contig	position	variantID	refAllele	altAllele	refCount	altCount	totalCount	lowMAPQDepth	lowBaseQDepth	rawDepth	otherBases	improperPairs
1	6698	.	G	A	16	20	36	0	3	39	0	0
1	6746	.	T	C	7	0	7	0	7	14	0	0
1	10093	.	C	T	6	5	11	0	0	11	0	0
1	14083	.	G	A	0	4	4	0	4	8	0	0
1	15050	.	G	A	1	4	5	0	14	19	0	0
1	15772	.	G	A	0	6	6	0	17	23	0	0
1	15828	.	G	A	0	8	8	0	14	22	0	0
1	16072	.	C	T	1	6	7	0	0	7	0	0
1	29950	.	A	G	0	1	1	0	0	1	0	0
1	32450	.	T	C	2	8	10	0	1	11	0	0
1	33036	.	C	T	13	9	22	0	2	24	0	0
1	38106	.	C	T	10	9	19	0	2	21	0	0
1	38814	.	G	A	2	12	14	0	9	23	0	0
1	39620	.	C	A	0	8	8	0	7	15	0	0
1	39621	.	G	C	6	9	15	0	0	15	0	0
1	39717	.	T	G	3	13	16	0	1	17	0	0
1	40409	.	T	C	0	2	2	0	0	2	0	0
1	41287	.	C	T	0	4	4	0	2	6	0	0
1	41560	.	G	A	0	1	1	0	0	1	0	0
1	42590	.	G	A	2	3	5	0	1	6	0	0
1	42662	.	G	A	1	2	3	0	0	3	0	0
1	62771	.	G	A	0	1	1	0	0	1	0	0
1	62838	.	C	T	2	2	4	0	0	4	0	0
1	141333	.	C	T	2	2	4	0	0	4	0	0
1	153527	.	A	G	0	1	1	0	0	1	0	0
1	154104	.	G	C	0	1	1	0	0	1	0	0
1	154113	.	G	A	0	1	1	0	0	1	0	0
1	154140	.	C	A	0	1	1	0	0	1	0	0
1	157915	.	T	A	4	4	8	0	0	8	0	0
1	176642	.	C	T	7	4	11	0	0	11	0	0
1	176774	.	C	T	1	2	3	0	0	3	0	0
1	181717	.	T	C	13	10	23	0	1	24	0	0
1	181754	.	C	T	4	9	13	0	5	18	0	0
1	181763	.	A	G	5	8	13	0	0	13	0	0
1	186864	.	G	A	0	1	1	0	0	1	0	0
1	208262	.	G	A	6	3	9	0	2	11	0	0
1	208265	.	G	A	7	3	10	0	1	11	0	0
1	208408	.	T	A	7	24	31	0	0	31	0	0
1	208564	.	T	C	8	3	11	0	0	11	0	0
1	208570	.	T	C	3	8	11	0	1	12	0	0
1	209113	.	T	C	5	9	14	0	1	15	0	0
1	212162	.	G	A	1	0	1	0	0	1	0	0
1	218551	.	C	T	1	2	3	0	0	3	0	0
1	225083	.	C	T	11	6	17	0	0	17	0	0
1	442456	.	T	C	2	3	5	0	1	6	0	0
1	474228	.	C	T	3	1	4	0	2	6	0	0
1	474273	.	C	G	0	2	2	0	0	2	0	0
1	474286	.	T	A	1	2	3	0	0	3	0	0
1	474398	.	C	A	0	6	6	0	6	12	0	0
1	474465	.	C	T	9	8	17	0	4	21	0	0
1	474473	.	A	G	11	9	20	0	1	21	0	0
1	476034	.	G	A	3	1	4	0	1	5	0	0
1	476998	.	G	C	9	2	11	0	0	11	0	0
1	477001	.	C	T	0	3	3	0	8	11	0	0
1	477046	.	G	A	6	4	10	0	0	10	0	0
1	477070	.	C	T	0	4	4	0	4	8	0	0
1	477951	.	C	T	3	0	3	0	0	3	0	0
1	479986	.	A	G	0	1	1	0	0	1	0	0
1	483820	.	T	A	0	3	3	0	0	3	0	0
1	483821	.	C	T	0	3	3	0	0	3	0	0
1	484094	.	G	A	1	2	3	0	0	3	0	0
1	484418	.	G	A	4	4	8	0	0	8	0	0
1	484434	.	C	T	4	7	11	0	0	11	0	0
1	484590	.	C	T	0	1	1	0	0	1	0	0
1	486475	.	G	C	3	2	5	0	0	5	0	0
1	488342	.	C	G	1	1	2	0	0	2	0	0
1	488390	.	G	A	1	4	5	0	0	5	0	0
1	489306	.	A	G	1	1	2	0	0	4	2	0
1	496871	.	G	A	3	2	5	0	0	5	0	0
1	497054	.	G	A	3	4	7	0	0	7	0	0
1	499220	.	A	G	2	3	5	0	1	6	0	0
1	501381	.	T	A	2	3	5	0	0	5	0	0
1	502079	.	C	A	2	5	7	0	0	7	0	0
1	503900	.	C	T	3	5	8	0	0	8	0	0
1	504663	.	C	G	15	4	19	0	2	21	0	0
1	504912	.	C	A	2	1	3	0	1	4	0	0
1	504985	.	A	G	8	4	12	0	0	12	0	0
1	505178	.	G	A	6	5	11	0	1	12	0	0
1	505260	.	A	G	8	0	8	0	10	18	0	0
1	505298	.	C	T	9	10	19	0	0	19	0	0
1	505403	.	G	A	11	5	16	0	0	16	0	0
1	505499	.	C	G	1	5	6	0	2	8	0	0
1	509387	.	A	G	5	7	12	0	1	13	0	0
1	509769	.	G	T	0	3	3	0	2	5	0	0
1	511525	.	G	A	0	0	0	0	1	1	0	0
1	511544	.	C	T	2	3	5	0	1	6	0	0
1	511957	.	G	A	2	2	4	0	0	4	0	0
1	511968	.	A	T	3	2	5	0	0	5	0	0
1	514070	.	T	C	1	4	5	0	0	5	0	0
1	514202	.	C	T	1	1	2	0	0	2	0	0
1	515549	.	G	A	2	2	4	0	0	4	0	0
1	515575	.	G	C	2	3	5	0	0	5	0	0
1	517515	.	C	T	2	0	2	0	0	2	0	0
1	517733	.	C	T	3	2	5	0	0	5	0	0
1	524697	.	C	G	1	3	4	0	0	4	0	0
1	524806	.	G	A	3	5	8	0	1	9	0	0
1	524828	.	C	T	0	4	4	0	0	4	0	0
1	528522	.	G	A	1	18	19	0	12	31	0	0
1	528552	.	A	C	14	10	24	0	6	30	0	0
1	586161	.	G	A	1	4	5	0	5	10	0	0
1	586165	.	C	T	5	7	12	0	0	12	0	0
1	586765	.	C	T	1	2	3	0	0	3	0	0
1	589044	.	A	T	6	4	10	0	1	12	1	0
1	589056	.	C	T	10	8	18	0	0	18	0	0
1	589115	.	G	A	0	8	8	0	12	20	0	0
1	603292	.	A	G	2	4	6	0	2	8	0	0
1	610606	.	C	T	4	11	15	0	1	16	0	0
1	610722	.	T	C	5	15	20	0	1	21	0	0
1	611267	.	T	C	15	22	37	0	3	40	0	0
1	617950	.	C	T	2	29	31	0	29	60	0	0
1	618190	.	A	C	20	3	23	0	39	62	0	0
1	618210	.	G	A	36	19	55	0	5	60	0	0
1	618277	.	A	G	26	24	50	0	6	56	0	0
1	618434	.	C	T	25	30	55	0	7	62	0	0
1	618723	.	C	T	12	1	13	0	0	13	0	0
1	618760	.	C	T	0	5	5	0	7	12	0	0
1	618776	.	C	A	8	10	18	0	1	19	0	0
1	618826	.	C	T	15	11	26	0	0	26	0	0
1	618918	.	A	T	13	35	48	0	5	53	0	0
1	618932	.	A	G	13	43	56	0	3	59	0	0
1	619679	.	T	A	9	11	20	0	5	25	0	0
1	619703	.	C	T	1	10	11	0	16	27	0	0
1	619764	.	C	T	19	6	25	1	1	27	0	0
1	620244	.	A	T	26	27	53	0	3	56	0	0
1	620314	.	G	A	30	16	46	0	3	49	0	0
1	620516	.	A	T	10	38	48	1	2	51	0	0
1	620517	.	T	G	11	38	49	1	1	51	0	0
1	621027	.	C	T	0	15	15	0	15	30	0	0
1	621063	.	T	A	16	10	26	0	1	27	0	0
1	621069	.	G	A	17	9	26	0	1	27	0	0
1	621102	.	A	T	6	18	24	0	5	29	0	0
1	621141	.	T	A	3	15	18	0	0	18	0	0
1	621283	.	C	T	0	17	17	0	12	29	0	0
1	621336	.	G	A	14	17	31	0	2	33	0	0
1	621389	.	C	T	14	18	32	0	1	33	0	0
1	621440	.	C	T	9	11	20	0	1	21	0	0
1	626601	.	G	A	12	9	21	0	3	24	0	0
1	634882	.	T	C	9	6	15	0	1	16	0	0
1	634933	.	T	C	6	3	9	0	2	13	2	0
1	638431	.	C	T	0	1	1	0	0	1	0	0
1	5275892	.	G	A	4	2	6	0	0	6	0	0
1	5276189	.	G	A	4	2	6	0	0	6	0	0
1	5276257	.	T	C	3	2	5	0	0	5	0	0
1	5276343	.	G	A	1	2	3	0	2	5	0	0
1	5354765	.	C	A	17	16	33	0	0	33	0	0
1	5354768	.	A	G	17	15	32	0	1	33	0	0
1	5354929	.	T	C	12	30	42	0	1	43	0	0
1	5355024	.	G	T	22	24	46	0	0	46	0	0
1	5355334	.	G	A	23	32	55	0	11	66	0	0
1	5355435	.	C	T	2	20	22	2	16	40	0	0
1	5355514	.	G	A	30	30	60	0	4	64	0	0
1	5355707	.	T	A	27	30	57	0	2	59	0	0
1	5355804	.	C	T	2	20	22	1	29	52	0	0
1	5356001	.	C	A	17	23	40	0	4	44	0	0
1	5356002	.	A	C	17	0	17	0	27	44	0	0
1	5356075	.	A	T	20	11	31	0	1	32	0	0
1	5356087	.	C	T	16	12	28	0	2	30	0	0
1	5356455	.	T	G	9	11	20	0	4	24	0	0
1	5356497	.	C	A	11	8	19	0	2	21	0	0
1	5356499	.	G	T	11	6	17	0	4	21	0	0
1	5356667	.	A	T	8	13	21	0	0	21	0	0
1	5356681	.	T	C	13	0	13	0	17	30	0	0
1	5357053	.	T	C	16	2	18	0	0	18	0	0
1	5357354	.	C	T	0	2	2	1	1	4	0	0
1	5357405	.	T	C	4	9	13	0	1	14	0	0
1	5357528	.	C	G	15	10	25	0	0	25	0	0
1	5357541	.	T	C	9	12	21	0	6	27	0	0
1	5357630	.	T	C	14	5	19	0	2	21	0	0
1	5357653	.	T	A	11	3	14	1	4	19	0	0
1	5357742	.	C	A	13	12	25	0	1	26	0	0
1	5357772	.	C	G	14	9	23	1	0	24	0	0
1	5357845	.	C	A	12	11	23	1	1	25	0	0
1	5357967	.	T	G	19	3	22	0	0	22	0	0
1	5358265	.	C	T	1	12	13	0	11	24	0	0
1	5358448	.	A	G	3	10	13	0	1	14	0	0
1	5358480	.	G	T	4	7	11	0	2	13	0	0
1	5358792	.	C	A	8	11	19	0	0	19	0	0
1	5375285	.	C	T	3	1	4	0	0	4	0	0
1	5378957	.	T	G	3	1	4	0	1	5	0	0
1	5402605	.	T	A	3	4	7	0	1	8	0	0
1	5414300	.	T	C	2	1	3	0	0	3	0	0
1	5415859	.	T	C	3	2	5	0	0	5	0	0
1	5415970	.	C	G	0	0	0	0	1	1	0	0
1	5418692	.	C	T	13	16	29	0	1	30	0	0
1	5418971	.	A	T	21	18	39	0	0	39	0	0
1	5419043	.	G	T	8	7	15	0	1	16	0	0
1	5433554	.	C	T	1	1	2	0	1	3	0	0
1	5433709	.	C	T	3	9	12	0	1	13	0	0
1	5433712	.	T	C	4	6	10	0	3	13	0	0
1	5433890	.	T	C	2	3	5	0	0	5	0	0
1	5503701	.	T	C	2	4	6	0	0	6	0	0
1	5503809	.	T	C	3	3	6	0	0	6	0	0
1	5503828	.	T	C	3	2	5	0	1	6	0	0
1	5503882	.	G	A	3	2	5	0	0	5	0	0
1	5504032	.	C	G	1	3	4	0	0	4	0	0
1	5606790	.	C	A	13	19	32	0	2	34	0	0
1	5607137	.	G	T	6	8	14	0	0	14	0	0
1	5607181	.	A	G	4	9	13	0	0	13	0	0
1	5607276	.	C	T	1	2	3	0	0	3	0	0
1	5607349	.	T	A	5	4	9	0	0	9	0	0
1	5607597	.	G	A	4	7	11	0	0	11	0	0
1	5607668	.	T	C	1	8	9	0	4	13	0	0
1	5607914	.	G	T	3	9	12	0	0	12	0	0
1	5607929	.	C	A	9	5	14	0	0	14	0	0
1	5607970	.	T	C	7	3	10	0	0	10	0	0
1	5608215	.	G	T	5	6	11	0	0	11	0	0
1	6149942	.	T	C	1	2	3	0	0	3	0	0
1	6158360	.	G	T	0	3	3	0	2	5	0	0
1	6165150	.	A	G	1	0	1	0	0	1	0	0
1	6167421	.	A	G	2	0	2	0	6	8	0	0
1	6168264	.	G	A	0	4	4	0	0	4	0	0
1	6168346	.	T	A	11	5	16	0	0	16	0	0
1	6168411	.	G	C	3	6	9	0	1	10	0	0
1	6168417	.	G	T	0	6	6	0	4	10	0	0
1	6168568	.	C	G	7	5	12	0	2	14	0	0
1	6168858	.	A	G	7	0	7	0	14	21	0	0
1	6168875	.	G	A	9	13	22	0	0	22	0	0
1	6168925	.	T	C	10	6	16	0	3	19	0	0
1	6169155	.	C	T	6	8	14	0	0	14	0	0
1	6169208	.	C	T	4	7	11	0	1	12	0	0
1	6169232	.	T	C	5	5	10	0	2	12	0	0
1	6169279	.	G	A	6	8	14	0	2	16	0	0
1	6169317	.	C	T	6	10	16	0	1	17	0	0
1	6169378	.	C	T	9	6	15	0	0	15	0	0
1	6169387	.	G	C	11	8	19	0	0	19	0	0
1	6169462	.	T	C	12	9	21	0	3	24	0	0
1	6169688	.	A	T	6	4	10	0	0	10	0	0
1	6169691	.	C	T	5	4	9	0	1	10	0	0
1	6173631	.	T	C	0	0	0	0	1	1	0	0
1	6185218	.	A	G	5	6	11	0	1	12	0	0
1	6185236	.	T	G	5	5	10	0	0	10	0	0
1	6185259	.	T	G	6	11	17	0	1	18	0	0
1	6185280	.	T	A	6	9	15	0	1	16	0	0
1	6185320	.	T	A	9	12	21	0	1	22	0	0
1	6185326	.	A	C	9	10	19	0	1	20	0	0
1	6185411	.	C	T	3	4	7	0	2	9	0	0
1	6207041	.	A	G	0	1	1	0	0	1	0	0
1	6209662	.	T	G	2	3	5	0	0	5	0	0
1	6210243	.	T	C	4	7	11	0	0	11	0	0
1	6226345	.	T	G	5	4	9	0	0	9	0	0
1	6226347	.	T	A	5	4	9	0	0	9	0	0
1	6236899	.	T	C	2	1	3	0	0	3	0	0
1	6238639	.	C	T	5	2	7	0	0	7	0	0
1	6240444	.	T	G	1	0	1	0	0	1	0	0
1	6241379	.	G	T	0	3	3	0	8	11	0	0
1	6254769	.	A	G	1	2	3	0	0	3	0	0
1	6269116	.	T	C	4	3	7	0	0	7	0	0
1	6271664	.	A	G	3	5	8	0	0	8	0	0
1	6271712	.	T	C	3	7	10	0	0	10	0	0
1	6272026	.	G	A	1	2	3	0	0	3	0	0
1	6272029	.	C	T	1	2	3	0	0	3	0	0
1	6357164	.	A	C	0	2	2	0	0	2	0	0
1	6357840	.	A	G	2	2	4	0	1	5	0	0
1	6364196	.	T	C	2	2	4	0	0	4	0	0
1	6365793	.	A	C	1	2	3	0	0	3	0	0
1	6366000	.	T	A	1	3	4	0	0	4	0	0
1	6366024	.	A	C	2	2	4	0	1	5	0	0
1	6404205	.	A	T	1	2	3	0	0	3	0	0
1	6429646	.	A	G	3	2	5	0	0	5	0	0
1	6648724	.	T	C	1	1	2	0	0	2	0	0
1	6662858	.	A	T	4	10	14	0	1	15	0	0
1	6663617	.	T	C	3	11	14	0	0	14	0	0
1	6663623	.	C	A	3	9	12	0	3	15	0	0
1	6663946	.	A	G	3	10	13	0	2	15	0	0
1	6924858	.	G	C	0	3	3	0	0	3	0	0
1	7518644	.	C	T	4	2	6	0	0	6	0	0
1	7522455	.	T	C	2	2	4	0	0	4	0	0
1	7523264	.	C	T	0	1	1	0	0	1	0	0
1	7526839	.	G	A	3	3	6	0	0	6	0	0
1	7528289	.	G	C	0	15	15	0	23	38	0	0
1	7529752	.	G	A	19	21	40	0	2	42	0	0
1	7529833	.	G	C	0	12	12	0	10	22	0	0
1	7530123	.	C	T	2	0	2	0	0	2	0	0
1	7538822	.	C	T	16	7	23	0	3	26	0	0
1	7539053	.	G	C	22	13	35	0	4	39	0	0
1	7554068	.	T	C	0	6	6	0	8	14	0	0
1	7632221	.	C	T	2	5	7	0	0	7	0	0
1	7662571	.	T	C	18	24	42	0	2	44	0	0
1	7662628	.	G	A	18	24	42	0	1	43	0	0
1	7662723	.	T	A	14	21	35	0	2	37	0	0
1	7662728	.	G	A	15	22	37	0	2	39	0	0
1	7662880	.	A	T	21	22	43	0	0	43	0	0
1	7670535	.	C	T	7	10	17	0	2	19	0	0
1	7672794	.	T	C	6	5	11	0	0	11	0	0
1	7672809	.	C	T	9	12	21	0	0	21	0	0
1	7673070	.	C	T	9	8	17	0	9	26	0	0
1	7673129	.	C	A	12	12	24	0	0	24	0	0
1	7673198	.	A	G	8	8	16	0	2	18	0	0
1	7682949	.	G	A	10	8	18	0	0	18	0	0
1	7875007	.	T	C	1	2	3	0	0	3	0	0
1	7875012	.	A	G	1	1	2	0	0	2	0	0
1	8022495	.	C	T	15	13	28	0	1	29	0	0
1	8022532	.	A	G	13	15	28	0	1	29	0	0
1	8022606	.	T	C	12	10	22	0	1	23	0	0
1	8022682	.	C	T	0	15	15	0	22	37	0	0
1	8023433	.	C	T	15	9	24	0	1	25	0	0
1	8023587	.	A	G	13	13	26	0	0	26	0	0
1	8023730	.	C	T	14	21	35	0	2	37	0	0
1	8024087	.	G	A	12	7	19	0	1	20	0	0
1	8025863	.	C	T	11	12	23	0	3	26	0	0
1	8026146	.	C	T	10	12	22	0	0	22	0	0
1	8026148	.	T	G	10	12	22	0	0	22	0	0
1	8026293	.	G	T	9	10	19	0	2	21	0	0
1	8026345	.	C	T	13	16	29	0	1	30	0	0
1	8026415	.	C	T	0	19	19	0	11	30	0	0
1	8026521	.	C	A	0	8	8	0	10	18	0	0
1	8026565	.	C	T	0	2	2	0	1	3	0	0
1	8026924	.	T	A	8	6	14	0	1	15	0	0
1	8028177	.	T	A	5	4	9	0	0	9	0	0
1	8028652	.	G	A	2	9	11	0	0	11	0	0
1	8028688	.	C	A	5	3	8	0	1	9	0	0
1	8028727	.	G	A	5	4	9	0	1	10	0	0
1	8028811	.	C	T	0	10	10	0	9	19	0	0
1	8032947	.	G	A	2	3	5	0	0	5	0	0
1	8051513	.	G	A	2	2	4	0	0	4	0	0
1	8055954	.	A	G	3	0	3	0	0	3	0	0
1	8165443	.	A	C	4	7	11	0	0	11	0	0
1	8165609	.	C	T	13	9	22	0	1	23	0	0
1	8165643	.	T	C	6	2	8	0	0	8	0	0
1	8165667	.	T	C	3	3	6	0	1	7	0	0
1	8165741	.	T	C	1	4	5	0	0	5	0	0
1	8166788	.	A	T	6	9	15	0	1	16	0	0
1	8166992	.	A	G	3	5	8	0	2	10	0	0
1	8167194	.	G	T	0	2	2	0	0	2	0	0
1	8167319	.	A	G	3	1	4	0	0	4	0	0
1	8167368	.	G	A	7	6	13	0	0	13	0	0
1	8167508	.	A	G	10	13	23	0	2	25	0	0
1	8167526	.	C	T	11	10	21	0	0	21	0	0
1	8167570	.	C	G	5	7	12	0	1	13	0	0
1	8167668	.	G	A	7	7	14	0	1	15	0	0
1	8185072	.	G	A	6	4	10	0	1	11	0	0
1	8185103	.	G	A	4	1	5	0	0	5	0	0
1	8189518	.	G	T	0	1	1	0	0	1	0	0
1	8192188	.	C	G	2	2	4	0	0	4	0	0
1	8192192	.	A	G	2	2	4	0	0	4	0	0
1	8403299	.	G	A	0	2	2	0	1	3	0	0
1	8416565	.	T	A	17	31	48	0	0	48	0	0
1	8416629	.	T	G	25	29	54	0	1	55	0	0
1	8416820	.	C	T	7	3	10	0	0	10	0	0
1	8417896	.	T	C	14	15	29	0	0	29	0	0
1	8417943	.	A	G	13	11	24	0	1	25	0	0
1	8418118	.	C	G	7	7	14	0	1	16	1	0
1	8418126	.	A	C	5	0	5	0	6	11	0	0
1	8422521	.	A	G	14	6	20	0	1	21	0	0
1	8424738	.	C	T	0	9	9	0	10	19	0	0
1	8424804	.	C	T	9	8	17	0	4	21	0	0
1	8424813	.	A	G	9	8	17	0	2	19	0	0
1	8508755	.	G	A	0	1	1	0	5	6	0	0
1	8508809	.	G	T	4	5	9	0	0	9	0	0
1	8508950	.	T	C	8	5	13	0	0	13	0	0
1	8511602	.	C	T	0	2	2	0	0	2	0	0
1	8511778	.	G	T	0	2	2	0	3	5	0	0
1	8516407	.	G	A	0	12	12	0	16	28	0	0
1	8516443	.	C	G	8	12	20	0	1	21	0	0
1	8516552	.	A	G	8	11	19	0	2	21	0	0
1	8530336	.	G	A	0	3	3	0	3	6	0	0
1	8530544	.	T	A	3	2	5	0	0	5	0	0
1	8530548	.	T	G	3	2	5	0	0	5	0	0
1	8531494	.	A	G	4	3	7	0	0	7	0	0
1	8543337	.	T	A	4	0	4	0	0	4	0	0
1	8543380	.	G	A	4	0	4	0	0	4	0	0
1	8543390	.	C	T	3	0	3	0	0	3	0	0
1	8543707	.	A	G	0	3	3	0	0	3	0	0
1	8544457	.	C	T	0	1	1	0	0	1	0	0
1	8544483	.	G	A	0	1	1	0	0	1	0	0
1	8550143	.	T	C	1	0	1	0	0	1	0	0
1	8550146	.	T	C	1	0	1	0	0	1	0	0
1	8555456	.	A	G	1	8	9	0	2	11	0	0
1	8555582	.	C	G	2	3	5	0	0	5	0	0
1	8559950	.	G	T	2	4	6	0	0	6	0	0
1	8559967	.	A	G	2	3	5	0	0	5	0	0
1	8560072	.	A	G	1	2	3	0	1	4	0	0
1	8560237	.	C	T	1	2	3	0	0	3	0	0
1	8560266	.	C	T	1	2	3	0	0	3	0	0
1	8564058	.	C	T	0	1	1	0	0	1	0	0
1	8607487	.	C	T	1	5	6	0	0	6	0	0
1	8608008	.	T	C	1	2	3	0	0	3	0	0
1	8610451	.	G	A	1	12	13	0	8	21	0	0
1	8638537	.	T	G	3	2	5	0	0	5	0	0
1	8639877	.	G	A	0	1	1	0	0	1	0	0
1	8639883	.	G	A	1	0	1	0	0	1	0	0
1	8642800	.	C	T	1	3	4	0	2	6	0	0
1	8642953	.	C	T	5	2	7	0	0	7	0	0
1	8649726	.	A	G	11	15	26	0	0	26	0	0
1	8649865	.	C	T	23	14	37	0	2	39	0	0
1	8649988	.	A	G	8	12	20	0	3	23	0	0
1	8649994	.	A	T	7	12	19	0	1	20	0	0
1	8650317	.	G	A	28	22	50	0	5	55	0	0
1	8650371	.	C	T	20	34	54	0	4	58	0	0
1	8650544	.	G	A	0	6	6	0	0	6	0	0
1	8651036	.	G	A	17	20	37	0	0	37	0	0
1	8651060	.	T	C	14	6	20	0	1	21	0	0
1	8651576	.	G	A	12	15	27	0	2	29	0	0
1	8662553	.	G	A	9	17	26	0	1	27	0	0
1	8663048	.	G	A	0	10	10	0	8	18	0	0
1	8663195	.	T	G	10	8	18	0	1	19	0	0
1	8663295	.	T	C	9	11	20	0	2	22	0	0
1	8667377	.	G	A	9	7	16	0	0	16	0	0
1	8667606	.	C	T	8	18	26	0	0	26	0	0
1	8668166	.	T	C	19	24	43	0	1	44	0	0
1	8668238	.	G	T	20	11	31	0	2	34	1	0
1	8669543	.	A	G	1	8	9	0	0	9	0	0
1	8669669	.	A	G	15	9	24	0	3	27	0	0
1	8669717	.	T	G	14	16	30	0	0	30	0	0
1	8669718	.	T	C	13	16	29	0	1	30	0	0
1	8669753	.	T	A	16	16	32	0	0	32	0	0
1	8669847	.	G	T	28	18	46	0	2	48	0	0
1	8670031	.	T	C	21	30	51	0	7	58	0	0
1	8670032	.	G	T	3	24	27	0	31	58	0	0
1	8670159	.	T	C	29	14	43	0	4	47	0	0
1	8670180	.	T	C	30	22	52	0	5	57	0	0
1	8670402	.	G	A	14	23	37	0	1	38	0	0
1	8670460	.	A	G	2	2	4	0	1	5	0	0
1	8694404	.	G	A	16	8	24	0	2	26	0	0
1	8698765	.	T	C	11	14	25	0	1	26	0	0
1	8701548	.	A	G	8	1	9	0	21	30	0	0
1	8702325	.	G	T	21	20	41	0	2	43	0	0
1	8702400	.	T	C	23	30	53	0	1	54	0	0
1	8764123	.	C	T	7	8	15	1	1	17	0	0
1	8765028	.	G	A	13	15	28	0	2	30	0	0
1	8765491	.	T	A	17	11	28	0	1	29	0	0
1	8765493	.	G	T	18	6	24	0	5	29	0	0
1	8766453	.	C	T	17	7	24	0	0	24	0	0
1	8766471	.	C	T	0	9	9	0	15	24	0	0
1	8766501	.	C	T	17	7	24	0	0	24	0	0
1	8766693	.	G	A	7	5	12	0	0	12	0	0
1	8766903	.	G	C	6	7	13	0	0	13	0	0
1	8771020	.	T	G	1	1	2	0	0	2	0	0
1	9044526	.	C	T	1	5	6	0	0	6	0	0
1	9044745	.	C	T	2	2	4	0	0	4	0	0
1	9051092	.	T	C	2	1	3	0	0	3	0	0
1	9064781	.	T	G	0	3	3	0	1	4	0	0
1	9064885	.	C	A	2	3	5	0	0	5	0	0
1	9074335	.	C	T	0	2	2	0	1	3	0	0
1	9118497	.	T	A	16	11	27	0	0	27	0	0
1	9123289	.	C	G	8	7	15	0	3	18	0	0
1	9261903	.	A	C	8	0	8	0	12	20	0	0
1	9261930	.	G	A	7	11	18	0	2	20	0	0
1	9262173	.	G	A	6	4	10	0	4	14	0	0
1	9262221	.	A	G	1	1	2	0	0	2	0	0
1	9265578	.	T	C	1	5	6	0	0	6	0	0
1	9273011	.	C	T	5	4	9	0	1	10	0	0
1	9273037	.	A	G	5	1	6	0	2	8	0	0
1	9273173	.	G	A	7	5	12	0	0	12	0	0
1	9273347	.	A	G	0	1	1	0	0	1	0	0
1	9278150	.	G	A	3	0	3	0	0	3	0	0
1	9290319	.	A	G	1	6	7	0	1	8	0	0
1	9290500	.	G	T	3	3	6	0	0	6	0	0
1	9292975	.	A	T	4	6	10	0	0	10	0	0
1	9293002	.	T	C	7	7	14	0	1	15	0	0
1	9293495	.	A	G	9	13	22	0	0	22	0	0
1	9499764	.	C	T	8	8	16	0	3	19	0	0
1	9500312	.	A	T	2	14	16	0	0	16	0	0
1	9500332	.	T	C	1	6	7	0	0	10	3	0
1	9500757	.	A	T	4	5	9	0	1	10	0	0
1	9500835	.	A	G	5	7	12	0	0	12	0	0
1	9500947	.	G	T	9	4	13	0	0	13	0	0
1	9501031	.	C	T	2	2	4	0	0	4	0	0
1	9501229	.	C	T	8	11	19	0	1	20	0	0
1	9501231	.	G	A	12	8	20	0	0	20	0	0
1	9501394	.	T	A	6	12	18	0	0	18	0	0
1	9508752	.	T	A	0	6	6	0	1	7	0	0
1	9710759	.	C	T	2	2	4	0	0	4	0	0
1	9710853	.	T	C	2	1	3	0	1	4	0	0
1	9711158	.	G	A	2	3	5	0	0	5	0	0
1	9711161	.	G	A	2	3	5	0	0	5	0	0
1	9711405	.	T	A	2	2	4	0	0	4	0	0
1	9711740	.	G	C	3	3	6	0	0	6	0	0
1	9712111	.	G	A	0	5	5	0	10	15	0	0
1	9793286	.	C	T	1	4	5	0	0	5	0	0
1	9808345	.	T	A	0	2	2	0	0	2	0	0
1	9808365	.	C	T	0	2	2	0	0	2	0	0
1	9866740	.	G	T	1	2	3	0	0	3	0	0
1	9873485	.	G	A	5	2	7	0	0	7	0	0
1	9873509	.	G	A	4	2	6	0	0	6	0	0
1	9873607	.	A	T	3	6	9	0	5	14	0	0
1	9873616	.	T	C	6	0	6	0	11	17	0	0
1	9873787	.	G	A	0	5	5	0	0	5	0	0
1	9914164	.	C	T	0	4	4	0	0	4	0	0
1	10033032	.	A	T	3	3	6	0	2	8	0	0
1	10667832	.	C	T	0	2	2	0	4	6	0	0
1	10683868	.	A	T	8	5	13	0	0	13	0	0
1	10683955	.	A	G	6	5	11	0	1	12	0	0
1	10683974	.	A	C	5	6	11	0	2	13	0	0
1	10684037	.	A	G	5	1	6	0	8	14	0	0
1	10684105	.	G	A	0	7	7	0	10	17	0	0
1	10692078	.	T	C	13	5	18	0	1	19	0	0
1	10692090	.	G	A	10	3	13	0	2	15	0	0
1	10736181	.	G	A	7	5	12	0	1	13	0	0
1	10738177	.	A	G	10	9	19	0	1	20	0	0
1	10738509	.	T	C	21	37	58	0	1	59	0	0
1	10738535	.	G	A	28	33	61	0	3	64	0	0
1	10738863	.	C	A	26	27	53	0	9	63	1	0
1	10739190	.	A	G	38	10	48	0	1	49	0	0
1	10841254	.	T	C	4	14	18	0	2	20	0	0
1	10841275	.	T	C	7	12	19	0	0	19	0	0
1	10841356	.	G	A	2	0	2	0	0	2	0	0
1	11125237	.	G	A	3	5	8	0	0	8	0	0
1	11125249	.	A	C	3	4	7	0	2	9	0	0
1	11127938	.	G	A	4	2	6	0	0	6	0	0
1	11130713	.	G	A	1	3	4	0	0	4	0	0
1	11132905	.	C	T	0	2	2	0	2	4	0	0
1	11670963	.	T	C	3	4	7	0	0	7	0	0
1	11671042	.	T	C	5	3	8	0	2	10	0	0
1	11671059	.	A	G	8	4	12	0	0	12	0	0
1	11671355	.	C	A	7	5	12	0	0	12	0	0
1	11671527	.	G	A	8	3	11	0	4	15	0	0
1	11671580	.	C	T	4	4	8	0	1	9	0	0
1	11671651	.	A	C	0	2	2	0	0	2	0	0
1	11783388	.	T	C	8	22	30	0	0	30	0	0
1	11783504	.	T	C	18	8	26	0	3	29	0	0
1	11783650	.	T	C	18	18	36	0	0	36	0	0
1	15254249	.	A	G	5	0	5	0	6	11	0	0
1	15255249	.	A	G	7	0	7	0	1	8	0	0
1	17522801	.	A	G	19	7	26	0	0	26	0	0
1	17523030	.	A	G	16	1	17	0	13	30	0	0
1	17523603	.	A	G	16	6	22	0	4	26	0	0
1	17535858	.	A	G	6	0	6	0	8	14	0	0
1	17535859	.	A	G	4	10	14	0	0	14	0	0
1	19105746	.	A	G	4	2	6	0	0	6	0	0
1	19562970	.	G	A	10	3	13	0	5	18	0	0
1	20705863	.	A	G	1	31	32	0	1	33	0	0
1	21341577	.	T	C	0	1	1	0	1	2	0	0
1	21576919	.	G	A	2	3	5	0	0	5	0	0
1	21579197	.	T	C	0	2	2	0	0	2	0	0
1	21610564	.	T	C	3	5	8	0	0	8	0	0
1	21611043	.	T	C	1	6	7	0	0	7	0	0
1	21612127	.	C	T	4	2	6	0	0	6	0	0
1	21612153	.	T	G	3	3	6	0	0	6	0	0
1	21612400	.	G	A	7	5	12	0	0	12	0	0
1	21612418	.	G	C	4	6	10	0	0	10	0	0
1	22236735	.	T	G	1	5	6	0	1	7	0	0
1	22236891	.	A	T	1	3	4	0	0	4	0	0
1	22389122	.	C	T	10	5	15	0	0	15	0	0
1	22389246	.	C	T	1	9	10	0	6	16	0	0
1	22389264	.	T	A	8	8	16	0	0	16	0	0
1	22389395	.	T	C	3	1	4	0	0	4	0	0
1	22393427	.	C	T	0	1	1	0	1	2	0	0
1	22412005	.	G	A	4	5	9	0	0	9	0	0
1	22483060	.	T	G	3	0	3	0	1	4	0	0
1	22483076	.	T	C	0	2	2	0	0	2	0	0
1	22484544	.	C	A	4	3	7	0	1	8	0	0
1	22647772	.	T	C	5	5	10	0	1	11	0	0
1	22648037	.	T	A	24	30	54	0	2	56	0	0
1	22648038	.	A	C	25	30	55	0	1	56	0	0
1	22651934	.	T	A	5	2	7	0	0	7	0	0
1	22664924	.	A	T	6	5	11	0	0	11	0	0
1	22713000	.	A	T	3	2	5	0	0	5	0	0
1	22713010	.	A	T	3	1	4	0	0	4	0	0
1	22770608	.	A	T	14	19	33	0	0	33	0	0
1	22770723	.	C	T	12	9	21	0	1	22	0	0
1	22770810	.	C	T	5	14	19	0	1	20	0	0
1	22771305	.	T	G	12	17	29	0	1	30	0	0
1	22771437	.	G	A	6	12	18	0	0	18	0	0
1	22771677	.	C	T	0	7	7	0	6	13	0	0
1	22771911	.	A	T	8	2	10	0	2	12	0	0
1	22771936	.	C	T	5	4	9	0	0	9	0	0
1	22771952	.	A	T	6	4	10	0	0	10	0	0
1	22772213	.	C	A	9	6	15	0	1	16	0	0
1	22772308	.	C	T	4	8	12	0	0	12	0	0
1	22772545	.	A	T	9	6	15	0	0	15	0	0
1	22772711	.	G	A	7	6	13	0	1	14	0	0
1	22777201	.	G	A	1	0	1	0	0	1	0	0
1	22803051	.	C	T	3	2	5	0	0	5	0	0
1	22805615	.	C	T	14	9	23	0	0	23	0	0
1	22805630	.	G	C	11	8	19	0	1	20	0	0
1	22805766	.	C	T	1	3	4	1	0	5	0	0
1	22805861	.	G	A	1	2	3	0	0	3	0	0
1	22805906	.	A	C	1	9	10	0	0	10	0	0
1	22805927	.	C	A	4	9	13	0	0	13	0	0
1	22806089	.	C	T	14	17	31	0	4	35	0	0
1	22806108	.	A	G	16	16	32	0	2	34	0	0
1	22806156	.	T	C	4	9	13	0	2	15	0	0
1	22806643	.	C	A	15	16	31	0	0	31	0	0
1	22806825	.	C	T	0	12	12	0	5	17	0	0
1	22806845	.	C	A	1	7	8	0	0	8	0	0
1	22806917	.	C	A	4	3	7	0	0	7	0	0
1	22806936	.	C	T	0	4	4	0	5	9	0	0
1	22806980	.	G	A	8	3	11	0	2	13	0	0
1	22807043	.	G	A	9	4	13	0	1	14	0	0
1	22807238	.	G	A	11	8	19	0	0	19	0	0
1	22807275	.	C	G	7	8	15	0	0	15	0	0
1	22807304	.	C	G	8	9	17	0	0	17	0	0
1	22807321	.	G	A	8	10	18	0	0	18	0	0
1	22807632	.	C	T	4	8	12	0	0	12	0	0
1	22807639	.	G	A	4	7	11	0	0	11	0	0
1	22807744	.	G	T	5	3	8	0	1	9	0	0
1	22808009	.	G	T	4	3	7	0	1	8	0	0
1	22808149	.	T	A	5	11	16	0	0	16	0	0
1	22808264	.	T	G	3	4	7	0	0	7	0	0
1	22808301	.	C	G	1	0	1	0	1	2	0	0
1	22808384	.	C	T	0	2	2	0	5	7	0	0
1	22808444	.	G	A	5	2	7	0	0	7	0	0
1	22808479	.	G	T	4	3	7	0	1	8	0	0
1	22808514	.	A	T	3	6	9	0	1	10	0	0
1	22808665	.	C	T	8	5	13	0	0	13	0	0
1	22814910	.	A	G	2	7	9	0	0	9	0	0
1	22829325	.	G	A	0	2	2	0	0	2	0	0
1	22851065	.	G	T	1	2	3	0	0	3	0	0
1	22851380	.	T	C	5	2	7	0	0	7	0	0
1	22851422	.	T	A	2	2	4	0	0	4	0	0
1	22851828	.	A	T	2	4	6	0	0	6	0	0
1	22856087	.	C	T	3	3	6	0	0	6	0	0
1	22857979	.	C	T	9	11	20	0	1	21	0	0
1	22857995	.	A	G	12	8	20	0	2	22	0	0
1	22858114	.	C	T	0	6	6	0	22	28	0	0
1	22858194	.	G	A	14	16	30	0	3	33	0	0
1	22858275	.	T	C	22	28	50	0	1	51	0	0
1	22858397	.	G	A	20	20	40	0	7	47	0	0
1	22858478	.	G	A	23	17	40	0	1	41	0	0
1	22861253	.	G	A	0	1	1	0	0	1	0	0
1	22861267	.	G	A	4	0	4	0	1	5	0	0
1	22864011	.	C	T	2	1	3	0	0	3	0	0
1	22943748	.	G	A	13	11	24	0	3	27	0	0
1	22944056	.	C	T	1	27	28	0	19	47	0	0
1	22944068	.	C	T	26	20	46	0	1	47	0	0
1	22944386	.	A	C	19	24	43	0	3	46	0	0
1	22945054	.	T	C	17	18	35	0	2	37	0	0
1	22945173	.	T	G	11	19	30	0	1	31	0	0
1	22945190	.	G	T	10	18	28	0	2	30	0	0
1	22945444	.	G	A	21	13	34	0	0	34	0	0
1	22945519	.	C	T	18	17	35	0	0	35	0	0
1	22945888	.	G	C	14	0	14	0	21	35	0	0
1	22945903	.	T	C	14	18	32	0	3	35	0	0
1	22946108	.	C	T	16	13	29	1	1	31	0	0
1	22956429	.	C	T	0	3	3	0	2	5	0	0
1	22966877	.	C	A	1	1	2	0	0	2	0	0
1	23072533	.	G	A	1	2	3	0	0	3	0	0
1	23072746	.	T	A	1	0	1	0	0	1	0	0
1	23094638	.	C	T	1	2	3	0	0	3	0	0
1	23094677	.	G	A	1	2	3	0	1	4	0	0
1	23233088	.	C	T	0	1	1	0	0	1	0	0
1	23243230	.	A	G	2	2	4	0	1	5	0	0
1	23243733	.	C	T	2	4	6	0	0	6	0	0
1	23254712	.	G	A	1	0	1	0	0	1	0	0
1	23271345	.	G	A	5	8	13	0	0	13	0	0
1	23271500	.	G	A	7	11	18	0	1	19	0	0
1	23271608	.	G	A	0	1	1	0	0	1	0	0
1	23271770	.	T	G	12	11	23	0	1	24	0	0
1	23274820	.	G	A	1	3	4	0	0	4	0	0
1	23275228	.	C	G	6	5	11	0	0	11	0	0
1	23283864	.	G	A	2	4	6	0	0	6	0	0
1	23283878	.	C	T	1	3	4	0	1	5	0	0
1	23297750	.	A	G	5	7	12	0	0	12	0	0
1	23298642	.	A	T	4	6	10	0	0	10	0	0
1	23298921	.	G	A	5	3	8	0	0	8	0	0
1	23308208	.	A	C	3	2	5	0	1	6	0	0
1	23506660	.	C	A	8	17	25	0	0	25	0	0
1	23506711	.	A	T	8	4	12	0	3	15	0	0
1	23506787	.	A	T	21	16	37	0	3	40	0	0
1	23506865	.	C	A	18	22	40	0	1	42	1	0
1	23508009	.	G	T	19	16	35	0	6	41	0	0
1	23526644	.	T	C	3	3	6	0	0	6	0	0
1	23528066	.	C	T	7	4	11	0	1	12	0	0
1	23530438	.	C	T	4	3	7	0	1	8	0	0
1	23536012	.	T	C	3	4	7	0	0	7	0	0
1	23536222	.	T	A	4	2	6	0	0	6	0	0
1	23573460	.	T	C	2	3	5	0	1	6	0	0
1	23573582	.	C	T	11	7	18	0	0	18	0	0
1	23573823	.	A	T	4	5	9	0	0	9	0	0
1	23574977	.	C	T	0	2	2	0	1	3	0	0
1	23578157	.	C	T	3	3	6	0	0	6	0	0
1	23578839	.	A	C	1	2	3	0	0	3	0	0
1	23585802	.	C	A	0	3	3	0	2	5	0	0
1	23586025	.	C	T	0	2	2	0	1	3	0	0
1	23586581	.	G	A	2	2	4	0	0	4	0	0
1	23586780	.	C	T	0	4	4	0	3	7	0	0
1	23589017	.	C	T	1	4	5	0	0	5	0	0
1	23908939	.	T	G	2	5	7	0	0	7	0	0
1	23908940	.	T	G	2	5	7	0	0	7	0	0
1	23909090	.	A	G	14	12	26	0	1	27	0	0
1	23909522	.	A	C	5	3	8	0	1	9	0	0
1	23909748	.	A	T	7	6	13	0	0	13	0	0
1	23920983	.	C	T	0	12	12	0	6	18	0	0
1	23921071	.	A	T	13	8	21	0	1	22	0	0
1	23921284	.	T	C	9	7	16	0	0	16	0	0
1	23921302	.	C	A	8	6	14	0	0	14	0	0
1	23921564	.	T	A	3	4	7	0	0	7	0	0
1	23936154	.	C	T	3	3	6	0	0	6	0	0
1	23943726	.	G	A	5	2	7	0	0	7	0	0
1	23947881	.	T	A	4	2	6	0	0	6	0	0
1	24076890	.	A	G	3	8	11	0	0	11	0	0
1	24077274	.	A	G	7	1	8	0	12	20	0	0
1	24077791	.	G	A	0	16	16	0	15	31	0	0
1	24077902	.	A	G	2	4	6	0	0	6	0	0
1	24157228	.	A	C	0	2	2	0	1	3	0	0
1	24197375	.	C	T	0	2	2	0	2	4	0	0
1	24357931	.	C	T	9	9	18	0	0	18	0	0
1	24520679	.	T	C	4	3	7	0	1	8	0	0
1	24523415	.	T	C	0	1	1	0	1	2	0	0
1	24557510	.	G	A	2	6	8	0	0	8	0	0
1	24558336	.	C	G	2	5	7	0	2	9	0	0
1	24558410	.	T	A	1	8	9	0	0	9	0	0
1	24871075	.	A	G	6	10	16	0	0	16	0	0
1	24871079	.	A	G	5	9	14	0	1	16	1	0
1	24879994	.	C	T	0	1	1	0	1	2	0	0
1	24908001	.	T	C	0	1	1	0	4	5	0	0
1	25296797	.	C	T	4	6	10	0	0	10	0	0
1	25296831	.	C	T	6	5	11	0	0	11	0	0
1	25305290	.	A	T	9	3	12	0	1	13	0	0
1	25310899	.	C	A	4	2	6	0	4	10	0	0
1	25310912	.	T	A	2	6	8	0	0	8	0	0
1	25313056	.	C	T	5	8	13	0	3	16	0	0
1	25313261	.	T	C	1	0	1	0	0	1	0	0
1	25313300	.	G	A	0	0	0	0	1	1	0	0
1	25399574	.	G	A	2	3	5	0	0	5	0	0
1	25400247	.	C	T	4	2	6	0	1	7	0	0
1	25400814	.	T	A	4	2	6	0	0	6	0	0
1	25400842	.	A	T	2	2	4	0	0	4	0	0
1	25401181	.	G	A	4	3	7	0	1	8	0	0
1	25654976	.	C	T	1	1	2	0	0	2	0	0
1	25660719	.	C	T	3	2	5	0	1	6	0	0
1	25666097	.	G	T	2	1	3	0	0	3	0	0
1	25741901	.	A	G	3	1	4	0	0	4	0	0
1	25743046	.	G	C	1	1	2	0	0	2	0	0
1	25798863	.	G	C	8	14	22	0	1	23	0	0
1	25811411	.	T	C	2	2	4	0	0	5	1	0
1	25863511	.	G	A	7	5	12	0	1	13	0	0
1	25918405	.	C	T	4	2	6	0	0	6	0	0
1	26046323	.	A	G	3	2	5	0	1	6	0	0
1	26046950	.	T	A	6	9	15	0	0	15	0	0
1	26046996	.	A	T	10	13	23	0	1	24	0	0
1	26063007	.	G	T	1	0	1	0	0	1	0	0
1	26096055	.	T	A	1	5	6	0	0	6	0	0
1	26096270	.	C	T	1	3	4	0	0	4	0	0
1	26096522	.	G	T	7	7	14	0	0	14	0	0
1	26109464	.	T	C	1	3	4	0	0	4	0	0
1	26109479	.	T	C	1	1	2	0	1	3	0	0
1	26127339	.	A	G	15	5	20	0	0	20	0	0
1	26127856	.	A	T	12	8	20	0	0	20	0	0
1	26251906	.	T	G	3	4	7	0	0	7	0	0
1	26252033	.	C	T	0	5	5	0	3	8	0	0
1	26252215	.	T	C	5	6	11	0	0	11	0	0
1	26252814	.	C	T	2	3	5	0	0	5	0	0
1	26252877	.	G	A	3	1	4	0	0	4	0	0
1	26252931	.	A	T	3	3	6	0	0	6	0	0
1	26376327	.	C	T	1	2	3	0	0	3	0	0
1	26382809	.	A	T	5	4	9	0	1	10	0	0
1	26383466	.	G	A	4	5	9	0	0	9	0	0
1	26384682	.	G	A	0	2	2	0	0	2	0	0
1	26384721	.	A	G	1	2	3	0	1	4	0	0
1	26384774	.	C	T	2	0	2	0	2	4	0	0
1	26384779	.	C	A	2	2	4	0	0	4	0	0
1	26385006	.	G	T	3	2	5	0	0	5	0	0
1	26385222	.	C	G	6	9	15	0	1	16	0	0
1	26385939	.	A	G	11	5	16	0	1	17	0	0
1	26391698	.	A	G	2	2	4	0	1	5	0	0
1	26391720	.	A	G	2	3	5	0	0	5	0	0
1	26392422	.	G	A	1	0	1	0	0	1	0	0
1	26454576	.	G	C	1	2	3	0	0	3	0	0
1	26463488	.	T	G	4	0	4	0	6	10	0	0
1	26463671	.	T	A	3	4	7	0	1	8	0	0
1	26463692	.	C	T	6	4	10	0	0	10	0	0
1	26463802	.	A	T	2	1	3	0	1	5	1	0
1	26463931	.	A	T	3	4	7	0	1	8	0	0
1	26464175	.	G	A	3	4	7	0	0	7	0	0
1	26464259	.	C	T	5	2	7	0	2	9	0	0
1	26464353	.	A	G	5	4	9	0	1	10	0	0
1	26464446	.	G	A	7	7	14	0	0	14	0	0
1	26464758	.	T	A	24	5	29	0	0	29	0	0
1	26465041	.	G	T	16	5	21	0	1	22	0	0
1	26465047	.	A	C	8	12	20	0	4	24	0	0
1	26465224	.	T	A	12	15	27	0	1	28	0	0
1	26489854	.	G	A	4	2	6	0	0	6	0	0
1	26498400	.	C	T	5	2	7	0	0	7	0	0
1	26498657	.	G	A	0	4	4	0	5	9	0	0
1	26504998	.	G	A	7	7	14	0	1	15	0	0
1	26505282	.	T	C	11	12	23	0	0	23	0	0
1	26505291	.	C	T	12	12	24	0	2	26	0	0
1	26507356	.	G	A	11	4	15	0	1	16	0	0
1	26507392	.	T	A	6	7	13	0	0	13	0	0
1	26507582	.	G	A	7	14	21	0	0	21	0	0
1	26699186	.	A	G	1	0	1	0	4	5	0	0
1	26827238	.	A	G	4	2	6	0	0	6	0	0
1	26827519	.	G	A	8	4	12	0	1	13	0	0
1	26850966	.	C	T	1	0	1	0	0	1	0	0
1	27208840	.	G	T	4	2	6	0	0	6	0	0
1	27209628	.	A	C	5	5	10	0	0	10	0	0
1	27210057	.	T	C	2	4	6	0	0	6	0	0
1	27210073	.	T	C	4	3	7	0	0	7	0	0
1	27210231	.	C	T	2	3	5	0	1	6	0	0
1	27210578	.	G	A	6	3	9	0	1	10	0	0
1	27210929	.	C	T	17	10	27	0	0	27	0	0
1	27211606	.	T	A	2	3	5	0	1	6	0	0
1	27809162	.	T	C	6	5	11	0	0	11	0	0
1	27826090	.	C	A	7	5	12	0	1	13	0	0
1	27826198	.	C	T	6	4	10	0	0	10	0	0
1	27826651	.	T	C	12	11	23	0	1	24	0	0
1	27842373	.	G	A	0	4	4	0	2	6	0	0
1	27860743	.	T	A	3	6	9	0	0	9	0	0
1	27893097	.	T	C	2	2	4	0	0	4	0	0
1	27893550	.	T	A	4	5	9	0	1	10	0	0
1	27893920	.	A	T	4	2	6	0	0	6	0	0
1	28018821	.	C	T	13	10	23	0	3	26	0	0
1	28018988	.	T	A	12	3	15	0	0	15	0	0
1	28035719	.	G	A	1	3	4	0	0	4	0	0
1	28036159	.	A	C	2	6	8	0	3	11	0	0
1	28046218	.	T	C	8	17	25	0	0	25	0	0
1	28046224	.	A	G	9	0	9	0	16	25	0	0
1	28046717	.	T	A	1	5	6	0	0	6	0	0
1	28391882	.	C	G	8	9	17	0	0	17	0	0
1	28391914	.	C	T	0	6	6	0	4	10	0	0
1	28422569	.	C	T	2	1	3	0	0	3	0	0
1	28724010	.	G	T	4	3	7	0	0	7	0	0
1	28833740	.	T	G	1	2	3	0	0	3	0	0
1	28833827	.	A	C	3	2	5	0	1	6	0	0
1	28834156	.	C	T	2	2	4	0	0	4	0	0
1	28834209	.	A	T	1	4	5	0	1	6	0	0
1	28834769	.	C	T	1	3	4	0	0	4	0	0
1	28835669	.	T	C	3	9	12	0	0	12	0	0
1	28847677	.	C	T	0	3	3	0	1	4	0	0
1	28874819	.	C	T	2	4	6	0	1	7	0	0
1	28899350	.	G	A	7	6	13	0	0	13	0	0
1	28899483	.	G	A	4	3	7	0	0	7	0	0
1	28899530	.	T	C	4	7	11	0	0	11	0	0
1	28943621	.	T	C	2	1	3	0	1	4	0	0
1	28965095	.	G	A	3	3	6	0	1	7	0	0
1	28979161	.	G	C	2	1	3	0	7	10	0	0
1	28986486	.	C	T	3	3	6	0	0	6	0	0
1	29045226	.	G	A	2	5	7	0	0	7	0	0
1	29060639	.	C	T	2	3	5	0	0	5	0	0
1	29162674	.	G	A	0	2	2	0	3	5	0	0
1	29174928	.	G	A	0	1	1	3	0	4	0	0
1	29178897	.	C	T	0	2	2	0	0	2	0	0
1	29201933	.	G	C	5	6	11	0	2	13	0	0
1	29202110	.	T	C	2	0	2	0	0	2	0	0
1	29202368	.	G	A	1	1	2	0	0	2	0	0
1	29202379	.	A	G	1	0	1	0	2	3	0	0
1	29212165	.	T	C	2	2	4	0	0	4	0	0
1	29228261	.	A	G	4	0	4	0	7	11	0	0
1	29228390	.	A	T	2	4	6	0	0	6	0	0
1	29270712	.	C	T	0	3	3	0	2	5	0	0
1	29270942	.	C	T	4	3	7	0	0	7	0	0
1	29608585	.	T	C	1	2	3	0	0	3	0	0
1	29752319	.	T	C	4	6	10	0	1	11	0	0
1	29752421	.	A	G	2	8	10	0	0	10	0	0
1	29754673	.	A	G	4	2	6	0	0	6	0	0
1	29754963	.	G	A	1	3	4	0	0	4	0	0
1	29772391	.	A	G	4	2	6	0	0	6	0	0
1	29772741	.	C	T	0	4	4	0	0	4	0	0
1	29775664	.	C	A	3	5	8	0	1	9	0	0
1	29779300	.	G	C	4	2	6	0	1	7	0	0
1	29779402	.	G	A	0	5	5	0	7	12	0	0
1	29781462	.	G	A	3	2	5	0	0	5	0	0
1	29781597	.	A	T	3	4	7	0	0	7	0	0
1	29786704	.	A	G	6	4	10	0	0	10	0	0
1	29787397	.	G	A	8	7	15	0	0	15	0	0
1	29789889	.	C	T	8	10	18	0	0	18	0	0
1	29790030	.	A	T	10	11	21	0	1	22	0	0
1	29795692	.	G	A	17	8	25	0	1	26	0	0
1	29797191	.	T	C	1	2	3	0	1	4	0	0
1	29797344	.	G	T	10	15	25	0	1	26	0	0
1	29797345	.	A	T	11	14	25	0	1	26	0	0
1	29797387	.	A	C	10	16	26	0	0	26	0	0
1	29797699	.	T	G	5	7	12	0	0	12	0	0
1	29817451	.	C	A	2	2	4	0	0	4	0	0
1	29820831	.	C	T	13	23	36	0	2	38	0	0
1	29823603	.	T	C	16	14	30	0	2	32	0	0
1	29823690	.	T	A	15	22	37	0	2	39	0	0
1	29823701	.	A	G	17	20	37	0	2	39	0	0
1	29858300	.	A	T	1	3	4	0	0	4	0	0
1	29860326	.	T	A	4	3	7	0	0	7	0	0
1	29891910	.	C	A	1	2	3	0	0	3	0	0
1	29916178	.	G	A	3	5	8	0	0	8	0	0
1	29952918	.	A	T	5	3	8	0	0	8	0	0
1	29953069	.	G	A	5	4	9	0	1	10	0	0
1	29953239	.	G	T	0	12	12	0	12	24	0	0
1	29953433	.	A	T	4	4	8	0	1	9	0	0
1	29954795	.	A	C	5	5	10	0	0	10	0	0
1	29954972	.	C	T	6	9	15	0	1	16	0	0
1	29955006	.	G	A	7	6	13	0	2	15	0	0
1	29955171	.	G	A	9	8	17	0	0	17	0	0
1	29955179	.	A	G	8	9	17	0	0	17	0	0
1	29955228	.	C	T	5	0	5	0	0	5	0	0
1	29955249	.	A	G	0	1	1	0	0	1	0	0
1	30038844	.	A	C	1	4	5	0	0	5	0	0
1	30039302	.	T	A	1	2	3	0	0	3	0	0
1	30180924	.	G	A	0	1	1	0	0	1	0	0
1	30183309	.	C	G	1	2	3	0	0	3	0	0
1	30212461	.	G	A	2	3	5	0	1	6	0	0
1	30212793	.	G	A	0	0	0	0	1	1	0	0
1	30250557	.	T	C	4	2	6	0	0	6	0	0
1	30255365	.	G	A	6	9	15	0	3	18	0	0
1	30255458	.	A	C	1	3	4	0	3	7	0	0
1	30282841	.	G	T	1	1	2	0	0	2	0	0
1	30343967	.	T	G	8	18	26	0	1	27	0	0
1	30344842	.	A	G	6	10	16	0	0	16	0	0
1	30345026	.	T	C	6	5	11	0	1	12	0	0
1	30345029	.	C	T	6	7	13	0	0	13	0	0
1	30345075	.	G	T	4	10	14	0	0	14	0	0
1	30345131	.	C	T	0	3	3	0	4	7	0	0
1	30345531	.	A	G	3	2	5	0	0	5	0	0
1	30345635	.	T	G	2	8	10	0	0	10	0	0
1	30345838	.	C	T	3	0	3	0	0	3	0	0
1	30345839	.	C	T	3	0	3	0	0	3	0	0
1	30345901	.	C	T	2	1	3	0	0	3	0	0
1	30345925	.	G	A	3	2	5	0	1	6	0	0
1	30345948	.	C	T	0	5	5	0	3	8	0	0
1	30346042	.	G	A	2	2	4	0	0	4	0	0
1	30346112	.	T	C	1	6	7	0	0	7	0	0
1	30346124	.	T	A	0	5	5	0	0	5	0	0
1	30346233	.	G	A	4	3	7	0	0	7	0	0
1	30346377	.	G	A	2	3	5	0	0	5	0	0
1	30346385	.	G	A	3	2	5	0	0	5	0	0
1	30346432	.	T	G	2	4	6	0	0	6	0	0
1	30346456	.	G	A	4	3	7	0	0	7	0	0
1	30346845	.	G	T	2	5	7	0	1	8	0	0
1	30346906	.	C	A	3	7	10	0	0	10	0	0
1	30346977	.	C	A	9	7	16	0	0	16	0	0
1	30347027	.	C	A	7	7	14	0	1	15	0	0
1	30347586	.	C	T	3	3	6	0	0	6	0	0
1	30439970	.	C	T	1	2	3	0	0	3	0	0
1	30440286	.	T	A	1	2	3	0	0	3	0	0
1	30441057	.	G	A	2	2	4	0	0	4	0	0
1	30540065	.	G	A	1	2	3	0	0	3	0	0
1	30540092	.	T	A	2	3	5	0	0	5	0	0
1	30540535	.	C	T	3	4	7	0	0	7	0	0
1	30688453	.	G	A	1	2	3	0	0	3	0	0
1	30688606	.	C	T	0	3	3	0	0	3	0	0
1	30688901	.	G	A	1	3	4	0	1	5	0	0
1	30688924	.	G	T	2	2	4	0	0	4	0	0
1	30718463	.	T	A	2	4	6	0	1	7	0	0
1	30718538	.	C	G	6	6	12	0	0	12	0	0
1	30718567	.	A	C	2	0	2	0	4	6	0	0
1	30736625	.	A	G	1	2	3	0	1	4	0	0
1	31061337	.	G	T	1	0	1	0	0	1	0	0
1	31063707	.	C	A	1	2	3	0	0	3	0	0
1	31072348	.	A	C	3	7	10	0	1	11	0	0
1	31072843	.	C	T	1	2	3	0	0	3	0	0
1	31072863	.	A	G	1	1	2	0	0	2	0	0
1	31075158	.	C	T	0	1	1	0	2	3	0	0
1	31083271	.	G	A	2	4	6	0	0	6	0	0
1	31112466	.	G	C	2	3	5	0	0	5	0	0
1	31112468	.	G	A	2	2	4	0	1	5	0	0
1	31117686	.	G	A	18	9	27	0	7	34	0	0
1	31117695	.	T	C	17	13	30	0	1	31	0	0
1	31119296	.	C	T	16	20	36	0	1	37	0	0
1	31122596	.	G	A	23	30	53	0	5	58	0	0
1	31130005	.	T	C	30	17	47	0	0	47	0	0
1	31130028	.	T	C	22	22	44	0	2	46	0	0
1	31130094	.	G	A	0	21	21	0	22	43	0	0
1	31130176	.	T	C	7	10	17	0	0	17	0	0
1	31136018	.	G	A	4	10	14	0	0	14	0	0
1	31136477	.	A	G	1	4	5	0	2	7	0	0
1	31374780	.	A	T	12	9	21	0	2	23	0	0
1	31386255	.	T	C	9	3	12	0	1	13	0	0
1	31423014	.	C	T	0	2	2	0	4	6	0	0
1	31428150	.	G	A	4	2	6	0	0	6	0	0
1	31445770	.	A	G	7	4	11	0	0	11	0	0
1	31472033	.	A	G	2	3	5	0	1	6	0	0
1	31661165	.	T	C	1	2	3	0	0	3	0	0
1	31667491	.	C	T	2	2	4	0	1	5	0	0
1	31671721	.	C	T	6	5	11	0	0	11	0	0
1	31671746	.	C	A	7	8	15	0	0	15	0	0
1	31671958	.	G	A	0	5	5	0	4	9	0	0
1	31793998	.	A	G	2	2	4	0	0	4	0	0
1	31797459	.	G	A	3	5	8	0	2	10	0	0
1	31797488	.	C	T	1	2	3	0	0	3	0	0
1	31797597	.	G	A	1	6	7	0	0	7	0	0
1	31798507	.	C	A	0	3	3	0	0	3	0	0
1	31798794	.	T	C	3	3	6	0	2	8	0	0
1	31798821	.	C	T	4	4	8	0	1	9	0	0
1	31798974	.	G	C	4	5	9	0	2	11	0	0
1	31798980	.	C	T	5	6	11	0	1	12	0	0
1	31799112	.	C	A	1	5	6	0	0	6	0	0
1	31799313	.	A	G	1	2	3	0	0	3	0	0
1	31809184	.	A	T	1	5	6	0	1	7	0	0
1	31809302	.	G	A	3	4	7	0	2	9	0	0
1	31809332	.	G	A	2	3	5	0	0	5	0	0
1	31813283	.	A	G	6	3	9	0	0	9	0	0
1	31813355	.	T	C	1	1	2	0	0	2	0	0
1	31865387	.	G	A	5	2	7	0	0	7	0	0
1	31866684	.	G	A	0	2	2	0	0	2	0	0
1	31867264	.	T	A	9	13	22	0	1	23	0	0
1	31867314	.	C	T	12	4	16	0	0	16	0	0
1	31867449	.	C	T	9	3	12	0	4	16	0	0
1	31867589	.	G	A	6	1	7	0	2	9	0	0
1	33384062	.	G	A	3	5	8	0	0	8	0	0
1	33449334	.	C	A	0	1	1	0	0	1	0	0
1	33457733	.	C	T	7	4	11	0	0	11	0	0
1	33484129	.	C	G	8	11	19	0	0	19	0	0
1	33484288	.	T	C	9	10	19	0	2	21	0	0
1	33484293	.	C	A	6	10	16	0	3	19	0	0
1	33484354	.	G	A	8	4	12	0	1	13	0	0
1	33484364	.	G	A	7	4	11	0	0	11	0	0
1	33484404	.	C	T	8	4	12	0	1	13	0	0
1	33484652	.	T	C	13	11	24	0	0	24	0	0
1	33485692	.	A	G	8	0	8	0	21	29	0	0
1	33548282	.	A	T	3	4	7	0	5	12	0	0
1	33556056	.	G	A	1	6	7	0	0	7	0	0
1	33561520	.	A	G	3	0	3	0	5	8	0	0
1	33561544	.	C	T	7	10	17	0	0	17	0	0
1	33568153	.	A	T	13	11	24	0	2	26	0	0
1	33568211	.	A	G	7	0	7	0	11	18	0	0
1	33568266	.	G	A	1	7	8	0	1	9	0	0
1	33568303	.	G	A	0	3	3	0	7	10	0	0
1	33568454	.	G	T	6	11	17	0	0	17	0	0
1	33568520	.	G	A	7	9	16	0	0	16	0	0
1	33568836	.	T	G	0	24	24	0	1	25	0	0
1	33568976	.	G	T	0	12	12	0	15	27	0	0
1	33657793	.	A	G	3	2	5	0	0	5	0	0
1	33657904	.	G	A	0	3	3	0	3	6	0	0
1	33658030	.	G	A	0	4	4	0	4	8	0	0
1	33658065	.	T	G	2	3	5	0	0	5	0	0
1	33658852	.	C	A	4	5	9	0	0	9	0	0
1	33658971	.	C	T	2	8	10	0	0	10	0	0
1	33659374	.	C	T	1	1	2	0	0	2	0	0
1	33686477	.	G	A	2	2	4	0	0	4	0	0
1	33686513	.	G	T	7	6	13	0	0	13	0	0
1	33687177	.	A	T	4	9	13	0	2	15	0	0
1	33693919	.	C	A	4	4	8	0	1	9	0	0
1	33694165	.	A	T	3	2	5	0	1	6	0	0
1	33694198	.	T	A	5	4	9	0	0	9	0	0
1	33694327	.	C	T	6	4	10	0	0	10	0	0
1	33694357	.	T	A	3	8	11	0	0	11	0	0
1	33694517	.	T	A	1	3	4	0	0	4	0	0
1	33701368	.	C	T	0	1	1	0	0	1	0	0
1	33701445	.	C	T	2	1	3	0	0	3	0	0
1	34043394	.	T	C	2	4	6	0	0	6	0	0
1	34137711	.	T	C	2	3	5	0	1	6	0	0
1	34137741	.	T	C	3	3	6	0	0	6	0	0
1	34176808	.	A	T	1	1	2	0	0	2	0	0
1	34182333	.	C	T	1	3	4	0	0	4	0	0
1	34199906	.	G	T	23	20	43	0	2	45	0	0
1	34199913	.	C	T	24	24	48	0	2	50	0	0
1	34232407	.	A	G	7	4	11	0	1	12	0	0
1	34232514	.	G	A	3	5	8	0	1	9	0	0
1	34232551	.	A	C	5	8	13	0	1	14	0	0
1	34232744	.	T	A	8	12	20	0	3	23	0	0
1	34232761	.	A	G	11	13	24	0	0	24	0	0
1	34232879	.	T	C	10	10	20	0	1	21	0	0
1	34232929	.	C	T	11	7	18	0	0	18	0	0
1	34232931	.	G	A	10	7	17	0	1	18	0	0
1	34233096	.	C	A	11	6	17	0	1	18	0	0
1	34233145	.	G	T	10	5	15	0	2	17	0	0
1	34233198	.	C	A	3	7	10	0	1	11	0	0
1	34233238	.	A	G	7	8	15	0	2	17	0	0
1	34233301	.	A	G	7	0	7	0	10	17	0	0
1	34233312	.	A	G	9	6	15	0	0	15	0	0
1	34258971	.	C	T	3	4	7	0	0	7	0	0
1	34259452	.	T	A	4	3	7	0	1	8	0	0
1	34259863	.	T	G	2	2	4	0	0	4	0	0
1	34260012	.	G	C	2	2	4	0	0	4	0	0
1	34260914	.	C	T	2	4	6	0	1	7	0	0
1	34261230	.	A	T	7	12	19	0	2	21	0	0
1	34261393	.	G	A	0	9	9	0	15	24	0	0
1	34296606	.	A	T	5	10	15	0	1	16	0	0
1	34297112	.	C	A	7	3	10	0	1	11	0	0
1	34297135	.	C	T	3	9	12	0	0	12	0	0
1	34297336	.	T	A	3	1	4	0	1	5	0	0
1	34540714	.	G	A	0	2	2	0	1	3	0	0
1	34540750	.	G	T	1	2	3	0	1	4	0	0
1	34555559	.	C	T	5	5	10	0	0	10	0	0
1	34556241	.	A	C	4	5	9	0	1	10	0	0
1	34556298	.	G	A	0	4	4	0	7	11	0	0
1	34556301	.	G	T	0	5	5	0	6	11	0	0
1	34679431	.	A	G	3	0	3	0	1	4	0	0
1	34683238	.	T	G	1	1	2	0	0	2	0	0
1	34683302	.	C	T	1	0	1	0	1	2	0	0
1	34685529	.	C	G	4	2	6	0	0	6	0	0
1	34685603	.	A	G	2	0	2	0	0	2	0	0
1	34693831	.	C	T	6	6	12	0	2	14	0	0
1	34695423	.	G	A	6	9	15	0	0	15	0	0
1	34695476	.	G	A	7	7	14	0	0	14	0	0
1	34696017	.	G	A	3	3	6	0	0	6	0	0
1	34703048	.	T	A	6	2	8	0	0	8	0	0
1	34703272	.	A	G	1	2	3	0	0	3	0	0
1	34706526	.	G	A	7	7	14	0	1	15	0	0
1	34706773	.	A	G	1	2	3	0	0	3	0	0
1	34707958	.	T	C	5	10	15	0	2	17	0	0
1	34708145	.	C	T	2	21	23	0	34	57	0	0
1	34712097	.	A	G	3	2	5	0	0	5	0	0
1	35481768	.	T	C	0	2	2	0	0	2	0	0
1	35484358	.	C	T	4	2	6	0	0	6	0	0
1	35484931	.	T	C	2	3	5	0	0	5	0	0
1	35484977	.	A	T	1	5	6	0	0	6	0	0
1	35485056	.	G	A	6	5	11	0	0	11	0	0
1	35485105	.	G	A	0	6	6	0	1	7	0	0
1	35485175	.	A	C	5	5	10	0	0	10	0	0
1	35485263	.	C	A	0	3	3	0	0	3	0	0
1	35485289	.	C	T	4	3	7	0	0	7	0	0
1	35485378	.	C	T	3	3	6	0	4	10	0	0
1	35488211	.	A	T	9	4	13	0	0	13	0	0
1	35488332	.	G	A	1	3	4	0	1	5	0	0
1	35607830	.	G	A	4	3	7	0	0	7	0	0
1	35608041	.	G	A	0	2	2	0	2	4	0	0
1	35608308	.	C	T	2	4	6	0	0	6	0	0
1	35608381	.	T	C	2	2	4	0	0	4	0	0
1	35608941	.	A	C	4	3	7	0	0	7	0	0
1	35609192	.	A	G	2	3	5	0	1	6	0	0
1	35609431	.	T	C	7	4	11	0	0	11	0	0
1	35609474	.	G	A	3	6	9	0	1	10	0	0
1	35811779	.	C	A	2	1	3	0	0	3	0	0
1	35811854	.	C	T	1	5	6	0	0	6	0	0
1	35815706	.	A	C	0	0	0	0	1	1	0	0
1	35834554	.	G	T	2	7	9	0	0	9	0	0
1	35835237	.	G	A	0	5	5	0	10	15	0	0
1	35835371	.	A	C	7	19	26	0	1	27	0	0
1	35835502	.	C	T	10	7	17	0	0	17	0	0
1	35949933	.	A	C	2	3	5	0	0	5	0	0
1	35949934	.	T	A	2	3	5	0	0	5	0	0
1	35950082	.	T	G	2	2	4	0	1	5	0	0
1	35950100	.	T	G	2	3	5	0	0	5	0	0
1	35956508	.	C	G	1	3	4	0	0	4	0	0
1	35959826	.	T	C	1	1	2	0	0	2	0	0
1	35963306	.	G	A	0	1	1	0	5	6	0	0
1	35963822	.	C	T	7	7	14	0	0	14	0	0
1	35969716	.	G	A	7	3	10	0	0	10	0	0
1	35969836	.	G	C	12	9	21	0	1	22	0	0
1	35969878	.	C	T	15	11	26	0	3	29	0	0
1	36018610	.	T	A	8	8	16	0	0	16	0	0
1	36018817	.	T	C	10	1	11	0	7	18	0	0
1	36019227	.	C	T	10	7	17	0	3	20	0	0
1	36019361	.	T	C	10	0	10	0	17	27	0	0
1	36019416	.	G	T	13	15	28	0	3	31	0	0
1	36020154	.	T	C	2	2	4	0	0	4	0	0
1	36020175	.	T	C	0	8	8	0	0	8	0	0
1	36020492	.	T	G	4	4	8	0	4	12	0	0
1	36021158	.	C	G	4	3	7	0	0	7	0	0
1	36021399	.	A	G	14	3	17	0	4	21	0	0
1	36057147	.	G	A	0	2	2	0	0	2	0	0
1	36078513	.	G	A	1	3	4	0	1	5	0	0
1	36105117	.	C	T	2	5	7	0	0	7	0	0
1	36119106	.	A	G	1	2	3	0	0	3	0	0
1	36194799	.	G	T	0	0	0	0	2	2	0	0
1	36200014	.	C	T	2	2	4	0	0	4	0	0
1	36438671	.	T	A	18	12	30	0	1	31	0	0
1	36438882	.	T	A	15	23	38	0	2	40	0	0
1	36439186	.	T	A	10	10	20	0	4	24	0	0
1	36439204	.	G	T	10	12	22	0	0	22	0	0
1	36439248	.	G	A	6	19	25	0	0	25	0	0
1	36439380	.	G	T	17	16	33	0	1	34	0	0
1	36701999	.	C	T	4	6	10	0	1	11	0	0
1	36735123	.	C	T	1	1	2	0	0	2	0	0
1	36738356	.	C	T	0	2	2	0	0	2	0	0
1	36738574	.	C	A	1	3	4	0	0	4	0	0
1	36738595	.	A	T	1	4	5	0	0	5	0	0
1	36738810	.	C	T	2	4	6	0	0	6	0	0
1	36739124	.	G	A	0	2	2	0	4	6	0	0
1	36740359	.	C	A	1	0	1	0	0	1	0	0
1	36740365	.	T	G	1	0	1	0	0	1	0	0
1	36740404	.	G	A	2	2	4	0	0	4	0	0
1	36740439	.	T	C	2	2	4	0	0	4	0	0
1	36740961	.	G	T	0	3	3	0	7	10	0	0
1	36741087	.	T	A	4	6	10	0	0	10	0	0
1	36741110	.	G	T	1	5	6	0	0	6	0	0
1	36741149	.	A	C	4	0	4	0	0	4	0	0
1	36741396	.	T	G	5	2	7	0	1	8	0	0
1	36741422	.	A	C	3	2	5	0	0	5	0	0
1	36741581	.	C	T	8	3	11	0	1	12	0	0
1	36741602	.	A	C	9	1	10	0	1	11	0	0
1	36741796	.	T	G	6	4	10	0	0	10	0	0
1	36741863	.	A	C	3	6	9	0	1	10	0	0
1	36742139	.	T	A	3	2	5	0	0	5	0	0
1	36742158	.	T	A	3	2	5	0	0	5	0	0
1	36746225	.	A	T	6	4	10	0	0	10	0	0
1	36755165	.	G	T	2	5	7	0	1	8	0	0
1	36755327	.	C	T	2	5	7	0	0	7	0	0
1	36755693	.	G	A	4	3	7	0	0	7	0	0
1	36761757	.	A	G	3	2	5	0	0	5	0	0
1	36771622	.	A	C	1	2	3	0	0	3	0	0
1	36887880	.	C	A	2	2	4	0	1	5	0	0
1	36903175	.	T	A	1	4	5	0	0	5	0	0
1	36911491	.	A	C	2	1	3	0	0	3	0	0
1	36911788	.	G	A	0	3	3	0	1	4	0	0
1	36911932	.	C	G	1	4	5	0	0	5	0	0
1	36912176	.	G	A	4	6	10	0	1	11	0	0
1	36935559	.	T	C	2	1	3	0	0	3	0	0
1	37083319	.	G	A	1	2	3	0	0	3	0	0
1	37195941	.	T	A	1	1	2	0	1	3	0	0
1	37195950	.	G	A	1	2	3	0	0	3	0	0
1	37212331	.	C	T	1	1	2	0	0	2	0	0
1	37284382	.	C	T	0	1	1	0	0	1	0	0
1	37287291	.	A	T	1	0	1	0	1	2	0	0
1	37287294	.	G	A	1	2	3	0	0	3	0	0
1	37291884	.	A	C	1	1	2	0	0	2	0	0
1	37304354	.	C	A	10	8	18	0	0	18	0	0
1	37304439	.	C	T	16	8	24	0	0	24	0	0
1	37304494	.	T	A	10	5	15	0	2	17	0	0
1	37304510	.	T	G	9	5	14	0	0	14	0	0
1	37304536	.	G	A	9	5	14	0	0	14	0	0
1	37304873	.	A	T	2	3	5	0	1	6	0	0
1	37305148	.	C	T	6	4	10	0	0	10	0	0
1	37305236	.	A	G	0	5	5	0	0	5	0	0
1	37305260	.	A	G	0	2	2	0	0	2	0	0
1	37306726	.	G	T	1	16	17	0	15	32	0	0
1	37306913	.	T	A	10	13	23	0	1	24	0	0
1	37306942	.	A	C	9	15	24	0	2	26	0	0
1	37344832	.	T	C	3	3	6	0	0	6	0	0
1	37353355	.	C	T	4	3	7	0	0	7	0	0
1	37355591	.	G	A	2	2	4	0	0	4	0	0
1	37359071	.	C	T	1	4	5	0	0	5	0	0
1	37361554	.	A	G	5	4	9	0	3	12	0	0
1	37361759	.	C	T	9	6	15	0	1	16	0	0
1	37361879	.	T	A	1	5	6	0	2	8	0	0
1	37361919	.	T	C	1	8	9	0	0	9	0	0
1	37361960	.	C	T	4	5	9	0	0	9	0	0
1	37417925	.	C	T	1	2	3	0	0	3	0	0
1	38125431	.	C	A	3	12	15	0	1	16	0	0
1	38125684	.	T	C	5	7	12	0	0	12	0	0
1	38131058	.	C	T	9	13	22	0	2	24	0	0
1	38131073	.	T	C	11	12	23	0	1	24	0	0
1	38131094	.	G	A	10	16	26	0	1	27	0	0
1	38131288	.	G	A	14	17	31	0	3	34	0	0
1	38131360	.	G	A	9	31	40	0	2	42	0	0
1	38131486	.	G	A	18	13	31	0	2	33	0	0
1	38131812	.	T	C	4	2	6	0	1	7	0	0
1	38132245	.	A	C	1	3	4	0	1	5	0	0
1	38132254	.	A	C	1	2	3	0	0	3	0	0
1	38163017	.	C	T	4	3	7	0	0	7	0	0
1	38163132	.	G	A	1	1	2	0	1	3	0	0
1	38166009	.	G	C	14	7	21	0	0	21	0	0
1	38166268	.	A	C	15	12	27	0	4	31	0	0
1	38166429	.	T	C	19	18	37	0	3	40	0	0
1	38166431	.	T	G	19	17	36	0	4	40	0	0
1	38166520	.	A	G	23	18	41	0	1	42	0	0
1	38169771	.	T	A	10	6	16	0	0	16	0	0
1	38169972	.	T	G	26	12	38	0	1	39	0	0
1	38170553	.	G	A	2	1	3	0	0	3	0	0
1	38346162	.	C	T	0	7	7	0	3	10	0	0
1	38346578	.	G	T	4	5	9	0	0	9	0	0
1	38346739	.	G	A	2	3	5	0	1	6	0	0
1	38416352	.	G	C	1	5	6	0	3	9	0	0
1	38416477	.	G	A	7	6	13	0	0	13	0	0
1	38416536	.	A	G	6	4	10	0	0	10	0	0
1	38417229	.	G	A	3	5	8	0	0	8	0	0
1	38417268	.	A	T	3	7	10	0	1	11	0	0
1	38417332	.	A	G	4	8	12	0	1	13	0	0
1	38417370	.	G	A	5	4	9	0	2	11	0	0
1	38417571	.	G	T	3	9	12	0	1	13	0	0
1	38417588	.	T	G	6	3	9	0	2	11	0	0
1	38417617	.	A	T	3	3	6	0	0	6	0	0
1	38417625	.	A	T	1	2	3	0	1	4	0	0
1	38417680	.	T	A	1	3	4	0	0	4	0	0
1	38417757	.	G	A	2	2	4	0	0	4	0	0
1	38417758	.	T	C	2	2	4	0	0	4	0	0
1	38418087	.	C	T	7	2	9	0	1	10	0	0
1	38418294	.	G	T	5	3	8	0	0	8	0	0
1	38466714	.	G	A	1	5	6	0	0	6	0	0
1	38649340	.	A	G	35	30	65	0	2	67	0	0
1	38649947	.	G	A	33	33	66	0	4	70	0	0
1	38650132	.	G	T	25	32	57	0	3	60	0	0
1	38650298	.	G	A	29	25	54	0	2	56	0	0
1	38650382	.	G	C	32	25	57	0	5	62	0	0
1	38650467	.	A	G	25	28	53	0	7	60	0	0
1	38650510	.	G	C	23	33	56	0	5	61	0	0
1	38650516	.	T	C	24	35	59	0	5	64	0	0
1	38650545	.	T	C	30	36	66	0	4	70	0	0
1	38651063	.	G	T	31	24	55	0	4	59	0	0
1	38651065	.	T	A	29	25	54	0	5	59	0	0
1	38651361	.	C	T	4	13	17	0	2	19	0	0
1	38651370	.	G	A	3	17	20	0	2	22	0	0
1	38651469	.	C	A	13	14	27	0	1	28	0	0
1	38651822	.	G	A	4	2	6	0	3	9	0	0
1	38657689	.	G	A	2	3	5	0	1	6	0	0
1	38660252	.	A	G	21	14	35	0	2	37	0	0
1	38660369	.	G	A	1	0	1	0	1	2	0	0
1	38775141	.	G	A	1	2	3	0	0	3	0	0
1	38775142	.	G	A	1	2	3	0	0	3	0	0
1	38787039	.	C	T	0	1	1	0	1	2	0	0
1	38791569	.	C	T	0	3	3	0	0	3	0	0
1	38797663	.	A	C	2	4	6	0	1	7	0	0
1	38799513	.	G	A	1	0	1	0	0	1	0	0
1	38799585	.	A	G	3	3	6	0	1	7	0	0
1	38799588	.	T	A	3	4	7	0	0	7	0	0
1	38802537	.	G	A	5	12	17	0	1	18	0	0
1	38802703	.	A	G	11	15	26	0	2	28	0	0
1	38802718	.	G	A	14	11	25	0	6	31	0	0
1	38802855	.	C	A	7	15	22	0	0	22	0	0
1	38803033	.	T	C	9	3	12	0	0	12	0	0
1	38803042	.	A	C	7	2	9	0	1	10	0	0
1	38803127	.	C	T	5	4	9	0	1	10	0	0
1	38803154	.	T	A	6	5	11	0	4	15	0	0
1	38803205	.	A	T	6	14	20	0	3	23	0	0
1	38805439	.	G	A	18	13	31	0	1	32	0	0
1	38805450	.	A	G	18	16	34	0	0	34	0	0
1	38805506	.	G	A	19	15	34	0	0	34	0	0
1	38807255	.	G	C	0	2	2	0	1	3	0	0
1	38808259	.	C	A	0	2	2	0	0	2	0	0
1	38808379	.	C	T	0	2	2	0	2	4	0	0
1	38808723	.	T	A	7	7	14	0	1	15	0	0
1	38820219	.	G	A	0	6	6	0	3	9	0	0
1	38822092	.	A	T	8	7	15	0	1	16	0	0
1	38851111	.	C	T	0	2	2	0	2	4	0	0
1	38851225	.	C	T	2	1	3	0	0	3	0	0
1	39770416	.	C	T	2	3	5	0	2	7	0	0
1	39771429	.	T	A	5	3	8	0	1	9	0	0
1	39772010	.	T	C	1	3	4	0	0	4	0	0
1	39772042	.	A	G	3	3	6	0	1	7	0	0
1	39772225	.	C	T	3	5	8	0	1	9	0	0
1	39774096	.	C	T	2	3	5	0	0	5	0	0
1	39774225	.	C	T	13	3	16	0	0	16	0	0
1	39774363	.	G	A	3	5	8	0	0	8	0	0
1	39774618	.	A	G	8	4	12	0	2	14	0	0
1	39774690	.	A	G	4	5	9	0	0	9	0	0
1	39774727	.	C	A	2	2	4	0	1	5	0	0
1	39774891	.	C	T	7	9	16	0	1	17	0	0
1	39774915	.	G	A	11	8	19	0	1	20	0	0
1	39775089	.	C	T	4	9	13	0	2	15	0	0
1	39775131	.	C	T	9	7	16	0	0	16	0	0
1	39775227	.	C	T	5	9	14	0	0	14	0	0
1	39776356	.	A	C	14	13	27	0	4	31	0	0
1	39777089	.	G	A	11	15	26	0	5	31	0	0
1	39777836	.	G	A	0	13	13	0	9	22	0	0
1	39777975	.	A	T	8	9	17	0	4	21	0	0
1	39778075	.	T	G	15	12	27	0	1	28	0	0
1	39778332	.	G	C	19	24	43	0	1	44	0	0
1	39778661	.	G	A	4	17	21	0	2	23	0	0
1	39778663	.	G	A	5	18	23	0	0	23	0	0
1	39778949	.	G	C	16	16	32	0	4	36	0	0
1	39779225	.	G	C	3	15	18	0	3	21	0	0
1	39779468	.	A	T	7	2	9	0	1	10	0	0
1	39869860	.	T	A	2	3	5	0	0	5	0	0
1	39869917	.	T	A	4	3	7	0	0	7	0	0
1	39869974	.	G	A	5	2	7	0	0	7	0	0
1	39870008	.	T	C	3	3	6	0	0	6	0	0
1	39882065	.	A	G	1	2	3	0	0	3	0	0
1	39882764	.	A	T	2	6	8	0	0	8	0	0
1	39882899	.	A	G	4	3	7	0	0	7	0	0
1	39882906	.	T	A	1	4	5	0	1	6	0	0
1	39883259	.	C	G	1	3	4	0	1	5	0	0
1	39899477	.	G	C	18	22	40	0	4	44	0	0
1	39899494	.	A	G	24	18	42	0	4	46	0	0
1	39899663	.	G	A	22	26	48	0	3	51	0	0
1	39900056	.	G	A	23	21	44	0	4	48	0	0
1	39900129	.	G	A	21	22	43	0	2	45	0	0
1	39900137	.	G	T	20	20	40	0	0	40	0	0
1	39900360	.	G	A	15	5	20	0	3	23	0	0
1	39900750	.	C	T	0	5	5	0	12	17	0	0
1	39901269	.	G	A	3	2	5	0	0	5	0	0
1	39901378	.	T	A	5	6	11	0	0	11	0	0
1	39901500	.	T	C	3	4	7	0	0	7	0	0
1	39901501	.	G	A	3	4	7	0	0	7	0	0
1	39907291	.	A	C	5	3	8	0	0	8	0	0
1	39908047	.	G	A	4	6	10	0	2	12	0	0
1	39908680	.	C	T	3	5	8	0	0	8	0	0
1	39908854	.	A	G	4	6	10	0	1	11	0	0
1	39908881	.	C	T	4	6	10	0	0	10	0	0
1	39908926	.	A	G	3	2	5	0	0	5	0	0
1	39909003	.	A	T	2	5	7	0	0	7	0	0
1	39909247	.	A	T	7	6	13	0	2	15	0	0
1	39909274	.	A	T	6	3	9	0	0	9	0	0
1	39981794	.	A	G	6	3	9	0	2	11	0	0
1	39995100	.	C	T	6	3	9	0	0	9	0	0
1	39998875	.	G	A	4	11	15	0	2	17	0	0
1	40001853	.	A	T	4	6	10	0	0	10	0	0
1	40001873	.	C	A	3	3	6	0	0	6	0	0
1	40002113	.	G	A	5	8	13	0	0	13	0	0
1	40002148	.	C	G	4	5	9	0	0	9	0	0
1	40008905	.	T	C	16	19	35	0	0	35	0	0
1	40008906	.	G	A	16	18	34	0	1	35	0	0
1	40009227	.	T	A	16	16	32	0	0	32	0	0
1	40009258	.	C	T	8	16	24	0	6	30	0	0
1	40009291	.	A	G	10	13	23	0	2	25	0	0
1	40009382	.	G	A	19	13	32	0	3	35	0	0
1	40009526	.	T	C	4	5	9	0	0	9	0	0
1	40009625	.	T	C	9	9	18	0	1	19	0	0
1	40009671	.	C	A	11	7	18	0	0	18	0	0
1	40009697	.	C	T	8	6	14	0	0	14	0	0
1	40009778	.	C	T	1	2	3	0	0	3	0	0
1	40009779	.	G	A	0	2	2	0	1	3	0	0
1	40015189	.	A	G	8	7	15	0	0	16	1	0
1	40015219	.	C	T	4	8	12	0	2	14	0	0
1	40015265	.	C	T	0	2	2	0	0	2	0	0
1	40015553	.	A	G	0	2	2	0	0	2	0	0
1	40015697	.	A	G	6	8	14	0	0	14	0	0
1	40028424	.	C	T	2	3	5	0	0	5	0	0
1	40028680	.	G	A	2	1	3	0	1	4	0	0
1	40041528	.	C	T	0	1	1	0	0	1	0	0
1	40044562	.	G	A	1	6	7	0	0	7	0	0
1	40044578	.	C	T	5	1	6	0	0	6	0	0
1	40046859	.	G	A	1	0	1	0	0	1	0	0
1	40047070	.	T	A	1	0	1	0	0	1	0	0
1	40051918	.	T	C	6	11	17	0	0	17	0	0
1	40051923	.	G	C	6	11	17	0	1	18	0	0
1	40051988	.	G	C	0	2	2	0	13	15	0	0
1	40052033	.	A	G	4	8	12	0	2	14	0	0
1	40052066	.	G	C	6	9	15	0	2	17	0	0
1	40052083	.	G	A	9	11	20	0	1	21	0	0
1	40052481	.	A	C	6	12	18	0	0	18	0	0
1	40052550	.	A	C	7	7	14	0	1	15	0	0
1	40052562	.	A	G	6	7	13	0	0	13	0	0
1	40052965	.	T	A	1	7	8	0	0	8	0	0
1	40057483	.	C	T	2	2	4	0	0	4	0	0
1	40057604	.	A	G	1	3	4	0	0	4	0	0
1	40057805	.	C	T	4	2	6	0	0	6	0	0
1	40060968	.	A	C	1	2	3	0	0	3	0	0
1	40060992	.	C	T	0	2	2	0	2	4	0	0
1	40107874	.	T	G	2	4	6	0	0	6	0	0
1	40107961	.	C	T	1	2	3	0	0	3	0	0
1	40111679	.	C	G	13	8	21	0	0	21	0	0
1	40111702	.	T	G	12	10	22	0	1	23	0	0
1	40111737	.	A	C	9	7	16	0	0	16	0	0
1	40111738	.	G	A	8	6	14	0	2	16	0	0
1	40111776	.	C	T	6	9	15	0	0	15	0	0
1	40111918	.	C	T	5	14	19	0	5	24	0	0
1	40112347	.	C	T	2	6	8	0	1	9	0	0
1	40112410	.	C	T	5	6	11	0	2	13	0	0
1	40112499	.	T	C	4	3	7	0	1	8	0	0
1	40112507	.	T	C	6	2	8	0	0	8	0	0
1	40112760	.	T	A	7	12	19	0	0	19	0	0
1	40112822	.	A	T	12	9	21	0	0	21	0	0
1	40112837	.	C	T	13	7	20	0	1	21	0	0
1	40112869	.	C	T	10	12	22	0	0	22	0	0
1	40112879	.	A	G	8	10	18	0	2	20	0	0
1	40112938	.	G	C	6	4	10	0	0	10	0	0
1	40113008	.	A	T	1	1	2	0	0	2	0	0
1	40113374	.	T	A	7	3	10	0	0	10	0	0
1	40114057	.	G	T	1	3	4	0	0	4	0	0
1	40114155	.	T	A	2	3	5	0	0	5	0	0
1	40115018	.	A	T	5	3	8	0	0	8	0	0
1	40115065	.	T	C	5	3	8	0	0	8	0	0
1	40116747	.	G	A	8	9	17	0	0	17	0	0
1	40116823	.	C	T	0	4	4	0	2	6	0	0
1	40116889	.	G	A	1	3	4	0	1	5	0	0
1	40116915	.	T	G	3	4	7	0	0	7	0	0
1	40116946	.	C	T	1	5	6	0	6	12	0	0
1	40117345	.	G	A	13	7	20	0	2	22	0	0
1	40126279	.	T	C	0	0	0	0	1	1	0	0
1	40126281	.	T	G	1	0	1	0	0	1	0	0
1	40210865	.	G	T	10	14	24	0	0	24	0	0
1	40211048	.	C	T	0	9	9	0	6	15	0	0
1	40211065	.	T	C	4	6	10	0	1	11	0	0
1	40211217	.	A	C	6	4	10	0	1	11	0	0
1	40211645	.	C	G	0	6	6	0	6	12	0	0
1	40212065	.	C	T	3	4	7	0	0	7	0	0
1	40212084	.	C	A	0	4	4	0	6	10	0	0
1	40212305	.	C	T	9	7	16	0	1	17	0	0
1	40226282	.	A	G	1	1	2	0	0	2	0	0
1	40226292	.	G	C	1	2	3	0	0	3	0	0
1	40227029	.	T	G	3	2	5	0	1	6	0	0
1	40248173	.	C	T	0	1	1	0	1	2	0	0
1	40248383	.	C	T	4	3	7	0	0	7	0	0
1	40252219	.	T	A	1	0	1	0	0	1	0	0
1	40257631	.	C	T	9	8	17	0	3	20	0	0
1	40257751	.	C	T	11	7	18	0	1	19	0	0
1	40257834	.	T	G	3	0	3	0	11	14	0	0
1	40258340	.	G	T	5	5	10	0	0	10	0	0
1	40266618	.	C	T	8	2	10	0	0	10	0	0
1	40270028	.	G	T	6	2	8	0	0	8	0	0
1	40270054	.	C	T	1	4	5	0	1	6	0	0
1	40270094	.	G	A	0	1	1	0	0	1	0	0
1	40270095	.	G	A	0	1	1	0	0	1	0	0
1	40336234	.	C	G	3	1	4	0	1	5	0	0
1	40336317	.	A	T	0	2	2	0	1	3	0	0
1	40336372	.	T	A	3	1	4	0	1	5	0	0
1	40336396	.	A	C	1	0	1	0	3	4	0	0
1	40337314	.	C	T	5	3	8	0	1	9	0	0
1	40337464	.	C	A	0	4	4	0	4	9	1	0
1	40340571	.	C	T	0	5	5	0	0	5	0	0
1	40410839	.	A	T	0	2	2	0	0	2	0	0
1	40410908	.	C	T	5	2	7	0	1	8	0	0
1	40411040	.	A	C	1	3	4	0	0	4	0	0
1	40411043	.	T	A	1	1	2	0	0	2	0	0
1	40567094	.	G	A	5	7	12	0	0	12	0	0
1	40568601	.	G	A	6	12	18	0	2	20	0	0
1	40568883	.	G	A	1	15	16	0	11	27	0	0
1	40568990	.	A	G	21	13	34	0	1	35	0	0
1	40569123	.	A	G	13	6	19	0	1	20	0	0
1	40569153	.	C	T	11	5	16	0	0	16	0	0
1	40569231	.	G	A	5	10	15	0	1	16	0	0
1	40569295	.	A	T	13	6	19	0	0	19	0	0
1	40569386	.	T	A	10	11	21	0	0	21	0	0
1	40569466	.	A	T	12	19	31	0	4	35	0	0
1	40569538	.	G	A	11	11	22	0	1	23	0	0
1	40569548	.	T	C	11	9	20	0	1	21	0	0
1	40573703	.	G	T	5	7	12	0	0	12	0	0
1	40590967	.	T	G	4	6	10	0	0	10	0	0
1	40591262	.	T	C	20	20	40	0	1	41	0	0
1	40591272	.	T	C	15	14	29	0	4	33	0	0
1	40594373	.	C	T	0	2	2	0	2	4	0	0
1	40594415	.	C	T	0	14	14	0	6	20	0	0
1	40594517	.	T	C	14	0	14	0	9	23	0	0
1	40594526	.	G	A	11	8	19	0	1	20	0	0
1	40600992	.	A	T	5	3	8	0	1	9	0	0
1	40601547	.	G	A	4	6	10	0	0	10	0	0
1	40627291	.	G	A	1	0	1	0	0	1	0	0
1	40638246	.	A	T	0	5	5	0	0	5	0	0
1	40796779	.	G	T	1	1	2	0	0	2	0	0
1	40796791	.	G	A	1	1	2	0	0	2	0	0
1	40992716	.	T	A	4	8	12	0	0	12	0	0
1	40992823	.	A	G	6	11	17	0	0	17	0	0
1	40992878	.	C	G	0	3	3	0	1	4	0	0
1	40993349	.	C	T	0	6	6	0	5	11	0	0
1	41131608	.	C	T	1	8	9	0	1	10	0	0
1	41133944	.	G	A	0	2	2	0	0	2	0	0
1	41138641	.	C	T	0	0	0	0	1	1	0	0
1	41140465	.	T	C	2	5	7	0	0	7	0	0
1	41140640	.	C	T	9	12	21	0	1	22	0	0
1	41215289	.	T	A	13	7	20	0	3	23	0	0
1	41215312	.	T	G	15	8	23	0	2	25	0	0
1	41215547	.	G	A	10	4	14	0	2	16	0	0
1	41215746	.	T	A	8	8	16	0	1	17	0	0
1	41215868	.	T	G	4	8	12	0	1	13	0	0
1	41215869	.	G	T	9	4	13	0	0	13	0	0
1	41215998	.	T	C	8	3	11	0	1	12	0	0
1	41222341	.	T	C	2	0	2	0	0	2	0	0
1	41294719	.	A	G	5	16	21	0	0	21	0	0
1	41294760	.	T	C	5	15	20	0	2	22	0	0
1	41294790	.	G	T	10	12	22	0	0	22	0	0
1	41297453	.	C	T	0	2	2	0	4	6	0	0
1	41297495	.	G	A	7	6	13	0	1	14	0	0
1	41297561	.	C	T	5	1	6	0	0	6	0	0
1	41297564	.	A	T	1	5	6	0	0	6	0	0
1	41300133	.	C	T	6	6	12	0	0	12	0	0
1	41309208	.	C	G	1	3	4	0	0	4	0	0
1	41310074	.	A	G	2	2	4	0	0	4	0	0
1	41331692	.	G	A	2	2	4	0	0	4	0	0
1	41470524	.	T	C	22	21	43	0	5	48	0	0
1	41471529	.	T	C	29	20	49	0	2	51	0	0
1	41487811	.	C	T	3	2	5	0	0	5	0	0
1	41488030	.	T	C	1	0	1	0	0	1	0	0
1	41489068	.	C	T	4	3	7	0	0	7	0	0
1	41489274	.	G	C	4	3	7	0	0	7	0	0
1	41489343	.	G	A	5	2	7	0	1	8	0	0
1	41489433	.	C	T	2	3	5	0	0	5	0	0
1	41492367	.	A	T	7	3	10	0	0	10	0	0
1	41604931	.	C	G	1	0	1	0	1	2	0	0
1	41604934	.	C	G	1	0	1	0	1	2	0	0
1	41605065	.	C	A	4	2	6	0	0	6	0	0
1	41605149	.	T	C	2	5	7	0	0	7	0	0
1	41605203	.	C	T	6	6	12	0	0	12	0	0
1	41605675	.	G	A	3	3	6	0	0	6	0	0
1	41615904	.	T	C	1	4	5	0	0	5	0	0
1	41615949	.	T	C	3	6	9	0	0	9	0	0
1	41615970	.	G	C	0	3	3	0	5	8	0	0
1	41615988	.	T	C	3	3	6	0	0	7	1	0
1	41616081	.	T	G	6	6	12	0	0	12	0	0
1	41616186	.	A	C	5	3	8	0	0	8	0	0
1	41690506	.	C	T	3	2	5	0	0	5	0	0
1	41730609	.	C	T	4	4	8	0	1	9	0	0
1	41744103	.	C	T	0	3	3	0	0	3	0	0
1	41755157	.	C	T	6	2	8	0	0	8	0	0
1	41755158	.	A	T	6	2	8	0	0	8	0	0
1	41755195	.	C	T	2	7	9	0	0	9	0	0
1	41770847	.	T	A	4	5	9	0	0	9	0	0
1	41770872	.	T	C	5	4	9	0	1	10	0	0
1	41770959	.	T	C	3	4	7	0	1	8	0	0
1	41849293	.	A	G	2	2	4	0	0	4	0	0
1	41849310	.	A	G	2	1	3	0	0	3	0	0
1	41865471	.	C	T	4	0	4	0	1	5	0	0
1	42375005	.	C	A	2	3	5	0	1	6	0	0
1	42375071	.	C	T	1	1	2	0	0	2	0	0
1	42391172	.	T	C	2	2	4	0	0	4	0	0
1	42391194	.	T	C	1	1	2	0	0	2	0	0
1	42776652	.	T	C	28	14	42	0	4	46	0	0
1	42776787	.	C	T	5	22	27	0	15	42	0	0
1	42776806	.	A	T	19	20	39	0	1	40	0	0
1	42776853	.	T	C	22	22	44	0	4	48	0	0
1	42776906	.	A	G	20	17	37	0	1	38	0	0
1	42777116	.	G	A	17	8	25	0	4	29	0	0
1	42777383	.	A	G	8	11	19	0	1	21	1	0
1	42777593	.	T	G	7	15	22	0	1	23	0	0
1	42777674	.	G	A	9	9	18	0	0	18	0	0
1	42882955	.	C	T	4	1	5	0	1	6	0	0
1	43023630	.	G	A	3	4	7	0	0	7	0	0
1	43034947	.	C	T	22	7	29	0	1	30	0	0
1	43035178	.	T	C	16	15	31	0	4	35	0	0
1	43035546	.	T	A	9	5	14	0	0	14	0	0
1	44558999	.	C	T	1	3	4	0	0	4	0	0
1	44571202	.	T	C	6	4	10	0	1	11	0	0
1	44571352	.	T	C	11	4	15	0	1	16	0	0
1	44872751	.	A	G	0	1	1	0	0	1	0	0
1	45570224	.	T	A	2	28	30	0	2	32	0	0
1	45743129	.	A	G	0	2	2	0	0	2	0	0
1	45744643	.	A	C	0	2	2	0	1	3	0	0
1	45834490	.	A	G	4	5	9	0	1	10	0	0
1	45834493	.	A	G	5	5	10	0	0	10	0	0
1	45868178	.	C	T	10	14	24	0	0	24	0	0
1	46020390	.	A	G	1	4	5	0	0	5	0	0
1	47120514	.	A	T	0	1	1	0	0	1	0	0
1	47159254	.	C	T	2	2	4	0	0	4	0	0
1	47510836	.	A	G	1	1	2	0	0	2	0	0
1	48582091	.	T	C	1	2	3	0	0	3	0	0
1	48583000	.	T	C	2	5	7	0	2	9	0	0
1	49271317	.	G	A	8	18	26	0	1	27	0	0
1	49293808	.	T	C	14	15	29	0	1	30	0	0
1	49293954	.	C	T	22	15	37	0	2	39	0	0
1	49294032	.	A	T	10	7	17	0	0	17	0	0
1	49294686	.	A	G	10	3	13	0	2	15	0	0
1	49353245	.	T	A	1	2	3	0	0	3	0	0
1	49418156	.	T	C	1	2	3	0	0	3	0	0
1	49418197	.	A	T	4	4	8	0	0	8	0	0
1	49607129	.	T	A	8	3	11	0	0	11	0	0
1	49814674	.	T	C	6	7	13	0	2	15	0	0
1	49814732	.	C	T	5	7	12	0	0	12	0	0
1	49814844	.	C	T	8	8	16	0	0	16	0	0
1	49869672	.	G	A	5	2	7	0	1	8	0	0
1	49903376	.	A	C	1	2	3	0	1	4	0	0
1	49912665	.	C	T	0	1	1	0	0	1	0	0
1	49912841	.	C	A	0	2	2	0	4	6	0	0
1	49912866	.	C	T	0	2	2	0	3	5	0	0
1	49913071	.	G	A	5	7	12	0	2	14	0	0
1	49913110	.	T	C	2	2	4	0	0	4	0	0
1	49915231	.	C	T	8	8	16	0	1	17	0	0
1	49915278	.	G	C	5	2	7	0	0	7	0	0
1	49915598	.	C	T	3	4	7	0	1	8	0	0
1	49929579	.	G	A	2	0	2	0	1	3	0	0
1	49980609	.	T	C	0	1	1	0	0	1	0	0
1	49980622	.	T	C	0	1	1	0	0	1	0	0
1	50171219	.	T	C	1	2	3	0	0	3	0	0
1	50172815	.	A	G	1	2	3	0	0	3	0	0
1	50178612	.	T	C	1	0	1	0	0	1	0	0
1	50178643	.	A	G	3	1	4	0	2	6	0	0
1	50178753	.	T	C	3	2	5	0	0	5	0	0
1	50178829	.	C	A	4	3	7	0	1	8	0	0
1	50178963	.	G	A	3	2	5	0	0	5	0	0
1	50178988	.	A	G	0	0	0	0	3	3	0	0
1	50185244	.	G	A	0	1	1	0	2	3	0	0
1	50187511	.	C	T	2	3	5	0	0	5	0	0
1	50187733	.	A	T	2	3	5	0	0	5	0	0
1	50198815	.	C	T	0	7	7	0	9	16	0	0
1	50199365	.	A	T	1	1	2	0	0	2	0	0
1	50199368	.	G	A	1	1	2	0	0	2	0	0
1	50199416	.	G	A	3	7	10	0	0	10	0	0
1	50270234	.	C	G	0	2	2	0	0	2	0	0
1	50270241	.	T	A	0	1	1	0	0	1	0	0
1	50272240	.	T	A	0	1	1	0	0	1	0	0
1	50303960	.	C	T	3	4	7	0	1	8	0	0
1	50303989	.	G	A	0	6	6	0	6	12	0	0
1	50317687	.	G	A	1	11	12	0	11	23	0	0
1	50317723	.	A	C	8	6	14	0	0	14	0	0
1	50319584	.	A	G	4	5	9	0	1	10	0	0
1	50487837	.	C	A	6	8	14	0	1	15	0	0
1	50487844	.	G	A	7	8	15	0	0	15	0	0
1	50488002	.	A	G	4	6	10	0	1	11	0	0
1	50496598	.	A	G	9	10	19	0	0	19	0	0
1	50502852	.	C	T	0	1	1	0	0	1	0	0
1	50503237	.	G	A	0	3	3	0	0	3	0	0
1	50594239	.	T	A	10	16	26	0	0	26	0	0
1	50594647	.	G	A	2	5	7	0	0	7	0	0
1	50594670	.	A	T	2	7	9	0	1	10	0	0
1	50594771	.	C	A	12	6	18	0	2	21	1	0
1	50594777	.	C	T	10	10	20	0	0	20	0	0
1	50595289	.	G	A	16	16	32	0	2	34	0	0
1	50595387	.	C	T	7	9	16	0	0	16	0	0
1	50595476	.	G	A	10	7	17	0	1	18	0	0
1	50595530	.	A	G	2	1	3	0	1	4	0	0
1	50595608	.	G	C	9	4	13	0	0	13	0	0
1	50595748	.	T	C	15	9	24	0	1	25	0	0
1	50595805	.	G	A	10	12	22	0	1	23	0	0
1	50596748	.	G	T	8	4	12	0	0	12	0	0
1	50598793	.	C	T	0	5	5	0	7	12	0	0
1	50598848	.	G	A	7	8	15	0	2	17	0	0
1	50608505	.	T	C	5	2	7	0	0	7	0	0
1	50608584	.	G	A	5	3	8	0	0	8	0	0
1	50694993	.	T	C	9	13	22	0	1	23	0	0
1	50694994	.	G	T	9	13	22	0	1	23	0	0
1	50847905	.	T	C	2	4	6	0	1	7	0	0
1	50848484	.	C	T	12	11	23	0	4	27	0	0
1	50848555	.	A	G	11	8	19	0	1	20	0	0
1	50849078	.	A	T	18	16	34	0	1	35	0	0
1	50849199	.	T	C	9	0	9	0	14	23	0	0
1	50849938	.	T	A	7	4	11	0	0	11	0	0
1	50849942	.	G	A	7	5	12	0	0	12	0	0
1	50850041	.	T	A	5	10	15	0	1	16	0	0
1	50969209	.	G	A	8	7	15	0	0	15	0	0
1	50977072	.	C	A	4	5	9	0	2	11	0	0
1	50977089	.	C	T	6	5	11	0	0	11	0	0
1	50977569	.	A	C	4	2	6	0	0	6	0	0
1	50977669	.	G	A	3	2	5	0	1	6	0	0
1	50977707	.	G	A	0	9	9	0	7	16	0	0
1	50983906	.	T	C	14	13	27	0	2	29	0	0
1	50985169	.	C	T	11	7	18	0	6	24	0	0
1	50987742	.	C	A	11	11	22	0	0	22	0	0
1	50990605	.	G	A	28	29	57	0	1	58	0	0
1	50990698	.	A	T	29	18	47	0	4	51	0	0
1	50990709	.	T	C	16	23	39	0	3	50	8	0
1	50990815	.	G	A	25	21	46	0	4	50	0	0
1	51021529	.	C	A	3	5	8	0	3	11	0	0
1	51021591	.	C	A	2	4	6	0	3	9	0	0
1	51039604	.	A	T	1	0	1	0	0	1	0	0
1	51041363	.	G	A	0	4	4	0	5	9	0	0
1	51042230	.	G	C	15	9	24	0	3	27	0	0
1	51107611	.	G	A	1	3	4	0	0	4	0	0
1	51196203	.	T	C	1	2	3	0	0	3	0	0
1	51196563	.	A	C	2	2	4	0	0	4	0	0
1	51197434	.	C	T	1	2	3	0	0	3	0	0
1	51210562	.	T	C	4	3	7	0	0	7	0	0
1	51211052	.	A	G	6	4	10	0	0	10	0	0
1	51211393	.	T	A	0	2	2	0	0	2	0	0
1	51211394	.	C	T	0	2	2	0	0	2	0	0
1	51212817	.	C	T	0	4	4	0	9	13	0	0
1	51212829	.	A	G	9	3	12	0	1	13	0	0
1	51217156	.	T	A	1	1	2	0	1	3	0	0
1	51221347	.	A	G	4	0	4	0	5	9	0	0
1	51221349	.	A	T	4	5	9	0	0	9	0	0
1	51229355	.	C	T	9	4	13	0	3	16	0	0
1	51229464	.	C	G	9	4	13	0	0	13	0	0
1	51229471	.	C	T	1	4	5	0	6	11	0	0
1	51230275	.	T	C	6	7	13	0	0	13	0	0
1	51230277	.	C	G	8	5	13	0	0	13	0	0
1	51230324	.	G	A	5	5	10	0	0	10	0	0
1	51230328	.	C	A	5	4	9	0	1	10	0	0
1	51230404	.	A	G	2	6	8	0	0	8	0	0
1	51230427	.	A	G	3	2	5	0	0	5	0	0
1	51230467	.	T	C	3	3	6	0	0	6	0	0
1	51230487	.	A	T	2	3	5	0	0	5	0	0
1	51230957	.	C	A	0	7	7	0	9	16	0	0
1	51231228	.	G	T	2	2	4	0	0	4	0	0
1	51244814	.	C	T	1	4	5	0	0	5	0	0
1	51246693	.	T	C	0	2	2	0	0	2	0	0
1	51373808	.	C	T	1	3	4	0	0	4	0	0
1	51373904	.	A	G	1	2	3	0	0	3	0	0
1	51374844	.	C	T	1	2	3	0	0	3	0	0
1	51395366	.	G	T	2	3	5	0	0	5	0	0
1	51403088	.	C	T	0	3	3	0	2	5	0	0
1	51403499	.	C	A	1	0	1	0	1	2	0	0
1	51403544	.	G	C	5	4	9	0	0	9	0	0
1	51403562	.	C	T	4	7	11	0	0	11	0	0
1	51405253	.	T	A	4	2	6	0	0	6	0	0
1	51405323	.	C	A	2	5	7	0	1	8	0	0
1	51405636	.	A	C	3	4	7	0	1	8	0	0
1	51405684	.	G	A	0	5	5	0	3	8	0	0
1	51405721	.	G	A	1	1	2	0	1	3	0	0
1	51406142	.	G	A	8	2	10	0	3	13	0	0
1	51406288	.	C	T	8	15	23	0	0	23	0	0
1	51413315	.	T	C	2	2	4	0	1	5	0	0
1	51424779	.	A	T	4	4	8	0	1	9	0	0
1	51424813	.	G	A	0	5	5	0	6	11	0	0
1	51424937	.	T	A	3	3	6	0	0	7	1	0
1	51425296	.	G	A	6	5	11	0	0	11	0	0
1	51426986	.	G	A	2	1	3	0	0	3	0	0
1	51427152	.	G	T	5	7	12	0	0	12	0	0
1	51427153	.	G	T	5	5	10	0	2	12	0	0
1	51427671	.	G	T	14	11	25	0	1	26	0	0
1	51427779	.	T	C	16	15	31	0	1	32	0	0
1	51427837	.	A	C	14	16	30	0	0	30	0	0
1	51445432	.	T	A	9	2	11	0	2	13	0	0
1	51445450	.	A	T	10	6	16	0	0	16	0	0
1	51445732	.	A	G	5	15	20	0	0	20	0	0
1	51446230	.	T	A	3	4	7	0	0	7	0	0
1	51446451	.	C	T	1	2	3	0	0	3	0	0
1	51446462	.	C	T	1	2	3	0	0	3	0	0
1	51446597	.	A	T	1	4	5	0	1	6	0	0
1	51446671	.	A	T	0	2	2	0	0	2	0	0
1	51447543	.	T	G	2	2	4	0	0	4	0	0
1	51448249	.	C	A	4	2	6	0	2	8	0	0
1	51448485	.	C	T	3	6	9	0	0	9	0	0
1	51449298	.	T	C	3	2	5	0	1	6	0	0
1	51450018	.	C	T	0	4	4	0	3	7	0	0
1	51450752	.	G	A	1	4	5	0	0	5	0	0
1	51557817	.	G	T	6	3	9	0	0	9	0	0
1	51557903	.	C	T	1	27	28	0	25	53	0	0
1	51558133	.	G	T	13	9	22	0	6	28	0	0
1	51558150	.	A	T	13	10	23	0	1	24	0	0
1	51558354	.	T	A	17	10	27	0	4	31	0	0
1	51558463	.	G	A	33	21	54	0	0	54	0	0
1	51558730	.	G	T	23	15	38	0	5	43	0	0
1	51558897	.	T	A	20	21	41	0	2	44	1	0
1	51558903	.	A	C	16	22	38	0	4	42	0	0
1	51559269	.	G	C	16	19	35	0	1	36	0	0
1	51559815	.	C	T	11	10	21	0	1	22	0	0
1	51562803	.	T	C	4	5	9	0	2	11	0	0
1	51593925	.	A	C	6	7	13	0	1	14	0	0
1	51593926	.	C	T	0	7	7	0	7	14	0	0
1	51594068	.	A	C	9	11	20	0	2	22	0	0
1	51594453	.	A	G	28	12	40	0	2	42	0	0
1	51594690	.	C	G	0	20	20	0	18	38	0	0
1	51594701	.	C	T	1	25	26	0	15	41	0	0
1	51594883	.	C	T	0	2	2	0	1	3	0	0
1	51606302	.	C	G	6	3	9	0	2	11	0	0
1	51612371	.	G	T	13	15	28	0	1	29	0	0
1	51612408	.	C	G	18	18	36	0	4	40	0	0
1	51615110	.	T	C	5	0	5	0	10	15	0	0
1	51703824	.	C	T	3	3	6	0	0	6	0	0
1	51710007	.	C	T	2	2	4	0	1	5	0	0
1	51712960	.	G	A	7	1	8	0	0	8	0	0
1	51712983	.	A	G	10	3	13	0	2	15	0	0
1	51713468	.	C	T	1	1	2	0	0	2	0	0
1	51719005	.	G	A	0	1	1	0	0	1	0	0
1	51721923	.	T	G	2	2	4	0	0	4	0	0
1	51726524	.	C	T	6	15	21	0	0	21	0	0
1	51727432	.	C	A	6	5	11	0	1	12	0	0
1	51729605	.	G	A	13	11	24	0	2	26	0	0
1	51729608	.	G	T	13	11	24	0	1	25	0	0
1	51729645	.	A	C	6	13	19	0	0	19	0	0
1	51729687	.	C	T	1	13	14	0	1	15	0	0
1	51729697	.	C	A	0	14	14	0	2	16	0	0
1	51729735	.	C	A	11	14	25	0	4	29	0	0
1	51729798	.	A	C	7	17	24	0	1	25	0	0
1	51733284	.	T	A	16	10	26	0	1	27	0	0
1	52115862	.	C	T	0	0	0	0	2	2	0	0
1	52121311	.	A	G	2	1	3	0	0	3	0	0
1	52124240	.	C	T	0	1	1	0	4	5	0	0
1	52130268	.	G	A	0	10	10	0	8	18	0	0
1	52130328	.	T	C	4	2	6	0	2	8	0	0
1	52130339	.	A	G	3	3	6	0	1	7	0	0
1	52130431	.	G	A	7	9	16	0	2	18	0	0
1	52134992	.	G	A	1	0	1	0	0	1	0	0
1	52135254	.	T	C	7	9	16	0	0	16	0	0
1	52135303	.	T	C	7	7	14	0	2	16	0	0
1	52135513	.	G	A	3	3	6	0	0	6	0	0
1	52135690	.	A	G	1	2	3	0	0	3	0	0
1	52135972	.	A	T	10	9	19	0	0	19	0	0
1	52136027	.	T	C	10	9	19	0	1	20	0	0
1	52136117	.	A	C	12	10	22	0	1	23	0	0
1	52136294	.	T	C	8	6	14	0	0	14	0	0
1	52136454	.	A	C	12	9	21	0	0	21	0	0
1	52136641	.	A	G	2	3	5	0	1	6	0	0
1	52136759	.	A	T	17	10	27	0	3	30	0	0
1	52136762	.	A	C	19	11	30	0	2	32	0	0
1	52136868	.	A	G	7	10	17	0	3	20	0	0
1	52136894	.	T	C	11	17	28	0	0	28	0	0
1	52136917	.	A	C	11	16	27	0	1	28	0	0
1	52137013	.	T	A	10	12	22	0	0	22	0	0
1	52137580	.	T	C	2	2	4	0	0	4	0	0
1	52137591	.	T	C	2	2	4	0	0	4	0	0
1	52146021	.	A	T	2	2	4	0	0	4	0	0
1	52149554	.	A	T	13	11	24	0	6	30	0	0
1	52149794	.	A	G	11	5	16	0	1	17	0	0
1	52149952	.	A	G	12	1	13	0	5	18	0	0
1	52149977	.	T	A	10	4	14	0	0	14	0	0
1	52150029	.	T	C	6	5	11	0	2	13	0	0
1	52150152	.	G	A	8	8	16	0	1	17	0	0
1	52150182	.	G	T	1	13	14	0	8	22	0	0
1	52150231	.	C	T	15	10	25	0	2	27	0	0
1	52150400	.	A	G	10	4	14	0	2	16	0	0
1	52150531	.	A	C	15	1	16	0	1	17	0	0
1	52150812	.	A	G	6	14	20	0	1	21	0	0
1	52150900	.	G	T	9	3	12	0	0	12	0	0
1	52152043	.	A	G	2	5	7	0	1	8	0	0
1	52152050	.	A	G	4	3	7	0	0	7	0	0
1	52152137	.	C	A	12	10	22	0	5	27	0	0
1	52152300	.	A	T	4	11	15	0	0	15	0	0
1	52152363	.	A	G	11	5	16	0	0	16	0	0
1	52152365	.	A	G	10	4	14	0	2	16	0	0
1	52152398	.	T	C	6	15	21	0	0	21	0	0
1	52152406	.	A	C	6	16	22	0	0	22	0	0
1	52152488	.	A	G	18	13	31	0	1	32	0	0
1	52179066	.	C	T	0	4	4	0	3	7	0	0
1	52198224	.	T	C	0	1	1	0	0	1	0	0
1	52198293	.	T	G	1	3	4	0	0	4	0	0
1	52452275	.	G	T	0	7	7	0	1	8	0	0
1	52452332	.	C	T	2	6	8	0	0	8	0	0
1	52455908	.	G	A	3	2	5	0	0	5	0	0
1	52455960	.	C	T	5	6	11	0	1	12	0	0
1	52456002	.	G	A	0	1	1	0	0	1	0	0
1	52460737	.	C	T	3	6	9	0	0	9	0	0
1	52460739	.	T	C	3	5	8	0	1	9	0	0
1	52460906	.	T	C	0	5	5	0	1	6	0	0
1	52460944	.	G	T	3	5	8	0	1	9	0	0
1	52478381	.	C	T	5	2	7	0	0	7	0	0
1	52478413	.	G	A	0	3	3	0	2	5	0	0
1	52478600	.	A	T	2	3	5	0	1	6	0	0
1	52486125	.	T	C	1	3	4	0	1	5	0	0
1	52489974	.	G	A	0	7	7	0	5	12	0	0
1	52495001	.	T	C	0	2	2	0	0	2	0	0
1	52495004	.	T	A	1	2	3	0	0	3	0	0
1	52495045	.	C	T	0	2	2	0	4	6	0	0
1	52501213	.	A	C	2	0	2	0	7	9	0	0
1	52501745	.	A	T	1	2	3	0	0	3	0	0
1	52501794	.	T	C	2	4	6	0	1	7	0	0
1	52501800	.	G	A	3	5	8	0	0	8	0	0
1	52538330	.	A	G	0	3	3	0	0	3	0	0
1	52538341	.	C	A	0	4	4	0	0	4	0	0
1	52610788	.	G	A	1	0	1	0	0	1	0	0
1	52614377	.	C	T	3	1	4	0	0	4	0	0
1	52618405	.	C	T	8	3	11	0	0	11	0	0
1	52621542	.	C	T	3	1	4	0	1	5	0	0
1	52621545	.	C	T	3	1	4	0	1	5	0	0
1	52623591	.	G	A	0	1	1	0	1	2	0	0
1	52625747	.	C	G	9	0	9	0	10	19	0	0
1	52626826	.	T	A	4	3	7	0	0	7	0	0
1	52627572	.	G	A	0	12	12	0	23	35	0	0
1	52627678	.	A	T	22	18	40	0	2	42	0	0
1	52627679	.	C	T	21	19	40	0	2	42	0	0
1	52627794	.	G	A	16	8	24	0	3	27	0	0
1	52627984	.	T	C	14	13	27	0	3	30	0	0
1	52628253	.	G	T	7	9	16	0	3	19	0	0
1	52628322	.	A	T	4	3	7	0	0	7	0	0
1	52655415	.	C	T	0	0	0	0	1	1	0	0
1	52655421	.	G	A	1	0	1	0	0	1	0	0
1	52688223	.	G	A	0	2	2	0	1	3	0	0
1	52688355	.	C	T	4	2	6	0	0	6	0	0
1	52698944	.	G	T	4	3	7	0	0	7	0	0
1	52698955	.	C	T	5	3	8	0	0	8	0	0
1	52764824	.	A	T	7	10	17	0	1	18	0	0
1	52773239	.	G	A	1	3	4	0	0	4	0	0
1	52773311	.	A	G	3	3	6	0	2	8	0	0
1	52775649	.	A	G	14	9	23	0	1	24	0	0
1	52779785	.	G	A	9	8	17	0	1	18	0	0
1	52782161	.	G	A	4	3	7	0	2	9	0	0
1	52782220	.	G	T	3	4	7	0	1	8	0	0
1	52784483	.	C	A	1	4	5	0	0	5	0	0
1	52784527	.	C	T	1	2	3	0	3	6	0	0
1	52784549	.	A	T	3	2	5	0	0	5	0	0
1	52784702	.	G	A	4	3	7	0	0	7	0	0
1	52796844	.	T	G	1	1	2	0	0	2	0	0
1	52796850	.	C	T	1	2	3	0	0	3	0	0
1	52796964	.	T	C	4	0	4	0	0	4	0	0
1	52797152	.	T	C	1	0	1	0	0	1	0	0
1	52812162	.	G	A	4	1	5	0	1	6	0	0
1	52812219	.	C	G	7	6	13	0	0	14	1	0
1	52813633	.	A	T	12	8	20	0	0	20	0	0
1	52817949	.	C	G	3	1	4	0	2	6	0	0
1	53007935	.	A	G	3	2	5	0	1	6	0	0
1	53025666	.	C	T	1	2	3	0	0	3	0	0
1	53025708	.	C	G	1	2	3	0	0	3	0	0
1	53025711	.	C	T	0	1	1	0	0	1	0	0
1	53132860	.	T	C	4	1	5	0	0	5	0	0
1	53156324	.	A	G	5	2	7	0	1	8	0	0
1	53156413	.	C	T	6	3	9	0	0	9	0	0
1	53166094	.	A	G	5	3	8	0	1	9	0	0
1	53185877	.	A	C	1	0	1	0	1	2	0	0
1	53185906	.	T	C	4	7	11	0	0	11	0	0
1	53185945	.	T	C	9	10	19	0	0	19	0	0
1	53267026	.	A	C	7	0	7	0	8	15	0	0
1	53267349	.	A	G	10	9	19	0	0	19	0	0
1	53269670	.	A	C	2	8	10	0	1	11	0	0
1	53269694	.	A	G	0	1	1	0	1	2	0	0
1	53277043	.	T	C	1	0	1	0	3	4	0	0
1	53277064	.	C	T	3	3	6	0	1	7	0	0
1	53360153	.	T	C	9	4	13	0	0	13	0	0
1	53360308	.	G	A	5	4	9	0	0	9	0	0
1	53360342	.	C	T	4	6	10	0	0	10	0	0
1	53360369	.	C	T	3	6	9	0	1	10	0	0
1	53360459	.	C	T	9	8	17	0	0	17	0	0
1	53360549	.	T	C	9	8	17	0	0	17	0	0
1	53387779	.	T	G	1	2	3	0	0	3	0	0
1	53387786	.	C	T	1	2	3	0	0	3	0	0
1	53388135	.	A	C	3	4	7	0	0	7	0	0
1	53388309	.	G	C	2	3	5	0	2	7	0	0
1	53388476	.	A	C	1	5	6	0	0	6	0	0
1	53388540	.	T	A	3	6	9	0	0	9	0	0
1	53388590	.	T	G	5	7	12	0	2	14	0	0
1	53388861	.	A	G	4	7	11	0	1	12	0	0
1	53391669	.	A	C	19	9	28	0	3	31	0	0
1	53391860	.	G	T	11	0	11	0	0	11	0	0
1	53391916	.	C	T	8	3	11	0	0	11	0	0
1	53392002	.	A	T	12	10	22	0	0	22	0	0
1	53392161	.	T	C	8	10	18	0	0	18	0	0
1	53392220	.	C	A	0	6	6	0	9	15	0	0
1	53392227	.	A	T	9	5	14	0	0	14	0	0
1	53392266	.	T	A	4	2	6	0	1	7	0	0
1	53395137	.	T	C	1	2	3	0	0	3	0	0
1	53395627	.	T	C	2	2	4	0	0	4	0	0
1	53395828	.	G	A	3	10	13	0	2	15	0	0
1	53491565	.	A	G	8	2	10	0	1	11	0	0
1	53491937	.	A	G	7	5	12	0	2	14	0	0
1	53491964	.	T	A	9	7	16	0	1	17	0	0
1	53492000	.	C	A	7	6	13	0	1	14	0	0
1	53670917	.	G	T	1	0	1	0	0	1	0	0
1	53674825	.	G	A	0	1	1	0	0	1	0	0
1	53701875	.	A	G	9	9	18	0	2	20	0	0
1	53701905	.	T	G	4	6	10	0	0	11	1	0
1	53703149	.	G	A	0	1	1	0	0	1	0	0
1	53703194	.	G	T	13	18	31	0	2	33	0	0
1	53704485	.	C	A	16	20	36	0	1	37	0	0
1	53705191	.	G	A	6	3	9	0	0	9	0	0
1	53705203	.	G	A	7	10	17	0	0	17	0	0
1	53705266	.	A	G	11	15	26	0	1	27	0	0
1	53709732	.	C	A	1	9	10	0	12	22	0	0
1	53709762	.	C	T	9	11	20	0	3	23	0	0
1	53713449	.	G	T	4	1	5	0	0	5	0	0
1	53714790	.	T	A	11	15	26	0	1	27	0	0
1	53718294	.	A	T	2	2	4	0	0	4	0	0
1	53719831	.	T	C	0	2	2	0	0	2	0	0
1	53720303	.	G	T	1	2	3	0	0	3	0	0
1	53720360	.	T	G	0	3	3	0	0	3	0	0
1	53724724	.	T	A	4	3	7	0	2	9	0	0
1	53726457	.	G	A	0	1	1	0	0	1	0	0
1	53727755	.	C	T	0	2	2	0	0	2	0	0
1	53729934	.	G	A	1	0	1	0	0	1	0	0
1	53730412	.	A	G	1	2	3	0	0	3	0	0
1	53735245	.	C	T	4	5	9	0	2	11	0	0
1	53735249	.	C	T	5	5	10	0	0	10	0	0
1	53735648	.	A	G	9	9	18	0	1	19	0	0
1	53735702	.	T	G	5	4	9	0	0	9	0	0
1	53735712	.	G	A	4	3	7	0	0	7	0	0
1	53739397	.	G	A	2	3	5	0	0	5	0	0
1	53756723	.	C	T	0	8	8	0	6	14	0	0
1	53871326	.	T	A	0	5	5	0	0	5	0	0
1	53871338	.	C	A	6	0	6	0	0	6	0	0
1	53871383	.	A	G	6	6	12	0	1	13	0	0
1	53871416	.	C	A	6	3	9	0	1	10	0	0
1	53872031	.	C	A	4	2	6	0	0	6	0	0
1	53879397	.	C	T	5	3	8	0	0	8	0	0
1	53879767	.	G	A	2	2	4	0	1	5	0	0
1	53912307	.	A	G	2	4	6	0	0	6	0	0
1	53912418	.	G	T	2	2	4	0	0	4	0	0
1	53921786	.	G	A	0	1	1	0	0	1	0	0
1	53926940	.	G	T	1	5	6	0	0	6	0	0
1	53932271	.	A	G	4	6	10	0	0	10	0	0
1	53935314	.	T	C	3	2	5	0	0	5	0	0
1	53937423	.	C	T	1	1	2	0	1	3	0	0
1	53939430	.	A	G	2	3	5	0	1	6	0	0
1	53939604	.	C	T	1	0	1	0	0	1	0	0
1	53953140	.	C	T	1	2	3	0	0	3	0	0
1	53954314	.	G	A	0	2	2	0	4	6	0	0
1	53954361	.	C	A	3	1	4	0	0	4	0	0
1	53954385	.	A	C	1	1	2	0	0	2	0	0
1	53955055	.	G	A	5	4	9	0	0	9	0	0
1	53958136	.	G	A	0	8	8	0	10	18	0	0
1	53958263	.	C	T	4	7	11	0	4	15	0	0
1	53962227	.	A	T	3	3	6	0	0	6	0	0
1	53962264	.	T	C	4	9	13	0	0	13	0	0
1	53962606	.	T	A	4	2	6	0	0	6	0	0
1	53962660	.	A	T	1	1	2	0	1	3	0	0
1	53962661	.	G	T	1	2	3	0	0	3	0	0
1	53962860	.	G	A	0	2	2	0	3	5	0	0
1	53962863	.	C	T	3	2	5	0	1	6	0	0
1	53962900	.	T	A	2	6	8	0	0	8	0	0
1	53962961	.	C	T	5	2	7	1	1	9	0	0
1	53963108	.	C	A	12	4	16	0	1	17	0	0
1	53963159	.	C	T	12	6	18	0	1	19	0	0
1	53963782	.	A	G	7	6	13	0	0	13	0	0
1	53982990	.	C	T	1	2	3	0	0	3	0	0
1	54048786	.	G	A	4	3	7	0	0	7	0	0
1	54061812	.	C	T	5	3	8	0	1	9	0	0
1	54061824	.	C	T	6	3	9	0	1	10	0	0
1	54062020	.	G	A	0	2	2	0	1	3	0	0
1	54062754	.	G	A	1	2	3	0	1	4	0	0
1	54062858	.	A	G	3	3	6	0	1	7	0	0
1	54070981	.	G	A	1	0	1	0	0	1	0	0
1	54080067	.	A	T	1	4	5	0	2	7	0	0
1	54080253	.	G	C	1	5	6	0	0	6	0	0
1	54080261	.	C	T	1	3	4	0	1	5	0	0
1	54080361	.	T	G	1	3	4	0	0	4	0	0
1	54084613	.	G	A	0	4	4	0	2	6	0	0
1	54084616	.	C	T	2	2	4	0	2	6	0	0
1	54097446	.	A	G	2	2	4	0	0	4	0	0
1	54137238	.	A	G	1	4	5	0	0	5	0	0
1	54142097	.	T	C	0	3	3	0	0	3	0	0
1	54144024	.	T	G	3	0	3	0	1	4	0	0
1	54146383	.	C	T	7	4	11	0	0	11	0	0
1	54146416	.	T	C	9	7	16	0	2	18	0	0
1	54158479	.	A	G	0	1	1	0	0	1	0	0
1	54167162	.	G	A	1	2	3	0	0	3	0	0
1	54178755	.	G	C	4	3	7	0	0	7	0	0
1	54182416	.	T	A	2	2	4	0	0	4	0	0
1	54182419	.	A	G	2	1	3	0	0	3	0	0
1	54184468	.	C	T	3	3	6	0	0	6	0	0
1	54190522	.	C	A	1	3	4	0	0	4	0	0
1	54244041	.	T	C	3	1	4	0	1	5	0	0
1	54244432	.	T	C	1	3	4	0	0	4	0	0
1	54248366	.	A	C	2	1	3	0	0	3	0	0
1	54253768	.	G	A	0	0	0	0	1	1	0	0
1	54255651	.	C	T	5	5	10	0	0	10	0	0
1	54674388	.	A	G	1	2	3	0	0	3	0	0
1	54674430	.	A	G	2	0	2	0	5	7	0	0
1	54683743	.	C	T	1	0	1	0	0	1	0	0
1	54685590	.	A	G	5	3	8	0	0	8	0	0
1	54685610	.	T	C	6	3	9	0	0	9	0	0
1	54685799	.	G	A	2	3	5	0	0	5	0	0
1	54685814	.	G	A	1	2	3	0	0	3	0	0
1	54687580	.	C	T	7	8	15	0	0	15	0	0
1	54687649	.	G	T	11	7	18	0	1	19	0	0
1	54687715	.	C	A	5	15	20	0	0	20	0	0
1	54687756	.	A	C	5	12	17	0	2	19	0	0
1	54687766	.	A	C	8	14	22	0	0	22	0	0
1	54687798	.	A	C	9	14	23	0	1	24	0	0
1	54687928	.	G	T	10	6	16	1	0	17	0	0
1	54687981	.	A	G	4	6	10	0	1	11	0	0
1	54701231	.	G	A	0	0	0	0	1	1	0	0
1	54707977	.	G	A	25	35	60	0	6	66	0	0
1	54708098	.	G	T	31	26	57	0	8	65	0	0
1	54708191	.	C	A	36	29	65	0	3	68	0	0
1	54708253	.	G	A	18	25	43	0	8	51	0	0
1	54708281	.	A	T	21	23	44	0	3	47	0	0
1	54708301	.	A	C	22	23	45	0	2	47	0	0
1	54708317	.	C	T	26	22	48	0	2	50	0	0
1	54708359	.	C	T	23	21	44	0	6	50	0	0
1	54708551	.	C	T	13	7	20	0	0	20	0	0
1	54708636	.	T	C	12	10	22	0	3	25	0	0
1	54708946	.	T	C	4	10	14	0	0	14	0	0
1	54709070	.	T	C	9	9	18	0	0	18	0	0
1	54709071	.	T	C	12	0	12	0	6	18	0	0
1	54709334	.	G	A	29	21	50	0	3	53	0	0
1	54726221	.	A	G	1	4	5	0	0	5	0	0
1	54737506	.	C	A	1	1	2	0	1	3	0	0
1	54753095	.	T	G	4	0	4	0	5	9	0	0
1	54753101	.	T	C	4	5	9	0	1	10	0	0
1	54754356	.	C	T	5	7	12	0	0	12	0	0
1	54754482	.	T	G	5	10	15	0	0	15	0	0
1	54754503	.	G	A	5	8	13	0	1	14	0	0
1	54754550	.	C	A	4	7	11	0	0	11	0	0
1	54754565	.	C	T	4	6	10	0	1	11	0	0
1	54754623	.	A	T	6	5	11	0	0	11	0	0
1	54754626	.	T	A	6	4	10	0	1	11	0	0
1	54754744	.	C	T	9	4	13	0	1	14	0	0
1	54754754	.	T	C	8	5	13	0	2	15	0	0
1	54758624	.	A	T	5	4	9	0	0	9	0	0
1	54758725	.	C	T	0	9	9	0	16	25	0	0
1	54758810	.	C	T	12	12	24	0	2	26	0	0
1	54758975	.	T	C	10	14	24	0	0	24	0	0
1	54759065	.	G	A	4	1	5	0	1	6	0	0
1	54762947	.	G	A	3	2	5	0	1	6	0	0
1	54762997	.	G	T	14	7	21	0	3	24	0	0
1	54763022	.	G	C	13	8	21	0	0	21	0	0
1	54763106	.	A	G	2	5	7	0	2	9	0	0
1	54763133	.	T	C	2	3	5	0	2	7	0	0
1	54763182	.	A	G	2	5	7	0	1	8	0	0
1	54763187	.	G	A	3	5	8	0	1	9	0	0
1	54763298	.	G	A	3	4	7	0	0	7	0	0
1	54765216	.	A	C	5	0	5	0	12	17	0	0
1	54765218	.	C	T	0	9	9	0	8	17	0	0
1	54774042	.	T	G	1	2	3	0	0	3	0	0
1	54777323	.	T	A	1	1	2	0	1	3	0	0
1	54777327	.	T	A	1	2	3	0	0	3	0	0
1	54779999	.	A	C	1	1	2	3	0	5	0	0
1	54893198	.	G	A	0	2	2	0	1	3	0	0
1	54897256	.	C	T	3	3	6	0	0	6	0	0
1	54897288	.	C	T	0	2	2	0	1	3	0	0
1	54906069	.	T	C	3	0	3	0	0	3	0	0
1	54906192	.	T	C	0	2	2	0	0	2	0	0
1	54906476	.	G	C	0	2	2	0	1	3	0	0
1	54906619	.	T	A	2	2	4	0	0	4	0	0
1	54907021	.	G	A	11	6	17	0	0	17	0	0
1	54907074	.	G	A	5	2	7	0	1	8	0	0
1	54907077	.	T	A	7	2	9	0	0	9	0	0
1	54907367	.	T	G	1	8	9	0	1	10	0	0
1	54907502	.	A	G	9	4	13	0	0	13	0	0
1	54907549	.	T	C	11	4	15	0	1	16	0	0
1	54907600	.	A	T	14	6	20	0	6	26	0	0
1	54907622	.	T	C	18	8	26	0	1	27	0	0
1	54907698	.	G	T	10	5	15	0	0	15	0	0
1	54907707	.	C	T	9	4	13	0	1	14	0	0
1	54927198	.	T	C	2	1	3	0	0	3	0	0
1	54929168	.	G	A	9	8	17	0	0	17	0	0
1	54929256	.	T	C	9	8	17	0	1	18	0	0
1	54929281	.	G	A	1	6	7	0	10	17	0	0
1	54929293	.	C	T	10	6	16	0	3	19	0	0
1	54929994	.	T	C	9	3	12	0	1	13	0	0
1	54930316	.	G	A	3	2	5	0	0	5	0	0
1	54930428	.	T	A	5	4	9	0	1	10	0	0
1	54930486	.	G	A	10	7	17	0	0	17	0	0
1	54930598	.	A	G	5	13	18	0	0	18	0	0
1	54930626	.	A	C	4	9	13	0	0	13	0	0
1	54930693	.	T	C	4	12	16	0	0	16	0	0
1	54930711	.	G	A	3	10	13	0	0	13	0	0
1	54930776	.	A	G	5	8	13	0	0	13	0	0
1	54930868	.	C	A	10	3	13	0	0	13	0	0
1	54931111	.	T	C	6	12	18	0	0	18	0	0
1	54931122	.	G	A	0	14	14	0	6	20	0	0
1	54931211	.	A	T	10	11	21	0	0	21	0	0
1	54931230	.	T	A	13	11	24	0	1	25	0	0
1	54931791	.	G	C	0	10	10	0	15	25	0	0
1	54931862	.	A	G	0	4	4	0	0	4	0	0
1	54936471	.	T	C	7	0	7	0	16	23	0	0
1	54938274	.	T	C	3	0	3	0	0	3	0	0
1	54939536	.	A	T	0	4	4	0	0	4	0	0
1	54941036	.	G	A	0	3	3	0	0	3	0	0
1	54943160	.	A	G	1	3	4	0	0	4	0	0
1	54950534	.	T	C	8	4	12	0	3	15	0	0
1	54950572	.	G	A	7	10	17	0	2	19	0	0
1	54950661	.	G	A	14	8	22	0	1	23	0	0
1	54950745	.	G	T	5	9	14	0	1	15	0	0
1	54950801	.	A	G	1	5	6	0	1	7	0	0
1	54955207	.	G	A	2	2	4	0	0	4	0	0
1	54955234	.	A	G	2	2	4	0	3	7	0	0
1	54958033	.	G	A	0	4	4	0	6	10	0	0
1	54958123	.	A	G	7	3	10	0	0	10	0	0
1	54958146	.	T	A	7	5	12	0	0	12	0	0
1	54960328	.	A	G	17	10	27	0	1	28	0	0
1	54960368	.	T	G	23	16	39	0	1	40	0	0
1	54960416	.	A	C	23	18	41	0	3	44	0	0
1	54960563	.	T	A	13	15	28	0	5	33	0	0
1	54960881	.	A	G	15	15	30	0	10	40	0	0
1	54962466	.	A	G	13	9	22	0	1	23	0	0
1	54963314	.	A	G	11	21	32	0	0	32	0	0
1	54964724	.	A	G	13	7	20	0	0	20	0	0
1	54974437	.	C	A	12	4	16	0	0	16	0	0
1	54974438	.	A	G	12	4	16	0	0	16	0	0
1	54974477	.	G	A	11	1	12	0	1	13	0	0
1	54974500	.	T	A	16	1	17	0	0	17	0	0
1	54974538	.	A	G	16	3	19	0	1	20	0	0
1	54974660	.	T	C	12	11	23	0	0	24	1	0
1	54974774	.	G	A	11	8	19	0	0	19	0	0
1	54974810	.	G	T	5	9	14	0	3	17	0	0
1	54975136	.	A	T	13	6	19	0	1	20	0	0
1	54975284	.	C	G	1	1	2	0	0	2	0	0
1	54975286	.	C	T	1	1	2	0	0	2	0	0
1	54975404	.	C	T	0	3	3	0	9	12	0	0
1	54975431	.	C	T	10	5	15	0	0	15	0	0
1	54975519	.	C	T	15	11	26	0	0	26	0	0
1	54975762	.	A	T	7	4	11	0	2	13	0	0
1	54975847	.	T	A	2	1	3	0	0	3	0	0
1	54975884	.	A	G	2	6	8	0	0	8	0	0
1	54975911	.	G	A	3	4	7	0	1	8	0	0
1	54976026	.	T	A	3	10	13	0	1	14	0	0
1	54976035	.	T	A	1	10	11	0	1	12	0	0
1	54976104	.	G	A	4	6	10	0	1	11	0	0
1	54976249	.	T	A	9	7	16	0	0	16	0	0
1	54976256	.	C	T	10	7	17	0	0	17	0	0
1	54976731	.	C	T	4	5	9	0	0	9	0	0
1	54976732	.	A	G	4	5	9	0	0	9	0	0
1	54976827	.	T	C	2	2	4	0	0	4	0	0
1	54976835	.	C	T	2	2	4	0	0	4	0	0
1	54977000	.	A	G	6	2	8	0	0	8	0	0
1	54977057	.	A	G	3	3	6	1	0	7	0	0
1	54977422	.	G	A	7	4	11	0	0	11	0	0
1	54977426	.	T	C	7	3	10	0	1	11	0	0
1	54977572	.	G	A	5	7	12	0	0	12	0	0
1	54977618	.	G	A	8	6	14	0	0	14	0	0
1	54977636	.	T	C	8	3	11	0	0	11	0	0
1	54977697	.	G	A	7	4	11	0	1	12	0	0
1	54977719	.	T	A	7	4	11	0	0	11	0	0
1	54977781	.	A	G	4	3	7	0	0	7	0	0
1	54977842	.	C	A	2	2	4	0	2	6	0	0
1	54978478	.	T	C	2	3	5	0	1	6	0	0
1	54981628	.	G	A	5	4	9	0	0	9	0	0
1	54984172	.	A	G	3	2	5	0	0	5	0	0
1	54984206	.	T	C	3	0	3	0	2	5	0	0
1	54984587	.	C	T	0	1	1	0	0	1	0	0
1	54988259	.	G	A	2	3	5	0	0	5	0	0
1	54997327	.	T	C	3	3	6	0	0	6	0	0
1	55008322	.	A	G	17	7	24	0	1	25	0	0
1	55008382	.	C	T	17	8	25	0	2	27	0	0
1	55008405	.	G	A	15	5	20	0	2	22	0	0
1	55008772	.	T	C	4	8	12	0	2	14	0	0
1	55010739	.	T	A	3	2	5	0	2	7	0	0
1	55010741	.	T	G	3	3	6	0	1	7	0	0
1	55010914	.	A	C	5	6	11	0	2	13	0	0
1	55011101	.	T	A	3	5	8	0	0	8	0	0
1	55011117	.	T	C	3	5	8	0	1	9	0	0
1	55011353	.	G	C	4	7	11	0	1	12	0	0
1	55011514	.	C	T	3	5	8	0	0	8	0	0
1	55011539	.	A	T	1	7	8	0	0	8	0	0
1	55011550	.	G	A	2	5	7	0	1	8	0	0
1	55011692	.	C	T	1	5	6	0	4	10	0	0
1	55013350	.	G	A	1	1	2	0	0	2	0	0
1	55013968	.	G	C	0	1	1	0	0	1	0	0
1	55046494	.	G	A	2	2	4	0	0	4	0	0
1	55047097	.	A	T	1	2	3	0	0	3	0	0
1	55047614	.	G	A	2	2	4	0	0	4	0	0
1	55047645	.	A	T	2	2	4	0	0	4	0	0
1	55048372	.	G	A	1	2	3	0	0	3	0	0
1	55085830	.	A	T	2	2	4	0	0	4	0	0
1	55088074	.	G	T	1	2	3	0	0	3	0	0
1	55088075	.	A	G	1	2	3	0	0	3	0	0
1	55089078	.	T	A	2	4	6	0	0	6	0	0
1	55089396	.	C	T	2	6	8	0	2	10	0	0
1	55089449	.	G	A	0	2	2	0	0	2	0	0
1	55099316	.	T	C	3	5	8	0	1	9	0	0
1	55099411	.	G	A	4	5	9	0	0	9	0	0
1	55099880	.	C	G	5	4	9	0	0	9	0	0
1	55100378	.	G	A	0	12	12	0	4	16	0	0
1	55100397	.	G	C	10	6	16	0	1	17	0	0
1	55100422	.	T	A	4	7	11	0	0	11	0	0
1	55101439	.	C	A	3	2	5	0	0	5	0	0
1	55103163	.	A	C	4	8	12	0	0	12	0	0
1	55109717	.	A	T	6	8	14	0	2	16	0	0
1	55126635	.	G	A	3	2	5	0	0	5	0	0
1	55127910	.	C	T	1	0	1	0	1	2	0	0
1	55131337	.	A	T	5	5	10	0	2	12	0	0
1	55131359	.	A	T	4	4	8	0	1	9	0	0
1	55161252	.	T	C	6	0	6	0	7	13	0	0
1	55169244	.	G	C	3	5	8	0	1	9	0	0
1	55169260	.	G	A	7	4	11	0	0	11	0	0
1	55169349	.	G	C	9	8	17	0	1	18	0	0
1	55169658	.	T	A	18	8	26	0	0	26	0	0
1	55169699	.	T	A	12	6	18	0	0	18	0	0
1	55170051	.	T	A	8	8	16	0	0	16	0	0
1	55170161	.	C	A	3	5	8	0	2	10	0	0
1	55170750	.	T	C	2	0	2	0	8	10	0	0
1	55171249	.	G	A	9	4	13	0	2	15	0	0
1	55179434	.	C	T	2	4	6	0	0	6	0	0
1	55179470	.	C	T	2	2	4	0	1	5	0	0
1	55182656	.	T	C	0	3	3	0	0	3	0	0
1	55183038	.	T	C	3	2	5	0	0	5	0	0
1	55191675	.	A	G	2	3	5	0	0	5	0	0
1	55229767	.	T	C	0	1	1	0	0	1	0	0
1	55745816	.	C	T	5	2	7	0	0	7	0	0
1	55745880	.	T	A	1	2	3	0	0	3	0	0
1	55746071	.	C	T	1	4	5	0	0	5	0	0
1	55776909	.	A	C	10	7	17	0	3	21	1	0
1	55785527	.	C	A	0	19	19	0	34	53	0	0
1	55785654	.	C	T	13	24	37	1	0	38	0	0
1	55785697	.	C	T	1	3	4	0	0	4	0	0
1	55817658	.	T	C	6	0	6	0	3	9	0	0
1	55817661	.	A	T	6	3	9	0	0	9	0	0
1	55817722	.	G	T	6	1	7	0	1	8	0	0
1	55817728	.	C	T	5	3	8	0	0	8	0	0
1	55818073	.	T	C	2	5	7	0	0	7	0	0
1	55818218	.	A	T	4	4	8	0	0	8	0	0
1	55818319	.	T	C	3	3	6	0	2	8	0	0
1	55833276	.	C	T	2	4	6	0	0	6	0	0
1	55833281	.	C	T	1	3	4	0	1	5	0	0
1	55839132	.	G	C	1	3	4	0	0	4	0	0
1	55843902	.	C	T	14	30	44	0	1	45	0	0
1	55843968	.	G	A	21	20	41	0	2	43	0	0
1	55844044	.	T	A	12	24	36	0	0	36	0	0
1	55844401	.	A	G	16	25	41	0	0	41	0	0
1	55853320	.	G	A	5	5	10	0	0	10	0	0
1	55872892	.	C	G	8	3	11	0	1	12	0	0
1	55873073	.	C	T	6	4	10	0	0	10	0	0
1	55878400	.	C	T	1	4	5	0	7	12	0	0
1	55878496	.	T	C	3	0	3	0	5	8	0	0
1	55878624	.	T	A	3	5	8	0	1	9	0	0
1	55878626	.	A	C	4	5	9	0	0	9	0	0
1	55885148	.	C	T	0	1	1	0	6	7	0	0
1	55888583	.	C	A	3	2	5	0	0	5	0	0
1	56217429	.	T	G	0	2	2	0	0	2	0	0
1	56217450	.	G	T	1	2	3	0	0	3	0	0
1	56217510	.	A	G	26	22	48	0	3	51	0	0
1	56217925	.	G	A	29	32	61	0	8	69	0	0
1	56218141	.	A	G	31	32	63	0	7	70	0	0
1	56218189	.	C	T	3	23	26	0	40	66	0	0
1	56424791	.	C	T	0	0	0	0	2	2	0	0
1	56424794	.	T	C	2	0	2	0	0	2	0	0
1	56425252	.	A	G	1	1	2	0	0	2	0	0
1	56428320	.	G	A	1	1	2	0	0	2	0	0
1	57278610	.	T	G	2	3	5	0	0	5	0	0
1	57278669	.	A	G	0	5	5	0	1	6	0	0
1	57278690	.	G	A	2	3	5	0	0	5	0	0
1	57278714	.	C	T	0	4	4	0	4	8	0	0
1	57278942	.	A	G	1	4	5	0	0	5	0	0
1	57280400	.	G	A	1	3	4	0	0	4	0	0
1	57311941	.	C	A	0	2	2	0	0	2	0	0
1	57311952	.	A	G	0	0	0	0	1	1	0	0
1	57338226	.	G	A	0	2	2	0	2	4	0	0
1	57338268	.	G	A	0	1	1	0	0	1	0	0
1	58547300	.	A	G	2	2	4	0	0	4	0	0
1	58592805	.	C	A	1	1	2	0	1	3	0	0
1	58593685	.	A	C	1	3	4	0	0	4	0	0
1	58593699	.	A	G	1	4	5	0	0	5	0	0
1	58593768	.	T	G	6	5	11	0	0	11	0	0
1	58593833	.	C	A	4	4	8	0	0	8	0	0
1	58593835	.	T	C	4	4	8	0	0	8	0	0
1	58593912	.	C	T	5	5	10	0	0	10	0	0
1	58593976	.	G	A	8	6	14	0	1	15	0	0
1	58594414	.	C	T	0	3	3	0	6	9	0	0
1	58594442	.	T	C	0	5	5	0	2	7	0	0
1	58594689	.	A	G	8	2	10	0	0	10	0	0
1	58594693	.	C	G	4	4	8	0	2	10	0	0
1	58595018	.	C	T	3	5	8	0	0	8	0	0
1	58598663	.	G	T	3	3	6	0	0	6	0	0
1	58612033	.	A	G	0	2	2	0	0	2	0	0
1	58612243	.	T	G	1	3	4	0	0	4	0	0
1	58612247	.	A	G	1	3	4	0	0	4	0	0
1	58612726	.	G	A	0	3	3	0	2	5	0	0
1	58612762	.	A	G	4	5	9	0	0	9	0	0
1	58612915	.	A	T	2	3	5	0	1	6	0	0
1	58613091	.	A	C	2	3	5	0	0	5	0	0
1	58613126	.	T	A	1	2	3	0	0	3	0	0
1	58617870	.	C	T	1	3	4	0	0	4	0	0
1	58618414	.	G	A	2	2	4	0	0	4	0	0
1	58631374	.	A	G	2	3	5	0	0	5	0	0
1	58631509	.	A	G	2	4	6	0	0	6	0	0
1	58631559	.	A	T	4	2	6	0	0	6	0	0
1	58631695	.	A	T	1	6	7	0	0	7	0	0
1	58631713	.	A	G	2	0	2	0	3	5	0	0
1	58677909	.	A	C	1	2	3	0	0	3	0	0
1	58677993	.	A	G	4	4	8	0	0	8	0	0
1	58678017	.	T	C	4	3	7	0	0	7	0	0
1	58678077	.	T	A	2	2	4	0	0	4	0	0
1	58680432	.	T	A	0	2	2	0	0	2	0	0
1	58680469	.	C	A	6	3	9	0	0	9	0	0
1	58680499	.	C	A	5	6	11	0	1	12	0	0
1	58680517	.	T	C	7	5	12	0	1	13	0	0
1	58680553	.	C	A	14	4	18	0	1	19	0	0
1	58680566	.	T	C	15	4	19	0	0	19	0	0
1	58680591	.	C	T	14	6	20	0	3	23	0	0
1	58680792	.	T	C	6	9	15	0	2	17	0	0
1	58681095	.	A	G	6	7	13	0	0	13	0	0
1	58681278	.	A	C	10	15	25	0	0	25	0	0
1	58681419	.	A	T	7	15	22	0	1	25	2	0
1	58850562	.	C	T	1	9	10	0	1	11	0	0
1	58850622	.	T	C	4	3	7	0	0	7	0	0
1	58982147	.	G	A	0	5	5	0	7	12	0	0
1	58982195	.	C	G	7	5	12	0	0	12	0	0
1	58984239	.	G	T	0	0	0	0	1	1	0	0
1	58984368	.	G	A	0	0	0	0	4	4	0	0
1	58984478	.	T	C	0	4	4	0	0	4	0	0
1	58984640	.	C	T	5	1	6	0	0	6	0	0
1	58985530	.	G	A	8	10	18	0	1	19	0	0
1	58985579	.	T	G	10	9	19	0	2	21	0	0
1	58985730	.	C	A	8	5	13	0	2	15	0	0
1	58999960	.	T	A	0	2	2	0	0	2	0	0
1	59009732	.	A	G	14	1	15	0	17	32	0	0
1	59010618	.	G	A	1	2	3	0	0	3	0	0
1	59018886	.	C	T	0	6	6	0	6	12	0	0
1	59019006	.	C	G	4	5	9	0	0	9	0	0
1	59019084	.	T	A	3	8	11	0	1	12	0	0
1	59019093	.	A	G	3	9	12	0	0	12	0	0
1	59062665	.	T	C	27	18	45	0	2	47	0	0
1	59065889	.	G	A	0	11	11	0	21	32	0	0
1	59141415	.	C	A	2	2	4	0	1	5	0	0
1	59141550	.	T	C	2	1	3	0	0	3	0	0
1	59141556	.	G	C	2	1	3	0	0	3	0	0
1	59147468	.	C	G	1	0	1	0	6	7	0	0
1	59148260	.	T	C	0	3	3	0	0	3	0	0
1	59148341	.	T	C	2	2	4	0	1	5	0	0
1	59149117	.	C	T	8	12	20	0	0	20	0	0
1	59149968	.	T	C	7	17	24	0	2	26	0	0
1	59150450	.	A	G	11	8	19	0	0	19	0	0
1	59150482	.	G	T	11	7	18	0	1	19	0	0
1	59150518	.	T	C	12	10	22	0	0	22	0	0
1	59150559	.	T	G	16	7	23	0	0	23	0	0
1	59150583	.	T	A	9	10	19	0	3	22	0	0
1	59150683	.	T	C	5	16	21	0	1	22	0	0
1	59150737	.	T	C	8	6	14	0	1	15	0	0
1	59150762	.	G	T	11	7	18	0	0	18	0	0
1	59150781	.	T	C	12	12	24	0	0	24	0	0
1	59157536	.	T	C	1	3	4	0	0	4	0	0
1	59157977	.	A	C	6	6	12	0	0	12	0	0
1	59158035	.	C	A	5	8	13	0	1	14	0	0
1	59158062	.	A	T	6	5	11	0	2	13	0	0
1	59158070	.	G	A	6	4	10	0	1	11	0	0
1	59172876	.	A	G	7	9	16	0	0	16	0	0
1	59172900	.	A	G	6	10	16	0	0	16	0	0
1	59172969	.	G	A	9	12	21	0	1	22	0	0
1	59173358	.	G	T	6	5	11	0	1	12	0	0
1	59173701	.	G	T	1	0	1	0	0	1	0	0
1	59173758	.	A	G	8	4	12	0	1	13	0	0
1	59173866	.	T	G	10	7	17	0	7	24	0	0
1	59173896	.	T	C	9	1	10	0	15	25	0	0
1	59174387	.	A	G	5	5	10	0	0	10	0	0
1	59174408	.	G	A	2	5	7	0	1	8	0	0
1	59174492	.	T	G	3	6	9	0	2	11	0	0
1	59174525	.	A	C	3	5	8	0	0	8	0	0
1	59174576	.	C	T	3	3	6	0	0	6	0	0
1	59174797	.	A	C	6	5	11	0	0	11	0	0
1	59174962	.	T	C	8	9	17	0	0	17	0	0
1	59175511	.	T	C	7	8	15	0	1	16	0	0
1	59175572	.	A	G	7	5	12	0	0	12	0	0
1	59175626	.	G	A	3	2	5	0	0	5	0	0
1	59175635	.	G	A	3	4	7	0	0	7	0	0
1	59175740	.	G	T	5	4	9	0	0	9	0	0
1	59175983	.	T	C	2	2	4	0	0	4	0	0
1	59218477	.	C	G	0	2	2	0	5	7	0	0
1	59218594	.	A	G	9	13	22	0	5	27	0	0
1	59226049	.	T	C	7	6	13	0	2	15	0	0
1	59226052	.	A	G	7	5	12	0	5	17	0	0
1	59226374	.	A	G	1	1	2	0	0	2	0	0
1	59228569	.	A	C	6	0	6	0	8	14	0	0
1	59229211	.	G	A	5	7	12	0	0	12	0	0
1	59232206	.	A	G	7	7	14	0	1	15	0	0
1	59232509	.	G	A	7	6	13	0	1	14	0	0
1	59235016	.	T	G	3	0	3	0	0	3	0	0
1	59238037	.	T	C	1	3	4	0	0	4	0	0
1	59238038	.	A	C	1	3	4	0	0	4	0	0
1	59244312	.	A	G	15	10	25	0	1	26	0	0
1	59244635	.	A	T	12	21	33	0	2	35	0	0
1	59244916	.	T	A	43	18	61	0	2	63	0	0
1	59244928	.	C	T	37	23	60	0	3	63	0	0
1	59245142	.	C	G	26	33	59	0	6	66	1	0
1	59245658	.	G	A	5	6	11	0	1	12	0	0
1	59245873	.	T	C	3	3	6	0	1	7	0	0
1	59245900	.	C	T	9	8	17	0	0	17	0	0
1	59246318	.	A	G	2	3	5	0	0	5	0	0
1	59246320	.	G	A	1	3	4	0	1	5	0	0
1	59246363	.	A	T	3	2	5	0	0	5	0	0
1	59247893	.	T	G	11	9	20	0	2	22	0	0
1	59247944	.	C	T	6	4	10	0	0	10	0	0
1	59248138	.	T	A	14	7	21	0	0	21	0	0
1	59251658	.	C	G	7	5	12	0	0	12	0	0
1	59298069	.	T	C	0	1	1	0	0	1	0	0
1	59298207	.	C	T	1	1	2	0	0	2	0	0
1	59298261	.	T	G	1	1	2	0	0	2	0	0
1	59302210	.	G	A	0	2	2	0	3	5	0	0
1	59302276	.	C	T	4	9	13	0	0	13	0	0
1	59302372	.	T	G	3	10	13	0	1	14	0	0
1	59302523	.	A	T	1	3	4	0	0	4	0	0
1	59303024	.	C	A	5	7	12	0	0	12	0	0
1	59303220	.	T	G	2	3	5	0	1	6	0	0
1	59303334	.	A	G	1	4	5	0	0	5	0	0
1	59304816	.	C	T	1	3	4	0	0	4	0	0
1	59305047	.	C	T	1	3	4	0	16	20	0	0
1	59305200	.	T	C	5	6	11	0	2	13	0	0
1	59305895	.	C	T	1	2	3	0	0	3	0	0
1	59314966	.	A	G	0	2	2	0	0	2	0	0
1	59324067	.	T	C	7	7	14	0	1	15	0	0
1	59328287	.	C	T	3	7	10	0	1	11	0	0
1	59328486	.	C	T	5	5	10	0	1	11	0	0
1	59330169	.	C	T	6	6	12	0	0	12	0	0
1	59409321	.	C	G	0	1	1	0	0	1	0	0
10	22543	.	T	A	0	4	4	0	1	5	0	0
10	22672	.	A	T	3	7	10	0	0	10	0	0
10	23959	.	C	T	0	1	1	0	0	1	0	0
10	24014	.	G	A	3	3	6	0	0	6	0	0
10	27705	.	A	G	6	3	9	0	1	10	0	0
10	27787	.	G	T	0	7	7	0	5	12	0	0
10	27987	.	A	T	2	4	6	0	1	7	0	0
10	32998	.	G	T	2	3	5	0	2	7	0	0
10	33427	.	G	A	10	3	13	0	3	16	0	0
10	33634	.	G	T	7	2	9	0	3	12	0	0
10	33689	.	G	C	2	6	8	0	0	8	0	0
10	34028	.	C	T	1	5	6	0	0	6	0	0
10	34233	.	G	A	1	3	4	0	0	4	0	0
10	34401	.	G	A	1	2	3	0	0	3	0	0
10	53930	.	T	G	7	3	10	0	1	11	0	0
10	55594	.	G	A	3	12	15	0	0	15	0	0
10	55627	.	C	T	0	11	11	0	4	15	0	0
10	55665	.	A	C	2	4	6	0	0	6	0	0
10	55666	.	G	C	2	0	2	0	4	6	0	0
10	62468	.	C	G	17	15	32	0	2	34	0	0
10	66886	.	A	G	7	4	11	0	0	11	0	0
10	66967	.	A	G	6	2	8	0	0	8	0	0
10	81276	.	C	T	7	12	19	0	1	20	0	0
10	81285	.	C	T	13	10	23	0	1	24	0	0
10	81348	.	C	T	18	16	34	0	5	39	0	0
10	81444	.	C	T	15	8	23	0	5	28	0	0
10	81579	.	G	T	1	5	6	0	12	18	0	0
10	82025	.	A	G	10	6	16	1	0	17	0	0
10	82336	.	A	G	23	13	36	0	1	37	0	0
10	83401	.	G	A	3	5	8	0	1	9	0	0
10	85404	.	G	A	4	3	7	0	0	7	0	0
10	85419	.	C	T	0	3	3	0	3	6	0	0
10	85571	.	G	C	5	8	13	0	1	14	0	0
10	85585	.	C	T	6	9	15	0	0	15	0	0
10	85927	.	A	G	5	5	10	0	0	10	0	0
10	85948	.	G	C	4	5	9	0	0	9	0	0
10	87353	.	G	A	2	0	2	0	1	3	0	0
10	87592	.	C	T	0	7	7	0	5	12	0	0
10	87606	.	G	A	4	5	9	0	0	9	0	0
10	115088	.	G	A	9	14	23	0	0	23	0	0
10	115493	.	G	T	8	10	18	0	1	19	0	0
10	115506	.	T	G	7	7	14	0	1	15	0	0
10	115615	.	T	C	10	11	21	0	1	22	0	0
10	115626	.	C	A	10	12	22	0	0	22	0	0
10	115679	.	A	T	5	13	18	0	1	19	0	0
10	115773	.	A	G	7	9	16	0	1	17	0	0
10	115820	.	T	C	6	11	17	0	2	19	0	0
10	115874	.	T	A	13	5	18	0	0	18	0	0
10	116020	.	T	G	3	3	6	0	0	6	0	0
10	116566	.	A	T	0	2	2	0	0	2	0	0
10	134661	.	C	T	0	9	9	0	20	29	0	0
10	134749	.	C	T	0	8	8	0	9	17	0	0
10	187823	.	C	T	6	4	10	0	0	10	0	0
10	190917	.	C	T	5	4	9	0	1	10	0	0
10	193853	.	G	A	3	6	9	0	3	12	0	0
10	196307	.	C	T	4	12	16	0	1	17	0	0
10	196426	.	T	A	13	14	27	0	1	29	1	0
10	196429	.	A	T	14	14	28	0	2	30	0	0
10	196524	.	A	G	7	0	7	0	7	14	0	0
10	196563	.	C	G	4	7	11	0	1	12	0	0
10	196670	.	G	A	18	19	37	0	2	39	0	0
10	207078	.	G	T	5	2	7	0	0	7	0	0
10	207128	.	G	A	7	8	15	0	1	16	0	0
10	207783	.	G	A	2	1	3	0	1	4	0	0
10	208034	.	A	T	16	16	32	0	0	32	0	0
10	208104	.	G	A	4	4	8	0	1	9	0	0
10	208674	.	G	A	5	4	9	0	1	10	0	0
10	208714	.	C	T	0	8	8	0	8	16	0	0
10	210568	.	A	G	1	9	10	0	0	10	0	0
10	210598	.	T	C	2	5	7	0	0	7	0	0
10	294113	.	G	A	1	5	6	0	0	6	0	0
10	296617	.	C	T	0	2	2	0	1	3	0	0
10	308288	.	T	C	6	2	8	0	0	8	0	0
10	311901	.	A	G	5	4	9	0	2	11	0	0
10	313332	.	T	C	1	2	3	0	2	5	0	0
10	474834	.	T	C	1	1	2	0	0	2	0	0
10	474896	.	T	C	0	2	2	0	1	3	0	0
10	478304	.	T	G	4	6	10	0	1	11	0	0
10	478388	.	G	A	0	13	13	0	7	20	0	0
10	478508	.	T	C	3	13	16	0	1	17	0	0
10	478661	.	C	T	9	19	28	0	2	30	0	0
10	478724	.	G	A	16	12	28	0	0	28	0	0
10	478742	.	C	T	14	12	26	0	0	26	0	0
10	479063	.	A	G	3	3	6	0	1	7	0	0
10	482335	.	G	A	5	6	11	0	4	15	0	0
10	482371	.	T	G	15	14	29	0	1	30	0	0
10	486146	.	G	A	11	11	22	0	3	25	0	0
10	486153	.	T	C	15	11	26	0	1	27	0	0
10	500114	.	A	G	4	0	4	0	7	11	0	0
10	500168	.	G	A	0	21	21	0	13	34	0	0
10	500473	.	T	C	6	6	12	0	1	13	0	0
10	501833	.	C	T	4	4	8	0	1	9	0	0
10	501899	.	G	C	8	10	18	0	3	21	0	0
10	505282	.	A	G	11	19	30	0	1	31	0	0
10	505316	.	G	A	0	27	27	0	11	38	0	0
10	577791	.	G	C	1	1	2	0	0	2	0	0
10	579989	.	A	G	1	0	1	0	5	6	0	0
10	580088	.	G	T	0	3	3	0	6	9	0	0
10	580092	.	G	A	4	3	7	0	2	9	0	0
10	586563	.	C	A	1	2	3	0	0	3	0	0
10	589487	.	G	A	8	7	15	0	1	16	0	0
10	589655	.	T	C	4	2	6	0	1	7	0	0
10	589789	.	G	A	0	4	4	0	7	11	0	0
10	589810	.	A	T	6	3	9	0	0	9	0	0
10	590273	.	A	C	4	6	10	0	0	10	0	0
10	590314	.	G	A	0	4	4	0	4	8	0	0
10	590356	.	A	G	0	5	5	0	1	6	0	0
10	590956	.	A	T	4	3	7	0	1	8	0	0
10	590957	.	A	G	5	3	8	0	0	8	0	0
10	590997	.	C	T	5	5	10	0	0	10	0	0
10	591017	.	T	C	11	8	19	0	2	21	0	0
10	591219	.	T	G	7	1	8	0	8	16	0	0
10	591220	.	C	T	8	8	16	0	0	16	0	0
10	591434	.	G	A	1	4	5	0	0	5	0	0
10	591476	.	A	G	3	0	3	0	11	14	0	0
10	591567	.	T	A	12	7	19	0	0	19	0	0
10	591634	.	T	G	8	7	15	0	1	16	0	0
10	591716	.	C	G	6	6	12	0	0	12	0	0
10	591720	.	G	A	0	5	5	0	6	11	0	0
10	600448	.	T	C	0	4	4	0	0	4	0	0
10	600450	.	T	C	0	3	3	0	1	4	0	0
10	600584	.	G	A	3	4	7	0	0	7	0	0
10	1056460	.	T	C	1	3	4	0	0	4	0	0
10	1075972	.	G	A	0	2	2	0	4	6	0	0
10	1076044	.	C	T	5	4	9	0	1	10	0	0
10	1076116	.	C	T	6	9	15	0	1	16	0	0
10	1107441	.	G	A	0	9	9	0	8	17	0	0
10	1107460	.	C	T	10	12	22	0	0	22	0	0
10	1107540	.	C	A	12	11	23	0	0	24	1	0
10	1479456	.	G	A	2	4	6	0	0	6	0	0
10	1541357	.	G	C	5	0	5	0	6	11	0	0
10	1541359	.	T	C	3	0	3	0	8	11	0	0
10	1543805	.	C	G	0	10	10	0	10	20	0	0
10	1543848	.	G	C	5	0	5	0	4	9	0	0
10	1549013	.	C	A	0	2	2	0	0	2	0	0
10	1549088	.	C	T	1	13	14	0	8	22	0	0
10	1549494	.	G	A	11	8	19	0	6	25	0	0
10	1549714	.	G	A	6	5	11	0	2	13	0	0
10	1549769	.	A	G	5	2	7	0	0	7	0	0
10	2843022	.	G	A	0	2	2	0	0	2	0	0
10	2846887	.	C	T	2	1	3	0	0	3	0	0
10	2850416	.	G	A	2	2	4	1	0	5	0	0
10	2850491	.	T	G	6	0	6	0	1	7	0	0
10	2850494	.	T	A	6	2	8	0	0	8	0	0
10	2850608	.	G	C	1	3	4	0	0	4	0	0
10	2850614	.	G	T	0	3	3	0	2	5	0	0
10	2850651	.	T	A	4	2	6	0	0	6	0	0
10	2850710	.	C	T	2	4	6	0	0	6	0	0
10	2856558	.	G	A	2	4	6	0	2	8	0	0
10	2856584	.	G	T	5	6	11	0	0	11	0	0
10	2860806	.	G	A	2	1	3	0	1	4	0	0
10	2861679	.	T	C	0	0	0	0	5	5	0	0
10	2862538	.	T	A	0	3	3	0	1	4	0	0
10	2869202	.	G	A	1	2	3	0	1	4	0	0
10	2885852	.	C	T	0	5	5	0	0	5	0	0
10	2891893	.	C	T	2	4	6	0	0	6	0	0
10	2891905	.	G	A	3	6	9	0	0	9	0	0
10	2891981	.	A	T	6	4	10	0	0	10	0	0
10	2894451	.	G	A	0	5	5	0	4	9	0	0
10	2897110	.	A	C	6	11	17	0	0	17	0	0
10	2897720	.	T	A	5	4	9	0	0	9	0	0
10	2897911	.	G	T	2	2	4	0	0	4	0	0
10	2898212	.	T	G	3	2	5	0	1	6	0	0
10	2898213	.	C	G	2	3	5	0	1	6	0	0
10	2898346	.	T	A	4	7	11	0	1	12	0	0
10	2898390	.	A	T	1	2	3	0	0	3	0	0
10	2906893	.	T	C	0	1	1	0	0	1	0	0
10	2914945	.	A	G	1	1	2	0	0	2	0	0
10	2914955	.	G	A	0	2	2	0	1	3	0	0
10	2915412	.	A	G	1	4	5	0	0	5	0	0
10	2915426	.	C	T	0	4	4	0	2	6	0	0
10	2920987	.	C	G	1	2	3	0	0	3	0	0
10	2925056	.	A	T	4	6	10	0	0	10	0	0
10	2925089	.	A	G	6	4	10	0	0	10	0	0
10	2925196	.	T	A	6	4	10	0	0	10	0	0
10	2925379	.	G	T	3	5	8	0	0	8	0	0
10	2930577	.	C	A	1	2	3	0	0	3	0	0
10	3024637	.	C	G	1	2	3	0	0	3	0	0
10	3024706	.	C	T	3	5	8	0	2	10	0	0
10	3026264	.	A	C	5	6	11	0	2	13	0	0
10	3031670	.	T	C	2	1	3	0	6	9	0	0
10	3032072	.	C	T	2	5	7	0	1	8	0	0
10	3133204	.	T	A	7	7	14	0	0	14	0	0
10	3133251	.	G	A	7	4	11	0	2	13	0	0
10	3133598	.	A	C	11	10	21	0	1	22	0	0
10	3154684	.	A	G	2	2	4	0	0	4	0	0
10	3155314	.	T	C	1	3	4	0	0	4	0	0
10	3189081	.	G	A	1	2	3	0	0	3	0	0
10	3192786	.	G	A	2	3	5	0	0	5	0	0
10	3194054	.	T	C	1	1	2	0	0	2	0	0
10	3197593	.	A	G	1	0	1	0	0	1	0	0
10	3201871	.	G	A	1	2	3	0	0	3	0	0
10	3204658	.	A	G	0	1	1	0	0	1	0	0
10	3207591	.	A	G	1	2	3	0	0	3	0	0
10	3207612	.	A	G	1	2	3	0	2	5	0	0
10	3207646	.	C	T	0	3	3	0	1	4	0	0
10	3311737	.	T	G	4	4	8	0	0	8	0	0
10	3311845	.	G	A	1	3	4	0	0	4	0	0
10	3317675	.	C	T	11	1	12	0	0	12	0	0
10	3317800	.	C	A	9	7	16	0	1	17	0	0
10	3317823	.	G	T	9	9	18	0	0	18	0	0
10	3318112	.	G	C	7	4	11	0	0	11	0	0
10	3318322	.	A	T	2	4	6	0	0	6	0	0
10	3318358	.	G	T	2	4	6	0	0	6	0	0
10	3318424	.	T	C	5	6	11	0	0	11	0	0
10	3318490	.	G	A	0	6	6	0	5	11	0	0
10	3318502	.	A	G	3	7	10	0	3	13	0	0
10	3318830	.	G	T	0	2	2	0	0	2	0	0
10	3319029	.	A	T	8	3	11	0	0	11	0	0
10	3319035	.	C	T	7	1	8	0	2	10	0	0
10	3319352	.	A	G	4	8	12	0	1	13	0	0
10	3319970	.	G	A	8	7	15	0	0	15	0	0
10	3319981	.	A	T	8	7	15	0	0	15	0	0
10	3320072	.	T	G	5	10	15	0	1	16	0	0
10	3320229	.	G	A	11	13	24	0	1	25	0	0
10	3320287	.	T	G	21	6	27	0	0	27	0	0
10	3320355	.	A	T	9	12	21	0	3	24	0	0
10	3320561	.	A	T	14	9	23	0	2	25	0	0
10	3320705	.	G	A	6	9	15	0	2	17	0	0
10	3320834	.	A	C	14	10	24	0	2	26	0	0
10	3320850	.	C	T	11	10	21	0	1	22	0	0
10	3321262	.	A	G	11	31	42	0	1	43	0	0
10	3322004	.	C	G	8	15	23	0	2	25	0	0
10	3322012	.	C	T	9	19	28	0	0	28	0	0
10	3322276	.	G	C	8	10	18	0	2	20	0	0
10	3341412	.	C	T	1	1	2	0	0	2	0	0
10	3342716	.	G	T	0	0	0	0	1	1	0	0
10	3342795	.	T	C	1	3	4	0	0	4	0	0
10	3355651	.	T	C	2	5	7	0	0	7	0	0
10	3366199	.	C	T	0	2	2	0	4	6	0	0
10	3367810	.	C	T	1	0	1	0	0	1	0	0
10	3370604	.	G	A	3	2	5	0	0	5	0	0
10	3375418	.	T	C	0	1	1	0	1	2	0	0
10	3377195	.	G	A	4	1	5	0	0	5	0	0
10	3398030	.	G	A	4	3	7	0	0	7	0	0
10	3400093	.	T	C	1	1	2	0	0	2	0	0
10	3400126	.	A	T	3	5	8	0	1	9	0	0
10	3400216	.	C	T	3	3	6	0	0	6	0	0
10	3400225	.	T	C	2	2	4	0	0	4	0	0
10	3403832	.	C	A	2	2	4	0	1	5	0	0
10	3420148	.	G	A	19	21	40	0	0	40	0	0
10	3420358	.	T	C	12	6	18	0	1	19	0	0
10	3420480	.	C	G	13	14	27	0	4	31	0	0
10	3420487	.	T	C	16	1	17	0	19	36	0	0
10	3441753	.	T	A	1	5	6	0	0	6	0	0
10	3441973	.	T	C	3	2	5	0	0	5	0	0
10	3441980	.	T	C	3	2	5	0	1	6	0	0
10	3445818	.	C	T	3	9	12	0	0	12	0	0
10	3450825	.	G	C	1	2	3	0	0	3	0	0
10	3450861	.	A	G	5	2	7	0	1	8	0	0
10	3450863	.	A	T	5	2	7	0	1	8	0	0
10	3451349	.	T	A	5	3	8	0	2	10	0	0
10	3452007	.	A	T	1	4	5	0	0	5	0	0
10	3452045	.	G	A	3	1	4	0	2	6	0	0
10	3452073	.	A	G	6	8	14	0	0	14	0	0
10	3452183	.	G	A	3	6	9	0	1	10	0	0
10	3452185	.	T	A	3	7	10	0	0	10	0	0
10	3452314	.	T	C	7	4	11	0	2	13	0	0
10	3532171	.	G	T	1	2	3	0	0	3	0	0
10	3532279	.	A	G	2	0	2	0	1	3	0	0
10	3969956	.	T	C	1	3	4	0	0	4	0	0
10	4029813	.	C	T	0	1	1	0	0	1	0	0
10	4030349	.	C	T	2	2	4	0	0	4	0	0
10	4030352	.	C	A	2	2	4	0	0	4	0	0
10	4034098	.	T	C	5	5	10	0	0	10	0	0
10	4037287	.	G	A	1	1	2	0	0	2	0	0
10	4037794	.	T	C	5	4	9	0	0	9	0	0
10	4038697	.	C	T	6	7	13	0	0	13	0	0
10	4038721	.	G	A	0	6	6	0	7	13	0	0
10	4038772	.	G	A	10	10	20	0	1	21	0	0
10	4039094	.	G	A	11	8	19	0	2	21	0	0
10	4039123	.	C	T	13	11	24	0	3	27	0	0
10	4039129	.	C	T	16	10	26	0	1	27	0	0
10	4039315	.	A	T	10	14	24	0	1	25	0	0
10	4039636	.	T	C	9	14	23	0	0	23	0	0
10	4039714	.	T	C	12	10	22	0	1	23	0	0
10	4098235	.	C	T	3	4	7	0	0	7	0	0
10	4098355	.	A	T	2	5	7	0	0	7	0	0
10	4240887	.	T	C	7	12	19	0	1	20	0	0
10	4240899	.	C	T	6	11	17	0	0	17	0	0
10	4253636	.	C	T	7	8	15	0	2	17	0	0
10	4279587	.	C	T	1	3	4	0	0	4	0	0
10	4279800	.	A	G	1	5	6	0	0	6	0	0
10	4369847	.	C	G	2	2	4	0	0	4	0	0
10	4369862	.	G	A	2	2	4	0	0	4	0	0
10	4501817	.	A	G	1	1	2	0	0	2	0	0
10	4502929	.	C	T	3	5	8	0	0	8	0	0
10	4503291	.	G	T	3	4	7	0	0	7	0	0
10	4503606	.	A	T	1	0	1	0	0	1	0	0
10	4508518	.	G	T	0	10	10	0	18	28	0	0
10	4940883	.	G	A	2	5	7	0	2	9	0	0
10	4950854	.	G	A	4	6	10	0	1	11	0	0
10	4950857	.	T	C	5	7	12	0	0	12	0	0
10	4950914	.	T	C	4	0	4	0	8	12	0	0
10	4953443	.	C	T	5	4	9	0	1	10	0	0
10	4953461	.	C	A	6	4	10	0	0	10	0	0
10	4953987	.	A	C	1	0	1	0	3	4	0	0
10	4954125	.	T	C	0	1	1	0	0	1	0	0
10	4956942	.	C	T	0	7	7	0	0	7	0	0
10	4956987	.	C	T	0	6	6	0	4	10	0	0
10	4966683	.	G	A	0	3	3	0	5	8	0	0
10	4968900	.	G	C	1	2	3	0	0	3	0	0
10	4969014	.	T	A	6	11	17	0	1	18	0	0
10	4969036	.	T	G	6	0	6	0	10	16	0	0
10	4969069	.	C	A	3	13	16	0	0	16	0	0
10	5000719	.	C	T	1	8	9	0	14	23	0	0
10	5000753	.	C	T	1	10	11	0	19	30	0	0
10	5004215	.	C	T	7	2	9	0	0	9	0	0
10	5010287	.	G	A	9	11	20	0	1	21	0	0
10	5010344	.	T	G	13	16	29	0	1	30	0	0
10	5010407	.	G	A	0	4	4	0	1	5	0	0
10	5016797	.	G	A	20	26	46	0	3	49	0	0
10	5016917	.	C	G	23	19	42	0	2	44	0	0
10	5016922	.	A	G	24	18	42	0	3	45	0	0
10	5020320	.	G	A	26	20	46	0	0	46	0	0
10	5020326	.	T	C	20	19	39	0	3	42	0	0
10	5024410	.	C	T	20	23	43	0	4	47	0	0
10	5025848	.	C	A	5	5	10	0	0	10	0	0
10	5026058	.	C	T	2	1	3	0	0	3	0	0
10	5028877	.	A	G	3	6	9	0	0	9	0	0
10	5031869	.	T	C	2	0	2	0	0	2	0	0
10	5036521	.	G	A	1	12	13	0	13	26	0	0
10	5036522	.	A	G	14	12	26	0	0	26	0	0
10	5036729	.	C	T	12	9	21	0	3	24	0	0
10	5037119	.	T	A	11	8	19	0	0	19	0	0
10	5037147	.	C	T	5	7	12	0	0	12	0	0
10	5037181	.	T	G	7	6	13	0	0	13	0	0
10	5037260	.	A	C	2	11	13	0	1	14	0	0
10	5042113	.	C	T	7	3	10	0	0	10	0	0
10	5042469	.	G	A	1	1	2	0	0	2	0	0
10	5092764	.	T	C	3	8	11	0	1	13	1	0
10	5092772	.	A	G	4	9	13	0	0	13	0	0
10	5093157	.	T	C	7	12	19	0	2	21	0	0
10	5093222	.	A	G	11	5	16	0	0	16	0	0
10	5093240	.	C	A	7	4	11	0	0	11	0	0
10	5093274	.	A	G	1	4	5	0	0	5	0	0
10	5093418	.	G	A	3	3	6	0	0	6	0	0
10	5093434	.	C	T	0	1	1	0	1	2	0	0
10	5094649	.	C	A	2	5	7	0	0	7	0	0
10	5094778	.	G	T	3	3	6	0	0	6	0	0
10	5097478	.	G	A	4	3	7	0	1	8	0	0
10	5097520	.	A	G	6	4	10	0	1	11	0	0
10	5113791	.	G	T	1	2	3	0	0	3	0	0
10	5146688	.	G	A	1	5	6	0	1	7	0	0
10	5147130	.	A	G	1	4	5	0	0	5	0	0
10	5147141	.	T	C	0	5	5	0	1	6	0	0
10	5203569	.	G	A	1	1	2	0	0	2	0	0
10	5216204	.	T	C	3	1	4	0	2	6	0	0
10	5216249	.	A	G	1	3	4	0	1	5	0	0
10	5220608	.	C	T	5	4	9	0	0	9	0	0
10	5220940	.	T	A	3	9	12	0	1	13	0	0
10	5220992	.	C	T	4	6	10	0	2	12	0	0
10	5220997	.	C	A	6	5	11	0	2	13	0	0
10	5221039	.	G	A	7	6	13	0	1	14	0	0
10	5221238	.	C	A	3	5	8	0	0	8	0	0
10	5221292	.	C	A	7	3	10	0	0	10	0	0
10	5221297	.	T	G	6	2	8	0	0	8	0	0
10	5221336	.	G	C	3	4	7	0	0	7	0	0
10	5258914	.	T	A	1	2	3	0	2	5	0	0
10	5264458	.	G	A	1	7	8	0	0	8	0	0
10	5264534	.	C	A	3	4	7	0	0	7	0	0
10	5414339	.	C	T	1	1	2	0	0	2	0	0
10	5418509	.	A	G	2	5	7	0	0	7	0	0
10	5418569	.	C	T	3	3	6	0	1	7	0	0
10	5461988	.	C	A	8	3	11	0	0	11	0	0
10	5461994	.	T	A	8	3	11	0	1	12	0	0
10	5475206	.	G	C	7	6	13	0	1	14	0	0
10	5475214	.	T	G	8	7	15	0	0	15	0	0
10	5475406	.	A	T	1	3	4	0	0	4	0	0
10	5475436	.	A	G	3	2	5	0	0	5	0	0
10	5475526	.	T	C	4	8	12	0	1	13	0	0
10	5534369	.	T	A	1	6	7	0	0	7	0	0
10	5534483	.	T	C	6	5	11	0	0	11	0	0
10	5534487	.	C	T	0	5	5	0	5	10	0	0
10	5534527	.	G	T	5	8	13	0	1	14	0	0
10	5534539	.	G	A	5	7	12	0	0	12	0	0
10	5534611	.	C	T	6	10	16	1	1	18	0	0
10	5534612	.	A	G	6	7	13	1	4	18	0	0
10	5534646	.	A	G	6	11	17	0	3	20	0	0
10	5534878	.	C	T	12	10	22	0	0	22	0	0
10	5534946	.	A	G	12	10	22	0	1	23	0	0
10	5534950	.	A	T	12	9	21	0	0	21	0	0
10	5535359	.	A	T	10	4	14	0	2	16	0	0
10	5535368	.	T	A	11	3	14	0	1	15	0	0
10	5535445	.	T	C	4	3	7	0	0	7	0	0
10	5535483	.	A	T	6	5	11	0	1	12	0	0
10	5535540	.	T	G	6	4	10	0	1	11	0	0
10	5535561	.	T	A	7	5	12	0	0	12	0	0
10	5536240	.	T	C	2	2	4	0	1	5	0	0
10	5536256	.	G	A	1	2	3	0	1	4	0	0
10	5536831	.	G	T	1	2	3	0	0	3	0	0
10	5537048	.	G	T	4	3	7	0	0	7	0	0
10	5538302	.	T	G	5	3	8	0	0	8	0	0
10	5545438	.	C	T	1	2	3	0	0	3	0	0
10	5545465	.	T	C	1	4	5	0	0	5	0	0
10	5567968	.	G	T	0	1	1	0	1	2	0	0
10	5567969	.	G	T	0	2	2	0	0	2	0	0
10	5568319	.	A	C	2	2	4	0	0	4	0	0
10	5568329	.	A	G	2	2	4	0	0	4	0	0
10	5667439	.	A	T	4	2	6	0	1	7	0	0
10	5667467	.	T	A	6	4	10	0	0	10	0	0
10	5667504	.	G	A	2	3	5	0	0	5	0	0
10	5667559	.	T	A	2	2	4	0	0	4	0	0
10	5667605	.	C	T	2	3	5	0	0	5	0	0
10	5668024	.	C	T	4	2	6	0	1	7	0	0
10	5668103	.	C	T	3	4	7	0	2	9	0	0
10	5668135	.	G	A	4	7	11	0	0	11	0	0
10	5668218	.	G	C	3	9	12	0	0	12	0	0
10	5724095	.	T	C	0	1	1	0	0	1	0	0
10	5737757	.	G	A	2	1	3	0	0	3	0	0
10	5744934	.	C	T	1	1	2	0	0	2	0	0
10	5745015	.	C	A	8	8	16	0	0	16	0	0
10	5760455	.	T	C	4	4	8	0	0	8	0	0
10	5760461	.	A	G	4	4	8	0	0	8	0	0
10	5766958	.	A	G	6	3	9	0	0	9	0	0
10	5769541	.	G	T	2	1	3	0	0	3	0	0
10	5772568	.	A	G	7	6	13	0	1	14	0	0
10	5782337	.	C	T	0	1	1	0	0	1	0	0
10	5788755	.	A	C	4	6	10	0	0	10	0	0
10	5788806	.	G	A	10	9	19	0	1	20	0	0
10	5788877	.	G	A	6	5	11	0	1	12	0	0
10	5789059	.	A	G	4	2	6	0	1	7	0	0
10	5789069	.	G	A	4	2	6	0	0	6	0	0
10	5789155	.	G	T	5	6	11	0	0	11	0	0
10	5789758	.	G	T	2	5	7	0	3	10	0	0
10	5789806	.	C	T	5	4	9	0	1	10	0	0
10	5789905	.	T	A	5	3	8	0	1	9	0	0
10	5790001	.	C	A	4	1	5	0	0	5	0	0
10	5790080	.	A	G	1	6	7	0	1	8	0	0
10	5790097	.	G	A	2	5	7	0	0	7	0	0
10	5790210	.	C	T	8	7	15	0	4	19	0	0
10	5790278	.	G	T	3	5	8	0	0	8	0	0
10	5790570	.	A	C	3	7	10	0	0	10	0	0
10	5790640	.	T	G	3	3	6	0	0	6	0	0
10	5790913	.	A	C	2	4	6	0	0	6	0	0
10	5790922	.	C	A	1	4	5	0	0	5	0	0
10	5790956	.	C	G	0	3	3	0	7	10	0	0
10	5791184	.	G	A	2	5	7	0	0	7	0	0
10	5791224	.	C	G	1	6	7	0	1	8	0	0
10	5791238	.	A	G	1	4	5	0	1	6	0	0
10	5791377	.	A	T	11	2	13	0	0	13	0	0
10	5791387	.	G	A	9	3	12	0	3	15	0	0
10	5791417	.	C	T	0	5	5	0	7	12	0	0
10	5791454	.	T	A	2	4	6	0	1	7	0	0
10	5791459	.	C	A	2	3	5	0	0	5	0	0
10	5792512	.	A	T	2	4	6	0	0	6	0	0
10	5792533	.	A	T	3	3	6	0	0	6	0	0
10	5792722	.	T	C	1	2	3	0	4	7	0	0
10	5792757	.	A	G	1	1	2	0	2	4	0	0
10	5793197	.	G	A	1	5	6	0	0	6	0	0
10	5828639	.	C	T	2	2	4	0	0	4	0	0
10	5828645	.	A	G	2	2	4	0	0	4	0	0
10	5828704	.	C	A	0	9	9	0	5	14	0	0
10	5828840	.	A	G	3	4	7	0	0	7	0	0
10	5829041	.	A	G	3	4	7	0	1	8	0	0
10	5837337	.	G	A	0	2	2	0	0	2	0	0
10	6016242	.	G	A	1	1	2	0	0	2	0	0
10	6032880	.	A	G	1	0	1	0	7	8	0	0
10	6032886	.	G	A	2	6	8	0	0	8	0	0
10	6033612	.	G	A	0	7	7	0	5	12	0	0
10	6033627	.	A	T	5	11	16	0	0	16	0	0
10	6034194	.	A	T	4	8	12	0	1	13	0	0
10	6034362	.	G	A	0	2	2	0	1	3	0	0
10	6034376	.	G	A	1	2	3	0	0	3	0	0
10	6275577	.	C	T	3	3	6	0	0	6	0	0
10	6280939	.	G	A	0	1	1	0	1	2	0	0
10	6280948	.	G	A	0	1	1	0	1	2	0	0
10	6301930	.	C	T	3	4	7	0	2	9	0	0
10	6312954	.	A	T	3	9	12	0	2	14	0	0
10	6313643	.	C	T	7	9	16	0	1	17	0	0
10	6348571	.	C	A	2	2	4	0	0	4	0	0
10	6372501	.	C	T	5	7	12	0	2	14	0	0
10	6372864	.	A	T	6	4	10	0	1	11	0	0
10	6372865	.	T	C	6	5	11	0	0	11	0	0
10	6372915	.	G	A	6	3	9	0	0	9	0	0
10	6372964	.	T	C	7	5	12	0	0	12	0	0
10	6373003	.	T	C	5	3	8	0	0	8	0	0
10	6373332	.	A	T	4	4	8	0	0	8	0	0
10	6373336	.	C	G	5	4	9	0	0	9	0	0
10	6373378	.	A	C	5	3	8	0	0	8	0	0
10	6373472	.	T	A	2	2	4	0	0	4	0	0
10	6373522	.	A	T	3	2	5	0	0	5	0	0
10	6373758	.	A	C	5	12	17	0	0	17	0	0
10	6374017	.	A	G	7	12	19	0	1	20	0	0
10	6374041	.	A	T	7	13	20	0	2	22	0	0
10	6374068	.	G	T	7	7	14	0	3	17	0	0
10	6374235	.	T	C	9	15	24	0	1	25	0	0
10	6374279	.	G	A	0	16	16	0	14	30	0	0
10	6374352	.	C	T	16	15	31	0	1	32	0	0
10	6374372	.	A	G	12	23	35	0	2	37	0	0
10	6374388	.	C	T	20	14	34	0	1	35	0	0
10	6374486	.	A	G	7	9	16	0	1	17	0	0
10	6374501	.	A	G	3	11	14	0	1	15	0	0
10	6374573	.	A	T	7	12	19	0	2	25	4	0
10	6402694	.	T	A	1	2	3	0	0	3	0	0
10	6404899	.	G	T	0	2	2	0	0	2	0	0
10	6404900	.	G	T	0	2	2	0	0	2	0	0
10	6405251	.	G	C	2	2	4	0	0	4	0	0
10	6405321	.	A	G	0	2	2	0	0	2	0	0
10	6405368	.	G	A	3	1	4	0	1	5	0	0
10	6405376	.	G	A	3	3	6	0	0	6	0	0
10	6406246	.	T	A	2	2	4	0	0	4	0	0
10	6406254	.	G	T	2	2	4	0	0	4	0	0
10	6407408	.	T	C	3	4	7	0	0	7	0	0
10	6407449	.	C	T	1	6	7	0	1	8	0	0
10	6407559	.	A	T	2	4	6	0	1	7	0	0
10	6407744	.	A	T	3	3	6	0	0	6	0	0
10	6407764	.	C	A	3	2	5	0	0	5	0	0
10	6407904	.	C	T	1	1	2	0	1	3	0	0
10	6408986	.	A	G	8	4	12	0	1	13	0	0
10	6409095	.	G	A	0	6	6	0	8	14	0	0
10	6409120	.	G	A	7	2	9	0	1	10	0	0
10	6409267	.	C	A	5	6	11	0	0	11	0	0
10	6409379	.	A	G	3	8	11	0	0	11	0	0
10	6409448	.	C	T	7	4	11	0	1	12	0	0
10	6409455	.	T	A	6	6	12	0	0	12	0	0
10	6409506	.	A	G	7	8	15	0	0	15	0	0
10	6409695	.	C	A	0	2	2	0	0	2	0	0
10	6473544	.	T	C	8	10	18	0	0	18	0	0
10	6473685	.	T	C	9	11	20	0	0	20	0	0
10	6473704	.	C	G	9	11	20	0	0	20	0	0
10	6473851	.	A	G	7	11	18	0	2	20	0	0
10	6473862	.	C	T	0	10	10	0	8	18	0	0
10	6473908	.	A	G	7	9	16	0	0	16	0	0
10	6473996	.	T	C	9	10	19	0	1	20	0	0
10	6474057	.	T	A	3	3	6	0	0	6	0	0
10	6479444	.	T	C	6	0	6	0	9	15	0	0
10	6479471	.	C	T	0	5	5	0	4	9	0	0
10	6510756	.	T	C	11	11	22	0	1	23	0	0
10	6510786	.	T	G	15	18	33	0	1	34	0	0
10	6510825	.	T	C	6	8	14	0	0	14	0	0
10	6517593	.	T	A	29	29	58	0	1	59	0	0
10	6517663	.	A	G	22	1	23	0	21	44	0	0
10	6517726	.	C	T	15	22	37	0	4	41	0	0
10	6517959	.	A	G	21	14	35	0	5	40	0	0
10	6522267	.	A	T	4	5	9	0	1	10	0	0
10	6528005	.	A	G	0	1	1	0	0	1	0	0
10	6531002	.	A	G	3	1	4	0	0	4	0	0
10	6531297	.	T	C	5	4	9	0	0	9	0	0
10	6533850	.	T	A	3	4	7	0	0	7	0	0
10	6546851	.	A	G	1	0	1	0	0	1	0	0
10	6781239	.	G	A	9	5	14	0	2	16	0	0
10	6781278	.	T	A	13	11	24	0	0	24	0	0
10	6781286	.	G	T	13	11	24	0	0	24	0	0
10	6781362	.	G	A	17	18	35	0	1	36	0	0
10	6781372	.	T	A	20	17	37	0	4	41	0	0
10	6781450	.	T	C	12	20	32	0	2	34	0	0
10	6781506	.	A	T	11	17	28	0	2	30	0	0
10	6781664	.	A	T	4	19	23	0	0	23	0	0
10	6781742	.	G	T	11	7	18	0	1	19	0	0
10	6781786	.	A	T	5	9	14	0	0	15	1	0
10	6781867	.	C	A	6	9	15	0	0	15	0	0
10	6781903	.	T	G	7	7	14	0	1	15	0	0
10	6781918	.	A	T	7	8	15	0	0	15	0	0
10	6782020	.	G	C	11	10	21	0	0	21	0	0
10	6782163	.	T	C	15	6	21	0	2	23	0	0
10	6782220	.	A	G	5	4	9	0	0	9	0	0
10	6782267	.	T	A	2	4	6	2	0	8	0	0
10	6782279	.	A	C	2	4	6	2	0	8	0	0
10	6782454	.	C	G	7	16	23	0	1	24	0	0
10	6782489	.	T	G	8	18	26	0	0	26	0	0
10	6782624	.	A	G	17	17	34	0	1	35	0	0
10	6782636	.	T	A	15	17	32	0	2	34	0	0
10	6782664	.	A	G	16	20	36	0	3	39	0	0
10	6786326	.	C	T	0	4	4	0	2	6	0	0
10	6786564	.	A	G	12	13	25	0	1	26	0	0
10	6824761	.	A	C	2	3	5	0	0	5	0	0
10	6824845	.	A	T	8	5	13	0	0	13	0	0
10	6824877	.	T	G	3	2	5	0	1	6	0	0
10	6834065	.	A	T	2	0	2	0	0	2	0	0
10	6851184	.	C	A	1	3	4	0	0	4	0	0
10	7210001	.	G	A	0	8	8	0	5	13	0	0
10	7221810	.	A	G	5	1	6	0	0	6	0	0
10	7222213	.	T	C	2	10	12	0	1	13	0	0
10	7224964	.	A	G	1	6	7	0	1	8	0	0
10	7231728	.	T	C	18	16	34	0	3	37	0	0
10	7231821	.	T	A	17	18	35	0	0	35	0	0
10	7231964	.	G	C	26	14	40	0	0	40	0	0
10	7232043	.	T	A	16	13	29	0	5	34	0	0
10	7232058	.	G	T	0	15	15	0	17	32	0	0
10	7232104	.	A	T	16	13	29	0	1	30	0	0
10	7232309	.	C	T	5	6	11	1	0	12	0	0
10	7232416	.	T	C	19	16	35	0	0	35	0	0
10	7232420	.	T	C	17	18	35	0	1	36	0	0
10	7233038	.	T	C	17	17	34	0	1	35	0	0
10	7233218	.	A	G	29	17	46	0	4	50	0	0
10	7233440	.	A	T	34	25	59	0	6	65	0	0
10	7233457	.	C	G	28	32	60	0	4	64	0	0
10	7233518	.	T	C	26	22	48	0	4	52	0	0
10	7233854	.	A	T	18	14	32	0	12	44	0	0
10	7233939	.	C	T	3	7	10	0	0	10	0	0
10	7284403	.	C	T	4	7	11	0	1	12	0	0
10	7284629	.	T	C	4	3	7	0	0	7	0	0
10	7311997	.	T	G	0	1	1	0	0	1	0	0
10	7312057	.	A	G	0	3	3	0	0	3	0	0
10	7564294	.	C	T	2	7	9	0	1	10	0	0
10	7593246	.	A	T	2	5	7	0	1	8	0	0
10	7593349	.	C	A	6	5	11	0	0	11	0	0
10	7617113	.	A	T	28	32	60	0	5	65	0	0
10	7617126	.	T	C	33	31	64	0	2	66	0	0
10	7617242	.	G	A	23	35	58	0	7	65	0	0
10	7617327	.	A	C	11	23	34	0	11	45	0	0
10	7617350	.	A	T	19	34	53	0	7	60	0	0
10	7617636	.	A	G	21	1	22	0	16	38	0	0
10	7640501	.	C	T	2	0	2	0	1	3	0	0
10	7640676	.	G	A	15	19	34	0	2	36	0	0
10	7671301	.	C	A	8	4	12	0	0	12	0	0
10	7671344	.	G	T	11	4	15	0	1	16	0	0
10	7671368	.	T	C	6	6	12	0	1	13	0	0
10	7671425	.	G	A	10	7	17	0	0	17	0	0
10	7672832	.	A	C	5	2	7	0	1	8	0	0
10	7672853	.	G	A	6	9	15	0	1	16	0	0
10	7673774	.	G	A	7	2	9	0	1	10	0	0
10	7673819	.	C	G	1	4	5	0	0	5	0	0
10	7673849	.	A	G	0	4	4	0	0	4	0	0
10	7674079	.	T	G	7	5	12	0	0	12	0	0
10	7674136	.	C	T	1	2	3	0	0	3	0	0
10	7674429	.	C	T	2	2	4	0	0	4	0	0
10	7674471	.	A	G	2	3	5	0	0	5	0	0
10	7674506	.	A	G	4	3	7	0	1	8	0	0
10	7678121	.	T	C	1	2	3	0	0	3	0	0
10	7678154	.	C	T	0	3	3	0	4	7	0	0
10	7700564	.	T	G	2	1	3	0	0	3	0	0
10	7700615	.	A	G	3	5	8	0	0	8	0	0
10	7700676	.	G	A	1	1	2	0	0	2	0	0
10	7709761	.	T	C	2	2	4	0	0	4	0	0
10	7709975	.	A	G	1	3	4	0	0	4	0	0
10	7709978	.	T	C	1	3	4	0	0	4	0	0
10	7712180	.	T	A	2	2	4	0	1	5	0	0
10	7721459	.	A	G	6	5	11	0	0	11	0	0
10	7721746	.	G	A	2	5	7	0	3	10	0	0
10	7722595	.	A	G	0	4	4	0	4	8	0	0
10	7723004	.	T	C	3	4	7	0	0	7	0	0
10	7723157	.	A	G	12	14	26	0	0	26	0	0
10	7723218	.	T	C	4	17	21	0	0	21	0	0
10	7723275	.	C	A	14	18	32	0	0	32	0	0
10	7723337	.	C	G	10	6	16	0	0	16	0	0
10	7727505	.	T	A	2	3	5	0	1	6	0	0
10	7727704	.	T	A	0	1	1	0	0	1	0	0
10	7770200	.	A	G	1	2	3	0	0	3	0	0
10	7770201	.	G	A	1	2	3	0	0	3	0	0
10	7771634	.	T	A	3	3	6	0	0	6	0	0
10	7771735	.	A	C	5	6	11	0	1	12	0	0
10	7771769	.	C	T	3	7	10	0	1	12	1	0
10	7771778	.	G	A	4	5	9	0	0	9	0	0
10	7772012	.	T	G	9	4	13	0	0	13	0	0
10	7772272	.	C	T	4	4	8	0	0	8	0	0
10	7810461	.	A	T	21	16	37	0	2	39	0	0
10	7810565	.	G	A	13	22	35	0	2	37	0	0
10	7811062	.	T	A	6	4	10	0	0	10	0	0
10	7811075	.	T	C	6	4	10	0	0	10	0	0
10	7811935	.	A	G	9	7	16	0	1	17	0	0
10	7812420	.	A	G	0	3	3	0	0	3	0	0
10	7812430	.	A	G	1	2	3	0	1	4	0	0
10	7815118	.	G	A	6	8	14	0	0	14	0	0
10	7815187	.	G	A	2	2	4	0	0	4	0	0
10	7881407	.	C	A	1	2	3	0	0	3	0	0
10	7901347	.	G	A	1	2	3	0	0	3	0	0
10	7916836	.	A	C	7	14	21	0	2	23	0	0
10	7916930	.	C	A	11	14	25	0	1	26	0	0
10	7917036	.	A	T	13	15	28	0	0	28	0	0
10	7917114	.	T	C	14	12	26	0	4	30	0	0
10	7917411	.	C	A	0	10	10	0	11	21	0	0
10	7917483	.	C	A	11	11	22	0	2	24	0	0
10	7917551	.	A	G	14	14	28	0	1	29	0	0
10	7917592	.	T	C	25	13	38	0	2	40	0	0
10	7917686	.	T	C	16	19	35	0	1	36	0	0
10	7917690	.	A	T	14	21	35	0	1	36	0	0
10	7920910	.	T	G	9	11	20	0	2	22	0	0
10	7920913	.	C	T	9	9	18	0	4	22	0	0
10	7922210	.	G	T	2	7	9	0	0	9	0	0
10	7922294	.	C	A	10	12	22	0	0	22	0	0
10	7926899	.	A	G	4	3	7	0	0	7	0	0
10	7936283	.	T	G	9	4	13	0	4	17	0	0
10	7938629	.	C	T	5	2	7	0	2	9	0	0
10	7938659	.	A	G	10	4	14	0	0	14	0	0
10	7938683	.	T	C	8	3	11	0	0	11	0	0
10	7984677	.	A	T	0	4	4	0	0	4	0	0
10	7986307	.	C	T	0	0	0	0	1	1	0	0
10	7989000	.	C	T	6	4	10	0	3	13	0	0
10	7989162	.	T	G	7	7	14	0	2	16	0	0
10	7989237	.	G	A	5	8	13	0	0	13	0	0
10	7989287	.	G	A	7	11	18	0	1	19	0	0
10	7989348	.	C	T	8	10	18	0	1	19	0	0
10	7989576	.	C	T	0	6	6	0	0	6	0	0
10	7992197	.	T	C	7	11	18	0	1	19	0	0
10	7996021	.	G	A	3	0	3	0	0	3	0	0
10	8001365	.	A	G	1	2	3	0	0	3	0	0
10	8005785	.	T	A	1	2	3	0	0	3	0	0
10	8033224	.	T	A	0	0	0	0	1	1	0	0
10	8034855	.	C	T	4	2	6	0	0	6	0	0
10	8035013	.	A	C	3	3	6	1	0	7	0	0
10	8035058	.	T	G	1	5	6	0	0	6	0	0
10	8035093	.	G	A	3	5	8	0	0	8	0	0
10	8035178	.	G	A	2	2	4	0	0	4	0	0
10	8035510	.	C	T	0	2	2	0	1	3	0	0
10	8035604	.	C	T	0	3	3	1	4	8	0	0
10	8035752	.	A	T	2	3	5	0	0	5	0	0
10	8036813	.	C	T	1	4	5	0	0	5	0	0
10	8036839	.	G	A	1	6	7	0	0	7	0	0
10	8037351	.	C	T	1	4	5	0	0	5	0	0
10	8037425	.	A	G	2	2	4	0	0	4	0	0
10	8037752	.	T	C	1	3	4	0	1	5	0	0
10	8037820	.	A	T	3	3	6	0	1	7	0	0
10	8037866	.	T	G	1	2	3	0	0	3	0	0
10	8041874	.	C	T	1	2	3	0	0	3	0	0
10	8091169	.	G	T	2	2	4	0	0	4	0	0
10	8097929	.	C	G	15	18	33	0	1	34	0	0
10	8154892	.	C	T	2	8	10	0	0	10	0	0
10	8160813	.	T	G	3	3	6	0	1	7	0	0
10	8160888	.	G	A	5	8	13	0	0	13	0	0
10	8160891	.	T	C	5	0	5	0	7	12	0	0
10	8161027	.	A	G	4	8	12	0	0	12	0	0
10	8163440	.	G	A	2	3	5	0	0	5	0	0
10	8175056	.	G	T	0	1	1	0	0	1	0	0
10	8177748	.	A	G	1	2	3	0	0	3	0	0
10	8213224	.	C	T	1	1	2	0	0	2	0	0
10	8213229	.	G	A	1	1	2	0	0	2	0	0
10	8236775	.	T	C	2	4	6	0	0	6	0	0
10	8263045	.	G	A	10	9	19	0	2	21	0	0
10	8263081	.	T	C	5	1	6	0	2	8	0	0
10	8263919	.	C	T	4	2	6	0	0	6	0	0
10	8266383	.	A	G	17	15	32	0	0	32	0	0
10	8269377	.	G	A	3	5	8	0	1	9	0	0
10	8278160	.	T	C	3	6	9	0	0	9	0	0
10	8278214	.	A	G	5	6	11	0	0	11	0	0
10	8295295	.	C	A	0	2	2	0	4	6	0	0
10	8630402	.	G	T	0	6	6	0	3	9	0	0
10	8630428	.	A	G	3	7	10	0	1	11	0	0
10	8630452	.	G	T	3	9	12	0	0	12	0	0
10	8630527	.	G	A	6	9	15	0	1	16	0	0
10	8630618	.	C	T	3	5	8	0	3	11	0	0
10	8630631	.	T	C	3	6	9	0	0	9	0	0
10	8630702	.	T	C	4	6	10	0	0	10	0	0
10	8630914	.	A	G	5	3	8	0	0	8	0	0
10	8631152	.	A	T	10	2	12	0	1	13	0	0
10	8660722	.	C	T	10	8	18	0	0	18	0	0
10	8670139	.	G	A	3	2	5	0	0	5	0	0
10	8684912	.	T	C	0	2	2	0	0	2	0	0
10	8684939	.	T	G	0	2	2	0	1	3	0	0
10	8686943	.	C	T	4	2	6	0	0	6	0	0
10	8950055	.	G	A	2	1	3	0	1	4	0	0
10	8950108	.	A	G	2	1	3	0	0	3	0	0
10	8952018	.	T	C	5	3	8	0	0	8	0	0
10	8955356	.	C	A	2	4	6	0	0	6	0	0
10	8976311	.	T	G	1	2	3	0	0	3	0	0
10	8976417	.	G	A	5	2	7	0	0	7	0	0
10	9006634	.	T	C	5	3	8	0	0	8	0	0
10	9089569	.	T	A	4	4	8	0	0	8	0	0
10	9164807	.	T	C	1	3	4	0	0	4	0	0
10	9165056	.	T	C	1	1	2	0	1	3	0	0
10	9181508	.	T	A	1	0	1	0	0	1	0	0
10	9184326	.	T	A	8	5	13	0	1	14	0	0
10	9184533	.	C	T	8	9	17	0	2	19	0	0
10	9234056	.	T	A	0	4	4	0	0	4	0	0
10	9234087	.	T	A	5	1	6	0	0	6	0	0
10	9234096	.	C	T	4	0	4	0	1	5	0	0
10	9234236	.	T	C	1	3	4	0	0	4	0	0
10	9235217	.	A	T	1	5	6	0	0	6	0	0
10	9247804	.	C	A	1	3	4	0	1	5	0	0
10	9255670	.	G	A	1	3	4	0	0	4	0	0
10	9305219	.	A	G	3	3	6	0	1	7	0	0
10	9305246	.	T	C	4	0	4	0	9	13	0	0
10	9305305	.	C	T	4	6	10	0	0	10	0	0
10	9305433	.	A	G	9	5	14	0	1	15	0	0
10	9308092	.	G	A	4	3	7	0	0	7	0	0
10	9308133	.	G	A	2	1	3	0	0	3	0	0
10	9361037	.	C	T	1	2	3	0	0	3	0	0
10	9361891	.	G	A	3	2	5	0	0	5	0	0
10	9361924	.	G	C	2	2	4	0	1	5	0	0
10	9370121	.	A	T	5	8	13	0	3	16	0	0
10	9370755	.	A	G	8	5	13	0	1	14	0	0
10	9394247	.	A	C	2	7	9	0	0	9	0	0
10	9394299	.	T	A	1	2	3	0	0	3	0	0
10	9394918	.	G	C	5	4	9	0	0	9	0	0
10	9395012	.	C	T	6	8	14	0	2	16	0	0
10	9629268	.	G	T	0	2	2	0	1	3	0	0
10	9642674	.	T	A	2	0	2	0	0	2	0	0
10	9704514	.	A	T	3	1	4	0	0	4	0	0
10	9714771	.	T	C	4	2	6	0	0	6	0	0
10	9781509	.	G	A	1	1	2	0	0	2	0	0
10	9784087	.	C	T	8	5	13	0	0	13	0	0
10	9800719	.	G	T	1	0	1	0	0	1	0	0
10	9802771	.	T	C	17	16	33	0	0	33	0	0
10	9806731	.	A	G	14	1	15	0	19	34	0	0
10	9807014	.	T	G	8	8	16	0	4	20	0	0
10	9807203	.	G	A	18	15	33	0	3	36	0	0
10	9836752	.	C	T	3	3	6	0	0	6	0	0
10	9836809	.	G	T	1	1	2	0	0	2	0	0
10	9837024	.	G	T	1	2	3	0	0	3	0	0
10	9837027	.	T	C	1	2	3	0	0	3	0	0
10	9837100	.	T	C	3	2	5	0	0	5	0	0
10	9846240	.	A	G	5	5	10	0	1	12	1	0
10	9846261	.	G	A	6	8	14	0	2	16	0	0
10	9895348	.	G	A	4	2	6	0	0	6	0	0
10	9899302	.	G	A	4	1	5	0	0	5	0	0
10	10254730	.	C	T	4	4	8	0	0	8	0	0
10	10254751	.	A	C	4	2	6	0	0	6	0	0
10	10261887	.	G	C	1	0	1	0	0	1	0	0
10	10261893	.	C	A	1	0	1	0	0	1	0	0
10	10262013	.	T	C	3	4	7	0	0	7	0	0
10	10262157	.	A	G	2	4	6	0	1	7	0	0
10	10269930	.	T	C	0	1	1	0	1	2	0	0
10	10325451	.	T	C	6	3	9	0	1	10	0	0
10	10325493	.	G	A	0	12	12	0	5	17	0	0
10	10379918	.	T	C	1	1	2	0	0	2	0	0
10	10567262	.	A	G	0	1	1	0	0	1	0	0
10	10729064	.	G	A	3	3	6	0	0	6	0	0
10	10729097	.	C	A	1	3	4	0	1	6	1	0
10	10764601	.	T	C	1	2	3	0	0	3	0	0
10	10780483	.	T	C	0	2	2	0	0	2	0	0
10	10782513	.	G	A	1	7	8	0	0	8	0	0
10	10860852	.	A	G	3	2	5	0	1	6	0	0
10	10861011	.	A	G	8	5	13	0	2	15	0	0
10	10861504	.	G	A	3	3	6	0	0	6	0	0
10	10880188	.	T	C	3	2	5	0	0	5	0	0
10	10880393	.	A	G	2	2	4	0	0	4	0	0
10	10880791	.	T	A	1	3	4	0	0	4	0	0
10	10930143	.	G	A	3	2	5	0	1	6	0	0
10	10935748	.	T	C	0	3	3	0	0	3	0	0
10	10935974	.	C	T	0	1	1	0	3	4	0	0
10	10997286	.	A	G	4	5	9	0	0	9	0	0
10	10997585	.	C	T	2	3	5	0	0	5	0	0
10	10997618	.	C	T	3	2	5	0	0	5	0	0
10	11001608	.	T	C	1	2	3	0	0	3	0	0
10	11001867	.	A	G	3	4	7	0	0	7	0	0
10	11001883	.	T	A	2	2	4	0	0	4	0	0
10	11001967	.	T	G	2	5	7	0	1	8	0	0
10	11001968	.	A	G	2	6	8	0	0	8	0	0
10	11002005	.	T	A	2	4	6	0	0	6	0	0
10	11003904	.	G	T	1	1	2	0	0	2	0	0
10	11003911	.	G	A	1	1	2	0	0	2	0	0
10	11003966	.	A	G	4	1	5	0	0	6	1	0
10	11093478	.	A	G	2	2	4	0	1	5	0	0
10	11298651	.	G	A	1	3	4	0	0	4	0	0
10	11298652	.	A	C	1	3	4	0	0	4	0	0
10	11298852	.	G	A	4	3	7	0	0	7	0	0
10	11298864	.	A	G	3	2	5	0	1	6	0	0
10	11298955	.	T	C	2	3	5	0	1	6	0	0
10	11298975	.	C	T	2	3	5	0	1	6	0	0
10	11310041	.	G	A	1	4	5	0	0	5	0	0
10	11310500	.	G	A	4	5	9	0	1	10	0	0
10	11310501	.	C	A	4	5	9	0	1	10	0	0
10	11310618	.	A	C	8	6	14	0	0	14	0	0
10	11310648	.	G	A	4	8	12	0	1	13	0	0
10	11310682	.	G	A	2	6	8	0	0	8	0	0
10	11320087	.	A	C	2	2	4	0	0	4	0	0
10	11322985	.	T	C	1	4	5	0	1	6	0	0
10	11323032	.	G	A	3	9	12	0	0	12	0	0
10	11327364	.	A	G	6	3	9	0	1	10	0	0
10	11327406	.	T	A	5	4	9	0	0	9	0	0
10	11327444	.	G	T	5	6	11	0	2	13	0	0
10	11327449	.	A	T	6	7	13	0	1	14	0	0
10	11327604	.	T	C	9	9	18	0	1	19	0	0
10	11327657	.	C	T	8	5	13	0	0	13	0	0
10	11327674	.	G	A	7	5	12	0	0	12	0	0
10	11331922	.	C	T	1	2	3	0	4	7	0	0
10	11332206	.	A	G	1	1	2	0	0	2	0	0
10	11339235	.	G	A	3	3	6	0	0	6	0	0
10	11362275	.	C	T	19	9	28	0	2	30	0	0
10	11394922	.	C	T	0	3	3	0	0	3	0	0
10	11398168	.	T	G	2	0	2	0	5	7	0	0
10	11399574	.	C	T	1	0	1	0	0	1	0	0
10	11403954	.	T	C	3	2	5	0	0	5	0	0
10	11501181	.	C	A	7	6	13	0	2	15	0	0
10	11779259	.	G	A	1	4	5	0	0	5	0	0
10	11790947	.	T	C	3	6	9	0	0	9	0	0
10	11805601	.	T	C	3	6	9	0	1	10	0	0
10	11838927	.	C	T	0	2	2	0	2	4	0	0
10	13063542	.	G	T	1	2	3	0	0	3	0	0
10	13238028	.	A	G	5	7	12	0	0	12	0	0
10	13238055	.	G	T	8	4	12	0	1	13	0	0
10	13283594	.	C	T	3	2	5	0	0	5	0	0
10	13286430	.	C	T	3	5	8	0	1	9	0	0
10	13286472	.	T	C	2	4	6	0	0	6	0	0
10	13286951	.	C	G	3	2	5	0	2	7	0	0
10	13460494	.	A	C	5	14	19	0	0	19	0	0
10	13460671	.	G	A	16	11	27	0	2	29	0	0
10	13460745	.	C	A	0	12	12	0	19	31	0	0
10	13460940	.	A	T	12	11	23	0	0	23	0	0
10	13461080	.	T	C	10	0	10	0	17	27	0	0
10	13461150	.	G	A	11	6	17	0	0	17	0	0
10	13476010	.	A	G	7	10	17	0	2	19	0	0
10	13529270	.	T	C	14	4	18	0	1	19	0	0
10	14470434	.	C	T	0	0	0	0	1	1	0	0
10	14491139	.	C	T	4	2	6	0	0	6	0	0
10	14493798	.	T	C	5	13	18	0	2	20	0	0
10	14493819	.	A	T	6	10	16	0	1	17	0	0
10	14493878	.	G	T	0	13	13	0	14	27	0	0
10	14493967	.	G	C	0	12	12	0	11	23	0	0
10	14533337	.	G	A	2	6	8	0	1	9	0	0
10	14533352	.	A	G	4	4	8	0	2	10	0	0
10	14542886	.	A	G	12	7	19	0	2	21	0	0
10	14542942	.	C	A	10	3	13	0	1	14	0	0
10	14543044	.	A	T	19	7	26	1	6	33	0	0
10	14543256	.	A	C	8	9	17	0	2	19	0	0
10	14543259	.	G	T	9	11	20	0	0	20	0	0
10	14543307	.	C	T	13	14	27	0	1	28	0	0
10	14545572	.	A	G	13	7	20	0	1	21	0	0
10	14871409	.	T	A	13	7	20	0	6	26	0	0
10	14871412	.	T	A	14	6	20	0	6	26	0	0
10	14871768	.	A	G	20	7	27	0	4	31	0	0
10	14871801	.	A	C	19	11	30	0	0	30	0	0
10	14872703	.	G	A	6	6	12	0	4	16	0	0
10	14872796	.	T	G	6	0	6	0	12	18	0	0
10	14929560	.	G	A	4	2	6	0	1	7	0	0
10	15621461	.	A	T	3	1	4	0	0	4	0	0
10	16476487	.	T	C	1	3	4	0	0	4	0	0
10	17924546	.	A	G	22	7	29	0	2	31	0	0
10	17924547	.	A	G	16	15	31	0	0	31	0	0
10	17945513	.	A	G	23	12	35	1	4	40	0	0
10	18906617	.	C	A	8	13	21	0	13	35	1	0
10	18906618	.	A	G	10	15	25	0	10	35	0	0
10	18911166	.	A	G	0	4	4	0	0	4	0	0
10	18927910	.	C	T	0	1	1	0	0	1	0	0
10	18930403	.	T	C	6	2	8	0	0	8	0	0
10	18934201	.	C	T	5	3	8	0	0	8	0	0
10	18934291	.	T	C	6	6	12	0	0	12	0	0
10	18934323	.	A	C	6	5	11	0	1	12	0	0
10	18934499	.	C	T	4	6	10	0	1	11	0	0
10	18934530	.	A	G	1	8	9	0	0	9	0	0
10	18934590	.	A	C	6	10	16	0	1	17	0	0
10	18934634	.	G	T	9	8	17	0	0	17	0	0
10	18934683	.	T	C	8	10	18	0	0	18	0	0
10	18934821	.	A	C	5	5	10	0	4	14	0	0
10	18935246	.	T	C	11	17	28	0	2	30	0	0
10	18935316	.	C	T	13	20	33	0	2	35	0	0
10	18935413	.	C	T	11	13	24	0	0	24	0	0
10	18935430	.	A	T	10	13	23	0	1	24	0	0
10	18935874	.	T	A	2	5	7	0	0	7	0	0
10	18970673	.	C	T	1	3	4	0	1	5	0	0
10	18973079	.	C	T	1	2	3	0	0	3	0	0
10	18977233	.	G	A	0	1	1	0	0	1	0	0
10	18992413	.	T	C	19	21	40	0	2	42	0	0
10	19017253	.	C	T	4	2	6	0	0	6	0	0
10	19017316	.	C	T	2	1	3	0	0	3	0	0
10	19020475	.	A	G	7	9	16	0	0	16	0	0
10	19021075	.	G	A	4	10	14	0	1	15	0	0
10	19021192	.	A	G	6	6	12	0	2	14	0	0
10	19021289	.	G	A	1	2	3	0	0	3	0	0
10	19021432	.	A	G	1	2	3	0	0	3	0	0
10	19021456	.	A	G	1	3	4	0	0	4	0	0
10	19554673	.	A	T	4	4	8	0	0	8	0	0
10	19562120	.	C	T	6	3	9	0	0	9	0	0
10	19564401	.	G	A	13	17	30	0	3	33	0	0
10	19565771	.	T	C	17	26	43	0	5	48	0	0
10	19565988	.	G	C	28	25	53	0	2	55	0	0
10	19566400	.	T	A	14	17	31	0	0	32	1	0
10	19566445	.	T	C	8	5	13	0	2	15	0	0
10	20093329	.	G	A	0	3	3	0	4	7	0	0
10	20099545	.	G	C	1	4	5	0	11	16	0	0
10	20100205	.	C	T	5	10	15	0	1	16	0	0
10	20100234	.	C	T	4	10	14	0	1	15	0	0
10	20100269	.	A	C	8	11	19	0	0	19	0	0
10	20103359	.	C	T	8	3	11	0	0	11	0	0
10	20103392	.	A	G	4	3	7	0	0	7	0	0
10	20103639	.	A	G	2	10	12	0	2	14	0	0
10	20105210	.	T	C	3	3	6	0	0	6	0	0
10	20128640	.	G	A	0	0	0	0	1	1	0	0
10	20128643	.	T	A	0	0	0	0	1	1	0	0
10	20131937	.	G	A	1	1	2	0	0	2	0	0
10	20137862	.	A	G	2	2	4	0	0	4	0	0
10	20140951	.	T	C	1	2	3	0	0	3	0	0
10	20143822	.	T	A	1	3	4	0	0	4	0	0
10	20143850	.	T	A	3	1	4	0	2	6	0	0
10	20146535	.	C	T	18	22	40	0	7	47	0	0
10	20215064	.	G	T	1	1	2	0	0	2	0	0
10	20218342	.	C	G	0	4	4	0	0	4	0	0
10	20234074	.	C	T	8	15	23	0	3	26	0	0
10	20276868	.	T	G	1	0	1	0	1	2	0	0
10	20276898	.	A	G	2	0	2	0	1	3	0	0
10	20276904	.	G	A	2	1	3	0	0	3	0	0
10	20287251	.	C	A	0	5	5	0	3	8	0	0
10	20351975	.	C	T	3	2	5	0	0	5	0	0
10	20368862	.	T	A	6	4	10	0	1	11	0	0
10	20368883	.	C	T	4	5	9	0	2	11	0	0
10	20371402	.	A	T	17	7	24	0	0	25	1	0
10	20371419	.	A	C	15	14	29	0	0	29	0	0
10	20371478	.	C	A	13	11	24	0	2	26	0	0
10	20371675	.	A	T	14	7	21	0	1	22	0	0
10	20392903	.	G	A	2	0	2	0	0	2	0	0
10	20395629	.	T	C	3	6	9	0	0	9	0	0
10	20398930	.	T	C	1	1	2	0	0	2	0	0
10	20401360	.	C	A	1	3	4	0	0	4	0	0
10	20401418	.	T	C	3	3	6	0	0	6	0	0
10	20401649	.	G	T	3	3	6	0	1	7	0	0
10	20401699	.	A	C	2	6	8	0	1	9	0	0
10	20401702	.	C	G	2	8	10	0	0	10	0	0
10	20401813	.	A	G	4	2	6	0	0	6	0	0
10	20401984	.	G	T	1	2	3	0	0	3	0	0
10	20468843	.	T	A	1	0	1	0	1	2	0	0
10	20468952	.	G	A	0	3	3	0	0	3	0	0
10	20472926	.	T	C	3	4	7	0	1	8	0	0
10	20473147	.	C	G	0	4	4	0	4	8	0	0
10	20473366	.	C	T	1	3	4	0	1	5	0	0
10	20473409	.	G	A	1	2	3	0	0	3	0	0
10	20473517	.	G	T	6	3	9	0	0	9	0	0
10	20481653	.	C	T	0	2	2	0	2	4	0	0
10	20481656	.	G	A	2	2	4	0	0	4	0	0
10	20505261	.	G	A	2	2	4	0	0	4	0	0
10	20505679	.	T	G	1	2	3	0	0	3	0	0
10	20527553	.	G	A	5	1	6	0	0	6	0	0
10	20527639	.	G	A	3	8	11	0	1	12	0	0
10	20527736	.	C	T	0	8	8	0	9	17	0	0
10	20527837	.	C	A	0	8	8	0	9	17	0	0
10	20543336	.	G	A	8	4	12	0	0	12	0	0
10	20546530	.	G	A	5	2	7	0	1	8	0	0
10	20546548	.	C	T	0	2	2	0	0	2	0	0
10	20558156	.	G	C	0	2	2	0	1	3	0	0
10	20558270	.	G	A	0	1	1	0	0	1	0	0
10	20562894	.	C	T	0	1	1	0	0	1	0	0
10	20590317	.	T	C	5	4	9	0	2	11	0	0
10	20590372	.	T	A	7	8	15	0	0	16	1	0
10	20590436	.	A	C	4	6	10	0	1	11	0	0
10	20590461	.	G	T	5	6	11	0	0	11	0	0
10	20590547	.	T	C	4	0	4	0	0	4	0	0
10	20590569	.	C	T	2	0	2	0	0	2	0	0
10	20592420	.	C	T	8	5	13	0	1	14	0	0
10	20592598	.	G	T	2	3	5	0	0	5	0	0
10	20598177	.	C	A	0	5	5	0	1	6	0	0
10	20598267	.	A	G	1	5	6	0	1	7	0	0
10	20598270	.	G	A	2	4	6	0	0	6	0	0
10	20604548	.	A	G	11	15	26	0	0	26	0	0
10	20604555	.	T	C	10	15	25	0	2	27	0	0
10	20604703	.	G	T	12	11	23	1	2	26	0	0
10	20605171	.	A	T	10	12	22	0	3	25	0	0
10	20636027	.	C	T	10	6	16	0	2	18	0	0
10	20636168	.	A	T	7	7	14	0	1	15	0	0
10	20636177	.	G	T	6	6	12	0	1	13	0	0
10	20636273	.	T	C	5	0	5	0	15	20	0	0
10	20636600	.	T	C	3	0	3	0	3	6	0	0
10	20920664	.	A	G	6	11	17	0	0	17	0	0
10	20971685	.	A	G	5	3	8	0	1	9	0	0
10	21043902	.	G	A	4	2	6	0	0	6	0	0
10	21044064	.	G	A	4	2	6	0	0	6	0	0
10	21436810	.	T	C	1	2	3	0	0	3	0	0
10	21442229	.	T	C	1	1	2	0	0	2	0	0
10	21443135	.	G	A	0	14	14	0	10	24	0	0
10	21443193	.	T	G	13	19	32	0	1	33	0	0
10	21443347	.	T	A	5	3	8	0	1	9	0	0
10	21452340	.	T	C	2	3	5	0	0	5	0	0
10	21452376	.	G	A	0	4	4	0	5	9	0	0
10	21452403	.	G	A	5	8	13	0	1	14	0	0
10	21459017	.	G	A	0	4	4	0	5	9	0	0
10	21459439	.	G	A	15	13	28	0	1	29	0	0
10	21462612	.	T	C	10	7	17	0	0	17	0	0
10	21470192	.	G	A	0	9	9	0	21	30	0	0
10	21474532	.	G	A	0	2	2	0	1	3	0	0
10	21524679	.	G	A	2	3	5	0	0	5	0	0
10	21524682	.	G	A	2	3	5	0	0	5	0	0
10	21525243	.	A	G	1	5	6	0	0	6	0	0
10	21525276	.	T	A	2	2	4	0	0	4	0	0
10	21646033	.	C	T	13	23	36	0	0	36	0	0
10	21646621	.	C	T	20	28	48	0	4	52	0	0
10	21646668	.	T	A	26	20	46	0	3	49	0	0
10	21646797	.	C	T	24	16	40	0	3	43	0	0
10	21646802	.	A	G	26	14	40	0	2	42	0	0
10	21646844	.	A	G	15	19	34	0	2	36	0	0
10	21647241	.	T	G	24	21	45	0	3	48	0	0
10	21647291	.	G	A	0	32	32	0	21	53	0	0
10	21647691	.	G	A	27	21	48	0	7	55	0	0
10	21679442	.	T	C	2	1	3	0	0	3	0	0
10	21704073	.	G	T	0	2	2	0	0	2	0	0
10	21720798	.	T	C	3	3	6	0	0	6	0	0
10	21720833	.	A	G	3	2	5	0	0	5	0	0
10	21729191	.	T	C	0	2	2	0	0	2	0	0
10	21778980	.	C	T	2	5	7	2	1	10	0	0
10	21780258	.	T	C	4	3	7	0	0	7	0	0
10	21780288	.	G	T	4	2	6	0	0	6	0	0
10	21780924	.	T	C	4	6	10	0	0	10	0	0
10	21781257	.	C	T	2	2	4	0	0	4	0	0
10	21781313	.	C	T	1	1	2	0	0	2	0	0
10	21781524	.	C	G	9	3	12	0	0	12	0	0
10	21781562	.	G	A	8	4	12	0	0	12	0	0
10	21781591	.	G	A	4	7	11	0	1	12	0	0
10	21781677	.	G	A	0	4	4	0	1	5	0	0
10	21781710	.	T	C	7	3	10	0	1	11	0	0
10	21781722	.	G	C	6	5	11	0	2	14	1	0
10	21783252	.	C	T	0	3	3	0	0	3	0	0
10	21783539	.	G	A	4	3	7	0	0	7	0	0
10	21783547	.	T	A	6	3	9	0	0	9	0	0
10	21783596	.	G	C	3	5	8	0	1	9	0	0
10	21784071	.	T	C	1	2	3	0	0	3	0	0
10	21784130	.	G	T	0	3	3	0	0	3	0	0
10	21784132	.	C	T	0	3	3	0	0	3	0	0
10	21784186	.	A	G	1	6	7	0	0	7	0	0
10	21784969	.	T	A	2	0	2	0	0	2	0	0
10	21784978	.	C	T	1	0	1	0	0	1	0	0
10	21785677	.	C	T	13	5	18	0	0	18	0	0
10	21786792	.	C	A	2	2	4	0	0	4	0	0
10	21786817	.	G	A	3	3	6	0	0	6	0	0
10	21786832	.	C	T	5	3	8	0	0	8	0	0
10	21788022	.	A	G	4	2	6	0	0	6	0	0
10	21790076	.	A	C	2	4	6	0	0	6	0	0
10	21790121	.	C	A	6	3	9	0	0	9	0	0
10	21790648	.	T	C	1	2	3	0	0	3	0	0
10	21790934	.	T	C	5	4	9	0	1	10	0	0
10	21791090	.	G	A	7	3	10	0	0	10	0	0
10	21791375	.	G	A	4	7	11	0	0	11	0	0
10	21791552	.	G	T	6	2	8	0	0	8	0	0
10	21795065	.	C	T	1	1	2	0	1	3	0	0
10	21795655	.	A	T	2	4	6	0	3	9	0	0
10	21797164	.	G	A	0	2	2	0	2	4	0	0
10	21797207	.	G	C	2	6	8	0	1	9	0	0
10	21797247	.	C	A	3	3	6	0	1	7	0	0
10	21797266	.	C	T	4	2	6	0	0	6	0	0
10	21801115	.	A	G	4	2	6	0	0	6	0	0
10	21801118	.	A	G	4	2	6	0	0	6	0	0
10	21801267	.	C	T	1	2	3	0	0	3	0	0
10	21801339	.	T	G	2	0	2	0	3	5	0	0
10	21801352	.	T	C	2	3	5	0	0	5	0	0
10	21801573	.	C	T	3	2	5	0	0	5	0	0
10	21801590	.	A	C	3	2	5	0	0	5	0	0
10	21801611	.	G	T	0	2	2	0	1	3	0	0
10	21801718	.	G	A	0	3	3	0	3	6	0	0
10	21802086	.	A	G	1	2	3	0	0	3	0	0
10	21802326	.	C	A	2	4	6	0	0	6	0	0
10	21802355	.	C	A	4	3	7	0	0	7	0	0
10	21802661	.	C	T	7	7	14	0	1	15	0	0
10	21802959	.	T	C	10	7	17	0	0	17	0	0
10	21802989	.	T	C	10	7	17	0	0	17	0	0
10	21803004	.	G	A	8	6	14	0	1	15	0	0
10	21803031	.	G	A	2	10	12	0	0	12	0	0
10	21804785	.	G	T	0	2	2	0	1	3	0	0
10	21804786	.	G	T	1	2	3	0	0	3	0	0
10	21806789	.	G	A	6	3	9	0	0	9	0	0
10	21818522	.	C	T	38	39	77	0	1	78	0	0
10	21818595	.	T	G	29	37	66	0	1	67	0	0
10	21818762	.	A	C	23	25	48	0	1	49	0	0
10	21818916	.	C	T	25	29	54	0	3	57	0	0
10	21819019	.	G	A	3	37	40	0	22	62	0	0
10	21819038	.	C	A	25	36	61	0	2	63	0	0
10	21819105	.	G	T	26	29	55	0	1	56	0	0
10	21819214	.	G	C	23	34	57	0	2	59	0	0
10	21819523	.	T	A	24	30	54	0	5	59	0	0
10	21819577	.	C	T	21	36	57	0	11	68	0	0
10	21819653	.	T	C	32	38	70	0	2	72	0	0
10	21819772	.	T	C	24	33	57	0	6	63	0	0
10	21819966	.	A	T	5	4	9	0	2	11	0	0
10	21944029	.	G	T	2	2	4	0	0	4	0	0
10	21944067	.	T	C	1	2	3	0	0	3	0	0
10	21944291	.	T	G	0	1	1	0	0	1	0	0
10	22012534	.	G	A	4	7	11	0	0	11	0	0
10	22030798	.	C	T	9	11	20	0	2	22	0	0
10	22030881	.	A	T	13	25	38	0	0	38	0	0
10	22031375	.	A	C	15	23	38	0	0	38	0	0
10	22031493	.	G	A	32	20	52	0	2	54	0	0
10	22031572	.	A	G	16	23	39	0	5	44	0	0
10	22031635	.	A	G	18	26	44	0	3	47	0	0
10	22031666	.	A	G	17	23	40	0	0	40	0	0
10	22031755	.	T	C	20	13	33	0	4	37	0	0
10	22031759	.	T	C	21	13	34	0	4	38	0	0
10	22031854	.	G	A	19	13	32	0	2	34	0	0
10	22041529	.	G	A	3	4	7	0	0	7	0	0
10	22041717	.	T	C	0	1	1	0	0	1	0	0
10	22044699	.	G	A	5	8	13	0	1	14	0	0
10	22044921	.	T	G	4	8	12	0	0	12	0	0
10	22044982	.	C	T	2	7	9	0	1	10	0	0
10	22045014	.	G	T	6	3	9	0	0	9	0	0
10	22051239	.	T	C	5	3	8	0	0	8	0	0
10	22051474	.	A	C	4	3	7	0	0	7	0	0
10	22052247	.	C	T	0	2	2	0	4	6	0	0
10	22163002	.	G	T	5	5	10	0	0	10	0	0
10	22381984	.	A	T	2	4	6	0	0	6	0	0
10	22382167	.	G	A	0	3	3	0	5	8	0	0
10	22382427	.	T	C	2	4	6	0	0	6	0	0
10	22475679	.	C	A	0	2	2	0	1	3	0	0
10	22475799	.	G	A	0	2	2	0	7	9	0	0
10	22477229	.	A	G	4	2	6	0	0	6	0	0
10	22477661	.	C	T	4	1	5	0	0	5	0	0
10	22516903	.	A	G	0	2	2	0	0	2	0	0
10	22516957	.	T	C	1	2	3	0	0	3	0	0
10	22518237	.	G	A	0	3	3	0	2	5	0	0
10	22518267	.	T	A	2	4	6	0	0	6	0	0
10	22519465	.	A	G	1	2	3	0	0	3	0	0
10	22525652	.	G	A	1	1	2	0	0	2	0	0
10	22528077	.	C	T	0	1	1	0	0	1	0	0
10	22530043	.	C	T	3	4	7	0	0	7	0	0
10	22530058	.	A	C	4	4	8	0	1	9	0	0
10	22530812	.	T	C	7	8	15	0	0	15	0	0
10	22531003	.	T	A	2	8	10	0	1	11	0	0
10	22531179	.	A	G	1	3	4	0	1	5	0	0
10	22531472	.	T	C	6	6	12	0	2	14	0	0
10	22531906	.	A	C	12	11	23	0	1	24	0	0
10	22531912	.	G	A	11	12	23	0	1	24	0	0
10	22532133	.	G	T	9	6	15	0	3	18	0	0
10	22532316	.	G	A	12	11	23	0	1	24	0	0
10	22532347	.	C	T	9	7	16	0	1	17	0	0
10	22532547	.	T	A	14	10	24	0	2	26	0	0
10	22532610	.	A	T	20	14	34	0	2	36	0	0
10	22532817	.	C	G	23	15	38	0	2	40	0	0
10	22745661	.	C	T	1	4	5	0	1	6	0	0
10	22747289	.	G	C	0	1	1	0	6	7	0	0
10	22747913	.	T	C	5	1	6	0	1	7	0	0
10	22748834	.	A	G	2	2	4	0	0	4	0	0
10	22755164	.	C	T	1	4	5	0	1	6	0	0
10	22758016	.	G	A	2	3	5	0	0	5	0	0
10	22760658	.	A	C	3	5	8	0	1	9	0	0
10	22786128	.	T	A	7	13	20	0	1	21	0	0
10	22786227	.	C	T	6	11	17	0	0	17	0	0
10	22811358	.	C	A	2	3	5	0	0	5	0	0
10	22812500	.	A	T	2	4	6	0	1	7	0	0
10	22814750	.	G	A	3	2	5	0	1	6	0	0
10	22838530	.	C	T	1	22	23	0	24	47	0	0
10	22841955	.	G	T	3	7	10	0	2	12	0	0
10	22845293	.	C	T	0	7	7	0	11	18	0	0
10	22855033	.	G	T	3	3	6	0	0	6	0	0
10	22856192	.	G	C	0	2	2	0	1	3	0	0
10	22856201	.	T	C	0	2	2	0	1	3	0	0
10	22893992	.	A	G	3	4	7	0	0	7	0	0
10	22895312	.	T	C	0	1	1	0	1	2	0	0
10	22895327	.	T	C	0	3	3	0	0	3	0	0
10	22896782	.	C	A	0	1	1	0	0	1	0	0
10	22896950	.	C	T	1	1	2	0	0	2	0	0
10	22896959	.	G	A	0	1	1	0	1	2	0	0
10	22897187	.	C	T	6	4	10	0	0	10	0	0
10	22906434	.	C	T	4	1	5	0	0	5	0	0
10	22906844	.	C	T	12	11	23	0	3	26	0	0
10	22906916	.	A	T	10	7	17	0	0	17	0	0
10	22915875	.	A	G	4	4	8	0	0	8	0	0
10	22915897	.	G	A	4	2	6	0	1	7	0	0
10	22915914	.	C	A	4	3	7	0	0	7	0	0
10	22916324	.	A	G	22	25	47	0	5	52	0	0
10	22916339	.	A	G	18	16	34	0	8	42	0	0
10	22916422	.	A	C	20	35	55	0	1	56	0	0
10	22916426	.	T	A	20	34	54	0	1	55	0	0
10	22916664	.	C	T	32	26	58	0	4	62	0	0
10	22916730	.	A	G	24	18	42	0	1	43	0	0
10	22918164	.	T	C	26	11	37	0	8	45	0	0
10	22918190	.	C	T	15	10	25	0	0	25	0	0
10	22918214	.	T	G	4	7	11	0	0	11	0	0
10	22924978	.	A	C	4	6	10	0	0	10	0	0
10	22925049	.	G	A	0	2	2	0	7	9	0	0
10	22925326	.	G	A	2	4	6	0	1	7	0	0
10	22925983	.	A	C	1	5	6	0	0	6	0	0
10	23024405	.	T	C	5	10	15	0	0	15	0	0
10	23024660	.	A	G	10	12	22	0	1	23	0	0
10	23024708	.	T	C	11	11	22	0	0	22	0	0
10	23024762	.	A	G	17	6	23	0	0	23	0	0
10	23026490	.	A	G	1	2	3	0	0	3	0	0
10	23060740	.	G	A	3	0	3	0	0	3	0	0
10	23065777	.	T	C	1	5	6	0	1	7	0	0
10	23068553	.	G	T	3	10	13	0	0	13	0	0
10	23068630	.	A	G	15	9	24	0	0	24	0	0
10	23068907	.	T	G	8	12	20	0	1	21	0	0
10	23068962	.	A	G	12	12	24	0	0	24	0	0
10	23068963	.	C	T	12	12	24	0	0	24	0	0
10	23069120	.	T	C	2	1	3	0	0	3	0	0
10	23069253	.	T	C	4	9	13	0	0	13	0	0
10	23071322	.	G	A	5	5	10	0	1	11	0	0
10	23071524	.	G	T	1	5	6	0	0	6	0	0
10	23071619	.	A	G	3	7	10	0	1	11	0	0
10	23071697	.	G	A	3	2	5	0	0	5	0	0
10	23071705	.	G	C	0	1	1	0	0	1	0	0
10	23126558	.	T	C	2	1	3	0	0	3	0	0
10	23139296	.	C	T	1	2	3	0	0	3	0	0
10	23141830	.	T	G	1	2	3	0	0	3	0	0
10	23220533	.	A	G	1	0	1	0	1	2	0	0
10	24325590	.	C	T	2	0	2	0	0	2	0	0
10	24334999	.	T	G	7	0	7	0	0	7	0	0
10	24373137	.	C	T	4	3	7	0	0	7	0	0
10	24422052	.	C	T	9	7	16	0	1	17	0	0
10	24422070	.	T	A	10	7	17	0	1	18	0	0
10	24422236	.	C	T	7	7	14	0	0	14	0	0
10	24425257	.	A	G	4	6	10	0	1	11	0	0
10	24426924	.	A	G	1	3	4	0	0	4	0	0
10	24427010	.	G	C	5	4	9	0	0	9	0	0
10	24429262	.	C	T	6	6	12	0	0	12	0	0
10	24429282	.	A	C	7	3	10	0	2	12	0	0
10	24429342	.	T	C	9	5	14	0	0	14	0	0
10	24429386	.	C	T	7	5	12	0	1	13	0	0
10	24431719	.	A	T	11	5	16	0	3	19	0	0
10	24431795	.	T	C	3	1	4	0	0	4	0	0
10	24431807	.	C	T	1	1	2	0	1	3	0	0
10	24437128	.	A	G	2	2	4	0	0	4	0	0
10	24441916	.	C	T	7	11	18	0	1	19	0	0
10	24442466	.	C	T	6	3	9	0	0	9	0	0
10	24442490	.	A	G	3	0	3	0	3	6	0	0
10	24563892	.	T	G	4	3	7	0	0	7	0	0
10	24565137	.	G	A	0	4	4	0	3	7	0	0
10	24565139	.	A	T	3	4	7	0	0	7	0	0
10	24600128	.	A	G	2	3	5	0	1	6	0	0
10	24616839	.	C	A	1	1	2	0	0	2	0	0
10	24617156	.	G	A	3	1	4	0	0	4	0	0
10	24617621	.	G	C	0	0	0	0	1	1	0	0
10	24617624	.	G	A	1	1	2	0	0	2	0	0
10	24621354	.	A	G	3	5	8	0	0	8	0	0
10	24621534	.	T	A	10	4	14	0	0	14	0	0
10	24621722	.	C	G	2	6	8	0	0	8	0	0
10	24621730	.	A	T	2	4	6	0	0	6	0	0
10	24621757	.	T	A	0	4	4	0	0	4	0	0
10	24650192	.	A	G	1	6	7	0	1	8	0	0
10	24650655	.	C	A	3	2	5	0	0	5	0	0
10	24652174	.	A	T	3	1	4	0	1	5	0	0
10	24654319	.	A	C	4	4	8	0	0	8	0	0
10	24677136	.	T	G	4	5	9	0	0	9	0	0
10	24677253	.	T	A	2	2	4	0	0	4	0	0
10	24710599	.	A	C	1	3	4	0	0	4	0	0
10	24710977	.	G	A	3	5	8	0	0	8	0	0
10	24725724	.	G	A	1	3	4	0	0	5	1	0
10	24726211	.	T	A	4	6	10	0	0	10	0	0
10	24726264	.	G	A	7	3	10	0	1	11	0	0
10	24726302	.	A	G	5	3	8	0	0	8	0	0
10	24726440	.	A	G	5	2	7	0	0	7	0	0
10	24726453	.	G	A	3	2	5	0	0	5	0	0
10	24726809	.	A	G	3	4	7	0	0	7	0	0
10	24727127	.	A	G	0	1	1	0	0	1	0	0
10	24762377	.	G	A	5	7	12	0	0	12	0	0
10	24762402	.	C	A	6	5	11	0	1	12	0	0
10	24762462	.	T	C	4	1	5	0	6	11	0	0
10	24762543	.	G	A	5	9	14	0	0	14	0	0
10	24762553	.	G	A	3	8	11	0	0	11	0	0
10	24762774	.	T	G	9	5	14	0	0	14	0	0
10	25205354	.	A	C	3	6	9	0	0	9	0	0
10	25209612	.	G	A	7	1	8	0	1	9	0	0
10	25210125	.	C	A	4	8	12	0	1	13	0	0
10	25214387	.	C	T	1	5	6	0	0	6	0	0
10	25214397	.	C	T	3	3	6	0	2	8	0	0
10	25214627	.	C	T	1	6	7	0	0	7	0	0
10	25214948	.	A	T	3	2	5	0	0	5	0	0
10	25262150	.	T	A	1	2	3	0	0	3	0	0
10	25262279	.	C	T	6	3	9	0	1	10	0	0
10	25262336	.	C	T	0	1	1	0	0	1	0	0
10	25269245	.	C	T	6	4	10	0	1	11	0	0
10	25269310	.	G	T	5	2	7	0	0	7	0	0
10	25269325	.	T	G	7	9	16	0	0	16	0	0
10	25269470	.	A	G	5	10	15	0	1	16	0	0
10	25269599	.	C	T	17	12	29	0	1	30	0	0
10	25269742	.	C	T	4	24	28	0	0	28	0	0
10	25269747	.	T	A	24	2	26	0	0	26	0	0
10	25269983	.	A	G	12	12	24	0	4	28	0	0
10	25270019	.	C	G	14	12	26	0	1	27	0	0
10	25270096	.	T	C	12	9	21	0	3	24	0	0
10	25270432	.	A	G	8	16	24	0	3	27	0	0
10	25270470	.	A	G	9	13	22	0	3	25	0	0
10	25270471	.	A	G	11	13	24	0	1	25	0	0
10	25270643	.	A	G	26	8	34	0	0	34	0	0
10	25270803	.	A	T	12	20	32	0	5	37	0	0
10	25270958	.	C	T	20	13	33	0	2	35	0	0
10	25271323	.	A	G	17	13	30	0	2	32	0	0
10	25312733	.	T	G	3	9	12	0	3	15	0	0
10	25329811	.	C	A	0	11	11	0	9	20	0	0
10	25330646	.	G	A	14	19	33	0	1	34	0	0
10	25336271	.	A	G	0	1	1	0	0	1	0	0
10	25338762	.	G	A	5	9	14	0	0	14	0	0
10	25368477	.	T	G	1	2	3	0	0	3	0	0
10	25368481	.	G	A	0	2	2	0	1	3	0	0
10	25383883	.	G	A	1	2	3	0	0	3	0	0
10	25403139	.	G	A	4	4	8	0	1	9	0	0
10	25403280	.	C	G	0	6	6	0	6	12	0	0
10	25403402	.	C	T	0	10	10	0	4	14	0	0
10	25410276	.	T	C	3	0	3	0	10	13	0	0
10	25410288	.	A	G	5	8	13	0	3	16	0	0
10	25410389	.	A	G	6	7	13	0	0	13	0	0
10	25436452	.	A	G	3	4	7	0	0	7	0	0
10	25461335	.	C	T	0	1	1	0	0	1	0	0
10	25573218	.	A	G	10	14	24	0	4	28	0	0
10	25573333	.	G	A	8	11	19	0	1	20	0	0
10	25573365	.	C	A	9	12	21	0	0	21	0	0
10	25574159	.	T	C	3	10	13	0	0	13	0	0
10	25574181	.	C	T	0	10	10	0	3	13	0	0
10	25580119	.	A	T	0	1	1	0	0	1	0	0
10	25580316	.	C	T	0	1	1	0	0	1	0	0
10	25582029	.	A	G	2	2	4	0	0	4	0	0
10	25582074	.	G	T	1	5	6	0	0	6	0	0
10	25582656	.	C	T	2	3	5	0	0	5	0	0
10	25600712	.	A	G	1	2	3	0	0	3	0	0
10	25601799	.	T	C	0	3	3	0	0	3	0	0
10	25694920	.	G	A	3	1	4	0	0	4	0	0
10	25697655	.	A	G	5	8	13	0	3	16	0	0
10	25697715	.	G	C	6	5	11	0	1	12	0	0
10	25700984	.	G	A	0	5	5	0	0	5	0	0
10	25701036	.	G	A	0	4	4	0	1	5	0	0
10	25701659	.	G	C	14	12	26	0	4	30	0	0
10	25701673	.	T	A	17	13	30	0	0	30	0	0
10	25704345	.	C	T	3	3	6	0	0	6	0	0
10	25706228	.	G	A	1	2	3	0	1	4	0	0
10	25829724	.	C	T	0	2	2	0	2	4	0	0
10	25830544	.	T	G	6	7	13	0	1	14	0	0
10	25830687	.	A	G	5	10	15	0	0	15	0	0
10	25830723	.	T	G	1	8	9	0	1	10	0	0
10	25837613	.	A	G	2	3	5	0	0	5	0	0
10	25852305	.	T	G	1	3	4	0	0	4	0	0
10	25948190	.	A	T	1	0	1	0	0	1	0	0
10	25960676	.	A	C	7	11	18	0	3	21	0	0
10	25960718	.	T	C	10	8	18	0	1	19	0	0
10	25960728	.	G	T	8	9	17	0	1	18	0	0
10	25961396	.	T	C	2	5	7	0	0	7	0	0
10	25961397	.	T	A	2	5	7	0	0	7	0	0
10	25961454	.	G	C	6	15	21	0	1	22	0	0
10	25961510	.	A	C	8	14	22	0	2	24	0	0
10	25961778	.	A	G	7	10	17	0	1	18	0	0
10	26112160	.	A	C	0	2	2	0	0	2	0	0
10	26113370	.	G	A	2	4	6	0	1	7	0	0
10	26113522	.	A	T	2	3	5	0	0	5	0	0
10	26113931	.	C	T	5	8	13	0	1	14	0	0
10	26114508	.	A	T	6	2	8	0	0	8	0	0
10	26114509	.	C	T	6	2	8	0	0	8	0	0
10	26114668	.	C	A	2	5	7	0	0	7	0	0
10	26114894	.	A	T	7	6	13	0	1	14	0	0
10	26114922	.	A	C	5	4	9	0	0	9	0	0
10	26114952	.	A	T	2	2	4	0	0	4	0	0
10	26115080	.	G	C	4	4	8	0	0	8	0	0
10	26115225	.	C	T	3	7	10	0	0	10	0	0
10	26123649	.	A	T	1	1	2	0	0	2	0	0
10	26123667	.	A	C	1	1	2	0	0	2	0	0
10	26126639	.	C	G	8	7	15	0	1	16	0	0
10	26126643	.	T	C	8	8	16	0	1	17	0	0
10	26126995	.	A	T	3	7	10	0	4	14	0	0
10	26127054	.	G	A	9	11	20	0	0	20	0	0
10	26127075	.	T	C	7	9	16	0	0	16	0	0
10	26127291	.	T	C	12	11	23	0	0	23	0	0
10	26127479	.	C	A	5	6	11	0	1	12	0	0
10	26127484	.	C	T	5	5	10	0	0	10	0	0
10	26127643	.	G	A	8	6	14	0	0	14	0	0
10	26127731	.	C	T	3	7	10	0	1	11	0	0
10	26127968	.	G	T	3	4	7	0	1	8	0	0
10	26128067	.	A	T	5	9	14	0	1	15	0	0
10	26131166	.	G	A	12	5	17	0	0	17	0	0
10	26131195	.	C	T	0	7	7	0	15	22	0	0
10	26131551	.	C	G	18	13	31	0	2	33	0	0
10	26131653	.	C	T	19	15	34	0	2	36	0	0
10	26131717	.	A	T	12	11	23	0	1	24	0	0
10	26131719	.	T	C	12	11	23	0	1	24	0	0
10	26131806	.	A	T	8	2	10	0	3	13	0	0
10	26131989	.	C	T	10	4	14	0	0	14	0	0
10	26132084	.	G	T	3	5	8	0	2	10	0	0
10	26132356	.	A	G	5	5	10	0	0	10	0	0
10	26132437	.	A	T	16	10	26	0	0	26	0	0
10	26132553	.	A	G	15	15	30	0	2	32	0	0
10	26132630	.	C	A	0	3	3	0	4	7	0	0
10	26139304	.	G	A	13	13	26	0	0	26	0	0
10	26139352	.	A	T	5	8	13	0	0	13	0	0
10	26141198	.	C	T	2	0	2	0	0	2	0	0
10	26144153	.	T	G	4	9	13	0	0	13	0	0
10	26144180	.	A	G	3	7	10	0	0	10	0	0
10	26144243	.	A	G	7	6	13	0	1	14	0	0
10	26144249	.	C	A	9	7	16	0	0	16	0	0
10	26155871	.	T	G	5	0	5	0	0	5	0	0
10	26203499	.	T	G	4	4	8	0	0	8	0	0
10	26204834	.	C	A	4	8	12	0	0	12	0	0
10	26204886	.	A	T	11	6	17	0	0	17	0	0
10	26204897	.	G	C	12	8	20	0	0	20	0	0
10	26205602	.	T	G	2	2	4	0	0	4	0	0
10	26205909	.	C	A	7	5	12	0	1	13	0	0
10	26206371	.	A	G	0	1	1	0	0	1	0	0
10	26206509	.	C	T	0	1	1	0	1	2	0	0
10	26209385	.	C	T	1	4	5	0	1	6	0	0
10	26209400	.	C	T	2	4	6	0	0	6	0	0
10	26269180	.	C	G	2	3	5	0	0	5	0	0
10	26269186	.	A	G	3	3	6	0	0	6	0	0
10	26269728	.	G	A	3	3	6	0	0	6	0	0
10	26270084	.	T	A	1	4	5	0	2	7	0	0
10	26270388	.	C	A	0	6	6	0	1	7	0	0
10	26271159	.	G	T	2	3	5	0	0	5	0	0
10	26271168	.	G	A	2	3	5	0	0	5	0	0
10	26273094	.	G	A	0	3	3	0	0	3	0	0
10	26273139	.	C	T	0	1	1	0	0	1	0	0
10	26279124	.	G	A	3	2	5	0	0	5	0	0
10	26543567	.	A	G	0	4	4	0	0	4	0	0
10	26547356	.	C	T	2	3	5	0	0	5	0	0
10	26551197	.	T	C	2	4	6	0	1	7	0	0
10	26551242	.	A	G	3	2	5	0	0	5	0	0
10	26553007	.	T	A	12	3	15	0	5	20	0	0
10	26560166	.	T	C	1	1	2	0	1	3	0	0
10	26560260	.	C	T	12	14	26	0	2	28	0	0
10	26565704	.	T	C	19	21	40	0	5	45	0	0
10	26565760	.	G	A	1	16	17	0	18	35	0	0
10	26566054	.	G	C	1	17	18	0	16	34	0	0
10	26566267	.	T	C	15	15	30	0	3	33	0	0
10	26566354	.	A	T	13	8	21	0	0	21	0	0
10	26566369	.	A	T	9	6	15	0	1	16	0	0
10	26566715	.	T	A	8	5	13	0	0	13	0	0
10	26566749	.	G	A	8	4	12	0	1	13	0	0
10	26566785	.	T	A	10	5	15	0	1	16	0	0
10	26566787	.	A	T	10	6	16	0	0	16	0	0
10	26566855	.	A	G	9	0	9	0	11	20	0	0
10	26567238	.	A	G	20	13	33	0	2	35	0	0
10	26567337	.	C	T	13	24	37	0	3	40	0	0
10	26567376	.	C	G	12	21	33	0	5	38	0	0
10	26567500	.	C	T	16	19	35	0	3	38	0	0
10	26567656	.	G	C	22	7	29	0	2	31	0	0
10	26567810	.	C	T	12	10	22	0	3	25	0	0
10	26567889	.	T	A	13	9	22	0	1	23	0	0
10	26568154	.	A	T	17	12	29	0	0	29	0	0
10	26568166	.	C	T	12	12	24	0	1	25	0	0
10	26568201	.	A	G	6	11	17	0	0	17	0	0
10	26568239	.	C	T	7	5	12	0	0	12	0	0
10	26568429	.	A	C	20	20	40	0	0	41	1	0
10	26568498	.	T	C	20	27	47	0	3	50	0	0
10	26568523	.	G	T	16	28	44	0	2	46	0	0
10	26568726	.	A	G	24	28	52	0	1	53	0	0
10	26569098	.	A	G	20	0	20	0	19	39	0	0
10	26569099	.	A	C	21	18	39	0	0	39	0	0
10	26569248	.	C	A	17	13	30	0	1	31	0	0
10	26574004	.	T	C	2	3	5	0	0	5	0	0
10	26578528	.	T	C	2	0	2	0	0	2	0	0
10	26583978	.	C	G	2	1	3	0	0	3	0	0
10	26596020	.	T	A	24	18	42	0	1	43	0	0
10	26596075	.	C	T	20	19	39	0	0	39	0	0
10	26596080	.	T	C	19	15	34	0	2	36	0	0
10	26596404	.	T	C	1	3	4	0	1	5	0	0
10	26656135	.	A	C	2	0	2	0	0	2	0	0
10	26933176	.	G	T	10	6	16	0	1	17	0	0
10	26958150	.	G	C	1	4	5	0	1	6	0	0
10	26958457	.	A	G	7	4	11	0	1	12	0	0
10	26958491	.	C	A	7	4	11	0	0	11	0	0
10	26958609	.	G	A	5	2	7	0	0	7	0	0
10	26959827	.	C	T	1	3	4	0	0	4	0	0
10	26959894	.	C	A	5	5	10	0	0	10	0	0
10	26960281	.	A	G	5	5	10	0	0	10	0	0
10	26972152	.	T	C	10	12	22	0	0	22	0	0
10	26972392	.	A	T	5	8	13	0	0	13	0	0
10	26972429	.	A	T	3	5	8	0	1	9	0	0
10	26977154	.	G	A	1	1	2	0	0	2	0	0
10	26978169	.	C	G	10	13	23	0	0	23	0	0
10	26982258	.	G	A	1	2	3	0	0	3	0	0
10	26982262	.	A	G	1	1	2	0	0	2	0	0
10	26982455	.	C	T	4	2	6	0	0	6	0	0
10	26982565	.	G	A	4	2	6	0	0	6	0	0
10	26982572	.	C	G	4	3	7	0	0	7	0	0
10	26982670	.	G	A	6	2	8	0	0	8	0	0
10	26983539	.	G	A	1	2	3	0	0	3	0	0
10	26987399	.	T	C	4	1	5	0	15	20	0	0
10	26989543	.	T	C	2	5	7	0	0	7	0	0
10	26989828	.	A	T	9	5	14	0	1	15	0	0
10	26989843	.	A	T	9	7	16	0	0	16	0	0
10	26990140	.	C	G	3	3	6	0	0	6	0	0
10	26991487	.	T	C	1	5	6	0	0	6	0	0
10	26991785	.	C	G	3	3	6	0	0	6	0	0
10	26991875	.	A	T	7	5	12	0	1	13	0	0
10	26991876	.	C	G	8	5	13	0	0	13	0	0
10	26991914	.	A	T	8	4	12	0	0	12	0	0
10	26991984	.	G	C	0	5	5	0	0	5	0	0
10	26991990	.	T	C	0	1	1	0	4	5	0	0
10	26997077	.	C	A	9	13	22	0	1	23	0	0
10	26997139	.	G	T	9	8	17	0	0	17	0	0
10	26997294	.	T	A	2	4	6	0	0	6	0	0
10	26999165	.	T	C	15	0	15	0	20	35	0	0
10	26999341	.	C	T	12	11	23	0	1	24	0	0
10	26999407	.	A	T	3	12	15	0	1	16	0	0
10	26999414	.	A	G	3	11	14	0	1	15	0	0
10	27006512	.	T	A	12	19	31	0	0	31	0	0
10	27006721	.	T	C	3	6	9	0	2	11	0	0
10	27046400	.	T	A	5	12	17	0	1	18	0	0
10	27057605	.	G	A	2	1	3	0	0	3	0	0
10	27092323	.	T	G	2	3	5	0	0	5	0	0
10	27183328	.	T	G	8	19	27	0	4	31	0	0
10	27183418	.	C	T	9	14	23	1	2	26	0	0
10	27183735	.	C	T	1	15	16	0	8	24	0	0
10	27184069	.	G	A	22	19	41	0	5	46	0	0
10	27184237	.	A	G	19	9	28	0	0	28	0	0
10	27184456	.	A	G	6	6	12	0	1	13	0	0
10	27184600	.	G	A	7	5	12	0	0	12	0	0
10	27184729	.	C	T	8	7	15	0	0	15	0	0
10	27184843	.	G	A	10	13	23	0	1	24	0	0
10	27184891	.	T	A	7	8	15	0	1	16	0	0
10	27184905	.	C	T	0	8	8	0	6	14	0	0
10	27185134	.	A	G	6	2	8	0	0	8	0	0
10	27196699	.	G	T	2	3	5	0	1	6	0	0
10	27977530	.	A	C	3	4	7	0	1	8	0	0
10	27977551	.	G	A	3	3	6	0	0	6	0	0
10	27977673	.	C	T	4	3	7	0	0	7	0	0
10	27977678	.	C	T	3	3	6	0	0	6	0	0
10	27978002	.	A	T	6	4	10	0	1	11	0	0
10	27978055	.	T	C	4	3	7	0	0	7	0	0
10	27988440	.	A	G	1	2	3	0	0	3	0	0
10	28030710	.	C	T	0	9	9	0	8	17	0	0
10	28030753	.	A	G	9	8	17	0	0	17	0	0
10	28030843	.	C	T	11	11	22	0	3	25	0	0
10	28036119	.	G	A	5	6	11	0	0	11	0	0
10	28037735	.	C	T	5	6	11	0	2	13	0	0
10	28037759	.	C	T	5	6	11	0	1	12	0	0
10	28038167	.	G	A	1	3	4	0	0	4	0	0
10	28039040	.	C	T	2	1	3	0	1	4	0	0
10	28040705	.	G	T	4	10	14	0	2	16	0	0
10	28041218	.	G	C	4	8	12	0	1	13	0	0
10	28043421	.	T	C	1	5	6	0	0	6	0	0
10	28043454	.	T	G	2	6	8	0	0	8	0	0
10	28043490	.	G	A	2	4	6	0	0	6	0	0
10	28168295	.	C	G	2	2	4	0	1	5	0	0
10	28169061	.	G	A	3	3	6	0	0	6	0	0
10	28172354	.	C	T	0	4	4	0	6	10	0	0
10	28172501	.	T	G	3	3	6	0	0	6	0	0
10	28172672	.	A	C	1	1	2	0	0	2	0	0
10	28308418	.	G	T	0	1	1	0	0	1	0	0
10	28308419	.	T	G	0	1	1	0	0	1	0	0
10	28308710	.	A	T	2	2	4	0	0	4	0	0
10	28308865	.	A	T	3	4	7	0	0	7	0	0
10	28311161	.	A	G	18	25	43	0	1	44	0	0
10	28315096	.	A	G	19	19	38	0	0	38	0	0
10	28315396	.	A	G	13	25	38	0	1	39	0	0
10	28315421	.	C	G	7	16	23	0	7	30	0	0
10	28319441	.	A	G	11	8	19	0	2	21	0	0
10	28321051	.	G	A	6	7	13	0	1	14	0	0
10	28323325	.	A	T	1	3	4	0	0	4	0	0
10	28328174	.	T	C	4	2	6	0	0	6	0	0
10	28339621	.	C	T	1	0	1	0	0	1	0	0
10	28371198	.	G	A	13	9	22	0	3	25	0	0
10	28371284	.	G	A	12	15	27	0	0	27	0	0
10	28371407	.	C	T	0	4	4	0	10	14	0	0
10	28376895	.	C	T	3	6	9	0	0	9	0	0
10	28483440	.	G	T	2	2	4	0	0	4	0	0
10	28690959	.	A	T	0	1	1	0	1	2	0	0
10	28695869	.	T	A	2	2	4	0	0	4	0	0
10	28723769	.	A	T	1	2	3	0	0	3	0	0
10	28723805	.	G	A	0	3	3	0	3	6	0	0
10	28724220	.	G	A	2	1	3	0	1	4	0	0
10	28730437	.	G	T	5	7	12	0	0	12	0	0
10	28730446	.	A	C	7	5	12	0	0	12	0	0
10	28730503	.	G	A	3	6	9	0	0	9	0	0
10	28730738	.	C	T	3	2	5	0	0	5	0	0
10	28730800	.	A	T	4	2	6	0	0	10	4	0
10	28730869	.	C	T	7	9	16	0	1	17	0	0
10	28730880	.	T	A	8	12	20	0	1	21	0	0
10	28730913	.	G	A	18	7	25	0	1	26	0	0
10	28731001	.	C	T	9	11	20	0	1	21	0	0
10	28731072	.	C	T	11	5	16	0	2	18	0	0
10	28731155	.	A	T	6	6	12	0	2	14	0	0
10	28731289	.	T	C	6	8	14	0	1	15	0	0
10	28731372	.	G	A	2	13	15	0	10	25	0	0
10	28732003	.	C	A	20	20	40	0	1	41	0	0
10	28732366	.	A	G	14	16	30	0	1	31	0	0
10	28732601	.	C	T	0	13	13	0	19	32	0	0
10	28732785	.	T	C	18	13	31	0	4	35	0	0
10	28733067	.	G	T	21	17	38	0	1	39	0	0
10	28733132	.	T	A	11	13	24	0	1	25	0	0
10	28737345	.	C	T	7	1	8	0	0	8	0	0
10	28743800	.	T	A	9	6	15	0	0	15	0	0
10	28745583	.	G	A	5	5	10	0	1	11	0	0
10	28748996	.	G	A	2	0	2	0	0	2	0	0
10	28835635	.	C	G	2	2	4	0	0	4	0	0
10	28835655	.	G	A	3	2	5	0	0	5	0	0
10	29166502	.	A	G	5	3	8	0	1	9	0	0
10	29185863	.	T	A	1	1	2	0	0	2	0	0
10	29187908	.	C	T	3	3	6	0	1	7	0	0
10	29201671	.	C	T	3	2	5	0	2	7	0	0
10	29205655	.	A	T	5	4	9	0	1	10	0	0
10	29223795	.	T	C	2	1	3	0	0	3	0	0
10	29224484	.	G	A	8	16	24	0	4	28	0	0
10	29224598	.	A	T	30	8	38	0	0	38	0	0
10	29224651	.	C	A	18	14	32	0	5	37	0	0
10	29225032	.	A	G	10	0	10	0	12	22	0	0
10	29265596	.	A	G	8	0	8	0	7	15	0	0
10	29265599	.	T	A	8	5	13	0	1	14	0	0
10	29266279	.	C	A	2	0	2	0	1	3	0	0
10	29266376	.	C	T	21	20	41	0	2	43	0	0
10	29270225	.	C	T	11	6	17	0	0	17	0	0
10	29271915	.	C	T	7	5	12	0	0	12	0	0
10	29572857	.	C	T	1	1	2	0	0	2	0	0
10	29578478	.	C	T	0	3	3	0	1	4	0	0
10	29661410	.	C	T	2	0	2	0	0	2	0	0
10	29661419	.	C	G	2	0	2	0	0	2	0	0
10	29678313	.	G	A	0	2	2	0	0	2	0	0
10	29705444	.	G	T	2	2	4	0	0	4	0	0
10	29736736	.	T	C	5	0	5	0	3	8	0	0
10	29736746	.	C	T	0	2	2	0	6	8	0	0
10	29742795	.	T	C	2	1	3	0	0	3	0	0
10	29751328	.	G	A	13	12	25	0	2	27	0	0
10	29761405	.	C	T	2	0	2	0	0	2	0	0
10	29761761	.	A	T	3	5	8	0	0	8	0	0
10	29761767	.	G	A	4	4	8	0	0	8	0	0
10	29762935	.	G	A	0	2	2	0	2	4	0	0
10	29762947	.	G	A	0	1	1	0	0	1	0	0
10	29763146	.	A	G	3	2	5	0	0	5	0	0
10	29768405	.	G	T	2	3	5	0	0	5	0	0
10	29815697	.	A	C	3	2	5	0	8	13	0	0
10	29815802	.	A	G	29	21	50	0	0	50	0	0
10	29816113	.	T	C	29	24	53	0	1	54	0	0
10	29816290	.	T	A	18	28	46	0	3	49	0	0
10	29816439	.	A	T	10	17	27	0	0	27	0	0
10	29816904	.	C	T	20	39	59	0	5	64	0	0
10	29817111	.	C	T	33	39	72	0	7	79	0	0
10	29817207	.	C	T	33	30	63	0	2	65	0	0
10	29817416	.	A	T	34	19	53	0	0	53	0	0
10	29820414	.	G	C	2	4	6	0	0	6	0	0
10	29820495	.	G	A	4	6	10	0	0	10	0	0
10	29823484	.	G	A	0	2	2	0	0	2	0	0
10	29824262	.	C	T	5	2	7	0	1	8	0	0
10	29851722	.	C	T	18	29	47	0	5	52	0	0
10	29852317	.	G	A	5	4	9	0	0	9	0	0
10	29852476	.	A	G	15	1	16	0	19	35	0	0
10	29852485	.	A	G	10	1	11	0	17	28	0	0
10	29892283	.	C	T	0	3	3	0	2	5	0	0
10	30576004	.	T	C	1	3	4	0	0	4	0	0
10	30576061	.	G	A	1	2	3	0	0	3	0	0
10	30618313	.	T	A	2	2	4	0	0	4	0	0
10	30623408	.	G	A	2	3	5	0	0	5	0	0
10	31020810	.	A	G	4	7	11	0	2	13	0	0
10	31021505	.	T	C	6	8	14	0	0	14	0	0
10	31021550	.	G	A	8	11	19	0	2	21	0	0
10	31021553	.	G	A	11	10	21	0	0	21	0	0
10	31021611	.	C	T	17	8	25	0	2	27	0	0
10	31021676	.	G	A	8	18	26	0	2	28	0	0
10	31023520	.	A	G	10	8	18	0	0	18	0	0
10	31032043	.	T	C	6	4	10	0	0	10	0	0
10	31034999	.	C	T	0	1	1	0	0	1	0	0
10	31035129	.	C	T	7	3	10	0	0	10	0	0
10	31035147	.	C	T	2	6	8	0	0	8	0	0
10	31066888	.	C	T	0	4	4	0	3	7	0	0
10	31628481	.	T	C	0	1	1	0	0	1	0	0
10	31632643	.	C	T	6	6	12	0	0	12	0	0
10	31632691	.	G	A	4	4	8	0	1	9	0	0
10	31632758	.	A	T	2	2	4	0	0	4	0	0
10	31632829	.	A	G	2	4	6	0	0	6	0	0
10	31632945	.	C	T	5	2	7	0	0	7	0	0
10	31633077	.	A	C	5	8	13	0	1	14	0	0
10	31633640	.	G	A	4	5	9	0	1	10	0	0
10	31633669	.	C	T	5	2	7	0	0	7	0	0
10	31725404	.	C	T	1	2	3	0	0	3	0	0
10	31725697	.	C	T	4	2	6	0	0	6	0	0
10	31725736	.	T	C	5	5	10	0	0	10	0	0
10	31738616	.	A	G	8	5	13	0	0	13	0	0
10	31739181	.	G	T	29	22	51	0	1	52	0	0
10	31739346	.	G	T	21	21	42	0	0	42	0	0
10	31751941	.	C	T	4	4	8	0	1	9	0	0
10	31757307	.	C	T	30	19	49	0	0	49	0	0
10	31772041	.	G	A	14	16	30	0	4	34	0	0
10	31782605	.	C	T	3	2	5	0	0	5	0	0
10	31800313	.	A	G	2	2	4	0	0	4	0	0
10	32037088	.	A	T	2	1	3	0	1	4	0	0
10	32037355	.	C	T	0	3	3	0	3	6	0	0
10	32037373	.	T	C	3	2	5	0	0	5	0	0
10	32037794	.	T	A	4	3	7	0	0	7	0	0
10	32037951	.	C	T	1	2	3	0	0	3	0	0
10	32038054	.	A	T	3	3	6	0	1	7	0	0
10	32038071	.	A	T	3	2	5	0	1	6	0	0
10	32064121	.	A	T	5	4	9	0	0	9	0	0
10	32064222	.	A	T	3	5	8	0	0	8	0	0
10	32106288	.	C	T	1	1	2	0	1	3	0	0
10	32122727	.	T	C	1	2	3	0	0	3	0	0
10	32122738	.	T	C	1	3	4	0	0	4	0	0
10	32122952	.	T	A	5	2	7	0	0	7	0	0
10	32265193	.	T	A	1	2	3	0	1	4	0	0
10	32265199	.	G	A	2	2	4	0	0	4	0	0
10	32265331	.	A	C	4	5	9	0	0	9	0	0
10	32383514	.	G	A	1	1	2	0	0	2	0	0
10	32398296	.	T	A	0	1	1	0	0	1	0	0
10	32561338	.	G	A	3	5	8	0	0	8	0	0
10	32561427	.	A	C	5	1	6	0	0	6	0	0
10	32561437	.	T	A	5	3	8	0	0	8	0	0
10	32561564	.	A	C	5	5	10	0	0	10	0	0
10	32561575	.	C	T	4	2	6	0	0	6	0	0
10	32561817	.	G	A	1	8	9	0	7	16	0	0
10	32561820	.	G	T	6	8	14	0	1	15	0	0
10	32562267	.	C	T	9	5	14	0	1	15	0	0
10	32577486	.	G	A	4	4	8	0	0	8	0	0
10	32577489	.	A	G	4	6	10	0	0	10	0	0
10	32577522	.	C	T	8	12	20	0	2	22	0	0
10	32577549	.	T	C	9	14	23	0	1	24	0	0
10	32577621	.	G	A	7	6	13	0	0	13	0	0
10	34402897	.	A	G	4	4	8	0	0	8	0	0
10	34662349	.	C	T	1	2	3	0	0	3	0	0
10	34676266	.	G	T	1	2	3	0	0	3	0	0
10	34677539	.	T	C	1	3	4	0	0	4	0	0
10	34701434	.	A	C	5	6	11	0	0	11	0	0
10	34707546	.	A	T	1	3	4	0	0	4	0	0
10	34709940	.	C	T	2	5	7	0	2	9	0	0
10	34724906	.	C	T	2	2	4	0	0	4	0	0
10	34729552	.	G	A	13	10	23	0	2	25	0	0
10	34729693	.	C	T	0	2	2	0	0	2	0	0
10	34733566	.	A	G	31	12	43	0	4	47	0	0
10	34733578	.	A	G	29	0	29	0	18	48	1	0
10	34733661	.	C	T	14	22	36	0	4	40	0	0
10	34733883	.	A	T	23	11	34	0	1	35	0	0
10	34734568	.	G	T	0	20	20	0	22	42	0	0
10	34734590	.	A	G	21	20	41	0	5	46	0	0
10	34734785	.	G	T	21	9	30	0	2	32	0	0
10	34737686	.	A	G	17	21	38	0	2	40	0	0
10	34738125	.	T	C	24	19	43	0	5	48	0	0
10	34741649	.	T	A	7	2	9	0	1	10	0	0
10	34743910	.	G	A	2	0	2	0	0	2	0	0
10	34754660	.	C	T	13	8	21	0	3	24	0	0
10	34756936	.	A	C	2	1	3	0	0	3	0	0
10	34768261	.	T	C	2	3	5	0	0	5	0	0
10	34768311	.	A	T	1	4	5	0	0	5	0	0
10	34768327	.	C	A	1	4	5	0	0	5	0	0
10	34813299	.	T	C	4	2	6	0	0	6	0	0
10	34867466	.	C	T	0	2	2	0	0	2	0	0
10	34913407	.	G	A	0	1	1	0	0	1	0	0
10	34915433	.	T	G	2	2	4	0	0	4	0	0
10	34951192	.	C	T	1	1	2	0	0	2	0	0
10	34958760	.	A	T	14	6	20	0	1	21	0	0
10	34961149	.	C	A	6	16	22	0	3	25	0	0
10	34983561	.	A	G	2	2	4	0	0	4	0	0
10	34984675	.	T	A	0	4	4	0	0	4	0	0
10	34984836	.	A	G	13	23	36	0	1	37	0	0
10	34984923	.	T	C	8	7	15	0	0	15	0	0
10	34984931	.	C	A	0	7	7	0	6	13	0	0
10	34998281	.	G	C	5	4	9	0	0	9	0	0
10	35002400	.	C	A	0	1	1	0	0	1	0	0
10	35006358	.	T	C	2	1	3	0	0	3	0	0
10	35008963	.	C	T	0	3	3	0	1	4	0	0
10	35011325	.	C	T	4	5	9	0	0	9	0	0
10	35011337	.	A	G	5	4	9	0	0	9	0	0
10	35011482	.	G	A	3	2	5	0	2	7	0	0
10	35169789	.	C	A	3	2	5	0	0	5	0	0
10	35236801	.	T	G	1	1	2	0	0	2	0	0
10	35241646	.	A	T	4	4	8	0	1	9	0	0
10	35245939	.	T	A	3	3	6	0	0	6	0	0
10	35245951	.	C	T	2	3	5	0	0	5	0	0
10	35247905	.	G	A	1	2	3	0	1	4	0	0
10	35266720	.	G	A	0	1	1	0	0	1	0	0
10	35281335	.	C	T	1	2	3	0	2	5	0	0
10	35292112	.	G	A	0	1	1	0	0	1	0	0
10	35298732	.	A	G	1	1	2	0	0	2	0	0
10	35300764	.	C	T	1	3	4	0	0	4	0	0
10	35302425	.	T	C	0	1	1	0	0	1	0	0
10	35304002	.	G	A	4	6	10	0	1	11	0	0
10	35307579	.	C	T	1	2	3	0	0	3	0	0
10	35312021	.	A	C	7	11	18	0	1	19	0	0
10	35538879	.	T	A	20	12	32	0	1	33	0	0
10	35539607	.	A	G	12	12	24	0	1	25	0	0
10	35539631	.	G	A	14	10	24	0	2	26	0	0
10	35540422	.	T	A	5	11	16	0	3	19	0	0
10	35540603	.	C	T	5	8	13	0	0	13	0	0
10	35540675	.	T	G	7	6	13	0	1	14	0	0
10	35540705	.	T	A	4	10	14	0	2	16	0	0
10	35540732	.	T	G	7	9	16	0	0	16	0	0
10	35540847	.	T	G	8	5	13	0	0	13	0	0
10	35541290	.	A	G	2	3	5	0	0	5	0	0
10	35579756	.	C	T	1	2	3	0	0	3	0	0
10	35584806	.	T	G	16	5	21	0	1	22	0	0
10	35584815	.	A	G	14	3	17	0	0	17	0	0
10	35584855	.	T	A	4	7	11	0	1	12	0	0
10	35585057	.	A	T	3	4	7	0	0	7	0	0
10	35585195	.	G	A	10	7	17	0	0	17	0	0
10	35585197	.	A	G	9	6	15	0	2	17	0	0
10	35585257	.	C	T	9	11	20	0	3	23	0	0
10	35585284	.	C	T	2	10	12	0	5	17	0	0
10	35592817	.	A	G	4	2	6	0	1	7	0	0
10	35592830	.	G	A	5	2	7	0	0	7	0	0
10	35595335	.	C	T	0	1	1	0	0	1	0	0
10	35595669	.	T	A	2	2	4	0	0	4	0	0
10	35602535	.	G	T	1	3	4	0	1	5	0	0
10	35602678	.	G	A	1	2	3	0	0	3	0	0
10	35607231	.	G	A	2	0	2	0	0	2	0	0
10	35654268	.	C	T	8	23	31	0	1	32	0	0
10	35654290	.	A	C	10	14	24	0	9	33	0	0
10	35654305	.	T	C	8	25	33	0	3	37	1	0
10	35664612	.	G	A	3	3	6	0	0	6	0	0
10	36443018	.	T	C	9	8	17	0	0	17	0	0
10	36443541	.	T	C	8	18	26	0	0	26	0	0
10	36443676	.	G	A	0	14	14	0	6	20	0	0
10	36443714	.	G	A	1	13	14	0	4	18	0	0
10	36446799	.	A	T	3	2	5	0	0	5	0	0
10	36451615	.	T	C	1	3	4	0	0	4	0	0
10	36451661	.	G	A	13	18	31	0	2	33	0	0
10	36454567	.	C	A	11	11	22	0	2	24	0	0
10	36454649	.	A	G	13	0	13	0	15	28	0	0
10	36454650	.	C	A	14	12	26	0	2	28	0	0
10	36454902	.	G	T	15	19	34	0	5	39	0	0
10	36455146	.	C	T	12	14	26	0	1	27	0	0
10	36455215	.	T	C	14	9	23	0	0	23	0	0
10	36455229	.	C	G	16	8	24	0	1	25	0	0
10	36455344	.	A	G	21	13	34	0	2	36	0	0
10	36455847	.	G	A	0	8	8	0	4	12	0	0
10	36463377	.	G	A	0	2	2	0	0	2	0	0
10	36476481	.	C	T	0	13	13	0	18	31	0	0
10	36476529	.	C	T	13	15	28	0	0	28	0	0
10	36476639	.	C	T	1	11	12	0	17	29	0	0
10	36476717	.	A	G	16	11	27	0	0	27	0	0
10	36476834	.	G	A	16	19	35	0	1	36	0	0
10	36476852	.	A	G	14	13	27	0	7	34	0	0
10	36476922	.	C	T	0	1	1	0	1	2	0	0
10	36481915	.	A	C	7	9	16	0	0	16	0	0
10	36482588	.	G	A	14	13	27	0	0	27	0	0
10	36487530	.	G	A	5	6	11	0	0	11	0	0
10	36489882	.	A	G	2	2	4	0	0	4	0	0
10	36489893	.	A	G	2	3	5	0	0	5	0	0
10	36492091	.	C	T	2	0	2	0	0	2	0	0
10	36494590	.	C	G	1	3	4	0	0	4	0	0
10	36496544	.	A	G	4	3	7	0	0	7	0	0
10	36496595	.	G	A	3	1	4	0	0	4	0	0
10	36500581	.	C	T	2	0	2	0	0	2	0	0
10	36506290	.	C	T	0	0	0	0	1	1	0	0
10	36520711	.	G	A	4	3	7	0	0	7	0	0
10	36558839	.	A	G	3	8	11	0	2	13	0	0
10	36558895	.	G	A	3	11	14	0	0	14	0	0
10	36572622	.	G	A	1	1	2	0	0	2	0	0
10	36572640	.	C	A	0	2	2	0	2	4	0	0
10	36572757	.	G	A	3	5	8	0	0	8	0	0
10	36613095	.	T	C	8	4	12	0	2	14	0	0
10	36613145	.	G	T	7	6	13	0	0	13	0	0
10	36613164	.	C	T	0	4	4	0	7	11	0	0
10	36613276	.	C	T	5	7	12	0	0	12	0	0
10	36615907	.	C	A	9	4	13	0	1	14	0	0
10	36618787	.	C	T	2	1	3	0	0	3	0	0
10	36625258	.	C	A	0	4	4	0	6	10	0	0
10	36625534	.	G	A	1	1	2	0	1	3	0	0
10	36625602	.	C	G	6	4	10	0	0	10	0	0
10	36625761	.	T	A	6	4	10	0	1	11	0	0
10	36626201	.	C	T	2	2	4	0	2	6	0	0
10	36627820	.	C	T	1	3	4	0	0	4	0	0
10	36628009	.	C	A	2	3	5	0	0	5	0	0
10	36628012	.	G	A	2	3	5	0	0	5	0	0
10	36628569	.	C	T	1	2	3	0	0	3	0	0
10	36628626	.	G	A	1	1	2	0	0	2	0	0
10	36670106	.	T	C	1	1	2	0	1	3	0	0
10	36673237	.	G	T	4	4	8	0	0	8	0	0
10	36679379	.	T	A	1	0	1	0	0	1	0	0
10	36688455	.	C	T	3	1	4	0	0	4	0	0
10	36695781	.	G	C	9	6	15	0	0	15	0	0
10	36695785	.	C	T	8	5	13	0	1	14	0	0
10	36704842	.	A	G	11	6	17	0	1	18	0	0
10	36706217	.	T	A	1	0	1	0	0	1	0	0
10	36708453	.	C	T	6	5	11	0	0	11	0	0
10	36710559	.	A	C	10	8	18	0	2	20	0	0
10	36710599	.	C	T	8	14	22	0	3	25	0	0
10	36710871	.	G	A	0	20	20	0	19	39	0	0
10	36710893	.	G	T	0	16	16	0	21	37	0	0
10	36711260	.	T	A	6	5	11	0	1	12	0	0
10	36711329	.	T	A	3	6	9	0	1	10	0	0
10	36711613	.	C	T	14	10	24	0	0	24	0	0
10	36784995	.	A	G	1	2	3	0	1	4	0	0
10	36796131	.	T	A	2	4	6	0	0	6	0	0
10	36800465	.	G	A	4	8	12	0	0	12	0	0
10	36800518	.	C	T	6	9	15	0	1	16	0	0
10	36800600	.	G	A	5	5	10	0	1	11	0	0
10	36800642	.	A	G	7	5	12	0	0	12	0	0
10	36808032	.	G	A	3	2	5	0	0	5	0	0
10	36811815	.	A	G	7	12	19	0	0	19	0	0
10	36812214	.	A	C	4	2	6	0	0	6	0	0
10	36814912	.	G	A	1	3	4	0	0	4	0	0
10	36815330	.	T	C	2	0	2	0	2	4	0	0
10	36817197	.	A	C	0	1	1	0	0	1	0	0
10	36817355	.	C	T	0	3	3	0	5	8	0	0
10	36817530	.	C	T	6	5	11	0	1	12	0	0
10	36817979	.	T	G	0	1	1	0	0	1	0	0
10	36819664	.	G	T	3	2	5	0	1	6	0	0
10	36819671	.	C	T	3	3	6	0	0	6	0	0
10	36820601	.	C	T	0	3	3	0	0	3	0	0
10	36820611	.	A	G	0	2	2	0	1	3	0	0
10	36820664	.	C	T	0	3	3	0	0	3	0	0
10	36820688	.	C	G	0	2	2	0	1	3	0	0
10	36820736	.	G	A	3	3	6	0	0	6	0	0
10	36820769	.	T	A	2	4	6	0	1	7	0	0
10	36825880	.	G	A	1	2	3	0	0	3	0	0
10	36828227	.	T	C	8	6	14	0	1	15	0	0
10	36828265	.	G	A	8	8	16	0	0	16	0	0
10	36828295	.	G	T	5	10	15	0	1	16	0	0
10	36828469	.	T	C	0	0	0	0	7	7	0	0
10	36828475	.	C	T	6	0	6	0	1	7	0	0
10	36835740	.	G	A	3	3	6	0	0	6	0	0
10	36838768	.	C	T	0	2	2	0	0	2	0	0
10	36843114	.	C	G	1	1	2	0	0	2	0	0
10	36850674	.	C	T	0	0	0	0	1	1	0	0
10	36850752	.	A	G	3	3	6	0	0	6	0	0
10	36852643	.	G	A	1	0	1	0	0	1	0	0
10	36950935	.	A	T	10	3	13	0	1	14	0	0
10	36951044	.	A	T	5	6	11	0	0	11	0	0
10	36951076	.	G	C	4	4	8	0	1	9	0	0
10	36951223	.	A	C	7	11	18	0	0	18	0	0
10	36951378	.	A	G	1	3	4	0	0	4	0	0
10	36951582	.	C	G	11	10	21	0	1	22	0	0
10	36951660	.	T	A	6	7	13	0	0	13	0	0
10	36963456	.	G	A	3	3	6	0	0	6	0	0
10	36967206	.	T	C	2	2	4	0	1	5	0	0
10	36969510	.	T	C	0	1	1	0	0	1	0	0
10	36969519	.	A	G	0	1	1	0	0	1	0	0
10	36974901	.	G	A	0	2	2	0	1	3	0	0
10	36987831	.	T	G	2	1	3	0	0	3	0	0
10	36999951	.	A	G	2	3	5	0	0	5	0	0
10	37137549	.	G	A	0	2	2	0	5	7	0	0
10	37145178	.	G	A	9	5	14	0	0	14	0	0
10	37152081	.	G	A	2	0	2	0	1	3	0	0
10	37155072	.	G	A	0	9	9	0	7	16	0	0
10	37163252	.	C	A	1	0	1	0	0	1	0	0
10	37167151	.	G	C	14	7	21	0	1	22	0	0
10	37253986	.	A	G	0	2	2	0	2	4	0	0
10	37367451	.	T	C	1	2	3	0	0	3	0	0
10	37394478	.	G	A	0	1	1	0	0	1	0	0
10	37394486	.	G	A	0	1	1	0	0	1	0	0
10	37764473	.	C	T	12	6	18	0	1	19	0	0
10	37779765	.	A	C	1	1	2	0	0	2	0	0
10	37779778	.	T	A	1	1	2	0	0	2	0	0
10	37783114	.	A	G	6	9	15	0	2	17	0	0
10	37783323	.	A	G	8	16	24	0	0	24	0	0
10	37783558	.	T	C	5	1	6	0	1	7	0	0
10	37783669	.	C	A	7	2	9	0	0	9	0	0
10	37997567	.	C	G	4	5	9	0	0	9	0	0
10	38000084	.	G	T	0	4	4	0	1	5	0	0
10	38003011	.	A	G	11	7	18	0	0	18	0	0
10	38005334	.	T	A	3	8	11	0	1	12	0	0
10	38005337	.	G	A	3	6	9	0	3	12	0	0
10	38005466	.	A	C	5	4	9	0	0	9	0	0
10	38040378	.	A	G	1	0	1	0	0	1	0	0
10	38149713	.	C	A	0	1	1	0	0	1	0	0
10	38149715	.	A	G	0	0	0	0	1	1	0	0
10	38170573	.	G	A	2	3	5	0	0	5	0	0
10	38170574	.	A	G	2	2	4	0	1	5	0	0
10	38170737	.	G	A	9	16	25	0	2	27	0	0
10	38171196	.	G	A	5	5	10	0	5	15	0	0
10	38171207	.	C	A	7	8	15	0	3	18	0	0
10	38171356	.	A	T	7	12	19	0	0	19	0	0
10	38171490	.	T	A	9	13	22	0	0	22	0	0
10	38173383	.	C	A	0	4	4	0	4	8	0	0
10	38177999	.	C	T	0	6	6	0	8	14	0	0
10	38178357	.	G	A	0	1	1	0	1	2	0	0
10	38180732	.	A	T	1	1	2	0	0	2	0	0
10	38199097	.	G	A	1	2	3	0	0	3	0	0
10	38199169	.	T	C	0	3	3	0	0	3	0	0
10	38211810	.	C	G	0	2	2	0	0	2	0	0
10	38231165	.	C	T	0	1	1	0	1	2	0	0
10	38257295	.	G	A	5	5	10	0	5	15	0	0
10	38257509	.	C	G	1	11	12	0	5	17	0	0
10	38257558	.	C	T	6	9	15	0	0	15	0	0
10	38257870	.	T	C	9	15	24	0	1	25	0	0
10	38258729	.	C	G	10	6	16	0	1	17	0	0
10	38259033	.	C	T	3	5	8	0	1	9	0	0
10	38259034	.	A	G	3	6	9	0	0	9	0	0
10	38259204	.	G	A	2	5	7	0	0	7	0	0
10	38259217	.	A	G	1	5	6	0	0	6	0	0
10	38259268	.	G	C	2	2	4	0	0	4	0	0
10	38259339	.	A	T	4	3	7	0	1	8	0	0
10	38259449	.	A	C	1	0	1	0	4	5	0	0
10	38259451	.	A	G	2	3	5	0	0	5	0	0
10	38260002	.	G	A	2	3	5	0	2	7	0	0
10	38260210	.	T	A	2	4	6	0	0	6	0	0
10	38665994	.	C	T	0	0	0	0	1	1	0	0
10	38666063	.	T	C	2	3	5	0	0	5	0	0
10	38686126	.	T	C	2	2	4	0	0	4	0	0
10	38695152	.	A	C	13	11	24	0	0	24	0	0
10	38695656	.	A	G	14	6	20	0	2	22	0	0
10	38695877	.	C	T	14	10	24	0	0	24	0	0
10	38695888	.	C	T	9	10	19	0	3	22	0	0
10	38712431	.	C	T	1	2	3	0	0	3	0	0
10	38723539	.	T	C	1	1	2	0	0	2	0	0
10	38724101	.	C	T	0	1	1	0	0	1	0	0
10	38726441	.	C	T	1	0	1	0	0	1	0	0
10	38891454	.	C	A	3	2	5	0	0	5	0	0
10	38922043	.	G	A	0	1	1	0	1	2	0	0
10	38924557	.	C	T	1	2	3	0	0	3	0	0
10	38924560	.	T	C	1	2	3	0	0	3	0	0
10	38934391	.	A	G	0	1	1	0	0	1	0	0
10	38937260	.	C	G	3	3	6	0	0	6	0	0
10	38937272	.	T	C	3	2	5	0	1	6	0	0
10	38940232	.	A	G	1	3	4	0	1	5	0	0
10	38950115	.	T	C	1	0	1	0	0	1	0	0
10	38950430	.	G	A	0	9	9	0	12	21	0	0
10	38950484	.	A	G	6	11	17	0	2	19	0	0
10	38950538	.	T	C	1	5	6	0	0	6	0	0
10	38954126	.	C	T	10	4	14	0	2	16	0	0
10	38954141	.	T	C	11	4	15	0	1	16	0	0
10	38954798	.	T	C	12	6	18	0	2	20	0	0
10	38954801	.	C	T	12	8	20	0	1	21	0	0
10	38957061	.	T	C	15	12	27	0	3	30	0	0
10	38957127	.	G	A	0	16	16	0	10	26	0	0
10	38957193	.	C	T	2	5	7	0	1	8	0	0
10	38957748	.	A	C	6	9	15	0	0	15	0	0
10	38957754	.	A	C	5	11	16	0	0	16	0	0
10	38969552	.	A	C	29	19	48	0	1	49	0	0
10	38969598	.	A	C	20	17	37	0	5	42	0	0
10	38969629	.	C	T	19	23	42	0	3	45	0	0
10	38969685	.	A	G	26	18	44	0	1	45	0	0
10	38969778	.	C	T	20	27	47	0	1	48	0	0
10	39011484	.	C	T	11	18	29	0	2	31	0	0
10	39086981	.	G	A	19	20	39	0	3	42	0	0
10	39087625	.	T	A	22	31	53	0	2	55	0	0
10	39087659	.	T	A	23	27	50	0	0	50	0	0
10	39102672	.	G	C	0	2	2	0	0	2	0	0
10	39102776	.	T	C	3	2	5	0	0	5	0	0
10	39110452	.	G	C	2	5	7	0	0	7	0	0
10	39115595	.	G	T	1	7	8	0	1	9	0	0
10	39115596	.	T	C	1	8	9	0	0	9	0	0
10	39120132	.	T	C	4	16	20	0	0	20	0	0
10	39130460	.	C	T	10	21	31	0	0	31	0	0
10	39140465	.	A	G	0	1	1	0	0	1	0	0
10	39175139	.	T	C	2	2	4	0	0	4	0	0
10	39175475	.	G	A	0	2	2	0	1	3	0	0
10	39177816	.	T	C	1	3	4	0	0	4	0	0
10	39179696	.	C	T	3	3	6	0	1	7	0	0
10	39179808	.	A	T	1	2	3	0	0	3	0	0
10	39179813	.	C	T	0	2	2	0	0	2	0	0
10	39179925	.	T	A	1	2	3	0	0	3	0	0
10	39179992	.	G	C	4	3	7	0	0	7	0	0
10	39181120	.	T	A	3	8	11	0	2	13	0	0
10	39181417	.	G	T	3	4	7	0	0	7	0	0
10	39181424	.	T	C	1	2	3	0	3	6	0	0
10	39182310	.	C	A	11	4	15	0	0	15	0	0
10	39182342	.	A	T	9	3	12	0	1	13	0	0
10	39182401	.	C	A	15	5	20	0	3	23	0	0
10	39182497	.	C	T	9	6	15	0	2	17	0	0
10	39182602	.	G	A	0	2	2	0	3	5	0	0
10	39182877	.	G	A	5	3	8	0	1	9	0	0
10	39206945	.	A	G	4	1	5	0	1	6	0	0
10	39207104	.	C	A	3	2	5	0	2	7	0	0
10	39207114	.	C	A	2	2	4	0	1	5	0	0
10	39219390	.	T	C	2	0	2	0	0	2	0	0
10	39219540	.	T	A	4	2	6	0	0	6	0	0
10	39222134	.	A	C	2	1	3	0	0	3	0	0
10	39222182	.	A	G	9	4	13	0	0	13	0	0
10	39225504	.	A	C	8	8	16	0	0	16	0	0
10	39225555	.	T	C	6	8	14	0	0	14	0	0
10	39231387	.	G	A	8	2	10	0	0	10	0	0
10	39265954	.	G	A	0	2	2	0	0	2	0	0
10	39266422	.	C	T	2	3	5	0	0	5	0	0
10	39266669	.	A	C	2	4	6	0	3	9	0	0
10	39285288	.	T	C	1	0	1	0	0	1	0	0
10	39293282	.	A	G	3	0	3	0	3	6	0	0
10	39293283	.	A	G	3	3	6	0	0	6	0	0
10	39293335	.	T	C	3	6	9	0	0	9	0	0
10	39293358	.	G	A	3	4	7	0	0	7	0	0
10	39293813	.	C	G	4	2	6	0	0	6	0	0
10	39293816	.	G	T	4	2	6	0	0	6	0	0
10	39904851	.	A	T	1	11	12	0	0	12	0	0
10	39904915	.	A	G	6	15	21	0	1	22	0	0
10	39904966	.	T	C	5	8	13	0	2	15	0	0
10	39905085	.	A	T	4	5	9	0	0	9	0	0
10	39905089	.	T	G	4	5	9	0	0	9	0	0
10	40110243	.	A	T	3	2	5	0	0	5	0	0
10	40110397	.	A	G	2	2	4	0	0	4	0	0
10	40110599	.	G	A	0	2	2	0	1	3	0	0
10	40110616	.	G	T	1	1	2	0	0	2	0	0
10	40110666	.	T	A	1	4	5	0	0	5	0	0
10	40110714	.	C	T	1	2	3	0	0	3	0	0
10	40111610	.	C	T	0	2	2	0	1	3	0	0
10	40111666	.	G	C	1	4	5	0	0	5	0	0
10	40111706	.	A	G	1	3	4	0	0	4	0	0
10	40111732	.	C	T	1	2	3	0	0	3	0	0
10	40112347	.	A	T	3	3	6	0	0	6	0	0
10	40113032	.	T	A	3	2	5	0	0	5	0	0
10	40113045	.	A	G	2	2	4	0	0	4	0	0
10	40113197	.	G	A	0	2	2	0	2	4	0	0
10	40113408	.	A	G	4	3	7	0	0	7	0	0
10	40113592	.	G	A	2	2	4	0	0	4	0	0
10	40266259	.	A	C	2	2	4	0	1	5	0	0
10	40274541	.	G	A	0	3	3	0	2	5	0	0
10	40274963	.	A	C	2	2	4	0	0	4	0	0
10	40275158	.	G	A	0	2	2	0	2	4	0	0
10	40303924	.	G	C	1	2	3	0	0	3	0	0
10	40303980	.	A	G	1	1	2	0	0	2	0	0
10	40307553	.	T	C	0	2	2	0	1	3	0	0
10	40307622	.	C	T	3	2	5	0	1	6	0	0
10	40314046	.	T	C	2	3	5	0	0	5	0	0
10	40314175	.	A	C	2	6	8	0	0	8	0	0
10	40314177	.	A	C	2	6	8	0	0	8	0	0
10	40315918	.	A	G	1	2	3	0	0	3	0	0
10	40316924	.	T	G	3	2	5	0	1	6	0	0
10	40317095	.	G	T	3	3	6	0	1	7	0	0
10	40317285	.	A	T	3	6	9	0	0	9	0	0
10	40822252	.	C	T	1	2	3	0	10	13	0	0
10	40826436	.	A	G	5	2	7	0	0	7	0	0
10	40826494	.	A	G	2	2	4	0	0	4	0	0
10	40826589	.	C	T	8	5	13	0	0	13	0	0
10	40826590	.	A	G	8	5	13	0	0	13	0	0
10	40859503	.	G	A	2	3	5	0	0	5	0	0
10	40859512	.	C	T	1	2	3	0	0	3	0	0
10	40859633	.	C	T	2	2	4	0	0	4	0	0
10	40859647	.	A	C	1	2	3	0	1	4	0	0
10	40859722	.	A	G	2	4	6	0	0	6	0	0
10	40859885	.	A	G	4	3	7	0	0	7	0	0
10	40859968	.	T	C	8	4	12	0	1	13	0	0
10	40860001	.	C	T	6	2	8	0	0	8	0	0
10	40861650	.	G	A	2	2	4	0	0	4	0	0
10	40861701	.	G	T	2	4	6	0	0	6	0	0
10	41108246	.	G	T	0	1	1	0	0	1	0	0
10	41111877	.	G	A	1	2	3	0	0	3	0	0
10	41362665	.	G	A	11	20	31	0	0	31	0	0
10	41362771	.	C	T	2	11	13	0	17	30	0	0
10	41368569	.	G	A	3	3	6	0	0	6	0	0
10	41368626	.	C	T	0	6	6	0	5	11	0	0
10	41373231	.	G	A	2	1	3	0	0	3	0	0
10	41376895	.	G	A	0	1	1	0	0	1	0	0
10	41379992	.	G	A	7	8	15	0	2	17	0	0
10	41416891	.	T	C	2	2	4	0	0	4	0	0
10	41607903	.	C	A	4	5	9	0	0	9	0	0
10	41607939	.	C	A	3	3	6	0	0	6	0	0
10	41608600	.	C	A	2	4	6	0	0	6	0	0
10	42021279	.	A	G	4	3	7	0	0	7	0	0
10	42047224	.	T	C	1	2	3	0	0	3	0	0
10	42137050	.	G	C	1	4	5	0	0	5	0	0
10	42739938	.	C	T	1	5	6	0	0	6	0	0
10	42930781	.	T	C	3	1	4	0	5	9	0	0
10	42930828	.	T	C	1	7	8	0	1	9	0	0
10	42931278	.	T	C	3	3	6	0	0	6	0	0
10	43863188	.	C	T	2	2	4	1	1	6	0	0
10	43863742	.	A	C	5	7	12	0	0	12	0	0
10	43863779	.	A	C	4	5	9	0	0	9	0	0
10	43863792	.	T	G	5	5	10	0	0	10	0	0
10	43863819	.	C	G	2	2	4	0	0	4	0	0
10	43936313	.	A	T	3	6	9	0	0	9	0	0
10	43937850	.	A	G	1	2	3	0	0	3	0	0
10	43999448	.	G	A	5	2	7	0	0	7	0	0
10	43999628	.	T	C	4	4	8	0	3	11	0	0
10	43999718	.	T	A	3	1	4	0	0	4	0	0
10	44057263	.	T	A	3	4	7	0	1	8	0	0
10	44137259	.	G	A	0	1	1	0	0	1	0	0
10	44180320	.	C	T	5	5	10	0	0	10	0	0
10	44189322	.	G	T	3	1	4	0	1	5	0	0
10	44314569	.	C	T	2	1	3	0	0	3	0	0
10	44314579	.	A	G	1	2	3	0	0	3	0	0
10	44320823	.	G	C	5	5	10	0	1	11	0	0
10	44337652	.	G	T	2	4	6	0	0	6	0	0
10	44340944	.	C	T	2	1	3	0	1	4	0	0
10	44346449	.	T	C	1	1	2	0	3	5	0	0
10	44354053	.	G	C	1	5	6	0	0	6	0	0
10	44363242	.	G	T	1	7	8	0	1	9	0	0
10	44364604	.	A	T	1	2	3	0	0	3	0	0
10	44364610	.	C	T	0	2	2	0	0	2	0	0
10	44371710	.	G	T	1	6	7	0	19	26	0	0
10	44375785	.	G	A	0	2	2	0	0	2	0	0
10	44437145	.	T	C	11	6	17	0	0	17	0	0
10	44466844	.	G	A	2	6	8	0	0	8	0	0
10	44503882	.	G	A	5	5	10	0	0	10	0	0
10	44513232	.	T	C	2	4	6	0	1	7	0	0
10	44513307	.	T	C	6	5	11	0	0	11	0	0
10	44513402	.	T	C	5	0	5	0	12	17	0	0
10	44513421	.	C	T	0	10	10	0	5	15	0	0
10	44515911	.	G	C	0	3	3	0	0	3	0	0
10	44515927	.	T	C	1	3	4	0	0	4	0	0
10	44516001	.	C	T	0	2	2	0	3	5	0	0
10	44640688	.	A	C	1	2	3	0	1	4	0	0
10	44640700	.	C	T	2	2	4	0	0	4	0	0
10	44650913	.	G	A	0	2	2	0	2	4	0	0
10	44652510	.	C	T	1	5	6	0	1	7	0	0
10	44656905	.	G	A	4	1	5	0	0	5	0	0
10	44663025	.	C	T	8	3	11	0	0	11	0	0
10	44663082	.	A	G	3	8	11	0	1	12	0	0
10	44663109	.	A	G	4	5	9	0	0	9	0	0
10	44665536	.	A	T	7	7	14	0	0	14	0	0
10	44665620	.	C	T	2	4	6	0	0	6	0	0
10	44669263	.	G	A	1	4	5	0	1	6	0	0
10	44669402	.	G	A	4	4	8	0	4	12	0	0
10	44669779	.	A	G	8	0	8	0	13	21	0	0
10	44669825	.	T	G	5	10	15	0	2	17	0	0
10	44669937	.	G	A	5	2	7	0	0	7	0	0
10	44670359	.	A	G	4	6	10	0	1	11	0	0
10	44670437	.	A	G	11	8	19	0	2	21	0	0
10	44670894	.	C	T	9	13	22	0	1	23	0	0
10	44670923	.	T	C	8	10	18	0	0	18	0	0
10	44671818	.	A	C	11	14	25	0	2	27	0	0
10	44672009	.	T	A	27	21	48	0	0	49	1	0
10	44672036	.	T	A	19	20	39	0	4	43	0	0
10	44693523	.	T	G	23	0	23	0	17	40	0	0
10	44693556	.	C	T	16	8	24	0	2	26	0	0
10	44693688	.	T	G	9	7	16	0	0	16	0	0
10	44693706	.	C	T	7	6	13	0	3	16	0	0
10	44693769	.	C	T	20	6	26	0	1	27	0	0
10	44693868	.	G	A	0	2	2	3	0	5	0	0
10	44694162	.	T	C	0	21	21	0	1	22	0	0
10	44694354	.	G	A	2	12	14	1	2	17	0	0
10	44745648	.	T	G	0	0	0	0	1	1	0	0
10	44746114	.	T	C	5	2	7	0	0	7	0	0
10	44905224	.	A	G	1	2	3	0	0	3	0	0
10	44914623	.	A	G	2	0	2	0	7	9	0	0
10	44914761	.	T	A	4	4	8	0	0	8	0	0
10	44979767	.	A	G	3	5	8	0	0	8	0	0
10	44979792	.	T	C	5	3	8	0	1	9	0	0
10	44980638	.	G	C	5	2	7	0	0	7	0	0
10	44989378	.	C	T	3	4	7	0	0	7	0	0
10	44989384	.	T	C	5	4	9	0	1	10	0	0
10	44990917	.	C	T	4	9	13	0	1	14	0	0
10	45053620	.	C	A	2	2	4	0	0	4	0	0
10	45055879	.	G	A	2	8	10	0	1	11	0	0
10	45055948	.	G	A	1	0	1	0	0	1	0	0
10	45059822	.	C	T	2	2	4	0	0	4	0	0
10	45064957	.	C	T	8	12	20	0	1	21	0	0
10	45190629	.	C	T	1	1	2	0	0	2	0	0
10	45203109	.	T	C	1	5	6	0	0	6	0	0
10	45203154	.	A	G	2	8	10	0	0	10	0	0
10	45203271	.	T	A	3	7	10	0	0	10	0	0
10	45203385	.	T	A	3	4	7	0	0	7	0	0
10	45203419	.	A	T	3	2	5	0	0	5	0	0
10	45203446	.	A	G	2	2	4	0	0	4	0	0
10	45203793	.	G	A	0	3	3	0	3	6	0	0
10	45203856	.	G	A	5	5	10	0	1	11	0	0
10	45204151	.	A	G	3	3	6	0	1	7	0	0
10	45204568	.	G	T	1	1	2	0	0	2	0	0
10	45205166	.	A	C	3	6	9	1	1	11	0	0
10	45205175	.	A	G	5	0	5	1	5	11	0	0
10	45205284	.	A	C	7	6	13	0	2	15	0	0
10	45205400	.	C	A	7	9	16	0	0	16	0	0
10	45205757	.	C	A	4	7	11	0	0	11	0	0
10	45205758	.	A	G	4	7	11	0	0	11	0	0
10	45206103	.	C	G	2	9	11	1	0	12	0	0
10	45206326	.	G	T	3	4	7	0	1	8	0	0
10	45206450	.	T	C	7	0	7	0	18	25	0	0
10	45206478	.	G	T	17	6	23	0	0	23	0	0
10	45208153	.	A	G	0	3	3	0	0	3	0	0
10	45208667	.	C	T	1	3	4	0	0	4	0	0
10	45208875	.	G	A	4	2	6	0	0	6	0	0
10	45208899	.	C	A	1	2	3	0	0	3	0	0
10	45213798	.	C	T	0	2	2	0	0	2	0	0
10	45313623	.	G	A	0	2	2	0	1	3	0	0
10	45313671	.	C	T	1	0	1	0	0	1	0	0
10	45325302	.	G	A	0	4	4	0	2	6	0	0
10	45334688	.	C	T	1	1	2	0	0	2	0	0
10	45336565	.	T	C	3	7	10	0	0	10	0	0
10	45340105	.	G	T	0	6	6	0	5	11	0	0
10	45340654	.	A	G	1	2	3	0	1	4	0	0
10	45340835	.	G	C	2	6	8	0	2	10	0	0
10	45340930	.	G	T	2	4	6	0	0	6	0	0
10	45341403	.	A	G	3	4	7	0	0	7	0	0
10	45341410	.	A	G	4	0	4	0	5	9	0	0
10	45341452	.	T	G	6	5	11	0	0	11	0	0
10	45341537	.	A	C	2	10	12	0	0	12	0	0
10	45341546	.	A	C	3	8	11	0	0	11	0	0
10	45341572	.	G	C	0	8	8	0	8	16	0	0
10	45341596	.	C	T	5	6	11	0	1	12	0	0
10	45341762	.	A	T	5	3	8	0	1	9	0	0
10	45349924	.	G	A	14	6	20	0	0	20	0	0
10	45351037	.	C	T	6	9	15	0	1	16	0	0
10	45352231	.	C	T	17	22	39	0	5	44	0	0
10	45375714	.	G	T	4	2	6	0	1	7	0	0
10	45375732	.	C	T	0	1	1	0	0	1	0	0
11	71435	.	G	T	0	2	2	0	0	2	0	0
11	126334	.	G	A	7	5	12	0	0	12	0	0
11	126595	.	A	T	2	6	8	0	1	9	0	0
11	127139	.	G	A	0	2	2	0	0	2	0	0
11	185396	.	C	T	0	9	9	0	4	13	0	0
11	185624	.	T	A	16	21	37	0	1	38	0	0
11	185678	.	G	A	12	19	31	0	5	36	0	0
11	185775	.	C	T	2	21	23	0	19	42	0	0
11	185890	.	A	G	12	18	30	0	1	31	0	0
11	185902	.	A	G	11	16	27	0	2	29	0	0
11	186235	.	G	A	9	9	18	0	1	19	0	0
11	186526	.	A	T	3	6	9	0	0	9	0	0
11	186745	.	G	T	5	12	17	0	0	17	0	0
11	186798	.	T	G	6	10	16	0	0	16	0	0
11	186939	.	A	G	13	10	23	0	1	24	0	0
11	187022	.	C	A	3	14	17	0	1	18	0	0
11	187104	.	T	A	6	14	20	0	3	23	0	0
11	187399	.	A	C	3	4	7	0	0	7	0	0
11	221929	.	T	C	18	1	19	0	21	40	0	0
11	222488	.	C	G	9	7	16	0	0	16	0	0
11	222722	.	C	T	0	7	7	0	8	15	0	0
11	222729	.	C	T	0	6	6	0	7	13	0	0
11	222776	.	C	T	4	10	14	0	0	14	0	0
11	222787	.	A	G	5	8	13	0	1	14	0	0
11	223046	.	G	T	3	7	10	0	2	12	0	0
11	223319	.	G	A	7	6	13	0	1	14	0	0
11	223806	.	A	G	9	12	21	0	1	22	0	0
11	233672	.	A	T	4	6	10	0	0	10	0	0
11	233674	.	G	A	4	6	10	0	0	10	0	0
11	236437	.	C	T	3	2	5	0	0	5	0	0
11	236515	.	T	C	1	5	6	0	1	7	0	0
11	236551	.	G	A	3	4	7	0	1	8	0	0
11	260909	.	G	A	18	7	25	0	2	27	0	0
11	265097	.	T	G	4	2	6	0	0	6	0	0
11	265404	.	G	A	11	10	21	0	0	21	0	0
11	265497	.	C	T	0	15	15	0	13	28	0	0
11	265506	.	G	C	13	15	28	0	1	29	0	0
11	268887	.	G	A	1	2	3	0	0	3	0	0
11	270090	.	A	G	19	9	28	0	2	30	0	0
11	281887	.	A	T	4	2	6	0	0	6	0	0
11	281961	.	A	G	4	11	15	0	0	15	0	0
11	282193	.	T	G	10	6	16	0	0	16	0	0
11	282279	.	A	T	7	11	18	0	0	18	0	0
11	282546	.	G	T	11	6	17	0	2	19	0	0
11	282553	.	A	G	15	4	19	0	0	19	0	0
11	282602	.	T	G	13	6	19	0	1	20	0	0
11	284424	.	G	T	4	2	6	0	1	7	0	0
11	296453	.	T	A	4	4	8	0	0	8	0	0
11	322076	.	G	A	1	9	10	0	2	12	0	0
11	675382	.	G	C	28	24	52	0	1	53	0	0
11	676856	.	T	C	24	13	37	0	1	38	0	0
11	677100	.	A	G	11	8	19	0	4	23	0	0
11	677264	.	T	C	23	11	34	0	6	40	0	0
11	677341	.	T	C	15	15	30	0	3	33	0	0
11	682905	.	C	T	6	5	11	0	1	12	0	0
11	682926	.	A	G	10	8	18	0	2	20	0	0
11	682943	.	G	A	14	10	24	0	1	25	0	0
11	687501	.	G	A	3	3	6	0	0	6	0	0
11	718404	.	A	C	6	4	10	0	0	10	0	0
11	718454	.	A	G	2	2	4	0	0	4	0	0
11	762445	.	A	G	6	4	10	0	1	11	0	0
11	779785	.	C	A	2	3	5	0	0	5	0	0
11	780405	.	T	A	1	2	3	0	1	4	0	0
11	813631	.	A	G	3	2	5	0	1	6	0	0
11	813667	.	A	G	2	2	4	0	0	4	0	0
11	813851	.	T	C	1	0	1	0	5	6	0	0
11	1148869	.	G	A	12	25	37	0	2	39	0	0
11	1148889	.	G	A	23	11	34	0	0	34	0	0
11	1149105	.	C	T	20	25	45	0	1	46	0	0
11	1149593	.	A	G	24	17	41	1	2	44	0	0
11	1149812	.	C	T	5	26	31	0	33	64	0	0
11	1163295	.	C	T	15	24	39	0	2	41	0	0
11	1165993	.	G	A	4	4	8	0	0	8	0	0
11	1177389	.	C	A	0	0	0	0	3	3	0	0
11	1183007	.	G	A	5	1	6	0	0	6	0	0
11	1183602	.	C	T	0	2	2	0	2	4	0	0
11	1183739	.	G	T	9	8	17	0	0	17	0	0
11	1198390	.	G	C	3	10	13	0	0	13	0	0
11	1198419	.	G	A	13	4	17	0	2	19	0	0
11	1198450	.	G	A	5	12	17	0	3	20	0	0
11	1198507	.	G	T	11	8	19	0	3	22	0	0
11	1203619	.	G	A	2	2	4	0	0	4	0	0
11	1221865	.	A	G	5	4	9	0	2	11	0	0
11	1222025	.	T	G	2	2	4	0	0	4	0	0
11	1339419	.	C	T	0	1	1	0	0	1	0	0
11	1341402	.	C	T	0	3	3	0	3	6	0	0
11	1342778	.	G	A	1	1	2	0	1	3	0	0
11	1342826	.	A	G	3	4	7	0	1	8	0	0
11	1348821	.	A	C	2	4	6	0	0	6	0	0
11	1351563	.	T	G	6	2	8	0	0	8	0	0
11	1396343	.	T	C	18	22	40	0	2	42	0	0
11	1403797	.	T	C	0	0	0	0	3	3	0	0
11	1403821	.	A	C	0	2	2	0	0	2	0	0
11	1403921	.	A	C	1	3	4	0	0	4	0	0
11	1404031	.	A	C	2	3	5	0	0	5	0	0
11	1404165	.	C	T	2	3	5	0	1	6	0	0
11	1404481	.	C	A	3	5	8	0	0	8	0	0
11	1404640	.	T	C	3	0	3	0	2	5	0	0
11	1404642	.	A	G	3	2	5	0	0	5	0	0
11	1406012	.	T	C	0	4	4	0	3	7	0	0
11	1407178	.	A	C	1	1	2	0	0	2	0	0
11	1435736	.	A	G	3	4	7	0	0	7	0	0
11	1467114	.	T	C	3	1	4	0	9	13	0	0
11	1467130	.	C	A	0	6	6	0	2	8	0	0
11	1469842	.	C	T	7	10	17	0	0	17	0	0
11	1469859	.	A	G	9	7	16	0	3	19	0	0
11	1469895	.	A	G	8	6	14	0	0	14	0	0
11	1470503	.	G	A	6	8	14	0	0	14	0	0
11	1470535	.	G	C	4	6	10	0	0	10	0	0
11	1474629	.	C	T	3	1	4	0	0	4	0	0
11	1512660	.	A	T	1	1	2	0	0	2	0	0
11	1516755	.	T	G	2	1	3	0	0	3	0	0
11	1516773	.	G	T	0	2	2	0	2	4	0	0
11	1517289	.	C	A	5	2	7	0	0	7	0	0
11	1520693	.	G	A	1	3	4	0	0	4	0	0
11	1522205	.	G	T	12	8	20	0	0	20	0	0
11	1522291	.	T	C	5	5	10	0	0	10	0	0
11	1523846	.	T	C	1	1	2	0	0	2	0	0
11	1524079	.	T	C	4	3	7	0	1	8	0	0
11	1524108	.	C	T	5	2	7	0	1	8	0	0
11	1525081	.	G	C	9	8	17	0	0	17	0	0
11	1525389	.	G	T	8	5	13	1	1	15	0	0
11	1525416	.	T	A	1	1	2	0	0	2	0	0
11	1526749	.	A	G	3	1	4	0	0	4	0	0
11	1529260	.	A	G	16	13	29	0	0	29	0	0
11	1529526	.	G	A	14	13	27	0	3	30	0	0
11	1529743	.	G	A	13	8	21	0	2	23	0	0
11	1529789	.	A	C	14	6	20	0	0	20	0	0
11	1529796	.	A	T	12	5	17	0	0	17	0	0
11	1529838	.	A	G	8	6	14	0	2	16	0	0
11	1530295	.	A	C	14	14	28	0	3	31	0	0
11	1530363	.	A	G	12	13	25	0	4	29	0	0
11	1530489	.	A	G	11	1	12	0	19	31	0	0
11	1530541	.	A	G	9	12	21	0	4	25	0	0
11	1530584	.	G	A	0	16	16	0	7	23	0	0
11	1530593	.	G	T	9	16	25	0	2	27	0	0
11	1530642	.	G	A	13	13	26	0	1	27	0	0
11	1535427	.	C	A	4	4	8	0	0	8	0	0
11	1535471	.	T	C	1	2	3	0	0	3	0	0
11	1542605	.	A	G	2	0	2	0	3	5	0	0
11	1543974	.	A	G	5	5	10	0	0	10	0	0
11	1545883	.	A	C	7	3	10	0	0	10	0	0
11	1773801	.	C	T	1	2	3	0	0	3	0	0
11	1796482	.	C	T	0	3	3	0	0	3	0	0
11	1810104	.	C	T	2	2	4	0	0	4	0	0
11	1813240	.	A	G	6	3	9	0	0	9	0	0
11	1829952	.	C	T	2	2	4	0	0	4	0	0
11	1834124	.	T	C	3	7	10	0	1	11	0	0
11	1836100	.	C	A	1	0	1	0	0	1	0	0
11	1836995	.	C	G	5	0	5	0	13	18	0	0
11	1838725	.	G	C	0	2	2	0	2	4	0	0
11	1841961	.	G	C	5	3	8	0	0	8	0	0
11	1843339	.	G	T	0	0	0	0	1	1	0	0
11	1843771	.	C	A	12	9	21	0	1	22	0	0
11	1843812	.	A	G	5	0	5	0	6	11	0	0
11	1843818	.	G	A	5	4	9	0	0	9	0	0
11	1863846	.	T	G	18	18	36	0	2	38	0	0
11	1864095	.	C	A	28	14	42	0	1	43	0	0
11	1864216	.	C	T	16	13	29	0	1	30	0	0
11	1919016	.	T	A	2	2	4	0	0	4	0	0
11	1919876	.	C	T	4	6	10	0	0	10	0	0
11	1920069	.	A	T	3	3	6	0	0	6	0	0
11	1945034	.	T	A	8	5	13	0	1	14	0	0
11	1945036	.	C	T	8	5	13	0	1	14	0	0
11	1945229	.	C	T	0	2	2	0	0	2	0	0
11	1947965	.	A	G	1	1	2	0	1	3	0	0
11	1948373	.	A	T	2	3	5	0	0	5	0	0
11	1967111	.	T	A	2	2	4	0	0	4	0	0
11	2112267	.	C	T	4	5	9	0	0	9	0	0
11	2240120	.	A	C	9	4	13	0	2	15	0	0
11	2244445	.	A	G	5	1	6	0	0	6	0	0
11	2249884	.	A	G	9	17	26	0	3	29	0	0
11	2249920	.	C	T	2	5	7	0	0	7	0	0
11	2253154	.	G	A	8	3	11	0	1	12	0	0
11	2255025	.	T	G	4	3	7	0	0	7	0	0
11	2255027	.	T	G	3	3	6	0	1	7	0	0
11	2263484	.	T	G	0	1	1	0	0	1	0	0
11	2462475	.	A	G	8	3	11	0	0	11	0	0
11	2462791	.	A	G	5	4	9	0	0	9	0	0
11	2506878	.	C	T	2	2	4	0	0	4	0	0
11	2507001	.	G	A	0	2	2	0	1	3	0	0
11	2541797	.	T	C	5	6	11	0	0	11	0	0
11	2542391	.	C	T	2	4	6	0	1	7	0	0
11	2545462	.	C	G	0	3	3	0	0	3	0	0
11	2566191	.	C	T	1	2	3	0	1	4	0	0
11	2571635	.	A	G	3	4	7	0	1	8	0	0
11	2585371	.	T	C	2	0	2	0	1	3	0	0
11	2615193	.	G	A	3	1	4	0	0	4	0	0
11	2616881	.	T	A	5	2	7	0	1	8	0	0
11	2616956	.	T	C	17	10	27	0	1	28	0	0
11	2617031	.	T	A	8	15	23	0	2	25	0	0
11	2617072	.	A	G	5	7	12	0	2	14	0	0
11	2618036	.	A	G	10	6	16	0	1	17	0	0
11	2618653	.	C	A	6	6	12	0	1	13	0	0
11	2619054	.	T	G	6	6	12	0	0	12	0	0
11	2619089	.	G	A	8	4	12	0	1	13	0	0
11	2619129	.	C	A	6	10	16	0	0	16	0	0
11	2619515	.	T	A	10	8	18	0	0	18	0	0
11	2619538	.	T	A	6	8	14	0	2	16	0	0
11	2621839	.	G	A	2	2	4	0	0	4	0	0
11	2625178	.	G	A	4	3	7	0	0	7	0	0
11	2625224	.	T	A	2	2	4	0	0	5	1	0
11	2625247	.	T	C	1	4	5	0	0	5	0	0
11	2656830	.	T	C	1	2	3	0	1	4	0	0
11	2660045	.	A	G	1	2	3	0	1	4	0	0
11	2664585	.	A	C	0	0	0	0	1	1	0	0
11	2665236	.	T	A	4	1	5	0	0	5	0	0
11	2675447	.	C	A	4	2	6	0	0	6	0	0
11	2675454	.	A	C	1	4	5	0	1	6	0	0
11	2677377	.	G	C	1	1	2	0	1	3	0	0
11	2677404	.	G	A	0	4	4	0	3	7	0	0
11	2677428	.	A	G	3	4	7	0	2	9	0	0
11	2677440	.	C	T	3	4	7	0	1	8	0	0
11	2678064	.	G	A	2	3	5	0	0	5	0	0
11	2678088	.	G	A	4	3	7	0	1	8	0	0
11	2680570	.	G	A	0	3	3	0	4	7	0	0
11	2680747	.	C	T	7	5	12	0	1	13	0	0
11	2680797	.	G	C	4	5	9	0	0	9	0	0
11	2681894	.	A	G	2	3	5	0	0	5	0	0
11	2681964	.	A	G	0	2	2	0	0	2	0	0
11	2682001	.	C	A	0	1	1	0	1	2	0	0
11	2682005	.	T	G	1	1	2	0	0	2	0	0
11	2682310	.	G	T	2	3	5	0	0	5	0	0
11	2682313	.	G	T	3	2	5	0	0	5	0	0
11	2682361	.	T	C	4	5	9	0	0	9	0	0
11	2682414	.	A	G	3	6	9	0	0	9	0	0
11	2682441	.	A	T	3	4	7	0	0	7	0	0
11	2682555	.	A	T	2	2	4	0	1	5	0	0
11	2682644	.	A	T	2	3	5	0	0	6	1	0
11	2682664	.	T	A	4	4	8	0	1	9	0	0
11	2682693	.	A	C	6	4	10	0	0	10	0	0
11	2682866	.	T	C	7	4	11	0	0	11	0	0
11	2683038	.	G	T	2	7	9	0	0	9	0	0
11	2687526	.	G	A	2	4	6	0	0	6	0	0
11	2687550	.	A	C	2	3	5	0	0	5	0	0
11	2688119	.	G	A	3	2	5	0	0	5	0	0
11	2688582	.	A	C	1	2	3	0	0	3	0	0
11	2688916	.	G	C	2	4	6	0	1	7	0	0
11	2688935	.	T	C	0	6	6	0	0	6	0	0
11	2690233	.	G	T	4	7	11	0	0	11	0	0
11	2690303	.	G	C	4	5	9	0	1	10	0	0
11	2690445	.	G	T	9	10	19	0	2	21	0	0
11	2690499	.	C	T	10	4	14	0	1	15	0	0
11	2690564	.	G	T	7	7	14	0	0	14	0	0
11	2690612	.	A	C	5	7	12	0	0	12	0	0
11	2690869	.	C	A	7	2	9	0	0	9	0	0
11	2690873	.	G	A	0	2	2	0	5	7	0	0
11	2690925	.	G	A	0	1	1	0	5	6	0	0
11	2691642	.	C	T	1	2	3	0	1	4	0	0
11	2691806	.	A	T	0	2	2	0	0	2	0	0
11	2691816	.	C	T	1	3	4	0	0	4	0	0
11	2692109	.	A	C	3	5	8	0	0	8	0	0
11	2692180	.	C	T	1	2	3	0	0	3	0	0
11	2702718	.	T	C	1	2	3	0	0	3	0	0
11	2702766	.	C	T	3	4	7	0	0	7	0	0
11	2702808	.	T	C	1	0	1	0	0	1	0	0
11	2705206	.	C	T	1	2	3	0	0	3	0	0
11	2705215	.	G	T	0	1	1	0	2	3	0	0
11	2705325	.	G	A	5	3	8	0	2	10	0	0
11	2705355	.	T	A	7	4	11	0	1	12	0	0
11	2705657	.	A	G	7	4	11	0	2	13	0	0
11	2705976	.	A	G	3	2	5	0	0	5	0	0
11	2706517	.	T	G	8	14	22	0	0	22	0	0
11	2706734	.	T	C	7	6	13	0	1	14	0	0
11	2706838	.	A	G	8	9	17	0	3	20	0	0
11	2706988	.	C	A	6	3	9	0	0	9	0	0
11	2710611	.	A	T	2	2	4	0	0	4	0	0
11	2743661	.	C	T	3	2	5	0	0	5	0	0
11	2756250	.	C	T	4	2	6	0	0	6	0	0
11	2757582	.	T	C	6	5	11	0	0	11	0	0
11	2757812	.	A	T	1	2	3	0	0	3	0	0
11	2758204	.	C	T	13	5	18	0	2	20	0	0
11	2758706	.	T	A	2	2	4	0	0	4	0	0
11	2758737	.	T	A	2	2	4	0	0	4	0	0
11	2759003	.	C	A	1	3	4	0	0	4	0	0
11	2759007	.	C	T	1	3	4	0	0	4	0	0
11	2759043	.	A	T	4	5	9	0	0	9	0	0
11	2759425	.	A	G	2	1	3	0	0	3	0	0
11	2759461	.	T	C	3	4	7	0	0	7	0	0
11	2759475	.	G	T	5	5	10	2	1	13	0	0
11	2759498	.	G	A	9	7	16	2	1	19	0	0
11	2759525	.	A	G	10	3	13	6	2	21	0	0
11	2759541	.	C	A	4	5	9	5	0	14	0	0
11	2759833	.	G	A	0	10	10	0	9	19	0	0
11	2759843	.	G	A	0	12	12	0	9	21	0	0
11	2759901	.	T	G	11	14	25	0	0	25	0	0
11	2759903	.	A	T	14	9	23	0	2	25	0	0
11	2759938	.	A	G	7	15	22	0	0	22	0	0
11	2760240	.	C	T	3	5	8	0	3	11	0	0
11	2805410	.	C	A	3	1	4	0	0	4	0	0
11	2809744	.	C	T	2	4	6	0	0	6	0	0
11	2809804	.	A	G	7	5	12	0	0	12	0	0
11	2813856	.	G	C	6	5	11	0	1	12	0	0
11	2815790	.	C	G	9	2	11	0	1	12	0	0
11	2815845	.	C	T	15	10	25	0	1	26	0	0
11	2820876	.	T	G	4	2	6	0	1	7	0	0
11	2820900	.	A	C	2	1	3	0	0	3	0	0
11	2826184	.	T	C	16	9	25	0	0	25	0	0
11	2826338	.	G	T	8	14	22	0	2	24	0	0
11	2826485	.	C	A	5	7	12	0	3	16	1	0
11	2828132	.	A	G	11	5	16	0	4	20	0	0
11	2828133	.	A	G	17	3	20	0	0	20	0	0
11	2828174	.	A	G	6	18	24	0	0	24	0	0
11	2828276	.	C	A	11	13	24	0	1	25	0	0
11	2828388	.	G	A	18	7	25	0	2	27	0	0
11	3222192	.	T	C	1	0	1	0	0	1	0	0
11	3227302	.	A	T	3	3	6	0	1	7	0	0
11	3238484	.	A	G	2	2	4	0	0	4	0	0
11	3238651	.	C	T	0	1	1	0	0	1	0	0
11	3238720	.	T	C	1	4	5	0	1	6	0	0
11	3240457	.	G	A	0	2	2	0	3	5	0	0
11	3246120	.	A	G	12	7	19	0	1	20	0	0
11	3246133	.	A	G	11	8	19	0	1	20	0	0
11	3246590	.	A	C	2	1	3	0	0	3	0	0
11	3249253	.	C	T	7	8	15	0	1	16	0	0
11	3249346	.	C	T	1	7	8	0	0	8	0	0
11	3249370	.	A	G	2	0	2	0	4	6	0	0
11	3317389	.	A	T	5	7	12	0	2	14	0	0
11	3323377	.	G	T	3	3	6	0	0	6	0	0
11	3336700	.	T	G	27	24	51	0	3	54	0	0
11	3336793	.	C	T	37	35	72	0	1	73	0	0
11	3337038	.	A	G	31	38	69	0	2	71	0	0
11	3337253	.	A	G	32	28	60	0	5	65	0	0
11	3337256	.	T	C	30	1	31	0	34	65	0	0
11	3337481	.	T	G	31	24	55	0	2	57	0	0
11	3337482	.	A	T	32	22	54	0	3	57	0	0
11	3337718	.	G	C	26	20	46	0	0	46	0	0
11	3338060	.	C	G	19	26	45	0	2	47	0	0
11	3338144	.	T	C	23	26	49	0	4	53	0	0
11	3338288	.	T	A	28	20	48	2	2	52	0	0
11	3338299	.	T	G	25	14	39	2	6	47	0	0
11	3338420	.	A	T	18	32	50	0	7	57	0	0
11	3338431	.	C	T	2	35	37	0	23	60	0	0
11	3338491	.	G	A	27	26	53	0	2	55	0	0
11	3338514	.	C	A	31	25	56	0	3	59	0	0
11	3338618	.	T	C	28	21	49	0	4	53	0	0
11	3338638	.	A	G	26	22	48	0	7	55	0	0
11	3338933	.	A	G	16	16	32	0	3	35	0	0
11	3339098	.	T	C	13	0	13	0	16	29	0	0
11	3339152	.	C	T	6	10	16	0	0	16	0	0
11	3341296	.	G	A	8	11	19	0	0	19	0	0
11	3345676	.	A	G	5	6	11	0	0	11	0	0
11	3345779	.	T	C	3	4	7	0	0	7	0	0
11	3346076	.	G	C	5	4	9	0	0	9	0	0
11	3346128	.	T	G	4	6	10	0	0	10	0	0
11	3367601	.	C	A	2	3	5	0	0	5	0	0
11	3367789	.	T	C	5	1	6	0	7	13	0	0
11	3367924	.	G	C	11	11	22	0	1	23	0	0
11	3367937	.	T	C	12	7	19	0	2	21	0	0
11	3369843	.	G	A	3	5	8	0	0	8	0	0
11	3373418	.	A	G	0	2	2	0	0	2	0	0
11	3373448	.	G	A	0	2	2	0	0	2	0	0
11	3379999	.	G	T	0	3	3	0	0	3	0	0
11	3380012	.	C	G	0	3	3	0	0	3	0	0
11	3395324	.	C	T	2	1	3	0	0	3	0	0
11	3395501	.	A	G	2	3	5	0	0	5	0	0
11	3401899	.	C	A	1	2	3	0	0	3	0	0
11	3425175	.	G	A	1	2	3	0	0	3	0	0
11	3520631	.	A	G	2	5	7	0	0	7	0	0
11	3523724	.	A	G	9	10	19	0	1	20	0	0
11	3523826	.	G	A	8	5	13	0	1	14	0	0
11	3523991	.	C	T	12	7	19	0	3	22	0	0
11	3524064	.	G	T	4	7	11	0	1	12	0	0
11	3524111	.	G	A	9	9	18	0	0	18	0	0
11	3524121	.	A	G	10	10	20	0	1	21	0	0
11	3524236	.	C	T	13	9	22	0	0	22	0	0
11	3524397	.	T	C	5	7	12	0	1	13	0	0
11	3524462	.	C	T	2	6	8	0	0	8	0	0
11	3524541	.	A	T	3	4	7	0	0	7	0	0
11	3524724	.	T	A	3	6	9	0	1	10	0	0
11	3524849	.	G	A	13	12	25	0	2	27	0	0
11	3526521	.	A	G	16	6	22	0	1	23	0	0
11	3526605	.	C	G	4	3	7	0	1	8	0	0
11	3528320	.	A	T	9	4	13	0	3	16	0	0
11	3550448	.	A	G	4	4	8	0	0	9	1	0
11	3550454	.	T	A	3	8	11	0	1	12	0	0
11	3550588	.	T	C	20	2	22	0	20	42	0	0
11	3551309	.	A	G	10	6	16	0	0	16	0	0
11	3551944	.	G	A	30	14	44	0	2	46	0	0
11	3593283	.	C	T	4	2	6	0	1	7	0	0
11	3593309	.	T	C	6	5	11	0	1	12	0	0
11	3593490	.	A	C	8	12	20	0	2	22	0	0
11	3593835	.	T	C	4	5	9	0	0	9	0	0
11	3593988	.	G	T	10	14	24	0	3	27	0	0
11	3594029	.	T	C	11	13	24	0	1	25	0	0
11	3594217	.	G	T	18	7	25	0	1	26	0	0
11	3594277	.	T	G	9	5	14	0	5	19	0	0
11	3594321	.	T	C	6	0	6	0	18	24	0	0
11	3594327	.	T	A	6	14	20	0	3	23	0	0
11	3594366	.	A	G	5	16	21	0	3	24	0	0
11	3594419	.	A	G	5	12	17	0	1	18	0	0
11	3594452	.	T	G	3	3	6	1	7	14	0	0
11	3595308	.	G	A	3	3	6	0	0	6	0	0
11	3595579	.	A	G	2	2	4	0	0	4	0	0
11	3602382	.	T	C	0	2	2	0	1	3	0	0
11	3604729	.	T	G	2	0	2	0	0	2	0	0
11	3604732	.	C	G	0	0	0	0	3	3	0	0
11	3630875	.	G	A	2	3	5	0	1	6	0	0
11	3848283	.	G	A	14	17	31	0	2	33	0	0
11	3848323	.	C	T	0	16	16	0	16	32	0	0
11	3848656	.	C	T	9	12	21	0	4	25	0	0
11	3893635	.	C	T	19	16	35	0	0	35	0	0
11	3893636	.	T	G	19	14	33	0	2	35	0	0
11	3893918	.	G	A	21	14	35	0	1	36	0	0
11	3893928	.	G	C	16	11	27	0	4	31	0	0
11	3894023	.	T	C	9	13	22	0	1	23	0	0
11	3898730	.	C	A	0	0	0	0	1	1	0	0
11	3898736	.	A	G	1	2	3	0	0	3	0	0
11	3899066	.	C	A	0	1	1	0	9	10	0	0
11	3899117	.	G	A	4	0	4	0	1	5	0	0
11	3901733	.	C	G	0	7	7	0	13	20	0	0
11	3904469	.	A	G	6	4	10	0	2	12	0	0
11	3904517	.	C	G	0	8	8	0	8	16	0	0
11	3904564	.	C	T	10	8	18	0	1	19	0	0
11	3904666	.	A	G	1	5	6	0	1	7	0	0
11	3904674	.	T	G	1	4	5	0	0	5	0	0
11	3917723	.	A	G	1	1	2	0	0	2	0	0
11	3921491	.	A	G	8	1	9	0	0	9	0	0
11	3921563	.	T	A	19	13	32	0	0	32	0	0
11	3922983	.	G	A	3	4	7	0	1	8	0	0
11	3925906	.	A	G	4	3	7	0	0	7	0	0
11	3925939	.	T	C	2	1	3	0	0	3	0	0
11	3928044	.	A	T	1	0	1	0	0	1	0	0
11	3931773	.	C	T	7	3	10	0	0	10	0	0
11	3933807	.	G	A	3	2	5	0	0	5	0	0
11	3933956	.	A	G	4	2	6	0	0	6	0	0
11	3934190	.	A	G	4	4	8	0	0	8	0	0
11	3936378	.	T	A	3	2	5	0	0	5	0	0
11	3941180	.	C	T	2	1	3	0	1	4	0	0
11	3963388	.	C	T	1	1	2	0	0	2	0	0
11	3963581	.	C	T	2	3	5	0	0	5	0	0
11	3963608	.	G	T	2	6	8	0	0	8	0	0
11	3963639	.	T	A	2	6	8	0	0	8	0	0
11	3964193	.	T	A	1	2	3	0	1	4	0	0
11	3965837	.	G	A	2	2	4	0	0	4	0	0
11	3965867	.	C	T	0	0	0	0	1	1	0	0
11	3965984	.	T	A	2	4	6	0	0	6	0	0
11	3967408	.	A	G	1	0	1	0	7	8	0	0
11	3967445	.	A	G	0	4	4	0	0	4	0	0
11	3968866	.	T	C	6	13	19	0	0	19	0	0
11	3968877	.	G	A	3	10	13	0	1	14	0	0
11	3968915	.	T	G	2	2	4	0	0	4	0	0
11	3968930	.	A	G	1	0	1	0	1	2	0	0
11	3970703	.	T	A	0	5	5	0	1	6	0	0
11	3970973	.	C	T	4	2	6	0	0	6	0	0
11	3971943	.	T	A	1	2	3	0	0	3	0	0
11	3993452	.	G	A	1	10	11	0	8	19	0	0
11	3993470	.	A	T	7	6	13	0	0	13	0	0
11	3994901	.	C	A	3	2	5	0	0	5	0	0
11	3995479	.	G	T	5	2	7	0	0	7	0	0
11	3997023	.	T	C	2	0	2	0	5	7	0	0
11	3997029	.	C	A	0	4	4	0	4	8	0	0
11	4006956	.	C	T	1	2	3	0	0	3	0	0
11	4010895	.	C	T	3	2	5	0	0	5	0	0
11	4113825	.	G	A	0	0	0	0	1	1	0	0
11	4128836	.	A	T	7	5	12	0	2	14	0	0
11	4131300	.	A	T	3	8	11	0	1	12	0	0
11	4131423	.	T	A	7	7	14	0	3	17	0	0
11	4132110	.	G	T	22	6	28	0	0	28	0	0
11	4132296	.	A	C	32	20	52	0	3	55	0	0
11	4132378	.	G	C	15	9	24	0	0	24	0	0
11	4132440	.	A	G	21	8	29	0	0	29	0	0
11	4132599	.	T	C	7	5	12	0	0	12	0	0
11	5923142	.	T	C	2	0	2	0	12	14	0	0
11	5923146	.	T	C	2	0	2	0	9	11	0	0
11	5923471	.	A	T	7	3	10	0	2	12	0	0
11	6144450	.	T	C	1	5	6	0	0	6	0	0
11	6457412	.	T	G	9	0	9	0	23	32	0	0
11	7042376	.	T	C	1	3	4	0	1	5	0	0
11	10468756	.	T	C	0	3	3	1	0	4	0	0
11	10468772	.	T	A	1	2	3	1	0	4	0	0
11	10670439	.	T	C	18	20	38	1	13	52	0	0
11	10672024	.	T	C	16	10	26	0	5	31	0	0
11	10672025	.	T	C	16	0	16	0	15	31	0	0
11	10672087	.	T	C	20	6	26	0	1	27	0	0
11	10672159	.	T	C	3	6	9	0	1	10	0	0
11	10672193	.	T	C	5	4	9	0	0	9	0	0
11	11177387	.	T	C	0	1	1	0	0	1	0	0
11	11177406	.	C	T	1	2	3	0	0	3	0	0
11	11177436	.	T	C	1	2	3	0	1	4	0	0
11	11184707	.	C	T	2	0	2	0	0	2	0	0
11	11184743	.	A	C	3	3	6	0	0	6	0	0
11	11186216	.	T	C	1	2	3	0	0	3	0	0
11	11186248	.	G	C	3	4	7	0	0	7	0	0
11	11191840	.	C	T	4	4	8	0	1	9	0	0
11	11191845	.	C	T	4	6	10	0	0	10	0	0
11	11191995	.	T	C	17	17	34	0	0	34	0	0
11	11192053	.	C	T	14	12	26	0	0	26	0	0
11	11192170	.	T	A	6	7	13	0	1	14	0	0
11	11192276	.	G	A	8	14	22	0	1	23	0	0
11	11192342	.	T	G	4	5	9	0	1	10	0	0
11	11192724	.	T	C	10	12	22	0	0	22	0	0
11	11193030	.	C	T	4	2	6	0	3	9	0	0
11	11272175	.	C	T	0	2	2	0	1	3	0	0
11	11274615	.	A	T	21	21	42	0	0	42	0	0
11	11319180	.	A	G	2	3	5	0	0	5	0	0
11	11324286	.	T	G	1	0	1	0	0	1	0	0
11	11324295	.	T	G	1	0	1	0	0	1	0	0
11	11325486	.	G	A	0	3	3	0	2	5	0	0
11	11325570	.	T	A	1	4	5	0	0	5	0	0
11	11326502	.	A	G	5	6	11	0	0	11	0	0
11	11326968	.	C	A	0	1	1	0	2	3	0	0
11	11332856	.	T	C	3	2	5	0	1	6	0	0
11	11332933	.	T	A	1	2	3	0	0	3	0	0
11	11332986	.	A	G	7	3	10	0	0	10	0	0
11	11332990	.	T	A	5	3	8	0	0	9	1	0
11	11333116	.	C	A	1	4	5	0	1	6	0	0
11	11333135	.	C	T	1	3	4	0	0	4	0	0
11	11468756	.	T	G	13	11	24	0	1	25	0	0
11	11469128	.	C	T	14	5	19	0	1	20	0	0
11	11469143	.	C	T	12	7	19	1	0	20	0	0
11	11469203	.	G	A	3	6	9	1	1	11	0	0
11	11469215	.	C	T	2	4	6	0	1	7	0	0
11	11469632	.	G	A	1	1	2	0	0	2	0	0
11	11469968	.	C	T	2	0	2	0	0	2	0	0
11	11470994	.	T	C	0	1	1	0	0	1	0	0
11	11471147	.	C	A	4	3	7	0	1	8	0	0
11	11471434	.	T	A	5	3	8	0	0	8	0	0
11	11516245	.	T	G	13	11	24	0	1	25	0	0
11	11517450	.	T	G	5	2	7	0	0	7	0	0
11	11517480	.	G	C	1	1	2	0	1	3	0	0
11	11518343	.	A	G	1	4	5	0	0	5	0	0
11	11597120	.	A	T	9	3	12	0	0	12	0	0
11	11597374	.	A	G	13	19	32	0	2	34	0	0
11	11597679	.	G	C	8	13	21	0	2	23	0	0
11	11597985	.	A	T	14	8	22	0	2	24	0	0
11	11598692	.	C	A	8	3	11	0	0	11	0	0
11	11607492	.	G	A	1	3	4	0	1	5	0	0
11	11607498	.	C	G	2	4	6	0	0	6	0	0
11	11607705	.	C	T	4	3	7	0	1	8	0	0
11	11612758	.	A	G	1	2	3	0	0	3	0	0
11	11612773	.	C	T	1	1	2	0	0	2	0	0
11	11624939	.	T	C	1	1	2	0	1	3	0	0
11	11625066	.	C	G	1	3	4	0	0	4	0	0
11	11625169	.	C	G	2	7	9	0	0	9	0	0
11	11780816	.	A	T	3	2	5	0	0	5	0	0
11	11780935	.	T	C	5	5	10	0	0	10	0	0
11	11870999	.	C	G	0	2	2	1	0	3	0	0
11	11871001	.	A	T	0	1	1	1	1	3	0	0
11	11918607	.	A	C	0	0	0	0	1	1	0	0
11	11928205	.	C	T	1	2	3	0	0	3	0	0
11	11983710	.	T	C	11	0	11	0	9	20	0	0
11	11983713	.	A	C	10	8	18	0	1	19	0	0
11	11983789	.	G	T	4	9	13	0	1	14	0	0
11	11983868	.	C	T	0	4	4	0	3	7	0	0
11	11983937	.	T	C	4	6	10	0	1	11	0	0
11	11984120	.	A	G	1	2	3	0	0	3	0	0
11	11984548	.	C	T	1	9	10	0	0	10	0	0
11	11984666	.	A	G	3	3	6	0	0	6	0	0
11	12004040	.	T	C	0	6	6	0	0	6	0	0
11	12004304	.	G	T	5	3	8	0	0	8	0	0
11	12016650	.	G	A	5	4	9	0	0	9	0	0
11	12050291	.	G	A	1	3	4	0	1	5	0	0
11	12051505	.	G	T	1	3	4	0	1	5	0	0
11	12096578	.	C	T	6	7	13	0	1	14	0	0
11	12096593	.	G	A	5	3	8	0	2	10	0	0
11	12108486	.	T	C	8	18	26	0	2	28	0	0
11	12108725	.	G	A	14	8	22	0	2	24	0	0
11	12108822	.	C	A	10	10	20	0	2	22	0	0
11	12131044	.	T	G	1	2	3	0	0	3	0	0
11	12720049	.	T	A	1	3	4	0	0	4	0	0
11	12727504	.	A	G	19	24	43	0	1	44	0	0
11	12727685	.	T	C	13	20	33	0	3	36	0	0
11	12727879	.	A	C	9	7	16	0	1	17	0	0
11	12728195	.	T	G	7	15	22	0	1	23	0	0
11	12728249	.	C	T	6	11	17	0	0	17	0	0
11	12732419	.	T	C	3	2	5	0	0	5	0	0
11	12732505	.	A	T	10	5	15	0	1	16	0	0
11	12733129	.	A	C	3	2	5	0	0	5	0	0
11	12733142	.	T	C	2	3	5	0	0	5	0	0
11	12733261	.	T	C	3	3	6	0	0	6	0	0
11	12733278	.	G	C	2	4	6	0	0	6	0	0
11	12733443	.	T	A	4	2	6	0	0	6	0	0
11	12733502	.	C	T	2	3	5	0	1	6	0	0
11	12733741	.	C	T	2	4	6	0	2	8	0	0
11	12733743	.	G	A	3	4	7	0	1	8	0	0
11	12733815	.	C	T	1	9	10	0	0	10	0	0
11	12733965	.	C	T	2	6	8	0	0	8	0	0
11	12734007	.	C	T	6	3	9	0	0	9	0	0
11	12734072	.	G	A	2	3	5	0	0	5	0	0
11	12752161	.	A	T	1	3	4	0	0	4	0	0
11	12759409	.	G	A	4	1	5	0	0	5	0	0
11	12759728	.	G	T	2	1	3	0	0	3	0	0
11	12759737	.	C	T	2	1	3	0	0	3	0	0
11	12768221	.	C	T	12	10	22	0	0	22	0	0
11	12768299	.	C	T	11	9	20	0	1	21	0	0
11	12768351	.	A	G	11	8	19	0	1	20	0	0
11	12768394	.	A	C	4	9	13	0	2	15	0	0
11	12782503	.	G	A	4	9	13	0	1	14	0	0
11	12782524	.	A	C	5	10	15	0	0	15	0	0
11	12782593	.	T	C	5	1	6	1	7	14	0	0
11	12845101	.	T	A	2	2	4	0	0	4	0	0
11	12845150	.	T	C	2	3	5	0	0	5	0	0
11	12845160	.	G	A	0	2	2	0	2	4	0	0
11	12861196	.	A	G	1	3	4	0	0	4	0	0
11	12869192	.	G	T	0	10	10	0	7	17	0	0
11	12869309	.	T	C	6	7	13	0	1	14	0	0
11	12869409	.	C	A	8	9	17	0	0	18	1	0
11	12869414	.	C	T	6	8	14	0	2	16	0	0
11	12872304	.	C	G	2	2	4	0	0	4	0	0
11	12872485	.	G	A	0	2	2	0	0	2	0	0
11	12872549	.	A	T	2	2	4	0	0	4	0	0
11	12874336	.	C	A	3	3	6	0	0	6	0	0
11	12987786	.	G	A	2	3	5	0	1	6	0	0
11	12988038	.	G	A	1	2	3	0	0	3	0	0
11	13055470	.	G	A	11	12	23	0	1	24	0	0
11	13055694	.	C	A	10	9	19	0	1	20	0	0
11	13055748	.	T	C	2	3	5	0	1	6	0	0
11	13067750	.	A	T	2	2	4	0	0	4	0	0
11	13085294	.	G	A	1	2	3	0	0	3	0	0
11	13094199	.	C	T	17	8	25	0	3	28	0	0
11	13094247	.	A	G	4	18	22	0	3	25	0	0
11	13094368	.	T	A	11	5	16	0	0	16	0	0
11	13094386	.	C	T	10	5	15	0	4	19	0	0
11	13094473	.	A	T	21	17	38	0	1	39	0	0
11	13094668	.	C	A	17	15	32	0	3	35	0	0
11	13094678	.	T	C	16	13	29	0	2	31	0	0
11	13094778	.	T	C	8	19	27	0	1	28	0	0
11	13094938	.	G	T	15	20	35	0	5	40	0	0
11	13095049	.	G	A	17	14	31	0	0	31	0	0
11	13185928	.	C	T	0	2	2	0	0	2	0	0
11	13185931	.	G	T	0	1	1	0	0	1	0	0
11	13189339	.	G	T	3	4	7	0	0	7	0	0
11	13189592	.	G	A	5	6	11	0	0	11	0	0
11	13189623	.	T	A	4	3	7	0	0	7	0	0
11	13189627	.	T	G	3	1	4	0	1	5	0	0
11	13208755	.	T	A	16	4	20	0	1	21	0	0
11	13208839	.	C	G	16	30	46	0	1	47	0	0
11	13209085	.	G	C	25	23	48	0	6	54	0	0
11	13209391	.	C	T	9	3	12	0	1	13	0	0
11	13210650	.	A	C	28	24	52	0	0	52	0	0
11	13210667	.	C	T	20	24	44	0	0	45	1	0
11	13210897	.	A	T	21	25	46	0	1	47	0	0
11	13210906	.	C	T	22	24	46	0	7	53	0	0
11	13212186	.	A	T	18	19	37	0	2	39	0	0
11	13212306	.	C	T	24	26	50	0	5	55	0	0
11	13280346	.	T	A	1	4	5	0	1	6	0	0
11	13280580	.	A	G	8	14	22	0	2	24	0	0
11	13281122	.	T	C	12	12	24	0	2	26	0	0
11	13281158	.	A	T	9	8	17	0	1	18	0	0
11	13281243	.	C	A	1	3	4	4	0	8	0	0
11	13281331	.	A	T	10	4	14	0	3	17	0	0
11	13281398	.	G	C	5	8	13	0	0	13	0	0
11	13281594	.	T	C	18	12	30	0	0	30	0	0
11	13281653	.	C	T	26	8	34	0	1	35	0	0
11	13282201	.	G	T	8	8	16	0	3	19	0	0
11	13282439	.	C	A	3	3	6	0	0	6	0	0
11	13282443	.	G	A	3	2	5	0	1	6	0	0
11	13282660	.	C	T	5	4	9	1	0	10	0	0
11	13282881	.	T	C	4	3	7	0	2	9	0	0
11	13282883	.	A	G	5	3	8	0	1	9	0	0
11	13283156	.	T	A	9	6	15	0	1	17	1	0
11	13283181	.	C	T	10	6	16	0	0	16	0	0
11	13283220	.	C	G	0	8	8	0	7	15	0	0
11	13283368	.	C	A	7	8	15	0	0	15	0	0
11	13283403	.	T	G	10	4	14	0	0	14	0	0
11	13283447	.	G	A	11	5	16	0	0	16	0	0
11	13283476	.	C	T	8	4	12	0	0	12	0	0
11	13283634	.	C	T	3	2	5	0	0	5	0	0
11	13283713	.	G	A	6	8	14	0	1	15	0	0
11	13292027	.	A	T	0	2	2	0	0	2	0	0
11	13292084	.	A	G	2	4	6	0	0	6	0	0
11	13292462	.	C	T	2	2	4	0	0	4	0	0
11	13292576	.	C	T	0	5	5	0	5	10	0	0
11	13305949	.	G	A	3	1	4	0	0	4	0	0
11	13530399	.	A	C	1	0	1	0	0	1	0	0
11	13531954	.	C	T	1	0	1	0	0	1	0	0
11	13532763	.	C	T	2	6	8	0	0	8	0	0
11	13533072	.	A	G	5	7	12	0	2	14	0	0
11	13533094	.	T	G	7	8	15	0	0	15	0	0
11	13533124	.	G	A	4	10	14	0	1	15	0	0
11	13533429	.	G	T	9	4	13	0	0	13	0	0
11	13636198	.	C	T	1	3	4	0	0	4	0	0
11	13789149	.	T	A	6	3	9	0	0	9	0	0
11	13789162	.	C	T	5	4	9	0	0	9	0	0
11	14061966	.	A	C	0	2	2	0	0	2	0	0
11	14062368	.	C	T	1	3	4	0	0	4	0	0
11	14062790	.	A	G	3	2	5	0	1	6	0	0
11	14063588	.	A	G	2	2	4	0	0	4	0	0
11	14064229	.	T	C	3	2	5	0	0	5	0	0
11	14064419	.	A	G	5	6	11	0	0	11	0	0
11	14064454	.	A	G	3	6	9	0	0	9	0	0
11	14064523	.	C	T	5	5	10	0	0	10	0	0
11	14073005	.	A	T	5	2	7	0	0	7	0	0
11	14073255	.	T	C	5	4	9	0	0	9	0	0
11	14073290	.	T	C	8	3	11	0	0	11	0	0
11	14073309	.	T	C	8	3	11	0	1	12	0	0
11	14073338	.	C	T	10	4	14	0	1	15	0	0
11	14073503	.	G	A	9	10	19	0	2	21	0	0
11	14073560	.	T	A	10	10	20	0	3	23	0	0
11	14073619	.	T	C	8	6	14	0	2	16	0	0
11	14073639	.	T	C	5	6	11	0	0	11	0	0
11	14073667	.	T	C	9	5	14	0	0	14	0	0
11	14073730	.	G	T	7	10	17	0	3	20	0	0
11	14074125	.	T	C	4	4	8	0	0	8	0	0
11	14074174	.	T	C	7	9	16	0	0	16	0	0
11	14074245	.	T	C	5	8	13	0	0	13	0	0
11	14074397	.	A	G	4	6	10	0	0	10	0	0
11	14074584	.	T	G	2	4	6	0	1	7	0	0
11	14074628	.	T	A	1	2	3	0	0	3	0	0
11	14074738	.	G	A	3	3	6	0	0	6	0	0
11	14075147	.	G	A	5	4	9	0	3	12	0	0
11	14075302	.	A	G	1	9	10	0	0	10	0	0
11	14101497	.	A	T	2	2	4	0	0	4	0	0
11	14101521	.	A	T	2	2	4	0	0	4	0	0
11	14143452	.	C	A	3	11	14	0	0	14	0	0
11	14143498	.	T	C	2	2	4	0	0	4	0	0
11	14143499	.	G	A	2	2	4	0	0	4	0	0
11	14148179	.	A	G	1	2	3	0	0	3	0	0
11	14148341	.	T	A	1	1	2	0	0	2	0	0
11	14149964	.	T	C	1	1	2	0	0	2	0	0
11	14159425	.	C	T	6	8	14	0	1	15	0	0
11	14159513	.	A	G	15	10	25	0	1	26	0	0
11	14159555	.	A	G	12	12	24	0	2	26	0	0
11	14159622	.	T	C	10	6	16	0	0	16	0	0
11	14159979	.	T	C	15	8	23	0	1	24	0	0
11	14160131	.	A	G	14	6	20	0	2	22	0	0
11	14160941	.	C	A	6	8	14	0	1	15	0	0
11	14161073	.	A	G	19	12	31	0	1	32	0	0
11	14161077	.	C	A	18	11	29	0	2	31	0	0
11	14161291	.	A	T	16	19	35	0	2	37	0	0
11	14161304	.	A	G	15	24	39	0	1	40	0	0
11	14249012	.	A	G	0	2	2	0	0	2	0	0
11	14266826	.	G	T	0	11	11	0	13	24	0	0
11	14267075	.	T	C	15	14	29	0	3	32	0	0
11	14267076	.	G	A	15	16	31	0	1	32	0	0
11	14267236	.	A	G	12	0	12	0	9	21	0	0
11	14267239	.	C	G	11	10	21	0	0	21	0	0
11	14432169	.	C	A	1	3	4	0	0	4	0	0
11	14640155	.	A	G	2	2	4	0	0	4	0	0
11	14676340	.	T	C	2	2	4	0	0	4	0	0
11	14676365	.	G	T	2	2	4	0	0	4	0	0
11	14955592	.	A	G	10	13	23	0	1	24	0	0
11	14955897	.	A	G	3	2	5	0	0	5	0	0
11	14957155	.	A	T	7	12	19	0	2	21	0	0
11	15834110	.	T	G	4	4	8	0	2	10	0	0
11	15834311	.	C	T	7	7	14	0	0	14	0	0
11	15834318	.	T	G	7	7	14	0	1	15	0	0
11	15834436	.	T	A	4	8	12	0	0	12	0	0
11	15874820	.	A	G	0	3	3	0	0	3	0	0
11	15915274	.	G	T	4	3	7	0	0	7	0	0
11	16005883	.	G	T	1	2	3	0	0	3	0	0
11	16011019	.	C	T	1	2	3	0	2	5	0	0
11	16012829	.	G	T	10	13	23	0	1	24	0	0
11	16095020	.	T	C	7	9	16	0	0	16	0	0
11	16095042	.	C	G	7	10	17	0	1	18	0	0
11	16099700	.	G	A	2	0	2	0	0	2	0	0
11	16104175	.	T	C	1	8	9	1	0	10	0	0
11	16115692	.	C	T	3	9	12	0	0	12	0	0
11	16143740	.	G	A	25	15	40	0	6	46	0	0
11	16143781	.	T	C	9	29	38	0	1	39	0	0
11	16153368	.	G	A	0	3	3	0	5	8	0	0
11	16158555	.	G	A	5	8	13	0	0	13	0	0
11	16159101	.	C	T	1	1	2	0	0	2	0	0
11	16159316	.	C	T	3	3	6	0	0	6	0	0
11	16159875	.	T	C	0	2	2	0	0	2	0	0
11	16159903	.	C	T	2	6	8	0	0	8	0	0
11	16159926	.	C	T	6	2	8	0	0	8	0	0
11	16160074	.	C	T	1	2	3	0	1	4	0	0
11	16165233	.	A	G	6	10	16	0	3	19	0	0
11	16165395	.	G	A	4	14	18	0	0	18	0	0
11	16177158	.	G	A	0	2	2	0	3	5	0	0
11	16179830	.	T	A	22	20	42	0	3	45	0	0
11	16179882	.	T	A	18	22	40	0	1	41	0	0
11	16184865	.	A	T	5	14	19	0	0	19	0	0
11	16192224	.	G	A	6	9	15	0	0	15	0	0
11	16214941	.	G	A	3	4	7	0	1	8	0	0
11	16329862	.	G	T	2	5	7	0	0	7	0	0
11	16329929	.	T	C	4	3	7	0	1	8	0	0
11	16330206	.	C	A	10	5	15	0	0	15	0	0
11	16330300	.	C	A	2	4	6	0	2	8	0	0
11	16330585	.	A	G	3	6	9	0	1	10	0	0
11	16330686	.	T	G	3	7	10	0	0	10	0	0
11	16330720	.	G	A	3	9	12	0	0	12	0	0
11	16331143	.	T	A	4	2	6	0	0	6	0	0
11	16331414	.	G	A	2	1	3	0	1	4	0	0
11	16331474	.	G	T	4	2	6	0	0	6	0	0
11	16583904	.	C	T	1	2	3	0	0	3	0	0
11	16584623	.	C	T	1	2	3	0	0	3	0	0
11	16586136	.	A	G	3	2	5	0	0	5	0	0
11	16586272	.	A	T	3	3	6	0	0	6	0	0
11	16586326	.	T	C	1	2	3	0	0	3	0	0
11	16586337	.	T	A	1	3	4	0	0	4	0	0
11	16586925	.	T	C	2	5	7	0	0	7	0	0
11	16587457	.	C	T	3	3	6	0	0	6	0	0
11	16587682	.	A	C	5	4	9	0	0	9	0	0
11	16738655	.	C	T	1	2	3	0	0	3	0	0
11	16849887	.	T	G	1	2	3	0	0	3	0	0
11	16849896	.	G	A	1	2	3	0	1	4	0	0
11	16974989	.	C	T	0	2	2	0	1	3	0	0
11	17512289	.	T	C	13	10	23	0	4	27	0	0
11	17597224	.	G	A	6	7	13	0	0	13	0	0
11	17597225	.	T	G	6	7	13	0	0	13	0	0
11	17608441	.	G	A	1	3	4	0	0	4	0	0
11	17757623	.	G	T	11	10	21	0	2	23	0	0
11	17757624	.	A	G	13	8	21	0	2	23	0	0
11	17757772	.	G	A	7	7	14	0	2	16	0	0
11	17757931	.	T	C	4	3	7	0	0	7	0	0
11	17763904	.	C	T	1	2	3	0	0	3	0	0
11	17763928	.	C	T	1	0	1	0	0	1	0	0
11	17765182	.	C	A	6	3	9	0	0	9	0	0
11	17765293	.	C	T	4	4	8	0	0	8	0	0
11	17765489	.	G	A	0	3	3	0	0	3	0	0
11	17769200	.	C	T	0	1	1	0	0	1	0	0
11	17769236	.	T	C	0	0	0	0	3	3	0	0
11	17769238	.	C	T	0	3	3	0	0	3	0	0
11	17769711	.	C	T	0	1	1	0	0	1	0	0
11	17770627	.	T	C	2	3	5	0	2	7	0	0
11	17771185	.	T	C	1	1	2	0	0	2	0	0
11	17778618	.	T	G	1	2	3	0	0	3	0	0
11	17778639	.	C	T	0	4	4	0	2	6	0	0
11	17779028	.	T	G	4	3	7	0	0	7	0	0
11	17779159	.	A	G	3	1	4	0	0	4	0	0
11	17779599	.	A	C	1	1	2	0	2	4	0	0
11	17782669	.	G	C	1	2	3	0	0	3	0	0
11	17785428	.	T	C	18	18	36	0	3	39	0	0
11	17789104	.	C	T	0	6	6	0	6	12	0	0
11	17789243	.	G	A	1	3	4	0	2	6	0	0
11	17984503	.	A	G	0	1	1	0	0	1	0	0
11	17987038	.	A	T	0	1	1	0	1	2	0	0
11	17994250	.	A	G	6	3	9	0	0	9	0	0
11	17994251	.	C	T	5	2	7	0	2	9	0	0
11	18010235	.	G	A	4	3	7	0	0	7	0	0
11	18205868	.	A	C	1	1	2	0	1	3	0	0
11	18216527	.	G	T	1	3	4	0	0	4	0	0
11	18216643	.	G	A	5	4	9	0	2	11	0	0
11	18223337	.	C	T	7	7	14	0	0	14	0	0
11	18223365	.	T	C	3	7	10	0	3	13	0	0
11	18223383	.	C	T	8	5	13	0	1	14	0	0
11	18223485	.	G	A	7	3	10	0	0	10	0	0
11	18237862	.	G	A	8	6	14	0	0	14	0	0
11	18238076	.	C	T	6	9	15	0	1	16	0	0
11	18238171	.	T	C	3	5	8	0	0	8	0	0
11	18243966	.	A	G	10	6	16	0	2	18	0	0
11	18244388	.	T	C	7	7	14	0	9	23	0	0
11	18283126	.	C	T	1	3	4	0	0	4	0	0
11	18287283	.	A	T	10	4	14	0	1	15	0	0
11	18287316	.	G	A	5	10	15	0	0	15	0	0
11	18287378	.	C	T	0	15	15	0	13	28	0	0
11	18287506	.	A	G	8	7	15	0	1	16	0	0
11	18287687	.	T	A	5	8	13	0	0	13	0	0
11	18287779	.	G	A	7	7	14	0	0	14	0	0
11	18287895	.	T	G	7	7	14	0	1	15	0	0
11	18287940	.	A	T	10	5	15	0	2	17	0	0
11	18288212	.	T	C	6	10	16	0	0	16	0	0
11	18288275	.	C	A	0	6	6	0	5	11	0	0
11	18288347	.	G	A	6	7	13	0	2	15	0	0
11	18289356	.	C	T	4	0	4	0	0	4	0	0
11	18290095	.	G	A	2	1	3	0	1	4	0	0
11	18291853	.	T	A	2	1	3	0	0	3	0	0
11	18292595	.	C	T	0	4	4	0	1	5	0	0
11	18292675	.	C	T	4	1	5	0	0	5	0	0
11	18294857	.	A	G	1	3	4	0	2	6	0	0
11	18294911	.	A	G	4	2	6	0	0	6	0	0
11	18304255	.	T	A	0	2	2	0	0	2	0	0
11	18315955	.	C	T	3	2	5	0	0	5	0	0
11	18315988	.	T	A	4	3	7	0	0	7	0	0
11	18345343	.	T	A	5	5	10	0	1	11	0	0
11	18345390	.	C	A	4	2	6	0	0	6	0	0
11	18345635	.	G	A	1	3	4	0	1	5	0	0
11	18345719	.	T	G	6	2	8	0	1	9	0	0
11	18346002	.	T	C	4	2	6	0	1	7	0	0
11	18346324	.	C	A	0	2	2	0	1	3	0	0
11	18397168	.	A	T	1	0	1	0	0	1	0	0
11	18398392	.	C	G	1	2	3	0	0	3	0	0
11	18398441	.	T	C	0	0	0	0	3	3	0	0
11	18398443	.	T	C	1	2	3	0	0	3	0	0
11	18398555	.	T	G	1	2	3	0	0	3	0	0
11	18535112	.	T	C	3	2	5	0	0	5	0	0
11	18536769	.	G	A	18	12	30	0	1	31	0	0
11	18536800	.	C	T	1	16	17	0	14	31	0	0
11	18536864	.	G	T	9	15	24	0	1	25	0	0
11	18536866	.	G	A	10	15	25	0	0	25	0	0
11	18537180	.	A	G	6	8	14	0	0	14	0	0
11	18537244	.	G	A	10	8	18	0	1	19	0	0
11	18537447	.	T	C	3	7	10	0	3	13	0	0
11	18537636	.	T	A	5	8	13	0	1	14	0	0
11	18537649	.	G	A	5	11	16	0	0	16	0	0
11	18538122	.	A	T	7	6	13	0	1	14	0	0
11	18538336	.	A	C	8	0	8	0	10	18	0	0
11	18538910	.	C	T	6	4	10	0	0	10	0	0
11	18539155	.	G	C	6	6	12	0	0	12	0	0
11	18539616	.	C	A	2	3	5	0	1	6	0	0
11	18542168	.	T	C	0	1	1	0	0	1	0	0
11	18542585	.	A	G	1	1	2	0	0	2	0	0
11	18543870	.	A	G	2	2	4	0	0	4	0	0
11	18546088	.	G	T	3	0	3	0	2	5	0	0
11	18546357	.	T	A	2	6	8	0	0	8	0	0
11	18547125	.	A	G	9	10	19	0	0	19	0	0
11	18551089	.	G	A	2	6	8	1	0	9	0	0
11	18551120	.	C	T	0	5	5	0	2	7	0	0
11	18561144	.	T	C	6	9	15	0	0	15	0	0
11	18561432	.	C	G	0	4	4	0	0	4	0	0
11	18561477	.	T	G	2	3	5	0	0	5	0	0
11	18561674	.	C	T	11	9	20	0	2	22	0	0
11	18561792	.	T	C	18	1	19	0	12	31	0	0
11	18561816	.	A	G	13	8	21	0	0	21	0	0
11	18562059	.	T	G	12	9	21	0	1	22	0	0
11	18562420	.	G	T	5	5	10	0	1	11	0	0
11	18562448	.	T	C	5	0	5	0	9	14	0	0
11	18562655	.	T	C	3	0	3	0	9	12	0	0
11	18562730	.	G	T	9	10	19	0	0	19	0	0
11	18569158	.	A	T	1	0	1	0	0	1	0	0
11	18569379	.	A	G	5	8	13	0	0	13	0	0
11	18572364	.	T	C	3	0	3	0	8	11	0	0
11	18572586	.	C	T	6	10	16	0	2	18	0	0
11	18572640	.	T	G	5	5	10	0	2	12	0	0
11	18572648	.	G	A	6	7	13	0	1	14	0	0
11	18575031	.	G	C	5	2	7	0	1	8	0	0
11	18577787	.	A	G	1	2	3	0	0	3	0	0
11	18579868	.	G	A	3	0	3	0	0	3	0	0
11	18579912	.	A	G	3	0	3	0	0	3	0	0
11	18586759	.	A	G	1	1	2	0	0	2	0	0
11	18686477	.	A	C	4	4	8	0	0	8	0	0
11	18686492	.	G	A	3	3	6	0	0	6	0	0
11	18688956	.	T	C	1	5	6	0	0	6	0	0
11	18694013	.	C	T	4	4	8	0	0	8	0	0
11	18697817	.	T	G	7	8	15	0	1	16	0	0
11	18698138	.	A	G	1	1	2	0	4	6	0	0
11	18698526	.	G	A	8	5	13	0	0	13	0	0
11	18698687	.	A	T	4	3	7	0	0	7	0	0
11	18699104	.	T	C	3	21	24	0	2	26	0	0
11	18704378	.	G	C	5	2	7	0	1	8	0	0
11	18704383	.	T	A	6	5	11	0	0	11	0	0
11	18704500	.	G	A	11	10	21	0	1	22	0	0
11	18704620	.	C	T	0	15	15	0	16	31	0	0
11	18705108	.	A	G	10	12	22	0	0	22	0	0
11	18784949	.	A	T	8	15	23	0	0	23	0	0
11	18784975	.	C	A	9	17	26	0	2	29	1	0
11	18785019	.	G	A	7	20	27	0	4	31	0	0
11	18785022	.	G	A	8	22	30	0	2	32	0	0
11	18785159	.	G	T	14	22	36	0	4	40	0	0
11	18785214	.	T	C	18	24	42	0	4	46	0	0
11	18785309	.	G	A	9	14	23	0	5	28	0	0
11	18785410	.	G	A	10	16	26	0	0	26	0	0
11	18785421	.	A	G	10	16	26	0	1	27	0	0
11	18785749	.	C	G	3	2	5	0	0	5	0	0
11	18785854	.	A	G	9	10	19	0	1	20	0	0
11	18786085	.	A	T	3	13	16	0	1	17	0	0
11	18794073	.	T	A	0	1	1	0	0	1	0	0
11	18802570	.	T	C	6	3	9	0	0	9	0	0
11	18803095	.	C	T	0	2	2	0	2	4	0	0
11	18803621	.	A	G	1	1	2	0	1	3	0	0
11	19013597	.	C	T	1	0	1	0	0	1	0	0
11	19041852	.	C	T	2	5	7	0	1	8	0	0
11	19042092	.	T	C	1	3	4	0	0	4	0	0
11	19042212	.	T	C	5	5	10	0	0	10	0	0
11	19068394	.	C	T	4	1	5	0	0	5	0	0
11	19072566	.	A	T	13	10	23	0	3	26	0	0
11	19072608	.	T	A	10	14	24	0	2	26	0	0
11	19072695	.	G	A	9	6	15	0	1	16	0	0
11	19072728	.	G	A	0	2	2	0	3	5	0	0
11	19084820	.	C	T	7	7	14	0	0	14	0	0
11	19089286	.	A	G	22	14	36	0	3	39	0	0
11	19089362	.	A	G	31	23	54	0	3	57	0	0
11	19089368	.	C	T	29	27	56	0	2	58	0	0
11	19089608	.	G	A	0	27	27	0	30	57	0	0
11	19089724	.	T	C	19	23	42	0	0	42	0	0
11	19089839	.	G	A	2	16	18	0	17	35	0	0
11	19090203	.	G	A	0	12	12	0	19	31	0	0
11	19090455	.	C	T	26	22	48	0	2	50	0	0
11	19090597	.	A	G	25	26	51	0	2	53	0	0
11	19217463	.	C	T	3	2	5	0	0	5	0	0
11	19462920	.	C	T	1	0	1	0	1	2	0	0
11	19462969	.	A	G	1	2	3	0	1	4	0	0
11	19464813	.	A	G	1	5	6	0	0	6	0	0
11	19465149	.	T	C	9	9	18	0	1	19	0	0
11	19465174	.	C	T	7	6	13	0	2	15	0	0
11	19465269	.	T	C	5	4	9	0	0	9	0	0
11	19465302	.	A	T	8	3	11	0	2	13	0	0
11	19465428	.	C	T	2	3	5	0	1	6	0	0
11	19467673	.	G	A	6	2	8	0	0	8	0	0
11	19467792	.	G	A	0	11	11	0	13	24	0	0
11	19468147	.	C	T	19	9	28	0	6	34	0	0
11	19502433	.	C	T	14	9	23	0	1	24	0	0
11	19505967	.	T	C	8	9	17	0	1	18	0	0
11	19506260	.	C	T	8	10	18	0	3	21	0	0
11	19512285	.	T	C	4	9	13	0	3	16	0	0
11	19512469	.	C	T	5	4	9	0	1	10	0	0
11	19513639	.	C	T	2	3	5	0	1	6	0	0
11	19604223	.	A	C	8	2	10	0	1	11	0	0
11	19611215	.	C	T	6	3	9	0	0	9	0	0
11	19624516	.	T	C	1	3	4	0	1	5	0	0
11	19624531	.	A	T	1	5	6	0	0	6	0	0
11	19624552	.	C	T	3	6	9	0	1	10	0	0
11	19624616	.	A	T	6	15	21	0	0	21	0	0
11	19624686	.	T	C	2	12	14	0	1	15	0	0
11	19624730	.	T	G	5	13	18	0	2	20	0	0
11	19625524	.	C	T	0	6	6	0	18	24	0	0
11	19625535	.	C	T	14	4	18	0	3	21	0	0
11	19625673	.	A	T	13	6	19	0	0	19	0	0
11	19625732	.	A	G	11	6	17	0	1	18	0	0
11	19625804	.	C	T	5	10	15	0	1	16	0	0
11	19625840	.	G	T	4	9	13	0	1	14	0	0
11	19626209	.	A	G	5	0	5	0	1	6	0	0
11	19626216	.	G	T	5	0	5	0	1	6	0	0
11	19627157	.	T	A	4	3	7	0	0	7	0	0
11	19627169	.	A	T	5	2	7	0	1	8	0	0
11	19627277	.	A	T	3	6	9	0	0	9	0	0
11	19729925	.	G	A	2	5	7	0	0	7	0	0
11	19729965	.	T	A	1	6	7	0	0	7	0	0
11	19730001	.	A	C	2	0	2	0	8	10	0	0
11	19986191	.	G	A	0	2	2	0	1	3	0	0
11	20017802	.	A	G	1	0	1	0	1	2	0	0
11	20036591	.	G	A	0	1	1	0	1	2	0	0
11	20058915	.	C	T	3	11	14	0	0	14	0	0
11	20794150	.	T	C	1	3	4	0	0	4	0	0
11	20815757	.	A	G	6	0	6	0	6	12	0	0
11	20826358	.	T	C	17	17	34	0	1	35	0	0
11	21154727	.	G	A	2	4	6	0	0	6	0	0
11	21154747	.	A	T	2	8	10	0	0	10	0	0
11	21154786	.	A	C	4	10	14	0	0	14	0	0
11	21155290	.	G	A	12	4	16	0	1	17	0	0
11	21155829	.	A	G	1	7	8	0	0	8	0	0
11	21156085	.	T	G	3	3	6	0	0	8	2	0
11	21156278	.	G	A	6	4	10	0	0	10	0	0
11	21156372	.	G	A	3	5	8	0	0	8	0	0
11	21217518	.	T	C	0	1	1	0	0	1	0	0
11	21259435	.	A	C	4	2	6	0	0	6	0	0
11	21259468	.	C	G	3	2	5	0	0	5	0	0
11	21259665	.	T	A	5	7	12	0	0	12	0	0
11	21259771	.	T	C	5	3	8	0	1	9	0	0
11	21259968	.	A	G	6	2	8	0	0	8	0	0
11	21260213	.	G	A	1	7	8	0	0	8	0	0
11	21260676	.	C	T	6	4	10	0	0	10	0	0
11	21260750	.	C	T	3	4	7	0	0	7	0	0
11	21260985	.	A	T	4	4	8	0	1	9	0	0
11	21261031	.	T	C	2	4	6	0	1	7	0	0
11	21278950	.	T	A	17	17	34	0	0	34	0	0
11	21279025	.	G	A	17	14	31	0	2	33	0	0
11	21279144	.	A	T	16	17	33	0	3	36	0	0
11	21279225	.	G	A	10	18	28	0	3	31	0	0
11	21279261	.	A	G	6	13	19	0	2	21	0	0
11	21279827	.	T	C	2	4	6	0	0	6	0	0
11	21279861	.	T	G	2	12	14	0	0	14	0	0
11	21279885	.	A	G	1	11	12	0	4	16	0	0
11	21279921	.	A	C	4	13	17	0	3	20	0	0
11	21279959	.	C	T	12	8	20	0	1	21	0	0
11	21280149	.	G	T	11	6	17	0	1	18	0	0
11	21280236	.	C	A	10	8	18	0	2	20	0	0
11	21280284	.	T	A	6	7	13	0	0	13	0	0
11	21280347	.	C	T	7	6	13	0	0	13	0	0
11	21280349	.	G	A	7	5	12	0	1	13	0	0
11	21280504	.	A	C	7	9	16	0	0	16	0	0
11	21280690	.	T	C	5	5	10	0	0	10	0	0
11	21280801	.	T	A	5	10	15	0	0	15	0	0
11	21280808	.	T	C	5	9	14	0	0	14	0	0
11	21280848	.	T	A	10	11	21	0	0	21	0	0
11	21280864	.	A	G	8	8	16	0	0	16	0	0
11	21280926	.	T	C	1	4	5	0	3	8	0	0
11	21280974	.	G	A	4	5	9	0	2	11	0	0
11	21281087	.	C	T	11	6	17	0	0	17	0	0
11	21281138	.	G	A	9	6	15	0	1	16	0	0
11	21281148	.	G	A	7	7	14	0	3	17	0	0
11	21281219	.	G	A	12	4	16	0	1	17	0	0
11	21281269	.	T	C	8	3	11	0	0	11	0	0
11	21281311	.	A	T	6	12	18	0	0	18	0	0
11	21281328	.	C	T	5	12	17	0	1	18	0	0
11	21281599	.	T	C	5	8	13	0	1	14	0	0
11	21281657	.	T	C	7	8	15	0	0	15	0	0
11	21281658	.	T	C	9	5	14	0	1	15	0	0
11	21281774	.	T	C	2	5	7	0	0	7	0	0
11	21282355	.	G	A	2	2	4	0	0	4	0	0
11	21282414	.	G	A	2	4	6	0	0	6	0	0
11	21282424	.	C	G	3	3	6	0	0	6	0	0
11	21282571	.	G	A	4	3	7	0	0	7	0	0
11	21282747	.	T	C	2	3	5	0	0	5	0	0
11	21284588	.	A	G	5	1	6	0	1	7	0	0
11	21284701	.	A	C	5	0	5	0	9	14	0	0
11	21284733	.	C	T	4	7	11	0	2	13	0	0
11	21323564	.	A	G	0	1	1	0	0	1	0	0
11	21352744	.	G	C	1	2	3	0	0	3	0	0
11	21352773	.	A	T	1	3	4	0	0	4	0	0
11	21407073	.	C	A	0	14	14	0	14	28	0	0
11	21407091	.	T	C	13	1	14	0	9	23	0	0
11	21407591	.	G	A	6	12	18	0	2	20	0	0
11	21407843	.	C	T	5	7	12	0	0	12	0	0
11	21407862	.	A	T	4	9	13	0	0	13	0	0
11	21407895	.	C	G	8	5	13	0	1	14	0	0
11	21407901	.	T	C	8	4	12	0	1	13	0	0
11	21408103	.	G	T	1	2	3	0	0	3	0	0
11	21408201	.	T	A	10	5	15	0	1	16	0	0
11	21408202	.	T	C	10	6	16	0	0	16	0	0
11	21408242	.	C	T	8	4	12	0	2	14	0	0
11	21408423	.	T	A	2	2	4	0	0	4	0	0
11	21408962	.	C	T	2	6	8	0	1	9	0	0
11	21409236	.	A	T	9	3	12	0	0	12	0	0
11	21409331	.	A	G	5	2	7	0	0	7	0	0
11	21409690	.	A	G	4	4	8	0	1	9	0	0
11	21409981	.	C	A	6	2	8	0	2	10	0	0
11	21410009	.	A	G	6	4	10	0	0	10	0	0
11	21410584	.	G	A	3	7	10	0	1	11	0	0
11	21419637	.	A	C	0	1	1	0	0	1	0	0
11	21596459	.	T	C	1	5	6	0	0	6	0	0
11	21596931	.	C	T	1	2	3	0	0	3	0	0
11	21597055	.	T	G	7	5	12	0	2	14	0	0
11	21597107	.	A	G	5	4	9	0	1	10	0	0
11	21597154	.	T	C	2	5	7	0	0	7	0	0
11	21597165	.	C	T	3	5	8	0	0	8	0	0
11	21597261	.	C	T	6	4	10	0	0	10	0	0
11	21597659	.	T	C	7	5	12	0	0	12	0	0
11	21597676	.	C	A	6	4	10	0	0	10	0	0
11	21597742	.	T	A	3	2	5	0	0	5	0	0
11	21598002	.	T	C	5	6	11	0	1	12	0	0
11	22089476	.	A	C	2	4	6	0	0	6	0	0
11	22089477	.	T	A	2	4	6	0	0	6	0	0
11	22089575	.	T	C	4	2	6	0	0	6	0	0
11	22092105	.	C	T	7	14	21	0	3	24	0	0
11	22092181	.	A	T	13	14	27	0	1	28	0	0
11	22092689	.	T	A	8	4	12	0	1	13	0	0
11	22092743	.	T	A	0	7	7	0	4	11	0	0
11	22093848	.	A	C	14	11	25	0	5	30	0	0
11	22094072	.	T	C	7	19	26	0	2	28	0	0
11	22363756	.	A	T	10	8	18	0	0	18	0	0
11	22363994	.	T	G	7	10	17	0	1	18	0	0
11	22364128	.	A	T	5	14	19	0	1	20	0	0
11	22364140	.	T	A	4	14	18	0	3	21	0	0
11	22364228	.	G	A	8	6	14	0	0	14	0	0
11	22364359	.	A	G	3	3	6	0	0	6	0	0
11	22364416	.	A	G	3	6	9	0	1	10	0	0
11	22364502	.	C	A	0	8	8	0	12	20	0	0
11	22366703	.	C	T	0	2	2	0	3	5	0	0
11	22366709	.	G	T	4	3	7	0	0	7	0	0
11	22366841	.	T	C	3	1	4	0	0	4	0	0
11	22367200	.	A	T	7	9	16	0	0	16	0	0
11	22367251	.	A	G	5	5	10	0	0	10	0	0
11	22369922	.	G	A	2	2	4	0	0	4	0	0
11	22370049	.	G	A	0	3	3	0	1	4	0	0
11	22495182	.	T	C	3	3	6	0	0	6	0	0
11	22552208	.	C	T	0	2	2	0	0	2	0	0
11	22560379	.	A	C	3	2	5	0	0	5	0	0
11	22571657	.	G	A	1	3	4	0	0	4	0	0
11	22571733	.	T	C	2	2	4	0	0	4	0	0
11	22571753	.	A	G	3	0	3	0	0	3	0	0
11	22578767	.	G	A	0	3	3	0	5	8	0	0
11	22578779	.	C	A	5	4	9	0	0	9	0	0
11	22582634	.	C	A	2	2	4	0	2	6	0	0
11	22583139	.	G	T	2	1	3	0	0	3	0	0
11	22583150	.	G	A	0	2	2	0	2	4	0	0
11	22583372	.	C	G	4	2	6	0	4	10	0	0
11	22583424	.	G	T	8	8	16	0	3	19	0	0
11	22583514	.	G	A	4	4	8	0	2	10	0	0
11	22583656	.	T	G	3	6	9	0	0	9	0	0
11	22583665	.	G	T	3	4	7	0	0	7	0	0
11	22583701	.	A	C	1	3	4	0	0	4	0	0
11	22583759	.	T	C	4	5	9	0	0	9	0	0
11	22583858	.	C	A	7	4	11	0	1	12	0	0
11	22583884	.	G	T	6	4	10	0	0	10	0	0
11	22583974	.	T	C	8	8	16	0	0	16	0	0
11	22583984	.	T	C	8	7	15	0	0	15	0	0
11	22584173	.	G	A	4	4	8	0	0	8	0	0
11	22584229	.	T	C	6	5	11	0	0	11	0	0
11	22584417	.	A	C	5	3	8	0	0	8	0	0
11	22624536	.	A	G	1	3	4	0	0	4	0	0
11	22630168	.	G	A	4	5	9	0	0	9	0	0
11	22630190	.	T	A	4	6	10	0	0	10	0	0
11	22630264	.	T	G	1	2	3	0	0	3	0	0
11	22891251	.	T	C	15	10	25	0	0	25	0	0
11	22891305	.	C	G	18	11	29	0	1	30	0	0
11	22891477	.	G	A	19	12	31	0	5	36	0	0
11	22891490	.	A	C	22	13	35	0	0	35	0	0
11	22891574	.	G	A	21	6	27	0	0	27	0	0
11	22891575	.	T	C	18	0	18	0	9	27	0	0
11	22891890	.	C	A	8	10	18	0	1	19	0	0
11	22891979	.	A	T	12	7	19	0	2	21	0	0
11	22892092	.	G	A	13	8	21	0	2	23	0	0
11	22892534	.	G	A	11	12	23	0	2	25	0	0
11	22905743	.	T	G	3	3	6	0	0	6	0	0
11	22911841	.	C	G	6	7	13	0	0	13	0	0
11	22915951	.	T	A	0	1	1	0	0	1	0	0
11	22915952	.	T	A	0	1	1	0	0	1	0	0
11	22916528	.	G	T	4	3	7	0	0	7	0	0
11	22916540	.	C	A	4	3	7	0	0	7	0	0
11	22921048	.	T	G	22	15	37	0	15	52	0	0
11	22921124	.	G	T	32	26	58	0	2	60	0	0
11	22921568	.	G	C	29	25	54	0	2	56	0	0
11	22921800	.	T	G	31	17	48	0	2	50	0	0
11	22921960	.	T	C	22	19	41	0	3	44	0	0
11	22921969	.	G	A	21	19	40	0	3	43	0	0
11	22922075	.	A	G	22	18	40	0	2	42	0	0
11	22922114	.	A	T	16	20	36	0	4	40	0	0
11	22922251	.	C	T	20	17	37	0	1	38	0	0
11	22922266	.	A	G	15	17	32	0	2	34	0	0
11	22922290	.	A	G	15	16	31	0	1	32	0	0
11	22922309	.	T	A	18	11	29	0	3	32	0	0
11	22922333	.	A	T	23	12	35	0	2	37	0	0
11	22922355	.	A	T	23	13	36	0	1	37	0	0
11	22922392	.	G	C	20	17	37	0	3	40	0	0
11	22922405	.	G	A	19	16	35	0	3	38	0	0
11	22922645	.	G	A	22	24	46	0	2	48	0	0
11	22922668	.	T	C	20	27	47	0	1	48	0	0
11	22922762	.	T	A	20	19	39	0	2	41	0	0
11	22922784	.	G	A	19	21	40	0	3	43	0	0
11	22922841	.	C	A	22	17	39	0	2	41	0	0
11	22922909	.	A	T	20	14	34	0	0	34	0	0
11	22923168	.	G	A	16	12	28	0	4	32	0	0
11	22924449	.	C	T	9	9	18	0	0	18	0	0
11	22924505	.	A	C	6	3	9	0	2	11	0	0
11	22924650	.	A	C	10	6	16	0	0	16	0	0
11	22924746	.	C	T	0	8	8	0	7	15	0	0
11	22925266	.	G	A	13	18	31	0	1	32	0	0
11	22925370	.	A	G	12	16	28	0	5	33	0	0
11	22925901	.	G	A	15	11	26	0	2	28	0	0
11	22925902	.	A	C	17	11	28	0	0	28	0	0
11	22925966	.	A	T	17	9	26	0	4	30	0	0
11	22995813	.	A	G	0	2	2	0	0	2	0	0
11	22997402	.	C	T	0	3	3	0	0	3	0	0
11	23312307	.	A	C	3	3	6	0	1	7	0	0
11	23312583	.	G	T	2	2	4	0	0	4	0	0
11	23343842	.	A	T	10	5	15	0	1	16	0	0
11	23344109	.	G	A	6	7	13	0	1	14	0	0
11	23344143	.	C	A	9	10	19	0	2	21	0	0
11	23344348	.	C	T	0	9	9	0	10	19	0	0
11	23344608	.	A	C	12	6	18	0	2	20	0	0
11	23345040	.	G	A	7	5	12	0	0	12	0	0
11	23365025	.	A	G	0	0	0	0	1	1	0	0
11	23377379	.	A	G	1	2	3	0	0	3	0	0
11	23422470	.	C	T	0	1	1	0	0	1	0	0
11	23595538	.	G	T	3	5	8	0	0	8	0	0
11	23595766	.	C	A	9	10	19	0	0	19	0	0
11	23595942	.	C	T	11	7	18	0	1	19	0	0
11	23596240	.	A	G	14	6	20	0	0	20	0	0
11	23596333	.	T	C	4	6	10	0	2	12	0	0
11	23596918	.	T	C	4	7	11	0	2	13	0	0
11	23597047	.	G	A	1	3	4	0	0	4	0	0
11	23597098	.	T	C	1	5	6	0	0	6	0	0
11	23597099	.	A	T	1	5	6	0	0	6	0	0
11	23597248	.	T	A	3	3	6	0	1	7	0	0
11	23597262	.	G	A	7	3	10	0	0	10	0	0
11	23597356	.	A	C	2	6	8	0	0	8	0	0
11	23597436	.	G	T	5	3	8	0	0	8	0	0
11	23597437	.	A	T	5	3	8	0	0	8	0	0
11	23597522	.	C	T	0	5	5	0	4	9	0	0
11	23597589	.	C	T	0	2	2	0	1	3	0	0
11	23604921	.	T	C	0	1	1	0	0	1	0	0
11	23604954	.	A	G	1	1	2	0	0	2	0	0
11	23606964	.	A	T	1	3	4	0	0	4	0	0
11	23609617	.	T	G	1	0	1	0	0	1	0	0
11	23856440	.	A	G	3	2	5	0	1	6	0	0
11	23879521	.	C	T	5	5	10	0	0	10	0	0
11	23879654	.	C	A	5	9	14	0	2	16	0	0
11	23879938	.	C	T	7	5	12	0	1	13	0	0
11	23880429	.	A	T	5	5	10	0	1	11	0	0
11	23880486	.	G	T	1	2	3	0	1	4	0	0
11	23880631	.	G	T	2	3	5	0	0	5	0	0
11	23880698	.	C	T	5	4	9	0	0	9	0	0
11	23880941	.	C	T	4	3	7	0	0	7	0	0
11	23881054	.	C	T	2	5	7	0	0	7	0	0
11	23881070	.	C	T	3	5	8	0	0	8	0	0
11	23881101	.	G	A	6	7	13	0	0	13	0	0
11	23881131	.	G	C	6	4	10	0	0	10	0	0
11	23881152	.	G	A	0	5	5	0	6	11	0	0
11	23881238	.	A	T	3	5	8	0	0	8	0	0
11	23881247	.	A	T	3	3	6	0	0	6	0	0
11	23881683	.	A	T	2	2	4	0	0	4	0	0
11	23881719	.	T	A	4	3	7	0	1	8	0	0
11	23881770	.	G	A	1	3	4	0	0	4	0	0
11	23881866	.	A	G	2	3	5	0	1	7	1	0
11	23882438	.	A	G	6	7	13	0	1	14	0	0
11	23882525	.	T	C	9	9	18	0	0	18	0	0
11	23882572	.	A	T	5	13	18	0	0	18	0	0
11	23882747	.	C	T	10	15	25	0	1	26	0	0
11	23882748	.	C	T	9	14	23	0	3	26	0	0
11	23883147	.	C	T	2	5	7	0	0	7	0	0
11	23883149	.	G	C	2	5	7	0	0	7	0	0
11	23883302	.	G	A	5	4	9	0	1	10	0	0
11	23883340	.	C	T	3	13	16	0	0	16	0	0
11	23883466	.	C	G	17	18	35	0	1	37	1	0
11	23883725	.	G	A	17	8	25	0	3	28	0	0
11	23883747	.	C	T	9	16	25	0	2	27	0	0
11	23883810	.	T	A	16	8	24	0	2	26	0	0
11	23884416	.	G	A	31	17	48	0	0	48	0	0
11	23884742	.	G	A	15	16	31	0	2	33	0	0
11	23979519	.	C	T	0	4	4	0	0	4	0	0
11	23987655	.	C	T	5	5	10	0	0	10	0	0
11	24054780	.	A	T	2	2	4	0	0	4	0	0
11	24339459	.	C	T	10	9	19	0	0	19	0	0
11	24340745	.	T	A	2	6	8	0	0	8	0	0
11	24340807	.	A	G	3	7	10	0	0	10	0	0
11	24341085	.	T	A	9	9	18	0	1	19	0	0
11	24342412	.	A	G	2	2	4	0	1	5	0	0
11	24343437	.	C	A	3	8	11	1	1	13	0	0
11	24344284	.	C	T	2	5	7	0	0	7	0	0
11	24344490	.	G	A	3	3	6	0	0	6	0	0
11	24344902	.	A	C	20	27	47	0	0	47	0	0
11	24344983	.	T	G	14	21	35	0	2	37	0	0
11	24345221	.	C	T	11	14	25	0	2	27	0	0
11	24349265	.	A	C	0	1	1	0	0	1	0	0
11	24360891	.	C	G	1	5	6	0	0	6	0	0
11	24360924	.	A	G	4	8	12	0	1	13	0	0
11	24360966	.	A	G	7	9	16	0	0	16	0	0
11	24361207	.	T	G	4	2	6	0	0	6	0	0
11	24465967	.	A	G	3	6	9	0	1	10	0	0
11	24466237	.	C	A	0	10	10	0	5	15	0	0
11	24471280	.	G	C	6	3	9	0	0	9	0	0
11	24471483	.	G	A	7	5	12	0	1	13	0	0
11	24471540	.	G	A	8	3	11	0	0	11	0	0
11	24472145	.	T	A	5	3	8	0	0	8	0	0
11	24478940	.	G	A	0	1	1	0	0	1	0	0
11	24645757	.	T	C	1	0	1	0	0	1	0	0
11	24645880	.	T	C	1	1	2	0	1	3	0	0
11	24645890	.	A	G	1	2	3	0	0	3	0	0
11	24658335	.	T	C	1	1	2	0	0	2	0	0
11	24662794	.	A	G	1	0	1	0	5	6	0	0
11	24662830	.	T	A	5	4	9	0	0	9	0	0
11	24662859	.	T	A	6	6	12	0	2	14	0	0
11	24663349	.	C	G	1	4	5	0	1	6	0	0
11	24672292	.	C	T	3	2	5	0	1	6	0	0
11	24744060	.	C	T	1	3	4	0	0	4	0	0
11	24782499	.	G	A	1	0	1	0	0	1	0	0
11	24782599	.	T	C	4	0	4	0	0	4	0	0
11	24786466	.	T	A	1	0	1	0	0	1	0	0
11	24792460	.	T	C	0	4	4	0	2	6	0	0
11	24796820	.	T	G	1	0	1	0	3	4	0	0
11	24799433	.	T	G	3	9	12	0	1	13	0	0
11	24804565	.	A	T	2	0	2	0	0	2	0	0
11	24805106	.	A	C	3	2	5	0	0	5	0	0
11	24809738	.	C	T	13	18	31	0	2	33	0	0
11	24813128	.	C	T	12	17	29	0	3	32	0	0
11	24813378	.	C	T	7	3	10	0	1	11	0	0
11	24813500	.	C	A	9	12	21	0	1	22	0	0
11	24813810	.	A	G	17	14	31	0	0	31	0	0
11	24813855	.	C	T	11	19	30	0	2	32	0	0
11	24814014	.	A	G	12	15	27	0	1	28	0	0
11	24817258	.	T	C	2	2	4	0	0	4	0	0
11	24819667	.	C	T	3	4	7	0	0	7	0	0
11	24833382	.	G	A	5	5	10	0	0	10	0	0
11	24836384	.	C	T	4	8	12	0	0	12	0	0
11	24836409	.	C	T	5	1	6	0	2	8	0	0
11	24848221	.	T	A	1	1	2	0	1	3	0	0
11	24850428	.	A	G	3	3	6	0	0	6	0	0
11	24869046	.	G	A	1	2	3	0	0	3	0	0
11	24869124	.	G	A	4	2	6	0	0	6	0	0
11	24876567	.	G	A	1	2	3	0	1	4	0	0
11	24882864	.	G	A	0	2	2	0	2	4	0	0
11	24884840	.	G	C	8	5	13	0	1	14	0	0
11	24884967	.	C	T	7	5	12	0	0	12	0	0
11	24885128	.	C	T	5	4	9	0	0	9	0	0
11	24885384	.	C	T	2	7	9	0	0	9	0	0
11	24885734	.	T	C	3	2	5	0	1	6	0	0
11	24885738	.	A	G	4	2	6	0	0	6	0	0
11	24885810	.	A	C	1	3	4	0	0	4	0	0
11	24885901	.	A	T	12	4	16	0	1	17	0	0
11	24885928	.	C	T	9	6	15	0	1	16	0	0
11	24885937	.	C	T	10	5	15	0	1	16	0	0
11	24886273	.	G	A	0	17	17	0	12	29	0	0
11	24886602	.	G	T	0	8	8	0	3	11	0	0
11	24886686	.	G	T	10	4	14	0	2	16	0	0
11	24886739	.	G	T	10	4	14	0	1	15	0	0
11	24886754	.	G	A	10	4	14	0	1	15	0	0
11	24886856	.	C	A	22	5	27	0	0	27	0	0
11	24886859	.	C	T	21	5	26	0	0	26	0	0
11	24887652	.	G	A	13	12	25	0	1	26	0	0
11	24887803	.	A	C	15	14	29	0	0	29	0	0
11	24888021	.	A	T	8	3	11	0	2	13	0	0
11	24888186	.	C	T	2	2	4	0	0	4	0	0
11	24888272	.	C	T	6	7	13	0	0	13	0	0
11	24901897	.	C	T	7	9	16	0	1	17	0	0
11	24904588	.	T	C	14	8	22	0	2	24	0	0
11	24905477	.	C	T	26	20	46	0	3	49	0	0
11	24905526	.	G	T	21	17	38	0	1	39	0	0
11	24905541	.	C	T	22	17	39	0	0	39	0	0
11	24905574	.	G	A	27	12	39	0	5	44	0	0
11	24905576	.	C	A	31	10	41	0	3	44	0	0
11	24905632	.	T	G	15	19	34	0	3	38	1	0
11	24905692	.	G	A	1	11	12	0	24	36	0	0
11	24905742	.	C	T	24	13	37	0	0	37	0	0
11	24905748	.	A	G	20	12	32	0	4	36	0	0
11	24905803	.	G	A	20	15	35	0	4	39	0	0
11	24905985	.	G	T	9	19	28	0	1	29	0	0
11	24906069	.	C	T	10	13	23	0	3	26	0	0
11	24906125	.	A	G	8	15	23	0	1	24	0	0
11	24906128	.	T	A	8	12	20	0	4	24	0	0
11	24906177	.	G	T	17	11	28	0	4	32	0	0
11	24906178	.	G	A	17	13	30	0	2	32	0	0
11	24966245	.	T	C	0	2	2	0	1	3	0	0
11	24966311	.	C	T	1	2	3	0	0	3	0	0
11	24966981	.	A	G	0	1	1	0	0	1	0	0
11	24980714	.	A	C	3	4	7	0	0	7	0	0
11	24987226	.	C	T	3	1	4	0	0	4	0	0
11	24992445	.	T	A	6	8	14	0	0	14	0	0
11	24992522	.	T	G	0	2	2	0	7	11	2	0
11	24992899	.	C	A	10	12	22	0	0	22	0	0
11	25025524	.	C	T	1	8	9	0	0	9	0	0
11	25031497	.	A	T	5	5	10	0	1	11	0	0
11	25040729	.	A	G	6	9	15	0	1	16	0	0
11	25040786	.	G	T	7	5	12	0	0	12	0	0
11	25040857	.	C	T	16	12	28	0	3	31	0	0
11	25041190	.	A	T	7	11	18	0	2	20	0	0
11	25041464	.	T	C	17	12	29	0	1	30	0	0
11	25041737	.	T	A	8	2	10	0	0	10	0	0
11	25053820	.	G	A	1	3	4	0	0	4	0	0
11	25054092	.	G	A	1	0	1	0	0	1	0	0
11	25054095	.	G	A	1	0	1	0	0	1	0	0
11	25138995	.	G	T	20	22	42	0	4	46	0	0
11	25167856	.	T	C	2	2	4	0	0	4	0	0
11	25260136	.	G	T	0	3	3	0	1	4	0	0
11	25260187	.	C	T	6	4	10	0	1	11	0	0
11	25260206	.	T	A	5	4	9	0	0	9	0	0
11	25261665	.	C	T	3	7	10	0	0	10	0	0
11	25261753	.	G	A	0	8	8	0	13	21	0	0
11	25265777	.	G	A	0	2	2	0	1	3	0	0
11	25265867	.	A	T	12	19	31	0	0	31	0	0
11	25265950	.	T	C	9	18	27	0	1	28	0	0
11	25265980	.	A	G	15	9	24	0	2	26	0	0
11	25303803	.	C	T	4	4	8	0	0	8	0	0
11	25306445	.	G	A	1	0	1	0	0	1	0	0
11	25307009	.	C	T	1	0	1	0	0	1	0	0
11	25307234	.	G	A	2	4	6	0	0	6	0	0
11	25307345	.	T	C	3	3	6	0	0	6	0	0
11	25310329	.	G	C	17	11	28	0	0	28	0	0
11	25310777	.	T	G	12	13	25	0	0	26	1	0
11	25313916	.	C	T	0	5	5	0	12	17	0	0
11	25314910	.	C	T	6	6	12	0	0	12	0	0
11	25315658	.	T	C	6	9	15	0	0	15	0	0
11	25315701	.	T	A	9	9	18	0	0	18	0	0
11	25315762	.	A	C	12	14	26	0	1	27	0	0
11	25315828	.	A	G	7	8	15	0	2	17	0	0
11	25315894	.	G	A	8	10	18	0	0	18	0	0
11	25316216	.	T	C	3	8	11	0	1	12	0	0
11	25316351	.	T	A	7	7	14	0	0	14	0	0
11	25316368	.	G	C	6	6	12	0	0	12	0	0
11	25316963	.	G	T	1	3	4	0	0	4	0	0
11	25317607	.	C	G	0	3	3	0	1	4	0	0
11	25317676	.	T	C	3	3	6	0	0	6	0	0
11	25317875	.	G	A	0	4	4	0	0	4	0	0
11	25383221	.	C	T	2	2	4	0	0	4	0	0
11	25383350	.	C	G	2	2	4	0	0	4	0	0
11	25383488	.	G	T	2	3	5	0	0	5	0	0
11	25408022	.	G	T	11	10	21	0	1	22	0	0
11	25436813	.	G	C	4	3	7	0	0	7	0	0
11	25436961	.	T	A	12	10	22	0	0	22	0	0
11	25437080	.	C	T	12	13	25	0	1	26	0	0
11	25437299	.	C	T	12	18	30	0	2	32	0	0
11	25437417	.	C	T	14	12	26	0	0	26	0	0
11	25437501	.	C	T	13	11	24	0	4	28	0	0
11	25437684	.	G	A	9	4	13	0	0	13	0	0
11	25437866	.	T	G	12	8	20	0	1	21	0	0
11	25437901	.	G	A	5	4	9	0	1	10	0	0
11	25439860	.	G	T	7	4	11	0	0	11	0	0
11	25440511	.	G	A	1	6	7	0	1	8	0	0
11	25441009	.	G	A	2	2	4	0	0	4	0	0
11	25441979	.	T	A	4	1	5	0	2	7	0	0
11	25442096	.	C	T	4	8	12	0	0	12	0	0
11	25442147	.	G	T	2	4	6	0	0	6	0	0
11	25442313	.	A	G	5	5	10	0	2	12	0	0
11	25442424	.	A	G	5	4	9	0	0	9	0	0
11	25442457	.	G	T	3	4	7	0	0	7	0	0
11	25447276	.	A	G	1	3	4	0	0	4	0	0
11	25500587	.	C	T	6	12	18	0	1	19	0	0
11	25500843	.	A	G	6	0	6	0	7	13	0	0
11	25501962	.	C	T	3	6	9	0	0	9	0	0
11	25502058	.	C	T	5	8	13	0	0	13	0	0
11	25502319	.	T	C	4	4	8	0	1	9	0	0
11	25502350	.	A	T	5	8	13	0	1	14	0	0
11	25502382	.	C	T	1	5	6	0	0	6	0	0
11	25539857	.	T	G	2	2	4	0	0	4	0	0
11	25542399	.	G	A	1	0	1	0	1	2	0	0
11	25542906	.	A	G	2	4	6	0	0	6	0	0
11	25548007	.	G	A	3	1	4	0	2	6	0	0
11	25548043	.	G	T	0	6	6	0	7	13	0	0
11	25548305	.	A	C	2	2	4	0	0	4	0	0
11	25549953	.	C	G	3	8	11	0	0	11	0	0
11	25560159	.	A	T	1	0	1	0	0	1	0	0
11	25570711	.	A	C	3	2	5	0	0	5	0	0
11	25575100	.	T	C	4	6	10	0	0	10	0	0
11	25575565	.	T	C	0	3	3	0	4	7	0	0
11	25575566	.	T	C	0	7	7	0	0	7	0	0
11	25612824	.	C	T	9	4	13	0	0	13	0	0
11	25615946	.	A	T	3	2	5	0	0	5	0	0
11	25616465	.	A	C	4	3	7	0	2	9	0	0
11	25616642	.	T	C	5	4	9	0	0	9	0	0
11	25616679	.	T	A	5	4	9	0	1	10	0	0
11	25616719	.	G	A	3	4	7	0	0	7	0	0
11	25617023	.	T	A	5	4	9	0	0	10	1	0
11	25617027	.	C	A	6	4	10	0	0	10	0	0
11	25617096	.	T	C	3	4	7	0	0	7	0	0
11	25617118	.	A	G	3	6	9	0	1	10	0	0
11	25617433	.	A	C	11	2	13	0	0	13	0	0
11	25617437	.	T	C	11	3	14	0	1	15	0	0
11	25617497	.	G	A	6	4	10	0	0	10	0	0
11	25617900	.	C	T	5	9	14	0	2	16	0	0
11	25618037	.	T	C	6	4	10	0	0	10	0	0
11	25618094	.	G	A	0	10	10	0	8	18	0	0
11	25618127	.	T	C	9	11	20	0	1	21	0	0
11	25618297	.	A	C	5	4	9	0	3	12	0	0
11	25618353	.	T	A	6	10	16	0	1	17	0	0
11	25631296	.	A	G	2	2	4	0	0	4	0	0
11	25668671	.	G	A	0	3	3	0	2	5	0	0
11	25671502	.	A	G	2	2	4	0	1	5	0	0
11	25671523	.	C	T	3	3	6	0	1	7	0	0
11	25675599	.	A	G	3	6	9	0	1	10	0	0
11	25678397	.	T	C	3	6	9	0	0	9	0	0
11	25678596	.	T	A	4	5	9	0	3	12	0	0
11	25678793	.	C	T	3	1	4	0	2	6	0	0
11	25678841	.	G	T	2	3	5	0	0	5	0	0
11	25678971	.	T	A	4	6	10	0	0	10	0	0
11	25681594	.	C	T	5	9	14	0	0	14	0	0
11	25681602	.	C	A	4	8	12	0	1	13	0	0
11	25684562	.	C	A	4	2	6	0	0	6	0	0
11	25686079	.	T	A	4	11	15	0	1	16	0	0
11	25689233	.	G	C	0	5	5	0	0	5	0	0
11	25689561	.	T	A	3	2	5	0	0	5	0	0
11	25693884	.	C	A	1	2	3	0	0	3	0	0
11	25695436	.	G	A	0	2	2	0	0	2	0	0
11	25695871	.	G	A	1	2	3	0	0	3	0	0
11	25698776	.	G	C	1	2	3	0	1	4	0	0
11	25698926	.	G	A	3	2	5	0	0	5	0	0
11	25699346	.	C	T	3	3	6	0	0	6	0	0
11	25699505	.	C	A	3	1	4	0	0	4	0	0
11	25702397	.	C	T	3	5	8	0	1	9	0	0
11	25705225	.	C	T	8	5	13	0	0	13	0	0
11	25707869	.	G	T	0	6	6	0	6	12	0	0
11	25708008	.	A	G	5	8	13	0	0	13	0	0
11	25708678	.	G	C	3	3	6	0	0	6	0	0
11	25712952	.	T	G	4	3	7	0	0	7	0	0
11	25713124	.	T	A	4	6	10	0	0	10	0	0
11	25713526	.	A	G	4	8	12	0	0	12	0	0
11	25713683	.	G	A	7	3	10	0	1	11	0	0
11	25713820	.	T	C	5	8	13	0	1	14	0	0
11	25714441	.	C	A	2	6	8	0	0	8	0	0
11	25718054	.	C	T	0	4	4	0	5	9	0	0
11	25718179	.	C	T	3	3	6	0	0	6	0	0
11	25718194	.	C	T	4	3	7	0	1	8	0	0
11	25721865	.	C	T	4	2	6	0	1	7	0	0
11	25723425	.	C	T	0	5	5	0	2	7	0	0
11	25723434	.	G	A	3	5	8	0	0	8	0	0
11	25749736	.	G	A	9	6	15	0	1	16	0	0
11	25749826	.	A	C	6	10	16	0	2	18	0	0
11	25750003	.	G	A	7	3	10	0	1	11	0	0
11	25750008	.	A	G	5	2	7	0	2	9	0	0
11	25783118	.	C	T	0	6	6	0	4	10	0	0
11	25783353	.	T	A	2	5	7	0	0	7	0	0
11	25783435	.	T	G	6	7	13	0	1	14	0	0
11	25789218	.	A	G	3	5	8	0	0	8	0	0
11	25866443	.	A	T	3	5	8	0	1	9	0	0
11	25868801	.	C	T	0	4	4	0	0	4	0	0
11	25871408	.	G	A	4	0	4	0	1	5	0	0
11	25887514	.	G	A	1	0	1	0	0	1	0	0
11	25893627	.	C	T	2	5	7	0	0	7	0	0
11	25893943	.	A	G	4	1	5	0	0	5	0	0
11	26190876	.	C	A	4	5	9	0	0	9	0	0
11	26191029	.	G	A	6	3	9	0	1	10	0	0
11	26191901	.	A	T	6	5	11	0	0	11	0	0
11	26192852	.	C	T	0	4	4	0	2	6	0	0
11	26193071	.	G	A	2	2	4	0	0	4	0	0
11	26194289	.	C	A	5	4	9	0	0	9	0	0
11	26195300	.	T	C	1	2	3	0	0	3	0	0
11	26229464	.	C	A	22	23	45	0	3	48	0	0
11	26229809	.	T	C	15	16	31	0	1	32	0	0
11	26230302	.	G	A	7	11	18	0	2	20	0	0
11	26230756	.	T	G	6	5	11	0	0	11	0	0
11	26230847	.	C	T	7	5	12	0	1	13	0	0
11	26230972	.	A	G	6	8	14	0	0	14	0	0
11	26233522	.	A	T	2	2	4	0	0	4	0	0
11	26366792	.	A	G	0	0	0	0	3	3	0	0
11	26366806	.	G	A	0	2	2	0	2	4	0	0
11	26370780	.	A	G	4	4	8	0	1	9	0	0
11	26370804	.	G	A	2	3	5	0	1	6	0	0
11	26371212	.	G	T	1	1	2	0	0	2	0	0
11	26371216	.	C	T	1	1	2	0	0	2	0	0
11	26376034	.	G	T	3	3	6	0	0	6	0	0
11	26380197	.	C	A	1	3	4	0	0	4	0	0
11	26380938	.	G	A	3	3	6	0	0	6	0	0
11	26380977	.	G	A	3	2	5	0	0	5	0	0
11	26382578	.	T	A	9	4	13	0	0	13	0	0
11	26382756	.	T	C	8	14	22	0	1	23	0	0
11	26383120	.	T	C	5	4	9	0	0	9	0	0
11	26390309	.	T	C	1	3	4	0	0	4	0	0
11	26391453	.	A	G	0	1	1	0	2	3	0	0
11	26396408	.	T	C	0	0	0	0	1	1	0	0
11	26398057	.	T	A	3	0	3	0	0	3	0	0
11	26400782	.	G	C	4	5	9	0	0	9	0	0
11	26400817	.	G	T	7	6	13	0	0	13	0	0
11	26400841	.	T	C	4	5	9	0	2	11	0	0
11	26400916	.	C	T	9	5	14	0	1	15	0	0
11	26401179	.	G	A	1	3	4	0	0	4	0	0
11	26401248	.	G	T	2	4	6	0	0	6	0	0
11	26401413	.	C	T	3	5	8	0	3	11	0	0
11	26614389	.	T	C	4	3	7	0	0	7	0	0
11	26614487	.	G	T	17	37	54	0	3	57	0	0
11	26614649	.	A	G	25	1	26	0	25	51	0	0
11	26614713	.	C	A	25	19	44	0	2	46	0	0
11	26614718	.	G	A	3	16	19	0	24	43	0	0
11	26614755	.	C	A	15	10	25	0	4	29	0	0
11	26614910	.	C	T	16	25	41	0	5	46	0	0
11	26615112	.	T	G	17	11	28	0	1	29	0	0
11	26615201	.	A	G	23	24	47	0	4	51	0	0
11	26615425	.	T	C	21	21	42	0	1	43	0	0
11	26683250	.	C	T	6	7	13	0	0	13	0	0
11	26696630	.	G	A	0	1	1	0	0	1	0	0
11	26705105	.	T	C	11	13	24	0	1	25	0	0
11	26705111	.	G	A	12	14	26	0	1	27	0	0
11	26705239	.	C	A	21	11	32	0	2	34	0	0
11	26705540	.	G	A	5	8	13	0	0	13	0	0
11	26705738	.	G	T	10	14	24	0	0	24	0	0
11	26705851	.	C	A	0	8	8	0	6	14	0	0
11	26705898	.	T	C	2	6	8	0	2	10	0	0
11	26706015	.	G	A	9	2	11	0	0	11	0	0
11	26706124	.	A	T	12	6	18	0	0	18	0	0
11	26706522	.	A	G	8	14	22	0	0	22	0	0
11	26706789	.	C	T	5	5	10	0	0	10	0	0
11	26706862	.	A	C	13	7	20	0	0	20	0	0
11	26707110	.	T	C	3	7	10	0	0	10	0	0
11	26707152	.	A	C	4	0	4	0	5	9	0	0
11	26707162	.	G	A	1	5	6	0	2	8	0	0
11	26707325	.	T	C	5	0	5	0	16	21	0	0
11	26707367	.	C	A	0	6	6	0	17	23	0	0
11	26714379	.	C	T	3	6	9	0	1	10	0	0
11	26715590	.	C	T	4	6	10	0	0	10	0	0
11	26722167	.	A	G	0	1	1	0	0	1	0	0
11	26739994	.	T	G	4	2	6	0	0	6	0	0
11	26740022	.	T	C	3	4	7	0	0	7	0	0
11	26740279	.	G	T	2	2	4	0	0	4	0	0
11	26740784	.	A	G	2	2	4	0	0	4	0	0
11	27195745	.	A	T	3	1	4	0	0	4	0	0
11	27197358	.	T	G	0	4	4	0	0	4	0	0
11	27197359	.	T	G	0	3	3	0	1	4	0	0
11	27197395	.	G	A	0	3	3	0	0	3	0	0
11	27487296	.	T	C	1	2	3	0	0	3	0	0
11	27487368	.	T	A	5	3	8	0	0	8	0	0
11	27487411	.	A	G	10	7	17	0	0	17	0	0
11	27487557	.	G	T	6	6	12	0	0	12	0	0
11	27488369	.	G	C	3	2	5	0	1	6	0	0
11	27488669	.	G	A	1	2	3	0	0	3	0	0
11	27516861	.	C	T	0	2	2	0	2	4	0	0
11	27516891	.	C	T	0	2	2	0	4	6	0	0
11	27526278	.	A	G	1	3	4	0	0	4	0	0
11	27644826	.	A	G	2	10	12	0	1	13	0	0
11	27645617	.	T	G	8	7	15	0	1	16	0	0
11	27645740	.	A	T	6	6	12	0	3	15	0	0
11	27645764	.	A	T	4	7	11	0	1	12	0	0
11	27646115	.	G	T	2	4	6	0	1	7	0	0
11	27646172	.	T	C	3	6	9	0	0	9	0	0
11	27646210	.	G	C	4	12	16	0	1	17	0	0
11	27646298	.	A	G	3	10	13	0	1	14	0	0
11	27646681	.	C	T	6	7	13	0	0	13	0	0
11	27649329	.	A	G	1	4	5	0	0	5	0	0
11	27649343	.	A	G	1	5	6	0	0	6	0	0
11	27649454	.	G	A	7	11	18	0	2	20	0	0
11	27652623	.	C	T	0	2	2	0	3	5	0	0
11	27652641	.	G	A	3	2	5	0	0	5	0	0
11	27655732	.	A	G	6	4	10	0	0	10	0	0
11	27655774	.	C	T	0	5	5	0	5	10	0	0
11	27655855	.	T	A	9	6	15	0	0	15	0	0
11	27705215	.	T	A	14	10	24	0	0	24	0	0
11	27705660	.	C	A	8	6	14	0	3	17	0	0
11	27705762	.	C	T	7	6	13	0	0	13	0	0
11	27706060	.	G	A	6	16	22	0	0	22	0	0
11	27706441	.	T	C	3	0	3	0	7	10	0	0
11	27710443	.	C	T	4	4	8	0	0	8	0	0
11	27713663	.	C	T	3	0	3	0	0	3	0	0
11	27721515	.	T	G	1	1	2	0	0	2	0	0
11	27727592	.	G	A	0	0	0	0	1	1	0	0
11	27743644	.	C	A	1	3	4	0	0	4	0	0
11	27743924	.	G	A	4	2	6	0	0	6	0	0
11	27746240	.	C	A	2	2	4	0	0	4	0	0
11	27817597	.	T	G	0	2	2	0	1	3	0	0
11	27817636	.	C	G	0	4	4	0	1	5	0	0
11	27817706	.	T	A	4	4	8	0	1	9	0	0
11	27818188	.	G	C	8	9	17	0	1	18	0	0
11	27818239	.	T	C	11	7	18	0	0	18	0	0
11	27818343	.	G	C	6	4	10	0	0	10	0	0
11	27818393	.	C	G	2	3	5	0	0	5	0	0
11	27818521	.	C	A	8	6	14	0	1	15	0	0
11	27818722	.	T	C	10	11	21	0	1	22	0	0
11	27820698	.	C	G	1	2	3	0	1	4	0	0
11	27820992	.	C	T	0	3	3	0	2	5	0	0
11	27828950	.	T	A	15	19	34	0	2	36	0	0
11	27829089	.	C	T	2	21	23	0	16	39	0	0
11	27829157	.	T	C	20	11	31	0	2	33	0	0
11	27829201	.	A	G	18	16	34	0	0	34	0	0
11	27829222	.	C	T	0	11	11	0	24	35	0	0
11	27829264	.	G	A	14	11	25	0	1	26	0	0
11	27829402	.	A	G	4	2	6	1	0	7	0	0
11	27829555	.	G	A	5	9	14	0	1	15	0	0
11	27829592	.	A	G	10	7	17	0	0	17	0	0
11	27829700	.	T	C	15	0	15	0	13	28	0	0
11	27829702	.	T	C	13	12	25	0	3	28	0	0
11	27835372	.	C	A	0	2	2	0	0	2	0	0
11	27838670	.	C	T	11	7	18	0	2	20	0	0
11	27840160	.	A	G	3	1	4	0	0	4	0	0
11	27842815	.	G	A	5	5	10	0	1	11	0	0
11	27843024	.	A	G	3	1	4	0	0	4	0	0
11	27845701	.	A	G	0	0	0	0	1	1	0	0
11	27847409	.	C	T	13	5	18	0	0	18	0	0
11	27857379	.	A	G	9	5	14	0	0	14	0	0
11	27861878	.	A	T	1	0	1	0	0	1	0	0
11	27866392	.	T	C	1	3	4	0	0	4	0	0
11	27997754	.	G	T	1	0	1	0	0	1	0	0
11	28009874	.	C	T	3	4	7	0	0	7	0	0
11	28009889	.	T	C	3	5	8	0	0	8	0	0
11	28010115	.	A	T	3	2	5	0	0	5	0	0
11	28110132	.	T	G	1	0	1	0	2	3	0	0
11	28110135	.	C	A	1	2	3	0	0	3	0	0
11	28110342	.	A	G	0	1	1	0	0	1	0	0
11	28124712	.	T	A	2	1	3	0	1	4	0	0
11	28124715	.	C	A	2	2	4	0	0	4	0	0
11	28124776	.	C	T	1	3	4	0	0	4	0	0
11	28419351	.	G	A	0	2	2	0	5	7	0	0
11	28420264	.	T	G	3	0	3	0	6	9	0	0
11	28420880	.	T	C	2	2	4	0	0	4	0	0
11	28421115	.	T	G	7	3	10	0	0	10	0	0
11	28422263	.	T	C	1	3	4	0	1	5	0	0
11	28422273	.	C	T	2	3	5	0	1	6	0	0
11	28422662	.	C	A	9	5	14	0	3	17	0	0
11	28422836	.	G	T	2	5	7	0	11	18	0	0
11	28422854	.	G	A	2	4	6	0	10	16	0	0
11	28423061	.	C	T	5	12	17	0	1	18	0	0
11	28423064	.	T	A	6	9	15	0	3	18	0	0
11	28423137	.	A	G	6	1	7	0	5	12	0	0
11	28423325	.	C	T	7	6	13	0	0	13	0	0
11	28423628	.	A	T	9	16	25	0	1	26	0	0
11	28424012	.	C	T	10	8	18	0	3	21	0	0
11	28478026	.	T	C	4	2	6	0	0	6	0	0
11	28513792	.	A	G	3	6	9	0	2	11	0	0
11	28513960	.	T	C	3	4	7	0	0	7	0	0
11	28514058	.	G	T	2	2	4	0	1	5	0	0
11	28514089	.	T	C	1	3	4	0	0	4	0	0
11	28514307	.	T	G	3	4	7	0	0	7	0	0
11	28514747	.	A	T	1	3	4	0	1	5	0	0
11	28590985	.	G	C	2	5	7	0	1	8	0	0
11	28597526	.	G	A	2	2	4	0	2	6	0	0
11	28614554	.	T	A	1	2	3	0	0	3	0	0
11	28643064	.	G	T	22	17	39	0	5	44	0	0
11	28643141	.	G	A	22	24	46	0	4	50	0	0
11	28643155	.	G	A	25	22	47	0	1	48	0	0
11	28661028	.	A	G	8	10	18	0	0	18	0	0
11	29331516	.	T	C	1	5	6	0	0	6	0	0
11	29331532	.	A	G	1	5	6	0	3	9	0	0
11	29331609	.	T	C	5	6	11	0	0	11	0	0
11	29331695	.	A	G	5	7	12	0	0	12	0	0
11	29331854	.	T	C	7	5	12	0	0	12	0	0
11	29331915	.	T	A	3	3	6	0	0	6	0	0
11	29332600	.	A	G	3	2	5	0	0	5	0	0
11	29575177	.	T	A	22	15	37	0	3	40	0	0
11	29575390	.	G	A	19	22	41	0	2	43	0	0
11	29575736	.	C	A	21	13	34	0	2	36	0	0
11	29575964	.	G	A	10	13	23	0	1	24	0	0
11	29576022	.	A	C	6	18	24	0	1	25	0	0
11	29576213	.	G	T	13	4	17	0	0	17	0	0
11	29576599	.	T	C	3	2	5	0	0	5	0	0
11	29577198	.	T	A	15	6	21	0	0	21	0	0
11	29577230	.	C	T	19	7	26	0	0	26	0	0
11	29577566	.	C	T	6	9	15	0	0	15	0	0
11	29577598	.	T	C	5	0	5	0	16	21	0	0
11	29577651	.	A	T	9	3	12	0	0	12	0	0
11	29577762	.	C	A	9	11	20	0	1	21	0	0
11	29577849	.	T	A	1	10	11	0	2	13	0	0
11	29577861	.	T	A	1	12	13	0	0	13	0	0
11	29577890	.	G	A	5	7	12	0	1	13	0	0
11	29577927	.	T	G	5	3	8	0	0	8	0	0
11	29578070	.	C	T	0	10	10	0	8	18	0	0
11	29578091	.	C	T	8	11	19	0	1	20	0	0
11	29578133	.	T	C	9	0	9	0	4	13	0	0
11	29578139	.	A	G	9	1	10	0	2	12	0	0
11	29578217	.	G	T	5	9	14	0	0	14	0	0
11	29578265	.	G	A	1	3	4	0	0	4	0	0
11	29581774	.	T	C	7	1	8	0	5	13	0	0
11	29581828	.	A	G	3	0	3	0	0	3	0	0
11	29584517	.	G	A	5	8	13	0	0	13	0	0
11	29587885	.	A	G	2	4	6	0	2	8	0	0
11	29587963	.	C	T	4	6	10	0	0	10	0	0
11	29589186	.	T	A	8	6	14	0	1	15	0	0
11	29589370	.	C	T	0	1	1	0	0	1	0	0
11	29593372	.	T	C	2	0	2	0	0	2	0	0
11	29596227	.	A	G	2	2	4	0	0	4	0	0
11	29652547	.	A	G	3	2	5	0	0	5	0	0
11	29652586	.	C	A	5	1	6	0	2	8	0	0
11	29652838	.	T	C	7	13	20	0	1	21	0	0
11	29655418	.	C	T	16	18	34	0	4	38	0	0
11	29657818	.	T	A	1	2	3	0	0	3	0	0
11	29685328	.	C	T	3	2	5	0	0	5	0	0
11	29762946	.	G	A	7	8	15	0	1	16	0	0
11	29917881	.	A	T	4	3	7	0	2	9	0	0
11	29918069	.	T	C	2	6	8	1	1	10	0	0
11	29918070	.	T	C	1	8	9	1	0	10	0	0
11	29918161	.	T	C	4	3	7	0	5	12	0	0
11	29918168	.	T	C	3	10	13	0	0	13	0	0
11	30147877	.	G	A	1	2	3	0	0	3	0	0
11	30149775	.	C	A	3	2	5	0	0	5	0	0
11	30205707	.	C	A	2	1	3	0	0	3	0	0
11	30219477	.	G	A	1	7	8	0	9	17	0	0
11	30219663	.	T	C	11	12	23	0	1	24	0	0
11	30221173	.	A	G	6	0	6	0	8	14	0	0
11	30221188	.	A	G	6	8	14	0	1	15	0	0
11	30222912	.	T	C	0	5	5	0	0	5	0	0
11	30222942	.	G	A	3	10	13	0	0	13	0	0
11	30222963	.	G	A	0	10	10	0	6	16	0	0
11	30642364	.	A	T	1	2	3	0	0	3	0	0
11	31024887	.	A	G	6	4	10	0	2	12	0	0
11	31668176	.	A	G	2	3	5	0	0	5	0	0
11	33846497	.	T	C	9	5	14	0	0	14	0	0
11	33846519	.	T	C	7	4	11	0	1	12	0	0
11	33846566	.	T	C	3	4	7	0	0	7	0	0
11	34780009	.	T	C	5	2	7	0	10	17	0	0
11	34899393	.	A	G	0	1	1	0	0	1	0	0
11	34907726	.	T	A	1	6	7	0	0	7	0	0
11	34908187	.	G	C	2	2	4	0	0	4	0	0
11	34908201	.	C	T	2	2	4	0	0	4	0	0
11	34908431	.	G	A	1	3	4	0	0	4	0	0
11	34908448	.	T	A	5	3	8	0	0	8	0	0
11	34909288	.	G	T	0	4	4	0	1	5	0	0
11	34909489	.	A	G	2	2	4	0	0	4	0	0
11	34909868	.	C	T	4	2	6	0	1	7	0	0
11	34910468	.	T	C	2	6	8	0	0	8	0	0
11	34910487	.	T	C	3	5	8	0	0	8	0	0
11	34910503	.	C	T	2	5	7	0	0	7	0	0
11	34910867	.	T	A	6	2	8	0	0	8	0	0
11	34910897	.	A	G	7	11	18	0	0	18	0	0
11	34911192	.	A	G	0	1	1	0	1	2	0	0
11	34911445	.	A	G	8	12	20	0	0	20	0	0
11	34911451	.	T	A	8	11	19	0	0	19	0	0
11	34912481	.	G	A	13	14	27	0	1	28	0	0
11	34912616	.	G	A	8	21	29	0	1	30	0	0
11	34912850	.	G	A	13	7	20	0	1	21	0	0
11	34913101	.	C	A	7	9	16	0	3	19	0	0
11	34914190	.	G	A	17	16	33	0	7	40	0	0
11	35034669	.	G	A	6	7	13	0	0	13	0	0
11	35038124	.	G	C	0	4	4	0	11	15	0	0
11	35440173	.	T	A	6	1	7	0	0	7	0	0
11	36214517	.	C	T	16	4	20	0	1	21	0	0
11	36214601	.	G	A	0	8	8	0	7	15	0	0
11	36214815	.	G	A	0	12	12	0	9	21	0	0
11	36215346	.	G	A	17	10	27	0	2	29	0	0
11	36215459	.	A	G	12	8	20	0	3	23	0	0
11	36215584	.	G	C	4	5	9	0	1	10	0	0
11	36224767	.	G	A	0	3	3	0	0	3	0	0
11	36258951	.	A	G	8	3	11	0	0	11	0	0
11	36263954	.	A	G	1	0	1	0	1	2	0	0
11	36269682	.	G	A	2	2	4	0	0	4	0	0
11	36269768	.	A	G	0	3	3	0	1	4	0	0
11	36281881	.	A	G	8	4	12	0	4	16	0	0
11	36281939	.	T	G	2	6	8	0	0	8	0	0
11	36281943	.	G	A	1	6	7	0	1	8	0	0
11	36282081	.	A	T	10	8	18	0	0	18	0	0
11	36282259	.	A	T	6	2	8	0	1	9	0	0
11	36282361	.	A	C	1	4	5	0	1	6	0	0
11	36282494	.	G	T	4	6	10	0	0	10	0	0
11	36282501	.	C	T	5	5	10	0	1	11	0	0
11	36343167	.	G	C	22	21	43	0	1	44	0	0
11	36347775	.	C	T	0	4	4	0	0	4	0	0
11	36689027	.	C	T	0	3	3	0	3	6	0	0
11	36689068	.	T	C	3	4	7	0	1	8	0	0
11	36689328	.	G	C	4	2	6	0	1	7	0	0
11	36689344	.	A	G	5	2	7	0	0	7	0	0
11	36691538	.	T	A	1	1	2	0	0	2	0	0
11	36695076	.	A	G	2	2	4	0	0	4	0	0
11	36719259	.	G	A	1	0	1	0	0	1	0	0
11	36788527	.	T	A	19	10	29	0	0	29	0	0
11	36793616	.	A	C	5	2	7	0	0	7	0	0
11	36793730	.	T	G	7	5	12	0	0	12	0	0
11	36793760	.	A	C	7	4	11	0	0	11	0	0
11	36795564	.	G	T	3	2	5	0	1	6	0	0
11	36810576	.	A	G	3	3	6	0	0	6	0	0
11	37004565	.	G	A	2	1	3	0	1	4	0	0
11	37023776	.	T	C	1	0	1	0	0	1	0	0
11	37031950	.	C	T	1	4	5	0	1	6	0	0
11	37032283	.	T	A	1	0	1	0	1	2	0	0
11	37032474	.	A	G	1	2	3	0	0	3	0	0
11	37032880	.	G	T	5	7	12	0	0	12	0	0
11	37033356	.	G	T	3	5	8	0	0	8	0	0
11	37033431	.	G	A	1	2	3	0	0	3	0	0
11	37033516	.	G	A	1	4	5	0	2	7	0	0
11	37033552	.	A	G	2	0	2	0	7	9	0	0
11	37033603	.	T	A	3	5	8	0	0	8	0	0
11	37033676	.	C	T	4	5	9	0	0	9	0	0
11	37033767	.	C	T	2	3	5	0	0	5	0	0
11	37033813	.	C	G	3	6	9	0	0	9	0	0
11	37033846	.	G	C	1	6	7	0	0	7	0	0
11	37033855	.	T	A	1	5	6	0	0	6	0	0
11	37033900	.	A	T	1	7	8	0	1	9	0	0
11	37034926	.	A	G	4	3	7	0	0	7	0	0
11	37035069	.	A	C	4	13	17	0	1	18	0	0
11	37035176	.	A	T	3	5	8	0	0	8	0	0
11	37101851	.	A	T	2	2	4	0	2	6	0	0
11	37101859	.	C	T	3	2	5	0	1	6	0	0
11	37155394	.	A	G	3	1	4	0	2	6	0	0
11	37158947	.	C	A	1	1	2	0	1	3	0	0
11	37159977	.	A	T	2	2	4	0	0	4	0	0
11	37160052	.	T	A	2	3	5	0	0	5	0	0
11	37162183	.	A	G	2	1	3	0	0	3	0	0
11	37163760	.	T	C	3	4	7	0	1	8	0	0
11	37163997	.	T	A	4	6	10	0	0	10	0	0
11	37164456	.	G	A	6	5	11	0	2	13	0	0
11	37167402	.	A	G	2	0	2	0	5	7	0	0
11	37167603	.	A	G	5	3	8	0	0	8	0	0
11	37167669	.	C	T	3	5	8	0	0	8	0	0
11	37167699	.	A	T	2	6	8	0	0	8	0	0
11	37168039	.	A	T	5	3	8	0	0	8	0	0
11	37169882	.	T	G	0	1	1	0	0	1	0	0
11	37170109	.	T	C	3	2	5	0	0	5	0	0
11	37273526	.	T	G	1	2	3	0	0	3	0	0
11	37273561	.	T	G	1	2	3	0	0	3	0	0
11	37273562	.	A	T	1	2	3	0	0	3	0	0
11	37274880	.	G	T	1	2	3	0	0	3	0	0
11	37297678	.	C	T	21	8	29	1	2	32	0	0
11	37297681	.	A	G	17	9	26	1	4	34	3	0
11	37297811	.	A	T	27	21	48	0	2	50	0	0
11	37298499	.	C	T	22	14	36	0	0	36	0	0
11	37298569	.	A	G	26	13	39	0	4	43	0	0
11	37298755	.	G	A	11	17	28	0	1	29	0	0
11	37298882	.	G	A	23	12	35	0	1	36	0	0
11	37299378	.	A	T	23	7	30	0	2	32	0	0
11	37431953	.	C	T	31	23	54	0	2	56	0	0
11	37434533	.	A	G	11	17	28	0	3	31	0	0
11	37440957	.	A	C	19	17	36	0	1	37	0	0
11	37440990	.	A	G	21	20	41	0	0	41	0	0
11	37441021	.	G	A	14	22	36	0	5	41	0	0
11	37441053	.	C	G	1	15	16	0	20	36	0	0
11	37441086	.	A	G	18	18	36	0	0	36	0	0
11	37441257	.	T	G	16	20	36	0	5	41	0	0
11	37442134	.	G	A	9	7	16	0	0	16	0	0
11	37442671	.	G	A	4	3	7	0	1	8	0	0
11	37442752	.	C	G	8	9	17	0	0	17	0	0
11	37442772	.	G	T	7	6	13	0	0	13	0	0
11	37445219	.	A	G	10	4	14	0	2	16	0	0
11	37445327	.	G	A	7	9	16	0	0	16	0	0
11	37445680	.	C	T	2	2	4	0	0	4	0	0
11	37445774	.	G	A	1	2	3	0	0	3	0	0
11	37448396	.	T	C	1	2	3	0	1	4	0	0
11	37449415	.	T	A	2	3	5	0	0	5	0	0
11	37451201	.	C	T	2	2	4	0	0	4	0	0
11	37613515	.	G	A	6	5	11	0	0	11	0	0
11	37613572	.	C	T	7	10	17	0	2	19	0	0
11	37613633	.	G	A	0	10	10	0	11	21	0	0
11	37613641	.	A	G	11	9	20	0	0	20	0	0
11	37616372	.	T	A	5	5	10	0	1	11	0	0
11	37622121	.	G	T	1	3	4	0	0	4	0	0
11	37628230	.	C	T	21	32	53	0	3	56	0	0
11	37628595	.	T	C	27	11	38	0	3	41	0	0
11	37628816	.	T	C	11	23	34	0	3	37	0	0
11	37628831	.	C	T	13	23	36	0	2	38	0	0
11	37628863	.	T	A	16	23	39	0	1	40	0	0
11	37629046	.	G	A	17	24	41	0	3	44	0	0
11	37709119	.	C	T	12	6	18	0	0	18	0	0
11	37709133	.	G	A	6	8	14	0	1	15	0	0
11	37709222	.	C	T	6	8	14	0	2	16	0	0
11	37709359	.	C	T	5	8	13	0	3	16	0	0
11	37710333	.	T	C	1	2	3	0	0	3	0	0
11	37720622	.	C	A	12	13	25	0	3	28	0	0
11	37720658	.	G	A	15	21	36	0	1	37	0	0
11	37720671	.	A	G	13	14	27	0	0	27	0	0
11	37831034	.	T	C	4	5	9	0	1	10	0	0
11	38033520	.	A	G	1	4	5	0	0	5	0	0
11	38413037	.	G	A	1	1	2	0	0	2	0	0
11	38505453	.	T	C	6	4	10	0	0	10	0	0
11	38505781	.	A	G	7	8	15	0	1	16	0	0
11	38506404	.	A	T	1	1	2	0	1	4	1	0
11	38507042	.	C	T	0	1	1	0	2	3	0	0
11	38507918	.	A	G	2	2	4	0	1	5	0	0
11	38508592	.	T	C	1	2	3	0	0	3	0	0
11	38508605	.	G	A	1	0	1	0	1	2	0	0
11	38509219	.	T	C	2	1	3	0	1	4	0	0
11	38509901	.	A	C	1	3	4	0	0	4	0	0
11	38540870	.	G	A	18	16	34	0	3	37	0	0
11	38541063	.	T	A	15	20	35	0	3	38	0	0
11	38541100	.	A	C	14	19	33	0	1	34	0	0
11	38541371	.	T	C	12	0	12	0	21	33	0	0
11	38541401	.	C	G	11	15	26	0	0	26	0	0
11	38541484	.	A	G	11	9	20	0	1	21	0	0
11	38541708	.	A	C	10	7	17	0	4	21	0	0
11	38542003	.	G	A	21	6	27	0	4	31	0	0
11	38542088	.	A	T	12	9	21	0	5	26	0	0
11	38542171	.	G	T	9	11	20	0	2	22	0	0
11	38542218	.	G	A	11	9	20	0	2	22	0	0
11	38542305	.	C	T	19	17	36	0	0	36	0	0
11	38542308	.	G	A	17	16	33	0	2	35	0	0
11	38542655	.	T	C	10	0	10	0	17	27	0	0
11	38545826	.	G	T	14	6	20	0	0	20	0	0
11	38545874	.	C	G	0	23	23	0	13	36	0	0
11	38846046	.	C	T	2	4	6	0	0	6	0	0
11	38846316	.	T	A	2	5	7	0	0	7	0	0
11	38850244	.	G	A	0	2	2	0	7	9	0	0
11	38853397	.	A	T	1	2	3	0	0	3	0	0
11	38853511	.	A	G	3	2	5	0	0	5	0	0
11	38868012	.	G	T	7	1	8	0	1	9	0	0
11	38874937	.	G	A	21	20	41	0	3	44	0	0
11	38875221	.	A	G	16	16	32	0	2	34	0	0
11	38875283	.	A	T	8	24	32	0	1	33	0	0
11	38875352	.	G	A	15	17	32	0	1	33	0	0
11	38875397	.	T	G	17	3	20	0	3	23	0	0
11	38875484	.	A	C	13	20	33	0	3	36	0	0
11	38875498	.	C	A	15	14	29	0	1	30	0	0
11	38875660	.	T	C	20	17	37	0	1	38	0	0
11	38875867	.	T	C	1	11	12	0	2	14	0	0
11	38875897	.	T	C	1	6	7	0	1	8	0	0
11	38875912	.	A	G	1	5	6	0	1	7	0	0
11	39014553	.	G	A	4	7	11	0	1	12	0	0
11	39044451	.	T	A	2	2	4	0	0	4	0	0
11	39076138	.	C	T	0	3	3	0	6	9	0	0
11	39107156	.	C	T	2	2	4	0	0	4	0	0
11	39109555	.	C	T	4	3	7	0	0	7	0	0
11	39110046	.	C	T	2	0	2	0	0	2	0	0
11	39112035	.	A	G	8	7	15	0	0	15	0	0
11	39112068	.	C	T	6	7	13	0	1	14	0	0
11	39135393	.	C	T	0	2	2	0	0	2	0	0
11	39141527	.	A	G	28	19	47	0	4	51	0	0
11	39141732	.	T	G	11	8	19	0	0	19	0	0
11	39141924	.	G	T	6	11	17	0	0	17	0	0
11	39147065	.	T	C	13	14	27	0	0	27	0	0
11	39147085	.	C	T	12	11	23	0	1	24	0	0
11	39147387	.	T	C	12	7	19	0	3	22	0	0
11	39147445	.	G	C	22	11	33	0	2	35	0	0
11	39147857	.	G	C	13	14	27	0	6	33	0	0
11	39147905	.	C	A	12	15	27	0	1	28	0	0
11	39147906	.	A	T	12	15	27	0	1	28	0	0
11	39147989	.	T	C	31	7	38	0	10	48	0	0
11	39148015	.	C	T	19	14	33	0	8	41	0	0
11	39168309	.	T	C	3	2	5	0	0	5	0	0
11	39168313	.	G	C	3	2	5	0	0	5	0	0
11	39877711	.	C	T	1	3	4	0	0	4	0	0
11	39878503	.	C	A	4	2	6	0	0	6	0	0
11	39878515	.	G	T	0	2	2	0	4	6	0	0
11	39878740	.	G	A	2	2	4	0	0	4	0	0
11	39878788	.	T	A	3	2	5	0	0	5	0	0
11	39879242	.	C	A	1	1	2	0	2	4	0	0
11	39905164	.	C	T	5	3	8	0	3	11	0	0
11	39906110	.	C	T	6	4	10	0	1	11	0	0
11	39907585	.	G	A	1	2	3	0	0	3	0	0
11	39907618	.	C	G	4	2	6	0	0	6	0	0
11	39908020	.	T	G	5	4	9	0	1	10	0	0
11	39916450	.	G	A	0	1	1	0	0	1	0	0
11	39922402	.	G	A	0	20	20	0	4	24	0	0
11	39922407	.	G	A	4	16	20	0	2	22	0	0
11	39922714	.	A	C	10	7	17	0	0	17	0	0
11	39923551	.	T	A	14	17	31	0	0	31	0	0
11	39923653	.	C	T	8	11	19	0	4	23	0	0
11	39924083	.	A	T	11	19	30	0	3	33	0	0
11	39924235	.	G	C	17	5	22	0	0	22	0	0
11	39924243	.	G	T	14	5	19	0	3	22	0	0
11	39924341	.	C	G	9	13	22	0	0	22	0	0
11	39924358	.	T	C	6	12	18	0	3	21	0	0
11	39924413	.	G	A	16	5	21	0	2	23	0	0
11	39924639	.	C	T	12	13	25	0	2	27	0	0
11	39924652	.	C	T	10	12	22	0	8	30	0	0
11	39924711	.	A	T	11	18	29	0	2	31	0	0
11	39924736	.	A	G	10	14	24	0	3	27	0	0
11	39924783	.	T	A	13	12	25	0	2	27	0	0
11	39924784	.	A	T	13	13	26	0	1	27	0	0
11	39924929	.	G	A	5	5	10	0	1	11	0	0
11	39924946	.	C	T	8	7	15	0	1	16	0	0
11	39924989	.	G	T	17	11	28	0	0	28	0	0
11	39924999	.	C	T	10	18	28	0	3	31	0	0
11	39925225	.	C	A	16	21	37	0	0	37	0	0
11	39925458	.	G	A	17	14	31	0	1	32	0	0
11	39925529	.	C	T	20	16	36	0	3	39	0	0
11	39926041	.	C	T	22	16	38	0	0	38	0	0
11	39926216	.	A	G	11	15	26	0	0	26	0	0
11	39953921	.	C	T	8	3	11	0	3	14	0	0
11	39954026	.	T	G	12	6	18	0	0	18	0	0
11	39954319	.	G	A	0	3	3	0	9	12	0	0
11	39985311	.	A	G	1	2	3	0	0	3	0	0
11	40002228	.	T	G	2	2	4	0	0	4	0	0
11	40004887	.	C	A	0	1	1	0	0	1	0	0
11	40009040	.	T	C	3	2	5	0	1	6	0	0
11	40014346	.	G	A	4	3	7	0	0	7	0	0
11	40015113	.	G	A	4	4	8	0	0	8	0	0
11	40015380	.	C	G	4	3	7	0	0	7	0	0
11	40015529	.	T	C	3	3	6	0	0	6	0	0
11	40015537	.	G	A	3	3	6	0	0	6	0	0
11	40015797	.	A	G	1	2	3	0	1	4	0	0
11	40015849	.	A	C	4	3	7	0	0	7	0	0
11	40016032	.	A	G	4	3	7	0	1	8	0	0
11	40016524	.	G	A	0	4	4	0	2	6	0	0
11	40016528	.	T	C	3	4	7	0	0	7	0	0
11	40016649	.	A	C	4	4	8	0	0	8	0	0
11	40017183	.	G	T	5	3	8	0	0	8	0	0
11	40017290	.	G	C	5	4	9	0	0	9	0	0
11	40017333	.	A	T	4	2	6	0	0	6	0	0
11	40017501	.	A	T	3	5	8	0	0	8	0	0
11	40017504	.	T	A	3	5	8	0	0	8	0	0
11	40017604	.	T	C	4	7	11	0	1	12	0	0
11	40017698	.	T	C	5	5	10	0	0	10	0	0
11	40017829	.	A	G	5	7	12	0	0	12	0	0
11	40017865	.	T	A	2	4	6	0	0	6	0	0
11	40017885	.	G	A	2	4	6	0	0	6	0	0
11	40017949	.	A	T	2	4	6	0	1	7	0	0
11	40017994	.	T	C	5	8	13	0	3	16	0	0
11	40018042	.	T	C	10	10	20	0	1	21	0	0
11	40018633	.	G	A	6	9	15	0	1	16	0	0
11	40018668	.	A	T	7	10	17	0	0	17	0	0
11	40018799	.	G	T	0	9	9	0	7	16	0	0
11	40019076	.	G	A	4	3	7	0	0	7	0	0
11	40019078	.	A	G	4	0	4	0	3	7	0	0
11	40019276	.	A	C	9	10	19	0	0	19	0	0
11	40019278	.	T	A	8	10	18	0	1	19	0	0
11	40019411	.	C	T	11	0	11	0	0	11	0	0
11	40020683	.	G	T	9	13	22	0	0	22	0	0
11	40020760	.	T	C	13	6	19	0	2	21	0	0
11	40020928	.	G	A	12	12	24	0	3	27	0	0
11	40020950	.	A	G	10	7	17	0	2	19	0	0
11	40657839	.	G	A	7	6	13	0	1	14	0	0
11	40657905	.	G	A	5	5	10	0	2	12	0	0
11	40658022	.	C	T	9	9	18	0	1	19	0	0
11	40658232	.	C	T	8	5	13	0	1	14	0	0
11	40658322	.	T	G	3	2	5	0	0	5	0	0
11	40658352	.	G	A	0	4	4	0	4	8	0	0
11	40661378	.	T	C	6	6	12	0	0	12	0	0
11	40665494	.	C	T	2	2	4	0	0	4	0	0
11	40665602	.	G	T	0	12	12	0	23	35	0	0
11	40673658	.	T	G	5	8	13	0	0	13	0	0
11	40673797	.	C	T	15	15	30	0	2	32	0	0
11	40677967	.	T	C	36	13	49	0	5	54	0	0
11	40714749	.	C	T	0	1	1	0	0	1	0	0
11	40843028	.	A	G	0	3	3	0	1	4	0	0
11	40843055	.	G	T	0	2	2	0	2	4	0	0
11	40843064	.	C	A	3	3	6	0	0	6	0	0
11	40843502	.	C	T	5	8	13	0	0	13	0	0
11	40843835	.	G	A	0	7	7	0	6	13	0	0
11	40844085	.	T	G	2	4	6	0	0	6	0	0
11	40844094	.	C	T	2	3	5	0	1	6	0	0
11	40845006	.	C	T	15	12	27	0	2	29	0	0
11	40845071	.	C	T	4	3	7	0	0	7	0	0
11	40845080	.	G	A	0	2	2	0	3	5	0	0
11	40845117	.	T	C	3	3	6	0	0	6	0	0
11	41066765	.	T	G	11	10	21	0	1	22	0	0
11	41066871	.	C	T	7	14	21	0	5	26	0	0
11	41066888	.	C	T	11	21	32	0	0	32	0	0
11	41066950	.	A	G	11	16	27	0	1	28	0	0
11	41067275	.	G	A	4	15	19	0	1	20	0	0
11	41067430	.	A	T	2	6	8	0	3	11	0	0
11	41067442	.	C	T	3	11	14	0	1	15	0	0
11	41067502	.	G	A	3	14	17	0	0	17	0	0
11	41067613	.	A	G	2	4	6	0	1	7	0	0
11	41078522	.	C	A	4	3	7	0	0	7	0	0
11	41078578	.	A	T	3	7	10	0	0	10	0	0
11	41078762	.	A	T	5	4	9	0	0	9	0	0
11	41101760	.	A	T	1	2	3	0	0	3	0	0
11	41101800	.	T	A	1	3	4	0	0	4	0	0
11	41101866	.	C	T	0	4	4	0	1	5	0	0
11	41101910	.	G	A	3	5	8	0	0	8	0	0
11	41101918	.	C	T	3	4	7	0	0	7	0	0
11	41102205	.	A	G	2	3	5	0	0	5	0	0
11	41104549	.	A	G	2	5	7	0	3	10	0	0
11	41104934	.	G	A	5	2	7	0	0	7	0	0
11	41104954	.	C	T	5	2	7	0	1	8	0	0
11	41105030	.	G	A	0	3	3	0	4	7	0	0
11	41105210	.	G	A	0	1	1	0	4	5	0	0
11	41111301	.	A	G	8	16	24	0	0	24	0	0
11	41111334	.	T	C	10	14	24	0	2	26	0	0
11	41111370	.	C	T	9	9	18	0	0	18	0	0
11	41111422	.	A	G	5	3	8	0	2	10	0	0
11	41111431	.	A	C	4	5	9	0	0	9	0	0
11	41111735	.	G	A	2	6	8	0	0	8	0	0
11	41114055	.	C	T	0	2	2	0	4	6	0	0
11	41114186	.	A	C	1	2	3	0	0	3	0	0
11	41125040	.	A	G	1	1	2	0	0	2	0	0
11	41216315	.	C	T	0	5	5	0	4	9	0	0
11	41216445	.	A	C	7	7	14	0	1	15	0	0
11	41216505	.	G	C	7	5	12	0	0	12	0	0
11	41222940	.	A	G	14	7	21	0	0	21	0	0
11	41363814	.	T	C	4	4	8	0	0	8	0	0
11	41459981	.	G	C	1	3	4	0	1	5	0	0
11	41461369	.	T	C	4	2	6	0	0	6	0	0
11	41461417	.	C	G	4	11	15	0	1	16	0	0
11	41463534	.	C	G	0	2	2	0	0	2	0	0
11	41468791	.	C	T	5	3	8	0	0	8	0	0
11	41474041	.	T	A	10	10	20	0	0	20	0	0
11	41474042	.	G	T	10	10	20	0	0	20	0	0
11	41699856	.	C	G	4	2	6	0	1	7	0	0
11	41838873	.	G	A	3	2	5	0	0	5	0	0
11	41838877	.	T	A	3	2	5	0	0	5	0	0
11	41844342	.	T	C	0	8	8	0	0	8	0	0
11	41845849	.	G	A	0	8	8	0	4	12	0	0
11	41846151	.	C	A	3	6	9	0	0	9	0	0
11	41846429	.	C	A	6	5	11	0	2	13	0	0
11	41846430	.	C	A	0	6	6	0	7	13	0	0
11	41849977	.	C	T	0	5	5	0	1	6	0	0
11	41850559	.	G	A	1	1	2	0	0	2	0	0
11	41850565	.	G	A	1	1	2	0	0	2	0	0
11	41958058	.	C	T	1	0	1	0	0	1	0	0
11	41958317	.	T	C	3	4	7	0	0	7	0	0
11	41960058	.	A	C	6	3	9	0	0	9	0	0
11	41960059	.	C	T	6	3	9	0	0	9	0	0
11	41960101	.	A	G	7	6	13	0	1	14	0	0
11	41960111	.	C	T	8	7	15	0	1	16	0	0
11	41982546	.	G	A	0	2	2	0	0	2	0	0
11	42128555	.	T	A	4	2	6	0	0	6	0	0
11	42128561	.	G	A	1	4	5	0	1	6	0	0
11	42305632	.	T	C	2	2	4	0	1	5	0	0
11	42305824	.	C	T	4	8	12	0	1	13	0	0
11	42305868	.	C	A	0	6	6	0	6	12	0	0
11	42306057	.	C	T	6	3	9	7	0	16	0	0
11	42307344	.	T	G	4	8	12	0	2	14	0	0
11	42307671	.	G	A	5	11	16	0	0	16	0	0
11	42307816	.	C	T	0	14	14	0	13	27	0	0
11	42315366	.	G	C	7	10	17	0	0	17	0	0
11	42319372	.	C	A	1	1	2	0	0	2	0	0
11	42325535	.	C	T	0	2	2	0	0	2	0	0
11	42329113	.	C	T	2	3	5	0	0	5	0	0
11	42350787	.	G	A	6	5	11	0	1	12	0	0
11	42350793	.	G	A	6	6	12	0	0	12	0	0
11	42350847	.	C	T	3	2	5	0	1	6	0	0
11	42353054	.	G	A	4	4	8	0	0	8	0	0
11	42356032	.	C	T	0	1	1	0	0	1	0	0
11	42385761	.	A	T	2	2	4	0	0	4	0	0
11	42418310	.	A	T	1	2	3	0	0	3	0	0
11	42457325	.	T	C	4	2	6	0	0	6	0	0
11	42457328	.	A	C	2	4	6	0	0	6	0	0
11	42502080	.	G	A	0	5	5	0	2	7	0	0
11	42502108	.	T	A	2	6	8	0	0	8	0	0
11	42502212	.	A	G	1	3	4	0	0	4	0	0
11	42502261	.	T	C	0	6	6	0	0	6	0	0
11	42522076	.	C	A	2	2	4	0	0	4	0	0
11	42522162	.	A	T	2	6	8	0	0	8	0	0
11	42522270	.	G	A	1	3	4	0	0	4	0	0
11	42532938	.	G	C	2	1	3	0	0	3	0	0
11	42532943	.	C	T	2	2	4	0	0	4	0	0
11	42533237	.	G	A	2	3	5	0	2	7	0	0
11	42560439	.	G	A	17	33	50	0	2	52	0	0
11	42560475	.	C	T	7	17	24	0	2	26	0	0
11	42561212	.	C	A	2	5	7	0	0	7	0	0
11	42608394	.	T	C	0	1	1	0	0	1	0	0
11	42626276	.	C	T	1	1	2	0	0	2	0	0
11	42730834	.	C	G	8	9	17	0	0	17	0	0
11	42730895	.	C	T	13	13	26	0	2	28	0	0
11	42730901	.	C	T	14	14	28	0	0	28	0	0
11	42730931	.	C	T	11	14	25	0	0	25	0	0
11	42730974	.	T	A	4	2	6	0	0	6	0	0
11	42730982	.	T	C	2	1	3	0	0	3	0	0
11	42731172	.	G	C	7	1	8	0	0	8	0	0
11	42731173	.	G	T	7	1	8	0	0	8	0	0
11	42801451	.	A	T	1	3	4	0	1	5	0	0
11	42809162	.	G	A	0	2	2	0	1	3	0	0
11	42809233	.	A	G	2	2	4	0	0	4	0	0
11	42809288	.	T	C	4	6	10	0	0	10	0	0
11	42809300	.	T	C	4	5	9	0	0	9	0	0
11	42809345	.	T	C	3	1	4	0	1	5	0	0
11	42809438	.	G	C	4	5	9	0	0	9	0	0
11	42809511	.	C	G	1	0	1	0	3	4	0	0
11	42809512	.	C	G	1	3	4	0	0	4	0	0
11	42809558	.	A	G	9	5	14	0	0	14	0	0
11	42809579	.	T	G	4	6	10	0	0	10	0	0
11	42809683	.	T	A	4	0	4	0	0	4	0	0
11	42809717	.	G	A	0	2	2	0	0	2	0	0
11	42815207	.	C	A	6	6	12	0	0	12	0	0
11	42816044	.	A	T	3	2	5	0	0	5	0	0
11	42816151	.	C	T	1	3	4	0	0	4	0	0
11	42816262	.	C	G	1	0	1	0	5	6	0	0
11	42817067	.	A	G	3	2	5	0	0	5	0	0
11	42817113	.	A	T	9	8	17	0	0	17	0	0
11	42817257	.	T	G	2	9	11	0	1	12	0	0
11	42817359	.	A	T	6	5	11	0	1	12	0	0
11	42817411	.	T	C	15	8	23	0	0	23	0	0
11	42817459	.	A	T	7	13	20	0	0	20	0	0
11	42817476	.	G	C	0	8	8	0	7	15	0	0
11	42817534	.	G	A	11	8	19	0	1	20	0	0
11	42817552	.	A	G	11	9	20	0	3	23	0	0
11	42817604	.	G	T	7	6	13	0	2	15	0	0
11	42912038	.	C	A	1	3	4	0	0	4	0	0
11	42912039	.	A	G	1	3	4	0	0	4	0	0
11	42912098	.	T	C	3	4	7	0	1	8	0	0
11	42912126	.	A	G	2	3	5	0	2	7	0	0
11	42912164	.	C	T	0	1	1	0	3	4	0	0
11	42912594	.	A	T	4	2	6	0	0	6	0	0
11	42912620	.	T	C	2	7	9	0	0	9	0	0
11	42912870	.	G	C	1	2	3	0	0	3	0	0
11	42933167	.	G	A	5	4	9	0	3	12	0	0
11	42933696	.	A	G	13	6	19	0	1	20	0	0
11	42933703	.	T	C	12	8	20	0	1	21	0	0
11	42933813	.	A	G	4	6	10	0	2	12	0	0
11	42933832	.	C	T	1	2	3	0	1	4	0	0
11	42942852	.	T	C	3	5	8	0	0	8	0	0
11	42942930	.	G	A	5	2	7	0	0	7	0	0
11	42947471	.	A	G	3	1	4	0	0	4	0	0
11	42947480	.	G	A	4	2	6	0	1	7	0	0
11	42949819	.	G	A	2	4	6	0	0	6	0	0
11	42949828	.	T	G	1	2	3	0	1	4	0	0
11	42954479	.	G	A	1	1	2	0	0	2	0	0
11	42978318	.	A	T	1	2	3	0	0	3	0	0
11	42980091	.	A	G	1	2	3	0	0	3	0	0
11	43115689	.	C	T	2	4	6	0	0	6	0	0
11	43115998	.	C	T	2	3	5	0	1	6	0	0
11	43137659	.	C	T	25	12	37	0	0	37	0	0
11	43151260	.	C	T	20	8	28	0	0	28	0	0
11	43164302	.	G	T	6	7	13	0	0	13	0	0
11	43170699	.	A	G	13	8	21	0	0	21	0	0
11	43170804	.	G	A	5	12	17	0	0	17	0	0
11	43170924	.	A	G	5	3	8	0	3	11	0	0
11	43171263	.	G	A	3	5	8	0	0	8	0	0
11	43171281	.	A	G	6	5	11	0	1	12	0	0
11	43171314	.	A	G	6	6	12	0	0	12	0	0
11	43178811	.	T	A	3	1	4	0	1	5	0	0
11	43178823	.	G	A	5	2	7	0	0	7	0	0
11	43178958	.	C	T	5	2	7	0	0	7	0	0
11	43178991	.	G	A	3	2	5	0	0	5	0	0
11	43179248	.	T	G	2	2	4	0	0	4	0	0
11	43189115	.	G	A	1	3	4	0	0	4	0	0
11	43189118	.	G	A	1	3	4	0	0	4	0	0
11	43190846	.	G	A	0	1	1	0	0	1	0	0
11	43200347	.	C	T	0	2	2	0	0	2	0	0
11	43470473	.	T	A	1	2	3	0	0	3	0	0
11	44328905	.	A	G	15	15	30	0	1	31	0	0
11	44328956	.	T	C	12	21	33	0	2	35	0	0
11	44329050	.	A	G	9	15	24	0	2	26	0	0
11	44329172	.	C	T	8	14	22	0	0	22	0	0
11	44334935	.	T	A	23	18	41	0	1	42	0	0
11	44358817	.	G	T	0	2	2	0	3	5	0	0
11	44361689	.	C	G	7	5	12	0	1	13	0	0
11	44361701	.	C	T	8	8	16	0	1	17	0	0
11	44400918	.	G	A	7	6	13	0	0	13	0	0
11	44400960	.	G	T	4	5	9	0	0	9	0	0
11	44401057	.	C	A	5	4	9	0	0	9	0	0
11	44401275	.	G	A	10	5	15	0	2	17	0	0
11	44401437	.	G	A	2	3	5	0	1	6	0	0
11	44403378	.	C	G	2	3	5	0	1	6	0	0
11	44468838	.	G	A	2	3	5	0	1	6	0	0
11	44468842	.	T	C	1	3	4	0	1	5	0	0
11	44606793	.	A	T	7	4	11	0	0	11	0	0
11	44606803	.	T	C	6	4	10	0	2	12	0	0
11	44606844	.	G	T	5	10	15	0	3	18	0	0
11	44607019	.	T	A	11	4	15	0	0	15	0	0
11	44607052	.	G	A	14	8	22	0	1	23	0	0
11	44633294	.	T	C	3	1	4	0	0	4	0	0
11	44634908	.	G	A	0	4	4	0	10	14	0	0
11	44635430	.	C	A	1	2	3	0	0	3	0	0
11	44635441	.	T	C	1	2	3	0	0	3	0	0
11	44637569	.	T	A	8	9	17	0	0	17	0	0
11	44637950	.	A	G	24	21	45	0	4	49	0	0
11	44643882	.	C	T	1	4	5	0	0	5	0	0
11	44647227	.	A	C	13	0	13	0	30	43	0	0
11	44647269	.	T	G	7	22	29	0	3	32	0	0
11	44723130	.	C	G	6	11	17	0	1	19	1	0
11	44723353	.	G	A	0	19	19	0	13	32	0	0
11	44723374	.	T	C	12	17	29	0	0	29	0	0
11	44723416	.	T	G	14	0	14	0	15	29	0	0
11	44723653	.	T	G	9	20	29	0	2	31	0	0
11	44723746	.	A	G	15	20	35	0	1	36	0	0
11	44725596	.	C	T	21	24	45	0	1	46	0	0
11	44725926	.	G	A	1	30	31	0	25	56	0	0
11	44838743	.	G	A	0	2	2	0	1	3	0	0
11	44852732	.	G	A	0	3	3	0	3	6	0	0
11	44852756	.	A	T	5	3	8	0	1	9	0	0
11	44852771	.	T	A	5	3	8	0	0	8	0	0
11	44854631	.	C	T	1	2	3	0	0	3	0	0
11	44854636	.	G	T	1	3	4	0	0	4	0	0
11	44854894	.	T	G	5	5	10	0	1	11	0	0
11	44854918	.	G	A	0	5	5	0	5	10	0	0
11	44854996	.	T	C	7	6	13	0	2	15	0	0
11	44855027	.	G	A	0	5	5	0	5	10	0	0
11	44880288	.	A	G	8	16	24	0	2	26	0	0
11	44880291	.	T	A	7	18	25	0	2	27	0	0
11	44880332	.	G	A	6	10	16	0	0	16	0	0
11	44880345	.	C	G	9	5	14	0	0	14	0	0
11	44887200	.	G	A	9	16	25	0	1	26	0	0
11	44887612	.	G	T	12	13	25	0	1	26	0	0
11	44891507	.	G	A	0	3	3	0	0	3	0	0
11	44892859	.	T	A	0	1	1	0	0	1	0	0
11	44892883	.	G	A	6	3	9	0	0	9	0	0
11	44892943	.	G	A	12	6	18	0	0	18	0	0
11	44892979	.	T	A	1	2	3	0	0	3	0	0
11	44897584	.	C	T	6	5	11	0	1	12	0	0
11	44897647	.	A	C	3	8	11	0	0	11	0	0
11	44901315	.	C	T	1	13	14	0	13	27	0	0
11	44901373	.	C	A	31	30	61	0	4	65	0	0
11	44910758	.	T	G	3	0	3	0	0	3	0	0
11	44912485	.	C	A	0	0	0	0	3	3	0	0
11	44913176	.	C	A	0	3	3	0	5	8	0	0
11	44914943	.	G	C	3	4	7	0	0	7	0	0
11	44927159	.	C	A	0	2	2	0	1	3	0	0
11	44927833	.	G	T	1	1	2	0	0	2	0	0
11	44935375	.	A	G	2	2	4	0	0	4	0	0
11	44953608	.	C	T	1	3	4	0	0	4	0	0
11	44953620	.	C	T	1	2	3	0	0	3	0	0
11	44960620	.	G	A	1	1	2	0	0	2	0	0
11	45125627	.	T	C	2	0	2	0	0	2	0	0
11	45126730	.	C	A	2	4	6	0	2	8	0	0
11	45126772	.	G	A	6	4	10	0	0	10	0	0
11	45127191	.	G	A	5	8	13	0	0	13	0	0
11	45127335	.	C	T	0	6	6	0	2	8	0	0
11	45127374	.	G	A	2	4	6	0	0	6	0	0
11	45130676	.	A	G	3	2	5	0	1	6	0	0
11	45130874	.	C	A	0	3	3	0	4	7	0	0
11	45131119	.	C	T	6	2	8	0	0	8	0	0
11	45139844	.	A	G	3	6	9	0	0	9	0	0
11	45140116	.	C	G	6	6	12	0	1	13	0	0
11	45141286	.	T	C	5	6	11	0	0	11	0	0
11	45161844	.	C	T	9	3	12	0	1	13	0	0
11	45162241	.	A	T	8	7	15	0	0	15	0	0
11	45167709	.	G	A	3	6	9	0	0	9	0	0
11	45242450	.	C	T	1	1	2	0	1	3	0	0
11	45242912	.	T	C	2	3	5	0	0	5	0	0
11	45245862	.	G	A	4	2	6	0	1	7	0	0
11	45262079	.	C	T	3	5	8	0	2	10	0	0
11	45262138	.	C	G	2	0	2	0	9	11	0	0
11	45262155	.	T	C	5	2	7	0	0	7	0	0
11	45262186	.	G	A	0	5	5	0	7	12	0	0
11	45262379	.	G	T	6	5	11	0	0	11	0	0
11	45265828	.	C	T	0	1	1	0	0	1	0	0
11	45272686	.	G	A	0	1	1	0	3	4	0	0
11	45287575	.	G	A	1	2	3	0	1	4	0	0
11	45290884	.	C	T	2	2	4	0	1	5	0	0
11	45291926	.	G	A	0	2	2	0	2	4	0	0
11	45292918	.	G	A	0	3	3	0	5	8	0	0
11	45294954	.	T	C	10	1	11	0	3	14	0	0
11	45294955	.	G	A	11	0	11	0	3	14	0	0
11	45342757	.	A	G	3	2	5	0	0	5	0	0
11	45342823	.	G	A	3	3	6	0	0	6	0	0
11	45342861	.	A	C	1	3	4	0	0	4	0	0
11	45343033	.	A	G	2	4	6	0	0	6	0	0
11	45343045	.	C	G	3	3	6	0	0	6	0	0
11	45343231	.	T	A	3	4	7	0	0	7	0	0
11	45343264	.	A	T	4	4	8	0	0	8	0	0
11	45348465	.	G	A	1	1	2	0	0	2	0	0
11	45355022	.	C	G	14	19	33	1	3	37	0	0
11	45355473	.	C	T	1	10	11	0	20	31	0	0
11	45355717	.	A	G	14	12	26	0	0	26	0	0
11	45356114	.	G	A	11	12	23	0	2	25	0	0
11	45356660	.	C	T	0	5	5	0	8	13	0	0
11	45359878	.	C	T	1	0	1	0	0	1	0	0
11	45362172	.	A	T	7	5	12	0	0	12	0	0
11	45363073	.	G	A	1	7	8	0	0	8	0	0
11	45366798	.	T	A	2	1	3	0	1	4	0	0
11	45371868	.	A	G	2	2	4	0	0	4	0	0
11	45389809	.	T	C	0	0	0	0	1	1	0	0
11	45389932	.	A	T	1	3	4	0	0	4	0	0
11	45391727	.	T	C	6	4	10	0	0	10	0	0
11	45391788	.	C	T	2	4	6	0	1	7	0	0
11	45393522	.	A	C	2	0	2	0	22	24	0	0
11	45395572	.	G	A	0	17	17	0	7	24	0	0
11	45397372	.	C	T	21	14	35	0	0	35	0	0
11	45398744	.	A	G	7	2	9	0	1	10	0	0
11	45398804	.	T	C	5	10	15	0	2	17	0	0
11	45399389	.	A	G	8	11	19	0	0	19	0	0
11	45399491	.	C	T	23	30	53	1	4	58	0	0
11	45399799	.	G	T	12	15	27	0	0	27	0	0
11	45399925	.	C	T	20	17	37	0	2	39	0	0
11	45399985	.	G	T	1	19	20	0	24	44	0	0
11	45402945	.	G	A	21	13	34	0	1	35	0	0
11	45403525	.	G	A	8	9	17	0	0	17	0	0
11	45403733	.	G	A	11	16	27	0	1	28	0	0
11	45403800	.	T	A	18	12	30	0	1	31	0	0
11	45403854	.	G	A	14	22	36	0	1	37	0	0
11	45407215	.	G	A	1	1	2	0	1	3	0	0
11	45430220	.	C	T	0	1	1	0	1	2	0	0
11	45460271	.	G	A	0	1	1	0	1	2	0	0
11	45461498	.	G	A	0	2	2	0	4	6	0	0
11	45463352	.	T	C	6	0	6	0	0	6	0	0
11	45463730	.	G	A	0	9	9	0	13	22	0	0
11	45463835	.	G	T	11	9	20	0	4	24	0	0
11	45463979	.	T	A	14	4	18	0	0	18	0	0
11	45464188	.	G	C	4	7	11	0	2	13	0	0
11	45464673	.	C	T	4	8	12	0	1	13	0	0
11	45464762	.	A	T	15	10	25	0	0	25	0	0
11	45464835	.	G	A	9	6	15	0	1	16	0	0
11	45465080	.	T	A	12	13	25	0	1	26	0	0
11	45468906	.	T	A	1	1	2	0	1	3	0	0
11	45468956	.	C	A	1	4	5	0	1	6	0	0
11	45468959	.	G	A	2	4	6	0	0	6	0	0
11	45469129	.	T	C	2	5	7	0	0	7	0	0
11	45469914	.	G	T	2	4	6	0	1	7	0	0
11	45470277	.	C	T	0	7	7	0	4	11	0	0
12	1387913	.	A	G	1	2	3	0	2	5	0	0
12	1388344	.	C	T	1	3	4	0	0	4	0	0
12	1515384	.	C	T	0	1	1	0	1	2	0	0
12	2849970	.	A	G	1	7	8	0	1	9	0	0
12	2850025	.	A	G	10	4	14	0	0	14	0	0
12	2850027	.	A	G	10	3	13	0	1	14	0	0
12	2850875	.	T	C	0	0	0	0	3	3	0	0
12	3060401	.	C	T	4	4	8	1	0	9	0	0
12	3060404	.	C	T	4	1	5	1	3	9	0	0
12	3271125	.	A	G	4	3	7	0	1	8	0	0
12	3271391	.	A	G	5	5	10	0	1	11	0	0
12	3271553	.	G	A	2	6	8	0	0	8	0	0
12	3272421	.	A	G	3	7	10	0	2	12	0	0
12	3272484	.	A	G	12	5	17	0	0	17	0	0
12	3272485	.	A	G	14	3	17	0	0	17	0	0
12	3571986	.	C	T	8	9	17	0	1	18	0	0
12	3574348	.	G	A	10	20	30	0	2	32	0	0
12	3574489	.	G	A	5	5	10	0	0	10	0	0
12	3714149	.	G	T	5	8	13	0	4	17	0	0
12	3714183	.	G	A	12	11	23	0	1	24	0	0
12	3714213	.	T	A	12	13	25	0	0	25	0	0
12	3714315	.	C	T	11	6	17	0	4	21	0	0
12	3714330	.	A	T	9	10	19	0	1	22	2	0
12	3714425	.	C	A	12	9	21	0	0	21	0	0
12	3714578	.	T	C	7	0	7	0	7	14	0	0
12	3714602	.	T	C	6	6	12	0	0	12	0	0
12	3714650	.	T	C	3	5	8	0	1	9	0	0
12	3714746	.	C	T	3	3	6	0	1	7	0	0
12	3714934	.	T	C	6	5	11	0	0	12	1	0
12	3714977	.	T	C	3	0	3	0	11	14	0	0
12	3715016	.	A	G	4	3	7	0	0	7	0	0
12	3715039	.	T	C	3	3	6	0	0	6	0	0
12	3715134	.	G	A	3	4	7	0	1	8	0	0
12	3715292	.	T	G	4	9	13	0	2	15	0	0
12	3715327	.	C	A	1	10	11	0	0	11	0	0
12	3715329	.	C	G	1	10	11	0	0	11	0	0
12	3715544	.	T	C	3	5	8	0	1	9	0	0
12	3715904	.	G	A	6	3	9	0	0	9	0	0
12	3716621	.	G	C	0	1	1	0	0	1	0	0
12	3723786	.	C	G	5	6	11	0	1	12	0	0
12	3723963	.	G	A	1	6	7	0	5	12	0	0
12	3726646	.	T	A	9	7	16	0	1	17	0	0
12	3740717	.	C	A	2	3	5	0	1	6	0	0
12	3740724	.	T	A	2	4	6	0	0	6	0	0
12	3740784	.	C	T	3	9	12	0	0	12	0	0
12	3740803	.	G	A	3	8	11	0	1	12	0	0
12	3747640	.	G	A	1	0	1	0	0	1	0	0
12	3749502	.	A	G	2	0	2	0	0	2	0	0
12	3749505	.	C	T	0	0	0	0	2	2	0	0
12	3860624	.	G	A	0	4	4	0	4	8	0	0
12	3860696	.	C	T	1	1	2	0	0	2	0	0
12	3875667	.	A	G	1	3	4	0	1	5	0	0
12	3889922	.	C	T	2	1	3	0	1	4	0	0
12	3921813	.	G	A	3	3	6	0	0	6	0	0
12	3921894	.	T	C	3	2	5	0	0	5	0	0
12	3922068	.	A	T	1	3	4	0	0	4	0	0
12	3922086	.	A	C	1	5	6	0	0	6	0	0
12	3922536	.	A	G	3	9	12	0	2	14	0	0
12	3922549	.	G	A	0	7	7	0	9	16	0	0
12	3922764	.	A	G	2	5	7	0	0	7	0	0
12	3922844	.	G	A	1	7	8	0	0	8	0	0
12	3944488	.	C	G	0	31	31	0	24	55	0	0
12	3944543	.	A	G	13	22	35	0	3	38	0	0
12	3946833	.	G	A	6	7	13	0	1	14	0	0
12	3947276	.	A	G	1	0	1	0	0	1	0	0
12	3947484	.	A	G	18	27	45	0	1	46	0	0
12	3947902	.	G	A	24	19	43	0	1	44	0	0
12	3947929	.	A	G	25	10	35	0	2	37	0	0
12	3948593	.	C	T	1	0	1	0	0	1	0	0
12	3948701	.	G	A	25	15	40	0	4	44	0	0
12	3949194	.	A	G	11	31	42	0	2	44	0	0
12	3953155	.	T	A	2	4	6	0	0	6	0	0
12	3953946	.	A	G	8	13	21	0	5	26	0	0
12	3954003	.	T	G	4	6	10	0	1	11	0	0
12	3956864	.	A	G	2	0	2	0	0	2	0	0
12	3957973	.	A	G	7	18	25	0	1	26	0	0
12	3964559	.	C	A	8	8	16	0	12	28	0	0
12	3964563	.	C	A	8	11	19	0	11	30	0	0
12	3964631	.	G	A	10	17	27	2	1	30	0	0
12	3964770	.	A	G	12	17	29	0	1	30	0	0
12	3964937	.	C	G	9	13	22	0	3	26	1	0
12	3965002	.	G	T	10	8	18	0	4	23	1	0
12	3965168	.	T	C	16	10	26	0	1	27	0	0
12	3967756	.	A	G	5	7	12	0	1	13	0	0
12	3974755	.	C	T	0	2	2	0	4	6	0	0
12	3998821	.	A	C	0	2	2	0	0	2	0	0
12	3998943	.	T	C	1	3	4	0	0	4	0	0
12	3998961	.	A	T	1	3	4	0	0	4	0	0
12	3999002	.	A	G	1	2	3	0	0	3	0	0
12	3999071	.	C	T	1	3	4	0	0	4	0	0
12	4002615	.	A	T	5	4	9	0	1	10	0	0
12	4002709	.	A	G	3	4	7	0	0	7	0	0
12	4004344	.	C	T	4	6	10	0	1	11	0	0
12	4004448	.	C	T	0	2	2	0	2	4	0	0
12	4009150	.	G	A	2	0	2	0	0	2	0	0
12	4009165	.	A	G	2	0	2	0	0	2	0	0
12	4009462	.	A	T	2	0	2	0	0	2	0	0
12	4227248	.	A	C	2	2	4	0	0	4	0	0
12	4231775	.	A	G	2	5	7	0	0	7	0	0
12	4231776	.	G	A	1	5	6	0	1	7	0	0
12	4232313	.	A	G	3	0	3	0	3	6	0	0
12	4232320	.	C	T	3	3	6	0	0	6	0	0
12	4232425	.	G	A	2	11	13	0	1	14	0	0
12	4232434	.	C	A	1	10	11	0	3	14	0	0
12	4238122	.	T	C	1	4	5	0	1	6	0	0
12	4238704	.	T	A	3	4	7	0	1	8	0	0
12	4238720	.	T	C	4	4	8	0	0	8	0	0
12	4601361	.	G	A	5	5	10	0	0	10	0	0
12	4601769	.	A	G	28	18	46	0	2	48	0	0
12	4602047	.	T	A	17	6	23	0	0	23	0	0
12	4602245	.	G	A	16	23	39	0	0	39	0	0
12	4602399	.	A	T	16	18	34	0	2	36	0	0
12	4602436	.	A	T	16	13	29	0	2	31	0	0
12	4606669	.	C	T	11	13	24	0	0	24	0	0
12	4609143	.	C	T	2	9	11	0	1	12	0	0
12	4609343	.	C	G	0	8	8	0	10	18	0	0
12	4609364	.	A	G	11	10	21	0	0	21	0	0
12	4609391	.	T	C	8	4	12	0	3	15	0	0
12	4609409	.	C	T	3	3	6	0	0	6	0	0
12	4611092	.	C	T	0	4	4	0	4	8	0	0
12	4611128	.	C	T	8	16	24	0	2	26	0	0
12	4616967	.	C	G	1	6	7	0	1	8	0	0
12	4616974	.	G	A	1	7	8	0	0	8	0	0
12	4617024	.	G	T	7	2	9	0	0	9	0	0
12	4617065	.	G	A	6	7	13	0	3	16	0	0
12	4617070	.	T	C	5	10	15	0	1	16	0	0
12	4617102	.	G	C	10	1	11	0	9	20	0	0
12	4617243	.	G	A	12	17	29	0	0	29	0	0
12	4617274	.	G	A	9	14	23	0	2	25	0	0
12	4617286	.	T	C	10	0	10	0	14	24	0	0
12	4619179	.	A	G	4	2	6	0	2	8	0	0
12	4619230	.	G	T	6	6	12	0	0	12	0	0
12	4619553	.	C	T	5	6	11	0	1	12	0	0
12	4621480	.	G	A	1	2	3	0	0	3	0	0
12	4621618	.	A	G	5	3	8	0	0	8	0	0
12	4622884	.	G	A	0	1	1	0	0	1	0	0
12	4644028	.	A	C	3	3	6	0	0	6	0	0
12	4648530	.	G	A	2	3	5	0	0	5	0	0
12	4690785	.	T	C	2	2	4	0	0	4	0	0
12	4691146	.	A	G	4	3	7	0	0	7	0	0
12	4712234	.	T	C	1	3	4	0	0	4	0	0
12	4713010	.	C	A	1	2	3	0	1	4	0	0
12	4715953	.	A	G	0	0	0	0	1	1	0	0
12	4715968	.	G	A	0	1	1	0	1	2	0	0
12	4716061	.	A	C	2	7	9	0	2	11	0	0
12	4716064	.	T	G	3	0	3	0	7	10	0	0
12	4716361	.	A	G	2	1	3	0	0	3	0	0
12	4716375	.	T	C	2	1	3	0	0	3	0	0
12	4720264	.	T	C	3	1	4	0	0	4	0	0
12	4721721	.	C	G	0	1	1	0	0	1	0	0
12	4721727	.	A	G	0	0	0	0	1	1	0	0
12	4724397	.	A	T	1	0	1	0	1	2	0	0
12	4724455	.	A	G	8	0	8	0	8	16	0	0
12	4724464	.	T	C	8	9	17	0	1	18	0	0
12	4724553	.	G	A	7	4	11	0	1	12	0	0
12	4724634	.	G	A	0	5	5	0	3	8	0	0
12	4724787	.	T	G	4	10	14	0	1	15	0	0
12	4724983	.	G	A	13	9	22	0	0	22	0	0
12	4725170	.	A	T	11	9	20	0	0	20	0	0
12	4725371	.	A	G	13	8	21	0	3	24	0	0
12	4733968	.	C	T	10	8	18	0	0	18	0	0
12	4734008	.	G	T	17	11	28	0	2	30	0	0
12	4734068	.	G	T	6	7	13	0	4	17	0	0
12	4734306	.	A	T	16	6	22	0	0	22	0	0
12	4734312	.	A	G	15	6	21	0	1	22	0	0
12	4734418	.	T	G	18	7	25	0	1	26	0	0
12	4734476	.	T	C	15	2	17	0	13	30	0	0
12	4734925	.	C	T	16	14	30	0	1	31	0	0
12	4734967	.	G	A	12	10	22	0	0	22	0	0
12	4734979	.	C	T	0	6	6	0	12	18	0	0
12	4751860	.	C	T	2	2	4	0	0	4	0	0
12	4752981	.	G	A	6	0	6	0	1	7	0	0
12	4753095	.	C	T	5	6	11	0	0	11	0	0
12	4753104	.	C	T	0	6	6	0	5	11	0	0
12	4957095	.	A	G	1	1	2	0	0	2	0	0
12	4960631	.	A	G	1	5	6	0	0	6	0	0
12	4961256	.	A	G	1	3	4	0	0	4	0	0
12	4961930	.	A	G	1	5	6	0	0	6	0	0
12	4961955	.	A	C	2	5	7	0	0	7	0	0
12	5044104	.	A	G	1	0	1	0	4	5	0	0
12	5044106	.	G	A	1	4	5	0	0	5	0	0
12	5044396	.	T	C	2	2	4	0	1	5	0	0
12	5044462	.	A	T	3	3	6	0	0	6	0	0
12	5059785	.	T	C	0	1	1	0	2	3	0	0
12	5070290	.	G	A	3	5	8	0	1	9	0	0
12	5071581	.	G	A	0	3	3	0	0	3	0	0
12	5084382	.	T	C	1	2	3	0	0	3	0	0
12	5084386	.	T	C	1	2	3	0	0	3	0	0
12	5090591	.	T	C	0	5	5	0	0	5	0	0
12	5091368	.	A	T	1	7	8	0	1	9	0	0
12	5116192	.	A	G	9	11	20	0	0	20	0	0
12	5119802	.	T	C	6	8	14	0	0	14	0	0
12	5156454	.	T	A	1	0	1	0	1	2	0	0
12	5156507	.	G	A	3	3	6	0	0	6	0	0
12	5156671	.	A	G	1	2	3	0	0	3	0	0
12	5180489	.	G	A	0	2	2	0	0	2	0	0
12	5389940	.	T	C	1	2	3	0	0	3	0	0
12	5398514	.	T	G	2	3	5	0	0	5	0	0
12	5399803	.	G	A	1	3	4	0	0	4	0	0
12	5407930	.	A	T	1	0	1	0	0	1	0	0
12	5427456	.	T	A	7	4	11	0	0	11	0	0
12	5427491	.	T	G	5	2	7	0	0	7	0	0
12	5459580	.	G	C	1	3	4	0	0	4	0	0
12	5576096	.	C	T	0	2	2	0	0	2	0	0
12	5994179	.	T	C	4	2	6	0	0	6	0	0
12	7237756	.	G	A	1	2	3	0	3	6	0	0
12	7237761	.	G	A	2	3	5	0	0	5	0	0
12	7610969	.	T	C	4	7	11	0	0	11	0	0
12	7611286	.	T	C	1	4	5	0	0	5	0	0
12	7612106	.	T	C	1	8	9	0	0	9	0	0
12	7612223	.	T	C	3	2	5	0	1	6	0	0
12	10412169	.	T	C	2	3	5	0	0	5	0	0
12	10447085	.	A	C	1	6	7	0	1	8	0	0
12	11389229	.	T	C	3	4	7	0	1	8	0	0
12	11390365	.	T	C	1	5	6	0	0	6	0	0
12	13474461	.	A	G	11	3	14	0	0	14	0	0
12	13474463	.	A	G	12	2	14	0	0	14	0	0
12	13475225	.	A	G	19	6	25	0	0	25	0	0
12	13811642	.	G	A	9	3	12	0	5	17	0	0
12	14166722	.	T	A	10	3	13	0	1	14	0	0
12	16964723	.	A	G	2	2	4	0	0	4	0	0
12	17323063	.	A	T	3	2	5	0	1	6	0	0
12	18913850	.	A	G	12	5	17	0	1	18	0	0
12	18913906	.	A	G	9	5	14	0	0	14	0	0
12	18913938	.	A	G	8	7	15	0	0	15	0	0
12	19062233	.	A	G	3	4	7	0	0	7	0	0
12	19063169	.	A	T	2	1	3	0	1	4	0	0
12	19339123	.	G	A	0	2	2	0	0	2	0	0
12	22412290	.	T	C	1	3	4	0	0	4	0	0
12	24636596	.	C	A	6	0	6	1	34	48	7	0
12	25094200	.	T	C	3	5	8	0	0	8	0	0
12	25094201	.	T	C	1	5	6	0	2	8	0	0
12	25094359	.	T	C	2	12	14	0	0	15	1	0
12	25094520	.	T	C	13	4	17	0	0	17	0	0
12	25485310	.	C	A	2	3	5	0	0	5	0	0
12	25485312	.	C	A	2	3	5	0	0	5	0	0
12	25768836	.	T	C	1	7	8	0	1	9	0	0
12	27229078	.	A	G	13	4	17	0	1	18	0	0
12	27305596	.	T	C	7	2	9	0	0	9	0	0
12	28072821	.	C	G	13	10	23	0	3	26	0	0
12	28949112	.	C	A	4	0	4	0	1	5	0	0
12	28952139	.	T	C	1	2	3	0	0	3	0	0
12	28959943	.	G	T	2	4	6	0	0	6	0	0
12	28960284	.	T	C	5	8	13	0	0	13	0	0
12	28960321	.	G	A	5	4	9	0	2	11	0	0
12	28960441	.	C	T	1	3	4	0	0	4	0	0
12	28960481	.	A	G	0	2	2	0	0	2	0	0
12	29084032	.	T	C	0	1	1	0	1	2	0	0
12	29102585	.	T	C	5	3	8	0	0	8	0	0
12	29103041	.	T	A	2	3	5	0	0	5	0	0
12	29105508	.	A	T	5	2	7	0	0	7	0	0
12	29105510	.	A	T	5	2	7	0	0	7	0	0
12	29207683	.	G	T	7	2	9	0	0	9	0	0
12	29208099	.	T	G	2	3	5	0	0	5	0	0
12	29209834	.	G	A	5	2	7	0	0	7	0	0
12	29209840	.	A	T	5	2	7	0	1	8	0	0
12	29210371	.	C	A	5	9	14	0	0	14	0	0
12	29210435	.	C	G	8	12	20	0	1	21	0	0
12	29210600	.	C	T	12	8	20	0	1	21	0	0
12	29210719	.	T	A	11	13	24	0	0	24	0	0
12	29210873	.	T	A	6	2	8	0	0	8	0	0
12	29210917	.	T	C	10	4	14	0	0	14	0	0
12	29211082	.	G	A	7	6	13	0	1	14	0	0
12	29211195	.	T	A	10	8	18	0	1	19	0	0
12	29211232	.	G	A	0	13	13	0	12	25	0	0
12	29211289	.	T	A	18	14	32	0	1	34	1	0
12	29211292	.	A	G	13	11	24	0	8	32	0	0
12	29223498	.	A	G	5	3	8	0	2	10	0	0
12	29223612	.	T	G	2	2	4	0	1	5	0	0
12	29223751	.	G	C	4	2	6	0	0	6	0	0
12	29223811	.	C	A	4	2	6	0	0	6	0	0
12	29223847	.	C	T	2	3	5	0	0	5	0	0
12	29223921	.	G	A	3	3	6	0	1	7	0	0
12	29224521	.	A	T	3	4	7	0	1	8	0	0
12	29224836	.	A	T	1	3	4	0	0	4	0	0
12	29226152	.	T	C	2	2	4	0	0	4	0	0
12	29251520	.	A	G	1	3	4	0	0	4	0	0
12	29260865	.	A	G	1	3	4	0	0	4	0	0
12	29266917	.	T	C	3	3	6	0	2	8	0	0
12	29269689	.	G	A	3	8	11	0	0	11	0	0
12	29269695	.	A	G	4	0	4	0	7	11	0	0
12	29269726	.	C	G	4	4	8	0	0	8	0	0
12	29269770	.	G	T	0	2	2	0	5	7	0	0
12	29269774	.	T	G	4	1	5	0	1	6	0	0
12	29350745	.	T	C	1	2	3	0	0	3	0	0
12	29350773	.	C	A	3	3	6	0	1	7	0	0
12	29351320	.	A	G	12	12	24	0	3	27	0	0
12	29351810	.	A	G	19	11	30	0	2	32	0	0
12	29358277	.	T	C	3	1	4	0	0	4	0	0
12	29358370	.	G	C	5	0	5	0	3	8	0	0
12	29358384	.	A	G	3	3	6	0	1	7	0	0
12	29358418	.	A	G	0	2	2	0	0	2	0	0
12	29624017	.	G	A	10	7	17	0	1	18	0	0
12	29624272	.	C	A	3	3	6	0	0	6	0	0
12	29843460	.	A	G	11	14	25	0	3	28	0	0
12	29844434	.	T	C	7	6	13	0	1	14	0	0
12	29873273	.	C	G	0	0	0	0	1	1	0	0
12	29921114	.	T	G	3	0	3	0	1	4	0	0
12	29947132	.	A	G	0	3	3	0	0	3	0	0
12	29947147	.	C	A	0	2	2	0	0	2	0	0
12	29957074	.	C	T	2	2	4	0	0	4	0	0
12	29957164	.	C	T	4	2	6	0	1	7	0	0
12	30031677	.	T	C	2	2	4	0	0	4	0	0
12	30031680	.	T	C	2	2	4	0	0	4	0	0
12	30036873	.	G	A	0	2	2	0	1	3	0	0
12	30200741	.	C	T	1	4	5	0	0	5	0	0
12	30208905	.	T	C	0	2	2	0	1	3	0	0
12	30216436	.	T	C	2	4	6	0	0	6	0	0
12	30216693	.	C	T	3	3	6	0	0	6	0	0
12	30216697	.	G	A	0	3	3	0	3	6	0	0
12	30217423	.	T	C	2	4	6	0	0	6	0	0
12	30217569	.	A	G	2	4	6	0	0	6	0	0
12	30217589	.	A	T	4	5	9	0	0	9	0	0
12	30217705	.	G	A	0	3	3	0	3	6	0	0
12	30217747	.	C	T	3	2	5	0	2	7	0	0
12	30217782	.	T	G	2	6	8	0	0	8	0	0
12	30217893	.	C	A	2	4	6	0	0	6	0	0
12	30217898	.	T	A	2	2	4	0	1	5	0	0
12	30217966	.	G	A	5	2	7	0	0	7	0	0
12	30217986	.	C	T	5	4	9	0	0	9	0	0
12	30218135	.	C	A	4	6	10	0	0	10	0	0
12	30218150	.	G	A	6	4	10	0	0	10	0	0
12	30218173	.	C	T	6	6	12	0	0	12	0	0
12	30219306	.	A	T	21	15	36	0	1	37	0	0
12	30219739	.	G	A	7	4	11	0	1	12	0	0
12	30219804	.	C	T	14	7	21	0	3	24	0	0
12	30304909	.	A	G	2	2	4	0	0	4	0	0
12	30307010	.	C	T	2	9	11	0	0	11	0	0
12	30385562	.	C	T	2	1	3	0	0	3	0	0
12	30391136	.	G	A	0	1	1	0	0	1	0	0
12	30418513	.	C	G	4	6	10	0	0	10	0	0
12	30419123	.	A	T	11	7	18	0	0	18	0	0
12	30419134	.	C	A	7	9	16	0	0	16	0	0
12	30419260	.	T	G	13	5	18	0	1	20	1	0
12	30419646	.	T	C	7	13	20	0	0	20	0	0
12	30419655	.	T	C	6	12	18	0	1	19	0	0
12	30419695	.	T	C	6	6	12	0	1	13	0	0
12	30419727	.	A	G	3	5	8	0	1	9	0	0
12	30442783	.	G	A	9	9	18	0	1	19	0	0
12	30459006	.	G	A	5	2	7	0	0	7	0	0
12	30459422	.	A	C	1	6	7	0	0	7	0	0
12	30459532	.	A	T	4	2	6	0	0	6	0	0
12	30459538	.	A	G	4	3	7	0	0	7	0	0
12	30460056	.	T	C	1	2	3	0	0	3	0	0
12	30460333	.	C	A	1	3	4	0	0	4	0	0
12	30741328	.	T	G	1	2	3	0	0	3	0	0
12	30800128	.	G	A	2	3	5	0	1	6	0	0
12	30803196	.	T	C	5	2	7	0	1	8	0	0
12	30803629	.	A	G	2	3	5	0	0	5	0	0
12	30805335	.	T	C	2	1	3	0	1	4	0	0
12	30805359	.	T	C	6	3	9	0	0	9	0	0
12	30806928	.	G	T	0	5	5	0	4	9	0	0
12	30807038	.	A	G	3	12	15	0	1	16	0	0
12	30807245	.	A	G	1	3	4	0	0	4	0	0
12	30807290	.	A	G	1	2	3	0	0	3	0	0
12	30807330	.	T	A	3	5	8	0	0	8	0	0
12	30807458	.	C	T	6	6	12	0	2	14	0	0
12	30807494	.	G	A	4	7	11	0	1	12	0	0
12	30807504	.	A	C	4	5	9	0	1	10	0	0
12	30807714	.	A	G	6	5	11	0	0	11	0	0
12	30808094	.	C	T	5	3	8	0	3	11	0	0
12	30808150	.	T	A	8	10	18	0	1	19	0	0
12	30808531	.	G	C	8	9	17	0	0	17	0	0
12	30808716	.	C	T	2	8	10	0	0	10	0	0
12	30808766	.	C	T	10	3	13	0	0	13	0	0
12	30808812	.	A	G	2	0	2	0	9	11	0	0
12	30979815	.	A	C	13	14	27	0	6	33	0	0
12	30979923	.	T	A	14	5	19	0	3	22	0	0
12	30980566	.	G	A	23	27	50	0	3	53	0	0
12	30981795	.	G	A	23	24	47	0	2	49	0	0
12	30986452	.	G	A	0	1	1	0	1	2	0	0
12	31102981	.	A	G	4	3	7	0	1	8	0	0
12	31435977	.	T	A	2	1	3	0	0	3	0	0
12	31438056	.	G	T	9	7	16	0	1	17	0	0
12	31438352	.	A	T	3	5	8	0	0	8	0	0
12	31438440	.	C	A	2	2	4	0	0	4	0	0
12	31532342	.	A	C	2	4	6	0	1	7	0	0
12	31532371	.	G	A	0	4	4	0	4	8	0	0
12	31532397	.	G	C	3	4	7	0	0	7	0	0
12	31532577	.	T	C	2	6	8	0	0	8	0	0
12	31532638	.	A	C	3	5	8	0	2	10	0	0
12	31629611	.	C	T	0	2	2	0	0	2	0	0
12	31631082	.	T	C	4	5	9	0	0	9	0	0
12	31631116	.	A	T	1	3	4	0	1	5	0	0
12	31631124	.	A	T	2	3	5	0	0	5	0	0
12	31689567	.	T	A	2	2	4	0	0	4	0	0
12	31704458	.	G	A	0	3	3	0	3	6	0	0
12	31704548	.	T	C	2	3	5	0	0	5	0	0
12	31708020	.	C	T	5	3	8	0	0	8	0	0
12	31708025	.	G	A	5	3	8	0	0	8	0	0
12	31709964	.	G	T	5	2	7	0	0	7	0	0
12	31720799	.	C	T	20	18	38	0	3	41	0	0
12	31722593	.	G	T	12	11	23	0	2	25	0	0
12	31722811	.	G	T	5	11	16	0	0	16	0	0
12	31724245	.	A	C	15	18	33	0	3	36	0	0
12	31724252	.	C	T	15	19	34	0	4	38	0	0
12	31729236	.	G	A	1	2	3	0	0	3	0	0
12	31753752	.	C	T	1	1	2	0	0	2	0	0
12	31753755	.	C	T	1	1	2	0	0	2	0	0
12	31764523	.	T	C	7	5	12	0	3	15	0	0
12	31764526	.	C	A	7	8	15	0	0	15	0	0
12	31765407	.	G	A	11	5	16	0	0	16	0	0
12	31765485	.	G	A	6	2	8	0	1	9	0	0
12	31765517	.	T	C	7	1	8	0	0	8	0	0
12	31785314	.	C	T	0	1	1	0	0	1	0	0
12	31785545	.	G	A	3	0	3	0	1	4	0	0
12	31787394	.	G	C	2	3	5	0	0	5	0	0
12	31787752	.	T	C	3	2	5	0	0	5	0	0
12	31787760	.	A	G	3	2	5	0	0	5	0	0
12	31789799	.	C	T	9	18	27	0	0	27	0	0
12	31794655	.	G	A	1	4	5	0	0	5	0	0
12	31909921	.	T	C	0	3	3	0	0	3	0	0
12	31909926	.	T	C	0	3	3	0	1	4	0	0
12	32039443	.	C	T	0	4	4	0	12	16	0	0
12	32039527	.	A	G	7	13	20	0	2	22	0	0
12	32039546	.	G	A	12	14	26	0	1	27	0	0
12	32039635	.	A	C	17	20	37	0	2	39	0	0
12	32039678	.	C	T	21	22	43	0	2	45	0	0
12	32039937	.	G	A	16	15	31	0	4	35	0	0
12	32040093	.	G	A	23	15	38	0	0	38	0	0
12	32045155	.	G	A	12	10	22	0	4	26	0	0
12	32066061	.	C	A	6	6	12	0	0	12	0	0
12	32068470	.	C	A	2	2	4	0	1	5	0	0
12	32068700	.	A	T	4	4	8	0	0	8	0	0
12	32160839	.	A	G	4	7	11	0	0	11	0	0
12	32160971	.	T	C	3	2	5	0	1	6	0	0
12	32162411	.	T	A	4	2	6	0	1	7	0	0
12	32373637	.	G	A	2	2	4	0	0	4	0	0
12	32389692	.	C	T	1	2	3	0	1	4	0	0
12	32389713	.	G	T	1	2	3	0	0	3	0	0
12	32976148	.	T	C	0	1	1	0	0	1	0	0
12	33151402	.	G	A	0	7	7	0	5	12	0	0
12	33151453	.	C	T	6	6	12	0	2	14	0	0
12	33245427	.	G	A	6	5	11	0	3	14	0	0
12	33246010	.	A	T	7	4	11	0	0	11	0	0
12	33247295	.	T	C	17	16	33	0	2	35	0	0
12	33247611	.	T	A	14	17	31	0	0	31	0	0
12	33248025	.	G	A	0	22	22	0	29	51	0	0
12	33248193	.	C	A	36	14	50	0	1	51	0	0
12	33248343	.	G	A	1	23	24	0	26	50	0	0
12	33320944	.	C	T	1	2	3	0	2	5	0	0
12	33329791	.	C	G	1	1	2	0	0	2	0	0
12	33331496	.	C	A	7	4	11	0	5	16	0	0
12	33331541	.	A	C	0	1	1	0	3	4	0	0
12	33331691	.	T	G	5	6	11	0	1	12	0	0
12	33331724	.	C	T	12	7	19	0	0	19	0	0
12	33335714	.	A	C	15	14	29	0	2	31	0	0
12	33335739	.	C	T	10	16	26	0	2	28	0	0
12	33335770	.	G	A	0	12	12	0	17	29	0	0
12	33335904	.	T	G	16	12	28	0	1	29	0	0
12	33335949	.	C	T	20	15	35	0	1	36	0	0
12	33336044	.	T	G	23	0	23	0	27	50	0	0
12	33336073	.	G	A	0	22	22	0	19	41	0	0
12	33336203	.	G	A	17	21	38	0	2	40	0	0
12	33336271	.	G	A	0	9	9	0	19	28	0	0
12	33351018	.	T	C	11	3	14	0	0	14	0	0
12	33351173	.	T	C	1	4	5	1	0	6	0	0
12	33351174	.	T	C	2	0	2	1	3	6	0	0
12	33351441	.	T	A	2	7	9	0	0	9	0	0
12	33352709	.	A	G	1	2	3	0	0	3	0	0
12	33352742	.	G	A	1	2	3	0	0	3	0	0
12	33352862	.	C	T	1	3	4	0	0	4	0	0
12	33434946	.	G	A	1	1	2	0	0	2	0	0
12	33434970	.	C	G	1	2	3	0	0	3	0	0
12	33437562	.	A	G	0	1	1	0	0	1	0	0
12	33438250	.	G	A	0	2	2	0	2	4	0	0
12	33439860	.	C	A	1	2	3	0	1	4	0	0
12	33440022	.	C	T	4	7	11	0	0	11	0	0
12	33440025	.	T	C	4	6	10	0	0	10	0	0
12	33440135	.	A	G	5	7	12	0	1	13	0	0
12	33440146	.	A	G	5	1	6	0	6	12	0	0
12	33442578	.	C	T	6	3	9	0	1	10	0	0
12	33442675	.	G	A	1	1	2	0	0	2	0	0
12	33442924	.	G	A	3	3	6	0	0	6	0	0
12	33444839	.	T	C	6	8	14	0	2	16	0	0
12	33448124	.	T	A	12	16	28	0	0	28	0	0
12	33448253	.	C	T	15	4	19	0	2	21	0	0
12	33448411	.	C	T	3	5	8	0	0	8	0	0
12	33448418	.	C	G	2	3	5	0	1	6	0	0
12	33449047	.	G	A	13	4	17	0	0	17	0	0
12	33449229	.	T	A	13	19	32	0	0	32	0	0
12	33449902	.	T	A	9	2	11	0	2	13	0	0
12	33449924	.	A	G	13	0	13	0	7	20	0	0
12	33450194	.	G	A	0	23	23	0	18	41	0	0
12	33450332	.	T	C	12	10	22	0	4	26	0	0
12	33450368	.	T	A	9	6	15	0	3	18	0	0
12	33450429	.	G	A	5	3	8	0	1	9	0	0
12	33450435	.	A	G	3	0	3	0	5	8	0	0
12	33453353	.	T	C	5	2	7	0	1	8	0	0
12	33453699	.	G	C	1	4	5	0	1	6	0	0
12	33453734	.	T	A	2	7	9	0	0	9	0	0
12	33456652	.	T	A	0	1	1	0	0	1	0	0
12	33460859	.	A	G	3	2	5	0	1	6	0	0
12	33460960	.	T	C	1	2	3	0	0	3	0	0
12	33467556	.	A	C	0	1	1	0	1	2	0	0
12	33469083	.	T	C	1	0	1	0	0	1	0	0
12	33472148	.	A	T	1	2	3	0	0	3	0	0
12	33473481	.	G	A	0	8	8	0	15	23	0	0
12	33473486	.	C	T	15	7	22	0	1	23	0	0
12	33473678	.	A	C	10	4	14	0	0	14	0	0
12	33473844	.	C	T	2	9	11	0	1	12	0	0
12	33473874	.	A	T	1	5	6	0	0	6	0	0
12	33536637	.	A	G	4	2	6	0	0	6	0	0
12	33536717	.	C	T	2	3	5	0	0	5	0	0
12	33536722	.	A	C	3	3	6	0	0	6	0	0
12	33536754	.	A	G	3	4	7	0	0	7	0	0
12	33536881	.	A	G	1	2	3	0	0	3	0	0
12	33561661	.	C	A	3	6	9	0	1	10	0	0
12	33561662	.	C	T	4	6	10	0	0	10	0	0
12	33568017	.	A	G	7	4	11	0	2	13	0	0
12	33570318	.	G	A	4	3	7	0	1	8	0	0
12	33574748	.	G	A	6	4	10	0	1	11	0	0
12	33579159	.	C	T	0	0	0	0	1	1	0	0
12	33602776	.	C	T	13	16	29	0	0	29	0	0
12	33603386	.	G	T	3	6	9	0	3	12	0	0
12	33603611	.	C	T	12	13	25	0	1	26	0	0
12	33604298	.	A	G	6	7	13	0	1	14	0	0
12	33604364	.	C	A	1	1	2	0	0	2	0	0
12	33606087	.	C	T	0	2	2	0	1	3	0	0
12	33606114	.	A	G	3	2	5	0	0	5	0	0
12	33738927	.	T	G	4	5	9	0	0	9	0	0
12	33738956	.	A	C	5	5	10	0	0	10	0	0
12	33806756	.	C	T	1	3	4	0	0	4	0	0
12	33806766	.	T	C	4	1	5	0	0	5	0	0
12	33806819	.	T	A	5	1	6	0	0	6	0	0
12	33807078	.	G	A	1	4	5	0	0	5	0	0
12	33807135	.	C	T	0	2	2	0	0	2	0	0
12	33812809	.	C	A	0	2	2	0	2	4	0	0
12	33817399	.	A	T	10	4	14	0	1	15	0	0
12	33818654	.	A	G	7	6	13	0	0	13	0	0
12	33818925	.	C	T	1	2	3	0	0	3	0	0
12	33832529	.	G	A	1	3	4	0	0	4	0	0
12	33912518	.	G	C	0	2	2	0	5	7	0	0
12	33912635	.	T	C	2	3	5	0	0	5	0	0
12	33912656	.	C	T	3	4	7	0	0	7	0	0
12	33912758	.	C	A	2	4	6	0	1	7	0	0
12	33912946	.	C	A	2	4	6	0	0	6	0	0
12	33912982	.	G	T	2	3	5	0	0	5	0	0
12	33913000	.	G	A	3	3	6	0	1	7	0	0
12	33913578	.	G	A	0	4	4	0	6	10	0	0
12	33913698	.	T	A	2	3	5	0	0	5	0	0
12	33913705	.	T	C	3	3	6	0	0	6	0	0
12	33913759	.	G	A	2	3	5	0	1	6	0	0
12	33913805	.	C	A	2	7	9	0	0	9	0	0
12	33913964	.	T	G	2	13	15	0	0	15	0	0
12	33919640	.	T	A	2	3	5	0	0	5	0	0
12	33920826	.	T	C	7	8	15	0	0	15	0	0
12	33933979	.	C	T	14	16	30	0	1	31	0	0
12	33934082	.	G	A	0	11	11	0	10	21	0	0
12	33934099	.	G	A	1	10	11	0	11	22	0	0
12	33934768	.	G	T	15	27	42	0	0	42	0	0
12	33935010	.	C	A	12	18	30	0	0	30	0	0
12	33935019	.	G	T	0	15	15	0	14	29	0	0
12	33966470	.	G	A	10	13	23	0	2	25	0	0
12	33966499	.	C	T	0	17	17	0	16	33	0	0
12	33966790	.	T	G	14	27	41	0	4	45	0	0
12	33966905	.	C	T	20	17	37	0	0	37	0	0
12	33967283	.	C	T	1	20	21	0	3	24	0	0
12	33967618	.	T	C	2	5	7	0	0	7	0	0
12	33967897	.	A	C	1	2	3	0	0	3	0	0
12	33967918	.	A	G	6	1	7	0	0	7	0	0
12	33967968	.	T	G	9	12	21	0	1	22	0	0
12	33968027	.	T	A	10	16	26	0	3	29	0	0
12	33968073	.	T	A	15	15	30	0	4	34	0	0
12	33968145	.	C	T	9	16	25	0	1	26	0	0
12	33968419	.	C	A	0	19	19	0	19	38	0	0
12	33971333	.	G	T	1	0	1	0	0	1	0	0
12	33971461	.	T	C	1	0	1	0	1	2	0	0
12	33972294	.	G	T	3	3	6	0	1	7	0	0
12	33991521	.	G	A	19	15	34	0	1	35	0	0
12	33991622	.	T	C	12	18	30	0	1	31	0	0
12	33991781	.	T	C	23	23	46	0	0	46	0	0
12	33991867	.	A	T	30	9	39	0	0	39	0	0
12	33991882	.	T	A	13	26	39	0	0	39	0	0
12	33991987	.	A	C	26	16	42	0	2	44	0	0
12	33992376	.	A	G	9	10	19	0	0	19	0	0
12	33992418	.	G	T	17	21	38	0	1	39	0	0
12	33993152	.	A	T	12	16	28	0	4	32	0	0
12	33993320	.	C	T	0	1	1	0	1	2	0	0
12	33997285	.	C	T	1	6	7	0	0	7	0	0
12	33997303	.	T	A	4	1	5	0	0	5	0	0
12	33997324	.	G	A	0	1	1	0	0	1	0	0
12	34119531	.	T	C	1	2	3	0	0	3	0	0
12	34179962	.	C	T	1	1	2	0	1	3	0	0
12	34180040	.	C	A	2	2	4	0	0	4	0	0
12	34187335	.	C	T	3	5	8	0	1	9	0	0
12	34187341	.	G	T	0	6	6	0	4	10	0	0
12	34187407	.	A	G	3	0	3	0	6	9	0	0
12	34192041	.	G	A	0	4	4	0	4	8	0	0
12	34192454	.	C	T	6	5	11	0	0	11	0	0
12	34192551	.	C	T	8	4	12	0	0	12	0	0
12	34192679	.	T	C	6	7	13	0	1	14	0	0
12	34209402	.	T	A	2	2	4	0	0	4	0	0
12	34219445	.	A	T	2	3	5	0	0	5	0	0
12	34219670	.	C	T	0	2	2	0	4	6	0	0
12	34276004	.	T	C	1	2	3	0	0	3	0	0
12	34276956	.	G	A	2	3	5	0	0	5	0	0
12	34397054	.	T	C	2	4	6	0	0	6	0	0
12	34397086	.	G	A	2	2	4	0	0	4	0	0
12	34397102	.	C	A	1	2	3	0	0	3	0	0
12	34564322	.	T	G	2	5	7	0	0	7	0	0
12	34564786	.	G	A	4	6	10	0	0	10	0	0
12	34565787	.	T	A	3	4	7	0	0	7	0	0
12	34820214	.	G	A	0	2	2	0	3	5	0	0
12	34821374	.	T	C	1	2	3	0	0	3	0	0
12	34821765	.	G	A	1	3	4	0	1	5	0	0
12	34841886	.	A	T	1	6	7	0	0	7	0	0
12	34841939	.	A	T	2	2	4	0	0	4	0	0
12	34841952	.	A	G	1	3	4	0	0	4	0	0
12	34845793	.	T	A	5	11	16	0	0	16	0	0
12	34845923	.	C	A	2	3	5	0	0	5	0	0
12	34845942	.	A	G	4	4	8	0	1	9	0	0
12	34846091	.	G	A	4	9	13	0	0	13	0	0
12	34846175	.	A	G	5	10	15	0	0	15	0	0
12	34846191	.	A	G	6	12	18	0	0	18	0	0
12	34846254	.	A	G	7	4	11	0	2	13	0	0
12	34846577	.	A	G	2	3	5	0	0	5	0	0
12	34846578	.	T	C	3	2	5	0	0	5	0	0
12	34846732	.	G	A	2	2	4	0	1	5	0	0
12	34847091	.	T	A	1	4	5	0	0	5	0	0
12	34847137	.	T	C	1	4	5	0	0	5	0	0
12	34847139	.	G	T	1	4	5	0	0	5	0	0
12	34847211	.	G	A	2	2	4	0	0	4	0	0
12	34847247	.	T	C	3	5	8	0	1	9	0	0
12	34847446	.	C	G	8	7	15	0	2	17	0	0
12	34851117	.	G	A	1	3	4	0	0	4	0	0
12	34876420	.	G	A	1	3	4	0	0	4	0	0
12	34876837	.	G	A	2	2	4	0	0	4	0	0
12	34877064	.	G	A	2	3	5	0	2	7	0	0
12	34891780	.	G	A	1	3	4	0	7	11	0	0
12	34891911	.	A	T	2	4	6	0	1	7	0	0
12	34892024	.	A	G	7	4	11	0	0	11	0	0
12	34892087	.	C	A	4	3	7	0	0	7	0	0
12	35012004	.	C	T	5	4	9	0	2	11	0	0
12	35012127	.	T	C	3	5	8	0	0	8	0	0
12	35018127	.	C	T	13	19	32	0	1	33	0	0
12	35018320	.	T	G	11	1	12	0	8	20	0	0
12	35021590	.	G	T	0	2	2	0	1	3	0	0
12	35021593	.	G	A	1	2	3	0	0	3	0	0
12	35051265	.	C	T	13	11	24	0	3	27	0	0
12	35085641	.	A	G	1	2	3	0	0	3	0	0
12	35099532	.	G	T	2	3	5	0	1	6	0	0
12	35103300	.	C	T	2	5	7	0	0	7	0	0
12	35167333	.	A	G	1	0	1	0	0	1	0	0
12	35178914	.	G	A	1	2	3	0	0	3	0	0
12	35189264	.	G	T	1	1	2	0	0	2	0	0
12	35191841	.	T	A	7	4	11	0	0	11	0	0
12	35191856	.	C	T	3	5	8	0	2	10	0	0
12	35328139	.	C	T	1	2	3	0	1	4	0	0
12	35334652	.	C	G	0	3	3	0	0	3	0	0
12	35339212	.	A	G	4	2	6	0	0	6	0	0
12	35339395	.	C	T	3	2	5	0	1	6	0	0
12	35346498	.	G	A	8	31	39	0	2	41	0	0
12	35346597	.	A	T	29	21	50	0	9	59	0	0
12	35346842	.	T	C	14	21	35	0	2	37	0	0
12	35346873	.	C	T	18	25	43	0	3	46	0	0
12	35347002	.	A	T	24	21	45	0	3	48	0	0
12	35347078	.	G	A	27	23	50	0	1	51	0	0
12	35347084	.	C	T	0	27	27	0	26	53	0	0
12	35347318	.	C	T	22	18	40	0	2	42	0	0
12	35347485	.	T	G	21	14	35	0	4	39	0	0
12	35347795	.	C	T	0	8	8	0	6	14	0	0
12	35347951	.	A	G	19	13	32	0	2	34	0	0
12	35350686	.	G	A	7	18	25	0	3	28	0	0
12	35351392	.	G	T	1	3	4	0	0	4	0	0
12	35386919	.	A	G	2	4	6	0	3	9	0	0
12	35543736	.	T	G	7	14	21	0	2	23	0	0
12	35543971	.	T	G	12	14	26	0	1	27	0	0
12	35544320	.	T	G	11	6	17	0	0	17	0	0
12	35544460	.	A	G	6	7	13	0	0	13	0	0
12	35544596	.	C	A	5	7	12	0	0	12	0	0
12	35544968	.	A	G	13	6	19	0	1	20	0	0
12	35551120	.	G	A	2	1	3	0	0	3	0	0
12	35559614	.	T	G	2	1	3	0	0	3	0	0
12	35593188	.	C	T	15	19	34	0	0	34	0	0
12	35593469	.	T	A	10	6	16	0	1	17	0	0
12	35594069	.	T	A	17	10	27	0	0	27	0	0
12	35594154	.	C	T	13	5	18	0	5	23	0	0
12	35594169	.	C	T	13	6	19	0	3	22	0	0
12	35594436	.	C	T	16	7	23	0	0	23	0	0
12	35594474	.	A	G	21	9	30	0	1	31	0	0
12	35594495	.	G	A	0	10	10	0	20	30	0	0
12	35594512	.	T	C	17	13	30	0	2	32	0	0
12	35594541	.	C	A	12	9	21	0	2	23	0	0
12	35594605	.	C	T	22	13	35	0	2	37	0	0
12	35594623	.	T	A	17	16	33	0	2	35	0	0
12	35670309	.	T	A	8	6	14	0	0	14	0	0
12	35670324	.	C	T	9	4	13	0	1	14	0	0
12	35674952	.	G	A	4	6	10	0	3	13	0	0
12	35689209	.	C	T	3	2	5	0	1	6	0	0
12	35689210	.	A	G	4	2	6	0	0	6	0	0
12	35704426	.	G	T	15	14	29	0	4	33	0	0
12	35704435	.	G	T	14	14	28	0	5	34	1	0
12	35704735	.	A	G	4	3	7	0	0	7	0	0
12	35704921	.	A	C	12	9	21	0	3	24	0	0
12	35704996	.	T	G	16	10	26	0	2	28	0	0
12	35705131	.	C	T	17	6	23	0	3	26	0	0
12	35705140	.	A	C	18	0	18	0	7	25	0	0
12	35705224	.	A	G	10	9	19	0	1	20	0	0
12	35705252	.	T	G	14	10	24	0	1	25	0	0
12	35705323	.	G	A	10	12	22	0	1	23	0	0
12	35705367	.	C	T	0	13	13	0	9	22	0	0
12	35705606	.	A	T	2	8	10	0	1	11	0	0
12	35705661	.	T	C	5	6	11	0	1	12	0	0
12	35705926	.	C	T	12	12	24	0	2	26	0	0
12	35706091	.	C	T	9	5	14	0	2	16	0	0
12	35706124	.	A	G	9	7	16	0	1	17	0	0
12	35706253	.	A	T	4	7	11	0	2	13	0	0
12	35706304	.	A	G	4	7	11	0	0	11	0	0
12	35706524	.	G	A	7	10	17	0	0	17	0	0
12	35706568	.	C	T	8	6	14	0	0	14	0	0
12	35706859	.	C	T	0	5	5	0	5	10	0	0
12	35706970	.	G	T	4	3	7	0	0	7	0	0
12	35707155	.	C	T	3	6	9	0	1	10	0	0
12	35707171	.	T	C	2	8	10	0	1	11	0	0
12	35707225	.	G	A	1	5	6	0	0	6	0	0
12	35707537	.	A	G	3	3	6	0	0	6	0	0
12	35707660	.	A	C	2	2	4	0	0	4	0	0
12	35707987	.	G	A	1	1	2	0	1	3	0	0
12	35708139	.	T	G	1	2	3	0	0	3	0	0
12	35708235	.	A	G	5	4	9	0	0	9	0	0
12	35708950	.	G	A	3	1	4	0	0	4	0	0
12	35710837	.	T	C	2	1	3	0	0	3	0	0
12	35740605	.	G	T	0	1	1	0	0	1	0	0
12	35837425	.	T	A	6	7	13	0	0	13	0	0
12	35837468	.	C	A	6	7	13	0	2	15	0	0
12	35837499	.	G	C	6	4	10	0	2	12	0	0
12	35837503	.	T	G	6	6	12	0	1	13	0	0
12	35837629	.	T	A	3	3	6	0	0	6	0	0
12	35837751	.	G	A	3	6	9	0	2	11	0	0
12	35837828	.	T	A	8	3	11	0	0	11	0	0
12	35837842	.	G	A	6	2	8	0	0	8	0	0
12	35838070	.	T	A	3	3	6	0	2	8	0	0
12	35838882	.	A	C	4	3	7	0	0	7	0	0
12	35839063	.	A	T	3	8	11	0	1	12	0	0
12	35839261	.	C	A	4	5	9	0	0	9	0	0
12	35839879	.	C	A	0	4	4	0	4	8	0	0
12	35840360	.	C	T	2	2	4	0	0	4	0	0
12	35840369	.	T	A	1	2	3	0	0	3	0	0
12	35840543	.	A	C	4	3	7	0	0	7	0	0
12	35847493	.	A	T	1	0	1	0	0	1	0	0
12	35868203	.	A	G	0	1	1	0	0	1	0	0
12	35963575	.	T	C	7	3	10	0	0	10	0	0
12	35980758	.	C	T	2	7	9	0	1	10	0	0
12	35980764	.	T	C	3	7	10	0	0	10	0	0
12	35980817	.	T	A	3	2	5	0	0	5	0	0
12	35981206	.	T	C	5	0	5	0	13	18	0	0
12	35981260	.	T	A	3	12	15	0	0	15	0	0
12	35981303	.	T	G	4	5	9	0	1	10	0	0
12	35981304	.	G	C	4	6	10	0	0	10	0	0
12	35981478	.	A	G	4	5	9	0	0	9	0	0
12	35981627	.	C	T	5	5	10	0	1	11	0	0
12	35981713	.	C	T	0	13	13	0	7	20	0	0
12	35981795	.	T	A	4	11	15	0	0	15	0	0
12	35981832	.	A	G	4	6	10	0	2	12	0	0
12	35988544	.	A	G	3	2	5	0	0	5	0	0
12	35988553	.	G	A	3	2	5	0	0	5	0	0
12	36105341	.	A	G	2	2	4	0	0	4	0	0
12	36158056	.	A	C	9	5	14	0	1	15	0	0
12	36158098	.	G	C	18	10	28	0	2	30	0	0
12	36158099	.	T	C	19	10	29	0	1	30	0	0
12	36158225	.	T	C	6	22	28	0	0	28	0	0
12	36158349	.	G	A	0	14	14	0	6	20	0	0
12	36158538	.	C	T	7	9	16	0	0	16	0	0
12	36159597	.	C	G	7	8	15	0	0	15	0	0
12	36416669	.	T	C	1	1	2	0	0	2	0	0
12	36416675	.	T	C	1	1	2	0	0	2	0	0
12	36422537	.	A	G	0	3	3	0	0	3	0	0
12	36424613	.	G	A	4	4	8	0	1	9	0	0
12	36424618	.	G	A	5	5	10	0	0	10	0	0
12	36462038	.	G	A	1	1	2	0	0	2	0	0
12	36670336	.	A	C	4	2	6	0	0	6	0	0
12	36670513	.	C	A	2	2	4	0	0	4	0	0
12	36670549	.	C	G	3	2	5	0	0	5	0	0
12	36671019	.	T	C	1	3	4	0	0	4	0	0
12	36671560	.	C	T	2	1	3	0	1	4	0	0
12	36891583	.	C	T	5	2	7	0	0	7	0	0
12	36895025	.	A	G	2	6	8	0	0	8	0	0
12	36895057	.	T	C	1	4	5	0	0	5	0	0
12	36895067	.	G	A	3	3	6	0	0	6	0	0
12	36960197	.	T	C	2	7	9	0	2	11	0	0
12	36960200	.	A	T	2	8	10	0	0	10	0	0
12	37003332	.	A	G	2	2	4	0	0	4	0	0
12	37003460	.	T	C	2	2	4	0	0	4	0	0
12	37005350	.	T	C	1	3	4	0	0	4	0	0
12	37275898	.	T	C	0	3	3	0	1	4	0	0
12	37275901	.	T	C	1	3	4	0	0	4	0	0
12	37408893	.	T	C	3	2	5	0	0	5	0	0
12	38556545	.	A	G	2	2	4	0	0	4	0	0
12	38556562	.	G	T	3	3	6	0	0	6	0	0
12	38561258	.	C	A	0	1	1	0	0	1	0	0
12	38802875	.	T	C	3	2	5	0	1	6	0	0
12	38803649	.	G	C	2	3	5	0	0	5	0	0
12	38804005	.	G	T	3	3	6	0	1	7	0	0
12	38804027	.	A	G	3	3	6	0	0	6	0	0
12	38804185	.	T	C	3	3	6	0	0	6	0	0
12	38804214	.	G	A	1	2	3	0	0	3	0	0
12	38804561	.	C	G	4	3	7	0	0	7	0	0
12	39744954	.	G	C	0	1	1	0	4	5	0	0
12	40502610	.	G	A	0	2	2	0	4	6	0	0
12	40518088	.	C	T	7	9	16	0	1	17	0	0
12	40518094	.	T	C	5	10	15	0	2	17	0	0
12	40518217	.	C	T	8	6	14	0	2	16	0	0
12	41437046	.	G	A	0	2	2	0	0	2	0	0
12	41461051	.	C	T	4	1	5	0	0	5	0	0
12	41467003	.	C	T	11	6	17	0	1	18	0	0
12	41467207	.	C	A	9	10	19	0	0	19	0	0
12	41528206	.	C	T	1	1	2	0	0	2	0	0
12	41528230	.	A	T	1	1	2	0	0	2	0	0
12	41535830	.	G	A	0	1	1	0	2	3	0	0
12	41535886	.	A	C	2	4	6	0	0	6	0	0
12	41535898	.	C	T	2	3	5	0	0	5	0	0
12	41535937	.	T	A	1	1	2	0	0	2	0	0
12	41539464	.	G	A	3	2	5	0	0	5	0	0
12	41549214	.	G	A	0	2	2	0	5	7	0	0
12	41549386	.	G	A	1	1	2	0	0	2	0	0
12	41549404	.	C	G	3	1	4	0	1	5	0	0
12	41549434	.	C	G	5	6	11	0	0	11	0	0
12	41549443	.	A	G	4	0	4	0	8	12	0	0
12	41580940	.	G	T	6	7	13	0	0	13	0	0
12	41581092	.	A	G	17	3	20	0	3	23	0	0
12	41584666	.	G	A	6	5	11	0	2	13	0	0
12	41584755	.	C	T	6	3	9	0	1	10	0	0
12	41589789	.	T	G	4	7	11	0	0	11	0	0
12	41606683	.	T	C	2	0	2	0	4	6	0	0
12	41606686	.	G	T	2	4	6	0	1	7	0	0
12	41618820	.	G	A	1	1	2	0	0	2	0	0
12	41631703	.	A	T	5	8	13	0	1	14	0	0
12	41631964	.	C	G	22	9	31	0	1	32	0	0
12	41643214	.	C	T	3	3	6	0	0	6	0	0
12	41643217	.	G	A	3	3	6	0	0	6	0	0
12	41647273	.	T	C	3	0	3	0	0	3	0	0
12	41653155	.	C	T	5	3	8	0	1	9	0	0
12	41653678	.	A	G	7	8	15	0	0	15	0	0
12	41656554	.	G	A	1	4	5	0	1	6	0	0
12	41698040	.	A	T	9	13	22	0	1	23	0	0
12	41698070	.	T	A	11	10	21	0	1	22	0	0
12	41702044	.	A	C	1	5	6	0	0	6	0	0
12	41723165	.	A	T	0	6	6	0	1	7	0	0
12	41723189	.	G	A	6	2	8	0	2	10	0	0
12	41723608	.	T	A	15	12	27	0	0	27	0	0
12	41732013	.	C	T	0	1	1	0	2	3	0	0
12	41735790	.	T	C	2	3	5	0	0	5	0	0
12	41739297	.	G	T	1	1	2	0	0	2	0	0
12	46630201	.	A	G	0	2	2	0	0	2	0	0
12	47291529	.	G	C	0	1	1	0	0	1	0	0
12	47291703	.	G	A	2	2	4	0	0	4	0	0
12	47295939	.	C	T	0	2	2	0	0	2	0	0
12	47302828	.	C	T	0	1	1	0	0	1	0	0
12	47302831	.	G	A	0	1	1	0	0	1	0	0
12	47331864	.	C	T	5	2	7	0	2	9	0	0
12	47332185	.	A	G	6	6	12	0	2	14	0	0
12	47332326	.	C	A	7	12	19	0	2	21	0	0
12	47332389	.	G	A	5	12	17	0	2	19	0	0
12	47332575	.	A	G	5	10	15	0	1	16	0	0
12	47332635	.	G	A	7	17	24	0	1	25	0	0
12	47332827	.	C	T	13	11	24	0	0	24	0	0
12	47335257	.	C	T	3	5	8	0	1	9	0	0
12	47335472	.	C	T	2	3	5	0	1	6	0	0
12	47344423	.	T	C	11	21	32	0	1	33	0	0
12	47347875	.	C	T	4	1	5	0	0	5	0	0
12	47448986	.	C	T	1	6	7	0	0	7	0	0
12	47449481	.	C	T	2	2	4	0	0	4	0	0
12	47449997	.	G	A	2	3	5	0	2	7	0	0
12	47461255	.	G	A	1	0	1	0	0	1	0	0
12	47480299	.	A	C	2	0	2	0	1	3	0	0
12	47480404	.	G	A	3	5	8	0	1	9	0	0
12	47480469	.	A	T	4	3	7	0	2	9	0	0
12	47480536	.	A	C	4	6	10	0	0	10	0	0
12	47480565	.	T	A	3	8	11	0	0	11	0	0
12	47480728	.	A	G	2	0	2	0	17	19	0	0
12	47480731	.	T	A	3	12	15	0	4	19	0	0
12	47481112	.	T	G	6	11	17	0	2	19	0	0
12	47481229	.	G	C	0	3	3	0	9	12	0	0
12	47481611	.	G	A	11	1	12	0	0	12	0	0
12	47510101	.	T	C	4	4	8	0	0	8	0	0
12	47523795	.	A	C	11	7	18	0	1	19	0	0
12	47540933	.	T	C	19	20	39	0	2	41	0	0
12	47540934	.	C	T	16	18	34	0	7	41	0	0
12	47540999	.	A	C	8	16	24	0	3	27	0	0
12	47543959	.	G	T	2	4	6	0	0	6	0	0
12	47544354	.	C	A	0	2	2	0	2	4	0	0
12	47544543	.	A	G	0	2	2	0	0	2	0	0
12	47922396	.	C	T	1	1	2	0	0	2	0	0
12	47959651	.	C	A	2	2	4	0	0	4	0	0
12	48094399	.	A	T	5	6	11	0	1	12	0	0
12	48118470	.	A	C	1	2	3	0	0	3	0	0
12	48118901	.	A	G	1	1	2	0	1	3	0	0
12	48119048	.	G	A	2	2	4	0	1	5	0	0
12	48119153	.	T	G	2	7	9	0	0	9	0	0
12	48137949	.	G	A	2	1	3	0	0	3	0	0
12	48157135	.	G	A	3	4	7	0	0	7	0	0
12	48161625	.	C	T	0	1	1	0	0	1	0	0
12	48168085	.	G	A	1	1	2	0	0	2	0	0
12	48168094	.	G	A	1	1	2	0	0	2	0	0
12	48211906	.	T	C	1	0	1	0	0	1	0	0
12	48216789	.	A	T	0	2	2	0	1	3	0	0
12	48220624	.	C	G	3	7	10	0	0	10	0	0
12	48228265	.	A	C	2	0	2	0	0	2	0	0
12	48231039	.	G	A	0	6	6	0	4	10	0	0
12	48231108	.	G	T	7	5	12	0	1	13	0	0
12	48239927	.	C	T	4	1	5	0	0	5	0	0
12	48240061	.	A	C	1	1	2	0	2	4	0	0
12	48312526	.	G	A	2	2	4	0	0	4	0	0
12	48312530	.	G	A	2	2	4	0	0	4	0	0
12	48327550	.	T	G	9	8	17	0	3	20	0	0
12	48340578	.	G	A	5	2	7	0	0	7	0	0
12	48341936	.	G	A	1	10	11	0	10	21	0	0
12	48349836	.	C	T	0	4	4	0	8	12	0	0
12	48367360	.	C	T	0	6	6	0	9	15	0	0
12	48367442	.	T	G	1	0	1	0	0	1	0	0
12	48419867	.	C	T	0	3	3	0	2	5	0	0
12	48440345	.	A	G	0	2	2	0	1	3	0	0
12	48469825	.	C	T	26	9	35	0	2	37	0	0
12	48470519	.	T	C	1	2	3	0	1	4	0	0
12	48476965	.	A	T	12	11	23	0	7	30	0	0
12	48522722	.	C	T	0	3	3	0	0	3	0	0
12	48619421	.	C	T	0	1	1	0	0	1	0	0
12	48680110	.	C	G	0	1	1	0	1	2	0	0
12	48680163	.	A	T	1	2	3	0	0	3	0	0
12	48682002	.	A	G	5	2	7	0	0	7	0	0
12	48682089	.	G	T	4	4	8	0	0	8	0	0
12	48682530	.	G	C	11	5	16	0	1	17	0	0
12	48682701	.	C	T	1	2	3	0	0	3	0	0
12	48796831	.	C	T	1	6	7	0	0	7	0	0
12	48799261	.	C	T	3	7	10	0	0	10	0	0
12	48810338	.	C	T	1	4	5	0	1	6	0	0
12	48810557	.	G	T	0	10	10	0	15	25	0	0
12	48810558	.	C	T	12	10	22	0	3	25	0	0
12	48810865	.	C	T	10	7	17	0	0	17	0	0
12	48811035	.	T	C	13	9	22	0	5	27	0	0
12	48826364	.	C	T	0	1	1	0	1	2	0	0
12	48826626	.	G	A	2	2	4	0	2	6	0	0
12	48828431	.	G	A	0	4	4	0	4	8	0	0
12	48828461	.	C	T	2	2	4	0	0	4	0	0
12	48828467	.	G	A	0	1	1	0	2	3	0	0
12	48833090	.	T	C	0	1	1	0	0	1	0	0
12	48833165	.	C	T	1	1	2	0	0	2	0	0
12	48836482	.	G	A	10	9	19	0	0	19	0	0
12	48959393	.	A	G	1	5	6	0	0	6	0	0
12	48959630	.	G	A	1	7	8	0	1	9	0	0
12	48979161	.	T	C	3	0	3	0	5	8	0	0
12	48979219	.	T	C	3	0	3	0	8	11	0	0
12	48979234	.	T	C	4	0	4	0	6	10	0	0
12	48979609	.	C	T	0	5	5	0	7	12	0	0
12	48979648	.	C	T	3	3	6	0	1	7	0	0
12	48982536	.	T	C	2	0	2	0	5	7	0	0
12	48982539	.	C	T	0	5	5	0	2	7	0	0
12	49004058	.	C	T	0	9	9	0	4	13	0	0
12	49004071	.	C	T	0	5	5	0	2	7	0	0
12	49005119	.	G	T	4	4	8	0	1	9	0	0
12	49005150	.	T	C	2	3	5	0	0	5	0	0
12	49008358	.	G	T	1	2	3	0	0	3	0	0
12	49010732	.	C	T	2	3	5	0	0	5	0	0
12	49035269	.	C	T	1	0	1	0	0	1	0	0
12	49037439	.	C	A	2	2	4	0	0	4	0	0
12	49037568	.	G	A	0	4	4	0	6	10	0	0
12	49114550	.	G	T	0	11	11	0	13	24	0	0
12	49125725	.	C	A	1	2	3	0	0	3	0	0
12	49125898	.	C	T	3	3	6	0	0	6	0	0
12	49125949	.	A	G	3	2	5	0	0	5	0	0
12	49148399	.	A	G	1	1	2	0	0	2	0	0
12	49157914	.	T	C	2	0	2	0	17	19	0	0
12	49158090	.	T	C	10	0	10	0	6	16	0	0
12	49160120	.	G	A	1	2	3	0	0	3	0	0
12	49166926	.	C	T	11	7	18	0	1	19	0	0
13	10935	.	C	T	4	4	8	0	0	8	0	0
13	11043	.	G	C	8	5	13	0	0	13	0	0
13	12252	.	C	G	1	2	3	0	1	4	0	0
13	40868	.	A	T	2	13	15	0	0	15	0	0
13	40965	.	T	G	5	9	14	0	3	17	0	0
13	41161	.	C	T	0	4	4	0	0	4	0	0
13	46625	.	T	C	14	2	16	0	15	31	0	0
13	46637	.	G	A	16	12	28	0	2	30	0	0
13	49070	.	T	G	6	2	8	0	0	8	0	0
13	214111	.	C	G	4	2	6	0	0	6	0	0
13	216562	.	A	G	10	20	30	0	3	33	0	0
13	217848	.	A	C	8	8	16	0	1	17	0	0
13	220842	.	T	C	9	1	10	0	11	22	1	0
13	220874	.	T	A	7	17	24	0	1	25	0	0
13	221131	.	C	A	12	16	28	0	1	29	0	0
13	221478	.	G	C	14	14	28	0	0	28	0	0
13	236612	.	G	A	2	2	4	0	1	5	0	0
13	237954	.	T	C	1	4	5	0	0	5	0	0
13	269861	.	C	T	0	4	4	0	4	8	0	0
13	270083	.	G	A	12	11	23	0	1	24	0	0
13	270110	.	C	T	0	9	9	0	14	23	0	0
13	281330	.	T	C	21	21	42	0	1	43	0	0
13	321752	.	C	T	0	5	5	0	4	9	0	0
13	325797	.	G	A	1	5	6	0	0	6	0	0
13	329835	.	G	C	0	1	1	0	1	2	0	0
13	329876	.	C	T	5	7	12	0	0	12	0	0
13	329922	.	G	A	5	2	7	0	0	7	0	0
13	343143	.	T	C	1	0	1	0	8	9	0	0
13	343243	.	T	G	6	4	10	0	0	10	0	0
13	343510	.	C	T	0	2	2	0	2	4	0	0
13	353686	.	C	T	3	7	10	0	1	11	0	0
13	421350	.	G	T	0	6	6	0	7	13	0	0
13	422990	.	T	C	3	1	4	0	1	5	0	0
13	428646	.	G	A	5	7	12	0	0	12	0	0
13	428766	.	C	T	15	7	22	0	2	24	0	0
13	428841	.	C	T	11	12	23	0	2	25	0	0
13	429087	.	C	T	17	16	33	0	1	34	0	0
13	429429	.	A	G	10	0	10	0	26	36	0	0
13	429514	.	C	T	13	15	28	0	1	29	0	0
13	429846	.	C	A	15	20	35	0	1	36	0	0
13	450040	.	C	T	0	7	7	0	5	12	0	0
13	450101	.	C	T	6	11	17	0	3	20	0	0
13	452598	.	C	A	3	8	11	0	0	11	0	0
13	452615	.	G	T	7	3	10	0	2	12	0	0
13	454846	.	C	A	0	6	6	0	2	8	0	0
13	454919	.	A	G	1	4	5	0	0	5	0	0
13	455473	.	G	A	1	4	5	0	1	6	0	0
13	458513	.	G	A	1	1	2	0	0	2	0	0
13	460821	.	C	T	0	2	2	0	2	4	0	0
13	460845	.	C	T	2	1	3	0	0	3	0	0
13	460875	.	G	A	0	1	1	0	0	1	0	0
13	463687	.	C	T	0	2	2	0	0	2	0	0
13	465329	.	T	A	2	0	2	0	0	2	0	0
13	466475	.	G	A	1	2	3	0	0	3	0	0
13	489773	.	T	C	1	2	3	0	0	3	0	0
13	514385	.	C	T	18	10	28	0	1	29	0	0
13	514664	.	G	A	8	9	17	0	2	19	0	0
13	514790	.	T	A	3	7	10	0	0	10	0	0
13	516347	.	G	C	6	4	10	0	0	10	0	0
13	516358	.	T	G	6	4	10	0	1	11	0	0
13	517163	.	G	T	4	7	11	0	0	11	0	0
13	518113	.	T	C	4	2	6	0	6	12	0	0
13	518915	.	G	A	4	2	6	0	1	7	0	0
13	522036	.	G	T	0	4	4	0	1	5	0	0
13	533133	.	T	A	2	3	5	0	1	6	0	0
13	555325	.	C	T	16	16	32	0	0	32	0	0
13	555326	.	G	A	16	16	32	0	0	32	0	0
13	555751	.	C	G	3	5	8	0	13	21	0	0
13	555770	.	A	T	10	10	20	0	3	23	0	0
13	555889	.	T	C	1	3	4	0	0	4	0	0
13	556572	.	A	G	4	6	10	0	1	11	0	0
13	556601	.	A	T	6	6	12	0	1	13	0	0
13	556658	.	C	A	5	2	7	0	0	7	0	0
13	556729	.	G	T	1	7	8	0	0	8	0	0
13	561575	.	T	A	1	1	2	0	0	2	0	0
13	561587	.	A	T	1	1	2	0	0	2	0	0
13	562966	.	C	T	0	0	0	0	1	1	0	0
13	565622	.	C	T	0	2	2	0	2	4	0	0
13	566019	.	G	A	1	3	4	0	0	4	0	0
13	566046	.	G	A	1	3	4	0	0	4	0	0
13	566569	.	G	A	1	1	2	0	0	2	0	0
13	658800	.	G	A	0	2	2	0	5	7	0	0
13	658872	.	C	T	1	5	6	0	1	7	0	0
13	660535	.	C	T	1	0	1	0	0	1	0	0
13	662635	.	C	A	1	4	5	0	3	8	0	0
13	662727	.	G	A	0	1	1	0	0	1	0	0
13	663532	.	T	A	3	6	9	0	3	12	0	0
13	663558	.	T	A	8	5	13	0	1	14	0	0
13	663573	.	G	A	0	10	10	0	4	14	0	0
13	663719	.	C	T	3	3	6	0	0	6	0	0
13	663896	.	A	G	3	3	6	0	0	6	0	0
13	664012	.	G	A	3	6	9	0	0	9	0	0
13	664139	.	C	T	5	1	6	0	0	6	0	0
13	664143	.	C	T	5	1	6	0	0	6	0	0
13	664196	.	A	G	3	0	3	0	9	12	0	0
13	664307	.	G	A	4	2	6	0	0	6	0	0
13	709673	.	C	T	2	2	4	0	0	4	0	0
13	710018	.	A	G	0	0	0	0	5	5	0	0
13	710042	.	C	T	1	5	6	0	1	7	0	0
13	715867	.	G	A	1	4	5	0	0	5	0	0
13	715883	.	C	G	1	0	1	0	3	4	0	0
13	719316	.	C	T	5	3	8	0	0	8	0	0
13	719334	.	C	G	2	1	3	0	0	3	0	0
13	721290	.	C	T	6	9	15	0	0	15	0	0
13	721332	.	G	A	12	12	24	0	0	24	0	0
13	721617	.	C	T	1	3	4	0	1	5	0	0
13	724060	.	A	G	5	0	5	0	10	15	0	0
13	724194	.	A	G	4	2	6	0	0	6	0	0
13	724296	.	A	T	1	2	3	0	0	3	0	0
13	760298	.	C	T	2	3	5	0	0	5	0	0
13	761135	.	C	T	2	2	4	0	1	5	0	0
13	761228	.	A	T	0	1	1	0	0	1	0	0
13	762321	.	T	C	1	1	2	0	0	2	0	0
13	762322	.	G	A	0	1	1	0	1	2	0	0
13	793631	.	C	T	3	1	4	0	0	4	0	0
13	802925	.	C	T	3	1	4	0	0	4	0	0
13	808334	.	A	G	4	4	8	0	0	8	0	0
13	808461	.	G	A	1	2	3	0	0	3	0	0
13	808530	.	A	C	7	4	11	0	0	11	0	0
13	808638	.	G	A	8	4	12	0	0	12	0	0
13	808648	.	G	A	5	6	11	0	1	12	0	0
13	809615	.	G	T	2	6	8	0	1	9	0	0
13	809620	.	T	C	6	3	9	0	0	9	0	0
13	809779	.	A	G	4	6	10	0	0	10	0	0
13	809808	.	A	G	2	10	12	0	0	12	0	0
13	809992	.	C	T	6	5	11	0	1	12	0	0
13	810008	.	G	C	4	6	10	0	1	11	0	0
13	810120	.	T	G	2	5	7	0	0	7	0	0
13	810621	.	C	T	3	5	8	0	0	8	0	0
13	810726	.	C	T	3	1	4	0	2	6	0	0
13	813926	.	C	T	2	8	10	0	0	10	0	0
13	813930	.	G	T	2	6	8	0	1	9	0	0
13	814038	.	G	A	7	12	19	0	1	20	0	0
13	814191	.	G	C	7	6	13	0	0	13	0	0
13	814290	.	G	C	10	5	15	0	1	16	0	0
13	814459	.	G	A	3	6	9	0	1	10	0	0
13	814501	.	T	C	6	6	12	0	0	12	0	0
13	814719	.	G	A	6	7	13	0	0	13	0	0
13	817238	.	G	A	1	3	4	0	0	4	0	0
13	826134	.	A	G	20	14	34	0	6	40	0	0
13	854419	.	G	A	1	3	4	0	0	4	0	0
13	854458	.	T	C	1	3	4	0	0	4	0	0
13	854627	.	G	A	4	4	8	0	0	8	0	0
13	912212	.	C	T	6	2	8	0	0	8	0	0
13	949809	.	T	C	1	1	2	0	0	2	0	0
13	949824	.	C	T	3	1	4	0	0	4	0	0
13	950859	.	T	C	2	4	6	0	0	6	0	0
13	957336	.	A	C	4	8	12	0	0	12	0	0
13	977619	.	A	G	9	5	14	0	0	14	0	0
13	1096613	.	C	G	3	5	8	0	0	8	0	0
13	1115091	.	C	T	10	11	21	0	1	22	0	0
13	1115106	.	C	T	6	8	14	0	3	17	0	0
13	1125197	.	C	T	1	6	7	0	0	7	0	0
13	1125199	.	C	A	1	5	6	0	1	7	0	0
13	1125292	.	T	A	13	7	20	0	3	23	0	0
13	1125331	.	G	C	17	6	23	0	2	25	0	0
13	1129255	.	G	C	3	5	8	0	0	8	0	0
13	1129261	.	T	C	2	4	6	0	0	6	0	0
13	1129902	.	T	C	13	12	25	0	0	25	0	0
13	1135581	.	G	A	0	1	1	0	0	1	0	0
13	1135584	.	A	C	0	1	1	0	0	1	0	0
13	1137920	.	A	G	2	0	2	0	0	2	0	0
13	1140590	.	T	C	5	6	11	0	0	11	0	0
13	1140591	.	G	T	0	4	4	0	7	11	0	0
13	1140659	.	C	G	3	9	12	0	0	12	0	0
13	1140941	.	C	T	9	2	11	0	0	11	0	0
13	1140987	.	G	T	5	2	7	0	0	7	0	0
13	1142839	.	C	A	0	8	8	0	16	25	1	0
13	1142841	.	T	A	13	8	21	0	4	25	0	0
13	1142918	.	G	A	7	23	30	0	6	36	0	0
13	1146062	.	A	G	1	0	1	0	0	1	0	0
13	1146101	.	C	T	8	7	15	0	2	17	0	0
13	1374626	.	C	T	1	2	3	0	0	3	0	0
13	1374773	.	T	C	3	2	5	0	1	6	0	0
13	1394582	.	G	C	4	2	6	0	0	6	0	0
13	1394938	.	G	A	0	3	3	0	3	6	0	0
13	1394941	.	G	A	3	3	6	0	0	6	0	0
13	1415315	.	C	G	0	4	4	0	9	13	0	0
13	1415511	.	A	T	10	3	13	0	0	13	0	0
13	1416074	.	C	A	2	4	6	0	0	6	0	0
13	1416098	.	G	A	2	6	8	0	0	8	0	0
13	1422111	.	G	A	0	4	4	0	0	4	0	0
13	1423520	.	G	A	2	1	3	0	0	3	0	0
13	1423568	.	G	A	1	2	3	0	0	3	0	0
13	1575388	.	C	T	2	2	4	0	0	4	0	0
13	1575390	.	G	A	2	2	4	0	0	4	0	0
13	1585203	.	C	T	0	2	2	0	0	2	0	0
13	1588073	.	T	C	1	3	4	0	0	4	0	0
13	1595642	.	G	A	0	1	1	0	1	2	0	0
13	1595749	.	T	C	1	3	4	0	0	4	0	0
13	1595938	.	A	G	2	2	4	0	0	4	0	0
13	1599692	.	A	G	3	4	7	0	0	7	0	0
13	1600264	.	T	A	1	4	5	0	0	5	0	0
13	1600582	.	G	T	0	5	5	0	4	9	0	0
13	1627605	.	G	A	0	1	1	0	0	1	0	0
13	1632106	.	G	A	5	4	9	0	0	9	0	0
13	1641762	.	C	T	1	2	3	0	0	3	0	0
13	1643933	.	C	T	3	3	6	0	0	6	0	0
13	1648470	.	G	A	2	6	8	0	0	8	0	0
13	1649725	.	C	T	4	5	9	0	1	10	0	0
13	1650938	.	G	C	2	6	8	0	0	8	0	0
13	1651727	.	C	T	1	0	1	0	0	1	0	0
13	1655426	.	T	C	6	5	11	0	0	11	0	0
13	1655767	.	T	C	0	2	2	0	0	2	0	0
13	1655905	.	G	A	1	7	8	0	1	9	0	0
13	1661740	.	A	G	1	3	4	0	0	4	0	0
13	1666451	.	T	C	1	0	1	0	0	1	0	0
13	1667865	.	T	A	6	12	18	0	0	18	0	0
13	1676895	.	G	A	0	7	7	0	4	11	0	0
13	1677009	.	G	T	0	0	0	0	4	4	0	0
13	1677859	.	G	T	2	0	2	0	1	3	0	0
13	1677913	.	C	T	6	11	17	0	1	18	0	0
13	1682856	.	T	C	4	8	12	0	1	13	0	0
13	1685150	.	G	C	6	7	13	0	4	17	0	0
13	1685192	.	A	T	5	13	18	0	0	18	0	0
13	1691983	.	T	A	2	1	3	0	0	3	0	0
13	1693284	.	G	A	1	10	11	0	9	20	0	0
13	1693312	.	C	A	12	17	29	0	1	30	0	0
13	1693386	.	C	T	3	6	9	0	0	9	0	0
13	1693392	.	C	T	3	3	6	0	1	7	0	0
13	1694395	.	C	A	12	9	21	0	2	23	0	0
13	1694417	.	C	A	12	9	21	0	1	22	0	0
13	1719777	.	G	A	0	25	25	0	19	44	0	0
13	1904124	.	C	T	2	1	3	0	0	3	0	0
13	2029314	.	T	C	1	2	3	0	1	4	0	0
13	2254607	.	A	T	3	3	6	0	0	6	0	0
13	2254638	.	T	C	4	3	7	0	0	7	0	0
13	2254751	.	T	A	2	6	8	0	0	8	0	0
13	2254753	.	G	C	2	0	2	0	6	8	0	0
13	2366936	.	G	A	3	1	4	0	0	4	0	0
13	2370529	.	G	T	0	1	1	0	2	3	0	0
13	2370556	.	G	T	0	2	2	0	4	6	0	0
13	2384958	.	A	G	0	3	3	0	0	3	0	0
13	2385812	.	G	A	1	4	5	0	0	5	0	0
13	2391818	.	A	G	15	19	34	0	6	40	0	0
13	2391964	.	G	C	12	9	21	0	2	23	0	0
13	2391965	.	A	T	13	8	21	0	2	23	0	0
13	2392342	.	G	A	3	7	10	0	0	10	0	0
13	2392397	.	G	A	10	3	13	0	2	15	0	0
13	2392459	.	A	G	4	0	4	0	13	17	0	0
13	2416172	.	T	C	0	2	2	0	0	2	0	0
13	2416221	.	G	A	2	3	5	0	0	5	0	0
13	2416987	.	A	G	1	3	4	0	1	5	0	0
13	2417235	.	C	T	0	2	2	0	0	2	0	0
13	2417251	.	C	T	0	2	2	0	0	2	0	0
13	2427026	.	G	A	10	4	14	0	0	14	0	0
13	2427174	.	C	T	7	7	14	0	1	15	0	0
13	2427175	.	T	G	7	5	12	0	3	15	0	0
13	2427251	.	T	A	4	2	6	0	0	6	0	0
13	2427446	.	G	C	5	5	10	0	3	13	0	0
13	2427450	.	G	A	5	8	13	0	2	15	0	0
13	2427522	.	A	G	8	10	18	0	0	18	0	0
13	2427702	.	T	C	25	5	30	0	30	60	0	0
13	2439886	.	C	T	2	1	3	0	0	3	0	0
13	2496334	.	C	T	2	3	5	0	0	5	0	0
13	2520778	.	G	A	3	1	4	0	1	5	0	0
13	2520834	.	C	T	9	8	17	0	3	20	0	0
13	2746311	.	A	C	2	3	5	0	0	5	0	0
13	2819432	.	C	T	1	2	3	0	0	3	0	0
13	2827605	.	G	T	9	24	33	0	2	35	0	0
13	2827670	.	C	T	26	9	35	0	3	38	0	0
13	2827773	.	A	G	2	5	7	0	1	8	0	0
13	2827832	.	G	T	19	5	24	0	1	25	0	0
13	2827844	.	T	C	19	5	24	0	1	25	0	0
13	2827867	.	A	G	4	17	21	0	1	22	0	0
13	2827918	.	A	T	0	9	9	0	1	10	0	0
13	2901620	.	G	A	1	2	3	0	0	3	0	0
13	2901630	.	C	A	3	1	4	0	0	4	0	0
13	2913822	.	C	T	19	10	29	0	0	29	0	0
13	2927676	.	C	T	0	5	5	0	10	15	0	0
13	2927832	.	T	A	10	8	18	0	0	18	0	0
13	2955501	.	C	A	0	2	2	0	0	2	0	0
13	2955528	.	T	C	0	2	2	0	0	2	0	0
13	3155196	.	T	A	2	5	7	0	0	7	0	0
13	3263990	.	G	A	3	8	11	0	0	11	0	0
13	3264012	.	G	A	3	7	10	0	1	11	0	0
13	3264467	.	C	A	1	7	8	0	1	9	0	0
13	3269340	.	G	A	3	1	4	0	1	5	0	0
13	3270110	.	C	T	0	0	0	0	1	1	0	0
13	3272706	.	C	A	0	1	1	0	1	2	0	0
13	3278079	.	A	G	2	1	3	0	2	5	0	0
13	3287268	.	C	A	0	1	1	0	0	1	0	0
13	3289120	.	T	C	0	1	1	0	0	1	0	0
13	3291953	.	G	A	0	1	1	0	0	1	0	0
13	3354930	.	C	T	3	2	5	0	0	5	0	0
13	3357683	.	C	T	0	0	0	0	3	3	0	0
13	3420158	.	G	T	2	2	4	0	0	4	0	0
13	3474346	.	G	A	0	1	1	0	0	1	0	0
13	3874618	.	T	C	1	4	5	0	0	5	0	0
13	3874903	.	C	A	0	2	2	0	0	2	0	0
13	3874909	.	G	A	1	2	3	0	0	3	0	0
13	3875113	.	C	G	1	1	2	0	1	3	0	0
13	3881204	.	T	C	1	3	4	0	0	4	0	0
13	3881208	.	G	T	1	4	5	0	0	5	0	0
13	3881269	.	C	G	2	2	4	0	0	4	0	0
13	3885350	.	A	C	1	0	1	0	0	1	0	0
13	3885359	.	G	T	1	0	1	0	0	1	0	0
13	3915908	.	A	G	3	6	9	0	0	9	0	0
13	3916150	.	A	G	18	10	28	0	2	30	0	0
13	3916198	.	A	G	16	10	26	0	0	26	0	0
13	3916377	.	G	A	0	1	1	0	2	3	0	0
13	3919020	.	T	C	12	0	12	0	19	31	0	0
13	3919057	.	A	C	9	14	23	0	5	28	0	0
13	3919136	.	A	T	11	6	17	0	1	18	0	0
13	3919167	.	A	G	17	6	23	0	3	26	0	0
13	3919555	.	T	C	10	11	21	0	0	21	0	0
13	3919672	.	T	G	6	3	9	0	1	10	0	0
13	3919686	.	G	A	6	3	9	0	1	10	0	0
13	3920759	.	C	T	0	0	0	0	1	1	0	0
13	3922791	.	T	C	2	0	2	0	0	2	0	0
13	3927931	.	T	C	1	2	3	0	0	3	0	0
13	3936482	.	C	G	3	6	9	0	0	9	0	0
13	3938574	.	C	A	4	5	9	0	0	9	0	0
13	3938619	.	C	A	4	4	8	0	0	8	0	0
13	3942055	.	G	A	0	6	6	0	5	11	0	0
13	3949847	.	G	A	11	10	21	0	3	24	0	0
13	3950007	.	G	A	11	10	21	0	2	24	1	0
13	3950074	.	A	T	10	8	18	0	0	18	0	0
13	3950181	.	T	C	22	10	32	0	2	34	0	0
13	3950497	.	G	T	9	12	21	0	0	21	0	0
13	3950669	.	T	A	8	8	16	0	2	18	0	0
13	3958895	.	C	T	1	2	3	0	0	3	0	0
13	3962845	.	C	T	2	3	5	0	1	6	0	0
13	3965966	.	G	A	14	18	32	0	3	35	0	0
13	3980164	.	C	T	3	2	5	0	0	5	0	0
13	3981808	.	T	C	3	2	5	0	0	5	0	0
13	3982711	.	C	T	1	2	3	0	0	3	0	0
13	4213240	.	G	A	1	2	3	0	0	3	0	0
13	4213291	.	A	C	2	2	4	0	0	4	0	0
13	4213300	.	C	T	1	3	4	0	1	5	0	0
13	4213804	.	G	A	3	8	11	0	1	12	0	0
13	4226664	.	C	A	14	11	25	0	1	26	0	0
13	4231438	.	T	A	7	11	18	0	0	18	0	0
13	4231652	.	A	G	5	16	21	0	0	21	0	0
13	4231819	.	G	A	10	11	21	0	4	25	0	0
13	4231954	.	T	A	8	3	11	0	0	11	0	0
13	4232003	.	A	G	3	4	7	0	1	8	0	0
13	4232051	.	G	A	7	4	11	0	1	12	0	0
13	4232054	.	A	T	7	4	11	0	0	11	0	0
13	4232171	.	C	T	11	14	25	0	2	27	0	0
13	4232280	.	T	C	25	18	43	0	0	43	0	0
13	4232284	.	T	C	26	15	41	0	1	42	0	0
13	4232324	.	T	G	24	13	37	0	1	39	1	0
13	4232358	.	A	T	17	15	32	0	2	34	0	0
13	4232400	.	A	T	9	13	22	0	4	26	0	0
13	4232402	.	G	T	11	13	24	0	3	27	0	0
13	4232718	.	G	A	2	9	11	0	4	15	0	0
13	4233030	.	C	T	0	20	20	0	17	37	0	0
13	4233033	.	G	A	20	15	35	0	2	37	0	0
13	4233167	.	T	A	15	13	28	1	0	29	0	0
13	4233361	.	G	T	8	20	28	0	1	29	0	0
13	4233365	.	G	A	19	9	28	0	1	29	0	0
13	4233625	.	T	A	11	7	18	0	0	18	0	0
13	4233779	.	G	A	13	13	26	0	3	29	0	0
13	4233889	.	G	A	11	6	17	0	1	18	0	0
13	4233911	.	G	C	12	5	17	0	2	19	0	0
13	4233952	.	T	G	15	7	22	0	0	22	0	0
13	4234337	.	G	A	7	10	17	0	0	17	0	0
13	4234349	.	G	T	10	8	18	0	0	18	0	0
13	4234655	.	G	A	18	13	31	0	2	33	0	0
13	4307752	.	A	G	6	15	21	0	0	21	0	0
13	4307782	.	C	T	21	11	32	0	1	33	0	0
13	4307934	.	T	C	25	18	43	0	0	43	0	0
13	4308269	.	G	A	11	10	21	0	2	23	0	0
13	4308841	.	T	G	9	9	18	0	1	19	0	0
13	4309166	.	T	G	7	9	16	0	0	16	0	0
13	4310247	.	G	A	7	7	14	0	3	17	0	0
13	4310511	.	C	T	0	12	12	0	15	27	0	0
13	4310565	.	G	A	10	7	17	0	2	19	0	0
13	4310568	.	A	T	7	11	18	0	1	19	0	0
13	4310610	.	C	T	11	6	17	0	0	17	0	0
13	4311081	.	T	C	5	9	14	0	2	16	0	0
13	4311699	.	G	T	9	7	16	0	1	17	0	0
13	4311912	.	C	T	1	1	2	0	1	3	0	0
13	4317721	.	T	C	1	2	3	0	0	3	0	0
13	4339161	.	C	T	5	8	13	0	2	15	0	0
13	4339168	.	G	A	5	9	14	0	0	14	0	0
13	4339382	.	C	T	11	8	19	0	0	19	0	0
13	4343183	.	C	T	0	7	7	0	11	18	0	0
13	4343216	.	A	T	8	13	21	0	3	24	0	0
13	4343221	.	T	A	7	14	21	0	2	23	0	0
13	4343490	.	G	A	8	9	17	0	0	17	0	0
13	4343931	.	G	A	5	2	7	0	2	9	0	0
13	4344159	.	C	G	5	2	7	0	0	8	1	0
13	4347474	.	T	G	1	2	3	0	0	3	0	0
13	4349830	.	G	T	1	0	1	0	0	1	0	0
13	4368536	.	T	C	3	3	6	0	0	6	0	0
13	4399211	.	A	G	2	2	4	0	0	4	0	0
13	4399212	.	A	G	1	3	4	0	0	4	0	0
13	4399618	.	A	G	7	2	9	0	2	11	0	0
13	4399667	.	G	A	4	3	7	0	0	7	0	0
13	4399702	.	G	A	4	3	7	0	1	8	0	0
13	4399786	.	T	C	8	5	13	0	1	14	0	0
13	4400065	.	A	G	1	2	3	0	0	3	0	0
13	4400462	.	A	C	2	3	5	0	1	6	0	0
13	4400464	.	C	G	2	4	6	0	0	6	0	0
13	4406090	.	T	A	15	16	31	0	1	32	0	0
13	4406816	.	T	C	21	11	32	0	1	33	0	0
13	4406937	.	T	A	10	5	15	0	0	15	0	0
13	4544101	.	G	A	2	3	5	0	0	5	0	0
13	4663444	.	A	G	9	6	15	0	0	15	0	0
13	4713193	.	C	G	5	8	13	0	0	13	0	0
13	4713310	.	A	T	7	5	12	0	2	14	0	0
13	4713373	.	T	A	10	6	16	0	1	17	0	0
13	4713478	.	G	A	6	4	10	0	0	10	0	0
13	4713748	.	T	C	5	5	10	0	2	12	0	0
13	4872079	.	G	A	0	7	7	0	0	7	0	0
13	4872121	.	C	T	5	0	5	0	0	5	0	0
13	4945804	.	C	T	5	1	6	0	2	8	0	0
13	4948345	.	G	A	2	1	3	0	0	3	0	0
13	4968421	.	A	G	2	3	5	0	0	5	0	0
13	4968583	.	T	A	7	10	17	0	1	18	0	0
13	4968727	.	G	A	6	7	13	0	1	14	0	0
13	4968890	.	T	C	9	16	25	0	2	27	0	0
13	4968931	.	T	A	15	15	30	0	0	30	0	0
13	4973556	.	T	A	1	2	3	0	1	4	0	0
13	4978680	.	A	G	13	8	21	0	1	22	0	0
13	4978885	.	T	C	5	8	13	0	0	13	0	0
13	4978887	.	C	A	5	7	12	0	1	13	0	0
13	4979190	.	T	C	5	4	9	0	0	9	0	0
13	4979339	.	C	T	3	6	9	0	2	11	0	0
13	4979420	.	T	C	5	3	8	0	2	10	0	0
13	4979471	.	T	C	2	5	7	0	0	7	0	0
13	4979607	.	G	T	4	4	8	0	1	9	0	0
13	4982284	.	G	A	5	4	9	0	0	9	0	0
13	5000490	.	G	A	0	0	0	0	4	4	0	0
13	5000560	.	A	G	10	5	15	0	2	17	0	0
13	5004996	.	C	T	6	6	12	0	1	13	0	0
13	5013671	.	A	G	1	2	3	0	2	5	0	0
13	5016700	.	G	A	8	6	14	0	0	14	0	0
13	5016758	.	G	C	0	2	2	0	0	2	0	0
13	5017657	.	A	C	5	10	15	0	0	15	0	0
13	5017680	.	G	A	7	14	21	0	1	22	0	0
13	5017699	.	G	A	7	13	20	0	2	22	0	0
13	5026131	.	C	T	16	24	40	0	0	40	0	0
13	5028224	.	T	G	8	7	15	0	1	16	0	0
13	5028407	.	G	A	23	29	52	0	2	54	0	0
13	5028414	.	T	C	20	26	46	0	5	51	0	0
13	5028499	.	A	T	12	36	48	0	5	53	0	0
13	5028711	.	C	T	28	27	55	0	3	58	0	0
13	5028912	.	C	T	5	22	27	0	10	37	0	0
13	5028954	.	C	A	2	2	4	0	1	5	0	0
13	5031370	.	G	A	4	3	7	0	0	7	0	0
13	5031391	.	G	A	3	2	5	0	1	6	0	0
13	5069973	.	C	T	1	2	3	0	0	3	0	0
13	5251175	.	G	T	2	3	5	0	0	5	0	0
13	5251183	.	T	C	3	2	5	0	0	5	0	0
13	5251237	.	G	A	0	3	3	0	0	3	0	0
13	5251540	.	T	C	1	2	3	0	0	3	0	0
13	5870703	.	C	G	1	2	3	0	0	3	0	0
13	5871084	.	C	A	1	1	2	0	2	4	0	0
13	5959654	.	T	C	3	2	5	0	1	6	0	0
13	5999159	.	G	A	5	2	7	0	0	7	0	0
13	6125207	.	A	T	1	2	3	0	1	4	0	0
13	6188877	.	C	G	1	2	3	0	2	5	0	0
13	6191523	.	C	A	0	1	1	0	0	1	0	0
13	6194867	.	T	A	3	5	8	0	0	8	0	0
13	6195043	.	T	G	4	0	4	0	5	9	0	0
13	6195055	.	A	T	3	3	6	0	1	7	0	0
13	6199336	.	G	A	0	6	6	0	6	12	0	0
13	6199375	.	T	C	7	4	11	0	1	12	0	0
13	6204583	.	G	A	6	10	16	0	2	18	0	0
13	6204957	.	T	C	8	5	13	0	0	13	0	0
13	6205311	.	G	A	5	7	12	0	1	13	0	0
13	6233482	.	A	C	1	2	3	0	0	3	0	0
13	6236772	.	G	A	1	5	6	0	0	6	0	0
13	6236901	.	G	A	3	1	4	0	0	4	0	0
13	6238204	.	G	A	3	11	14	0	0	14	0	0
13	6238466	.	T	C	10	10	20	0	1	21	0	0
13	6238658	.	G	T	1	12	13	0	9	22	0	0
13	6238762	.	A	G	3	11	14	0	0	14	0	0
13	6238883	.	A	G	9	6	15	0	0	15	0	0
13	6238972	.	G	A	4	7	11	0	1	12	0	0
13	6239091	.	A	T	4	7	11	0	0	11	0	0
13	6239112	.	A	G	4	5	9	0	0	9	0	0
13	6259409	.	T	G	6	3	9	0	0	9	0	0
13	6259813	.	C	T	0	3	3	0	3	6	0	0
13	6279243	.	T	C	1	2	3	0	1	4	0	0
13	6961186	.	A	G	1	2	3	0	0	3	0	0
13	7063602	.	C	G	3	9	12	0	0	12	0	0
13	7063644	.	C	T	8	8	16	0	1	17	0	0
13	7063757	.	C	G	6	8	14	0	1	15	0	0
13	7170250	.	C	T	3	2	5	0	0	5	0	0
13	7170279	.	C	G	1	2	3	0	1	4	0	0
13	7184446	.	G	A	1	1	2	0	0	2	0	0
13	7312015	.	T	A	3	2	5	0	0	5	0	0
13	7312201	.	T	A	3	2	5	0	0	5	0	0
13	7312225	.	G	C	3	3	6	0	0	6	0	0
13	7312675	.	C	T	3	2	5	0	0	5	0	0
13	7312713	.	T	A	2	3	5	0	0	5	0	0
13	7312991	.	T	C	2	4	6	0	0	6	0	0
13	7313020	.	G	A	0	2	2	0	3	5	0	0
13	7313185	.	T	C	1	2	3	0	0	3	0	0
13	7313418	.	G	C	3	3	6	0	0	6	0	0
13	7313546	.	A	G	4	2	6	0	0	6	0	0
13	7313641	.	C	A	3	3	6	0	0	6	0	0
13	7313827	.	C	T	6	3	9	0	1	10	0	0
13	7314049	.	T	C	2	4	6	0	0	6	0	0
13	7314080	.	G	A	1	4	5	0	0	5	0	0
13	7314300	.	T	C	5	6	11	0	0	11	0	0
13	7315015	.	C	T	11	11	22	0	0	22	0	0
13	7315098	.	T	C	12	4	16	0	0	16	0	0
13	7315424	.	G	A	0	11	11	0	10	21	0	0
13	7316042	.	C	A	17	6	23	0	1	24	0	0
13	7316157	.	G	T	15	7	22	0	3	25	0	0
13	7316207	.	C	T	8	5	13	0	2	15	0	0
13	7316532	.	C	A	6	3	9	0	0	9	0	0
13	7346864	.	A	G	28	15	43	0	2	45	0	0
13	7347125	.	G	A	8	3	11	0	1	12	0	0
13	7347142	.	A	G	3	3	6	0	0	6	0	0
13	7556703	.	G	A	0	2	2	0	0	2	0	0
13	7725965	.	C	T	3	4	7	0	0	7	0	0
13	7744319	.	A	G	2	2	4	0	0	4	0	0
13	7744443	.	G	A	0	2	2	0	0	2	0	0
13	7745544	.	C	T	5	7	12	0	0	12	0	0
13	7745705	.	G	A	6	5	11	0	0	11	0	0
13	7745814	.	C	A	5	2	7	0	0	7	0	0
13	7745866	.	A	G	4	1	5	0	4	9	0	0
13	7747513	.	C	G	4	4	8	0	1	9	0	0
13	7747738	.	T	C	8	7	15	0	0	15	0	0
13	7747760	.	T	C	7	6	13	0	1	14	0	0
13	7748021	.	G	T	7	8	15	0	1	16	0	0
13	7748424	.	T	C	7	3	10	0	0	10	0	0
13	7748497	.	T	G	6	3	9	0	1	10	0	0
13	7748533	.	T	G	4	7	11	0	3	14	0	0
13	7748794	.	G	A	0	22	22	0	10	32	0	0
13	7748882	.	A	T	10	20	30	0	1	31	0	0
13	7748995	.	T	A	7	18	25	0	0	25	0	0
13	7749000	.	G	C	7	16	23	0	1	24	0	0
13	7755875	.	T	C	14	1	15	0	21	36	0	0
13	7759403	.	T	C	5	9	14	0	1	15	0	0
13	7763810	.	A	G	7	4	11	0	0	11	0	0
13	7766936	.	C	T	0	8	8	0	11	19	0	0
13	8142558	.	A	G	2	3	5	0	1	6	0	0
13	8152973	.	T	C	1	3	4	0	1	5	0	0
13	8270551	.	C	T	2	4	6	0	0	6	0	0
13	8270554	.	T	C	2	4	6	0	0	6	0	0
13	8270586	.	G	T	2	2	4	0	0	4	0	0
13	8277667	.	A	G	1	1	2	0	1	3	0	0
13	8281433	.	C	T	0	6	6	0	4	10	0	0
13	8281619	.	C	A	4	3	7	0	0	7	0	0
13	8281655	.	A	C	3	2	5	0	0	5	0	0
13	8285559	.	G	A	0	1	1	0	0	1	0	0
13	8320631	.	T	C	7	4	11	0	0	11	0	0
13	8320785	.	G	A	2	4	6	0	0	6	0	0
13	8326274	.	T	C	7	5	12	0	0	12	0	0
13	8333500	.	C	T	0	2	2	0	0	2	0	0
13	8340044	.	G	T	2	3	5	0	0	5	0	0
13	8375932	.	A	T	12	17	29	0	2	31	0	0
13	8375935	.	C	A	12	18	30	0	1	31	0	0
13	8375981	.	A	G	17	23	40	0	6	46	0	0
13	8376064	.	A	G	7	19	26	0	1	27	0	0
13	8376077	.	C	G	8	20	28	0	1	29	0	0
13	8376184	.	C	T	6	4	10	0	1	11	0	0
13	8376187	.	G	A	7	5	12	0	0	12	0	0
13	8376301	.	A	T	4	10	14	0	0	14	0	0
13	8376317	.	T	A	7	8	15	0	0	15	0	0
13	8376613	.	T	G	10	3	13	0	0	13	0	0
13	8376675	.	C	A	0	10	10	0	6	16	0	0
13	8376845	.	A	G	8	7	15	0	0	15	0	0
13	8376882	.	C	T	0	4	4	0	8	12	0	0
13	8376896	.	T	C	7	2	9	0	0	9	0	0
13	8377327	.	A	G	3	3	6	0	0	6	0	0
13	8377334	.	A	G	3	3	6	0	0	6	0	0
13	8377606	.	A	G	2	3	5	0	0	5	0	0
13	8378738	.	T	C	1	2	3	0	0	3	0	0
13	8380274	.	T	C	1	2	3	0	0	3	0	0
13	8380283	.	T	C	1	2	3	0	0	3	0	0
13	8453720	.	A	G	2	4	6	0	0	6	0	0
13	8600706	.	G	T	2	5	7	0	0	7	0	0
13	8625581	.	T	G	1	4	5	0	0	5	0	0
13	8625610	.	G	A	2	4	6	0	0	6	0	0
13	8626645	.	T	A	4	3	7	0	0	7	0	0
13	8626786	.	G	A	0	4	4	0	3	7	0	0
13	8627626	.	G	A	0	5	5	0	7	12	0	0
13	8627634	.	T	A	6	3	9	0	0	9	0	0
13	8627677	.	G	A	8	3	11	0	0	11	0	0
13	8627883	.	T	C	2	2	4	0	1	5	0	0
13	8627898	.	A	C	1	2	3	0	0	3	0	0
13	8685176	.	C	T	2	5	7	0	0	7	0	0
13	8685217	.	A	T	2	3	5	0	0	5	0	0
13	8685272	.	C	T	1	3	4	0	1	5	0	0
13	8685417	.	G	A	4	4	8	0	0	8	0	0
13	8692368	.	C	T	0	2	2	0	4	6	0	0
13	8692776	.	T	G	3	1	4	0	0	4	0	0
13	8692827	.	T	G	3	2	5	0	0	5	0	0
13	8755678	.	A	C	2	2	4	0	0	4	0	0
13	8777682	.	C	T	19	14	33	0	3	36	0	0
13	8777701	.	G	A	14	16	30	0	7	37	0	0
13	8778501	.	G	T	33	16	49	0	6	55	0	0
13	8781222	.	T	C	2	2	4	0	1	5	0	0
13	8903804	.	C	T	1	1	2	0	0	2	0	0
13	8903809	.	G	A	0	1	1	0	1	2	0	0
13	8945361	.	G	C	1	2	3	0	0	3	0	0
13	8945365	.	C	T	0	2	2	0	1	3	0	0
13	8945406	.	G	A	1	2	3	0	0	3	0	0
13	8950686	.	G	A	8	7	15	0	0	15	0	0
13	8950783	.	C	G	2	3	5	0	0	5	0	0
13	8950829	.	A	G	2	4	6	0	0	6	0	0
13	8951259	.	T	G	7	4	11	0	0	11	0	0
13	8951492	.	G	T	1	1	2	0	1	3	0	0
13	9299796	.	A	G	1	2	3	0	1	4	0	0
13	9299881	.	C	G	1	2	3	0	1	4	0	0
13	9304107	.	G	C	3	4	7	0	0	7	0	0
13	9307646	.	T	C	13	2	15	0	0	15	0	0
13	9311156	.	C	A	12	8	20	0	1	21	0	0
13	9313806	.	C	T	0	17	17	0	19	36	0	0
13	9313858	.	A	T	38	24	62	0	2	64	0	0
13	9313975	.	T	C	35	28	63	0	7	70	0	0
13	9314024	.	C	A	31	29	60	0	3	63	0	0
13	9314040	.	T	A	29	28	57	0	5	62	0	0
13	9314238	.	G	A	35	21	56	0	3	59	0	0
13	9314338	.	C	T	35	24	59	0	1	60	0	0
13	9314580	.	A	T	39	28	67	0	5	72	0	0
13	9314620	.	C	T	30	36	66	0	1	67	0	0
13	9314630	.	C	T	0	30	30	0	33	63	0	0
13	9314710	.	G	A	37	28	65	0	2	67	0	0
13	9315004	.	C	T	35	32	67	0	4	71	0	0
13	9315019	.	T	C	28	34	62	0	7	69	0	0
13	9315045	.	C	G	23	36	59	0	9	68	0	0
13	9315384	.	G	A	32	34	66	0	3	69	0	0
13	9315406	.	A	G	25	25	50	0	7	57	0	0
13	9315424	.	G	A	17	21	38	0	1	39	0	0
13	9315686	.	C	T	1	15	16	0	28	44	0	0
13	9315730	.	A	G	9	4	13	0	1	14	0	0
13	9317915	.	T	C	32	31	63	0	5	68	0	0
13	9317945	.	C	T	35	30	65	0	6	71	0	0
13	9318003	.	C	T	4	36	40	0	37	77	0	0
13	9318116	.	T	C	34	32	66	0	1	67	0	0
13	9318125	.	C	T	32	34	66	0	4	70	0	0
13	9318263	.	C	T	37	31	68	0	4	72	0	0
13	9318446	.	T	C	34	38	72	0	4	76	0	0
13	9318521	.	A	G	34	28	62	0	5	67	0	0
13	9340019	.	C	T	9	7	16	0	0	16	0	0
13	9340609	.	C	A	0	11	11	0	6	17	0	0
13	9343329	.	T	C	3	8	11	0	0	11	0	0
13	9345182	.	A	C	2	1	3	0	0	3	0	0
13	9356123	.	G	T	9	2	11	0	1	12	0	0
13	9358449	.	C	T	7	3	10	0	0	10	0	0
13	9358457	.	T	G	6	4	10	0	0	10	0	0
13	9367562	.	T	A	2	6	8	0	2	10	0	0
13	9375860	.	G	C	2	2	4	0	1	5	0	0
13	9384772	.	T	C	1	2	3	0	0	3	0	0
13	9384839	.	A	G	2	6	8	0	0	8	0	0
13	9384877	.	T	A	1	5	6	0	0	6	0	0
13	9384935	.	A	G	1	2	3	0	0	3	0	0
13	9384997	.	C	G	3	2	5	0	0	5	0	0
13	9384998	.	G	A	0	2	2	0	3	5	0	0
13	9385060	.	C	T	1	2	3	0	0	3	0	0
13	9385561	.	G	A	1	0	1	0	0	1	0	0
13	9392047	.	G	A	2	6	8	0	0	8	0	0
13	9392068	.	A	G	1	5	6	0	3	9	0	0
13	9392260	.	G	A	0	3	3	0	2	5	0	0
13	9394684	.	A	T	6	3	9	0	0	9	0	0
13	9394716	.	A	G	4	4	8	0	0	8	0	0
13	9395458	.	G	T	3	6	9	0	0	9	0	0
13	9554825	.	T	G	1	3	4	0	0	4	0	0
13	9554828	.	T	C	1	2	3	0	0	3	0	0
13	9555861	.	C	A	1	2	3	0	0	3	0	0
13	9556426	.	C	T	1	3	4	0	1	5	0	0
13	9556991	.	T	C	1	1	2	0	0	2	0	0
13	9556999	.	C	T	1	2	3	0	0	3	0	0
13	9557035	.	A	C	0	2	2	0	0	2	0	0
13	9557638	.	T	A	5	2	7	0	0	7	0	0
13	9557917	.	G	C	2	4	6	0	0	6	0	0
13	9557997	.	G	C	3	3	6	0	0	6	0	0
13	9558312	.	T	A	4	2	6	0	1	7	0	0
13	9559476	.	T	A	0	2	2	0	0	2	0	0
13	9559527	.	A	C	3	4	7	0	0	7	0	0
13	9565065	.	G	A	0	3	3	0	3	6	0	0
13	9568821	.	C	T	1	6	7	0	0	7	0	0
13	9568857	.	G	A	0	4	4	0	0	4	0	0
13	9568861	.	T	C	0	4	4	0	0	4	0	0
13	9570967	.	A	G	2	2	4	0	1	5	0	0
13	9571695	.	C	T	9	5	14	0	1	15	0	0
13	9571949	.	T	C	12	5	17	0	0	17	0	0
13	9571972	.	G	A	10	5	15	0	1	16	0	0
13	9571996	.	T	G	8	5	13	0	1	14	0	0
13	9572036	.	G	A	7	7	14	0	2	16	0	0
13	9572134	.	G	T	4	5	9	0	1	10	0	0
13	9655977	.	A	G	4	2	6	0	0	6	0	0
13	9828568	.	A	T	3	5	8	0	0	8	0	0
13	9828572	.	G	A	0	4	4	0	3	7	0	0
13	9828933	.	G	T	3	3	6	0	0	6	0	0
13	9829232	.	T	C	1	3	4	0	0	4	0	0
13	9829274	.	C	A	1	1	2	0	0	2	0	0
13	9829289	.	T	C	1	1	2	0	1	3	0	0
13	9829855	.	C	T	4	5	9	0	0	9	0	0
13	9830089	.	T	C	1	6	7	0	0	7	0	0
13	9830147	.	A	T	3	3	6	0	0	7	1	0
13	9830148	.	C	G	3	3	6	0	1	7	0	0
13	9830417	.	C	A	1	2	3	0	0	3	0	0
13	9830518	.	A	T	5	3	8	0	0	8	0	0
13	9830521	.	A	C	5	3	8	0	0	8	0	0
13	9830554	.	A	G	5	3	8	0	0	8	0	0
13	9831056	.	G	C	1	9	10	0	1	11	0	0
13	9831116	.	A	G	4	7	11	0	0	11	0	0
13	9836485	.	A	T	1	2	3	0	0	3	0	0
13	9841702	.	T	A	2	9	11	0	2	13	0	0
13	9844746	.	T	C	4	3	7	0	0	7	0	0
13	9855508	.	G	T	11	16	27	0	2	29	0	0
13	9855874	.	G	A	13	18	31	0	1	32	0	0
13	9856143	.	G	A	8	11	19	0	1	20	0	0
13	9856192	.	A	G	10	14	24	0	1	25	0	0
13	9856493	.	A	T	16	21	37	0	2	39	0	0
13	9856816	.	G	A	7	15	22	0	2	24	0	0
13	10895731	.	T	G	1	1	2	0	1	3	0	0
13	10906719	.	G	A	2	1	3	0	0	3	0	0
13	10906817	.	T	C	0	1	1	0	0	1	0	0
13	10910423	.	G	T	0	1	1	0	1	2	0	0
13	10922497	.	T	G	4	6	10	0	1	11	0	0
13	10922578	.	C	T	4	6	10	0	2	12	0	0
13	10922613	.	A	T	6	10	16	0	0	16	0	0
13	10922660	.	G	A	7	6	13	0	1	14	0	0
13	10975980	.	G	A	0	1	1	0	0	1	0	0
13	10982404	.	C	T	9	13	22	0	0	22	0	0
13	10982444	.	G	A	16	8	24	0	0	24	0	0
13	10982472	.	T	G	12	8	20	0	2	22	0	0
13	10982966	.	A	T	14	12	26	0	1	27	0	0
13	10983231	.	G	A	1	3	4	0	0	4	0	0
13	10983280	.	C	A	2	1	3	0	0	3	0	0
13	10983283	.	C	A	3	1	4	0	0	4	0	0
13	10983482	.	T	A	8	2	10	0	1	11	0	0
13	10983788	.	T	C	7	9	16	0	1	17	0	0
13	10984205	.	G	A	6	19	25	0	2	27	0	0
13	10990959	.	G	A	2	2	4	0	1	5	0	0
13	10994107	.	A	G	2	4	6	0	0	6	0	0
13	10997566	.	A	G	2	4	6	0	2	8	0	0
13	11002052	.	A	G	1	4	5	0	0	5	0	0
13	11002234	.	C	T	0	3	3	0	5	8	0	0
13	11002247	.	G	A	5	2	7	0	1	8	0	0
13	11002541	.	A	G	1	3	4	0	1	5	0	0
13	11002697	.	A	G	2	4	6	0	0	6	0	0
13	11002778	.	T	C	6	4	10	0	0	10	0	0
13	11002922	.	C	T	2	3	5	0	0	5	0	0
13	11002970	.	T	C	3	3	6	0	0	6	0	0
13	11012349	.	C	T	2	2	4	0	0	4	0	0
13	11029585	.	G	T	1	0	1	0	0	1	0	0
13	11083167	.	A	G	1	0	1	0	0	1	0	0
13	11119837	.	A	G	1	2	3	0	0	3	0	0
13	11166435	.	G	A	2	5	7	0	0	7	0	0
13	11166467	.	A	G	3	2	5	0	0	5	0	0
13	11166613	.	C	G	1	2	3	0	0	3	0	0
13	11184784	.	G	A	5	3	8	0	0	8	0	0
13	11441080	.	T	A	4	8	12	0	3	15	0	0
13	11442090	.	A	T	16	13	29	0	0	29	0	0
13	11443457	.	T	A	26	22	48	0	0	48	0	0
13	11443881	.	C	T	17	25	42	0	1	43	0	0
13	11444022	.	A	T	17	10	27	0	1	29	1	0
13	11444263	.	G	A	0	21	21	0	23	44	0	0
13	11444295	.	C	T	20	29	49	0	3	52	0	0
13	11444801	.	T	A	15	14	29	0	1	30	0	0
13	11489965	.	T	C	6	3	9	0	0	9	0	0
13	11489999	.	C	A	10	5	15	0	1	16	0	0
13	11490035	.	A	G	11	5	16	0	1	17	0	0
13	11490065	.	G	A	5	6	11	0	3	14	0	0
13	11490084	.	G	A	3	5	8	0	1	9	0	0
13	11490214	.	A	C	4	2	6	0	1	7	0	0
13	11490300	.	G	T	3	1	4	0	2	6	0	0
13	11490626	.	G	A	6	6	12	0	1	13	0	0
13	11536901	.	T	A	3	2	5	0	0	5	0	0
13	11550734	.	G	T	0	5	5	0	1	6	0	0
13	11550741	.	T	C	3	4	7	0	0	7	0	0
13	11675148	.	G	A	5	9	14	0	1	15	0	0
13	11675185	.	A	G	7	2	9	0	2	11	0	0
13	11675270	.	G	A	2	3	5	0	0	5	0	0
13	11675343	.	C	G	6	4	10	0	0	10	0	0
13	11675378	.	T	C	2	3	5	0	1	6	0	0
13	11675464	.	A	G	2	2	4	0	0	4	0	0
13	11675584	.	C	T	4	6	10	0	0	10	0	0
13	11746459	.	C	A	20	16	36	0	3	39	0	0
13	11751402	.	G	A	1	0	1	0	1	2	0	0
13	11767651	.	T	C	4	2	6	0	0	6	0	0
13	11767768	.	A	G	6	8	14	0	0	14	0	0
13	11781751	.	C	T	0	4	4	0	2	6	0	0
13	11781769	.	A	G	2	2	4	0	1	5	0	0
13	11791391	.	A	G	0	1	1	0	0	1	0	0
13	11836187	.	C	T	1	0	1	0	1	2	0	0
13	11869049	.	G	T	5	4	9	0	0	9	0	0
13	11869219	.	G	T	3	4	7	0	0	7	0	0
13	11869220	.	G	T	3	4	7	0	0	7	0	0
13	11869357	.	G	T	5	4	9	0	2	11	0	0
13	11869539	.	T	C	8	3	11	0	1	12	0	0
13	11876698	.	T	G	3	3	6	0	2	8	0	0
13	11876841	.	G	A	2	2	4	0	1	5	0	0
13	11876850	.	G	A	3	2	5	0	0	5	0	0
13	11911904	.	A	G	1	0	1	0	1	2	0	0
13	11921405	.	A	G	0	1	1	0	0	1	0	0
13	11921432	.	G	A	0	2	2	0	1	3	0	0
13	11921543	.	T	C	3	2	5	0	0	5	0	0
13	11923834	.	G	C	3	2	5	0	2	7	0	0
13	11926692	.	C	G	7	4	11	0	1	12	0	0
13	11927341	.	C	G	6	8	14	0	0	14	0	0
13	11927347	.	T	A	4	9	13	0	0	13	0	0
13	11927491	.	T	C	12	5	17	0	0	17	0	0
13	11927735	.	T	C	4	4	8	0	0	8	0	0
13	11927829	.	A	T	6	8	14	0	3	17	0	0
13	11927830	.	T	G	7	8	15	0	2	17	0	0
13	11966316	.	A	G	0	2	2	0	0	2	0	0
13	11977394	.	A	T	0	3	3	0	0	3	0	0
13	11984768	.	A	C	0	2	2	0	1	3	0	0
13	11984857	.	T	A	2	3	5	0	0	5	0	0
13	11989357	.	T	C	18	16	34	0	1	35	0	0
13	11989468	.	A	C	13	23	36	0	5	41	0	0
13	11989554	.	A	G	18	19	37	0	5	42	0	0
13	11989629	.	C	T	21	18	39	0	2	41	0	0
13	11989633	.	T	C	23	18	41	0	1	42	0	0
13	11989698	.	C	T	12	12	24	0	5	29	0	0
13	11990118	.	G	A	16	14	30	0	3	33	0	0
13	11990175	.	T	C	12	2	14	0	17	31	0	0
13	11990294	.	A	G	11	7	18	0	1	19	0	0
13	11990329	.	T	G	13	10	23	0	1	24	0	0
13	11990389	.	G	T	11	10	21	0	0	21	0	0
13	11993451	.	A	T	11	7	18	0	1	19	0	0
13	12000699	.	T	C	0	1	1	0	1	2	0	0
13	12000700	.	G	C	0	2	2	0	0	2	0	0
13	12005588	.	C	T	0	2	2	0	3	5	0	0
13	12010891	.	C	G	0	1	1	0	0	1	0	0
13	12045797	.	A	T	3	6	9	0	0	9	0	0
13	12087528	.	G	A	0	6	6	0	5	11	0	0
13	12088223	.	C	G	19	18	37	0	2	39	0	0
13	12088255	.	A	G	13	11	24	0	0	24	0	0
13	12088327	.	A	G	15	11	26	0	3	29	0	0
13	12088406	.	T	C	5	16	21	0	2	23	0	0
13	12088795	.	T	C	1	2	3	0	1	4	0	0
13	12202096	.	A	T	1	4	5	0	1	6	0	0
13	12207170	.	A	T	7	9	16	0	0	16	0	0
13	12207583	.	G	T	7	2	9	0	1	10	0	0
13	12207591	.	A	T	6	5	11	0	0	11	0	0
13	12207656	.	C	T	7	11	18	0	0	18	0	0
13	12329553	.	C	T	0	1	1	0	0	1	0	0
13	12370839	.	A	G	1	3	4	0	0	4	0	0
13	12371290	.	G	T	1	1	2	0	0	2	0	0
13	12371529	.	T	C	1	2	3	0	0	3	0	0
13	12371541	.	T	C	1	1	2	0	1	3	0	0
13	12372247	.	T	C	2	3	5	0	0	5	0	0
13	12372552	.	C	A	3	2	5	0	1	6	0	0
13	12372596	.	C	G	2	2	4	0	0	4	0	0
13	12373059	.	T	C	4	4	8	0	0	8	0	0
13	12373093	.	A	T	5	4	9	0	0	9	0	0
13	12373262	.	C	T	3	6	9	0	1	10	0	0
13	12373274	.	A	T	4	5	9	0	0	9	0	0
13	12373430	.	T	A	7	7	14	0	0	14	0	0
13	12373460	.	A	G	6	6	12	0	1	13	0	0
13	12373514	.	A	G	1	2	3	0	1	4	0	0
13	12373679	.	T	C	2	3	5	0	0	5	0	0
13	12374414	.	A	G	7	5	12	0	0	12	0	0
13	12374710	.	A	G	3	0	3	0	14	17	0	0
13	12374771	.	A	G	4	9	13	0	2	15	0	0
13	12374775	.	T	G	6	9	15	0	1	16	0	0
13	12374901	.	C	A	4	6	10	0	0	10	0	0
13	12374910	.	G	A	0	7	7	0	3	10	0	0
13	12374954	.	A	C	5	6	11	0	0	11	0	0
13	12375198	.	A	G	12	9	21	0	3	24	0	0
13	12375348	.	C	A	9	9	18	0	0	18	0	0
13	12375389	.	A	G	9	11	20	0	2	22	0	0
13	12378142	.	G	T	6	2	8	0	0	8	0	0
13	12378315	.	T	A	8	8	16	0	0	16	0	0
13	12378356	.	T	G	12	5	17	0	2	19	0	0
13	12378407	.	T	C	6	3	9	0	0	9	0	0
13	12385182	.	A	G	10	5	15	0	0	15	0	0
13	12385538	.	G	T	5	4	9	0	1	10	0	0
13	12387658	.	G	A	7	2	9	0	0	9	0	0
13	12428776	.	A	C	1	2	3	0	0	3	0	0
13	12443951	.	C	T	3	4	7	0	0	7	0	0
13	12447952	.	T	C	3	2	5	0	0	5	0	0
13	12447961	.	A	C	2	1	3	0	0	3	0	0
13	12450980	.	G	T	5	5	10	0	1	11	0	0
13	12479382	.	C	A	5	5	10	0	0	10	0	0
13	12479490	.	G	A	17	11	28	0	3	31	0	0
13	12489232	.	G	A	1	3	4	0	1	5	0	0
13	12489360	.	A	G	1	7	8	0	1	9	0	0
13	12489553	.	T	A	2	1	3	0	0	3	0	0
13	12494069	.	C	T	0	2	2	0	0	2	0	0
13	12632946	.	T	A	7	8	15	0	2	17	0	0
13	12632967	.	T	C	6	4	10	0	1	11	0	0
13	12633014	.	C	G	6	3	9	0	0	9	0	0
13	12665126	.	A	G	3	4	7	1	1	9	0	0
13	12665152	.	T	C	5	2	7	0	0	7	0	0
13	12665202	.	A	T	4	4	8	0	0	8	0	0
13	12665328	.	C	A	5	4	9	0	0	9	0	0
13	12665411	.	T	A	4	2	6	0	0	6	0	0
13	12665546	.	T	C	6	10	16	0	4	20	0	0
13	12665587	.	C	T	0	7	7	0	9	16	0	0
13	12665699	.	T	C	7	4	11	0	1	12	0	0
13	12665704	.	T	C	4	8	12	0	0	12	0	0
13	12665859	.	A	T	4	2	6	0	0	6	0	0
13	12665863	.	C	T	0	2	2	0	4	6	0	0
13	12665945	.	A	C	5	4	9	0	1	10	0	0
13	12665963	.	A	G	3	5	8	0	0	8	0	0
13	12665990	.	C	A	4	7	11	0	0	11	0	0
13	12666362	.	A	G	2	3	5	0	0	5	0	0
13	12681150	.	T	C	2	2	4	0	0	4	0	0
13	12681315	.	A	G	3	3	6	0	0	6	0	0
13	12681527	.	G	T	1	2	3	0	1	4	0	0
13	12681716	.	T	C	1	2	3	0	0	3	0	0
13	12740113	.	A	T	2	2	4	0	0	4	0	0
13	12740566	.	A	G	7	3	10	0	0	10	0	0
13	12740599	.	C	T	4	3	7	0	4	11	0	0
13	12740674	.	G	A	2	5	7	0	2	9	0	0
13	12740782	.	C	T	7	5	12	0	0	12	0	0
13	12740794	.	G	A	0	4	4	0	8	12	0	0
13	12740971	.	T	G	11	11	22	0	1	23	0	0
13	12778862	.	T	A	4	2	6	0	0	6	0	0
13	12911146	.	A	C	2	2	4	0	0	4	0	0
13	12918191	.	T	C	1	4	5	0	0	5	0	0
13	12918194	.	T	C	1	4	5	0	0	5	0	0
13	12919196	.	C	T	1	2	3	0	0	3	0	0
13	12940138	.	C	T	1	3	4	0	1	5	0	0
13	12943630	.	G	A	3	2	5	0	0	5	0	0
13	12955278	.	T	C	4	1	5	0	0	5	0	0
13	12955615	.	T	C	4	9	13	0	0	13	0	0
13	12957817	.	G	A	7	5	12	0	0	12	0	0
13	12961126	.	T	A	9	5	14	0	1	15	0	0
13	12961141	.	C	T	4	6	10	0	2	12	0	0
13	12967432	.	G	C	6	9	15	0	3	18	0	0
13	12967438	.	C	T	5	9	14	0	2	16	0	0
13	12970797	.	C	T	9	5	14	0	0	14	0	0
13	12971757	.	A	C	9	10	19	0	3	22	0	0
13	12971763	.	A	G	6	1	7	0	14	21	0	0
13	12971856	.	G	A	5	3	8	0	0	8	0	0
13	12974602	.	A	G	1	1	2	0	0	2	0	0
13	12985114	.	C	T	12	19	31	0	5	36	0	0
13	12985193	.	T	A	15	18	33	0	0	33	0	0
13	12985376	.	G	A	0	14	14	0	14	28	0	0
13	12985822	.	T	G	12	5	17	0	0	17	0	0
13	12993928	.	C	T	5	4	9	0	1	10	0	0
13	12994043	.	C	A	1	2	3	0	0	3	0	0
13	12994364	.	A	G	6	9	15	0	0	15	0	0
13	12994395	.	A	G	5	9	14	0	1	15	0	0
13	12994738	.	A	T	12	5	17	0	1	18	0	0
13	12994801	.	A	G	6	9	15	0	1	16	0	0
13	12994802	.	G	T	7	8	15	0	1	16	0	0
13	12997845	.	C	T	5	3	8	0	0	8	0	0
13	12997966	.	A	G	3	0	3	0	0	3	0	0
13	12999701	.	G	T	2	2	4	0	0	4	0	0
13	13075034	.	T	C	0	1	1	0	0	1	0	0
13	13091046	.	C	A	0	1	1	0	0	1	0	0
13	13091079	.	T	C	0	5	5	0	0	5	0	0
13	13213678	.	A	G	6	5	11	0	0	11	0	0
13	13213900	.	T	C	2	0	2	0	5	7	0	0
13	13214412	.	G	A	10	15	25	0	0	25	0	0
13	13214462	.	T	A	8	13	21	0	3	24	0	0
13	13215426	.	T	G	2	2	4	0	0	4	0	0
13	13215917	.	A	G	1	2	3	0	0	3	0	0
13	13215937	.	A	G	1	2	3	0	0	3	0	0
13	13216092	.	G	A	4	3	7	0	0	7	0	0
13	13216381	.	T	A	2	2	4	0	1	5	0	0
13	13693781	.	A	T	3	2	5	0	0	5	0	0
13	13698433	.	T	C	5	5	10	0	1	11	0	0
13	13700335	.	A	C	1	0	1	0	0	1	0	0
13	13704011	.	T	G	1	1	2	0	0	2	0	0
13	13713106	.	C	G	3	3	6	0	0	6	0	0
13	13724919	.	T	A	1	0	1	0	0	1	0	0
13	13737474	.	G	C	23	6	29	0	2	31	0	0
13	13737514	.	A	G	26	1	27	0	14	41	0	0
13	13737524	.	G	A	25	13	38	0	5	43	0	0
13	13737612	.	G	C	0	17	17	0	26	43	0	0
13	13913140	.	G	C	0	0	0	0	1	1	0	0
13	13917991	.	C	T	6	3	9	0	1	10	0	0
13	13938461	.	G	A	0	3	3	0	1	4	0	0
13	13942449	.	C	T	3	2	5	0	0	5	0	0
13	13943372	.	C	A	3	3	6	0	0	6	0	0
13	13943959	.	T	C	4	9	13	0	1	14	0	0
13	13943983	.	A	G	6	7	13	0	2	15	0	0
13	13997299	.	C	T	1	3	4	0	0	4	0	0
13	13997536	.	T	C	1	1	2	0	0	2	0	0
13	13997545	.	G	A	1	2	3	0	0	3	0	0
13	14002776	.	A	G	1	4	5	0	3	8	0	0
13	14003099	.	A	G	5	3	8	0	0	8	0	0
13	14004161	.	T	C	5	5	10	0	0	10	0	0
13	14004209	.	C	T	6	7	13	0	0	13	0	0
13	14004276	.	C	T	9	3	12	0	0	12	0	0
13	14070868	.	C	T	1	2	3	0	0	3	0	0
13	14094441	.	G	A	0	2	2	0	0	2	0	0
13	14137061	.	C	T	1	1	2	0	0	2	0	0
13	14181750	.	C	T	11	8	19	0	1	20	0	0
13	14181952	.	T	C	3	11	14	0	0	14	0	0
13	14190780	.	C	T	0	19	19	0	21	40	0	0
13	14191033	.	T	C	13	9	22	0	2	24	0	0
13	14191045	.	G	C	12	10	22	0	0	22	0	0
13	14191528	.	A	G	10	9	19	0	1	20	0	0
13	14191553	.	A	G	14	2	16	0	3	19	0	0
13	14191724	.	G	A	12	5	17	0	2	19	0	0
13	14191769	.	T	C	17	10	27	0	1	28	0	0
13	14191797	.	A	G	18	13	31	0	0	31	0	0
13	14192110	.	T	C	6	11	17	0	0	17	0	0
13	14192131	.	G	A	6	7	13	0	0	13	0	0
13	14192178	.	A	T	6	7	13	0	0	13	0	0
13	14192414	.	A	G	6	3	9	0	0	9	0	0
13	14192448	.	A	C	8	5	13	0	0	13	0	0
13	14192506	.	G	A	2	7	9	0	0	9	0	0
13	14192511	.	A	T	3	7	10	0	1	11	0	0
13	14192561	.	G	T	2	3	5	0	1	6	0	0
13	14194109	.	C	G	1	3	4	0	0	4	0	0
13	14194110	.	C	A	1	3	4	0	0	4	0	0
13	14194484	.	C	T	3	5	8	0	0	8	0	0
13	14194571	.	G	A	7	1	8	0	1	9	0	0
13	14194573	.	C	A	7	2	9	0	0	9	0	0
13	14194611	.	T	G	7	6	13	0	0	13	0	0
13	14194660	.	G	A	2	7	9	0	0	9	0	0
13	14194904	.	T	C	1	4	5	0	1	6	0	0
13	14199190	.	A	G	1	3	4	0	0	4	0	0
13	14220900	.	G	A	2	1	3	0	0	3	0	0
13	14902500	.	C	A	5	10	15	0	1	16	0	0
13	14902507	.	T	C	3	11	14	0	0	14	0	0
13	14902546	.	C	T	5	9	14	0	0	14	0	0
13	14902702	.	G	A	2	1	3	0	0	3	0	0
13	14906587	.	G	C	11	6	17	0	1	18	0	0
13	14906614	.	G	A	8	9	17	0	1	18	0	0
13	14906754	.	A	G	0	3	3	0	0	3	0	0
13	14908880	.	A	G	1	5	6	0	1	7	0	0
13	14915669	.	G	A	2	3	5	0	1	6	0	0
13	15211952	.	T	C	2	3	5	0	0	5	0	0
13	15212611	.	A	G	1	1	2	0	1	3	0	0
13	15212962	.	T	A	2	3	5	0	0	5	0	0
13	15213130	.	A	T	5	2	7	0	0	7	0	0
13	15215789	.	A	T	11	11	22	0	4	26	0	0
13	15580864	.	T	A	4	5	9	0	1	10	0	0
13	15580948	.	G	T	4	3	7	0	0	7	0	0
13	15647444	.	A	G	5	1	6	0	0	6	0	0
13	15657987	.	A	G	20	28	48	0	2	50	0	0
13	15668124	.	A	T	5	6	11	0	3	14	0	0
13	15725311	.	A	T	4	4	8	0	0	8	0	0
13	15762515	.	T	C	1	10	11	0	2	13	0	0
13	15763273	.	T	C	2	3	5	0	1	6	0	0
13	15763733	.	T	C	3	3	6	0	1	7	0	0
13	15801705	.	T	A	2	2	4	0	0	4	0	0
13	15801726	.	T	C	3	2	5	0	0	5	0	0
13	15814429	.	A	G	5	10	15	0	1	16	0	0
13	15814724	.	T	A	3	6	9	0	0	9	0	0
13	15816637	.	G	A	4	3	7	0	1	8	0	0
13	15848817	.	A	G	7	3	10	0	0	10	0	0
13	15849541	.	T	C	4	2	6	0	0	6	0	0
13	15869322	.	A	G	1	1	2	0	0	2	0	0
13	15872256	.	A	G	5	12	17	0	1	18	0	0
13	15880940	.	T	G	0	1	1	0	0	1	0	0
13	15882860	.	A	C	11	19	30	0	2	33	1	0
13	15928805	.	T	C	0	1	1	0	1	2	0	0
13	15929308	.	C	A	1	2	3	0	0	3	0	0
13	15943695	.	T	C	2	2	4	0	0	4	0	0
13	16186182	.	G	A	4	6	10	0	1	11	0	0
13	16186209	.	T	C	2	0	2	0	8	10	0	0
13	16191517	.	A	T	1	2	3	0	0	3	0	0
13	16191580	.	A	G	3	4	7	0	1	8	0	0
13	16300653	.	G	A	1	2	3	0	0	3	0	0
13	16300670	.	T	C	2	3	5	0	0	5	0	0
13	16311465	.	A	G	0	1	1	0	0	1	0	0
13	16313525	.	G	C	1	0	1	0	0	1	0	0
13	16326333	.	G	T	4	6	10	0	2	12	0	0
13	16436524	.	A	G	0	4	4	0	3	7	0	0
13	16436686	.	C	T	1	4	5	0	0	5	0	0
13	16436786	.	T	C	2	2	4	0	0	4	0	0
13	16448511	.	G	A	0	1	1	0	2	3	0	0
13	16479914	.	T	A	2	5	7	0	0	7	0	0
13	16496254	.	T	C	9	7	16	0	0	16	0	0
13	16496377	.	G	A	0	2	2	0	3	5	0	0
13	16496770	.	T	A	22	7	29	0	1	30	0	0
13	16852953	.	G	A	3	0	3	0	0	3	0	0
13	16856045	.	T	A	5	4	9	0	0	9	0	0
13	16871830	.	A	C	5	5	10	0	0	10	0	0
13	16878895	.	A	C	12	7	19	0	2	21	0	0
13	16886040	.	C	T	16	9	25	0	1	26	0	0
13	16886068	.	C	T	15	7	22	0	2	24	0	0
13	17702802	.	C	T	5	3	8	0	0	8	0	0
13	17703308	.	G	A	5	3	8	0	2	10	0	0
13	17703453	.	T	A	4	4	8	0	0	8	0	0
13	17703454	.	C	A	4	4	8	0	0	8	0	0
13	17703548	.	C	T	2	5	7	0	0	7	0	0
13	17703557	.	G	C	0	5	5	0	3	8	0	0
13	17705633	.	C	T	1	2	3	0	0	3	0	0
13	17705669	.	C	T	2	2	4	0	1	5	0	0
13	17705681	.	C	T	2	2	4	0	0	4	0	0
13	17714510	.	G	T	20	28	48	0	3	51	0	0
13	17714530	.	C	A	26	23	49	0	5	54	0	0
13	17714881	.	C	T	22	15	37	0	11	48	0	0
13	17714905	.	T	C	15	24	39	0	3	42	0	0
13	17752932	.	A	T	14	6	20	0	1	21	0	0
13	17752993	.	C	A	8	10	18	0	1	19	0	0
13	17754071	.	T	G	2	2	4	0	1	6	1	0
13	17754125	.	T	C	2	2	4	0	0	4	0	0
13	17754275	.	G	T	3	5	8	0	2	10	0	0
13	17754510	.	T	C	5	3	8	0	0	8	0	0
13	17754571	.	C	G	1	5	6	0	0	6	0	0
13	17754809	.	T	C	6	4	10	0	1	11	0	0
13	17754897	.	C	T	0	9	9	0	3	12	0	0
13	17755618	.	T	C	4	3	7	0	0	7	0	0
13	17755743	.	G	A	4	3	7	0	0	7	0	0
13	17755898	.	G	A	2	4	6	0	1	7	0	0
13	17755980	.	G	A	6	2	8	0	2	10	0	0
13	17943175	.	G	T	2	2	4	0	0	4	0	0
13	18019786	.	C	T	0	2	2	0	2	4	0	0
13	18032872	.	C	T	0	4	4	0	3	7	0	0
13	18032941	.	A	G	4	2	6	0	2	8	0	0
13	18032960	.	G	A	5	3	8	0	0	8	0	0
13	18033405	.	T	C	3	3	6	0	1	7	0	0
13	18046258	.	G	A	2	2	4	0	0	4	0	0
13	18073433	.	A	G	12	13	25	0	3	28	0	0
13	18073460	.	C	T	11	12	23	0	2	25	0	0
13	18073557	.	C	A	9	7	16	0	0	16	0	0
13	18073706	.	G	A	9	6	15	0	0	15	0	0
13	18076710	.	T	G	5	7	12	0	0	12	0	0
13	18076722	.	G	T	7	9	16	0	0	16	0	0
13	18076818	.	G	A	9	15	24	0	0	24	0	0
13	18077056	.	G	T	10	10	20	0	7	27	0	0
13	18077116	.	G	A	11	12	23	0	1	24	0	0
13	18077206	.	C	T	6	6	12	0	1	13	0	0
13	18083415	.	G	A	5	1	6	0	1	7	0	0
13	18087918	.	G	A	0	2	2	0	1	3	0	0
13	18088283	.	C	T	0	4	4	0	1	5	0	0
13	18104881	.	C	T	0	1	1	0	0	1	0	0
13	18104890	.	C	T	1	1	2	0	0	2	0	0
13	18105007	.	A	G	1	0	1	0	0	1	0	0
13	18105175	.	G	A	2	2	4	0	0	4	0	0
13	18179500	.	G	C	2	2	4	0	2	6	0	0
13	18179733	.	T	A	14	9	23	0	2	25	0	0
13	18179859	.	C	A	10	16	26	0	0	26	0	0
13	18195926	.	G	A	0	3	3	0	2	5	0	0
13	18282953	.	G	A	0	1	1	0	0	1	0	0
13	18295423	.	G	A	0	2	2	0	1	3	0	0
13	18295468	.	C	T	1	3	4	0	0	4	0	0
13	18321156	.	T	C	3	3	6	0	0	6	0	0
13	18323464	.	A	G	9	12	21	0	1	22	0	0
13	18323595	.	G	A	0	11	11	0	15	26	0	0
13	18323787	.	T	A	16	9	25	0	1	26	0	0
13	18358680	.	G	A	1	4	5	0	0	5	0	0
13	18358890	.	G	C	17	15	32	0	0	32	0	0
13	18359112	.	G	C	6	14	20	0	2	22	0	0
13	18359176	.	C	A	21	8	29	0	1	30	0	0
13	18359202	.	C	T	15	6	21	0	1	22	0	0
13	18359507	.	A	T	8	13	21	0	0	21	0	0
13	18359551	.	T	C	3	7	10	0	0	10	0	0
13	18359554	.	A	G	3	7	10	0	0	10	0	0
13	18371186	.	A	C	0	2	2	0	0	2	0	0
13	18375465	.	C	A	4	3	7	0	0	7	0	0
13	18375512	.	T	A	3	2	5	0	0	5	0	0
13	18385497	.	C	T	0	1	1	0	0	1	0	0
13	18418390	.	C	T	0	4	4	0	0	4	0	0
13	18418528	.	G	A	2	1	3	0	0	3	0	0
13	18428103	.	A	G	5	4	9	0	0	9	0	0
13	18431301	.	C	T	7	9	16	0	0	16	0	0
13	18431430	.	C	T	4	2	6	0	1	7	0	0
13	18434075	.	A	G	2	0	2	0	0	2	0	0
13	18434085	.	C	T	2	4	6	0	0	6	0	0
13	18434150	.	T	C	1	4	5	0	1	6	0	0
13	18434229	.	A	T	3	3	6	0	0	6	0	0
13	18434427	.	C	T	6	4	10	0	0	10	0	0
13	18434519	.	C	A	5	7	12	0	0	12	0	0
13	18434520	.	G	C	0	7	7	0	5	12	0	0
13	18434570	.	C	G	12	12	24	0	1	25	0	0
13	18434794	.	C	A	6	7	13	0	3	16	0	0
13	18434902	.	C	T	8	11	19	0	0	19	0	0
13	18434957	.	G	A	8	3	11	0	1	12	0	0
13	18434962	.	A	G	7	3	10	0	1	11	0	0
13	18499660	.	C	T	4	3	7	0	0	7	0	0
13	18499773	.	A	T	1	2	3	0	0	3	0	0
13	18499864	.	C	T	2	0	2	0	0	2	0	0
13	18509592	.	G	A	0	6	6	0	7	13	0	0
13	18510204	.	T	C	6	5	11	0	4	15	0	0
13	18510324	.	A	G	8	8	16	0	2	18	0	0
13	18511023	.	C	T	9	9	18	0	1	19	0	0
13	18511637	.	A	C	7	9	16	0	1	17	0	0
13	18512082	.	C	G	10	12	22	0	2	24	0	0
13	18669200	.	G	T	8	17	25	0	3	28	0	0
13	18677437	.	T	C	8	5	13	0	1	14	0	0
13	18689043	.	C	T	3	3	6	0	0	6	0	0
13	18801566	.	G	A	3	5	8	0	0	8	0	0
13	19304688	.	A	G	10	13	23	0	0	23	0	0
13	19306817	.	C	G	15	4	19	0	1	20	0	0
13	19316930	.	G	C	14	16	30	0	1	31	0	0
13	19317016	.	T	A	4	5	9	0	1	10	0	0
13	19317018	.	C	G	4	6	10	0	0	10	0	0
13	19317051	.	T	G	6	7	13	0	0	13	0	0
13	19317499	.	G	C	5	13	18	0	0	18	0	0
13	19610625	.	C	T	0	4	4	0	2	6	0	0
13	19799192	.	A	G	2	3	5	0	0	5	0	0
13	19799467	.	G	A	15	10	25	0	2	27	0	0
13	19799522	.	C	T	24	4	28	0	1	29	0	0
13	19799623	.	T	C	12	6	18	0	1	19	0	0
13	19799646	.	C	A	0	6	6	0	13	19	0	0
13	19799705	.	A	G	10	9	19	0	3	22	0	0
13	19799799	.	C	T	0	2	2	0	2	4	0	0
13	20401263	.	C	A	0	3	3	0	12	15	0	0
13	20425396	.	C	T	0	3	3	0	3	6	0	0
13	21638671	.	T	C	1	2	3	0	0	3	0	0
13	21638916	.	G	A	4	3	7	0	0	7	0	0
13	21676256	.	A	T	0	1	1	0	1	2	0	0
13	21680844	.	A	T	1	1	2	0	0	2	0	0
13	21683057	.	A	C	4	12	16	0	0	16	0	0
13	21683077	.	T	C	2	9	11	0	1	12	0	0
13	21683488	.	A	T	19	14	33	0	0	33	0	0
13	21683511	.	T	G	19	10	29	0	0	29	0	0
13	21683546	.	C	T	6	14	20	0	1	21	0	0
13	21689438	.	A	C	8	9	17	0	0	17	0	0
13	21689439	.	C	T	8	9	17	0	0	17	0	0
13	21689530	.	A	T	9	3	12	0	0	12	0	0
13	21689667	.	A	T	0	2	2	0	1	3	0	0
13	21689839	.	C	T	2	3	5	0	3	8	0	0
13	21689854	.	C	T	5	0	5	0	1	6	0	0
13	21690096	.	C	G	5	6	11	0	0	11	0	0
13	21690229	.	A	C	5	4	9	2	1	12	0	0
13	21690374	.	G	A	8	7	15	0	4	19	0	0
13	21690530	.	C	T	0	6	6	0	8	14	0	0
13	21690724	.	A	T	7	5	12	0	1	13	0	0
13	21690877	.	A	C	2	0	2	0	2	5	1	0
13	21690907	.	G	A	2	4	6	1	0	7	0	0
13	21691324	.	G	A	3	3	6	2	0	8	0	0
13	21692328	.	C	A	5	7	12	0	0	12	0	0
13	21692338	.	C	T	5	6	11	0	1	12	0	0
13	21692705	.	C	G	0	2	2	0	4	6	0	0
13	21692859	.	C	T	2	2	4	0	1	5	0	0
13	21693187	.	A	G	1	3	4	0	1	5	0	0
13	21693285	.	A	T	3	6	9	0	1	10	0	0
13	21693342	.	C	T	4	3	7	0	0	7	0	0
13	21693361	.	C	T	3	4	7	0	1	8	0	0
13	21693410	.	G	C	4	3	7	0	0	7	0	0
13	21695438	.	G	T	2	3	5	0	0	5	0	0
13	21712507	.	G	A	7	13	20	0	1	21	0	0
13	21712526	.	G	A	6	12	18	0	0	18	0	0
13	21712755	.	G	C	2	2	4	0	0	4	0	0
13	21770891	.	T	C	11	8	19	0	0	19	0	0
13	21775469	.	C	T	11	10	21	0	4	25	0	0
13	21775697	.	C	T	5	12	17	0	1	18	0	0
13	21775905	.	C	A	5	2	7	0	0	7	0	0
13	21776039	.	C	T	2	2	4	0	0	4	0	0
13	21776046	.	G	C	1	2	3	0	0	3	0	0
13	21820866	.	A	G	0	4	4	0	1	5	0	0
13	21821393	.	A	C	2	2	4	0	0	4	0	0
13	21860027	.	T	A	0	1	1	0	0	1	0	0
13	21860111	.	G	A	0	1	1	0	0	1	0	0
13	21861775	.	A	C	1	2	3	0	0	3	0	0
13	21861777	.	G	A	1	2	3	0	0	3	0	0
13	21866357	.	A	C	3	3	6	0	1	7	0	0
13	21869927	.	C	T	3	3	6	0	1	7	0	0
13	21870467	.	G	C	0	12	12	0	11	23	0	0
13	21870575	.	A	G	7	0	7	0	16	23	0	0
13	21870608	.	A	T	9	11	20	0	1	21	0	0
13	21874107	.	C	T	3	4	7	0	0	7	0	0
13	21874149	.	G	T	0	10	10	0	12	22	0	0
13	21874649	.	C	T	9	4	13	0	1	14	0	0
13	21884298	.	C	T	16	10	26	0	1	27	0	0
13	21884328	.	G	A	11	12	23	0	3	26	0	0
13	21884407	.	T	C	11	10	21	0	3	24	0	0
13	21884408	.	C	T	10	12	22	0	2	24	0	0
13	21884979	.	T	C	7	7	14	0	1	15	0	0
13	21884980	.	C	T	7	8	15	0	0	15	0	0
13	21885143	.	C	A	18	12	30	0	1	31	0	0
13	21885198	.	T	A	19	22	41	0	1	42	0	0
13	22076892	.	C	T	1	2	3	0	0	3	0	0
13	22087098	.	C	T	2	0	2	0	0	2	0	0
13	22087508	.	C	T	4	16	20	0	0	20	0	0
13	22088061	.	T	G	2	0	2	0	9	11	0	0
13	22094800	.	T	C	3	11	14	0	1	15	0	0
13	22094871	.	T	G	9	11	20	0	1	21	0	0
13	22095589	.	G	A	5	7	12	0	1	13	0	0
13	22095594	.	T	A	7	6	13	0	0	13	0	0
13	22207003	.	C	T	1	1	2	0	0	2	0	0
13	22238125	.	C	A	5	6	11	0	1	12	0	0
13	22238209	.	T	C	9	15	24	0	1	25	0	0
13	22238233	.	G	A	11	14	25	0	0	25	0	0
13	22240672	.	T	A	3	4	7	0	0	7	0	0
13	22241103	.	T	A	14	13	27	0	0	27	0	0
13	22241123	.	G	T	0	6	6	0	15	21	0	0
13	22241374	.	A	C	19	23	42	0	1	43	0	0
13	22241482	.	G	C	16	13	29	0	1	30	0	0
13	22241648	.	T	G	19	26	45	0	3	48	0	0
13	22241730	.	G	C	28	16	44	0	4	48	0	0
13	22241731	.	A	T	30	17	47	0	1	48	0	0
13	22242197	.	G	C	18	15	33	0	4	37	0	0
13	22242299	.	C	G	21	14	35	0	1	36	0	0
13	22242394	.	C	G	21	27	48	0	0	48	0	0
13	22242837	.	T	G	27	19	46	0	1	47	0	0
13	22357236	.	T	G	1	2	3	0	0	3	0	0
13	22358021	.	A	G	3	2	5	0	0	5	0	0
13	22361332	.	G	A	3	3	6	0	0	6	0	0
13	22364908	.	T	C	6	4	10	0	1	11	0	0
13	22365016	.	C	T	12	14	26	0	2	28	0	0
13	22365404	.	C	T	4	12	16	0	1	17	0	0
13	22365461	.	A	G	2	7	9	0	1	10	0	0
13	22367600	.	C	A	5	4	9	0	0	9	0	0
13	22369262	.	C	T	2	3	5	0	0	5	0	0
13	22369295	.	T	C	6	5	11	0	0	11	0	0
13	22369349	.	C	T	5	9	14	0	1	15	0	0
13	22369399	.	A	C	5	5	10	0	2	12	0	0
13	22369445	.	C	T	0	4	4	0	0	6	2	0
13	22371981	.	G	A	0	14	14	0	20	34	0	0
13	22372015	.	C	G	17	21	38	0	2	40	0	0
13	22372075	.	T	C	16	20	36	0	2	38	0	0
13	22372105	.	G	A	2	16	18	0	16	34	0	0
13	22372126	.	C	T	13	17	30	0	3	33	0	0
13	22372205	.	A	G	16	15	31	0	2	33	0	0
13	22618353	.	A	T	1	2	3	0	0	3	0	0
13	22619067	.	G	A	2	5	7	0	3	10	0	0
13	22619157	.	C	T	4	2	6	0	0	6	0	0
13	22659195	.	C	G	5	0	5	0	13	18	0	0
13	22659196	.	A	G	4	10	14	0	4	18	0	0
13	22659231	.	G	A	0	17	17	0	14	31	0	0
13	22659291	.	A	G	12	13	25	0	2	27	0	0
13	22659363	.	G	A	2	3	5	0	1	6	0	0
13	22669319	.	T	C	7	10	17	0	0	17	0	0
13	22679306	.	G	A	1	5	6	0	0	6	0	0
13	22679837	.	G	A	2	7	9	0	0	9	0	0
13	22683416	.	A	T	0	1	1	0	0	1	0	0
13	22705687	.	G	A	1	2	3	0	0	3	0	0
13	22713016	.	G	A	1	2	3	0	0	3	0	0
13	22735063	.	T	C	5	5	10	0	0	10	0	0
13	22735139	.	A	G	6	6	12	0	2	14	0	0
13	22742791	.	G	A	3	3	6	0	0	6	0	0
13	22867888	.	G	A	1	3	4	0	6	10	0	0
13	22867910	.	A	G	8	3	11	0	0	11	0	0
13	22868447	.	G	A	0	2	2	0	3	5	0	0
13	22868456	.	T	C	4	3	7	0	0	7	0	0
13	22871900	.	C	A	4	1	5	0	0	5	0	0
13	22872519	.	T	A	2	1	3	0	1	4	0	0
13	22872538	.	C	T	1	2	3	0	0	3	0	0
13	22876623	.	G	A	9	7	16	0	0	16	0	0
13	22876678	.	A	T	8	11	19	0	0	19	0	0
13	22877076	.	C	T	13	10	23	0	0	23	0	0
13	22877130	.	G	T	13	15	28	0	0	28	0	0
13	22878754	.	G	A	1	0	1	0	0	1	0	0
13	22879149	.	A	T	7	4	11	0	1	12	0	0
13	22898042	.	A	G	1	2	3	0	0	3	0	0
13	22900733	.	G	A	1	3	4	0	0	4	0	0
13	22900742	.	A	T	1	3	4	0	0	4	0	0
13	22902882	.	A	C	2	3	5	0	0	5	0	0
13	22902987	.	G	A	1	6	7	0	1	8	0	0
13	22970688	.	T	C	2	3	5	0	0	5	0	0
13	22970750	.	T	C	1	3	4	0	0	4	0	0
13	22973314	.	A	G	23	28	51	0	4	55	0	0
13	22973348	.	A	G	24	20	44	0	4	49	1	0
13	22973531	.	T	C	23	1	24	0	30	54	0	0
13	22973895	.	A	G	19	21	40	0	5	45	0	0
13	22974033	.	A	G	17	22	39	0	4	43	0	0
13	22974108	.	C	T	9	8	17	0	1	18	0	0
13	22976067	.	C	A	13	14	27	0	1	28	0	0
13	22976070	.	G	A	12	13	25	0	2	27	0	0
13	22976383	.	T	C	6	0	6	0	9	15	0	0
13	22977283	.	G	A	8	10	18	0	0	18	0	0
13	22977319	.	A	G	10	18	28	0	1	29	0	0
13	22977343	.	A	G	8	18	26	0	2	28	0	0
13	22978059	.	T	C	4	0	4	0	5	9	0	0
13	22978062	.	G	A	5	4	9	0	0	9	0	0
13	22983106	.	A	G	3	2	5	0	0	5	0	0
13	22983109	.	A	G	3	2	5	0	0	5	0	0
13	23037752	.	C	G	1	3	4	0	1	5	0	0
13	23037831	.	C	A	8	7	15	0	0	15	0	0
13	23042321	.	A	G	1	0	1	0	0	1	0	0
13	23042387	.	C	G	1	3	4	0	2	6	0	0
13	23042676	.	A	G	7	5	12	0	0	12	0	0
13	23042745	.	G	A	9	4	13	0	1	14	0	0
13	23042929	.	G	T	3	2	5	0	0	5	0	0
13	23043112	.	T	C	5	2	7	0	0	7	0	0
13	23043117	.	A	G	4	2	6	0	2	8	0	0
13	23070787	.	C	T	1	4	5	0	0	5	0	0
13	23070895	.	T	C	8	9	17	0	0	17	0	0
13	23070957	.	T	C	6	2	8	0	0	8	0	0
13	23084177	.	C	G	13	14	27	1	0	28	0	0
13	23084841	.	G	C	8	9	17	0	2	19	0	0
13	23090190	.	A	C	5	5	10	0	1	11	0	0
13	23094895	.	G	T	5	5	10	0	0	10	0	0
13	23128791	.	C	T	3	2	5	0	0	5	0	0
13	23223469	.	T	A	9	4	13	0	0	13	0	0
13	23223486	.	C	T	8	5	13	0	0	13	0	0
13	23223567	.	C	T	7	3	10	0	0	10	0	0
13	23223572	.	C	T	6	4	10	0	0	10	0	0
13	23223858	.	A	T	2	1	3	0	1	4	0	0
13	23223875	.	C	A	3	2	5	0	0	5	0	0
13	23224087	.	G	A	4	4	8	0	0	8	0	0
13	23224113	.	A	T	3	2	5	0	0	5	0	0
13	23224360	.	A	G	4	4	8	0	3	11	0	0
13	23224363	.	T	G	5	5	10	0	1	11	0	0
13	23224427	.	C	T	4	7	11	0	0	11	0	0
13	23224470	.	G	A	9	7	16	0	1	17	0	0
13	23224605	.	G	T	10	7	17	0	1	18	0	0
13	23224727	.	C	T	10	9	19	0	1	20	0	0
13	23224735	.	A	G	11	7	18	0	2	20	0	0
13	23224821	.	T	A	10	7	17	0	0	17	0	0
13	23224860	.	T	A	7	6	13	0	1	14	0	0
13	23225541	.	T	C	11	7	18	0	3	21	0	0
13	23225776	.	T	A	7	5	12	0	3	15	0	0
13	23226114	.	G	A	2	9	11	0	17	28	0	0
13	23226213	.	A	C	7	10	17	0	1	18	0	0
13	23226345	.	G	T	4	2	6	0	0	6	0	0
13	23234675	.	C	A	1	2	3	0	0	3	0	0
13	23234680	.	C	T	1	2	3	0	0	3	0	0
13	23314904	.	T	G	2	7	9	0	2	11	0	0
13	23382393	.	G	A	4	4	8	0	0	8	0	0
13	23387252	.	T	C	6	5	11	0	4	15	0	0
13	23387913	.	A	T	1	3	4	0	0	4	0	0
13	23669916	.	C	A	1	1	2	0	0	2	0	0
13	23675892	.	G	C	0	2	2	0	1	3	0	0
13	23676856	.	G	A	0	1	1	0	0	1	0	0
13	23679888	.	G	A	1	2	3	0	0	3	0	0
13	23685301	.	G	A	1	2	3	0	0	3	0	0
13	23692515	.	C	T	7	5	12	0	2	14	0	0
13	23692572	.	C	T	2	1	3	0	1	4	0	0
13	23703048	.	G	C	6	8	14	0	1	15	0	0
13	23703053	.	T	C	7	7	14	0	2	16	0	0
13	23709532	.	C	T	5	2	7	0	1	8	0	0
13	23709562	.	T	C	12	9	21	0	3	24	0	0
13	23709592	.	A	G	16	13	29	0	3	32	0	0
13	23711937	.	G	A	11	11	22	0	1	23	0	0
13	23728490	.	T	A	3	2	5	0	1	6	0	0
13	23730801	.	G	A	6	5	11	0	0	11	0	0
13	23876865	.	C	T	0	1	1	0	0	1	0	0
13	23882686	.	C	T	2	3	5	0	0	5	0	0
13	23898015	.	A	T	11	8	19	0	0	19	0	0
13	23898045	.	T	G	7	10	17	0	1	18	0	0
13	23901334	.	C	T	13	11	24	0	2	26	0	0
13	23901349	.	T	C	12	11	23	0	2	25	0	0
13	23901502	.	A	G	10	11	21	0	2	23	0	0
13	23901555	.	A	G	6	1	7	0	4	11	0	0
13	23901570	.	T	C	6	5	11	0	2	13	0	0
13	23920791	.	A	G	0	2	2	0	0	2	0	0
13	23931192	.	T	C	3	1	4	0	6	10	0	0
13	23940754	.	C	A	2	1	3	0	0	3	0	0
13	23943040	.	T	G	1	1	2	0	0	2	0	0
13	23996192	.	G	A	4	5	9	0	0	9	0	0
13	23999129	.	G	A	1	0	1	0	0	1	0	0
13	24000394	.	G	A	3	2	5	0	0	5	0	0
13	24014578	.	T	C	0	2	2	0	0	2	0	0
13	24034092	.	T	G	1	2	3	0	0	3	0	0
13	24034206	.	A	G	1	2	3	0	0	3	0	0
13	24045342	.	C	T	0	1	1	0	0	1	0	0
13	24056221	.	C	T	3	5	8	0	1	9	0	0
13	24068790	.	C	T	0	17	17	0	12	29	0	0
13	24069624	.	C	A	11	13	24	0	1	25	0	0
13	24069902	.	A	T	9	7	16	0	2	18	0	0
13	24070242	.	C	T	0	4	4	0	10	14	0	0
13	24070730	.	C	T	2	5	7	0	2	9	0	0
13	24096437	.	G	T	2	3	5	0	0	5	0	0
13	24241436	.	A	G	1	0	1	0	0	1	0	0
13	24276108	.	A	C	0	1	1	0	1	2	0	0
13	24276128	.	T	A	1	2	3	0	0	3	0	0
13	24276354	.	A	G	5	2	7	0	0	7	0	0
13	24276366	.	C	T	4	3	7	0	0	7	0	0
13	24290132	.	A	T	0	4	4	0	2	6	0	0
13	24290140	.	A	G	5	4	9	0	1	10	0	0
13	24292374	.	A	G	1	5	6	0	0	6	0	0
13	24292398	.	G	A	7	2	9	0	0	9	0	0
13	24292675	.	A	G	6	5	11	0	1	12	0	0
13	24292727	.	G	A	15	6	21	0	2	23	0	0
13	24292796	.	T	A	10	10	20	0	3	23	0	0
13	24292800	.	A	T	11	12	23	0	1	24	0	0
13	24292947	.	A	T	8	10	18	0	1	19	0	0
13	24293381	.	A	T	11	20	31	0	2	33	0	0
13	24293465	.	C	T	6	15	21	0	13	34	0	0
13	24293516	.	G	A	9	24	33	0	4	37	0	0
13	24293518	.	C	A	12	24	36	0	1	37	0	0
13	24293615	.	G	A	11	22	33	0	18	51	0	0
13	24293698	.	C	T	28	8	36	0	1	37	0	0
13	24293793	.	A	G	18	10	28	0	0	28	0	0
13	24294046	.	A	G	10	6	16	0	0	16	0	0
13	24295999	.	T	C	2	4	6	0	0	6	0	0
13	24296071	.	G	A	3	6	9	0	0	9	0	0
13	24296094	.	A	C	2	4	6	0	0	6	0	0
13	24296198	.	A	T	3	3	6	0	0	6	0	0
13	24303840	.	G	A	0	2	2	0	0	2	0	0
13	24305975	.	T	G	3	5	8	0	1	9	0	0
13	24311510	.	G	A	0	1	1	0	0	1	0	0
13	24395373	.	G	A	1	2	3	0	0	3	0	0
13	24401618	.	A	G	2	2	4	0	1	5	0	0
13	24401626	.	G	C	0	3	3	0	3	6	0	0
13	24401663	.	C	A	5	3	8	0	1	9	0	0
13	24402560	.	T	C	4	1	5	0	2	7	0	0
13	24411029	.	A	G	18	16	34	0	4	38	0	0
13	24423930	.	T	C	1	4	5	0	1	6	0	0
13	24424260	.	A	T	2	2	4	0	0	4	0	0
13	24424899	.	T	G	1	2	3	0	1	4	0	0
13	24431365	.	T	G	2	9	11	0	0	11	0	0
13	24432096	.	C	T	13	4	17	0	2	19	0	0
13	24432162	.	G	C	5	13	18	0	0	18	0	0
13	24432350	.	C	T	1	14	15	0	11	26	0	0
13	24436011	.	C	G	4	4	8	0	0	8	0	0
13	24436054	.	G	A	8	8	16	0	0	16	0	0
13	24437225	.	G	A	3	2	5	0	0	5	0	0
13	24522025	.	A	G	3	5	8	0	0	8	0	0
13	24522140	.	T	C	1	2	3	0	0	3	0	0
13	24524206	.	G	A	7	3	10	0	0	10	0	0
13	24524305	.	T	G	4	4	8	0	0	8	0	0
13	24580372	.	G	A	3	0	3	0	0	3	0	0
13	24580411	.	G	A	9	11	20	0	1	21	0	0
13	24580705	.	C	T	7	4	11	0	0	11	0	0
13	24580756	.	G	C	0	2	2	0	2	4	0	0
13	24580869	.	T	C	0	2	2	0	0	2	0	0
13	24580941	.	T	C	2	0	2	0	1	3	0	0
13	24581274	.	G	A	4	9	13	0	1	14	0	0
13	24581316	.	C	A	15	6	21	0	2	23	0	0
13	24581334	.	G	C	7	9	16	0	1	17	0	0
13	24581358	.	T	C	4	5	9	0	1	10	0	0
13	24581748	.	A	C	13	9	22	0	3	25	0	0
13	24581798	.	T	A	5	11	16	0	2	18	0	0
13	24581840	.	T	G	16	9	25	0	1	26	0	0
13	24581854	.	C	T	18	11	29	0	1	30	0	0
13	24582047	.	A	G	6	13	19	0	0	19	0	0
13	24582110	.	C	T	5	13	18	0	1	19	0	0
13	24582122	.	T	C	6	10	16	0	0	16	0	0
13	24582211	.	C	T	4	3	7	0	3	10	0	0
13	24582213	.	G	A	4	5	9	0	1	10	0	0
13	24664144	.	T	A	2	4	6	0	1	7	0	0
13	24664197	.	A	G	1	5	6	0	0	6	0	0
13	24665759	.	T	G	3	0	3	0	0	3	0	0
13	24702033	.	C	A	0	7	7	0	6	13	0	0
13	24702114	.	T	C	10	3	13	0	2	15	0	0
13	24702415	.	T	C	6	5	11	0	2	13	0	0
13	24702478	.	T	G	7	8	15	0	1	16	0	0
13	24702602	.	T	A	5	12	17	0	0	17	0	0
13	24702652	.	A	T	4	5	9	0	1	10	0	0
13	24702724	.	C	T	3	4	7	0	0	7	0	0
13	24702883	.	A	T	10	11	21	0	0	21	0	0
13	24703276	.	C	T	5	1	6	0	1	7	0	0
13	24703411	.	A	T	2	3	5	0	1	6	0	0
13	24704032	.	A	G	3	3	6	0	1	7	0	0
13	24704102	.	C	A	10	3	13	0	0	13	0	0
13	24716363	.	T	C	1	2	3	0	0	3	0	0
13	24716375	.	A	T	1	2	3	0	0	3	0	0
13	24737285	.	C	G	0	2	2	0	0	2	0	0
13	24745169	.	A	G	1	3	4	0	1	5	0	0
13	24745188	.	A	C	1	3	4	0	0	4	0	0
13	24745209	.	T	G	1	2	3	0	0	3	0	0
13	24781536	.	G	A	16	14	30	0	2	32	0	0
13	24781580	.	T	C	13	13	26	0	1	27	0	0
13	24781605	.	T	C	10	17	27	0	3	30	0	0
13	24781640	.	G	A	6	14	20	0	0	20	0	0
13	24781713	.	A	G	10	11	21	0	1	22	0	0
13	24781885	.	G	A	8	5	13	0	2	15	0	0
13	24786900	.	T	A	10	10	20	0	1	21	0	0
13	24791077	.	G	T	4	3	7	0	0	7	0	0
13	24804104	.	C	T	1	3	4	0	0	4	0	0
13	24804765	.	C	T	2	3	5	0	1	6	0	0
13	24805148	.	A	C	3	2	5	0	0	5	0	0
13	24806423	.	T	C	1	0	1	0	3	4	0	0
13	24834446	.	C	T	1	6	7	0	2	9	0	0
13	24837627	.	A	G	12	16	28	0	6	34	0	0
13	24837876	.	T	C	3	12	15	0	0	15	0	0
13	24871866	.	A	G	11	9	20	0	2	22	0	0
13	24872667	.	A	G	7	10	17	0	0	17	0	0
13	24872733	.	G	A	5	7	12	0	1	13	0	0
13	24873141	.	C	A	0	9	9	0	4	13	0	0
13	24873186	.	A	T	2	2	4	0	0	4	0	0
13	24873480	.	A	G	8	10	18	0	0	18	0	0
13	24873579	.	C	T	3	3	6	0	1	7	0	0
13	24874897	.	G	A	4	4	8	0	0	8	0	0
13	24878633	.	A	T	1	0	1	0	0	1	0	0
13	24918814	.	T	A	8	11	19	0	1	20	0	0
13	24918820	.	T	C	7	12	19	0	1	20	0	0
13	24986203	.	G	A	1	2	3	0	0	3	0	0
13	24986238	.	G	T	3	3	6	0	0	6	0	0
13	25208276	.	A	G	1	2	3	0	0	3	0	0
13	25208484	.	T	G	4	2	6	0	0	6	0	0
13	25214739	.	G	A	1	0	1	0	0	1	0	0
13	25365034	.	G	A	1	3	4	0	0	4	0	0
13	25369449	.	C	T	1	0	1	0	0	1	0	0
13	25371436	.	A	G	3	9	12	0	0	12	0	0
13	25371475	.	C	A	7	9	16	0	0	16	0	0
13	25371918	.	A	G	2	1	3	0	0	3	0	0
13	25378924	.	T	G	8	8	16	0	0	16	0	0
13	25379263	.	A	T	20	15	35	0	0	35	0	0
13	25379304	.	A	G	14	0	14	0	18	32	0	0
13	25379352	.	A	C	8	7	15	0	2	17	0	0
13	25384281	.	T	C	3	2	5	0	1	6	0	0
13	25386904	.	C	T	2	1	3	0	0	3	0	0
13	25388389	.	G	A	7	5	12	0	3	15	0	0
13	25388764	.	T	G	1	0	1	0	4	5	0	0
13	25403985	.	G	A	1	1	2	0	2	4	0	0
13	25429048	.	T	A	2	3	5	0	1	6	0	0
13	25429145	.	G	A	2	2	4	0	0	4	0	0
13	25429158	.	G	A	1	3	4	0	0	4	0	0
13	25436360	.	A	T	6	12	18	0	0	18	0	0
13	25449688	.	A	C	1	2	3	0	1	4	0	0
13	25449867	.	C	A	1	2	3	0	0	3	0	0
13	25450114	.	G	A	3	2	5	0	0	5	0	0
13	25450460	.	A	C	1	6	7	0	0	7	0	0
13	25472084	.	C	T	5	6	11	0	0	11	0	0
13	25472336	.	G	A	27	16	43	0	2	45	0	0
13	25472735	.	G	A	14	13	27	0	0	27	0	0
13	25472859	.	G	A	15	10	25	0	2	27	0	0
13	25473084	.	T	A	28	19	47	0	3	50	0	0
13	25473325	.	G	A	5	4	9	0	0	9	0	0
13	25474019	.	G	T	16	14	30	0	2	32	0	0
13	25475904	.	A	G	6	2	8	0	1	9	0	0
13	25477304	.	A	G	6	6	12	0	2	14	0	0
13	25495556	.	C	T	2	3	5	0	0	5	0	0
13	25495781	.	G	A	1	0	1	0	1	2	0	0
13	25497575	.	T	C	5	1	6	0	1	7	0	0
13	25497581	.	C	T	5	3	8	0	0	8	0	0
13	25497700	.	G	C	5	6	11	0	0	11	0	0
13	25497769	.	T	A	10	8	18	0	2	20	0	0
13	25519063	.	G	A	0	3	3	0	1	4	0	0
13	25531776	.	T	C	3	4	7	0	0	7	0	0
13	25532352	.	C	T	10	8	18	0	0	18	0	0
13	25532574	.	C	A	13	13	26	0	0	26	0	0
13	25533233	.	G	A	6	14	20	0	1	21	0	0
13	25533258	.	T	A	5	13	18	0	1	20	1	0
13	25533452	.	A	T	7	14	21	0	0	21	0	0
13	25533657	.	C	G	6	0	6	0	12	18	0	0
13	25533767	.	G	T	11	13	24	0	2	26	0	0
13	25533846	.	G	A	7	14	21	0	2	23	0	0
13	25533897	.	C	T	4	6	10	0	0	10	0	0
13	25534172	.	T	A	9	11	20	0	0	20	0	0
13	25534787	.	A	G	1	3	4	0	0	4	0	0
13	25534812	.	A	T	2	2	4	0	0	4	0	0
13	25535405	.	G	A	4	4	8	0	4	12	0	0
13	25541048	.	G	A	1	1	2	0	0	2	0	0
13	25560458	.	A	T	2	0	2	0	0	2	0	0
13	25560471	.	G	A	0	0	0	0	2	2	0	0
13	25563221	.	C	A	4	3	7	0	0	7	0	0
13	25565379	.	T	C	12	4	16	0	0	16	0	0
13	25565985	.	G	A	4	6	10	0	0	10	0	0
13	25565988	.	A	C	4	5	9	0	1	10	0	0
13	25566205	.	A	T	4	8	12	0	0	12	0	0
13	25566222	.	C	T	4	4	8	0	1	9	0	0
13	25569940	.	A	C	4	3	7	0	1	8	0	0
13	25570104	.	C	T	5	3	8	0	1	9	0	0
13	25570410	.	A	G	10	6	16	0	2	18	0	0
13	25570477	.	G	A	6	9	15	0	1	16	0	0
13	25570618	.	A	T	4	5	9	0	1	10	0	0
13	25570709	.	T	C	4	0	4	0	7	11	0	0
13	25570715	.	C	T	4	6	10	0	0	10	0	0
13	25570854	.	A	T	2	4	6	0	5	12	1	0
13	25571113	.	A	T	4	2	6	0	0	6	0	0
13	25571274	.	C	T	5	3	8	0	0	8	0	0
13	25575396	.	C	T	0	2	2	0	0	2	0	0
13	25575411	.	A	C	0	2	2	0	1	3	0	0
13	25580764	.	C	A	3	2	5	0	0	5	0	0
13	25585785	.	T	C	1	2	3	0	0	3	0	0
13	25726201	.	C	T	4	5	9	0	0	9	0	0
13	25726308	.	A	C	3	6	9	0	0	9	0	0
13	25728453	.	A	C	2	6	8	0	2	10	0	0
13	25728606	.	A	T	3	3	6	0	1	7	0	0
13	25795635	.	T	C	2	2	4	0	0	5	1	0
13	25796084	.	G	A	1	2	3	0	0	3	0	0
13	25824718	.	C	T	12	17	29	0	2	31	0	0
13	25825016	.	G	A	15	19	34	0	0	34	0	0
13	25825445	.	A	T	3	3	6	0	1	7	0	0
13	25827421	.	G	A	6	3	9	0	0	9	0	0
13	25923392	.	A	G	10	10	20	0	1	21	0	0
13	25923450	.	A	T	6	5	11	0	0	11	0	0
13	25924388	.	C	T	6	10	16	0	3	19	0	0
13	25924523	.	C	T	3	7	10	0	1	11	0	0
13	27036660	.	T	C	1	4	5	0	1	6	0	0
13	27038163	.	G	A	1	2	3	0	0	3	0	0
13	27201552	.	G	A	0	1	1	0	0	1	0	0
13	27209852	.	T	C	0	1	1	0	0	1	0	0
13	27227407	.	C	A	3	3	6	0	0	6	0	0
13	27227449	.	A	G	2	5	7	0	1	8	0	0
13	27232456	.	A	G	1	4	5	0	0	5	0	0
13	27232479	.	C	A	2	2	4	0	0	4	0	0
13	27295080	.	T	C	1	2	3	0	0	3	0	0
13	27295459	.	T	C	1	3	4	0	0	4	0	0
13	27295488	.	C	T	2	1	3	0	4	7	0	0
13	27295576	.	G	A	4	2	6	0	0	6	0	0
13	27295578	.	C	T	4	2	6	0	0	6	0	0
13	27295706	.	A	T	1	2	3	0	0	3	0	0
13	27296278	.	A	G	5	5	10	0	0	10	0	0
13	27296291	.	T	C	4	5	9	0	0	9	0	0
13	27296396	.	G	A	3	3	6	0	0	6	0	0
13	27296415	.	T	A	4	5	9	0	0	9	0	0
13	27296433	.	A	G	3	6	9	0	0	9	0	0
13	27296576	.	C	T	2	7	9	0	1	10	0	0
13	27312888	.	G	A	2	3	5	0	0	5	0	0
13	27312938	.	C	T	3	3	6	0	0	6	0	0
13	27313044	.	A	C	2	2	4	0	1	5	0	0
13	27313066	.	G	T	2	2	4	0	0	4	0	0
13	27313310	.	T	A	8	10	18	0	0	18	0	0
13	27317026	.	C	T	9	10	19	0	1	20	0	0
13	27320771	.	C	T	1	0	1	0	0	1	0	0
13	27320996	.	G	A	0	7	7	0	15	22	0	0
13	27321211	.	C	T	19	34	53	0	8	61	0	0
13	27323976	.	G	A	0	18	18	0	17	35	0	0
13	27324341	.	A	T	30	29	59	0	1	60	0	0
13	27324346	.	T	C	29	30	59	0	1	60	0	0
13	27634324	.	T	C	21	14	35	0	1	36	0	0
13	27634789	.	A	G	14	18	32	0	4	36	0	0
13	27641472	.	T	C	6	6	12	0	0	12	0	0
13	27675462	.	T	C	1	0	1	0	7	8	0	0
13	27685329	.	C	T	0	3	3	0	6	9	0	0
13	27685363	.	G	A	3	7	10	0	0	10	0	0
13	27685446	.	C	T	12	3	15	0	0	15	0	0
13	27685552	.	G	A	5	10	15	0	0	15	0	0
13	27685583	.	C	T	0	15	15	0	7	22	0	0
13	27686252	.	G	A	4	6	10	0	1	11	0	0
13	27686405	.	G	A	10	8	18	0	0	18	0	0
13	27771607	.	T	G	2	0	2	0	5	7	0	0
13	27782332	.	C	T	1	3	4	0	0	4	0	0
13	27782448	.	G	A	1	2	3	0	1	4	0	0
13	27782585	.	G	A	4	4	8	0	0	8	0	0
13	27951758	.	T	A	7	7	14	0	0	14	0	0
13	27951827	.	G	A	0	4	4	0	6	10	0	0
13	27951883	.	A	G	3	1	4	0	7	11	0	0
13	27952156	.	C	T	6	11	17	0	2	19	0	0
13	27952414	.	A	G	18	17	35	0	0	35	0	0
13	27952441	.	G	T	16	19	35	0	1	36	0	0
13	28009108	.	C	T	13	15	28	0	0	28	0	0
13	28009159	.	G	A	12	15	27	0	1	28	0	0
13	28009178	.	A	C	11	15	26	0	4	30	0	0
13	28009246	.	A	T	17	21	38	0	0	38	0	0
13	28009567	.	G	A	16	16	32	0	1	33	0	0
13	28010183	.	G	A	27	24	51	0	15	66	0	0
13	28010214	.	C	A	3	29	32	0	29	61	0	0
13	28498793	.	G	A	1	0	1	0	1	2	0	0
13	28498812	.	G	A	4	0	4	0	0	4	0	0
13	28561116	.	T	C	1	3	4	0	0	4	0	0
13	28561184	.	T	C	3	2	5	0	0	5	0	0
13	28561190	.	A	T	3	3	6	0	1	7	0	0
13	28561244	.	G	C	3	6	9	0	1	10	0	0
13	28561304	.	T	A	10	6	16	0	3	19	0	0
13	28615556	.	C	T	15	4	19	0	0	19	0	0
13	28615622	.	T	C	4	4	8	0	1	9	0	0
13	28643087	.	C	T	3	5	8	0	0	8	0	0
13	28649848	.	A	C	9	13	22	0	4	26	0	0
13	28650239	.	A	T	14	15	29	0	0	29	0	0
13	28650416	.	G	C	15	11	26	0	0	26	0	0
13	28650683	.	A	G	18	12	30	0	4	34	0	0
13	28650945	.	T	C	21	9	30	0	0	30	0	0
13	28650954	.	T	G	6	20	26	0	1	27	0	0
13	28650984	.	A	G	9	10	19	0	3	22	0	0
13	28651214	.	C	A	1	11	12	0	14	26	0	0
13	28676134	.	G	C	2	5	7	0	1	8	0	0
13	28676472	.	C	G	3	0	3	0	6	9	0	0
13	28680634	.	T	A	3	12	15	0	1	16	0	0
13	28680847	.	T	A	2	5	7	0	2	9	0	0
13	28692778	.	C	T	1	3	4	0	1	5	0	0
13	28694384	.	C	A	3	4	7	0	0	7	0	0
13	28694390	.	C	T	3	5	8	0	0	8	0	0
13	28694664	.	T	C	7	3	10	0	1	11	0	0
13	28701246	.	G	A	0	0	0	0	2	2	0	0
13	28743835	.	C	T	13	9	22	0	1	23	0	0
13	28744495	.	G	A	0	18	18	0	12	30	0	0
13	28744775	.	C	T	8	12	20	0	0	20	0	0
13	28744831	.	C	T	5	4	9	0	0	9	0	0
13	28745801	.	T	G	5	15	20	0	2	22	0	0
13	28745934	.	C	A	3	11	14	0	0	14	0	0
13	28746033	.	G	A	5	16	21	0	0	21	0	0
13	28746326	.	A	G	2	3	5	0	0	5	0	0
13	28848220	.	G	A	1	2	3	0	0	3	0	0
13	28848473	.	C	T	0	0	0	0	1	1	0	0
13	28865700	.	T	C	3	13	16	0	1	17	0	0
13	28866413	.	A	T	17	17	34	0	1	35	0	0
13	28866518	.	C	T	15	13	28	0	2	30	0	0
13	28866590	.	A	G	14	12	26	0	2	28	0	0
13	28866615	.	C	T	21	12	33	0	0	33	0	0
13	28866722	.	T	C	11	13	24	0	0	24	0	0
13	28866810	.	G	A	11	12	23	0	3	26	0	0
13	28866857	.	G	A	0	7	7	0	12	19	0	0
13	28867159	.	G	A	1	20	21	0	17	38	0	0
13	28867367	.	C	T	19	14	33	0	4	37	0	0
13	28867382	.	A	T	16	19	35	0	3	38	0	0
13	28870917	.	T	C	15	39	54	0	0	54	0	0
13	28871055	.	T	C	4	5	9	0	3	12	0	0
13	28901714	.	T	A	24	29	53	0	3	56	0	0
13	28901871	.	A	T	3	25	28	0	2	30	0	0
13	28902058	.	C	T	19	16	35	0	1	36	0	0
13	28902169	.	C	T	19	18	37	0	3	40	0	0
13	28902170	.	C	G	18	19	37	0	3	40	0	0
13	28902215	.	T	C	21	19	40	0	3	43	0	0
13	29346927	.	G	A	0	7	7	0	4	11	0	0
13	29347156	.	G	A	0	9	9	0	3	12	0	0
13	29347170	.	G	A	4	6	10	0	2	12	0	0
13	29347327	.	A	T	5	3	8	0	1	9	0	0
13	29347745	.	A	C	8	12	20	0	1	21	0	0
13	29374514	.	C	T	0	3	3	0	0	3	0	0
13	29381047	.	A	C	2	1	3	0	0	3	0	0
13	29385786	.	A	G	2	0	2	0	0	2	0	0
13	29385894	.	G	A	0	2	2	0	1	3	0	0
13	29395207	.	C	A	1	6	7	0	1	8	0	0
13	29395236	.	C	T	1	5	6	0	0	6	0	0
13	29402613	.	T	G	9	9	18	0	0	18	0	0
13	29402669	.	C	T	1	5	6	0	1	7	0	0
13	29402681	.	A	C	2	4	6	0	0	6	0	0
13	29403957	.	C	T	17	7	24	0	1	25	0	0
13	29404003	.	G	A	10	8	18	0	0	18	0	0
13	29404218	.	T	A	8	8	16	0	2	18	0	0
13	29404399	.	A	T	16	12	28	0	2	30	0	0
13	29404400	.	C	T	16	12	28	0	2	30	0	0
13	29404754	.	T	A	8	8	16	0	0	17	1	0
13	29407802	.	T	G	14	6	20	0	1	21	0	0
13	29408226	.	T	C	8	6	14	0	0	14	0	0
13	29408499	.	G	A	6	7	13	0	0	13	0	0
13	29408530	.	C	T	3	0	3	0	0	3	0	0
13	29408650	.	A	G	5	6	11	0	1	12	0	0
13	29408745	.	G	A	5	7	12	0	0	12	0	0
13	29408989	.	G	A	6	9	15	0	0	15	0	0
13	29409239	.	G	A	3	4	7	0	1	8	0	0
13	29409265	.	C	T	0	3	3	0	3	6	0	0
13	29412299	.	G	A	2	2	4	0	0	4	0	0
13	29414546	.	A	G	2	0	2	0	0	2	0	0
13	29422459	.	C	T	4	3	7	0	2	9	0	0
13	29422499	.	C	G	0	4	4	0	5	9	0	0
13	29422808	.	G	A	4	5	9	0	0	9	0	0
13	29749717	.	G	T	1	1	2	0	0	2	0	0
13	29802607	.	C	A	8	5	13	0	2	15	0	0
13	29802633	.	A	G	5	3	8	0	1	9	0	0
13	29803253	.	C	T	1	5	6	0	0	6	0	0
13	29803801	.	G	A	6	3	9	0	0	9	0	0
13	29804178	.	T	A	1	4	5	0	1	6	0	0
13	29804362	.	T	C	4	6	10	0	0	10	0	0
13	29804800	.	G	A	3	2	5	0	0	5	0	0
13	29925560	.	A	T	1	2	3	0	1	4	0	0
13	29926221	.	G	A	1	1	2	0	0	2	0	0
13	29926242	.	C	T	2	1	3	0	0	3	0	0
13	29928675	.	A	G	6	6	12	0	0	12	0	0
13	29935371	.	A	G	2	5	7	0	0	7	0	0
13	29935678	.	T	G	0	6	6	0	1	8	1	0
13	29935682	.	T	C	1	5	6	0	1	7	0	0
13	29935885	.	C	A	5	2	7	0	3	10	0	0
13	29952902	.	C	T	5	2	7	0	0	7	0	0
13	29952914	.	G	A	5	2	7	0	0	7	0	0
13	29952972	.	C	T	4	7	11	0	1	12	0	0
13	29952973	.	A	T	4	7	11	0	1	12	0	0
13	29953265	.	T	G	7	5	12	0	3	15	0	0
13	29953267	.	C	A	8	6	14	0	1	15	0	0
13	29953522	.	T	C	5	0	5	0	9	14	0	0
13	29958513	.	T	A	3	9	12	0	0	12	0	0
13	29958551	.	G	A	2	7	9	0	1	10	0	0
13	29965856	.	G	A	2	2	4	0	0	4	0	0
13	29979966	.	T	C	1	2	3	0	0	3	0	0
13	29992119	.	T	C	2	2	4	0	0	4	0	0
13	30008116	.	G	A	1	3	4	0	0	4	0	0
13	30008147	.	G	A	1	1	2	0	1	3	0	0
13	30008596	.	A	T	27	20	47	0	4	51	0	0
13	30008631	.	T	C	24	18	42	0	5	47	0	0
13	30008737	.	T	C	19	17	36	0	5	41	0	0
13	30009128	.	G	C	6	5	11	0	1	12	0	0
13	30009818	.	A	C	17	26	43	0	4	47	0	0
13	30009968	.	T	C	14	14	28	4	1	33	0	0
13	30010059	.	C	A	21	11	32	0	3	35	0	0
13	30021321	.	T	A	4	5	9	0	0	9	0	0
13	30027133	.	T	G	5	2	7	0	0	7	0	0
13	30027523	.	T	A	1	2	3	0	0	3	0	0
13	30039013	.	C	T	3	4	7	0	0	7	0	0
13	30041662	.	G	A	2	3	5	0	0	5	0	0
13	30043579	.	A	G	7	2	9	0	0	9	0	0
13	30112396	.	C	T	2	4	6	0	4	10	0	0
13	30112414	.	T	A	4	2	6	0	0	6	0	0
13	30115125	.	A	G	3	0	3	0	1	4	0	0
13	30115217	.	C	T	1	3	4	0	0	4	0	0
13	30125106	.	G	A	1	0	1	0	0	1	0	0
13	30125107	.	T	C	1	0	1	0	0	1	0	0
13	30128388	.	A	T	1	0	1	0	1	2	0	0
13	30131722	.	G	T	24	14	38	0	1	39	0	0
13	30131804	.	G	A	15	22	37	0	1	38	0	0
13	30132190	.	T	C	31	18	49	0	4	53	0	0
13	30145000	.	A	C	1	4	5	0	0	5	0	0
13	30145217	.	A	G	7	8	15	0	0	15	0	0
13	30145514	.	T	A	4	3	7	0	0	7	0	0
13	30145616	.	T	A	4	6	10	0	0	10	0	0
13	30145660	.	T	C	1	5	6	0	0	6	0	0
13	30145662	.	C	A	1	5	6	0	0	6	0	0
13	30146199	.	C	A	3	1	4	0	0	4	0	0
13	30146447	.	T	A	2	2	4	0	1	5	0	0
13	30152310	.	A	C	7	7	14	0	1	15	0	0
13	30152502	.	G	C	7	15	22	0	5	27	0	0
13	30155934	.	C	T	6	13	19	0	4	23	0	0
13	30155973	.	T	A	5	4	9	0	2	11	0	0
13	30156176	.	T	C	3	10	13	0	0	13	0	0
13	30156347	.	A	T	1	2	3	0	0	3	0	0
13	30158975	.	A	G	1	5	6	0	0	6	0	0
13	30161553	.	T	A	4	6	10	0	1	11	0	0
13	30166340	.	C	A	8	12	20	0	1	21	0	0
13	30167430	.	T	G	9	14	23	0	2	25	0	0
13	30167432	.	A	G	11	13	24	0	1	25	0	0
13	30167711	.	G	A	16	17	33	0	3	36	0	0
13	30167716	.	T	C	17	17	34	0	4	38	0	0
13	30167807	.	G	A	0	22	22	0	17	39	0	0
13	30168662	.	T	A	18	12	30	0	5	35	0	0
13	30199148	.	G	A	2	3	5	0	1	6	0	0
13	30199190	.	T	C	3	3	6	0	1	7	0	0
13	30199210	.	T	C	1	4	5	0	0	5	0	0
13	30199225	.	T	C	1	2	3	0	0	3	0	0
13	30199424	.	A	T	2	4	6	0	0	6	0	0
13	30229090	.	A	G	26	1	27	0	34	61	0	0
13	30233273	.	T	A	2	2	4	0	0	4	0	0
13	30234351	.	A	C	7	4	11	0	1	12	0	0
13	30235107	.	G	C	1	2	3	0	0	3	0	0
13	30553002	.	C	T	1	3	4	0	1	5	0	0
13	30553682	.	C	T	1	4	5	0	0	5	0	0
13	30555751	.	G	A	2	0	2	0	0	2	0	0
13	30556278	.	C	T	2	1	3	0	0	3	0	0
13	30558555	.	C	A	1	1	2	0	0	2	0	0
13	30559044	.	A	G	1	1	2	0	0	2	0	0
13	30562079	.	T	G	6	3	9	0	0	9	0	0
13	30562673	.	T	C	3	1	4	0	3	7	0	0
13	30568158	.	T	C	6	5	11	0	0	11	0	0
13	30568316	.	T	A	8	3	11	0	0	11	0	0
13	30568875	.	A	G	5	12	17	0	1	18	0	0
13	30569650	.	A	C	4	2	6	0	1	7	0	0
13	30575206	.	G	A	0	1	1	0	0	1	0	0
13	30575325	.	A	G	0	1	1	0	0	1	0	0
13	30575452	.	C	A	5	2	7	0	1	8	0	0
13	30575637	.	T	A	2	11	13	0	0	13	0	0
13	30579552	.	A	G	3	6	9	0	1	10	0	0
13	30579565	.	A	G	4	4	8	0	2	10	0	0
13	30580786	.	A	T	1	2	3	0	0	4	1	0
13	30580966	.	T	G	3	4	7	0	1	8	0	0
13	30581686	.	A	T	2	5	7	0	0	7	0	0
13	30582461	.	T	C	1	1	2	0	1	3	0	0
13	30582468	.	A	G	2	1	3	0	0	3	0	0
13	30582729	.	G	A	1	2	3	0	0	3	0	0
13	30582746	.	C	T	0	2	2	0	2	4	0	0
13	30582781	.	G	A	2	2	4	0	0	4	0	0
13	30583664	.	T	A	1	3	4	0	0	4	0	0
13	30817617	.	G	T	2	4	6	0	0	6	0	0
13	30817633	.	G	A	2	5	7	0	0	7	0	0
13	30817872	.	A	G	3	0	3	0	7	10	0	0
13	30818107	.	C	G	6	6	12	0	0	12	0	0
13	30818246	.	C	T	5	13	18	0	0	18	0	0
13	30818849	.	A	G	8	10	18	0	0	18	0	0
13	30818876	.	C	T	9	8	17	0	0	17	0	0
13	30818986	.	T	A	13	2	15	0	1	16	0	0
13	30819133	.	G	C	9	22	31	0	1	32	0	0
13	30819334	.	T	C	4	7	11	1	1	14	1	0
13	30819645	.	T	C	4	4	8	0	1	9	0	0
13	30878624	.	A	T	3	2	5	0	0	5	0	0
13	30892629	.	C	T	1	1	2	0	0	2	0	0
13	30903921	.	T	A	2	2	4	0	1	5	0	0
13	30905716	.	T	C	6	6	12	0	0	12	0	0
13	30906016	.	A	G	3	4	7	0	2	9	0	0
13	30906190	.	A	T	2	1	3	0	0	3	0	0
13	30908977	.	T	C	7	6	13	0	1	14	0	0
13	30909449	.	G	T	1	3	4	0	0	4	0	0
13	30909624	.	T	A	2	4	6	0	0	6	0	0
13	33122276	.	T	A	5	8	13	0	0	13	0	0
13	33122429	.	C	G	10	6	16	0	2	18	0	0
13	33122524	.	C	T	7	10	17	0	1	18	0	0
13	33122554	.	A	T	11	8	19	0	1	20	0	0
13	33122626	.	A	T	19	3	22	0	2	24	0	0
13	33122642	.	G	A	19	5	24	0	1	25	0	0
13	33122756	.	A	G	8	16	24	0	2	26	0	0
13	33122773	.	G	T	9	14	23	0	2	25	0	0
13	33122795	.	C	A	10	16	26	0	0	26	0	0
13	33122941	.	C	T	16	7	23	0	3	26	0	0
13	33122949	.	G	C	18	3	21	0	5	26	0	0
13	33122986	.	A	G	13	0	13	0	16	29	0	0
13	33123031	.	T	A	13	12	25	0	0	25	0	0
13	33123154	.	C	A	8	12	20	0	1	21	0	0
13	33155680	.	C	T	3	2	5	0	0	5	0	0
13	33174415	.	A	T	4	8	12	0	2	14	0	0
13	33174865	.	T	G	5	2	7	0	3	10	0	0
13	33175097	.	A	C	3	2	5	0	0	5	0	0
13	33175190	.	A	G	6	8	14	0	0	14	0	0
13	33175202	.	T	C	5	0	5	0	8	13	0	0
13	33175314	.	A	G	5	3	8	0	2	10	0	0
13	33177425	.	G	T	2	2	4	0	1	5	0	0
13	33177637	.	A	G	4	4	8	0	0	8	0	0
13	33177682	.	C	G	0	3	3	0	7	10	0	0
13	33187199	.	G	A	0	2	2	0	0	2	0	0
13	33187388	.	T	C	0	2	2	0	1	3	0	0
13	33187760	.	G	A	2	2	4	0	0	4	0	0
13	33192619	.	C	A	2	4	6	0	2	8	0	0
13	33194458	.	G	A	2	2	4	0	0	4	0	0
13	33194527	.	G	C	0	3	3	0	1	4	0	0
13	33211445	.	A	T	11	4	15	0	0	15	0	0
13	33214492	.	T	C	4	0	4	0	1	5	0	0
13	33214664	.	C	T	0	4	4	0	5	9	0	0
13	33214706	.	C	T	10	13	23	0	0	23	0	0
13	33214709	.	T	C	9	14	23	0	1	24	0	0
13	33214804	.	G	A	4	10	14	0	1	15	0	0
13	33214985	.	C	T	6	5	11	0	0	11	0	0
13	33216341	.	G	A	3	13	16	0	0	16	0	0
13	33218037	.	T	C	7	3	10	0	1	11	0	0
13	33218214	.	C	T	1	4	5	0	0	5	0	0
13	33219988	.	C	A	0	5	5	0	3	8	0	0
13	33220164	.	A	G	1	3	4	0	0	4	0	0
13	33222342	.	C	A	0	1	1	0	1	2	0	0
13	33222396	.	G	A	2	6	8	0	0	8	0	0
13	33224678	.	G	A	3	6	9	0	1	10	0	0
13	33224706	.	T	G	3	6	9	0	2	11	0	0
13	33224716	.	G	A	5	6	11	0	0	11	0	0
13	33224742	.	G	T	4	3	7	0	0	7	0	0
13	33227271	.	G	C	2	2	4	0	0	4	0	0
13	33229449	.	C	T	0	3	3	0	1	4	0	0
13	33229502	.	T	G	12	6	18	0	2	20	0	0
13	33229739	.	T	C	11	17	28	0	2	30	0	0
13	33229753	.	C	T	9	17	26	0	2	28	0	0
13	33230024	.	A	T	17	23	40	0	3	43	0	0
13	33230163	.	G	C	12	25	37	0	0	37	0	0
13	33230177	.	G	A	10	25	35	0	0	35	0	0
13	33230518	.	T	C	4	0	4	0	14	19	1	0
13	33236111	.	T	C	1	4	5	0	0	5	0	0
13	33236482	.	G	T	2	2	4	0	1	5	0	0
13	33236902	.	C	T	2	2	4	0	1	5	0	0
13	33238954	.	A	G	7	11	18	0	1	19	0	0
13	33238960	.	G	A	7	11	18	0	2	20	0	0
13	33239237	.	T	C	3	0	3	0	12	15	0	0
13	33242878	.	C	T	4	3	7	0	0	7	0	0
13	33246227	.	T	A	4	4	8	0	1	9	0	0
13	33246249	.	T	A	6	6	12	0	1	13	0	0
13	33248255	.	T	C	10	9	19	0	2	21	0	0
13	33248308	.	C	T	4	6	10	0	2	12	0	0
13	33248443	.	T	C	8	11	19	0	0	19	0	0
13	33250992	.	T	A	15	14	29	0	0	29	0	0
13	33251058	.	C	G	1	0	1	0	6	7	0	0
13	33261198	.	A	G	21	18	39	0	2	41	0	0
13	33261620	.	T	C	23	24	47	0	1	48	0	0
13	33261637	.	G	A	21	9	30	0	1	36	5	0
13	33261889	.	C	T	22	23	45	0	1	46	0	0
13	33262909	.	G	T	12	23	35	0	0	35	0	0
13	33262944	.	C	G	9	26	35	0	1	36	0	0
13	33262956	.	C	A	10	28	38	0	2	40	0	0
13	33262997	.	A	G	12	27	39	0	2	41	0	0
13	33263138	.	C	A	5	9	14	0	1	15	0	0
13	33263203	.	C	T	0	4	4	0	3	7	0	0
13	33263213	.	G	A	2	1	3	0	1	4	0	0
13	33263385	.	G	A	2	3	5	0	1	6	0	0
13	33263568	.	G	A	6	14	20	0	4	24	0	0
13	33263670	.	T	A	16	9	25	0	0	25	0	0
13	33263685	.	T	C	15	10	25	0	2	27	0	0
13	33263774	.	G	A	9	3	12	0	2	14	0	0
13	33263860	.	A	T	14	0	14	0	1	15	0	0
13	33263940	.	T	C	9	15	24	0	2	26	0	0
13	33263985	.	C	A	6	13	19	0	1	20	0	0
13	33264001	.	G	A	9	11	20	0	0	20	0	0
13	33264483	.	T	A	14	10	24	0	0	24	0	0
13	33264519	.	C	T	0	11	11	0	11	22	0	0
13	33264550	.	T	C	10	10	20	0	0	20	0	0
13	33264635	.	A	T	11	10	21	0	0	21	0	0
13	33264772	.	A	T	7	9	16	0	2	18	0	0
13	33265210	.	T	G	10	21	31	0	0	31	0	0
13	33276011	.	G	A	1	1	2	0	1	3	0	0
13	33276156	.	T	C	1	3	4	0	0	4	0	0
13	33293608	.	C	A	1	2	3	0	0	3	0	0
13	33295894	.	T	A	5	2	7	0	0	7	0	0
13	33301604	.	C	G	1	2	3	0	0	3	0	0
13	33310635	.	C	A	1	2	3	0	0	3	0	0
13	33311074	.	G	A	0	2	2	0	0	2	0	0
13	33313085	.	C	G	0	1	1	0	0	1	0	0
13	33314863	.	T	C	3	3	6	0	0	6	0	0
13	33314946	.	T	C	3	4	7	0	1	8	0	0
13	33314974	.	T	A	4	5	9	0	0	9	0	0
13	33315112	.	C	G	3	2	5	0	0	5	0	0
13	33394476	.	A	C	21	21	42	0	6	48	0	0
13	33394887	.	G	A	20	23	43	0	3	46	0	0
13	33394976	.	T	C	10	32	42	0	1	43	0	0
13	33395174	.	C	G	17	21	38	0	1	39	0	0
13	33395256	.	T	G	5	16	21	0	1	22	0	0
13	33396026	.	A	C	3	0	3	0	3	6	0	0
13	33398365	.	C	T	14	12	26	0	0	26	0	0
13	33398445	.	C	A	1	9	10	0	4	14	0	0
13	33398498	.	G	A	5	6	11	0	0	11	0	0
13	33398668	.	C	A	5	8	13	0	1	14	0	0
13	33411068	.	C	T	0	3	3	0	1	4	0	0
13	33445279	.	G	A	1	0	1	0	0	1	0	0
13	33447088	.	C	G	0	1	1	0	1	2	0	0
13	33447137	.	A	G	1	8	9	0	0	9	0	0
13	33447168	.	T	A	1	8	9	0	0	9	0	0
13	33447175	.	A	G	1	0	1	0	8	9	0	0
13	33447260	.	C	T	3	4	7	0	0	7	0	0
13	33447281	.	A	G	3	4	7	0	0	7	0	0
13	33447389	.	T	C	3	6	9	0	1	10	0	0
13	33448217	.	T	G	1	2	3	0	0	3	0	0
13	33448245	.	C	A	2	2	4	0	0	4	0	0
13	33614712	.	C	A	2	1	3	0	0	3	0	0
13	33614751	.	T	C	1	1	2	0	0	2	0	0
13	33617129	.	T	A	1	0	1	0	0	1	0	0
13	33619849	.	A	G	3	1	4	0	0	4	0	0
13	33622486	.	A	G	0	1	1	0	0	1	0	0
13	33622519	.	T	C	0	1	1	0	0	1	0	0
13	33624713	.	C	G	1	2	3	0	0	3	0	0
13	33636073	.	G	T	2	3	5	0	0	5	0	0
13	33636434	.	T	G	2	2	4	0	0	4	0	0
13	33645569	.	C	T	8	4	12	0	1	13	0	0
13	33645754	.	T	C	1	2	3	0	0	3	0	0
13	33646059	.	A	G	5	6	11	0	1	12	0	0
13	33646063	.	C	G	6	7	13	0	1	14	0	0
13	33646458	.	T	G	1	2	3	0	0	3	0	0
13	33646514	.	A	G	4	3	7	0	0	7	0	0
13	33646545	.	A	G	3	3	6	0	0	6	0	0
13	33646615	.	G	A	3	7	10	0	0	10	0	0
13	33649184	.	T	G	2	2	4	0	0	4	0	0
13	33682048	.	C	A	18	13	31	0	1	32	0	0
13	33682474	.	T	G	4	2	6	0	2	8	0	0
13	33682482	.	A	T	5	4	9	0	0	9	0	0
13	33682617	.	T	C	5	4	9	0	3	12	0	0
13	33682682	.	G	A	28	13	41	0	2	43	0	0
13	33682731	.	G	A	17	16	33	0	1	34	0	0
13	33683609	.	T	C	2	2	4	0	0	4	0	0
13	33683696	.	A	G	19	33	52	0	1	53	0	0
13	33683701	.	G	C	19	35	54	0	2	56	0	0
13	33813428	.	A	C	4	8	12	0	1	13	0	0
13	33816176	.	T	A	2	2	4	0	0	4	0	0
13	33968506	.	T	C	0	3	3	0	0	3	0	0
13	33968509	.	C	T	0	3	3	0	0	3	0	0
13	34217398	.	C	T	2	3	5	0	0	5	0	0
13	34519607	.	T	A	0	3	3	0	0	3	0	0
13	34523224	.	G	A	1	1	2	0	1	3	0	0
13	34556374	.	C	A	0	1	1	0	0	1	0	0
13	34690105	.	T	A	0	1	1	0	0	1	0	0
13	34747254	.	C	T	3	2	5	0	0	5	0	0
13	34747260	.	G	T	3	2	5	0	0	5	0	0
13	34748062	.	A	T	3	2	5	0	0	5	0	0
13	34748086	.	G	T	2	1	3	0	0	3	0	0
13	34748479	.	A	G	2	2	4	0	0	4	0	0
13	34748527	.	G	A	4	3	7	0	1	8	0	0
13	34748570	.	C	A	7	6	13	0	0	13	0	0
13	34749147	.	C	A	1	2	3	0	0	3	0	0
13	34749366	.	T	C	3	4	7	0	0	7	0	0
13	34749693	.	C	T	10	4	14	0	0	14	0	0
13	34749751	.	C	T	7	8	15	0	0	15	0	0
13	34749786	.	A	C	11	9	20	0	0	20	0	0
13	34749819	.	C	T	12	10	22	0	2	24	0	0
13	34749833	.	A	G	11	12	23	0	0	23	0	0
13	34749936	.	T	A	9	6	15	0	1	16	0	0
13	34765315	.	A	G	5	4	9	0	0	9	0	0
13	34765383	.	G	A	1	3	4	0	0	4	0	0
13	34765480	.	G	A	5	5	10	0	0	10	0	0
13	34765569	.	T	G	3	5	8	0	0	8	0	0
13	34765690	.	A	G	1	2	3	0	1	4	0	0
13	34766238	.	G	A	1	2	3	0	0	3	0	0
13	35049461	.	A	G	1	1	2	0	0	2	0	0
13	35389670	.	C	T	1	1	2	0	1	3	0	0
13	35481503	.	C	T	2	3	5	0	0	5	0	0
13	35511074	.	A	G	1	2	3	0	0	3	0	0
13	35511245	.	A	G	3	3	6	0	0	6	0	0
13	35511339	.	A	G	7	5	12	0	0	12	0	0
13	35511612	.	C	T	5	4	9	0	0	9	0	0
13	35527647	.	G	T	2	2	4	0	0	4	0	0
13	35723494	.	G	A	0	3	3	0	1	4	0	0
13	35744378	.	C	T	4	3	7	0	0	7	0	0
13	35744803	.	G	C	1	2	3	0	0	3	0	0
13	35745657	.	T	C	3	2	5	0	0	5	0	0
13	35745686	.	T	C	4	3	7	0	0	7	0	0
13	35746775	.	T	C	2	7	9	0	0	9	0	0
13	35746838	.	T	C	6	4	10	0	1	11	0	0
13	35747420	.	T	C	8	8	16	0	2	18	0	0
13	35747510	.	G	A	13	14	27	0	0	27	0	0
13	35747564	.	A	G	14	13	27	0	1	28	0	0
13	35747918	.	T	C	17	16	33	0	5	38	0	0
13	35747954	.	T	C	18	23	41	0	3	44	0	0
13	35748096	.	C	G	13	0	13	0	25	38	0	0
13	35748109	.	C	G	16	17	33	0	3	36	0	0
13	35748144	.	A	G	18	12	30	0	2	32	0	0
13	35748238	.	T	A	18	16	34	0	0	34	0	0
13	35748319	.	T	C	15	11	26	0	2	28	0	0
13	35748412	.	A	C	19	12	31	0	2	33	0	0
13	35750836	.	G	A	14	6	20	0	1	21	0	0
13	35751047	.	T	C	6	11	17	0	0	17	0	0
13	35751162	.	T	A	12	13	25	0	3	28	0	0
13	35751211	.	T	C	7	10	17	0	0	17	0	0
13	35756029	.	G	T	3	3	6	0	0	6	0	0
13	35757260	.	G	A	6	4	10	0	0	10	0	0
13	35757338	.	T	G	4	2	6	0	2	8	0	0
13	35787680	.	G	T	4	5	9	0	0	9	0	0
13	35787722	.	G	A	0	3	3	0	1	4	0	0
13	35787735	.	T	C	1	2	3	0	0	3	0	0
13	35788128	.	G	T	12	15	27	0	0	27	0	0
13	35788497	.	T	G	14	16	30	0	1	31	0	0
13	35788503	.	T	C	16	15	31	0	3	34	0	0
13	35788562	.	C	G	0	7	7	0	22	30	1	0
13	35791419	.	C	G	10	10	20	0	4	24	0	0
13	35791455	.	A	G	17	15	32	0	0	32	0	0
13	35791539	.	G	A	4	5	9	0	0	9	0	0
13	35798915	.	A	G	5	4	9	0	0	9	0	0
13	35799146	.	G	A	1	2	3	0	0	3	0	0
13	35799194	.	C	T	3	4	7	0	2	9	0	0
13	35799200	.	G	T	3	6	9	0	0	9	0	0
13	35799230	.	A	G	2	1	3	0	0	3	0	0
13	35801413	.	C	G	9	9	18	0	1	19	0	0
13	35801419	.	A	G	9	10	19	0	0	19	0	0
13	35801452	.	A	G	10	8	18	0	2	20	0	0
13	35801473	.	A	G	10	9	19	0	0	19	0	0
13	35801501	.	T	C	6	0	6	0	6	12	0	0
13	35808197	.	G	T	3	0	3	0	0	3	0	0
13	35808949	.	T	C	1	4	5	0	0	5	0	0
13	35811400	.	A	G	2	3	5	0	0	5	0	0
13	35824278	.	A	G	2	2	4	0	0	4	0	0
13	35871825	.	C	T	3	2	5	0	0	5	0	0
13	35904738	.	C	T	0	2	2	0	2	4	0	0
13	35904775	.	C	G	6	4	10	0	0	10	0	0
13	35904964	.	G	A	1	2	3	0	0	3	0	0
13	35905024	.	G	A	5	3	8	0	0	8	0	0
13	35905136	.	G	A	2	2	4	0	0	4	0	0
13	36039711	.	C	T	8	4	12	0	0	12	0	0
13	36039807	.	T	C	14	13	27	0	2	29	0	0
13	36039828	.	T	C	12	0	12	0	20	32	0	0
13	36040061	.	G	T	16	18	34	0	5	39	0	0
13	36040127	.	A	T	16	25	41	0	6	47	0	0
13	36040429	.	C	T	7	6	13	0	2	15	0	0
13	36040473	.	A	C	7	7	14	0	0	14	0	0
13	36040635	.	C	A	3	5	8	0	1	9	0	0
13	36044370	.	C	T	2	0	2	0	0	2	0	0
13	36047444	.	G	A	0	0	0	0	1	1	0	0
13	36048658	.	A	C	1	5	6	0	0	6	0	0
13	36054289	.	A	G	10	8	18	0	1	19	0	0
13	36054432	.	A	C	7	4	11	0	1	12	0	0
13	36054962	.	T	C	17	14	31	0	2	33	0	0
13	36135416	.	A	G	3	6	9	0	1	10	0	0
13	36136585	.	A	G	0	4	4	0	3	7	0	0
13	36136669	.	C	G	0	3	3	0	3	6	0	0
13	36138360	.	G	A	5	6	11	0	0	11	0	0
13	36146596	.	G	A	10	5	15	0	1	16	0	0
13	36151234	.	G	A	0	5	5	0	9	14	0	0
13	36151462	.	G	A	9	10	19	0	1	20	0	0
13	36151635	.	T	C	13	6	19	0	2	21	0	0
13	36151858	.	G	C	12	16	28	0	2	30	0	0
13	36151868	.	A	G	12	9	21	0	4	25	0	0
13	36151894	.	G	C	13	8	21	0	2	23	0	0
13	36151929	.	C	T	12	8	20	0	0	20	0	0
13	36152030	.	C	A	21	13	34	0	6	40	0	0
13	36152069	.	A	C	18	15	33	0	5	38	0	0
13	36152102	.	T	A	19	20	39	0	2	41	0	0
13	36152108	.	T	C	21	20	41	0	2	43	0	0
13	36152202	.	T	C	19	20	39	0	3	42	0	0
13	36152269	.	T	G	16	16	32	0	3	35	0	0
13	36152364	.	T	C	24	17	41	0	0	41	0	0
13	36152402	.	C	T	22	22	44	0	0	44	0	0
13	36152415	.	A	G	22	27	49	0	0	49	0	0
13	36152440	.	T	G	23	1	24	0	23	47	0	0
13	36152700	.	T	A	13	17	30	0	1	31	0	0
13	36152733	.	A	G	9	14	23	0	0	23	0	0
13	36152758	.	C	T	10	14	24	0	1	25	0	0
13	36152778	.	A	G	7	16	23	0	1	24	0	0
13	36152795	.	A	C	9	14	23	0	0	23	0	0
13	36152838	.	A	G	6	0	6	0	11	17	0	0
13	36152874	.	C	T	3	7	10	0	0	10	0	0
13	36153063	.	T	A	1	3	4	0	0	4	0	0
13	36153098	.	G	A	2	3	5	0	0	5	0	0
13	36153112	.	G	T	2	2	4	0	0	4	0	0
13	36153183	.	A	T	5	4	9	0	0	9	0	0
13	36153313	.	T	C	8	16	24	0	5	29	0	0
13	36153382	.	C	T	12	22	34	0	2	36	0	0
13	36170636	.	A	G	1	2	3	0	0	3	0	0
13	36179838	.	C	T	2	4	6	0	0	6	0	0
13	36179844	.	A	T	2	6	8	0	0	8	0	0
13	36312080	.	T	C	3	4	7	0	0	7	0	0
13	36312103	.	C	G	4	4	8	0	1	9	0	0
13	36312193	.	G	T	16	6	22	0	4	26	0	0
13	36312361	.	C	A	5	3	8	0	0	8	0	0
13	36312447	.	A	G	4	5	9	0	0	9	0	0
13	36312469	.	T	G	8	3	11	0	0	11	0	0
13	36312497	.	C	T	1	3	4	0	7	11	0	0
13	36312682	.	G	A	4	2	6	0	0	6	0	0
13	36322099	.	C	T	0	8	8	0	14	22	0	0
13	36322133	.	A	G	17	7	24	0	2	26	0	0
13	36330642	.	G	A	3	3	6	0	1	7	0	0
13	36335033	.	G	A	0	3	3	0	1	4	0	0
13	36335057	.	A	G	1	3	4	0	0	4	0	0
13	36349674	.	G	A	0	1	1	0	1	2	0	0
13	36409233	.	A	T	5	2	7	0	1	8	0	0
13	36409246	.	C	T	5	1	6	0	0	6	0	0
13	36409691	.	A	G	15	6	21	0	0	21	0	0
13	36410339	.	T	C	4	4	8	0	2	10	0	0
13	36410671	.	T	C	4	3	7	0	0	7	0	0
13	36424414	.	G	A	2	3	5	0	0	5	0	0
13	36450109	.	C	T	2	2	4	0	0	4	0	0
13	36530629	.	A	G	38	23	61	0	2	63	0	0
13	36531957	.	A	G	10	1	11	0	0	11	0	0
13	36532607	.	G	T	31	31	62	0	4	66	0	0
13	36532752	.	G	A	24	24	48	0	0	48	0	0
13	36533174	.	C	T	22	15	37	0	2	39	0	0
13	36534273	.	T	C	3	4	7	0	1	8	0	0
13	36537510	.	T	A	10	5	15	0	0	15	0	0
13	36560808	.	G	A	6	2	8	0	0	8	0	0
13	36568867	.	A	G	20	11	31	0	1	32	0	0
13	36568897	.	G	A	20	12	32	0	3	35	0	0
13	36569020	.	A	T	20	13	33	0	3	36	0	0
13	36569330	.	G	A	9	5	14	0	0	14	0	0
13	36579281	.	G	A	7	6	13	0	0	13	0	0
13	36579356	.	G	C	8	11	19	0	2	21	0	0
13	36589020	.	G	A	8	4	12	0	0	12	0	0
13	36589556	.	A	G	2	0	2	0	0	2	0	0
13	36592619	.	G	T	20	11	31	0	2	33	0	0
13	36592732	.	T	C	10	14	24	0	2	27	1	0
13	36592952	.	A	G	14	14	28	0	1	29	0	0
13	36592969	.	T	C	19	15	34	0	2	36	0	0
13	36593052	.	G	A	16	12	28	0	1	29	0	0
13	36593121	.	C	T	9	11	20	0	0	20	0	0
13	36593278	.	T	C	30	17	47	0	3	50	0	0
13	36593478	.	C	A	11	10	21	0	1	22	0	0
13	36605649	.	G	A	3	8	11	0	18	29	0	0
13	36605682	.	T	C	16	10	26	0	0	26	0	0
13	36605811	.	T	C	14	9	23	0	2	25	0	0
13	36605851	.	G	A	1	6	7	0	12	21	2	0
13	36606012	.	C	T	11	7	18	0	1	19	0	0
13	36606023	.	T	C	9	6	15	0	2	17	0	0
13	36606073	.	C	A	10	6	16	0	1	17	0	0
13	36606422	.	C	T	18	10	28	0	4	32	0	0
13	36606632	.	A	T	6	8	14	0	0	14	0	0
13	36606657	.	C	T	12	7	19	0	1	20	0	0
13	36606724	.	C	A	14	10	24	0	1	25	0	0
13	36606725	.	A	G	15	10	25	0	0	25	0	0
13	36614574	.	C	T	1	2	3	0	0	3	0	0
13	36625784	.	T	C	2	5	7	0	1	8	0	0
13	36625821	.	G	A	2	6	8	0	0	8	0	0
13	36636464	.	A	G	16	2	18	0	26	44	0	0
13	36636491	.	C	T	11	16	27	0	1	28	0	0
13	36638783	.	C	T	18	17	35	0	0	35	0	0
13	36638906	.	C	A	10	6	16	0	0	16	0	0
13	36639424	.	A	G	12	17	29	0	0	29	0	0
13	36639598	.	C	T	5	6	11	0	1	12	0	0
13	36640032	.	A	G	11	9	20	0	1	21	0	0
13	36640063	.	G	C	6	6	12	0	3	15	0	0
13	36640555	.	T	G	4	10	14	0	4	18	0	0
13	36647553	.	C	T	0	1	1	0	0	1	0	0
13	36995940	.	A	G	1	2	3	0	0	3	0	0
13	36996530	.	A	G	3	2	5	0	0	5	0	0
13	37076269	.	T	C	12	7	19	0	3	22	0	0
13	38304824	.	A	G	3	2	5	0	0	5	0	0
13	38466247	.	C	T	1	2	3	0	0	3	0	0
13	38466343	.	T	C	5	1	6	0	0	6	0	0
13	38583699	.	C	A	16	22	38	0	2	40	0	0
13	38583714	.	A	G	20	18	38	0	2	40	0	0
13	38593559	.	A	G	23	26	49	0	4	53	0	0
13	38593574	.	A	T	27	20	47	0	1	48	0	0
13	38622184	.	C	T	0	5	5	0	10	15	0	0
13	38666128	.	G	A	3	3	6	0	0	6	0	0
13	39114474	.	G	T	2	2	4	0	0	4	0	0
13	39114730	.	G	T	1	1	2	0	1	3	0	0
13	39114751	.	A	T	1	4	5	0	0	5	0	0
13	39114793	.	A	G	1	2	3	0	1	4	0	0
13	39115335	.	C	T	1	2	3	0	0	3	0	0
13	39115422	.	A	T	3	2	5	0	0	5	0	0
13	39217657	.	C	T	2	3	5	0	0	5	0	0
13	39218060	.	T	C	2	4	6	0	0	6	0	0
13	39218097	.	A	G	2	2	4	0	1	5	0	0
13	39218133	.	C	A	3	2	5	0	0	5	0	0
13	39218602	.	A	G	3	0	3	0	9	12	0	0
13	39218706	.	T	C	7	7	14	0	0	14	0	0
13	39218843	.	G	A	0	8	8	0	6	14	0	0
13	39221960	.	T	C	1	2	3	0	1	4	0	0
13	39224003	.	C	T	1	1	2	0	0	2	0	0
13	39226666	.	T	C	2	8	10	0	3	13	0	0
13	39227275	.	G	A	0	12	12	0	10	22	0	0
13	39228272	.	G	A	4	2	6	0	0	6	0	0
13	39301051	.	G	A	1	1	2	0	0	2	0	0
13	39303070	.	A	G	1	2	3	0	0	3	0	0
13	39305208	.	C	G	0	2	2	0	0	2	0	0
13	39657068	.	A	G	5	4	9	0	0	9	0	0
13	39657625	.	A	C	1	4	5	0	0	5	0	0
13	39657652	.	A	G	2	4	6	0	0	6	0	0
13	39830658	.	C	G	2	2	4	0	0	4	0	0
13	40335087	.	T	G	5	5	10	0	0	10	0	0
13	40344258	.	C	T	1	6	7	0	2	9	0	0
13	40344303	.	G	A	0	7	7	0	4	11	0	0
13	40351869	.	G	A	11	11	22	0	1	23	0	0
13	40351914	.	G	A	0	9	9	0	12	21	0	0
13	40351953	.	C	T	13	7	20	0	2	22	0	0
13	40352345	.	C	T	13	16	29	0	2	31	0	0
13	40352349	.	C	G	12	18	30	0	0	30	0	0
13	40352415	.	T	G	9	15	24	0	0	24	0	0
13	40352476	.	A	G	13	4	17	0	1	18	0	0
13	40353199	.	A	G	5	3	8	0	0	8	0	0
13	40353512	.	G	T	20	13	33	0	2	35	0	0
13	40353736	.	A	C	9	10	19	0	3	22	0	0
13	40354235	.	C	T	4	9	13	0	1	14	0	0
13	40445253	.	C	T	2	4	6	0	1	7	0	0
13	40463048	.	T	A	3	3	6	0	0	6	0	0
13	40463116	.	C	T	1	2	3	0	0	3	0	0
13	40463242	.	T	G	2	2	4	0	0	4	0	0
13	40463732	.	C	T	0	7	7	0	7	14	0	0
13	40481324	.	A	T	1	1	2	0	0	2	0	0
13	40497802	.	A	G	2	2	4	0	0	4	0	0
13	40498267	.	A	G	2	2	4	0	1	5	0	0
13	40498294	.	G	A	1	3	4	0	1	5	0	0
13	40715454	.	C	T	0	2	2	0	0	2	0	0
13	40746930	.	C	A	0	3	3	0	4	7	0	0
13	40746971	.	G	T	5	4	9	0	2	11	0	0
13	40747256	.	T	A	9	14	23	0	1	24	0	0
13	40747274	.	T	C	7	1	8	0	11	19	0	0
13	40747337	.	T	A	4	4	8	0	0	8	0	0
13	40747397	.	C	A	6	3	9	0	1	10	0	0
13	40747398	.	C	A	6	3	9	0	1	10	0	0
13	40747467	.	C	T	0	4	4	0	4	8	0	0
13	40747607	.	G	T	2	4	6	0	1	7	0	0
13	40747839	.	T	C	1	3	4	0	0	4	0	0
13	40747841	.	T	C	1	0	1	0	3	4	0	0
13	40748246	.	A	C	7	3	10	0	0	10	0	0
13	40748248	.	C	A	7	3	10	0	0	10	0	0
13	40748310	.	T	G	4	2	6	0	0	6	0	0
13	40748356	.	G	T	7	3	10	0	0	10	0	0
13	40748408	.	C	T	1	5	6	0	1	7	0	0
13	40748431	.	G	A	2	3	5	0	0	5	0	0
13	40748582	.	G	A	2	5	7	0	0	7	0	0
13	40748620	.	C	T	2	4	6	0	0	6	0	0
13	40748621	.	T	A	1	4	5	0	1	6	0	0
13	40748736	.	C	T	7	3	10	0	0	10	0	0
13	40748740	.	G	A	7	3	10	0	0	10	0	0
13	40749138	.	A	C	2	3	5	0	0	5	0	0
13	40749142	.	C	T	2	3	5	0	0	5	0	0
13	40754433	.	A	T	5	2	7	0	1	8	0	0
13	40754441	.	G	T	5	3	8	0	0	8	0	0
13	41125475	.	C	T	9	9	18	0	0	18	0	0
13	41125652	.	C	T	4	3	7	0	2	9	0	0
13	41125766	.	A	G	7	4	11	0	0	11	0	0
13	41214863	.	G	A	1	2	3	0	2	5	0	0
13	41289112	.	C	T	0	2	2	0	4	6	0	0
13	41320070	.	G	C	2	1	3	0	0	3	0	0
13	41910428	.	G	A	5	4	9	0	2	11	0	0
13	41911090	.	G	A	21	12	33	0	2	35	0	0
13	41911092	.	C	A	13	21	34	0	1	35	0	0
13	41911276	.	T	C	6	16	22	0	0	22	0	0
13	41911402	.	T	A	14	9	23	1	0	24	0	0
13	41911597	.	G	T	20	7	27	0	0	27	0	0
13	41911771	.	A	G	10	4	14	0	1	15	0	0
13	41911788	.	C	T	9	3	12	0	2	14	0	0
13	41911932	.	A	G	11	7	18	0	0	18	0	0
13	41915604	.	A	G	9	8	17	0	0	17	0	0
13	41917003	.	C	A	5	2	7	0	1	8	0	0
13	41936597	.	G	A	0	2	2	0	1	3	0	0
13	41936615	.	A	G	1	2	3	0	0	3	0	0
13	41944269	.	T	A	4	4	8	0	0	8	0	0
13	41944446	.	T	G	0	4	4	0	0	4	0	0
13	41944479	.	G	A	4	5	9	0	0	9	0	0
13	41944815	.	C	A	0	6	6	0	9	15	0	0
13	41945455	.	C	T	4	5	9	0	0	9	0	0
13	41945464	.	C	T	0	3	3	0	5	8	0	0
13	41945737	.	A	G	4	4	8	0	1	9	0	0
13	41945762	.	T	A	4	2	6	0	2	8	0	0
13	41947874	.	C	T	2	4	6	0	0	6	0	0
13	41947882	.	C	T	0	5	5	0	2	7	0	0
13	42142194	.	C	A	4	4	8	0	0	8	0	0
13	42142296	.	T	C	8	2	10	0	1	11	0	0
13	42142854	.	G	A	11	9	20	0	0	20	0	0
13	42143118	.	G	A	0	8	8	0	8	16	0	0
13	42143285	.	A	T	10	11	21	0	0	21	0	0
13	42143294	.	T	G	11	10	21	0	0	21	0	0
13	42143572	.	T	A	2	7	9	0	0	9	0	0
13	42143581	.	T	A	1	4	5	0	0	5	0	0
13	42349499	.	C	T	4	3	7	0	0	7	0	0
13	42349683	.	C	T	7	5	12	0	0	12	0	0
13	42361795	.	A	G	9	13	22	0	0	22	0	0
13	42365043	.	A	G	0	1	1	0	0	1	0	0
13	42365121	.	T	C	5	6	11	0	0	11	0	0
13	42365374	.	C	T	3	3	6	0	1	7	0	0
13	42400391	.	T	A	2	2	4	0	0	4	0	0
13	42400473	.	C	T	4	2	6	0	0	6	0	0
13	42481169	.	T	C	9	7	16	0	1	17	0	0
13	42481256	.	A	G	13	14	27	0	1	28	0	0
13	42481267	.	G	A	10	19	29	0	2	31	0	0
13	42481306	.	T	C	10	16	26	0	1	27	0	0
13	42481512	.	A	G	13	14	27	0	2	29	0	0
13	42481538	.	A	G	12	17	29	0	3	32	0	0
13	42481575	.	T	C	10	12	22	0	1	23	0	0
13	42481599	.	A	G	10	3	13	0	1	14	0	0
13	42483050	.	A	G	6	8	14	0	1	15	0	0
13	42483082	.	A	G	3	3	6	0	1	7	0	0
13	42483089	.	T	C	3	3	6	0	0	6	0	0
13	42488440	.	C	T	4	6	10	0	1	11	0	0
13	42490778	.	T	C	2	3	5	0	0	5	0	0
13	42491406	.	G	A	2	2	4	0	0	4	0	0
13	42491448	.	C	T	0	1	1	0	0	1	0	0
13	42500370	.	A	G	1	1	2	0	0	2	0	0
13	42516915	.	C	G	0	2	2	0	1	3	0	0
13	42526376	.	C	T	1	1	2	0	0	2	0	0
13	42604301	.	A	C	1	1	2	0	0	2	0	0
13	42604325	.	C	T	1	1	2	0	0	2	0	0
13	42610900	.	C	T	2	2	4	0	0	4	0	0
13	42611019	.	T	C	2	2	4	0	0	4	0	0
13	42611052	.	C	T	3	2	5	0	0	5	0	0
13	42615004	.	A	T	1	1	2	0	0	2	0	0
13	42615073	.	T	G	1	4	5	0	0	5	0	0
13	42615094	.	G	A	0	3	3	0	0	3	0	0
13	42616301	.	A	C	1	1	2	0	0	2	0	0
13	42621864	.	A	G	3	3	6	0	0	6	0	0
13	42621870	.	A	C	3	2	5	0	0	5	0	0
13	42622006	.	C	T	3	7	10	0	1	11	0	0
13	42622013	.	C	T	2	7	9	0	1	10	0	0
13	42626622	.	C	T	0	1	1	0	0	1	0	0
13	42632966	.	A	G	5	2	7	0	0	7	0	0
13	42681759	.	G	T	12	6	18	0	0	18	0	0
13	42681856	.	T	G	9	9	18	0	0	18	0	0
13	42682033	.	T	A	5	12	17	1	0	18	0	0
13	42691482	.	G	T	0	2	2	0	0	2	0	0
13	42693030	.	G	A	4	5	9	0	2	11	0	0
13	42702835	.	T	C	4	2	6	0	0	6	0	0
13	43223679	.	G	A	17	14	31	0	2	33	0	0
13	43223722	.	T	G	12	10	22	0	0	22	0	0
13	43225093	.	C	T	6	4	10	0	0	10	0	0
13	43226423	.	T	A	9	11	20	0	3	23	0	0
13	43226429	.	C	T	0	10	10	0	10	20	0	0
13	43229872	.	A	C	6	17	23	0	0	23	0	0
13	43229923	.	G	A	6	12	18	0	1	19	0	0
13	43238513	.	C	A	6	6	12	0	1	13	0	0
13	44495671	.	G	A	1	2	3	0	0	3	0	0
13	44702469	.	T	C	6	2	8	0	25	33	0	0
13	44738328	.	G	A	9	4	13	0	0	13	0	0
13	44767765	.	T	C	2	0	2	0	0	2	0	0
13	44772073	.	A	G	5	1	6	0	0	6	0	0
13	44775714	.	G	A	2	2	4	0	0	4	0	0
13	44775895	.	C	T	0	3	3	0	2	5	0	0
13	44779071	.	A	G	2	2	4	0	0	4	0	0
13	44779083	.	A	G	3	2	5	0	0	5	0	0
13	44779107	.	C	T	3	3	6	0	0	6	0	0
13	44788217	.	C	T	7	5	12	0	0	12	0	0
13	44788358	.	G	A	11	4	15	0	1	16	0	0
13	44788361	.	T	A	11	4	15	0	1	16	0	0
13	44788539	.	G	A	16	6	22	0	4	26	0	0
13	44788815	.	C	T	18	10	28	0	0	28	0	0
13	44788827	.	A	C	19	6	25	0	0	25	0	0
13	44808582	.	A	C	2	0	2	0	5	7	0	0
13	44808632	.	A	G	5	7	12	0	0	12	0	0
13	44832437	.	T	A	1	5	6	0	0	6	0	0
13	44841248	.	T	C	3	2	5	0	0	5	0	0
13	44842810	.	G	T	1	4	5	0	2	7	0	0
13	44888282	.	C	T	3	2	5	0	1	6	0	0
13	45010064	.	A	G	8	8	16	0	0	16	0	0
13	45012835	.	A	T	6	8	14	0	3	17	0	0
13	45015355	.	A	T	10	17	27	0	1	28	0	0
13	45015443	.	T	C	20	26	46	0	1	47	0	0
13	45015503	.	T	C	8	13	21	0	3	24	0	0
13	45018600	.	A	G	24	25	49	0	7	56	0	0
13	45018732	.	G	A	9	21	30	0	4	34	0	0
13	45019001	.	A	C	5	1	6	0	19	25	0	0
13	45035991	.	A	G	2	6	8	0	2	10	0	0
13	45432170	.	A	G	2	2	4	0	0	4	0	0
13	45434952	.	T	G	3	6	9	0	1	10	0	0
13	45436554	.	A	G	5	1	6	0	0	6	0	0
13	45436561	.	G	T	4	1	5	0	0	5	0	0
13	45468567	.	A	T	11	47	58	0	1	59	0	0
13	45468827	.	G	C	6	0	6	0	15	21	0	0
13	45470601	.	A	G	40	24	64	0	3	67	0	0
13	45470815	.	A	T	21	27	48	0	1	49	0	0
13	45470926	.	G	C	23	9	32	0	2	34	0	0
13	45470983	.	A	G	5	13	18	0	2	20	0	0
13	45471048	.	A	G	7	11	18	0	2	20	0	0
13	45471243	.	G	A	29	21	50	0	3	53	0	0
13	45471367	.	A	T	20	19	39	0	3	42	0	0
13	45471475	.	C	A	12	14	26	0	2	28	0	0
13	45471669	.	C	T	25	31	56	0	2	58	0	0
13	45471888	.	C	T	0	17	17	0	21	38	0	0
13	45472124	.	T	G	8	8	16	0	1	17	0	0
13	45472215	.	G	C	11	6	17	0	1	18	0	0
13	45472653	.	G	A	8	14	22	0	3	25	0	0
13	45472924	.	G	A	30	40	70	0	5	75	0	0
13	45472954	.	G	A	28	41	69	0	4	73	0	0
13	45476285	.	C	T	1	8	9	0	0	9	0	0
13	45476360	.	A	C	8	8	16	0	0	16	0	0
13	45476711	.	C	T	1	6	7	0	0	7	0	0
13	45476731	.	A	T	2	0	2	0	1	3	0	0
13	45478902	.	C	T	0	1	1	0	0	1	0	0
13	45481475	.	G	A	16	18	34	0	2	36	0	0
13	45481583	.	A	G	22	4	26	0	0	26	0	0
13	45481703	.	G	T	16	9	25	0	3	28	0	0
13	45481792	.	A	G	2	10	12	0	0	12	0	0
13	45494912	.	G	C	16	14	30	0	3	33	0	0
13	45495227	.	C	A	17	18	35	0	2	37	0	0
13	45495442	.	G	T	1	4	5	0	1	6	0	0
13	45524500	.	T	C	3	7	10	0	0	10	0	0
13	45553072	.	G	A	2	2	4	0	0	4	0	0
13	45565508	.	C	T	2	4	6	0	1	7	0	0
13	45565637	.	G	A	4	3	7	0	1	8	0	0
13	45565646	.	G	A	0	5	5	0	3	8	0	0
13	45570300	.	A	C	12	8	20	0	0	20	0	0
13	45774682	.	G	A	1	2	3	0	0	3	0	0
13	45794475	.	C	T	4	3	7	0	0	7	0	0
13	45991772	.	T	C	21	17	38	0	1	39	0	0
13	45991801	.	C	T	14	10	24	0	1	25	0	0
13	45999530	.	G	A	0	10	10	0	17	27	0	0
13	45999723	.	C	T	20	19	39	0	2	41	0	0
13	46000060	.	G	A	0	6	6	0	5	11	0	0
13	46179340	.	C	T	23	27	50	0	4	54	0	0
13	46179387	.	C	T	29	30	59	0	4	63	0	0
13	46179392	.	G	A	29	31	60	0	3	63	0	0
13	46179806	.	T	A	28	28	56	0	3	59	0	0
13	46179814	.	A	G	27	25	52	0	5	57	0	0
13	46298734	.	G	A	8	5	13	0	3	16	0	0
13	46299827	.	A	G	3	4	7	0	0	7	0	0
13	46299873	.	T	A	2	3	5	0	0	5	0	0
13	46299875	.	T	G	2	3	5	0	0	5	0	0
13	46299934	.	G	A	5	3	8	0	0	8	0	0
13	46300224	.	T	A	1	3	4	0	0	4	0	0
13	46300247	.	A	T	1	3	4	0	0	4	0	0
13	46300259	.	T	G	2	4	6	0	0	6	0	0
13	46300421	.	C	T	2	3	5	0	0	5	0	0
13	46300450	.	C	T	1	3	4	0	1	5	0	0
13	46300737	.	G	A	3	5	8	0	1	9	0	0
13	46520924	.	T	C	4	8	12	0	2	14	0	0
13	46521542	.	C	T	0	5	5	0	3	8	0	0
13	46521633	.	G	A	4	8	12	0	0	12	0	0
13	46521664	.	C	A	4	8	12	0	1	13	0	0
13	46521762	.	T	A	5	4	9	0	0	9	0	0
13	46686936	.	T	C	3	2	5	0	2	7	0	0
13	46795515	.	G	A	0	4	4	0	3	7	0	0
13	46831698	.	C	T	0	5	5	0	4	9	0	0
13	46831831	.	A	T	2	7	9	0	1	10	0	0
13	46832084	.	A	G	2	7	9	0	0	9	0	0
13	46832286	.	T	C	10	3	13	0	3	16	0	0
13	46832292	.	G	A	10	4	14	0	2	16	0	0
13	46832449	.	A	T	7	3	10	0	0	10	0	0
13	46832471	.	A	C	7	6	13	0	0	13	0	0
13	46832560	.	A	C	6	6	12	0	0	12	0	0
13	46832724	.	C	A	0	8	8	0	5	13	0	0
13	46833050	.	C	G	1	4	5	0	0	5	0	0
13	46833197	.	A	G	3	4	7	0	0	7	0	0
13	46834550	.	G	A	1	5	6	0	0	6	0	0
13	46834815	.	C	T	2	2	4	0	0	4	0	0
13	46834860	.	T	A	1	3	4	0	0	4	0	0
13	46844205	.	G	A	1	1	2	0	0	2	0	0
13	46935089	.	C	T	0	1	1	0	0	1	0	0
13	46988299	.	C	T	9	12	21	0	1	22	0	0
13	46988390	.	T	C	14	0	14	0	20	34	0	0
13	46988457	.	C	A	0	2	2	0	1	3	0	0
13	46988561	.	A	G	3	6	9	0	0	9	0	0
13	46988588	.	A	G	6	15	21	0	0	21	0	0
13	46988638	.	T	G	3	7	10	0	1	11	0	0
13	46989607	.	C	T	0	6	6	0	7	13	0	0
13	47100347	.	C	T	0	1	1	0	0	1	0	0
13	47146860	.	C	T	2	1	3	0	0	3	0	0
13	47689564	.	A	G	1	2	3	0	0	3	0	0
13	47690269	.	A	T	5	2	7	0	0	7	0	0
13	47690300	.	A	T	4	3	7	0	0	7	0	0
13	47690329	.	T	A	2	2	4	0	0	4	0	0
13	47690383	.	C	G	2	3	5	0	0	5	0	0
13	47691316	.	G	A	1	4	5	0	0	5	0	0
13	47691328	.	T	C	1	4	5	0	1	6	0	0
13	47751554	.	A	C	2	2	4	0	0	4	0	0
13	47751568	.	G	T	2	2	4	0	0	4	0	0
13	47839071	.	C	T	1	6	7	0	1	8	0	0
13	47839119	.	A	T	2	3	5	0	1	6	0	0
13	48748722	.	A	G	1	4	5	0	1	6	0	0
13	48755035	.	A	G	1	3	4	0	0	4	0	0
13	48760119	.	A	G	1	3	4	0	0	4	0	0
13	48760686	.	G	T	0	2	2	0	0	2	0	0
13	49153896	.	T	C	3	1	4	0	0	4	0	0
13	49153904	.	T	C	5	3	8	0	0	8	0	0
13	49153938	.	G	A	8	3	11	0	0	11	0	0
13	49153953	.	A	G	8	3	11	0	0	11	0	0
13	49154048	.	G	A	9	5	14	0	1	15	0	0
13	49154631	.	T	C	8	0	8	0	13	21	0	0
13	49158734	.	G	A	4	0	4	0	0	4	0	0
13	49167185	.	T	G	3	2	5	0	0	5	0	0
13	49167195	.	C	T	3	1	4	0	1	5	0	0
13	49169121	.	G	C	2	1	3	0	1	4	0	0
13	49443721	.	C	T	7	15	22	0	1	23	0	0
13	49443868	.	T	C	17	3	20	0	22	42	0	0
13	49444090	.	C	T	11	15	26	0	0	26	0	0
13	49444177	.	C	A	0	11	11	0	18	29	0	0
13	49444224	.	G	A	12	13	25	0	0	25	0	0
13	49444446	.	C	A	14	11	25	0	1	26	0	0
13	49543145	.	A	T	0	1	1	0	0	1	0	0
13	49544509	.	C	T	0	1	1	0	3	4	0	0
13	49544535	.	G	A	2	0	2	0	0	2	0	0
13	49544560	.	T	A	2	0	2	0	0	2	0	0
13	49544577	.	A	G	2	3	5	0	0	5	0	0
13	49544641	.	T	C	2	6	8	0	0	8	0	0
13	49544833	.	C	T	21	18	39	0	4	43	0	0
13	49544873	.	T	A	15	24	39	0	1	40	0	0
13	49544973	.	G	T	23	12	35	0	2	37	0	0
13	49545039	.	A	G	3	6	9	0	0	9	0	0
13	49585341	.	T	A	15	12	27	0	0	27	0	0
13	49585344	.	A	T	14	12	26	0	0	26	0	0
13	49585384	.	T	G	3	3	6	0	1	7	0	0
13	49597297	.	C	T	0	3	3	0	3	6	0	0
13	49636115	.	G	T	1	1	2	0	0	2	0	0
13	49727548	.	A	G	3	2	5	0	0	5	0	0
13	49727550	.	A	G	3	2	5	0	0	5	0	0
13	49767539	.	A	G	8	10	18	0	1	19	0	0
13	49767570	.	G	A	9	11	20	0	2	22	0	0
13	49767736	.	T	G	3	5	8	0	0	8	0	0
13	49767806	.	T	A	1	9	10	0	1	11	0	0
13	49767807	.	G	T	2	8	10	0	1	11	0	0
13	49767953	.	T	A	2	12	14	0	3	17	0	0
13	49768095	.	A	G	13	8	21	0	1	22	0	0
13	49768207	.	C	T	8	3	11	0	0	11	0	0
13	49768401	.	C	T	11	11	22	0	0	22	0	0
13	49768402	.	A	C	11	11	22	0	0	22	0	0
13	49768592	.	A	T	4	10	14	0	0	14	0	0
13	49768646	.	A	G	6	4	10	0	0	10	0	0
13	49768917	.	T	A	1	2	3	0	2	5	0	0
13	49769060	.	C	T	6	14	20	0	0	20	0	0
13	49769141	.	G	C	5	6	11	0	0	11	0	0
13	49774893	.	G	T	6	10	16	0	0	16	0	0
13	49775018	.	T	G	6	6	12	0	0	12	0	0
13	49775075	.	T	G	5	5	10	0	1	11	0	0
13	49785412	.	C	T	4	8	12	0	1	13	0	0
13	49785417	.	T	C	5	8	13	0	0	13	0	0
13	49785455	.	C	G	1	6	7	0	0	7	0	0
13	49785456	.	A	G	1	6	7	0	0	7	0	0
13	49788102	.	A	T	0	2	2	0	1	3	0	0
13	49818982	.	A	G	3	5	8	0	0	8	0	0
13	49819001	.	C	A	0	7	7	0	5	12	0	0
13	49819019	.	A	G	4	10	14	0	0	14	0	0
13	49917748	.	T	C	0	2	2	0	0	2	0	0
13	50389968	.	G	A	1	0	1	0	0	1	0	0
13	50670802	.	T	G	7	0	7	0	1	8	0	0
13	50715205	.	A	G	0	2	2	0	0	2	0	0
13	51140665	.	A	G	12	5	17	0	1	18	0	0
13	51140782	.	A	G	6	3	9	0	0	9	0	0
13	51145614	.	T	G	6	3	9	0	0	9	0	0
13	51147152	.	G	A	3	2	5	0	0	5	0	0
13	51147164	.	A	G	2	2	4	0	0	4	0	0
13	51503093	.	T	A	2	2	4	0	0	4	0	0
13	51580096	.	G	T	0	7	7	0	2	9	0	0
13	51580105	.	T	C	1	7	8	0	0	8	0	0
13	51582341	.	T	A	2	4	6	0	0	6	0	0
13	51582507	.	T	G	3	2	5	0	0	5	0	0
13	51583019	.	C	A	11	3	14	0	0	14	0	0
13	51583043	.	T	C	11	4	15	0	2	17	0	0
13	51583130	.	A	G	9	0	9	0	9	18	0	0
13	51719661	.	G	C	1	0	1	0	0	1	0	0
13	51719767	.	A	C	5	6	11	0	0	11	0	0
13	51720057	.	T	C	3	3	6	0	1	7	0	0
13	51720126	.	C	A	3	4	7	0	2	9	0	0
13	51720291	.	A	G	4	0	4	0	7	11	0	0
13	51720993	.	G	C	0	5	5	0	5	10	0	0
13	51721143	.	T	C	5	8	13	0	2	15	0	0
13	51728520	.	G	A	7	5	12	0	2	15	1	0
13	51728597	.	A	G	7	0	7	0	12	19	0	0
13	51728782	.	C	G	5	11	16	0	2	18	0	0
13	51728902	.	A	C	13	11	24	0	2	26	0	0
13	51728937	.	A	G	14	8	22	0	0	22	0	0
13	51877993	.	T	C	3	2	5	0	0	5	0	0
13	51893807	.	C	T	17	9	26	0	1	27	0	0
13	51894204	.	C	T	20	12	32	0	3	35	0	0
13	51894215	.	A	G	21	11	32	0	2	34	0	0
13	51898991	.	C	G	0	0	0	0	2	2	0	0
13	51899138	.	C	T	0	16	16	0	17	33	0	0
13	51899707	.	C	T	7	8	15	0	2	17	0	0
13	51903040	.	A	G	2	2	4	0	0	4	0	0
13	51956414	.	T	C	3	1	4	0	0	4	0	0
13	51956418	.	G	A	3	2	5	0	0	5	0	0
13	51956482	.	C	G	1	3	4	0	0	4	0	0
13	51962211	.	C	T	4	7	11	0	5	16	0	0
13	51962407	.	C	T	3	3	6	0	3	9	0	0
13	51962754	.	G	A	0	9	9	0	4	13	0	0
13	51962802	.	G	A	6	6	12	0	2	14	0	0
13	51962836	.	A	G	4	1	5	0	4	12	3	0
13	51962892	.	C	A	12	12	24	0	0	24	0	0
13	51962961	.	C	G	6	10	16	0	1	17	0	0
13	51963039	.	C	T	4	6	10	1	0	11	0	0
13	51963071	.	T	C	6	5	11	0	0	11	0	0
13	51963383	.	C	T	7	5	12	0	3	15	0	0
13	51967129	.	C	T	0	4	4	0	3	7	0	0
13	51967149	.	T	C	3	0	3	0	4	7	0	0
13	51967259	.	G	A	1	2	3	0	0	3	0	0
13	51969086	.	G	C	0	2	2	0	0	2	0	0
13	51969219	.	A	G	3	4	7	0	0	7	0	0
13	51969313	.	C	T	1	1	2	0	1	3	0	0
13	52011666	.	T	C	3	1	4	0	1	5	0	0
13	52108428	.	G	A	2	2	4	0	0	4	0	0
14	548928	.	C	T	1	3	4	0	0	4	0	0
14	567500	.	C	T	1	2	3	0	0	3	0	0
14	606255	.	A	G	2	0	2	0	0	2	0	0
14	616648	.	G	A	1	1	2	0	0	2	0	0
14	684179	.	G	A	15	16	31	0	1	32	0	0
14	699438	.	T	C	2	3	5	0	0	5	0	0
14	718194	.	A	C	2	3	5	0	1	6	0	0
14	719926	.	A	G	1	4	5	0	0	5	0	0
14	723539	.	T	C	1	6	7	0	1	8	0	0
14	723542	.	T	C	1	7	8	0	0	8	0	0
14	758637	.	A	G	1	1	2	0	1	3	0	0
14	791696	.	T	A	3	2	5	0	0	5	0	0
14	791707	.	T	A	2	3	5	0	1	6	0	0
14	791989	.	G	T	3	2	5	0	0	5	0	0
14	792133	.	C	A	4	4	8	0	0	8	0	0
14	792173	.	C	A	6	2	8	0	0	8	0	0
14	792536	.	A	C	1	4	5	0	0	5	0	0
14	863048	.	A	G	2	3	5	0	0	5	0	0
14	863418	.	T	A	4	3	7	0	0	7	0	0
14	863767	.	A	G	3	7	10	0	0	10	0	0
14	863807	.	A	T	9	6	15	0	2	17	0	0
14	863868	.	G	T	10	13	23	0	1	24	0	0
14	863949	.	T	C	13	5	18	0	2	20	0	0
14	868838	.	G	A	2	3	5	0	0	5	0	0
14	868855	.	A	G	2	4	6	0	0	6	0	0
14	912754	.	C	T	1	0	1	0	0	1	0	0
14	912775	.	G	A	1	1	2	0	0	2	0	0
14	928258	.	C	T	1	1	2	0	0	2	0	0
14	928273	.	C	T	1	1	2	0	0	2	0	0
14	937298	.	G	A	1	2	3	0	0	3	0	0
14	937789	.	T	A	0	2	2	0	1	3	0	0
14	937849	.	A	C	2	4	6	0	2	8	0	0
14	997273	.	T	A	2	3	5	0	0	5	0	0
14	997603	.	T	C	3	4	7	0	0	7	0	0
14	997651	.	A	C	1	3	4	0	0	4	0	0
14	997765	.	T	C	7	1	8	0	1	9	0	0
14	997783	.	A	G	5	2	7	0	0	7	0	0
14	997853	.	C	T	3	3	6	0	0	6	0	0
14	1119423	.	A	G	3	1	4	0	1	5	0	0
14	1119432	.	T	C	2	1	3	0	3	6	0	0
14	1119993	.	T	C	1	2	3	0	0	3	0	0
14	1120017	.	T	C	1	2	3	0	0	3	0	0
14	1120072	.	C	A	3	4	7	0	2	9	0	0
14	1120154	.	T	C	3	5	8	0	0	8	0	0
14	1120178	.	C	T	2	4	6	0	0	6	0	0
14	1120364	.	T	A	2	3	5	0	0	5	0	0
14	1120501	.	A	G	2	3	5	0	0	5	0	0
14	1120598	.	T	C	1	3	4	0	0	4	0	0
14	1120639	.	T	C	1	2	3	0	0	3	0	0
14	1121029	.	A	G	1	3	4	0	0	4	0	0
14	1121068	.	C	T	3	3	6	0	0	6	0	0
14	1121297	.	T	G	2	5	7	0	0	7	0	0
14	1121303	.	G	C	3	5	8	0	0	8	0	0
14	1124602	.	C	G	1	4	5	0	0	5	0	0
14	1128800	.	C	G	0	2	2	0	0	2	0	0
14	1139509	.	C	T	2	1	3	0	0	3	0	0
14	1146630	.	G	A	1	1	2	0	0	2	0	0
14	1150594	.	A	G	1	1	2	0	0	2	0	0
14	1152544	.	C	A	3	1	4	0	2	6	0	0
14	1153665	.	T	C	1	1	2	0	0	2	0	0
14	1153830	.	T	A	2	5	7	0	0	7	0	0
14	1159869	.	A	G	9	0	9	0	16	25	0	0
14	1160333	.	C	T	12	8	20	0	3	23	0	0
14	1160427	.	T	G	16	8	24	0	3	27	0	0
14	1171052	.	T	A	2	3	5	0	1	6	0	0
14	1171081	.	T	A	2	2	4	0	0	4	0	0
14	1177865	.	A	G	5	3	8	0	4	12	0	0
14	1192448	.	G	A	3	12	15	0	1	16	0	0
14	1194090	.	C	T	0	1	1	0	3	4	0	0
14	1194133	.	G	A	8	3	11	0	1	12	0	0
14	1194154	.	C	T	0	6	6	0	11	17	0	0
14	1196568	.	C	G	1	0	1	0	0	1	0	0
14	1196658	.	T	G	2	4	6	0	0	6	0	0
14	1200460	.	T	G	1	2	3	0	0	3	0	0
14	1200545	.	G	T	6	4	10	0	1	11	0	0
14	1203713	.	A	G	18	17	35	0	2	37	0	0
14	1203770	.	G	T	7	0	7	0	0	7	0	0
14	1204197	.	A	T	1	0	1	0	0	1	0	0
14	1204299	.	G	A	13	9	22	0	1	23	0	0
14	1952803	.	C	T	0	2	2	0	0	2	0	0
14	2220101	.	C	T	1	1	2	0	1	3	0	0
14	2360116	.	T	A	1	3	4	0	0	4	0	0
14	2384096	.	T	G	8	4	12	1	0	13	0	0
14	3102955	.	C	T	1	3	4	0	0	4	0	0
14	3576058	.	A	T	4	5	9	0	0	9	0	0
14	4158268	.	T	C	5	2	7	0	0	7	0	0
14	4184570	.	G	A	2	3	5	0	0	5	0	0
14	4192875	.	T	C	2	2	4	0	0	4	0	0
14	4291538	.	A	G	3	2	5	0	0	5	0	0
14	4291539	.	A	G	3	2	5	0	0	5	0	0
14	4812929	.	T	C	2	2	4	0	0	4	0	0
14	5588315	.	A	T	1	2	3	0	0	3	0	0
14	6000428	.	A	G	1	2	3	0	0	3	0	0
14	6001098	.	T	C	3	2	5	0	0	5	0	0
14	6333022	.	T	C	4	8	12	0	1	13	0	0
14	6624621	.	A	G	8	20	28	0	1	29	0	0
14	6624625	.	A	G	25	7	32	0	0	32	0	0
14	6625002	.	A	C	6	13	19	4	2	25	0	0
14	6625521	.	G	C	25	32	57	0	2	59	0	0
14	7900627	.	A	T	0	10	10	0	1	11	0	0
14	7900630	.	A	T	0	13	13	0	1	14	0	0
14	7915624	.	A	G	0	6	6	0	0	6	0	0
14	8495666	.	T	A	2	7	9	1	0	10	0	0
14	8569251	.	A	G	4	3	7	0	0	7	0	0
14	8569654	.	A	G	4	2	6	0	0	6	0	0
14	8821677	.	G	A	0	2	2	0	0	2	0	0
14	9002269	.	G	A	10	5	15	0	4	19	0	0
14	9507489	.	T	C	0	2	2	0	2	4	0	0
14	9595330	.	T	C	1	7	8	0	0	8	0	0
14	10338670	.	G	A	5	2	7	0	2	9	0	0
14	10339539	.	T	C	8	22	30	0	1	31	0	0
14	11266531	.	A	T	1	5	6	0	1	7	0	0
14	11976729	.	T	C	8	3	11	0	3	14	0	0
14	11977066	.	C	T	5	2	7	0	0	7	0	0
14	12486275	.	G	T	6	4	10	0	2	12	0	0
14	12605900	.	T	C	2	4	6	0	0	6	0	0
14	14723432	.	T	C	7	3	10	0	0	10	0	0
14	14838402	.	A	G	2	3	5	0	0	5	0	0
14	15663174	.	T	C	7	4	11	0	0	11	0	0
14	15972303	.	G	A	1	4	5	0	0	5	0	0
14	15972419	.	A	G	3	3	6	0	0	10	4	0
14	15972435	.	C	A	5	3	8	0	0	8	0	0
14	15972493	.	T	G	4	6	10	0	1	11	0	0
14	15972526	.	G	T	4	2	6	0	1	7	0	0
14	15972549	.	T	C	6	1	7	0	1	8	0	0
14	15972660	.	C	G	5	4	9	0	0	9	0	0
14	15972666	.	G	A	4	4	8	0	1	9	0	0
14	16044274	.	A	C	6	3	9	0	0	9	0	0
14	16044638	.	G	A	0	4	4	0	7	11	0	0
14	16090764	.	T	C	3	13	16	0	1	17	0	0
14	16090800	.	T	A	2	8	10	0	0	10	0	0
14	16090828	.	A	T	3	7	10	0	1	11	0	0
14	16090897	.	C	T	7	10	17	0	0	17	0	0
14	16090939	.	A	C	8	7	15	0	1	16	0	0
14	16091563	.	C	T	7	9	16	0	6	22	0	0
14	16091586	.	T	A	9	9	18	0	2	20	0	0
14	16091709	.	T	G	10	7	17	0	2	19	0	0
14	16093983	.	G	A	5	2	7	0	2	9	0	0
14	16095683	.	A	G	4	2	6	0	0	6	0	0
14	16115278	.	G	A	7	4	11	0	1	12	0	0
14	16115353	.	A	G	1	0	1	0	0	1	0	0
14	16122866	.	T	C	16	16	32	0	1	33	0	0
14	16122962	.	G	A	20	16	36	0	1	37	0	0
14	16123055	.	G	C	0	22	22	0	17	39	0	0
14	16127308	.	C	T	1	0	1	0	0	1	0	0
14	16132423	.	T	G	4	1	5	0	0	5	0	0
14	16145112	.	T	A	1	2	3	0	0	3	0	0
14	16203904	.	A	T	5	4	9	0	0	9	0	0
14	16208059	.	T	G	2	4	6	0	0	6	0	0
14	16384039	.	T	C	1	2	3	0	0	3	0	0
14	16384157	.	T	C	2	2	4	0	0	4	0	0
14	16384167	.	T	C	1	0	1	0	3	4	0	0
14	16432788	.	C	T	5	4	9	0	0	9	0	0
14	16433098	.	A	T	13	22	35	0	3	38	0	0
14	16433473	.	C	A	0	17	17	0	20	37	0	0
14	16433496	.	A	G	19	16	35	0	3	38	0	0
14	16433623	.	T	G	11	2	13	0	2	15	0	0
14	16433943	.	C	T	0	14	14	0	15	29	0	0
14	16434131	.	G	C	18	13	31	0	3	34	0	0
14	16434179	.	T	C	18	15	33	0	3	36	0	0
14	16434363	.	C	A	12	4	16	0	2	18	0	0
14	16434791	.	A	G	16	14	30	0	2	32	0	0
14	16434981	.	T	C	18	1	19	0	23	42	0	0
14	16434990	.	T	A	17	11	28	0	13	42	1	0
14	16448208	.	A	T	11	7	18	0	1	19	0	0
14	16484069	.	C	T	9	5	14	0	0	14	0	0
14	16484265	.	T	A	15	4	19	0	0	19	0	0
14	16484429	.	C	T	5	4	9	0	0	9	0	0
14	16484558	.	A	T	5	4	9	0	0	9	0	0
14	16484713	.	A	G	4	10	14	0	0	14	0	0
14	16485222	.	C	T	0	12	12	0	4	16	0	0
14	16586602	.	G	A	3	1	4	0	0	4	0	0
14	16606655	.	C	T	0	7	7	0	2	9	0	0
14	16618118	.	G	A	2	7	9	0	0	9	0	0
14	16754192	.	A	C	3	5	8	0	0	8	0	0
14	16754243	.	G	A	1	3	4	0	0	4	0	0
14	16766053	.	C	T	2	2	4	0	0	4	0	0
14	16769067	.	A	G	6	8	14	0	1	15	0	0
14	16769109	.	T	C	6	10	16	0	0	16	0	0
14	16769189	.	C	T	10	8	18	0	1	19	0	0
14	16769246	.	C	T	8	7	15	0	1	16	0	0
14	16769515	.	G	A	8	7	15	0	1	16	0	0
14	16770260	.	C	T	10	6	16	0	1	17	0	0
14	16770338	.	T	A	8	7	15	0	0	15	0	0
14	16770646	.	C	A	10	8	18	0	1	19	0	0
14	16770847	.	C	T	13	13	26	0	0	26	0	0
14	16771265	.	A	T	8	9	17	0	0	17	0	0
14	16771397	.	T	C	1	2	3	0	0	3	0	0
14	16777673	.	T	C	3	0	3	0	6	9	0	0
14	16777677	.	A	C	3	6	9	0	0	9	0	0
14	16777708	.	T	C	2	5	7	0	0	7	0	0
14	16813863	.	G	A	4	3	7	0	0	7	0	0
14	16997008	.	G	A	1	1	2	0	0	2	0	0
14	17003570	.	G	A	0	1	1	0	0	1	0	0
14	17025080	.	A	G	2	0	2	0	5	7	0	0
14	17025109	.	A	T	7	7	14	0	0	14	0	0
14	17025151	.	T	A	6	9	15	0	0	15	0	0
14	17025200	.	G	A	2	7	9	0	2	11	0	0
14	17025215	.	T	C	1	5	6	0	0	6	0	0
14	17025574	.	A	G	3	8	11	0	2	13	0	0
14	17025579	.	A	G	4	5	9	0	2	11	0	0
14	17025751	.	T	A	2	2	4	0	0	4	0	0
14	17025752	.	T	C	2	2	4	0	0	4	0	0
14	17025807	.	T	C	1	4	5	0	1	6	0	0
14	17025819	.	C	T	2	3	5	0	1	6	0	0
14	17025849	.	A	G	7	3	10	0	1	11	0	0
14	17026100	.	T	A	7	4	11	0	1	12	0	0
14	17026488	.	G	A	6	6	12	0	0	12	0	0
14	17026572	.	T	G	8	13	21	0	2	23	0	0
14	17026724	.	T	C	9	18	27	0	4	31	0	0
14	17026840	.	T	C	6	5	11	0	0	11	0	0
14	17026881	.	G	T	4	7	11	0	1	12	0	0
14	17027207	.	G	A	5	13	18	0	0	18	0	0
14	17197240	.	A	C	0	1	1	0	0	1	0	0
14	17199990	.	A	G	14	21	35	0	0	35	0	0
14	17200407	.	C	A	5	6	11	0	0	11	0	0
14	17200653	.	A	C	15	17	32	0	1	33	0	0
14	17230601	.	A	G	6	6	12	0	0	12	0	0
14	17233598	.	C	A	9	13	22	0	0	22	0	0
14	17239275	.	C	T	0	0	0	0	1	1	0	0
14	17240587	.	A	G	1	3	4	0	0	4	0	0
14	17266010	.	C	T	0	10	10	0	7	17	0	0
14	17275648	.	G	A	2	3	5	0	0	5	0	0
14	17275708	.	C	G	3	1	4	0	1	5	0	0
14	17278972	.	C	T	3	7	10	0	1	11	0	0
14	17279005	.	T	C	2	1	3	0	0	3	0	0
14	17279197	.	G	A	1	3	4	0	0	4	0	0
14	17279212	.	C	T	2	7	9	0	0	9	0	0
14	17279305	.	T	C	2	2	4	0	1	5	0	0
14	17281761	.	A	G	7	4	11	0	0	11	0	0
14	17282095	.	C	G	4	2	6	0	0	6	0	0
14	17282100	.	C	T	0	2	2	0	4	6	0	0
14	17282139	.	C	T	2	2	4	0	1	5	0	0
14	17349409	.	C	T	3	2	5	0	0	5	0	0
14	17443283	.	C	T	2	2	4	0	0	4	0	0
14	17443377	.	C	T	1	3	4	0	1	5	0	0
14	17567968	.	T	A	3	5	8	0	1	9	0	0
14	17568099	.	A	G	10	11	21	0	0	21	0	0
14	17572743	.	T	C	1	3	4	0	0	4	0	0
14	17575607	.	G	T	3	5	8	0	0	8	0	0
14	17580685	.	G	A	18	16	34	0	1	35	0	0
14	17580922	.	C	A	25	26	51	0	3	54	0	0
14	17581084	.	A	T	23	28	51	0	3	54	0	0
14	17581214	.	A	T	36	11	47	0	1	48	0	0
14	17586693	.	G	A	2	2	4	0	0	4	0	0
14	17588131	.	G	T	10	17	27	0	2	29	0	0
14	17593429	.	T	C	6	7	13	0	2	15	0	0
14	17593444	.	G	T	6	8	14	0	1	15	0	0
14	17593490	.	A	G	5	7	12	0	1	13	0	0
14	17593720	.	C	T	6	9	15	0	2	17	0	0
14	17593767	.	A	T	10	13	23	0	1	24	0	0
14	17593783	.	T	A	12	14	26	0	1	27	0	0
14	17593823	.	A	T	18	14	32	0	1	33	0	0
14	17593992	.	T	A	5	3	8	0	1	9	0	0
14	17594527	.	A	G	2	8	10	0	0	10	0	0
14	17594734	.	A	T	3	5	8	0	0	8	0	0
14	17595460	.	T	A	0	5	5	0	1	6	0	0
14	17595539	.	T	C	4	5	9	0	0	9	0	0
14	17596002	.	T	A	1	2	3	0	0	3	0	0
14	18667852	.	T	C	16	12	28	0	3	31	0	0
14	18669481	.	C	A	15	14	29	0	1	30	0	0
14	18670446	.	C	T	6	2	8	0	0	8	0	0
14	18670582	.	T	A	3	4	7	0	1	8	0	0
14	18671011	.	A	T	4	4	8	0	0	8	0	0
14	20189789	.	G	T	3	3	6	0	1	7	0	0
14	20190945	.	A	C	1	4	5	0	5	10	0	0
14	21750970	.	C	T	4	4	8	0	2	10	0	0
14	21761334	.	T	C	0	2	2	0	0	2	0	0
14	21772385	.	T	C	5	5	10	0	0	10	0	0
14	21772412	.	C	T	4	5	9	0	0	9	0	0
14	21772459	.	T	C	6	3	9	0	0	9	0	0
14	21772466	.	T	C	5	2	7	0	1	8	0	0
14	21772553	.	C	T	6	7	13	0	0	13	0	0
14	21772594	.	A	G	3	3	6	0	0	6	0	0
14	21772663	.	G	C	3	2	5	0	1	6	0	0
14	21779102	.	C	T	6	2	8	0	0	8	0	0
14	21779241	.	G	A	9	3	12	0	1	13	0	0
14	21779300	.	T	G	8	5	13	0	1	14	0	0
14	21779518	.	C	T	9	5	14	0	0	14	0	0
14	21779551	.	A	G	9	2	11	0	0	11	0	0
14	21779582	.	T	C	3	1	4	0	2	6	0	0
14	21779617	.	T	C	4	4	8	0	0	8	0	0
14	21779633	.	T	C	2	4	6	0	1	7	0	0
14	21779977	.	G	A	8	3	11	0	0	11	0	0
14	21780125	.	A	G	9	5	14	0	0	14	0	0
14	21780206	.	A	G	14	9	23	0	0	23	0	0
14	21780274	.	A	C	9	9	18	0	2	20	0	0
14	21780321	.	T	C	7	8	15	0	1	16	0	0
14	21780501	.	G	A	1	2	3	0	0	3	0	0
14	21783361	.	T	G	1	2	3	0	1	4	0	0
14	21816373	.	C	T	18	12	30	0	1	31	0	0
14	21816388	.	T	C	19	10	29	0	1	30	0	0
14	21816467	.	G	A	13	7	20	0	3	23	0	0
14	21834912	.	C	T	1	2	3	0	0	3	0	0
14	21837304	.	T	C	3	0	3	0	0	3	0	0
14	21842735	.	A	C	12	10	22	0	1	23	0	0
14	21844187	.	T	A	7	11	18	0	2	20	0	0
14	21844486	.	C	T	6	2	8	0	0	8	0	0
14	21844668	.	A	C	8	7	15	0	0	15	0	0
14	21844679	.	T	A	7	5	12	0	1	13	0	0
14	21845129	.	T	A	16	18	34	0	0	34	0	0
14	21845363	.	A	G	14	1	15	0	18	33	0	0
14	21845822	.	A	C	14	6	20	0	3	24	1	0
14	21924299	.	A	G	2	3	5	0	0	5	0	0
14	21980762	.	G	A	2	3	5	0	0	5	0	0
14	21980769	.	C	T	0	3	3	0	2	5	0	0
14	21980871	.	C	A	1	3	4	0	0	4	0	0
14	21999213	.	A	G	2	4	6	0	0	6	0	0
14	22102371	.	A	G	12	10	22	0	1	23	0	0
14	22102381	.	A	G	12	13	25	0	1	26	0	0
14	22104906	.	T	C	2	4	6	0	0	6	0	0
14	22108215	.	C	T	3	11	14	0	1	15	0	0
14	22108368	.	A	T	3	2	5	0	1	6	0	0
14	22108373	.	G	A	3	3	6	0	0	6	0	0
14	22132473	.	T	C	14	16	30	0	2	32	0	0
14	22132536	.	A	T	3	7	10	0	0	10	0	0
14	22139254	.	G	A	22	31	53	0	4	57	0	0
14	22139358	.	G	A	22	23	45	0	5	50	0	0
14	22139398	.	T	A	30	23	53	0	1	54	0	0
14	22139668	.	G	A	1	28	29	0	24	53	0	0
14	22140150	.	G	A	2	2	4	0	0	4	0	0
14	22140417	.	T	C	9	10	19	0	2	21	0	0
14	22151875	.	G	A	10	8	18	0	0	18	0	0
14	22151879	.	C	T	0	8	8	0	11	19	0	0
14	22151913	.	C	T	12	10	22	0	3	25	0	0
14	22172138	.	C	T	4	8	12	0	2	14	0	0
14	22249344	.	G	A	1	11	12	0	1	13	0	0
14	22254184	.	T	C	8	9	17	0	3	20	0	0
14	22272340	.	G	A	22	15	37	0	4	41	0	0
14	22272351	.	G	A	22	17	39	0	0	39	0	0
14	22272749	.	A	G	17	1	18	0	21	39	0	0
14	22441210	.	A	T	2	2	4	0	0	4	0	0
14	23405034	.	G	A	2	4	6	0	1	7	0	0
14	23455989	.	G	A	2	9	11	0	0	11	0	0
14	23463681	.	G	A	0	1	1	0	0	1	0	0
14	23463708	.	A	G	1	2	3	0	0	3	0	0
14	23463717	.	A	G	1	0	1	0	2	3	0	0
14	23463760	.	C	A	1	1	2	0	0	2	0	0
14	23615480	.	G	A	2	2	4	0	0	4	0	0
14	23621903	.	C	T	1	2	3	0	0	3	0	0
14	23622190	.	C	T	2	2	4	0	0	4	0	0
14	23663911	.	G	C	3	4	7	0	0	7	0	0
14	23664063	.	T	G	1	0	1	0	0	1	0	0
14	23666002	.	C	T	3	7	10	0	0	10	0	0
14	23666227	.	G	A	0	14	14	0	11	25	0	0
14	23666326	.	C	T	8	10	18	0	1	19	0	0
14	23666491	.	G	A	0	2	2	0	2	4	0	0
14	23673373	.	G	A	0	2	2	0	2	4	0	0
14	23673499	.	A	G	9	8	17	0	1	18	0	0
14	23673514	.	G	A	9	5	14	0	1	15	0	0
14	23679369	.	T	C	2	0	2	0	11	13	0	0
14	23679375	.	T	A	4	10	14	0	0	14	0	0
14	23679411	.	C	A	6	5	11	0	0	11	0	0
14	23679564	.	T	C	4	3	7	0	0	7	0	0
14	23679671	.	G	A	1	2	3	0	0	3	0	0
14	23679674	.	T	G	1	2	3	0	0	3	0	0
14	23679842	.	A	G	1	2	3	0	0	3	0	0
14	23679843	.	A	T	1	2	3	0	0	3	0	0
14	23680031	.	C	T	1	2	3	0	0	3	0	0
14	23680344	.	T	C	4	3	7	0	1	8	0	0
14	23687872	.	G	C	2	4	6	0	0	6	0	0
14	23693720	.	G	T	1	2	3	0	0	3	0	0
14	23696893	.	A	T	1	2	3	0	0	3	0	0
14	23700121	.	T	C	18	13	31	0	1	32	0	0
14	23700142	.	G	T	13	11	24	0	1	25	0	0
14	23702323	.	G	A	0	6	6	0	6	12	0	0
14	23702703	.	G	A	2	1	3	0	1	4	0	0
14	23704771	.	G	C	0	11	11	0	5	16	0	0
14	23707976	.	A	G	13	11	24	0	2	26	0	0
14	23717277	.	A	T	8	14	22	0	2	24	0	0
14	23717289	.	A	T	9	15	24	0	1	25	0	0
14	23720196	.	A	T	6	4	10	0	0	10	0	0
14	23722030	.	C	T	2	4	6	0	3	9	0	0
14	23726393	.	C	A	30	22	52	0	8	60	0	0
14	23726413	.	G	A	33	27	60	0	4	64	0	0
14	23726547	.	C	T	24	16	40	0	10	50	0	0
14	23732167	.	C	A	4	8	12	0	1	13	0	0
14	23732368	.	C	A	0	8	8	0	9	17	0	0
14	23732396	.	A	G	9	9	18	0	1	19	0	0
14	23732444	.	G	T	8	13	21	0	3	24	0	0
14	23732497	.	C	A	9	15	24	0	1	25	0	0
14	23732508	.	C	T	9	10	19	0	1	20	0	0
14	23732547	.	T	A	4	7	11	0	1	12	0	0
14	23732718	.	A	G	3	3	6	0	1	7	0	0
14	23732745	.	C	G	3	5	8	0	0	8	0	0
14	23732824	.	T	A	1	4	5	0	0	5	0	0
14	23733097	.	A	G	1	7	8	0	0	8	0	0
14	23733220	.	G	A	4	9	13	0	0	13	0	0
14	23737655	.	G	A	1	2	3	0	1	4	0	0
14	23747360	.	T	A	24	12	36	0	2	38	0	0
14	23748654	.	A	G	13	14	27	0	3	30	0	0
14	23752335	.	C	T	4	1	5	0	1	6	0	0
14	23756410	.	G	A	2	2	4	0	0	4	0	0
14	23756637	.	A	G	1	3	4	0	1	5	0	0
14	23756680	.	A	G	3	6	9	0	1	10	0	0
14	23756716	.	T	A	3	7	10	0	2	12	0	0
14	23756752	.	T	G	5	9	14	0	2	16	0	0
14	23756809	.	G	T	5	9	14	0	1	15	0	0
14	23801145	.	C	A	0	3	3	0	2	5	0	0
14	23801159	.	C	A	0	2	2	0	3	5	0	0
14	23801249	.	G	A	1	3	4	0	0	4	0	0
14	23812581	.	C	T	2	1	3	0	0	3	0	0
14	23967226	.	C	T	1	2	3	0	0	3	0	0
14	23967248	.	G	A	1	1	2	0	1	3	0	0
14	23968517	.	G	C	3	2	5	0	1	6	0	0
14	23968564	.	T	A	1	4	5	0	0	5	0	0
14	23968720	.	G	A	7	6	13	0	0	13	0	0
14	23969152	.	G	A	3	6	9	0	0	9	0	0
14	23969154	.	T	C	3	4	7	0	2	9	0	0
14	23969443	.	G	C	2	3	5	1	0	6	0	0
14	23969796	.	T	C	5	8	13	0	0	13	0	0
14	23972351	.	C	T	0	2	2	0	0	2	0	0
14	23972572	.	G	A	1	2	3	0	0	3	0	0
14	23972587	.	C	T	0	1	1	0	0	1	0	0
14	23982623	.	A	T	7	2	9	0	1	10	0	0
14	23991507	.	C	T	3	5	8	0	1	9	0	0
14	23993952	.	A	G	12	13	25	0	1	26	0	0
14	23998961	.	C	A	18	16	34	0	1	35	0	0
14	23999021	.	C	T	18	19	37	0	1	38	0	0
14	23999112	.	A	G	23	21	44	0	1	45	0	0
14	23999315	.	A	G	16	14	30	0	1	31	0	0
14	23999459	.	A	C	12	11	23	0	0	24	1	0
14	24097686	.	A	G	9	10	19	0	1	20	0	0
14	24097734	.	G	A	18	9	27	0	0	27	0	0
14	24098470	.	C	G	6	4	10	0	0	10	0	0
14	24098648	.	G	A	10	10	20	0	1	21	0	0
14	24098694	.	G	T	17	13	30	0	1	31	0	0
14	24099059	.	A	T	7	8	15	0	0	15	0	0
14	24109706	.	T	G	4	2	6	0	0	6	0	0
14	24220467	.	A	G	9	0	9	0	26	35	0	0
14	24220959	.	A	T	18	5	23	0	2	25	0	0
14	24221053	.	G	A	9	11	20	0	2	22	0	0
14	24221194	.	T	A	10	19	29	0	1	30	0	0
14	24243669	.	T	C	6	5	11	0	0	11	0	0
14	24243925	.	G	A	3	2	5	0	0	5	0	0
14	24248398	.	C	A	1	3	4	0	1	5	0	0
14	24268332	.	A	C	4	0	4	0	8	12	0	0
14	24268403	.	G	A	3	5	8	0	0	8	0	0
14	24268676	.	A	T	5	7	12	0	3	15	0	0
14	24268781	.	G	A	7	14	21	0	0	21	0	0
14	24274575	.	C	T	1	1	2	0	0	2	0	0
14	24278144	.	C	G	21	14	35	0	3	38	0	0
14	24278162	.	C	G	20	10	30	0	5	35	0	0
14	24278234	.	A	G	20	11	31	0	1	32	0	0
14	24278831	.	T	C	19	16	35	0	2	37	0	0
14	24279011	.	A	C	13	15	28	0	3	31	0	0
14	24279305	.	A	T	9	3	12	0	0	12	0	0
14	24279326	.	A	C	7	8	15	0	2	17	0	0
14	24279383	.	T	A	11	11	22	0	1	23	0	0
14	24279429	.	T	C	18	12	30	0	0	30	0	0
14	24279459	.	C	G	19	16	35	0	2	37	0	0
14	24279682	.	T	C	15	13	28	0	0	28	0	0
14	24280452	.	T	C	13	8	21	0	1	22	0	0
14	24280517	.	A	C	10	21	31	0	1	32	0	0
14	24280904	.	T	G	15	17	32	0	1	33	0	0
14	24280975	.	A	G	11	19	30	0	1	31	0	0
14	24281118	.	T	A	13	23	36	0	1	37	0	0
14	24281149	.	A	C	5	8	13	0	2	15	0	0
14	24283536	.	C	T	7	4	11	0	0	11	0	0
14	24283609	.	G	A	16	20	36	0	0	36	0	0
14	24301750	.	G	T	7	2	9	0	2	11	0	0
14	24301779	.	T	G	4	4	8	0	3	11	0	0
14	24301946	.	C	A	5	4	9	0	1	10	0	0
14	24302052	.	T	C	2	4	6	0	0	6	0	0
14	24302236	.	A	C	2	2	4	0	1	5	0	0
14	24302310	.	A	C	2	2	4	0	0	4	0	0
14	24302363	.	T	A	0	3	3	0	1	4	0	0
14	24302428	.	T	C	2	2	4	0	0	4	0	0
14	24302439	.	G	A	2	1	3	0	0	3	0	0
14	24302560	.	G	A	4	5	9	0	0	9	0	0
14	24303104	.	G	C	3	5	8	0	0	8	0	0
14	24303205	.	T	A	5	1	6	0	0	6	0	0
14	24303217	.	G	A	4	1	5	0	0	5	0	0
14	24303465	.	G	T	0	9	9	0	5	14	0	0
14	24303504	.	C	T	9	11	20	0	0	20	0	0
14	24303523	.	G	T	9	13	22	0	1	23	0	0
14	24303660	.	T	C	6	4	10	0	1	11	0	0
14	24303665	.	C	A	6	5	11	0	0	11	0	0
14	24304271	.	T	A	9	12	21	0	0	21	0	0
14	24304276	.	G	A	8	14	22	0	1	23	0	0
14	24304309	.	G	A	10	10	20	0	0	20	0	0
14	24304480	.	A	C	11	3	14	0	0	14	0	0
14	24304518	.	T	C	8	6	14	0	0	14	0	0
14	24304591	.	T	A	16	8	24	0	1	25	0	0
14	24304823	.	A	G	8	3	11	0	0	11	0	0
14	24317226	.	G	A	23	28	51	0	3	54	0	0
14	24317266	.	A	T	24	30	54	0	3	57	0	0
14	24317272	.	G	A	25	30	55	0	3	58	0	0
14	24317316	.	C	T	27	36	63	0	3	66	0	0
14	24317508	.	T	C	35	20	55	0	5	60	0	0
14	24317576	.	A	G	27	30	57	0	1	58	0	0
14	24317751	.	C	A	0	20	20	0	20	40	0	0
14	24318041	.	A	T	19	21	40	0	2	42	0	0
14	24318087	.	A	T	22	21	43	0	3	46	0	0
14	24318479	.	A	T	17	26	43	0	1	44	0	0
14	24318685	.	G	A	15	11	26	0	0	26	0	0
14	24318723	.	T	C	12	20	32	0	1	33	0	0
14	24318726	.	T	C	13	1	14	0	18	32	0	0
14	24318868	.	T	C	21	18	39	0	0	39	0	0
14	24325537	.	T	C	3	6	9	0	1	10	0	0
14	24326937	.	G	A	2	2	4	0	0	4	0	0
14	24327917	.	G	A	7	4	11	0	0	11	0	0
14	24328142	.	T	C	5	6	11	0	1	12	0	0
14	24332817	.	A	T	7	6	13	0	0	13	0	0
14	24333761	.	A	G	1	7	8	0	0	8	0	0
14	24369557	.	G	A	4	5	9	0	0	9	0	0
14	24391361	.	A	G	7	9	16	0	0	16	0	0
14	24406609	.	C	G	0	4	4	0	3	7	0	0
14	24409293	.	C	A	1	2	3	0	4	7	0	0
14	24410373	.	G	A	0	1	1	0	1	2	0	0
14	24410450	.	A	C	8	6	14	0	1	15	0	0
14	24410556	.	T	C	11	9	20	0	0	20	0	0
14	24492051	.	G	C	9	3	12	0	0	12	0	0
14	24492154	.	C	T	4	6	10	0	0	10	0	0
14	24492225	.	G	A	1	3	4	0	1	5	0	0
14	24492226	.	C	A	0	4	4	0	1	5	0	0
14	24497739	.	T	C	3	1	4	0	1	5	0	0
14	24852639	.	T	C	2	2	4	0	0	4	0	0
14	24985474	.	T	C	4	3	7	0	0	7	0	0
14	24985478	.	C	T	4	3	7	0	0	7	0	0
14	24990428	.	G	T	1	1	2	0	2	4	0	0
14	24997535	.	C	T	5	6	11	0	1	12	0	0
14	24997954	.	C	A	4	5	9	0	0	9	0	0
14	24998093	.	T	C	16	6	22	0	0	22	0	0
14	24998121	.	C	T	9	5	14	0	1	15	0	0
14	24998203	.	C	T	3	13	16	0	1	17	0	0
14	24998359	.	C	A	5	7	12	0	0	12	0	0
14	24998459	.	C	A	9	6	15	0	0	15	0	0
14	24998765	.	A	T	5	11	16	0	5	21	0	0
14	24998930	.	C	G	7	7	14	0	2	16	0	0
14	25000109	.	A	G	1	11	12	0	1	13	0	0
14	25000492	.	A	T	10	13	23	0	2	25	0	0
14	25000621	.	A	G	13	17	30	0	1	31	0	0
14	25040313	.	G	A	0	1	1	0	0	1	0	0
14	25063607	.	G	T	2	2	4	0	0	4	0	0
14	25063617	.	A	G	1	2	3	0	1	4	0	0
14	25067463	.	G	T	5	5	10	0	0	10	0	0
14	25067905	.	C	T	16	11	27	0	3	30	0	0
14	25076629	.	A	G	4	2	6	0	0	6	0	0
14	25077642	.	G	A	4	5	9	0	1	10	0	0
14	25078505	.	A	T	3	3	6	0	1	7	0	0
14	25080687	.	C	G	20	16	36	0	1	37	0	0
14	25537231	.	T	C	21	6	27	0	1	28	0	0
14	25538269	.	T	C	3	6	9	0	0	9	0	0
14	26404641	.	T	G	0	2	2	0	0	2	0	0
14	26405323	.	G	A	3	2	5	0	0	5	0	0
14	26718332	.	T	A	0	4	4	0	0	4	0	0
14	30731889	.	G	A	4	2	6	0	0	6	0	0
14	30801552	.	C	A	1	5	6	0	0	6	0	0
14	30876670	.	A	T	0	8	8	0	1	9	0	0
14	30879107	.	T	A	3	2	5	0	2	7	0	0
14	31477482	.	A	G	1	8	9	0	0	9	0	0
14	31643781	.	A	G	3	5	8	0	0	8	0	0
14	31643849	.	A	G	4	3	7	0	0	7	0	0
14	31646793	.	C	T	2	1	3	0	1	4	0	0
14	31647217	.	A	G	6	12	18	0	3	21	0	0
14	31681840	.	T	G	2	0	2	0	4	6	0	0
14	33414015	.	G	T	0	1	1	0	0	1	0	0
14	33826997	.	T	C	4	4	8	0	0	8	0	0
14	33827381	.	T	C	2	4	6	0	1	7	0	0
14	33827434	.	T	C	2	3	5	0	0	5	0	0
14	33901591	.	T	C	1	3	4	0	1	5	0	0
14	34090422	.	A	G	4	2	6	0	0	6	0	0
14	34125983	.	T	A	0	3	3	0	2	5	0	0
14	34126061	.	T	A	10	3	13	0	2	15	0	0
14	34488338	.	C	T	8	3	11	0	0	11	0	0
14	36268424	.	T	C	0	3	3	0	2	5	0	0
14	36268426	.	T	C	0	5	5	0	0	5	0	0
14	36720985	.	A	G	5	5	10	0	2	12	0	0
14	38663969	.	A	C	3	2	5	0	0	5	0	0
14	38663972	.	C	T	2	2	4	0	0	4	0	0
14	38668543	.	G	C	0	3	3	0	0	3	0	0
14	38668546	.	T	C	0	3	3	0	0	3	0	0
14	38668782	.	C	A	0	2	2	0	0	2	0	0
14	38668863	.	T	C	1	2	3	0	0	3	0	0
14	38669487	.	A	G	1	1	2	0	0	2	0	0
14	38669562	.	G	T	0	2	2	0	1	3	0	0
14	38672310	.	A	G	1	0	1	0	7	8	0	0
14	38672521	.	G	T	5	3	8	0	0	8	0	0
14	38678070	.	C	T	1	1	2	0	0	2	0	0
14	38688730	.	G	A	5	5	10	0	0	10	0	0
14	38688829	.	G	C	2	7	9	0	1	10	0	0
14	38689174	.	G	A	1	5	6	0	1	7	0	0
14	38689332	.	A	G	3	9	12	0	0	12	0	0
14	38689409	.	A	C	2	3	5	0	1	6	0	0
14	38689428	.	G	C	2	3	5	0	0	5	0	0
14	38763334	.	A	C	18	12	30	0	2	32	0	0
14	38763381	.	G	A	11	19	30	0	4	34	0	0
14	38763394	.	G	A	19	17	36	0	4	40	0	0
14	38783272	.	T	C	1	8	9	0	0	9	0	0
14	38796156	.	C	G	1	1	2	0	0	2	0	0
14	38802884	.	C	T	2	3	5	0	1	6	0	0
14	38802904	.	A	T	2	5	7	0	0	7	0	0
14	38802967	.	T	G	1	2	3	0	0	3	0	0
14	38803088	.	C	T	0	2	2	0	2	4	0	0
14	38809512	.	C	T	0	2	2	0	0	2	0	0
14	38845762	.	T	C	12	9	21	0	3	24	0	0
14	38845912	.	A	G	27	20	47	0	3	50	0	0
14	38846587	.	A	T	43	19	62	0	3	65	0	0
14	38847235	.	A	G	22	10	32	0	1	33	0	0
14	38849729	.	C	T	16	21	37	0	1	38	0	0
14	38849946	.	A	C	16	24	40	0	7	47	0	0
14	38853381	.	C	G	10	4	14	0	0	14	0	0
14	38853397	.	A	G	5	10	15	0	1	16	0	0
14	38862589	.	A	G	1	3	4	0	0	4	0	0
14	38862598	.	A	G	2	3	5	0	0	5	0	0
14	38869753	.	G	A	1	3	4	0	0	4	0	0
14	38872541	.	A	G	2	2	4	0	0	4	0	0
14	38875444	.	C	T	0	2	2	0	1	3	0	0
14	38878552	.	T	C	10	6	16	0	0	16	0	0
14	38881363	.	G	A	0	3	3	0	4	7	0	0
14	38882982	.	T	C	2	2	4	0	0	4	0	0
14	38937099	.	T	C	1	2	3	0	1	4	0	0
14	38941498	.	A	G	1	3	4	0	0	4	0	0
14	39002205	.	A	T	2	2	4	0	0	4	0	0
14	39002433	.	G	C	5	6	11	0	2	13	0	0
14	39002555	.	C	T	3	6	9	0	1	10	0	0
14	39002562	.	C	T	2	8	10	0	1	11	0	0
14	39002698	.	C	A	7	5	12	0	0	12	0	0
14	39002739	.	G	C	13	1	14	0	6	20	0	0
14	39002752	.	A	G	13	6	19	0	1	20	0	0
14	39002820	.	A	T	9	4	13	0	2	15	0	0
14	39002883	.	A	G	6	5	11	0	1	12	0	0
14	40852670	.	A	T	4	5	9	0	0	9	0	0
14	40852732	.	T	C	5	8	13	0	0	13	0	0
14	40853268	.	C	G	1	0	1	0	0	1	0	0
14	40857654	.	T	G	1	1	2	0	0	2	0	0
14	40857711	.	G	A	1	1	2	0	0	2	0	0
14	40857881	.	T	C	2	1	3	0	0	3	0	0
14	40857977	.	C	T	0	4	4	0	0	4	0	0
14	40860291	.	T	A	4	4	8	0	1	9	0	0
14	40860354	.	C	T	6	10	16	0	6	22	0	0
14	40863062	.	A	G	12	14	26	0	5	31	0	0
14	40863161	.	T	C	8	6	14	0	1	15	0	0
14	40863176	.	A	G	3	4	7	0	0	7	0	0
14	40869331	.	C	A	9	10	19	0	0	19	0	0
14	40869895	.	T	C	0	0	0	0	1	1	0	0
14	40874026	.	G	T	7	6	13	0	0	13	0	0
14	41276516	.	T	A	6	10	16	0	5	21	0	0
14	41276608	.	G	A	5	6	11	0	0	11	0	0
14	41277391	.	A	T	7	5	12	0	3	15	0	0
14	41277424	.	C	A	4	12	16	0	1	17	0	0
14	41277556	.	A	G	17	25	42	0	5	48	1	0
14	41277624	.	A	T	26	26	52	0	0	52	0	0
14	41278238	.	T	A	18	14	32	0	1	33	0	0
14	41278255	.	A	G	15	15	30	0	0	30	0	0
14	41278658	.	T	G	10	8	18	0	0	18	0	0
14	41278754	.	C	G	2	3	5	0	1	6	0	0
14	41279133	.	C	T	9	13	22	1	1	24	0	0
14	41279214	.	C	T	20	15	35	0	1	36	0	0
14	41279277	.	G	C	16	17	33	0	3	36	0	0
14	41279527	.	C	T	0	9	9	0	3	12	0	0
14	41279542	.	C	A	0	5	5	0	14	19	0	0
14	41279624	.	G	A	20	9	29	0	0	29	0	0
14	41279974	.	T	G	10	10	20	0	0	20	0	0
14	41279977	.	G	T	10	10	20	0	1	21	0	0
14	41280013	.	G	A	10	13	23	0	1	24	0	0
14	41280149	.	G	A	15	25	40	0	0	40	0	0
14	41280228	.	A	G	16	11	27	0	3	30	0	0
14	41280517	.	G	C	1	2	3	0	1	4	0	0
14	41339309	.	T	C	2	2	4	0	1	5	0	0
14	41339820	.	G	C	5	2	7	0	1	8	0	0
14	41340042	.	A	C	3	2	5	0	0	5	0	0
14	41340054	.	T	A	3	3	6	0	0	6	0	0
14	41340081	.	A	T	4	3	7	0	1	8	0	0
14	41340172	.	A	C	3	4	7	0	0	7	0	0
14	41340231	.	G	A	4	3	7	0	0	7	0	0
14	41340284	.	C	T	0	4	4	0	0	4	0	0
14	41340681	.	T	A	2	3	5	0	0	5	0	0
14	41361985	.	C	T	1	7	8	0	10	18	0	0
14	41362007	.	G	A	3	10	13	0	2	15	0	0
14	41362060	.	C	T	17	5	22	0	1	23	0	0
14	41366823	.	G	A	12	13	25	0	1	26	0	0
14	41366889	.	C	A	0	1	1	0	0	1	0	0
14	41385823	.	G	A	2	6	8	0	0	8	0	0
14	41385895	.	C	T	0	5	5	0	8	13	0	0
14	41388120	.	G	A	4	4	8	0	1	9	0	0
14	41388136	.	C	T	1	2	3	0	0	3	0	0
14	41428500	.	C	T	4	9	13	0	0	13	0	0
14	41435662	.	C	T	5	2	7	0	0	7	0	0
14	41436773	.	T	A	5	5	10	0	0	10	0	0
14	41436943	.	C	T	5	6	11	0	1	12	0	0
14	41438005	.	G	A	9	5	14	0	0	14	0	0
14	41466483	.	T	A	5	5	10	0	1	11	0	0
14	41466522	.	G	A	7	8	15	0	0	15	0	0
14	41466922	.	T	A	12	14	26	0	1	27	0	0
14	41467152	.	T	C	14	19	33	0	2	35	0	0
14	41467155	.	C	T	21	15	36	0	1	37	0	0
14	41467356	.	C	G	10	8	18	0	1	19	0	0
14	41469575	.	T	A	3	3	6	0	0	6	0	0
14	41469662	.	C	A	2	3	5	0	1	6	0	0
14	41469761	.	G	T	2	5	7	0	0	7	0	0
14	41469827	.	T	C	5	2	7	0	0	7	0	0
14	41469829	.	T	C	5	2	7	0	0	7	0	0
14	41469925	.	T	A	2	3	5	0	1	6	0	0
14	41469935	.	C	T	2	2	4	0	0	4	0	0
14	41470032	.	C	T	0	1	1	0	3	4	0	0
14	41470037	.	A	T	1	2	3	0	0	3	0	0
14	41514842	.	C	T	2	2	4	0	0	4	0	0
14	42172389	.	A	C	3	3	6	0	0	6	0	0
14	42173803	.	C	T	2	4	6	0	0	6	0	0
14	42174247	.	G	A	0	5	5	0	7	12	0	0
14	42174401	.	C	T	1	2	3	0	0	3	0	0
14	42174645	.	A	T	6	6	12	0	1	13	0	0
14	42178503	.	C	T	8	7	15	0	2	17	0	0
14	42178728	.	G	A	14	7	21	0	1	22	0	0
14	42178974	.	G	A	16	8	24	0	1	25	0	0
14	42179574	.	G	T	5	2	7	0	0	7	0	0
14	42179697	.	G	A	0	6	6	0	1	7	0	0
14	42978975	.	A	G	15	8	23	0	0	23	0	0
14	42978980	.	A	C	13	10	23	0	0	23	0	0
14	42979087	.	A	T	17	9	26	0	0	26	0	0
14	42979090	.	T	A	15	9	24	0	2	26	0	0
14	42979655	.	A	G	17	18	35	0	3	38	0	0
14	42997943	.	G	A	17	7	24	0	0	24	0	0
14	42998353	.	G	A	8	4	12	0	2	14	0	0
14	42998879	.	G	A	2	5	7	0	0	7	0	0
14	42999314	.	C	T	1	3	4	0	0	4	0	0
14	43000785	.	A	T	3	4	7	0	0	7	0	0
14	43577346	.	C	T	0	5	5	0	9	14	0	0
14	43577704	.	G	A	7	3	10	0	0	10	0	0
14	43577916	.	G	A	1	0	1	0	0	1	0	0
14	43580985	.	G	T	5	4	9	0	0	9	0	0
14	43582551	.	C	G	1	1	2	0	1	3	0	0
14	43582567	.	G	A	2	1	3	0	0	3	0	0
14	43590849	.	C	T	4	2	6	0	0	6	0	0
14	43591152	.	G	T	3	6	9	0	0	9	0	0
14	43591188	.	G	A	7	14	21	0	0	21	0	0
14	43605214	.	T	C	7	2	9	0	2	11	0	0
14	43605510	.	G	A	3	2	5	0	1	6	0	0
14	44589624	.	C	T	7	9	16	0	0	16	0	0
14	44589834	.	A	G	8	6	14	0	0	14	0	0
14	44589972	.	T	A	4	4	8	0	0	8	0	0
14	44589978	.	G	A	4	4	8	0	0	8	0	0
14	44590297	.	G	C	11	8	19	0	2	21	0	0
14	44590301	.	A	G	12	0	12	0	11	23	0	0
14	44590644	.	C	T	15	13	28	0	0	28	0	0
14	44590838	.	T	A	9	13	22	0	1	23	0	0
14	44590935	.	G	A	1	9	10	0	15	25	0	0
14	44590992	.	A	G	11	13	24	0	1	25	0	0
14	44770817	.	A	T	1	2	3	0	0	3	0	0
14	44809395	.	A	G	0	1	1	0	0	1	0	0
14	44824661	.	A	T	3	1	4	0	2	6	0	0
14	44825436	.	T	A	0	6	6	0	2	8	0	0
14	44829706	.	A	T	2	6	8	0	0	8	0	0
14	45435592	.	T	C	5	3	8	0	0	8	0	0
14	45636070	.	G	A	0	29	29	2	19	50	0	0
14	45636071	.	A	C	35	0	35	2	14	51	0	0
14	45928398	.	T	C	1	2	3	0	0	3	0	0
14	45928432	.	T	C	1	2	3	0	0	3	0	0
14	45929137	.	T	G	1	4	5	0	0	5	0	0
14	45929140	.	T	A	1	4	5	0	0	5	0	0
14	45929173	.	A	G	1	2	3	0	0	3	0	0
14	45929591	.	T	A	1	2	3	0	0	3	0	0
14	45929837	.	T	A	3	4	7	0	0	7	0	0
14	45930399	.	C	T	1	5	6	0	0	6	0	0
14	45930508	.	A	G	1	3	4	0	0	4	0	0
14	45930515	.	G	A	1	1	2	0	0	2	0	0
14	45930669	.	A	G	4	1	5	0	1	6	0	0
14	45930690	.	A	G	4	2	6	0	0	6	0	0
14	45930735	.	T	A	4	2	6	0	1	9	2	0
14	45930794	.	G	A	8	6	14	0	0	14	0	0
14	45931079	.	C	G	13	5	18	0	0	18	0	0
14	45931194	.	G	T	7	8	15	0	1	16	0	0
14	45931504	.	C	G	6	10	16	0	3	19	0	0
14	45931637	.	C	T	13	12	25	0	0	25	0	0
14	45931899	.	C	T	9	3	12	0	1	13	0	0
14	45932128	.	T	G	14	3	17	0	1	18	0	0
14	45997103	.	A	G	1	0	1	0	2	3	0	0
14	45997114	.	T	C	1	3	4	0	0	4	0	0
14	46007306	.	A	G	3	3	6	0	0	6	0	0
14	46007321	.	G	A	1	1	2	0	0	2	0	0
14	46009611	.	G	A	7	3	10	0	1	11	0	0
14	46009683	.	A	T	1	2	3	0	0	3	0	0
14	46013121	.	A	T	0	3	3	0	0	3	0	0
14	46013402	.	C	T	11	15	26	0	1	27	0	0
14	46015888	.	C	A	2	0	2	0	0	2	0	0
14	46016107	.	A	G	2	3	5	0	1	6	0	0
14	46017969	.	G	A	12	17	29	0	0	29	0	0
14	46018029	.	C	T	12	14	26	0	0	26	0	0
14	46018548	.	A	G	7	17	24	0	1	25	0	0
14	46028329	.	G	T	2	4	6	0	0	6	0	0
14	46028330	.	T	A	2	4	6	0	0	6	0	0
14	46028376	.	G	A	1	3	4	0	0	4	0	0
14	46039751	.	T	C	3	2	5	0	1	6	0	0
14	46041763	.	T	G	3	4	7	0	1	8	0	0
14	46041800	.	C	T	8	6	14	0	0	14	0	0
14	46041861	.	A	T	9	8	17	0	0	17	0	0
14	46048396	.	A	G	6	5	11	0	1	12	0	0
14	46048644	.	C	T	0	14	14	0	9	23	0	0
14	46048704	.	C	G	0	13	13	0	12	25	0	0
14	46048875	.	T	C	13	15	28	0	1	29	0	0
14	46052172	.	T	A	7	7	14	0	0	14	0	0
14	46052244	.	G	T	6	4	10	0	0	10	0	0
14	46067317	.	A	T	1	0	1	0	0	1	0	0
14	46074433	.	C	T	10	5	15	0	2	17	0	0
14	46074473	.	T	A	12	3	15	0	1	16	0	0
14	46074489	.	A	G	9	2	11	0	0	11	0	0
14	46074568	.	C	T	11	2	13	0	0	13	0	0
14	46074576	.	G	A	9	0	9	0	2	11	0	0
14	46074626	.	C	G	5	2	7	0	0	7	0	0
14	46074646	.	G	T	3	3	6	0	1	7	0	0
14	46075640	.	A	C	3	2	5	0	2	7	0	0
14	46075749	.	A	G	6	2	8	0	0	8	0	0
14	46075903	.	C	A	3	3	6	0	3	9	0	0
14	46075937	.	T	A	5	3	8	0	1	9	0	0
14	46076197	.	T	A	1	2	3	0	1	4	0	0
14	46076858	.	T	C	4	3	7	0	0	7	0	0
14	46088595	.	T	A	5	2	7	0	1	8	0	0
14	46088921	.	A	G	9	8	17	0	0	17	0	0
14	46089176	.	C	T	11	5	16	0	0	16	0	0
14	46089433	.	T	G	8	3	11	0	0	11	0	0
14	46089532	.	T	C	5	2	7	0	1	8	0	0
14	46089717	.	T	C	1	1	2	0	1	3	0	0
14	46089718	.	T	C	1	2	3	0	0	3	0	0
14	46090015	.	G	A	7	4	11	0	1	12	0	0
14	46090033	.	T	C	10	1	11	0	1	12	0	0
14	46090636	.	A	G	3	3	6	0	0	6	0	0
14	46090653	.	T	A	2	3	5	0	0	5	0	0
14	46091627	.	T	C	4	2	6	0	1	7	0	0
14	46094922	.	C	T	11	8	19	0	7	26	0	0
14	46095043	.	A	G	24	17	41	0	2	43	0	0
14	46095058	.	A	G	23	11	34	0	2	36	0	0
14	46095108	.	A	G	23	26	49	0	4	53	0	0
14	46104150	.	C	T	12	3	15	0	2	17	0	0
14	46104222	.	C	T	0	3	3	0	3	6	0	0
14	46104935	.	G	A	4	5	9	0	1	10	0	0
14	46113296	.	T	G	19	12	31	0	2	33	0	0
14	46113309	.	C	G	0	8	8	0	18	26	0	0
14	46114929	.	G	A	1	1	2	0	0	2	0	0
14	46116576	.	A	G	3	5	8	0	0	8	0	0
14	46117279	.	G	T	4	2	6	0	2	8	0	0
14	46129955	.	C	A	3	2	5	0	0	5	0	0
14	46140812	.	C	A	1	3	4	0	0	4	0	0
14	46146715	.	G	A	10	5	15	0	3	18	0	0
14	46146730	.	G	A	9	6	15	0	0	15	0	0
14	46154358	.	C	A	8	8	16	0	0	16	0	0
14	46154713	.	A	G	9	6	15	0	0	15	0	0
14	46154899	.	A	C	8	7	15	0	0	15	0	0
14	46154966	.	T	A	8	3	11	0	3	14	0	0
14	46154969	.	T	A	8	4	12	0	2	14	0	0
14	46183679	.	A	G	3	0	3	0	2	5	0	0
14	46183683	.	A	G	3	2	5	0	1	6	0	0
14	46224479	.	T	C	1	0	1	0	0	1	0	0
14	46679274	.	T	C	4	2	6	0	0	6	0	0
14	46679356	.	T	C	5	7	12	0	3	15	0	0
14	47003023	.	T	G	8	16	24	0	0	24	0	0
14	47003330	.	A	C	12	26	38	0	0	38	0	0
14	47003696	.	G	T	15	16	31	0	0	31	0	0
14	47003908	.	C	T	2	16	18	0	21	39	0	0
14	47003958	.	T	A	16	18	34	0	6	40	0	0
14	47004090	.	T	G	9	16	25	0	1	26	0	0
14	47004187	.	C	A	11	9	20	0	1	21	0	0
14	47004365	.	G	A	5	10	15	0	1	16	0	0
14	47004734	.	G	A	7	7	14	0	0	14	0	0
14	47004959	.	T	G	9	10	19	0	0	19	0	0
14	47027767	.	G	A	2	5	7	0	2	9	0	0
14	47066764	.	G	A	2	4	6	0	0	6	0	0
14	47085624	.	A	G	1	2	3	0	0	3	0	0
14	47131242	.	T	G	0	2	2	0	0	2	0	0
14	47131260	.	G	A	0	3	3	0	0	3	0	0
14	47882878	.	T	A	1	2	3	0	0	3	0	0
14	48109953	.	G	A	1	5	6	0	0	6	0	0
14	48934010	.	T	C	14	11	25	0	3	28	0	0
14	48934630	.	C	G	10	12	22	0	0	22	0	0
14	48934639	.	T	C	13	0	13	0	6	19	0	0
14	48998118	.	G	A	1	4	5	0	1	6	0	0
14	49022071	.	A	G	3	1	4	0	6	10	0	0
14	49029169	.	A	G	4	2	6	0	0	6	0	0
14	49210955	.	A	G	3	5	8	0	0	8	0	0
14	49211001	.	A	G	1	9	10	0	1	11	0	0
14	49212505	.	A	G	1	2	3	0	0	3	0	0
14	49430817	.	A	G	4	11	15	0	1	16	0	0
14	49432340	.	A	G	13	5	18	0	2	20	0	0
14	49489002	.	A	G	0	25	25	0	5	30	0	0
14	50808007	.	T	C	1	3	4	0	0	4	0	0
14	50973322	.	A	G	2	3	5	0	1	6	0	0
14	50974827	.	A	G	0	2	2	0	0	2	0	0
14	50994282	.	A	C	6	10	16	0	0	16	0	0
14	50994361	.	A	G	5	11	16	0	1	17	0	0
14	50994687	.	G	T	19	16	35	0	4	39	0	0
14	50994695	.	G	C	21	20	41	0	2	43	0	0
14	50999698	.	A	G	9	7	16	0	1	17	0	0
14	51002874	.	G	A	2	6	8	0	3	11	0	0
14	51014221	.	T	G	1	0	1	0	0	1	0	0
14	51017771	.	G	A	0	16	16	0	15	31	0	0
14	51017841	.	A	G	11	8	19	0	1	20	0	0
14	51017952	.	G	A	0	4	4	0	6	10	0	0
14	51017990	.	T	A	0	3	3	0	0	3	0	0
14	51018084	.	G	T	1	2	3	0	0	3	0	0
14	51829341	.	G	A	28	33	61	0	6	67	0	0
14	51829377	.	A	G	29	37	66	0	2	68	0	0
14	51830952	.	G	A	8	2	10	0	0	10	0	0
14	52354225	.	T	C	1	2	3	0	0	3	0	0
14	52354231	.	A	G	1	2	3	0	0	3	0	0
14	52358842	.	A	C	2	1	3	0	0	3	0	0
14	52358915	.	G	A	0	2	2	0	4	6	0	0
14	52358971	.	G	C	2	1	3	0	2	5	0	0
14	52361399	.	C	T	0	1	1	0	0	1	0	0
14	52366401	.	G	A	12	6	18	0	0	18	0	0
14	52366464	.	C	T	9	6	15	0	1	16	0	0
14	52369558	.	C	A	2	5	7	0	1	8	0	0
14	52379732	.	C	A	5	5	10	0	0	10	0	0
14	52379740	.	T	A	6	6	12	0	0	12	0	0
14	52379992	.	C	A	4	5	9	0	0	9	0	0
14	52380345	.	C	A	3	2	5	0	0	5	0	0
14	52383817	.	G	A	5	3	8	0	0	8	0	0
14	52383871	.	G	A	7	6	13	0	1	14	0	0
14	52386667	.	G	A	6	5	11	0	0	11	0	0
14	52386736	.	C	T	10	14	24	0	3	27	0	0
14	52386750	.	G	A	9	14	23	0	6	29	0	0
14	52388115	.	G	A	2	0	2	0	1	3	0	0
14	52388136	.	G	C	2	1	3	0	0	3	0	0
14	52388297	.	T	C	2	0	2	0	2	4	0	0
14	52391664	.	G	A	4	2	6	0	1	7	0	0
14	52392238	.	G	A	4	6	10	0	1	11	0	0
14	52395492	.	G	A	4	5	9	0	0	9	0	0
14	52395552	.	C	T	0	1	1	0	0	1	0	0
14	52397293	.	C	T	2	3	5	0	1	6	0	0
14	52399977	.	A	G	0	3	3	0	0	3	0	0
14	52413205	.	G	A	0	1	1	0	0	1	0	0
14	52417462	.	T	A	2	4	6	0	0	6	0	0
14	52417470	.	A	T	4	4	8	0	0	8	0	0
14	52418127	.	T	A	3	3	6	0	0	6	0	0
14	52418772	.	G	T	8	8	16	0	4	20	0	0
14	52418818	.	A	G	11	3	14	0	3	17	0	0
14	52418943	.	A	T	2	4	6	0	0	6	0	0
14	52419007	.	C	G	3	2	5	0	0	5	0	0
14	52476624	.	T	C	1	4	5	0	0	5	0	0
14	52476640	.	A	G	0	4	4	0	1	5	0	0
14	52494686	.	T	C	3	3	6	0	0	6	0	0
14	52512529	.	G	A	0	4	4	0	6	10	0	0
14	52517782	.	T	A	6	6	12	0	2	14	0	0
14	52517784	.	A	C	6	6	12	0	2	14	0	0
14	52517957	.	T	C	11	8	19	0	1	20	0	0
14	52518002	.	A	G	6	11	17	0	2	19	0	0
14	52518030	.	G	A	1	11	12	0	14	26	0	0
14	52518125	.	C	A	3	11	14	0	1	15	0	0
14	52518329	.	A	T	6	4	10	0	3	13	0	0
14	52520270	.	G	A	5	2	7	0	0	7	0	0
14	52522820	.	T	C	16	14	30	0	0	30	0	0
14	52522822	.	C	T	15	14	29	0	1	30	0	0
14	52522876	.	C	T	7	20	27	0	0	27	0	0
14	52523237	.	G	C	6	3	9	0	0	9	0	0
14	52523290	.	C	T	0	7	7	0	6	13	0	0
14	52523648	.	G	T	7	13	20	0	1	21	0	0
14	52523707	.	A	G	9	10	19	0	2	21	0	0
14	52524091	.	A	G	1	2	3	0	0	3	0	0
14	52524110	.	A	G	2	4	6	0	0	6	0	0
14	52524364	.	C	T	0	3	3	0	11	14	0	0
14	52524525	.	A	T	3	3	6	0	1	7	0	0
14	52524651	.	A	T	10	3	13	0	0	13	0	0
14	52524653	.	G	T	10	2	12	0	1	13	0	0
14	52524687	.	T	A	3	9	12	0	0	12	0	0
14	52524767	.	A	G	4	8	12	0	0	12	0	0
14	52524792	.	A	G	3	2	5	0	1	6	0	0
14	52525016	.	C	T	0	7	7	0	5	12	0	0
14	52525673	.	G	A	6	3	9	0	1	10	0	0
14	52525812	.	C	T	0	7	7	0	5	12	0	0
14	52528210	.	G	A	1	0	1	0	0	1	0	0
14	52533500	.	G	A	8	4	12	0	0	12	0	0
14	52536303	.	G	C	0	1	1	0	1	2	0	0
14	52552852	.	A	G	15	2	17	0	3	22	2	0
14	52552863	.	G	A	9	16	25	0	3	28	0	0
14	52574954	.	C	G	0	3	3	0	1	4	0	0
14	52575754	.	T	C	2	11	13	0	1	14	0	0
14	52575878	.	A	G	4	7	11	0	2	13	0	0
14	52575879	.	T	A	4	9	13	0	0	13	0	0
14	52576006	.	A	G	1	3	4	0	0	4	0	0
14	52577036	.	G	A	5	3	8	0	0	8	0	0
14	52577042	.	A	G	5	2	7	0	0	7	0	0
14	52580849	.	G	A	0	2	2	0	0	2	0	0
15	784368	.	G	C	2	3	5	0	0	5	0	0
15	895740	.	A	T	1	1	2	0	1	3	0	0
15	1033435	.	A	T	5	9	14	0	0	14	0	0
15	1033479	.	T	G	5	6	11	0	0	11	0	0
15	1033564	.	G	T	6	3	9	0	0	9	0	0
15	1033632	.	G	A	5	6	11	0	0	11	0	0
15	1033853	.	A	G	6	3	9	0	0	9	0	0
15	1036614	.	C	T	1	0	1	0	0	1	0	0
15	1036677	.	C	T	0	5	5	0	6	11	0	0
15	1036825	.	T	C	3	4	7	0	0	7	0	0
15	1038152	.	A	T	0	1	1	0	0	1	0	0
15	1168999	.	A	G	1	1	2	0	0	2	0	0
15	1173067	.	C	T	1	4	5	0	0	5	0	0
15	1173542	.	C	T	2	2	4	0	0	4	0	0
15	1174823	.	A	G	0	1	1	0	0	1	0	0
15	1176447	.	G	A	0	2	2	0	3	5	0	0
15	1178927	.	C	A	5	5	10	0	0	10	0	0
15	1183930	.	G	T	2	3	5	0	0	5	0	0
15	1183984	.	C	T	0	8	8	0	9	17	0	0
15	1186181	.	A	G	3	4	7	0	1	8	0	0
15	1186202	.	C	T	0	4	4	0	3	7	0	0
15	1189664	.	C	T	11	6	17	0	1	18	0	0
15	1191792	.	G	A	1	3	4	0	10	14	0	0
15	1194590	.	A	G	11	12	23	0	6	29	0	0
15	1194619	.	G	A	0	13	13	0	12	25	0	0
15	1194633	.	A	G	12	11	23	0	0	23	0	0
15	1194670	.	G	A	18	7	25	0	1	26	0	0
15	1194739	.	G	T	12	4	16	0	0	16	0	0
15	1194754	.	T	C	11	5	16	0	1	17	0	0
15	1672372	.	A	G	8	11	19	0	0	20	1	0
15	1848098	.	T	C	2	9	11	0	1	12	0	0
15	1848121	.	T	C	10	5	15	0	0	15	0	0
15	2414584	.	G	T	4	3	7	0	1	8	0	0
15	2414603	.	A	T	9	3	12	0	0	12	0	0
15	2414764	.	A	G	6	4	10	0	0	10	0	0
15	2414798	.	A	G	6	5	11	0	0	12	1	0
15	2507281	.	C	G	0	4	4	0	0	4	0	0
15	2537882	.	G	A	2	1	3	0	0	3	0	0
15	2729971	.	T	C	3	6	9	0	0	9	0	0
15	2730358	.	T	C	5	10	15	0	1	16	0	0
15	2730399	.	T	C	10	4	14	0	1	15	0	0
15	3377017	.	T	C	1	2	3	0	0	3	0	0
15	3924542	.	G	A	4	2	6	0	0	6	0	0
15	3924600	.	T	G	2	3	5	0	0	5	0	0
15	3924601	.	T	G	2	3	5	0	0	5	0	0
15	3925206	.	G	T	0	4	4	0	3	7	0	0
15	3925241	.	A	T	3	4	7	0	0	7	0	0
15	3925276	.	A	T	1	2	3	0	0	3	0	0
15	3925286	.	G	A	2	1	3	0	1	4	0	0
15	3927285	.	T	C	1	4	5	0	0	5	0	0
15	3927295	.	T	A	1	5	6	0	0	6	0	0
15	3928029	.	G	A	1	3	4	0	0	4	0	0
15	3928232	.	C	T	1	2	3	0	1	4	0	0
15	3928866	.	G	C	3	2	5	0	0	5	0	0
15	3928877	.	T	A	4	2	6	0	0	6	0	0
15	4105009	.	A	G	6	2	8	0	0	8	0	0
15	4105168	.	T	G	7	6	13	0	0	13	0	0
15	4105235	.	T	C	6	3	9	0	2	11	0	0
15	4105262	.	A	G	5	4	9	0	0	9	0	0
15	4105328	.	A	G	9	4	13	0	0	13	0	0
15	4105416	.	G	T	3	4	7	0	0	7	0	0
15	4111821	.	A	G	0	3	3	0	0	3	0	0
15	4112123	.	A	T	1	2	3	0	1	4	0	0
15	4112132	.	T	C	2	2	4	0	0	4	0	0
15	4112233	.	C	T	1	0	1	0	0	1	0	0
15	4119284	.	A	G	3	2	5	0	0	5	0	0
15	4119323	.	G	A	2	1	3	0	1	4	0	0
15	4119329	.	A	G	2	2	4	0	0	4	0	0
15	4172458	.	C	T	1	2	3	0	0	3	0	0
15	4353333	.	T	C	6	0	6	0	12	21	3	0
15	4353353	.	C	T	12	17	29	0	1	30	0	0
15	4353858	.	C	T	32	22	54	0	10	64	0	0
15	4353965	.	G	A	27	37	64	0	13	77	0	0
15	4354071	.	G	A	32	37	69	0	1	70	0	0
15	4367594	.	T	C	26	27	53	0	2	55	0	0
15	4371833	.	T	C	4	6	10	0	0	10	0	0
15	4371863	.	C	T	0	2	2	0	1	3	0	0
15	4415864	.	G	C	4	2	6	0	2	8	0	0
15	4422128	.	G	T	8	3	11	0	0	11	0	0
15	4422222	.	A	G	2	3	5	0	0	5	0	0
15	4422302	.	T	C	1	2	3	0	0	3	0	0
15	4422514	.	G	C	1	3	4	0	1	5	0	0
15	4422580	.	A	G	1	1	2	0	0	2	0	0
15	4553776	.	C	T	1	2	3	0	0	3	0	0
15	4585517	.	T	C	13	0	13	0	16	29	0	0
15	4585771	.	T	A	10	7	17	0	2	19	0	0
15	4586190	.	C	G	0	12	12	0	21	33	0	0
15	4586235	.	A	G	13	11	24	0	1	25	0	0
15	4586299	.	G	T	7	8	15	0	2	17	0	0
15	4633700	.	C	G	13	0	13	0	26	39	0	0
15	4634063	.	C	T	23	22	45	0	4	49	0	0
15	4634196	.	T	C	25	13	38	0	4	42	0	0
15	4634354	.	A	G	20	26	46	0	1	47	0	0
15	4634454	.	A	G	22	21	43	0	4	47	0	0
15	4634627	.	A	G	16	12	28	0	4	32	0	0
15	4634698	.	C	A	17	7	24	0	2	26	0	0
15	4635055	.	G	A	0	22	22	0	31	53	0	0
15	4635073	.	T	C	26	25	51	0	2	53	0	0
15	4635179	.	C	A	28	17	45	0	6	51	0	0
15	4635387	.	C	T	25	19	44	0	2	46	0	0
15	4635517	.	G	A	16	15	31	0	4	35	0	0
15	4635573	.	C	T	25	8	33	0	2	35	0	0
15	4969267	.	T	C	2	2	4	0	0	4	0	0
15	4969522	.	C	G	3	1	4	0	0	4	0	0
15	4969558	.	C	T	3	1	4	0	0	4	0	0
15	4981675	.	G	T	1	2	3	0	0	3	0	0
15	4982614	.	T	C	3	2	5	0	0	5	0	0
15	4982744	.	C	A	1	2	3	0	1	4	0	0
15	4983533	.	A	T	2	5	7	0	0	7	0	0
15	4983596	.	A	G	5	1	6	0	0	6	0	0
15	4983708	.	A	T	1	3	4	0	1	5	0	0
15	4984740	.	T	C	5	3	8	0	1	9	0	0
15	4984759	.	T	C	2	6	8	0	1	9	0	0
15	4985002	.	A	T	2	2	4	0	1	5	0	0
15	4991716	.	T	C	2	0	2	0	0	2	0	0
15	4991722	.	A	G	2	0	2	0	0	2	0	0
15	4995166	.	A	G	5	6	11	0	1	12	0	0
15	4999347	.	G	C	2	9	11	0	1	12	0	0
15	4999572	.	G	C	7	12	19	0	1	20	0	0
15	5074033	.	G	A	2	4	6	0	0	6	0	0
15	5074873	.	A	G	3	6	9	0	0	9	0	0
15	5140807	.	G	A	0	1	1	0	0	1	0	0
15	5140936	.	C	A	0	1	1	0	0	1	0	0
15	5140939	.	G	A	0	1	1	0	0	1	0	0
15	5144775	.	T	C	0	0	0	0	1	1	0	0
15	5144805	.	A	C	4	0	4	0	1	5	0	0
15	5145104	.	C	A	1	5	6	0	0	6	0	0
15	5145137	.	A	C	1	1	2	0	0	2	0	0
15	5147843	.	C	T	4	2	6	0	1	7	0	0
15	5147987	.	T	C	6	3	9	0	2	11	0	0
15	5148519	.	T	A	3	4	7	0	0	7	0	0
15	5148562	.	G	A	2	6	8	0	0	8	0	0
15	5403687	.	A	C	1	2	3	0	0	3	0	0
15	5566420	.	A	T	0	1	1	0	0	1	0	0
15	5566452	.	C	A	0	2	2	0	0	2	0	0
15	5632677	.	A	G	4	2	6	0	0	6	0	0
15	5632683	.	C	T	4	2	6	0	0	6	0	0
15	5650755	.	G	A	0	1	1	0	0	1	0	0
15	5650758	.	T	G	0	1	1	0	0	1	0	0
15	5660306	.	G	C	1	1	2	0	0	2	0	0
15	5660339	.	A	G	0	1	1	0	0	1	0	0
15	5723734	.	C	A	5	3	8	0	0	8	0	0
15	5723938	.	T	G	9	7	16	0	1	17	0	0
15	5723980	.	C	G	0	10	10	0	8	18	0	0
15	5726178	.	T	A	5	2	7	0	0	7	0	0
15	5728461	.	A	G	3	3	6	0	0	6	0	0
15	5738967	.	A	G	1	3	4	0	0	4	0	0
15	5829922	.	C	T	6	7	13	0	0	13	0	0
15	5830106	.	G	T	1	6	7	0	0	7	0	0
15	5830218	.	T	C	3	4	7	0	0	7	0	0
15	5830443	.	T	G	11	6	17	0	0	17	0	0
15	5830513	.	C	T	2	6	8	0	0	8	0	0
15	5830691	.	T	C	5	6	11	0	0	11	0	0
15	5830696	.	C	T	0	6	6	0	6	12	0	0
15	5830740	.	G	T	7	8	15	0	0	15	0	0
15	5831004	.	G	A	7	4	11	0	0	11	0	0
15	5831199	.	G	A	2	6	8	0	1	9	0	0
15	5831375	.	T	G	0	4	4	0	1	5	0	0
15	5831405	.	T	C	1	6	7	0	1	8	0	0
15	5836499	.	G	A	5	5	10	0	0	10	0	0
15	5836532	.	C	T	5	6	11	0	0	11	0	0
15	5836542	.	C	T	4	6	10	0	0	10	0	0
15	5836610	.	G	T	5	5	10	0	0	10	0	0
15	5853119	.	A	T	2	2	4	0	0	4	0	0
15	5862639	.	A	T	1	2	3	0	0	3	0	0
15	5898511	.	T	A	3	7	10	0	1	11	0	0
15	5898856	.	A	G	23	20	43	0	3	46	0	0
15	5898920	.	A	C	16	14	30	0	1	31	0	0
15	5899083	.	C	T	0	21	21	0	19	40	0	0
15	5899113	.	G	A	0	30	30	0	2	33	1	0
15	5899237	.	C	A	0	10	10	0	6	16	0	0
15	5899277	.	A	G	5	1	6	0	3	9	0	0
15	5904761	.	T	C	7	6	13	0	1	14	0	0
15	5914994	.	G	A	0	1	1	0	3	4	0	0
15	5916387	.	C	A	19	14	33	0	3	36	0	0
15	5916389	.	G	C	19	16	35	0	1	36	0	0
15	5916442	.	G	A	15	11	26	0	1	27	0	0
15	5916651	.	A	T	2	2	4	0	1	5	0	0
15	5916676	.	G	T	2	1	3	0	2	5	0	0
15	5916741	.	G	T	2	2	4	0	0	4	0	0
15	6139624	.	G	C	13	7	20	0	1	21	0	0
15	6139800	.	G	A	7	24	31	0	6	37	0	0
15	6139803	.	C	T	9	21	30	0	7	37	0	0
15	6154439	.	T	A	8	10	18	0	3	21	0	0
15	6161789	.	A	G	1	2	3	0	1	4	0	0
15	6161804	.	C	T	0	1	1	0	1	2	0	0
15	6515063	.	T	C	0	4	4	0	0	4	0	0
15	6652600	.	T	C	3	12	15	0	1	16	0	0
15	6653094	.	T	G	2	0	2	0	0	2	0	0
15	6653209	.	G	T	0	1	1	0	0	1	0	0
15	6653282	.	C	G	1	0	1	0	0	1	0	0
15	6654587	.	C	A	8	9	17	0	1	18	0	0
15	6659159	.	G	A	9	4	13	0	0	13	0	0
15	6661390	.	G	A	10	12	22	0	0	22	0	0
15	6661449	.	T	C	15	14	29	0	1	30	0	0
15	6661499	.	G	A	0	0	0	0	1	1	0	0
15	6778515	.	T	A	1	0	1	0	0	1	0	0
15	6778856	.	C	A	3	3	6	0	2	8	0	0
15	6778877	.	A	G	3	4	7	0	2	9	0	0
15	6784118	.	C	T	1	2	3	0	0	3	0	0
15	6799903	.	G	A	3	5	8	0	1	9	0	0
15	6806712	.	G	C	13	12	25	0	3	28	0	0
15	6806836	.	G	A	11	15	26	0	4	30	0	0
15	6806912	.	T	G	8	9	17	0	1	18	0	0
15	6806931	.	T	G	10	8	18	0	1	19	0	0
15	6807014	.	A	T	1	2	3	0	0	3	0	0
15	6807500	.	C	G	12	11	23	0	1	24	0	0
15	6807514	.	G	A	11	14	25	0	1	26	0	0
15	6807563	.	A	T	20	15	35	0	2	37	0	0
15	6807874	.	C	T	7	8	15	0	1	16	0	0
15	6838043	.	C	A	3	2	5	0	0	5	0	0
15	6838126	.	G	A	3	2	5	0	2	7	0	0
15	6838154	.	T	A	2	3	5	0	0	5	0	0
15	6838771	.	T	C	4	2	6	0	0	6	0	0
15	6838786	.	T	C	4	3	7	0	0	7	0	0
15	6841506	.	G	T	0	1	1	0	0	1	0	0
15	6845636	.	T	A	1	2	3	0	0	3	0	0
15	6863137	.	T	C	2	2	4	0	0	4	0	0
15	6957221	.	C	G	5	3	8	0	0	8	0	0
15	8604835	.	A	C	1	13	14	0	0	14	0	0
15	8605259	.	C	A	11	16	27	0	1	28	0	0
15	8605318	.	G	A	12	13	25	0	3	28	0	0
15	8605452	.	C	A	6	10	16	0	1	17	0	0
15	8605838	.	T	A	4	15	19	0	2	21	0	0
15	8605839	.	A	T	4	14	18	0	3	21	0	0
15	8605972	.	T	A	8	10	18	0	2	20	0	0
15	8606207	.	A	T	8	4	12	0	1	14	1	0
15	8606224	.	G	A	6	5	11	0	1	12	0	0
15	8606256	.	A	C	5	4	9	0	1	10	0	0
15	8606464	.	A	G	12	12	24	0	1	25	0	0
15	8606501	.	G	A	11	12	23	0	1	24	0	0
15	8606507	.	G	A	10	11	21	0	2	23	0	0
15	8606555	.	C	T	7	9	16	0	1	17	0	0
15	8606601	.	A	C	9	4	13	0	0	13	0	0
15	8606619	.	A	G	8	6	14	0	2	16	0	0
15	8606733	.	T	C	1	9	10	0	0	10	0	0
15	8606739	.	A	T	3	7	10	0	3	13	0	0
15	8606872	.	C	A	5	10	15	0	0	15	0	0
15	8606897	.	T	C	7	6	13	0	0	13	0	0
15	8607025	.	T	A	6	11	17	0	0	17	0	0
15	8607182	.	T	A	4	7	11	0	0	11	0	0
15	8607846	.	T	A	2	1	3	0	0	3	0	0
15	8661671	.	C	T	6	4	10	0	0	10	0	0
15	8797850	.	T	C	16	22	38	0	5	43	0	0
15	8799141	.	T	A	15	21	36	0	1	37	0	0
15	8799267	.	C	T	13	3	16	0	3	19	0	0
15	8799462	.	T	A	25	12	37	0	0	37	0	0
15	8799713	.	G	A	20	26	46	0	6	52	0	0
15	8799730	.	T	G	19	2	21	0	36	57	0	0
15	8799831	.	T	C	16	21	37	0	7	44	0	0
15	8799856	.	G	A	12	18	30	0	3	33	0	0
15	8799872	.	C	A	13	17	30	0	3	33	0	0
15	8799892	.	C	T	12	19	31	0	1	32	0	0
15	8799916	.	T	C	11	16	27	0	2	29	0	0
15	8990820	.	G	A	2	3	5	0	0	5	0	0
15	8991713	.	T	C	1	2	3	0	0	3	0	0
15	8991738	.	A	G	1	2	3	0	0	3	0	0
15	8991757	.	G	C	1	2	3	0	0	3	0	0
15	8992325	.	C	T	1	2	3	0	0	3	0	0
15	9011092	.	A	G	1	2	3	0	0	3	0	0
15	9011178	.	C	T	2	4	6	0	0	6	0	0
15	9234102	.	A	C	18	25	43	0	2	45	0	0
15	9234114	.	A	G	20	29	49	0	5	54	0	0
15	9234156	.	A	C	20	40	60	0	4	64	0	0
15	9234634	.	A	T	18	23	41	0	3	45	1	0
15	9234885	.	A	G	38	15	53	0	8	61	0	0
15	9234960	.	C	T	35	27	62	0	1	63	0	0
15	9234972	.	T	C	33	27	60	0	4	64	0	0
15	9235081	.	C	G	31	29	60	0	4	64	0	0
15	9235128	.	A	C	34	25	59	0	1	60	0	0
15	9235254	.	A	G	29	24	53	0	4	57	0	0
15	9235319	.	C	T	35	16	51	0	2	53	0	0
15	9235461	.	T	G	38	9	47	0	4	51	0	0
15	9238101	.	G	A	8	6	14	0	1	15	0	0
15	9249293	.	G	A	0	3	3	0	0	3	0	0
15	9249344	.	C	T	22	19	41	0	4	45	0	0
15	9249346	.	A	G	22	21	43	0	2	45	0	0
15	9315612	.	C	A	3	5	8	0	1	9	0	0
15	9315825	.	T	C	1	7	8	0	3	11	0	0
15	9367812	.	G	A	12	6	18	0	1	19	0	0
15	9367842	.	T	C	9	8	17	0	1	18	0	0
15	9368757	.	G	A	3	7	10	0	0	10	0	0
15	9368834	.	A	G	8	4	12	1	0	13	0	0
15	9369114	.	T	C	8	6	14	0	0	14	0	0
15	9369344	.	G	T	3	4	7	0	1	8	0	0
15	9369368	.	C	T	2	2	4	0	1	5	0	0
15	9369571	.	A	T	4	4	8	0	0	8	0	0
15	9369610	.	A	T	2	5	7	0	0	7	0	0
15	9369651	.	G	C	8	3	11	0	0	11	0	0
15	9369689	.	G	A	5	4	9	0	1	10	0	0
15	9369733	.	C	T	3	7	10	0	2	12	0	0
15	9369737	.	C	G	8	5	13	0	0	13	0	0
15	9370096	.	T	C	2	5	7	0	0	7	0	0
15	9370131	.	C	T	7	4	11	0	0	11	0	0
15	9370400	.	T	C	1	3	4	0	0	4	0	0
15	9370416	.	A	T	0	3	3	0	0	3	0	0
15	9370477	.	A	G	3	1	4	0	1	5	0	0
15	9370492	.	C	G	2	2	4	0	1	5	0	0
15	9370534	.	T	A	3	2	5	0	0	5	0	0
15	9370553	.	C	T	2	2	4	0	1	5	0	0
15	9371303	.	G	A	7	3	10	0	0	10	0	0
15	9371564	.	A	G	3	2	5	0	1	6	0	0
15	9371657	.	T	C	1	3	4	0	0	4	0	0
15	9371678	.	A	G	2	4	6	0	1	7	0	0
15	10001851	.	A	G	15	15	30	0	1	32	1	0
15	10002281	.	G	A	9	10	19	0	3	22	0	0
15	10002317	.	G	A	9	10	19	0	0	19	0	0
15	10002478	.	T	C	0	4	4	0	1	5	0	0
15	10002480	.	T	A	0	5	5	0	0	5	0	0
15	10002524	.	T	C	7	7	14	0	2	16	0	0
15	10002545	.	C	T	11	5	16	0	0	16	0	0
15	10002591	.	A	G	9	9	18	0	0	18	0	0
15	10003274	.	C	T	9	11	20	0	1	21	0	0
15	10003357	.	G	A	3	7	10	0	0	10	0	0
15	10003379	.	G	A	5	8	13	0	0	13	0	0
15	10003647	.	C	T	0	5	5	0	6	11	0	0
15	10003767	.	C	T	0	2	2	0	5	7	0	0
15	10025010	.	T	C	1	4	5	0	0	5	0	0
15	10025760	.	T	G	3	1	4	0	1	5	0	0
15	10027296	.	A	G	1	2	3	0	0	3	0	0
15	10081966	.	G	A	1	1	2	0	0	2	0	0
15	11308486	.	T	C	5	2	7	0	0	7	0	0
15	11668633	.	C	T	1	2	3	0	0	3	0	0
15	11670283	.	A	C	5	3	8	0	0	8	0	0
15	11670590	.	G	T	1	8	9	0	0	9	0	0
15	11690967	.	T	C	6	3	9	0	1	10	0	0
15	11691008	.	T	G	4	0	4	0	7	11	0	0
15	11757580	.	T	A	4	3	7	0	2	9	0	0
15	15406925	.	T	G	1	0	1	0	0	1	0	0
15	15406934	.	C	T	1	0	1	0	0	1	0	0
15	15445876	.	T	C	3	2	5	0	1	6	0	0
15	15449191	.	G	A	0	1	1	0	1	2	0	0
15	15449215	.	A	G	3	2	5	0	0	5	0	0
15	15513583	.	A	G	1	1	2	0	1	3	0	0
15	15513593	.	A	G	0	0	0	0	2	2	0	0
15	16379806	.	T	A	1	2	3	0	0	3	0	0
15	16406604	.	G	T	12	3	15	0	1	16	0	0
15	17124296	.	A	G	10	4	14	0	1	15	0	0
15	17487291	.	A	G	4	3	7	0	0	7	0	0
15	17487293	.	A	G	2	2	4	0	3	7	0	0
15	17487544	.	A	G	13	5	18	0	1	19	0	0
15	19293919	.	G	T	8	4	12	0	1	13	0	0
15	19293920	.	G	T	8	5	13	0	0	13	0	0
15	19301087	.	A	G	1	2	3	0	0	3	0	0
15	19301259	.	A	G	1	3	4	0	0	4	0	0
15	19311505	.	G	T	0	1	1	0	2	3	0	0
15	19316319	.	T	G	2	2	4	0	0	4	0	0
15	19316437	.	C	A	1	3	4	0	2	6	0	0
15	19316497	.	A	T	8	4	12	0	0	12	0	0
15	19316573	.	T	C	5	3	8	0	0	8	0	0
15	19318927	.	A	C	2	2	4	0	0	4	0	0
15	19319150	.	A	G	3	0	3	0	6	9	0	0
15	19319227	.	C	G	3	11	14	0	1	15	0	0
15	19319250	.	T	C	6	11	17	0	1	18	0	0
15	19319272	.	G	C	7	9	16	0	1	17	0	0
15	19319429	.	G	A	3	3	6	0	1	7	0	0
15	19319523	.	A	C	2	3	5	0	0	5	0	0
15	19319666	.	A	G	4	0	4	0	7	11	0	0
15	19327665	.	G	A	0	4	4	0	4	8	0	0
15	19328334	.	G	A	1	2	3	0	1	4	0	0
15	19329944	.	G	A	6	3	9	0	0	9	0	0
15	19329950	.	C	T	6	3	9	0	0	9	0	0
15	19330144	.	C	T	4	6	10	0	0	10	0	0
15	19330652	.	A	G	6	1	7	0	5	12	0	0
15	19330745	.	T	A	1	3	4	0	0	4	0	0
15	19330748	.	C	A	1	2	3	0	0	3	0	0
15	19331011	.	C	A	5	5	10	0	0	10	0	0
15	19336799	.	G	A	2	1	3	0	0	3	0	0
15	19345614	.	C	T	1	8	9	0	0	9	0	0
15	19347878	.	G	T	9	10	19	0	0	19	0	0
15	19348038	.	A	G	7	5	12	0	0	12	0	0
15	19348275	.	C	T	9	8	17	0	0	17	0	0
15	19522085	.	T	C	0	1	1	0	0	1	0	0
15	19576879	.	A	G	2	1	3	0	0	3	0	0
15	19577242	.	G	A	4	2	6	0	0	6	0	0
15	19577367	.	C	A	1	1	2	0	1	3	0	0
15	19583841	.	C	T	12	4	16	0	0	16	0	0
15	19584132	.	G	T	2	1	3	0	0	3	0	0
15	19584187	.	T	C	6	9	15	0	0	15	0	0
15	19595508	.	C	T	3	6	9	0	0	9	0	0
15	19595509	.	T	G	6	0	6	0	3	9	0	0
15	19600214	.	C	T	10	14	24	0	0	24	0	0
15	19600390	.	A	T	6	4	10	0	1	11	0	0
15	19661756	.	T	A	8	11	19	0	5	24	0	0
15	19661820	.	G	T	12	13	25	0	2	27	0	0
15	19668294	.	T	G	2	4	6	0	0	6	0	0
15	19668534	.	A	G	3	6	9	0	0	9	0	0
15	19668558	.	G	A	2	4	6	0	0	6	0	0
15	19668585	.	A	G	1	4	5	0	0	5	0	0
15	19726925	.	T	A	1	2	3	0	0	3	0	0
15	19726939	.	T	C	1	3	4	0	0	4	0	0
15	19726987	.	C	A	0	3	3	0	0	3	0	0
15	19727056	.	A	C	2	4	6	0	0	6	0	0
15	19727184	.	T	C	3	4	7	0	0	7	0	0
15	19728131	.	A	T	11	6	17	0	1	18	0	0
15	19728638	.	A	G	28	16	44	0	5	49	0	0
15	19728853	.	T	A	4	13	17	0	0	17	0	0
15	19728989	.	A	C	17	9	26	0	0	26	0	0
15	19737755	.	C	T	0	2	2	0	0	2	0	0
15	19742655	.	T	C	6	4	10	0	0	10	0	0
15	19745764	.	C	A	0	6	6	0	5	11	0	0
15	19878747	.	C	T	1	3	4	0	0	4	0	0
15	19891939	.	T	C	3	5	8	1	1	10	0	0
15	19895285	.	A	G	12	6	18	0	1	19	0	0
15	19895304	.	T	A	9	8	17	0	0	17	0	0
15	19895991	.	A	G	7	0	7	0	11	18	0	0
15	19896052	.	A	C	7	7	14	0	2	16	0	0
15	19907046	.	T	A	1	2	3	0	0	3	0	0
15	19907082	.	G	A	0	5	5	0	1	6	0	0
15	19907083	.	A	G	1	5	6	0	0	6	0	0
15	19907233	.	T	C	1	5	6	0	0	6	0	0
15	19907241	.	A	G	1	5	6	0	0	6	0	0
15	19908328	.	T	A	4	5	9	0	0	9	0	0
15	19908340	.	T	A	1	5	6	0	0	6	0	0
15	19908777	.	A	T	4	10	14	0	0	14	0	0
15	19925978	.	G	A	2	4	6	0	0	6	0	0
15	20003130	.	G	A	1	7	8	0	0	8	0	0
15	20005301	.	A	G	3	7	10	0	1	11	0	0
15	20005665	.	C	A	2	3	5	0	1	6	0	0
15	20005943	.	A	G	14	5	19	0	0	19	0	0
15	20006747	.	T	G	5	6	11	0	1	12	0	0
15	20008357	.	C	T	2	2	4	0	0	4	0	0
15	20061367	.	G	A	10	5	15	0	0	15	0	0
15	20065029	.	T	C	1	2	3	0	0	3	0	0
15	20065074	.	G	A	6	3	9	0	1	10	0	0
15	20065125	.	A	G	3	0	3	0	0	3	0	0
15	20069165	.	T	C	2	2	4	0	1	5	0	0
15	20069201	.	G	A	4	5	9	0	0	9	0	0
15	20071596	.	G	A	2	3	5	0	1	6	0	0
15	20071713	.	T	C	1	0	1	0	0	1	0	0
15	20081275	.	T	A	0	2	2	0	0	2	0	0
15	20081903	.	G	A	1	2	3	0	0	3	0	0
15	20204850	.	T	G	3	2	5	0	0	5	0	0
15	20204873	.	C	T	2	3	5	0	0	5	0	0
15	20374712	.	G	A	0	1	1	0	0	1	0	0
15	20376393	.	A	G	0	1	1	0	0	1	0	0
15	20377873	.	A	T	2	1	3	0	0	3	0	0
15	20377946	.	C	T	1	3	4	0	0	4	0	0
15	20378479	.	T	C	2	5	7	0	1	8	0	0
15	20379860	.	C	T	4	5	9	0	0	9	0	0
15	20380144	.	C	A	1	0	1	0	0	1	0	0
15	20383150	.	C	T	3	5	8	0	1	9	0	0
15	20384539	.	A	G	7	0	7	0	7	14	0	0
15	20385868	.	C	G	0	0	0	0	1	1	0	0
15	20394672	.	T	C	9	5	14	0	1	15	0	0
15	20395141	.	G	A	1	18	19	0	9	28	0	0
15	20406270	.	A	C	5	8	13	0	0	13	0	0
15	20406413	.	C	T	0	2	2	0	8	10	0	0
15	20406484	.	G	C	4	6	10	0	0	10	0	0
15	20407407	.	C	T	0	1	1	0	0	1	0	0
15	20407938	.	G	T	2	3	5	0	1	6	0	0
15	20407951	.	G	T	2	3	5	0	0	5	0	0
15	20412107	.	G	T	2	2	4	0	0	4	0	0
15	20412171	.	G	C	1	12	13	0	0	13	0	0
15	20463954	.	C	A	2	2	4	0	0	4	0	0
15	20464148	.	C	T	4	2	6	0	0	6	0	0
15	20475817	.	A	G	4	7	11	0	1	12	0	0
15	20478820	.	G	A	12	5	17	0	1	18	0	0
15	20479056	.	A	G	8	8	16	0	0	16	0	0
15	20489875	.	G	A	4	0	4	0	0	4	0	0
15	20540641	.	T	A	2	2	4	0	0	4	0	0
15	20540943	.	T	A	1	2	3	0	1	4	0	0
15	20629622	.	C	T	0	2	2	0	0	2	0	0
15	20652813	.	A	T	14	19	33	0	0	34	1	0
15	20652955	.	A	G	27	17	44	0	2	46	0	0
15	20653005	.	T	A	21	23	44	0	2	46	0	0
15	20653258	.	T	A	25	15	40	0	6	46	0	0
15	20709184	.	T	A	9	5	14	0	2	16	0	0
15	20709340	.	G	C	14	11	25	0	3	28	0	0
15	20709490	.	A	G	9	9	18	0	1	19	0	0
15	20709925	.	G	A	12	6	18	0	2	20	0	0
15	20731260	.	G	C	9	9	18	0	0	18	0	0
15	20832687	.	A	G	0	2	2	0	0	2	0	0
15	20832831	.	C	T	8	3	11	0	0	11	0	0
15	20833018	.	A	G	2	1	3	0	0	3	0	0
15	20875296	.	C	T	1	2	3	0	0	3	0	0
15	20891154	.	T	A	5	4	9	0	2	11	0	0
15	20893920	.	T	A	8	2	10	0	1	11	0	0
15	20894094	.	A	G	8	0	8	0	18	26	0	0
15	20894177	.	C	A	15	19	34	0	1	35	0	0
15	20901053	.	T	C	13	23	36	0	0	36	0	0
15	20901133	.	A	G	17	20	37	0	1	38	0	0
15	20901366	.	T	A	18	17	35	0	1	36	0	0
15	20901540	.	C	T	0	8	8	0	3	11	0	0
15	20901562	.	G	A	8	4	12	0	2	14	0	0
15	20907603	.	A	G	1	4	5	0	1	6	0	0
15	20941492	.	T	A	7	3	10	0	0	10	0	0
15	22047389	.	T	C	2	5	7	0	1	8	0	0
15	22143027	.	G	A	2	1	3	0	0	3	0	0
15	22147174	.	C	G	0	4	4	0	0	4	0	0
15	22147186	.	G	T	0	3	3	0	1	4	0	0
15	22324529	.	A	T	1	1	2	0	0	2	0	0
15	22324538	.	T	A	1	0	1	0	0	1	0	0
15	22324760	.	A	G	12	5	17	0	5	22	0	0
15	22324948	.	T	C	8	6	14	0	0	14	0	0
15	22325007	.	C	T	7	3	10	0	1	11	0	0
15	22325617	.	G	T	9	11	20	1	0	21	0	0
15	22325687	.	A	C	6	4	10	0	0	10	0	0
15	22325725	.	G	A	1	2	3	0	0	3	0	0
15	22441639	.	C	T	3	2	5	0	0	5	0	0
15	22441855	.	C	T	2	1	3	0	1	4	0	0
15	22441900	.	T	C	3	3	6	0	0	6	0	0
15	22441972	.	G	A	5	4	9	0	0	9	0	0
15	22442713	.	A	T	3	5	8	0	0	8	0	0
15	22442875	.	G	A	0	3	3	0	5	8	0	0
15	22443048	.	T	G	1	3	4	0	0	4	0	0
15	22443136	.	C	T	5	4	9	0	1	10	0	0
15	22443282	.	C	T	7	2	9	0	2	11	0	0
15	22443289	.	A	T	8	3	11	0	1	12	0	0
15	22443460	.	G	A	0	2	2	0	6	8	0	0
15	22443462	.	A	G	6	0	6	0	2	8	0	0
15	22443520	.	A	G	11	7	18	0	0	18	0	0
15	22443615	.	G	A	9	9	18	0	2	20	0	0
15	22443630	.	G	T	0	11	11	0	13	24	0	0
15	22443798	.	A	G	18	13	31	0	2	33	0	0
15	22443858	.	A	G	17	17	34	0	0	34	0	0
15	22443934	.	G	A	1	15	16	0	19	35	0	0
15	22444062	.	A	G	16	18	34	0	0	34	0	0
15	22444239	.	G	A	0	19	19	0	14	33	0	0
15	22444266	.	A	G	9	14	23	0	4	27	0	0
15	22444310	.	T	A	7	15	22	0	3	25	0	0
15	22444331	.	G	A	14	8	22	0	3	25	0	0
15	22444483	.	T	G	8	1	9	0	6	15	0	0
15	22444486	.	A	T	8	7	15	0	0	15	0	0
15	22444524	.	T	C	8	4	12	0	0	12	0	0
15	22500750	.	G	A	0	2	2	0	0	2	0	0
15	22516432	.	C	A	3	2	5	0	1	6	0	0
15	22524099	.	C	A	0	2	2	0	0	2	0	0
15	22526463	.	G	C	1	4	5	0	3	8	0	0
15	22533518	.	G	A	1	6	7	0	0	7	0	0
15	22536756	.	C	T	4	1	5	0	2	7	0	0
15	22536795	.	G	C	1	3	4	0	7	11	0	0
15	22536973	.	C	T	7	3	10	0	3	13	0	0
15	22537008	.	T	A	10	4	14	0	0	14	0	0
15	22999133	.	T	C	1	2	3	0	0	3	0	0
15	23181511	.	C	A	8	4	12	0	0	12	0	0
15	23187879	.	T	A	5	5	10	0	0	10	0	0
15	23187902	.	T	G	4	0	4	0	9	13	0	0
15	23188188	.	T	G	5	7	12	0	0	12	0	0
15	23188190	.	C	T	4	7	11	0	1	12	0	0
15	23188245	.	T	A	4	8	12	0	1	13	0	0
15	23256320	.	C	T	1	1	2	0	0	2	0	0
15	23256449	.	T	C	3	2	5	0	0	5	0	0
15	23256546	.	C	A	2	3	5	0	0	5	0	0
15	23256547	.	C	T	2	2	4	0	1	5	0	0
15	23264547	.	G	A	0	2	2	0	3	5	0	0
15	23264945	.	T	C	4	4	8	0	0	8	0	0
15	23265217	.	C	T	8	2	10	0	1	11	0	0
15	23272060	.	C	T	2	3	5	0	0	5	0	0
15	23357957	.	G	C	1	2	3	0	1	4	0	0
15	23386976	.	C	T	0	4	4	0	1	5	0	0
15	23387010	.	A	G	1	6	7	0	0	7	0	0
15	23387334	.	G	A	1	2	3	0	0	3	0	0
15	23387567	.	G	A	1	4	5	0	0	5	0	0
15	23387577	.	G	A	4	3	7	0	1	8	0	0
15	23423674	.	C	T	3	3	6	0	0	6	0	0
15	23426717	.	T	A	1	2	3	0	0	3	0	0
15	23451149	.	C	A	2	2	4	0	0	4	0	0
15	23468224	.	C	A	2	2	4	0	0	4	0	0
15	23468383	.	G	T	2	2	4	0	0	4	0	0
15	23468501	.	G	T	2	3	5	0	0	5	0	0
15	23468522	.	A	T	3	5	8	0	1	9	0	0
15	23512882	.	T	C	3	2	5	0	0	5	0	0
15	23528160	.	A	G	1	3	4	0	0	4	0	0
15	23528183	.	G	A	1	3	4	0	0	4	0	0
15	23531126	.	G	T	2	2	4	0	0	4	0	0
15	23531276	.	G	A	2	3	5	0	0	5	0	0
15	23532332	.	C	T	1	2	3	0	1	4	0	0
15	23532336	.	A	T	2	2	4	0	0	4	0	0
15	23540536	.	T	C	1	2	3	0	0	3	0	0
15	23541616	.	C	T	3	2	5	0	0	5	0	0
15	23541822	.	G	A	4	4	8	0	1	9	0	0
15	23551218	.	G	A	0	1	1	0	1	2	0	0
15	23551769	.	T	G	1	0	1	0	3	4	0	0
15	23551775	.	C	T	0	3	3	0	0	3	0	0
15	23617364	.	G	A	0	1	1	0	1	2	0	0
15	23617612	.	G	T	2	1	3	0	0	3	0	0
15	23619093	.	G	A	0	15	15	0	6	21	0	0
15	23620453	.	T	G	1	1	2	0	0	2	0	0
15	23620511	.	G	A	9	7	16	0	2	18	0	0
15	23620541	.	C	T	7	8	15	0	1	16	0	0
15	23627514	.	G	A	9	5	14	0	1	15	0	0
15	23640374	.	T	A	9	21	30	0	7	37	0	0
15	23640678	.	A	C	2	1	3	0	31	34	0	0
15	23640807	.	C	T	14	11	25	0	5	30	0	0
15	23641057	.	C	T	19	6	25	0	1	26	0	0
15	23641102	.	T	G	8	17	25	0	1	26	0	0
15	23641107	.	G	C	17	8	25	0	1	26	0	0
15	23641426	.	G	A	10	13	23	0	0	23	0	0
15	23645698	.	G	A	1	2	3	0	0	3	0	0
15	23686857	.	G	A	0	2	2	0	0	2	0	0
15	23709660	.	G	A	5	4	9	0	1	10	0	0
15	23710339	.	T	C	7	9	16	0	0	16	0	0
15	23710465	.	C	T	6	9	15	0	0	15	0	0
15	23710490	.	G	T	6	9	15	0	1	16	0	0
15	23710515	.	G	A	7	9	16	0	0	16	0	0
15	23710539	.	T	C	8	10	18	0	0	18	0	0
15	23710811	.	A	G	3	6	9	0	0	9	0	0
15	23712082	.	A	G	5	6	11	0	1	12	0	0
15	23713923	.	C	T	2	2	4	0	0	4	0	0
15	23730816	.	C	A	0	1	1	0	0	1	0	0
15	23733485	.	C	A	1	4	5	0	2	7	0	0
15	23738914	.	C	T	12	11	23	0	1	24	0	0
15	23738915	.	G	C	1	10	11	0	13	24	0	0
15	23739032	.	C	T	0	2	2	0	0	2	0	0
15	23745659	.	G	A	4	2	6	0	0	6	0	0
15	23745753	.	G	A	2	1	3	0	5	8	0	0
15	23746655	.	A	T	1	4	5	0	0	5	0	0
15	23746674	.	G	A	1	2	3	0	0	3	0	0
15	23780791	.	A	T	2	4	6	0	0	6	0	0
15	23781320	.	G	A	0	2	2	0	0	2	0	0
15	23783669	.	C	T	0	2	2	0	0	2	0	0
15	23784896	.	C	T	0	0	0	0	1	1	0	0
15	23788266	.	G	A	4	5	9	0	0	9	0	0
15	23793206	.	C	T	1	6	7	0	1	8	0	0
15	23817403	.	T	A	15	10	25	0	0	25	0	0
15	23817517	.	G	A	9	9	18	0	4	22	0	0
15	23817901	.	C	T	0	12	12	0	12	24	0	0
15	23818313	.	T	A	8	3	11	0	1	12	0	0
15	23818422	.	T	C	7	3	10	0	0	10	0	0
15	23818460	.	T	C	5	10	15	0	0	15	0	0
15	23818765	.	G	A	3	5	8	0	0	8	0	0
15	23819248	.	T	A	5	4	9	0	1	10	0	0
15	23819253	.	C	T	5	6	11	0	0	11	0	0
15	23819423	.	G	A	3	6	9	0	1	10	0	0
15	23823508	.	C	T	5	7	12	0	0	12	0	0
15	23830658	.	G	A	1	2	3	0	0	3	0	0
15	23918333	.	G	C	5	2	7	0	0	7	0	0
15	23918365	.	C	T	2	2	4	0	0	4	0	0
15	23922714	.	G	A	8	7	15	0	3	18	0	0
15	23922994	.	G	T	9	10	19	0	1	20	0	0
15	23923261	.	T	G	5	4	9	0	0	9	0	0
15	23925372	.	G	C	1	2	3	0	0	3	0	0
15	23927992	.	G	T	11	5	16	0	1	17	0	0
15	23931187	.	A	G	2	4	6	0	0	6	0	0
15	23931454	.	A	G	3	2	5	0	0	5	0	0
15	23942804	.	T	G	3	9	12	0	0	12	0	0
15	24084737	.	T	A	3	2	5	0	1	6	0	0
15	24084773	.	C	T	2	4	6	0	1	7	0	0
15	24094697	.	T	C	3	3	6	0	0	6	0	0
15	24096474	.	G	A	3	2	5	0	1	6	0	0
15	24096657	.	C	A	4	4	8	0	0	8	0	0
15	24104648	.	C	T	3	4	7	0	1	8	0	0
15	24106821	.	C	T	6	5	11	0	2	13	0	0
15	24119372	.	A	G	3	5	8	0	0	8	0	0
15	24119391	.	C	T	2	7	9	0	1	10	0	0
15	24119571	.	T	C	6	9	15	0	1	16	0	0
15	24119720	.	G	A	0	4	4	0	9	13	0	0
15	24120490	.	G	A	0	2	2	0	4	6	0	0
15	24120588	.	C	T	5	8	13	0	0	13	0	0
15	24530477	.	G	A	0	3	3	0	2	5	0	0
15	24535495	.	C	T	1	1	2	0	1	3	0	0
15	24543991	.	C	T	1	1	2	0	0	2	0	0
15	24544305	.	T	A	2	3	5	0	0	5	0	0
15	24544325	.	G	A	1	6	7	0	0	7	0	0
15	24544653	.	A	T	2	1	3	0	1	4	0	0
15	24544657	.	A	G	2	0	2	0	2	4	0	0
15	24554786	.	C	A	2	2	4	0	0	4	0	0
15	24557185	.	C	T	3	2	5	0	0	5	0	0
15	24557432	.	A	G	2	4	6	0	0	6	0	0
15	24557540	.	G	A	5	4	9	0	1	10	0	0
15	24557810	.	A	C	3	2	5	0	3	8	0	0
15	24561055	.	T	C	1	2	3	0	0	3	0	0
15	24561414	.	G	A	2	2	4	0	0	4	0	0
15	24561501	.	C	T	11	5	16	0	1	17	0	0
15	24562188	.	A	G	4	3	7	0	2	9	0	0
15	24565265	.	T	A	1	2	3	0	1	4	0	0
15	24568588	.	T	C	0	1	1	0	0	1	0	0
15	24583933	.	C	G	7	2	9	0	1	10	0	0
15	24673385	.	T	C	1	4	5	0	0	5	0	0
15	24673723	.	T	A	14	10	24	0	1	25	0	0
15	24673997	.	A	G	3	3	6	0	1	7	0	0
15	24676950	.	A	T	1	2	3	0	0	3	0	0
15	24676983	.	T	A	1	3	4	0	0	4	0	0
15	24677001	.	C	A	1	3	4	0	0	4	0	0
15	24679744	.	T	C	1	0	1	0	1	2	0	0
15	24679944	.	T	C	0	1	1	0	0	1	0	0
15	24683236	.	A	G	3	4	7	0	0	7	0	0
15	24686282	.	C	T	5	8	13	0	0	13	0	0
15	24686450	.	G	A	0	2	2	0	0	2	0	0
15	24689592	.	G	A	0	17	17	0	14	31	0	0
15	24689701	.	G	A	2	12	14	0	9	23	0	0
15	24689948	.	T	C	7	9	16	0	0	16	0	0
15	24691551	.	A	G	1	0	1	0	3	4	0	0
15	24733569	.	G	A	2	2	4	0	1	5	0	0
15	24733689	.	G	A	4	5	9	0	1	10	0	0
15	24733791	.	T	G	4	7	11	0	1	12	0	0
15	24733932	.	T	C	2	5	7	0	0	7	0	0
15	24735111	.	G	T	11	6	17	0	2	19	0	0
15	24735163	.	C	G	9	3	12	0	0	12	0	0
15	24735341	.	C	T	7	13	20	0	1	21	0	0
15	24735472	.	T	C	3	2	5	0	0	5	0	0
15	24735677	.	G	T	15	8	23	0	0	23	0	0
15	24736244	.	A	T	2	1	3	0	0	3	0	0
15	24736362	.	G	C	5	4	9	0	0	9	0	0
15	24736413	.	A	G	11	3	14	0	4	18	0	0
15	24736446	.	C	A	4	9	13	0	2	15	0	0
15	24736525	.	A	G	7	4	11	0	0	11	0	0
15	24736814	.	C	A	2	2	4	0	0	4	0	0
15	24737745	.	A	G	2	4	6	0	1	7	0	0
15	24742930	.	G	A	0	6	6	0	17	23	0	0
15	24743843	.	G	A	4	7	11	0	0	11	0	0
15	24744691	.	G	C	15	18	33	0	1	34	0	0
15	24744724	.	A	T	15	10	25	0	4	29	0	0
15	24749895	.	G	A	0	15	15	0	18	33	0	0
15	24751322	.	C	T	10	10	20	0	0	20	0	0
15	24754361	.	A	T	6	4	10	0	1	11	0	0
15	24754524	.	G	A	14	19	33	0	0	33	0	0
15	24791630	.	G	T	1	2	3	0	1	4	0	0
15	24791806	.	G	C	2	3	5	0	1	6	0	0
15	24792183	.	G	A	4	2	6	0	1	7	0	0
15	24792418	.	C	T	1	2	3	0	1	4	0	0
15	24792604	.	T	C	2	5	7	0	0	7	0	0
15	24793432	.	A	G	3	4	7	0	0	7	0	0
15	24794104	.	C	T	7	4	11	0	2	13	0	0
15	24794441	.	T	A	6	7	13	0	0	13	0	0
15	24798529	.	G	A	1	2	3	0	0	3	0	0
15	24837105	.	G	A	0	7	7	0	15	22	0	0
15	24837402	.	C	T	7	6	13	0	0	13	0	0
15	24837474	.	A	G	11	7	18	0	0	18	0	0
15	24845205	.	G	A	9	8	17	0	3	20	0	0
15	24845500	.	G	T	4	5	9	0	0	9	0	0
15	24846186	.	T	C	5	7	12	0	1	13	0	0
15	24846311	.	T	A	1	4	5	0	0	5	0	0
15	24846594	.	T	C	2	0	2	0	5	7	0	0
15	24946564	.	C	G	0	2	2	0	1	3	0	0
15	24946864	.	A	G	2	5	7	0	0	7	0	0
15	24946887	.	C	T	1	2	3	0	1	4	0	0
15	24950967	.	C	T	0	2	2	0	2	4	0	0
15	25085266	.	G	C	1	2	3	0	1	4	0	0
15	25096386	.	G	T	2	3	5	0	0	5	0	0
15	25097290	.	C	T	2	1	3	0	1	4	0	0
15	25101042	.	C	T	8	8	16	0	0	16	0	0
15	25101083	.	A	G	6	7	13	0	0	13	0	0
15	25101085	.	T	G	4	7	11	0	2	13	0	0
15	25101260	.	T	C	4	7	11	0	0	11	0	0
15	25101267	.	A	G	5	8	13	0	0	13	0	0
15	25101302	.	G	A	3	11	14	0	3	17	0	0
15	25101538	.	G	A	3	11	14	0	0	14	0	0
15	25101619	.	A	G	7	10	17	0	1	18	0	0
15	25101740	.	C	A	10	17	27	0	1	28	0	0
15	25101990	.	A	G	14	11	25	0	1	26	0	0
15	25127854	.	A	G	0	1	1	0	1	2	0	0
15	25173015	.	C	T	1	7	8	0	4	12	0	0
15	25173157	.	A	G	6	8	14	0	0	14	0	0
15	25173188	.	A	T	9	10	19	0	1	20	0	0
15	25173494	.	A	C	8	12	20	0	0	20	0	0
15	25173759	.	T	C	6	5	11	0	1	12	0	0
15	25173898	.	G	A	2	3	5	0	0	5	0	0
15	25173920	.	G	A	2	3	5	0	0	5	0	0
15	25174048	.	C	A	0	7	7	0	3	10	0	0
15	25175621	.	A	G	3	2	5	0	1	6	0	0
15	25176075	.	C	T	1	3	4	0	1	5	0	0
15	25214272	.	T	C	2	2	4	0	1	5	0	0
15	25214384	.	A	G	6	7	13	0	1	14	0	0
15	25229156	.	A	G	0	3	3	0	0	3	0	0
15	25243412	.	C	T	3	1	4	0	2	6	0	0
15	25267804	.	G	A	0	1	1	0	1	2	0	0
15	25273187	.	C	T	11	13	24	0	0	24	0	0
15	25274918	.	T	G	7	11	18	0	0	18	0	0
15	25278986	.	A	G	12	9	21	0	0	21	0	0
15	25281387	.	G	A	3	5	8	0	1	9	0	0
15	25321973	.	G	A	3	3	6	0	2	8	0	0
15	25321982	.	A	C	2	5	7	0	2	9	0	0
15	25322410	.	C	A	0	9	9	0	8	17	0	0
15	25322607	.	T	G	13	7	20	0	5	25	0	0
15	25322783	.	G	A	9	9	18	0	1	19	0	0
15	25322853	.	C	T	5	10	15	0	2	17	0	0
15	25323064	.	G	C	9	5	14	0	2	16	0	0
15	25333922	.	C	T	0	2	2	0	1	3	0	0
15	25344998	.	G	A	2	4	6	0	1	7	0	0
15	25349844	.	C	T	0	2	2	0	0	2	0	0
15	25377137	.	C	T	0	2	2	0	2	4	0	0
15	25377155	.	C	T	0	3	3	0	2	5	0	0
15	25388120	.	C	T	1	2	3	0	1	4	0	0
15	25398406	.	A	C	1	2	3	0	1	4	0	0
15	25485278	.	A	G	3	3	6	0	0	6	0	0
15	25485802	.	A	G	4	3	7	0	0	7	0	0
15	25498515	.	G	T	0	1	1	0	0	1	0	0
15	25498645	.	G	C	0	7	7	0	5	12	0	0
15	25498718	.	C	A	8	7	15	0	0	15	0	0
15	25498946	.	C	T	4	4	8	0	0	8	0	0
15	25499171	.	A	G	3	2	5	0	1	6	0	0
15	25504064	.	A	G	3	4	7	0	2	9	0	0
15	25504397	.	A	C	6	0	6	0	7	13	0	0
15	25504399	.	T	A	7	6	13	0	0	13	0	0
15	25504902	.	C	G	0	2	2	0	1	3	0	0
15	25507942	.	A	T	5	3	8	0	0	8	0	0
15	25508539	.	T	G	4	2	6	0	1	7	0	0
15	25508852	.	T	G	1	0	1	0	0	1	0	0
15	25509414	.	C	A	0	2	2	0	2	4	0	0
15	25509498	.	G	A	1	1	2	0	0	2	0	0
15	25509500	.	C	T	0	1	1	0	1	2	0	0
15	25515702	.	G	A	1	1	2	0	0	2	0	0
15	25538178	.	A	G	9	6	15	0	3	18	0	0
15	25538381	.	T	C	10	7	17	0	1	18	0	0
15	25538793	.	G	A	0	3	3	0	3	6	0	0
15	25588805	.	A	G	22	14	36	0	1	37	0	0
15	25588836	.	A	C	24	20	44	0	2	46	0	0
15	25588840	.	T	C	24	0	24	0	23	48	1	0
15	25589119	.	G	T	9	6	15	0	1	16	0	0
15	25589197	.	T	A	27	12	39	0	1	40	0	0
15	25589280	.	G	T	13	15	28	0	1	29	0	0
15	25589321	.	A	G	15	6	21	0	3	24	0	0
15	25589438	.	C	G	14	10	24	0	2	26	0	0
15	25589582	.	G	C	9	10	19	0	1	20	0	0
15	25589624	.	C	T	6	12	18	0	1	19	0	0
15	25589640	.	T	C	5	11	16	0	1	17	0	0
15	25589708	.	A	G	17	12	29	0	0	29	0	0
15	25589812	.	A	T	9	13	22	0	1	23	0	0
15	25589838	.	A	G	14	8	22	0	1	23	0	0
15	25589979	.	T	A	7	9	16	0	0	16	0	0
15	25589983	.	C	T	7	9	16	0	0	16	0	0
15	25590022	.	A	G	8	7	15	0	1	16	0	0
15	25590129	.	A	G	9	12	21	0	1	22	0	0
15	25590155	.	T	C	7	14	21	0	1	22	0	0
15	25590235	.	A	G	5	4	9	0	3	12	0	0
15	25590240	.	A	G	8	1	9	0	1	10	0	0
15	25590297	.	A	G	5	6	11	1	2	14	0	0
15	25590394	.	T	A	7	9	16	0	1	17	0	0
15	25590474	.	G	A	7	10	17	0	1	18	0	0
15	25590585	.	G	T	10	5	15	0	0	15	0	0
15	25590820	.	A	G	3	4	7	0	2	9	0	0
15	25591541	.	A	T	14	8	22	0	1	23	0	0
15	25591553	.	A	C	14	10	24	0	1	25	0	0
15	25591807	.	C	G	2	6	8	0	0	8	0	0
15	25591820	.	A	T	1	3	4	0	0	4	0	0
15	25593257	.	C	T	1	3	4	0	0	4	0	0
15	25594214	.	A	C	2	2	4	0	1	5	0	0
15	25595187	.	T	C	1	2	3	0	0	3	0	0
15	25598963	.	G	A	1	2	3	0	1	4	0	0
15	25640891	.	C	T	2	2	4	0	0	4	0	0
15	25640892	.	T	G	2	2	4	0	0	4	0	0
15	25641002	.	C	G	3	3	6	0	0	6	0	0
15	25650100	.	T	G	0	1	1	0	1	2	0	0
15	25653349	.	A	G	0	1	1	0	0	1	0	0
15	25656103	.	C	T	8	7	15	0	0	15	0	0
15	25656175	.	A	G	4	4	8	0	1	9	0	0
15	25910655	.	A	C	1	3	4	0	0	4	0	0
15	26399801	.	T	C	1	3	4	0	0	4	0	0
15	26400297	.	G	C	7	2	9	0	0	9	0	0
15	26400300	.	A	C	5	2	7	0	2	9	0	0
15	26400743	.	T	G	4	5	9	0	1	10	0	0
15	26400766	.	A	G	4	7	11	0	1	13	1	0
15	26400819	.	A	G	2	5	7	0	1	8	0	0
15	26400836	.	G	A	2	5	7	0	1	8	0	0
15	26400876	.	G	A	4	5	9	0	0	9	0	0
15	26400900	.	C	T	4	3	7	0	1	8	0	0
15	26400924	.	A	T	5	2	7	0	2	9	0	0
15	26401101	.	A	G	6	6	12	0	0	12	0	0
15	26401194	.	T	G	6	4	10	0	1	11	0	0
15	26401200	.	C	T	5	5	10	0	1	11	0	0
15	26401259	.	A	C	8	1	9	0	3	12	0	0
15	26401623	.	A	T	5	8	13	0	0	13	0	0
15	26401779	.	A	G	9	9	18	0	0	18	0	0
15	26401888	.	G	C	0	4	4	0	1	5	0	0
15	26402167	.	G	A	13	6	19	0	1	20	0	0
15	26498400	.	T	G	1	6	7	0	0	7	0	0
15	26498455	.	A	T	5	10	15	0	0	16	1	0
15	26498615	.	C	T	6	13	19	0	3	22	0	0
15	26498621	.	C	A	9	13	22	0	3	25	0	0
15	26498716	.	A	G	13	14	27	0	2	29	0	0
15	26498749	.	A	T	11	16	27	0	4	31	0	0
15	26498820	.	T	G	7	13	20	0	1	21	0	0
15	26505495	.	C	A	4	2	6	0	1	7	0	0
15	26515021	.	C	T	0	5	5	0	3	8	0	0
15	26538874	.	A	G	1	2	3	0	0	3	0	0
15	26538885	.	G	A	1	3	4	0	0	4	0	0
15	26553093	.	A	T	6	9	15	0	1	16	0	0
15	26553095	.	T	C	6	9	15	0	1	16	0	0
15	26554008	.	G	A	0	4	4	0	0	5	1	0
15	26554014	.	A	T	1	4	5	0	0	5	0	0
15	26554686	.	G	A	3	4	7	0	1	8	0	0
15	26561058	.	A	C	1	1	2	0	0	2	0	0
15	26561347	.	G	A	2	2	4	0	0	4	0	0
15	26561526	.	C	T	0	2	2	0	3	5	0	0
15	26678917	.	C	A	0	4	4	0	6	10	0	0
15	26678932	.	T	A	4	4	8	0	0	8	0	0
15	26679070	.	T	A	3	2	5	0	0	5	0	0
15	26679908	.	C	T	0	4	4	0	4	8	0	0
15	26683504	.	A	G	2	2	4	0	0	4	0	0
15	26683758	.	G	A	3	8	11	0	2	13	0	0
15	26683764	.	G	A	8	4	12	0	1	13	0	0
15	26686828	.	A	T	0	0	0	0	1	10	9	0
15	26707518	.	G	A	1	2	3	0	0	3	0	0
15	26729480	.	G	A	1	1	2	0	0	2	0	0
15	26849054	.	T	A	1	1	2	0	1	3	0	0
15	26849351	.	A	G	1	3	4	0	0	4	0	0
15	26873946	.	G	A	1	2	3	0	0	3	0	0
15	26904430	.	A	G	8	7	15	0	0	15	0	0
15	26904779	.	G	A	6	3	9	0	1	10	0	0
15	26904838	.	A	G	4	3	7	0	1	8	0	0
15	26904942	.	C	A	0	6	6	0	4	10	0	0
15	26904989	.	C	A	2	3	5	0	0	5	0	0
15	26905002	.	C	T	2	3	5	0	1	6	0	0
15	26915384	.	T	A	12	7	19	0	0	19	0	0
15	26915531	.	A	G	7	8	15	0	0	15	0	0
15	26915568	.	G	A	6	7	13	0	1	14	0	0
15	26915633	.	C	T	3	6	9	0	0	9	0	0
15	26915651	.	T	C	0	2	2	0	0	2	0	0
15	26919255	.	T	C	4	2	6	0	1	7	0	0
15	26924056	.	T	C	5	6	11	0	0	11	0	0
15	26924080	.	C	G	0	1	1	0	4	5	0	0
15	26926474	.	G	A	1	3	4	0	0	4	0	0
15	26935032	.	A	T	5	6	11	0	0	11	0	0
15	26935696	.	G	A	0	1	1	0	0	1	0	0
15	26938324	.	A	C	5	1	6	0	0	6	0	0
15	26939031	.	C	A	5	7	12	0	0	12	0	0
15	26939224	.	G	T	11	5	16	0	0	16	0	0
15	26939233	.	A	C	6	9	15	0	1	16	0	0
15	26939279	.	G	A	0	6	6	0	6	12	0	0
15	26939362	.	A	G	0	2	2	0	0	2	0	0
15	26939363	.	T	A	0	2	2	0	0	2	0	0
15	27071096	.	C	G	2	0	2	0	0	2	0	0
15	27071099	.	A	G	2	0	2	0	0	2	0	0
15	27071792	.	T	G	3	2	5	0	0	5	0	0
15	27071849	.	G	A	2	1	3	0	0	3	0	0
15	27087813	.	C	T	0	3	3	0	2	5	0	0
15	27352608	.	G	A	6	3	9	0	0	9	0	0
15	27353481	.	G	A	3	7	10	0	0	10	0	0
15	27354412	.	T	A	16	19	35	0	2	37	0	0
15	27371021	.	T	A	2	2	4	0	0	4	0	0
15	27452813	.	A	C	2	2	4	0	1	5	0	0
15	27703845	.	A	G	18	11	29	0	2	31	0	0
15	27704220	.	C	A	0	11	11	0	14	25	0	0
15	27710392	.	A	G	1	2	3	0	0	3	0	0
15	27710396	.	C	T	2	2	4	0	0	4	0	0
15	28085422	.	G	A	1	2	3	0	0	3	0	0
15	28124913	.	T	C	1	3	4	0	0	4	0	0
15	28125186	.	A	G	3	5	8	0	0	8	0	0
15	28189029	.	T	A	4	4	8	0	1	9	0	0
15	28189046	.	T	G	6	6	12	0	0	12	0	0
15	28189409	.	A	C	4	2	6	0	0	6	0	0
15	28189589	.	T	C	3	1	4	0	8	12	0	0
15	28189591	.	T	C	3	9	12	0	0	12	0	0
15	28189945	.	T	G	1	2	3	0	2	5	0	0
15	28192706	.	A	G	3	6	9	0	1	10	0	0
15	28194669	.	T	C	1	1	2	0	1	3	0	0
15	28194708	.	A	G	2	5	7	0	0	7	0	0
15	28199431	.	A	G	0	1	1	0	1	2	0	0
15	28230658	.	A	G	0	1	1	0	2	3	0	0
15	28249301	.	G	T	6	3	9	0	1	10	0	0
15	28251094	.	T	A	1	2	3	0	0	3	0	0
15	28252597	.	T	C	4	4	8	0	1	9	0	0
15	28252599	.	A	G	6	3	9	0	0	9	0	0
15	28253522	.	C	T	1	5	6	0	0	6	0	0
15	28254184	.	T	C	0	1	1	0	0	1	0	0
15	28254202	.	G	T	1	3	4	0	0	4	0	0
15	28257277	.	A	G	0	0	0	0	1	1	0	0
15	28343667	.	C	T	1	1	2	0	0	2	0	0
15	28350999	.	T	G	5	3	8	0	0	8	0	0
15	28351089	.	C	G	3	3	6	0	1	7	0	0
15	28351375	.	A	T	1	2	3	0	0	3	0	0
15	28351381	.	G	C	1	2	3	0	0	3	0	0
15	28352138	.	T	C	15	4	19	0	2	21	0	0
15	28352168	.	C	A	15	5	20	0	0	20	0	0
15	28431708	.	A	G	3	2	5	0	0	5	0	0
15	28432697	.	C	A	9	13	22	0	1	23	0	0
15	28432739	.	C	T	7	7	14	0	1	15	0	0
15	28432741	.	A	T	8	7	15	0	0	15	0	0
15	28432871	.	T	C	11	5	16	0	2	18	0	0
15	28432993	.	C	T	0	11	11	0	12	23	0	0
15	28433073	.	A	G	9	5	14	0	1	15	0	0
15	28433102	.	C	A	3	6	9	0	0	9	0	0
15	28433126	.	G	T	4	4	8	0	1	9	0	0
15	28433161	.	T	C	7	3	10	0	0	10	0	0
15	28433282	.	G	A	14	8	22	0	1	23	0	0
15	28433947	.	A	G	7	10	17	0	1	18	0	0
15	28437178	.	G	T	3	1	4	0	1	5	0	0
15	28439441	.	G	A	2	1	3	0	0	3	0	0
15	28443402	.	T	G	1	2	3	0	0	3	0	0
15	28446791	.	A	T	2	3	5	0	0	5	0	0
15	28453102	.	C	T	0	0	0	0	1	1	0	0
15	28463609	.	C	T	0	1	1	0	1	2	0	0
15	28483230	.	C	T	1	2	3	0	0	3	0	0
15	28483333	.	A	C	0	2	2	0	0	2	0	0
15	28526386	.	A	T	3	0	3	0	0	3	0	0
15	28537852	.	T	C	4	4	8	0	0	8	0	0
15	28537872	.	G	A	0	4	4	0	4	8	0	0
15	28538012	.	G	A	0	3	3	0	5	8	0	0
15	28538173	.	G	A	2	3	5	0	0	5	0	0
15	28538199	.	T	C	2	4	6	0	0	6	0	0
15	28538239	.	G	T	7	2	9	0	0	9	0	0
15	28538405	.	T	C	9	4	13	0	0	13	0	0
15	28538602	.	A	T	2	1	3	0	0	3	0	0
15	28538605	.	G	A	0	2	2	0	2	4	0	0
15	28538667	.	A	G	4	3	7	0	1	8	0	0
15	28538761	.	A	G	8	5	13	0	0	13	0	0
15	28538765	.	C	T	8	5	13	0	0	13	0	0
15	28539022	.	C	A	2	6	8	0	1	9	0	0
15	28539112	.	C	T	5	5	10	0	0	10	0	0
15	28539160	.	T	C	3	3	6	0	1	7	0	0
15	28539232	.	C	T	4	3	7	0	0	7	0	0
15	28539381	.	A	T	3	7	10	0	0	10	0	0
15	28539383	.	A	T	3	6	9	0	1	10	0	0
15	28539523	.	T	C	4	2	6	0	0	6	0	0
15	28539556	.	G	A	6	4	10	0	0	10	0	0
15	28539607	.	A	G	4	5	9	0	2	11	0	0
15	28549003	.	G	A	10	3	13	0	1	14	0	0
15	28549347	.	G	T	7	7	14	0	0	14	0	0
15	28549348	.	T	A	7	6	13	0	0	14	1	0
15	28549392	.	A	C	7	5	12	0	0	12	0	0
15	28549665	.	T	C	1	0	1	0	6	7	0	0
15	28550088	.	A	G	4	4	8	0	0	8	0	0
15	28550841	.	T	G	4	2	6	0	0	6	0	0
15	28551422	.	A	T	1	2	3	0	0	3	0	0
15	28551430	.	T	A	1	1	2	0	1	3	0	0
15	28551498	.	A	G	1	5	6	0	0	6	0	0
15	28634719	.	G	A	16	11	27	0	2	29	0	0
15	28646696	.	T	C	1	0	1	0	1	2	0	0
15	28672508	.	T	G	0	1	1	0	0	1	0	0
15	28677558	.	T	A	1	1	2	0	0	2	0	0
15	28686433	.	A	T	3	5	8	0	0	8	0	0
15	28758907	.	G	C	0	3	3	0	5	8	0	0
15	28758988	.	C	T	2	6	8	0	0	8	0	0
15	28760090	.	T	C	7	9	16	0	0	16	0	0
15	28760675	.	A	T	3	4	7	0	1	8	0	0
15	28761031	.	T	C	4	4	8	0	1	9	0	0
15	28761173	.	T	C	7	8	15	0	0	15	0	0
15	28761284	.	T	A	6	11	17	0	1	18	0	0
15	28762440	.	C	T	8	15	23	0	1	24	0	0
15	28763124	.	T	C	12	10	22	0	1	23	0	0
15	28763134	.	T	C	12	9	21	0	2	23	0	0
15	28763677	.	C	A	15	11	26	0	2	28	0	0
15	28763770	.	T	C	14	18	32	0	1	33	0	0
15	28763927	.	G	A	1	20	21	0	20	41	0	0
15	28763986	.	G	A	0	17	17	0	18	35	0	0
15	28764206	.	G	T	0	14	14	0	12	26	0	0
15	28764252	.	A	G	17	1	18	0	25	43	0	0
15	28766069	.	A	G	5	3	8	0	1	9	0	0
15	28787262	.	T	A	2	4	6	0	0	6	0	0
15	28881717	.	G	A	6	3	9	0	0	9	0	0
15	28882675	.	T	A	4	7	11	0	0	11	0	0
15	28882687	.	A	G	3	6	9	0	0	9	0	0
15	28973434	.	C	A	3	2	5	0	0	5	0	0
15	29000989	.	C	T	5	8	13	0	1	14	0	0
15	29001556	.	C	T	9	9	18	0	2	20	0	0
15	29001583	.	T	C	8	7	15	0	1	16	0	0
15	29004485	.	A	G	0	1	1	0	0	1	0	0
15	29005346	.	T	A	3	6	9	0	0	9	0	0
15	29005363	.	A	C	2	4	6	0	0	6	0	0
15	29005564	.	T	G	8	7	15	0	0	15	0	0
15	29005600	.	A	C	7	14	21	0	1	22	0	0
15	29005862	.	T	A	9	9	18	0	5	23	0	0
15	29005869	.	A	T	12	13	25	0	0	25	0	0
15	29005935	.	C	T	17	10	27	0	2	29	0	0
15	29005984	.	C	T	13	12	25	0	1	26	0	0
15	29005996	.	C	A	12	11	23	0	2	25	0	0
15	29006097	.	C	T	12	13	25	0	1	26	0	0
15	29006142	.	G	A	0	14	14	0	17	31	0	0
15	29089143	.	T	A	15	10	25	0	1	26	0	0
15	29089279	.	C	A	12	14	26	0	3	29	0	0
15	29089317	.	A	G	12	16	28	0	4	32	0	0
15	29089392	.	A	G	14	10	24	0	3	27	0	0
15	29089524	.	T	C	20	13	33	0	2	35	0	0
15	29089788	.	G	A	17	19	36	0	2	38	0	0
15	29089827	.	G	T	0	18	18	0	22	40	0	0
15	29089870	.	C	T	19	30	49	0	5	54	0	0
15	29090181	.	A	G	13	31	44	0	7	51	0	0
15	29091565	.	G	A	24	18	42	0	6	48	0	0
15	29092871	.	C	T	2	5	7	0	1	8	0	0
15	29093073	.	C	A	2	6	8	0	0	8	0	0
15	29097468	.	T	C	0	0	0	0	1	1	0	0
15	29097640	.	A	G	3	10	13	0	2	15	0	0
15	29100574	.	T	G	5	1	6	0	1	7	0	0
15	29100623	.	G	A	2	1	3	0	0	3	0	0
15	29100934	.	C	G	0	1	1	0	0	1	0	0
15	29104050	.	G	A	2	2	4	0	0	4	0	0
15	29108812	.	T	C	3	6	9	0	0	9	0	0
15	29108872	.	A	G	1	3	4	0	0	4	0	0
15	29108896	.	A	G	0	1	1	0	0	1	0	0
15	29116177	.	T	C	3	3	6	0	0	6	0	0
15	29116264	.	A	G	6	3	9	0	1	10	0	0
15	29119813	.	A	C	2	2	4	0	0	4	0	0
15	29119829	.	A	C	1	2	3	0	1	4	0	0
15	29122072	.	T	A	5	8	13	0	0	13	0	0
15	29123085	.	G	T	1	1	2	0	1	3	0	0
15	29130553	.	A	T	1	2	3	0	0	3	0	0
15	29130560	.	A	T	1	2	3	0	0	3	0	0
15	29136127	.	A	T	1	1	2	0	0	2	0	0
15	29152041	.	G	T	7	8	15	0	0	15	0	0
15	29456410	.	C	T	1	0	1	0	0	1	0	0
15	29459013	.	A	G	1	2	3	0	0	3	0	0
15	29459046	.	G	A	2	4	6	0	0	6	0	0
15	29465874	.	T	C	2	5	7	0	1	8	0	0
15	29467216	.	T	A	9	9	18	0	1	19	0	0
15	29467254	.	A	G	6	1	7	0	7	14	0	0
15	29467339	.	A	G	0	2	2	0	0	2	0	0
15	29469851	.	G	T	2	5	7	0	1	8	0	0
15	29481884	.	A	G	7	5	12	0	0	12	0	0
15	29481921	.	G	A	1	4	5	0	5	10	0	0
15	29482286	.	G	C	8	13	21	0	1	22	0	0
15	29482439	.	A	G	10	4	14	0	0	14	0	0
15	29483095	.	T	G	1	4	5	0	0	5	0	0
15	29483236	.	T	G	8	6	14	0	1	15	0	0
15	29483434	.	G	C	11	5	16	0	1	17	0	0
15	29483608	.	A	T	8	6	14	0	0	14	0	0
15	29483851	.	G	T	19	9	28	0	2	30	0	0
15	29549677	.	T	A	5	3	8	0	0	8	0	0
15	29549804	.	C	T	0	2	2	0	1	3	0	0
15	29555793	.	A	G	1	2	3	0	1	4	0	0
15	29712127	.	C	A	5	5	10	0	0	10	0	0
15	29712210	.	G	A	0	5	5	0	10	15	0	0
15	29712221	.	C	T	9	5	14	0	0	14	0	0
15	29712405	.	G	A	9	9	18	0	0	18	0	0
15	29775134	.	A	G	1	2	3	0	5	8	0	0
15	30127451	.	T	C	1	1	2	0	0	2	0	0
15	30130530	.	A	C	2	2	4	0	0	4	0	0
15	30130664	.	G	A	0	3	3	0	2	5	0	0
15	30131482	.	G	A	7	6	13	0	0	13	0	0
15	30131585	.	C	T	5	4	9	0	0	9	0	0
15	30131803	.	G	A	2	3	5	0	0	5	0	0
15	30134489	.	G	A	3	4	7	0	0	7	0	0
15	30134679	.	C	G	7	2	9	0	1	10	0	0
15	30134779	.	G	T	4	3	7	0	0	7	0	0
15	30135016	.	T	A	4	3	7	0	0	7	0	0
15	30135572	.	A	G	5	0	5	0	10	15	0	0
15	30135920	.	A	G	2	3	5	0	1	6	0	0
15	30135948	.	G	A	3	3	6	0	0	6	0	0
15	30136445	.	G	A	2	2	4	0	0	4	0	0
15	30136512	.	T	A	1	2	3	0	0	3	0	0
15	30136962	.	A	G	8	0	8	0	12	20	0	0
15	30137561	.	C	T	12	18	30	0	2	32	0	0
15	30158096	.	G	T	0	2	2	0	2	4	0	0
15	30252404	.	A	G	0	0	0	0	1	1	0	0
15	30252414	.	T	C	0	1	1	0	0	1	0	0
15	30265017	.	C	T	2	1	3	0	1	4	0	0
15	30301196	.	G	A	0	2	2	0	4	6	0	0
15	30301239	.	G	A	0	4	4	0	2	6	0	0
15	30301320	.	T	C	7	7	14	0	0	14	0	0
15	30301447	.	G	A	4	2	6	0	0	6	0	0
15	30311016	.	C	T	6	4	10	0	0	10	0	0
15	30311062	.	G	T	0	5	5	0	6	11	0	0
15	30311616	.	T	G	1	3	4	0	0	4	0	0
15	30350666	.	A	T	2	2	4	0	0	4	0	0
15	30354513	.	G	T	3	5	8	0	0	8	0	0
15	30354603	.	A	T	6	9	15	0	0	15	0	0
15	30424673	.	C	T	0	6	6	0	3	9	0	0
15	30425936	.	G	A	3	2	5	0	1	6	0	0
15	30838455	.	C	G	5	8	13	0	3	16	0	0
15	30838777	.	G	A	16	19	35	0	3	38	0	0
15	30838867	.	C	T	13	15	28	0	1	29	0	0
15	30838991	.	C	A	13	6	19	0	3	22	0	0
15	30839168	.	A	T	14	10	24	0	0	24	0	0
15	30853096	.	T	A	1	2	3	0	0	3	0	0
15	30861987	.	C	A	0	5	5	0	3	8	0	0
15	30862251	.	A	T	9	8	17	0	0	17	0	0
15	30862449	.	A	G	6	6	12	0	2	14	0	0
15	30862452	.	G	T	5	8	13	0	1	14	0	0
15	30862517	.	G	A	3	5	8	0	1	9	0	0
15	30862712	.	G	A	4	9	13	0	3	16	0	0
15	30862785	.	C	T	6	11	17	0	0	17	0	0
15	30862814	.	A	G	9	7	16	0	4	20	0	0
15	30862848	.	T	C	11	8	19	0	2	21	0	0
15	30862997	.	T	G	4	3	7	0	0	7	0	0
15	30863117	.	T	C	5	4	9	0	0	9	0	0
15	30863123	.	A	C	7	4	11	0	1	12	0	0
15	30863354	.	C	T	3	7	10	0	0	10	0	0
15	30863535	.	G	T	7	9	16	0	3	19	0	0
15	30863569	.	G	A	7	10	17	0	5	22	0	0
15	30863834	.	G	T	8	6	14	0	0	14	0	0
15	30863850	.	T	C	8	6	14	0	1	15	0	0
15	30864072	.	T	G	3	3	6	0	1	7	0	0
15	30864308	.	C	A	10	4	14	0	0	14	0	0
15	30864424	.	C	A	5	1	6	0	0	6	0	0
15	30864425	.	T	A	5	1	6	0	0	6	0	0
15	30874327	.	A	G	2	3	5	0	2	7	0	0
15	30874387	.	G	A	3	0	3	0	0	3	0	0
15	30907811	.	A	G	1	1	2	0	0	2	0	0
15	30907818	.	G	A	0	3	3	0	1	4	0	0
15	30909308	.	G	A	0	7	7	0	11	18	0	0
15	30909572	.	C	A	4	8	12	0	2	14	0	0
15	30909639	.	A	G	5	9	14	0	1	15	0	0
15	30909663	.	G	A	4	6	10	0	2	12	0	0
15	30909771	.	T	C	5	10	15	0	4	19	0	0
15	30909798	.	A	G	5	0	5	0	8	13	0	0
15	30909824	.	A	C	4	6	10	0	1	11	0	0
15	30909884	.	C	T	10	6	16	0	0	16	0	0
15	30917436	.	C	T	1	2	3	0	0	3	0	0
15	30917737	.	C	T	2	3	5	0	0	5	0	0
15	30917750	.	A	T	3	4	7	0	0	7	0	0
15	30919478	.	C	T	2	6	8	0	0	8	0	0
15	30919595	.	T	C	3	4	7	0	1	8	0	0
15	30919676	.	G	T	6	2	8	1	0	9	0	0
15	30919784	.	A	G	5	6	11	0	0	11	0	0
15	30920135	.	A	G	6	6	12	0	0	12	0	0
15	30920242	.	A	C	6	5	11	0	0	11	0	0
15	30920698	.	C	A	12	15	27	0	2	29	0	0
15	30920780	.	T	C	5	4	9	0	0	9	0	0
15	30920795	.	A	G	5	4	9	0	0	9	0	0
15	31073463	.	G	A	0	0	0	0	1	1	0	0
15	31162074	.	T	A	13	19	32	0	3	35	0	0
15	31162122	.	A	G	19	13	32	0	2	34	0	0
15	31162186	.	G	C	19	9	28	0	1	29	0	0
15	31162795	.	G	A	12	5	17	0	2	19	0	0
15	31162836	.	A	G	12	7	19	0	0	19	0	0
15	31163089	.	G	A	4	11	15	0	0	15	0	0
15	31163148	.	T	A	7	14	21	0	0	21	0	0
15	31163335	.	A	T	6	16	22	0	0	22	0	0
15	31163621	.	T	A	15	21	36	0	0	36	0	0
15	31166755	.	C	A	2	4	6	0	0	6	0	0
15	31166788	.	A	G	0	1	1	0	0	1	0	0
15	31173414	.	G	A	2	2	4	0	1	5	0	0
15	31177053	.	A	G	1	3	4	0	1	5	0	0
15	31177054	.	T	A	1	4	5	0	0	5	0	0
15	31177214	.	T	G	1	4	5	0	0	5	0	0
15	31213171	.	A	G	1	4	5	0	0	5	0	0
15	31213208	.	C	T	1	1	2	0	0	2	0	0
15	31237173	.	T	C	1	0	1	0	0	1	0	0
15	31237191	.	T	C	1	0	1	0	0	1	0	0
15	31244412	.	C	T	0	5	5	0	7	12	0	0
15	31513561	.	G	A	29	22	51	0	7	58	0	0
15	31513842	.	A	G	23	23	46	0	3	49	0	0
15	31513848	.	T	C	20	22	42	0	2	44	0	0
15	31513893	.	C	A	0	3	3	0	4	7	0	0
15	31514325	.	A	G	18	14	32	0	3	35	0	0
15	31516046	.	G	A	2	2	4	0	0	4	0	0
15	31564440	.	G	C	13	4	17	0	1	18	0	0
15	31564864	.	G	T	9	5	14	0	0	14	0	0
15	31564885	.	A	G	8	3	11	0	0	11	0	0
15	31564946	.	T	C	2	0	2	0	0	2	0	0
15	31568159	.	C	T	0	0	0	0	10	10	0	0
15	31700738	.	C	T	1	2	3	0	1	4	0	0
15	31706200	.	G	C	0	1	1	0	0	1	0	0
15	31732502	.	A	G	6	10	16	0	1	17	0	0
15	31881825	.	G	A	2	1	3	0	0	3	0	0
15	31881873	.	G	A	0	2	2	0	3	5	0	0
15	31890902	.	T	G	1	3	4	0	0	4	0	0
15	31893536	.	A	C	3	2	5	0	0	5	0	0
15	31893599	.	C	T	0	1	1	0	0	1	0	0
15	31905040	.	G	A	14	8	22	0	1	23	0	0
15	31905097	.	A	G	6	8	14	0	1	15	0	0
15	31909454	.	A	C	16	12	28	0	2	30	0	0
15	31909819	.	G	A	0	4	4	0	3	7	0	0
15	32195729	.	A	G	2	3	5	0	0	5	0	0
15	32249188	.	G	A	11	10	21	0	0	21	0	0
15	32259056	.	G	A	6	3	9	0	1	10	0	0
15	32261461	.	G	C	0	10	10	0	11	21	0	0
15	32261464	.	T	C	12	10	22	0	2	24	0	0
15	32265889	.	T	C	11	11	22	0	1	23	0	0
15	32266557	.	A	T	11	8	19	0	0	19	0	0
15	32266921	.	G	A	0	14	14	0	14	28	0	0
15	32267078	.	A	G	5	5	10	0	0	10	0	0
15	32267120	.	C	A	2	2	4	0	0	4	0	0
15	32349754	.	A	G	3	3	6	0	0	6	0	0
15	32349975	.	A	G	6	3	9	0	0	9	0	0
15	32349980	.	A	G	3	6	9	0	0	9	0	0
15	32350116	.	G	T	4	7	11	0	1	12	0	0
15	32350430	.	A	G	5	2	7	0	0	7	0	0
15	32350441	.	A	G	4	3	7	0	0	7	0	0
15	32350515	.	A	G	2	8	10	0	2	12	0	0
15	32350517	.	A	G	5	6	11	0	2	13	0	0
15	32351183	.	A	G	2	4	6	0	0	6	0	0
15	32351409	.	A	G	7	6	13	0	0	13	0	0
15	32351534	.	A	G	1	7	8	0	1	9	0	0
15	32887858	.	A	G	3	6	9	0	3	12	0	0
15	32889123	.	A	C	0	3	3	0	0	3	0	0
15	33696658	.	C	T	4	2	6	0	0	6	0	0
15	33853701	.	C	T	1	2	3	0	0	3	0	0
15	33864152	.	A	G	5	2	7	0	0	7	0	0
15	33864266	.	G	A	6	6	12	0	1	13	0	0
15	33864585	.	G	A	4	2	6	0	0	6	0	0
15	33864713	.	T	C	1	2	3	0	0	3	0	0
15	33891825	.	G	A	6	5	11	0	3	14	0	0
15	33891826	.	G	A	8	4	12	0	2	14	0	0
15	33891869	.	G	T	9	6	15	0	1	16	0	0
15	33896117	.	G	T	14	7	21	0	1	22	0	0
15	33896177	.	T	C	15	13	28	0	1	29	0	0
15	33896213	.	T	C	9	2	11	0	15	26	0	0
15	33896303	.	T	A	14	5	19	0	0	19	0	0
15	33896306	.	A	G	5	13	18	0	0	18	0	0
15	33896832	.	T	C	5	4	9	0	1	10	0	0
15	33899556	.	C	G	3	5	8	0	0	8	0	0
15	33899808	.	T	A	6	6	12	0	2	14	0	0
15	33910546	.	G	C	0	3	3	0	0	3	0	0
15	33970854	.	C	T	15	11	26	0	1	27	0	0
15	33970907	.	C	T	5	2	7	0	0	7	0	0
15	33971097	.	G	C	10	15	25	0	0	25	0	0
15	33977716	.	A	T	15	12	27	0	6	33	0	0
15	33977942	.	A	C	8	10	18	0	1	19	0	0
15	34074558	.	C	T	4	6	10	0	0	10	0	0
15	34074744	.	C	G	0	1	1	0	1	2	0	0
15	34074745	.	A	T	0	2	2	0	0	2	0	0
15	34174532	.	T	A	13	6	19	0	1	20	0	0
15	34174568	.	T	A	11	6	17	0	1	18	0	0
15	34174635	.	T	C	8	6	14	0	0	14	0	0
15	34174744	.	A	T	5	4	9	0	1	10	0	0
15	34175101	.	T	C	17	23	40	0	1	41	0	0
15	34175359	.	G	A	6	4	10	0	0	10	0	0
15	34175426	.	T	A	1	7	8	0	4	12	0	0
15	34175718	.	G	A	9	8	17	0	0	17	0	0
15	34175917	.	C	T	11	4	15	0	1	16	0	0
15	34175929	.	C	T	4	16	20	0	0	20	0	0
15	34176203	.	A	T	6	12	18	0	2	20	0	0
15	34176214	.	C	T	9	5	14	0	1	15	0	0
15	34176379	.	A	C	9	10	19	0	3	22	0	0
15	34176841	.	A	T	4	8	12	0	1	13	0	0
15	34176993	.	G	A	6	7	13	0	1	14	0	0
15	34186690	.	A	T	1	0	1	0	0	1	0	0
15	34189452	.	G	A	10	5	15	0	0	15	0	0
15	34223260	.	A	G	0	1	1	0	0	1	0	0
15	34534245	.	C	G	1	0	1	0	0	1	0	0
15	34558428	.	G	A	2	5	7	0	0	7	0	0
15	34573337	.	C	T	3	2	5	0	0	5	0	0
15	34573343	.	A	G	3	3	6	0	0	6	0	0
15	34573597	.	A	T	0	5	5	0	0	5	0	0
15	34573664	.	G	T	4	4	8	0	0	8	0	0
15	34574116	.	G	A	6	7	13	0	3	16	0	0
15	34577749	.	G	A	0	0	0	0	1	1	0	0
15	34586304	.	A	G	1	0	1	0	0	1	0	0
15	34618456	.	T	G	7	9	16	0	0	16	0	0
15	34618669	.	A	T	21	17	38	0	0	38	0	0
15	34618948	.	T	G	14	15	29	0	1	30	0	0
15	34618958	.	G	A	11	13	24	0	6	30	0	0
15	34621868	.	G	A	11	9	20	0	2	22	0	0
15	34621875	.	G	A	10	13	23	0	2	25	0	0
15	34627792	.	T	A	3	0	3	0	0	3	0	0
15	34627874	.	T	C	11	8	19	0	1	20	0	0
15	34635321	.	C	A	2	3	5	0	1	6	0	0
15	34635336	.	A	C	1	0	1	0	3	4	0	0
15	34637582	.	C	T	0	2	2	0	1	3	0	0
15	34641276	.	G	A	1	3	4	0	0	4	0	0
15	34641300	.	G	A	1	2	3	0	0	3	0	0
15	34641384	.	G	A	1	1	2	0	1	3	0	0
15	35091591	.	A	G	3	2	5	0	0	5	0	0
15	35092114	.	A	G	8	3	11	0	0	11	0	0
15	35115699	.	A	G	0	1	1	0	0	1	0	0
15	35157052	.	T	A	6	6	12	0	1	13	0	0
15	35157054	.	G	A	7	5	12	0	1	13	0	0
15	35158661	.	T	G	3	1	4	0	0	4	0	0
15	35163492	.	T	G	1	2	3	0	0	3	0	0
15	35163523	.	C	T	0	1	1	0	0	1	0	0
15	35212177	.	G	A	2	2	4	0	0	4	0	0
15	35214784	.	T	A	7	5	12	0	0	12	0	0
15	35214901	.	G	A	10	11	21	0	3	24	0	0
15	35217475	.	T	C	6	8	14	0	2	16	0	0
15	35217487	.	C	A	0	9	9	0	9	18	0	0
15	35221304	.	A	T	0	5	5	0	0	5	0	0
15	35224269	.	G	C	3	2	5	0	0	5	0	0
15	35227221	.	A	T	8	1	9	0	4	13	0	0
15	35247678	.	A	T	10	9	19	0	4	23	0	0
15	35247687	.	A	G	11	13	24	0	0	24	0	0
15	35247729	.	A	G	12	10	22	0	0	22	0	0
15	35247762	.	T	C	13	8	21	0	1	22	0	0
15	35737680	.	T	C	2	2	4	0	1	5	0	0
15	35761024	.	T	C	2	3	5	0	1	6	0	0
15	35761027	.	A	G	3	2	5	0	1	6	0	0
15	35761225	.	G	A	2	3	5	0	1	6	0	0
15	35889183	.	C	A	1	2	3	0	0	3	0	0
15	35889443	.	G	T	0	3	3	0	0	3	0	0
15	35889474	.	G	A	3	1	4	0	1	5	0	0
15	35889516	.	A	C	2	2	4	0	0	4	0	0
15	35889517	.	C	A	0	2	2	0	2	4	0	0
15	35889865	.	A	G	2	7	9	0	0	9	0	0
15	35890046	.	G	A	4	4	8	0	0	8	0	0
15	35891121	.	T	C	1	3	4	0	0	4	0	0
15	35891127	.	A	G	0	4	4	0	0	4	0	0
15	35891639	.	T	A	1	3	4	0	0	4	0	0
15	35944474	.	A	C	3	2	5	0	0	5	0	0
15	37227033	.	T	G	11	33	44	0	3	47	0	0
15	37227059	.	A	G	15	0	15	0	35	50	0	0
15	37227509	.	A	G	24	1	25	0	31	56	0	0
15	37227714	.	A	G	16	1	17	0	31	48	0	0
15	37227770	.	G	A	20	23	43	0	4	51	4	0
15	37228164	.	A	G	26	20	46	0	2	48	0	0
15	37228236	.	C	T	15	27	42	0	4	46	0	0
15	37228266	.	T	C	13	32	45	0	1	46	0	0
15	37228301	.	T	A	17	24	41	0	1	42	0	0
15	37228338	.	T	A	27	7	34	0	1	35	0	0
15	37228620	.	G	C	29	29	58	0	1	59	0	0
15	37228665	.	C	G	22	32	54	0	3	57	0	0
15	37228809	.	T	G	35	0	35	1	19	55	0	0
15	37228843	.	T	A	28	26	54	2	2	58	0	0
15	37228845	.	T	G	28	25	53	2	2	57	0	0
15	37229346	.	T	G	37	10	47	0	5	52	0	0
15	37229871	.	A	T	32	34	66	0	6	72	0	0
15	37229991	.	C	A	32	43	75	0	2	77	0	0
15	37230038	.	G	A	35	29	64	0	3	67	0	0
15	37230100	.	G	A	33	34	67	0	3	70	0	0
15	37459369	.	T	C	2	3	5	0	0	5	0	0
15	37459819	.	T	C	2	4	6	0	0	6	0	0
15	37460399	.	T	C	2	1	3	0	0	3	0	0
15	37460405	.	T	C	2	2	4	0	0	4	0	0
15	38296467	.	A	G	16	6	22	0	1	23	0	0
15	39208133	.	C	A	6	2	8	0	0	8	0	0
15	39208150	.	C	T	6	2	8	0	0	8	0	0
15	39208201	.	C	A	1	6	7	0	2	9	0	0
15	39208211	.	C	T	3	6	9	0	0	9	0	0
15	39208258	.	C	T	6	4	10	0	1	11	0	0
15	39228174	.	A	G	11	12	23	0	3	26	0	0
15	39278501	.	G	T	8	7	15	0	0	15	0	0
15	39281923	.	A	G	8	10	18	0	1	19	0	0
15	39294391	.	C	T	8	8	16	0	3	19	0	0
15	39296706	.	A	G	7	4	11	0	1	12	0	0
15	39296730	.	G	A	3	7	10	0	2	12	0	0
15	39297081	.	A	G	1	5	6	0	1	7	0	0
15	39305598	.	G	A	1	0	1	0	0	1	0	0
15	39354726	.	G	A	1	2	3	0	0	3	0	0
15	39967275	.	G	A	11	12	23	0	1	24	0	0
15	39969923	.	T	G	17	16	33	0	3	36	0	0
15	39986125	.	C	A	0	2	2	0	0	2	0	0
15	39987655	.	C	T	0	1	1	0	0	1	0	0
15	40000981	.	A	T	3	2	5	0	0	5	0	0
15	40002242	.	C	T	3	1	4	0	0	4	0	0
15	40002319	.	C	T	5	11	16	0	0	16	0	0
15	40002325	.	C	T	4	10	14	0	1	15	0	0
15	40005111	.	A	G	1	6	7	0	1	8	0	0
15	40005279	.	C	T	2	6	8	0	0	8	0	0
15	40005297	.	A	C	6	2	8	0	1	10	1	0
15	40005318	.	T	A	1	8	9	0	0	9	0	0
15	40005466	.	C	T	9	9	18	0	1	19	0	0
15	40005545	.	T	C	11	8	19	0	1	20	0	0
15	40006090	.	A	C	10	9	19	0	3	23	1	0
15	40008449	.	C	T	2	15	17	0	0	17	0	0
15	40008498	.	C	T	9	8	17	0	2	19	0	0
15	40008544	.	C	A	10	12	22	0	1	23	0	0
15	40018239	.	G	A	0	15	15	0	8	23	0	0
15	40018290	.	C	T	3	2	5	0	2	7	0	0
15	40027138	.	C	T	14	29	43	0	4	47	0	0
15	40027279	.	T	C	39	29	68	0	3	71	0	0
15	40027484	.	T	G	19	0	19	0	35	54	0	0
15	40027540	.	A	C	20	25	45	0	11	56	0	0
15	40027717	.	A	G	25	20	45	0	5	50	0	0
15	40028457	.	T	G	37	27	64	0	6	70	0	0
15	40028568	.	G	A	29	20	49	0	3	52	0	0
15	40028574	.	A	G	26	22	48	0	9	57	0	0
15	40091068	.	C	T	4	3	7	0	0	7	0	0
15	40099812	.	C	T	3	3	6	0	0	6	0	0
15	40104028	.	T	C	1	2	3	0	0	3	0	0
15	40108886	.	T	C	4	3	7	0	0	7	0	0
15	40108898	.	C	T	4	2	6	0	0	6	0	0
15	40115610	.	A	T	1	3	4	0	0	4	0	0
15	40115676	.	C	T	0	3	3	0	0	3	0	0
15	40122221	.	A	G	3	2	5	0	0	5	0	0
15	40122625	.	G	A	4	2	6	0	1	7	0	0
15	40126698	.	A	G	4	0	4	0	8	12	0	0
15	40128979	.	C	G	18	15	33	0	2	35	0	0
15	40129543	.	G	C	15	13	28	0	0	28	0	0
15	40129594	.	T	G	10	17	27	0	1	28	0	0
15	40129604	.	A	T	7	17	24	0	4	28	0	0
15	40129810	.	A	C	8	14	22	0	0	22	0	0
15	40130181	.	G	A	0	8	8	0	9	17	0	0
15	40130208	.	G	A	8	6	14	0	0	14	0	0
15	40130362	.	T	C	5	8	13	0	0	13	0	0
15	40130389	.	A	G	4	9	13	0	1	14	0	0
15	40130630	.	A	G	8	3	11	0	1	12	0	0
15	40130631	.	A	G	9	3	12	0	0	12	0	0
15	40130759	.	A	G	5	12	17	0	3	20	0	0
15	40130982	.	G	A	8	5	13	0	2	15	0	0
15	40131001	.	G	A	0	6	6	0	7	13	0	0
15	40131060	.	A	G	10	9	19	0	0	19	0	0
15	40131112	.	C	A	10	14	24	0	0	24	0	0
15	40131139	.	T	A	10	13	23	0	1	24	0	0
15	40131157	.	A	G	11	11	22	0	1	23	0	0
15	40131216	.	G	A	21	1	22	0	1	23	0	0
15	40131232	.	C	T	18	2	20	0	2	22	0	0
15	40131276	.	C	G	10	10	20	0	1	21	0	0
15	40131297	.	C	G	11	13	24	0	0	24	0	0
15	40131316	.	C	A	13	13	26	0	1	27	0	0
15	40131363	.	G	T	0	18	18	0	14	32	0	0
15	40131498	.	A	G	15	0	15	0	30	45	0	0
15	40131500	.	A	G	15	27	42	0	3	45	0	0
15	40131547	.	T	C	9	28	37	0	3	40	0	0
15	40131560	.	T	A	7	28	35	0	2	37	0	0
15	40131586	.	C	T	14	23	37	0	2	39	0	0
15	40131619	.	T	C	17	25	42	0	3	45	0	0
15	40131624	.	T	A	17	25	42	0	4	46	0	0
15	40131769	.	T	C	21	17	38	0	1	40	1	0
15	40202354	.	T	G	11	18	29	0	4	34	1	0
15	40202393	.	C	T	7	6	13	0	2	15	0	0
15	40211507	.	T	C	3	5	8	0	1	9	0	0
15	40211591	.	A	C	21	22	43	0	2	45	0	0
15	40211741	.	C	G	24	20	44	0	0	44	0	0
15	40211954	.	G	T	15	8	23	0	0	23	0	0
15	40212066	.	G	T	8	2	10	0	2	12	0	0
15	40938119	.	G	A	2	2	4	0	0	4	0	0
15	40941322	.	G	A	0	3	3	0	0	3	0	0
15	40945690	.	T	C	1	2	3	0	0	3	0	0
15	40988189	.	T	C	5	2	7	0	3	10	0	0
15	40988228	.	C	T	5	5	10	0	2	12	0	0
15	40988565	.	A	G	3	3	6	0	0	6	0	0
15	40989053	.	T	G	1	2	3	0	0	3	0	0
15	40989690	.	A	G	5	5	10	0	0	10	0	0
15	40989801	.	A	G	1	0	1	0	6	7	0	0
15	41170289	.	A	G	12	25	37	0	1	38	0	0
15	41170445	.	G	T	14	19	33	0	0	33	0	0
15	41170710	.	G	A	18	15	33	0	0	33	0	0
15	41170992	.	G	A	10	11	21	0	1	22	0	0
15	41171081	.	T	C	12	0	12	0	16	28	0	0
15	41171135	.	A	G	11	12	23	0	1	24	0	0
15	41171335	.	A	T	3	11	14	0	1	15	0	0
15	41171448	.	A	C	13	8	21	0	4	25	0	0
15	41171471	.	G	T	14	10	24	0	2	26	0	0
15	41171516	.	C	A	0	9	9	0	29	38	0	0
15	41172103	.	G	A	6	10	16	0	1	17	0	0
15	41172427	.	T	C	2	5	7	0	0	7	0	0
15	41172649	.	T	A	2	2	4	0	1	5	0	0
15	41172801	.	G	C	3	4	7	0	0	7	0	0
15	41172893	.	A	C	9	2	11	0	2	13	0	0
15	41172904	.	G	C	7	4	11	0	1	12	0	0
15	41173093	.	A	T	4	7	11	0	0	11	0	0
15	41173109	.	C	T	5	5	10	0	0	10	0	0
15	41173142	.	G	A	2	4	6	0	1	7	0	0
15	41173326	.	C	T	9	11	20	0	0	20	0	0
15	41173620	.	G	A	2	3	5	0	0	5	0	0
15	41807100	.	A	G	1	2	3	0	0	3	0	0
15	41845121	.	G	A	4	2	6	0	1	7	0	0
15	41845139	.	C	T	1	3	4	0	1	5	0	0
15	41845310	.	G	T	4	5	9	0	0	9	0	0
15	41845526	.	G	A	0	4	4	0	3	7	0	0
15	41947772	.	A	T	1	4	5	1	0	6	0	0
15	41948220	.	C	G	3	4	7	0	1	8	0	0
15	41948276	.	A	C	4	2	6	0	1	7	0	0
15	41949500	.	C	T	2	2	4	0	0	4	0	0
15	41949827	.	A	G	1	2	3	0	0	3	0	0
15	41950245	.	G	T	2	4	6	0	0	6	0	0
15	42264955	.	C	T	0	3	3	0	10	13	0	0
15	42265070	.	G	C	16	12	28	0	0	28	0	0
15	42265197	.	G	A	21	27	48	0	4	52	0	0
15	42265263	.	A	G	3	5	8	0	0	8	0	0
15	42267390	.	C	T	0	3	3	0	0	3	0	0
15	42267408	.	T	A	10	3	13	0	0	13	0	0
15	42272452	.	C	A	5	7	12	0	1	13	0	0
15	42278936	.	T	A	2	4	6	0	0	6	0	0
15	42280689	.	G	A	2	2	4	0	0	4	0	0
15	42283746	.	C	T	3	2	5	0	0	5	0	0
15	42285766	.	A	G	8	0	8	0	11	19	0	0
15	42285767	.	G	T	8	10	18	0	1	19	0	0
15	42302915	.	A	G	13	13	26	0	2	28	0	0
15	42317277	.	C	G	3	8	11	0	0	11	0	0
15	42317289	.	C	T	6	3	9	0	0	9	0	0
15	42344847	.	C	T	1	2	3	0	1	4	0	0
15	42346196	.	T	C	5	3	8	0	0	8	0	0
15	42346260	.	T	A	9	5	14	0	0	14	0	0
15	42346593	.	T	C	8	2	10	0	1	11	0	0
15	42346627	.	G	T	5	2	7	0	0	7	0	0
15	42346771	.	C	A	5	12	17	0	0	17	0	0
15	42346818	.	A	T	6	8	14	0	0	14	0	0
15	42346841	.	T	C	6	3	9	0	1	10	0	0
15	42346902	.	C	T	5	8	13	0	1	14	0	0
15	42346951	.	A	T	2	12	14	0	0	14	0	0
15	42346958	.	C	T	2	11	13	0	2	15	0	0
15	42550856	.	G	A	8	3	11	0	0	11	0	0
15	42550961	.	C	T	4	3	7	0	0	7	0	0
15	42551067	.	G	A	0	2	2	0	5	7	0	0
15	42920332	.	G	T	1	2	3	0	0	3	0	0
15	42920365	.	C	T	2	2	4	0	0	4	0	0
15	42980862	.	T	C	2	4	6	0	0	6	0	0
15	42981069	.	C	T	3	4	7	0	0	7	0	0
15	42981223	.	A	G	3	7	10	0	0	10	0	0
15	42981303	.	T	A	3	5	8	0	0	8	0	0
15	42981321	.	G	A	3	3	6	0	0	6	0	0
15	42981395	.	T	A	1	2	3	0	0	3	0	0
15	43099974	.	C	A	1	2	3	0	0	3	0	0
15	43187423	.	T	C	13	21	34	0	2	36	0	0
15	43195924	.	G	A	0	6	6	0	0	6	0	0
15	43196102	.	A	T	22	28	50	0	2	52	0	0
15	43196106	.	A	G	21	1	22	0	29	51	0	0
15	43196202	.	C	A	28	37	65	0	0	65	0	0
15	43196306	.	C	T	27	40	67	0	12	79	0	0
15	43196341	.	T	A	24	50	74	0	2	76	0	0
15	43196483	.	C	A	18	56	74	0	3	77	0	0
15	43196491	.	T	C	16	47	63	0	11	74	0	0
15	43196977	.	C	T	1	3	4	0	0	4	0	0
15	43604190	.	G	A	1	1	2	0	0	2	0	0
15	43604224	.	G	A	1	7	8	0	0	8	0	0
15	43604325	.	G	A	3	2	5	0	1	6	0	0
15	43604903	.	C	G	1	5	6	0	0	6	0	0
15	43604928	.	A	G	2	2	4	0	0	4	0	0
15	43604988	.	G	C	1	2	3	0	0	3	0	0
15	43604996	.	A	G	0	2	2	0	1	3	0	0
15	43605379	.	T	G	0	3	3	0	0	3	0	0
15	43605398	.	G	T	1	2	3	0	0	3	0	0
15	43605484	.	G	A	3	2	5	0	0	5	0	0
15	43936577	.	T	C	1	6	7	0	0	7	0	0
15	43936746	.	G	A	0	0	0	0	1	1	0	0
15	43982517	.	T	C	1	3	4	0	2	6	0	0
15	44035113	.	G	A	1	2	3	0	0	3	0	0
15	44074653	.	A	G	1	1	2	0	0	2	0	0
15	44075125	.	C	T	0	3	3	0	3	6	0	0
15	44077766	.	A	T	4	5	9	0	0	9	0	0
15	44140583	.	C	T	1	2	3	0	0	3	0	0
15	44140780	.	A	G	2	2	4	0	0	4	0	0
15	44140991	.	T	C	4	2	6	0	0	6	0	0
15	44141311	.	A	G	1	4	5	0	1	6	0	0
15	44141644	.	A	C	4	2	6	0	0	6	0	0
15	44209147	.	T	G	1	1	2	0	0	2	0	0
15	44254986	.	A	C	2	1	3	0	0	3	0	0
15	44255001	.	G	A	3	2	5	0	0	5	0	0
15	44255130	.	A	T	6	3	9	0	0	9	0	0
15	44283812	.	A	G	1	0	1	0	0	1	0	0
15	44290546	.	C	T	4	1	5	0	0	5	0	0
15	44295044	.	G	A	1	3	4	0	0	4	0	0
15	44336923	.	A	T	3	5	8	0	0	8	0	0
15	44340093	.	C	T	1	1	2	0	0	2	0	0
15	44344283	.	G	A	0	2	2	0	1	3	0	0
15	44345243	.	T	A	0	1	1	0	0	1	0	0
15	44348323	.	C	A	1	2	3	0	0	3	0	0
15	44371076	.	C	T	2	3	5	0	0	5	0	0
15	44371484	.	T	C	1	2	3	0	2	5	0	0
15	44385021	.	G	A	3	3	6	0	0	6	0	0
15	44385117	.	T	C	5	2	7	0	0	7	0	0
15	44385126	.	C	T	5	2	7	0	0	7	0	0
15	44399204	.	C	T	1	2	3	0	1	4	0	0
15	44445243	.	C	T	2	5	7	0	0	7	0	0
15	44465352	.	G	A	1	1	2	0	1	3	0	0
15	44499445	.	A	G	17	19	36	0	1	37	0	0
15	44499653	.	T	A	20	23	43	0	5	48	0	0
15	44499730	.	C	T	23	21	44	0	1	45	0	0
15	44534976	.	G	A	5	3	8	0	2	10	0	0
15	44733135	.	G	A	3	4	7	0	0	7	0	0
15	44733157	.	A	G	2	4	6	0	0	6	0	0
15	45027401	.	G	A	5	2	7	0	1	8	0	0
15	45034764	.	C	T	0	1	1	0	2	3	0	0
15	45048200	.	G	A	5	1	6	0	1	7	0	0
15	45056530	.	G	A	1	2	3	0	0	3	0	0
15	45558213	.	C	T	5	1	6	0	0	6	0	0
15	46691114	.	G	T	0	1	1	0	0	1	0	0
15	46723744	.	C	A	1	1	2	0	0	2	0	0
15	46727382	.	G	A	1	1	2	0	0	2	0	0
15	46727571	.	G	A	2	1	3	0	1	4	0	0
15	47336295	.	G	A	6	6	12	0	1	13	0	0
15	47386982	.	T	A	5	5	10	0	2	12	0	0
15	47410231	.	C	A	2	1	3	0	0	3	0	0
15	47418607	.	G	A	0	4	4	0	1	5	0	0
15	47418627	.	G	A	0	5	5	0	0	5	0	0
15	47419090	.	G	A	1	19	20	0	10	30	0	0
15	47419096	.	C	T	9	21	30	0	2	32	0	0
15	47419240	.	C	T	14	19	33	0	1	34	0	0
15	47419394	.	C	T	6	13	19	0	2	21	0	0
15	47419395	.	A	T	6	12	18	0	3	21	0	0
15	47420838	.	T	A	25	26	51	0	3	54	0	0
15	47421329	.	A	G	8	10	18	0	0	18	0	0
15	47421669	.	C	T	13	17	30	0	2	32	0	0
15	47421675	.	G	C	16	13	29	0	1	30	0	0
15	47448354	.	G	T	1	2	3	0	0	3	0	0
15	47448425	.	G	A	0	2	2	0	1	3	0	0
15	47448596	.	G	C	1	4	5	0	1	6	0	0
15	47452875	.	G	A	4	3	7	0	0	7	0	0
15	47453734	.	T	G	2	2	4	0	0	4	0	0
15	47830783	.	C	T	3	2	5	0	0	5	0	0
15	47830837	.	G	T	1	3	4	0	0	4	0	0
15	47831096	.	C	T	5	12	17	0	1	18	0	0
15	47831195	.	G	C	8	9	17	0	0	17	0	0
15	47831249	.	C	T	4	8	12	0	0	12	0	0
15	47831265	.	T	A	1	7	8	0	0	8	0	0
15	47831495	.	C	G	9	6	15	0	0	15	0	0
15	47831511	.	C	T	0	8	8	0	10	18	0	0
15	47831565	.	C	A	18	9	27	0	1	28	0	0
15	47831731	.	T	G	5	4	9	0	0	9	0	0
15	47831765	.	G	A	1	3	4	0	2	6	0	0
15	47831869	.	G	A	2	4	6	0	1	7	0	0
15	47832280	.	C	T	5	2	7	0	0	7	0	0
15	47832424	.	T	G	0	4	4	0	0	4	0	0
15	47833083	.	G	A	4	7	11	0	0	11	0	0
15	47833392	.	G	A	4	7	11	0	0	11	0	0
15	47833395	.	C	T	0	7	7	0	4	11	0	0
15	47833436	.	C	T	0	5	5	0	3	8	0	0
15	47833493	.	C	T	0	3	3	0	5	8	0	0
15	47833814	.	C	T	1	4	5	0	0	5	0	0
15	47834559	.	G	A	1	4	5	0	0	5	0	0
15	47839080	.	G	A	1	2	3	0	0	3	0	0
15	47845908	.	A	G	0	1	1	0	0	1	0	0
15	47847180	.	T	C	0	0	0	0	5	5	0	0
15	47847373	.	G	A	2	5	7	0	0	7	0	0
15	47848495	.	C	T	22	16	38	0	3	41	0	0
15	47851205	.	T	A	30	30	60	0	1	61	0	0
15	47851342	.	C	G	44	12	56	1	2	59	0	0
15	47851455	.	T	G	28	30	58	0	0	58	0	0
15	47851486	.	G	A	29	32	61	0	0	61	0	0
15	47851522	.	C	T	2	26	28	0	31	59	0	0
15	47851751	.	A	G	31	13	44	0	4	48	0	0
15	47851828	.	G	A	25	18	43	0	5	48	0	0
15	47851978	.	C	T	6	5	11	0	1	12	0	0
15	47851979	.	A	G	7	5	12	0	0	12	0	0
15	47852049	.	G	T	9	10	19	0	2	21	0	0
15	47855085	.	A	G	2	16	18	0	7	25	0	0
15	47856418	.	T	C	2	5	7	0	0	7	0	0
15	47860443	.	C	T	0	27	27	0	15	42	0	0
16	50458	.	C	A	3	8	11	0	0	11	0	0
16	51458	.	C	T	1	1	2	0	0	2	0	0
16	68355	.	T	C	5	4	9	0	0	9	0	0
16	68356	.	C	T	5	4	9	0	0	9	0	0
16	68404	.	A	G	1	10	11	0	1	12	0	0
16	68477	.	G	A	0	6	6	0	9	15	0	0
16	68513	.	G	C	0	5	5	0	6	11	0	0
16	68635	.	A	G	4	6	10	0	1	11	0	0
16	68812	.	A	G	8	6	14	0	2	16	0	0
16	68854	.	T	C	7	10	17	0	1	18	0	0
16	69005	.	T	A	8	5	13	0	7	20	0	0
16	69428	.	A	C	8	5	13	0	0	13	0	0
16	70697	.	T	C	15	8	23	0	2	25	0	0
16	70881	.	A	G	8	5	13	0	2	15	0	0
16	221747	.	G	A	1	6	7	0	2	9	0	0
16	221828	.	C	T	12	14	26	0	1	27	0	0
16	224707	.	A	G	17	20	37	0	0	37	0	0
16	224734	.	C	G	16	20	36	0	3	39	0	0
16	224743	.	C	A	12	22	34	0	5	39	0	0
16	224837	.	A	C	23	17	40	0	2	42	0	0
16	224886	.	G	A	0	18	18	0	31	49	0	0
16	224974	.	A	T	22	19	41	0	1	42	0	0
16	225005	.	T	C	18	28	46	0	3	49	0	0
16	225304	.	C	A	27	18	45	0	3	48	0	0
16	225564	.	T	C	23	21	44	0	5	49	0	0
16	225615	.	A	G	24	29	53	0	1	54	0	0
16	225660	.	C	G	26	24	50	0	5	55	0	0
16	226361	.	C	G	19	30	49	0	3	52	0	0
16	226374	.	T	A	20	29	49	0	1	50	0	0
16	226526	.	A	G	21	21	42	0	1	43	0	0
16	227590	.	A	T	4	2	6	0	0	6	0	0
16	250422	.	T	A	2	5	7	0	0	7	0	0
16	277917	.	T	C	4	0	4	0	5	9	0	0
16	277949	.	G	T	3	1	4	0	1	5	0	0
16	278750	.	C	T	0	3	3	0	3	6	0	0
16	379711	.	A	G	1	4	5	0	0	5	0	0
16	559050	.	T	A	5	5	10	0	2	13	1	0
16	560755	.	G	A	4	6	10	0	1	11	0	0
16	815859	.	C	T	6	6	12	0	1	13	0	0
16	815967	.	G	A	9	10	19	0	0	19	0	0
16	816096	.	A	G	9	13	22	0	3	25	0	0
16	817431	.	T	C	1	0	1	0	0	1	0	0
16	1199324	.	C	T	0	2	2	0	1	3	0	0
16	1199357	.	T	C	1	2	3	0	0	3	0	0
16	1199699	.	C	T	1	1	2	0	1	3	0	0
16	1199740	.	A	G	1	1	2	0	0	2	0	0
16	1199741	.	C	T	0	1	1	0	1	2	0	0
16	1207149	.	T	A	3	2	5	0	0	5	0	0
16	1207948	.	C	G	0	1	1	0	0	1	0	0
16	1209528	.	C	T	2	2	4	0	0	4	0	0
16	1210280	.	G	A	4	5	9	0	0	9	0	0
16	1210403	.	C	T	5	6	11	0	1	12	0	0
16	1228093	.	A	C	6	6	12	0	1	13	0	0
16	1230470	.	C	T	2	2	4	0	1	5	0	0
16	1234138	.	A	T	2	0	2	0	0	2	0	0
16	1239500	.	T	C	7	9	16	0	1	17	0	0
16	1355316	.	A	T	3	0	3	0	1	4	0	0
16	1355720	.	T	C	5	1	6	0	1	7	0	0
16	1359119	.	T	C	2	2	4	0	0	4	0	0
16	1397112	.	C	T	1	2	3	0	0	3	0	0
16	1397126	.	C	A	1	2	3	0	0	3	0	0
16	1397399	.	T	A	2	2	4	0	0	4	0	0
16	1523892	.	A	G	2	2	4	0	0	4	0	0
16	1996533	.	A	G	3	2	5	0	0	5	0	0
16	2009844	.	T	G	1	3	4	0	0	4	0	0
16	2043021	.	C	T	5	3	8	0	0	8	0	0
16	2043122	.	G	C	0	1	1	0	4	5	0	0
16	2071535	.	G	A	0	3	3	0	3	6	0	0
16	2102743	.	A	T	2	1	3	0	2	5	0	0
16	2103052	.	C	T	9	7	16	0	1	17	0	0
16	2103058	.	G	T	9	7	16	0	1	17	0	0
16	2103088	.	G	A	0	10	10	0	11	21	0	0
16	2103167	.	C	T	7	6	13	0	0	13	0	0
16	2103209	.	C	T	13	4	17	0	1	18	0	0
16	2103241	.	T	A	9	10	19	0	1	20	0	0
16	2103268	.	A	T	7	10	17	0	2	19	0	0
16	2103307	.	T	C	7	9	16	0	2	18	0	0
16	2103714	.	A	T	4	6	10	0	2	12	0	0
16	2103783	.	A	T	1	4	5	0	0	5	0	0
16	2104114	.	T	A	2	2	4	0	1	5	0	0
16	2104181	.	T	A	2	4	6	0	0	6	0	0
16	2104312	.	A	C	6	14	20	0	3	23	0	0
16	2104400	.	T	C	11	15	26	0	0	26	0	0
16	2104597	.	T	C	27	25	52	0	3	55	0	0
16	2104604	.	A	G	29	0	29	0	28	57	0	0
16	2105035	.	A	G	2	9	11	0	0	11	0	0
16	2353191	.	C	A	3	7	10	0	1	11	0	0
16	2353382	.	T	A	1	4	5	0	1	6	0	0
16	2353388	.	G	T	2	3	5	0	0	5	0	0
16	2355134	.	T	A	1	2	3	0	0	3	0	0
16	2365716	.	G	A	1	2	3	0	0	3	0	0
16	2472263	.	G	A	1	5	6	0	2	8	0	0
16	2472284	.	T	C	1	2	3	0	0	3	0	0
16	2485904	.	G	A	0	1	1	0	0	1	0	0
16	2495649	.	G	C	2	2	4	0	0	4	0	0
16	2517184	.	G	T	2	4	6	0	0	6	0	0
16	2519056	.	T	C	2	1	3	0	0	3	0	0
16	2528209	.	A	G	2	0	2	0	0	2	0	0
16	2545290	.	C	T	2	1	3	0	0	3	0	0
16	2567316	.	A	G	4	0	4	0	7	11	0	0
16	2568847	.	G	A	0	8	8	0	8	16	0	0
16	2574963	.	C	T	0	2	2	0	0	2	0	0
16	2577717	.	T	A	2	0	2	0	0	2	0	0
16	2578771	.	G	A	0	1	1	0	0	1	0	0
16	2580255	.	T	A	11	18	29	0	1	30	0	0
16	2580340	.	G	A	1	2	3	0	0	3	0	0
16	2637597	.	A	T	2	5	7	0	0	7	0	0
16	2637703	.	C	A	2	4	6	0	0	6	0	0
16	2638472	.	A	C	0	2	2	0	1	3	0	0
16	2638507	.	G	C	1	2	3	0	0	3	0	0
16	2843739	.	A	C	2	2	4	0	0	4	0	0
16	2843932	.	T	C	3	2	5	0	0	5	0	0
16	2843950	.	A	C	2	2	4	0	0	4	0	0
16	2844077	.	T	A	2	2	4	0	0	4	0	0
16	2847901	.	T	G	4	4	8	0	0	8	0	0
16	2987434	.	T	A	1	2	3	0	0	3	0	0
16	3091178	.	C	T	0	1	1	0	0	1	0	0
16	3091195	.	A	G	0	2	2	0	0	2	0	0
16	3091279	.	A	C	0	2	2	0	0	2	0	0
16	3091288	.	G	A	0	1	1	0	0	1	0	0
16	3096160	.	C	G	2	5	7	0	0	7	0	0
16	3096166	.	T	C	2	5	7	0	0	7	0	0
16	3096319	.	T	C	3	7	10	0	0	10	0	0
16	3096384	.	C	T	8	6	14	0	1	15	0	0
16	3096420	.	T	C	10	7	17	0	1	18	0	0
16	3096446	.	A	T	9	8	17	0	0	17	0	0
16	3096516	.	G	A	3	8	11	0	0	11	0	0
16	3463895	.	A	G	9	5	14	0	0	14	0	0
16	3470212	.	G	A	1	1	2	0	1	3	0	0
16	3470332	.	A	G	3	3	6	0	0	6	0	0
16	4110092	.	T	C	2	0	2	0	0	2	0	0
16	4110095	.	C	T	2	0	2	0	0	2	0	0
16	4117624	.	G	A	1	0	1	0	0	1	0	0
16	4126464	.	C	T	4	3	7	0	0	7	0	0
16	4126927	.	C	T	3	0	3	0	0	3	0	0
16	4128322	.	C	T	0	3	3	0	0	3	0	0
16	4131062	.	T	C	3	5	8	0	2	10	0	0
16	4190170	.	A	T	0	2	2	0	0	2	0	0
16	4190217	.	C	G	0	2	2	0	0	2	0	0
16	4190257	.	G	A	1	2	3	0	0	3	0	0
16	4190259	.	T	A	1	2	3	0	0	3	0	0
16	4190580	.	C	T	0	2	2	0	0	2	0	0
16	4190599	.	G	A	1	2	3	0	0	3	0	0
16	4196966	.	A	T	1	2	3	0	0	3	0	0
16	4200749	.	G	T	5	2	7	0	0	7	0	0
16	4201948	.	C	G	7	9	16	0	1	17	0	0
16	4202081	.	T	C	4	9	13	0	0	13	0	0
16	4202128	.	A	G	1	2	3	0	1	4	0	0
16	4287704	.	C	A	6	3	9	0	1	10	0	0
16	4288656	.	T	A	4	4	8	0	1	9	0	0
16	4288960	.	T	C	2	5	7	0	0	7	0	0
16	4289022	.	A	T	3	4	7	0	0	7	0	0
16	4293419	.	G	T	3	4	7	0	0	7	0	0
16	4309183	.	A	G	1	2	3	0	1	4	0	0
16	4309192	.	T	G	2	3	5	0	0	5	0	0
16	4317799	.	T	A	1	2	3	0	0	3	0	0
16	4542055	.	C	T	7	3	10	0	0	10	0	0
16	4542060	.	C	T	7	3	10	0	0	10	0	0
16	4858779	.	G	T	0	0	0	0	1	1	0	0
16	4861083	.	T	C	5	2	7	0	0	7	0	0
16	4867496	.	A	G	5	2	7	0	0	7	0	0
16	4875198	.	A	G	3	1	4	0	0	4	0	0
16	4876470	.	C	T	1	0	1	0	1	2	0	0
16	4882206	.	C	T	6	3	9	0	0	9	0	0
16	4882491	.	C	T	4	6	10	0	1	11	0	0
16	4882492	.	G	A	0	6	6	0	5	11	0	0
16	4882945	.	G	A	4	3	7	0	1	8	0	0
16	5014391	.	A	G	1	3	4	0	1	5	0	0
16	5014564	.	A	G	3	8	11	0	1	12	0	0
16	5025494	.	G	A	2	2	4	0	0	4	0	0
16	5086725	.	G	A	5	4	9	0	0	9	0	0
16	5105119	.	T	G	2	3	5	0	1	6	0	0
16	5105221	.	G	A	8	8	16	0	2	18	0	0
16	5119900	.	C	T	0	2	2	0	1	3	0	0
16	5167249	.	A	C	7	6	13	0	0	13	0	0
16	5193353	.	C	T	1	0	1	0	0	1	0	0
16	5196377	.	C	T	2	2	4	0	0	4	0	0
16	5196630	.	C	T	2	3	5	0	1	6	0	0
16	5196813	.	C	A	2	1	3	0	0	3	0	0
16	5199442	.	C	T	0	2	2	0	1	3	0	0
16	5205146	.	G	A	0	4	4	0	3	7	0	0
16	5221622	.	T	A	4	7	11	0	0	11	0	0
16	5223206	.	G	A	2	4	6	0	0	6	0	0
16	5223355	.	G	A	7	5	12	0	1	13	0	0
16	5223375	.	A	G	7	5	12	0	1	13	0	0
16	5223454	.	C	T	2	8	10	0	1	11	0	0
16	5223470	.	G	A	3	5	8	0	0	8	0	0
16	5223880	.	G	C	0	8	8	0	7	15	0	0
16	5224328	.	A	G	15	12	27	0	2	29	0	0
16	5224375	.	G	C	0	13	13	0	10	23	0	0
16	5224429	.	A	T	0	1	1	0	0	1	0	0
16	5496522	.	T	C	2	2	4	0	0	4	0	0
16	5604865	.	A	G	3	2	5	0	0	5	0	0
16	5604906	.	T	C	2	2	4	0	0	4	0	0
16	5624467	.	C	T	0	2	2	0	0	2	0	0
16	5710483	.	G	A	0	1	1	0	2	3	0	0
16	5776245	.	T	C	17	12	29	0	4	33	0	0
16	5776356	.	C	T	18	19	37	0	2	39	0	0
16	5776371	.	T	G	16	13	29	0	2	31	0	0
16	5786945	.	G	A	5	3	8	0	0	8	0	0
16	5786977	.	G	A	8	8	16	0	1	17	0	0
16	5787185	.	A	T	3	5	8	0	4	12	0	0
16	5787435	.	T	C	5	12	17	0	0	17	0	0
16	5787436	.	C	A	4	12	16	0	1	17	0	0
16	5787485	.	T	A	6	11	17	0	0	17	0	0
16	5787519	.	G	A	4	8	12	0	0	12	0	0
16	5787670	.	A	G	2	5	7	0	3	10	0	0
16	5788079	.	A	G	4	2	6	0	1	7	0	0
16	5788655	.	T	C	2	2	4	0	0	4	0	0
16	5788705	.	T	C	2	5	7	0	1	8	0	0
16	5789124	.	C	A	0	7	7	0	5	12	0	0
16	5789340	.	G	C	3	0	3	0	9	12	0	0
16	5800670	.	C	T	0	4	4	0	4	8	0	0
16	5806440	.	G	A	4	2	6	0	1	7	0	0
16	5808790	.	G	A	0	4	4	0	0	4	0	0
16	5808802	.	A	G	1	3	4	0	1	5	0	0
16	5808910	.	T	C	1	1	2	0	0	2	0	0
16	5819209	.	T	A	0	0	0	0	1	1	0	0
16	5820045	.	C	T	1	0	1	0	0	1	0	0
16	6101477	.	G	A	0	2	2	0	0	2	0	0
16	6126477	.	T	A	3	2	5	0	0	5	0	0
16	6182755	.	C	T	32	18	50	0	1	51	0	0
16	6183022	.	A	C	23	14	37	0	2	39	0	0
16	6183658	.	T	G	26	29	55	0	0	55	0	0
16	6191514	.	A	G	29	15	44	0	2	46	0	0
16	6191526	.	G	C	29	13	42	0	2	44	0	0
16	6197212	.	T	C	5	8	13	0	0	13	0	0
16	6205657	.	G	T	2	1	3	0	0	3	0	0
16	6356673	.	A	T	1	3	4	0	1	5	0	0
16	6356680	.	T	A	1	3	4	0	0	4	0	0
16	6356823	.	T	A	5	4	9	0	0	9	0	0
16	6356850	.	T	C	5	4	9	0	0	9	0	0
16	6735149	.	C	T	1	2	3	0	0	3	0	0
16	6742797	.	T	C	2	3	5	0	0	5	0	0
16	6746038	.	C	A	4	2	6	0	0	6	0	0
16	6747256	.	G	T	3	4	7	1	1	9	0	0
16	6760819	.	G	A	0	2	2	0	0	2	0	0
16	6760864	.	T	C	0	3	3	0	0	3	0	0
16	6760880	.	A	G	0	2	2	0	0	2	0	0
16	6776120	.	G	A	0	2	2	0	0	2	0	0
16	6776126	.	G	A	0	2	2	0	0	2	0	0
16	6782653	.	T	C	1	3	4	0	0	4	0	0
16	6782948	.	T	C	0	2	2	0	0	2	0	0
16	6784609	.	C	G	1	0	1	0	0	1	0	0
16	6784866	.	C	T	2	6	8	0	0	8	0	0
16	6787801	.	A	G	3	0	3	0	5	8	0	0
16	6790964	.	C	T	1	4	5	0	0	5	0	0
16	6790978	.	C	T	1	4	5	0	0	5	0	0
16	6792044	.	C	T	5	3	8	0	0	8	0	0
16	6792059	.	C	G	3	1	4	0	1	5	0	0
16	6793333	.	C	G	0	1	1	0	0	1	0	0
16	6796118	.	C	T	2	2	4	0	0	4	0	0
16	6796195	.	A	G	4	2	6	0	1	7	0	0
16	6800033	.	G	A	6	6	12	0	0	12	0	0
16	6800043	.	G	A	0	7	7	0	4	11	0	0
16	6800140	.	C	T	7	10	17	0	0	17	0	0
16	6800209	.	G	A	6	4	10	0	0	10	0	0
16	6800211	.	A	G	6	0	6	0	4	10	0	0
16	6800263	.	G	A	3	2	5	0	0	5	0	0
16	6800383	.	G	A	2	5	7	0	0	7	0	0
16	6803650	.	A	T	19	21	40	0	2	42	0	0
16	6803736	.	G	C	21	18	39	0	4	43	0	0
16	6809872	.	A	G	6	8	14	0	0	14	0	0
16	6820725	.	G	A	6	14	20	0	1	21	0	0
16	6820746	.	G	C	8	11	19	0	2	21	0	0
16	6821214	.	G	A	5	9	14	0	0	14	0	0
16	6821423	.	A	G	5	11	16	0	1	17	0	0
16	6822014	.	G	A	12	6	18	0	0	18	0	0
16	6849625	.	A	G	0	3	3	0	0	3	0	0
16	6917140	.	A	G	1	3	4	0	0	4	0	0
16	6920023	.	T	C	2	2	4	0	1	5	0	0
16	6920026	.	G	A	0	2	2	0	3	5	0	0
16	6932384	.	A	T	2	4	6	0	0	6	0	0
16	6932420	.	G	A	2	5	7	0	0	7	0	0
16	6932423	.	C	T	2	5	7	0	0	7	0	0
16	6932651	.	T	A	1	2	3	0	0	3	0	0
16	6933030	.	A	C	5	2	7	0	1	8	0	0
16	6937447	.	T	C	0	1	1	0	1	2	0	0
16	6937670	.	A	G	2	2	4	0	0	4	0	0
16	6947998	.	T	C	8	11	19	0	0	19	0	0
16	6955048	.	G	A	17	20	37	0	1	38	0	0
16	6955368	.	A	G	12	10	22	0	0	22	0	0
16	7202513	.	A	C	1	0	1	0	1	4	2	0
16	7202587	.	A	G	3	2	5	0	0	5	0	0
16	7202699	.	T	C	2	2	4	0	0	4	0	0
16	7217013	.	A	G	10	11	21	0	0	21	0	0
16	7217052	.	G	T	6	12	18	0	5	23	0	0
16	7220142	.	A	G	3	4	7	0	0	7	0	0
16	7220225	.	C	T	0	1	1	0	4	5	0	0
16	7221846	.	C	T	0	1	1	0	1	2	0	0
16	7239374	.	A	C	3	6	9	0	0	9	0	0
16	7242729	.	A	T	3	5	8	0	0	8	0	0
16	7242735	.	T	A	3	4	7	0	1	8	0	0
16	7242821	.	A	T	5	2	7	0	0	7	0	0
16	7252871	.	T	C	3	16	19	0	1	20	0	0
16	7254778	.	G	A	0	12	12	0	11	23	0	0
16	7259719	.	T	C	3	8	11	0	0	11	0	0
16	7259853	.	A	G	1	8	9	0	0	9	0	0
16	7259869	.	T	A	2	7	9	0	0	9	0	0
16	7259900	.	A	G	5	10	15	0	1	16	0	0
16	7259956	.	A	T	6	21	27	0	1	28	0	0
16	7259957	.	G	A	5	20	25	0	3	28	0	0
16	7260156	.	T	C	5	2	7	0	0	7	0	0
16	7260262	.	G	A	4	8	12	0	1	13	0	0
16	7260280	.	T	A	3	8	11	0	0	11	0	0
16	7316083	.	G	A	1	2	3	0	0	3	0	0
16	7728408	.	C	T	3	1	4	0	0	4	0	0
16	7730647	.	C	A	2	2	4	0	0	4	0	0
16	7743398	.	C	T	0	7	7	0	4	11	0	0
16	7743598	.	T	A	5	4	9	0	0	9	0	0
16	7745053	.	C	G	4	3	7	0	0	7	0	0
16	7745455	.	A	G	3	2	5	0	0	5	0	0
16	7745464	.	T	G	3	1	4	0	0	4	0	0
16	7745513	.	A	C	4	3	7	0	0	7	0	0
16	7745741	.	G	A	1	5	6	0	0	6	0	0
16	7746087	.	T	G	2	4	6	0	0	6	0	0
16	7803192	.	C	A	2	12	14	0	0	14	0	0
16	7803200	.	C	G	2	12	14	0	0	14	0	0
16	7803455	.	C	A	1	2	3	0	1	4	0	0
16	7803549	.	C	T	0	4	4	0	12	16	0	0
16	7803560	.	A	G	11	6	17	0	0	17	0	0
16	7803765	.	C	G	8	4	12	0	3	15	0	0
16	7803782	.	C	A	0	6	6	0	6	12	0	0
16	7803923	.	T	A	5	7	12	0	0	12	0	0
16	7803971	.	T	A	9	6	15	0	0	15	0	0
16	7804914	.	C	T	0	3	3	0	1	4	0	0
16	7805410	.	T	G	1	2	3	0	2	5	0	0
16	7985896	.	T	A	2	2	4	0	0	4	0	0
16	7994808	.	T	G	2	2	4	0	0	4	0	0
16	8027172	.	G	A	0	1	1	0	3	4	0	0
16	8040833	.	C	G	4	11	15	0	0	15	0	0
16	8040843	.	T	G	3	0	3	0	9	12	0	0
16	8040927	.	A	T	6	4	10	0	0	10	0	0
16	8041010	.	A	G	3	13	16	0	2	18	0	0
16	8051558	.	T	G	13	13	26	0	3	29	0	0
16	8052329	.	T	C	15	9	24	0	0	24	0	0
16	8052469	.	G	A	12	15	27	0	0	27	0	0
16	8052652	.	A	G	17	11	28	0	3	31	0	0
16	8052747	.	A	G	8	5	13	0	2	15	0	0
16	8052831	.	T	A	8	9	17	0	1	18	0	0
16	8052866	.	C	A	0	4	4	0	10	14	0	0
16	8052909	.	T	A	4	6	10	0	0	10	0	0
16	8052982	.	T	C	7	7	14	0	0	14	0	0
16	8053202	.	C	T	5	5	10	0	1	11	0	0
16	8053206	.	T	G	6	6	12	0	0	12	0	0
16	8053716	.	A	G	8	15	23	0	2	25	0	0
16	8053717	.	T	C	9	11	20	0	5	25	0	0
16	8053893	.	A	G	8	6	14	0	0	14	0	0
16	8054434	.	T	C	1	0	1	0	7	8	0	0
16	8066237	.	A	C	2	3	5	0	0	5	0	0
16	8066318	.	A	G	3	2	5	0	0	5	0	0
16	8119672	.	G	A	1	6	7	0	0	7	0	0
16	8119922	.	G	A	1	3	4	0	1	5	0	0
16	8120090	.	G	A	2	3	5	0	0	5	0	0
16	8161735	.	G	A	1	2	3	0	0	3	0	0
16	8161774	.	G	A	0	3	3	0	2	5	0	0
16	8298607	.	C	T	0	8	8	0	0	8	0	0
16	8298642	.	T	C	2	6	8	0	0	8	0	0
16	8298915	.	T	C	3	4	7	0	0	7	0	0
16	8299302	.	G	A	3	2	5	0	0	5	0	0
16	8299308	.	T	A	4	2	6	0	0	6	0	0
16	8299476	.	A	T	5	3	8	0	0	8	0	0
16	8300289	.	A	T	5	3	8	0	0	8	0	0
16	8531249	.	C	T	0	2	2	0	1	3	0	0
16	8531643	.	G	A	4	4	8	0	0	8	0	0
16	8531682	.	C	T	5	5	10	0	0	10	0	0
16	8531744	.	T	C	4	5	9	0	0	9	0	0
16	8532168	.	C	T	1	2	3	0	0	3	0	0
16	8532284	.	G	A	1	2	3	0	0	3	0	0
16	8772812	.	A	T	4	10	14	0	0	14	0	0
16	8772821	.	A	G	4	7	11	0	0	11	0	0
16	9275806	.	C	T	4	3	7	0	0	7	0	0
16	9276020	.	C	T	8	7	15	0	1	16	0	0
16	9282707	.	C	T	1	0	1	0	0	1	0	0
16	9286997	.	G	A	3	0	3	0	0	3	0	0
16	9299775	.	A	T	0	2	2	0	0	2	0	0
16	9300314	.	G	A	1	4	5	0	0	5	0	0
16	9412125	.	A	G	1	2	3	0	0	3	0	0
16	9412151	.	T	C	1	4	5	0	0	5	0	0
16	9412350	.	C	T	0	6	6	0	0	6	0	0
16	9412354	.	C	A	1	5	6	0	1	7	0	0
16	9412401	.	C	T	2	4	6	0	2	8	0	0
16	9415124	.	T	A	6	3	9	0	0	9	0	0
16	9415740	.	G	A	2	6	8	0	0	8	0	0
16	9415793	.	C	T	2	3	5	0	0	5	0	0
16	9420003	.	G	A	3	2	5	0	0	5	0	0
16	9433855	.	A	G	1	4	5	0	1	6	0	0
16	9433954	.	A	G	6	2	8	0	0	8	0	0
16	9434023	.	G	A	5	3	8	0	1	9	0	0
16	9593865	.	A	C	1	2	3	0	1	4	0	0
16	9602508	.	C	T	1	5	6	0	0	6	0	0
16	9602523	.	G	A	1	8	9	0	0	9	0	0
16	9602672	.	A	G	0	1	1	0	0	1	0	0
16	9605436	.	A	T	4	9	13	0	0	13	0	0
16	9605728	.	G	C	4	5	9	0	0	9	0	0
16	9605823	.	A	T	2	6	8	0	1	9	0	0
16	9605982	.	C	A	11	11	22	0	0	22	0	0
16	9714080	.	G	A	1	2	3	0	0	3	0	0
16	9724918	.	G	A	4	4	8	0	1	9	0	0
16	9724919	.	T	A	5	4	9	0	0	9	0	0
16	9724959	.	C	T	5	5	10	0	1	11	0	0
16	9725016	.	C	G	3	6	9	0	0	9	0	0
16	9752318	.	G	A	1	1	2	0	0	2	0	0
16	9758128	.	C	T	1	0	1	0	0	1	0	0
16	9758164	.	C	T	3	2	5	0	0	5	0	0
16	9758414	.	T	G	1	4	5	0	0	5	0	0
16	9758452	.	A	T	1	4	5	0	0	5	0	0
16	9758485	.	G	A	1	2	3	0	0	3	0	0
16	9758844	.	A	G	2	2	4	0	0	4	0	0
16	9758944	.	G	A	0	4	4	0	4	8	0	0
16	9758956	.	A	G	2	4	6	0	0	6	0	0
16	9759336	.	C	T	4	1	5	0	1	6	0	0
16	9759698	.	A	C	6	4	10	0	1	11	0	0
16	9760083	.	T	C	6	7	13	0	1	14	0	0
16	9760085	.	C	A	5	7	12	0	2	14	0	0
16	9760248	.	T	C	3	9	12	0	0	12	0	0
16	9760564	.	C	T	5	2	7	0	0	7	0	0
16	9760775	.	G	C	6	3	9	0	0	9	0	0
16	9760783	.	G	A	6	3	9	0	0	9	0	0
16	9760835	.	A	T	1	2	3	0	0	3	0	0
16	9760894	.	A	T	12	6	18	0	0	18	0	0
16	9761141	.	G	A	0	12	12	0	14	26	0	0
16	9761287	.	T	C	0	5	5	0	1	6	0	0
16	9761298	.	C	T	1	2	3	0	0	3	0	0
16	9761336	.	T	A	5	6	11	0	1	12	0	0
16	9761525	.	G	A	16	9	25	0	2	27	0	0
16	9771283	.	C	G	7	9	16	0	1	17	0	0
16	9771284	.	T	C	8	8	16	0	1	17	0	0
16	9774187	.	G	A	7	12	19	0	0	19	0	0
16	9774381	.	G	A	0	0	0	0	1	1	0	0
16	9777497	.	T	C	17	29	46	0	1	47	0	0
16	9777613	.	A	G	12	11	23	0	2	26	1	0
16	9777629	.	A	T	11	16	27	0	2	29	0	0
16	9777716	.	A	G	11	8	19	0	0	19	0	0
16	9785990	.	G	A	15	9	24	0	0	24	0	0
16	9786088	.	C	T	4	9	13	0	0	13	0	0
16	9786097	.	G	A	5	5	10	0	2	12	0	0
16	9787891	.	T	G	12	15	27	0	1	28	0	0
16	9787925	.	A	G	19	16	35	0	0	35	0	0
16	9788005	.	C	T	11	18	29	0	4	33	0	0
16	9788019	.	T	A	18	9	27	0	2	29	0	0
16	9788447	.	T	C	3	12	15	0	0	15	0	0
16	9788504	.	A	T	6	12	18	0	1	19	0	0
16	9788672	.	G	A	11	5	16	0	1	17	0	0
16	9788929	.	T	G	5	5	10	0	0	10	0	0
16	9789007	.	A	T	5	9	14	0	2	16	0	0
16	9789015	.	C	G	10	6	16	0	0	16	0	0
16	9789048	.	G	T	3	5	8	0	0	8	0	0
16	9789063	.	A	C	2	5	7	0	2	9	0	0
16	9789097	.	C	T	5	6	11	0	0	11	0	0
16	9789225	.	A	C	12	3	15	0	3	18	0	0
16	9789513	.	C	G	20	16	36	0	1	37	0	0
16	9797177	.	A	G	1	2	3	0	0	3	0	0
16	9833482	.	A	T	2	4	6	0	0	6	0	0
16	9833559	.	A	T	3	5	8	0	0	8	0	0
16	9833577	.	G	A	6	3	9	0	0	9	0	0
16	9833791	.	T	A	23	18	41	0	2	43	0	0
16	9833794	.	T	A	25	19	44	0	0	44	0	0
16	9833889	.	C	A	16	29	45	0	2	47	0	0
16	9833974	.	G	A	21	20	41	0	4	45	0	0
16	9834258	.	G	A	17	15	32	0	2	34	0	0
16	9834271	.	C	T	19	16	35	0	1	36	0	0
16	9834491	.	T	A	15	9	24	0	2	26	0	0
16	9834748	.	G	C	11	8	19	0	4	23	0	0
16	9834873	.	G	C	15	10	25	0	0	25	0	0
16	9847149	.	G	A	6	7	13	0	0	13	0	0
16	9978350	.	A	T	28	21	49	0	1	50	0	0
16	10038806	.	A	T	0	1	1	0	0	1	0	0
16	10055679	.	A	G	6	4	10	0	0	10	0	0
16	10055730	.	C	A	1	2	3	0	0	3	0	0
16	10055865	.	G	A	2	2	4	0	0	4	0	0
16	10065578	.	G	A	1	4	5	0	0	5	0	0
16	10068095	.	C	G	1	1	2	0	0	2	0	0
16	10068125	.	C	G	1	2	3	0	0	3	0	0
16	10071730	.	G	A	5	3	8	0	1	9	0	0
16	10071812	.	C	T	0	3	3	0	0	3	0	0
16	10097388	.	A	C	1	1	2	0	0	2	0	0
16	10097397	.	G	T	1	2	3	0	0	3	0	0
16	10279330	.	C	T	3	2	5	0	0	5	0	0
16	10283438	.	C	A	3	2	5	0	0	5	0	0
16	10284593	.	T	A	8	5	13	0	0	13	0	0
16	10287908	.	A	G	1	9	10	0	0	10	0	0
16	10287996	.	G	A	3	8	11	0	0	11	0	0
16	10288022	.	C	A	1	3	4	0	0	4	0	0
16	10288230	.	A	G	3	6	9	0	1	10	0	0
16	10288260	.	C	T	4	8	12	0	0	12	0	0
16	10288311	.	G	C	4	5	9	0	0	9	0	0
16	10325723	.	G	A	0	4	4	0	2	6	0	0
16	10325732	.	T	C	4	2	6	0	0	6	0	0
16	10325960	.	G	A	0	7	7	0	12	19	0	0
16	10326092	.	C	T	11	13	24	0	3	27	0	0
16	10326305	.	G	A	0	11	11	0	18	29	0	0
16	10326704	.	C	T	29	22	51	0	3	54	0	0
16	10326737	.	A	G	24	29	53	0	1	54	0	0
16	10326990	.	G	A	2	25	27	0	19	46	0	0
16	10326993	.	A	T	23	18	41	0	3	44	0	0
16	10327128	.	C	T	17	19	36	0	2	38	0	0
16	10327530	.	C	A	15	16	31	0	1	32	0	0
16	10338255	.	C	G	2	2	4	0	1	5	0	0
16	10339682	.	G	A	2	4	6	0	0	6	0	0
16	10339709	.	A	C	3	2	5	0	0	5	0	0
16	10340349	.	G	A	4	1	5	0	2	7	0	0
16	10340621	.	T	A	0	3	3	0	0	3	0	0
16	10340630	.	G	C	1	3	4	0	1	5	0	0
16	10340840	.	G	A	2	5	7	0	1	8	0	0
16	10340935	.	G	C	5	10	15	0	0	15	0	0
16	10340941	.	T	C	10	5	15	0	0	15	0	0
16	10341377	.	A	T	2	2	4	0	0	4	0	0
16	10341470	.	G	A	4	2	6	0	2	8	0	0
16	10341508	.	A	G	5	3	8	0	1	9	0	0
16	10341548	.	G	A	3	5	8	0	0	8	0	0
16	10341778	.	C	A	5	5	10	0	0	10	0	0
16	10341881	.	A	G	5	3	8	0	0	8	0	0
16	10342169	.	C	T	1	2	3	0	0	3	0	0
16	10342275	.	C	T	1	0	1	0	0	1	0	0
16	10345595	.	A	G	6	8	14	0	1	15	0	0
16	10368086	.	A	T	1	2	3	0	0	3	0	0
16	10368452	.	T	A	1	3	4	0	0	4	0	0
16	10368713	.	G	T	4	4	8	0	0	8	0	0
16	10369266	.	G	A	3	3	6	0	0	6	0	0
16	10413815	.	C	A	5	4	9	0	0	9	0	0
16	10426335	.	T	C	1	4	5	0	0	5	0	0
16	10426343	.	T	A	1	4	5	0	0	5	0	0
16	10427576	.	G	A	2	4	6	0	0	6	0	0
16	10427590	.	G	C	2	3	5	0	0	5	0	0
16	10427746	.	T	G	0	5	5	0	0	5	0	0
16	10427786	.	T	G	1	2	3	0	0	3	0	0
16	10427964	.	A	C	3	6	9	0	0	9	0	0
16	10445228	.	C	T	0	1	1	0	0	1	0	0
16	10447983	.	C	T	0	2	2	0	0	2	0	0
16	10459006	.	C	A	0	1	1	0	0	1	0	0
16	10461712	.	A	T	0	1	1	0	0	1	0	0
16	10464570	.	T	C	4	2	6	0	0	6	0	0
16	10468283	.	T	C	4	4	8	0	0	8	0	0
16	10472192	.	T	C	1	1	2	0	0	2	0	0
16	10475006	.	C	T	15	13	28	0	0	28	0	0
16	10475646	.	A	G	7	4	11	0	1	12	0	0
16	10477836	.	C	T	0	13	13	0	11	24	0	0
16	10478061	.	G	T	12	15	27	0	1	28	0	0
16	10481488	.	C	T	0	4	4	0	5	9	0	0
16	10489410	.	G	A	3	2	5	0	0	5	0	0
16	10502069	.	A	G	0	1	1	0	0	1	0	0
16	10504444	.	C	A	0	2	2	0	0	2	0	0
16	10506411	.	C	T	2	1	3	0	0	3	0	0
16	10620183	.	T	C	1	2	3	0	0	3	0	0
16	10620213	.	C	T	1	1	2	0	0	2	0	0
16	10634271	.	C	T	2	2	4	0	1	5	0	0
16	10634460	.	T	C	1	4	5	0	0	5	0	0
16	10634510	.	C	T	3	4	7	0	0	7	0	0
16	10635338	.	A	T	4	9	13	0	0	13	0	0
16	10635401	.	T	G	10	10	20	0	1	21	0	0
16	10635532	.	T	C	4	3	7	0	0	7	0	0
16	10635551	.	A	C	6	4	10	0	0	10	0	0
16	10635838	.	T	C	7	5	12	0	1	13	0	0
16	10635927	.	A	G	2	6	8	0	0	8	0	0
16	10636418	.	T	C	1	4	5	0	2	7	0	0
16	10636671	.	C	T	3	9	12	0	0	12	0	0
16	10636698	.	T	A	8	5	13	0	1	14	0	0
16	10636882	.	C	T	10	5	15	0	2	17	0	0
16	10637050	.	C	T	6	15	21	0	1	22	0	0
16	10637192	.	G	A	0	3	3	0	2	5	0	0
16	10637329	.	C	A	6	11	17	0	1	18	0	0
16	10637379	.	T	A	11	11	22	0	0	22	0	0
16	10637510	.	T	C	6	13	19	0	2	21	0	0
16	10637544	.	T	C	2	13	15	0	1	16	0	0
16	10637629	.	T	C	1	6	7	0	0	7	0	0
16	10637943	.	T	A	6	4	10	0	1	11	0	0
16	10731571	.	A	T	2	5	7	0	1	8	0	0
16	10731648	.	T	C	2	2	4	0	4	8	0	0
16	10731968	.	A	C	2	5	7	0	0	7	0	0
16	10731995	.	G	A	1	4	5	0	0	5	0	0
16	10732218	.	T	C	5	2	7	0	0	7	0	0
16	10732268	.	A	G	1	4	5	0	0	5	0	0
16	10795620	.	G	A	4	2	6	0	0	6	0	0
16	10799155	.	T	C	4	3	7	0	0	7	0	0
16	10801121	.	G	A	2	5	7	0	0	7	0	0
16	10801127	.	T	C	2	5	7	0	0	7	0	0
16	10801374	.	T	C	4	3	7	0	0	7	0	0
16	10801422	.	G	A	1	0	1	0	0	1	0	0
16	10801517	.	T	C	2	2	4	0	0	4	0	0
16	10806318	.	C	T	0	1	1	0	0	1	0	0
16	10807360	.	T	A	18	7	25	0	1	26	0	0
16	10807471	.	A	G	13	8	21	0	1	22	0	0
16	10807486	.	C	T	9	7	16	0	2	18	0	0
16	10813372	.	C	T	15	13	28	0	1	29	0	0
16	10819971	.	C	T	30	20	50	0	2	52	0	0
16	10819972	.	C	T	20	19	39	0	13	52	0	0
16	10820157	.	G	A	0	35	35	0	31	66	0	0
16	10820215	.	A	T	25	35	60	0	4	64	0	0
16	10820224	.	T	A	27	37	64	0	2	66	0	0
16	10820803	.	C	T	26	26	52	0	14	66	0	0
16	10820866	.	A	G	21	19	40	0	1	41	0	0
16	10828887	.	T	C	3	1	4	0	0	4	0	0
16	10829276	.	T	A	7	4	11	0	0	11	0	0
16	10829458	.	T	C	12	0	12	0	16	28	0	0
16	10829569	.	A	T	21	2	23	0	0	23	0	0
16	10829633	.	A	T	4	9	13	0	0	13	0	0
16	10829635	.	A	C	4	8	12	0	1	13	0	0
16	10829968	.	T	G	7	12	19	0	0	19	0	0
16	10830013	.	T	G	6	7	13	0	2	15	0	0
16	10830145	.	T	G	6	4	10	0	0	10	0	0
16	10830147	.	T	A	5	4	9	0	1	10	0	0
16	10830309	.	T	A	4	7	11	0	2	13	0	0
16	10830328	.	T	C	3	10	13	0	1	14	0	0
16	10830625	.	G	C	3	1	4	0	0	4	0	0
16	10833900	.	C	G	1	3	4	0	0	4	0	0
16	10833987	.	G	A	5	4	9	0	0	9	0	0
16	10841612	.	T	C	3	3	6	0	0	6	0	0
16	10846654	.	A	G	5	5	10	0	1	11	0	0
16	10855924	.	A	G	9	7	16	0	3	19	0	0
16	10856130	.	A	G	5	8	13	0	0	13	0	0
16	10856235	.	C	G	8	5	13	0	3	16	0	0
16	10856406	.	A	T	13	4	17	0	0	17	0	0
16	10858554	.	G	A	10	7	17	0	1	18	0	0
16	10858656	.	A	G	17	10	27	0	1	28	0	0
16	10859434	.	C	T	18	21	39	0	2	41	0	0
16	10859435	.	T	C	20	20	40	0	1	41	0	0
16	10859857	.	T	C	33	21	54	0	2	56	0	0
16	10861956	.	A	G	26	17	43	0	3	46	0	0
16	10861971	.	T	A	21	20	41	0	0	41	0	0
16	10862331	.	C	G	23	9	32	0	4	36	0	0
16	10862627	.	G	A	2	21	23	0	34	57	0	0
16	10862762	.	C	T	22	22	44	0	2	46	0	0
16	10862773	.	T	C	23	27	50	0	1	51	0	0
16	10990344	.	A	G	1	2	3	0	0	3	0	0
16	11139008	.	G	A	0	2	2	0	3	5	0	0
16	11139933	.	A	G	4	2	6	0	1	7	0	0
16	11140001	.	A	G	5	0	5	0	2	7	0	0
16	11140004	.	G	A	5	1	6	0	0	6	0	0
16	11140151	.	T	C	4	2	6	0	0	6	0	0
16	11140267	.	A	G	2	1	3	0	0	4	1	0
16	11140274	.	G	T	2	3	5	0	0	5	0	0
16	11140364	.	A	G	4	8	12	0	0	12	0	0
16	11140475	.	T	C	7	3	10	0	2	12	0	0
16	11140494	.	T	C	6	4	10	0	0	10	0	0
16	11140542	.	G	T	0	3	3	0	3	7	1	0
16	11140643	.	A	C	1	2	3	0	0	3	0	0
16	11140896	.	G	A	3	6	9	0	0	9	0	0
16	11141451	.	C	G	3	2	5	0	0	5	0	0
16	11141466	.	A	T	1	4	5	0	1	6	0	0
16	11141908	.	G	A	0	7	7	0	11	18	0	0
16	11142018	.	G	A	0	5	5	0	12	17	0	0
16	11142064	.	G	A	7	5	12	0	0	12	0	0
16	11142111	.	A	G	4	8	12	0	1	13	0	0
16	11151884	.	G	A	1	2	3	0	0	3	0	0
16	11166908	.	G	A	2	3	5	0	1	6	0	0
16	11167436	.	G	A	2	3	5	0	0	5	0	0
16	11170152	.	C	G	1	4	5	0	4	9	0	0
16	11188937	.	G	A	0	1	1	0	1	2	0	0
16	11193643	.	A	G	4	2	6	0	0	6	0	0
16	11193652	.	A	G	4	0	4	0	4	8	0	0
16	11195922	.	G	A	1	0	1	0	0	1	0	0
16	11199220	.	C	T	6	4	10	0	1	11	0	0
16	11199293	.	T	C	4	3	7	0	1	8	0	0
16	11206313	.	A	C	3	4	7	0	0	7	0	0
16	11206316	.	C	T	3	5	8	0	1	9	0	0
16	11212111	.	C	A	18	11	29	0	1	30	0	0
16	11212332	.	A	T	3	13	16	0	3	19	0	0
16	11212398	.	A	G	6	20	26	0	2	28	0	0
16	11212438	.	A	G	12	0	12	0	19	31	0	0
16	11215495	.	C	T	14	11	25	0	2	27	0	0
16	11215515	.	T	C	17	17	34	0	2	36	0	0
16	11221071	.	A	G	19	9	28	0	2	30	0	0
16	11221398	.	G	A	20	8	28	0	1	29	0	0
16	11221406	.	A	C	19	8	27	0	3	30	0	0
16	11221667	.	A	G	11	12	23	0	0	23	0	0
16	11222030	.	T	A	12	3	15	0	2	17	0	0
16	11222139	.	G	A	17	13	30	0	1	31	0	0
16	11222738	.	G	A	0	16	16	0	24	40	0	0
16	11222873	.	A	G	1	0	1	0	2	3	0	0
16	11222880	.	C	A	1	2	3	0	0	3	0	0
16	11227434	.	C	T	6	3	9	0	0	9	0	0
16	11227611	.	G	A	6	5	11	0	0	11	0	0
16	11227813	.	A	T	1	5	6	0	1	7	0	0
16	11227865	.	C	T	3	2	5	0	0	5	0	0
16	11228292	.	T	G	6	7	13	0	0	13	0	0
16	11228358	.	C	A	0	5	5	0	4	9	0	0
16	11228978	.	G	A	2	2	4	0	0	4	0	0
16	11228979	.	G	A	2	2	4	0	0	4	0	0
16	11229095	.	A	G	2	3	5	0	0	5	0	0
16	11231348	.	G	A	1	3	4	0	0	4	0	0
16	11242495	.	T	A	5	2	7	0	0	7	0	0
16	11266016	.	T	G	3	3	6	0	0	6	0	0
16	11275795	.	C	T	4	5	9	0	2	11	0	0
16	11275980	.	A	G	4	1	5	0	3	8	0	0
16	11290844	.	C	A	9	9	18	0	2	20	0	0
16	11290975	.	A	C	5	11	16	0	2	18	0	0
16	11291799	.	T	C	16	22	38	0	1	39	0	0
16	11291803	.	G	A	15	20	35	0	2	37	0	0
16	11344446	.	G	A	0	2	2	0	1	3	0	0
16	11530746	.	T	G	0	1	1	0	0	1	0	0
16	11531018	.	A	G	4	3	7	0	0	7	0	0
16	11531069	.	T	C	2	2	4	0	0	4	0	0
16	11533864	.	T	C	2	2	4	0	0	4	0	0
16	11533897	.	C	T	1	0	1	0	0	1	0	0
16	11541776	.	T	C	1	0	1	0	0	1	0	0
16	11542083	.	C	T	10	6	16	0	0	16	0	0
16	11544525	.	C	T	8	3	11	0	2	13	0	0
16	11544636	.	A	G	3	2	5	0	0	5	0	0
16	11544645	.	A	T	3	2	5	0	0	5	0	0
16	11544672	.	T	C	3	2	5	0	0	5	0	0
16	11554859	.	C	T	14	4	18	0	1	19	0	0
16	11554874	.	A	G	11	0	11	0	9	20	0	0
16	11554907	.	T	C	11	1	12	0	3	15	0	0
16	11554916	.	A	G	11	4	15	0	1	16	0	0
16	11554970	.	A	C	12	11	23	0	2	26	1	0
16	11555034	.	A	C	18	9	27	0	3	30	0	0
16	11555160	.	C	T	16	16	32	0	1	33	0	0
16	11555542	.	T	A	17	15	32	0	8	40	0	0
16	11774168	.	G	A	15	6	21	0	2	23	0	0
16	11774291	.	G	A	13	9	22	0	2	24	0	0
16	11774361	.	T	C	9	9	18	0	2	20	0	0
16	11774790	.	A	T	8	6	14	0	1	15	0	0
16	11774948	.	T	A	8	9	17	0	4	21	0	0
16	11775200	.	A	G	5	2	7	0	1	8	0	0
16	11775279	.	T	C	1	4	5	0	1	6	0	0
16	11775361	.	T	C	8	9	17	0	1	18	0	0
16	11775614	.	G	A	11	12	23	0	1	24	0	0
16	11775683	.	T	C	5	10	15	0	2	17	0	0
16	11778299	.	G	A	3	3	6	0	0	6	0	0
16	11778302	.	T	A	3	3	6	0	0	6	0	0
16	11965673	.	G	T	19	23	42	0	3	45	0	0
16	11965803	.	G	T	21	22	43	0	0	44	1	0
16	11965931	.	T	C	25	2	27	0	24	51	0	0
16	11968056	.	A	G	10	8	18	0	3	21	0	0
16	11970128	.	A	G	3	10	13	0	0	13	0	0
16	11970161	.	G	A	6	16	22	0	3	25	0	0
16	11978028	.	A	G	4	8	12	0	0	12	0	0
16	11978045	.	G	A	7	6	13	0	1	14	0	0
16	11978094	.	A	C	4	6	10	0	0	10	0	0
16	11979494	.	G	A	2	2	4	0	0	4	0	0
16	11982323	.	G	A	0	4	4	0	0	4	0	0
16	11982507	.	T	A	0	0	0	0	1	1	0	0
16	11982519	.	G	T	0	1	1	0	0	1	0	0
16	11986208	.	G	A	2	4	6	0	0	6	0	0
16	11986257	.	G	A	5	9	14	0	1	15	0	0
16	11986258	.	C	T	0	10	10	0	5	15	0	0
16	11999767	.	T	C	1	7	8	0	0	8	0	0
16	12052487	.	T	C	3	2	5	0	0	5	0	0
16	12054138	.	C	T	0	2	2	0	1	3	0	0
16	12064771	.	T	A	3	7	10	0	0	10	0	0
16	12064906	.	A	T	8	12	20	0	0	20	0	0
16	12065201	.	C	T	15	13	28	0	3	31	0	0
16	12065410	.	A	G	10	7	17	0	1	18	0	0
16	12069729	.	C	T	0	8	8	0	7	15	0	0
16	12076492	.	A	G	3	5	8	0	1	9	0	0
16	12078916	.	A	G	1	1	2	0	0	2	0	0
16	12078976	.	C	T	1	1	2	0	0	2	0	0
16	12095103	.	T	C	1	1	2	0	0	2	0	0
16	12102432	.	T	A	20	23	43	0	5	48	0	0
16	12102492	.	A	T	31	25	56	0	0	56	0	0
16	12102709	.	G	A	34	32	66	0	5	71	0	0
16	12103263	.	A	T	28	28	56	0	2	58	0	0
16	12103292	.	A	T	31	17	48	0	8	56	0	0
16	12103598	.	G	A	24	16	40	0	2	42	0	0
16	12103732	.	C	T	0	9	9	0	16	25	0	0
16	12103934	.	C	T	14	25	39	0	4	43	0	0
16	12103941	.	A	G	15	30	45	0	2	47	0	0
16	12104209	.	A	C	26	7	33	0	1	34	0	0
16	12104316	.	T	A	24	10	34	0	0	34	0	0
16	12104454	.	T	C	26	10	36	0	2	38	0	0
16	12104455	.	G	A	27	10	37	0	1	38	0	0
16	12104905	.	A	T	25	5	30	0	3	34	1	0
16	12104925	.	C	G	21	12	33	0	3	36	0	0
16	12105689	.	C	T	0	15	15	0	8	23	0	0
16	12105720	.	T	C	11	12	23	0	1	24	0	0
16	12105854	.	A	G	16	20	36	0	2	38	0	0
16	12108607	.	G	A	9	19	28	0	4	32	0	0
16	12114975	.	G	A	3	7	10	0	0	10	0	0
16	12127040	.	A	G	1	1	2	0	0	2	0	0
16	12138841	.	G	A	3	3	6	0	0	6	0	0
16	12150415	.	T	C	1	0	1	0	1	2	0	0
16	12150457	.	A	G	2	4	6	0	0	6	0	0
16	12150460	.	C	T	2	4	6	0	0	6	0	0
16	12173406	.	A	G	2	3	5	0	0	5	0	0
16	12175007	.	A	T	5	5	10	0	0	10	0	0
16	12175047	.	T	G	2	4	6	0	0	6	0	0
16	12475434	.	T	A	2	2	4	0	0	4	0	0
16	12475624	.	G	A	1	2	3	0	1	4	0	0
16	12505303	.	G	T	27	24	51	0	4	55	0	0
16	12637779	.	C	T	6	2	8	0	0	8	0	0
16	12638349	.	A	C	1	2	3	0	1	4	0	0
16	12639156	.	T	A	4	7	11	0	0	11	0	0
16	12639161	.	C	G	4	0	4	0	7	11	0	0
16	12639377	.	T	G	2	9	11	0	2	13	0	0
16	12639503	.	T	G	2	4	6	0	0	6	0	0
16	12740926	.	C	T	1	3	4	0	1	5	0	0
16	12747312	.	A	G	6	8	14	0	0	14	0	0
16	12748517	.	A	T	5	4	9	0	0	9	0	0
16	12748568	.	T	C	15	5	20	0	1	21	0	0
16	12748646	.	G	A	0	10	10	0	15	25	0	0
16	12748857	.	G	A	1	2	3	0	0	3	0	0
16	12748908	.	G	C	0	6	6	0	12	18	0	0
16	12748989	.	T	C	3	4	7	0	1	8	0	0
16	12754690	.	C	T	2	6	8	0	1	9	0	0
16	12754849	.	T	C	13	17	30	0	2	32	0	0
16	12755260	.	G	A	0	20	20	0	15	35	0	0
16	12755992	.	C	T	26	16	42	0	0	42	0	0
16	12756051	.	G	T	20	17	37	0	2	39	0	0
16	12756255	.	C	T	16	10	26	0	2	28	0	0
16	12793932	.	A	G	3	1	4	0	1	5	0	0
16	12793969	.	A	G	3	2	5	0	0	5	0	0
16	12794028	.	A	G	5	4	9	0	0	9	0	0
16	12809604	.	T	C	2	0	2	0	0	2	0	0
16	12816486	.	T	C	3	4	7	0	0	7	0	0
16	12816745	.	A	C	4	4	8	0	1	9	0	0
16	12818220	.	G	T	4	2	6	0	0	6	0	0
16	12963064	.	T	C	3	3	6	0	0	6	0	0
16	12963109	.	A	G	4	6	10	0	2	12	0	0
16	12963696	.	T	G	18	27	45	0	12	57	0	0
16	12963975	.	A	G	22	22	44	0	2	46	0	0
16	13180298	.	T	C	2	6	8	0	0	8	0	0
16	13180389	.	T	C	2	12	14	0	0	14	0	0
16	13569025	.	G	A	1	3	4	0	0	4	0	0
16	13569058	.	T	A	1	3	4	0	1	5	0	0
16	13600680	.	A	C	11	16	27	0	2	29	0	0
16	13601026	.	T	C	11	8	19	0	1	20	0	0
16	13602164	.	T	C	2	10	12	0	1	13	0	0
16	13602454	.	T	A	9	7	16	0	1	17	0	0
16	13602488	.	T	C	6	4	10	0	0	10	0	0
16	13602697	.	A	G	4	3	7	0	1	8	0	0
16	13602800	.	T	A	4	3	7	0	1	8	0	0
16	13603375	.	C	T	1	2	3	0	0	3	0	0
16	13606896	.	A	T	1	1	2	0	0	2	0	0
16	13606977	.	G	A	3	7	10	0	1	11	0	0
16	13610726	.	T	A	7	5	12	0	2	14	0	0
16	13610882	.	G	A	7	5	12	0	1	13	0	0
16	13610966	.	A	G	4	6	10	0	0	10	0	0
16	13611035	.	G	A	2	6	8	0	1	9	0	0
16	13617023	.	C	T	0	14	14	0	9	23	0	0
16	13617152	.	C	T	7	17	24	0	0	24	0	0
16	13617291	.	G	A	7	7	14	0	0	14	0	0
16	13617329	.	T	G	10	3	13	0	0	13	0	0
16	13618170	.	A	G	5	11	16	0	2	18	0	0
16	13618172	.	C	G	10	5	15	0	3	18	0	0
16	13618374	.	A	T	8	5	13	0	1	14	0	0
16	13618644	.	T	A	11	5	16	0	0	16	0	0
16	13619001	.	A	C	7	5	12	0	0	12	0	0
16	13619436	.	A	G	3	5	8	0	0	8	0	0
16	13619448	.	T	C	3	4	7	0	1	8	0	0
16	13621056	.	G	A	0	2	2	0	0	2	0	0
16	13636760	.	G	A	11	11	22	0	0	22	0	0
16	13643969	.	C	A	3	5	8	0	0	8	0	0
16	13644509	.	A	T	4	2	6	0	0	6	0	0
16	13644781	.	T	A	0	3	3	0	1	4	0	0
16	13645076	.	A	T	3	3	6	0	1	7	0	0
16	13645242	.	G	C	3	2	5	0	0	5	0	0
16	13673143	.	T	C	5	9	14	0	4	18	0	0
16	13673660	.	T	A	2	2	4	0	0	4	0	0
16	13673734	.	A	C	10	7	17	0	0	17	0	0
16	13701482	.	C	T	4	1	5	0	1	6	0	0
16	13701599	.	A	G	3	1	4	0	1	5	0	0
16	13706061	.	G	A	2	1	3	0	1	4	0	0
16	13706207	.	G	C	5	4	9	0	0	9	0	0
16	13706714	.	G	T	4	3	7	0	0	7	0	0
16	13721408	.	C	T	7	4	11	0	2	13	0	0
16	13721420	.	G	A	5	8	13	0	0	13	0	0
16	13729810	.	C	T	2	1	3	0	1	4	0	0
16	13741584	.	C	T	1	2	3	0	0	3	0	0
16	13826195	.	C	T	2	2	4	0	0	4	0	0
16	13841360	.	T	A	4	3	7	0	0	7	0	0
16	13845368	.	G	A	0	10	10	0	15	25	0	0
16	13845846	.	A	G	4	12	16	0	2	18	0	0
16	13855472	.	T	C	6	8	14	0	0	14	0	0
16	13855482	.	T	A	7	5	12	0	0	12	0	0
16	13870508	.	A	C	3	7	10	0	0	10	0	0
16	13870517	.	A	G	2	8	10	0	1	11	0	0
16	13870685	.	A	C	4	3	7	0	1	8	0	0
16	13870857	.	T	A	5	5	10	0	2	12	0	0
16	13883968	.	C	A	7	3	10	0	0	10	0	0
16	13883980	.	A	C	7	3	10	0	0	10	0	0
16	14021817	.	G	T	3	7	10	0	0	10	0	0
16	14021886	.	C	T	0	5	5	0	1	6	0	0
16	14021907	.	T	A	0	4	4	0	0	4	0	0
16	14022035	.	A	C	6	4	10	0	0	10	0	0
16	14022445	.	T	C	7	8	15	0	0	15	0	0
16	14022585	.	C	A	3	7	10	0	1	11	0	0
16	14022697	.	T	A	7	4	11	0	0	11	0	0
16	14022842	.	A	G	4	2	6	0	0	6	0	0
16	14029359	.	A	C	5	2	7	0	0	7	0	0
16	14039604	.	T	C	0	1	1	0	0	1	0	0
16	14051150	.	G	C	8	10	18	0	1	19	0	0
16	14051249	.	T	C	8	9	17	0	0	17	0	0
16	14051329	.	A	T	8	11	19	0	0	19	0	0
16	14051339	.	A	C	8	9	17	0	2	19	0	0
16	14052681	.	A	G	7	11	18	0	1	19	0	0
16	14052735	.	C	G	5	7	12	0	0	12	0	0
16	14052743	.	G	A	4	5	9	0	0	9	0	0
16	14055071	.	A	T	0	2	2	0	0	2	0	0
16	14093909	.	T	A	3	2	5	0	0	5	0	0
16	14094219	.	A	G	5	4	9	0	0	9	0	0
16	14094222	.	C	A	4	4	8	0	0	8	0	0
16	14094364	.	A	C	9	4	13	0	0	13	0	0
16	14094422	.	C	G	12	15	27	0	1	28	0	0
16	14094601	.	G	A	10	11	21	0	0	21	0	0
16	14094604	.	T	A	10	10	20	0	0	20	0	0
16	14094640	.	G	T	11	7	18	0	0	18	0	0
16	14094668	.	T	A	11	8	19	0	1	20	0	0
16	14094801	.	C	T	14	0	14	0	0	14	0	0
16	14094806	.	G	A	14	0	14	0	0	14	0	0
16	14095097	.	C	T	0	8	8	0	5	13	0	0
16	14095126	.	T	A	4	5	9	0	0	9	0	0
16	14095176	.	A	T	4	3	7	0	0	7	0	0
16	14095183	.	G	C	4	3	7	0	0	7	0	0
16	14095279	.	C	A	11	11	22	0	0	22	0	0
16	14095397	.	A	C	8	7	15	0	3	19	1	0
16	14098014	.	C	T	2	9	11	0	1	12	0	0
16	14101832	.	G	A	1	3	4	0	1	5	0	0
16	14101864	.	T	C	3	4	7	0	4	11	0	0
16	14126267	.	C	T	8	2	10	0	0	10	0	0
16	14126294	.	T	C	5	1	6	0	0	6	0	0
16	14133317	.	G	A	2	4	6	0	1	7	0	0
16	14133521	.	G	A	13	5	18	0	2	20	0	0
16	14133721	.	C	T	3	3	6	0	1	7	0	0
16	14133734	.	A	C	5	2	7	0	0	7	0	0
16	14133874	.	C	T	2	2	4	0	0	4	0	0
16	14133910	.	C	G	1	2	3	0	1	4	0	0
16	14134020	.	C	T	0	7	7	0	5	12	0	0
16	14134116	.	A	T	0	1	1	0	0	1	0	0
16	14154150	.	T	G	4	3	7	0	0	7	0	0
16	14154240	.	T	A	3	8	11	0	0	11	0	0
16	14155997	.	A	T	2	2	4	0	1	5	0	0
16	14156775	.	C	A	0	3	3	0	2	5	0	0
16	14202111	.	A	C	1	2	3	0	0	3	0	0
16	14202116	.	C	T	2	2	4	0	0	4	0	0
16	14202192	.	A	C	1	8	9	0	0	9	0	0
16	14202197	.	T	A	1	6	7	0	1	8	0	0
16	14209142	.	A	C	2	3	5	0	0	5	0	0
16	14209195	.	G	A	2	3	5	0	0	5	0	0
16	14209348	.	T	C	8	6	14	0	1	15	0	0
16	14210949	.	A	C	0	2	2	0	0	2	0	0
16	14212079	.	G	C	0	8	8	0	4	12	0	0
16	14214961	.	G	C	1	0	1	0	0	1	0	0
16	14215565	.	C	G	1	2	3	0	0	3	0	0
16	14229574	.	A	G	3	2	5	0	2	7	0	0
16	14229614	.	A	G	0	4	4	0	2	6	0	0
16	14230373	.	T	C	3	3	6	0	0	6	0	0
16	14231135	.	G	A	0	6	6	0	9	15	0	0
16	14231138	.	C	T	8	6	14	0	1	15	0	0
16	14231207	.	T	A	8	7	15	0	0	15	0	0
16	14231928	.	C	A	16	15	31	0	2	33	0	0
16	14242688	.	C	T	0	2	2	0	3	5	0	0
16	14242811	.	A	G	3	3	6	0	2	8	0	0
16	14249570	.	G	C	1	1	2	0	0	2	0	0
16	14258294	.	C	T	1	2	3	0	0	3	0	0
16	14416622	.	C	T	7	2	9	0	0	9	0	0
16	14588225	.	A	C	1	4	5	0	0	5	0	0
16	14671227	.	C	T	1	6	7	0	0	7	0	0
16	14674706	.	C	T	8	9	17	0	0	17	0	0
16	14674718	.	T	G	8	10	18	0	3	21	0	0
16	14674788	.	T	G	4	6	10	0	0	10	0	0
16	14674801	.	G	T	4	4	8	0	0	8	0	0
16	14674923	.	A	T	5	4	9	0	0	9	0	0
16	14675101	.	T	A	6	7	13	0	1	14	0	0
16	14675373	.	A	C	8	12	20	0	0	20	0	0
16	14675513	.	A	C	6	4	10	0	2	12	0	0
16	14675658	.	A	G	9	13	22	0	2	24	0	0
16	14675780	.	A	G	11	3	14	0	1	15	0	0
16	15034906	.	C	T	4	1	5	0	0	5	0	0
16	15037775	.	G	A	3	1	4	0	2	6	0	0
16	15037778	.	C	T	1	3	4	0	1	5	0	0
16	15048253	.	T	C	2	9	11	0	0	11	0	0
16	15048338	.	G	A	0	8	8	0	10	18	0	0
16	15048645	.	G	A	2	4	6	0	1	7	0	0
16	15049760	.	A	C	2	3	5	0	1	6	0	0
16	15050195	.	T	C	3	7	10	0	3	13	0	0
16	15050277	.	G	A	5	7	12	0	0	12	0	0
16	15050372	.	C	T	14	16	30	0	3	33	0	0
16	15050478	.	T	A	14	7	21	0	1	22	0	0
16	15140987	.	G	A	0	2	2	0	1	3	0	0
16	15143512	.	G	A	3	1	4	0	0	4	0	0
16	15168740	.	G	A	0	1	1	0	0	1	0	0
16	16042986	.	T	C	8	6	14	0	3	17	0	0
16	16078951	.	A	G	1	2	3	0	1	4	0	0
16	16165179	.	T	A	37	26	63	0	1	64	0	0
16	16165361	.	A	G	31	37	68	0	4	72	0	0
16	16165418	.	C	T	40	19	59	0	8	67	0	0
16	16165725	.	A	C	33	38	71	0	4	75	0	0
16	16212520	.	A	G	3	1	4	0	0	4	0	0
16	16232963	.	T	C	3	2	5	0	2	7	0	0
16	16233410	.	A	G	7	3	10	0	1	11	0	0
16	16234309	.	C	A	0	6	6	0	6	12	0	0
16	16234840	.	A	T	4	6	10	0	2	12	0	0
16	16269926	.	G	C	1	3	4	0	0	4	0	0
16	16269964	.	T	C	2	2	4	0	1	5	0	0
16	16270424	.	T	C	0	3	3	0	0	3	0	0
16	16276938	.	T	C	1	2	3	0	0	3	0	0
16	16278172	.	G	T	0	4	4	0	2	6	0	0
16	16281740	.	A	C	2	6	8	0	0	8	0	0
16	16283706	.	A	G	0	2	2	0	4	6	0	0
16	16284057	.	T	C	5	6	11	0	2	13	0	0
16	16284159	.	G	A	0	10	10	0	7	17	0	0
16	16284192	.	C	A	7	9	16	0	2	18	0	0
16	16289121	.	C	T	3	6	9	0	0	9	0	0
16	16302166	.	T	C	9	7	16	0	0	16	0	0
16	16302247	.	A	T	9	7	16	0	1	17	0	0
16	16302371	.	A	C	8	12	20	0	2	22	0	0
16	16302426	.	T	A	8	8	16	0	2	18	0	0
16	16302477	.	G	A	1	10	11	0	11	22	0	0
16	16302835	.	T	C	12	8	20	0	3	23	0	0
16	16303025	.	C	T	16	23	39	0	2	41	0	0
16	16303065	.	A	G	14	15	29	0	3	32	0	0
16	16303086	.	T	A	16	10	26	0	2	28	0	0
16	16303163	.	G	A	0	13	13	0	7	20	0	0
16	16303196	.	A	G	8	0	8	0	14	22	0	0
16	16303293	.	T	G	8	8	16	0	0	16	0	0
16	16553899	.	C	T	7	5	12	0	0	12	0	0
16	16554053	.	G	A	2	3	5	0	0	5	0	0
16	16555611	.	A	G	11	9	20	0	0	20	0	0
16	16555975	.	T	A	3	5	8	0	0	8	0	0
16	16565963	.	G	C	2	6	8	0	0	8	0	0
16	16565998	.	C	T	1	3	4	0	0	4	0	0
16	16566182	.	T	C	2	1	3	0	2	5	0	0
16	16566402	.	G	A	0	1	1	0	0	1	0	0
16	16569047	.	G	A	2	0	2	0	1	3	0	0
16	16574168	.	T	C	1	0	1	0	0	1	0	0
16	16586290	.	G	A	4	3	7	0	0	7	0	0
16	16589462	.	G	A	0	1	1	0	0	1	0	0
16	16589552	.	G	A	1	1	2	0	1	3	0	0
16	16590715	.	T	C	1	3	4	0	0	4	0	0
16	16597863	.	A	G	3	2	5	0	0	5	0	0
16	16908487	.	C	T	1	3	4	0	0	4	0	0
16	16916699	.	G	A	1	3	4	0	1	5	0	0
16	16940732	.	A	G	1	5	6	0	0	6	0	0
16	16940768	.	A	G	4	0	4	0	7	11	0	0
16	16941121	.	G	A	0	6	6	0	3	9	0	0
16	16941237	.	G	A	0	8	8	0	8	16	0	0
16	16941270	.	G	A	1	8	9	0	6	15	0	0
16	16941343	.	G	A	5	5	10	0	0	10	0	0
16	16941361	.	T	C	7	3	10	0	1	11	0	0
16	16941394	.	C	T	5	6	11	0	0	11	0	0
16	16941741	.	C	T	5	5	10	0	1	11	0	0
16	16941979	.	C	A	5	3	8	0	0	8	0	0
16	16942001	.	G	A	0	4	4	0	2	6	0	0
16	16942200	.	C	T	11	7	18	0	0	18	0	0
16	16942332	.	G	A	5	3	8	0	1	9	0	0
16	16942867	.	A	G	7	11	18	0	1	19	0	0
16	16942906	.	C	G	8	7	15	0	0	15	0	0
16	16942953	.	A	G	7	7	14	0	0	14	0	0
16	16943258	.	C	A	11	7	18	0	0	18	0	0
16	16943348	.	C	A	7	6	13	0	0	13	0	0
16	16943388	.	T	A	11	3	14	0	0	14	0	0
16	16943651	.	A	T	8	12	20	0	0	20	0	0
16	16944023	.	G	T	6	13	19	0	0	19	0	0
16	16944066	.	T	C	6	7	13	0	2	15	0	0
16	16944142	.	A	T	9	9	18	0	1	19	0	0
16	16944150	.	T	C	8	11	19	0	0	19	0	0
16	16944884	.	A	G	12	7	19	0	2	21	0	0
16	16945208	.	C	T	3	3	6	0	0	6	0	0
16	16945261	.	A	G	4	4	8	0	2	10	0	0
16	16945328	.	G	A	5	7	12	0	1	13	0	0
16	16945365	.	T	G	3	14	17	0	2	19	0	0
16	16945585	.	A	C	4	2	6	0	5	11	0	0
16	16985499	.	C	T	6	5	11	0	0	11	0	0
16	16985511	.	A	T	2	2	4	0	0	4	0	0
16	17122132	.	C	A	0	3	3	0	3	6	0	0
16	17162524	.	C	A	4	2	6	0	0	6	0	0
16	17194355	.	A	G	1	1	2	0	0	2	0	0
16	17195160	.	G	A	0	2	2	0	0	2	0	0
16	17195343	.	A	G	0	2	2	0	0	2	0	0
16	17235001	.	G	A	4	6	10	0	1	11	0	0
16	17235018	.	A	T	4	8	12	0	1	13	0	0
16	17240607	.	C	G	1	2	3	0	0	3	0	0
16	17252909	.	G	C	10	6	16	0	0	16	0	0
16	17253056	.	T	C	5	11	16	0	1	17	0	0
16	17253085	.	C	T	6	7	13	0	1	14	0	0
16	17253274	.	T	C	3	8	11	0	0	11	0	0
16	17302526	.	T	C	3	5	8	0	0	8	0	0
16	17302821	.	A	G	1	2	3	0	0	3	0	0
16	17467361	.	G	A	0	2	2	0	4	6	0	0
16	17560294	.	G	A	0	1	1	0	0	1	0	0
16	17581021	.	A	T	6	4	10	0	1	11	0	0
16	17639989	.	T	A	2	12	14	0	1	15	0	0
16	17640184	.	C	T	8	8	16	0	3	19	0	0
16	17640297	.	G	A	7	9	16	0	2	18	0	0
16	17640550	.	A	T	9	8	17	0	1	18	0	0
16	17640693	.	G	A	5	5	10	0	0	10	0	0
16	17646269	.	T	C	5	3	8	0	0	8	0	0
16	17763933	.	T	A	2	3	5	0	0	5	0	0
16	17764238	.	G	A	3	6	9	0	0	9	0	0
16	17798055	.	T	C	5	14	19	0	2	21	0	0
16	17798056	.	C	T	5	15	20	0	1	21	0	0
16	18146283	.	A	G	4	2	6	0	1	7	0	0
16	18535689	.	G	A	1	3	4	0	0	4	0	0
16	18552492	.	C	T	1	4	5	0	0	5	0	0
16	18568933	.	C	T	5	5	10	0	2	12	0	0
16	19136322	.	C	T	0	3	3	0	0	3	0	0
16	19150814	.	T	A	7	7	14	0	0	14	0	0
16	19150952	.	T	A	7	4	11	0	0	11	0	0
16	19151187	.	T	G	6	8	14	0	0	14	0	0
16	19151189	.	T	G	6	8	14	0	0	14	0	0
16	19151254	.	A	G	4	4	8	0	0	8	0	0
16	19151680	.	A	T	1	7	8	0	0	8	0	0
16	19151694	.	T	C	0	5	5	0	0	5	0	0
16	19151742	.	C	T	2	1	3	0	0	3	0	0
16	19151765	.	T	C	2	2	4	0	0	4	0	0
16	19538936	.	A	G	4	2	6	0	0	6	0	0
16	19538982	.	T	A	2	4	6	0	0	6	0	0
16	19539235	.	C	A	3	4	7	0	0	7	0	0
16	19539574	.	C	A	1	5	6	0	0	6	0	0
16	19733788	.	G	A	2	2	4	0	0	4	0	0
16	19840562	.	T	C	11	11	22	0	0	23	1	0
16	19840645	.	T	A	10	3	13	0	1	15	1	0
16	19840658	.	A	C	8	2	10	0	5	15	0	0
16	19840867	.	A	G	12	15	27	0	1	28	0	0
16	19841082	.	C	G	0	11	11	0	29	40	0	0
16	19841135	.	C	T	13	14	27	0	1	28	0	0
16	19841290	.	A	T	11	9	20	0	1	21	0	0
16	19841358	.	C	T	7	6	13	0	1	14	0	0
16	19841502	.	A	T	6	4	10	0	2	12	0	0
16	19841591	.	A	G	11	5	16	0	3	19	0	0
16	19841720	.	A	G	7	6	13	0	1	14	0	0
16	19841786	.	A	T	5	2	7	0	0	7	0	0
16	19841890	.	G	A	4	4	8	0	0	8	0	0
16	19841922	.	G	A	5	4	9	0	0	9	0	0
16	19842493	.	G	A	6	4	10	0	2	12	0	0
16	19842530	.	A	G	3	3	6	0	0	6	0	0
16	19843053	.	G	T	9	8	17	0	0	17	0	0
16	19843056	.	G	T	6	11	17	0	2	19	0	0
16	19850683	.	G	T	8	9	17	0	0	17	0	0
16	19853074	.	G	A	2	1	3	0	1	4	0	0
16	19853098	.	C	T	5	6	11	0	5	16	0	0
16	19853230	.	A	C	0	3	3	0	0	3	0	0
16	19876308	.	A	G	1	1	2	0	0	2	0	0
16	20151770	.	A	G	10	7	17	0	0	17	0	0
16	20151841	.	T	C	9	9	18	0	0	18	0	0
16	20151936	.	A	G	8	15	23	0	3	26	0	0
16	20152044	.	C	A	15	7	22	0	3	27	2	0
16	20152106	.	A	T	6	6	12	0	2	14	0	0
16	20152203	.	A	G	9	0	9	0	19	28	0	0
16	20152250	.	T	C	5	7	12	0	0	12	0	0
16	20152405	.	A	G	4	2	6	0	1	7	0	0
16	20152474	.	A	G	1	5	6	0	0	6	0	0
16	20152476	.	C	A	1	5	6	0	0	6	0	0
16	20193844	.	C	G	1	2	3	0	0	3	0	0
16	20238932	.	G	A	2	2	4	0	1	5	0	0
16	20265567	.	C	T	1	1	2	0	1	3	0	0
16	20265702	.	G	A	1	4	5	0	1	6	0	0
16	20265815	.	A	C	4	0	4	0	6	10	0	0
16	20266106	.	T	C	3	3	6	0	0	6	0	0
16	20266109	.	T	A	3	3	6	0	0	6	0	0
16	20266321	.	T	C	2	2	4	0	0	4	0	0
16	20266840	.	T	A	5	4	9	0	0	9	0	0
16	20267340	.	T	C	3	8	11	0	1	12	0	0
16	20267909	.	A	T	3	2	5	0	1	6	0	0
16	20271634	.	T	G	0	2	2	0	1	3	0	0
16	20271756	.	A	G	2	4	6	0	0	6	0	0
16	20324870	.	C	T	6	3	9	0	0	9	0	0
16	20371350	.	A	G	4	0	4	0	0	4	0	0
16	20402139	.	G	T	2	6	8	0	0	8	0	0
16	20492604	.	C	T	4	3	7	0	0	7	0	0
16	20497218	.	C	T	3	3	6	0	0	6	0	0
16	20497242	.	C	T	1	2	3	0	0	3	0	0
16	20513152	.	A	G	11	7	18	0	0	18	0	0
16	20514814	.	G	A	3	3	6	0	0	6	0	0
16	20514816	.	C	T	3	3	6	0	0	6	0	0
16	20792982	.	T	A	4	2	6	0	2	8	0	0
16	20800347	.	C	T	4	2	6	0	0	6	0	0
16	20806006	.	C	T	7	4	11	0	0	11	0	0
16	20806747	.	A	G	17	19	36	0	1	37	0	0
16	20813628	.	C	T	0	14	14	0	21	35	0	0
16	20815743	.	A	G	2	3	5	0	2	7	0	0
16	20822881	.	T	C	1	3	4	0	0	4	0	0
16	20824508	.	C	G	2	1	3	0	0	3	0	0
16	20824566	.	C	T	10	7	17	0	2	19	0	0
16	20826697	.	T	C	11	9	20	0	0	20	0	0
16	20836218	.	G	A	4	4	8	0	1	9	0	0
16	20836870	.	G	A	2	3	5	0	1	6	0	0
16	20855582	.	G	A	6	1	7	0	1	8	0	0
16	20874252	.	T	C	3	4	7	0	0	7	0	0
16	20889292	.	G	A	7	8	15	0	2	17	0	0
16	20889325	.	C	T	8	5	13	0	0	13	0	0
16	20889514	.	G	T	1	3	4	0	0	4	0	0
16	21038693	.	T	A	9	2	11	0	1	12	0	0
16	22365543	.	T	A	4	1	5	0	1	6	0	0
16	22752738	.	T	C	3	5	8	0	1	9	0	0
16	22752739	.	T	C	1	7	8	0	1	9	0	0
16	23353727	.	G	A	2	2	4	0	0	4	0	0
16	23379313	.	G	A	0	2	2	0	0	2	0	0
16	23379386	.	T	G	0	2	2	0	0	2	0	0
16	23383399	.	T	A	0	2	2	0	0	2	0	0
16	23385909	.	A	G	1	2	3	0	0	3	0	0
16	23388400	.	A	T	12	8	20	0	0	20	0	0
16	23388532	.	C	T	2	2	4	0	0	4	0	0
16	23398489	.	T	C	2	2	4	0	0	4	0	0
16	23399307	.	T	C	2	5	7	0	2	9	0	0
16	23495775	.	A	T	2	4	6	0	1	7	0	0
16	23495820	.	C	T	2	4	6	0	1	7	0	0
16	23556448	.	T	C	8	7	15	0	2	17	0	0
16	23556748	.	A	G	10	0	10	0	14	24	0	0
16	23556758	.	C	T	11	14	25	0	2	27	0	0
16	23556822	.	A	G	11	11	22	0	1	23	0	0
16	23557013	.	G	A	2	7	9	0	2	11	0	0
16	23557414	.	A	G	2	2	4	0	0	4	0	0
16	23600307	.	C	T	1	2	3	0	1	4	0	0
16	23718419	.	G	C	14	14	28	0	0	28	0	0
16	23718687	.	A	G	7	5	12	0	2	14	0	0
16	23718700	.	A	G	10	6	16	0	1	17	0	0
16	23719011	.	A	G	10	2	12	0	1	13	0	0
16	23788830	.	A	G	34	31	65	1	1	67	0	0
16	23809311	.	A	C	2	3	5	0	0	5	0	0
16	23821654	.	T	A	3	3	6	0	0	6	0	0
16	23831697	.	A	G	2	1	3	0	0	3	0	0
16	23832072	.	C	T	2	2	4	0	0	4	0	0
16	23832204	.	C	T	4	3	7	0	0	7	0	0
16	23832302	.	T	C	2	4	6	0	3	9	0	0
16	23832304	.	A	T	3	5	8	0	1	9	0	0
16	23832520	.	A	C	7	6	13	0	1	14	0	0
16	23832561	.	T	C	5	5	10	0	2	12	0	0
16	23832589	.	G	A	4	8	12	0	0	12	0	0
16	23832646	.	A	T	3	7	10	0	0	10	0	0
16	23832695	.	A	G	4	10	14	0	0	14	0	0
16	23832787	.	T	C	8	5	13	0	2	15	0	0
16	23832850	.	A	G	8	6	14	0	0	14	0	0
16	23833070	.	A	C	3	9	12	0	1	13	0	0
16	23833121	.	A	G	4	8	12	0	2	14	0	0
16	23833227	.	C	A	8	1	9	0	0	9	0	0
16	23833238	.	A	C	9	1	10	0	0	10	0	0
16	23833347	.	T	A	5	8	13	0	0	13	0	0
16	23833377	.	G	T	4	5	9	0	2	11	0	0
16	23833420	.	G	T	8	5	13	0	1	14	0	0
16	23833442	.	G	A	7	3	10	0	0	10	0	0
16	23833528	.	A	T	3	5	8	0	1	9	0	0
16	23833723	.	A	G	10	13	23	0	0	23	0	0
16	23833916	.	G	A	5	10	15	0	2	17	0	0
16	23834001	.	A	C	5	10	15	0	0	15	0	0
16	23834513	.	T	G	10	8	18	0	1	19	0	0
16	23834540	.	T	C	18	10	28	0	1	29	0	0
16	23834554	.	A	G	14	13	27	0	5	32	0	0
16	23834859	.	A	G	11	10	21	0	2	23	0	0
16	23834885	.	A	T	13	12	25	0	0	25	0	0
16	23835310	.	T	A	2	5	7	0	1	8	0	0
16	23864805	.	A	G	2	4	6	0	0	6	0	0
16	23864902	.	G	A	1	0	1	0	0	1	0	0
16	23864905	.	C	T	0	0	0	0	1	1	0	0
16	23880208	.	C	T	1	2	3	0	0	3	0	0
16	23901394	.	C	T	5	5	10	0	0	10	0	0
16	23901420	.	G	C	4	4	8	0	0	8	0	0
16	23901578	.	G	A	1	3	4	0	1	5	0	0
16	23901607	.	A	G	4	0	4	0	4	8	0	0
16	23901614	.	T	G	4	3	7	0	0	7	0	0
16	23901805	.	G	A	2	3	5	0	0	5	0	0
16	23902179	.	C	T	6	3	9	0	0	9	0	0
16	23902235	.	T	C	6	3	9	0	0	9	0	0
16	23902285	.	C	G	2	3	5	0	0	5	0	0
16	23902330	.	T	C	2	3	5	0	0	5	0	0
16	23961878	.	C	T	10	8	18	0	1	19	0	0
16	23962007	.	G	A	8	12	20	0	0	20	0	0
16	23963241	.	C	T	22	19	41	0	3	44	0	0
16	23963257	.	G	T	22	26	48	0	0	48	0	0
16	23972939	.	G	A	0	1	1	0	0	1	0	0
16	24517824	.	G	A	1	2	3	0	1	4	0	0
16	24551929	.	A	T	1	2	3	0	0	3	0	0
16	24552024	.	A	T	3	4	7	0	0	7	0	0
16	24552155	.	A	C	5	6	11	0	0	11	0	0
16	24552176	.	C	G	6	9	15	0	0	15	0	0
16	24552215	.	C	T	9	9	18	0	1	19	0	0
16	24552459	.	A	G	6	5	11	0	0	11	0	0
16	24552801	.	A	G	5	2	7	0	1	8	0	0
16	24552826	.	G	A	3	5	8	0	0	8	0	0
16	24553450	.	T	C	6	5	11	0	1	12	0	0
16	24553464	.	G	T	3	2	5	0	1	6	0	0
16	24553633	.	A	G	3	3	6	0	0	6	0	0
16	24553663	.	T	G	2	4	6	0	1	7	0	0
16	24554475	.	A	G	4	5	9	0	0	9	0	0
16	24554509	.	C	T	4	4	8	0	0	8	0	0
16	24590541	.	C	T	3	4	7	0	0	7	0	0
16	24590767	.	T	A	10	19	29	0	0	29	0	0
16	24590804	.	G	T	9	25	34	0	7	41	0	0
16	24590823	.	C	T	10	23	33	0	7	40	0	0
16	24590950	.	T	A	10	14	24	0	1	25	0	0
16	24590999	.	A	G	10	13	23	1	2	26	0	0
16	24591010	.	G	A	11	11	22	1	5	28	0	0
16	24591036	.	T	C	16	13	29	1	3	33	0	0
16	24591074	.	G	A	18	17	35	0	1	36	0	0
16	24591172	.	A	G	18	18	36	0	2	38	0	0
16	24591207	.	T	G	10	19	29	0	0	29	0	0
16	24591379	.	C	T	7	5	12	0	6	18	0	0
16	24591422	.	C	A	4	5	9	0	1	10	0	0
16	24596192	.	C	T	1	1	2	0	0	2	0	0
16	24632148	.	T	C	2	6	8	0	1	9	0	0
16	24632306	.	C	A	6	3	9	0	2	11	0	0
16	24637342	.	G	T	3	4	7	0	0	7	0	0
16	24637369	.	A	C	0	1	1	0	0	1	0	0
16	24639396	.	G	A	5	9	14	0	0	14	0	0
16	24645240	.	C	T	5	0	5	0	0	5	0	0
16	24645448	.	C	G	6	6	12	0	0	12	0	0
16	24645476	.	A	T	7	8	15	0	2	17	0	0
16	24645796	.	G	A	8	5	13	0	2	15	0	0
16	24645820	.	A	T	11	11	22	0	1	23	0	0
16	24645978	.	A	T	4	5	9	0	0	9	0	0
16	24646000	.	A	T	2	4	6	0	0	6	0	0
16	24646620	.	T	C	3	6	9	0	2	11	0	0
16	24646684	.	C	A	4	2	6	0	1	7	0	0
16	24658825	.	A	G	1	3	4	0	1	5	0	0
16	24669991	.	T	C	3	5	8	0	0	8	0	0
16	24670772	.	C	A	0	0	0	0	2	2	0	0
16	24670798	.	A	T	1	0	1	0	0	1	0	0
16	24692635	.	T	C	31	26	57	0	5	62	0	0
16	24695295	.	C	G	29	28	57	0	3	60	0	0
16	24695301	.	T	C	28	23	51	0	7	58	0	0
16	24695520	.	G	A	41	31	72	0	6	78	0	0
16	24695551	.	G	A	5	34	39	0	24	63	0	0
16	24721982	.	G	C	3	2	5	0	1	6	0	0
16	24723430	.	A	C	1	3	4	0	1	5	0	0
16	24727766	.	G	A	1	2	3	0	0	3	0	0
16	24727826	.	A	T	1	2	3	0	0	3	0	0
16	24729093	.	G	C	0	1	1	0	0	1	0	0
16	24732829	.	A	G	5	0	5	0	8	13	0	0
16	24732869	.	G	T	5	9	14	0	0	14	0	0
16	24732921	.	C	A	9	5	14	0	0	14	0	0
16	24733125	.	A	G	2	7	9	0	0	9	0	0
16	24733127	.	A	G	2	6	8	0	1	9	0	0
16	24896464	.	G	C	1	4	5	0	0	5	0	0
16	24915998	.	T	G	0	1	1	0	0	1	0	0
16	24916004	.	T	C	0	1	1	0	0	1	0	0
16	24973938	.	G	A	1	2	3	0	0	3	0	0
16	24973948	.	C	T	1	2	3	0	0	3	0	0
16	24991391	.	T	C	6	5	11	0	1	12	0	0
16	25030732	.	C	G	2	2	4	0	0	4	0	0
16	25031884	.	G	A	1	2	3	0	0	3	0	0
16	25033071	.	G	A	1	2	3	0	1	4	0	0
16	25033953	.	G	A	1	2	3	0	0	3	0	0
16	25033983	.	T	A	1	2	3	0	0	3	0	0
16	25034115	.	A	G	1	5	6	0	0	6	0	0
16	25034223	.	A	C	2	2	4	0	0	4	0	0
16	25034241	.	G	A	2	4	6	0	0	6	0	0
16	25034416	.	A	C	1	2	3	0	0	3	0	0
16	25034445	.	A	G	1	2	3	0	0	3	0	0
16	25034766	.	G	A	7	3	10	0	0	10	0	0
16	25035129	.	A	G	1	5	6	0	1	7	0	0
16	25035169	.	G	T	1	8	9	0	1	10	0	0
16	25035906	.	A	T	5	6	11	0	1	12	0	0
16	25038011	.	T	C	14	7	21	0	0	21	0	0
16	25038412	.	A	G	13	14	27	0	0	27	0	0
16	25038429	.	C	T	10	14	24	0	1	25	0	0
16	25038689	.	A	C	2	1	3	0	1	4	0	0
16	25038696	.	A	T	2	3	5	0	0	5	0	0
16	25078815	.	G	C	3	5	8	0	2	10	0	0
16	25095659	.	C	T	3	3	6	0	0	6	0	0
16	25104031	.	T	C	14	12	26	0	1	27	0	0
16	25104196	.	A	G	11	13	24	0	0	24	0	0
16	25104226	.	A	G	16	6	22	0	2	24	0	0
16	25104454	.	C	G	9	21	30	0	0	31	1	0
16	25104595	.	C	T	11	13	24	0	0	24	0	0
16	25104850	.	A	C	16	9	25	0	1	26	0	0
16	25107378	.	A	T	2	2	4	0	1	5	0	0
16	25111755	.	T	A	1	2	3	0	0	3	0	0
16	25112115	.	G	A	2	3	5	0	2	7	0	0
16	25113091	.	A	T	3	5	8	0	0	8	0	0
16	25114362	.	C	T	5	6	11	0	0	11	0	0
16	25114450	.	G	A	0	4	4	0	3	7	0	0
16	25114451	.	C	G	3	4	7	0	0	7	0	0
16	25114508	.	C	A	4	3	7	0	0	7	0	0
16	25114522	.	A	C	3	3	6	0	2	8	0	0
16	25114546	.	A	G	5	7	12	0	0	12	0	0
16	25114848	.	A	G	12	12	24	0	1	25	0	0
16	25114881	.	T	C	14	10	24	0	1	25	0	0
16	25114944	.	T	C	9	14	23	0	1	24	0	0
16	25120851	.	T	C	2	2	4	0	0	4	0	0
16	25121541	.	G	A	1	2	3	0	0	3	0	0
16	25121607	.	T	C	3	4	7	0	0	7	0	0
16	25122086	.	G	T	1	2	3	0	0	3	0	0
16	25122193	.	C	T	4	8	12	0	2	14	0	0
16	25122240	.	C	T	1	5	6	0	0	6	0	0
16	25122770	.	T	A	4	2	6	0	0	6	0	0
16	25122929	.	A	G	7	3	10	0	1	11	0	0
16	25122933	.	A	G	5	0	5	0	7	12	0	0
16	25122964	.	A	G	3	3	6	0	1	7	0	0
16	25122971	.	A	T	1	5	6	0	0	6	0	0
16	25123058	.	A	G	2	4	6	0	0	6	0	0
16	25123129	.	A	G	1	4	5	0	1	6	0	0
16	25123130	.	A	G	2	2	4	0	2	6	0	0
16	25123248	.	G	A	2	4	6	0	0	6	0	0
16	25123293	.	C	T	3	5	8	0	0	8	0	0
16	25123294	.	T	G	3	5	8	0	0	8	0	0
16	25123424	.	A	G	0	2	2	0	1	3	0	0
16	25123435	.	A	G	0	1	1	0	2	3	0	0
16	25123832	.	A	G	4	3	7	0	0	7	0	0
16	25123843	.	T	A	4	2	6	0	0	6	0	0
16	25123938	.	A	G	5	4	9	0	0	9	0	0
16	25124138	.	T	G	1	3	4	0	0	4	0	0
16	25124203	.	T	C	2	3	5	0	0	5	0	0
16	25124662	.	G	T	4	6	10	0	0	10	0	0
16	25124763	.	A	T	4	5	9	0	0	9	0	0
16	25124832	.	C	T	4	5	9	0	1	10	0	0
16	25149123	.	G	A	1	2	3	0	1	4	0	0
16	25149254	.	G	T	1	1	2	0	1	3	0	0
16	25149402	.	T	C	3	2	5	0	0	5	0	0
16	25149654	.	T	C	1	2	3	0	0	3	0	0
16	25149878	.	T	C	1	2	3	0	0	3	0	0
16	25149992	.	A	C	3	5	8	0	0	8	0	0
16	25151419	.	G	A	4	2	6	0	0	6	0	0
16	25161292	.	A	G	4	4	8	0	0	8	0	0
16	25161315	.	T	C	4	5	9	0	0	9	0	0
16	25161420	.	G	T	0	5	5	0	5	10	0	0
16	25161876	.	T	C	10	12	22	0	0	22	0	0
16	25162163	.	G	A	0	2	2	0	2	4	0	0
16	25162514	.	G	A	0	2	2	0	8	10	0	0
16	25162516	.	T	C	8	2	10	0	0	10	0	0
16	25162814	.	A	T	3	3	6	0	1	7	0	0
16	25167828	.	T	C	5	1	6	0	0	6	0	0
16	25169003	.	A	G	7	10	17	0	1	18	0	0
16	25169501	.	T	A	1	3	4	0	0	4	0	0
16	25176825	.	G	T	0	2	2	0	2	4	0	0
16	25180397	.	A	C	1	2	3	0	0	3	0	0
16	25180485	.	T	C	7	4	11	0	0	11	0	0
16	25180534	.	C	T	4	4	8	0	1	9	0	0
16	25180561	.	C	A	3	7	10	0	0	10	0	0
16	25180642	.	G	A	3	4	7	0	0	7	0	0
16	25180733	.	G	T	2	4	6	0	0	6	0	0
16	25180846	.	T	C	7	4	11	0	0	11	0	0
16	25181046	.	A	G	2	3	5	0	0	5	0	0
16	25181113	.	T	C	4	4	8	0	0	8	0	0
16	25181350	.	A	T	1	2	3	0	1	4	0	0
16	25199291	.	G	C	2	2	4	0	0	4	0	0
16	25269825	.	C	G	0	3	3	0	1	4	0	0
16	25272148	.	G	T	0	2	2	0	2	4	0	0
16	25272149	.	A	G	2	2	4	0	0	4	0	0
16	25272215	.	C	T	1	3	4	0	0	4	0	0
16	25275767	.	T	A	2	2	4	0	0	4	0	0
16	25275984	.	C	T	0	7	7	0	19	26	0	0
16	25283378	.	A	G	7	7	14	0	1	15	0	0
16	25283402	.	G	T	4	3	7	0	1	8	0	0
16	25311654	.	G	A	3	1	4	0	0	4	0	0
16	25314708	.	G	A	1	1	2	0	0	2	0	0
16	25314900	.	G	A	3	4	7	0	0	7	0	0
16	25314933	.	G	C	1	4	5	0	0	5	0	0
16	25327730	.	C	T	3	1	4	0	0	4	0	0
16	25334326	.	A	G	1	3	4	0	0	4	0	0
16	25334353	.	T	C	3	9	12	0	2	14	0	0
16	25337665	.	T	G	6	13	19	0	0	19	0	0
16	25347762	.	G	A	2	2	4	0	0	4	0	0
16	25348860	.	C	T	1	3	4	0	0	4	0	0
16	25353019	.	C	T	4	4	8	0	1	9	0	0
16	25354571	.	A	G	0	0	0	0	4	4	0	0
16	25356717	.	A	C	0	1	1	0	0	1	0	0
16	25357980	.	T	A	1	6	7	0	0	7	0	0
16	25357989	.	C	T	1	6	7	0	0	7	0	0
16	25360557	.	T	A	3	2	5	0	0	5	0	0
16	25360605	.	C	A	6	5	11	0	1	12	0	0
16	25373924	.	G	A	4	5	9	0	1	10	0	0
16	25373979	.	T	A	3	2	5	0	1	6	0	0
16	25374441	.	C	T	0	6	6	0	3	9	0	0
16	25374508	.	T	G	2	8	10	0	2	12	0	0
16	25391411	.	A	G	1	0	1	0	0	1	0	0
16	25394879	.	C	A	2	2	4	0	0	4	0	0
16	25394883	.	C	T	2	2	4	0	0	4	0	0
16	25395154	.	G	T	1	6	7	0	0	7	0	0
16	25395700	.	A	T	1	5	6	0	0	6	0	0
16	25395702	.	G	T	1	5	6	0	0	6	0	0
16	25477398	.	G	C	0	2	2	0	2	4	0	0
16	25487720	.	A	G	5	5	10	0	0	10	0	0
16	25500137	.	A	G	2	1	3	0	0	3	0	0
16	25504122	.	C	T	0	2	2	0	10	12	0	0
16	25504180	.	C	T	0	9	9	0	15	24	0	0
16	25504315	.	C	T	22	10	32	0	1	33	0	0
16	25504337	.	G	A	14	10	24	0	2	26	0	0
16	25504585	.	C	T	20	13	33	0	5	38	0	0
16	25504642	.	G	A	12	19	31	0	6	37	0	0
16	25507392	.	C	T	0	2	2	0	4	6	0	0
16	25507485	.	G	A	5	18	23	0	1	24	0	0
16	25507536	.	G	A	2	6	8	0	0	8	0	0
16	25507582	.	T	A	2	5	7	0	0	7	0	0
16	25507643	.	T	A	5	5	10	0	0	10	0	0
16	25507696	.	T	C	8	3	11	0	1	12	0	0
16	25519635	.	A	G	12	6	18	0	0	18	0	0
16	25527541	.	T	G	2	4	6	0	0	6	0	0
16	25535229	.	C	T	0	7	7	0	0	7	0	0
16	25535283	.	T	C	1	5	6	0	0	6	0	0
16	25555806	.	A	G	13	9	22	0	0	22	0	0
16	25557285	.	C	T	4	2	6	0	1	7	0	0
16	25558007	.	C	G	0	4	4	0	5	9	0	0
16	25558223	.	A	G	4	6	10	0	4	14	0	0
16	25558351	.	C	T	0	3	3	0	9	12	0	0
16	25558484	.	T	C	6	3	9	0	0	9	0	0
16	25558600	.	G	A	4	3	7	0	0	7	0	0
16	25558986	.	A	G	2	6	8	0	2	10	0	0
16	25559028	.	A	C	5	5	10	0	0	10	0	0
16	25559165	.	A	C	3	5	8	0	3	11	0	0
16	25559193	.	A	G	5	6	11	0	1	12	0	0
16	25559274	.	C	T	1	7	8	0	0	8	0	0
16	25559296	.	T	C	1	7	8	0	1	9	0	0
16	25559643	.	C	T	3	2	5	0	0	5	0	0
16	25559743	.	A	T	3	2	5	0	2	7	0	0
16	25559837	.	G	A	1	3	4	0	0	4	0	0
16	25559848	.	T	C	1	4	5	0	0	5	0	0
16	25560265	.	G	A	2	2	4	0	0	4	0	0
16	25560863	.	C	T	1	3	4	0	0	4	0	0
16	25561001	.	A	C	1	3	4	0	0	4	0	0
16	25561011	.	A	T	1	3	4	0	0	4	0	0
16	25567951	.	T	G	1	1	2	0	0	2	0	0
16	25593883	.	G	A	5	3	8	0	1	9	0	0
16	25593973	.	G	A	5	7	12	0	0	12	0	0
16	25594415	.	C	T	3	4	7	0	0	7	0	0
16	25641050	.	G	A	9	9	18	0	1	19	0	0
16	25642713	.	T	A	16	9	25	0	0	25	0	0
16	25642848	.	C	A	14	7	21	0	8	29	0	0
16	25643818	.	G	T	9	5	14	0	0	14	0	0
16	25673880	.	T	C	8	5	13	0	0	13	0	0
16	25683018	.	T	C	2	6	8	0	3	11	0	0
16	25683152	.	A	T	5	15	20	0	3	23	0	0
16	25683440	.	G	T	13	9	22	0	1	23	0	0
16	25688709	.	C	A	1	3	4	0	1	5	0	0
16	25697956	.	C	A	1	3	4	0	0	4	0	0
16	25697971	.	A	T	1	5	6	0	0	6	0	0
16	25698045	.	G	A	3	3	6	0	0	6	0	0
16	26021245	.	A	G	4	7	11	0	0	11	0	0
16	26027081	.	G	T	10	13	23	0	4	27	0	0
16	26027158	.	A	T	13	14	27	0	3	30	0	0
16	26030380	.	T	A	9	9	18	0	2	20	0	0
16	26039945	.	C	T	0	0	0	0	1	1	0	0
16	26141290	.	G	T	5	4	9	0	1	10	0	0
16	26141295	.	T	A	6	3	9	0	1	10	0	0
16	26141599	.	T	A	8	8	16	0	0	16	0	0
16	26141665	.	T	C	5	3	8	0	1	9	0	0
16	26141817	.	T	G	3	11	14	0	0	14	0	0
16	26142405	.	A	G	1	2	3	0	1	4	0	0
16	26142703	.	A	T	4	4	8	0	0	8	0	0
16	26151592	.	G	A	1	0	1	0	0	1	0	0
16	26234460	.	C	T	2	2	4	0	1	5	0	0
16	26234640	.	C	G	5	4	9	0	0	9	0	0
16	26234772	.	T	C	6	3	9	0	0	9	0	0
16	26235461	.	A	G	2	4	6	0	0	6	0	0
16	26236263	.	G	A	1	2	3	0	1	4	0	0
16	26236341	.	G	T	1	2	3	0	0	3	0	0
16	26237122	.	T	C	3	2	5	0	0	5	0	0
16	26237501	.	A	T	3	2	5	0	0	5	0	0
16	26381538	.	T	C	10	10	20	0	0	20	0	0
16	26384219	.	G	A	1	4	5	0	0	5	0	0
16	26439860	.	T	C	1	3	4	0	0	4	0	0
16	26444480	.	C	T	4	10	14	0	0	14	0	0
16	26444541	.	G	T	4	2	6	0	1	7	0	0
16	26444634	.	G	T	2	4	6	0	0	6	0	0
16	26444644	.	A	T	2	4	6	0	0	6	0	0
16	26444954	.	T	A	4	1	5	0	1	6	0	0
16	26444976	.	T	A	1	3	4	0	0	4	0	0
16	26445032	.	C	T	3	4	7	0	0	7	0	0
16	26445069	.	A	T	2	4	6	0	0	6	0	0
16	26445458	.	T	C	2	3	5	0	1	6	0	0
16	26445990	.	G	A	4	5	9	0	0	9	0	0
16	26446005	.	G	A	5	4	9	0	1	10	0	0
16	26510740	.	C	A	3	2	5	0	1	6	0	0
16	26510997	.	G	A	4	2	6	0	0	6	0	0
16	26516813	.	G	C	2	2	4	0	2	6	0	0
16	26530989	.	A	T	1	2	3	0	0	3	0	0
16	26599551	.	T	A	2	3	5	0	1	6	0	0
16	26599555	.	A	G	3	3	6	0	0	6	0	0
16	26634530	.	T	A	4	2	6	0	0	6	0	0
16	26689955	.	T	C	0	2	2	0	0	2	0	0
16	26691475	.	G	A	1	2	3	0	0	3	0	0
16	26696759	.	T	G	0	1	1	0	0	1	0	0
16	26702745	.	T	C	6	5	11	0	0	11	0	0
16	26702870	.	T	C	4	6	10	0	2	12	0	0
16	26703111	.	T	C	5	4	9	0	2	11	0	0
16	26706551	.	G	A	4	1	5	0	0	5	0	0
16	26706584	.	G	A	3	1	4	0	0	4	0	0
16	26706840	.	T	A	1	2	3	0	0	3	0	0
16	26710777	.	G	A	0	5	5	0	9	14	0	0
16	26710798	.	C	T	13	9	22	0	0	22	0	0
16	26710900	.	C	A	16	13	29	0	1	30	0	0
16	26710954	.	A	T	15	16	31	0	1	32	0	0
16	26710969	.	C	A	13	15	28	0	3	31	0	0
16	26713964	.	G	T	13	10	23	0	0	23	0	0
16	26768803	.	A	G	2	5	7	0	0	7	0	0
16	26769118	.	C	T	4	4	8	0	0	8	0	0
16	26769167	.	T	G	5	3	8	0	0	8	0	0
16	26816806	.	G	T	4	3	7	0	1	8	0	0
16	26817304	.	T	C	3	1	4	0	5	9	0	0
16	26817898	.	G	A	1	3	4	0	0	4	0	0
16	26817922	.	T	C	1	0	1	0	6	7	0	0
16	26850845	.	T	C	5	14	19	0	0	19	0	0
16	26850870	.	G	A	4	14	18	0	0	18	0	0
16	26850885	.	C	T	4	17	21	0	1	22	0	0
16	26851025	.	C	G	3	3	6	0	1	7	0	0
16	26851036	.	T	A	2	2	4	0	1	5	0	0
16	26851071	.	C	A	2	2	4	0	0	4	0	0
16	26851191	.	C	T	6	6	12	0	1	13	0	0
16	26863545	.	C	T	2	3	5	0	0	5	0	0
16	26994555	.	T	C	2	0	2	0	0	2	0	0
16	26994564	.	G	T	2	1	3	0	0	3	0	0
16	26994618	.	A	G	3	2	5	0	0	5	0	0
16	27025096	.	T	C	2	3	5	0	0	5	0	0
16	27061912	.	A	C	4	2	6	0	0	6	0	0
16	27069527	.	C	T	1	3	4	0	0	4	0	0
16	27072464	.	C	T	6	2	8	0	0	8	0	0
16	27089100	.	T	G	2	3	5	0	0	5	0	0
16	27098530	.	A	G	6	4	10	0	2	12	0	0
16	27098549	.	A	T	5	4	9	0	2	11	0	0
16	27098806	.	G	A	6	6	12	0	0	12	0	0
16	27099069	.	A	C	3	1	4	0	0	4	0	0
16	27099121	.	A	T	2	2	4	0	0	4	0	0
16	27099323	.	G	A	0	8	8	0	8	16	0	0
16	27099506	.	C	T	4	5	9	0	0	9	0	0
16	27100133	.	A	C	5	5	10	0	2	12	0	0
16	27100139	.	A	T	5	7	12	0	1	13	0	0
16	27100198	.	T	A	13	13	26	0	2	28	0	0
16	27126615	.	G	A	17	10	27	0	3	30	0	0
16	27126695	.	G	T	13	14	27	0	1	28	0	0
16	27126849	.	C	T	16	10	26	0	1	27	0	0
16	27126998	.	A	G	3	3	6	0	0	6	0	0
16	27126999	.	T	A	3	3	6	0	0	6	0	0
16	27127046	.	A	T	12	10	22	0	0	22	0	0
16	27127157	.	G	C	14	17	31	0	3	34	0	0
16	27127158	.	C	A	15	18	33	0	1	34	0	0
16	27127281	.	T	G	14	4	18	0	1	19	0	0
16	27127497	.	T	A	15	7	22	0	0	22	0	0
16	27138391	.	C	G	0	1	1	0	0	1	0	0
16	27148864	.	G	T	1	1	2	0	0	2	0	0
16	27158753	.	T	C	5	0	5	0	0	5	0	0
16	27166174	.	A	G	2	4	6	0	0	6	0	0
16	27166205	.	A	G	2	4	6	0	0	6	0	0
16	27166277	.	G	A	5	5	10	0	0	10	0	0
16	27169529	.	G	A	5	6	11	0	1	12	0	0
16	27169586	.	G	A	4	4	8	0	1	9	0	0
16	27169809	.	G	A	1	1	2	0	0	2	0	0
16	27170170	.	G	A	0	2	2	0	0	2	0	0
16	27216297	.	C	T	2	4	6	0	1	7	0	0
16	27216398	.	G	T	1	1	2	0	0	2	0	0
16	27216419	.	C	A	2	2	4	0	0	4	0	0
16	27231410	.	G	A	21	20	41	0	7	48	0	0
16	27231469	.	T	G	26	17	43	0	2	45	0	0
16	27363205	.	G	A	0	1	1	0	1	2	0	0
16	27367624	.	A	G	1	0	1	0	0	1	0	0
16	27367695	.	T	C	6	3	9	0	0	9	0	0
16	27368516	.	C	T	4	4	8	0	0	8	0	0
16	27368577	.	A	G	6	3	9	0	0	9	0	0
16	27368705	.	C	T	7	6	13	0	0	13	0	0
16	27368756	.	A	G	2	1	3	0	1	4	0	0
16	27369057	.	T	C	2	3	5	0	0	5	0	0
16	27405383	.	A	T	1	2	3	0	0	3	0	0
16	27405389	.	G	A	1	2	3	0	0	3	0	0
16	27417573	.	T	C	10	9	19	0	0	19	0	0
16	27427919	.	A	G	5	1	6	0	1	7	0	0
16	27510736	.	C	A	1	3	4	0	6	10	0	0
16	27513944	.	G	A	1	1	2	0	0	2	0	0
16	27543963	.	A	G	0	2	2	0	0	2	0	0
16	27548014	.	C	T	2	2	4	0	0	4	0	0
16	27550215	.	G	A	1	2	3	0	0	3	0	0
16	27555175	.	T	C	10	8	18	0	2	20	0	0
16	27555362	.	C	T	3	3	6	0	0	6	0	0
16	27571114	.	G	A	1	2	3	0	0	3	0	0
16	27571147	.	A	T	1	2	3	0	0	3	0	0
16	27581100	.	T	C	0	1	1	0	0	1	0	0
16	27615102	.	C	T	4	6	10	0	1	11	0	0
16	27615184	.	A	T	6	10	16	0	0	16	0	0
16	27615203	.	A	G	6	7	13	0	1	14	0	0
16	27617046	.	C	T	0	2	2	0	0	2	0	0
16	27617130	.	C	T	1	2	3	0	0	3	0	0
16	27621645	.	A	T	8	24	32	0	2	34	0	0
16	27621780	.	A	C	7	15	22	0	0	22	0	0
16	27621830	.	T	G	7	10	17	0	0	17	0	0
16	27621869	.	A	G	9	7	16	0	1	17	0	0
16	27621897	.	A	T	8	6	14	0	1	15	0	0
16	27626566	.	G	T	24	19	43	0	5	49	1	0
16	27627051	.	T	C	2	1	3	0	0	3	0	0
16	27628860	.	A	T	7	5	12	0	1	13	0	0
16	27629052	.	C	T	18	19	37	0	1	38	0	0
16	27629212	.	C	T	0	2	2	0	0	2	0	0
16	27629455	.	T	G	19	16	35	0	1	36	0	0
16	27629483	.	G	A	14	15	29	0	4	33	0	0
16	27629713	.	T	C	16	15	31	0	2	33	0	0
16	27630087	.	C	T	0	14	14	0	13	27	0	0
16	27630174	.	A	T	11	13	24	0	1	25	0	0
16	27630209	.	T	C	8	15	23	0	0	23	0	0
16	27630294	.	G	A	11	12	23	0	2	25	0	0
16	27630399	.	G	T	11	8	19	0	2	21	0	0
16	27630785	.	G	A	8	7	15	0	0	15	0	0
16	27631061	.	G	A	5	8	13	0	0	13	0	0
16	27631768	.	G	A	5	3	8	0	2	10	0	0
16	27632879	.	T	C	2	2	4	0	0	4	0	0
16	27632880	.	G	A	2	2	4	0	0	4	0	0
16	27633002	.	G	A	1	2	3	0	0	3	0	0
16	27633089	.	A	G	3	3	6	0	3	9	0	0
16	27660055	.	C	T	2	4	6	0	0	6	0	0
16	27660103	.	T	C	4	4	8	0	0	8	0	0
16	27660104	.	A	C	3	4	7	0	1	8	0	0
16	27660144	.	T	C	5	6	11	0	0	11	0	0
16	27660196	.	A	T	2	5	7	0	0	7	0	0
16	27660242	.	G	T	2	4	6	0	0	6	0	0
16	27660271	.	A	G	7	5	12	0	0	12	0	0
16	27660346	.	C	T	10	5	15	0	0	15	0	0
16	27660750	.	C	T	0	7	7	0	5	12	0	0
16	27660781	.	G	A	5	7	12	0	1	13	0	0
16	27660868	.	A	G	7	5	12	0	1	13	0	0
16	27660934	.	C	T	2	6	8	0	0	8	0	0
16	27667312	.	G	T	0	0	0	0	1	1	0	0
16	27669912	.	T	C	0	0	0	0	5	5	0	0
16	27669993	.	G	C	2	3	5	0	0	5	0	0
16	27670032	.	T	C	3	2	5	0	0	5	0	0
16	27734958	.	C	A	5	2	7	0	0	7	0	0
16	28112951	.	C	A	4	4	8	0	0	8	0	0
16	28112989	.	C	T	6	6	12	0	0	12	0	0
16	28113033	.	C	T	0	5	5	0	8	13	0	0
16	28113049	.	G	A	6	2	8	0	1	9	0	0
16	28256806	.	G	A	0	1	1	0	1	2	0	0
16	28263526	.	G	A	3	2	5	0	0	5	0	0
16	28265687	.	T	C	0	1	1	0	0	1	0	0
16	28270157	.	C	A	1	2	3	0	2	5	0	0
16	28276383	.	T	C	2	7	9	0	1	10	0	0
16	28276389	.	C	T	2	8	10	0	0	10	0	0
16	28276455	.	C	T	1	6	7	0	0	7	0	0
16	28277053	.	G	T	0	2	2	0	0	2	0	0
16	28277068	.	G	A	0	1	1	0	0	1	0	0
16	28277340	.	C	G	2	8	10	0	0	10	0	0
16	28277385	.	G	C	1	4	5	0	2	7	0	0
16	28309479	.	A	T	0	1	1	0	0	1	0	0
16	28313822	.	G	A	2	3	5	0	1	6	0	0
16	28313823	.	G	A	2	4	6	0	0	6	0	0
16	28370465	.	C	T	10	19	29	0	3	32	0	0
16	28370513	.	G	C	8	18	26	0	1	27	0	0
16	28370566	.	A	C	10	8	18	0	2	20	0	0
16	28370703	.	A	G	3	2	5	0	0	5	0	0
16	28370943	.	A	T	6	14	20	0	2	22	0	0
16	28371138	.	T	C	12	18	30	0	1	31	0	0
16	28371148	.	A	G	12	19	31	0	1	32	0	0
16	28573514	.	T	C	4	4	8	0	0	8	0	0
16	28573574	.	G	A	0	3	3	0	4	7	0	0
16	28573634	.	C	T	2	6	8	0	2	10	0	0
16	28573795	.	G	A	0	3	3	0	5	8	0	0
16	28573957	.	T	A	3	3	6	0	0	6	0	0
16	28574063	.	C	T	2	4	6	0	0	6	0	0
16	28574403	.	C	T	4	3	7	0	0	7	0	0
16	28574465	.	G	A	0	5	5	0	7	12	0	0
16	28581874	.	A	C	2	2	4	0	0	4	0	0
16	28591305	.	A	T	11	14	25	0	0	25	0	0
16	28591363	.	G	A	15	9	24	0	0	24	0	0
16	28591459	.	G	A	1	7	8	0	13	21	0	0
16	28592697	.	C	A	7	4	11	0	0	11	0	0
16	28592745	.	T	C	8	3	11	0	2	13	0	0
16	28592946	.	G	A	7	6	13	0	0	13	0	0
16	28593242	.	A	G	1	3	4	0	1	5	0	0
16	28593802	.	T	C	6	3	9	0	0	9	0	0
16	28593952	.	T	C	0	1	1	0	0	1	0	0
16	28598780	.	T	A	26	20	46	0	1	47	0	0
16	28598790	.	A	T	26	18	44	0	2	46	0	0
16	28598846	.	G	T	0	8	8	0	9	17	0	0
16	28620694	.	T	A	0	1	1	0	0	1	0	0
16	28624648	.	G	C	0	2	2	0	1	3	0	0
16	28624670	.	C	T	1	0	1	0	0	1	0	0
16	28626257	.	G	C	0	1	1	0	2	3	0	0
16	28626843	.	G	A	1	3	4	0	1	5	0	0
16	28626844	.	G	T	2	3	5	0	0	5	0	0
16	28627127	.	C	T	2	2	4	0	0	4	0	0
16	28627240	.	G	A	1	2	3	0	1	4	0	0
16	28627341	.	T	G	4	2	6	0	1	7	0	0
16	28627342	.	T	A	5	1	6	0	1	7	0	0
16	28627383	.	T	G	5	6	11	0	2	13	0	0
16	28627385	.	T	A	6	6	12	0	1	13	0	0
16	28627467	.	C	T	3	5	8	0	0	8	0	0
16	28627485	.	C	T	2	6	8	0	0	8	0	0
16	28627522	.	G	T	2	3	5	0	0	5	0	0
16	28629285	.	C	A	2	5	7	0	0	7	0	0
16	28632525	.	C	T	1	2	3	0	0	3	0	0
16	28663405	.	A	G	0	2	2	0	0	2	0	0
16	28664720	.	A	C	2	2	4	0	0	4	0	0
16	28664721	.	C	T	2	2	4	0	0	4	0	0
16	28842438	.	C	T	22	14	36	0	2	38	0	0
16	28846595	.	G	T	8	3	11	0	1	12	0	0
16	28846761	.	T	C	5	5	10	0	0	10	0	0
16	28856026	.	G	A	5	10	15	0	0	15	0	0
16	28856034	.	G	A	5	8	13	0	0	13	0	0
16	28983936	.	T	C	1	2	3	0	0	3	0	0
16	28983939	.	C	T	1	2	3	0	0	3	0	0
16	28986722	.	A	G	1	2	3	0	0	3	0	0
16	28986728	.	C	T	1	2	3	0	0	3	0	0
16	28990523	.	C	G	2	4	6	0	1	7	0	0
16	28990948	.	T	G	1	3	4	0	0	4	0	0
16	29010125	.	C	T	1	2	3	0	0	3	0	0
16	29012933	.	G	T	1	4	5	0	4	9	0	0
16	29013039	.	C	G	3	4	7	0	0	7	0	0
16	29013126	.	C	T	3	2	5	0	0	5	0	0
16	29013134	.	C	A	3	2	5	0	0	5	0	0
16	29013188	.	C	T	3	2	5	0	0	5	0	0
16	29013377	.	C	T	4	6	10	0	0	10	0	0
16	29014091	.	A	T	4	3	7	0	1	8	0	0
16	29014109	.	T	C	5	3	8	0	0	8	0	0
16	29016904	.	T	C	6	6	12	0	1	13	0	0
16	29017221	.	T	C	3	5	8	0	0	8	0	0
16	29019039	.	G	A	9	6	15	0	0	15	0	0
16	29020482	.	G	T	4	1	5	0	1	6	0	0
16	29022955	.	C	A	11	13	24	0	0	24	0	0
16	29022963	.	A	G	11	12	23	0	0	23	0	0
16	29023266	.	A	T	3	4	7	0	0	7	0	0
16	29024181	.	A	G	1	3	4	0	0	4	0	0
16	29024739	.	T	A	1	2	3	0	0	3	0	0
16	29029296	.	T	C	4	3	7	0	0	7	0	0
16	29029444	.	G	A	1	3	4	0	0	4	0	0
16	29029476	.	A	G	1	3	4	0	0	4	0	0
16	29051841	.	C	G	1	3	4	0	0	4	0	0
16	29051842	.	C	A	1	3	4	0	0	4	0	0
16	29052030	.	C	T	2	2	4	0	1	5	0	0
16	29052914	.	G	A	2	3	5	0	0	5	0	0
16	29052991	.	C	T	8	4	12	0	1	13	0	0
16	29053166	.	A	G	2	3	5	0	0	5	0	0
16	29053534	.	A	G	2	5	7	0	1	8	0	0
16	29053781	.	A	T	7	10	17	0	0	17	0	0
16	29053798	.	C	G	8	0	8	0	12	20	0	0
16	29053923	.	C	A	4	3	7	0	2	9	0	0
16	29073539	.	C	T	13	6	19	0	5	24	0	0
16	29073621	.	T	A	9	3	12	0	1	13	0	0
16	29074254	.	G	A	20	24	44	0	1	45	0	0
16	29074535	.	A	G	9	11	20	0	0	20	0	0
16	29074688	.	A	G	14	16	30	0	2	32	0	0
16	29075222	.	T	A	7	7	14	0	0	14	0	0
16	29075343	.	G	A	10	12	22	0	0	22	0	0
16	29075674	.	C	A	9	12	21	0	3	24	0	0
16	29075757	.	A	G	3	4	7	0	1	8	0	0
16	29075870	.	G	T	9	7	16	0	1	17	0	0
16	29075959	.	C	T	5	6	11	0	3	14	0	0
16	29076009	.	T	A	4	10	14	0	2	16	0	0
16	29076019	.	A	C	5	11	16	0	3	19	0	0
16	29076407	.	C	T	0	12	12	0	15	27	0	0
16	29076575	.	C	G	0	10	10	0	13	23	0	0
16	29076633	.	G	A	7	8	15	0	0	15	0	0
16	29076669	.	A	G	2	6	8	0	0	8	0	0
16	29076678	.	T	C	0	0	0	0	5	5	0	0
16	29091699	.	T	C	1	3	4	0	0	4	0	0
16	29111066	.	T	C	0	0	0	0	8	8	0	0
16	29222033	.	T	C	5	14	19	0	1	20	0	0
16	29222167	.	G	A	3	6	9	0	0	9	0	0
16	29225752	.	A	G	1	1	2	0	0	2	0	0
16	29225763	.	A	G	2	3	5	0	0	5	0	0
16	29225902	.	G	C	5	6	11	0	1	12	0	0
16	29226151	.	C	T	4	4	8	0	1	9	0	0
16	29226538	.	G	T	1	3	4	0	0	4	0	0
16	29226566	.	T	C	4	2	6	0	1	7	0	0
16	29265904	.	A	G	1	2	3	0	1	4	0	0
16	29310206	.	A	G	10	3	13	0	0	13	0	0
16	29310213	.	C	A	8	3	11	0	1	12	0	0
16	29310281	.	C	G	13	12	25	0	2	27	0	0
16	29310455	.	C	T	13	9	22	0	3	25	0	0
16	29310530	.	C	A	19	13	32	0	1	33	0	0
16	29310541	.	A	G	20	12	32	0	0	32	0	0
16	29311367	.	C	A	8	3	11	0	2	13	0	0
16	29311381	.	G	A	8	3	11	0	0	12	1	0
16	29311489	.	A	G	9	7	16	0	1	17	0	0
16	29311720	.	T	C	1	1	2	0	1	3	0	0
16	29320647	.	A	G	6	2	8	0	0	8	0	0
16	29323247	.	A	T	4	2	6	0	1	8	1	0
16	29380846	.	C	G	3	2	5	0	1	6	0	0
16	29380920	.	A	C	2	3	5	0	0	5	0	0
16	29380922	.	C	T	2	3	5	0	0	5	0	0
16	29383834	.	A	C	1	2	3	0	2	5	0	0
16	29384090	.	T	C	1	3	4	0	0	4	0	0
16	29384099	.	T	A	2	3	5	0	0	5	0	0
16	29384139	.	G	A	4	4	8	0	0	8	0	0
16	29384182	.	C	T	4	4	8	0	0	8	0	0
16	29384187	.	T	C	4	4	8	0	0	8	0	0
16	29407754	.	C	T	6	7	13	0	1	14	0	0
16	29408060	.	T	C	21	31	52	0	7	59	0	0
16	29408172	.	T	A	39	24	63	0	3	66	0	0
16	29408926	.	A	T	16	15	31	0	0	31	0	0
16	29409476	.	T	C	25	12	37	0	3	40	0	0
16	29409480	.	T	C	23	13	36	0	2	38	0	0
16	29409533	.	T	G	8	15	23	0	2	25	0	0
16	29409544	.	T	C	10	10	20	0	4	24	0	0
16	29409732	.	T	G	21	19	40	0	5	45	0	0
16	29409918	.	T	G	12	15	27	0	1	28	0	0
16	29410032	.	A	G	12	11	23	0	3	26	0	0
16	29410033	.	G	A	12	12	24	0	2	26	0	0
16	29410107	.	A	C	21	32	53	0	2	55	0	0
16	29410129	.	C	T	20	31	51	0	1	52	0	0
16	29410251	.	T	A	9	17	26	0	3	29	0	0
16	29410418	.	C	T	0	25	25	0	14	39	0	0
16	29410425	.	A	G	13	24	37	0	1	38	0	0
16	29410620	.	T	C	13	0	13	0	10	23	0	0
16	29410679	.	T	G	8	20	28	0	0	28	0	0
16	29410921	.	G	A	16	17	33	0	0	33	0	0
16	29411196	.	A	G	14	15	29	0	0	29	0	0
16	29411436	.	G	C	16	12	28	0	2	30	0	0
16	29411646	.	G	A	7	10	17	0	1	18	0	0
16	29411741	.	T	A	5	4	9	0	0	9	0	0
16	29412074	.	T	A	3	6	9	0	1	10	0	0
16	29413166	.	C	T	6	12	18	0	1	19	0	0
16	29456165	.	G	T	2	2	4	0	0	4	0	0
16	29457158	.	A	G	5	2	7	0	0	7	0	0
16	30268660	.	A	G	7	3	10	0	1	11	0	0
16	30268767	.	A	G	13	8	21	0	1	22	0	0
16	30423224	.	T	C	6	0	6	0	7	13	0	0
16	30808615	.	T	C	0	1	1	0	0	1	0	0
16	30919363	.	A	G	2	2	4	0	0	4	0	0
16	31469176	.	A	T	1	2	3	0	0	3	0	0
16	31516536	.	T	C	0	2	2	0	0	2	0	0
16	31602170	.	A	G	1	0	1	0	0	1	0	0
16	31608967	.	G	T	1	2	3	0	0	3	0	0
16	31609241	.	C	T	0	1	1	0	1	2	0	0
16	31762960	.	C	T	18	18	36	0	1	37	0	0
16	31763316	.	T	C	18	9	27	0	1	28	0	0
16	31763318	.	C	T	18	9	27	0	1	28	0	0
16	31763668	.	C	G	7	15	22	0	5	27	0	0
16	31763743	.	T	A	14	22	36	0	1	37	0	0
16	31763751	.	A	C	12	19	31	0	3	34	0	0
16	31763785	.	G	A	25	12	37	0	1	38	0	0
16	31763786	.	C	A	22	12	34	0	4	38	0	0
16	31763880	.	A	G	17	18	35	0	0	35	0	0
16	31764987	.	C	T	2	1	3	0	0	3	0	0
16	31766937	.	T	A	0	3	3	0	0	3	0	0
16	31767116	.	T	C	7	0	7	0	12	19	0	0
16	31767152	.	A	G	5	6	11	0	0	11	0	0
16	31767163	.	G	A	5	5	10	0	0	10	0	0
16	31768343	.	C	G	10	4	14	0	0	14	0	0
16	31768394	.	T	C	11	6	17	0	0	17	0	0
16	31768436	.	T	C	12	11	23	0	0	23	0	0
16	31769317	.	G	A	3	5	8	0	2	10	0	0
16	31769395	.	A	G	5	2	7	0	0	7	0	0
16	31769428	.	G	A	1	0	1	0	0	1	0	0
16	31770050	.	T	C	2	0	2	0	7	9	0	0
16	31776125	.	C	T	0	1	1	0	0	1	0	0
16	31780108	.	C	T	0	1	1	0	1	2	0	0
16	31815523	.	C	A	10	3	13	0	2	15	0	0
16	31815584	.	T	A	8	2	10	0	1	11	0	0
16	31815638	.	C	T	14	10	24	0	0	24	0	0
16	31815878	.	G	A	13	7	20	0	0	20	0	0
16	31816005	.	C	A	10	13	23	0	1	24	0	0
16	31816205	.	C	T	8	1	9	0	2	11	0	0
16	31816596	.	C	T	5	16	21	0	0	21	0	0
16	31827642	.	T	A	7	9	16	0	0	16	0	0
16	31827703	.	C	T	13	9	22	0	2	24	0	0
16	31832606	.	A	G	8	0	8	0	33	41	0	0
16	31834746	.	C	T	1	2	3	0	1	4	0	0
16	31837073	.	G	A	1	3	4	0	0	4	0	0
16	31853932	.	T	A	0	1	1	0	0	1	0	0
16	31855351	.	G	C	0	2	2	0	1	3	0	0
16	31855575	.	C	T	1	3	4	0	1	5	0	0
16	31855576	.	C	T	1	4	5	0	0	5	0	0
16	31856276	.	G	A	0	2	2	0	1	3	0	0
16	31859065	.	A	G	2	0	2	0	11	13	0	0
16	31859227	.	T	C	20	14	34	0	3	37	0	0
16	31859310	.	A	G	18	10	28	0	3	31	0	0
16	31859341	.	C	T	16	21	37	0	1	38	0	0
16	31859371	.	T	C	16	17	33	0	3	36	0	0
16	31859416	.	T	C	7	24	31	0	1	32	0	0
16	31859425	.	C	T	1	23	24	0	6	30	0	0
16	31859686	.	G	A	8	12	20	0	0	20	0	0
16	31868443	.	G	A	15	20	35	0	3	38	0	0
16	31922892	.	A	G	6	3	9	0	0	9	0	0
16	31923083	.	G	A	24	15	39	0	6	45	0	0
16	31923435	.	A	G	28	28	56	0	1	57	0	0
16	31924485	.	T	C	22	26	48	0	1	49	0	0
16	31924501	.	A	C	22	26	48	0	4	52	0	0
16	31958957	.	G	T	0	2	2	0	0	2	0	0
16	31959098	.	G	A	0	2	2	0	3	5	0	0
16	31959476	.	G	A	0	3	3	0	0	3	0	0
16	31959496	.	A	G	3	0	3	0	2	5	0	0
16	31959612	.	G	A	2	5	7	0	0	7	0	0
16	31960037	.	G	A	0	4	4	0	5	9	0	0
16	31960145	.	C	T	9	9	18	0	1	19	0	0
16	31960152	.	C	T	7	10	17	0	2	19	0	0
16	32011649	.	C	T	2	4	6	0	0	6	0	0
16	32013272	.	G	A	1	1	2	0	0	2	0	0
16	32013861	.	G	A	4	3	7	0	0	7	0	0
16	32013891	.	G	A	4	2	6	0	1	7	0	0
16	32019695	.	G	A	0	2	2	0	0	2	0	0
16	32023124	.	T	A	0	3	3	0	0	3	0	0
16	32025648	.	T	A	5	12	17	0	1	18	0	0
16	32025978	.	G	A	6	9	15	0	0	15	0	0
16	32025987	.	T	A	6	9	15	0	1	16	0	0
16	32026063	.	G	A	0	5	5	0	8	13	0	0
16	32026105	.	T	A	7	4	11	0	0	11	0	0
16	32026154	.	T	G	2	2	4	0	0	4	0	0
16	32051854	.	A	C	3	2	5	0	3	8	0	0
16	32052004	.	T	G	0	4	4	0	0	4	0	0
16	32052283	.	T	A	0	2	2	0	0	2	0	0
16	32052307	.	T	C	0	6	6	0	0	6	0	0
16	32052328	.	T	A	2	9	11	0	1	12	0	0
16	32052404	.	G	T	0	3	3	0	6	9	0	0
16	32055726	.	T	G	9	11	20	0	2	22	0	0
16	32057809	.	T	C	6	4	10	0	1	11	0	0
16	32057853	.	G	A	0	6	6	0	6	12	0	0
16	32071965	.	G	C	4	2	6	0	0	6	0	0
16	32071997	.	C	A	5	2	7	0	0	7	0	0
16	32072334	.	A	G	6	9	15	0	1	16	0	0
16	32073301	.	A	C	9	11	20	0	0	20	0	0
16	32073507	.	A	C	12	14	26	0	0	26	0	0
16	32073555	.	A	G	14	13	27	0	2	29	0	0
16	32073760	.	G	A	15	13	28	0	2	30	0	0
16	32074041	.	G	A	14	7	21	0	1	22	0	0
16	32074257	.	A	G	14	0	14	0	21	35	0	0
16	32074293	.	T	A	12	23	35	0	1	36	0	0
16	32074294	.	A	G	9	22	31	0	5	36	0	0
16	32080069	.	G	T	1	9	10	0	11	21	0	0
16	32080099	.	G	A	5	2	7	0	0	7	0	0
16	32080196	.	T	C	1	5	6	0	1	7	0	0
16	32080206	.	T	C	1	6	7	0	0	7	0	0
16	32080306	.	T	A	7	3	10	0	0	10	0	0
16	32080508	.	T	A	15	13	28	0	2	30	0	0
16	32080738	.	G	A	1	5	6	0	0	6	0	0
16	32082397	.	T	C	4	0	4	0	0	4	0	0
16	32082589	.	G	A	2	6	8	0	0	8	0	0
16	32082597	.	G	A	2	6	8	0	0	8	0	0
16	32082642	.	G	A	2	3	5	0	0	5	0	0
16	32085319	.	T	A	0	1	1	0	0	1	0	0
16	32085778	.	A	C	0	1	1	0	0	1	0	0
16	32086136	.	C	T	3	3	6	0	0	6	0	0
16	32090349	.	C	T	15	6	21	0	2	23	0	0
16	32090425	.	G	C	14	5	19	0	2	21	0	0
16	32110659	.	A	G	13	17	30	0	0	30	0	0
16	32111246	.	G	T	7	16	23	0	4	27	0	0
16	32113155	.	G	A	11	5	16	0	3	19	0	0
16	32113218	.	G	A	5	1	6	0	2	8	0	0
16	32116790	.	A	T	2	2	4	0	0	4	0	0
16	32117345	.	T	A	4	3	7	0	1	8	0	0
16	32119581	.	C	A	4	7	11	0	2	13	0	0
16	32119618	.	C	T	4	7	11	0	0	11	0	0
16	32119895	.	G	T	4	3	7	0	0	7	0	0
16	32120173	.	G	A	5	4	9	0	0	9	0	0
16	32120204	.	G	T	4	4	8	0	0	8	0	0
16	32120279	.	A	C	1	5	6	0	0	6	0	0
16	32140378	.	C	T	1	3	4	0	0	4	0	0
16	32141544	.	A	G	5	0	5	0	6	11	0	0
16	32141565	.	A	C	4	2	6	0	2	8	0	0
16	32141604	.	A	T	2	2	4	0	0	4	0	0
16	32144854	.	G	T	0	3	3	0	3	6	0	0
16	32145160	.	T	A	8	5	13	0	2	15	0	0
16	32145547	.	T	C	2	4	6	0	0	6	0	0
16	32145636	.	A	G	10	5	15	0	1	16	0	0
16	32197969	.	C	T	1	0	1	0	0	1	0	0
16	32267128	.	G	A	4	3	7	0	0	7	0	0
16	32267203	.	G	A	0	3	3	0	7	10	0	0
16	32273066	.	G	T	1	0	1	0	0	1	0	0
16	32273192	.	G	A	0	2	2	0	2	4	0	0
16	32274935	.	G	A	2	4	6	0	1	7	0	0
16	32275628	.	A	T	4	9	13	0	0	13	0	0
16	32561581	.	T	A	5	8	13	0	0	13	0	0
16	32561618	.	T	C	1	6	7	0	2	9	0	0
16	32562038	.	A	T	5	3	8	0	2	10	0	0
16	33102463	.	C	T	37	12	49	0	3	52	0	0
16	33735481	.	G	A	4	3	7	0	0	7	0	0
16	33735503	.	C	T	2	4	6	0	0	6	0	0
16	33735933	.	A	T	1	2	3	0	0	3	0	0
16	33735934	.	C	T	1	2	3	0	0	3	0	0
16	33773861	.	A	G	1	4	5	0	0	5	0	0
16	33774448	.	C	T	0	3	3	0	1	4	0	0
16	33910305	.	G	A	1	1	2	0	0	2	0	0
16	33923421	.	G	T	1	4	5	0	0	5	0	0
16	33923448	.	G	T	6	4	10	0	0	10	0	0
16	33923514	.	G	A	6	9	15	0	0	15	0	0
16	33925565	.	T	G	5	3	8	0	1	9	0	0
16	33926074	.	C	T	0	1	1	0	0	1	0	0
16	33928015	.	G	A	0	3	3	0	1	4	0	0
16	33933213	.	C	T	2	3	5	0	0	5	0	0
16	33933496	.	G	C	2	4	6	0	0	6	0	0
16	33933498	.	C	T	3	2	5	0	1	6	0	0
16	33939824	.	T	C	1	2	3	0	0	3	0	0
16	33939859	.	C	T	2	5	7	0	0	7	0	0
16	33940098	.	G	A	3	4	7	0	1	8	0	0
16	33940122	.	G	A	3	3	6	0	0	6	0	0
16	33940364	.	A	G	6	1	7	0	4	11	0	0
16	33940379	.	T	A	7	7	14	0	0	14	0	0
16	33983784	.	T	G	4	5	9	0	0	9	0	0
16	33983904	.	C	T	6	6	12	0	0	12	0	0
16	33984178	.	C	T	1	2	3	0	0	3	0	0
16	33984190	.	C	T	1	2	3	0	1	4	0	0
16	33985050	.	G	T	0	12	12	0	9	21	0	0
16	33985362	.	C	T	7	13	20	0	2	22	0	0
16	33986179	.	A	T	9	15	24	0	3	27	0	0
16	33986452	.	T	G	21	21	42	0	1	43	0	0
16	33995754	.	G	A	1	1	2	0	1	3	0	0
16	33996739	.	C	T	2	0	2	0	0	2	0	0
16	34004562	.	G	A	0	3	3	0	5	8	0	0
16	34004595	.	T	C	10	11	21	0	0	21	0	0
16	34004862	.	C	T	4	6	10	0	0	10	0	0
16	34005415	.	C	T	10	7	17	0	0	17	0	0
16	34005500	.	C	A	4	2	6	0	1	7	0	0
16	34005669	.	C	T	8	8	16	0	2	18	0	0
16	34005686	.	C	T	10	10	20	0	1	21	0	0
16	34005812	.	T	A	9	7	16	0	0	16	0	0
16	34005845	.	A	G	11	4	15	0	3	18	0	0
16	34006051	.	G	A	0	2	2	0	0	2	0	0
16	34054171	.	A	G	1	2	3	0	0	3	0	0
16	34054464	.	C	A	1	3	4	0	1	5	0	0
16	34054515	.	A	G	1	1	2	0	0	2	0	0
16	34054519	.	C	T	1	1	2	0	0	2	0	0
16	34054923	.	G	A	0	3	3	0	2	5	0	0
16	34056324	.	T	G	1	3	4	0	0	4	0	0
16	34172916	.	G	A	4	2	6	0	0	6	0	0
16	34173000	.	T	C	1	3	4	0	1	5	0	0
16	34173331	.	G	A	3	3	6	0	0	6	0	0
16	34185709	.	A	C	2	5	7	0	0	7	0	0
16	34185906	.	A	T	10	7	17	0	1	18	0	0
16	34200704	.	C	T	3	1	4	0	1	5	0	0
16	34201023	.	A	G	5	4	9	0	2	11	0	0
16	34208696	.	A	G	11	18	29	0	2	31	0	0
16	34212477	.	A	G	11	7	18	0	0	18	0	0
16	34212516	.	A	G	8	6	14	0	2	16	0	0
16	34212565	.	G	A	8	16	24	0	3	27	0	0
16	34212567	.	G	C	11	15	26	0	1	27	0	0
16	34212630	.	T	C	12	2	14	0	14	28	0	0
16	34222439	.	T	G	6	5	11	0	2	13	0	0
16	34225173	.	T	C	1	0	1	0	0	1	0	0
16	34225392	.	A	G	11	10	21	0	0	21	0	0
16	34225472	.	G	A	8	6	14	0	0	14	0	0
16	34267938	.	C	T	0	2	2	0	1	3	0	0
16	34267991	.	G	C	1	2	3	0	0	4	1	0
16	34303761	.	T	G	1	0	1	0	0	1	0	0
16	34321568	.	A	T	1	10	11	0	0	11	0	0
16	34322036	.	G	T	5	5	10	0	0	10	0	0
16	34322346	.	G	A	13	18	31	0	1	32	0	0
16	34322372	.	C	T	1	16	17	0	10	27	0	0
16	34331489	.	A	G	1	1	2	0	1	3	0	0
16	34337976	.	A	T	6	9	15	0	1	16	0	0
16	34338475	.	A	G	8	8	16	0	0	16	0	0
16	34339432	.	A	T	5	9	14	0	1	15	0	0
16	34339693	.	C	T	2	3	5	0	0	5	0	0
16	34339808	.	A	G	3	2	5	0	1	6	0	0
16	34339857	.	T	G	3	3	6	0	0	6	0	0
16	34340397	.	A	C	4	5	9	0	0	9	0	0
16	34340520	.	G	T	1	1	2	0	3	5	0	0
16	34340538	.	C	T	2	2	4	0	0	4	0	0
16	34340965	.	C	T	1	2	3	0	0	3	0	0
16	34340967	.	A	G	1	2	3	0	0	3	0	0
16	34342182	.	T	C	3	2	5	0	1	6	0	0
16	34461322	.	G	A	1	2	3	0	0	3	0	0
16	34498734	.	A	G	1	0	1	0	7	8	0	0
16	34498785	.	G	C	2	2	4	0	0	4	0	0
16	34498787	.	A	G	2	1	3	0	1	4	0	0
16	34498872	.	A	G	4	3	7	0	0	7	0	0
16	34499778	.	G	A	0	4	4	0	0	4	0	0
16	34499960	.	A	T	3	7	10	0	1	11	0	0
16	34500007	.	C	T	5	3	8	0	0	8	0	0
16	34500542	.	G	C	9	8	17	0	2	19	0	0
16	34500683	.	A	G	0	2	2	0	0	2	0	0
16	34500840	.	T	G	7	9	16	0	1	17	0	0
16	34500899	.	G	A	10	9	19	0	1	20	0	0
16	34501136	.	C	T	9	8	17	0	0	17	0	0
16	34501137	.	A	G	9	8	17	0	0	17	0	0
16	34501380	.	C	T	8	7	15	0	0	15	0	0
16	34501589	.	A	G	4	0	4	0	1	5	0	0
16	34501794	.	G	A	9	7	16	0	2	18	0	0
16	34525621	.	C	A	22	20	42	0	3	45	0	0
16	34526092	.	C	G	23	19	42	0	2	45	1	0
16	34526093	.	A	C	20	19	39	0	6	45	0	0
16	34526926	.	A	T	32	23	55	1	15	71	0	0
16	34527183	.	C	T	5	4	9	0	4	13	0	0
16	34532205	.	G	A	0	5	5	0	2	7	0	0
16	34532799	.	G	A	0	3	3	0	2	5	0	0
16	34930635	.	A	G	0	1	1	0	0	1	0	0
16	34930719	.	C	T	0	4	4	0	5	9	0	0
16	34948262	.	C	T	3	3	6	0	0	6	0	0
16	35053907	.	C	G	1	1	2	0	1	3	0	0
16	35376825	.	C	T	4	3	7	0	0	7	0	0
16	35376832	.	G	T	3	3	6	0	0	6	0	0
16	35376929	.	C	T	2	2	4	0	0	4	0	0
16	35376933	.	C	G	2	2	4	0	0	4	0	0
16	35411363	.	T	C	6	7	13	0	0	13	0	0
16	35414455	.	A	G	6	4	10	0	0	10	0	0
16	35414470	.	T	C	4	4	8	0	0	8	0	0
16	35415710	.	A	G	3	5	8	0	0	8	0	0
16	35415872	.	G	A	6	7	13	0	0	13	0	0
16	35416158	.	C	T	0	1	1	0	2	3	0	0
16	35418804	.	G	A	6	6	12	0	2	14	0	0
16	35423651	.	A	G	4	4	8	0	1	9	0	0
16	35423985	.	C	T	0	1	1	0	0	1	0	0
16	35424003	.	A	T	0	0	0	0	0	0	0	0
16	35426998	.	T	C	4	0	4	0	8	12	0	0
16	35535353	.	T	G	2	4	6	0	0	6	0	0
16	35536480	.	G	A	12	11	23	2	2	27	0	0
16	35536574	.	C	A	7	13	20	0	2	22	0	0
16	35536576	.	G	A	0	14	14	0	8	22	0	0
16	35536739	.	C	T	7	7	14	0	1	15	0	0
16	35536960	.	T	C	8	10	18	0	1	19	0	0
16	35537153	.	G	A	11	8	19	0	1	20	0	0
16	35556275	.	C	A	1	3	4	0	0	4	0	0
16	35556365	.	A	G	2	2	4	0	1	5	0	0
16	35556378	.	G	A	2	2	4	0	0	4	0	0
16	35556619	.	T	C	4	2	6	0	0	6	0	0
16	35743809	.	A	G	2	4	6	0	1	7	0	0
16	35750548	.	T	C	3	4	7	0	1	8	0	0
16	35750647	.	T	G	9	7	16	0	4	20	0	0
16	35750648	.	G	C	9	11	20	0	0	20	0	0
16	35750714	.	T	A	5	13	18	0	1	19	0	0
16	35772762	.	C	T	18	10	28	0	2	30	0	0
16	35772933	.	T	C	15	15	30	0	1	31	0	0
16	35773005	.	A	G	9	14	23	0	2	25	0	0
16	36041247	.	G	A	0	2	2	0	0	2	0	0
16	36074270	.	C	A	3	2	5	0	1	6	0	0
16	36075417	.	T	A	5	9	14	0	0	14	0	0
16	36075471	.	G	A	3	10	13	0	2	15	0	0
16	36075478	.	T	A	5	8	13	0	1	14	0	0
16	36075677	.	C	A	15	5	20	0	2	22	0	0
16	36075999	.	A	G	11	6	17	0	2	19	0	0
16	36076082	.	G	A	4	9	13	0	0	13	0	0
16	36080364	.	C	T	10	7	17	0	0	17	0	0
16	36080376	.	A	C	10	7	17	0	0	17	0	0
16	36150674	.	A	G	2	3	5	0	0	5	0	0
16	36150707	.	C	T	3	6	9	0	0	9	0	0
16	36150949	.	C	T	5	6	11	0	4	15	0	0
16	36150964	.	C	T	4	6	10	0	2	12	0	0
16	36151000	.	C	A	2	0	2	0	0	2	0	0
16	36159928	.	T	C	16	12	28	0	2	30	0	0
16	36162013	.	C	T	7	15	22	0	5	27	0	0
16	36162201	.	A	G	7	5	12	0	3	15	0	0
16	36162584	.	G	C	0	17	17	0	6	23	0	0
16	36162650	.	T	C	12	13	25	0	1	26	0	0
16	36162727	.	A	G	16	7	23	0	2	25	0	0
16	36162754	.	A	G	13	6	19	0	3	22	0	0
16	36162938	.	G	T	14	5	19	0	0	19	0	0
16	36163005	.	G	A	8	8	16	0	0	16	0	0
16	36163006	.	A	C	7	8	15	0	1	16	0	0
16	36168251	.	C	T	9	8	17	0	0	17	0	0
16	36168317	.	G	C	14	9	23	0	1	24	0	0
16	36168416	.	T	C	8	7	15	0	2	17	0	0
16	36168450	.	A	T	8	3	11	0	2	13	0	0
16	36168510	.	A	T	3	5	8	0	1	9	0	0
16	36168729	.	T	C	1	0	1	0	2	3	0	0
16	36168747	.	T	C	2	2	4	0	0	4	0	0
16	36168768	.	G	T	3	2	5	0	2	7	0	0
16	36168787	.	T	A	3	5	8	0	0	8	0	0
16	36168994	.	C	T	1	5	6	0	0	6	0	0
16	36169007	.	T	C	1	5	6	0	0	6	0	0
16	36169057	.	T	G	2	5	7	0	0	7	0	0
16	36169150	.	T	C	4	8	12	0	0	12	0	0
16	36172982	.	C	T	0	3	3	0	0	3	0	0
16	36173406	.	A	T	0	1	1	0	1	2	0	0
16	36180591	.	A	G	1	2	3	0	0	3	0	0
16	36721560	.	A	T	4	2	6	0	5	11	0	0
16	36721589	.	T	G	5	5	10	0	3	13	0	0
16	36724010	.	C	G	0	6	6	0	6	12	0	0
16	36729322	.	A	T	3	4	7	0	0	7	0	0
16	36729352	.	G	T	6	8	14	0	0	14	0	0
16	36729373	.	A	G	4	9	13	0	3	16	0	0
16	36731307	.	A	G	3	7	10	0	1	11	0	0
16	36743328	.	G	A	3	5	8	0	0	8	0	0
16	36743351	.	G	A	2	3	5	0	0	5	0	0
16	36759812	.	A	G	2	1	3	0	2	5	0	0
16	36759834	.	T	C	1	2	3	0	0	3	0	0
16	36759908	.	A	T	7	5	12	0	0	12	0	0
16	36759937	.	A	G	6	5	11	0	0	11	0	0
16	36760093	.	C	T	1	2	3	0	0	3	0	0
16	36766180	.	T	G	14	8	22	0	1	23	0	0
16	36766467	.	G	T	5	7	12	0	5	17	0	0
16	36908844	.	C	A	3	2	5	0	0	5	0	0
16	36925462	.	G	A	0	2	2	0	5	7	0	0
16	36926775	.	C	A	8	1	9	0	1	10	0	0
16	36926779	.	A	C	8	0	8	0	0	8	0	0
16	36928169	.	A	T	2	1	3	0	0	3	0	0
16	36928179	.	A	C	2	1	3	0	0	3	0	0
16	36928429	.	A	G	4	3	7	0	0	7	0	0
16	36931728	.	T	C	21	6	27	0	2	29	0	0
16	36931822	.	T	C	9	5	14	1	0	15	0	0
16	36934191	.	T	A	5	2	7	0	0	7	0	0
16	36934340	.	C	A	1	2	3	0	2	5	0	0
16	36934398	.	G	C	4	5	9	0	4	13	0	0
16	36939973	.	T	C	0	1	1	0	1	2	0	0
16	36939982	.	A	G	0	2	2	0	0	2	0	0
16	36940045	.	C	T	3	4	7	0	2	9	0	0
16	36941706	.	T	C	0	1	1	0	0	1	0	0
16	36941790	.	T	C	5	2	7	0	0	7	0	0
16	36942068	.	C	A	1	1	2	0	0	2	0	0
16	36945182	.	T	G	2	1	3	0	1	4	0	0
16	36945288	.	G	A	1	3	4	0	0	4	0	0
16	36975141	.	G	A	8	7	15	0	0	15	0	0
16	36975146	.	C	T	0	5	5	0	8	13	0	0
16	36975318	.	T	A	6	5	11	0	0	11	0	0
16	36976721	.	A	G	5	10	15	0	2	17	0	0
16	36977387	.	A	G	3	4	7	0	0	7	0	0
16	36979518	.	G	A	12	6	18	0	3	21	0	0
16	36979521	.	A	G	11	8	19	0	1	20	0	0
16	37167011	.	A	T	1	2	3	0	0	3	0	0
16	37167545	.	T	A	1	9	10	0	0	10	0	0
16	37167589	.	T	G	3	12	15	0	1	16	0	0
16	37167784	.	C	G	3	7	10	0	1	11	0	0
16	37306905	.	G	A	1	5	6	0	0	6	0	0
16	37554821	.	C	T	2	2	4	0	1	5	0	0
16	37593444	.	G	A	2	1	3	0	0	3	0	0
16	37596645	.	C	T	2	4	6	0	0	6	0	0
16	37596669	.	G	A	1	4	5	0	0	5	0	0
16	37614071	.	A	G	0	2	2	0	1	3	0	0
16	37617738	.	T	C	16	13	29	0	1	30	0	0
16	37627218	.	T	G	6	10	16	1	8	25	0	0
16	37627762	.	G	A	1	17	18	0	15	33	0	0
16	37627997	.	T	G	21	22	43	0	1	44	0	0
16	37944176	.	C	T	1	3	4	0	0	4	0	0
16	37944222	.	G	A	0	3	3	0	2	5	0	0
16	37947769	.	T	C	8	4	12	0	0	12	0	0
16	37947944	.	C	T	7	3	10	0	0	10	0	0
16	37948061	.	A	G	7	9	16	0	2	18	0	0
16	37948199	.	C	T	1	7	8	0	0	8	0	0
16	37948205	.	T	C	1	0	1	0	7	8	0	0
16	37948256	.	G	T	5	4	9	0	0	10	1	0
16	37948425	.	A	G	10	8	18	0	0	18	0	0
16	37948426	.	G	T	9	8	17	0	1	18	0	0
16	37948624	.	G	A	7	4	11	0	2	13	0	0
16	37948625	.	G	A	7	5	12	0	1	13	0	0
16	38067822	.	G	A	1	4	5	0	0	5	0	0
16	38067856	.	G	A	1	3	4	0	0	4	0	0
16	38121981	.	C	T	0	2	2	0	1	3	0	0
16	38129689	.	T	C	1	2	3	0	1	4	0	0
16	38130661	.	T	C	1	2	3	0	0	3	0	0
16	38132166	.	C	T	1	2	3	0	0	3	0	0
16	38133170	.	G	C	4	3	7	0	0	7	0	0
16	38133696	.	A	T	1	2	3	0	0	3	0	0
16	38133732	.	C	G	6	4	10	0	0	10	0	0
16	38133804	.	C	T	9	5	14	0	0	14	0	0
16	38133903	.	A	G	10	4	14	0	0	14	0	0
16	38134152	.	A	G	3	1	4	0	1	5	0	0
16	38134215	.	G	A	2	5	7	0	0	7	0	0
16	38134302	.	C	T	1	2	3	0	0	3	0	0
16	38134428	.	C	A	5	6	11	0	0	11	0	0
16	38134467	.	G	A	3	7	10	0	2	12	0	0
16	38134515	.	C	T	7	7	14	0	2	16	0	0
16	38134676	.	C	A	2	2	4	0	1	5	0	0
16	38134710	.	T	A	8	4	12	0	0	12	0	0
16	38135166	.	C	A	17	5	22	0	0	22	0	0
16	38135555	.	A	T	1	2	3	0	1	4	0	0
16	38135591	.	G	T	1	5	6	0	1	7	0	0
16	38135625	.	C	G	3	3	6	0	0	6	0	0
16	38135626	.	T	G	3	3	6	0	0	6	0	0
16	38135740	.	T	C	4	4	8	0	1	9	0	0
16	38135763	.	A	G	6	4	10	0	1	11	0	0
16	38135816	.	T	C	6	3	9	0	1	10	0	0
16	38135953	.	A	T	5	2	7	0	0	7	0	0
16	38136317	.	G	A	16	9	25	0	2	27	0	0
16	38167734	.	T	C	1	3	4	0	0	4	0	0
16	38188955	.	G	A	0	6	6	0	2	8	0	0
16	38191645	.	C	T	2	2	4	0	0	4	0	0
16	38193969	.	A	G	3	4	7	0	1	8	0	0
16	38194017	.	T	C	3	2	5	0	0	5	0	0
16	38198125	.	C	A	8	9	17	0	2	20	1	0
16	38198418	.	T	G	9	9	18	0	1	19	0	0
16	38198648	.	G	A	6	10	16	0	0	16	0	0
16	38198836	.	A	T	14	12	26	0	1	27	0	0
16	38199369	.	T	A	5	4	9	0	0	9	0	0
16	38354134	.	A	G	5	6	11	0	0	11	0	0
16	38454535	.	A	G	3	4	7	0	2	9	0	0
16	38556912	.	G	A	14	11	25	0	1	26	0	0
16	38556922	.	C	G	0	11	11	0	13	24	0	0
16	38557876	.	G	C	5	0	5	0	17	22	0	0
16	38590735	.	A	C	5	2	7	0	1	8	0	0
16	38626434	.	T	C	1	2	3	0	0	3	0	0
16	38663163	.	G	A	0	1	1	0	5	6	0	0
16	38729548	.	G	A	7	10	17	0	0	17	0	0
16	38940811	.	T	G	3	5	8	0	0	8	0	0
16	39154953	.	G	A	0	1	1	0	0	1	0	0
16	39160445	.	C	T	5	6	11	0	0	11	0	0
16	39160458	.	A	C	4	1	5	0	0	5	0	0
16	39162786	.	C	T	16	12	28	0	0	28	0	0
16	39164213	.	G	A	0	2	2	0	0	2	0	0
16	39166299	.	G	T	25	13	38	0	1	39	0	0
16	39166422	.	G	A	2	21	23	0	18	41	0	0
16	39166591	.	G	A	19	16	35	0	4	39	0	0
16	39185580	.	G	A	4	13	17	0	1	18	0	0
16	39190767	.	T	G	5	8	13	0	1	14	0	0
16	39194303	.	A	G	0	4	4	0	0	4	0	0
16	39196850	.	A	C	1	2	3	0	0	3	0	0
16	39238630	.	G	A	4	4	8	0	0	8	0	0
16	39245587	.	C	A	14	6	20	0	0	20	0	0
16	39249184	.	A	G	1	5	6	0	0	6	0	0
16	39271329	.	A	C	1	3	4	0	0	4	0	0
16	39287126	.	G	T	0	1	1	0	0	1	0	0
16	39297336	.	C	A	2	3	5	0	1	6	0	0
16	39297344	.	A	T	3	2	5	0	0	5	0	0
16	39325189	.	G	A	1	1	2	0	0	2	0	0
16	39361889	.	C	T	1	1	2	0	0	2	0	0
16	39362147	.	C	A	3	3	6	0	2	8	0	0
16	39362312	.	G	T	0	0	0	0	1	1	0	0
16	39372345	.	G	A	6	10	16	0	1	17	0	0
16	39372372	.	T	C	5	10	15	0	0	15	0	0
16	39372735	.	G	C	0	9	9	0	10	19	0	0
16	39372780	.	C	A	5	9	14	0	2	16	0	0
16	39382047	.	C	G	8	10	18	0	0	18	0	0
16	39382226	.	G	A	4	8	12	0	0	12	0	0
16	39382384	.	A	C	3	3	6	0	1	7	0	0
16	39382467	.	C	G	5	8	13	0	1	14	0	0
16	39385565	.	T	G	5	2	7	0	0	7	0	0
16	39385568	.	T	G	5	0	5	0	2	7	0	0
16	39385755	.	T	C	6	0	6	0	19	25	0	0
16	39386920	.	C	T	0	12	12	0	19	31	0	0
16	39393370	.	A	G	3	3	6	0	0	6	0	0
16	39394581	.	A	G	8	4	12	0	1	13	0	0
16	39396983	.	C	T	0	1	1	0	3	4	0	0
16	39413496	.	T	C	2	3	5	0	0	5	0	0
16	39413514	.	C	T	3	2	5	0	0	5	0	0
16	39505447	.	C	T	0	2	2	0	3	5	0	0
16	39643512	.	G	A	1	2	3	0	0	3	0	0
16	40066964	.	C	T	1	0	1	0	0	1	0	0
16	40073960	.	C	T	4	1	5	0	0	5	0	0
16	40131552	.	T	A	1	2	3	0	0	3	0	0
16	40131556	.	T	G	1	2	3	0	0	3	0	0
16	40153313	.	G	C	1	4	5	0	1	6	0	0
16	40340706	.	T	G	2	3	5	0	0	5	0	0
16	40340844	.	C	A	1	2	3	0	0	3	0	0
16	40340847	.	A	G	1	0	1	0	2	3	0	0
16	40341055	.	C	A	1	1	2	0	0	2	0	0
16	40343482	.	A	G	2	3	5	0	0	5	0	0
16	40343750	.	C	T	3	2	5	0	1	6	0	0
16	40495482	.	C	T	0	4	4	0	1	5	0	0
16	40569123	.	C	T	1	2	3	0	0	3	0	0
16	40569558	.	A	C	2	3	5	0	0	5	0	0
16	40594146	.	G	A	3	3	6	0	0	6	0	0
16	40607351	.	T	A	0	3	3	0	0	3	0	0
16	40622799	.	G	A	0	2	2	0	0	2	0	0
16	40954538	.	C	T	4	4	8	0	2	10	0	0
16	40954695	.	A	G	5	0	5	0	7	12	0	0
16	40954866	.	T	C	8	8	16	0	1	17	0	0
16	40954983	.	A	C	6	13	19	0	1	20	0	0
16	40955515	.	G	T	10	2	12	0	0	12	0	0
16	40955525	.	C	T	7	3	10	0	3	13	0	0
16	40955722	.	G	C	4	4	8	0	0	8	0	0
16	41023341	.	A	G	6	7	13	0	1	14	0	0
16	41023367	.	G	A	2	5	7	0	0	7	0	0
16	41023620	.	G	A	1	0	1	0	0	1	0	0
16	41023689	.	C	A	8	13	21	0	0	21	0	0
16	41023761	.	G	T	7	5	12	3	2	17	0	0
16	41028360	.	T	G	1	0	1	0	5	6	0	0
16	41029588	.	G	A	0	2	2	0	3	5	0	0
16	41029836	.	A	G	2	4	6	0	0	6	0	0
16	41029866	.	G	T	6	6	12	0	2	14	0	0
16	41029981	.	T	C	5	4	9	0	1	10	0	0
16	41030017	.	A	C	8	5	13	0	0	13	0	0
16	41030137	.	A	G	10	6	16	0	0	16	0	0
16	41030492	.	A	C	9	4	13	0	1	14	0	0
16	41030493	.	G	T	9	4	13	0	1	14	0	0
16	41052000	.	T	C	1	0	1	0	0	1	0	0
16	41059450	.	C	T	1	2	3	0	0	3	0	0
16	41059453	.	T	C	1	0	1	0	2	3	0	0
16	41112571	.	T	C	4	5	9	0	0	9	0	0
16	41112572	.	G	A	4	5	9	0	0	9	0	0
16	41112915	.	A	T	8	8	16	0	2	18	0	0
16	41112916	.	C	T	0	8	8	0	10	18	0	0
16	41113134	.	G	A	9	10	19	0	1	20	0	0
16	41113347	.	A	G	14	8	22	0	3	25	0	0
16	41113434	.	A	T	8	15	23	0	0	23	0	0
16	41113449	.	A	G	5	13	18	0	1	19	0	0
16	41113676	.	T	G	1	0	1	0	0	1	0	0
16	41113698	.	A	T	1	2	3	0	1	4	0	0
16	41113755	.	C	T	0	2	2	0	1	3	0	0
16	41114575	.	A	T	1	1	2	0	0	2	0	0
16	41114890	.	C	T	2	3	5	0	0	5	0	0
16	41116671	.	C	T	3	2	5	0	0	5	0	0
16	41117041	.	C	T	3	2	5	0	0	5	0	0
16	41345674	.	A	T	5	14	19	0	0	19	0	0
16	41345710	.	T	A	4	2	6	0	0	6	0	0
16	41345826	.	G	T	7	8	15	0	1	16	0	0
16	41346007	.	C	A	0	8	8	0	6	14	0	0
16	41353140	.	G	A	3	4	7	0	1	8	0	0
16	41353224	.	A	G	6	5	11	0	0	11	0	0
16	41354452	.	G	A	4	6	10	0	3	13	0	0
16	41393773	.	C	T	1	1	2	0	0	2	0	0
16	41468848	.	T	G	3	2	5	0	1	6	0	0
16	41469130	.	T	A	3	2	5	0	0	5	0	0
16	41469329	.	G	A	4	4	8	0	1	9	0	0
16	41469390	.	A	C	2	4	6	0	1	7	0	0
16	41469426	.	T	A	3	2	5	0	0	5	0	0
16	41469508	.	G	C	0	2	2	0	1	3	0	0
16	41507316	.	C	A	0	2	2	0	1	3	0	0
16	41585743	.	C	T	0	4	4	0	2	6	0	0
16	41589214	.	A	G	1	2	3	0	0	3	0	0
16	41703632	.	G	T	2	3	5	0	0	5	0	0
16	41717479	.	G	A	5	2	7	0	0	7	0	0
16	41717482	.	A	G	4	2	6	0	1	7	0	0
16	41717666	.	G	A	1	3	4	0	8	12	0	0
16	41720536	.	T	G	0	1	1	0	0	1	0	0
16	41720587	.	T	C	0	1	1	0	1	2	0	0
16	41723280	.	A	G	1	0	1	0	8	9	0	0
16	41725215	.	T	C	7	3	10	0	0	10	0	0
16	41725238	.	T	C	7	3	10	0	0	10	0	0
16	41727376	.	C	A	0	1	1	0	0	1	0	0
16	41730407	.	G	A	0	3	3	0	0	3	0	0
16	41730625	.	C	G	2	0	2	0	0	2	0	0
16	41731928	.	A	T	7	3	10	0	0	10	0	0
16	41731929	.	C	A	7	3	10	0	0	10	0	0
16	41732031	.	G	T	0	4	4	0	3	7	0	0
16	41732067	.	T	C	1	4	5	0	3	8	0	0
16	41732262	.	T	C	5	3	8	0	1	9	0	0
16	41732295	.	G	T	5	4	9	0	0	9	0	0
16	41732343	.	C	T	4	4	8	0	0	8	0	0
16	41732358	.	A	G	5	4	9	0	0	9	0	0
16	41732409	.	A	G	5	2	7	0	1	8	0	0
16	41740924	.	A	G	3	2	5	0	4	9	0	0
16	41741199	.	A	T	2	4	6	0	0	6	0	0
16	41742460	.	T	C	1	5	6	0	0	6	0	0
16	41742481	.	C	T	1	4	5	0	0	5	0	0
16	41794900	.	C	A	0	22	22	0	14	36	0	0
16	41801525	.	G	T	6	6	12	0	0	12	0	0
16	41873717	.	T	A	8	5	13	0	1	14	0	0
16	41873797	.	G	A	5	3	8	0	0	8	0	0
16	41873992	.	C	T	1	4	5	0	1	6	0	0
16	41874039	.	G	C	1	1	2	0	0	2	0	0
16	41891572	.	C	T	14	15	29	0	1	30	0	0
16	41891662	.	A	C	1	3	4	0	2	6	0	0
16	41896361	.	G	A	7	16	23	0	3	26	0	0
16	41897244	.	A	G	11	12	23	0	0	23	0	0
16	41897332	.	A	G	6	15	21	0	0	21	0	0
16	41897347	.	G	A	9	17	26	0	1	27	0	0
16	41897375	.	A	T	10	23	33	0	0	33	0	0
16	41897452	.	C	A	16	6	22	0	1	23	0	0
16	41903475	.	A	T	9	10	19	0	2	21	0	0
16	41903686	.	G	A	21	12	33	0	1	34	0	0
16	41903957	.	T	C	10	8	18	0	0	18	0	0
16	41904121	.	T	G	9	8	17	0	0	17	0	0
16	41904209	.	T	C	9	13	22	0	0	22	0	0
16	41904261	.	G	A	11	11	22	0	0	22	0	0
16	41904430	.	C	A	14	14	28	0	1	30	1	0
16	41904440	.	C	A	0	15	15	0	13	28	0	0
16	41904879	.	A	T	5	4	9	0	0	9	0	0
16	41904961	.	A	G	6	9	15	0	2	17	0	0
16	41905631	.	A	G	6	5	11	0	3	14	0	0
16	41905666	.	A	G	6	6	12	0	0	12	0	0
16	41905682	.	G	T	7	7	14	0	1	15	0	0
16	41905720	.	T	A	5	4	9	0	2	11	0	0
16	41905807	.	G	C	5	6	11	0	2	13	0	0
16	41916819	.	A	G	0	5	5	0	0	5	0	0
16	41929993	.	T	G	0	1	1	0	0	1	0	0
16	41933411	.	G	A	0	1	1	0	0	1	0	0
16	42072207	.	T	A	18	11	29	0	0	29	0	0
16	42072719	.	A	C	18	16	34	0	3	38	1	0
16	42073086	.	A	G	6	4	10	0	0	10	0	0
16	42073488	.	T	C	13	1	14	0	19	33	0	0
16	42083039	.	G	A	1	8	9	0	0	9	0	0
16	42091814	.	A	G	4	3	7	0	0	7	0	0
16	42177840	.	C	T	4	5	9	0	0	9	0	0
16	42179879	.	C	A	9	6	15	0	2	17	0	0
16	42180079	.	A	G	0	1	1	0	0	1	0	0
16	42180271	.	G	A	2	1	3	0	0	3	0	0
16	42186022	.	G	A	1	1	2	0	0	2	0	0
16	42186043	.	A	T	2	1	3	0	0	3	0	0
16	42322623	.	T	G	7	0	7	0	17	24	0	0
16	42322636	.	A	C	6	1	7	0	10	17	0	0
16	42423683	.	A	G	7	4	11	0	3	14	0	0
16	42424189	.	G	A	17	12	29	0	2	31	0	0
16	42424405	.	G	A	11	11	22	0	1	23	0	0
16	42428454	.	T	C	12	7	19	0	1	20	0	0
16	42428472	.	C	T	10	5	15	0	0	15	0	0
16	42440999	.	T	C	3	6	9	0	0	9	0	0
16	42443875	.	A	G	1	7	8	0	0	8	0	0
16	42443965	.	G	A	1	0	1	0	0	1	0	0
16	42472229	.	T	C	2	2	4	0	0	4	0	0
16	42472715	.	C	T	6	2	8	0	0	8	0	0
16	42482275	.	T	C	1	0	1	0	0	1	0	0
16	42482378	.	T	C	4	2	6	0	0	6	0	0
16	42482418	.	A	T	4	4	8	0	1	9	0	0
16	42487947	.	A	G	3	5	8	0	4	12	0	0
16	42490255	.	C	T	4	8	12	0	0	12	0	0
16	42490264	.	T	C	4	8	12	0	0	12	0	0
16	42493796	.	G	C	0	10	10	0	16	26	0	0
16	42493900	.	A	T	12	3	15	0	2	17	0	0
16	42494084	.	G	A	0	8	8	0	7	15	0	0
16	42494143	.	A	T	7	8	15	0	0	15	0	0
16	42494201	.	C	A	1	2	3	0	0	3	0	0
16	42681270	.	G	C	2	2	4	0	0	4	0	0
16	42829855	.	C	A	3	6	9	0	0	9	0	0
16	42840237	.	A	G	3	5	8	0	0	8	0	0
16	42843128	.	G	A	7	5	12	0	1	13	0	0
16	42900259	.	A	C	3	5	8	0	0	8	0	0
16	42900500	.	G	A	2	3	5	0	0	5	0	0
16	42900509	.	A	G	2	2	4	0	1	5	0	0
16	42938926	.	A	T	4	5	9	0	0	9	0	0
16	42938927	.	G	T	4	4	8	0	1	9	0	0
16	42938995	.	A	G	3	6	9	0	3	12	0	0
16	42939124	.	T	A	5	3	8	0	0	8	0	0
16	42939343	.	C	T	0	6	6	0	9	15	0	0
16	42939411	.	G	C	1	1	2	0	8	10	0	0
16	42939443	.	A	C	8	0	8	0	14	22	0	0
16	42939607	.	C	T	9	12	21	0	0	21	0	0
16	42939675	.	G	C	3	12	15	0	0	15	0	0
16	42939841	.	T	C	2	3	5	0	0	5	0	0
16	42941189	.	C	A	0	3	3	0	0	3	0	0
16	42941405	.	A	T	1	2	3	0	1	4	0	0
16	43001124	.	A	T	4	2	6	0	1	7	0	0
16	43001148	.	G	A	4	3	7	0	0	7	0	0
16	43001290	.	A	C	4	4	8	0	1	9	0	0
16	43001368	.	T	G	11	12	23	0	0	23	0	0
16	43011187	.	T	C	0	1	1	0	0	1	0	0
16	43011223	.	C	T	0	2	2	0	0	2	0	0
16	43015484	.	A	G	24	35	59	0	3	62	0	0
16	43026164	.	G	T	1	2	3	0	1	4	0	0
16	43026189	.	A	C	2	3	5	0	0	5	0	0
16	43026201	.	G	T	2	3	5	0	0	5	0	0
16	43028153	.	T	A	3	5	8	0	0	8	0	0
16	43028156	.	G	A	3	4	7	0	1	8	0	0
16	43028262	.	C	A	8	7	15	0	1	16	0	0
16	43028452	.	T	C	3	2	5	0	0	5	0	0
16	43028626	.	A	C	1	0	1	0	0	1	0	0
16	43126347	.	G	T	1	3	4	0	0	4	0	0
16	43126513	.	T	A	3	5	8	0	0	8	0	0
16	43126546	.	A	C	2	0	2	0	9	11	0	0
16	43126603	.	A	T	3	2	5	0	1	6	0	0
16	43130296	.	C	T	2	0	2	0	0	2	0	0
16	43228017	.	T	A	5	9	14	0	0	14	0	0
16	43228055	.	C	T	6	3	9	0	1	10	0	0
16	43228567	.	A	G	3	4	7	0	0	7	0	0
16	43228796	.	C	T	0	4	4	0	9	13	0	0
16	43228847	.	G	T	8	3	11	0	0	11	0	0
16	43228942	.	C	T	2	8	10	0	1	11	0	0
16	43228945	.	T	C	2	8	10	0	1	11	0	0
16	43229396	.	T	C	3	3	6	0	0	6	0	0
16	43229610	.	C	G	0	3	3	0	2	5	0	0
16	43229612	.	T	C	1	4	5	0	0	5	0	0
16	43230258	.	T	C	3	4	7	0	3	10	0	0
16	43230296	.	A	G	6	3	9	0	0	9	0	0
16	43263617	.	G	T	0	2	2	0	3	5	0	0
16	43269922	.	C	T	3	2	5	0	0	5	0	0
16	43283941	.	C	T	4	3	7	0	0	7	0	0
16	43284313	.	G	A	5	4	9	0	0	9	0	0
16	43284429	.	C	T	9	10	19	0	0	19	0	0
16	43291872	.	T	C	3	1	4	0	1	5	0	0
16	43291907	.	A	G	3	0	3	0	1	4	0	0
16	43297195	.	G	C	2	5	7	0	1	8	0	0
16	43300053	.	A	G	6	8	14	0	0	14	0	0
16	43300083	.	C	T	1	8	9	0	5	14	0	0
16	43301905	.	T	G	2	6	8	0	0	8	0	0
16	43303873	.	T	C	3	3	6	0	0	6	0	0
16	43303912	.	A	G	4	3	7	0	0	7	0	0
16	43303921	.	C	T	4	1	5	0	1	6	0	0
16	43303948	.	T	C	2	1	3	0	0	3	0	0
16	43306721	.	T	C	5	2	7	0	0	7	0	0
16	43306995	.	A	G	0	2	2	0	0	2	0	0
16	43336681	.	A	G	6	7	13	0	0	13	0	0
16	43336855	.	G	A	0	1	1	0	0	1	0	0
16	43341256	.	C	T	0	1	1	0	7	8	0	0
16	43345237	.	C	A	12	10	22	0	1	23	0	0
16	43346877	.	C	T	5	5	10	0	1	11	0	0
16	43349183	.	C	T	4	5	9	0	1	10	0	0
16	43350160	.	G	A	3	4	7	0	0	7	0	0
16	43350191	.	T	G	5	0	5	0	0	5	0	0
16	43350236	.	T	C	1	6	7	0	0	7	0	0
16	43368574	.	T	A	3	2	5	0	0	5	0	0
16	43368669	.	G	T	0	2	2	0	0	2	0	0
16	43375493	.	G	A	0	2	2	0	3	5	0	0
16	43375550	.	A	G	1	0	1	0	0	1	0	0
16	43389752	.	T	C	0	2	2	0	0	2	0	0
16	43389797	.	T	C	0	2	2	0	0	2	0	0
16	43391618	.	G	A	4	6	10	0	1	11	0	0
16	43517526	.	C	T	0	2	2	0	3	5	0	0
16	43804352	.	A	G	0	0	0	0	1	1	0	0
16	43804361	.	C	T	0	1	1	0	0	1	0	0
16	43819623	.	A	G	13	8	21	0	2	23	0	0
16	43819934	.	A	G	14	10	24	0	1	25	0	0
16	43820317	.	A	G	13	14	27	0	0	27	0	0
16	43820405	.	G	A	9	11	20	0	0	20	0	0
16	43820453	.	C	T	9	15	24	0	2	26	0	0
16	43820654	.	T	C	12	7	19	0	3	22	0	0
16	43820655	.	G	A	13	8	21	0	1	22	0	0
16	43820777	.	G	A	11	8	19	0	2	21	0	0
16	43821047	.	G	A	4	4	8	0	3	11	0	0
16	43821146	.	G	A	8	6	14	0	3	17	0	0
16	43821170	.	T	G	9	7	16	0	1	17	0	0
16	43821455	.	C	T	3	7	10	0	1	11	0	0
16	43821734	.	G	T	5	6	11	0	0	11	0	0
16	43822025	.	T	C	1	3	4	0	0	4	0	0
16	43822343	.	T	G	1	2	3	0	0	3	0	0
16	43822794	.	G	T	1	4	5	0	0	5	0	0
16	44349766	.	A	G	7	11	18	0	1	19	0	0
16	44349830	.	A	G	8	16	24	0	2	26	0	0
16	44379120	.	A	G	9	9	18	0	2	20	0	0
16	44379168	.	T	C	18	15	33	0	0	33	0	0
16	44379219	.	T	A	13	13	26	0	0	26	0	0
16	44460348	.	C	T	0	3	3	0	6	9	0	0
16	44462580	.	T	A	5	2	7	0	1	8	0	0
16	44509758	.	G	A	8	4	12	0	0	12	0	0
16	44509821	.	C	T	8	9	17	0	0	17	0	0
16	44509842	.	T	C	6	0	6	0	12	18	0	0
16	44509923	.	C	T	1	7	8	0	0	8	0	0
16	44510055	.	C	A	9	3	12	0	0	12	0	0
16	44512625	.	A	T	2	1	3	0	1	4	0	0
16	44512685	.	G	C	8	2	10	0	1	11	0	0
16	44512706	.	G	A	3	6	9	0	0	9	0	0
16	44512733	.	A	G	4	5	9	0	1	10	0	0
16	44588173	.	G	A	2	2	4	0	0	4	0	0
16	44588182	.	A	T	1	1	2	0	1	3	0	0
16	44665348	.	C	T	0	3	3	0	3	6	0	0
16	44665358	.	A	G	2	6	8	0	2	10	0	0
16	44668083	.	G	A	0	4	4	0	0	4	0	0
16	44669333	.	A	G	0	2	2	0	0	2	0	0
16	44672368	.	C	T	0	1	1	0	1	2	0	0
16	44672389	.	A	C	0	1	1	0	0	1	0	0
16	44673734	.	C	A	5	2	7	0	0	7	0	0
16	44673769	.	A	G	2	2	4	0	0	4	0	0
16	44673778	.	G	A	1	1	2	0	0	2	0	0
16	44687738	.	T	C	1	7	8	0	0	8	0	0
16	44881979	.	C	T	6	3	9	0	0	9	0	0
16	44884701	.	A	G	0	2	2	0	0	2	0	0
16	44888458	.	T	G	5	5	10	0	0	10	0	0
16	44888473	.	G	A	3	4	7	0	0	7	0	0
16	44893131	.	C	T	3	0	3	0	3	6	0	0
16	44893137	.	C	G	4	2	6	0	1	7	0	0
16	44900199	.	T	A	4	2	6	0	0	6	0	0
16	44983679	.	A	T	2	6	8	0	0	8	0	0
16	44983982	.	A	C	2	6	8	0	0	8	0	0
16	44984170	.	C	T	7	2	9	0	1	10	0	0
16	45001768	.	A	T	1	1	2	0	0	2	0	0
16	45019606	.	A	T	6	18	24	0	0	24	0	0
16	45019768	.	C	G	20	13	33	0	3	36	0	0
16	45019868	.	A	G	3	4	7	0	1	8	0	0
16	45034336	.	G	A	2	4	6	0	0	6	0	0
16	45041736	.	A	G	3	1	4	0	0	4	0	0
16	45044709	.	T	G	31	24	55	0	3	58	0	0
16	45044710	.	A	T	32	23	55	0	3	58	0	0
16	45044858	.	T	C	32	4	36	0	39	75	0	0
16	45044910	.	T	C	46	41	87	0	5	92	0	0
16	45044952	.	T	A	45	40	85	0	5	90	0	0
16	45054004	.	A	G	12	9	21	0	0	21	0	0
16	45088196	.	A	C	4	2	6	0	0	6	0	0
16	45094348	.	C	T	0	3	3	0	6	9	0	0
16	45094355	.	A	G	6	3	9	0	0	9	0	0
16	45094399	.	A	G	6	3	9	0	0	9	0	0
16	45094423	.	A	G	9	2	11	0	1	12	0	0
16	45094523	.	A	G	2	4	6	0	0	6	0	0
16	45202703	.	G	A	25	7	32	0	2	34	0	0
16	45202795	.	A	G	13	12	25	0	0	25	0	0
16	45202798	.	A	G	12	13	25	0	2	27	0	0
16	45202926	.	A	G	13	14	27	0	0	27	0	0
16	45202962	.	T	A	11	7	18	0	1	19	0	0
16	45203076	.	C	A	9	13	22	0	1	23	0	0
16	45209294	.	A	G	1	0	1	0	0	1	0	0
16	45209300	.	A	G	1	0	1	0	0	1	0	0
16	45225374	.	G	A	0	2	2	0	0	2	0	0
16	45225381	.	C	A	0	3	3	0	0	3	0	0
16	45364428	.	C	T	0	1	1	0	2	3	0	0
16	45364438	.	T	A	2	2	4	0	0	4	0	0
16	45364556	.	G	A	1	2	3	0	1	4	0	0
16	45364570	.	C	T	0	1	1	0	3	4	0	0
16	45573228	.	A	G	1	2	3	0	0	3	0	0
16	45627258	.	C	T	2	4	6	0	0	6	0	0
16	45627363	.	A	G	1	0	1	0	0	1	0	0
16	45627378	.	G	A	1	0	1	0	0	1	0	0
16	45630207	.	G	C	0	0	0	0	1	1	0	0
16	45686536	.	C	T	4	2	6	0	0	6	0	0
16	45686998	.	T	A	3	4	7	0	1	8	0	0
16	45687065	.	G	A	4	3	7	0	0	7	0	0
16	45687076	.	A	G	4	0	4	0	3	7	0	0
16	45687299	.	C	T	5	3	8	0	0	8	0	0
16	45687896	.	T	G	5	5	10	0	0	10	0	0
16	45688005	.	T	C	3	4	7	0	0	7	0	0
16	45688171	.	C	T	4	6	10	0	0	10	0	0
16	45688228	.	G	A	0	6	6	0	4	10	0	0
16	45688323	.	G	T	2	3	5	0	0	5	0	0
16	45688431	.	T	A	6	11	17	0	1	18	0	0
16	45688662	.	T	C	14	5	19	0	2	21	0	0
16	45688814	.	C	T	9	14	23	0	3	26	0	0
16	45689411	.	T	A	11	8	19	0	1	20	0	0
16	45689435	.	A	G	13	13	26	0	1	27	0	0
16	45689476	.	T	A	15	16	31	0	3	34	0	0
16	45689484	.	G	T	16	21	37	0	0	37	0	0
16	45689835	.	T	C	18	10	28	0	0	28	0	0
16	45689898	.	A	T	19	15	34	0	0	34	0	0
16	45690148	.	A	T	18	5	23	0	0	23	0	0
16	45690296	.	T	C	16	17	33	0	3	36	0	0
16	45690926	.	G	A	18	6	24	0	3	28	1	0
16	45693611	.	G	A	3	6	9	0	1	10	0	0
16	45697007	.	T	C	2	2	4	0	0	4	0	0
16	45708377	.	T	A	2	3	5	0	0	5	0	0
16	45709001	.	G	T	1	3	4	0	2	6	0	0
16	45710316	.	T	A	2	1	3	0	0	3	0	0
16	45710337	.	T	C	5	2	7	0	0	7	0	0
16	45710536	.	C	T	6	2	8	0	0	8	0	0
16	45710691	.	A	G	9	7	16	0	2	18	0	0
16	45711077	.	C	T	0	8	8	0	6	14	0	0
16	45711117	.	A	G	3	9	12	0	0	12	0	0
16	45712455	.	A	G	1	3	4	0	0	4	0	0
16	45713631	.	A	G	9	15	24	0	0	24	0	0
16	45713661	.	A	G	10	0	10	0	17	27	0	0
16	45725844	.	A	G	4	3	7	0	1	8	0	0
16	45726665	.	T	A	12	10	22	0	2	24	0	0
16	45726677	.	A	G	9	6	15	0	1	16	0	0
16	45733990	.	G	A	0	1	1	0	2	3	0	0
16	45763476	.	G	A	0	4	4	0	4	8	0	0
16	45765813	.	C	T	0	1	1	0	0	1	0	0
16	45782233	.	C	G	8	4	12	0	4	16	0	0
16	45782244	.	C	G	6	5	11	0	4	15	0	0
16	45929436	.	A	G	9	3	12	0	22	34	0	0
16	45982401	.	T	C	1	2	3	0	0	3	0	0
16	45982438	.	G	T	1	1	2	0	1	3	0	0
16	46086280	.	A	G	3	9	12	0	1	13	0	0
16	46086333	.	G	A	7	9	16	0	2	18	0	0
16	46086357	.	A	G	10	5	15	0	0	15	0	0
16	46086373	.	T	A	10	7	17	0	1	18	0	0
16	46086484	.	A	T	10	3	13	0	0	13	0	0
16	46086538	.	G	A	1	3	4	0	7	11	0	0
16	46086691	.	T	A	3	2	5	0	0	5	0	0
16	46086719	.	G	T	3	2	5	0	0	5	0	0
16	46086885	.	T	C	3	2	5	0	0	5	0	0
16	46087257	.	G	A	7	5	12	0	0	12	0	0
16	46087290	.	T	A	6	7	13	0	0	13	0	0
16	46087583	.	C	A	3	2	5	0	0	5	0	0
16	46087945	.	T	A	12	8	20	0	1	21	0	0
16	46087951	.	T	A	11	10	21	0	1	22	0	0
16	46088298	.	G	A	4	5	9	0	1	10	0	0
16	46088372	.	T	C	2	3	5	0	0	5	0	0
16	46088652	.	C	T	8	12	20	0	1	21	0	0
16	46088711	.	T	G	6	10	16	0	2	18	0	0
16	46088837	.	C	T	10	14	24	0	1	25	0	0
16	46089278	.	A	T	13	4	17	0	0	17	0	0
16	46089485	.	A	G	6	4	10	0	2	12	0	0
16	46089490	.	T	A	8	5	13	0	0	13	0	0
16	46089749	.	A	C	8	5	13	0	1	14	0	0
16	46089809	.	C	T	1	10	11	0	5	16	0	0
16	46089867	.	G	A	8	10	18	0	3	21	0	0
16	46089979	.	T	A	13	8	21	0	2	23	0	0
16	46090056	.	C	G	7	4	11	0	2	13	0	0
16	46090070	.	T	C	8	4	12	0	1	13	0	0
16	46090157	.	G	A	8	3	11	0	0	11	0	0
16	46090296	.	G	A	7	3	10	1	0	11	0	0
16	46090447	.	A	G	3	10	13	0	0	13	0	0
16	46090629	.	G	T	2	2	4	0	0	4	0	0
16	46090640	.	A	G	4	2	6	0	1	7	0	0
16	46090713	.	T	C	4	0	4	0	8	12	0	0
16	46090731	.	T	G	5	5	10	0	2	12	0	0
16	46090749	.	G	C	5	3	8	0	1	9	0	0
16	46091068	.	T	C	2	3	5	0	0	5	0	0
16	46091116	.	A	G	1	3	4	0	0	4	0	0
16	46093332	.	A	T	4	2	6	0	0	6	0	0
16	46093580	.	G	T	4	3	7	0	0	7	0	0
16	46097033	.	A	C	0	0	0	0	1	1	0	0
16	46097111	.	G	A	3	2	5	0	1	6	0	0
16	46097239	.	G	A	5	2	7	0	1	8	0	0
16	46097268	.	A	G	4	2	6	0	0	6	0	0
16	46179734	.	T	C	1	2	3	0	1	4	0	0
16	46196245	.	C	T	5	6	11	0	0	11	0	0
16	46196287	.	T	C	5	6	11	0	2	13	0	0
16	46196347	.	T	A	4	9	13	0	0	13	0	0
16	46196536	.	T	C	3	5	8	0	0	8	0	0
16	46197193	.	A	G	24	8	32	0	5	37	0	0
16	46197195	.	A	G	29	6	35	0	1	37	1	0
16	46197266	.	G	A	0	19	19	0	19	38	0	0
16	46197308	.	A	G	15	1	16	0	29	45	0	0
16	46197313	.	T	G	14	24	38	0	5	44	1	0
16	46197343	.	C	T	20	28	48	0	1	49	0	0
16	46197358	.	A	G	8	1	9	0	35	44	0	0
16	46197442	.	G	A	20	13	33	0	4	37	0	0
16	46197490	.	G	A	23	9	32	0	7	39	0	0
16	46197955	.	T	G	13	13	26	2	3	31	0	0
16	46197988	.	A	T	6	17	23	2	2	27	0	0
16	46197999	.	A	C	9	15	24	2	3	29	0	0
16	46198166	.	T	A	10	15	25	0	1	26	0	0
16	46198167	.	T	G	10	16	26	0	0	26	0	0
16	46198208	.	C	T	8	17	25	0	2	27	0	0
16	46198222	.	T	A	10	15	25	0	1	26	0	0
16	46198451	.	A	C	10	16	26	0	2	28	0	0
16	46198486	.	A	C	12	11	23	0	0	23	0	0
16	46198658	.	T	A	1	6	7	0	1	8	0	0
16	46199364	.	C	T	19	19	38	0	0	38	0	0
16	46199471	.	C	A	26	29	55	0	0	55	0	0
16	46199492	.	C	A	24	25	49	0	2	51	0	0
16	46200063	.	T	C	27	17	44	0	6	50	0	0
16	46200165	.	C	A	21	14	35	0	4	39	0	0
16	46200409	.	T	C	17	35	52	0	4	56	0	0
16	46200510	.	G	T	26	21	47	0	4	51	0	0
16	46200560	.	G	C	34	20	54	0	3	57	0	0
16	46200578	.	G	A	32	25	57	0	3	60	0	0
16	46200655	.	G	A	3	25	28	0	29	57	0	0
16	46200678	.	A	T	29	29	58	0	1	59	0	0
16	46200787	.	T	C	17	27	44	0	4	48	0	0
16	46200907	.	T	C	14	32	46	0	1	47	0	0
16	46200958	.	C	A	12	34	46	0	1	47	0	0
16	46201121	.	T	G	34	20	54	0	4	58	0	0
16	46201214	.	C	T	38	17	55	1	1	57	0	0
16	46201254	.	A	T	20	36	56	0	1	57	0	0
16	46201525	.	T	C	23	24	47	0	6	53	0	0
16	46201559	.	A	T	37	22	59	0	2	61	0	0
16	46201583	.	A	G	34	18	52	0	5	57	0	0
16	46201599	.	T	C	30	22	52	0	4	56	0	0
16	46201943	.	T	A	31	21	52	0	4	56	0	0
16	46202287	.	G	A	30	34	64	0	7	71	0	0
16	46202423	.	C	A	19	20	39	0	2	41	0	0
16	46209196	.	A	C	5	5	10	0	1	11	0	0
16	46209231	.	T	C	7	4	11	0	0	11	0	0
16	46398536	.	A	C	5	0	5	0	0	5	0	0
16	46398567	.	C	G	4	5	9	0	1	10	0	0
16	46398595	.	T	A	11	3	14	0	0	14	0	0
16	46398609	.	G	T	11	2	13	0	3	16	0	0
16	46399542	.	G	T	2	3	5	0	1	6	0	0
16	46399680	.	C	G	0	4	4	0	0	4	0	0
16	46399709	.	C	A	1	3	4	0	0	4	0	0
16	46399788	.	G	A	3	9	12	0	1	13	0	0
16	46399834	.	A	G	0	4	4	0	1	5	0	0
16	46400404	.	A	G	1	2	3	0	0	3	0	0
16	46401030	.	A	T	2	5	7	0	0	7	0	0
16	46401284	.	G	A	1	4	5	0	0	5	0	0
16	46401308	.	T	G	3	5	8	0	0	8	0	0
16	46401350	.	T	G	5	3	8	0	0	8	0	0
16	46401576	.	A	G	3	4	7	0	0	7	0	0
16	46401584	.	T	A	2	4	6	0	0	6	0	0
16	46401617	.	A	T	3	4	7	0	0	7	0	0
16	46401805	.	G	A	1	7	8	0	1	9	0	0
16	46401945	.	A	T	3	4	7	0	0	7	0	0
16	46402049	.	C	A	2	4	6	0	0	6	0	0
16	46402167	.	G	C	3	1	4	0	0	4	0	0
16	46415769	.	T	G	13	5	18	0	0	18	0	0
16	46415836	.	T	C	2	2	4	0	0	4	0	0
16	46423028	.	G	C	0	3	3	0	1	4	0	0
16	46423378	.	G	A	2	8	10	0	3	13	0	0
16	46423477	.	G	A	5	2	7	0	0	7	0	0
16	46423636	.	G	A	12	4	16	0	0	16	0	0
16	46423663	.	A	G	11	5	16	0	1	17	0	0
16	46423675	.	T	C	10	4	14	0	0	14	0	0
16	46423705	.	G	A	10	7	17	0	3	20	0	0
16	46423793	.	C	T	9	2	11	0	2	13	0	0
16	46423805	.	T	C	12	4	16	0	0	16	0	0
16	46434021	.	A	T	12	7	19	0	1	20	0	0
16	46434982	.	C	G	3	2	5	5	0	10	0	0
16	46464090	.	A	C	0	5	5	0	1	6	0	0
16	46464132	.	T	A	2	5	7	0	0	7	0	0
16	46464148	.	T	G	2	5	7	0	0	7	0	0
16	46464345	.	C	A	1	7	8	0	0	8	0	0
16	46493014	.	G	C	1	0	1	0	0	1	0	0
16	46495109	.	G	A	0	3	3	0	4	7	0	0
16	46495334	.	T	C	5	4	9	0	2	11	0	0
16	46495697	.	C	T	8	4	12	0	1	13	0	0
16	46495798	.	T	A	10	3	13	0	0	13	0	0
16	46495811	.	G	A	10	3	13	0	2	15	0	0
16	46495934	.	C	T	9	7	16	0	3	19	0	0
16	46495967	.	T	A	11	7	18	0	0	18	0	0
16	46495973	.	G	A	10	6	16	0	0	16	0	0
16	46518484	.	G	T	10	9	19	0	1	20	0	0
16	46519918	.	G	T	5	7	12	0	0	12	0	0
16	46597670	.	C	T	0	3	3	0	1	4	0	0
16	46597917	.	G	T	1	2	3	0	0	3	0	0
16	46669372	.	C	T	3	8	11	0	0	11	0	0
16	46672203	.	C	T	15	14	29	0	2	31	0	0
16	46673322	.	A	G	4	2	6	0	0	6	0	0
16	46680792	.	G	A	12	4	16	0	0	16	0	0
16	46680793	.	A	T	12	4	16	0	0	16	0	0
16	46681041	.	G	A	9	8	17	0	1	18	0	0
16	46681057	.	G	A	7	6	13	0	1	14	0	0
16	46686003	.	C	T	2	1	3	0	0	3	0	0
16	46690948	.	G	A	0	6	6	0	5	11	0	0
16	46691033	.	G	C	5	5	10	0	3	13	0	0
16	46691090	.	C	T	3	7	10	0	0	10	0	0
16	46691095	.	A	T	3	7	10	0	0	10	0	0
16	47212235	.	T	C	3	4	7	0	0	7	0	0
16	47212262	.	T	C	1	3	4	0	0	4	0	0
16	47220058	.	A	G	4	4	8	0	0	8	0	0
16	47220091	.	C	T	4	4	8	0	0	8	0	0
16	47277494	.	A	C	2	0	2	0	0	2	0	0
16	47390924	.	G	A	20	23	43	0	4	47	0	0
16	47407678	.	G	A	5	3	8	0	1	9	0	0
16	47412094	.	T	C	7	7	14	0	1	15	0	0
16	47446694	.	A	G	1	2	3	0	1	4	0	0
16	47449824	.	C	T	1	4	5	0	0	5	0	0
16	47449968	.	C	T	1	1	2	0	1	3	0	0
16	47449978	.	T	C	1	2	3	0	0	3	0	0
16	48333845	.	G	A	9	5	14	0	1	15	0	0
16	48409352	.	T	A	10	3	13	0	0	13	0	0
16	48413512	.	T	C	2	1	3	0	0	3	0	0
16	48413518	.	A	G	0	1	1	0	0	1	0	0
16	48415976	.	A	G	10	14	24	0	3	27	0	0
16	48416125	.	A	G	2	1	3	0	0	3	0	0
16	48420833	.	T	C	6	7	13	0	0	13	0	0
16	48420875	.	T	G	2	1	3	0	0	3	0	0
16	48421111	.	C	A	11	9	20	0	1	21	0	0
16	48421120	.	G	A	11	10	21	0	2	23	0	0
16	48425249	.	T	C	1	1	2	0	0	2	0	0
16	48425361	.	C	T	2	2	4	0	0	4	0	0
16	48425409	.	A	G	10	6	16	0	1	17	0	0
16	48426900	.	T	C	7	0	7	0	3	10	0	0
16	48426912	.	T	C	7	2	9	0	1	10	0	0
16	48427232	.	G	C	0	1	1	0	0	1	0	0
16	48428029	.	T	G	2	1	3	0	1	4	0	0
16	48621332	.	A	G	1	3	4	0	0	4	0	0
16	48621341	.	C	T	0	3	3	0	0	3	0	0
16	48642999	.	C	T	3	3	6	0	0	6	0	0
16	48645844	.	A	C	3	2	5	0	0	5	0	0
16	48724702	.	A	G	3	0	3	0	3	6	0	0
16	48729892	.	T	C	1	2	3	0	0	3	0	0
16	48729898	.	T	C	1	2	3	0	0	3	0	0
16	48736081	.	A	T	0	5	5	0	0	5	0	0
16	48738688	.	C	G	1	2	3	0	1	4	0	0
16	48740686	.	C	T	2	3	5	0	0	5	0	0
16	48740787	.	A	G	4	5	9	0	0	9	0	0
16	48740799	.	C	T	4	5	9	0	0	9	0	0
16	48740833	.	C	T	6	2	8	0	1	9	0	0
16	48746356	.	T	C	3	3	6	0	1	7	0	0
16	48746364	.	A	G	3	4	7	0	0	7	0	0
16	48746661	.	A	G	6	5	11	0	0	11	0	0
16	48746695	.	T	G	6	4	10	0	0	10	0	0
16	48746731	.	G	A	4	4	8	0	0	8	0	0
16	48746744	.	T	C	4	4	8	0	2	10	0	0
16	48746783	.	A	T	1	5	6	0	2	8	0	0
16	48747619	.	C	T	1	5	6	0	1	7	0	0
16	48747626	.	G	C	1	4	5	0	0	5	0	0
16	49092586	.	T	C	1	1	2	0	1	3	0	0
16	49093519	.	T	C	3	2	5	0	0	5	0	0
16	49101761	.	A	C	3	4	7	0	0	7	0	0
16	49101764	.	T	C	3	3	6	0	0	6	0	0
16	49101833	.	G	A	0	3	3	0	1	4	0	0
16	49152252	.	A	G	2	0	2	0	0	2	0	0
16	49601851	.	C	A	5	4	9	0	0	9	0	0
16	49601927	.	T	A	1	4	5	0	0	5	0	0
16	49602080	.	T	C	1	2	3	0	0	3	0	0
16	49602096	.	A	T	2	2	4	0	0	4	0	0
16	49602143	.	C	G	2	0	2	0	6	8	0	0
16	49604533	.	T	C	2	0	2	0	0	2	0	0
16	49618212	.	T	C	4	1	5	0	0	5	0	0
16	50075551	.	C	T	15	25	40	1	0	41	0	0
16	50075605	.	T	A	18	19	37	0	2	39	0	0
16	50075929	.	A	C	9	9	18	0	2	20	0	0
16	50076029	.	C	T	14	17	31	0	3	34	0	0
16	50089599	.	T	A	4	2	6	0	0	6	0	0
16	50100455	.	C	T	2	3	5	0	0	5	0	0
16	50103878	.	G	A	1	6	7	0	4	11	0	0
16	50106063	.	C	T	2	1	3	0	1	4	0	0
16	50106645	.	A	G	8	7	15	0	1	16	0	0
16	50108878	.	C	G	6	4	10	0	0	10	0	0
16	50108888	.	C	T	3	3	6	0	1	7	0	0
16	50109017	.	C	T	0	7	7	0	3	10	0	0
16	50109386	.	T	A	5	8	13	0	1	14	0	0
16	50109434	.	G	A	7	9	16	0	6	22	0	0
16	50109595	.	T	C	10	8	18	0	2	20	0	0
16	50109795	.	T	C	13	19	32	1	1	34	0	0
16	50110125	.	G	A	0	10	10	0	12	22	0	0
16	50110277	.	C	T	21	20	41	0	3	44	0	0
16	50110671	.	A	G	25	13	38	0	3	41	0	0
16	50110899	.	T	C	14	12	26	0	1	27	0	0
16	50214904	.	G	T	5	6	11	0	0	11	0	0
16	50215016	.	T	C	9	21	30	0	1	31	0	0
16	50215017	.	G	C	9	22	31	0	0	31	0	0
16	50215058	.	C	T	13	19	32	0	1	33	0	0
16	50215068	.	T	C	10	19	29	0	2	31	0	0
16	50215112	.	C	T	11	14	25	0	6	31	0	0
16	50215171	.	G	A	15	18	33	0	2	35	0	0
16	50215222	.	A	C	22	15	37	0	2	39	0	0
16	50215734	.	T	C	9	18	27	0	1	28	0	0
16	50218386	.	T	C	1	0	1	0	3	4	0	0
16	50218401	.	A	G	3	8	11	0	1	12	0	0
16	50218470	.	T	A	2	14	16	0	3	19	0	0
16	50824069	.	C	A	9	6	15	0	0	15	0	0
16	50824090	.	C	T	7	4	11	0	1	12	0	0
16	51183892	.	A	T	6	4	10	0	2	12	0	0
16	51371348	.	G	A	1	2	3	0	0	3	0	0
16	51885808	.	G	A	19	28	47	0	6	53	0	0
16	51885855	.	A	T	11	8	19	0	1	20	0	0
16	51888929	.	C	T	18	14	32	0	2	34	0	0
16	51950697	.	T	A	10	12	22	0	4	26	0	0
16	51950726	.	C	A	20	17	37	0	3	40	0	0
16	51950754	.	C	T	19	22	41	0	2	43	0	0
16	51950814	.	A	T	33	0	33	0	1	34	0	0
16	51950877	.	G	C	20	23	43	0	4	47	0	0
16	51951017	.	T	C	11	33	44	0	1	45	0	0
16	51951021	.	T	C	24	16	40	0	1	41	0	0
16	51951109	.	C	G	10	7	17	0	3	20	0	0
16	51951119	.	T	C	7	14	21	0	2	23	0	0
16	51951144	.	A	C	4	20	24	0	1	25	0	0
16	51951690	.	T	C	6	12	18	0	0	18	0	0
16	51951691	.	T	C	12	6	18	0	0	18	0	0
16	51951861	.	G	C	14	10	24	0	3	27	0	0
16	51952002	.	T	G	9	16	25	0	4	29	0	0
16	51952023	.	A	T	11	15	26	0	3	29	0	0
16	51952063	.	A	C	7	11	18	0	1	19	0	0
16	51952817	.	C	T	5	1	6	0	0	6	0	0
16	51952826	.	C	A	2	6	8	0	0	8	0	0
16	51953009	.	G	A	16	17	33	0	3	36	0	0
16	51953048	.	T	C	17	24	41	0	4	45	0	0
16	51953057	.	T	A	18	24	42	0	2	44	0	0
16	51953189	.	G	T	6	4	10	0	0	10	0	0
16	51954683	.	C	T	0	11	11	0	11	22	0	0
16	51955675	.	G	A	12	3	15	0	1	16	0	0
16	51955696	.	G	A	8	1	9	0	0	9	0	0
16	51962068	.	A	G	3	5	8	0	0	8	0	0
16	51966774	.	C	G	2	0	2	0	0	2	0	0
16	53449751	.	C	T	1	3	4	0	0	4	0	0
16	53502390	.	C	T	3	2	5	0	1	6	0	0
16	53513549	.	C	T	4	6	10	0	0	10	0	0
16	53516147	.	T	G	14	11	25	0	2	27	0	0
16	53516232	.	G	A	13	15	28	0	1	29	0	0
16	53516303	.	T	C	10	9	19	0	2	21	0	0
16	53530047	.	G	C	0	5	5	0	2	7	0	0
16	53530490	.	A	T	4	5	9	0	1	10	0	0
16	53539399	.	T	C	1	4	5	0	0	5	0	0
16	53541879	.	A	G	13	6	19	0	0	19	0	0
16	53541963	.	T	A	9	8	17	0	0	17	0	0
16	53590609	.	C	T	2	2	4	0	0	4	0	0
16	53591908	.	C	G	2	3	5	0	0	5	0	0
16	53596872	.	C	T	1	5	6	0	0	6	0	0
16	53626832	.	T	C	1	1	2	0	0	2	0	0
16	53626853	.	T	C	1	1	2	0	0	2	0	0
16	53701171	.	A	C	7	9	16	0	3	19	0	0
16	53708312	.	C	G	31	31	62	0	5	68	1	0
16	53708537	.	G	T	5	3	8	0	1	9	0	0
16	53733920	.	C	A	0	2	2	0	2	4	0	0
16	53734226	.	C	T	0	3	3	0	2	5	0	0
16	53734522	.	A	C	1	3	4	0	1	5	0	0
16	54222382	.	C	T	3	7	10	0	0	10	0	0
16	54222433	.	T	C	3	2	5	0	1	6	0	0
16	54222448	.	G	A	3	2	5	0	0	5	0	0
16	54231432	.	G	T	0	1	1	0	1	2	0	0
16	54245580	.	T	A	4	4	8	0	0	8	0	0
16	54245777	.	G	A	2	3	5	0	0	5	0	0
16	54245781	.	T	A	2	2	4	0	1	5	0	0
16	54245812	.	T	C	3	2	5	0	0	5	0	0
16	54303742	.	G	C	3	3	6	0	1	7	0	0
16	54313643	.	T	A	3	2	5	0	0	5	0	0
16	54314226	.	G	A	0	1	1	0	0	1	0	0
16	54314463	.	C	G	1	2	3	0	0	3	0	0
16	54320243	.	A	G	1	3	4	0	0	4	0	0
16	54483392	.	C	T	0	3	3	0	0	3	0	0
16	54829650	.	C	T	21	25	46	0	1	48	1	0
16	54829656	.	A	G	19	27	46	0	3	49	0	0
16	54837250	.	T	C	8	8	16	0	0	16	0	0
16	54843723	.	C	T	23	40	63	0	5	68	0	0
16	54843798	.	A	G	15	1	16	0	23	39	0	0
16	54846250	.	G	A	0	4	4	0	8	12	0	0
16	54930903	.	A	G	2	2	4	0	0	4	0	0
16	54930916	.	T	A	2	1	3	0	0	3	0	0
16	54932914	.	C	A	3	4	7	0	0	7	0	0
16	54932963	.	T	C	4	2	6	0	0	6	0	0
16	54947978	.	G	A	7	4	11	0	1	12	0	0
16	54948227	.	A	G	6	5	11	0	0	11	0	0
16	54948369	.	T	A	8	7	15	0	1	16	0	0
16	54948467	.	C	A	7	3	10	0	0	10	0	0
16	54948483	.	T	A	5	4	9	0	1	10	0	0
16	54948511	.	C	A	0	5	5	0	3	8	0	0
16	54948538	.	A	T	3	2	5	0	0	5	0	0
16	54949140	.	G	A	10	12	22	0	3	25	0	0
16	54952935	.	G	A	3	6	9	0	0	9	0	0
16	54953031	.	C	T	0	11	11	0	9	20	0	0
16	54953067	.	G	A	5	3	8	0	0	8	0	0
16	54956620	.	C	T	2	2	4	0	0	4	0	0
16	54956777	.	T	C	2	3	5	0	0	5	0	0
16	54964146	.	A	G	0	3	3	0	0	3	0	0
16	55004634	.	C	A	2	3	5	0	1	6	0	0
16	55004655	.	A	T	7	7	14	0	1	15	0	0
16	55004716	.	T	C	11	1	12	0	12	24	0	0
16	55007670	.	G	A	11	12	23	0	0	23	0	0
16	55083392	.	G	T	2	2	4	0	1	5	0	0
16	55095692	.	T	A	0	1	1	0	0	1	0	0
16	55102387	.	C	T	1	2	3	0	0	3	0	0
16	55102467	.	G	A	3	3	6	0	2	8	0	0
16	55102608	.	T	C	3	1	4	0	1	5	0	0
16	55106058	.	T	A	2	2	4	0	0	4	0	0
16	55106111	.	A	C	2	4	6	0	0	6	0	0
16	55106207	.	T	C	6	7	13	0	0	13	0	0
16	55106223	.	A	G	9	9	18	0	0	18	0	0
16	55106279	.	C	A	27	12	39	0	1	40	0	0
16	55106367	.	A	C	14	16	30	0	1	31	0	0
16	55106405	.	G	A	8	3	11	0	0	11	0	0
16	55106443	.	C	T	4	10	14	0	1	15	0	0
16	55106474	.	C	T	1	8	9	0	5	14	0	0
16	55108828	.	C	T	4	5	9	0	0	9	0	0
16	55122779	.	T	C	8	10	18	0	2	20	0	0
16	55181565	.	G	A	0	2	2	0	2	4	0	0
16	55182249	.	A	T	7	3	10	0	0	10	0	0
17	70665	.	A	G	2	4	6	0	0	6	0	0
17	70668	.	A	G	0	0	0	0	6	6	0	0
17	1142184	.	T	C	0	1	1	0	0	1	0	0
17	2149168	.	C	T	0	2	2	0	0	2	0	0
17	2149174	.	A	G	0	2	2	0	0	2	0	0
17	3282307	.	C	T	1	2	3	1	0	4	0	0
17	3283250	.	A	T	3	2	5	0	0	5	0	0
17	3284985	.	G	T	1	4	5	0	0	5	0	0
17	3284989	.	G	A	1	3	4	0	0	4	0	0
17	3288101	.	A	G	1	2	3	0	0	3	0	0
17	3290771	.	A	T	1	1	2	0	0	2	0	0
17	3566811	.	A	G	3	5	8	0	0	8	0	0
17	3566844	.	T	A	3	4	7	0	1	8	0	0
17	3569047	.	T	C	8	6	14	0	1	15	0	0
17	3569050	.	A	C	8	8	16	0	0	16	0	0
17	3569169	.	A	G	9	8	17	0	1	18	0	0
17	3569264	.	A	C	9	7	16	0	2	18	0	0
17	3569298	.	A	G	2	5	7	0	1	8	0	0
17	3841153	.	A	G	2	6	8	0	1	9	0	0
17	3854266	.	T	C	2	5	7	0	0	7	0	0
17	3854287	.	C	T	0	5	5	0	3	8	0	0
17	3855403	.	G	A	1	3	4	0	0	4	0	0
17	3860797	.	T	C	0	0	0	0	2	2	0	0
17	3868765	.	T	C	1	0	1	0	0	1	0	0
17	4054565	.	C	T	0	1	1	0	0	1	0	0
17	4227439	.	G	A	1	2	3	0	0	3	0	0
17	4239567	.	T	A	5	3	8	0	0	8	0	0
17	4240014	.	T	A	12	4	16	0	2	18	0	0
17	4240188	.	G	T	14	6	20	0	1	21	0	0
17	4297232	.	G	A	12	2	14	0	1	15	0	0
17	4297546	.	C	T	16	15	31	0	2	33	0	0
17	4297551	.	A	C	18	12	30	0	1	31	0	0
17	4297600	.	T	C	17	7	24	0	0	24	0	0
17	4297608	.	G	C	12	0	12	0	10	22	0	0
17	4297697	.	A	T	3	9	12	0	0	12	0	0
17	4297957	.	G	C	10	0	10	0	13	24	1	0
17	4298174	.	C	T	8	8	16	0	2	18	0	0
17	4298190	.	T	A	10	13	23	0	0	23	0	0
17	4298221	.	T	A	7	11	18	0	3	21	0	0
17	4298307	.	A	T	7	4	11	0	2	13	0	0
17	4298326	.	T	G	3	9	12	0	1	13	0	0
17	4298349	.	T	A	4	11	15	0	2	17	0	0
17	4298768	.	T	G	1	4	5	0	1	6	0	0
17	4298945	.	G	A	3	2	5	0	0	5	0	0
17	4298990	.	A	G	4	12	16	0	0	16	0	0
17	4298996	.	C	T	6	12	18	0	0	18	0	0
17	4299030	.	C	G	5	13	18	0	0	18	0	0
17	4299031	.	C	T	5	12	17	0	1	18	0	0
17	4378210	.	G	A	1	0	1	0	0	1	0	0
17	4378219	.	C	T	1	0	1	0	0	1	0	0
17	5061184	.	G	C	1	3	4	0	0	4	0	0
17	5217087	.	A	T	2	1	3	0	0	3	0	0
17	5629782	.	G	A	0	2	2	0	1	3	0	0
17	5819661	.	C	A	1	2	3	0	0	3	0	0
17	5819672	.	A	T	1	3	4	0	0	4	0	0
17	5820083	.	C	T	3	5	8	0	0	8	0	0
17	5820209	.	T	C	2	2	4	0	1	5	0	0
17	5820572	.	A	G	3	3	6	0	0	6	0	0
17	5821130	.	C	T	2	2	4	0	0	4	0	0
17	5821134	.	A	G	2	2	4	0	0	4	0	0
17	5821476	.	G	A	5	8	13	0	0	13	0	0
17	5821578	.	C	T	2	2	4	0	0	4	0	0
17	5896025	.	G	A	9	8	17	0	3	20	0	0
17	5916392	.	A	G	6	6	12	0	0	12	0	0
17	5926722	.	T	C	16	18	34	0	1	35	0	0
17	5927085	.	C	A	25	8	33	0	1	34	0	0
17	5927101	.	T	C	17	7	24	0	0	24	0	0
17	5927172	.	G	A	3	4	7	0	0	7	0	0
17	6101114	.	G	A	1	2	3	0	0	3	0	0
17	6101343	.	C	T	2	2	4	0	0	4	0	0
17	6279806	.	C	A	1	4	5	0	0	5	0	0
17	6279876	.	G	T	0	18	18	0	16	34	0	0
17	6395381	.	G	C	2	1	3	0	0	3	0	0
17	6438226	.	C	T	6	3	9	0	1	10	0	0
17	6438630	.	T	A	3	6	9	0	0	9	0	0
17	6444514	.	T	A	2	5	7	0	1	8	0	0
17	6447234	.	A	G	3	2	5	0	0	5	0	0
17	6447418	.	G	T	4	3	7	0	0	7	0	0
17	6447477	.	A	G	2	1	3	0	0	3	0	0
17	6460449	.	A	C	1	0	1	0	0	1	0	0
17	6462228	.	G	A	7	5	12	0	0	12	0	0
17	6544078	.	C	T	1	2	3	0	0	3	0	0
17	6715755	.	T	A	27	18	45	0	1	46	0	0
17	6716412	.	G	T	29	22	51	0	4	56	1	0
17	6716472	.	G	A	33	20	53	0	6	59	0	0
17	6730114	.	G	A	15	13	28	0	0	28	0	0
17	6737970	.	C	A	0	3	3	0	6	9	0	0
17	6758867	.	T	G	1	3	4	0	0	4	0	0
17	7781821	.	T	C	0	2	2	0	1	3	0	0
17	7802799	.	A	G	2	0	2	0	0	2	0	0
17	7844994	.	G	A	4	9	13	0	0	13	0	0
17	7845364	.	G	C	14	14	28	0	1	29	0	0
17	7845412	.	T	C	18	13	31	0	1	32	0	0
17	7845566	.	C	T	10	23	33	0	1	34	0	0
17	7861124	.	C	T	17	24	41	0	4	45	0	0
17	7868632	.	G	A	1	0	1	0	0	1	0	0
17	7879348	.	T	C	8	5	13	0	0	13	0	0
17	7882941	.	G	A	4	6	10	0	1	11	0	0
17	7882998	.	G	A	10	12	22	0	1	23	0	0
17	7885662	.	A	G	7	10	17	0	1	18	0	0
17	7894976	.	T	A	11	7	18	0	0	18	0	0
17	7895023	.	G	A	3	5	8	0	1	9	0	0
17	7896356	.	C	T	0	8	8	0	9	17	0	0
17	7896390	.	C	T	0	14	14	0	14	28	0	0
17	7896478	.	C	T	0	1	1	0	0	1	0	0
17	7901137	.	C	T	7	3	10	0	2	12	0	0
17	7906568	.	G	T	3	6	9	0	0	9	0	0
17	7906610	.	C	T	2	3	5	0	1	6	0	0
17	7906612	.	G	A	4	2	6	0	0	6	0	0
17	7906646	.	T	A	1	1	2	0	1	3	0	0
17	7917997	.	G	A	3	2	5	0	0	5	0	0
17	7926040	.	G	A	2	3	5	0	0	5	0	0
17	7926076	.	C	T	4	4	8	0	2	10	0	0
17	7931737	.	G	A	0	3	3	0	0	3	0	0
17	7942122	.	G	A	3	2	5	0	0	5	0	0
17	7942127	.	T	C	2	1	3	0	2	5	0	0
17	7942366	.	T	G	1	4	5	0	2	7	0	0
17	7945421	.	C	G	3	4	7	0	0	7	0	0
17	7949042	.	G	A	1	1	2	0	0	2	0	0
17	7949066	.	G	A	2	4	6	0	1	7	0	0
17	7950372	.	C	T	2	1	3	0	0	3	0	0
17	7963282	.	G	A	3	3	6	0	0	6	0	0
17	7963294	.	G	A	4	3	7	0	0	7	0	0
17	7978112	.	T	G	0	2	2	0	0	2	0	0
17	7991338	.	G	A	0	2	2	0	0	2	0	0
17	8000049	.	T	C	0	0	0	0	1	1	0	0
17	8002895	.	G	T	1	1	2	0	0	2	0	0
17	8002928	.	C	G	1	2	3	0	0	3	0	0
17	8202712	.	G	A	0	2	2	0	1	3	0	0
17	8202778	.	T	C	5	4	9	0	0	9	0	0
17	8203468	.	G	A	7	3	10	0	0	10	0	0
17	8203498	.	G	A	3	5	8	0	3	11	0	0
17	8204086	.	G	C	3	3	6	0	0	6	0	0
17	8204087	.	C	T	3	3	6	0	0	6	0	0
17	8204248	.	A	G	5	0	5	0	9	14	0	0
17	8204533	.	C	T	11	7	18	0	2	20	0	0
17	8204755	.	A	G	11	14	25	0	1	26	0	0
17	8204818	.	A	G	10	14	24	0	2	26	0	0
17	8204935	.	T	C	13	11	24	0	3	27	0	0
17	8204962	.	C	T	12	12	24	0	1	25	0	0
17	8205340	.	A	T	15	8	23	0	2	25	0	0
17	8205697	.	A	G	13	10	23	1	2	26	0	0
17	8209315	.	T	C	1	1	2	0	0	2	0	0
17	8209327	.	C	T	4	3	7	0	0	7	0	0
17	8209837	.	T	A	12	12	24	0	0	24	0	0
17	8209931	.	C	A	12	8	20	0	0	20	0	0
17	8209944	.	A	G	10	14	24	0	0	24	0	0
17	8210203	.	G	A	8	10	18	0	0	18	0	0
17	8210242	.	C	T	8	14	22	0	0	22	0	0
17	8210411	.	A	G	6	11	17	0	1	18	0	0
17	8210466	.	A	G	9	0	9	0	11	20	0	0
17	8229964	.	C	T	1	4	5	0	1	6	0	0
17	8246121	.	C	T	1	1	2	0	0	2	0	0
17	8248987	.	A	G	0	4	4	0	0	4	0	0
17	8261565	.	G	A	1	2	3	0	0	3	0	0
17	8261762	.	C	T	2	1	3	0	1	4	0	0
17	8261769	.	G	A	2	1	3	0	0	3	0	0
17	8498844	.	A	T	0	2	2	0	0	2	0	0
17	8498845	.	A	T	0	2	2	0	0	2	0	0
17	8502883	.	G	A	1	3	4	0	0	4	0	0
17	8502934	.	A	G	1	2	3	0	0	3	0	0
17	8597174	.	T	A	15	10	25	0	0	25	0	0
17	8597702	.	A	T	16	17	33	0	1	35	1	0
17	8597871	.	T	C	17	6	23	0	2	25	0	0
17	8597965	.	T	A	27	15	42	0	3	45	0	0
17	8611580	.	G	A	6	4	10	0	1	11	0	0
17	8623396	.	G	A	9	5	14	0	1	15	0	0
17	8623456	.	T	C	12	13	25	0	0	25	0	0
17	8766176	.	G	A	1	0	1	0	0	1	0	0
17	8780716	.	G	A	2	3	5	0	0	5	0	0
17	8784682	.	T	C	0	1	1	0	0	1	0	0
17	8784742	.	G	A	0	5	5	0	2	7	0	0
17	8791468	.	A	G	5	8	13	0	0	13	0	0
17	8791841	.	T	G	2	7	9	0	0	9	0	0
17	8791863	.	C	T	5	2	7	0	0	7	0	0
17	8927638	.	A	G	2	2	4	0	1	5	0	0
17	8927641	.	A	G	3	1	4	0	1	5	0	0
17	8934223	.	G	A	13	10	23	0	0	23	0	0
17	8934307	.	C	T	11	6	17	0	0	17	0	0
17	8937918	.	G	A	6	5	11	0	1	12	0	0
17	8937954	.	G	A	14	7	21	0	4	25	0	0
17	8938023	.	C	T	4	1	5	0	1	6	0	0
17	8938249	.	T	C	5	7	12	0	0	12	0	0
17	8938269	.	G	A	15	8	23	0	2	25	0	0
17	8938305	.	T	A	15	25	40	0	0	40	0	0
17	8941309	.	T	C	6	7	13	0	0	13	0	0
17	8941320	.	C	T	4	7	11	0	1	12	0	0
17	8951606	.	C	G	1	11	12	0	13	25	0	0
17	8951644	.	C	T	0	12	12	0	7	19	0	0
17	8951655	.	T	C	9	9	18	0	0	18	0	0
17	8951867	.	C	T	0	4	4	0	3	7	0	0
17	8964520	.	G	A	7	7	14	0	0	14	0	0
17	8969278	.	A	G	1	2	3	0	0	3	0	0
17	8969296	.	G	A	6	5	11	0	0	11	0	0
17	9042447	.	C	T	2	2	4	0	1	5	0	0
17	9042652	.	T	C	1	3	4	0	0	4	0	0
17	9225184	.	G	A	0	2	2	0	3	5	0	0
17	9225223	.	A	G	1	2	3	0	0	3	0	0
17	9254269	.	T	A	2	2	4	0	0	4	0	0
17	9255547	.	G	C	7	5	12	0	0	12	0	0
17	9255703	.	C	T	8	10	18	0	0	18	0	0
17	9266298	.	C	T	21	12	33	0	1	34	0	0
17	9266501	.	G	T	0	13	13	0	19	32	0	0
17	9888958	.	C	G	1	2	3	0	0	3	0	0
17	9889223	.	C	T	4	3	7	0	2	9	0	0
17	9889427	.	G	A	2	6	8	0	0	8	0	0
17	9889728	.	A	T	4	7	11	0	2	13	0	0
17	9889745	.	A	G	5	0	5	0	8	13	0	0
17	9944725	.	A	G	12	4	16	0	0	16	0	0
17	9944848	.	T	A	8	4	12	0	0	12	0	0
17	9944996	.	G	T	1	3	4	0	0	4	0	0
17	9944999	.	G	A	0	2	2	0	1	3	0	0
17	9945176	.	T	A	3	6	9	0	1	10	0	0
17	9945178	.	T	G	4	5	9	0	1	10	0	0
17	9951885	.	G	A	2	7	9	0	0	9	0	0
17	9952033	.	C	T	1	7	8	0	7	15	0	0
17	9957913	.	T	A	1	2	3	0	0	3	0	0
17	9962399	.	C	A	1	0	1	0	0	1	0	0
17	9963519	.	G	A	2	10	12	0	2	14	0	0
17	9964019	.	G	A	7	4	11	0	2	13	0	0
17	9964072	.	A	G	4	0	4	0	0	4	0	0
17	9964437	.	A	T	2	3	5	0	1	6	0	0
17	9964912	.	G	A	3	6	9	0	1	10	0	0
17	9964944	.	C	A	1	4	5	0	0	5	0	0
17	9965344	.	T	A	0	2	2	0	0	2	0	0
17	10007385	.	C	T	1	4	5	0	0	5	0	0
17	10765766	.	A	G	1	3	4	0	0	4	0	0
17	10765773	.	A	G	2	3	5	0	1	6	0	0
17	11378906	.	T	A	3	2	5	0	0	5	0	0
17	11716754	.	A	G	3	3	6	0	0	6	0	0
17	15041258	.	T	C	3	2	5	0	1	6	0	0
17	15115945	.	A	T	0	1	1	0	0	1	0	0
17	15633377	.	T	C	4	23	27	0	0	27	0	0
17	15633379	.	T	C	5	22	27	0	0	27	0	0
17	15633605	.	T	C	5	4	9	0	2	11	0	0
17	15633721	.	T	C	7	8	15	0	1	16	0	0
17	15636967	.	T	C	5	2	7	0	0	7	0	0
17	16026486	.	C	T	1	3	4	0	0	4	0	0
17	16804700	.	A	G	2	7	9	0	1	10	0	0
17	17492857	.	A	T	0	3	3	0	1	4	0	0
17	18176723	.	C	T	2	2	4	0	2	6	0	0
17	19420197	.	C	T	12	22	34	0	2	36	0	0
17	19420434	.	C	T	0	6	6	0	14	20	0	0
17	19420563	.	T	G	15	6	21	0	0	21	0	0
17	19421109	.	C	G	10	9	19	0	1	20	0	0
17	19421248	.	T	G	8	11	19	0	0	19	0	0
17	19421667	.	A	G	8	7	15	0	2	17	0	0
17	19421948	.	C	T	7	8	15	0	0	15	0	0
17	19421955	.	A	T	7	9	16	0	2	18	0	0
17	19423145	.	C	T	2	3	5	0	0	5	0	0
17	19423713	.	G	A	3	3	6	0	0	6	0	0
17	19431718	.	G	A	2	3	5	0	0	5	0	0
17	19440492	.	G	A	1	3	4	0	0	4	0	0
17	19440500	.	T	G	2	3	5	0	0	5	0	0
17	19607654	.	A	T	1	12	13	0	2	15	0	0
17	19607835	.	T	A	8	4	12	0	0	12	0	0
17	19609013	.	C	T	0	3	3	0	3	6	0	0
17	19692573	.	A	C	0	4	4	0	0	4	0	0
17	19715899	.	T	C	4	2	6	0	0	6	0	0
17	19754364	.	G	A	3	2	5	0	0	5	0	0
17	19754794	.	T	C	2	6	8	0	0	8	0	0
17	19757450	.	G	T	2	1	3	0	0	3	0	0
17	19757456	.	C	T	1	2	3	0	1	4	0	0
17	19831852	.	C	T	0	5	5	0	3	8	0	0
17	19831980	.	A	T	1	2	3	0	0	3	0	0
17	20147636	.	A	C	0	2	2	0	0	2	0	0
17	20147644	.	G	C	1	3	4	0	0	4	0	0
17	20147693	.	A	G	2	8	10	0	0	10	0	0
17	20147756	.	A	C	5	8	13	0	0	13	0	0
17	20147771	.	A	G	6	4	10	0	0	10	0	0
17	20148867	.	G	A	1	0	1	0	0	1	0	0
17	20161885	.	A	G	0	3	3	0	0	3	0	0
17	20185215	.	G	A	1	2	3	0	0	3	0	0
17	20188795	.	G	T	1	3	4	0	0	4	0	0
17	20188819	.	T	G	1	2	3	0	1	4	0	0
17	20188836	.	C	T	1	4	5	0	0	5	0	0
17	20189047	.	A	T	4	13	17	0	0	17	0	0
17	20191956	.	A	G	1	1	2	0	0	2	0	0
17	20202365	.	C	G	0	2	2	0	3	5	0	0
17	20202391	.	G	A	5	4	9	0	0	9	0	0
17	20214550	.	C	T	1	2	3	0	2	5	0	0
17	20214570	.	C	A	3	2	5	0	0	5	0	0
17	20214757	.	T	C	2	1	3	0	0	3	0	0
17	20214766	.	T	C	0	0	0	0	1	1	0	0
17	20215498	.	G	A	1	1	2	0	1	3	0	0
17	20215570	.	A	C	0	0	0	0	3	3	0	0
17	20232526	.	G	T	1	2	3	1	0	4	0	0
17	20243375	.	C	A	17	21	38	0	6	44	0	0
17	20243564	.	G	A	14	14	28	0	1	29	0	0
17	20243611	.	G	A	17	16	33	0	1	34	0	0
17	20248398	.	A	G	13	6	19	0	0	19	0	0
17	20248455	.	A	T	11	9	20	0	2	22	0	0
17	20248479	.	T	C	14	13	27	0	2	29	0	0
17	20248500	.	C	G	0	10	10	0	9	19	0	0
17	20251987	.	T	C	0	3	3	0	0	3	0	0
17	20256603	.	A	C	5	3	8	0	0	8	0	0
17	20256669	.	A	G	6	6	12	0	0	12	0	0
17	20256894	.	T	C	2	2	4	0	0	4	0	0
17	20256921	.	A	G	2	4	6	0	0	6	0	0
17	20256948	.	G	C	1	0	1	0	6	7	0	0
17	20259679	.	A	C	3	3	6	0	0	6	0	0
17	20264097	.	C	T	2	3	5	0	0	5	0	0
17	20264106	.	T	C	0	0	0	0	3	3	0	0
17	20268379	.	G	A	3	1	4	0	1	5	0	0
17	20268442	.	C	T	0	1	1	0	0	1	0	0
17	20324012	.	T	C	0	3	3	0	0	3	0	0
17	20324036	.	C	T	0	4	4	0	2	6	0	0
17	20324051	.	A	G	3	4	7	0	0	7	0	0
17	20324114	.	C	T	1	8	9	0	3	12	0	0
17	20324144	.	G	A	5	6	11	0	0	11	0	0
17	20518101	.	T	G	1	2	3	0	0	3	0	0
17	20518147	.	G	A	0	3	3	0	0	3	0	0
17	20585362	.	T	C	0	1	1	0	0	1	0	0
17	20587321	.	A	C	3	2	5	0	0	5	0	0
17	20653983	.	T	C	5	4	9	0	0	9	0	0
17	20654140	.	G	A	3	2	5	0	0	5	0	0
17	20674063	.	C	T	6	5	11	0	1	12	0	0
17	20674794	.	C	T	8	7	15	0	3	18	0	0
17	20674889	.	T	A	11	12	23	0	1	24	0	0
17	20684685	.	A	T	7	5	12	0	1	13	0	0
17	20695604	.	G	A	4	2	6	0	1	7	0	0
17	20695941	.	C	A	0	3	3	0	7	10	0	0
17	20701602	.	A	G	24	22	46	0	3	49	0	0
17	20701999	.	G	A	12	14	26	0	0	26	0	0
17	20702030	.	C	T	0	8	8	0	4	12	0	0
17	20702056	.	G	A	2	1	3	0	0	3	0	0
17	20719067	.	G	C	11	8	19	0	0	19	0	0
17	20719232	.	A	G	3	7	10	0	0	10	0	0
17	20719746	.	G	T	6	3	9	0	0	9	0	0
17	20720046	.	C	T	0	9	9	0	7	16	0	0
17	20720121	.	G	T	14	9	23	0	1	24	0	0
17	20720334	.	C	T	7	13	20	0	0	20	0	0
17	20720581	.	G	A	8	7	15	0	2	17	0	0
17	20720739	.	G	T	7	6	13	0	2	15	0	0
17	20721597	.	A	G	1	3	4	0	0	4	0	0
17	20722389	.	A	G	1	4	5	0	0	5	0	0
17	20722955	.	A	G	3	2	5	0	0	5	0	0
17	20723081	.	A	T	3	2	5	0	0	5	0	0
17	20724318	.	C	T	5	2	7	0	0	7	0	0
17	20724675	.	A	G	3	5	8	0	1	9	0	0
17	20725107	.	G	A	3	3	6	0	2	8	0	0
17	20725296	.	T	C	3	4	7	0	1	8	0	0
17	20725474	.	A	C	2	2	4	0	0	4	0	0
17	20725554	.	G	A	3	2	5	0	0	5	0	0
17	20795992	.	G	A	1	1	2	0	0	2	0	0
17	20929201	.	C	T	4	3	7	0	1	8	0	0
17	20963653	.	T	C	12	14	26	0	3	29	0	0
17	20963664	.	T	C	12	12	24	0	1	25	0	0
17	20964669	.	A	G	5	6	11	0	0	11	0	0
17	20964978	.	A	G	7	6	13	0	1	14	0	0
17	20965143	.	G	A	5	9	14	0	1	15	0	0
17	20965182	.	C	T	0	6	6	0	11	17	0	0
17	20965194	.	G	T	10	5	15	0	1	16	0	0
17	20965295	.	T	G	1	1	2	0	0	2	0	0
17	20978673	.	A	G	7	6	13	0	0	13	0	0
17	20978972	.	G	A	2	4	6	0	0	6	0	0
17	21120781	.	G	A	2	10	12	0	1	13	0	0
17	21123537	.	T	C	1	3	4	0	0	4	0	0
17	21139672	.	C	G	0	1	1	0	0	1	0	0
17	21151996	.	C	T	2	2	4	0	1	5	0	0
17	21152106	.	G	A	1	2	3	0	0	3	0	0
17	21152145	.	A	C	2	4	6	0	0	6	0	0
17	21154691	.	A	G	11	4	15	0	1	16	0	0
17	21154957	.	C	A	9	4	13	0	1	14	0	0
17	21155425	.	C	A	11	9	20	0	3	23	0	0
17	21155817	.	T	C	4	12	16	0	1	17	0	0
17	21156140	.	G	T	4	2	6	0	5	11	0	0
17	21156162	.	A	G	9	7	16	0	1	17	0	0
17	21156207	.	A	C	11	8	19	0	0	19	0	0
17	21156220	.	C	T	10	6	16	0	2	18	0	0
17	21156265	.	T	A	5	3	8	0	0	8	0	0
17	21156413	.	C	G	1	1	2	0	1	3	0	0
17	21156808	.	A	T	1	3	4	0	0	4	0	0
17	21158629	.	C	G	0	2	2	0	1	3	0	0
17	21372616	.	C	T	0	11	11	0	15	26	0	0
17	21372810	.	G	T	26	27	53	0	1	54	0	0
17	21373062	.	G	A	20	14	34	0	4	38	0	0
17	21373105	.	C	G	1	10	11	0	29	40	0	0
17	21377133	.	G	A	5	1	6	0	0	6	0	0
17	21396399	.	A	G	2	0	2	0	1	3	0	0
17	21396444	.	A	G	3	2	5	0	0	5	0	0
17	21396462	.	A	G	0	2	2	0	0	2	0	0
17	21433014	.	C	T	0	4	4	0	5	9	0	0
17	21433074	.	G	A	5	9	14	0	1	15	0	0
17	21433396	.	C	T	0	3	3	0	1	4	0	0
17	21433464	.	G	A	1	4	5	0	0	5	0	0
17	21433680	.	C	A	1	5	6	0	0	6	0	0
17	21433750	.	C	T	1	4	5	0	3	8	0	0
17	21550216	.	T	C	2	3	5	0	2	7	0	0
17	21560706	.	A	T	3	5	8	0	0	8	0	0
17	21560738	.	A	G	4	6	10	0	0	10	0	0
17	21560763	.	T	C	5	10	15	0	1	16	0	0
17	21562542	.	T	G	1	2	3	0	0	3	0	0
17	21563193	.	G	A	3	4	7	0	0	7	0	0
17	21791668	.	T	C	3	0	3	0	8	11	0	0
17	21791974	.	C	T	1	4	5	0	0	5	0	0
17	21817651	.	G	A	0	2	2	0	2	4	0	0
17	21817652	.	G	A	2	2	4	0	0	4	0	0
17	21820366	.	C	T	1	2	3	0	0	3	0	0
17	21820378	.	C	T	1	2	3	0	0	3	0	0
17	21820583	.	G	A	3	7	10	0	0	10	0	0
17	21820657	.	C	A	3	7	10	0	0	10	0	0
17	21820744	.	A	T	5	3	8	0	0	8	0	0
17	21820772	.	A	G	7	4	11	0	0	11	0	0
17	21820879	.	C	T	9	5	14	0	3	17	0	0
17	21821381	.	A	G	9	9	18	0	2	20	0	0
17	21821405	.	T	C	9	10	19	0	0	19	0	0
17	21821627	.	C	T	4	3	7	0	0	7	0	0
17	21821653	.	T	C	3	5	8	0	1	9	0	0
17	21821856	.	C	T	13	5	18	0	2	20	0	0
17	21821958	.	C	T	4	9	13	0	1	14	0	0
17	21904009	.	G	A	0	5	5	0	7	12	0	0
17	21911999	.	T	C	13	20	33	0	3	36	0	0
17	21912381	.	T	C	15	10	25	0	5	30	0	0
17	21912489	.	T	C	15	7	22	0	1	23	0	0
17	21912517	.	T	C	13	6	19	0	2	21	0	0
17	21912554	.	G	T	8	5	13	0	1	14	0	0
17	21912597	.	C	A	4	5	9	0	4	13	0	0
17	21912622	.	C	A	6	6	12	0	0	12	0	0
17	21912676	.	A	T	7	7	14	0	0	14	0	0
17	21912708	.	T	A	7	14	21	0	0	21	0	0
17	21912797	.	T	C	12	14	26	0	1	27	0	0
17	21912874	.	A	G	18	13	31	0	3	34	0	0
17	21912890	.	G	T	16	17	33	0	1	34	0	0
17	21954957	.	C	T	1	2	3	0	0	3	0	0
17	21958945	.	A	G	3	0	3	0	8	11	0	0
17	21959239	.	A	T	8	9	17	0	1	18	0	0
17	21975525	.	G	A	0	5	5	0	0	5	0	0
17	21975528	.	C	G	1	5	6	0	1	7	0	0
17	22032345	.	T	A	2	3	5	0	1	6	0	0
17	22032354	.	A	G	0	5	5	0	0	5	0	0
17	22033020	.	G	A	4	5	9	0	1	10	0	0
17	22035945	.	C	T	0	5	5	0	1	6	0	0
17	22036427	.	C	T	3	3	6	0	0	6	0	0
17	22036460	.	C	A	4	4	8	0	1	9	0	0
17	22036686	.	A	G	1	7	8	0	0	8	0	0
17	22047883	.	C	T	0	4	4	0	5	9	0	0
17	22052074	.	G	A	1	0	1	0	0	1	0	0
17	22063318	.	T	C	2	2	4	0	2	6	0	0
17	22090897	.	T	G	2	0	2	0	5	7	0	0
17	22091044	.	T	G	2	3	5	0	0	5	0	0
17	22091067	.	G	A	1	4	5	0	0	5	0	0
17	22091118	.	T	A	2	2	4	0	1	5	0	0
17	22091120	.	A	T	3	2	5	0	0	5	0	0
17	22108065	.	G	A	10	10	20	0	2	22	0	0
17	22108207	.	A	T	0	1	1	0	0	1	0	0
17	22113050	.	T	C	3	0	3	0	0	3	0	0
17	22489033	.	A	C	1	2	3	0	0	3	0	0
17	22489072	.	G	C	0	2	2	0	1	3	0	0
17	22500507	.	C	A	4	4	8	0	1	9	0	0
17	22500627	.	C	T	2	4	6	0	0	6	0	0
17	22500937	.	G	A	0	2	2	0	4	6	0	0
17	22500972	.	A	C	6	2	8	0	2	10	0	0
17	22501063	.	G	A	0	5	5	0	4	9	0	0
17	22501353	.	G	A	2	5	7	0	0	7	0	0
17	22501490	.	T	C	5	5	10	0	0	10	0	0
17	22501493	.	C	A	5	5	10	0	0	10	0	0
17	22501547	.	C	A	6	9	15	0	2	17	0	0
17	22501645	.	G	T	0	8	8	0	0	8	0	0
17	22501858	.	C	T	2	4	6	0	0	6	0	0
17	22584847	.	G	A	16	20	36	0	3	39	0	0
17	22585264	.	T	A	21	24	45	0	4	49	0	0
17	22585273	.	C	T	22	20	42	0	7	49	0	0
17	22585337	.	T	A	18	18	36	0	0	36	0	0
17	22650586	.	C	T	4	3	7	0	0	7	0	0
17	22650641	.	C	A	4	2	6	0	0	6	0	0
17	22650760	.	C	T	0	0	0	0	1	1	0	0
17	22651351	.	C	T	0	3	3	0	0	3	0	0
17	22651375	.	T	C	0	3	3	0	0	3	0	0
17	22653491	.	C	T	2	5	7	0	0	7	0	0
17	22653710	.	C	T	4	3	7	0	0	7	0	0
17	22654096	.	C	T	2	4	6	0	0	6	0	0
17	22658245	.	A	G	0	1	1	0	1	2	0	0
17	22659206	.	G	A	0	0	0	0	1	1	0	0
17	22662759	.	T	C	2	2	4	0	1	5	0	0
17	22669012	.	G	A	0	7	7	0	6	13	0	0
17	22669060	.	C	T	11	7	18	0	0	18	0	0
17	22669511	.	A	C	11	3	14	0	1	15	0	0
17	22687408	.	C	A	5	15	20	0	2	22	0	0
17	22687409	.	C	G	5	16	21	0	1	22	0	0
17	22687451	.	T	C	10	6	16	0	4	20	0	0
17	22687500	.	T	G	8	4	12	0	1	13	0	0
17	22687558	.	T	A	15	13	28	0	0	28	0	0
17	22687561	.	G	A	15	14	29	0	0	29	0	0
17	22687729	.	T	C	16	24	40	0	3	43	0	0
17	22687842	.	T	A	16	15	31	0	2	33	0	0
17	22713696	.	C	T	9	13	22	0	2	24	0	0
17	22723479	.	T	C	10	10	20	0	1	21	0	0
17	22723515	.	C	T	5	7	12	0	0	12	0	0
17	22729079	.	T	C	0	3	3	0	0	3	0	0
17	22729772	.	T	A	8	15	23	0	1	24	0	0
17	22729796	.	G	A	0	12	12	0	16	28	0	0
17	22729886	.	C	T	0	3	3	0	0	3	0	0
17	22738350	.	G	A	7	4	11	0	0	11	0	0
17	22741044	.	C	T	10	13	23	0	1	24	0	0
17	22741070	.	G	A	0	9	9	0	13	22	0	0
17	22741096	.	A	T	4	9	13	0	2	15	0	0
17	22741437	.	A	T	14	11	25	0	0	25	0	0
17	22918230	.	G	A	0	2	2	0	0	2	0	0
17	22918258	.	A	G	0	1	1	0	0	1	0	0
17	22937684	.	A	T	2	3	5	0	1	6	0	0
17	22937719	.	A	T	1	3	4	0	0	4	0	0
17	22944875	.	A	G	3	3	6	0	1	7	0	0
17	22944887	.	A	G	4	3	7	0	0	7	0	0
17	22946926	.	C	T	3	6	9	0	0	9	0	0
17	22946930	.	A	G	2	4	6	0	1	7	0	0
17	23194040	.	T	C	1	3	4	0	1	5	0	0
17	23215411	.	T	C	1	3	4	0	0	4	0	0
17	23215612	.	G	A	1	0	1	0	0	1	0	0
17	23215678	.	A	T	1	1	2	0	0	2	0	0
17	23216461	.	C	T	0	2	2	0	1	3	0	0
17	23220627	.	A	G	1	1	2	0	0	2	0	0
17	23220698	.	T	A	1	0	1	0	0	1	0	0
17	23222460	.	C	G	5	2	7	0	0	7	0	0
17	23223166	.	C	G	2	4	6	0	1	7	0	0
17	23224626	.	C	T	3	2	5	0	2	7	0	0
17	23224680	.	G	A	6	4	10	0	1	11	0	0
17	23224743	.	A	G	5	0	5	0	9	14	0	0
17	23224800	.	G	A	7	10	17	0	0	17	0	0
17	23226667	.	C	T	7	7	14	0	1	15	0	0
17	23231130	.	C	T	7	1	8	0	1	9	0	0
17	23258050	.	C	T	2	2	4	0	0	4	0	0
17	23300999	.	A	T	1	2	3	0	0	3	0	0
17	23301001	.	C	T	0	3	3	0	0	3	0	0
17	23301102	.	C	T	1	2	3	0	1	4	0	0
17	23301303	.	G	A	8	9	17	0	0	17	0	0
17	23301372	.	C	T	5	12	17	0	1	18	0	0
17	23301390	.	G	A	0	6	6	0	15	21	0	0
17	23301433	.	G	T	13	10	23	0	0	23	0	0
17	23301484	.	G	A	12	5	17	0	1	18	0	0
17	23434216	.	G	A	3	4	7	0	1	8	0	0
17	23434264	.	A	G	5	3	8	0	0	8	0	0
17	23441698	.	A	G	2	1	3	0	0	3	0	0
17	23444362	.	G	C	1	4	5	0	1	6	0	0
17	23542264	.	T	A	2	2	4	0	1	5	0	0
17	23542662	.	C	T	1	2	3	0	1	4	0	0
17	23542677	.	G	A	2	3	5	0	0	5	0	0
17	23542890	.	C	G	1	2	3	0	0	3	0	0
17	23549416	.	G	A	2	3	5	0	0	5	0	0
17	23549710	.	G	T	5	7	12	0	0	12	0	0
17	23551512	.	T	C	2	4	6	0	0	6	0	0
17	23551536	.	C	T	3	6	9	0	0	9	0	0
17	23555150	.	C	T	0	1	1	0	0	1	0	0
17	23575324	.	T	A	3	3	6	0	0	6	0	0
17	23656112	.	C	T	0	10	10	0	12	22	0	0
17	23659853	.	C	T	5	9	14	0	0	14	0	0
17	23711184	.	A	T	4	7	11	0	0	11	0	0
17	23711421	.	A	C	9	7	16	0	0	16	0	0
17	23711775	.	C	T	0	7	7	0	11	18	0	0
17	23727637	.	G	T	3	3	6	0	1	7	0	0
17	23764591	.	T	C	3	3	6	0	1	7	0	0
17	23820614	.	A	G	8	5	13	0	1	14	0	0
17	23821410	.	C	T	2	6	8	0	0	8	0	0
17	23822235	.	G	T	1	5	6	0	1	7	0	0
17	23822323	.	G	A	1	2	3	0	0	3	0	0
17	23822749	.	C	T	1	3	4	0	0	4	0	0
17	23822856	.	G	A	3	4	7	0	0	7	0	0
17	23824504	.	A	G	1	3	4	0	0	4	0	0
17	23935259	.	C	T	2	4	6	0	0	6	0	0
17	23937626	.	T	G	4	7	11	0	0	11	0	0
17	23940102	.	C	A	5	15	20	0	0	20	0	0
17	23948365	.	A	G	6	5	11	0	1	12	0	0
17	23952672	.	G	C	1	11	12	0	1	13	0	0
17	23956882	.	G	A	6	20	26	0	1	27	0	0
17	23956925	.	G	A	0	15	15	0	11	26	0	0
17	23964568	.	A	T	1	2	3	0	0	3	0	0
17	23964690	.	T	A	5	2	7	0	0	7	0	0
17	23964719	.	A	G	4	2	6	0	1	7	0	0
17	23964732	.	T	C	5	4	9	0	0	9	0	0
17	23965241	.	G	T	3	5	8	0	0	8	0	0
17	23965475	.	G	C	5	3	8	0	0	8	0	0
17	23965694	.	A	C	4	4	8	0	0	8	0	0
17	23965983	.	C	A	4	7	11	0	0	11	0	0
17	23986153	.	A	G	6	0	6	0	8	14	0	0
17	23986585	.	T	C	13	11	24	0	0	24	0	0
17	24081209	.	A	G	2	2	4	0	1	5	0	0
17	24186029	.	C	T	0	1	1	0	1	2	0	0
17	24186042	.	T	C	1	3	4	0	0	4	0	0
17	24186129	.	C	T	3	3	6	0	0	6	0	0
17	24222649	.	G	A	10	5	15	0	0	15	0	0
17	24222730	.	T	A	5	10	15	0	1	16	0	0
17	24222752	.	A	T	7	11	18	0	1	19	0	0
17	24222771	.	G	T	5	8	13	0	4	17	0	0
17	24247670	.	G	T	2	4	6	0	0	6	0	0
17	24254467	.	G	A	0	3	3	0	4	7	0	0
17	24268278	.	G	A	2	4	6	0	1	7	0	0
17	24313974	.	T	A	1	4	5	0	0	5	0	0
17	24314068	.	G	A	1	3	4	0	0	4	0	0
17	24314331	.	A	G	6	9	15	0	0	15	0	0
17	24314468	.	A	T	4	5	9	0	0	9	0	0
17	24314986	.	G	A	0	8	8	0	9	17	0	0
17	24339217	.	G	T	0	3	3	0	0	3	0	0
17	24440579	.	G	A	0	1	1	0	0	1	0	0
17	24442526	.	G	A	0	6	6	0	2	8	0	0
17	24442888	.	C	T	1	1	2	0	0	2	0	0
17	24444239	.	T	G	4	10	14	0	2	16	0	0
17	24464939	.	A	C	6	5	11	0	2	13	0	0
17	24464987	.	A	T	7	4	11	0	0	11	0	0
17	24469255	.	G	A	1	2	3	0	0	3	0	0
17	24469752	.	A	C	9	4	13	0	0	13	0	0
17	24470146	.	C	A	14	18	32	0	6	38	0	0
17	24480111	.	T	C	4	2	6	0	0	6	0	0
17	24480273	.	C	T	0	2	2	0	1	3	0	0
17	24537442	.	G	T	1	2	3	0	0	3	0	0
17	24537450	.	T	A	1	2	3	0	0	3	0	0
17	24579158	.	T	C	1	3	4	0	0	4	0	0
17	24579518	.	T	C	1	2	3	0	0	3	0	0
17	24579519	.	A	C	1	1	2	0	1	3	0	0
17	24599488	.	C	G	1	3	4	0	0	4	0	0
17	24600150	.	A	C	4	5	9	0	0	9	0	0
17	24600595	.	G	A	0	2	2	0	3	5	0	0
17	24600767	.	G	A	0	2	2	0	3	5	0	0
17	24600976	.	G	A	6	6	12	0	3	15	0	0
17	24601072	.	G	A	0	2	2	0	4	6	0	0
17	24601579	.	T	A	12	6	18	0	0	18	0	0
17	24601654	.	A	C	3	0	3	0	9	12	0	0
17	24601924	.	C	T	7	5	12	0	0	12	0	0
17	24604523	.	A	T	2	3	5	0	0	5	0	0
17	24612726	.	A	G	11	2	13	0	4	17	0	0
17	24614468	.	C	T	35	28	63	0	5	68	0	0
17	24617888	.	C	A	3	29	32	0	3	35	0	0
17	24618198	.	A	G	1	6	7	0	1	8	0	0
17	24618912	.	C	T	2	3	5	0	1	6	0	0
17	24618945	.	C	T	1	1	2	0	0	2	0	0
17	24619650	.	A	G	0	3	3	0	0	3	0	0
17	24619693	.	A	G	1	0	1	0	4	5	0	0
17	24622623	.	G	T	11	2	13	0	0	13	0	0
17	24622644	.	G	A	14	4	18	0	0	18	0	0
17	24624477	.	G	C	0	1	1	0	1	2	0	0
17	24626513	.	T	G	1	0	1	0	0	1	0	0
17	24631128	.	T	C	3	5	8	0	1	9	0	0
17	24631156	.	C	T	3	6	9	0	0	9	0	0
17	24652987	.	C	T	2	1	3	0	1	4	0	0
17	24685850	.	C	T	9	3	12	0	0	12	0	0
17	24686352	.	C	T	2	9	11	0	0	11	0	0
17	24686443	.	A	T	8	4	12	0	1	13	0	0
17	24686511	.	G	A	3	5	8	0	1	9	0	0
17	24687602	.	G	C	2	2	4	0	0	4	0	0
17	24690050	.	G	A	1	5	6	0	4	10	0	0
17	24690615	.	G	A	2	5	7	0	1	8	0	0
17	24691987	.	C	T	1	1	2	0	0	2	0	0
17	24693207	.	T	C	1	3	4	0	1	5	0	0
17	24694145	.	A	G	4	5	9	0	0	9	0	0
17	24694573	.	T	A	4	2	6	0	1	7	0	0
17	24694742	.	C	A	1	2	3	0	0	3	0	0
17	24694877	.	C	G	4	5	9	0	0	9	0	0
17	24695096	.	C	A	4	5	9	0	0	9	0	0
17	24695683	.	T	A	6	9	15	0	1	16	0	0
17	24695743	.	G	A	12	8	20	0	2	22	0	0
17	24695815	.	G	C	5	1	6	0	12	18	0	0
17	24695968	.	G	C	6	6	12	0	1	13	0	0
17	24696047	.	G	T	8	14	22	0	0	22	0	0
17	24696142	.	A	C	5	2	7	0	1	8	0	0
17	24696274	.	T	C	3	5	8	0	0	8	0	0
17	24696658	.	C	A	8	9	17	0	3	20	0	0
17	24696716	.	A	G	8	11	19	0	2	21	0	0
17	24699483	.	G	A	3	4	7	0	0	7	0	0
17	24701496	.	C	T	9	6	15	0	1	16	0	0
17	24701767	.	T	C	2	7	9	0	0	9	0	0
17	24701793	.	C	G	0	2	2	0	2	4	0	0
17	24702981	.	T	C	3	2	5	0	0	5	0	0
17	24709204	.	C	T	7	8	15	0	1	16	0	0
17	24709443	.	T	G	1	0	1	0	0	1	0	0
17	24715189	.	A	G	2	3	5	0	0	5	0	0
17	24720907	.	T	C	1	3	4	0	0	4	0	0
17	24721345	.	G	A	2	2	4	0	0	4	0	0
17	24721378	.	C	A	5	6	11	0	0	11	0	0
17	24721384	.	G	A	5	6	11	0	0	11	0	0
17	24721462	.	G	A	0	6	6	0	6	12	0	0
17	24722402	.	C	T	5	2	7	0	1	8	0	0
17	24722441	.	A	G	3	2	5	0	1	6	0	0
17	24725877	.	C	A	12	11	23	0	0	23	0	0
17	24726035	.	A	T	14	8	22	0	2	24	0	0
17	24726239	.	G	T	14	14	28	0	0	28	0	0
17	24726276	.	A	G	8	13	21	0	5	26	0	0
17	24726533	.	T	A	12	6	18	0	0	18	0	0
17	24726585	.	C	T	12	9	21	0	1	22	0	0
17	24726613	.	G	A	7	10	17	0	6	23	0	0
17	24726637	.	A	G	12	8	20	0	3	23	0	0
17	24726737	.	T	C	17	12	29	0	1	30	0	0
17	24726753	.	G	A	12	14	26	0	4	30	0	0
17	24726996	.	A	G	12	9	21	0	1	22	0	0
17	24727037	.	C	T	7	14	21	0	1	22	0	0
17	24727130	.	T	G	9	0	9	0	16	25	0	0
17	24727186	.	C	G	3	9	12	0	1	13	0	0
17	24747328	.	A	C	2	2	4	0	0	4	0	0
17	24747485	.	C	T	1	3	4	0	0	4	0	0
17	24787519	.	G	A	2	2	4	0	1	5	0	0
17	24787774	.	A	T	1	3	4	0	0	4	0	0
17	24820044	.	C	T	0	4	4	0	0	4	0	0
17	24820134	.	T	C	4	5	9	0	1	10	0	0
17	24820136	.	G	C	5	4	9	0	1	10	0	0
17	24820559	.	C	T	1	5	6	0	0	6	0	0
17	24820587	.	C	T	1	5	6	0	0	6	0	0
17	24821697	.	T	C	3	2	5	0	0	5	0	0
17	24835158	.	A	T	12	14	26	0	1	27	0	0
17	24835251	.	G	C	5	13	18	0	2	20	0	0
17	24835547	.	A	T	6	2	8	0	1	9	0	0
17	24856019	.	G	A	14	13	27	0	1	28	0	0
17	24856088	.	C	G	17	13	30	0	0	30	0	0
17	24856338	.	T	C	9	3	12	0	0	12	0	0
17	24856648	.	G	T	6	6	12	0	1	13	0	0
17	24858939	.	A	C	4	1	5	0	8	13	0	0
17	24861176	.	C	T	1	6	7	0	12	19	0	0
17	24861252	.	G	A	8	7	15	0	3	18	0	0
17	24861558	.	A	G	10	7	17	0	0	17	0	0
17	24863929	.	C	G	2	4	6	0	0	6	0	0
17	24869963	.	G	A	3	2	5	0	0	5	0	0
17	24869990	.	T	A	2	2	4	0	1	5	0	0
17	24872714	.	T	A	2	2	4	0	0	4	0	0
17	24880613	.	G	A	3	4	7	0	0	7	0	0
17	24887118	.	T	C	2	6	8	0	0	8	0	0
17	24887419	.	G	A	0	1	1	0	0	1	0	0
17	24892561	.	C	T	1	2	3	0	0	3	0	0
17	24926623	.	G	A	2	3	5	0	0	5	0	0
17	24932994	.	T	A	3	5	8	0	0	8	0	0
17	24936154	.	A	T	2	1	3	0	0	3	0	0
17	24936160	.	G	A	2	1	3	0	0	3	0	0
17	25140974	.	C	T	2	2	4	0	0	4	0	0
17	25173899	.	A	T	0	3	3	0	1	4	0	0
17	25174567	.	A	T	1	2	3	0	0	3	0	0
17	25175134	.	T	C	1	3	4	0	0	4	0	0
17	25289571	.	C	A	5	5	10	0	0	10	0	0
17	25290396	.	C	T	6	4	10	0	0	10	0	0
17	25290481	.	G	A	0	6	6	0	3	9	0	0
17	25290657	.	C	T	3	6	9	0	0	9	0	0
17	25297908	.	C	T	1	1	2	0	0	2	0	0
17	25298003	.	T	G	3	3	6	0	2	8	0	0
17	25301622	.	C	T	1	1	2	0	0	2	0	0
17	25306107	.	G	A	0	2	2	0	0	2	0	0
17	25336507	.	T	C	3	3	6	0	0	6	0	0
17	25337466	.	C	T	2	6	8	0	0	8	0	0
17	25339779	.	G	A	2	5	7	0	0	7	0	0
17	25342003	.	T	A	1	2	3	0	0	3	0	0
17	25393034	.	A	C	4	2	6	0	0	6	0	0
17	25393073	.	C	T	2	1	3	0	1	4	0	0
17	25409170	.	A	T	0	4	4	0	0	4	0	0
17	25418800	.	A	G	1	2	3	0	0	3	0	0
17	25420937	.	C	T	5	3	8	0	1	9	0	0
17	25424205	.	C	A	7	6	13	0	1	14	0	0
17	25424239	.	C	T	7	6	13	0	0	13	0	0
17	25424330	.	T	A	11	13	24	0	2	26	0	0
17	25424331	.	C	A	10	15	25	0	1	26	0	0
17	25424462	.	G	T	9	12	21	0	0	21	0	0
17	25424568	.	A	G	13	11	24	0	1	25	0	0
17	25424597	.	C	T	9	13	22	0	2	24	0	0
17	25424664	.	G	A	14	11	25	0	2	27	0	0
17	25424770	.	G	A	0	8	8	0	5	13	0	0
17	25424771	.	A	G	5	7	12	0	1	13	0	0
17	25425081	.	G	T	6	10	16	0	0	16	0	0
17	25425094	.	A	G	5	10	15	0	1	16	0	0
17	25425146	.	T	A	8	9	17	0	0	17	0	0
17	25434250	.	G	T	1	0	1	0	0	1	0	0
17	25435992	.	A	G	23	21	44	0	2	46	0	0
17	25436073	.	T	C	20	26	46	0	6	52	0	0
17	25436591	.	A	T	15	11	26	0	1	27	0	0
17	25439909	.	G	A	25	26	51	0	0	51	0	0
17	25439949	.	C	T	19	17	36	0	6	42	0	0
17	25439950	.	C	A	21	18	39	0	3	42	0	0
17	25475601	.	C	T	2	1	3	0	0	3	0	0
17	25479147	.	T	A	3	3	6	0	0	6	0	0
17	25479151	.	A	C	2	3	5	0	0	5	0	0
17	25479594	.	T	A	4	6	10	0	2	12	0	0
17	25479640	.	A	G	5	12	17	0	2	19	0	0
17	25479792	.	G	A	13	9	22	0	1	23	0	0
17	25479874	.	T	A	16	7	23	0	0	23	0	0
17	25479980	.	C	T	8	2	10	0	4	14	0	0
17	25480129	.	T	G	7	11	18	0	2	20	0	0
17	25548992	.	G	A	0	2	2	0	0	2	0	0
17	25549001	.	G	T	1	1	2	0	0	2	0	0
17	25549056	.	T	C	1	2	3	0	0	3	0	0
17	25549557	.	T	C	1	4	5	0	1	6	0	0
17	25549574	.	C	T	1	1	2	0	1	3	0	0
17	25555209	.	G	A	1	0	1	0	0	1	0	0
17	25558916	.	G	A	3	1	4	0	2	6	0	0
17	25562160	.	A	G	0	1	1	0	0	1	0	0
17	25562198	.	G	T	3	2	5	0	0	5	0	0
17	25563524	.	T	A	0	1	1	0	0	1	0	0
17	25563542	.	G	A	1	2	3	0	0	3	0	0
17	25563667	.	C	T	0	2	2	0	2	4	0	0
17	25563738	.	G	A	4	3	7	0	0	7	0	0
17	25575804	.	A	T	2	2	4	0	0	4	0	0
17	25585596	.	C	T	3	2	5	0	0	5	0	0
17	25595611	.	A	G	0	0	0	0	1	1	0	0
17	25595618	.	G	A	0	1	1	0	0	1	0	0
17	25595653	.	G	A	0	2	2	0	1	3	0	0
17	25595674	.	G	A	2	2	4	0	0	4	0	0
17	25595697	.	G	A	2	2	4	0	0	4	0	0
17	25596801	.	C	T	2	1	3	0	1	4	0	0
17	25602744	.	C	T	0	2	2	0	0	2	0	0
17	25606154	.	G	A	1	9	10	0	12	22	0	0
17	25606161	.	C	T	11	14	25	0	3	28	0	0
17	25606421	.	T	A	10	10	20	0	0	20	0	0
17	25610895	.	G	T	14	10	24	0	0	24	0	0
17	25611011	.	A	G	9	4	13	0	0	13	0	0
17	25611067	.	A	C	5	9	14	0	1	15	0	0
17	25611091	.	C	A	0	8	8	0	5	14	1	0
17	25612941	.	G	C	4	3	7	0	1	8	0	0
17	25612978	.	G	A	0	2	2	0	1	3	0	0
17	25615493	.	A	G	1	3	4	0	0	4	0	0
17	25615609	.	T	A	2	3	5	0	0	5	0	0
17	25615894	.	A	G	0	1	1	0	0	1	0	0
17	25618850	.	G	T	4	1	5	0	0	5	0	0
17	25625764	.	A	G	2	0	2	0	0	2	0	0
17	25636167	.	G	A	23	20	43	0	1	44	0	0
17	25636381	.	C	T	3	36	39	0	30	69	0	0
17	25636412	.	A	G	32	25	57	0	6	63	0	0
17	25636539	.	T	C	31	3	34	1	31	66	0	0
17	25636594	.	C	T	4	38	42	0	28	71	1	0
17	25636679	.	C	T	2	34	36	0	32	68	0	0
17	25637106	.	A	C	23	34	57	0	9	66	0	0
17	25637676	.	T	C	25	0	25	0	32	57	0	0
17	25640476	.	G	A	7	5	12	0	0	12	0	0
17	25873990	.	C	A	0	1	1	0	0	1	0	0
17	25878173	.	A	G	2	2	4	0	0	4	0	0
17	25885155	.	T	G	2	2	4	0	0	4	0	0
17	25885163	.	G	A	2	2	4	0	0	4	0	0
17	25885415	.	T	A	3	4	7	0	1	8	0	0
17	25885418	.	C	G	3	5	8	0	0	8	0	0
17	26335000	.	G	A	0	1	1	0	0	1	0	0
17	26362130	.	G	A	10	5	15	0	0	15	0	0
17	26362500	.	C	T	2	3	5	0	0	5	0	0
17	26362741	.	C	T	2	6	8	0	1	9	0	0
17	26477743	.	A	C	9	7	16	0	2	18	0	0
17	26477747	.	T	A	5	9	14	0	3	17	0	0
17	26477795	.	A	C	11	6	17	0	2	19	0	0
17	26477857	.	T	C	13	12	25	0	4	29	0	0
17	26477860	.	C	T	11	14	25	0	4	29	0	0
17	26478023	.	T	C	18	5	23	0	0	23	0	0
17	26478403	.	T	G	4	4	8	0	4	12	0	0
17	26478592	.	A	G	14	8	22	0	4	26	0	0
17	26478818	.	T	C	4	0	4	0	8	12	0	0
17	26478952	.	G	A	11	6	17	0	3	20	0	0
17	26478986	.	A	G	6	10	16	0	0	16	0	0
17	26479063	.	A	G	12	12	24	0	1	25	0	0
17	26479145	.	T	C	10	11	21	0	1	22	0	0
17	26479916	.	G	T	4	5	9	0	0	9	0	0
17	26479960	.	C	T	3	4	7	0	0	7	0	0
17	26479997	.	A	T	1	2	3	0	0	3	0	0
17	26480086	.	G	T	1	2	3	0	0	3	0	0
17	26480250	.	A	C	4	2	6	0	1	7	0	0
17	26480254	.	G	A	3	2	5	0	2	7	0	0
17	26480622	.	A	T	6	4	10	0	0	10	0	0
17	26480926	.	T	G	1	3	4	0	0	4	0	0
17	26585163	.	A	T	0	3	3	0	1	4	0	0
17	26585646	.	C	T	16	7	23	0	1	24	0	0
17	26585748	.	A	G	4	0	4	0	9	13	0	0
17	26585763	.	T	A	3	10	13	0	0	13	0	0
17	26590001	.	T	G	10	5	15	0	0	15	0	0
17	26590170	.	A	T	3	2	5	0	0	5	0	0
17	26590330	.	T	C	13	8	21	0	1	22	0	0
17	26590495	.	A	G	1	4	5	0	0	5	0	0
17	26590536	.	G	A	2	3	5	0	0	5	0	0
17	26590650	.	G	T	4	5	9	0	0	9	0	0
17	26594931	.	C	T	4	7	11	0	0	11	0	0
17	26599208	.	C	T	0	0	0	0	2	2	0	0
17	26600639	.	G	A	5	3	8	0	0	8	0	0
17	26600667	.	C	T	1	3	4	0	0	4	0	0
17	26600785	.	G	A	1	1	2	0	0	2	0	0
17	26600881	.	G	A	2	3	5	0	0	5	0	0
17	26639659	.	C	T	3	3	6	0	0	6	0	0
17	26642775	.	C	A	0	4	4	0	0	4	0	0
17	26642817	.	T	G	0	0	0	0	4	4	0	0
17	26642818	.	T	C	0	4	4	0	0	4	0	0
17	26657852	.	T	C	8	4	12	0	1	13	0	0
17	26662347	.	C	T	4	1	5	0	0	5	0	0
17	26683466	.	T	C	0	2	2	0	0	2	0	0
17	26683526	.	C	T	14	7	21	0	1	22	0	0
17	26689753	.	G	A	7	19	26	0	7	33	0	0
17	26689768	.	C	A	25	4	29	0	3	32	0	0
17	26689792	.	C	A	9	23	32	0	1	33	0	0
17	26690112	.	T	A	17	12	29	0	1	30	0	0
17	26690250	.	C	T	4	10	14	0	2	16	0	0
17	26690276	.	C	T	14	7	21	0	2	23	0	0
17	26690478	.	C	T	14	14	28	0	0	28	0	0
17	26690558	.	G	A	0	16	16	0	17	33	0	0
17	26714009	.	C	T	30	35	65	0	7	72	0	0
17	26743948	.	T	C	2	3	5	0	0	5	0	0
17	26744862	.	G	A	2	2	4	0	0	4	0	0
17	26744981	.	C	T	1	3	4	0	0	4	0	0
17	26745014	.	G	T	2	3	5	0	0	5	0	0
17	26745106	.	T	C	3	3	6	0	0	6	0	0
17	26745110	.	C	T	1	4	5	0	1	6	0	0
17	26747348	.	A	G	2	2	4	0	0	4	0	0
17	26747392	.	G	T	0	1	1	0	0	1	0	0
17	26810380	.	C	T	10	7	17	0	0	17	0	0
17	26846203	.	C	T	5	5	10	0	1	11	0	0
17	26846650	.	G	A	5	5	10	0	1	11	0	0
17	26846707	.	G	A	0	2	2	0	3	5	0	0
17	26846901	.	T	G	4	4	8	0	0	8	0	0
17	26879854	.	A	C	5	16	21	0	1	22	0	0
17	26879869	.	A	G	10	12	22	0	2	24	0	0
17	26879893	.	A	G	24	11	35	0	1	36	0	0
17	26880107	.	G	A	16	25	41	0	3	44	0	0
17	26880231	.	T	C	23	30	53	0	4	57	0	0
17	26880424	.	T	C	24	29	53	0	6	59	0	0
17	26880714	.	G	T	9	0	9	0	0	9	0	0
17	26880926	.	T	C	15	2	17	0	21	38	0	0
17	26880964	.	A	G	24	22	46	0	1	47	0	0
17	26881131	.	T	A	25	12	37	0	5	42	0	0
17	26881354	.	A	G	16	16	32	0	1	33	0	0
17	26881777	.	A	G	20	14	34	0	3	37	0	0
17	26911747	.	A	G	9	8	17	0	1	18	0	0
17	26928727	.	T	C	1	2	3	0	0	3	0	0
17	26928737	.	A	G	0	1	1	0	1	2	0	0
17	26929475	.	T	C	4	4	8	0	0	8	0	0
17	26929577	.	C	A	5	6	11	0	0	11	0	0
17	26929649	.	A	G	5	6	11	0	1	12	0	0
17	26929654	.	T	A	6	2	8	0	3	11	0	0
17	26929776	.	C	T	3	3	6	0	1	7	0	0
17	26929893	.	G	A	7	6	13	0	1	14	0	0
17	26985469	.	G	C	5	6	11	0	1	12	0	0
17	26985473	.	G	A	6	2	8	0	4	12	0	0
17	26985544	.	T	A	2	5	7	0	1	8	0	0
17	26985586	.	C	T	0	6	6	0	1	7	0	0
17	26985638	.	T	G	0	5	5	0	0	5	0	0
17	26985656	.	T	A	0	4	4	0	0	4	0	0
17	26985692	.	G	T	1	2	3	0	0	3	0	0
17	27160912	.	G	A	1	2	3	0	0	3	0	0
17	27163266	.	T	C	3	3	6	0	0	6	0	0
17	27164497	.	T	C	2	3	5	0	0	5	0	0
17	27166257	.	T	C	2	2	4	0	0	4	0	0
17	27166521	.	C	T	0	1	1	0	0	1	0	0
17	27168957	.	G	T	0	3	3	0	3	6	0	0
17	27169783	.	A	C	4	6	10	0	0	10	0	0
17	27170017	.	G	A	0	5	5	0	9	14	0	0
17	27170153	.	A	T	7	7	14	0	1	15	0	0
17	27170516	.	G	A	0	6	6	0	6	12	0	0
17	27170549	.	G	A	4	5	9	0	0	9	0	0
17	27170605	.	T	G	4	10	14	0	1	15	0	0
17	27170678	.	C	A	4	5	9	0	1	10	0	0
17	27170730	.	T	G	2	5	7	0	2	9	0	0
17	27170746	.	A	T	3	4	7	0	1	8	0	0
17	27171314	.	A	C	4	7	11	0	0	11	0	0
17	27176640	.	G	A	1	2	3	0	0	3	0	0
17	27176871	.	G	A	1	2	3	0	2	5	0	0
17	27177864	.	C	T	4	2	6	0	0	6	0	0
17	27178088	.	T	A	3	4	7	0	0	7	0	0
17	27178356	.	T	A	1	2	3	0	0	3	0	0
17	27178401	.	C	T	3	3	6	0	0	6	0	0
17	27178557	.	C	T	1	3	4	0	1	5	0	0
17	27178638	.	C	G	3	4	7	0	0	7	0	0
17	27178730	.	C	A	3	3	6	0	0	6	0	0
17	27179189	.	A	G	3	5	8	0	1	9	0	0
17	27179203	.	G	T	0	5	5	0	2	7	0	0
17	27179434	.	G	T	3	3	6	0	0	6	0	0
17	27179848	.	A	G	1	2	3	0	0	3	0	0
17	27180407	.	T	A	5	4	9	0	0	9	0	0
17	27180447	.	A	T	1	2	3	0	1	4	0	0
17	27181021	.	T	C	3	5	8	0	1	9	0	0
17	27181048	.	C	G	5	7	12	0	2	14	0	0
17	27181129	.	G	A	3	11	14	0	1	15	0	0
17	27181130	.	G	A	4	11	15	0	0	15	0	0
17	27181257	.	A	C	9	8	17	0	0	17	0	0
17	27181323	.	A	G	4	0	4	0	12	16	0	0
17	27181427	.	C	T	5	7	12	0	0	12	0	0
17	27181618	.	C	A	3	2	5	0	0	5	0	0
17	27181829	.	A	G	4	2	6	0	1	7	0	0
17	27182039	.	T	C	15	8	23	0	1	24	0	0
17	27182114	.	A	G	5	10	15	0	0	15	0	0
17	27182146	.	C	T	5	8	13	0	0	13	0	0
17	27182331	.	T	G	3	3	6	0	1	7	0	0
17	27182340	.	C	T	4	3	7	0	0	7	0	0
17	27182449	.	G	T	5	7	12	0	0	12	0	0
17	27182484	.	T	C	6	12	18	0	1	19	0	0
17	27182645	.	G	T	13	16	29	0	1	30	0	0
17	27182649	.	A	G	14	16	30	0	0	30	0	0
17	27182769	.	A	G	6	7	13	0	2	15	0	0
17	27182894	.	T	C	8	9	17	0	2	19	0	0
17	27182925	.	A	T	8	7	15	0	1	16	0	0
17	27182979	.	C	T	8	10	18	0	1	19	0	0
17	27191528	.	C	T	2	3	5	0	1	6	0	0
17	27192048	.	G	A	1	0	1	0	0	1	0	0
17	27272913	.	T	C	4	5	9	0	1	10	0	0
17	27273013	.	C	T	9	3	12	0	0	12	0	0
17	27408386	.	A	G	10	12	22	0	0	22	0	0
17	27408472	.	C	T	13	9	22	0	6	28	0	0
17	27408523	.	G	T	9	3	12	0	0	12	0	0
17	27408531	.	T	A	2	3	5	0	5	10	0	0
17	27408836	.	T	G	3	7	10	0	2	12	0	0
17	27408889	.	T	C	1	8	9	0	1	10	0	0
17	27413705	.	T	C	4	8	12	0	0	12	0	0
17	27414035	.	G	A	2	3	5	0	2	7	0	0
17	27414098	.	C	A	2	4	6	0	0	6	0	0
17	27414203	.	G	A	6	9	15	0	0	15	0	0
17	27414215	.	C	T	0	9	9	0	7	16	0	0
17	27414367	.	A	G	5	9	14	0	0	14	0	0
17	27414658	.	T	C	3	5	8	0	1	9	0	0
17	27414791	.	A	G	5	2	7	0	0	7	0	0
17	27414815	.	G	A	2	4	6	0	1	7	0	0
17	27415010	.	C	T	0	4	4	0	2	6	0	0
17	27723800	.	G	T	3	4	7	0	0	7	0	0
17	27807455	.	T	C	15	12	27	0	0	27	0	0
17	27808335	.	A	G	15	16	31	0	0	31	0	0
17	27808686	.	G	A	3	6	9	0	2	11	0	0
17	27808700	.	G	A	4	7	11	0	0	11	0	0
17	27808987	.	G	T	0	19	19	0	28	47	0	0
17	27809548	.	T	A	12	7	19	0	2	21	0	0
17	27809631	.	G	T	1	5	6	0	7	13	0	0
17	27809779	.	C	A	17	17	34	1	0	35	0	0
17	27809885	.	A	G	22	22	44	0	3	47	0	0
17	27811277	.	C	G	3	2	5	0	0	5	0	0
17	27812525	.	A	C	12	16	28	0	3	31	0	0
17	27812562	.	G	A	0	13	13	0	15	28	0	0
17	27813221	.	C	T	19	4	23	0	2	25	0	0
17	27813222	.	A	G	18	6	24	0	1	25	0	0
17	27813549	.	C	G	8	4	12	0	1	13	0	0
17	27813553	.	C	G	8	4	12	0	0	12	0	0
17	28051739	.	A	G	4	3	7	0	0	7	0	0
17	28052322	.	C	A	2	4	6	0	0	6	0	0
17	28067389	.	C	T	1	2	3	0	2	5	0	0
17	28067472	.	A	C	4	7	11	0	0	11	0	0
17	28067618	.	A	G	1	2	3	0	0	3	0	0
17	28067856	.	C	T	8	6	14	0	1	15	0	0
17	28068083	.	T	C	6	5	11	0	0	11	0	0
17	28068087	.	G	T	6	5	11	0	0	11	0	0
17	28068168	.	G	A	5	3	8	0	0	8	0	0
17	28068507	.	A	G	6	5	11	0	0	11	0	0
17	28068514	.	T	C	7	4	11	0	0	11	0	0
17	28068916	.	C	T	2	5	7	0	0	7	0	0
17	28069170	.	G	A	6	3	9	0	0	9	0	0
17	28069341	.	G	T	3	7	10	0	0	10	0	0
17	28069342	.	T	C	3	6	9	0	1	10	0	0
17	28069645	.	G	T	7	9	16	0	0	16	0	0
17	28069716	.	G	C	10	13	23	0	2	25	0	0
17	28069787	.	G	A	0	12	12	0	9	21	0	0
17	28070078	.	G	C	12	3	15	0	0	15	0	0
17	28070167	.	C	T	11	12	23	0	0	23	0	0
17	28070284	.	G	A	8	8	16	0	2	18	0	0
17	28070286	.	A	C	10	8	18	0	0	18	0	0
17	28070481	.	T	A	7	15	22	0	0	22	0	0
17	28070600	.	C	A	8	10	18	0	3	21	0	0
17	28070840	.	G	A	4	8	12	0	1	13	0	0
17	28070879	.	T	G	6	3	9	0	0	9	0	0
17	28071029	.	A	T	0	1	1	0	2	3	0	0
17	28071194	.	C	T	5	2	7	0	3	10	0	0
17	28071260	.	A	G	4	13	17	0	2	19	0	0
17	28084592	.	C	T	7	6	13	0	1	14	0	0
17	28084733	.	T	C	19	10	29	0	2	31	0	0
17	28084869	.	A	C	17	14	31	0	0	31	0	0
17	28084996	.	A	T	17	28	45	0	1	46	0	0
17	28097235	.	G	A	3	2	5	0	0	5	0	0
17	28100598	.	C	T	0	3	3	0	5	8	0	0
17	28166980	.	C	T	3	5	8	0	1	9	0	0
17	28167439	.	G	A	8	9	17	0	0	17	0	0
17	28168054	.	A	G	2	4	6	0	1	7	0	0
17	28423698	.	T	C	1	2	3	0	0	3	0	0
17	28466228	.	T	C	2	2	4	0	0	4	0	0
17	28560736	.	T	C	1	4	5	0	0	5	0	0
17	28563725	.	G	A	6	12	18	0	1	19	0	0
17	28608088	.	G	T	0	1	1	0	0	1	0	0
17	28657421	.	G	T	0	2	2	0	0	2	0	0
17	28668465	.	T	C	5	3	8	0	0	8	0	0
17	28668627	.	C	T	3	4	7	0	0	7	0	0
17	28695753	.	C	T	1	2	3	0	0	3	0	0
17	28701100	.	G	A	14	6	20	0	0	20	0	0
17	28707268	.	T	A	5	3	8	0	1	9	0	0
17	28724530	.	A	G	0	0	0	0	1	1	0	0
17	28724539	.	A	T	0	1	1	0	0	1	0	0
17	28724833	.	T	C	5	9	14	0	0	14	0	0
17	28730705	.	C	T	0	3	3	0	0	3	0	0
17	28738387	.	C	T	2	1	3	0	0	3	0	0
17	28741442	.	G	A	9	7	16	0	0	16	0	0
17	28741467	.	G	A	0	10	10	0	10	20	0	0
17	28741752	.	C	T	10	13	23	0	0	23	0	0
17	28741934	.	C	T	7	5	12	0	3	15	0	0
17	28742263	.	G	C	10	15	25	0	1	26	0	0
17	28742385	.	T	A	11	8	19	0	1	20	0	0
17	28742505	.	T	G	15	20	35	0	1	36	0	0
17	28742559	.	C	T	19	17	36	0	1	37	0	0
17	28742681	.	C	T	2	3	5	0	0	5	0	0
17	28742755	.	C	A	2	3	5	0	0	5	0	0
17	28771228	.	T	A	0	3	3	0	0	3	0	0
17	28778186	.	C	T	0	1	1	0	0	1	0	0
17	28784090	.	G	T	5	4	9	0	0	9	0	0
17	28785010	.	G	A	2	2	4	0	2	6	0	0
17	28786873	.	G	A	0	0	0	0	1	1	0	0
17	28789014	.	C	T	0	0	0	0	3	3	0	0
17	28968461	.	T	C	20	14	34	0	1	35	0	0
17	29117355	.	G	A	4	2	6	0	3	9	0	0
17	29227594	.	G	A	2	3	5	0	0	5	0	0
17	29227600	.	G	A	3	3	6	0	1	7	0	0
17	29227691	.	T	A	1	3	4	0	0	4	0	0
17	29228114	.	G	A	2	3	5	0	0	5	0	0
17	29228222	.	A	G	2	1	3	0	1	4	0	0
17	29251810	.	G	C	9	5	14	0	0	14	0	0
17	29252043	.	C	T	5	4	9	0	1	10	0	0
17	29252122	.	C	A	6	4	10	0	1	11	0	0
17	29252218	.	C	T	4	9	13	0	2	15	0	0
17	29252254	.	C	T	4	4	8	0	0	8	0	0
17	29252295	.	T	C	4	2	6	0	0	6	0	0
17	29252308	.	T	G	4	2	6	0	0	6	0	0
17	29252352	.	C	T	2	3	5	0	0	5	0	0
17	29252665	.	G	C	2	4	6	0	0	6	0	0
17	29252754	.	C	G	0	4	4	0	8	12	0	0
17	29283380	.	T	A	2	5	7	0	0	7	0	0
17	29283902	.	G	A	2	4	6	0	0	6	0	0
17	29283920	.	A	C	2	0	2	0	7	9	0	0
17	29283943	.	A	G	3	4	7	0	0	7	0	0
17	29283962	.	A	G	2	3	5	0	1	6	0	0
17	29288718	.	A	G	2	0	2	0	0	2	0	0
17	29300641	.	A	T	2	2	4	0	0	4	0	0
17	29300650	.	A	G	2	2	4	0	0	4	0	0
17	29334520	.	T	A	2	1	3	0	0	3	0	0
17	29335645	.	G	A	0	0	0	0	1	1	0	0
17	29339149	.	T	G	10	9	19	0	0	19	0	0
17	29341079	.	C	T	7	9	16	0	0	16	0	0
17	29341118	.	C	T	9	6	15	0	0	15	0	0
17	29341597	.	T	C	3	13	16	0	1	17	0	0
17	29342904	.	G	A	0	4	4	0	11	15	0	0
17	29342947	.	C	T	5	8	13	0	0	13	0	0
17	29343143	.	T	C	12	14	26	0	3	29	0	0
17	29343153	.	G	A	12	15	27	0	0	27	0	0
17	29343358	.	A	G	18	13	31	0	1	32	0	0
17	29343494	.	A	G	5	10	15	0	1	16	0	0
17	29345725	.	T	G	1	2	3	0	0	3	0	0
17	29364713	.	C	T	1	4	5	0	0	5	0	0
17	29367320	.	T	C	6	4	10	0	1	11	0	0
17	29369029	.	C	T	1	1	2	0	0	2	0	0
17	29369072	.	T	C	3	3	6	0	0	6	0	0
17	29369114	.	T	C	2	2	4	0	1	5	0	0
17	29369213	.	T	G	5	4	9	0	0	9	0	0
17	29369612	.	A	G	5	5	10	0	0	10	0	0
17	29369713	.	A	C	3	4	7	0	0	7	0	0
17	29369748	.	C	T	6	5	11	0	1	12	0	0
17	29369780	.	C	A	4	2	6	0	1	7	0	0
17	29798098	.	A	G	3	3	6	0	0	6	0	0
17	29798312	.	C	A	0	6	6	0	4	10	0	0
17	29841590	.	A	T	0	2	2	0	0	2	0	0
17	29877094	.	A	G	0	3	3	0	2	5	0	0
17	30411205	.	C	T	2	2	4	0	0	4	0	0
17	30411208	.	A	G	2	3	5	0	0	5	0	0
17	30460216	.	T	C	1	2	3	0	0	3	0	0
17	30460217	.	G	C	1	2	3	0	0	3	0	0
17	30466186	.	G	A	1	0	1	0	0	1	0	0
17	30468428	.	C	T	4	7	11	0	1	12	0	0
17	30469200	.	C	A	4	2	6	0	0	6	0	0
17	30469350	.	A	T	2	3	5	0	0	5	0	0
17	30469364	.	T	C	2	2	4	0	0	4	0	0
17	30474161	.	A	G	3	6	9	0	1	10	0	0
17	30474226	.	A	G	2	3	5	0	0	5	0	0
17	30476939	.	C	A	0	1	1	0	2	3	0	0
17	30476978	.	A	G	3	3	6	0	1	7	0	0
17	30478808	.	A	G	0	1	1	0	0	1	0	0
17	30478897	.	G	A	2	3	5	0	0	5	0	0
17	30478943	.	A	G	1	0	1	0	0	1	0	0
17	30479359	.	T	C	0	2	2	0	0	2	0	0
17	30479647	.	T	C	3	2	5	0	0	5	0	0
17	30487040	.	G	A	2	2	4	0	0	4	0	0
17	30494073	.	T	G	3	5	8	0	0	8	0	0
17	30586485	.	C	T	1	2	3	0	0	3	0	0
17	30589166	.	T	C	1	5	6	0	4	10	0	0
17	30589623	.	T	A	1	3	4	0	1	5	0	0
17	30590020	.	A	G	5	5	10	0	0	10	0	0
17	30590075	.	A	T	11	4	15	0	0	15	0	0
17	30590271	.	G	T	7	15	22	0	0	22	0	0
17	30590273	.	C	G	6	14	20	0	2	22	0	0
17	30590325	.	C	T	6	10	16	0	0	16	0	0
17	30590367	.	G	A	4	6	10	0	0	10	0	0
17	30590838	.	T	C	6	4	10	0	0	10	0	0
17	30590842	.	C	A	6	4	10	0	0	10	0	0
17	30816937	.	T	C	1	3	4	0	0	4	0	0
17	30817119	.	T	A	3	4	7	0	0	7	0	0
17	30817170	.	A	G	2	3	5	0	0	5	0	0
17	30853988	.	T	C	0	3	3	0	0	3	0	0
17	30853989	.	C	T	0	3	3	0	0	3	0	0
17	30855508	.	A	G	1	2	3	0	0	3	0	0
17	30857288	.	A	G	17	6	23	0	2	25	0	0
17	30857431	.	A	T	5	3	8	0	2	10	0	0
17	30857433	.	A	T	5	4	9	0	1	10	0	0
17	30858809	.	C	T	0	14	14	0	12	26	0	0
17	30860630	.	G	T	6	3	9	0	1	10	0	0
17	30862909	.	A	G	9	5	14	0	0	14	0	0
17	30979170	.	T	C	15	13	28	0	3	31	0	0
17	30979208	.	T	C	11	10	21	0	1	23	1	0
17	30979339	.	T	C	11	10	21	0	0	21	0	0
17	30979391	.	T	C	6	0	6	0	18	24	0	0
17	30979518	.	G	A	4	12	16	0	1	17	0	0
17	30980336	.	A	G	8	9	17	0	1	18	0	0
17	30986665	.	T	C	3	4	7	0	0	7	0	0
17	30986712	.	G	T	3	7	10	0	0	10	0	0
17	30995008	.	G	A	2	3	5	0	0	5	0	0
17	31014189	.	G	A	3	6	9	0	0	9	0	0
17	31014192	.	T	C	3	4	7	0	2	9	0	0
17	31199717	.	G	A	0	3	3	0	1	4	0	0
17	31200222	.	T	C	3	2	5	0	0	5	0	0
17	31200247	.	C	A	3	2	5	0	0	5	0	0
17	31200475	.	A	T	4	3	7	0	0	7	0	0
17	31200481	.	C	T	3	4	7	0	0	7	0	0
17	31200621	.	C	T	4	2	6	0	1	7	0	0
17	31201207	.	C	T	6	8	14	0	1	15	0	0
17	31201348	.	A	G	5	0	5	0	10	15	0	0
17	31201523	.	A	T	9	10	19	0	0	19	0	0
17	31201894	.	A	C	6	5	11	0	0	11	0	0
17	31201954	.	A	G	11	10	21	0	2	23	0	0
17	31205360	.	G	A	1	4	5	0	0	5	0	0
17	31205375	.	T	A	1	6	7	0	0	7	0	0
17	31205614	.	G	A	7	3	10	0	0	10	0	0
17	31205727	.	G	A	5	3	8	0	1	9	0	0
17	31214459	.	A	T	4	4	8	0	1	9	0	0
17	31219140	.	C	T	0	2	2	0	1	3	0	0
17	31222505	.	A	T	4	9	13	0	1	14	0	0
17	31228767	.	G	C	18	13	31	0	2	33	0	0
17	31228801	.	C	T	14	11	25	0	1	26	0	0
17	31228837	.	G	A	0	15	15	0	12	27	0	0
17	31228900	.	T	C	7	4	11	0	1	12	0	0
17	31277169	.	A	T	12	6	18	0	1	19	0	0
17	31277443	.	A	G	15	15	30	0	3	33	0	0
17	31277674	.	C	A	7	3	10	0	1	11	0	0
17	31277820	.	C	A	8	11	19	0	0	19	0	0
17	31277855	.	G	A	12	13	25	0	6	31	0	0
17	31277987	.	T	C	12	1	13	0	10	23	0	0
17	31278022	.	G	A	7	7	14	0	0	14	0	0
17	31278433	.	C	A	16	9	25	0	1	26	0	0
17	31283510	.	C	G	0	9	9	0	5	14	0	0
17	31286221	.	G	A	3	4	7	0	1	8	0	0
17	31297284	.	G	A	3	5	8	0	1	9	0	0
17	31297746	.	C	T	0	4	4	0	1	5	0	0
17	31297768	.	G	T	2	2	4	0	1	5	0	0
17	31297791	.	C	T	5	2	7	0	0	7	0	0
17	31298042	.	A	C	2	3	5	0	0	5	0	0
17	31298055	.	T	C	2	2	4	0	0	4	0	0
17	31307882	.	T	C	1	2	3	0	0	3	0	0
17	31346575	.	A	G	1	2	3	0	1	4	0	0
17	31346582	.	T	C	1	7	8	0	0	8	0	0
17	31346653	.	C	T	3	11	14	0	0	14	0	0
17	31346695	.	A	G	3	7	10	0	1	11	0	0
17	31346712	.	G	A	4	5	9	0	3	12	0	0
17	31346840	.	A	G	7	10	17	0	2	19	0	0
17	31347029	.	T	A	18	15	33	0	0	33	0	0
17	31347046	.	T	G	16	14	30	0	2	32	0	0
17	31347193	.	A	C	17	11	28	0	0	28	0	0
17	31347254	.	A	G	10	10	20	0	4	24	0	0
17	31347344	.	C	G	7	8	15	0	0	15	0	0
17	31357531	.	C	T	0	1	1	0	2	3	0	0
17	31360786	.	G	A	1	2	3	0	1	4	0	0
17	31360804	.	C	T	2	3	5	0	0	5	0	0
17	31360854	.	G	A	3	3	6	0	0	6	0	0
17	31393962	.	A	T	2	5	7	0	0	7	0	0
17	31540138	.	C	T	0	2	2	0	0	2	0	0
17	31550907	.	A	G	1	2	3	0	0	3	0	0
17	31588961	.	C	T	0	2	2	0	0	2	0	0
17	31590984	.	G	A	2	3	5	0	0	5	0	0
17	31590986	.	A	G	2	3	5	0	0	5	0	0
17	31606944	.	A	C	2	4	6	0	0	6	0	0
17	31611592	.	C	A	0	2	2	0	0	2	0	0
17	31611895	.	G	C	1	2	3	0	0	3	0	0
17	31611902	.	T	A	1	2	3	0	0	3	0	0
17	31612019	.	A	G	3	4	7	0	0	7	0	0
17	31612027	.	A	G	4	2	6	0	2	8	0	0
17	31616799	.	T	C	3	2	5	0	0	5	0	0
17	31618624	.	C	T	2	0	2	0	0	2	0	0
17	31618636	.	T	C	2	0	2	0	1	3	0	0
17	31618953	.	T	C	13	20	33	0	4	37	0	0
17	31618962	.	A	G	16	15	31	0	5	36	0	0
17	31621894	.	C	T	8	3	11	0	0	11	0	0
17	31621921	.	C	A	4	4	8	0	0	8	0	0
17	31622024	.	C	A	7	8	15	0	3	18	0	0
17	31622083	.	A	C	10	9	19	0	4	23	0	0
17	31622123	.	C	A	7	16	23	0	0	23	0	0
17	31622233	.	T	A	0	2	2	0	0	2	0	0
17	31622367	.	A	G	8	7	15	0	0	15	0	0
17	31622662	.	C	T	6	2	8	0	1	9	0	0
17	31622690	.	A	C	3	2	5	0	0	5	0	0
17	31622715	.	T	C	3	2	5	0	1	6	0	0
17	31623191	.	C	T	1	1	2	0	1	3	0	0
17	31623588	.	A	G	5	10	15	0	1	16	0	0
17	31623635	.	C	T	5	7	12	0	0	12	0	0
17	31623646	.	A	G	7	7	14	0	2	16	0	0
17	31623829	.	G	C	11	9	20	0	3	23	0	0
17	31624119	.	A	T	4	7	11	0	0	11	0	0
17	31624604	.	A	G	10	6	16	0	1	17	0	0
17	31624652	.	C	T	0	9	9	0	9	18	0	0
17	31624682	.	A	G	9	7	16	0	2	18	0	0
17	31624716	.	T	A	6	13	19	0	0	19	0	0
17	31628812	.	C	A	0	5	5	0	2	7	0	0
17	31628953	.	G	T	0	4	4	0	0	4	0	0
17	31632288	.	T	C	3	1	4	0	0	4	0	0
17	31632330	.	A	G	8	4	12	0	1	13	0	0
17	31632751	.	C	T	4	5	9	0	1	10	0	0
17	31633027	.	A	G	3	5	8	0	0	8	0	0
17	31633186	.	C	T	11	11	22	0	0	22	0	0
17	31639721	.	T	C	5	4	9	0	0	9	0	0
17	31668688	.	G	A	4	2	6	0	0	6	0	0
17	31699881	.	G	T	0	1	1	0	0	1	0	0
17	31699931	.	A	G	0	1	1	0	0	1	0	0
17	31700087	.	T	C	0	1	1	0	0	1	0	0
17	31721451	.	G	A	0	3	3	0	2	5	0	0
17	31744553	.	G	A	0	3	3	0	5	8	0	0
17	31746341	.	T	A	8	4	12	0	2	14	0	0
17	31746553	.	T	C	7	9	16	0	0	16	0	0
17	31746833	.	G	A	9	5	14	0	0	14	0	0
17	31796240	.	C	T	8	9	17	0	1	18	0	0
17	31796481	.	T	G	15	6	21	0	1	22	0	0
17	31796576	.	G	A	7	6	13	0	0	13	0	0
17	31796821	.	T	A	6	9	15	0	1	16	0	0
17	31806994	.	T	A	1	5	6	0	0	6	0	0
17	31935226	.	C	T	2	2	4	0	0	4	0	0
17	31935486	.	C	T	2	2	4	0	0	4	0	0
17	32366387	.	A	G	2	4	6	0	1	7	0	0
17	32366543	.	A	G	4	3	7	0	0	7	0	0
17	32367193	.	A	G	1	2	3	0	0	3	0	0
17	32500495	.	G	A	0	4	4	0	3	7	0	0
17	32503110	.	G	A	0	7	7	0	6	13	0	0
17	32516973	.	T	C	17	6	23	0	1	24	0	0
17	32524654	.	C	T	23	22	45	0	4	49	0	0
17	32524717	.	A	G	35	12	47	0	4	51	0	0
17	32524851	.	T	G	29	36	65	0	4	69	0	0
17	32535870	.	C	A	1	1	2	0	0	2	0	0
17	32535929	.	T	C	4	2	6	0	1	7	0	0
17	32535977	.	T	C	3	2	5	0	0	5	0	0
17	32536401	.	C	T	0	0	0	0	1	1	0	0
17	32538638	.	A	G	2	1	3	0	0	3	0	0
17	32549402	.	T	C	1	1	2	0	0	2	0	0
17	32549416	.	G	A	2	1	3	0	0	3	0	0
17	32551164	.	G	T	0	2	2	0	0	2	0	0
17	32551176	.	T	C	0	2	2	0	0	2	0	0
17	32622966	.	C	A	5	2	7	0	2	9	0	0
17	32623004	.	T	G	3	1	4	0	1	5	0	0
17	32623009	.	T	G	3	0	3	0	1	4	0	0
17	32624451	.	C	T	4	0	4	0	0	4	0	0
17	32624460	.	T	C	1	0	1	0	0	1	0	0
17	32624653	.	A	C	3	2	5	0	0	5	0	0
17	32624668	.	A	T	3	4	7	0	0	7	0	0
17	32624707	.	T	C	1	6	7	0	0	7	0	0
17	32624725	.	C	T	0	3	3	0	1	4	0	0
17	32624910	.	T	C	2	5	7	0	0	7	0	0
17	32624916	.	A	T	1	5	6	0	0	6	0	0
17	32627740	.	G	T	4	2	6	0	0	6	0	0
17	32629918	.	G	T	18	9	27	0	1	28	0	0
17	32629930	.	A	T	21	7	28	0	1	29	0	0
17	32631400	.	C	T	5	6	11	0	1	12	0	0
17	32631513	.	A	T	9	7	16	0	0	16	0	0
17	32631533	.	A	G	5	9	14	0	0	14	0	0
17	32631560	.	G	T	2	10	12	0	0	12	0	0
17	32631603	.	C	G	1	1	2	0	0	2	0	0
17	32634254	.	C	T	0	1	1	0	0	1	0	0
17	32636025	.	A	T	3	1	4	0	0	4	0	0
17	33306121	.	A	G	1	7	8	0	0	8	0	0
17	33306767	.	A	G	2	2	4	0	0	4	0	0
17	33307922	.	A	T	5	2	7	0	1	8	0	0
17	35248121	.	T	A	2	12	14	0	0	14	0	0
17	36867336	.	T	C	8	6	14	0	1	15	0	0
17	37294887	.	T	C	3	2	5	0	0	5	0	0
17	37445659	.	G	A	2	2	4	0	0	4	0	0
17	37445790	.	T	C	2	12	14	0	0	14	0	0
17	37445924	.	G	A	9	6	15	0	0	15	0	0
17	37445926	.	A	T	6	9	15	0	0	15	0	0
17	37446208	.	A	T	13	8	21	0	1	22	0	0
17	37446379	.	T	C	2	5	7	0	0	7	0	0
17	37446555	.	T	A	9	5	14	0	0	14	0	0
17	37446563	.	G	A	7	5	12	0	1	13	0	0
17	37446735	.	G	A	7	11	18	0	1	19	0	0
17	37446789	.	A	C	11	2	13	0	4	17	0	0
17	37446790	.	A	C	13	1	14	0	3	17	0	0
17	37449200	.	G	C	1	3	4	0	0	4	0	0
17	37450180	.	T	G	0	2	2	0	0	2	0	0
17	37585002	.	A	G	0	3	3	0	0	3	0	0
17	37603748	.	G	A	0	1	1	0	6	7	0	0
17	37605870	.	A	G	1	0	1	0	3	4	0	0
17	37606011	.	G	A	1	3	4	0	6	10	0	0
17	37606101	.	G	A	0	6	6	0	6	12	0	0
17	37606116	.	G	A	5	2	7	0	2	9	0	0
17	37618028	.	C	G	1	2	3	0	0	3	0	0
17	37618070	.	T	C	3	4	7	0	3	10	0	0
17	37618083	.	T	G	3	6	9	0	2	11	0	0
17	37618143	.	T	C	7	5	12	0	4	16	0	0
17	37618157	.	A	C	9	6	15	0	1	16	0	0
17	37618485	.	C	T	9	9	18	0	4	22	0	0
17	37624913	.	A	T	3	9	12	0	0	12	0	0
17	37648766	.	C	T	6	3	9	0	0	9	0	0
17	37792745	.	A	G	3	4	7	0	0	7	0	0
17	38022200	.	T	C	1	3	4	0	0	4	0	0
17	38022207	.	C	T	1	3	4	0	0	4	0	0
17	38232211	.	A	T	3	2	5	0	0	5	0	0
17	38232237	.	T	C	2	3	5	0	0	5	0	0
17	38263912	.	G	C	0	4	4	0	2	6	0	0
17	38264044	.	G	T	6	8	14	0	0	14	0	0
17	38295925	.	C	A	3	3	6	0	0	6	0	0
17	38295927	.	T	A	3	3	6	0	0	6	0	0
17	38295991	.	C	T	2	2	4	0	1	5	0	0
17	38296642	.	G	A	2	3	5	0	0	5	0	0
17	38296644	.	T	G	3	2	5	0	0	5	0	0
17	38303423	.	C	T	5	6	11	0	2	13	0	0
17	38303607	.	A	G	2	3	5	0	0	5	0	0
17	38303652	.	G	A	0	3	3	0	2	5	0	0
17	38471137	.	C	T	1	2	3	0	0	3	0	0
17	38472752	.	G	A	0	0	0	0	1	1	0	0
17	38472866	.	A	G	1	0	1	0	0	1	0	0
17	38472894	.	C	A	1	0	1	0	0	1	0	0
17	38545563	.	C	A	1	2	3	0	0	3	0	0
17	38713696	.	A	G	1	0	1	0	0	1	0	0
17	38713709	.	C	T	0	2	2	0	0	2	0	0
17	38714216	.	A	C	1	2	3	0	0	3	0	0
17	38714811	.	T	C	3	3	6	0	1	7	0	0
17	38740605	.	C	T	0	2	2	0	1	3	0	0
17	38740626	.	G	A	2	2	4	0	0	4	0	0
17	38740684	.	T	C	9	7	16	0	0	16	0	0
17	38740698	.	A	T	10	6	16	0	0	16	0	0
17	38751711	.	T	A	0	0	0	0	1	1	0	0
17	38755038	.	A	G	3	6	9	0	1	10	0	0
17	38755077	.	A	G	1	0	1	0	0	1	0	0
17	38756777	.	T	G	6	6	12	0	1	13	0	0
17	38758682	.	G	A	3	2	5	0	0	5	0	0
17	38760619	.	G	A	0	1	1	0	0	1	0	0
17	38768370	.	G	T	1	1	2	0	0	2	0	0
17	38769924	.	T	A	3	0	3	0	0	3	0	0
17	38769935	.	T	C	3	0	3	0	0	3	0	0
17	38769975	.	G	A	2	0	2	0	0	2	0	0
17	38784477	.	T	C	13	5	18	0	1	19	0	0
17	38784642	.	T	C	3	5	8	0	0	8	0	0
17	38787327	.	G	A	1	2	3	0	0	3	0	0
17	38928073	.	A	T	3	5	8	0	1	9	0	0
17	38929142	.	T	G	2	3	5	0	0	5	0	0
17	39717616	.	T	C	1	1	2	0	0	2	0	0
17	39720791	.	T	C	3	2	5	0	0	5	0	0
17	39728239	.	C	T	4	3	7	0	1	8	0	0
17	39728261	.	G	T	5	5	10	0	1	11	0	0
17	39728423	.	T	A	0	2	2	0	0	2	0	0
17	39729014	.	G	A	6	5	11	0	2	13	0	0
17	39732512	.	C	T	6	5	11	0	0	11	0	0
17	39732573	.	C	A	7	5	12	0	2	14	0	0
17	39732584	.	G	A	6	8	14	0	1	15	0	0
17	39736088	.	T	A	3	4	7	0	1	8	0	0
17	39736103	.	G	A	4	4	8	0	0	8	0	0
17	39736130	.	T	C	6	6	12	0	0	12	0	0
17	39739842	.	A	T	6	3	9	0	0	9	0	0
17	39862536	.	C	G	2	4	6	0	0	6	0	0
17	39863633	.	C	T	1	0	1	0	0	1	0	0
17	40860266	.	C	T	2	3	5	0	0	5	0	0
17	40899489	.	A	C	1	4	5	0	0	5	0	0
17	40900686	.	T	G	4	4	8	0	0	8	0	0
17	40901439	.	T	C	2	4	6	0	0	6	0	0
17	40901695	.	G	C	2	8	10	0	0	10	0	0
17	40901712	.	C	G	2	9	11	0	0	11	0	0
17	40901752	.	G	A	4	6	10	0	0	10	0	0
17	40901799	.	A	C	2	3	5	0	0	5	0	0
17	40901804	.	A	T	2	2	4	0	0	4	0	0
17	40902005	.	C	A	3	7	10	0	5	15	0	0
17	40902148	.	G	T	3	6	9	0	1	10	0	0
17	40902180	.	G	C	4	5	9	0	0	9	0	0
17	40902314	.	A	G	6	0	6	0	4	10	0	0
17	40902368	.	T	G	6	6	12	0	1	13	0	0
17	40902598	.	G	A	11	7	18	0	0	18	0	0
17	40902629	.	A	T	9	12	21	0	1	23	1	0
17	40902657	.	A	C	11	10	21	0	0	21	0	0
17	40902830	.	A	T	6	10	16	0	1	17	0	0
17	40903162	.	C	T	9	5	14	0	2	16	0	0
17	40990061	.	T	A	8	12	20	0	0	20	0	0
17	40990097	.	T	A	3	2	5	0	0	5	0	0
17	40999460	.	A	G	12	16	28	0	1	29	0	0
17	40999697	.	C	G	12	8	20	0	1	21	0	0
17	40999700	.	C	A	13	8	21	0	0	21	0	0
17	40999732	.	A	G	6	9	15	0	0	15	0	0
17	41084670	.	T	C	1	5	6	0	0	6	0	0
17	41254741	.	C	T	1	1	2	0	1	3	0	0
17	41264165	.	C	A	8	6	14	0	0	14	0	0
17	41314040	.	G	T	0	2	2	0	1	3	0	0
17	41314097	.	T	C	3	4	7	0	1	8	0	0
17	41314309	.	T	A	2	1	3	0	0	3	0	0
17	41314471	.	G	A	9	4	13	0	0	13	0	0
17	41314501	.	A	G	2	3	5	0	0	5	0	0
17	41317494	.	G	A	5	14	19	0	2	21	0	0
17	41317999	.	G	A	10	15	25	0	1	26	0	0
17	41318310	.	A	G	12	13	25	0	0	25	0	0
17	41318392	.	G	A	2	2	4	0	0	4	0	0
17	41465504	.	A	C	5	10	15	0	0	15	0	0
17	41465709	.	G	A	0	3	3	0	8	12	1	0
17	41465922	.	G	A	5	4	9	0	0	9	0	0
17	41475863	.	T	C	15	16	31	0	0	31	0	0
17	41476161	.	A	G	18	18	36	0	0	36	0	0
17	41476279	.	G	A	14	24	38	0	1	39	0	0
17	41476298	.	T	A	12	17	29	0	5	34	0	0
17	41476393	.	G	T	13	4	17	0	3	20	0	0
17	41476906	.	A	C	4	0	4	0	7	11	0	0
17	41476917	.	C	T	0	7	7	0	5	12	0	0
17	41476970	.	T	C	3	8	11	0	0	11	0	0
17	41476994	.	G	A	2	7	9	0	0	9	0	0
17	41477007	.	C	T	0	7	7	0	2	9	0	0
17	41477157	.	T	C	3	4	7	0	1	8	0	0
17	41477324	.	G	A	8	6	14	0	1	15	0	0
17	41558269	.	G	C	0	0	0	0	1	1	0	0
17	41571328	.	T	A	2	2	4	0	1	5	0	0
17	41583555	.	C	G	0	4	4	0	3	7	0	0
17	41583747	.	G	T	4	3	7	0	1	8	0	0
17	41667069	.	G	A	1	2	3	0	1	4	0	0
17	41667109	.	C	T	0	2	2	0	1	3	0	0
17	42027915	.	C	T	2	3	5	0	0	5	0	0
17	42095602	.	A	G	1	4	5	0	1	6	0	0
17	42095620	.	C	T	1	5	6	0	0	6	0	0
17	42096960	.	C	G	0	2	2	0	2	4	0	0
17	42566169	.	C	T	0	1	1	0	1	2	0	0
17	42566189	.	T	G	1	2	3	0	0	3	0	0
17	42611579	.	C	A	1	2	3	0	0	3	0	0
17	42611581	.	C	T	1	2	3	0	0	3	0	0
17	42871419	.	G	T	7	4	11	0	1	12	0	0
17	43013675	.	G	A	3	5	8	0	1	9	0	0
17	43017672	.	C	T	8	14	22	0	0	22	0	0
17	43017687	.	G	A	10	13	23	0	0	23	0	0
17	43017830	.	A	G	9	6	15	0	0	15	0	0
17	43017863	.	A	C	15	6	21	0	3	24	0	0
17	43018037	.	G	A	0	10	10	0	20	30	0	0
17	43018124	.	A	G	27	0	27	0	3	30	0	0
17	43018273	.	G	A	13	24	37	0	1	38	0	0
17	43018382	.	T	G	11	15	26	0	3	29	0	0
17	43018502	.	T	A	24	20	44	0	1	45	0	0
17	43018549	.	C	G	17	13	30	0	1	31	0	0
17	43018638	.	A	T	23	8	31	0	1	32	0	0
17	43018815	.	A	G	21	12	33	0	7	40	0	0
17	43018899	.	T	A	13	23	36	0	0	36	0	0
17	43030737	.	T	G	2	13	15	0	0	15	0	0
17	43030828	.	G	A	5	3	8	0	2	10	0	0
17	43031495	.	G	A	4	0	4	0	1	5	0	0
17	43033177	.	G	A	6	9	15	0	3	18	0	0
17	43035798	.	T	C	17	17	34	0	5	39	0	0
17	43035958	.	A	G	14	7	21	0	1	22	0	0
17	43035996	.	G	T	8	15	23	0	1	24	0	0
17	43036025	.	A	G	11	9	20	0	1	21	0	0
17	43036055	.	T	C	8	8	16	0	1	17	0	0
17	43036075	.	T	G	11	6	17	0	0	17	0	0
17	43036109	.	A	G	10	5	15	0	0	15	0	0
17	43039706	.	A	G	4	6	10	0	1	11	0	0
17	43082871	.	G	A	0	1	1	0	0	1	0	0
17	43082976	.	A	T	2	6	8	0	1	9	0	0
17	43087252	.	A	T	1	3	4	0	0	4	0	0
17	43146487	.	G	A	1	2	3	0	0	3	0	0
17	43297946	.	G	C	7	6	13	0	1	14	0	0
17	43298011	.	G	A	6	9	15	0	0	15	0	0
17	43298068	.	G	A	12	5	17	0	0	17	0	0
17	43302492	.	G	A	5	4	9	0	0	9	0	0
17	43309095	.	A	G	2	5	7	0	0	7	0	0
17	43309164	.	C	T	0	3	3	0	2	5	0	0
17	43315085	.	C	T	2	0	2	0	0	2	0	0
17	43348986	.	T	C	0	3	3	0	0	3	0	0
17	43437305	.	G	C	9	8	17	0	1	18	0	0
17	43437365	.	C	G	3	3	6	0	0	6	0	0
17	43439720	.	G	T	8	8	16	0	8	24	0	0
17	43441575	.	A	T	2	1	3	0	0	3	0	0
17	43453507	.	T	C	5	3	8	0	1	9	0	0
17	43453531	.	G	A	6	7	13	0	1	14	0	0
17	43456825	.	C	T	5	8	13	0	0	13	0	0
17	43456900	.	G	A	5	3	8	0	0	8	0	0
17	43456921	.	T	C	2	5	7	0	0	7	0	0
17	43461181	.	G	A	0	1	1	0	0	1	0	0
17	43469377	.	G	A	0	1	1	0	0	1	0	0
17	43473913	.	T	C	3	5	8	0	0	8	0	0
17	43475577	.	G	A	0	9	9	0	6	15	0	0
17	43475619	.	A	G	3	0	3	0	11	14	0	0
17	43476046	.	C	T	9	4	13	0	2	15	0	0
17	43476137	.	T	A	6	10	16	0	0	16	0	0
17	43513109	.	G	A	11	5	16	0	0	16	0	0
17	43516464	.	T	A	3	2	5	0	0	5	0	0
17	43516502	.	G	T	4	5	9	0	1	10	0	0
17	43516506	.	A	C	4	5	9	0	0	9	0	0
17	43516548	.	A	G	3	6	9	0	1	10	0	0
17	43520103	.	G	A	1	3	4	0	0	4	0	0
17	43520136	.	G	A	2	2	4	0	0	4	0	0
17	43537865	.	C	T	3	2	5	0	0	5	0	0
17	43538018	.	A	C	2	4	6	0	0	6	0	0
17	43538035	.	C	T	0	5	5	0	2	7	0	0
17	43538081	.	G	A	2	3	5	0	0	5	0	0
17	43538097	.	C	T	2	2	4	0	0	4	0	0
17	43538131	.	G	A	1	3	4	0	1	5	0	0
17	43538209	.	C	T	4	2	6	0	0	6	0	0
17	43551835	.	A	G	1	2	3	0	0	3	0	0
17	43551841	.	G	C	1	3	4	0	0	4	0	0
17	43565680	.	A	T	9	5	14	0	0	14	0	0
17	43565697	.	C	A	7	7	14	0	0	14	0	0
17	43611873	.	C	T	2	2	4	0	0	4	0	0
17	43660232	.	G	A	6	7	13	0	0	13	0	0
17	43660779	.	T	C	12	8	20	0	1	21	0	0
17	43661106	.	T	G	4	6	10	0	1	11	0	0
17	43663611	.	T	G	5	10	15	0	1	16	0	0
17	43663789	.	A	C	14	18	32	0	3	35	0	0
17	43663870	.	G	A	18	19	37	0	1	38	0	0
17	43664128	.	G	C	18	16	34	0	1	36	1	0
17	43664580	.	A	G	3	10	13	0	2	15	0	0
17	43664605	.	G	A	4	11	15	0	0	15	0	0
17	43708546	.	C	T	8	4	12	0	1	13	0	0
17	43708563	.	A	G	6	3	9	0	1	11	1	0
17	43708608	.	C	T	9	2	11	0	2	13	0	0
17	43708649	.	T	C	4	6	10	0	0	10	0	0
17	43715607	.	C	T	4	2	6	0	0	6	0	0
17	43715851	.	T	C	5	3	8	0	0	8	0	0
17	43716633	.	C	T	3	2	5	0	1	6	0	0
17	43851013	.	A	G	14	14	28	0	1	29	0	0
17	43853538	.	G	A	0	1	1	0	0	1	0	0
17	43853767	.	A	G	8	3	11	0	0	11	0	0
17	43853778	.	C	T	0	7	7	0	2	9	0	0
17	43854007	.	G	A	5	8	13	0	1	14	0	0
17	43854010	.	T	G	8	5	13	0	0	13	0	0
17	43856232	.	T	C	0	1	1	0	0	1	0	0
17	43859282	.	T	C	1	1	2	0	1	3	0	0
17	43863609	.	A	C	3	10	13	0	1	14	0	0
17	43946901	.	C	T	2	6	8	0	0	8	0	0
17	43987048	.	A	G	8	0	8	0	0	8	0	0
17	43996483	.	G	A	3	2	5	0	0	5	0	0
17	43996485	.	G	A	3	2	5	0	0	5	0	0
17	43996620	.	A	T	0	1	1	0	1	2	0	0
17	43996667	.	G	A	2	5	7	0	0	7	0	0
17	44001540	.	A	G	18	14	32	0	0	32	0	0
17	44001584	.	T	C	17	15	32	0	2	34	0	0
17	44002032	.	A	T	9	9	18	0	2	20	0	0
17	44007240	.	T	A	1	2	3	0	0	3	0	0
17	44007252	.	A	T	1	2	3	0	0	3	0	0
17	45107401	.	C	T	3	2	5	0	0	5	0	0
17	45138591	.	T	C	6	3	9	0	2	11	0	0
17	45138733	.	T	C	5	8	13	0	1	14	0	0
17	45138741	.	T	C	7	7	14	0	1	15	0	0
17	45138796	.	T	C	17	7	24	0	1	25	0	0
17	45139429	.	T	C	13	7	20	0	2	22	0	0
17	45402422	.	A	G	2	3	5	0	0	5	0	0
17	45402602	.	A	T	3	4	7	0	3	10	0	0
17	45402640	.	C	A	2	7	9	0	0	9	0	0
17	45455329	.	C	T	0	2	2	0	1	3	0	0
17	45482087	.	T	C	0	2	2	0	0	2	0	0
17	45482121	.	T	C	2	3	5	0	0	5	0	0
17	45482181	.	C	A	5	2	7	0	0	7	0	0
17	45482313	.	A	T	1	6	7	0	0	7	0	0
17	45502485	.	C	T	0	2	2	0	1	3	0	0
17	45731991	.	T	C	8	4	12	0	0	12	0	0
17	45732147	.	T	C	15	11	26	0	0	26	0	0
17	45732173	.	C	T	0	9	9	0	16	25	0	0
17	45732327	.	G	A	13	6	19	0	1	20	0	0
17	45732589	.	A	G	3	5	8	0	3	11	0	0
17	45733632	.	T	G	2	4	6	0	0	6	0	0
17	45733752	.	G	A	2	2	4	0	4	8	0	0
17	45748674	.	A	G	2	1	3	0	0	3	0	0
17	45750485	.	C	T	0	3	3	0	0	3	0	0
17	45751404	.	T	C	0	2	2	0	0	2	0	0
17	45756610	.	T	C	2	1	3	0	1	4	0	0
17	45756652	.	T	C	2	0	2	0	0	2	0	0
17	45762487	.	G	A	4	5	9	0	0	9	0	0
17	45765234	.	G	A	1	1	2	0	0	2	0	0
17	45766167	.	A	G	0	0	0	0	1	1	0	0
17	45774378	.	G	A	0	5	5	0	4	9	0	0
17	45774425	.	C	A	1	6	7	0	0	7	0	0
17	45983347	.	C	A	1	3	4	0	0	4	0	0
17	45983392	.	G	A	1	2	3	0	0	3	0	0
17	45983410	.	C	T	1	2	3	0	0	3	0	0
17	45984415	.	A	G	1	0	1	0	6	7	0	0
17	45984465	.	G	T	1	3	4	0	1	5	0	0
17	45987120	.	C	T	2	6	8	0	1	9	0	0
17	45987143	.	A	T	2	2	4	0	1	5	0	0
17	45988361	.	A	T	3	3	6	0	0	6	0	0
17	45988742	.	T	C	3	4	7	0	0	7	0	0
17	45988864	.	C	T	5	3	8	0	1	9	0	0
17	45988991	.	G	C	1	2	3	0	1	4	0	0
17	46439186	.	A	G	2	1	3	0	0	3	0	0
17	46457321	.	G	C	3	5	8	0	0	8	0	0
17	46457326	.	C	A	0	5	5	0	4	9	0	0
17	47164707	.	T	C	1	1	2	0	0	2	0	0
17	47164815	.	G	A	0	0	0	0	1	1	0	0
17	47189003	.	A	G	6	11	17	0	0	17	0	0
17	47189025	.	C	A	8	6	14	0	1	15	0	0
17	47189283	.	A	T	5	6	11	0	2	13	0	0
17	47189725	.	G	A	5	13	18	0	1	19	0	0
17	47189765	.	G	T	1	6	7	0	1	8	0	0
17	47189790	.	A	G	3	3	6	0	0	6	0	0
17	47189810	.	C	T	0	2	2	0	7	9	0	0
17	47189919	.	G	T	9	11	20	0	0	20	0	0
17	47190032	.	C	T	7	8	15	0	0	15	0	0
17	47190045	.	C	A	0	7	7	0	8	15	0	0
17	47190149	.	G	C	5	3	8	0	0	8	0	0
17	47190264	.	C	T	0	4	4	0	8	12	0	0
17	47190492	.	G	A	3	4	7	0	0	7	0	0
17	47190904	.	G	A	2	3	5	0	0	5	0	0
17	47190941	.	G	T	5	4	9	0	0	9	0	0
17	47190967	.	T	G	7	4	11	0	0	11	0	0
17	47191068	.	C	T	3	2	5	0	1	6	0	0
17	47191229	.	G	A	2	2	4	0	0	4	0	0
17	47191248	.	G	A	1	2	3	0	0	3	0	0
17	47191286	.	A	T	5	2	7	0	0	7	0	0
17	47191298	.	A	T	4	2	6	0	0	6	0	0
17	47191325	.	T	C	3	2	5	0	0	5	0	0
17	47191842	.	T	C	1	3	4	0	0	4	0	0
17	47192766	.	C	T	2	2	4	0	0	4	0	0
17	47192872	.	A	G	3	3	6	0	0	6	0	0
17	47193651	.	A	G	2	2	4	0	0	4	0	0
17	48138510	.	T	A	0	1	1	0	0	1	0	0
17	48908911	.	A	G	0	1	1	0	0	1	0	0
17	48911097	.	T	G	2	7	9	0	0	9	0	0
17	48911441	.	G	A	3	7	10	0	0	10	0	0
17	48911442	.	T	A	3	7	10	0	0	10	0	0
17	48915387	.	A	T	1	0	1	0	0	1	0	0
17	49010727	.	T	C	1	3	4	0	0	4	0	0
17	49011174	.	A	G	2	4	6	0	1	7	0	0
17	49011177	.	C	A	3	3	6	0	1	7	0	0
17	49016534	.	C	T	1	5	6	0	0	6	0	0
17	49016858	.	C	T	0	1	1	0	0	1	0	0
17	49018224	.	G	A	0	3	3	0	8	11	0	0
17	49018508	.	C	G	9	8	17	0	1	18	0	0
17	49018575	.	G	A	3	6	9	0	0	9	0	0
17	49019177	.	C	A	11	18	29	0	1	30	0	0
17	49113961	.	C	T	1	2	3	0	0	3	0	0
17	49306256	.	C	T	9	6	15	0	1	16	0	0
17	49354722	.	G	A	1	2	3	0	0	3	0	0
17	49416044	.	T	G	6	6	12	0	0	12	0	0
17	49416327	.	T	C	11	4	15	0	1	16	0	0
17	49417137	.	C	T	6	8	14	0	2	16	0	0
17	49417148	.	A	T	5	8	13	0	1	15	1	0
17	49417414	.	T	A	4	4	8	0	0	8	0	0
17	49417569	.	T	C	9	4	13	0	0	13	0	0
17	49417599	.	G	C	8	3	11	0	2	13	0	0
17	49417835	.	G	A	4	6	10	0	0	10	0	0
17	49417838	.	A	G	4	7	11	0	0	11	0	0
17	49417961	.	A	C	6	3	9	0	0	9	0	0
17	49417974	.	C	A	4	3	7	0	0	7	0	0
17	49418940	.	T	A	1	5	6	0	0	6	0	0
17	49419761	.	G	T	1	5	6	0	0	6	0	0
17	49421117	.	A	G	2	1	3	0	1	4	0	0
17	49983202	.	A	T	6	10	16	0	1	17	0	0
17	49983273	.	C	T	15	27	42	0	1	43	0	0
17	49983315	.	C	T	20	17	37	0	0	37	0	0
17	49992629	.	G	A	12	4	16	0	2	18	0	0
17	49998171	.	T	C	8	11	19	0	0	19	0	0
17	49998221	.	G	A	12	8	20	0	0	20	0	0
17	49998658	.	G	A	2	2	4	0	1	5	0	0
17	49998734	.	G	A	11	18	29	0	1	30	0	0
17	49998804	.	C	A	15	20	35	0	1	36	0	0
17	49999037	.	G	T	18	10	28	0	1	29	0	0
17	50002381	.	A	G	19	14	33	0	1	34	0	0
17	50007340	.	G	A	1	6	7	0	0	7	0	0
17	50009829	.	T	C	6	0	6	0	6	12	0	0
17	50009832	.	T	A	5	6	11	0	1	12	0	0
17	50010078	.	T	C	8	6	14	0	0	14	0	0
17	50010087	.	C	A	1	5	6	0	8	14	0	0
17	50107391	.	G	A	2	1	3	0	0	3	0	0
17	50107394	.	C	A	0	1	1	0	0	1	0	0
17	50110391	.	G	T	2	2	4	0	1	5	0	0
17	50110461	.	G	A	2	9	11	0	1	12	0	0
17	50111106	.	A	C	1	2	3	0	0	3	0	0
17	50111397	.	A	G	1	5	6	0	1	7	0	0
17	50111406	.	G	A	6	2	8	0	0	8	0	0
17	50111680	.	A	T	2	2	4	0	0	4	0	0
17	50111718	.	T	G	2	3	5	0	0	5	0	0
17	50113141	.	G	A	8	8	16	0	1	17	0	0
17	50113148	.	C	T	5	8	13	0	3	16	0	0
17	50113196	.	G	A	0	7	7	0	6	13	0	0
17	50113336	.	C	T	4	6	10	0	1	11	0	0
17	50113404	.	C	T	5	5	10	0	0	10	0	0
17	50141766	.	T	A	1	4	5	0	0	5	0	0
17	50141904	.	A	T	1	1	2	0	0	2	0	0
17	50172581	.	T	G	0	2	2	0	0	2	0	0
17	50176483	.	G	A	2	2	4	0	0	4	0	0
17	50176519	.	C	A	2	1	3	0	0	3	0	0
17	50180672	.	C	T	2	4	6	0	0	6	0	0
17	50185665	.	T	A	7	8	15	0	0	15	0	0
17	50185841	.	A	T	12	5	17	0	0	17	0	0
17	50185930	.	T	C	8	9	17	0	0	17	0	0
17	50185964	.	G	A	0	9	9	0	9	18	0	0
17	50186011	.	G	A	0	6	6	0	11	17	0	0
17	50186097	.	G	A	6	4	10	0	0	10	0	0
17	50186241	.	T	A	2	3	5	0	0	5	0	0
17	50186243	.	A	C	1	3	4	0	0	5	1	0
17	50186291	.	G	T	7	2	9	0	2	11	0	0
17	50229135	.	A	C	4	5	9	0	0	9	0	0
17	50229301	.	G	T	8	3	11	0	1	12	0	0
17	50229718	.	A	G	2	1	3	0	0	3	0	0
17	50245400	.	G	A	4	6	10	0	1	11	0	0
17	50245580	.	G	A	10	16	26	0	1	27	0	0
17	50245673	.	T	C	16	17	33	0	4	37	0	0
17	50245715	.	C	G	15	21	36	0	2	38	0	0
17	50245772	.	C	T	10	2	12	0	1	13	0	0
17	50247886	.	T	C	0	0	0	0	1	1	0	0
17	50247988	.	A	T	13	3	16	0	0	16	0	0
17	50272729	.	G	A	1	1	2	0	0	2	0	0
17	50278808	.	C	T	9	4	13	0	3	16	0	0
17	50284899	.	T	A	15	13	28	0	1	29	0	0
17	50285009	.	A	T	4	6	10	0	0	10	0	0
17	50285052	.	C	T	1	4	5	0	1	6	0	0
17	50285221	.	A	T	3	5	8	0	0	8	0	0
17	50285399	.	A	C	0	12	12	0	0	12	0	0
17	50285400	.	A	C	12	0	12	0	0	12	0	0
17	50415805	.	C	A	5	5	10	0	0	10	0	0
17	50415806	.	G	A	5	5	10	0	0	10	0	0
17	50415844	.	C	T	5	9	14	0	0	14	0	0
17	50415858	.	A	G	7	4	11	0	1	12	0	0
17	50415948	.	G	A	3	1	4	0	0	4	0	0
17	50416079	.	T	C	2	3	5	0	1	6	0	0
17	50416332	.	A	G	3	2	5	0	0	5	0	0
17	50416392	.	T	C	4	1	5	0	0	5	0	0
17	50416414	.	T	A	6	1	7	0	0	7	0	0
17	50416456	.	C	T	3	4	7	0	0	7	0	0
17	50416525	.	A	G	2	3	5	0	0	5	0	0
17	50416593	.	T	C	0	2	2	0	1	3	0	0
17	50416916	.	T	C	1	0	1	0	4	5	0	0
17	50424455	.	T	C	1	0	1	0	5	6	0	0
17	50424555	.	A	T	5	5	10	0	1	11	0	0
17	50424556	.	A	T	5	6	11	0	0	11	0	0
17	50424596	.	A	T	5	6	11	0	0	11	0	0
17	50424662	.	A	G	4	14	18	0	0	18	0	0
17	50424663	.	A	G	4	14	18	0	0	18	0	0
17	50424697	.	A	G	7	10	17	0	0	17	0	0
17	50424961	.	T	A	1	4	5	0	0	5	0	0
17	50425042	.	C	G	0	7	7	0	0	7	0	0
17	50425083	.	A	G	2	3	5	0	0	5	0	0
17	50425171	.	A	T	2	5	7	0	1	8	0	0
17	50425321	.	C	T	4	4	8	0	1	9	0	0
17	50425478	.	C	T	3	0	3	0	0	3	0	0
17	50425488	.	A	G	3	0	3	0	0	3	0	0
17	50425854	.	C	T	0	5	5	0	1	6	0	0
17	50425858	.	T	A	1	5	6	0	0	6	0	0
17	50425899	.	A	G	1	2	3	0	0	3	0	0
17	50425954	.	C	T	2	3	5	0	0	5	0	0
17	50425992	.	A	T	1	4	5	0	0	5	0	0
17	50426092	.	C	T	3	3	6	1	0	7	0	0
17	50426194	.	C	A	3	4	7	0	0	7	0	0
17	50426303	.	A	G	2	5	7	0	1	8	0	0
17	50450315	.	C	G	0	2	2	0	0	2	0	0
17	50657829	.	T	C	3	4	7	0	0	7	0	0
17	50688480	.	T	C	3	6	9	0	0	9	0	0
17	50689755	.	G	A	1	4	5	1	3	9	0	0
17	50689787	.	T	A	1	3	4	0	0	4	0	0
17	50690868	.	T	A	4	2	6	0	0	6	0	0
17	50690874	.	T	G	2	4	6	0	0	6	0	0
17	50976567	.	C	T	7	6	13	0	2	15	0	0
17	51020214	.	A	G	7	7	14	0	2	16	0	0
17	51206851	.	T	C	12	16	28	0	1	29	0	0
17	51231980	.	T	C	7	8	15	0	0	15	0	0
17	51232547	.	T	C	4	5	9	0	1	10	0	0
17	51720543	.	A	G	3	2	5	0	0	5	0	0
17	51823617	.	G	T	15	5	20	0	0	20	0	0
17	51823989	.	G	T	6	2	8	0	1	9	0	0
17	51824046	.	C	T	14	3	17	0	1	18	0	0
17	52528662	.	G	C	1	0	1	0	0	1	0	0
17	52533036	.	C	G	7	4	11	0	1	12	0	0
17	52533073	.	C	T	3	1	4	0	3	7	0	0
17	52534241	.	G	A	0	8	8	0	9	17	0	0
17	52534343	.	G	A	11	1	12	0	4	16	0	0
17	52541342	.	G	A	0	12	12	0	11	23	0	0
17	52553107	.	C	A	20	18	38	0	2	40	0	0
17	52553141	.	T	C	15	20	35	0	3	38	0	0
17	52553270	.	G	A	18	21	39	0	3	42	0	0
17	52566100	.	C	T	0	2	2	0	1	3	0	0
17	52578489	.	A	G	0	1	1	0	0	1	0	0
17	52578491	.	A	G	0	1	1	0	0	1	0	0
17	52624926	.	T	G	2	6	8	0	0	8	0	0
17	52630641	.	A	G	3	11	14	0	0	14	0	0
17	52630752	.	A	C	1	0	1	0	9	10	0	0
17	52630796	.	G	A	4	2	6	0	0	6	0	0
17	52630907	.	A	T	3	4	7	0	0	7	0	0
17	52632139	.	A	G	6	9	15	0	1	16	0	0
17	52632151	.	G	C	6	7	13	0	2	15	0	0
17	52635258	.	A	G	0	7	7	0	1	8	0	0
17	52635261	.	C	T	0	5	5	0	2	7	0	0
17	52636829	.	C	T	6	4	10	0	0	10	0	0
17	52636831	.	C	G	6	4	10	0	0	10	0	0
17	52639729	.	C	T	1	11	12	0	15	27	0	0
17	52640311	.	G	A	20	22	42	0	0	42	0	0
17	52640385	.	G	C	17	17	34	0	3	37	0	0
17	52640419	.	C	T	0	16	16	0	19	35	0	0
17	52640540	.	C	T	0	22	22	0	8	30	0	0
17	52640645	.	T	G	7	16	23	0	0	23	0	0
17	52641091	.	A	T	13	6	19	0	1	20	0	0
17	52641571	.	C	T	8	10	18	0	1	19	0	0
17	52641724	.	A	C	12	9	21	0	2	23	0	0
17	52650878	.	G	C	0	1	1	0	0	1	0	0
17	52856614	.	T	C	10	11	21	0	1	22	0	0
17	52920792	.	C	T	25	27	52	1	7	60	0	0
17	52921053	.	C	G	1	1	2	0	12	14	0	0
17	52940710	.	T	C	4	2	6	0	3	9	0	0
17	52940880	.	T	C	5	2	7	0	0	7	0	0
17	52940884	.	T	C	2	4	6	0	0	6	0	0
17	53250861	.	C	T	4	2	6	0	0	6	0	0
17	53250909	.	G	A	0	1	1	0	3	4	0	0
17	53298472	.	A	G	1	1	2	0	3	5	0	0
17	53298514	.	C	G	4	2	6	0	0	6	0	0
17	53299346	.	G	T	3	2	5	0	0	5	0	0
17	53301281	.	C	T	0	1	1	0	0	1	0	0
17	53302527	.	T	C	3	0	3	0	0	3	0	0
17	53303258	.	G	A	0	4	4	0	7	11	0	0
17	53303980	.	G	C	10	14	24	0	2	26	0	0
17	53304566	.	G	A	5	6	11	0	0	11	0	0
17	53304635	.	A	T	7	4	11	0	0	11	0	0
17	53305318	.	G	C	1	7	8	0	1	9	0	0
17	53305327	.	C	T	0	5	5	0	0	5	0	0
17	53307580	.	C	G	12	6	18	0	0	19	1	0
17	53308737	.	T	C	5	6	11	0	2	13	0	0
17	53308820	.	C	T	0	3	3	0	5	8	0	0
17	53315422	.	C	T	2	3	5	0	0	5	0	0
17	53315604	.	G	A	5	5	10	0	0	10	0	0
17	53317065	.	C	T	1	2	3	0	0	3	0	0
17	53317123	.	T	C	4	9	13	0	0	13	0	0
17	53317175	.	G	A	0	3	3	0	3	6	0	0
17	53317663	.	T	C	4	5	9	0	3	12	0	0
17	53317664	.	C	A	5	7	12	0	0	12	0	0
17	53317844	.	G	A	0	3	3	0	6	9	0	0
17	53346600	.	G	A	2	2	4	0	0	4	0	0
17	53346648	.	C	A	3	2	5	0	0	5	0	0
17	53348412	.	G	A	1	1	2	0	0	2	0	0
17	53364109	.	T	C	3	6	9	0	0	9	0	0
17	53364111	.	T	C	2	6	8	0	1	9	0	0
17	53390540	.	A	G	2	2	4	0	1	5	0	0
17	53390561	.	A	G	2	0	2	0	3	5	0	0
17	53393165	.	G	A	15	16	31	0	0	31	0	0
18	298740	.	C	T	0	2	2	0	0	2	0	0
18	302902	.	C	T	5	7	12	0	0	12	0	0
18	303136	.	G	T	0	0	0	0	1	1	0	0
18	316039	.	C	T	7	4	11	0	0	11	0	0
18	318821	.	T	C	10	7	17	0	0	17	0	0
18	318824	.	C	T	8	7	15	0	1	16	0	0
18	321802	.	T	C	6	7	13	0	2	15	0	0
18	321820	.	C	T	9	7	16	0	0	16	0	0
18	321934	.	C	T	2	2	4	0	0	4	0	0
18	323840	.	G	A	0	3	3	0	8	11	0	0
18	324190	.	T	C	13	6	19	0	0	19	0	0
18	324317	.	G	A	5	2	7	0	2	9	0	0
18	324325	.	A	G	7	2	9	0	0	9	0	0
18	324380	.	T	G	10	5	15	0	1	16	0	0
18	324409	.	C	T	7	9	16	0	1	17	0	0
18	324465	.	T	C	12	9	21	0	2	23	0	0
18	324692	.	A	T	11	17	28	0	0	28	0	0
18	324834	.	T	G	17	0	17	0	17	34	0	0
18	324835	.	G	T	15	17	32	0	2	34	0	0
18	325044	.	A	G	16	11	27	0	4	31	0	0
18	325189	.	C	T	23	23	46	0	5	51	0	0
18	325290	.	G	A	0	23	23	0	24	47	0	0
18	325312	.	G	T	21	23	44	0	2	46	0	0
18	325407	.	T	G	22	15	37	0	2	39	0	0
18	328733	.	A	G	3	3	6	0	1	7	0	0
18	328795	.	G	C	9	6	15	0	0	15	0	0
18	330474	.	A	G	6	7	13	0	0	13	0	0
18	333765	.	T	C	8	11	19	0	1	20	0	0
18	334018	.	C	T	5	6	11	0	1	12	0	0
18	334560	.	T	C	2	3	5	0	0	5	0	0
18	334634	.	G	A	1	4	5	0	0	5	0	0
18	334872	.	C	T	0	2	2	0	5	7	0	0
18	334876	.	T	A	3	5	8	0	0	8	0	0
18	336212	.	A	C	3	2	5	0	0	5	0	0
18	336607	.	T	G	8	5	13	0	2	15	0	0
18	344437	.	C	A	0	2	2	0	1	3	0	0
18	422992	.	G	A	0	0	0	0	1	1	0	0
18	606277	.	A	T	3	4	7	0	1	8	0	0
18	609365	.	A	G	2	3	5	0	0	5	0	0
18	609658	.	T	A	6	3	9	0	0	9	0	0
18	609667	.	C	G	6	2	8	0	1	9	0	0
18	609877	.	G	A	15	7	22	0	1	23	0	0
18	610327	.	A	G	2	0	2	0	8	10	0	0
18	610395	.	T	C	6	7	13	0	0	13	0	0
18	610397	.	T	C	6	7	13	0	0	13	0	0
18	610681	.	A	T	5	3	8	0	0	8	0	0
18	939430	.	C	T	15	13	28	0	0	28	0	0
18	948938	.	C	T	7	13	20	0	0	20	0	0
18	950849	.	C	T	49	36	85	0	4	89	0	0
18	951327	.	T	C	31	33	64	0	8	72	0	0
18	951391	.	C	T	36	17	53	0	4	58	1	0
18	951536	.	C	T	21	14	35	0	0	35	0	0
18	955705	.	A	G	1	2	3	0	0	3	0	0
18	1151525	.	T	C	2	2	4	0	1	5	0	0
18	1151536	.	C	A	3	2	5	0	0	5	0	0
18	1151566	.	C	T	0	4	4	0	2	6	0	0
18	1152125	.	T	C	3	7	10	0	1	11	0	0
18	1152141	.	A	C	4	0	4	0	7	11	0	0
18	1161054	.	T	A	15	11	26	0	4	30	0	0
18	1173819	.	G	A	1	2	3	0	1	4	0	0
18	1173856	.	G	A	14	16	30	0	0	30	0	0
18	1189420	.	G	A	12	11	23	0	1	24	0	0
18	1197218	.	G	T	9	9	18	0	4	22	0	0
18	1292083	.	C	G	5	6	11	0	1	12	0	0
18	1292164	.	G	A	3	3	6	1	0	7	0	0
18	1293121	.	G	A	2	6	8	0	0	8	0	0
18	1293182	.	G	A	5	6	11	0	0	11	0	0
18	1293242	.	G	A	3	0	3	0	0	3	0	0
18	1404683	.	G	A	1	0	1	0	0	1	0	0
18	2180636	.	C	T	1	2	3	0	0	3	0	0
18	2197638	.	A	C	1	1	2	0	1	3	0	0
18	2205302	.	T	A	5	5	10	0	2	12	0	0
18	2211091	.	T	C	3	4	7	0	1	8	0	0
18	2214873	.	A	G	1	1	2	0	0	2	0	0
18	2215557	.	C	T	0	1	1	0	0	1	0	0
18	2225632	.	C	T	0	2	2	0	2	4	0	0
18	2225661	.	C	T	4	7	11	0	0	11	0	0
18	2377645	.	T	C	8	0	8	0	14	22	0	0
18	2378510	.	C	A	1	5	6	0	0	6	0	0
18	2378619	.	T	G	1	3	4	0	0	4	0	0
18	2378625	.	G	T	1	3	4	0	0	4	0	0
18	2378687	.	A	C	6	2	8	0	0	8	0	0
18	2378713	.	T	G	4	9	13	0	0	13	0	0
18	2378722	.	C	T	0	5	5	0	8	13	0	0
18	2379073	.	G	A	1	4	5	0	3	8	0	0
18	2412660	.	T	C	2	1	3	0	0	3	0	0
18	2414993	.	T	C	0	0	0	0	1	1	0	0
18	2682726	.	T	C	15	0	15	0	6	21	0	0
18	2934938	.	C	T	2	1	3	0	1	4	0	0
18	3043779	.	C	T	7	15	22	0	2	24	0	0
18	3094913	.	T	C	9	7	16	0	2	18	0	0
18	3094920	.	C	A	8	8	16	0	3	19	0	0
18	3096739	.	C	T	2	2	4	0	0	4	0	0
18	3096914	.	A	C	2	5	7	0	0	7	0	0
18	3097194	.	T	C	2	8	10	0	2	12	0	0
18	3100651	.	A	G	3	6	9	0	0	9	0	0
18	3140747	.	G	A	1	3	4	0	0	4	0	0
18	3142685	.	A	G	1	2	3	0	1	4	0	0
18	3158237	.	C	T	1	6	7	0	2	9	0	0
18	3158245	.	T	A	3	7	10	0	0	10	0	0
18	3158273	.	G	A	7	5	12	0	0	12	0	0
18	3158588	.	A	C	6	18	24	0	1	25	0	0
18	3158739	.	A	G	3	16	19	0	1	20	0	0
18	3158801	.	G	A	6	8	14	0	2	16	0	0
18	3158896	.	C	T	3	3	6	1	1	8	0	0
18	3159140	.	C	A	7	3	10	0	0	10	0	0
18	3159711	.	A	C	3	5	8	0	1	9	0	0
18	3159712	.	C	A	3	6	9	0	0	9	0	0
18	3160148	.	C	G	0	2	2	0	2	4	0	0
18	3160188	.	A	T	1	4	5	0	0	5	0	0
18	3160218	.	C	T	0	3	3	0	5	8	0	0
18	3160354	.	C	T	0	2	2	0	1	3	0	0
18	3166246	.	T	A	1	2	3	0	1	4	0	0
18	3259807	.	C	A	9	11	20	0	0	20	0	0
18	3276085	.	G	C	15	15	30	0	2	32	0	0
18	3276187	.	A	G	0	0	0	0	3	3	0	0
18	3278976	.	G	A	13	13	26	0	1	27	0	0
18	3283412	.	G	A	15	15	30	0	1	31	0	0
18	3283631	.	G	T	18	20	38	0	2	40	0	0
18	3283686	.	T	C	19	23	42	0	1	43	0	0
18	3283882	.	T	C	17	22	39	0	3	42	0	0
18	3334581	.	G	C	1	2	3	0	1	4	0	0
18	3345141	.	T	A	2	2	4	0	2	6	0	0
18	3501282	.	C	T	1	2	3	0	0	3	0	0
18	3501283	.	C	G	0	2	2	0	1	3	0	0
18	3536883	.	A	G	6	4	10	0	0	10	0	0
18	3536937	.	T	C	1	1	2	0	1	3	0	0
18	3540027	.	C	T	4	1	5	0	2	7	0	0
18	3542204	.	G	A	4	4	8	0	0	8	0	0
18	3556542	.	A	G	5	0	5	0	0	5	0	0
18	3556626	.	C	T	0	10	10	0	6	16	0	0
18	3556710	.	G	A	6	5	11	0	3	14	0	0
18	3556743	.	G	A	3	8	11	0	0	11	0	0
18	3556935	.	C	T	3	3	6	0	0	6	0	0
18	3575938	.	C	A	6	3	9	0	0	9	0	0
18	3575984	.	G	A	7	9	16	0	2	18	0	0
18	3576104	.	C	T	6	12	18	0	2	20	0	0
18	3576185	.	T	A	5	10	15	0	0	15	0	0
18	3618015	.	C	G	0	1	1	0	0	1	0	0
18	5094876	.	A	C	16	0	16	0	12	28	0	0
18	5095537	.	G	T	7	8	15	0	1	16	0	0
18	5140128	.	C	T	9	3	12	0	1	13	0	0
18	5142338	.	C	T	4	16	20	0	0	20	0	0
18	5167232	.	T	C	30	18	48	0	3	51	0	0
18	5167374	.	A	G	26	19	45	0	2	47	0	0
18	5167437	.	T	C	32	14	46	0	3	49	0	0
18	5167689	.	A	G	13	11	24	0	1	25	0	0
18	5169779	.	T	C	21	28	49	0	2	51	0	0
18	5170016	.	C	G	24	22	46	0	2	48	0	0
18	5170069	.	A	G	19	2	21	0	33	54	0	0
18	5170123	.	C	A	19	14	33	0	14	48	1	0
18	5519138	.	A	G	3	3	6	0	2	8	0	0
18	5911552	.	T	A	8	5	13	0	1	14	0	0
18	6075821	.	T	G	1	2	3	0	1	4	0	0
18	6078123	.	T	C	0	2	2	0	1	3	0	0
18	6078131	.	T	C	1	2	3	0	0	3	0	0
18	6079374	.	G	T	4	3	7	0	1	8	0	0
18	6079864	.	T	C	5	4	9	0	0	9	0	0
18	6080272	.	A	G	1	6	7	0	1	8	0	0
18	6082054	.	C	T	9	7	16	0	1	17	0	0
18	6868483	.	A	G	24	7	31	0	1	33	1	0
18	7015557	.	T	C	3	2	5	0	0	5	0	0
18	7099981	.	A	G	0	6	6	0	1	7	0	0
18	7571628	.	C	T	4	3	7	0	0	7	0	0
18	7571657	.	A	G	2	5	7	0	1	8	0	0
18	7571684	.	A	C	2	6	8	0	0	8	0	0
18	7571712	.	G	T	4	2	6	0	2	8	0	0
18	8845677	.	C	T	2	1	3	0	0	3	0	0
18	9670480	.	T	A	0	2	2	0	1	3	0	0
18	10693077	.	G	A	6	2	8	0	1	9	0	0
18	10693085	.	T	A	7	3	10	0	0	10	0	0
18	10693123	.	C	T	6	8	14	0	0	14	0	0
18	10693155	.	T	A	3	7	10	0	1	11	0	0
18	10693322	.	A	T	7	7	14	0	1	15	0	0
18	10698083	.	T	C	6	6	12	0	1	13	0	0
18	10698161	.	T	G	5	3	8	0	0	8	0	0
18	10703669	.	A	G	0	1	1	0	1	2	0	0
18	10708346	.	G	A	0	0	0	0	1	1	0	0
18	10825951	.	A	G	0	2	2	0	1	3	0	0
18	10847743	.	C	T	1	1	2	0	0	2	0	0
18	10867181	.	A	C	3	4	7	0	1	8	0	0
18	10870806	.	T	C	1	0	1	0	0	1	0	0
18	10888245	.	A	C	1	0	1	0	0	1	0	0
18	10889951	.	G	A	1	4	5	0	0	5	0	0
18	10890432	.	G	A	5	2	7	0	1	8	0	0
18	10921408	.	A	T	7	4	11	0	0	11	0	0
18	10921630	.	A	T	3	7	10	0	1	11	0	0
18	10921734	.	T	C	6	6	12	0	1	13	0	0
18	10921791	.	T	C	3	10	13	0	2	15	0	0
18	10921855	.	T	C	5	8	13	1	0	14	0	0
18	10921857	.	G	A	0	8	8	1	5	14	0	0
18	10921927	.	C	T	5	5	10	0	2	12	0	0
18	11515830	.	C	T	1	3	4	0	0	4	0	0
18	11557106	.	G	A	0	3	3	0	0	3	0	0
18	12111625	.	A	G	1	2	3	0	0	3	0	0
18	12111628	.	A	T	1	2	3	0	0	3	0	0
18	12112105	.	T	C	1	3	4	0	0	4	0	0
18	12112153	.	T	C	3	5	8	0	0	8	0	0
18	12112219	.	C	T	3	4	7	0	0	7	0	0
18	12112726	.	C	T	1	2	3	0	0	3	0	0
18	12112750	.	G	A	0	1	1	0	0	1	0	0
18	12148050	.	T	G	1	0	1	0	0	1	0	0
18	12214299	.	A	G	0	1	1	0	0	1	0	0
18	12228217	.	C	A	0	1	1	0	1	2	0	0
18	12228758	.	C	T	2	2	4	0	0	4	0	0
18	12228834	.	G	C	2	5	7	0	0	7	0	0
18	12229120	.	A	T	3	3	6	0	0	6	0	0
18	12229223	.	A	C	3	3	6	0	0	6	0	0
18	12229245	.	C	T	2	2	4	0	0	4	0	0
18	12229405	.	G	A	1	2	3	0	0	3	0	0
18	12236113	.	G	A	4	4	8	0	0	8	0	0
18	12236126	.	T	A	4	3	7	0	1	8	0	0
18	12236351	.	C	T	5	2	7	0	0	7	0	0
18	12238082	.	G	A	2	3	5	0	1	6	0	0
18	12240681	.	C	T	4	1	5	0	0	5	0	0
18	12240740	.	G	C	1	0	1	0	0	1	0	0
18	12242967	.	C	T	0	1	1	0	0	1	0	0
18	12245576	.	A	G	2	2	4	0	0	4	0	0
18	12276859	.	C	T	16	14	30	0	1	31	0	0
18	12277052	.	A	G	13	10	23	0	2	25	0	0
18	12277206	.	G	C	10	16	26	0	2	29	1	0
18	12277490	.	G	A	27	18	45	0	1	46	0	0
18	12280269	.	C	T	11	9	20	0	0	20	0	0
18	12292017	.	G	A	14	14	28	0	1	29	0	0
18	12327321	.	C	A	0	3	3	0	2	5	0	0
18	12470136	.	G	A	1	2	3	0	0	3	0	0
18	12495185	.	C	T	0	1	1	0	1	2	0	0
18	12612160	.	A	G	1	2	3	0	0	3	0	0
18	12659226	.	C	T	1	0	1	0	0	1	0	0
18	12776727	.	C	T	2	3	5	0	0	5	0	0
18	12779357	.	T	A	1	4	5	0	0	5	0	0
18	13124606	.	T	C	3	5	8	0	0	8	0	0
18	13124664	.	T	C	4	2	6	0	1	7	0	0
18	14772522	.	G	A	1	5	6	0	0	6	0	0
18	14773050	.	C	T	3	2	5	0	0	5	0	0
18	14773068	.	G	T	3	4	7	0	0	7	0	0
18	14866506	.	G	A	3	3	6	0	0	6	0	0
18	14866508	.	C	T	2	4	6	0	0	6	0	0
18	14867144	.	A	C	4	0	4	0	6	10	0	0
18	14867153	.	C	T	3	6	9	0	0	9	0	0
18	14891794	.	T	C	0	1	1	0	0	1	0	0
18	14909768	.	G	A	0	2	2	0	0	2	0	0
18	14909831	.	A	T	2	3	5	0	0	5	0	0
18	14930095	.	T	C	1	1	2	0	0	2	0	0
18	15122894	.	C	T	2	1	3	0	0	3	0	0
18	15122915	.	G	A	0	2	2	0	3	5	0	0
18	15123008	.	C	A	3	3	6	0	0	6	0	0
18	15123011	.	A	G	3	2	5	0	0	5	0	0
18	15125122	.	G	A	1	0	1	0	0	1	0	0
18	15125193	.	A	C	1	0	1	0	0	1	0	0
18	15125418	.	C	A	1	1	2	0	0	2	0	0
18	15128960	.	T	C	6	3	9	0	0	9	0	0
18	15129476	.	G	T	1	2	3	0	0	3	0	0
18	15132372	.	T	C	3	5	8	0	0	8	0	0
18	15132383	.	T	C	3	5	8	0	0	8	0	0
18	15139150	.	G	A	4	6	10	0	0	10	0	0
18	15139540	.	C	T	9	11	20	0	0	20	0	0
18	15139757	.	G	A	6	4	10	0	0	10	0	0
18	15148021	.	T	C	3	5	8	0	0	8	0	0
18	15148199	.	T	C	3	4	7	0	0	7	0	0
18	15148207	.	A	C	3	4	7	0	1	8	0	0
18	15148248	.	T	C	1	6	7	0	1	8	0	0
18	15148259	.	A	C	1	5	6	0	1	7	0	0
18	15148886	.	G	A	2	3	5	0	0	5	0	0
18	15148912	.	A	G	2	2	4	0	0	4	0	0
18	15261773	.	T	C	1	2	3	0	0	3	0	0
18	15287709	.	A	G	1	1	2	0	0	2	0	0
18	15295976	.	G	T	6	2	8	0	1	9	0	0
18	15296062	.	G	A	9	3	12	0	2	14	0	0
18	15459835	.	T	A	4	6	10	1	0	11	0	0
18	15469907	.	T	C	5	8	13	0	0	13	0	0
18	15481364	.	T	G	1	1	2	0	0	2	0	0
18	15483345	.	A	G	1	2	3	0	0	3	0	0
18	15483351	.	C	T	2	2	4	0	0	4	0	0
18	15635311	.	A	G	2	2	4	0	0	4	0	0
18	15635323	.	A	G	2	2	4	0	0	4	0	0
18	15792294	.	T	G	12	16	28	0	3	31	0	0
18	15792368	.	G	C	18	16	34	0	6	41	1	0
18	15792459	.	A	C	30	15	45	0	2	48	1	0
18	15792596	.	T	A	26	22	48	0	1	49	0	0
18	15792611	.	A	G	29	18	47	0	1	48	0	0
18	15792743	.	T	A	15	17	32	0	3	35	0	0
18	15793064	.	A	G	7	9	16	0	1	17	0	0
18	15829588	.	A	G	1	2	3	0	0	3	0	0
18	15836917	.	A	G	5	3	8	0	1	9	0	0
18	15836961	.	C	T	4	2	6	0	0	6	0	0
18	15849413	.	T	C	1	1	2	0	0	2	0	0
18	15874550	.	C	T	2	2	4	0	0	4	0	0
18	15875196	.	G	A	1	0	1	0	0	1	0	0
18	16111467	.	C	G	0	2	2	0	2	4	0	0
18	16127885	.	A	G	9	13	22	0	1	23	0	0
18	16127927	.	A	C	8	15	23	0	0	23	0	0
18	16128427	.	T	A	3	2	5	0	0	5	0	0
18	16128730	.	A	G	7	6	13	0	0	13	0	0
18	16128960	.	T	G	16	16	32	0	0	32	0	0
18	16129210	.	A	C	23	16	39	0	0	39	0	0
18	16129583	.	T	A	20	22	42	0	4	47	1	0
18	16129862	.	C	T	19	18	37	0	4	41	0	0
18	16140047	.	G	A	1	0	1	0	0	1	0	0
18	16140337	.	G	T	0	9	9	0	16	25	0	0
18	16145618	.	T	G	17	25	42	0	1	43	0	0
18	16145621	.	C	T	16	24	40	0	4	45	1	0
18	16145994	.	C	G	3	2	5	0	1	6	0	0
18	16151809	.	T	A	3	2	5	0	1	6	0	0
18	16151936	.	G	A	8	3	11	0	1	12	0	0
18	16215954	.	C	T	0	2	2	0	0	2	0	0
18	16388195	.	G	A	0	2	2	0	1	3	0	0
18	16719963	.	T	C	5	8	13	0	0	13	0	0
18	16720197	.	G	A	4	3	7	0	1	8	0	0
18	16721705	.	G	A	11	8	19	0	0	19	0	0
18	16721741	.	G	A	5	1	6	0	1	7	0	0
18	16722124	.	G	A	8	14	22	0	3	25	0	0
18	16722584	.	G	A	10	9	19	0	2	21	0	0
18	16723514	.	T	C	14	12	26	0	0	27	1	0
18	16723520	.	A	G	14	0	14	0	12	26	0	0
18	16723785	.	A	G	13	0	13	0	10	23	0	0
18	16725309	.	C	T	18	11	29	0	0	29	0	0
18	16725323	.	C	T	17	7	24	0	3	27	0	0
18	16725917	.	A	G	15	11	26	0	1	27	0	0
18	16726011	.	C	T	9	16	25	0	3	28	0	0
18	16755962	.	C	A	11	20	31	0	0	31	0	0
18	16756001	.	C	T	9	22	31	0	3	34	0	0
18	16756058	.	T	A	7	11	18	0	1	19	0	0
18	16756065	.	G	A	9	10	19	0	1	20	0	0
18	16876903	.	A	G	1	6	7	0	0	7	0	0
18	16877282	.	C	T	1	3	4	0	0	4	0	0
18	16877283	.	A	G	1	3	4	0	0	4	0	0
18	16886079	.	C	T	1	1	2	0	0	2	0	0
18	16894571	.	T	A	2	4	6	0	1	7	0	0
18	16894594	.	T	G	2	5	7	0	1	8	0	0
18	16894630	.	A	G	1	2	3	0	1	4	0	0
18	16918725	.	G	A	1	1	2	0	1	3	0	0
18	16918760	.	C	A	1	2	3	0	0	3	0	0
18	16929772	.	G	A	6	11	17	0	1	18	0	0
18	16936758	.	T	C	2	3	5	0	0	5	0	0
18	16936787	.	A	G	2	6	8	0	0	8	0	0
18	16961046	.	A	G	4	3	7	0	0	7	0	0
18	16962778	.	A	G	3	2	5	0	0	5	0	0
18	16962783	.	C	T	3	2	5	0	0	5	0	0
18	16962823	.	C	T	0	1	1	0	0	1	0	0
18	16963091	.	C	G	6	3	9	0	0	9	0	0
18	16966911	.	T	C	3	3	6	0	1	7	0	0
18	16968314	.	T	C	4	6	10	0	0	10	0	0
18	16970455	.	A	T	13	3	16	0	0	16	0	0
18	16970459	.	G	A	0	3	3	0	14	17	0	0
18	16970598	.	C	T	11	3	14	0	1	15	0	0
18	16970795	.	A	T	7	9	16	0	0	16	0	0
18	16970912	.	T	C	9	2	11	0	2	13	0	0
18	16970950	.	T	G	12	5	17	0	1	18	0	0
18	16970997	.	G	C	1	10	11	0	18	29	0	0
18	16971155	.	A	T	12	5	17	0	0	17	0	0
18	16971255	.	T	A	1	6	7	0	0	7	0	0
18	16990122	.	C	T	0	4	4	0	4	8	0	0
18	16990150	.	G	T	5	3	8	0	0	8	0	0
18	16990385	.	A	C	1	0	1	0	4	5	0	0
18	17002653	.	A	G	6	5	11	0	2	13	0	0
18	17003602	.	A	G	2	0	2	0	0	2	0	0
18	17007720	.	T	C	1	1	2	0	0	2	0	0
18	17024007	.	G	A	1	2	3	0	0	3	0	0
18	17024399	.	T	G	1	6	7	0	0	7	0	0
18	17062226	.	G	A	1	2	3	0	0	3	0	0
18	17062227	.	G	A	1	2	3	0	0	3	0	0
18	17062336	.	T	C	3	2	5	0	0	5	0	0
18	17062364	.	T	G	3	3	6	0	0	6	0	0
18	17062487	.	G	T	1	3	4	0	1	5	0	0
18	17078575	.	A	T	2	0	2	0	1	3	0	0
18	17078593	.	T	C	1	3	4	0	0	4	0	0
18	17078946	.	A	G	2	2	4	0	0	4	0	0
18	17079156	.	G	C	1	3	4	0	1	5	0	0
18	17079541	.	T	C	11	8	19	0	2	21	0	0
18	17079724	.	C	T	0	10	10	0	13	23	0	0
18	17080089	.	G	C	8	7	15	0	1	16	0	0
18	17080122	.	A	G	8	8	16	0	2	18	0	0
18	17080131	.	T	C	6	1	7	0	11	18	0	0
18	17084489	.	C	T	0	1	1	0	1	2	0	0
18	17097893	.	T	C	6	5	11	0	2	13	0	0
18	17098562	.	T	A	3	0	3	0	0	3	0	0
18	17102046	.	C	T	0	6	6	0	9	15	0	0
18	17131006	.	A	G	1	1	2	0	1	3	0	0
18	17144909	.	T	A	2	3	5	0	0	5	0	0
18	17535748	.	A	T	2	9	11	0	1	12	0	0
18	18482388	.	A	T	1	2	3	0	0	3	0	0
18	19419307	.	C	T	6	3	9	0	1	10	0	0
18	19441492	.	C	G	6	6	12	0	1	13	0	0
18	19441561	.	T	C	3	4	7	0	0	7	0	0
18	19441585	.	C	A	2	3	5	0	0	5	0	0
18	19450486	.	T	C	18	11	29	0	4	33	0	0
18	19450563	.	A	T	23	32	55	0	2	58	1	0
18	19450642	.	A	T	26	17	43	0	1	44	0	0
18	19450692	.	A	G	11	18	29	0	0	29	0	0
18	19450755	.	A	G	32	25	57	0	0	57	0	0
18	19451023	.	C	T	12	27	39	0	1	40	0	0
18	19451117	.	C	T	5	11	16	0	2	18	0	0
18	19451427	.	G	A	27	14	41	0	3	44	0	0
18	19451430	.	T	C	28	4	32	0	14	46	0	0
18	19451477	.	G	A	20	28	48	0	5	53	0	0
18	19452126	.	T	A	10	16	26	0	3	29	0	0
18	19452594	.	G	A	11	24	35	0	6	41	0	0
18	19452639	.	A	G	10	20	30	0	2	32	0	0
18	19487779	.	G	A	23	18	41	0	0	41	0	0
18	19490515	.	C	T	6	13	19	0	3	22	0	0
18	19698539	.	C	T	3	0	3	0	0	3	0	0
18	19698833	.	T	C	2	2	4	0	0	4	0	0
18	19698854	.	G	A	3	2	5	0	0	5	0	0
18	19812874	.	T	C	8	12	20	0	0	20	0	0
18	19812943	.	A	T	11	9	20	0	0	20	0	0
18	19813002	.	A	G	9	14	23	0	2	25	0	0
18	19815743	.	A	T	2	1	3	0	0	3	0	0
18	19817682	.	G	A	2	4	6	0	0	6	0	0
18	19817717	.	G	A	1	2	3	0	0	3	0	0
18	19819719	.	C	A	6	3	9	0	0	9	0	0
18	19883812	.	G	T	0	6	6	0	6	12	0	0
18	19981553	.	G	A	4	2	6	0	0	6	0	0
18	19981584	.	C	T	1	3	4	0	0	4	0	0
18	20022806	.	T	C	2	1	3	0	0	3	0	0
18	20024856	.	T	C	1	3	4	0	2	6	0	0
18	20031708	.	T	G	1	1	2	0	1	3	0	0
18	20041825	.	T	C	1	0	1	0	0	1	0	0
18	20042088	.	C	T	8	14	22	0	0	22	0	0
18	20044847	.	T	C	14	8	22	0	1	23	0	0
18	20045197	.	T	C	3	2	5	0	0	5	0	0
18	20226131	.	G	T	1	3	4	0	1	5	0	0
18	20249005	.	G	T	0	3	3	0	1	4	0	0
18	20252129	.	C	T	1	1	2	0	0	2	0	0
18	20254384	.	C	T	5	4	9	0	0	9	0	0
18	20254398	.	G	A	0	2	2	0	6	8	0	0
18	20256275	.	C	T	11	9	20	0	2	22	0	0
18	20256379	.	A	G	5	9	14	0	0	14	0	0
18	20256491	.	T	A	6	8	14	0	1	16	1	0
18	20256492	.	A	T	8	8	16	0	0	16	0	0
18	20256539	.	G	A	4	7	11	0	2	13	0	0
18	20257005	.	G	A	1	14	15	0	15	30	0	0
18	20257159	.	C	G	8	13	21	0	1	22	0	0
18	20257200	.	A	T	18	8	26	0	0	26	0	0
18	20436731	.	C	G	0	2	2	0	1	3	0	0
18	20436741	.	T	G	1	2	3	0	0	3	0	0
18	20468514	.	G	T	1	2	3	0	2	5	0	0
18	20469275	.	T	A	0	1	1	0	0	1	0	0
18	20475854	.	C	T	2	4	6	0	0	6	0	0
18	20479008	.	A	G	5	5	10	0	0	10	0	0
18	20490672	.	G	A	1	2	3	0	0	3	0	0
18	20490709	.	A	G	1	0	1	0	3	4	0	0
18	20490720	.	A	G	2	4	6	0	0	6	0	0
18	20490759	.	A	G	3	3	6	0	1	7	0	0
18	20490768	.	A	T	3	4	7	0	0	7	0	0
18	20491073	.	C	A	2	3	5	0	1	6	0	0
18	20491095	.	T	C	3	4	7	0	1	8	0	0
18	20516863	.	A	C	1	3	4	0	0	4	0	0
18	20516869	.	T	G	1	3	4	0	0	4	0	0
18	20517000	.	G	A	3	3	6	0	0	6	0	0
18	20518961	.	A	C	1	3	4	0	0	4	0	0
18	20521053	.	T	G	3	2	5	0	0	5	0	0
18	20521680	.	G	A	0	3	3	0	0	3	0	0
18	20532685	.	T	C	2	2	4	0	0	4	0	0
18	20535074	.	T	A	8	6	14	0	1	15	0	0
18	20539548	.	G	A	0	10	10	0	7	17	0	0
18	20539703	.	T	A	3	2	5	0	3	8	0	0
18	20539979	.	T	A	3	3	6	0	0	6	0	0
18	20540144	.	G	A	1	1	2	0	1	3	0	0
18	20540581	.	G	T	3	5	8	0	1	9	0	0
18	20541575	.	A	C	10	9	19	1	2	22	0	0
18	20541735	.	A	G	8	8	16	0	1	17	0	0
18	20541863	.	C	G	2	2	4	0	1	5	0	0
18	20542107	.	C	T	0	9	9	0	13	22	0	0
18	20542128	.	T	G	8	9	17	0	1	18	0	0
18	20542214	.	A	T	4	6	10	0	0	10	0	0
18	20542388	.	T	G	8	9	17	0	1	18	0	0
18	20542398	.	A	C	12	10	22	0	0	22	0	0
18	20542503	.	G	A	8	21	29	0	1	30	0	0
18	20542562	.	T	G	12	17	29	0	2	31	0	0
18	20542647	.	C	T	6	15	21	0	2	23	0	0
18	20543466	.	T	A	8	8	16	0	0	16	0	0
18	20544901	.	G	C	2	8	10	0	1	11	0	0
18	20553607	.	T	C	3	3	6	0	1	7	0	0
18	20554066	.	C	T	0	2	2	0	1	3	0	0
18	20572016	.	G	A	0	2	2	0	0	2	0	0
18	20572036	.	G	A	0	2	2	0	0	2	0	0
18	20582109	.	G	A	16	12	28	0	0	28	0	0
18	20582222	.	G	A	11	7	18	0	0	18	0	0
18	20582303	.	C	T	0	4	4	0	12	16	0	0
18	20582314	.	C	G	11	4	15	0	0	15	0	0
18	20582629	.	T	C	8	3	11	0	2	13	0	0
18	20583127	.	C	T	4	2	6	0	1	7	0	0
18	20583154	.	G	T	3	3	6	0	0	6	0	0
18	20583763	.	A	G	2	7	9	0	0	9	0	0
18	20583820	.	A	T	4	3	7	0	0	7	0	0
18	20584077	.	G	A	2	4	6	0	0	6	0	0
18	20584098	.	T	A	3	2	5	0	1	6	0	0
18	20584340	.	C	T	0	2	2	0	3	5	0	0
18	20584797	.	G	A	1	4	5	0	0	5	0	0
18	20584801	.	C	T	1	4	5	0	0	5	0	0
18	20584986	.	T	G	1	2	3	0	0	3	0	0
18	20585314	.	C	T	3	5	8	0	0	8	0	0
18	20585837	.	G	A	1	3	4	0	0	4	0	0
18	20726304	.	T	C	19	2	21	0	31	52	0	0
18	20729281	.	C	T	0	3	3	0	6	9	0	0
18	20739298	.	C	T	3	1	4	0	2	6	0	0
18	20742029	.	C	G	1	2	3	0	1	4	0	0
18	20744164	.	T	C	3	6	9	0	0	9	0	0
18	20752848	.	G	A	5	5	10	0	1	11	0	0
18	20755763	.	G	A	2	0	2	0	0	2	0	0
18	20755787	.	G	T	2	2	4	0	0	4	0	0
18	20755843	.	G	C	4	6	10	0	0	10	0	0
18	20755844	.	C	A	4	6	10	0	0	10	0	0
18	20755971	.	G	T	2	4	6	1	1	8	0	0
18	20757934	.	C	T	6	6	12	0	1	13	0	0
18	20757977	.	A	C	7	0	7	0	6	13	0	0
18	20757979	.	G	A	5	6	11	0	2	13	0	0
18	20768407	.	C	T	5	5	10	0	8	18	0	0
18	20768977	.	C	T	4	3	7	0	1	8	0	0
18	20771085	.	A	G	3	2	5	0	0	5	0	0
18	20882057	.	G	A	1	2	3	0	0	3	0	0
18	20882062	.	T	C	1	0	1	0	3	4	0	0
18	20882237	.	C	G	1	3	4	0	0	4	0	0
18	21102764	.	C	T	0	5	5	0	3	8	0	0
18	21102797	.	G	T	5	3	8	0	0	8	0	0
18	21102914	.	G	A	1	4	5	0	0	5	0	0
18	21103079	.	G	A	2	2	4	0	0	4	0	0
18	21105722	.	G	A	1	3	4	0	0	4	0	0
18	21113462	.	T	A	1	2	3	0	0	3	0	0
18	21114475	.	T	C	3	3	6	0	0	6	0	0
18	21116381	.	C	A	2	1	3	0	0	3	0	0
18	21117589	.	C	A	2	4	6	0	0	6	0	0
18	21118232	.	C	G	11	4	15	0	1	16	0	0
18	21119498	.	G	A	7	9	16	0	1	17	0	0
18	21119562	.	G	A	7	6	13	0	0	13	0	0
18	21119579	.	A	T	9	7	16	0	2	18	0	0
18	21119854	.	T	C	6	5	11	0	1	12	0	0
18	21136948	.	C	T	1	6	7	0	0	7	0	0
18	21143473	.	A	T	13	14	27	0	1	28	0	0
18	21143787	.	C	A	7	11	18	0	3	21	0	0
18	21143938	.	C	G	11	9	20	0	0	20	0	0
18	21143998	.	C	T	12	15	27	0	2	29	0	0
18	21144005	.	C	A	11	17	28	0	3	31	0	0
18	21144060	.	G	A	0	20	20	0	16	36	0	0
18	21144800	.	A	T	5	4	9	0	0	9	0	0
18	21144880	.	G	T	11	9	20	0	1	21	0	0
18	21145142	.	A	G	7	5	12	0	7	19	0	0
18	21145290	.	G	T	7	7	14	0	0	14	0	0
18	21179730	.	A	G	8	2	10	0	1	11	0	0
18	21198961	.	G	T	16	19	35	0	0	35	0	0
18	21199165	.	G	T	10	15	25	0	1	26	0	0
18	21199515	.	T	C	1	5	6	0	1	7	0	0
18	21214976	.	T	C	1	1	2	0	1	3	0	0
18	21218734	.	G	A	7	5	12	0	1	13	0	0
18	21257600	.	A	T	12	3	15	0	0	15	0	0
18	21257657	.	T	C	8	13	21	0	2	23	0	0
18	21257786	.	G	A	9	7	16	0	0	16	0	0
18	21257867	.	G	A	2	13	15	0	3	18	0	0
18	21257946	.	C	T	13	5	18	0	2	20	0	0
18	21258083	.	G	A	10	4	14	0	0	14	0	0
18	21263120	.	G	A	0	5	5	0	0	5	0	0
18	21266815	.	A	G	4	0	4	0	0	4	0	0
18	21492325	.	T	C	4	5	9	0	0	9	0	0
18	21617864	.	G	A	0	12	12	0	20	32	0	0
18	21618343	.	C	T	17	14	31	0	1	32	0	0
18	21618379	.	A	G	18	10	28	0	2	30	0	0
18	21618496	.	G	A	16	17	33	0	3	36	0	0
18	21618659	.	C	A	13	17	30	0	2	32	0	0
18	21618731	.	G	T	19	20	39	0	3	42	0	0
18	21618910	.	G	T	15	18	33	0	3	36	0	0
18	21619011	.	C	T	17	11	28	0	4	32	0	0
18	21619018	.	A	T	20	12	32	0	0	32	0	0
18	21619055	.	G	T	13	12	25	0	2	27	0	0
18	21619260	.	C	T	21	10	31	0	3	34	0	0
18	21619284	.	G	T	10	19	29	0	1	30	0	0
18	21619672	.	A	G	13	12	25	0	1	26	0	0
18	21619686	.	G	A	12	11	23	0	1	24	0	0
18	21619777	.	A	G	22	10	32	0	2	34	0	0
18	21619799	.	T	G	25	20	45	0	1	46	0	0
18	21619948	.	C	T	11	25	36	0	3	39	0	0
18	21620082	.	A	T	19	14	33	0	1	34	0	0
18	21620376	.	A	C	24	32	56	0	1	57	0	0
18	21620426	.	G	A	2	28	30	0	23	53	0	0
18	21645492	.	G	A	8	7	15	0	1	16	0	0
18	21645627	.	A	G	8	4	12	0	0	12	0	0
18	21645965	.	G	A	9	6	15	0	3	18	0	0
18	21645989	.	T	G	6	1	7	0	0	7	0	0
18	21648582	.	A	G	3	5	8	0	0	8	0	0
18	21648627	.	C	T	2	1	3	0	0	3	0	0
18	21648633	.	A	T	2	1	3	0	0	3	0	0
18	21653937	.	C	T	8	6	14	0	0	14	0	0
18	21654145	.	C	T	2	2	4	0	1	5	0	0
18	21654375	.	C	A	1	0	1	0	0	1	0	0
18	21654432	.	T	C	3	3	6	0	0	6	0	0
18	21654489	.	C	T	3	4	7	0	0	7	0	0
18	21656211	.	C	T	1	1	2	0	1	3	0	0
18	21656217	.	G	A	1	2	3	0	0	3	0	0
18	21657642	.	T	G	1	1	2	0	1	3	0	0
18	21674320	.	G	T	1	2	3	0	0	3	0	0
18	21689043	.	G	C	3	5	8	0	0	8	0	0
18	21689052	.	A	G	3	5	8	0	0	8	0	0
18	21689079	.	G	A	9	5	14	0	0	14	0	0
18	21693213	.	G	A	6	8	14	0	1	15	0	0
18	21693441	.	G	A	4	3	7	0	0	7	0	0
18	21697776	.	C	T	4	8	12	0	2	14	0	0
18	21698855	.	G	T	3	2	5	0	0	5	0	0
18	21724220	.	G	T	1	2	3	0	0	3	0	0
18	21724480	.	A	G	2	3	5	0	0	5	0	0
18	21782362	.	T	G	1	2	3	0	0	3	0	0
18	21782445	.	T	G	3	4	7	0	0	7	0	0
18	21782500	.	A	G	4	2	6	0	0	6	0	0
18	21782506	.	G	C	3	2	5	0	0	5	0	0
18	21782577	.	G	A	2	2	4	0	0	4	0	0
18	21783077	.	C	T	4	3	7	0	0	7	0	0
18	21783087	.	G	A	4	3	7	0	0	7	0	0
18	21783257	.	G	T	1	3	4	0	2	6	0	0
18	21783279	.	G	A	4	2	6	0	0	6	0	0
18	21783325	.	A	T	5	3	8	0	0	8	0	0
18	21783368	.	G	A	4	4	8	0	0	8	0	0
18	21783494	.	A	C	2	2	4	0	0	4	0	0
18	21860755	.	C	T	7	4	11	0	1	12	0	0
18	21861134	.	T	A	11	9	20	0	1	21	0	0
18	21861225	.	T	A	14	16	30	0	0	30	0	0
18	21861381	.	G	T	8	3	11	0	1	12	0	0
18	21861497	.	A	T	7	10	17	0	1	18	0	0
18	21861688	.	C	A	5	3	8	0	0	8	0	0
18	21861934	.	C	T	5	6	11	0	0	11	0	0
18	21862000	.	G	C	6	6	12	0	0	12	0	0
18	21862141	.	T	C	4	0	4	0	8	12	0	0
18	21862175	.	C	T	0	2	2	0	4	6	0	0
18	21862237	.	G	T	2	2	4	0	1	5	0	0
18	21862346	.	T	A	7	5	12	0	0	12	0	0
18	21888256	.	C	T	3	2	5	0	0	5	0	0
18	21913799	.	A	T	14	9	23	0	4	27	0	0
18	21913907	.	G	C	9	14	23	0	3	26	0	0
18	21913988	.	C	A	7	6	13	0	1	14	0	0
18	21914018	.	C	A	5	6	11	0	0	11	0	0
18	21914225	.	C	T	0	19	19	0	12	31	0	0
18	21914281	.	G	A	6	12	18	0	4	22	0	0
18	21914283	.	C	A	8	14	22	0	0	22	0	0
18	22002476	.	G	A	3	7	10	0	0	10	0	0
18	22002508	.	C	T	2	7	9	0	1	10	0	0
18	22030995	.	A	C	1	2	3	0	0	3	0	0
18	22031018	.	T	G	1	2	3	0	0	3	0	0
18	22082366	.	T	C	4	3	7	0	0	7	0	0
18	22232775	.	T	C	1	2	3	0	0	3	0	0
18	22255005	.	C	T	1	2	3	0	0	3	0	0
18	22272969	.	C	A	8	5	13	0	0	13	0	0
18	22275051	.	T	C	4	8	12	0	0	12	0	0
18	22282766	.	A	T	15	4	19	0	0	19	0	0
18	22282809	.	A	T	7	14	21	0	2	23	0	0
18	22282923	.	G	T	7	12	19	0	2	21	0	0
18	22282960	.	C	T	11	13	24	0	2	26	0	0
18	22282961	.	A	G	11	14	25	0	1	26	0	0
18	22283087	.	C	A	8	7	15	0	0	15	0	0
18	22283116	.	T	A	8	8	16	0	0	16	0	0
18	22289075	.	T	C	5	2	7	0	0	7	0	0
18	22289314	.	C	T	5	4	9	0	0	9	0	0
18	22290900	.	G	A	5	3	8	0	1	9	0	0
18	22290933	.	C	T	11	7	18	0	0	18	0	0
18	22292215	.	A	T	17	16	33	0	1	34	0	0
18	22292286	.	G	A	16	14	30	0	2	32	0	0
18	22292339	.	A	T	12	13	25	0	1	26	0	0
18	22293191	.	T	G	3	2	5	0	0	5	0	0
18	22293193	.	T	G	3	2	5	0	0	5	0	0
18	22356989	.	C	T	12	10	22	0	3	25	0	0
18	22377096	.	A	T	17	14	31	0	6	37	0	0
18	22377372	.	G	A	1	20	21	0	30	51	0	0
18	22377471	.	C	T	17	16	33	0	2	35	0	0
18	22385900	.	G	A	22	24	46	0	11	57	0	0
18	22405895	.	A	T	4	8	12	0	1	13	0	0
18	22406162	.	C	T	1	5	6	0	5	11	0	0
18	22406187	.	T	A	5	5	10	0	0	10	0	0
18	22406375	.	T	A	2	3	5	0	1	6	0	0
18	22406728	.	A	T	1	2	3	0	0	3	0	0
18	22407365	.	C	T	0	2	2	0	1	3	0	0
18	22417058	.	C	T	1	3	4	0	0	4	0	0
18	22417082	.	G	A	0	4	4	0	2	6	0	0
18	22417103	.	C	A	2	3	5	0	0	5	0	0
18	22420551	.	A	T	1	3	4	0	0	4	0	0
18	22420558	.	C	A	1	3	4	0	0	4	0	0
18	22424532	.	T	C	0	1	1	0	0	1	0	0
18	22424536	.	A	G	0	0	0	0	3	3	0	0
18	22424601	.	A	G	3	0	3	0	10	13	0	0
18	22486123	.	T	C	2	2	4	0	0	4	0	0
18	22486579	.	A	T	2	7	9	0	1	10	0	0
18	22679540	.	C	T	1	3	4	0	0	4	0	0
18	22685329	.	T	C	4	6	10	0	0	10	0	0
18	22685380	.	A	T	3	6	9	0	2	11	0	0
18	22685608	.	C	A	8	4	12	0	1	13	0	0
18	22686269	.	A	T	8	6	14	0	0	14	0	0
18	22686320	.	G	A	4	6	10	0	0	10	0	0
18	22686358	.	G	A	7	1	8	0	2	10	0	0
18	22686653	.	A	T	3	3	6	0	0	6	0	0
18	22686723	.	C	T	4	3	7	0	0	7	0	0
18	22686789	.	G	A	3	4	7	0	0	7	0	0
18	22686795	.	C	G	3	5	8	0	0	8	0	0
18	22687312	.	G	A	7	10	17	0	1	18	0	0
18	22687527	.	G	C	10	22	32	0	3	35	0	0
18	22687575	.	T	A	15	22	37	0	2	39	0	0
18	22687599	.	A	T	17	20	37	0	0	37	0	0
18	22687666	.	C	T	24	13	37	0	1	38	0	0
18	22732391	.	A	G	2	2	4	0	0	4	0	0
18	22921942	.	C	T	9	12	21	0	0	21	0	0
18	22921950	.	T	C	10	11	21	0	2	23	0	0
18	22975090	.	T	C	25	31	56	0	3	59	0	0
18	22975297	.	A	C	26	27	53	0	2	55	0	0
18	23070059	.	T	C	2	2	4	0	0	4	0	0
18	23071331	.	C	T	1	2	3	0	0	3	0	0
18	23071884	.	A	C	1	3	4	0	0	4	0	0
18	23072082	.	G	T	1	2	3	0	1	4	0	0
18	23072164	.	G	A	2	4	6	0	0	6	0	0
18	23869784	.	T	A	22	18	40	0	0	40	0	0
18	23888223	.	G	A	2	2	4	0	0	4	0	0
18	24922124	.	C	A	0	2	2	0	1	3	0	0
18	24922149	.	G	A	1	2	3	0	0	3	0	0
18	24926925	.	T	C	1	1	2	0	0	2	0	0
18	24928941	.	A	G	4	4	8	0	0	8	0	0
18	24929079	.	T	G	1	3	4	0	2	6	0	0
18	24929406	.	A	G	1	0	1	0	2	3	0	0
18	24929413	.	G	A	1	3	4	0	0	4	0	0
18	24929465	.	T	C	3	9	12	0	0	12	0	0
18	24929633	.	C	T	5	5	10	0	0	10	0	0
18	24929720	.	C	T	8	6	14	0	0	14	0	0
18	24930530	.	T	C	11	11	22	0	2	24	0	0
18	24931326	.	G	A	5	7	12	0	1	13	0	0
18	24931699	.	T	C	5	8	13	0	2	15	0	0
18	24933638	.	C	G	14	11	25	0	1	26	0	0
18	24933769	.	C	A	12	10	22	0	4	26	0	0
18	24933799	.	A	G	15	8	23	0	5	28	0	0
18	24934333	.	A	T	7	6	13	0	2	15	0	0
18	24934719	.	G	C	10	8	18	0	1	19	0	0
18	24934950	.	G	A	11	5	16	0	0	16	0	0
18	24935099	.	A	G	20	9	29	0	0	29	0	0
18	24938712	.	A	G	1	4	5	0	0	5	0	0
18	24938805	.	A	G	8	9	17	0	1	18	0	0
18	24938871	.	T	C	6	9	15	0	0	15	0	0
18	24938919	.	C	T	1	3	4	0	0	4	0	0
18	24944039	.	A	T	4	1	5	0	1	6	0	0
18	24944045	.	T	C	3	1	4	0	0	4	0	0
18	24946637	.	T	C	3	1	4	0	1	5	0	0
18	24946727	.	T	A	3	1	4	0	0	4	0	0
18	24947678	.	A	G	3	3	6	0	0	6	0	0
18	25003359	.	A	T	6	7	13	0	2	15	0	0
18	25009233	.	C	T	2	2	4	0	0	4	0	0
18	25009253	.	C	T	6	5	11	0	1	12	0	0
18	25009326	.	C	A	12	8	20	0	0	20	0	0
18	25009407	.	T	C	5	13	18	0	2	20	0	0
18	25028181	.	C	A	0	2	2	0	1	3	0	0
18	25752722	.	G	A	4	3	7	0	0	7	0	0
18	25754551	.	G	A	8	4	12	0	2	14	0	0
18	25754580	.	G	T	7	3	10	0	0	10	0	0
18	25754690	.	T	G	1	3	4	0	0	4	0	0
18	25754693	.	A	G	1	0	1	0	3	4	0	0
18	25783752	.	G	A	1	2	3	0	0	3	0	0
18	26089305	.	G	C	2	4	6	0	0	6	0	0
18	26097091	.	G	T	36	23	59	0	5	64	0	0
18	26097428	.	G	A	12	9	21	0	0	21	0	0
18	26099274	.	A	T	21	19	40	0	2	42	0	0
18	26338420	.	C	T	2	5	7	0	0	7	0	0
18	26389326	.	G	A	5	8	13	0	1	14	0	0
18	26393716	.	C	A	4	2	6	0	0	6	0	0
18	26401680	.	T	C	13	11	24	0	5	29	0	0
18	26401719	.	T	C	13	14	27	0	0	27	0	0
18	26401938	.	A	C	5	4	9	0	0	9	0	0
18	26410176	.	T	C	3	2	5	0	0	5	0	0
18	26412001	.	A	G	0	2	2	0	0	2	0	0
18	26417753	.	G	A	0	0	0	0	0	0	0	0
18	26426448	.	G	A	1	0	1	0	0	1	0	0
18	26428415	.	A	T	1	3	4	0	0	4	0	0
18	26460723	.	G	T	3	3	6	0	0	6	0	0
18	26460747	.	G	T	1	2	3	0	0	3	0	0
18	26460773	.	A	T	2	4	6	0	0	6	0	0
18	26460822	.	G	C	4	4	8	0	0	8	0	0
18	26790510	.	A	T	8	5	13	0	1	14	0	0
18	26800167	.	C	G	5	2	7	0	2	9	0	0
18	26807304	.	C	T	1	3	4	0	1	5	0	0
18	26809791	.	G	T	1	1	2	0	0	2	0	0
18	26863515	.	C	T	1	2	3	0	0	3	0	0
18	26870137	.	G	A	1	2	3	0	0	3	0	0
18	26896277	.	T	C	3	5	8	0	0	8	0	0
18	26896571	.	C	T	3	2	5	0	1	6	0	0
18	26899453	.	T	C	2	6	8	0	1	9	0	0
18	26919226	.	C	T	12	6	18	0	0	18	0	0
18	26919227	.	T	A	12	4	16	0	2	18	0	0
18	26919865	.	T	C	8	13	21	0	2	23	0	0
18	26919989	.	T	A	22	16	38	0	4	42	0	0
18	26920116	.	T	C	3	3	6	0	0	6	0	0
18	26968799	.	G	A	2	6	8	0	0	8	0	0
18	26968822	.	T	C	1	0	1	0	3	4	0	0
18	26971513	.	G	A	2	3	5	0	0	5	0	0
18	26977226	.	T	C	2	2	4	0	0	4	0	0
18	27081050	.	C	T	2	2	4	0	0	4	0	0
18	27081056	.	T	C	2	1	3	0	0	3	0	0
18	27085060	.	A	G	3	2	5	0	0	5	0	0
18	27085101	.	A	G	1	2	3	0	0	3	0	0
18	27085104	.	C	T	1	3	4	0	0	4	0	0
18	27241292	.	G	A	0	2	2	0	1	3	0	0
18	27281456	.	A	G	0	1	1	0	0	1	0	0
18	27283304	.	C	T	1	3	4	0	0	4	0	0
18	27285741	.	C	T	1	3	4	0	0	4	0	0
18	27309512	.	T	C	1	5	6	0	1	7	0	0
18	27309873	.	C	T	18	12	30	0	1	31	0	0
18	27335583	.	T	C	4	4	8	0	1	9	0	0
18	27335597	.	G	A	5	5	10	0	2	12	0	0
18	27335828	.	A	G	2	4	6	0	1	7	0	0
18	27335935	.	T	A	1	3	4	0	1	5	0	0
18	27358388	.	A	C	4	2	6	0	1	7	0	0
18	27358709	.	A	G	1	3	4	0	0	4	0	0
18	27358787	.	T	C	1	2	3	0	0	3	0	0
18	27568337	.	A	G	9	4	13	0	0	13	0	0
18	27568352	.	A	G	6	6	12	0	2	14	0	0
18	33729756	.	T	G	1	3	4	0	0	4	0	0
18	36598337	.	A	G	5	4	9	0	0	9	0	0
18	36598439	.	A	G	11	3	14	0	0	14	0	0
18	36869676	.	A	G	7	7	14	0	0	14	0	0
18	36869677	.	A	G	6	7	13	0	1	14	0	0
18	39039867	.	G	C	0	1	1	0	0	1	0	0
18	39293066	.	A	G	6	12	18	0	3	21	0	0
18	39293074	.	A	C	5	15	20	0	1	21	0	0
18	40383665	.	T	A	3	5	8	0	2	10	0	0
18	40384022	.	G	T	0	3	3	0	3	6	0	0
18	40384160	.	C	T	3	4	7	0	2	9	0	0
18	40384214	.	T	C	4	4	8	0	1	9	0	0
18	40384253	.	A	G	4	5	9	0	1	10	0	0
18	40384277	.	T	A	3	5	8	0	1	9	0	0
18	40387506	.	C	T	10	8	18	0	1	19	0	0
18	40387606	.	G	A	6	12	18	0	1	19	0	0
18	40387650	.	T	A	8	11	19	0	0	19	0	0
18	40387811	.	T	A	5	8	13	0	2	15	0	0
18	40486632	.	A	G	2	2	4	0	2	6	0	0
18	40489539	.	G	A	3	5	8	0	2	10	0	0
18	40492253	.	T	C	7	3	10	0	1	11	0	0
18	41278299	.	G	A	1	3	4	0	0	4	0	0
18	41284700	.	C	T	1	2	3	0	0	3	0	0
18	41284802	.	G	A	2	1	3	0	1	4	0	0
18	41295246	.	C	T	3	1	4	0	1	5	0	0
18	41300057	.	T	G	0	0	0	0	1	1	0	0
18	41300063	.	A	G	1	0	1	0	1	2	0	0
18	41305867	.	C	T	7	4	11	0	0	11	0	0
18	41309305	.	G	A	11	1	12	0	2	14	0	0
18	41310464	.	G	A	0	16	16	0	17	33	0	0
18	41364890	.	T	C	0	2	2	0	1	3	0	0
18	41365649	.	G	T	1	1	2	0	1	3	0	0
18	41495859	.	A	G	12	17	29	0	1	30	0	0
18	41495865	.	A	T	11	15	26	0	2	28	0	0
18	41499679	.	A	G	12	7	19	0	1	20	0	0
18	41499683	.	T	C	13	7	20	0	1	21	0	0
18	41499789	.	C	T	5	5	10	0	0	10	0	0
18	41503578	.	C	A	19	17	36	0	5	41	0	0
18	41509564	.	C	G	20	11	31	0	0	31	0	0
18	41509716	.	G	T	20	6	26	0	4	30	0	0
18	41512217	.	C	T	4	13	17	0	0	17	0	0
18	41512370	.	G	A	6	3	9	0	0	9	0	0
18	41514977	.	C	A	2	5	7	0	0	7	0	0
18	41524354	.	G	A	8	10	18	0	3	21	0	0
18	41524364	.	C	A	10	11	21	0	0	21	0	0
18	41525864	.	T	C	24	19	43	0	1	44	0	0
18	41525880	.	G	A	1	18	19	0	25	44	0	0
18	41526014	.	C	G	15	0	15	0	26	41	0	0
18	41526026	.	A	G	15	23	38	0	1	39	0	0
18	41526247	.	T	A	18	17	35	0	5	40	0	0
18	41526299	.	T	A	11	18	29	0	3	32	0	0
18	41526318	.	A	G	11	16	27	0	4	31	0	0
18	41526380	.	C	T	4	6	10	0	1	11	0	0
18	41526381	.	T	C	5	5	10	0	1	11	0	0
18	41533072	.	C	T	2	6	8	0	0	8	0	0
18	41538770	.	G	A	4	13	17	0	0	17	0	0
18	41538856	.	G	A	0	5	5	0	0	5	0	0
18	41539039	.	C	T	1	3	4	0	0	4	0	0
18	41542632	.	A	G	1	3	4	0	0	4	0	0
18	41542661	.	A	T	1	1	2	0	0	2	0	0
18	41542790	.	T	G	4	2	6	0	0	6	0	0
18	41543076	.	C	T	5	6	11	0	0	11	0	0
18	41547273	.	T	G	1	2	3	0	2	5	0	0
18	41547308	.	C	T	1	2	3	0	1	4	0	0
18	41549817	.	T	A	1	3	4	0	0	4	0	0
18	41558711	.	C	T	4	5	9	0	2	11	0	0
18	41561248	.	C	T	1	1	2	0	1	3	0	0
18	41573681	.	T	C	1	3	4	0	0	4	0	0
18	41573948	.	G	A	0	2	2	0	2	4	0	0
18	41574155	.	A	G	2	2	4	0	0	4	0	0
18	41574557	.	T	C	4	3	7	0	0	7	0	0
18	41574608	.	T	C	4	4	8	0	0	8	0	0
18	41579975	.	T	A	3	4	7	0	0	7	0	0
18	41580151	.	A	T	4	4	8	0	1	9	0	0
18	41586440	.	T	C	5	3	8	0	0	8	0	0
18	41588148	.	A	G	4	0	4	0	1	5	0	0
18	41588166	.	C	T	2	1	3	0	0	3	0	0
18	41589613	.	A	C	0	4	4	0	0	4	0	0
18	41648941	.	T	C	11	11	22	0	0	22	0	0
18	41649061	.	C	T	8	11	19	0	1	20	0	0
18	41649571	.	A	G	5	9	14	0	0	14	0	0
18	41650171	.	C	T	3	2	5	0	1	6	0	0
18	41650222	.	C	T	7	5	12	0	0	12	0	0
18	41650396	.	G	A	2	4	6	0	1	7	0	0
18	41757350	.	C	A	17	17	34	0	1	35	0	0
18	41757373	.	G	C	24	20	44	0	2	46	0	0
18	41757449	.	G	A	26	24	50	0	2	52	0	0
18	41757454	.	G	A	26	26	52	0	1	53	0	0
18	41757669	.	C	T	1	7	8	0	1	9	0	0
18	41808695	.	T	C	2	2	4	0	0	4	0	0
18	42151412	.	A	C	15	0	15	0	21	36	0	0
18	42165295	.	A	C	2	1	3	0	0	3	0	0
18	42201141	.	C	G	1	1	2	0	0	2	0	0
18	43162650	.	T	C	2	4	6	0	1	7	0	0
18	43183845	.	T	C	1	5	6	0	0	6	0	0
18	43225614	.	T	C	8	7	15	0	0	15	0	0
18	43225650	.	C	T	7	14	21	0	2	23	0	0
18	43225683	.	C	T	10	11	21	0	5	26	0	0
18	43225896	.	C	T	19	21	40	0	3	43	0	0
18	44321063	.	A	G	9	5	14	0	1	15	0	0
18	44321260	.	T	A	11	5	16	0	1	17	0	0
18	44321323	.	C	T	6	2	8	0	3	11	0	0
18	44321909	.	G	A	2	7	9	0	3	12	0	0
18	44321949	.	T	C	3	10	13	0	0	13	0	0
18	44321950	.	T	C	6	7	13	0	0	13	0	0
18	44322280	.	T	C	2	2	4	0	0	4	0	0
18	44322481	.	C	T	0	15	15	0	8	23	0	0
18	44325470	.	A	G	0	2	2	0	0	2	0	0
18	44325526	.	A	T	5	2	7	0	1	8	0	0
18	44327944	.	A	G	3	4	7	0	0	7	0	0
18	44327953	.	G	A	2	3	5	0	0	5	0	0
18	44331117	.	G	C	1	3	4	0	0	4	0	0
18	44332725	.	C	T	2	4	6	0	0	6	0	0
18	44364647	.	C	A	31	22	53	0	2	55	0	0
18	44365064	.	C	A	16	31	47	0	5	52	0	0
18	44365114	.	T	A	36	23	59	0	2	62	1	0
18	44365650	.	T	C	15	15	30	0	4	34	0	0
18	44365714	.	C	A	17	23	40	0	2	42	0	0
18	44365717	.	A	G	18	24	42	0	1	43	0	0
18	44365977	.	T	C	12	22	34	0	0	34	0	0
18	44365987	.	T	A	13	23	36	0	0	36	0	0
18	44367241	.	A	T	6	12	18	0	2	20	0	0
18	44367426	.	C	T	27	15	42	0	2	44	0	0
18	44367488	.	G	A	7	10	17	0	1	18	0	0
18	44377404	.	C	A	3	2	5	0	0	5	0	0
18	44377417	.	C	T	3	2	5	0	0	5	0	0
18	44388421	.	C	T	10	3	13	0	1	14	0	0
18	44397330	.	G	A	2	2	4	0	0	4	0	0
18	44404609	.	C	T	2	1	3	0	1	4	0	0
18	44404872	.	C	T	0	0	0	0	1	1	0	0
18	44408841	.	G	A	2	0	2	0	0	2	0	0
18	44418164	.	C	T	5	3	8	0	0	8	0	0
18	44425150	.	A	C	3	5	8	0	0	8	0	0
18	44587696	.	C	A	3	2	5	0	0	5	0	0
18	44587777	.	C	A	0	0	0	0	1	1	0	0
18	44589770	.	G	C	6	3	9	0	1	10	0	0
18	44597048	.	G	A	2	3	5	0	0	5	0	0
18	44597308	.	C	A	18	23	41	0	3	44	0	0
18	44597850	.	A	G	13	7	20	0	1	21	0	0
18	44597884	.	G	A	12	11	23	0	0	23	0	0
18	44598234	.	C	T	0	11	11	0	11	22	0	0
18	44598371	.	C	T	9	14	23	0	0	23	0	0
18	44599837	.	G	A	5	8	13	0	0	13	0	0
18	44606194	.	G	A	1	0	1	0	1	2	0	0
18	44615685	.	G	A	9	9	18	0	2	20	0	0
18	44615770	.	G	A	13	17	30	0	1	31	0	0
18	44615819	.	T	C	17	10	27	0	1	28	0	0
18	44615861	.	A	T	6	9	15	0	0	15	0	0
18	44618795	.	G	T	10	3	13	0	2	15	0	0
18	44619049	.	T	G	4	14	18	0	0	18	0	0
18	44623527	.	G	A	2	6	8	0	1	9	0	0
18	44637835	.	A	T	3	3	6	0	0	6	0	0
18	44637898	.	G	A	2	1	3	0	1	4	0	0
18	44638087	.	G	T	0	2	2	0	3	5	0	0
18	44640464	.	C	T	2	1	3	0	0	3	0	0
18	44644443	.	C	A	4	6	10	0	0	10	0	0
18	44645008	.	A	T	4	9	13	0	4	17	0	0
18	44645350	.	A	G	1	0	1	0	6	7	0	0
18	44645368	.	T	C	1	5	6	0	0	6	0	0
18	44645617	.	G	A	0	12	12	0	4	16	0	0
18	44645782	.	G	C	7	7	14	0	2	16	0	0
18	44645870	.	T	A	8	11	19	0	1	20	0	0
18	44646048	.	C	T	4	4	8	0	0	8	0	0
18	44646215	.	C	T	5	9	14	0	0	14	0	0
18	44646467	.	A	C	13	10	23	0	1	24	0	0
18	44646504	.	C	T	12	10	22	0	2	24	0	0
18	44646587	.	G	A	0	15	15	0	13	28	0	0
18	44646678	.	C	T	12	9	21	0	1	22	0	0
18	44646781	.	A	G	10	8	18	0	1	19	0	0
18	44696319	.	A	C	2	7	9	0	0	9	0	0
18	44696451	.	A	T	3	4	7	0	0	7	0	0
18	44782413	.	G	A	0	2	2	0	0	2	0	0
18	44783396	.	G	A	0	1	1	0	2	3	0	0
18	44783399	.	G	C	1	2	3	0	0	3	0	0
18	44783771	.	C	T	0	2	2	0	0	2	0	0
18	44790635	.	A	G	3	5	8	0	0	8	0	0
18	44790722	.	G	A	5	4	9	0	0	9	0	0
18	44791251	.	A	C	1	2	3	0	0	3	0	0
18	44791258	.	C	G	0	0	0	0	3	3	0	0
18	44791774	.	A	G	1	6	7	0	0	7	0	0
18	44826427	.	C	T	1	12	13	0	18	31	0	0
18	44826554	.	T	G	14	10	24	0	1	25	0	0
18	44826910	.	C	T	11	2	13	0	1	14	0	0
18	44830217	.	C	T	8	5	13	0	0	13	0	0
18	44830247	.	G	A	14	10	24	0	3	27	0	0
18	44830283	.	G	A	13	10	23	0	0	23	0	0
18	44832693	.	C	A	7	4	11	0	0	11	0	0
18	44837085	.	T	C	1	3	4	0	0	4	0	0
18	44838285	.	G	A	5	5	10	0	0	10	0	0
18	44838342	.	G	A	5	6	11	0	1	12	0	0
18	44840994	.	C	T	6	11	17	0	1	18	0	0
18	44843407	.	G	A	0	1	1	0	0	1	0	0
18	44843531	.	C	A	2	4	6	0	0	6	0	0
18	44852404	.	C	T	1	0	1	0	0	1	0	0
18	44866841	.	C	T	0	2	2	0	0	2	0	0
18	44870505	.	G	A	0	4	4	0	4	8	0	0
18	44870526	.	G	A	0	4	4	0	6	10	0	0
18	44870541	.	G	A	0	4	4	0	6	10	0	0
18	44873083	.	C	T	0	3	3	0	1	4	0	0
18	44873993	.	G	T	3	4	7	0	2	9	0	0
18	44874249	.	T	G	9	0	9	0	6	15	0	0
18	44874252	.	C	T	9	5	14	0	1	15	0	0
18	44913653	.	G	T	8	3	11	0	0	11	0	0
18	45257475	.	C	T	3	1	4	0	0	4	0	0
18	45259930	.	C	T	3	2	5	0	0	5	0	0
18	45260228	.	T	C	2	3	5	0	0	5	0	0
18	45260595	.	A	G	2	4	6	0	0	6	0	0
18	45261319	.	A	T	2	5	7	0	0	7	0	0
18	45261369	.	G	T	4	8	12	0	1	13	0	0
18	45261438	.	G	A	4	4	8	0	0	8	0	0
18	45261501	.	G	C	3	2	5	0	0	5	0	0
18	45261845	.	T	A	2	6	8	0	0	8	0	0
18	45261882	.	T	C	6	4	10	0	0	10	0	0
18	45262351	.	C	T	5	8	13	0	0	13	0	0
18	45262687	.	G	T	7	11	18	0	1	19	0	0
18	45262855	.	A	C	12	5	17	0	0	17	0	0
18	45262865	.	T	C	11	5	16	0	1	17	0	0
18	45550831	.	G	C	0	9	9	0	9	18	0	0
18	45550839	.	A	C	11	8	19	0	0	19	0	0
18	45561677	.	G	T	1	0	1	0	0	1	0	0
18	45569075	.	C	A	11	6	17	0	1	18	0	0
18	45569092	.	A	G	9	0	9	0	6	15	0	0
18	45574140	.	A	G	10	17	27	0	1	28	0	0
18	45574275	.	A	T	2	1	3	0	0	3	0	0
18	45575079	.	G	A	0	6	6	0	13	19	0	0
18	45581704	.	C	A	6	4	10	0	0	10	0	0
18	45581784	.	C	T	0	1	1	0	0	1	0	0
18	45583038	.	A	C	5	6	11	0	2	13	0	0
18	45583042	.	G	A	0	5	5	0	5	10	0	0
18	45584036	.	C	T	8	7	15	0	0	15	0	0
18	45584368	.	T	C	21	17	38	0	1	39	0	0
18	45588336	.	C	T	15	8	23	0	0	23	0	0
18	45591836	.	A	T	11	12	23	0	2	25	0	0
18	45591929	.	G	A	12	12	24	0	0	24	0	0
18	45647838	.	G	A	0	0	0	0	1	1	0	0
18	45647940	.	C	T	7	4	11	0	0	11	0	0
18	45649613	.	C	T	8	6	14	0	1	15	0	0
18	45649658	.	G	T	12	12	24	0	1	25	0	0
18	45651032	.	C	T	2	5	7	0	0	7	0	0
18	45651559	.	T	A	4	5	9	0	0	9	0	0
18	45656062	.	T	C	11	6	17	0	1	18	0	0
18	45656089	.	T	C	3	3	6	0	0	6	0	0
18	45686398	.	C	T	0	2	2	0	0	2	0	0
18	45686500	.	A	G	2	4	6	0	0	6	0	0
18	45686840	.	T	C	7	5	12	0	0	12	0	0
18	45687882	.	C	T	2	4	6	0	0	6	0	0
18	45689081	.	C	T	5	1	6	0	0	6	0	0
18	45691123	.	G	A	3	3	6	0	1	7	0	0
18	45697623	.	A	G	3	5	8	0	0	8	0	0
18	45697999	.	T	C	3	5	8	0	0	8	0	0
18	45698344	.	C	A	2	8	10	0	0	10	0	0
18	45734477	.	T	C	13	6	19	0	2	21	0	0
18	45742051	.	C	A	8	8	16	0	2	18	0	0
18	45742059	.	G	A	7	7	14	0	4	18	0	0
18	45743518	.	G	A	4	1	5	0	0	5	0	0
18	45743522	.	G	A	4	1	5	0	0	5	0	0
18	45743555	.	C	A	4	1	5	0	0	5	0	0
18	45745504	.	A	T	0	5	5	0	0	5	0	0
18	45750912	.	A	C	3	0	3	0	3	6	0	0
18	45750915	.	A	G	3	3	6	0	0	6	0	0
18	45759309	.	G	T	5	8	13	0	0	13	0	0
18	45784225	.	A	G	23	44	67	0	5	72	0	0
18	45807903	.	C	G	0	0	0	0	8	8	0	0
18	45809892	.	T	C	1	2	3	0	0	3	0	0
18	45818602	.	C	T	9	8	17	0	1	18	0	0
18	45820588	.	A	G	10	8	18	0	0	18	0	0
18	45824315	.	C	T	8	13	21	0	0	21	0	0
18	45824467	.	G	A	0	8	8	0	12	20	0	0
18	45824607	.	G	A	0	1	1	0	0	1	0	0
18	45835115	.	C	T	3	2	5	0	0	5	0	0
18	45840471	.	T	A	10	11	21	0	2	23	0	0
18	45840504	.	C	T	12	10	22	0	1	23	0	0
18	45842491	.	T	C	7	5	12	0	1	13	0	0
18	45842679	.	G	A	0	9	9	0	7	16	0	0
18	45844458	.	C	T	14	14	28	0	2	30	0	0
18	45844473	.	A	T	11	19	30	0	4	34	0	0
18	45848355	.	C	T	2	1	3	0	0	3	0	0
18	45849283	.	C	T	13	10	23	0	2	25	0	0
18	45851540	.	G	A	1	7	8	0	8	16	0	0
18	45886957	.	G	T	1	2	3	0	0	3	0	0
18	45944903	.	G	T	1	2	3	0	0	3	0	0
18	45962500	.	A	G	3	5	8	0	0	8	0	0
18	45962581	.	T	C	9	3	12	0	2	14	0	0
18	45962593	.	G	C	7	5	12	0	0	12	0	0
18	45962668	.	C	T	7	13	20	0	5	25	0	0
18	45969252	.	C	A	3	2	5	0	0	5	0	0
18	45979887	.	C	T	5	2	7	0	1	8	0	0
18	45983268	.	A	C	18	18	36	0	4	40	0	0
18	46005023	.	T	A	1	2	3	0	0	3	0	0
18	46012631	.	C	T	3	0	3	0	0	3	0	0
18	46059425	.	A	C	1	2	3	0	0	3	0	0
18	46061242	.	G	A	2	3	5	0	1	6	0	0
18	46061326	.	C	A	4	2	6	0	0	6	0	0
18	46367733	.	G	A	3	5	8	0	1	9	0	0
18	46367772	.	C	G	0	5	5	0	7	12	0	0
18	46368513	.	T	C	7	1	8	0	6	14	0	0
18	46368771	.	C	T	0	2	2	0	3	5	0	0
18	46368924	.	C	A	2	2	4	0	0	4	0	0
18	46417181	.	C	T	3	4	7	0	0	7	0	0
18	46417342	.	A	G	11	26	37	0	3	40	0	0
18	46417402	.	G	A	14	15	29	0	0	29	0	0
18	46417624	.	T	C	13	8	21	0	1	22	0	0
18	46417714	.	G	C	17	5	22	0	1	23	0	0
18	46418632	.	G	A	7	4	11	0	3	14	0	0
18	46418818	.	C	A	4	5	9	0	1	10	0	0
18	46418860	.	C	T	0	7	7	0	6	13	0	0
18	46419056	.	C	T	5	7	12	0	0	12	0	0
18	46419124	.	T	C	3	3	6	0	1	7	0	0
18	46419275	.	T	C	3	5	8	0	2	10	0	0
18	46419451	.	A	T	0	2	2	0	0	2	0	0
18	46419616	.	T	C	4	5	9	0	0	9	0	0
18	46634544	.	T	C	3	2	5	0	1	6	0	0
18	46635591	.	C	T	5	2	7	0	0	7	0	0
18	46635805	.	C	G	2	4	6	0	0	6	0	0
18	46699773	.	G	A	19	13	32	0	2	34	0	0
18	46702492	.	G	A	9	3	12	0	0	12	0	0
18	47301204	.	T	C	2	3	5	0	0	5	0	0
18	47305433	.	A	G	0	3	3	0	0	3	0	0
18	47306677	.	T	G	4	2	6	0	0	6	0	0
18	47306782	.	A	G	3	9	12	0	0	12	0	0
18	48642856	.	T	A	5	2	7	0	0	7	0	0
18	48643055	.	A	G	3	2	5	0	0	5	0	0
18	48696303	.	C	A	1	2	3	0	0	3	0	0
18	48808099	.	A	G	2	1	3	0	2	5	0	0
18	48808552	.	T	C	1	4	5	0	0	5	0	0
18	48808659	.	G	A	0	3	3	0	3	6	0	0
18	48808708	.	T	A	3	4	7	0	0	7	0	0
18	48809226	.	G	A	3	7	10	0	0	10	0	0
18	48809268	.	T	A	1	2	3	0	0	3	0	0
18	48809276	.	A	G	1	0	1	0	1	2	0	0
18	48864665	.	C	T	3	3	6	0	0	6	0	0
18	48864668	.	T	C	3	3	6	0	0	6	0	0
18	48864856	.	T	C	1	2	3	0	0	3	0	0
18	48864944	.	C	T	4	2	6	0	0	6	0	0
18	48928230	.	C	T	6	13	19	0	0	19	0	0
18	48928240	.	A	G	7	0	7	0	14	21	0	0
18	48928342	.	A	G	10	1	11	0	8	19	0	0
18	48928387	.	T	A	11	8	19	0	1	20	0	0
18	48934524	.	T	C	4	11	15	0	0	15	0	0
18	48934593	.	T	C	1	2	3	0	0	3	0	0
18	48934805	.	A	G	14	7	21	0	1	22	0	0
18	48934833	.	T	C	16	8	24	0	0	24	0	0
18	48935170	.	G	A	17	15	32	0	2	34	0	0
18	48935279	.	T	G	22	18	40	0	1	41	0	0
18	48935282	.	T	G	23	17	40	0	3	43	0	0
18	48935394	.	A	T	14	12	26	0	2	28	0	0
18	48935709	.	A	G	8	27	35	0	0	35	0	0
18	48951382	.	C	T	1	1	2	0	1	3	0	0
18	48971165	.	T	C	1	2	3	0	0	3	0	0
18	48971192	.	A	G	0	1	1	0	0	1	0	0
18	48972490	.	A	T	4	5	9	0	1	10	0	0
18	49154130	.	A	G	6	6	12	0	0	12	0	0
18	49154131	.	A	G	8	3	11	0	1	12	0	0
18	49154328	.	G	A	3	9	12	0	3	15	0	0
18	49154458	.	G	T	10	9	19	0	1	20	0	0
18	49154483	.	G	T	0	8	8	0	15	23	0	0
18	49154525	.	C	T	15	13	28	0	1	29	0	0
18	49154527	.	T	C	13	11	24	0	5	29	0	0
18	49154722	.	A	G	15	9	24	0	0	24	0	0
18	49155045	.	A	G	6	0	6	0	8	14	0	0
18	49155211	.	C	A	15	6	21	0	0	21	0	0
18	49155303	.	G	A	6	3	9	0	0	9	0	0
18	49155941	.	C	T	9	10	19	0	0	20	1	0
18	49155956	.	T	C	10	17	27	0	0	27	0	0
18	49155976	.	A	T	5	17	22	0	0	22	0	0
18	49156009	.	G	C	5	14	19	0	1	20	0	0
18	49156034	.	A	C	10	3	13	0	1	14	0	0
18	49156077	.	A	G	13	0	13	0	12	25	0	0
18	49156145	.	A	G	2	3	5	0	0	5	0	0
18	49156370	.	A	G	4	4	8	0	1	9	0	0
18	49156437	.	T	A	4	5	9	0	1	10	0	0
18	49156444	.	G	A	6	5	11	0	0	11	0	0
18	49156482	.	G	T	6	6	12	0	1	13	0	0
18	49214171	.	A	G	2	2	4	0	0	4	0	0
18	49214441	.	C	T	1	4	5	0	0	5	0	0
18	49244819	.	C	A	3	5	8	0	1	9	0	0
18	49244821	.	C	A	3	6	9	0	0	9	0	0
18	49245256	.	G	C	4	5	9	0	0	9	0	0
18	49245686	.	T	C	1	2	3	0	0	3	0	0
18	49246672	.	T	A	5	5	10	0	0	10	0	0
18	49246956	.	T	C	1	2	3	0	0	3	0	0
18	49246964	.	T	A	1	2	3	0	0	3	0	0
18	49247010	.	A	G	3	2	5	0	0	5	0	0
18	49247020	.	T	C	4	2	6	0	0	6	0	0
18	49248524	.	G	T	1	6	7	0	0	7	0	0
18	49261687	.	T	C	0	3	3	0	0	3	0	0
18	49265001	.	G	T	6	13	19	0	0	19	0	0
18	49265002	.	G	T	5	13	18	0	1	19	0	0
18	49266589	.	A	G	4	5	9	0	0	9	0	0
18	49266635	.	A	G	6	5	11	0	0	11	0	0
18	49266636	.	A	G	5	6	11	0	0	11	0	0
18	49266715	.	C	T	3	3	6	0	0	6	0	0
18	49266746	.	A	G	4	4	8	0	0	8	0	0
18	49266998	.	A	G	1	3	4	0	1	5	0	0
18	49267011	.	A	G	4	0	4	0	2	6	0	0
18	49267415	.	T	C	1	1	2	0	1	3	0	0
18	49267416	.	G	T	2	1	3	0	0	3	0	0
18	49267458	.	A	T	1	2	3	0	0	3	0	0
18	49267489	.	A	G	2	3	5	0	0	5	0	0
18	49267605	.	A	G	10	3	13	0	0	13	0	0
18	49267645	.	T	A	8	5	13	0	0	13	0	0
18	49267665	.	A	T	6	5	11	0	1	12	0	0
18	49267682	.	T	A	7	6	13	0	0	13	0	0
18	49267701	.	A	T	6	5	11	0	0	11	0	0
18	49274317	.	C	T	1	3	4	0	0	4	0	0
18	49274372	.	A	T	1	3	4	0	0	4	0	0
18	49274468	.	A	T	2	2	4	0	0	4	0	0
18	49274688	.	A	T	1	2	3	0	0	3	0	0
18	49412259	.	T	C	2	2	4	0	0	4	0	0
18	49428793	.	T	C	4	4	8	0	1	9	0	0
18	49446293	.	C	G	3	6	9	0	1	10	0	0
18	49446312	.	G	A	0	6	6	0	4	10	0	0
18	49446881	.	T	C	4	2	6	0	0	6	0	0
18	49447008	.	C	A	5	5	10	0	0	10	0	0
18	49447041	.	G	A	0	5	5	0	8	13	0	0
18	49969646	.	A	G	3	0	3	0	3	6	0	0
18	50037820	.	C	T	4	3	7	0	0	7	0	0
18	50038720	.	T	G	5	8	13	0	0	13	0	0
18	50038721	.	G	T	5	5	10	0	3	13	0	0
18	50038872	.	T	C	3	2	5	0	0	5	0	0
18	50039295	.	C	A	3	2	5	0	0	5	0	0
18	50039536	.	G	A	0	3	3	0	3	6	0	0
18	50039684	.	T	C	5	7	12	0	0	12	0	0
18	50039852	.	G	T	13	9	22	0	1	23	0	0
18	50039939	.	C	T	9	5	14	0	2	16	0	0
18	50276173	.	C	T	17	7	24	0	3	27	0	0
18	50276435	.	G	A	10	10	20	0	0	20	0	0
18	50276476	.	C	G	4	4	8	0	0	8	0	0
18	50279112	.	A	T	20	20	40	0	2	42	0	0
18	50353650	.	C	T	19	34	53	0	0	53	0	0
18	50356440	.	G	A	31	15	46	0	8	54	0	0
18	50356518	.	C	A	24	28	52	0	8	60	0	0
18	50356532	.	G	A	24	27	51	0	3	54	0	0
18	50356632	.	T	C	18	28	46	0	5	51	0	0
18	50443666	.	T	C	1	7	8	0	3	11	0	0
18	50443722	.	G	T	3	3	6	0	1	7	0	0
18	50443851	.	G	A	2	4	6	0	1	7	0	0
18	50443868	.	T	A	3	2	5	0	0	5	0	0
18	50529552	.	T	A	1	3	4	0	0	4	0	0
18	50532421	.	C	T	8	3	11	0	0	11	0	0
18	50536290	.	A	T	7	4	11	0	1	12	0	0
18	50536843	.	C	T	2	6	8	0	6	14	0	0
18	50537884	.	G	A	15	12	27	0	1	28	0	0
18	50538019	.	A	C	9	10	19	0	0	19	0	0
18	50538020	.	G	A	9	10	19	0	0	19	0	0
18	50538235	.	T	C	10	3	13	0	0	13	0	0
18	50538268	.	A	G	6	10	16	0	0	16	0	0
18	50538340	.	T	C	4	14	18	0	0	18	0	0
18	50538442	.	T	C	10	6	16	0	0	16	0	0
18	50538704	.	T	C	10	4	14	0	1	15	0	0
18	50538760	.	G	A	4	6	10	0	0	10	0	0
18	50539041	.	G	T	8	6	14	0	1	15	0	0
18	50539271	.	G	A	2	3	5	0	2	7	0	0
18	50539341	.	G	C	7	4	11	0	0	11	0	0
18	50579546	.	G	A	2	2	4	0	0	4	0	0
18	50579551	.	C	T	2	1	3	0	1	4	0	0
18	50601149	.	G	A	3	4	7	0	2	9	0	0
18	50601426	.	C	G	3	3	6	0	0	6	0	0
18	50601630	.	C	A	15	11	26	0	1	27	0	0
18	50601636	.	A	G	11	13	24	0	4	28	0	0
18	50614145	.	T	A	2	7	9	0	1	10	0	0
18	50689583	.	G	A	1	0	1	0	0	1	0	0
18	50911951	.	T	C	0	6	6	0	1	7	0	0
19	371856	.	A	G	4	2	6	0	1	7	0	0
19	372209	.	A	G	2	2	4	0	1	5	0	0
19	372211	.	A	G	1	4	5	0	0	5	0	0
19	372768	.	A	G	11	0	11	0	5	16	0	0
19	981432	.	C	T	0	4	4	0	7	11	0	0
19	981483	.	A	G	2	1	3	0	0	3	0	0
19	983651	.	T	G	2	1	3	0	0	3	0	0
19	985629	.	T	C	1	1	2	0	3	5	0	0
19	985638	.	G	C	1	3	4	0	0	4	0	0
19	987655	.	T	A	2	2	4	0	0	4	0	0
19	1010434	.	G	C	0	3	3	0	2	5	0	0
19	1010529	.	C	A	1	2	3	0	1	4	0	0
19	1010901	.	C	T	1	2	3	0	0	3	0	0
19	1010904	.	T	A	1	2	3	0	0	3	0	0
19	1011091	.	C	T	1	2	3	0	0	3	0	0
19	1011329	.	C	A	1	3	4	0	1	5	0	0
19	1011359	.	G	T	1	4	5	0	0	5	0	0
19	1011400	.	C	T	2	3	5	0	0	5	0	0
19	1011917	.	T	C	1	2	3	0	0	3	0	0
19	1011926	.	T	C	1	2	3	0	0	3	0	0
19	1011955	.	T	G	1	3	4	0	0	4	0	0
19	1012048	.	G	A	0	7	7	0	4	11	0	0
19	1012459	.	A	G	2	1	3	0	1	4	0	0
19	1012474	.	T	C	3	2	5	0	2	7	0	0
19	1012888	.	A	T	5	5	10	0	1	11	0	0
19	1021490	.	C	T	1	0	1	0	0	1	0	0
19	1097579	.	A	G	2	0	2	0	4	6	0	0
19	1097613	.	T	C	2	1	3	0	0	3	0	0
19	1097616	.	T	C	2	1	3	0	0	3	0	0
19	1110528	.	G	A	4	8	12	0	2	14	0	0
19	1111871	.	T	C	12	11	23	0	0	23	0	0
19	1111882	.	G	T	12	11	23	0	0	23	0	0
19	1111982	.	T	G	4	2	6	0	0	6	0	0
19	1111983	.	G	A	4	2	6	0	0	6	0	0
19	1112032	.	C	A	3	3	6	0	1	7	0	0
19	1112121	.	T	C	2	6	8	0	0	8	0	0
19	1112467	.	G	T	3	3	6	0	0	6	0	0
19	1185244	.	T	C	3	3	6	0	0	6	0	0
19	1185281	.	G	A	2	3	5	0	0	5	0	0
19	1185343	.	G	A	0	8	8	0	5	13	0	0
19	1185485	.	A	G	4	5	9	0	4	13	0	0
19	1331064	.	G	T	6	4	10	0	1	11	0	0
19	1331105	.	T	A	2	5	7	0	1	8	0	0
19	1331146	.	C	A	8	9	17	0	0	17	0	0
19	1331394	.	T	G	4	6	10	0	1	11	0	0
19	1359700	.	T	G	2	2	4	0	0	4	0	0
19	1359703	.	G	A	2	2	4	0	0	4	0	0
19	1361459	.	C	T	1	0	1	0	0	1	0	0
19	1362021	.	T	G	2	2	4	0	0	4	0	0
19	1370714	.	A	G	2	3	5	0	0	5	0	0
19	1370725	.	A	C	2	1	3	0	0	3	0	0
19	1385881	.	A	G	0	1	1	0	0	1	0	0
19	1392134	.	G	A	1	15	16	0	10	26	0	0
19	1392482	.	T	C	3	10	13	0	0	13	0	0
19	1392544	.	T	A	3	9	12	0	0	12	0	0
19	1392565	.	A	G	4	11	15	0	0	15	0	0
19	1392586	.	T	A	3	15	18	0	1	19	0	0
19	1393073	.	T	A	12	25	37	0	1	38	0	0
19	1393085	.	C	A	12	21	33	0	0	33	0	0
19	1393176	.	C	T	4	9	13	0	4	17	0	0
19	1393199	.	A	G	9	7	16	0	1	17	0	0
19	1406549	.	A	C	6	5	11	0	1	12	0	0
19	1406593	.	T	G	7	6	13	0	0	13	0	0
19	1406751	.	C	T	3	6	9	0	0	9	0	0
19	1406760	.	A	T	3	5	8	0	0	8	0	0
19	1406795	.	A	C	3	4	7	0	1	8	0	0
19	1406967	.	G	T	4	3	7	0	1	8	0	0
19	1407104	.	A	C	5	2	7	0	0	7	0	0
19	1407181	.	T	A	5	2	7	0	0	7	0	0
19	1407396	.	A	G	3	6	9	0	2	11	0	0
19	1411036	.	C	A	1	2	3	0	0	3	0	0
19	1411076	.	A	G	1	3	4	0	1	5	0	0
19	1684972	.	C	T	2	3	5	0	0	5	0	0
19	1790838	.	A	G	1	2	3	0	0	3	0	0
19	1848239	.	G	A	4	7	11	0	0	11	0	0
19	1848298	.	A	G	2	4	6	0	0	6	0	0
19	1848301	.	G	A	0	4	4	0	2	6	0	0
19	1848334	.	T	C	2	5	7	0	0	7	0	0
19	1852303	.	T	C	11	14	25	0	4	29	0	0
19	1853802	.	A	G	1	3	4	0	1	5	0	0
19	1853826	.	T	C	1	4	5	0	2	7	0	0
19	1856458	.	T	G	9	6	15	0	1	16	0	0
19	1856556	.	C	G	11	14	25	0	2	27	0	0
19	1856641	.	T	A	15	3	18	0	0	18	0	0
19	1856716	.	A	C	5	4	9	0	0	9	0	0
19	1858785	.	G	A	2	1	3	0	0	3	0	0
19	1868327	.	A	G	0	1	1	0	0	1	0	0
19	1868460	.	C	T	0	1	1	0	1	2	0	0
19	1872897	.	G	A	11	11	22	0	0	22	0	0
19	1877255	.	A	G	14	1	15	0	21	36	0	0
19	1877288	.	T	C	12	23	35	0	5	40	0	0
19	1877536	.	G	C	20	13	33	0	1	34	0	0
19	1877544	.	G	T	21	11	32	0	1	33	0	0
19	1877737	.	A	C	1	2	3	0	0	3	0	0
19	1878618	.	G	A	3	4	7	0	2	9	0	0
19	1878630	.	C	G	3	6	9	0	0	9	0	0
19	1880602	.	T	C	1	4	5	0	0	5	0	0
19	1880836	.	G	A	0	2	2	0	0	2	0	0
19	1880886	.	T	C	2	3	5	0	0	5	0	0
19	1953569	.	A	G	9	16	25	0	0	25	0	0
19	1953583	.	G	T	13	14	27	0	0	27	0	0
19	1960987	.	T	G	14	9	23	0	1	24	0	0
19	1960997	.	T	C	13	10	23	0	3	26	0	0
19	1990839	.	G	C	2	2	4	0	0	4	0	0
19	1995229	.	G	A	0	2	2	0	1	3	0	0
19	1995404	.	G	A	2	2	4	0	2	6	0	0
19	1995499	.	G	T	3	4	7	0	1	8	0	0
19	1995915	.	A	G	3	0	3	0	5	8	0	0
19	1995925	.	C	A	2	2	4	0	0	4	0	0
19	1995982	.	G	C	3	2	5	0	0	5	0	0
19	1996444	.	C	T	4	3	7	0	1	8	0	0
19	1996452	.	A	G	4	3	7	0	2	9	0	0
19	1996494	.	G	T	0	2	2	0	6	8	0	0
19	1996504	.	T	C	4	2	6	0	0	6	0	0
19	1996550	.	G	A	3	2	5	0	0	5	0	0
19	1996776	.	G	A	5	7	12	0	0	12	0	0
19	1996831	.	A	C	3	3	6	0	0	6	0	0
19	1997326	.	G	T	0	4	4	0	2	6	0	0
19	1997495	.	C	G	4	2	6	0	0	6	0	0
19	1997521	.	A	G	4	3	7	0	0	7	0	0
19	1997538	.	G	C	5	4	9	0	0	9	0	0
19	1997638	.	T	A	5	5	10	0	0	10	0	0
19	1997733	.	C	T	4	0	4	0	0	4	0	0
19	1997767	.	C	G	3	2	5	0	1	6	0	0
19	1997781	.	A	T	3	4	7	0	0	7	0	0
19	1997978	.	G	A	6	6	12	0	0	12	0	0
19	1998260	.	G	A	6	5	11	0	0	11	0	0
19	2000142	.	C	G	4	1	5	0	1	6	0	0
19	2001557	.	T	C	0	3	3	0	1	4	0	0
19	2001618	.	A	C	3	2	5	0	0	5	0	0
19	2003767	.	C	T	5	13	18	0	1	19	0	0
19	2003803	.	C	G	6	0	6	0	17	23	0	0
19	2003902	.	A	T	12	5	17	0	2	19	0	0
19	2003962	.	G	T	0	16	16	0	8	24	0	0
19	2004046	.	G	C	11	7	18	0	4	22	0	0
19	2019147	.	C	T	0	0	0	0	1	1	0	0
19	2028006	.	T	C	0	2	2	0	0	2	0	0
19	2064762	.	G	C	1	5	6	0	0	6	0	0
19	2296760	.	A	T	6	2	8	0	0	8	0	0
19	2307268	.	C	T	0	6	6	0	0	6	0	0
19	2315666	.	A	G	4	4	8	0	0	8	0	0
19	2316531	.	A	G	1	2	3	0	0	3	0	0
19	2395783	.	G	C	1	2	3	0	0	3	0	0
19	2396647	.	C	T	1	3	4	0	0	4	0	0
19	2396743	.	A	G	1	3	4	0	0	4	0	0
19	2397822	.	G	A	3	1	4	0	0	4	0	0
19	2550676	.	G	A	1	1	2	0	2	4	0	0
19	2550839	.	C	T	2	5	7	0	0	7	0	0
19	2551214	.	C	T	4	3	7	0	0	7	0	0
19	2560950	.	A	G	2	4	6	0	1	7	0	0
19	2561048	.	A	C	5	2	7	0	3	10	0	0
19	2561739	.	G	A	1	5	6	0	10	16	0	0
19	2602934	.	G	A	3	5	8	0	0	8	0	0
19	2645115	.	C	T	4	2	6	0	0	6	0	0
19	2651272	.	A	G	3	1	4	0	0	4	0	0
19	2651344	.	G	A	0	3	3	0	1	4	0	0
19	2654388	.	A	T	3	9	12	0	0	12	0	0
19	2654424	.	C	T	6	3	9	0	0	9	0	0
19	2663609	.	A	G	10	4	14	0	0	14	0	0
19	2664125	.	G	A	5	7	12	0	4	16	0	0
19	2664394	.	C	T	13	12	25	0	2	27	0	0
19	2664613	.	T	C	10	6	16	0	1	17	0	0
19	2685839	.	T	C	1	3	4	0	0	4	0	0
19	2695314	.	G	A	8	15	23	0	4	27	0	0
19	2695351	.	A	G	6	1	7	0	10	17	0	0
19	2695358	.	G	A	4	8	12	0	0	12	0	0
19	2861399	.	T	A	2	2	4	0	0	4	0	0
19	2871511	.	A	G	5	6	11	0	1	12	0	0
19	2871553	.	C	T	3	5	8	0	0	8	0	0
19	2872162	.	G	A	6	9	15	0	0	15	0	0
19	2877563	.	C	T	1	1	2	0	0	2	0	0
19	2877569	.	G	C	1	2	3	0	0	3	0	0
19	2880160	.	C	T	0	1	1	0	0	1	0	0
19	2882754	.	A	C	2	0	2	0	0	2	0	0
19	2887046	.	G	C	0	2	2	0	1	3	0	0
19	2930521	.	T	C	3	7	10	0	0	10	0	0
19	2934321	.	A	G	0	3	3	0	0	3	0	0
19	2960590	.	G	A	1	2	3	0	0	3	0	0
19	3052828	.	A	G	1	1	2	0	0	2	0	0
19	3052836	.	A	T	1	1	2	0	0	2	0	0
19	3080572	.	G	A	1	2	3	0	0	3	0	0
19	3080580	.	C	A	1	2	3	0	0	3	0	0
19	3080712	.	T	A	4	4	8	0	0	8	0	0
19	3081106	.	C	G	3	1	4	0	2	6	0	0
19	3081122	.	A	T	3	2	5	0	0	5	0	0
19	3081154	.	G	C	3	3	6	0	0	6	0	0
19	3081206	.	G	T	2	4	6	0	0	6	0	0
19	3081927	.	G	A	7	7	14	0	0	14	0	0
19	3081933	.	G	A	0	6	6	0	8	14	0	0
19	3082102	.	C	T	7	5	12	0	1	13	0	0
19	3087025	.	A	G	1	5	6	0	0	6	0	0
19	3137727	.	C	T	0	30	30	0	23	53	0	0
19	3137761	.	C	A	19	17	36	0	3	41	2	0
19	3137803	.	A	T	27	13	40	0	1	41	0	0
19	3138325	.	A	C	14	11	25	0	2	27	0	0
19	3138355	.	T	G	13	7	20	0	2	22	0	0
19	3386141	.	C	T	1	2	3	0	0	3	0	0
19	3386580	.	T	A	7	3	10	0	1	11	0	0
19	3866165	.	T	C	10	7	17	0	2	19	0	0
19	3866179	.	T	C	6	0	6	0	7	13	0	0
19	4010146	.	A	G	2	5	7	0	3	10	0	0
19	4010175	.	C	A	7	9	16	0	1	17	0	0
19	4446667	.	A	G	7	0	7	0	3	10	0	0
19	4856678	.	A	G	1	2	3	0	0	3	0	0
19	4856691	.	G	A	0	2	2	0	1	3	0	0
19	4857526	.	C	T	3	2	5	0	1	6	0	0
19	4857802	.	C	T	2	2	4	0	0	4	0	0
19	4866919	.	T	C	6	9	15	0	1	16	0	0
19	4866936	.	C	T	5	8	13	0	1	14	0	0
19	4866986	.	A	G	5	3	8	0	0	8	0	0
19	4867168	.	G	C	7	6	13	0	3	16	0	0
19	4867232	.	C	A	4	5	9	0	0	9	0	0
19	4867274	.	G	A	0	5	5	0	4	9	0	0
19	4875478	.	G	A	5	4	9	0	0	9	0	0
19	4875529	.	C	T	8	6	14	0	0	14	0	0
19	4875595	.	A	G	3	1	4	0	0	4	0	0
19	4881414	.	T	C	6	6	12	0	0	12	0	0
19	4904774	.	A	G	11	4	15	0	0	15	0	0
19	5077114	.	C	T	1	0	1	0	1	2	0	0
19	5077173	.	C	T	9	3	12	0	0	12	0	0
19	5080124	.	T	A	0	1	1	0	0	1	0	0
19	5081796	.	C	T	21	9	30	0	1	31	0	0
19	5082161	.	C	T	9	15	24	0	2	26	0	0
19	5089755	.	C	G	13	7	20	0	2	22	0	0
19	5090070	.	A	T	23	28	51	0	1	52	0	0
19	5090071	.	G	T	23	29	52	0	0	52	0	0
19	5090368	.	T	C	25	21	46	0	3	49	0	0
19	5090583	.	C	T	9	6	15	0	2	17	0	0
19	5091483	.	T	C	39	24	63	0	7	70	0	0
19	5091503	.	C	T	33	28	61	0	6	67	0	0
19	5091726	.	T	C	5	1	6	0	0	6	0	0
19	5094288	.	G	T	12	5	17	0	1	18	0	0
19	5094417	.	A	T	7	15	22	0	1	23	0	0
19	5094504	.	A	G	9	15	24	0	0	24	0	0
19	5094564	.	T	A	6	9	15	0	1	16	0	0
19	5094591	.	C	T	6	11	17	0	0	17	0	0
19	5100191	.	G	A	7	6	13	0	1	14	0	0
19	5100240	.	G	A	2	0	2	0	0	2	0	0
19	5100249	.	C	T	0	0	0	0	1	1	0	0
19	5100458	.	G	A	2	1	3	0	0	3	0	0
19	5100665	.	C	T	4	3	7	0	2	9	0	0
19	5149133	.	T	C	13	16	29	0	0	29	0	0
19	5149867	.	C	T	13	10	23	0	1	24	0	0
19	5158572	.	G	A	27	25	52	0	15	67	0	0
19	5159083	.	A	T	26	48	74	1	2	77	0	0
19	5159157	.	C	A	27	35	62	0	5	67	0	0
19	5159425	.	C	T	32	25	57	0	3	60	0	0
19	5159534	.	G	A	25	15	40	0	6	46	0	0
19	5160048	.	C	G	26	31	57	0	6	63	0	0
19	5160121	.	T	C	25	0	25	0	34	59	0	0
19	5160201	.	A	G	21	30	51	0	4	55	0	0
19	5161750	.	A	G	24	13	37	0	3	40	0	0
19	5161782	.	C	T	23	14	37	0	2	39	0	0
19	5162252	.	A	T	32	21	53	0	1	54	0	0
19	5162253	.	T	C	33	0	33	0	21	54	0	0
19	5162300	.	T	G	21	26	47	0	1	48	0	0
19	5162544	.	A	G	11	22	33	0	0	33	0	0
19	5162685	.	T	A	17	20	37	0	0	37	0	0
19	5162827	.	C	T	13	9	22	0	5	27	0	0
19	5162923	.	C	T	11	10	21	0	0	21	0	0
19	5162960	.	A	T	8	6	14	0	4	18	0	0
19	5163031	.	C	T	8	13	21	0	1	22	0	0
19	5163127	.	A	T	18	12	30	0	0	30	0	0
19	5163434	.	A	G	17	22	39	0	0	39	0	0
19	5163635	.	C	T	9	10	19	0	2	22	1	0
19	5254510	.	A	G	12	13	25	0	1	26	0	0
19	5299970	.	T	C	2	0	2	0	1	3	0	0
19	5300120	.	T	C	1	2	3	0	0	3	0	0
19	5300211	.	T	A	1	0	1	0	0	1	0	0
19	5300215	.	C	A	1	0	1	0	0	1	0	0
19	5305418	.	A	G	2	2	4	0	1	5	0	0
19	5316439	.	T	C	3	2	5	0	0	5	0	0
19	5318806	.	A	C	3	6	9	0	0	9	0	0
19	5318979	.	G	A	5	2	7	0	5	12	0	0
19	5319096	.	C	G	6	12	18	0	2	20	0	0
19	5320139	.	G	A	8	5	13	0	4	17	0	0
19	5320234	.	T	C	3	5	8	0	0	8	0	0
19	5367858	.	C	A	1	4	5	0	0	5	0	0
19	5368080	.	C	A	1	1	2	0	0	2	0	0
19	5378808	.	T	A	3	1	4	0	0	4	0	0
19	5379587	.	T	C	3	2	5	0	0	5	0	0
19	5379727	.	C	T	1	0	1	0	0	1	0	0
19	5418116	.	T	A	16	15	31	0	1	32	0	0
19	5421086	.	T	A	26	28	54	0	4	58	0	0
19	5421277	.	T	G	24	2	26	0	34	60	0	0
19	5480485	.	T	C	2	1	3	0	0	3	0	0
19	5552442	.	G	A	2	0	2	0	0	2	0	0
19	5582418	.	T	C	2	1	3	0	0	3	0	0
19	5587716	.	C	T	3	3	6	0	1	7	0	0
19	5608628	.	C	G	4	3	7	0	0	7	0	0
19	5610860	.	T	A	1	5	6	0	0	6	0	0
19	5611439	.	G	A	0	7	7	0	9	16	0	0
19	5611586	.	T	C	9	8	17	0	1	18	0	0
19	5615570	.	C	A	0	1	1	0	1	2	0	0
19	5617832	.	T	C	5	8	13	0	1	14	0	0
19	5619685	.	G	A	0	2	2	0	10	12	0	0
19	5619735	.	G	A	23	17	40	0	0	40	0	0
19	5619931	.	A	G	4	9	13	0	1	14	0	0
19	5620011	.	G	A	0	12	12	0	9	21	0	0
19	5620380	.	G	A	22	13	35	0	1	36	0	0
19	5620498	.	T	A	21	13	34	0	0	34	0	0
19	5620525	.	C	T	24	13	37	0	0	37	0	0
19	5620631	.	C	T	9	20	29	0	1	30	0	0
19	5620772	.	G	A	15	14	29	0	3	32	0	0
19	5620810	.	T	C	16	16	32	0	0	32	0	0
19	5621124	.	G	T	23	9	32	0	2	34	0	0
19	5779170	.	C	T	3	9	12	0	1	13	0	0
19	5779601	.	T	C	16	10	26	0	1	27	0	0
19	5779897	.	T	C	21	10	31	0	2	33	0	0
19	5779946	.	G	C	14	12	26	0	1	27	0	0
19	5780032	.	C	G	0	5	5	0	4	9	0	0
19	5780301	.	T	A	1	7	8	0	0	8	0	0
19	5780342	.	A	C	6	0	6	1	7	14	0	0
19	5780989	.	G	A	5	3	8	0	0	8	0	0
19	5781316	.	G	T	5	2	7	0	0	7	0	0
19	5781367	.	T	C	4	5	9	0	2	11	0	0
19	5781397	.	A	G	6	9	15	0	0	15	0	0
19	5781421	.	T	G	4	7	11	0	1	12	0	0
19	5793484	.	C	G	1	4	5	0	0	5	0	0
19	5793532	.	T	C	0	5	5	0	0	5	0	0
19	5805833	.	G	A	4	6	10	0	0	10	0	0
19	5805839	.	G	A	4	5	9	0	1	10	0	0
19	6060309	.	A	T	15	8	23	0	1	24	0	0
19	6073362	.	T	C	0	3	3	0	1	4	0	0
19	6085987	.	A	G	4	5	9	0	0	9	0	0
19	6086441	.	C	G	9	32	41	0	1	42	0	0
19	6086577	.	C	T	1	20	21	0	13	34	0	0
19	6087130	.	T	A	12	8	20	0	0	20	0	0
19	6087146	.	C	T	0	8	8	0	11	19	0	0
19	6087186	.	A	T	8	9	17	0	0	18	1	0
19	6087894	.	G	A	2	7	9	0	1	10	0	0
19	6087948	.	A	T	6	7	13	0	1	14	0	0
19	6088000	.	C	T	0	13	13	0	6	19	0	0
19	6088166	.	T	C	7	6	13	0	0	13	0	0
19	6088259	.	A	C	9	5	14	0	4	18	0	0
19	6088419	.	A	T	5	2	7	0	0	7	0	0
19	6090702	.	T	C	1	5	6	0	1	7	0	0
19	6090732	.	T	A	0	1	1	0	0	1	0	0
19	6097416	.	A	G	4	8	12	0	1	13	0	0
19	6099984	.	G	A	4	3	7	0	2	9	0	0
19	6099992	.	G	A	7	2	9	0	1	10	0	0
19	6100027	.	G	A	4	6	10	0	2	12	0	0
19	6100037	.	C	T	4	5	9	0	1	10	0	0
19	6100073	.	T	G	6	6	12	0	1	13	0	0
19	6100198	.	C	A	4	4	8	0	1	9	0	0
19	6104838	.	C	T	0	4	4	0	2	6	0	0
19	6111085	.	G	A	2	3	5	0	0	5	0	0
19	6111214	.	A	G	4	4	8	0	1	9	0	0
19	6111223	.	A	G	4	4	8	0	0	8	0	0
19	6111268	.	G	A	6	3	9	0	1	10	0	0
19	6111460	.	C	G	4	4	8	0	1	9	0	0
19	6111730	.	C	A	1	2	3	0	0	3	0	0
19	6126001	.	G	A	2	3	5	0	1	6	0	0
19	6126046	.	A	T	1	2	3	0	1	4	0	0
19	6127108	.	C	A	1	2	3	0	0	3	0	0
19	6142187	.	C	A	0	3	3	0	9	12	0	0
19	6142433	.	T	A	9	3	12	0	2	14	0	0
19	6142714	.	A	T	6	10	16	0	0	16	0	0
19	6142803	.	A	G	3	6	9	0	0	9	0	0
19	6142951	.	A	G	5	5	10	0	0	10	0	0
19	6142970	.	C	T	3	7	10	0	2	12	0	0
19	6143278	.	A	C	2	2	4	0	0	4	0	0
19	6143373	.	T	C	2	6	8	0	1	9	0	0
19	6143583	.	C	G	4	3	7	0	0	7	0	0
19	6143610	.	T	A	4	3	7	0	1	8	0	0
19	6144722	.	C	T	2	3	5	0	0	5	0	0
19	6214772	.	G	A	7	4	11	0	0	11	0	0
19	6214835	.	G	T	2	5	7	0	0	7	0	0
19	6216125	.	C	T	1	2	3	0	0	3	0	0
19	6216392	.	A	G	1	3	4	0	1	5	0	0
19	6328442	.	T	C	42	11	53	0	32	85	0	0
19	6328514	.	A	C	38	38	76	0	3	79	0	0
19	6329154	.	C	T	2	24	26	0	31	57	0	0
19	6329236	.	A	G	21	16	37	0	1	38	0	0
19	6329237	.	G	A	21	17	38	0	0	38	0	0
19	6329301	.	A	C	30	27	57	0	4	62	1	0
19	6329329	.	G	A	40	25	65	0	3	68	0	0
19	6329533	.	C	T	1	25	26	0	40	66	0	0
19	6329660	.	C	T	4	10	14	0	43	61	4	0
19	6330050	.	T	C	30	22	52	0	3	55	0	0
19	6332902	.	C	A	0	3	3	0	12	15	0	0
19	6333448	.	G	A	21	11	32	0	2	34	0	0
19	6338207	.	A	G	4	3	7	0	0	7	0	0
19	6338261	.	A	G	9	10	19	0	1	20	0	0
19	6339131	.	A	G	4	5	9	0	1	10	0	0
19	6341941	.	A	G	3	3	6	0	0	6	0	0
19	6342076	.	C	G	3	2	5	0	1	6	0	0
19	6344573	.	G	T	17	14	31	0	0	31	0	0
19	6344621	.	C	T	10	13	23	0	0	23	0	0
19	6346506	.	C	G	16	7	23	0	1	24	0	0
19	6346587	.	C	T	0	5	5	0	9	14	0	0
19	6352379	.	A	G	0	2	2	0	0	2	0	0
19	6362804	.	T	A	3	0	3	0	0	3	0	0
19	6606725	.	T	C	2	1	3	0	0	3	0	0
19	6606764	.	A	T	0	1	1	0	0	1	0	0
19	6892337	.	A	G	1	2	3	0	0	3	0	0
19	6907785	.	G	A	3	2	5	1	0	6	0	0
19	6907848	.	G	A	2	1	3	0	0	3	0	0
19	6907857	.	C	T	2	2	4	0	0	4	0	0
19	6908495	.	A	T	2	2	4	0	0	4	0	0
19	6908520	.	T	C	1	1	2	0	0	2	0	0
19	6908650	.	T	C	2	2	4	0	0	4	0	0
19	6908651	.	T	C	2	1	3	0	1	4	0	0
19	6915114	.	C	T	1	3	4	0	0	4	0	0
19	6915175	.	A	C	3	3	6	0	1	7	0	0
19	6915177	.	A	G	4	3	7	0	0	7	0	0
19	6916019	.	T	C	4	3	7	0	1	8	0	0
19	6916029	.	G	A	5	3	8	0	1	9	0	0
19	6916158	.	C	A	4	2	6	0	1	7	0	0
19	6933469	.	G	A	1	2	3	0	0	3	0	0
19	6933511	.	C	T	0	2	2	0	0	2	0	0
19	6933716	.	T	A	1	1	2	0	0	2	0	0
19	6933808	.	G	C	2	3	5	0	0	5	0	0
19	6938364	.	A	T	3	1	4	0	0	4	0	0
19	6940213	.	C	T	1	0	1	0	0	1	0	0
19	6949256	.	G	A	0	9	9	0	11	20	0	0
19	6949316	.	C	A	2	5	7	0	2	9	0	0
19	6952600	.	T	C	13	11	24	0	1	25	0	0
19	6955061	.	C	T	14	11	25	0	1	26	0	0
19	6955130	.	C	T	10	9	19	0	1	20	0	0
19	6955131	.	C	T	8	10	18	0	2	20	0	0
19	6955198	.	C	A	13	15	28	0	4	32	0	0
19	6955475	.	T	C	5	6	11	0	1	12	0	0
19	6955609	.	C	G	9	9	18	0	0	18	0	0
19	6955620	.	G	A	0	9	9	0	9	18	0	0
19	6955920	.	G	A	9	7	16	0	2	18	0	0
19	6956058	.	T	C	8	16	24	0	1	25	0	0
19	6956060	.	G	A	8	17	25	0	0	25	0	0
19	6956665	.	C	A	7	6	13	0	1	14	0	0
19	6956728	.	T	A	13	11	24	0	0	24	0	0
19	6956829	.	T	A	9	9	18	0	1	19	0	0
19	6956835	.	C	G	9	8	17	0	0	17	0	0
19	6956881	.	T	C	6	6	12	0	4	16	0	0
19	6956892	.	T	A	7	7	14	0	0	14	0	0
19	6957127	.	A	T	26	16	42	0	3	45	0	0
19	6957131	.	C	A	22	17	39	0	5	44	0	0
19	6960653	.	C	A	9	7	16	0	1	17	0	0
19	6961095	.	G	A	4	4	8	0	1	9	0	0
19	6961120	.	T	C	6	6	12	0	0	12	0	0
19	6961130	.	T	C	6	0	6	0	5	11	0	0
19	6961211	.	T	C	3	3	6	1	1	8	0	0
19	6961421	.	T	A	9	3	12	0	0	12	0	0
19	6961610	.	G	A	3	4	7	0	0	7	0	0
19	6961674	.	A	G	4	8	12	0	0	12	0	0
19	6963020	.	C	T	5	2	7	0	0	7	0	0
19	6963175	.	A	T	3	3	6	0	1	7	0	0
19	6963863	.	C	A	1	3	4	0	1	5	0	0
19	6963874	.	A	G	0	2	2	0	0	2	0	0
19	6964273	.	C	A	2	2	4	0	0	4	0	0
19	6964364	.	C	T	4	3	7	0	0	7	0	0
19	6964381	.	T	C	3	3	6	0	1	7	0	0
19	6964417	.	A	G	1	3	4	0	1	5	0	0
19	6964583	.	C	T	4	2	6	0	0	6	0	0
19	6964584	.	T	C	4	2	6	0	0	6	0	0
19	6965894	.	C	A	0	2	2	0	4	6	0	0
19	6965897	.	C	T	4	2	6	0	0	6	0	0
19	6966003	.	C	A	1	2	3	0	0	3	0	0
19	6966022	.	A	G	1	2	3	0	0	3	0	0
19	6966208	.	G	A	3	3	6	0	0	6	0	0
19	6966271	.	T	G	1	2	3	0	2	5	0	0
19	6996114	.	C	A	1	3	4	0	0	4	0	0
19	6996131	.	A	G	1	3	4	0	0	4	0	0
19	6996152	.	T	C	1	4	5	0	0	5	0	0
19	7000068	.	C	T	3	4	7	0	0	7	0	0
19	7014570	.	C	A	1	2	3	0	0	3	0	0
19	7014815	.	C	T	7	3	10	0	0	10	0	0
19	7014863	.	T	G	5	4	9	0	0	9	0	0
19	7014909	.	C	A	3	5	8	0	0	8	0	0
19	7014912	.	G	A	3	5	8	0	0	8	0	0
19	7014957	.	C	T	0	2	2	0	3	5	0	0
19	7014962	.	G	A	2	2	4	0	1	5	0	0
19	7020179	.	G	A	5	3	8	0	0	8	0	0
19	7020775	.	T	C	3	3	6	0	0	6	0	0
19	7024591	.	T	G	1	3	4	0	0	4	0	0
19	7024593	.	C	T	1	3	4	0	0	4	0	0
19	7024627	.	T	C	3	3	6	0	0	6	0	0
19	7027127	.	G	C	0	2	2	0	0	2	0	0
19	7027927	.	G	A	4	2	6	0	0	6	0	0
19	7029806	.	C	G	1	2	3	0	0	3	0	0
19	7029811	.	G	A	1	2	3	0	0	3	0	0
19	7031333	.	A	G	0	0	0	0	1	1	0	0
19	7031350	.	G	A	0	1	1	0	0	1	0	0
19	7039308	.	G	A	0	1	1	0	0	1	0	0
19	7100564	.	A	T	4	3	7	0	0	7	0	0
19	7131372	.	T	A	1	4	5	0	0	5	0	0
19	7152971	.	G	T	0	5	5	0	6	11	0	0
19	7152974	.	G	A	5	5	10	0	1	11	0	0
19	7154729	.	A	G	17	13	30	0	6	36	0	0
19	7154770	.	A	C	17	14	31	0	2	33	0	0
19	7155001	.	A	T	7	16	23	0	1	24	0	0
19	7155034	.	A	G	15	17	32	0	2	34	0	0
19	7155065	.	T	C	18	14	32	0	1	33	0	0
19	7159062	.	G	A	0	2	2	0	2	4	0	0
19	7159107	.	T	C	9	3	12	0	0	12	0	0
19	7161452	.	G	A	0	3	3	0	0	3	0	0
19	7161539	.	G	T	0	2	2	0	0	2	0	0
19	7163872	.	C	T	6	7	13	0	0	13	0	0
19	7163908	.	A	G	4	7	11	0	1	12	0	0
19	7164022	.	G	A	4	2	6	0	0	6	0	0
19	7166211	.	C	T	2	13	15	0	2	17	0	0
19	7166454	.	C	A	1	1	2	0	0	2	0	0
19	7169204	.	A	C	5	6	11	0	4	15	0	0
19	7169228	.	C	T	9	12	21	0	3	24	0	0
19	7169770	.	A	C	6	5	11	0	0	11	0	0
19	7169809	.	C	T	6	5	11	0	0	11	0	0
19	7169880	.	T	C	9	4	13	0	0	13	0	0
19	7169886	.	G	A	7	3	10	0	2	12	0	0
19	7169929	.	G	A	11	4	15	0	0	15	0	0
19	7170014	.	A	C	8	5	13	0	2	15	0	0
19	7170015	.	T	C	7	7	14	0	1	15	0	0
19	7170128	.	A	G	8	9	17	0	0	17	0	0
19	7170191	.	A	C	4	11	15	0	0	15	0	0
19	7170228	.	A	T	4	7	11	0	0	11	0	0
19	7170242	.	G	T	9	2	11	0	0	11	0	0
19	7176913	.	G	A	0	0	0	0	1	1	0	0
19	7176915	.	C	A	1	0	1	0	0	1	0	0
19	7249800	.	A	G	6	5	11	0	3	14	0	0
19	7249811	.	T	C	7	5	12	0	1	13	0	0
19	7250372	.	T	C	0	1	1	0	0	1	0	0
19	7258085	.	A	G	1	1	2	0	0	2	0	0
19	7258118	.	C	T	2	2	4	0	0	4	0	0
19	7265377	.	T	C	0	1	1	0	0	1	0	0
19	7272224	.	C	A	0	2	2	0	0	2	0	0
19	7276063	.	A	T	1	2	3	0	3	6	0	0
19	7276106	.	G	A	7	22	29	0	3	32	0	0
19	7276149	.	A	G	21	30	51	0	3	54	0	0
19	7276194	.	T	A	33	25	58	0	0	58	0	0
19	7276559	.	G	A	29	32	61	0	2	63	0	0
19	7276610	.	G	A	24	24	48	0	7	55	0	0
19	7279235	.	A	G	12	15	27	0	3	30	0	0
19	7279721	.	A	G	6	2	8	0	0	8	0	0
19	7282541	.	C	T	8	11	19	0	0	19	0	0
19	7282554	.	G	A	11	16	27	0	0	27	0	0
19	7283427	.	C	A	16	14	30	0	1	31	0	0
19	7283499	.	A	G	12	9	21	0	1	22	0	0
19	7284840	.	C	T	0	7	7	0	15	22	0	0
19	7286301	.	A	G	3	7	10	0	1	11	0	0
19	7286355	.	A	G	13	18	31	0	0	31	0	0
19	7286421	.	T	A	7	5	12	0	0	12	0	0
19	7286742	.	A	G	5	6	11	0	0	11	0	0
19	7287600	.	T	C	6	12	18	0	4	22	0	0
19	7287603	.	G	A	9	10	19	0	0	19	0	0
19	7288195	.	A	G	3	1	4	0	1	5	0	0
19	7290175	.	A	G	0	2	2	0	0	2	0	0
19	7290214	.	A	G	5	6	11	0	0	11	0	0
19	7295279	.	G	A	3	8	11	0	0	11	0	0
19	7295572	.	G	C	0	7	7	0	1	8	0	0
19	7309154	.	G	A	9	10	19	0	3	22	0	0
19	7309391	.	C	A	23	20	43	0	2	45	0	0
19	7309522	.	G	C	23	15	38	0	3	41	0	0
19	7309556	.	T	A	18	14	32	0	0	32	0	0
19	7309557	.	T	A	17	12	29	0	3	32	0	0
19	7309754	.	T	G	13	7	20	0	1	21	0	0
19	7309929	.	A	T	18	17	35	0	2	37	0	0
19	7309968	.	G	T	18	12	30	0	0	30	0	0
19	7310131	.	C	T	11	8	19	0	0	19	0	0
19	7310154	.	A	T	12	5	17	0	2	19	0	0
19	7311678	.	T	G	1	2	3	0	0	3	0	0
19	7313933	.	C	G	7	6	13	0	1	14	0	0
19	7327462	.	A	G	8	6	14	0	0	14	0	0
19	7327519	.	C	T	5	11	16	0	0	16	0	0
19	7327564	.	G	T	1	5	6	0	0	6	0	0
19	7327570	.	T	C	0	4	4	0	0	4	0	0
19	7337862	.	C	A	0	1	1	0	0	1	0	0
19	7338033	.	C	T	0	12	12	0	12	24	0	0
19	7338125	.	C	T	6	4	10	0	1	11	0	0
19	7338218	.	A	T	2	3	5	0	0	5	0	0
19	7338309	.	C	T	0	4	4	0	7	11	0	0
19	7338402	.	C	T	0	3	3	0	6	9	0	0
19	7338425	.	T	C	5	0	5	0	2	7	0	0
19	7338978	.	T	C	4	0	4	0	2	6	0	0
19	7339008	.	T	G	5	3	8	0	1	9	0	0
19	7341300	.	G	A	7	3	10	0	0	10	0	0
19	7358131	.	A	G	1	4	5	0	0	5	0	0
19	7408360	.	T	G	3	3	6	0	0	6	0	0
19	7411975	.	T	C	1	3	4	0	0	4	0	0
19	7412062	.	T	C	2	2	4	0	0	4	0	0
19	7412320	.	C	T	2	7	9	0	1	10	0	0
19	7412358	.	A	T	4	9	13	0	0	13	0	0
19	7412490	.	T	C	1	7	8	0	1	9	0	0
19	7426967	.	T	C	4	6	10	0	0	10	0	0
19	7427099	.	C	A	1	0	1	0	0	1	0	0
19	7430160	.	T	C	10	9	19	0	2	21	0	0
19	7430607	.	G	A	0	11	11	0	15	26	0	0
19	7430652	.	C	T	9	10	19	0	0	19	0	0
19	7430700	.	A	G	5	0	5	0	5	10	0	0
19	7430715	.	C	A	7	5	12	0	1	13	0	0
19	7432753	.	T	C	2	2	4	0	0	4	0	0
19	7432806	.	A	C	2	5	7	0	1	8	0	0
19	7432922	.	G	A	1	2	3	0	0	3	0	0
19	7433068	.	T	A	4	3	7	0	0	7	0	0
19	7433598	.	C	T	1	1	2	0	1	3	0	0
19	7433601	.	T	C	1	2	3	0	0	3	0	0
19	7434161	.	G	T	3	2	5	0	0	5	0	0
19	7434611	.	G	C	4	3	7	0	1	8	0	0
19	7434813	.	G	A	2	4	6	0	0	6	0	0
19	7435164	.	C	T	0	2	2	0	1	3	0	0
19	7435237	.	A	G	1	3	4	0	0	4	0	0
19	7435252	.	G	A	2	3	5	0	0	5	0	0
19	7435410	.	A	G	2	3	5	0	0	5	0	0
19	7435422	.	G	A	2	2	4	0	0	4	0	0
19	7435605	.	T	C	0	2	2	0	0	2	0	0
19	7445676	.	G	A	5	5	10	0	0	10	0	0
19	7445897	.	C	T	26	28	54	0	3	57	0	0
19	7446050	.	T	C	27	20	47	0	4	51	0	0
19	7446137	.	G	T	19	27	46	0	4	50	0	0
19	7446286	.	G	T	29	27	56	0	1	57	0	0
19	7446495	.	G	T	22	28	50	0	15	65	0	0
19	7446621	.	C	A	27	33	60	0	3	63	0	0
19	7446702	.	T	C	3	2	5	0	0	5	0	0
19	7450572	.	G	A	24	18	42	0	1	43	0	0
19	7450658	.	T	C	10	12	22	0	0	22	0	0
19	7450750	.	A	G	5	5	10	0	0	10	0	0
19	7456364	.	T	C	1	2	3	0	0	3	0	0
19	7456371	.	A	C	1	2	3	0	0	3	0	0
19	7456793	.	A	G	2	3	5	0	0	5	0	0
19	7456816	.	C	G	1	3	4	0	1	5	0	0
19	7468556	.	G	T	6	7	13	0	0	13	0	0
19	7468580	.	C	T	7	6	13	0	2	15	0	0
19	7468746	.	T	A	1	0	1	0	0	1	0	0
19	7474242	.	T	C	6	8	14	0	0	14	0	0
19	7474245	.	T	G	6	0	6	0	7	13	0	0
19	7478159	.	A	G	11	10	21	0	2	23	0	0
19	7478283	.	C	T	3	9	12	0	1	13	0	0
19	7478356	.	G	A	5	16	21	0	1	22	0	0
19	7482993	.	G	A	2	2	4	0	0	4	0	0
19	7483059	.	A	T	4	3	7	0	0	7	0	0
19	7483469	.	T	G	3	4	7	0	0	7	0	0
19	7484313	.	T	A	2	3	5	0	0	5	0	0
19	7484354	.	A	T	2	4	6	0	0	6	0	0
19	7484357	.	G	A	2	4	6	0	0	6	0	0
19	7484856	.	C	G	1	4	5	0	0	5	0	0
19	7485117	.	C	T	2	2	4	0	1	5	0	0
19	7485339	.	A	C	1	3	4	0	0	4	0	0
19	7485343	.	T	A	1	2	3	0	0	3	0	0
19	7486087	.	G	A	1	4	5	0	0	5	0	0
19	7487096	.	G	A	1	2	3	0	0	3	0	0
19	7487103	.	G	A	1	2	3	0	0	3	0	0
19	7487592	.	T	A	2	2	4	0	0	4	0	0
19	7495867	.	A	T	3	3	6	0	0	6	0	0
19	7498046	.	T	C	11	10	21	0	0	21	0	0
19	7498079	.	A	G	10	13	23	0	2	25	0	0
19	7498103	.	A	G	8	11	19	0	0	19	0	0
19	7505591	.	A	G	8	3	11	0	1	12	0	0
19	7506036	.	A	G	5	0	5	0	10	15	0	0
19	7506097	.	T	C	4	4	8	0	0	8	0	0
19	7507833	.	A	T	7	4	11	0	0	11	0	0
19	7510223	.	T	C	4	5	9	0	1	10	0	0
19	7510348	.	T	C	7	3	10	0	1	11	0	0
19	7510567	.	C	T	2	4	6	0	0	6	0	0
19	7512406	.	C	G	7	9	16	0	0	16	0	0
19	7513085	.	C	T	6	7	13	0	0	13	0	0
19	7513291	.	A	C	7	9	16	0	1	17	0	0
19	7513406	.	A	T	10	8	18	0	0	18	0	0
19	7513563	.	A	G	4	3	7	0	1	8	0	0
19	7513651	.	A	G	3	5	8	0	0	8	0	0
19	7514031	.	C	T	5	5	10	0	0	10	0	0
19	7514066	.	C	T	7	3	10	0	2	12	0	0
19	7514069	.	G	T	9	3	12	0	1	13	0	0
19	7514708	.	A	G	6	2	8	0	1	9	0	0
19	7515356	.	G	A	12	6	18	0	1	19	0	0
19	7515423	.	A	G	9	4	13	0	3	16	0	0
19	7515660	.	A	G	8	2	10	0	3	13	0	0
19	7515787	.	A	T	9	10	19	0	1	20	0	0
19	7515829	.	C	T	10	14	24	0	0	24	0	0
19	7515845	.	A	T	12	14	26	0	1	27	0	0
19	7516035	.	A	G	10	8	18	0	1	19	0	0
19	7516063	.	A	C	11	11	22	0	1	23	0	0
19	7516169	.	C	A	19	16	35	0	1	36	0	0
19	7516183	.	T	G	16	13	29	0	1	30	0	0
19	7525148	.	C	T	0	2	2	0	0	2	0	0
19	7525222	.	T	G	1	3	4	0	0	4	0	0
19	7552887	.	A	G	0	1	1	0	0	1	0	0
19	7557538	.	T	C	5	3	8	0	0	8	0	0
19	7557735	.	T	C	8	6	14	0	1	15	0	0
19	7557793	.	G	C	12	9	21	0	0	21	0	0
19	7564073	.	A	G	5	2	7	0	1	8	0	0
19	7564176	.	C	T	6	9	15	0	1	16	0	0
19	7565462	.	T	A	18	7	25	0	0	25	0	0
19	7565463	.	T	C	18	7	25	0	0	25	0	0
19	7566488	.	A	T	6	3	9	0	2	11	0	0
19	7566770	.	A	G	13	13	26	0	1	27	0	0
19	7567011	.	T	C	21	14	35	0	3	38	0	0
19	7567021	.	T	A	19	16	35	0	1	37	1	0
19	7567196	.	A	C	3	2	5	0	0	5	0	0
19	7630359	.	T	A	3	4	7	0	0	7	0	0
19	7630689	.	A	T	3	4	7	0	0	7	0	0
19	7631386	.	C	T	11	11	22	0	4	26	0	0
19	7631700	.	G	A	0	12	12	0	5	17	0	0
19	7631860	.	T	C	7	10	17	0	1	18	0	0
19	7631968	.	T	C	7	7	14	0	0	14	0	0
19	7632056	.	C	T	5	4	9	0	0	9	0	0
19	7632470	.	C	T	9	10	19	0	0	19	0	0
19	7632526	.	T	C	7	12	19	0	0	19	0	0
19	7632837	.	C	T	14	9	23	0	0	23	0	0
19	7679110	.	A	G	2	2	4	0	0	4	0	0
19	7775547	.	A	T	7	7	14	0	0	14	0	0
19	7775552	.	T	C	8	7	15	0	0	15	0	0
19	7784681	.	T	A	1	3	4	0	2	6	0	0
19	7784684	.	T	A	1	4	5	0	1	6	0	0
19	7785138	.	C	T	1	0	1	0	0	1	0	0
19	7794830	.	G	C	0	13	13	0	11	24	0	0
19	7794872	.	A	G	9	0	9	0	21	30	0	0
19	7796398	.	C	T	18	18	36	0	8	44	0	0
19	7796975	.	T	C	10	13	23	0	1	24	0	0
19	7797539	.	T	G	18	18	36	0	2	39	1	0
19	7799137	.	T	C	2	4	6	0	0	6	0	0
19	7802622	.	G	A	4	8	12	0	1	13	0	0
19	7802700	.	G	A	2	7	9	0	0	9	0	0
19	7802704	.	T	C	2	6	8	0	0	8	0	0
19	7803480	.	G	A	0	3	3	0	1	4	0	0
19	7803685	.	C	A	5	11	16	0	0	16	0	0
19	7803730	.	G	A	1	8	9	0	0	9	0	0
19	7803745	.	T	A	1	3	4	0	0	4	0	0
19	7804785	.	A	C	1	5	6	0	0	6	0	0
19	7804841	.	G	A	5	20	25	0	1	26	0	0
19	7804843	.	G	A	4	21	25	0	1	26	0	0
19	7804892	.	C	T	6	14	20	0	0	20	0	0
19	7804937	.	C	T	4	8	12	0	0	12	0	0
19	7820018	.	C	G	9	6	15	0	1	16	0	0
19	7820767	.	C	T	0	6	6	0	7	13	0	0
19	7820992	.	C	A	2	9	11	0	10	21	0	0
19	7821055	.	C	T	10	9	19	0	0	19	0	0
19	7822581	.	T	C	1	0	1	0	5	6	0	0
19	7825025	.	T	G	3	4	7	0	0	7	0	0
19	7825127	.	T	C	0	2	2	0	0	2	0	0
19	7825259	.	G	A	2	5	7	0	1	8	0	0
19	7825300	.	A	G	1	1	2	0	0	2	0	0
19	7830064	.	A	G	1	1	2	0	1	3	0	0
19	7835708	.	C	T	0	2	2	0	0	2	0	0
19	8336328	.	G	A	4	2	6	0	0	6	0	0
19	8501662	.	A	G	7	4	11	0	2	13	0	0
19	9685695	.	A	G	21	27	48	0	1	49	0	0
19	9685714	.	A	C	18	26	44	0	3	47	0	0
19	9686078	.	C	A	12	8	20	0	2	22	0	0
19	9686099	.	G	T	12	8	20	0	3	23	0	0
19	9686160	.	T	C	19	8	27	0	3	30	0	0
19	9686199	.	G	T	10	13	23	0	6	29	0	0
19	9686474	.	G	A	12	12	24	0	0	24	0	0
19	9686503	.	A	G	7	9	16	0	1	17	0	0
19	9686548	.	T	A	8	8	16	0	0	16	0	0
19	9686575	.	T	A	5	8	13	0	0	13	0	0
19	9686616	.	A	T	5	5	10	0	3	13	0	0
19	9686646	.	C	T	10	6	16	0	2	18	0	0
19	9686678	.	T	A	9	8	17	0	0	17	0	0
19	9686905	.	T	C	2	0	2	0	5	7	0	0
19	9687033	.	C	T	10	7	17	0	3	20	0	0
19	9687073	.	G	A	15	12	27	0	1	28	0	0
19	9687146	.	T	C	25	11	36	0	4	40	0	0
19	9691780	.	A	G	3	4	7	0	2	9	0	0
19	9712444	.	G	A	1	3	4	0	1	5	0	0
19	10269915	.	T	C	3	1	4	0	0	4	0	0
19	10408007	.	T	A	2	2	4	0	1	5	0	0
19	10870057	.	T	C	1	6	7	0	0	7	0	0
19	10989189	.	A	C	7	10	17	0	0	17	0	0
19	10989343	.	T	A	15	13	28	0	4	32	0	0
19	10989457	.	T	C	6	17	23	0	1	24	0	0
19	10989511	.	A	G	9	9	18	0	2	21	1	0
19	10989653	.	C	A	15	9	24	0	2	26	0	0
19	11014636	.	G	A	6	12	18	0	4	22	0	0
19	11014675	.	A	G	13	6	19	0	1	20	0	0
19	11039539	.	A	C	3	4	7	0	0	7	0	0
19	11039829	.	G	C	11	8	19	0	2	21	0	0
19	11040493	.	A	T	13	16	29	0	2	31	0	0
19	11045311	.	C	A	0	18	18	0	6	24	0	0
19	11045323	.	C	T	10	15	25	0	0	25	0	0
19	11045864	.	A	C	9	6	15	0	0	15	0	0
19	11048822	.	C	T	0	2	2	0	1	3	0	0
19	11051581	.	T	C	2	4	6	0	0	6	0	0
19	11070794	.	G	A	1	3	4	0	0	4	0	0
19	11093564	.	T	C	0	2	2	0	0	2	0	0
19	11093567	.	A	G	0	2	2	0	0	2	0	0
19	11191376	.	T	C	1	2	3	0	0	3	0	0
19	11231386	.	C	A	11	9	20	0	1	21	0	0
19	11237043	.	A	G	2	4	6	0	0	6	0	0
19	11237049	.	T	C	2	5	7	0	0	7	0	0
19	11271224	.	C	T	3	5	8	0	1	9	0	0
19	11275304	.	T	A	0	1	1	0	0	1	0	0
19	11275607	.	G	C	1	2	3	0	0	3	0	0
19	11314945	.	A	G	1	2	3	0	0	3	0	0
19	11331967	.	G	T	10	17	27	0	3	30	0	0
19	11332050	.	G	T	15	19	34	0	2	36	0	0
19	11332071	.	T	C	17	13	30	0	2	32	0	0
19	11332574	.	T	A	19	9	28	0	2	30	0	0
19	11332576	.	C	T	21	9	30	0	0	30	0	0
19	11332670	.	T	C	15	1	16	0	14	30	0	0
19	11347910	.	C	T	0	2	2	0	4	6	0	0
19	11356692	.	G	A	3	5	8	0	1	9	0	0
19	11508991	.	G	C	2	6	8	0	0	8	0	0
19	11509029	.	T	C	1	0	1	0	8	9	0	0
19	11546105	.	G	A	0	3	3	0	0	3	0	0
19	11815448	.	T	A	1	2	3	0	0	3	0	0
19	11815762	.	T	C	1	0	1	0	3	4	0	0
19	11892419	.	A	T	2	10	12	0	1	13	0	0
19	11892422	.	A	G	2	10	12	0	1	13	0	0
19	11892515	.	A	G	4	12	16	0	2	18	0	0
19	11892636	.	T	A	2	15	17	0	0	18	1	0
19	11892814	.	G	A	2	5	7	0	0	7	0	0
19	11892840	.	A	G	4	2	6	0	0	6	0	0
19	11892961	.	A	G	4	3	7	0	0	7	0	0
19	11893087	.	A	G	3	11	14	0	0	14	0	0
19	11893309	.	G	T	1	1	2	1	4	7	0	0
19	11893313	.	G	A	5	1	6	1	0	7	0	0
19	11893445	.	A	G	5	9	14	0	0	14	0	0
19	11893624	.	T	C	2	5	7	0	1	8	0	0
19	11893785	.	G	T	2	3	5	0	0	5	0	0
19	11897774	.	T	C	3	5	8	0	0	9	1	0
19	11897841	.	G	T	5	4	9	0	1	10	0	0
19	11899324	.	A	G	10	6	16	0	0	16	0	0
19	11899384	.	T	C	6	1	7	0	0	7	0	0
19	11903571	.	A	G	0	1	1	0	0	1	0	0
19	11906238	.	T	G	5	3	8	0	0	8	0	0
19	11908436	.	A	G	1	1	2	0	0	2	0	0
19	11908567	.	G	A	1	1	2	0	0	2	0	0
19	11910595	.	A	C	1	0	1	0	0	1	0	0
19	11912635	.	T	A	0	2	2	0	0	2	0	0
19	11915272	.	A	G	1	1	2	0	0	2	0	0
19	11917609	.	T	A	1	4	5	0	0	5	0	0
19	11955713	.	A	G	4	5	9	0	0	9	0	0
19	11960343	.	C	T	0	4	4	0	1	5	0	0
19	11985848	.	C	T	3	5	8	0	1	9	0	0
19	11985858	.	T	C	2	5	7	0	3	10	0	0
19	11996249	.	T	A	3	1	4	0	0	4	0	0
19	11996360	.	A	C	1	1	2	0	0	2	0	0
19	12017902	.	G	A	0	6	6	0	13	19	0	0
19	12018036	.	C	G	10	6	16	1	0	17	0	0
19	12018084	.	C	T	3	4	7	0	0	7	0	0
19	12018367	.	G	T	0	10	10	0	10	20	0	0
19	12031138	.	G	T	6	5	11	0	0	11	0	0
19	12031202	.	C	T	1	10	11	0	11	22	0	0
19	12031466	.	T	A	4	5	9	0	0	9	0	0
19	12031515	.	T	G	3	2	5	0	0	5	0	0
19	12031920	.	G	A	5	2	7	0	1	8	0	0
19	12031925	.	G	T	6	3	9	0	0	9	0	0
19	12032273	.	G	T	2	3	5	0	0	5	0	0
19	12032622	.	C	T	3	2	5	0	1	6	0	0
19	12032649	.	G	A	3	2	5	0	0	5	0	0
19	12122035	.	A	G	29	23	52	0	3	55	0	0
19	12122039	.	G	A	25	24	49	0	6	55	0	0
19	12122124	.	C	A	30	24	54	0	10	64	0	0
19	12122489	.	G	T	14	12	26	0	2	28	0	0
19	12130089	.	G	A	12	10	22	0	1	23	0	0
19	12134950	.	C	G	1	4	5	0	1	6	0	0
19	12134960	.	T	G	1	2	3	0	1	4	0	0
19	12145548	.	A	T	17	14	31	0	2	33	0	0
19	12171712	.	C	T	10	8	18	0	3	21	0	0
19	12193604	.	A	G	5	4	9	0	0	9	0	0
19	12193617	.	T	A	6	3	9	0	0	9	0	0
19	12211809	.	T	C	2	5	7	0	0	7	0	0
19	12939106	.	T	C	2	2	4	0	0	4	0	0
19	13151155	.	A	G	5	0	5	0	16	21	0	0
19	13413674	.	A	G	4	3	7	0	1	8	0	0
19	13413683	.	A	G	2	5	7	0	0	7	0	0
19	17292706	.	G	A	3	2	5	0	0	5	0	0
19	17517136	.	T	C	7	3	10	0	3	13	0	0
19	18914077	.	T	C	1	2	3	0	0	3	0	0
19	19779908	.	A	T	1	2	3	0	0	3	0	0
19	20244292	.	C	T	1	2	3	0	1	4	0	0
19	20721761	.	A	C	2	12	14	1	2	17	0	0
19	21413001	.	G	T	12	3	15	0	1	16	0	0
19	24491867	.	C	T	4	1	5	0	2	7	0	0
19	24916543	.	A	T	2	2	4	0	0	4	0	0
19	26378250	.	T	C	0	3	3	0	0	3	0	0
19	26378473	.	C	T	5	2	7	0	1	8	0	0
19	26746397	.	G	A	4	2	6	0	1	7	0	0
19	27445181	.	T	C	0	0	0	0	2	2	0	0
19	27445195	.	T	C	1	1	2	0	0	2	0	0
19	27469130	.	A	G	0	6	6	0	1	7	0	0
19	29837617	.	C	A	3	2	5	0	0	5	0	0
19	30388080	.	G	T	0	4	4	0	4	8	0	0
19	30388091	.	C	T	4	3	7	0	0	7	0	0
19	30393967	.	T	C	0	2	2	0	0	2	0	0
19	30396777	.	C	T	8	2	10	0	0	10	0	0
19	30398392	.	T	C	12	7	19	0	1	20	0	0
19	30398395	.	T	C	13	9	22	0	0	22	0	0
19	30398487	.	G	A	6	7	13	0	0	13	0	0
19	30398632	.	T	C	7	5	12	0	0	12	0	0
19	30398763	.	T	G	0	4	4	0	1	5	0	0
19	30398909	.	T	C	3	2	5	0	0	5	0	0
19	30399047	.	A	T	7	4	11	0	1	12	0	0
19	30410192	.	G	A	4	2	6	0	0	6	0	0
19	30410406	.	A	G	21	12	33	0	4	37	0	0
19	30416523	.	A	T	1	0	1	0	0	1	0	0
19	30425622	.	T	C	0	2	2	0	1	3	0	0
19	30428688	.	A	C	6	18	24	0	0	24	0	0
19	30428726	.	A	G	5	1	6	0	10	16	0	0
19	30429063	.	G	A	9	7	16	0	0	16	0	0
19	30432742	.	G	A	0	0	0	0	1	1	0	0
19	30436825	.	A	G	1	0	1	0	0	1	0	0
19	30438496	.	G	A	0	1	1	0	0	1	0	0
19	30438518	.	A	G	0	1	1	0	0	1	0	0
19	30439733	.	C	T	5	4	9	0	0	9	0	0
19	30439754	.	C	T	4	4	8	0	0	8	0	0
19	30455697	.	A	G	3	4	7	0	0	7	0	0
19	30457627	.	G	A	3	2	5	0	2	7	0	0
19	30457648	.	C	T	4	4	8	0	0	8	0	0
19	30458039	.	C	A	8	4	12	0	0	12	0	0
19	30458103	.	G	A	0	9	9	0	10	19	0	0
19	30458121	.	C	T	8	8	16	0	0	16	0	0
19	30463210	.	G	C	1	2	3	0	0	3	0	0
19	30481799	.	T	A	7	11	18	0	4	22	0	0
19	30485029	.	G	A	1	0	1	0	0	1	0	0
19	30485085	.	T	C	8	9	17	0	2	19	0	0
19	30485253	.	A	G	1	0	1	0	0	1	0	0
19	30495908	.	C	T	1	3	4	0	0	4	0	0
19	30506619	.	C	T	1	3	4	0	0	4	0	0
19	30518480	.	T	A	14	11	25	0	2	27	0	0
19	30518646	.	A	C	27	23	50	0	4	54	0	0
19	30518906	.	A	G	14	16	30	0	1	31	0	0
19	30518973	.	C	T	24	15	39	0	1	40	0	0
19	30519319	.	A	G	3	6	9	0	0	9	0	0
19	30519324	.	C	T	4	6	10	0	0	10	0	0
19	30519459	.	T	A	4	2	6	0	0	6	0	0
19	30519510	.	T	C	0	2	2	0	2	4	0	0
19	30519802	.	C	T	14	15	29	0	0	29	0	0
19	30519803	.	T	G	13	14	27	0	2	29	0	0
19	30519858	.	A	G	6	14	20	0	1	21	0	0
19	30520061	.	T	G	13	14	27	0	0	27	0	0
19	30520214	.	C	T	9	27	36	0	3	39	0	0
19	30520337	.	A	G	17	10	27	0	1	28	0	0
19	30520419	.	G	A	9	19	28	0	1	29	0	0
19	30520431	.	C	G	11	15	26	0	1	27	0	0
19	30520567	.	T	A	12	11	23	0	0	23	0	0
19	30520569	.	T	A	12	10	22	0	1	23	0	0
19	30521256	.	G	A	2	7	9	0	3	13	1	0
19	30522182	.	T	C	5	6	11	0	0	11	0	0
19	30669930	.	A	G	10	8	18	0	2	20	0	0
19	30672935	.	T	C	11	14	25	0	1	26	0	0
19	30673004	.	T	A	6	3	9	0	2	11	0	0
19	30676543	.	G	A	0	1	1	0	0	1	0	0
19	30676699	.	C	T	6	11	17	0	0	17	0	0
19	30681938	.	G	A	2	18	20	0	24	44	0	0
19	30682680	.	G	A	20	40	60	0	3	63	0	0
19	30682781	.	C	A	25	25	50	0	3	53	0	0
19	30682947	.	A	G	15	27	42	0	1	43	0	0
19	30683129	.	A	C	23	27	50	0	4	54	0	0
19	30683395	.	A	T	29	15	44	0	3	47	0	0
19	30723172	.	C	T	9	3	12	0	0	12	0	0
19	30723251	.	A	T	2	3	5	0	1	6	0	0
19	30723554	.	C	G	4	8	12	0	0	12	0	0
19	30723675	.	A	T	3	5	8	0	0	8	0	0
19	30723691	.	G	A	5	3	8	0	0	8	0	0
19	30757713	.	A	G	2	1	3	0	0	3	0	0
19	30805617	.	C	T	2	6	8	0	1	9	0	0
19	30805698	.	C	G	10	4	14	0	0	14	0	0
19	30805886	.	A	C	3	6	9	0	0	9	0	0
19	30807557	.	A	G	2	3	5	0	3	8	0	0
19	30868063	.	C	G	0	1	1	0	0	1	0	0
19	30876908	.	C	T	1	0	1	0	0	1	0	0
19	30880083	.	C	G	2	1	3	0	0	3	0	0
19	30882576	.	G	T	4	5	9	0	0	9	0	0
19	30882688	.	T	C	4	4	8	0	0	8	0	0
19	30882743	.	G	A	6	1	7	0	1	8	0	0
19	30882973	.	A	T	8	10	18	0	0	18	0	0
19	30883224	.	C	T	7	5	12	0	0	12	0	0
19	30883298	.	G	A	7	8	15	0	0	15	0	0
19	30883302	.	G	A	6	7	13	0	1	14	0	0
19	30883476	.	A	T	8	4	12	0	1	13	0	0
19	30883549	.	T	C	2	5	7	0	5	12	0	0
19	30894883	.	G	A	13	15	28	0	1	29	0	0
19	30894980	.	A	G	4	10	14	0	0	14	0	0
19	30895163	.	G	A	5	5	10	0	1	11	0	0
19	30897545	.	T	A	2	4	6	0	1	7	0	0
19	30897585	.	A	C	2	4	6	0	0	6	0	0
19	30897649	.	G	C	1	5	6	0	0	6	0	0
19	30897916	.	C	A	1	3	4	0	0	4	0	0
19	30898050	.	C	T	1	3	4	0	1	5	0	0
19	30898651	.	G	C	1	0	1	0	2	3	0	0
19	30898665	.	C	G	1	2	3	0	0	3	0	0
19	30899536	.	C	A	1	2	3	0	0	3	0	0
19	30997318	.	G	A	0	2	2	0	1	3	0	0
19	30999947	.	T	C	5	0	5	0	6	11	0	0
19	31000077	.	C	T	1	9	10	0	11	21	0	0
19	31000207	.	T	C	7	17	24	0	3	27	0	0
19	31001318	.	T	G	1	2	3	0	0	3	0	0
19	31001417	.	A	G	0	1	1	0	0	1	0	0
19	31003330	.	A	T	4	4	8	0	0	8	0	0
19	31010033	.	A	C	9	8	17	0	0	17	0	0
19	31010061	.	T	A	3	2	5	0	0	5	0	0
19	31012900	.	G	A	6	8	14	0	2	16	0	0
19	31016410	.	A	T	8	4	12	0	0	12	0	0
19	31016458	.	C	A	13	8	21	0	0	21	0	0
19	31340089	.	G	A	5	6	11	0	1	12	0	0
19	31341000	.	C	T	3	4	7	0	1	8	0	0
19	31392375	.	C	T	5	3	8	0	0	8	0	0
19	31392700	.	G	A	7	13	20	0	1	21	0	0
19	31392803	.	C	T	0	1	1	0	1	2	0	0
19	31394550	.	A	G	6	4	10	0	0	10	0	0
19	31398979	.	A	G	2	2	4	0	0	4	0	0
19	31416787	.	G	A	4	3	7	0	0	7	0	0
19	31431021	.	T	C	5	3	8	0	2	10	0	0
19	31437956	.	A	G	7	14	21	0	2	23	0	0
19	31437974	.	G	A	10	12	22	0	1	23	0	0
19	31438009	.	G	T	6	5	11	0	0	11	0	0
19	31438016	.	T	C	5	0	5	0	5	10	0	0
19	31449834	.	T	G	4	5	9	0	1	10	0	0
19	31455562	.	T	C	1	0	1	0	0	1	0	0
19	31461620	.	C	G	2	0	2	0	0	2	0	0
19	31517478	.	T	C	0	1	1	0	0	1	0	0
19	31517536	.	A	G	0	3	3	0	1	4	0	0
19	31560775	.	G	A	9	11	20	0	0	20	0	0
19	31569155	.	C	A	1	2	3	0	0	3	0	0
19	31569535	.	C	T	1	4	5	0	0	5	0	0
19	31576954	.	A	G	3	10	13	0	0	13	0	0
19	31579783	.	T	A	18	20	38	0	2	40	0	0
19	31579860	.	G	T	31	16	47	0	0	47	0	0
19	31580071	.	C	A	0	16	16	0	20	36	0	0
19	31580103	.	A	T	23	17	40	0	9	49	0	0
19	31580160	.	T	A	16	21	37	0	3	40	0	0
19	31580186	.	T	G	10	23	33	0	1	34	0	0
19	31580328	.	A	C	19	3	22	0	30	52	0	0
19	31583137	.	A	G	4	7	11	0	1	12	0	0
19	31583179	.	C	T	5	4	9	0	2	11	0	0
19	31583289	.	C	T	4	8	12	0	2	14	0	0
19	31583305	.	A	G	5	3	8	0	0	8	0	0
19	31584018	.	T	G	14	11	25	0	2	27	0	0
19	31589213	.	C	T	0	2	2	0	1	3	0	0
19	31593594	.	C	A	3	2	5	0	1	6	0	0
19	31593595	.	C	A	3	3	6	0	0	6	0	0
19	31593762	.	G	A	4	7	11	0	4	15	0	0
19	31593891	.	T	C	1	5	6	0	0	6	0	0
19	31593957	.	C	T	12	3	15	0	0	15	0	0
19	31603335	.	T	C	0	4	4	0	0	4	0	0
19	31603351	.	G	C	2	3	5	0	0	5	0	0
19	31771335	.	T	A	18	11	29	0	5	34	0	0
19	31789666	.	C	T	21	13	34	0	10	44	0	0
19	31790042	.	C	A	32	10	42	0	8	50	0	0
19	31790079	.	A	G	36	15	51	0	6	57	0	0
19	31790097	.	C	T	33	18	51	0	4	55	0	0
19	31790115	.	C	A	14	29	43	0	5	48	0	0
19	31790283	.	G	C	43	19	62	0	4	67	1	0
19	31790385	.	A	G	22	24	46	2	9	57	0	0
19	31797778	.	G	A	7	4	11	0	0	11	0	0
19	31797834	.	G	T	5	4	9	0	0	9	0	0
19	31878529	.	A	T	3	0	3	0	1	4	0	0
19	31882114	.	G	A	4	5	9	0	0	9	0	0
19	31891350	.	A	G	1	2	3	0	0	3	0	0
19	31938817	.	T	C	1	4	5	0	2	7	0	0
19	32049055	.	A	G	9	16	25	0	2	27	0	0
19	32049443	.	T	C	11	11	22	0	1	23	0	0
19	32049485	.	A	T	8	9	17	0	4	21	0	0
19	32049775	.	G	A	10	8	18	0	3	21	0	0
19	32049850	.	A	G	19	6	25	0	0	25	0	0
19	32049891	.	A	G	8	11	19	0	0	19	0	0
19	32050174	.	T	G	8	8	16	0	0	16	0	0
19	32050535	.	A	T	11	19	30	0	3	33	0	0
19	32050536	.	T	A	12	18	30	0	3	33	0	0
19	32050593	.	A	T	0	12	12	0	0	12	0	0
19	32050679	.	C	A	3	4	7	0	0	7	0	0
19	32050702	.	G	A	3	4	7	0	0	7	0	0
19	32050811	.	C	A	2	4	6	0	0	6	0	0
19	32050822	.	C	T	0	2	2	0	2	4	0	0
19	32050944	.	A	T	7	11	18	0	2	20	0	0
19	32051218	.	C	A	5	4	9	0	0	9	0	0
19	32051226	.	G	A	7	6	13	0	0	13	0	0
19	32051541	.	T	G	2	4	6	0	0	6	0	0
19	32051566	.	G	C	2	0	2	0	0	2	0	0
19	32064557	.	T	G	6	10	16	0	0	16	0	0
19	32588962	.	T	A	6	2	8	0	0	8	0	0
19	32866663	.	T	A	0	3	3	0	0	3	0	0
19	32895702	.	G	A	19	6	25	0	3	29	1	0
19	33273994	.	C	G	0	1	1	0	0	1	0	0
19	33514616	.	T	G	4	2	6	0	0	6	0	0
19	33772291	.	A	C	1	0	1	0	13	14	0	0
19	34960099	.	A	G	2	7	9	0	0	9	0	0
19	34960143	.	A	G	7	5	12	0	2	14	0	0
19	34960147	.	G	A	6	6	12	0	3	15	0	0
19	34960190	.	C	G	0	12	12	0	18	30	0	0
19	34960198	.	T	C	18	11	29	0	3	32	0	0
19	34960315	.	T	A	3	3	6	0	1	7	0	0
19	34960574	.	A	G	4	2	6	1	0	7	0	0
19	34961152	.	C	T	1	2	3	0	1	4	0	0
19	35002450	.	G	A	3	3	6	0	0	6	0	0
19	35002527	.	G	A	0	2	2	0	0	2	0	0
19	35002714	.	A	C	1	4	5	0	2	7	0	0
19	35002723	.	T	C	1	3	4	0	0	4	0	0
19	35004117	.	A	C	4	3	7	0	2	9	0	0
19	35004135	.	C	T	3	5	8	0	1	9	0	0
19	35004868	.	C	A	1	0	1	0	0	1	0	0
19	35004869	.	C	A	1	0	1	0	0	1	0	0
19	35004920	.	G	A	2	4	6	0	0	6	0	0
19	35004941	.	T	C	2	6	8	0	1	9	0	0
19	35005136	.	A	C	6	4	10	0	1	11	0	0
19	35005137	.	A	T	6	5	11	0	0	11	0	0
19	35005318	.	G	A	10	10	20	0	6	26	0	0
19	35007021	.	G	A	0	4	4	0	4	8	0	0
19	35007220	.	G	A	3	4	7	0	0	7	0	0
19	35007235	.	G	A	2	4	6	0	0	6	0	0
19	35013806	.	C	T	20	22	42	0	0	42	0	0
19	35016477	.	C	T	1	0	1	0	0	1	0	0
19	35016553	.	T	G	18	11	29	0	0	29	0	0
19	35016646	.	A	T	21	10	31	0	5	36	0	0
19	35016696	.	T	G	11	12	23	0	5	28	0	0
19	35016835	.	C	T	13	5	18	0	2	20	0	0
19	35016962	.	T	A	8	8	16	0	0	16	0	0
19	35019339	.	C	A	1	2	3	0	1	4	0	0
19	35019351	.	T	C	2	2	4	0	0	4	0	0
19	35040003	.	G	T	4	9	13	0	1	14	0	0
19	35041158	.	T	A	13	31	44	0	2	46	0	0
19	35041308	.	A	G	20	23	43	0	8	51	0	0
19	35041458	.	T	C	10	0	10	0	8	18	0	0
19	35052411	.	G	T	11	9	20	0	1	21	0	0
19	35055889	.	A	G	6	11	17	0	1	18	0	0
19	35057860	.	G	T	1	0	1	0	0	1	0	0
19	35057869	.	C	T	1	2	3	0	2	5	0	0
19	35058232	.	T	C	5	3	8	0	0	8	0	0
19	35060217	.	A	C	12	9	21	0	0	21	0	0
19	35065906	.	A	T	1	5	6	0	0	6	0	0
19	35067367	.	G	A	4	5	9	0	0	9	0	0
19	35069299	.	G	T	2	0	2	0	0	2	0	0
19	35069755	.	C	A	1	3	4	0	0	4	0	0
19	35069934	.	T	G	2	0	2	0	1	3	0	0
19	35070015	.	C	T	3	4	7	0	1	8	0	0
19	35072613	.	A	C	6	10	16	0	0	16	0	0
19	35075637	.	C	T	0	5	5	0	4	9	0	0
19	35076301	.	C	T	0	7	7	0	8	15	0	0
19	35076773	.	G	A	4	2	6	0	0	6	0	0
19	35078632	.	T	C	1	0	1	0	4	5	0	0
19	35079259	.	C	T	4	4	8	0	1	9	0	0
19	35079515	.	A	T	1	2	3	0	0	3	0	0
19	35083010	.	G	A	1	0	1	0	0	1	0	0
19	35083019	.	C	T	1	0	1	0	0	1	0	0
19	35083182	.	C	T	0	1	1	0	1	2	0	0
19	35116228	.	A	G	1	5	6	0	0	6	0	0
19	35116297	.	T	C	2	2	4	0	0	4	0	0
19	35116405	.	A	G	1	2	3	0	0	3	0	0
19	35116438	.	G	A	2	1	3	0	1	4	0	0
19	35119039	.	T	C	1	3	4	0	0	4	0	0
19	35119052	.	A	G	1	2	3	0	1	4	0	0
19	35119169	.	G	A	1	5	6	0	1	7	0	0
19	35119205	.	G	A	4	4	8	0	0	8	0	0
19	35119436	.	C	T	5	3	8	0	0	8	0	0
19	35121459	.	T	C	2	2	4	0	0	4	0	0
19	35359341	.	C	T	14	27	41	0	3	44	0	0
19	35386288	.	T	G	0	2	2	0	0	2	0	0
19	35418974	.	T	A	2	2	4	0	0	4	0	0
19	35419202	.	A	G	4	4	8	0	0	8	0	0
19	35419215	.	T	A	2	4	6	0	0	6	0	0
19	35422354	.	T	C	2	5	7	0	0	7	0	0
19	35428735	.	G	A	3	2	5	0	0	5	0	0
19	35433322	.	G	T	1	2	3	0	0	3	0	0
19	35433592	.	G	A	2	1	3	0	0	3	0	0
19	35433615	.	A	T	2	3	5	0	0	5	0	0
19	35459414	.	A	G	16	14	30	1	2	33	0	0
19	35459737	.	G	A	21	25	46	0	2	48	0	0
19	35459801	.	A	T	26	18	44	0	2	46	0	0
19	35473080	.	C	A	1	2	3	0	4	7	0	0
19	35722947	.	T	C	1	6	7	0	1	8	0	0
19	35723040	.	G	T	15	10	25	0	5	30	0	0
19	35723087	.	G	T	13	19	32	0	1	33	0	0
19	35723113	.	G	T	15	17	32	0	4	36	0	0
19	35723153	.	G	T	7	11	18	0	0	18	0	0
19	35723170	.	T	G	2	6	8	0	0	8	0	0
19	35723237	.	C	A	4	19	23	0	1	24	0	0
19	35723268	.	A	T	8	21	29	0	0	29	0	0
19	35723289	.	C	A	9	15	24	0	2	26	0	0
19	35723422	.	C	T	13	11	24	0	4	28	0	0
19	35723552	.	C	T	0	10	10	0	7	17	0	0
19	35733351	.	T	C	8	3	11	0	0	11	0	0
19	36120265	.	C	T	0	2	2	0	2	4	0	0
19	36167703	.	C	T	0	2	2	0	0	2	0	0
19	36167704	.	A	G	0	2	2	0	0	2	0	0
19	36627087	.	T	C	0	1	1	0	0	1	0	0
19	37122536	.	A	G	0	0	0	0	2	2	0	0
19	37127483	.	A	T	8	1	9	0	0	9	0	0
19	37133719	.	G	T	6	2	8	0	0	8	0	0
19	37133872	.	T	C	3	2	5	0	0	5	0	0
19	37138743	.	C	T	6	12	18	0	1	19	0	0
19	37139266	.	T	C	8	9	17	0	0	17	0	0
19	37481658	.	C	T	2	2	4	0	0	4	0	0
19	37492351	.	G	A	2	2	4	0	0	4	0	0
19	37501738	.	T	C	4	0	4	0	17	22	1	0
19	37501802	.	C	T	16	12	28	0	2	30	0	0
19	37501935	.	A	G	25	20	45	0	3	48	0	0
19	37501959	.	C	T	24	23	47	0	0	47	0	0
19	37502235	.	G	A	9	10	19	0	1	20	0	0
19	37504201	.	G	A	0	1	1	0	0	1	0	0
19	37505790	.	G	A	2	0	2	0	0	2	0	0
19	37505808	.	G	A	2	4	6	0	0	6	0	0
19	37505880	.	C	G	3	3	6	0	0	6	0	0
19	37506405	.	G	A	1	0	1	0	0	1	0	0
19	37506414	.	T	C	1	0	1	0	0	1	0	0
19	37508533	.	G	A	2	1	3	0	0	3	0	0
19	37815718	.	C	A	2	4	6	0	0	6	0	0
19	37815733	.	A	G	5	2	7	0	0	7	0	0
19	37815763	.	G	A	3	1	4	0	0	4	0	0
19	37835433	.	A	C	3	2	5	0	0	5	0	0
19	37926003	.	C	T	14	7	21	0	1	22	0	0
19	37926066	.	C	A	17	11	28	0	3	31	0	0
19	37926261	.	C	T	11	15	26	0	2	28	0	0
19	37926267	.	C	A	9	14	23	0	2	25	0	0
19	37926447	.	C	T	14	20	34	0	0	34	0	0
19	37926493	.	C	T	13	10	23	0	3	26	0	0
19	37926637	.	A	G	4	0	4	0	8	12	0	0
19	37926816	.	T	G	25	17	42	0	3	46	1	0
19	38171067	.	G	A	2	0	2	0	0	2	0	0
19	38205350	.	T	C	2	2	4	0	0	4	0	0
19	38216302	.	A	C	3	3	6	0	0	6	0	0
19	38216310	.	C	G	2	0	2	0	6	8	0	0
19	38227086	.	T	G	3	1	4	0	0	4	0	0
19	38327186	.	T	C	3	6	9	0	1	10	0	0
19	38327305	.	G	A	4	3	7	0	0	7	0	0
19	38327638	.	G	T	1	2	3	0	0	3	0	0
19	38389833	.	G	A	0	2	2	0	1	3	0	0
19	38467153	.	T	A	1	2	3	0	0	3	0	0
19	38776962	.	A	G	3	5	8	0	0	8	0	0
19	38777235	.	T	C	1	2	3	0	1	4	0	0
19	38793349	.	G	A	0	2	2	0	2	4	0	0
19	40026627	.	A	G	8	10	18	0	2	20	0	0
19	40026661	.	T	C	14	9	23	0	1	24	0	0
19	40027652	.	C	A	10	9	19	0	2	21	0	0
19	40031164	.	G	A	20	13	33	0	0	33	0	0
19	40039603	.	G	A	4	9	13	0	0	13	0	0
19	40039606	.	T	A	4	9	13	0	0	13	0	0
19	40039651	.	A	T	10	9	19	0	0	19	0	0
19	40052809	.	G	T	8	6	14	0	0	14	0	0
19	40052884	.	G	A	4	8	12	0	2	14	0	0
19	40055365	.	A	T	8	4	12	0	2	14	0	0
19	40105100	.	A	G	1	4	5	0	0	5	0	0
19	40105108	.	C	A	1	3	4	0	0	4	0	0
19	40110897	.	G	A	6	11	17	0	2	19	0	0
19	40113618	.	T	C	3	7	10	0	0	10	0	0
19	40147782	.	T	C	3	2	5	0	0	5	0	0
19	40147821	.	G	A	0	2	2	0	2	4	0	0
19	40151351	.	C	T	5	2	7	0	0	7	0	0
19	40151970	.	G	A	1	2	3	0	0	3	0	0
19	40151983	.	C	T	1	1	2	0	0	2	0	0
19	40153024	.	A	T	1	1	2	0	0	2	0	0
19	40154957	.	C	T	0	4	4	0	1	5	0	0
19	40155144	.	C	A	2	0	2	0	0	2	0	0
19	40155327	.	C	T	3	3	6	0	2	8	0	0
19	40156805	.	G	A	0	1	1	0	1	2	0	0
19	40157041	.	T	A	0	5	5	0	0	5	0	0
19	40162945	.	C	A	13	10	23	0	2	25	0	0
19	40163077	.	C	T	4	4	8	0	0	8	0	0
19	40163184	.	C	T	2	2	4	0	0	4	0	0
19	40163223	.	G	A	5	9	14	0	1	15	0	0
19	40177726	.	G	C	0	6	6	0	0	6	0	0
19	40180011	.	C	T	7	3	10	0	0	10	0	0
19	40180058	.	G	A	3	2	5	0	1	6	0	0
19	40340319	.	A	G	5	2	7	0	1	8	0	0
19	40343087	.	C	T	5	1	6	0	0	6	0	0
19	40347702	.	T	A	27	13	40	0	6	46	0	0
19	40347760	.	T	A	17	11	28	0	1	29	0	0
19	40347785	.	A	T	15	12	27	0	1	28	0	0
19	40558221	.	C	T	1	0	1	0	0	1	0	0
19	40558281	.	A	G	1	1	2	0	0	2	0	0
19	40641439	.	C	T	1	2	3	0	0	3	0	0
19	40685424	.	C	T	6	5	11	0	1	12	0	0
19	40685447	.	A	G	5	0	5	0	9	14	0	0
19	40685772	.	T	A	1	2	3	0	0	3	0	0
19	40686599	.	T	C	3	5	8	0	1	9	0	0
19	40716977	.	T	C	2	4	6	0	0	6	0	0
19	40717649	.	C	A	8	3	11	0	1	12	0	0
19	40731649	.	C	T	2	2	4	0	0	4	0	0
19	40889832	.	T	C	0	1	1	0	0	1	0	0
19	40892312	.	T	C	1	4	5	0	0	5	0	0
19	40895763	.	G	A	3	15	18	0	0	18	0	0
19	40895826	.	T	C	3	2	5	0	0	5	0	0
19	40898334	.	A	C	2	11	13	0	1	14	0	0
19	40898352	.	T	G	2	0	2	0	9	11	0	0
19	40898500	.	G	A	4	2	6	0	0	6	0	0
19	40900132	.	A	C	8	4	12	0	1	13	0	0
19	40906097	.	A	C	13	6	19	0	1	20	0	0
19	40906118	.	T	A	9	3	12	0	1	13	0	0
19	41002079	.	G	T	4	2	6	0	0	6	0	0
19	41021048	.	T	C	1	1	2	0	0	2	0	0
19	41033811	.	G	A	0	11	11	0	10	21	0	0
19	41038855	.	C	T	9	32	41	0	2	43	0	0
19	42573955	.	T	C	1	3	4	0	0	4	0	0
19	42843606	.	A	G	2	2	4	0	2	6	0	0
19	42843609	.	A	G	4	0	4	0	2	6	0	0
19	42843845	.	A	G	8	11	19	0	3	22	0	0
19	42843894	.	A	G	14	12	26	0	0	26	0	0
19	43900196	.	A	G	7	6	13	0	1	14	0	0
19	43900215	.	A	G	2	8	10	0	1	11	0	0
19	43900995	.	A	G	5	4	9	0	0	9	0	0
19	43901028	.	A	G	4	4	8	0	0	8	0	0
19	45859824	.	C	T	8	8	16	0	2	18	0	0
19	45868237	.	A	C	1	4	5	0	1	6	0	0
19	45883536	.	C	T	3	5	8	0	0	8	0	0
19	45883563	.	G	A	8	7	15	0	2	17	0	0
19	45896193	.	C	T	3	9	12	0	2	14	0	0
19	45962214	.	G	A	1	4	5	0	0	5	0	0
19	45967406	.	G	A	11	6	17	0	0	17	0	0
19	45967516	.	A	G	4	1	5	0	4	9	0	0
19	45977712	.	C	T	0	2	2	0	0	2	0	0
19	45980323	.	C	T	2	11	13	0	0	13	0	0
19	45980428	.	A	C	6	3	9	0	2	11	0	0
19	45999146	.	G	A	2	6	8	0	0	8	0	0
19	46001218	.	G	A	2	1	3	0	0	3	0	0
19	46019644	.	A	T	5	6	11	0	0	11	0	0
19	46019645	.	A	T	6	4	10	0	1	11	0	0
19	46020177	.	A	C	9	0	9	0	11	20	0	0
19	46020276	.	C	T	0	11	11	0	9	20	0	0
19	46020462	.	G	A	14	9	23	0	2	25	0	0
19	46020544	.	G	C	5	1	6	0	4	10	0	0
19	46028151	.	T	A	5	6	11	0	1	12	0	0
19	46043943	.	G	T	1	1	2	0	1	3	0	0
19	47481449	.	T	C	1	7	8	0	0	8	0	0
19	47976325	.	C	T	23	27	50	0	1	51	0	0
19	47982897	.	A	G	18	15	33	0	0	33	0	0
19	47983014	.	C	G	6	3	9	0	1	10	0	0
19	47983859	.	G	A	3	2	5	0	0	5	0	0
19	47984483	.	C	T	5	2	7	0	0	7	0	0
19	47986324	.	C	T	0	12	12	0	14	26	0	0
19	47997422	.	C	G	1	2	3	0	2	5	0	0
19	48013142	.	G	A	4	1	5	0	3	8	0	0
19	48013172	.	A	G	10	2	12	0	2	14	0	0
19	48014266	.	A	G	4	4	8	0	1	9	0	0
19	48022023	.	G	A	0	3	3	0	1	4	0	0
19	48022989	.	T	G	11	11	22	0	3	25	0	0
19	48031094	.	T	C	2	2	4	0	0	4	0	0
19	48032167	.	G	A	0	3	3	0	3	6	0	0
19	48033631	.	A	G	5	7	12	0	0	12	0	0
19	48036809	.	T	G	16	0	16	0	23	40	1	0
19	48049279	.	T	G	7	7	14	0	3	18	1	0
19	48050029	.	G	A	0	6	6	0	6	12	0	0
19	48053315	.	A	C	11	9	20	0	2	22	0	0
19	48064617	.	T	C	4	2	6	0	0	6	0	0
19	48065272	.	G	A	0	2	2	0	3	5	0	0
19	48067046	.	C	T	7	5	12	0	0	12	0	0
19	48069366	.	T	C	6	4	10	0	2	12	0	0
19	48102652	.	C	T	3	0	3	0	0	3	0	0
19	48114344	.	T	A	7	7	14	0	1	15	0	0
19	48119203	.	T	C	5	8	13	1	1	15	0	0
19	48120238	.	A	G	14	1	15	0	16	32	1	0
19	48281289	.	T	C	0	2	2	0	0	2	0	0
19	48284234	.	A	T	4	3	7	0	0	7	0	0
19	48364454	.	T	A	1	3	4	0	0	4	0	0
19	48364835	.	T	A	2	8	10	0	0	10	0	0
19	48364870	.	T	C	10	11	21	0	1	22	0	0
19	48407241	.	T	C	1	4	5	0	0	5	0	0
2	19225	.	T	C	9	9	18	0	0	18	0	0
2	19568	.	G	A	10	10	20	0	1	21	0	0
2	21074	.	A	G	16	10	26	0	4	30	0	0
2	21479	.	C	T	0	19	19	0	24	43	0	0
2	68899	.	A	G	1	2	3	0	0	3	0	0
2	71743	.	A	G	2	5	7	0	0	7	0	0
2	108000	.	C	T	4	5	9	0	0	9	0	0
2	108586	.	G	A	0	2	2	0	1	3	0	0
2	109030	.	G	A	16	15	31	0	1	32	0	0
2	109075	.	T	C	11	5	16	0	2	18	0	0
2	109284	.	T	C	7	3	10	0	1	11	0	0
2	112990	.	C	T	1	1	2	0	0	2	0	0
2	113654	.	A	G	0	4	4	0	0	4	0	0
2	114957	.	A	G	2	2	4	0	0	4	0	0
2	137169	.	T	C	0	1	1	0	0	1	0	0
2	138603	.	G	A	1	2	3	0	0	3	0	0
2	177241	.	G	T	20	0	20	0	1	21	0	0
2	177243	.	G	C	21	0	21	0	0	21	0	0
2	281634	.	A	G	2	4	6	0	2	8	0	0
2	374634	.	T	C	4	4	8	0	2	10	0	0
2	1220802	.	T	C	2	0	2	0	0	2	0	0
2	1453259	.	G	A	1	3	4	0	0	4	0	0
2	1500276	.	A	T	1	3	4	0	0	4	0	0
2	1500279	.	G	A	1	2	3	0	0	3	0	0
2	1504911	.	G	A	0	2	2	0	0	2	0	0
2	1527682	.	C	G	1	2	3	0	0	3	0	0
2	1569132	.	T	C	1	2	3	0	0	3	0	0
2	1595187	.	C	T	17	5	22	0	0	22	0	0
2	1595275	.	T	C	3	21	24	0	0	24	0	0
2	1595283	.	T	C	14	7	21	0	0	21	0	0
2	1595330	.	A	G	16	1	17	0	0	17	0	0
2	1595334	.	G	A	14	0	14	0	2	16	0	0
2	1595470	.	T	C	12	5	17	0	1	18	0	0
2	1595495	.	C	T	0	5	5	0	14	19	0	0
2	1595524	.	T	G	7	7	14	0	1	15	0	0
2	1595696	.	A	G	2	7	9	0	0	9	0	0
2	1595914	.	T	C	5	6	11	0	1	12	0	0
2	1595945	.	G	C	6	8	14	0	2	16	0	0
2	1596159	.	C	T	0	3	3	0	4	7	0	0
2	1596196	.	T	A	5	4	9	0	0	9	0	0
2	1596282	.	G	T	3	9	12	0	3	15	0	0
2	1596325	.	C	A	0	11	11	0	6	17	0	0
2	1596327	.	C	T	0	11	11	0	6	17	0	0
2	1596424	.	T	A	4	9	13	0	0	13	0	0
2	1596744	.	G	A	3	2	5	0	0	5	0	0
2	1596758	.	A	G	3	3	6	0	0	6	0	0
2	1597048	.	C	T	1	2	3	0	0	3	0	0
2	1597054	.	A	G	1	2	3	0	1	4	0	0
2	1597084	.	G	A	1	2	3	0	0	3	0	0
2	1597096	.	G	A	3	3	6	0	0	6	0	0
2	1597355	.	T	C	3	2	5	0	0	5	0	0
2	1597396	.	A	C	4	2	6	0	0	6	0	0
2	1597413	.	T	C	4	2	6	0	0	6	0	0
2	1597588	.	A	G	5	3	8	0	0	8	0	0
2	1597617	.	T	C	3	6	9	0	0	9	0	0
2	1597634	.	T	A	6	2	8	0	1	9	0	0
2	1597658	.	C	T	0	3	3	0	8	11	0	0
2	1597691	.	T	C	7	4	11	0	0	11	0	0
2	1598065	.	A	G	0	4	4	0	0	4	0	0
2	1598115	.	C	A	1	5	6	0	1	7	0	0
2	1598124	.	G	A	4	6	10	0	0	10	0	0
2	1598533	.	A	C	4	0	4	0	6	10	0	0
2	1868115	.	T	C	0	2	2	0	0	2	0	0
2	1941054	.	G	A	2	0	2	0	0	2	0	0
2	1942812	.	C	T	5	5	10	0	0	10	0	0
2	1943037	.	A	G	5	0	5	0	13	18	0	0
2	2001661	.	G	T	1	3	4	0	1	5	0	0
2	2005807	.	T	C	1	4	5	0	0	5	0	0
2	2005836	.	T	A	3	4	7	0	0	7	0	0
2	2005844	.	C	A	3	4	7	0	0	7	0	0
2	2008086	.	A	G	4	2	6	0	1	7	0	0
2	2010287	.	A	C	6	4	10	0	0	10	0	0
2	2010288	.	T	A	6	3	9	0	1	10	0	0
2	2010765	.	T	C	18	1	19	0	31	50	0	0
2	2010945	.	G	C	30	21	51	0	4	55	0	0
2	2011287	.	T	A	11	16	27	0	3	30	0	0
2	2013834	.	C	T	1	3	4	0	10	14	0	0
2	2017450	.	T	C	8	2	10	0	0	10	0	0
2	2025044	.	A	G	2	6	8	0	2	10	0	0
2	2025080	.	T	C	3	5	8	0	1	9	0	0
2	2025175	.	C	A	7	4	11	0	0	11	0	0
2	2025219	.	G	T	4	4	8	0	0	8	0	0
2	2025617	.	A	G	6	5	11	0	0	11	0	0
2	2026068	.	G	A	1	5	6	0	1	7	0	0
2	2026151	.	C	T	0	3	3	0	3	6	0	0
2	2026164	.	G	A	2	3	5	0	0	5	0	0
2	2026475	.	G	T	0	3	3	0	1	4	0	0
2	2168642	.	T	A	4	0	4	0	1	5	0	0
2	2169353	.	T	C	2	1	3	0	0	3	0	0
2	2172878	.	G	A	1	15	16	0	10	26	0	0
2	2172879	.	T	A	11	15	26	0	0	26	0	0
2	2173317	.	A	T	30	17	47	0	2	49	0	0
2	2251501	.	C	T	5	3	8	0	0	8	0	0
2	2256216	.	T	C	1	6	7	0	0	7	0	0
2	2256372	.	C	G	4	2	6	0	0	6	0	0
2	2256375	.	C	T	2	3	5	0	0	5	0	0
2	2256467	.	T	A	1	2	3	0	0	3	0	0
2	2630212	.	A	G	18	11	29	0	3	32	0	0
2	2633731	.	G	A	2	0	2	0	1	3	0	0
2	2638528	.	C	T	0	2	2	0	1	3	0	0
2	2785378	.	C	T	10	6	16	0	0	16	0	0
2	2786198	.	T	A	0	6	6	0	0	6	0	0
2	2791168	.	C	T	0	8	8	0	5	13	0	0
2	2795564	.	C	T	2	3	5	0	2	7	0	0
2	2873546	.	G	A	5	3	8	0	0	8	0	0
2	2873579	.	T	A	4	3	7	0	0	7	0	0
2	2892531	.	A	G	9	4	13	0	0	13	0	0
2	2894098	.	A	T	8	4	12	0	2	15	1	0
2	2911877	.	G	T	0	0	0	0	1	1	0	0
2	2911892	.	A	T	0	2	2	0	0	2	0	0
2	2913151	.	C	T	8	5	13	0	0	13	0	0
2	2913161	.	G	A	9	6	15	0	0	15	0	0
2	2916697	.	T	C	0	4	4	0	1	5	0	0
2	2917105	.	T	C	14	12	26	0	1	27	0	0
2	2967361	.	A	C	2	3	5	0	1	6	0	0
2	2967440	.	T	G	2	4	6	0	2	8	0	0
2	2967453	.	C	T	3	3	6	0	1	7	0	0
2	2973759	.	C	A	1	2	3	0	0	3	0	0
2	2975272	.	G	A	0	3	3	0	0	3	0	0
2	2977237	.	C	A	2	4	6	0	0	6	0	0
2	2987062	.	G	A	5	3	8	0	1	9	0	0
2	2987320	.	A	G	3	3	6	0	2	9	1	0
2	2987488	.	A	C	2	5	7	0	1	8	0	0
2	2988441	.	T	A	2	1	3	0	0	3	0	0
2	2988626	.	A	C	1	6	7	0	0	7	0	0
2	3014242	.	G	C	4	2	6	0	0	6	0	0
2	3015951	.	T	C	1	0	1	0	0	1	0	0
2	3020186	.	G	T	1	3	4	0	0	4	0	0
2	3026997	.	T	C	4	12	16	0	0	16	0	0
2	3027200	.	T	A	13	17	30	0	2	32	0	0
2	3027286	.	G	A	8	16	24	0	2	26	0	0
2	3027383	.	C	T	9	12	21	0	0	21	0	0
2	3027504	.	C	T	14	5	19	0	0	19	0	0
2	3027704	.	C	G	15	13	28	0	2	30	0	0
2	3027765	.	G	T	7	11	18	0	2	20	0	0
2	3027804	.	C	T	1	9	10	0	4	14	0	0
2	3027859	.	T	C	10	1	11	0	10	21	0	0
2	3027862	.	A	G	9	11	20	0	1	21	0	0
2	3027928	.	T	C	6	5	11	0	0	11	0	0
2	3028117	.	A	G	10	10	20	0	0	20	0	0
2	3028156	.	G	T	12	11	23	0	0	24	1	0
2	3028203	.	T	C	17	5	22	0	1	23	0	0
2	3028233	.	C	T	13	5	18	0	2	20	0	0
2	3028270	.	A	T	9	5	14	0	2	16	0	0
2	3028312	.	T	G	9	6	15	0	0	15	0	0
2	3028463	.	G	A	5	5	10	0	0	11	1	0
2	3028893	.	A	G	6	6	12	0	0	12	0	0
2	3028908	.	A	T	4	4	8	0	0	8	0	0
2	3029383	.	T	A	10	3	13	0	0	13	0	0
2	3032707	.	G	A	5	6	11	0	0	11	0	0
2	3032944	.	C	T	1	3	4	0	1	5	0	0
2	3034819	.	G	A	3	4	7	0	0	7	0	0
2	3050486	.	C	T	1	2	3	0	0	3	0	0
2	3056663	.	A	C	0	1	1	0	0	1	0	0
2	3062181	.	T	G	2	4	6	0	0	6	0	0
2	3062356	.	T	G	4	4	8	0	0	8	0	0
2	3062381	.	T	G	4	4	8	0	0	8	0	0
2	3062464	.	C	A	1	8	9	0	0	9	0	0
2	3064922	.	A	G	10	5	15	0	0	15	0	0
2	3064984	.	C	G	4	6	10	0	0	10	0	0
2	3064991	.	T	C	3	7	10	0	1	11	0	0
2	3065248	.	C	T	3	4	7	0	1	8	0	0
2	3065428	.	C	T	6	4	10	0	1	11	0	0
2	3065451	.	C	T	7	4	11	0	1	12	0	0
2	3065474	.	C	G	7	5	12	0	0	12	0	0
2	3065507	.	C	T	9	5	14	0	0	14	0	0
2	3065563	.	G	A	3	4	7	0	0	7	0	0
2	3065581	.	A	T	2	2	4	0	0	4	0	0
2	4019583	.	C	G	0	16	16	0	0	16	0	0
2	4019586	.	T	C	0	0	0	0	16	16	0	0
2	4052149	.	A	G	1	3	4	0	1	5	0	0
2	4729279	.	A	T	3	5	8	0	0	8	0	0
2	4729329	.	G	A	5	11	16	0	0	16	0	0
2	4729340	.	G	A	5	10	15	0	1	16	0	0
2	4729554	.	A	G	4	8	12	0	1	13	0	0
2	4729682	.	A	T	8	9	17	0	1	18	0	0
2	4729798	.	A	T	2	2	4	0	2	6	0	0
2	4729857	.	G	T	5	4	9	0	1	10	0	0
2	4730051	.	T	C	2	4	6	0	0	6	0	0
2	4736978	.	G	A	3	4	7	0	0	7	0	0
2	4737177	.	C	G	1	3	4	0	0	5	1	0
2	4737217	.	G	T	1	4	5	0	0	5	0	0
2	4900650	.	T	C	30	11	41	0	3	44	0	0
2	4900688	.	A	C	18	15	33	0	3	36	0	0
2	4900798	.	T	C	21	25	46	0	1	47	0	0
2	4907857	.	C	T	2	4	6	0	0	6	0	0
2	4950607	.	C	T	1	1	2	0	0	2	0	0
2	4995045	.	C	G	2	6	8	0	1	9	0	0
2	4995084	.	C	T	0	4	4	0	1	5	0	0
2	5014631	.	A	C	4	4	8	0	1	9	0	0
2	5407507	.	A	G	5	4	9	0	0	9	0	0
2	5883127	.	A	G	15	8	23	0	2	25	0	0
2	5883761	.	G	A	0	1	1	0	0	1	0	0
2	5883777	.	C	T	0	1	1	0	0	1	0	0
2	7150995	.	T	A	2	2	4	0	0	4	0	0
2	7150997	.	T	G	2	2	4	0	0	4	0	0
2	7423129	.	T	C	0	2	2	0	0	2	0	0
2	7423142	.	T	C	1	0	1	0	3	4	0	0
2	7765859	.	T	C	0	4	4	0	0	4	0	0
2	7767314	.	C	T	3	4	7	0	2	9	0	0
2	10094267	.	T	C	3	1	4	0	0	4	0	0
2	10685924	.	A	G	8	0	8	0	4	12	0	0
2	11945684	.	A	T	10	3	13	0	0	13	0	0
2	15864586	.	C	T	1	5	6	0	0	6	0	0
2	15942637	.	A	G	8	8	16	0	0	16	0	0
2	16221213	.	T	C	1	0	1	0	4	5	0	0
2	16548508	.	T	C	25	9	34	0	1	35	0	0
2	16548514	.	T	C	16	14	30	0	3	33	0	0
2	16838836	.	T	C	1	0	1	2	8	11	0	0
2	16838837	.	C	T	0	6	6	2	3	11	0	0
2	17267621	.	G	A	1	2	3	0	0	3	0	0
2	17450642	.	C	T	7	7	14	0	0	14	0	0
2	17450726	.	A	T	7	8	15	0	1	16	0	0
2	17450841	.	A	T	1	5	6	0	0	6	0	0
2	17450859	.	C	A	0	4	4	0	3	7	0	0
2	17451003	.	G	A	7	5	12	0	0	12	0	0
2	17451198	.	G	A	7	10	17	0	1	18	0	0
2	17451327	.	A	G	12	9	21	0	3	24	0	0
2	17451375	.	G	A	10	7	17	0	0	17	0	0
2	17468947	.	C	T	1	0	1	0	0	1	0	0
2	17578471	.	A	T	3	3	6	0	0	6	0	0
2	17578710	.	A	G	15	23	38	0	2	40	0	0
2	17579033	.	G	A	22	9	31	0	2	33	0	0
2	17579109	.	A	C	27	0	27	0	9	38	2	0
2	17579110	.	A	G	28	8	36	0	0	38	2	0
2	17579324	.	T	C	29	8	37	0	1	38	0	0
2	17604640	.	G	C	3	2	5	0	0	5	0	0
2	17644609	.	T	C	3	0	3	0	12	15	0	0
2	17646976	.	G	A	0	2	2	0	0	2	0	0
2	17651565	.	C	T	3	18	21	0	1	22	0	0
2	17651574	.	C	T	4	16	20	0	1	21	0	0
2	17656547	.	G	A	1	5	6	0	1	7	0	0
2	19101485	.	T	G	0	0	0	0	0	2	2	0
2	20264295	.	G	C	1	2	3	0	0	3	0	0
2	20367846	.	A	C	6	4	10	0	0	10	0	0
2	20368569	.	A	C	2	4	6	0	1	7	0	0
2	20368630	.	G	A	0	7	7	0	5	12	0	0
2	20368761	.	T	C	13	10	23	0	1	24	0	0
2	20368812	.	G	A	17	9	26	0	1	27	0	0
2	20368965	.	C	T	16	18	34	0	2	36	0	0
2	20369516	.	A	G	14	6	20	0	2	22	0	0
2	20369836	.	A	T	13	21	34	0	1	35	0	0
2	20369925	.	T	A	14	13	27	0	0	27	0	0
2	20369947	.	A	C	13	8	21	0	6	27	0	0
2	20370012	.	C	T	6	14	20	0	1	21	0	0
2	20370090	.	G	C	11	21	32	0	1	33	0	0
2	20370143	.	C	T	16	20	36	0	0	36	0	0
2	20370710	.	A	T	7	2	9	0	2	11	0	0
2	20370792	.	T	C	21	17	38	0	4	42	0	0
2	20370893	.	C	T	18	16	34	0	2	36	0	0
2	20370998	.	A	G	15	16	31	0	3	34	0	0
2	20371060	.	T	A	14	5	19	0	1	20	0	0
2	20371210	.	G	C	6	7	13	0	0	13	0	0
2	20437721	.	G	A	6	4	10	0	0	10	0	0
2	20437878	.	G	A	5	2	7	0	1	8	0	0
2	20438054	.	G	A	7	8	15	0	0	15	0	0
2	20438061	.	A	T	7	6	13	0	1	14	0	0
2	20438589	.	C	T	5	6	11	0	0	11	0	0
2	20439070	.	A	G	4	0	4	0	15	19	0	0
2	20439223	.	G	T	14	11	25	0	1	27	1	0
2	20439303	.	C	T	11	8	19	0	3	22	0	0
2	20440244	.	G	A	1	0	1	0	1	2	0	0
2	20505994	.	C	T	3	1	4	0	1	5	0	0
2	20505995	.	C	T	1	3	4	0	1	5	0	0
2	20514915	.	A	G	0	2	2	0	0	2	0	0
2	20515013	.	G	A	4	5	9	0	1	10	0	0
2	20515056	.	G	A	3	1	4	0	0	4	0	0
2	20515060	.	T	G	2	0	2	0	0	2	0	0
2	20516291	.	G	A	2	2	4	0	1	5	0	0
2	20523002	.	C	T	4	2	6	0	0	6	0	0
2	20523004	.	C	T	3	2	5	0	1	6	0	0
2	20523351	.	T	A	5	12	17	0	2	20	1	0
2	20523364	.	A	G	8	16	24	0	0	24	0	0
2	20526411	.	T	C	18	29	47	0	3	50	0	0
2	20526592	.	A	G	20	0	20	0	12	32	0	0
2	20526599	.	T	A	21	10	31	0	2	33	0	0
2	20811080	.	C	T	1	4	5	0	0	5	0	0
2	20814291	.	T	G	10	6	16	0	0	16	0	0
2	20814488	.	C	T	14	8	22	0	1	23	0	0
2	20814754	.	G	T	0	3	3	0	0	3	0	0
2	20817736	.	G	A	2	3	5	0	0	5	0	0
2	20820587	.	C	T	3	4	7	0	0	7	0	0
2	20822794	.	A	G	5	4	9	0	0	9	0	0
2	20824654	.	T	C	0	0	0	0	1	1	0	0
2	20826495	.	T	C	2	0	2	0	0	2	0	0
2	20828235	.	C	T	0	1	1	0	1	2	0	0
2	20830387	.	A	G	2	6	8	0	0	8	0	0
2	20837017	.	G	A	1	1	2	0	0	2	0	0
2	20840539	.	C	A	2	2	4	0	1	5	0	0
2	20868556	.	G	T	1	0	1	0	0	1	0	0
2	20874515	.	T	C	1	0	1	0	0	1	0	0
2	20875064	.	C	T	11	5	16	0	0	16	0	0
2	20875112	.	G	A	0	7	7	0	11	18	0	0
2	20875166	.	C	T	4	0	4	0	1	5	0	0
2	20875860	.	A	G	3	4	7	0	0	7	0	0
2	20875922	.	T	A	0	2	2	0	0	2	0	0
2	20916904	.	C	T	0	2	2	0	2	4	0	0
2	20917133	.	G	A	1	1	2	0	0	2	0	0
2	20967782	.	C	G	1	1	2	0	0	2	0	0
2	20967788	.	G	A	1	2	3	0	0	3	0	0
2	20972877	.	A	G	3	6	9	0	3	12	0	0
2	20973019	.	G	A	1	2	3	0	0	3	0	0
2	20973794	.	A	T	5	7	12	0	0	12	0	0
2	20973864	.	G	A	0	1	1	0	2	3	0	0
2	20973934	.	T	C	5	2	7	0	0	7	0	0
2	20975010	.	T	C	4	3	7	0	0	7	0	0
2	20975255	.	G	C	8	7	15	0	1	16	0	0
2	20975283	.	C	T	12	11	23	0	0	23	0	0
2	20975460	.	T	C	3	6	9	0	0	9	0	0
2	20980356	.	T	C	8	7	15	0	1	16	0	0
2	21071401	.	T	A	2	1	3	0	0	3	0	0
2	21071957	.	G	A	1	0	1	0	0	1	0	0
2	21073286	.	T	A	3	2	5	0	1	6	0	0
2	21073350	.	A	C	3	2	5	0	0	5	0	0
2	21076203	.	C	T	14	3	17	0	2	19	0	0
2	21076342	.	T	C	5	2	7	0	1	8	0	0
2	21076499	.	T	G	1	2	3	0	0	3	0	0
2	21076805	.	C	A	4	3	7	0	0	7	0	0
2	21077268	.	G	T	14	10	24	0	2	26	0	0
2	21077299	.	C	T	11	11	22	0	3	25	0	0
2	21077726	.	C	T	3	7	10	0	1	11	0	0
2	21082585	.	C	G	4	2	6	0	1	7	0	0
2	21082596	.	C	A	3	2	5	0	0	5	0	0
2	21156350	.	G	A	1	3	4	0	0	4	0	0
2	21156490	.	G	A	1	3	4	0	0	4	0	0
2	21167395	.	G	A	0	1	1	0	0	1	0	0
2	21177237	.	G	A	2	3	5	0	0	5	0	0
2	21182482	.	G	T	3	7	10	0	1	11	0	0
2	21312257	.	T	C	1	2	3	0	0	3	0	0
2	21320664	.	C	T	1	2	3	0	0	3	0	0
2	21320768	.	G	A	4	2	6	0	1	7	0	0
2	21321144	.	G	A	0	2	2	0	0	2	0	0
2	21321149	.	A	T	1	2	3	0	0	3	0	0
2	21338095	.	G	A	4	3	7	0	0	7	0	0
2	21338146	.	C	A	2	3	5	0	0	5	0	0
2	21338276	.	T	C	2	1	3	0	0	3	0	0
2	21356392	.	C	T	3	2	5	0	0	5	0	0
2	21367952	.	A	G	1	2	3	0	0	3	0	0
2	21367977	.	C	T	2	3	5	0	1	6	0	0
2	21368006	.	T	C	2	2	4	0	2	6	0	0
2	21381230	.	C	T	3	6	9	0	1	10	0	0
2	21459196	.	C	T	3	3	6	0	1	7	0	0
2	21459661	.	C	G	3	3	6	0	0	6	0	0
2	21459701	.	C	A	2	3	5	0	0	5	0	0
2	21462185	.	A	G	2	0	2	0	1	3	0	0
2	21462191	.	A	G	2	1	3	0	0	3	0	0
2	21466555	.	T	C	12	8	20	0	0	20	0	0
2	21466567	.	A	T	13	11	24	0	1	25	0	0
2	21468807	.	G	A	16	13	29	0	0	29	0	0
2	21468825	.	G	A	19	9	28	0	2	30	0	0
2	21469405	.	T	C	7	15	22	0	2	24	0	0
2	21469490	.	T	C	10	10	20	0	2	22	0	0
2	21469644	.	A	G	14	9	23	0	0	23	0	0
2	21469830	.	T	A	5	7	12	0	0	12	0	0
2	21502301	.	G	T	2	2	4	0	0	4	0	0
2	21502307	.	C	T	1	2	3	0	0	3	0	0
2	21502364	.	C	T	1	2	3	0	0	3	0	0
2	21502540	.	G	C	5	6	11	0	2	13	0	0
2	21605857	.	T	C	2	4	6	0	0	6	0	0
2	21607519	.	A	T	2	0	2	0	1	3	0	0
2	21608427	.	C	G	5	4	9	0	0	9	0	0
2	21608582	.	G	A	13	14	27	0	0	27	0	0
2	21608587	.	C	T	16	13	29	0	1	30	0	0
2	21608710	.	T	A	7	11	18	0	0	18	0	0
2	21608781	.	T	G	6	3	9	0	1	10	0	0
2	21609104	.	A	T	4	3	7	0	0	7	0	0
2	21609223	.	C	T	0	3	3	0	2	5	0	0
2	21609443	.	C	A	5	4	9	0	0	9	0	0
2	21609446	.	C	T	5	4	9	0	0	9	0	0
2	21609789	.	A	T	1	2	3	0	0	3	0	0
2	21610233	.	G	A	0	3	3	0	0	3	0	0
2	21612380	.	C	T	3	3	6	0	2	8	0	0
2	21613008	.	T	C	1	1	2	0	0	2	0	0
2	21620412	.	A	G	9	2	11	0	1	12	0	0
2	21620691	.	G	A	6	7	13	0	0	13	0	0
2	21620856	.	C	T	10	4	14	0	2	16	0	0
2	21621151	.	G	A	7	5	12	0	1	13	0	0
2	21621423	.	C	T	0	2	2	0	7	9	0	0
2	21621507	.	T	C	4	3	7	0	1	8	0	0
2	21621528	.	A	G	5	2	7	0	0	7	0	0
2	21621606	.	C	T	1	3	4	0	0	4	0	0
2	21621762	.	T	C	1	4	5	0	0	5	0	0
2	21766212	.	A	G	8	12	20	0	0	20	0	0
2	21766237	.	G	A	12	4	16	0	2	18	0	0
2	21766277	.	G	A	10	6	16	0	2	18	0	0
2	21766478	.	T	A	11	4	15	0	3	18	0	0
2	21766554	.	G	A	6	5	11	0	1	12	0	0
2	21766785	.	G	A	5	8	13	0	2	17	2	0
2	21767207	.	C	T	6	8	14	0	2	16	0	0
2	21767244	.	A	T	4	7	11	0	0	11	0	0
2	21767286	.	T	C	7	3	10	0	0	10	0	0
2	21768168	.	G	A	9	5	14	0	0	14	0	0
2	21768821	.	T	A	4	3	7	0	0	7	0	0
2	21771191	.	G	T	4	3	7	0	1	8	0	0
2	21772082	.	G	A	0	2	2	0	0	2	0	0
2	21777101	.	C	A	1	2	3	0	0	3	0	0
2	21777102	.	A	G	1	2	3	0	0	3	0	0
2	21822288	.	C	A	17	28	45	0	9	54	0	0
2	21822816	.	T	A	14	13	27	0	2	29	0	0
2	21827276	.	A	G	7	19	26	0	0	26	0	0
2	21855248	.	C	G	3	4	7	0	0	7	0	0
2	21855253	.	G	A	0	3	3	0	4	7	0	0
2	21862511	.	C	T	6	2	8	0	0	8	0	0
2	21865620	.	G	C	9	5	14	0	0	14	0	0
2	21877711	.	C	G	11	10	21	0	0	21	0	0
2	21877878	.	G	A	7	5	12	0	0	12	0	0
2	21878036	.	G	C	18	10	28	0	0	28	0	0
2	21878053	.	T	C	9	15	24	0	1	25	0	0
2	21878197	.	T	C	22	15	37	0	0	37	0	0
2	21878415	.	C	T	17	18	35	0	1	36	0	0
2	21878462	.	T	C	21	10	31	0	1	32	0	0
2	22058098	.	C	T	5	4	9	0	0	9	0	0
2	22058200	.	C	T	2	7	9	0	6	15	0	0
2	22058254	.	G	A	3	4	7	0	0	7	0	0
2	22058281	.	C	T	1	4	5	0	0	5	0	0
2	22073176	.	C	T	7	12	19	0	2	21	0	0
2	22101657	.	C	T	21	16	37	0	1	38	0	0
2	22101699	.	A	C	7	7	14	0	2	16	0	0
2	22104292	.	C	T	16	22	38	0	2	40	0	0
2	22104415	.	C	A	17	13	30	0	7	37	0	0
2	22104506	.	T	C	17	12	29	0	0	29	0	0
2	22104999	.	A	G	27	18	45	0	2	47	0	0
2	22105079	.	G	A	5	5	10	0	0	10	0	0
2	22208514	.	G	T	3	8	11	0	2	13	0	0
2	22208560	.	G	A	12	8	20	0	2	22	0	0
2	22208638	.	A	G	12	11	23	0	0	23	0	0
2	22209045	.	C	A	13	17	30	0	0	30	0	0
2	22209722	.	C	T	6	10	16	0	1	17	0	0
2	22210412	.	G	A	7	5	12	0	0	12	0	0
2	22353568	.	T	C	18	16	34	0	1	35	0	0
2	22353661	.	T	A	17	12	29	0	1	30	0	0
2	22353818	.	T	C	12	12	24	0	5	29	0	0
2	22353827	.	T	A	14	15	29	0	4	33	0	0
2	22362290	.	G	A	15	12	27	0	2	29	0	0
2	22362302	.	G	A	14	14	28	0	1	29	0	0
2	22363365	.	T	C	0	2	2	0	0	2	0	0
2	22363418	.	T	A	0	2	2	0	0	2	0	0
2	22395336	.	G	C	1	2	3	0	0	3	0	0
2	22480321	.	G	T	13	12	25	0	1	26	0	0
2	22480759	.	G	A	19	18	37	0	1	38	0	0
2	22483222	.	G	A	3	7	10	0	0	10	0	0
2	22483351	.	A	G	1	8	9	0	0	9	0	0
2	22483381	.	A	G	7	3	10	0	1	11	0	0
2	22483423	.	C	T	6	6	12	0	0	12	0	0
2	22483444	.	A	G	5	5	10	0	0	10	0	0
2	22513202	.	A	G	4	2	6	0	0	6	0	0
2	22516758	.	A	G	3	0	3	0	0	3	0	0
2	22521337	.	G	A	3	2	5	0	2	7	0	0
2	22599787	.	C	T	2	3	5	0	0	5	0	0
2	22602653	.	A	G	3	2	5	0	0	5	0	0
2	22602808	.	C	T	4	4	8	0	0	8	0	0
2	22602826	.	C	T	4	4	8	0	0	8	0	0
2	22608314	.	G	T	5	7	12	0	0	12	0	0
2	22614357	.	T	A	4	2	6	0	1	7	0	0
2	22614448	.	T	A	6	6	12	0	2	14	0	0
2	22614529	.	C	T	8	7	15	0	0	15	0	0
2	22614959	.	A	T	9	10	19	0	1	20	0	0
2	22617932	.	G	A	12	19	31	0	3	34	0	0
2	22626878	.	T	A	11	5	16	0	1	17	0	0
2	22627149	.	G	A	12	9	21	0	0	21	0	0
2	22629684	.	C	T	0	5	5	0	6	11	0	0
2	22633869	.	G	A	5	3	8	0	0	8	0	0
2	22634070	.	A	G	5	1	6	0	0	6	0	0
2	22653693	.	T	A	8	7	15	0	0	15	0	0
2	22656651	.	G	A	5	4	9	0	0	9	0	0
2	22656708	.	T	C	1	2	3	0	0	3	0	0
2	22656870	.	A	G	6	6	12	0	0	12	0	0
2	22659072	.	G	A	1	2	3	0	0	3	0	0
2	22714603	.	A	G	2	2	4	0	0	4	0	0
2	22716770	.	T	C	2	3	5	0	0	5	0	0
2	22718895	.	T	A	2	2	4	0	1	5	0	0
2	22719145	.	A	G	3	0	3	0	3	6	0	0
2	22724661	.	T	C	0	1	1	0	0	1	0	0
2	22733494	.	A	T	1	2	3	0	0	3	0	0
2	22733813	.	A	G	3	4	7	0	0	7	0	0
2	22735205	.	A	T	7	5	12	0	0	12	0	0
2	22735232	.	C	T	3	2	5	0	1	6	0	0
2	22742179	.	C	T	3	2	5	0	0	5	0	0
2	22745690	.	C	T	2	2	4	0	0	4	0	0
2	22747304	.	C	T	7	3	10	0	0	10	0	0
2	22750164	.	C	T	0	1	1	0	0	1	0	0
2	22750621	.	C	T	1	3	4	0	0	4	0	0
2	22750622	.	A	G	1	2	3	0	1	4	0	0
2	22756528	.	C	T	10	9	19	0	1	20	0	0
2	22795615	.	A	G	11	11	22	0	1	23	0	0
2	22799294	.	T	A	1	1	2	0	0	2	0	0
2	22801748	.	T	C	24	20	44	0	0	44	0	0
2	22801899	.	A	T	7	13	20	0	2	23	1	0
2	22802030	.	G	A	0	17	17	0	20	37	0	0
2	22802117	.	A	T	15	19	34	0	6	40	0	0
2	22802402	.	T	C	17	18	35	0	0	35	0	0
2	22802504	.	G	A	20	11	31	0	1	32	0	0
2	22802524	.	T	A	18	12	30	0	0	30	0	0
2	22803110	.	T	A	19	25	44	0	2	46	0	0
2	22803128	.	G	T	28	22	50	0	2	52	0	0
2	22803190	.	C	T	28	22	50	0	3	53	0	0
2	22859339	.	C	A	1	1	2	0	1	3	0	0
2	22860487	.	A	G	1	2	3	0	0	3	0	0
2	22860517	.	A	T	1	3	4	0	0	4	0	0
2	22860541	.	C	T	2	2	4	0	0	4	0	0
2	22861088	.	A	T	2	2	4	0	0	4	0	0
2	22932584	.	C	T	1	3	4	0	0	4	0	0
2	22933175	.	T	G	2	4	6	0	0	6	0	0
2	22933218	.	C	A	2	3	5	0	0	5	0	0
2	22933539	.	G	A	8	5	13	0	1	14	0	0
2	22933554	.	G	A	5	5	10	0	2	12	0	0
2	22944464	.	G	A	1	2	3	0	1	4	0	0
2	22970363	.	C	A	5	3	8	0	0	8	0	0
2	22970413	.	G	A	6	7	13	0	1	14	0	0
2	22970683	.	C	G	2	6	8	0	0	8	0	0
2	22970707	.	G	A	2	6	8	0	0	8	0	0
2	22970764	.	G	A	2	3	5	0	1	6	0	0
2	22971012	.	T	A	12	10	22	0	0	22	0	0
2	22979805	.	G	A	1	3	4	0	0	5	1	0
2	22994327	.	G	A	7	4	11	0	2	13	0	0
2	22996520	.	A	T	3	0	3	0	0	3	0	0
2	23001533	.	G	A	8	8	16	0	2	18	0	0
2	23001638	.	G	T	5	8	13	0	0	13	0	0
2	23003857	.	C	G	0	1	1	0	0	1	0	0
2	23020948	.	C	T	0	2	2	0	0	2	0	0
2	23023465	.	G	A	6	4	10	0	1	11	0	0
2	23023466	.	C	G	5	5	10	0	1	11	0	0
2	23023741	.	A	C	2	1	3	0	1	4	0	0
2	23023890	.	G	T	5	4	9	0	0	9	0	0
2	23024069	.	C	A	4	6	10	0	1	11	0	0
2	23024735	.	G	T	5	2	7	0	1	8	0	0
2	23066671	.	C	T	1	2	3	0	0	3	0	0
2	23078082	.	A	G	8	5	13	0	3	16	0	0
2	23085185	.	C	T	1	2	3	0	0	3	0	0
2	23094876	.	C	T	2	2	4	0	0	4	0	0
2	23094912	.	C	T	2	1	3	0	0	3	0	0
2	23098416	.	G	A	0	2	2	0	0	2	0	0
2	23098856	.	T	A	7	3	10	0	0	10	0	0
2	23099307	.	T	C	2	2	4	0	1	5	0	0
2	23099369	.	G	C	2	8	10	0	1	11	0	0
2	23223037	.	C	T	2	1	3	0	0	3	0	0
2	23238502	.	C	T	1	0	1	0	0	1	0	0
2	23263294	.	T	A	1	1	2	0	0	2	0	0
2	23292123	.	A	T	3	2	5	0	0	5	0	0
2	23292262	.	G	A	5	6	11	0	0	12	1	0
2	23292429	.	A	T	9	10	19	0	1	20	0	0
2	23292516	.	G	A	0	8	8	0	8	16	0	0
2	23292549	.	C	A	3	9	12	0	1	13	0	0
2	23292690	.	T	A	9	9	18	0	0	18	0	0
2	23293123	.	G	C	10	6	16	0	2	18	0	0
2	23293230	.	A	T	11	5	16	0	1	17	0	0
2	23361208	.	C	T	23	14	37	0	0	37	0	0
2	23361359	.	T	C	14	11	25	0	0	25	0	0
2	23379480	.	G	C	1	5	6	0	0	6	0	0
2	23379532	.	G	A	4	8	12	0	0	12	0	0
2	23379588	.	C	T	10	10	20	0	2	22	0	0
2	23379861	.	G	A	7	5	12	0	0	12	0	0
2	23721729	.	T	A	0	1	1	0	2	3	0	0
2	23722311	.	C	T	2	2	4	0	0	4	0	0
2	23722849	.	T	C	3	2	5	0	0	5	0	0
2	23723521	.	A	T	2	4	6	0	0	6	0	0
2	23723571	.	G	A	3	2	5	0	2	7	0	0
2	23723638	.	A	T	1	2	3	0	1	4	0	0
2	23724359	.	A	T	2	3	5	0	0	5	0	0
2	23724535	.	T	G	2	3	5	0	0	5	0	0
2	23725075	.	G	A	7	9	16	0	0	16	0	0
2	23725159	.	T	C	6	11	17	0	1	18	0	0
2	23725184	.	C	A	9	8	17	0	1	18	0	0
2	23725239	.	C	T	1	7	8	0	1	9	0	0
2	23725608	.	A	T	3	9	12	0	2	14	0	0
2	23725754	.	A	T	4	5	9	0	3	12	0	0
2	23725756	.	A	T	7	5	12	0	0	12	0	0
2	23725906	.	C	A	6	4	10	0	1	11	0	0
2	23725980	.	A	C	5	4	9	0	1	10	0	0
2	23725986	.	G	T	6	5	11	0	0	11	0	0
2	23726290	.	T	C	12	7	19	0	2	21	0	0
2	23726312	.	G	A	13	16	29	0	0	29	0	0
2	23726353	.	G	A	12	16	28	0	0	28	0	0
2	23726393	.	C	T	6	10	16	0	1	18	1	0
2	23803219	.	G	A	1	1	2	0	1	3	0	0
2	23816293	.	A	C	5	2	7	0	0	7	0	0
2	23818209	.	A	T	1	2	3	0	0	3	0	0
2	23818418	.	A	T	2	3	5	0	0	5	0	0
2	23818580	.	T	A	1	3	4	0	0	4	0	0
2	23819237	.	T	G	0	2	2	0	0	2	0	0
2	23819241	.	G	C	0	2	2	0	0	2	0	0
2	23819302	.	C	G	1	3	4	0	0	4	0	0
2	23819603	.	T	C	1	3	4	0	0	4	0	0
2	23819640	.	T	A	2	2	4	0	0	4	0	0
2	23819862	.	A	C	3	6	9	0	0	9	0	0
2	23937227	.	G	A	5	5	10	0	1	11	0	0
2	24202456	.	G	A	2	2	4	0	0	4	0	0
2	24218927	.	G	A	0	13	13	0	9	22	0	0
2	24222069	.	A	C	5	5	10	0	1	11	0	0
2	24223991	.	A	G	5	16	21	0	7	28	0	0
2	24238629	.	C	T	2	2	4	0	1	5	0	0
2	24248657	.	A	G	2	31	33	0	2	35	0	0
2	24249037	.	T	A	20	17	37	0	2	39	0	0
2	24249211	.	A	G	21	21	42	0	1	43	0	0
2	24249849	.	C	T	5	10	15	0	1	16	0	0
2	24250303	.	C	T	8	14	22	0	0	22	0	0
2	24250345	.	A	C	13	9	22	0	3	25	0	0
2	24250482	.	C	T	23	15	38	0	2	40	0	0
2	24251294	.	G	A	0	27	27	0	33	61	1	0
2	24251430	.	A	G	27	24	51	0	9	60	0	0
2	24251800	.	G	A	28	25	53	0	5	58	0	0
2	24251848	.	T	C	29	29	58	0	3	61	0	0
2	24252088	.	C	T	30	35	65	0	2	67	0	0
2	24310822	.	C	T	10	13	23	0	0	23	0	0
2	24310850	.	G	C	17	14	31	0	1	32	0	0
2	24310897	.	G	A	17	18	35	0	2	37	0	0
2	24311045	.	T	C	19	0	19	0	20	39	0	0
2	24311697	.	C	T	7	3	10	0	2	12	0	0
2	24311703	.	A	G	6	5	11	0	3	14	0	0
2	24311793	.	G	C	18	20	38	0	4	42	0	0
2	24311879	.	A	G	7	8	15	0	2	17	0	0
2	24313884	.	T	C	9	12	21	0	0	21	0	0
2	24314185	.	T	A	4	4	8	0	0	8	0	0
2	24315047	.	A	G	0	4	4	0	0	4	0	0
2	24315068	.	A	G	0	3	3	0	0	3	0	0
2	24316545	.	C	T	1	2	3	0	0	3	0	0
2	24317537	.	G	A	7	12	19	0	0	19	0	0
2	24319851	.	T	C	12	9	21	0	3	24	0	0
2	24320173	.	C	T	9	9	18	0	2	20	0	0
2	24321853	.	T	C	5	0	5	0	9	14	0	0
2	24322180	.	G	T	10	6	16	0	2	18	0	0
2	24326455	.	A	G	3	4	7	0	0	7	0	0
2	24326509	.	G	A	2	2	4	0	0	4	0	0
2	24335246	.	G	A	1	3	4	0	0	4	0	0
2	24376511	.	C	T	3	4	7	0	0	7	0	0
2	24385271	.	T	G	3	11	14	0	0	14	0	0
2	24385633	.	C	T	11	10	21	0	1	22	0	0
2	24386286	.	A	T	3	2	5	0	0	5	0	0
2	24414062	.	G	A	7	5	12	0	0	12	0	0
2	24432634	.	G	T	0	2	2	0	1	3	0	0
2	24444839	.	C	G	0	3	3	0	2	5	0	0
2	24461305	.	C	T	0	2	2	0	3	5	0	0
2	24461957	.	G	A	0	2	2	0	2	4	0	0
2	24508860	.	G	T	0	4	4	0	0	4	0	0
2	24541321	.	T	C	0	1	1	0	0	1	0	0
2	24558443	.	C	T	7	2	9	0	1	10	0	0
2	24558465	.	C	T	8	4	12	0	0	12	0	0
2	24558512	.	A	T	10	6	16	0	0	16	0	0
2	24558537	.	T	A	9	2	11	0	1	12	0	0
2	24558570	.	C	T	8	3	11	0	0	11	0	0
2	24558677	.	G	A	2	4	6	0	2	8	0	0
2	24558682	.	T	A	3	4	7	0	2	9	0	0
2	24558790	.	C	G	0	2	2	0	0	2	0	0
2	24558836	.	T	C	3	2	5	0	0	5	0	0
2	24559091	.	A	T	3	4	7	0	0	7	0	0
2	24559243	.	T	G	1	2	3	0	0	3	0	0
2	24559434	.	G	A	1	2	3	1	1	5	0	0
2	24560248	.	A	G	3	4	7	0	0	7	0	0
2	24560794	.	T	A	0	7	7	0	1	8	0	0
2	24561244	.	A	G	1	2	3	0	0	3	0	0
2	24650758	.	C	T	2	5	7	0	1	8	0	0
2	24682951	.	T	C	12	9	21	0	3	24	0	0
2	24683093	.	A	G	15	2	17	0	7	24	0	0
2	24749438	.	A	G	3	2	5	0	0	5	0	0
2	24750918	.	A	T	1	2	3	0	0	3	0	0
2	24751567	.	T	A	5	3	8	0	0	8	0	0
2	24751608	.	A	T	3	3	6	0	0	6	0	0
2	24751991	.	A	G	7	3	10	0	0	10	0	0
2	24752048	.	C	T	3	3	6	0	2	8	0	0
2	24752157	.	G	A	3	7	10	0	0	10	0	0
2	24752179	.	C	T	3	5	8	0	1	9	0	0
2	24752737	.	A	G	6	4	10	0	0	10	0	0
2	24753062	.	T	C	2	5	7	0	0	7	0	0
2	24753311	.	G	T	3	2	5	0	0	5	0	0
2	24753362	.	A	G	4	2	6	0	0	6	0	0
2	24753535	.	A	C	3	7	10	0	0	10	0	0
2	24754489	.	G	A	4	1	5	0	0	6	1	0
2	24754565	.	A	T	4	4	8	0	0	8	0	0
2	24754597	.	C	T	8	4	12	0	1	13	0	0
2	24754641	.	G	A	0	13	13	0	6	19	0	0
2	24754783	.	C	T	8	17	25	0	2	27	0	0
2	24754794	.	G	A	18	9	27	0	0	27	0	0
2	24754883	.	T	A	8	13	21	0	0	21	0	0
2	24755018	.	T	C	16	11	27	0	3	30	0	0
2	24766941	.	G	A	0	3	3	0	0	3	0	0
2	24770603	.	C	T	1	2	3	0	0	3	0	0
2	24773684	.	C	A	3	3	6	0	0	6	0	0
2	24778283	.	A	G	0	1	1	0	0	1	0	0
2	24865187	.	C	A	3	5	8	0	0	8	0	0
2	24865872	.	T	A	1	2	3	0	0	3	0	0
2	24865972	.	A	T	9	5	14	0	0	14	0	0
2	24866075	.	G	C	7	5	12	0	0	12	0	0
2	24873047	.	G	A	6	6	12	0	1	13	0	0
2	24875201	.	T	C	7	5	12	0	0	12	0	0
2	24876864	.	T	A	5	3	8	0	0	8	0	0
2	24877010	.	A	G	4	8	12	0	1	13	0	0
2	24877227	.	C	T	3	10	13	0	1	14	0	0
2	24877276	.	A	C	8	8	16	0	1	17	0	0
2	24877294	.	T	C	6	11	17	0	1	18	0	0
2	24877327	.	T	C	4	7	11	0	1	12	0	0
2	24877797	.	G	A	4	2	6	0	0	6	0	0
2	24878051	.	C	T	10	22	32	0	2	34	0	0
2	24878081	.	T	A	20	20	40	0	0	40	0	0
2	24878332	.	A	G	7	6	13	0	3	16	0	0
2	24943237	.	G	A	1	11	12	0	7	19	0	0
2	24943398	.	C	T	6	4	10	0	2	12	0	0
2	24943536	.	C	T	2	7	9	0	0	9	0	0
2	24943660	.	T	C	2	2	4	0	0	4	0	0
2	24943689	.	C	T	3	11	14	0	0	14	0	0
2	24943891	.	A	T	4	14	18	0	1	20	1	0
2	24943916	.	T	C	1	8	9	0	3	12	0	0
2	24943971	.	A	T	3	9	12	0	0	12	0	0
2	24944187	.	C	T	14	5	19	0	2	21	0	0
2	24944644	.	A	G	1	4	5	0	1	7	1	0
2	24947129	.	G	T	1	2	3	0	0	3	0	0
2	24952186	.	G	A	3	3	6	0	1	7	0	0
2	24952406	.	C	A	6	4	10	0	0	10	0	0
2	24952607	.	T	C	1	0	1	0	0	1	0	0
2	24957008	.	G	A	0	3	3	0	0	3	0	0
2	24958921	.	G	A	1	4	5	0	0	5	0	0
2	24958945	.	C	T	1	2	3	0	0	3	0	0
2	24990621	.	T	A	2	5	7	0	2	9	0	0
2	24990629	.	T	A	2	6	8	0	1	9	0	0
2	24990751	.	A	T	2	2	4	0	0	4	0	0
2	24990845	.	T	C	4	10	14	0	0	14	0	0
2	24991202	.	C	G	15	12	27	0	0	27	0	0
2	24991265	.	T	G	10	8	18	0	2	20	0	0
2	24991387	.	G	T	8	16	24	0	3	27	0	0
2	24991429	.	G	A	13	18	31	0	1	32	0	0
2	24991909	.	A	G	12	10	22	0	1	23	0	0
2	24992035	.	A	C	7	5	12	0	2	14	0	0
2	24992110	.	G	A	11	6	17	0	2	19	0	0
2	24992134	.	G	A	8	8	16	0	1	17	0	0
2	24992185	.	T	C	9	5	14	0	0	14	0	0
2	24992368	.	T	C	2	11	13	0	2	15	0	0
2	24992464	.	C	T	16	9	25	0	3	28	0	0
2	24992536	.	C	G	3	7	10	0	2	12	0	0
2	24992584	.	G	A	1	2	3	0	0	3	0	0
2	25086854	.	G	A	0	1	1	0	0	1	0	0
2	25097106	.	G	A	0	4	4	0	3	7	0	0
2	25097289	.	G	A	4	2	6	0	0	6	0	0
2	25097543	.	C	T	3	3	6	0	0	6	0	0
2	25097582	.	T	C	2	1	3	0	1	4	0	0
2	25105586	.	C	T	8	3	11	0	0	11	0	0
2	25105618	.	A	C	0	8	8	0	1	9	0	0
2	25105716	.	T	C	7	5	12	0	2	14	0	0
2	25105900	.	C	T	8	5	13	0	1	14	0	0
2	25105992	.	G	A	6	3	9	0	1	10	0	0
2	25106020	.	T	C	5	5	10	0	3	13	0	0
2	25106099	.	G	T	4	5	9	0	1	10	0	0
2	25106310	.	A	T	6	6	12	0	1	14	1	0
2	25106380	.	A	G	3	3	6	0	0	6	0	0
2	25106402	.	C	A	4	4	8	0	0	9	1	0
2	25106554	.	G	T	8	6	14	0	0	14	0	0
2	25106631	.	C	G	1	6	7	0	0	7	0	0
2	25106874	.	A	C	3	8	11	0	0	11	0	0
2	25107891	.	G	T	20	12	32	0	2	34	0	0
2	25108104	.	A	G	9	6	15	0	1	16	0	0
2	25108377	.	T	A	9	10	19	0	1	20	0	0
2	25118414	.	G	A	1	0	1	0	0	1	0	0
2	25127042	.	G	T	1	2	3	0	0	3	0	0
2	25127261	.	G	T	0	2	2	0	1	3	0	0
2	25127876	.	G	A	0	4	4	0	2	6	0	0
2	25128019	.	C	G	2	2	4	0	1	5	0	0
2	25128024	.	C	T	3	2	5	0	0	5	0	0
2	25128505	.	A	T	3	2	5	0	2	7	0	0
2	25128668	.	C	T	3	9	12	0	3	15	0	0
2	25128780	.	T	A	4	13	17	0	1	18	0	0
2	25128858	.	C	T	8	11	19	0	1	20	0	0
2	25542890	.	C	A	7	1	8	0	1	9	0	0
2	25794241	.	C	A	1	1	2	0	0	2	0	0
2	25798647	.	A	G	1	4	5	0	1	6	0	0
2	25815407	.	A	T	9	7	16	0	2	18	0	0
2	25815737	.	G	T	4	2	6	0	1	7	0	0
2	25815758	.	C	T	3	3	6	0	2	8	0	0
2	25815780	.	T	G	2	2	4	0	1	5	0	0
2	25816321	.	C	T	7	6	13	0	0	13	0	0
2	25839381	.	G	T	0	3	3	0	8	11	0	0
2	25843532	.	T	C	8	9	17	0	2	19	0	0
2	25843806	.	G	A	0	10	10	0	15	25	0	0
2	25844341	.	T	C	12	6	18	0	1	19	0	0
2	25844345	.	A	T	11	9	20	0	2	22	0	0
2	25844840	.	C	T	17	19	36	1	1	38	0	0
2	25984928	.	T	C	2	2	4	0	0	4	0	0
2	25985012	.	C	T	2	3	5	0	0	5	0	0
2	25985219	.	T	C	2	3	5	0	0	5	0	0
2	25985234	.	G	A	2	2	4	0	1	5	0	0
2	25985300	.	A	C	1	3	4	0	1	5	0	0
2	25985405	.	C	T	4	3	7	0	3	10	0	0
2	25985409	.	C	T	6	3	9	0	1	10	0	0
2	25988570	.	T	C	5	7	12	0	0	12	0	0
2	25988633	.	A	G	4	9	13	0	0	13	0	0
2	25988635	.	A	G	3	9	12	0	1	13	0	0
2	25988846	.	A	G	3	0	3	0	8	11	0	0
2	25988874	.	T	C	4	9	13	0	2	15	0	0
2	25988991	.	T	C	3	4	7	0	0	7	0	0
2	25988992	.	C	A	2	4	6	0	1	7	0	0
2	25989134	.	A	G	5	9	14	0	2	16	0	0
2	25989142	.	T	G	7	10	17	0	0	17	0	0
2	25989246	.	T	A	7	12	19	0	2	22	1	0
2	25989290	.	T	G	12	8	20	0	0	20	0	0
2	25990020	.	C	A	14	12	26	0	6	32	0	0
2	25990323	.	G	A	11	11	22	0	1	23	0	0
2	25990563	.	A	G	8	10	18	0	1	19	0	0
2	25990628	.	C	A	13	5	18	0	0	18	0	0
2	25990702	.	G	A	21	16	37	0	3	40	0	0
2	25990777	.	T	G	5	6	11	1	1	13	0	0
2	26199708	.	C	T	6	6	12	0	0	12	0	0
2	26199714	.	C	T	6	7	13	0	0	13	0	0
2	26207155	.	C	T	3	2	5	0	0	5	0	0
2	26207350	.	G	A	5	6	11	0	1	12	0	0
2	26207713	.	G	A	6	8	14	0	0	14	0	0
2	26207752	.	C	T	8	7	15	0	0	15	0	0
2	26207938	.	C	T	12	7	19	0	2	21	0	0
2	26208480	.	A	C	8	10	18	0	1	19	0	0
2	26208520	.	A	G	11	10	21	0	2	23	0	0
2	26208589	.	A	G	8	7	15	0	0	15	0	0
2	26208733	.	C	A	13	4	17	0	0	17	0	0
2	26208815	.	G	T	11	13	24	0	1	25	0	0
2	26209120	.	C	T	8	9	17	0	2	19	0	0
2	26209141	.	G	A	3	9	12	0	1	13	0	0
2	26209266	.	A	C	2	2	4	0	0	4	0	0
2	26209325	.	G	A	0	3	3	0	1	4	0	0
2	26240742	.	C	T	8	16	24	0	7	31	0	0
2	26240771	.	A	T	20	9	29	0	1	30	0	0
2	26240857	.	C	T	10	12	22	0	4	26	0	0
2	26277924	.	C	A	1	3	4	0	3	7	0	0
2	26278044	.	G	A	1	0	1	0	1	2	0	0
2	26282745	.	C	T	24	21	45	0	3	48	0	0
2	26283181	.	C	T	17	12	29	0	4	33	0	0
2	26283723	.	A	G	13	8	21	0	3	24	0	0
2	26283922	.	T	G	18	20	38	0	5	44	1	0
2	26300085	.	A	G	1	2	3	0	0	3	0	0
2	26300091	.	G	A	0	2	2	0	1	3	0	0
2	26300341	.	A	G	2	2	4	0	1	5	0	0
2	26303689	.	A	T	1	3	4	0	0	4	0	0
2	26304008	.	C	A	3	4	7	0	1	8	0	0
2	26422266	.	G	T	0	0	0	0	1	1	0	0
2	26422287	.	C	T	3	3	6	0	0	6	0	0
2	26422332	.	C	T	3	5	8	0	1	9	0	0
2	26422359	.	C	T	4	6	10	0	0	10	0	0
2	26443146	.	G	T	15	14	29	0	2	31	0	0
2	26443517	.	T	C	4	2	6	0	0	6	0	0
2	26444332	.	C	A	4	5	9	0	0	9	0	0
2	26444403	.	G	A	0	3	3	0	5	8	0	0
2	26463199	.	C	A	4	2	6	0	0	6	0	0
2	26463309	.	C	T	7	5	12	0	1	13	0	0
2	26463534	.	C	A	6	4	10	0	2	12	0	0
2	26470237	.	G	T	13	13	26	0	1	27	0	0
2	26470267	.	G	A	16	17	33	0	0	33	0	0
2	26470357	.	G	A	20	15	35	0	1	36	0	0
2	26470537	.	C	T	7	7	14	0	1	15	0	0
2	26470636	.	C	T	0	17	17	0	20	37	0	0
2	26470666	.	A	G	20	16	36	0	2	38	0	0
2	26473106	.	T	C	3	7	10	0	0	10	0	0
2	26473361	.	C	T	4	4	8	0	0	8	0	0
2	26483946	.	G	T	3	2	5	0	0	5	0	0
2	26486605	.	A	G	0	1	1	0	0	1	0	0
2	26491676	.	A	T	2	3	5	0	0	5	0	0
2	26499519	.	C	T	8	19	27	0	0	27	0	0
2	26500872	.	T	C	25	19	44	0	2	46	0	0
2	26500899	.	G	A	29	31	60	0	5	65	0	0
2	26500989	.	C	T	3	6	9	0	1	10	0	0
2	26577314	.	T	A	2	14	16	0	0	16	0	0
2	26578227	.	T	G	1	5	6	0	1	7	0	0
2	26605135	.	G	A	1	2	3	0	0	3	0	0
2	26607450	.	G	A	1	1	2	0	0	2	0	0
2	26612624	.	G	C	4	9	13	0	2	15	0	0
2	26619829	.	G	T	1	0	1	0	0	1	0	0
2	26623480	.	G	T	2	0	2	0	7	11	2	0
2	26627301	.	C	A	7	15	22	0	2	24	0	0
2	26627332	.	T	A	2	3	5	0	0	5	0	0
2	26631084	.	G	A	4	2	6	0	0	6	0	0
2	26632384	.	T	G	7	9	16	0	0	16	0	0
2	26638857	.	C	T	1	0	1	0	1	2	0	0
2	26639157	.	T	C	3	3	6	0	1	7	0	0
2	26662143	.	T	A	0	1	1	0	0	1	0	0
2	26665081	.	A	G	1	5	6	0	1	7	0	0
2	26665155	.	A	T	6	4	10	0	0	10	0	0
2	26665233	.	G	A	1	4	5	0	0	5	0	0
2	26665375	.	A	G	3	4	7	0	0	7	0	0
2	26665517	.	A	T	5	3	8	0	1	9	0	0
2	26665824	.	A	T	6	7	13	0	0	13	0	0
2	26672488	.	A	G	11	9	20	0	1	21	0	0
2	26672761	.	T	G	3	0	3	0	13	16	0	0
2	26677172	.	G	A	2	3	5	0	0	5	0	0
2	26680440	.	G	A	1	2	3	0	0	3	0	0
2	26680690	.	A	T	4	3	7	0	0	7	0	0
2	26681214	.	A	C	2	2	4	0	1	5	0	0
2	26681219	.	T	A	2	3	5	0	0	5	0	0
2	26681773	.	C	T	4	2	6	0	0	6	0	0
2	26681958	.	G	T	2	3	5	0	0	5	0	0
2	26682031	.	G	T	0	4	4	0	11	15	0	0
2	26684689	.	A	G	1	1	2	0	1	3	0	0
2	26686340	.	A	T	1	1	2	0	0	2	0	0
2	26697666	.	C	T	0	1	1	0	1	2	0	0
2	27064687	.	T	C	3	1	4	0	0	4	0	0
2	27075884	.	G	A	0	0	0	0	2	2	0	0
2	27075992	.	A	T	4	2	6	0	0	6	0	0
2	27094393	.	C	T	5	7	12	0	1	13	0	0
2	27540458	.	C	T	3	4	7	0	0	7	0	0
2	27540488	.	C	A	4	6	10	0	0	10	0	0
2	27540614	.	C	T	3	5	8	0	1	9	0	0
2	27540905	.	T	C	6	2	8	0	1	9	0	0
2	27541468	.	C	T	5	5	10	0	1	11	0	0
2	27541778	.	G	T	5	4	9	0	0	9	0	0
2	27541914	.	A	C	7	6	13	0	3	16	0	0
2	27542721	.	C	T	13	12	25	0	1	26	0	0
2	27542856	.	G	A	0	7	7	0	17	24	0	0
2	27542958	.	A	G	7	7	14	0	0	14	0	0
2	27543103	.	A	T	9	17	26	0	0	26	0	0
2	27543212	.	T	A	16	8	24	0	0	24	0	0
2	27543499	.	C	A	7	6	13	0	2	15	0	0
2	27614082	.	G	C	1	1	2	0	0	2	0	0
2	27635788	.	C	T	2	1	3	0	0	3	0	0
2	27635928	.	T	A	6	3	9	0	0	9	0	0
2	27641130	.	G	A	5	2	7	0	0	7	0	0
2	27642776	.	C	G	4	5	9	0	0	9	0	0
2	27658566	.	A	G	4	7	11	0	0	11	0	0
2	27658651	.	T	C	0	2	2	0	0	2	0	0
2	27658973	.	T	G	2	3	5	0	0	5	0	0
2	27659018	.	T	C	3	5	8	0	0	8	0	0
2	27662374	.	C	T	3	5	8	0	0	8	0	0
2	27662496	.	G	A	1	3	4	0	0	4	0	0
2	27663334	.	A	G	1	2	3	0	0	3	0	0
2	27663335	.	A	G	1	2	3	0	0	3	0	0
2	27663402	.	T	C	6	3	9	0	2	11	0	0
2	27663435	.	C	T	7	2	9	0	0	9	0	0
2	27664105	.	G	A	5	3	8	0	2	10	0	0
2	27664143	.	G	T	4	2	6	0	0	6	0	0
2	27664195	.	A	C	4	5	9	0	0	9	0	0
2	27664317	.	G	T	6	5	11	0	0	11	0	0
2	27664482	.	G	C	3	2	5	0	0	5	0	0
2	27664665	.	A	C	5	5	10	0	1	11	0	0
2	27670760	.	T	C	0	2	2	0	0	2	0	0
2	27670764	.	T	C	2	0	2	0	0	2	0	0
2	27672103	.	T	C	5	6	11	0	0	11	0	0
2	27672426	.	T	C	3	2	5	0	1	6	0	0
2	27672440	.	C	T	0	2	2	0	5	7	0	0
2	27673041	.	A	G	2	4	6	0	0	6	0	0
2	27673080	.	G	A	2	2	4	0	0	4	0	0
2	27673173	.	A	G	1	3	4	0	0	4	0	0
2	27774370	.	G	A	1	3	4	0	4	8	0	0
2	27812578	.	G	A	0	0	0	0	1	1	0	0
2	27843845	.	G	A	1	4	5	0	0	5	0	0
2	27843848	.	C	T	0	4	4	0	1	5	0	0
2	27845845	.	A	T	1	2	3	0	0	3	0	0
2	27846053	.	T	A	1	2	3	0	0	3	0	0
2	27846108	.	G	A	1	2	3	0	0	3	0	0
2	27933143	.	C	T	1	2	3	0	0	3	0	0
2	27933215	.	C	A	2	2	4	0	1	5	0	0
2	27933260	.	C	A	2	3	5	0	1	6	0	0
2	27933764	.	G	T	1	4	5	0	0	5	0	0
2	27957786	.	T	A	6	3	9	0	0	9	0	0
2	27963660	.	G	A	2	4	6	0	0	6	0	0
2	27963686	.	C	T	0	2	2	0	2	4	0	0
2	27966602	.	C	T	0	2	2	0	3	5	0	0
2	27966636	.	C	T	3	1	4	0	1	5	0	0
2	27969966	.	G	A	2	2	4	0	0	4	0	0
2	27969985	.	A	G	1	1	2	0	1	3	0	0
2	27975458	.	T	C	1	2	3	0	0	3	0	0
2	28049696	.	C	T	13	15	28	0	0	28	0	0
2	28049996	.	A	G	9	8	17	0	0	17	0	0
2	28050047	.	G	T	4	2	6	0	2	8	0	0
2	28050058	.	C	A	3	2	5	0	1	6	0	0
2	28050565	.	T	A	5	7	12	0	0	12	0	0
2	28050600	.	G	C	3	1	4	0	3	7	0	0
2	28050759	.	A	G	4	3	7	0	0	7	0	0
2	28050921	.	G	T	6	4	10	0	0	10	0	0
2	28050933	.	G	A	3	5	8	0	0	8	0	0
2	28051041	.	T	A	1	7	8	0	0	8	0	0
2	28051092	.	C	T	0	5	5	0	4	9	0	0
2	28051104	.	G	A	4	5	9	0	0	9	0	0
2	28650422	.	T	C	2	6	8	0	1	9	0	0
2	28650504	.	T	C	2	6	8	0	0	8	0	0
2	28650612	.	T	G	11	4	15	0	3	18	0	0
2	28650629	.	G	T	13	9	22	0	1	23	0	0
2	28651128	.	T	A	9	9	18	0	3	21	0	0
2	28651193	.	A	G	5	6	11	0	0	11	0	0
2	28651497	.	G	A	2	5	7	0	1	8	0	0
2	28659998	.	C	G	1	2	3	0	0	3	0	0
2	28930100	.	T	C	4	3	7	0	0	7	0	0
2	28934011	.	C	T	7	7	14	0	0	14	0	0
2	28934152	.	T	C	4	10	14	0	1	15	0	0
2	29317718	.	G	A	9	6	15	0	0	15	0	0
2	29352279	.	G	A	0	10	10	0	17	27	0	0
2	29352379	.	A	C	12	6	18	0	2	20	0	0
2	29352411	.	A	C	8	7	15	0	2	17	0	0
2	29352481	.	G	C	4	4	8	0	0	8	0	0
2	29352673	.	C	T	17	6	23	0	0	23	0	0
2	29477653	.	T	C	19	16	35	0	2	37	0	0
2	29477733	.	A	T	13	20	33	0	2	35	0	0
2	29477769	.	G	T	12	20	32	0	3	35	0	0
2	29482390	.	G	A	3	3	6	0	0	6	0	0
2	29482417	.	A	G	3	3	6	0	0	6	0	0
2	29485046	.	G	A	4	4	8	0	1	9	0	0
2	29485068	.	G	T	4	6	10	0	1	11	0	0
2	30755717	.	C	A	7	3	10	0	0	10	0	0
2	31891344	.	T	A	9	22	31	0	0	33	2	0
2	31943187	.	A	G	0	3	3	0	0	3	0	0
2	32561572	.	T	A	7	4	11	1	1	13	0	0
2	32637145	.	G	C	2	5	7	0	0	7	0	0
2	33418235	.	T	A	1	2	3	0	0	3	0	0
2	33419602	.	A	G	2	3	5	0	0	5	0	0
2	33420806	.	C	T	2	6	8	0	0	8	0	0
2	33420975	.	G	A	0	6	6	0	4	10	0	0
2	33421078	.	G	T	2	3	5	0	1	6	0	0
2	33421154	.	G	A	2	2	4	0	1	5	0	0
2	33421200	.	C	T	3	4	7	0	0	7	0	0
2	33421222	.	A	C	2	4	6	0	1	7	0	0
2	33421275	.	C	G	3	4	7	0	1	8	0	0
2	33421276	.	T	C	3	5	8	0	0	8	0	0
2	33421331	.	C	A	4	3	7	0	0	7	0	0
2	33421382	.	A	T	4	5	9	0	0	9	0	0
2	33421404	.	T	A	3	3	6	0	0	6	0	0
2	33421613	.	C	T	3	4	7	0	0	7	0	0
2	33421720	.	A	G	4	7	11	0	0	11	0	0
2	33421774	.	A	G	2	4	6	0	0	6	0	0
2	33422286	.	T	G	2	7	9	0	0	9	0	0
2	33422289	.	C	T	2	6	8	0	1	9	0	0
2	33422526	.	T	A	10	5	15	0	0	15	0	0
2	33422565	.	C	A	20	9	29	0	1	30	0	0
2	33422604	.	C	T	20	17	37	0	2	39	0	0
2	33466068	.	C	A	1	2	3	0	0	3	0	0
2	33477073	.	C	T	3	0	3	0	0	3	0	0
2	33477139	.	G	A	4	3	7	0	1	8	0	0
2	33676391	.	G	A	3	3	6	0	1	7	0	0
2	33681330	.	G	A	20	19	39	0	2	41	0	0
2	33681483	.	A	G	12	18	30	0	2	32	0	0
2	33681701	.	A	T	15	16	31	0	2	33	0	0
2	33682321	.	G	A	6	9	15	0	2	17	0	0
2	33682323	.	T	A	8	9	17	0	0	17	0	0
2	33685582	.	T	A	1	3	4	0	0	4	0	0
2	33687110	.	C	A	10	10	20	0	0	20	0	0
2	34009003	.	G	T	2	3	5	0	0	5	0	0
2	34022992	.	T	A	1	3	4	0	0	4	0	0
2	34024832	.	A	G	2	2	4	0	0	4	0	0
2	34025152	.	C	A	5	4	9	0	2	11	0	0
2	34025167	.	G	A	5	5	10	0	2	12	0	0
2	34029353	.	G	A	0	1	1	0	0	1	0	0
2	34047951	.	T	C	1	2	3	0	0	3	0	0
2	34122859	.	A	G	7	4	11	0	0	11	0	0
2	34122886	.	C	A	10	3	13	0	2	15	0	0
2	34122928	.	C	T	5	9	14	0	1	15	0	0
2	34125775	.	G	A	0	7	7	0	13	20	0	0
2	34125909	.	A	T	7	8	15	0	0	15	0	0
2	34126040	.	T	C	3	4	7	0	0	7	0	0
2	34126514	.	G	T	8	4	12	0	0	12	0	0
2	34126588	.	A	T	6	3	9	0	0	9	0	0
2	34160995	.	G	A	0	1	1	0	0	1	0	0
2	34172900	.	C	T	1	2	3	0	0	3	0	0
2	34172954	.	T	C	2	2	4	0	0	4	0	0
2	34173253	.	C	T	2	5	7	0	0	7	0	0
2	34173297	.	C	A	2	7	9	0	1	10	0	0
2	34173335	.	A	C	3	4	7	0	0	7	0	0
2	34173360	.	C	T	5	5	10	0	3	13	0	0
2	34381013	.	T	G	10	9	19	0	0	19	0	0
2	34381032	.	T	C	7	7	14	0	2	16	0	0
2	34444801	.	C	T	0	2	2	0	0	2	0	0
2	34460848	.	G	A	1	0	1	0	0	1	0	0
2	34924412	.	A	G	4	15	19	0	1	20	0	0
2	37566708	.	C	T	0	1	1	0	1	2	0	0
2	37816173	.	A	T	5	2	7	0	0	7	0	0
2	37990210	.	T	C	5	2	7	0	0	7	0	0
2	39028424	.	A	C	1	8	9	0	0	9	0	0
2	39553213	.	A	G	6	4	10	0	4	14	0	0
2	39553630	.	T	A	2	0	2	0	1	3	0	0
2	41542707	.	A	T	1	5	6	0	0	6	0	0
2	41578137	.	G	T	13	11	24	0	3	27	0	0
2	41581035	.	T	A	15	1	16	0	3	19	0	0
2	41581042	.	C	G	0	0	0	0	20	20	0	0
2	41582077	.	T	C	8	2	10	0	0	10	0	0
2	41582083	.	T	C	3	4	7	0	2	9	0	0
2	41582115	.	T	C	7	2	9	0	1	10	0	0
2	42051071	.	G	A	0	1	1	0	0	1	0	0
2	43962610	.	T	C	6	3	9	0	2	11	0	0
2	44678904	.	C	G	0	1	1	0	0	1	0	0
2	44678913	.	A	G	0	1	1	0	0	1	0	0
2	46172217	.	A	G	0	2	2	0	0	2	0	0
2	46175367	.	G	T	0	1	1	0	1	2	0	0
2	46175484	.	C	T	0	2	2	0	1	3	0	0
2	46176783	.	A	G	1	2	3	0	0	3	0	0
2	46176822	.	T	C	0	1	1	0	1	2	0	0
2	46181029	.	T	C	1	2	3	0	0	3	0	0
2	46183855	.	T	C	4	5	9	0	1	10	0	0
2	46183897	.	G	A	4	6	10	0	0	10	0	0
2	46183985	.	A	T	3	8	11	0	2	13	0	0
2	46184024	.	T	A	3	9	12	0	0	12	0	0
2	46184057	.	C	A	5	6	11	0	0	11	0	0
2	46184193	.	C	T	6	14	20	0	0	20	0	0
2	46184248	.	G	C	5	4	9	0	1	10	0	0
2	46184277	.	C	A	3	4	7	0	0	7	0	0
2	46184555	.	A	G	2	7	9	0	1	10	0	0
2	47500251	.	C	T	1	2	3	0	0	3	0	0
2	47506185	.	C	T	0	1	1	0	0	1	0	0
2	47506187	.	G	A	0	1	1	0	0	1	0	0
2	47511341	.	T	C	1	1	2	0	1	3	0	0
2	47512820	.	G	A	8	9	17	0	1	18	0	0
2	47513002	.	G	T	15	10	25	0	0	25	0	0
2	47513391	.	G	A	0	2	2	0	3	5	0	0
2	47513712	.	C	A	12	15	27	0	0	27	0	0
2	47513871	.	C	A	11	14	25	0	2	27	0	0
2	47514001	.	A	G	15	12	27	0	4	31	0	0
2	47514504	.	C	A	4	7	11	0	0	11	0	0
2	47514582	.	T	G	4	9	13	0	0	13	0	0
2	47514613	.	T	A	7	13	20	0	0	20	0	0
2	47514619	.	A	T	8	13	21	0	1	22	0	0
2	47514697	.	A	G	10	13	23	0	2	25	0	0
2	47514878	.	T	G	19	19	38	0	2	40	0	0
2	47515019	.	T	C	19	16	35	0	0	35	0	0
2	47515073	.	T	C	12	12	24	0	4	29	1	0
2	47515111	.	G	A	9	12	21	0	2	23	0	0
2	47515223	.	T	A	8	13	21	0	0	21	0	0
2	47582891	.	A	G	7	8	15	0	1	16	0	0
2	47583029	.	C	A	20	21	41	0	3	44	0	0
2	47583377	.	G	A	0	30	30	0	20	50	0	0
2	47583701	.	C	T	22	18	40	0	0	40	0	0
2	47583788	.	T	A	18	23	41	0	5	46	0	0
2	47584064	.	G	A	0	33	33	0	24	57	0	0
2	47584092	.	G	A	28	25	53	0	1	54	0	0
2	47584547	.	T	A	25	15	40	0	8	48	0	0
2	47584612	.	G	A	22	23	45	0	1	46	0	0
2	47584799	.	A	T	40	21	61	0	0	62	1	0
2	47587652	.	C	T	4	2	6	0	0	6	0	0
2	47587703	.	A	G	5	1	6	0	3	9	0	0
2	47633835	.	T	A	1	1	2	0	0	2	0	0
2	47633841	.	C	T	1	1	2	0	0	2	0	0
2	47633879	.	G	T	3	1	4	0	0	4	0	0
2	47633884	.	G	T	3	1	4	0	0	4	0	0
2	47644488	.	T	G	19	24	43	0	1	44	0	0
2	47648076	.	A	G	15	15	30	0	2	32	0	0
2	47648091	.	T	G	11	10	21	0	1	22	0	0
2	47651598	.	A	G	3	6	9	0	1	10	0	0
2	47652403	.	A	G	5	2	7	0	0	7	0	0
2	47652406	.	A	G	3	2	5	0	3	8	0	0
2	47658641	.	T	G	7	1	8	0	0	8	0	0
2	47658653	.	G	A	8	2	10	0	0	10	0	0
2	47658752	.	A	G	1	6	7	0	1	8	0	0
2	47661273	.	A	C	4	0	4	0	4	8	0	0
2	47662955	.	A	G	4	3	7	0	1	8	0	0
2	47829112	.	T	C	4	3	7	0	0	7	0	0
2	47829126	.	C	T	4	3	7	0	0	7	0	0
2	47911118	.	C	T	1	3	4	0	0	4	0	0
2	47911285	.	C	A	1	3	4	0	0	4	0	0
2	47916384	.	T	A	1	1	2	0	0	2	0	0
2	47916389	.	T	C	1	0	1	0	2	3	0	0
2	47916467	.	A	T	2	3	5	0	0	5	0	0
2	47918584	.	C	T	1	3	4	0	0	4	0	0
2	47955325	.	A	G	2	3	5	0	0	5	0	0
2	47955364	.	T	C	2	2	4	0	0	4	0	0
2	47955412	.	A	G	3	2	5	0	0	5	0	0
2	47955423	.	T	C	1	4	5	0	0	5	0	0
2	47955510	.	T	C	2	2	4	0	0	4	0	0
2	47955511	.	T	C	1	2	3	0	1	4	0	0
2	47955654	.	T	C	3	2	5	0	0	5	0	0
2	47955727	.	T	G	0	2	2	0	1	3	0	0
2	47957332	.	G	A	1	2	3	0	0	3	0	0
2	48098019	.	T	A	1	2	3	0	0	3	0	0
2	48113040	.	G	A	1	0	1	0	0	1	0	0
2	48115732	.	T	A	5	3	8	0	0	8	0	0
2	48118470	.	T	C	1	2	3	0	5	8	0	0
2	48119134	.	G	A	3	6	9	0	2	11	0	0
2	48119209	.	G	A	8	3	11	0	2	13	0	0
2	48119631	.	A	C	10	5	15	0	0	15	0	0
2	48119696	.	A	T	13	8	21	0	1	22	0	0
2	48119704	.	A	T	12	8	20	0	3	23	0	0
2	48119744	.	A	G	11	10	21	0	0	21	0	0
2	48119793	.	A	C	10	18	28	0	2	30	0	0
2	48119821	.	T	A	16	15	31	0	0	31	0	0
2	48120190	.	A	T	23	3	26	0	0	26	0	0
2	48120273	.	T	C	9	6	15	0	0	15	0	0
2	48120274	.	T	A	9	6	15	0	0	15	0	0
2	48120318	.	A	T	7	3	10	0	0	10	0	0
2	48120430	.	C	T	9	3	12	0	1	13	0	0
2	48120516	.	T	C	10	9	19	0	1	20	0	0
2	48120689	.	G	A	8	10	18	0	2	20	0	0
2	48120694	.	C	G	8	11	19	0	0	19	0	0
2	48120743	.	T	C	9	5	14	0	0	14	0	0
2	48120744	.	G	A	8	5	13	0	1	14	0	0
2	48120805	.	T	A	8	3	11	0	0	11	0	0
2	48120825	.	A	C	6	4	10	0	1	11	0	0
2	48120864	.	C	A	3	4	7	0	0	7	0	0
2	48121164	.	A	T	1	1	2	0	0	2	0	0
2	48121197	.	C	T	0	1	1	0	2	3	0	0
2	48121275	.	A	G	6	2	8	0	0	8	0	0
2	48121312	.	G	A	6	4	10	0	0	10	0	0
2	48121351	.	G	C	5	3	8	0	0	8	0	0
2	48121352	.	T	C	5	3	8	0	0	8	0	0
2	48127614	.	G	A	0	2	2	0	0	2	0	0
2	48130224	.	A	G	2	2	4	0	1	5	0	0
2	48203544	.	A	G	14	11	25	0	0	25	0	0
2	48203554	.	C	T	13	11	24	0	2	26	0	0
2	48203622	.	G	A	10	15	25	0	0	25	0	0
2	48203920	.	C	A	0	3	3	0	14	17	0	0
2	48207319	.	C	T	1	11	12	0	14	26	0	0
2	48212114	.	C	A	1	1	2	0	1	3	0	0
2	48217229	.	T	A	1	0	1	0	1	2	0	0
2	48221479	.	C	T	0	4	4	0	6	10	0	0
2	48224011	.	T	C	3	3	6	0	0	6	0	0
2	48284721	.	G	A	19	17	36	0	1	37	0	0
2	48285153	.	C	G	17	11	28	0	3	31	0	0
2	48285241	.	T	G	7	6	13	0	2	15	0	0
2	48285265	.	A	C	7	5	12	0	0	12	0	0
2	48290805	.	A	T	29	23	52	0	1	53	0	0
2	48290820	.	C	T	27	17	44	0	3	47	0	0
2	48304467	.	G	A	10	13	23	0	4	27	0	0
2	48309874	.	T	A	11	9	20	0	0	20	0	0
2	48309876	.	A	T	11	9	20	0	0	20	0	0
2	48309970	.	C	A	22	12	34	0	1	35	0	0
2	48310207	.	C	T	0	11	11	0	8	19	0	0
2	48310258	.	A	T	14	10	24	0	2	26	0	0
2	48310266	.	T	C	13	1	14	0	9	23	0	0
2	48310330	.	C	G	4	8	12	0	1	13	0	0
2	48310342	.	A	G	5	5	10	0	2	12	0	0
2	48310374	.	G	A	3	4	7	0	2	9	0	0
2	48313598	.	A	G	7	1	8	0	0	8	0	0
2	48317363	.	G	T	11	8	19	0	3	22	0	0
2	48317418	.	C	G	7	5	12	0	0	12	0	0
2	48317444	.	G	T	2	5	7	0	1	8	0	0
2	48323317	.	C	T	10	5	15	0	1	16	0	0
2	48323341	.	T	C	12	5	17	0	0	17	0	0
2	48323470	.	A	T	13	15	28	0	0	28	0	0
2	48323562	.	A	T	14	13	27	0	4	31	0	0
2	48323572	.	A	G	12	11	23	0	5	28	0	0
2	48323695	.	A	G	11	15	26	0	4	31	1	0
2	48323863	.	A	G	14	6	20	0	1	21	0	0
2	48326354	.	G	A	5	2	7	0	0	7	0	0
2	48326408	.	C	T	0	2	2	0	4	6	0	0
2	48332566	.	A	G	2	3	5	0	0	5	0	0
2	48335187	.	G	A	1	1	2	0	0	2	0	0
2	48345379	.	A	G	0	2	2	0	0	2	0	0
2	48478608	.	A	G	5	3	8	0	0	8	0	0
2	48512187	.	T	C	1	4	5	0	0	5	0	0
2	48539393	.	T	G	1	2	3	0	0	3	0	0
2	48539408	.	T	G	1	2	3	0	0	3	0	0
2	48546121	.	T	A	2	7	9	0	0	9	0	0
2	49007765	.	A	G	15	8	23	0	2	25	0	0
2	49007781	.	A	T	9	9	18	0	2	20	0	0
2	49008339	.	A	T	3	3	6	0	0	6	0	0
2	49008382	.	T	G	2	6	8	0	2	10	0	0
2	49017754	.	C	T	2	4	6	0	0	6	0	0
2	50892671	.	A	G	6	4	10	0	0	10	0	0
2	52052697	.	A	G	1	0	1	0	0	1	0	0
2	52052790	.	T	C	3	3	6	0	1	7	0	0
2	52060070	.	T	G	0	2	2	0	0	2	0	0
2	52060365	.	C	T	2	0	2	0	0	2	0	0
2	52060390	.	T	C	1	2	3	0	1	4	0	0
2	52060409	.	A	G	3	3	6	0	0	6	0	0
2	52062918	.	G	A	0	14	14	0	12	26	0	0
2	52062989	.	T	A	4	5	9	0	0	9	0	0
2	52063101	.	T	A	5	5	10	0	0	10	0	0
2	52063128	.	T	C	6	1	7	0	1	8	0	0
2	52063207	.	T	C	2	9	11	0	0	11	0	0
2	52063208	.	C	T	2	9	11	0	0	11	0	0
2	52063250	.	C	G	3	7	10	0	2	12	0	0
2	52810997	.	G	T	2	4	6	0	1	7	0	0
2	52814146	.	C	T	1	1	2	0	1	3	0	0
2	52815260	.	G	A	0	2	2	0	0	2	0	0
2	52815292	.	C	T	2	4	6	0	1	7	0	0
2	52827298	.	A	G	2	2	4	0	0	4	0	0
2	54771112	.	C	T	0	1	1	0	0	1	0	0
2	54771296	.	T	G	3	5	8	0	0	8	0	0
2	54774726	.	G	A	4	2	6	0	2	8	0	0
2	54775406	.	C	T	4	5	9	0	1	10	0	0
2	54775415	.	A	G	4	5	9	0	0	9	0	0
2	54775475	.	G	A	3	5	8	0	0	8	0	0
2	54775929	.	G	C	4	5	9	0	0	9	0	0
2	54775940	.	T	C	5	4	9	0	0	9	0	0
2	54775998	.	T	C	3	6	9	0	0	9	0	0
2	54776108	.	G	T	0	5	5	0	4	9	0	0
2	54776170	.	G	T	3	3	6	0	0	6	0	0
2	54776357	.	A	C	6	4	10	0	0	10	0	0
2	54776560	.	T	C	6	6	12	0	1	13	0	0
2	54776870	.	C	T	6	4	10	0	0	10	0	0
2	54776966	.	A	G	3	7	10	0	0	10	0	0
2	54777178	.	T	G	9	4	13	0	0	13	0	0
2	54777642	.	G	A	3	8	11	0	0	11	0	0
2	54777849	.	G	A	6	12	18	0	0	18	0	0
2	54777855	.	C	A	7	10	17	0	0	17	0	0
2	54778064	.	G	A	4	6	10	0	1	11	0	0
2	54778255	.	C	T	8	10	18	0	0	18	0	0
2	54778577	.	C	G	13	11	24	0	1	25	0	0
2	54786533	.	G	A	3	7	10	1	0	11	0	0
2	54786741	.	A	C	20	5	25	1	1	27	0	0
2	54832709	.	T	C	1	2	3	0	0	3	0	0
2	54971494	.	T	C	0	1	1	0	0	1	0	0
2	54977337	.	A	G	6	0	6	0	9	15	0	0
2	54977431	.	C	T	6	6	12	0	2	14	0	0
2	54977959	.	T	G	3	0	3	0	2	5	0	0
2	54977960	.	T	A	3	2	5	0	0	5	0	0
2	54978348	.	A	G	1	6	7	0	0	7	0	0
2	54978640	.	T	G	2	0	2	0	5	7	0	0
2	54978647	.	T	A	2	4	6	0	1	7	0	0
2	54979273	.	G	C	0	4	4	0	5	9	0	0
2	55210962	.	C	T	0	3	3	0	0	3	0	0
2	55430016	.	C	T	1	2	3	0	0	3	0	0
2	55430024	.	T	C	1	3	4	0	1	5	0	0
2	55430091	.	T	C	7	4	11	0	0	11	0	0
2	55433494	.	C	A	9	5	14	0	1	15	0	0
2	55444789	.	A	G	6	0	6	0	9	15	0	0
2	55444825	.	C	G	9	10	19	0	0	19	0	0
2	55444831	.	A	G	8	9	17	0	1	18	0	0
2	55488992	.	G	A	0	3	3	0	4	7	0	0
2	55489237	.	T	G	4	3	7	0	0	7	0	0
2	55489261	.	C	T	4	5	9	0	0	9	0	0
2	55489317	.	T	A	7	11	18	0	0	18	0	0
2	55489342	.	T	G	7	13	20	0	1	21	0	0
2	55489383	.	T	A	10	11	21	0	0	21	0	0
2	55490181	.	A	G	11	10	21	0	0	21	0	0
2	55490686	.	T	A	13	10	23	0	0	23	0	0
2	55490812	.	T	C	9	7	16	0	1	17	0	0
2	55490934	.	G	T	17	20	37	0	0	37	0	0
2	55491445	.	T	G	19	16	35	0	2	37	0	0
2	55491754	.	C	A	16	20	36	0	0	36	0	0
2	55491945	.	A	T	7	20	27	0	1	28	0	0
2	55492010	.	G	A	23	25	48	0	1	49	0	0
2	55784141	.	C	T	3	2	5	0	0	5	0	0
2	55784243	.	G	T	2	2	4	0	0	4	0	0
2	55785044	.	G	A	3	3	6	0	1	7	0	0
2	55785177	.	T	A	2	2	4	0	0	4	0	0
2	55785341	.	G	T	1	2	3	0	1	4	0	0
2	55785636	.	C	A	2	2	4	0	0	4	0	0
2	55791100	.	G	A	1	1	2	0	1	3	0	0
2	55964675	.	G	A	0	2	2	0	2	4	0	0
2	55965050	.	T	C	4	6	10	0	1	11	0	0
2	55965076	.	T	C	5	7	12	0	0	12	0	0
2	55965328	.	C	T	2	7	9	0	0	9	0	0
2	55966822	.	T	G	1	2	3	0	0	3	0	0
2	55966912	.	A	T	3	4	7	0	0	7	0	0
2	55967188	.	T	C	3	7	10	0	0	10	0	0
2	55967195	.	T	C	6	3	9	0	0	9	0	0
2	55967233	.	C	T	1	8	9	0	1	10	0	0
2	55967341	.	A	T	9	5	14	0	1	15	0	0
2	55967473	.	C	T	5	10	15	0	0	15	0	0
2	55967758	.	T	C	10	22	32	1	2	35	0	0
2	55967881	.	A	T	4	2	6	0	1	7	0	0
2	55967916	.	C	A	2	2	4	0	0	4	0	0
2	55967963	.	G	C	1	4	5	0	0	5	0	0
2	55967987	.	T	G	1	2	3	0	0	3	0	0
2	55968240	.	C	T	9	6	15	0	1	16	0	0
2	55968447	.	C	T	9	16	25	0	0	25	0	0
2	55970407	.	A	T	0	2	2	0	0	2	0	0
2	55970432	.	A	T	1	2	3	0	0	3	0	0
2	55970466	.	C	A	1	3	4	0	1	5	0	0
2	55970499	.	T	A	3	5	8	0	0	8	0	0
2	55970504	.	C	G	3	5	8	0	0	8	0	0
2	55970662	.	C	T	14	9	23	0	0	23	0	0
2	55970684	.	C	T	14	14	28	0	1	29	0	0
2	56125231	.	G	A	8	12	20	0	0	20	0	0
2	56125773	.	C	T	17	21	38	0	2	40	0	0
2	56126359	.	A	G	1	1	2	0	7	9	0	0
2	56126848	.	A	T	3	5	8	0	0	8	0	0
2	56126869	.	T	A	5	2	7	0	1	8	0	0
2	56127493	.	T	C	6	6	12	0	0	12	0	0
2	56127612	.	G	A	5	8	13	0	0	13	0	0
2	56128029	.	A	T	14	11	25	0	0	25	0	0
2	56128455	.	G	A	11	5	16	0	3	19	0	0
2	56128622	.	T	C	6	7	13	0	3	16	0	0
2	56128895	.	T	A	8	7	15	0	1	16	0	0
2	56129175	.	G	C	7	10	17	0	0	17	0	0
2	56129285	.	G	T	4	8	12	0	1	13	0	0
2	56129299	.	G	A	6	9	15	0	1	16	0	0
2	56129332	.	G	A	6	5	11	0	1	12	0	0
2	56129613	.	T	C	4	2	6	0	0	6	0	0
2	56129633	.	A	G	4	4	8	0	0	8	0	0
2	56129920	.	T	A	7	5	12	0	0	12	0	0
2	56129931	.	A	G	5	3	8	0	1	9	0	0
2	56130212	.	T	G	3	6	9	0	0	9	0	0
2	56131264	.	A	T	8	8	16	0	2	18	0	0
2	56131299	.	G	A	5	1	6	0	0	7	1	0
2	56162217	.	C	T	1	3	4	0	0	4	0	0
2	56162412	.	C	T	1	2	3	0	0	3	0	0
2	56216760	.	C	T	2	2	4	0	1	5	0	0
2	56218685	.	A	G	1	0	1	0	0	1	0	0
2	56226369	.	C	G	7	4	11	0	0	11	0	0
2	56226372	.	A	G	6	0	6	0	6	12	0	0
2	56226444	.	T	C	2	4	6	0	1	7	0	0
2	56233253	.	C	T	8	9	17	0	1	18	0	0
2	56234286	.	C	T	16	10	26	0	1	27	0	0
2	56234580	.	T	G	22	14	36	0	0	36	0	0
2	56234584	.	G	T	20	14	34	0	0	34	0	0
2	56234670	.	A	T	13	19	32	0	1	33	0	0
2	56234700	.	C	T	12	15	27	0	3	30	0	0
2	56234749	.	T	C	17	13	30	0	0	30	0	0
2	56234872	.	A	T	10	17	27	0	2	29	0	0
2	56339104	.	T	G	19	20	39	0	2	41	0	0
2	56342894	.	G	A	13	7	20	0	2	22	0	0
2	56356730	.	G	T	3	16	19	0	1	20	0	0
2	56356796	.	T	C	3	8	11	0	0	11	0	0
2	56359495	.	G	A	1	2	3	0	0	3	0	0
2	56359680	.	G	A	0	1	1	0	0	1	0	0
2	56361412	.	A	G	4	0	4	0	0	4	0	0
2	56385241	.	G	A	1	1	2	0	0	2	0	0
2	56463308	.	C	T	7	11	18	0	1	19	0	0
2	56463333	.	C	A	8	10	18	0	2	20	0	0
2	56472472	.	C	T	4	6	10	0	0	10	0	0
2	56472553	.	C	T	2	8	10	0	0	10	0	0
2	56474451	.	C	T	3	2	5	0	0	5	0	0
2	56476113	.	G	A	0	8	8	0	2	10	0	0
2	56476573	.	G	T	0	19	19	0	16	35	0	0
2	56476812	.	A	G	19	14	33	0	1	34	0	0
2	56476909	.	A	C	5	9	14	0	5	19	0	0
2	56508570	.	A	C	10	6	16	0	3	19	0	0
2	56508695	.	T	C	19	21	40	0	4	44	0	0
2	56508715	.	C	G	21	10	31	0	5	36	0	0
2	56509165	.	T	C	20	8	28	0	2	30	0	0
2	56509183	.	T	C	18	10	28	0	3	31	0	0
2	56509912	.	A	T	23	19	42	0	1	43	0	0
2	56509929	.	A	C	22	23	45	0	1	46	0	0
2	56509982	.	T	G	16	18	34	0	3	37	0	0
2	56510200	.	G	A	23	5	28	0	0	28	0	0
2	56510216	.	G	A	9	17	26	0	4	30	0	0
2	56510424	.	G	T	7	4	11	0	2	13	0	0
2	56510450	.	T	C	6	2	8	0	1	9	0	0
2	56511047	.	C	T	4	8	12	0	0	12	0	0
2	56511063	.	C	A	0	4	4	0	6	10	0	0
2	56511687	.	A	T	3	3	6	0	0	6	0	0
2	56511845	.	G	T	2	2	4	0	0	4	0	0
2	56511877	.	C	T	1	4	5	0	0	5	0	0
2	56511917	.	C	T	2	3	5	0	0	5	0	0
2	56512151	.	G	T	4	4	8	0	3	11	0	0
2	56513795	.	G	T	8	7	15	0	0	15	0	0
2	56533104	.	C	G	4	8	12	0	1	13	0	0
2	56533234	.	A	T	1	1	2	0	0	2	0	0
2	56541387	.	G	A	0	2	2	0	0	2	0	0
2	56541417	.	G	A	5	2	7	0	0	7	0	0
2	56553809	.	G	T	3	5	8	0	2	10	0	0
2	56557264	.	G	T	1	7	8	0	0	8	0	0
2	56572165	.	C	A	3	4	7	0	1	8	0	0
2	56572168	.	C	A	0	5	5	0	4	9	0	0
2	56572461	.	G	A	2	2	4	0	0	4	0	0
2	56642185	.	C	G	11	15	26	0	3	29	0	0
2	56645027	.	G	A	23	35	58	0	2	60	0	0
2	56649806	.	A	G	11	5	16	0	0	16	0	0
2	57082243	.	G	A	2	2	4	0	0	4	0	0
2	59137027	.	C	G	3	5	8	0	0	8	0	0
2	59137113	.	C	T	5	6	11	0	1	12	0	0
2	59137182	.	G	T	5	2	7	0	0	7	0	0
2	59143145	.	G	A	1	2	3	0	1	4	0	0
20	67388	.	C	A	2	3	5	0	0	5	0	0
20	67867	.	T	G	2	4	6	0	0	6	0	0
20	75266	.	G	A	0	8	8	0	4	12	0	0
20	75330	.	T	A	5	5	10	0	0	10	0	0
20	75374	.	A	G	7	6	13	0	2	15	0	0
20	75376	.	G	T	0	8	8	0	7	15	0	0
20	76285	.	C	T	15	5	20	0	1	21	0	0
20	89176	.	A	G	3	7	10	0	0	10	0	0
20	89188	.	G	T	0	6	6	0	3	9	0	0
20	89222	.	A	T	0	5	5	0	1	6	0	0
20	89225	.	T	C	1	5	6	0	0	6	0	0
20	89351	.	C	G	1	2	3	0	0	3	0	0
20	89354	.	C	T	1	2	3	0	0	3	0	0
20	89607	.	G	T	0	11	11	0	5	16	0	0
20	89720	.	G	A	9	11	20	0	1	21	0	0
20	89855	.	G	C	10	11	21	0	2	23	0	0
20	90167	.	C	T	20	15	35	0	1	36	0	0
20	90246	.	T	C	13	12	25	0	3	28	0	0
20	114147	.	G	A	0	6	6	1	1	8	0	0
20	114708	.	A	G	28	18	46	0	2	48	0	0
20	114776	.	A	G	12	19	31	0	1	32	0	0
20	122542	.	T	C	6	8	14	0	0	14	0	0
20	122702	.	C	T	0	5	5	0	6	11	0	0
20	124610	.	C	T	1	3	4	0	0	4	0	0
20	151153	.	T	A	1	3	4	0	0	4	0	0
20	151486	.	C	T	7	6	13	0	0	13	0	0
20	151534	.	A	G	4	9	13	0	0	13	0	0
20	151598	.	A	G	0	3	3	0	0	3	0	0
20	151846	.	C	T	18	12	30	0	3	33	0	0
20	152861	.	A	C	2	2	4	0	0	4	0	0
20	186674	.	C	G	8	24	32	0	0	32	0	0
20	186675	.	T	C	8	23	31	0	1	32	0	0
20	186776	.	A	G	13	18	31	0	1	32	0	0
20	186796	.	C	T	0	12	12	0	10	22	0	0
20	186993	.	G	A	1	1	2	0	0	2	0	0
20	188449	.	A	G	0	14	14	0	0	14	0	0
20	197031	.	C	G	8	15	23	0	0	23	0	0
20	197274	.	T	C	13	6	19	0	1	20	0	0
20	198319	.	G	T	15	7	22	0	1	23	0	0
20	198321	.	G	T	14	7	21	0	2	23	0	0
20	198552	.	G	T	4	6	10	0	0	10	0	0
20	198577	.	G	A	9	6	15	0	0	15	0	0
20	198622	.	A	G	7	13	20	0	2	22	0	0
20	198733	.	A	G	4	4	8	0	0	8	0	0
20	198735	.	C	A	4	3	7	0	1	8	0	0
20	199129	.	T	G	5	11	16	0	1	17	0	0
20	199504	.	C	T	3	7	10	0	1	11	0	0
20	199536	.	C	G	4	6	10	0	0	10	0	0
20	200245	.	C	T	0	3	3	0	3	6	0	0
20	200851	.	G	A	3	2	5	0	0	5	0	0
20	201628	.	T	A	1	3	4	0	0	4	0	0
20	202052	.	A	G	1	2	3	0	0	3	0	0
20	202384	.	G	A	2	2	4	0	1	5	0	0
20	202510	.	G	A	1	4	5	0	0	5	0	0
20	384585	.	G	T	0	0	0	0	1	1	0	0
20	393304	.	A	T	0	1	1	0	0	1	0	0
20	395859	.	T	A	2	2	4	0	0	4	0	0
20	395928	.	G	A	2	2	4	0	0	4	0	0
20	405925	.	A	C	4	6	10	0	0	10	0	0
20	406078	.	A	G	3	6	9	0	1	10	0	0
20	406079	.	C	A	3	6	9	0	1	10	0	0
20	406221	.	T	C	2	3	5	0	0	5	0	0
20	410981	.	A	T	6	10	16	0	2	18	0	0
20	423715	.	G	T	1	2	3	0	0	3	0	0
20	424420	.	T	A	2	2	4	0	0	4	0	0
20	426434	.	T	A	1	3	4	0	0	4	0	0
20	430703	.	A	C	1	0	1	0	0	1	0	0
20	522778	.	C	T	1	1	2	0	0	2	0	0
20	525663	.	G	A	7	8	15	0	0	15	0	0
20	530384	.	G	C	10	5	15	0	1	16	0	0
20	530393	.	C	T	11	5	16	0	0	16	0	0
20	530536	.	C	T	4	4	8	0	1	9	0	0
20	557260	.	G	A	2	3	5	0	0	5	0	0
20	557444	.	T	A	1	4	5	0	0	5	0	0
20	589599	.	G	C	2	1	3	0	0	3	0	0
20	589628	.	C	T	1	2	3	0	0	3	0	0
20	700899	.	C	A	7	6	13	0	0	13	0	0
20	700965	.	C	T	4	2	6	0	1	7	0	0
20	711983	.	T	A	10	16	26	0	2	28	0	0
20	711988	.	C	T	16	9	25	0	1	26	0	0
20	757525	.	C	A	2	1	3	0	0	3	0	0
20	764346	.	A	G	1	5	6	0	0	6	0	0
20	764355	.	G	C	5	1	6	0	0	6	0	0
20	771986	.	C	G	3	3	6	0	0	6	0	0
20	772577	.	C	A	0	1	1	0	0	1	0	0
20	775538	.	G	A	1	8	9	0	11	20	0	0
20	775562	.	C	T	7	4	11	0	2	13	0	0
20	775583	.	T	A	5	3	8	0	0	8	0	0
20	775925	.	G	T	0	9	9	0	6	15	0	0
20	776261	.	A	T	15	16	31	0	2	33	0	0
20	776700	.	T	C	11	10	21	0	5	26	0	0
20	776826	.	G	A	10	14	24	0	0	24	0	0
20	776961	.	G	T	5	6	11	0	3	14	0	0
20	847705	.	T	A	1	3	4	0	0	4	0	0
20	847736	.	G	C	1	2	3	0	0	3	0	0
20	847742	.	A	C	2	1	3	0	1	4	0	0
20	847893	.	T	A	1	6	7	0	0	7	0	0
20	851699	.	G	A	2	5	7	0	1	8	0	0
20	851732	.	T	A	2	8	10	0	1	11	0	0
20	851746	.	G	A	9	4	13	0	1	14	0	0
20	852217	.	C	T	0	5	5	0	2	7	0	0
20	853669	.	C	T	9	2	11	0	1	12	0	0
20	856170	.	G	A	4	5	9	0	1	10	0	0
20	866396	.	G	A	4	2	6	0	0	6	0	0
20	875005	.	G	A	3	2	5	0	0	5	0	0
20	875008	.	C	G	3	2	5	0	0	5	0	0
20	875285	.	A	G	1	0	1	0	0	1	0	0
20	880430	.	G	A	5	2	7	0	0	7	0	0
20	880447	.	A	G	5	2	7	0	0	7	0	0
20	883106	.	C	A	4	2	6	0	1	7	0	0
20	884404	.	A	T	0	2	2	0	0	2	0	0
20	902671	.	G	A	2	2	4	0	1	5	0	0
20	902712	.	A	T	2	5	7	0	1	8	0	0
20	902721	.	T	C	5	4	9	0	0	9	0	0
20	902770	.	G	A	1	4	5	0	2	7	0	0
20	902913	.	C	T	0	2	2	0	3	5	0	0
20	902937	.	G	T	3	3	6	0	1	7	0	0
20	908096	.	C	A	1	5	6	0	0	6	0	0
20	908195	.	A	G	1	2	3	0	0	3	0	0
20	943944	.	T	G	6	8	14	0	0	14	0	0
20	943986	.	T	A	6	5	11	0	0	11	0	0
20	943995	.	T	C	6	5	11	0	1	12	0	0
20	944021	.	T	C	7	3	10	0	1	11	0	0
20	944405	.	T	A	2	7	9	0	0	9	0	0
20	1079035	.	G	A	2	1	3	0	0	3	0	0
20	1079084	.	G	C	1	1	2	0	0	2	0	0
20	1081960	.	G	A	2	2	4	0	1	5	0	0
20	1121528	.	G	T	1	2	3	0	0	3	0	0
20	1121715	.	A	G	2	3	5	0	0	5	0	0
20	1132194	.	C	T	0	4	4	0	3	7	0	0
20	1177814	.	T	C	7	4	11	0	2	13	0	0
20	1177879	.	A	T	6	4	10	0	1	11	0	0
20	1178040	.	T	A	1	10	11	0	0	11	0	0
20	1178041	.	T	C	1	10	11	0	0	11	0	0
20	1178505	.	T	C	0	5	5	0	0	5	0	0
20	1178759	.	G	C	4	6	10	0	0	10	0	0
20	1179577	.	C	T	0	1	1	0	5	6	0	0
20	1182872	.	G	A	1	1	2	0	0	2	0	0
20	1191775	.	G	A	2	1	3	0	1	4	0	0
20	1198376	.	G	A	4	12	16	0	1	17	0	0
20	1198397	.	G	A	1	10	11	0	0	11	0	0
20	1201826	.	T	C	3	4	7	0	0	7	0	0
20	1201918	.	C	A	3	3	6	0	0	6	0	0
20	1202016	.	G	T	3	3	6	0	0	6	0	0
20	1204577	.	G	T	1	4	5	0	1	6	0	0
20	1230195	.	A	G	0	2	2	0	1	3	0	0
20	1230201	.	C	G	0	2	2	0	1	3	0	0
20	1240962	.	C	A	3	5	8	0	1	9	0	0
20	1240963	.	T	A	3	6	9	0	0	9	0	0
20	1241075	.	G	A	6	4	10	0	1	11	0	0
20	1241081	.	C	T	6	4	10	0	2	12	0	0
20	1241318	.	C	A	2	1	3	0	0	3	0	0
20	1241535	.	T	C	4	4	8	0	0	8	0	0
20	1241596	.	T	A	4	3	7	0	1	8	0	0
20	1242029	.	A	T	4	2	6	0	0	6	0	0
20	1242500	.	G	A	1	2	3	0	0	3	0	0
20	1244379	.	G	A	4	4	8	0	0	8	0	0
20	1246936	.	C	T	0	3	3	0	2	5	0	0
20	1257193	.	G	A	2	3	5	0	0	5	0	0
20	1278796	.	G	A	1	4	5	0	1	6	0	0
20	1281278	.	G	T	3	1	4	0	1	5	0	0
20	1281883	.	G	A	0	2	2	0	0	2	0	0
20	1282601	.	C	A	4	7	11	0	1	12	0	0
20	1282634	.	A	C	4	5	9	0	1	10	0	0
20	1294062	.	C	G	16	13	29	0	0	29	0	0
20	1294099	.	G	C	25	11	36	0	2	38	0	0
20	1294196	.	G	A	11	16	27	0	4	31	0	0
20	1294200	.	T	G	17	12	29	0	2	31	0	0
20	1294267	.	T	G	17	29	46	0	0	46	0	0
20	1294275	.	A	G	16	28	44	0	0	44	0	0
20	1294612	.	T	C	0	1	1	0	0	1	0	0
20	1294785	.	T	C	13	4	17	0	2	19	0	0
20	1294970	.	A	G	6	19	25	0	0	25	0	0
20	1295302	.	T	C	7	5	12	0	0	12	0	0
20	1295312	.	T	C	5	8	13	0	1	14	0	0
20	1295363	.	T	C	8	5	13	0	0	13	0	0
20	1295426	.	G	T	1	2	3	0	0	3	0	0
20	1295840	.	G	A	16	10	26	0	0	26	0	0
20	1296022	.	G	C	8	11	19	0	2	21	0	0
20	1296114	.	G	A	11	17	28	0	1	29	0	0
20	1296139	.	A	G	8	15	23	0	6	29	0	0
20	1316757	.	G	C	1	4	5	0	0	5	0	0
20	1322643	.	A	G	2	2	4	0	0	4	0	0
20	1322715	.	G	A	0	1	1	0	2	3	0	0
20	1327501	.	C	A	1	2	3	0	0	3	0	0
20	1327528	.	A	C	8	5	13	0	0	13	0	0
20	1327545	.	A	T	10	6	16	0	0	16	0	0
20	1338955	.	T	C	1	2	3	0	0	3	0	0
20	1339459	.	G	C	0	3	3	0	4	7	0	0
20	1339486	.	T	G	4	2	6	0	0	6	0	0
20	1339978	.	G	C	2	1	3	0	4	7	0	0
20	1339984	.	C	A	4	2	6	0	2	8	0	0
20	1340266	.	T	C	0	1	1	0	0	1	0	0
20	1340269	.	T	C	0	1	1	0	0	1	0	0
20	1349153	.	C	G	2	6	8	0	0	8	0	0
20	1349357	.	G	A	0	3	3	0	5	8	0	0
20	1349555	.	T	C	3	3	6	0	0	6	0	0
20	1349622	.	T	C	7	3	10	0	0	10	0	0
20	1349739	.	A	G	3	0	3	0	6	9	0	0
20	1349947	.	G	A	1	6	7	0	5	12	0	0
20	1349955	.	G	A	3	3	6	0	4	10	0	0
20	1350029	.	C	G	10	8	18	0	0	18	0	0
20	1392415	.	T	G	3	2	5	0	0	5	0	0
20	1441666	.	T	C	6	6	12	0	2	14	0	0
20	1441777	.	A	G	10	20	30	1	0	31	0	0
20	1441815	.	A	C	18	12	30	1	0	34	3	0
20	1441825	.	T	C	18	12	30	0	2	32	0	0
20	1442515	.	A	T	10	12	22	0	2	24	0	0
20	1442624	.	C	T	11	8	19	0	5	24	0	0
20	1445375	.	C	T	3	1	4	0	0	4	0	0
20	1454098	.	A	G	13	11	24	0	0	24	0	0
20	1455104	.	G	A	7	3	10	0	0	10	0	0
20	1460979	.	C	A	2	5	7	0	1	8	0	0
20	1487549	.	A	G	2	2	4	0	0	4	0	0
20	1560842	.	C	T	0	1	1	0	0	1	0	0
20	2241401	.	C	T	0	2	2	0	0	2	0	0
20	2290470	.	G	A	5	4	9	0	1	10	0	0
20	2293263	.	C	A	0	9	9	0	8	17	0	0
20	2295532	.	G	A	18	11	29	0	2	31	0	0
20	2716055	.	A	G	5	4	9	0	2	11	0	0
20	2976077	.	A	G	9	1	10	0	0	10	0	0
20	2976094	.	A	G	7	1	8	0	0	8	0	0
20	2976909	.	C	A	8	5	13	1	1	15	0	0
20	2977257	.	C	T	18	16	34	0	5	39	0	0
20	2977417	.	C	A	14	0	14	0	2	16	0	0
20	2977418	.	C	A	15	0	15	0	1	16	0	0
20	2977540	.	A	G	5	5	10	0	0	10	0	0
20	2977541	.	A	G	3	7	10	0	0	10	0	0
20	2983255	.	C	T	1	4	5	0	0	5	0	0
20	2983258	.	T	C	1	0	1	0	4	5	0	0
20	3016311	.	G	A	2	3	5	0	1	6	0	0
20	3018319	.	T	C	1	0	1	0	8	9	0	0
20	3020281	.	A	T	3	4	7	0	0	7	0	0
20	3026253	.	G	A	1	0	1	0	0	1	0	0
20	3029659	.	A	C	1	0	1	0	0	1	0	0
20	3029662	.	A	G	1	0	1	0	0	1	0	0
20	3061079	.	C	G	0	2	2	0	0	2	0	0
20	3086398	.	T	C	1	4	5	0	0	5	0	0
20	3117860	.	C	T	2	2	4	0	0	4	0	0
20	3117881	.	G	T	1	3	4	0	0	4	0	0
20	3117915	.	A	C	1	1	2	0	1	3	0	0
20	3121179	.	A	G	2	2	4	0	0	4	0	0
20	3122251	.	G	A	1	3	4	0	1	5	0	0
20	3129754	.	C	G	0	1	1	0	0	1	0	0
20	3130185	.	C	T	3	3	6	0	0	6	0	0
20	3239094	.	T	G	4	7	11	0	0	11	0	0
20	3239205	.	C	G	0	10	10	0	8	18	0	0
20	3239383	.	A	T	10	7	17	0	0	17	0	0
20	3242733	.	G	A	3	2	5	0	0	5	0	0
20	3242944	.	A	G	1	1	2	0	1	3	0	0
20	3248778	.	C	A	9	5	14	0	3	17	0	0
20	3248817	.	T	C	7	1	8	0	10	18	0	0
20	3248919	.	T	A	9	6	15	0	1	16	0	0
20	3249029	.	G	A	5	14	19	0	3	22	0	0
20	3249060	.	A	T	14	8	22	0	2	24	0	0
20	3249445	.	G	A	4	9	13	0	3	16	0	0
20	3249513	.	G	T	2	6	8	0	1	9	0	0
20	3249600	.	C	A	0	7	7	0	6	13	0	0
20	3249725	.	C	T	7	5	12	0	0	12	0	0
20	3249870	.	C	T	5	2	7	0	0	7	0	0
20	3249872	.	G	A	5	1	6	0	1	7	0	0
20	3282039	.	G	T	1	3	4	0	0	4	0	0
20	3286355	.	G	A	1	1	2	0	0	2	0	0
20	3288086	.	T	G	7	0	7	0	6	13	0	0
20	3292722	.	A	G	2	2	4	0	0	4	0	0
20	3349067	.	T	A	0	8	8	0	0	8	0	0
20	3916456	.	T	A	3	5	8	0	0	8	0	0
20	3916464	.	C	T	3	7	10	0	0	10	0	0
20	3916621	.	T	G	4	5	9	0	0	9	0	0
20	3920746	.	T	G	2	2	4	0	0	4	0	0
20	3920873	.	T	A	5	7	12	0	0	12	0	0
20	3920875	.	G	A	5	7	12	0	0	12	0	0
20	3921127	.	A	T	5	3	8	0	2	10	0	0
20	3921184	.	G	A	2	4	6	0	1	7	0	0
20	3921202	.	T	C	1	3	4	0	0	4	0	0
20	3923735	.	C	G	4	2	6	0	1	7	0	0
20	3923983	.	G	A	0	5	5	0	7	12	0	0
20	3924098	.	A	T	12	6	18	0	1	19	0	0
20	3924349	.	G	A	5	3	8	0	1	9	0	0
20	3924430	.	G	A	0	6	6	0	6	12	0	0
20	3924528	.	C	A	2	5	7	0	2	9	0	0
20	3925146	.	A	T	3	8	11	0	1	12	0	0
20	3925537	.	T	C	5	7	12	0	0	12	0	0
20	3925544	.	T	A	9	5	14	0	1	15	0	0
20	3925842	.	C	A	7	4	11	0	0	11	0	0
20	3925889	.	C	T	7	7	14	0	3	17	0	0
20	3925907	.	T	A	6	5	11	0	1	12	0	0
20	3926020	.	C	T	6	9	15	0	0	15	0	0
20	3926337	.	C	T	4	5	9	3	0	12	0	0
20	3926679	.	G	T	10	0	10	1	0	11	0	0
20	3926721	.	T	C	4	9	13	0	1	14	0	0
20	3926736	.	T	A	10	11	21	0	1	22	0	0
20	3926907	.	T	G	12	11	23	0	3	26	0	0
20	3926928	.	T	A	16	12	28	0	1	29	0	0
20	3926951	.	A	G	17	17	34	0	1	35	0	0
20	3927267	.	C	A	25	17	42	0	5	47	0	0
20	3927326	.	A	G	20	16	36	0	2	38	0	0
20	3927446	.	C	G	9	15	24	0	2	26	0	0
20	3927601	.	A	G	4	2	6	0	2	8	0	0
20	3947006	.	T	G	0	2	2	0	0	2	0	0
20	3947058	.	C	A	1	2	3	0	0	3	0	0
20	3947100	.	C	T	1	1	2	0	0	2	0	0
20	3953593	.	T	C	5	2	7	0	0	7	0	0
20	3954813	.	G	C	4	2	6	0	0	6	0	0
20	3954870	.	C	T	0	2	2	0	2	4	0	0
20	4009750	.	T	G	5	0	5	0	0	5	0	0
20	4010256	.	T	C	2	11	13	0	0	13	0	0
20	4010462	.	C	T	3	11	14	0	0	14	0	0
20	4030825	.	G	A	1	2	3	0	0	3	0	0
20	4035837	.	G	A	2	6	8	0	0	8	0	0
20	4035858	.	G	C	1	6	7	0	0	7	0	0
20	4036462	.	A	G	1	0	1	0	0	1	0	0
20	4036587	.	T	C	4	3	7	0	0	7	0	0
20	4037409	.	T	A	1	1	2	0	1	3	0	0
20	4037461	.	G	T	1	2	3	0	0	3	0	0
20	4037823	.	G	C	1	0	1	0	3	4	0	0
20	4037824	.	T	G	1	3	4	0	0	4	0	0
20	4053012	.	G	A	0	3	3	0	4	7	0	0
20	4887996	.	G	T	1	4	5	0	1	6	0	0
20	4888004	.	A	G	1	4	5	0	1	6	0	0
20	4888037	.	T	C	0	1	1	0	0	1	0	0
20	4896120	.	G	T	6	10	16	0	0	16	0	0
20	4896201	.	G	A	5	7	12	0	2	14	0	0
20	4896240	.	A	C	6	2	8	0	1	9	0	0
20	4896297	.	T	G	2	2	4	0	0	4	0	0
20	4896300	.	T	A	2	1	3	0	0	3	0	0
20	4898036	.	C	T	0	2	2	0	0	2	0	0
20	4898112	.	T	G	1	0	1	0	4	5	0	0
20	4898126	.	A	G	1	4	5	0	0	5	0	0
20	4898563	.	A	T	17	16	33	0	7	40	0	0
20	4898683	.	C	T	21	17	38	0	3	41	0	0
20	4898776	.	C	T	17	11	28	0	6	34	0	0
20	4898784	.	T	C	16	12	28	0	3	31	0	0
20	4899342	.	T	G	8	11	19	0	0	19	0	0
20	4899935	.	A	T	5	9	14	0	1	15	0	0
20	4900564	.	T	C	5	5	10	0	0	10	0	0
20	4900600	.	G	A	6	3	9	0	0	9	0	0
20	4900609	.	T	C	6	0	6	0	3	9	0	0
20	4900697	.	T	C	10	3	13	0	2	15	0	0
20	4900855	.	C	T	5	4	9	0	1	10	0	0
20	4903334	.	G	C	2	5	7	0	2	9	0	0
20	4903456	.	A	G	3	3	6	0	0	6	0	0
20	5069389	.	G	A	4	5	9	0	3	12	0	0
20	5069500	.	T	C	4	2	6	0	0	6	0	0
20	5090938	.	G	A	0	2	2	0	6	8	0	0
20	5093872	.	A	T	5	2	7	0	1	8	0	0
20	5094205	.	A	C	1	5	6	0	0	6	0	0
20	6802354	.	T	G	3	4	7	0	0	7	0	0
20	6802441	.	A	C	4	2	6	0	0	6	0	0
20	6803105	.	A	T	5	2	7	0	0	7	0	0
20	6803170	.	G	T	5	4	9	0	0	9	0	0
20	6803213	.	T	G	7	5	12	0	0	12	0	0
20	6810046	.	T	C	1	1	2	0	0	2	0	0
20	6898118	.	A	G	0	2	2	0	1	3	0	0
20	7071208	.	G	T	0	0	0	0	1	1	0	0
20	9059266	.	T	A	1	1	2	0	1	3	0	0
20	9096451	.	T	A	1	4	5	0	0	5	0	0
20	9096596	.	C	A	2	2	4	0	0	4	0	0
20	9097597	.	T	A	3	6	9	0	0	9	0	0
20	9097639	.	A	G	4	5	9	0	1	10	0	0
20	9097666	.	T	C	3	3	6	0	0	6	0	0
20	9102068	.	T	C	1	3	4	0	0	4	0	0
20	9105204	.	C	G	3	3	6	0	0	6	0	0
20	9111228	.	A	G	2	1	3	0	0	3	0	0
20	9115236	.	G	T	2	3	5	0	0	5	0	0
20	9115241	.	G	A	2	3	5	0	0	5	0	0
20	9125359	.	T	G	3	2	5	0	0	5	0	0
20	9130368	.	C	T	0	3	3	0	1	4	0	0
20	9172370	.	C	T	3	2	5	0	0	5	0	0
20	9174014	.	T	C	15	15	30	0	1	31	0	0
20	9183159	.	T	G	1	1	2	0	0	2	0	0
20	9184696	.	T	C	7	6	13	0	1	14	0	0
20	9184708	.	C	T	5	4	9	0	1	10	0	0
20	9184928	.	C	A	6	6	12	0	0	12	0	0
20	9185389	.	G	T	1	3	4	0	0	4	0	0
20	9185515	.	T	C	4	0	4	0	0	4	0	0
20	9186200	.	A	G	3	3	6	0	0	6	0	0
20	9186310	.	T	C	3	1	4	0	0	4	0	0
20	9190238	.	A	T	7	3	10	0	0	10	0	0
20	9190468	.	T	G	2	4	6	0	0	6	0	0
20	9190510	.	C	T	1	0	1	0	0	1	0	0
20	9190637	.	G	T	3	1	4	0	0	4	0	0
20	9191144	.	G	A	2	5	7	0	0	7	0	0
20	9191353	.	T	G	6	2	8	0	1	9	0	0
20	9192375	.	T	A	3	4	7	0	0	7	0	0
20	9192444	.	C	T	0	2	2	0	1	3	0	0
20	9199500	.	C	T	1	3	4	0	0	4	0	0
20	9241884	.	G	A	6	2	8	0	1	9	0	0
20	9242145	.	T	C	4	2	6	0	0	6	0	0
20	9242151	.	T	C	3	2	5	0	1	6	0	0
20	9242476	.	T	C	4	5	9	0	0	9	0	0
20	9248692	.	G	A	2	2	4	0	0	4	0	0
20	9249901	.	A	G	3	2	5	0	0	5	0	0
20	9249934	.	C	T	0	2	2	0	2	4	0	0
20	9418744	.	A	G	5	2	7	0	0	7	0	0
20	9418804	.	T	C	7	6	13	0	3	16	0	0
20	9419014	.	A	T	5	8	13	0	0	13	0	0
20	9419218	.	G	A	9	6	15	0	1	16	0	0
20	9419314	.	C	T	5	9	14	0	0	14	0	0
20	9419575	.	C	T	8	19	27	0	0	27	0	0
20	9419716	.	T	C	11	11	22	0	6	28	0	0
20	9419842	.	C	T	11	6	17	0	0	17	0	0
20	9419896	.	C	T	10	9	19	0	0	19	0	0
20	9420018	.	C	T	10	9	19	0	5	24	0	0
20	9420168	.	T	C	8	11	19	0	2	21	0	0
20	9420974	.	A	T	28	10	38	2	4	44	0	0
20	9420976	.	C	T	29	10	39	2	3	44	0	0
20	9421011	.	A	G	18	0	18	0	36	54	0	0
20	9421515	.	G	A	3	4	7	0	2	9	0	0
20	9421563	.	G	A	3	7	10	0	1	11	0	0
20	9421672	.	C	T	0	1	1	0	14	15	0	0
20	9421690	.	G	T	5	12	17	0	0	17	0	0
20	9421732	.	T	A	14	11	25	0	0	25	0	0
20	9421781	.	T	C	9	1	10	0	10	20	0	0
20	9422045	.	G	A	8	12	20	0	2	22	0	0
20	9422536	.	G	A	7	10	17	0	1	18	0	0
20	9422566	.	G	A	6	9	15	0	2	17	0	0
20	9427737	.	G	T	2	5	7	0	0	7	0	0
20	9429315	.	G	T	14	6	20	0	5	25	0	0
20	9429363	.	G	A	25	16	41	0	5	46	0	0
20	9429370	.	C	T	25	20	45	0	2	47	0	0
20	9429648	.	A	G	3	0	3	0	0	3	0	0
20	9436314	.	A	T	5	19	24	0	0	24	0	0
20	9436363	.	A	G	0	7	7	0	0	7	0	0
20	9462312	.	T	A	3	1	4	0	0	4	0	0
20	9462412	.	G	T	5	10	15	0	0	15	0	0
20	9575868	.	T	C	2	0	2	0	4	6	0	0
20	9576550	.	C	T	2	2	4	0	0	4	0	0
20	9576710	.	C	G	0	2	2	0	0	2	0	0
20	9577487	.	G	A	1	2	3	0	0	3	0	0
20	9766973	.	G	A	2	2	4	0	0	4	0	0
20	9768191	.	C	T	6	6	12	0	0	12	0	0
20	9768230	.	C	T	2	2	4	0	1	5	0	0
20	9775889	.	A	G	6	11	17	0	0	17	0	0
20	9775934	.	T	C	15	22	37	0	2	39	0	0
20	9776270	.	G	A	12	8	20	0	2	22	0	0
20	9776770	.	A	G	3	3	6	0	0	6	0	0
20	9782747	.	C	A	1	3	4	0	1	5	0	0
20	9782913	.	T	C	4	2	6	0	2	8	0	0
20	9782990	.	T	C	2	5	7	0	0	7	0	0
20	9820430	.	T	C	1	0	1	0	0	1	0	0
20	9830642	.	T	C	7	17	24	0	6	30	0	0
20	9830684	.	G	T	21	22	43	0	1	44	0	0
20	9831443	.	G	A	19	29	48	0	2	50	0	0
20	9831703	.	T	A	33	25	58	0	2	60	0	0
20	9837587	.	G	A	30	30	60	0	5	65	0	0
20	9837593	.	T	C	30	30	60	0	6	66	0	0
20	9846751	.	A	G	9	1	10	0	1	11	0	0
20	9846989	.	T	C	20	33	53	0	8	61	0	0
20	9846997	.	A	T	20	35	55	0	3	58	0	0
20	9847078	.	T	C	28	30	58	0	2	60	0	0
20	9847252	.	G	T	12	10	22	0	1	23	0	0
20	9847298	.	T	G	13	10	23	0	2	25	0	0
20	9847304	.	G	A	13	10	23	0	2	25	0	0
20	9847381	.	A	C	24	8	32	0	1	33	0	0
20	9847529	.	A	T	31	15	46	0	2	48	0	0
20	9847772	.	T	C	31	21	52	0	1	53	0	0
20	9847895	.	C	T	27	23	50	0	5	55	0	0
20	9848116	.	C	T	41	16	57	0	1	58	0	0
20	9848181	.	A	T	44	6	50	0	0	50	0	0
20	9848196	.	T	G	51	10	61	0	0	61	0	0
20	9959377	.	G	A	5	3	8	0	0	8	0	0
20	9959699	.	T	A	1	3	4	0	0	4	0	0
20	9959725	.	C	T	0	4	4	0	0	4	0	0
20	9959890	.	G	A	2	3	5	0	0	5	0	0
20	9961144	.	G	A	2	2	4	0	0	4	0	0
20	9961145	.	T	C	2	0	2	0	2	4	0	0
20	10057890	.	G	A	0	2	2	0	1	3	0	0
20	10057993	.	C	G	0	7	7	0	11	18	0	0
20	10058109	.	T	A	9	15	24	0	0	24	0	0
20	10058111	.	A	G	9	15	24	0	0	24	0	0
20	10058242	.	T	C	13	13	26	0	0	26	0	0
20	10058350	.	C	T	10	4	14	0	3	17	0	0
20	10058441	.	A	T	7	9	16	0	0	16	0	0
20	10058476	.	T	A	7	12	19	0	0	19	0	0
20	10058796	.	G	A	6	7	13	0	0	13	0	0
20	10058829	.	T	A	7	5	12	0	0	12	0	0
20	10058853	.	C	A	7	4	11	0	1	12	0	0
20	10058897	.	C	T	5	2	7	0	0	7	0	0
20	10058901	.	G	C	5	2	7	0	0	7	0	0
20	10058948	.	T	A	5	2	7	0	1	8	0	0
20	10059194	.	G	A	3	13	16	0	0	16	0	0
20	10059278	.	A	G	7	5	12	0	1	13	0	0
20	10059815	.	A	G	3	2	5	0	1	6	0	0
20	10060391	.	G	A	4	2	6	0	0	6	0	0
20	10060483	.	A	C	4	5	9	0	0	9	0	0
20	10060768	.	G	C	2	2	4	0	0	4	0	0
20	10061859	.	C	T	0	1	1	0	0	1	0	0
20	10099362	.	T	A	3	3	6	0	0	6	0	0
20	10099363	.	C	T	3	3	6	0	0	6	0	0
20	10099640	.	G	A	2	6	8	0	0	8	0	0
20	10099932	.	C	A	5	8	13	0	1	14	0	0
20	10102593	.	G	A	1	6	7	0	2	9	0	0
20	10116067	.	A	G	5	6	11	0	1	12	0	0
20	10353335	.	T	C	2	4	6	0	0	6	0	0
20	10354482	.	T	G	1	0	1	0	0	1	0	0
20	11098317	.	T	A	6	2	8	0	1	10	1	0
20	13567497	.	T	C	7	4	11	0	0	11	0	0
20	13567503	.	T	C	4	0	4	0	5	9	0	0
20	13567556	.	T	C	2	4	6	0	1	7	0	0
20	13567574	.	T	C	1	3	4	0	2	6	0	0
20	14977165	.	G	A	0	3	3	0	1	4	0	0
20	14983779	.	C	T	1	3	4	0	0	4	0	0
20	14997711	.	G	C	8	0	8	0	1	9	0	0
20	14997729	.	G	A	9	2	11	0	1	12	0	0
20	14997753	.	T	A	9	3	12	0	0	12	0	0
20	15004153	.	T	C	8	10	18	0	1	19	0	0
20	15004205	.	C	T	15	21	36	0	4	40	0	0
20	15004321	.	C	T	22	16	38	0	2	40	0	0
20	15004334	.	A	C	23	14	37	0	4	41	0	0
20	15004518	.	A	G	3	17	20	0	0	20	0	0
20	15004575	.	C	A	10	11	21	0	0	21	0	0
20	15004611	.	A	C	14	12	26	0	0	26	0	0
20	15004710	.	C	T	7	17	24	0	2	26	0	0
20	15004746	.	T	A	7	15	22	0	3	25	0	0
20	15004751	.	T	G	7	16	23	0	1	24	0	0
20	15004806	.	C	T	3	14	17	0	0	17	0	0
20	15004825	.	A	T	4	13	17	0	1	18	0	0
20	15004862	.	T	C	10	13	23	0	3	26	0	0
20	15004874	.	A	G	11	0	11	0	20	31	0	0
20	15004992	.	A	G	13	6	19	0	1	20	0	0
20	15023488	.	T	C	2	3	5	0	1	6	0	0
20	15026847	.	C	T	0	3	3	0	12	15	0	0
20	15033948	.	G	A	5	1	6	0	0	6	0	0
20	15033960	.	G	A	4	4	8	0	0	8	0	0
20	15034192	.	A	G	5	4	9	0	1	10	0	0
20	15050753	.	G	T	1	4	5	0	0	5	0	0
20	15051379	.	T	G	0	2	2	0	0	2	0	0
20	15051812	.	T	C	0	2	2	0	0	2	0	0
20	15054365	.	G	A	1	2	3	0	1	4	0	0
20	15093847	.	T	C	1	2	3	0	0	3	0	0
20	15171711	.	C	T	4	7	11	0	0	11	0	0
20	15184455	.	C	T	10	15	25	0	0	25	0	0
20	15184527	.	T	A	19	18	37	0	0	37	0	0
20	15184568	.	T	G	17	18	35	0	1	36	0	0
20	15184611	.	A	T	12	12	24	0	0	24	0	0
20	15184629	.	T	G	8	7	15	0	3	18	0	0
20	15184654	.	C	T	7	8	15	0	1	16	0	0
20	15184671	.	A	G	9	5	14	0	1	15	0	0
20	15553003	.	C	T	10	12	22	0	2	24	0	0
20	15553159	.	A	G	10	9	19	0	0	19	0	0
20	15553366	.	G	T	11	15	26	0	2	28	0	0
20	15554247	.	A	G	17	11	28	0	2	30	0	0
20	15574202	.	G	A	1	0	1	0	0	1	0	0
20	15857317	.	G	C	15	15	30	0	4	34	0	0
20	15857761	.	T	A	16	12	28	0	5	33	0	0
20	15857805	.	T	A	13	17	30	0	0	30	0	0
20	15857850	.	C	T	8	14	22	0	3	26	1	0
20	15866267	.	A	G	1	2	3	0	0	3	0	0
20	15866414	.	T	C	6	4	10	0	0	10	0	0
20	15911808	.	A	G	0	2	2	0	0	2	0	0
20	15911880	.	C	T	3	10	13	0	1	14	0	0
20	15912102	.	T	C	4	11	15	0	2	17	0	0
20	15912167	.	A	G	5	11	16	0	1	17	0	0
20	15922350	.	A	T	4	8	12	0	0	12	0	0
20	15922364	.	C	G	6	12	18	0	0	18	0	0
20	15933419	.	G	A	11	6	17	0	1	18	0	0
20	15933553	.	G	A	5	7	12	0	1	13	0	0
20	15933659	.	C	T	9	4	13	0	2	15	0	0
20	15933852	.	C	T	13	9	22	0	2	24	0	0
20	15933904	.	C	A	17	0	17	0	5	22	0	0
20	15933914	.	T	A	5	8	13	0	6	19	0	0
20	15934026	.	G	A	14	8	22	0	0	22	0	0
20	15934395	.	G	T	3	3	6	0	2	8	0	0
20	15934459	.	G	A	9	6	15	0	0	15	0	0
20	15934519	.	A	G	6	3	9	0	1	11	1	0
20	15934526	.	G	T	7	4	11	0	0	11	0	0
20	15934639	.	G	C	0	3	3	0	1	4	0	0
20	15937613	.	G	A	1	3	4	0	3	7	0	0
20	15937637	.	A	G	3	1	4	0	1	5	0	0
20	15970213	.	A	G	0	2	2	0	0	2	0	0
20	16034879	.	T	C	1	0	1	0	0	1	0	0
20	16163348	.	T	C	5	12	17	0	3	20	0	0
20	16163447	.	T	C	10	1	11	0	14	25	0	0
20	16163552	.	G	A	5	7	12	0	0	12	0	0
20	16177796	.	A	G	1	2	3	0	1	4	0	0
20	16177799	.	C	T	1	3	4	0	0	4	0	0
20	16193776	.	A	G	2	2	4	0	1	5	0	0
20	16198986	.	G	A	0	4	4	0	2	6	0	0
20	16200983	.	T	A	8	3	11	0	1	12	0	0
20	16201017	.	C	T	5	6	11	0	3	14	0	0
20	16201109	.	T	A	6	8	14	0	2	16	0	0
20	16201163	.	T	A	17	5	22	0	0	22	0	0
20	16201394	.	G	A	9	14	23	0	1	24	0	0
20	16201649	.	A	C	9	17	26	0	1	27	0	0
20	16438258	.	A	T	10	8	18	0	3	21	0	0
20	16438557	.	A	C	8	5	13	0	1	14	0	0
20	16438658	.	A	T	5	11	16	0	0	16	0	0
20	16438776	.	C	G	5	8	13	0	0	13	0	0
20	16438785	.	G	T	5	6	11	0	0	11	0	0
20	16438837	.	T	C	4	0	4	0	11	15	0	0
20	16438957	.	T	G	7	5	12	0	3	15	0	0
20	16438958	.	C	G	8	4	12	0	3	15	0	0
20	16443545	.	G	A	2	2	4	0	0	4	0	0
20	16443677	.	T	C	10	12	22	0	1	23	0	0
20	16443701	.	T	A	9	8	17	0	1	18	0	0
20	16443740	.	C	T	4	2	6	0	0	6	0	0
20	16446685	.	A	G	1	1	2	0	0	2	0	0
20	16448913	.	G	T	3	3	6	0	1	7	0	0
20	16448930	.	T	C	4	3	7	0	0	7	0	0
20	16478011	.	A	G	1	3	4	0	0	4	0	0
20	16478273	.	T	A	1	3	4	0	0	4	0	0
20	16639964	.	G	A	0	4	4	0	2	6	0	0
20	16640049	.	C	T	3	3	6	0	0	6	0	0
20	16645004	.	T	C	1	2	3	0	0	3	0	0
20	16652964	.	G	A	0	1	1	0	1	2	0	0
20	16660218	.	G	A	0	14	14	0	15	29	0	0
20	16660327	.	G	C	12	13	25	0	1	26	0	0
20	16660462	.	A	T	16	14	30	0	0	30	0	0
20	16660567	.	G	A	16	12	28	0	0	28	0	0
20	16660652	.	G	A	18	10	28	0	3	31	0	0
20	16660707	.	G	A	0	12	12	0	9	21	0	0
20	16660808	.	C	T	5	3	8	0	0	8	0	0
20	16736960	.	G	A	5	4	9	0	1	10	0	0
20	16737485	.	C	T	16	17	33	0	0	33	0	0
20	16737524	.	T	C	12	13	25	0	0	25	0	0
20	16771318	.	C	T	10	14	24	0	3	27	0	0
20	16774513	.	A	T	37	23	60	0	3	63	0	0
20	16774868	.	A	G	25	10	35	0	3	38	0	0
20	16774970	.	T	A	24	38	62	0	4	66	0	0
20	16832788	.	G	T	13	6	19	0	0	19	0	0
20	16833019	.	C	T	0	10	10	0	12	22	0	0
20	16833089	.	A	G	4	10	14	0	0	14	0	0
20	16833096	.	A	G	5	9	14	0	0	14	0	0
20	16833125	.	C	T	2	9	11	0	0	11	0	0
20	16833213	.	G	C	6	8	14	0	0	14	0	0
20	16833284	.	A	T	8	10	18	0	1	19	0	0
20	16833560	.	T	C	3	5	8	0	1	9	0	0
20	16834096	.	T	C	5	8	13	0	0	13	0	0
20	16834307	.	C	A	1	4	5	0	3	8	0	0
20	16834525	.	A	G	5	4	9	0	0	9	0	0
20	16834778	.	T	C	5	11	16	0	0	16	0	0
20	16884434	.	C	T	1	4	5	0	1	6	0	0
20	16903806	.	T	A	0	1	1	0	0	1	0	0
20	16903878	.	T	A	0	1	1	0	0	1	0	0
20	16906564	.	C	T	5	3	8	0	0	8	0	0
20	17798876	.	C	T	4	3	7	0	2	9	0	0
20	17798930	.	C	T	3	1	4	0	0	4	0	0
20	17799127	.	C	A	7	5	12	0	0	13	1	0
20	17800493	.	T	C	4	1	5	0	0	5	0	0
20	17802868	.	C	T	3	6	9	0	0	9	0	0
20	17802874	.	A	G	4	6	10	0	0	10	0	0
20	17802979	.	C	T	5	3	8	0	0	8	0	0
20	17803572	.	T	C	4	10	14	0	0	14	0	0
20	17809123	.	G	A	15	20	35	0	0	35	0	0
20	17809141	.	T	C	15	18	33	0	1	34	0	0
20	17809177	.	C	T	16	14	30	0	0	30	0	0
20	17811587	.	G	A	3	3	6	0	0	6	0	0
20	17817433	.	T	G	21	21	42	0	4	46	0	0
20	17817659	.	G	T	14	12	26	0	2	28	0	0
20	17817926	.	G	T	16	11	27	0	1	28	0	0
20	17818204	.	T	A	16	6	22	0	1	23	0	0
20	17818291	.	T	C	9	9	18	0	7	25	0	0
20	17818445	.	T	A	12	15	27	0	1	28	0	0
20	17819008	.	T	C	40	0	40	0	8	48	0	0
20	18225441	.	C	A	1	5	6	0	0	6	0	0
20	18255474	.	A	G	5	1	6	0	19	25	0	0
20	18255810	.	T	C	13	19	32	0	2	34	0	0
20	18255931	.	A	T	8	15	23	0	3	26	0	0
20	18256176	.	T	A	4	6	10	0	1	11	0	0
20	18306290	.	T	A	12	10	22	0	0	22	0	0
20	18306298	.	T	G	14	9	23	0	1	24	0	0
20	18307075	.	T	C	3	0	3	0	1	4	0	0
20	18309277	.	C	T	8	5	13	0	1	14	0	0
20	18312803	.	T	C	10	3	13	0	0	13	0	0
20	18312839	.	T	C	14	9	23	0	1	24	0	0
20	18357820	.	T	C	2	2	4	0	1	5	0	0
20	18358002	.	T	C	6	5	11	0	0	11	0	0
20	18369979	.	G	A	0	1	1	0	0	1	0	0
20	18373014	.	T	G	1	1	2	0	0	2	0	0
20	18376800	.	C	T	1	2	3	0	0	3	0	0
20	18392845	.	C	T	14	17	31	0	2	33	0	0
20	18393249	.	T	C	16	14	30	0	1	31	0	0
20	18393359	.	A	T	8	13	21	0	0	21	0	0
20	18393376	.	C	T	9	9	18	0	0	18	0	0
20	18396134	.	A	G	3	1	4	0	0	4	0	0
20	18414262	.	C	T	2	3	5	0	0	5	0	0
20	18432732	.	C	T	1	1	2	0	0	2	0	0
20	18443435	.	G	A	2	2	4	0	1	5	0	0
20	18591638	.	G	T	5	4	9	0	2	11	0	0
20	18591704	.	G	A	16	17	33	0	0	33	0	0
20	18591716	.	A	C	11	11	22	0	3	25	0	0
20	18591743	.	A	T	6	5	11	0	1	12	0	0
20	18594958	.	C	A	34	12	46	0	0	46	0	0
20	18594980	.	T	A	9	31	40	0	1	41	0	0
20	18595296	.	T	G	10	0	10	0	18	28	0	0
20	18669600	.	G	A	1	0	1	0	0	1	0	0
20	18672064	.	C	T	2	15	17	0	0	17	0	0
20	18672094	.	T	C	2	11	13	0	0	13	0	0
20	18672193	.	G	A	0	0	0	0	3	3	0	0
20	18672733	.	A	T	2	10	12	0	0	12	0	0
20	18677343	.	G	A	1	1	2	0	0	2	0	0
20	18678023	.	T	C	1	0	1	0	0	1	0	0
20	18678466	.	C	T	6	5	11	0	0	11	0	0
20	18683158	.	T	C	4	9	13	0	0	13	0	0
20	18684922	.	A	T	17	12	29	0	3	32	0	0
20	18685139	.	G	A	9	17	26	0	0	26	0	0
20	18708770	.	T	C	16	14	30	0	2	32	0	0
20	18713067	.	T	C	15	15	30	0	2	32	0	0
20	18714024	.	C	T	4	3	7	0	0	7	0	0
20	18714052	.	A	G	0	7	7	0	0	7	0	0
20	18721775	.	T	G	6	12	18	0	0	18	0	0
20	18721910	.	G	A	10	3	13	0	1	14	0	0
20	18722089	.	G	C	12	9	21	0	0	21	0	0
20	18722312	.	A	C	5	9	14	0	2	16	0	0
20	18722565	.	A	T	10	8	18	0	3	21	0	0
20	18722630	.	C	T	0	4	4	0	3	7	0	0
20	18722857	.	G	A	4	6	10	0	1	11	0	0
20	18722860	.	A	T	6	3	9	0	0	9	0	0
20	18723062	.	C	T	4	6	10	0	0	10	0	0
20	18723105	.	C	T	8	8	16	0	1	17	0	0
20	18723239	.	G	T	7	3	10	0	0	10	0	0
20	18723441	.	G	A	1	6	7	0	0	7	0	0
20	18723459	.	T	C	4	6	10	0	1	11	0	0
20	18723781	.	T	G	4	8	12	0	0	12	0	0
20	18727472	.	T	C	1	1	2	0	0	2	0	0
20	18730840	.	T	C	4	5	9	0	1	10	0	0
20	18755824	.	A	C	1	4	5	0	1	6	0	0
20	18776270	.	C	T	2	3	5	0	0	5	0	0
20	18915249	.	C	T	3	3	6	0	1	7	0	0
20	18947331	.	G	A	0	1	1	0	2	3	0	0
20	18955563	.	A	T	1	0	1	0	0	1	0	0
20	18956729	.	C	T	1	2	3	0	0	3	0	0
20	18958106	.	C	G	3	2	5	0	1	6	0	0
20	18958159	.	T	C	3	1	4	0	0	4	0	0
20	18968826	.	C	T	3	6	9	0	2	11	0	0
20	18972850	.	T	A	3	3	6	0	0	6	0	0
20	18983543	.	T	G	10	17	27	0	3	30	0	0
20	18983567	.	T	C	14	19	33	0	1	34	0	0
20	18983625	.	G	A	14	14	28	0	2	30	0	0
20	18983755	.	T	C	5	12	17	0	0	17	0	0
20	18983767	.	T	C	6	10	16	0	0	16	0	0
20	18992711	.	G	A	1	2	3	0	0	3	0	0
20	18992763	.	T	C	1	2	3	0	0	3	0	0
20	18996331	.	C	T	2	0	2	0	0	2	0	0
20	18996832	.	T	C	4	7	11	0	0	11	0	0
20	18997305	.	A	G	16	11	27	0	0	27	0	0
20	18997853	.	G	C	15	8	23	0	1	24	0	0
20	18997875	.	A	G	11	5	16	0	1	17	0	0
20	19077156	.	T	C	4	4	8	0	2	10	0	0
20	19077628	.	A	G	5	9	14	0	2	16	0	0
20	19078159	.	T	G	1	2	3	0	1	4	0	0
20	19213235	.	G	A	7	3	10	0	3	13	0	0
20	19238509	.	A	T	2	2	4	0	0	4	0	0
20	19258639	.	T	C	3	3	6	0	0	6	0	0
20	19277115	.	G	A	5	4	9	0	0	9	0	0
20	19277403	.	C	T	5	3	8	0	0	8	0	0
20	19277409	.	T	C	5	3	8	0	0	8	0	0
20	19277551	.	C	T	0	2	2	0	1	3	0	0
20	19277893	.	C	T	1	4	5	0	1	6	0	0
20	19278011	.	T	A	0	5	5	0	0	5	0	0
20	19278132	.	C	T	6	6	12	0	0	12	0	0
20	19290958	.	T	C	1	0	1	0	0	1	0	0
20	19373510	.	A	T	6	7	13	0	0	13	0	0
20	19373511	.	G	T	6	6	12	0	1	13	0	0
20	19373616	.	T	C	5	9	14	0	1	15	0	0
20	19373647	.	C	T	13	13	26	0	1	27	0	0
20	19373653	.	T	A	13	14	27	0	0	27	0	0
20	19374043	.	A	C	5	0	5	0	8	13	0	0
20	19374714	.	G	A	2	7	9	0	0	9	0	0
20	19374728	.	G	A	1	6	7	0	1	8	0	0
20	19374755	.	A	G	3	5	8	0	1	9	0	0
20	19391641	.	A	G	2	4	6	0	0	6	0	0
20	19391704	.	A	G	2	2	4	0	0	4	0	0
20	19401018	.	T	C	2	1	3	0	0	3	0	0
20	19406475	.	A	G	1	5	6	0	0	6	0	0
20	19406542	.	C	T	0	2	2	0	1	3	0	0
20	19406620	.	A	G	2	3	5	0	0	5	0	0
20	19406643	.	C	T	0	6	6	0	2	8	0	0
20	19415260	.	G	A	3	2	5	0	0	5	0	0
20	19429846	.	C	T	0	2	2	0	0	2	0	0
20	19429879	.	T	C	1	1	2	0	0	2	0	0
20	19430092	.	T	C	1	1	2	0	1	3	0	0
20	19430782	.	G	A	8	6	14	0	3	17	0	0
20	19430790	.	C	T	9	8	17	0	2	19	0	0
20	19431012	.	T	C	8	8	16	0	0	16	0	0
20	19431360	.	C	G	2	3	5	0	0	5	0	0
20	19431477	.	T	A	5	7	12	0	2	14	0	0
20	19431631	.	G	C	4	7	11	0	0	11	0	0
20	19432007	.	G	T	3	4	7	0	2	9	0	0
20	19432150	.	T	A	10	5	15	0	0	15	0	0
20	19432213	.	A	G	6	7	13	0	0	13	0	0
20	19436389	.	G	C	5	7	12	0	1	13	0	0
20	19436577	.	C	G	7	8	15	0	0	15	0	0
20	19436705	.	T	G	3	3	6	0	2	8	0	0
20	19436890	.	T	C	5	0	5	0	0	5	0	0
20	19436899	.	C	A	4	3	7	0	0	7	0	0
20	19437206	.	A	G	1	2	3	0	0	3	0	0
20	19438082	.	T	C	4	0	4	0	5	9	0	0
20	19438193	.	T	A	0	4	4	0	1	5	0	0
20	19442994	.	G	A	1	3	4	0	0	4	0	0
20	19513054	.	G	A	2	3	5	0	1	6	0	0
20	19513093	.	G	A	5	6	11	0	1	12	0	0
20	19513289	.	A	T	1	0	1	0	0	1	0	0
20	19515966	.	G	T	4	4	8	0	0	8	0	0
20	19516068	.	C	T	6	5	11	0	0	11	0	0
20	19516206	.	T	A	3	9	12	0	0	12	0	0
20	19516246	.	G	T	4	5	9	0	0	9	0	0
20	19516274	.	C	A	5	4	9	0	1	10	0	0
20	19516286	.	T	C	4	2	6	0	2	8	0	0
20	19516315	.	G	C	2	4	6	0	1	7	0	0
20	19516360	.	A	G	3	0	3	0	4	7	0	0
20	19516392	.	T	C	3	2	5	0	0	5	0	0
20	19516537	.	T	C	6	5	11	0	3	14	0	0
20	19516713	.	C	A	3	5	8	0	1	9	0	0
20	19516746	.	A	G	5	7	12	0	0	12	0	0
20	19516772	.	T	C	6	5	11	0	0	11	0	0
20	19516803	.	T	C	8	4	12	0	0	12	0	0
20	19516837	.	G	A	8	6	14	0	3	17	0	0
20	19516850	.	T	C	10	8	18	0	3	21	0	0
20	19517027	.	C	G	8	14	22	0	3	25	0	0
20	19518685	.	A	G	3	6	9	0	0	9	0	0
20	19521387	.	G	A	1	0	1	0	0	1	0	0
20	19521657	.	C	T	1	2	3	0	0	3	0	0
20	19524966	.	A	G	4	4	8	0	0	8	0	0
20	19524978	.	G	A	4	5	9	0	0	9	0	0
20	19562736	.	G	T	4	3	7	0	0	7	0	0
20	19562848	.	C	G	0	1	1	0	0	1	0	0
20	19573889	.	C	A	1	0	1	0	0	1	0	0
20	19575264	.	G	A	2	5	7	0	2	9	0	0
20	19575271	.	A	G	2	6	8	0	1	9	0	0
20	19579897	.	G	A	3	2	5	0	0	5	0	0
20	19579940	.	G	A	2	3	5	0	1	6	0	0
20	19580158	.	T	G	6	3	9	0	1	10	0	0
20	19580205	.	G	T	11	5	16	0	0	16	0	0
20	19580234	.	C	T	12	7	19	0	0	19	0	0
20	19580360	.	G	T	10	2	12	0	4	16	0	0
20	19580362	.	C	A	12	4	16	0	0	16	0	0
20	19580525	.	C	A	11	6	17	0	0	17	0	0
20	19580654	.	C	T	17	6	23	0	0	23	0	0
20	19582896	.	G	A	9	5	14	0	1	15	0	0
20	19582955	.	C	T	5	5	10	0	1	11	0	0
20	19588759	.	G	A	7	7	14	0	2	16	0	0
20	19590288	.	G	A	3	5	8	0	0	8	0	0
20	19821817	.	T	C	2	2	4	0	0	4	0	0
20	19823825	.	A	G	1	1	2	0	2	4	0	0
20	20231857	.	C	T	11	8	19	0	1	20	0	0
20	20231919	.	A	G	10	12	22	0	3	25	0	0
20	20231995	.	G	C	12	18	30	0	3	33	0	0
20	20232347	.	A	T	16	7	23	0	1	24	0	0
20	20275095	.	A	T	4	6	10	0	1	11	0	0
20	20275244	.	G	T	10	11	21	0	0	21	0	0
20	20275306	.	C	T	6	13	19	0	2	21	0	0
20	20275322	.	T	A	7	11	18	0	1	19	0	0
20	20275439	.	G	A	14	14	28	0	3	31	0	0
20	20275609	.	T	A	6	14	20	0	2	22	0	0
20	20275661	.	C	T	0	12	12	0	10	22	0	0
20	20275766	.	T	G	7	13	20	0	3	23	0	0
20	20275776	.	T	C	6	0	6	0	16	22	0	0
20	20276607	.	T	G	4	9	13	0	0	13	0	0
20	20276654	.	T	C	4	7	11	0	0	11	0	0
20	20277162	.	T	C	6	4	10	0	1	11	0	0
20	20277183	.	T	C	5	5	10	0	0	10	0	0
20	20277337	.	A	T	1	2	3	0	0	3	0	0
20	20277370	.	T	C	3	8	11	0	0	11	0	0
20	20277460	.	G	C	2	4	6	0	1	7	0	0
20	20277481	.	A	T	2	4	6	0	0	6	0	0
20	20277525	.	T	C	2	0	2	0	6	8	0	0
20	20277530	.	A	T	2	5	7	0	1	8	0	0
20	20277597	.	C	G	5	3	8	0	0	8	0	0
20	20277603	.	A	G	5	3	8	0	0	8	0	0
20	20277674	.	T	G	1	1	2	0	1	3	0	0
20	20277675	.	G	A	1	1	2	0	1	3	0	0
20	20278213	.	G	A	4	6	10	0	1	11	0	0
20	20278442	.	G	C	2	4	6	0	0	6	0	0
20	20278907	.	C	A	1	2	3	0	0	3	0	0
20	20279196	.	A	G	1	3	4	0	0	4	0	0
20	20326945	.	A	T	6	2	8	0	2	10	0	0
20	20328055	.	A	G	9	24	33	0	6	39	0	0
20	20328137	.	G	A	23	22	45	0	7	52	0	0
20	20330256	.	T	C	7	4	11	0	0	11	0	0
20	20331235	.	T	A	13	15	28	0	1	29	0	0
20	20331740	.	A	G	10	7	17	0	1	18	0	0
20	20332079	.	G	A	12	11	23	0	0	23	0	0
20	20334705	.	G	A	4	3	7	0	1	8	0	0
20	20335543	.	A	G	1	0	1	0	0	1	0	0
20	20335739	.	G	C	3	3	6	0	1	7	0	0
20	20335784	.	A	T	0	2	2	0	1	3	0	0
20	20337215	.	G	A	2	8	10	0	0	10	0	0
20	20337263	.	A	C	0	3	3	0	1	4	0	0
20	20601233	.	C	G	12	13	25	0	2	27	0	0
20	20601651	.	T	G	13	14	27	0	2	29	0	0
20	20601883	.	A	T	17	11	28	0	2	30	0	0
20	20601884	.	A	C	18	11	29	0	1	30	0	0
20	20601985	.	T	C	17	11	28	0	0	29	1	0
20	20602097	.	A	T	8	9	17	0	2	19	0	0
20	20602232	.	T	C	9	6	15	0	0	15	0	0
20	20602290	.	G	T	5	7	12	0	0	13	1	0
20	20602370	.	A	T	5	3	8	0	0	8	0	0
20	20603131	.	T	A	4	6	10	0	0	10	0	0
20	20604015	.	T	G	1	2	3	0	0	3	0	0
20	20605107	.	T	C	3	2	5	0	0	5	0	0
20	20605136	.	T	C	4	4	8	0	1	9	0	0
20	20609663	.	G	A	3	5	8	0	0	8	0	0
20	20655339	.	A	T	4	2	6	0	0	6	0	0
20	20658851	.	G	T	4	4	8	0	0	8	0	0
20	20658954	.	C	T	11	10	21	0	1	22	0	0
20	20659009	.	T	C	6	9	15	0	2	17	0	0
20	20659067	.	G	A	10	5	15	0	1	16	0	0
20	20659188	.	C	G	7	11	18	0	1	19	0	0
20	20659305	.	T	C	10	5	15	0	0	15	0	0
20	20659306	.	C	T	10	5	15	0	0	15	0	0
20	20672289	.	T	C	19	24	43	0	2	45	0	0
20	20672335	.	C	T	8	14	22	0	3	25	0	0
20	20694918	.	A	T	27	30	57	0	4	61	0	0
20	20694999	.	C	T	14	19	33	0	3	36	0	0
20	20695642	.	G	T	2	25	27	0	36	63	0	0
20	20695779	.	T	A	28	30	58	0	1	60	1	0
20	20695829	.	A	T	21	28	49	0	2	51	0	0
20	20695856	.	A	T	20	22	42	0	2	44	0	0
20	20716211	.	A	G	2	0	2	0	2	4	0	0
20	20722032	.	T	C	0	2	2	0	0	2	0	0
20	20722071	.	A	G	2	2	4	0	1	5	0	0
20	20726287	.	G	T	7	2	9	0	1	10	0	0
20	20726291	.	G	A	0	1	1	0	8	9	0	0
20	20726966	.	T	C	23	22	45	0	0	45	0	0
20	20726993	.	C	A	17	11	28	0	2	30	0	0
20	20730008	.	C	G	29	17	46	0	3	49	0	0
20	20730061	.	C	G	26	22	48	0	4	52	0	0
20	20730141	.	A	T	17	17	34	0	0	34	0	0
20	20730151	.	G	A	14	19	33	0	0	33	0	0
20	20730182	.	T	A	6	11	17	0	1	18	0	0
20	20795927	.	G	A	0	3	3	0	1	4	0	0
20	20802754	.	C	A	2	1	3	0	1	4	0	0
20	20805438	.	T	C	8	6	14	0	2	16	0	0
20	20805643	.	G	C	0	1	1	0	9	10	0	0
20	20807987	.	C	T	6	3	9	0	0	9	0	0
20	20808038	.	G	T	5	4	9	0	0	9	0	0
20	20809666	.	T	C	1	3	4	0	0	4	0	0
20	20812728	.	T	C	15	11	26	0	0	26	0	0
20	20812852	.	C	A	12	12	24	0	0	24	0	0
20	20812876	.	C	T	11	11	22	0	0	22	0	0
20	20812898	.	T	C	11	3	14	0	2	16	0	0
20	20813014	.	G	A	16	9	25	0	1	26	0	0
20	20813162	.	T	C	12	16	28	0	2	30	0	0
20	20813197	.	A	C	16	20	36	0	1	37	0	0
20	20813367	.	A	C	10	4	14	0	3	17	0	0
20	20813414	.	T	C	6	13	19	0	4	23	0	0
20	20813439	.	A	G	6	17	23	0	2	25	0	0
20	20813458	.	T	C	6	17	23	0	0	23	0	0
20	20813568	.	A	C	12	13	25	0	1	26	0	0
20	20813570	.	G	A	12	14	26	0	0	26	0	0
20	20813624	.	G	A	10	9	19	0	2	21	0	0
20	20813685	.	A	T	8	8	16	0	2	18	0	0
20	20813748	.	G	A	1	2	3	0	1	4	0	0
20	20816875	.	G	A	32	35	67	0	8	75	0	0
20	20817011	.	G	A	31	30	61	0	9	70	0	0
20	20817921	.	A	G	8	4	12	0	7	19	0	0
20	20818523	.	A	G	26	26	52	0	3	55	0	0
20	20928239	.	C	G	0	14	14	0	29	43	0	0
20	20928272	.	C	T	27	14	41	0	5	46	0	0
20	20930149	.	G	A	10	5	15	0	1	16	0	0
20	20931142	.	C	G	2	5	7	0	0	7	0	0
20	20980554	.	C	A	1	0	1	0	1	2	0	0
20	20980716	.	C	T	4	3	7	0	0	7	0	0
20	21015747	.	A	C	2	5	7	0	1	8	0	0
20	21016521	.	T	A	2	3	5	0	0	5	0	0
20	21017901	.	T	A	3	2	5	0	0	5	0	0
20	21269081	.	T	C	0	1	1	0	0	1	0	0
20	21467733	.	G	T	1	3	4	0	0	4	0	0
20	21469759	.	G	C	0	1	1	0	0	1	0	0
20	21473644	.	A	G	8	3	11	0	0	11	0	0
20	21473674	.	C	T	7	7	14	0	0	14	0	0
20	21473681	.	T	C	7	6	13	0	0	13	0	0
20	21474271	.	A	G	3	3	6	0	1	7	0	0
20	21474700	.	A	G	6	3	9	0	1	10	0	0
20	21474715	.	A	C	2	4	6	0	0	6	0	0
20	21474877	.	A	T	6	2	8	0	0	8	0	0
20	21475432	.	A	T	5	10	15	0	0	15	0	0
20	21638400	.	G	A	3	2	5	0	0	5	0	0
20	21638431	.	C	A	1	3	4	0	0	4	0	0
20	21638707	.	C	T	2	3	5	0	0	5	0	0
20	21815659	.	G	T	7	10	17	0	2	19	0	0
20	21815986	.	C	T	0	12	12	0	11	23	0	0
20	21816061	.	C	G	12	18	30	0	0	30	0	0
20	21819062	.	T	C	10	16	26	0	0	26	0	0
20	21839504	.	G	A	3	2	5	0	1	6	0	0
20	21841312	.	G	A	0	1	1	0	0	1	0	0
20	21841316	.	G	T	0	1	1	0	0	1	0	0
20	21855195	.	T	C	4	3	7	0	2	9	0	0
20	21862963	.	C	T	0	3	3	0	6	9	0	0
20	21862975	.	C	T	0	2	2	0	7	9	0	0
20	21875111	.	G	A	0	1	1	0	0	1	0	0
20	21875411	.	C	A	0	1	1	0	0	1	0	0
20	21910005	.	C	T	0	1	1	0	4	5	0	0
20	23378401	.	G	A	1	1	2	0	0	2	0	0
20	23378899	.	G	A	0	3	3	0	1	4	0	0
20	23395404	.	C	T	2	0	2	0	1	3	0	0
20	23406545	.	T	A	8	7	15	0	0	15	0	0
20	23408734	.	T	C	3	6	9	0	0	9	0	0
20	23418228	.	G	A	6	7	13	0	3	16	0	0
20	23418291	.	C	G	14	6	20	0	2	22	0	0
20	23420784	.	A	T	7	24	31	0	6	37	0	0
20	23421442	.	T	C	8	13	21	0	1	22	0	0
20	23421695	.	T	C	16	27	43	0	1	44	0	0
20	23422061	.	T	C	21	19	40	0	2	42	0	0
20	23422205	.	A	T	7	8	15	0	1	16	0	0
20	23431658	.	T	A	1	2	3	0	0	3	0	0
20	23446854	.	C	T	7	9	16	0	3	19	0	0
20	23446868	.	T	A	7	10	17	0	2	19	0	0
20	23447564	.	C	G	11	4	15	0	1	16	0	0
20	23447873	.	C	G	4	3	7	0	0	7	0	0
20	23471742	.	G	A	1	4	5	0	0	5	0	0
20	23471985	.	G	A	1	2	3	0	0	3	0	0
20	23472239	.	C	T	0	3	3	0	2	5	0	0
20	23472259	.	G	T	3	5	8	0	0	8	0	0
20	23475653	.	G	C	4	9	13	0	2	15	0	0
20	23647541	.	C	T	4	2	6	0	0	6	0	0
20	23647669	.	C	T	4	2	6	0	1	7	0	0
20	23647869	.	T	A	2	2	4	0	1	5	0	0
20	23648235	.	T	A	3	3	6	0	0	6	0	0
20	23648724	.	T	C	6	4	10	0	0	10	0	0
20	23651156	.	C	A	3	3	6	0	0	6	0	0
20	23651254	.	G	A	3	3	6	0	0	6	0	0
20	23651294	.	C	T	4	4	8	0	0	8	0	0
20	23651350	.	C	T	4	3	7	0	0	7	0	0
20	23655767	.	C	T	0	1	1	0	0	1	0	0
20	23656226	.	T	A	4	5	9	0	0	9	0	0
20	23656454	.	A	G	3	2	5	0	0	5	0	0
20	23664970	.	G	A	0	2	2	0	1	3	0	0
20	23665041	.	G	A	0	3	3	0	4	7	0	0
20	23665185	.	A	T	2	3	5	0	0	5	0	0
20	23665793	.	G	T	0	12	12	0	4	16	0	0
20	23665863	.	G	A	0	9	9	0	8	17	0	0
20	23666055	.	T	A	3	4	7	0	0	7	0	0
20	23666135	.	G	A	3	2	5	0	0	5	0	0
20	23666137	.	G	T	2	3	5	0	0	5	0	0
20	23666346	.	C	T	2	2	4	0	0	4	0	0
20	23685529	.	T	A	1	1	2	0	0	2	0	0
20	23689902	.	T	C	0	1	1	0	0	1	0	0
20	23689996	.	G	A	3	3	6	0	0	6	0	0
20	23690051	.	A	T	1	2	3	0	0	3	0	0
20	23691015	.	G	A	0	5	5	0	0	5	0	0
20	23691911	.	T	C	2	1	3	0	0	3	0	0
20	23691917	.	C	T	2	1	3	0	0	3	0	0
20	23692094	.	T	C	5	4	9	0	0	9	0	0
20	23694299	.	G	T	0	1	1	0	4	5	0	0
20	23705719	.	G	A	5	1	6	0	1	7	0	0
20	23705974	.	G	A	4	2	6	0	0	6	0	0
20	23713122	.	G	A	0	5	5	0	7	12	0	0
20	23713266	.	G	A	0	4	4	0	3	7	0	0
20	23713475	.	T	A	5	2	7	0	3	10	0	0
20	23713497	.	G	T	5	4	9	0	1	10	0	0
20	23713512	.	A	T	6	4	10	0	0	10	0	0
20	23713535	.	A	G	3	1	4	0	1	5	0	0
20	23713824	.	A	G	4	7	11	0	0	11	0	0
20	23713858	.	T	G	4	0	4	0	7	11	0	0
20	23713883	.	A	G	5	0	5	0	8	13	0	0
20	23828102	.	G	T	2	2	4	0	1	5	0	0
20	23829170	.	C	T	0	2	2	0	0	2	0	0
20	23832884	.	G	C	3	1	4	0	1	5	0	0
20	23835228	.	C	T	3	1	4	0	0	4	0	0
20	23835354	.	C	T	7	5	12	0	0	12	0	0
20	23835367	.	A	C	4	7	11	0	1	12	0	0
20	23835472	.	C	T	5	9	14	0	0	14	0	0
20	23835591	.	G	T	2	4	6	0	0	6	0	0
20	23836106	.	A	T	3	3	6	0	0	6	0	0
20	23836161	.	C	T	2	4	6	0	1	8	1	0
20	23836310	.	A	T	4	3	7	0	0	7	0	0
20	23836685	.	A	T	6	4	10	0	1	11	0	0
20	23836688	.	C	A	4	6	10	0	1	11	0	0
20	23836756	.	G	A	0	3	3	0	8	11	0	0
20	23836880	.	C	T	5	5	10	0	2	12	0	0
20	23856274	.	T	A	5	2	7	0	0	7	0	0
20	23856345	.	A	T	10	5	15	0	0	15	0	0
20	23857214	.	G	C	12	17	29	0	1	30	0	0
20	23857407	.	C	A	3	4	7	0	0	7	0	0
20	23857592	.	C	T	0	3	3	0	0	3	0	0
20	23859383	.	G	C	6	4	10	0	0	10	0	0
20	23859386	.	A	G	6	3	9	0	1	10	0	0
20	23859425	.	G	A	0	6	6	0	16	22	0	0
20	23859486	.	G	A	0	4	4	0	9	13	0	0
20	23877623	.	G	A	3	1	4	0	2	6	0	0
20	23879673	.	C	T	1	1	2	0	0	2	0	0
20	23882437	.	C	T	3	4	7	0	1	8	0	0
20	23883008	.	T	C	3	2	5	0	0	5	0	0
20	23883351	.	T	A	5	4	9	0	0	9	0	0
20	23883599	.	T	C	0	2	2	0	0	2	0	0
20	23884479	.	T	C	0	0	0	0	1	1	0	0
20	23885485	.	T	A	5	3	8	0	1	9	0	0
20	23885505	.	C	T	0	4	4	0	1	5	0	0
20	23885925	.	G	A	1	1	2	0	0	2	0	0
20	23886277	.	A	G	1	3	4	0	0	4	0	0
20	23886358	.	A	G	1	3	4	0	0	4	0	0
20	23888878	.	C	G	0	3	3	0	1	4	0	0
20	23889403	.	T	G	3	1	4	0	2	6	0	0
20	23890478	.	C	T	1	3	4	0	0	4	0	0
20	23890489	.	C	T	1	3	4	0	0	4	0	0
20	23951630	.	C	T	2	3	5	0	0	5	0	0
20	23952169	.	A	G	1	2	3	0	0	3	0	0
20	23954847	.	G	A	0	2	2	0	1	3	0	0
20	23955171	.	G	T	2	3	5	0	0	5	0	0
20	23955237	.	C	G	0	4	4	0	0	4	0	0
20	23955384	.	A	T	4	3	7	0	0	7	0	0
20	23973433	.	T	C	1	4	5	0	0	5	0	0
20	23974834	.	T	C	1	3	4	0	0	4	0	0
20	23974953	.	T	G	1	1	2	0	1	3	0	0
20	24151599	.	C	T	1	3	4	0	5	9	0	0
20	24152098	.	G	A	1	4	5	0	0	5	0	0
20	24152821	.	G	A	6	9	15	0	2	17	0	0
20	24152822	.	G	A	9	7	16	0	1	17	0	0
20	24175892	.	A	G	1	3	4	0	0	4	0	0
20	24818922	.	T	C	17	14	31	0	3	34	0	0
20	24819091	.	A	G	5	8	13	0	3	16	0	0
20	24819152	.	C	G	4	4	8	0	4	12	0	0
20	24819184	.	G	A	0	3	3	0	3	6	0	0
20	24819376	.	G	A	3	3	6	0	0	6	0	0
20	24819403	.	T	A	1	4	5	0	0	5	0	0
20	24819582	.	C	T	0	7	7	0	10	17	0	0
20	24820032	.	T	C	1	4	5	0	0	5	0	0
20	24820353	.	A	T	4	2	6	0	0	6	0	0
20	24820405	.	G	A	3	4	7	0	0	7	0	0
20	24820963	.	T	A	10	2	12	0	2	14	0	0
20	24821072	.	A	G	3	7	10	0	0	10	0	0
20	24821499	.	T	G	5	1	6	0	3	9	0	0
20	24835754	.	C	T	0	4	4	0	5	9	0	0
20	24849372	.	G	A	2	0	2	0	0	2	0	0
20	24849453	.	C	T	0	1	1	0	1	2	0	0
20	24852707	.	C	T	0	2	2	0	3	5	0	0
20	25271815	.	C	T	0	1	1	0	0	1	0	0
20	25342837	.	G	A	0	6	6	0	9	15	0	0
20	25352527	.	C	T	1	1	2	0	0	2	0	0
20	25368785	.	A	G	2	3	5	0	0	5	0	0
20	25371869	.	A	G	3	1	4	0	0	4	0	0
20	25384473	.	A	T	1	1	2	0	0	2	0	0
20	25387865	.	A	G	1	3	4	0	0	4	0	0
20	25440628	.	T	G	3	9	12	0	1	13	0	0
20	25440648	.	C	G	3	12	15	0	0	15	0	0
20	25440668	.	T	C	7	13	20	0	0	20	0	0
20	25440724	.	G	T	9	8	17	0	0	17	0	0
20	25440731	.	G	A	9	9	18	0	0	18	0	0
20	25440790	.	A	C	19	9	28	0	1	29	0	0
20	25441033	.	G	T	12	18	30	0	2	32	0	0
20	25443159	.	T	A	5	2	7	0	0	7	0	0
20	25444903	.	G	A	0	2	2	0	0	2	0	0
20	25557127	.	C	T	1	1	2	0	0	2	0	0
20	25618240	.	G	A	7	6	13	0	0	13	0	0
20	25618330	.	G	A	2	6	8	0	0	8	0	0
20	25618601	.	T	A	5	3	8	0	0	8	0	0
20	25618908	.	G	A	2	4	6	0	0	6	0	0
20	25619965	.	G	A	4	0	4	0	0	4	0	0
20	25623770	.	A	T	2	0	2	0	0	2	0	0
20	25623778	.	A	T	0	2	2	0	0	2	0	0
20	25623921	.	C	T	0	1	1	0	0	1	0	0
20	25628390	.	C	T	0	0	0	0	1	1	0	0
20	25660441	.	A	G	16	17	33	0	1	34	0	0
20	25661199	.	A	G	15	12	27	0	2	29	0	0
20	25661396	.	G	A	10	14	24	0	1	25	0	0
20	25661403	.	T	G	13	9	22	0	1	23	0	0
20	25661509	.	G	A	11	15	26	0	2	28	0	0
20	25665325	.	T	G	8	3	11	0	0	11	0	0
20	25666402	.	A	T	15	10	25	0	0	25	0	0
20	25666524	.	T	C	9	5	14	0	0	14	0	0
20	25669512	.	T	C	0	0	0	0	2	2	0	0
20	25709311	.	C	T	0	2	2	0	2	4	0	0
20	25726388	.	T	C	2	2	4	0	0	4	0	0
20	25729819	.	G	T	1	3	4	0	0	4	0	0
20	25735011	.	G	A	0	2	2	0	4	6	0	0
20	25853191	.	T	C	1	3	4	0	0	4	0	0
20	25906480	.	A	T	2	2	4	0	0	4	0	0
20	25909276	.	T	C	0	1	1	0	0	1	0	0
20	25909661	.	C	A	10	7	17	0	2	19	0	0
20	25910099	.	C	T	7	3	10	0	0	10	0	0
20	25910368	.	A	T	6	2	8	0	0	8	0	0
20	25921009	.	C	T	5	3	8	0	0	8	0	0
20	25926688	.	C	A	2	4	6	0	0	6	0	0
20	25927310	.	A	G	14	8	22	0	0	22	0	0
20	26023822	.	T	C	0	7	7	0	0	7	0	0
20	26324196	.	T	G	0	2	2	0	0	2	0	0
20	26324307	.	T	A	3	5	8	0	0	8	0	0
20	26325380	.	A	G	0	3	3	0	1	4	0	0
20	26325481	.	T	A	3	2	5	0	0	5	0	0
20	26325493	.	T	C	2	1	3	0	0	3	0	0
20	26329035	.	G	A	1	1	2	0	0	2	0	0
20	26331683	.	C	T	8	12	20	0	1	21	0	0
20	26334414	.	A	G	11	10	21	0	1	22	0	0
20	26334446	.	C	T	9	7	16	0	2	18	0	0
20	26337790	.	C	A	12	8	20	0	1	21	0	0
20	26342889	.	C	T	5	6	11	0	0	11	0	0
20	26345230	.	C	T	15	15	30	0	2	32	0	0
20	26345856	.	T	A	18	7	25	0	1	26	0	0
20	26346710	.	C	T	11	26	37	0	4	41	0	0
20	26353770	.	A	G	11	17	28	0	5	33	0	0
20	26358743	.	G	A	16	23	39	0	3	42	0	0
20	26358964	.	G	A	23	26	49	0	4	53	0	0
20	26360070	.	C	T	0	3	3	0	1	4	0	0
20	26360125	.	T	G	2	3	5	0	5	10	0	0
20	26360225	.	A	G	5	0	5	0	1	6	0	0
20	26360235	.	A	G	4	0	4	0	0	4	0	0
20	26360333	.	A	G	0	1	1	0	0	1	0	0
20	26360470	.	A	G	2	6	8	0	2	10	0	0
20	26387181	.	G	A	6	5	11	0	1	12	0	0
20	26387288	.	T	A	6	12	18	0	0	18	0	0
20	26404753	.	C	A	4	5	9	0	2	11	0	0
20	26405683	.	T	C	3	2	5	0	0	5	0	0
20	26406160	.	G	A	0	2	2	0	5	7	0	0
20	26406252	.	T	C	3	2	5	0	0	5	0	0
20	26406806	.	C	T	6	2	8	0	0	8	0	0
20	26407091	.	T	C	3	4	7	0	0	7	0	0
20	26409194	.	T	A	7	4	11	0	2	13	0	0
20	26409261	.	C	A	0	8	8	0	13	21	0	0
20	26409295	.	C	A	11	5	16	0	2	19	1	0
20	26409310	.	A	T	13	4	17	0	0	17	0	0
20	26409372	.	T	G	2	4	6	0	1	7	0	0
20	26409471	.	C	T	0	12	12	0	8	20	0	0
20	26409723	.	C	T	7	11	18	0	1	19	0	0
20	26409922	.	T	C	6	12	18	0	1	19	0	0
20	26409991	.	G	A	15	12	27	0	1	28	0	0
20	26410224	.	G	T	8	10	18	0	3	22	1	0
20	26410275	.	G	A	4	11	15	0	1	16	0	0
20	26410341	.	A	G	9	7	16	0	1	17	0	0
20	26410344	.	A	C	9	9	18	0	1	19	0	0
20	26412372	.	T	A	9	10	19	0	0	19	0	0
20	26412479	.	C	T	6	5	11	0	0	11	0	0
20	26412501	.	G	A	6	3	9	0	1	10	0	0
20	26412579	.	C	A	8	6	14	0	1	15	0	0
20	26412876	.	G	A	10	12	22	0	1	23	0	0
20	26412968	.	T	A	11	11	22	0	1	23	0	0
20	26413038	.	C	T	8	8	16	0	0	16	0	0
20	26413057	.	G	A	7	7	14	0	2	16	0	0
20	26413269	.	C	A	3	4	7	0	1	8	0	0
20	26413311	.	C	T	4	6	10	0	1	11	0	0
20	26413470	.	G	T	1	3	4	0	2	6	0	0
20	26413640	.	C	A	2	3	5	0	0	5	0	0
20	26414724	.	C	T	0	5	5	0	4	9	0	0
20	26414747	.	C	T	4	3	7	0	0	7	0	0
20	26414919	.	A	G	4	3	7	0	0	7	0	0
20	26415021	.	G	T	0	2	2	0	0	2	0	0
20	26587834	.	A	G	2	4	6	0	0	6	0	0
20	26599709	.	C	T	3	1	4	0	0	4	0	0
20	26601222	.	G	A	1	2	3	0	0	3	0	0
20	26610433	.	G	A	1	2	3	0	0	3	0	0
20	26775892	.	G	A	5	4	9	0	0	9	0	0
20	26809059	.	A	G	0	0	0	0	2	2	0	0
20	26822389	.	A	G	1	6	7	0	0	7	0	0
20	26822449	.	A	G	2	6	8	0	0	8	0	0
20	26893304	.	A	G	1	2	3	0	0	3	0	0
20	26893311	.	C	T	0	2	2	0	1	3	0	0
20	26907893	.	C	T	0	1	1	0	0	1	0	0
20	26913236	.	G	T	2	4	6	0	0	6	0	0
20	26915472	.	T	C	2	4	6	0	0	6	0	0
20	26921031	.	C	T	1	2	3	0	0	3	0	0
20	26944106	.	G	A	10	12	22	0	2	24	0	0
20	26944311	.	G	A	16	10	26	0	7	33	0	0
20	26944576	.	C	T	12	9	21	0	2	23	0	0
20	26944762	.	C	T	10	12	22	0	2	24	0	0
20	26944951	.	C	T	5	7	12	0	0	12	0	0
20	26945394	.	C	T	17	10	27	0	0	27	0	0
20	26945735	.	C	T	12	8	20	0	0	20	0	0
20	26945793	.	T	A	11	8	19	0	0	19	0	0
20	26945950	.	T	A	10	10	20	0	0	20	0	0
20	26948161	.	A	G	1	3	4	0	0	4	0	0
20	26958685	.	A	G	1	3	4	0	0	4	0	0
20	26959431	.	A	T	3	2	5	0	0	5	0	0
20	26959605	.	T	C	1	5	6	0	0	6	0	0
20	26959624	.	C	T	1	4	5	0	0	5	0	0
20	26959829	.	C	T	3	4	7	0	0	7	0	0
20	26960039	.	T	G	4	7	11	0	0	11	0	0
20	26960430	.	C	T	2	2	4	0	1	5	0	0
20	26961149	.	A	G	9	6	15	0	1	16	0	0
20	26961469	.	A	G	6	7	13	0	1	14	0	0
20	26961758	.	A	T	6	7	13	0	1	14	0	0
20	26961862	.	T	C	12	8	20	0	0	20	0	0
20	26962095	.	T	C	8	6	14	0	1	15	0	0
20	26962119	.	T	C	6	11	17	0	0	17	0	0
20	26962290	.	G	T	14	9	23	0	2	25	0	0
20	26962318	.	G	A	0	10	10	0	10	20	0	0
20	26999506	.	T	A	0	2	2	0	0	2	0	0
20	27001816	.	A	C	11	6	17	0	2	19	0	0
20	27002595	.	T	G	6	6	12	0	1	13	0	0
20	27002769	.	T	A	7	5	12	0	1	13	0	0
20	27002989	.	G	A	4	12	16	0	1	17	0	0
20	27020294	.	T	A	11	16	27	0	1	28	0	0
20	27020346	.	A	C	11	7	18	0	2	20	0	0
20	27020442	.	G	T	4	4	8	0	0	8	0	0
20	27029685	.	A	C	0	2	2	0	0	2	0	0
20	27033700	.	C	T	3	1	4	0	1	5	0	0
20	27033847	.	A	T	12	36	48	0	0	48	0	0
20	27033914	.	A	G	17	17	34	0	6	40	0	0
20	27039339	.	A	C	36	24	60	0	1	61	0	0
20	27039364	.	G	T	2	32	34	0	26	60	0	0
20	27039498	.	C	T	21	32	53	0	4	57	0	0
20	27039523	.	C	T	30	19	49	0	3	52	0	0
20	27045501	.	G	A	18	18	36	0	1	37	0	0
20	27045649	.	T	G	38	6	44	0	28	72	0	0
20	27045858	.	T	A	9	5	14	0	1	15	0	0
20	27045875	.	T	C	6	10	16	0	0	16	0	0
20	27087600	.	T	A	2	6	8	0	0	8	0	0
20	27089281	.	C	T	5	3	8	0	2	10	0	0
20	27089674	.	A	G	2	6	8	0	0	8	0	0
20	27089717	.	C	T	4	4	8	0	0	8	0	0
20	27089954	.	G	A	2	4	6	0	0	6	0	0
20	27089995	.	C	T	2	2	4	0	0	4	0	0
20	27090120	.	C	T	5	2	7	0	0	7	0	0
20	27090134	.	G	T	2	4	6	0	0	6	0	0
20	27090401	.	C	T	7	5	12	0	0	12	0	0
20	27090409	.	C	T	5	9	14	0	0	14	0	0
20	27090525	.	T	G	4	3	7	0	0	7	0	0
20	27091157	.	C	T	4	3	7	0	0	7	0	0
20	27091179	.	T	A	6	7	13	0	1	14	0	0
20	27091206	.	G	A	10	7	17	0	2	19	0	0
20	27092231	.	C	T	12	14	26	0	1	27	0	0
20	27093159	.	T	G	3	2	5	0	0	5	0	0
20	27093219	.	T	C	2	3	5	0	0	5	0	0
20	27093286	.	C	T	3	2	5	0	0	5	0	0
20	27093335	.	G	A	2	6	8	0	0	8	0	0
20	27094693	.	T	C	2	2	4	0	0	4	0	0
20	27096092	.	A	T	1	0	1	0	0	1	0	0
20	27100011	.	A	T	9	6	15	0	1	16	0	0
20	27107089	.	C	T	8	7	15	0	1	16	0	0
20	27107140	.	C	A	7	13	20	0	3	23	0	0
20	27107241	.	C	A	11	6	17	0	1	18	0	0
20	27107572	.	C	G	5	3	8	0	3	11	0	0
20	27194918	.	T	C	3	2	5	0	0	5	0	0
20	27198172	.	A	G	2	2	4	0	0	4	0	0
20	27240885	.	C	T	0	2	2	0	0	2	0	0
20	27280808	.	G	A	2	4	6	0	0	6	0	0
20	27280840	.	G	A	0	4	4	0	4	8	0	0
20	27280877	.	C	A	5	3	8	0	2	10	0	0
20	27281295	.	T	A	1	2	3	0	0	3	0	0
20	27281624	.	T	C	6	4	10	0	2	12	0	0
20	27281780	.	T	G	2	1	3	0	1	4	0	0
20	27281789	.	C	T	2	2	4	0	0	4	0	0
20	27282592	.	A	G	6	6	12	0	1	13	0	0
20	27283604	.	G	A	8	4	12	0	0	12	0	0
20	27321860	.	C	G	0	1	1	0	0	1	0	0
20	27331149	.	G	A	2	3	5	0	0	5	0	0
20	27353040	.	T	C	0	1	1	0	0	1	0	0
20	27353265	.	C	T	2	0	2	0	0	2	0	0
20	27358777	.	C	A	5	1	6	0	0	6	0	0
20	27358859	.	G	A	3	1	4	0	0	4	0	0
20	27542005	.	G	A	0	2	2	0	1	3	0	0
20	27542371	.	G	A	0	2	2	0	2	4	0	0
20	27545984	.	G	A	1	1	2	0	0	2	0	0
20	27546032	.	C	T	1	1	2	0	1	3	0	0
20	27550148	.	C	T	4	4	8	0	0	8	0	0
20	27550150	.	A	C	4	4	8	0	0	8	0	0
20	27550526	.	G	A	1	2	3	0	0	3	0	0
20	27550866	.	G	A	2	4	6	0	0	6	0	0
20	27550915	.	T	A	4	4	8	0	0	8	0	0
20	27551123	.	G	T	3	3	6	0	0	6	0	0
20	27551363	.	G	A	2	5	7	0	0	7	0	0
20	27551492	.	C	G	4	2	6	0	1	7	0	0
20	27551563	.	T	C	2	3	5	0	0	5	0	0
20	27707974	.	G	A	3	2	5	0	0	5	0	0
20	27708016	.	G	A	2	2	4	0	0	4	0	0
20	27708181	.	C	T	2	3	5	0	1	6	0	0
20	27716086	.	G	A	0	2	2	0	0	2	0	0
20	27716093	.	C	T	0	2	2	0	0	2	0	0
20	27716227	.	T	C	0	3	3	0	0	3	0	0
20	27717055	.	T	A	3	2	5	0	0	5	0	0
20	27717945	.	C	T	1	2	3	0	0	3	0	0
20	27718549	.	T	A	3	4	7	0	0	7	0	0
20	27718578	.	A	T	3	2	5	0	0	5	0	0
20	27719063	.	A	G	10	3	13	0	0	13	0	0
20	27719088	.	A	G	4	7	11	0	1	12	0	0
20	27719099	.	A	G	4	7	11	0	1	12	0	0
20	27719763	.	G	A	8	5	13	0	2	15	0	0
20	27719859	.	T	C	7	4	11	0	0	11	0	0
20	27732832	.	A	G	3	9	12	0	0	12	0	0
20	27733034	.	G	A	3	6	9	0	1	10	0	0
20	27733650	.	C	A	0	2	2	0	1	3	0	0
20	28316845	.	G	T	1	2	3	0	0	3	0	0
20	28354549	.	T	A	5	6	11	0	0	11	0	0
20	28354588	.	A	G	8	6	14	0	2	16	0	0
20	28354951	.	A	G	6	4	10	0	0	10	0	0
20	28356989	.	T	C	6	4	10	0	0	10	0	0
20	28356998	.	G	A	3	4	7	0	2	9	0	0
20	28357028	.	A	G	8	7	15	0	0	15	0	0
20	28357184	.	A	G	8	3	11	0	0	11	0	0
20	28357190	.	C	T	7	3	10	0	1	11	0	0
20	28357570	.	A	G	2	3	5	0	0	5	0	0
20	28357610	.	A	G	3	8	11	0	0	11	0	0
20	28357688	.	T	C	4	4	8	0	0	8	0	0
20	28357718	.	T	C	3	4	7	0	0	7	0	0
20	28357733	.	G	A	2	2	4	0	1	5	0	0
20	28399987	.	C	A	0	3	3	0	3	6	0	0
20	28400232	.	A	T	3	2	5	0	1	6	0	0
20	28400422	.	C	T	1	2	3	0	0	3	0	0
20	28400455	.	A	C	6	6	12	0	0	12	0	0
20	28400481	.	A	G	8	6	14	0	1	15	0	0
20	28400619	.	G	A	13	18	31	0	0	31	0	0
20	28401147	.	A	G	5	5	10	0	3	13	0	0
20	28401587	.	G	A	2	2	4	0	0	4	0	0
20	28402426	.	G	A	1	2	3	0	0	3	0	0
20	28402456	.	A	G	1	4	5	0	0	5	0	0
20	28404270	.	T	G	3	3	6	0	0	6	0	0
20	28408028	.	C	T	1	3	4	0	0	4	0	0
20	28418587	.	C	T	6	4	10	0	1	11	0	0
20	28418730	.	A	T	2	5	7	0	1	8	0	0
20	28418939	.	T	C	5	3	8	0	2	10	0	0
20	28419015	.	A	T	6	4	10	0	1	11	0	0
20	28419133	.	A	T	4	2	6	0	0	6	0	0
20	28419767	.	C	A	1	3	4	0	1	5	0	0
20	28419807	.	T	A	4	3	7	0	0	7	0	0
20	28420438	.	C	G	12	5	17	0	2	19	0	0
20	28420496	.	C	T	6	9	15	0	1	16	0	0
20	28422920	.	A	G	5	2	7	0	0	7	0	0
20	28422927	.	T	C	4	0	4	0	2	6	0	0
20	28423035	.	G	T	4	6	10	0	1	11	0	0
20	28423062	.	G	A	5	5	10	0	0	10	0	0
20	28423072	.	A	T	6	7	13	0	0	13	0	0
20	28456574	.	T	C	2	2	4	0	0	4	0	0
20	28469982	.	A	G	4	5	9	0	1	10	0	0
20	28476107	.	T	C	1	0	1	0	0	1	0	0
20	28487287	.	T	C	2	1	3	0	1	4	0	0
20	28514878	.	T	C	7	3	10	0	2	12	0	0
20	28650323	.	T	C	10	16	26	0	1	27	0	0
20	28650328	.	A	C	11	16	27	0	1	29	1	0
20	28650945	.	A	T	20	11	31	0	2	33	0	0
20	28650946	.	T	G	19	12	31	0	2	33	0	0
20	28651194	.	C	T	13	17	30	0	2	32	0	0
20	28651239	.	A	G	14	12	26	0	4	30	0	0
20	28651454	.	G	A	27	19	46	0	1	47	0	0
20	28651958	.	T	G	4	7	11	0	0	11	0	0
20	28652449	.	G	C	12	13	25	0	3	28	0	0
20	28654339	.	G	A	3	0	3	0	0	3	0	0
20	28658666	.	A	C	3	5	8	0	2	10	0	0
20	28658693	.	T	C	3	0	3	0	4	7	0	0
20	28659924	.	A	G	2	3	5	0	0	5	0	0
20	28659969	.	G	T	1	2	3	0	0	3	0	0
20	28660050	.	G	A	2	1	3	0	0	3	0	0
20	28660795	.	G	A	4	2	6	0	0	6	0	0
20	28677911	.	G	T	0	1	1	0	0	1	0	0
20	28783046	.	T	C	15	11	26	0	1	27	0	0
20	28783327	.	T	C	4	7	11	0	1	12	0	0
20	28783502	.	C	G	6	3	9	0	1	10	0	0
20	28783607	.	T	C	9	1	10	0	8	18	0	0
20	28783627	.	T	C	9	8	17	0	0	17	0	0
20	28783688	.	C	A	11	11	22	0	1	23	0	0
20	28784045	.	G	T	9	5	14	0	0	14	0	0
20	28800961	.	A	G	8	6	14	0	0	14	0	0
20	28804089	.	G	A	5	12	17	0	0	17	0	0
20	28814902	.	T	C	2	0	2	0	1	3	0	0
20	28817492	.	A	G	0	2	2	0	0	2	0	0
20	28822696	.	T	A	3	8	11	0	1	12	0	0
20	28822735	.	T	C	2	2	4	0	0	4	0	0
20	28823116	.	T	C	4	0	4	0	0	4	0	0
20	28825375	.	C	T	8	12	20	0	1	21	0	0
20	28827208	.	A	G	1	0	1	0	0	1	0	0
20	28827350	.	T	C	6	12	18	0	0	18	0	0
20	28827388	.	C	A	12	12	24	0	0	24	0	0
20	28827416	.	C	T	13	9	22	0	1	23	0	0
20	28827433	.	A	C	8	10	18	0	3	21	0	0
20	28827633	.	T	C	8	5	13	0	0	13	0	0
20	28833245	.	C	T	14	30	44	0	1	45	0	0
20	28833312	.	C	A	19	20	39	0	4	43	0	0
20	28833793	.	A	G	17	22	39	0	3	42	0	0
20	28834008	.	C	T	12	27	39	0	8	47	0	0
20	28834536	.	C	A	3	4	7	0	0	7	0	0
20	28834571	.	G	A	5	2	7	0	0	7	0	0
20	28834684	.	T	C	1	7	8	0	0	8	0	0
20	28870806	.	C	G	19	31	50	0	6	56	0	0
20	28870843	.	T	C	32	24	56	0	1	57	0	0
20	28871830	.	G	A	28	30	58	0	9	67	0	0
20	28875824	.	T	C	6	0	6	0	17	23	0	0
20	28876885	.	G	A	2	14	16	0	2	18	0	0
20	28876899	.	A	G	2	10	12	0	2	14	0	0
20	28876942	.	T	A	5	4	9	0	0	9	0	0
20	28876971	.	A	C	2	0	2	0	7	9	0	0
20	28876996	.	T	A	5	7	12	0	0	12	0	0
20	28877028	.	C	T	9	9	18	0	0	18	0	0
20	28877085	.	T	A	4	4	8	0	1	9	0	0
20	28877696	.	T	C	8	0	8	0	14	22	0	0
20	28878097	.	T	G	5	5	10	0	0	10	0	0
20	28884768	.	T	A	1	0	1	0	0	1	0	0
20	28886159	.	A	T	15	9	24	0	0	24	0	0
20	28886311	.	T	C	17	14	31	0	2	33	0	0
20	28886530	.	C	T	7	7	14	0	2	16	0	0
20	28886608	.	C	A	5	6	11	0	1	12	0	0
20	28886618	.	C	A	6	2	8	0	0	8	0	0
20	28886735	.	T	C	11	10	21	0	3	24	0	0
20	28886771	.	A	C	8	11	19	0	2	21	0	0
20	28886991	.	T	A	4	2	6	0	0	6	0	0
20	28887233	.	A	C	1	5	6	0	0	6	0	0
20	28887303	.	A	G	7	7	14	0	0	14	0	0
20	28887498	.	T	A	12	10	22	0	0	22	0	0
20	28887590	.	G	C	10	12	22	0	0	22	0	0
20	28888012	.	C	A	8	3	11	0	0	11	0	0
20	28888041	.	A	T	7	3	10	0	2	12	0	0
20	28888331	.	T	A	5	12	17	0	0	17	0	0
20	28888743	.	T	A	5	2	7	0	1	9	1	0
20	28888856	.	A	G	5	3	8	0	1	9	0	0
20	28889248	.	G	T	5	5	10	0	1	11	0	0
20	28889306	.	A	G	5	3	8	0	0	8	0	0
20	28973655	.	A	C	2	4	6	0	0	6	0	0
20	28973834	.	T	C	6	6	12	0	3	15	0	0
20	29268179	.	A	G	6	3	9	0	0	9	0	0
20	29268260	.	A	G	3	2	5	0	0	5	0	0
20	29471486	.	T	A	1	2	3	0	0	3	0	0
20	30879286	.	C	A	1	2	3	0	1	4	0	0
20	30879298	.	T	C	1	2	3	0	1	4	0	0
20	30889723	.	A	G	3	2	5	0	0	5	0	0
20	30889754	.	T	G	1	3	4	0	0	4	0	0
20	30889792	.	T	A	1	2	3	0	0	3	0	0
20	30894408	.	C	T	3	1	4	0	0	4	0	0
20	30894427	.	C	T	4	5	9	0	1	10	0	0
20	30894496	.	G	T	2	1	3	0	0	3	0	0
20	30894510	.	T	A	2	2	4	0	0	4	0	0
20	30894630	.	A	T	2	5	7	0	0	7	0	0
20	30895007	.	A	G	2	5	7	0	0	7	0	0
20	30895013	.	A	G	2	4	6	0	0	6	0	0
20	30895070	.	A	G	4	4	8	0	1	9	0	0
20	30895091	.	G	A	4	5	9	0	0	9	0	0
20	30899353	.	A	G	3	5	8	0	0	8	0	0
20	30922687	.	G	A	12	5	17	0	2	19	0	0
20	30922688	.	A	T	13	5	18	0	0	19	1	0
20	30922808	.	T	A	8	4	12	0	2	14	0	0
20	30922836	.	C	A	15	3	18	0	1	20	1	0
20	30923101	.	T	C	5	4	9	0	1	10	0	0
20	30925253	.	T	C	1	0	1	0	2	3	0	0
20	30926205	.	T	C	2	1	3	0	0	3	0	0
20	30931021	.	A	T	0	1	1	0	0	1	0	0
20	30939177	.	T	C	9	10	19	0	4	23	0	0
20	30940566	.	C	G	6	2	8	0	1	9	0	0
20	30947353	.	T	C	24	22	46	0	5	51	0	0
20	30947433	.	T	C	13	13	26	0	3	29	0	0
20	31147609	.	G	A	2	2	4	0	0	4	0	0
20	31172725	.	A	C	1	1	2	0	0	2	0	0
20	31187975	.	G	A	9	8	17	0	0	17	0	0
20	31192304	.	A	C	4	1	5	0	1	6	0	0
20	31192720	.	C	T	5	5	10	0	2	12	0	0
20	31193762	.	G	A	0	3	3	0	1	4	0	0
20	31193826	.	C	T	13	5	18	0	0	18	0	0
20	31197217	.	G	T	6	7	13	0	2	15	0	0
20	31197307	.	G	A	0	4	4	0	9	13	0	0
20	31197465	.	T	C	12	7	19	0	0	19	0	0
20	31199655	.	G	A	0	1	1	0	0	1	0	0
20	31202316	.	C	T	2	2	4	0	0	4	0	0
20	31204173	.	T	C	12	7	19	0	1	20	0	0
20	31204191	.	A	C	12	8	20	0	0	20	0	0
20	31206649	.	A	G	1	4	5	0	0	5	0	0
20	31211701	.	T	A	19	13	32	0	2	34	0	0
20	31211710	.	A	G	19	12	31	0	3	34	0	0
20	31211812	.	G	A	0	10	10	0	9	19	0	0
20	31211846	.	G	A	0	6	6	0	12	18	0	0
20	31212156	.	G	A	0	15	15	0	19	34	0	0
20	31212390	.	G	C	17	8	25	0	1	26	0	0
20	31223336	.	C	T	4	1	5	0	0	5	0	0
20	31225875	.	C	T	2	2	4	0	0	4	0	0
20	31233463	.	T	G	4	2	6	0	0	6	0	0
20	31233566	.	T	G	2	3	5	0	1	6	0	0
20	31238061	.	A	G	2	5	7	0	0	7	0	0
20	31429181	.	C	T	4	3	7	0	0	7	0	0
20	31429648	.	C	T	14	9	23	0	1	24	0	0
20	31429824	.	G	A	4	6	10	0	2	12	0	0
20	31430039	.	G	C	5	3	8	0	0	8	0	0
20	31430204	.	C	A	6	4	10	0	1	11	0	0
20	31430279	.	A	G	8	4	12	0	0	12	0	0
20	31430769	.	C	T	0	8	8	0	5	13	0	0
20	31430922	.	T	A	6	2	8	1	0	9	0	0
20	31431106	.	A	T	2	3	5	0	0	5	0	0
20	31431160	.	A	T	9	9	18	0	1	19	0	0
20	31431375	.	T	C	5	3	8	0	0	8	0	0
20	31431457	.	T	A	5	2	7	0	1	8	0	0
20	31431739	.	A	G	7	2	9	0	2	11	0	0
20	31431962	.	A	G	3	8	11	0	1	12	0	0
20	31436304	.	C	T	6	2	8	0	0	8	0	0
20	31436450	.	G	A	4	2	6	0	1	7	0	0
20	31436483	.	C	T	4	8	12	0	0	12	0	0
20	31436819	.	C	A	1	4	5	0	0	5	0	0
20	31441076	.	G	A	0	2	2	0	0	2	0	0
20	31449416	.	T	C	1	2	3	0	0	3	0	0
20	31746604	.	C	T	8	11	19	0	0	19	0	0
20	31746611	.	A	T	7	7	14	0	1	15	0	0
20	31747116	.	A	T	9	13	22	0	1	23	0	0
20	31747673	.	C	A	0	12	12	0	14	26	0	0
20	31747695	.	G	C	13	10	23	0	2	25	0	0
20	31747792	.	C	T	0	6	6	0	18	24	0	0
20	31747860	.	C	T	0	5	5	0	10	15	0	0
20	31748178	.	T	C	12	12	24	0	1	25	0	0
20	31748183	.	C	T	11	10	21	0	2	23	0	0
20	31748363	.	A	G	6	6	12	0	1	13	0	0
20	31748448	.	A	G	10	15	25	0	1	26	0	0
20	31748518	.	C	T	8	10	18	0	0	18	0	0
20	31748845	.	A	T	6	7	13	0	1	14	0	0
20	31771899	.	G	A	0	0	0	0	1	1	0	0
20	31777192	.	C	T	0	2	2	0	1	3	0	0
20	32047457	.	T	C	11	10	21	0	1	22	0	0
20	32047741	.	A	C	12	26	38	0	0	38	0	0
20	32061596	.	G	A	1	3	4	0	0	4	0	0
20	32061611	.	C	A	0	2	2	0	1	3	0	0
20	32065517	.	G	A	3	3	6	0	0	6	0	0
20	32110331	.	G	A	3	3	6	0	0	6	0	0
20	32118621	.	G	A	0	2	2	0	0	2	0	0
20	32135962	.	T	C	9	7	16	0	1	17	0	0
20	32136451	.	T	G	6	8	14	0	2	16	0	0
20	32136588	.	G	T	2	3	5	0	1	6	0	0
20	32136953	.	C	T	6	4	10	0	0	10	0	0
20	32137365	.	T	A	2	4	6	0	0	6	0	0
20	32137423	.	G	A	2	5	7	0	0	7	0	0
20	32137529	.	A	T	4	4	8	0	1	9	0	0
20	32137638	.	A	G	3	4	7	0	1	8	0	0
20	32137752	.	G	T	7	8	15	0	1	16	0	0
20	32137984	.	A	T	11	7	18	0	0	18	0	0
20	32138029	.	T	A	12	4	16	0	0	16	0	0
20	32138111	.	C	T	8	15	23	0	0	23	0	0
20	32138171	.	T	C	14	12	26	0	1	27	0	0
20	32138478	.	A	G	11	18	29	0	1	30	0	0
20	32144872	.	T	G	1	4	5	0	0	5	0	0
20	32224452	.	A	G	1	0	1	0	5	6	0	0
20	32224485	.	C	A	1	2	3	0	2	6	1	0
20	32228863	.	G	A	12	14	26	0	0	26	0	0
20	32228872	.	A	G	13	8	21	0	1	22	0	0
20	32228936	.	A	C	5	10	15	0	1	16	0	0
20	32229004	.	G	A	12	20	32	0	0	32	0	0
20	32229047	.	G	A	20	10	30	0	1	31	0	0
20	32229053	.	C	T	8	19	27	0	1	28	0	0
20	32229095	.	T	C	10	6	16	0	2	18	0	0
20	32229214	.	G	T	10	10	20	0	1	21	0	0
20	32229825	.	G	T	9	20	29	0	4	33	0	0
20	32230017	.	A	C	15	22	37	0	3	40	0	0
20	32230362	.	C	A	4	5	9	0	0	9	0	0
20	32230470	.	T	C	9	9	18	0	0	18	0	0
20	32230472	.	A	C	9	9	18	0	0	18	0	0
20	32230518	.	C	A	13	9	22	0	1	23	0	0
20	32230521	.	G	A	1	7	8	0	15	23	0	0
20	32230555	.	C	A	13	11	24	0	1	25	0	0
20	32230620	.	C	T	11	16	27	0	2	29	0	0
20	32230836	.	T	C	12	10	22	0	1	23	0	0
20	32286800	.	C	T	0	3	3	0	8	11	0	0
20	32286875	.	C	T	13	13	26	0	2	28	0	0
20	32286877	.	A	C	13	15	28	0	0	28	0	0
20	32286960	.	A	C	9	9	18	0	1	19	0	0
20	32287317	.	C	T	5	5	10	0	0	10	0	0
20	32287349	.	C	G	4	8	12	0	0	12	0	0
20	32287736	.	T	C	12	6	18	0	0	18	0	0
20	32290435	.	A	G	7	6	13	0	0	13	0	0
20	32290679	.	G	A	6	3	9	0	0	9	0	0
20	32291287	.	G	A	0	1	1	0	0	1	0	0
20	32403587	.	C	T	0	4	4	0	2	6	0	0
20	32406066	.	T	C	2	3	5	0	2	7	0	0
20	32432156	.	T	C	17	13	30	0	0	30	0	0
20	32432315	.	G	T	9	8	17	0	0	17	0	0
20	32432532	.	C	T	8	13	21	0	5	26	0	0
20	32437598	.	T	A	1	2	3	0	0	3	0	0
20	32484600	.	C	T	2	2	4	0	1	5	0	0
20	32487507	.	T	C	1	3	4	0	0	4	0	0
20	32489618	.	G	A	0	2	2	0	7	9	0	0
20	32490047	.	A	T	1	3	4	0	1	5	0	0
20	32490403	.	C	T	7	6	13	0	1	14	0	0
20	32490480	.	C	T	5	4	9	0	1	10	0	0
20	32490783	.	C	G	3	4	7	0	0	7	0	0
20	32498335	.	C	T	3	2	5	0	0	5	0	0
20	32498635	.	C	A	3	6	9	0	0	9	0	0
20	32498639	.	C	A	3	6	9	0	0	9	0	0
20	32498771	.	C	G	1	2	3	0	0	3	0	0
20	32498869	.	A	G	4	6	10	0	2	12	0	0
20	32499166	.	G	A	0	6	6	0	8	14	0	0
20	32513235	.	G	A	3	4	7	0	0	7	0	0
20	32513256	.	G	A	1	2	3	0	1	4	0	0
20	32515968	.	C	T	1	1	2	0	0	2	0	0
20	32518298	.	T	C	1	2	3	0	0	3	0	0
20	32518306	.	G	A	1	2	3	0	0	3	0	0
20	32520852	.	A	G	2	9	11	0	0	11	0	0
20	32520853	.	A	T	9	2	11	0	0	11	0	0
20	32521203	.	C	T	10	10	20	0	0	20	0	0
20	32521220	.	T	C	12	8	20	0	0	20	0	0
20	32521377	.	C	T	7	5	12	0	0	12	0	0
20	32521686	.	A	C	14	19	33	0	0	33	0	0
20	32521719	.	A	C	15	14	29	0	3	32	0	0
20	32574157	.	T	C	3	2	5	0	0	5	0	0
20	32574190	.	G	A	5	1	6	0	0	6	0	0
20	32756790	.	G	A	0	3	3	0	4	7	0	0
20	32758490	.	A	G	13	6	19	0	2	21	0	0
20	32758558	.	T	C	11	8	19	0	3	22	0	0
20	32863650	.	A	G	5	3	8	0	0	8	0	0
20	32863657	.	A	G	4	2	6	0	1	7	0	0
20	32872075	.	C	A	0	2	2	0	0	2	0	0
20	32939176	.	T	C	1	1	2	0	0	2	0	0
20	32963111	.	A	G	1	2	3	0	0	3	0	0
20	32963132	.	T	A	1	2	3	0	0	3	0	0
20	33177904	.	C	T	0	1	1	0	0	1	0	0
20	33180295	.	G	A	2	2	4	0	1	5	0	0
20	33180547	.	C	T	4	2	6	0	0	6	0	0
20	33189386	.	G	A	0	3	3	0	2	5	0	0
20	33189631	.	G	A	5	4	9	0	0	9	0	0
20	33298184	.	C	T	6	5	11	0	0	11	0	0
20	33467794	.	A	T	6	10	16	0	4	20	0	0
20	33468040	.	T	G	20	17	37	0	3	40	0	0
20	33484083	.	G	A	1	2	3	0	0	3	0	0
20	33484387	.	T	C	2	4	6	0	1	7	0	0
20	33486846	.	G	A	1	3	4	0	0	4	0	0
20	33494411	.	G	T	17	19	36	0	2	38	0	0
20	33758874	.	C	T	4	2	6	0	0	6	0	0
20	33759151	.	G	C	3	0	3	0	13	16	0	0
20	33773493	.	G	A	1	4	5	0	0	5	0	0
20	33789927	.	C	T	0	2	2	0	1	3	0	0
20	33789965	.	G	T	2	1	3	0	1	4	0	0
20	33809476	.	T	C	3	2	5	0	1	6	0	0
20	33809707	.	A	G	16	7	23	0	0	23	0	0
20	33809971	.	C	A	9	0	9	0	1	10	0	0
20	33810921	.	T	C	9	0	9	0	8	17	0	0
20	33811519	.	G	T	7	9	16	0	1	17	0	0
20	33839868	.	A	G	1	1	2	0	0	2	0	0
20	33859788	.	A	T	1	2	3	0	0	3	0	0
20	33860113	.	G	A	2	2	4	0	0	4	0	0
20	33862741	.	G	A	0	1	1	0	0	1	0	0
20	33969910	.	G	A	1	2	3	0	0	3	0	0
20	33984086	.	G	C	2	0	2	0	0	2	0	0
20	34007128	.	G	A	1	1	2	0	0	2	0	0
20	34007589	.	G	C	1	2	3	0	0	3	0	0
20	34007607	.	G	A	2	1	3	0	0	3	0	0
20	34009952	.	C	A	5	9	14	0	0	14	0	0
20	34012649	.	T	A	5	6	11	0	0	11	0	0
20	34012828	.	T	A	5	8	13	0	3	16	0	0
20	34012916	.	A	T	8	10	18	0	0	18	0	0
20	34013073	.	T	G	4	4	8	0	0	8	0	0
20	34015654	.	C	T	0	6	6	0	10	16	0	0
20	34015907	.	G	A	8	9	17	0	4	21	0	0
20	34015921	.	T	A	9	12	21	0	0	21	0	0
20	34018852	.	C	A	2	0	2	0	1	3	0	0
20	34023551	.	T	C	0	1	1	0	0	1	0	0
20	34039408	.	A	C	6	4	10	0	0	10	0	0
20	34040132	.	C	A	10	8	18	0	0	18	0	0
20	34044813	.	G	A	3	6	9	0	0	9	0	0
20	34044845	.	A	T	1	1	2	0	0	2	0	0
20	34049141	.	G	A	2	3	5	0	0	5	0	0
20	34051237	.	C	T	1	2	3	0	0	3	0	0
20	34051417	.	G	A	2	2	4	0	0	4	0	0
20	34054401	.	C	T	1	3	4	0	0	4	0	0
20	34056206	.	C	G	3	2	5	0	1	6	0	0
20	34056227	.	C	T	2	2	4	0	0	4	0	0
20	34057323	.	C	A	3	3	6	0	0	6	0	0
20	34063986	.	T	A	1	3	4	0	0	4	0	0
20	34065620	.	G	A	2	1	3	0	0	3	0	0
20	34122068	.	T	C	1	2	3	0	0	3	0	0
20	34122272	.	G	A	1	2	3	0	0	3	0	0
20	34151818	.	C	A	6	5	11	0	1	12	0	0
20	34151873	.	C	T	5	4	9	0	0	9	0	0
20	34154122	.	C	T	3	1	4	0	0	4	0	0
20	34154618	.	C	A	11	2	13	0	3	16	0	0
20	34154831	.	G	A	2	5	7	0	2	9	0	0
20	34154982	.	G	T	13	8	21	0	1	22	0	0
20	34155025	.	C	T	9	11	20	0	1	21	0	0
20	34155192	.	T	C	11	11	22	0	1	23	0	0
20	34158354	.	T	A	1	3	4	0	0	4	0	0
20	34332683	.	C	A	15	15	30	0	0	30	0	0
20	34333733	.	T	C	6	5	11	0	0	11	0	0
20	34339473	.	G	A	7	5	12	0	2	14	0	0
20	34339516	.	C	T	12	27	39	0	2	41	0	0
20	34340055	.	T	C	24	17	41	0	1	42	0	0
20	34340678	.	A	T	15	23	38	0	1	39	0	0
20	34364991	.	C	T	1	0	1	0	0	1	0	0
20	34382518	.	C	T	0	2	2	0	1	3	0	0
20	34382539	.	C	T	1	2	3	0	0	3	0	0
20	34382559	.	A	T	1	2	3	0	0	3	0	0
20	34398646	.	G	A	1	2	3	0	0	3	0	0
20	34420788	.	G	A	23	27	50	0	1	51	0	0
20	34420860	.	A	G	21	17	38	0	0	38	0	0
20	34421307	.	A	G	11	9	20	0	0	20	0	0
20	34421485	.	C	T	10	14	24	0	3	27	0	0
20	34421758	.	G	A	14	10	24	0	2	26	0	0
20	34421801	.	G	C	9	1	10	0	11	21	0	0
20	34421804	.	G	A	10	9	19	0	1	20	0	0
20	34426660	.	T	G	3	3	6	0	2	8	0	0
20	34430100	.	T	G	4	5	9	0	0	9	0	0
20	34431467	.	G	C	1	1	2	0	0	2	0	0
20	34431661	.	A	G	6	2	8	0	0	8	0	0
20	34445005	.	A	G	0	1	1	0	0	1	0	0
20	34446718	.	G	A	2	2	4	0	0	4	0	0
20	34446733	.	A	G	2	2	4	0	0	4	0	0
20	34507247	.	A	G	2	2	4	0	0	4	0	0
20	34537775	.	A	C	6	5	11	0	0	11	0	0
20	34597244	.	A	G	5	4	9	0	0	9	0	0
20	34597631	.	C	T	7	4	11	0	0	11	0	0
20	34597844	.	T	C	5	8	13	0	0	13	0	0
20	34598076	.	T	A	2	7	9	0	1	10	0	0
20	34598113	.	C	A	1	0	1	0	0	1	0	0
20	34601175	.	G	A	14	10	24	0	1	25	0	0
20	34601214	.	A	T	12	11	23	0	0	23	0	0
20	34602561	.	A	C	9	15	24	0	1	25	0	0
20	34602576	.	T	G	10	14	24	0	3	27	0	0
20	34603661	.	C	T	5	23	28	0	3	31	0	0
20	34603733	.	T	G	1	2	3	0	1	4	0	0
20	34604241	.	C	A	15	16	31	0	0	31	0	0
20	34604356	.	C	T	10	17	27	0	2	29	0	0
20	34604432	.	C	T	3	6	9	0	0	9	0	0
20	34607698	.	A	G	1	0	1	0	2	4	1	0
20	34607893	.	A	G	10	11	21	0	1	22	0	0
20	34607970	.	C	T	3	5	8	0	0	8	0	0
20	34608235	.	A	G	9	13	22	0	2	24	0	0
20	34608458	.	A	C	5	7	12	0	0	12	0	0
20	34608519	.	T	C	4	5	9	0	2	11	0	0
20	34611709	.	G	T	0	1	1	0	0	1	0	0
20	34617516	.	T	C	2	1	3	0	0	3	0	0
20	34617543	.	C	T	5	3	8	0	0	8	0	0
20	34617642	.	T	C	1	2	3	0	1	4	0	0
20	34627817	.	G	C	2	2	4	0	0	4	0	0
20	34630281	.	A	G	6	4	10	0	1	11	0	0
20	34632864	.	C	A	0	2	2	0	0	2	0	0
20	34632911	.	T	A	2	3	5	0	0	5	0	0
20	34634988	.	T	C	1	2	3	0	0	3	0	0
20	34636529	.	A	T	2	2	4	0	0	4	0	0
20	34636536	.	G	A	4	2	6	0	0	6	0	0
20	34638235	.	G	A	0	7	7	0	6	13	0	0
20	34638251	.	G	A	6	5	11	0	0	11	0	0
20	34642805	.	A	G	5	5	10	0	0	10	0	0
20	34642931	.	G	A	3	3	6	0	1	7	0	0
20	34643007	.	A	G	10	9	19	0	1	20	0	0
20	34643051	.	T	C	17	11	28	0	0	28	0	0
20	34643054	.	A	G	17	12	29	0	0	29	0	0
20	34643163	.	A	G	8	12	20	0	2	22	0	0
20	34643433	.	T	A	2	6	8	0	1	9	0	0
20	34643491	.	A	T	3	7	10	0	1	11	0	0
20	34643535	.	T	C	6	4	10	0	0	10	0	0
20	34643800	.	C	T	7	4	11	0	0	11	0	0
20	34661498	.	A	G	1	1	2	0	0	2	0	0
20	34661501	.	A	G	1	2	3	0	0	3	0	0
20	34727666	.	G	A	2	3	5	0	0	5	0	0
20	34733553	.	C	A	10	10	20	0	2	22	0	0
20	34733604	.	G	A	16	6	22	0	0	22	0	0
20	34733752	.	C	T	6	14	20	0	3	23	0	0
20	34737886	.	T	A	4	4	8	0	0	8	0	0
20	34738198	.	G	A	17	19	36	0	5	41	0	0
20	34738314	.	G	A	10	25	35	0	6	41	0	0
20	34738397	.	G	T	7	7	14	0	0	14	0	0
20	34738473	.	T	G	11	5	16	0	0	16	0	0
20	34738756	.	A	G	10	8	18	0	4	22	0	0
20	34742840	.	G	A	1	1	2	0	0	2	0	0
20	34745872	.	A	G	3	2	5	0	3	8	0	0
20	34746019	.	G	A	5	5	10	0	1	11	0	0
20	34747208	.	T	C	4	1	5	0	0	5	0	0
20	34749747	.	G	A	5	5	10	0	0	10	0	0
20	34794668	.	T	C	6	8	14	0	0	14	0	0
20	34794939	.	C	T	23	34	57	0	2	59	0	0
20	34795111	.	C	A	37	32	69	0	3	73	1	0
20	34795126	.	A	G	33	37	70	0	4	74	0	0
20	34795296	.	T	C	27	29	56	0	1	57	0	0
20	34795379	.	T	C	42	24	66	0	2	68	0	0
20	34795473	.	C	T	0	33	33	0	19	52	0	0
20	34795689	.	C	T	30	30	60	0	4	64	0	0
20	34797252	.	G	T	33	24	57	0	0	57	0	0
20	34797598	.	A	T	22	39	61	0	3	64	0	0
20	34955791	.	C	T	32	25	57	0	9	66	0	0
20	34956159	.	A	T	26	4	30	0	0	30	0	0
20	34956164	.	T	A	25	4	29	0	2	31	0	0
20	34967476	.	T	C	6	0	6	0	9	15	0	0
20	34969773	.	A	T	4	7	11	0	0	11	0	0
20	34975831	.	G	A	2	4	6	0	0	6	0	0
20	34980452	.	T	C	3	2	5	0	1	6	0	0
20	34982018	.	C	T	0	1	1	0	0	1	0	0
20	34982323	.	T	A	1	3	4	0	0	4	0	0
20	34985184	.	C	T	3	4	7	0	1	8	0	0
20	34985368	.	C	A	1	3	4	0	1	5	0	0
20	34985384	.	C	T	0	4	4	0	2	6	0	0
20	34985424	.	T	G	0	3	3	0	0	3	0	0
20	34985462	.	A	G	1	2	3	0	0	3	0	0
20	34985480	.	A	T	1	2	3	0	0	3	0	0
20	34985499	.	A	C	2	3	5	0	0	5	0	0
20	34991739	.	T	A	2	2	4	0	1	5	0	0
20	34991804	.	C	T	0	3	3	0	5	8	0	0
20	34993974	.	G	A	1	1	2	0	1	3	0	0
20	34994019	.	G	T	2	2	4	0	1	5	0	0
20	35011946	.	C	T	1	2	3	0	0	4	1	0
20	35018537	.	G	A	1	3	4	0	0	4	0	0
20	35059085	.	G	A	0	6	6	0	8	14	0	0
20	35064469	.	T	C	10	11	21	0	2	23	0	0
20	35064808	.	C	T	2	3	5	0	2	7	0	0
20	35065345	.	G	A	0	4	4	0	2	6	0	0
20	35065573	.	A	C	8	9	17	0	6	23	0	0
20	35066821	.	G	A	1	8	9	0	13	22	0	0
20	35066935	.	G	A	0	24	24	0	22	46	0	0
20	35068790	.	A	T	11	11	22	0	1	23	0	0
20	35069063	.	A	C	4	7	11	0	2	13	0	0
20	35069756	.	A	G	5	17	22	0	2	24	0	0
20	35069963	.	A	C	28	13	41	0	0	42	1	0
20	35070176	.	C	T	14	19	33	0	3	36	0	0
20	35070217	.	T	G	21	23	44	0	4	48	0	0
20	35195535	.	A	G	3	0	3	0	1	4	0	0
20	35204702	.	A	C	0	2	2	0	1	3	0	0
20	35204814	.	A	G	1	0	1	0	9	10	0	0
20	35204848	.	T	G	4	6	10	0	1	11	0	0
20	35204944	.	G	A	2	3	5	0	1	6	0	0
20	35205061	.	C	T	4	8	12	0	1	13	0	0
20	35205182	.	T	C	8	5	13	0	0	13	0	0
20	35205309	.	A	T	2	2	4	0	0	4	0	0
20	35205361	.	T	A	3	5	8	0	1	9	0	0
20	35205600	.	A	T	13	9	22	0	0	22	0	0
20	35205680	.	A	G	8	4	12	0	0	12	0	0
20	35206101	.	A	T	4	7	11	0	1	12	0	0
20	35208046	.	A	G	4	5	9	0	1	10	0	0
20	35209012	.	G	A	1	4	5	0	0	5	0	0
20	35209080	.	T	A	5	5	10	0	3	13	0	0
20	35209405	.	C	T	9	18	27	0	2	29	0	0
20	35209481	.	G	A	14	12	26	0	0	26	0	0
20	35210175	.	C	A	10	11	21	0	0	21	0	0
20	35210212	.	G	T	10	11	21	0	0	21	0	0
20	35210229	.	A	C	10	8	18	0	0	18	0	0
20	35210282	.	T	C	2	0	2	0	9	11	0	0
20	35210489	.	C	T	0	2	2	0	2	4	0	0
20	35210538	.	C	G	4	4	8	0	0	8	0	0
20	35210690	.	A	G	5	2	7	0	0	7	0	0
20	35211153	.	A	G	2	2	4	0	0	4	0	0
20	35211225	.	A	G	2	3	5	0	0	5	0	0
20	35211399	.	G	A	3	2	5	0	1	6	0	0
20	35211760	.	G	A	7	3	10	0	0	10	0	0
20	35215671	.	C	T	2	1	3	0	0	3	0	0
20	35215680	.	T	G	1	1	2	0	1	3	0	0
20	35296980	.	T	C	2	3	5	0	1	6	0	0
20	35297417	.	T	G	14	8	22	0	0	23	1	0
20	35297693	.	G	A	6	7	13	0	0	13	0	0
20	35297699	.	A	G	6	7	13	0	1	14	0	0
20	35297870	.	T	C	4	9	13	0	2	15	0	0
20	35392100	.	C	T	9	6	15	0	1	16	0	0
20	35427409	.	G	C	13	30	43	0	1	44	0	0
20	35427676	.	T	G	18	0	18	0	42	60	0	0
20	35427745	.	A	G	23	1	24	0	35	59	0	0
20	35427782	.	T	C	19	35	54	0	3	57	0	0
20	35427907	.	C	G	23	23	46	0	3	49	0	0
20	35427946	.	A	G	17	0	17	0	31	48	0	0
20	35428035	.	A	G	30	18	48	0	2	50	0	0
20	35428076	.	A	G	28	9	37	0	2	39	0	0
20	35428436	.	G	A	27	32	59	0	10	69	0	0
20	35428633	.	T	C	25	33	58	0	4	62	0	0
20	35428802	.	A	G	21	47	68	0	3	71	0	0
20	35428910	.	A	G	23	35	58	0	3	61	0	0
20	35429017	.	T	A	30	10	40	0	2	43	1	0
20	35429054	.	A	G	30	2	32	0	34	66	0	0
20	35429610	.	A	T	27	41	68	0	5	73	0	0
20	35497048	.	A	G	0	1	1	0	0	1	0	0
20	35798043	.	T	A	1	3	4	0	0	4	0	0
20	35798370	.	G	A	16	20	36	0	5	41	0	0
20	35798697	.	A	T	4	4	8	0	0	8	0	0
20	35798973	.	T	A	2	10	12	0	1	13	0	0
20	35799001	.	A	G	6	11	17	0	0	17	0	0
20	35799135	.	G	A	9	13	22	0	1	23	0	0
20	35799175	.	T	C	6	6	12	0	0	12	0	0
20	35799192	.	T	A	2	4	6	0	0	6	0	0
20	35799224	.	T	C	1	2	3	0	0	3	0	0
20	35799238	.	G	A	1	3	4	0	0	4	0	0
20	35799291	.	G	C	4	4	8	0	0	8	0	0
20	35799534	.	T	C	4	9	13	0	2	15	0	0
20	35799612	.	A	T	12	5	17	0	2	19	0	0
20	35799673	.	T	A	9	11	20	0	2	22	0	0
20	35799729	.	T	A	10	10	20	0	0	20	0	0
20	35799751	.	G	A	10	6	16	0	1	17	0	0
20	35799889	.	A	T	8	7	15	0	0	15	0	0
20	35799913	.	T	G	7	3	10	0	0	10	0	0
20	35800032	.	G	A	6	6	12	0	6	18	0	0
20	35800042	.	T	G	5	13	18	0	3	21	0	0
20	35800098	.	G	A	7	15	22	0	2	24	0	0
20	35800338	.	T	G	4	3	7	0	0	7	0	0
20	35800349	.	C	T	2	4	6	0	2	8	0	0
20	35800520	.	G	A	5	4	9	0	0	9	0	0
20	35800557	.	G	A	3	5	8	0	0	8	0	0
20	35800564	.	T	C	3	4	7	0	0	7	0	0
20	35800749	.	G	A	2	10	12	0	0	12	0	0
20	35816533	.	A	G	5	3	8	0	0	8	0	0
20	35816534	.	A	G	5	3	8	0	0	8	0	0
20	35831719	.	C	T	0	1	1	0	0	1	0	0
20	35979899	.	G	T	3	5	8	0	0	8	0	0
20	35979910	.	T	G	3	5	8	0	0	8	0	0
20	35979983	.	G	C	4	1	5	0	0	5	0	0
20	35980009	.	A	G	4	1	5	0	0	5	0	0
20	35980021	.	C	T	3	0	3	0	1	4	0	0
20	36233931	.	C	T	6	3	9	0	1	10	0	0
20	36290217	.	C	T	6	3	9	0	0	9	0	0
20	36297356	.	G	A	0	6	6	0	8	14	0	0
20	36297418	.	C	A	12	7	19	0	0	19	0	0
20	36297871	.	A	T	11	6	17	0	3	20	0	0
20	36380406	.	A	G	2	2	4	0	0	4	0	0
20	36395833	.	T	C	1	3	4	0	2	6	0	0
20	36396668	.	A	G	5	3	8	0	2	10	0	0
20	36420218	.	A	C	12	13	25	0	3	28	0	0
20	36420713	.	C	T	0	10	10	0	17	27	0	0
20	36420753	.	T	A	21	8	29	0	1	30	0	0
20	36420804	.	G	T	15	9	24	0	4	28	0	0
20	36421219	.	G	A	11	7	18	0	2	20	0	0
20	36421238	.	C	T	7	11	18	0	1	19	0	0
20	36421757	.	C	T	0	6	6	0	7	13	0	0
20	36422098	.	C	A	10	14	24	0	4	28	0	0
20	36422146	.	G	C	12	11	23	0	0	23	0	0
20	36422291	.	G	T	5	7	12	0	0	12	0	0
20	36434308	.	A	G	6	3	9	0	0	9	0	0
20	36439858	.	A	C	3	4	7	0	0	7	0	0
20	36449286	.	G	A	1	0	1	0	0	1	0	0
20	36449385	.	C	T	4	1	5	0	3	8	0	0
20	36449442	.	A	C	2	7	9	0	0	9	0	0
20	36449601	.	C	T	4	2	6	0	0	6	0	0
20	36559761	.	T	G	2	3	5	0	0	5	0	0
20	36623850	.	C	T	5	0	5	0	0	5	0	0
20	36623860	.	T	A	6	3	9	0	1	10	0	0
20	36626218	.	C	T	16	11	27	0	1	28	0	0
20	36626248	.	G	A	16	16	32	0	1	33	0	0
20	36626335	.	C	T	14	10	24	0	3	27	0	0
20	36626354	.	C	A	13	7	20	0	0	20	0	0
20	36626465	.	C	T	3	4	7	0	0	7	0	0
20	36637604	.	T	A	7	8	15	0	0	15	0	0
20	36637657	.	A	C	5	7	12	0	0	12	0	0
20	36637829	.	T	C	6	4	10	0	0	10	0	0
20	36637999	.	G	A	4	3	7	0	0	7	0	0
20	36638033	.	G	T	4	5	9	0	1	10	0	0
20	36638138	.	C	G	3	3	6	0	0	6	0	0
20	36638169	.	T	C	2	2	4	0	0	4	0	0
20	36675456	.	G	A	9	11	20	0	0	20	0	0
20	36675468	.	C	T	7	13	20	0	1	21	0	0
20	36677457	.	C	T	4	5	9	0	0	9	0	0
20	36677574	.	G	A	0	3	3	0	1	4	0	0
20	36785477	.	G	A	1	2	3	0	0	3	0	0
20	36791885	.	C	T	3	4	7	0	0	7	0	0
20	36792123	.	T	C	2	3	5	0	0	5	0	0
20	36798128	.	T	A	1	7	8	0	0	8	0	0
20	36798154	.	C	G	3	9	12	0	1	13	0	0
20	36817368	.	G	C	1	2	3	0	0	3	0	0
20	36828833	.	T	C	4	2	6	0	1	7	0	0
20	36828948	.	A	C	2	2	4	0	0	4	0	0
20	36829040	.	T	C	3	6	9	0	1	10	0	0
20	36829208	.	T	C	4	4	8	0	2	10	0	0
20	36838717	.	C	T	9	6	15	0	0	15	0	0
20	36838805	.	C	T	4	7	11	0	1	12	0	0
20	36838871	.	C	T	5	9	14	0	0	14	0	0
20	36838896	.	A	G	4	6	10	0	0	10	0	0
20	36915481	.	G	A	11	9	20	0	4	24	0	0
20	36915529	.	G	A	17	10	27	0	1	28	0	0
20	36916004	.	G	A	9	9	18	0	0	18	0	0
20	36916050	.	A	G	11	10	21	0	0	21	0	0
20	36917631	.	C	T	4	5	9	0	0	9	0	0
20	37263668	.	C	A	2	3	5	0	0	5	0	0
20	37300862	.	G	C	0	2	2	0	1	3	0	0
20	37358885	.	G	A	0	11	11	0	8	19	0	0
20	37376467	.	G	A	0	10	10	0	3	13	0	0
20	37512259	.	G	A	14	14	28	0	3	31	0	0
20	37512503	.	T	G	2	3	5	0	0	5	0	0
20	37513257	.	C	A	16	22	38	0	3	41	0	0
20	37513632	.	A	G	20	33	53	0	3	56	0	0
20	37513702	.	G	A	19	25	44	0	7	51	0	0
20	37513753	.	G	T	18	26	44	0	5	49	0	0
20	37515525	.	G	T	7	10	17	0	1	18	0	0
20	37515607	.	T	G	16	6	22	0	1	23	0	0
20	37516363	.	C	T	5	3	8	0	0	8	0	0
20	37518823	.	A	G	2	7	9	0	0	9	0	0
20	37519399	.	G	A	4	2	6	0	0	6	0	0
20	37519429	.	A	T	4	4	8	0	0	8	0	0
20	37519453	.	G	T	3	3	6	0	0	6	0	0
20	37736409	.	T	G	7	14	21	0	1	22	0	0
20	37760614	.	C	A	1	2	3	0	0	3	0	0
20	37761205	.	C	T	0	1	1	0	0	1	0	0
20	37764500	.	C	A	0	2	2	0	0	2	0	0
20	37768543	.	G	A	2	6	8	0	0	8	0	0
20	37768621	.	C	T	4	8	12	0	0	12	0	0
20	37768627	.	T	A	2	7	9	0	1	10	0	0
20	37768844	.	G	T	7	6	13	0	1	14	0	0
20	37768862	.	T	C	7	5	12	0	0	12	0	0
20	37768997	.	A	T	8	6	14	0	1	15	0	0
20	37769084	.	A	G	4	5	9	0	0	9	0	0
20	37769099	.	C	A	4	4	8	0	0	8	0	0
20	37796473	.	A	C	4	1	5	0	1	6	0	0
20	37798805	.	A	G	0	2	2	0	0	2	0	0
20	37798860	.	A	C	0	2	2	0	0	2	0	0
20	37800100	.	A	C	2	3	5	0	0	5	0	0
20	37825839	.	C	T	1	0	1	0	0	1	0	0
20	37831776	.	T	C	1	2	3	0	1	4	0	0
20	37859577	.	T	C	4	3	7	0	0	7	0	0
20	37862303	.	C	G	5	7	12	0	0	12	0	0
20	37862414	.	T	C	6	12	18	0	1	19	0	0
20	37862466	.	C	G	7	3	10	0	1	11	0	0
20	37866514	.	C	T	3	3	6	0	0	6	0	0
20	37896247	.	T	C	6	2	8	0	0	8	0	0
20	37896256	.	T	C	6	2	8	0	0	8	0	0
20	37899220	.	A	G	4	1	5	0	0	5	0	0
20	37913572	.	A	T	0	3	3	0	1	4	0	0
20	37913752	.	T	C	1	2	3	0	0	3	0	0
20	37914048	.	G	C	5	4	9	0	0	9	0	0
20	37914395	.	A	G	2	3	5	0	0	5	0	0
20	37914651	.	C	T	6	2	8	0	0	8	0	0
20	37914668	.	G	T	7	3	10	0	0	10	0	0
20	37914750	.	C	A	6	2	8	0	0	8	0	0
20	37914855	.	T	G	6	7	13	0	4	17	0	0
20	37914913	.	A	G	6	11	17	0	2	19	0	0
20	37914924	.	T	C	7	11	18	0	2	20	0	0
20	37915005	.	A	C	4	3	7	0	1	9	1	0
20	37915027	.	C	T	5	5	10	0	0	10	0	0
20	37915080	.	T	A	2	3	5	0	0	5	0	0
20	37915097	.	C	G	3	6	9	0	0	9	0	0
20	37915237	.	C	T	5	1	6	0	2	8	0	0
20	37915292	.	A	G	9	6	15	0	2	17	0	0
20	37915465	.	A	G	3	0	3	0	10	13	0	0
20	37915619	.	T	G	6	5	11	0	0	11	0	0
20	37915733	.	C	T	8	4	12	0	1	13	0	0
20	37915859	.	C	T	4	5	9	0	2	11	0	0
20	37920487	.	C	A	5	3	8	0	1	9	0	0
20	37920726	.	A	G	9	12	21	0	2	23	0	0
20	37920773	.	T	C	5	7	12	0	0	12	0	0
20	37925455	.	A	C	2	3	5	0	1	6	0	0
20	37928510	.	C	G	0	2	2	0	0	2	0	0
20	37930514	.	C	G	2	0	2	0	0	2	0	0
20	38045859	.	G	T	4	2	6	0	0	6	0	0
20	38086653	.	A	G	2	1	3	0	0	3	0	0
20	38091814	.	C	T	0	2	2	0	0	2	0	0
20	38091838	.	G	A	1	0	1	0	0	1	0	0
20	38099500	.	C	T	5	0	5	0	1	6	0	0
20	38210484	.	C	T	2	1	3	0	0	3	0	0
20	38210544	.	C	T	1	2	3	0	0	3	0	0
20	38216798	.	C	T	0	1	1	0	0	1	0	0
20	38240907	.	G	A	5	6	11	0	0	11	0	0
20	38241264	.	C	T	2	7	9	0	0	9	0	0
20	38241357	.	T	C	2	1	3	0	0	3	0	0
20	38241363	.	T	A	2	2	4	0	0	4	0	0
20	38241430	.	G	A	1	2	3	0	0	3	0	0
20	38241567	.	T	A	1	3	4	0	0	4	0	0
20	38241619	.	G	A	5	2	7	0	0	7	0	0
20	38241637	.	C	T	7	2	9	0	1	10	0	0
20	38241825	.	T	G	1	4	5	0	0	5	0	0
20	38358534	.	T	C	2	2	4	0	0	4	0	0
20	38358657	.	A	C	1	2	3	0	0	3	0	0
20	38358691	.	G	A	1	5	6	0	0	6	0	0
20	38359152	.	C	T	1	1	2	0	1	3	0	0
20	38359181	.	T	C	2	2	4	0	0	4	0	0
20	38359235	.	G	A	0	2	2	0	2	4	0	0
20	38458149	.	C	T	1	1	2	0	0	2	0	0
20	38473763	.	T	C	3	3	6	0	0	6	0	0
20	38473805	.	A	T	6	3	9	0	1	10	0	0
20	38473817	.	C	T	3	6	9	0	0	9	0	0
20	38473886	.	T	C	2	1	3	0	1	4	0	0
20	38517640	.	C	T	10	4	14	0	2	16	0	0
20	38518861	.	C	G	2	2	4	0	0	4	0	0
20	38518878	.	T	A	1	3	4	0	0	4	0	0
20	38518906	.	C	T	1	2	3	0	0	3	0	0
20	38538098	.	G	C	1	1	2	0	0	2	0	0
20	38538445	.	T	C	1	1	2	0	1	3	0	0
20	38584098	.	G	A	2	2	4	0	0	4	0	0
20	38647270	.	T	A	1	2	3	0	0	3	0	0
20	38657825	.	T	C	4	1	5	0	0	5	0	0
20	38662649	.	A	G	3	6	9	0	0	9	0	0
20	38662697	.	G	T	4	6	10	0	2	12	0	0
20	38665194	.	G	A	3	1	4	0	0	4	0	0
20	38669329	.	A	G	3	0	3	0	6	9	0	0
20	38669406	.	C	A	3	3	6	0	0	6	0	0
20	38669481	.	C	T	4	5	9	0	0	9	0	0
20	38669562	.	C	T	1	4	5	0	0	5	0	0
20	38669869	.	T	G	1	6	7	0	1	8	0	0
20	38669888	.	T	A	1	6	7	0	1	8	0	0
20	38670071	.	C	T	3	5	8	0	0	8	0	0
20	38670100	.	C	T	4	5	9	0	0	9	0	0
20	38670108	.	T	C	4	4	8	0	0	8	0	0
20	38670143	.	C	T	8	3	11	0	1	12	0	0
20	38670157	.	G	A	0	7	7	0	9	16	0	0
20	38670397	.	C	T	3	2	5	0	1	6	0	0
20	38726253	.	A	G	13	7	20	0	2	22	0	0
20	38726283	.	C	T	10	1	11	0	1	13	1	0
20	38726399	.	A	C	7	10	17	0	3	20	0	0
20	38726624	.	C	G	6	10	16	0	0	16	0	0
20	38726664	.	C	T	7	4	11	0	1	12	0	0
20	38726721	.	C	A	6	3	9	0	0	9	0	0
20	38726935	.	C	T	11	13	24	0	3	27	0	0
20	38727047	.	A	G	12	11	23	0	1	24	0	0
20	38764192	.	C	A	8	21	29	0	2	31	0	0
20	38764201	.	C	A	12	18	30	0	2	32	0	0
20	38764265	.	A	G	13	8	21	0	1	22	0	0
20	38764992	.	T	C	4	6	10	0	3	13	0	0
20	38765100	.	C	T	0	10	10	0	7	17	0	0
20	38765296	.	T	G	8	2	10	0	0	10	0	0
20	38765318	.	T	C	6	6	12	0	0	12	0	0
20	38765364	.	T	A	9	9	18	0	2	20	0	0
20	38765450	.	C	A	1	4	5	0	1	6	0	0
20	38765452	.	A	G	3	3	6	0	0	6	0	0
20	38765552	.	C	T	0	15	15	0	7	22	0	0
20	38778463	.	G	A	0	2	2	0	1	3	0	0
20	38787014	.	T	A	8	6	14	0	0	14	0	0
20	38788358	.	C	A	1	6	7	0	0	7	0	0
20	38788624	.	G	A	2	4	6	0	1	7	0	0
20	38788676	.	C	T	3	0	3	0	0	3	0	0
20	38788749	.	A	C	2	5	7	0	0	7	0	0
20	38788887	.	G	A	7	4	11	0	0	11	0	0
20	38789855	.	T	C	4	3	7	0	0	7	0	0
20	38790051	.	C	T	0	4	4	0	2	6	0	0
20	38790283	.	A	G	9	8	17	0	1	18	0	0
20	38793405	.	G	A	6	5	11	0	0	11	0	0
20	38793414	.	C	T	0	5	5	0	6	11	0	0
20	38798501	.	A	C	1	0	1	0	0	1	0	0
20	38808291	.	G	A	1	2	3	0	0	3	0	0
20	38871129	.	A	G	0	1	1	0	0	1	0	0
20	38872436	.	T	C	1	1	2	0	0	2	0	0
20	38889148	.	C	T	0	1	1	0	0	1	0	0
20	38910374	.	A	G	2	3	5	0	0	5	0	0
20	39045960	.	A	T	11	13	24	0	0	24	0	0
20	39046032	.	T	C	9	7	16	0	1	17	0	0
20	39052063	.	A	T	12	14	26	0	1	27	0	0
20	39052100	.	T	A	20	13	33	0	2	35	0	0
20	39052254	.	C	T	0	19	19	0	28	47	0	0
20	39052505	.	C	A	19	11	30	0	1	31	0	0
20	39055706	.	T	A	5	6	11	0	1	12	0	0
20	39055731	.	G	T	6	3	9	0	2	11	0	0
20	39055868	.	T	A	7	4	11	0	1	12	0	0
20	39081196	.	A	G	0	1	1	0	0	1	0	0
20	39081322	.	C	T	0	1	1	0	0	1	0	0
20	39190993	.	C	T	2	2	4	0	0	4	0	0
20	39191486	.	A	G	2	2	4	0	0	4	0	0
20	39256515	.	A	G	4	3	7	0	0	7	0	0
20	39256735	.	G	A	0	6	6	0	4	10	0	0
20	39256968	.	C	T	0	4	4	0	1	5	0	0
20	39257053	.	G	A	1	2	3	0	0	3	0	0
20	39258586	.	G	A	1	2	3	0	0	3	0	0
20	39259836	.	G	A	3	6	9	0	0	9	0	0
20	39260755	.	C	T	33	25	58	0	2	60	0	0
20	39260837	.	G	A	17	33	50	0	2	52	0	0
20	39260865	.	T	G	11	19	30	0	2	33	1	0
20	39267227	.	T	G	4	4	8	0	0	8	0	0
20	39271725	.	T	C	1	3	4	0	1	5	0	0
20	39271731	.	G	A	4	2	6	0	1	7	0	0
20	39271833	.	C	G	2	2	4	0	0	4	0	0
20	39273910	.	A	T	6	4	10	0	0	10	0	0
20	39338845	.	C	T	4	5	9	0	0	9	0	0
20	39338929	.	C	T	2	5	7	0	0	7	0	0
20	39338965	.	T	C	4	6	10	0	1	11	0	0
20	39338981	.	G	T	6	8	14	0	3	17	0	0
20	39339030	.	T	C	4	10	14	0	0	14	0	0
20	39339169	.	A	G	3	0	3	0	0	3	0	0
20	39341517	.	G	A	6	17	23	0	1	24	0	0
20	39341520	.	T	C	7	16	23	0	1	24	0	0
20	39344011	.	C	A	2	0	2	0	0	2	0	0
20	39344085	.	T	C	5	7	12	0	0	12	0	0
20	39520783	.	A	C	1	2	3	0	0	3	0	0
20	39520835	.	T	C	2	3	5	0	0	5	0	0
20	39520942	.	C	A	4	5	9	0	1	10	0	0
20	39579329	.	A	G	1	2	3	0	0	3	0	0
20	40716124	.	C	A	13	3	16	1	0	17	0	0
20	41998507	.	T	C	9	3	12	0	0	12	0	0
20	41998516	.	T	C	9	2	11	0	0	11	0	0
20	42203407	.	G	T	0	3	3	0	0	3	0	0
20	42203461	.	T	C	0	1	1	0	3	4	0	0
20	42203465	.	T	C	0	3	3	0	0	3	0	0
20	42221216	.	C	A	0	3	3	0	2	5	0	0
20	42221269	.	T	C	5	5	10	0	0	10	0	0
20	42221360	.	G	A	5	6	11	0	0	11	0	0
20	42221555	.	C	T	21	15	36	0	1	37	0	0
20	42221713	.	C	T	14	6	20	0	2	22	0	0
20	42221731	.	T	G	13	6	19	0	1	20	0	0
20	42221834	.	A	T	4	6	10	0	0	10	0	0
20	42221836	.	G	A	4	6	10	0	0	10	0	0
20	42222296	.	A	C	3	4	7	0	0	7	0	0
20	42222444	.	A	T	3	7	10	0	0	10	0	0
20	42222546	.	A	T	4	10	14	0	1	15	0	0
20	42222549	.	A	T	3	11	14	0	0	14	0	0
20	42222769	.	T	C	4	2	6	0	0	6	0	0
20	42222770	.	T	C	1	5	6	0	0	6	0	0
20	42222883	.	T	C	5	4	9	0	0	9	0	0
20	42223480	.	A	T	4	2	6	0	0	6	0	0
20	42232554	.	A	G	0	1	1	0	0	1	0	0
20	42233955	.	G	C	0	2	2	0	0	2	0	0
20	42281176	.	T	C	3	3	6	0	0	6	0	0
20	42300177	.	G	T	1	2	3	0	0	3	0	0
20	42653523	.	C	T	2	2	4	0	0	4	0	0
20	42660034	.	A	G	4	3	7	0	0	7	0	0
20	42660491	.	G	T	0	4	4	0	2	6	0	0
20	42688225	.	A	C	2	2	4	0	0	4	0	0
20	42688252	.	G	C	1	2	3	0	0	3	0	0
20	42954302	.	G	A	0	2	2	0	0	2	0	0
20	42968857	.	T	A	2	2	4	0	0	4	0	0
20	42969040	.	G	A	2	2	4	0	0	4	0	0
20	43012694	.	A	T	3	3	6	0	0	6	0	0
20	43016828	.	G	A	2	6	8	0	0	8	0	0
20	43016890	.	T	A	3	2	5	0	0	5	0	0
20	43016955	.	G	A	3	3	6	0	0	6	0	0
20	43120256	.	T	G	13	4	17	0	0	17	0	0
20	43120658	.	T	G	11	16	27	0	1	28	0	0
20	43120718	.	C	T	0	6	6	0	19	25	0	0
20	43120753	.	A	T	13	10	23	0	0	23	0	0
20	43120787	.	G	C	0	1	1	0	21	22	0	0
20	43120796	.	T	C	13	0	13	0	11	24	0	0
20	43121545	.	A	G	9	2	11	1	3	15	0	0
20	43122160	.	T	C	1	2	3	0	0	3	0	0
20	43122596	.	A	T	1	2	3	0	0	3	0	0
20	43122744	.	A	C	3	2	5	0	0	5	0	0
20	43122921	.	G	T	1	15	16	0	1	21	4	0
20	43123314	.	C	T	2	1	3	0	0	3	0	0
20	43133228	.	G	C	4	4	8	0	1	9	0	0
20	43133322	.	G	C	3	5	8	0	0	8	0	0
20	43133426	.	A	G	8	7	15	0	0	15	0	0
20	43159027	.	C	G	1	1	2	0	1	3	0	0
20	43184362	.	G	A	0	1	1	0	0	1	0	0
20	43671935	.	G	A	2	1	3	0	0	3	0	0
20	43673634	.	G	A	0	1	1	0	1	2	0	0
20	43680616	.	C	A	1	1	2	0	1	3	0	0
20	43680700	.	G	A	3	4	7	0	0	7	0	0
20	43680752	.	C	T	1	2	3	0	0	3	0	0
20	43689138	.	T	A	13	6	19	0	1	20	0	0
20	43689254	.	C	A	7	4	11	0	0	11	0	0
20	43689360	.	C	T	5	8	13	0	3	16	0	0
20	43689418	.	G	A	0	8	8	0	8	16	0	0
20	43714699	.	T	G	2	0	2	0	5	7	0	0
20	43715032	.	T	A	1	2	3	0	0	3	0	0
20	43746689	.	G	C	0	2	2	0	0	2	0	0
20	43746738	.	A	G	3	2	5	0	1	6	0	0
20	43746749	.	C	T	0	3	3	0	4	7	0	0
20	43746780	.	C	T	2	3	5	0	0	5	0	0
20	43750362	.	A	G	4	9	13	0	1	14	0	0
20	43750680	.	A	G	3	14	17	0	1	18	0	0
20	43776373	.	T	C	23	20	43	0	2	45	0	0
20	43776456	.	T	A	31	21	52	0	2	54	0	0
20	43776841	.	G	A	24	31	55	0	2	57	0	0
20	43776842	.	A	G	31	25	56	0	0	57	1	0
20	43786415	.	T	C	6	4	10	0	2	12	0	0
20	43793065	.	T	C	5	6	11	0	2	13	0	0
20	43793193	.	G	A	21	11	32	0	2	34	0	0
20	43793329	.	C	T	9	5	14	0	3	17	0	0
20	43793410	.	C	A	1	4	5	0	21	26	0	0
20	43793428	.	G	A	15	7	22	0	2	24	0	0
20	43793666	.	C	T	0	5	5	0	8	13	0	0
20	43793683	.	G	A	10	8	18	0	1	19	0	0
20	43793702	.	C	T	12	16	28	0	0	28	0	0
20	43793867	.	A	C	3	14	17	0	0	17	0	0
20	43793901	.	A	G	8	9	17	0	4	21	0	0
20	43793960	.	A	T	9	8	17	0	1	18	0	0
20	43794004	.	G	A	10	11	21	0	3	24	0	0
20	43794053	.	A	T	20	15	35	0	1	36	0	0
20	43794312	.	C	T	0	4	4	0	3	8	1	0
20	43794488	.	A	G	9	5	14	0	0	14	0	0
20	43812584	.	G	A	11	5	16	0	0	16	0	0
20	43825607	.	A	G	0	3	3	0	0	3	0	0
20	43831482	.	T	C	5	6	11	0	0	11	0	0
20	43895806	.	G	A	1	3	4	0	0	4	0	0
20	43895827	.	T	A	1	2	3	0	0	3	0	0
20	44372854	.	G	C	4	7	11	0	2	13	0	0
20	44372973	.	C	A	8	3	11	0	1	12	0	0
20	44372977	.	C	T	8	3	11	0	2	13	0	0
20	44373336	.	G	A	13	13	26	0	1	27	0	0
20	44373378	.	A	G	3	2	5	0	0	5	0	0
20	44386452	.	C	T	0	10	10	0	13	23	0	0
20	44386501	.	A	G	22	12	34	0	0	34	0	0
20	44389647	.	G	A	4	7	11	0	1	12	0	0
20	44402769	.	C	T	6	6	12	0	5	17	0	0
20	44447798	.	G	T	10	12	22	0	0	22	0	0
20	44451262	.	G	A	1	1	2	0	0	2	0	0
20	44451286	.	C	A	0	3	3	0	2	5	0	0
20	44457278	.	C	T	1	1	2	0	1	3	0	0
20	44457314	.	A	G	4	2	6	0	0	6	0	0
20	44457593	.	C	T	5	1	6	0	0	6	0	0
20	44457595	.	G	T	1	5	6	0	0	6	0	0
20	44464453	.	C	T	0	2	2	0	4	6	0	0
20	44464502	.	G	T	6	3	9	0	1	10	0	0
20	44464579	.	T	C	12	10	22	0	0	22	0	0
20	44514469	.	C	T	0	2	2	0	1	3	0	0
20	44514502	.	A	G	0	1	1	0	1	2	0	0
20	44523296	.	A	G	1	2	3	0	0	3	0	0
20	44566955	.	T	G	5	10	15	0	0	15	0	0
20	44567001	.	G	A	8	8	16	0	1	17	0	0
20	44569943	.	C	A	2	0	2	0	0	2	0	0
20	44621337	.	T	C	2	1	3	0	1	4	0	0
20	44799458	.	T	A	8	8	16	0	0	16	0	0
20	45406735	.	C	A	4	1	5	0	5	14	4	0
20	45406783	.	C	T	16	7	23	0	2	25	0	0
20	45406870	.	G	A	26	10	36	0	1	37	0	0
20	45406997	.	T	C	10	10	20	0	2	22	0	0
20	45407313	.	T	A	5	13	18	0	1	19	0	0
20	45408047	.	T	C	6	5	11	0	1	12	0	0
20	45408179	.	G	C	2	7	9	0	0	9	0	0
20	45408345	.	G	A	6	7	13	0	0	13	0	0
20	45643947	.	G	C	5	4	9	0	0	9	0	0
20	45644095	.	C	T	6	3	9	0	2	11	0	0
20	45644096	.	T	G	8	3	11	0	0	11	0	0
20	45644163	.	G	T	8	3	11	0	2	13	0	0
20	45644275	.	G	A	1	4	5	0	0	5	0	0
20	45645560	.	A	G	0	2	2	0	1	3	0	0
20	45669311	.	C	T	9	9	18	0	0	18	0	0
20	45669353	.	C	T	0	4	4	0	6	10	0	0
20	45742077	.	A	G	1	0	1	0	0	1	0	0
20	45745423	.	C	T	5	4	9	0	2	11	0	0
20	45745930	.	A	G	2	0	2	0	6	8	0	0
20	45746063	.	C	T	8	5	13	0	1	14	0	0
20	45746064	.	A	G	8	6	14	0	0	14	0	0
20	45746297	.	C	T	6	10	16	0	0	16	0	0
20	45746402	.	G	A	18	13	31	0	2	33	0	0
20	45746432	.	C	T	17	10	27	0	0	27	0	0
20	45746486	.	T	C	13	9	22	0	0	22	0	0
20	45746524	.	T	A	14	12	26	0	0	26	0	0
20	45746567	.	C	T	15	13	28	0	1	29	0	0
20	45746588	.	C	A	14	13	27	0	1	28	0	0
20	45746797	.	T	C	13	10	23	0	3	26	0	0
20	45746807	.	A	C	13	12	25	0	0	25	0	0
20	45747089	.	A	T	11	15	26	0	0	26	0	0
20	45747098	.	A	G	9	11	20	0	1	21	0	0
20	45747125	.	G	A	0	7	7	0	0	7	0	0
20	45751304	.	T	C	0	1	1	0	0	1	0	0
20	45751364	.	T	A	9	11	20	0	0	20	0	0
20	45751561	.	G	C	0	10	10	0	22	32	0	0
20	45751989	.	T	A	3	6	9	0	1	10	0	0
20	45764722	.	T	C	1	3	4	0	0	4	0	0
20	45764857	.	G	A	3	1	4	0	0	4	0	0
20	45766941	.	G	A	0	1	1	0	0	1	0	0
20	45898775	.	C	T	2	2	4	0	0	4	0	0
20	46352851	.	C	A	0	2	2	0	1	3	0	0
20	46353253	.	G	A	3	6	9	0	0	9	0	0
20	46353259	.	G	A	1	6	7	0	1	8	0	0
20	46353428	.	C	T	2	2	4	0	1	5	0	0
20	46441612	.	G	A	0	4	4	0	5	9	0	0
20	46441627	.	C	T	6	6	12	0	0	12	0	0
20	46441695	.	G	C	6	7	13	0	0	13	0	0
20	46441724	.	C	A	4	6	10	0	1	11	0	0
20	46441783	.	T	C	0	1	1	0	0	1	0	0
20	46442397	.	T	C	2	3	5	0	1	6	0	0
20	46457175	.	A	T	7	12	19	0	0	19	0	0
20	46457376	.	A	G	2	5	7	0	0	7	0	0
20	46463315	.	T	A	4	3	7	0	0	7	0	0
20	46463327	.	T	C	1	0	1	0	3	4	0	0
20	46466920	.	G	A	2	0	2	0	1	3	0	0
20	46492279	.	T	C	0	2	2	0	1	3	0	0
20	46502423	.	T	A	3	2	5	0	0	5	0	0
20	46502535	.	C	A	4	2	6	0	2	8	0	0
20	46509336	.	G	A	0	0	0	0	1	1	0	0
20	46517173	.	A	T	2	2	4	0	0	4	0	0
20	46517286	.	C	G	2	1	3	0	1	4	0	0
20	46517429	.	C	T	2	1	3	0	0	3	0	0
20	46519076	.	A	G	1	2	3	0	1	4	0	0
20	46519082	.	G	A	1	4	5	0	1	6	0	0
20	46519148	.	T	A	3	5	8	0	0	8	0	0
20	46525639	.	T	A	8	6	14	0	0	14	0	0
20	46528643	.	T	C	1	2	3	0	0	3	0	0
20	46529398	.	G	A	7	2	9	0	0	9	0	0
20	46529479	.	T	C	6	5	11	0	0	11	0	0
20	46533930	.	G	A	3	3	6	0	1	7	0	0
20	46536906	.	T	G	23	20	43	0	3	46	0	0
20	46537039	.	A	T	18	24	42	0	4	46	0	0
20	46537231	.	C	G	23	17	40	0	5	45	0	0
20	46537239	.	C	T	21	21	42	0	4	46	0	0
20	46537404	.	G	A	9	10	19	0	0	19	0	0
20	46539619	.	A	G	11	13	24	0	0	24	0	0
20	46540898	.	A	G	1	1	2	0	0	2	0	0
20	46552431	.	C	T	0	7	7	0	4	11	0	0
20	46552965	.	G	T	25	27	52	0	5	57	0	0
20	46552966	.	G	T	28	27	55	0	2	57	0	0
20	46553020	.	T	G	31	21	52	0	4	56	0	0
20	46553274	.	G	C	15	30	45	0	5	50	0	0
20	46553512	.	T	C	2	3	5	0	0	5	0	0
20	46554037	.	G	T	1	2	3	0	0	3	0	0
20	46554063	.	T	A	1	0	1	0	2	3	0	0
20	46699344	.	T	C	6	3	9	0	0	9	0	0
20	46713607	.	C	T	2	1	3	0	0	3	0	0
20	46721084	.	G	A	3	6	9	0	0	9	0	0
20	46724740	.	C	T	9	7	16	0	1	17	0	0
20	46730654	.	T	C	2	5	7	0	0	7	0	0
20	46730663	.	G	A	2	7	9	0	1	10	0	0
20	46730734	.	C	T	11	7	18	0	3	21	0	0
20	46731010	.	T	A	9	5	14	0	1	15	0	0
20	46731761	.	T	C	5	2	7	0	0	7	0	0
20	46732336	.	T	G	0	0	0	0	8	8	0	0
20	46732848	.	T	A	9	17	26	0	0	26	0	0
20	46732887	.	C	T	14	9	23	0	0	23	0	0
20	46733096	.	C	T	1	3	4	0	4	8	0	0
20	46733764	.	A	G	10	6	16	0	2	18	0	0
20	46733809	.	G	A	9	4	13	0	4	17	0	0
20	46746711	.	G	A	0	2	2	0	4	6	0	0
20	46758728	.	C	T	1	0	1	0	0	1	0	0
20	46758782	.	G	A	1	2	3	0	0	3	0	0
20	46759449	.	G	T	1	1	2	0	1	3	0	0
20	46831124	.	T	C	7	9	16	0	3	19	0	0
20	46835112	.	A	G	1	3	4	0	0	4	0	0
20	46835350	.	C	T	0	0	0	0	1	1	0	0
20	46835363	.	G	T	2	1	3	0	0	3	0	0
20	46858896	.	G	A	3	3	6	0	1	7	0	0
20	46957559	.	G	T	22	31	53	0	1	54	0	0
20	46957575	.	C	G	17	29	46	0	7	53	0	0
20	46957600	.	T	A	10	21	31	0	5	36	0	0
20	46957650	.	A	T	17	23	40	0	2	42	0	0
20	46957803	.	T	A	21	22	43	0	1	44	0	0
20	46958136	.	C	T	11	15	26	0	1	27	0	0
20	46958478	.	T	C	12	0	12	0	22	34	0	0
20	46958705	.	G	T	19	7	26	0	0	26	0	0
20	46958766	.	T	A	10	12	22	0	2	24	0	0
20	46959135	.	T	C	17	21	38	0	2	40	0	0
20	46959147	.	A	T	15	20	35	0	3	38	0	0
20	46959465	.	C	A	6	6	12	0	0	12	0	0
20	46959477	.	A	T	6	4	10	0	1	11	0	0
20	46959504	.	T	C	5	5	10	0	2	12	0	0
20	46959525	.	T	C	4	0	4	0	9	13	0	0
20	46959543	.	A	T	3	11	14	0	1	15	0	0
20	47290466	.	A	T	5	8	13	0	0	13	0	0
20	47290698	.	T	A	3	2	5	0	2	7	0	0
20	47290705	.	T	C	3	2	5	0	3	8	0	0
20	47291133	.	C	T	0	1	1	0	3	4	0	0
20	47291137	.	G	A	2	0	2	0	3	5	0	0
20	47301729	.	A	G	1	3	4	0	0	4	0	0
20	47305152	.	G	A	0	2	2	0	1	3	0	0
20	47383913	.	A	G	5	6	11	0	1	12	0	0
20	47386932	.	T	G	1	3	4	0	2	6	0	0
20	47386965	.	T	C	3	7	10	0	0	10	0	0
20	47387067	.	T	C	4	2	6	0	0	6	0	0
20	47388431	.	G	A	2	3	5	0	0	5	0	0
20	47421471	.	C	A	4	2	6	0	2	8	0	0
20	47421554	.	A	G	3	3	6	0	1	7	0	0
20	47435065	.	G	T	0	14	14	0	10	24	0	0
20	47435186	.	C	A	7	11	18	0	1	19	0	0
20	47471391	.	A	G	27	2	29	0	11	40	0	0
20	47689531	.	G	A	2	2	4	0	0	4	0	0
20	47689570	.	A	G	4	4	8	0	2	10	0	0
20	47689621	.	A	T	16	13	29	0	1	30	0	0
20	47689647	.	A	C	10	0	10	0	13	23	0	0
20	47689671	.	T	C	12	7	19	0	1	20	0	0
20	47689801	.	C	T	16	10	26	0	2	28	0	0
20	47700055	.	C	T	3	3	6	0	0	6	0	0
20	47718458	.	T	C	11	9	20	0	2	22	0	0
20	47726010	.	G	A	0	4	4	0	0	4	0	0
20	47726049	.	C	G	3	5	8	0	0	8	0	0
20	47932268	.	G	T	10	10	20	0	0	20	0	0
20	47932424	.	T	C	12	18	30	0	4	34	0	0
20	47932867	.	T	C	5	9	14	0	0	14	0	0
20	47938981	.	C	T	0	1	1	0	0	1	0	0
20	47942600	.	G	A	4	7	11	0	1	12	0	0
20	47942651	.	A	G	4	5	9	0	0	9	0	0
20	47944132	.	C	T	0	3	3	0	2	5	0	0
20	47944151	.	G	A	2	3	5	0	0	5	0	0
20	47944277	.	C	T	0	1	1	0	3	4	0	0
20	48037036	.	T	C	4	2	6	0	0	7	1	0
20	48037061	.	G	C	4	2	6	0	1	7	0	0
20	48037071	.	G	A	4	1	5	0	0	5	0	0
20	48296314	.	T	C	8	0	8	0	5	13	0	0
20	48296315	.	A	G	9	4	13	0	0	13	0	0
20	48298716	.	C	T	2	0	2	0	0	2	0	0
20	48312445	.	A	G	1	2	3	0	0	3	0	0
20	49804501	.	C	T	1	1	2	0	0	2	0	0
20	50996515	.	G	T	0	12	12	0	7	19	0	0
20	50998672	.	T	A	22	18	40	0	4	44	0	0
20	50998746	.	A	G	24	15	39	0	6	45	0	0
20	50998858	.	C	T	18	23	41	0	5	46	0	0
20	50999024	.	C	G	13	26	39	0	8	47	0	0
20	50999297	.	C	A	4	12	16	0	1	17	0	0
20	50999311	.	T	C	3	7	10	0	0	10	0	0
20	51069864	.	A	G	2	0	2	0	8	10	0	0
20	51070017	.	A	G	1	2	3	0	1	4	0	0
20	51073369	.	A	T	5	3	8	0	0	9	1	0
20	51073449	.	G	A	1	7	8	0	9	17	0	0
20	51073692	.	G	A	5	9	14	0	0	14	0	0
20	51073783	.	G	A	12	10	22	0	0	22	0	0
20	51073800	.	G	A	13	7	20	0	0	20	0	0
20	51074291	.	A	G	2	0	2	0	6	8	0	0
20	51074317	.	C	T	2	6	8	0	0	8	0	0
20	51074352	.	A	T	1	2	3	0	0	3	0	0
20	51076506	.	A	T	1	2	3	0	0	3	0	0
20	51076524	.	G	A	1	2	3	0	0	3	0	0
20	51077524	.	A	C	3	2	5	0	0	5	0	0
20	51077744	.	A	G	0	2	2	0	0	2	0	0
20	51081249	.	C	T	2	3	5	0	0	5	0	0
20	51088683	.	G	A	27	9	36	0	2	38	0	0
20	51088802	.	A	T	32	24	56	0	2	58	0	0
20	51088920	.	C	T	23	27	50	0	2	52	0	0
20	51088967	.	C	A	29	20	49	0	3	52	0	0
20	51089236	.	T	C	14	1	15	0	28	43	0	0
20	51089243	.	T	C	17	24	41	0	1	42	0	0
20	51089465	.	T	A	21	14	35	0	1	36	0	0
20	51089559	.	G	A	26	24	50	0	1	51	0	0
20	51089877	.	G	A	17	32	49	0	2	51	0	0
20	51089883	.	A	G	19	32	51	0	1	52	0	0
20	51089919	.	A	G	13	30	43	0	6	49	0	0
20	51100498	.	T	C	3	5	8	0	1	9	0	0
20	51112208	.	C	T	5	10	15	0	2	17	0	0
20	51117664	.	G	A	10	6	16	0	1	17	0	0
20	51118314	.	T	C	6	16	22	0	1	23	0	0
20	51123088	.	C	T	12	13	25	0	0	25	0	0
20	51123151	.	A	T	14	20	34	0	0	34	0	0
20	51132127	.	C	G	12	7	19	0	0	19	0	0
20	51132208	.	A	G	22	4	26	0	2	28	0	0
20	51132219	.	A	G	22	5	27	0	2	29	0	0
20	51145837	.	A	G	6	6	12	0	1	13	0	0
20	51146152	.	T	G	5	11	16	0	0	17	1	0
20	51146194	.	A	G	0	3	3	0	0	3	0	0
20	51157061	.	C	T	1	11	12	0	13	25	0	0
20	51157082	.	T	C	14	12	26	0	0	26	0	0
20	51168559	.	A	T	1	1	2	0	0	2	0	0
20	51199791	.	T	C	6	8	14	0	4	18	0	0
20	51200015	.	C	T	21	28	49	0	6	55	0	0
20	51204759	.	C	T	13	14	27	0	2	29	0	0
20	51205691	.	T	G	5	12	17	0	2	19	0	0
20	51205745	.	G	A	25	39	64	0	6	70	0	0
20	51206976	.	C	A	28	33	61	0	9	70	0	0
20	51207030	.	C	T	30	31	61	0	5	66	0	0
20	51207051	.	G	A	30	35	65	0	7	72	0	0
20	51207609	.	C	A	4	3	7	0	1	8	0	0
20	51207726	.	C	T	48	32	80	0	1	81	0	0
20	51211459	.	A	G	37	8	45	0	39	84	0	0
20	51240121	.	C	G	0	2	2	0	0	2	0	0
20	51240130	.	T	G	0	1	1	0	1	2	0	0
20	51274748	.	G	A	0	3	3	0	0	3	0	0
20	51276459	.	G	A	1	4	5	0	0	5	0	0
20	51283410	.	G	A	0	1	1	0	0	1	0	0
20	51312886	.	C	T	1	3	4	0	0	4	0	0
20	51312894	.	T	C	1	3	4	0	0	4	0	0
20	51313036	.	C	T	0	5	5	0	0	5	0	0
20	51313049	.	C	T	2	6	8	0	0	8	0	0
20	51332239	.	C	T	1	0	1	0	0	1	0	0
20	51332587	.	A	T	4	2	6	0	1	7	0	0
20	51332593	.	T	C	6	2	8	0	0	8	0	0
20	51332917	.	G	C	1	3	4	0	0	4	0	0
20	51333118	.	A	T	1	3	4	0	0	4	0	0
20	51333698	.	A	C	3	11	14	0	1	15	0	0
20	51334081	.	G	A	5	9	14	0	1	15	0	0
20	51334173	.	G	T	3	6	9	0	0	9	0	0
20	51334193	.	G	T	2	4	6	0	0	6	0	0
20	51363773	.	A	G	6	4	10	0	2	12	0	0
20	51377158	.	G	A	8	10	18	0	0	18	0	0
20	51377261	.	G	A	7	9	16	0	0	16	0	0
20	51383804	.	C	G	3	3	6	0	0	6	0	0
20	51386444	.	G	T	2	2	4	0	1	5	0	0
20	51386487	.	G	A	4	2	6	0	0	6	0	0
20	51390341	.	A	G	2	2	4	0	0	4	0	0
20	51390352	.	A	G	2	1	3	0	1	4	0	0
20	51489866	.	G	A	1	2	3	0	0	3	0	0
20	51490846	.	A	T	1	2	3	0	0	3	0	0
20	51647836	.	A	G	2	5	7	0	1	8	0	0
20	51647872	.	A	T	4	7	11	0	1	12	0	0
20	51648072	.	A	G	5	4	9	0	1	10	0	0
20	51649188	.	A	G	2	2	4	0	0	4	0	0
20	51649189	.	C	A	0	2	2	0	2	4	0	0
20	51703406	.	T	C	5	2	7	0	1	8	0	0
20	51703445	.	C	T	0	0	0	0	1	1	0	0
20	51703939	.	G	A	10	9	19	0	1	20	0	0
20	51713103	.	G	A	1	2	3	0	0	3	0	0
20	51720465	.	A	G	2	1	3	0	0	3	0	0
20	51723227	.	A	G	0	1	1	0	0	1	0	0
20	51743891	.	T	C	2	0	2	0	0	2	0	0
20	51745943	.	G	A	3	1	4	0	1	5	0	0
20	51753509	.	G	A	1	6	7	0	7	14	0	0
20	51753512	.	G	T	5	8	13	0	1	14	0	0
20	51753562	.	C	T	9	4	13	0	1	14	0	0
20	51758611	.	A	C	8	5	13	0	2	15	0	0
20	51759191	.	A	C	10	9	19	1	1	21	0	0
20	51759562	.	G	A	13	10	23	0	0	23	0	0
20	51763248	.	G	T	13	9	22	0	1	23	0	0
20	51787392	.	T	C	3	0	3	0	0	3	0	0
20	51794071	.	A	G	2	0	2	0	1	3	0	0
20	51799052	.	G	A	2	0	2	0	0	2	0	0
20	51802061	.	A	T	0	2	2	0	0	2	0	0
20	51802242	.	G	A	0	1	1	0	0	1	0	0
20	51807785	.	A	G	1	1	2	0	0	2	0	0
20	51813934	.	T	A	1	0	1	0	0	1	0	0
20	51873991	.	C	A	2	4	6	0	0	6	0	0
20	51873999	.	G	A	3	2	5	0	1	6	0	0
20	52275622	.	A	T	1	1	2	0	0	2	0	0
20	52275647	.	G	A	1	2	3	0	0	3	0	0
20	52333070	.	A	G	0	11	11	0	0	11	0	0
20	52333385	.	G	A	6	6	12	0	0	12	0	0
20	52416080	.	C	T	3	3	6	0	0	6	0	0
20	52416125	.	C	T	1	2	3	0	0	3	0	0
20	52420126	.	G	T	0	1	1	0	1	2	0	0
20	52473266	.	C	T	1	3	4	0	0	4	0	0
20	52487851	.	C	T	0	6	6	0	0	6	0	0
20	52554022	.	G	T	10	5	15	0	1	16	0	0
20	52554065	.	A	C	12	6	18	0	3	21	0	0
20	52554222	.	G	A	10	12	22	0	2	24	0	0
20	52554283	.	C	T	9	16	25	0	1	26	0	0
20	52554547	.	A	C	12	13	25	0	2	27	0	0
20	52554685	.	A	G	1	3	4	0	1	5	0	0
20	52561670	.	A	G	18	12	30	0	2	32	0	0
20	52563215	.	C	A	0	3	3	0	0	3	0	0
20	52568373	.	C	G	0	1	1	0	0	1	0	0
20	52574900	.	G	A	0	27	27	0	19	46	0	0
20	52575020	.	A	G	18	0	18	0	26	44	0	0
20	52582594	.	A	T	3	4	7	0	1	8	0	0
20	52907631	.	A	T	1	3	4	1	0	5	0	0
20	52923827	.	G	A	0	2	2	0	0	2	0	0
20	53181085	.	C	T	2	1	3	0	0	3	0	0
20	53181091	.	G	A	0	1	1	0	1	2	0	0
20	53215338	.	A	G	2	0	2	0	4	6	0	0
20	53224594	.	C	T	3	3	6	0	0	6	0	0
20	53230903	.	G	T	0	7	7	0	4	11	0	0
20	53262237	.	G	T	0	6	6	0	10	16	0	0
20	53262283	.	C	T	11	8	19	0	0	19	0	0
20	53302300	.	G	A	1	4	5	0	0	5	0	0
20	53318814	.	G	T	3	3	6	0	0	6	0	0
20	53365921	.	C	T	0	3	3	0	4	7	0	0
20	53377661	.	A	G	1	0	1	0	1	2	0	0
20	53377691	.	G	A	1	0	1	0	1	2	0	0
20	53391922	.	G	T	2	2	4	0	2	6	0	0
20	53393594	.	T	C	0	3	3	0	0	3	0	0
20	53393669	.	C	A	5	5	10	0	0	10	0	0
20	53396115	.	C	G	1	2	3	0	0	3	0	0
20	53396160	.	G	A	0	1	1	0	1	2	0	0
20	53398790	.	C	T	3	5	8	0	0	8	0	0
20	53401910	.	C	T	3	3	6	0	3	9	0	0
20	53422244	.	G	T	1	2	3	0	0	3	0	0
20	53423863	.	C	T	0	1	1	0	0	1	0	0
20	53641418	.	A	C	6	0	6	0	1	8	1	0
20	53641462	.	T	C	3	10	13	0	0	13	0	0
20	53803783	.	T	A	5	2	7	0	1	8	0	0
20	53804342	.	A	G	3	3	6	0	1	7	0	0
20	53804470	.	G	T	1	2	3	0	0	5	2	0
20	53804480	.	A	G	3	2	5	0	0	5	0	0
20	53804689	.	A	G	5	1	6	0	3	9	0	0
20	53804690	.	C	T	6	3	9	0	0	9	0	0
20	53898770	.	C	T	0	13	13	0	20	33	0	0
20	53898930	.	G	A	13	8	21	0	1	22	0	0
20	53898968	.	A	T	16	13	29	0	0	29	0	0
20	53899023	.	G	C	12	15	27	0	2	29	0	0
20	53899035	.	G	A	8	16	24	0	1	25	0	0
20	53899063	.	G	A	13	9	22	0	2	24	0	0
20	53901136	.	G	C	2	3	5	0	0	5	0	0
20	53903856	.	T	C	4	7	11	0	1	12	0	0
20	53912208	.	C	T	0	2	2	0	2	4	0	0
20	53930457	.	G	A	1	0	1	0	0	1	0	0
20	53930466	.	C	T	0	0	0	0	2	2	0	0
20	53968126	.	A	G	29	17	46	0	7	53	0	0
20	53968273	.	A	G	1	3	4	7	0	11	0	0
20	53970281	.	C	T	10	21	31	2	1	34	0	0
20	53974508	.	T	C	11	6	17	0	1	18	0	0
20	53974565	.	G	A	5	6	11	0	0	11	0	0
20	53974580	.	G	A	4	4	8	0	0	8	0	0
20	53981487	.	C	T	4	3	7	0	0	7	0	0
20	54051044	.	C	T	1	4	5	0	0	5	0	0
20	54067399	.	G	A	9	4	13	0	0	13	0	0
20	54067414	.	G	A	7	4	11	0	1	12	0	0
20	54085851	.	T	C	9	5	14	0	1	15	0	0
20	54197263	.	G	C	13	13	26	0	3	29	0	0
20	54197287	.	A	T	14	18	32	0	2	34	0	0
20	54197383	.	G	A	15	14	29	0	1	30	0	0
20	54197473	.	A	G	15	17	32	0	0	32	0	0
20	54205704	.	C	T	12	5	17	0	2	19	0	0
20	54215115	.	A	G	12	11	23	0	7	30	0	0
20	54219286	.	T	C	2	1	3	0	2	5	0	0
20	54232738	.	A	G	14	17	31	0	0	31	0	0
20	54232772	.	G	C	5	0	5	0	8	13	0	0
20	54233207	.	T	C	1	0	1	0	2	3	0	0
20	54249577	.	G	C	5	14	19	0	2	21	0	0
20	54251406	.	T	C	5	5	10	0	1	11	0	0
20	54274516	.	T	C	9	6	15	0	0	15	0	0
20	54274521	.	A	T	9	5	14	0	0	14	0	0
20	54278190	.	C	T	0	2	2	0	0	2	0	0
20	54283025	.	G	T	0	1	1	0	4	5	0	0
20	54283695	.	A	G	0	2	2	0	0	2	0	0
20	54286145	.	A	G	7	8	15	0	1	16	0	0
20	54286154	.	A	G	6	4	10	0	2	12	0	0
20	54286797	.	G	T	12	9	21	0	2	23	0	0
20	54334478	.	C	T	3	5	8	0	0	8	0	0
20	54339998	.	C	T	5	2	7	0	0	7	0	0
20	54340018	.	G	C	4	2	6	0	0	6	0	0
20	54340260	.	G	C	4	2	6	0	2	8	0	0
20	54340285	.	C	T	6	4	10	0	0	10	0	0
20	54341453	.	C	T	3	1	4	0	2	6	0	0
20	54342388	.	A	G	2	1	3	0	0	3	0	0
20	54342674	.	T	C	1	3	4	0	1	5	0	0
20	54343695	.	A	T	8	6	14	0	0	14	0	0
20	54343720	.	A	T	7	8	15	0	0	15	0	0
20	54343866	.	G	A	5	5	10	0	0	10	0	0
20	54343928	.	A	G	5	5	10	0	0	10	0	0
20	54344125	.	C	A	2	4	6	0	1	7	0	0
20	54344373	.	T	G	3	11	14	0	1	15	0	0
20	54344386	.	T	A	1	7	8	0	1	10	1	0
20	54344533	.	G	A	7	9	16	0	1	17	0	0
20	54344795	.	G	A	8	8	16	0	2	18	0	0
20	54344815	.	G	T	6	9	15	0	0	15	0	0
20	54344900	.	T	G	3	6	9	0	0	9	0	0
20	54345895	.	C	T	14	17	31	0	2	33	0	0
20	54346124	.	A	T	11	7	18	0	0	18	0	0
20	54346361	.	A	G	2	1	3	0	0	3	0	0
20	54350102	.	C	T	1	1	2	0	1	3	0	0
20	54357955	.	C	T	5	8	13	0	1	14	0	0
20	54358601	.	A	G	3	0	3	0	7	10	0	0
20	54360143	.	G	A	6	2	8	0	1	9	0	0
20	54360148	.	G	T	0	2	2	0	5	7	0	0
20	54360818	.	C	T	1	3	4	0	0	4	0	0
20	54398242	.	C	T	5	7	12	0	0	12	0	0
20	54398449	.	G	A	1	6	7	0	5	12	0	0
20	54402121	.	C	T	4	5	9	0	0	9	0	0
20	54402157	.	G	T	0	6	6	0	10	16	0	0
20	54402211	.	G	A	0	9	9	0	8	17	0	0
20	54402346	.	G	A	6	8	14	0	2	16	0	0
20	54402553	.	C	T	3	4	7	0	0	7	0	0
20	54406954	.	G	A	16	3	19	0	4	23	0	0
20	54407196	.	G	A	0	22	22	0	10	32	0	0
20	54422636	.	G	A	21	18	39	0	6	45	0	0
20	54422780	.	C	G	12	7	19	0	1	20	0	0
20	54422868	.	T	G	10	8	18	0	2	20	0	0
20	54422884	.	G	A	3	7	10	0	4	14	0	0
20	54422909	.	C	T	13	7	20	0	0	20	0	0
20	54422929	.	G	A	11	10	21	0	2	23	0	0
20	54423005	.	T	C	12	8	20	0	0	20	0	0
20	54423065	.	T	C	14	5	19	0	1	20	0	0
20	54423217	.	C	T	1	12	13	0	14	27	0	0
20	54434895	.	G	A	4	22	26	0	1	27	0	0
20	54434918	.	C	T	3	19	22	0	2	24	0	0
20	54446877	.	G	A	10	10	20	0	2	22	0	0
20	54462151	.	G	C	8	7	15	0	0	15	0	0
20	54525439	.	T	C	5	8	13	0	0	13	0	0
20	54563425	.	A	G	9	5	14	0	0	14	0	0
20	54563866	.	C	A	2	3	5	0	0	5	0	0
20	54563995	.	G	A	3	5	8	0	0	8	0	0
20	54563998	.	G	C	3	5	8	0	0	8	0	0
20	54670746	.	T	C	1	1	2	0	0	2	0	0
20	54670836	.	C	G	3	4	7	0	0	7	0	0
20	54670966	.	A	G	1	5	6	0	1	7	0	0
20	54670984	.	T	A	1	4	5	0	0	5	0	0
20	54671864	.	T	G	2	3	5	0	0	5	0	0
20	54671894	.	A	C	0	2	2	0	3	5	0	0
20	54671989	.	G	A	0	0	0	0	1	1	0	0
20	54672869	.	T	C	9	5	14	0	2	16	0	0
20	54672891	.	T	C	4	6	10	0	0	10	0	0
20	54672974	.	G	A	0	2	2	0	5	7	0	0
20	54673175	.	T	C	3	3	6	0	0	6	0	0
20	54673198	.	T	A	3	4	7	0	0	7	0	0
20	54675294	.	T	C	3	9	12	0	1	13	0	0
20	54675308	.	C	G	3	0	3	0	11	14	0	0
20	54675356	.	C	T	3	10	13	0	1	14	0	0
20	54675391	.	T	C	2	9	11	0	0	11	0	0
20	54676529	.	A	G	5	1	6	0	11	17	0	0
20	54676532	.	T	G	5	13	18	0	1	19	0	0
20	54676583	.	C	T	5	2	7	0	2	9	0	0
20	54681734	.	G	A	7	8	15	0	0	15	0	0
20	54681797	.	T	A	4	13	17	0	2	19	0	0
20	54681944	.	A	T	8	4	12	0	1	13	0	0
20	54699133	.	C	T	7	4	11	0	1	12	0	0
20	54708193	.	T	C	5	6	11	0	3	14	0	0
20	54708277	.	G	A	0	7	7	0	8	15	0	0
20	54711535	.	G	C	2	3	5	0	0	5	0	0
20	54738249	.	C	G	2	1	3	0	1	4	0	0
20	54740904	.	G	A	9	10	19	0	1	20	0	0
20	54740907	.	A	G	10	0	10	0	10	20	0	0
20	54740955	.	C	T	10	7	17	0	0	17	0	0
20	54740976	.	G	T	2	6	8	0	14	23	1	0
20	54741763	.	G	A	3	6	9	0	0	9	0	0
20	54742581	.	G	A	9	7	16	0	3	19	0	0
20	54742714	.	C	T	8	6	14	0	4	18	0	0
20	54742750	.	A	G	10	0	10	0	9	19	0	0
20	54742765	.	A	C	11	12	23	0	1	24	0	0
20	54743917	.	G	A	22	9	31	0	4	35	0	0
20	54743937	.	C	T	18	7	25	0	3	28	0	0
20	54744230	.	C	T	13	21	34	0	4	38	0	0
20	54744363	.	A	G	12	1	13	0	22	35	0	0
20	54744419	.	A	G	21	14	35	0	0	35	0	0
20	54744451	.	A	G	16	9	25	0	3	28	0	0
21	18055	.	A	T	4	2	6	0	4	10	0	0
21	18057	.	T	A	4	4	8	0	2	10	0	0
21	18176	.	G	A	5	4	9	0	0	9	0	0
21	36595	.	C	T	1	2	3	0	0	3	0	0
21	40609	.	T	C	14	18	32	0	2	34	0	0
21	41914	.	A	G	1	2	3	0	0	3	0	0
21	103308	.	T	C	3	3	6	0	0	6	0	0
21	104046	.	T	C	1	5	6	0	0	6	0	0
21	104143	.	G	C	0	3	3	0	5	8	0	0
21	112730	.	C	A	3	4	7	0	0	7	0	0
21	170842	.	C	G	1	1	2	0	0	2	0	0
21	170896	.	A	C	3	4	7	0	0	7	0	0
21	170916	.	T	C	2	2	4	0	2	6	0	0
21	173536	.	A	G	4	5	9	0	0	9	0	0
21	173545	.	T	C	7	7	14	0	0	14	0	0
21	178193	.	T	A	4	5	9	0	1	10	0	0
21	178227	.	G	A	0	4	4	0	9	13	0	0
21	178247	.	G	T	5	7	12	0	1	13	0	0
21	178559	.	T	C	3	8	11	0	0	11	0	0
21	178697	.	A	T	2	2	4	0	0	4	0	0
21	178703	.	A	T	1	1	2	0	2	4	0	0
21	217974	.	T	C	11	8	19	0	2	21	0	0
21	218795	.	A	G	5	4	9	0	0	9	0	0
21	219250	.	C	T	0	5	5	0	3	8	0	0
21	219259	.	T	C	3	0	3	0	4	7	0	0
21	233123	.	G	C	7	17	24	0	0	24	0	0
21	237246	.	G	C	1	4	5	0	0	5	0	0
21	243053	.	C	G	3	4	7	0	0	7	0	0
21	245641	.	G	A	0	1	1	0	2	3	0	0
21	247942	.	T	C	3	8	11	0	0	11	0	0
21	248156	.	C	G	11	6	17	0	6	23	0	0
21	248284	.	A	C	7	4	11	0	2	13	0	0
21	248286	.	A	C	8	2	10	0	3	13	0	0
21	248396	.	C	T	7	3	10	0	1	11	0	0
21	262572	.	C	G	6	1	7	0	1	8	0	0
21	263733	.	A	G	0	3	3	0	0	3	0	0
21	267717	.	T	C	3	0	3	0	0	3	0	0
21	269053	.	G	C	0	10	10	0	10	20	0	0
21	269057	.	G	A	8	9	17	0	1	18	0	0
21	269117	.	T	C	9	9	18	0	2	20	0	0
21	269328	.	G	A	0	10	10	0	5	15	0	0
21	269348	.	A	G	5	6	11	0	2	13	0	0
21	269634	.	T	C	13	8	21	0	1	22	0	0
21	269676	.	C	T	11	6	17	0	1	18	0	0
21	269693	.	A	T	7	6	13	0	0	13	0	0
21	269727	.	C	T	3	5	8	0	0	8	0	0
21	269789	.	A	G	7	3	10	0	1	11	0	0
21	269840	.	A	T	6	4	10	0	0	10	0	0
21	269858	.	G	A	5	3	8	0	0	8	0	0
21	272086	.	G	A	1	2	3	0	0	3	0	0
21	272159	.	T	C	3	2	5	0	0	5	0	0
21	272206	.	T	C	1	3	4	0	0	4	0	0
21	301298	.	G	A	11	5	16	0	0	16	0	0
21	303310	.	G	A	4	3	7	0	0	7	0	0
21	409978	.	G	A	1	5	6	0	7	13	0	0
21	409986	.	G	A	6	6	12	0	1	13	0	0
21	410139	.	A	G	7	9	16	0	1	17	0	0
21	410268	.	A	G	4	9	13	0	0	13	0	0
21	410281	.	C	T	3	7	10	0	3	13	0	0
21	410320	.	T	G	7	4	11	0	0	11	0	0
21	520628	.	G	A	2	2	4	0	0	4	0	0
21	522633	.	A	T	4	7	11	0	0	11	0	0
21	522926	.	A	G	2	4	6	0	0	6	0	0
21	527570	.	A	T	1	3	4	0	0	4	0	0
21	734962	.	A	G	7	0	7	0	20	27	0	0
21	1576168	.	T	C	5	2	7	0	0	7	0	0
21	1599075	.	C	A	2	4	6	0	0	6	0	0
21	1604351	.	G	A	0	7	7	0	4	11	0	0
21	1610473	.	C	G	1	0	1	0	0	1	0	0
21	1907038	.	C	A	6	2	8	0	0	8	0	0
21	1930112	.	A	T	1	2	3	0	0	3	0	0
21	1934091	.	T	C	2	3	5	0	0	5	0	0
21	1934156	.	A	G	3	2	5	0	0	5	0	0
21	1991007	.	G	T	12	8	20	0	2	22	0	0
21	1991097	.	A	G	14	15	29	0	3	32	0	0
21	1991118	.	G	A	13	20	33	0	2	35	0	0
21	1991160	.	G	A	8	8	16	0	1	17	0	0
21	1996944	.	T	C	1	0	1	0	0	1	0	0
21	2025607	.	C	T	2	2	4	0	0	4	0	0
21	2033964	.	T	G	2	0	2	0	0	2	0	0
21	2036975	.	G	A	0	1	1	0	0	1	0	0
21	2112595	.	A	T	1	3	4	0	0	4	0	0
21	2119814	.	G	A	1	2	3	0	0	3	0	0
21	2119975	.	T	C	2	2	4	0	0	4	0	0
21	2120038	.	T	C	2	3	5	0	0	5	0	0
21	2120061	.	C	G	1	3	4	0	2	6	0	0
21	2120073	.	G	A	0	3	3	0	1	4	0	0
21	2189717	.	C	G	1	2	3	0	0	3	0	0
21	2189718	.	T	C	1	2	3	0	0	3	0	0
21	2202836	.	G	A	1	2	3	0	0	3	0	0
21	2220295	.	A	T	1	2	3	0	0	3	0	0
21	2220326	.	G	C	4	2	6	0	1	7	0	0
21	2220612	.	G	A	1	5	6	0	0	6	0	0
21	2220713	.	T	C	2	2	4	0	0	4	0	0
21	2220988	.	C	T	1	2	3	0	1	4	0	0
21	2237552	.	G	T	0	1	1	0	0	1	0	0
21	2237578	.	A	G	0	1	1	0	0	1	0	0
21	2238237	.	G	C	0	1	1	0	0	1	0	0
21	2260435	.	C	T	0	2	2	0	1	3	0	0
21	2281401	.	A	G	2	3	5	0	0	5	0	0
21	5004353	.	C	T	1	5	6	0	0	6	0	0
21	5368346	.	G	A	4	6	10	0	0	10	0	0
21	5368417	.	C	T	0	8	8	0	15	23	0	0
21	5368461	.	C	T	0	8	8	0	14	22	0	0
21	5368510	.	C	T	0	9	9	0	12	21	0	0
21	5370451	.	T	A	5	3	8	0	0	8	0	0
21	5372598	.	G	A	1	5	6	0	0	6	0	0
21	5372643	.	T	C	7	2	9	0	0	9	0	0
21	5372673	.	G	A	3	4	7	0	0	7	0	0
21	5374209	.	C	T	0	1	1	0	1	2	0	0
21	5374528	.	T	C	2	1	3	0	0	3	0	0
21	5374788	.	G	A	0	1	1	0	0	1	0	0
21	5392941	.	T	A	1	2	3	0	0	3	0	0
21	5392963	.	G	T	1	2	3	0	0	3	0	0
21	5781134	.	C	T	33	26	59	0	4	63	0	0
21	5782043	.	T	C	26	9	35	0	36	71	0	0
21	5789938	.	G	A	16	17	33	0	0	33	0	0
21	5796060	.	T	C	15	23	38	0	3	41	0	0
21	5798978	.	T	A	15	12	27	0	0	28	1	0
21	5803474	.	C	T	7	3	10	0	0	10	0	0
21	5803495	.	T	C	2	1	3	0	4	7	0	0
21	5807177	.	A	C	7	7	14	0	0	14	0	0
21	5831364	.	G	T	1	3	4	0	0	4	0	0
21	5884836	.	G	A	0	16	16	0	29	45	0	0
21	5884897	.	T	A	27	27	54	0	0	54	0	0
21	5884945	.	G	A	26	25	51	0	0	51	0	0
21	5885071	.	T	G	1	4	5	0	0	5	0	0
21	5920426	.	C	T	4	2	6	0	1	7	0	0
21	5920530	.	A	C	2	4	6	0	0	6	0	0
21	5920535	.	G	A	2	4	6	0	0	6	0	0
21	5929158	.	C	T	3	2	5	0	1	6	0	0
21	5932610	.	C	T	5	3	8	0	0	8	0	0
21	5938303	.	A	T	1	4	5	0	1	6	0	0
21	5938364	.	T	C	2	3	5	0	0	5	0	0
21	5938399	.	G	T	4	3	7	0	0	7	0	0
21	5942534	.	A	C	1	2	3	0	0	3	0	0
21	5942661	.	G	T	9	12	21	0	1	22	0	0
21	5942868	.	T	G	8	14	22	0	0	22	0	0
21	5942906	.	C	A	15	8	23	0	3	26	0	0
21	5942927	.	C	T	8	15	23	0	2	25	0	0
21	5966657	.	G	A	0	1	1	0	1	2	0	0
21	5971630	.	C	A	13	0	13	0	0	13	0	0
21	5971638	.	C	A	8	4	12	0	0	12	0	0
21	5971839	.	A	T	5	6	11	0	0	11	0	0
21	5971949	.	A	T	6	5	11	0	0	11	0	0
21	5971983	.	C	T	6	8	14	0	2	16	0	0
21	5972087	.	G	T	0	9	9	0	16	25	0	0
21	5972092	.	T	C	14	11	25	0	1	26	0	0
21	5972252	.	A	G	9	11	20	0	0	20	0	0
21	5972631	.	T	A	3	3	6	0	1	7	0	0
21	6133407	.	G	A	2	3	5	0	0	5	0	0
21	6133434	.	G	A	0	3	3	0	3	6	0	0
21	6133588	.	T	C	2	2	4	0	0	4	0	0
21	6133996	.	T	G	1	2	3	0	0	3	0	0
21	6137579	.	C	T	1	0	1	0	1	2	0	0
21	6145991	.	G	A	9	7	16	0	3	19	0	0
21	6147499	.	C	T	0	0	0	0	1	1	0	0
21	6148091	.	G	A	0	8	8	0	7	16	1	0
21	6149938	.	T	C	19	16	35	0	0	35	0	0
21	6150113	.	T	A	10	7	17	0	2	19	0	0
21	6411047	.	A	T	1	1	2	0	0	2	0	0
21	6411067	.	T	C	1	1	2	0	0	2	0	0
21	11133653	.	A	G	2	2	4	0	0	4	0	0
21	11493661	.	A	G	30	11	41	0	8	49	0	0
21	11494536	.	A	G	8	3	11	0	40	51	0	0
21	11501975	.	A	G	25	17	42	0	5	47	0	0
21	11502056	.	A	G	44	12	56	0	5	61	0	0
21	11502143	.	A	G	10	51	61	0	3	64	0	0
21	11781400	.	A	G	7	2	9	0	0	9	0	0
21	11883160	.	A	G	1	3	4	0	1	5	0	0
21	13612494	.	T	C	5	0	5	0	4	9	0	0
21	13612502	.	T	C	5	0	5	0	3	8	0	0
21	13612711	.	T	C	2	3	5	0	0	5	0	0
21	17337750	.	G	T	0	2	2	0	0	2	0	0
21	17568543	.	A	G	2	10	12	0	1	13	0	0
21	19764727	.	T	A	4	2	6	0	3	9	0	0
21	20634263	.	A	G	1	3	4	0	0	4	0	0
21	21297979	.	A	G	1	4	5	0	0	5	0	0
21	21343123	.	A	G	1	2	3	0	0	3	0	0
21	21343146	.	A	G	4	1	5	0	1	6	0	0
21	21343477	.	A	G	0	7	7	0	0	7	0	0
21	21343478	.	A	G	1	6	7	0	0	7	0	0
21	22447164	.	T	C	2	3	5	0	0	5	0	0
21	22447370	.	T	C	2	2	4	0	0	4	0	0
21	22447373	.	G	C	2	2	4	0	0	4	0	0
21	22448380	.	C	G	8	4	12	0	2	14	0	0
21	22448445	.	A	T	4	4	8	0	0	8	0	0
21	22448574	.	A	G	2	7	9	0	0	9	0	0
21	22448597	.	T	A	3	5	8	0	0	8	0	0
21	22448961	.	C	T	3	8	11	0	1	12	0	0
21	22457812	.	A	T	1	3	4	0	0	4	0	0
21	22633734	.	A	G	9	6	15	0	3	18	0	0
21	22697107	.	C	T	2	2	4	0	0	4	0	0
21	22697161	.	T	C	3	3	6	0	0	6	0	0
21	22698809	.	C	T	1	1	2	0	0	2	0	0
21	22699471	.	T	C	3	4	7	0	1	8	0	0
21	22699491	.	T	C	5	5	10	0	0	10	0	0
21	22699512	.	T	C	5	4	9	0	0	9	0	0
21	22699556	.	A	G	5	3	8	0	0	8	0	0
21	22699563	.	C	T	6	4	10	0	0	10	0	0
21	22699595	.	C	A	7	5	12	0	0	12	0	0
21	22699608	.	T	C	5	3	8	0	0	8	0	0
21	22699853	.	G	T	0	6	6	0	4	10	0	0
21	22699916	.	G	A	4	8	12	0	1	13	0	0
21	22699956	.	T	G	4	5	9	0	0	9	0	0
21	22699986	.	T	A	7	3	10	0	0	10	0	0
21	22700015	.	A	G	3	0	3	0	3	6	0	0
21	22702551	.	A	C	8	9	17	0	0	17	0	0
21	22702804	.	C	T	8	7	15	0	1	16	0	0
21	22705087	.	C	T	5	4	9	0	0	9	0	0
21	22705203	.	C	T	2	3	5	0	0	5	0	0
21	22706389	.	T	G	1	0	1	0	1	2	0	0
21	22706396	.	G	T	1	1	2	0	0	2	0	0
21	22791122	.	T	C	1	3	4	0	0	4	0	0
21	22791174	.	A	C	2	3	5	0	1	6	0	0
21	22791178	.	C	T	2	3	5	0	1	6	0	0
21	22795009	.	T	C	6	7	13	0	1	14	0	0
21	22795107	.	G	A	0	6	6	0	4	10	0	0
21	22847022	.	A	T	5	5	10	0	1	11	0	0
21	22847136	.	C	T	12	4	16	0	2	18	0	0
21	22847163	.	A	G	9	4	13	0	0	13	0	0
21	22847174	.	G	C	5	5	10	0	1	11	0	0
21	22847207	.	A	G	9	3	12	0	0	12	0	0
21	22847284	.	A	G	16	0	16	0	7	23	0	0
21	22847304	.	G	A	0	7	7	0	10	17	0	0
21	22847329	.	A	G	3	17	20	0	0	20	0	0
21	22847750	.	C	T	15	25	40	0	6	46	0	0
21	22847969	.	C	T	17	20	37	0	0	37	0	0
21	22847984	.	A	T	17	21	38	0	2	40	0	0
21	22848011	.	G	A	18	21	39	0	1	40	0	0
21	22848047	.	C	T	19	16	35	0	2	37	0	0
21	22848173	.	C	T	9	14	23	0	1	24	0	0
21	22848403	.	T	C	4	6	10	0	1	11	0	0
21	22848424	.	C	T	6	7	13	0	0	13	0	0
21	22850949	.	G	A	14	25	39	0	0	39	0	0
21	22851300	.	C	A	1	2	3	0	0	3	0	0
21	22876417	.	A	G	1	1	2	0	1	3	0	0
21	22876478	.	G	T	2	2	4	0	0	4	0	0
21	22876510	.	G	A	2	3	5	0	0	5	0	0
21	22876955	.	A	G	1	0	1	0	5	6	0	0
21	22876976	.	T	A	1	4	5	0	0	5	0	0
21	22877430	.	T	A	4	2	6	0	0	6	0	0
21	22878844	.	A	C	5	5	10	0	0	10	0	0
21	22878856	.	G	A	7	6	13	0	2	15	0	0
21	22879338	.	C	A	10	5	15	0	1	16	0	0
21	22879458	.	A	G	6	0	6	0	12	18	0	0
21	22879559	.	A	C	9	5	14	0	0	14	0	0
21	22879733	.	G	C	0	7	7	0	9	16	0	0
21	22879824	.	A	C	10	10	20	0	1	21	0	0
21	22879909	.	C	A	5	9	14	0	0	14	0	0
21	22880016	.	A	T	7	11	18	0	0	18	0	0
21	22880079	.	C	T	8	14	22	0	1	23	0	0
21	22881477	.	G	C	5	3	8	0	0	8	0	0
21	22882138	.	T	C	1	3	4	0	0	4	0	0
21	22882354	.	G	T	6	4	10	0	0	10	0	0
21	22882587	.	A	C	4	5	9	0	0	9	0	0
21	22882761	.	C	T	3	4	7	0	3	10	0	0
21	22882801	.	G	T	4	3	7	0	0	7	0	0
21	22882866	.	T	C	8	5	13	0	1	14	0	0
21	22883182	.	C	T	3	3	6	0	0	6	0	0
21	22883363	.	T	C	2	3	5	0	1	6	0	0
21	22884361	.	T	C	9	5	14	0	0	14	0	0
21	22884412	.	C	T	8	9	17	0	0	17	0	0
21	22884556	.	G	A	0	7	7	0	11	18	0	0
21	22884661	.	T	C	8	12	20	0	1	21	0	0
21	22884769	.	C	T	14	11	25	0	2	27	0	0
21	22885083	.	G	T	2	0	2	0	1	3	0	0
21	22901119	.	G	A	3	4	7	0	0	7	0	0
21	23019589	.	T	G	12	13	25	0	0	25	0	0
21	23019679	.	C	A	21	21	42	0	3	45	0	0
21	23019836	.	T	G	21	17	38	0	3	41	0	0
21	23020095	.	A	C	14	17	31	0	3	34	0	0
21	23020126	.	A	G	18	18	36	0	2	38	0	0
21	23020440	.	A	T	16	14	30	0	6	36	0	0
21	23020523	.	T	C	17	0	17	0	14	31	0	0
21	23020558	.	C	T	0	18	18	0	21	39	0	0
21	23021145	.	C	A	7	4	11	0	1	12	0	0
21	23025233	.	G	A	1	1	2	0	0	2	0	0
21	23026978	.	C	T	0	1	1	0	1	2	0	0
21	23027017	.	C	T	3	7	10	0	0	10	0	0
21	23027023	.	A	T	8	3	11	0	1	12	0	0
21	23036393	.	A	T	0	4	4	0	0	4	0	0
21	23036459	.	A	G	1	3	4	0	0	4	0	0
21	23036534	.	G	A	5	2	7	0	0	7	0	0
21	23040529	.	C	T	2	2	4	0	3	7	0	0
21	23040577	.	A	G	4	5	9	0	1	10	0	0
21	23160558	.	T	G	6	6	12	0	0	12	0	0
21	23160851	.	A	T	14	14	28	0	0	28	0	0
21	23161651	.	C	A	6	5	11	0	0	11	0	0
21	23162023	.	C	T	12	6	18	0	1	19	0	0
21	23162127	.	A	T	12	10	22	0	1	23	0	0
21	23162395	.	T	G	2	3	5	0	1	6	0	0
21	23162618	.	C	A	6	3	9	0	1	10	0	0
21	23163938	.	G	T	9	7	16	0	3	19	0	0
21	23163990	.	A	T	9	5	14	0	0	14	0	0
21	23164090	.	C	T	1	3	4	0	0	4	0	0
21	23175440	.	C	T	1	1	2	0	1	3	0	0
21	23338168	.	A	G	1	4	5	0	2	7	0	0
21	23338241	.	G	A	3	6	9	0	0	9	0	0
21	23350240	.	A	G	1	1	2	0	0	2	0	0
21	23352629	.	A	G	0	1	1	0	0	1	0	0
21	23352707	.	A	G	3	2	5	0	1	6	0	0
21	23367200	.	C	T	12	9	21	0	1	22	0	0
21	23367218	.	T	G	20	10	30	0	1	31	0	0
21	23473213	.	G	A	0	2	2	0	0	2	0	0
21	24531725	.	A	T	3	3	6	0	0	6	0	0
21	24548563	.	G	A	1	0	1	0	0	1	0	0
21	25043681	.	C	T	4	5	9	0	0	9	0	0
21	25044523	.	G	A	0	2	2	0	2	4	0	0
21	25044532	.	C	A	1	2	3	0	0	3	0	0
21	25044656	.	A	T	0	2	2	0	1	3	0	0
21	25044662	.	C	T	3	3	6	0	0	6	0	0
21	25044848	.	C	G	2	2	4	0	0	4	0	0
21	25044876	.	A	T	3	4	7	0	0	7	0	0
21	25044885	.	G	C	3	4	7	0	1	8	0	0
21	25045470	.	C	A	2	1	3	0	1	4	0	0
21	25045517	.	C	T	2	1	3	0	1	4	0	0
21	25045521	.	T	C	2	2	4	0	0	4	0	0
21	25045634	.	A	T	3	5	8	0	0	8	0	0
21	25046210	.	G	C	3	5	8	0	1	9	0	0
21	25046840	.	C	T	4	6	10	0	1	11	0	0
21	25057547	.	A	G	0	1	1	0	0	1	0	0
21	25059752	.	G	A	0	1	1	0	1	2	0	0
21	25059941	.	G	A	1	1	2	0	0	2	0	0
21	25103676	.	T	A	4	10	14	0	0	14	0	0
21	25117588	.	A	G	14	10	24	0	0	24	0	0
21	25117777	.	T	G	13	10	23	0	0	23	0	0
21	25117959	.	G	A	8	11	19	0	3	22	0	0
21	25117974	.	A	C	12	9	21	0	3	24	0	0
21	25118065	.	G	A	14	8	22	0	0	22	0	0
21	25118108	.	T	C	10	14	24	0	0	24	0	0
21	25118560	.	G	A	1	4	5	0	9	14	0	0
21	25135777	.	A	G	2	0	2	0	3	5	0	0
21	25135789	.	C	T	3	3	6	0	1	7	0	0
21	25136093	.	T	C	0	1	1	0	0	1	0	0
21	25140596	.	A	G	3	3	6	0	1	7	0	0
21	25142536	.	T	A	6	0	6	0	0	6	0	0
21	25142635	.	A	G	1	0	1	0	0	1	0	0
21	25156379	.	C	T	3	3	6	0	2	9	1	0
21	25182091	.	C	A	13	9	22	0	0	22	0	0
21	25182207	.	A	T	13	5	18	0	0	18	0	0
21	25195376	.	G	A	0	2	2	0	0	2	0	0
21	25209223	.	G	A	2	0	2	0	0	2	0	0
21	25247236	.	C	T	0	4	4	0	4	8	0	0
21	25247240	.	C	T	0	4	4	0	4	8	0	0
21	25250497	.	C	T	0	2	2	0	0	2	0	0
21	25250836	.	G	A	6	4	10	0	3	13	0	0
21	25250986	.	G	A	4	4	8	0	0	8	0	0
21	25251013	.	G	A	5	3	8	0	1	9	0	0
21	25251034	.	G	T	3	4	7	0	0	7	0	0
21	25380817	.	T	A	5	3	8	0	1	9	0	0
21	25384076	.	T	C	4	0	4	0	0	4	0	0
21	25386752	.	T	C	1	5	6	0	0	6	0	0
21	25391290	.	C	A	4	9	13	0	0	13	0	0
21	25399339	.	T	G	5	5	10	0	0	10	0	0
21	25399909	.	T	G	13	18	31	0	3	34	0	0
21	25407216	.	C	G	16	10	26	0	2	28	0	0
21	25425773	.	C	A	14	10	24	0	1	25	0	0
21	25425798	.	T	C	7	5	12	0	2	14	0	0
21	25425826	.	G	T	5	5	10	0	4	14	0	0
21	25425848	.	C	A	0	8	8	0	8	16	0	0
21	25425873	.	A	T	6	9	15	0	4	19	0	0
21	25439974	.	T	A	2	3	5	0	14	19	0	0
21	25440049	.	G	A	13	13	26	0	3	29	0	0
21	25449464	.	G	A	0	1	1	0	1	2	0	0
21	25450846	.	G	A	3	2	5	0	0	5	0	0
21	25452558	.	G	A	5	3	8	0	0	8	0	0
21	25458902	.	T	A	3	5	8	0	0	8	0	0
21	25460713	.	G	A	2	1	3	0	0	3	0	0
21	25460734	.	G	A	5	3	8	0	0	8	0	0
21	25476597	.	G	A	1	1	2	0	1	3	0	0
21	25492981	.	C	T	1	0	1	0	0	1	0	0
21	25534003	.	C	T	2	2	4	0	0	4	0	0
21	25536122	.	G	A	0	1	1	0	0	1	0	0
21	25536182	.	G	A	1	1	2	0	0	2	0	0
21	25538219	.	A	C	2	3	5	0	0	5	0	0
21	25541272	.	A	G	2	5	7	0	0	7	0	0
21	25541473	.	C	T	2	2	4	0	0	4	0	0
21	25541704	.	T	C	4	2	6	0	0	6	0	0
21	25541893	.	A	G	3	3	6	0	1	7	0	0
21	25541902	.	C	T	3	3	6	0	1	7	0	0
21	25542356	.	C	A	4	2	6	0	0	6	0	0
21	25542791	.	G	A	0	3	3	0	4	7	0	0
21	25542813	.	A	T	5	2	7	0	1	8	0	0
21	25543284	.	C	A	1	6	7	0	0	7	0	0
21	25543286	.	T	C	1	6	7	0	0	7	0	0
21	25565268	.	C	T	9	12	21	0	3	24	0	0
21	25570042	.	A	G	14	8	22	0	1	23	0	0
21	25570275	.	G	C	7	10	17	0	5	22	0	0
21	25570416	.	C	G	0	5	5	0	9	14	0	0
21	25571436	.	T	A	4	2	6	0	0	6	0	0
21	25571446	.	G	A	3	2	5	0	1	6	0	0
21	25571488	.	T	A	1	5	6	0	0	6	0	0
21	25571919	.	T	C	0	1	1	0	0	1	0	0
21	25572785	.	G	T	0	0	0	0	1	1	0	0
21	25572930	.	C	T	1	3	4	0	3	7	0	0
21	25605597	.	T	C	4	3	7	0	0	7	0	0
21	25605647	.	A	G	5	4	9	0	0	9	0	0
21	25606796	.	C	T	3	1	4	0	0	4	0	0
21	25606819	.	C	G	0	0	0	0	2	2	0	0
21	25606971	.	A	G	1	1	2	0	1	3	0	0
21	25609470	.	A	T	2	1	3	0	0	3	0	0
21	25610512	.	T	C	0	0	0	0	6	6	0	0
21	25611659	.	A	G	1	2	3	0	0	3	0	0
21	25611861	.	G	A	2	2	4	0	0	4	0	0
21	25614934	.	C	A	0	1	1	0	2	3	0	0
21	25620446	.	T	C	4	2	6	0	0	6	0	0
21	25620573	.	A	G	2	1	3	0	1	4	0	0
21	25623185	.	C	A	2	2	4	0	0	4	0	0
21	25645555	.	T	G	15	14	29	0	1	30	0	0
21	25645655	.	G	C	10	9	19	0	2	21	0	0
21	25677015	.	T	G	1	2	3	0	0	3	0	0
21	25693141	.	G	T	1	0	1	0	0	1	0	0
21	25694895	.	G	A	1	2	3	0	0	3	0	0
21	25694896	.	G	A	1	2	3	0	0	3	0	0
21	25816780	.	G	A	2	3	5	0	0	5	0	0
21	25817230	.	A	G	2	4	6	0	0	6	0	0
21	25817832	.	A	G	3	3	6	0	0	6	0	0
21	25817842	.	A	G	2	2	4	0	0	4	0	0
21	25818193	.	T	G	2	0	2	0	7	9	0	0
21	25818430	.	G	A	0	2	2	0	0	2	0	0
21	26021662	.	T	A	3	2	5	0	0	5	0	0
21	26021867	.	A	T	1	2	3	0	0	3	0	0
21	26022992	.	C	T	3	5	8	0	2	10	0	0
21	26023209	.	G	A	3	7	10	0	0	10	0	0
21	26023231	.	G	A	3	4	7	0	3	10	0	0
21	26026171	.	A	G	4	4	8	0	1	9	0	0
21	26030687	.	T	C	5	3	8	0	0	8	0	0
21	26033800	.	C	T	0	5	5	0	0	5	0	0
21	26043333	.	A	G	1	0	1	0	0	1	0	0
21	26050097	.	C	T	1	5	6	0	0	6	0	0
21	26050115	.	C	T	2	6	8	0	0	8	0	0
21	26050415	.	T	G	5	3	8	0	0	8	0	0
21	26053929	.	C	A	12	12	24	0	0	24	0	0
21	26054453	.	A	G	6	0	6	0	6	12	0	0
21	26057490	.	T	A	16	10	26	0	0	26	0	0
21	26057707	.	C	T	3	6	9	0	4	13	0	0
21	26057864	.	T	A	10	5	15	0	0	17	2	0
21	26058121	.	C	T	10	14	24	0	5	29	0	0
21	26058275	.	G	T	12	22	34	0	4	38	0	0
21	26058378	.	C	T	7	9	16	0	2	18	0	0
21	26058386	.	C	A	10	8	18	0	2	20	0	0
21	26080633	.	G	C	4	5	9	0	0	10	1	0
21	26389462	.	C	T	5	6	11	0	0	11	0	0
21	26390614	.	G	A	8	10	18	0	2	20	0	0
21	26390620	.	A	G	5	10	15	0	1	16	0	0
21	26391964	.	T	A	11	10	21	0	1	22	0	0
21	26408340	.	A	C	14	0	14	0	16	30	0	0
21	26415195	.	C	T	12	8	20	0	2	22	0	0
21	26417389	.	A	T	1	1	2	0	0	2	0	0
21	26417854	.	A	T	4	2	6	0	0	6	0	0
21	26438785	.	C	T	1	2	3	0	0	3	0	0
21	26523233	.	C	T	1	2	3	0	0	3	0	0
21	26525311	.	C	T	0	3	3	0	0	3	0	0
21	26527782	.	G	A	0	8	8	0	9	17	0	0
21	26527808	.	A	G	9	12	21	0	0	21	0	0
21	26530332	.	G	A	0	3	3	0	1	4	0	0
21	26530663	.	T	A	2	0	2	0	0	2	0	0
21	26530737	.	G	C	7	7	14	0	2	16	0	0
21	26531014	.	G	A	6	9	15	0	1	16	0	0
21	26545622	.	T	A	3	0	3	0	0	3	0	0
21	26554015	.	A	T	4	2	6	0	1	7	0	0
21	26634042	.	C	T	15	11	26	0	1	27	0	0
21	26657476	.	C	T	5	6	11	0	0	11	0	0
21	26657484	.	C	A	4	2	6	0	0	6	0	0
21	26660055	.	G	A	0	14	14	0	15	29	0	0
21	26662745	.	G	A	16	10	26	0	0	26	0	0
21	26664824	.	G	A	6	5	11	0	0	11	0	0
21	26665046	.	G	T	1	8	9	0	2	11	0	0
21	26665092	.	C	T	0	6	6	0	9	15	0	0
21	26665141	.	A	G	9	6	15	0	4	19	0	0
21	26669386	.	C	G	4	2	6	0	0	6	0	0
21	26669394	.	C	T	2	3	5	0	1	6	0	0
21	26669421	.	T	C	3	3	6	0	1	7	0	0
21	26670306	.	T	A	3	6	9	0	0	9	0	0
21	26671390	.	G	A	1	2	3	0	0	3	0	0
21	26672611	.	G	A	3	3	6	0	0	6	0	0
21	26677745	.	A	T	2	4	6	0	1	7	0	0
21	26678649	.	C	T	3	6	9	0	1	10	0	0
21	26678650	.	C	T	4	6	10	0	0	10	0	0
21	26678753	.	T	A	5	3	8	0	0	8	0	0
21	26678838	.	C	A	6	4	10	0	0	10	0	0
21	26678965	.	C	T	0	7	7	0	10	17	0	0
21	26679023	.	T	C	7	2	9	0	1	10	0	0
21	26689934	.	A	T	4	2	6	0	0	6	0	0
21	26690151	.	T	A	1	2	3	0	0	3	0	0
21	26691889	.	T	C	2	3	5	0	0	5	0	0
21	26691898	.	A	T	2	2	4	0	1	5	0	0
21	26697686	.	G	C	34	13	47	1	1	49	0	0
21	26706581	.	C	A	32	28	60	0	3	63	0	0
21	26706583	.	G	A	31	28	59	0	4	63	0	0
21	26706646	.	C	G	23	23	46	0	3	49	0	0
21	26706662	.	T	A	29	25	54	0	2	56	0	0
21	26706846	.	T	A	32	21	53	0	1	54	0	0
21	26710071	.	A	G	24	18	42	0	1	43	0	0
21	26710194	.	T	A	15	20	35	0	2	37	0	0
21	26710239	.	G	A	17	17	34	0	0	34	0	0
21	26710496	.	C	A	18	27	45	0	2	47	0	0
21	26710514	.	A	G	20	30	50	0	0	50	0	0
21	26714361	.	C	T	0	4	4	0	0	4	0	0
21	26714373	.	C	A	0	1	1	0	0	1	0	0
21	26721385	.	C	A	1	4	5	0	0	5	0	0
21	26722269	.	C	T	4	3	7	0	1	8	0	0
21	26722347	.	G	A	2	4	6	0	1	7	0	0
21	26722431	.	T	C	1	1	2	0	0	2	0	0
21	26722625	.	C	T	5	6	11	0	0	11	0	0
21	26722688	.	T	A	1	3	4	0	0	4	0	0
21	26724649	.	A	G	6	9	15	0	0	15	0	0
21	26724833	.	A	G	11	17	28	0	1	29	0	0
21	26725135	.	A	G	2	5	7	0	0	7	0	0
21	26725247	.	C	T	11	10	21	0	2	23	0	0
21	26731344	.	G	A	36	29	65	0	1	66	0	0
21	26731364	.	T	A	38	27	65	0	1	66	0	0
21	26731765	.	C	T	32	40	72	0	4	76	0	0
21	26731925	.	C	A	23	35	58	0	6	64	0	0
21	26909169	.	C	T	8	7	15	0	2	17	0	0
21	26909177	.	C	T	7	5	12	0	3	15	0	0
21	26909228	.	A	G	6	7	13	0	2	15	0	0
21	26909425	.	C	G	13	6	19	0	0	19	0	0
21	26914870	.	T	G	6	9	15	0	0	15	0	0
21	26914915	.	T	G	10	11	21	0	2	23	0	0
21	26915086	.	G	A	8	5	13	0	0	13	0	0
21	26915203	.	A	G	5	8	13	0	0	13	0	0
21	26918684	.	G	A	0	1	1	0	2	3	0	0
21	26918726	.	G	A	2	3	5	0	0	5	0	0
21	26918762	.	C	A	1	2	3	0	0	3	0	0
21	26918767	.	G	A	1	2	3	0	0	3	0	0
21	26927255	.	T	C	2	3	5	0	0	5	0	0
21	26934419	.	G	A	1	4	5	0	2	7	0	0
21	26934888	.	C	T	1	3	4	0	0	4	0	0
21	26954405	.	G	A	5	2	7	0	0	7	0	0
21	26954430	.	T	C	2	3	5	0	0	5	0	0
21	26961015	.	A	T	1	0	1	0	0	1	0	0
21	26961084	.	A	G	8	6	14	0	2	16	0	0
21	26965918	.	A	T	7	15	22	0	1	23	0	0
21	26966025	.	T	C	6	6	12	0	0	12	0	0
21	26966047	.	A	T	7	7	14	0	0	14	0	0
21	26966079	.	A	G	4	0	4	0	7	11	0	0
21	26966088	.	A	T	4	6	10	0	0	10	0	0
21	26966287	.	G	A	1	5	6	0	11	17	0	0
21	26966681	.	A	G	9	0	9	0	15	24	0	0
21	26967230	.	C	T	4	15	19	0	1	20	0	0
21	26967265	.	T	A	6	15	21	0	0	21	0	0
21	26967551	.	A	T	9	15	24	0	6	30	0	0
21	26967906	.	T	G	22	12	34	0	1	35	0	0
21	26968042	.	G	A	19	21	40	0	1	41	0	0
21	26968344	.	G	A	17	9	26	0	1	27	0	0
21	26968499	.	T	G	9	16	25	0	1	26	0	0
21	26995869	.	G	A	6	7	13	0	0	13	0	0
21	26996849	.	C	A	2	18	20	0	30	50	0	0
21	27010406	.	T	A	14	16	30	0	4	34	0	0
21	27047839	.	A	T	4	5	9	0	0	9	0	0
21	27047955	.	G	A	10	4	14	0	1	15	0	0
21	27048320	.	C	A	1	2	3	0	0	3	0	0
21	27048423	.	G	T	1	4	5	0	0	5	0	0
21	27189802	.	G	A	0	7	7	0	9	16	0	0
21	27190038	.	G	C	2	2	4	0	0	4	0	0
21	27198405	.	C	T	7	13	20	0	4	24	0	0
21	27199893	.	G	A	4	7	11	0	1	12	0	0
21	27204648	.	C	T	11	9	20	0	0	20	0	0
21	27204669	.	T	C	11	1	12	0	11	23	0	0
21	27204713	.	T	A	14	12	26	0	0	26	0	0
21	27204747	.	C	T	22	11	33	0	0	33	0	0
21	27204942	.	G	A	12	11	23	0	0	23	0	0
21	27204957	.	G	A	6	12	18	0	0	18	0	0
21	27205050	.	G	A	11	10	21	0	2	23	0	0
21	27213209	.	A	T	7	9	16	0	1	17	0	0
21	27213287	.	T	A	6	8	14	0	1	15	0	0
21	27221206	.	G	A	0	0	0	0	1	1	0	0
21	27302943	.	C	A	8	9	17	0	0	17	0	0
21	27305739	.	T	G	4	6	10	0	0	10	0	0
21	27306203	.	C	T	1	4	5	0	0	5	0	0
21	27308671	.	C	T	9	17	26	0	1	27	0	0
21	27311230	.	C	T	3	9	12	0	0	12	0	0
21	27311450	.	C	T	8	8	16	0	0	16	0	0
21	27312950	.	C	T	8	10	18	0	1	19	0	0
21	27312962	.	G	A	7	5	12	0	0	12	0	0
21	27318274	.	G	T	8	3	11	0	0	11	0	0
21	27327875	.	A	C	1	2	3	0	0	3	0	0
21	27327904	.	T	C	1	2	3	0	0	3	0	0
21	27331984	.	G	A	0	0	0	0	1	1	0	0
21	27343814	.	G	A	0	2	2	0	1	3	0	0
21	27344065	.	A	G	1	1	2	0	0	2	0	0
21	27344125	.	T	C	1	1	2	0	0	2	0	0
21	27347994	.	C	T	1	1	2	0	0	2	0	0
21	27348033	.	A	C	2	1	3	0	0	3	0	0
21	27351316	.	T	C	4	4	8	0	1	9	0	0
21	27354112	.	A	G	8	14	22	0	0	22	0	0
21	27354142	.	C	A	8	10	18	0	3	21	0	0
21	27354147	.	T	C	10	10	20	0	1	21	0	0
21	27354434	.	C	A	8	11	19	0	1	20	0	0
21	27354505	.	T	C	12	7	19	0	0	19	0	0
21	27354602	.	G	T	4	10	14	0	0	14	0	0
21	27357019	.	T	C	0	2	2	0	1	3	0	0
21	27375247	.	C	T	3	5	8	0	1	9	0	0
21	27377354	.	C	A	10	8	18	0	5	23	0	0
21	27377815	.	G	A	0	3	3	0	0	3	0	0
21	27378011	.	A	C	5	5	10	0	2	12	0	0
21	27378269	.	T	A	6	10	16	0	1	17	0	0
21	27378388	.	T	G	5	8	13	0	0	13	0	0
21	27378607	.	T	A	6	5	11	0	0	11	0	0
21	27378663	.	G	A	0	7	7	0	2	9	0	0
21	27488954	.	A	G	0	1	1	0	0	1	0	0
21	27491626	.	C	A	0	2	2	0	1	3	0	0
21	27523079	.	T	C	3	0	3	0	0	3	0	0
21	27536026	.	G	A	0	2	2	0	5	7	0	0
21	27549702	.	G	T	5	3	8	0	0	8	0	0
21	27552699	.	C	G	5	3	8	0	0	8	0	0
21	27554837	.	T	C	9	6	15	0	3	18	0	0
21	27554858	.	C	T	8	10	18	0	2	20	0	0
21	27554904	.	A	G	12	9	21	0	1	22	0	0
21	27554939	.	G	C	10	12	22	0	3	25	0	0
21	27554986	.	C	T	9	5	14	0	1	15	0	0
21	27555051	.	G	T	6	5	11	0	0	11	0	0
21	27586827	.	C	T	0	2	2	0	1	3	0	0
21	27602850	.	C	T	1	2	3	0	0	3	0	0
21	27636438	.	C	T	20	20	40	0	2	42	0	0
21	27636664	.	C	T	0	12	12	1	18	31	0	0
21	27636733	.	C	A	15	17	32	0	1	33	0	0
21	27636739	.	G	A	14	22	36	0	1	37	0	0
21	27636867	.	C	T	13	15	28	0	2	30	0	0
21	27637534	.	C	T	16	15	31	0	2	33	0	0
21	27637912	.	G	A	15	21	36	0	3	39	0	0
21	27637951	.	A	G	15	14	29	0	2	31	0	0
21	27637993	.	G	A	15	20	35	0	0	35	0	0
21	27638226	.	C	G	1	3	4	0	4	8	0	0
21	27638260	.	A	G	7	5	12	0	1	13	0	0
21	27657475	.	A	G	12	10	22	0	1	23	0	0
21	28496276	.	T	C	24	16	40	0	0	40	0	0
21	28496332	.	C	T	31	25	56	0	6	62	0	0
21	28500561	.	C	T	31	26	57	0	5	62	0	0
21	28502369	.	G	A	0	1	1	0	0	1	0	0
21	28510226	.	C	T	1	2	3	0	0	3	0	0
21	28510258	.	A	G	4	8	12	0	0	12	0	0
21	28512800	.	G	T	10	10	20	0	0	20	0	0
21	28567343	.	G	A	1	2	3	0	0	3	0	0
21	28636721	.	C	A	0	2	2	0	0	2	0	0
21	28724148	.	C	T	5	3	8	0	0	8	0	0
21	28793800	.	A	C	2	5	7	0	0	7	0	0
21	28863254	.	A	G	2	4	6	0	2	8	0	0
21	28863810	.	A	G	7	13	20	0	0	20	0	0
21	28863884	.	G	A	2	3	5	0	0	5	0	0
21	28864246	.	G	A	12	11	23	0	1	24	0	0
21	28864475	.	C	T	1	7	8	0	8	16	0	0
21	28901022	.	C	A	0	9	9	0	18	27	0	0
21	28901037	.	G	A	12	8	20	0	2	22	0	0
21	28901078	.	T	C	3	4	7	0	0	7	0	0
21	28920111	.	C	T	0	4	4	0	2	6	0	0
21	29039214	.	C	A	2	2	4	0	2	6	0	0
21	29059819	.	G	A	0	2	2	0	2	4	0	0
21	29062843	.	G	A	1	7	8	0	1	9	0	0
21	29064692	.	T	C	3	4	7	0	0	7	0	0
21	29074438	.	C	G	21	23	44	0	1	45	0	0
21	29074439	.	T	C	21	23	44	0	1	45	0	0
21	29074492	.	A	T	21	21	42	0	1	43	0	0
21	29075234	.	T	G	16	6	22	0	1	24	1	0
21	29075235	.	T	G	18	6	24	0	0	24	0	0
21	29075332	.	G	T	15	23	38	0	0	38	0	0
21	29090879	.	C	T	1	6	7	0	4	11	0	0
21	29090907	.	T	A	3	2	5	0	2	7	0	0
21	29090935	.	C	T	0	3	3	0	8	11	0	0
21	29090984	.	T	G	18	10	28	0	1	29	0	0
21	29091012	.	C	T	20	10	30	0	0	30	0	0
21	29091053	.	T	C	16	18	34	0	2	36	0	0
21	29091054	.	G	A	15	20	35	0	1	36	0	0
21	29091362	.	C	G	3	1	4	0	0	4	0	0
21	29092199	.	A	G	1	2	3	0	1	4	0	0
21	29096709	.	T	G	14	5	19	0	2	21	0	0
21	29247636	.	C	T	2	2	4	0	0	4	0	0
21	30010042	.	T	C	1	0	1	0	0	1	0	0
21	30010146	.	C	T	5	4	9	0	1	10	0	0
21	30010299	.	C	A	1	6	7	0	0	7	0	0
21	30010462	.	C	T	3	2	5	0	0	5	0	0
21	30014318	.	C	T	1	6	7	0	0	7	0	0
21	30018856	.	T	C	1	0	1	0	0	1	0	0
21	30019225	.	C	T	5	6	11	0	1	12	0	0
21	30019250	.	C	T	5	7	12	0	0	12	0	0
21	30019336	.	A	C	3	5	8	0	1	9	0	0
21	30019385	.	C	G	8	6	14	0	0	14	0	0
21	30019586	.	T	A	1	6	7	0	0	7	0	0
21	30019930	.	C	A	3	4	7	0	1	8	0	0
21	30019953	.	A	T	3	2	5	0	1	6	0	0
21	30020062	.	T	A	14	6	20	0	0	20	0	0
21	30020097	.	A	G	6	12	18	0	1	19	0	0
21	30025514	.	G	A	1	4	5	0	1	6	0	0
21	30026162	.	C	T	0	7	7	0	5	12	0	0
21	30031316	.	G	A	1	3	4	0	2	6	0	0
21	30031987	.	G	A	6	2	8	0	1	9	0	0
21	30032045	.	C	T	2	6	8	0	1	9	0	0
21	30116508	.	G	A	7	5	12	0	2	14	0	0
21	30181216	.	G	A	4	2	6	0	0	6	0	0
21	30195389	.	C	T	1	1	2	0	0	2	0	0
21	30201092	.	G	A	9	4	13	0	0	13	0	0
21	30201235	.	C	T	1	2	3	0	0	3	0	0
21	30206393	.	A	T	0	3	3	0	1	4	0	0
21	30208255	.	G	A	0	5	5	0	7	12	0	0
21	30232112	.	T	G	16	9	25	0	0	25	0	0
21	30232187	.	C	T	13	16	29	0	0	29	0	0
21	30232212	.	C	T	13	17	30	0	1	31	0	0
21	30232304	.	C	T	1	1	2	0	1	3	0	0
21	30232307	.	C	T	2	0	2	0	0	2	0	0
21	30236791	.	C	A	3	3	6	0	0	6	0	0
21	30239975	.	A	C	8	16	24	0	1	25	0	0
21	30240378	.	C	A	17	17	34	0	1	35	0	0
21	30240400	.	T	G	14	14	28	0	4	32	0	0
21	30244739	.	G	T	7	11	18	0	0	18	0	0
21	30246684	.	A	G	3	5	8	0	1	9	0	0
21	30253692	.	A	G	7	8	15	0	0	15	0	0
21	30253884	.	A	G	5	5	10	0	0	10	0	0
21	30253942	.	A	C	3	5	8	0	0	9	1	0
21	30253954	.	A	C	2	7	9	0	0	9	0	0
21	30260961	.	C	T	1	9	10	0	9	19	0	0
21	30270015	.	C	G	0	1	1	0	8	9	0	0
21	30270024	.	A	C	2	0	2	0	4	7	1	0
21	30273366	.	C	A	3	4	7	0	0	7	0	0
21	30299416	.	T	C	3	1	4	0	0	4	0	0
21	30299561	.	T	C	16	7	23	0	1	24	0	0
21	30299679	.	A	T	3	8	11	0	0	11	0	0
21	30299735	.	C	T	6	3	9	0	2	11	0	0
21	30478522	.	A	C	3	1	4	0	0	4	0	0
21	30478536	.	G	A	0	3	3	0	1	4	0	0
21	30693311	.	A	G	1	6	7	0	1	8	0	0
21	30693312	.	A	G	3	4	7	0	1	8	0	0
21	30694222	.	A	G	1	2	3	0	0	3	0	0
21	32281076	.	G	A	8	10	18	0	0	18	0	0
21	32281122	.	G	A	9	16	25	0	1	26	0	0
21	32281155	.	G	A	9	17	26	0	0	26	0	0
21	32281680	.	C	T	2	2	4	0	0	4	0	0
21	32283519	.	G	A	2	1	3	0	0	3	0	0
21	32284398	.	A	G	3	5	8	0	0	8	0	0
21	32285080	.	C	T	3	4	7	0	0	7	0	0
21	32285161	.	A	G	2	2	4	0	0	4	0	0
21	32343230	.	C	A	1	3	4	0	1	5	0	0
21	32343248	.	C	A	4	5	9	0	0	9	0	0
21	32343316	.	T	A	7	12	19	0	0	19	0	0
21	32343453	.	C	T	9	13	22	0	2	24	0	0
21	32343649	.	C	A	7	7	14	0	3	17	0	0
21	32344021	.	C	A	9	6	15	0	0	15	0	0
21	32345162	.	T	C	9	4	13	0	0	13	0	0
21	32345318	.	G	A	0	6	6	0	6	12	0	0
21	32345499	.	A	G	8	9	17	0	0	17	0	0
21	32345607	.	C	T	9	11	20	0	2	22	0	0
21	32345724	.	A	G	9	3	12	0	0	12	0	0
21	32345749	.	A	G	6	4	10	0	0	10	0	0
21	32345774	.	A	T	5	8	13	0	1	14	0	0
21	32345827	.	C	A	8	4	12	0	0	12	0	0
21	32346021	.	A	C	5	5	10	0	1	11	0	0
21	32346273	.	G	A	16	20	36	0	2	38	0	0
21	32346603	.	G	C	10	18	28	0	0	28	0	0
21	32346630	.	T	C	7	21	28	0	2	30	0	0
21	32346674	.	T	A	9	15	24	0	2	26	0	0
21	32346689	.	A	G	8	10	18	0	3	21	0	0
21	32346799	.	G	A	7	16	23	0	0	23	0	0
21	32346800	.	T	A	5	16	21	0	2	23	0	0
21	32346899	.	A	G	14	10	24	0	1	25	0	0
21	32346901	.	A	G	14	10	24	0	1	25	0	0
21	32347134	.	T	A	9	20	29	0	1	30	0	0
21	32347569	.	G	T	13	14	27	0	0	27	0	0
21	32347855	.	T	C	7	7	14	0	1	15	0	0
21	32348230	.	A	T	9	4	13	0	0	13	0	0
21	32348321	.	C	A	2	2	4	0	0	4	0	0
21	32348512	.	G	T	7	11	18	0	0	18	0	0
21	32348542	.	A	T	9	13	22	0	1	23	0	0
21	32348570	.	C	T	7	7	14	0	0	14	0	0
21	32348600	.	C	T	6	5	11	0	1	12	0	0
21	32348664	.	G	A	8	5	13	0	0	13	0	0
21	32353049	.	G	A	2	2	4	0	0	4	0	0
21	32354980	.	A	G	0	7	7	0	0	7	0	0
21	32374460	.	A	T	1	2	3	0	0	3	0	0
21	32457785	.	T	C	10	11	21	0	0	21	0	0
21	32457923	.	C	A	15	15	30	0	0	30	0	0
21	32457931	.	T	G	15	14	29	0	1	30	0	0
21	32457983	.	G	A	13	18	31	0	2	33	0	0
21	32458261	.	A	G	21	23	44	0	0	44	0	0
21	32458315	.	T	A	14	19	33	0	1	35	1	0
21	32460782	.	G	C	1	1	2	0	0	2	0	0
21	32460912	.	A	G	9	8	17	0	1	18	0	0
21	32466140	.	G	C	1	4	5	0	1	6	0	0
21	32467660	.	A	G	3	13	16	0	1	17	0	0
21	32467724	.	T	C	10	12	22	0	0	22	0	0
21	32476760	.	A	G	19	32	51	0	1	52	0	0
21	32477584	.	T	C	21	20	41	0	5	46	0	0
21	32477967	.	C	T	14	19	33	0	4	37	0	0
21	32477987	.	A	T	16	11	27	0	9	36	0	0
21	32478227	.	G	T	13	12	25	0	0	25	0	0
21	32482797	.	C	T	8	5	13	0	1	14	0	0
21	32482854	.	T	C	18	1	19	0	20	40	1	0
21	32758351	.	C	T	13	10	23	0	0	23	0	0
21	32758584	.	G	A	11	12	23	0	2	25	0	0
21	32759104	.	C	A	10	2	12	0	3	15	0	0
21	32759421	.	C	T	8	6	14	0	1	15	0	0
21	32766389	.	G	A	3	4	7	0	3	10	0	0
21	33058940	.	G	C	9	8	17	0	1	18	0	0
21	33066214	.	T	G	2	0	2	0	2	4	0	0
21	33069896	.	A	G	3	2	5	0	1	6	0	0
21	33211266	.	A	G	2	2	4	0	0	4	0	0
21	33211296	.	T	C	3	3	6	0	1	7	0	0
21	33211506	.	T	A	8	12	20	0	1	21	0	0
21	33211568	.	C	T	8	8	16	0	0	16	0	0
21	33211664	.	T	G	10	6	16	0	2	18	0	0
21	33211720	.	A	T	4	8	12	0	0	12	0	0
21	33211809	.	A	T	13	15	28	0	1	29	0	0
21	33213315	.	C	T	6	6	12	0	0	12	0	0
21	33218312	.	T	C	2	1	3	0	0	3	0	0
21	33218405	.	G	A	3	5	8	0	0	8	0	0
21	33447251	.	A	G	12	12	24	0	4	28	0	0
21	33463486	.	A	G	3	1	4	0	0	4	0	0
21	34001982	.	C	T	19	7	26	0	2	28	0	0
21	34002041	.	C	A	11	11	22	0	2	24	0	0
21	34002154	.	A	C	9	4	13	0	0	13	0	0
21	34002155	.	A	T	9	4	13	0	0	13	0	0
21	34002333	.	T	C	8	3	11	0	0	11	0	0
21	34002455	.	G	A	5	7	12	0	0	14	2	0
21	34002507	.	A	G	9	9	18	0	1	19	0	0
21	34031232	.	G	A	1	3	4	0	0	4	0	0
21	34057611	.	T	G	1	5	6	0	0	6	0	0
21	34074618	.	A	G	5	13	18	0	0	18	0	0
21	34103275	.	G	A	0	3	3	0	3	6	0	0
21	34128660	.	A	G	5	4	9	0	1	10	0	0
21	34129073	.	G	C	15	15	30	0	2	32	0	0
21	34129195	.	G	T	13	14	27	0	0	27	0	0
21	34129279	.	A	G	9	25	34	0	2	36	0	0
21	34129401	.	T	A	6	2	8	0	1	9	0	0
21	34129629	.	A	G	1	2	3	0	0	3	0	0
21	34199704	.	T	C	3	2	5	0	0	5	0	0
21	34210970	.	G	A	6	3	9	0	0	9	0	0
21	34211206	.	T	C	6	12	18	0	1	19	0	0
21	34211344	.	G	A	18	7	25	0	2	27	0	0
21	34211418	.	G	A	1	9	10	0	2	12	0	0
21	34211427	.	A	C	2	7	9	0	1	10	0	0
21	34211511	.	A	T	3	6	9	0	1	10	0	0
21	34364595	.	G	A	3	9	12	0	1	13	0	0
21	34364774	.	G	A	3	3	6	0	0	6	0	0
21	34364962	.	G	T	15	10	25	0	3	28	0	0
21	34391104	.	C	T	5	3	8	0	0	8	0	0
21	34391155	.	T	C	0	1	1	0	0	1	0	0
21	34392786	.	C	T	1	0	1	0	1	2	0	0
21	34392828	.	G	T	4	2	6	0	2	8	0	0
21	34424116	.	A	G	2	3	5	0	1	6	0	0
21	34430533	.	A	G	3	3	6	0	1	7	0	0
21	34430544	.	A	G	2	4	6	0	1	7	0	0
21	34714359	.	G	A	0	5	5	0	1	6	0	0
21	34714403	.	C	A	2	3	5	0	0	5	0	0
21	34724797	.	G	A	1	2	3	0	0	3	0	0
21	34724956	.	C	T	3	2	5	0	0	5	0	0
21	34741120	.	T	C	0	1	1	0	0	1	0	0
21	34770460	.	G	A	1	2	3	0	0	3	0	0
21	34770483	.	G	A	1	1	2	0	1	3	0	0
21	34770510	.	C	T	0	2	2	0	1	3	0	0
21	34792896	.	G	A	3	1	4	0	1	5	0	0
21	34793224	.	C	T	13	12	25	0	1	26	0	0
21	34793405	.	C	T	11	11	22	0	1	23	0	0
21	34793660	.	T	A	6	4	10	0	1	11	0	0
21	34793753	.	A	C	3	7	10	0	0	10	0	0
21	34834508	.	T	A	1	3	4	0	0	4	0	0
21	34879230	.	C	T	0	2	2	0	1	3	0	0
21	34987505	.	C	T	4	4	8	0	0	8	0	0
21	34987612	.	G	A	0	3	3	0	3	6	0	0
21	34987662	.	G	T	4	2	6	0	0	6	0	0
21	35009706	.	C	T	0	1	1	0	0	1	0	0
21	35010135	.	A	T	0	1	1	0	0	1	0	0
21	35013762	.	A	G	1	3	4	0	0	4	0	0
21	35033847	.	G	A	1	2	3	0	0	3	0	0
21	35033853	.	G	A	0	2	2	0	1	3	0	0
21	35040310	.	C	T	4	4	8	0	0	8	0	0
21	35054879	.	G	A	3	5	8	0	0	8	0	0
21	35054892	.	G	A	2	6	8	0	0	8	0	0
21	36598347	.	T	G	0	5	5	0	0	5	0	0
21	37067216	.	G	A	5	2	7	0	1	8	0	0
21	37107035	.	T	A	12	16	28	0	2	31	1	0
21	37107307	.	G	A	13	4	17	0	0	17	0	0
21	37107432	.	A	T	6	6	12	0	1	13	0	0
21	37107614	.	T	C	7	6	13	0	0	13	0	0
21	37107861	.	T	C	6	12	18	0	1	19	0	0
21	37108022	.	A	G	12	10	22	1	1	24	0	0
21	37108204	.	A	T	14	18	32	0	0	32	0	0
21	37637792	.	G	A	6	6	12	0	0	12	0	0
21	37637794	.	A	T	6	6	12	0	0	12	0	0
21	37640005	.	G	A	1	2	3	0	0	3	0	0
21	37687084	.	G	A	3	2	5	0	0	5	0	0
21	37687099	.	C	T	4	2	6	0	1	7	0	0
21	37687523	.	G	A	8	6	14	0	2	16	0	0
21	37687729	.	C	T	4	12	16	0	0	16	0	0
21	37687876	.	T	C	0	5	5	0	0	5	0	0
21	37689192	.	T	G	3	3	6	1	0	7	0	0
21	37690468	.	T	C	4	2	6	0	0	6	0	0
21	37733096	.	C	T	0	2	2	0	0	2	0	0
21	38013631	.	T	C	4	4	8	0	0	8	0	0
21	38587378	.	T	C	4	9	13	0	0	13	0	0
21	40045441	.	T	C	5	4	9	0	0	9	0	0
21	40045569	.	G	T	10	13	23	0	1	24	0	0
21	40045665	.	G	A	16	13	29	0	1	30	0	0
21	40045701	.	G	A	10	15	25	0	0	25	0	0
21	40045754	.	G	A	2	4	6	0	0	6	0	0
21	40048981	.	C	A	0	1	1	0	0	1	0	0
21	40049524	.	A	G	1	2	3	0	0	3	0	0
21	40049556	.	T	G	5	5	10	0	0	10	0	0
21	40049606	.	T	G	3	2	5	0	0	5	0	0
21	40119253	.	A	G	0	1	1	0	0	1	0	0
21	40355063	.	A	C	8	4	12	0	0	12	0	0
21	40355102	.	G	A	3	8	11	0	0	11	0	0
21	40355539	.	G	T	9	7	16	0	1	17	0	0
21	40355968	.	T	A	6	9	15	0	0	15	0	0
21	40364758	.	C	A	2	5	7	0	0	7	0	0
21	40365356	.	G	T	3	2	5	0	2	7	0	0
21	40368568	.	A	G	0	1	1	0	1	2	0	0
21	40369108	.	C	T	0	3	3	0	2	5	0	0
21	40373048	.	G	T	1	1	2	0	1	3	0	0
21	40373049	.	G	T	1	2	3	0	0	3	0	0
21	40373137	.	C	T	0	3	3	0	2	5	0	0
21	40377861	.	A	G	1	2	3	0	0	3	0	0
21	40381967	.	C	T	1	1	2	0	0	2	0	0
21	40402659	.	A	G	2	6	8	0	0	8	0	0
21	40402864	.	C	T	0	9	9	0	12	21	0	0
21	40403423	.	A	G	8	7	15	0	1	16	0	0
21	40403465	.	G	A	7	14	21	0	0	21	0	0
21	40403581	.	G	C	6	3	9	0	0	9	0	0
21	40406796	.	C	A	7	3	10	0	0	10	0	0
21	40410983	.	T	A	1	1	2	0	0	2	0	0
21	40411034	.	G	A	1	2	3	0	0	3	0	0
21	40466893	.	C	T	1	2	3	0	3	6	0	0
21	40474875	.	G	A	3	5	8	0	1	9	0	0
21	40475427	.	C	T	6	6	12	0	1	13	0	0
21	40475563	.	C	G	5	7	12	0	2	14	0	0
21	40475579	.	G	T	10	4	14	0	1	15	0	0
21	40528986	.	C	T	20	20	40	0	1	41	0	0
21	40531316	.	C	T	15	9	24	0	0	24	0	0
21	40531615	.	G	A	8	11	19	0	3	22	0	0
21	40531971	.	A	T	5	3	8	0	0	8	0	0
21	40531993	.	G	A	4	4	8	0	0	8	0	0
21	40532147	.	A	G	5	8	13	0	1	14	0	0
21	40532204	.	A	G	4	2	6	0	1	7	0	0
21	40532368	.	T	C	2	3	5	0	0	5	0	0
21	40532584	.	T	G	6	7	13	0	0	13	0	0
21	40532848	.	G	A	7	3	10	0	0	10	0	0
21	40532891	.	A	G	5	2	7	0	0	7	0	0
21	40532931	.	G	C	5	5	10	0	0	10	0	0
21	40533039	.	T	C	3	3	6	0	0	6	0	0
21	40533165	.	A	G	2	3	5	0	0	5	0	0
21	40537149	.	C	T	2	8	10	0	1	11	0	0
21	40537152	.	G	A	3	8	11	0	0	11	0	0
21	40546922	.	T	C	4	6	10	0	0	10	0	0
21	40547729	.	G	A	1	3	4	0	0	4	0	0
21	40553356	.	G	T	1	0	1	0	0	1	0	0
21	40553365	.	C	T	0	0	0	0	1	1	0	0
21	40685948	.	A	G	5	0	5	0	8	13	0	0
21	40685964	.	A	C	4	8	12	0	0	12	0	0
21	40686109	.	G	A	2	4	6	0	0	6	0	0
21	40686158	.	T	A	3	5	8	0	0	8	0	0
21	40686170	.	T	A	3	4	7	0	0	7	0	0
21	40709069	.	G	A	5	2	7	0	3	10	0	0
21	40709140	.	A	T	8	6	14	0	1	15	0	0
21	40714691	.	C	T	11	6	17	0	0	17	0	0
21	40715622	.	A	G	0	1	1	0	0	1	0	0
21	40715730	.	T	C	6	4	10	0	1	11	0	0
21	40715808	.	A	G	2	2	4	0	0	4	0	0
21	40731482	.	A	G	0	1	1	0	0	1	0	0
21	40959280	.	A	T	2	1	3	0	0	3	0	0
21	41028902	.	A	G	4	6	10	0	0	10	0	0
21	41034863	.	A	G	1	1	2	0	0	2	0	0
21	41046647	.	T	A	0	2	2	0	0	2	0	0
21	41046745	.	T	A	3	2	5	0	0	5	0	0
21	41046746	.	G	C	3	2	5	0	0	5	0	0
21	41049005	.	G	A	1	1	2	0	0	2	0	0
21	41049488	.	A	G	1	1	2	0	0	2	0	0
21	41256821	.	C	T	1	7	8	0	9	17	0	0
21	41257136	.	A	G	40	13	53	0	0	53	0	0
21	41257157	.	C	G	35	14	49	0	0	49	0	0
21	41257228	.	T	G	32	17	49	0	5	54	0	0
21	41257256	.	T	C	19	27	46	0	4	50	0	0
21	41257357	.	G	A	34	26	60	0	4	64	0	0
21	41257374	.	C	T	30	33	63	0	2	65	0	0
21	41257599	.	T	A	32	20	52	0	2	54	0	0
21	41293435	.	G	A	7	8	15	0	2	17	0	0
21	41305128	.	G	T	2	1	3	0	2	5	0	0
21	41305269	.	C	T	2	0	2	0	0	2	0	0
21	41305271	.	C	T	0	2	2	0	0	2	0	0
21	41311133	.	C	A	6	3	9	0	1	10	0	0
21	41311605	.	A	G	13	17	30	0	1	31	0	0
21	41311922	.	G	A	11	16	27	0	1	28	0	0
21	41312058	.	A	T	16	12	28	0	2	30	0	0
21	41367563	.	T	G	1	1	2	0	4	6	0	0
21	41367568	.	T	G	0	0	0	0	6	6	0	0
21	41598942	.	G	C	16	8	24	0	0	24	0	0
21	41599060	.	T	C	7	23	30	0	3	33	0	0
21	42046969	.	G	A	0	6	6	5	0	12	1	0
21	42051103	.	T	G	3	0	3	0	7	10	0	0
21	42778937	.	G	A	2	6	8	0	0	8	0	0
21	42779684	.	G	T	1	2	3	0	0	3	0	0
21	43476276	.	T	C	10	10	20	0	2	22	0	0
21	43477593	.	T	C	10	6	16	0	1	18	1	0
21	43505943	.	T	C	1	4	5	0	1	6	0	0
21	43506620	.	A	G	3	1	4	0	1	5	0	0
21	43506980	.	G	A	2	2	4	0	0	4	0	0
21	43507055	.	A	G	2	3	5	0	1	6	0	0
21	43507058	.	C	T	1	4	5	0	0	5	0	0
21	43507114	.	T	G	3	5	8	0	0	8	0	0
21	43507768	.	C	A	2	4	6	0	0	6	0	0
21	43508200	.	C	T	3	2	5	0	0	5	0	0
21	43508356	.	C	T	1	3	4	0	0	4	0	0
21	43508408	.	C	A	1	2	3	0	0	3	0	0
21	43515778	.	A	T	2	6	8	0	0	8	0	0
21	43524271	.	G	A	4	5	9	0	2	11	0	0
21	43524778	.	T	C	12	5	17	0	0	17	0	0
21	43525522	.	A	G	3	6	9	0	0	9	0	0
21	43525909	.	C	T	0	3	3	0	1	4	0	0
21	43525978	.	G	A	4	2	6	0	0	6	0	0
21	43536532	.	A	G	2	3	5	0	0	5	0	0
21	43536592	.	G	A	1	2	3	0	0	3	0	0
21	43581478	.	A	G	5	12	17	0	0	17	0	0
21	43581505	.	T	C	4	0	4	0	12	16	0	0
21	43581606	.	A	G	9	16	25	0	0	25	0	0
21	43584745	.	G	A	9	11	20	0	3	23	0	0
21	43584822	.	A	G	6	17	23	0	0	23	0	0
21	43586774	.	C	T	1	11	12	0	8	20	0	0
21	43588112	.	T	C	3	2	5	0	0	5	0	0
21	43588136	.	G	C	1	0	1	0	2	3	0	0
21	43595318	.	G	A	3	5	8	0	2	10	0	0
21	43595384	.	C	T	1	0	1	0	1	2	0	0
21	43606392	.	T	A	1	0	1	0	0	1	0	0
21	43695580	.	T	C	1	2	3	0	0	3	0	0
21	43705848	.	G	A	0	4	4	0	3	7	0	0
21	43705866	.	G	A	2	4	6	0	0	6	0	0
21	43705893	.	C	T	1	1	2	0	0	2	0	0
21	43709743	.	T	C	1	1	2	0	0	2	0	0
21	43710834	.	A	C	1	8	9	0	0	9	0	0
21	43710842	.	A	G	0	0	0	0	6	6	0	0
21	43886134	.	T	G	0	2	2	0	0	2	0	0
21	43897365	.	C	T	11	19	30	0	2	32	0	0
21	43900196	.	T	C	15	17	32	0	1	33	0	0
21	43906670	.	G	A	0	1	1	0	0	1	0	0
21	43920541	.	A	G	1	4	5	0	1	6	0	0
21	43926773	.	C	A	0	1	1	0	0	1	0	0
21	44005548	.	G	A	3	6	9	0	1	10	0	0
21	44005583	.	G	A	14	13	27	0	2	29	0	0
21	44005587	.	A	C	14	14	28	0	3	32	1	0
21	44005637	.	T	G	14	7	21	0	1	22	0	0
21	44022008	.	T	A	14	11	25	0	5	30	0	0
21	44022014	.	A	G	17	13	30	0	0	30	0	0
21	44025907	.	A	G	18	19	37	0	1	38	0	0
21	44028691	.	G	A	13	23	36	0	1	37	0	0
21	44028755	.	C	A	13	18	31	0	2	33	0	0
21	44031139	.	T	C	2	3	5	0	1	6	0	0
21	44031145	.	T	A	3	3	6	0	0	6	0	0
21	44036872	.	A	T	4	12	16	0	0	16	0	0
21	44036912	.	A	C	7	9	16	0	1	17	0	0
21	44036984	.	T	A	12	12	24	0	1	25	0	0
21	44037011	.	T	A	11	12	23	0	3	26	0	0
21	44037040	.	G	A	0	9	9	0	11	20	0	0
21	44037046	.	A	G	10	0	10	0	10	20	0	0
21	44037090	.	A	G	3	2	5	0	1	6	0	0
21	44037092	.	A	G	3	1	4	0	2	6	0	0
21	44687941	.	A	G	8	0	8	0	4	12	0	0
21	44687949	.	T	C	8	3	11	0	1	12	0	0
21	44688711	.	G	A	12	8	20	0	0	20	0	0
21	44689277	.	A	T	10	4	14	0	1	15	0	0
21	44689476	.	C	T	13	5	18	0	0	18	0	0
21	44689503	.	A	T	13	6	19	0	0	19	0	0
21	44689655	.	C	T	13	4	17	0	0	17	0	0
21	44690520	.	A	G	10	2	12	0	8	20	0	0
21	44737825	.	T	C	0	3	3	0	1	4	0	0
21	45043527	.	G	T	10	4	14	0	0	14	0	0
21	45043548	.	G	A	9	3	12	0	1	13	0	0
21	45043590	.	T	C	7	1	8	0	2	10	0	0
21	45043611	.	A	G	4	3	7	0	3	10	0	0
21	45052584	.	G	A	5	5	10	0	0	10	0	0
21	45054887	.	G	A	1	1	2	0	0	2	0	0
21	45061869	.	C	T	2	1	3	0	0	3	0	0
21	45114925	.	G	A	0	2	2	0	2	4	0	0
21	45117465	.	T	C	5	5	10	0	0	10	0	0
21	45117469	.	T	G	6	4	10	0	0	10	0	0
21	45186175	.	G	A	5	6	11	0	0	11	0	0
21	45187072	.	T	G	1	3	4	0	0	4	0	0
21	45187123	.	C	T	1	2	3	0	0	3	0	0
21	45190704	.	A	G	22	32	54	0	3	57	0	0
21	45190766	.	T	A	21	29	50	0	5	55	0	0
21	45190861	.	A	T	25	24	49	0	5	54	0	0
21	45190926	.	C	T	20	27	47	0	0	47	0	0
21	45193365	.	G	A	5	1	6	0	0	6	0	0
21	45341958	.	A	T	23	25	48	0	3	51	0	0
21	45342043	.	G	T	25	36	61	0	4	65	0	0
21	45349469	.	G	A	0	2	2	0	1	3	0	0
21	45352211	.	G	A	24	7	31	0	5	36	0	0
21	45352212	.	G	A	28	7	35	0	1	36	0	0
21	45352415	.	C	T	0	11	11	0	12	23	0	0
21	45359397	.	G	A	10	16	26	0	1	27	0	0
21	45363684	.	C	T	15	12	27	0	0	27	0	0
21	45363728	.	C	T	13	11	24	0	1	25	0	0
21	45363778	.	T	G	13	15	28	0	3	31	0	0
21	45366262	.	T	A	1	2	3	0	1	4	0	0
21	45366301	.	A	C	2	5	7	0	1	8	0	0
21	45374375	.	A	G	6	5	11	0	1	12	0	0
21	45374413	.	C	A	5	8	13	0	0	13	0	0
21	45374509	.	T	C	4	6	10	0	0	10	0	0
21	45374583	.	A	T	1	5	6	0	0	6	0	0
21	45374725	.	G	A	5	6	11	0	0	11	0	0
21	45374747	.	T	G	7	5	12	0	0	12	0	0
21	45377351	.	G	T	5	6	11	0	1	12	0	0
21	45377404	.	T	C	9	10	19	0	0	19	0	0
21	45377409	.	T	C	9	8	17	0	1	18	0	0
21	45377546	.	G	A	17	13	30	0	1	31	0	0
21	45377604	.	T	G	12	5	17	0	0	17	0	0
21	45377685	.	G	A	19	13	32	0	1	33	0	0
21	45382162	.	G	A	2	3	5	0	0	5	0	0
21	45544108	.	C	T	3	3	6	0	0	6	0	0
21	45544374	.	C	T	1	6	7	0	2	9	0	0
21	45547147	.	C	T	3	4	7	0	0	7	0	0
21	45549075	.	A	G	0	2	2	0	0	2	0	0
21	45550066	.	G	A	0	6	6	0	3	9	0	0
21	45550244	.	C	G	4	3	7	0	1	8	0	0
21	45550354	.	C	T	2	2	4	0	0	4	0	0
21	45550928	.	A	T	5	5	10	0	1	11	0	0
21	45551011	.	T	A	4	4	8	0	0	8	0	0
21	45551014	.	T	C	4	4	8	0	0	8	0	0
21	45551095	.	A	C	3	3	6	0	0	6	0	0
21	45551096	.	G	A	3	3	6	0	0	6	0	0
21	45551386	.	G	C	2	5	7	0	0	7	0	0
21	45551391	.	A	G	3	5	8	0	0	8	0	0
21	45551421	.	T	C	3	3	6	0	0	6	0	0
21	45551606	.	T	A	3	2	5	0	1	6	0	0
21	45551620	.	C	T	5	3	8	0	0	8	0	0
21	45551785	.	G	A	5	6	11	0	2	13	0	0
21	45551845	.	C	T	1	3	4	0	0	4	0	0
21	45551972	.	G	A	0	9	9	0	8	17	0	0
21	45552187	.	T	C	7	15	22	0	1	23	0	0
21	45552282	.	T	C	9	9	18	0	0	18	0	0
21	45552286	.	C	T	9	8	17	0	0	17	0	0
21	45552676	.	G	A	14	11	25	0	1	26	0	0
21	45552924	.	C	T	9	9	18	0	1	19	0	0
21	45582048	.	T	C	8	8	16	0	3	19	0	0
21	45582907	.	A	G	0	5	5	0	0	5	0	0
21	45582931	.	G	A	1	2	3	0	0	3	0	0
21	45584817	.	C	T	0	1	1	0	0	1	0	0
21	45591105	.	A	G	3	3	6	0	0	6	0	0
21	45599379	.	G	A	0	1	1	0	0	1	0	0
21	45632793	.	A	G	5	2	7	0	0	7	0	0
21	45632866	.	T	C	6	3	9	0	0	9	0	0
21	45673667	.	T	A	21	12	33	0	7	40	0	0
21	45673826	.	G	A	18	15	33	0	2	35	0	0
21	45674321	.	T	C	11	31	42	0	2	44	0	0
21	45694166	.	C	T	0	1	1	0	2	3	0	0
21	45696135	.	C	T	2	2	4	0	0	4	0	0
21	45696164	.	G	A	0	2	2	0	2	4	0	0
21	45699347	.	T	A	4	5	9	0	0	9	0	0
21	45703316	.	T	C	1	4	5	0	0	5	0	0
21	45704975	.	C	T	0	3	3	0	0	3	0	0
21	45704999	.	C	T	0	2	2	0	0	2	0	0
21	45705267	.	T	C	4	5	9	0	0	9	0	0
21	45705276	.	T	C	4	6	10	0	0	10	0	0
21	45705375	.	A	G	2	4	6	0	1	7	0	0
21	45705948	.	T	C	2	1	3	0	0	3	0	0
21	45707154	.	T	C	1	2	3	0	0	3	0	0
21	45707734	.	T	C	3	2	5	0	0	5	0	0
21	45714390	.	T	C	0	8	8	0	1	9	0	0
21	45715241	.	T	C	15	16	31	0	5	36	0	0
21	45715271	.	G	A	8	8	16	0	24	40	0	0
21	45715558	.	G	C	15	2	17	0	1	18	0	0
21	45716032	.	T	C	8	5	13	1	1	15	0	0
21	45716112	.	A	G	3	6	9	0	0	9	0	0
21	45719205	.	T	G	5	0	5	0	11	16	0	0
21	45721245	.	T	C	4	4	8	0	1	9	0	0
21	45721246	.	C	G	5	0	5	0	4	9	0	0
21	45721760	.	G	A	5	4	9	0	0	9	0	0
21	45723174	.	G	C	1	1	2	0	0	2	0	0
21	45726391	.	C	T	2	1	3	0	0	3	0	0
21	45726600	.	C	T	2	4	6	0	0	6	0	0
21	45728723	.	T	G	15	17	32	0	2	34	0	0
21	45728774	.	T	C	9	8	17	0	2	19	0	0
21	45729365	.	C	G	5	10	15	0	2	17	0	0
21	45730150	.	G	C	21	19	40	0	4	44	0	0
21	45732018	.	C	G	9	14	23	0	2	25	0	0
21	45733905	.	C	T	6	4	10	0	0	10	0	0
21	45734044	.	T	C	2	1	3	0	1	4	0	0
21	45735918	.	G	A	0	2	2	0	2	4	0	0
21	45736157	.	T	G	9	0	9	0	11	20	0	0
21	45736179	.	T	C	7	10	17	0	1	18	0	0
21	45736244	.	T	C	11	9	20	0	4	24	0	0
21	45736463	.	T	A	7	4	11	0	0	11	0	0
21	45737960	.	T	G	7	4	11	0	0	11	0	0
21	45738043	.	T	C	5	6	11	0	1	12	0	0
21	45738046	.	T	C	5	6	11	0	1	12	0	0
21	45738125	.	C	T	4	5	9	0	0	9	0	0
21	45738525	.	G	A	0	10	10	0	16	26	0	0
21	45738592	.	T	C	6	7	13	0	1	14	0	0
21	45738658	.	A	C	10	8	18	0	1	19	0	0
21	45738775	.	A	G	8	7	15	0	3	18	0	0
21	45738852	.	G	A	18	13	31	0	2	33	0	0
21	45738856	.	C	T	18	12	30	0	2	32	0	0
21	45739074	.	A	C	8	13	21	0	1	22	0	0
21	45739087	.	A	C	11	13	24	0	1	25	0	0
21	45739125	.	A	G	16	11	27	0	2	29	0	0
21	45739139	.	C	T	16	9	25	0	1	26	0	0
21	45739169	.	T	A	13	8	21	0	0	22	1	0
21	45739235	.	T	C	14	8	22	0	4	26	0	0
21	45739519	.	C	G	20	8	28	0	0	28	0	0
21	45739613	.	A	T	14	9	23	0	1	24	0	0
21	45739642	.	G	A	0	8	8	0	20	28	0	0
21	45739724	.	A	T	17	17	34	0	2	36	0	0
21	45760767	.	G	A	0	0	0	0	1	1	0	0
21	45761690	.	A	T	1	2	3	0	0	3	0	0
21	45767470	.	C	A	1	3	4	0	0	4	0	0
21	45767716	.	C	A	1	3	4	0	1	5	0	0
21	45767965	.	A	T	5	5	10	0	1	11	0	0
21	45768031	.	G	A	0	2	2	0	5	7	0	0
21	45768043	.	T	C	5	2	7	0	0	7	0	0
21	45768114	.	G	C	5	2	7	0	0	7	0	0
21	45768220	.	A	G	1	6	7	0	0	7	0	0
21	45768260	.	T	A	2	4	6	0	0	6	0	0
21	45768462	.	A	G	9	6	15	0	0	15	0	0
21	45768597	.	G	C	6	4	10	0	1	11	0	0
21	45769130	.	C	G	13	4	17	0	1	18	0	0
21	45769199	.	C	A	11	10	21	0	0	21	0	0
21	45838304	.	C	T	12	19	31	0	1	32	0	0
21	45839258	.	A	G	10	12	22	0	2	24	0	0
21	45840307	.	C	A	0	6	6	0	9	15	0	0
21	45840317	.	G	T	9	5	14	0	1	15	0	0
21	45848701	.	T	C	8	5	13	0	0	13	0	0
21	45850905	.	G	A	0	7	7	0	10	17	0	0
21	45851180	.	T	C	5	7	12	0	1	13	0	0
21	45851493	.	A	T	20	8	28	0	1	29	0	0
21	45851496	.	A	C	20	8	28	0	1	29	0	0
21	45851563	.	A	C	21	13	34	0	1	35	0	0
21	45851925	.	C	G	3	0	3	0	3	6	0	0
21	45851930	.	G	A	0	3	3	0	3	6	0	0
21	45856614	.	G	A	5	3	8	0	0	8	0	0
21	45857954	.	T	G	8	7	15	0	1	16	0	0
21	45858021	.	A	G	0	2	2	0	0	2	0	0
21	45859589	.	C	T	4	5	9	0	1	10	0	0
21	45860602	.	A	G	1	0	1	0	0	1	0	0
21	45863053	.	G	A	4	14	18	0	0	18	0	0
21	45865174	.	C	T	6	7	13	0	0	13	0	0
21	45866065	.	G	A	11	5	16	0	0	17	1	0
21	45866066	.	G	A	9	6	15	0	2	17	0	0
21	45875861	.	C	T	0	9	9	0	3	12	0	0
21	45875870	.	A	T	3	7	10	0	2	12	0	0
21	45876230	.	T	C	6	9	15	0	0	15	0	0
21	45876253	.	A	T	5	10	15	0	2	17	0	0
21	45876638	.	A	G	15	0	15	0	4	37	18	0
21	45876642	.	C	A	0	18	18	0	20	38	0	0
21	45884210	.	A	G	3	5	8	0	0	8	0	0
21	45905088	.	T	C	5	3	8	0	0	8	0	0
21	45905257	.	C	G	2	2	4	0	1	5	0	0
21	45914107	.	C	A	0	1	1	0	0	1	0	0
21	45914182	.	A	G	0	1	1	0	1	2	0	0
21	45918739	.	A	G	2	2	4	0	0	4	0	0
21	45919139	.	G	T	2	3	5	0	0	5	0	0
21	45919290	.	C	T	3	4	7	0	0	7	0	0
22	336325	.	T	C	12	24	36	1	0	37	0	0
22	336982	.	C	T	17	13	30	0	2	32	0	0
22	337540	.	A	T	16	14	30	0	1	31	0	0
22	337970	.	C	G	11	4	15	0	1	16	0	0
22	338187	.	G	A	8	10	18	0	0	18	0	0
22	338199	.	G	T	0	10	10	0	5	15	0	0
22	338226	.	C	T	6	6	12	0	0	12	0	0
22	338431	.	C	T	12	11	23	0	0	23	0	0
22	338564	.	C	A	1	4	5	0	1	6	0	0
22	581977	.	C	T	3	2	5	0	0	5	0	0
22	711071	.	A	G	26	23	49	0	4	53	0	0
22	711475	.	T	C	5	4	9	0	0	9	0	0
22	711787	.	A	T	26	17	43	0	0	43	0	0
22	712187	.	G	T	19	14	33	0	3	36	0	0
22	724890	.	A	C	0	5	5	0	0	5	0	0
22	729619	.	C	A	0	2	2	0	0	2	0	0
22	732142	.	G	A	0	4	4	0	6	10	0	0
22	732149	.	G	T	0	4	4	0	6	10	0	0
22	732398	.	T	G	0	4	4	0	1	5	0	0
22	744646	.	T	C	2	3	5	0	0	5	0	0
22	745380	.	C	T	5	8	13	0	2	15	0	0
22	745425	.	A	C	3	3	6	0	0	6	0	0
22	748837	.	C	T	4	13	17	0	2	19	0	0
22	748951	.	T	C	3	2	5	0	0	5	0	0
22	750695	.	T	C	4	1	5	0	0	5	0	0
22	750699	.	G	A	0	2	2	0	4	6	0	0
22	750759	.	C	A	2	12	14	0	0	14	0	0
22	750770	.	C	G	4	12	16	0	0	16	0	0
22	750863	.	T	C	2	3	5	0	0	5	0	0
22	751075	.	A	G	0	3	3	0	0	3	0	0
22	753210	.	C	T	7	9	16	0	0	16	0	0
22	753219	.	T	C	7	9	16	0	0	16	0	0
22	774949	.	G	C	14	9	23	0	3	26	0	0
22	775085	.	G	A	8	8	16	0	0	16	0	0
22	777072	.	G	A	0	1	1	0	0	1	0	0
22	797196	.	G	T	0	5	5	0	9	14	0	0
22	797255	.	T	C	3	2	5	0	0	5	0	0
22	799595	.	A	G	13	1	14	0	10	24	0	0
22	799712	.	C	T	4	10	14	0	1	15	0	0
22	806155	.	C	T	7	3	10	0	4	14	0	0
22	808015	.	T	A	7	7	14	0	0	14	0	0
22	808032	.	T	C	8	11	19	0	0	19	0	0
22	808069	.	T	A	12	4	16	0	2	18	0	0
22	808077	.	A	G	9	0	9	0	5	14	0	0
22	819787	.	G	A	3	2	5	0	0	5	0	0
22	820459	.	G	T	2	0	2	0	2	4	0	0
22	820660	.	A	G	3	1	4	0	0	4	0	0
22	825091	.	T	A	10	8	18	0	0	18	0	0
22	825130	.	G	A	5	11	16	0	2	18	0	0
22	827309	.	G	A	6	2	8	0	0	8	0	0
22	828235	.	C	G	2	5	7	0	1	8	0	0
22	831180	.	C	T	0	1	1	0	3	4	0	0
22	831185	.	C	T	2	2	4	0	1	5	0	0
22	831575	.	C	T	1	1	2	0	0	2	0	0
22	857511	.	C	G	6	7	13	0	0	13	0	0
22	857572	.	A	T	4	9	13	0	2	15	0	0
22	857720	.	A	G	7	8	15	0	0	15	0	0
22	860224	.	G	A	3	4	7	0	0	7	0	0
22	860236	.	G	A	3	3	6	0	0	6	0	0
22	868195	.	C	A	12	7	19	0	2	21	0	0
22	868321	.	T	C	5	12	17	0	4	21	0	0
22	869584	.	C	T	3	6	9	0	0	9	0	0
22	869739	.	G	A	3	6	9	0	0	9	0	0
22	869793	.	C	A	6	4	10	0	0	10	0	0
22	869798	.	G	T	6	4	10	0	0	10	0	0
22	876959	.	C	G	0	0	0	0	1	1	0	0
22	877886	.	G	A	4	3	7	0	0	7	0	0
22	877898	.	C	T	0	4	4	0	4	8	0	0
22	877922	.	C	T	2	5	7	0	0	7	0	0
22	912528	.	G	A	1	1	2	0	0	2	0	0
22	912531	.	T	A	1	1	2	0	0	2	0	0
22	912563	.	T	C	1	1	2	0	0	2	0	0
22	1203320	.	A	T	12	6	18	0	0	18	0	0
22	1203373	.	A	T	10	10	20	0	3	23	0	0
22	1214535	.	T	G	1	0	1	0	0	1	0	0
22	1372968	.	G	A	1	5	6	0	0	6	0	0
22	1793776	.	G	A	3	2	5	0	0	5	0	0
22	1793791	.	A	G	2	1	3	0	0	3	0	0
22	1793817	.	C	T	4	3	7	0	1	8	0	0
22	1793842	.	A	G	2	5	7	0	0	7	0	0
22	1809319	.	C	G	1	2	3	0	0	3	0	0
22	1817701	.	T	A	1	2	3	0	0	3	0	0
22	1849115	.	G	C	3	2	5	0	0	5	0	0
22	1860867	.	G	A	2	2	4	0	0	4	0	0
22	1860922	.	G	A	2	2	4	0	0	4	0	0
22	1901238	.	T	A	2	3	5	0	0	5	0	0
22	1901245	.	T	C	1	3	4	0	1	5	0	0
22	1901428	.	C	A	1	3	4	0	0	4	0	0
22	1901456	.	C	G	1	2	3	0	0	3	0	0
22	1901516	.	T	C	2	2	4	0	0	4	0	0
22	1925132	.	T	C	2	2	4	0	0	4	0	0
22	1925182	.	A	G	5	2	7	0	0	7	0	0
22	1925228	.	G	A	0	3	3	1	5	9	0	0
22	1946691	.	C	A	3	3	6	0	0	6	0	0
22	1946723	.	C	A	4	2	6	1	0	7	0	0
22	1948847	.	A	C	3	2	5	0	0	5	0	0
22	2033740	.	C	T	1	3	4	0	0	4	0	0
22	2033767	.	G	A	3	3	6	0	1	7	0	0
22	2033908	.	C	T	3	3	6	0	1	7	0	0
22	2106657	.	G	C	1	2	3	0	0	3	0	0
22	2106806	.	A	C	2	4	6	0	0	6	0	0
22	2106814	.	G	A	0	2	2	0	4	6	0	0
22	2106868	.	A	C	2	2	4	0	1	5	0	0
22	2107104	.	G	A	0	2	2	0	1	3	0	0
22	2107146	.	G	T	0	3	3	0	0	3	0	0
22	2172090	.	C	T	3	2	5	0	0	5	0	0
22	2178221	.	T	C	1	2	3	0	0	3	0	0
22	2178333	.	A	C	0	2	2	0	0	2	0	0
22	2242763	.	C	T	3	2	5	0	0	5	0	0
22	2352130	.	G	A	0	1	1	0	0	1	0	0
22	2368037	.	C	T	2	4	6	0	0	6	0	0
22	2368161	.	C	G	3	6	9	0	0	9	0	0
22	2420325	.	A	G	3	2	5	0	0	5	0	0
22	2420623	.	C	G	2	2	4	0	1	5	0	0
22	2421028	.	A	T	2	7	9	0	0	9	0	0
22	2443865	.	T	C	2	2	4	0	0	4	0	0
22	2444186	.	G	T	5	3	8	0	0	8	0	0
22	2444234	.	G	A	2	4	6	0	0	6	0	0
22	2444303	.	G	A	4	4	8	0	0	8	0	0
22	2497872	.	T	C	1	2	3	0	1	4	0	0
22	2497976	.	G	C	1	3	4	0	0	4	0	0
22	2498567	.	G	A	2	2	4	0	0	4	0	0
22	2498601	.	C	A	1	4	5	0	0	5	0	0
22	2538440	.	T	C	2	3	5	0	0	5	0	0
22	2557876	.	C	T	1	2	3	0	0	3	0	0
22	2557879	.	G	A	1	2	3	0	0	3	0	0
22	2558279	.	A	T	6	4	10	0	1	11	0	0
22	2558344	.	G	A	5	5	10	0	3	13	0	0
22	2558386	.	C	T	2	8	10	0	1	11	0	0
22	2558416	.	A	T	1	6	7	1	0	9	1	0
22	2577040	.	C	G	3	2	5	0	1	6	0	0
22	2602437	.	G	A	1	3	4	0	0	4	0	0
22	2623062	.	G	A	2	2	4	0	0	4	0	0
22	2623083	.	G	A	1	2	3	0	0	3	0	0
22	2626968	.	G	A	0	1	1	0	1	2	0	0
22	2627567	.	C	T	6	2	8	0	2	10	0	0
22	2627736	.	A	T	4	2	6	0	0	6	0	0
22	2627773	.	A	T	3	4	7	0	0	7	0	0
22	2627853	.	C	A	0	4	4	0	0	4	0	0
22	2627864	.	A	C	0	3	3	0	1	4	0	0
22	2627903	.	G	A	5	3	8	0	0	8	0	0
22	2637827	.	T	A	1	3	4	0	0	4	0	0
22	2645741	.	C	T	0	2	2	0	0	2	0	0
22	2650072	.	T	A	0	1	1	0	0	1	0	0
22	2653023	.	T	C	5	7	12	0	0	12	0	0
22	2657856	.	G	A	0	2	2	0	1	3	0	0
22	2659103	.	A	T	2	2	4	0	1	5	0	0
22	2659111	.	G	C	3	3	6	0	0	6	0	0
22	2659152	.	A	T	2	3	5	0	0	5	0	0
22	2659153	.	C	A	2	3	5	0	0	5	0	0
22	2659463	.	C	T	0	2	2	0	0	2	0	0
22	2664411	.	G	A	2	3	5	0	1	6	0	0
22	2667992	.	T	A	1	0	1	0	0	1	0	0
22	2667993	.	T	C	1	0	1	0	0	1	0	0
22	2668031	.	G	A	1	2	3	0	0	3	0	0
22	2668043	.	C	T	1	2	3	0	0	3	0	0
22	2668262	.	A	G	1	2	3	0	0	3	0	0
22	2668352	.	C	T	1	6	7	0	0	7	0	0
22	2668467	.	G	C	0	4	4	0	4	8	0	0
22	2668486	.	G	A	3	4	7	0	0	7	0	0
22	2897681	.	A	G	18	10	28	0	2	30	0	0
22	2897742	.	G	A	14	12	26	0	2	28	0	0
22	2897997	.	G	C	8	8	16	0	1	17	0	0
22	2898089	.	C	A	1	20	21	0	15	36	0	0
22	2900999	.	G	A	4	4	8	0	1	9	0	0
22	2908264	.	T	G	0	2	2	0	0	2	0	0
22	2912869	.	G	T	2	2	4	0	0	4	0	0
22	2919050	.	A	G	2	3	5	0	0	5	0	0
22	2919501	.	C	T	3	4	7	0	0	7	0	0
22	2931544	.	T	A	4	7	11	0	1	12	0	0
22	2933861	.	G	C	4	6	10	0	1	11	0	0
22	2941886	.	C	T	5	1	6	0	0	6	0	0
22	2941888	.	C	T	5	1	6	0	0	6	0	0
22	2941929	.	C	T	0	3	3	0	1	4	0	0
22	2951416	.	C	G	0	1	1	0	3	4	0	0
22	3077864	.	T	A	2	4	6	0	1	7	0	0
22	3121191	.	T	G	6	10	16	0	2	18	0	0
22	3121451	.	C	A	1	6	7	0	13	20	0	0
22	3121531	.	A	T	5	5	10	0	2	12	0	0
22	3121683	.	T	A	6	4	10	0	1	11	0	0
22	3121725	.	T	G	6	5	11	0	1	12	0	0
22	3121789	.	A	T	12	12	24	0	3	27	0	0
22	3122004	.	A	G	4	3	7	0	0	7	0	0
22	3122258	.	C	T	13	14	27	0	0	27	0	0
22	3124031	.	G	A	5	4	9	0	0	9	0	0
22	3124132	.	G	T	7	5	12	0	0	12	0	0
22	3127257	.	T	C	2	0	2	0	1	3	0	0
22	3161346	.	C	T	7	5	12	0	0	12	0	0
22	3162335	.	T	C	3	10	13	0	0	13	0	0
22	3162405	.	G	A	3	2	5	0	0	5	0	0
22	3169448	.	C	T	0	0	0	0	2	2	0	0
22	3169529	.	T	C	1	3	4	0	0	4	0	0
22	3169723	.	T	C	1	4	5	0	0	5	0	0
22	3172774	.	C	T	2	3	5	0	0	5	0	0
22	3177227	.	A	G	0	2	2	0	0	2	0	0
22	3198047	.	C	T	0	1	1	0	0	1	0	0
22	3198266	.	T	A	0	1	1	0	0	1	0	0
22	3204054	.	G	A	1	5	6	0	1	7	0	0
22	3208281	.	A	G	8	5	13	0	1	14	0	0
22	3214279	.	G	A	2	6	8	0	0	8	0	0
22	3214309	.	G	A	4	2	6	0	1	7	0	0
22	3231677	.	T	G	9	4	13	0	1	14	0	0
22	3232370	.	T	A	2	3	5	0	0	5	0	0
22	3233413	.	G	A	0	2	2	0	0	2	0	0
22	3262925	.	C	T	0	10	10	0	7	17	0	0
22	3263129	.	T	C	9	10	19	0	2	21	0	0
22	3263318	.	A	G	5	10	15	0	0	15	0	0
22	3263672	.	G	T	7	9	16	0	1	17	0	0
22	3263917	.	C	T	12	6	18	0	3	21	0	0
22	3265889	.	C	A	3	7	10	0	1	11	0	0
22	3271943	.	G	A	0	1	1	0	0	1	0	0
22	3384831	.	G	A	24	19	43	0	3	46	0	0
22	3384844	.	C	T	17	23	40	0	4	44	0	0
22	3387865	.	T	C	3	3	6	0	0	6	0	0
22	3387870	.	G	A	4	2	6	0	0	6	0	0
22	3387946	.	T	C	1	0	1	0	2	3	0	0
22	3389500	.	T	G	5	7	12	0	0	12	0	0
22	3389803	.	G	A	3	3	6	0	1	7	0	0
22	4707916	.	A	G	1	1	2	0	0	2	0	0
22	4747302	.	C	A	1	3	4	0	1	5	0	0
22	4747456	.	C	A	1	3	4	0	0	4	0	0
22	4962472	.	T	A	6	5	11	0	0	11	0	0
22	4962559	.	G	A	9	12	21	0	0	21	0	0
22	4962610	.	A	T	8	16	24	0	1	25	0	0
22	4962635	.	A	G	8	19	27	0	1	28	0	0
22	4962696	.	T	C	0	1	1	0	1	2	0	0
22	4962878	.	G	A	18	10	28	0	0	28	0	0
22	4968955	.	A	G	2	1	3	0	0	3	0	0
22	4969051	.	G	A	7	5	12	0	0	12	0	0
22	4970773	.	T	C	0	0	0	0	3	3	0	0
22	4970797	.	G	C	1	3	4	0	0	4	0	0
22	4972848	.	T	G	7	6	13	0	0	13	0	0
22	4972980	.	C	T	0	2	2	0	3	5	0	0
22	4975236	.	T	A	5	10	15	0	1	16	0	0
22	4977106	.	G	A	5	3	8	0	0	8	0	0
22	5056425	.	G	T	9	10	19	0	0	19	0	0
22	5056706	.	G	A	12	5	17	0	1	18	0	0
22	5056760	.	T	G	5	23	28	0	0	28	0	0
22	5056978	.	A	T	8	5	13	0	0	13	0	0
22	5057421	.	C	A	0	7	7	0	11	18	0	0
22	5057443	.	T	C	5	0	5	0	15	20	0	0
22	5059916	.	A	G	5	1	6	0	0	6	0	0
22	5060162	.	T	A	3	1	4	0	0	4	0	0
22	5062457	.	G	A	1	0	1	0	2	3	0	0
22	5075673	.	A	G	1	2	3	0	0	3	0	0
22	5075732	.	T	C	1	0	1	0	0	1	0	0
22	5087488	.	G	A	5	3	8	0	0	8	0	0
22	5090115	.	C	A	0	2	2	0	3	5	0	0
22	5098433	.	G	T	3	3	6	0	0	6	0	0
22	5112644	.	G	T	2	0	2	0	0	2	0	0
22	5112749	.	T	C	5	3	8	0	1	9	0	0
22	5112864	.	G	A	4	4	8	0	1	9	0	0
22	5112915	.	A	C	4	5	9	0	0	9	0	0
22	5114380	.	G	C	0	10	10	0	10	20	0	0
22	5116267	.	A	C	11	13	24	0	2	26	0	0
22	5121464	.	C	T	1	7	8	0	0	8	0	0
22	5121471	.	C	T	1	7	8	0	0	8	0	0
22	5140840	.	C	T	0	3	3	0	2	5	0	0
22	5140851	.	C	G	2	2	4	0	0	4	0	0
22	5144566	.	G	C	4	8	12	0	1	13	0	0
22	5144645	.	C	T	9	9	18	0	0	18	0	0
22	5144750	.	T	A	4	6	10	0	0	10	0	0
22	5144981	.	T	C	4	1	5	0	2	7	0	0
22	5145109	.	C	A	3	3	6	0	1	7	0	0
22	5228744	.	G	A	0	5	5	0	7	12	0	0
22	5229151	.	A	G	2	4	6	0	0	6	0	0
22	5229267	.	A	C	0	7	7	0	1	8	0	0
22	5230076	.	T	A	3	0	3	0	0	3	0	0
22	5230339	.	A	G	12	7	19	0	0	19	0	0
22	5758235	.	C	A	7	2	9	0	1	10	0	0
22	6077906	.	C	G	0	1	1	0	0	1	0	0
22	6078213	.	C	T	2	1	3	0	0	3	0	0
22	6078223	.	C	A	1	2	3	0	0	3	0	0
22	6099105	.	C	G	4	0	4	0	0	4	0	0
22	6300363	.	C	T	1	2	3	0	0	3	0	0
22	6527546	.	C	T	1	3	4	0	0	4	0	0
22	6527553	.	C	A	0	3	3	0	4	7	0	0
22	6528059	.	A	T	7	4	11	0	0	11	0	0
22	6528177	.	C	T	0	3	3	0	3	6	0	0
22	6528586	.	C	T	1	3	4	0	0	4	0	0
22	6953787	.	T	A	1	5	6	0	0	6	0	0
22	6959404	.	C	T	0	2	2	0	2	4	0	0
22	6959421	.	A	G	2	2	4	0	0	4	0	0
22	6996343	.	G	A	5	5	10	0	0	10	0	0
22	6998904	.	A	G	3	10	13	0	1	14	0	0
22	6998949	.	G	T	9	9	18	0	0	18	0	0
22	6998988	.	T	C	7	4	11	0	2	13	0	0
22	6999006	.	A	G	6	5	11	0	1	12	0	0
22	6999060	.	G	C	1	0	1	0	2	3	0	0
22	6999148	.	T	A	0	1	1	0	0	1	0	0
22	7001827	.	G	A	2	2	4	0	0	4	0	0
22	7009333	.	A	T	22	12	34	0	5	39	0	0
22	7009393	.	A	G	10	11	21	0	0	21	0	0
22	7009833	.	C	T	3	7	10	0	0	10	0	0
22	7009835	.	T	G	3	8	11	0	0	11	0	0
22	7009911	.	A	G	8	11	19	0	0	19	0	0
22	7009915	.	C	T	1	9	10	0	7	17	0	0
22	7010011	.	A	C	12	10	22	0	2	25	1	0
22	7010100	.	T	C	15	0	15	0	20	35	0	0
22	7010151	.	T	C	13	12	25	0	3	28	0	0
22	7012898	.	C	T	0	6	6	0	12	18	0	0
22	7012931	.	C	G	7	5	12	0	1	13	0	0
22	7016655	.	A	G	5	3	8	0	0	8	0	0
22	7018223	.	G	A	1	3	4	0	0	4	0	0
22	7019397	.	C	A	0	4	4	0	6	10	0	0
22	7044634	.	C	G	8	3	11	0	1	12	0	0
22	7044667	.	T	G	5	7	12	0	1	13	0	0
22	7044681	.	T	C	6	4	10	0	0	10	0	0
22	7045031	.	G	A	5	5	10	0	0	10	0	0
22	7045041	.	C	A	5	5	10	0	0	10	0	0
22	7045070	.	C	T	6	1	7	0	1	8	0	0
22	7056645	.	C	T	0	0	0	0	1	1	0	0
22	7359844	.	T	C	1	1	2	0	0	2	0	0
22	7545827	.	A	C	1	3	4	0	0	4	0	0
22	7558417	.	C	T	1	1	2	0	0	2	0	0
22	7558430	.	T	A	2	1	3	0	0	3	0	0
22	7636988	.	T	A	0	1	1	0	0	1	0	0
22	7640313	.	A	G	1	2	3	0	0	3	0	0
22	7677394	.	C	A	0	1	1	1	0	2	0	0
22	7683668	.	A	T	1	0	1	0	0	1	0	0
22	7693741	.	C	A	0	2	2	1	0	3	0	0
22	7972792	.	A	G	2	7	9	0	1	10	0	0
22	7972848	.	A	G	6	4	10	0	0	10	0	0
22	7972851	.	T	C	6	4	10	0	0	10	0	0
22	7974164	.	C	A	3	4	7	0	0	7	0	0
22	7974302	.	C	G	1	0	1	0	0	1	0	0
22	8163917	.	G	A	3	4	7	0	0	7	0	0
22	8239945	.	T	C	2	3	5	0	0	5	0	0
22	8240737	.	A	C	3	2	5	0	1	6	0	0
22	8240843	.	G	A	1	3	4	0	0	4	0	0
22	8240852	.	A	T	2	3	5	0	0	5	0	0
22	8240892	.	T	A	3	2	5	0	0	5	0	0
22	8240902	.	A	T	3	1	4	0	0	4	0	0
22	8240952	.	T	A	2	2	4	0	0	4	0	0
22	8246050	.	T	C	2	3	5	1	0	6	0	0
22	8583548	.	G	T	1	3	4	0	0	4	0	0
22	8634149	.	T	A	2	1	3	0	0	3	0	0
22	8634180	.	T	A	0	2	2	1	0	3	0	0
22	8769431	.	A	G	1	6	7	0	1	8	0	0
22	8769579	.	T	G	4	7	11	0	0	11	0	0
22	8785914	.	C	T	1	3	4	0	0	4	0	0
22	8785965	.	C	T	1	2	3	0	0	3	0	0
22	8785982	.	T	G	3	2	5	0	0	5	0	0
22	8786316	.	C	T	1	1	2	0	1	3	0	0
22	9006911	.	A	G	1	2	3	0	1	4	0	0
22	9070639	.	G	A	1	2	3	0	0	3	0	0
22	9191439	.	A	G	0	1	1	0	0	1	0	0
22	9192810	.	T	G	1	3	4	0	0	4	0	0
22	9192811	.	C	T	3	1	4	0	0	4	0	0
22	9276440	.	A	T	0	2	2	2	0	4	0	0
22	9496617	.	G	A	1	1	2	0	0	2	0	0
22	9496936	.	G	A	1	1	2	0	1	3	0	0
22	9503739	.	G	A	1	1	2	0	1	3	0	0
22	9504749	.	T	C	3	3	6	0	1	7	0	0
22	9509637	.	G	A	0	3	3	0	2	5	0	0
22	9512565	.	A	C	11	18	29	0	2	31	0	0
22	9512717	.	C	T	3	6	9	1	0	10	0	0
22	9512731	.	T	A	2	6	8	1	1	10	0	0
22	9512829	.	A	G	3	6	9	0	0	9	0	0
22	9512885	.	T	G	5	2	7	0	5	12	0	0
22	9513039	.	C	T	8	8	16	0	0	16	0	0
22	9527409	.	T	C	3	5	8	0	1	9	0	0
22	9527439	.	G	T	3	6	9	0	0	9	0	0
22	9530377	.	G	A	3	3	6	0	0	6	0	0
22	9530388	.	C	T	3	3	6	0	0	6	0	0
22	9532488	.	G	A	0	1	1	0	0	1	0	0
22	9534138	.	C	T	1	2	3	0	4	7	0	0
22	9535914	.	G	A	7	3	10	0	1	11	0	0
22	9535932	.	C	A	3	6	9	0	2	11	0	0
22	9537267	.	T	C	30	10	40	0	1	41	0	0
22	9537583	.	T	C	21	13	34	0	19	53	0	0
22	9537859	.	C	T	7	5	12	0	3	15	0	0
22	9829111	.	C	T	1	5	6	0	0	6	0	0
22	9835039	.	C	T	3	2	5	0	1	6	0	0
22	9835108	.	C	T	5	3	8	1	1	10	0	0
22	9836274	.	T	A	0	2	2	0	0	2	0	0
22	9836337	.	T	C	1	1	2	0	0	2	0	0
22	9836348	.	T	C	1	2	3	0	0	3	0	0
22	9886990	.	C	T	0	2	2	0	2	4	0	0
22	9887434	.	G	A	1	3	4	0	0	4	0	0
22	9887632	.	C	T	1	2	3	0	0	3	0	0
22	9887777	.	T	A	1	2	3	0	0	3	0	0
22	9887894	.	G	C	2	2	4	0	0	4	0	0
22	9893688	.	G	A	0	2	2	0	0	2	0	0
22	9894327	.	G	T	2	0	2	0	0	2	0	0
22	9894340	.	T	G	1	0	1	0	0	1	0	0
22	9898052	.	A	G	1	4	5	0	0	5	0	0
22	9898589	.	A	C	8	3	11	0	0	11	0	0
22	9898598	.	G	A	5	2	7	0	1	8	0	0
22	9899279	.	A	G	0	4	4	2	0	6	0	0
22	9926449	.	T	C	3	1	4	0	1	5	0	0
22	9926475	.	A	G	2	3	5	0	0	5	0	0
22	9926532	.	C	G	2	4	6	0	0	6	0	0
22	9934095	.	T	G	0	3	3	0	0	3	0	0
22	10019645	.	C	G	3	2	5	0	0	5	0	0
22	10039497	.	G	A	2	3	5	0	0	5	0	0
22	10039678	.	G	A	3	3	6	0	0	6	0	0
22	10045173	.	A	T	1	0	1	0	0	1	0	0
22	10048389	.	G	T	0	1	1	0	1	2	0	0
22	10049292	.	C	T	0	2	2	0	2	4	0	0
22	10049308	.	C	A	2	2	4	0	0	4	0	0
22	10049352	.	A	G	1	0	1	0	1	2	0	0
22	10123910	.	G	C	9	9	18	0	3	21	0	0
22	10123962	.	T	C	9	0	9	0	15	24	0	0
22	10123998	.	C	T	0	4	4	0	8	12	0	0
22	10129878	.	A	G	2	3	5	0	4	9	0	0
22	10162958	.	A	T	2	0	2	0	0	2	0	0
22	10184079	.	T	A	1	1	2	0	0	2	0	0
22	10189781	.	G	A	0	1	1	0	0	1	0	0
22	10196291	.	T	C	4	6	10	0	2	12	0	0
22	10196297	.	A	T	8	4	12	0	1	13	0	0
22	10196330	.	C	T	8	5	13	0	0	13	0	0
22	10196468	.	A	T	7	6	13	0	1	14	0	0
22	10196483	.	A	G	4	4	8	0	1	9	0	0
22	10196508	.	T	A	2	5	7	0	0	7	0	0
22	10196621	.	C	A	3	8	11	0	0	11	0	0
22	10196622	.	C	A	8	3	11	0	0	11	0	0
22	10196813	.	A	G	10	0	10	0	14	24	0	0
22	10196821	.	C	T	9	13	22	0	2	24	0	0
22	10196928	.	G	A	1	1	2	0	5	7	0	0
22	10196929	.	G	A	4	2	6	0	1	7	0	0
22	10197180	.	T	A	14	5	19	0	0	19	0	0
22	10197195	.	T	C	15	5	20	0	1	21	0	0
22	10197957	.	C	A	9	8	17	0	6	23	0	0
22	10197966	.	C	T	11	10	21	0	2	23	0	0
22	10198018	.	A	C	12	14	26	0	0	26	0	0
22	10198075	.	T	G	4	0	4	0	9	13	0	0
22	10198120	.	A	T	4	5	9	0	0	9	0	0
22	10198167	.	G	A	10	7	17	0	2	19	0	0
22	10198211	.	T	C	7	8	15	0	2	17	0	0
22	10198232	.	T	A	5	9	14	0	0	15	1	0
22	10198335	.	A	C	13	17	30	0	4	34	0	0
22	10198359	.	G	A	16	21	37	0	0	37	0	0
22	10198399	.	T	A	21	23	44	0	2	46	0	0
22	10205736	.	C	T	3	6	9	0	0	9	0	0
22	10208212	.	C	T	11	9	20	0	5	25	0	0
22	10210467	.	T	C	2	10	12	0	1	13	0	0
22	10212089	.	C	T	8	5	13	0	0	13	0	0
22	10212161	.	A	C	20	33	53	0	3	56	0	0
22	10212307	.	C	T	21	26	47	0	3	50	0	0
22	10212416	.	T	A	8	12	20	0	1	21	0	0
22	10218656	.	A	T	1	2	3	0	0	3	0	0
22	10218973	.	T	C	3	3	6	0	0	6	0	0
22	10219030	.	T	C	3	5	8	0	1	9	0	0
22	10260258	.	G	A	1	3	4	0	4	8	0	0
22	10261037	.	C	T	3	2	5	0	1	6	0	0
22	10261792	.	T	A	9	8	17	0	1	18	0	0
22	10261853	.	G	A	9	10	19	0	0	19	0	0
22	10261905	.	T	C	18	9	27	0	0	27	0	0
22	10262236	.	T	G	13	11	24	0	1	25	0	0
22	10282344	.	G	A	1	1	2	0	0	2	0	0
22	10361385	.	C	G	4	6	10	0	1	11	0	0
22	10361391	.	T	C	7	4	11	0	0	11	0	0
22	10361937	.	C	T	1	10	11	0	8	19	0	0
22	10362072	.	G	A	7	7	14	0	1	15	0	0
22	10362239	.	G	A	4	8	12	0	4	16	0	0
22	10368054	.	A	T	1	4	5	0	0	5	0	0
22	10373118	.	A	T	3	7	10	0	0	10	0	0
22	10373263	.	G	T	5	2	7	0	1	8	0	0
22	10374012	.	G	A	1	2	3	0	0	3	0	0
22	10430183	.	C	A	0	1	1	0	1	2	0	0
22	10430292	.	G	C	4	2	6	0	0	6	0	0
22	10430369	.	A	T	4	5	9	0	0	9	0	0
22	10514288	.	G	T	8	6	14	0	1	15	0	0
22	10514302	.	C	T	0	5	5	0	7	12	0	0
22	10517499	.	T	C	0	0	0	0	3	3	0	0
22	10517505	.	A	C	0	0	0	0	2	2	0	0
22	10540812	.	G	T	6	4	10	0	1	11	0	0
22	10545408	.	G	A	0	5	5	0	0	5	0	0
22	10548171	.	G	A	1	0	1	0	0	1	0	0
22	10553620	.	G	T	1	2	3	0	0	3	0	0
22	10553626	.	G	A	2	2	4	0	1	5	0	0
22	10557870	.	T	G	1	1	2	0	0	2	0	0
22	10557898	.	C	T	1	1	2	0	0	2	0	0
22	10561255	.	A	T	15	8	23	0	0	23	0	0
22	10561514	.	A	G	8	3	11	0	0	11	0	0
22	10561758	.	A	G	8	9	17	0	0	17	0	0
22	10567550	.	T	A	1	2	3	0	0	3	0	0
22	10570575	.	T	C	3	3	6	0	0	6	0	0
22	10575350	.	T	C	1	0	1	0	6	7	0	0
22	10592056	.	A	G	3	3	6	0	0	6	0	0
22	10592059	.	A	G	3	3	6	0	0	6	0	0
22	10592426	.	C	A	5	4	9	0	0	9	0	0
22	10592719	.	T	C	10	8	18	0	0	18	0	0
22	10593310	.	A	G	5	4	9	0	0	9	0	0
22	10593527	.	A	G	12	9	21	0	4	25	0	0
22	10593531	.	G	A	13	10	23	0	1	24	0	0
22	10593831	.	T	C	7	4	11	0	1	12	0	0
22	10593990	.	A	G	6	6	12	0	1	13	0	0
22	10594008	.	G	T	3	6	9	0	2	11	0	0
22	10594074	.	C	T	7	2	9	0	3	12	0	0
22	10594098	.	G	A	9	7	16	0	0	16	0	0
22	10594170	.	A	G	8	5	13	0	1	14	0	0
22	10597470	.	A	T	3	1	4	0	1	5	0	0
22	10597715	.	T	C	1	0	1	0	3	4	0	0
22	10599510	.	A	G	4	4	8	0	0	8	0	0
22	10600175	.	T	C	2	2	4	0	0	4	0	0
22	10600265	.	C	T	0	2	2	0	2	4	0	0
22	10604423	.	C	T	5	2	7	0	0	7	0	0
22	10626747	.	T	C	1	4	5	0	0	5	0	0
22	10626861	.	T	C	0	1	1	0	0	1	0	0
22	10626873	.	C	T	0	1	1	0	0	1	0	0
22	10629133	.	T	C	5	2	7	0	0	7	0	0
22	10634437	.	G	A	4	4	8	0	2	10	0	0
22	10634810	.	T	C	0	1	1	0	0	1	0	0
22	10634822	.	G	A	0	2	2	0	0	2	0	0
22	10635402	.	G	A	0	1	1	0	0	1	0	0
22	10636581	.	T	C	0	2	2	0	0	2	0	0
22	10636762	.	A	T	5	8	13	0	1	14	0	0
22	10636974	.	G	C	10	8	18	0	0	18	0	0
22	10637232	.	A	G	8	9	17	0	1	18	0	0
22	10637253	.	T	C	11	7	18	0	1	19	0	0
22	10637298	.	C	A	9	11	20	0	0	20	0	0
22	10637669	.	G	T	10	4	14	0	1	15	0	0
22	10637729	.	T	C	8	9	17	0	0	17	0	0
22	10638536	.	A	T	8	8	16	0	1	17	0	0
22	10638700	.	T	C	3	3	6	0	1	7	0	0
22	10638887	.	T	C	12	7	19	0	1	20	0	0
22	10638932	.	G	A	1	12	13	0	6	19	0	0
22	10638974	.	G	A	4	9	13	0	1	14	0	0
22	10640369	.	A	G	3	3	6	0	0	6	0	0
22	10654549	.	C	T	1	0	1	0	0	1	0	0
22	10658007	.	T	A	2	2	4	0	0	4	0	0
22	10658042	.	A	C	3	2	5	0	0	5	0	0
22	10658090	.	G	A	0	4	4	0	2	6	0	0
22	10658102	.	A	C	3	3	6	0	0	6	0	0
22	10660261	.	A	T	10	5	15	0	0	15	0	0
22	10662886	.	C	T	8	6	14	0	2	16	0	0
22	10662952	.	C	T	0	1	1	0	0	1	0	0
22	10663090	.	G	T	0	3	3	0	3	6	0	0
22	10663390	.	T	G	9	6	15	0	0	16	1	0
22	10663433	.	A	T	9	10	19	0	2	21	0	0
22	10663469	.	T	A	5	15	20	0	3	23	0	0
22	10663504	.	T	A	10	16	26	0	0	26	0	0
22	10663567	.	A	T	16	17	33	0	1	34	0	0
22	10704081	.	T	G	1	0	1	0	4	5	0	0
22	10704255	.	A	C	3	3	6	0	0	6	0	0
22	10704279	.	T	C	1	1	2	0	0	2	0	0
22	10706462	.	G	A	0	5	5	0	6	11	0	0
22	10706586	.	T	G	7	8	15	0	1	16	0	0
22	10706603	.	G	A	0	10	10	0	10	20	0	0
22	10706726	.	A	T	3	2	5	0	0	5	0	0
22	10706732	.	A	G	3	2	5	0	0	5	0	0
22	10706855	.	T	A	3	3	6	0	0	6	0	0
22	10713858	.	T	C	1	3	4	0	0	4	0	0
22	10713880	.	C	A	1	3	4	0	0	4	0	0
22	10726968	.	T	C	1	3	4	0	0	4	0	0
22	10729626	.	C	T	2	4	6	0	1	7	0	0
22	10729675	.	C	A	1	0	1	0	1	2	0	0
22	10733360	.	A	G	5	0	5	0	14	19	0	0
22	10733512	.	C	T	5	6	11	0	0	11	0	0
22	10733554	.	G	A	8	8	16	0	1	17	0	0
22	10733977	.	A	G	4	4	8	0	0	8	0	0
22	10733992	.	A	T	4	4	8	0	0	8	0	0
22	10734967	.	A	T	7	8	15	0	0	15	0	0
22	10735015	.	C	A	0	5	5	0	2	7	0	0
22	10755600	.	A	G	15	12	27	0	0	27	0	0
22	10755652	.	T	A	10	7	17	0	1	18	0	0
22	10755746	.	G	T	22	19	41	0	2	43	0	0
22	10755888	.	T	C	20	14	34	0	5	39	0	0
22	10771195	.	C	T	0	10	10	0	12	22	0	0
22	10771284	.	T	C	7	11	18	0	1	19	0	0
22	10771369	.	G	A	15	9	24	0	2	26	0	0
22	10771415	.	A	T	11	8	19	0	0	19	0	0
22	10771628	.	T	C	7	6	13	0	1	14	0	0
22	10771743	.	C	G	6	8	14	0	0	14	0	0
22	10771752	.	G	A	8	6	14	0	0	14	0	0
22	10771919	.	T	C	5	1	6	0	7	13	0	0
22	10774628	.	G	A	5	7	12	0	0	12	0	0
22	10774632	.	T	C	4	7	11	0	0	11	0	0
22	10795290	.	A	C	2	2	4	0	0	4	0	0
22	10795696	.	C	G	2	4	6	0	1	7	0	0
22	10795745	.	T	C	1	2	3	0	0	3	0	0
22	10814345	.	A	G	1	2	3	0	0	3	0	0
22	11071011	.	G	C	3	0	3	0	8	11	0	0
22	11071053	.	A	G	5	8	13	0	1	14	0	0
22	11071059	.	C	T	7	7	14	0	1	15	0	0
22	11071416	.	G	C	1	1	2	0	0	2	0	0
22	11071568	.	C	A	2	2	4	0	0	4	0	0
22	11075978	.	A	G	4	4	8	0	0	8	0	0
22	11078902	.	T	C	1	1	2	0	0	2	0	0
22	11078944	.	C	A	0	6	6	0	4	10	0	0
22	11123770	.	C	T	29	17	46	0	4	50	0	0
22	11123889	.	T	C	24	17	41	0	2	43	0	0
22	11124524	.	T	C	0	5	5	0	0	5	0	0
22	11126857	.	A	G	8	9	17	0	4	21	0	0
22	11126866	.	G	A	9	11	20	0	4	24	0	0
22	11129995	.	G	A	10	5	15	0	3	18	0	0
22	11130058	.	T	C	7	0	7	0	3	10	0	0
22	11135408	.	G	A	2	1	3	0	0	3	0	0
22	11135446	.	G	A	12	4	16	0	2	18	0	0
22	11136606	.	G	A	4	1	5	0	2	7	0	0
22	11161201	.	T	C	7	3	10	0	0	10	0	0
22	11170855	.	T	C	2	1	3	0	0	3	0	0
22	11170954	.	T	C	6	4	10	0	0	10	0	0
22	11170966	.	T	G	6	0	6	0	4	10	0	0
22	11171086	.	G	A	4	12	16	0	0	16	0	0
22	11188598	.	C	T	5	2	7	0	0	7	0	0
22	11199942	.	T	A	17	14	31	0	0	31	0	0
22	11200242	.	T	G	3	8	11	0	2	13	0	0
22	11200401	.	G	A	0	15	15	0	11	26	0	0
22	12171293	.	G	A	2	3	5	0	0	5	0	0
22	12174573	.	T	G	7	11	18	0	0	18	0	0
22	12174740	.	A	G	10	8	18	0	0	18	0	0
22	12175181	.	T	C	10	2	12	0	3	15	0	0
22	12175556	.	A	G	6	0	6	0	10	16	0	0
22	12175583	.	A	T	5	10	15	0	1	16	0	0
22	12176043	.	G	T	15	14	29	0	2	31	0	0
22	12230054	.	G	A	3	2	5	0	1	6	0	0
22	12247703	.	T	G	1	6	7	0	0	7	0	0
22	12247715	.	T	C	1	0	1	0	6	7	0	0
22	12447861	.	A	G	8	3	11	0	1	12	0	0
22	13459294	.	A	G	4	3	7	0	2	9	0	0
22	13459472	.	T	A	5	5	10	0	1	11	0	0
22	13459596	.	T	C	6	0	6	0	7	13	0	0
22	13459611	.	A	G	8	7	15	0	2	17	0	0
22	13459636	.	G	T	9	10	19	0	2	21	0	0
22	13459718	.	A	G	4	9	13	0	2	16	1	0
22	13459865	.	G	C	2	1	3	0	10	13	0	0
22	13460191	.	T	C	7	9	16	0	1	17	0	0
22	13460406	.	T	C	5	7	12	0	1	13	0	0
22	13460441	.	C	T	0	6	6	0	7	13	0	0
22	13460483	.	A	G	3	7	10	0	2	12	0	0
22	13460509	.	T	G	1	8	9	0	2	11	0	0
22	13461012	.	A	G	5	4	9	0	2	11	0	0
22	13461073	.	C	G	4	3	7	0	0	7	0	0
22	13461084	.	C	T	5	2	7	0	1	8	0	0
22	13461622	.	T	C	2	3	5	0	0	5	0	0
22	13461993	.	A	G	2	5	7	0	1	8	0	0
22	13461996	.	A	G	2	5	7	0	0	7	0	0
22	13463071	.	A	G	4	11	15	0	1	16	0	0
22	13472514	.	G	A	4	3	7	0	0	7	0	0
22	13479990	.	A	G	1	2	3	0	0	3	0	0
22	13486398	.	A	T	1	1	2	0	0	2	0	0
22	13846395	.	T	A	8	11	19	0	1	20	0	0
22	13846606	.	G	A	14	13	27	0	3	30	0	0
22	13846788	.	C	A	7	3	10	0	1	11	0	0
22	13847783	.	A	G	18	19	37	0	5	42	0	0
22	13847797	.	C	G	18	16	34	0	4	39	1	0
22	13847940	.	G	A	9	15	24	0	1	25	0	0
22	13848031	.	G	A	24	13	37	0	2	39	0	0
22	13848085	.	G	A	18	6	24	0	1	25	0	0
22	13848106	.	A	G	13	4	17	0	0	17	0	0
22	13850865	.	A	G	8	12	20	0	1	21	0	0
22	13920529	.	T	A	0	2	2	0	1	3	0	0
22	13939993	.	G	C	0	2	2	0	0	2	0	0
22	13940036	.	T	C	1	3	4	0	0	4	0	0
22	13942856	.	T	G	1	4	5	0	0	5	0	0
22	14366222	.	G	A	3	4	7	0	1	8	0	0
22	14366267	.	C	T	2	1	3	0	0	3	0	0
22	14398645	.	G	A	2	3	5	0	0	5	0	0
22	14851158	.	A	C	3	2	5	0	0	5	0	0
22	14853887	.	A	C	1	3	4	0	0	4	0	0
22	16192570	.	T	C	0	2	2	0	1	3	0	0
22	16348504	.	A	T	2	2	4	0	0	4	0	0
22	16348506	.	C	T	2	2	4	0	0	4	0	0
22	16350682	.	G	A	14	14	28	0	4	32	0	0
22	16350792	.	T	A	20	13	33	0	10	43	0	0
22	16350811	.	T	G	26	9	35	0	5	41	1	0
22	16351141	.	G	A	15	15	30	0	1	31	0	0
22	16351199	.	C	G	11	17	28	0	1	29	0	0
22	16351345	.	A	T	3	3	6	0	1	7	0	0
22	16351353	.	G	A	3	4	7	0	0	7	0	0
22	16351390	.	A	C	2	2	4	0	0	4	0	0
22	16351404	.	C	T	1	4	5	0	0	5	0	0
22	16351439	.	C	T	2	4	6	0	0	6	0	0
22	16351490	.	T	G	2	3	5	0	1	6	0	0
22	16352215	.	A	G	6	6	12	0	2	14	0	0
22	16352249	.	T	C	15	8	23	0	1	24	0	0
22	16352269	.	T	G	15	8	23	0	2	25	0	0
22	16352668	.	T	C	10	0	10	0	15	25	0	0
22	16352768	.	A	G	11	13	24	0	1	25	0	0
22	16357818	.	A	G	1	1	2	0	0	2	0	0
22	16357867	.	G	A	6	2	8	0	0	8	0	0
22	16357909	.	C	T	2	1	3	0	0	3	0	0
22	16367055	.	A	G	5	4	9	0	0	9	0	0
22	16377364	.	A	G	3	3	6	0	0	6	0	0
22	16407193	.	G	T	2	3	5	0	0	5	0	0
22	16410600	.	A	G	0	1	1	0	0	1	0	0
22	16423042	.	G	A	0	1	1	0	2	3	0	0
22	16424576	.	T	C	5	3	8	0	0	8	0	0
22	16427969	.	A	G	4	0	4	0	4	8	0	0
22	16428005	.	C	A	4	6	10	0	0	10	0	0
22	16430623	.	G	A	13	8	21	0	1	22	0	0
22	16430782	.	T	A	7	12	19	0	1	21	1	0
22	16430843	.	C	T	4	3	7	0	1	8	0	0
22	16430913	.	T	C	3	6	9	0	0	9	0	0
22	16430924	.	G	C	1	2	3	0	1	4	0	0
22	16433009	.	G	A	6	3	9	0	0	9	0	0
22	16433054	.	T	A	10	5	15	0	2	17	0	0
22	16433078	.	G	A	11	10	21	0	0	21	0	0
22	16433096	.	A	G	13	11	24	0	1	25	0	0
22	16433378	.	G	A	6	5	11	0	3	14	0	0
22	16433394	.	G	A	7	6	13	0	0	13	0	0
22	16433422	.	A	G	6	6	12	0	0	12	0	0
22	16433895	.	T	C	5	6	11	0	0	11	0	0
22	16433912	.	T	A	7	7	14	0	0	14	0	0
22	16433940	.	C	T	8	8	16	0	1	17	0	0
22	16434056	.	G	A	14	7	21	0	1	22	0	0
22	16440072	.	G	A	2	1	3	0	0	3	0	0
22	16473784	.	G	A	0	1	1	0	2	3	0	0
22	16477061	.	T	G	1	2	3	0	0	3	0	0
22	16484167	.	A	T	2	3	5	0	3	8	0	0
22	16484489	.	G	C	9	0	9	0	29	38	0	0
22	16484712	.	C	T	4	3	7	0	0	7	0	0
22	16484877	.	A	T	8	9	17	0	2	19	0	0
22	16484938	.	A	G	5	17	22	0	0	22	0	0
22	16484944	.	T	C	5	16	21	0	0	21	0	0
22	16485238	.	A	C	5	13	18	0	1	19	0	0
22	16485379	.	A	T	9	12	21	0	2	23	0	0
22	16485563	.	A	T	4	3	7	0	0	7	0	0
22	16485688	.	G	A	1	4	5	0	0	5	0	0
22	16485768	.	G	A	4	2	6	0	0	6	0	0
22	16485920	.	G	A	7	8	15	0	0	15	0	0
22	16485962	.	C	G	4	9	13	0	1	14	0	0
22	16486008	.	A	C	3	3	6	0	1	7	0	0
22	16486027	.	G	A	4	2	6	0	0	6	0	0
22	16486102	.	G	A	3	3	6	0	2	8	0	0
22	16486112	.	T	C	6	3	9	0	1	10	0	0
22	16491711	.	C	A	2	4	6	0	1	7	0	0
22	16491942	.	G	A	9	9	18	0	0	18	0	0
22	16498232	.	T	C	13	11	24	0	2	26	0	0
22	16498333	.	A	C	16	16	32	0	2	34	0	0
22	16498661	.	A	G	9	0	9	0	16	25	0	0
22	16537701	.	C	T	1	2	3	0	0	3	0	0
22	16537854	.	C	T	3	4	7	0	0	7	0	0
22	16537878	.	C	A	5	5	10	0	0	10	0	0
22	16544186	.	A	G	6	8	14	0	3	17	0	0
22	16544197	.	A	G	13	4	17	0	1	19	1	0
22	16544243	.	C	T	10	6	16	0	0	16	0	0
22	16544308	.	A	G	1	1	2	0	0	2	0	0
22	16544319	.	A	G	3	2	5	0	0	5	0	0
22	16544384	.	G	A	13	6	19	0	2	21	0	0
22	16544400	.	T	G	11	8	19	0	3	22	0	0
22	16544599	.	A	G	11	0	11	0	20	31	0	0
22	16544674	.	T	G	17	13	30	0	4	34	0	0
22	16544780	.	A	T	12	15	27	0	7	34	0	0
22	16544800	.	G	A	16	14	30	0	0	30	0	0
22	16594852	.	G	A	0	1	1	0	0	1	0	0
22	16594870	.	T	A	2	1	3	0	0	3	0	0
22	16594981	.	C	A	2	6	8	0	0	8	0	0
22	16601400	.	C	T	1	2	3	0	0	3	0	0
22	16601422	.	C	T	2	0	2	0	0	2	0	0
22	16775197	.	G	A	0	13	13	0	11	24	0	0
22	16775284	.	T	G	8	9	17	0	0	17	0	0
22	16775306	.	C	T	7	9	16	0	2	18	0	0
22	16862842	.	A	G	0	2	2	0	1	3	0	0
22	17200635	.	G	A	14	5	19	0	1	20	0	0
22	17200890	.	G	A	10	11	21	0	2	23	0	0
22	17200985	.	A	C	7	14	21	0	0	21	0	0
22	17201015	.	C	G	7	17	24	0	3	27	0	0
22	17201102	.	C	G	15	6	21	0	2	23	0	0
22	17201135	.	G	A	14	7	21	0	0	21	0	0
22	17201172	.	C	T	5	5	10	0	2	12	0	0
22	17208680	.	T	C	5	0	5	0	0	5	0	0
22	17208695	.	A	G	6	1	7	0	0	7	0	0
22	17208770	.	T	C	8	3	11	0	1	12	0	0
22	17208913	.	A	C	6	3	9	0	2	11	0	0
22	17209384	.	A	C	11	9	20	0	1	21	0	0
22	17209413	.	T	A	9	12	21	0	1	22	0	0
22	17209484	.	T	A	6	9	15	0	0	15	0	0
22	17209492	.	T	A	5	7	12	0	0	13	1	0
22	17209523	.	A	T	10	4	14	0	0	14	0	0
22	17209737	.	T	C	11	9	20	0	2	22	0	0
22	17209762	.	T	C	11	7	18	0	2	21	1	0
22	17209858	.	C	A	12	4	16	0	3	19	0	0
22	17209872	.	A	G	14	0	14	0	6	20	0	0
22	17209986	.	A	T	11	2	13	0	0	13	0	0
22	17209993	.	A	T	9	3	12	0	1	13	0	0
22	17210053	.	C	G	4	3	7	0	3	10	0	0
22	17210157	.	T	A	19	7	26	0	2	28	0	0
22	17210217	.	C	A	20	7	27	0	1	28	0	0
22	17210820	.	A	C	26	18	44	0	4	48	0	0
22	17210825	.	G	A	1	19	20	0	27	47	0	0
22	17211343	.	C	T	18	9	27	0	4	31	0	0
22	17211361	.	A	G	21	10	31	0	1	32	0	0
22	17211431	.	C	T	25	10	35	0	2	37	0	0
22	17211438	.	T	C	23	13	36	0	0	36	0	0
22	17211875	.	G	C	24	18	42	0	2	44	0	0
22	17211990	.	A	G	16	23	39	0	0	39	0	0
22	17212235	.	T	A	10	7	17	0	2	19	0	0
22	17212236	.	T	C	10	8	18	0	1	19	0	0
22	17227931	.	C	A	1	0	1	0	0	1	0	0
22	17234620	.	G	A	0	6	6	0	5	11	0	0
22	17235449	.	A	C	0	6	6	0	0	6	0	0
22	17248068	.	T	C	2	2	4	0	0	4	0	0
22	17315266	.	G	A	0	2	2	0	1	3	0	0
22	17343530	.	A	G	0	1	1	0	0	1	0	0
22	17359816	.	G	C	0	4	4	0	3	7	0	0
22	17360107	.	C	A	6	5	11	0	1	12	0	0
22	17360428	.	G	A	0	6	6	0	7	13	0	0
22	17405361	.	C	T	3	2	5	0	0	5	0	0
22	17446858	.	T	C	1	3	4	0	0	4	0	0
22	17448778	.	G	A	0	2	2	0	0	2	0	0
22	17448781	.	C	T	0	2	2	0	0	2	0	0
22	17450115	.	G	A	0	10	10	0	13	23	0	0
22	17452798	.	C	T	15	13	28	0	2	30	0	0
22	17453286	.	T	G	24	19	43	0	2	45	0	0
22	17453419	.	G	A	13	15	28	0	1	29	0	0
22	17453478	.	T	A	18	18	36	0	2	38	0	0
22	17453552	.	T	C	15	7	22	0	0	22	0	0
22	17453569	.	C	G	13	5	18	0	2	20	0	0
22	17453680	.	C	T	12	7	19	0	0	19	0	0
22	17453688	.	A	G	11	5	16	0	0	16	0	0
22	17453742	.	A	G	9	10	19	0	1	20	0	0
22	17453836	.	A	G	18	9	27	0	3	30	0	0
22	17453883	.	A	T	21	12	33	0	1	34	0	0
22	17453884	.	T	C	21	12	33	0	1	34	0	0
22	17454015	.	T	C	14	15	29	0	1	30	0	0
22	17454038	.	G	T	15	11	26	0	0	26	0	0
22	17454120	.	C	T	2	8	10	0	0	10	0	0
22	17454178	.	A	G	6	0	6	0	19	25	0	0
22	17454179	.	T	G	5	17	22	0	3	25	0	0
22	17454320	.	T	C	15	13	28	0	3	31	0	0
22	17454382	.	C	T	6	9	15	0	3	18	0	0
22	17501623	.	G	C	2	4	6	0	1	7	0	0
22	17505820	.	A	C	27	16	43	0	9	52	0	0
22	17506002	.	C	T	7	9	16	0	2	18	0	0
22	17506003	.	T	C	13	5	18	0	0	18	0	0
22	17506536	.	A	T	23	20	43	0	3	46	0	0
22	17506537	.	T	G	24	21	45	0	1	46	0	0
22	17509449	.	A	T	1	2	3	0	0	3	0	0
22	17509494	.	T	A	1	2	3	0	0	3	0	0
22	17531188	.	A	G	10	10	20	0	1	21	0	0
22	17533907	.	C	T	5	5	10	0	1	11	0	0
22	17539297	.	C	T	29	17	46	0	1	47	0	0
22	17539633	.	G	A	7	13	20	0	0	20	0	0
22	17541191	.	T	G	1	6	7	0	1	8	0	0
22	17541450	.	C	A	12	17	29	0	2	31	0	0
22	17541593	.	G	A	22	17	39	0	3	42	0	0
22	17542016	.	C	T	11	18	29	0	0	29	0	0
22	17542057	.	C	T	15	13	28	0	1	29	0	0
22	17542117	.	T	C	12	13	25	0	2	27	0	0
22	17542136	.	G	A	14	15	29	0	1	30	0	0
22	17542199	.	A	T	8	10	18	0	1	19	0	0
22	17542293	.	C	T	12	10	22	0	2	24	0	0
22	17542594	.	G	T	6	4	10	0	2	12	0	0
22	17542702	.	G	A	5	3	8	0	0	8	0	0
22	17542774	.	C	T	2	1	3	0	2	5	0	0
22	17543079	.	C	G	5	5	10	0	0	10	0	0
22	17543552	.	G	A	7	4	11	0	1	12	0	0
22	17543634	.	A	C	4	7	11	0	0	11	0	0
22	17543668	.	A	T	3	3	6	0	0	6	0	0
22	17543748	.	A	C	2	0	2	0	5	7	0	0
22	17543903	.	A	G	5	5	10	0	0	10	0	0
22	17550643	.	T	C	2	0	2	0	7	9	0	0
22	17550664	.	G	A	5	6	11	0	0	11	0	0
22	17550684	.	C	T	0	5	5	0	6	11	0	0
22	17550724	.	T	G	1	1	2	0	0	2	0	0
22	17552526	.	A	G	1	2	3	0	0	3	0	0
22	17554785	.	G	A	4	11	15	0	2	17	0	0
22	17564009	.	T	C	6	5	11	0	0	11	0	0
22	17565735	.	C	T	5	4	9	0	2	11	0	0
22	17565837	.	A	G	0	2	2	0	0	2	0	0
22	17571533	.	C	A	0	0	0	0	1	1	0	0
22	17590019	.	G	A	0	1	1	0	0	1	0	0
22	17590037	.	C	T	0	1	1	0	0	1	0	0
22	17591712	.	G	A	5	17	22	0	1	23	0	0
22	17596874	.	G	A	0	3	3	0	0	3	0	0
22	17596903	.	C	G	10	11	21	0	0	21	0	0
22	17596943	.	A	T	15	17	32	0	0	32	0	0
22	17606908	.	A	C	4	10	14	0	0	14	0	0
22	17607226	.	G	A	3	5	8	0	2	10	0	0
22	17609589	.	C	G	1	0	1	0	0	1	0	0
22	17830360	.	A	G	15	8	23	0	0	23	0	0
22	17830632	.	A	G	14	5	19	0	1	20	0	0
22	17830640	.	A	G	12	5	17	0	1	18	0	0
22	17865106	.	G	A	0	2	2	0	0	2	0	0
22	18156459	.	G	A	0	1	1	0	0	1	0	0
22	18160149	.	A	T	2	2	4	0	0	4	0	0
22	18175050	.	T	A	0	3	3	0	1	4	0	0
22	18175062	.	T	A	1	3	4	0	0	4	0	0
22	18211058	.	G	A	0	2	2	0	0	2	0	0
22	18213480	.	A	C	3	2	5	0	0	5	0	0
22	18214451	.	T	C	1	2	3	0	0	3	0	0
22	18231234	.	A	G	2	2	4	0	0	4	0	0
22	18231370	.	A	G	6	4	10	0	1	11	0	0
22	18231770	.	C	G	2	6	8	0	2	10	0	0
22	18231831	.	T	A	3	2	5	0	1	6	0	0
22	18232503	.	G	C	3	2	5	0	0	5	0	0
22	18232527	.	C	T	2	2	4	0	0	4	0	0
22	18232754	.	T	C	1	2	3	0	1	4	0	0
22	18232868	.	G	T	4	3	7	0	0	7	0	0
22	18232935	.	T	G	3	4	7	0	0	7	0	0
22	18233053	.	C	A	3	8	11	0	0	11	0	0
22	18233143	.	T	A	1	4	5	0	1	6	0	0
22	18233164	.	C	G	1	2	3	0	0	3	0	0
22	18233284	.	T	A	2	3	5	0	0	5	0	0
22	18233367	.	T	A	4	3	7	0	0	7	0	0
22	18233403	.	G	A	2	4	6	0	0	6	0	0
22	18247883	.	T	C	2	5	7	0	0	7	0	0
22	18376434	.	G	A	7	4	11	0	1	12	0	0
22	18376467	.	A	C	2	2	4	0	1	5	0	0
22	18383311	.	G	T	0	4	4	0	2	6	0	0
22	18383996	.	C	T	1	4	5	0	1	6	0	0
22	18384306	.	G	T	1	4	5	0	0	5	0	0
22	18384330	.	T	G	4	3	7	0	1	8	0	0
22	18384352	.	G	C	6	5	11	0	2	14	1	0
22	18459182	.	C	T	3	3	6	0	1	7	0	0
22	18461964	.	C	T	1	6	7	0	2	9	0	0
22	18462018	.	A	G	2	6	8	0	2	10	0	0
22	18462239	.	C	T	9	10	19	0	1	20	0	0
22	18464455	.	T	C	3	1	4	0	0	4	0	0
22	18488823	.	T	C	2	4	6	0	1	7	0	0
22	18488952	.	C	A	3	5	8	0	1	9	0	0
22	18489191	.	A	G	2	2	4	0	0	4	0	0
22	18530697	.	A	C	2	0	2	0	0	2	0	0
22	18542090	.	C	T	35	16	51	0	3	54	0	0
22	18542393	.	C	T	12	13	25	0	4	29	0	0
22	18542508	.	A	G	35	11	46	0	2	48	0	0
22	18542720	.	A	T	17	19	36	0	0	37	1	0
22	18543819	.	C	G	29	25	54	0	8	62	0	0
22	18543847	.	T	G	32	28	60	0	1	61	0	0
22	18544465	.	C	T	0	6	6	0	1	7	0	0
22	18544992	.	T	C	11	4	15	0	2	17	0	0
22	18725485	.	T	A	3	6	9	0	1	10	0	0
22	18726040	.	A	T	19	7	26	0	3	29	0	0
22	18726470	.	A	T	18	17	35	0	4	39	0	0
22	18726505	.	T	A	15	20	35	0	0	35	0	0
22	18726668	.	C	A	13	12	25	0	0	25	0	0
22	18727787	.	C	A	0	6	6	0	9	15	0	0
22	18727890	.	G	A	10	6	16	0	1	17	0	0
22	18736182	.	C	T	7	11	18	0	1	19	0	0
22	18736859	.	A	G	7	7	14	0	2	16	0	0
22	18746486	.	A	G	2	3	5	0	0	5	0	0
22	18778872	.	C	T	22	20	42	0	2	44	0	0
22	18778895	.	A	C	28	14	42	0	3	45	0	0
22	18799190	.	C	T	1	3	4	0	0	4	0	0
22	20313722	.	C	A	21	9	30	0	12	42	0	0
22	20952534	.	T	C	2	2	4	0	0	4	0	0
22	21359357	.	G	A	6	1	7	0	0	7	0	0
22	21359360	.	T	C	3	2	5	0	3	8	0	0
22	21361753	.	T	C	0	2	2	0	0	2	0	0
22	21365143	.	C	T	0	2	2	0	4	6	0	0
22	21367155	.	G	C	1	3	4	0	1	5	0	0
22	21369882	.	C	T	0	2	2	0	2	4	0	0
22	21372030	.	A	G	0	3	3	0	0	3	0	0
22	21465461	.	G	A	1	2	3	0	0	3	0	0
22	21465597	.	G	T	6	6	12	0	1	13	0	0
22	21465606	.	T	C	6	8	14	0	0	14	0	0
22	21584038	.	G	A	2	2	4	0	1	5	0	0
22	21618633	.	G	A	3	2	5	0	0	5	0	0
22	21624764	.	G	C	2	1	3	0	1	4	0	0
22	21657891	.	G	A	0	2	2	0	1	3	0	0
22	21661258	.	T	A	2	1	3	0	0	3	0	0
22	21661789	.	G	A	5	3	8	0	0	8	0	0
22	21662138	.	G	A	0	4	4	0	3	7	0	0
22	21676296	.	G	A	0	8	8	0	1	9	0	0
22	21852158	.	C	T	11	10	21	0	0	21	0	0
22	21852269	.	A	G	6	3	9	0	1	10	0	0
22	21852281	.	T	C	6	0	6	0	3	9	0	0
22	22129754	.	A	G	2	4	6	0	1	7	0	0
22	22130528	.	G	A	2	3	5	0	0	5	0	0
22	22130549	.	T	C	2	2	4	0	1	5	0	0
22	22141373	.	T	C	2	2	4	0	0	4	0	0
22	22141533	.	T	C	5	2	7	0	0	7	0	0
22	22141567	.	G	A	1	3	4	0	0	4	0	0
22	22141650	.	T	A	1	5	6	0	0	6	0	0
22	22142272	.	G	A	1	2	3	0	0	3	0	0
22	22142293	.	A	T	0	2	2	0	0	2	0	0
22	22179714	.	A	G	3	1	4	0	0	4	0	0
22	22179825	.	C	T	1	1	2	0	0	2	0	0
22	22187939	.	T	A	1	2	3	0	0	3	0	0
22	22188682	.	T	C	7	7	14	0	1	15	0	0
22	22188715	.	T	C	5	10	15	0	1	16	0	0
22	22188717	.	C	T	5	10	15	0	1	16	0	0
22	22231662	.	C	T	1	2	3	0	1	4	0	0
22	22231717	.	A	T	5	3	8	0	0	8	0	0
22	22234418	.	C	T	0	9	9	0	17	26	0	0
22	22234750	.	G	A	2	12	14	0	1	15	0	0
22	22240918	.	G	A	2	2	4	0	0	4	0	0
22	22241769	.	A	G	4	2	6	0	1	7	0	0
22	22245435	.	C	T	6	4	10	0	0	10	0	0
22	22245617	.	A	G	2	3	5	0	0	5	0	0
22	22245781	.	G	T	5	5	10	0	0	10	0	0
22	22245812	.	C	T	6	4	10	0	1	11	0	0
22	22259155	.	G	A	2	4	6	0	1	7	0	0
22	22273388	.	C	T	1	2	3	0	0	3	0	0
22	22273465	.	G	A	3	4	7	0	0	7	0	0
22	22274249	.	T	G	2	2	4	0	1	5	0	0
22	22312496	.	C	A	2	3	5	0	0	5	0	0
22	22312548	.	C	A	2	1	3	0	1	4	0	0
22	22313686	.	G	A	0	2	2	0	2	4	0	0
22	22313710	.	C	A	2	3	5	0	0	5	0	0
22	22313794	.	G	A	4	4	8	0	0	8	0	0
22	22314043	.	T	G	0	4	4	0	2	6	0	0
22	22314094	.	T	C	2	1	3	0	0	3	0	0
22	22314135	.	A	G	2	3	5	0	0	5	0	0
22	22314276	.	T	C	1	6	7	0	0	7	0	0
22	22314547	.	T	G	4	6	10	0	0	10	0	0
22	22314564	.	C	A	2	8	10	0	1	11	0	0
22	22314991	.	T	C	2	3	5	0	1	6	0	0
22	22315211	.	A	G	3	5	8	0	0	8	0	0
22	22315277	.	A	G	2	3	5	0	0	5	0	0
22	22315298	.	C	T	1	1	2	0	0	2	0	0
22	22345197	.	C	T	8	12	20	0	2	22	0	0
22	22348234	.	A	G	4	1	5	0	1	6	0	0
22	22350963	.	C	T	4	3	7	0	0	7	0	0
22	22351180	.	A	T	4	2	6	0	0	6	0	0
22	22352249	.	C	T	2	4	6	0	0	6	0	0
22	22352312	.	T	C	5	4	9	0	1	10	0	0
22	22352611	.	A	C	1	2	3	0	0	3	0	0
22	22352693	.	T	A	4	4	8	0	2	10	0	0
22	22353128	.	G	A	4	4	8	0	1	9	0	0
22	22353470	.	G	A	1	2	3	0	0	3	0	0
22	22420646	.	G	T	0	2	2	0	2	4	0	0
22	22420664	.	A	G	2	3	5	0	0	5	0	0
22	22420746	.	G	T	2	1	3	0	0	3	0	0
22	22422123	.	A	T	0	1	1	0	0	1	0	0
22	22424034	.	G	A	1	0	1	0	0	1	0	0
22	22424085	.	A	T	1	6	7	0	0	7	0	0
22	22424106	.	G	A	0	5	5	0	3	8	0	0
22	22425439	.	T	C	6	3	9	0	0	9	0	0
22	22427415	.	T	C	7	9	16	0	0	16	0	0
22	22427442	.	T	C	5	6	11	0	0	11	0	0
22	22427694	.	C	T	9	6	15	0	4	19	0	0
22	22634944	.	A	T	2	2	4	0	0	4	0	0
22	22634971	.	G	T	1	2	3	0	0	3	0	0
22	22979798	.	T	C	0	2	2	0	0	2	0	0
22	23492909	.	A	C	1	2	3	0	0	3	0	0
22	23492910	.	T	A	1	2	3	0	0	3	0	0
22	23575330	.	C	T	1	0	1	0	0	1	0	0
22	24157961	.	G	C	4	7	11	0	0	11	0	0
22	24158146	.	A	C	4	4	8	0	1	9	0	0
22	24158190	.	C	T	8	6	14	0	2	16	0	0
22	24158242	.	C	A	9	11	20	0	0	20	0	0
22	24158275	.	G	C	8	5	13	0	2	15	0	0
22	24166896	.	G	A	0	9	9	0	9	18	0	0
22	24166919	.	A	G	8	12	20	0	0	20	0	0
22	24167633	.	C	T	11	14	25	0	1	26	0	0
22	24168125	.	T	C	19	14	33	0	0	33	0	0
22	24168573	.	T	C	23	13	36	0	0	36	0	0
22	24168610	.	T	A	21	21	42	0	2	44	0	0
22	24218656	.	T	A	3	5	8	0	0	8	0	0
22	24220962	.	A	G	8	7	15	0	1	16	0	0
22	24220996	.	G	A	10	7	17	0	0	17	0	0
22	24221009	.	C	T	8	9	17	0	0	17	0	0
22	24225409	.	T	C	3	3	6	0	0	6	0	0
22	24229513	.	T	C	11	15	26	0	0	26	0	0
22	24229890	.	T	C	6	3	9	0	0	9	0	0
22	24230005	.	G	A	0	3	3	0	2	5	0	0
22	24230020	.	G	A	9	7	16	0	0	16	0	0
22	24233536	.	G	T	13	16	29	0	1	30	0	0
22	24233730	.	C	T	1	3	4	0	0	4	0	0
22	24361095	.	A	G	10	8	18	0	2	20	0	0
22	24715404	.	A	G	1	0	1	0	6	7	0	0
22	24716636	.	T	A	11	10	21	0	0	21	0	0
22	24717105	.	G	A	3	3	6	0	1	7	0	0
22	24718973	.	T	C	10	9	19	0	1	20	0	0
22	24975668	.	C	T	0	3	3	0	5	8	0	0
22	24975792	.	C	T	1	1	2	0	1	3	0	0
22	24981171	.	T	C	0	2	2	0	0	2	0	0
22	25028660	.	G	A	1	1	2	0	0	2	0	0
22	25028694	.	G	A	3	6	9	0	0	9	0	0
22	25028751	.	A	G	4	5	9	0	2	11	0	0
22	25028838	.	A	G	4	2	6	0	0	6	0	0
22	25029136	.	T	A	7	4	11	0	0	11	0	0
22	25029193	.	C	G	0	1	1	0	3	4	0	0
22	25032266	.	C	T	10	6	16	0	0	16	0	0
22	25032293	.	T	C	11	7	18	0	0	18	0	0
22	25032344	.	C	T	1	7	8	0	6	14	0	0
22	25032665	.	T	C	3	4	7	0	6	13	0	0
22	25032693	.	T	C	5	8	13	0	3	16	0	0
22	25038315	.	C	T	3	1	4	0	2	6	0	0
22	25038360	.	T	C	3	3	6	0	0	6	0	0
22	25038387	.	A	G	1	5	6	0	0	6	0	0
22	25038432	.	T	C	0	7	7	0	0	7	0	0
22	25040814	.	G	A	5	4	9	0	2	11	0	0
22	25042166	.	A	G	3	1	4	0	0	4	0	0
22	25042879	.	G	A	1	3	4	0	0	4	0	0
22	25059919	.	G	A	0	2	2	0	1	3	0	0
22	25060629	.	C	A	1	0	1	0	0	1	0	0
22	25063745	.	C	A	6	4	10	0	1	11	0	0
22	25063767	.	C	A	4	4	8	0	0	8	0	0
22	25063882	.	C	T	1	2	3	0	0	3	0	0
22	25066332	.	C	T	0	3	3	0	5	8	0	0
22	25066410	.	T	C	8	14	22	0	1	23	0	0
22	25066583	.	A	G	8	4	12	0	2	14	0	0
22	25066939	.	C	T	4	5	9	0	2	11	0	0
22	25067274	.	A	G	1	4	5	0	0	5	0	0
22	25067596	.	C	T	1	3	4	0	0	4	0	0
22	25076727	.	A	G	5	7	12	0	2	14	0	0
22	25078630	.	A	C	3	8	11	0	0	11	0	0
22	25094986	.	G	A	0	1	1	0	0	1	0	0
22	25136371	.	G	A	1	2	3	0	0	3	0	0
22	25136381	.	G	A	1	2	3	0	0	3	0	0
22	25136437	.	G	A	1	2	3	0	0	3	0	0
22	25554433	.	C	T	0	1	1	0	0	1	0	0
22	25558774	.	T	C	2	2	4	0	0	4	0	0
22	25573313	.	G	A	0	1	1	0	0	1	0	0
22	25581699	.	A	G	3	2	5	0	0	5	0	0
22	25581722	.	T	C	2	1	3	0	0	3	0	0
22	25582764	.	T	C	2	6	8	0	1	9	0	0
22	25586906	.	T	A	1	2	3	0	1	4	0	0
22	25844997	.	C	T	1	1	2	0	1	3	0	0
22	25845010	.	C	T	2	2	4	0	0	4	0	0
22	25934659	.	G	A	0	1	1	0	0	1	0	0
22	25934662	.	A	G	0	1	1	0	0	1	0	0
22	25935627	.	G	A	1	3	4	0	8	12	0	0
22	25937001	.	G	A	0	1	1	0	0	1	0	0
22	25937037	.	T	A	2	2	4	0	0	4	0	0
22	25937052	.	T	C	2	2	4	0	0	4	0	0
22	25939060	.	C	T	0	1	1	0	0	1	0	0
22	25939066	.	A	G	1	0	1	0	0	1	0	0
22	25940965	.	A	T	3	3	6	0	0	6	0	0
22	25942349	.	A	G	2	7	9	0	0	9	0	0
22	25942390	.	A	C	1	0	1	0	0	1	0	0
22	25942392	.	C	A	1	0	1	0	0	1	0	0
22	25942586	.	G	T	9	3	12	0	0	12	0	0
22	25942659	.	A	G	4	2	6	0	0	6	0	0
22	25942769	.	T	C	7	4	11	0	1	12	0	0
22	25942985	.	G	T	6	7	13	0	0	13	0	0
22	26239610	.	G	A	7	6	13	0	1	14	0	0
22	26239654	.	A	T	7	12	19	0	1	20	0	0
22	26239752	.	G	A	11	3	14	0	3	17	0	0
22	26239798	.	C	A	0	5	5	0	9	14	0	0
22	26239873	.	T	A	12	7	19	0	0	19	0	0
22	26239879	.	G	A	11	7	18	0	0	18	0	0
22	26244704	.	C	T	5	5	10	0	0	10	0	0
22	26244755	.	C	T	6	3	9	0	2	11	0	0
22	26264805	.	T	A	1	1	2	0	0	2	0	0
22	26264807	.	A	G	1	1	2	0	0	2	0	0
22	26266765	.	C	T	7	1	8	0	1	9	0	0
22	26266798	.	C	A	1	1	2	0	0	2	0	0
22	26266807	.	T	A	1	1	2	0	0	2	0	0
22	26277695	.	T	C	3	8	11	0	1	12	0	0
22	26277735	.	A	C	3	7	10	0	3	13	0	0
22	26277773	.	G	A	5	8	13	0	0	13	0	0
22	26277820	.	T	C	7	4	11	0	0	11	0	0
22	26277871	.	C	A	3	2	5	0	0	5	0	0
22	26278042	.	T	C	5	2	7	0	0	7	0	0
22	26278081	.	C	T	4	5	9	0	1	10	0	0
22	26278144	.	T	G	7	3	10	0	0	10	0	0
22	26281043	.	A	G	8	4	12	0	0	12	0	0
22	26289397	.	A	C	1	0	1	0	0	1	0	0
22	26289430	.	G	A	3	1	4	0	0	4	0	0
22	26290324	.	C	T	6	7	13	0	0	13	0	0
22	26290508	.	C	T	18	7	25	0	3	28	0	0
22	26290764	.	A	G	4	4	8	0	0	8	0	0
22	26290771	.	A	C	4	1	5	0	0	5	0	0
22	26290851	.	A	T	1	2	3	0	0	3	0	0
22	26309106	.	C	G	1	2	3	0	0	3	0	0
22	26311254	.	A	G	4	4	8	0	0	8	0	0
22	26524896	.	G	A	5	6	11	0	1	12	0	0
22	26524910	.	A	T	6	4	10	0	0	10	0	0
22	26525535	.	C	T	3	2	5	0	0	5	0	0
22	26526057	.	C	T	0	7	7	0	2	9	0	0
22	26526127	.	G	T	7	9	16	0	0	16	0	0
22	26526135	.	G	C	6	7	13	0	1	14	0	0
22	26526178	.	T	C	6	6	12	0	1	13	0	0
22	26526293	.	A	C	4	5	9	0	0	9	0	0
22	26526637	.	C	T	0	9	9	0	7	16	0	0
22	26526710	.	G	A	3	5	8	0	1	9	0	0
22	26526722	.	A	G	3	4	7	0	0	7	0	0
22	26526969	.	A	T	4	3	7	0	0	7	0	0
22	26527792	.	A	G	4	3	7	0	0	7	0	0
22	26528781	.	G	A	0	2	2	0	0	2	0	0
22	26528783	.	T	C	0	0	0	0	2	2	0	0
22	26529278	.	T	G	2	2	4	0	1	5	0	0
22	26858108	.	T	C	7	3	10	0	0	10	0	0
22	29119249	.	A	G	1	1	2	0	1	3	0	0
22	29119270	.	T	C	0	5	5	0	0	5	0	0
22	29858936	.	T	C	10	16	26	0	1	27	0	0
22	30359955	.	G	T	12	2	14	0	0	14	0	0
22	31671957	.	T	A	9	5	14	0	3	17	0	0
22	32291834	.	T	C	11	0	11	0	11	22	0	0
22	32291836	.	T	C	8	0	8	0	14	22	0	0
22	33592309	.	T	C	9	8	17	0	0	17	0	0
22	33592530	.	G	T	3	7	10	0	0	10	0	0
22	33639388	.	G	A	3	1	4	0	0	4	0	0
22	33791208	.	G	A	3	2	5	0	1	6	0	0
22	33915629	.	G	A	5	1	6	0	1	7	0	0
22	35206302	.	A	T	3	2	5	0	0	5	0	0
22	35531002	.	C	T	3	5	8	0	0	8	0	0
22	35531196	.	G	A	3	4	7	0	1	8	0	0
22	35531281	.	G	A	3	2	5	0	0	5	0	0
22	35531376	.	A	G	1	4	5	0	1	6	0	0
22	35531485	.	C	G	1	5	6	0	0	6	0	0
22	36524302	.	T	C	2	3	5	0	1	6	0	0
22	36527075	.	C	T	0	2	2	0	0	2	0	0
22	36527591	.	A	G	0	1	1	0	0	1	0	0
22	36616814	.	G	A	0	0	0	0	1	1	0	0
22	36622717	.	A	G	1	1	2	0	0	2	0	0
22	36634111	.	T	C	5	5	10	0	0	10	0	0
22	36634127	.	T	C	5	5	10	0	0	10	0	0
22	36676056	.	G	C	9	10	19	0	2	21	0	0
22	36679390	.	G	A	12	13	25	0	1	26	0	0
22	36683803	.	C	A	4	2	6	0	0	6	0	0
22	36685729	.	C	T	16	7	23	0	2	25	0	0
22	36686828	.	G	A	1	2	3	0	0	3	0	0
22	36686867	.	G	A	3	8	11	0	1	12	0	0
22	36686870	.	A	G	4	7	11	0	1	12	0	0
22	36686948	.	G	T	1	3	4	0	1	5	0	0
22	36687328	.	G	A	1	3	4	0	1	5	0	0
22	36687403	.	G	A	4	1	5	0	1	6	0	0
22	36687541	.	T	C	1	6	7	0	0	7	0	0
22	36687616	.	C	T	0	10	10	0	4	14	0	0
22	36690668	.	T	A	6	10	16	0	1	17	0	0
22	36755371	.	T	G	1	5	6	0	1	7	0	0
22	36755554	.	A	C	5	3	8	0	0	8	0	0
22	36755641	.	C	T	1	5	6	0	0	6	0	0
22	36755662	.	A	G	3	1	4	0	0	4	0	0
22	36755751	.	A	T	1	6	7	0	0	7	0	0
22	36755831	.	G	A	4	5	9	0	2	11	0	0
22	36755963	.	G	C	2	0	2	0	12	14	0	0
22	36756112	.	A	G	3	8	11	0	0	11	0	0
22	36756400	.	C	T	5	5	10	0	2	12	0	0
22	36756404	.	G	C	5	7	12	0	1	13	0	0
22	36756464	.	T	A	5	3	8	0	0	8	0	0
22	36795845	.	G	T	4	6	10	0	1	11	0	0
22	36798416	.	G	A	0	2	2	0	0	2	0	0
22	36800981	.	G	C	3	4	7	0	0	7	0	0
22	36875449	.	T	G	1	2	3	0	0	3	0	0
22	36877484	.	G	T	1	1	2	0	0	2	0	0
22	36882150	.	G	A	2	5	7	0	0	7	0	0
22	36882168	.	G	A	0	2	2	0	4	6	0	0
22	36882189	.	G	A	0	2	2	0	2	4	0	0
22	36882409	.	T	A	2	0	2	0	0	2	0	0
22	36887954	.	C	T	1	1	2	0	0	2	0	0
22	36888623	.	A	G	3	1	4	0	1	5	0	0
22	36891142	.	G	A	3	3	6	0	0	6	0	0
22	36893330	.	T	C	5	1	6	0	0	6	0	0
22	36893357	.	G	A	2	8	10	0	0	10	0	0
22	36894316	.	T	A	8	5	13	0	0	13	0	0
22	36894410	.	A	C	2	2	4	0	0	4	0	0
22	36896641	.	G	A	0	2	2	0	2	4	0	0
22	36896677	.	G	T	5	8	13	0	0	13	0	0
22	36899269	.	C	T	4	3	7	0	0	7	0	0
22	36899483	.	G	A	0	6	6	0	5	11	0	0
22	36899611	.	C	A	7	3	10	0	0	10	0	0
22	36899621	.	A	T	5	7	12	0	0	12	0	0
22	36947793	.	T	A	6	7	13	0	0	13	0	0
22	36947836	.	C	A	4	5	9	0	1	10	0	0
22	36947849	.	G	A	6	6	12	0	0	12	0	0
22	36947879	.	G	C	10	8	18	0	1	19	0	0
22	36947997	.	A	G	8	8	16	0	1	17	0	0
22	36948052	.	T	G	6	9	15	0	0	15	0	0
22	36948133	.	G	A	1	5	6	0	0	6	0	0
22	36948134	.	C	T	1	5	6	0	0	6	0	0
22	36948202	.	C	A	7	3	10	0	2	12	0	0
22	36948395	.	T	C	7	0	7	0	9	16	0	0
22	36948603	.	T	A	7	7	14	0	1	15	0	0
22	37276451	.	G	A	2	2	4	0	0	4	0	0
22	37276635	.	T	C	9	0	9	0	11	20	0	0
22	37276709	.	C	T	0	6	6	0	11	17	0	0
22	37278141	.	G	A	6	2	8	0	1	9	0	0
22	37278146	.	A	C	6	1	7	0	1	8	0	0
22	37278260	.	G	T	0	6	6	0	0	6	0	0
22	37278283	.	A	T	1	3	4	0	0	5	1	0
22	37278475	.	A	G	19	5	24	0	2	26	0	0
22	37278479	.	T	C	18	1	19	0	6	25	0	0
22	37278634	.	C	T	0	5	5	0	0	5	0	0
22	37352700	.	C	G	1	9	10	0	1	11	0	0
22	37534114	.	T	C	0	2	2	0	0	2	0	0
22	37534122	.	C	G	1	3	4	0	0	4	0	0
22	37542836	.	C	A	3	7	10	0	0	10	0	0
22	37543070	.	A	T	14	8	22	0	0	22	0	0
22	37543457	.	A	G	14	11	25	0	0	25	0	0
22	37551496	.	T	C	1	2	3	0	0	3	0	0
22	37552717	.	G	A	5	3	8	0	0	8	0	0
22	37552783	.	A	C	13	2	15	0	14	29	0	0
22	37557531	.	G	A	4	9	13	0	1	14	0	0
22	37558433	.	C	T	0	2	2	0	0	2	0	0
22	37559603	.	G	A	1	2	3	0	1	4	0	0
22	37561642	.	C	G	2	0	2	0	0	2	0	0
22	37588622	.	T	C	10	1	11	0	9	20	0	0
22	37588667	.	A	C	11	10	21	0	2	23	0	0
22	37588715	.	T	C	12	9	21	0	7	28	0	0
22	37589420	.	T	C	3	4	7	0	1	8	0	0
22	37590171	.	C	T	1	3	4	0	0	4	0	0
22	37590339	.	A	T	9	8	17	0	5	22	0	0
22	37590535	.	C	T	10	3	13	0	0	13	0	0
22	37590925	.	T	C	9	7	16	0	0	16	0	0
22	37591023	.	A	C	4	2	6	0	0	6	0	0
22	37591457	.	T	C	2	7	9	0	0	9	0	0
22	37591491	.	A	T	9	3	12	0	1	13	0	0
22	37641741	.	G	A	2	1	3	0	0	3	0	0
22	37644009	.	C	A	7	6	13	0	0	13	0	0
22	37644021	.	C	G	6	5	11	0	0	11	0	0
22	37644048	.	A	G	1	1	2	0	0	2	0	0
22	37646124	.	C	T	4	2	6	0	1	7	0	0
22	37646226	.	T	A	1	0	1	0	0	1	0	0
22	37652191	.	C	T	3	2	5	0	0	5	0	0
22	37652925	.	C	T	0	2	2	0	0	2	0	0
22	37655702	.	C	T	3	1	4	0	1	5	0	0
22	37697408	.	C	T	2	4	6	0	1	7	0	0
22	37708199	.	T	A	14	19	33	0	2	35	0	0
22	37710178	.	G	T	0	1	1	0	2	3	0	0
22	37716493	.	G	C	3	9	12	0	0	12	0	0
22	37805329	.	C	T	16	14	30	0	4	34	0	0
22	37823332	.	C	A	0	3	3	0	4	7	0	0
22	37875270	.	T	C	0	4	4	0	0	4	0	0
22	37881126	.	C	T	2	7	9	0	0	9	0	0
22	37881134	.	G	A	1	7	8	0	0	8	0	0
22	38016901	.	G	C	0	1	1	0	1	2	0	0
22	38037603	.	G	T	4	1	5	0	2	7	0	0
22	38044902	.	G	C	0	8	8	0	6	14	0	0
22	38045009	.	T	A	7	13	20	0	0	20	0	0
22	38045213	.	G	T	3	2	5	0	1	6	0	0
22	38191715	.	A	G	1	3	4	0	1	5	0	0
22	38192440	.	A	G	1	2	3	0	0	3	0	0
22	38194106	.	C	T	1	2	3	0	0	3	0	0
22	38194415	.	A	G	0	3	3	0	0	3	0	0
22	38194419	.	G	C	0	2	2	0	1	3	0	0
22	38195217	.	G	A	12	9	21	1	1	23	0	0
22	38197777	.	C	T	1	1	2	0	1	3	0	0
22	38197783	.	G	C	3	4	7	0	0	7	0	0
22	38199812	.	A	G	8	10	18	0	1	19	0	0
22	38205099	.	C	T	0	4	4	0	3	7	0	0
22	38211271	.	C	A	0	2	2	0	1	3	0	0
22	38283993	.	A	G	3	0	3	0	0	3	0	0
22	38525072	.	C	G	0	4	4	0	0	5	1	0
22	38525093	.	A	G	1	1	2	0	0	2	0	0
22	38912360	.	A	G	3	3	6	0	0	6	0	0
23	251628	.	A	T	1	6	7	0	0	7	0	0
23	310662	.	G	T	9	5	14	0	2	16	0	0
23	310860	.	G	C	5	2	7	0	0	7	0	0
23	312700	.	C	A	2	2	4	0	0	4	0	0
23	312703	.	A	C	3	3	6	0	0	6	0	0
23	313274	.	G	A	14	6	20	0	0	20	0	0
23	313368	.	A	G	8	0	8	0	7	15	0	0
23	313382	.	C	G	3	9	12	0	3	15	0	0
23	313485	.	G	A	2	4	6	0	0	6	0	0
23	313559	.	G	A	2	4	6	0	0	6	0	0
23	313942	.	T	C	0	3	3	0	0	3	0	0
23	313943	.	G	A	0	3	3	0	0	3	0	0
23	314018	.	G	A	2	5	7	0	0	7	0	0
23	314235	.	C	T	2	5	7	0	0	7	0	0
23	314268	.	T	C	5	2	7	0	0	7	0	0
23	314316	.	C	T	1	2	3	0	0	3	0	0
23	314370	.	T	A	3	4	7	0	0	7	0	0
23	314413	.	G	T	0	6	6	0	6	12	0	0
23	314523	.	C	T	3	5	8	0	0	8	0	0
23	314561	.	G	A	4	4	8	0	1	9	0	0
23	314573	.	A	G	3	5	8	0	2	10	0	0
23	314841	.	A	T	3	4	7	0	0	7	0	0
23	314850	.	T	C	6	3	9	0	0	9	0	0
23	314910	.	C	T	5	4	9	0	1	10	0	0
23	315057	.	G	C	2	4	6	0	0	6	0	0
23	315286	.	A	G	30	18	48	0	3	51	0	0
23	320806	.	T	C	2	2	4	0	0	4	0	0
23	320819	.	A	G	2	2	4	0	1	5	0	0
23	328783	.	G	T	1	3	4	0	0	4	0	0
23	328806	.	C	G	1	4	5	0	0	5	0	0
23	355954	.	C	T	1	3	4	0	0	4	0	0
23	359371	.	A	T	0	2	2	0	0	2	0	0
23	359442	.	C	T	3	6	9	0	0	9	0	0
23	366662	.	T	C	2	4	6	0	1	7	0	0
23	367431	.	T	A	4	10	14	0	2	16	0	0
23	367500	.	C	T	4	7	11	0	1	12	0	0
23	367674	.	A	T	1	2	3	0	0	3	0	0
23	367682	.	T	C	1	2	3	0	0	3	0	0
23	457872	.	T	C	5	9	14	0	2	16	0	0
23	457995	.	A	T	6	3	9	0	1	10	0	0
23	458194	.	T	A	5	6	11	0	1	12	0	0
23	458254	.	T	C	6	7	13	0	0	13	0	0
23	458297	.	C	T	6	3	9	0	0	9	0	0
23	459671	.	C	T	0	6	6	0	8	14	0	0
23	460612	.	G	C	1	3	4	0	0	4	0	0
23	461177	.	T	C	4	2	6	0	1	7	0	0
23	480551	.	C	G	8	11	19	0	2	21	0	0
23	480552	.	A	G	10	11	21	0	0	21	0	0
23	481089	.	T	G	30	13	43	0	2	45	0	0
23	484376	.	C	A	5	3	8	0	1	9	0	0
23	484588	.	G	A	5	3	8	0	1	9	0	0
23	488257	.	A	G	2	1	3	0	0	3	0	0
23	488996	.	G	A	5	1	6	0	1	7	0	0
23	496582	.	C	T	2	2	4	0	0	4	0	0
23	528234	.	T	A	1	3	4	0	0	4	0	0
23	529416	.	G	A	0	3	3	0	0	3	0	0
23	547870	.	T	G	1	3	4	0	0	4	0	0
23	547873	.	G	A	1	3	4	0	0	4	0	0
23	551277	.	C	T	1	5	6	0	0	6	0	0
23	552367	.	T	C	7	5	12	0	0	12	0	0
23	552392	.	C	G	0	4	4	0	5	9	0	0
23	570688	.	G	A	6	9	15	0	0	15	0	0
23	570702	.	A	C	7	9	16	0	2	18	0	0
23	571355	.	A	G	9	14	23	0	0	23	0	0
23	571415	.	C	A	0	11	11	0	6	17	0	0
23	571724	.	A	G	2	3	5	0	0	5	0	0
23	584380	.	G	A	0	5	5	0	7	12	0	0
23	584580	.	G	A	1	6	7	0	6	13	0	0
23	584790	.	G	A	0	3	3	0	5	8	0	0
23	584938	.	G	A	1	2	3	0	1	4	0	0
23	585655	.	C	T	6	6	12	0	0	12	0	0
23	585691	.	G	C	0	3	3	0	9	12	0	0
23	585825	.	A	G	5	12	17	0	2	19	0	0
23	585848	.	A	G	8	0	8	0	10	18	0	0
23	585877	.	A	T	7	4	11	0	1	12	0	0
23	586149	.	T	C	6	4	10	0	1	11	0	0
23	586158	.	A	T	6	5	11	0	1	12	0	0
23	586371	.	G	A	0	3	3	0	5	8	0	0
23	586379	.	T	C	4	3	7	0	0	7	0	0
23	586529	.	C	G	3	1	4	0	5	9	0	0
23	586614	.	A	T	6	6	12	0	2	14	0	0
23	586874	.	G	A	5	11	16	0	0	16	0	0
23	587119	.	A	C	2	4	6	0	3	9	0	0
23	587169	.	A	C	3	9	12	0	2	14	0	0
23	587341	.	G	T	10	7	17	0	1	18	0	0
23	587360	.	T	G	8	4	12	0	0	12	0	0
23	587437	.	G	T	11	4	15	0	1	16	0	0
23	587581	.	G	A	13	12	25	0	0	25	0	0
23	587614	.	T	G	6	11	17	0	2	19	0	0
23	587806	.	T	G	6	11	17	0	3	20	0	0
23	587830	.	A	C	7	15	22	0	1	23	0	0
23	587890	.	A	C	13	18	31	0	0	31	0	0
23	587924	.	A	T	12	25	37	0	5	42	0	0
23	587966	.	C	T	21	27	48	0	2	50	0	0
23	597127	.	A	C	3	3	6	0	0	6	0	0
23	597163	.	C	T	1	1	2	0	1	3	0	0
23	597548	.	T	G	4	5	9	0	1	10	0	0
23	650656	.	C	T	1	0	1	0	0	1	0	0
23	650734	.	C	T	1	0	1	0	0	1	0	0
23	804124	.	A	G	1	2	3	0	0	3	0	0
23	804154	.	G	C	1	0	1	0	3	4	0	0
23	804164	.	A	G	1	1	2	0	1	3	0	0
23	828299	.	G	A	1	1	2	0	0	2	0	0
23	829340	.	A	C	1	2	3	0	0	3	0	0
23	829386	.	C	A	1	2	3	0	0	3	0	0
23	831659	.	C	T	1	2	3	0	0	3	0	0
23	835575	.	G	C	5	3	8	0	0	8	0	0
23	835712	.	A	G	1	5	6	0	0	6	0	0
23	835717	.	T	C	1	5	6	0	0	6	0	0
23	838285	.	C	G	4	5	9	0	1	10	0	0
23	862391	.	A	G	2	2	4	0	0	4	0	0
23	862423	.	G	C	3	2	5	0	0	5	0	0
23	862501	.	C	G	1	8	9	0	0	9	0	0
23	862713	.	T	G	1	3	4	0	0	4	0	0
23	862782	.	T	A	5	9	14	0	0	14	0	0
23	863024	.	G	A	5	3	8	0	1	9	0	0
23	863261	.	C	A	3	6	9	0	0	9	0	0
23	863574	.	T	C	12	4	16	0	1	17	0	0
23	863659	.	T	C	5	7	12	0	1	13	0	0
23	863673	.	T	C	4	4	8	0	1	9	0	0
23	864418	.	C	T	1	2	3	0	0	3	0	0
23	865619	.	T	C	3	4	7	0	1	8	0	0
23	865644	.	G	T	2	2	4	0	0	4	0	0
23	865892	.	T	C	1	3	4	0	0	4	0	0
23	865903	.	A	G	1	4	5	0	0	5	0	0
23	865999	.	C	T	0	3	3	0	3	6	0	0
23	866004	.	A	T	3	3	6	0	0	6	0	0
23	866409	.	A	G	0	0	0	0	1	1	0	0
23	866439	.	C	T	0	1	1	0	1	2	0	0
23	866444	.	T	C	1	0	1	0	1	2	0	0
23	874620	.	A	G	1	0	1	0	0	1	0	0
23	874621	.	T	G	1	0	1	0	0	1	0	0
23	895965	.	G	A	2	2	4	0	0	4	0	0
23	896023	.	C	A	1	2	3	0	0	3	0	0
23	898127	.	A	G	0	1	1	0	0	1	0	0
23	903104	.	A	G	1	6	7	0	0	7	0	0
23	903212	.	G	C	18	17	35	0	3	38	0	0
23	903334	.	G	A	14	24	38	0	2	40	0	0
23	903415	.	T	A	11	18	29	0	2	31	0	0
23	903553	.	T	G	22	24	46	0	4	51	1	0
23	903848	.	G	A	14	15	29	0	2	31	0	0
23	906346	.	T	A	2	3	5	0	0	5	0	0
23	910357	.	A	G	6	3	9	0	2	11	0	0
23	1043130	.	C	T	1	1	2	0	0	2	0	0
23	1043140	.	C	T	2	1	3	0	0	3	0	0
23	1043275	.	T	C	1	1	2	0	0	2	0	0
23	1043283	.	G	A	1	1	2	0	0	2	0	0
23	1049304	.	T	A	3	1	4	0	0	4	0	0
23	1049318	.	A	C	1	1	2	0	0	2	0	0
23	1697238	.	T	G	5	0	5	0	1	6	0	0
23	1697242	.	C	T	5	1	6	0	0	6	0	0
23	1697434	.	C	T	1	2	3	0	0	3	0	0
23	1697469	.	G	A	0	2	2	0	0	2	0	0
23	1697513	.	G	A	0	3	3	0	0	3	0	0
23	1697517	.	T	C	0	2	2	0	0	2	0	0
23	1697690	.	A	G	5	5	10	0	0	10	0	0
23	1698053	.	T	C	10	4	14	0	0	14	0	0
23	1698202	.	C	T	12	6	18	0	0	18	0	0
23	1698229	.	G	T	8	5	13	0	1	14	0	0
23	1698358	.	G	T	0	2	2	0	5	7	0	0
23	1709724	.	C	T	1	4	5	0	0	5	0	0
23	3712484	.	T	C	4	2	6	0	0	6	0	0
23	5587860	.	G	A	1	4	5	0	0	5	0	0
23	5756781	.	G	T	3	2	5	0	0	5	0	0
23	5757010	.	G	A	3	2	5	0	0	5	0	0
23	5757047	.	A	T	2	2	4	0	0	4	0	0
23	5757055	.	C	T	1	1	2	0	0	2	0	0
23	5757193	.	G	T	2	3	5	0	0	5	0	0
23	5757202	.	C	T	0	2	2	0	1	3	0	0
23	5758610	.	G	A	2	8	10	0	2	12	0	0
23	6011931	.	G	A	1	3	4	0	0	4	0	0
23	6301287	.	T	A	1	0	1	0	0	1	0	0
23	6304243	.	A	G	2	0	2	0	1	3	0	0
23	6304249	.	T	C	2	1	3	0	0	3	0	0
23	6313752	.	T	A	8	3	11	0	1	12	0	0
23	6632043	.	G	A	0	3	3	0	1	4	0	0
23	6632044	.	A	T	1	3	4	0	0	4	0	0
23	6673724	.	C	A	0	12	12	0	12	24	0	0
23	6673956	.	A	G	12	11	23	0	3	26	0	0
23	6673991	.	A	C	8	18	26	0	4	30	0	0
23	6675100	.	C	T	7	2	9	0	1	10	0	0
23	6675135	.	G	A	2	7	9	0	0	9	0	0
23	6675325	.	G	T	7	10	17	0	0	17	0	0
23	6675537	.	G	A	6	13	19	0	0	19	0	0
23	6675550	.	A	T	3	15	18	0	0	18	0	0
23	6675835	.	G	A	9	6	15	0	1	16	0	0
23	6675959	.	C	G	5	3	8	0	0	8	0	0
23	6680521	.	T	C	4	0	4	0	3	7	0	0
23	6680880	.	C	T	5	6	11	0	0	11	0	0
23	6682025	.	C	T	2	2	4	0	2	6	0	0
23	6683992	.	C	A	0	2	2	0	4	6	0	0
23	6694340	.	G	A	7	2	9	0	0	9	0	0
23	6694341	.	A	T	7	2	9	0	0	9	0	0
23	6694608	.	A	T	1	2	3	0	0	3	0	0
23	6700626	.	C	A	1	2	3	0	0	3	0	0
23	6707243	.	T	A	1	4	5	0	0	5	0	0
23	6736121	.	T	A	10	12	22	0	1	24	1	0
23	6736166	.	C	T	0	11	11	0	12	23	0	0
23	6744328	.	C	T	2	3	5	0	0	5	0	0
23	6744385	.	C	T	5	8	13	0	1	14	0	0
23	6749754	.	C	G	3	6	9	0	0	9	0	0
23	6753309	.	C	T	3	3	6	0	1	7	0	0
23	6753363	.	C	T	2	4	6	0	0	6	0	0
23	6753414	.	C	T	6	3	9	0	1	10	0	0
23	6753462	.	G	T	0	7	7	0	5	12	0	0
23	6763911	.	C	A	0	2	2	0	1	3	0	0
23	6773374	.	T	C	3	3	6	0	5	11	0	0
23	6780803	.	A	G	5	7	12	0	0	12	0	0
23	6780856	.	G	A	0	5	5	0	5	10	0	0
23	6780859	.	G	A	2	5	7	0	2	9	0	0
23	6780895	.	A	G	1	3	4	0	1	5	0	0
23	6783957	.	C	T	3	5	8	0	0	8	0	0
23	6784176	.	C	T	2	2	4	0	0	4	0	0
23	6795737	.	A	T	3	2	5	0	0	5	0	0
23	6804831	.	T	C	1	1	2	0	0	2	0	0
23	6808515	.	C	T	1	1	2	0	0	2	0	0
23	6814119	.	T	G	3	12	15	0	1	16	0	0
23	6827511	.	C	T	2	2	4	0	1	5	0	0
23	6841005	.	T	C	16	10	26	0	1	27	0	0
23	6841021	.	G	A	1	7	8	0	19	27	0	0
23	6841138	.	C	A	12	8	20	0	1	21	0	0
23	6951157	.	C	T	0	4	4	0	1	5	0	0
23	6952261	.	T	C	0	0	0	0	2	2	0	0
23	6958256	.	A	G	0	2	2	0	0	2	0	0
23	6961490	.	A	G	1	2	3	0	0	3	0	0
23	7000229	.	C	T	6	3	9	0	1	10	0	0
23	7000372	.	C	A	9	2	11	0	1	12	0	0
23	7003572	.	G	T	5	8	13	0	1	14	0	0
23	7003744	.	C	T	2	1	3	0	0	3	0	0
23	7007879	.	C	T	1	3	4	0	0	4	0	0
23	7017443	.	A	G	1	0	1	0	0	1	0	0
23	7024631	.	T	C	9	6	15	0	3	18	0	0
23	7029585	.	G	A	1	2	3	0	0	3	0	0
23	7029600	.	G	A	2	3	5	0	1	6	0	0
23	7029741	.	G	A	2	4	6	0	0	6	0	0
23	7029916	.	A	T	5	1	6	0	0	6	0	0
23	7040725	.	G	A	0	1	1	0	0	1	0	0
23	7046813	.	G	A	2	2	4	0	0	4	0	0
23	7046816	.	G	C	1	0	1	0	3	4	0	0
23	7567105	.	A	G	0	2	2	0	0	2	0	0
23	7578710	.	T	C	9	11	20	0	1	21	0	0
23	7715873	.	G	A	1	3	4	0	0	4	0	0
23	7716023	.	T	C	3	3	6	0	0	6	0	0
23	7716281	.	T	C	2	4	6	0	0	6	0	0
23	7718359	.	C	T	0	3	3	0	0	3	0	0
23	7728606	.	C	T	2	1	3	0	0	3	0	0
23	7732649	.	C	T	4	6	10	0	0	10	0	0
23	7732651	.	T	C	4	6	10	0	0	10	0	0
23	7732866	.	C	G	1	2	3	0	0	3	0	0
23	7732874	.	C	G	1	2	3	0	0	3	0	0
23	7732918	.	G	A	0	3	3	0	1	4	0	0
23	7733043	.	C	T	1	7	8	0	4	12	0	0
23	7733047	.	G	A	7	5	12	0	0	12	0	0
23	7733081	.	A	G	2	6	8	0	3	11	0	0
23	7733269	.	C	G	2	1	3	0	2	5	0	0
23	7733732	.	T	C	3	2	5	0	0	5	0	0
23	7735360	.	T	G	1	0	1	0	3	4	0	0
23	7735464	.	T	C	4	2	6	0	0	6	0	0
23	7735497	.	T	C	3	3	6	0	2	8	0	0
23	7735695	.	C	T	6	3	9	0	0	9	0	0
23	7736257	.	G	A	5	1	6	0	3	9	0	0
23	7743748	.	G	T	3	4	7	0	1	8	0	0
23	7743871	.	C	T	2	8	10	0	3	13	0	0
23	7755165	.	G	A	1	3	4	0	0	4	0	0
23	7765955	.	G	A	0	1	1	0	0	1	0	0
23	7771378	.	A	T	1	3	4	0	1	5	0	0
23	7771440	.	G	A	1	3	4	0	0	4	0	0
23	7792567	.	A	G	1	0	1	0	0	1	0	0
23	8284903	.	C	T	12	4	16	0	1	17	0	0
23	8284991	.	G	T	11	4	15	0	0	15	0	0
23	8285220	.	G	A	10	6	16	0	2	18	0	0
23	8285236	.	G	T	11	8	19	0	1	20	0	0
23	8285332	.	C	T	19	11	30	0	3	33	0	0
23	8285365	.	G	A	15	18	33	0	1	34	0	0
23	8286261	.	C	T	0	7	7	0	5	12	0	0
23	8286333	.	G	T	2	2	4	0	2	6	0	0
23	8373535	.	T	G	2	4	6	0	0	6	0	0
23	9014843	.	T	G	1	3	4	0	1	5	0	0
23	9131467	.	C	T	1	1	2	0	0	2	0	0
23	9268466	.	T	C	3	2	5	0	0	5	0	0
23	9272984	.	T	C	3	3	6	0	0	6	0	0
23	9538742	.	A	G	1	0	1	0	1	2	0	0
23	9542588	.	T	C	0	2	2	0	1	3	0	0
23	9549493	.	A	G	1	2	3	0	0	3	0	0
23	9561099	.	C	A	3	4	7	0	0	7	0	0
23	9561695	.	G	A	6	4	10	0	0	10	0	0
23	9564268	.	T	C	2	2	4	0	0	4	0	0
23	9564283	.	C	A	1	1	2	0	0	2	0	0
23	9565948	.	T	C	17	12	29	0	3	32	0	0
23	9566370	.	T	C	0	1	1	0	0	1	0	0
23	9566375	.	G	A	0	2	2	0	2	4	0	0
23	9567122	.	C	T	8	11	19	0	0	19	0	0
23	9567532	.	T	C	1	2	3	0	0	3	0	0
23	9567698	.	C	T	0	3	3	0	4	7	0	0
23	9567729	.	G	A	4	4	8	0	0	8	0	0
23	9584289	.	C	T	0	0	0	0	1	1	0	0
23	9794733	.	T	C	8	3	11	0	0	11	0	0
23	9794868	.	T	G	17	18	35	0	2	37	0	0
23	9794959	.	T	A	17	16	33	0	1	34	0	0
23	9795057	.	A	G	24	15	39	0	2	42	1	0
23	9795434	.	C	T	0	17	17	0	12	29	0	0
23	9795663	.	A	C	8	11	19	0	0	19	0	0
23	9800761	.	T	G	6	3	9	0	0	9	0	0
23	9805838	.	A	G	1	1	2	0	0	2	0	0
23	9809863	.	A	G	15	15	30	0	2	32	0	0
23	9818057	.	A	G	12	15	27	0	0	27	0	0
23	9823221	.	T	C	6	2	8	0	1	9	0	0
23	9828762	.	G	A	1	7	8	0	1	9	0	0
23	9828765	.	C	G	0	7	7	0	2	9	0	0
23	9828925	.	G	A	3	7	10	0	0	10	0	0
23	9836778	.	G	A	2	6	8	0	2	10	0	0
23	9843221	.	T	C	2	1	3	0	0	3	0	0
23	9914751	.	A	G	0	1	1	0	0	1	0	0
23	9914756	.	G	A	0	1	1	0	0	1	0	0
23	9938349	.	T	C	2	6	8	0	0	8	0	0
23	9938497	.	G	A	6	2	8	0	0	8	0	0
23	9938714	.	G	T	3	11	14	0	1	15	0	0
23	9938765	.	A	G	1	6	7	0	0	7	0	0
23	9938812	.	A	T	3	4	7	0	0	7	0	0
23	9938869	.	C	T	4	3	7	0	2	9	0	0
23	9938905	.	T	C	3	0	3	0	6	9	0	0
23	9939602	.	T	C	5	6	11	0	0	11	0	0
23	9939817	.	A	G	3	2	5	0	1	6	0	0
23	9952460	.	C	T	0	2	2	0	0	2	0	0
23	10174961	.	A	G	7	1	8	0	2	10	0	0
23	10250357	.	G	A	7	9	16	0	0	16	0	0
23	10251076	.	A	G	3	3	6	0	0	6	0	0
23	10251750	.	T	C	1	3	4	0	1	5	0	0
23	10252499	.	A	G	4	2	6	0	2	8	0	0
23	10252526	.	G	A	5	3	8	0	2	10	0	0
23	10252625	.	T	A	1	1	2	0	0	2	0	0
23	10348049	.	T	C	3	2	5	0	0	5	0	0
23	10351405	.	T	A	11	7	18	0	0	18	0	0
23	10405703	.	G	A	3	7	10	0	0	10	0	0
23	10417484	.	T	G	2	1	3	0	0	3	0	0
23	10417502	.	C	T	1	0	1	0	0	1	0	0
23	10423909	.	C	G	1	0	1	0	0	1	0	0
23	10423948	.	C	T	3	8	11	0	0	11	0	0
23	10426291	.	C	T	4	5	9	0	0	9	0	0
23	10448606	.	G	T	0	4	4	0	10	14	0	0
23	10448642	.	G	A	7	17	24	0	3	27	0	0
23	10449405	.	A	T	5	3	8	0	1	9	0	0
23	10449755	.	A	G	1	3	4	0	0	4	0	0
23	10638386	.	A	G	2	2	4	0	0	4	0	0
23	10638774	.	A	T	0	2	2	0	0	2	0	0
23	10638775	.	T	A	0	2	2	0	0	2	0	0
23	10642720	.	T	C	1	5	6	0	0	6	0	0
23	10642729	.	A	G	1	5	6	0	0	6	0	0
23	10644873	.	G	C	0	1	1	0	0	1	0	0
23	10644879	.	T	C	0	1	1	0	0	1	0	0
23	10645201	.	G	A	1	1	2	0	1	3	0	0
23	10724336	.	A	G	10	13	23	0	2	25	0	0
23	10725491	.	T	G	9	7	16	0	1	17	0	0
23	10725753	.	A	C	6	5	11	0	1	12	0	0
23	10745139	.	T	G	4	3	7	0	0	7	0	0
23	10762922	.	G	A	7	16	23	0	1	24	0	0
23	10763070	.	G	A	9	8	17	0	0	17	0	0
23	10763182	.	G	C	9	5	14	0	1	15	0	0
23	10763301	.	T	C	4	12	16	0	2	18	0	0
23	10763303	.	T	C	5	12	17	0	1	18	0	0
23	10771991	.	C	A	0	7	7	0	16	23	0	0
23	10817176	.	C	G	2	2	4	0	0	4	0	0
23	10817292	.	T	G	2	2	4	0	0	4	0	0
23	10825569	.	A	G	2	0	2	0	5	7	0	0
23	10825591	.	C	T	2	5	7	0	2	9	0	0
23	10825996	.	G	A	3	5	8	0	0	8	0	0
23	10826120	.	C	T	5	7	12	0	1	13	0	0
23	10826194	.	C	A	11	4	15	0	0	15	0	0
23	10826618	.	T	C	8	8	16	0	0	16	0	0
23	10826856	.	A	T	5	7	12	0	0	12	0	0
23	10828929	.	T	C	1	2	3	0	0	3	0	0
23	11861321	.	T	C	1	1	2	0	1	3	0	0
23	11861367	.	C	T	2	3	5	0	0	5	0	0
23	11861378	.	G	C	3	3	6	0	0	6	0	0
23	11864948	.	T	C	27	13	40	0	4	44	0	0
23	11865055	.	T	A	6	9	15	0	4	19	0	0
23	11865274	.	A	C	8	6	14	0	0	14	0	0
23	11865510	.	T	C	19	16	35	0	3	38	0	0
23	11865545	.	A	G	23	10	33	0	1	34	0	0
23	11866086	.	G	A	14	19	33	0	1	34	0	0
23	11866259	.	T	C	18	22	40	0	1	41	0	0
23	11871807	.	G	A	10	10	20	0	1	21	0	0
23	11878173	.	A	G	2	3	5	0	0	5	0	0
23	12014796	.	C	T	7	3	10	0	0	10	0	0
23	12150658	.	G	A	1	7	8	0	0	8	0	0
23	12155166	.	G	A	4	2	6	0	0	6	0	0
23	12155391	.	G	A	3	2	5	0	0	5	0	0
23	12161851	.	T	A	3	3	6	0	0	6	0	0
23	12232873	.	G	A	6	5	11	0	0	11	0	0
23	12233117	.	G	A	7	19	26	0	1	27	0	0
23	12260903	.	T	C	1	0	1	0	0	1	0	0
23	12278655	.	A	C	1	0	1	0	1	2	0	0
23	12487331	.	C	T	1	4	5	0	0	5	0	0
23	12612350	.	A	G	2	4	6	0	0	6	0	0
23	13567257	.	G	T	0	1	1	0	0	1	0	0
23	13589383	.	A	G	1	1	2	0	0	2	0	0
23	13598632	.	T	C	5	12	17	0	0	17	0	0
23	13598679	.	C	T	6	10	16	0	0	16	0	0
23	13598766	.	A	C	7	17	24	0	1	25	0	0
23	13599079	.	G	A	0	2	2	0	4	6	0	0
23	13806444	.	T	C	9	17	26	0	1	27	0	0
23	13833376	.	T	A	3	2	5	0	0	5	0	0
23	13839846	.	A	G	5	2	7	0	0	7	0	0
23	13840362	.	C	T	0	6	6	0	5	11	0	0
23	13845114	.	A	C	5	8	13	0	1	14	0	0
23	13845149	.	T	G	9	11	20	0	0	20	0	0
23	13845201	.	A	G	5	8	13	0	0	13	0	0
23	13845220	.	C	T	4	2	6	0	2	8	0	0
23	13845247	.	G	T	1	3	4	0	0	4	0	0
23	13845411	.	G	T	6	8	14	0	0	14	0	0
23	13845447	.	T	C	13	8	21	0	1	22	0	0
23	13845544	.	C	T	9	11	20	0	0	20	0	0
23	13845558	.	C	T	0	11	11	0	5	16	0	0
23	13845764	.	A	G	2	3	5	0	1	6	0	0
23	13846207	.	A	T	6	5	11	0	0	11	0	0
23	13846482	.	G	T	2	4	6	0	0	6	0	0
23	13846854	.	C	T	1	2	3	0	0	3	0	0
23	13846885	.	A	G	2	2	4	0	0	4	0	0
23	13846917	.	T	G	4	3	7	1	0	8	0	0
23	13847220	.	T	C	3	4	7	0	0	7	0	0
23	13848537	.	G	A	0	1	1	0	0	1	0	0
23	13850343	.	A	G	1	3	4	0	0	4	0	0
23	13941275	.	C	T	5	6	11	0	2	13	0	0
23	13944394	.	A	G	1	0	1	0	0	1	0	0
23	13948990	.	A	G	2	5	7	0	1	8	0	0
23	13948993	.	G	A	2	6	8	0	0	8	0	0
23	13949074	.	T	C	2	6	8	0	2	10	0	0
23	13949089	.	T	C	3	3	6	0	1	7	0	0
23	13949110	.	C	T	0	4	4	0	4	8	0	0
23	13963821	.	A	T	1	1	2	0	0	2	0	0
23	14193559	.	A	C	1	1	2	0	1	3	0	0
23	14193640	.	T	C	4	2	6	0	2	8	0	0
23	14193649	.	G	T	2	5	7	0	2	9	0	0
23	14193777	.	C	T	12	8	20	0	2	22	0	0
23	14193851	.	A	G	18	11	29	0	1	30	0	0
23	14194101	.	T	A	17	14	31	0	1	32	0	0
23	14194125	.	A	G	18	10	28	0	2	30	0	0
23	14198137	.	G	A	6	3	9	0	1	10	0	0
23	14201512	.	T	C	3	4	7	0	2	9	0	0
23	14201521	.	T	C	3	6	9	0	1	10	0	0
23	14203829	.	T	G	5	6	11	0	3	14	0	0
23	14208718	.	A	G	2	1	3	0	0	3	0	0
23	14208817	.	A	T	0	4	4	0	1	5	0	0
23	14209024	.	T	G	2	1	3	0	2	5	0	0
23	14211707	.	C	T	4	6	10	0	0	10	0	0
23	14217769	.	G	A	0	3	3	0	1	4	0	0
23	14218018	.	A	G	4	2	6	0	0	6	0	0
23	14265152	.	A	G	4	1	5	0	1	6	0	0
23	14265182	.	C	T	8	2	10	0	0	10	0	0
23	14265220	.	A	T	7	3	10	0	0	10	0	0
23	14320390	.	T	C	3	3	6	0	0	6	0	0
23	14784285	.	G	A	0	1	1	0	0	1	0	0
23	14786347	.	T	C	1	2	3	0	1	4	0	0
23	14787372	.	T	C	2	3	5	0	0	5	0	0
23	14787378	.	A	G	2	0	2	0	3	5	0	0
23	14787409	.	G	A	0	2	2	0	2	4	0	0
23	14790659	.	T	C	0	1	1	0	0	1	0	0
23	14790795	.	A	G	0	1	1	0	0	1	0	0
23	14790827	.	G	A	0	1	1	0	1	2	0	0
23	14799653	.	T	C	0	3	3	0	0	3	0	0
23	14808335	.	C	T	2	3	5	0	2	7	0	0
23	14808399	.	G	A	2	6	8	0	1	9	0	0
23	14808537	.	G	T	5	4	9	0	0	9	0	0
23	14809613	.	C	A	3	5	8	0	0	8	0	0
23	14819874	.	G	A	1	1	2	0	0	2	0	0
23	14832585	.	T	G	6	12	18	0	4	22	0	0
23	14832733	.	G	A	16	24	40	0	13	53	0	0
23	14832740	.	A	C	24	23	47	0	7	55	1	0
23	14832866	.	C	T	22	28	50	0	7	57	0	0
23	14832941	.	C	A	1	33	34	0	22	56	0	0
23	14833142	.	A	T	21	28	49	0	2	51	0	0
23	14833143	.	A	T	22	22	44	0	7	51	0	0
23	14833389	.	A	C	23	20	43	0	1	44	0	0
23	14990819	.	G	T	5	5	10	0	2	12	0	0
23	14993089	.	G	A	20	5	25	0	0	25	0	0
23	14993302	.	A	C	13	9	22	0	3	25	0	0
23	14993393	.	C	A	8	8	16	0	1	17	0	0
23	14993421	.	G	A	6	6	12	0	1	13	0	0
23	14993438	.	A	G	7	4	11	0	0	11	0	0
23	14993493	.	A	T	9	13	22	0	0	22	0	0
23	14993525	.	A	T	10	11	21	0	0	21	0	0
23	14993563	.	C	G	15	7	22	0	1	23	0	0
23	14997341	.	A	G	8	7	15	0	3	18	0	0
23	14999053	.	C	T	6	6	12	0	2	14	0	0
23	14999095	.	C	T	0	11	11	0	12	23	0	0
23	15036698	.	G	A	2	0	2	0	0	2	0	0
23	15204028	.	C	T	20	8	28	0	1	29	0	0
23	15204038	.	T	G	20	4	24	0	1	25	0	0
23	15204222	.	C	T	0	13	13	0	26	39	0	0
23	15204321	.	T	A	8	18	26	0	3	29	0	0
23	15204324	.	T	A	8	21	29	0	2	31	0	0
23	15204417	.	A	G	11	6	17	0	1	18	0	0
23	15204926	.	C	A	5	12	17	0	2	19	0	0
23	15205100	.	T	G	20	10	30	0	8	38	0	0
23	15205428	.	A	T	12	18	30	0	3	33	0	0
23	15205487	.	C	G	16	10	26	0	2	28	0	0
23	15211253	.	G	C	6	13	19	0	2	21	0	0
23	15215709	.	G	A	9	11	20	0	0	20	0	0
23	15216664	.	G	T	2	3	5	0	1	6	0	0
23	15222509	.	G	A	1	2	3	0	0	3	0	0
23	15222521	.	C	T	1	3	4	0	0	4	0	0
23	15284602	.	G	T	2	1	3	0	0	3	0	0
23	15851064	.	A	G	12	18	30	0	0	30	0	0
23	15851506	.	C	G	17	8	25	0	1	26	0	0
23	15854004	.	T	C	16	15	31	0	2	33	0	0
23	15854102	.	A	C	8	4	12	0	1	13	0	0
23	15861092	.	C	T	0	6	6	0	7	13	0	0
23	15861536	.	T	C	3	1	4	0	0	4	0	0
23	15872605	.	T	A	1	0	1	0	0	1	0	0
23	15900255	.	C	T	8	7	15	0	1	16	0	0
23	15900330	.	G	A	18	13	31	0	0	31	0	0
23	15900387	.	G	A	11	13	24	0	0	24	0	0
23	15916232	.	A	T	9	7	16	0	0	16	0	0
23	16640860	.	A	G	1	5	6	0	1	7	0	0
23	16641012	.	A	G	3	0	3	0	2	5	0	0
23	16641017	.	A	G	3	2	5	0	0	5	0	0
23	16648643	.	A	G	4	2	6	0	1	7	0	0
23	16660094	.	G	T	2	1	3	0	0	3	0	0
23	16696509	.	A	G	2	2	4	0	0	4	0	0
23	16748903	.	A	T	3	1	4	0	1	5	0	0
23	16748915	.	T	A	3	2	5	0	0	5	0	0
23	16753735	.	T	C	1	2	3	0	0	3	0	0
23	16757414	.	T	G	2	0	2	0	0	2	0	0
23	16769255	.	T	C	2	2	4	0	0	4	0	0
23	16769385	.	T	A	1	3	4	1	0	5	0	0
23	16769700	.	A	G	1	3	4	0	0	4	0	0
23	16769949	.	T	C	2	9	11	0	1	12	0	0
23	16769991	.	T	G	4	0	4	0	12	16	0	0
23	16770008	.	G	A	0	6	6	0	5	11	0	0
23	16770091	.	A	G	2	0	2	4	6	12	0	0
23	16770340	.	G	C	2	4	6	1	2	9	0	0
23	16810343	.	A	G	1	1	2	0	1	3	0	0
23	16821940	.	T	C	2	5	7	0	0	7	0	0
23	16831386	.	G	A	1	2	3	0	0	3	0	0
23	16831822	.	G	A	0	3	3	0	4	7	0	0
23	16849383	.	A	G	4	4	8	1	1	10	0	0
23	16953147	.	G	A	3	2	5	0	0	5	0	0
23	16964140	.	G	A	1	2	3	0	0	3	0	0
23	17012024	.	T	C	1	0	1	0	2	3	0	0
23	17012033	.	T	C	1	0	1	0	2	3	0	0
23	17113842	.	A	G	2	1	3	0	0	3	0	0
23	17355498	.	G	T	1	2	3	0	0	3	0	0
23	17447240	.	A	G	0	10	10	0	0	10	0	0
23	17450650	.	G	T	10	2	12	0	0	12	0	0
23	17450660	.	T	A	2	8	10	0	1	11	0	0
23	17473187	.	C	T	14	22	36	0	0	36	0	0
23	17473278	.	C	G	12	12	24	0	1	25	0	0
23	17473309	.	G	A	11	14	25	0	4	29	0	0
23	17473649	.	T	A	9	6	15	0	0	15	0	0
23	17473779	.	G	A	18	30	48	0	2	50	0	0
23	17473857	.	A	G	19	23	42	0	1	43	0	0
23	17473981	.	G	A	18	7	25	0	4	29	0	0
23	17474206	.	A	T	5	7	12	0	0	12	0	0
23	17474577	.	A	T	11	7	18	0	0	18	0	0
23	17474592	.	G	A	13	7	20	0	1	21	0	0
23	17474801	.	T	G	10	12	22	0	1	23	0	0
23	17476145	.	T	A	4	2	6	1	0	7	0	0
23	17477252	.	C	T	4	6	10	0	0	10	0	0
23	17477384	.	A	C	7	8	15	0	3	18	0	0
23	17484395	.	C	T	1	7	8	0	0	8	0	0
23	17509537	.	A	G	4	2	6	0	0	6	0	0
23	17516889	.	C	T	6	12	18	0	3	21	0	0
23	17516897	.	C	T	8	10	18	0	0	18	0	0
23	17516945	.	G	A	1	1	2	0	0	2	0	0
23	17520086	.	A	T	20	9	29	0	1	30	0	0
23	17520870	.	T	C	6	6	12	0	1	13	0	0
23	17656044	.	A	G	10	5	15	0	0	15	0	0
23	17656477	.	G	A	14	13	27	0	0	27	0	0
23	17656654	.	G	A	5	5	10	0	0	10	0	0
23	17657130	.	T	G	1	3	4	0	1	5	0	0
23	17657325	.	A	G	7	3	10	0	1	11	0	0
23	17812711	.	C	T	10	19	29	0	3	32	0	0
23	17812720	.	T	A	22	12	34	0	1	35	0	0
23	17812755	.	G	T	17	10	27	0	5	32	0	0
23	17813057	.	G	A	18	11	29	0	4	33	0	0
23	17813717	.	G	A	25	21	46	0	0	46	0	0
23	17813924	.	A	G	10	3	13	0	0	13	0	0
23	17813952	.	G	T	14	8	22	0	1	23	0	0
23	17814056	.	G	A	20	21	41	0	2	43	0	0
23	17814223	.	C	T	7	27	34	0	11	45	0	0
23	17814281	.	G	T	28	22	50	0	0	50	0	0
23	17814299	.	A	C	30	20	50	0	1	51	0	0
23	17814408	.	A	C	16	18	34	0	2	36	0	0
23	17846597	.	G	C	0	1	1	0	0	1	0	0
23	17849044	.	T	A	3	3	6	0	0	6	0	0
23	17849275	.	T	G	9	5	14	0	1	15	0	0
23	17849296	.	C	G	1	5	6	0	10	17	1	0
23	17849627	.	C	T	9	7	16	0	0	16	0	0
23	17851768	.	C	T	0	5	5	0	5	10	0	0
23	17853145	.	T	G	1	1	2	0	0	2	0	0
23	17855427	.	C	A	3	1	4	0	2	6	0	0
23	17872320	.	C	A	2	2	4	0	0	4	0	0
23	17872338	.	C	T	2	1	3	0	1	4	0	0
23	17873750	.	C	A	29	23	52	0	2	54	0	0
23	17879152	.	A	T	2	2	4	0	0	4	0	0
23	17879153	.	A	C	1	2	3	0	1	4	0	0
23	17880800	.	C	T	3	6	9	0	1	10	0	0
23	17881252	.	T	C	5	5	10	0	0	10	0	0
23	17994274	.	C	G	6	4	10	0	1	11	0	0
23	17994354	.	T	C	2	8	10	0	1	11	0	0
23	17994359	.	C	T	7	3	10	0	0	10	0	0
23	17994897	.	C	T	4	2	6	0	0	6	0	0
23	17995469	.	G	T	6	2	8	0	0	8	0	0
23	17997033	.	A	G	0	1	1	0	0	1	0	0
23	17997043	.	T	C	0	0	0	0	1	1	0	0
23	18032772	.	G	A	5	4	9	0	0	9	0	0
23	18032912	.	A	C	5	5	10	0	0	10	0	0
23	18032924	.	T	A	7	3	10	0	1	11	0	0
23	18118653	.	A	T	2	3	5	0	1	6	0	0
23	18118922	.	G	A	33	15	48	0	2	50	0	0
23	18119166	.	C	T	15	21	36	0	3	39	0	0
23	18119192	.	T	C	13	0	13	0	19	32	0	0
23	18119399	.	A	G	6	11	17	0	3	20	0	0
23	18286781	.	G	A	2	6	8	0	0	8	0	0
23	18286782	.	C	T	2	6	8	0	0	8	0	0
23	18372124	.	A	T	5	1	6	0	0	6	0	0
23	18372135	.	C	T	5	4	9	0	1	10	0	0
23	18387709	.	T	A	24	27	51	0	2	53	0	0
23	18388004	.	G	A	14	17	31	0	0	31	0	0
23	18388166	.	T	A	13	6	19	0	1	20	0	0
23	18388476	.	G	A	9	4	13	0	0	13	0	0
23	18388555	.	A	G	4	18	22	0	1	23	0	0
23	18388620	.	A	C	6	11	17	0	3	20	0	0
23	18388685	.	G	A	6	11	17	0	1	18	0	0
23	18388764	.	G	A	13	4	17	0	0	17	0	0
23	18388858	.	T	G	5	2	7	0	1	8	0	0
23	18388954	.	G	A	2	9	11	0	1	12	0	0
23	18389594	.	G	T	11	11	22	0	0	22	0	0
23	18390402	.	G	A	7	6	13	0	1	14	0	0
23	18390635	.	G	A	6	8	14	0	0	14	0	0
23	18390780	.	C	T	7	11	18	0	0	18	0	0
23	18391490	.	G	A	2	3	5	0	1	6	0	0
23	18405812	.	C	T	1	3	4	0	0	4	0	0
23	18405862	.	A	G	0	1	1	0	0	1	0	0
23	18561051	.	T	C	13	5	18	0	1	19	0	0
23	18561289	.	T	A	19	12	31	0	0	31	0	0
23	18561434	.	C	T	0	15	15	0	16	31	0	0
23	18562299	.	A	T	1	4	5	0	0	5	0	0
23	18562358	.	T	G	3	5	8	0	1	9	0	0
23	18562427	.	C	T	6	5	11	0	1	12	0	0
23	18562484	.	G	A	4	6	10	0	0	10	0	0
23	18562522	.	A	C	0	3	3	0	0	3	0	0
23	18562623	.	C	T	8	8	16	0	2	18	0	0
23	18562911	.	C	A	0	7	7	0	12	19	0	0
23	18563951	.	G	T	6	9	15	0	0	15	0	0
23	18563952	.	T	C	6	0	6	0	9	15	0	0
23	18568144	.	G	A	2	2	4	0	0	4	0	0
23	18568206	.	G	A	2	3	5	0	0	5	0	0
23	18569380	.	T	A	10	9	19	0	0	19	0	0
23	18569399	.	C	A	0	11	11	0	10	21	0	0
23	18569455	.	T	G	5	6	11	0	1	12	0	0
23	18569462	.	T	A	4	5	9	0	1	10	0	0
23	18569543	.	T	C	15	12	27	0	4	31	0	0
23	18569625	.	A	G	21	18	39	0	3	42	0	0
23	18572547	.	T	A	4	3	7	0	0	7	0	0
23	18572605	.	T	A	4	8	12	0	1	13	0	0
23	18572618	.	G	A	8	2	10	0	0	10	0	0
23	18574353	.	G	A	15	14	29	0	1	30	0	0
23	18574720	.	T	C	18	9	27	0	2	29	0	0
23	18574800	.	C	T	0	14	14	0	14	28	0	0
23	18580933	.	C	A	3	1	4	0	0	4	0	0
23	18580939	.	C	A	0	4	4	0	3	7	0	0
23	18581065	.	A	G	1	1	2	0	0	2	0	0
23	18581835	.	G	A	1	1	2	0	1	3	0	0
23	18581933	.	T	G	3	10	13	0	0	13	0	0
23	18588969	.	C	T	6	7	13	0	0	13	0	0
23	18597667	.	G	A	3	7	10	0	2	12	0	0
23	18616880	.	T	A	15	9	24	0	1	25	0	0
23	18616980	.	C	G	8	10	18	0	0	18	0	0
23	18617300	.	G	A	7	11	18	0	0	18	0	0
23	18619766	.	C	T	1	0	1	0	0	1	0	0
23	18622541	.	T	G	7	7	14	0	1	15	0	0
23	18628746	.	C	T	6	6	12	0	0	12	0	0
23	18629024	.	T	C	2	4	6	0	0	6	0	0
23	18651918	.	C	A	3	1	4	0	0	4	0	0
23	18652067	.	T	C	2	2	4	0	0	4	0	0
23	18668440	.	T	C	2	5	7	0	1	8	0	0
23	18703170	.	C	T	2	1	3	0	0	3	0	0
23	18759802	.	C	A	6	9	15	0	1	16	0	0
23	18759827	.	T	C	6	7	13	0	0	13	0	0
23	18759944	.	C	T	1	6	7	0	0	7	0	0
23	18759973	.	T	G	5	2	7	0	0	7	0	0
23	18760004	.	G	C	4	0	4	0	6	10	0	0
23	18760049	.	T	A	5	9	14	0	0	14	0	0
23	18760223	.	T	A	2	4	6	0	0	6	0	0
23	18760519	.	T	A	2	3	5	0	0	5	0	0
23	18762948	.	T	C	3	2	5	0	0	5	0	0
23	18769154	.	T	C	1	1	2	0	0	2	0	0
23	18774122	.	T	C	2	2	4	0	0	4	0	0
23	18795055	.	T	C	5	8	13	0	2	15	0	0
23	18795620	.	A	G	15	22	37	0	1	38	0	0
23	18795721	.	C	T	7	3	10	0	2	12	0	0
23	18801275	.	G	A	6	5	11	0	1	12	0	0
23	18870235	.	A	T	4	2	6	0	0	6	0	0
23	18944543	.	G	A	0	4	4	0	2	6	0	0
23	18947344	.	C	A	15	9	24	0	3	27	0	0
23	18947385	.	G	C	8	14	22	0	2	24	0	0
23	18950968	.	T	C	16	16	32	0	0	32	0	0
23	18950970	.	T	A	16	16	32	0	0	32	0	0
23	18951010	.	G	A	9	13	22	0	8	30	0	0
23	18954023	.	A	G	4	3	7	0	0	7	0	0
23	18954100	.	A	G	2	6	8	0	0	8	0	0
23	18954151	.	G	A	1	4	5	0	2	7	0	0
23	18954759	.	T	G	13	12	25	0	0	25	0	0
23	18979342	.	C	T	12	9	21	0	2	23	0	0
23	18979561	.	G	A	9	12	21	0	0	21	0	0
23	18979756	.	T	C	7	9	16	0	1	17	0	0
23	18982375	.	G	A	3	3	6	0	0	6	0	0
23	18986338	.	G	A	11	10	21	0	0	21	0	0
23	18986344	.	G	A	9	11	20	0	0	20	0	0
23	18990914	.	C	T	0	6	6	0	4	10	0	0
23	18993827	.	C	T	0	1	1	0	3	4	0	0
23	19003263	.	A	G	0	3	3	0	0	3	0	0
23	19005486	.	T	C	0	2	2	0	0	2	0	0
23	19005758	.	C	T	0	1	1	0	0	1	0	0
23	19007389	.	G	T	3	1	4	0	0	4	0	0
23	19118372	.	G	T	2	4	6	0	0	6	0	0
23	19198348	.	A	T	7	5	12	0	1	13	0	0
23	19198588	.	A	T	3	2	5	0	0	5	0	0
23	19200168	.	G	A	8	7	15	0	0	15	0	0
23	19201103	.	C	A	13	14	27	0	0	27	0	0
23	19201148	.	G	T	4	6	10	0	2	12	0	0
23	19203952	.	C	T	1	3	4	0	0	4	0	0
23	19204126	.	C	T	0	2	2	0	0	2	0	0
23	19204130	.	T	C	1	3	4	0	0	4	0	0
23	19204597	.	G	A	2	5	7	0	1	8	0	0
23	19206052	.	C	T	3	4	7	0	1	8	0	0
23	19221073	.	G	T	1	0	1	0	2	3	0	0
23	19221744	.	G	T	1	2	3	0	0	3	0	0
23	19474823	.	G	T	14	13	27	0	0	27	0	0
23	19575044	.	G	A	0	3	3	0	3	6	0	0
23	19575134	.	C	T	8	8	16	0	0	16	0	0
23	19577464	.	G	A	0	9	9	0	8	17	0	0
23	19582481	.	T	C	16	17	33	0	2	35	0	0
23	19582559	.	G	T	11	9	20	0	0	20	0	0
23	19582668	.	T	C	10	11	21	0	1	22	0	0
23	19582678	.	C	T	14	13	27	0	1	28	0	0
23	19583208	.	G	A	1	11	12	0	13	25	0	0
23	19583252	.	C	T	12	11	23	0	1	24	0	0
23	19603630	.	T	C	14	8	22	0	1	23	0	0
23	19603753	.	T	C	28	27	55	0	3	58	0	0
23	19603803	.	T	C	18	27	45	0	1	46	0	0
23	19603880	.	A	T	16	17	33	0	9	42	0	0
23	19603994	.	G	A	18	28	46	0	2	48	0	0
23	19604263	.	A	G	10	0	10	0	26	36	0	0
23	19604351	.	G	T	10	11	21	0	2	23	0	0
23	19670139	.	G	C	3	2	5	0	1	6	0	0
23	19670185	.	A	T	2	2	4	0	2	6	0	0
23	19672720	.	T	C	3	5	8	0	1	9	0	0
23	19673170	.	C	T	17	13	30	0	3	33	0	0
23	19673376	.	C	T	7	14	21	0	1	22	0	0
23	19680158	.	C	G	2	2	4	0	0	4	0	0
23	19680276	.	T	C	1	2	3	0	0	3	0	0
23	19712898	.	G	A	16	22	38	0	5	43	0	0
23	19713291	.	A	G	12	19	31	0	0	31	0	0
23	19713324	.	A	G	24	24	48	0	4	52	0	0
23	19792821	.	T	C	0	1	1	0	0	1	0	0
23	19798174	.	A	G	1	1	2	0	0	2	0	0
23	19804543	.	C	A	0	0	0	0	1	1	0	0
23	19805577	.	A	T	2	3	5	0	0	5	0	0
23	19808022	.	C	T	10	7	17	0	2	19	0	0
23	19808078	.	T	C	8	8	16	0	0	16	0	0
23	19808691	.	G	A	0	12	12	0	14	26	0	0
23	19815467	.	G	A	0	2	2	0	0	2	0	0
23	19816699	.	A	T	1	0	1	0	0	1	0	0
23	19821150	.	C	T	5	4	9	0	1	10	0	0
23	19821277	.	A	C	3	6	9	0	3	12	0	0
23	19835308	.	T	C	39	13	52	0	1	53	0	0
23	19836260	.	C	T	24	29	53	0	1	54	0	0
23	19837080	.	T	C	27	23	50	0	2	52	0	0
23	19837503	.	G	A	17	16	33	0	2	35	0	0
23	19837939	.	A	G	2	14	16	0	1	17	0	0
23	19837974	.	G	A	2	12	14	0	0	14	0	0
23	19838100	.	C	A	9	9	18	0	0	18	0	0
23	19838387	.	A	T	6	9	15	0	1	16	0	0
23	19838388	.	T	A	4	10	14	0	2	16	0	0
23	19838458	.	A	T	4	8	12	0	1	13	0	0
23	19838459	.	A	C	5	8	13	0	0	13	0	0
23	19869132	.	G	A	6	7	13	0	0	13	0	0
23	19871615	.	A	G	12	9	21	0	2	23	0	0
23	19879576	.	C	T	0	3	3	0	2	5	0	0
23	19893409	.	A	T	5	2	7	0	1	8	0	0
23	19933542	.	A	G	3	2	5	0	0	5	0	0
23	19933578	.	G	A	4	3	7	0	0	7	0	0
23	19933742	.	G	A	4	4	8	0	0	8	0	0
23	19933896	.	A	G	1	2	3	0	1	4	0	0
23	19933952	.	A	G	1	6	7	0	0	7	0	0
23	19952743	.	C	T	0	3	3	0	2	5	0	0
23	19952869	.	T	A	2	3	5	0	0	5	0	0
23	19969109	.	A	T	1	2	3	0	0	3	0	0
23	19969710	.	G	A	4	5	9	0	0	9	0	0
23	19974092	.	G	A	3	3	6	0	0	6	0	0
23	19976882	.	G	C	3	2	5	0	1	6	0	0
23	19981554	.	T	C	6	2	8	0	2	10	0	0
23	19981608	.	A	T	5	9	14	0	0	14	0	0
23	19985054	.	A	G	4	2	6	0	1	7	0	0
23	20000716	.	A	G	2	4	6	0	1	7	0	0
23	20002339	.	G	C	1	2	3	0	0	3	0	0
23	20014285	.	A	T	2	6	8	0	0	8	0	0
23	20014528	.	G	A	1	1	2	0	1	3	0	0
23	20113599	.	T	C	17	10	27	0	0	27	0	0
23	20113848	.	G	T	21	15	36	0	2	38	0	0
23	20114327	.	C	A	6	2	8	0	0	8	0	0
23	20117625	.	C	G	0	3	3	0	10	13	0	0
23	20117830	.	A	G	2	0	2	0	0	2	0	0
23	20117938	.	A	C	6	0	6	0	10	16	0	0
23	20118597	.	T	G	1	0	1	0	0	1	0	0
23	20118730	.	T	A	1	2	3	0	1	4	0	0
23	20121265	.	T	A	1	0	1	0	1	2	0	0
23	20121270	.	G	T	2	1	3	0	0	3	0	0
23	20121326	.	G	A	6	7	13	0	0	13	0	0
23	20122190	.	A	G	1	3	4	0	0	4	0	0
23	20123375	.	G	A	1	1	2	0	0	2	0	0
23	20123386	.	G	T	1	1	2	0	0	2	0	0
23	20123575	.	C	A	1	2	3	0	0	3	0	0
23	20123576	.	C	T	1	2	3	0	0	3	0	0
23	20123629	.	A	G	1	1	2	0	0	2	0	0
23	20139248	.	T	C	0	3	3	0	0	3	0	0
23	20139320	.	T	C	0	3	3	0	0	3	0	0
23	20141925	.	C	T	1	2	3	0	0	3	0	0
23	20142886	.	G	A	1	1	2	0	1	3	0	0
23	20145420	.	T	A	8	24	32	0	1	33	0	0
23	20145823	.	T	C	11	13	24	0	0	24	0	0
23	20146080	.	A	G	14	9	23	0	0	23	0	0
23	20152477	.	T	C	6	3	9	0	0	9	0	0
23	20152640	.	G	A	3	3	6	0	1	7	0	0
23	20154486	.	A	G	6	4	10	0	0	10	0	0
23	20157790	.	G	A	2	3	5	0	1	6	0	0
23	20167966	.	G	A	1	2	3	0	1	4	0	0
23	20168127	.	C	T	0	2	2	0	0	2	0	0
23	20168404	.	C	G	1	3	4	0	0	4	0	0
23	20169105	.	C	G	0	0	0	0	1	1	0	0
23	20170945	.	T	A	1	2	3	0	0	3	0	0
23	20525946	.	G	A	6	3	9	0	4	13	0	0
23	20730098	.	A	G	6	2	8	0	1	9	0	0
23	20902390	.	T	A	2	6	8	0	0	8	0	0
23	20931095	.	C	A	5	3	8	0	1	9	0	0
23	20931119	.	C	T	3	3	6	0	3	9	0	0
23	20936226	.	G	A	0	5	5	0	7	12	0	0
23	20936395	.	T	A	5	6	11	0	0	11	0	0
23	20936467	.	T	C	5	4	9	0	0	9	0	0
23	21106219	.	A	T	0	1	1	0	0	1	0	0
23	21113750	.	T	C	1	2	3	0	0	3	0	0
23	21113770	.	C	T	2	2	4	0	0	4	0	0
23	21114732	.	A	C	2	2	4	0	0	4	0	0
23	21269792	.	T	G	4	2	6	0	0	6	0	0
23	21277208	.	G	A	1	3	4	0	0	4	0	0
23	21277247	.	T	A	4	4	8	0	0	8	0	0
23	21338834	.	C	T	0	2	2	0	1	3	0	0
23	21341304	.	G	A	1	2	3	0	0	3	0	0
23	21356056	.	C	T	2	2	4	0	1	5	0	0
23	21361570	.	G	A	3	2	5	0	0	5	0	0
23	21362735	.	G	A	1	1	2	0	0	2	0	0
23	21363039	.	C	A	1	1	2	0	1	3	0	0
23	21364431	.	G	A	3	3	6	0	0	6	0	0
23	21364449	.	G	A	0	6	6	0	5	11	0	0
23	21364632	.	T	C	0	2	2	0	0	2	0	0
23	21364725	.	C	T	0	1	1	0	0	1	0	0
23	21366588	.	C	T	2	1	3	0	0	3	0	0
23	21366743	.	A	C	3	0	3	0	0	3	0	0
23	21367861	.	A	G	2	1	3	0	2	5	0	0
23	21367994	.	A	T	1	1	2	0	0	2	0	0
23	21368078	.	C	T	10	10	20	0	1	21	0	0
23	21368090	.	G	A	13	10	23	0	0	23	0	0
23	21369126	.	G	C	0	1	1	0	5	6	0	0
23	21369678	.	T	C	14	19	33	0	2	35	0	0
23	21369703	.	C	A	14	20	34	0	0	34	0	0
23	21369750	.	C	T	3	5	8	0	1	9	0	0
23	21376413	.	T	A	22	14	36	0	1	37	0	0
23	21376570	.	C	T	21	14	35	0	2	37	0	0
23	21376678	.	G	T	10	12	22	0	2	24	0	0
23	21376689	.	C	T	15	9	24	0	0	24	0	0
23	21376787	.	C	G	6	14	20	0	0	20	0	0
23	21445197	.	A	T	1	2	3	0	0	3	0	0
23	21453059	.	G	A	1	2	3	0	0	3	0	0
23	21453061	.	T	G	1	2	3	0	0	3	0	0
23	21488054	.	T	C	1	5	6	0	1	7	0	0
23	21489121	.	C	T	4	4	8	0	0	8	0	0
23	21489233	.	T	C	4	10	14	0	2	16	0	0
23	21489567	.	T	C	6	6	12	0	0	12	0	0
23	21490211	.	G	A	0	5	5	0	3	8	0	0
23	21497808	.	C	T	2	2	4	0	0	4	0	0
23	21498141	.	T	C	3	1	4	0	0	4	0	0
23	21498165	.	T	C	2	2	4	0	0	4	0	0
23	21498383	.	A	T	1	2	3	0	0	3	0	0
23	21498449	.	T	C	4	7	11	0	0	11	0	0
23	21498478	.	T	C	4	8	12	0	1	13	0	0
23	21618055	.	C	T	0	2	2	0	1	3	0	0
23	21626211	.	C	T	4	2	6	0	1	7	0	0
23	21630363	.	T	G	5	7	12	0	1	13	0	0
23	21630393	.	G	A	4	4	8	0	1	9	0	0
23	21630676	.	G	A	5	8	13	0	0	13	0	0
23	21630973	.	C	T	2	8	10	0	0	10	0	0
23	21661227	.	C	T	6	11	17	0	0	17	0	0
23	21674163	.	G	T	3	2	5	0	0	5	0	0
23	21674167	.	G	T	3	3	6	0	0	6	0	0
23	21721568	.	T	C	5	2	7	0	0	7	0	0
23	21721667	.	C	T	2	3	5	0	0	5	0	0
23	21721868	.	G	A	3	3	6	0	0	6	0	0
23	21741133	.	C	T	1	1	2	0	0	2	0	0
23	21744988	.	A	G	0	2	2	0	0	2	0	0
23	21803801	.	T	C	2	3	5	0	0	5	0	0
23	22034461	.	C	T	4	4	8	0	0	8	0	0
23	22034473	.	G	A	0	4	4	0	4	8	0	0
23	22054542	.	C	A	5	2	7	0	0	7	0	0
23	22064493	.	A	G	5	3	8	0	0	8	0	0
23	22067865	.	G	T	3	2	5	0	0	5	0	0
23	22071424	.	A	T	1	0	1	0	0	1	0	0
23	22084512	.	T	G	2	3	5	0	0	5	0	0
23	22394219	.	G	A	0	1	1	0	0	1	0	0
23	22424506	.	T	A	0	1	1	0	0	1	0	0
23	22424524	.	C	T	2	0	2	0	0	2	0	0
23	22424562	.	A	G	0	2	2	0	0	2	0	0
23	22424574	.	G	A	0	2	2	0	1	3	0	0
23	22424764	.	C	T	4	3	7	0	2	9	0	0
23	22496525	.	C	A	6	8	14	0	0	16	2	0
23	22496589	.	A	G	6	9	15	0	1	16	0	0
23	22496785	.	A	G	6	4	10	0	0	10	0	0
23	22497049	.	A	T	6	11	17	0	0	17	0	0
23	22497550	.	A	G	11	5	16	0	1	17	0	0
23	22591168	.	C	T	1	3	4	0	0	4	0	0
23	22591304	.	C	A	1	3	4	0	1	5	0	0
23	22591327	.	T	C	1	4	5	0	2	7	0	0
23	22635036	.	T	A	2	2	4	0	4	8	0	0
23	22635284	.	G	A	9	5	14	0	0	14	0	0
23	22635490	.	C	G	1	4	5	0	1	6	0	0
23	22667247	.	C	T	17	17	34	0	2	36	0	0
23	22674704	.	C	T	3	5	8	0	0	8	0	0
23	22677394	.	A	C	8	13	21	0	3	24	0	0
23	22677496	.	C	T	45	30	75	0	4	79	0	0
23	22677638	.	C	T	38	27	65	0	5	70	0	0
23	22920431	.	A	C	0	0	0	0	7	7	0	0
23	22920524	.	A	C	1	0	1	0	17	18	0	0
23	22922775	.	A	C	4	8	12	0	2	14	0	0
23	22922795	.	G	T	3	9	12	0	0	12	0	0
23	22923021	.	A	C	8	12	20	0	4	24	0	0
23	22923033	.	C	T	9	11	20	0	2	22	0	0
23	22923198	.	C	T	6	7	13	0	0	13	0	0
23	22923339	.	C	T	16	7	23	0	2	25	0	0
23	22923537	.	C	T	4	7	11	0	0	11	0	0
23	22923603	.	T	C	9	3	12	0	0	12	0	0
23	22925490	.	C	A	1	1	2	0	0	2	0	0
23	23122381	.	C	T	6	8	14	0	1	15	0	0
23	23122955	.	G	T	4	3	7	0	0	7	0	0
23	23123146	.	G	T	3	5	8	0	0	8	0	0
23	23126589	.	A	C	4	6	10	0	0	10	0	0
23	23126621	.	T	C	4	6	10	0	0	10	0	0
23	23136745	.	G	A	0	1	1	0	0	1	0	0
23	23192478	.	G	A	5	1	6	0	0	6	0	0
23	23192514	.	A	T	0	2	2	0	1	3	0	0
23	23194228	.	C	T	2	1	3	0	0	3	0	0
23	23205469	.	A	G	6	0	6	0	11	17	0	0
23	23205511	.	T	C	4	6	10	0	0	10	0	0
23	23210288	.	A	G	12	5	17	0	2	19	0	0
23	23210303	.	A	G	14	8	22	0	0	22	0	0
23	23210339	.	C	T	8	9	17	0	1	18	0	0
23	23212257	.	C	T	2	2	4	0	0	4	0	0
23	23212567	.	C	T	13	12	25	0	2	27	0	0
23	23213219	.	T	C	18	18	36	0	0	36	0	0
23	23213437	.	G	A	0	13	13	0	12	25	0	0
23	23213582	.	C	A	20	11	31	0	0	31	0	0
23	23213613	.	T	A	15	17	32	0	0	32	0	0
23	23213657	.	G	A	24	13	37	0	3	40	0	0
23	23213757	.	G	A	25	17	42	0	1	43	0	0
23	23213800	.	G	A	1	13	14	0	14	28	0	0
23	23213917	.	T	A	18	11	29	0	6	35	0	0
23	23213939	.	T	A	18	17	35	0	0	35	0	0
23	23214070	.	C	T	10	7	17	0	1	18	0	0
23	23214417	.	C	T	15	6	21	0	2	23	0	0
23	23399987	.	T	C	5	5	10	0	0	10	0	0
23	23830985	.	C	G	0	1	1	0	0	1	0	0
23	23860113	.	T	A	1	5	6	0	0	6	0	0
23	23860117	.	G	A	1	5	6	0	0	6	0	0
23	23888136	.	G	A	0	10	10	0	9	19	0	0
23	23891551	.	G	A	0	2	2	0	4	6	0	0
23	23903278	.	G	A	1	11	12	0	6	18	0	0
23	23903432	.	C	T	3	3	6	0	2	8	0	0
23	23912720	.	G	T	13	14	27	0	1	28	0	0
23	23912723	.	C	A	13	15	28	0	0	28	0	0
23	23912900	.	C	G	11	13	24	0	1	25	0	0
23	23913240	.	G	T	16	17	33	0	0	33	0	0
23	23913818	.	A	T	17	21	38	0	1	39	0	0
23	23913858	.	A	C	18	21	39	0	4	43	0	0
23	23914017	.	G	A	1	21	22	0	22	44	0	0
23	23914176	.	A	T	16	19	35	0	1	36	0	0
23	23973724	.	T	A	1	2	3	0	0	3	0	0
23	23987646	.	A	G	0	1	1	0	0	1	0	0
23	23994537	.	T	C	1	0	1	0	0	1	0	0
23	23994595	.	C	T	2	3	5	0	1	6	0	0
23	24113184	.	C	T	1	2	3	0	0	3	0	0
23	24113193	.	G	A	2	2	4	0	0	4	0	0
23	24170870	.	G	A	14	12	26	0	1	27	0	0
23	24188087	.	C	T	0	0	0	0	1	1	0	0
23	24195469	.	C	T	1	3	4	0	1	5	0	0
23	24202602	.	C	T	3	2	5	0	0	5	0	0
23	24202760	.	C	T	2	4	6	0	0	6	0	0
23	24202858	.	C	T	2	5	7	0	0	7	0	0
23	24202985	.	T	C	3	2	5	0	0	5	0	0
23	24208176	.	G	A	2	5	7	0	0	7	0	0
23	24227352	.	A	T	11	3	14	0	1	15	0	0
23	24227380	.	A	G	12	11	23	0	0	23	0	0
23	24227458	.	T	C	6	19	25	0	0	25	0	0
23	24227673	.	C	A	25	16	41	0	3	45	1	0
23	24228767	.	G	A	15	7	22	0	0	22	0	0
23	24229110	.	G	A	11	6	17	0	0	17	0	0
23	24231222	.	A	G	2	6	8	0	0	8	0	0
23	24233458	.	A	G	1	4	5	0	0	5	0	0
23	24233831	.	A	G	2	1	3	0	0	3	0	0
23	24238551	.	G	A	1	2	3	0	0	3	0	0
23	24240979	.	G	T	12	5	17	0	2	19	0	0
23	24243168	.	G	A	1	0	1	0	0	1	0	0
23	24244694	.	C	T	0	2	2	0	1	3	0	0
23	24301213	.	G	A	0	2	2	0	1	3	0	0
23	24301297	.	C	T	1	1	2	0	0	2	0	0
23	24439480	.	G	T	11	11	22	0	2	24	0	0
23	24439780	.	G	A	13	18	31	0	0	31	0	0
23	24440397	.	C	T	5	10	15	0	7	22	0	0
23	24442787	.	T	G	0	1	1	0	1	2	0	0
23	24443161	.	G	T	10	6	16	0	2	18	0	0
23	24443576	.	A	G	11	8	19	0	0	19	0	0
23	24443609	.	C	T	0	9	9	0	7	16	0	0
23	24444291	.	A	G	7	13	20	0	1	21	0	0
23	24444344	.	C	G	5	12	17	0	0	17	0	0
23	24444543	.	C	T	0	10	10	0	6	16	0	0
23	24444803	.	T	G	6	8	14	0	0	14	0	0
23	24444861	.	G	A	8	5	13	0	1	14	0	0
23	24445112	.	G	T	7	4	11	0	3	14	0	0
23	24445338	.	A	G	7	7	14	0	0	14	0	0
23	24445584	.	A	G	5	8	13	0	0	13	0	0
23	24445876	.	A	G	4	5	9	0	1	10	0	0
23	24445906	.	G	C	6	6	12	0	0	12	0	0
23	24446411	.	C	T	2	5	7	0	2	9	0	0
23	24447113	.	C	T	6	2	8	0	1	9	0	0
23	24447297	.	C	T	1	2	3	0	0	3	0	0
23	24447794	.	G	A	1	3	4	0	0	4	0	0
23	24448273	.	G	C	2	2	4	0	0	4	0	0
23	24448621	.	G	C	1	3	4	0	0	4	0	0
23	24448630	.	G	T	1	3	4	0	0	4	0	0
23	24451083	.	A	G	3	1	4	0	2	6	0	0
23	24528226	.	C	G	1	1	2	0	0	2	0	0
23	24593017	.	G	A	0	2	2	0	1	3	0	0
23	24600513	.	C	T	2	2	4	0	0	4	0	0
23	24600947	.	T	C	5	6	11	0	0	11	0	0
23	24604042	.	C	T	8	5	13	0	2	15	0	0
23	24604323	.	C	T	0	1	1	0	0	1	0	0
23	24604461	.	A	G	0	0	0	0	5	5	0	0
23	24608805	.	G	A	6	4	10	0	0	10	0	0
23	24608847	.	G	A	0	14	14	0	10	24	0	0
23	24653058	.	C	T	1	3	4	0	0	4	0	0
23	24654287	.	G	T	2	2	4	0	0	4	0	0
23	24655761	.	T	G	3	0	3	0	6	9	0	0
23	24661851	.	C	T	1	3	4	0	0	4	0	0
23	24669381	.	C	T	0	10	10	0	9	19	0	0
23	24669442	.	T	C	2	0	2	0	12	14	0	0
23	24672365	.	C	T	3	4	7	0	4	11	0	0
23	24676192	.	G	C	4	3	7	0	0	7	0	0
23	24694242	.	C	A	21	13	34	0	0	34	0	0
23	24694756	.	C	T	1	1	2	0	0	2	0	0
23	24694763	.	T	A	1	1	2	0	0	2	0	0
23	24697036	.	G	A	8	10	18	0	1	19	0	0
23	24699281	.	T	A	6	9	15	0	0	15	0	0
23	24749673	.	C	T	2	3	5	0	0	5	0	0
23	24750339	.	C	A	0	3	3	0	1	4	0	0
23	24803130	.	C	T	17	10	27	0	3	30	0	0
23	24823899	.	T	C	0	1	1	0	0	1	0	0
23	24932979	.	G	A	3	5	8	0	0	8	0	0
23	24933121	.	C	T	4	3	7	0	1	8	0	0
23	24934567	.	T	C	9	9	18	0	0	18	0	0
23	24934597	.	C	G	6	6	12	0	1	13	0	0
23	24957161	.	G	C	1	2	3	0	0	3	0	0
23	24959374	.	G	C	1	2	3	0	0	3	0	0
23	24959406	.	T	C	1	3	4	0	1	5	0	0
23	24965393	.	C	T	4	4	8	0	0	8	0	0
23	24965396	.	G	A	4	4	8	0	0	8	0	0
23	24965432	.	G	T	5	5	10	0	0	10	0	0
23	24965767	.	C	G	2	2	4	0	1	5	0	0
23	24968676	.	C	A	3	2	5	0	0	5	0	0
23	24970331	.	A	G	1	0	1	0	2	3	0	0
23	24970372	.	G	A	3	5	8	0	1	9	0	0
23	24970589	.	A	G	7	5	12	0	1	13	0	0
23	24970593	.	G	A	7	6	13	0	0	13	0	0
23	24970710	.	G	A	6	2	8	0	0	8	0	0
23	24970732	.	C	T	2	2	4	0	0	4	0	0
23	24980349	.	T	A	0	0	0	0	0	1	1	0
23	24983572	.	C	T	1	0	1	0	1	2	0	0
23	24984969	.	A	C	2	2	4	0	1	5	0	0
23	25756641	.	A	G	1	2	3	0	1	4	0	0
23	25757012	.	G	A	0	1	1	0	0	1	0	0
23	25757378	.	G	A	1	1	2	0	2	4	0	0
23	25768118	.	G	T	1	1	2	0	1	3	0	0
23	25768384	.	C	T	1	2	3	0	0	3	0	0
23	25770804	.	T	A	3	4	7	0	1	8	0	0
23	25772799	.	G	A	1	2	3	0	0	3	0	0
23	25773460	.	G	A	5	3	8	0	0	8	0	0
23	25773469	.	G	A	3	4	7	0	0	7	0	0
23	25776824	.	C	T	2	1	3	0	0	3	0	0
23	25796410	.	T	A	4	6	10	0	2	12	0	0
23	25796670	.	T	G	4	5	9	0	1	10	0	0
23	25797011	.	T	A	3	4	7	0	0	7	0	0
23	25797022	.	T	A	5	3	8	0	1	9	0	0
23	25797216	.	G	A	3	5	8	0	0	8	0	0
23	25869706	.	A	G	2	2	4	0	0	4	0	0
23	25871764	.	C	A	3	4	7	0	0	7	0	0
23	25873444	.	C	A	5	3	8	0	1	9	0	0
23	25873522	.	T	G	2	3	5	0	0	5	0	0
23	25873670	.	A	G	2	2	4	0	0	4	0	0
23	25873967	.	T	A	1	2	3	0	1	4	0	0
23	25873976	.	T	A	3	2	5	0	2	7	0	0
23	25874249	.	A	G	6	0	6	0	14	20	0	0
23	25874261	.	T	A	5	14	19	0	1	20	0	0
23	25874334	.	C	G	6	7	13	0	1	14	0	0
23	25874355	.	A	T	6	8	14	0	1	15	0	0
23	25874459	.	A	T	6	14	20	0	0	20	0	0
23	25874498	.	G	A	5	11	16	0	2	18	0	0
23	25874615	.	G	A	3	3	6	0	0	6	0	0
23	25879786	.	A	G	2	2	4	0	2	6	0	0
23	25879930	.	A	C	2	3	5	0	0	5	0	0
23	25930689	.	C	T	1	2	3	0	1	4	0	0
23	25942399	.	T	G	23	0	23	0	21	44	0	0
23	25942559	.	T	A	3	8	11	0	0	11	0	0
23	25946931	.	A	T	1	1	2	0	0	2	0	0
23	25946941	.	A	T	1	2	3	0	0	3	0	0
23	26063560	.	A	T	23	29	52	0	3	55	0	0
23	26063614	.	A	C	20	29	49	0	3	54	2	0
23	26063734	.	G	A	22	24	46	0	3	49	0	0
23	26063843	.	G	A	28	29	57	0	1	58	0	0
23	26063985	.	A	T	35	16	51	0	7	58	0	0
23	26064050	.	T	A	26	26	52	0	1	53	0	0
23	26064122	.	T	A	9	12	21	0	0	21	0	0
23	26064124	.	T	A	15	6	21	0	0	21	0	0
23	26064266	.	T	A	16	12	28	0	1	29	0	0
23	26064923	.	T	C	27	0	27	0	29	56	0	0
23	26064948	.	T	G	30	24	54	0	0	54	0	0
23	26064989	.	A	G	26	24	50	0	5	55	0	0
23	26065079	.	T	C	26	33	59	0	1	60	0	0
23	26066629	.	C	T	0	1	1	0	0	1	0	0
23	26074123	.	G	A	5	6	11	0	1	12	0	0
23	26074252	.	T	A	0	1	1	0	0	1	0	0
23	26088845	.	A	G	5	2	7	0	0	7	0	0
23	26093597	.	A	G	1	2	3	0	1	4	0	0
23	26093922	.	A	T	6	3	9	0	0	9	0	0
23	26094533	.	A	G	4	9	13	0	1	14	0	0
23	26094589	.	G	C	9	20	29	0	2	31	0	0
23	26094617	.	T	C	9	25	34	0	1	35	0	0
23	26094626	.	T	C	7	0	7	0	29	36	0	0
23	26094694	.	A	C	2	14	16	0	0	16	0	0
23	26094877	.	A	G	3	7	10	0	1	11	0	0
23	26094932	.	G	A	6	2	8	0	1	9	0	0
23	26094938	.	C	A	7	1	8	0	1	9	0	0
23	26095081	.	G	A	7	16	23	0	2	25	0	0
23	26095096	.	C	T	10	17	27	0	1	28	0	0
23	26095153	.	G	A	10	12	22	0	0	22	0	0
23	26095285	.	T	A	11	8	19	0	1	20	0	0
23	26095400	.	C	T	7	19	26	0	1	27	0	0
23	26095416	.	T	G	7	15	22	0	0	22	0	0
23	26110735	.	G	A	10	9	19	0	0	19	0	0
23	26111090	.	C	G	3	0	3	1	0	4	0	0
23	26120198	.	C	A	0	3	3	0	1	4	0	0
23	26227697	.	C	T	0	2	2	0	1	3	0	0
23	26232509	.	C	A	7	4	11	0	3	14	0	0
23	26499228	.	A	G	0	2	2	0	0	2	0	0
23	26499394	.	A	G	1	2	3	0	0	3	0	0
23	26504202	.	A	T	42	10	52	0	4	56	0	0
23	26504254	.	G	A	45	8	53	0	1	54	0	0
23	26504264	.	C	T	47	8	55	0	0	55	0	0
23	26507741	.	G	A	22	29	51	0	4	55	0	0
23	26509764	.	G	A	11	21	32	0	4	36	0	0
23	26517183	.	G	A	9	16	25	0	0	25	0	0
23	26522647	.	A	G	7	4	11	0	0	11	0	0
23	26522892	.	G	A	9	8	17	0	2	19	0	0
23	26763798	.	A	T	3	7	10	0	0	10	0	0
23	26763994	.	C	A	3	3	6	0	1	7	0	0
23	26764230	.	G	T	2	2	4	0	0	4	0	0
23	26764351	.	A	C	1	2	3	0	3	6	0	0
23	26955383	.	C	T	1	1	2	0	0	2	0	0
23	26955401	.	A	G	1	0	1	0	0	1	0	0
23	26979223	.	C	A	8	6	14	0	0	14	0	0
23	27003630	.	T	A	4	13	17	0	0	17	0	0
23	27003720	.	G	A	17	24	41	0	2	43	0	0
23	27003801	.	T	C	15	17	32	0	4	36	0	0
23	27004310	.	C	T	16	7	23	0	4	27	0	0
23	27004339	.	C	T	18	13	31	0	2	33	0	0
23	27004347	.	G	A	18	10	28	0	5	33	0	0
23	27004383	.	C	T	13	16	29	0	3	32	0	0
23	27004397	.	T	C	11	13	24	0	3	27	0	0
23	27004665	.	T	C	17	14	31	0	0	31	0	0
23	27005195	.	G	A	20	19	39	0	4	43	0	0
23	27041461	.	A	T	5	3	8	0	0	8	0	0
23	27041503	.	C	G	2	8	10	0	0	10	0	0
23	27042132	.	A	G	2	6	8	0	1	9	0	0
23	27042533	.	C	T	0	1	1	0	0	1	0	0
23	27044241	.	C	T	2	2	4	0	0	4	0	0
23	27044526	.	A	G	3	3	6	0	0	6	0	0
23	27044946	.	C	G	1	2	3	0	0	3	0	0
23	27044947	.	T	C	1	0	1	0	2	3	0	0
23	27052123	.	C	A	3	13	16	0	0	16	0	0
23	27052125	.	C	T	3	13	16	0	0	16	0	0
23	27054361	.	C	T	4	4	8	0	0	8	0	0
23	27059120	.	G	A	0	20	20	0	15	35	0	0
23	27059376	.	T	A	16	11	27	0	0	27	0	0
23	27059422	.	C	T	11	16	27	0	1	28	0	0
23	27059459	.	A	G	9	0	9	0	22	31	0	0
23	27251789	.	G	C	15	16	31	0	1	32	0	0
23	27251859	.	G	A	20	25	45	0	2	47	0	0
23	27251872	.	C	T	2	23	25	0	19	44	0	0
23	27252425	.	G	A	16	20	36	0	5	41	0	0
23	27252587	.	A	G	14	11	25	0	2	27	0	0
23	27252833	.	A	G	8	10	18	0	2	20	0	0
23	27274110	.	G	A	0	1	1	0	0	1	0	0
23	27279281	.	A	G	2	2	4	0	1	5	0	0
23	27279320	.	A	G	4	2	6	0	0	6	0	0
23	27279476	.	G	A	2	2	4	0	0	4	0	0
23	27358990	.	A	T	9	6	15	0	1	16	0	0
23	27359203	.	A	G	7	12	19	0	0	19	0	0
23	27359410	.	G	A	7	3	10	0	1	11	0	0
23	27359526	.	T	C	11	5	16	0	0	16	0	0
23	27359755	.	C	T	0	8	8	0	4	12	0	0
23	27359825	.	C	A	4	8	12	0	0	12	0	0
23	27359867	.	A	C	10	6	16	0	1	17	0	0
23	27360007	.	G	A	7	6	13	0	0	13	0	0
23	27361210	.	A	T	2	2	4	0	0	4	0	0
23	27361216	.	G	A	3	3	6	0	0	6	0	0
23	27364018	.	C	T	2	6	8	0	0	8	0	0
23	27366669	.	C	T	1	0	1	0	0	1	0	0
23	27497960	.	A	T	7	15	22	0	2	24	0	0
23	27498027	.	A	T	8	12	20	0	0	20	0	0
23	27498040	.	C	G	11	8	19	0	1	20	0	0
23	27498195	.	A	T	16	17	33	0	0	33	0	0
23	27498798	.	C	T	0	14	14	0	17	31	0	0
23	27499096	.	G	A	12	7	19	0	1	20	0	0
23	27499195	.	A	T	5	13	18	0	0	18	0	0
23	27499246	.	G	A	7	9	16	0	1	17	0	0
23	27499306	.	C	T	11	7	18	0	0	18	0	0
23	27501872	.	A	G	4	5	9	0	1	10	0	0
23	27513819	.	G	A	0	1	1	0	0	1	0	0
23	27513952	.	A	G	3	2	5	0	0	5	0	0
23	27515931	.	G	A	3	3	6	0	0	6	0	0
23	27518434	.	G	A	2	7	9	0	1	10	0	0
23	27521815	.	G	A	1	1	2	0	0	2	0	0
23	27576533	.	T	G	2	0	2	0	0	2	0	0
23	27591834	.	C	T	10	4	14	0	0	14	0	0
23	27591859	.	C	T	7	6	13	0	0	13	0	0
23	27591939	.	A	G	3	7	10	0	1	11	0	0
23	27592411	.	A	C	8	6	14	0	1	15	0	0
23	27592615	.	T	C	5	3	8	0	0	8	0	0
23	27592796	.	T	C	4	0	4	0	10	14	0	0
23	27593230	.	C	T	9	9	18	0	0	18	0	0
23	27597141	.	C	A	0	0	0	0	1	1	0	0
23	27597808	.	G	A	4	3	7	0	1	8	0	0
23	27599110	.	A	C	0	2	2	0	0	2	0	0
23	27622036	.	T	A	23	19	42	0	0	42	0	0
23	27622212	.	C	A	11	7	18	0	0	18	0	0
23	27622258	.	T	C	9	10	19	0	0	19	0	0
23	27622324	.	T	C	14	6	20	0	0	20	0	0
23	27629923	.	A	T	0	3	3	0	0	3	0	0
23	27677263	.	G	A	22	22	44	0	2	46	0	0
23	27677278	.	G	A	17	13	30	0	7	37	0	0
23	27683248	.	C	A	0	2	2	0	2	4	0	0
23	27683497	.	C	T	1	5	6	0	0	6	0	0
23	27683629	.	C	T	0	3	3	0	2	5	0	0
23	27787598	.	T	C	1	2	3	0	0	3	0	0
23	27789577	.	T	C	1	2	3	0	0	3	0	0
23	27800681	.	G	T	7	7	14	0	4	18	0	0
23	27800954	.	A	C	9	9	18	0	1	19	0	0
23	27800977	.	C	T	13	10	23	0	1	24	0	0
23	27801101	.	T	C	6	0	6	0	7	13	0	0
23	27801104	.	T	C	7	6	13	0	0	13	0	0
23	27801237	.	T	C	12	9	21	0	0	21	0	0
23	27801268	.	C	A	10	13	23	0	1	24	0	0
23	27801629	.	C	T	9	5	14	0	0	14	0	0
23	27802381	.	T	A	1	2	3	0	0	3	0	0
23	27805414	.	A	G	4	3	7	0	0	7	0	0
23	27807664	.	G	A	1	2	3	0	1	4	0	0
23	27836003	.	C	G	8	2	10	0	1	11	0	0
23	27836235	.	C	T	0	2	2	0	5	7	0	0
23	27836245	.	G	A	5	2	7	0	0	8	1	0
23	28005087	.	C	T	1	1	2	0	0	2	0	0
23	28005338	.	A	G	1	3	4	0	0	4	0	0
23	28023784	.	T	C	11	9	20	0	1	21	0	0
23	28025664	.	A	G	4	2	6	0	0	6	0	0
23	28125796	.	C	T	6	2	8	0	0	8	0	0
23	28125841	.	C	T	7	2	9	0	0	9	0	0
23	28128445	.	T	C	1	0	1	0	1	2	0	0
23	28131047	.	T	C	1	3	4	0	0	4	0	0
23	28131285	.	C	T	2	3	5	0	0	5	0	0
23	28131320	.	G	A	2	4	6	0	0	6	0	0
23	28136167	.	G	T	4	2	6	0	0	6	0	0
23	28136349	.	T	C	3	4	7	0	0	7	0	0
23	28136615	.	C	G	1	3	4	0	0	4	0	0
23	28139515	.	C	T	4	4	8	0	0	8	0	0
23	28139564	.	A	G	5	4	9	0	0	9	0	0
23	28139633	.	T	C	2	6	8	0	1	9	0	0
23	28139812	.	A	G	0	1	1	0	0	1	0	0
23	28186060	.	T	A	2	5	7	0	3	10	0	0
23	28186688	.	T	G	1	0	1	0	0	1	0	0
23	28190648	.	A	G	3	1	4	0	0	4	0	0
23	28200967	.	A	G	2	2	4	0	0	4	0	0
23	28374722	.	C	T	13	7	20	0	4	24	0	0
23	28374756	.	A	G	9	3	12	0	2	14	0	0
23	28514820	.	G	A	0	1	1	0	0	1	0	0
23	28539279	.	G	A	0	1	1	0	0	1	0	0
23	28539626	.	G	A	1	2	3	0	0	3	0	0
23	28541638	.	C	T	2	2	4	0	0	4	0	0
23	28546798	.	T	C	3	5	8	0	0	8	0	0
23	28547261	.	A	G	4	5	9	0	1	10	0	0
23	28548883	.	A	G	2	0	2	0	2	4	0	0
23	28551306	.	A	T	3	5	8	0	0	8	0	0
23	28551770	.	G	A	3	6	9	0	1	10	0	0
23	28554784	.	A	T	1	2	3	0	0	3	0	0
23	28557337	.	T	C	11	5	16	0	4	20	0	0
23	28561248	.	T	C	1	0	1	0	0	1	0	0
23	28561836	.	C	T	2	4	6	0	0	6	0	0
23	28672155	.	G	A	0	3	3	0	2	5	0	0
23	28675754	.	G	A	2	0	2	0	0	2	0	0
23	28681558	.	G	C	14	14	28	0	2	30	0	0
23	28681559	.	C	A	14	13	27	0	3	30	0	0
23	28681723	.	T	A	16	12	28	0	0	28	0	0
23	28687446	.	C	T	2	1	3	0	0	3	0	0
23	28687448	.	C	G	2	1	3	0	0	3	0	0
23	28687591	.	T	C	4	2	6	0	0	6	0	0
23	28687656	.	G	A	3	5	8	0	0	8	0	0
23	28689939	.	T	A	1	1	2	0	1	3	0	0
23	28689940	.	T	C	1	1	2	0	1	3	0	0
23	28704611	.	G	A	5	1	6	0	2	8	0	0
23	28704635	.	C	T	3	1	4	0	1	5	0	0
23	28707051	.	C	T	1	2	3	0	0	3	0	0
23	28712193	.	T	G	0	1	1	0	0	1	0	0
23	28713648	.	C	T	1	2	3	0	0	3	0	0
23	28725425	.	C	T	2	4	6	0	1	7	0	0
23	28725822	.	G	T	3	3	6	0	0	6	0	0
23	28725899	.	T	A	1	2	3	0	1	4	0	0
23	28725991	.	T	C	1	2	3	0	0	3	0	0
23	28725994	.	G	A	1	2	3	0	0	3	0	0
23	28726026	.	T	C	1	2	3	0	0	3	0	0
23	28726486	.	A	T	3	5	8	0	0	8	0	0
23	28726738	.	A	G	7	10	17	0	3	20	0	0
23	28726852	.	T	C	10	8	18	0	0	18	0	0
23	28726937	.	C	A	9	6	15	0	0	15	0	0
23	28731489	.	A	C	24	19	43	0	3	46	0	0
23	28731834	.	C	T	20	36	56	0	6	62	0	0
23	28731914	.	T	C	38	21	59	0	6	65	0	0
23	28732305	.	A	T	1	3	4	0	0	4	0	0
23	28803253	.	T	C	3	4	7	0	0	7	0	0
23	28803256	.	T	C	3	0	3	0	4	7	0	0
23	28803305	.	C	T	1	3	4	0	1	5	0	0
23	28806278	.	A	G	3	3	6	0	0	6	0	0
23	28856977	.	A	G	0	2	2	0	0	2	0	0
23	28922024	.	A	G	1	4	5	0	0	5	0	0
23	28922778	.	T	A	1	3	4	0	0	4	0	0
23	28922854	.	A	C	2	3	5	0	0	5	0	0
23	28922920	.	T	A	3	4	7	0	0	7	0	0
23	28923540	.	A	G	2	5	7	0	1	8	0	0
23	28923660	.	A	T	2	8	10	0	0	10	0	0
23	28923797	.	G	A	2	6	8	0	1	9	0	0
23	28923959	.	T	A	7	8	15	0	1	16	0	0
23	28924079	.	A	C	3	4	7	0	0	7	0	0
23	28924117	.	G	C	2	9	11	0	0	11	0	0
23	28924399	.	C	G	1	14	15	0	2	17	0	0
23	28924672	.	C	T	3	3	6	0	0	6	0	0
23	28924687	.	G	A	0	3	3	0	4	7	0	0
23	28924806	.	A	G	2	10	12	0	0	12	0	0
23	28924872	.	G	A	3	2	5	0	0	5	0	0
23	28925156	.	A	T	5	9	14	0	2	16	0	0
23	28925159	.	G	A	0	10	10	0	7	17	0	0
23	28925270	.	T	G	5	6	11	0	1	12	0	0
23	28925272	.	A	G	8	2	10	0	2	12	0	0
23	28925354	.	T	C	6	4	10	0	1	11	0	0
23	29359664	.	T	A	7	7	14	0	1	15	0	0
23	29360044	.	T	C	15	11	26	0	1	27	0	0
23	29360407	.	G	T	0	10	10	0	12	22	0	0
23	29362740	.	T	G	0	2	2	0	1	3	0	0
23	29376111	.	T	C	4	6	10	0	0	10	0	0
23	29376410	.	C	T	4	9	13	0	1	14	0	0
23	29381612	.	C	A	7	7	14	0	1	15	0	0
23	29381816	.	G	A	8	21	29	0	2	31	0	0
23	29381819	.	T	G	7	25	32	0	1	33	0	0
23	29381855	.	T	G	3	16	19	0	5	24	0	0
23	29383693	.	C	A	5	8	13	0	2	15	0	0
23	29392421	.	G	A	6	4	10	0	0	10	0	0
23	29396482	.	C	T	22	33	55	0	3	58	0	0
23	29396588	.	T	C	36	3	39	0	24	63	0	0
23	29397116	.	C	G	23	18	41	0	0	41	0	0
23	29397451	.	T	G	22	18	40	0	0	40	0	0
23	29397476	.	T	C	21	16	37	0	3	40	0	0
23	29397537	.	G	A	22	18	40	0	1	41	0	0
23	29397584	.	C	A	13	16	29	0	4	33	0	0
23	29397590	.	C	G	14	16	30	0	3	33	0	0
23	29397665	.	T	G	20	17	37	0	1	38	0	0
23	29398015	.	C	A	0	19	19	0	27	46	0	0
23	29398025	.	G	A	24	18	42	0	2	44	0	0
23	29398065	.	T	C	17	16	33	0	4	37	0	0
23	29398288	.	T	G	24	7	31	0	5	36	0	0
23	29398310	.	C	T	23	12	35	0	5	40	0	0
23	29398343	.	A	G	21	19	40	0	4	44	0	0
23	29398390	.	C	T	21	20	41	0	1	42	0	0
23	29398718	.	A	T	19	23	42	0	2	44	0	0
23	29402103	.	A	G	17	13	30	0	1	31	0	0
23	29403243	.	G	A	23	15	38	0	0	38	0	0
23	29403297	.	G	A	7	6	13	0	1	14	0	0
23	29403437	.	G	A	3	5	8	0	1	9	0	0
23	29403491	.	C	A	5	6	11	0	1	12	0	0
23	29403515	.	A	C	1	0	1	0	1	2	0	0
23	29405829	.	A	G	16	10	26	0	1	27	0	0
23	29408773	.	A	G	15	11	26	0	1	27	0	0
23	29408929	.	G	A	0	3	3	0	0	3	0	0
23	29412411	.	A	G	2	7	9	0	0	9	0	0
23	29415484	.	A	G	4	0	4	0	1	5	0	0
23	29423410	.	G	A	6	5	11	0	0	11	0	0
23	29431995	.	T	C	5	6	11	0	2	13	0	0
23	29432040	.	A	G	8	5	13	0	1	14	0	0
23	29432055	.	G	A	9	2	11	0	1	12	0	0
23	29432867	.	T	G	3	1	4	0	1	5	0	0
23	29433670	.	G	A	5	4	9	0	1	10	0	0
23	29435044	.	T	C	1	1	2	0	0	2	0	0
23	29435330	.	C	T	1	1	2	0	0	2	0	0
23	29435381	.	G	A	1	0	1	0	0	1	0	0
23	29457942	.	T	C	0	1	1	0	5	6	0	0
23	29468980	.	G	A	1	2	3	0	0	3	0	0
23	29502227	.	C	T	0	0	0	0	3	3	0	0
23	29502311	.	C	T	0	2	2	0	0	2	0	0
23	29507723	.	A	T	15	22	37	0	0	37	0	0
23	29507825	.	T	C	7	0	7	0	15	22	0	0
23	29507859	.	T	G	9	11	20	0	0	20	0	0
23	29507883	.	G	A	10	8	18	0	0	18	0	0
23	29519565	.	G	A	1	3	4	0	0	4	0	0
23	29520070	.	A	C	1	0	1	0	0	1	0	0
23	29523602	.	G	A	3	3	6	0	0	6	0	0
23	29570627	.	C	G	4	2	6	0	0	6	0	0
23	29580587	.	A	T	5	3	8	0	0	8	0	0
23	29582416	.	T	C	14	41	55	0	3	58	0	0
23	29582420	.	T	C	12	46	58	0	1	59	0	0
23	29582476	.	T	C	7	38	45	0	3	48	0	0
23	29582496	.	T	C	32	14	46	0	2	48	0	0
23	29582634	.	C	A	39	24	63	0	2	65	0	0
23	29582673	.	A	G	37	20	57	0	4	61	0	0
23	29583417	.	T	A	23	24	47	0	6	53	0	0
23	29583708	.	G	A	31	23	54	0	5	59	0	0
23	29583814	.	T	A	34	28	62	0	3	65	0	0
23	29583882	.	A	G	39	23	62	0	0	62	0	0
23	29583960	.	G	A	22	31	53	0	3	56	0	0
23	29586380	.	G	A	10	16	26	0	2	28	0	0
23	29589392	.	A	G	13	15	28	0	1	29	0	0
23	29592588	.	T	C	11	1	12	0	11	23	0	0
23	29592708	.	G	A	17	13	30	0	0	30	0	0
23	29592741	.	C	T	14	8	22	0	1	23	0	0
23	29594441	.	A	G	2	8	10	0	0	10	0	0
23	29601269	.	C	T	4	2	6	0	0	6	0	0
23	29607011	.	A	G	7	3	10	0	3	13	0	0
23	29667473	.	A	C	2	0	2	0	0	2	0	0
23	29667480	.	G	A	3	0	3	0	0	3	0	0
23	29667614	.	C	G	4	2	6	0	1	7	0	0
23	29711788	.	G	A	13	11	24	0	3	27	0	0
23	29711911	.	C	T	17	15	32	0	0	32	0	0
23	29711998	.	G	A	20	13	33	0	0	33	0	0
23	29712140	.	G	A	8	9	17	0	1	18	0	0
23	29712465	.	G	A	14	6	20	0	3	23	0	0
23	29712922	.	C	A	11	7	18	0	0	18	0	0
23	29756865	.	A	T	6	10	16	0	2	18	0	0
23	29757038	.	G	A	7	6	13	0	1	14	0	0
23	29757099	.	A	T	3	7	10	0	3	13	0	0
23	29758030	.	C	T	0	5	5	0	9	14	0	0
23	29758088	.	A	G	5	5	10	0	0	10	0	0
23	29764120	.	T	C	1	4	5	0	1	6	0	0
23	29827748	.	G	A	2	5	7	0	0	7	0	0
23	29829160	.	A	T	1	3	4	0	0	4	0	0
23	29829186	.	A	C	1	3	4	0	0	4	0	0
23	29840171	.	T	C	0	0	0	0	1	1	0	0
23	29840178	.	A	G	1	0	1	0	1	2	0	0
23	29840274	.	C	A	2	5	7	0	0	7	0	0
23	29841374	.	T	C	8	2	10	0	1	11	0	0
23	29842966	.	C	T	4	5	9	0	1	10	0	0
23	29842967	.	T	G	4	6	10	0	0	10	0	0
23	29843067	.	A	T	1	2	3	0	0	3	0	0
23	29854359	.	G	A	0	1	1	0	0	1	0	0
23	29854362	.	C	T	0	1	1	0	0	1	0	0
23	29861645	.	A	T	4	6	10	0	0	10	0	0
23	29861973	.	A	G	21	18	39	0	1	40	0	0
23	29861976	.	T	C	19	1	20	0	19	39	0	0
23	29867576	.	G	A	0	7	7	0	0	7	0	0
23	29872254	.	A	G	2	3	5	0	0	5	0	0
23	29886897	.	G	C	24	11	35	0	0	35	0	0
23	29886937	.	T	A	13	17	30	0	0	30	0	0
23	29978089	.	T	C	0	1	1	0	0	1	0	0
23	29992023	.	G	C	1	2	3	0	0	3	0	0
23	30013535	.	G	A	1	2	3	0	0	3	0	0
23	30061605	.	A	C	18	9	27	0	2	29	0	0
23	30061763	.	C	T	0	21	21	0	25	46	0	0
23	30061804	.	A	C	14	23	37	0	4	41	0	0
23	30061960	.	T	C	25	3	28	0	23	51	0	0
23	30062364	.	T	A	15	16	31	0	0	31	0	0
23	30062792	.	C	T	14	12	26	0	4	30	0	0
23	30062888	.	C	T	0	15	15	0	13	29	1	0
23	30063216	.	T	C	14	1	15	0	13	28	0	0
23	30063217	.	T	G	13	12	25	0	3	28	0	0
23	30063527	.	G	A	2	9	11	0	1	12	0	0
23	30063578	.	A	G	6	7	13	0	1	14	0	0
23	30063643	.	C	T	10	4	14	0	2	16	0	0
23	30063722	.	G	A	4	9	13	0	0	13	0	0
23	30064289	.	T	C	5	4	9	0	3	12	0	0
23	30064579	.	A	G	10	7	17	0	1	18	0	0
23	30064743	.	C	A	7	4	11	0	1	13	1	0
23	30064804	.	A	G	6	6	12	0	0	12	0	0
23	30064853	.	A	G	2	8	10	0	0	10	0	0
23	30071637	.	G	A	1	0	1	0	0	1	0	0
23	30075201	.	G	A	5	2	7	0	0	7	0	0
23	30124651	.	A	G	2	3	5	0	0	5	0	0
23	30124960	.	G	A	2	2	4	0	0	4	0	0
23	30715328	.	T	C	1	1	2	0	0	2	0	0
23	30715397	.	G	A	0	0	0	0	1	1	0	0
23	30716096	.	C	T	2	4	6	0	1	7	0	0
23	30718514	.	T	A	0	3	3	0	0	3	0	0
23	30724230	.	C	A	3	8	11	0	0	11	0	0
23	30724698	.	T	A	3	7	10	0	0	10	0	0
23	30724828	.	G	C	3	3	6	0	0	6	0	0
23	30750183	.	G	A	0	9	9	0	12	21	0	0
23	30750402	.	C	A	6	6	12	0	0	12	0	0
23	30752095	.	C	A	16	9	25	0	0	26	1	0
23	30752233	.	T	G	9	5	14	0	0	14	0	0
23	30761144	.	G	A	3	1	4	0	0	4	0	0
23	30764212	.	T	C	6	3	9	0	0	9	0	0
23	30770193	.	A	G	6	7	13	0	0	13	0	0
23	30772902	.	C	T	0	3	3	0	0	3	0	0
23	30775273	.	T	C	2	2	4	0	0	4	0	0
23	30778499	.	G	A	6	4	10	0	1	11	0	0
23	30890191	.	T	G	1	2	3	0	0	3	0	0
23	30898132	.	C	T	2	2	4	0	0	4	0	0
23	30898150	.	T	C	2	2	4	0	0	4	0	0
23	30898355	.	A	C	2	2	4	0	1	5	0	0
23	30898387	.	C	T	2	2	4	0	0	4	0	0
23	30918961	.	G	T	2	2	4	0	0	4	0	0
23	30918998	.	A	G	2	7	9	0	0	9	0	0
23	30919027	.	T	G	4	6	10	0	0	10	0	0
23	30992939	.	C	A	1	3	4	0	0	4	0	0
23	30992952	.	G	A	1	3	4	0	0	4	0	0
23	31248605	.	A	T	2	5	7	0	0	7	0	0
23	31248779	.	T	C	2	3	5	0	0	5	0	0
23	31276396	.	T	A	0	2	2	0	0	2	0	0
23	31276453	.	G	A	0	3	3	0	0	3	0	0
23	31276657	.	T	C	2	2	4	0	0	4	0	0
23	31278183	.	G	T	1	1	2	0	0	2	0	0
23	31278237	.	C	T	0	2	2	0	1	3	0	0
23	31278375	.	A	G	2	2	4	0	0	4	0	0
23	31278417	.	G	T	2	3	5	0	1	6	0	0
23	31278450	.	T	A	1	2	3	0	1	4	0	0
23	31278732	.	C	T	1	0	1	0	0	1	0	0
23	31358342	.	A	T	24	18	42	0	1	44	1	0
23	31358344	.	A	T	23	19	42	0	2	44	0	0
23	31358489	.	T	G	22	23	45	0	5	50	0	0
23	31358631	.	G	A	35	18	53	0	5	59	1	0
23	31381068	.	C	T	2	4	6	0	0	6	0	0
23	31405519	.	C	T	2	2	4	0	0	4	0	0
23	31405570	.	A	C	4	6	10	0	0	10	0	0
23	31419172	.	A	T	2	5	7	0	0	7	0	0
23	31422564	.	A	G	1	2	3	0	3	6	0	0
23	31422768	.	A	G	5	7	12	0	1	13	0	0
23	31423091	.	T	C	5	12	17	0	0	17	0	0
23	31423145	.	G	A	1	7	8	0	6	14	0	0
23	31423392	.	C	A	18	9	27	0	5	32	0	0
23	31423427	.	A	G	24	0	24	0	8	32	0	0
23	31423432	.	C	A	20	7	27	0	4	31	0	0
23	31435892	.	T	A	9	0	9	0	2	11	0	0
23	31440119	.	T	A	1	5	6	0	0	6	0	0
23	31597571	.	T	C	3	6	9	0	0	9	0	0
23	31604900	.	C	T	1	6	7	0	0	7	0	0
23	31604912	.	G	T	0	5	5	0	1	6	0	0
23	31619577	.	G	A	1	2	3	0	0	3	0	0
23	31641153	.	C	A	15	22	37	0	5	42	0	0
23	31641197	.	A	G	18	21	39	0	3	42	0	0
23	31641270	.	G	A	12	18	30	0	3	33	0	0
23	31643818	.	A	G	13	7	20	0	1	21	0	0
23	31644368	.	A	G	5	2	7	0	3	10	0	0
23	31644419	.	A	G	2	3	5	0	0	5	0	0
23	31644602	.	T	G	6	4	10	0	4	14	0	0
23	31684244	.	A	G	0	0	0	0	1	1	0	0
23	31684352	.	G	A	6	5	11	0	0	11	0	0
23	31752909	.	A	G	2	10	12	0	1	13	0	0
23	31768596	.	T	C	6	5	11	0	0	11	0	0
23	31771282	.	T	C	0	2	2	0	0	2	0	0
23	31774194	.	G	A	1	1	2	1	0	3	0	0
23	31778174	.	A	G	0	2	2	0	0	2	0	0
23	31778183	.	C	T	0	2	2	0	0	2	0	0
23	31785175	.	G	A	1	3	4	0	0	4	0	0
23	31785183	.	T	G	2	2	4	0	0	4	0	0
23	31804162	.	A	G	1	2	3	0	0	3	0	0
23	31915069	.	T	C	1	3	4	0	0	4	0	0
23	31940681	.	C	A	0	2	2	0	0	2	0	0
23	31940775	.	T	A	4	2	6	0	2	8	0	0
23	31940776	.	A	G	4	4	8	0	0	8	0	0
23	31953228	.	A	T	1	3	4	0	0	4	0	0
23	31953501	.	A	G	1	3	4	0	1	5	0	0
23	31953518	.	C	T	1	3	4	0	0	4	0	0
23	31953537	.	A	C	1	5	6	0	0	6	0	0
23	31962648	.	A	T	0	3	3	0	2	5	0	0
23	31962650	.	T	C	0	3	3	0	2	5	0	0
23	31962971	.	T	C	11	8	19	0	1	20	0	0
23	31963226	.	C	T	9	7	16	0	0	16	0	0
23	31963360	.	A	G	3	3	6	0	0	6	0	0
23	31964680	.	C	T	4	2	6	0	0	6	0	0
23	31997582	.	G	A	1	7	8	0	0	8	0	0
23	32003354	.	T	A	2	3	5	0	0	5	0	0
23	32003808	.	T	C	5	6	11	0	0	11	0	0
23	32003820	.	G	T	4	4	8	0	0	8	0	0
23	32007376	.	T	G	6	7	13	0	0	13	0	0
23	32007445	.	T	A	8	9	17	1	0	18	0	0
23	32007520	.	T	C	4	8	12	0	0	12	0	0
23	32007526	.	C	G	5	8	13	0	1	14	0	0
23	32026927	.	T	C	0	4	4	0	0	4	0	0
23	32026978	.	C	T	1	4	5	0	1	6	0	0
23	32037265	.	C	T	2	3	5	0	0	5	0	0
23	32037336	.	A	G	1	1	2	0	0	2	0	0
23	32081708	.	C	T	4	1	5	0	1	6	0	0
23	32081717	.	T	C	4	1	5	0	1	6	0	0
23	32128848	.	A	T	1	2	3	0	0	3	0	0
23	32128893	.	T	C	1	2	3	0	1	4	0	0
23	32129476	.	G	T	6	5	11	0	0	11	0	0
23	32129514	.	G	T	3	6	9	0	2	11	0	0
23	32151406	.	A	G	3	0	3	0	0	3	0	0
23	32151669	.	A	C	14	16	30	0	2	32	0	0
23	32152022	.	C	T	16	19	35	0	1	36	0	0
23	32154021	.	G	T	2	4	6	0	0	6	0	0
23	32155325	.	A	G	2	0	2	0	0	2	0	0
23	32155719	.	C	T	2	7	9	0	0	9	0	0
23	32155720	.	C	T	0	6	6	0	3	9	0	0
23	32200071	.	A	G	4	4	8	0	0	8	0	0
23	32200076	.	T	G	3	4	7	0	0	7	0	0
23	32200114	.	A	C	1	5	6	0	1	7	0	0
23	32200410	.	A	G	3	3	6	0	0	6	0	0
23	32200583	.	C	T	0	2	2	0	1	3	0	0
23	32200979	.	A	G	2	5	7	0	0	7	0	0
23	32239672	.	G	A	8	6	14	0	0	14	0	0
23	32239688	.	C	A	11	6	17	0	1	18	0	0
23	32239708	.	G	A	15	5	20	0	1	21	0	0
23	32239824	.	G	A	8	11	19	0	0	19	0	0
23	32240258	.	C	T	5	3	8	0	2	10	0	0
23	32240290	.	A	G	3	3	6	0	1	7	0	0
23	32242086	.	C	A	2	3	5	0	1	6	0	0
23	32242251	.	T	C	6	4	10	0	1	11	0	0
23	32309187	.	T	C	14	15	29	0	1	30	0	0
23	32309193	.	G	A	13	16	29	0	0	29	0	0
23	32309323	.	G	A	13	14	27	0	3	30	0	0
23	32309533	.	A	G	11	16	27	0	0	27	0	0
23	32309659	.	C	A	0	8	8	0	11	19	0	0
23	32309709	.	G	A	9	10	19	0	0	19	0	0
23	32309787	.	A	C	11	7	18	0	0	18	0	0
23	32309846	.	T	A	1	4	5	0	0	5	0	0
23	32309943	.	A	G	6	3	9	0	0	9	0	0
23	32310864	.	G	A	11	4	15	0	1	16	0	0
23	32311418	.	T	C	8	3	11	0	1	12	0	0
23	32311555	.	G	C	11	11	22	0	1	23	0	0
23	32311612	.	G	A	6	10	16	0	1	17	0	0
23	32318047	.	A	G	7	8	15	0	0	15	0	0
23	33657431	.	T	A	11	16	27	0	1	28	0	0
23	33657460	.	C	T	17	15	32	0	1	33	0	0
23	33657467	.	T	A	16	15	31	0	2	33	0	0
23	33657714	.	T	G	12	12	24	0	0	24	0	0
23	33682045	.	A	T	3	4	7	0	1	8	0	0
23	33682306	.	T	C	5	4	9	0	1	10	0	0
23	33682313	.	A	G	4	3	7	0	1	8	0	0
23	33682736	.	A	G	2	6	8	0	0	8	0	0
23	33682740	.	A	T	2	7	9	0	0	9	0	0
23	33682992	.	T	A	2	3	5	0	1	6	0	0
23	33683092	.	T	G	6	6	12	0	0	12	0	0
23	33683299	.	T	A	3	1	4	0	0	4	0	0
23	33683518	.	A	G	4	2	6	0	0	6	0	0
23	33693482	.	G	A	1	0	1	0	0	1	0	0
23	33693572	.	T	C	1	1	2	0	0	2	0	0
23	33718699	.	T	C	14	15	29	0	2	31	0	0
23	33724825	.	G	A	0	15	15	0	18	33	0	0
23	33727916	.	C	T	18	12	30	0	5	35	0	0
23	33728398	.	A	T	15	16	31	0	2	33	0	0
23	33728518	.	T	C	13	15	28	0	1	29	0	0
23	33728609	.	A	T	24	15	39	0	7	46	0	0
23	33728877	.	T	A	15	22	37	0	1	38	0	0
23	33728994	.	T	A	15	6	21	0	2	23	0	0
23	33729231	.	T	A	6	10	16	0	0	16	0	0
23	33729510	.	A	G	15	21	36	0	1	37	0	0
23	33892021	.	C	T	0	4	4	0	0	4	0	0
23	33901239	.	C	T	5	5	10	0	1	11	0	0
23	33901271	.	C	T	6	5	11	0	0	11	0	0
23	33907969	.	C	A	5	9	14	0	0	14	0	0
23	33907990	.	A	G	4	0	4	0	7	11	0	0
23	33918162	.	C	T	9	5	14	0	1	15	0	0
23	33920287	.	G	A	5	1	6	0	0	6	0	0
23	33920311	.	A	G	6	3	9	0	0	9	0	0
23	33920344	.	C	T	5	7	12	0	0	12	0	0
23	33920431	.	C	T	2	2	4	0	0	4	0	0
23	33926555	.	C	A	1	1	2	0	0	2	0	0
23	33926663	.	C	T	15	22	37	0	0	37	0	0
23	33927045	.	C	T	15	28	43	0	6	49	0	0
23	33927244	.	G	A	0	17	17	0	17	34	0	0
23	33927500	.	T	A	10	12	22	0	0	22	0	0
23	33927897	.	T	G	22	27	49	0	7	56	0	0
23	33927941	.	C	T	25	23	48	0	3	51	0	0
23	33935471	.	C	G	7	12	19	0	1	20	0	0
23	33935549	.	C	T	3	0	3	0	0	3	0	0
23	33944059	.	G	A	1	5	6	0	0	6	0	0
23	33944188	.	C	T	2	6	8	0	0	8	0	0
23	33944336	.	A	T	7	2	9	0	1	10	0	0
23	33944337	.	G	A	7	2	9	0	1	10	0	0
23	33974392	.	T	C	6	2	8	0	0	8	0	0
23	33974659	.	C	A	5	19	24	0	1	25	0	0
23	33974662	.	A	T	6	19	25	0	1	26	0	0
23	33974827	.	A	T	9	19	28	0	1	29	0	0
23	33974904	.	T	A	14	11	25	0	0	25	0	0
23	33975854	.	T	A	16	21	37	0	2	39	0	0
23	33975994	.	G	A	2	6	8	0	0	8	0	0
23	33978028	.	T	G	4	7	11	0	0	11	0	0
23	33978049	.	A	T	4	3	7	0	0	7	0	0
23	33978125	.	A	C	3	2	5	0	0	5	0	0
23	33978462	.	T	A	13	16	29	0	0	29	0	0
23	33978469	.	C	T	15	10	25	0	3	28	0	0
23	33978577	.	C	T	5	6	11	0	0	11	0	0
23	33978617	.	T	C	0	3	3	0	0	3	0	0
23	33978639	.	G	T	5	6	11	0	0	11	0	0
23	33978671	.	T	A	11	9	20	0	0	20	0	0
23	33983333	.	G	C	4	4	8	0	0	8	0	0
23	33984364	.	G	A	5	4	9	0	1	10	0	0
23	33987467	.	T	G	3	3	6	0	0	6	0	0
23	33991132	.	G	A	1	4	5	0	0	5	0	0
23	34005089	.	G	T	5	13	18	0	0	18	0	0
23	34005095	.	T	C	5	4	9	0	6	15	0	0
23	34035241	.	G	T	1	3	4	0	0	4	0	0
23	34035295	.	G	A	5	4	9	0	1	10	0	0
23	34036432	.	A	G	0	2	2	0	1	3	0	0
23	34038436	.	C	T	8	6	14	0	1	15	0	0
23	34042998	.	C	T	25	14	39	0	1	40	0	0
23	34043308	.	G	T	17	19	36	0	0	36	0	0
23	34043335	.	G	A	0	18	18	0	23	41	0	0
23	34043423	.	G	A	11	20	31	0	0	31	0	0
23	34043536	.	T	C	12	16	28	0	4	32	0	0
23	34043596	.	T	C	4	7	11	0	4	15	0	0
23	34047440	.	G	A	0	2	2	0	0	2	0	0
23	34136467	.	C	T	12	8	20	0	2	22	0	0
23	34184982	.	G	C	4	3	7	0	0	7	0	0
23	34385720	.	G	A	1	2	3	0	0	3	0	0
23	34726384	.	A	G	0	0	0	0	2	2	0	0
23	34726387	.	A	G	0	2	2	0	0	2	0	0
23	34753803	.	A	G	4	5	9	0	0	9	0	0
23	35027386	.	T	G	3	3	6	0	0	6	0	0
23	35027480	.	T	G	5	4	9	0	0	9	0	0
23	35027518	.	T	A	4	4	8	0	0	8	0	0
23	35027541	.	A	G	5	5	10	0	0	10	0	0
23	35027736	.	C	G	6	4	10	0	0	10	0	0
23	35039803	.	C	T	2	1	3	0	0	3	0	0
23	35362951	.	C	T	4	10	14	0	2	16	0	0
23	35362973	.	G	T	10	5	15	0	0	15	0	0
23	35363024	.	A	T	11	6	17	0	3	20	0	0
23	35363067	.	A	T	9	6	15	0	6	21	0	0
23	35363106	.	G	A	14	12	26	0	1	27	0	0
23	35363111	.	C	G	12	15	27	0	1	28	0	0
23	35363341	.	A	G	17	12	29	0	0	29	0	0
23	35369733	.	G	A	2	1	3	0	0	3	0	0
23	35469135	.	T	C	1	2	3	0	0	3	0	0
23	35469136	.	G	A	1	2	3	0	0	3	0	0
23	35469479	.	A	G	8	4	12	0	3	15	0	0
23	35469668	.	G	T	2	10	12	0	0	12	0	0
23	35473640	.	A	G	2	0	2	0	0	2	0	0
23	35537291	.	T	A	8	3	11	0	0	11	0	0
23	35537293	.	A	G	7	3	10	0	1	11	0	0
23	35537599	.	G	A	8	13	21	0	3	24	0	0
23	35537617	.	G	A	9	9	18	0	0	18	0	0
23	35537693	.	A	C	7	4	11	0	0	11	0	0
23	35642195	.	C	T	7	6	13	0	0	13	0	0
23	35642327	.	T	G	7	7	14	0	1	15	0	0
23	35661530	.	T	C	1	2	3	0	0	3	0	0
23	35661549	.	A	C	1	3	4	0	0	4	0	0
23	35691968	.	T	G	0	2	2	0	0	2	0	0
23	35710179	.	A	C	13	26	39	2	0	41	0	0
23	35714883	.	T	C	0	0	0	0	1	1	0	0
23	36298658	.	G	A	0	8	8	0	4	12	0	0
23	36298667	.	T	A	8	2	10	0	1	11	0	0
23	36310415	.	C	A	1	2	3	0	0	3	0	0
23	37288406	.	A	G	1	4	5	0	0	5	0	0
23	37466157	.	C	T	1	2	3	0	0	3	0	0
23	39413235	.	A	G	4	2	6	0	0	6	0	0
23	39756775	.	T	G	2	22	24	0	0	24	0	0
23	39757050	.	T	C	6	4	10	0	0	10	0	0
23	39757167	.	T	C	1	5	6	0	0	6	0	0
23	39809185	.	G	A	2	4	6	1	1	8	0	0
23	40526489	.	T	C	1	2	3	0	0	3	0	0
23	40526953	.	T	C	0	3	3	0	1	4	0	0
23	40526961	.	A	T	0	2	2	0	1	3	0	0
23	40527564	.	C	T	1	2	3	0	0	3	0	0
23	40527583	.	G	A	3	2	5	0	0	5	0	0
23	40527632	.	G	A	1	2	3	0	1	4	0	0
23	40528019	.	C	T	3	2	5	0	1	6	0	0
23	40528064	.	G	A	1	2	3	0	0	3	0	0
23	40742067	.	G	A	0	5	5	0	4	9	0	0
23	40742133	.	G	C	3	6	9	0	1	10	0	0
23	40742234	.	C	A	4	3	7	0	0	7	0	0
23	40742236	.	G	C	3	4	7	0	0	7	0	0
23	40756296	.	A	C	0	2	2	0	0	2	0	0
23	40873948	.	A	G	0	2	2	0	0	2	0	0
23	40873953	.	G	C	0	1	1	0	0	1	0	0
23	40972205	.	A	T	2	2	4	0	0	4	0	0
23	40972208	.	C	T	1	2	3	0	1	4	0	0
23	42283476	.	A	G	3	8	11	0	0	11	0	0
23	42330063	.	C	T	1	1	2	0	1	3	0	0
23	42330090	.	C	G	1	3	4	0	0	4	0	0
23	42372252	.	T	A	2	3	5	0	0	5	0	0
23	42372294	.	A	C	1	2	3	0	0	3	0	0
23	43508141	.	A	G	1	2	3	0	0	3	0	0
23	43508171	.	T	C	2	3	5	0	0	5	0	0
23	43517458	.	A	G	1	1	2	0	0	2	0	0
23	43642334	.	C	T	0	1	1	0	0	1	0	0
23	43652306	.	G	C	5	1	6	0	0	6	0	0
23	43652831	.	G	C	5	5	10	0	1	11	0	0
23	43652901	.	C	G	3	3	6	0	0	6	0	0
23	43688291	.	T	C	1	2	3	0	1	4	0	0
23	43688730	.	G	A	1	1	2	0	0	2	0	0
23	43688737	.	G	A	1	2	3	0	0	3	0	0
23	43688805	.	C	T	2	1	3	0	2	5	0	0
23	43688810	.	T	C	3	2	5	0	2	7	0	0
23	43688852	.	C	G	3	3	6	0	1	7	0	0
23	43689729	.	G	A	1	2	3	0	0	3	0	0
23	43690361	.	T	C	1	3	4	0	0	4	0	0
23	43690394	.	A	G	2	3	5	0	0	5	0	0
23	43690490	.	A	G	2	7	9	0	0	9	0	0
23	43690622	.	G	C	0	5	5	0	1	6	0	0
23	43690625	.	T	G	1	4	5	0	1	6	0	0
23	43690715	.	T	C	4	2	6	0	2	8	0	0
23	43690762	.	C	A	0	2	2	0	1	3	0	0
23	43690808	.	A	T	1	2	3	0	0	3	0	0
23	43690838	.	A	G	3	2	5	0	0	5	0	0
23	43690913	.	T	G	1	4	5	0	0	5	0	0
23	43691636	.	G	T	1	3	4	0	0	4	0	0
23	43691716	.	A	T	2	2	4	0	0	4	0	0
23	43691770	.	T	C	4	5	9	0	0	9	0	0
23	43691810	.	A	T	3	4	7	0	0	7	0	0
23	43691992	.	T	C	2	4	6	0	0	6	0	0
23	43695927	.	C	A	0	15	15	0	12	27	0	0
23	43695956	.	C	T	0	17	17	0	16	33	0	0
23	43696355	.	G	A	16	19	35	0	0	35	0	0
23	43699846	.	A	G	6	9	15	0	2	17	0	0
23	43700064	.	T	C	8	0	8	0	12	20	0	0
23	43700082	.	C	G	10	15	25	0	1	26	0	0
23	43700114	.	G	A	5	8	13	0	1	14	0	0
23	43700121	.	G	A	6	7	13	0	0	13	0	0
23	43705961	.	G	T	6	14	20	0	2	22	0	0
23	43706003	.	A	G	13	21	34	0	0	34	0	0
23	43706102	.	T	G	9	9	18	0	1	19	0	0
23	43707165	.	C	T	1	5	6	0	1	7	0	0
23	43718042	.	C	A	2	3	5	0	0	5	0	0
23	43723615	.	G	A	0	1	1	0	0	1	0	0
23	43770583	.	C	A	9	3	12	0	0	12	0	0
23	43770682	.	T	C	2	4	6	0	0	6	0	0
23	43770715	.	C	T	2	2	4	0	0	4	0	0
23	43770832	.	T	C	1	1	2	0	0	2	0	0
23	43780214	.	C	T	1	2	3	0	1	4	0	0
23	43784985	.	C	T	8	11	19	0	0	19	0	0
23	43799699	.	T	C	0	4	4	0	0	4	0	0
23	43799798	.	A	C	2	2	4	0	0	4	0	0
23	43800684	.	G	A	0	3	3	0	2	5	0	0
23	43800701	.	T	C	3	3	6	0	0	6	0	0
23	43800723	.	G	A	0	5	5	0	4	9	0	0
23	43800747	.	A	C	4	3	7	0	1	8	0	0
23	43800912	.	C	T	1	4	5	0	0	5	0	0
23	43800968	.	T	G	2	3	5	0	0	5	0	0
23	43800983	.	G	A	1	3	4	0	0	4	0	0
23	43801090	.	A	C	2	2	4	0	0	4	0	0
23	43801284	.	C	G	3	3	6	0	2	8	0	0
23	43801408	.	A	T	2	1	3	0	0	3	0	0
23	43802049	.	C	T	3	3	6	0	0	6	0	0
23	43830408	.	C	T	1	3	4	0	1	5	0	0
23	43830412	.	T	C	2	3	5	0	1	6	0	0
23	43898097	.	A	C	1	2	3	0	0	3	0	0
23	43977921	.	C	T	1	0	1	0	1	2	0	0
23	44090326	.	T	A	3	3	6	0	0	6	0	0
23	44092839	.	T	A	2	2	4	0	0	4	0	0
23	44096060	.	A	G	6	0	6	0	9	15	0	0
23	44098511	.	A	G	4	4	8	0	0	8	0	0
23	44098517	.	C	T	0	3	3	0	4	7	0	0
23	44102199	.	G	T	0	1	1	0	0	1	0	0
23	44106540	.	C	T	25	21	46	0	3	49	0	0
23	44106591	.	G	C	23	22	45	0	2	47	0	0
23	44107138	.	C	T	15	12	27	0	3	30	0	0
23	44236361	.	G	T	4	5	9	0	0	9	0	0
23	44236388	.	A	T	1	3	4	0	1	5	0	0
23	44236750	.	T	A	3	2	5	0	0	5	0	0
23	44237158	.	A	C	5	9	14	0	1	15	0	0
23	44237416	.	T	C	5	3	8	0	1	9	0	0
23	44237531	.	G	T	10	5	15	0	1	16	0	0
23	44237611	.	G	C	0	9	9	0	10	19	0	0
23	44237701	.	C	A	16	9	25	0	2	27	0	0
23	44238125	.	G	T	9	8	17	0	2	19	0	0
23	44238186	.	C	T	4	6	10	0	1	11	0	0
23	44242535	.	A	C	4	5	9	0	0	9	0	0
23	44242608	.	T	C	6	13	19	0	1	20	0	0
23	44250702	.	C	A	12	7	19	0	0	19	0	0
23	44250736	.	C	T	6	10	16	0	1	17	0	0
23	44308088	.	G	A	4	6	10	0	0	10	0	0
23	44312611	.	G	A	0	4	4	0	6	10	0	0
23	44313190	.	G	C	1	2	3	0	0	3	0	0
23	44328488	.	G	A	1	3	4	0	1	5	0	0
23	44328557	.	C	T	7	6	13	0	0	13	0	0
23	44332614	.	C	T	14	15	29	0	2	31	0	0
23	44332617	.	C	T	16	12	28	0	3	31	0	0
23	44332675	.	C	T	12	9	21	0	4	26	1	0
23	44400965	.	C	T	3	2	5	0	1	6	0	0
23	44428067	.	A	C	8	11	19	0	1	21	1	0
23	44430544	.	C	T	5	7	12	0	0	12	0	0
23	44432608	.	C	T	2	0	2	0	1	3	0	0
23	44440421	.	G	A	9	9	18	0	1	19	0	0
23	44440489	.	C	T	12	15	27	0	0	27	0	0
23	44478131	.	A	G	2	5	7	0	0	7	0	0
23	44487465	.	C	G	2	2	4	0	2	6	0	0
23	44487521	.	A	G	2	1	3	0	1	4	0	0
23	44518479	.	G	A	2	3	5	0	0	5	0	0
23	44518550	.	G	A	1	3	4	0	0	4	0	0
23	44519381	.	T	G	2	0	2	0	9	11	0	0
23	44519543	.	A	G	1	2	3	0	0	3	0	0
23	44519991	.	G	T	1	1	2	0	1	3	0	0
23	44521264	.	A	T	9	4	13	0	0	13	0	0
23	44521330	.	A	G	5	10	15	0	2	17	0	0
23	44521495	.	G	A	3	8	11	0	0	11	0	0
23	44521516	.	A	C	3	7	10	0	1	11	0	0
23	44521676	.	C	T	4	4	8	0	0	8	0	0
23	44521721	.	T	G	0	2	2	0	0	2	0	0
23	44537383	.	G	A	3	3	6	0	2	8	0	0
23	44546116	.	G	A	1	2	3	0	0	3	0	0
23	44550446	.	G	A	9	12	21	0	4	25	0	0
23	44603710	.	T	C	1	1	2	0	0	2	0	0
23	44603912	.	G	A	6	4	10	0	0	10	0	0
23	44603990	.	C	G	4	8	12	0	2	14	0	0
23	44617600	.	T	C	2	3	5	0	1	6	0	0
23	44620750	.	C	T	2	1	3	0	0	3	0	0
23	44620911	.	C	T	1	0	1	0	0	1	0	0
23	44622736	.	T	C	1	1	2	0	0	2	0	0
23	44652616	.	C	A	3	2	5	0	1	6	0	0
23	44652697	.	T	G	1	2	3	0	1	4	0	0
23	44652702	.	T	A	2	2	4	0	0	4	0	0
23	44652877	.	A	G	3	4	7	0	0	7	0	0
23	44653259	.	A	T	7	9	16	0	0	16	0	0
23	44732976	.	G	A	16	11	27	0	5	32	0	0
23	44755296	.	T	C	0	1	1	0	0	1	0	0
23	44761680	.	G	C	13	14	27	0	4	31	0	0
23	44762190	.	T	C	23	35	58	0	1	59	0	0
23	44844111	.	T	A	3	5	8	0	0	8	0	0
23	44850274	.	G	A	0	1	1	0	0	1	0	0
23	44893126	.	G	C	2	3	5	0	0	5	0	0
23	44973321	.	G	T	5	2	7	0	0	7	0	0
23	44979861	.	C	T	0	0	0	0	1	1	0	0
23	44999663	.	A	C	1	2	3	0	0	3	0	0
23	45021218	.	G	A	1	0	1	0	1	2	0	0
23	45027911	.	C	T	14	6	20	0	3	23	0	0
23	45028191	.	T	C	26	27	53	0	2	55	0	0
23	45028248	.	C	T	12	12	24	0	3	27	0	0
23	45043654	.	G	A	3	3	6	0	0	6	0	0
23	45855667	.	A	G	1	2	3	0	1	4	0	0
23	46208578	.	T	G	18	16	34	0	0	34	0	0
23	46208611	.	T	G	15	24	39	0	3	42	0	0
23	46208718	.	G	A	27	16	43	0	2	45	0	0
23	46217045	.	C	A	4	3	7	0	1	8	0	0
24	187630	.	A	G	13	5	18	0	0	18	0	0
24	187643	.	A	G	5	13	18	0	1	19	0	0
24	187756	.	A	G	16	5	21	0	3	24	0	0
24	187757	.	A	G	14	7	21	0	3	24	0	0
24	188071	.	A	G	5	4	9	0	1	10	0	0
24	788327	.	A	G	1	5	6	0	0	6	0	0
24	788343	.	A	G	4	2	6	0	0	6	0	0
24	788384	.	A	G	2	4	6	0	0	6	0	0
24	985258	.	T	G	14	10	24	0	0	24	0	0
24	1111146	.	T	C	2	3	5	0	1	6	0	0
24	3470608	.	T	C	4	4	8	0	0	8	0	0
24	3471477	.	T	C	5	4	9	0	0	9	0	0
24	4142956	.	G	A	5	2	7	0	1	8	0	0
24	6011725	.	A	G	5	3	8	0	0	8	0	0
24	6342819	.	T	A	1	2	3	0	0	3	0	0
24	8861380	.	T	C	1	2	3	0	1	4	0	0
24	9558641	.	G	A	0	2	2	0	0	2	0	0
24	9572907	.	A	G	2	2	4	0	0	4	0	0
24	9594999	.	T	C	8	2	10	0	1	11	0	0
24	9596093	.	A	C	1	2	3	0	0	3	0	0
24	9596350	.	G	A	5	2	7	0	0	7	0	0
24	9596366	.	T	A	5	2	7	0	0	7	0	0
24	9673517	.	T	G	4	0	4	0	3	7	0	0
24	9673525	.	C	A	6	1	7	0	0	7	0	0
24	9673568	.	G	T	7	4	11	0	1	12	0	0
24	9676144	.	T	C	4	6	10	0	0	10	0	0
24	9676147	.	T	A	4	7	11	0	0	11	0	0
24	9676204	.	C	A	3	3	6	0	0	6	0	0
24	9678514	.	A	T	11	13	24	0	4	28	0	0
24	9689709	.	G	T	4	7	11	0	0	11	0	0
24	9721103	.	A	C	0	3	3	0	0	3	0	0
24	9729966	.	A	T	0	1	1	0	0	1	0	0
24	9730098	.	G	A	6	5	11	0	0	11	0	0
24	9730134	.	G	A	6	3	9	0	0	9	0	0
24	9732066	.	T	A	0	2	2	0	0	2	0	0
24	9744236	.	G	A	0	2	2	0	2	4	0	0
24	10303168	.	C	T	2	4	6	0	0	6	0	0
24	10303178	.	G	T	0	7	7	0	1	8	0	0
24	10303221	.	A	G	2	0	2	0	4	6	0	0
24	10303240	.	T	A	2	3	5	0	0	5	0	0
24	10309243	.	A	G	5	1	6	0	2	8	0	0
24	10309289	.	C	T	4	2	6	0	0	6	0	0
24	10309532	.	T	A	3	5	8	0	0	8	0	0
24	10349671	.	C	T	4	3	7	0	1	8	0	0
24	10349783	.	G	T	3	2	5	0	0	5	0	0
24	10349818	.	G	A	4	3	7	0	0	7	0	0
24	10349865	.	T	G	6	5	11	0	0	11	0	0
24	10349898	.	T	C	5	5	10	0	0	10	0	0
24	10350239	.	T	A	5	6	11	0	0	11	0	0
24	10406464	.	C	G	1	4	5	0	0	5	0	0
24	10414039	.	T	C	3	2	5	0	0	5	0	0
24	10414439	.	G	T	0	4	4	0	2	6	0	0
24	10415193	.	A	G	8	11	19	0	1	20	0	0
24	10415370	.	G	C	9	7	16	0	1	17	0	0
24	10797306	.	T	C	1	2	3	0	0	3	0	0
24	10824235	.	C	T	3	6	9	0	1	10	0	0
24	10897254	.	G	A	0	3	3	0	0	3	0	0
24	10901467	.	A	C	10	8	18	0	2	20	0	0
24	10901696	.	C	G	26	24	50	0	4	54	0	0
24	10901759	.	G	T	20	19	39	0	4	43	0	0
24	10901946	.	C	T	9	12	21	0	3	24	0	0
24	10902065	.	T	G	7	13	20	0	2	22	0	0
24	10902192	.	T	A	8	5	13	0	0	13	0	0
24	10902268	.	G	A	6	11	17	0	2	19	0	0
24	10902568	.	T	C	21	0	21	0	22	43	0	0
24	10902688	.	G	A	14	15	29	0	2	31	0	0
24	10907000	.	T	C	1	3	4	0	1	5	0	0
24	10907473	.	C	T	13	9	22	0	6	28	0	0
24	10907587	.	G	T	5	1	6	0	2	8	0	0
24	10917040	.	C	T	1	1	2	0	1	3	0	0
24	10917046	.	C	T	0	1	1	0	2	3	0	0
24	10917238	.	C	T	2	1	3	0	0	3	0	0
24	10919519	.	A	G	1	2	3	0	1	4	0	0
24	10919563	.	G	T	0	1	1	0	0	1	0	0
24	10924880	.	C	T	6	3	9	0	0	9	0	0
24	10924912	.	C	T	6	4	10	0	0	10	0	0
24	11059944	.	T	A	2	3	5	0	0	5	0	0
24	11061128	.	A	T	0	3	3	0	0	3	0	0
24	11061146	.	A	G	0	3	3	0	0	3	0	0
24	11062595	.	C	G	0	2	2	0	0	2	0	0
24	11083860	.	C	T	5	3	8	0	0	8	0	0
24	11084074	.	A	C	1	0	1	0	0	1	0	0
24	11086437	.	G	T	3	2	5	0	0	5	0	0
24	11086679	.	T	A	5	9	14	0	0	14	0	0
24	11086887	.	C	A	2	4	6	0	0	6	0	0
24	11112153	.	T	A	5	7	12	0	0	12	0	0
24	11112290	.	G	A	5	6	11	0	1	12	0	0
24	11112474	.	A	G	10	6	16	0	0	16	0	0
24	11112710	.	A	C	12	1	13	0	11	24	0	0
24	11112839	.	G	A	17	10	27	0	1	28	0	0
24	11113027	.	T	C	6	5	11	0	0	11	0	0
24	11113110	.	C	T	2	13	15	0	2	17	0	0
24	11113243	.	G	A	7	4	11	0	0	11	0	0
24	11113293	.	A	T	6	11	17	0	1	18	0	0
24	11113493	.	T	C	3	0	3	0	6	9	0	0
24	11113507	.	T	C	3	2	5	0	0	5	0	0
24	11113912	.	A	T	6	10	16	0	2	18	0	0
24	11113966	.	T	C	3	7	10	0	1	11	0	0
24	11113972	.	C	G	4	8	12	0	0	12	0	0
24	11114184	.	G	T	4	11	15	0	1	16	0	0
24	11114236	.	A	T	9	7	16	0	1	17	0	0
24	11114408	.	T	C	2	2	4	0	1	5	0	0
24	11114786	.	A	G	4	5	9	0	0	9	0	0
24	11115114	.	G	A	2	4	6	0	1	7	0	0
24	11115222	.	A	C	2	4	6	0	2	8	0	0
24	11115280	.	C	G	2	4	6	0	1	7	0	0
24	11115532	.	G	A	3	3	6	0	0	6	0	0
24	11115719	.	T	A	2	4	6	0	0	6	0	0
24	11115720	.	A	G	2	4	6	0	0	6	0	0
24	11115806	.	A	G	1	2	3	0	1	4	0	0
24	11115920	.	T	C	0	3	3	0	0	3	0	0
24	11127483	.	G	A	2	1	3	0	0	3	0	0
24	11141027	.	G	A	1	3	4	0	0	4	0	0
24	11141065	.	C	T	3	5	8	0	0	8	0	0
24	11141654	.	A	G	1	1	2	0	0	2	0	0
24	11141849	.	G	A	2	2	4	0	1	5	0	0
24	11145196	.	C	T	2	2	4	0	1	5	0	0
24	11145250	.	G	A	2	4	6	0	0	6	0	0
24	11145460	.	A	G	2	3	5	0	0	5	0	0
24	11473845	.	T	G	2	4	6	0	1	7	0	0
24	11473857	.	C	A	4	2	6	0	1	7	0	0
24	11473968	.	T	C	7	1	8	0	8	16	0	0
24	11474167	.	T	C	5	9	14	0	2	16	0	0
24	11474257	.	G	A	11	6	17	0	0	17	0	0
24	11483833	.	C	T	1	0	1	0	0	1	0	0
24	11490060	.	C	T	4	4	8	0	1	9	0	0
24	11496890	.	G	A	2	2	4	0	0	4	0	0
24	11496922	.	G	A	2	2	4	0	0	4	0	0
24	11496937	.	A	G	2	2	4	0	1	5	0	0
24	11497243	.	A	G	2	2	4	0	0	4	0	0
24	11497351	.	C	T	2	4	6	0	0	6	0	0
24	11528577	.	A	G	4	5	9	0	1	10	0	0
24	11529966	.	C	T	4	5	9	0	0	9	0	0
24	11530003	.	T	C	4	4	8	0	1	9	0	0
24	11888799	.	T	C	11	8	19	0	1	20	0	0
24	11888854	.	T	C	9	10	19	0	1	20	0	0
24	11889353	.	C	T	2	3	5	0	0	5	0	0
24	11889717	.	T	C	1	2	3	0	0	3	0	0
24	11919170	.	A	G	3	5	8	0	1	9	0	0
24	12133963	.	C	A	2	2	4	0	1	5	0	0
24	12133998	.	A	C	2	4	6	0	1	7	0	0
24	12252675	.	G	T	11	10	21	0	1	22	0	0
24	12253067	.	G	A	5	6	11	0	1	12	0	0
24	12253154	.	T	G	6	13	19	0	0	19	0	0
24	12630352	.	A	G	8	4	12	0	1	13	0	0
24	12634439	.	C	T	13	8	21	0	1	22	0	0
24	12686316	.	A	T	0	1	1	0	0	1	0	0
24	12744894	.	G	T	4	3	7	0	1	8	0	0
24	12745075	.	T	G	2	2	4	0	0	4	0	0
24	12746597	.	A	G	2	3	5	0	0	5	0	0
24	12749046	.	G	A	9	3	12	0	2	14	0	0
24	12754296	.	T	A	1	2	3	0	0	3	0	0
24	12966730	.	C	T	9	6	15	0	2	17	0	0
24	12966981	.	G	A	5	15	20	0	0	20	0	0
24	12967041	.	C	T	1	1	2	0	0	2	0	0
24	12967163	.	G	A	3	4	7	0	0	7	0	0
24	12970814	.	A	T	1	3	4	0	0	4	0	0
24	12981349	.	A	T	2	3	5	0	0	5	0	0
24	12981384	.	C	T	0	4	4	0	3	7	0	0
24	12983478	.	A	T	1	1	2	0	0	2	0	0
24	13015572	.	C	T	6	4	10	0	0	10	0	0
24	13015843	.	C	G	3	3	6	0	0	6	0	0
24	13023054	.	C	T	23	15	38	0	2	40	0	0
24	13026060	.	G	A	17	6	23	0	3	26	0	0
24	13026449	.	T	C	2	1	3	0	1	4	0	0
24	13101143	.	C	A	24	26	50	0	3	53	0	0
24	13229408	.	G	A	10	6	16	0	0	16	0	0
24	13239040	.	C	T	9	11	20	0	23	43	0	0
24	13239045	.	A	T	26	9	35	0	10	45	0	0
24	13239712	.	G	T	1	42	43	0	26	69	0	0
24	13239934	.	G	T	19	35	54	0	1	55	0	0
24	13239985	.	G	C	28	14	42	0	1	43	0	0
24	13251801	.	A	C	5	8	13	0	1	14	0	0
24	13251963	.	T	C	3	10	13	0	2	15	0	0
24	13255400	.	C	T	3	4	7	0	0	7	0	0
24	13271637	.	C	T	0	1	1	0	1	2	0	0
24	14233833	.	G	A	0	2	2	0	1	3	0	0
24	14233840	.	T	G	0	2	2	0	0	2	0	0
24	14234518	.	T	A	6	7	13	0	0	13	0	0
24	14234567	.	A	T	4	9	13	0	1	14	0	0
24	14234594	.	A	C	2	8	10	0	0	10	0	0
24	14385405	.	G	A	0	2	2	0	2	4	0	0
24	14385520	.	A	G	2	1	3	0	1	4	0	0
24	14385526	.	C	A	3	1	4	0	0	4	0	0
24	14385969	.	C	T	1	4	5	0	0	5	0	0
24	14385999	.	T	C	1	4	5	0	0	5	0	0
24	14443592	.	C	G	6	6	12	0	1	13	0	0
24	14542501	.	A	G	2	2	4	0	0	4	0	0
24	14550242	.	T	G	2	1	3	0	0	3	0	0
24	14550305	.	T	A	2	1	3	0	2	5	0	0
24	14550479	.	G	A	6	4	10	0	0	11	1	0
24	14550487	.	A	T	7	8	15	0	0	15	0	0
24	14550545	.	C	T	10	11	21	0	1	22	0	0
24	14559391	.	A	G	14	15	29	0	2	31	0	0
24	14560155	.	G	A	24	25	49	0	3	52	0	0
24	14568300	.	G	T	26	16	42	0	4	46	0	0
24	14575607	.	G	A	3	4	7	0	0	7	0	0
24	14576693	.	A	G	12	5	17	0	0	17	0	0
24	14576782	.	A	G	10	3	13	0	0	13	0	0
24	14577512	.	G	C	1	2	3	0	1	4	0	0
24	14597264	.	G	A	1	4	5	0	1	6	0	0
24	14597311	.	C	T	3	7	10	0	2	12	0	0
24	14597313	.	G	A	4	8	12	0	0	12	0	0
24	14600137	.	G	A	1	6	7	0	1	8	0	0
24	14713865	.	A	G	7	13	20	0	1	21	0	0
24	14713927	.	T	C	6	5	11	0	0	11	0	0
24	14718476	.	A	G	0	1	1	0	1	2	0	0
24	14725323	.	T	C	16	34	50	0	4	54	0	0
24	15061397	.	T	C	1	3	4	0	0	4	0	0
24	15061434	.	T	C	1	2	3	0	0	3	0	0
24	15061866	.	G	A	2	3	5	0	0	5	0	0
24	15124818	.	C	T	6	9	15	0	0	15	0	0
24	15124847	.	C	T	0	9	9	0	6	15	0	0
24	15124890	.	A	G	4	5	9	0	1	10	0	0
24	15127376	.	G	T	0	1	1	0	0	1	0	0
24	15127487	.	A	T	9	7	16	0	0	16	0	0
24	15127581	.	G	T	1	4	5	0	0	5	0	0
24	15137260	.	G	A	1	0	1	0	0	1	0	0
24	16162185	.	T	G	2	3	5	0	0	5	0	0
24	16612792	.	G	T	2	2	4	0	0	4	0	0
24	16612819	.	G	A	0	2	2	0	4	6	0	0
24	16615706	.	A	G	0	1	1	0	0	1	0	0
24	16630964	.	T	C	2	3	5	0	0	5	0	0
24	16646712	.	C	G	2	5	7	0	0	7	0	0
24	16646781	.	C	G	0	1	1	0	2	3	0	0
24	16685001	.	G	A	4	2	6	0	1	7	0	0
24	16696741	.	T	C	8	5	13	0	0	13	0	0
24	16702886	.	G	T	0	8	8	0	9	17	0	0
24	16705890	.	A	C	9	16	25	0	1	26	0	0
24	16705948	.	C	T	20	14	34	0	2	36	0	0
24	16705949	.	A	G	22	13	35	0	1	36	0	0
24	16706349	.	T	C	14	13	27	0	1	28	0	0
24	16905265	.	A	C	9	6	15	0	0	15	0	0
24	16905292	.	C	T	9	8	17	0	1	18	0	0
24	16908771	.	A	C	3	4	7	0	0	7	0	0
24	16908827	.	G	A	10	14	24	0	2	26	0	0
24	16908848	.	C	T	15	7	22	0	1	24	1	0
24	16908908	.	C	T	5	10	15	0	0	15	0	0
24	16911940	.	G	C	15	14	29	0	1	30	0	0
24	16911949	.	T	A	13	13	26	0	1	27	0	0
24	16912086	.	G	A	0	1	1	0	4	5	0	0
24	16912188	.	G	A	1	22	23	0	28	51	0	0
24	16912191	.	G	A	20	26	46	0	4	50	0	0
24	16912710	.	G	A	28	17	45	0	2	47	0	0
24	16913077	.	G	A	3	7	10	0	1	11	0	0
24	16913143	.	A	T	1	7	8	0	0	8	0	0
24	16913144	.	G	T	1	7	8	0	0	8	0	0
24	16914700	.	C	T	0	1	1	0	0	1	0	0
24	16914728	.	A	C	1	0	1	0	2	3	0	0
24	16915183	.	C	T	1	4	5	0	0	5	0	0
24	16964353	.	C	A	1	7	8	0	1	9	0	0
24	16964452	.	G	A	5	2	7	0	0	7	0	0
24	16964753	.	C	T	1	4	5	0	0	5	0	0
24	16964787	.	T	A	2	2	4	0	1	5	0	0
24	16964819	.	T	C	2	4	6	0	0	6	0	0
24	16964839	.	A	C	2	5	7	0	1	8	0	0
24	16964854	.	T	C	1	5	6	0	0	6	0	0
24	16964881	.	G	C	1	5	6	0	0	6	0	0
24	16964889	.	A	G	1	6	7	0	1	8	0	0
24	16964943	.	A	T	2	5	7	0	1	8	0	0
24	16965020	.	C	T	2	6	8	0	0	8	0	0
24	16965032	.	G	A	3	5	8	0	2	10	0	0
24	16965503	.	G	A	3	2	5	0	0	5	0	0
24	16965972	.	A	G	3	5	8	0	1	9	0	0
24	16966176	.	G	A	5	5	10	0	0	10	0	0
24	16966185	.	T	C	6	0	6	0	5	11	0	0
24	16966479	.	T	C	3	2	5	0	0	5	0	0
24	16968778	.	C	T	0	2	2	0	2	4	0	0
24	16992440	.	A	G	11	10	21	0	1	22	0	0
24	16992506	.	A	C	2	1	3	0	0	3	0	0
24	16999057	.	T	G	21	23	44	0	0	44	0	0
24	17010923	.	G	T	4	3	7	0	0	7	0	0
24	17016658	.	T	C	2	1	3	0	1	4	0	0
24	17017060	.	T	C	0	2	2	0	0	2	0	0
24	17019669	.	A	G	1	3	4	0	0	4	0	0
24	17022028	.	A	G	0	8	8	0	1	9	0	0
24	17022029	.	T	A	0	9	9	0	0	9	0	0
24	17027464	.	G	A	13	10	23	0	1	24	0	0
24	17027484	.	C	A	15	12	27	0	1	28	0	0
24	17028990	.	C	T	1	0	1	0	0	1	0	0
24	17040803	.	A	T	2	2	4	0	0	5	1	0
24	17042159	.	T	G	1	3	4	0	0	4	0	0
24	17124124	.	C	T	6	5	11	0	2	13	0	0
24	17124306	.	T	A	2	2	4	0	2	6	0	0
24	17125503	.	G	A	7	8	15	0	0	15	0	0
24	17126069	.	G	A	14	9	23	0	3	26	0	0
24	17126391	.	T	C	11	15	26	0	2	28	0	0
24	17126738	.	T	A	25	22	47	0	1	48	0	0
24	17136843	.	T	A	1	2	3	0	0	3	0	0
24	17214629	.	T	C	12	10	22	1	3	26	0	0
24	17214642	.	G	A	11	9	20	0	1	21	0	0
24	17214746	.	C	T	9	6	15	0	0	15	0	0
24	17214756	.	C	T	9	6	15	0	0	15	0	0
24	17258426	.	G	A	0	1	1	0	0	1	0	0
24	17258451	.	G	T	1	1	2	0	0	2	0	0
24	17266382	.	G	A	5	4	9	0	2	11	0	0
24	17266876	.	G	A	12	8	20	0	0	20	0	0
24	17276447	.	T	C	1	0	1	0	0	1	0	0
24	17352009	.	C	T	0	2	2	0	0	2	0	0
24	17352335	.	C	A	2	5	7	0	0	7	0	0
24	17360183	.	T	C	1	1	2	0	0	2	0	0
24	17363371	.	T	A	2	4	6	0	0	6	0	0
24	17364010	.	G	A	0	6	6	0	4	10	0	0
24	17365081	.	A	G	9	8	17	0	5	22	0	0
24	17368343	.	T	A	1	3	4	0	1	5	0	0
24	17368816	.	G	A	3	2	5	0	1	6	0	0
24	17372074	.	G	A	3	3	6	0	0	6	0	0
24	17377871	.	G	A	2	4	6	0	0	6	0	0
24	17377874	.	G	A	2	4	6	0	0	6	0	0
24	17378123	.	T	C	0	0	0	0	4	4	0	0
24	17389415	.	G	A	0	2	2	0	0	2	0	0
24	17410153	.	A	T	3	2	5	0	0	5	0	0
24	17417535	.	T	G	12	19	31	0	1	33	1	0
24	17417899	.	G	C	9	6	15	0	1	16	0	0
24	17417947	.	A	G	4	7	11	0	1	12	0	0
24	17418024	.	C	A	10	10	20	0	1	21	0	0
24	17418180	.	G	T	11	11	22	0	1	23	0	0
24	17418460	.	T	C	3	7	10	0	0	10	0	0
24	17418741	.	G	C	5	8	13	0	0	13	0	0
24	17418752	.	T	A	8	5	13	0	1	14	0	0
24	17418887	.	T	A	2	5	7	0	0	7	0	0
24	17418993	.	C	T	0	2	2	0	1	3	0	0
24	17420516	.	G	A	11	9	20	0	0	20	0	0
24	17420519	.	T	C	11	0	11	0	8	19	0	0
24	17420595	.	T	A	1	4	5	1	1	7	0	0
24	17421216	.	G	T	13	5	18	0	1	19	0	0
24	17421311	.	G	C	11	10	21	0	5	26	0	0
24	17465715	.	C	T	1	1	2	0	0	2	0	0
24	17465722	.	A	T	1	1	2	0	0	2	0	0
24	18444095	.	A	C	6	5	11	0	0	11	0	0
24	18444097	.	A	T	4	6	10	0	1	11	0	0
24	18444153	.	G	C	2	4	6	0	0	6	0	0
24	18444265	.	A	T	12	16	28	0	2	30	0	0
24	18444399	.	C	T	2	2	4	0	1	5	0	0
24	18444429	.	A	C	3	5	8	0	0	8	0	0
24	18444434	.	T	C	3	5	8	0	0	8	0	0
24	18445784	.	A	G	9	16	25	0	3	28	0	0
24	18446527	.	T	A	11	9	20	0	1	21	0	0
24	18446545	.	G	A	11	11	22	0	1	23	0	0
24	18521467	.	C	A	4	8	12	0	2	14	0	0
24	18549388	.	A	G	2	2	4	0	0	4	0	0
24	18549400	.	G	A	0	2	2	0	0	2	0	0
24	18553898	.	C	T	2	2	4	0	0	4	0	0
24	18557481	.	A	G	3	1	4	0	0	4	0	0
24	18563695	.	G	A	1	1	2	0	0	2	0	0
24	18599254	.	A	G	0	3	3	0	0	3	0	0
24	18684818	.	C	T	1	4	5	0	0	5	0	0
24	18709025	.	C	T	3	2	5	0	0	5	0	0
24	18711125	.	C	T	1	1	2	0	0	2	0	0
24	18714339	.	C	T	1	2	3	0	0	3	0	0
24	18724019	.	T	G	0	1	1	0	0	1	0	0
24	18731867	.	T	C	4	4	8	0	1	9	0	0
24	18737472	.	G	T	9	7	16	0	0	16	0	0
24	18746161	.	C	T	1	0	1	0	0	1	0	0
24	18750012	.	G	C	8	10	18	0	2	20	0	0
24	18751734	.	T	A	0	0	0	0	1	1	0	0
24	18751740	.	C	T	0	0	0	0	1	1	0	0
24	18751785	.	G	A	5	11	16	0	1	17	0	0
24	18751833	.	A	G	3	8	11	0	0	11	0	0
24	18752695	.	C	T	4	3	7	0	0	7	0	0
24	18769556	.	G	A	3	0	3	0	0	3	0	0
24	18777699	.	T	G	1	0	1	0	0	1	0	0
24	18782982	.	G	T	1	1	2	0	0	2	0	0
24	18783404	.	C	T	0	1	1	0	1	2	0	0
24	18783638	.	G	A	1	4	5	0	1	6	0	0
24	18794455	.	T	C	2	2	4	0	0	4	0	0
24	19402505	.	G	T	10	4	14	0	0	14	0	0
24	19402645	.	C	T	4	3	7	0	1	8	0	0
24	19586439	.	G	C	0	2	2	0	1	3	0	0
24	19692056	.	G	A	1	0	1	0	1	2	0	0
24	19696884	.	A	G	1	2	3	0	0	3	0	0
24	19707742	.	G	A	8	6	14	0	1	15	0	0
24	19707838	.	G	A	7	11	18	0	2	20	0	0
24	19708085	.	A	G	12	7	19	0	2	21	0	0
24	19708366	.	C	T	2	6	8	0	1	9	0	0
24	19708927	.	G	A	4	4	8	0	0	8	0	0
24	19709272	.	C	A	2	4	6	0	1	7	0	0
24	19719122	.	G	A	5	2	7	0	1	8	0	0
24	20064504	.	G	A	4	2	6	0	0	6	0	0
24	20064844	.	A	G	5	6	11	0	0	11	0	0
24	20064892	.	G	A	3	8	11	0	1	12	0	0
24	20064924	.	A	G	3	3	6	0	0	6	0	0
24	20065156	.	C	A	0	3	3	0	3	6	0	0
24	20065236	.	T	C	2	7	9	0	0	9	0	0
24	20065366	.	T	G	2	3	5	0	1	6	0	0
24	20065375	.	T	A	2	3	5	0	1	6	0	0
24	20065733	.	T	C	1	3	4	0	0	4	0	0
24	20066002	.	G	A	4	3	7	0	1	8	0	0
24	20066021	.	T	C	1	3	4	0	4	8	0	0
24	20066250	.	T	C	2	2	4	0	0	4	0	0
24	20072399	.	G	A	0	2	2	0	0	2	0	0
24	20072405	.	G	A	0	2	2	0	0	2	0	0
24	20328430	.	C	T	3	0	3	0	0	3	0	0
24	20334326	.	T	G	1	2	3	0	3	6	0	0
24	20334386	.	C	T	1	1	2	0	0	2	0	0
24	20335825	.	C	G	2	1	3	0	1	4	0	0
24	20335858	.	C	A	2	3	5	0	0	5	0	0
24	20335869	.	T	C	0	1	1	0	1	2	0	0
24	20336686	.	T	C	1	3	4	0	0	4	0	0
24	20336784	.	G	A	0	1	1	0	0	1	0	0
24	20450270	.	G	C	5	6	11	0	2	13	0	0
24	20450417	.	C	G	7	5	12	0	0	14	2	0
24	20450424	.	A	T	6	6	12	0	1	13	0	0
24	20450467	.	C	G	7	3	10	0	0	10	0	0
24	20450475	.	G	A	3	7	10	0	0	10	0	0
24	20450536	.	C	T	3	7	10	0	0	10	0	0
24	20450766	.	G	A	18	18	36	0	3	39	0	0
24	20501159	.	G	A	3	3	6	0	0	6	0	0
24	20531566	.	C	T	3	7	10	0	1	11	0	0
24	20531692	.	C	A	1	3	4	0	0	4	0	0
24	20542907	.	G	A	1	4	5	0	0	5	0	0
24	20542909	.	C	T	1	3	4	0	1	5	0	0
24	20552393	.	A	T	3	7	10	0	1	11	0	0
24	20552578	.	A	C	7	5	12	0	0	12	0	0
24	20554857	.	G	T	13	9	22	0	3	25	0	0
24	20554858	.	T	G	14	9	23	0	1	25	1	0
24	20643765	.	T	C	5	5	10	0	0	10	0	0
24	20644063	.	A	C	6	5	11	0	6	17	0	0
24	20644123	.	A	C	11	11	22	0	0	22	0	0
24	20644356	.	C	T	6	3	9	0	1	10	0	0
24	20644685	.	C	T	0	2	2	0	1	3	0	0
24	20646270	.	T	A	12	10	22	0	0	22	0	0
24	20646289	.	T	A	8	8	16	0	0	16	0	0
24	20647394	.	C	T	10	4	14	0	0	14	0	0
24	20647423	.	G	T	6	8	14	0	0	14	0	0
24	20648942	.	C	T	1	3	4	0	0	4	0	0
24	20648945	.	T	C	2	1	3	0	1	4	0	0
24	20658386	.	C	A	1	1	2	0	0	2	0	0
24	20893389	.	A	G	1	3	4	0	0	4	0	0
24	20897011	.	T	A	1	3	4	0	0	4	0	0
24	20900211	.	C	A	1	1	2	0	0	2	0	0
24	20912070	.	A	T	0	1	1	0	0	1	0	0
24	20912076	.	G	A	0	1	1	0	0	1	0	0
24	20920648	.	G	C	0	13	13	0	1	14	0	0
24	20921594	.	C	T	6	6	12	0	0	12	0	0
24	20922603	.	C	T	1	2	3	0	0	3	0	0
24	20941687	.	A	G	19	19	38	0	2	40	0	0
24	20941789	.	A	G	19	21	40	0	2	42	0	0
24	20942281	.	G	A	15	12	27	0	1	28	0	0
24	20942541	.	G	T	17	15	32	0	4	36	0	0
24	20946263	.	G	A	2	4	6	0	1	7	0	0
24	20946305	.	C	T	9	12	21	0	0	21	0	0
24	20948122	.	C	T	8	11	19	0	1	20	0	0
24	20948330	.	G	A	2	0	2	0	0	2	0	0
24	20949494	.	A	G	6	9	15	0	0	15	0	0
24	20953045	.	C	T	0	2	2	0	0	2	0	0
24	20980197	.	C	T	1	0	1	0	0	1	0	0
24	20987732	.	C	T	5	9	14	0	0	14	0	0
24	21005546	.	C	T	2	2	4	0	0	4	0	0
24	21005729	.	A	G	8	8	16	0	2	18	0	0
24	21005973	.	A	T	8	8	16	0	1	17	0	0
24	21060365	.	G	A	1	2	3	0	1	4	0	0
24	21119452	.	C	G	1	1	2	0	0	2	0	0
24	21154160	.	G	A	10	8	18	0	1	19	0	0
24	21154165	.	G	A	12	9	21	0	0	21	0	0
24	21154586	.	T	C	27	24	51	0	4	55	0	0
24	21157661	.	G	A	7	2	9	0	0	9	0	0
24	21167389	.	A	G	5	0	5	0	0	5	0	0
24	21167443	.	G	A	11	2	13	0	2	15	0	0
24	21167446	.	G	A	11	2	13	0	2	15	0	0
24	21167660	.	G	A	0	4	4	0	0	4	0	0
24	21167720	.	G	A	2	2	4	0	0	4	0	0
24	21182156	.	A	G	1	2	3	0	0	3	0	0
24	21182783	.	C	T	10	7	17	0	7	24	0	0
24	21183047	.	A	C	6	4	10	0	0	10	0	0
24	21183290	.	A	C	18	16	34	0	4	38	0	0
24	21183474	.	G	A	5	4	9	0	1	10	0	0
24	21200926	.	C	T	2	4	6	0	1	7	0	0
24	21200953	.	C	G	2	4	6	0	0	6	0	0
24	21201500	.	G	T	0	11	11	0	7	18	0	0
24	21201506	.	T	C	5	9	14	0	2	16	0	0
24	21201830	.	A	T	8	10	18	0	0	19	1	0
24	21201860	.	G	A	0	8	8	0	9	17	0	0
24	21202225	.	C	T	6	5	11	0	0	11	0	0
24	21202256	.	G	T	5	2	7	0	1	8	0	0
24	21206352	.	G	T	4	3	7	0	0	7	0	0
24	21206527	.	C	A	1	2	3	0	0	3	0	0
24	21371345	.	C	T	0	13	13	0	8	21	0	0
24	21371481	.	T	C	22	17	39	0	1	40	0	0
24	21371520	.	G	C	23	20	43	0	3	46	0	0
24	21371547	.	T	C	19	27	46	0	4	50	0	0
24	21371599	.	C	T	24	24	48	0	4	52	0	0
24	21371833	.	A	T	21	24	45	0	2	47	0	0
24	21372208	.	G	T	0	3	3	0	0	3	0	0
24	21382737	.	C	A	5	1	6	0	1	7	0	0
24	21411463	.	G	A	3	4	7	0	0	7	0	0
24	21411834	.	G	T	0	7	7	0	0	7	0	0
24	21411876	.	T	A	12	3	15	0	1	16	0	0
24	21417797	.	C	T	0	5	5	0	7	12	0	0
24	21417872	.	C	T	1	1	2	0	1	3	0	0
24	21498770	.	G	A	2	1	3	0	0	3	0	0
24	21501990	.	C	G	5	5	10	0	2	12	0	0
24	21502305	.	A	G	10	13	23	0	2	25	0	0
24	21502762	.	T	A	8	5	13	0	1	14	0	0
24	21502842	.	T	A	8	5	13	0	1	14	0	0
24	21502880	.	G	T	7	8	15	0	2	18	1	0
24	21503350	.	C	T	3	3	6	0	0	6	0	0
24	21503575	.	A	G	1	3	4	0	0	4	0	0
24	21503682	.	C	T	1	3	4	0	1	5	0	0
24	21503694	.	C	G	2	2	4	0	1	5	0	0
24	21503748	.	T	C	5	2	7	0	2	9	0	0
24	21503816	.	T	C	1	3	4	0	0	4	0	0
24	21504785	.	A	G	1	3	4	0	0	4	0	0
24	21504860	.	G	T	1	2	3	0	1	4	0	0
24	21505178	.	A	C	1	3	4	0	0	4	0	0
24	21538568	.	A	C	16	10	26	0	1	27	0	0
24	21538982	.	T	A	12	15	27	0	1	28	0	0
24	21539131	.	T	G	12	6	18	0	0	18	0	0
24	21561074	.	C	T	0	2	2	0	0	2	0	0
24	21568808	.	T	A	1	4	5	0	0	5	0	0
24	21572604	.	G	T	3	4	7	0	0	7	0	0
24	21575273	.	T	A	1	0	1	0	0	1	0	0
24	21575311	.	G	C	6	5	11	0	0	11	0	0
24	21575372	.	G	A	8	6	14	0	1	15	0	0
24	21577239	.	G	A	0	2	2	0	0	2	0	0
24	21577394	.	C	A	7	13	20	0	1	21	0	0
24	21577573	.	T	G	6	7	13	0	0	13	0	0
24	21577638	.	A	G	7	6	13	0	0	13	0	0
24	21584231	.	T	A	1	2	3	0	0	3	0	0
24	21625149	.	C	T	24	26	50	0	8	58	0	0
24	21650034	.	T	A	9	7	16	0	1	17	0	0
24	21650088	.	G	A	10	13	23	0	2	25	0	0
24	21657606	.	T	C	13	6	19	0	1	20	0	0
24	21659792	.	C	T	0	5	5	0	5	10	0	0
24	21659819	.	G	A	7	9	16	0	4	20	0	0
24	21659864	.	A	T	4	8	12	0	1	13	0	0
24	21671381	.	A	G	2	6	8	0	0	8	0	0
24	21671387	.	G	A	6	2	8	0	0	8	0	0
24	21671506	.	G	A	8	6	14	0	0	14	0	0
24	21679971	.	G	A	4	4	8	0	0	8	0	0
24	21680010	.	G	A	0	8	8	0	8	16	0	0
24	21680143	.	T	C	6	5	11	0	4	15	0	0
24	21680252	.	G	T	1	1	2	0	0	2	0	0
24	21680610	.	G	T	2	4	6	0	0	6	0	0
24	21680661	.	T	G	2	3	5	0	0	5	0	0
24	21680811	.	C	G	3	6	9	0	0	9	0	0
24	21680970	.	A	C	3	10	13	0	0	13	0	0
24	21681074	.	G	T	3	5	8	0	2	10	0	0
24	21681112	.	T	A	4	4	8	0	0	8	0	0
24	21735379	.	G	A	2	5	7	0	0	7	0	0
24	21735466	.	A	G	1	2	3	0	0	3	0	0
24	21738430	.	T	C	1	3	4	0	0	4	0	0
24	21744200	.	C	T	3	3	6	0	1	7	0	0
24	21744239	.	G	A	0	2	2	0	6	8	0	0
24	21744266	.	A	G	2	2	4	0	0	4	0	0
24	21747316	.	T	G	0	4	4	0	0	4	0	0
24	21747325	.	T	C	0	3	3	0	1	4	0	0
24	21747368	.	T	C	4	4	8	0	2	10	0	0
24	21747376	.	C	T	3	5	8	0	2	10	0	0
24	21747550	.	G	T	5	5	10	0	1	11	0	0
24	21747672	.	G	A	0	8	8	0	4	12	0	0
24	21748249	.	T	C	19	11	30	0	2	32	0	0
24	21780981	.	A	G	3	2	5	0	0	5	0	0
24	21781146	.	A	G	2	3	5	0	0	5	0	0
24	21917654	.	C	G	0	1	1	0	5	6	0	0
24	21917704	.	G	C	3	4	7	0	2	9	0	0
24	21917777	.	C	A	8	1	9	0	2	11	0	0
24	21920915	.	A	G	2	3	5	0	0	5	0	0
24	21920918	.	T	G	2	2	4	0	0	4	0	0
24	21927377	.	T	C	3	2	5	0	0	5	0	0
24	21927638	.	G	A	3	3	6	0	2	8	0	0
24	21927720	.	T	G	2	3	5	0	0	5	0	0
24	21960358	.	C	G	1	11	12	0	0	12	0	0
24	21960538	.	A	G	3	6	9	0	0	9	0	0
24	21960546	.	C	G	8	3	11	0	0	11	0	0
24	21978394	.	T	C	3	3	6	0	1	7	0	0
24	21978470	.	A	G	8	13	21	0	1	22	0	0
24	21978524	.	C	T	11	9	20	0	1	21	0	0
24	21978593	.	T	C	9	0	9	0	14	23	0	0
24	21978805	.	T	C	13	8	21	2	3	26	0	0
24	21984192	.	C	A	0	1	1	0	0	1	0	0
24	21984256	.	C	A	0	5	5	0	2	7	0	0
24	22070389	.	T	A	5	7	12	0	1	13	0	0
24	22070477	.	A	G	4	10	14	0	0	14	0	0
24	22070877	.	G	A	1	6	7	0	3	10	0	0
24	22070878	.	A	G	4	3	7	0	3	10	0	0
24	22071174	.	C	T	2	2	4	0	0	4	0	0
24	22071371	.	G	A	6	2	8	0	3	11	0	0
24	22071556	.	G	C	5	1	6	0	10	16	0	0
24	22071649	.	G	T	23	17	40	0	3	43	0	0
24	22100861	.	G	C	5	3	8	0	1	9	0	0
24	22122279	.	C	G	0	2	2	0	1	3	0	0
24	22122823	.	A	C	11	6	17	0	1	18	0	0
24	22122827	.	A	C	13	4	17	0	1	18	0	0
24	22122929	.	G	A	11	18	29	0	5	34	0	0
24	22123024	.	G	A	12	4	16	0	2	18	0	0
24	22123115	.	C	T	0	12	12	0	9	21	0	0
24	22123176	.	T	A	12	8	20	0	3	23	0	0
24	22123434	.	G	C	13	11	24	0	2	26	0	0
24	22123640	.	A	G	11	14	25	0	0	25	0	0
24	22123784	.	T	A	11	16	27	0	4	31	0	0
24	22123927	.	A	C	9	0	9	0	17	26	0	0
24	22123930	.	G	T	8	11	19	0	6	25	0	0
24	22174471	.	A	G	1	3	4	0	1	5	0	0
24	22219741	.	C	T	3	4	7	0	0	7	0	0
24	22219792	.	G	A	5	11	16	0	0	16	0	0
24	22275400	.	C	T	0	4	4	0	0	4	0	0
24	22275403	.	A	T	0	4	4	0	0	4	0	0
24	22740552	.	T	C	4	4	8	0	0	8	0	0
24	22740553	.	T	C	4	4	8	0	0	8	0	0
24	22740589	.	T	C	5	10	15	0	1	16	0	0
24	22740772	.	T	A	3	5	8	0	2	10	0	0
24	22744460	.	C	T	4	3	7	0	0	7	0	0
24	22744487	.	C	T	4	4	8	0	0	8	0	0
24	22744502	.	A	G	3	4	7	0	1	8	0	0
24	22746843	.	T	G	3	3	6	0	2	8	0	0
24	22759703	.	C	T	12	10	22	0	2	24	0	0
24	22769484	.	C	T	7	3	10	0	1	11	0	0
24	23214125	.	G	A	0	2	2	0	1	3	0	0
24	23214154	.	G	A	0	2	2	0	2	4	0	0
24	23243116	.	T	C	9	0	9	0	16	25	0	0
24	23243257	.	A	G	3	2	5	0	1	6	0	0
24	23243872	.	A	T	11	4	15	0	1	16	0	0
24	23243946	.	C	A	8	5	13	0	1	14	0	0
24	23243947	.	A	C	10	4	14	0	0	14	0	0
24	23244161	.	T	A	10	9	19	0	1	20	0	0
24	23687836	.	C	T	0	3	3	0	1	4	0	0
24	23687961	.	A	G	1	0	1	0	0	1	0	0
24	23717064	.	C	G	2	2	4	0	0	4	0	0
24	23717079	.	T	G	2	3	5	0	0	5	0	0
24	23720091	.	G	A	5	6	11	0	0	11	0	0
24	23723983	.	G	A	4	6	10	0	0	10	0	0
24	23758880	.	A	C	5	2	7	0	1	8	0	0
24	23759505	.	A	G	4	3	7	0	0	7	0	0
24	23759679	.	G	A	6	4	10	0	3	13	0	0
24	23759787	.	T	G	1	2	3	0	0	3	0	0
24	23760291	.	A	G	1	0	1	0	1	2	0	0
24	23768788	.	G	A	2	1	3	0	0	3	0	0
24	23838469	.	C	A	0	6	6	0	1	7	0	0
24	23838535	.	T	A	9	3	12	0	0	12	0	0
24	23838823	.	C	T	10	5	15	0	1	16	0	0
24	23839088	.	C	T	11	4	15	0	1	16	0	0
24	23839303	.	A	G	2	2	4	0	1	5	0	0
24	23839342	.	T	C	5	3	8	0	2	10	0	0
24	23839600	.	A	G	10	7	17	0	0	17	0	0
24	23884402	.	G	A	0	2	2	0	0	2	0	0
24	23937985	.	C	T	4	2	6	0	0	6	0	0
24	23970809	.	A	G	1	0	1	0	0	1	0	0
24	23971151	.	C	G	14	18	32	0	0	32	0	0
24	23971205	.	T	C	5	8	13	0	0	13	0	0
24	23974411	.	C	T	21	32	53	0	3	56	0	0
24	23974484	.	C	T	0	18	18	0	17	35	0	0
24	24027990	.	A	T	8	9	17	0	0	17	0	0
24	24028059	.	T	A	13	14	27	0	0	27	0	0
24	24102026	.	C	T	1	7	8	0	8	16	0	0
24	24102190	.	A	T	22	17	39	0	1	40	0	0
24	24102318	.	A	C	19	28	47	0	2	50	1	0
24	24108653	.	T	C	6	9	15	0	2	17	0	0
24	24110935	.	C	T	9	7	16	0	0	16	0	0
24	24111470	.	G	A	4	10	14	0	0	14	0	0
24	24111587	.	G	T	1	2	3	0	1	4	0	0
24	24114272	.	G	C	6	9	15	0	1	16	0	0
24	24114424	.	C	T	1	7	8	0	3	11	0	0
24	24114447	.	A	G	6	7	13	0	0	13	0	0
24	24114810	.	A	C	5	6	11	0	1	12	0	0
24	24115352	.	T	G	4	5	9	0	0	9	0	0
24	24115485	.	C	G	0	3	3	0	5	8	0	0
24	24115602	.	A	G	4	3	7	0	4	11	0	0
24	24115626	.	G	T	3	5	8	0	0	8	0	0
24	24118304	.	A	G	6	3	9	0	0	9	0	0
24	24121282	.	C	G	1	23	24	0	20	44	0	0
24	24121502	.	T	A	12	9	21	0	0	21	0	0
24	24121568	.	C	T	14	13	27	0	7	34	0	0
24	24121582	.	T	C	15	0	15	0	19	34	0	0
24	24122040	.	G	A	0	4	4	0	0	4	0	0
24	24129728	.	C	T	13	14	27	0	1	28	0	0
24	24130794	.	A	G	21	28	49	0	3	52	0	0
24	24130824	.	T	C	22	24	46	0	1	47	0	0
24	24136047	.	T	G	15	17	32	0	5	37	0	0
24	24146669	.	T	C	11	0	11	0	12	23	0	0
24	24146815	.	T	A	4	5	9	0	0	9	0	0
24	24155607	.	G	A	0	2	2	0	1	3	0	0
24	24155655	.	A	G	8	7	15	0	0	15	0	0
24	24155664	.	C	A	7	7	14	0	0	14	0	0
24	24155718	.	A	T	1	0	1	0	0	1	0	0
24	24164278	.	C	A	8	4	12	0	0	12	0	0
24	24164770	.	G	A	11	9	20	0	4	24	0	0
24	24164812	.	A	T	4	15	19	0	3	22	0	0
24	24165563	.	G	T	6	8	14	0	0	14	0	0
24	24168359	.	G	C	12	13	25	0	1	26	0	0
24	24171315	.	G	T	1	2	3	0	0	3	0	0
24	24174889	.	T	C	2	2	4	0	0	4	0	0
24	24175497	.	G	T	2	3	5	0	0	5	0	0
24	24175614	.	T	A	1	2	3	0	0	3	0	0
24	24177010	.	G	A	1	1	2	0	0	2	0	0
24	24177024	.	T	C	1	8	9	0	0	9	0	0
24	24177080	.	G	A	4	11	15	0	1	16	0	0
24	24177200	.	G	T	8	8	16	0	0	16	0	0
24	24177213	.	G	C	7	8	15	0	0	15	0	0
24	24177357	.	G	C	1	3	4	0	1	5	0	0
24	24177367	.	C	T	1	4	5	0	0	5	0	0
24	24183974	.	T	C	2	2	4	0	0	4	0	0
24	24183996	.	C	T	1	3	4	0	1	5	0	0
24	24273912	.	T	G	1	3	4	0	0	4	0	0
24	24287980	.	T	C	1	2	3	0	0	3	0	0
24	24288004	.	T	C	2	3	5	0	0	5	0	0
24	24288223	.	T	C	2	7	9	0	0	9	0	0
24	24299421	.	G	A	0	4	4	0	3	7	0	0
24	24299597	.	T	C	5	7	12	0	0	12	0	0
24	24300125	.	C	T	2	3	5	0	0	5	0	0
24	24417214	.	C	T	0	2	2	0	1	3	0	0
24	24462036	.	G	C	1	8	9	0	5	14	0	0
24	24462081	.	C	T	2	9	11	0	0	11	0	0
24	24463212	.	T	A	20	20	40	0	2	42	0	0
24	25348187	.	C	A	1	5	6	0	0	6	0	0
24	25351368	.	A	T	2	3	5	0	1	6	0	0
24	25352109	.	G	A	4	3	7	0	0	7	0	0
24	25448374	.	G	A	3	4	7	0	0	7	0	0
24	25448475	.	C	T	5	3	8	0	0	8	0	0
24	25448741	.	T	C	2	9	11	0	1	12	0	0
24	25449245	.	A	C	3	6	9	0	0	9	0	0
24	25449319	.	G	A	4	2	6	0	1	7	0	0
24	25452620	.	G	A	2	5	7	0	0	7	0	0
24	25455160	.	T	C	1	1	2	0	0	2	0	0
24	25496194	.	A	C	1	3	4	0	0	4	0	0
24	25496215	.	T	G	1	3	4	0	0	4	0	0
24	25496336	.	G	C	1	3	4	0	0	4	0	0
24	25496435	.	T	C	3	2	5	0	1	6	0	0
24	25496590	.	T	C	2	2	4	0	1	5	0	0
24	25496789	.	T	C	6	5	11	0	0	11	0	0
24	25497036	.	A	T	4	5	9	0	0	9	0	0
24	25497102	.	C	G	7	5	12	0	0	12	0	0
24	25497189	.	G	A	5	6	11	0	0	11	0	0
24	25497236	.	A	C	3	4	7	0	2	9	0	0
24	25497273	.	A	T	1	4	5	0	1	6	0	0
24	25497412	.	C	A	2	4	6	0	0	6	0	0
24	25497414	.	A	T	2	4	6	0	0	6	0	0
24	25497477	.	G	T	6	6	12	0	1	13	0	0
24	25497680	.	G	T	6	9	15	0	1	16	0	0
24	25498687	.	T	C	2	2	4	0	1	5	0	0
24	25498766	.	C	A	2	2	4	0	0	4	0	0
24	25498880	.	G	T	2	2	4	0	0	4	0	0
24	25514767	.	T	A	4	1	5	0	0	5	0	0
24	25514777	.	A	T	2	1	3	0	1	4	0	0
24	25526192	.	C	A	0	2	2	0	0	2	0	0
24	26475383	.	C	G	9	12	21	0	0	21	0	0
24	26478889	.	C	T	0	5	5	0	7	12	0	0
24	26482097	.	A	G	17	27	44	0	5	49	0	0
24	26482133	.	C	A	30	27	57	0	0	57	0	0
24	26492905	.	G	T	2	3	5	0	0	5	0	0
24	26493029	.	T	G	7	4	11	0	0	11	0	0
24	26493077	.	T	C	6	0	6	0	6	12	0	0
24	26493302	.	G	A	2	4	6	0	0	6	0	0
24	26493312	.	A	C	2	4	6	0	0	6	0	0
24	26493542	.	C	A	8	11	19	0	1	20	0	0
24	26493690	.	G	T	2	10	12	0	0	12	0	0
24	26493715	.	C	T	2	6	8	0	1	9	0	0
24	26494077	.	C	A	3	6	9	0	1	10	0	0
24	26508844	.	A	G	2	4	6	0	0	6	0	0
24	26516788	.	C	T	1	1	2	0	0	2	0	0
24	26662814	.	C	T	1	4	5	0	0	5	0	0
24	26663232	.	A	T	2	5	7	0	0	7	0	0
24	26663381	.	C	T	0	2	2	0	3	5	0	0
24	26663696	.	G	T	1	2	3	0	0	3	0	0
24	26663842	.	G	C	2	3	5	0	0	5	0	0
24	26895836	.	T	G	2	2	4	0	0	4	0	0
24	26901589	.	A	G	1	2	3	0	0	3	0	0
24	26901647	.	T	C	1	3	4	0	0	4	0	0
24	26902269	.	G	A	2	2	4	0	0	4	0	0
24	26936809	.	T	C	1	2	3	0	0	3	0	0
24	26936839	.	T	C	1	3	4	0	0	4	0	0
24	26936846	.	G	A	2	3	5	0	0	5	0	0
24	26941493	.	T	G	8	7	15	0	0	15	0	0
24	26941713	.	C	T	9	11	20	0	2	22	0	0
24	26942614	.	C	T	0	7	7	0	14	21	0	0
24	26942711	.	T	C	6	8	14	0	0	14	0	0
24	26942880	.	A	T	7	7	14	0	4	18	0	0
24	26942989	.	G	A	3	9	12	0	0	12	0	0
24	26943103	.	C	G	6	5	11	0	1	12	0	0
24	26943148	.	C	T	5	6	11	0	0	11	0	0
24	26945274	.	T	A	4	3	7	0	0	7	0	0
24	26949412	.	C	T	3	4	7	0	0	7	0	0
24	26949606	.	T	C	5	6	11	0	1	12	0	0
24	26958347	.	A	G	4	5	9	0	0	9	0	0
24	26958365	.	T	A	5	6	11	0	0	11	0	0
24	26959816	.	G	A	2	2	4	0	1	5	0	0
24	26961917	.	A	G	0	1	1	0	0	1	0	0
24	26964659	.	C	T	2	2	4	0	0	4	0	0
24	26964935	.	A	C	1	2	3	0	0	3	0	0
24	27014011	.	C	T	3	0	3	0	0	3	0	0
24	27019276	.	C	T	4	5	9	0	1	10	0	0
24	27019523	.	T	A	3	6	9	0	0	9	0	0
24	27176102	.	C	T	1	1	2	0	0	2	0	0
24	27185859	.	T	A	1	1	2	0	0	2	0	0
24	27222610	.	A	C	6	9	15	0	1	16	0	0
24	27222937	.	G	A	0	10	10	0	6	16	0	0
24	27224484	.	A	T	11	19	30	0	7	37	0	0
24	27224842	.	G	A	13	12	25	0	3	28	0	0
24	27224990	.	G	A	23	14	37	0	2	39	0	0
24	27225238	.	C	T	0	14	14	0	12	26	0	0
24	27225342	.	G	A	17	19	36	0	1	37	0	0
24	27225675	.	T	A	17	13	30	0	1	32	1	0
24	27225693	.	A	G	16	16	32	0	2	34	0	0
24	27225842	.	A	G	13	12	25	0	1	26	0	0
24	27225859	.	C	G	10	9	19	0	1	20	0	0
24	27225960	.	G	A	11	8	19	0	0	19	0	0
24	27226044	.	A	G	5	4	9	0	0	9	0	0
24	27226368	.	C	T	5	4	9	0	2	11	0	0
24	27226469	.	T	G	2	0	2	0	19	21	0	0
24	27226472	.	G	C	5	0	5	0	19	24	0	0
24	27238527	.	G	A	2	0	2	0	0	2	0	0
24	27346792	.	C	T	1	2	3	0	1	4	0	0
24	27346819	.	G	A	2	4	6	0	0	6	0	0
24	27346837	.	C	T	3	5	8	0	0	8	0	0
24	27399940	.	G	A	3	3	6	0	0	6	0	0
24	27399969	.	T	C	3	2	5	0	1	6	0	0
24	27714717	.	A	G	1	3	4	0	0	4	0	0
24	27784348	.	C	T	0	2	2	0	0	2	0	0
24	27784444	.	G	A	4	2	6	0	0	6	0	0
24	28240609	.	T	C	0	0	0	0	1	1	0	0
24	28252605	.	C	T	11	6	17	0	1	18	0	0
24	28253782	.	A	T	16	13	29	0	1	30	0	0
24	28259128	.	C	T	8	2	10	0	0	10	0	0
24	28263850	.	G	A	0	0	0	0	1	1	0	0
24	28263856	.	G	C	1	0	1	0	1	2	0	0
24	28263964	.	G	A	2	1	3	0	0	3	0	0
24	28293347	.	C	T	0	2	2	0	1	3	0	0
24	28312359	.	G	A	1	4	5	0	0	5	0	0
24	28312431	.	G	A	3	5	8	0	0	8	0	0
24	28312460	.	A	T	1	3	4	0	0	4	0	0
24	28365152	.	G	A	0	1	1	0	0	1	0	0
24	28381351	.	C	A	2	3	5	0	0	5	0	0
24	28394446	.	G	T	1	2	3	0	1	4	0	0
24	28394461	.	A	T	1	2	3	0	0	3	0	0
24	28426131	.	A	T	4	5	9	0	2	11	0	0
24	28426363	.	T	G	26	20	46	0	3	49	0	0
24	28426705	.	T	A	21	13	34	0	2	36	0	0
24	28426717	.	C	T	0	13	13	0	21	34	0	0
24	28432297	.	A	C	18	21	39	0	1	40	0	0
24	28432372	.	G	A	16	16	32	0	1	33	0	0
24	28437405	.	G	A	16	21	37	0	1	38	0	0
24	28437681	.	C	T	7	11	18	0	0	18	0	0
24	28686815	.	C	T	0	4	4	0	8	12	0	0
24	28686864	.	T	A	4	3	7	0	0	7	0	0
24	28687245	.	A	C	6	0	6	0	2	8	0	0
24	28687253	.	G	A	7	4	11	0	0	11	0	0
24	28687576	.	A	G	8	11	19	0	1	20	0	0
24	28687783	.	G	T	9	11	20	0	0	20	0	0
24	28688104	.	G	A	6	6	12	0	1	13	0	0
24	28691389	.	C	T	2	3	5	0	1	6	0	0
24	28691457	.	C	T	0	5	5	0	3	8	0	0
24	28710953	.	G	A	2	2	4	0	0	4	0	0
24	28764251	.	A	C	2	3	5	0	0	5	0	0
24	28949511	.	G	A	2	2	4	0	0	4	0	0
24	28953040	.	C	A	4	6	10	0	1	11	0	0
24	28963133	.	C	T	8	8	16	0	1	17	0	0
24	28963445	.	C	T	1	1	2	0	0	2	0	0
24	28965578	.	G	A	1	4	5	0	0	5	0	0
24	28966068	.	T	A	3	3	6	0	0	6	0	0
24	28966088	.	A	T	5	2	7	0	0	7	0	0
24	28966810	.	T	C	3	7	10	0	1	11	0	0
24	28966812	.	T	G	3	8	11	0	0	11	0	0
24	28966873	.	C	A	6	4	10	0	0	10	0	0
24	28966892	.	T	C	3	4	7	0	0	7	0	0
24	29353048	.	C	T	1	6	7	0	0	7	0	0
24	29382153	.	T	A	3	3	6	0	0	6	0	0
24	29382235	.	T	C	4	4	8	0	1	9	0	0
24	29450183	.	C	T	8	2	10	0	3	13	0	0
24	29525071	.	C	T	11	12	23	0	0	23	0	0
24	29525262	.	T	C	9	12	21	0	1	22	0	0
24	29961904	.	C	G	1	2	3	0	0	3	0	0
24	29997145	.	A	T	10	0	10	0	0	10	0	0
24	30053987	.	C	T	0	4	4	0	2	6	0	0
24	30054147	.	A	C	2	2	4	0	0	4	0	0
24	30054152	.	T	A	2	2	4	0	0	4	0	0
24	30835992	.	G	T	3	4	7	0	2	9	0	0
24	30836042	.	C	T	5	4	9	0	0	9	0	0
24	30837682	.	G	C	7	5	12	0	0	12	0	0
24	31082078	.	A	G	6	7	13	0	1	14	0	0
24	31082758	.	A	T	6	4	10	0	0	10	0	0
24	31082774	.	C	A	4	4	8	0	0	8	0	0
24	31098655	.	C	A	7	6	13	0	0	13	0	0
24	31098720	.	A	G	9	4	13	0	0	13	0	0
24	31098820	.	A	G	4	4	8	0	1	9	0	0
24	31098874	.	G	T	1	4	5	0	0	5	0	0
24	31140251	.	A	G	2	3	5	0	0	5	0	0
24	31140269	.	C	T	3	4	7	0	0	7	0	0
24	31140293	.	G	A	3	3	6	0	0	6	0	0
24	31170558	.	T	A	6	13	19	0	0	19	0	0
24	31170751	.	A	T	5	1	6	0	0	6	0	0
24	31171285	.	G	A	4	5	9	0	0	9	0	0
24	31171417	.	G	A	4	3	7	0	0	7	0	0
24	31171468	.	A	T	1	2	3	0	0	3	0	0
24	31174152	.	A	G	1	1	2	0	0	2	0	0
24	31310849	.	T	A	7	8	15	0	1	16	0	0
24	31310981	.	T	G	9	6	15	0	1	16	0	0
24	31311087	.	G	A	10	12	22	0	0	22	0	0
24	31311110	.	T	A	11	14	25	0	0	25	0	0
24	31311137	.	A	G	9	9	18	0	1	19	0	0
24	31315500	.	A	G	5	2	7	0	0	7	0	0
24	31319544	.	T	C	0	1	1	0	0	1	0	0
24	31320006	.	A	G	0	1	1	0	0	1	0	0
24	31322920	.	A	G	0	2	2	0	0	2	0	0
24	31334313	.	A	G	12	6	18	0	3	21	0	0
24	31340562	.	A	C	3	2	5	0	1	6	0	0
24	31340610	.	C	G	14	1	15	0	27	42	0	0
24	31340673	.	T	C	6	6	12	0	3	15	0	0
24	31342773	.	A	C	1	2	3	0	0	3	0	0
24	31367533	.	T	C	4	3	7	0	1	8	0	0
24	31367612	.	C	T	2	5	7	0	0	7	0	0
24	31379390	.	A	G	2	3	5	0	0	5	0	0
24	31379402	.	G	C	1	3	4	0	0	4	0	0
24	31397840	.	G	A	1	7	8	0	1	9	0	0
24	31398002	.	A	G	2	0	2	0	1	3	0	0
24	31404580	.	C	G	7	9	16	0	0	16	0	0
24	31832970	.	C	T	1	6	7	0	1	8	0	0
24	31834468	.	T	C	4	3	7	0	0	7	0	0
24	32152877	.	T	G	1	5	6	0	1	7	0	0
24	32152898	.	C	T	1	4	5	0	1	6	0	0
24	32152914	.	A	T	3	7	10	0	1	11	0	0
24	32152944	.	C	T	2	5	7	0	1	8	0	0
24	32163890	.	C	T	4	4	8	0	0	8	0	0
24	32164027	.	C	T	2	2	4	0	1	5	0	0
24	32173646	.	A	G	2	2	4	0	0	4	0	0
24	32176222	.	T	C	2	4	6	0	0	6	0	0
24	32176499	.	T	C	3	7	10	0	0	10	0	0
24	32176716	.	G	C	11	4	15	0	1	16	0	0
24	32180747	.	C	T	0	4	4	0	4	8	0	0
24	32184363	.	C	T	11	6	17	0	2	19	0	0
24	32184379	.	C	A	11	4	15	0	3	18	0	0
24	32187534	.	G	A	22	13	35	0	1	36	0	0
24	32192518	.	G	A	1	31	32	0	15	47	0	0
24	32192529	.	T	C	12	29	41	0	1	42	0	0
24	32192558	.	G	A	9	24	33	0	0	33	0	0
24	32415366	.	G	A	5	4	9	0	0	9	0	0
24	32415367	.	C	G	5	4	9	0	0	9	0	0
24	32473594	.	C	G	7	6	13	0	0	13	0	0
24	32473597	.	G	A	0	7	7	0	6	13	0	0
24	32473821	.	G	A	1	3	4	0	0	4	0	0
24	32474309	.	A	T	1	2	3	0	0	3	0	0
24	32517984	.	G	A	13	21	34	0	1	35	0	0
24	32519471	.	G	A	5	2	7	0	0	7	0	0
24	32522462	.	T	A	16	14	30	0	1	31	0	0
24	32522526	.	A	G	26	19	45	0	4	49	0	0
24	32530539	.	A	G	1	3	4	0	0	4	0	0
24	32534867	.	C	T	0	1	1	0	0	1	0	0
24	32547755	.	T	C	1	4	5	0	0	5	0	0
24	32547926	.	A	C	0	4	4	0	2	6	0	0
24	32547959	.	A	T	2	6	8	0	0	8	0	0
24	32548038	.	A	C	4	2	6	0	1	7	0	0
24	33836689	.	A	G	5	2	7	0	0	7	0	0
24	33836732	.	A	G	2	2	4	0	0	4	0	0
24	33836733	.	A	G	1	2	3	0	1	4	0	0
24	33837710	.	A	G	2	7	9	0	0	9	0	0
24	33837760	.	A	G	7	2	9	0	0	9	0	0
24	33837790	.	A	G	2	4	6	0	0	6	0	0
24	33837914	.	A	G	3	2	5	0	0	5	0	0
24	33837923	.	A	G	2	3	5	0	0	5	0	0
24	33838097	.	A	G	4	3	7	0	0	7	0	0
24	33838535	.	A	G	5	4	9	0	0	9	0	0
24	34488691	.	T	C	2	2	4	0	0	4	0	0
24	34488697	.	A	T	1	2	3	0	1	4	0	0
24	34607240	.	C	T	5	3	8	0	1	9	0	0
24	34607282	.	C	G	5	3	8	0	0	8	0	0
24	34608653	.	C	T	2	3	5	0	0	5	0	0
24	34610215	.	G	T	0	6	6	0	5	11	0	0
24	34610293	.	A	G	1	4	5	0	1	6	0	0
24	34610515	.	G	A	9	9	18	0	1	19	0	0
24	34610655	.	G	A	0	7	7	0	4	11	0	0
24	34610874	.	A	G	13	9	22	0	0	22	0	0
24	34610920	.	A	T	9	13	22	0	1	23	0	0
24	34611151	.	T	C	14	7	21	0	1	22	0	0
24	34611211	.	G	A	10	15	25	0	1	26	0	0
24	34611236	.	G	A	0	14	14	0	18	32	0	0
24	34611378	.	G	T	20	15	35	0	4	39	0	0
24	34611407	.	G	C	10	23	33	0	4	37	0	0
24	34611445	.	A	G	8	19	27	0	3	30	0	0
24	34611536	.	G	A	15	11	26	0	1	27	0	0
24	34611623	.	A	G	4	12	16	0	1	17	0	0
24	34611681	.	C	T	20	5	25	0	2	27	0	0
24	34611915	.	A	G	8	0	8	0	10	18	0	0
24	34612187	.	C	A	16	15	31	0	4	35	0	0
24	34612317	.	G	A	15	21	36	0	3	39	0	0
24	34612327	.	A	T	16	21	37	0	2	39	0	0
24	35523134	.	T	A	19	15	34	0	3	37	0	0
24	35523135	.	T	A	16	20	36	0	1	37	0	0
24	36399565	.	A	G	1	2	3	0	0	3	0	0
24	37195514	.	T	A	8	8	16	0	3	19	0	0
24	37203849	.	A	G	2	0	2	0	1	3	0	0
24	37206315	.	G	A	2	1	3	0	0	3	0	0
24	37257922	.	T	G	19	8	27	0	2	31	2	0
24	37261221	.	A	G	3	3	6	0	1	7	0	0
24	37277246	.	G	T	2	2	4	0	0	4	0	0
24	37277257	.	T	G	1	0	1	0	2	3	0	0
24	37302011	.	T	A	21	9	30	0	3	33	0	0
24	37302539	.	G	A	23	17	40	0	2	42	0	0
24	37302747	.	G	A	16	26	42	0	1	43	0	0
24	37302764	.	G	T	18	24	42	0	0	42	0	0
24	37303266	.	A	G	6	14	20	0	3	23	0	0
24	37303275	.	G	T	8	15	23	0	4	27	0	0
24	37310338	.	A	C	10	8	18	0	1	19	0	0
24	37312146	.	T	C	7	7	14	0	0	14	0	0
24	37312173	.	A	G	8	5	13	0	0	13	0	0
24	37319851	.	G	A	0	2	2	0	0	2	0	0
24	37329390	.	A	G	1	4	5	0	0	5	0	0
24	37329476	.	T	A	4	4	8	0	0	8	0	0
24	37329578	.	T	A	1	4	5	0	0	5	0	0
24	37336975	.	A	G	2	1	3	0	0	3	0	0
24	37337763	.	C	T	5	4	9	0	0	9	0	0
24	37340776	.	A	G	0	1	1	0	1	2	0	0
24	37340846	.	A	T	2	1	3	0	0	3	0	0
24	37344146	.	A	T	11	8	19	0	0	19	0	0
24	37344164	.	G	A	10	9	19	0	1	20	0	0
24	37347937	.	A	C	4	3	7	0	1	8	0	0
24	37347946	.	T	C	5	4	9	0	0	9	0	0
24	37375160	.	C	T	9	4	13	0	2	15	0	0
24	37375165	.	T	C	7	4	11	0	3	14	0	0
24	37469699	.	G	A	4	6	10	0	0	10	0	0
24	37474110	.	A	G	4	4	8	0	2	10	0	0
24	37476633	.	A	C	1	2	3	0	0	3	0	0
24	37476735	.	A	C	3	4	7	0	1	8	0	0
24	37476759	.	T	C	1	3	4	0	0	4	0	0
24	37476955	.	A	G	6	10	16	0	2	18	0	0
24	37477036	.	C	T	1	1	2	0	0	2	0	0
24	37482699	.	T	A	1	1	2	0	0	2	0	0
24	37484029	.	C	A	1	1	2	0	0	2	0	0
24	37527338	.	C	G	1	1	2	0	0	2	0	0
24	37527368	.	C	A	1	2	3	0	0	3	0	0
24	37555605	.	C	T	0	2	2	0	0	2	0	0
24	37567342	.	C	T	12	15	27	0	4	31	0	0
24	37567734	.	C	T	0	24	24	0	19	43	0	0
24	37567953	.	A	G	19	16	35	0	1	36	0	0
24	37568186	.	A	C	16	15	31	0	2	33	0	0
24	37568349	.	T	G	5	5	10	0	0	10	0	0
24	37631842	.	G	A	3	3	6	0	0	6	0	0
24	37657923	.	C	T	2	2	4	0	1	5	0	0
24	37657974	.	T	C	2	1	3	0	1	4	0	0
24	37660472	.	C	T	1	4	5	0	0	5	0	0
24	37661521	.	C	A	1	2	3	0	0	3	0	0
24	37681556	.	G	T	1	4	5	0	0	5	0	0
24	37685942	.	C	T	0	6	6	0	6	12	0	0
24	37686132	.	C	T	2	1	3	0	0	3	0	0
24	37686147	.	G	A	2	1	3	0	0	3	0	0
24	37689919	.	T	C	20	24	44	0	2	46	0	0
24	37692529	.	G	A	17	12	29	0	0	29	0	0
24	37696427	.	G	A	7	6	13	0	2	15	0	0
24	37700263	.	A	G	0	0	0	0	1	1	0	0
24	37708288	.	A	C	3	6	9	0	0	9	0	0
24	37725179	.	T	A	1	3	4	0	0	4	0	0
24	37726867	.	C	G	2	2	4	0	1	5	0	0
24	37781446	.	C	T	3	4	7	0	0	7	0	0
24	37786365	.	C	T	6	3	9	0	0	9	0	0
24	37788853	.	G	A	1	3	4	0	0	4	0	0
24	37793276	.	C	A	1	1	2	0	0	2	0	0
24	37793282	.	C	T	1	2	3	0	0	3	0	0
24	37793315	.	C	T	1	3	4	0	0	4	0	0
24	37815037	.	G	A	0	2	2	0	0	2	0	0
24	37818511	.	G	A	4	4	8	0	0	8	0	0
24	37829270	.	A	T	1	2	3	0	0	3	0	0
24	37829278	.	C	T	1	2	3	0	0	3	0	0
24	37896875	.	C	T	1	2	3	0	0	3	0	0
24	37896974	.	T	C	0	4	4	0	0	4	0	0
24	37901014	.	A	G	4	4	8	0	0	8	0	0
24	37901035	.	T	G	3	2	5	0	0	5	0	0
24	37901114	.	A	G	2	4	6	0	0	6	0	0
24	37901178	.	C	T	3	6	9	0	0	9	0	0
24	37941862	.	C	T	0	5	5	0	2	7	0	0
24	37941922	.	A	C	5	3	8	0	0	8	0	0
24	37941958	.	A	G	6	4	10	0	0	10	0	0
24	37942032	.	C	T	4	4	8	0	0	8	0	0
24	37942183	.	A	T	3	3	6	0	1	7	0	0
24	37942323	.	C	T	0	4	4	0	3	7	0	0
24	37942559	.	C	T	2	3	5	0	0	5	0	0
24	38073271	.	G	A	11	12	23	0	2	25	0	0
24	38073319	.	G	A	21	12	33	0	3	36	0	0
24	38073688	.	G	A	3	4	7	0	0	7	0	0
24	38073712	.	C	T	3	3	6	0	0	6	0	0
24	38073793	.	G	A	8	2	10	0	1	11	0	0
24	38189840	.	C	A	3	2	5	0	0	5	0	0
24	38189892	.	C	T	1	2	3	0	0	3	0	0
24	38189957	.	G	A	1	2	3	0	0	3	0	0
24	38190160	.	T	A	3	1	4	0	1	5	0	0
24	38190768	.	G	A	2	4	6	0	0	6	0	0
24	38190789	.	C	T	3	2	5	0	0	5	0	0
24	38190933	.	G	A	0	3	3	0	5	8	0	0
24	38191841	.	C	T	4	5	9	0	1	10	0	0
24	38191900	.	A	G	4	2	6	0	0	6	0	0
24	38337629	.	A	G	0	0	0	0	1	1	0	0
24	38369559	.	T	A	21	12	33	0	1	34	0	0
24	38369819	.	A	G	10	13	23	0	3	26	0	0
24	38369873	.	G	A	14	14	28	0	1	29	0	0
24	38370188	.	A	G	9	4	13	0	1	14	0	0
24	38370325	.	A	G	7	8	15	0	0	15	0	0
24	38370404	.	T	A	5	7	12	0	1	13	0	0
24	38370518	.	C	T	4	3	7	0	2	9	0	0
24	38370796	.	T	G	2	3	5	0	1	6	0	0
24	38370998	.	A	G	4	3	7	0	0	7	0	0
24	38371178	.	A	G	4	3	7	0	0	7	0	0
24	38374684	.	G	A	2	2	4	0	0	4	0	0
24	38384245	.	A	T	2	5	7	0	0	7	0	0
24	38816010	.	G	T	3	3	6	0	0	6	0	0
24	38816184	.	T	G	1	2	3	0	1	4	0	0
24	38816340	.	T	G	1	3	4	0	0	4	0	0
24	39051042	.	T	C	2	2	4	0	0	4	0	0
24	39051692	.	G	C	4	5	9	0	5	14	0	0
24	39051981	.	G	A	0	5	5	0	3	8	0	0
24	39052117	.	T	C	2	1	3	0	0	3	0	0
24	39052125	.	A	G	2	3	5	0	0	5	0	0
24	39052302	.	G	A	4	4	8	0	0	8	0	0
24	39052386	.	A	G	3	1	4	0	0	4	0	0
24	39064643	.	T	C	2	0	2	0	0	2	0	0
24	39065822	.	A	G	0	0	0	0	2	2	0	0
24	39065978	.	T	C	1	3	4	0	0	4	0	0
24	39075534	.	T	C	3	2	5	0	0	5	0	0
24	39147852	.	A	G	8	4	12	0	0	12	0	0
24	39147871	.	A	G	8	0	8	0	2	10	0	0
24	39151004	.	A	T	5	3	8	0	0	8	0	0
24	39151040	.	C	T	4	5	9	0	0	9	0	0
24	39151235	.	G	A	4	2	6	0	0	6	0	0
24	39151301	.	A	C	3	1	4	0	1	5	0	0
24	39151343	.	G	A	7	6	13	0	1	14	0	0
24	39151467	.	T	C	3	2	5	0	0	5	0	0
24	39151637	.	G	C	8	9	17	0	0	17	0	0
24	39151675	.	T	C	7	7	14	0	0	14	0	0
24	39151725	.	C	T	7	10	17	0	0	17	0	0
24	39151727	.	T	C	5	10	15	0	2	17	0	0
24	39152001	.	A	G	8	3	11	0	1	12	0	0
24	39152077	.	C	G	4	4	8	0	0	8	0	0
24	39152504	.	A	G	5	1	6	0	1	7	0	0
24	39152523	.	A	G	5	3	8	0	1	9	0	0
24	39152794	.	A	G	9	4	13	0	0	13	0	0
24	39152917	.	G	A	6	4	10	0	0	10	0	0
24	39153635	.	T	C	3	4	7	1	0	8	0	0
24	39153647	.	G	A	3	6	9	1	1	11	0	0
24	39153817	.	G	A	2	15	17	0	0	17	0	0
24	39153857	.	G	T	3	4	7	0	1	8	0	0
24	39154044	.	G	A	15	20	35	0	3	38	0	0
24	39154230	.	A	G	27	9	36	0	2	38	0	0
24	39154315	.	C	T	20	22	42	0	2	44	0	0
24	39154551	.	C	A	22	15	37	0	1	38	0	0
24	39154620	.	C	T	13	17	30	0	3	33	0	0
24	39154865	.	C	A	11	15	26	0	0	26	0	0
24	39154892	.	T	G	13	10	23	0	0	23	0	0
24	39172141	.	T	C	19	36	55	0	2	57	0	0
24	39172222	.	A	G	12	17	29	0	2	31	0	0
24	39174437	.	T	C	1	5	6	0	1	7	0	0
24	39174570	.	C	T	33	32	65	0	4	69	0	0
24	39175002	.	A	C	18	20	38	0	5	43	0	0
24	39175044	.	A	G	12	39	51	0	0	51	0	0
24	39175047	.	T	C	10	35	45	0	6	51	0	0
24	39175083	.	C	G	18	29	47	0	3	50	0	0
24	39175109	.	T	A	38	15	53	1	0	54	0	0
24	39175143	.	C	T	30	27	57	1	3	61	0	0
24	39175207	.	A	G	35	4	39	0	30	69	0	0
24	39178516	.	T	G	3	3	6	0	0	6	0	0
24	39178591	.	C	A	0	7	7	0	3	10	0	0
24	39178627	.	C	A	0	2	2	0	2	4	0	0
24	39182404	.	G	A	1	4	5	0	1	6	0	0
24	39182676	.	G	A	3	2	5	0	0	5	0	0
24	39309684	.	A	G	2	0	2	0	6	8	0	0
24	39310061	.	A	G	3	4	7	0	2	9	0	0
24	39310129	.	G	A	2	2	4	0	0	4	0	0
24	39310163	.	G	T	3	3	6	0	0	6	0	0
24	39322945	.	G	T	0	11	11	0	8	19	0	0
24	39323791	.	C	T	10	7	17	0	1	18	0	0
24	39333916	.	C	T	8	5	13	0	1	14	0	0
24	39333972	.	A	C	22	18	40	0	4	44	0	0
24	39334054	.	A	G	27	11	38	0	2	40	0	0
24	39334187	.	G	A	0	17	17	0	18	35	0	0
24	39334388	.	A	G	25	22	47	0	5	52	0	0
24	39334400	.	G	A	0	23	23	0	31	54	0	0
24	39510079	.	C	T	3	2	5	0	1	6	0	0
24	39510108	.	T	C	2	3	5	0	0	5	0	0
24	39510891	.	T	C	6	3	9	0	0	9	0	0
24	39510981	.	A	G	4	3	7	0	2	9	0	0
24	39511016	.	T	C	6	3	9	0	0	9	0	0
24	39511034	.	G	A	4	5	9	0	0	9	0	0
24	39511157	.	G	A	2	9	11	0	1	12	0	0
24	39514056	.	T	C	1	0	1	0	0	1	0	0
24	39514296	.	C	G	6	3	9	0	0	9	0	0
24	39518841	.	T	C	4	3	7	0	0	7	0	0
24	39533836	.	C	T	3	4	7	0	0	7	0	0
24	39533987	.	T	A	4	7	11	0	1	12	0	0
24	39556760	.	G	A	0	1	1	0	0	1	0	0
24	39576414	.	C	T	1	2	3	0	0	3	0	0
24	39579730	.	A	G	1	2	3	0	0	3	0	0
24	39579989	.	G	A	0	4	4	0	5	9	0	0
24	39586778	.	A	T	2	2	4	0	2	6	0	0
24	39587369	.	C	G	1	2	3	0	1	4	0	0
24	39593009	.	T	C	2	0	2	0	1	3	0	0
24	39593038	.	G	A	0	0	0	0	4	4	0	0
24	39595866	.	A	C	3	3	6	0	0	6	0	0
24	39606237	.	G	A	20	19	39	0	4	43	0	0
24	39610535	.	G	T	13	11	24	0	1	25	0	0
24	39615373	.	G	T	8	7	15	0	3	20	2	0
24	39615374	.	G	T	8	10	18	0	2	20	0	0
24	39615584	.	C	G	7	0	7	0	0	7	0	0
24	39616170	.	C	A	5	5	10	0	0	10	0	0
24	39638642	.	G	A	8	13	21	0	1	22	0	0
24	39642072	.	A	T	9	5	14	0	1	15	0	0
24	39642220	.	A	G	9	4	13	0	1	14	0	0
24	39642229	.	A	G	9	4	13	0	0	13	0	0
24	39642336	.	C	A	4	6	10	0	2	12	0	0
24	39642361	.	G	T	9	6	15	0	1	16	0	0
24	39644259	.	T	C	7	4	11	0	2	13	0	0
24	39646762	.	C	T	7	13	20	0	1	21	0	0
24	39647021	.	C	T	5	2	7	0	0	7	0	0
24	39647042	.	G	C	10	9	19	0	2	21	0	0
24	39648806	.	C	T	15	8	23	0	0	23	0	0
24	39651567	.	T	G	22	19	41	0	2	43	0	0
24	39651612	.	A	T	11	16	27	0	1	28	0	0
24	39653626	.	G	A	22	10	32	14	4	50	0	0
24	39660219	.	C	T	2	1	3	0	1	4	0	0
24	39661890	.	T	A	0	2	2	0	0	2	0	0
24	39661905	.	C	T	4	3	7	0	1	8	0	0
24	39662074	.	T	C	2	5	7	0	0	7	0	0
24	39663197	.	A	G	2	0	2	0	1	4	1	0
24	39667348	.	T	C	15	10	25	0	0	25	0	0
24	39742336	.	G	A	1	3	4	0	0	4	0	0
24	39742396	.	G	A	2	4	6	0	0	6	0	0
24	39742786	.	T	A	2	4	6	0	0	6	0	0
24	39778982	.	C	G	1	1	2	0	2	4	0	0
24	39779020	.	C	T	1	3	4	0	0	4	0	0
24	39779108	.	G	T	1	3	4	0	0	4	0	0
24	39779637	.	A	G	0	1	1	0	0	1	0	0
24	40001569	.	T	C	2	3	5	0	0	5	0	0
24	41473618	.	G	A	1	0	1	0	0	1	0	0
24	41473627	.	G	A	2	0	2	0	0	2	0	0
24	41916447	.	G	T	0	1	1	0	1	2	0	0
24	41994610	.	G	T	3	2	5	0	0	5	0	0
25	244180	.	C	T	0	5	5	0	1	6	0	0
25	488399	.	T	C	1	9	10	0	1	11	0	0
25	3246485	.	A	G	2	1	3	0	0	3	0	0
25	3246593	.	A	G	8	6	14	0	0	14	0	0
25	3362791	.	T	G	1	1	2	0	0	2	0	0
25	3708449	.	T	A	10	2	12	0	2	14	0	0
25	3881306	.	A	G	4	3	7	0	0	7	0	0
25	4689523	.	A	G	0	0	0	0	4	4	0	0
25	4689524	.	A	G	0	3	3	0	1	4	0	0
25	4689688	.	A	G	3	5	8	0	0	8	0	0
25	6042829	.	A	T	2	2	4	0	0	4	0	0
25	6206264	.	G	T	3	2	5	0	1	6	0	0
25	7230239	.	T	C	1	2	3	0	0	3	0	0
25	7324580	.	C	T	1	1	2	0	0	2	0	0
25	7327718	.	C	T	13	13	26	0	1	27	0	0
25	7333751	.	G	A	18	11	29	0	2	31	0	0
25	7333841	.	C	T	9	12	21	0	4	25	0	0
25	7334951	.	T	C	17	11	28	0	5	33	0	0
25	7334987	.	G	C	8	9	17	0	0	17	0	0
25	7336096	.	T	A	13	11	24	0	4	28	0	0
25	7336269	.	A	G	6	3	9	0	2	11	0	0
25	7401054	.	C	T	3	2	5	0	0	5	0	0
25	7410558	.	C	A	2	2	4	0	0	4	0	0
25	7413288	.	T	A	1	2	3	0	0	3	0	0
25	7428932	.	A	C	7	3	10	0	1	11	0	0
25	7428971	.	A	T	2	1	3	0	0	3	0	0
25	7429028	.	C	A	0	1	1	0	0	1	0	0
25	7431288	.	T	G	1	1	2	0	0	2	0	0
25	7431310	.	A	C	0	2	2	0	0	2	0	0
25	7431334	.	G	A	3	1	4	0	1	5	0	0
25	7433584	.	T	C	1	2	3	0	0	3	0	0
25	7451133	.	C	A	4	3	7	0	0	7	0	0
25	7454578	.	T	C	9	4	13	0	0	13	0	0
25	7454599	.	T	C	8	2	10	0	4	14	0	0
25	7456535	.	C	A	1	1	2	0	0	2	0	0
25	7456843	.	G	A	0	9	9	0	2	11	0	0
25	7456860	.	G	A	0	0	0	0	6	6	0	0
25	7477641	.	C	T	4	6	10	0	0	10	0	0
25	7487835	.	G	C	22	20	42	0	6	48	0	0
25	7488407	.	T	C	9	21	30	0	0	30	0	0
25	7488660	.	C	T	18	6	24	0	3	27	0	0
25	7488812	.	G	A	20	27	47	0	3	50	0	0
25	7488813	.	G	T	21	27	48	0	2	50	0	0
25	7489011	.	A	T	25	34	59	0	5	64	0	0
25	7489034	.	G	A	1	21	22	0	39	61	0	0
25	7489197	.	G	T	21	13	34	0	0	34	0	0
25	7492888	.	C	T	3	3	6	0	0	6	0	0
25	7492927	.	T	A	1	3	4	0	0	4	0	0
25	7496021	.	C	T	1	2	3	0	0	3	0	0
25	7496039	.	C	T	3	2	5	0	0	5	0	0
25	7496992	.	G	C	0	4	4	0	3	7	0	0
25	7500473	.	T	C	7	5	12	0	0	12	0	0
25	7501997	.	G	A	9	14	23	0	0	23	0	0
25	7502022	.	G	C	13	6	19	0	3	22	0	0
25	7502241	.	G	A	0	1	1	0	0	1	0	0
25	7520370	.	A	T	0	8	8	0	0	8	0	0
25	7520376	.	T	A	3	7	10	0	0	10	0	0
25	7890351	.	T	C	3	3	6	0	2	8	0	0
25	7890372	.	T	C	4	4	8	0	0	8	0	0
25	7892297	.	T	C	1	2	3	0	0	3	0	0
25	8627943	.	T	C	5	7	12	0	3	15	0	0
25	9678666	.	G	A	5	3	8	0	0	8	0	0
25	9679242	.	G	A	9	9	18	0	0	18	0	0
25	9679389	.	G	A	3	5	8	0	0	8	0	0
25	9679413	.	C	T	0	4	4	0	4	8	0	0
25	9679539	.	T	C	1	4	5	0	0	5	0	0
25	9680022	.	T	C	4	2	6	0	0	6	0	0
25	9680448	.	A	G	1	2	3	0	0	3	0	0
25	9805253	.	G	C	2	2	4	0	0	4	0	0
25	9805257	.	G	C	1	1	2	0	1	3	0	0
25	11704574	.	G	A	1	3	4	0	0	4	0	0
25	11704605	.	C	T	1	2	3	0	0	3	0	0
25	11796579	.	T	A	17	13	30	0	1	31	0	0
25	11796728	.	A	T	15	19	34	0	2	36	0	0
25	11796860	.	T	C	15	12	27	0	4	31	0	0
25	11796987	.	A	G	11	6	17	0	0	17	0	0
25	11797515	.	A	G	9	9	18	0	0	18	0	0
25	11797550	.	G	T	8	6	14	0	1	15	0	0
25	11797583	.	G	T	11	4	15	0	0	15	0	0
25	11797592	.	T	C	11	4	15	0	0	15	0	0
25	11797789	.	A	T	4	5	9	0	0	9	0	0
25	11797912	.	T	A	2	3	5	0	0	5	0	0
25	11798043	.	G	A	2	2	4	0	1	5	0	0
25	11798215	.	A	C	5	9	14	0	0	14	0	0
25	11798227	.	T	A	2	7	9	0	2	11	0	0
25	11798381	.	T	A	5	3	8	0	1	9	0	0
25	11798509	.	A	T	5	3	8	0	1	9	0	0
25	11798511	.	C	A	0	4	4	0	5	9	0	0
25	11798598	.	C	T	1	3	4	0	0	4	0	0
25	11799527	.	A	T	4	2	6	0	0	6	0	0
25	11799577	.	G	A	1	5	6	0	1	7	0	0
25	11799625	.	A	T	2	3	5	0	1	6	0	0
25	11799670	.	G	T	4	3	7	0	2	9	0	0
25	11799685	.	A	G	5	2	7	0	0	7	0	0
25	11799945	.	T	C	7	2	9	0	0	9	0	0
25	11799954	.	G	T	4	2	6	0	0	6	0	0
25	11800098	.	G	C	2	6	8	0	1	9	0	0
25	11800652	.	C	T	0	4	4	0	1	5	0	0
25	11800883	.	C	T	1	3	4	0	1	5	0	0
25	11801111	.	C	A	2	2	4	0	0	4	0	0
25	11801642	.	C	G	2	4	6	0	0	6	0	0
25	11801731	.	C	G	2	2	4	0	0	4	0	0
25	11802192	.	T	A	3	3	6	0	0	6	0	0
25	11804688	.	T	G	2	3	5	0	0	5	0	0
25	11805675	.	T	A	0	2	2	0	1	3	0	0
25	12853318	.	C	A	24	7	31	0	3	34	0	0
25	12853640	.	G	A	36	15	51	0	4	55	0	0
25	12853691	.	C	T	14	33	47	0	3	50	0	0
25	12853811	.	G	A	19	6	25	0	0	25	0	0
25	12853971	.	T	A	18	32	50	0	1	51	0	0
25	12854112	.	C	T	35	11	46	0	2	48	0	0
25	12854201	.	C	T	18	21	39	1	2	42	0	0
25	12854266	.	A	T	9	18	27	0	4	31	0	0
25	13104333	.	C	A	0	2	2	0	3	5	0	0
25	13105061	.	A	G	1	2	3	0	1	4	0	0
25	13332531	.	C	T	38	23	61	0	3	64	0	0
25	13332693	.	G	A	34	43	77	0	3	80	0	0
25	13332737	.	A	G	38	32	70	0	14	84	0	0
25	13333027	.	A	G	46	19	65	0	6	71	0	0
25	13333287	.	A	G	36	31	67	0	4	71	0	0
25	13333986	.	T	A	32	32	64	0	6	70	0	0
25	13333994	.	C	T	35	35	70	0	1	71	0	0
25	13334023	.	T	A	31	31	62	0	0	62	0	0
25	13334049	.	A	T	33	30	63	0	4	67	0	0
25	13334061	.	A	G	37	28	65	0	2	67	0	0
25	13334334	.	A	T	20	22	42	0	2	44	0	0
25	13334371	.	T	C	15	29	44	0	2	46	0	0
25	13334397	.	C	G	19	30	49	0	4	53	0	0
25	13334429	.	T	C	21	28	49	0	3	52	0	0
25	13334526	.	A	G	35	20	55	0	1	56	0	0
25	13334537	.	T	C	40	0	40	0	16	56	0	0
25	13334729	.	C	T	38	28	66	0	4	70	0	0
25	13335021	.	G	T	39	21	60	0	2	62	0	0
25	13335059	.	G	C	33	23	56	0	2	59	1	0
25	13335078	.	A	G	29	23	52	0	1	53	0	0
25	13335185	.	A	G	27	20	47	0	2	49	0	0
25	13335225	.	T	C	29	21	50	0	2	52	0	0
25	13335331	.	T	C	24	28	52	0	6	58	0	0
25	13335359	.	C	T	3	29	32	0	29	61	0	0
25	13335524	.	T	C	17	23	40	0	5	45	0	0
25	13335892	.	A	G	17	24	41	0	2	43	0	0
25	13335897	.	T	C	17	24	41	0	3	44	0	0
25	13336236	.	G	T	40	16	56	0	0	56	0	0
25	13336391	.	G	A	24	35	59	0	0	60	1	0
25	13336409	.	A	C	21	37	58	0	3	61	0	0
25	13336755	.	G	T	25	21	46	0	10	56	0	0
25	13336780	.	A	G	28	19	47	0	7	54	0	0
25	13336815	.	T	A	26	28	54	0	2	56	0	0
25	13336967	.	T	A	16	23	39	0	2	41	0	0
25	13337044	.	G	A	19	16	35	0	2	37	0	0
25	13337136	.	A	G	18	23	41	0	1	42	0	0
25	13350259	.	A	G	2	2	4	0	0	4	0	0
25	13351894	.	T	A	6	7	13	0	1	14	0	0
25	13353747	.	G	A	5	6	11	0	1	12	0	0
25	13469844	.	A	G	11	1	12	0	11	23	0	0
25	13469858	.	T	C	8	12	20	0	2	22	0	0
25	13470424	.	C	T	10	13	23	0	2	25	0	0
25	13470430	.	A	T	8	15	23	0	4	27	0	0
25	13470544	.	A	T	15	8	23	0	1	24	0	0
25	13471127	.	A	G	18	1	19	0	16	35	0	0
25	13474246	.	C	T	4	4	8	0	0	8	0	0
25	13474362	.	C	G	2	6	8	0	0	8	0	0
25	13474411	.	A	G	0	4	4	0	0	4	0	0
25	13509942	.	T	A	1	2	3	0	0	3	0	0
25	13525295	.	C	G	6	4	10	0	0	10	0	0
25	13525407	.	G	A	2	4	6	0	0	6	0	0
25	13525453	.	C	T	5	3	8	0	0	8	0	0
25	13525521	.	A	C	2	8	10	0	0	10	0	0
25	13525633	.	A	C	4	6	10	0	0	10	0	0
25	13525848	.	A	T	5	9	14	0	2	16	0	0
25	13525864	.	G	A	6	8	14	0	1	15	0	0
25	13525890	.	A	C	6	7	13	0	1	14	0	0
25	13526171	.	A	C	13	13	26	0	1	28	1	0
25	13528361	.	G	A	2	5	7	0	0	7	0	0
25	13559168	.	T	G	3	6	9	0	1	10	0	0
25	13559194	.	G	A	5	14	19	0	0	19	0	0
25	13559220	.	G	A	1	15	16	0	4	20	0	0
25	13559446	.	T	A	7	12	19	0	3	22	0	0
25	13559500	.	T	C	8	9	17	0	1	18	0	0
25	13559723	.	T	A	5	5	10	0	1	11	0	0
25	13559740	.	A	G	5	3	8	0	1	9	0	0
25	13559953	.	A	T	4	9	13	0	1	14	0	0
25	13560080	.	C	T	2	5	7	0	2	9	0	0
25	13560136	.	C	T	3	2	5	0	2	7	0	0
25	13560149	.	C	T	2	3	5	0	0	5	0	0
25	13560186	.	A	G	6	5	11	0	2	13	0	0
25	13560207	.	T	C	6	7	13	0	1	14	0	0
25	13560414	.	T	C	12	0	12	0	8	20	0	0
25	13560420	.	T	C	10	9	19	0	0	19	0	0
25	13560576	.	C	T	4	6	10	0	0	10	0	0
25	13560598	.	T	G	4	7	11	0	0	11	0	0
25	13560638	.	C	A	3	4	7	0	0	7	0	0
25	13561133	.	T	C	3	2	5	0	0	5	0	0
25	13561149	.	T	C	2	5	7	0	0	7	0	0
25	13561296	.	A	G	4	3	7	0	0	7	0	0
25	13561775	.	C	A	0	2	2	0	3	5	0	0
25	13561851	.	A	C	2	3	5	0	0	5	0	0
25	13562371	.	G	A	5	2	7	0	0	7	0	0
25	13625007	.	C	T	0	2	2	0	1	3	0	0
25	13645911	.	C	T	8	5	13	0	0	13	0	0
25	13646153	.	G	A	2	1	3	0	0	3	0	0
25	13658316	.	C	T	0	3	3	0	5	8	0	0
25	13658940	.	G	A	1	5	6	0	0	6	0	0
25	13659075	.	T	A	4	5	9	0	0	9	0	0
25	13672106	.	T	A	4	2	6	0	0	6	0	0
25	13672111	.	A	T	4	2	6	0	0	6	0	0
25	13672349	.	G	A	0	2	2	0	0	2	0	0
25	13677352	.	G	A	0	2	2	0	1	3	0	0
25	13677396	.	A	G	1	2	3	0	0	3	0	0
25	13677519	.	C	T	1	2	3	0	0	3	0	0
25	13680295	.	A	G	0	5	5	0	0	5	0	0
25	13685300	.	G	C	0	1	1	0	0	1	0	0
25	13689166	.	G	A	5	4	9	0	0	9	0	0
25	13689945	.	G	A	3	4	7	0	0	7	0	0
25	13744547	.	G	T	2	2	4	0	0	4	0	0
25	13745659	.	A	G	25	35	60	0	0	60	0	0
25	13745665	.	A	G	25	34	59	0	0	59	0	0
25	13745776	.	A	G	7	13	20	0	0	20	0	0
25	13747722	.	G	C	10	2	12	0	26	38	0	0
25	13750734	.	T	A	11	7	18	0	1	19	0	0
25	13754015	.	A	G	2	1	3	0	0	3	0	0
25	13754094	.	T	A	12	13	25	0	1	26	0	0
25	13754338	.	T	G	0	1	1	0	0	1	0	0
25	13754359	.	A	G	2	1	3	0	0	3	0	0
25	13759547	.	G	A	2	6	8	0	0	8	0	0
25	13762889	.	T	C	0	1	1	0	1	2	0	0
25	13767612	.	G	A	5	2	7	0	1	8	0	0
25	13768396	.	G	A	1	2	3	0	0	3	0	0
25	13774036	.	C	T	1	0	1	0	0	1	0	0
25	13774400	.	G	A	0	1	1	0	0	1	0	0
25	13780322	.	C	G	3	2	5	0	0	5	0	0
25	13787514	.	A	T	1	0	1	0	0	1	0	0
25	13791853	.	A	C	3	8	11	0	0	11	0	0
25	13795332	.	G	A	1	2	3	0	0	3	0	0
25	13795440	.	T	C	17	16	33	0	0	33	0	0
25	13795441	.	G	A	16	16	32	0	1	33	0	0
25	13795494	.	A	G	5	5	10	0	1	11	0	0
25	13796379	.	T	C	1	0	1	0	0	1	0	0
25	13799172	.	G	A	3	4	7	0	0	7	0	0
25	13799689	.	C	T	15	19	34	0	0	34	0	0
25	13801895	.	G	C	17	14	31	0	1	32	0	0
25	13801933	.	C	T	15	20	35	0	0	35	0	0
25	13802100	.	C	T	15	22	37	0	5	42	0	0
25	13802235	.	T	A	13	13	26	0	2	28	0	0
25	13802673	.	C	T	0	11	11	0	19	30	0	0
25	13802688	.	C	A	20	10	30	0	3	33	0	0
25	13802710	.	C	T	15	13	28	0	3	31	0	0
25	13802876	.	G	A	7	23	30	0	5	35	0	0
25	13802901	.	G	A	13	26	39	0	1	40	0	0
25	13802918	.	A	G	14	24	38	0	2	40	0	0
25	13802940	.	A	T	15	26	41	0	1	42	0	0
25	13803710	.	A	G	14	17	31	0	3	34	0	0
25	13803712	.	T	G	13	20	33	0	1	34	0	0
25	13803895	.	A	G	6	16	22	0	0	22	0	0
25	13803903	.	C	T	17	6	23	0	0	23	0	0
25	13804056	.	C	T	10	15	25	0	4	29	0	0
25	13804097	.	T	A	9	18	27	0	2	29	0	0
25	13804216	.	C	T	9	9	18	0	1	19	0	0
25	13813656	.	A	G	4	8	12	0	1	13	0	0
25	13813659	.	G	A	4	7	11	0	1	12	0	0
25	13815325	.	G	A	10	3	13	0	0	13	0	0
25	13815361	.	A	G	6	10	16	0	0	16	0	0
25	13816724	.	G	A	6	3	9	0	2	11	0	0
25	13816840	.	C	T	0	10	10	0	4	14	0	0
25	13817135	.	C	G	6	4	10	0	0	10	0	0
25	13817243	.	C	T	0	2	2	0	1	3	0	0
25	13821187	.	C	T	1	1	2	0	0	2	0	0
25	13847533	.	A	G	14	4	18	0	0	18	0	0
25	13848801	.	G	A	10	9	19	0	1	20	0	0
25	13848930	.	A	G	5	1	6	0	0	6	0	0
25	13850757	.	A	C	4	3	7	0	0	7	0	0
25	13854838	.	G	A	7	5	12	0	0	12	0	0
25	13855707	.	T	A	1	9	10	0	0	10	0	0
25	13856023	.	C	A	0	2	2	0	1	3	0	0
25	13871070	.	C	T	2	3	5	0	2	7	0	0
25	14018007	.	T	C	1	3	4	0	0	4	0	0
25	14019921	.	G	A	0	9	9	0	11	21	1	0
25	14020780	.	G	A	9	4	13	0	3	16	0	0
25	14020806	.	T	A	7	4	11	0	0	11	0	0
25	14020923	.	C	A	9	2	11	0	1	12	0	0
25	14020924	.	A	C	9	3	12	0	0	12	0	0
25	14020973	.	C	T	4	3	7	0	2	9	0	0
25	14021000	.	A	C	7	2	9	0	1	10	0	0
25	14021062	.	A	G	2	2	4	0	0	4	0	0
25	14021070	.	T	C	1	2	3	0	1	4	0	0
25	14033013	.	G	C	3	1	4	0	0	4	0	0
25	14033031	.	C	A	1	2	3	0	0	3	0	0
25	14033268	.	T	C	14	11	25	0	1	26	0	0
25	14033670	.	T	G	4	10	14	0	1	15	0	0
25	14033867	.	A	G	7	6	13	0	0	13	0	0
25	14033914	.	G	A	10	4	14	0	0	14	0	0
25	14033984	.	G	T	6	4	10	0	1	11	0	0
25	14034065	.	T	C	4	4	8	0	0	8	0	0
25	14034240	.	G	C	23	11	34	0	1	35	0	0
25	14034398	.	C	T	13	4	17	0	2	19	0	0
25	14034406	.	G	A	15	5	20	0	1	21	0	0
25	14034512	.	C	T	12	4	16	0	2	18	0	0
25	14034513	.	T	A	12	5	17	0	1	18	0	0
25	14034620	.	A	G	3	8	11	0	4	15	0	0
25	14034667	.	C	T	7	4	11	1	0	12	0	0
25	14034725	.	T	A	5	5	10	0	0	10	0	0
25	14034881	.	T	C	7	10	17	0	1	18	0	0
25	14034911	.	C	G	11	5	16	0	1	17	0	0
25	14035012	.	T	G	6	8	14	0	1	15	0	0
25	14035017	.	T	A	6	9	15	0	0	15	0	0
25	14035188	.	T	G	3	4	7	0	3	10	0	0
25	14035189	.	G	A	5	5	10	0	0	10	0	0
25	14035229	.	C	T	6	4	10	0	0	10	0	0
25	14035247	.	T	G	4	2	6	0	2	8	0	0
25	14035414	.	A	T	7	4	11	0	1	12	0	0
25	14035500	.	T	G	4	2	6	0	1	7	0	0
25	14035559	.	T	G	4	3	7	0	2	9	0	0
25	14361812	.	C	T	2	6	8	0	1	9	0	0
25	14363216	.	C	T	5	5	10	0	1	11	0	0
25	14363291	.	T	A	4	7	11	0	0	11	0	0
25	14363572	.	G	T	8	5	13	0	0	13	0	0
25	14365546	.	G	A	2	0	2	0	0	2	0	0
25	14365781	.	C	T	14	6	20	0	1	21	0	0
25	14365834	.	C	T	8	6	14	0	0	14	0	0
25	14366056	.	T	A	7	6	13	0	1	14	0	0
25	14369587	.	G	T	12	4	16	0	1	17	0	0
25	14369631	.	C	T	13	16	29	0	2	31	0	0
25	14369712	.	G	A	10	11	21	0	8	29	0	0
25	14369869	.	T	A	10	6	16	0	2	18	0	0
25	14369883	.	T	C	8	2	10	0	11	21	0	0
25	14381497	.	T	G	4	3	7	0	1	8	0	0
25	14381513	.	G	T	5	5	10	0	0	10	0	0
25	14381583	.	A	G	11	23	34	0	0	34	0	0
25	14381763	.	G	A	10	11	21	0	1	22	0	0
25	14384028	.	G	T	13	13	26	0	2	28	0	0
25	14387616	.	C	T	1	2	3	0	0	3	0	0
25	14388955	.	A	T	7	9	16	0	0	16	0	0
25	14392808	.	C	G	11	5	16	0	1	17	0	0
25	14393533	.	A	G	2	4	6	0	0	6	0	0
25	14401150	.	C	T	1	2	3	0	0	3	0	0
25	14403369	.	T	C	6	7	13	0	2	15	0	0
25	14403404	.	C	T	4	2	6	0	1	7	0	0
25	14406608	.	A	C	11	6	17	0	2	19	0	0
25	14406621	.	T	C	7	8	15	0	5	20	0	0
25	14406649	.	A	T	3	10	13	0	0	13	0	0
25	14409642	.	G	A	0	2	2	0	0	2	0	0
25	14426595	.	A	T	2	0	2	0	0	2	0	0
25	14511458	.	T	A	2	1	3	0	1	4	0	0
25	14511470	.	G	T	2	3	5	0	0	5	0	0
25	14694979	.	T	C	0	2	2	0	1	3	0	0
25	14695092	.	C	T	4	1	5	0	0	5	0	0
25	14733824	.	C	T	2	1	3	0	0	3	0	0
25	14734122	.	A	G	2	1	3	0	0	3	0	0
25	14738244	.	A	G	7	3	10	0	0	10	0	0
25	14738462	.	T	A	4	2	6	0	0	6	0	0
25	14870811	.	T	C	1	2	3	0	0	3	0	0
25	15029225	.	C	T	6	12	18	0	0	18	0	0
25	15031773	.	G	A	5	0	5	0	2	7	0	0
25	15031851	.	A	G	2	2	4	0	1	5	0	0
25	15032087	.	A	G	5	3	8	0	0	8	0	0
25	15034012	.	C	T	0	2	2	0	1	3	0	0
25	15273455	.	A	T	1	6	7	0	0	7	0	0
25	15275985	.	G	A	1	1	2	0	0	2	0	0
25	15281889	.	C	T	2	2	4	0	1	5	0	0
25	15281891	.	A	G	2	3	5	0	0	5	0	0
25	15284485	.	T	C	3	2	5	0	2	7	0	0
25	15284734	.	G	T	13	5	18	0	0	18	0	0
25	15284799	.	C	T	10	8	18	0	2	20	0	0
25	15284862	.	T	C	11	14	25	0	0	25	0	0
25	15284959	.	T	C	12	16	28	0	1	29	0	0
25	15285004	.	A	C	14	12	26	0	1	27	0	0
25	15285092	.	T	C	8	10	18	0	1	19	0	0
25	15285105	.	C	A	10	7	17	0	0	17	0	0
25	15285213	.	G	C	9	15	24	0	1	25	0	0
25	15285256	.	T	A	8	19	27	0	0	27	0	0
25	15285470	.	C	T	3	11	14	0	0	14	0	0
25	15285471	.	C	A	2	11	13	0	1	14	0	0
25	15343016	.	C	A	2	3	5	0	0	5	0	0
25	15345474	.	C	A	2	2	4	0	0	4	0	0
25	15350012	.	A	G	3	5	8	0	1	9	0	0
25	15350016	.	G	A	4	5	9	0	1	10	0	0
25	15350058	.	A	G	4	6	10	0	1	11	0	0
25	15350402	.	T	G	7	8	15	0	1	16	0	0
25	15350467	.	T	C	8	8	16	0	0	16	0	0
25	15351088	.	A	G	11	8	19	0	0	19	0	0
25	15404898	.	G	A	2	6	8	0	0	8	0	0
25	15408820	.	G	A	0	9	9	0	10	19	0	0
25	15409013	.	T	C	5	7	12	0	3	15	0	0
25	15430310	.	T	C	3	5	8	0	2	10	0	0
25	15430334	.	T	C	1	1	2	0	2	4	0	0
25	15432769	.	G	A	2	2	4	0	0	4	0	0
25	15434566	.	T	C	4	4	8	0	3	11	0	0
25	15434579	.	C	T	4	6	10	0	0	10	0	0
25	15438723	.	G	A	0	10	10	0	10	20	0	0
25	15438789	.	C	A	1	0	1	0	1	2	0	0
25	15450807	.	C	G	12	12	24	0	0	24	0	0
25	15465167	.	T	C	5	2	7	0	1	8	0	0
25	15472286	.	C	A	17	24	41	0	1	42	0	0
25	15477186	.	G	A	1	5	6	0	10	16	0	0
25	15478092	.	A	G	6	7	13	0	1	14	0	0
25	15480676	.	G	A	2	9	11	0	14	25	0	0
25	15480711	.	T	C	23	15	38	0	3	41	0	0
25	15481040	.	C	T	10	7	17	0	11	28	0	0
25	15481240	.	A	G	29	25	54	0	5	59	0	0
25	15481481	.	T	G	19	20	39	0	1	40	0	0
25	15481759	.	G	A	23	14	37	0	2	39	0	0
25	15648237	.	T	A	2	5	7	0	0	7	0	0
25	15648243	.	C	A	2	5	7	0	0	7	0	0
25	16963161	.	T	C	1	3	4	0	0	4	0	0
25	17479278	.	T	C	1	6	7	0	0	7	0	0
25	18908661	.	A	G	3	4	7	0	3	10	0	0
25	18977092	.	A	G	2	5	7	0	0	7	0	0
25	19121092	.	T	C	0	6	6	0	0	6	0	0
25	19192050	.	C	T	2	1	3	0	2	5	0	0
25	19356594	.	C	T	3	2	5	0	2	7	0	0
25	20669202	.	T	G	5	1	6	0	1	7	0	0
25	20726981	.	A	G	0	1	1	0	7	8	0	0
25	20998134	.	A	G	0	3	3	0	1	4	0	0
25	22095022	.	C	T	1	2	3	0	0	3	0	0
25	22095389	.	C	A	0	2	2	0	1	3	0	0
25	22232831	.	C	A	2	3	5	0	0	5	0	0
25	22232870	.	C	T	1	2	3	0	1	4	0	0
25	22291805	.	G	A	4	5	9	0	0	9	0	0
25	22292558	.	G	A	2	2	4	0	0	4	0	0
25	22633999	.	T	G	2	2	4	0	0	4	0	0
25	22635759	.	A	G	30	23	53	0	5	58	0	0
25	22635812	.	T	G	28	20	48	0	1	49	0	0
25	22636075	.	C	A	10	11	21	0	1	22	0	0
25	22636574	.	G	A	15	23	38	0	5	43	0	0
25	22636967	.	C	T	14	13	27	0	2	29	0	0
25	22637012	.	C	T	12	14	26	0	0	26	0	0
25	22637039	.	A	G	10	12	22	0	2	24	0	0
25	22637290	.	C	A	0	9	9	0	9	18	0	0
25	22637384	.	G	A	10	8	18	0	1	19	0	0
25	22637444	.	A	T	10	5	15	0	2	17	0	0
25	22637501	.	A	G	11	7	18	0	1	19	0	0
25	22637584	.	A	T	9	7	16	0	1	17	0	0
25	22637667	.	T	C	5	7	12	0	2	14	0	0
25	22637729	.	G	T	13	8	21	0	1	22	0	0
25	22637732	.	G	A	9	9	18	0	4	22	0	0
25	22637873	.	C	A	5	12	17	0	1	18	0	0
25	22639039	.	G	A	2	5	7	0	2	9	0	0
25	22979987	.	T	A	5	3	8	0	0	8	0	0
25	23555998	.	A	T	4	10	14	0	1	15	0	0
25	23556452	.	T	C	4	6	10	0	0	10	0	0
25	23562487	.	C	T	0	2	2	0	5	7	0	0
25	23571614	.	A	G	3	4	7	0	0	7	0	0
25	23630701	.	C	T	0	3	3	0	0	3	0	0
25	23643111	.	A	C	3	2	5	0	0	5	0	0
25	23643122	.	A	T	2	2	4	0	0	4	0	0
25	23643477	.	C	T	2	3	5	0	0	5	0	0
25	23777510	.	C	A	2	6	8	0	0	8	0	0
25	23777545	.	G	A	3	6	9	0	0	9	0	0
25	23815540	.	C	T	8	17	25	0	1	26	0	0
25	24181349	.	A	G	2	3	5	0	0	5	0	0
25	24181367	.	T	C	3	0	3	0	3	6	0	0
25	24192894	.	G	T	0	0	0	0	1	1	0	0
25	24236397	.	G	A	0	2	2	0	1	3	0	0
25	24237184	.	C	T	1	2	3	0	1	4	0	0
25	24237196	.	T	C	0	3	3	0	1	4	0	0
25	24237238	.	T	C	1	2	3	0	0	3	0	0
25	24237407	.	T	C	1	3	4	0	0	4	0	0
25	24237636	.	G	A	10	13	23	0	1	24	0	0
25	24238066	.	T	G	10	11	21	0	1	22	0	0
25	24238243	.	T	C	3	5	8	0	0	8	0	0
25	24240918	.	C	T	10	11	21	0	0	21	0	0
25	24241338	.	T	G	6	10	16	0	1	17	0	0
25	24241350	.	G	A	5	9	14	0	2	16	0	0
25	24242001	.	A	G	7	8	15	0	3	18	0	0
25	24242103	.	A	G	3	3	6	0	0	6	0	0
25	24242115	.	T	C	3	1	4	0	0	4	0	0
25	24247267	.	C	G	8	5	13	0	1	14	0	0
25	24247282	.	A	C	8	6	14	0	0	14	0	0
25	24247758	.	A	C	4	0	4	0	5	9	0	0
25	24247765	.	T	C	3	6	9	0	0	9	0	0
25	24247814	.	T	C	2	6	8	0	1	9	0	0
25	24247852	.	A	G	2	8	10	0	0	10	0	0
25	24247985	.	G	A	1	8	9	0	0	9	0	0
25	24593766	.	A	G	1	3	4	0	0	4	0	0
25	24596961	.	T	C	0	1	1	0	0	1	0	0
25	24596976	.	T	A	0	1	1	0	0	1	0	0
25	24605595	.	G	T	2	1	3	0	1	4	0	0
25	24605598	.	A	C	3	1	4	0	0	4	0	0
25	24609348	.	C	T	2	2	4	0	0	4	0	0
25	24609463	.	T	A	1	0	1	0	0	1	0	0
25	24610020	.	G	A	6	3	9	0	0	9	0	0
25	24610030	.	T	C	5	2	7	0	0	7	0	0
25	24719044	.	T	C	1	2	3	0	1	4	0	0
25	24720580	.	A	G	0	1	1	0	1	2	0	0
25	24720595	.	A	G	1	0	1	0	2	3	0	0
25	24723468	.	T	C	2	2	4	0	0	4	0	0
25	24736579	.	A	T	8	16	24	0	0	24	0	0
25	24736828	.	A	T	3	6	9	0	0	9	0	0
25	24736875	.	T	G	3	9	12	0	0	12	0	0
25	24736921	.	G	A	2	6	8	0	0	8	0	0
25	24737026	.	C	T	4	6	10	0	2	12	0	0
25	24737154	.	C	T	0	3	3	0	2	5	0	0
25	24737215	.	C	T	7	4	11	0	0	11	0	0
25	24737664	.	C	A	3	6	9	0	0	9	0	0
25	24737961	.	C	T	2	2	4	0	0	4	0	0
25	24738023	.	T	C	3	0	3	0	7	10	0	0
25	24738084	.	T	C	4	0	4	0	13	17	0	0
25	24738114	.	C	G	5	9	14	0	0	14	0	0
25	24738754	.	T	C	2	3	5	0	1	6	0	0
25	24738826	.	G	A	4	9	13	0	0	13	0	0
25	24739029	.	A	G	3	13	16	0	0	16	0	0
25	24752181	.	A	G	7	3	10	0	2	12	0	0
25	24763746	.	A	G	0	1	1	0	0	1	0	0
25	24763755	.	G	T	1	1	2	0	0	2	0	0
25	24792647	.	C	A	3	3	6	0	0	6	0	0
25	24805912	.	T	A	2	1	3	0	1	4	0	0
25	25124779	.	A	T	3	5	8	0	0	8	0	0
25	25127090	.	C	T	4	5	9	0	0	9	0	0
25	25127250	.	A	G	7	13	20	0	0	20	0	0
25	25130648	.	C	T	21	23	44	0	2	46	0	0
25	25130693	.	C	T	19	29	48	0	3	51	0	0
25	25130747	.	C	T	23	23	46	0	3	49	0	0
25	25130782	.	G	A	22	21	43	0	3	46	0	0
25	25130908	.	C	T	30	13	43	0	1	44	0	0
25	25130924	.	T	C	29	15	44	0	1	45	0	0
25	25130968	.	C	T	18	21	39	0	2	41	0	0
25	25131274	.	A	G	13	18	31	0	1	32	0	0
25	25131298	.	A	T	16	22	38	0	2	40	0	0
25	25131389	.	A	T	26	28	54	0	0	54	0	0
25	25131464	.	G	A	22	12	34	0	0	34	0	0
25	25131631	.	C	T	30	22	52	0	3	56	1	0
25	25131710	.	A	G	21	16	37	0	2	39	0	0
25	25132985	.	C	T	11	5	16	0	1	17	0	0
25	25133030	.	G	A	12	7	19	0	0	19	0	0
25	25133123	.	T	G	15	8	23	0	3	26	0	0
25	25133171	.	A	G	15	9	24	0	1	25	0	0
25	25133353	.	G	A	5	10	15	0	1	16	0	0
25	25133365	.	T	A	6	11	17	0	1	18	0	0
25	25133509	.	A	G	2	4	6	0	0	6	0	0
25	25396237	.	T	C	8	11	19	0	2	21	0	0
25	25396295	.	T	C	1	1	2	0	1	3	0	0
25	25536394	.	C	A	1	1	2	0	0	2	0	0
25	25538206	.	G	T	1	3	4	0	0	4	0	0
25	25538354	.	T	A	4	3	7	0	0	7	0	0
25	25538440	.	T	G	2	3	5	0	0	5	0	0
25	25539028	.	G	A	2	3	5	0	0	5	0	0
25	25539270	.	C	A	5	3	8	0	0	9	1	0
25	25539434	.	G	A	0	3	3	0	2	5	0	0
25	25539723	.	C	A	6	6	12	0	2	14	0	0
25	25539783	.	G	C	2	7	9	0	0	9	0	0
25	25539800	.	A	G	4	6	10	0	1	11	0	0
25	25539834	.	A	T	2	7	9	0	2	11	0	0
25	25540058	.	T	A	3	7	10	0	0	10	0	0
25	25540060	.	G	A	3	7	10	0	0	10	0	0
25	25540181	.	A	T	2	4	6	0	0	6	0	0
25	25540245	.	A	G	6	5	11	0	0	11	0	0
25	25540444	.	T	C	3	4	7	0	0	7	0	0
25	25540954	.	G	A	12	7	19	0	1	20	0	0
25	25545131	.	T	C	9	5	14	0	1	15	0	0
25	25545149	.	G	C	8	7	15	0	0	15	0	0
25	25545365	.	G	C	10	5	15	0	1	16	0	0
25	25545420	.	G	A	0	3	3	0	9	12	0	0
25	25545989	.	G	C	1	6	7	0	0	7	0	0
25	25546053	.	G	A	1	6	7	0	1	8	0	0
25	25547137	.	C	A	2	3	5	0	1	6	0	0
25	25547150	.	T	A	2	3	5	0	0	5	0	0
25	25547228	.	G	A	1	4	5	0	0	5	0	0
25	25548032	.	G	T	2	2	4	0	0	4	0	0
25	25548076	.	T	A	1	3	4	0	0	4	0	0
25	25736865	.	T	C	2	0	2	0	7	9	0	0
25	25806264	.	C	T	10	2	12	0	0	12	0	0
25	25823529	.	T	C	5	6	11	0	0	11	0	0
25	25829020	.	T	C	5	6	11	0	0	11	0	0
25	26673233	.	A	G	0	3	3	0	0	3	0	0
25	26823607	.	T	C	2	0	2	0	0	2	0	0
25	26829266	.	G	T	2	8	10	0	0	10	0	0
25	26832141	.	A	G	2	0	2	0	0	2	0	0
25	26840452	.	G	T	7	5	12	0	3	15	0	0
25	26840480	.	T	G	7	9	16	0	1	17	0	0
25	26840919	.	G	A	1	2	3	0	1	4	0	0
25	26867671	.	A	T	1	2	3	0	0	3	0	0
25	26867682	.	G	T	2	1	3	0	0	3	0	0
25	26867832	.	T	A	2	2	4	0	0	4	0	0
25	26877783	.	A	T	10	15	25	0	0	25	0	0
25	26877865	.	A	T	17	9	26	0	1	27	0	0
25	26879592	.	T	C	5	6	11	0	0	11	0	0
25	26884286	.	G	A	7	6	13	0	0	13	0	0
25	26884407	.	C	T	4	2	6	0	1	7	0	0
25	26888170	.	A	G	1	3	4	0	0	4	0	0
25	26909101	.	C	T	3	2	5	0	0	5	0	0
25	26909197	.	G	A	6	4	10	0	0	10	0	0
25	26909269	.	A	G	6	3	9	0	0	9	0	0
25	26909392	.	A	T	6	11	17	0	0	17	0	0
25	26909618	.	A	C	6	4	10	0	1	11	0	0
25	26911216	.	C	T	2	3	5	0	0	5	0	0
25	26911554	.	T	A	9	7	16	0	1	17	0	0
25	26911605	.	C	A	4	9	13	0	0	13	0	0
25	26911768	.	A	G	3	6	9	0	2	11	0	0
25	26911792	.	G	A	5	4	9	0	0	9	0	0
25	26912037	.	C	T	7	9	16	0	0	16	0	0
25	26912062	.	C	T	3	5	8	0	0	8	0	0
25	27174065	.	C	T	2	2	4	0	0	4	0	0
25	27210906	.	T	C	21	10	31	0	2	33	0	0
25	27237022	.	A	G	4	7	11	0	2	13	0	0
25	27491669	.	C	T	2	0	2	0	0	2	0	0
25	27491679	.	A	G	2	0	2	0	0	2	0	0
25	27494536	.	G	A	1	2	3	0	0	3	0	0
25	27499385	.	T	C	2	2	4	0	0	4	0	0
25	27500038	.	C	A	3	2	5	0	1	6	0	0
25	27718698	.	A	G	0	5	5	0	0	5	0	0
25	27744408	.	C	A	1	3	4	0	2	6	0	0
25	27795017	.	A	G	8	3	11	0	2	13	0	0
25	27795083	.	C	T	1	5	6	0	4	10	0	0
25	27801873	.	T	G	1	0	1	0	15	16	0	0
25	27801876	.	A	C	2	1	3	0	12	15	0	0
25	27802122	.	C	A	9	11	20	0	0	20	0	0
25	27802149	.	G	A	1	7	8	0	1	9	0	0
25	27811761	.	C	T	17	10	27	0	2	29	0	0
25	28640724	.	T	G	18	22	40	0	12	52	0	0
25	28640890	.	T	G	18	22	40	0	2	42	0	0
25	28641207	.	A	T	4	8	12	0	3	16	1	0
25	28641261	.	T	A	12	16	28	0	1	29	0	0
25	28641321	.	T	G	19	15	34	0	1	35	0	0
25	28648067	.	T	C	1	0	1	0	0	1	0	0
25	28648078	.	A	G	1	7	8	0	1	9	0	0
25	28650764	.	T	A	8	6	14	0	0	14	0	0
25	28655056	.	G	A	1	0	1	0	0	1	0	0
25	28661185	.	C	T	3	3	6	0	0	6	0	0
25	28661227	.	T	C	6	10	16	0	2	18	0	0
25	28661351	.	G	A	10	10	20	0	0	20	0	0
25	28661626	.	G	A	4	3	7	0	2	9	0	0
25	28665446	.	T	A	5	6	11	0	1	12	0	0
25	28665464	.	A	C	4	6	10	0	0	10	0	0
25	28668001	.	G	A	1	1	2	0	0	2	0	0
25	28668723	.	C	A	7	8	15	0	1	16	0	0
25	28714616	.	A	G	9	3	12	0	1	13	0	0
25	28715206	.	A	T	8	4	12	0	1	13	0	0
25	28715221	.	G	A	8	3	11	0	0	11	0	0
25	28715605	.	C	G	0	2	2	0	4	6	0	0
25	28716206	.	G	A	6	2	8	0	0	8	0	0
25	28719957	.	T	G	2	0	2	0	0	2	0	0
25	28726537	.	C	A	0	1	1	0	2	3	0	0
25	28736679	.	C	T	0	2	2	0	0	2	0	0
25	28736893	.	A	G	1	0	1	0	0	1	0	0
25	28740295	.	A	T	1	0	1	0	0	1	0	0
25	28752579	.	C	T	0	2	2	0	1	3	0	0
25	28825652	.	G	C	0	1	1	0	0	1	0	0
25	28846383	.	G	T	0	6	6	0	16	22	0	0
25	28893665	.	T	A	4	5	9	0	1	10	0	0
25	28893713	.	C	A	6	7	13	0	2	15	0	0
25	28893956	.	C	T	6	5	11	0	0	11	0	0
25	28903105	.	A	C	7	3	10	0	0	10	0	0
25	29076852	.	T	A	2	0	2	0	0	2	0	0
25	29080112	.	G	A	0	7	7	0	1	8	0	0
25	29083827	.	T	A	1	5	6	0	0	6	0	0
25	29084154	.	G	A	3	2	5	0	0	5	0	0
25	29109251	.	G	A	1	0	1	0	0	1	0	0
25	29110052	.	A	G	0	1	1	0	0	1	0	0
25	29212302	.	C	T	0	2	2	0	1	3	0	0
25	29212835	.	A	T	1	3	4	0	0	4	0	0
25	29212851	.	G	T	1	3	4	0	0	4	0	0
25	29319097	.	A	G	29	30	59	0	5	64	0	0
25	29319239	.	A	T	22	20	42	0	5	47	0	0
25	29319706	.	T	C	33	5	38	0	29	67	0	0
25	29319712	.	A	G	34	25	59	0	4	63	0	0
25	29319831	.	A	G	29	21	50	0	1	51	0	0
25	29319849	.	G	A	22	11	33	0	4	37	0	0
25	29329949	.	A	G	17	27	44	0	4	48	0	0
25	29427959	.	A	C	8	3	11	0	5	16	0	0
25	29427963	.	A	C	8	4	12	0	4	16	0	0
25	29428094	.	A	G	23	16	39	0	3	42	0	0
25	29428300	.	C	A	18	17	35	0	2	37	0	0
25	29428638	.	A	G	17	17	34	0	2	36	0	0
25	29428806	.	T	A	12	12	24	0	2	26	0	0
25	29428963	.	G	A	15	18	33	0	3	36	0	0
25	29429420	.	G	A	14	19	33	0	2	35	0	0
25	29429569	.	T	C	9	0	9	0	9	18	0	0
25	29429589	.	G	T	8	10	18	0	2	20	0	0
25	29429710	.	G	A	3	0	3	0	4	7	0	0
25	29429732	.	A	T	6	6	12	0	2	14	0	0
25	29429984	.	T	C	7	0	7	0	10	17	0	0
25	29662436	.	C	A	2	2	4	0	0	4	0	0
25	29663116	.	T	G	2	1	3	0	1	4	0	0
25	29665705	.	G	A	0	7	7	0	11	18	0	0
25	29666299	.	A	G	25	6	31	0	1	32	0	0
25	29666607	.	G	T	2	4	6	0	1	7	0	0
25	29666640	.	T	A	5	6	11	0	0	11	0	0
25	29666797	.	T	A	6	5	11	0	0	11	0	0
25	29694824	.	A	C	1	3	4	0	0	4	0	0
25	29696881	.	A	G	1	1	2	0	1	3	0	0
25	29698784	.	C	T	5	3	8	0	1	9	0	0
25	29698922	.	A	T	4	2	6	0	1	7	0	0
25	29699018	.	G	A	0	1	1	0	0	1	0	0
25	29699227	.	T	C	1	3	4	0	0	4	0	0
25	29699236	.	A	T	1	2	3	0	0	3	0	0
25	29701710	.	G	A	0	1	1	0	0	1	0	0
25	29711597	.	A	T	5	3	8	0	1	9	0	0
25	29711754	.	C	A	8	5	13	0	0	13	0	0
25	31248117	.	T	C	1	0	1	0	0	1	0	0
25	31248118	.	T	C	1	0	1	0	0	1	0	0
25	32216389	.	A	G	1	0	1	0	5	6	0	0
25	32739551	.	C	T	2	2	4	0	3	7	0	0
25	33121219	.	T	C	2	0	2	0	1	3	0	0
25	33145031	.	C	T	1	1	2	0	0	2	0	0
25	33225248	.	A	G	5	9	14	0	0	14	0	0
25	33225287	.	G	A	8	10	18	0	1	19	0	0
25	33238303	.	G	A	2	2	4	0	0	4	0	0
25	33242605	.	A	T	5	5	10	0	1	11	0	0
25	33242606	.	T	G	6	3	9	0	2	11	0	0
25	33249640	.	C	T	14	4	18	0	3	21	0	0
25	33249905	.	T	G	15	19	34	0	1	35	0	0
25	33250017	.	C	A	8	9	17	0	0	17	0	0
25	33250053	.	A	G	11	10	21	0	1	22	0	0
25	33256212	.	C	A	1	2	3	0	0	3	0	0
25	33258739	.	G	A	0	2	2	0	5	7	0	0
25	33258745	.	T	G	4	0	4	0	2	6	0	0
25	33262180	.	A	G	3	6	9	0	0	9	0	0
25	33265814	.	C	T	6	6	12	0	1	13	0	0
25	33265898	.	C	T	3	6	9	0	0	9	0	0
25	33266029	.	G	A	4	10	14	0	1	15	0	0
25	33266157	.	A	C	4	5	9	0	0	9	0	0
25	33962809	.	G	A	0	3	3	0	4	7	0	0
25	33963168	.	C	A	3	6	9	0	0	9	0	0
25	33963427	.	A	T	1	4	5	0	0	5	0	0
25	33964962	.	A	G	5	4	9	0	0	9	0	0
25	33964968	.	A	G	3	4	7	0	3	10	0	0
25	33965016	.	C	A	2	5	7	0	1	8	0	0
25	33965414	.	A	T	7	5	12	0	0	12	0	0
25	33965518	.	G	T	8	2	10	0	0	10	0	0
25	33965541	.	C	T	6	5	11	0	0	11	0	0
25	33965695	.	C	T	5	3	8	0	1	9	0	0
25	33965786	.	T	C	3	3	6	0	0	6	0	0
25	33965974	.	A	C	4	4	8	0	0	8	0	0
25	33966100	.	G	A	5	3	8	0	3	11	0	0
25	33966251	.	T	G	10	8	18	0	0	18	0	0
25	33966731	.	T	C	8	6	14	0	2	16	0	0
25	33966854	.	C	T	5	6	11	0	0	11	0	0
25	33966969	.	T	A	2	1	3	0	1	4	0	0
25	33967133	.	T	A	8	7	15	0	2	17	0	0
25	33967361	.	A	G	17	8	25	0	1	26	0	0
25	33967495	.	T	C	11	4	15	0	1	16	0	0
25	33967695	.	T	C	4	5	9	0	0	9	0	0
25	33967791	.	C	T	10	13	23	0	0	23	0	0
25	33967803	.	G	A	11	11	22	0	1	23	0	0
25	33968091	.	C	T	13	13	26	0	0	26	0	0
25	33968470	.	T	A	12	7	19	0	3	22	0	0
25	33968691	.	A	G	16	15	31	0	1	32	0	0
25	33968842	.	G	C	26	22	48	0	3	51	0	0
25	33968857	.	C	T	20	21	41	0	3	44	0	0
25	33968881	.	T	A	22	14	36	0	1	37	0	0
25	33983108	.	G	A	2	3	5	0	0	5	0	0
25	34000414	.	A	G	0	1	1	0	1	2	0	0
25	34002778	.	A	G	9	0	9	0	5	14	0	0
25	34002784	.	T	C	10	4	14	0	0	14	0	0
25	34002853	.	T	C	2	3	5	0	0	5	0	0
25	34018537	.	C	T	2	3	5	0	0	5	0	0
25	34022288	.	T	C	0	4	4	0	2	6	0	0
25	34022309	.	T	C	1	5	6	0	0	6	0	0
25	34027086	.	A	T	7	10	17	0	1	18	0	0
25	34027215	.	C	A	8	9	17	0	0	17	0	0
25	34027263	.	G	T	7	7	14	0	0	14	0	0
25	34154496	.	A	T	8	9	17	0	3	20	0	0
25	34154540	.	T	G	13	11	24	0	1	25	0	0
25	34154678	.	G	A	22	17	39	0	1	40	0	0
25	34257427	.	T	C	1	1	2	0	0	2	0	0
25	34257433	.	G	A	1	1	2	0	0	2	0	0
25	34260835	.	T	C	1	0	1	0	1	2	0	0
25	34268155	.	A	C	0	2	2	0	1	3	0	0
25	34663894	.	T	C	1	2	3	0	0	3	0	0
25	34911352	.	A	G	1	4	5	0	0	5	0	0
25	34956661	.	T	C	3	1	4	0	0	4	0	0
25	34973070	.	C	T	4	3	7	0	0	7	0	0
25	34973090	.	C	A	3	2	5	0	0	5	0	0
25	34979406	.	C	T	1	2	3	0	0	3	0	0
25	35002394	.	G	A	19	26	45	0	5	50	0	0
25	35005362	.	G	A	10	8	18	0	1	19	0	0
25	35006830	.	G	A	0	17	17	0	21	38	0	0
25	35006989	.	C	T	18	15	33	0	2	35	0	0
25	35007857	.	C	T	6	4	10	0	1	11	0	0
25	35007864	.	G	A	7	8	15	0	0	15	0	0
25	35270407	.	A	G	3	1	4	0	1	5	0	0
25	35680972	.	T	C	2	2	4	0	0	4	0	0
25	35713260	.	G	A	3	2	5	0	0	5	0	0
25	35713263	.	G	C	2	2	4	0	1	5	0	0
25	36199100	.	T	C	12	6	18	0	3	21	0	0
25	37336710	.	A	G	2	4	6	0	0	6	0	0
3	13937	.	C	T	0	2	2	0	0	2	0	0
3	13952	.	T	C	2	2	4	0	0	4	0	0
3	1192748	.	A	G	17	9	26	0	2	28	0	0
3	1323776	.	A	C	2	4	6	0	1	7	0	0
3	1323879	.	T	A	10	5	15	0	0	15	0	0
3	1324064	.	C	A	13	8	21	0	1	22	0	0
3	1324281	.	G	T	11	4	15	0	0	15	0	0
3	1324383	.	G	C	2	0	2	0	6	8	0	0
3	1324509	.	C	A	3	9	12	0	0	12	0	0
3	1324515	.	C	T	4	10	14	0	1	15	0	0
3	1324688	.	T	C	13	8	21	0	1	22	0	0
3	1337593	.	A	G	7	4	11	0	0	11	0	0
3	1339147	.	T	A	0	3	3	0	0	3	0	0
3	3610185	.	C	A	1	2	3	0	0	3	0	0
3	3610202	.	A	T	1	2	3	0	0	3	0	0
3	3630587	.	T	C	0	1	1	0	0	1	0	0
3	3631407	.	T	C	8	5	13	0	0	13	0	0
3	4465966	.	T	C	1	3	4	0	0	4	0	0
3	4502158	.	C	A	1	1	2	0	0	2	0	0
3	4506897	.	A	G	1	3	4	0	0	4	0	0
3	4506961	.	G	A	0	0	0	0	1	1	0	0
3	4508042	.	A	C	1	6	7	0	0	7	0	0
3	4508093	.	C	A	3	3	6	0	2	8	0	0
3	4508120	.	C	T	3	0	3	0	0	3	0	0
3	4511052	.	T	C	2	3	5	0	0	5	0	0
3	4514030	.	G	A	0	1	1	0	0	1	0	0
3	4516925	.	C	A	0	2	2	0	0	2	0	0
3	4530061	.	G	A	2	3	5	0	0	5	0	0
3	4530118	.	T	A	5	7	12	0	0	12	0	0
3	4997623	.	C	T	1	2	3	0	0	3	0	0
3	5012832	.	C	G	0	3	3	0	3	6	0	0
3	5021432	.	G	A	7	2	9	0	0	9	0	0
3	5021453	.	C	T	0	13	13	0	6	19	0	0
3	5040757	.	A	G	3	2	5	0	0	5	0	0
3	5040777	.	G	A	0	3	3	0	0	3	0	0
3	5052823	.	T	G	3	9	12	0	0	12	0	0
3	5052868	.	G	A	3	7	10	0	1	11	0	0
3	5053060	.	C	T	0	21	21	0	13	34	0	0
3	5053454	.	T	A	9	19	28	0	2	30	0	0
3	5053934	.	G	A	10	16	26	0	0	26	0	0
3	5053988	.	C	G	10	10	20	0	1	21	0	0
3	5056247	.	G	A	10	10	20	0	3	23	0	0
3	5062827	.	C	T	0	1	1	0	1	2	0	0
3	5063125	.	G	A	4	13	17	0	1	18	0	0
3	5063176	.	G	A	6	0	6	0	0	6	0	0
3	5067581	.	T	A	7	5	12	0	0	12	0	0
3	5130851	.	T	C	1	2	3	0	0	3	0	0
3	5134113	.	G	A	0	2	2	0	1	3	0	0
3	5134122	.	G	A	4	0	4	0	0	4	0	0
3	5134669	.	T	C	4	4	8	0	0	8	0	0
3	5136617	.	G	A	2	2	4	0	1	5	0	0
3	5141035	.	C	T	4	3	7	0	1	8	0	0
3	5141152	.	C	T	4	3	7	0	0	7	0	0
3	5143522	.	C	T	0	5	5	0	0	5	0	0
3	5147544	.	G	A	2	2	4	0	0	4	0	0
3	5150391	.	G	A	0	2	2	0	0	2	0	0
3	5152715	.	T	C	1	1	2	0	0	2	0	0
3	5265754	.	C	T	5	13	18	0	3	21	0	0
3	5267221	.	G	A	8	5	13	0	0	13	0	0
3	5267251	.	C	T	13	7	20	0	0	20	0	0
3	5270274	.	C	T	0	9	9	0	13	22	0	0
3	5624487	.	C	T	0	2	2	0	7	9	0	0
3	5633056	.	A	G	7	11	18	0	0	18	0	0
3	5633089	.	G	A	10	7	17	0	1	18	0	0
3	5633122	.	A	G	9	7	16	0	1	17	0	0
3	5634976	.	A	G	9	4	13	0	1	14	0	0
3	5637213	.	A	C	1	8	9	0	1	10	0	0
3	5637222	.	A	G	1	6	7	0	0	7	0	0
3	5723632	.	A	G	1	1	2	0	0	2	0	0
3	5723652	.	A	T	1	1	2	0	0	2	0	0
3	5778981	.	G	A	13	16	29	0	2	31	0	0
3	5779044	.	T	A	12	17	29	0	0	29	0	0
3	5779093	.	G	T	16	13	29	0	1	30	0	0
3	5782501	.	A	G	1	2	3	0	2	5	0	0
3	5782715	.	A	G	1	1	2	0	0	2	0	0
3	5812205	.	C	T	2	0	2	0	1	3	0	0
3	5814475	.	C	T	0	6	6	0	0	6	0	0
3	5814478	.	C	T	0	5	5	0	1	6	0	0
3	5823477	.	G	A	3	4	7	0	1	8	0	0
3	5823483	.	C	A	0	5	5	0	3	8	0	0
3	5824826	.	T	C	0	1	1	0	0	1	0	0
3	5824858	.	C	T	1	2	3	0	0	3	0	0
3	5824870	.	C	T	1	2	3	0	0	3	0	0
3	5829415	.	A	G	5	5	10	0	0	10	0	0
3	5886917	.	C	T	0	16	16	0	30	46	0	0
3	5887223	.	T	C	13	10	23	0	1	24	0	0
3	5887463	.	T	G	10	15	25	0	1	26	0	0
3	5887661	.	A	T	9	14	23	0	1	24	0	0
3	5887673	.	G	C	10	0	10	0	16	26	0	0
3	5887715	.	T	C	9	16	25	0	1	26	0	0
3	5887841	.	T	A	9	14	23	0	5	28	0	0
3	5887931	.	A	T	12	7	19	0	1	20	0	0
3	5888245	.	C	T	10	10	20	0	3	23	0	0
3	5888664	.	G	A	6	6	12	0	3	15	0	0
3	5888868	.	G	A	6	7	13	0	1	14	0	0
3	5889077	.	G	T	5	6	11	0	1	12	0	0
3	5889642	.	A	T	0	3	3	0	0	3	0	0
3	5890274	.	T	A	5	4	9	0	0	9	0	0
3	5890287	.	A	G	5	4	9	0	1	10	0	0
3	5890833	.	G	A	2	2	4	0	0	4	0	0
3	5908262	.	C	T	2	3	5	0	0	5	0	0
3	5964113	.	G	A	1	1	2	0	0	2	0	0
3	6380368	.	T	C	12	20	32	0	1	33	0	0
3	6417172	.	G	A	12	16	28	0	2	30	0	0
3	6474593	.	A	G	1	2	3	0	0	3	0	0
3	6477596	.	G	C	3	4	7	0	0	7	0	0
3	6490987	.	C	T	3	2	5	0	0	5	0	0
3	6491011	.	T	G	3	4	7	0	0	7	0	0
3	6491540	.	C	T	2	3	5	0	2	7	0	0
3	6491542	.	G	T	3	3	6	0	1	7	0	0
3	6491881	.	G	T	4	4	8	0	0	8	0	0
3	6491906	.	T	C	2	3	5	0	2	7	0	0
3	6498049	.	C	G	0	2	2	0	2	4	0	0
3	6502039	.	G	A	1	1	2	0	0	2	0	0
3	6607975	.	C	T	4	2	6	0	0	6	0	0
3	6607976	.	A	G	4	2	6	0	0	6	0	0
3	6664173	.	G	A	1	0	1	0	1	2	0	0
3	6664603	.	A	G	0	3	3	0	0	3	0	0
3	6664609	.	T	C	2	4	6	0	0	6	0	0
3	6664915	.	A	G	3	2	5	0	0	5	0	0
3	6665479	.	A	G	1	1	2	0	1	3	0	0
3	6665874	.	C	G	3	0	3	0	7	10	0	0
3	6665902	.	G	T	5	9	14	0	0	14	0	0
3	6665951	.	C	A	4	2	6	0	1	7	0	0
3	6665985	.	A	T	1	3	4	0	0	4	0	0
3	6666027	.	C	T	3	2	5	0	0	5	0	0
3	6666080	.	A	G	6	2	8	0	0	8	0	0
3	6666092	.	T	C	3	7	10	0	0	10	0	0
3	6666194	.	G	C	8	8	16	0	1	17	0	0
3	6666283	.	A	T	8	7	15	0	0	15	0	0
3	6666342	.	A	G	7	3	10	0	0	10	0	0
3	6666362	.	G	A	4	6	10	0	0	10	0	0
3	6667060	.	G	C	17	8	25	0	4	29	0	0
3	6667209	.	C	T	9	8	17	0	2	19	0	0
3	6669511	.	C	T	0	3	3	0	0	3	0	0
3	6721278	.	A	G	2	10	12	0	1	13	0	0
3	6721286	.	G	C	2	10	12	0	0	12	0	0
3	6721421	.	T	G	5	16	21	0	1	22	0	0
3	6721456	.	A	T	7	10	17	0	1	18	0	0
3	6721497	.	T	A	5	9	14	0	3	17	0	0
3	6721504	.	A	T	7	8	15	0	2	17	0	0
3	6721763	.	T	C	2	3	5	0	0	5	0	0
3	6721773	.	T	G	4	4	8	0	0	8	0	0
3	6721851	.	C	T	4	7	11	0	0	11	0	0
3	6722021	.	T	A	5	10	15	0	0	15	0	0
3	6722070	.	C	G	4	4	8	0	1	9	0	0
3	6722333	.	C	A	7	3	10	0	3	13	0	0
3	6722341	.	G	A	6	6	12	0	1	13	0	0
3	6722401	.	T	C	5	6	11	0	1	12	0	0
3	6722438	.	C	T	3	3	6	0	0	6	0	0
3	6723257	.	A	G	7	3	10	0	0	10	0	0
3	6725130	.	C	T	4	1	5	0	0	5	0	0
3	6725150	.	G	C	1	1	2	0	1	3	0	0
3	6726284	.	A	T	1	4	5	0	0	5	0	0
3	6731289	.	G	T	0	1	1	0	0	1	0	0
3	6895657	.	C	G	1	2	3	0	0	3	0	0
3	7008290	.	C	T	1	5	6	0	0	6	0	0
3	7008415	.	C	T	4	2	6	0	0	6	0	0
3	7099160	.	A	G	1	6	7	0	1	8	0	0
3	7099210	.	T	C	0	5	5	0	1	6	0	0
3	7099285	.	G	T	1	5	6	0	0	6	0	0
3	7099344	.	A	G	2	3	5	0	0	5	0	0
3	7099380	.	C	T	3	3	6	0	0	6	0	0
3	7099600	.	T	C	2	2	4	0	0	4	0	0
3	7112990	.	C	T	0	10	10	0	6	16	0	0
3	7113036	.	G	T	4	11	15	0	1	16	0	0
3	7113075	.	T	G	4	8	12	0	0	12	0	0
3	7113126	.	A	G	2	6	8	0	0	8	0	0
3	7113327	.	T	C	5	0	5	0	7	12	0	0
3	7113330	.	T	C	4	5	9	0	2	11	0	0
3	7113424	.	G	C	2	4	6	0	1	7	0	0
3	7113433	.	T	C	2	4	6	0	2	8	0	0
3	7113669	.	C	T	0	1	1	0	0	1	0	0
3	7113720	.	G	A	1	5	6	0	0	6	0	0
3	7113821	.	A	T	3	2	5	0	1	6	0	0
3	7113822	.	A	G	4	2	6	0	0	6	0	0
3	7124056	.	A	G	2	0	2	1	0	3	0	0
3	7124659	.	C	T	2	2	4	0	0	4	0	0
3	7133435	.	T	G	1	4	5	0	0	5	0	0
3	7133925	.	T	C	1	2	3	0	0	3	0	0
3	7133967	.	G	A	1	5	6	0	1	7	0	0
3	7134079	.	T	G	4	2	6	0	0	6	0	0
3	7141369	.	T	C	1	4	5	0	2	7	0	0
3	7141527	.	G	T	2	6	8	0	0	8	0	0
3	7141562	.	A	T	2	2	4	0	0	4	0	0
3	7142350	.	A	G	1	3	4	0	0	4	0	0
3	7142372	.	C	G	2	3	5	0	0	5	0	0
3	7155012	.	T	C	2	0	2	0	6	8	0	0
3	7155039	.	T	C	2	6	8	0	2	10	0	0
3	7155156	.	C	T	0	3	3	0	2	5	0	0
3	7155196	.	T	A	3	11	14	0	0	14	0	0
3	7155198	.	A	G	3	6	9	0	5	14	0	0
3	7155428	.	G	A	4	9	13	0	2	15	0	0
3	7156035	.	C	T	3	4	7	0	0	7	0	0
3	7156141	.	C	T	0	1	1	0	0	1	0	0
3	7509845	.	C	G	0	2	2	0	3	5	0	0
3	7510019	.	G	A	1	2	3	0	0	3	0	0
3	7510054	.	G	A	3	2	5	0	0	5	0	0
3	7638208	.	A	T	1	2	3	0	0	3	0	0
3	7819497	.	A	G	3	3	6	0	0	6	0	0
3	7819498	.	A	G	4	2	6	0	0	6	0	0
3	7819722	.	A	G	1	2	3	0	0	3	0	0
3	11575354	.	G	A	0	1	1	0	1	2	0	0
3	11585815	.	A	G	13	7	20	0	1	21	0	0
3	11585852	.	T	A	14	10	24	0	1	25	0	0
3	11585937	.	G	A	9	13	22	0	4	26	0	0
3	11586217	.	G	A	8	3	11	0	1	12	0	0
3	11586331	.	C	T	2	11	13	0	23	36	0	0
3	11586346	.	C	T	20	13	33	0	2	35	0	0
3	11586382	.	G	A	21	17	38	0	1	39	0	0
3	11586635	.	A	G	22	5	27	0	5	32	0	0
3	11586679	.	C	T	14	11	25	0	0	25	0	0
3	11586695	.	C	T	0	9	9	0	9	18	0	0
3	11590280	.	A	G	4	9	13	0	2	15	0	0
3	11614970	.	T	C	2	1	3	0	1	4	0	0
3	11615007	.	A	T	9	4	13	0	4	17	0	0
3	11615109	.	G	A	18	10	28	0	2	30	0	0
3	11615133	.	A	G	19	8	27	0	3	30	0	0
3	11615224	.	A	G	13	11	24	0	0	24	0	0
3	11624298	.	A	G	13	8	21	0	1	22	0	0
3	11781003	.	A	C	9	9	18	2	1	23	2	0
3	11781079	.	T	C	14	1	15	1	0	16	0	0
3	11781113	.	G	A	17	12	29	0	2	31	0	0
3	11784743	.	G	A	14	12	26	0	4	30	0	0
3	11797076	.	C	T	0	2	2	0	3	5	0	0
3	11934018	.	G	A	3	9	12	0	0	12	0	0
3	11934021	.	T	C	2	6	8	0	2	10	0	0
3	11934072	.	C	T	1	1	2	0	0	2	0	0
3	11937063	.	G	A	6	4	10	0	1	11	0	0
3	11937093	.	T	C	1	2	3	0	0	3	0	0
3	11937295	.	C	T	5	4	9	0	1	10	0	0
3	11941226	.	A	C	1	1	2	0	0	2	0	0
3	11947012	.	A	G	20	1	21	0	9	30	0	0
3	11947323	.	C	G	8	6	14	0	1	15	0	0
3	11947401	.	A	T	6	9	15	0	0	15	0	0
3	12345351	.	T	C	8	11	19	0	1	20	0	0
3	12345373	.	G	T	10	14	24	0	0	24	0	0
3	12349672	.	A	G	7	6	13	0	2	15	0	0
3	12647220	.	G	T	2	3	5	0	0	5	0	0
3	12647229	.	A	G	2	3	5	0	0	5	0	0
3	12647256	.	C	T	2	3	5	0	0	5	0	0
3	12672068	.	C	T	4	2	6	0	0	6	0	0
3	12672195	.	C	A	1	1	2	0	0	2	0	0
3	12681359	.	G	A	10	3	13	0	0	13	0	0
3	12689490	.	T	C	3	3	6	0	0	6	0	0
3	12689613	.	T	A	3	1	4	0	1	5	0	0
3	12691823	.	C	A	8	3	11	0	0	11	0	0
3	12692858	.	G	T	13	4	17	0	1	18	0	0
3	12692859	.	T	G	13	5	18	0	0	18	0	0
3	12698831	.	A	T	11	10	21	0	1	22	0	0
3	12698890	.	T	C	12	10	22	0	4	26	0	0
3	12698897	.	A	G	13	11	24	0	2	26	0	0
3	12698976	.	C	A	5	10	15	0	5	20	0	0
3	12699026	.	T	A	8	7	15	0	1	16	0	0
3	12699044	.	T	C	12	6	18	0	1	19	0	0
3	12699073	.	T	A	12	6	18	0	1	19	0	0
3	12699260	.	A	G	9	10	19	0	0	19	0	0
3	12699274	.	C	T	9	12	21	0	0	21	0	0
3	12699311	.	A	T	15	12	27	0	0	27	0	0
3	12699525	.	C	T	18	7	25	0	0	25	0	0
3	12699645	.	G	C	19	15	34	0	2	36	0	0
3	12699662	.	C	T	19	13	32	0	3	35	0	0
3	13860363	.	G	A	5	5	10	0	1	11	0	0
3	14450993	.	A	G	5	13	18	0	3	21	0	0
3	14451012	.	A	G	6	14	20	0	0	20	0	0
3	14507505	.	A	G	3	2	5	0	0	5	0	0
3	14507517	.	A	G	3	1	4	0	1	5	0	0
3	14580598	.	A	C	3	3	6	0	0	6	0	0
3	14598409	.	C	T	1	1	2	0	0	2	0	0
3	14605750	.	T	C	2	8	10	0	0	10	0	0
3	14605813	.	G	A	1	2	3	0	1	4	0	0
3	14692201	.	T	C	19	22	41	0	2	43	0	0
3	14692204	.	T	C	18	1	19	0	23	42	0	0
3	14694835	.	G	A	17	18	35	0	1	36	0	0
3	15020506	.	C	T	4	4	8	0	0	8	0	0
3	15020548	.	T	A	2	5	7	0	0	7	0	0
3	15020572	.	C	T	0	2	2	0	0	2	0	0
3	15041084	.	T	C	5	2	7	0	0	7	0	0
3	15057191	.	A	T	8	4	12	0	2	14	0	0
3	15057321	.	T	C	7	8	15	0	0	15	0	0
3	15057538	.	C	T	6	14	20	0	0	20	0	0
3	15057696	.	T	C	5	4	9	0	0	9	0	0
3	15057697	.	G	T	5	4	9	0	0	9	0	0
3	15057928	.	G	A	7	4	11	0	0	11	0	0
3	15058003	.	C	G	5	2	7	0	0	7	0	0
3	15058106	.	C	T	8	9	17	0	1	18	0	0
3	15058123	.	A	G	8	8	16	0	0	16	0	0
3	15058161	.	T	C	5	8	13	0	1	14	0	0
3	15058259	.	G	T	6	7	13	0	1	14	0	0
3	15058278	.	A	T	4	5	9	0	1	10	0	0
3	15085669	.	A	G	10	10	20	0	2	22	0	0
3	15085673	.	G	A	10	10	20	0	0	20	0	0
3	15085784	.	G	C	7	10	17	0	2	19	0	0
3	15095987	.	A	G	8	6	14	0	0	14	0	0
3	15098847	.	A	G	1	2	3	0	0	3	0	0
3	15114793	.	G	A	1	2	3	0	0	3	0	0
3	15115138	.	G	A	1	4	5	0	0	5	0	0
3	15134493	.	T	C	1	6	7	0	1	8	0	0
3	15134537	.	T	A	1	3	4	0	0	4	0	0
3	15137023	.	C	T	0	2	2	0	0	2	0	0
3	15137045	.	A	G	6	3	9	0	1	10	0	0
3	15193773	.	T	A	15	7	22	0	1	23	0	0
3	15198701	.	A	G	2	6	8	0	2	10	0	0
3	15203329	.	C	A	23	10	33	0	0	33	0	0
3	15203371	.	A	C	10	15	25	0	1	26	0	0
3	15203388	.	T	G	11	9	20	0	2	22	0	0
3	15203935	.	C	T	5	8	13	0	0	13	0	0
3	15203977	.	G	A	1	3	4	0	0	4	0	0
3	15207876	.	T	A	5	6	11	0	0	11	0	0
3	15210405	.	A	T	2	3	5	0	1	6	0	0
3	15214098	.	G	T	1	2	3	0	0	3	0	0
3	15214252	.	A	C	11	9	20	0	0	20	0	0
3	15214300	.	T	A	5	10	15	0	0	15	0	0
3	15214462	.	C	A	13	16	29	0	2	31	0	0
3	15214475	.	T	A	10	15	25	0	1	26	0	0
3	15215101	.	T	A	0	1	1	0	0	1	0	0
3	15215599	.	G	A	2	2	4	0	1	5	0	0
3	15215625	.	G	A	3	2	5	0	0	5	0	0
3	15217246	.	A	G	0	1	1	0	0	1	0	0
3	15217255	.	C	T	0	1	1	0	0	1	0	0
3	15223921	.	G	A	2	2	4	0	1	5	0	0
3	15232447	.	A	G	19	31	50	0	4	54	0	0
3	15232481	.	G	A	26	17	43	0	2	45	0	0
3	15232498	.	G	A	13	25	38	0	0	38	0	0
3	15242201	.	C	T	0	2	2	0	4	6	0	0
3	15245973	.	C	T	12	18	30	0	3	33	0	0
3	15246060	.	T	C	4	4	8	0	2	10	0	0
3	15246871	.	C	T	4	1	5	0	0	5	0	0
3	15258440	.	T	A	1	2	3	0	0	3	0	0
3	15272263	.	A	G	0	2	2	0	0	2	0	0
3	15273982	.	G	C	0	1	1	0	1	2	0	0
3	15274280	.	G	A	0	8	8	0	9	17	0	0
3	15274320	.	G	A	7	9	16	0	1	17	0	0
3	15274649	.	G	A	0	1	1	0	2	3	0	0
3	15274691	.	T	C	11	4	15	0	0	15	0	0
3	15278931	.	A	G	2	0	2	0	9	11	0	0
3	15279045	.	C	G	16	13	29	0	0	29	0	0
3	15282328	.	C	T	5	3	8	0	1	9	0	0
3	15284041	.	C	T	7	12	19	0	1	20	0	0
3	15284047	.	C	T	8	13	21	0	0	21	0	0
3	15284513	.	C	A	2	8	10	0	14	24	0	0
3	15284604	.	G	A	0	8	8	0	10	18	0	0
3	15332476	.	C	A	21	19	40	0	2	42	0	0
3	15332601	.	G	T	18	12	30	0	6	36	0	0
3	15332641	.	C	T	18	17	35	0	0	35	0	0
3	15332881	.	G	A	14	6	20	0	4	24	0	0
3	15332902	.	C	A	0	13	13	0	19	32	0	0
3	15332923	.	G	A	21	20	41	0	1	42	0	0
3	15333065	.	G	A	17	25	42	0	2	44	0	0
3	15361086	.	G	T	0	5	5	0	2	7	0	0
3	15362277	.	C	T	3	2	5	0	0	5	0	0
3	15400517	.	G	A	1	1	2	0	0	2	0	0
3	15406059	.	C	A	1	1	2	0	2	4	0	0
3	15416645	.	G	A	0	1	1	0	10	11	0	0
3	15419098	.	C	T	11	7	18	0	0	18	0	0
3	15455662	.	A	G	4	4	8	0	1	9	0	0
3	15458554	.	G	A	6	3	9	0	1	10	0	0
3	15468983	.	A	G	1	2	3	0	0	3	0	0
3	15476843	.	G	A	6	8	14	0	0	14	0	0
3	15476891	.	G	T	6	8	14	0	2	16	0	0
3	15477765	.	C	T	3	0	3	0	0	3	0	0
3	15477827	.	T	C	5	2	7	0	0	7	0	0
3	15480386	.	A	T	7	4	11	0	0	11	0	0
3	15480437	.	G	T	3	4	7	0	0	7	0	0
3	15480464	.	A	G	1	2	3	0	0	3	0	0
3	15486290	.	G	A	0	2	2	0	0	2	0	0
3	15489862	.	G	A	1	2	3	0	0	3	0	0
3	15490026	.	A	C	1	6	7	0	0	7	0	0
3	15490543	.	C	T	0	0	0	0	1	1	0	0
3	15490681	.	T	G	3	6	9	0	0	9	0	0
3	15491473	.	G	A	1	1	2	0	0	2	0	0
3	15505658	.	G	A	7	4	11	0	3	14	0	0
3	15505856	.	A	T	9	6	15	0	0	15	0	0
3	15505864	.	G	A	0	9	9	0	10	19	0	0
3	15505910	.	C	T	14	7	21	0	1	22	0	0
3	15505911	.	G	A	0	8	8	0	14	22	0	0
3	15505979	.	G	A	8	3	11	0	1	12	0	0
3	15608000	.	C	A	15	3	18	0	1	19	0	0
3	15627447	.	A	G	7	3	10	0	0	10	0	0
3	15627539	.	G	A	6	3	9	0	0	9	0	0
3	15627596	.	A	G	2	4	6	0	1	7	0	0
3	15627598	.	G	A	2	3	5	0	2	7	0	0
3	15627767	.	G	A	13	10	23	0	2	25	0	0
3	15628056	.	G	A	5	0	5	0	0	5	0	0
3	15628292	.	C	T	1	2	3	0	0	3	0	0
3	15628455	.	G	A	3	3	6	0	0	6	0	0
3	15628458	.	A	C	3	0	3	0	3	6	0	0
3	15628956	.	G	A	3	5	8	0	1	9	0	0
3	15629349	.	A	G	2	3	5	0	0	5	0	0
3	15629894	.	T	C	1	2	3	0	0	3	0	0
3	15629967	.	G	C	2	2	4	0	1	5	0	0
3	15630062	.	C	T	1	2	3	0	0	3	0	0
3	15630257	.	A	T	1	2	3	0	0	3	0	0
3	15635054	.	G	A	0	2	2	0	0	2	0	0
3	15635069	.	A	G	0	3	3	0	0	3	0	0
3	15636122	.	G	T	1	2	3	0	0	3	0	0
3	15638264	.	C	T	0	8	8	0	3	11	0	0
3	15647699	.	C	T	6	4	10	0	0	10	0	0
3	15647784	.	G	A	2	2	4	0	0	4	0	0
3	15667548	.	G	A	1	2	3	0	0	3	0	0
3	15670505	.	G	A	4	3	7	0	0	7	0	0
3	15670584	.	T	A	4	3	7	0	0	7	0	0
3	15670719	.	G	C	3	2	5	0	0	5	0	0
3	15670722	.	C	T	2	3	5	0	0	5	0	0
3	15670897	.	A	G	1	3	4	0	0	4	0	0
3	15670922	.	C	T	0	4	4	0	3	7	0	0
3	15671055	.	G	A	6	8	14	0	2	16	0	0
3	15671631	.	T	C	2	2	4	0	0	4	0	0
3	15671635	.	T	A	2	3	5	0	0	5	0	0
3	15818992	.	T	C	0	1	1	0	0	1	0	0
3	15988113	.	A	G	29	7	36	0	3	39	0	0
3	15988337	.	A	G	6	13	19	0	2	21	0	0
3	16019316	.	G	A	5	2	7	0	0	7	0	0
3	16284414	.	A	G	4	4	8	0	0	8	0	0
3	16456222	.	T	A	2	2	4	0	0	4	0	0
3	16456255	.	C	T	4	2	6	0	0	6	0	0
3	16456543	.	C	T	0	3	3	0	0	3	0	0
3	16457843	.	C	A	2	1	3	0	2	5	0	0
3	16513445	.	G	A	0	0	0	0	2	2	0	0
3	16638069	.	C	T	1	1	2	0	0	2	0	0
3	16644899	.	G	T	0	1	1	0	1	2	0	0
3	16648459	.	G	T	4	4	8	0	0	8	0	0
3	16652265	.	C	T	3	5	8	0	1	9	0	0
3	16654018	.	G	T	16	6	22	0	1	23	0	0
3	16678754	.	G	A	0	9	9	0	6	15	0	0
3	16678830	.	C	T	5	5	10	0	2	12	0	0
3	16679171	.	T	G	6	5	11	0	2	13	0	0
3	16679172	.	G	T	7	6	13	0	0	13	0	0
3	16679238	.	C	T	3	12	15	0	0	15	0	0
3	16679331	.	T	C	6	8	14	0	1	15	0	0
3	16679387	.	G	A	5	3	8	0	0	8	0	0
3	16733790	.	C	T	1	2	3	0	0	3	0	0
3	16741179	.	A	C	1	5	6	0	1	7	0	0
3	16741830	.	A	G	3	3	6	0	0	6	0	0
3	16741851	.	T	C	3	2	5	0	1	6	0	0
3	16746339	.	A	G	0	4	4	0	1	5	0	0
3	16746796	.	G	A	6	4	10	0	1	11	0	0
3	16746947	.	A	T	13	11	24	0	4	28	0	0
3	16747229	.	A	G	5	0	5	0	6	11	0	0
3	16747233	.	G	T	0	6	6	0	5	11	0	0
3	16871503	.	G	A	3	4	7	0	0	7	0	0
3	16871504	.	G	T	3	4	7	0	0	7	0	0
3	16871938	.	G	T	3	2	5	0	0	5	0	0
3	16871941	.	C	A	3	2	5	0	0	5	0	0
3	16872038	.	T	A	0	2	2	0	0	2	0	0
3	16872179	.	G	T	4	2	6	0	0	6	0	0
3	16872453	.	A	T	3	4	7	0	0	7	0	0
3	16872493	.	T	C	3	5	8	0	0	8	0	0
3	16872508	.	G	T	5	7	12	0	0	12	0	0
3	16872584	.	G	A	0	11	11	0	9	20	0	0
3	16972877	.	T	C	2	4	6	0	1	7	0	0
3	16972878	.	G	T	2	5	7	0	0	7	0	0
3	17074430	.	A	C	0	2	2	0	0	2	0	0
3	17458615	.	C	T	1	2	3	0	0	3	0	0
3	17481844	.	C	T	0	1	1	0	0	1	0	0
3	17481886	.	T	C	1	1	2	0	0	2	0	0
3	17481955	.	G	A	0	3	3	0	3	6	0	0
3	17601636	.	C	A	1	2	3	0	0	3	0	0
3	17602078	.	G	A	0	6	6	0	3	9	0	0
3	17602119	.	A	G	2	5	7	0	2	9	0	0
3	17602344	.	T	A	1	3	4	1	3	8	0	0
3	17603313	.	A	G	2	5	7	0	0	7	0	0
3	17603558	.	G	A	3	6	9	0	1	10	0	0
3	17867564	.	T	C	14	5	19	0	4	23	0	0
3	17867870	.	T	C	7	5	12	0	0	12	0	0
3	17942432	.	C	T	1	0	1	0	0	1	0	0
3	17943332	.	A	G	4	2	6	0	0	6	0	0
3	18498689	.	C	T	1	2	3	0	5	8	0	0
3	18498691	.	G	T	3	2	5	0	3	8	0	0
3	18839017	.	C	T	5	3	8	0	2	10	0	0
3	20108790	.	T	C	7	7	14	2	1	17	0	0
3	20109247	.	T	C	10	0	10	0	8	18	0	0
3	21889268	.	A	G	2	4	6	0	0	6	0	0
3	22152952	.	C	T	2	2	4	0	0	4	0	0
3	22153116	.	C	T	8	6	14	0	1	15	0	0
3	22153762	.	C	G	3	2	5	0	0	5	0	0
3	22153849	.	A	G	4	4	8	0	0	8	0	0
3	22153850	.	A	G	4	3	7	0	1	8	0	0
3	22154745	.	C	T	8	15	23	0	2	25	0	0
3	22158243	.	T	A	24	27	51	0	2	53	0	0
3	22158364	.	T	C	12	11	23	0	3	26	0	0
3	22158414	.	G	A	17	23	40	0	4	44	0	0
3	22158416	.	G	C	23	18	41	0	3	44	0	0
3	22158489	.	G	A	29	31	60	0	2	62	0	0
3	22158904	.	A	T	16	14	30	0	0	30	0	0
3	22159081	.	T	C	21	37	58	0	3	61	0	0
3	22159520	.	T	G	3	12	15	0	1	17	1	0
3	22159525	.	A	T	3	12	15	0	0	15	0	0
3	22159569	.	A	G	16	8	24	0	1	25	0	0
3	22159697	.	A	G	13	26	39	0	1	40	0	0
3	22159797	.	G	A	7	3	10	0	0	10	0	0
3	22160007	.	G	A	15	11	26	0	2	28	0	0
3	22160131	.	C	G	1	4	5	0	1	6	0	0
3	22160436	.	A	C	11	17	28	0	0	28	0	0
3	22160706	.	T	A	4	10	14	0	1	15	0	0
3	22160767	.	G	T	7	6	13	0	1	15	1	0
3	22160779	.	C	T	11	8	19	0	1	20	0	0
3	22160888	.	A	T	7	3	10	0	1	11	0	0
3	22160938	.	T	A	5	2	7	0	1	8	0	0
3	22160947	.	C	A	6	1	7	0	0	7	0	0
3	22161153	.	A	G	8	9	17	0	3	20	0	0
3	22161317	.	C	T	0	4	4	0	6	10	0	0
3	22161366	.	G	A	5	13	18	0	1	19	0	0
3	22161389	.	T	A	3	9	12	0	1	13	0	0
3	22161588	.	C	T	5	10	15	0	2	17	0	0
3	22168615	.	C	T	1	2	3	0	2	5	0	0
3	22172837	.	G	A	2	4	6	0	1	7	0	0
3	22191042	.	T	C	7	9	16	0	1	17	0	0
3	22191044	.	C	A	7	8	15	0	2	17	0	0
3	22216358	.	G	A	1	3	4	0	0	4	0	0
3	22216413	.	C	G	0	2	2	0	0	2	0	0
3	22547182	.	A	G	7	5	12	0	0	12	0	0
3	22547227	.	C	T	4	4	8	0	0	8	0	0
3	22548052	.	G	A	7	0	7	0	0	7	0	0
3	22548094	.	A	G	5	5	10	0	0	10	0	0
3	22548095	.	G	T	5	5	10	0	0	10	0	0
3	22548177	.	G	T	3	0	3	0	0	3	0	0
3	22548231	.	C	T	1	0	1	0	0	1	0	0
3	22548388	.	G	A	2	5	7	0	0	7	0	0
3	22548666	.	C	G	9	7	16	0	2	18	0	0
3	22548677	.	C	T	6	6	12	0	3	15	0	0
3	22548903	.	A	C	12	11	23	0	0	23	0	0
3	22548928	.	T	A	14	11	25	0	0	25	0	0
3	22783277	.	A	G	1	2	3	0	0	3	0	0
3	22792033	.	T	C	1	2	3	0	0	3	0	0
3	22794705	.	T	C	0	2	2	0	0	2	0	0
3	22811835	.	G	A	0	8	8	0	5	13	0	0
3	22812753	.	A	G	10	1	11	0	15	26	0	0
3	22812759	.	C	A	9	17	26	0	2	28	0	0
3	22813052	.	G	A	0	16	16	0	11	27	0	0
3	22813515	.	T	A	10	7	17	0	1	18	0	0
3	22813563	.	G	T	4	10	14	0	3	17	0	0
3	22813569	.	T	G	6	10	16	0	0	16	0	0
3	22813628	.	C	A	12	9	21	0	0	21	0	0
3	22813629	.	T	A	12	9	21	0	0	21	0	0
3	22813778	.	C	T	11	7	18	0	0	18	0	0
3	22813998	.	T	G	4	4	8	0	0	8	0	0
3	22814109	.	G	A	12	9	21	0	1	22	0	0
3	22814147	.	G	A	0	10	10	0	14	24	0	0
3	22814209	.	T	C	12	13	25	0	0	25	0	0
3	22814230	.	A	G	10	1	11	0	16	27	0	0
3	22814453	.	A	G	6	17	23	0	5	28	0	0
3	22814478	.	A	G	4	16	20	0	3	23	0	0
3	22814546	.	G	A	18	14	32	0	1	33	0	0
3	22815994	.	C	T	0	7	7	0	10	17	0	0
3	22816030	.	A	G	8	5	13	0	2	15	0	0
3	22816166	.	T	C	7	2	9	0	1	10	0	0
3	22816167	.	G	A	7	2	9	0	1	10	0	0
3	22816586	.	G	A	9	4	13	0	2	15	0	0
3	22816652	.	A	G	12	3	15	0	2	17	0	0
3	22816676	.	T	C	9	5	14	0	0	14	0	0
3	22816909	.	T	C	9	1	10	0	4	14	0	0
3	22816910	.	A	G	11	2	13	0	1	14	0	0
3	22816989	.	C	T	5	3	8	0	0	8	0	0
3	22817004	.	G	T	6	3	9	0	2	11	0	0
3	22821125	.	A	G	1	2	3	0	0	3	0	0
3	22953926	.	T	C	0	2	2	0	0	2	0	0
3	22993279	.	A	C	4	2	6	0	0	6	0	0
3	22993542	.	G	A	4	4	8	0	0	8	0	0
3	22993614	.	C	T	2	5	7	0	0	7	0	0
3	22993997	.	C	A	7	2	9	0	0	9	0	0
3	22994019	.	A	C	10	7	17	0	0	17	0	0
3	22994078	.	G	T	0	8	8	0	16	24	0	0
3	22994344	.	G	T	0	4	4	0	6	10	0	0
3	25437003	.	G	A	9	4	13	0	0	13	0	0
3	26032359	.	A	G	7	3	10	0	0	10	0	0
3	26032392	.	A	G	7	3	10	0	0	10	0	0
3	26120592	.	G	A	2	0	2	0	0	2	0	0
3	26157625	.	T	C	3	2	5	0	0	5	0	0
3	26157626	.	T	C	2	0	2	0	3	5	0	0
3	26351448	.	A	G	7	16	23	0	2	25	0	0
3	27767208	.	A	G	7	4	11	0	4	15	0	0
3	27767284	.	A	G	1	6	7	0	0	7	0	0
3	27767288	.	A	G	3	3	6	0	0	6	0	0
3	27833009	.	T	C	17	7	24	0	0	24	0	0
3	27833057	.	T	C	20	5	25	0	1	26	0	0
3	27834304	.	T	C	15	6	21	0	1	22	0	0
3	27834305	.	T	C	13	8	21	0	1	22	0	0
3	27834412	.	T	C	12	16	28	0	1	29	0	0
3	27834552	.	T	C	4	6	10	0	2	12	0	0
3	27836036	.	T	C	3	4	7	0	2	9	0	0
3	28627044	.	T	A	4	6	10	0	0	10	0	0
3	28634485	.	T	A	4	4	8	0	0	8	0	0
3	28634549	.	A	G	12	11	23	0	0	23	0	0
3	28634883	.	C	A	8	6	14	0	2	16	0	0
3	28634884	.	A	C	7	6	13	0	3	16	0	0
3	28635106	.	G	A	8	11	19	0	0	19	0	0
3	28640608	.	C	T	0	3	3	0	1	4	0	0
3	28665218	.	T	C	2	2	4	0	1	5	0	0
3	28665239	.	G	A	2	3	5	0	0	5	0	0
3	28719506	.	C	G	8	7	15	0	1	16	0	0
3	28719592	.	T	G	6	7	13	0	1	14	0	0
3	28719636	.	T	A	5	10	15	0	0	15	0	0
3	28719649	.	C	T	4	9	13	0	1	14	0	0
3	28719730	.	G	T	4	8	12	0	0	12	0	0
3	28719878	.	G	A	6	5	11	0	3	14	0	0
3	28719905	.	C	A	0	6	6	0	7	13	0	0
3	28719971	.	C	A	0	3	3	0	5	8	0	0
3	28720010	.	G	A	3	2	5	0	0	5	0	0
3	29950927	.	T	C	12	10	22	0	2	24	0	0
3	29951245	.	T	C	13	9	22	0	2	24	0	0
3	29951246	.	T	C	11	11	22	0	2	24	0	0
3	29951384	.	T	C	13	10	23	0	2	25	0	0
3	30868430	.	A	G	1	2	3	0	0	3	0	0
3	30868853	.	T	G	6	3	9	0	1	10	0	0
3	30868855	.	T	C	5	3	8	0	2	10	0	0
3	30869205	.	A	G	4	6	10	0	0	10	0	0
3	30869206	.	C	T	4	4	8	0	2	10	0	0
3	30869662	.	C	T	4	11	15	0	0	15	0	0
3	30869728	.	C	T	0	4	4	0	2	6	0	0
3	30869938	.	A	G	2	3	5	0	0	5	0	0
3	30870382	.	T	G	3	3	6	0	0	6	0	0
3	30870409	.	G	A	1	2	3	0	0	3	0	0
3	30870838	.	T	A	1	2	3	0	2	5	0	0
3	30870974	.	A	C	3	2	5	0	0	5	0	0
3	30873102	.	T	C	0	2	2	0	0	2	0	0
3	30890630	.	T	A	6	10	16	0	1	17	0	0
3	30890869	.	G	A	15	23	38	0	4	42	0	0
3	30891201	.	A	G	16	22	38	0	1	39	0	0
3	30894281	.	A	G	5	5	10	0	1	11	0	0
3	30926689	.	A	G	0	2	2	0	0	2	0	0
3	30948206	.	C	A	1	1	2	0	1	3	0	0
3	31044431	.	C	T	1	3	4	0	1	5	0	0
3	31044493	.	A	C	1	5	6	0	0	6	0	0
3	31044579	.	A	G	7	3	10	0	1	11	0	0
3	31044850	.	T	C	1	3	4	0	0	4	0	0
3	31044916	.	G	C	2	3	5	0	1	6	0	0
3	31044923	.	A	G	3	2	5	0	1	6	0	0
3	31045098	.	G	A	2	2	4	0	0	4	0	0
3	31060366	.	C	T	4	5	9	0	0	9	0	0
3	31063625	.	A	T	2	6	8	0	0	8	0	0
3	31066143	.	C	G	2	4	6	0	0	6	0	0
3	31066259	.	A	G	0	3	3	0	0	3	0	0
3	31066269	.	A	C	0	1	1	0	0	1	0	0
3	31066637	.	G	A	1	0	1	0	0	1	0	0
3	31069634	.	T	C	10	15	25	0	0	25	0	0
3	31070892	.	A	G	3	3	6	0	0	6	0	0
3	31082995	.	T	A	0	1	1	0	0	1	0	0
3	31086366	.	A	G	2	1	3	0	1	4	0	0
3	31103852	.	G	A	2	1	3	0	0	3	0	0
3	31103861	.	C	T	1	2	3	0	0	3	0	0
3	31104104	.	G	C	2	5	7	0	0	7	0	0
3	31104127	.	A	T	1	5	6	0	0	6	0	0
3	31104333	.	A	G	0	4	4	0	0	4	0	0
3	31104943	.	C	T	2	2	4	0	3	7	0	0
3	31104969	.	G	A	7	7	14	0	1	15	0	0
3	31105259	.	A	C	28	26	54	0	2	56	0	0
3	31120249	.	C	T	6	5	11	0	1	12	0	0
3	31122581	.	T	G	10	16	26	0	5	31	0	0
3	31135898	.	T	C	0	0	0	0	2	2	0	0
3	31138225	.	A	G	0	1	1	0	0	1	0	0
3	31138247	.	C	T	0	2	2	0	0	2	0	0
3	31396679	.	A	G	4	2	6	0	0	6	0	0
3	31396826	.	T	C	0	0	0	0	1	1	0	0
3	31430327	.	T	C	1	4	5	0	0	5	0	0
3	31603766	.	G	A	0	2	2	0	3	5	0	0
3	31603925	.	A	G	3	2	5	0	1	6	0	0
3	31604133	.	T	C	3	4	7	0	0	7	0	0
3	31604411	.	T	A	1	1	2	0	1	3	0	0
3	31604834	.	A	T	5	5	10	0	1	11	0	0
3	31605033	.	A	G	6	10	16	0	0	16	0	0
3	31605039	.	C	T	5	10	15	0	1	16	0	0
3	31706607	.	C	A	7	15	22	0	3	25	0	0
3	31706966	.	T	C	10	6	16	0	1	17	0	0
3	31709010	.	C	T	10	14	24	0	1	25	0	0
3	31709079	.	G	A	12	7	19	0	0	20	1	0
3	31711526	.	T	C	5	6	11	0	0	11	0	0
3	31712328	.	G	T	0	1	1	0	0	1	0	0
3	31722101	.	A	T	11	20	31	0	0	31	0	0
3	31722342	.	A	G	4	5	9	0	1	10	0	0
3	31725824	.	C	T	16	12	28	0	4	32	0	0
3	31726066	.	T	C	17	17	34	0	0	34	0	0
3	31726395	.	G	A	0	7	7	0	11	18	0	0
3	31726541	.	A	T	3	11	14	0	0	14	0	0
3	31726829	.	C	T	7	13	20	0	1	21	0	0
3	31729087	.	T	G	2	3	5	0	0	5	0	0
3	31729531	.	C	T	2	5	7	0	0	7	0	0
3	31734188	.	C	T	1	2	3	0	1	4	0	0
3	31792600	.	T	A	1	5	6	0	1	7	0	0
3	31792856	.	G	A	14	10	24	0	0	24	0	0
3	31793080	.	C	T	8	6	14	0	1	15	0	0
3	31793515	.	T	G	2	8	10	0	1	11	0	0
3	31793739	.	C	T	1	2	3	0	0	3	0	0
3	31797508	.	C	G	1	2	3	0	0	3	0	0
3	31797749	.	A	G	0	1	1	0	0	1	0	0
3	31874969	.	G	T	2	2	4	0	0	4	0	0
3	31879513	.	T	A	4	5	9	0	2	11	0	0
3	31879626	.	G	A	6	8	14	0	1	15	0	0
3	31879725	.	T	A	7	5	12	0	2	14	0	0
3	31879726	.	C	A	8	6	14	0	0	14	0	0
3	31879880	.	G	T	12	11	23	0	0	23	0	0
3	31879911	.	T	C	13	8	21	0	3	24	0	0
3	31880016	.	C	A	10	2	12	0	1	13	0	0
3	31880184	.	C	G	0	6	6	0	7	13	0	0
3	31880641	.	C	T	0	8	8	0	12	20	0	0
3	31881082	.	G	T	3	5	8	0	1	9	0	0
3	31884001	.	A	G	0	0	0	0	1	1	0	0
3	31884321	.	C	T	0	0	0	0	1	1	0	0
3	31884477	.	C	T	3	5	8	0	1	9	0	0
3	31886783	.	C	T	0	2	2	0	4	6	0	0
3	31897120	.	T	A	1	3	4	0	0	4	0	0
3	31914167	.	T	A	3	1	4	0	0	4	0	0
3	31916701	.	A	T	11	4	15	0	5	20	0	0
3	31916724	.	A	G	13	6	19	0	1	20	0	0
3	31916787	.	G	T	14	12	26	0	2	28	0	0
3	31916863	.	T	C	14	14	28	0	1	29	0	0
3	31917075	.	T	G	11	0	11	0	10	21	0	0
3	31917279	.	G	T	12	4	16	0	0	16	0	0
3	31922838	.	G	C	1	0	1	0	0	1	0	0
3	31939272	.	A	G	1	0	1	0	1	2	0	0
3	31939473	.	G	T	0	14	14	0	10	24	0	0
3	31939566	.	C	A	13	17	30	0	2	32	0	0
3	31941152	.	C	T	4	5	9	0	0	9	0	0
3	31944357	.	A	T	11	5	16	0	1	17	0	0
3	31951034	.	A	C	1	3	4	0	0	4	0	0
3	31961992	.	G	A	0	2	2	0	5	7	0	0
3	32049740	.	C	T	4	4	8	0	1	9	0	0
3	32083179	.	C	T	1	0	1	0	0	1	0	0
3	32087455	.	T	G	1	1	2	0	0	2	0	0
3	32087888	.	T	C	0	1	1	0	0	1	0	0
3	32098130	.	G	A	0	2	2	0	3	5	0	0
3	32098194	.	C	T	2	6	8	0	0	8	0	0
3	32100183	.	G	T	10	5	15	0	1	16	0	0
3	32100206	.	T	C	10	5	15	0	0	15	0	0
3	32100755	.	T	C	14	13	27	0	0	27	0	0
3	32105746	.	C	A	3	2	5	0	0	5	0	0
3	32120187	.	A	T	6	2	8	0	0	8	0	0
3	32139671	.	G	A	5	4	9	0	0	9	0	0
3	32139701	.	C	G	4	4	8	0	1	9	0	0
3	32169545	.	G	A	1	2	3	0	1	4	0	0
3	32169677	.	C	T	1	2	3	0	1	4	0	0
3	32172579	.	C	T	2	3	5	0	0	5	0	0
3	32175758	.	C	T	0	1	1	0	1	2	0	0
3	32294745	.	G	A	16	19	35	0	0	35	0	0
3	32294869	.	C	G	0	11	11	0	28	39	0	0
3	32295151	.	C	T	9	13	22	0	2	24	0	0
3	32295294	.	G	A	20	9	29	0	0	29	0	0
3	32295519	.	A	C	13	12	25	0	0	25	0	0
3	32295635	.	T	A	5	9	14	0	2	16	0	0
3	32295880	.	C	T	0	2	2	0	4	6	0	0
3	32295903	.	A	T	4	4	8	0	0	8	0	0
3	32295923	.	C	T	0	5	5	0	8	13	0	0
3	32296122	.	C	T	9	9	18	0	2	20	0	0
3	32296202	.	G	A	15	7	22	0	1	23	0	0
3	32296283	.	G	A	10	4	14	0	0	14	0	0
3	32296306	.	G	A	7	4	11	0	0	11	0	0
3	32296379	.	A	G	10	9	19	0	1	20	0	0
3	32296559	.	G	A	7	4	11	0	0	11	0	0
3	32296560	.	C	T	0	6	6	0	6	12	0	0
3	32296673	.	A	G	9	14	23	0	2	25	0	0
3	32296873	.	G	A	6	11	17	0	1	18	0	0
3	32303045	.	G	A	4	3	7	0	2	9	0	0
3	32325218	.	A	G	3	6	9	0	0	9	0	0
3	32329167	.	A	T	7	11	18	0	0	18	0	0
3	32357596	.	C	T	10	20	30	0	6	36	0	0
3	32357799	.	A	C	20	28	48	0	4	52	0	0
3	32360978	.	G	A	6	3	9	0	1	10	0	0
3	32361669	.	G	A	7	7	14	0	2	16	0	0
3	32366332	.	G	A	1	2	3	0	0	3	0	0
3	32400967	.	C	T	16	39	55	0	11	66	0	0
3	32401159	.	C	A	30	31	61	0	4	65	0	0
3	32401252	.	C	T	12	39	51	0	9	60	0	0
3	32405571	.	C	T	2	2	4	0	0	4	0	0
3	32405865	.	G	C	13	11	24	0	4	28	0	0
3	32405910	.	C	T	27	8	35	0	1	36	0	0
3	32406447	.	T	C	30	29	59	0	3	62	0	0
3	32406547	.	T	C	26	27	53	0	3	56	0	0
3	32406618	.	G	A	21	25	46	0	5	51	0	0
3	32406631	.	C	G	21	25	46	0	3	49	0	0
3	32415781	.	A	C	2	2	4	0	1	5	0	0
3	32434974	.	G	A	1	3	4	0	4	8	0	0
3	32435034	.	G	T	0	3	3	0	2	5	0	0
3	32435757	.	G	A	0	5	5	0	1	6	0	0
3	32436109	.	T	A	1	2	3	0	0	3	0	0
3	32436426	.	C	T	6	2	8	0	0	8	0	0
3	32436736	.	G	C	1	4	5	0	1	6	0	0
3	32436774	.	G	A	1	4	5	0	0	5	0	0
3	32438425	.	A	C	11	8	19	0	1	20	0	0
3	32440805	.	A	G	1	5	6	0	0	6	0	0
3	32441156	.	T	G	8	0	8	0	17	25	0	0
3	32441297	.	C	A	13	10	23	0	0	23	0	0
3	32441385	.	G	C	11	18	29	0	1	30	0	0
3	32441532	.	G	A	3	9	12	0	0	12	0	0
3	32441779	.	C	T	17	12	29	0	5	34	0	0
3	32447386	.	G	A	12	7	19	0	0	19	0	0
3	32447505	.	G	T	19	15	34	0	1	36	1	0
3	32447674	.	C	G	13	18	31	0	0	31	0	0
3	32447800	.	T	C	6	4	10	0	0	10	0	0
3	32450399	.	T	C	13	12	25	0	1	26	0	0
3	32453727	.	G	A	8	4	12	0	2	14	0	0
3	32457325	.	G	A	0	7	7	0	7	14	0	0
3	32457620	.	T	C	20	13	33	0	4	37	0	0
3	32457686	.	T	C	21	9	30	0	3	33	0	0
3	32458627	.	C	T	9	13	22	0	1	23	0	0
3	32482222	.	A	T	0	5	5	0	1	6	0	0
3	32482231	.	A	G	1	0	1	0	5	6	0	0
3	32482495	.	G	T	0	3	3	0	3	6	0	0
3	32482834	.	A	G	6	6	12	0	0	12	0	0
3	32483557	.	T	G	7	3	10	0	4	14	0	0
3	32483956	.	T	C	2	6	8	0	0	8	0	0
3	32484034	.	A	G	11	0	11	0	6	17	0	0
3	32484039	.	A	G	10	0	10	0	6	16	0	0
3	32484204	.	T	C	8	5	13	0	2	15	0	0
3	32484472	.	T	C	9	5	14	0	0	14	0	0
3	32484676	.	T	G	10	10	20	0	2	22	0	0
3	32484892	.	A	G	8	2	10	0	2	12	0	0
3	32485306	.	A	G	18	12	30	0	4	34	0	0
3	32485324	.	C	T	17	14	31	0	4	35	0	0
3	32485366	.	A	G	15	14	29	0	1	30	0	0
3	32485519	.	A	C	13	14	27	0	2	29	0	0
3	32485967	.	C	A	16	15	31	0	4	35	0	0
3	32486049	.	A	T	16	18	34	0	2	36	0	0
3	32486069	.	C	G	17	0	17	0	17	34	0	0
3	32489613	.	C	T	25	19	44	0	3	47	0	0
3	32490098	.	C	T	12	16	28	0	1	29	0	0
3	32490251	.	G	T	18	13	31	0	0	31	0	0
3	32490264	.	G	A	14	10	24	0	1	25	0	0
3	32490487	.	G	T	15	13	28	0	1	29	0	0
3	32534263	.	A	G	2	1	3	0	1	4	0	0
3	32534353	.	C	T	4	3	7	0	0	7	0	0
3	32534365	.	T	A	2	2	4	0	0	4	0	0
3	32587304	.	C	T	7	5	12	0	0	12	0	0
3	32641716	.	T	G	2	3	5	0	1	6	0	0
3	32643512	.	G	A	12	7	19	0	2	21	0	0
3	32647124	.	T	C	9	14	23	0	1	24	0	0
3	32647194	.	C	T	6	13	19	0	4	23	0	0
3	32647252	.	G	A	5	9	14	0	2	16	0	0
3	32647308	.	G	C	9	10	19	0	2	21	0	0
3	32647414	.	A	G	1	0	1	0	0	1	0	0
3	32649846	.	C	T	17	12	29	0	3	32	0	0
3	32649960	.	G	A	12	14	26	0	1	27	0	0
3	32650004	.	A	G	12	9	21	0	2	23	0	0
3	32650199	.	C	A	7	7	14	0	1	15	0	0
3	32658076	.	T	C	1	0	1	0	0	1	0	0
3	32658265	.	T	G	1	1	2	0	0	2	0	0
3	32662034	.	A	C	1	2	3	0	0	3	0	0
3	32663485	.	T	C	4	3	7	0	0	7	0	0
3	32665515	.	G	A	2	2	4	0	0	4	0	0
3	32667118	.	A	C	2	1	3	0	0	3	0	0
3	32668806	.	A	G	11	6	17	0	3	20	0	0
3	32668818	.	A	G	12	5	17	0	0	17	0	0
3	32669040	.	C	G	3	2	5	0	0	5	0	0
3	32675236	.	G	A	10	8	18	0	1	19	0	0
3	32679267	.	T	A	9	4	13	0	0	13	0	0
3	32679289	.	T	A	9	10	19	0	3	22	0	0
3	32679332	.	C	T	13	15	28	0	0	28	0	0
3	32679528	.	C	A	14	7	21	0	2	23	0	0
3	32685708	.	A	G	5	0	5	0	6	11	0	0
3	32698500	.	A	G	11	7	18	0	0	18	0	0
3	32700758	.	A	G	7	7	14	0	3	17	0	0
3	32700988	.	C	T	3	7	10	0	0	10	0	0
3	32702596	.	T	A	11	5	16	0	1	17	0	0
3	32707219	.	G	A	5	8	13	0	0	13	0	0
3	32707267	.	T	C	5	10	15	0	2	17	0	0
3	32707272	.	C	A	3	11	14	0	0	14	0	0
3	32707480	.	C	T	14	6	20	0	2	22	0	0
3	32707621	.	C	G	14	10	24	0	5	29	0	0
3	32707813	.	C	G	17	15	32	0	3	35	0	0
3	32708077	.	T	C	14	9	23	0	1	24	0	0
3	32710705	.	A	G	7	7	14	0	1	15	0	0
3	32710812	.	G	A	0	2	2	0	4	6	0	0
3	32710999	.	C	A	9	4	13	0	2	15	0	0
3	32711117	.	T	C	1	6	7	0	2	9	0	0
3	32711147	.	T	A	3	5	8	0	0	8	0	0
3	32728304	.	T	C	1	2	3	0	0	3	0	0
3	32729150	.	T	C	6	4	10	0	1	11	0	0
3	32729232	.	T	C	2	5	7	0	1	8	0	0
3	32729534	.	A	G	0	3	3	0	1	4	0	0
3	32729663	.	C	T	2	3	5	0	2	7	0	0
3	32729759	.	C	A	5	4	9	0	1	10	0	0
3	32729827	.	A	T	2	4	6	0	0	6	0	0
3	32729845	.	G	A	3	3	6	0	0	6	0	0
3	32730011	.	A	G	2	0	2	0	7	9	0	0
3	32730071	.	T	A	6	4	10	0	0	10	0	0
3	32730131	.	A	G	2	4	6	0	0	6	0	0
3	32731418	.	C	T	3	9	12	0	0	12	0	0
3	32731804	.	T	C	3	3	6	0	1	7	0	0
3	32731840	.	T	C	2	2	4	0	0	4	0	0
3	32731855	.	T	C	2	2	4	0	0	4	0	0
3	32741137	.	G	A	0	10	10	0	10	20	0	0
3	32741385	.	G	A	0	8	8	0	12	20	0	0
3	32777481	.	A	C	4	15	19	0	1	20	0	0
3	32777733	.	G	T	9	15	24	0	2	26	0	0
3	32789985	.	T	C	2	0	2	0	0	2	0	0
3	32795614	.	C	T	2	1	3	0	0	3	0	0
3	32807667	.	G	A	2	3	5	0	1	6	0	0
3	32808023	.	T	A	7	6	13	0	0	13	0	0
3	32808185	.	T	C	7	16	23	0	1	24	0	0
3	32808214	.	G	A	10	16	26	0	1	27	0	0
3	32808338	.	A	C	14	17	31	0	1	32	0	0
3	32808554	.	T	G	7	6	13	0	2	15	0	0
3	32808771	.	G	A	7	5	12	0	1	13	0	0
3	32808772	.	G	C	7	6	13	0	0	13	0	0
3	32808979	.	T	G	10	7	17	0	2	19	0	0
3	32809154	.	A	T	6	8	14	0	0	14	0	0
3	32809368	.	G	A	1	13	14	0	2	16	0	0
3	32809410	.	G	A	3	8	11	0	0	11	0	0
3	32809432	.	T	A	4	5	9	0	1	10	0	0
3	32809548	.	T	C	9	5	14	0	1	15	0	0
3	32809561	.	G	A	10	6	16	0	2	18	0	0
3	32809836	.	A	G	6	0	6	0	11	17	0	0
3	32809927	.	T	C	10	6	16	0	2	18	0	0
3	32810011	.	T	A	5	13	18	0	0	18	0	0
3	32810580	.	C	T	21	12	33	0	1	34	0	0
3	32810715	.	A	G	18	18	36	0	2	38	0	0
3	32811094	.	A	T	5	4	9	0	1	10	0	0
3	32831417	.	T	C	0	1	1	0	0	1	0	0
3	32837514	.	G	A	9	8	17	0	3	20	0	0
3	32837643	.	G	A	23	6	29	0	2	31	0	0
3	32838033	.	G	A	0	10	10	0	7	17	0	0
3	32838039	.	A	G	7	8	15	0	0	15	0	0
3	32842163	.	C	T	7	6	13	0	1	14	0	0
3	32842235	.	G	T	11	10	21	0	1	22	0	0
3	32842318	.	C	T	9	9	18	0	1	19	0	0
3	32847771	.	G	A	0	2	2	0	3	5	0	0
3	32847839	.	C	A	2	4	6	0	0	6	0	0
3	32847887	.	C	G	2	2	4	0	1	5	0	0
3	32848418	.	C	T	1	2	3	0	1	4	0	0
3	32849079	.	C	T	2	2	4	0	2	6	0	0
3	32849679	.	T	A	3	11	14	0	2	16	0	0
3	32850029	.	A	T	4	1	5	0	0	5	0	0
3	32854276	.	T	C	6	4	10	0	2	12	0	0
3	32854533	.	T	C	7	5	12	0	0	12	0	0
3	32854743	.	C	G	5	0	5	0	10	15	0	0
3	32854744	.	A	G	5	8	13	0	2	15	0	0
3	32855066	.	G	A	9	4	13	0	3	16	0	0
3	32855416	.	A	G	1	1	2	0	1	3	0	0
3	32855425	.	T	A	2	2	4	0	0	4	0	0
3	32855500	.	T	C	0	3	3	0	0	3	0	0
3	32863016	.	A	G	1	2	3	0	0	3	0	0
3	32865309	.	A	C	1	1	2	0	0	2	0	0
3	32866068	.	A	T	1	0	1	0	0	1	0	0
3	32866135	.	C	T	1	4	5	0	0	5	0	0
3	32868114	.	G	T	1	6	7	0	1	8	0	0
3	32868143	.	C	T	1	3	4	0	0	4	0	0
3	32868519	.	G	T	2	3	5	0	0	5	0	0
3	32868590	.	C	T	3	2	5	0	1	6	0	0
3	32868593	.	A	G	2	0	2	0	4	6	0	0
3	32869770	.	C	T	3	4	7	0	0	7	0	0
3	32869773	.	G	A	3	4	7	0	0	7	0	0
3	32869913	.	C	T	1	4	5	0	0	5	0	0
3	32869930	.	C	T	2	4	6	0	0	6	0	0
3	32870488	.	C	G	1	2	3	0	0	3	0	0
3	32870947	.	A	G	4	5	9	0	0	9	0	0
3	32871023	.	G	C	4	5	9	0	1	10	0	0
3	32871202	.	T	C	1	4	5	0	0	5	0	0
3	32889849	.	T	C	6	0	6	0	10	16	0	0
3	32890002	.	G	T	14	26	40	0	2	42	0	0
3	32890058	.	A	G	14	13	27	0	3	30	0	0
3	32892061	.	G	A	3	8	11	0	0	11	0	0
3	32892422	.	A	G	3	4	7	0	0	7	0	0
3	32900428	.	A	G	4	3	7	0	0	7	0	0
3	32924386	.	G	A	1	4	5	0	0	5	0	0
3	32924643	.	G	A	2	2	4	0	2	6	0	0
3	32924836	.	T	A	4	2	6	0	1	7	0	0
3	32925066	.	G	A	1	4	5	0	0	5	0	0
3	32925400	.	C	T	1	2	3	0	0	3	0	0
3	32933774	.	A	C	2	3	5	0	1	6	0	0
3	32937628	.	A	G	6	8	14	0	1	15	0	0
3	32941242	.	G	A	3	6	9	0	0	9	0	0
3	32941661	.	A	G	3	3	6	0	0	6	0	0
3	32944203	.	C	A	4	8	12	0	0	12	0	0
3	32944569	.	C	T	2	2	4	0	0	4	0	0
3	32944668	.	C	A	11	8	19	0	1	20	0	0
3	32944854	.	C	T	9	13	22	0	1	23	0	0
3	32947971	.	T	C	3	3	6	0	1	7	0	0
3	32950959	.	G	A	3	19	22	0	0	22	0	0
3	32950977	.	G	A	0	14	14	0	6	20	0	0
3	32951001	.	G	T	0	9	9	0	7	16	0	0
3	32951394	.	G	A	21	22	43	0	3	46	0	0
3	32951564	.	A	C	12	10	22	0	2	24	0	0
3	32951637	.	G	A	8	14	22	0	0	22	0	0
3	32951778	.	C	T	16	18	34	0	5	39	0	0
3	32951891	.	T	C	13	16	29	0	3	32	0	0
3	33065643	.	T	A	6	4	10	0	0	10	0	0
3	33065950	.	T	C	3	3	6	0	2	8	0	0
3	33066155	.	C	T	0	9	9	0	8	17	0	0
3	33066241	.	C	T	0	3	3	0	1	4	0	0
3	33066714	.	A	T	1	9	10	0	1	11	0	0
3	33066804	.	T	C	3	0	3	0	12	15	0	0
3	33066809	.	C	G	3	10	13	0	2	15	0	0
3	33066976	.	T	C	4	2	6	0	1	7	0	0
3	33067337	.	A	G	3	2	5	0	0	5	0	0
3	33067340	.	A	G	3	1	4	0	1	5	0	0
3	33067376	.	G	A	2	3	5	0	0	5	0	0
3	33067438	.	G	A	1	0	1	0	0	1	0	0
3	33069274	.	A	C	2	3	5	0	0	5	0	0
3	33069596	.	G	A	3	5	8	0	3	11	0	0
3	33341072	.	T	A	3	1	4	0	1	5	0	0
3	33344470	.	T	A	6	10	16	0	1	17	0	0
3	33344636	.	A	T	1	5	6	0	0	6	0	0
3	33368134	.	T	C	0	2	2	0	0	2	0	0
3	33372555	.	G	C	0	3	3	0	3	6	0	0
3	33373540	.	A	C	3	6	9	0	0	9	0	0
3	33375645	.	C	A	1	6	7	0	0	7	0	0
3	33420561	.	C	T	2	3	5	0	0	5	0	0
3	33420614	.	A	T	2	3	5	0	0	5	0	0
3	33424010	.	C	T	0	8	8	0	9	17	0	0
3	33424420	.	G	A	26	17	43	0	4	47	0	0
3	33426513	.	G	A	11	4	15	0	0	15	0	0
3	33433621	.	G	A	9	4	13	0	0	13	0	0
3	33449405	.	C	T	5	2	7	0	0	7	0	0
3	33449554	.	G	A	0	5	5	0	2	7	0	0
3	33452168	.	C	T	14	12	26	0	2	28	0	0
3	33455809	.	G	A	1	5	6	0	12	18	0	0
3	33458803	.	C	T	16	20	36	0	3	39	0	0
3	33458911	.	A	T	16	10	26	0	1	27	0	0
3	33459394	.	T	A	12	5	17	0	1	18	0	0
3	33459489	.	C	T	3	9	12	0	1	13	0	0
3	33459517	.	C	T	6	12	18	0	2	20	0	0
3	33459532	.	G	A	9	13	22	0	2	24	0	0
3	33461366	.	C	T	0	12	12	0	15	27	0	0
3	33461646	.	C	T	0	7	7	0	10	17	0	0
3	33461796	.	A	T	11	14	25	0	0	25	0	0
3	33469614	.	T	A	2	2	4	0	0	4	0	0
3	33473131	.	C	T	0	6	6	0	6	12	0	0
3	33476589	.	T	C	3	8	11	0	0	11	0	0
3	33478690	.	G	A	3	1	4	0	1	5	0	0
3	33761597	.	C	T	9	10	19	0	0	19	0	0
3	33761705	.	G	A	0	15	15	0	19	34	0	0
3	33761834	.	G	A	12	13	25	0	1	26	0	0
3	33761835	.	A	T	10	13	23	0	3	26	0	0
3	33762068	.	A	G	11	6	17	0	2	19	0	0
3	33762278	.	A	G	12	16	28	0	2	30	0	0
3	33762310	.	C	A	13	13	26	0	3	29	0	0
3	33762408	.	T	A	11	14	25	0	0	25	0	0
3	33762480	.	C	T	10	4	14	0	1	15	0	0
3	33773294	.	A	G	12	6	18	0	1	19	0	0
3	33777317	.	T	G	7	6	13	0	2	15	0	0
3	33777425	.	A	G	12	8	20	0	1	21	0	0
3	33777807	.	A	G	1	1	2	0	1	3	0	0
3	33820568	.	C	T	1	2	3	0	0	4	1	0
3	33820580	.	A	G	0	3	3	0	0	3	0	0
3	33918537	.	T	A	0	3	3	0	0	3	0	0
3	33918611	.	A	G	2	3	5	0	0	5	0	0
3	33918775	.	A	G	3	5	8	0	0	8	0	0
3	33921663	.	A	C	5	9	14	0	3	17	0	0
3	33921878	.	C	A	0	3	3	0	1	4	0	0
3	33922269	.	A	G	5	2	7	0	0	7	0	0
3	33922359	.	G	A	3	13	16	0	1	17	0	0
3	33922413	.	T	A	6	9	15	0	1	16	0	0
3	33922415	.	G	A	6	10	16	0	0	16	0	0
3	33922471	.	T	C	6	10	16	0	2	18	0	0
3	33932170	.	C	T	0	3	3	0	3	6	0	0
3	33932628	.	G	A	2	7	9	0	0	9	0	0
3	33934848	.	T	C	3	5	8	0	1	9	0	0
3	33934849	.	G	C	4	5	9	0	0	9	0	0
3	33936783	.	G	C	5	3	8	0	0	8	0	0
3	34129941	.	C	T	1	11	12	0	12	24	0	0
3	34135868	.	C	T	2	1	3	0	0	3	0	0
3	34144807	.	C	G	3	2	5	0	0	5	0	0
3	34144808	.	G	A	0	2	2	0	3	5	0	0
3	34146338	.	C	T	5	2	7	0	0	7	0	0
3	34146882	.	G	T	7	14	21	0	0	21	0	0
3	34146955	.	A	G	2	3	5	0	0	5	0	0
3	34166288	.	C	A	2	6	8	0	1	9	0	0
3	34170913	.	G	A	14	12	26	0	0	26	0	0
3	34180332	.	A	G	3	2	5	0	1	6	0	0
3	34182164	.	C	T	8	8	16	0	0	16	0	0
3	34182306	.	G	C	11	6	17	0	0	17	0	0
3	34182376	.	A	C	10	4	14	0	0	14	0	0
3	34182386	.	G	A	0	4	4	0	8	12	0	0
3	34244901	.	G	C	9	9	18	0	1	19	0	0
3	34245001	.	A	G	3	2	5	0	2	7	0	0
3	34258965	.	G	A	17	15	32	0	1	33	0	0
3	34259013	.	C	G	23	12	35	0	3	38	0	0
3	34259060	.	C	T	25	18	43	0	0	43	0	0
3	34260325	.	T	C	7	9	16	0	0	16	0	0
3	34260808	.	T	C	11	6	17	0	1	18	0	0
3	34261204	.	T	C	5	5	10	0	0	10	0	0
3	34261354	.	A	G	10	14	24	0	0	24	0	0
3	34261662	.	G	A	11	3	14	0	0	14	0	0
3	34261664	.	G	A	10	2	12	0	2	14	0	0
3	34261795	.	G	A	7	8	15	0	0	15	0	0
3	34262290	.	C	T	7	11	18	0	0	18	0	0
3	34262421	.	C	A	7	5	12	0	1	13	0	0
3	34262639	.	G	A	7	7	14	0	1	15	0	0
3	34262823	.	A	T	6	7	13	0	1	14	0	0
3	34263007	.	C	T	0	3	3	1	7	11	0	0
3	34263101	.	T	A	4	2	6	0	1	7	0	0
3	34264140	.	A	T	2	2	4	0	0	4	0	0
3	34264634	.	T	A	3	4	7	0	0	7	0	0
3	34456538	.	A	G	2	3	5	0	1	6	0	0
3	34588493	.	A	G	2	2	4	0	0	4	0	0
3	34588788	.	G	A	6	2	8	0	0	8	0	0
3	34590350	.	A	C	2	2	4	0	0	4	0	0
3	34604202	.	A	G	3	2	5	0	1	6	0	0
3	34697461	.	G	A	2	4	6	0	2	9	1	0
3	34767112	.	G	T	26	25	51	0	9	60	0	0
3	34767662	.	T	G	30	34	64	0	2	66	0	0
3	34767669	.	G	A	28	33	61	0	1	62	0	0
3	34772941	.	T	G	17	21	38	0	1	39	0	0
3	34775942	.	G	A	17	23	40	0	0	41	1	0
3	34776115	.	T	G	0	3	3	0	0	3	0	0
3	34776133	.	G	C	0	4	4	0	0	4	0	0
3	34776151	.	C	A	0	4	4	0	0	4	0	0
3	34781074	.	A	G	16	19	35	0	0	35	0	0
3	34781095	.	C	T	18	18	36	0	1	37	0	0
3	34781448	.	T	C	6	4	10	0	0	10	0	0
3	34783970	.	G	A	2	2	4	0	0	4	0	0
3	34783982	.	A	G	1	2	3	0	1	4	0	0
3	34801034	.	T	C	2	2	4	0	1	5	0	0
3	34804427	.	A	G	12	9	21	0	3	24	0	0
3	34811024	.	G	A	6	3	9	0	0	9	0	0
3	34811042	.	C	T	2	2	4	0	2	6	0	0
3	34814839	.	A	G	2	3	5	0	1	6	0	0
3	34822049	.	C	T	4	8	12	0	1	13	0	0
3	34822169	.	C	T	9	6	15	0	0	15	0	0
3	34822214	.	T	C	2	6	8	0	1	9	0	0
3	34911704	.	A	T	0	2	2	0	0	2	0	0
3	34919892	.	C	T	5	3	8	0	1	9	0	0
3	34977497	.	A	G	6	0	6	0	4	10	0	0
3	34977508	.	A	G	1	0	1	0	2	3	0	0
3	34994140	.	C	T	31	29	60	0	1	61	0	0
3	34994750	.	A	G	16	9	25	0	2	27	0	0
3	35170112	.	T	C	4	0	4	0	0	4	0	0
3	35225202	.	C	T	13	8	21	0	2	23	0	0
3	35248470	.	T	C	5	10	15	0	0	15	0	0
3	35248492	.	T	A	8	11	19	0	2	21	0	0
3	35249369	.	T	C	14	17	31	0	5	36	0	0
3	35249535	.	T	C	12	20	32	0	2	34	0	0
3	35250145	.	A	T	21	20	41	0	2	43	0	0
3	35250188	.	A	G	9	13	22	0	5	27	0	0
3	35264406	.	T	G	20	18	38	0	2	40	0	0
3	35264460	.	C	T	21	17	38	0	0	38	0	0
3	35264744	.	T	A	25	11	36	0	0	36	0	0
3	35264951	.	G	A	16	9	25	0	0	25	0	0
3	35264970	.	C	T	11	5	16	1	2	19	0	0
3	35265350	.	T	C	16	20	36	0	1	37	0	0
3	35265419	.	T	G	20	21	41	0	2	43	0	0
3	35265654	.	G	A	0	25	25	0	32	57	0	0
3	35266006	.	G	A	2	4	6	0	0	6	0	0
3	35374719	.	C	T	11	10	21	0	3	24	0	0
3	35375112	.	G	A	10	9	19	0	2	21	0	0
3	35375162	.	T	A	12	8	20	0	4	24	0	0
3	35375279	.	A	T	9	12	21	0	2	23	0	0
3	35375306	.	T	C	8	8	16	0	2	18	0	0
3	35375448	.	T	G	14	0	14	0	22	36	0	0
3	35375638	.	T	A	19	15	34	0	4	38	0	0
3	35406648	.	G	T	0	2	2	0	2	4	0	0
3	35418047	.	A	G	3	2	5	0	0	5	0	0
3	35419683	.	A	T	8	9	17	0	0	17	0	0
3	35420588	.	A	G	6	7	13	0	2	15	0	0
3	35420604	.	C	T	5	7	12	0	0	12	0	0
3	35515074	.	C	T	1	2	3	0	0	3	0	0
3	35515179	.	T	C	1	3	4	0	0	4	0	0
3	35515206	.	G	A	1	4	5	0	0	5	0	0
3	35515304	.	T	G	1	2	3	0	0	3	0	0
3	35517999	.	A	C	3	3	6	0	0	6	0	0
3	35518962	.	C	A	2	3	5	0	0	5	0	0
3	35523824	.	C	G	3	5	8	0	0	8	0	0
3	35527024	.	T	C	0	2	2	0	0	2	0	0
3	35529040	.	T	C	5	6	11	0	0	11	0	0
3	35531018	.	T	C	7	4	11	0	4	15	0	0
3	35531028	.	T	C	9	6	15	0	1	16	0	0
3	35531328	.	G	A	1	11	12	0	8	20	0	0
3	35531329	.	A	T	8	12	20	0	0	20	0	0
3	35531671	.	A	T	5	15	20	0	1	21	0	0
3	35531866	.	T	A	23	10	33	0	1	34	0	0
3	35531985	.	G	A	23	18	41	0	1	42	0	0
3	35532074	.	A	T	15	12	27	0	2	29	0	0
3	35532452	.	A	T	23	18	41	0	2	43	0	0
3	35532634	.	A	G	12	0	12	0	20	32	0	0
3	35532665	.	C	T	9	14	23	0	4	27	0	0
3	35532736	.	A	C	17	11	28	0	0	28	0	0
3	35535695	.	A	C	1	1	2	0	0	2	0	0
3	35535702	.	G	T	1	1	2	0	0	2	0	0
3	35535818	.	G	A	0	1	1	0	1	2	0	0
3	35536115	.	C	G	12	15	27	0	1	28	0	0
3	35536269	.	G	A	0	5	5	0	0	5	0	0
3	35541273	.	A	G	25	22	47	0	7	54	0	0
3	35548780	.	T	C	1	2	3	0	0	3	0	0
3	35548822	.	C	A	2	4	6	0	0	6	0	0
3	35549002	.	G	A	2	4	6	0	0	6	0	0
3	35549178	.	C	T	1	2	3	0	0	3	0	0
3	35551047	.	A	T	15	13	28	0	1	30	1	0
3	35551190	.	C	T	0	9	9	0	15	24	0	0
3	35589548	.	C	T	23	18	41	0	2	43	0	0
3	35589881	.	T	C	17	19	36	0	8	44	0	0
3	35589908	.	A	G	25	27	52	0	2	54	0	0
3	35589918	.	G	A	23	28	51	0	5	56	0	0
3	35590270	.	T	C	21	0	21	0	31	52	0	0
3	35602007	.	A	C	8	0	8	0	29	37	0	0
3	35602047	.	A	G	15	19	34	0	3	37	0	0
3	35602153	.	A	G	9	15	24	0	2	26	0	0
3	35602154	.	T	A	9	16	25	0	1	26	0	0
3	35634953	.	A	G	2	4	6	0	1	7	0	0
3	35635039	.	C	T	9	7	16	0	2	18	0	0
3	35636157	.	A	G	2	2	4	0	1	5	0	0
3	35638008	.	T	A	7	8	15	0	2	17	0	0
3	35638119	.	A	C	21	15	36	0	0	36	0	0
3	35638201	.	A	G	16	15	31	0	3	34	0	0
3	35638240	.	C	T	13	15	28	0	1	29	0	0
3	35638366	.	T	C	10	3	13	0	3	16	0	0
3	35638513	.	G	A	14	9	23	0	0	23	0	0
3	35638908	.	C	T	0	16	16	0	19	35	0	0
3	35638986	.	C	A	15	22	37	0	0	37	0	0
3	35639020	.	A	G	12	20	32	0	0	32	0	0
3	35639021	.	G	A	11	20	31	0	1	32	0	0
3	35639621	.	A	C	10	15	25	0	2	27	0	0
3	35639817	.	T	A	5	5	10	0	0	10	0	0
3	35639862	.	G	T	10	6	16	0	0	16	0	0
3	35640042	.	A	G	10	8	18	0	0	18	0	0
3	35640122	.	G	T	9	10	19	0	3	22	0	0
3	35640625	.	C	T	7	10	17	0	2	19	0	0
3	35640784	.	T	C	9	6	15	0	0	15	0	0
3	35640828	.	A	G	6	5	11	1	1	13	0	0
3	35641173	.	C	T	3	3	6	0	0	6	0	0
3	35641371	.	C	T	0	13	13	0	13	26	0	0
3	35641382	.	G	A	12	12	24	0	1	25	0	0
3	35641595	.	A	T	5	15	20	0	1	21	0	0
3	35641663	.	T	C	7	9	16	0	1	17	0	0
3	35641785	.	C	T	0	8	8	0	4	12	0	0
3	35642012	.	A	T	5	10	15	0	0	15	0	0
3	35642072	.	A	G	6	9	15	0	0	15	0	0
3	35643320	.	G	A	3	7	10	0	3	13	0	0
3	35643357	.	G	A	2	3	5	0	3	8	0	0
3	35643540	.	G	A	4	8	12	0	0	12	0	0
3	35643546	.	A	T	3	5	8	0	1	9	0	0
3	35645411	.	G	A	7	4	11	0	1	12	0	0
3	35645661	.	T	G	12	5	17	0	1	18	0	0
3	35646025	.	G	T	6	5	11	0	0	11	0	0
3	35646160	.	G	T	4	4	8	0	1	9	0	0
3	35647321	.	G	A	1	1	2	0	1	3	0	0
3	35647975	.	A	G	0	1	1	0	0	1	0	0
3	35800614	.	C	G	1	3	4	0	1	5	0	0
3	35800936	.	A	C	0	4	4	0	0	4	0	0
3	35831095	.	G	T	0	4	4	0	2	6	0	0
3	35831167	.	T	C	2	2	4	0	1	5	0	0
3	35840264	.	A	G	3	0	3	0	3	6	0	0
3	35840267	.	T	A	3	3	6	0	0	6	0	0
3	35846410	.	A	T	2	6	8	0	0	8	0	0
3	35846440	.	G	A	5	3	8	0	1	9	0	0
3	35846823	.	A	G	7	4	11	0	0	11	0	0
3	35849855	.	T	C	3	2	5	0	0	5	0	0
3	35850380	.	C	T	3	4	7	0	0	7	0	0
3	36023342	.	T	G	7	13	20	0	0	20	0	0
3	36023455	.	A	G	9	14	23	0	0	23	0	0
3	36023465	.	A	G	8	13	21	0	3	24	0	0
3	36026294	.	C	G	0	8	8	0	6	14	0	0
3	36032241	.	G	A	2	0	2	0	0	2	0	0
3	36038631	.	G	A	6	7	13	0	1	14	0	0
3	36040863	.	A	G	1	1	2	0	0	2	0	0
3	36041017	.	A	C	5	1	6	0	3	9	0	0
3	36123546	.	G	A	2	1	3	0	0	3	0	0
3	36125256	.	C	G	1	4	5	0	6	11	0	0
3	36131883	.	T	A	7	5	12	0	1	13	0	0
3	36132099	.	C	T	0	2	2	0	1	3	0	0
3	36132740	.	T	C	9	10	19	0	0	19	0	0
3	36135084	.	A	G	2	3	5	0	0	5	0	0
3	36135309	.	G	A	1	2	3	0	1	4	0	0
3	36136184	.	T	A	1	2	3	0	0	3	0	0
3	36136186	.	A	T	1	2	3	0	0	3	0	0
3	36136609	.	T	C	4	2	6	0	0	6	0	0
3	36173633	.	T	C	8	16	24	0	0	24	0	0
3	36174175	.	C	A	7	22	29	0	2	31	0	0
3	36174248	.	C	G	11	11	22	0	0	22	0	0
3	36184806	.	A	G	3	4	7	0	0	7	0	0
3	36188400	.	A	G	2	0	2	0	0	2	0	0
3	36228310	.	T	C	1	0	1	0	0	1	0	0
3	36228319	.	T	G	1	0	1	0	0	1	0	0
3	36229886	.	A	T	4	1	5	0	0	5	0	0
3	36232218	.	A	G	2	3	5	0	1	6	0	0
3	36232331	.	C	T	6	9	15	0	1	16	0	0
3	36232368	.	A	C	3	5	8	0	0	8	0	0
3	36241839	.	T	C	5	1	6	0	0	6	0	0
3	36241938	.	T	C	1	0	1	0	2	3	0	0
3	36242239	.	C	T	0	5	5	0	1	6	0	0
3	36249172	.	C	T	6	5	11	0	0	11	0	0
3	36249419	.	G	A	21	7	28	0	3	31	0	0
3	36249476	.	T	A	21	14	35	0	0	35	0	0
3	36249516	.	T	A	12	12	24	0	4	28	0	0
3	36249518	.	A	C	14	13	27	0	1	28	0	0
3	36255436	.	A	G	3	5	8	0	0	8	0	0
3	36259855	.	T	C	8	12	20	0	1	21	0	0
3	36262799	.	A	C	14	0	14	0	21	35	0	0
3	36263099	.	T	C	11	0	11	0	24	35	0	0
3	36263151	.	A	G	11	18	29	0	2	31	0	0
3	36263163	.	C	T	10	18	28	0	1	29	0	0
3	36263464	.	C	A	19	10	29	0	2	31	0	0
3	36263557	.	A	G	9	20	29	0	2	31	0	0
3	36263563	.	T	A	10	21	31	0	0	31	0	0
3	36263596	.	T	C	5	0	5	0	12	17	0	0
3	36263824	.	T	C	12	22	34	0	4	38	0	0
3	36263895	.	A	T	9	13	22	0	1	23	0	0
3	36264204	.	T	G	8	13	21	0	2	23	0	0
3	36264217	.	A	C	6	17	23	0	2	25	0	0
3	36264248	.	T	C	9	11	20	0	1	21	0	0
3	36264498	.	G	A	8	10	18	0	3	21	0	0
3	36264582	.	C	G	3	11	14	0	1	15	0	0
3	36265895	.	C	T	0	3	3	0	1	4	0	0
3	36266137	.	T	A	1	1	2	0	0	2	0	0
3	36266173	.	A	G	5	3	8	0	1	9	0	0
3	36268616	.	A	G	4	4	8	0	0	8	0	0
3	36292481	.	G	C	0	0	0	0	7	7	0	0
3	36292657	.	T	C	0	2	2	0	0	2	0	0
3	36293950	.	C	T	3	3	6	0	1	7	0	0
3	36293964	.	C	T	4	3	7	0	0	7	0	0
3	36305854	.	A	G	18	21	39	0	6	45	0	0
3	36305860	.	A	G	23	1	24	0	22	46	0	0
3	36305971	.	T	A	16	15	31	0	1	32	0	0
3	36325569	.	T	A	1	3	4	0	0	4	0	0
3	36325648	.	A	T	5	4	9	0	1	10	0	0
3	36325726	.	C	T	5	3	8	0	0	8	0	0
3	36326091	.	A	C	1	2	3	0	0	3	0	0
3	36326139	.	T	G	1	3	4	0	0	4	0	0
3	36326370	.	A	G	5	3	8	0	0	8	0	0
3	36326681	.	T	C	6	2	8	0	0	8	0	0
3	36326685	.	T	A	6	2	8	0	1	9	0	0
3	36327060	.	G	A	1	4	5	0	1	6	0	0
3	36327061	.	A	C	2	4	6	0	0	6	0	0
3	36327097	.	C	T	5	2	7	0	1	8	0	0
3	36327129	.	G	A	9	4	13	0	1	14	0	0
3	36327793	.	T	A	8	2	10	0	0	10	0	0
3	36327802	.	C	A	9	3	12	0	1	14	1	0
3	36327906	.	G	T	5	4	9	0	0	9	0	0
3	36327909	.	G	T	0	4	4	0	5	9	0	0
3	36328029	.	T	G	4	2	6	0	0	6	0	0
3	36328204	.	C	A	11	3	14	0	0	14	0	0
3	36328218	.	G	A	13	6	19	0	0	19	0	0
3	36328339	.	G	A	4	7	11	0	2	13	0	0
3	36328390	.	A	T	1	4	5	0	0	5	0	0
3	36328414	.	T	A	1	2	3	0	0	3	0	0
3	36402930	.	T	C	1	0	1	0	6	7	0	0
3	36407283	.	C	A	2	2	4	0	0	4	0	0
3	36409656	.	C	T	0	3	3	0	0	3	0	0
3	36409877	.	C	T	1	2	3	0	0	3	0	0
3	36409969	.	T	C	4	2	6	0	0	6	0	0
3	36410038	.	T	A	1	3	4	0	0	4	0	0
3	36410157	.	A	G	3	2	5	0	0	5	0	0
3	36410172	.	A	G	3	2	5	0	0	5	0	0
3	36414501	.	A	G	1	2	3	0	0	3	0	0
3	36428612	.	T	A	20	18	38	0	5	43	0	0
3	36428620	.	T	A	19	18	37	0	7	45	1	0
3	36431380	.	T	C	6	9	15	0	0	15	0	0
3	36442021	.	T	C	2	3	5	0	0	5	0	0
3	36442029	.	A	G	1	1	2	0	0	2	0	0
3	36442071	.	A	G	2	4	6	0	0	6	0	0
3	36442551	.	C	T	0	10	10	0	11	21	0	0
3	36442661	.	T	G	10	9	19	0	0	19	0	0
3	36442726	.	A	G	18	13	31	0	2	33	0	0
3	36443189	.	G	A	1	0	1	0	0	1	0	0
3	36446613	.	A	G	2	2	4	0	0	4	0	0
3	36859720	.	C	T	2	4	6	0	0	6	0	0
3	36859755	.	A	T	3	4	7	0	0	7	0	0
3	36868428	.	T	C	1	2	3	0	0	3	0	0
3	36871254	.	A	T	3	3	6	0	0	6	0	0
3	36871260	.	G	A	0	4	4	0	2	6	0	0
3	36871310	.	A	G	6	1	7	0	4	11	0	0
3	36871316	.	A	G	5	1	6	0	5	11	0	0
3	36877656	.	A	G	11	5	16	0	0	16	0	0
3	36880046	.	C	T	4	1	5	0	0	5	0	0
3	36888169	.	T	C	2	1	3	0	1	4	0	0
3	36888395	.	G	A	5	1	6	0	0	6	0	0
3	36889376	.	G	A	0	1	1	0	2	3	0	0
3	36892130	.	C	T	19	9	28	0	1	29	0	0
3	36892514	.	G	C	2	2	4	0	1	5	0	0
3	36895506	.	A	T	2	3	5	0	0	5	0	0
3	36895509	.	A	C	3	3	6	0	0	6	0	0
3	36907411	.	T	C	1	1	2	0	0	2	0	0
3	36917320	.	A	T	0	2	2	0	0	2	0	0
3	36917365	.	A	G	2	2	4	0	0	4	0	0
3	37107093	.	C	T	2	2	4	0	1	5	0	0
3	37558571	.	C	A	3	3	6	0	1	7	0	0
3	37558591	.	G	A	1	2	3	0	0	3	0	0
3	37559334	.	A	T	34	26	60	0	1	61	0	0
3	37559905	.	A	C	15	15	30	0	1	31	0	0
3	37564769	.	G	A	7	12	19	0	1	20	0	0
3	37660307	.	G	A	7	5	12	0	1	13	0	0
3	37664117	.	A	T	11	15	26	0	1	27	0	0
3	37664635	.	A	G	13	10	23	0	2	25	0	0
3	37665855	.	G	A	24	11	35	0	4	39	0	0
3	37666774	.	C	T	0	9	9	0	14	23	0	0
3	37667562	.	C	T	0	15	15	0	13	28	0	0
3	37667608	.	G	C	20	7	27	0	1	28	0	0
3	37667646	.	C	T	19	8	27	0	1	28	0	0
3	37667952	.	C	T	0	6	6	0	10	16	0	0
3	37668319	.	A	G	2	1	3	0	2	5	0	0
3	37668370	.	T	C	2	2	4	0	0	4	0	0
3	37668578	.	T	A	2	5	7	0	0	7	0	0
3	37668667	.	C	A	2	3	5	0	2	7	0	0
3	37670156	.	G	T	4	2	6	0	0	6	0	0
3	37727784	.	T	C	1	1	2	0	1	3	0	0
3	37727926	.	C	G	3	2	5	0	0	5	0	0
3	37737680	.	C	A	3	7	10	0	1	11	0	0
3	37737735	.	T	G	3	0	3	0	2	5	0	0
3	37737736	.	C	T	2	2	4	0	1	5	0	0
3	37738024	.	A	G	2	5	7	0	1	8	0	0
3	37738050	.	C	G	2	3	5	0	1	6	0	0
3	37738089	.	G	A	3	3	6	0	1	7	0	0
3	37742152	.	T	C	0	2	2	0	0	2	0	0
3	37742245	.	C	T	3	6	9	0	0	9	0	0
3	37742247	.	A	G	3	6	9	0	0	9	0	0
3	37742284	.	T	G	2	4	6	0	2	8	0	0
3	37742338	.	C	G	1	2	3	0	1	4	0	0
3	37776713	.	T	C	5	5	10	0	1	11	0	0
3	37777417	.	G	C	2	4	6	0	0	6	0	0
3	37777508	.	T	A	4	2	6	0	0	6	0	0
3	37777590	.	C	T	4	5	9	0	0	9	0	0
3	37777811	.	C	T	0	14	14	0	7	21	0	0
3	37788401	.	T	C	3	1	4	0	0	4	0	0
3	38505629	.	A	G	3	5	8	0	0	8	0	0
3	38614366	.	C	T	0	1	1	0	0	1	0	0
3	38614562	.	C	T	0	2	2	0	0	2	0	0
3	38624823	.	G	A	15	5	20	0	0	20	0	0
3	38625098	.	A	C	16	7	23	0	1	24	0	0
3	38625497	.	G	T	13	5	18	0	0	18	0	0
3	38625559	.	T	C	9	6	15	0	0	15	0	0
3	38625605	.	G	A	10	8	18	0	1	19	0	0
3	38625751	.	A	C	8	7	15	0	1	16	0	0
3	38625901	.	T	G	7	8	15	0	1	16	0	0
3	38649991	.	A	T	6	9	15	0	0	15	0	0
3	38650440	.	T	C	4	8	12	0	1	13	0	0
3	38650462	.	T	C	2	6	8	0	1	9	0	0
3	38763153	.	T	A	9	9	18	0	1	19	0	0
3	38763391	.	A	G	9	5	14	0	2	16	0	0
3	38763449	.	C	T	4	5	9	0	0	9	0	0
3	38763527	.	C	T	0	3	3	0	8	11	0	0
3	38763564	.	C	A	4	6	10	0	0	10	0	0
3	38763700	.	G	A	11	5	16	0	2	18	0	0
3	38764227	.	C	T	3	3	6	0	0	6	0	0
3	38764229	.	G	A	2	3	5	0	1	6	0	0
3	38764990	.	G	T	2	4	6	0	0	6	0	0
3	38765149	.	A	T	2	2	4	0	0	4	0	0
3	38858908	.	G	A	0	3	3	0	2	5	0	0
3	38858949	.	G	C	5	5	10	0	0	10	0	0
3	38859066	.	G	A	2	3	5	0	0	5	0	0
3	38859126	.	A	T	1	2	3	0	1	4	0	0
3	39181560	.	A	C	3	2	5	0	1	6	0	0
3	39181635	.	C	T	1	3	4	0	2	6	0	0
3	39184156	.	A	G	5	5	10	0	1	11	0	0
3	39184180	.	C	T	4	7	11	0	1	12	0	0
3	39184710	.	A	G	1	3	4	0	0	4	0	0
3	39189208	.	G	T	0	2	2	0	0	2	0	0
3	39189212	.	A	G	0	2	2	0	0	2	0	0
3	39238579	.	C	A	5	11	16	0	0	16	0	0
3	39238580	.	C	A	5	10	15	0	1	16	0	0
3	39239380	.	A	G	6	4	10	0	1	11	0	0
3	39241350	.	G	T	3	2	5	0	2	7	0	0
3	39248863	.	A	G	4	4	8	0	0	8	0	0
3	39259624	.	T	C	6	0	6	0	8	14	0	0
3	39260818	.	A	G	3	2	5	0	1	6	0	0
3	39260934	.	G	A	2	2	4	0	0	4	0	0
3	39261182	.	C	A	0	2	2	0	2	4	0	0
3	39313310	.	A	G	4	9	13	0	4	17	0	0
3	39313625	.	T	C	6	12	18	0	0	18	0	0
3	39314028	.	C	T	8	13	21	0	0	21	0	0
3	39314101	.	T	C	13	12	25	0	1	26	0	0
3	39314146	.	C	G	12	8	20	0	1	21	0	0
3	39314260	.	A	G	3	3	6	0	2	8	0	0
3	39314502	.	G	C	11	6	17	0	0	17	0	0
3	39314631	.	C	T	0	4	4	0	10	14	0	0
3	39314677	.	C	T	7	4	11	0	1	12	0	0
3	39314857	.	G	T	1	3	4	0	0	4	0	0
3	39315154	.	C	A	4	5	9	0	1	10	0	0
3	39315169	.	C	G	3	6	9	0	0	9	0	0
3	39315728	.	C	T	0	4	4	0	0	4	0	0
3	39315737	.	T	C	0	4	4	0	0	4	0	0
3	39315816	.	A	G	1	3	4	0	0	4	0	0
3	39315874	.	C	A	2	1	3	0	2	5	0	0
3	39315876	.	C	T	2	2	4	0	1	5	0	0
3	39316570	.	G	A	2	2	4	0	0	4	0	0
3	39316846	.	T	C	4	7	11	0	0	11	0	0
3	39316906	.	C	A	3	5	8	0	1	9	0	0
3	39316912	.	G	A	4	4	8	0	0	8	0	0
3	39316996	.	A	G	7	4	11	0	1	12	0	0
3	39317215	.	C	G	1	4	5	0	1	6	0	0
3	39317279	.	C	T	1	3	4	0	1	5	0	0
3	39317310	.	T	C	2	2	4	0	0	4	0	0
3	39317370	.	C	T	3	2	5	0	0	5	0	0
3	39328095	.	G	C	2	3	5	0	0	5	0	0
3	39568368	.	T	G	4	3	7	0	0	7	0	0
3	39568856	.	A	G	13	9	22	0	0	22	0	0
3	39574883	.	C	A	15	20	35	0	4	39	0	0
3	39574961	.	G	A	30	33	63	0	0	63	0	0
3	39576621	.	T	G	25	2	27	0	31	59	1	0
3	39576663	.	A	G	29	44	73	0	2	75	0	0
3	39576866	.	T	C	27	14	41	0	6	47	0	0
3	39586473	.	A	T	2	2	4	0	0	4	0	0
3	39592797	.	C	T	2	1	3	0	1	4	0	0
3	39592800	.	G	C	0	1	1	0	4	5	0	0
3	39606220	.	C	T	3	3	6	0	0	6	0	0
3	39612261	.	T	A	17	10	27	0	0	27	0	0
3	39612430	.	T	C	12	12	24	0	0	24	0	0
3	39612579	.	G	C	10	14	24	0	4	28	0	0
3	39612715	.	A	T	6	11	17	0	0	17	0	0
3	39613024	.	T	C	11	12	23	0	1	24	0	0
3	39631505	.	T	C	4	3	7	0	1	8	0	0
3	39688368	.	C	T	1	1	2	0	1	3	0	0
3	39689216	.	T	C	7	4	11	0	0	11	0	0
3	39689234	.	G	T	5	4	9	0	1	10	0	0
3	39689277	.	A	G	6	3	9	0	0	9	0	0
3	39691978	.	C	G	8	7	15	0	0	15	0	0
3	39692008	.	G	T	6	6	12	0	1	13	0	0
3	39692165	.	A	T	3	7	10	0	0	10	0	0
3	39692196	.	C	T	0	7	7	0	2	9	0	0
3	39692206	.	C	T	2	7	9	0	0	9	0	0
3	39692235	.	C	A	3	8	11	0	0	11	0	0
3	39692265	.	G	A	3	7	10	0	1	11	0	0
3	39692307	.	A	G	5	11	16	0	1	17	0	0
3	39877952	.	C	T	1	1	2	0	0	2	0	0
3	39940210	.	T	C	2	1	3	0	0	3	0	0
3	39949650	.	G	A	0	1	1	0	1	2	0	0
3	39950276	.	A	C	9	8	17	0	2	19	0	0
3	39950340	.	C	T	7	3	10	0	1	11	0	0
3	39950414	.	T	C	10	9	19	0	1	20	0	0
3	39950954	.	T	C	11	5	16	0	2	18	0	0
3	39951124	.	C	T	4	12	16	0	0	16	0	0
3	39951216	.	T	C	1	8	9	0	1	10	0	0
3	39951703	.	A	T	2	7	9	0	1	10	0	0
3	39952025	.	T	C	5	9	14	0	1	15	0	0
3	39952272	.	A	G	8	11	19	0	1	20	0	0
3	39952273	.	A	T	8	11	19	0	1	20	0	0
3	39958680	.	C	T	3	6	9	0	1	10	0	0
3	39958729	.	T	A	3	12	15	0	0	15	0	0
3	39959679	.	A	C	4	2	6	0	0	6	0	0
3	39962981	.	T	C	10	13	23	0	1	24	0	0
3	39963053	.	T	C	8	9	17	0	2	19	0	0
3	39963089	.	A	G	5	2	7	0	3	10	0	0
3	39970492	.	G	A	0	2	2	0	0	2	0	0
3	39970555	.	G	A	8	6	14	0	3	17	0	0
3	39970641	.	T	G	7	7	14	0	1	15	0	0
3	39971349	.	T	C	3	3	6	0	0	6	0	0
3	39971470	.	T	C	7	3	10	0	2	12	0	0
3	39971499	.	T	C	8	4	12	0	1	13	0	0
3	39971592	.	T	C	4	7	11	0	0	11	0	0
3	39971894	.	T	C	4	6	10	0	1	11	0	0
3	39982019	.	C	T	4	3	7	0	0	7	0	0
3	40154310	.	G	A	1	2	3	0	1	4	0	0
3	40154322	.	G	A	2	2	4	0	0	4	0	0
3	40154387	.	C	T	7	4	11	0	0	11	0	0
3	40158383	.	C	G	5	4	9	0	0	9	0	0
3	40160676	.	G	A	1	0	1	0	0	1	0	0
3	40164156	.	C	T	5	7	12	0	1	13	0	0
3	40164233	.	T	C	5	11	16	0	1	17	0	0
3	40164238	.	G	T	5	12	17	0	1	18	0	0
3	40165637	.	T	C	6	5	11	0	0	11	0	0
3	40165733	.	T	C	8	6	14	0	1	15	0	0
3	40168006	.	A	C	1	0	1	0	0	1	0	0
3	40168007	.	G	A	1	0	1	0	0	1	0	0
3	40168192	.	T	G	2	9	11	0	0	11	0	0
3	40168424	.	T	G	1	2	3	0	0	3	0	0
3	40172218	.	C	T	10	5	15	0	1	16	0	0
3	40178148	.	C	T	13	12	25	0	2	27	0	0
3	40178154	.	C	T	16	14	30	0	0	30	0	0
3	40178343	.	G	A	13	10	23	0	4	27	0	0
3	40178761	.	G	A	7	3	10	0	1	11	0	0
3	40178833	.	G	A	0	5	5	0	11	16	0	0
3	40178956	.	G	T	10	9	19	0	0	19	0	0
3	40179025	.	G	C	14	11	25	0	0	25	0	0
3	40179331	.	A	T	14	16	30	0	1	31	0	0
3	40179457	.	A	T	14	8	22	0	0	22	0	0
3	40179476	.	T	C	10	11	21	0	1	22	0	0
3	40179528	.	G	T	11	13	24	0	0	24	0	0
3	40179533	.	T	A	12	12	24	0	1	25	0	0
3	40179604	.	T	A	19	13	32	0	1	33	0	0
3	40179608	.	A	G	19	13	32	0	1	33	0	0
3	40179642	.	C	T	19	13	32	0	11	43	0	0
3	40179669	.	G	A	27	20	47	0	0	47	0	0
3	40179849	.	C	T	20	23	43	0	7	50	0	0
3	40179870	.	C	A	22	21	43	0	4	48	1	0
3	40180091	.	A	G	18	30	48	0	2	50	0	0
3	40180092	.	A	G	17	29	46	0	3	50	1	0
3	40180197	.	A	T	12	6	18	1	2	21	0	0
3	40186041	.	C	T	12	4	16	0	3	19	0	0
3	40188830	.	A	G	2	5	7	0	0	7	0	0
3	40190805	.	A	G	2	5	7	0	1	8	0	0
3	40190926	.	C	T	0	4	4	0	4	8	0	0
3	40191116	.	C	T	4	3	7	0	0	7	0	0
3	40193589	.	G	T	3	1	4	0	0	4	0	0
3	40202314	.	T	G	0	1	1	0	0	1	0	0
3	40206184	.	G	A	9	9	18	0	0	18	0	0
3	40206355	.	C	A	12	4	16	0	1	17	0	0
3	40206430	.	G	T	11	8	19	0	2	21	0	0
3	40206440	.	T	C	12	7	19	0	1	20	0	0
3	40206597	.	A	T	14	9	23	0	3	26	0	0
3	40206736	.	T	G	12	6	18	0	1	19	0	0
3	40206766	.	C	T	0	5	5	0	11	16	0	0
3	40207030	.	A	G	12	12	24	0	1	25	0	0
3	40207407	.	A	C	3	3	6	0	0	6	0	0
3	40207449	.	C	A	1	7	8	0	0	8	0	0
3	40212040	.	G	T	2	2	4	0	1	5	0	0
3	40214005	.	C	T	5	1	6	0	0	6	0	0
3	40216281	.	G	A	1	0	1	1	1	3	0	0
3	40235463	.	G	C	1	0	1	0	5	6	0	0
3	40235483	.	T	A	2	2	4	0	0	4	0	0
3	40237174	.	A	C	4	2	6	0	1	7	0	0
3	40237298	.	A	G	5	3	8	0	0	8	0	0
3	40237492	.	G	A	4	3	7	0	1	8	0	0
3	40237496	.	A	G	5	2	7	0	1	8	0	0
3	40237555	.	G	A	3	3	6	0	0	6	0	0
3	40237574	.	A	T	3	2	5	0	1	6	0	0
3	40246693	.	G	A	4	3	7	0	0	7	0	0
3	40256373	.	G	A	3	4	7	0	1	8	0	0
3	40256418	.	C	T	7	4	11	0	0	11	0	0
3	40256835	.	C	T	1	3	4	0	0	4	0	0
3	40256864	.	C	T	2	3	5	0	0	5	0	0
3	40280034	.	T	C	1	3	4	0	2	6	0	0
3	40284447	.	T	A	9	11	20	0	1	21	0	0
3	40284837	.	A	T	2	3	5	0	2	7	0	0
3	40284860	.	G	T	10	7	17	0	1	18	0	0
3	40287227	.	C	T	5	2	7	0	0	7	0	0
3	40287538	.	C	T	3	2	5	0	1	6	0	0
3	40287574	.	A	G	2	5	7	0	0	7	0	0
3	40287808	.	A	G	0	7	7	0	1	8	0	0
3	40287831	.	T	C	1	1	2	0	1	3	0	0
3	40290123	.	T	C	3	3	6	0	0	6	0	0
3	40294179	.	G	A	3	2	5	0	0	5	0	0
3	40299905	.	A	T	4	4	8	0	0	8	0	0
3	40318613	.	A	G	2	2	4	0	0	4	0	0
3	40333793	.	T	C	0	2	2	0	0	2	0	0
3	40346035	.	C	T	13	7	20	0	1	21	0	0
3	40348839	.	T	C	15	14	29	0	2	31	0	0
3	40349123	.	C	T	8	6	14	0	2	16	0	0
3	40349354	.	T	G	10	6	16	0	1	17	0	0
3	40349417	.	A	C	6	5	11	0	0	11	0	0
3	40404688	.	A	T	1	3	4	0	1	5	0	0
3	40444470	.	G	A	4	2	6	0	0	6	0	0
3	40451268	.	C	T	1	4	5	0	0	5	0	0
3	40467687	.	G	A	2	2	4	0	0	4	0	0
3	40467756	.	C	T	9	2	11	0	2	13	0	0
3	40468374	.	C	T	2	1	3	0	0	3	0	0
3	40479736	.	A	T	0	2	2	0	0	2	0	0
3	40480877	.	G	A	0	1	1	0	1	2	0	0
3	40480986	.	G	T	3	2	5	0	2	7	0	0
3	40484376	.	A	T	2	8	10	0	1	11	0	0
3	40484454	.	C	A	12	6	18	0	2	20	0	0
3	40485360	.	C	A	13	7	20	0	0	20	0	0
3	40485499	.	G	A	14	10	24	0	0	24	0	0
3	40485582	.	C	T	8	17	25	0	0	25	0	0
3	40485965	.	G	C	7	4	11	0	0	11	0	0
3	40486256	.	C	T	18	13	31	0	0	31	0	0
3	40486294	.	C	T	15	22	37	0	2	39	0	0
3	40487095	.	G	T	9	8	17	0	2	19	0	0
3	40487197	.	T	A	12	5	17	0	1	18	0	0
3	40487628	.	T	C	16	25	41	0	1	42	0	0
3	40487704	.	T	C	3	17	20	1	3	24	0	0
3	40487957	.	G	A	18	22	40	0	0	40	0	0
3	40488212	.	C	T	20	13	33	0	3	36	0	0
3	40488266	.	T	C	17	4	21	0	8	29	0	0
3	40488630	.	T	C	5	8	13	0	0	13	0	0
3	40488640	.	T	C	3	7	10	0	0	10	0	0
3	40527028	.	G	A	17	22	39	0	1	40	0	0
3	40527575	.	G	A	10	13	23	0	4	27	0	0
3	40528241	.	A	T	16	12	28	0	6	34	0	0
3	40576600	.	C	T	12	11	23	0	6	29	0	0
3	40576780	.	C	T	6	11	17	0	1	18	0	0
3	40577032	.	C	T	11	8	19	0	0	19	0	0
3	40581432	.	C	T	6	10	16	0	0	16	0	0
3	40587884	.	G	A	0	28	28	0	22	50	0	0
3	40587901	.	G	A	0	26	26	0	23	49	0	0
3	40588109	.	A	T	24	29	53	0	1	55	1	0
3	40588363	.	C	T	20	25	45	0	1	46	0	0
3	40588410	.	C	A	17	21	38	0	0	38	0	0
3	40588746	.	C	G	18	18	36	0	6	42	0	0
3	40589117	.	T	A	26	25	51	0	0	51	0	0
3	40589214	.	C	A	24	30	54	0	4	58	0	0
3	40589348	.	A	G	9	25	34	0	1	35	0	0
3	40589356	.	A	G	11	22	33	0	4	37	0	0
3	40605308	.	G	A	5	3	8	0	1	9	0	0
3	40615891	.	A	G	1	0	1	0	0	1	0	0
3	40615948	.	G	A	5	3	8	0	0	8	0	0
3	40647450	.	C	A	3	3	6	0	0	6	0	0
3	40649928	.	A	T	5	2	7	0	0	7	0	0
3	40656600	.	T	C	5	3	8	0	0	8	0	0
3	40690901	.	G	A	1	8	9	0	2	11	0	0
3	40690937	.	T	A	2	4	6	0	0	6	0	0
3	40690949	.	G	A	2	4	6	0	1	7	0	0
3	40691643	.	A	T	6	3	9	0	1	10	0	0
3	40691969	.	C	T	2	8	10	0	1	11	0	0
3	40692064	.	A	T	7	3	10	0	0	10	0	0
3	40692099	.	A	G	6	10	16	0	0	16	0	0
3	40698424	.	C	A	1	6	7	0	0	7	0	0
3	40698481	.	A	G	4	4	8	0	1	9	0	0
3	40716045	.	G	A	2	1	3	0	0	3	0	0
3	40804286	.	T	G	27	4	31	1	4	36	0	0
3	40804382	.	G	A	2	10	12	0	13	25	0	0
3	40817213	.	G	A	1	2	3	0	0	3	0	0
3	40817338	.	C	T	2	2	4	0	0	4	0	0
3	40817712	.	G	A	3	5	8	0	0	8	0	0
3	40820007	.	A	G	0	1	1	0	0	1	0	0
3	40821871	.	A	T	16	11	27	0	2	29	0	0
3	40826707	.	G	T	0	1	1	0	0	1	0	0
3	40833733	.	C	T	1	1	2	0	0	2	0	0
3	40833775	.	C	T	0	3	3	0	5	8	0	0
3	40876757	.	G	A	3	2	5	0	0	5	0	0
3	40876770	.	G	C	1	3	4	0	0	4	0	0
3	40880130	.	C	A	0	3	3	0	0	3	0	0
3	40883137	.	C	T	1	2	3	0	0	3	0	0
3	40902163	.	C	T	0	12	12	0	3	15	0	0
3	40913590	.	G	A	2	2	4	0	0	4	0	0
3	40913730	.	G	A	2	2	4	0	0	4	0	0
3	40932798	.	G	A	0	3	3	0	0	3	0	0
3	40969547	.	C	T	0	0	0	0	1	1	0	0
3	40979597	.	G	C	3	13	16	0	1	17	0	0
3	40979746	.	T	A	6	13	19	0	0	19	0	0
3	40979791	.	G	C	5	5	10	0	0	10	0	0
3	40980024	.	G	A	8	8	16	0	2	18	0	0
3	40980166	.	T	A	7	5	12	0	4	16	0	0
3	40980167	.	T	A	6	9	15	0	1	16	0	0
3	40980245	.	G	T	7	9	16	0	3	19	0	0
3	40983062	.	A	G	8	3	11	0	0	11	0	0
3	40990933	.	A	G	1	4	5	0	0	5	0	0
3	40995278	.	G	A	1	2	3	0	0	3	0	0
3	41003413	.	G	A	1	1	2	0	0	2	0	0
3	41030891	.	C	T	0	3	3	0	3	6	0	0
3	41030939	.	T	C	1	1	2	0	0	2	0	0
3	41037779	.	A	T	1	1	2	0	0	2	0	0
3	41705626	.	G	T	5	2	7	0	0	7	0	0
3	41715646	.	G	A	0	4	4	0	2	6	0	0
3	41719049	.	G	A	3	1	4	0	1	5	0	0
3	41721916	.	G	A	1	0	1	0	0	1	0	0
3	41723069	.	G	A	16	5	21	0	1	22	0	0
3	41723437	.	G	A	7	5	12	0	0	12	0	0
3	41724298	.	C	T	15	7	22	0	2	24	0	0
3	41724806	.	G	A	15	14	29	0	2	31	0	0
3	41917608	.	G	T	1	2	3	0	0	3	0	0
3	41917830	.	T	C	2	2	4	0	0	4	0	0
3	41925508	.	A	G	2	3	5	0	0	5	0	0
3	41925541	.	C	G	2	4	6	0	0	6	0	0
3	41925663	.	C	T	4	3	7	0	0	7	0	0
3	41925889	.	T	C	1	2	3	0	0	3	0	0
3	41926633	.	T	A	2	2	4	0	0	4	0	0
3	41926695	.	T	C	4	4	8	0	0	8	0	0
3	41955449	.	A	G	3	2	5	0	0	5	0	0
3	41955526	.	C	T	3	3	6	0	0	6	0	0
3	41955613	.	G	T	16	15	31	0	2	33	0	0
3	41955911	.	C	G	13	16	29	0	1	30	0	0
3	41956040	.	G	T	9	7	16	0	5	21	0	0
3	41956299	.	T	C	8	11	19	0	2	21	0	0
3	41956353	.	T	A	8	14	22	0	1	24	1	0
3	41956467	.	T	A	1	3	4	1	0	5	0	0
3	41956504	.	C	T	3	3	6	1	0	7	0	0
3	41956792	.	A	T	5	9	14	0	1	15	0	0
3	41956818	.	T	C	6	7	13	0	0	13	0	0
3	41956837	.	T	G	5	8	13	0	0	13	0	0
3	41956855	.	C	T	3	9	12	0	1	13	0	0
3	41956921	.	T	A	4	8	12	0	0	12	0	0
3	41956941	.	T	C	3	6	9	0	1	10	0	0
3	41956978	.	G	A	1	6	7	0	2	9	0	0
3	41957918	.	T	G	3	2	5	0	0	5	0	0
3	41957924	.	C	T	0	1	1	0	4	5	0	0
3	41958291	.	T	G	2	4	6	0	0	6	0	0
3	41959370	.	G	T	5	5	10	0	1	11	0	0
3	41959658	.	G	T	1	8	9	0	0	9	0	0
3	41959772	.	A	G	0	5	5	0	1	6	0	0
3	41959906	.	T	A	3	2	5	0	1	6	0	0
3	41960249	.	C	T	1	2	3	0	0	3	0	0
3	41960254	.	A	C	1	3	4	0	0	4	0	0
3	41961314	.	G	A	0	2	2	0	1	3	0	0
3	41961341	.	T	G	2	3	5	0	0	5	0	0
3	41961469	.	A	G	1	4	5	0	0	5	0	0
3	41961651	.	G	A	5	3	8	0	1	9	0	0
3	41962463	.	G	A	0	1	1	0	2	3	0	0
3	42126551	.	A	G	0	2	2	0	0	2	0	0
3	42126594	.	A	T	0	2	2	0	0	2	0	0
3	42126621	.	A	G	0	2	2	0	0	2	0	0
3	42918924	.	C	A	9	4	13	0	0	13	0	0
3	42919474	.	C	T	13	6	19	0	2	21	0	0
3	42919510	.	C	T	7	3	10	0	2	12	0	0
3	42919664	.	C	T	4	2	6	0	0	6	0	0
3	42919846	.	T	G	5	8	13	0	0	13	0	0
3	42919849	.	C	T	5	8	13	0	0	13	0	0
3	42919881	.	C	T	1	5	6	0	0	6	0	0
3	42919895	.	A	G	2	2	4	0	0	4	0	0
3	42919943	.	G	C	2	2	4	0	0	4	0	0
3	42919959	.	A	T	2	2	4	0	0	4	0	0
3	43040677	.	G	A	0	4	4	0	5	9	0	0
3	43052230	.	T	C	3	3	6	0	1	7	0	0
3	43059090	.	A	G	1	0	1	0	0	1	0	0
3	43059153	.	A	G	4	8	12	0	1	13	0	0
3	43060866	.	T	C	3	7	10	0	2	12	0	0
3	43376543	.	A	G	1	2	3	0	0	3	0	0
3	43380283	.	C	T	9	4	13	0	0	13	0	0
3	43392755	.	T	A	5	3	8	0	1	9	0	0
3	43392795	.	C	A	10	6	16	0	0	16	0	0
3	43474920	.	A	T	1	2	3	0	0	3	0	0
3	43475265	.	G	A	4	3	7	0	0	7	0	0
3	43475325	.	A	G	5	4	9	0	1	10	0	0
3	43475376	.	T	C	4	3	7	0	0	7	0	0
3	43475397	.	C	T	1	3	4	0	2	6	0	0
3	43475592	.	A	C	2	3	5	0	0	5	0	0
3	43475617	.	G	T	0	4	4	0	2	6	0	0
3	43475654	.	C	T	2	5	7	0	0	7	0	0
3	43476088	.	G	T	2	6	8	0	0	8	0	0
3	43476097	.	C	A	4	4	8	0	0	8	0	0
3	43476514	.	A	C	4	2	6	0	1	7	0	0
3	43476698	.	A	G	1	3	4	0	0	4	0	0
3	43476880	.	C	T	5	2	7	0	1	8	0	0
3	43476887	.	T	G	6	2	8	0	0	8	0	0
3	43477255	.	T	A	2	4	6	0	0	6	0	0
3	43477705	.	T	A	4	2	6	0	2	8	0	0
3	43477975	.	T	G	2	4	6	0	0	6	0	0
3	43478137	.	T	C	5	9	14	0	1	15	0	0
3	43478238	.	C	T	7	3	10	0	0	10	0	0
3	43478310	.	T	G	8	5	13	0	1	14	0	0
3	43478321	.	A	G	8	0	8	0	7	15	0	0
3	43478433	.	A	T	6	8	14	0	0	14	0	0
3	43478586	.	C	T	1	4	5	0	1	6	0	0
3	43579820	.	C	T	0	8	8	0	14	22	0	0
3	43580055	.	A	G	10	11	21	0	1	22	0	0
3	43580195	.	A	T	11	10	21	0	0	21	0	0
3	43580583	.	T	C	13	8	21	0	0	21	0	0
3	43581272	.	A	C	6	11	17	0	2	19	0	0
3	43584453	.	T	C	7	7	14	0	1	15	0	0
3	43594256	.	A	G	2	3	5	0	0	5	0	0
3	43594358	.	C	T	5	5	10	0	1	11	0	0
3	43594376	.	C	T	0	6	6	0	6	12	0	0
3	43594577	.	G	A	8	6	14	0	0	14	0	0
3	43594655	.	C	T	0	6	6	0	2	8	0	0
3	43594658	.	G	A	2	6	8	0	0	8	0	0
3	43594735	.	T	C	4	4	8	0	1	9	0	0
3	43600999	.	C	T	0	4	4	0	2	6	0	0
3	43645900	.	G	C	3	6	9	0	3	12	0	0
3	43646161	.	A	G	3	2	5	0	2	7	0	0
3	43754860	.	T	A	2	2	4	0	0	4	0	0
3	43791284	.	T	C	3	3	6	0	0	6	0	0
3	43791317	.	G	A	5	4	9	0	0	9	0	0
3	43793273	.	G	A	0	3	3	0	0	3	0	0
3	43801338	.	C	T	3	1	4	0	0	4	0	0
3	43807512	.	T	C	7	8	15	0	1	16	0	0
3	43807921	.	C	A	10	12	22	0	2	24	0	0
3	43807945	.	T	A	10	11	21	0	1	24	2	0
3	43821273	.	G	T	3	5	8	0	1	9	0	0
3	43821328	.	A	G	4	2	6	0	0	6	0	0
3	43825892	.	T	A	2	2	4	0	0	4	0	0
3	43825901	.	T	C	2	1	3	0	1	4	0	0
3	43828827	.	T	C	1	2	3	0	0	3	0	0
3	43828865	.	C	A	3	2	5	0	1	6	0	0
3	43828870	.	T	C	2	4	6	0	0	6	0	0
3	43828902	.	G	A	1	4	5	0	0	5	0	0
3	43828906	.	T	C	1	3	4	0	0	4	0	0
3	43829154	.	G	C	2	5	7	0	1	8	0	0
3	43829179	.	G	C	4	4	8	0	1	9	0	0
3	43829370	.	A	C	1	3	4	0	1	5	0	0
3	43829411	.	C	T	2	3	5	0	0	5	0	0
3	43829413	.	C	T	1	3	4	0	1	5	0	0
3	43829712	.	G	A	2	2	4	0	3	7	0	0
3	43942053	.	A	C	2	1	3	0	1	4	0	0
3	43944611	.	A	G	2	1	3	0	0	3	0	0
3	43953805	.	C	T	1	2	3	0	1	4	0	0
3	43985549	.	T	C	1	3	4	0	0	4	0	0
3	44077429	.	A	C	6	5	11	0	0	11	0	0
3	44077508	.	C	T	3	3	6	0	0	6	0	0
3	44077543	.	G	T	1	3	4	0	1	5	0	0
3	44081692	.	T	G	1	2	3	0	0	3	0	0
3	44081793	.	G	A	0	2	2	0	0	2	0	0
3	44082200	.	A	G	2	0	2	0	0	2	0	0
3	44082239	.	T	G	1	1	2	0	0	2	0	0
3	44082427	.	A	G	1	1	2	0	0	2	0	0
3	44082439	.	A	G	0	0	0	0	1	1	0	0
3	45261427	.	A	G	3	2	5	0	0	5	0	0
3	45284339	.	T	C	5	2	7	0	1	8	0	0
3	45715776	.	T	C	2	2	4	0	0	4	0	0
3	45716098	.	C	T	1	2	3	0	0	3	0	0
3	45716156	.	A	T	5	2	7	0	0	7	0	0
3	45716561	.	A	G	3	2	5	0	0	5	0	0
3	45716562	.	A	G	2	3	5	0	0	5	0	0
3	45716766	.	A	G	2	0	2	0	3	5	0	0
3	45717180	.	C	T	3	14	17	0	3	20	0	0
3	45776520	.	T	C	23	1	24	0	25	49	0	0
3	45776721	.	T	C	7	14	21	0	3	24	0	0
3	45814631	.	A	T	2	4	6	0	0	6	0	0
3	45815997	.	G	A	0	4	4	0	2	6	0	0
3	45816004	.	C	T	2	2	4	0	1	5	0	0
3	45816549	.	A	G	5	7	12	0	0	12	0	0
3	45816618	.	T	C	4	9	13	0	0	13	0	0
3	45845905	.	T	C	0	0	0	1	0	1	0	0
3	46553656	.	G	A	2	2	4	0	0	4	0	0
3	46795013	.	G	T	3	2	5	0	0	5	0	0
3	46795113	.	G	T	0	3	3	0	1	4	0	0
3	53074922	.	A	C	0	4	4	0	0	4	0	0
3	53446429	.	A	G	0	2	2	0	0	2	0	0
3	54906390	.	A	G	2	0	2	0	0	2	0	0
3	55100228	.	T	C	10	0	10	0	0	10	0	0
3	55104129	.	T	C	6	7	13	0	4	17	0	0
3	55104214	.	T	C	0	0	0	0	9	9	0	0
3	55104215	.	A	G	0	8	8	0	1	9	0	0
3	55421891	.	T	C	1	2	3	0	0	3	0	0
3	55508330	.	A	G	1	1	2	0	0	2	0	0
3	56883657	.	T	C	3	0	3	0	9	12	0	0
3	56883690	.	C	T	2	3	5	0	0	5	0	0
3	57173711	.	T	C	2	2	4	0	0	4	0	0
3	57322619	.	C	T	1	1	2	0	1	3	0	0
3	57423485	.	A	C	3	3	6	0	0	6	0	0
3	57423489	.	C	T	3	3	6	0	0	6	0	0
3	57424244	.	C	T	1	2	3	0	0	3	0	0
3	57462285	.	G	A	5	6	11	0	0	11	0	0
3	57462301	.	A	C	5	5	10	0	2	12	0	0
3	57462490	.	G	T	12	15	27	0	1	28	0	0
3	57462548	.	C	T	0	11	11	0	21	32	0	0
3	57462584	.	C	T	9	16	25	0	1	26	0	0
3	57462598	.	A	G	8	16	24	0	0	24	0	0
3	57462643	.	A	C	8	6	14	0	1	15	0	0
3	57462673	.	G	T	7	5	12	0	0	12	0	0
3	57462751	.	G	C	11	5	16	0	0	16	0	0
3	57463446	.	A	T	9	7	16	0	1	17	0	0
3	57463470	.	C	T	9	6	15	0	0	15	0	0
3	57463817	.	C	G	7	9	16	0	3	19	0	0
3	57463933	.	G	A	10	8	18	0	2	20	0	0
3	57464484	.	G	A	6	4	10	0	0	10	0	0
3	57464706	.	C	A	3	5	8	0	0	8	0	0
3	57464735	.	T	A	5	3	8	0	0	8	0	0
3	57464746	.	C	T	0	4	4	0	2	6	0	0
3	57464793	.	T	A	3	3	6	0	0	6	0	0
3	57464986	.	A	C	5	2	7	0	0	7	0	0
3	57465090	.	G	C	4	10	14	0	1	15	0	0
3	57465176	.	G	C	6	11	17	0	2	19	0	0
3	57465308	.	T	C	6	0	6	0	11	17	0	0
3	57465544	.	A	T	4	4	8	0	0	8	0	0
3	57465550	.	A	G	4	5	9	0	0	9	0	0
3	57465827	.	G	C	6	3	9	0	0	9	0	0
3	57465965	.	G	T	0	1	1	0	0	1	0	0
3	57494405	.	G	A	0	1	1	0	0	1	0	0
3	57583954	.	C	T	11	14	25	0	2	27	0	0
3	57584599	.	A	T	3	9	12	0	2	14	0	0
3	57584606	.	A	G	3	10	13	0	1	14	0	0
3	57584656	.	A	C	4	13	17	0	2	19	0	0
3	57584783	.	T	C	4	0	4	0	8	12	0	0
3	57585015	.	C	T	0	6	6	0	11	17	0	0
3	57585033	.	C	T	6	12	18	0	1	19	0	0
3	57585150	.	C	T	0	5	5	0	4	9	0	0
3	57593524	.	C	T	2	1	3	0	1	4	0	0
3	57593977	.	G	A	5	9	14	0	2	16	0	0
3	57593978	.	G	A	5	10	15	0	1	16	0	0
3	57594016	.	G	A	4	3	7	0	3	11	1	0
3	57599177	.	C	T	1	2	3	0	0	3	0	0
3	57634139	.	G	T	5	6	11	0	0	11	0	0
3	57634380	.	A	G	3	4	7	0	0	7	0	0
3	57634480	.	G	A	0	0	0	0	1	1	0	0
3	57646269	.	A	G	4	7	11	0	0	11	0	0
3	57654123	.	A	G	1	0	1	0	0	1	0	0
3	57742154	.	G	A	1	3	4	0	0	4	0	0
3	57742220	.	G	A	5	4	9	0	0	9	0	0
3	57742262	.	C	G	3	6	9	0	1	10	0	0
3	57747866	.	T	C	4	0	4	0	3	7	0	0
3	57747889	.	C	A	5	3	8	0	0	8	0	0
3	57747977	.	C	T	3	6	9	0	0	9	0	0
3	57748246	.	C	T	6	4	10	0	0	10	0	0
3	57748342	.	T	A	8	7	15	0	0	15	0	0
3	57748437	.	A	G	5	8	13	0	0	13	0	0
3	57748449	.	G	A	5	8	13	0	1	14	0	0
3	57748494	.	T	C	2	6	8	0	0	8	0	0
3	57748581	.	C	G	1	4	5	0	7	12	0	0
3	57751835	.	G	A	3	3	6	0	0	6	0	0
3	58001814	.	G	A	0	2	2	0	1	3	0	0
3	58140344	.	G	A	2	1	3	0	0	3	0	0
3	58148028	.	C	A	3	3	6	0	0	6	0	0
3	58148031	.	G	T	3	3	6	0	0	6	0	0
3	58149114	.	C	A	1	4	5	0	0	5	0	0
3	58153889	.	T	A	3	3	6	0	0	6	0	0
3	58153994	.	A	G	2	0	2	0	5	7	0	0
3	58154073	.	G	A	0	2	2	0	6	8	0	0
3	58158712	.	T	C	4	2	6	0	0	6	0	0
3	58158826	.	T	C	2	3	5	0	0	5	0	0
3	58171761	.	C	T	1	1	2	0	0	2	0	0
3	58174380	.	C	T	0	0	0	0	1	1	0	0
3	58175761	.	G	C	4	4	8	0	1	9	0	0
3	58178032	.	G	A	1	11	12	0	17	29	0	0
3	58180664	.	G	A	5	8	13	0	6	19	0	0
3	58197600	.	A	G	0	0	0	2	0	2	0	0
3	58197611	.	G	A	0	0	0	2	0	2	0	0
3	58220560	.	C	T	0	2	2	0	3	5	0	0
3	58220562	.	C	A	2	3	5	0	0	5	0	0
3	58608335	.	G	A	1	2	3	0	1	4	0	0
3	58611208	.	G	A	0	3	3	0	0	3	0	0
3	58615466	.	C	T	0	2	2	0	1	3	0	0
3	59961399	.	G	A	5	5	10	0	0	10	0	0
3	59986181	.	G	T	2	3	5	0	0	5	0	0
3	59994744	.	G	A	7	3	10	0	0	10	0	0
3	59995019	.	T	G	3	9	12	0	1	13	0	0
3	59995028	.	C	T	3	6	9	0	1	10	0	0
3	59995122	.	G	T	6	0	6	0	2	8	0	0
3	60025587	.	C	T	4	2	6	0	0	6	0	0
3	60055155	.	T	C	1	2	3	0	0	3	0	0
3	60073702	.	G	T	1	3	4	0	0	4	0	0
3	60073756	.	A	G	2	1	3	0	1	4	0	0
3	60074043	.	A	G	0	3	3	0	0	3	0	0
3	60074061	.	C	T	2	2	4	0	1	5	0	0
3	60074316	.	C	T	1	2	3	0	0	3	0	0
3	60074324	.	G	A	1	2	3	0	0	3	0	0
3	60099074	.	C	T	1	3	4	0	0	4	0	0
3	60099361	.	G	A	1	2	3	0	3	6	0	0
3	60294089	.	C	G	1	1	2	0	0	2	0	0
3	60342876	.	T	G	0	4	4	0	0	4	0	0
3	60526385	.	G	C	5	3	8	0	0	8	0	0
3	60526426	.	A	G	3	3	6	1	0	7	0	0
3	60526544	.	C	T	0	2	2	0	1	3	0	0
3	60526545	.	G	T	1	2	3	0	0	3	0	0
3	60526620	.	C	A	3	1	4	0	0	4	0	0
3	60526647	.	A	G	0	1	1	0	0	1	0	0
3	60576005	.	A	T	5	3	8	0	0	8	0	0
3	60576415	.	C	A	4	2	6	0	0	6	0	0
3	60576453	.	G	A	2	4	6	0	0	6	0	0
3	60577258	.	A	T	0	3	3	0	0	3	0	0
3	60577319	.	T	C	0	2	2	0	0	2	0	0
3	60578176	.	T	A	6	3	9	0	1	10	0	0
3	60578201	.	C	T	0	3	3	0	7	10	0	0
3	60578217	.	C	T	5	3	8	0	0	8	0	0
3	60594169	.	A	G	1	3	4	0	0	4	0	0
3	60594197	.	C	G	4	3	7	0	0	7	0	0
3	60594809	.	G	A	0	2	2	0	0	3	1	0
3	60595769	.	T	G	0	4	4	0	0	4	0	0
3	60595980	.	G	T	7	1	8	0	1	9	0	0
3	60595983	.	A	T	8	1	9	0	1	10	0	0
3	60596647	.	A	G	5	3	8	0	1	9	0	0
3	60596808	.	A	C	1	2	3	0	0	3	0	0
3	60601907	.	A	T	1	1	2	0	0	2	0	0
3	60601958	.	G	A	5	1	6	0	0	6	0	0
3	60711017	.	T	C	2	2	4	0	0	4	0	0
3	60732406	.	C	T	1	2	3	0	0	3	0	0
3	60732416	.	G	A	1	3	4	0	0	4	0	0
3	60732617	.	A	G	0	1	1	0	1	2	0	0
3	60732630	.	A	G	1	4	5	0	0	5	0	0
3	60789730	.	C	A	0	4	4	0	1	5	0	0
3	60841113	.	G	A	0	3	3	0	3	6	0	0
3	60841149	.	C	T	1	4	5	0	0	5	0	0
3	60862519	.	G	A	5	3	8	0	1	9	0	0
3	60875169	.	T	G	1	1	2	0	0	2	0	0
3	60978344	.	G	A	1	2	3	0	0	3	0	0
3	60978389	.	T	C	3	3	6	0	1	7	0	0
3	60982492	.	A	C	1	4	5	0	0	5	0	0
3	60984213	.	A	G	0	0	0	0	2	2	0	0
3	60985817	.	T	C	3	1	4	0	0	4	0	0
3	60994718	.	T	C	1	0	1	0	0	1	0	0
3	60994742	.	G	T	0	3	3	0	2	5	0	0
3	60997781	.	C	G	2	2	4	0	0	4	0	0
3	61004295	.	G	A	1	5	6	0	1	7	0	0
3	61004397	.	C	T	5	5	10	0	4	14	0	0
3	61004442	.	G	T	4	2	6	0	1	7	0	0
3	61030699	.	G	C	9	13	22	0	0	22	0	0
3	61030800	.	G	A	6	5	11	0	2	13	0	0
3	61033183	.	C	T	12	22	34	0	9	43	0	0
3	61033697	.	T	C	13	22	35	0	2	37	0	0
3	61033979	.	C	A	8	18	26	0	2	28	0	0
3	61034024	.	T	C	24	32	56	0	2	58	0	0
3	61034096	.	T	C	22	32	54	0	4	58	0	0
3	61279844	.	G	A	0	4	4	0	4	8	0	0
3	61280326	.	G	T	1	7	8	0	0	8	0	0
3	61280350	.	C	G	2	4	6	0	1	7	0	0
3	61280495	.	T	C	7	3	10	0	0	10	0	0
3	61280527	.	G	A	1	3	4	0	5	9	0	0
3	61281592	.	A	G	3	0	3	0	1	4	0	0
3	61285200	.	G	T	14	8	22	0	2	24	0	0
3	61285224	.	T	A	5	10	15	0	0	15	0	0
3	61285260	.	C	T	5	2	7	0	0	7	0	0
3	61285303	.	G	A	5	6	11	0	2	13	0	0
3	61285310	.	G	C	0	6	6	0	7	13	0	0
3	61285437	.	C	T	5	2	7	0	0	7	0	0
3	61285444	.	A	G	5	3	8	0	0	8	0	0
3	61285705	.	C	A	0	2	2	0	0	2	0	0
3	61285706	.	A	T	0	2	2	0	0	2	0	0
3	61285742	.	T	A	5	1	6	0	1	7	0	0
3	61286007	.	T	G	2	2	4	0	2	6	0	0
3	61286062	.	T	A	5	5	10	0	0	10	0	0
3	61286065	.	T	G	5	5	10	0	0	10	0	0
3	61286143	.	C	G	6	13	19	0	0	19	0	0
3	61286362	.	G	C	11	5	16	0	0	16	0	0
3	61286414	.	A	T	8	3	11	0	0	11	0	0
3	61286420	.	T	G	7	3	10	0	0	10	0	0
3	61286468	.	C	T	5	6	11	0	0	11	0	0
3	61286639	.	G	T	7	6	13	0	2	15	0	0
3	61286687	.	T	A	4	4	8	0	0	8	0	0
3	61286878	.	T	C	9	8	17	0	0	17	0	0
3	61287260	.	G	T	6	7	13	0	0	13	0	0
3	61287343	.	G	T	12	8	20	0	0	20	0	0
3	61287383	.	T	A	16	11	27	0	0	27	0	0
3	61287395	.	G	A	12	9	21	0	1	22	0	0
3	61287491	.	T	A	10	15	25	0	0	25	0	0
3	61287496	.	T	C	11	14	25	0	1	26	0	0
3	61287590	.	G	T	8	18	26	0	1	27	0	0
3	61288097	.	G	T	13	9	22	0	3	25	0	0
3	61308994	.	C	A	1	1	2	0	1	3	0	0
3	61317185	.	C	T	2	2	4	0	0	4	0	0
3	61317188	.	C	G	0	2	2	0	2	4	0	0
3	61326373	.	G	A	0	2	2	0	0	2	0	0
3	61342341	.	G	T	4	1	5	0	1	6	0	0
3	61342368	.	T	C	5	5	10	0	0	10	0	0
3	61342387	.	G	A	4	6	10	0	0	10	0	0
3	61342408	.	G	A	11	3	14	0	0	14	0	0
3	61342423	.	G	C	2	8	10	0	1	11	0	0
3	61342708	.	T	A	5	5	10	0	0	10	0	0
3	61342747	.	C	T	0	6	6	0	6	12	0	0
3	61342891	.	A	G	3	5	8	0	0	8	0	0
3	61343224	.	C	T	2	7	9	0	0	9	0	0
3	61349477	.	C	T	1	3	4	0	3	7	0	0
3	61349489	.	A	T	3	2	5	0	0	5	0	0
3	61349556	.	C	G	4	3	7	0	0	7	0	0
3	61349734	.	G	A	3	4	7	0	3	10	0	0
3	61350120	.	C	T	2	3	5	0	0	5	0	0
3	61350529	.	T	A	1	2	3	0	1	4	0	0
3	61350600	.	T	C	2	2	4	0	0	4	0	0
3	61350648	.	G	A	2	3	5	0	0	5	0	0
3	61350667	.	C	T	3	2	5	0	0	5	0	0
3	61350700	.	C	T	1	2	3	0	0	3	0	0
3	61350787	.	A	T	1	4	5	0	0	5	0	0
3	61350788	.	T	G	1	3	4	0	1	5	0	0
3	61351387	.	C	T	0	2	2	0	0	2	0	0
3	61351967	.	T	C	2	3	5	0	0	5	0	0
3	61352058	.	C	T	0	1	1	0	0	1	0	0
3	61358195	.	T	C	4	3	7	0	0	7	0	0
3	61358196	.	T	C	4	3	7	0	0	7	0	0
3	61358265	.	C	T	3	3	6	0	0	6	0	0
3	61358269	.	G	A	4	3	7	0	0	7	0	0
3	61365083	.	C	T	1	2	3	0	0	3	0	0
3	61365135	.	G	A	0	2	2	0	1	3	0	0
3	61372060	.	T	G	4	5	9	0	1	10	0	0
3	61383550	.	T	G	3	2	5	0	0	5	0	0
3	61391687	.	T	C	1	5	6	0	0	6	0	0
3	61391797	.	G	A	0	2	2	0	4	6	0	0
3	61391953	.	C	A	4	5	9	0	1	10	0	0
3	61395211	.	G	A	0	2	2	0	1	3	0	0
3	61396523	.	C	T	2	1	3	0	0	3	0	0
3	61397037	.	T	A	6	3	9	0	1	10	0	0
3	61397141	.	G	T	5	3	8	0	1	9	0	0
3	61397294	.	C	T	4	9	13	0	0	13	0	0
3	61397744	.	T	A	1	2	3	0	0	3	0	0
3	61398251	.	A	G	5	2	7	0	0	7	0	0
3	61398610	.	T	A	9	11	20	0	1	21	0	0
4	308804	.	T	A	1	2	3	0	0	3	0	0
4	313108	.	A	C	15	17	32	0	4	36	0	0
4	317091	.	A	G	10	18	28	0	2	30	0	0
4	317275	.	G	T	6	8	14	0	3	17	0	0
4	325073	.	C	T	2	3	5	0	1	6	0	0
4	325126	.	G	A	5	8	13	0	0	14	1	0
4	325136	.	G	A	7	10	17	0	2	19	0	0
4	325161	.	A	C	14	0	14	0	11	25	0	0
4	352031	.	C	G	2	2	4	0	0	4	0	0
4	352289	.	T	C	0	3	3	0	0	3	0	0
4	352504	.	T	C	3	5	8	0	0	8	0	0
4	353049	.	A	T	2	3	5	0	0	5	0	0
4	353064	.	C	G	2	3	5	0	0	5	0	0
4	353238	.	T	G	7	0	7	0	5	12	0	0
4	353247	.	T	C	5	4	9	0	3	12	0	0
4	353379	.	A	T	8	6	14	0	1	15	0	0
4	353638	.	C	T	1	2	3	0	0	3	0	0
4	362282	.	C	T	1	4	5	0	0	5	0	0
4	385092	.	C	T	14	9	23	0	7	30	0	0
4	385625	.	A	T	2	4	6	0	0	6	0	0
4	385668	.	G	A	7	7	14	0	1	15	0	0
4	385710	.	T	C	13	10	23	0	1	24	0	0
4	386014	.	A	C	22	4	26	0	4	30	0	0
4	386037	.	T	G	24	6	30	0	3	33	0	0
4	386085	.	G	A	14	11	25	0	0	25	0	0
4	386124	.	C	A	3	5	8	0	8	16	0	0
4	386537	.	T	A	22	18	40	0	2	42	0	0
4	386538	.	T	A	28	17	45	0	0	45	0	0
4	386717	.	G	C	28	0	28	0	4	32	0	0
4	394020	.	T	C	10	23	33	0	4	37	0	0
4	397913	.	A	G	5	5	10	0	0	10	0	0
4	647752	.	G	T	0	0	0	0	1	1	0	0
4	659276	.	C	T	6	5	11	0	1	12	0	0
4	659345	.	T	C	1	1	2	0	0	2	0	0
4	660571	.	G	A	1	2	3	0	0	3	0	0
4	660649	.	T	A	1	8	9	0	1	10	0	0
4	660655	.	G	A	0	7	7	0	2	9	0	0
4	660715	.	T	C	2	2	4	0	0	4	0	0
4	667358	.	T	C	4	5	9	0	0	9	0	0
4	667382	.	A	G	4	0	4	0	7	11	0	0
4	674838	.	T	C	9	7	16	0	0	16	0	0
4	675080	.	T	C	4	5	9	0	2	11	0	0
4	676885	.	A	G	10	7	17	0	0	17	0	0
4	676942	.	A	G	2	2	4	0	0	4	0	0
4	678853	.	C	T	8	7	15	0	1	16	0	0
4	679441	.	C	G	0	9	9	0	11	20	0	0
4	680314	.	G	T	6	3	9	0	1	10	0	0
4	680320	.	C	T	6	3	9	0	0	9	0	0
4	680359	.	C	T	3	3	6	0	0	6	0	0
4	680395	.	T	C	1	0	1	0	2	3	0	0
4	680404	.	G	A	0	1	1	0	1	2	0	0
4	694299	.	T	C	3	3	6	0	0	6	0	0
4	694300	.	G	A	3	3	6	0	0	6	0	0
4	694373	.	C	T	2	2	4	0	0	4	0	0
4	694680	.	A	C	2	2	4	0	0	4	0	0
4	694718	.	G	A	1	1	2	0	0	2	0	0
4	694741	.	T	G	1	0	1	0	0	1	0	0
4	694757	.	A	T	1	0	1	0	0	1	0	0
4	695219	.	T	C	0	5	5	0	0	5	0	0
4	700281	.	A	C	7	14	21	0	4	25	0	0
4	700284	.	G	T	0	16	16	0	10	26	0	0
4	700563	.	G	T	6	3	9	0	0	9	0	0
4	700569	.	G	A	0	2	2	0	5	7	0	0
4	700598	.	A	T	4	2	6	0	0	6	0	0
4	700606	.	T	C	4	2	6	0	0	6	0	0
4	700634	.	A	C	2	2	4	0	0	4	0	0
4	700665	.	G	T	0	2	2	0	0	2	0	0
4	702061	.	C	G	2	6	8	0	4	12	0	0
4	702130	.	G	A	0	1	1	0	1	2	0	0
4	702138	.	C	A	1	0	1	0	0	1	0	0
4	736442	.	A	G	8	5	13	0	0	13	0	0
4	737636	.	A	T	10	4	14	0	0	14	0	0
4	737927	.	T	G	1	0	1	0	1	2	0	0
4	740435	.	A	T	2	2	4	0	0	4	0	0
4	740921	.	T	C	5	3	8	0	0	8	0	0
4	740965	.	T	G	5	1	6	0	0	6	0	0
4	749803	.	G	A	11	5	16	0	0	16	0	0
4	749989	.	G	T	4	3	7	0	2	9	0	0
4	750526	.	C	G	2	2	4	0	0	4	0	0
4	750531	.	C	T	4	2	6	0	0	6	0	0
4	750661	.	C	T	0	2	2	0	2	4	0	0
4	751275	.	A	G	1	1	2	0	0	2	0	0
4	751546	.	G	A	4	4	8	0	0	8	0	0
4	751553	.	C	T	4	3	7	0	1	8	0	0
4	751640	.	T	G	5	4	9	0	1	10	0	0
4	765112	.	A	G	8	6	14	0	1	15	0	0
4	766575	.	G	A	4	8	12	0	0	12	0	0
4	766588	.	G	A	5	9	14	0	1	15	0	0
4	766613	.	A	C	6	6	12	0	1	13	0	0
4	769533	.	A	T	1	1	2	0	0	2	0	0
4	772363	.	C	T	0	3	3	0	1	4	0	0
4	778111	.	G	A	1	2	3	0	0	3	0	0
4	779310	.	G	A	1	2	3	0	0	3	0	0
4	779363	.	T	C	1	0	1	0	6	7	0	0
4	779429	.	A	G	3	3	6	0	0	6	0	0
4	779442	.	G	A	3	3	6	0	0	6	0	0
4	783816	.	G	T	18	29	47	0	1	48	0	0
4	783835	.	A	G	22	21	43	0	2	45	0	0
4	784002	.	T	A	24	16	40	0	4	44	0	0
4	784177	.	T	C	25	16	41	0	7	48	0	0
4	784325	.	A	T	14	11	25	0	1	26	0	0
4	784373	.	T	A	6	4	10	0	1	11	0	0
4	784472	.	T	C	4	2	6	0	1	7	0	0
4	784473	.	A	C	5	2	7	0	0	7	0	0
4	784543	.	A	C	2	3	5	0	0	5	0	0
4	784558	.	G	A	3	3	6	0	0	6	0	0
4	784733	.	T	A	8	4	12	0	0	12	0	0
4	784854	.	C	A	5	3	8	0	0	8	0	0
4	784990	.	T	A	13	15	28	0	3	31	0	0
4	785011	.	T	C	10	10	20	0	8	28	0	0
4	785132	.	G	A	22	18	40	0	0	40	0	0
4	789589	.	A	G	9	6	15	0	1	16	0	0
4	798743	.	G	C	4	7	11	0	1	12	0	0
4	798804	.	G	A	12	17	29	0	2	31	0	0
4	798850	.	A	C	13	15	28	0	3	31	0	0
4	798861	.	G	T	12	16	28	0	2	30	0	0
4	799006	.	G	T	17	12	29	0	3	32	0	0
4	799090	.	T	C	18	15	33	0	2	35	0	0
4	799127	.	T	G	20	14	34	0	1	35	0	0
4	799245	.	G	A	14	15	29	0	0	29	0	0
4	799385	.	C	G	7	3	10	0	0	10	0	0
4	799475	.	A	G	7	16	23	0	1	24	0	0
4	799513	.	G	A	11	17	28	0	2	30	0	0
4	799620	.	C	T	22	12	34	0	2	36	0	0
4	799643	.	T	A	20	13	33	0	6	39	0	0
4	799933	.	C	T	21	23	44	0	2	46	0	0
4	800027	.	C	T	15	9	24	0	1	25	0	0
4	800094	.	A	G	13	13	26	0	2	28	0	0
4	800113	.	A	G	18	12	30	0	1	31	0	0
4	800363	.	C	T	0	15	15	0	19	34	0	0
4	800520	.	T	C	9	8	17	0	0	17	0	0
4	802909	.	T	A	5	18	23	0	0	23	0	0
4	806319	.	G	A	4	3	7	0	2	9	0	0
4	806322	.	T	C	4	4	8	0	1	9	0	0
4	807895	.	C	G	2	2	4	0	1	5	0	0
4	807898	.	A	G	0	4	4	0	1	5	0	0
4	808031	.	C	T	2	0	2	0	0	2	0	0
4	809456	.	A	G	5	6	11	0	1	12	0	0
4	809549	.	A	G	2	5	7	0	0	7	0	0
4	813226	.	A	G	4	4	8	0	0	8	0	0
4	861474	.	G	A	1	2	3	0	0	3	0	0
4	861681	.	G	A	1	2	3	0	0	3	0	0
4	861856	.	T	A	3	2	5	0	0	5	0	0
4	862009	.	A	G	2	5	7	0	0	7	0	0
4	864324	.	T	A	1	0	1	0	0	1	0	0
4	864712	.	C	T	6	4	10	0	1	11	0	0
4	864739	.	G	C	5	4	9	0	0	9	0	0
4	867601	.	G	C	1	4	5	0	0	5	0	0
4	870833	.	C	T	0	4	4	0	4	8	0	0
4	870876	.	C	T	1	2	3	0	0	3	0	0
4	873763	.	C	G	5	5	10	0	0	10	0	0
4	874241	.	G	T	4	1	5	0	0	5	0	0
4	880365	.	G	A	2	3	5	0	0	5	0	0
4	881784	.	G	A	1	2	3	0	0	3	0	0
4	882207	.	G	T	2	3	5	0	0	5	0	0
4	905713	.	C	G	1	2	3	0	0	3	0	0
4	958978	.	A	T	9	10	19	0	0	19	0	0
4	959015	.	T	C	5	4	9	0	0	9	0	0
4	961542	.	G	A	3	2	5	0	0	5	0	0
4	967974	.	C	T	1	3	4	0	0	4	0	0
4	968001	.	G	A	0	3	3	0	1	4	0	0
4	968121	.	T	C	1	0	1	0	0	1	0	0
4	969486	.	T	G	1	0	1	0	0	1	0	0
4	971765	.	A	G	2	4	6	0	0	6	0	0
4	974482	.	C	T	6	3	9	0	2	12	1	0
4	975735	.	G	C	0	0	0	0	1	1	0	0
4	975758	.	C	T	4	3	7	0	0	7	0	0
4	975792	.	G	C	0	5	5	0	7	12	0	0
4	982892	.	G	A	2	4	6	0	0	6	0	0
4	982893	.	T	C	4	2	6	0	0	6	0	0
4	982938	.	C	G	3	2	5	0	1	6	0	0
4	982958	.	A	G	3	3	6	0	0	6	0	0
4	986210	.	T	C	3	3	6	0	0	6	0	0
4	1054775	.	G	A	9	23	32	0	4	36	0	0
4	1055081	.	C	T	25	7	32	0	1	33	0	0
4	1055095	.	T	A	19	7	26	0	3	29	0	0
4	1055149	.	A	G	8	3	11	0	0	11	0	0
4	1055200	.	A	G	12	4	16	0	0	16	0	0
4	1055454	.	T	G	21	24	45	0	10	55	0	0
4	1055526	.	T	C	14	23	37	0	2	39	0	0
4	1055671	.	G	A	21	15	36	0	2	38	0	0
4	1055724	.	C	T	21	12	33	0	3	36	0	0
4	1055770	.	A	G	23	12	35	0	1	36	0	0
4	1055807	.	G	C	13	15	28	0	4	32	0	0
4	1055831	.	T	A	12	12	24	0	2	26	0	0
4	1055863	.	A	T	11	12	23	0	1	24	0	0
4	1055868	.	G	A	14	10	24	0	1	25	0	0
4	1389028	.	A	G	0	4	4	0	0	4	0	0
4	1392957	.	G	A	5	4	9	0	0	9	0	0
4	1393004	.	T	A	3	5	8	0	0	8	0	0
4	1633092	.	A	G	0	0	0	0	9	9	0	0
4	1652192	.	C	T	0	2	2	0	3	5	0	0
4	1733945	.	T	C	2	3	5	0	0	5	0	0
4	1988778	.	T	A	2	2	4	0	0	4	0	0
4	2044359	.	A	C	19	14	33	0	5	38	0	0
4	2044379	.	T	A	22	18	40	0	5	45	0	0
4	2044409	.	A	G	20	25	45	0	0	45	0	0
4	2044432	.	G	T	20	15	35	0	4	39	0	0
4	2044541	.	T	C	12	0	12	0	26	38	0	0
4	2044721	.	A	C	1	3	4	0	0	4	0	0
4	2045000	.	T	A	5	2	7	0	0	7	0	0
4	2051929	.	T	G	15	14	29	0	4	33	0	0
4	2055019	.	G	A	13	11	24	0	2	26	0	0
4	2055103	.	G	T	1	3	4	0	1	5	0	0
4	2055265	.	G	A	7	8	15	0	1	16	0	0
4	2056028	.	G	A	9	12	21	0	0	21	0	0
4	2056055	.	A	C	8	0	8	0	13	21	0	0
4	2056607	.	G	A	9	7	16	0	1	17	0	0
4	2061217	.	G	A	6	4	10	0	0	10	0	0
4	2062088	.	G	A	8	7	15	0	0	15	0	0
4	2062133	.	G	A	15	11	26	0	1	27	0	0
4	2151664	.	T	A	7	4	11	0	0	11	0	0
4	2162639	.	G	A	2	0	2	0	0	2	0	0
4	2162664	.	T	G	2	1	3	0	0	3	0	0
4	2163521	.	A	G	1	3	4	0	0	4	0	0
4	2210437	.	T	G	11	5	16	0	3	19	0	0
4	2210459	.	C	T	9	5	14	0	1	15	0	0
4	2210499	.	T	C	7	0	7	0	6	13	0	0
4	2210517	.	C	T	6	7	13	0	0	13	0	0
4	2210553	.	A	G	6	6	12	0	0	12	0	0
4	2210583	.	A	G	2	2	4	0	0	4	0	0
4	2259067	.	G	A	3	4	7	0	0	7	0	0
4	2259071	.	T	C	4	0	4	0	4	8	0	0
4	2259851	.	G	T	1	2	3	0	0	3	0	0
4	2361733	.	G	A	4	2	6	0	1	7	0	0
4	2362945	.	C	A	0	8	8	0	14	22	0	0
4	2368016	.	A	G	8	4	12	0	0	12	0	0
4	2497044	.	T	C	2	2	4	0	1	5	0	0
4	2506611	.	C	T	0	1	1	0	0	1	0	0
4	2508427	.	A	C	7	5	12	0	0	12	0	0
4	2511830	.	C	T	14	17	31	2	2	35	0	0
4	2511921	.	T	C	12	12	24	0	4	28	0	0
4	2511991	.	A	T	11	12	23	0	2	25	0	0
4	2516385	.	G	A	0	2	2	0	0	2	0	0
4	2548943	.	T	A	3	2	5	0	3	8	0	0
4	2550932	.	T	C	2	3	5	0	0	5	0	0
4	2550934	.	C	T	0	3	3	0	2	5	0	0
4	2556508	.	C	T	5	3	8	0	0	8	0	0
4	2571695	.	T	A	1	2	3	0	0	3	0	0
4	2571701	.	A	G	1	1	2	0	0	2	0	0
4	2620973	.	C	A	5	7	12	0	0	12	0	0
4	2621086	.	G	A	7	6	13	0	0	13	0	0
4	2621761	.	T	C	6	2	8	0	3	11	0	0
4	2622344	.	G	C	9	14	23	0	0	24	1	0
4	2622496	.	T	C	10	8	18	0	2	20	0	0
4	2622529	.	C	A	12	11	23	0	3	26	0	0
4	2642254	.	T	A	4	6	10	0	1	11	0	0
4	2666085	.	G	C	3	2	5	0	0	5	0	0
4	2666219	.	T	C	1	3	4	0	0	4	0	0
4	2675235	.	C	T	5	6	11	0	3	14	0	0
4	2688740	.	T	C	2	2	4	0	0	4	0	0
4	2688785	.	T	G	1	1	2	0	0	2	0	0
4	2752987	.	C	T	0	3	3	0	0	3	0	0
4	2753455	.	C	T	0	2	2	0	1	3	0	0
4	2866748	.	T	C	2	1	3	0	0	3	0	0
4	2867111	.	C	A	1	4	5	0	0	5	0	0
4	3338195	.	A	G	2	5	7	0	0	7	0	0
4	3474744	.	A	G	1	6	7	0	0	7	0	0
4	3980436	.	C	T	4	2	6	0	0	6	0	0
4	4225967	.	A	G	0	1	1	0	0	1	0	0
4	4225969	.	A	T	0	1	1	0	0	1	0	0
4	4228648	.	G	A	1	0	1	0	0	1	0	0
4	4228654	.	G	A	1	0	1	0	0	1	0	0
4	5339126	.	T	A	4	10	14	0	1	15	0	0
4	5765181	.	C	T	1	2	3	0	1	4	0	0
4	8027183	.	A	T	0	4	4	0	0	4	0	0
4	8045781	.	A	G	6	10	16	0	5	21	0	0
4	9465364	.	A	T	1	0	1	0	0	1	0	0
4	9603488	.	T	C	6	2	8	0	0	8	0	0
4	9618867	.	A	C	3	5	8	0	0	8	0	0
4	9624781	.	C	A	2	1	3	0	0	3	0	0
4	9855482	.	G	A	0	3	3	0	0	3	0	0
4	9999865	.	T	G	3	1	4	0	1	5	0	0
4	10044556	.	G	A	4	1	5	0	0	5	0	0
4	10044605	.	C	T	10	8	18	0	2	20	0	0
4	10044777	.	A	G	7	7	14	0	0	14	0	0
4	10045599	.	C	T	0	2	2	0	0	2	0	0
4	10045605	.	A	G	0	2	2	0	0	2	0	0
4	10121668	.	A	G	1	2	3	0	0	3	0	0
4	10121671	.	C	T	1	2	3	0	0	3	0	0
4	10128809	.	C	T	1	2	3	0	0	3	0	0
4	10130199	.	G	A	1	1	2	0	1	3	0	0
4	10130239	.	C	A	2	3	5	0	0	5	0	0
4	10366884	.	G	A	1	2	3	0	0	3	0	0
4	10367562	.	C	T	2	2	4	0	0	4	0	0
4	10553452	.	C	T	5	4	9	0	0	9	0	0
4	10553515	.	C	A	2	2	4	0	0	4	0	0
4	10558403	.	G	A	0	4	4	0	5	9	0	0
4	10559042	.	A	T	6	3	9	0	0	9	0	0
4	10559621	.	C	A	4	6	10	0	1	11	0	0
4	10560246	.	G	A	9	12	21	0	2	23	0	0
4	10560253	.	A	T	9	16	25	0	0	25	0	0
4	10560284	.	C	T	7	18	25	0	4	29	0	0
4	10560437	.	A	C	8	13	21	0	4	25	0	0
4	10560507	.	C	T	8	13	21	0	2	23	0	0
4	10560607	.	A	G	6	7	13	0	0	13	0	0
4	10560916	.	C	T	8	8	16	0	3	19	0	0
4	10561101	.	T	A	11	34	45	0	1	46	0	0
4	10614856	.	T	C	9	8	17	0	2	19	0	0
4	10614862	.	T	C	10	7	17	0	1	18	0	0
4	10762071	.	G	A	2	3	5	0	0	5	0	0
4	10762087	.	G	A	0	3	3	0	3	6	0	0
4	10783836	.	C	T	0	1	1	0	0	1	0	0
4	10825629	.	G	A	0	1	1	0	0	1	0	0
4	10890822	.	G	A	2	1	3	0	1	4	0	0
4	10896354	.	G	C	1	2	3	0	1	4	0	0
4	10896618	.	C	T	2	3	5	0	0	5	0	0
4	10896620	.	A	T	2	3	5	0	0	5	0	0
4	10904784	.	C	T	1	0	1	0	0	1	0	0
4	10905246	.	C	T	3	1	4	0	0	4	0	0
4	10906235	.	C	T	3	2	5	0	0	5	0	0
4	10908001	.	C	T	15	13	28	0	2	30	0	0
4	10908182	.	T	C	9	6	15	0	0	15	0	0
4	10908294	.	C	T	11	6	17	0	1	18	0	0
4	10908726	.	T	C	6	5	11	0	0	11	0	0
4	10974650	.	C	T	2	5	7	0	1	8	0	0
4	10974722	.	G	A	4	4	8	0	1	9	0	0
4	10974747	.	A	T	6	3	9	0	0	9	0	0
4	10976944	.	G	A	2	1	3	0	0	3	0	0
4	10982291	.	C	T	0	1	1	0	0	1	0	0
4	10982339	.	T	G	0	2	2	0	1	3	0	0
4	11054484	.	A	C	7	4	11	0	1	12	0	0
4	11054509	.	G	C	4	5	9	0	2	11	0	0
4	11366316	.	G	A	0	2	2	0	2	4	0	0
4	11366360	.	T	C	5	3	8	0	0	8	0	0
4	11366481	.	G	A	6	6	12	0	1	13	0	0
4	11366848	.	A	G	11	7	18	0	0	18	0	0
4	11366868	.	T	A	10	6	16	0	0	16	0	0
4	11366984	.	T	A	8	10	18	1	0	19	0	0
4	11367668	.	T	A	6	9	15	0	1	16	0	0
4	11367884	.	C	T	6	15	21	0	0	21	0	0
4	11367896	.	A	G	4	13	17	0	2	19	0	0
4	11368076	.	G	T	15	19	34	0	4	38	0	0
4	11368143	.	C	T	13	20	33	0	1	34	0	0
4	11368171	.	G	A	0	14	14	0	24	38	0	0
4	11368432	.	A	T	1	3	4	0	1	5	0	0
4	11414799	.	T	C	3	4	7	0	0	7	0	0
4	11414824	.	A	T	2	2	4	0	0	4	0	0
4	11420136	.	C	T	2	2	4	0	0	4	0	0
4	11422664	.	T	C	9	4	13	0	1	14	0	0
4	11427820	.	A	C	4	4	8	0	0	8	0	0
4	11431768	.	A	C	1	0	1	0	0	1	0	0
4	11439544	.	C	A	2	5	7	0	2	9	0	0
4	11441789	.	T	A	4	2	6	0	1	7	0	0
4	11442085	.	C	T	1	0	1	0	0	1	0	0
4	11444080	.	C	T	1	0	1	0	0	1	0	0
4	11444209	.	C	A	7	3	10	0	0	10	0	0
4	11445978	.	T	C	11	13	24	0	1	25	0	0
4	11446365	.	A	T	20	13	33	0	3	36	0	0
4	11446878	.	A	G	7	4	11	0	1	12	0	0
4	11447037	.	T	G	10	9	19	0	4	23	0	0
4	11447144	.	G	A	15	12	27	0	1	28	0	0
4	11447226	.	T	G	8	0	8	0	14	22	0	0
4	11447251	.	T	C	12	12	24	0	0	24	0	0
4	11447599	.	C	T	17	18	35	0	0	35	0	0
4	11447632	.	C	G	18	22	40	0	0	41	1	0
4	11448403	.	G	A	0	20	20	0	28	48	0	0
4	11448680	.	A	G	20	21	41	0	2	43	0	0
4	11461181	.	C	G	1	2	3	0	1	4	0	0
4	11461865	.	T	A	6	5	11	0	0	11	0	0
4	11461914	.	A	G	4	3	7	0	0	7	0	0
4	11462054	.	A	T	1	1	2	0	0	2	0	0
4	11470854	.	A	G	1	0	1	0	0	1	0	0
4	11470920	.	C	T	4	2	6	0	0	6	0	0
4	11471203	.	T	C	7	5	12	0	0	12	0	0
4	11472674	.	T	C	8	8	16	0	0	16	0	0
4	11476406	.	T	C	5	8	13	0	0	13	0	0
4	11476472	.	G	A	0	23	23	0	29	52	0	0
4	11476487	.	C	T	23	24	47	0	7	54	0	0
4	11476740	.	C	T	30	26	56	0	6	62	0	0
4	11477566	.	G	A	12	29	41	0	3	44	0	0
4	11480866	.	C	T	3	0	3	0	0	3	0	0
4	11482235	.	G	A	1	4	5	0	7	12	0	0
4	11482259	.	G	A	8	4	12	0	0	12	0	0
4	11482358	.	T	G	2	0	2	0	1	3	0	0
4	11482367	.	C	G	1	0	1	0	0	1	0	0
4	11487176	.	C	T	1	0	1	0	0	1	0	0
4	11573696	.	T	A	3	2	5	0	1	6	0	0
4	11709544	.	C	T	1	0	1	0	0	1	0	0
4	11712653	.	C	T	2	1	3	0	1	4	0	0
4	11712704	.	G	T	0	1	1	0	3	4	0	0
4	11712722	.	T	A	3	2	5	0	0	5	0	0
4	11712794	.	T	C	1	0	1	0	0	1	0	0
4	11721659	.	T	C	0	1	1	0	0	1	0	0
4	11721770	.	T	C	0	1	1	0	0	1	0	0
4	11726366	.	T	A	0	1	1	0	1	2	0	0
4	11728959	.	G	A	0	2	2	0	3	5	0	0
4	11729471	.	A	T	2	6	8	0	0	8	0	0
4	11729719	.	G	A	5	6	11	0	5	16	0	0
4	11729792	.	G	A	13	6	19	0	1	20	0	0
4	11730033	.	G	A	0	11	11	0	5	16	0	0
4	11730088	.	A	T	2	7	9	0	0	9	0	0
4	11730317	.	T	G	2	11	13	0	0	13	0	0
4	11730515	.	C	A	7	9	16	0	2	18	0	0
4	11732213	.	G	A	3	3	6	0	0	6	0	0
4	11732222	.	G	A	5	4	9	0	0	9	0	0
4	11732956	.	A	G	3	4	7	0	0	7	0	0
4	11732975	.	G	A	3	3	6	0	0	6	0	0
4	11780598	.	C	A	4	3	7	0	0	7	0	0
4	11804769	.	T	A	3	3	6	0	0	6	0	0
4	11804932	.	G	A	8	4	12	0	2	14	0	0
4	11805095	.	G	T	7	5	12	0	0	12	0	0
4	11805149	.	C	A	8	3	11	0	0	11	0	0
4	11805396	.	G	T	1	3	4	0	0	4	0	0
4	11805557	.	G	A	3	7	10	0	1	11	0	0
4	11806934	.	G	A	3	6	9	0	0	9	0	0
4	11806965	.	G	C	3	4	7	0	0	7	0	0
4	11814055	.	C	T	0	34	34	0	17	51	0	0
4	11814074	.	T	A	24	32	56	0	0	56	0	0
4	11814264	.	A	C	12	7	19	0	0	19	0	0
4	11814407	.	G	A	8	12	20	0	2	22	0	0
4	11814429	.	A	T	9	8	17	0	2	19	0	0
4	11814471	.	G	A	9	8	17	0	1	18	0	0
4	11814494	.	C	T	9	11	20	0	2	22	0	0
4	11814641	.	T	A	7	12	19	0	1	20	0	0
4	11814723	.	A	C	12	15	27	0	1	28	0	0
4	11814997	.	G	A	15	12	27	0	1	28	0	0
4	11815137	.	G	T	12	14	26	0	1	27	0	0
4	11815143	.	C	G	13	14	27	0	1	28	0	0
4	11815324	.	A	C	10	12	22	0	2	24	0	0
4	11815413	.	A	G	10	11	21	0	1	22	0	0
4	11815417	.	T	A	8	9	17	0	4	21	0	0
4	11815470	.	T	G	5	1	6	0	0	6	0	0
4	11815481	.	G	T	3	3	6	0	1	8	1	0
4	11815772	.	C	A	6	5	11	0	1	12	0	0
4	11816346	.	C	A	4	7	11	0	2	13	0	0
4	11816347	.	C	A	0	7	7	0	6	13	0	0
4	11816420	.	G	A	2	8	10	0	0	10	0	0
4	11816687	.	C	T	4	6	10	0	0	10	0	0
4	11818347	.	G	A	0	1	1	0	0	1	0	0
4	11827171	.	C	T	2	1	3	0	0	3	0	0
4	12013583	.	T	A	2	4	6	0	0	6	0	0
4	12021748	.	G	T	0	10	10	0	10	20	0	0
4	12021754	.	C	T	12	9	21	0	1	22	0	0
4	12023382	.	C	T	2	1	3	0	0	3	0	0
4	12025771	.	G	A	1	18	19	0	0	19	0	0
4	12026098	.	G	A	3	5	8	0	3	11	0	0
4	12026305	.	T	C	14	12	26	0	4	30	0	0
4	12026363	.	G	A	18	10	28	0	2	30	0	0
4	12026369	.	G	T	11	18	29	0	0	29	0	0
4	12026429	.	C	A	9	13	22	0	0	22	0	0
4	12026488	.	T	C	2	4	6	0	1	7	0	0
4	12026500	.	C	T	2	2	4	0	1	5	0	0
4	12075100	.	G	A	7	8	15	0	0	15	0	0
4	12076395	.	T	C	6	7	13	0	1	14	0	0
4	12086701	.	C	T	0	3	3	0	2	5	0	0
4	12089269	.	C	T	0	0	0	0	1	1	0	0
4	12091104	.	G	T	1	2	3	0	0	3	0	0
4	12101955	.	G	A	4	4	8	0	0	8	0	0
4	12103602	.	G	A	2	4	6	0	1	7	0	0
4	12103675	.	G	T	11	5	16	0	1	17	0	0
4	12103911	.	A	T	3	5	8	0	0	8	0	0
4	12104100	.	T	C	1	0	1	0	1	2	0	0
4	12230608	.	T	C	0	5	5	0	0	5	0	0
4	12230665	.	C	T	2	4	6	0	0	6	0	0
4	12230713	.	T	C	1	4	5	0	0	5	0	0
4	12231101	.	A	G	1	0	1	0	2	3	0	0
4	12231789	.	C	A	1	2	3	1	0	4	0	0
4	12232253	.	G	T	4	8	12	0	1	13	0	0
4	12232328	.	A	T	8	4	12	0	0	12	0	0
4	12232463	.	T	C	2	3	5	0	0	5	0	0
4	12232614	.	A	C	5	2	7	0	0	7	0	0
4	12232742	.	A	G	1	0	1	0	5	6	0	0
4	12232985	.	G	T	5	2	7	0	0	7	0	0
4	12233420	.	G	C	1	2	3	0	0	3	0	0
4	12233450	.	C	A	2	2	4	0	0	4	0	0
4	12234284	.	T	A	2	2	4	0	0	4	0	0
4	12234670	.	A	G	4	0	4	0	4	8	0	0
4	12234755	.	C	A	2	7	9	0	2	11	0	0
4	12234792	.	A	G	10	6	16	0	2	18	0	0
4	12234828	.	C	T	7	8	15	0	0	15	0	0
4	12235123	.	G	A	5	8	13	0	3	16	0	0
4	12235414	.	A	C	3	4	7	0	1	8	0	0
4	12235416	.	A	C	3	3	6	0	2	8	0	0
4	12235838	.	T	A	6	6	12	0	0	12	0	0
4	12236178	.	T	G	10	9	19	4	0	23	0	0
4	12236427	.	T	C	7	4	11	0	1	12	0	0
4	12236429	.	T	A	7	2	9	0	1	12	2	0
4	12236471	.	G	T	8	5	13	0	0	13	0	0
4	12236519	.	A	G	8	7	15	0	0	15	0	0
4	12236584	.	C	T	4	2	6	0	0	6	0	0
4	12236592	.	T	A	5	1	6	0	0	7	1	0
4	12236641	.	A	G	4	9	13	0	2	15	0	0
4	12237689	.	C	A	11	16	27	0	0	27	0	0
4	12237849	.	C	T	14	15	29	0	0	29	0	0
4	12238064	.	G	T	18	7	25	0	3	29	1	0
4	12238065	.	C	A	17	8	25	0	4	29	0	0
4	12238161	.	C	T	15	15	30	0	3	33	0	0
4	12238904	.	G	A	3	14	17	0	0	17	0	0
4	12243754	.	T	G	4	3	7	0	0	7	0	0
4	12243779	.	T	C	3	4	7	0	2	9	0	0
4	12243881	.	T	G	11	7	18	0	3	21	0	0
4	12243930	.	T	C	10	1	11	0	0	11	0	0
4	12244071	.	T	C	17	8	25	0	0	25	0	0
4	12244086	.	T	G	13	14	27	0	2	30	1	0
4	12244373	.	G	A	11	13	24	0	2	26	0	0
4	12244607	.	C	T	0	3	3	0	10	13	0	0
4	12245324	.	T	A	3	2	5	0	0	5	0	0
4	12245470	.	G	A	5	6	11	0	3	14	0	0
4	12245555	.	T	G	3	0	3	0	13	16	0	0
4	12245584	.	A	G	8	14	22	0	0	22	0	0
4	12265133	.	A	G	5	4	9	0	4	13	0	0
4	12285925	.	T	C	0	1	1	0	0	1	0	0
4	12298513	.	A	T	12	8	20	0	0	20	0	0
4	12304561	.	C	T	7	14	21	0	0	21	0	0
4	12306880	.	G	A	10	16	26	0	0	26	0	0
4	12311632	.	G	A	1	3	4	0	0	4	0	0
4	12317645	.	C	G	5	5	10	0	2	12	0	0
4	12317674	.	A	T	4	7	11	0	0	11	0	0
4	12382234	.	C	T	6	3	9	0	1	10	0	0
4	12382433	.	G	C	5	4	9	0	2	11	0	0
4	12382469	.	C	A	6	2	8	0	1	9	0	0
4	12382712	.	G	A	10	8	18	0	2	20	0	0
4	12382889	.	T	G	8	9	17	0	7	24	0	0
4	12382921	.	G	A	14	6	20	0	3	23	0	0
4	12382943	.	T	G	19	5	24	0	1	25	0	0
4	12382961	.	T	C	18	7	25	0	0	25	0	0
4	12382979	.	A	T	14	14	28	0	1	29	0	0
4	12383030	.	C	T	6	17	23	0	2	25	0	0
4	12384831	.	A	G	13	5	18	0	0	18	0	0
4	12388419	.	T	C	8	6	14	0	0	14	0	0
4	12620983	.	G	A	5	2	7	0	0	7	0	0
4	12657838	.	G	A	0	9	9	0	8	17	0	0
4	12657905	.	G	C	9	7	16	0	0	16	0	0
4	12678204	.	C	G	23	26	49	0	4	53	0	0
4	12678676	.	C	A	17	18	35	0	2	38	1	0
4	12678885	.	T	C	34	13	47	0	3	50	0	0
4	12715800	.	C	T	0	4	4	0	1	5	0	0
4	12719052	.	G	A	2	3	5	0	0	5	0	0
4	12719248	.	A	C	3	2	5	0	1	6	0	0
4	12755207	.	C	A	4	8	12	0	0	12	0	0
4	12755275	.	G	T	2	3	5	0	0	5	0	0
4	12793632	.	G	A	6	9	15	0	0	15	0	0
4	12793806	.	G	A	5	4	9	0	1	10	0	0
4	12793893	.	G	A	3	2	5	0	2	7	0	0
4	12793914	.	T	A	2	3	5	0	0	5	0	0
4	12793943	.	C	G	4	7	11	0	0	11	0	0
4	12795394	.	G	A	5	10	15	0	0	15	0	0
4	12893073	.	T	C	2	2	4	0	0	4	0	0
4	12893146	.	G	A	3	2	5	0	0	5	0	0
4	13422116	.	G	A	0	1	1	0	1	2	0	0
4	13424839	.	G	A	20	13	33	0	3	36	0	0
4	13424968	.	A	C	7	11	18	0	0	18	0	0
4	13457587	.	T	G	1	4	5	0	0	5	0	0
4	13457770	.	G	C	3	3	6	0	0	6	0	0
4	13458052	.	G	T	0	3	3	0	8	11	0	0
4	13458187	.	A	T	2	6	8	0	0	8	0	0
4	13458469	.	C	T	1	7	8	0	0	8	0	0
4	13458703	.	C	G	5	7	12	0	1	13	0	0
4	13458800	.	C	T	4	4	8	0	0	8	0	0
4	13459602	.	T	G	5	4	9	0	0	9	0	0
4	13459753	.	G	T	5	5	10	0	0	10	0	0
4	13459823	.	G	A	2	8	10	0	0	10	0	0
4	13459917	.	G	A	7	5	12	0	0	12	0	0
4	13459964	.	A	T	7	3	10	0	0	10	0	0
4	13460125	.	G	A	8	5	13	0	2	15	0	0
4	13460244	.	A	G	7	8	15	0	0	15	0	0
4	13460289	.	G	A	5	2	7	0	1	8	0	0
4	13460653	.	G	A	4	12	16	1	1	18	0	0
4	13461216	.	T	A	9	8	17	0	5	22	0	0
4	13551447	.	G	A	1	4	5	0	0	5	0	0
4	13555327	.	G	A	3	1	4	0	0	4	0	0
4	13563313	.	C	T	1	2	3	0	0	3	0	0
4	13563314	.	A	T	1	2	3	0	0	3	0	0
4	13564889	.	G	A	0	2	2	0	0	2	0	0
4	13575296	.	C	T	3	2	5	0	0	5	0	0
4	13589787	.	G	A	0	2	2	0	0	2	0	0
4	13592863	.	G	A	2	4	6	0	0	6	0	0
4	13593060	.	G	A	0	2	2	0	3	5	0	0
4	13595838	.	G	A	0	5	5	0	3	8	0	0
4	13597547	.	A	G	0	2	2	0	0	2	0	0
4	13599365	.	G	T	2	2	4	0	0	4	0	0
4	13599410	.	C	T	2	2	4	0	0	4	0	0
4	13599570	.	A	G	6	0	6	0	4	10	0	0
4	13599840	.	C	T	13	5	18	0	1	19	0	0
4	13628328	.	G	T	2	5	7	0	0	7	0	0
4	13628583	.	G	A	2	5	7	0	1	8	0	0
4	13628724	.	G	A	1	3	4	0	0	4	0	0
4	13631269	.	G	A	3	8	11	0	0	11	0	0
4	13640812	.	C	T	5	4	9	0	1	10	0	0
4	13642486	.	C	T	5	12	17	0	0	17	0	0
4	13642676	.	T	G	4	1	5	0	16	21	0	0
4	13642715	.	A	T	11	6	17	0	0	17	0	0
4	13642897	.	A	G	4	4	8	1	0	9	0	0
4	13643349	.	A	T	7	7	14	0	0	14	0	0
4	13643427	.	G	A	10	2	12	0	1	13	0	0
4	13643547	.	C	T	8	5	13	0	1	14	0	0
4	13705743	.	G	A	0	0	0	0	1	1	0	0
4	13723362	.	C	T	0	0	0	0	1	1	0	0
4	13723446	.	C	T	6	6	12	0	1	13	0	0
4	13742619	.	A	G	4	4	8	0	0	8	0	0
4	13742827	.	A	G	1	1	2	0	0	2	0	0
4	13744525	.	C	A	3	2	5	0	2	7	0	0
4	13744717	.	G	A	1	1	2	0	0	2	0	0
4	13747793	.	C	A	5	1	6	0	0	6	0	0
4	13747799	.	C	T	0	1	1	0	4	5	0	0
4	13748217	.	C	T	2	8	10	0	1	11	0	0
4	13748250	.	T	C	2	7	9	0	0	9	0	0
4	13748521	.	T	G	6	2	8	0	1	9	0	0
4	13753404	.	G	A	8	8	16	0	1	17	0	0
4	13753561	.	A	T	1	4	5	0	1	6	0	0
4	13753717	.	C	T	10	4	14	0	0	14	0	0
4	13753864	.	T	C	8	12	20	0	0	20	0	0
4	13754405	.	C	T	10	21	31	0	2	33	0	0
4	13754456	.	A	C	11	18	29	0	2	31	0	0
4	13755213	.	G	A	10	3	13	0	1	14	0	0
4	13755392	.	G	A	1	9	10	0	17	27	0	0
4	13755455	.	A	T	4	9	13	0	1	14	0	0
4	13755476	.	G	T	5	11	16	0	0	16	0	0
4	13755813	.	C	T	5	9	14	0	0	14	0	0
4	13756222	.	T	G	10	6	16	0	0	16	0	0
4	13756324	.	T	C	14	11	25	0	0	25	0	0
4	13756508	.	T	G	0	0	0	0	3	3	0	0
4	13859984	.	G	A	2	5	7	0	0	7	0	0
4	13896154	.	C	T	1	1	2	0	0	2	0	0
4	13905926	.	T	A	12	7	19	0	2	21	0	0
4	13905985	.	C	T	4	6	10	0	2	12	0	0
4	13906217	.	G	T	1	2	3	0	0	3	0	0
4	13906547	.	G	C	7	4	11	0	1	12	0	0
4	13906766	.	G	A	12	13	25	0	6	31	0	0
4	13906847	.	C	T	1	9	10	0	16	26	0	0
4	13920902	.	A	G	2	4	6	0	0	6	0	0
4	13925621	.	A	G	9	3	12	0	0	12	0	0
4	13925714	.	C	T	0	2	2	0	0	2	0	0
4	13929543	.	G	A	0	2	2	0	0	2	0	0
4	13931846	.	G	A	1	0	1	0	0	1	0	0
4	13953957	.	C	A	1	2	3	0	3	6	0	0
4	13954031	.	C	T	3	0	3	0	0	3	0	0
4	13963045	.	T	C	13	12	25	0	3	28	0	0
4	13963048	.	T	A	14	12	26	0	3	29	0	0
4	13964366	.	G	A	3	3	6	0	0	6	0	0
4	13964769	.	A	T	3	2	5	0	0	5	0	0
4	14193462	.	G	T	13	10	23	0	1	24	0	0
4	14193473	.	C	A	12	9	21	0	2	23	0	0
4	14193512	.	T	C	7	0	7	0	9	16	0	0
4	14194036	.	G	A	2	5	7	0	0	7	0	0
4	14194426	.	G	A	5	5	10	0	1	11	0	0
4	14196368	.	T	C	1	5	6	0	2	8	0	0
4	14247890	.	G	C	20	20	40	0	5	45	0	0
4	14248128	.	G	A	22	33	55	0	5	60	0	0
4	14248332	.	C	A	2	24	26	0	31	57	0	0
4	14248615	.	T	A	33	30	63	0	2	65	0	0
4	14248643	.	A	G	26	30	56	0	2	58	0	0
4	14248750	.	T	G	44	5	49	0	3	52	0	0
4	14248751	.	A	G	46	5	51	0	1	52	0	0
4	14248804	.	G	A	18	28	46	1	3	50	0	0
4	14248969	.	T	G	16	5	21	0	0	21	0	0
4	14249043	.	C	T	17	11	28	0	4	32	0	0
4	14249151	.	T	C	9	4	13	0	0	13	0	0
4	14249159	.	T	G	8	4	12	0	0	12	0	0
4	14249247	.	A	T	2	10	12	0	0	12	0	0
4	14249269	.	T	C	2	11	13	0	0	13	0	0
4	14249329	.	C	T	3	6	9	0	0	9	0	0
4	14249549	.	C	A	6	4	10	0	0	10	0	0
4	14249649	.	T	C	1	4	5	0	0	5	0	0
4	14250024	.	T	A	16	5	21	0	8	29	0	0
4	14250053	.	G	A	1	6	7	0	3	10	0	0
4	14250065	.	G	A	1	0	1	0	0	1	0	0
4	14250678	.	G	A	4	17	21	0	2	23	0	0
4	14250831	.	G	A	16	14	30	0	1	31	0	0
4	14282301	.	C	T	2	1	3	0	0	3	0	0
4	14305901	.	G	A	8	3	11	0	1	12	0	0
4	14311380	.	G	A	1	1	2	0	0	2	0	0
4	14315713	.	T	A	1	1	2	0	0	2	0	0
4	14328925	.	A	G	1	3	4	0	0	4	0	0
4	14348492	.	C	T	2	5	7	0	1	8	0	0
4	14348510	.	A	C	3	7	10	0	0	10	0	0
4	14348562	.	A	C	2	2	4	0	1	5	0	0
4	14372509	.	A	T	3	3	6	0	1	7	0	0
4	14372610	.	C	A	4	8	12	0	0	12	0	0
4	14372785	.	C	T	8	3	11	0	2	13	0	0
4	14449276	.	A	C	1	3	4	0	0	4	0	0
4	14449297	.	G	A	3	5	8	0	1	9	0	0
4	14449492	.	G	C	15	0	15	0	8	23	0	0
4	14449660	.	T	A	4	2	6	0	8	14	0	0
4	14449762	.	T	A	4	3	7	0	1	8	0	0
4	14450330	.	T	C	3	0	3	0	5	8	0	0
4	14450355	.	A	T	4	4	8	0	1	9	0	0
4	14450377	.	T	C	5	4	9	0	0	9	0	0
4	14450501	.	G	A	2	7	9	0	1	10	0	0
4	14450634	.	A	T	3	3	6	0	0	6	0	0
4	14466078	.	A	G	1	0	1	0	0	1	0	0
4	14684812	.	T	C	1	4	5	0	0	5	0	0
4	14692667	.	C	T	1	1	2	0	0	2	0	0
4	14692931	.	T	C	1	0	1	0	0	1	0	0
4	14700843	.	A	T	0	0	0	0	1	1	0	0
4	14702044	.	T	C	1	3	4	0	0	4	0	0
4	14711899	.	A	G	3	7	10	0	1	11	0	0
4	14711984	.	G	T	1	4	5	0	0	5	0	0
4	14728640	.	T	A	3	6	9	0	0	9	0	0
4	14734276	.	A	T	6	9	15	0	0	15	0	0
4	14734336	.	C	T	19	17	36	0	1	37	0	0
4	14736369	.	G	A	19	8	27	0	2	29	0	0
4	14863282	.	A	G	4	2	6	0	0	6	0	0
4	14863321	.	A	C	2	2	4	0	0	4	0	0
4	14863363	.	C	T	2	2	4	0	0	4	0	0
4	14896037	.	T	C	1	2	3	0	1	4	0	0
4	14896040	.	T	C	2	2	4	0	0	4	0	0
4	14906746	.	C	G	6	5	11	0	2	13	0	0
4	14906767	.	G	A	11	3	14	0	1	15	0	0
4	14906991	.	T	G	2	10	12	0	1	13	0	0
4	14906993	.	C	A	3	9	12	0	1	13	0	0
4	14907046	.	G	A	3	3	6	0	0	6	0	0
4	14907047	.	A	T	3	3	6	0	0	6	0	0
4	14912790	.	C	T	1	1	2	0	1	3	0	0
4	14913094	.	A	T	1	0	1	0	0	1	0	0
4	14928973	.	G	A	0	0	0	0	1	1	0	0
4	14931446	.	G	A	17	11	28	0	0	28	0	0
4	14932676	.	A	T	2	3	5	0	1	6	0	0
4	14933513	.	G	T	4	5	9	0	1	10	0	0
4	14933567	.	C	T	0	5	5	0	3	8	0	0
4	14933750	.	G	A	1	1	2	0	0	2	0	0
4	14933768	.	C	G	1	0	1	0	0	1	0	0
4	14942927	.	G	A	1	2	3	0	0	3	0	0
4	14991806	.	A	G	3	8	11	0	0	11	0	0
4	14992131	.	C	A	4	3	7	0	0	7	0	0
4	14992569	.	T	C	6	7	13	0	0	13	0	0
4	14992590	.	C	T	1	3	4	0	0	4	0	0
4	14992723	.	T	C	6	4	10	0	0	10	0	0
4	14992774	.	G	C	4	4	8	0	0	8	0	0
4	14992838	.	A	T	1	4	5	0	0	5	0	0
4	14992902	.	G	A	3	2	5	0	2	7	0	0
4	14993076	.	T	C	2	6	8	0	3	11	0	0
4	14995395	.	G	T	0	4	4	0	0	4	0	0
4	15007968	.	A	G	1	0	1	0	0	1	0	0
4	15009243	.	C	T	2	1	3	0	0	3	0	0
4	15009332	.	G	C	2	8	10	0	0	10	0	0
4	15010172	.	T	A	2	1	3	0	0	3	0	0
4	15010386	.	G	A	0	6	6	0	6	12	0	0
4	15010557	.	A	G	8	0	8	0	9	17	0	0
4	15010584	.	T	G	8	7	15	0	0	15	0	0
4	15010789	.	T	A	0	4	4	0	3	7	0	0
4	16633451	.	T	C	0	3	3	0	1	4	0	0
4	16742246	.	A	T	3	1	4	0	2	6	0	0
4	16784712	.	A	T	1	3	4	0	0	4	0	0
4	16791673	.	C	A	0	7	7	0	0	7	0	0
4	17661046	.	A	G	3	2	5	0	0	5	0	0
4	17873930	.	C	T	4	4	8	0	1	9	0	0
4	18208068	.	A	G	9	10	19	0	2	21	0	0
4	18208215	.	C	T	7	23	30	0	2	32	0	0
4	18208347	.	C	G	10	3	13	0	5	19	1	0
4	18208393	.	T	G	7	4	11	0	2	13	0	0
4	18208519	.	A	G	2	4	6	0	0	6	0	0
4	18208569	.	T	C	2	5	7	0	0	7	0	0
4	18208814	.	A	G	3	2	5	0	1	6	0	0
4	18208939	.	C	T	4	6	10	0	0	10	0	0
4	18209084	.	G	A	9	6	15	0	0	15	0	0
4	18235114	.	T	C	1	5	6	0	0	6	0	0
4	18235140	.	A	G	0	4	4	0	0	4	0	0
4	18237355	.	A	G	2	3	5	0	0	5	0	0
4	18240607	.	C	A	0	3	3	0	8	11	0	0
4	18248692	.	C	T	0	1	1	0	2	3	0	0
4	18287467	.	A	G	5	2	7	0	0	7	0	0
4	18296126	.	T	C	3	2	5	0	1	6	0	0
4	18301500	.	A	G	1	0	1	0	0	1	0	0
4	18383328	.	G	A	5	2	7	0	0	7	0	0
4	18416305	.	G	C	4	1	5	0	0	5	0	0
4	18453875	.	T	A	6	4	10	0	0	10	0	0
4	18454423	.	G	A	6	2	8	0	1	9	0	0
4	18454583	.	T	C	1	0	1	0	0	1	0	0
4	18502437	.	A	G	1	2	3	0	0	3	0	0
4	18503393	.	G	C	2	2	4	0	0	4	0	0
4	18503489	.	T	C	0	4	4	0	0	4	0	0
4	18503519	.	A	C	0	1	1	0	0	1	0	0
4	18504505	.	T	A	0	3	3	0	0	3	0	0
4	18593989	.	T	A	3	5	8	0	1	9	0	0
4	18597683	.	C	G	3	2	5	0	0	5	0	0
4	18597685	.	C	T	2	3	5	0	0	5	0	0
4	18599283	.	C	T	1	1	2	0	2	4	0	0
4	18599637	.	G	A	2	3	5	0	1	6	0	0
4	18609759	.	C	G	0	2	2	0	0	2	0	0
4	18609769	.	A	G	1	2	3	0	0	3	0	0
4	18609855	.	G	C	2	3	5	0	0	5	0	0
4	18610030	.	G	A	6	2	8	0	0	8	0	0
4	18720905	.	C	T	9	5	14	0	0	14	0	0
4	18720947	.	G	T	4	6	10	0	2	12	0	0
4	18836957	.	A	T	3	4	7	0	0	7	0	0
4	18837307	.	T	C	7	6	13	0	6	19	0	0
4	18837559	.	C	T	0	14	14	0	11	25	0	0
4	18837561	.	T	G	9	11	20	0	5	25	0	0
4	18838057	.	C	T	2	4	6	0	1	7	0	0
4	18846932	.	G	A	5	2	7	0	0	7	0	0
4	18853815	.	A	G	11	11	22	0	3	25	0	0
4	18853972	.	C	G	2	14	16	0	0	16	0	0
4	18854250	.	A	C	12	0	12	0	16	28	0	0
4	18854417	.	T	A	2	4	6	1	6	13	0	0
4	18854519	.	A	C	3	6	9	0	0	9	0	0
4	18854525	.	A	C	4	7	11	0	0	11	0	0
4	18979820	.	T	A	1	1	2	0	0	2	0	0
4	18981945	.	A	G	5	4	9	0	0	9	0	0
4	18984234	.	A	C	7	10	17	0	2	19	0	0
4	18984588	.	A	G	13	7	20	0	1	21	0	0
4	18984628	.	G	A	15	4	19	0	1	20	0	0
4	18984999	.	T	C	11	3	14	0	4	18	0	0
4	18985048	.	A	T	7	7	14	0	0	14	0	0
4	18985142	.	G	A	8	11	19	0	1	20	0	0
4	18985206	.	T	C	8	15	23	0	0	23	0	0
4	18985216	.	T	C	6	17	23	0	2	25	0	0
4	18985327	.	A	C	8	5	13	0	1	14	0	0
4	18985406	.	G	T	0	5	5	0	8	13	0	0
4	18985594	.	T	A	5	4	9	0	0	9	0	0
4	18985730	.	G	A	5	8	13	0	1	14	0	0
4	18986413	.	G	A	9	6	15	0	2	17	0	0
4	18986497	.	C	T	0	17	17	0	9	26	0	0
4	18986754	.	T	C	2	5	7	0	1	8	0	0
4	18986805	.	G	T	7	2	9	0	0	9	0	0
4	18986873	.	C	T	5	7	12	0	0	12	0	0
4	18986893	.	C	G	7	6	13	0	2	15	0	0
4	18986997	.	G	A	4	9	13	0	0	13	0	0
4	18987202	.	C	A	6	3	9	0	1	10	0	0
4	18987250	.	G	A	6	5	11	0	2	13	0	0
4	18987391	.	G	A	8	6	14	0	1	15	0	0
4	18999680	.	C	T	0	3	3	0	2	5	0	0
4	19007357	.	C	T	0	2	2	0	2	4	0	0
4	19007377	.	T	A	3	2	5	0	0	5	0	0
4	19397640	.	A	T	4	10	14	0	3	17	0	0
4	19397641	.	A	T	13	1	14	0	3	17	0	0
4	19414905	.	G	A	4	3	7	0	0	7	0	0
4	19493773	.	G	T	6	8	14	0	0	14	0	0
4	19535360	.	T	A	4	3	7	0	0	7	0	0
4	19535841	.	T	G	9	8	17	0	0	17	0	0
4	19536344	.	A	T	6	8	14	0	0	14	0	0
4	19536554	.	A	T	12	6	18	0	1	19	0	0
4	19536953	.	C	T	20	11	31	0	2	33	0	0
4	19536959	.	G	A	19	10	29	0	2	31	0	0
4	19537268	.	G	A	0	11	11	0	22	33	0	0
4	19537703	.	A	G	21	20	41	0	3	45	1	0
4	19537803	.	A	C	21	18	39	0	12	51	0	0
4	19537937	.	A	G	23	1	24	0	28	52	0	0
4	19538578	.	A	T	18	24	42	0	9	51	0	0
4	19539017	.	C	T	16	4	20	0	1	21	0	0
4	19611694	.	G	A	2	4	6	0	0	6	0	0
4	19611739	.	T	G	3	4	7	0	0	7	0	0
4	19611769	.	G	A	1	1	2	0	0	2	0	0
4	19675261	.	C	T	2	3	5	0	0	5	0	0
4	19947743	.	G	T	3	3	6	0	1	7	0	0
4	19947781	.	G	T	3	3	6	0	0	6	0	0
4	19948131	.	G	A	4	2	6	0	0	6	0	0
4	19948306	.	C	T	2	4	6	0	0	6	0	0
4	19948697	.	G	A	3	4	7	0	0	7	0	0
4	19948746	.	T	C	1	2	3	0	0	3	0	0
4	19948883	.	C	G	1	4	5	0	0	5	0	0
4	19949388	.	C	A	0	3	3	0	4	7	0	0
4	19949730	.	T	C	4	4	8	0	0	8	0	0
4	19949793	.	C	T	0	6	6	0	1	7	0	0
4	19949865	.	T	A	6	5	11	0	0	11	0	0
4	19949989	.	T	C	2	2	4	0	0	4	0	0
4	19950024	.	T	A	0	3	3	0	0	3	0	0
4	20037916	.	A	T	1	3	4	0	0	4	0	0
4	20051485	.	A	G	1	1	2	0	0	2	0	0
4	20051488	.	A	G	0	1	1	0	1	2	0	0
4	20053901	.	C	T	19	9	28	0	3	31	0	0
4	20054036	.	C	T	13	13	26	0	5	31	0	0
4	20054243	.	A	G	2	3	5	0	3	8	0	0
4	20054516	.	C	T	6	4	10	0	0	10	0	0
4	20065233	.	C	T	1	2	3	0	0	3	0	0
4	20065762	.	C	A	1	2	3	0	1	4	0	0
4	20066208	.	G	A	5	4	9	0	0	9	0	0
4	20066276	.	G	A	0	3	3	0	3	6	0	0
4	20068446	.	G	A	6	7	13	0	0	13	0	0
4	20069091	.	T	C	5	3	8	0	4	12	0	0
4	20069343	.	C	A	10	9	19	0	0	19	0	0
4	20071344	.	A	T	6	4	10	0	1	11	0	0
4	20071401	.	G	T	6	9	15	0	0	15	0	0
4	20071509	.	T	C	1	1	2	0	2	4	0	0
4	20072129	.	T	G	3	4	7	0	0	7	0	0
4	20072176	.	A	T	4	5	9	0	0	9	0	0
4	20072429	.	T	G	9	12	21	0	0	21	0	0
4	20072441	.	C	T	9	11	20	0	3	23	0	0
4	20073790	.	T	C	0	1	1	0	0	1	0	0
4	20075025	.	A	G	1	0	1	0	1	2	0	0
4	20075028	.	T	C	1	1	2	0	0	2	0	0
4	20091055	.	G	C	0	3	3	0	1	4	0	0
4	20093155	.	A	T	0	3	3	0	0	3	0	0
4	20094257	.	T	C	2	2	4	0	0	4	0	0
4	20098630	.	T	C	4	1	5	0	0	5	0	0
4	20098662	.	T	A	8	5	13	0	2	15	0	0
4	20098793	.	C	G	3	4	7	0	0	7	0	0
4	20099131	.	C	T	6	5	11	0	0	11	0	0
4	20099261	.	C	T	4	2	6	0	1	7	0	0
4	20099631	.	T	C	3	4	7	0	0	7	0	0
4	20099854	.	G	C	0	2	2	0	7	9	0	0
4	20100081	.	C	T	3	4	7	0	1	8	0	0
4	20100730	.	A	T	8	6	14	0	0	14	0	0
4	20100754	.	A	G	9	1	10	0	7	17	0	0
4	20100805	.	C	T	8	6	14	0	0	14	0	0
4	20101072	.	G	A	7	9	16	0	0	16	0	0
4	20101207	.	C	T	3	2	5	0	1	6	0	0
4	20101399	.	A	C	7	7	14	0	0	14	0	0
4	20101404	.	G	A	6	8	14	0	1	15	0	0
4	20101508	.	A	G	4	7	11	0	0	11	0	0
4	20101510	.	A	T	4	7	11	0	0	11	0	0
4	20101562	.	T	C	1	6	7	0	0	7	0	0
4	20102291	.	C	T	1	2	3	0	1	4	0	0
4	20102905	.	A	T	2	4	6	0	1	7	0	0
4	20125874	.	C	T	3	5	8	0	0	8	0	0
4	20130015	.	G	T	1	2	3	0	0	3	0	0
4	20979435	.	C	A	1	2	3	0	0	3	0	0
4	20980971	.	A	G	1	1	2	0	0	2	0	0
4	20981184	.	T	C	4	3	7	0	0	7	0	0
4	20981198	.	G	A	0	5	5	0	3	8	0	0
4	20981273	.	A	C	1	1	2	0	0	2	0	0
4	20986930	.	A	T	4	6	10	0	0	10	0	0
4	20987317	.	A	T	4	5	9	0	0	9	0	0
4	20987326	.	T	G	4	5	9	0	0	9	0	0
4	21263703	.	C	T	2	1	3	0	0	3	0	0
4	21290798	.	G	A	11	4	15	0	1	16	0	0
4	21312731	.	C	G	30	10	40	0	3	43	0	0
4	21312981	.	C	T	23	25	48	0	8	56	0	0
4	21313779	.	T	G	23	24	47	0	4	51	0	0
4	21313805	.	G	A	0	33	33	0	28	61	0	0
4	21314036	.	T	A	22	34	56	0	2	58	0	0
4	21314338	.	G	T	29	31	60	0	4	64	0	0
4	21314663	.	C	T	29	30	59	0	2	61	0	0
4	21314771	.	T	C	33	30	63	0	6	69	0	0
4	21314940	.	C	T	33	43	76	0	3	79	0	0
4	21466265	.	A	G	4	6	10	0	0	10	0	0
4	21489110	.	G	A	13	19	32	0	1	33	0	0
4	21489242	.	G	A	19	12	31	0	5	36	0	0
4	21489550	.	A	G	7	3	10	1	5	16	0	0
4	21489975	.	T	A	14	17	31	0	4	35	0	0
4	21507026	.	G	A	1	4	5	0	0	5	0	0
4	21508317	.	G	A	2	2	4	0	1	5	0	0
4	21512191	.	C	T	4	2	6	0	1	7	0	0
4	21519783	.	C	T	5	3	8	0	0	8	0	0
4	21523541	.	A	T	4	5	9	0	0	9	0	0
4	21523789	.	T	G	5	3	8	0	1	9	0	0
4	21525430	.	G	T	0	1	1	0	0	1	0	0
4	21539658	.	G	A	0	0	0	0	1	1	0	0
4	21651465	.	A	T	9	13	22	0	0	22	0	0
4	21651525	.	G	A	6	13	19	0	1	20	0	0
4	21752284	.	G	A	6	4	10	0	3	13	0	0
4	21752291	.	C	T	7	7	14	0	1	15	0	0
4	21752372	.	T	A	4	3	7	1	0	8	0	0
4	21752688	.	G	C	10	1	11	0	18	29	0	0
4	21752699	.	C	T	12	13	25	0	1	26	0	0
4	21752728	.	A	T	9	15	24	0	2	26	0	0
4	21752736	.	T	C	18	8	26	0	1	27	0	0
4	21752867	.	T	C	5	11	16	0	1	17	0	0
4	21753145	.	T	C	14	6	20	0	1	21	0	0
4	21761688	.	A	T	10	5	15	0	0	15	0	0
4	21766808	.	G	A	6	8	14	0	2	16	0	0
4	21958043	.	A	G	14	9	23	0	3	26	0	0
4	21958210	.	A	C	13	8	21	0	1	22	0	0
4	21958226	.	T	G	12	11	23	0	3	26	0	0
4	21962364	.	T	A	0	4	4	0	0	4	0	0
4	21973713	.	T	C	4	2	6	0	0	6	0	0
4	21975248	.	G	A	7	5	12	0	1	13	0	0
4	21981118	.	T	C	6	4	10	0	1	11	0	0
4	22006507	.	C	A	0	2	2	0	0	2	0	0
4	22299976	.	A	G	2	0	2	0	6	8	0	0
4	22300125	.	A	C	2	5	7	0	0	7	0	0
4	22300153	.	T	A	2	4	6	0	0	6	0	0
4	22300166	.	A	G	2	0	2	0	3	5	0	0
4	22313107	.	A	T	7	8	15	0	1	16	0	0
4	22313244	.	G	A	13	9	22	0	0	22	0	0
4	22313397	.	C	A	4	3	7	0	2	9	0	0
4	22313677	.	A	G	4	2	6	0	0	6	0	0
4	22313722	.	A	C	2	7	9	0	1	10	0	0
4	22313861	.	T	A	4	9	13	0	0	13	0	0
4	22314085	.	G	A	3	5	8	0	0	8	0	0
4	22314094	.	A	C	3	4	7	0	1	8	0	0
4	22314279	.	G	A	2	0	2	0	0	2	0	0
4	22316148	.	T	C	2	6	8	0	0	8	0	0
4	22316321	.	C	T	2	4	6	0	1	7	0	0
4	22316323	.	C	T	0	3	3	0	4	7	0	0
4	22316481	.	C	T	5	3	8	0	1	9	0	0
4	22316558	.	G	A	5	8	13	0	1	14	0	0
4	22316624	.	A	T	8	8	16	0	1	17	0	0
4	22318144	.	C	T	4	2	6	0	0	6	0	0
4	22318574	.	T	C	1	2	3	0	1	4	0	0
4	22318640	.	A	T	3	2	5	0	0	5	0	0
4	22319407	.	A	G	2	3	5	0	0	5	0	0
4	22319428	.	G	C	3	2	5	0	0	5	0	0
4	22319558	.	G	A	1	2	3	0	0	3	0	0
4	22319840	.	T	C	1	2	3	0	0	3	0	0
4	22320056	.	C	T	1	2	3	0	0	3	0	0
4	22320156	.	G	A	3	2	5	0	0	5	0	0
4	22321089	.	T	C	1	2	3	0	0	3	0	0
4	22321111	.	C	A	1	2	3	0	0	3	0	0
4	22328321	.	C	A	1	2	3	0	0	3	0	0
4	22328333	.	T	C	1	1	2	0	0	2	0	0
4	22365152	.	C	T	9	4	13	0	0	13	0	0
4	22365356	.	T	G	4	5	9	0	1	10	0	0
4	22365400	.	G	A	4	4	8	0	0	8	0	0
4	22365489	.	C	A	14	5	19	0	1	20	0	0
4	22418966	.	C	G	31	21	52	0	2	54	0	0
4	22419003	.	A	G	27	25	52	0	1	53	0	0
4	22419483	.	G	T	24	26	50	0	5	55	0	0
4	22424891	.	A	G	23	18	41	0	3	44	0	0
4	22424927	.	A	T	26	18	44	0	6	50	0	0
4	22425115	.	G	A	13	15	28	0	2	30	0	0
4	22428148	.	C	T	1	8	9	0	6	15	0	0
4	22428619	.	T	C	2	3	5	0	0	5	0	0
4	22432825	.	G	T	4	5	9	0	1	10	0	0
4	22433062	.	C	T	0	3	3	0	0	3	0	0
4	22433307	.	A	G	1	3	4	0	2	6	0	0
4	22433348	.	G	A	8	3	11	0	0	11	0	0
4	22433474	.	T	C	0	1	1	0	0	1	0	0
4	22472526	.	C	T	0	2	2	0	1	3	0	0
4	22480266	.	G	T	20	27	47	0	3	50	0	0
4	22480279	.	T	A	21	23	44	0	4	48	0	0
4	22482708	.	A	G	4	2	6	0	1	7	0	0
4	22482828	.	C	G	10	8	18	0	0	18	0	0
4	22482923	.	T	C	12	13	25	0	0	25	0	0
4	22482930	.	G	A	12	12	24	0	1	25	0	0
4	22483117	.	T	A	3	7	10	0	1	11	0	0
4	22485085	.	C	T	1	5	6	0	1	7	0	0
4	22492406	.	T	C	2	4	6	0	1	7	0	0
4	22495375	.	G	A	1	1	2	0	0	2	0	0
4	22652698	.	A	C	1	2	3	0	0	3	0	0
4	22652782	.	T	C	1	3	4	0	0	4	0	0
4	22658838	.	A	G	8	9	17	0	2	19	0	0
4	22660036	.	A	T	2	0	2	0	0	2	0	0
4	22669421	.	G	A	0	1	1	0	0	1	0	0
4	22671354	.	T	C	2	4	6	0	1	7	0	0
4	22680636	.	G	T	0	6	6	0	4	10	0	0
4	22697095	.	C	G	3	0	3	0	4	7	0	0
4	22697209	.	T	C	3	1	4	0	0	4	0	0
4	22707767	.	T	C	26	19	45	0	1	46	0	0
4	22707820	.	C	T	7	8	15	0	2	17	0	0
4	22713026	.	G	A	2	3	5	0	0	5	0	0
4	22713260	.	A	G	7	0	7	0	18	25	0	0
4	22713644	.	A	G	16	25	41	0	5	46	0	0
4	22713946	.	T	G	14	1	15	0	18	33	0	0
4	22730951	.	A	C	6	4	10	0	0	10	0	0
4	22731883	.	C	T	1	1	2	0	0	2	0	0
4	22731943	.	T	G	5	5	10	0	3	13	0	0
4	22734643	.	C	T	6	8	14	0	2	16	0	0
4	22734676	.	C	T	2	5	7	0	0	7	0	0
4	22736977	.	A	G	3	2	5	0	0	5	0	0
4	22740885	.	C	T	6	2	8	0	0	8	0	0
4	22740891	.	G	C	5	2	7	0	1	8	0	0
4	22741066	.	A	G	0	1	1	0	0	1	0	0
4	22743616	.	A	G	4	1	5	0	1	6	0	0
4	22749481	.	C	T	1	1	2	0	0	2	0	0
4	22749482	.	T	C	1	1	2	0	0	2	0	0
4	22756239	.	T	C	12	13	25	0	0	25	0	0
4	22756301	.	A	C	9	9	18	0	2	20	0	0
4	22756333	.	C	T	9	11	20	0	1	21	0	0
4	22756436	.	G	A	4	12	16	0	2	18	0	0
4	22756593	.	A	T	7	3	10	0	1	11	0	0
4	22757402	.	T	G	7	2	9	0	0	9	0	0
4	22757494	.	T	A	1	4	5	0	0	6	1	0
4	22758095	.	C	T	2	2	4	0	0	4	0	0
4	22758343	.	C	T	4	2	6	0	1	7	0	0
4	23122759	.	T	C	1	1	2	0	1	3	0	0
4	23122999	.	T	C	2	2	4	0	0	4	0	0
4	23129080	.	A	G	1	1	2	0	1	3	0	0
4	23132725	.	G	A	2	1	3	0	0	3	0	0
4	23134282	.	C	G	5	7	12	0	1	13	0	0
4	23134520	.	T	C	7	6	13	0	0	13	0	0
4	23134541	.	G	A	5	6	11	0	1	12	0	0
4	23135330	.	A	G	6	5	11	0	0	11	0	0
4	23135354	.	G	C	4	5	9	0	0	9	0	0
4	23135791	.	A	C	1	4	5	0	0	5	0	0
4	23135858	.	A	G	2	3	5	0	0	5	0	0
4	23408029	.	G	A	3	4	7	0	1	8	0	0
4	23458752	.	G	T	3	1	4	0	0	4	0	0
4	23459111	.	C	T	2	0	2	0	0	2	0	0
4	23465482	.	A	G	1	2	3	0	0	3	0	0
4	23465570	.	G	T	0	2	2	0	0	2	0	0
4	23486639	.	G	A	0	4	4	1	0	5	0	0
4	25055479	.	C	G	2	17	19	0	16	35	0	0
4	25055602	.	A	G	24	32	56	0	2	58	0	0
4	25084487	.	T	G	8	6	14	0	0	14	0	0
4	25084596	.	A	G	3	2	5	0	0	5	0	0
4	25084744	.	A	G	10	7	17	0	3	20	0	0
4	25104684	.	C	T	5	4	9	0	0	9	0	0
4	25104957	.	C	T	3	7	10	0	2	12	0	0
4	25105502	.	G	T	10	13	23	0	3	26	0	0
4	25105662	.	A	G	2	7	9	0	3	12	0	0
4	25105761	.	T	C	1	2	3	0	1	4	0	0
4	25165623	.	A	G	4	3	7	0	0	7	0	0
4	25168280	.	T	C	2	4	6	0	0	6	0	0
4	25168368	.	G	A	4	4	8	0	0	8	0	0
4	25168417	.	A	G	3	2	5	0	0	5	0	0
4	25168418	.	A	G	3	2	5	0	0	5	0	0
4	25173387	.	T	C	18	19	37	0	2	39	0	0
4	25173396	.	A	G	14	16	30	0	4	34	0	0
4	25176093	.	A	G	9	8	17	0	2	19	0	0
4	25178069	.	G	T	5	1	6	0	1	7	0	0
4	25178402	.	G	C	5	1	6	0	1	7	0	0
4	25178425	.	G	A	12	8	20	0	2	22	0	0
4	25179897	.	A	G	2	7	9	0	0	9	0	0
4	25179948	.	C	T	0	19	19	0	9	28	0	0
4	25179996	.	A	G	2	5	7	0	0	7	0	0
4	25184559	.	C	T	4	2	6	0	0	6	0	0
4	25184565	.	G	A	4	2	6	0	0	6	0	0
4	25184718	.	G	A	3	2	5	0	0	5	0	0
4	25184890	.	C	T	0	1	1	0	0	1	0	0
4	25185797	.	T	C	2	3	5	0	0	5	0	0
4	25473708	.	A	T	3	5	8	0	0	8	0	0
4	25473927	.	C	A	0	5	5	0	9	14	0	0
4	25473934	.	T	G	3	9	12	0	0	12	0	0
4	25474417	.	G	A	9	15	24	0	1	25	0	0
4	25476629	.	G	A	3	0	3	0	0	3	0	0
4	25480923	.	A	T	0	1	1	0	0	1	0	0
4	25482595	.	C	A	1	1	2	0	0	2	0	0
4	25497398	.	G	A	5	2	7	0	1	8	0	0
4	25497411	.	T	C	2	0	2	0	6	8	0	0
4	25497464	.	T	C	4	0	4	0	7	11	0	0
4	25506896	.	A	G	0	5	5	0	0	5	0	0
4	25511451	.	T	C	3	4	7	0	0	7	0	0
4	25512840	.	C	T	1	2	3	0	1	4	0	0
4	25515157	.	C	T	2	2	4	0	1	5	0	0
4	25694866	.	G	T	0	1	1	0	1	2	0	0
4	25697282	.	T	G	1	2	3	0	0	3	0	0
4	25700800	.	A	T	0	6	6	0	0	6	0	0
4	25754991	.	A	G	5	5	10	0	2	12	0	0
4	25755137	.	C	T	4	4	8	0	0	8	0	0
4	25756020	.	A	G	1	2	3	0	0	3	0	0
4	25756105	.	A	G	1	1	2	0	1	3	0	0
4	25756148	.	A	G	2	1	3	0	0	3	0	0
4	25756165	.	T	C	2	1	3	0	0	3	0	0
4	25756305	.	A	C	4	6	10	0	0	10	0	0
4	25756453	.	G	T	7	5	12	0	0	12	0	0
4	25759198	.	C	T	0	2	2	0	1	3	0	0
4	25759327	.	G	A	6	3	9	0	1	10	0	0
4	25759518	.	C	A	0	4	4	0	3	7	0	0
4	25759549	.	T	C	1	3	4	0	2	6	0	0
4	25796765	.	G	A	3	5	8	0	0	8	0	0
4	25829939	.	G	A	15	12	27	0	3	30	0	0
4	25833221	.	G	A	2	5	7	0	0	7	0	0
4	25839179	.	A	G	1	2	3	0	0	3	0	0
4	25839670	.	T	G	2	3	5	0	0	5	0	0
4	25839737	.	G	A	3	6	9	0	2	11	0	0
4	25839817	.	A	C	1	0	1	0	6	7	0	0
4	25839911	.	G	C	6	5	11	0	0	11	0	0
4	25839931	.	C	T	0	3	3	0	9	12	0	0
4	25842788	.	C	T	5	3	8	0	0	8	0	0
4	25843004	.	A	G	2	3	5	0	0	5	0	0
4	25860634	.	C	T	2	3	5	0	0	5	0	0
4	25936437	.	A	G	1	2	3	0	1	4	0	0
4	25936491	.	A	G	1	2	3	0	0	3	0	0
4	25936512	.	C	T	0	0	0	0	1	1	0	0
4	25939194	.	T	A	2	0	2	0	0	2	0	0
4	25939200	.	T	C	0	0	0	0	1	1	0	0
4	26010878	.	T	C	1	3	4	0	0	4	0	0
4	26022351	.	C	G	6	5	11	0	0	11	0	0
4	26022413	.	C	T	3	2	5	0	0	5	0	0
4	26028813	.	C	T	2	2	4	0	0	4	0	0
4	26028873	.	C	T	0	2	2	0	2	4	0	0
4	26072844	.	G	A	2	3	5	0	0	5	0	0
4	26077483	.	T	C	2	2	4	0	0	4	0	0
4	26077671	.	A	T	3	5	8	0	0	8	0	0
4	26078847	.	A	G	1	4	5	0	0	5	0	0
4	26079353	.	A	C	4	4	8	0	0	8	0	0
4	26079372	.	C	T	2	4	6	0	2	8	0	0
4	26079940	.	T	C	3	7	10	0	0	10	0	0
4	26080102	.	A	T	3	4	7	0	0	7	0	0
4	26081006	.	G	A	9	7	16	0	0	16	0	0
4	26303911	.	A	G	7	14	21	0	1	22	0	0
4	26303953	.	T	C	7	13	20	0	2	22	0	0
4	26304190	.	T	A	9	5	14	0	2	16	0	0
4	26304240	.	T	G	13	9	22	0	4	26	0	0
4	26304730	.	G	T	3	9	12	0	3	15	0	0
4	26305191	.	T	C	9	5	14	0	0	14	0	0
4	26305286	.	C	A	5	9	14	0	1	15	0	0
4	26305309	.	T	A	8	10	18	0	2	20	0	0
4	26305324	.	C	T	6	11	17	0	0	17	0	0
4	26305368	.	C	T	6	12	18	0	2	20	0	0
4	26305382	.	G	A	7	9	16	0	2	18	0	0
4	26305413	.	A	C	7	9	16	0	0	16	0	0
4	26305468	.	A	T	12	5	17	0	1	18	0	0
4	26305516	.	A	T	8	4	12	0	2	14	0	0
4	26305578	.	A	T	4	5	9	0	1	10	0	0
4	26322651	.	C	T	4	8	12	0	0	12	0	0
4	26629672	.	C	T	4	5	9	0	0	9	0	0
4	26762518	.	G	T	5	3	8	0	1	9	0	0
4	26765056	.	T	C	4	1	5	0	1	6	0	0
4	26765057	.	A	T	3	2	5	0	1	6	0	0
4	27082234	.	G	A	3	4	7	0	1	8	0	0
4	27109288	.	A	T	9	4	13	0	0	13	0	0
4	27112663	.	T	A	2	3	5	0	1	6	0	0
4	27113265	.	T	A	3	2	5	0	1	6	0	0
4	27114157	.	T	C	5	4	9	0	0	9	0	0
4	27114894	.	A	G	2	3	5	0	1	6	0	0
4	27115228	.	G	T	6	2	8	0	0	8	0	0
4	27137517	.	T	A	1	3	4	0	0	4	0	0
4	27139739	.	T	C	2	2	4	0	0	4	0	0
4	27139922	.	A	G	1	3	4	0	0	4	0	0
4	27140644	.	C	T	0	1	1	0	0	1	0	0
4	27147510	.	T	C	2	4	6	0	1	7	0	0
4	27147752	.	A	G	3	5	8	0	1	9	0	0
4	27148142	.	T	C	6	4	10	0	0	10	0	0
4	27148267	.	A	G	10	5	15	0	1	16	0	0
4	27148927	.	G	A	3	3	6	0	3	9	0	0
4	27149676	.	G	T	4	2	6	0	2	8	0	0
4	27149680	.	G	T	3	6	9	0	3	12	0	0
4	27252178	.	C	T	1	9	10	0	10	20	0	0
4	27252581	.	G	A	12	18	30	0	0	30	0	0
4	27252813	.	C	T	12	15	27	0	2	29	0	0
4	27253043	.	T	A	19	21	40	0	0	40	0	0
4	27350666	.	G	A	4	4	8	0	1	9	0	0
4	27628170	.	G	A	7	4	11	0	1	12	0	0
4	27628300	.	C	A	5	4	9	0	0	9	0	0
4	27628697	.	A	C	6	5	11	0	0	11	0	0
4	27628788	.	T	A	7	3	10	0	0	10	0	0
4	27921925	.	A	G	2	3	5	0	0	5	0	0
4	27945941	.	T	C	0	1	1	0	0	1	0	0
4	27945947	.	C	T	0	2	2	0	0	2	0	0
4	27953774	.	C	T	1	2	3	0	1	4	0	0
4	28062562	.	G	C	1	4	5	0	0	5	0	0
4	28062581	.	A	G	1	3	4	0	0	4	0	0
4	28062690	.	T	C	0	7	7	0	0	7	0	0
4	28062846	.	T	A	3	5	8	0	1	9	0	0
4	28063635	.	A	G	6	5	11	0	1	12	0	0
4	28063653	.	G	T	4	4	8	0	2	10	0	0
4	28063715	.	A	G	4	2	6	0	1	7	0	0
4	28063911	.	C	G	0	1	1	0	4	5	0	0
4	28064028	.	T	C	1	3	4	0	0	4	0	0
4	28066394	.	G	A	3	0	3	0	0	3	0	0
4	28068908	.	G	A	0	3	3	0	0	3	0	0
4	28093323	.	A	G	1	3	4	0	0	4	0	0
4	28191712	.	G	A	2	4	6	0	0	6	0	0
4	28194299	.	C	T	3	3	6	0	0	6	0	0
4	28194359	.	G	A	2	3	5	0	0	5	0	0
4	28195380	.	A	C	1	3	4	0	1	5	0	0
4	28195396	.	T	C	2	4	6	0	0	6	0	0
4	28195552	.	G	A	0	0	0	0	1	1	0	0
4	28195558	.	C	T	0	0	0	0	1	1	0	0
4	28373691	.	A	G	1	0	1	0	0	1	0	0
4	28373791	.	T	G	7	5	12	0	1	13	0	0
4	28379172	.	T	A	3	2	5	0	0	5	0	0
4	28379740	.	G	A	2	2	4	0	0	4	0	0
4	28422856	.	C	G	1	2	3	0	0	3	0	0
4	28422935	.	G	A	1	3	4	0	0	4	0	0
4	28422950	.	G	A	1	2	3	0	0	3	0	0
4	28423483	.	T	C	3	3	6	0	1	7	0	0
4	28423499	.	A	T	1	4	5	0	2	7	0	0
4	28423547	.	C	T	2	5	7	0	0	7	0	0
4	28423595	.	A	G	2	6	8	0	0	8	0	0
4	28423669	.	A	G	1	5	6	0	0	6	0	0
4	28423735	.	C	T	2	4	6	0	1	7	0	0
4	28423786	.	A	T	3	3	6	0	0	6	0	0
4	28423923	.	T	C	2	2	4	0	0	4	0	0
4	28423952	.	G	C	1	3	4	0	1	5	0	0
4	28424085	.	A	G	1	0	1	0	2	3	0	0
4	28975577	.	T	C	1	2	3	0	1	4	0	0
4	28975587	.	A	C	2	2	4	0	0	4	0	0
4	28975943	.	G	A	1	3	4	0	0	4	0	0
4	28976088	.	G	T	1	2	3	0	0	3	0	0
4	28976097	.	A	G	0	2	2	0	1	3	0	0
4	29040106	.	T	C	1	4	5	0	0	5	0	0
4	29040526	.	A	T	0	4	4	0	1	5	0	0
4	29040548	.	A	G	1	5	6	0	0	6	0	0
4	29040677	.	G	A	1	3	4	0	0	4	0	0
4	29040980	.	C	A	3	6	9	0	0	9	0	0
4	29042658	.	G	T	2	2	4	0	0	4	0	0
4	29050168	.	T	A	1	1	2	0	0	2	0	0
4	29285251	.	C	T	1	4	5	0	1	6	0	0
4	29287803	.	C	A	4	2	6	0	0	6	0	0
4	40959626	.	C	T	3	3	6	0	1	7	0	0
4	40959639	.	T	G	3	2	5	0	2	7	0	0
4	50756006	.	C	T	0	3	3	0	0	3	0	0
4	52740687	.	C	T	1	5	6	0	0	6	0	0
4	57351478	.	G	A	3	2	5	0	0	5	0	0
4	60761026	.	A	T	0	2	2	1	0	3	0	0
4	60761027	.	A	T	0	2	2	1	0	3	0	0
4	70842309	.	T	A	1	2	3	0	0	3	0	0
4	70850966	.	G	T	10	3	13	0	1	14	0	0
4	70851202	.	T	C	1	0	1	0	5	6	0	0
4	70855939	.	C	T	0	2	2	0	5	7	0	0
4	70860166	.	A	G	8	3	11	0	0	11	0	0
4	72272239	.	G	A	2	3	5	0	0	5	0	0
4	72272617	.	G	A	3	2	5	0	0	5	0	0
4	72348990	.	C	G	1	2	3	0	0	3	0	0
4	72422797	.	A	T	3	3	6	0	0	6	0	0
4	72436430	.	T	C	1	2	3	0	0	3	0	0
4	72436638	.	A	T	2	3	5	0	0	5	0	0
4	72436642	.	G	A	2	4	6	0	0	6	0	0
4	72436763	.	T	C	2	5	7	0	0	7	0	0
4	72437201	.	A	G	1	2	3	0	0	3	0	0
4	72437838	.	G	A	5	4	9	0	0	9	0	0
4	72439362	.	C	T	0	2	2	0	1	3	0	0
4	72535570	.	G	T	3	2	5	0	1	6	0	0
4	72549591	.	T	G	3	2	5	0	0	5	0	0
4	72549597	.	A	T	2	2	4	0	0	4	0	0
4	72555393	.	A	G	1	1	2	0	0	2	0	0
4	72559474	.	G	A	5	2	7	0	0	7	0	0
4	72559558	.	A	G	3	4	7	0	0	7	0	0
4	72559612	.	A	G	1	2	3	0	0	3	0	0
4	72559629	.	C	G	1	2	3	0	0	3	0	0
4	72559951	.	C	T	0	2	2	0	3	5	0	0
4	72604472	.	G	A	2	2	4	0	1	5	0	0
4	72628932	.	G	A	2	3	5	0	0	5	0	0
4	72629295	.	T	C	2	2	4	0	0	4	0	0
4	72630174	.	A	G	1	4	5	0	0	5	0	0
4	72630316	.	G	A	0	2	2	0	1	3	0	0
4	72723788	.	T	C	8	15	23	0	3	26	0	0
4	72723832	.	A	T	5	9	14	0	1	15	0	0
4	72723858	.	A	G	9	9	18	0	0	18	0	0
4	72748096	.	T	C	7	7	14	0	2	16	0	0
4	72754244	.	C	T	7	18	25	0	2	27	0	0
4	73063099	.	C	T	1	2	3	0	0	3	0	0
4	73064975	.	A	T	0	1	1	0	0	1	0	0
4	73382536	.	C	T	0	2	2	0	2	4	0	0
4	73383895	.	G	C	0	3	3	0	0	3	0	0
4	73419970	.	G	A	1	3	4	0	1	5	0	0
4	73473074	.	C	T	2	3	5	0	0	5	0	0
4	73473076	.	C	T	3	2	5	0	0	5	0	0
4	73473128	.	T	C	3	3	6	0	0	6	0	0
4	73473169	.	G	C	1	3	4	0	0	4	0	0
4	73499046	.	T	C	2	8	10	0	2	12	0	0
4	73499279	.	T	C	4	4	8	0	0	8	0	0
4	73499433	.	G	A	0	4	4	0	0	4	0	0
4	73499468	.	G	T	0	4	4	0	0	4	0	0
4	73499476	.	C	G	0	4	4	0	0	4	0	0
4	73499772	.	G	C	1	2	3	0	0	3	0	0
4	73519433	.	A	G	0	2	2	0	0	2	0	0
4	73542757	.	C	A	3	2	5	0	0	5	0	0
4	73542786	.	G	A	1	2	3	0	0	3	0	0
4	73542830	.	C	T	2	2	4	0	1	5	0	0
4	73542845	.	G	A	4	2	6	0	0	6	0	0
4	73550610	.	A	T	6	3	9	0	1	10	0	0
4	73564276	.	C	T	1	2	3	0	0	3	0	0
4	73574374	.	G	A	0	4	4	0	0	4	0	0
4	73575576	.	G	T	1	2	3	0	0	3	0	0
4	73897449	.	T	C	1	2	3	0	0	3	0	0
4	73899370	.	G	A	3	2	5	0	0	5	0	0
4	73899670	.	A	C	1	3	4	0	0	4	0	0
4	74204687	.	A	G	2	2	4	0	1	5	0	0
4	74204715	.	A	G	1	3	4	0	0	4	0	0
4	74204735	.	A	G	3	2	5	0	0	5	0	0
4	74875829	.	A	G	1	0	1	0	0	1	0	0
4	74943202	.	A	T	5	5	10	0	1	11	0	0
4	74952477	.	G	A	10	7	17	0	2	19	0	0
4	74952660	.	G	T	1	9	10	0	7	17	0	0
4	74960826	.	C	T	12	15	27	0	2	29	0	0
4	74961007	.	C	T	9	4	13	0	0	13	0	0
4	74961011	.	C	T	9	2	11	0	1	12	0	0
4	74961075	.	G	A	7	17	24	0	0	24	0	0
4	74961520	.	T	A	8	9	17	0	1	18	0	0
4	75138707	.	G	A	1	7	8	0	0	8	0	0
4	75138750	.	A	G	5	3	8	0	3	11	0	0
4	75138792	.	G	A	9	3	12	0	3	15	0	0
4	75139194	.	C	T	15	8	23	0	3	26	0	0
4	75142239	.	C	T	8	8	16	0	2	18	0	0
4	75142269	.	G	A	5	8	13	0	0	13	0	0
4	75149026	.	T	C	10	4	14	0	0	14	0	0
4	75149056	.	C	T	8	12	20	0	0	20	0	0
4	75149071	.	T	A	9	13	22	0	1	23	0	0
4	75149125	.	C	A	0	5	5	0	3	8	0	0
4	75149149	.	C	T	0	1	1	0	2	3	0	0
4	75150767	.	G	A	2	2	4	0	0	4	0	0
4	75153925	.	C	T	3	1	4	0	0	4	0	0
4	75154498	.	G	T	1	0	1	0	1	2	0	0
4	75416680	.	A	T	1	2	3	0	0	3	0	0
4	75417632	.	C	T	3	3	6	0	0	6	0	0
4	75417643	.	T	C	3	3	6	0	0	6	0	0
4	75419353	.	C	T	7	1	8	0	0	8	0	0
4	75419387	.	C	T	4	2	6	0	0	6	0	0
4	75419421	.	G	T	3	2	5	0	2	7	0	0
4	75419428	.	C	T	3	2	5	0	1	6	0	0
4	75419528	.	G	C	0	3	3	0	3	6	0	0
4	75419551	.	G	C	1	3	4	0	1	5	0	0
4	75419683	.	G	T	0	2	2	0	5	7	0	0
4	75419819	.	C	G	5	10	15	0	1	16	0	0
4	75419822	.	A	C	6	10	16	0	0	16	0	0
4	75419916	.	G	T	8	9	17	0	0	17	0	0
4	75419961	.	A	C	5	5	10	0	2	12	0	0
4	75419970	.	G	A	0	6	6	0	6	12	0	0
4	75420186	.	A	G	3	0	3	0	4	7	0	0
4	75420194	.	T	C	3	3	6	0	0	6	0	0
4	75420264	.	C	A	8	4	12	0	0	12	0	0
4	75420270	.	A	G	9	4	13	0	0	13	0	0
4	75420647	.	A	T	1	2	3	0	0	3	0	0
4	75420754	.	T	A	4	6	10	0	0	10	0	0
4	75420873	.	A	C	2	11	13	0	2	15	0	0
4	75420931	.	A	G	1	9	10	0	0	10	0	0
4	76320752	.	G	A	2	1	3	0	0	3	0	0
4	76320798	.	C	G	0	1	1	0	1	2	0	0
4	76322771	.	T	C	4	2	6	0	1	7	0	0
4	76322882	.	G	A	0	5	5	0	1	6	0	0
4	76336471	.	A	C	0	1	1	0	0	1	0	0
4	76345689	.	C	T	5	3	8	0	0	8	0	0
4	76345923	.	A	G	1	0	1	0	5	6	0	0
4	76345974	.	A	G	3	5	8	0	0	8	0	0
4	76346004	.	T	C	2	2	4	0	1	5	0	0
4	76346011	.	T	C	2	3	5	0	0	5	0	0
4	76346238	.	C	A	5	3	8	0	0	8	0	0
4	76346564	.	C	T	2	2	4	0	0	4	0	0
4	76347080	.	A	G	3	3	6	0	1	7	0	0
4	76347126	.	T	C	4	6	10	0	1	11	0	0
4	76347163	.	A	G	1	5	6	0	1	7	0	0
4	76347206	.	A	G	2	3	5	0	0	5	0	0
4	76347225	.	A	G	1	0	1	0	3	4	0	0
4	76347508	.	T	G	6	5	11	0	1	12	0	0
4	76347977	.	A	T	0	2	2	0	1	3	0	0
4	76359636	.	C	T	4	3	7	0	0	7	0	0
4	76359666	.	C	T	4	2	6	0	0	6	0	0
4	76359969	.	C	T	2	3	5	0	0	5	0	0
4	76359993	.	C	T	2	2	4	0	0	4	0	0
4	76360446	.	T	C	1	3	4	0	0	4	0	0
4	76360500	.	T	A	1	1	2	0	1	3	0	0
4	76361212	.	C	A	1	2	3	0	0	3	0	0
4	76361229	.	T	C	1	3	4	0	0	4	0	0
4	76361286	.	T	C	2	2	4	0	0	4	0	0
4	76361624	.	T	A	4	3	7	0	0	7	0	0
4	76361627	.	G	A	0	2	2	0	5	7	0	0
4	76363195	.	C	T	0	2	2	0	0	2	0	0
4	76363204	.	A	C	0	2	2	0	0	2	0	0
4	76364359	.	T	A	2	3	5	0	0	5	0	0
4	76378482	.	G	A	2	2	4	0	0	4	0	0
4	76378489	.	T	G	2	1	3	0	1	4	0	0
4	76409300	.	A	G	1	2	3	0	0	3	0	0
4	76409494	.	A	C	2	3	5	0	0	5	0	0
4	76411505	.	C	T	1	2	3	0	0	3	0	0
4	76411517	.	T	C	2	2	4	0	0	4	0	0
4	76411547	.	G	A	1	1	2	0	1	3	0	0
4	76411757	.	A	T	1	2	3	0	0	3	0	0
4	76411759	.	A	T	0	2	2	0	1	3	0	0
4	76412625	.	C	A	2	2	4	0	0	4	0	0
4	76412884	.	G	T	10	1	11	1	0	12	0	0
4	76412887	.	G	A	8	2	10	1	1	12	0	0
4	76421958	.	C	T	2	3	5	0	1	6	0	0
4	76421987	.	G	T	0	3	3	0	0	3	0	0
4	76422057	.	T	A	1	4	5	0	0	5	0	0
4	76422084	.	A	G	5	2	7	0	1	8	0	0
4	76423177	.	A	G	3	2	5	0	1	6	0	0
4	76423190	.	A	G	0	2	2	0	0	5	3	0
4	76423418	.	A	G	4	2	6	0	0	6	0	0
4	76423450	.	G	A	3	2	5	0	0	5	0	0
4	76423462	.	A	G	1	0	1	0	5	6	0	0
4	76429969	.	G	A	2	5	7	0	0	7	0	0
4	76430115	.	G	A	2	2	4	0	0	4	0	0
4	76430256	.	G	A	0	4	4	0	0	4	0	0
4	76430257	.	A	G	0	4	4	0	0	4	0	0
4	76437342	.	G	T	0	2	2	0	1	3	0	0
4	76437869	.	A	G	1	6	7	0	0	7	0	0
4	76437999	.	A	T	4	3	7	0	0	7	0	0
4	76438012	.	A	T	4	2	6	0	0	6	0	0
4	76439149	.	C	T	2	6	8	0	0	8	0	0
4	76439467	.	C	A	6	5	11	0	0	11	0	0
4	76439792	.	A	T	1	3	4	0	0	4	0	0
4	76464859	.	G	C	2	1	3	0	0	3	0	0
4	76465329	.	T	C	0	9	9	0	0	9	0	0
4	76480573	.	T	C	2	2	4	0	1	5	0	0
4	76480694	.	C	A	1	2	3	0	0	3	0	0
4	76480915	.	T	A	1	1	2	0	0	2	0	0
4	76480916	.	T	A	1	1	2	0	0	2	0	0
4	76481177	.	T	C	3	0	3	0	9	12	0	0
4	76481403	.	T	A	4	16	20	0	1	21	0	0
4	76481572	.	G	A	4	7	11	0	0	11	0	0
4	76481576	.	C	A	6	5	11	0	0	11	0	0
4	76481665	.	A	T	4	4	8	0	0	8	0	0
4	76481746	.	A	C	1	4	5	0	0	5	0	0
4	76482075	.	G	T	2	2	4	0	1	5	0	0
4	76482137	.	C	T	1	2	3	0	0	3	0	0
4	76482245	.	C	T	2	0	2	0	0	2	0	0
4	76482273	.	C	G	1	0	1	0	0	1	0	0
4	76488269	.	G	T	2	2	4	0	0	4	0	0
4	76488617	.	G	A	4	2	6	0	0	6	0	0
4	76488820	.	G	A	1	4	5	0	0	5	0	0
4	76582696	.	G	A	0	2	2	0	0	2	0	0
4	76587474	.	C	T	0	2	2	0	0	2	0	0
4	76588133	.	A	C	2	3	5	0	0	5	0	0
4	76588134	.	C	G	2	0	2	0	3	5	0	0
4	76588177	.	T	C	2	4	6	0	2	8	0	0
4	76588256	.	G	C	7	4	11	0	3	14	0	0
4	76588295	.	G	T	6	6	12	0	0	12	0	0
4	76866993	.	A	G	4	2	6	0	0	6	0	0
4	76867743	.	T	C	5	11	16	1	2	19	0	0
4	76867829	.	C	G	4	3	7	0	0	7	0	0
4	77057695	.	C	G	2	0	2	0	2	4	0	0
4	77058024	.	G	A	3	4	7	0	0	7	0	0
4	77058097	.	T	C	2	10	12	0	1	13	0	0
4	77058108	.	A	G	3	8	11	0	0	11	0	0
4	77058162	.	G	A	2	3	5	0	0	5	0	0
4	77058167	.	A	T	2	1	3	0	0	3	0	0
4	77058420	.	C	G	1	5	6	0	0	6	0	0
4	77058436	.	A	T	1	4	5	0	0	5	0	0
4	77058503	.	G	C	3	3	6	0	0	6	0	0
4	77058543	.	G	A	0	3	3	0	1	4	0	0
4	77058603	.	A	T	3	2	5	0	0	5	0	0
4	77058604	.	A	G	2	2	4	0	1	5	0	0
4	77058723	.	A	G	5	3	8	0	0	8	0	0
4	77058875	.	T	A	2	3	5	0	0	5	0	0
4	77059969	.	C	T	6	2	8	0	0	8	0	0
4	77064830	.	G	A	1	2	3	0	0	3	0	0
4	77065265	.	G	A	2	2	4	0	2	6	0	0
4	77065304	.	A	T	2	2	4	0	0	4	0	0
4	77065342	.	A	T	5	2	7	0	0	7	0	0
4	77065582	.	A	C	1	2	3	0	0	3	0	0
4	77148695	.	G	T	5	0	5	0	0	5	0	0
4	77148706	.	G	C	4	0	4	0	0	4	0	0
4	77149576	.	G	A	0	2	2	0	1	3	0	0
4	77149729	.	G	A	1	4	5	0	0	5	0	0
4	77149805	.	A	T	2	3	5	0	1	6	0	0
4	77149888	.	C	T	8	3	11	0	0	11	0	0
4	77207768	.	G	C	4	4	8	0	0	8	0	0
4	77207903	.	C	T	0	3	3	0	0	3	0	0
4	77211866	.	G	A	0	2	2	0	1	3	0	0
4	77211872	.	G	A	2	3	5	0	0	5	0	0
4	77212090	.	T	A	5	2	7	0	2	9	0	0
4	77229875	.	G	A	5	2	7	0	2	9	0	0
4	77230155	.	G	A	2	2	4	0	0	4	0	0
4	77233708	.	C	G	0	4	4	0	0	4	0	0
4	77233880	.	T	G	1	4	5	0	0	5	0	0
4	77250856	.	A	T	3	1	4	0	0	4	0	0
4	77250862	.	G	A	3	2	5	0	0	5	0	0
4	77251225	.	T	C	1	4	5	0	0	5	0	0
4	77251255	.	A	G	6	2	8	0	0	8	0	0
4	77251264	.	A	G	7	2	9	0	0	9	0	0
4	77254446	.	C	G	1	3	4	0	4	8	0	0
4	77262868	.	A	G	2	2	4	0	0	4	0	0
4	77270065	.	A	C	3	5	8	0	0	8	0	0
4	77270251	.	A	G	3	5	8	0	0	8	0	0
4	77270278	.	T	A	1	3	4	0	1	5	0	0
4	77270517	.	A	T	1	4	5	0	0	5	0	0
4	77270523	.	A	G	1	5	6	0	0	6	0	0
4	77270604	.	A	T	1	4	5	0	0	5	0	0
4	77270683	.	G	A	3	3	6	0	1	7	0	0
4	77270773	.	G	C	6	7	13	0	0	13	0	0
4	77271020	.	G	A	2	2	4	0	0	4	0	0
4	77271057	.	A	G	2	3	5	0	0	5	0	0
4	77271203	.	C	T	5	4	9	0	0	9	0	0
4	77271278	.	G	A	2	4	6	0	0	6	0	0
4	77271310	.	C	T	2	3	5	0	1	6	0	0
4	77271341	.	T	A	3	5	8	0	0	8	0	0
4	77271975	.	C	T	3	2	5	0	0	5	0	0
4	77271984	.	G	A	3	1	4	0	0	4	0	0
4	77272134	.	T	C	3	0	3	0	7	10	0	0
4	77272192	.	G	A	2	4	6	0	0	6	0	0
4	77272429	.	C	A	0	1	1	0	0	1	0	0
4	77273061	.	G	C	3	1	4	0	1	5	0	0
4	77273068	.	T	G	3	3	6	0	0	6	0	0
4	77389929	.	G	C	9	4	13	0	0	13	0	0
4	77389932	.	C	A	8	3	11	0	1	12	0	0
4	77928526	.	G	C	1	4	5	0	0	5	0	0
4	77931408	.	G	A	5	2	7	0	0	7	0	0
4	77932143	.	C	T	12	6	18	0	1	19	0	0
4	77932186	.	T	C	25	12	37	0	3	40	0	0
4	77932198	.	A	G	24	11	35	0	3	38	0	0
4	77932221	.	A	G	19	8	27	0	4	31	0	0
4	77932408	.	G	C	15	7	22	0	3	25	0	0
4	77932414	.	T	C	14	10	24	0	0	24	0	0
4	77932461	.	G	A	16	12	28	0	1	29	0	0
4	77932489	.	A	G	14	11	25	0	0	25	0	0
4	77943194	.	T	C	0	2	2	0	0	2	0	0
4	77948591	.	G	A	2	3	5	0	0	5	0	0
4	77953227	.	C	A	2	0	2	0	1	3	0	0
4	77953696	.	C	T	2	3	5	0	1	6	0	0
4	77953995	.	C	A	3	3	6	0	0	6	0	0
4	77957718	.	C	A	3	4	7	0	2	9	0	0
4	77959109	.	T	C	0	1	1	0	0	1	0	0
4	77960149	.	C	T	4	3	7	0	1	8	0	0
4	77965345	.	T	C	3	11	14	0	1	15	0	0
4	77965360	.	G	C	2	14	16	0	0	16	0	0
4	77967069	.	T	A	1	0	1	0	0	1	0	0
4	77967578	.	G	C	2	6	8	0	0	8	0	0
4	77968472	.	C	T	1	3	4	0	0	4	0	0
4	77971683	.	C	T	1	4	5	0	0	5	0	0
4	77973947	.	G	A	2	3	5	0	0	5	0	0
4	77974587	.	C	G	1	3	4	0	0	4	0	0
4	77976001	.	C	T	0	2	2	0	1	3	0	0
4	77979375	.	G	A	1	2	3	0	0	3	0	0
4	77981599	.	C	T	2	3	5	0	0	5	0	0
4	77981644	.	G	A	4	2	6	0	2	8	0	0
4	77981663	.	G	A	0	3	3	0	5	8	0	0
4	77993210	.	G	A	1	0	1	0	1	2	0	0
4	77993555	.	G	T	4	5	9	0	0	9	0	0
4	77993574	.	C	A	2	2	4	0	2	6	0	0
4	77993916	.	G	A	8	9	17	0	1	18	0	0
4	77995494	.	C	G	8	2	10	0	0	10	0	0
4	77995677	.	C	A	2	3	5	0	1	6	0	0
4	77995988	.	A	C	5	1	6	0	3	9	0	0
4	77995990	.	C	G	3	5	8	0	1	9	0	0
4	77996032	.	C	A	0	1	1	0	0	1	0	0
4	77996171	.	C	T	0	1	1	0	0	1	0	0
4	78022662	.	C	A	0	11	11	0	17	28	0	0
4	78024265	.	G	A	19	18	37	0	6	43	0	0
4	78024322	.	C	T	0	8	8	0	15	23	0	0
4	78024558	.	C	T	1	13	14	0	12	26	0	0
4	78025223	.	C	T	0	11	11	0	13	24	0	0
4	78025241	.	A	G	14	20	34	0	1	35	0	0
4	78025434	.	T	A	0	1	1	0	1	2	0	0
5	318077	.	G	A	1	0	1	0	0	1	0	0
5	318125	.	C	T	1	0	1	0	0	1	0	0
5	894613	.	C	T	1	0	1	0	0	1	0	0
5	895581	.	T	C	0	1	1	0	0	1	0	0
5	896908	.	C	A	2	4	6	0	0	6	0	0
5	899952	.	C	T	3	1	4	0	0	4	0	0
5	905263	.	C	A	2	3	5	0	0	5	0	0
5	917336	.	C	T	0	2	2	0	0	2	0	0
5	1055103	.	C	T	1	1	2	0	0	2	0	0
5	1059697	.	T	C	0	3	3	0	0	3	0	0
5	1068116	.	T	A	7	6	13	0	0	13	0	0
5	1073609	.	G	A	4	3	7	0	0	7	0	0
5	1079480	.	C	T	11	8	19	0	0	19	0	0
5	1083203	.	G	C	3	5	8	0	0	8	0	0
5	1083679	.	G	A	0	6	6	0	4	10	0	0
5	1083894	.	T	G	6	0	6	0	10	16	0	0
5	1152013	.	G	C	2	3	5	0	0	5	0	0
5	1155594	.	G	A	3	2	5	0	0	5	0	0
5	1159612	.	G	A	0	1	1	0	0	1	0	0
5	1216494	.	A	G	2	4	6	0	0	6	0	0
5	1216536	.	C	T	0	7	7	0	3	10	0	0
5	1216575	.	G	A	3	1	4	0	0	4	0	0
5	1218781	.	G	A	0	1	1	0	0	1	0	0
5	1219232	.	G	A	7	2	9	0	1	10	0	0
5	1219263	.	C	T	15	8	23	0	0	23	0	0
5	1219381	.	G	A	8	5	13	0	0	13	0	0
5	1223368	.	A	T	13	12	25	0	4	29	0	0
5	1223369	.	C	T	17	12	29	0	0	29	0	0
5	1223460	.	G	A	9	8	17	0	1	18	0	0
5	1240403	.	C	A	0	2	2	0	1	3	0	0
5	1240517	.	T	C	1	1	2	0	0	2	0	0
5	1240534	.	G	A	1	2	3	0	0	3	0	0
5	1240589	.	C	T	0	2	2	0	0	2	0	0
5	1317871	.	T	C	2	2	4	0	0	4	0	0
5	1317883	.	G	A	2	0	2	0	0	2	0	0
5	1420729	.	A	G	10	4	14	0	1	15	0	0
5	1445964	.	G	A	2	4	6	0	0	6	0	0
5	1519571	.	G	C	1	4	5	0	0	5	0	0
5	1519574	.	T	A	1	2	3	0	1	4	0	0
5	2068299	.	C	A	5	1	6	1	1	8	0	0
5	2068844	.	G	T	2	2	4	0	0	4	0	0
5	2658348	.	G	A	1	2	3	0	0	3	0	0
5	2686225	.	G	C	5	2	7	0	0	7	0	0
5	2709533	.	A	G	1	7	8	0	1	9	0	0
5	2709561	.	T	C	2	2	4	0	0	4	0	0
5	2713967	.	A	G	21	23	44	0	2	46	0	0
5	2714042	.	C	T	30	14	44	0	3	47	0	0
5	2714135	.	C	T	22	28	50	0	2	52	0	0
5	2714237	.	G	A	27	29	56	0	2	58	0	0
5	2714495	.	G	A	27	17	44	0	4	48	0	0
5	2714507	.	A	G	26	22	48	0	3	51	0	0
5	2716930	.	G	A	6	7	13	0	1	14	0	0
5	2716963	.	G	A	12	9	21	0	0	21	0	0
5	2717014	.	G	A	13	12	25	0	1	26	0	0
5	2717022	.	G	A	13	10	23	0	2	25	0	0
5	2717260	.	T	C	2	1	3	0	0	3	0	0
5	2717611	.	C	T	3	3	6	0	0	6	0	0
5	2717623	.	A	G	1	2	3	0	0	3	0	0
5	2717960	.	A	G	1	4	5	0	0	5	0	0
5	2718696	.	A	G	3	5	8	0	0	8	0	0
5	2718834	.	G	A	0	2	2	0	0	2	0	0
5	2720119	.	A	G	1	2	3	0	0	3	0	0
5	2721588	.	C	T	1	0	1	0	0	1	0	0
5	2742784	.	A	G	4	3	7	0	0	7	0	0
5	2744938	.	C	T	1	3	4	0	0	4	0	0
5	2744962	.	C	G	1	3	4	0	1	5	0	0
5	2745220	.	G	T	0	0	0	0	1	1	0	0
5	2750087	.	G	A	4	3	7	0	0	7	0	0
5	2750127	.	G	A	3	2	5	0	0	5	0	0
5	3545205	.	A	T	27	0	27	0	3	30	0	0
5	6717505	.	C	T	2	2	4	0	0	4	0	0
5	6717757	.	C	A	1	4	5	0	0	5	0	0
5	6717804	.	T	C	1	3	4	0	0	4	0	0
5	6717809	.	G	A	1	4	5	0	0	5	0	0
5	6726416	.	T	C	4	3	7	0	0	7	0	0
5	6726864	.	A	C	2	0	2	0	0	2	0	0
5	6839136	.	A	C	1	0	1	0	0	1	0	0
5	6858380	.	C	A	4	8	12	0	0	12	0	0
5	6858389	.	T	A	2	9	11	0	1	12	0	0
5	6858540	.	T	A	16	9	25	0	0	25	0	0
5	6858779	.	G	T	0	6	6	0	7	13	0	0
5	6863577	.	C	T	6	3	9	0	0	9	0	0
5	6863647	.	C	T	16	10	26	0	9	35	0	0
5	6863768	.	G	C	8	14	22	0	1	23	0	0
5	6863793	.	G	A	18	6	24	0	0	24	0	0
5	6863834	.	A	G	5	0	5	0	7	12	0	0
5	6863855	.	G	A	10	3	13	0	0	13	0	0
5	6864010	.	C	T	3	3	6	0	1	7	0	0
5	6881773	.	C	T	2	1	3	0	0	3	0	0
5	6956504	.	A	T	1	2	3	0	0	3	0	0
5	6956547	.	C	G	1	2	3	0	0	3	0	0
5	7498844	.	C	A	0	1	1	0	0	1	0	0
5	7499034	.	G	A	1	1	2	0	0	2	0	0
5	7499037	.	G	A	1	1	2	0	0	2	0	0
5	8006206	.	A	G	6	6	12	0	0	12	0	0
5	8006474	.	A	G	4	1	5	0	6	11	0	0
5	8006503	.	A	G	7	4	11	0	2	13	0	0
5	8006977	.	A	G	7	6	13	0	2	15	0	0
5	8015099	.	C	T	0	3	3	0	4	7	0	0
5	8015165	.	G	A	5	5	10	0	0	10	0	0
5	8015192	.	C	T	0	7	7	0	4	11	0	0
5	8015252	.	C	T	1	5	6	0	1	7	0	0
5	8015361	.	G	T	6	13	19	0	0	19	0	0
5	8019962	.	A	G	7	2	9	0	1	10	0	0
5	8020001	.	C	T	2	2	4	0	0	4	0	0
5	8033036	.	A	G	1	2	3	0	0	3	0	0
5	8043891	.	C	T	0	3	3	0	0	3	0	0
5	9443145	.	C	T	0	2	2	1	0	3	0	0
5	9443250	.	T	C	1	7	8	0	0	8	0	0
5	9443251	.	T	C	2	6	8	0	0	8	0	0
5	10084310	.	C	T	5	3	8	0	0	8	0	0
5	10766286	.	G	A	4	10	14	0	2	16	0	0
5	10766505	.	A	G	11	13	24	0	3	27	0	0
5	10766529	.	G	A	14	11	25	0	2	27	0	0
5	10766879	.	A	G	16	12	28	0	1	29	0	0
5	10767113	.	C	T	10	7	17	0	4	21	0	0
5	10767259	.	A	G	19	21	40	0	1	41	0	0
5	10767456	.	G	A	4	4	8	0	0	8	0	0
5	10768089	.	G	A	4	3	7	0	0	7	0	0
5	10768182	.	G	A	5	6	11	0	0	11	0	0
5	11507602	.	A	G	1	1	2	0	0	2	0	0
5	11812278	.	C	T	0	2	2	0	0	2	0	0
5	11818849	.	G	A	1	1	2	0	0	2	0	0
5	11818876	.	A	C	1	0	1	0	0	1	0	0
5	11824059	.	G	A	0	1	1	0	1	2	0	0
5	11826347	.	T	C	3	1	4	0	0	4	0	0
5	11864593	.	A	G	1	3	4	0	0	4	0	0
5	11864774	.	T	G	4	10	14	0	2	16	0	0
5	11869576	.	C	A	0	4	4	0	2	6	0	0
5	11905086	.	A	T	1	2	3	0	0	3	0	0
5	11905725	.	C	T	2	2	4	0	1	5	0	0
5	11905890	.	A	G	6	4	10	0	0	10	0	0
5	11905903	.	T	G	2	5	7	0	0	7	0	0
5	11917125	.	C	T	5	6	11	0	0	11	0	0
5	11917405	.	G	A	8	5	13	0	1	14	0	0
5	11917436	.	G	A	4	11	15	0	0	15	0	0
5	11917485	.	G	A	12	3	15	0	1	16	0	0
5	11917596	.	C	A	0	10	10	0	11	21	0	0
5	11933155	.	A	G	6	3	9	0	1	10	0	0
5	11935444	.	G	A	1	2	3	0	0	3	0	0
5	11943868	.	G	A	1	6	7	0	0	7	0	0
5	11943934	.	C	A	2	2	4	0	1	5	0	0
5	11943948	.	T	A	2	2	4	0	1	5	0	0
5	11949244	.	G	T	2	10	12	0	0	12	0	0
5	11959776	.	G	T	0	12	12	0	12	24	0	0
5	11959777	.	C	T	11	12	23	0	1	24	0	0
5	11959818	.	C	T	11	15	26	0	2	28	0	0
5	11959966	.	C	G	12	9	21	0	0	21	0	0
5	11959988	.	G	A	0	11	11	0	8	19	0	0
5	11982950	.	C	A	6	3	9	0	1	10	0	0
5	11983017	.	T	C	2	3	5	0	0	5	0	0
5	11983395	.	T	A	1	2	3	0	0	3	0	0
5	11983548	.	C	G	5	8	13	0	0	13	0	0
5	11984086	.	T	C	4	3	7	0	0	7	0	0
5	11984133	.	C	T	3	4	7	0	0	7	0	0
5	11985133	.	A	T	1	2	3	0	0	3	0	0
5	12033007	.	T	A	1	2	3	0	0	3	0	0
5	12044743	.	A	G	2	2	4	0	0	4	0	0
5	12100209	.	A	T	1	2	3	0	0	3	0	0
5	12100335	.	G	A	2	2	4	0	0	4	0	0
5	12284075	.	C	T	22	15	37	0	1	38	0	0
5	12285504	.	C	A	0	3	3	0	1	4	0	0
5	12288511	.	T	C	1	6	7	0	2	9	0	0
5	12288541	.	A	G	2	3	5	0	0	5	0	0
5	12297084	.	C	T	0	2	2	0	0	2	0	0
5	12322321	.	G	A	2	1	3	0	0	3	0	0
5	12357554	.	C	T	2	0	2	0	0	2	0	0
5	12524938	.	A	G	3	0	3	0	1	4	0	0
5	12530423	.	G	T	1	0	1	0	0	1	0	0
5	12530425	.	C	A	0	0	0	0	1	1	0	0
5	12549258	.	C	T	10	4	14	0	1	15	0	0
5	12549807	.	A	G	5	2	7	0	0	7	0	0
5	12554073	.	G	A	1	0	1	0	0	1	0	0
5	12724121	.	C	T	15	5	20	0	0	20	0	0
5	12724224	.	G	A	11	12	23	0	1	24	0	0
5	12724249	.	A	C	7	7	14	0	0	15	1	0
5	12724292	.	C	A	6	1	7	0	0	7	0	0
5	12724307	.	A	G	4	6	10	2	0	12	0	0
5	12724412	.	A	G	2	1	3	0	0	3	0	0
5	12724450	.	C	T	0	4	4	0	3	7	0	0
5	12724505	.	C	A	7	12	19	0	1	20	0	0
5	12724518	.	G	C	11	0	11	0	12	23	0	0
5	12724567	.	A	G	17	12	29	0	2	31	0	0
5	12724694	.	C	T	0	8	8	0	18	26	0	0
5	12725930	.	G	A	2	1	3	0	1	4	0	0
5	12726842	.	A	G	3	1	4	0	0	4	0	0
5	12729397	.	C	T	2	0	2	0	0	2	0	0
5	12734910	.	T	C	0	4	4	0	0	4	0	0
5	12837064	.	G	A	2	1	3	0	1	4	0	0
5	12859258	.	T	C	8	8	16	0	1	17	0	0
5	12865072	.	G	A	2	8	10	0	0	10	0	0
5	12906273	.	C	T	1	3	4	0	0	4	0	0
5	12956918	.	T	C	1	2	3	0	0	3	0	0
5	12956960	.	C	T	2	1	3	0	0	3	0	0
5	12975532	.	C	T	3	0	3	0	0	3	0	0
5	12979889	.	C	T	5	3	8	0	0	8	0	0
5	13037199	.	C	T	0	4	4	0	4	8	0	0
5	13037203	.	C	T	0	4	4	0	5	9	0	0
5	13037939	.	T	G	1	3	4	0	1	5	0	0
5	13037967	.	G	A	1	5	6	0	1	7	0	0
5	13037998	.	A	G	1	5	6	0	1	7	0	0
5	13105020	.	C	T	11	10	21	0	4	25	0	0
5	13105070	.	C	A	0	21	21	0	13	34	0	0
5	13112979	.	G	A	1	1	2	0	0	2	0	0
5	13167048	.	A	T	2	3	5	0	0	5	0	0
5	13214637	.	C	G	6	6	12	0	0	12	0	0
5	13214802	.	C	G	1	2	3	0	1	4	0	0
5	13223062	.	G	A	1	1	2	0	0	2	0	0
5	13308959	.	G	A	1	5	6	0	1	7	0	0
5	13308985	.	T	C	1	5	6	0	1	7	0	0
5	13308997	.	G	T	2	6	8	0	0	8	0	0
5	13309215	.	C	T	7	13	20	0	0	20	0	0
5	13309273	.	C	T	14	11	25	0	1	26	0	0
5	13309309	.	G	A	11	10	21	0	1	22	0	0
5	13309402	.	A	G	8	14	22	0	2	24	0	0
5	13309435	.	A	T	12	15	27	0	0	27	0	0
5	13309522	.	G	A	11	8	19	0	0	19	0	0
5	13312671	.	A	T	1	2	3	0	0	3	0	0
5	13312746	.	G	A	6	16	22	0	0	22	0	0
5	13315490	.	G	C	4	4	8	0	0	8	0	0
5	13315526	.	T	C	6	6	12	0	1	13	0	0
5	13332930	.	A	G	2	2	4	0	0	4	0	0
5	13335333	.	G	A	1	2	3	0	0	3	0	0
5	13335373	.	G	T	0	2	2	0	1	3	0	0
5	13335423	.	C	T	3	3	6	0	0	6	0	0
5	13337803	.	C	T	9	15	24	0	5	29	0	0
5	13337883	.	T	A	17	27	44	0	3	47	0	0
5	13338441	.	C	T	0	21	21	0	19	40	0	0
5	13338762	.	A	T	12	18	30	0	0	30	0	0
5	13339038	.	G	C	17	12	29	0	15	44	0	0
5	13415128	.	A	T	2	0	2	0	0	2	0	0
5	13415131	.	A	G	2	0	2	0	0	2	0	0
5	13418084	.	C	A	0	1	1	0	0	1	0	0
5	13418096	.	T	C	0	1	1	0	0	1	0	0
5	13465095	.	T	C	1	2	3	0	0	3	0	0
5	13468172	.	C	T	4	5	9	0	0	9	0	0
5	13469105	.	T	A	5	4	9	0	1	10	0	0
5	13469137	.	C	A	5	5	10	0	0	10	0	0
5	13539403	.	A	G	1	0	1	0	2	3	0	0
5	13540689	.	C	T	5	2	7	0	0	7	0	0
5	13540738	.	C	T	1	3	4	0	0	4	0	0
5	13540846	.	T	A	4	3	7	0	0	7	0	0
5	13643325	.	G	A	23	11	34	0	1	35	0	0
5	13643411	.	C	T	2	28	30	0	17	47	0	0
5	13643824	.	G	A	13	9	22	0	0	22	0	0
5	13644126	.	A	T	18	19	37	0	0	37	0	0
5	13644185	.	T	G	13	14	27	0	0	27	0	0
5	13644189	.	T	G	14	11	25	0	4	29	0	0
5	13644227	.	A	G	8	12	20	0	2	22	0	0
5	13644256	.	A	T	9	5	14	0	3	17	0	0
5	13644581	.	T	G	13	20	33	0	7	40	0	0
5	13644602	.	T	A	19	16	35	0	2	37	0	0
5	13644797	.	A	G	4	12	16	0	0	16	0	0
5	13645047	.	C	G	11	14	25	0	1	26	0	0
5	13645746	.	A	G	11	15	26	0	1	27	0	0
5	13645885	.	T	C	9	8	17	0	1	18	0	0
5	13649518	.	C	T	8	4	12	0	0	12	0	0
5	13652410	.	T	C	9	21	30	0	4	34	0	0
5	13671624	.	G	T	3	5	8	0	2	10	0	0
5	13671899	.	C	G	6	12	18	0	1	20	1	0
5	13672004	.	C	T	1	15	16	0	20	36	0	0
5	13672211	.	C	T	13	12	25	0	1	26	0	0
5	13672232	.	C	T	11	12	23	0	3	26	0	0
5	13673016	.	C	G	1	4	5	0	3	8	0	0
5	13684132	.	A	G	15	9	24	0	2	26	0	0
5	13684502	.	C	A	3	11	14	0	13	27	0	0
5	14309520	.	T	A	4	2	6	0	0	6	0	0
5	14323165	.	T	C	1	2	3	0	0	3	0	0
5	14477551	.	T	C	1	2	3	0	0	3	0	0
5	14477555	.	T	C	1	2	3	0	0	3	0	0
5	15356919	.	A	G	6	0	6	0	22	28	0	0
5	15356934	.	A	G	15	16	31	0	0	31	0	0
5	15357517	.	A	G	3	4	7	0	0	7	0	0
5	18935168	.	A	G	6	5	11	0	2	13	0	0
5	18935182	.	A	G	3	8	11	0	0	11	0	0
5	19008334	.	A	G	19	4	23	0	20	43	0	0
5	19437773	.	T	C	3	4	7	0	0	7	0	0
5	19851321	.	G	A	1	2	3	0	0	3	0	0
5	20787190	.	T	C	4	13	17	0	0	17	0	0
5	20787270	.	T	C	1	3	4	0	0	4	0	0
5	22012345	.	T	C	5	7	12	0	1	13	0	0
5	22012459	.	T	C	4	11	15	0	0	15	0	0
5	22489369	.	A	G	1	7	8	0	1	9	0	0
5	22683732	.	G	T	0	30	30	0	5	35	0	0
5	23132256	.	G	T	3	2	5	0	0	5	0	0
5	23397221	.	T	C	1	2	3	0	0	3	0	0
5	23574618	.	T	A	5	2	7	0	0	7	0	0
5	23574916	.	T	C	1	9	10	0	0	10	0	0
5	23575646	.	T	C	2	6	8	0	0	8	0	0
5	24163098	.	A	G	1	2	3	0	2	5	0	0
5	24163289	.	A	G	1	6	7	0	1	8	0	0
5	24818523	.	T	C	6	6	12	0	0	12	0	0
5	24818529	.	T	C	8	4	12	0	0	12	0	0
5	24818564	.	T	C	5	8	13	0	0	13	0	0
5	26062582	.	A	G	4	3	7	0	0	7	0	0
5	26263194	.	C	T	12	3	15	0	1	16	0	0
5	28789611	.	C	T	1	2	3	0	1	4	0	0
5	30606225	.	A	G	1	3	4	0	0	4	0	0
5	33329786	.	A	G	8	9	17	0	0	17	0	0
5	35124479	.	C	T	0	3	3	0	2	5	0	0
5	35124859	.	C	T	8	5	13	0	1	14	0	0
5	35124939	.	G	A	4	4	8	0	2	10	0	0
5	35125414	.	C	T	1	3	4	0	2	6	0	0
5	35125423	.	C	T	3	3	6	0	0	6	0	0
5	35125882	.	G	A	5	2	7	0	2	9	0	0
5	35125883	.	A	T	7	2	9	0	0	9	0	0
5	35129861	.	C	A	2	1	3	0	1	4	0	0
5	35137621	.	C	T	0	1	1	0	0	1	0	0
5	35202876	.	A	T	7	4	11	0	4	15	0	0
5	35202958	.	G	A	5	4	9	0	1	10	0	0
5	35202959	.	A	T	6	4	10	0	0	10	0	0
5	35203092	.	G	A	8	13	21	0	2	23	0	0
5	35203486	.	C	A	8	5	13	0	1	14	0	0
5	35203629	.	C	T	0	15	15	0	4	19	0	0
5	35204077	.	T	G	5	5	10	0	2	12	0	0
5	35204159	.	C	T	4	7	11	0	1	12	0	0
5	35204280	.	A	T	5	8	13	0	2	15	0	0
5	35204322	.	A	G	5	6	11	0	1	12	0	0
5	35204353	.	C	T	8	4	12	0	0	12	0	0
5	35204681	.	A	C	4	5	9	0	0	9	0	0
5	35204689	.	A	C	4	0	4	0	5	9	0	0
5	35204754	.	C	T	4	9	13	0	0	13	0	0
5	35205005	.	G	A	8	8	16	0	1	17	0	0
5	35207914	.	T	G	0	6	6	0	0	6	0	0
5	35271001	.	C	T	22	14	36	0	5	41	0	0
5	35271154	.	A	T	17	21	38	0	2	40	0	0
5	35271181	.	A	G	22	22	44	0	4	48	0	0
5	35271194	.	G	A	23	27	50	0	3	53	0	0
5	35271309	.	T	A	26	31	57	0	0	57	0	0
5	35271465	.	T	C	27	21	48	0	6	54	0	0
5	35271824	.	C	A	15	13	28	0	1	29	0	0
5	35272032	.	G	A	11	17	28	0	1	29	0	0
5	35272438	.	C	T	0	15	15	0	18	33	0	0
5	35272497	.	G	A	5	9	14	0	2	16	0	0
5	35272560	.	T	G	11	12	23	0	0	23	0	0
5	35273062	.	G	A	17	20	37	0	1	38	0	0
5	35273225	.	T	C	10	14	24	0	1	25	0	0
5	35273447	.	A	G	9	8	17	0	1	18	0	0
5	35273509	.	A	T	7	10	17	0	1	18	0	0
5	35273546	.	A	T	10	10	20	0	0	20	0	0
5	35273564	.	G	A	9	10	19	0	0	19	0	0
5	35273708	.	T	C	10	10	20	0	0	20	0	0
5	35273793	.	A	T	9	10	19	0	1	20	0	0
5	35273838	.	A	C	8	15	23	0	2	25	0	0
5	35273992	.	A	G	10	15	25	0	1	26	0	0
5	35274398	.	G	A	8	13	21	0	0	21	0	0
5	35275103	.	C	T	15	12	27	0	1	28	0	0
5	35275859	.	G	T	4	6	10	0	1	11	0	0
5	35276154	.	A	G	7	4	11	0	0	11	0	0
5	35276303	.	G	C	5	6	11	0	0	11	0	0
5	35276386	.	G	A	6	3	9	0	0	9	0	0
5	35276580	.	A	G	5	2	7	0	0	7	0	0
5	35276811	.	C	G	4	2	6	0	0	6	0	0
5	35277184	.	T	A	1	3	4	0	0	4	0	0
5	35277256	.	T	A	1	3	4	0	0	4	0	0
5	35277459	.	T	C	2	8	10	0	0	10	0	0
5	35277509	.	A	T	5	3	8	0	1	9	0	0
5	35278597	.	C	T	1	3	4	0	0	4	0	0
5	35278977	.	T	G	4	2	6	0	0	6	0	0
5	35279007	.	C	T	0	5	5	0	3	8	0	0
5	35279065	.	A	G	0	4	4	0	1	5	0	0
5	35279230	.	T	G	6	4	10	0	0	10	0	0
5	35279275	.	T	G	4	5	9	0	1	10	0	0
5	35422324	.	T	C	2	4	6	0	0	6	0	0
5	35422530	.	C	T	1	4	5	0	0	5	0	0
5	35431641	.	A	G	4	5	9	0	0	9	0	0
5	35431703	.	T	G	1	1	2	0	1	3	0	0
5	35454464	.	C	T	3	7	10	0	0	10	0	0
5	35486917	.	C	A	2	4	6	0	0	6	0	0
5	35486955	.	T	C	3	3	6	0	2	8	0	0
5	35487030	.	A	G	2	7	9	0	0	9	0	0
5	35487332	.	T	A	3	3	6	0	2	8	0	0
5	35487407	.	A	T	2	3	5	0	1	6	0	0
5	35487416	.	G	C	1	4	5	0	1	6	0	0
5	35487459	.	A	T	4	5	9	0	1	10	0	0
5	35487781	.	C	G	1	4	5	0	0	5	0	0
5	35487881	.	A	G	2	2	4	0	0	4	0	0
5	35682874	.	A	G	2	2	4	0	0	4	0	0
5	35683225	.	C	A	2	3	5	0	0	5	0	0
5	35683861	.	A	G	1	1	2	0	0	2	0	0
5	35748938	.	T	C	2	1	3	0	0	3	0	0
5	35751883	.	G	T	2	1	3	0	0	3	0	0
5	35751977	.	A	G	5	6	11	0	0	11	0	0
5	35754424	.	T	C	10	15	25	0	2	27	0	0
5	35754431	.	A	G	10	0	10	0	15	25	0	0
5	35754503	.	A	C	11	15	26	0	1	27	0	0
5	35754599	.	T	A	16	23	39	0	0	39	0	0
5	35754663	.	A	G	13	9	22	0	4	26	0	0
5	35955514	.	T	C	7	13	20	0	0	20	0	0
5	35967234	.	C	T	7	5	12	0	0	12	0	0
5	35967270	.	T	A	7	4	11	0	1	12	0	0
5	35967500	.	A	G	1	0	1	0	5	6	0	0
5	36271160	.	T	G	2	4	6	0	1	7	0	0
5	36296066	.	G	A	1	2	3	0	0	3	0	0
5	36296114	.	T	C	2	2	4	0	0	4	0	0
5	36416204	.	A	G	9	8	17	0	2	19	0	0
5	36416307	.	C	G	5	0	5	0	11	16	0	0
5	36416367	.	G	A	1	8	9	0	7	16	0	0
5	36416478	.	G	T	7	11	18	0	2	20	0	0
5	36416583	.	C	T	15	21	36	0	0	36	0	0
5	36421991	.	G	A	0	8	8	0	9	17	0	0
5	36530959	.	A	T	1	6	7	0	1	8	0	0
5	36536665	.	T	C	7	12	19	0	0	19	0	0
5	36536742	.	C	T	10	13	23	0	0	23	0	0
5	36536859	.	A	G	2	0	2	0	6	8	0	0
5	36536910	.	G	A	6	3	9	0	0	9	0	0
5	36537020	.	A	G	8	8	16	0	1	17	0	0
5	36537021	.	T	A	9	8	17	0	0	17	0	0
5	36537057	.	G	A	7	5	12	0	1	13	0	0
5	36537073	.	A	C	10	5	15	0	0	15	0	0
5	36537124	.	A	G	14	6	20	0	1	21	0	0
5	36537231	.	A	T	8	9	17	0	1	18	0	0
5	36537334	.	A	T	11	5	16	0	1	18	1	0
5	36537352	.	G	A	9	5	14	0	1	15	0	0
5	36537611	.	C	A	7	3	10	0	2	12	0	0
5	36537672	.	C	A	6	5	11	0	0	11	0	0
5	36558059	.	G	A	7	9	16	0	1	17	0	0
5	36558348	.	A	G	18	10	28	0	0	28	0	0
5	36558369	.	G	A	16	11	27	0	0	27	0	0
5	36558441	.	C	T	11	3	14	0	1	15	0	0
5	36563257	.	T	C	3	1	4	0	2	6	0	0
5	36570280	.	G	A	2	1	3	0	0	3	0	0
5	36585054	.	C	T	1	0	1	0	0	1	0	0
5	36586190	.	G	A	1	1	2	0	0	2	0	0
5	36586192	.	C	G	1	1	2	0	0	2	0	0
5	36595912	.	G	A	7	8	15	0	1	16	0	0
5	36596106	.	A	G	2	2	4	0	0	4	0	0
5	36596278	.	G	A	1	2	3	0	0	3	0	0
5	36596378	.	G	A	1	3	4	0	0	4	0	0
5	36596397	.	T	A	0	2	2	0	1	3	0	0
5	36596517	.	C	A	0	4	4	0	5	9	0	0
5	36609010	.	C	G	1	2	3	0	0	3	0	0
5	36609412	.	G	A	2	3	5	0	0	5	0	0
5	36609469	.	T	C	0	2	2	0	1	3	0	0
5	36624620	.	G	A	0	1	1	0	1	2	0	0
5	36650153	.	C	A	2	4	6	0	1	7	0	0
5	36650176	.	A	T	1	3	4	0	1	5	0	0
5	36653522	.	G	A	3	6	9	0	1	10	0	0
5	36654147	.	G	A	0	10	10	0	9	19	0	0
5	36665351	.	C	T	11	8	19	0	0	19	0	0
5	36668321	.	C	T	1	4	5	0	0	5	0	0
5	36673470	.	C	A	4	4	8	0	1	9	0	0
5	36673609	.	A	G	5	2	7	0	2	9	0	0
5	36673687	.	A	T	4	3	7	0	0	7	0	0
5	36673981	.	A	T	2	1	3	0	0	3	0	0
5	36674005	.	A	T	4	4	8	0	0	8	0	0
5	36674796	.	G	C	3	13	16	0	0	16	0	0
5	36674831	.	C	T	6	10	16	0	0	16	0	0
5	36730732	.	C	T	1	2	3	0	0	3	0	0
5	36732199	.	G	C	3	2	5	0	1	6	0	0
5	36732217	.	A	G	3	3	6	0	0	6	0	0
5	36739134	.	T	C	15	18	33	0	1	34	0	0
5	36739310	.	T	A	13	14	27	0	0	27	0	0
5	36739316	.	T	C	13	13	26	0	0	26	0	0
5	36739352	.	T	A	10	12	22	0	3	25	0	0
5	36739361	.	T	C	11	13	24	0	0	24	0	0
5	36832565	.	A	G	2	0	2	0	0	2	0	0
5	36834909	.	G	A	1	1	2	0	0	2	0	0
5	36834915	.	G	T	1	1	2	0	0	2	0	0
5	36851191	.	C	T	3	1	4	0	0	4	0	0
5	36852848	.	G	A	0	1	1	0	0	1	0	0
5	36853849	.	C	G	4	3	7	0	0	7	0	0
5	36854177	.	C	T	8	4	12	0	1	13	0	0
5	36854206	.	A	T	12	3	15	0	2	17	0	0
5	36895627	.	G	A	1	0	1	0	0	1	0	0
5	36898476	.	C	T	3	5	8	0	0	8	0	0
5	36898668	.	A	G	7	0	7	0	10	17	0	0
5	36901003	.	T	G	1	0	1	0	0	1	0	0
5	36902610	.	A	G	4	0	4	0	4	8	0	0
5	36902628	.	T	C	5	3	8	0	0	8	0	0
5	36907182	.	G	T	7	4	11	0	0	11	0	0
5	36908034	.	T	C	21	16	37	0	1	38	0	0
5	36916370	.	A	T	0	6	6	0	0	6	0	0
5	36924122	.	G	C	0	1	1	0	0	1	0	0
5	36945378	.	T	A	25	18	43	0	3	46	0	0
5	36945383	.	A	T	25	16	41	0	4	45	0	0
5	36945463	.	T	A	29	26	55	0	2	57	0	0
5	36945518	.	T	G	23	17	40	0	12	52	0	0
5	36945719	.	G	T	30	31	61	0	13	74	0	0
5	36945747	.	T	A	26	25	51	0	11	62	0	0
5	36945927	.	A	C	30	29	59	0	1	60	0	0
5	36945937	.	C	T	25	35	60	0	3	63	0	0
5	36946244	.	A	G	37	32	69	0	6	76	1	0
5	36946261	.	T	C	42	1	43	0	26	69	0	0
5	36946341	.	C	T	2	30	32	0	35	67	0	0
5	36996458	.	A	G	4	8	12	0	3	15	0	0
5	36997133	.	A	G	10	11	21	0	3	24	0	0
5	37032095	.	A	G	9	9	18	0	1	19	0	0
5	37032191	.	T	C	6	5	11	0	1	12	0	0
5	37032280	.	C	G	6	10	16	0	0	16	0	0
5	37032339	.	A	G	3	0	3	0	9	12	0	0
5	37032611	.	T	C	6	5	11	0	0	11	0	0
5	37032782	.	G	A	4	13	17	0	2	19	0	0
5	37032799	.	A	T	3	11	14	0	0	15	1	0
5	37032959	.	A	G	2	3	5	0	0	5	0	0
5	37034111	.	T	C	2	2	4	0	0	4	0	0
5	37036404	.	T	C	8	8	16	0	0	16	0	0
5	37036856	.	T	C	9	10	19	0	2	21	0	0
5	37036975	.	A	T	6	6	12	0	0	12	0	0
5	37037079	.	C	T	12	8	20	0	2	22	0	0
5	37037152	.	T	C	10	21	31	0	0	31	0	0
5	37037308	.	C	A	4	4	8	0	1	9	0	0
5	37037436	.	G	T	0	4	4	0	8	12	0	0
5	37037583	.	T	C	11	16	27	0	3	30	0	0
5	37037617	.	A	T	13	22	35	0	0	35	0	0
5	37037669	.	T	G	15	17	32	0	3	35	0	0
5	37037742	.	A	T	17	18	35	0	1	36	0	0
5	37038017	.	T	C	12	11	23	0	2	25	0	0
5	37038059	.	C	T	1	3	4	0	1	5	0	0
5	37065416	.	T	C	21	11	32	0	1	33	0	0
5	37065729	.	C	T	15	5	20	0	2	22	0	0
5	37277355	.	A	G	1	3	4	0	0	4	0	0
5	37277534	.	A	G	3	3	6	0	0	6	0	0
5	37286590	.	G	A	4	10	14	0	0	14	0	0
5	37293815	.	T	C	0	1	1	0	0	1	0	0
5	37293841	.	G	A	0	1	1	0	0	1	0	0
5	37295646	.	C	T	0	1	1	0	0	1	0	0
5	37296298	.	C	T	2	3	5	0	0	5	0	0
5	37301236	.	G	A	3	2	5	0	0	5	0	0
5	37301249	.	C	T	4	4	8	0	0	8	0	0
5	37301282	.	C	T	7	7	14	0	0	14	0	0
5	37301505	.	A	G	0	0	0	0	1	1	0	0
5	37301783	.	A	G	0	5	5	0	1	6	0	0
5	37304028	.	T	C	3	5	8	0	1	9	0	0
5	37304070	.	G	T	1	1	2	0	0	2	0	0
5	37307921	.	C	G	4	3	7	0	0	7	0	0
5	37309734	.	A	G	8	7	15	0	1	16	0	0
5	37309881	.	C	T	10	6	16	0	0	16	0	0
5	37331854	.	C	T	2	0	2	0	0	2	0	0
5	37333870	.	G	A	6	6	12	0	1	13	0	0
5	37413762	.	G	A	0	1	1	0	0	1	0	0
5	37439388	.	C	T	4	6	10	0	1	11	0	0
5	37439418	.	C	T	3	4	7	0	1	8	0	0
5	37439505	.	T	C	5	10	15	0	0	15	0	0
5	37439517	.	A	C	4	8	12	0	0	12	0	0
5	37439891	.	T	C	16	16	32	0	2	34	0	0
5	37507901	.	C	T	1	5	6	0	0	6	0	0
5	37508828	.	C	T	2	5	7	0	0	7	0	0
5	37508832	.	T	G	2	5	7	0	0	7	0	0
5	37509156	.	G	A	1	3	4	0	0	4	0	0
5	37509296	.	G	C	4	4	8	0	1	9	0	0
5	37509703	.	C	T	9	11	20	0	0	20	0	0
5	37509766	.	G	A	0	13	13	0	5	18	0	0
5	37509857	.	A	G	7	7	14	0	0	14	0	0
5	37509916	.	A	G	4	10	14	0	0	14	0	0
5	37510247	.	C	T	4	3	7	0	1	8	0	0
5	37510292	.	C	T	3	6	9	0	0	9	0	0
5	37510293	.	T	C	2	6	8	0	1	9	0	0
5	37510574	.	C	G	9	4	13	0	0	13	0	0
5	37510733	.	C	T	3	2	5	0	0	5	0	0
5	37573436	.	C	T	2	2	4	0	0	4	0	0
5	37581111	.	G	A	0	1	1	0	0	1	0	0
5	37686590	.	C	T	1	1	2	0	0	2	0	0
5	37688422	.	A	G	2	2	4	0	0	4	0	0
5	37692620	.	T	C	3	3	6	0	0	6	0	0
5	37694568	.	A	C	3	3	6	0	0	6	0	0
5	37695528	.	A	G	2	0	2	0	0	2	0	0
5	37696582	.	G	A	1	1	2	0	3	5	0	0
5	37697134	.	C	T	8	9	17	0	0	17	0	0
5	37700687	.	C	A	4	0	4	0	0	4	0	0
5	37700908	.	T	C	6	7	13	0	1	14	0	0
5	37701262	.	T	A	3	5	8	0	2	10	0	0
5	37702934	.	C	T	6	7	13	0	2	15	0	0
5	37703176	.	G	A	0	1	1	0	2	3	0	0
5	37706798	.	C	T	6	4	10	0	0	10	0	0
5	37707190	.	G	A	8	10	18	0	1	19	0	0
5	37708995	.	A	T	17	15	32	0	0	32	0	0
5	37709057	.	T	A	11	19	30	0	0	30	0	0
5	37754583	.	A	G	0	1	1	0	0	1	0	0
5	37757505	.	C	T	4	5	9	0	0	9	0	0
5	37757677	.	C	T	9	3	12	0	0	12	0	0
5	37757690	.	T	C	9	5	14	0	0	14	0	0
5	37812090	.	C	T	1	2	3	0	0	3	0	0
5	37838415	.	T	C	2	5	7	0	0	7	0	0
5	37839029	.	G	T	28	22	50	0	1	51	0	0
5	37851528	.	T	C	2	2	4	0	0	4	0	0
5	37851542	.	G	A	2	2	4	0	0	4	0	0
5	37851579	.	C	T	2	2	4	0	0	4	0	0
5	37851588	.	A	C	3	2	5	0	0	5	0	0
5	37851742	.	G	A	2	6	8	0	0	8	0	0
5	37851758	.	T	A	2	6	8	0	0	8	0	0
5	37851876	.	C	T	4	3	7	0	1	8	0	0
5	37851923	.	G	A	3	6	9	0	0	9	0	0
5	37851962	.	C	T	3	2	5	0	1	6	0	0
5	37851970	.	A	C	3	2	5	0	1	6	0	0
5	37864845	.	A	G	5	6	11	0	1	12	0	0
5	37865142	.	C	T	8	4	12	0	0	12	0	0
5	37865265	.	A	G	4	2	6	0	1	7	0	0
5	37865628	.	T	C	5	3	8	0	0	8	0	0
5	37865677	.	G	T	1	2	3	0	0	3	0	0
5	37865744	.	C	G	1	1	2	0	1	3	0	0
5	37866310	.	C	T	5	1	6	0	2	8	0	0
5	37867491	.	C	T	1	0	1	0	0	1	0	0
5	37912292	.	T	A	22	14	36	0	2	39	1	0
5	37912442	.	A	G	13	12	25	0	0	25	0	0
5	37912489	.	T	A	10	10	20	0	2	22	0	0
5	37912748	.	A	T	19	5	24	0	1	25	0	0
5	37912859	.	A	C	7	5	12	0	1	13	0	0
5	37912970	.	A	C	6	14	20	0	0	20	0	0
5	37913041	.	C	G	6	12	18	0	0	18	0	0
5	37913064	.	T	C	7	16	23	0	1	24	0	0
5	37918882	.	C	T	0	4	4	0	0	4	0	0
5	37918894	.	A	T	2	2	4	0	1	5	0	0
5	37918932	.	A	T	2	2	4	0	0	4	0	0
5	37963130	.	C	T	0	1	1	0	0	1	0	0
5	37963155	.	G	A	0	2	2	0	0	2	0	0
5	37963259	.	C	T	4	3	7	0	1	8	0	0
5	37963262	.	G	T	3	4	7	0	0	7	0	0
5	37968912	.	T	G	2	3	5	0	0	5	0	0
5	37968951	.	G	A	3	2	5	0	1	6	0	0
5	37968966	.	T	C	0	0	0	0	1	1	0	0
5	37970764	.	C	T	6	8	14	0	1	15	0	0
5	37970773	.	A	T	5	7	12	0	0	12	0	0
5	37981972	.	C	T	3	2	5	0	1	6	0	0
5	37987325	.	C	T	0	2	2	0	4	6	0	0
5	37987369	.	G	A	1	2	3	0	0	3	0	0
5	37988969	.	G	T	2	3	5	0	3	8	0	0
5	37989090	.	G	A	3	1	4	0	2	6	0	0
5	37989135	.	A	G	4	7	11	0	0	11	0	0
5	37989325	.	G	A	6	3	9	0	1	10	0	0
5	38089247	.	G	T	1	2	3	0	0	3	0	0
5	38091247	.	A	G	1	2	3	0	0	3	0	0
5	38100992	.	T	C	0	0	0	0	1	1	0	0
5	38101587	.	T	C	1	2	3	0	0	3	0	0
5	38101869	.	C	T	1	2	3	0	0	3	0	0
5	38105327	.	T	C	1	2	3	0	0	3	0	0
5	38106815	.	C	T	1	3	4	0	0	4	0	0
5	38107054	.	T	C	6	3	9	0	0	9	0	0
5	38110826	.	G	T	8	6	14	0	1	15	0	0
5	38110908	.	A	T	10	9	19	0	0	19	0	0
5	38115349	.	T	C	5	4	9	0	0	9	0	0
5	38115361	.	T	C	5	4	9	0	0	9	0	0
5	38115395	.	A	G	4	4	8	0	0	8	0	0
5	38115502	.	C	T	6	6	12	0	0	12	0	0
5	38115582	.	C	T	7	4	11	0	1	12	0	0
5	38115685	.	A	T	5	7	12	0	1	13	0	0
5	38120116	.	A	G	2	0	2	0	2	4	0	0
5	38120117	.	C	A	1	1	2	0	2	4	0	0
5	38121942	.	A	G	4	3	7	0	0	7	0	0
5	38121991	.	A	T	6	3	9	0	1	10	0	0
5	38121993	.	T	C	7	3	10	0	0	10	0	0
5	38122100	.	C	A	5	2	7	0	0	7	0	0
5	38122112	.	T	A	4	2	6	0	0	6	0	0
5	38214258	.	A	G	1	5	6	0	0	6	0	0
5	38216344	.	G	A	2	3	5	0	0	5	0	0
5	38216469	.	C	A	1	2	3	0	0	3	0	0
5	38216471	.	C	T	0	2	2	0	1	3	0	0
5	38217422	.	G	T	1	3	4	0	0	4	0	0
5	38251120	.	A	C	3	2	5	0	0	5	0	0
5	38251244	.	T	G	1	6	7	0	0	7	0	0
5	38251506	.	C	T	0	4	4	0	3	7	0	0
5	38251968	.	T	G	2	6	8	0	0	8	0	0
5	38252113	.	G	C	0	1	1	0	1	2	0	0
5	38263384	.	G	A	4	11	15	0	1	16	0	0
5	38263611	.	G	A	3	6	9	0	0	9	0	0
5	38263870	.	C	T	1	1	2	0	0	2	0	0
5	38281540	.	G	C	0	6	6	0	4	10	0	0
5	38287103	.	C	T	9	10	19	0	1	20	0	0
5	38289358	.	A	C	10	16	26	0	2	28	0	0
5	38296192	.	C	T	17	18	35	0	5	40	0	0
5	38296193	.	A	G	21	18	39	0	1	40	0	0
5	38296475	.	G	A	17	19	36	0	3	39	0	0
5	38296765	.	A	C	20	15	35	0	4	39	0	0
5	38296799	.	A	C	20	20	40	0	2	42	0	0
5	38302085	.	G	A	10	16	26	0	7	33	0	0
5	38302158	.	C	A	14	22	36	0	4	40	0	0
5	38302159	.	A	C	23	16	39	0	1	40	0	0
5	38302490	.	A	G	26	13	39	0	6	45	0	0
5	38302589	.	T	A	24	19	43	0	2	46	1	0
5	38302753	.	G	T	25	21	46	0	5	51	0	0
5	38302859	.	C	T	15	20	35	0	2	37	0	0
5	38302911	.	A	T	17	13	30	0	1	31	0	0
5	38303028	.	G	T	16	20	36	0	1	37	0	0
5	38303301	.	T	C	12	0	12	0	11	23	0	0
5	38303895	.	A	T	14	17	31	0	2	33	0	0
5	38303896	.	G	A	15	18	33	0	0	33	0	0
5	38304578	.	C	T	8	17	25	0	4	29	0	0
5	38304633	.	T	G	9	15	24	0	3	27	0	0
5	38304768	.	G	A	12	13	25	0	1	26	0	0
5	38305068	.	G	A	8	17	25	0	2	27	0	0
5	38305127	.	T	C	10	12	22	0	2	25	1	0
5	38305493	.	C	T	1	11	12	0	2	14	0	0
5	38305698	.	G	A	7	6	13	0	0	13	0	0
5	38308378	.	C	A	0	2	2	0	0	2	0	0
5	38314069	.	C	T	4	2	6	0	0	6	0	0
5	38320825	.	A	G	1	1	2	0	1	3	0	0
5	38388875	.	C	G	1	2	3	0	3	6	0	0
5	38389147	.	T	C	4	5	9	0	0	9	0	0
5	38389165	.	G	T	3	4	7	0	0	7	0	0
5	38389538	.	G	A	1	6	7	0	1	8	0	0
5	38476750	.	C	A	7	6	13	0	0	13	0	0
5	38532216	.	A	T	1	4	5	0	1	6	0	0
5	38533248	.	G	A	3	2	5	0	0	5	0	0
5	38533296	.	T	G	1	2	3	0	1	4	0	0
5	38533464	.	A	G	3	3	6	0	0	6	0	0
5	38533551	.	A	G	1	2	3	0	0	3	0	0
5	38605094	.	C	T	8	8	16	0	0	16	0	0
5	38605106	.	A	T	7	6	13	0	3	16	0	0
5	38605164	.	C	T	5	4	9	0	0	9	0	0
5	38605201	.	A	C	4	6	10	0	1	11	0	0
5	38605291	.	G	C	10	6	16	0	1	17	0	0
5	38605347	.	G	T	15	9	24	0	0	24	0	0
5	38611096	.	G	T	0	2	2	0	0	2	0	0
5	38611108	.	T	C	0	0	0	0	1	1	0	0
5	38721044	.	G	C	0	2	2	0	0	2	0	0
5	38726961	.	A	T	2	2	4	0	0	4	0	0
5	38736093	.	G	A	1	1	2	0	0	2	0	0
5	38745925	.	C	T	2	6	8	0	0	8	0	0
5	38745962	.	A	T	2	5	7	0	0	7	0	0
5	38745980	.	G	T	0	3	3	0	2	5	0	0
5	38749767	.	C	T	2	4	6	0	1	7	0	0
5	38749939	.	C	A	2	2	4	0	0	4	0	0
5	38750033	.	A	C	4	2	6	0	0	6	0	0
5	38750035	.	A	G	4	2	6	0	0	6	0	0
5	38786808	.	C	T	4	4	8	0	0	8	0	0
5	38786823	.	G	A	4	5	9	0	0	9	0	0
5	38786922	.	T	C	7	5	12	0	1	13	0	0
5	38826047	.	A	C	0	2	2	0	0	2	0	0
5	38827340	.	T	A	1	0	1	0	0	1	0	0
5	38831573	.	A	G	3	5	8	0	1	9	0	0
5	39085067	.	G	T	0	2	2	0	1	3	0	0
5	39085271	.	T	C	2	2	4	0	0	4	0	0
5	39085302	.	T	A	2	2	4	0	0	4	0	0
5	39085328	.	C	T	1	3	4	0	1	5	0	0
5	39085976	.	C	T	6	8	14	0	0	14	0	0
5	39099642	.	T	C	1	3	4	0	0	4	0	0
5	39136032	.	G	A	1	3	4	0	1	5	0	0
5	39143310	.	C	T	3	4	7	0	0	7	0	0
5	39143447	.	C	T	1	3	4	0	0	4	0	0
5	39152411	.	C	T	5	1	6	0	1	7	0	0
5	39152582	.	A	G	2	4	6	0	1	7	0	0
5	39152613	.	T	A	3	3	6	0	1	7	0	0
5	39154819	.	C	G	10	12	22	0	1	23	0	0
5	39154829	.	G	T	11	12	23	0	2	25	0	0
5	39154919	.	A	G	6	15	21	0	2	23	0	0
5	39154958	.	C	G	8	13	21	0	1	22	0	0
5	39154979	.	C	T	0	10	10	0	10	20	0	0
5	39155006	.	T	A	5	11	16	0	1	17	0	0
5	39155044	.	A	G	6	9	15	0	1	16	0	0
5	39155146	.	T	A	3	2	5	0	0	5	0	0
5	39155419	.	C	T	5	4	9	0	1	10	0	0
5	39155473	.	T	A	6	4	10	0	0	10	0	0
5	39155474	.	G	T	6	4	10	0	0	10	0	0
5	39155511	.	A	G	2	4	6	0	2	8	0	0
5	39160584	.	G	A	3	5	8	0	0	8	0	0
5	39386667	.	A	G	5	4	9	0	0	9	0	0
5	39386685	.	A	G	5	2	7	0	0	7	0	0
5	39386709	.	T	A	2	2	4	0	0	4	0	0
5	39386721	.	A	T	3	2	5	0	0	5	0	0
5	39508009	.	C	T	16	18	34	0	4	38	0	0
5	39508059	.	T	A	13	10	23	0	1	25	1	0
5	39508540	.	G	A	0	9	9	0	14	23	0	0
5	39663402	.	A	G	2	1	3	0	0	3	0	0
5	39707665	.	A	T	2	2	4	0	0	4	0	0
5	39707758	.	A	C	6	4	10	0	1	11	0	0
5	39707825	.	G	A	7	12	19	0	3	22	0	0
5	39708046	.	A	G	8	9	17	0	0	17	0	0
5	39712557	.	T	C	0	2	2	0	0	2	0	0
5	39714917	.	T	C	2	0	2	0	0	2	0	0
5	39715249	.	G	A	1	4	5	0	0	5	0	0
5	39730511	.	A	G	6	4	10	0	0	10	0	0
5	39730575	.	C	T	1	1	2	0	0	2	0	0
5	39730713	.	T	C	2	5	7	0	0	7	0	0
5	39731805	.	T	C	3	3	6	0	0	6	0	0
5	39736279	.	C	T	2	6	8	0	0	8	0	0
5	40003650	.	C	T	1	4	5	0	0	5	0	0
5	40054407	.	C	G	2	2	4	0	0	4	0	0
5	40059722	.	C	G	8	9	17	0	1	18	0	0
5	40059761	.	T	C	9	10	19	0	1	20	0	0
5	40097502	.	A	G	1	2	3	0	0	3	0	0
5	40097505	.	A	G	0	2	2	0	2	4	0	0
5	40203540	.	G	A	2	2	4	0	0	4	0	0
5	40206117	.	G	A	2	2	4	0	0	4	0	0
5	40206358	.	A	C	2	6	8	0	0	8	0	0
5	40210379	.	A	C	2	2	4	0	0	4	0	0
5	40273166	.	C	A	3	2	5	0	0	5	0	0
5	40273444	.	A	C	1	3	4	0	2	6	0	0
5	40273468	.	T	C	3	5	8	0	0	8	0	0
5	40273510	.	G	T	4	4	8	0	0	8	0	0
5	40273606	.	C	T	0	4	4	0	4	8	0	0
5	40273727	.	T	A	4	2	6	0	0	6	0	0
5	40273864	.	G	A	1	0	1	0	0	1	0	0
5	40505124	.	C	T	0	6	6	0	4	10	0	0
5	40506837	.	A	G	1	1	2	0	1	3	0	0
5	40507154	.	C	G	4	2	6	0	0	6	0	0
5	40507577	.	C	A	3	2	5	0	0	5	0	0
5	40728852	.	A	G	4	4	8	0	0	8	0	0
5	40729081	.	A	C	4	3	7	0	1	9	1	0
5	40729147	.	T	C	9	4	13	0	0	13	0	0
5	40729408	.	G	A	5	11	16	0	0	16	0	0
5	40729618	.	A	G	6	5	11	0	1	12	0	0
5	40845344	.	G	C	4	2	6	0	0	6	0	0
5	40845387	.	A	G	2	1	3	0	1	4	0	0
5	40845389	.	A	T	2	2	4	0	0	4	0	0
5	40845556	.	C	A	5	10	15	0	0	15	0	0
5	40845893	.	A	G	2	4	6	0	1	7	0	0
5	40846122	.	G	A	2	9	11	0	0	11	0	0
5	40910770	.	A	G	1	1	2	0	1	3	0	0
5	41082921	.	C	G	10	10	20	0	1	21	0	0
5	41082951	.	A	C	6	1	7	0	10	17	0	0
5	41083000	.	C	A	8	10	18	0	0	18	0	0
5	41083001	.	T	C	8	0	8	0	10	18	0	0
5	41083118	.	C	T	0	3	3	0	6	9	0	0
5	41083763	.	A	G	14	7	21	0	0	21	0	0
5	41084063	.	G	C	9	8	17	0	0	17	0	0
5	41084274	.	A	G	8	20	28	0	0	28	0	0
5	41084367	.	C	A	0	10	10	0	8	18	0	0
5	41085049	.	A	C	1	2	3	0	0	3	0	0
5	41085118	.	A	G	3	5	8	0	0	8	0	0
5	41085414	.	T	A	4	2	6	0	0	6	0	0
5	41086082	.	T	G	4	3	7	0	1	8	0	0
5	41103286	.	T	C	4	5	9	0	1	10	0	0
5	41103462	.	A	G	4	7	11	0	0	11	0	0
5	41103469	.	G	A	4	7	11	0	3	14	0	0
5	41124760	.	T	C	3	0	3	0	7	10	0	0
5	41125229	.	G	T	5	5	10	0	1	11	0	0
5	41125310	.	A	C	24	14	38	0	2	40	0	0
5	41125311	.	A	C	26	13	39	0	1	40	0	0
5	41125354	.	C	A	26	12	38	0	1	39	0	0
5	41125996	.	T	C	22	16	38	0	1	39	0	0
5	41126059	.	G	A	21	13	34	0	3	37	0	0
5	41127078	.	A	G	3	5	8	0	0	8	0	0
5	41127111	.	T	C	4	7	11	0	0	11	0	0
5	41127132	.	C	T	4	7	11	0	0	11	0	0
5	41128808	.	T	G	6	8	14	0	0	14	0	0
5	41133401	.	A	T	6	9	15	0	0	15	0	0
5	41134921	.	A	T	4	5	9	0	1	10	0	0
5	41134942	.	A	G	9	7	16	0	0	16	0	0
5	41135002	.	A	G	12	2	14	0	3	17	0	0
5	41137311	.	G	A	3	7	10	0	0	10	0	0
5	41137341	.	G	A	5	9	14	0	0	14	0	0
5	41138377	.	C	T	5	4	9	0	0	9	0	0
5	41138720	.	T	C	2	3	5	0	1	6	0	0
5	41138738	.	A	G	3	4	7	0	0	7	0	0
5	41138756	.	C	A	5	2	7	0	0	7	0	0
5	41146801	.	G	A	4	2	6	0	0	6	0	0
5	41150615	.	C	T	11	5	16	0	1	17	0	0
5	41150898	.	T	A	20	17	37	0	0	37	0	0
5	41150979	.	A	C	20	18	38	0	2	40	0	0
5	41151265	.	G	A	13	6	19	0	3	22	0	0
5	41260937	.	C	T	7	5	12	0	0	12	0	0
5	41261032	.	A	G	2	2	4	0	0	4	0	0
5	41478349	.	C	T	1	2	3	0	0	3	0	0
5	41481405	.	A	G	1	2	3	0	1	4	0	0
5	41484391	.	A	C	2	7	9	0	0	9	0	0
5	41484460	.	T	C	7	10	17	0	2	19	0	0
5	41484496	.	T	C	5	12	17	0	0	17	0	0
5	41484680	.	C	T	8	10	18	0	3	21	0	0
5	41484797	.	C	A	11	11	22	0	0	22	0	0
5	41484991	.	A	G	1	3	4	0	0	4	0	0
5	41485363	.	C	G	12	22	34	0	3	37	0	0
5	41485365	.	A	G	13	24	37	0	0	37	0	0
5	41485497	.	C	G	21	20	41	0	2	43	0	0
5	41485533	.	C	T	2	24	26	0	27	53	0	0
5	41485709	.	A	T	29	31	60	0	4	64	0	0
5	41485814	.	A	T	21	37	58	0	1	59	0	0
5	41486025	.	A	G	33	29	62	0	4	66	0	0
5	41486031	.	T	G	32	31	63	0	1	64	0	0
5	41486803	.	G	A	5	1	6	0	1	7	0	0
5	41486890	.	C	T	21	16	37	0	5	42	0	0
5	41488903	.	A	G	13	12	25	0	3	28	0	0
5	41489487	.	G	T	5	18	23	0	1	24	0	0
5	41489493	.	C	T	5	19	24	0	1	25	0	0
5	41489748	.	T	C	8	7	15	0	1	16	0	0
5	41492135	.	C	T	2	1	3	0	0	3	0	0
5	41492183	.	C	T	0	10	10	0	7	17	0	0
5	41492234	.	G	A	14	7	21	0	2	24	1	0
5	41492279	.	G	A	7	5	12	0	0	12	0	0
5	41492901	.	G	A	14	13	27	0	1	29	1	0
5	41492934	.	A	G	11	12	23	0	0	23	0	0
5	41509073	.	T	G	2	2	4	0	0	4	0	0
5	41513013	.	T	C	2	3	5	0	0	5	0	0
5	41514127	.	A	G	3	1	4	0	0	4	0	0
5	41516322	.	A	C	4	1	5	0	0	5	0	0
5	41516521	.	G	A	1	3	4	0	1	5	0	0
5	41518836	.	T	C	18	12	30	0	2	32	0	0
5	41519423	.	A	C	22	20	42	0	3	45	0	0
5	41519459	.	T	C	14	12	26	0	0	26	0	0
5	41520822	.	A	T	22	26	48	0	2	50	0	0
5	41520823	.	T	C	23	25	48	0	2	50	0	0
5	41582736	.	G	A	2	2	4	0	1	5	0	0
5	41585186	.	G	A	2	3	5	0	0	5	0	0
5	41639787	.	A	T	4	6	10	0	0	10	0	0
5	41639814	.	A	G	4	5	9	0	2	11	0	0
5	41639874	.	G	T	2	9	11	0	0	11	0	0
5	41641750	.	G	A	10	9	19	0	4	23	0	0
5	41641835	.	G	C	6	13	19	0	0	19	0	0
5	41641887	.	A	G	8	10	18	0	1	19	0	0
5	41642167	.	A	G	1	3	4	0	0	4	0	0
5	41642348	.	G	A	2	1	3	0	0	3	0	0
5	41643084	.	A	G	1	2	3	0	0	3	0	0
5	41643095	.	A	G	1	2	3	0	0	3	0	0
5	41645652	.	A	G	22	16	38	0	1	39	0	0
5	41645982	.	A	G	18	10	28	0	0	28	0	0
5	41650451	.	T	C	8	0	8	0	21	29	0	0
5	41650505	.	T	G	4	3	7	0	17	24	0	0
5	41655134	.	G	A	0	2	2	0	0	2	0	0
5	41655155	.	T	A	5	4	9	0	0	9	0	0
5	41670193	.	G	A	3	1	4	0	1	5	0	0
5	41676855	.	T	C	1	2	3	0	2	5	0	0
5	41691606	.	A	G	0	1	1	0	0	1	0	0
5	41878612	.	A	C	14	10	24	0	0	24	0	0
5	41878660	.	A	G	14	9	23	0	0	23	0	0
5	41878711	.	C	T	0	13	13	0	13	26	0	0
5	41878965	.	G	C	7	9	16	0	2	19	1	0
5	41879465	.	C	G	7	9	16	0	0	16	0	0
5	41879497	.	T	C	6	11	17	0	1	18	0	0
5	41879848	.	C	A	2	3	5	0	0	5	0	0
5	41880240	.	T	C	7	1	8	0	13	21	0	0
5	41880243	.	T	C	5	1	6	0	13	19	0	0
5	41880280	.	C	G	5	14	19	0	1	20	0	0
5	41880288	.	G	A	6	12	18	0	0	18	0	0
5	41882364	.	T	C	1	3	4	0	2	6	0	0
5	41885861	.	C	A	0	0	0	0	1	1	0	0
5	41888132	.	T	C	3	1	4	0	5	9	0	0
5	41890054	.	G	A	2	7	9	0	0	9	0	0
5	41890092	.	A	G	3	5	8	0	0	8	0	0
5	41898424	.	A	G	1	1	2	0	0	2	0	0
5	42053399	.	T	C	2	3	5	0	0	5	0	0
5	42053465	.	G	C	4	2	6	0	0	6	0	0
5	42053679	.	C	T	1	2	3	0	0	3	0	0
5	42122838	.	G	A	4	2	6	0	0	6	0	0
5	42122907	.	C	T	15	3	18	0	0	18	0	0
5	42122914	.	C	T	12	4	16	0	3	19	0	0
5	42123023	.	C	T	25	11	36	0	1	37	0	0
5	42123125	.	C	T	24	11	35	0	4	39	0	0
5	42123375	.	C	A	16	6	22	0	3	25	0	0
5	42123664	.	A	G	9	7	16	0	0	16	0	0
5	42123697	.	G	C	9	9	18	0	3	21	0	0
5	42123766	.	G	T	9	8	17	0	0	17	0	0
5	45204175	.	G	A	0	1	1	0	0	1	0	0
5	45224048	.	C	T	4	3	7	0	2	9	0	0
5	45224396	.	A	G	0	1	1	0	0	1	0	0
5	45230659	.	C	A	2	1	3	0	0	3	0	0
5	45261926	.	C	T	8	1	9	0	0	9	0	0
5	45269380	.	A	G	2	5	7	0	1	8	0	0
5	45269386	.	A	G	2	6	8	0	2	10	0	0
5	45272056	.	C	T	5	2	7	0	0	7	0	0
5	45272068	.	G	A	2	1	3	0	0	3	0	0
5	45274486	.	C	T	11	7	18	0	1	19	0	0
5	45282910	.	G	A	6	6	12	1	1	14	0	0
5	45283046	.	G	T	6	3	9	0	0	9	0	0
5	45283074	.	G	A	0	6	6	0	6	12	0	0
5	45283117	.	A	C	3	6	9	0	0	9	0	0
5	45283165	.	C	T	3	4	7	0	0	7	0	0
5	45283274	.	T	C	4	8	12	0	1	13	0	0
5	45283284	.	T	C	4	7	11	0	0	11	0	0
5	45283365	.	G	A	7	9	16	0	2	18	0	0
5	45283645	.	C	T	4	11	15	0	0	15	0	0
5	45747118	.	G	T	3	5	8	0	1	9	0	0
5	45747455	.	C	T	8	12	20	0	0	20	0	0
5	45747475	.	C	T	0	8	8	0	8	16	0	0
5	45747647	.	A	G	10	8	18	0	0	18	0	0
5	45747845	.	C	A	1	2	3	0	0	3	0	0
5	45748339	.	T	G	5	10	15	0	1	16	0	0
5	45754818	.	C	T	4	1	5	0	0	5	0	0
5	45754851	.	A	G	9	5	14	0	0	14	0	0
5	45754899	.	G	A	4	6	10	0	1	11	0	0
5	45890036	.	A	T	7	4	11	0	1	12	0	0
5	45890086	.	A	T	3	9	12	0	1	13	0	0
5	45890087	.	A	T	3	9	12	0	1	13	0	0
5	45890159	.	A	G	3	3	6	0	0	6	0	0
5	45890195	.	A	G	8	6	14	0	0	14	0	0
5	45890219	.	A	T	10	9	19	0	0	19	0	0
5	45890625	.	C	T	16	6	22	0	1	23	0	0
5	45890908	.	C	T	0	8	8	0	12	20	0	0
5	45890915	.	C	T	11	7	18	0	0	18	0	0
5	45891074	.	A	G	4	7	11	0	0	11	0	0
5	45891090	.	A	G	5	7	12	0	0	12	0	0
5	45891147	.	T	A	5	5	10	0	1	11	0	0
5	45891226	.	T	A	10	7	17	0	0	17	0	0
5	45891327	.	G	T	12	13	25	0	1	26	0	0
5	45894699	.	C	T	1	7	8	0	0	8	0	0
5	45894720	.	T	C	4	7	11	0	0	11	0	0
5	45894737	.	T	C	4	7	11	0	1	12	0	0
5	45904764	.	C	A	3	2	5	0	0	5	0	0
5	46174671	.	G	C	1	1	2	0	1	3	0	0
5	46327798	.	G	T	11	10	21	0	1	22	0	0
5	46329750	.	C	G	1	6	7	0	4	11	0	0
5	46491924	.	A	T	0	2	2	0	0	2	0	0
5	46659285	.	T	G	15	15	30	0	3	33	0	0
5	46659401	.	A	G	20	20	40	0	2	42	0	0
5	46659666	.	T	A	33	10	43	0	1	44	0	0
5	46659707	.	C	A	25	20	45	0	7	52	0	0
5	46659861	.	G	A	12	14	26	0	6	32	0	0
5	46659950	.	C	T	17	18	35	0	3	38	0	0
5	46659985	.	A	G	19	26	45	0	1	46	0	0
5	46660068	.	C	T	13	19	32	0	1	33	0	0
5	46660116	.	C	T	18	10	28	0	1	29	0	0
5	46660120	.	A	G	10	14	24	0	4	28	0	0
5	46660162	.	C	G	15	12	27	0	0	27	0	0
5	46660600	.	T	A	10	8	18	1	1	20	0	0
5	46660672	.	G	A	21	7	28	0	4	32	0	0
5	46660940	.	G	A	13	17	30	0	1	32	1	0
5	46660941	.	A	T	18	12	30	0	2	32	0	0
5	46661073	.	G	A	8	4	12	0	3	15	0	0
5	46661168	.	T	A	4	4	8	0	0	8	0	0
5	46661213	.	A	G	7	4	11	0	0	11	0	0
5	46661240	.	A	G	7	8	15	0	0	15	0	0
5	46661519	.	C	T	11	12	23	0	1	24	0	0
5	46662316	.	A	G	6	4	10	0	1	11	0	0
5	46685872	.	A	G	7	4	11	0	1	12	0	0
5	46724854	.	G	A	10	10	20	0	0	20	0	0
5	46724893	.	G	T	5	8	13	0	2	15	0	0
5	47727760	.	C	T	0	15	15	0	27	42	0	0
5	47949992	.	G	A	1	2	3	0	0	3	0	0
5	47950082	.	A	C	1	1	2	0	0	2	0	0
5	47959994	.	C	A	2	2	4	0	1	5	0	0
5	47968970	.	C	T	1	1	2	0	0	2	0	0
5	47973386	.	T	G	1	1	2	0	0	2	0	0
5	47976525	.	C	T	3	3	6	0	0	6	0	0
5	47976728	.	C	G	5	3	8	0	2	10	0	0
5	47976747	.	C	A	8	4	12	0	0	12	0	0
5	47976827	.	A	G	4	9	13	0	2	15	0	0
5	48022826	.	G	A	0	4	4	0	2	6	0	0
5	48023044	.	C	T	2	1	3	0	1	4	0	0
5	48028338	.	C	A	5	3	8	0	0	8	0	0
5	48028451	.	T	A	4	3	7	0	3	10	0	0
5	48028508	.	T	C	3	3	6	0	0	6	0	0
5	48028696	.	C	A	7	2	9	0	0	9	0	0
5	48029497	.	A	T	8	0	8	0	0	8	0	0
5	48029510	.	C	A	2	4	6	0	0	6	0	0
5	48029633	.	C	A	1	2	3	0	0	3	0	0
5	48029720	.	T	G	6	3	9	0	0	9	0	0
5	48029732	.	C	T	0	6	6	0	5	11	0	0
5	48029793	.	C	T	4	8	12	0	2	14	0	0
5	48029805	.	A	C	5	9	14	0	0	14	0	0
5	48029828	.	A	T	6	7	13	0	2	15	0	0
5	48110331	.	G	A	8	10	18	0	1	19	0	0
5	48154436	.	G	A	1	1	2	0	0	2	0	0
5	48154456	.	T	A	1	1	2	0	0	2	0	0
5	48182265	.	A	G	6	1	7	0	2	9	0	0
5	48182550	.	A	T	2	4	6	0	0	6	0	0
5	48182725	.	T	C	4	10	14	0	2	16	0	0
5	48183577	.	C	T	0	11	11	0	7	18	0	0
5	48183579	.	A	G	6	9	15	0	3	18	0	0
5	48183628	.	T	C	5	0	5	0	11	16	0	0
5	48208539	.	G	A	4	2	6	0	0	6	0	0
5	48242529	.	T	G	0	1	1	0	0	1	0	0
5	48242610	.	G	A	5	2	7	0	0	7	0	0
5	48659794	.	T	C	1	0	1	0	2	3	0	0
5	48672641	.	A	G	2	2	4	0	0	4	0	0
5	48672740	.	G	A	13	6	19	0	0	19	0	0
5	48672925	.	A	T	4	2	6	0	0	7	1	0
5	48673084	.	C	T	3	6	9	0	0	9	0	0
5	48673501	.	A	G	3	9	12	0	1	13	0	0
5	48673639	.	C	A	1	2	3	0	3	6	0	0
5	48679428	.	A	T	4	5	9	0	0	9	0	0
5	48679482	.	A	T	3	5	8	0	0	8	0	0
5	48935915	.	C	T	0	1	1	0	0	1	0	0
5	48935981	.	C	T	4	4	8	0	0	8	0	0
5	48936032	.	C	T	2	1	3	0	0	3	0	0
5	48986109	.	G	A	10	10	20	0	2	22	0	0
5	48986405	.	T	A	8	9	17	0	1	18	0	0
5	48986410	.	G	T	9	10	19	0	0	19	0	0
5	48986565	.	A	G	7	21	28	0	1	29	0	0
5	48986626	.	A	T	10	18	28	0	1	29	0	0
5	48986939	.	C	T	13	14	27	0	1	28	0	0
5	48987007	.	A	T	14	10	24	0	5	29	0	0
5	48987199	.	C	T	13	17	30	0	3	33	0	0
5	48987356	.	G	T	5	17	22	0	1	23	0	0
5	48987920	.	T	C	11	13	24	0	1	25	0	0
5	48988051	.	C	T	0	5	5	0	4	9	0	0
5	48988084	.	A	G	1	0	1	0	0	1	0	0
5	48992972	.	C	T	1	0	1	0	0	1	0	0
5	48995559	.	A	T	6	8	14	0	0	14	0	0
5	48995613	.	A	G	7	3	10	0	1	11	0	0
5	48995637	.	A	T	8	6	14	0	0	14	0	0
5	48995884	.	G	A	2	7	9	0	0	9	0	0
5	48995945	.	G	A	3	6	9	0	0	9	0	0
5	49019451	.	G	A	1	4	5	0	0	5	0	0
5	49019456	.	G	A	1	3	4	0	0	4	0	0
5	49019528	.	T	C	2	3	5	0	0	5	0	0
5	49019594	.	C	A	3	1	4	0	1	5	0	0
5	49020194	.	A	T	2	3	5	0	0	5	0	0
5	49020200	.	T	A	2	2	4	0	1	5	0	0
5	49734581	.	C	T	6	8	14	0	1	15	0	0
5	49734708	.	G	T	6	17	23	0	1	24	0	0
5	49734709	.	G	A	7	16	23	0	1	24	0	0
5	49734751	.	T	G	8	7	15	0	2	17	0	0
5	49734889	.	C	T	5	4	9	0	0	9	0	0
5	49735022	.	G	T	1	5	6	0	0	6	0	0
5	49735169	.	A	T	5	3	8	0	0	8	0	0
5	49735453	.	T	C	3	2	5	0	2	7	0	0
5	49735942	.	T	G	5	4	9	0	0	9	0	0
5	49745130	.	T	A	3	2	5	0	0	5	0	0
5	49747271	.	G	T	0	10	10	0	5	15	0	0
5	49750765	.	C	T	8	8	16	0	1	17	0	0
5	49750796	.	A	C	4	7	11	0	2	13	0	0
5	49768324	.	G	T	2	2	4	0	0	4	0	0
5	49768341	.	T	C	1	2	3	0	1	4	0	0
5	49768774	.	C	G	1	4	5	0	0	5	0	0
5	49768885	.	T	C	2	3	5	0	0	5	0	0
5	49768977	.	A	G	3	2	5	0	0	5	0	0
5	49769217	.	A	G	2	1	3	0	1	4	0	0
5	49769277	.	G	T	2	2	4	0	0	4	0	0
5	49769485	.	A	G	2	1	3	0	0	3	0	0
5	49769711	.	C	G	5	2	7	0	0	7	0	0
5	49769812	.	A	T	1	2	3	0	1	4	0	0
5	49773772	.	G	A	0	2	2	0	2	4	0	0
5	49773801	.	A	T	4	2	6	0	0	6	0	0
5	49919762	.	G	A	1	2	3	0	0	3	0	0
5	49919774	.	T	A	1	1	2	0	2	4	0	0
5	50256327	.	T	G	2	2	4	0	0	4	0	0
5	50256351	.	T	C	1	2	3	0	0	3	0	0
5	50435897	.	G	A	2	3	5	0	0	5	0	0
5	50436028	.	C	T	2	4	6	0	2	8	0	0
5	50436175	.	C	G	2	0	2	0	7	9	0	0
5	50436354	.	G	A	4	4	8	0	0	8	0	0
5	50436359	.	G	T	3	4	7	0	1	8	0	0
5	50443077	.	T	C	14	21	35	0	4	39	0	0
5	50443184	.	A	G	18	11	29	0	4	33	0	0
5	50443211	.	C	A	10	16	26	0	1	27	0	0
5	50443399	.	G	C	18	9	27	0	2	29	0	0
5	50443418	.	T	A	11	17	28	0	2	30	0	0
5	50443466	.	A	G	9	15	24	0	1	25	0	0
5	50443837	.	G	A	4	4	8	0	0	8	0	0
5	50520009	.	G	A	3	4	7	0	1	8	0	0
5	50544227	.	G	A	0	1	1	0	0	1	0	0
5	50544281	.	T	C	0	3	3	0	0	3	0	0
5	50576699	.	G	A	2	4	6	0	1	7	0	0
5	50576705	.	A	G	3	3	6	0	0	6	0	0
5	50582271	.	G	A	2	2	4	0	0	4	0	0
5	50582482	.	T	G	2	2	4	0	0	4	0	0
5	50817403	.	C	T	2	5	7	0	2	9	0	0
5	50817414	.	C	T	3	4	7	0	1	8	0	0
5	50840669	.	G	T	1	1	2	0	1	3	0	0
5	50886309	.	C	T	1	1	2	0	0	2	0	0
5	50889675	.	T	G	1	2	3	0	1	4	0	0
5	50889714	.	G	A	1	2	3	0	0	3	0	0
5	50892968	.	T	A	2	2	4	0	1	5	0	0
5	50895330	.	A	C	1	2	3	0	0	3	0	0
5	50895544	.	C	T	0	2	2	0	0	2	0	0
5	50895606	.	C	T	1	0	1	0	0	1	0	0
5	50897465	.	G	T	1	4	5	0	9	14	0	0
5	50897585	.	C	T	2	3	5	0	0	5	0	0
5	50967003	.	C	A	0	3	3	0	2	5	0	0
5	50973014	.	C	T	2	1	3	0	1	4	0	0
5	50973039	.	C	T	4	3	7	0	1	8	0	0
5	50973518	.	A	C	9	6	15	0	0	15	0	0
5	50973625	.	A	T	2	3	5	0	0	5	0	0
5	50973748	.	C	T	4	5	9	0	1	10	0	0
5	50983029	.	G	A	1	1	2	0	0	2	0	0
5	51102044	.	T	C	3	4	7	0	0	7	0	0
5	51102828	.	G	A	1	2	3	0	0	3	0	0
5	51102947	.	C	A	1	3	4	0	0	4	0	0
5	51103007	.	T	C	1	3	4	0	0	4	0	0
5	51103411	.	G	A	1	2	3	0	1	4	0	0
5	51103447	.	A	G	1	2	3	0	0	3	0	0
5	51103448	.	C	G	1	1	2	0	1	3	0	0
5	51103642	.	C	T	2	2	4	0	0	4	0	0
5	51103646	.	A	G	2	2	4	0	0	4	0	0
5	51104010	.	G	A	2	4	6	0	0	6	0	0
5	51104031	.	G	A	0	3	3	0	3	6	0	0
5	51121295	.	G	A	1	3	4	0	0	4	0	0
5	51127283	.	A	G	7	3	10	0	1	11	0	0
5	51127396	.	C	G	2	10	12	0	0	12	0	0
5	51169022	.	G	T	1	3	4	0	0	4	0	0
5	51169545	.	C	T	1	2	3	0	1	4	0	0
5	51169749	.	C	T	1	3	4	0	0	4	0	0
5	51170171	.	T	C	3	2	5	0	0	5	0	0
5	51170264	.	A	G	2	2	4	0	0	4	0	0
5	51202938	.	G	A	3	2	5	0	0	5	0	0
5	51205439	.	G	T	3	4	7	0	0	7	0	0
5	51205473	.	T	A	1	3	4	0	0	4	0	0
5	51208565	.	G	A	1	1	2	0	1	3	0	0
5	51227197	.	C	T	1	2	3	0	1	4	0	0
5	51236528	.	A	G	1	2	3	0	0	3	0	0
5	51240679	.	A	G	4	5	9	0	0	9	0	0
5	51240830	.	T	C	5	2	7	0	0	7	0	0
5	51241095	.	C	T	2	3	5	0	0	5	0	0
5	51241817	.	C	A	1	2	3	0	0	3	0	0
5	51242020	.	C	T	4	4	8	0	0	8	0	0
5	51242684	.	A	G	0	1	1	0	0	1	0	0
5	51242697	.	G	A	0	1	1	0	0	1	0	0
5	51242882	.	A	G	6	2	8	0	2	10	0	0
5	51242904	.	C	T	6	7	13	0	0	13	0	0
5	51243006	.	T	A	5	5	10	0	0	10	0	0
5	51243068	.	A	G	12	8	20	0	1	21	0	0
5	51243085	.	C	A	12	7	19	0	0	19	0	0
5	51243157	.	T	A	3	6	9	0	1	10	0	0
5	51243243	.	C	T	3	5	8	0	1	9	0	0
5	51243287	.	G	A	3	6	9	0	0	9	0	0
5	51243341	.	G	A	2	5	7	0	1	8	0	0
5	51243635	.	C	T	6	9	15	0	0	15	0	0
5	51243645	.	A	T	5	10	15	0	0	16	1	0
5	51243680	.	T	G	9	10	19	0	1	20	0	0
5	51243706	.	C	T	9	16	25	0	1	26	0	0
5	51360591	.	C	T	0	1	1	0	0	1	0	0
5	51439900	.	G	C	3	2	5	0	0	5	0	0
5	51616474	.	A	T	4	2	6	0	1	7	0	0
5	51616580	.	A	T	3	8	11	0	0	11	0	0
5	51616704	.	C	G	8	10	18	0	0	18	0	0
5	51616959	.	G	A	6	5	11	0	0	11	0	0
5	51775190	.	C	T	6	12	18	0	1	19	0	0
5	51775291	.	A	T	20	17	37	0	0	37	0	0
5	51775364	.	A	T	17	27	44	0	0	44	0	0
5	51775458	.	A	C	27	8	35	0	0	35	0	0
5	51775501	.	T	G	16	16	32	0	6	39	1	0
5	51775642	.	T	A	18	15	33	0	1	34	0	0
5	51775962	.	G	T	15	13	28	0	2	30	0	0
5	51776150	.	C	A	10	6	16	0	0	16	0	0
5	51779513	.	C	T	3	1	4	0	1	5	0	0
5	51789180	.	C	T	0	3	3	0	4	7	0	0
5	51792974	.	G	A	8	7	15	0	1	16	0	0
5	51835634	.	C	T	2	7	9	0	1	10	0	0
5	51840420	.	C	T	1	0	1	0	0	1	0	0
5	51840942	.	C	T	4	4	8	0	1	9	0	0
5	51846285	.	C	A	0	1	1	0	0	1	0	0
5	51847429	.	T	C	9	6	15	0	0	15	0	0
5	51847675	.	C	G	4	2	6	0	0	6	0	0
5	51885779	.	C	A	1	3	4	2	0	6	0	0
5	51886188	.	A	C	9	15	24	0	1	25	0	0
5	51894040	.	T	C	3	3	6	0	1	7	0	0
5	51898796	.	C	T	0	1	1	0	2	3	0	0
5	51942666	.	G	A	1	2	3	0	0	3	0	0
5	51947370	.	G	T	7	6	13	0	0	13	0	0
5	51947398	.	C	T	0	8	8	0	10	18	0	0
5	51947497	.	C	T	14	14	28	0	0	28	0	0
5	51947650	.	T	C	6	12	18	0	2	20	0	0
5	51947696	.	A	T	9	16	25	0	0	25	0	0
5	51947852	.	A	T	4	6	10	0	1	11	0	0
5	51947976	.	C	G	0	1	1	0	0	1	0	0
5	51948017	.	G	T	2	6	8	0	1	9	0	0
5	51948146	.	G	A	5	10	15	1	0	16	0	0
5	51948207	.	T	C	4	3	7	0	1	8	0	0
5	51948708	.	A	T	2	4	6	0	0	6	0	0
5	51948755	.	C	A	1	5	6	0	0	6	0	0
5	51948825	.	T	C	4	8	12	0	1	13	0	0
5	51948827	.	C	G	9	4	13	0	0	13	0	0
5	51948870	.	A	G	6	7	13	0	2	15	0	0
5	51949069	.	T	A	5	12	17	0	2	19	0	0
5	51949115	.	G	T	4	6	10	0	2	12	0	0
5	51950032	.	G	C	3	8	11	0	0	11	0	0
5	52002660	.	T	G	2	4	6	0	2	8	0	0
5	52002708	.	T	C	5	6	11	0	2	13	0	0
5	52002743	.	T	G	2	1	3	0	1	4	0	0
5	52005851	.	G	T	0	2	2	0	0	2	0	0
5	52005893	.	C	T	1	4	5	0	1	6	0	0
5	52122189	.	C	G	1	2	3	0	0	3	0	0
5	52123640	.	G	T	2	1	3	0	1	4	0	0
5	52124734	.	A	G	1	3	4	0	0	4	0	0
5	52190720	.	G	A	1	3	4	0	0	4	0	0
5	52191185	.	G	T	3	4	7	0	0	7	0	0
5	52191288	.	C	A	6	7	13	0	0	13	0	0
5	52191630	.	T	C	3	3	6	0	0	6	0	0
5	52192496	.	T	A	0	2	2	0	0	2	0	0
5	52192545	.	T	A	0	4	4	0	1	5	0	0
5	52192557	.	C	T	3	3	6	0	1	7	0	0
5	52193817	.	A	G	0	2	2	0	0	2	0	0
5	52198066	.	G	A	1	2	3	0	0	3	0	0
5	52227030	.	A	C	6	3	9	0	0	9	0	0
5	52227090	.	T	A	5	5	10	0	1	11	0	0
5	52227190	.	T	A	6	8	14	0	1	15	0	0
5	52227570	.	C	T	0	1	1	0	1	2	0	0
5	52234708	.	A	G	3	4	7	0	0	7	0	0
5	52257106	.	A	C	8	0	8	0	7	15	0	0
5	52257299	.	G	A	10	15	25	0	1	26	0	0
5	52257976	.	G	T	8	10	18	0	0	18	0	0
5	52258036	.	G	A	8	9	17	0	3	20	0	0
5	52258234	.	G	A	5	13	18	0	0	18	0	0
5	52258268	.	C	G	6	13	19	0	1	20	0	0
5	52258464	.	T	C	2	0	2	0	18	20	0	0
5	52258518	.	C	T	8	6	14	0	1	15	0	0
5	52258614	.	C	A	4	5	9	0	0	9	0	0
5	52258721	.	C	G	7	3	10	0	0	10	0	0
5	52258921	.	T	G	3	6	9	0	0	9	0	0
5	52259221	.	T	A	5	6	11	0	0	11	0	0
5	52259579	.	A	T	2	3	5	0	0	5	0	0
5	52259825	.	C	A	3	6	9	0	1	10	0	0
5	52264354	.	C	T	0	6	6	0	2	8	0	0
5	52264456	.	C	G	0	6	6	0	7	13	0	0
5	52264549	.	C	T	0	5	5	0	1	6	0	0
5	52264654	.	C	G	1	1	2	0	1	3	0	0
5	52277282	.	G	A	1	5	6	0	0	6	0	0
5	52277390	.	G	A	4	4	8	0	0	8	0	0
5	52277448	.	A	T	2	4	6	0	0	6	0	0
5	52512768	.	A	G	0	2	2	0	0	2	0	0
5	52697519	.	A	C	1	2	3	0	1	4	0	0
5	52698067	.	G	A	2	5	7	0	0	7	0	0
5	52726099	.	G	C	1	0	1	0	0	1	0	0
5	52726111	.	C	T	0	1	1	0	0	1	0	0
5	52730704	.	C	T	5	3	8	0	0	8	0	0
5	52731550	.	C	T	4	7	11	0	0	11	0	0
5	52731678	.	A	T	4	9	13	0	0	13	0	0
5	52731758	.	G	C	5	4	9	0	0	9	0	0
5	52731787	.	G	A	3	8	11	0	1	12	0	0
5	52731919	.	C	A	3	3	6	0	0	6	0	0
5	52732146	.	C	T	5	12	17	0	0	17	0	0
5	52732147	.	G	A	12	5	17	0	0	17	0	0
5	52732383	.	C	T	12	6	18	0	1	19	0	0
5	52732727	.	G	A	4	15	19	0	0	19	0	0
5	52732931	.	C	T	9	11	20	0	1	21	0	0
5	52732991	.	A	G	8	0	8	0	13	21	0	0
5	52733022	.	G	T	13	8	21	0	0	21	0	0
5	52733230	.	G	A	17	15	32	0	0	32	0	0
5	52733259	.	T	G	15	12	27	0	3	30	0	0
5	52733266	.	T	G	13	15	28	0	2	30	0	0
5	52733370	.	A	T	15	13	28	0	2	30	0	0
5	52733411	.	G	A	13	7	20	0	1	21	0	0
5	52745571	.	T	G	3	4	7	0	0	7	0	0
5	52748724	.	T	C	2	3	5	0	0	5	0	0
5	52752479	.	A	G	0	1	1	0	0	1	0	0
5	52783758	.	C	T	1	2	3	0	0	3	0	0
5	52859100	.	C	T	2	2	4	0	1	5	0	0
5	52859751	.	G	T	1	2	3	0	0	3	0	0
5	52860310	.	T	A	1	2	3	0	1	4	0	0
5	52860503	.	A	T	8	6	14	0	0	14	0	0
5	52860701	.	G	T	1	6	7	0	1	8	0	0
5	52860718	.	G	C	3	8	11	0	1	12	0	0
5	52860863	.	G	T	9	8	17	0	1	18	0	0
5	52861213	.	T	C	3	5	8	0	2	10	0	0
5	52861239	.	G	T	0	5	5	0	3	8	0	0
5	52861266	.	A	C	2	2	4	0	0	4	0	0
5	52861818	.	G	A	5	12	17	0	5	22	0	0
5	52937798	.	A	G	3	3	6	0	1	7	0	0
5	52937956	.	A	T	10	5	15	0	0	15	0	0
5	52937988	.	T	A	3	12	15	0	3	18	0	0
5	52938528	.	A	G	5	2	7	0	0	7	0	0
5	52938532	.	T	C	4	2	6	0	1	7	0	0
5	52938742	.	C	T	7	3	10	0	0	10	0	0
5	52938787	.	C	A	3	5	8	0	0	8	0	0
5	52972260	.	A	G	2	7	9	0	0	9	0	0
5	52972323	.	C	A	0	0	0	0	1	1	0	0
5	52988108	.	C	T	3	4	7	0	1	8	0	0
5	52988147	.	C	T	3	4	7	0	0	7	0	0
5	53003463	.	C	G	0	3	3	0	2	5	0	0
5	53003640	.	C	G	4	2	6	0	1	7	0	0
5	53009239	.	T	A	1	1	2	0	1	3	0	0
5	53734556	.	C	T	0	1	1	0	0	1	0	0
5	53748244	.	C	T	2	2	4	0	1	5	0	0
5	53759491	.	A	T	5	5	10	0	3	13	0	0
5	53763009	.	A	T	3	2	5	0	0	5	0	0
5	53865322	.	T	C	1	3	4	0	0	4	0	0
5	53876236	.	A	T	2	0	2	0	0	2	0	0
5	53876244	.	G	A	2	0	2	0	0	2	0	0
5	53899585	.	G	T	11	11	22	0	1	23	0	0
5	53908613	.	T	A	1	2	3	0	0	3	0	0
5	53908722	.	G	T	1	4	5	0	1	6	0	0
5	53908892	.	A	G	2	3	5	0	0	5	0	0
5	53908893	.	G	A	2	3	5	0	0	5	0	0
5	53908957	.	A	T	4	3	7	0	1	8	0	0
5	53909321	.	C	T	2	3	5	0	0	5	0	0
5	53909509	.	G	A	0	3	3	0	1	4	0	0
5	53909914	.	C	T	7	3	10	0	0	10	0	0
5	53910004	.	G	A	6	7	13	0	0	13	0	0
5	53913085	.	A	G	2	3	5	0	0	5	0	0
5	54280436	.	A	T	2	2	4	0	0	4	0	0
5	54280801	.	G	A	3	2	5	0	0	5	0	0
5	54280889	.	G	A	2	1	3	0	0	3	0	0
5	54290289	.	C	A	5	5	10	0	0	10	0	0
5	54297461	.	T	G	2	2	4	0	0	4	0	0
5	54297668	.	C	T	2	1	3	0	0	3	0	0
5	54304666	.	C	G	3	6	9	0	0	9	0	0
5	54304731	.	T	A	1	1	2	0	0	2	0	0
5	54305209	.	G	A	2	4	6	0	0	6	0	0
5	54337575	.	G	A	6	12	18	0	1	19	0	0
5	54337831	.	T	A	6	8	14	0	1	15	0	0
5	54337880	.	T	C	8	0	8	0	13	21	0	0
5	54337902	.	C	T	11	6	17	0	0	17	0	0
5	54337934	.	C	A	8	9	17	0	1	18	0	0
5	54339740	.	C	T	3	2	5	0	0	5	0	0
5	54340047	.	G	A	4	2	6	0	0	6	0	0
5	54342135	.	C	T	1	0	1	0	0	1	0	0
5	54395339	.	T	A	2	2	4	0	0	4	0	0
5	54416392	.	G	C	3	2	5	0	0	5	0	0
5	54416411	.	T	C	2	1	3	0	0	3	0	0
5	54416429	.	T	A	5	1	6	0	0	6	0	0
5	54416446	.	T	C	4	1	5	0	1	6	0	0
5	54416743	.	A	T	1	2	3	0	0	3	0	0
5	54416810	.	C	T	2	8	10	0	0	10	0	0
5	54416820	.	A	G	3	7	10	0	0	10	0	0
5	54458053	.	A	C	7	9	16	0	2	18	0	0
5	54458326	.	G	A	7	12	19	0	0	19	0	0
5	54458345	.	T	A	9	5	14	0	0	14	0	0
5	54458437	.	C	T	10	5	15	0	0	15	0	0
5	54458668	.	C	A	9	6	15	0	1	16	0	0
5	54458791	.	C	G	2	5	7	0	12	19	0	0
5	54458974	.	C	G	10	4	14	0	0	14	0	0
5	54459086	.	G	T	6	3	9	0	1	10	0	0
5	54459454	.	C	T	1	1	2	0	0	2	0	0
5	54459628	.	G	T	1	6	7	0	1	8	0	0
5	54459647	.	A	C	3	6	9	0	0	9	0	0
5	54459682	.	C	T	6	4	10	0	1	11	0	0
5	54460218	.	A	C	2	3	5	0	0	5	0	0
5	54460237	.	T	A	2	4	6	0	0	6	0	0
5	54460259	.	G	A	5	2	7	0	0	7	0	0
5	54460322	.	T	A	8	5	13	0	0	13	0	0
5	54460371	.	T	A	4	3	7	0	2	9	0	0
5	54460460	.	A	G	2	9	11	0	0	11	0	0
5	54460481	.	C	T	0	3	3	0	8	11	0	0
5	54460555	.	G	A	6	2	8	0	1	9	0	0
5	54460558	.	A	T	6	2	8	0	2	10	0	0
5	54470912	.	C	G	4	2	6	0	0	6	0	0
5	54482550	.	G	A	0	1	1	0	0	1	0	0
5	54482561	.	A	C	1	0	1	0	0	1	0	0
5	54482795	.	C	A	3	2	5	0	0	5	0	0
5	54482806	.	C	T	3	2	5	0	0	5	0	0
5	54482927	.	T	C	3	4	7	0	0	7	0	0
5	54493073	.	A	C	0	1	1	0	0	1	0	0
5	54498226	.	G	C	5	4	9	0	1	10	0	0
5	54498255	.	A	C	6	4	10	0	3	13	0	0
5	54498272	.	G	A	6	4	10	0	1	11	0	0
5	54498292	.	C	T	2	3	5	0	1	6	0	0
5	54498363	.	C	T	9	6	15	0	0	15	0	0
5	54498452	.	C	T	9	8	17	0	0	17	0	0
5	54501179	.	C	T	0	3	3	0	2	5	0	0
5	54501485	.	C	T	1	2	3	0	0	3	0	0
5	54502264	.	G	A	1	2	3	0	1	4	0	0
5	54541975	.	C	A	7	2	9	0	0	9	0	0
5	54545553	.	G	C	1	3	4	0	1	5	0	0
5	54558738	.	A	C	1	2	3	0	1	4	0	0
5	54564682	.	C	T	1	0	1	0	0	1	0	0
5	54564835	.	C	T	1	1	2	0	0	2	0	0
5	54572808	.	C	T	2	4	6	0	1	7	0	0
5	54572859	.	T	A	1	1	2	0	0	2	0	0
5	54576127	.	C	T	2	2	4	0	0	4	0	0
5	54576142	.	C	T	2	3	5	0	0	5	0	0
5	54576238	.	G	A	1	3	4	0	1	5	0	0
5	54576562	.	G	T	0	0	0	0	1	1	0	0
5	54579900	.	A	C	1	1	2	0	0	2	0	0
5	54579955	.	C	T	3	4	7	0	1	8	0	0
5	54580125	.	G	A	1	0	1	0	0	1	0	0
5	54652941	.	T	A	8	12	20	0	0	21	1	0
5	54652947	.	C	A	13	8	21	0	0	21	0	0
5	54656583	.	A	G	2	0	2	0	4	6	0	0
5	54656613	.	T	C	3	3	6	0	0	6	0	0
5	54685371	.	A	T	6	7	13	0	0	13	0	0
5	54685445	.	C	A	5	7	12	0	0	12	0	0
5	54712071	.	C	T	3	2	5	0	0	5	0	0
5	54719503	.	A	G	6	3	9	0	0	9	0	0
5	54767361	.	C	A	15	9	24	0	1	25	0	0
5	54767688	.	C	T	19	19	38	0	2	40	0	0
5	54767734	.	T	A	24	10	34	0	1	35	0	0
5	54768993	.	G	T	12	14	26	0	0	26	0	0
5	54769091	.	A	G	6	11	17	0	1	18	0	0
5	54769133	.	A	G	11	6	17	0	0	17	0	0
5	54769896	.	A	G	16	10	26	0	0	26	0	0
5	54769914	.	C	T	15	10	25	0	2	27	0	0
5	54770121	.	T	C	1	0	1	0	0	1	0	0
5	54770370	.	G	A	9	8	17	0	1	18	0	0
5	54770889	.	C	T	2	1	3	0	1	4	0	0
5	54772955	.	T	C	4	2	6	0	1	7	0	0
5	54776408	.	T	C	2	2	4	0	0	4	0	0
5	54776413	.	G	C	1	2	3	0	1	4	0	0
5	54790751	.	A	C	2	3	5	0	0	5	0	0
5	55160567	.	C	G	9	7	16	0	0	16	0	0
5	55160572	.	G	A	7	9	16	0	0	16	0	0
5	55160685	.	C	T	1	4	5	0	0	5	0	0
5	55165175	.	A	T	4	4	8	0	0	8	0	0
5	55168177	.	G	T	16	12	28	0	0	28	0	0
5	55200982	.	C	T	1	2	3	0	0	3	0	0
5	55371908	.	C	T	11	7	18	0	1	19	0	0
5	55372218	.	A	G	15	8	23	0	2	25	0	0
5	55372761	.	G	T	4	3	7	0	1	8	0	0
5	55372773	.	A	T	5	5	10	0	0	10	0	0
5	55373299	.	G	A	14	14	28	0	3	31	0	0
5	55373869	.	G	T	4	4	8	0	0	8	0	0
5	55374343	.	T	A	7	5	12	0	0	12	0	0
5	55374560	.	T	C	2	1	3	0	0	3	0	0
5	55588458	.	T	C	6	5	11	0	0	11	0	0
5	55588562	.	T	C	3	2	5	0	0	5	0	0
5	55600149	.	T	C	2	3	5	0	0	5	0	0
5	55600154	.	A	G	2	3	5	0	0	5	0	0
5	55603894	.	T	C	1	2	3	0	1	4	0	0
5	55604037	.	G	C	13	6	19	1	2	22	0	0
5	55604162	.	G	C	15	5	20	0	4	24	0	0
5	55604211	.	A	T	9	3	12	0	2	14	0	0
5	55604228	.	G	T	5	8	13	0	1	14	0	0
5	55604302	.	A	T	20	1	21	0	1	22	0	0
5	55604438	.	A	G	12	17	29	0	3	32	0	0
5	55609426	.	T	G	24	23	47	0	2	49	0	0
5	55613789	.	G	A	14	15	29	0	0	29	0	0
5	55613813	.	A	C	17	6	23	0	2	25	0	0
5	55613999	.	G	A	2	1	3	0	0	3	0	0
5	55720486	.	C	T	0	6	6	0	9	15	0	0
5	55723534	.	A	G	6	4	10	0	0	10	0	0
5	55763649	.	A	G	19	31	50	0	3	53	0	0
5	55763752	.	G	T	26	24	50	0	4	54	0	0
5	55763884	.	G	A	22	21	43	0	2	45	0	0
5	55764173	.	T	C	11	0	11	0	20	31	0	0
5	55764509	.	G	A	21	24	45	0	1	46	0	0
5	55773856	.	A	G	1	2	3	0	0	3	0	0
5	55873688	.	G	T	0	1	1	0	1	2	0	0
5	55873712	.	C	A	1	2	3	0	0	3	0	0
5	55876508	.	C	G	1	5	6	0	0	6	0	0
5	55876698	.	T	A	1	2	3	0	0	3	0	0
5	55920943	.	A	T	4	3	7	0	0	7	0	0
5	55921076	.	A	T	12	12	24	0	1	25	0	0
5	55921335	.	G	A	11	22	33	0	1	34	0	0
5	55921628	.	T	C	3	4	7	0	1	8	0	0
5	55921931	.	A	G	8	4	12	0	2	14	0	0
5	55928367	.	A	G	1	2	3	0	0	3	0	0
5	55933243	.	T	C	2	3	5	0	1	6	0	0
5	55936430	.	C	A	1	2	3	0	0	3	0	0
5	56100260	.	T	A	1	2	3	0	0	3	0	0
5	56113978	.	C	T	0	2	2	0	1	3	0	0
5	56273737	.	C	T	0	1	1	0	0	1	0	0
5	56274002	.	A	G	1	2	3	0	0	3	0	0
5	56274085	.	T	C	1	2	3	0	0	3	0	0
5	56308816	.	C	T	0	12	12	0	13	25	0	0
5	56308851	.	C	T	9	12	21	0	4	25	0	0
5	56308856	.	C	A	12	10	22	0	2	24	0	0
5	56309013	.	G	C	19	8	27	1	1	29	0	0
5	56309109	.	C	T	0	33	33	0	12	45	0	0
5	56309115	.	A	T	12	34	46	0	0	46	0	0
5	56309244	.	A	G	5	4	9	1	3	13	0	0
5	56309246	.	A	C	5	7	12	1	0	13	0	0
5	56309454	.	A	G	24	8	32	0	2	34	0	0
5	56309517	.	T	C	11	12	23	0	4	27	0	0
5	56309672	.	C	A	0	11	11	0	16	27	0	0
5	56309677	.	C	A	15	9	24	0	3	27	0	0
5	56309761	.	G	C	11	8	19	0	3	22	0	0
5	56309844	.	G	A	20	13	33	0	2	35	0	0
5	56313189	.	A	G	8	9	17	0	4	21	0	0
5	56313207	.	G	A	13	13	26	0	1	27	0	0
5	56317153	.	T	A	6	7	13	0	0	13	0	0
5	56317170	.	C	T	1	4	5	0	0	5	0	0
5	56317377	.	G	A	10	9	19	0	0	19	0	0
5	56322148	.	A	G	8	8	16	0	1	17	0	0
5	56322205	.	C	T	10	10	20	0	3	23	0	0
5	56322404	.	A	G	1	4	5	0	1	6	0	0
5	56322449	.	T	C	1	3	4	0	1	5	0	0
5	56322467	.	G	A	0	2	2	0	2	4	0	0
5	56326387	.	A	G	0	1	1	0	0	1	0	0
5	56340613	.	A	G	2	3	5	0	1	6	0	0
5	56343032	.	C	T	0	3	3	0	2	5	0	0
5	56343095	.	C	T	2	2	4	0	0	4	0	0
5	56345091	.	A	G	1	3	4	0	0	4	0	0
5	56345109	.	A	G	3	3	6	0	0	6	0	0
5	56345138	.	T	G	4	4	8	0	0	8	0	0
5	56376741	.	T	G	0	1	1	0	0	1	0	0
5	56918932	.	G	A	6	6	12	0	0	12	0	0
5	56918974	.	A	G	5	4	9	0	0	9	0	0
5	56920385	.	A	T	1	1	2	0	0	2	0	0
5	56927749	.	G	T	2	2	4	0	0	4	0	0
5	56927898	.	G	A	2	2	4	0	0	4	0	0
5	56934960	.	A	G	2	2	4	0	0	4	0	0
5	56935240	.	A	G	1	1	2	0	0	2	0	0
5	56951015	.	A	C	6	0	6	0	24	30	0	0
5	56951081	.	T	C	10	16	26	0	3	29	0	0
5	56951144	.	A	T	6	11	17	0	2	19	0	0
5	56951156	.	C	T	16	8	24	0	1	25	0	0
5	56951220	.	C	T	13	15	28	0	3	31	0	0
5	56951258	.	A	C	10	9	19	0	2	21	0	0
5	56951686	.	G	A	6	4	10	0	0	10	0	0
5	56951830	.	T	A	10	4	14	0	3	17	0	0
5	56958513	.	C	T	3	2	5	0	0	5	0	0
5	56964475	.	G	A	3	4	7	0	0	7	0	0
5	57217249	.	G	A	0	1	1	0	0	1	0	0
5	57217343	.	T	G	1	2	3	0	0	3	0	0
5	57219429	.	T	C	5	2	7	0	0	7	0	0
5	57219430	.	T	A	5	2	7	0	0	7	0	0
5	57219496	.	G	A	1	5	6	0	2	8	0	0
5	57219789	.	C	T	3	4	7	0	0	7	0	0
5	57219938	.	G	C	0	5	5	0	7	12	0	0
5	57219990	.	C	A	3	2	5	0	0	5	0	0
5	57220108	.	G	A	0	4	4	0	4	8	0	0
5	57220262	.	A	T	1	4	5	0	0	5	0	0
5	57220324	.	T	C	1	0	1	0	1	2	0	0
5	57225332	.	C	T	0	2	2	0	2	4	0	0
5	57225343	.	C	T	3	2	5	0	0	5	0	0
5	57226522	.	T	C	1	1	2	0	1	3	0	0
5	57234053	.	A	C	3	3	6	0	3	9	0	0
5	57234074	.	C	T	2	4	6	0	0	6	0	0
5	57320235	.	C	T	28	27	55	0	5	60	0	0
5	57320274	.	G	A	31	19	50	0	3	53	0	0
5	57325158	.	T	G	31	26	57	0	4	61	0	0
5	57325204	.	T	G	30	0	30	0	30	60	0	0
5	57325210	.	G	A	29	28	57	0	4	61	0	0
5	57325359	.	G	A	37	20	57	0	5	63	1	0
5	57352465	.	G	C	3	3	6	0	0	6	0	0
5	57353387	.	T	C	2	6	8	0	0	8	0	0
5	57353616	.	T	A	6	6	12	0	2	14	0	0
5	57353886	.	C	T	4	4	8	0	0	8	0	0
5	57353959	.	C	A	6	5	11	0	4	15	0	0
5	57353981	.	C	T	8	5	13	0	2	15	0	0
5	57354046	.	G	A	3	8	11	0	0	11	0	0
5	57354061	.	G	A	0	2	2	0	6	8	0	0
5	57354096	.	A	G	2	2	4	0	0	4	0	0
5	57354302	.	A	G	10	4	14	0	1	15	0	0
5	57354311	.	G	A	14	3	17	0	3	20	0	0
5	57354552	.	C	T	3	7	10	0	1	11	0	0
5	57354656	.	A	G	5	5	10	0	0	10	0	0
5	57354680	.	G	A	0	12	12	0	6	18	0	0
5	57354719	.	T	G	6	15	21	0	0	21	0	0
5	57354786	.	G	T	6	8	14	0	1	15	0	0
5	57354832	.	C	A	1	5	6	0	1	7	0	0
5	57354839	.	A	G	6	0	6	0	1	7	0	0
5	57359588	.	C	A	1	1	2	0	1	3	0	0
5	57359740	.	G	A	11	11	22	0	0	22	0	0
5	57359811	.	A	G	9	14	23	0	1	24	0	0
5	57361015	.	G	T	9	14	23	0	0	23	0	0
5	57446925	.	G	A	2	1	3	0	0	3	0	0
5	57453587	.	T	C	9	5	14	0	2	16	0	0
5	57453635	.	T	C	10	3	13	0	0	13	0	0
5	57489821	.	G	A	9	16	25	0	2	27	0	0
5	57500086	.	T	C	8	6	14	0	0	14	0	0
5	57505050	.	C	T	5	3	8	0	0	8	0	0
5	57506568	.	A	C	2	4	6	0	0	6	0	0
5	57514428	.	G	A	5	5	10	0	0	10	0	0
5	57635542	.	A	T	1	2	3	0	0	3	0	0
5	57641751	.	C	T	3	0	3	0	0	3	0	0
5	57641808	.	T	C	3	2	5	0	0	5	0	0
5	57641811	.	T	C	2	2	4	0	0	4	0	0
5	57644184	.	T	G	2	1	3	0	1	4	0	0
5	57644256	.	G	A	4	3	7	0	0	7	0	0
5	57644280	.	G	A	3	4	7	0	2	9	0	0
5	57644813	.	A	T	1	2	3	0	0	3	0	0
5	57644833	.	G	C	1	2	3	0	0	3	0	0
5	57645325	.	T	C	1	4	5	0	1	6	0	0
5	57650695	.	C	T	4	4	8	0	0	8	0	0
5	57650699	.	C	A	4	4	8	0	0	8	0	0
5	57693556	.	A	G	3	4	7	0	0	7	0	0
5	57693577	.	G	A	4	4	8	0	0	8	0	0
5	57693607	.	T	G	3	5	8	0	0	8	0	0
5	57693625	.	C	A	1	5	6	0	0	6	0	0
5	57693709	.	T	C	3	3	6	0	0	6	0	0
5	57693730	.	G	A	2	2	4	0	0	4	0	0
5	57700098	.	T	C	1	0	1	0	1	2	0	0
5	57715904	.	T	C	7	13	20	0	0	20	0	0
5	57718478	.	G	T	4	4	8	0	1	9	0	0
5	57718614	.	C	A	2	4	6	0	1	7	0	0
5	57718649	.	A	G	16	0	16	0	0	16	0	0
5	57718659	.	C	T	9	15	24	0	1	26	1	0
5	57737337	.	A	G	1	2	3	0	0	3	0	0
5	57737427	.	G	A	0	2	2	0	6	8	0	0
5	57737460	.	C	T	8	2	10	0	0	10	0	0
5	57737504	.	C	A	1	9	10	0	0	10	0	0
5	57737727	.	A	T	2	5	7	0	0	7	0	0
5	57737862	.	T	A	2	6	8	0	0	8	0	0
5	57737863	.	A	C	2	6	8	0	0	8	0	0
5	57738078	.	C	T	2	4	6	0	0	6	0	0
5	57738233	.	C	T	3	6	9	0	0	9	0	0
5	57738321	.	G	A	3	3	6	0	0	6	0	0
5	57743868	.	G	A	3	2	5	0	1	6	0	0
5	57743907	.	A	G	2	4	6	0	2	8	0	0
5	57744681	.	C	T	4	1	5	0	0	5	0	0
5	57751676	.	T	A	0	1	1	0	1	2	0	0
5	57753821	.	C	T	1	1	2	0	0	2	0	0
5	57753827	.	A	G	1	0	1	0	1	2	0	0
5	57762390	.	A	G	4	1	5	0	1	6	0	0
5	57762468	.	G	T	16	23	39	0	1	40	0	0
5	57762479	.	A	T	16	24	40	0	1	41	0	0
5	57762529	.	C	T	19	16	35	0	3	38	0	0
5	57762656	.	T	G	17	23	40	0	0	40	0	0
5	57762849	.	A	T	6	24	30	0	0	30	0	0
5	57762868	.	A	G	6	21	27	0	1	28	0	0
5	57762900	.	T	C	6	15	21	0	3	24	0	0
5	57762938	.	A	T	11	18	29	0	2	31	0	0
5	57762986	.	C	G	12	10	22	0	2	24	0	0
5	57787630	.	C	T	9	5	14	0	2	16	0	0
5	57790583	.	G	A	20	13	33	0	2	35	0	0
5	57797085	.	A	C	14	16	30	0	4	34	0	0
5	57797770	.	T	C	12	31	43	0	3	46	0	0
5	57797774	.	T	C	11	30	41	0	5	46	0	0
5	57797844	.	C	T	23	25	48	0	10	58	0	0
5	57797887	.	A	T	28	30	58	0	2	60	0	0
5	57797954	.	T	C	26	13	39	0	0	39	0	0
5	57814454	.	C	A	3	2	5	0	0	5	0	0
5	57814627	.	G	A	7	5	12	0	2	14	0	0
5	57814630	.	T	C	3	1	4	0	10	14	0	0
5	58075599	.	C	T	3	0	3	0	0	3	0	0
5	58081110	.	C	T	0	1	1	0	1	2	0	0
5	58372217	.	G	A	9	3	12	0	2	15	1	0
5	58372226	.	C	T	10	12	22	0	3	25	0	0
5	58372268	.	T	C	12	19	31	0	2	33	0	0
5	58372286	.	G	A	13	4	17	0	2	19	0	0
5	58382358	.	C	T	7	48	55	0	3	58	0	0
5	58382458	.	T	A	14	6	20	0	0	20	0	0
5	58412403	.	T	C	2	4	6	0	0	6	0	0
5	58450455	.	T	C	1	3	4	0	0	4	0	0
5	58459476	.	A	C	1	1	2	0	0	2	0	0
5	58500411	.	C	T	1	2	3	0	0	3	0	0
5	58500489	.	G	A	1	0	1	0	0	1	0	0
5	58504447	.	G	T	1	0	1	0	0	1	0	0
5	58504562	.	G	T	1	0	1	0	0	1	0	0
5	58504613	.	C	G	0	2	2	0	0	2	0	0
5	58511553	.	T	C	3	2	5	0	0	5	0	0
5	58687623	.	A	T	8	5	13	0	1	14	0	0
5	58687649	.	C	A	10	6	16	0	2	18	0	0
5	58687673	.	T	C	11	3	14	0	1	15	0	0
5	58687739	.	G	A	0	1	1	0	0	1	0	0
5	58688749	.	A	G	0	1	1	0	0	1	0	0
5	58695764	.	G	A	0	13	13	0	5	18	0	0
5	58696412	.	A	C	7	12	19	0	0	19	0	0
5	58696420	.	C	G	13	6	19	0	0	19	0	0
5	58696905	.	C	G	7	7	14	0	0	14	0	0
5	58699888	.	C	T	1	0	1	0	0	1	0	0
5	58704272	.	C	T	6	3	9	0	0	9	0	0
5	58711159	.	G	T	2	2	4	0	0	4	0	0
5	58713213	.	C	T	0	3	3	0	4	7	0	0
5	58713579	.	C	T	0	1	1	0	0	1	0	0
5	58717618	.	A	T	1	0	1	0	0	1	0	0
5	58719797	.	C	T	2	3	5	0	2	7	0	0
5	58721406	.	C	T	0	3	3	0	8	11	0	0
5	58730739	.	G	A	1	2	3	0	1	4	0	0
5	58850871	.	G	T	14	17	31	0	11	42	0	0
5	58850923	.	A	C	16	21	37	0	2	39	0	0
5	58851297	.	T	A	12	8	20	0	4	24	0	0
5	58851789	.	A	C	11	0	11	0	20	32	1	0
5	58851865	.	T	C	13	0	13	0	18	31	0	0
5	58851925	.	G	A	17	11	28	0	3	31	0	0
5	58851938	.	C	T	17	7	24	0	2	26	0	0
5	58852164	.	T	C	15	5	20	0	2	22	0	0
5	58852223	.	A	T	11	19	30	0	0	30	0	0
5	58852515	.	A	G	2	4	6	0	0	6	0	0
5	58852758	.	C	A	8	6	14	0	0	14	0	0
5	58852825	.	A	C	10	7	17	0	0	17	0	0
5	58852864	.	T	G	2	6	8	0	1	9	0	0
5	58852925	.	T	G	4	3	7	0	1	8	0	0
5	58853407	.	C	T	6	2	8	0	1	10	1	0
5	58853711	.	T	A	7	9	16	0	0	16	0	0
5	58866495	.	C	T	2	2	4	0	1	5	0	0
5	58875058	.	A	G	4	2	6	0	0	6	0	0
5	58875140	.	C	G	0	1	1	0	0	1	0	0
5	58993040	.	G	A	1	2	3	0	0	3	0	0
5	59060620	.	C	T	2	3	5	0	0	5	0	0
5	59060855	.	C	T	1	2	3	0	0	3	0	0
5	59079919	.	G	A	0	2	2	0	5	7	0	0
5	59079932	.	C	T	2	3	5	0	2	7	0	0
5	59080452	.	G	T	0	11	11	0	5	16	0	0
5	59080526	.	T	A	5	9	14	0	0	14	0	0
5	59080874	.	A	G	4	2	6	0	0	6	0	0
5	59081870	.	C	T	0	2	2	0	0	2	0	0
5	59082495	.	C	A	9	13	22	0	0	22	0	0
5	59082540	.	C	T	8	6	14	0	1	15	0	0
5	59082581	.	T	A	6	8	14	0	0	15	1	0
5	59082882	.	C	T	7	21	28	0	2	30	0	0
5	59083136	.	T	G	13	9	22	0	5	27	0	0
5	59083201	.	T	A	7	8	15	0	0	15	0	0
5	59092513	.	A	G	1	3	4	0	0	4	0	0
5	59092644	.	G	A	0	3	3	0	0	3	0	0
5	59100577	.	G	A	1	3	4	0	0	4	0	0
5	59101813	.	G	A	1	1	2	0	0	2	0	0
5	59101933	.	G	A	2	2	4	0	2	6	0	0
5	59198649	.	C	G	3	4	7	0	1	8	0	0
5	59200130	.	A	G	4	2	6	0	0	6	0	0
5	59200153	.	T	G	1	6	7	0	0	7	0	0
5	59200211	.	C	T	2	6	8	0	0	8	0	0
5	59200270	.	T	A	4	6	10	0	0	10	0	0
5	59200435	.	T	G	3	3	6	0	0	6	0	0
5	59200444	.	G	A	2	2	4	0	0	4	0	0
5	59201690	.	T	C	3	3	6	0	0	6	0	0
5	59201785	.	T	G	3	9	12	0	1	13	0	0
5	59201825	.	G	A	2	11	13	0	1	14	0	0
5	59201883	.	T	G	8	8	16	0	1	17	0	0
5	59201947	.	A	G	5	9	14	0	5	19	0	0
5	59202206	.	C	T	1	3	4	0	0	4	0	0
5	59234451	.	G	T	3	4	7	0	0	7	0	0
5	59239773	.	C	G	1	3	4	0	0	4	0	0
5	59239851	.	G	A	2	0	2	0	0	2	0	0
5	59247894	.	A	G	2	2	4	0	0	4	0	0
5	59248038	.	C	G	8	4	12	0	1	13	0	0
5	59248067	.	T	C	4	2	6	0	0	6	0	0
5	59248156	.	A	G	3	0	3	0	4	7	0	0
5	59248162	.	T	C	4	4	8	0	0	8	0	0
5	59278569	.	G	A	1	2	3	0	0	3	0	0
5	59386512	.	C	G	3	2	5	0	2	7	0	0
5	59387021	.	T	A	3	0	3	0	2	5	0	0
5	59387024	.	C	T	4	1	5	0	0	5	0	0
5	59387075	.	A	C	3	0	3	0	0	3	0	0
5	59387094	.	A	T	0	2	2	0	0	2	0	0
5	59387120	.	C	T	0	3	3	0	0	3	0	0
5	59388449	.	G	A	1	4	5	0	3	8	0	0
5	59388479	.	G	A	3	3	6	0	0	6	0	0
5	59388660	.	A	G	5	11	16	0	0	16	0	0
5	59388686	.	C	T	2	7	9	0	1	10	0	0
5	59389014	.	G	A	13	6	19	0	0	19	0	0
5	59389101	.	G	A	7	2	9	0	1	10	0	0
5	59389107	.	G	A	7	3	10	0	0	10	0	0
5	59389688	.	G	A	8	9	17	0	0	17	0	0
5	59419954	.	C	T	1	2	3	0	0	3	0	0
5	59420096	.	T	C	1	3	4	0	0	4	0	0
5	59420111	.	G	A	0	4	4	0	0	4	0	0
5	59420414	.	G	T	0	3	3	0	3	6	0	0
5	59449767	.	C	T	2	5	7	0	1	8	0	0
5	59462457	.	G	A	1	1	2	0	0	2	0	0
5	59462595	.	C	T	2	5	7	0	0	7	0	0
5	59462663	.	C	T	4	2	6	0	0	6	0	0
5	59462679	.	C	T	3	4	7	0	0	7	0	0
5	59462829	.	T	G	6	4	10	0	0	10	0	0
5	59462881	.	G	A	3	2	5	0	1	6	0	0
5	59462994	.	A	T	6	2	8	0	0	8	0	0
5	59463183	.	G	T	2	5	7	0	0	7	0	0
5	59463213	.	T	C	6	2	8	0	1	9	0	0
5	59463261	.	C	A	3	7	10	0	0	10	0	0
5	59473885	.	A	C	1	2	3	0	0	3	0	0
5	59479818	.	C	G	7	1	8	0	0	9	1	0
5	59479973	.	C	T	5	6	11	0	1	12	0	0
5	59538782	.	C	T	1	2	3	0	0	3	0	0
5	59544327	.	C	T	2	3	5	0	0	5	0	0
5	59549182	.	G	A	2	5	7	0	0	7	0	0
5	59549382	.	A	G	4	3	7	0	2	9	0	0
5	59549389	.	G	A	7	3	10	0	1	11	0	0
5	59550260	.	A	T	4	4	8	0	0	8	0	0
5	59550529	.	T	G	3	3	6	0	0	6	0	0
5	59550725	.	G	T	2	4	6	0	0	6	0	0
5	59559881	.	C	T	4	3	7	0	0	7	0	0
5	59559905	.	T	C	4	3	7	0	1	8	0	0
5	59560110	.	T	C	3	8	11	0	0	11	0	0
5	59560131	.	A	G	0	0	0	0	8	8	0	0
5	59584626	.	C	T	3	5	8	0	0	8	0	0
5	59589199	.	G	A	0	3	3	0	2	5	0	0
5	59593297	.	G	C	0	3	3	0	8	11	0	0
5	59593363	.	C	T	4	6	10	0	0	10	0	0
5	59593408	.	G	T	4	7	11	0	2	13	0	0
5	59593523	.	C	T	2	2	4	0	2	6	0	0
5	59593623	.	C	T	7	7	14	0	0	14	0	0
5	59593822	.	G	T	1	3	4	0	2	6	0	0
5	59594222	.	A	G	5	3	8	0	0	8	0	0
5	59594328	.	T	C	4	6	10	0	0	10	0	0
5	59594507	.	A	C	13	5	18	0	0	18	0	0
5	59594544	.	C	T	14	5	19	0	1	20	0	0
5	59594648	.	A	T	3	12	15	0	0	15	0	0
5	59594762	.	G	A	6	5	11	0	0	11	0	0
5	59594951	.	T	A	5	3	8	0	0	8	0	0
5	59595193	.	G	A	7	5	12	0	0	12	0	0
5	59595307	.	C	A	8	7	15	0	2	17	0	0
5	59595339	.	G	A	10	7	17	0	3	20	0	0
5	59595360	.	A	G	11	5	16	0	1	17	0	0
5	59595407	.	G	A	13	11	24	0	3	27	0	0
5	60685481	.	G	A	6	14	20	0	0	20	0	0
5	60685513	.	A	G	12	6	18	0	0	18	0	0
5	60685758	.	T	C	7	4	11	0	0	11	0	0
5	60685822	.	C	T	9	4	13	0	0	13	0	0
5	60685851	.	G	A	6	4	10	0	0	10	0	0
5	60685952	.	A	C	3	7	10	0	0	10	0	0
5	60686374	.	A	T	2	5	7	0	1	8	0	0
5	60686380	.	C	A	2	5	7	0	2	9	0	0
5	60686409	.	G	A	4	4	8	0	0	8	0	0
5	60686686	.	C	G	4	6	10	0	0	10	0	0
5	60686784	.	G	T	7	3	10	0	0	10	0	0
5	60687344	.	A	T	5	4	9	0	0	9	0	0
5	60850638	.	T	C	1	3	4	0	0	4	0	0
5	60867936	.	A	G	5	4	9	0	0	9	0	0
5	60868173	.	G	A	0	3	3	0	2	5	0	0
5	60868216	.	G	A	2	2	4	0	0	4	0	0
5	60871999	.	A	T	6	7	13	0	0	13	0	0
5	60872258	.	C	T	1	4	5	0	0	5	0	0
5	60872639	.	G	A	0	7	7	0	3	10	0	0
5	60872708	.	T	C	5	6	11	0	0	11	0	0
5	60872951	.	G	T	0	3	3	0	1	4	0	0
5	60872966	.	T	A	1	3	4	0	0	4	0	0
5	60894675	.	G	A	0	4	4	0	0	4	0	0
5	60906002	.	C	T	0	2	2	0	0	2	0	0
5	61270901	.	G	A	4	6	10	0	1	11	0	0
5	61270905	.	C	T	5	4	9	0	2	11	0	0
5	61325345	.	A	T	3	5	8	0	0	8	0	0
5	61329486	.	G	A	4	3	7	0	1	8	0	0
5	61329508	.	G	C	4	3	7	0	1	8	0	0
5	61329650	.	A	G	4	8	12	0	1	13	0	0
5	61349991	.	C	T	0	2	2	0	0	2	0	0
5	61351851	.	C	T	1	0	1	0	0	1	0	0
5	61354097	.	A	C	2	5	7	0	4	11	0	0
5	61354264	.	A	G	7	5	12	0	1	13	0	0
5	61380103	.	T	A	7	4	11	0	2	13	0	0
5	61380130	.	C	T	8	10	18	0	0	18	0	0
5	61389725	.	T	C	12	8	20	0	0	20	0	0
5	61396054	.	G	A	3	3	6	0	0	6	0	0
5	61401915	.	C	T	6	6	12	0	0	12	0	0
5	61402030	.	G	A	7	12	19	0	3	22	0	0
5	61402366	.	G	C	10	6	16	0	3	19	0	0
5	61402440	.	T	C	10	13	23	0	1	24	0	0
5	61402479	.	G	A	10	19	29	0	4	33	0	0
5	61402532	.	C	T	15	11	26	0	7	33	0	0
5	61402534	.	T	A	18	11	29	0	4	33	0	0
5	61402570	.	T	C	20	13	33	0	2	35	0	0
5	61403005	.	A	T	10	12	22	0	6	28	0	0
5	61404613	.	C	A	5	2	7	0	0	7	0	0
5	61404702	.	A	T	3	2	5	0	1	6	0	0
5	61414618	.	A	T	9	3	12	0	0	12	0	0
5	61429013	.	C	A	2	7	9	0	0	9	0	0
5	61459502	.	T	C	3	1	4	0	1	5	0	0
5	61464874	.	G	T	17	9	26	0	1	27	0	0
5	61472457	.	C	T	3	6	9	0	0	9	0	0
5	61552554	.	T	C	12	5	17	0	1	18	0	0
5	61552591	.	A	T	15	11	26	0	1	27	0	0
5	61552620	.	G	C	18	8	26	0	3	29	0	0
5	61552724	.	G	T	7	4	11	0	1	12	0	0
5	61552808	.	T	A	11	9	20	0	0	20	0	0
5	61552836	.	T	A	8	11	19	0	2	21	0	0
5	61553207	.	C	T	4	4	8	0	0	8	0	0
5	61553252	.	G	T	4	13	17	0	1	18	0	0
5	61553309	.	A	G	5	0	5	0	9	14	0	0
5	61553418	.	G	A	8	11	19	0	0	19	0	0
5	61553517	.	G	T	14	9	23	0	4	27	0	0
5	61553556	.	A	T	8	11	19	0	2	21	0	0
5	61553611	.	T	G	18	0	18	0	0	18	0	0
5	61553614	.	C	T	18	0	18	0	0	18	0	0
5	61553702	.	A	T	18	13	31	0	2	33	0	0
5	61553852	.	A	T	12	7	19	0	0	19	0	0
5	61570931	.	C	T	1	2	3	0	0	3	0	0
5	61584008	.	A	T	5	5	10	0	2	12	0	0
5	61584010	.	A	T	5	6	11	0	1	12	0	0
5	61588989	.	C	T	2	2	4	0	2	6	0	0
5	61676700	.	T	G	7	6	13	0	0	13	0	0
5	61676739	.	A	C	4	2	6	0	0	6	0	0
5	61682577	.	C	T	2	1	3	0	0	3	0	0
5	61682715	.	A	C	6	4	10	0	1	11	0	0
5	61682721	.	C	T	6	6	12	0	1	13	0	0
5	61698770	.	C	T	4	1	5	0	1	7	1	0
5	61701969	.	C	A	4	5	9	0	0	9	0	0
5	61712754	.	C	T	13	6	19	0	1	20	0	0
5	61723061	.	G	A	28	26	54	0	5	59	0	0
5	61723180	.	T	C	24	30	54	0	2	56	0	0
5	61723366	.	A	G	23	21	44	0	3	47	0	0
5	61723637	.	A	G	18	19	37	0	2	39	0	0
5	61723694	.	T	G	15	23	38	0	2	40	0	0
5	61723914	.	T	C	26	26	52	0	3	55	0	0
5	61723979	.	C	T	16	4	20	0	0	20	0	0
5	61723981	.	G	A	16	3	19	0	1	20	0	0
5	61724055	.	G	A	0	4	4	0	8	12	0	0
5	61790220	.	G	A	2	4	6	0	0	6	0	0
5	61790442	.	C	G	0	3	3	0	3	6	0	0
5	61790460	.	G	T	2	3	5	0	0	5	0	0
5	61790501	.	A	T	2	1	3	0	1	4	0	0
5	61791376	.	G	A	2	0	2	0	0	2	0	0
5	61799766	.	G	A	7	6	13	0	1	14	0	0
5	61801070	.	G	A	7	4	11	0	0	11	0	0
5	61804538	.	C	T	0	1	1	0	0	1	0	0
5	61806498	.	T	C	1	3	4	0	0	4	0	0
5	61817051	.	A	T	20	20	40	0	1	41	0	0
5	61877517	.	G	A	0	2	2	0	0	2	0	0
5	61881101	.	C	T	2	2	4	0	0	4	0	0
5	61881353	.	A	G	1	1	2	0	1	3	0	0
5	61884167	.	G	A	6	5	11	0	0	11	0	0
5	61884460	.	C	T	9	9	18	0	0	18	0	0
5	61884478	.	C	T	9	11	20	0	2	22	0	0
5	61884514	.	C	T	9	11	20	0	2	22	0	0
5	61886601	.	C	T	8	9	17	0	0	17	0	0
5	61886622	.	G	A	11	10	21	0	1	22	0	0
5	61889572	.	C	G	4	2	6	0	1	7	0	0
5	61890223	.	G	A	0	15	15	0	11	26	0	0
5	61890336	.	A	T	11	3	14	0	1	15	0	0
5	61928415	.	C	T	3	2	5	0	0	5	0	0
5	61930715	.	A	T	14	5	19	0	2	21	0	0
5	61931392	.	A	G	17	21	38	0	7	45	0	0
5	61931409	.	C	T	23	17	40	0	1	41	0	0
5	61931782	.	A	C	3	2	5	0	0	5	0	0
5	61932319	.	C	T	8	5	13	0	0	13	0	0
5	61932332	.	C	T	5	8	13	0	1	14	0	0
5	61932383	.	G	A	6	7	13	0	0	13	0	0
5	61932568	.	T	C	3	22	25	0	1	26	0	0
5	61932706	.	C	G	7	9	16	0	0	16	0	0
5	61932707	.	T	G	7	8	15	0	1	16	0	0
5	61932754	.	G	C	16	11	27	0	0	27	0	0
5	61934446	.	T	C	2	0	2	0	0	2	0	0
5	61934579	.	C	T	1	1	2	0	0	2	0	0
5	61948214	.	C	T	2	2	4	0	0	4	0	0
5	61949549	.	T	G	5	3	8	0	0	8	0	0
5	61949624	.	C	T	5	4	9	0	0	9	0	0
5	61950345	.	T	G	2	3	5	0	0	5	0	0
5	61950573	.	A	G	2	5	7	0	1	8	0	0
5	61950834	.	A	T	2	3	5	0	1	6	0	0
5	61951038	.	A	G	6	6	12	0	2	14	0	0
5	61998644	.	C	T	4	13	17	0	1	18	0	0
5	62004552	.	C	T	0	1	1	0	0	1	0	0
5	62004561	.	A	G	4	2	6	0	1	7	0	0
5	62004999	.	A	G	10	12	22	0	2	25	1	0
5	62005005	.	G	T	10	13	23	0	0	23	0	0
5	62005054	.	C	T	4	4	8	0	0	8	0	0
5	62038700	.	C	A	3	2	5	0	1	6	0	0
5	62042450	.	A	G	0	3	3	0	0	3	0	0
5	62288882	.	T	C	1	4	5	0	1	6	0	0
5	62288960	.	C	T	2	6	8	0	1	9	0	0
5	62289032	.	A	T	2	4	6	0	0	6	0	0
5	62289478	.	A	G	4	2	6	0	0	6	0	0
5	62290516	.	G	T	0	3	3	0	3	6	0	0
5	62290568	.	A	T	3	3	6	0	0	6	0	0
5	62290605	.	T	C	4	2	6	0	1	7	0	0
5	62290844	.	G	A	4	5	9	0	0	9	0	0
5	62290869	.	A	T	3	4	7	0	0	7	0	0
5	62290904	.	T	C	2	7	9	0	0	9	0	0
5	62290931	.	T	C	2	4	6	0	0	6	0	0
5	62290956	.	T	C	3	3	6	0	1	7	0	0
5	62311639	.	C	A	4	2	6	0	0	6	0	0
5	62329102	.	C	T	0	2	2	0	0	2	0	0
5	62330124	.	C	T	2	3	5	0	0	5	0	0
5	62330389	.	A	G	3	3	6	0	0	6	0	0
5	62330438	.	G	A	0	3	3	0	3	6	0	0
5	62330661	.	G	A	0	2	2	0	0	2	0	0
5	62330737	.	C	G	1	7	8	0	0	8	0	0
5	62331120	.	T	C	3	2	5	0	0	5	0	0
5	62331123	.	A	T	3	2	5	0	0	5	0	0
5	62331255	.	T	C	1	3	4	0	1	5	0	0
5	62331364	.	G	A	2	3	5	0	1	6	0	0
5	62331365	.	T	A	3	3	6	0	0	6	0	0
5	62331427	.	A	T	3	2	5	0	0	5	0	0
5	62331478	.	C	A	3	2	5	0	0	5	0	0
5	62331516	.	A	T	1	5	6	0	0	6	0	0
5	62331519	.	A	G	1	5	6	0	0	6	0	0
5	62331675	.	G	A	4	3	7	0	1	8	0	0
5	62331897	.	C	T	3	4	7	0	1	8	0	0
5	62331932	.	T	G	8	4	12	0	1	13	0	0
5	62331999	.	G	T	3	2	5	0	2	7	0	0
5	62332112	.	G	A	8	2	10	0	0	10	0	0
5	62332231	.	A	C	4	3	7	0	0	7	0	0
5	62332491	.	G	A	5	9	14	0	0	14	0	0
5	62332508	.	G	A	5	7	12	0	0	12	0	0
5	62332735	.	C	T	4	3	7	0	0	7	0	0
5	62332756	.	A	T	2	3	5	0	0	5	0	0
5	62332773	.	C	G	1	2	3	0	0	3	0	0
5	62333198	.	C	A	3	1	4	1	0	5	0	0
5	62333534	.	A	C	3	2	5	0	0	6	1	0
5	62333740	.	T	G	4	2	6	0	0	6	0	0
5	62334121	.	G	C	4	4	8	0	3	11	0	0
5	62334164	.	G	A	5	6	11	0	1	12	0	0
5	62334610	.	C	T	5	4	9	0	0	9	0	0
5	62334738	.	A	C	3	2	5	0	0	5	0	0
5	62334754	.	G	A	1	1	2	0	0	2	0	0
5	62334788	.	A	G	1	1	2	0	1	3	0	0
5	62334843	.	G	T	5	5	10	0	2	12	0	0
5	62334980	.	G	A	6	1	7	0	3	10	0	0
5	62335079	.	A	G	5	0	5	0	6	11	0	0
5	62335089	.	A	G	3	0	3	0	8	11	0	0
5	62335167	.	T	C	4	3	7	0	1	8	0	0
5	62335297	.	C	A	3	2	5	0	2	7	0	0
5	62335337	.	A	T	2	3	5	0	0	5	0	0
5	62335641	.	T	A	3	5	8	0	0	8	0	0
5	62335655	.	G	T	2	4	6	0	0	6	0	0
5	62521757	.	C	A	2	3	5	0	0	5	0	0
5	62526295	.	C	T	4	3	7	0	0	7	0	0
5	62533737	.	C	T	1	0	1	0	0	1	0	0
5	62637753	.	A	C	7	4	11	0	1	12	0	0
5	62639596	.	G	A	17	12	29	0	4	33	0	0
5	62642989	.	A	G	15	6	21	3	1	25	0	0
5	62806675	.	A	G	7	12	19	0	0	19	0	0
5	62806701	.	A	G	4	12	16	0	1	17	0	0
5	62806902	.	T	C	5	0	5	0	6	11	0	0
5	62806918	.	G	C	4	4	8	0	2	10	0	0
5	62806951	.	A	G	5	3	8	0	0	8	0	0
5	62807294	.	G	A	6	3	9	0	0	9	0	0
5	62807357	.	G	A	4	1	5	0	1	6	0	0
5	62821214	.	A	T	3	2	5	0	0	5	0	0
5	62868303	.	T	C	1	2	3	0	0	3	0	0
5	62883587	.	C	T	2	5	7	0	0	7	0	0
5	62885777	.	A	G	2	3	5	0	0	5	0	0
5	62885835	.	C	T	2	3	5	0	0	5	0	0
5	62885838	.	G	A	2	2	4	0	0	4	0	0
5	62889966	.	C	G	1	3	4	0	0	4	0	0
5	62890593	.	C	T	0	2	2	0	1	3	0	0
5	62890650	.	C	T	2	3	5	0	0	5	0	0
5	62890740	.	C	T	1	3	4	0	0	4	0	0
5	63089582	.	T	G	1	0	1	0	0	1	0	0
5	63201014	.	T	G	0	2	2	0	0	2	0	0
5	63305610	.	T	C	2	5	7	0	0	7	0	0
5	63359936	.	G	A	2	1	3	0	1	4	0	0
5	63360227	.	G	C	1	2	3	0	0	3	0	0
5	63360284	.	C	T	2	2	4	0	0	4	0	0
5	63360290	.	A	G	2	1	3	0	0	3	0	0
5	63360344	.	T	C	2	1	3	0	0	3	0	0
5	63362978	.	G	A	1	2	3	0	0	3	0	0
5	63363058	.	C	T	1	2	3	0	0	3	0	0
5	63373157	.	T	C	2	0	2	0	0	2	0	0
5	63376108	.	C	T	1	2	3	0	0	3	0	0
5	63386817	.	G	C	1	3	4	0	0	4	0	0
5	63395030	.	T	C	4	2	6	0	0	6	0	0
5	63395057	.	A	T	3	2	5	0	1	6	0	0
5	63398317	.	A	T	20	6	26	0	3	29	0	0
5	63398329	.	T	C	27	4	31	0	1	32	0	0
5	63398847	.	T	C	9	11	20	0	1	21	0	0
5	63399066	.	G	C	20	13	33	0	1	34	0	0
5	63399202	.	C	T	17	28	45	0	2	47	0	0
5	63399479	.	C	T	25	34	59	0	4	63	0	0
5	63399683	.	T	A	21	12	33	0	1	34	0	0
5	63400685	.	G	A	1	1	2	0	0	2	0	0
5	63412576	.	T	C	2	1	3	0	1	4	0	0
5	63412759	.	A	G	1	2	3	0	0	3	0	0
5	63510908	.	G	T	8	5	13	0	0	13	0	0
5	63511045	.	A	G	4	6	10	0	0	10	0	0
5	63511110	.	T	C	3	0	3	0	10	13	0	0
5	63511170	.	A	G	2	4	6	0	0	6	0	0
5	63511172	.	T	G	1	4	5	0	1	6	0	0
5	63511525	.	A	G	5	4	9	0	0	9	0	0
5	63511537	.	A	G	5	4	9	0	0	9	0	0
5	63629136	.	G	A	3	4	7	0	0	7	0	0
5	63662111	.	A	T	1	1	2	0	0	2	0	0
5	63680709	.	T	G	0	2	2	0	0	2	0	0
5	63680718	.	A	G	0	0	0	0	1	1	0	0
5	63695760	.	C	T	0	2	2	0	0	2	0	0
5	63698549	.	T	C	2	0	2	0	0	2	0	0
5	63720639	.	A	G	4	4	8	0	0	8	0	0
5	63723807	.	G	A	0	6	6	0	1	7	0	0
5	63730115	.	G	A	0	11	11	0	8	19	0	0
5	63740093	.	C	T	14	11	25	0	4	30	1	0
5	63740097	.	T	A	16	10	26	0	3	29	0	0
5	63740149	.	T	C	17	5	22	0	0	22	0	0
5	63740167	.	A	G	6	15	21	0	2	23	0	0
5	63740431	.	A	G	23	7	30	0	0	30	0	0
5	63740465	.	C	A	8	8	16	0	3	22	3	0
5	63740815	.	A	C	19	29	48	0	4	52	0	0
5	63740874	.	A	C	23	24	47	0	2	49	0	0
5	63740895	.	A	C	20	19	39	0	10	49	0	0
5	63740910	.	A	G	22	24	46	0	4	50	0	0
5	63741023	.	T	A	15	11	26	0	1	27	0	0
5	63741077	.	A	T	12	14	26	0	2	28	0	0
5	63848662	.	C	G	2	2	4	0	0	4	0	0
5	63861355	.	G	A	0	2	2	0	1	3	0	0
5	64177760	.	T	A	0	3	3	0	0	3	0	0
5	64177762	.	T	A	3	0	3	0	0	3	0	0
5	64184521	.	C	T	1	0	1	0	0	1	0	0
5	64184626	.	G	A	3	1	4	0	0	4	0	0
5	64204517	.	C	T	6	13	19	0	0	19	0	0
5	64204524	.	T	C	6	12	18	0	1	19	0	0
5	64204565	.	T	G	1	7	8	0	0	8	0	0
5	64204574	.	G	A	0	4	4	0	0	4	0	0
5	64205046	.	C	T	6	3	9	0	1	10	0	0
5	64205219	.	G	T	1	7	8	0	0	8	0	0
5	64205229	.	A	G	1	5	6	0	1	7	0	0
5	64205388	.	C	T	3	12	15	0	1	16	0	0
5	64205624	.	C	A	0	3	3	0	1	4	0	0
5	64205639	.	A	T	2	3	5	0	0	5	0	0
5	64205879	.	T	A	7	5	12	0	1	13	0	0
5	64205881	.	G	A	7	6	13	0	0	13	0	0
5	64205937	.	T	C	4	5	9	0	0	9	0	0
5	64206182	.	G	A	1	8	9	0	1	10	0	0
5	64206402	.	G	A	6	2	8	0	2	10	0	0
5	64206411	.	A	G	4	2	6	0	2	8	0	0
5	64206455	.	C	T	2	3	5	1	1	7	0	0
5	64206591	.	A	G	9	5	14	0	1	15	0	0
5	64206688	.	C	T	4	5	9	0	0	9	0	0
5	64207415	.	C	T	0	3	3	0	11	14	0	0
5	64207570	.	T	G	2	4	6	0	0	6	0	0
5	64207779	.	A	G	1	3	4	0	0	4	0	0
5	64210227	.	C	T	0	2	2	0	1	3	0	0
5	64212865	.	G	A	2	3	5	0	0	5	0	0
5	64212868	.	T	A	2	3	5	0	0	5	0	0
5	64376756	.	C	A	2	2	4	0	0	4	0	0
5	64377399	.	C	T	5	4	9	0	0	9	0	0
5	64377618	.	T	C	2	3	5	0	1	6	0	0
5	64378234	.	T	A	2	2	4	0	0	4	0	0
5	64378272	.	C	T	3	5	8	0	0	8	0	0
5	64378293	.	G	A	0	1	1	0	8	9	0	0
5	64378369	.	T	C	7	6	13	0	0	13	0	0
5	64378404	.	T	C	5	7	12	0	0	12	0	0
5	64378413	.	G	C	8	5	13	0	0	13	0	0
5	64397667	.	C	A	12	19	31	0	3	34	0	0
5	64398506	.	C	T	22	22	44	0	3	47	0	0
5	64398554	.	G	A	9	13	22	0	0	22	0	0
5	64398688	.	C	T	6	9	15	0	1	16	0	0
5	64412096	.	C	T	0	16	16	0	10	26	0	0
5	64412907	.	G	A	12	12	24	0	1	25	0	0
5	64413095	.	A	C	10	24	34	0	2	36	0	0
5	64413319	.	G	A	8	3	11	0	1	12	0	0
5	64413458	.	A	G	5	4	9	0	1	10	0	0
5	64413834	.	G	T	7	9	16	0	0	18	2	0
5	64413943	.	C	T	10	11	21	0	2	23	0	0
5	64439116	.	G	A	8	4	12	0	3	15	0	0
5	64439272	.	T	C	2	0	2	0	7	9	0	0
5	64444517	.	G	A	0	0	0	0	1	1	0	0
5	64454394	.	A	G	1	2	3	0	1	4	0	0
5	64671188	.	A	T	1	2	3	0	0	3	0	0
5	64671207	.	T	C	1	1	2	0	0	2	0	0
5	64732170	.	T	A	10	29	39	0	1	40	0	0
5	64732240	.	T	C	21	30	51	0	1	52	0	0
5	64740004	.	G	A	4	4	8	0	3	11	0	0
5	64848958	.	A	G	2	3	5	0	0	5	0	0
5	64857138	.	G	A	0	2	2	0	7	9	0	0
5	65112769	.	T	A	1	2	3	0	0	3	0	0
5	66236573	.	A	G	1	1	2	0	1	3	0	0
5	66236585	.	A	T	1	3	4	0	0	4	0	0
5	66361569	.	A	T	1	2	3	0	0	3	0	0
5	67079660	.	A	G	2	2	4	0	0	4	0	0
5	67095814	.	C	T	1	3	4	0	0	4	0	0
5	67188350	.	C	T	9	5	14	0	2	16	0	0
5	67188515	.	C	G	0	0	0	0	3	3	0	0
5	67188524	.	G	A	0	2	2	0	0	2	0	0
5	67194260	.	G	A	0	2	2	0	0	2	0	0
5	67200217	.	G	T	2	3	5	0	0	5	0	0
5	67205570	.	C	T	0	1	1	0	2	3	0	0
5	67205590	.	C	T	0	1	1	0	0	1	0	0
5	67211298	.	A	G	2	1	3	0	0	3	0	0
5	67211372	.	T	C	2	2	4	0	0	4	0	0
5	67217758	.	T	A	3	7	10	0	0	10	0	0
5	67217839	.	A	G	1	2	3	0	0	3	0	0
5	67234603	.	T	G	2	3	5	0	0	5	0	0
5	67239399	.	C	A	0	2	2	0	2	4	0	0
5	67253116	.	A	T	1	3	4	0	0	4	0	0
5	67254501	.	T	G	7	5	12	0	0	12	0	0
5	67254531	.	G	A	6	8	14	0	1	15	0	0
5	67254601	.	T	G	7	5	12	0	0	12	0	0
5	67254861	.	G	A	5	5	10	0	1	11	0	0
5	67255049	.	C	T	3	2	5	0	1	6	0	0
5	67260308	.	C	A	1	2	3	0	0	3	0	0
5	67260354	.	A	G	1	1	2	0	0	2	0	0
5	67272557	.	T	C	3	7	10	0	1	11	0	0
5	67272580	.	A	G	1	8	9	0	0	9	0	0
5	67272686	.	T	G	1	3	4	0	0	4	0	0
5	67272760	.	C	G	1	3	4	0	0	4	0	0
5	67272901	.	T	G	1	3	4	0	0	4	0	0
5	67273027	.	G	A	1	3	4	0	0	4	0	0
5	67273308	.	A	G	2	2	4	0	0	4	0	0
5	67276160	.	G	A	3	3	6	0	0	6	0	0
5	67278712	.	T	C	15	9	24	0	1	25	0	0
5	67280269	.	C	T	0	24	24	0	25	49	0	0
5	67280329	.	C	A	0	14	14	0	6	20	0	0
5	67280332	.	G	T	5	11	16	0	3	19	0	0
5	67288575	.	C	T	2	5	7	0	0	7	0	0
5	67288576	.	T	G	2	4	6	0	1	7	0	0
5	67288662	.	A	G	2	8	10	0	1	11	0	0
5	67288733	.	G	A	1	5	6	0	1	7	0	0
5	67289050	.	G	T	1	2	3	0	1	4	0	0
5	67292599	.	A	T	4	7	11	0	0	11	0	0
5	67316352	.	T	C	2	2	4	0	0	4	0	0
5	67474362	.	T	C	1	7	8	0	1	9	0	0
5	67474365	.	A	G	1	6	7	0	2	9	0	0
5	67484741	.	A	T	3	2	5	0	0	5	0	0
5	67838400	.	C	T	1	4	5	0	0	5	0	0
5	67838519	.	T	G	0	0	0	0	3	3	0	0
5	67838521	.	T	G	1	0	1	0	2	3	0	0
5	67838608	.	G	T	0	2	2	0	2	4	0	0
5	67838659	.	C	T	2	2	4	0	1	5	0	0
5	67839973	.	C	G	3	0	3	0	1	4	0	0
5	67839975	.	A	T	4	0	4	0	0	4	0	0
5	67840721	.	C	T	1	2	3	0	0	3	0	0
5	67842965	.	A	T	1	3	4	0	0	4	0	0
5	67845505	.	A	G	2	2	4	0	0	4	0	0
5	67845527	.	A	C	1	2	3	0	0	3	0	0
5	67847635	.	G	A	5	3	8	0	0	8	0	0
5	67849749	.	A	G	1	2	3	0	0	3	0	0
5	67855969	.	G	A	0	1	1	0	4	5	0	0
5	67857796	.	A	G	4	7	11	0	0	11	0	0
5	67857877	.	T	C	5	1	6	0	1	7	0	0
5	67858727	.	G	A	1	4	5	0	0	5	0	0
5	67860007	.	A	G	8	3	11	0	0	11	0	0
5	67873094	.	G	A	3	3	6	0	1	7	0	0
5	67873103	.	C	T	0	5	5	0	3	8	0	0
5	67874952	.	T	G	7	3	10	0	1	11	0	0
5	67884293	.	C	T	1	4	5	0	1	6	0	0
5	67884361	.	A	G	6	6	12	0	0	12	0	0
5	67884436	.	A	G	6	6	12	0	1	13	0	0
5	67884533	.	G	A	5	6	11	0	1	12	0	0
5	67884583	.	G	A	9	2	11	0	0	11	0	0
5	67884701	.	T	C	0	2	2	0	0	2	0	0
5	67884737	.	A	T	1	6	7	0	0	7	0	0
5	67884762	.	T	G	2	3	5	0	1	6	0	0
5	67884779	.	G	A	3	4	7	0	0	7	0	0
5	67885142	.	G	A	8	4	12	0	0	12	0	0
5	67885211	.	A	T	7	3	10	0	1	11	0	0
5	67885240	.	G	A	4	5	9	0	0	9	0	0
5	67885294	.	A	G	3	3	6	0	3	9	0	0
5	67885302	.	T	C	4	5	9	0	0	9	0	0
5	67885444	.	G	A	8	5	13	0	1	14	0	0
5	67885526	.	C	T	0	5	5	0	7	12	0	0
5	67886945	.	G	T	0	4	4	0	1	5	0	0
5	67886996	.	A	T	1	5	6	0	0	6	0	0
5	67887028	.	C	T	0	3	3	0	1	4	0	0
5	67887143	.	A	G	3	11	14	0	1	15	0	0
5	67887239	.	T	C	0	7	7	0	0	7	0	0
5	67887281	.	T	C	2	5	7	0	2	9	0	0
5	67887380	.	G	A	4	3	7	0	0	7	0	0
5	67889104	.	A	G	1	3	4	0	0	4	0	0
5	67889124	.	A	G	1	2	3	0	0	3	0	0
5	67891030	.	A	G	1	2	3	0	1	4	0	0
5	67909854	.	G	A	2	7	9	0	0	9	0	0
5	67910829	.	T	A	4	5	9	0	0	9	0	0
5	67971698	.	T	A	3	2	5	0	0	5	0	0
5	67971710	.	C	T	3	3	6	0	0	6	0	0
5	67974464	.	C	T	5	3	8	0	2	10	0	0
5	67974485	.	C	T	5	5	10	0	0	10	0	0
5	67977911	.	G	T	10	7	17	0	0	17	0	0
5	67977914	.	C	T	3	7	10	0	8	18	0	0
5	67978636	.	G	A	5	11	16	0	0	16	0	0
5	67978662	.	G	T	1	7	8	0	3	11	0	0
5	67978673	.	G	T	3	6	9	0	2	11	0	0
5	67980719	.	G	A	2	5	7	0	0	7	0	0
5	67980720	.	T	A	2	4	6	0	1	7	0	0
5	67982853	.	G	A	2	3	5	0	0	5	0	0
5	67992910	.	T	G	1	2	3	0	0	3	0	0
5	67992912	.	C	G	1	2	3	0	0	3	0	0
5	68060143	.	T	A	13	11	24	0	3	27	0	0
5	68060578	.	T	C	5	12	17	0	2	19	0	0
5	68060634	.	T	C	6	13	19	0	4	23	0	0
5	68060789	.	T	G	9	6	15	0	0	15	0	0
5	68060841	.	T	C	1	2	3	0	0	3	0	0
5	68066856	.	C	T	9	11	20	0	2	22	0	0
5	68068550	.	C	T	0	12	12	0	17	29	0	0
5	68068574	.	A	G	8	8	16	0	1	17	0	0
5	68069003	.	C	T	0	5	5	0	4	9	0	0
5	68074508	.	G	A	6	6	12	0	0	12	0	0
5	68074565	.	A	G	8	4	12	0	2	14	0	0
5	68076925	.	T	A	11	29	40	0	0	40	0	0
5	68090104	.	G	A	11	9	20	0	0	20	0	0
5	68093051	.	A	C	9	1	10	0	14	24	0	0
5	68181041	.	A	G	1	1	2	0	0	2	0	0
5	68188140	.	C	T	0	0	0	0	1	1	0	0
5	68206764	.	T	A	1	2	3	0	0	3	0	0
5	68409956	.	C	T	0	1	1	0	8	9	0	0
5	68409977	.	T	C	3	0	3	0	11	14	0	0
5	68415142	.	C	T	1	3	4	0	0	4	0	0
5	68431452	.	G	A	5	3	8	0	0	8	0	0
5	68766688	.	T	C	2	0	2	0	6	8	0	0
5	68767050	.	C	T	0	13	13	0	9	22	0	0
5	68767201	.	C	T	10	5	15	0	0	15	0	0
5	68767439	.	G	T	5	5	10	0	2	12	0	0
5	68767642	.	A	C	7	4	11	0	1	12	0	0
5	68767802	.	G	A	3	2	5	0	1	6	0	0
5	68778040	.	G	T	5	7	12	0	1	13	0	0
5	68778455	.	T	A	2	5	7	0	0	7	0	0
5	68778524	.	C	A	0	4	4	0	4	8	0	0
5	68778895	.	C	G	5	4	9	0	0	9	0	0
5	68778937	.	A	G	5	2	7	0	1	8	0	0
5	68778957	.	G	T	3	2	5	0	0	5	0	0
5	68782433	.	T	G	1	2	3	0	0	3	0	0
5	68826169	.	A	G	2	1	3	0	1	4	0	0
5	68826171	.	C	T	2	2	4	0	0	4	0	0
5	68826647	.	C	T	0	0	0	0	1	1	0	0
5	68831382	.	C	T	2	1	3	0	0	3	0	0
5	68840928	.	T	C	1	4	5	0	0	5	0	0
5	68848116	.	G	A	0	3	3	0	0	3	0	0
5	68850856	.	C	T	0	0	0	0	1	1	0	0
5	68850967	.	C	G	0	4	4	0	2	6	0	0
5	68863784	.	C	T	0	2	2	0	2	4	0	0
5	68892515	.	A	C	4	2	6	0	0	6	0	0
5	68900820	.	C	G	2	5	7	0	2	9	0	0
5	68900825	.	G	A	3	2	5	0	2	7	0	0
5	68900891	.	C	T	0	1	1	0	0	1	0	0
5	68963602	.	A	T	1	2	3	0	0	3	0	0
5	68982340	.	G	A	1	3	4	0	1	5	0	0
5	69141307	.	G	A	5	2	7	0	2	9	0	0
5	69141440	.	G	T	10	4	14	0	0	14	0	0
5	69144428	.	C	T	0	2	2	0	5	7	0	0
5	69234768	.	A	G	1	2	3	0	0	3	0	0
5	69246853	.	G	C	1	1	2	0	0	2	0	0
5	69278192	.	A	G	10	0	10	0	22	32	0	0
5	69287061	.	C	T	8	5	13	0	1	14	0	0
5	69287180	.	A	T	18	21	39	0	3	42	0	0
5	69287264	.	C	G	17	15	32	0	0	32	0	0
5	69287498	.	C	T	5	9	14	0	1	15	0	0
5	69290980	.	C	T	1	2	3	0	0	3	0	0
5	69427984	.	A	G	8	17	25	0	6	31	0	0
5	69428056	.	A	T	5	6	11	0	0	11	0	0
5	69428148	.	T	C	1	6	7	0	2	9	0	0
5	69429132	.	G	A	3	2	5	0	0	5	0	0
5	69429205	.	G	T	1	3	4	0	0	4	0	0
5	69429225	.	T	C	3	2	5	0	0	5	0	0
5	69429544	.	G	A	2	15	17	0	3	20	0	0
5	69431287	.	G	C	6	8	14	0	1	15	0	0
5	69463008	.	C	A	1	0	1	0	0	1	0	0
5	69464773	.	G	A	1	2	3	0	0	3	0	0
5	69464811	.	C	T	0	2	2	0	3	5	0	0
5	69486618	.	T	C	6	7	13	0	1	14	0	0
5	69486698	.	G	A	8	5	13	0	0	13	0	0
5	69486749	.	A	T	6	7	13	0	1	14	0	0
5	69486756	.	G	A	5	8	13	0	1	14	0	0
5	69486844	.	G	T	1	3	4	0	0	4	0	0
5	69491754	.	G	A	1	1	2	0	0	2	0	0
5	69505492	.	T	C	2	2	4	0	0	4	0	0
5	69536449	.	C	G	1	3	4	0	0	4	0	0
5	69557764	.	A	G	1	1	2	0	0	2	0	0
5	69557776	.	G	T	1	2	3	0	0	3	0	0
5	69574886	.	A	G	3	7	10	0	0	10	0	0
5	69574972	.	G	T	11	13	24	0	4	28	0	0
5	69579118	.	T	C	5	0	5	0	3	8	0	0
5	69588720	.	A	T	0	2	2	0	1	3	0	0
5	69595361	.	G	A	0	4	4	0	0	4	0	0
5	69599798	.	G	T	2	1	3	0	0	3	0	0
5	69851203	.	T	C	1	6	7	0	0	7	0	0
5	69907537	.	T	C	7	8	15	0	0	15	0	0
5	70182082	.	A	G	15	22	37	0	2	39	0	0
5	70319533	.	C	T	2	2	4	0	0	4	0	0
5	71253635	.	T	C	2	2	4	0	1	5	0	0
5	72130903	.	T	C	0	2	2	0	0	2	0	0
6	28313	.	G	A	2	2	4	0	0	4	0	0
6	29439	.	T	C	7	11	18	0	3	21	0	0
6	32436	.	G	A	0	2	2	0	5	7	0	0
6	37050	.	C	T	5	3	8	0	0	8	0	0
6	37919	.	C	T	5	10	15	0	1	16	0	0
6	38264	.	C	G	12	6	18	0	1	19	0	0
6	41065	.	A	T	12	6	18	0	1	19	0	0
6	41164	.	A	G	4	2	6	0	8	14	0	0
6	42301	.	A	T	17	15	32	0	2	34	0	0
6	58559	.	G	A	0	3	3	0	4	7	0	0
6	59048	.	C	T	8	3	11	0	0	11	0	0
6	59171	.	G	A	3	2	5	0	0	5	0	0
6	59459	.	T	C	2	3	5	0	1	6	0	0
6	59465	.	G	A	2	3	5	0	0	5	0	0
6	68277	.	A	T	4	2	6	0	2	8	0	0
6	92359	.	T	G	7	5	12	0	0	12	0	0
6	92383	.	A	G	6	3	9	0	2	11	0	0
6	93840	.	T	C	15	9	24	0	3	27	0	0
6	93966	.	A	G	3	3	6	0	1	7	0	0
6	121239	.	C	T	5	4	9	0	0	9	0	0
6	132157	.	G	C	4	7	11	0	2	13	0	0
6	136816	.	G	A	3	3	6	0	1	7	0	0
6	136988	.	A	T	2	2	4	0	0	4	0	0
6	152680	.	T	A	6	10	16	0	2	18	0	0
6	184361	.	C	T	10	7	17	0	0	17	0	0
6	184382	.	A	G	2	0	2	0	6	8	0	0
6	205090	.	T	C	1	3	4	0	0	4	0	0
6	205102	.	G	A	1	2	3	0	0	3	0	0
6	205258	.	G	A	0	2	2	0	1	3	0	0
6	265188	.	G	T	11	10	21	0	2	23	0	0
6	265191	.	A	T	12	9	21	0	0	21	0	0
6	265837	.	G	A	5	5	10	0	0	10	0	0
6	267412	.	C	T	10	4	14	0	0	14	0	0
6	267417	.	C	G	10	3	13	0	1	14	0	0
6	267451	.	G	A	0	4	4	0	15	19	0	0
6	267501	.	G	C	8	3	11	0	0	11	0	0
6	267516	.	G	A	7	2	9	0	1	10	0	0
6	267645	.	C	T	6	10	16	0	3	19	0	0
6	267669	.	C	T	5	6	11	0	4	15	0	0
6	267817	.	G	A	6	10	16	0	2	18	0	0
6	267884	.	T	C	5	3	8	0	0	8	0	0
6	267886	.	T	C	5	3	8	0	0	8	0	0
6	271793	.	C	A	28	18	46	0	1	47	0	0
6	272041	.	C	T	20	22	42	0	5	47	0	0
6	272056	.	A	G	21	21	42	0	3	45	0	0
6	272298	.	G	A	0	19	19	0	35	54	0	0
6	272503	.	T	C	16	10	26	0	0	26	0	0
6	322371	.	C	T	1	4	5	0	0	5	0	0
6	331909	.	T	A	4	5	9	0	1	10	0	0
6	331912	.	C	T	5	6	11	0	0	11	0	0
6	340670	.	A	G	18	17	35	0	1	36	0	0
6	340800	.	T	G	9	8	17	0	0	17	0	0
6	340839	.	A	G	6	8	14	0	0	14	0	0
6	340931	.	G	A	9	9	18	0	1	19	0	0
6	341882	.	G	A	19	22	41	0	1	42	0	0
6	341933	.	G	A	12	25	37	0	3	41	1	0
6	341953	.	C	T	9	35	44	0	1	45	0	0
6	342017	.	T	A	17	18	35	0	2	37	0	0
6	342123	.	C	T	17	14	31	0	1	32	0	0
6	374956	.	T	A	5	9	14	0	0	14	0	0
6	374988	.	G	T	6	3	9	0	1	10	0	0
6	375051	.	T	C	5	4	9	0	0	9	0	0
6	840792	.	C	G	16	19	35	0	0	35	0	0
6	841511	.	T	C	11	9	20	0	0	20	0	0
6	841557	.	A	G	10	5	15	0	4	19	0	0
6	841851	.	T	C	10	18	28	0	1	29	0	0
6	841941	.	G	A	7	9	16	1	2	19	0	0
6	842009	.	G	A	18	5	23	0	3	26	0	0
6	842010	.	C	T	0	6	6	0	20	26	0	0
6	842149	.	A	T	7	6	13	0	0	16	3	0
6	842241	.	T	C	7	3	10	0	1	11	0	0
6	842301	.	T	C	9	5	14	0	3	17	0	0
6	842309	.	T	A	9	7	16	0	0	16	0	0
6	842343	.	C	T	4	4	8	0	0	8	0	0
6	842461	.	C	T	7	6	13	0	1	14	0	0
6	842739	.	C	T	0	7	7	0	14	21	0	0
6	842791	.	C	A	13	9	22	0	0	22	0	0
6	842816	.	A	C	12	9	21	0	0	21	0	0
6	843745	.	C	A	6	4	10	0	0	10	0	0
6	843836	.	G	A	6	4	10	0	0	10	0	0
6	844146	.	G	T	3	1	4	0	1	5	0	0
6	844164	.	C	T	1	5	6	0	0	6	0	0
6	844209	.	G	A	3	3	6	0	0	6	0	0
6	844337	.	A	G	3	4	7	0	2	9	0	0
6	858026	.	C	T	0	3	3	0	4	7	0	0
6	858128	.	C	T	0	2	2	0	10	12	0	0
6	858713	.	A	G	4	7	11	0	0	11	0	0
6	859364	.	C	T	4	3	7	0	3	10	0	0
6	859907	.	A	G	0	1	1	0	0	1	0	0
6	859910	.	C	T	0	1	1	0	0	1	0	0
6	866742	.	G	T	1	2	3	0	0	3	0	0
6	869374	.	T	C	2	0	2	0	0	2	0	0
6	1535603	.	G	T	3	4	7	0	0	7	0	0
6	1554299	.	T	G	1	4	5	0	0	5	0	0
6	1554743	.	G	C	1	1	2	0	1	3	0	0
6	1554922	.	A	T	5	2	7	0	0	7	0	0
6	1798716	.	T	G	2	7	9	0	0	9	0	0
6	1799112	.	A	T	1	4	5	0	1	6	0	0
6	1838527	.	C	T	1	2	3	0	0	3	0	0
6	1838555	.	A	T	2	2	4	0	0	4	0	0
6	1874606	.	T	G	1	0	1	0	2	3	0	0
6	2081728	.	G	A	1	2	3	0	0	3	0	0
6	2118349	.	C	G	4	2	6	0	0	6	0	0
6	2118355	.	C	G	2	3	5	0	1	6	0	0
6	2120734	.	G	A	0	1	1	0	0	1	0	0
6	2125757	.	T	C	0	2	2	0	0	2	0	0
6	2126486	.	T	A	1	6	7	0	0	7	0	0
6	2126512	.	C	T	2	3	5	0	2	7	0	0
6	2166111	.	A	T	4	2	6	0	0	7	1	0
6	2166157	.	G	A	2	7	9	0	0	9	0	0
6	2166240	.	T	C	2	0	2	0	6	8	0	0
6	2166397	.	A	G	4	3	7	0	1	8	0	0
6	2166418	.	G	A	1	5	6	0	0	6	0	0
6	2166531	.	A	T	5	5	10	0	1	11	0	0
6	2170110	.	C	T	1	3	4	0	0	4	0	0
6	2198105	.	G	C	4	4	8	0	0	8	0	0
6	2206682	.	C	T	4	7	11	0	0	11	0	0
6	2206704	.	G	T	3	3	6	0	0	6	0	0
6	2206884	.	G	A	8	6	14	0	0	14	0	0
6	2208261	.	A	T	1	4	5	0	1	6	0	0
6	2208479	.	T	G	1	6	7	0	0	7	0	0
6	2208562	.	C	T	5	3	8	0	2	10	0	0
6	2208609	.	C	T	5	7	12	0	0	12	0	0
6	2208655	.	A	G	3	3	6	0	1	7	0	0
6	2210120	.	A	G	4	1	5	0	0	5	0	0
6	2215208	.	T	A	7	3	10	0	1	11	0	0
6	2453730	.	T	C	5	0	5	0	0	5	0	0
6	2453751	.	A	C	7	3	10	0	0	10	0	0
6	2560500	.	C	T	1	2	3	0	0	3	0	0
6	2620078	.	C	G	2	2	4	0	0	4	0	0
6	2621637	.	C	G	0	6	6	0	3	9	0	0
6	2621656	.	G	A	7	4	11	0	2	13	0	0
6	2621677	.	C	T	9	3	12	0	1	13	0	0
6	2621719	.	T	A	1	1	2	0	0	2	0	0
6	2624527	.	G	C	1	1	2	0	0	2	0	0
6	3143292	.	T	A	3	2	5	0	0	5	0	0
6	3145256	.	C	A	0	1	1	0	0	1	0	0
6	3197028	.	C	T	1	10	11	0	1	12	0	0
6	3205538	.	T	C	1	3	4	0	1	5	0	0
6	3223245	.	C	T	2	2	4	0	0	4	0	0
6	3223341	.	C	G	2	1	3	0	0	3	0	0
6	3268327	.	T	C	1	1	2	0	1	3	0	0
6	3270011	.	G	A	5	6	11	0	2	13	0	0
6	3273341	.	T	A	11	10	21	0	0	21	0	0
6	3273379	.	A	G	8	7	15	0	1	16	0	0
6	3273588	.	A	T	6	8	14	1	1	16	0	0
6	3273826	.	A	T	13	11	24	0	2	26	0	0
6	3273965	.	C	T	17	22	39	0	3	42	0	0
6	3273986	.	T	C	15	24	39	0	2	41	0	0
6	3274114	.	G	C	0	17	17	0	21	38	0	0
6	3274289	.	C	T	17	19	36	0	0	36	0	0
6	3395649	.	C	T	2	2	4	0	0	4	0	0
6	3398906	.	A	G	6	2	8	0	1	9	0	0
6	3404956	.	G	A	0	3	3	0	3	6	0	0
6	3405060	.	G	A	0	7	7	0	7	14	0	0
6	3405143	.	T	C	4	1	5	0	2	7	0	0
6	3405191	.	G	C	5	5	10	0	0	10	0	0
6	3405244	.	A	G	8	5	13	0	1	14	0	0
6	3405245	.	C	A	8	5	13	0	1	14	0	0
6	3499159	.	T	A	1	3	4	0	0	4	0	0
6	3509041	.	T	G	3	1	4	0	1	5	0	0
6	3514481	.	A	C	20	19	39	0	2	41	0	0
6	3704391	.	G	A	0	2	2	0	0	2	0	0
6	3707095	.	A	G	6	4	10	0	0	10	0	0
6	3707116	.	G	A	6	5	11	0	1	12	0	0
6	3707371	.	G	A	0	11	11	0	11	22	0	0
6	3707372	.	A	G	11	11	22	0	0	22	0	0
6	3707407	.	T	C	17	12	29	0	0	29	0	0
6	3708061	.	A	G	9	9	18	0	0	18	0	0
6	3708149	.	T	C	6	9	15	0	1	16	0	0
6	3711338	.	A	G	7	5	12	0	2	14	0	0
6	3711386	.	T	C	3	2	5	0	2	7	0	0
6	3711419	.	A	G	4	2	6	0	0	6	0	0
6	3711448	.	C	A	3	1	4	0	1	5	0	0
6	3711616	.	G	A	1	2	3	0	0	3	0	0
6	3712069	.	A	T	6	2	8	0	1	9	0	0
6	3712136	.	G	A	4	2	6	0	1	7	0	0
6	3712335	.	T	G	5	1	6	0	5	11	0	0
6	3712433	.	A	T	2	2	4	0	0	4	0	0
6	3717060	.	T	A	1	1	2	0	0	2	0	0
6	3717843	.	C	T	0	1	1	0	0	1	0	0
6	3724870	.	A	C	8	4	12	0	0	12	0	0
6	3725767	.	C	A	8	6	14	0	1	15	0	0
6	3727891	.	C	T	12	11	23	0	1	24	0	0
6	3728295	.	A	T	3	8	11	0	0	11	0	0
6	3728559	.	G	C	6	6	12	0	0	12	0	0
6	3827894	.	C	A	4	6	10	0	2	12	0	0
6	3834630	.	G	C	12	12	24	0	1	25	0	0
6	3853120	.	T	G	9	0	9	0	18	27	0	0
6	3853165	.	T	C	8	20	28	0	3	31	0	0
6	3862018	.	A	G	13	21	34	0	3	37	0	0
6	3867542	.	A	T	1	1	2	0	0	2	0	0
6	3869454	.	G	A	0	1	1	0	5	6	0	0
6	3869891	.	C	T	6	5	11	0	0	11	0	0
6	3871982	.	T	A	6	5	11	0	0	11	0	0
6	3874504	.	G	A	2	16	18	0	24	42	0	0
6	3874533	.	C	T	21	17	38	0	2	40	0	0
6	3874686	.	A	G	17	8	25	0	2	27	0	0
6	3878513	.	T	A	3	5	8	0	0	8	0	0
6	3878593	.	A	G	7	6	13	0	2	15	0	0
6	3878831	.	G	C	2	2	4	0	0	4	0	0
6	3878983	.	A	T	8	10	18	0	4	22	0	0
6	3879158	.	A	G	8	4	12	0	3	15	0	0
6	3879247	.	C	A	0	13	13	0	9	22	0	0
6	3879314	.	C	G	0	10	10	0	7	17	0	0
6	3879335	.	C	T	4	10	14	0	0	14	0	0
6	3879367	.	G	A	1	4	5	0	0	5	0	0
6	3881078	.	G	A	0	2	2	0	1	3	0	0
6	3885451	.	C	T	4	7	11	0	1	12	0	0
6	3895442	.	A	T	1	0	1	0	0	1	0	0
6	3895460	.	C	T	0	3	3	0	5	8	0	0
6	3907796	.	A	T	2	3	5	0	0	5	0	0
6	3950267	.	C	T	1	1	2	0	0	2	0	0
6	3950270	.	C	T	1	1	2	0	0	2	0	0
6	3950309	.	C	T	3	1	4	0	1	5	0	0
6	3953280	.	T	C	4	2	6	0	0	6	0	0
6	3953302	.	A	C	3	2	5	0	0	5	0	0
6	3961387	.	G	A	8	3	11	0	0	11	0	0
6	3962132	.	G	A	15	16	31	0	1	32	0	0
6	3962192	.	A	T	10	12	22	0	0	22	0	0
6	3965389	.	G	T	5	1	6	0	1	7	0	0
6	3965461	.	A	G	4	6	10	0	1	11	0	0
6	3973572	.	G	A	0	0	0	0	1	1	0	0
6	3973638	.	T	G	1	1	2	0	0	2	0	0
6	3974047	.	G	A	4	2	6	0	0	6	0	0
6	3984909	.	T	A	1	5	6	0	0	6	0	0
6	3985083	.	G	A	4	7	11	0	3	14	0	0
6	3985137	.	G	A	7	11	18	0	0	18	0	0
6	3987131	.	A	G	3	2	5	0	0	5	0	0
6	3987145	.	T	C	1	1	2	0	0	2	0	0
6	4185678	.	G	A	8	9	17	0	0	17	0	0
6	4191449	.	C	T	1	2	3	0	0	3	0	0
6	4246466	.	T	C	1	2	3	0	0	3	0	0
6	4246638	.	A	C	1	2	3	0	0	3	0	0
6	4247928	.	C	T	4	3	7	0	0	7	0	0
6	4247942	.	T	C	1	2	3	0	2	5	0	0
6	4248307	.	G	A	0	2	2	0	3	5	0	0
6	4248399	.	A	T	4	4	8	0	1	9	0	0
6	4248412	.	T	A	5	5	10	0	1	11	0	0
6	4249420	.	C	T	0	5	5	0	0	5	0	0
6	4249437	.	A	G	0	6	6	0	0	6	0	0
6	4249684	.	A	G	8	3	11	0	0	11	0	0
6	4249821	.	G	A	3	5	8	0	0	8	0	0
6	4249872	.	T	G	8	0	8	0	1	9	0	0
6	4401087	.	T	A	0	9	9	0	1	10	0	0
6	6967350	.	A	G	1	3	4	0	1	5	0	0
6	6990063	.	G	A	0	3	3	5	1	9	0	0
6	7542491	.	G	T	1	3	4	0	0	4	0	0
6	7545794	.	C	T	9	4	13	0	0	13	0	0
6	7545824	.	T	C	7	6	13	0	1	14	0	0
6	7547451	.	C	T	4	1	5	0	0	5	0	0
6	7549967	.	G	A	6	4	10	0	0	10	0	0
6	7550210	.	A	C	11	5	16	0	2	18	0	0
6	7550405	.	C	T	14	10	24	0	3	27	0	0
6	7551087	.	C	A	6	3	9	0	1	10	0	0
6	7624012	.	T	C	3	2	5	0	0	5	0	0
6	7626457	.	C	T	1	0	1	0	1	2	0	0
6	7633452	.	G	C	0	1	1	0	3	4	0	0
6	7636811	.	A	T	2	3	5	0	0	5	0	0
6	7637195	.	C	T	3	4	7	0	0	7	0	0
6	7638717	.	G	A	9	5	14	0	1	15	0	0
6	7645319	.	T	C	2	2	4	0	0	4	0	0
6	7646039	.	A	G	4	2	6	0	1	7	0	0
6	7646102	.	G	A	12	6	18	0	4	22	0	0
6	7646111	.	G	C	14	7	21	0	0	21	0	0
6	7648224	.	A	G	5	0	5	0	6	11	0	0
6	7652458	.	C	T	7	9	16	0	4	20	0	0
6	7652470	.	A	C	10	6	16	0	1	17	0	0
6	7652896	.	G	A	1	15	16	0	14	30	0	0
6	7652959	.	C	T	7	11	18	0	0	18	0	0
6	7652989	.	C	T	2	2	4	0	0	4	0	0
6	7656932	.	A	G	17	14	31	0	1	32	0	0
6	7657177	.	C	T	16	13	29	0	3	32	0	0
6	7657793	.	A	C	13	18	31	0	0	31	0	0
6	7657886	.	T	A	23	13	36	0	0	36	0	0
6	7657887	.	G	T	23	12	35	0	1	36	0	0
6	7657972	.	T	G	18	9	27	0	3	30	0	0
6	7658076	.	G	A	15	15	30	0	2	32	0	0
6	7660063	.	C	A	3	2	5	0	1	6	0	0
6	7660119	.	A	G	9	13	22	0	0	22	0	0
6	7660369	.	T	C	0	2	2	0	1	3	0	0
6	7660594	.	C	T	4	6	10	0	1	11	0	0
6	7660659	.	C	A	0	3	3	0	2	5	0	0
6	7660707	.	C	T	0	2	2	0	3	5	0	0
6	7688598	.	C	T	0	3	3	0	3	6	0	0
6	7697573	.	G	A	0	3	3	0	0	3	0	0
6	7713350	.	A	T	6	3	9	0	0	9	0	0
6	7713433	.	G	A	21	17	38	0	5	43	0	0
6	7721530	.	T	A	10	5	15	0	0	15	0	0
6	7721860	.	G	A	5	6	11	0	2	13	0	0
6	7721906	.	G	A	11	7	18	0	3	21	0	0
6	7721958	.	C	A	7	15	22	0	4	26	0	0
6	7722143	.	G	T	14	10	24	0	1	25	0	0
6	7722159	.	A	T	16	9	25	0	2	27	0	0
6	7722195	.	G	T	4	12	16	0	1	17	0	0
6	7722205	.	G	A	7	11	18	0	0	18	0	0
6	7722333	.	G	A	5	9	14	0	1	15	0	0
6	7722387	.	T	C	8	7	15	0	3	18	0	0
6	7722402	.	T	C	3	9	12	1	2	15	0	0
6	7722467	.	T	A	2	5	7	1	0	9	1	0
6	7722577	.	C	T	0	9	9	0	6	15	0	0
6	7722921	.	A	T	3	2	5	0	2	7	0	0
6	7723008	.	G	T	9	7	16	0	0	16	0	0
6	7723155	.	A	C	7	7	14	0	1	16	1	0
6	7723232	.	A	T	10	4	14	0	2	16	0	0
6	7723850	.	C	T	0	3	3	0	6	9	0	0
6	7723961	.	G	A	6	6	12	0	0	12	0	0
6	7726824	.	G	A	5	7	12	0	1	13	0	0
6	7795698	.	C	T	15	5	20	0	3	23	0	0
6	7842034	.	C	A	4	2	6	0	0	6	0	0
6	8176101	.	A	G	2	3	5	0	0	5	0	0
6	8177030	.	T	C	3	3	6	0	0	6	0	0
6	8177399	.	T	C	3	2	5	0	0	5	0	0
6	8177600	.	T	C	5	6	11	0	1	12	0	0
6	8177678	.	C	T	2	4	6	0	3	9	0	0
6	8178002	.	T	C	11	6	17	0	1	18	0	0
6	8178053	.	G	A	0	7	7	0	5	12	0	0
6	8178113	.	T	C	3	4	7	0	2	9	0	0
6	8178351	.	G	A	3	8	11	0	0	11	0	0
6	8179022	.	G	T	0	12	12	0	14	26	0	0
6	8179205	.	A	T	13	8	21	0	0	21	0	0
6	8179373	.	G	A	12	13	25	0	1	26	0	0
6	8179683	.	A	T	6	4	10	0	0	10	0	0
6	8210334	.	A	G	1	5	6	0	0	6	0	0
6	8211075	.	C	T	3	9	12	0	0	12	0	0
6	8211106	.	T	C	0	5	5	0	1	6	0	0
6	8211143	.	A	T	3	2	5	0	2	7	0	0
6	8211154	.	T	C	5	2	7	0	0	7	0	0
6	8211253	.	G	A	5	3	8	0	0	8	0	0
6	8214044	.	G	A	1	1	2	0	0	2	0	0
6	8214045	.	T	G	1	1	2	0	0	2	0	0
6	8265214	.	G	A	2	3	5	0	1	6	0	0
6	8265282	.	G	A	4	7	11	0	1	13	1	0
6	8267111	.	C	T	6	13	19	0	0	19	0	0
6	8267266	.	A	G	10	11	21	0	4	25	0	0
6	8267284	.	G	A	6	10	16	0	6	22	0	0
6	8267307	.	G	C	14	5	19	0	1	20	0	0
6	8267352	.	A	T	10	9	19	0	4	23	0	0
6	8267519	.	G	A	15	7	22	0	1	23	0	0
6	8267563	.	G	T	15	11	26	0	4	30	0	0
6	8267635	.	T	C	15	11	26	0	0	26	0	0
6	8267795	.	T	A	8	5	13	0	0	13	0	0
6	8267880	.	G	A	5	6	11	0	0	11	0	0
6	8268529	.	A	G	3	2	5	0	1	6	0	0
6	8315076	.	A	G	2	3	5	0	0	5	0	0
6	8315078	.	A	G	1	3	4	0	1	5	0	0
6	8328181	.	G	T	10	16	26	0	1	27	0	0
6	8365753	.	T	C	1	5	6	0	2	8	0	0
6	8366006	.	A	T	7	7	14	0	1	16	1	0
6	8366167	.	C	T	16	13	29	0	3	32	0	0
6	8374716	.	G	A	9	3	12	0	1	13	0	0
6	8375089	.	C	T	17	9	26	0	0	26	0	0
6	8380485	.	G	T	1	2	3	0	0	3	0	0
6	8391629	.	C	T	0	5	5	0	3	8	0	0
6	8392005	.	G	A	1	2	3	0	0	3	0	0
6	8460493	.	G	T	3	2	5	0	1	6	0	0
6	9130510	.	A	G	2	9	11	0	0	11	0	0
6	9130521	.	A	G	4	7	11	0	1	12	0	0
6	9130575	.	A	G	3	7	10	0	1	11	0	0
6	9130839	.	G	A	1	2	3	0	0	3	0	0
6	10741853	.	T	G	1	1	2	0	1	3	0	0
6	10982877	.	C	T	2	4	6	0	0	6	0	0
6	10983029	.	A	C	2	7	9	1	0	10	0	0
6	10983066	.	T	C	1	4	5	0	0	5	0	0
6	10983193	.	T	A	4	4	8	0	1	9	0	0
6	10983203	.	C	T	4	5	9	0	1	10	0	0
6	10983274	.	C	A	2	2	4	0	1	5	0	0
6	10985878	.	C	T	3	3	6	0	0	6	0	0
6	10986131	.	C	T	0	5	5	0	6	11	0	0
6	10986652	.	A	G	4	7	11	0	0	11	0	0
6	11067436	.	A	C	1	2	3	0	0	3	0	0
6	11070411	.	G	C	26	11	37	0	4	41	0	0
6	11070563	.	A	C	23	34	57	0	4	62	1	0
6	11070806	.	G	A	25	25	50	0	4	54	0	0
6	11071056	.	T	A	21	19	40	0	1	41	0	0
6	11071222	.	A	G	19	24	43	0	5	48	0	0
6	11071345	.	G	A	9	11	20	0	3	23	0	0
6	11071357	.	A	G	4	8	12	0	0	12	0	0
6	11101765	.	T	A	5	2	7	0	0	7	0	0
6	11129357	.	T	C	1	2	3	0	0	3	0	0
6	11253396	.	T	C	2	2	4	0	1	5	0	0
6	11254430	.	C	T	1	3	4	0	0	4	0	0
6	11257788	.	C	T	3	4	7	0	0	7	0	0
6	11261308	.	C	A	9	7	16	0	0	16	0	0
6	11262080	.	C	T	8	7	15	0	0	15	0	0
6	11264258	.	G	A	6	9	15	0	0	15	0	0
6	11265321	.	G	T	15	8	23	0	1	24	0	0
6	11265424	.	T	C	8	10	18	0	4	22	0	0
6	11265505	.	A	T	8	18	26	0	0	26	0	0
6	11265562	.	T	A	6	13	19	0	1	20	0	0
6	11265761	.	A	T	19	27	46	0	1	47	0	0
6	11266104	.	A	G	6	26	32	0	2	34	0	0
6	11266111	.	A	G	15	0	15	0	18	34	1	0
6	11266164	.	T	C	16	29	45	0	1	46	0	0
6	11266176	.	C	T	16	25	41	0	2	43	0	0
6	11266360	.	T	G	18	11	29	0	0	29	0	0
6	11266490	.	A	T	6	5	11	0	0	11	0	0
6	11266496	.	T	C	5	5	10	0	0	10	0	0
6	11276827	.	T	A	2	0	2	0	2	4	0	0
6	11276912	.	A	G	2	1	3	0	0	3	0	0
6	11279686	.	T	C	0	0	0	0	1	1	0	0
6	11281923	.	A	G	3	1	4	0	0	4	0	0
6	11281973	.	G	A	8	6	14	0	1	15	0	0
6	11285310	.	C	T	2	4	6	0	3	9	0	0
6	11285362	.	T	C	2	0	2	0	5	7	0	0
6	11285374	.	C	T	2	5	7	0	0	7	0	0
6	11285453	.	T	C	7	6	13	0	0	13	0	0
6	11285459	.	C	G	6	6	12	0	1	13	0	0
6	11285772	.	C	T	3	4	7	0	0	7	0	0
6	11285835	.	G	A	3	4	7	0	1	8	0	0
6	11288265	.	T	G	2	2	4	0	1	5	0	0
6	11292087	.	G	T	0	1	1	0	0	1	0	0
6	11295435	.	G	T	1	2	3	0	0	3	0	0
6	11295616	.	T	G	3	2	5	0	0	5	0	0
6	11298514	.	A	G	2	2	4	0	0	4	0	0
6	11298557	.	G	A	0	1	1	0	0	1	0	0
6	11299643	.	C	T	2	2	4	0	0	4	0	0
6	11299680	.	A	T	2	5	7	0	0	7	0	0
6	11299682	.	C	T	2	2	4	0	3	7	0	0
6	11303424	.	T	G	0	1	1	0	0	1	0	0
6	11407918	.	G	A	3	1	4	0	0	4	0	0
6	11407944	.	A	G	3	1	4	0	0	4	0	0
6	11407954	.	A	G	3	1	4	0	0	4	0	0
6	11414448	.	T	C	11	13	24	0	0	24	0	0
6	11414748	.	G	A	9	4	13	0	2	15	0	0
6	11414777	.	A	T	8	5	13	0	0	13	0	0
6	11415089	.	G	A	11	6	17	0	0	17	0	0
6	11415104	.	C	T	5	5	10	0	9	19	0	0
6	11507994	.	A	G	0	3	3	0	0	3	0	0
6	11765506	.	A	G	21	31	52	0	3	55	0	0
6	11766190	.	T	A	23	12	35	0	0	35	0	0
6	11766267	.	G	A	23	11	34	0	1	35	0	0
6	11766276	.	A	G	26	11	37	0	0	37	0	0
6	11766765	.	T	C	1	5	6	0	1	7	0	0
6	12529163	.	C	T	1	2	3	0	0	3	0	0
6	12529247	.	C	T	3	1	4	0	0	4	0	0
6	12550437	.	G	A	3	1	4	0	2	6	0	0
6	12550764	.	G	A	7	9	16	0	2	18	0	0
6	12550934	.	C	T	15	15	30	0	0	30	0	0
6	12797755	.	G	A	3	5	8	0	2	10	0	0
6	12797815	.	A	G	9	3	12	0	2	14	0	0
6	12803568	.	A	G	2	3	5	0	0	5	0	0
6	12803598	.	T	C	2	2	4	0	1	5	0	0
6	12804024	.	A	T	3	2	5	0	0	5	0	0
6	13037675	.	C	T	2	1	3	0	0	3	0	0
6	13187103	.	T	G	0	0	0	0	7	7	0	0
6	13510493	.	G	A	0	1	1	0	0	1	0	0
6	13513936	.	C	T	3	3	6	0	0	6	0	0
6	13730697	.	G	A	1	1	2	0	0	2	0	0
6	13734266	.	G	A	1	2	3	0	1	4	0	0
6	13734439	.	C	T	4	2	6	0	0	6	0	0
6	13734449	.	C	T	2	3	5	0	1	6	0	0
6	13743317	.	G	A	16	24	40	0	1	41	0	0
6	13743753	.	T	C	27	22	49	1	2	52	0	0
6	13743923	.	C	T	29	30	59	0	5	64	0	0
6	13744099	.	C	T	35	24	59	0	4	63	0	0
6	13746346	.	T	A	8	3	11	0	0	11	0	0
6	13806522	.	C	T	8	8	16	0	3	19	0	0
6	13862576	.	A	C	9	10	19	0	1	20	0	0
6	13866551	.	G	A	14	18	32	0	1	33	0	0
6	13868823	.	A	G	20	12	32	0	2	34	0	0
6	13868850	.	A	T	21	6	27	0	3	30	0	0
6	13869343	.	A	C	6	6	12	0	2	14	0	0
6	13869608	.	C	T	19	19	38	0	1	39	0	0
6	13871906	.	G	T	1	2	3	0	0	3	0	0
6	13871941	.	T	G	1	3	4	0	0	4	0	0
6	13873193	.	T	C	2	1	3	0	0	3	0	0
6	13901312	.	C	T	1	1	2	0	0	2	0	0
6	13908633	.	G	A	0	7	7	0	7	14	0	0
6	13914821	.	T	C	4	2	6	0	0	6	0	0
6	13914824	.	G	A	4	1	5	0	1	6	0	0
6	13920194	.	A	G	6	5	11	0	0	11	0	0
6	13920275	.	T	G	3	2	5	0	0	5	0	0
6	13941729	.	C	A	2	2	4	0	1	5	0	0
6	13967038	.	A	T	1	3	4	0	0	4	0	0
6	13967328	.	G	A	1	0	1	0	1	2	0	0
6	13967512	.	C	A	5	6	11	0	2	13	0	0
6	13977080	.	T	A	3	1	4	0	1	5	0	0
6	13977567	.	G	T	4	13	17	0	0	17	0	0
6	13977588	.	C	T	4	14	18	0	2	20	0	0
6	13977648	.	G	A	5	5	10	0	1	11	0	0
6	13987287	.	G	C	6	3	9	0	2	11	0	0
6	13987299	.	A	T	8	7	15	0	0	15	0	0
6	13987346	.	C	T	3	6	9	0	0	9	0	0
6	13987560	.	T	C	7	9	16	0	5	21	0	0
6	13987631	.	G	A	17	12	29	0	0	29	0	0
6	13987663	.	T	A	15	10	25	0	2	27	0	0
6	13987710	.	G	A	10	10	20	0	0	20	0	0
6	13987713	.	T	G	8	10	18	0	1	19	0	0
6	13993553	.	G	C	1	2	3	0	0	3	0	0
6	14032693	.	T	C	27	7	34	1	2	37	0	0
6	14032698	.	T	A	29	7	36	1	0	37	0	0
6	14032739	.	G	A	16	16	32	0	2	34	0	0
6	14033030	.	G	T	8	7	15	0	2	17	0	0
6	14033167	.	G	A	14	16	30	0	3	33	0	0
6	14033556	.	T	A	3	3	6	0	1	7	0	0
6	14033836	.	G	C	5	4	9	0	0	9	0	0
6	14034887	.	G	C	7	7	14	0	0	14	0	0
6	14034907	.	C	T	0	6	6	0	10	16	0	0
6	14034949	.	G	A	4	8	12	0	0	12	0	0
6	14086810	.	T	C	20	31	51	0	3	54	0	0
6	14086901	.	G	T	21	26	47	0	8	55	0	0
6	14086942	.	G	C	23	33	56	0	2	58	0	0
6	14087182	.	C	A	26	18	44	0	6	50	0	0
6	14087220	.	T	A	29	26	55	0	0	55	0	0
6	14087569	.	T	G	19	28	47	0	2	49	0	0
6	14087641	.	A	C	18	30	48	0	3	51	0	0
6	14087883	.	T	C	12	12	24	0	3	27	0	0
6	14088095	.	C	T	15	24	39	0	3	42	0	0
6	14092942	.	T	A	8	13	21	0	4	26	1	0
6	14096684	.	C	T	0	1	1	0	2	3	0	0
6	14098760	.	C	T	1	12	13	0	9	22	0	0
6	14105071	.	G	T	3	4	7	0	0	7	0	0
6	14172926	.	A	T	4	2	6	0	0	6	0	0
6	14173599	.	A	G	4	7	11	0	1	12	0	0
6	14173641	.	G	A	6	4	10	0	0	10	0	0
6	14212370	.	G	A	1	2	3	0	0	3	0	0
6	16045912	.	T	C	7	1	8	0	17	25	0	0
6	16046443	.	T	C	6	5	11	0	0	11	0	0
6	17726055	.	C	A	8	3	11	0	1	12	0	0
6	17726078	.	G	A	2	3	5	0	3	8	0	0
6	17727452	.	A	G	2	4	6	0	0	6	0	0
6	18554719	.	T	C	0	0	0	0	6	6	0	0
6	18937533	.	A	T	0	4	4	0	0	4	0	0
6	18937633	.	T	A	1	2	3	0	1	4	0	0
6	20918141	.	A	G	1	3	4	0	0	4	0	0
6	20918193	.	A	G	2	2	4	0	0	4	0	0
6	22026241	.	A	G	0	4	4	0	1	5	0	0
6	22326656	.	A	T	0	4	4	0	0	4	0	0
6	22683308	.	A	G	7	6	13	0	0	13	0	0
6	23053572	.	A	G	6	3	9	0	2	11	0	0
6	23053583	.	G	T	12	3	15	0	1	16	0	0
6	23053714	.	A	G	2	5	7	0	0	7	0	0
6	23053761	.	A	G	5	5	10	0	1	11	0	0
6	23053784	.	A	G	8	5	13	0	0	13	0	0
6	23054267	.	A	G	16	0	16	0	16	32	0	0
6	25169385	.	T	A	1	2	3	0	0	3	0	0
6	27088476	.	C	T	2	2	4	0	0	4	0	0
6	27271208	.	A	G	14	1	15	0	29	44	0	0
6	27271214	.	A	G	23	16	39	0	2	41	0	0
6	27271312	.	A	G	4	19	23	0	2	25	0	0
6	27271530	.	A	G	18	16	34	0	2	36	0	0
6	27816260	.	T	C	5	6	11	0	0	11	0	0
6	27874309	.	T	C	7	11	18	0	5	23	0	0
6	27874487	.	G	A	26	12	38	0	5	43	0	0
6	27874529	.	G	A	0	26	26	0	17	43	0	0
6	27874591	.	T	A	23	21	44	0	4	48	0	0
6	27874674	.	T	C	12	20	32	0	0	32	0	0
6	27874680	.	C	G	11	22	33	0	1	34	0	0
6	27874753	.	G	C	0	7	7	0	3	10	0	0
6	27874769	.	T	A	3	5	8	0	1	9	0	0
6	27874896	.	T	A	11	17	28	0	1	29	0	0
6	27875309	.	T	C	25	16	41	0	3	44	0	0
6	27875555	.	C	T	26	33	59	0	12	71	0	0
6	27875873	.	A	G	28	27	55	0	2	57	0	0
6	27875876	.	T	G	27	26	53	0	3	56	0	0
6	27875941	.	C	G	27	26	53	0	4	57	0	0
6	27875944	.	G	A	0	27	27	0	30	57	0	0
6	27876051	.	T	A	34	21	55	0	7	62	0	0
6	27876134	.	C	T	25	24	49	0	2	51	0	0
6	27884952	.	G	A	2	1	3	0	0	3	0	0
6	27884967	.	G	A	2	1	3	0	0	3	0	0
6	27922934	.	G	A	0	2	2	0	1	3	0	0
6	27997662	.	C	A	0	1	1	0	1	2	0	0
6	27999373	.	T	C	2	4	6	0	0	6	0	0
6	27999744	.	A	C	3	4	7	0	0	7	0	0
6	28000242	.	T	A	5	3	8	0	0	8	0	0
6	28033174	.	G	C	1	1	2	0	0	2	0	0
6	28035197	.	G	A	0	1	1	0	3	4	0	0
6	28039034	.	C	T	3	5	8	0	0	8	0	0
6	28039175	.	T	A	1	2	3	0	0	3	0	0
6	28041161	.	G	A	0	4	4	0	4	8	0	0
6	28044308	.	C	T	0	1	1	0	0	1	0	0
6	28044398	.	C	T	5	0	5	0	1	6	0	0
6	28049173	.	A	C	7	5	12	0	0	12	0	0
6	28049185	.	G	A	1	5	6	0	5	11	0	0
6	28207340	.	C	T	7	3	10	0	1	11	0	0
6	28207418	.	C	G	14	14	28	0	0	28	0	0
6	28207593	.	A	G	4	4	8	0	1	9	0	0
6	28216496	.	G	A	7	6	13	0	1	14	0	0
6	28216535	.	C	T	19	10	29	0	1	30	0	0
6	28217058	.	C	G	1	3	4	0	0	4	0	0
6	28217103	.	T	C	4	1	5	0	8	13	0	0
6	28217596	.	C	T	0	9	9	0	7	16	0	0
6	28218367	.	G	A	3	6	9	0	0	9	0	0
6	28914331	.	A	G	9	6	15	0	0	15	0	0
6	28914418	.	A	G	14	16	30	0	0	30	0	0
6	28914571	.	T	A	24	12	36	0	0	36	0	0
6	28914790	.	G	A	17	6	23	0	1	24	0	0
6	28914886	.	G	A	14	9	23	0	1	24	0	0
6	28915342	.	T	G	8	4	12	0	1	13	0	0
6	28923667	.	G	A	0	1	1	0	0	1	0	0
6	28926540	.	C	T	1	0	1	0	0	1	0	0
6	28926567	.	T	A	2	2	4	0	0	4	0	0
6	28929960	.	A	G	1	2	3	0	0	3	0	0
6	28931184	.	C	T	1	4	5	0	0	5	0	0
6	28934498	.	A	G	0	0	0	0	1	1	0	0
6	28946048	.	A	T	10	14	24	0	5	29	0	0
6	28946199	.	T	G	14	9	23	0	3	26	0	0
6	28956323	.	A	G	6	4	10	0	2	12	0	0
6	28956350	.	T	A	5	1	6	0	0	6	0	0
6	28957089	.	G	A	7	0	7	0	0	7	0	0
6	28957814	.	C	G	2	3	5	0	0	5	0	0
6	28957820	.	G	T	2	3	5	0	0	5	0	0
6	29039981	.	A	C	0	0	0	0	2	2	0	0
6	29040066	.	A	C	4	2	6	0	0	6	0	0
6	29040870	.	C	T	0	2	2	0	5	7	0	0
6	29086613	.	C	T	1	3	4	0	1	5	0	0
6	29086676	.	A	T	2	5	7	0	0	7	0	0
6	29089480	.	T	A	9	12	21	0	0	21	0	0
6	29096659	.	A	C	5	9	14	0	5	19	0	0
6	29097384	.	G	A	4	2	6	0	0	6	0	0
6	29103005	.	G	A	1	6	7	0	1	8	0	0
6	29103749	.	T	C	3	2	5	0	0	5	0	0
6	29147764	.	C	T	4	1	5	0	0	5	0	0
6	29152208	.	C	T	12	4	16	0	0	16	0	0
6	29152334	.	G	A	3	3	6	0	1	7	0	0
6	29152669	.	A	G	1	2	3	0	0	3	0	0
6	29154193	.	C	T	0	6	6	0	0	6	0	0
6	29154280	.	T	A	4	3	7	0	2	9	0	0
6	29154496	.	A	G	1	3	4	0	0	4	0	0
6	29154520	.	C	T	1	3	4	0	0	4	0	0
6	29154889	.	C	A	2	5	7	0	0	7	0	0
6	29155039	.	G	A	1	2	3	0	0	3	0	0
6	29156573	.	A	C	3	2	5	0	0	5	0	0
6	29158227	.	T	C	3	3	6	0	0	6	0	0
6	29221040	.	C	T	3	1	4	0	0	4	0	0
6	29223513	.	G	A	0	2	2	0	0	2	0	0
6	29226070	.	G	C	5	6	11	0	0	11	0	0
6	29226077	.	A	C	5	7	12	0	0	12	0	0
6	29226186	.	A	G	7	13	20	0	2	22	0	0
6	29226189	.	C	T	14	8	22	0	1	23	0	0
6	29226767	.	A	T	15	9	24	0	1	25	0	0
6	29226790	.	G	A	6	15	21	0	4	25	0	0
6	29226823	.	A	C	4	15	19	0	1	20	0	0
6	29227149	.	A	G	21	15	36	0	6	49	7	0
6	29227555	.	T	C	3	2	5	0	0	5	0	0
6	29278868	.	T	G	3	3	6	0	0	6	0	0
6	29278874	.	G	A	2	3	5	0	1	6	0	0
6	29288121	.	A	G	2	4	6	0	0	6	0	0
6	29289905	.	G	A	1	0	1	0	1	2	0	0
6	29291606	.	C	T	3	3	6	0	0	6	0	0
6	29291614	.	T	C	2	3	5	0	0	5	0	0
6	29291666	.	G	A	1	3	4	0	0	4	0	0
6	29295492	.	T	A	7	9	16	0	1	17	0	0
6	29295517	.	G	C	4	13	17	0	1	18	0	0
6	29295535	.	T	A	5	12	17	0	2	19	0	0
6	29295714	.	G	A	3	5	8	0	0	8	0	0
6	29295851	.	G	A	1	8	9	0	0	9	0	0
6	29295860	.	C	T	1	6	7	0	2	9	0	0
6	29297379	.	G	T	4	1	5	0	1	6	0	0
6	29303630	.	G	A	0	2	2	0	1	3	0	0
6	29303778	.	C	T	0	2	2	0	2	4	0	0
6	29303863	.	T	A	2	3	5	0	0	5	0	0
6	29303925	.	C	T	1	2	3	0	0	3	0	0
6	29313312	.	C	A	5	8	13	0	0	13	0	0
6	29313607	.	A	T	18	9	27	0	0	27	0	0
6	29313679	.	A	G	8	13	21	0	0	21	0	0
6	29322029	.	T	C	1	0	1	0	1	2	0	0
6	29322595	.	C	G	1	4	5	0	0	5	0	0
6	29335675	.	G	A	1	3	4	0	0	4	0	0
6	29387493	.	G	A	3	3	6	0	0	6	0	0
6	29390565	.	A	G	1	1	2	0	0	2	0	0
6	29393533	.	T	A	0	3	3	0	0	3	0	0
6	29393714	.	C	T	2	1	3	0	0	3	0	0
6	29395297	.	C	T	17	13	30	0	1	31	0	0
6	29395424	.	G	A	12	17	29	0	0	29	0	0
6	29395497	.	T	A	12	6	18	0	0	18	0	0
6	29397697	.	G	A	6	6	12	0	2	14	0	0
6	29403052	.	G	T	0	12	12	0	10	22	0	0
6	29403550	.	G	A	4	4	8	0	0	8	0	0
6	29404094	.	T	C	14	8	22	0	2	24	0	0
6	29410040	.	C	T	5	4	9	0	0	9	0	0
6	29459034	.	T	C	1	1	2	0	0	2	0	0
6	29466993	.	T	A	1	1	2	0	1	3	0	0
6	29467159	.	G	C	1	3	4	0	1	5	0	0
6	29476983	.	C	A	2	3	5	0	0	5	0	0
6	29477093	.	T	A	3	4	7	0	0	7	0	0
6	29477094	.	T	C	3	4	7	0	0	7	0	0
6	29488695	.	A	G	1	1	2	0	0	2	0	0
6	29703846	.	A	C	2	3	5	0	0	5	0	0
6	29703865	.	A	T	2	2	4	0	0	4	0	0
6	29705561	.	A	T	12	7	19	1	1	21	0	0
6	29705767	.	A	G	7	11	18	0	3	21	0	0
6	29705901	.	T	C	1	3	4	0	0	4	0	0
6	29708010	.	T	C	1	1	2	0	0	2	0	0
6	29708073	.	A	C	2	4	6	0	1	7	0	0
6	29710111	.	C	T	1	3	4	0	0	4	0	0
6	29710157	.	A	G	4	0	4	0	7	11	0	0
6	29710216	.	C	T	4	6	10	0	0	10	0	0
6	29710988	.	A	G	2	3	5	0	1	6	0	0
6	29712470	.	T	C	8	7	15	0	0	15	0	0
6	29712651	.	G	A	6	5	11	0	2	13	0	0
6	29713920	.	G	T	5	7	12	0	0	12	0	0
6	29713926	.	T	C	5	9	14	0	0	14	0	0
6	29714017	.	A	G	3	8	11	0	6	17	0	0
6	29714054	.	A	C	2	4	6	0	0	6	0	0
6	29714064	.	C	T	2	2	4	0	0	4	0	0
6	29791206	.	C	G	11	6	17	0	1	18	0	0
6	29791310	.	A	C	4	7	11	0	0	11	0	0
6	29793798	.	C	A	5	15	20	0	1	21	0	0
6	29794003	.	T	G	5	6	11	0	1	12	0	0
6	29794639	.	T	C	30	30	60	0	3	63	0	0
6	30019954	.	C	T	2	2	4	0	1	5	0	0
6	30027896	.	C	A	5	6	11	0	1	12	0	0
6	30048421	.	G	A	0	2	2	0	5	7	0	0
6	30052061	.	C	A	6	14	20	0	3	23	0	0
6	30052085	.	A	G	4	8	12	0	1	13	0	0
6	30082255	.	G	A	8	7	15	0	0	15	0	0
6	30082752	.	T	G	9	22	31	0	2	33	0	0
6	30115399	.	A	G	0	2	2	0	0	2	0	0
6	30121872	.	G	T	2	2	4	0	0	4	0	0
6	30122248	.	A	T	3	4	7	0	0	7	0	0
6	30124575	.	C	T	12	14	26	0	1	27	0	0
6	30134052	.	C	T	1	7	8	0	23	32	1	0
6	30147219	.	G	A	3	0	3	0	0	3	0	0
6	30147831	.	C	T	7	4	11	0	1	12	0	0
6	30148056	.	A	T	7	3	10	0	1	11	0	0
6	30148143	.	G	A	3	8	11	0	1	12	0	0
6	30148422	.	C	T	9	3	12	0	2	14	0	0
6	30151537	.	G	A	6	7	13	0	0	13	0	0
6	30160956	.	C	T	2	4	6	0	0	6	0	0
6	30450458	.	T	C	2	2	4	0	0	4	0	0
6	30450464	.	G	A	1	2	3	0	0	3	0	0
6	30452669	.	A	T	2	2	4	0	0	4	0	0
6	30583815	.	A	G	4	2	6	0	0	6	0	0
6	30626227	.	A	G	15	13	28	0	1	29	0	0
6	30626240	.	A	T	17	16	33	0	0	33	0	0
6	30626276	.	T	C	14	14	28	0	5	33	0	0
6	30626715	.	T	G	12	9	21	0	4	25	0	0
6	30626765	.	C	T	12	14	26	0	0	26	0	0
6	30626908	.	G	A	14	4	18	0	1	19	0	0
6	30627292	.	T	C	19	12	31	0	0	31	0	0
6	30627433	.	A	T	7	12	19	1	1	21	0	0
6	30627549	.	G	A	11	6	17	0	0	17	0	0
6	30627605	.	G	C	15	10	25	0	3	28	0	0
6	30627606	.	A	C	14	0	14	0	14	28	0	0
6	30627660	.	A	C	15	9	24	0	3	27	0	0
6	30627714	.	C	T	1	11	12	0	17	29	0	0
6	30627724	.	A	T	16	10	26	0	6	32	0	0
6	30627807	.	G	T	13	10	23	0	1	24	0	0
6	30627914	.	T	C	13	5	18	0	1	19	0	0
6	30627921	.	G	T	10	3	13	0	5	18	0	0
6	30627996	.	A	C	8	0	8	0	10	18	0	0
6	30627998	.	T	C	8	0	8	0	10	18	0	0
6	30628066	.	T	C	5	10	15	0	0	15	0	0
6	30628170	.	T	C	3	8	11	0	0	11	0	0
6	30628185	.	G	A	3	9	12	0	0	12	0	0
6	30628447	.	G	A	7	5	12	0	2	14	0	0
6	30628459	.	A	G	8	7	15	0	0	15	0	0
6	30628651	.	G	A	4	2	6	0	0	6	0	0
6	30628684	.	C	A	8	7	15	0	0	15	0	0
6	30628922	.	T	C	6	3	9	0	1	10	0	0
6	30628978	.	C	T	4	10	14	0	0	14	0	0
6	30629142	.	G	A	2	6	8	0	0	8	0	0
6	30629459	.	A	G	2	2	4	0	0	4	0	0
6	30629656	.	T	G	3	4	7	0	0	7	0	0
6	30629850	.	G	C	4	3	7	0	1	8	0	0
6	30629869	.	C	A	0	3	3	0	4	7	0	0
6	30629988	.	C	A	1	4	5	0	1	6	0	0
6	30631021	.	T	C	1	5	6	0	0	6	0	0
6	30677055	.	A	C	1	2	3	0	0	3	0	0
6	30677347	.	G	T	6	2	8	0	1	10	1	0
6	30677445	.	G	C	8	2	10	0	3	13	0	0
6	30677654	.	A	C	7	6	13	0	0	13	0	0
6	30678133	.	A	T	0	1	1	0	0	1	0	0
6	30678279	.	T	G	1	5	6	0	0	6	0	0
6	30678396	.	T	C	1	2	3	0	0	3	0	0
6	30681291	.	C	A	2	1	3	0	0	3	0	0
6	30682141	.	A	G	0	1	1	0	0	1	0	0
6	30685044	.	A	G	3	1	4	0	0	4	0	0
6	30685311	.	A	G	3	2	5	0	0	5	0	0
6	30685353	.	T	C	2	2	4	0	1	5	0	0
6	30685354	.	G	A	3	2	5	0	0	5	0	0
6	30685391	.	G	T	1	2	3	0	1	4	0	0
6	30685544	.	A	G	2	3	5	0	0	5	0	0
6	30685563	.	G	A	1	3	4	0	0	4	0	0
6	30688021	.	A	G	1	2	3	0	0	3	0	0
6	30700395	.	G	A	0	1	1	0	0	1	0	0
6	30710270	.	A	G	19	27	46	0	3	49	0	0
6	30710342	.	T	G	22	30	52	0	1	53	0	0
6	30710351	.	G	T	17	29	46	0	4	50	0	0
6	30710457	.	C	T	20	19	39	0	2	41	0	0
6	30710460	.	T	G	18	20	38	0	3	41	0	0
6	30710591	.	G	A	8	6	14	0	1	15	0	0
6	30711485	.	A	T	11	16	27	0	1	28	0	0
6	30711511	.	C	T	11	21	32	0	1	33	0	0
6	30711612	.	G	A	18	15	33	0	2	35	0	0
6	30711851	.	T	C	8	14	22	0	2	24	0	0
6	30711852	.	A	T	7	15	22	0	2	24	0	0
6	30711948	.	A	G	16	8	24	0	1	25	0	0
6	30711957	.	T	C	15	12	27	0	1	28	0	0
6	30712121	.	G	T	12	12	24	0	6	30	0	0
6	30712265	.	T	C	13	7	20	0	1	21	0	0
6	30712455	.	A	T	3	2	5	0	0	5	0	0
6	30712458	.	A	G	3	2	5	0	0	5	0	0
6	30712508	.	G	A	4	6	10	0	0	10	0	0
6	30712582	.	T	C	5	0	5	0	15	20	0	0
6	30713296	.	C	T	9	8	17	0	0	17	0	0
6	30713341	.	G	A	9	5	14	0	1	15	0	0
6	30713666	.	T	C	6	5	11	0	0	11	0	0
6	30713724	.	C	T	8	4	12	0	0	12	0	0
6	30713725	.	A	T	8	4	12	0	0	12	0	0
6	30713761	.	G	C	10	5	15	0	0	15	0	0
6	30713869	.	C	T	0	8	8	0	10	18	0	0
6	30713929	.	C	G	12	13	25	0	1	26	0	0
6	30714218	.	T	A	5	5	10	0	0	10	0	0
6	30714372	.	C	T	4	2	6	0	1	7	0	0
6	30715009	.	T	G	4	3	7	0	2	9	0	0
6	30715446	.	T	C	5	0	5	0	6	11	0	0
6	30715647	.	A	T	10	8	18	0	0	18	0	0
6	30715865	.	A	T	4	6	10	0	0	10	0	0
6	30717579	.	T	C	8	5	13	0	0	13	0	0
6	30719319	.	G	A	4	7	11	0	0	11	0	0
6	30719348	.	G	C	4	6	10	0	1	11	0	0
6	30719391	.	A	T	7	2	9	0	2	11	0	0
6	30721397	.	G	A	6	5	11	0	1	12	0	0
6	30740106	.	G	A	3	4	7	0	0	7	0	0
6	30740127	.	T	A	3	4	7	0	0	7	0	0
6	30853053	.	T	A	26	26	52	0	1	53	0	0
6	30859381	.	T	A	4	9	13	0	1	14	0	0
6	31069556	.	G	A	0	1	1	0	0	1	0	0
6	31184651	.	T	C	4	5	9	0	1	10	0	0
6	31185066	.	C	T	6	2	8	0	0	8	0	0
6	31185067	.	C	T	5	2	7	0	1	8	0	0
6	31185133	.	G	A	5	9	14	0	0	14	0	0
6	31185247	.	C	G	3	4	7	0	1	8	0	0
6	31185292	.	A	C	4	2	6	0	1	7	0	0
6	31187055	.	G	A	3	2	5	0	0	5	0	0
6	31187067	.	A	C	2	2	4	0	1	5	0	0
6	31280164	.	T	C	17	23	40	0	2	42	0	0
6	31280238	.	T	C	19	22	41	0	1	42	0	0
6	31280253	.	T	A	19	16	35	0	0	35	0	0
6	31280495	.	C	T	22	14	36	0	1	37	0	0
6	31280586	.	A	G	16	8	24	0	1	25	0	0
6	31280645	.	C	T	6	7	13	0	1	14	0	0
6	31280646	.	A	C	6	7	13	0	0	14	1	0
6	31280945	.	A	T	12	6	18	0	1	19	0	0
6	31281006	.	C	T	0	13	13	0	8	21	0	0
6	31281130	.	A	G	19	25	44	0	2	46	0	0
6	31281249	.	G	A	13	16	29	0	2	31	0	0
6	31281262	.	T	C	13	0	13	0	17	30	0	0
6	31281493	.	T	A	4	2	6	0	0	6	0	0
6	31281674	.	T	C	8	9	17	0	0	17	0	0
6	31281732	.	T	A	8	5	13	0	0	13	0	0
6	31281994	.	T	A	8	5	13	0	2	15	0	0
6	31282028	.	T	G	5	2	7	0	2	9	0	0
6	31282399	.	T	A	5	8	13	0	0	13	0	0
6	31282494	.	C	T	8	5	13	0	2	15	0	0
6	31282640	.	A	C	5	1	6	0	0	6	0	0
6	31282654	.	T	C	2	1	3	0	0	3	0	0
6	31283167	.	G	T	8	9	17	0	2	19	0	0
6	31283210	.	T	G	7	9	16	0	1	17	0	0
6	31283299	.	G	A	11	8	19	0	1	20	0	0
6	31285874	.	G	A	6	6	12	0	1	13	0	0
6	31288637	.	C	G	1	4	5	0	0	5	0	0
6	31288642	.	C	G	0	5	5	0	1	6	0	0
6	31288894	.	T	A	5	5	10	0	0	10	0	0
6	31291030	.	G	A	2	1	3	0	0	3	0	0
6	31291033	.	C	A	2	1	3	0	0	3	0	0
6	31352907	.	T	C	5	5	10	0	0	10	0	0
6	31352963	.	A	G	9	8	17	0	3	20	0	0
6	31353073	.	T	C	13	6	19	0	3	22	0	0
6	31353099	.	T	C	13	4	17	0	1	18	0	0
6	31353613	.	G	A	6	8	14	0	2	16	0	0
6	31417667	.	C	T	0	2	2	0	0	2	0	0
6	31426287	.	G	T	12	3	15	0	2	17	0	0
6	31426465	.	T	C	13	6	19	0	0	19	0	0
6	31426881	.	C	T	7	8	15	0	3	18	0	0
6	31426955	.	G	A	8	3	11	0	2	13	0	0
6	31427261	.	T	C	1	3	4	0	0	4	0	0
6	31427905	.	A	G	8	8	16	0	1	17	0	0
6	31427937	.	A	G	13	8	21	0	2	23	0	0
6	31428204	.	T	C	14	9	23	0	1	24	0	0
6	31428283	.	C	A	25	10	35	0	1	36	0	0
6	31428448	.	T	A	3	2	5	0	1	6	0	0
6	31428484	.	T	A	4	2	6	0	0	6	0	0
6	31428485	.	G	A	3	2	5	0	1	6	0	0
6	31428770	.	G	A	10	15	25	0	1	26	0	0
6	31428780	.	T	G	10	16	26	0	3	29	0	0
6	31431422	.	A	G	21	16	37	0	2	39	0	0
6	31431646	.	A	T	20	13	33	0	0	33	0	0
6	31431870	.	G	A	14	7	21	0	2	24	1	0
6	31432213	.	G	A	5	6	11	0	0	11	0	0
6	31432214	.	C	A	5	6	11	0	0	11	0	0
6	31432302	.	G	A	4	4	8	0	0	8	0	0
6	31432563	.	T	C	4	4	8	0	1	9	0	0
6	31432684	.	T	C	2	5	7	0	0	7	0	0
6	31432746	.	A	C	6	3	9	0	2	11	0	0
6	31432761	.	A	G	8	5	13	0	0	13	0	0
6	31432892	.	G	A	12	7	19	0	0	19	0	0
6	31432950	.	G	A	10	3	13	0	2	15	0	0
6	31432955	.	T	C	9	3	12	0	1	13	0	0
6	31432991	.	T	C	4	7	11	0	0	11	0	0
6	31433020	.	A	C	4	7	11	0	1	12	0	0
6	31433033	.	T	G	4	6	10	0	1	11	0	0
6	31433060	.	T	C	2	0	2	0	0	2	0	0
6	31433252	.	T	A	3	3	6	0	0	6	0	0
6	31433262	.	G	T	2	3	5	0	0	5	0	0
6	31433362	.	T	A	1	2	3	0	1	4	0	0
6	31433692	.	A	T	2	4	6	0	0	6	0	0
6	31433846	.	G	A	6	3	9	0	0	9	0	0
6	31434050	.	C	A	2	3	5	0	0	5	0	0
6	31434773	.	T	G	2	7	9	0	0	9	0	0
6	31435005	.	T	C	2	3	5	0	0	5	0	0
6	31435017	.	C	T	0	2	2	0	3	5	0	0
6	31438395	.	T	C	2	3	5	0	0	5	0	0
6	31438404	.	T	G	2	2	4	0	0	4	0	0
6	31591123	.	C	T	4	12	16	0	8	24	0	0
6	31591163	.	A	G	8	10	18	0	2	20	0	0
6	31591619	.	G	A	8	11	19	0	1	20	0	0
6	31591841	.	G	A	18	10	28	0	7	35	0	0
6	31607768	.	T	G	6	9	15	0	2	17	0	0
6	31611647	.	T	A	4	1	5	0	1	6	0	0
6	31617167	.	C	G	0	4	4	0	6	10	0	0
6	31624107	.	T	C	0	1	1	0	0	1	0	0
6	32010215	.	C	T	4	3	7	0	1	8	0	0
6	32010259	.	G	A	5	13	18	0	0	18	0	0
6	32010341	.	C	T	0	20	20	0	19	39	0	0
6	32010475	.	A	G	4	1	5	0	1	6	0	0
6	32014771	.	T	G	4	1	5	0	0	5	0	0
6	32016492	.	T	C	2	3	5	0	0	5	0	0
6	32024960	.	C	T	2	3	5	0	0	5	0	0
6	32029267	.	A	T	2	3	5	0	0	5	0	0
6	32029269	.	A	T	2	3	5	0	0	5	0	0
6	32032371	.	A	C	4	8	12	0	0	12	0	0
6	32032374	.	A	C	4	7	11	0	1	12	0	0
6	32032479	.	C	T	2	5	7	0	0	7	0	0
6	32034611	.	G	A	0	3	3	0	1	4	0	0
6	32035921	.	G	A	3	1	4	0	0	4	0	0
6	32037710	.	T	C	1	3	4	0	0	4	0	0
6	32042381	.	G	A	1	4	5	0	0	5	0	0
6	32065159	.	C	G	1	3	4	0	0	4	0	0
6	32065238	.	A	G	2	5	7	0	0	7	0	0
6	32068411	.	G	C	2	2	4	0	0	4	0	0
6	32375581	.	T	C	0	1	1	0	0	1	0	0
6	32378689	.	T	C	2	3	5	0	0	5	0	0
6	32382629	.	C	T	5	1	6	0	0	6	0	0
6	32386908	.	T	C	5	1	6	0	0	6	0	0
6	32396755	.	T	C	4	1	5	0	1	6	0	0
6	32397588	.	C	T	19	17	36	0	2	38	0	0
6	32397659	.	T	C	3	0	3	0	1	4	0	0
6	32404206	.	C	G	7	2	9	0	1	10	0	0
6	32404863	.	C	T	0	9	9	0	9	18	0	0
6	32405054	.	A	T	9	5	14	0	1	15	0	0
6	32405266	.	G	A	10	3	13	0	0	13	0	0
6	32405478	.	A	T	3	4	7	0	0	7	0	0
6	32405952	.	C	T	5	3	8	0	1	9	0	0
6	32408299	.	G	A	2	1	3	0	0	3	0	0
6	32415560	.	C	A	1	4	5	0	0	5	0	0
6	32415658	.	T	G	2	0	2	0	0	2	0	0
6	32481835	.	G	A	1	2	3	0	0	3	0	0
6	32497549	.	A	G	5	2	7	0	0	7	0	0
6	32506349	.	T	A	3	1	4	0	0	4	0	0
6	32506350	.	G	A	3	1	4	0	0	4	0	0
6	32506386	.	C	T	5	7	12	0	0	12	0	0
6	32506526	.	A	G	2	3	5	0	0	5	0	0
6	33550455	.	C	T	5	3	8	0	1	9	0	0
6	33550947	.	G	A	3	2	5	0	1	6	0	0
6	33552574	.	T	C	6	5	11	0	0	11	0	0
6	33552601	.	A	T	9	9	18	0	1	19	0	0
6	33554009	.	T	A	6	8	14	0	2	16	0	0
6	33554356	.	T	C	4	6	10	0	0	10	0	0
6	33554433	.	A	T	4	2	6	0	0	6	0	0
6	33554435	.	C	T	4	2	6	0	0	6	0	0
6	33554786	.	T	C	3	5	8	0	0	8	0	0
6	33554809	.	G	C	3	4	7	0	0	7	0	0
6	33554904	.	T	G	1	3	4	0	0	4	0	0
6	33555235	.	G	T	2	3	5	0	0	5	0	0
6	33555241	.	T	C	2	3	5	0	0	5	0	0
6	33555736	.	G	T	4	4	8	1	6	15	0	0
6	33555808	.	C	G	10	9	19	0	0	19	0	0
6	33556036	.	T	A	8	7	15	0	1	16	0	0
6	33556316	.	C	T	6	10	16	0	2	18	0	0
6	33556325	.	A	T	7	9	16	0	1	17	0	0
6	33556424	.	A	G	5	5	10	0	1	11	0	0
6	33556497	.	A	T	6	11	17	1	2	20	0	0
6	33556706	.	G	C	14	8	22	0	0	22	0	0
6	33556730	.	A	G	15	9	24	0	0	24	0	0
6	33556772	.	A	T	9	10	19	0	0	19	0	0
6	33556819	.	G	A	13	6	19	0	2	21	0	0
6	33556835	.	T	C	13	9	22	0	2	24	0	0
6	33556877	.	G	A	0	15	15	0	17	32	0	0
6	33557227	.	A	G	5	15	20	0	2	22	0	0
6	33557377	.	A	C	4	9	13	0	1	14	0	0
6	33557562	.	T	G	18	20	38	0	1	39	0	0
6	33557625	.	C	T	19	18	37	0	2	39	0	0
6	33558204	.	G	A	12	6	18	0	0	18	0	0
6	33558437	.	G	A	21	17	38	0	3	41	0	0
6	33663690	.	T	C	5	9	14	0	1	15	0	0
6	33663701	.	T	C	10	5	15	0	1	16	0	0
6	33663776	.	A	T	12	8	20	0	1	21	0	0
6	33663839	.	C	T	0	15	15	0	13	28	0	0
6	33663842	.	T	A	12	14	26	0	2	28	0	0
6	33664137	.	C	G	0	3	3	0	7	10	0	0
6	33664390	.	A	G	5	7	12	0	0	12	0	0
6	33664852	.	T	C	1	3	4	0	0	4	0	0
6	33664937	.	G	C	6	2	8	0	2	10	0	0
6	33665062	.	A	G	8	2	10	0	0	10	0	0
6	33665097	.	A	G	7	3	10	0	0	10	0	0
6	33665578	.	A	T	4	5	9	0	0	9	0	0
6	33665734	.	C	T	4	8	12	0	2	14	0	0
6	33665968	.	C	T	5	6	11	0	0	11	0	0
6	33666302	.	C	A	7	6	13	0	0	13	0	0
6	33666308	.	G	A	6	6	12	0	1	13	0	0
6	33666472	.	G	T	7	8	15	0	0	15	0	0
6	33666499	.	A	G	8	5	13	0	1	14	0	0
6	33666511	.	C	T	0	6	6	0	9	15	0	0
6	33666578	.	G	T	3	7	10	0	0	10	0	0
6	33666631	.	C	T	4	11	15	0	1	16	0	0
6	33666660	.	A	T	3	7	10	0	1	11	0	0
6	33666777	.	C	T	4	8	12	0	0	12	0	0
6	33666910	.	G	T	2	6	8	0	0	8	0	0
6	33666952	.	T	C	3	0	3	0	6	9	0	0
6	33666964	.	G	C	1	0	1	0	7	8	0	0
6	33667056	.	T	C	1	0	1	0	5	6	0	0
6	33667345	.	G	C	7	5	12	0	0	12	0	0
6	33667483	.	T	G	2	2	4	0	3	7	0	0
6	33667546	.	G	A	1	2	3	0	0	3	0	0
6	33668228	.	A	T	2	3	5	0	0	5	0	0
6	33875902	.	C	T	0	4	4	0	2	6	0	0
6	33883916	.	T	A	3	6	9	0	1	10	0	0
6	33884447	.	G	A	1	11	12	0	10	22	0	0
6	33896406	.	T	G	10	0	10	0	26	36	0	0
6	33896457	.	A	G	10	27	37	0	3	40	0	0
6	33896538	.	T	C	21	9	30	0	2	32	0	0
6	33896562	.	A	G	18	14	32	0	1	33	0	0
6	33896615	.	G	A	0	15	15	0	17	32	0	0
6	33896858	.	T	C	12	16	28	0	2	30	0	0
6	33896975	.	A	C	13	12	25	0	0	25	0	0
6	33897472	.	T	A	7	13	20	0	0	20	0	0
6	33897505	.	G	A	8	17	25	0	1	26	0	0
6	33897766	.	A	T	7	6	13	0	6	19	0	0
6	33912228	.	G	T	0	2	2	0	1	3	0	0
6	33912240	.	G	A	1	2	3	0	0	3	0	0
6	33912708	.	A	C	0	0	0	0	5	5	0	0
6	33918916	.	A	G	5	6	11	0	1	12	0	0
6	33921304	.	T	C	4	6	10	0	1	11	0	0
6	33921559	.	G	A	3	4	7	0	0	7	0	0
6	33924693	.	A	G	1	2	3	0	0	3	0	0
6	33925345	.	G	A	0	2	2	0	0	2	0	0
6	33929724	.	G	C	0	2	2	0	1	3	0	0
6	34072285	.	C	A	1	2	3	0	0	3	0	0
6	34072339	.	G	A	2	2	4	0	0	4	0	0
6	34072514	.	A	C	2	2	4	0	0	4	0	0
6	34072517	.	A	T	2	2	4	0	0	4	0	0
6	34806450	.	G	T	1	4	5	0	0	5	0	0
6	34808835	.	C	A	3	4	7	0	0	7	0	0
6	34808914	.	C	T	5	7	12	0	1	13	0	0
6	34809040	.	G	A	5	7	12	0	0	12	0	0
6	34809071	.	G	A	4	2	6	0	2	8	0	0
6	34809564	.	A	T	3	8	11	0	2	13	0	0
6	34809697	.	C	G	7	0	7	0	9	16	0	0
6	34809826	.	C	A	9	6	15	0	0	15	0	0
6	34809850	.	G	T	9	8	17	0	0	17	0	0
6	34810313	.	C	T	14	16	30	0	2	32	0	0
6	34810490	.	G	A	0	10	10	0	10	20	0	0
6	34810763	.	T	A	6	11	17	0	3	20	0	0
6	34810890	.	T	C	7	7	14	0	0	14	0	0
6	34810896	.	G	A	7	5	12	0	1	13	0	0
6	34811130	.	A	T	5	3	8	0	0	8	0	0
6	34811150	.	A	C	10	5	15	0	0	15	0	0
6	34811175	.	T	C	12	7	19	0	0	19	0	0
6	34825910	.	A	C	1	2	3	0	0	3	0	0
6	34826151	.	C	T	0	2	2	0	4	6	0	0
6	34826214	.	G	A	1	3	4	0	0	4	0	0
6	34826711	.	A	T	6	4	10	0	2	12	0	0
6	34826736	.	A	T	6	4	10	0	0	10	0	0
6	34826750	.	C	G	0	6	6	0	5	11	0	0
6	34826850	.	G	C	4	9	13	0	1	14	0	0
6	34826882	.	T	G	3	14	17	0	1	18	0	0
6	34831124	.	A	C	0	1	1	0	1	2	0	0
6	34848320	.	C	T	1	5	6	0	0	6	0	0
6	34932657	.	G	A	10	11	21	0	2	23	0	0
6	34932927	.	A	T	37	19	56	0	4	60	0	0
6	34933574	.	C	T	5	0	5	0	0	5	0	0
6	34934870	.	C	T	2	9	11	0	22	33	0	0
6	34934903	.	G	T	19	25	44	0	2	46	0	0
6	34943550	.	A	G	1	2	3	0	0	3	0	0
6	34943683	.	A	T	2	7	9	0	0	9	0	0
6	34943760	.	A	G	2	3	5	0	0	5	0	0
6	34944523	.	G	A	0	1	1	0	0	1	0	0
6	35036275	.	A	C	3	3	6	0	0	6	0	0
6	35036303	.	C	T	4	3	7	0	0	7	0	0
6	35036320	.	C	T	4	4	8	0	1	9	0	0
6	35036459	.	A	T	4	10	14	0	0	14	0	0
6	35036463	.	T	C	4	0	4	0	9	13	0	0
6	35036525	.	T	G	2	2	4	0	1	5	0	0
6	35039912	.	G	T	5	6	11	0	1	12	0	0
6	35039966	.	C	T	4	9	13	0	0	13	0	0
6	35042201	.	A	G	1	2	3	0	0	3	0	0
6	35046783	.	G	A	3	0	3	0	1	4	0	0
6	35051403	.	T	G	0	1	1	0	0	1	0	0
6	35056519	.	C	A	1	2	3	0	0	3	0	0
6	35056547	.	C	T	1	3	4	0	1	5	0	0
6	35056578	.	T	A	1	4	5	0	0	5	0	0
6	35058456	.	C	T	0	0	0	0	1	1	0	0
6	35099980	.	T	C	4	5	9	0	0	9	0	0
6	35100084	.	G	A	4	7	11	0	0	11	0	0
6	35100230	.	T	A	6	7	13	0	0	13	0	0
6	35100461	.	T	A	1	4	5	0	0	5	0	0
6	35100528	.	A	G	5	10	15	0	0	15	0	0
6	35100857	.	A	G	8	4	12	0	0	12	0	0
6	35100868	.	T	A	6	3	9	0	3	12	0	0
6	35100894	.	C	T	0	7	7	0	8	15	0	0
6	35100933	.	A	G	5	7	12	0	1	13	0	0
6	35101184	.	A	T	4	6	10	0	0	10	0	0
6	35101696	.	C	T	1	1	2	0	0	2	0	0
6	35101703	.	T	G	0	2	2	0	0	2	0	0
6	35101991	.	T	G	1	3	4	0	1	5	0	0
6	35102174	.	G	T	0	2	2	0	0	2	0	0
6	35102178	.	A	C	1	2	3	0	0	3	0	0
6	35136451	.	T	C	5	3	8	0	0	8	0	0
6	35136471	.	C	T	0	3	3	0	6	9	0	0
6	35136505	.	T	A	4	4	8	0	0	8	0	0
6	35136558	.	G	A	5	4	9	0	0	9	0	0
6	35137320	.	A	G	0	2	2	0	1	3	0	0
6	35137587	.	A	G	2	0	2	0	0	2	0	0
6	35309901	.	T	G	2	2	4	0	0	4	0	0
6	35309942	.	G	A	1	2	3	0	0	3	0	0
6	35364869	.	G	A	2	5	7	0	0	7	0	0
6	35365179	.	T	C	1	4	5	0	0	5	0	0
6	35365185	.	T	A	1	3	4	0	0	4	0	0
6	35365714	.	T	C	2	1	3	0	1	4	0	0
6	35365730	.	C	T	2	2	4	0	0	4	0	0
6	35365768	.	C	T	2	2	4	0	0	4	0	0
6	35365785	.	C	G	3	3	6	0	0	6	0	0
6	35366140	.	G	T	0	6	6	0	8	14	0	0
6	35366141	.	A	G	8	6	14	0	0	14	0	0
6	35366375	.	C	T	1	2	3	0	0	3	0	0
6	35366544	.	A	G	6	5	11	0	1	12	0	0
6	35366640	.	C	G	12	5	17	0	0	17	0	0
6	35389095	.	G	A	1	4	5	0	0	5	0	0
6	35389116	.	T	A	1	2	3	0	0	3	0	0
6	35443604	.	T	G	1	2	3	0	1	4	0	0
6	35443756	.	T	A	10	5	15	0	0	15	0	0
6	35443819	.	G	T	14	6	20	0	0	20	0	0
6	35443822	.	C	T	14	6	20	0	0	20	0	0
6	35443951	.	T	C	27	15	42	0	3	45	0	0
6	35443960	.	C	T	0	16	16	0	31	47	0	0
6	35444467	.	G	A	9	9	18	0	3	21	0	0
6	35676724	.	C	T	6	3	9	0	0	9	0	0
6	35676799	.	C	T	9	9	18	0	1	19	0	0
6	35677534	.	T	A	13	6	19	0	0	19	0	0
6	35693656	.	C	T	2	2	4	0	0	4	0	0
6	35738397	.	G	A	1	2	3	0	0	3	0	0
6	36129115	.	C	G	4	2	6	0	2	8	0	0
6	36129164	.	T	C	5	4	9	0	1	10	0	0
6	36129299	.	T	A	1	2	3	0	1	4	0	0
6	36129946	.	T	G	2	1	3	0	1	4	0	0
6	36130962	.	G	A	2	2	4	0	0	4	0	0
6	36130963	.	A	G	2	2	4	0	0	4	0	0
6	36131538	.	C	T	0	6	6	0	5	11	0	0
6	36131937	.	G	A	1	2	3	0	0	3	0	0
6	36471058	.	A	C	0	2	2	0	0	2	0	0
6	36552508	.	A	G	6	5	11	0	0	11	0	0
6	36720006	.	G	A	4	4	8	0	0	8	0	0
6	36720083	.	C	T	4	3	7	0	0	7	0	0
6	36720457	.	C	T	5	10	15	0	1	16	0	0
6	36720563	.	G	T	2	2	4	0	0	4	0	0
6	36721061	.	T	A	17	13	30	0	0	30	0	0
6	36721066	.	G	T	20	12	32	0	1	33	0	0
6	36721125	.	A	T	11	22	33	0	1	34	0	0
6	36721159	.	A	T	12	23	35	0	1	36	0	0
6	36721339	.	G	T	20	11	31	0	6	37	0	0
6	36721366	.	G	A	15	13	28	0	1	29	0	0
6	36721380	.	C	G	12	11	23	0	1	24	0	0
6	36724345	.	A	G	3	0	3	0	0	3	0	0
6	36724375	.	G	A	0	3	3	0	0	3	0	0
6	36758758	.	A	G	2	4	6	0	0	6	0	0
6	36760065	.	A	C	9	0	9	0	9	18	0	0
6	36760080	.	T	A	7	11	18	0	0	18	0	0
6	36760140	.	C	T	3	3	6	0	0	6	0	0
6	36783178	.	T	C	1	2	3	0	0	3	0	0
6	36783187	.	T	A	1	1	2	0	0	2	0	0
6	36789072	.	A	G	0	2	2	0	0	2	0	0
6	36792112	.	A	G	1	3	4	0	0	4	0	0
6	36792130	.	A	T	1	3	4	0	1	5	0	0
6	36792163	.	C	G	4	3	7	0	0	7	0	0
6	36792294	.	A	G	0	1	1	0	0	1	0	0
6	36819202	.	C	G	3	3	6	0	0	6	0	0
6	36876926	.	A	G	3	2	5	0	0	5	0	0
6	36877288	.	A	G	7	4	11	0	0	11	0	0
6	36877293	.	A	C	3	7	10	0	1	11	0	0
6	36877419	.	A	G	5	0	5	0	3	8	0	0
6	36897568	.	A	C	1	2	3	0	0	3	0	0
6	37071353	.	G	A	6	4	10	0	0	10	0	0
6	37071374	.	A	G	6	3	9	0	1	10	0	0
6	37163366	.	A	T	4	6	10	0	1	11	0	0
6	37163449	.	G	A	0	9	9	0	12	21	0	0
6	37163488	.	G	A	9	9	18	0	0	18	0	0
6	37163588	.	G	T	0	15	15	0	7	22	0	0
6	37627141	.	C	A	0	1	1	0	0	1	0	0
6	38789903	.	A	T	12	5	17	0	13	30	0	0
6	38859938	.	A	G	9	6	15	0	0	15	0	0
6	38902329	.	C	T	3	1	4	0	1	5	0	0
6	39187295	.	T	A	3	0	3	0	0	3	0	0
6	39208979	.	C	T	6	4	10	0	1	11	0	0
6	40947468	.	C	G	0	0	0	0	6	8	2	0
6	41354816	.	C	T	0	1	1	0	0	1	0	0
6	41435866	.	A	G	16	5	21	0	0	21	0	0
6	41460563	.	A	T	0	8	8	0	0	8	0	0
6	42915168	.	G	T	7	2	9	0	1	10	0	0
6	44245051	.	C	A	2	2	4	0	0	4	0	0
6	45373791	.	G	T	1	1	2	0	1	3	0	0
6	46454816	.	T	A	5	4	9	0	0	9	0	0
6	47809905	.	T	G	4	3	7	0	1	8	0	0
6	47810323	.	A	G	8	4	12	0	0	12	0	0
6	47810671	.	T	A	8	8	16	0	0	16	0	0
6	47811024	.	G	A	6	7	13	0	0	13	0	0
6	47811875	.	A	C	1	3	4	0	0	4	0	0
6	47811890	.	G	A	0	3	3	0	1	4	0	0
6	47811940	.	G	A	2	2	4	0	0	4	0	0
6	47812843	.	C	T	0	3	3	0	2	5	0	0
6	47813100	.	T	G	5	2	7	0	1	8	0	0
6	47813499	.	G	A	2	2	4	0	0	4	0	0
6	47813548	.	T	C	2	2	4	0	0	4	0	0
6	47813877	.	G	A	0	4	4	0	0	4	0	0
6	47825488	.	G	A	1	2	3	0	0	3	0	0
6	47865238	.	C	G	2	1	3	0	1	4	0	0
6	47865287	.	C	A	2	4	6	0	0	6	0	0
6	47865322	.	C	T	0	4	4	0	1	5	0	0
6	47865391	.	C	T	4	10	14	0	2	16	0	0
6	47865553	.	T	C	3	2	5	0	0	5	0	0
6	47865554	.	C	G	3	0	3	0	2	5	0	0
6	47865588	.	T	C	2	2	4	0	0	4	0	0
6	47865770	.	A	C	4	1	5	0	0	5	0	0
6	47865780	.	C	G	4	2	6	0	0	6	0	0
6	47865816	.	A	T	2	3	5	0	1	6	0	0
6	47869500	.	C	T	2	5	7	0	0	7	0	0
6	47870463	.	G	A	1	3	4	0	0	4	0	0
6	48051616	.	A	G	0	1	1	0	0	1	0	0
6	48051766	.	G	A	1	0	1	0	0	1	0	0
6	48052310	.	C	T	3	2	5	0	0	5	0	0
6	48052346	.	T	C	0	2	2	0	0	2	0	0
6	48057928	.	C	T	6	11	17	0	1	18	0	0
6	48058160	.	T	G	4	2	6	0	0	6	0	0
6	48058719	.	A	G	4	0	4	0	3	7	0	0
6	48058720	.	C	T	4	3	7	0	0	7	0	0
6	49106297	.	C	T	3	2	5	0	0	5	0	0
6	49108999	.	T	C	38	10	48	0	0	48	0	0
6	49109093	.	T	C	12	8	20	1	0	21	0	0
6	49738006	.	A	G	6	2	8	0	1	9	0	0
6	49738171	.	A	G	1	0	1	0	11	12	0	0
6	49738490	.	A	G	6	4	10	0	0	10	0	0
6	49738752	.	A	G	4	5	9	0	1	10	0	0
6	49738823	.	A	G	2	6	8	0	0	8	0	0
6	50685617	.	A	G	1	3	4	0	1	5	0	0
6	52223936	.	A	G	26	10	36	0	4	40	0	0
6	52223956	.	A	G	25	12	37	0	5	42	0	0
6	52224090	.	A	G	29	22	51	0	0	51	0	0
6	52224406	.	A	G	38	19	57	0	6	63	0	0
6	52224521	.	A	G	34	7	41	0	3	44	0	0
6	52353753	.	C	T	2	2	4	0	1	5	0	0
6	52356741	.	G	A	11	3	14	0	1	15	0	0
6	54806458	.	T	C	5	2	7	0	1	8	0	0
6	54806566	.	T	C	7	6	13	0	0	13	0	0
6	55217796	.	A	G	7	5	12	0	0	12	0	0
6	57439021	.	T	C	0	2	2	0	0	2	0	0
6	57439429	.	C	T	0	1	1	0	0	1	0	0
6	57455557	.	T	C	3	0	3	0	0	3	0	0
6	57459817	.	C	T	2	3	5	0	0	5	0	0
6	57459823	.	T	G	2	3	5	0	0	5	0	0
6	57478900	.	C	T	0	2	2	0	6	8	0	0
6	57481377	.	A	G	4	5	9	0	2	11	0	0
6	57492086	.	G	A	3	13	16	0	0	16	0	0
6	57498088	.	T	C	1	2	3	0	0	3	0	0
6	57498253	.	A	G	4	1	5	0	0	5	0	0
6	57498255	.	A	T	4	1	5	0	0	5	0	0
6	57500563	.	G	A	1	1	2	0	0	2	0	0
6	57500608	.	C	T	0	3	3	0	1	4	0	0
6	57500617	.	G	C	1	0	1	0	3	4	0	0
6	57503925	.	C	T	0	0	0	0	2	2	0	0
6	57510245	.	T	A	1	1	2	0	0	2	0	0
6	57510254	.	T	A	1	1	2	0	0	2	0	0
6	57519534	.	G	A	2	3	5	0	0	5	0	0
6	57519597	.	G	C	3	2	5	0	0	5	0	0
6	57523315	.	T	G	2	1	3	0	0	3	0	0
6	57523330	.	T	A	2	1	3	0	0	3	0	0
6	57541942	.	T	A	4	2	6	0	0	6	0	0
6	57595160	.	T	C	0	3	3	0	0	3	0	0
6	57618934	.	C	T	4	4	8	0	0	8	0	0
6	57620177	.	T	C	17	12	29	0	1	30	0	0
6	57620315	.	A	C	18	13	31	0	1	32	0	0
6	57630819	.	A	G	7	6	13	0	0	13	0	0
6	57630879	.	C	A	5	5	10	0	0	10	0	0
6	57634880	.	T	G	3	11	14	0	1	15	0	0
6	57634922	.	G	A	9	6	15	0	0	15	0	0
6	57634949	.	G	A	7	6	13	0	0	13	0	0
6	57644779	.	C	T	1	0	1	0	0	1	0	0
6	57900462	.	C	T	0	3	3	0	0	3	0	0
6	57901172	.	C	T	6	9	15	0	1	16	0	0
6	57909090	.	T	C	2	0	2	0	9	11	0	0
6	57930218	.	A	G	0	2	2	0	1	3	0	0
6	57984041	.	C	T	3	1	4	0	0	4	0	0
6	58384020	.	T	C	0	1	1	0	0	1	0	0
6	58389115	.	A	C	2	0	2	0	0	2	0	0
6	58389139	.	C	T	0	2	2	0	0	2	0	0
6	58389151	.	G	T	2	0	2	0	0	2	0	0
6	58393919	.	A	T	2	2	4	0	0	4	0	0
6	58395372	.	G	A	3	2	5	0	0	5	0	0
6	58395444	.	G	A	0	7	7	0	4	11	0	0
6	58395451	.	C	A	3	5	8	0	2	10	0	0
6	58495301	.	G	A	1	3	4	0	1	5	0	0
6	58495315	.	A	C	1	3	4	0	0	4	0	0
6	58497864	.	A	T	1	3	4	0	1	5	0	0
6	58522771	.	A	G	7	14	21	0	1	22	0	0
6	58524509	.	C	A	1	1	2	0	0	2	0	0
6	58553387	.	G	A	4	4	8	0	2	10	0	0
6	58553424	.	T	C	9	14	23	0	0	23	0	0
6	58560682	.	G	A	23	16	39	1	2	42	0	0
6	58560718	.	G	A	23	21	44	0	4	48	0	0
6	58561057	.	T	C	11	13	24	0	0	24	0	0
6	58561081	.	A	C	9	15	24	0	4	28	0	0
6	58561190	.	C	G	12	14	26	0	3	29	0	0
6	58562407	.	T	A	14	10	24	1	1	26	0	0
6	58563093	.	T	A	20	28	48	0	1	49	0	0
6	58563157	.	T	C	17	27	44	0	5	50	1	0
6	58563159	.	G	A	18	28	46	0	4	50	0	0
6	58563229	.	A	C	21	9	30	0	1	31	0	0
6	58563374	.	C	T	14	15	29	0	3	32	0	0
6	58563415	.	A	T	10	12	22	0	2	24	0	0
6	58708185	.	A	G	3	0	3	0	2	5	0	0
6	58708194	.	T	C	5	2	7	0	0	7	0	0
6	58708227	.	T	G	3	2	5	0	1	6	0	0
6	58712458	.	G	C	4	7	11	0	3	14	0	0
6	58712477	.	C	G	3	2	5	0	1	6	0	0
6	58712540	.	G	A	0	4	4	0	4	8	0	0
6	58723254	.	C	G	4	2	6	0	0	6	0	0
6	58723383	.	T	G	6	3	9	0	0	9	0	0
6	58726154	.	A	G	5	4	9	0	1	10	0	0
6	58728706	.	G	A	0	7	7	0	2	9	0	0
6	58728825	.	A	G	3	6	9	0	0	9	0	0
6	58728858	.	G	A	0	5	5	0	4	9	0	0
6	58729053	.	T	A	7	6	13	0	0	13	0	0
6	58729059	.	T	G	7	0	7	0	6	13	0	0
6	58729100	.	C	G	8	0	8	0	5	13	0	0
6	58729120	.	T	C	7	8	15	0	0	15	0	0
6	58729145	.	G	A	7	5	12	0	1	13	0	0
6	58730208	.	A	T	1	9	10	0	2	12	0	0
6	58730603	.	A	G	3	4	7	0	0	7	0	0
6	58730657	.	T	C	4	4	8	0	2	10	0	0
6	58732475	.	C	G	26	12	38	0	2	40	0	0
6	58773647	.	T	G	2	1	3	0	0	3	0	0
6	58773785	.	C	T	0	4	4	0	9	13	0	0
6	58773788	.	A	G	8	4	12	0	2	14	0	0
6	58855648	.	C	T	0	2	2	0	0	2	0	0
6	58859737	.	G	A	0	4	4	0	3	7	0	0
6	58861707	.	A	G	1	0	1	0	0	1	0	0
6	58862341	.	G	A	0	4	4	0	9	13	0	0
6	58867362	.	A	G	18	6	24	0	0	24	0	0
6	58867470	.	C	A	14	22	36	0	0	36	0	0
6	58892365	.	C	T	0	1	1	0	2	3	0	0
6	58918095	.	T	C	0	1	1	0	0	1	0	0
6	58918506	.	A	G	13	0	13	0	17	30	0	0
6	58918676	.	T	G	10	22	32	0	0	32	0	0
6	58918693	.	T	C	12	22	34	0	2	36	0	0
6	58921434	.	C	A	5	6	11	0	0	11	0	0
6	58921506	.	G	T	11	15	26	0	0	26	0	0
6	58923246	.	T	C	1	1	2	0	1	3	0	0
6	58939261	.	T	C	3	3	6	0	0	6	0	0
6	58939303	.	G	T	2	0	2	0	0	2	0	0
6	58948931	.	C	T	2	4	6	0	0	6	0	0
6	58953302	.	G	T	1	2	3	0	0	3	0	0
6	59691533	.	C	T	1	3	4	0	0	4	0	0
6	59813578	.	G	A	0	3	3	0	5	8	0	0
6	59813608	.	A	G	7	11	18	0	3	21	0	0
6	59813857	.	G	A	0	3	3	0	3	6	0	0
6	59813905	.	A	G	12	1	13	0	10	23	0	0
6	59819362	.	C	T	8	12	20	0	1	21	0	0
6	59824482	.	C	T	23	12	35	0	4	39	0	0
6	59824496	.	C	T	23	12	35	0	1	36	0	0
6	59824672	.	C	T	18	20	38	0	7	45	0	0
6	59824736	.	C	T	16	15	31	0	3	34	0	0
6	59833006	.	T	A	4	5	9	0	0	9	0	0
6	59833007	.	A	G	4	5	9	0	0	9	0	0
6	59837587	.	C	G	3	1	4	0	1	5	0	0
6	59837747	.	G	A	0	1	1	0	2	3	0	0
6	59839033	.	G	A	0	5	5	0	7	12	0	0
6	59839048	.	G	A	4	5	9	0	1	10	0	0
6	59841394	.	G	A	0	4	4	0	12	16	0	0
6	59848119	.	C	T	14	11	25	0	0	25	0	0
6	59848345	.	T	C	26	20	46	0	2	48	0	0
6	59848624	.	C	G	5	12	17	4	0	21	0	0
6	59848894	.	T	C	19	20	39	1	3	43	0	0
6	59850253	.	C	T	20	22	42	0	1	43	0	0
6	59850308	.	T	C	16	26	42	0	3	45	0	0
6	59874147	.	G	A	0	1	1	0	2	3	0	0
6	59882680	.	T	C	7	9	16	0	0	16	0	0
6	59882704	.	T	C	8	7	15	0	1	16	0	0
6	59883154	.	G	A	5	6	11	0	2	13	0	0
6	59889640	.	G	T	0	3	3	0	1	4	0	0
6	59889964	.	A	G	0	0	0	0	1	1	0	0
6	59889978	.	C	T	0	1	1	0	0	1	0	0
6	59891289	.	T	C	6	8	14	0	3	17	0	0
6	59892864	.	C	T	1	2	3	0	0	3	0	0
6	59894548	.	T	C	14	12	26	0	1	27	0	0
6	59894580	.	T	A	14	18	32	0	1	33	0	0
6	59894719	.	T	C	14	11	25	0	1	26	0	0
6	59915599	.	T	C	1	3	4	0	0	4	0	0
6	59915608	.	T	C	0	3	3	0	0	3	0	0
6	59917077	.	T	C	7	4	11	0	1	12	0	0
6	59921661	.	T	G	13	7	20	0	2	22	0	0
6	59921685	.	T	C	8	8	16	0	1	17	0	0
6	59921788	.	A	C	10	14	24	0	0	24	0	0
6	59939277	.	G	A	12	3	15	0	0	15	0	0
6	59947097	.	C	A	3	2	5	0	0	5	0	0
6	59949585	.	A	G	0	1	1	0	1	2	0	0
6	59949591	.	G	A	1	1	2	0	0	2	0	0
6	59951483	.	C	G	1	5	6	0	0	6	0	0
6	59968016	.	T	C	4	0	4	0	3	7	0	0
6	59968039	.	T	C	0	3	3	0	0	3	0	0
6	59971416	.	C	T	30	12	42	0	2	44	0	0
6	59971711	.	G	A	19	20	39	0	2	41	0	0
6	59971718	.	C	A	14	22	36	0	4	40	0	0
6	59971964	.	G	A	4	3	7	0	1	8	0	0
6	59971968	.	A	G	3	4	7	0	1	8	0	0
6	59985833	.	C	T	2	4	6	0	1	7	0	0
6	60031520	.	G	A	9	6	15	0	1	16	0	0
6	60031641	.	C	T	0	2	2	0	4	6	0	0
6	60043150	.	A	G	2	4	6	0	0	6	0	0
6	60043297	.	T	A	1	2	3	0	0	3	0	0
6	60043413	.	G	A	8	5	13	0	0	13	0	0
6	60043792	.	T	C	6	4	10	0	0	10	0	0
6	60043842	.	C	T	3	7	10	0	0	10	0	0
6	60044319	.	T	A	4	4	8	0	2	10	0	0
6	60044320	.	A	T	4	5	9	0	1	10	0	0
7	742828	.	T	C	11	20	31	0	5	36	0	0
7	762326	.	G	A	2	3	5	0	0	5	0	0
7	838170	.	A	C	1	2	3	0	0	3	0	0
7	846766	.	A	G	0	4	4	0	1	5	0	0
7	846972	.	T	C	3	3	6	0	1	7	0	0
7	1416647	.	C	A	0	2	2	0	0	2	0	0
7	1418216	.	A	T	2	2	4	1	1	6	0	0
7	1526589	.	G	T	12	8	20	0	7	27	0	0
7	1526932	.	A	T	4	25	29	0	1	30	0	0
7	1527081	.	A	G	20	4	24	0	3	27	0	0
7	1543693	.	G	C	0	1	1	0	0	1	0	0
7	1543698	.	T	C	0	1	1	0	0	1	0	0
7	1600153	.	C	T	2	1	3	0	0	3	0	0
7	1600263	.	A	T	5	1	6	0	0	6	0	0
7	1603053	.	G	T	0	3	3	0	5	8	0	0
7	1603116	.	T	G	3	0	3	0	13	16	0	0
7	1609555	.	C	T	13	8	21	0	0	21	0	0
7	1613117	.	T	C	7	7	14	0	1	15	0	0
7	1613131	.	A	G	13	8	21	0	2	23	0	0
7	1613230	.	T	G	2	3	5	0	1	6	0	0
7	1615439	.	C	T	1	3	4	0	1	5	0	0
7	1617209	.	T	A	4	7	11	0	0	11	0	0
7	1617433	.	A	C	1	13	14	0	0	14	0	0
7	1618863	.	T	C	23	6	29	0	2	31	0	0
7	1618865	.	G	A	7	21	28	0	3	31	0	0
7	1619124	.	A	T	8	10	18	0	1	19	0	0
7	3931029	.	A	G	33	18	51	0	3	54	0	0
7	3931264	.	C	T	24	29	53	0	2	55	0	0
7	3931396	.	A	T	34	22	56	0	2	58	0	0
7	3931543	.	A	T	28	12	40	0	2	43	1	0
7	3931598	.	G	T	32	18	50	0	3	53	0	0
7	3932209	.	A	T	13	18	31	0	3	34	0	0
7	3932402	.	T	C	9	16	25	0	6	31	0	0
7	3932405	.	A	T	11	17	28	0	3	31	0	0
7	3932463	.	T	G	7	6	13	0	4	17	0	0
7	3932486	.	T	C	13	4	17	0	1	18	0	0
7	3932546	.	C	A	0	4	4	0	0	4	0	0
7	3932694	.	G	A	21	10	31	0	0	31	0	0
7	3932698	.	T	C	20	10	30	0	2	32	0	0
7	3932731	.	C	A	27	11	38	0	1	39	0	0
7	3932935	.	C	A	15	19	34	0	1	35	0	0
7	3933121	.	G	A	22	26	48	0	3	51	0	0
7	3933243	.	C	A	12	16	28	0	1	29	0	0
7	3933271	.	C	T	19	13	32	0	2	34	0	0
7	3933383	.	A	C	12	0	12	0	12	24	0	0
7	3933481	.	T	C	17	0	17	0	13	30	0	0
7	3933483	.	C	T	0	9	9	0	21	30	0	0
7	3933998	.	C	T	15	10	25	0	4	29	0	0
7	3934038	.	A	T	11	13	24	0	1	25	0	0
7	3934387	.	C	T	11	17	28	0	0	28	0	0
7	3934428	.	G	T	13	15	28	0	0	28	0	0
7	3934551	.	A	T	10	5	15	0	1	16	0	0
7	3934696	.	A	G	6	8	14	0	4	18	0	0
7	3934710	.	G	A	6	6	12	0	4	16	0	0
7	3934818	.	G	A	4	5	9	0	0	9	0	0
7	3934840	.	T	A	5	3	8	0	0	8	0	0
7	3934970	.	A	G	5	6	11	0	1	12	0	0
7	3935055	.	T	C	4	8	12	0	1	13	0	0
7	3935123	.	A	G	4	7	11	0	1	12	0	0
7	3935283	.	G	A	6	6	12	0	3	15	0	0
7	3935737	.	C	T	0	12	12	0	8	20	0	0
7	3935788	.	C	A	3	5	8	0	1	9	0	0
7	3936127	.	C	T	0	7	7	0	6	13	0	0
7	3936764	.	G	A	5	3	8	0	2	10	0	0
7	3952993	.	A	G	0	1	1	0	0	1	0	0
7	4088334	.	C	T	13	19	32	0	3	35	0	0
7	4088545	.	C	T	1	18	19	0	11	30	0	0
7	4088680	.	G	A	10	15	25	0	1	26	0	0
7	4088727	.	A	T	18	20	38	0	1	39	0	0
7	4088832	.	A	G	13	27	40	0	7	47	0	0
7	4089042	.	A	G	23	12	35	0	3	38	0	0
7	4089090	.	G	A	16	9	25	0	1	26	0	0
7	4095265	.	C	T	0	16	16	0	12	28	0	0
7	4100931	.	C	T	8	7	15	0	1	16	0	0
7	4100967	.	G	A	10	14	24	0	1	25	0	0
7	4181728	.	G	A	1	7	8	0	1	9	0	0
7	4183317	.	G	A	2	2	4	0	0	5	1	0
7	4184897	.	G	T	2	3	5	0	1	6	0	0
7	4186499	.	A	G	0	7	7	1	0	8	0	0
7	4186553	.	T	C	0	8	8	0	1	9	0	0
7	4186611	.	A	G	4	4	8	0	0	8	0	0
7	7002248	.	C	T	1	2	3	0	0	3	0	0
7	7031161	.	C	T	2	1	3	0	0	3	0	0
7	7038541	.	G	A	3	2	5	2	0	7	0	0
7	7039446	.	T	A	1	5	6	0	1	7	0	0
7	7039475	.	C	G	5	8	13	0	0	13	0	0
7	7042160	.	A	G	8	4	12	0	0	12	0	0
7	7042506	.	C	T	7	2	9	0	1	10	0	0
7	7042604	.	C	T	19	20	39	0	0	39	0	0
7	7042626	.	T	G	18	15	33	0	1	34	0	0
7	7248212	.	A	T	3	13	16	0	3	19	0	0
7	7248292	.	T	C	9	5	14	0	1	15	0	0
7	7248293	.	A	G	11	0	11	0	4	15	0	0
7	7248813	.	G	C	4	7	11	0	0	11	0	0
7	7248819	.	C	A	4	5	9	0	1	10	0	0
7	7248849	.	A	G	6	4	10	0	0	10	0	0
7	7248862	.	A	G	4	5	9	0	0	9	0	0
7	7249515	.	T	A	5	12	17	0	0	17	0	0
7	7364417	.	T	C	3	2	5	0	0	5	0	0
7	7364879	.	G	T	1	2	3	0	1	4	0	0
7	7367450	.	C	A	1	2	3	0	0	3	0	0
7	7368109	.	G	C	1	7	8	0	4	12	0	0
7	7368148	.	T	C	2	8	10	0	2	12	0	0
7	7368187	.	A	G	2	7	9	0	2	11	0	0
7	7368199	.	C	T	2	4	6	0	2	8	0	0
7	7368582	.	C	T	3	6	9	0	0	9	0	0
7	7368744	.	A	G	3	5	8	0	0	8	0	0
7	7368834	.	G	T	6	3	9	0	1	10	0	0
7	7368869	.	T	C	5	4	9	0	1	10	0	0
7	7368972	.	T	A	2	5	7	0	1	8	0	0
7	7369000	.	G	T	0	4	4	0	3	7	0	0
7	7369040	.	G	A	0	4	4	0	3	7	0	0
7	7369768	.	G	A	0	2	2	0	3	5	0	0
7	7369831	.	G	A	0	2	2	0	7	9	0	0
7	7372404	.	A	G	14	9	23	0	1	24	0	0
7	7372694	.	A	G	15	21	36	0	1	37	0	0
7	7372772	.	A	G	9	0	9	0	17	26	0	0
7	7372892	.	A	G	10	12	22	0	6	28	0	0
7	7466495	.	A	G	7	5	12	0	0	12	0	0
7	7466603	.	C	T	1	8	9	0	9	18	0	0
7	7466706	.	A	G	6	6	12	0	1	13	0	0
7	7466827	.	A	T	3	3	6	0	0	6	0	0
7	7467303	.	A	T	5	5	10	0	1	11	0	0
7	7467308	.	C	T	6	6	12	0	0	12	0	0
7	7467376	.	A	G	9	7	16	0	0	16	0	0
7	7467386	.	G	A	11	6	17	0	0	17	0	0
7	7467509	.	C	A	5	3	8	0	0	8	0	0
7	7467568	.	T	A	3	3	6	0	0	6	0	0
7	7467906	.	T	A	7	3	10	0	0	10	0	0
7	7469026	.	G	T	2	2	4	0	0	4	0	0
7	7469031	.	C	T	0	2	2	0	2	4	0	0
7	7477594	.	A	T	16	11	27	0	1	28	0	0
7	7477981	.	G	T	2	3	5	0	1	6	0	0
7	7478105	.	A	G	7	6	13	0	0	13	0	0
7	7478137	.	A	G	3	3	6	0	0	6	0	0
7	7478654	.	T	C	6	8	14	0	0	14	0	0
7	7478717	.	T	G	11	10	21	0	2	23	0	0
7	7478806	.	G	A	14	16	30	0	1	31	0	0
7	7482475	.	G	A	12	7	19	0	0	19	0	0
7	7552069	.	C	T	2	1	3	0	1	4	0	0
7	7552113	.	G	A	2	4	6	0	0	6	0	0
7	7608965	.	C	T	3	2	5	0	0	5	0	0
7	7617861	.	G	A	0	10	10	0	11	21	0	0
7	7624082	.	A	G	12	12	24	0	5	29	0	0
7	7641230	.	A	T	10	14	24	1	3	28	0	0
7	7641240	.	T	G	12	13	25	0	2	27	0	0
7	7641351	.	G	A	17	11	28	0	2	30	0	0
7	7641353	.	G	A	15	13	28	0	2	30	0	0
7	7641481	.	C	T	19	11	30	0	0	30	0	0
7	7641504	.	G	A	0	12	12	0	18	30	0	0
7	7641678	.	T	A	1	16	17	0	0	17	0	0
7	7641765	.	T	C	6	9	15	0	0	15	0	0
7	7641856	.	C	A	5	3	8	0	1	9	0	0
7	7642554	.	T	A	16	16	32	0	2	34	0	0
7	7642578	.	A	G	15	0	15	0	12	27	0	0
7	7642787	.	A	T	14	17	31	0	2	33	0	0
7	7643277	.	T	C	10	25	35	0	5	40	0	0
7	7643313	.	T	C	11	33	44	0	2	46	0	0
7	7643488	.	A	G	25	17	42	0	6	48	0	0
7	7643676	.	G	A	1	14	15	1	27	43	0	0
7	7643711	.	C	A	16	25	41	0	4	45	0	0
7	7643712	.	T	C	18	25	43	0	2	45	0	0
7	7643867	.	C	T	3	5	8	0	0	8	0	0
7	7662467	.	C	G	11	9	20	0	0	20	0	0
7	7663132	.	A	G	15	10	25	0	0	25	0	0
7	7663254	.	G	A	4	6	10	0	0	10	0	0
7	7663453	.	A	T	10	12	22	0	2	24	0	0
7	7663682	.	C	T	0	5	5	0	5	10	0	0
7	7663902	.	G	T	2	9	11	0	0	11	0	0
7	7664473	.	C	T	0	2	2	0	1	3	0	0
7	7664535	.	T	A	1	3	4	0	0	4	0	0
7	7664708	.	T	A	12	9	21	0	0	21	0	0
7	7664760	.	G	T	9	11	20	0	1	21	0	0
7	7664815	.	C	A	4	7	11	0	0	11	0	0
7	7664838	.	G	T	8	4	12	0	0	12	0	0
7	7665480	.	A	C	4	4	8	0	1	9	0	0
7	7665559	.	T	A	2	8	10	0	1	11	0	0
7	7666388	.	G	A	0	6	6	0	1	7	0	0
7	7666760	.	T	A	0	2	2	0	1	3	0	0
7	7684895	.	T	A	1	0	1	0	0	1	0	0
7	7696726	.	G	C	1	6	7	0	0	7	0	0
7	7696875	.	C	A	5	3	8	0	0	8	0	0
7	7705993	.	C	G	1	0	1	0	5	6	0	0
7	7706005	.	C	T	1	7	8	0	0	8	0	0
7	7706869	.	A	G	1	4	5	0	1	6	0	0
7	7707029	.	T	G	5	8	13	0	0	13	0	0
7	7708572	.	T	C	1	2	3	0	0	3	0	0
7	7708642	.	G	A	3	1	4	0	1	5	0	0
7	7708666	.	A	C	3	3	6	0	1	7	0	0
7	7708826	.	T	G	1	3	4	0	0	4	0	0
7	7708972	.	A	C	2	2	4	0	1	5	0	0
7	7709446	.	T	G	2	3	5	0	0	5	0	0
7	7785604	.	C	T	1	1	2	0	0	2	0	0
7	8890460	.	T	A	5	2	7	0	0	7	0	0
7	8890495	.	C	T	0	5	5	0	3	8	0	0
7	8890736	.	T	C	10	5	15	0	0	15	0	0
7	8890884	.	A	G	20	21	41	0	0	41	0	0
7	8890903	.	G	A	17	17	34	0	7	41	0	0
7	8890983	.	C	A	0	10	10	0	11	21	0	0
7	8891057	.	A	T	15	10	25	0	0	25	0	0
7	8891062	.	G	T	10	14	24	0	0	24	0	0
7	8891236	.	C	G	10	5	15	0	0	15	0	0
7	8891412	.	T	C	2	3	5	0	0	5	0	0
7	8891710	.	A	G	5	5	10	0	0	10	0	0
7	8891717	.	A	G	5	6	11	0	0	11	0	0
7	8891755	.	T	G	2	5	7	0	0	7	0	0
7	8891844	.	T	C	1	2	3	0	0	3	0	0
7	8891855	.	G	A	2	1	3	0	0	3	0	0
7	8892077	.	G	T	1	2	3	0	0	3	0	0
7	9291049	.	C	A	9	6	15	0	2	17	0	0
7	9299776	.	T	A	2	2	4	0	0	4	0	0
7	9302654	.	G	A	0	9	9	0	9	18	0	0
7	9302664	.	T	C	9	6	15	0	0	15	0	0
7	9302736	.	C	A	10	3	13	0	1	14	0	0
7	9302841	.	A	G	14	10	24	0	2	26	0	0
7	9302990	.	T	A	22	5	27	0	0	27	0	0
7	9303000	.	T	A	21	6	27	0	1	28	0	0
7	9304692	.	T	C	10	5	15	0	1	16	0	0
7	9305501	.	G	A	5	2	7	0	1	8	0	0
7	9308683	.	A	G	9	12	21	0	1	22	0	0
7	9308715	.	C	T	9	12	21	0	0	21	0	0
7	9308817	.	A	G	2	2	4	0	0	4	0	0
7	9312770	.	G	A	0	7	7	0	6	13	0	0
7	9319626	.	T	C	13	13	26	0	1	27	0	0
7	9320431	.	A	T	7	12	19	0	0	19	0	0
7	9320489	.	A	G	8	7	15	0	2	17	0	0
7	9320719	.	C	T	11	12	23	0	0	23	0	0
7	9321124	.	G	A	0	3	3	0	11	15	1	0
7	9321374	.	C	T	3	1	4	0	1	5	0	0
7	9321375	.	T	A	3	1	4	0	1	5	0	0
7	9321800	.	G	A	0	4	4	0	8	12	0	0
7	9321981	.	G	T	15	23	38	0	3	41	0	0
7	9322176	.	C	A	15	8	23	0	0	25	2	0
7	9322178	.	T	C	17	8	25	0	0	25	0	0
7	9322216	.	A	G	15	6	21	0	1	22	0	0
7	9322271	.	G	C	12	12	24	0	0	24	0	0
7	9322441	.	C	T	12	8	20	0	1	21	0	0
7	9511184	.	C	T	4	5	9	0	1	10	0	0
7	10875024	.	A	G	21	8	29	0	0	29	0	0
7	10875187	.	A	G	13	9	22	0	4	26	0	0
7	11340964	.	A	G	4	0	4	0	5	9	0	0
7	12843543	.	T	A	4	2	6	0	1	7	0	0
7	13858725	.	T	C	2	2	4	0	0	4	0	0
7	13858831	.	G	A	4	5	9	0	0	9	0	0
7	13858929	.	G	A	3	6	9	0	2	11	0	0
7	13897297	.	C	T	1	2	3	0	0	3	0	0
7	13897765	.	A	C	1	2	3	0	1	4	0	0
7	13897768	.	A	C	2	0	2	0	2	4	0	0
7	13897822	.	G	A	1	2	3	0	0	3	0	0
7	13897897	.	T	C	1	0	1	0	0	1	0	0
7	14203690	.	A	G	1	3	4	0	0	4	0	0
7	14204447	.	T	A	1	2	3	0	0	3	0	0
7	14205527	.	G	C	6	3	9	0	0	9	0	0
7	14205559	.	T	C	5	3	8	0	0	8	0	0
7	14205857	.	C	A	5	2	7	0	0	7	0	0
7	14205881	.	A	G	5	2	7	0	1	8	0	0
7	14205992	.	G	T	3	2	5	0	1	6	0	0
7	14206499	.	T	A	5	5	10	0	0	10	0	0
7	14206790	.	T	G	4	9	13	0	0	13	0	0
7	14206847	.	C	A	4	3	7	0	0	7	0	0
7	14265966	.	A	T	4	2	6	0	1	7	0	0
7	14350822	.	G	A	1	4	5	0	0	5	0	0
7	14393956	.	A	T	2	6	8	0	0	8	0	0
7	14393966	.	G	A	6	2	8	0	0	8	0	0
7	14394824	.	G	T	2	3	5	0	0	5	0	0
7	14394839	.	G	C	2	4	6	0	0	6	0	0
7	14394860	.	A	C	2	4	6	0	3	9	0	0
7	14394891	.	G	A	4	6	10	0	1	11	0	0
7	14394925	.	A	G	3	5	8	0	2	10	0	0
7	14394991	.	G	A	3	3	6	0	0	6	0	0
7	14395029	.	A	G	1	4	5	0	0	5	0	0
7	14397850	.	A	G	3	1	4	0	0	4	0	0
7	14512064	.	G	A	5	3	8	0	1	9	0	0
7	14512081	.	A	C	7	5	12	0	0	12	0	0
7	14512099	.	C	G	7	4	11	0	1	12	0	0
7	14532066	.	T	C	4	4	8	0	0	8	0	0
7	14535719	.	T	C	2	3	5	0	0	5	0	0
7	14535749	.	T	A	6	7	13	0	0	13	0	0
7	14535782	.	G	T	8	8	16	0	0	16	0	0
7	14535834	.	A	C	2	2	4	0	0	4	0	0
7	14539470	.	T	C	1	5	6	0	1	7	0	0
7	14542854	.	C	T	3	5	8	0	0	8	0	0
7	14542893	.	C	T	5	4	9	0	0	9	0	0
7	14543002	.	T	C	9	7	16	0	2	18	0	0
7	14543031	.	G	A	3	6	9	0	3	12	0	0
7	14543128	.	A	T	2	4	6	0	0	6	0	0
7	14543156	.	T	G	2	3	5	0	0	5	0	0
7	14543454	.	G	T	3	4	7	0	1	8	0	0
7	14543463	.	T	C	3	4	7	0	0	7	0	0
7	14860521	.	C	T	3	5	8	0	0	8	0	0
7	14860524	.	A	C	3	5	8	0	0	8	0	0
7	14900869	.	G	A	0	1	1	0	0	1	0	0
7	14905516	.	G	C	2	1	3	0	0	3	0	0
7	14934738	.	G	A	2	5	7	0	1	8	0	0
7	14938134	.	C	T	12	9	21	0	1	22	0	0
7	14938404	.	C	T	4	3	7	0	0	7	0	0
7	15087831	.	A	T	1	2	3	0	0	3	0	0
7	15087833	.	G	A	1	2	3	0	0	3	0	0
7	15605950	.	T	C	2	5	7	0	0	7	0	0
7	15605968	.	T	A	3	6	9	0	0	9	0	0
7	15607650	.	C	T	3	10	13	0	1	14	0	0
7	15607757	.	G	A	0	4	4	0	7	11	0	0
7	15607867	.	C	T	3	3	6	0	0	6	0	0
7	15608730	.	A	C	1	2	3	0	1	4	0	0
7	15608767	.	T	A	1	5	6	0	0	6	0	0
7	15608774	.	C	G	1	5	6	0	0	6	0	0
7	15609037	.	A	G	12	6	18	0	1	19	0	0
7	15609137	.	A	C	5	5	10	0	0	10	0	0
7	15609156	.	G	A	2	3	5	0	1	6	0	0
7	15609387	.	T	A	6	7	13	0	1	14	0	0
7	15609469	.	C	T	12	13	25	0	1	26	0	0
7	15609520	.	G	A	6	5	11	0	0	11	0	0
7	15609826	.	C	T	6	10	16	0	1	17	0	0
7	15609961	.	C	T	12	13	25	0	0	25	0	0
7	15629291	.	A	G	1	0	1	0	0	1	0	0
7	15629298	.	C	T	1	0	1	0	0	1	0	0
7	15653514	.	G	A	5	3	8	0	0	8	0	0
7	15653537	.	G	A	2	2	4	0	0	4	0	0
7	15819692	.	C	T	1	0	1	0	0	1	0	0
7	15825888	.	T	C	1	0	1	0	3	4	0	0
7	15830007	.	T	C	2	4	6	0	0	6	0	0
7	15830026	.	A	G	3	4	7	0	0	7	0	0
7	15891623	.	C	A	2	1	3	0	0	3	0	0
7	15896959	.	G	C	1	2	3	0	1	4	0	0
7	15896998	.	G	A	0	2	2	0	1	3	0	0
7	15897671	.	G	T	2	2	4	0	0	4	0	0
7	15897676	.	T	C	1	3	4	0	1	5	0	0
7	15898280	.	T	C	1	4	5	0	0	5	0	0
7	15899286	.	A	G	7	3	10	0	1	11	0	0
7	15899468	.	A	T	3	8	11	0	1	12	0	0
7	15899532	.	T	A	10	11	21	0	2	23	0	0
7	15899799	.	A	C	2	0	2	0	0	2	0	0
7	15900102	.	G	A	1	3	4	0	0	4	0	0
7	15959883	.	G	T	0	1	1	0	0	1	0	0
7	16234725	.	A	C	1	2	3	0	0	3	0	0
7	16234777	.	T	G	1	3	4	0	0	4	0	0
7	16348898	.	A	G	6	3	9	0	0	9	0	0
7	16388262	.	C	T	1	0	1	0	0	1	0	0
7	16388307	.	C	T	2	5	7	0	1	8	0	0
7	16388310	.	G	C	3	5	8	0	0	8	0	0
7	16388358	.	T	C	3	4	7	0	0	7	0	0
7	16456854	.	C	T	4	3	7	0	0	7	0	0
7	16460093	.	C	T	7	5	12	0	2	14	0	0
7	16460252	.	G	A	7	9	16	0	1	17	0	0
7	16545638	.	C	T	1	3	4	0	4	8	0	0
7	16545860	.	G	T	2	5	7	0	0	7	0	0
7	17008230	.	T	C	1	2	3	0	0	3	0	0
7	17011427	.	T	C	2	2	4	0	1	5	0	0
7	17013825	.	T	C	3	4	7	0	1	8	0	0
7	17013827	.	T	A	4	4	8	0	0	8	0	0
7	17013899	.	C	T	4	6	10	0	2	12	0	0
7	17014219	.	A	G	1	6	7	0	0	7	0	0
7	17014338	.	T	G	1	1	2	0	3	5	0	0
7	17014453	.	A	C	1	8	9	0	1	10	0	0
7	17014531	.	C	A	7	9	16	0	0	16	0	0
7	17014548	.	G	T	6	11	17	0	1	18	0	0
7	17014621	.	T	A	11	11	22	0	0	22	0	0
7	17014653	.	C	T	12	5	17	0	1	18	0	0
7	17014748	.	T	C	8	9	17	0	1	18	0	0
7	17014809	.	A	C	6	4	10	0	0	10	0	0
7	17014815	.	T	C	5	6	11	0	2	13	0	0
7	17014914	.	A	G	3	5	8	0	1	9	0	0
7	17096421	.	T	C	5	3	8	0	0	8	0	0
7	17097176	.	G	A	3	1	4	0	0	4	0	0
7	17102964	.	G	T	4	2	6	0	0	6	0	0
7	17103021	.	A	G	1	2	3	0	0	3	0	0
7	17104402	.	G	A	0	2	2	0	0	2	0	0
7	17104412	.	A	G	0	0	0	0	4	4	0	0
7	17104445	.	C	A	0	1	1	0	1	2	0	0
7	17251222	.	G	A	0	22	22	0	18	40	0	0
7	17251234	.	A	G	20	18	38	0	0	38	0	0
7	17692797	.	G	A	3	7	10	0	0	10	0	0
7	17692857	.	T	C	2	8	10	0	0	10	0	0
7	17695039	.	C	T	5	3	8	0	0	8	0	0
7	17695051	.	A	G	2	4	6	0	2	8	0	0
7	17754299	.	G	A	7	6	13	1	0	14	0	0
7	17755699	.	C	T	0	1	1	0	1	2	0	0
7	17756705	.	A	G	42	14	56	0	0	56	0	0
7	17757019	.	A	G	21	28	49	0	9	58	0	0
7	17757024	.	C	T	30	26	56	0	3	59	0	0
7	17757078	.	A	G	36	26	62	0	4	66	0	0
7	17757243	.	T	G	29	12	41	0	6	47	0	0
7	17757371	.	T	C	30	24	54	0	10	64	0	0
7	17757408	.	G	A	31	37	68	0	1	69	0	0
7	17761063	.	A	C	4	7	11	0	2	13	0	0
7	17761117	.	T	G	5	3	8	0	0	8	0	0
7	17761685	.	T	C	4	2	6	0	0	6	0	0
7	17762433	.	C	T	1	2	3	0	1	4	0	0
7	17762480	.	G	C	0	4	4	0	1	5	0	0
7	17763342	.	C	G	1	2	3	0	0	3	0	0
7	17766963	.	T	A	1	1	2	0	0	2	0	0
7	17792032	.	A	C	3	3	6	0	0	6	0	0
7	17800993	.	C	T	1	4	5	0	1	6	0	0
7	17801435	.	T	A	0	2	2	0	0	2	0	0
7	17801442	.	G	A	0	2	2	0	0	2	0	0
7	17801841	.	C	T	1	2	3	0	0	3	0	0
7	17801896	.	T	G	3	3	6	0	0	6	0	0
7	17801900	.	A	G	3	0	3	0	3	6	0	0
7	17801938	.	A	G	2	0	2	0	4	6	0	0
7	17802645	.	G	A	4	2	6	0	0	6	0	0
7	17802968	.	T	C	1	3	4	0	0	4	0	0
7	17803374	.	T	G	1	4	5	0	1	6	0	0
7	17803484	.	A	G	2	2	4	0	1	5	0	0
7	17805706	.	C	G	12	7	19	0	1	20	0	0
7	17809860	.	C	T	1	1	2	0	0	2	0	0
7	17810581	.	C	T	7	5	12	0	1	13	0	0
7	17810611	.	G	A	4	5	9	0	1	10	0	0
7	17810624	.	C	T	5	2	7	0	1	8	0	0
7	17812892	.	T	A	3	5	8	0	0	8	0	0
7	17813283	.	A	G	4	3	7	0	1	8	0	0
7	17933314	.	C	G	1	1	2	0	0	2	0	0
7	17933323	.	C	T	2	1	3	0	0	3	0	0
7	17933350	.	G	A	0	5	5	0	4	9	0	0
7	17933362	.	A	G	4	0	4	0	6	10	0	0
7	17933413	.	T	A	5	7	12	0	0	12	0	0
7	17936753	.	C	G	5	5	10	0	2	12	0	0
7	17936795	.	G	A	0	5	5	0	6	11	0	0
7	17938069	.	C	A	5	4	9	0	1	10	0	0
7	17941936	.	C	T	9	6	15	0	2	17	0	0
7	17942370	.	G	A	4	8	12	0	1	13	0	0
7	17942540	.	A	G	4	2	6	0	0	6	0	0
7	17942883	.	T	G	14	12	26	0	1	27	0	0
7	17943078	.	A	G	11	8	19	0	2	21	0	0
7	17943133	.	C	T	12	9	21	0	2	23	0	0
7	17943170	.	G	A	1	18	19	0	21	40	0	0
7	17943376	.	C	G	12	16	28	0	3	31	0	0
7	17943851	.	G	C	1	5	6	0	0	6	0	0
7	17953986	.	G	A	3	2	5	0	1	6	0	0
7	17969145	.	C	T	12	4	16	0	0	16	0	0
7	17969720	.	C	T	2	4	6	0	0	6	0	0
7	17969792	.	A	G	5	2	7	0	0	7	0	0
7	17969851	.	A	G	3	6	9	0	0	9	0	0
7	17969883	.	G	C	0	2	2	0	4	6	0	0
7	17969941	.	C	T	5	2	7	0	0	7	0	0
7	17969949	.	A	G	1	5	6	0	1	7	0	0
7	17970016	.	C	T	3	4	7	0	1	8	0	0
7	17970337	.	A	G	9	0	9	0	3	12	0	0
7	17970338	.	C	T	9	3	12	0	0	12	0	0
7	17970654	.	G	A	2	4	6	0	1	7	0	0
7	17970790	.	A	G	2	3	5	0	0	5	0	0
7	18072762	.	C	A	1	2	3	0	0	3	0	0
7	18072797	.	T	G	1	5	6	0	0	6	0	0
7	18072856	.	G	A	0	5	5	0	0	5	0	0
7	18114316	.	G	A	0	23	23	0	28	51	0	0
7	18114495	.	C	T	10	14	24	0	7	31	0	0
7	18114518	.	A	T	8	6	14	0	12	26	0	0
7	18115220	.	T	A	20	17	37	0	2	40	1	0
7	18115261	.	G	T	16	11	27	0	3	30	0	0
7	18115302	.	G	A	0	16	16	0	11	27	0	0
7	18115470	.	C	T	20	20	40	0	5	45	0	0
7	18115584	.	T	G	15	17	32	1	1	34	0	0
7	18115721	.	G	A	0	21	21	0	26	47	0	0
7	18116037	.	C	T	16	8	24	0	3	27	0	0
7	18116204	.	G	A	23	25	48	0	5	53	0	0
7	18122445	.	C	G	13	14	27	0	2	29	0	0
7	18124218	.	C	T	7	6	13	0	1	14	0	0
7	18124314	.	C	T	12	14	26	0	1	27	0	0
7	18124329	.	T	A	11	7	18	0	2	20	0	0
7	18137325	.	C	T	0	9	9	0	17	26	0	0
7	18146699	.	T	G	3	4	7	0	0	7	0	0
7	18168253	.	T	A	6	11	17	0	3	20	0	0
7	18367052	.	C	T	2	1	3	0	0	3	0	0
7	18367075	.	A	C	3	3	6	0	0	6	0	0
7	18367165	.	A	T	3	4	7	0	0	7	0	0
7	18412706	.	T	C	2	0	2	0	4	6	0	0
7	18412722	.	A	C	0	0	0	0	8	8	0	0
7	18412779	.	A	G	6	6	12	0	1	13	0	0
7	18413054	.	G	T	3	7	10	0	1	11	0	0
7	18413086	.	G	T	4	4	8	0	0	8	0	0
7	18413585	.	A	C	4	5	9	0	0	9	0	0
7	18413745	.	G	A	3	3	6	0	0	6	0	0
7	18414120	.	C	T	0	4	4	0	0	4	0	0
7	18414124	.	C	T	1	3	4	0	0	4	0	0
7	18415009	.	A	T	4	4	8	0	0	8	0	0
7	18415530	.	C	T	1	2	3	0	0	3	0	0
7	18462466	.	T	C	1	3	4	0	0	4	0	0
7	18462733	.	G	A	5	4	9	0	1	10	0	0
7	18463132	.	T	A	2	3	5	0	0	5	0	0
7	18463259	.	T	C	5	3	8	0	0	8	0	0
7	18463488	.	A	T	2	5	7	0	1	8	0	0
7	18464919	.	C	T	3	5	8	0	0	8	0	0
7	18465000	.	G	A	8	11	19	0	1	20	0	0
7	18465096	.	A	G	9	9	18	0	2	20	0	0
7	18465435	.	T	G	3	2	5	0	1	6	0	0
7	18470277	.	G	A	1	2	3	0	0	3	0	0
7	18470314	.	C	T	1	1	2	0	2	4	0	0
7	18470573	.	C	A	1	4	5	0	0	5	0	0
7	18474945	.	G	A	3	2	5	0	0	5	0	0
7	18474994	.	C	T	2	2	4	0	1	5	0	0
7	18475150	.	C	G	2	2	4	0	0	4	0	0
7	18482163	.	G	A	3	4	7	0	0	7	0	0
7	18550224	.	C	T	1	2	3	0	0	3	0	0
7	18550499	.	C	T	3	5	8	0	0	8	0	0
7	18558504	.	C	T	12	10	22	0	2	24	0	0
7	18558806	.	A	T	16	11	27	0	2	29	0	0
7	18558871	.	G	A	9	12	21	0	2	23	0	0
7	18558906	.	T	G	12	13	25	0	0	25	0	0
7	18559197	.	G	T	7	8	15	0	1	16	0	0
7	18559212	.	C	A	4	11	15	0	2	17	0	0
7	18559258	.	A	G	6	17	23	0	0	23	0	0
7	18559548	.	C	T	5	5	10	0	0	10	0	0
7	18559576	.	A	G	11	5	16	0	0	16	0	0
7	18560013	.	C	A	4	4	8	0	1	9	0	0
7	18560047	.	G	A	3	5	8	0	1	9	0	0
7	18560397	.	C	T	0	6	6	0	6	12	0	0
7	18560474	.	C	T	0	5	5	0	5	10	0	0
7	18560478	.	T	A	5	5	10	0	0	10	0	0
7	18560952	.	C	T	0	4	4	0	2	6	0	0
7	18594557	.	T	C	4	0	4	0	6	10	0	0
7	18598610	.	C	T	3	0	3	0	0	3	0	0
7	18606967	.	A	G	2	2	4	0	0	4	0	0
7	18618113	.	T	A	7	6	13	0	1	14	0	0
7	18618776	.	T	C	4	5	9	0	0	9	0	0
7	18618927	.	T	C	14	8	22	0	1	23	0	0
7	18619661	.	G	A	7	4	11	0	1	12	0	0
7	18619990	.	C	T	1	2	3	0	0	3	0	0
7	18620027	.	A	T	5	1	6	0	1	7	0	0
7	18620049	.	A	C	3	2	5	0	2	7	0	0
7	18620223	.	C	T	0	4	4	0	3	7	0	0
7	18620481	.	C	A	2	2	4	0	0	4	0	0
7	18655807	.	C	T	1	3	4	0	0	4	0	0
7	18780119	.	A	G	6	5	11	0	1	12	0	0
7	18780196	.	A	G	6	2	8	0	3	11	0	0
7	18810675	.	A	G	1	3	4	0	0	4	0	0
7	18810692	.	T	C	1	3	4	0	0	4	0	0
7	18810710	.	C	T	3	3	6	0	1	7	0	0
7	18810926	.	T	C	1	3	4	0	0	4	0	0
7	18810971	.	C	T	0	4	4	0	2	6	0	0
7	18810990	.	C	A	1	2	3	0	0	3	0	0
7	18811128	.	A	G	7	4	11	0	1	12	0	0
7	18876417	.	A	C	1	4	5	0	0	5	0	0
7	18876519	.	G	A	2	1	3	0	0	4	1	0
7	18971066	.	G	T	1	2	3	0	0	3	0	0
7	18971068	.	C	A	1	2	3	0	0	3	0	0
7	18976568	.	T	C	1	4	5	0	0	5	0	0
7	18976592	.	A	C	0	2	2	0	1	3	0	0
7	18980787	.	G	T	3	4	7	0	0	7	0	0
7	19055605	.	C	T	8	14	22	0	0	22	0	0
7	19065861	.	A	G	2	2	4	0	1	5	0	0
7	19070994	.	C	T	1	17	18	0	19	37	0	0
7	19071420	.	T	C	8	0	8	0	8	16	0	0
7	19071617	.	T	C	11	8	19	0	1	20	0	0
7	19071639	.	C	A	7	13	20	0	1	21	0	0
7	19072767	.	T	A	3	6	9	0	1	10	0	0
7	19073481	.	T	C	3	3	6	0	0	6	0	0
7	19073495	.	G	A	5	3	8	0	0	8	0	0
7	19073708	.	T	C	5	5	10	0	1	11	0	0
7	19073716	.	T	C	4	8	12	0	0	12	0	0
7	19073818	.	T	C	2	5	7	0	1	8	0	0
7	19073833	.	G	A	4	1	5	0	0	5	0	0
7	19073918	.	G	A	6	4	10	0	1	11	0	0
7	19074041	.	G	A	4	2	6	0	1	7	0	0
7	19074056	.	T	C	7	2	9	0	1	10	0	0
7	19074173	.	C	T	12	5	17	0	1	18	0	0
7	19074194	.	A	T	9	9	18	0	0	18	0	0
7	19074270	.	G	A	3	7	10	0	1	11	0	0
7	19074363	.	T	C	3	3	6	0	0	6	0	0
7	19075025	.	C	T	0	2	2	0	3	5	0	0
7	19076154	.	A	G	1	3	4	0	0	4	0	0
7	19076550	.	G	A	3	2	5	0	0	5	0	0
7	19076759	.	C	A	2	4	6	0	0	6	0	0
7	19077092	.	G	A	3	5	8	0	0	8	0	0
7	19179977	.	C	T	0	3	3	0	2	5	0	0
7	19180024	.	T	C	5	0	5	0	4	9	0	0
7	19180029	.	A	G	5	4	9	0	0	9	0	0
7	19180152	.	T	A	4	4	8	0	1	9	0	0
7	19180589	.	C	T	1	7	8	0	0	8	0	0
7	19340663	.	G	A	0	1	1	0	0	1	0	0
7	19681734	.	C	A	2	2	4	0	0	4	0	0
7	19753008	.	C	A	2	1	3	0	1	4	0	0
7	19759079	.	G	T	3	1	4	0	1	5	0	0
7	19759194	.	C	A	2	3	5	0	2	7	0	0
7	19759209	.	G	A	0	3	3	0	6	9	0	0
7	19759263	.	T	A	7	3	10	0	0	10	0	0
7	19759296	.	C	T	2	6	8	0	0	8	0	0
7	19759299	.	A	T	2	6	8	0	0	8	0	0
7	19759550	.	C	T	5	5	10	0	0	10	0	0
7	19759962	.	C	T	1	3	4	0	0	4	0	0
7	19860967	.	T	C	1	0	1	0	0	1	0	0
7	19862407	.	C	T	0	1	1	0	0	1	0	0
7	19864504	.	G	A	0	1	1	0	1	2	0	0
7	19893149	.	T	G	1	2	3	0	0	3	0	0
7	19893290	.	C	G	1	3	4	0	0	4	0	0
7	19893573	.	T	A	3	2	5	0	1	6	0	0
7	19894016	.	A	G	1	2	3	0	1	4	0	0
7	19895088	.	G	A	0	4	4	0	3	7	0	0
7	19895139	.	G	C	2	2	4	0	1	5	0	0
7	19895683	.	C	T	6	4	10	0	0	10	0	0
7	19896400	.	A	C	2	4	6	0	1	7	0	0
7	19897309	.	C	T	6	5	11	0	2	13	0	0
7	19897959	.	T	C	9	3	12	0	0	12	0	0
7	19910438	.	A	T	2	2	4	0	0	4	0	0
7	19965281	.	G	A	3	2	5	0	0	5	0	0
7	19966252	.	G	A	1	3	4	0	0	4	0	0
7	19966273	.	T	G	2	3	5	0	0	5	0	0
7	19978616	.	G	A	2	6	8	0	0	8	0	0
7	19978847	.	G	A	2	5	7	0	0	7	0	0
7	19979028	.	C	T	3	5	8	0	0	8	0	0
7	19979133	.	C	T	2	6	8	0	0	8	0	0
7	19979200	.	A	G	3	7	10	0	0	10	0	0
7	19979943	.	A	T	5	3	8	0	0	8	0	0
7	19979968	.	C	A	0	2	2	0	5	7	0	0
7	19988581	.	G	A	1	2	3	0	0	3	0	0
7	20027495	.	G	A	2	2	4	0	0	4	0	0
7	20027595	.	A	T	4	9	13	0	0	13	0	0
7	20027717	.	G	A	5	4	9	0	0	9	0	0
7	20027806	.	T	C	0	5	5	0	1	6	0	0
7	20027807	.	G	A	0	4	4	0	2	6	0	0
7	20059097	.	C	A	2	2	4	0	0	4	0	0
7	20059099	.	T	A	1	3	4	0	0	4	0	0
7	20118330	.	T	C	1	1	2	0	0	2	0	0
7	20141697	.	T	C	19	14	33	0	1	34	0	0
7	20141823	.	A	G	10	16	26	0	0	26	0	0
7	20141916	.	T	C	15	11	26	0	1	27	0	0
7	20142497	.	T	A	5	5	10	0	0	10	0	0
7	20142523	.	T	C	5	3	8	0	0	8	0	0
7	20176444	.	A	T	4	6	10	0	1	11	0	0
7	20222385	.	A	G	6	4	10	0	0	10	0	0
7	20222949	.	A	C	5	4	9	0	0	9	0	0
7	20222993	.	A	T	7	9	16	0	4	20	0	0
7	20223074	.	G	A	5	13	18	0	0	18	0	0
7	20223079	.	A	G	5	11	16	0	4	20	0	0
7	20223110	.	G	A	2	10	12	0	0	12	0	0
7	20223478	.	T	A	10	8	18	0	0	18	0	0
7	20223568	.	C	T	12	11	23	0	0	23	0	0
7	20223632	.	C	T	5	7	12	0	0	12	0	0
7	20223880	.	G	A	0	6	6	0	5	11	0	0
7	20224598	.	T	A	0	2	2	0	0	2	0	0
7	20240298	.	T	C	0	2	2	0	1	3	0	0
7	20294663	.	A	G	0	2	2	0	1	3	0	0
7	20298789	.	C	G	1	3	4	0	0	4	0	0
7	20302952	.	A	G	3	4	7	0	0	7	0	0
7	20305694	.	C	T	1	1	2	0	0	2	0	0
7	20305697	.	C	T	1	0	1	0	1	2	0	0
7	20310893	.	T	C	1	0	1	0	1	2	0	0
7	20315913	.	G	A	3	3	6	0	0	6	0	0
7	20325995	.	C	T	5	1	6	0	0	6	0	0
7	20332513	.	T	C	12	8	20	0	1	21	0	0
7	20332775	.	A	T	11	9	20	0	0	20	0	0
7	20332784	.	G	A	8	11	19	0	1	20	0	0
7	20332959	.	G	A	10	13	23	0	1	24	0	0
7	20332963	.	G	A	11	12	23	0	1	24	0	0
7	20333061	.	A	G	7	1	8	0	10	18	0	0
7	20333076	.	C	A	6	6	12	0	0	12	0	0
7	20333120	.	A	C	2	3	5	0	0	5	0	0
7	20333276	.	T	G	4	8	12	0	0	12	0	0
7	20333435	.	A	G	1	2	3	0	0	3	0	0
7	20334388	.	A	C	2	2	4	0	1	5	0	0
7	20334603	.	T	C	3	4	7	0	0	7	0	0
7	20334891	.	T	G	1	5	6	0	0	6	0	0
7	20335035	.	C	T	1	3	4	0	0	4	0	0
7	20529725	.	C	T	2	4	6	0	0	6	0	0
7	20529728	.	G	A	2	4	6	0	0	6	0	0
7	20529760	.	C	T	3	3	6	0	0	6	0	0
7	20529773	.	T	C	4	4	8	0	0	8	0	0
7	20530284	.	A	T	6	3	9	0	0	9	0	0
7	20530314	.	G	A	5	3	8	0	0	8	0	0
7	20530338	.	C	T	4	5	9	0	0	9	0	0
7	20530373	.	T	A	3	7	10	0	1	11	0	0
7	20542251	.	G	A	3	7	10	0	3	13	0	0
7	20542262	.	C	A	3	7	10	0	2	12	0	0
7	20587681	.	G	T	4	6	10	0	0	10	0	0
7	20587685	.	T	G	4	5	9	0	1	10	0	0
7	20587812	.	T	C	1	2	3	0	0	3	0	0
7	20588229	.	G	A	0	1	1	0	0	1	0	0
7	20593682	.	G	A	0	1	1	0	1	2	0	0
7	20593809	.	G	A	2	1	3	0	4	7	0	0
7	20597033	.	G	A	6	4	10	0	0	10	0	0
7	20597132	.	C	T	4	11	15	0	2	17	0	0
7	20600211	.	T	A	2	4	6	0	0	6	0	0
7	20600398	.	C	T	11	6	17	0	0	17	0	0
7	20600447	.	A	G	7	0	7	0	13	20	0	0
7	20601052	.	G	A	3	6	9	0	0	9	0	0
7	20601072	.	T	C	4	5	9	0	1	10	0	0
7	20601192	.	C	T	5	5	10	0	1	11	0	0
7	20601250	.	A	G	5	2	7	0	2	9	0	0
7	20601325	.	A	G	3	4	7	0	0	7	0	0
7	20601410	.	T	A	3	5	8	0	0	8	0	0
7	20601524	.	G	A	1	2	3	0	0	3	0	0
7	20601713	.	A	T	3	2	5	0	0	5	0	0
7	20601835	.	G	T	6	3	9	0	0	9	0	0
7	20601907	.	A	T	1	4	5	0	0	5	0	0
7	20601925	.	T	C	4	3	7	0	0	7	0	0
7	20605661	.	A	G	2	4	6	0	0	6	0	0
7	20610565	.	C	A	2	0	2	0	0	2	0	0
7	20629598	.	A	T	1	1	2	0	1	3	0	0
7	20629792	.	G	A	2	4	6	0	0	6	0	0
7	20629801	.	A	G	1	4	5	0	0	5	0	0
7	20633683	.	A	C	2	3	5	0	0	5	0	0
7	20633686	.	T	A	2	3	5	0	0	5	0	0
7	20634444	.	A	T	0	3	3	0	1	4	0	0
7	20634498	.	T	A	5	10	15	0	0	15	0	0
7	20634577	.	T	G	5	13	18	0	3	21	0	0
7	20635475	.	A	G	13	5	18	0	1	19	0	0
7	20635495	.	T	A	11	5	16	0	1	17	0	0
7	20635616	.	T	C	3	6	9	0	0	9	0	0
7	20635760	.	A	G	2	7	9	0	0	9	0	0
7	20636344	.	A	G	3	13	16	0	2	18	0	0
7	20636379	.	A	T	3	14	17	0	0	17	0	0
7	20636410	.	C	T	6	14	20	0	3	23	0	0
7	20636414	.	T	G	6	14	20	0	4	24	0	0
7	20636464	.	G	A	6	10	16	0	3	19	0	0
7	20636465	.	A	G	7	12	19	0	0	19	0	0
7	20636802	.	T	G	8	19	27	0	1	28	0	0
7	20636833	.	A	G	7	21	28	0	1	29	0	0
7	20636844	.	T	A	9	22	31	0	3	34	0	0
7	20664621	.	A	T	4	3	7	0	1	8	0	0
7	20693673	.	G	T	12	10	22	0	3	25	0	0
7	20695949	.	G	T	5	4	9	0	0	9	0	0
7	20698208	.	T	A	1	1	2	0	0	2	0	0
7	20712555	.	C	T	2	4	6	0	0	6	0	0
7	20715434	.	C	T	3	0	3	0	0	3	0	0
7	20731052	.	C	T	2	5	7	0	0	7	0	0
7	20731166	.	A	G	1	3	4	0	0	4	0	0
7	20738148	.	A	G	3	2	5	0	0	5	0	0
7	20743583	.	G	A	3	2	5	0	0	5	0	0
7	20754669	.	G	A	1	1	2	0	0	2	0	0
7	20780285	.	G	A	7	4	11	0	0	11	0	0
7	20780317	.	C	T	6	6	12	0	0	12	0	0
7	20780337	.	A	C	5	6	11	0	0	11	0	0
7	20780356	.	A	G	6	3	9	0	0	9	0	0
7	20780732	.	A	C	2	5	7	0	0	7	0	0
7	20780794	.	T	C	7	7	14	0	0	14	0	0
7	20780918	.	C	T	0	8	8	0	5	13	0	0
7	20780987	.	G	A	2	3	5	0	1	6	0	0
7	20781110	.	C	T	7	12	19	0	0	19	0	0
7	20781327	.	A	G	1	2	3	0	2	5	0	0
7	20781377	.	T	C	1	2	3	0	0	3	0	0
7	20781549	.	C	G	6	3	9	0	0	9	0	0
7	20781996	.	T	G	2	2	4	0	0	4	0	0
7	20784772	.	G	A	2	3	5	0	0	5	0	0
7	20787233	.	C	T	2	2	4	0	0	4	0	0
7	20859446	.	G	C	6	11	17	0	0	17	0	0
7	20859975	.	G	A	7	2	9	0	0	9	0	0
7	20860011	.	T	C	2	0	2	0	0	2	0	0
7	20864097	.	A	G	1	0	1	0	0	1	0	0
7	20864256	.	T	C	2	0	2	0	0	2	0	0
7	20892307	.	A	T	2	0	2	0	0	2	0	0
7	20935684	.	C	T	2	0	2	0	0	2	0	0
7	20935737	.	T	A	5	2	7	0	0	7	0	0
7	20935765	.	A	G	1	2	3	0	0	3	0	0
7	20938812	.	C	T	4	3	7	0	1	8	0	0
7	21766917	.	G	A	3	2	5	0	0	5	0	0
7	21766937	.	C	A	3	2	5	0	0	5	0	0
7	21767423	.	A	G	3	3	6	0	0	6	0	0
7	21768002	.	T	C	2	2	4	0	1	5	0	0
7	21768060	.	A	G	3	3	6	0	0	6	0	0
7	21768334	.	C	A	7	4	11	0	2	13	0	0
7	21769318	.	A	G	2	2	4	0	0	4	0	0
7	21769733	.	G	A	4	4	8	0	0	8	0	0
7	21770819	.	G	T	0	3	3	0	6	9	0	0
7	21773542	.	C	T	6	7	13	0	1	14	0	0
7	21773626	.	C	T	2	7	9	0	0	9	0	0
7	21774127	.	G	A	4	6	10	0	1	11	0	0
7	21776426	.	C	T	0	5	5	0	1	6	0	0
7	21776683	.	G	A	8	6	14	0	1	15	0	0
7	21776693	.	T	C	6	4	10	0	2	12	0	0
7	21777203	.	G	T	8	3	11	0	0	11	0	0
7	21777720	.	G	A	17	13	30	0	1	31	0	0
7	21777978	.	T	G	13	15	28	0	1	29	0	0
7	21778070	.	T	C	3	2	5	0	0	5	0	0
7	21872656	.	G	A	2	2	4	0	0	4	0	0
7	21873342	.	A	C	4	2	6	0	0	6	0	0
7	21873350	.	G	A	2	4	6	0	0	6	0	0
7	21876652	.	T	C	2	2	4	0	0	4	0	0
7	21878507	.	G	A	3	1	4	0	0	4	0	0
7	21881863	.	C	T	3	4	7	0	0	7	0	0
7	21884703	.	C	T	0	4	4	0	2	6	0	0
7	21887797	.	A	T	1	3	4	0	0	4	0	0
7	21887967	.	C	T	18	15	33	0	3	36	0	0
7	21888084	.	T	A	17	25	42	0	1	43	0	0
7	21888274	.	T	A	15	12	27	0	1	28	0	0
7	21890998	.	C	T	1	3	4	0	0	4	0	0
7	21891031	.	G	A	0	3	3	0	1	4	0	0
7	21891208	.	C	T	3	3	6	0	0	6	0	0
7	21891219	.	A	G	5	0	5	0	1	6	0	0
7	21917927	.	C	A	3	5	8	0	0	8	0	0
7	21917972	.	C	G	1	2	3	0	0	3	0	0
7	21940965	.	T	G	1	13	14	0	0	14	0	0
7	21940992	.	A	G	9	13	22	0	0	22	0	0
7	21941016	.	T	G	15	14	29	0	1	32	2	0
7	21941460	.	G	A	12	8	20	0	1	21	0	0
7	21941477	.	C	A	10	16	26	0	0	26	0	0
7	21941568	.	C	T	21	8	29	0	1	30	0	0
7	21941579	.	A	C	6	20	26	0	0	26	0	0
7	21942378	.	C	T	8	13	21	0	2	23	0	0
7	21942513	.	A	T	13	13	26	0	3	29	0	0
7	21942644	.	T	A	12	10	22	0	0	22	0	0
7	21942672	.	C	T	9	14	23	0	1	24	0	0
7	21943553	.	A	G	14	9	23	0	0	23	0	0
7	21943625	.	G	A	9	6	15	0	1	16	0	0
7	21943716	.	T	G	4	6	10	0	0	10	0	0
7	21943772	.	T	C	7	4	11	0	1	12	0	0
7	21944495	.	T	C	3	2	5	0	1	6	0	0
7	21944753	.	G	A	3	3	6	0	1	7	0	0
7	21945257	.	C	T	0	4	4	0	6	10	0	0
7	21945347	.	C	T	1	7	8	0	4	12	0	0
7	22799377	.	A	C	1	2	3	0	15	18	0	0
7	23751420	.	T	C	10	3	13	0	1	14	0	0
7	23751956	.	C	A	5	2	7	0	1	8	0	0
7	23752387	.	T	A	5	2	7	0	0	7	0	0
7	23887218	.	G	A	1	2	3	0	0	3	0	0
7	23907784	.	G	T	7	15	22	0	0	22	0	0
7	23909369	.	A	C	11	9	20	0	0	20	0	0
7	23909456	.	T	G	11	11	22	0	3	25	0	0
7	23915104	.	G	A	1	23	24	0	19	43	0	0
7	23915296	.	C	T	22	31	53	0	2	55	0	0
7	23915359	.	G	A	1	24	25	0	28	53	0	0
7	23915379	.	T	A	29	24	53	0	4	57	0	0
7	23915700	.	G	T	16	11	27	0	5	32	0	0
7	23915731	.	G	T	25	13	38	0	1	39	0	0
7	23915926	.	C	T	32	23	55	0	2	57	0	0
7	23915963	.	A	G	24	0	24	0	31	55	0	0
7	23915964	.	A	T	24	28	52	0	3	55	0	0
7	23967515	.	A	C	11	0	11	0	17	28	0	0
7	23967522	.	G	A	11	14	25	0	3	28	0	0
7	23967705	.	G	A	6	10	16	0	0	16	0	0
7	23967772	.	A	G	10	21	31	0	1	32	0	0
7	23967861	.	C	T	0	18	18	0	15	33	0	0
7	23967878	.	G	A	17	16	33	0	0	33	0	0
7	23967930	.	A	G	20	17	37	0	3	40	0	0
7	23968174	.	A	C	5	11	16	0	2	18	0	0
7	23968267	.	A	C	9	12	21	0	2	23	0	0
7	23968292	.	T	G	8	8	16	0	1	17	0	0
7	23969226	.	G	A	4	4	8	0	0	8	0	0
7	23969446	.	C	T	9	7	16	0	0	16	0	0
7	23969593	.	G	A	3	5	8	0	2	10	0	0
7	23970196	.	A	G	4	6	10	0	0	10	0	0
7	23970236	.	T	A	6	5	11	0	0	11	0	0
7	23970320	.	G	T	11	8	19	0	0	19	0	0
7	23970331	.	G	A	15	8	23	0	1	24	0	0
7	23970428	.	T	C	9	3	12	0	2	14	0	0
7	23970545	.	C	A	4	2	6	0	0	6	0	0
7	23970560	.	T	A	4	2	6	0	0	6	0	0
7	23970695	.	T	C	3	2	5	0	0	5	0	0
7	23971181	.	G	C	1	2	3	0	0	3	0	0
7	23971682	.	T	A	2	3	5	0	0	5	0	0
7	23971714	.	G	C	2	0	2	0	0	2	0	0
7	23971728	.	T	A	0	2	2	0	0	2	0	0
7	24007097	.	A	G	1	2	3	0	1	4	0	0
7	24011474	.	C	A	1	2	3	0	0	3	0	0
7	24011926	.	T	C	4	5	9	0	0	9	0	0
7	24012794	.	T	C	8	4	12	0	1	13	0	0
7	24013269	.	G	A	3	5	8	0	0	8	0	0
7	24013489	.	G	A	0	7	7	0	14	21	0	0
7	24033639	.	C	G	3	5	8	0	0	8	0	0
7	24043391	.	G	A	0	1	1	0	0	1	0	0
7	24059570	.	C	T	5	2	7	0	0	7	0	0
7	24059861	.	C	G	1	2	3	0	0	3	0	0
7	24059873	.	C	T	1	2	3	0	1	4	0	0
7	24066825	.	C	T	1	3	4	0	0	4	0	0
7	24067056	.	G	T	2	4	6	0	0	6	0	0
7	24068078	.	T	G	7	4	11	0	2	13	0	0
7	24068224	.	A	T	10	5	15	0	1	16	0	0
7	24068586	.	C	T	3	8	11	0	0	11	0	0
7	24068868	.	G	A	0	6	6	0	3	9	0	0
7	24069484	.	T	C	1	2	3	0	1	4	0	0
7	24075776	.	C	T	2	3	5	0	0	5	0	0
7	24075911	.	G	A	1	2	3	0	0	3	0	0
7	24076192	.	C	T	0	5	5	0	0	5	0	0
7	24076198	.	C	T	2	2	4	0	1	5	0	0
7	24076269	.	C	T	3	5	8	0	0	8	0	0
7	24076329	.	C	T	4	5	9	0	1	10	0	0
7	24076373	.	C	T	6	3	9	0	1	10	0	0
7	24084783	.	C	T	0	1	1	0	0	1	0	0
7	24084879	.	C	T	3	2	5	0	0	5	0	0
7	24087362	.	A	T	7	4	11	0	0	12	1	0
7	24087365	.	T	C	4	7	11	0	2	13	0	0
7	24087724	.	C	A	2	2	4	0	0	4	0	0
7	24090182	.	G	A	11	4	15	0	0	15	0	0
7	24091054	.	G	A	4	12	16	0	1	17	0	0
7	24091269	.	G	A	0	6	6	0	10	16	0	0
7	24092626	.	C	T	1	2	3	0	0	3	0	0
7	24093165	.	C	G	10	15	25	0	2	27	0	0
7	24093300	.	C	T	16	15	31	0	2	33	0	0
7	24093301	.	A	C	17	16	33	0	0	33	0	0
7	24093372	.	A	G	4	1	5	0	0	5	0	0
7	24095515	.	C	G	23	20	43	0	4	47	0	0
7	24095717	.	G	A	0	9	9	0	21	30	0	0
7	24095776	.	G	A	10	19	29	0	4	33	0	0
7	24095788	.	A	G	13	17	30	0	1	31	0	0
7	24095836	.	C	T	3	10	13	0	1	14	0	0
7	24095848	.	G	A	9	9	18	0	1	19	0	0
7	24095883	.	T	A	7	15	22	0	2	24	0	0
7	24095926	.	A	C	14	15	29	0	0	29	0	0
7	24095978	.	T	A	23	16	39	0	0	39	0	0
7	24096399	.	C	A	18	15	33	0	1	34	0	0
7	24096505	.	G	A	0	16	16	0	15	31	0	0
7	24096541	.	C	T	9	12	21	0	2	23	0	0
7	24096767	.	A	C	22	16	38	0	5	43	0	0
7	24115186	.	G	A	1	0	1	0	0	1	0	0
7	24159155	.	G	T	0	0	0	0	1	1	0	0
7	24161591	.	C	A	5	4	9	0	3	12	0	0
7	24162019	.	G	A	3	7	10	0	0	10	0	0
7	24162034	.	C	T	1	5	6	0	1	7	0	0
7	24162368	.	A	T	7	10	17	0	1	18	0	0
7	24162369	.	A	C	8	10	18	0	0	18	0	0
7	24162485	.	C	T	11	10	21	0	1	22	0	0
7	24162567	.	T	C	4	4	8	0	0	8	0	0
7	24162761	.	G	T	3	4	7	0	1	8	0	0
7	24197574	.	C	A	6	2	8	0	0	8	0	0
7	24197814	.	G	A	4	2	6	0	0	6	0	0
7	24197841	.	G	A	4	2	6	0	0	6	0	0
7	24198334	.	C	T	6	5	11	0	1	12	0	0
7	24198335	.	C	T	0	5	5	0	7	12	0	0
7	24200052	.	C	T	0	1	1	0	2	3	0	0
7	24207520	.	A	C	11	23	34	0	1	35	0	0
7	24207590	.	A	T	20	22	42	0	1	43	0	0
7	24207632	.	G	C	19	13	32	0	1	33	0	0
7	24210323	.	C	A	0	17	17	0	11	28	0	0
7	24210422	.	T	C	10	15	25	0	2	27	0	0
7	24210629	.	T	A	13	23	36	0	5	41	0	0
7	24210659	.	A	G	17	24	41	0	4	45	0	0
7	24210676	.	A	G	17	19	36	0	3	39	0	0
7	24211015	.	A	T	8	8	16	0	0	16	0	0
7	24211054	.	G	A	5	11	16	0	0	16	0	0
7	24211081	.	T	A	8	15	23	0	1	24	0	0
7	24211342	.	C	T	0	8	8	0	16	24	0	0
7	24211443	.	C	T	0	5	5	0	16	21	0	0
7	24211542	.	G	T	1	5	6	0	0	6	0	0
7	24211646	.	C	T	0	4	4	0	10	14	0	0
7	24211978	.	G	A	8	9	17	1	3	21	0	0
7	24212093	.	C	G	5	12	17	0	0	17	0	0
7	24212122	.	T	C	9	3	12	0	0	12	0	0
7	24212383	.	G	A	10	9	19	0	0	19	0	0
7	24214655	.	C	T	2	2	4	0	1	5	0	0
7	24214673	.	C	A	3	2	5	0	0	5	0	0
7	24236177	.	C	G	2	3	5	0	0	5	0	0
7	24457691	.	C	A	31	23	54	0	3	58	1	0
7	24457788	.	C	A	28	9	37	0	2	39	0	0
7	24457803	.	A	C	25	7	32	0	0	32	0	0
7	24458103	.	C	A	22	14	36	0	3	39	0	0
7	24458128	.	G	C	25	15	40	0	1	41	0	0
7	24458205	.	G	A	38	18	56	0	2	58	0	0
7	24458282	.	C	T	25	10	35	0	2	37	0	0
7	24458339	.	A	G	23	16	39	0	2	41	0	0
7	24458866	.	T	C	19	17	36	0	2	38	0	0
7	24458894	.	T	A	18	20	38	0	3	41	0	0
7	24459452	.	G	A	17	13	30	0	2	32	0	0
7	24459847	.	A	G	21	13	34	0	3	37	0	0
7	24459932	.	T	C	19	16	35	0	1	36	0	0
7	24460025	.	G	A	9	20	29	0	0	29	0	0
7	24460026	.	C	T	9	19	28	0	1	29	0	0
7	24460189	.	T	C	8	13	21	0	2	23	0	0
7	24460443	.	G	A	11	12	23	0	2	25	0	0
7	24460461	.	G	A	8	12	20	0	3	23	0	0
7	24461115	.	A	C	11	12	23	0	2	25	0	0
7	24461298	.	G	A	12	5	17	0	0	17	0	0
7	24461601	.	A	G	8	6	14	0	0	14	0	0
7	24462394	.	A	G	4	4	8	0	0	8	0	0
7	24470812	.	A	G	6	4	10	0	0	10	0	0
7	24485688	.	T	C	5	2	7	0	0	7	0	0
7	24485741	.	G	A	6	2	8	0	0	8	0	0
7	24486345	.	A	G	26	18	44	0	5	50	1	0
7	24486515	.	A	C	23	35	58	0	4	62	0	0
7	24486546	.	G	C	28	27	55	0	2	59	2	0
7	24486721	.	G	A	34	30	64	0	8	72	0	0
7	24486822	.	G	A	28	32	60	0	2	62	0	0
7	24489888	.	A	G	5	5	10	0	1	11	0	0
7	24498912	.	C	T	2	3	5	0	0	5	0	0
7	24504508	.	C	T	3	2	5	0	0	5	0	0
7	24504875	.	C	T	10	12	22	0	1	23	0	0
7	24528917	.	T	A	3	4	7	0	0	7	0	0
7	24569961	.	T	C	2	5	7	0	1	8	0	0
7	24569990	.	T	G	5	5	10	0	3	13	0	0
7	24570012	.	A	T	8	6	14	0	0	14	0	0
7	24570714	.	G	A	0	6	6	0	6	12	0	0
7	24571056	.	C	T	5	2	7	0	0	7	0	0
7	24581458	.	T	A	5	4	9	0	0	9	0	0
7	24582131	.	C	A	3	2	5	0	0	5	0	0
7	24582133	.	C	T	3	2	5	0	0	5	0	0
7	24593439	.	T	C	7	2	9	0	1	10	0	0
7	24593452	.	T	A	5	3	8	0	0	8	0	0
7	24594860	.	T	A	5	4	9	0	0	9	0	0
7	24598728	.	G	T	3	3	6	0	2	8	0	0
7	24603028	.	G	T	0	4	4	0	0	4	0	0
7	24616240	.	G	A	2	0	2	0	0	2	0	0
7	24621385	.	C	T	3	2	5	0	0	5	0	0
7	24631812	.	C	A	6	4	10	0	0	10	0	0
7	24631818	.	G	A	6	5	11	0	1	12	0	0
7	24632080	.	C	T	0	1	1	0	0	1	0	0
7	24637765	.	C	A	1	2	3	0	0	3	0	0
7	24637934	.	T	C	1	3	4	0	1	5	0	0
7	24638015	.	C	A	0	1	1	0	2	3	0	0
7	24640622	.	T	C	1	0	1	0	0	1	0	0
7	24644434	.	G	C	2	0	2	0	0	2	0	0
7	24645292	.	A	G	1	2	3	0	0	3	0	0
7	24649421	.	C	T	0	1	1	0	0	1	0	0
7	24653020	.	G	A	3	2	5	0	0	5	0	0
7	24653121	.	G	A	1	0	1	0	0	1	0	0
7	24662235	.	G	A	3	1	4	0	0	4	0	0
7	24672257	.	G	C	12	15	27	0	2	29	0	0
7	24672766	.	A	G	2	5	7	0	0	7	0	0
7	24681673	.	A	G	14	18	32	0	6	38	0	0
7	24681731	.	T	C	13	21	34	0	4	38	0	0
7	24681755	.	A	G	10	19	29	0	0	29	0	0
7	24681806	.	A	G	1	1	2	0	1	3	0	0
7	24697400	.	T	C	1	0	1	0	0	1	0	0
7	24699881	.	G	T	4	4	8	0	0	8	0	0
7	24715058	.	T	C	3	2	5	0	0	5	0	0
7	24715361	.	T	C	1	3	4	0	0	4	0	0
7	24715870	.	C	T	0	6	6	0	3	9	0	0
7	24715879	.	C	T	2	5	7	0	1	8	0	0
7	24716056	.	G	T	1	2	3	0	1	4	0	0
7	24812538	.	G	C	2	3	5	0	0	5	0	0
7	24812587	.	C	T	7	4	11	0	0	11	0	0
7	24812662	.	G	T	2	2	4	0	0	4	0	0
7	24812829	.	A	G	1	3	4	0	0	4	0	0
7	24815992	.	C	T	6	5	11	0	0	11	0	0
7	24819788	.	G	A	2	1	3	0	0	3	0	0
7	24819812	.	G	A	6	10	16	0	0	16	0	0
7	24822914	.	G	A	9	4	13	0	0	13	0	0
7	24888986	.	T	C	1	2	3	0	0	3	0	0
7	24923112	.	G	A	0	2	2	0	4	6	0	0
7	24946895	.	C	T	0	2	2	0	0	2	0	0
7	24946913	.	T	C	0	4	4	0	0	4	0	0
7	24947440	.	T	C	4	1	5	0	0	5	0	0
7	24974916	.	T	C	3	5	8	0	0	8	0	0
7	24974937	.	T	C	2	6	8	0	3	11	0	0
7	24975264	.	T	C	13	14	27	0	1	28	0	0
7	24975646	.	C	T	14	8	22	0	0	22	0	0
7	24975678	.	G	A	12	10	22	0	0	22	0	0
7	24976539	.	T	C	21	15	36	0	1	37	0	0
7	24979979	.	A	G	8	4	12	0	0	12	0	0
7	24980107	.	T	G	8	11	19	0	0	19	0	0
7	24980185	.	T	G	5	9	14	0	0	14	0	0
7	24980469	.	C	T	5	16	21	0	1	22	0	0
7	25010745	.	C	T	26	14	40	0	2	42	0	0
7	25011238	.	A	G	9	15	24	0	1	25	0	0
7	25011375	.	T	C	2	3	5	0	0	5	0	0
7	25011585	.	T	G	7	4	11	0	0	11	0	0
7	25015154	.	C	T	2	4	6	0	0	6	0	0
7	25015239	.	C	T	3	4	7	0	0	7	0	0
7	25017967	.	G	C	1	4	5	0	0	5	0	0
7	25018043	.	G	T	0	1	1	0	1	2	0	0
7	25021647	.	T	G	1	2	3	0	1	4	0	0
7	25021697	.	T	C	3	6	9	0	0	9	0	0
7	25021718	.	C	T	3	7	10	0	1	11	0	0
7	25024266	.	T	C	4	8	12	0	2	14	0	0
7	25024277	.	A	T	5	11	16	0	0	16	0	0
7	25024346	.	G	C	0	1	1	0	3	4	0	0
7	25026873	.	C	T	8	7	15	0	0	15	0	0
7	25026960	.	C	T	10	7	17	0	0	17	0	0
7	25027022	.	T	C	10	4	14	0	0	14	0	0
7	25027034	.	A	G	8	5	13	0	0	13	0	0
7	25027208	.	G	A	6	3	9	0	0	9	0	0
7	25027211	.	G	T	0	2	2	0	7	9	0	0
7	25027266	.	T	C	9	4	13	0	0	13	0	0
7	25027397	.	T	C	3	1	4	0	2	6	0	0
7	25027399	.	T	G	3	3	6	0	0	6	0	0
7	25027466	.	C	A	2	6	8	0	1	9	0	0
7	25027561	.	C	T	3	14	17	0	0	17	0	0
7	25027571	.	A	G	2	13	15	0	0	15	0	0
7	25027756	.	T	C	6	6	12	0	0	12	0	0
7	25028034	.	C	T	7	12	19	0	0	19	0	0
7	25028081	.	A	G	12	10	22	0	0	22	0	0
7	25028085	.	G	C	12	10	22	0	1	23	0	0
7	25028205	.	T	A	10	9	19	0	0	19	0	0
7	25028598	.	A	G	7	5	12	0	0	12	0	0
7	25028627	.	T	A	7	4	11	0	2	13	0	0
7	25029129	.	C	T	0	4	4	0	0	4	0	0
7	25029140	.	T	A	0	5	5	0	0	5	0	0
7	25029169	.	G	A	1	6	7	0	2	9	0	0
7	25029191	.	G	A	0	6	6	0	2	8	0	0
7	25045337	.	T	A	1	0	1	0	0	1	0	0
7	25045777	.	A	G	5	1	6	0	0	6	0	0
7	25047228	.	A	C	1	7	8	0	0	8	0	0
7	25047307	.	G	C	5	9	14	0	1	15	0	0
7	25047318	.	A	C	7	11	18	0	0	18	0	0
7	25047441	.	T	G	9	13	22	0	2	24	0	0
7	25047604	.	T	A	12	15	27	0	0	27	0	0
7	25047954	.	G	A	5	3	8	0	1	9	0	0
7	25049262	.	A	G	13	11	24	0	2	26	0	0
7	25059856	.	C	T	7	3	10	0	0	10	0	0
7	25096889	.	T	C	7	2	9	0	3	12	0	0
7	25098910	.	G	A	34	17	51	0	2	53	0	0
7	25099133	.	A	G	26	5	31	0	21	52	0	0
7	25099302	.	T	C	4	14	18	0	2	20	0	0
7	25099594	.	T	G	14	12	26	0	1	27	0	0
7	25099704	.	T	C	17	14	31	0	3	34	0	0
7	25128575	.	T	A	1	2	3	0	0	3	0	0
7	25129889	.	A	G	4	2	6	0	0	6	0	0
7	25129954	.	T	A	2	3	5	0	1	6	0	0
7	25292455	.	T	C	2	2	4	0	0	4	0	0
7	25292660	.	T	C	2	2	4	0	0	4	0	0
7	25292978	.	G	A	0	2	2	0	2	4	0	0
7	25293666	.	A	G	4	6	10	0	0	10	0	0
7	25347024	.	C	T	2	3	5	0	1	6	0	0
7	25347459	.	T	G	6	5	11	0	1	12	0	0
7	25347679	.	A	T	1	2	3	0	1	4	0	0
7	25348031	.	C	T	2	3	5	0	0	5	0	0
7	25558837	.	T	A	0	2	2	0	0	2	0	0
7	25558952	.	C	A	0	5	5	0	4	9	0	0
7	25559010	.	T	C	1	2	3	0	0	3	0	0
7	25559093	.	A	G	5	2	7	0	0	7	0	0
7	25559814	.	C	T	1	5	6	0	0	6	0	0
7	25854239	.	T	C	5	4	9	0	0	9	0	0
7	25854245	.	C	G	5	4	9	0	0	9	0	0
7	25858611	.	C	A	1	0	1	0	1	2	0	0
7	25863708	.	C	T	1	2	3	0	0	3	0	0
7	25867412	.	C	T	3	4	7	0	0	7	0	0
7	25869617	.	C	T	2	0	2	0	1	3	0	0
7	25872580	.	C	T	7	6	13	1	0	14	0	0
7	25873009	.	C	T	2	4	6	0	0	6	0	0
7	25873743	.	C	A	11	7	18	0	1	19	0	0
7	25873857	.	T	C	4	5	9	0	0	9	0	0
7	25876947	.	A	C	9	7	16	1	0	17	0	0
7	25877033	.	A	T	14	6	20	0	1	21	0	0
7	25877038	.	G	A	13	6	19	0	3	22	0	0
7	25877420	.	T	C	15	14	29	0	2	31	0	0
7	25877445	.	G	C	15	14	29	0	0	29	0	0
7	25878417	.	T	G	4	12	16	0	0	16	0	0
7	25878642	.	G	T	15	24	39	0	6	45	0	0
7	25878723	.	A	C	18	17	35	0	8	44	1	0
7	25878786	.	C	T	0	16	16	0	41	57	0	0
7	25878849	.	T	C	22	17	39	0	3	42	0	0
7	25878977	.	A	G	24	18	42	0	2	44	0	0
7	25879116	.	T	G	21	25	46	0	6	52	0	0
7	25879130	.	G	C	21	27	48	0	4	52	0	0
7	25879514	.	T	A	22	19	41	0	0	41	0	0
7	25879905	.	G	A	12	18	30	0	0	30	0	0
7	25879920	.	G	T	24	11	35	0	0	35	0	0
7	25880033	.	A	T	14	8	22	0	2	24	0	0
7	25880046	.	C	A	13	9	22	0	1	24	1	0
7	25880207	.	T	A	10	10	20	0	0	20	0	0
7	25880226	.	G	A	9	11	20	0	1	21	0	0
7	25880313	.	T	A	17	13	30	0	4	34	0	0
7	25880340	.	C	T	1	17	18	0	21	39	0	0
7	25880754	.	C	T	0	6	6	0	17	23	0	0
7	25880843	.	G	A	9	12	21	0	1	22	0	0
7	25881215	.	C	T	9	11	20	0	0	20	0	0
7	25881583	.	G	A	13	4	17	0	0	17	0	0
7	25881605	.	A	C	3	7	10	0	2	12	0	0
7	25884007	.	G	T	2	2	4	0	0	4	0	0
7	25917046	.	A	G	12	14	26	0	4	30	0	0
7	25917473	.	G	A	1	24	25	0	35	60	0	0
7	25917634	.	A	T	31	40	71	0	2	73	0	0
7	25918056	.	C	T	22	43	65	0	12	77	0	0
7	25920966	.	A	G	3	0	3	0	3	6	0	0
7	25979417	.	C	T	9	6	15	0	1	16	0	0
7	25979468	.	C	T	6	10	16	0	4	20	0	0
7	25979510	.	T	C	4	7	11	0	0	11	0	0
7	25986069	.	G	T	0	2	2	0	1	4	1	0
7	25986099	.	C	T	8	6	14	0	0	14	0	0
7	25988324	.	C	A	0	1	1	0	0	1	0	0
7	26002674	.	C	T	13	23	36	0	3	39	0	0
7	26002915	.	T	A	20	17	37	0	3	40	0	0
7	26003853	.	C	T	4	5	9	0	0	9	0	0
7	26004616	.	A	G	7	3	10	0	0	10	0	0
7	26004876	.	T	A	8	9	17	0	3	20	0	0
7	26005033	.	A	G	3	11	14	0	0	14	0	0
7	26005574	.	A	T	2	3	5	0	0	5	0	0
7	26011665	.	A	T	1	0	1	0	0	1	0	0
7	26013041	.	C	G	1	1	2	0	0	2	0	0
7	26015544	.	G	T	2	3	5	0	0	5	0	0
7	26015595	.	C	A	3	3	6	0	0	6	0	0
7	26015693	.	C	A	1	1	2	0	0	2	0	0
7	26020078	.	T	C	3	0	3	0	0	3	0	0
7	26020192	.	C	T	6	4	10	0	2	12	0	0
7	26020273	.	G	A	1	6	7	0	12	19	0	0
7	26020408	.	A	C	6	2	8	0	0	8	0	0
7	26020659	.	C	T	6	13	19	0	2	21	0	0
7	26020779	.	C	T	9	9	18	0	1	19	0	0
7	26020927	.	A	T	4	6	10	0	3	13	0	0
7	26021146	.	A	G	11	18	29	0	0	29	0	0
7	26026176	.	C	T	5	13	18	0	3	21	0	0
7	26026188	.	C	A	6	16	22	0	1	23	0	0
7	26026241	.	G	A	8	10	18	0	0	18	0	0
7	26026264	.	C	G	10	3	13	0	1	14	0	0
7	26026330	.	A	T	7	6	13	0	1	14	0	0
7	26026358	.	A	C	6	3	9	0	0	9	0	0
7	26026379	.	C	T	4	2	6	0	0	6	0	0
7	26026491	.	T	G	3	4	7	0	0	7	0	0
7	26048402	.	T	C	1	2	3	0	0	3	0	0
7	26048403	.	T	C	1	2	3	0	0	3	0	0
7	26074160	.	C	A	5	8	13	0	1	14	0	0
7	26077845	.	G	T	21	22	43	0	2	45	0	0
7	26077947	.	T	A	16	31	47	0	4	51	0	0
7	26077949	.	C	T	18	28	46	0	5	51	0	0
7	26078061	.	T	C	14	20	34	0	6	40	0	0
7	26078243	.	A	C	17	22	39	0	1	40	0	0
7	26078284	.	C	T	18	24	42	0	1	44	1	0
7	26078345	.	T	A	20	23	43	0	2	45	0	0
7	26078435	.	G	T	11	10	21	0	2	23	0	0
7	26078516	.	T	A	16	5	21	0	6	27	0	0
7	26078897	.	G	A	29	21	50	0	3	53	0	0
7	26078947	.	G	A	32	14	46	0	1	47	0	0
7	26079370	.	T	G	10	27	37	0	3	40	0	0
7	26079667	.	C	G	1	19	20	0	19	39	0	0
7	26081171	.	C	T	14	7	21	0	2	23	0	0
7	26081252	.	A	G	4	2	6	0	0	6	0	0
7	26081744	.	T	C	8	6	14	0	0	14	0	0
7	26082281	.	G	A	3	2	5	0	0	5	0	0
7	26082311	.	A	G	4	2	6	0	1	7	0	0
7	26116876	.	A	G	2	2	4	0	0	4	0	0
7	26132724	.	C	T	4	1	5	0	0	5	0	0
7	26132743	.	C	T	1	0	1	0	0	1	0	0
7	26140767	.	A	G	1	3	4	0	1	5	0	0
7	26141394	.	G	C	6	3	9	0	0	9	0	0
7	26141519	.	T	A	4	10	14	0	0	14	0	0
7	26141568	.	T	A	14	8	22	0	0	22	0	0
7	26142339	.	T	C	4	4	8	0	2	10	0	0
7	26142525	.	T	G	9	0	9	0	6	15	0	0
7	26142702	.	A	G	5	12	17	0	1	18	0	0
7	26142736	.	A	T	4	5	9	0	0	9	0	0
7	26143343	.	A	G	1	6	7	0	0	7	0	0
7	26143501	.	T	C	7	11	18	0	4	22	0	0
7	26143760	.	G	A	10	6	16	0	2	18	0	0
7	26144628	.	C	T	1	2	3	0	1	4	0	0
7	26145605	.	T	C	11	23	34	0	0	34	0	0
7	26145816	.	C	T	1	2	3	0	0	3	0	0
7	26145910	.	T	C	7	6	13	0	5	18	0	0
7	26146176	.	A	C	15	24	39	0	3	42	0	0
7	26146188	.	T	C	18	24	42	0	3	45	0	0
7	26146796	.	A	G	15	3	18	0	25	43	0	0
7	26146993	.	C	T	27	28	55	0	5	60	0	0
7	26148181	.	A	C	30	22	52	1	3	57	1	0
7	26148263	.	A	G	39	15	54	0	4	58	0	0
7	26148312	.	T	G	19	19	38	0	4	43	1	0
7	26148773	.	G	A	5	2	7	0	3	10	0	0
7	26149252	.	G	A	29	27	56	0	3	59	0	0
7	26149690	.	C	T	22	29	51	0	3	54	0	0
7	26150096	.	T	A	24	21	45	0	2	47	0	0
7	26224320	.	A	G	7	3	10	0	0	10	0	0
7	26224365	.	A	T	4	4	8	0	0	8	0	0
7	26226772	.	G	C	5	9	14	0	0	14	0	0
7	26227119	.	C	T	11	8	19	0	0	19	0	0
7	26227149	.	C	T	7	2	9	0	0	9	0	0
7	26227527	.	T	C	4	10	14	0	0	14	0	0
7	26227539	.	T	C	3	9	12	0	1	13	0	0
7	26228290	.	C	T	24	13	37	0	1	38	0	0
7	26228639	.	T	C	17	21	38	0	0	38	0	0
7	26229449	.	G	A	13	19	32	0	0	32	0	0
7	26229529	.	C	T	25	17	42	0	4	46	0	0
7	26229551	.	T	A	27	17	44	0	7	51	0	0
7	26229640	.	T	C	30	22	52	0	1	53	0	0
7	26229935	.	C	T	22	20	42	0	1	43	0	0
7	26229979	.	A	G	11	14	25	0	4	29	0	0
7	26245668	.	T	C	11	13	24	0	3	27	0	0
7	26245714	.	A	T	9	17	26	0	1	27	0	0
7	26263153	.	C	T	6	8	14	0	1	15	0	0
7	26265917	.	T	C	1	3	4	0	0	4	0	0
7	26265961	.	G	A	4	2	6	0	1	7	0	0
7	26266069	.	G	C	3	7	10	0	0	10	0	0
7	26300184	.	A	G	2	2	4	0	1	5	0	0
7	26300263	.	A	G	8	5	13	0	0	13	0	0
7	26300359	.	A	G	4	7	11	0	1	12	0	0
7	26366620	.	T	C	8	7	15	0	0	15	0	0
7	26366684	.	C	T	6	10	16	0	0	16	0	0
7	26366778	.	G	A	13	10	23	0	0	23	0	0
7	26366919	.	G	A	9	6	15	0	0	15	0	0
7	26367280	.	C	T	0	8	8	0	7	15	0	0
7	26367315	.	T	C	4	4	8	0	0	8	0	0
7	26367328	.	T	A	4	1	5	0	1	6	0	0
7	26367364	.	T	G	3	2	5	0	0	5	0	0
7	26367470	.	C	G	7	3	10	0	0	10	0	0
7	26367486	.	A	C	6	3	9	0	0	9	0	0
7	26367525	.	A	G	2	5	7	0	1	8	0	0
7	26367797	.	T	C	2	3	5	0	1	6	0	0
7	26367944	.	G	A	4	5	9	0	1	10	0	0
7	26368080	.	T	A	5	5	10	0	1	11	0	0
7	26368240	.	C	A	10	6	16	0	1	17	0	0
7	26368291	.	A	C	6	7	13	0	1	14	0	0
7	26368333	.	A	T	3	7	10	0	0	10	0	0
7	26368549	.	A	G	5	3	8	0	1	9	0	0
7	26368719	.	C	A	4	3	7	0	0	7	0	0
7	26368836	.	A	T	5	3	8	0	1	9	0	0
7	26368955	.	G	T	4	6	10	0	1	11	0	0
7	26371702	.	G	A	1	3	4	0	0	4	0	0
7	26371711	.	G	A	1	2	3	0	1	4	0	0
7	26378224	.	G	A	2	3	5	0	0	5	0	0
7	26393903	.	T	C	2	1	3	0	3	6	0	0
7	26394208	.	A	T	16	17	33	0	5	38	0	0
7	26394285	.	A	T	18	8	26	0	2	28	0	0
7	26394382	.	C	T	0	26	26	0	11	37	0	0
7	26394476	.	G	A	18	21	39	0	0	39	0	0
7	26394791	.	A	G	19	14	33	0	5	38	0	0
7	26394848	.	G	A	14	11	25	0	1	26	0	0
7	26394951	.	T	A	5	8	13	0	2	15	0	0
7	26395215	.	C	G	1	1	2	0	1	3	0	0
7	26395538	.	T	C	11	10	21	0	0	21	0	0
7	26395625	.	T	A	3	6	9	0	0	9	0	0
7	26395778	.	T	G	7	6	13	0	0	13	0	0
7	26396170	.	G	A	6	9	15	0	1	16	0	0
7	26396560	.	C	G	3	2	5	0	0	5	0	0
7	26396768	.	G	A	11	10	21	0	1	22	0	0
7	26396915	.	A	C	1	4	5	0	1	6	0	0
7	26396975	.	A	G	2	4	6	0	0	6	0	0
7	26397003	.	T	G	2	3	5	0	1	6	0	0
7	26397541	.	G	A	4	9	13	0	0	13	0	0
7	26397760	.	C	T	8	4	12	0	1	13	0	0
7	26398159	.	A	T	3	4	7	0	0	7	0	0
7	26398351	.	A	G	4	5	9	0	2	11	0	0
7	26398867	.	G	A	6	3	9	0	0	9	0	0
7	26402680	.	C	A	2	2	4	0	1	5	0	0
7	26402788	.	T	G	2	2	4	0	0	4	0	0
7	26469820	.	G	A	0	1	1	0	3	4	0	0
7	26472340	.	A	C	3	11	14	0	1	15	0	0
7	26472346	.	A	T	4	10	14	0	0	14	0	0
7	26472398	.	C	T	4	6	10	0	0	10	0	0
7	26472413	.	A	G	4	8	12	0	0	12	0	0
7	26472512	.	G	T	3	5	8	0	0	8	0	0
7	26472971	.	C	G	5	7	12	0	0	12	0	0
7	26473163	.	G	A	1	4	5	0	0	5	0	0
7	26511439	.	A	T	20	15	35	0	3	38	0	0
7	26511691	.	G	A	27	21	48	0	1	49	0	0
7	26511760	.	A	G	25	21	46	0	2	48	0	0
7	26511801	.	T	G	20	17	37	0	4	41	0	0
7	26519052	.	A	G	8	4	12	0	0	12	0	0
7	26519150	.	A	T	15	14	29	0	1	30	0	0
7	26522358	.	T	C	9	2	11	0	2	13	0	0
7	26522364	.	C	T	9	2	11	0	1	12	0	0
7	27451551	.	A	T	2	2	4	0	0	4	0	0
7	27681025	.	G	T	6	7	13	0	2	15	0	0
7	27681071	.	A	T	2	9	11	0	0	11	0	0
7	27682919	.	C	T	6	10	16	0	0	16	0	0
7	27700517	.	G	A	9	13	22	0	0	22	0	0
7	27700777	.	C	T	0	12	12	0	16	28	0	0
7	27701155	.	C	G	0	6	6	0	7	13	0	0
7	27701231	.	T	A	6	9	15	0	0	15	0	0
7	27701348	.	A	C	5	6	11	0	1	12	0	0
7	27701431	.	T	A	3	2	5	0	1	6	0	0
7	27701561	.	A	T	7	9	16	0	0	16	0	0
7	27701623	.	C	A	7	7	14	0	0	14	0	0
7	27701634	.	A	G	5	5	10	0	0	10	0	0
7	27702003	.	A	C	3	3	6	0	0	6	0	0
7	27702934	.	G	A	7	10	17	0	0	17	0	0
7	27702998	.	T	A	2	9	11	0	0	11	0	0
7	27703102	.	T	C	3	0	3	0	0	3	0	0
7	27705837	.	G	A	3	4	7	0	0	7	0	0
7	27718258	.	C	G	0	1	1	0	0	1	0	0
7	27720520	.	A	G	2	0	2	0	0	2	0	0
7	27722534	.	A	G	1	2	3	0	1	4	0	0
7	27724920	.	T	G	1	2	3	0	0	3	0	0
7	27805487	.	A	G	1	2	3	0	0	3	0	0
7	27811770	.	C	T	5	6	11	0	2	13	0	0
7	27813749	.	C	T	0	4	4	0	0	4	0	0
7	27813942	.	G	A	9	4	13	0	2	15	0	0
7	27814326	.	C	T	8	13	21	0	3	24	0	0
7	27816668	.	T	C	3	10	13	0	0	13	0	0
7	27816875	.	C	T	10	10	20	0	0	20	0	0
7	27817229	.	C	A	9	4	13	0	0	13	0	0
7	27817755	.	G	C	3	4	7	0	0	7	0	0
7	27820177	.	G	A	7	4	11	0	1	12	0	0
7	27834170	.	A	G	1	3	4	0	0	4	0	0
7	27884185	.	A	G	3	2	5	0	0	5	0	0
7	27884211	.	A	G	5	2	7	0	0	7	0	0
7	27884979	.	G	T	1	2	3	0	0	3	0	0
7	27885000	.	T	C	2	2	4	0	0	4	0	0
7	27885043	.	C	T	2	2	4	0	0	4	0	0
7	27885160	.	A	G	4	2	6	0	1	7	0	0
7	27885703	.	A	T	5	4	9	0	1	10	0	0
7	27885706	.	C	T	5	6	11	0	0	11	0	0
7	27885941	.	G	A	5	6	11	0	1	12	0	0
7	27886502	.	A	T	1	3	4	0	0	4	0	0
7	27886508	.	A	T	1	2	3	0	1	4	0	0
7	27886602	.	C	A	9	3	12	0	0	12	0	0
7	27886923	.	A	G	8	8	16	0	1	17	0	0
7	27886924	.	A	G	9	7	16	0	1	17	0	0
7	27977061	.	C	T	0	2	2	0	0	2	0	0
7	27977083	.	G	A	0	1	1	0	0	1	0	0
7	28033649	.	G	A	0	0	0	0	1	1	0	0
7	28039990	.	G	A	0	2	2	0	1	3	0	0
7	28040014	.	G	T	0	2	2	0	2	4	0	0
7	28041496	.	T	C	3	2	5	0	0	5	0	0
7	28041538	.	T	C	1	3	4	0	0	4	0	0
7	28041736	.	A	G	2	2	4	0	0	4	0	0
7	28042027	.	G	A	3	3	6	0	0	6	0	0
7	28042664	.	G	A	1	2	3	0	0	3	0	0
7	28042732	.	G	A	3	1	4	0	1	5	0	0
7	28042740	.	G	A	2	4	6	0	0	6	0	0
7	28042909	.	C	T	0	6	6	0	0	6	0	0
7	28043076	.	T	C	2	2	4	0	0	4	0	0
7	28043077	.	T	C	2	2	4	0	0	4	0	0
7	28043173	.	T	G	3	2	5	0	1	6	0	0
7	28043184	.	A	G	2	1	3	0	6	9	0	0
7	28043284	.	A	G	4	3	7	0	1	8	0	0
7	28043416	.	A	G	3	3	6	0	0	6	0	0
7	28043837	.	T	G	3	0	3	0	3	6	0	0
7	28044193	.	A	G	11	6	17	0	0	17	0	0
7	28044339	.	A	G	1	4	5	0	1	6	0	0
7	28044639	.	A	G	3	5	8	0	0	8	0	0
7	28045160	.	G	A	0	5	5	0	5	10	0	0
7	28045263	.	C	G	8	7	15	1	0	16	0	0
7	28045404	.	A	C	6	5	11	1	0	12	0	0
7	28045444	.	T	A	9	10	19	0	0	19	0	0
7	28045571	.	T	C	7	4	11	1	0	12	0	0
7	28045600	.	C	T	7	13	20	1	1	22	0	0
7	28045685	.	C	T	7	2	9	0	0	9	0	0
7	28046436	.	T	C	2	5	7	0	0	7	0	0
7	28046530	.	A	G	8	10	18	0	1	19	0	0
7	28046572	.	T	C	13	8	21	0	0	21	0	0
7	28046580	.	A	G	5	16	21	0	2	23	0	0
7	28046718	.	G	A	9	2	11	0	0	11	0	0
7	28046723	.	G	A	9	3	12	0	0	12	0	0
7	28046918	.	A	C	0	7	7	0	0	7	0	0
7	28047004	.	G	A	14	5	19	0	1	20	0	0
7	28047072	.	C	T	5	7	12	0	2	14	0	0
7	28047163	.	C	T	7	3	10	0	0	10	0	0
7	28147806	.	T	A	19	12	31	0	1	32	0	0
7	28406477	.	G	A	2	3	5	0	0	5	0	0
7	28406514	.	G	A	1	5	6	0	0	6	0	0
7	28407339	.	A	G	4	3	7	0	1	8	0	0
7	28407437	.	A	G	1	2	3	0	0	3	0	0
7	28424095	.	G	A	0	2	2	0	0	2	0	0
7	28424237	.	C	G	10	4	14	0	1	15	0	0
7	28424381	.	A	T	12	10	22	0	0	22	0	0
7	28430010	.	G	A	3	3	6	0	0	6	0	0
7	28430127	.	C	A	2	4	6	0	0	6	0	0
7	28430430	.	C	T	6	9	15	0	0	15	0	0
7	28430454	.	C	A	4	5	9	0	1	10	0	0
7	28430503	.	G	A	4	4	8	0	0	8	0	0
7	28430528	.	G	T	4	3	7	0	0	7	0	0
7	28434034	.	A	T	1	1	2	0	0	2	0	0
7	28436486	.	G	C	6	5	11	0	0	11	0	0
7	28442009	.	G	C	8	7	15	0	1	16	0	0
7	28465338	.	G	A	11	8	19	0	1	20	0	0
7	28467182	.	A	G	5	7	12	0	2	14	0	0
7	28559907	.	G	A	10	15	25	0	0	25	0	0
7	28559969	.	G	T	6	13	19	0	0	19	0	0
7	28560250	.	G	C	15	13	28	0	1	29	0	0
7	28560256	.	G	A	14	14	28	0	1	29	0	0
7	28560467	.	C	G	14	18	32	0	1	34	1	0
7	28562196	.	A	G	11	4	15	0	0	15	0	0
7	28612726	.	T	C	11	12	23	0	0	23	0	0
7	28612899	.	G	A	0	12	12	0	4	16	0	0
7	28612929	.	A	G	4	13	17	0	0	17	0	0
7	28612962	.	G	A	6	1	7	0	1	8	0	0
7	28615709	.	T	C	7	2	9	0	0	9	0	0
7	28615850	.	G	A	11	13	24	0	3	27	0	0
7	28615922	.	A	G	7	0	7	0	12	19	0	0
7	28618813	.	C	T	3	4	7	1	1	9	0	0
7	28622856	.	G	A	16	19	35	0	7	42	0	0
7	28622970	.	T	C	26	13	39	0	4	43	0	0
7	28623456	.	G	A	4	5	9	0	0	9	0	0
7	28623506	.	T	A	2	4	6	0	1	7	0	0
7	28623533	.	A	T	2	3	5	0	1	6	0	0
7	28623748	.	A	T	0	2	2	0	1	3	0	0
7	28623779	.	A	C	4	0	4	0	0	4	0	0
7	28623803	.	G	A	5	2	7	0	0	7	0	0
7	28623823	.	G	T	6	5	11	0	0	11	0	0
7	28623860	.	A	G	5	8	13	0	1	14	0	0
7	28623863	.	A	G	5	8	13	0	1	14	0	0
7	28624106	.	A	T	8	1	9	0	0	9	0	0
7	28624157	.	C	G	3	6	9	0	2	11	0	0
7	28624688	.	A	T	9	6	15	0	0	15	0	0
7	28624692	.	T	C	5	8	13	0	1	14	0	0
7	28624897	.	T	C	2	8	10	0	0	10	0	0
7	28624934	.	T	A	2	6	8	0	0	8	0	0
7	28625080	.	G	T	1	2	3	0	1	4	0	0
7	28625219	.	C	A	2	2	4	0	0	4	0	0
7	28625792	.	C	T	0	2	2	0	1	3	0	0
7	28625831	.	A	G	1	2	3	0	0	3	0	0
7	28626098	.	G	A	0	1	1	0	0	1	0	0
7	29051856	.	A	G	7	4	11	0	1	12	0	0
7	29080302	.	C	T	0	3	3	0	1	4	0	0
7	29109604	.	A	G	6	3	9	0	0	9	0	0
7	29944935	.	A	T	0	7	7	0	0	7	0	0
7	29969704	.	A	G	7	4	11	0	0	11	0	0
7	30086732	.	T	C	0	8	8	0	0	8	0	0
7	30770628	.	A	T	5	2	7	0	2	9	0	0
7	32743231	.	A	G	2	2	4	0	0	4	0	0
7	32746213	.	A	G	14	8	22	0	1	23	0	0
7	32747956	.	A	G	8	1	9	0	14	23	0	0
7	32747973	.	A	G	8	19	27	0	1	28	0	0
7	32748203	.	A	G	17	7	24	0	3	27	0	0
7	32815268	.	T	C	5	0	5	0	10	15	0	0
7	32835573	.	T	A	1	3	4	0	0	4	0	0
7	33442228	.	C	T	3	0	3	0	1	4	0	0
7	34105791	.	T	C	2	2	4	0	0	4	0	0
7	34105793	.	T	C	2	2	4	0	0	4	0	0
7	34314696	.	A	G	1	0	1	0	2	3	0	0
7	34314701	.	A	G	1	0	1	0	2	3	0	0
7	35283238	.	T	A	3	2	5	0	1	6	0	0
7	36619056	.	T	A	0	3	3	0	0	4	1	0
7	38392031	.	C	T	4	2	6	0	0	6	0	0
7	38392422	.	A	C	3	2	5	0	1	6	0	0
7	38392424	.	C	T	3	2	5	0	1	6	0	0
7	38456516	.	C	A	4	4	8	0	0	8	0	0
7	38456517	.	C	T	4	4	8	0	0	8	0	0
7	38456699	.	T	C	3	6	9	0	1	10	0	0
7	38476911	.	T	A	2	2	4	0	0	4	0	0
7	38476976	.	C	T	3	2	5	0	0	5	0	0
7	38477196	.	C	T	1	2	3	0	0	3	0	0
7	38529899	.	C	T	1	3	4	0	0	4	0	0
7	38532382	.	A	C	0	2	2	0	0	2	0	0
7	38532390	.	G	A	0	2	2	0	0	2	0	0
7	38532832	.	C	T	3	2	5	0	0	5	0	0
7	38532833	.	C	T	3	2	5	0	0	5	0	0
7	38532888	.	G	A	2	2	4	0	0	4	0	0
7	38533013	.	T	C	3	2	5	0	0	5	0	0
7	38533048	.	C	A	1	2	3	0	0	3	0	0
7	38533225	.	G	T	3	3	6	0	0	6	0	0
7	38533250	.	C	G	5	2	7	0	0	7	0	0
7	38533275	.	A	G	5	1	6	0	0	6	0	0
7	38533683	.	A	T	4	2	6	0	1	7	0	0
7	38536370	.	C	T	17	19	36	0	2	38	0	0
7	38536416	.	C	T	22	16	38	0	1	39	0	0
7	38536697	.	A	G	23	12	35	0	1	36	0	0
7	38536703	.	A	T	21	14	35	0	1	36	0	0
7	38536889	.	G	T	18	13	31	0	0	31	0	0
7	38537085	.	T	A	12	9	21	0	4	25	0	0
7	38537345	.	C	T	14	15	29	0	0	29	0	0
7	38537657	.	C	T	5	10	15	0	1	16	0	0
7	38539554	.	A	G	6	5	11	0	0	11	0	0
7	38539577	.	A	G	5	4	9	0	0	9	0	0
7	38539643	.	C	A	2	3	5	0	0	5	0	0
7	38539730	.	G	A	3	3	6	0	0	6	0	0
7	38539768	.	T	A	2	3	5	0	1	6	0	0
7	38539992	.	G	A	5	7	12	0	0	12	0	0
7	38540134	.	G	A	9	5	14	0	0	14	0	0
7	38544706	.	A	G	1	3	4	0	0	4	0	0
7	38578128	.	T	C	2	3	5	0	0	5	0	0
7	38578140	.	T	C	0	2	2	0	1	3	0	0
7	38594474	.	A	C	14	17	31	0	1	32	0	0
7	38594510	.	G	C	12	15	27	0	2	29	0	0
7	38600226	.	A	G	22	18	40	0	0	40	0	0
7	38600265	.	T	C	22	21	43	0	4	47	0	0
7	38600483	.	A	G	12	17	29	0	3	32	0	0
7	38600519	.	A	C	16	7	23	0	3	26	0	0
7	38600531	.	G	A	14	4	18	0	6	24	0	0
7	38600585	.	C	T	1	18	19	0	23	42	0	0
7	38600892	.	G	A	15	13	28	0	1	29	0	0
7	38600982	.	G	A	33	25	58	0	2	60	0	0
7	38601025	.	G	T	36	19	55	0	3	58	0	0
7	38601067	.	G	T	29	21	50	0	5	55	0	0
7	38601156	.	G	T	24	8	32	0	2	34	0	0
7	38601374	.	C	T	22	34	56	0	2	58	0	0
7	38601391	.	T	A	21	36	57	0	5	62	0	0
7	38601417	.	A	C	25	31	56	0	1	57	0	0
7	38601625	.	C	A	19	16	35	0	3	38	0	0
7	38601646	.	G	A	17	29	46	0	0	46	0	0
7	38601751	.	T	C	32	16	48	0	3	52	1	0
7	38601759	.	C	G	38	11	49	0	7	56	0	0
7	38601823	.	C	A	1	15	16	0	30	46	0	0
7	38601909	.	C	T	0	12	12	0	17	29	0	0
7	38602123	.	C	T	22	23	45	0	4	49	0	0
7	38602160	.	A	T	23	27	50	0	0	50	0	0
7	38602623	.	T	C	18	20	38	0	4	42	0	0
7	38602656	.	G	A	15	17	32	0	4	36	0	0
7	38602917	.	A	T	24	21	45	0	2	47	0	0
7	38612100	.	A	G	0	2	2	0	1	3	0	0
7	38612109	.	G	A	2	4	6	0	1	7	0	0
7	38642870	.	A	G	1	2	3	0	0	3	0	0
7	38671782	.	T	C	0	1	1	0	1	2	0	0
7	38674189	.	T	C	0	0	0	0	1	1	0	0
7	38677497	.	T	C	13	17	30	0	3	33	0	0
7	38677880	.	G	T	19	13	32	0	2	34	0	0
7	38677999	.	A	T	11	12	23	0	0	23	0	0
7	38681322	.	C	T	2	0	2	0	0	2	0	0
7	38683834	.	T	C	6	2	8	0	2	10	0	0
7	38684830	.	C	T	11	14	25	0	2	27	0	0
7	38684970	.	C	T	15	24	39	0	2	41	0	0
7	38686849	.	T	C	1	2	3	0	0	3	0	0
7	38687152	.	G	A	1	2	3	0	0	3	0	0
7	38689701	.	G	A	0	6	6	0	4	10	0	0
7	38689898	.	G	A	2	1	3	0	0	3	0	0
7	38696163	.	A	G	34	32	66	0	4	70	0	0
7	38703509	.	C	T	0	4	4	0	5	9	0	0
7	38703598	.	C	T	2	7	9	0	0	9	0	0
7	38703962	.	G	T	9	5	14	0	0	14	0	0
7	38703964	.	A	T	9	5	14	0	0	14	0	0
7	38704006	.	G	A	8	5	13	0	0	13	0	0
7	38704009	.	G	A	8	5	13	0	0	13	0	0
7	38704055	.	T	C	6	3	9	0	1	10	0	0
7	38704125	.	T	C	7	2	9	0	0	9	0	0
7	38704622	.	C	A	4	3	7	0	0	7	0	0
7	38704623	.	T	C	4	0	4	0	3	7	0	0
7	38704754	.	C	T	3	2	5	0	0	5	0	0
7	38705012	.	A	T	3	3	6	0	0	6	0	0
7	38705367	.	C	G	0	6	6	0	7	13	0	0
7	38705643	.	A	G	2	3	5	0	2	7	0	0
7	38709326	.	G	T	3	4	7	0	1	8	0	0
7	38714503	.	A	T	0	2	2	0	0	2	0	0
7	38726646	.	A	G	7	15	22	0	0	22	0	0
7	38734152	.	G	A	0	8	8	0	4	12	0	0
7	38734276	.	T	G	11	4	15	0	1	16	0	0
7	38734431	.	C	A	14	7	21	0	0	21	0	0
7	38734475	.	A	C	14	9	23	0	2	25	0	0
7	38734527	.	T	C	10	13	23	0	3	26	0	0
7	38734573	.	A	G	7	11	18	0	2	20	0	0
7	38734626	.	G	T	7	17	24	0	0	24	0	0
7	38735363	.	A	G	14	17	31	0	1	32	0	0
7	38735406	.	C	T	18	17	35	0	0	35	0	0
7	38735460	.	G	T	19	16	35	0	1	37	1	0
7	38735465	.	A	C	20	15	35	0	2	37	0	0
7	38735501	.	T	C	10	9	19	0	1	20	0	0
7	38735711	.	G	A	14	7	21	0	0	21	0	0
7	38735727	.	A	T	11	9	20	0	2	23	1	0
7	38735827	.	A	C	7	7	14	0	3	17	0	0
7	38736320	.	G	C	28	14	42	0	1	43	0	0
7	38736526	.	C	T	15	7	22	0	2	24	0	0
7	38736818	.	C	A	2	5	7	0	0	7	0	0
7	38736819	.	A	G	2	5	7	0	0	7	0	0
7	38736912	.	T	C	1	4	5	0	0	5	0	0
7	38737020	.	T	C	6	13	19	0	2	21	0	0
7	38737170	.	C	T	13	7	20	0	2	22	0	0
7	38737224	.	C	T	9	3	12	0	1	13	0	0
7	38737286	.	C	T	11	6	17	0	5	22	0	0
7	38773039	.	C	T	1	0	1	0	0	1	0	0
7	38775075	.	A	G	1	2	3	0	0	3	0	0
7	38775078	.	C	T	0	3	3	0	1	4	0	0
7	38777082	.	C	T	4	2	6	0	0	6	0	0
7	38783439	.	C	T	13	17	30	0	2	32	0	0
7	38783644	.	A	G	10	22	32	0	4	36	0	0
7	38783742	.	G	A	23	9	32	0	4	36	0	0
7	38783972	.	T	C	10	5	15	0	1	16	0	0
7	38784648	.	A	G	31	23	54	0	2	56	0	0
7	38784766	.	C	A	25	19	44	0	0	44	0	0
7	38784786	.	T	A	17	28	45	0	2	47	0	0
7	38784818	.	G	A	35	12	47	0	3	50	0	0
7	38784976	.	T	A	19	24	43	0	0	43	0	0
7	38785069	.	C	T	14	21	35	0	1	37	1	0
7	38785182	.	G	C	2	20	22	0	23	45	0	0
7	38785224	.	G	A	2	21	23	0	19	42	0	0
7	38794090	.	T	G	14	15	29	0	2	31	0	0
7	38794235	.	C	T	20	7	27	0	1	28	0	0
7	38798630	.	A	G	4	1	5	0	0	5	0	0
7	38805508	.	T	G	0	1	1	0	0	1	0	0
7	38807677	.	T	G	2	1	3	0	0	3	0	0
7	38807714	.	G	A	5	3	8	0	0	8	0	0
7	38807723	.	A	T	5	3	8	0	0	8	0	0
7	38809865	.	G	T	0	2	2	0	5	7	0	0
7	38810084	.	A	C	1	3	4	0	0	4	0	0
7	38820388	.	A	T	1	2	3	0	1	4	0	0
7	38820889	.	G	A	1	2	3	0	0	3	0	0
7	38822327	.	C	T	7	5	12	0	0	12	0	0
7	38822368	.	A	T	7	6	13	0	0	13	0	0
7	38822523	.	G	A	3	5	8	0	2	10	0	0
7	38822528	.	C	A	0	6	6	0	4	10	0	0
7	38822559	.	C	T	0	5	5	0	5	10	0	0
7	38822825	.	T	C	3	2	5	0	0	5	0	0
7	38824259	.	G	A	6	4	10	0	2	12	0	0
7	38824972	.	G	A	0	2	2	0	0	2	0	0
7	38950644	.	G	A	0	2	2	0	1	3	0	0
7	38954102	.	T	C	2	3	5	0	0	5	0	0
7	38954657	.	T	C	1	6	7	0	1	8	0	0
7	39123095	.	G	A	0	3	3	0	0	3	0	0
7	39153769	.	C	A	2	3	5	0	0	5	0	0
7	39153849	.	G	A	0	3	3	0	1	4	0	0
7	39153975	.	G	A	3	4	7	0	1	8	0	0
7	39154119	.	C	T	2	5	7	0	1	8	0	0
7	39154181	.	A	T	3	4	7	0	2	9	0	0
7	39154971	.	C	T	2	2	4	0	0	4	0	0
7	39155344	.	G	A	3	3	6	0	0	6	0	0
7	39155758	.	T	G	1	2	3	0	0	3	0	0
7	39155940	.	T	A	2	5	7	0	0	7	0	0
7	39156140	.	T	C	8	7	15	0	1	16	0	0
7	39156161	.	C	T	6	10	16	0	1	17	0	0
7	39156207	.	T	C	6	7	13	0	3	16	0	0
7	39156474	.	T	C	9	12	21	0	2	23	0	0
7	39156553	.	C	A	9	6	15	0	4	19	0	0
7	39156673	.	A	T	6	1	7	0	2	9	0	0
7	39156760	.	A	G	7	12	19	0	4	23	0	0
7	39157175	.	A	T	12	10	22	0	2	24	0	0
7	39157219	.	G	A	0	13	13	0	13	26	0	0
7	39157239	.	C	A	13	11	24	0	1	25	0	0
7	39174052	.	T	C	3	4	7	0	0	7	0	0
7	39174452	.	G	A	0	15	15	0	7	22	0	0
7	39176261	.	G	A	0	8	8	0	10	18	0	0
7	39176444	.	G	A	0	9	9	0	24	33	0	0
7	39176447	.	A	C	21	10	31	0	1	32	0	0
7	39176739	.	A	T	6	9	15	0	5	20	0	0
7	39176863	.	G	A	9	26	35	0	1	36	0	0
7	39176881	.	G	A	23	11	34	0	0	34	0	0
7	39176940	.	A	G	5	9	14	0	1	15	0	0
7	39176957	.	A	G	2	7	9	0	1	10	0	0
7	39176983	.	T	C	3	6	9	0	2	11	0	0
7	39177729	.	A	G	9	12	21	0	1	22	0	0
7	39177871	.	C	A	2	8	10	0	0	10	0	0
7	39178065	.	A	G	1	6	7	0	2	9	0	0
7	39181275	.	A	G	11	9	20	0	2	22	0	0
7	39181318	.	C	T	21	11	32	0	0	32	0	0
7	39181597	.	C	A	13	7	20	0	2	22	0	0
7	39181853	.	C	A	2	7	9	0	0	9	0	0
7	39182265	.	T	C	7	6	13	0	1	14	0	0
7	39182433	.	T	C	5	7	12	0	2	14	0	0
7	39182910	.	G	A	4	5	9	0	1	10	0	0
7	39183045	.	A	G	2	3	5	0	0	5	0	0
7	39256023	.	C	T	2	2	4	0	0	4	0	0
7	39256029	.	T	C	1	0	1	0	2	3	0	0
7	39256302	.	A	C	2	2	4	0	0	4	0	0
7	39256303	.	C	A	2	2	4	0	0	4	0	0
7	39460201	.	T	A	2	3	5	0	0	5	0	0
7	39537921	.	A	T	2	4	6	0	0	6	0	0
7	39537983	.	C	G	3	5	8	0	0	8	0	0
7	39541293	.	T	G	1	2	3	0	0	3	0	0
7	39541452	.	A	C	0	4	4	0	0	4	0	0
7	39552270	.	G	T	2	3	5	0	1	6	0	0
7	39642671	.	G	A	0	2	2	0	2	4	0	0
7	39643001	.	G	A	0	1	1	0	0	1	0	0
7	39654722	.	C	T	1	5	6	0	0	6	0	0
7	39655524	.	T	A	2	2	4	0	0	4	0	0
7	39657891	.	A	G	1	2	3	0	0	3	0	0
7	39658356	.	T	C	2	3	5	0	0	5	0	0
7	39658445	.	C	A	4	3	7	0	0	8	1	0
7	39658730	.	G	T	0	9	9	0	14	23	0	0
7	39658831	.	T	G	10	12	22	0	1	23	0	0
7	39659275	.	A	C	3	5	8	0	0	8	0	0
7	39659400	.	T	A	4	2	6	0	0	6	0	0
7	39659607	.	A	C	0	2	2	0	1	3	0	0
7	39659608	.	A	T	1	2	3	0	0	3	0	0
7	39659758	.	C	A	0	1	1	0	0	1	0	0
7	39659806	.	G	A	5	4	9	0	0	9	0	0
7	39659973	.	A	G	4	3	7	0	1	8	0	0
7	39660054	.	A	C	2	4	6	0	0	6	0	0
7	39660201	.	G	A	11	10	21	0	4	25	0	0
7	39660249	.	A	C	15	21	36	0	0	36	0	0
7	39670892	.	G	C	2	4	6	0	0	6	0	0
7	39671281	.	G	A	2	9	11	0	0	11	0	0
7	39671647	.	C	T	3	4	7	0	1	8	0	0
7	39671715	.	A	C	2	4	6	0	0	6	0	0
7	39672054	.	A	T	3	6	9	0	0	9	0	0
7	39672165	.	G	A	2	2	4	0	0	4	0	0
7	39672741	.	A	G	3	7	10	0	2	12	0	0
7	39673095	.	A	G	6	0	6	0	10	16	0	0
7	39673773	.	G	C	0	6	6	0	6	12	0	0
7	39675838	.	A	G	5	6	11	0	0	11	0	0
7	39676183	.	T	A	6	9	15	0	0	15	0	0
7	39676446	.	A	T	5	7	12	0	1	13	0	0
7	39676518	.	A	G	6	8	14	0	0	14	0	0
7	39676833	.	T	C	6	7	13	0	0	13	0	0
7	39676947	.	T	G	7	7	14	0	3	17	0	0
7	39676948	.	T	G	10	4	14	0	3	17	0	0
7	39677257	.	A	T	0	5	5	0	0	5	0	0
7	39677347	.	G	A	8	10	18	0	1	19	0	0
7	39677948	.	G	T	8	18	26	0	0	26	0	0
7	39693686	.	T	C	0	0	0	0	2	2	0	0
7	39695776	.	A	C	0	1	1	0	0	1	0	0
7	39701913	.	A	C	4	2	6	0	2	8	0	0
7	39702256	.	A	T	0	1	1	0	2	3	0	0
7	39702800	.	C	T	2	2	4	0	0	4	0	0
7	39702827	.	C	T	3	2	5	0	0	5	0	0
7	39704085	.	A	G	1	4	5	0	0	5	0	0
7	39704166	.	A	T	7	4	11	0	1	12	0	0
7	39705601	.	A	G	7	4	11	0	0	11	0	0
7	39705683	.	T	A	10	0	10	0	0	10	0	0
7	39738122	.	T	C	1	2	3	0	0	3	0	0
7	39742574	.	G	T	1	3	4	0	0	4	0	0
7	39742820	.	T	G	3	6	9	0	0	9	0	0
7	39742841	.	A	T	6	5	11	0	0	11	0	0
7	39743126	.	G	A	2	2	4	0	1	5	0	0
7	39744543	.	G	A	3	6	9	0	0	9	0	0
7	39745091	.	T	C	1	4	5	0	0	5	0	0
7	39748847	.	T	C	2	0	2	0	0	2	0	0
7	39748934	.	A	C	5	7	12	0	0	12	0	0
7	40050986	.	G	C	0	1	1	0	0	1	0	0
7	40053306	.	G	A	0	1	1	0	0	1	0	0
7	40053490	.	T	C	3	4	7	0	0	7	0	0
7	40053537	.	C	T	2	2	4	0	0	4	0	0
7	40053717	.	T	A	4	3	7	0	1	8	0	0
7	40053720	.	G	A	4	4	8	0	0	8	0	0
7	40054052	.	C	T	0	3	3	0	0	3	0	0
7	40054814	.	C	T	2	3	5	0	1	6	0	0
7	40054901	.	G	T	2	6	8	0	0	8	0	0
7	40054925	.	G	T	0	3	3	0	4	7	0	0
7	40055080	.	T	C	4	11	15	0	4	19	0	0
7	40055178	.	C	G	2	7	9	0	0	9	0	0
7	40055219	.	A	T	3	2	5	0	0	5	0	0
7	40055353	.	A	G	4	1	5	0	4	9	0	0
7	40055504	.	A	G	0	0	0	0	7	7	0	0
7	40055612	.	C	T	2	5	7	0	1	8	0	0
7	40055628	.	G	A	2	8	10	0	0	10	0	0
7	40055672	.	G	A	3	5	8	0	0	8	0	0
7	40055844	.	C	T	5	5	10	0	0	10	0	0
7	40055928	.	T	C	4	4	8	0	0	8	0	0
7	40055945	.	C	T	3	3	6	0	0	6	0	0
7	40056060	.	C	T	6	3	9	0	0	9	0	0
7	40056112	.	T	G	13	5	18	0	1	20	1	0
7	40056243	.	C	A	5	4	9	0	0	9	0	0
7	40056307	.	C	T	11	4	15	0	0	15	0	0
7	40056353	.	G	A	9	7	16	0	2	18	0	0
7	40056542	.	A	T	3	10	13	0	0	13	0	0
7	40056587	.	C	T	12	5	17	0	0	17	0	0
7	40056589	.	T	C	12	4	16	0	1	17	0	0
7	40056729	.	A	T	7	3	10	0	1	11	0	0
7	40056851	.	T	C	0	6	6	0	2	8	0	0
7	40056854	.	C	T	7	0	7	0	1	8	0	0
7	40056982	.	C	T	1	1	2	0	1	3	0	0
7	40057140	.	G	A	9	11	20	0	1	21	0	0
7	40057393	.	C	T	7	15	22	0	2	24	0	0
7	40057581	.	T	G	10	10	20	0	0	20	0	0
7	40057674	.	A	G	6	6	12	0	0	12	0	0
7	40059207	.	G	A	7	6	13	0	1	14	0	0
7	40059248	.	T	C	10	5	15	0	0	15	0	0
7	40060115	.	A	G	7	4	11	0	0	11	0	0
7	40070301	.	G	A	2	4	6	0	1	7	0	0
7	40070461	.	T	C	1	2	3	0	1	4	0	0
7	40070464	.	T	C	1	2	3	0	0	3	0	0
7	40070531	.	C	G	1	2	3	0	0	3	0	0
7	40070567	.	A	C	1	2	3	0	0	3	0	0
7	40071776	.	G	A	1	4	5	0	0	5	0	0
7	40072184	.	T	C	2	4	6	0	0	6	0	0
7	40076782	.	A	G	1	0	1	0	3	4	0	0
7	40081813	.	C	T	0	3	3	0	3	6	0	0
7	40083683	.	T	A	5	4	9	0	0	9	0	0
7	40083762	.	C	G	4	3	7	0	0	7	0	0
7	40083815	.	T	A	2	2	4	0	0	4	0	0
7	40084064	.	C	T	3	2	5	0	0	5	0	0
7	40084071	.	C	T	2	2	4	0	0	4	0	0
7	40090547	.	T	A	8	6	14	0	0	14	0	0
7	40090602	.	T	C	15	13	28	0	2	30	0	0
7	40091332	.	C	A	7	4	11	0	0	11	0	0
7	40091460	.	C	T	6	5	11	0	2	13	0	0
7	40091510	.	G	T	2	1	3	0	1	4	0	0
7	40091552	.	A	T	3	2	5	0	3	8	0	0
7	40091622	.	C	G	9	5	14	0	2	16	0	0
7	40091718	.	G	A	17	11	28	0	1	29	0	0
7	40091749	.	T	C	18	9	27	0	1	28	0	0
7	40091818	.	T	G	13	5	18	0	1	19	0	0
7	40091951	.	A	T	4	2	6	0	2	8	0	0
7	40093771	.	C	T	1	2	3	0	0	3	0	0
7	40097105	.	A	C	2	1	3	0	1	4	0	0
7	40097271	.	C	G	3	3	6	0	0	6	0	0
7	40100294	.	C	T	4	3	7	0	0	7	0	0
7	40100306	.	T	C	3	3	6	0	0	6	0	0
7	40100357	.	C	T	2	3	5	0	0	5	0	0
7	40100976	.	C	T	1	3	4	0	0	4	0	0
7	40101067	.	G	T	1	3	4	0	0	4	0	0
7	40101174	.	T	C	1	3	4	0	0	4	0	0
7	40102406	.	A	G	1	2	3	0	0	3	0	0
7	40102418	.	T	G	1	3	4	0	0	4	0	0
7	40102457	.	C	A	2	3	5	0	0	5	0	0
7	40102481	.	A	T	2	3	5	0	0	5	0	0
7	40104296	.	T	C	2	0	2	0	0	2	0	0
7	40123112	.	T	A	1	2	3	0	0	3	0	0
7	40123113	.	A	G	1	2	3	0	0	3	0	0
7	40123342	.	T	C	4	4	8	0	0	8	0	0
7	40126615	.	T	C	2	2	4	0	0	4	0	0
7	40126829	.	C	T	0	2	2	0	0	2	0	0
7	40126845	.	C	A	0	0	0	0	1	1	0	0
7	40138794	.	C	T	1	0	1	0	1	2	0	0
7	40140399	.	T	C	0	2	2	0	0	2	0	0
7	40144195	.	C	T	1	5	6	0	0	6	0	0
7	40188991	.	C	T	2	3	5	0	0	5	0	0
7	40197623	.	C	A	1	1	2	0	1	3	0	0
7	40200740	.	G	A	2	2	4	0	0	4	0	0
7	40201016	.	C	T	2	1	3	0	1	4	0	0
7	40201108	.	G	T	5	7	12	0	0	12	0	0
7	40201200	.	G	A	1	3	4	0	1	5	0	0
7	40201296	.	C	T	1	2	3	0	1	4	0	0
7	40201975	.	A	G	8	8	16	0	1	17	0	0
7	40228499	.	A	T	3	4	7	0	0	7	0	0
7	40292834	.	T	C	1	0	1	0	0	1	0	0
7	40318309	.	T	A	2	3	5	0	1	6	0	0
7	40318580	.	G	T	3	2	5	0	0	5	0	0
7	40318593	.	G	A	1	2	3	0	0	3	0	0
7	40321174	.	C	T	6	6	12	0	0	12	0	0
7	40321224	.	A	G	5	6	11	0	1	12	0	0
7	40321273	.	G	T	9	11	20	0	0	20	0	0
7	40321443	.	C	T	2	3	5	0	1	6	0	0
7	40460256	.	T	C	5	1	6	0	2	8	0	0
7	40460371	.	C	T	8	11	19	0	1	20	0	0
7	40466026	.	A	G	11	12	23	0	2	25	0	0
7	40471301	.	A	G	7	6	13	0	1	14	0	0
7	40492740	.	T	A	1	2	3	0	0	3	0	0
7	40492764	.	G	C	0	2	2	0	0	2	0	0
7	40492789	.	T	C	0	2	2	0	0	2	0	0
7	40492800	.	G	T	0	2	2	0	0	2	0	0
7	40498598	.	G	A	18	32	50	0	3	53	0	0
7	40498934	.	C	A	28	21	49	0	2	51	0	0
7	40499177	.	A	C	7	9	16	0	1	17	0	0
7	40499182	.	A	G	6	10	16	0	0	16	0	0
7	40537936	.	A	C	2	2	4	0	0	4	0	0
7	40560398	.	C	T	2	3	5	0	0	5	0	0
7	40560934	.	G	A	10	15	25	0	2	27	0	0
7	40567075	.	T	C	1	2	3	0	0	3	0	0
7	40578658	.	C	G	5	4	9	0	0	9	0	0
7	40584065	.	A	C	7	8	15	0	2	17	0	0
7	40584121	.	A	C	9	19	28	0	3	31	0	0
7	40584148	.	T	C	9	0	9	0	19	28	0	0
7	40584308	.	A	G	10	7	17	0	0	17	0	0
7	40584321	.	T	A	12	7	19	0	0	19	0	0
7	40584395	.	G	C	18	7	25	0	0	25	0	0
7	40584415	.	G	C	18	9	27	0	1	28	0	0
7	40584469	.	C	T	7	11	18	0	0	18	0	0
7	40584988	.	A	C	9	5	14	0	0	14	0	0
7	40585546	.	A	T	4	5	9	0	0	9	0	0
7	40602439	.	G	A	2	2	4	0	0	4	0	0
7	40607911	.	T	A	0	2	2	0	1	3	0	0
7	40645217	.	A	G	0	2	2	0	0	2	0	0
7	40889981	.	C	T	3	3	6	0	0	6	0	0
7	40890410	.	A	G	3	4	7	0	0	7	0	0
7	40900772	.	G	A	9	7	16	0	1	17	0	0
7	40900785	.	C	A	0	11	11	0	8	19	0	0
7	40901126	.	A	T	3	3	6	0	0	6	0	0
7	40901425	.	T	A	0	1	1	0	3	4	0	0
7	40901436	.	G	A	2	2	4	0	1	5	0	0
7	40901621	.	T	G	0	4	4	0	0	4	0	0
7	40901628	.	A	G	2	3	5	0	0	5	0	0
7	40901945	.	T	C	6	7	13	0	0	13	0	0
7	40902042	.	T	C	3	3	6	0	1	7	0	0
7	40902205	.	G	A	1	5	6	0	1	7	0	0
7	40904630	.	T	A	2	2	4	0	0	4	0	0
7	40905164	.	A	T	0	2	2	0	0	2	0	0
7	40905695	.	A	T	15	8	23	0	3	26	0	0
7	40905774	.	C	T	0	9	9	0	12	21	0	0
7	40906286	.	T	C	3	6	9	0	1	10	0	0
7	40935308	.	C	T	1	3	4	0	0	4	0	0
7	40951391	.	G	A	1	1	2	0	0	2	0	0
7	40951535	.	A	T	1	3	4	0	0	4	0	0
7	40989156	.	A	G	6	5	11	0	0	11	0	0
7	40990473	.	G	C	4	7	11	0	0	11	0	0
7	40990589	.	T	A	1	2	3	0	0	3	0	0
7	40993298	.	G	A	1	4	5	0	0	5	0	0
7	41008618	.	T	C	11	11	22	0	2	24	0	0
7	41008856	.	C	T	0	13	13	0	17	30	0	0
7	41009217	.	C	T	0	9	9	0	10	19	0	0
7	41009797	.	T	A	19	11	30	0	1	31	0	0
7	41012081	.	A	T	1	2	3	0	0	3	0	0
7	41012505	.	C	T	0	2	2	0	4	6	0	0
7	41014175	.	C	T	2	2	4	0	0	4	0	0
7	41082391	.	T	G	6	4	10	0	0	10	0	0
7	41147792	.	A	G	0	0	0	0	3	3	0	0
7	41157531	.	G	C	4	30	34	0	1	35	0	0
7	41157735	.	T	C	24	9	33	0	2	35	0	0
7	41157805	.	C	A	16	20	36	0	2	38	0	0
7	41157997	.	G	A	20	6	26	0	0	26	0	0
7	41158057	.	C	T	17	12	29	0	5	34	0	0
7	41249282	.	A	G	1	1	2	0	0	2	0	0
7	41257549	.	G	T	1	2	3	0	1	4	0	0
7	41258015	.	T	C	1	3	4	0	2	6	0	0
7	41261343	.	C	A	2	5	7	0	0	7	0	0
7	41262058	.	T	G	2	0	2	0	0	2	0	0
7	41262277	.	A	G	12	5	17	0	1	19	1	0
7	41262361	.	G	A	2	3	5	0	0	5	0	0
7	41263277	.	G	A	0	6	6	0	6	12	0	0
7	41267424	.	C	T	1	1	2	0	1	3	0	0
7	41273527	.	T	C	6	8	14	0	1	15	0	0
7	41273889	.	T	C	6	7	13	0	0	13	0	0
7	41274080	.	T	G	6	12	18	0	1	19	0	0
7	41274258	.	T	C	8	12	20	0	2	22	0	0
7	41274261	.	A	G	8	0	8	0	13	21	0	0
7	41274802	.	C	A	22	8	30	0	5	35	0	0
7	41274896	.	A	C	8	13	21	0	4	25	0	0
7	41274916	.	A	C	9	15	24	0	3	27	0	0
7	41274943	.	T	A	10	17	27	0	2	29	0	0
7	41313894	.	G	C	2	2	4	0	0	4	0	0
7	41318020	.	A	G	0	2	2	0	1	3	0	0
7	41318023	.	A	T	0	3	3	0	0	3	0	0
7	41318087	.	A	T	2	5	7	0	0	7	0	0
7	41329674	.	T	G	3	2	5	0	0	5	0	0
7	41329683	.	A	G	2	2	4	0	1	5	0	0
7	41329736	.	C	T	0	4	4	0	0	4	0	0
7	41330106	.	A	T	1	3	4	0	0	4	0	0
7	41330167	.	G	C	2	2	4	0	0	4	0	0
7	41330198	.	G	A	1	2	3	0	2	5	0	0
7	41330210	.	T	A	4	2	6	0	1	7	0	0
7	41330747	.	A	C	0	1	1	0	2	3	0	0
7	41344440	.	T	A	0	1	1	0	1	2	0	0
7	41345105	.	C	T	2	2	4	0	0	4	0	0
7	41345123	.	C	T	1	2	3	0	1	4	0	0
7	41345282	.	A	C	3	4	7	0	1	8	0	0
7	41345828	.	G	T	6	2	8	0	0	8	0	0
7	41347123	.	A	G	1	1	2	0	1	3	0	0
7	41347138	.	C	T	1	3	4	0	0	4	0	0
7	41347642	.	T	C	6	3	9	0	0	9	0	0
7	41347813	.	C	T	6	3	9	0	1	10	0	0
7	41347897	.	C	T	2	4	6	0	1	7	0	0
7	41349454	.	G	T	4	6	10	0	0	10	0	0
7	41352145	.	T	A	2	2	4	0	0	4	0	0
7	41355308	.	T	C	4	3	7	0	2	9	0	0
7	41356140	.	T	C	1	0	1	0	0	1	0	0
7	41356547	.	C	T	2	1	3	0	1	4	0	0
7	41357331	.	C	T	1	2	3	0	1	4	0	0
7	41357602	.	G	A	3	2	5	0	0	5	0	0
7	41357623	.	G	C	1	2	3	0	0	3	0	0
7	41358708	.	C	T	1	0	1	0	0	1	0	0
7	41401851	.	C	T	2	2	4	0	2	6	0	0
7	41401881	.	T	C	2	3	5	0	0	5	0	0
7	41402040	.	A	G	3	3	6	0	0	6	0	0
7	41402079	.	C	T	0	2	2	0	2	4	0	0
7	41402943	.	C	G	3	3	6	0	0	6	0	0
7	41402988	.	G	C	3	3	6	0	0	6	0	0
7	41404081	.	C	T	8	3	11	0	1	12	0	0
7	41404090	.	T	C	5	3	8	0	1	9	0	0
7	41404552	.	G	A	12	3	15	0	0	15	0	0
7	41404564	.	A	G	12	1	13	0	2	15	0	0
7	41406005	.	G	A	1	1	2	0	0	2	0	0
7	41416192	.	G	A	1	0	1	0	0	1	0	0
7	41419132	.	G	A	3	2	5	0	0	5	0	0
7	41419183	.	G	T	1	1	2	0	0	2	0	0
7	41422123	.	C	A	0	2	2	0	1	3	0	0
7	41422318	.	C	G	2	1	3	0	1	4	0	0
7	41430417	.	T	C	6	2	8	0	0	8	0	0
7	41431901	.	A	T	1	4	5	0	0	5	0	0
7	41431916	.	T	C	1	3	4	0	1	5	0	0
7	41432039	.	T	C	2	3	5	0	0	5	0	0
7	41432220	.	G	A	0	5	5	0	7	12	0	0
7	41432676	.	T	C	5	10	15	0	0	15	0	0
7	41432732	.	A	T	9	5	14	0	0	14	0	0
7	41432906	.	T	C	9	7	16	0	0	16	0	0
7	41433244	.	A	G	5	0	5	0	7	12	0	0
7	41436575	.	T	C	7	1	8	0	5	13	0	0
7	41436811	.	T	A	6	5	11	0	0	11	0	0
7	41436845	.	G	A	7	4	11	0	0	11	0	0
7	41436902	.	A	G	12	2	14	0	2	16	0	0
7	41436907	.	G	A	13	5	18	0	0	18	0	0
7	41437342	.	A	C	12	11	23	0	2	25	0	0
7	41437363	.	A	G	12	11	23	0	2	25	0	0
7	41437623	.	C	A	7	11	18	0	2	20	0	0
7	41437715	.	T	G	9	8	17	0	2	19	0	0
7	41437827	.	C	A	0	8	8	0	8	16	0	0
7	41437948	.	G	A	4	9	13	0	0	13	0	0
7	41438036	.	A	C	7	4	11	0	1	12	0	0
7	41438417	.	T	A	2	4	6	0	1	7	0	0
7	41438502	.	C	T	0	2	2	0	6	8	0	0
7	41438676	.	G	T	8	3	11	0	0	11	0	0
7	41438677	.	T	C	8	3	11	0	0	11	0	0
7	41438826	.	C	T	0	7	7	0	5	12	0	0
7	41438871	.	C	T	0	5	5	0	1	6	0	0
7	41438896	.	C	T	1	3	4	0	2	6	0	0
7	41438970	.	G	A	6	7	13	0	0	13	0	0
7	41439411	.	C	T	0	4	4	0	4	8	0	0
7	41443125	.	G	A	1	0	1	0	0	1	0	0
7	41491635	.	T	G	3	5	8	0	0	8	0	0
7	41491652	.	C	T	4	6	10	0	0	10	0	0
7	41491785	.	A	G	9	5	14	0	0	14	0	0
7	41491841	.	T	C	5	5	10	0	0	10	0	0
7	41498075	.	T	C	1	5	6	0	0	6	0	0
7	41500538	.	A	G	12	8	20	0	0	20	0	0
7	41500676	.	G	A	0	2	2	0	1	3	0	0
7	41501124	.	A	G	1	0	1	0	0	1	0	0
7	41503775	.	G	A	0	2	2	0	0	2	0	0
7	41511626	.	C	T	2	4	6	0	0	6	0	0
7	41517442	.	C	G	3	10	13	0	2	15	0	0
7	41517467	.	A	G	6	6	12	0	1	13	0	0
7	41517593	.	G	T	5	5	10	0	0	10	0	0
7	41517607	.	T	A	5	4	9	0	0	9	0	0
7	41517777	.	T	A	4	3	7	0	0	7	0	0
7	41517909	.	T	A	4	8	12	0	0	12	0	0
7	41517978	.	A	G	6	9	15	0	0	15	0	0
7	41518033	.	G	A	4	5	9	0	0	9	0	0
7	41518109	.	C	A	6	3	9	0	1	10	0	0
7	41518217	.	C	A	0	5	5	0	8	13	0	0
7	41518328	.	T	G	10	6	16	0	0	16	0	0
7	41518420	.	G	C	5	3	8	0	1	9	0	0
7	41518663	.	A	G	3	3	6	0	0	6	0	0
7	41518721	.	G	T	0	7	7	0	3	10	0	0
7	41518727	.	C	T	2	7	9	0	1	10	0	0
7	41518871	.	T	G	1	5	6	0	0	6	0	0
7	41518875	.	G	A	1	5	6	0	0	6	0	0
7	41713997	.	G	A	4	4	8	0	1	9	0	0
7	41714076	.	A	T	3	2	5	0	2	7	0	0
7	41714140	.	C	T	0	5	5	0	5	10	0	0
7	41714196	.	T	A	7	4	11	0	2	13	0	0
7	41714205	.	C	T	11	5	16	0	0	16	0	0
7	41714244	.	A	G	8	3	11	0	0	11	0	0
7	41714453	.	T	C	11	3	14	0	2	16	0	0
7	41714481	.	C	T	8	7	15	0	2	17	0	0
7	41714923	.	G	A	10	8	18	0	1	19	0	0
7	41715446	.	G	A	7	4	11	0	0	11	0	0
7	41715594	.	T	A	10	4	14	0	3	17	0	0
7	41715721	.	T	A	5	6	11	0	1	12	0	0
7	41715794	.	C	T	0	4	4	0	6	10	0	0
7	41726186	.	C	T	3	2	5	0	0	5	0	0
7	41726339	.	C	T	0	3	3	0	1	4	0	0
7	41726355	.	G	T	2	2	4	0	1	5	0	0
7	41726535	.	G	T	1	1	2	0	1	3	0	0
7	41748916	.	G	T	3	2	5	0	0	5	0	0
7	41749093	.	A	T	3	2	5	0	0	5	0	0
7	41751146	.	C	T	3	2	5	0	0	5	0	0
7	41751510	.	T	C	5	5	10	0	1	11	0	0
7	41751671	.	C	T	4	3	7	0	0	7	0	0
7	41752497	.	C	A	14	4	18	2	0	20	0	0
7	41752631	.	A	G	14	9	23	0	0	23	0	0
7	41752662	.	G	A	15	6	21	0	2	23	0	0
7	41752892	.	T	A	6	3	9	0	0	9	0	0
7	41752974	.	T	G	6	1	7	0	5	12	0	0
7	41753038	.	C	T	3	3	6	0	1	7	0	0
7	41753061	.	A	G	3	5	8	0	0	8	0	0
7	41753093	.	T	A	5	2	7	0	0	7	0	0
7	41753107	.	T	A	3	2	5	0	0	5	0	0
7	41753195	.	A	T	6	2	8	0	0	8	0	0
7	41757730	.	G	A	27	21	48	0	4	52	0	0
7	41773951	.	T	G	10	14	24	0	0	24	0	0
7	41774020	.	A	G	11	17	28	0	0	28	0	0
7	41774035	.	G	A	10	14	24	0	3	27	0	0
7	41774125	.	A	G	3	2	5	0	1	6	0	0
7	41780925	.	A	T	2	8	10	0	1	11	0	0
7	41791469	.	T	C	3	4	7	0	0	7	0	0
7	41791538	.	G	A	0	2	2	0	0	2	0	0
7	41791857	.	C	T	0	5	5	0	0	5	0	0
7	41873215	.	A	T	12	4	16	0	1	17	0	0
7	41873256	.	C	T	16	8	24	0	1	25	0	0
7	41873257	.	T	G	16	8	24	0	1	25	0	0
7	41873426	.	T	C	22	6	28	0	2	30	0	0
7	41873503	.	A	G	22	11	33	0	2	35	0	0
7	41873554	.	A	T	25	19	44	0	2	46	0	0
7	41873691	.	T	C	14	15	29	0	1	30	0	0
7	41875951	.	T	C	17	9	26	0	0	26	0	0
7	41896315	.	A	C	1	3	4	0	0	4	0	0
7	41896385	.	A	G	1	1	2	0	0	2	0	0
7	41899352	.	C	T	2	4	6	0	1	7	0	0
7	41899426	.	C	A	2	3	5	0	1	6	0	0
7	41899674	.	T	C	3	2	5	0	0	5	0	0
7	41900402	.	G	C	0	3	3	0	0	3	0	0
7	41901355	.	A	G	7	4	11	0	2	13	0	0
7	41903633	.	T	A	11	12	23	0	2	25	0	0
7	41903681	.	C	T	10	24	34	0	1	35	0	0
7	41903907	.	A	G	7	10	17	0	0	17	0	0
7	41904152	.	A	G	23	26	49	0	3	52	0	0
7	41904520	.	G	A	10	12	22	0	2	24	0	0
7	41911604	.	C	T	0	4	4	0	5	9	0	0
7	41912618	.	T	C	5	4	9	0	2	11	0	0
7	42068201	.	C	T	1	1	2	0	0	2	0	0
7	42229877	.	C	T	0	1	1	0	0	1	0	0
7	42345361	.	G	T	13	12	25	0	1	26	0	0
7	42345681	.	T	A	12	15	27	0	4	31	0	0
7	42345782	.	G	A	4	5	9	0	1	10	0	0
7	42547161	.	C	T	1	2	3	0	0	3	0	0
7	43174642	.	G	A	3	2	5	0	0	5	0	0
7	43309851	.	T	G	2	3	5	0	0	5	0	0
7	43760755	.	T	C	17	5	22	0	5	28	1	0
7	43760822	.	G	A	12	10	22	0	2	24	0	0
7	43760875	.	T	A	10	10	20	0	3	23	0	0
7	43760881	.	G	A	9	12	21	0	0	21	0	0
7	43761810	.	T	A	7	8	15	0	0	15	0	0
7	43765189	.	A	G	4	7	11	0	0	11	0	0
7	43765197	.	A	G	4	7	11	0	1	12	0	0
7	43765348	.	G	A	6	2	8	0	0	8	0	0
7	43775054	.	G	A	1	2	3	0	0	3	0	0
7	43778690	.	C	G	8	3	11	0	0	11	0	0
7	43781554	.	G	T	1	1	2	0	0	2	0	0
7	43787480	.	C	G	4	2	6	0	0	6	0	0
7	43840624	.	C	T	4	1	5	0	1	6	0	0
7	45400754	.	A	T	0	1	1	0	1	2	0	0
7	45400790	.	C	T	6	11	17	0	0	17	0	0
7	45402452	.	C	T	4	4	8	0	2	10	0	0
7	45402887	.	C	A	17	20	37	0	5	42	0	0
7	45402989	.	C	T	28	19	47	0	1	48	0	0
7	45403244	.	C	T	17	12	29	0	3	32	0	0
7	45403292	.	G	A	19	11	30	0	3	33	0	0
7	45403294	.	A	T	17	11	28	0	4	33	1	0
7	45403360	.	T	G	13	9	22	0	4	26	0	0
7	45403370	.	A	T	15	12	27	0	1	28	0	0
7	45403416	.	C	T	12	11	23	0	3	26	0	0
7	45403735	.	G	A	0	5	5	0	4	9	0	0
7	45403793	.	G	A	3	3	6	0	0	6	0	0
7	45404063	.	T	G	3	2	5	0	0	5	0	0
7	45404079	.	C	A	0	3	3	0	1	4	0	0
7	45404312	.	G	A	1	3	4	0	0	4	0	0
7	45404490	.	C	T	5	5	10	0	1	11	0	0
7	45405163	.	C	T	8	7	15	0	1	16	0	0
7	45405179	.	G	T	9	7	16	0	0	16	0	0
7	45405455	.	G	T	1	1	2	0	1	3	0	0
7	45405839	.	G	T	4	7	11	0	1	12	0	0
7	45405871	.	A	C	2	5	7	0	2	9	0	0
7	45405992	.	C	T	5	6	11	0	1	12	0	0
7	45966120	.	C	T	5	2	7	0	0	7	0	0
7	45971454	.	A	T	4	9	13	0	1	15	1	0
7	46004948	.	T	G	4	5	9	0	1	10	0	0
7	46004971	.	C	G	6	5	11	0	1	13	1	0
7	46004991	.	C	G	6	0	6	0	3	9	0	0
7	46373295	.	A	G	1	3	4	0	0	4	0	0
7	46374272	.	T	A	2	5	7	0	0	7	0	0
7	46374390	.	A	G	1	4	5	0	0	5	0	0
7	46430098	.	C	T	2	4	6	0	0	6	0	0
7	46430530	.	G	A	7	4	11	0	0	11	0	0
7	46430847	.	C	G	10	4	14	0	0	14	0	0
7	46431108	.	T	A	4	6	10	0	0	10	0	0
7	46431256	.	C	A	12	6	18	0	0	18	0	0
7	46431273	.	C	G	6	5	11	0	2	13	0	0
7	46431319	.	A	G	4	6	10	0	0	10	0	0
7	46431577	.	G	A	6	13	19	0	2	21	0	0
7	46486048	.	C	T	5	9	14	0	0	14	0	0
7	46486244	.	A	C	7	12	19	0	1	20	0	0
7	46486629	.	G	A	0	15	15	0	17	32	0	0
7	46486719	.	G	T	19	9	28	0	3	31	0	0
7	46487322	.	C	T	16	14	30	0	0	30	0	0
7	46728687	.	G	A	2	4	6	0	0	6	0	0
7	46728721	.	A	C	4	0	4	0	7	11	0	0
7	46728791	.	A	C	2	2	4	0	0	4	0	0
7	46729053	.	C	T	3	2	5	0	0	5	0	0
7	46729545	.	C	T	0	3	3	0	9	12	0	0
7	46730076	.	A	G	4	3	7	0	0	7	0	0
7	46730178	.	A	T	5	4	9	0	0	9	0	0
7	46730469	.	C	T	10	10	20	0	1	21	0	0
7	46730705	.	C	T	3	5	8	0	0	8	0	0
7	46731141	.	C	T	6	4	10	0	0	10	0	0
7	47265569	.	A	G	5	0	5	0	7	12	0	0
7	47265810	.	G	A	1	3	4	0	0	4	0	0
7	47265859	.	A	T	5	5	10	0	0	10	0	0
7	47265898	.	G	A	0	8	8	0	7	15	0	0
7	47358467	.	G	T	0	0	0	0	1	1	0	0
7	47411358	.	C	A	0	3	3	0	0	3	0	0
7	47412000	.	T	A	6	2	8	0	1	9	0	0
7	47412040	.	C	T	3	5	8	0	0	8	0	0
7	47412495	.	A	G	2	1	3	0	3	6	0	0
7	47413517	.	C	A	3	2	5	0	0	5	0	0
7	47413601	.	G	T	1	4	5	0	0	5	0	0
7	47414174	.	C	T	5	3	8	0	1	9	0	0
7	47414199	.	G	T	2	0	2	0	0	2	0	0
7	47414348	.	C	T	10	5	15	0	0	15	0	0
7	47414726	.	A	T	9	4	13	0	1	14	0	0
7	47414882	.	A	G	6	0	6	0	6	12	0	0
7	47416438	.	T	A	3	5	8	0	0	8	0	0
7	47416439	.	C	T	5	3	8	0	0	8	0	0
7	47416473	.	G	A	8	1	9	0	1	10	0	0
7	47416496	.	T	A	0	9	9	0	1	10	0	0
7	47416790	.	T	A	5	12	17	0	2	19	0	0
7	47416807	.	A	T	9	12	21	0	1	22	0	0
7	47416904	.	T	A	3	7	10	0	0	10	0	0
7	47417002	.	C	A	8	9	17	0	0	17	0	0
7	47417080	.	T	C	17	2	19	0	2	21	0	0
7	47417810	.	C	T	9	13	22	0	0	22	0	0
7	47417934	.	T	A	13	12	25	0	1	26	0	0
7	47418575	.	G	T	11	5	16	0	1	17	0	0
7	47418697	.	C	A	4	17	21	0	0	21	0	0
7	47418847	.	T	A	9	7	16	0	0	16	0	0
7	47419114	.	A	C	7	7	14	0	1	15	0	0
7	47419250	.	T	G	6	4	10	0	1	11	0	0
7	47419653	.	G	A	5	6	11	0	3	14	0	0
7	47419842	.	G	A	8	10	18	0	2	20	0	0
7	47420019	.	A	G	10	8	18	0	3	21	0	0
7	47421313	.	C	T	5	6	11	0	1	12	0	0
7	47448218	.	G	A	6	2	8	0	0	8	0	0
7	47488246	.	C	T	5	0	5	0	0	5	0	0
7	47563359	.	C	T	0	2	2	0	2	4	0	0
7	48054990	.	G	A	1	2	3	0	0	3	0	0
7	48063519	.	A	G	4	7	11	0	0	11	0	0
7	48063546	.	A	G	2	9	11	0	0	11	0	0
7	48252774	.	A	T	2	2	4	0	0	4	0	0
7	48288848	.	A	G	4	0	4	0	0	4	0	0
7	48291844	.	A	G	7	4	11	1	0	12	0	0
7	48291864	.	G	A	10	10	20	1	1	22	0	0
7	48295902	.	G	T	18	16	34	0	1	35	0	0
7	48295910	.	C	T	15	16	31	0	2	33	0	0
7	48296075	.	A	G	9	8	17	0	0	17	0	0
7	48296181	.	T	G	6	2	8	0	0	8	0	0
7	48300621	.	T	C	3	2	5	0	0	5	0	0
7	48300648	.	G	C	5	3	8	0	0	8	0	0
7	48302925	.	A	G	2	3	5	0	0	5	0	0
7	48304118	.	C	T	2	3	5	0	0	5	0	0
7	48304119	.	T	C	3	2	5	0	0	5	0	0
7	48304348	.	C	T	3	5	8	0	1	9	0	0
7	48304350	.	A	T	3	5	8	0	1	9	0	0
7	48304548	.	A	T	6	5	11	0	3	14	0	0
7	48304589	.	A	T	7	6	13	0	0	13	0	0
7	48327867	.	C	A	1	3	4	0	0	4	0	0
7	48342526	.	T	C	5	2	7	0	2	9	0	0
7	48347478	.	T	G	12	12	24	0	0	24	0	0
7	48347680	.	A	C	9	10	19	0	0	19	0	0
7	48348003	.	G	A	8	12	20	0	1	21	0	0
7	48348006	.	A	G	8	12	20	0	1	21	0	0
7	48348062	.	C	T	10	9	19	0	1	20	0	0
7	48348485	.	A	G	10	3	13	0	0	13	0	0
7	48348519	.	C	T	5	3	8	0	2	10	0	0
7	48348554	.	G	A	2	5	7	0	0	7	0	0
7	48352914	.	G	A	1	2	3	0	0	3	0	0
7	48353844	.	G	A	1	5	6	0	0	6	0	0
7	48358792	.	A	T	1	6	7	0	0	7	0	0
7	48369043	.	C	G	0	2	2	0	5	7	0	0
7	48369306	.	G	A	0	2	2	0	1	3	0	0
7	48369999	.	C	T	1	1	2	0	0	2	0	0
7	48370014	.	T	G	2	2	4	0	0	4	0	0
7	48460315	.	C	T	2	3	5	0	0	5	0	0
7	48482286	.	C	A	6	2	8	0	0	8	0	0
7	48482370	.	C	T	2	2	4	0	1	5	0	0
7	48483513	.	T	A	12	10	22	0	0	22	0	0
7	48484269	.	T	C	16	14	30	0	6	36	0	0
7	48484307	.	G	A	0	10	10	0	12	22	0	0
7	48484416	.	G	A	5	16	21	0	0	21	0	0
7	48484621	.	C	T	10	13	23	0	1	24	0	0
7	48664032	.	A	G	2	2	4	0	1	5	0	0
7	48720078	.	G	T	2	2	4	0	0	4	0	0
7	48720887	.	A	G	1	2	3	0	0	3	0	0
7	48788369	.	T	C	5	11	16	0	0	16	0	0
7	48788389	.	G	C	5	0	5	0	12	17	0	0
7	48788910	.	C	T	1	3	4	0	1	5	0	0
7	48788966	.	C	T	3	3	6	0	0	6	0	0
7	48809031	.	T	C	1	2	3	0	0	3	0	0
7	48818563	.	T	C	1	2	3	0	0	3	0	0
7	48819684	.	A	G	1	0	1	0	1	2	0	0
7	48820773	.	C	T	5	4	9	0	0	9	0	0
7	48821065	.	T	C	8	4	12	0	0	12	0	0
7	48821331	.	T	C	2	3	5	0	0	5	0	0
7	48821362	.	C	T	0	2	2	0	0	2	0	0
7	48823809	.	A	T	2	1	3	0	0	3	0	0
7	48829569	.	G	C	16	16	32	0	2	34	0	0
7	48829728	.	A	G	8	5	13	0	3	16	0	0
7	48829926	.	A	T	3	4	7	0	1	8	0	0
7	49051660	.	C	T	7	3	10	0	0	10	0	0
7	49052044	.	T	A	6	2	8	0	1	9	0	0
7	49052097	.	T	G	4	4	8	0	0	8	0	0
7	49052112	.	C	T	2	6	8	0	1	9	0	0
7	49052138	.	G	A	5	8	13	0	1	14	0	0
7	49052333	.	C	T	3	4	7	0	2	9	0	0
7	49052359	.	A	G	5	5	10	0	3	13	0	0
7	49052476	.	G	A	6	4	10	0	0	10	0	0
7	49052625	.	C	T	3	2	5	0	0	5	0	0
7	49053092	.	G	A	6	1	7	0	1	8	0	0
7	49053095	.	C	G	6	2	8	0	1	9	0	0
7	49053133	.	A	G	2	1	3	0	0	3	0	0
7	49053143	.	T	C	1	2	3	0	0	3	0	0
7	49053300	.	A	T	2	5	7	0	0	7	0	0
7	49053314	.	T	A	2	4	6	0	0	6	0	0
7	49053445	.	A	G	5	5	10	0	2	12	0	0
7	49053454	.	T	A	5	6	11	0	1	12	0	0
7	49053483	.	A	C	3	9	12	0	1	13	0	0
7	49053491	.	T	A	2	10	12	0	0	12	0	0
7	49053785	.	G	C	8	10	18	0	4	22	0	0
7	49053977	.	C	T	3	2	5	0	0	5	0	0
7	49054475	.	T	C	7	6	13	0	0	13	0	0
7	49054739	.	A	G	8	10	18	0	6	24	0	0
7	49054885	.	C	T	9	5	14	0	0	14	0	0
7	49054899	.	C	T	10	8	18	0	0	18	0	0
7	49054981	.	T	A	2	4	6	0	1	7	0	0
7	49054985	.	T	C	3	3	6	0	1	7	0	0
7	49055227	.	G	A	0	9	9	0	7	16	0	0
7	49055256	.	T	C	4	11	15	0	1	16	0	0
7	49251540	.	A	G	1	3	4	0	0	4	0	0
7	49257333	.	T	C	3	6	9	0	1	10	0	0
7	49257384	.	T	C	10	5	15	0	0	15	0	0
7	49257774	.	C	T	15	6	21	0	2	23	0	0
7	49257979	.	A	G	8	6	14	0	0	14	0	0
7	49258012	.	G	A	10	6	16	0	0	16	0	0
7	49258279	.	C	T	6	4	10	0	1	11	0	0
7	49269896	.	A	G	9	0	9	0	11	20	0	0
7	49269913	.	A	G	8	0	8	0	7	15	0	0
7	49271069	.	C	T	12	7	19	0	0	19	0	0
7	49271121	.	G	T	11	7	18	0	2	20	0	0
7	49271147	.	A	C	13	11	24	0	1	25	0	0
7	49271208	.	C	T	10	7	17	0	0	17	0	0
7	49320237	.	A	G	8	4	12	0	0	12	0	0
7	49320253	.	G	A	9	4	13	0	2	15	0	0
7	49320342	.	A	T	1	4	5	0	0	5	0	0
7	49324690	.	C	T	0	2	2	0	2	4	0	0
7	49325033	.	T	A	10	5	15	0	1	16	0	0
7	49325319	.	T	C	4	8	12	0	1	13	0	0
7	49325346	.	A	G	5	9	14	0	0	14	0	0
7	49338336	.	G	A	11	11	22	0	2	24	0	0
7	49357357	.	G	A	1	3	4	0	1	5	0	0
7	49358228	.	A	C	3	2	5	0	1	6	0	0
7	49619680	.	T	C	2	2	4	0	0	4	0	0
7	49619827	.	T	C	1	2	3	0	0	3	0	0
7	49620059	.	T	C	1	2	3	0	0	3	0	0
7	49620089	.	T	G	2	2	4	0	0	4	0	0
7	49620241	.	T	C	1	0	1	0	6	7	0	0
7	49638880	.	T	G	5	3	8	0	1	9	0	0
7	49639272	.	G	T	4	6	10	0	0	10	0	0
7	49639392	.	T	A	2	2	4	0	0	4	0	0
7	49639394	.	G	C	2	1	3	0	1	4	0	0
7	49639701	.	T	C	2	8	10	0	0	10	0	0
7	49639876	.	A	T	9	9	18	0	1	19	0	0
7	49639926	.	A	C	6	8	14	0	2	16	0	0
7	49640040	.	G	A	9	12	21	0	4	25	0	0
7	49716898	.	T	C	2	3	5	0	0	5	0	0
7	49799240	.	T	A	2	2	4	0	0	4	0	0
7	49799272	.	C	T	5	4	9	0	0	9	0	0
7	49799470	.	A	T	4	5	9	0	0	9	0	0
7	49799526	.	T	A	5	3	8	0	0	8	0	0
7	50109317	.	T	C	2	2	4	0	1	5	0	0
7	50110585	.	C	T	8	4	12	0	0	12	0	0
7	50111330	.	C	T	6	8	14	0	3	17	0	0
7	50112025	.	C	T	9	11	20	0	1	21	0	0
7	50112039	.	T	G	9	13	22	0	0	22	0	0
7	50112063	.	G	A	7	13	20	0	1	21	0	0
7	50112196	.	A	G	2	0	2	0	2	12	8	0
7	50112286	.	T	C	5	6	11	0	0	11	0	0
7	50112383	.	G	A	12	7	19	0	4	23	0	0
7	50112460	.	C	T	15	11	26	0	0	26	0	0
7	50112825	.	A	T	19	11	30	0	1	31	0	0
7	50112922	.	C	A	6	4	10	0	0	10	0	0
7	50228314	.	C	A	8	11	19	0	0	20	1	0
7	50228326	.	T	C	10	1	11	0	9	20	0	0
7	50228355	.	C	T	13	11	24	0	0	24	0	0
7	50228548	.	T	C	4	7	11	0	1	12	0	0
7	50228785	.	C	G	2	4	6	0	0	6	0	0
7	50229223	.	T	C	13	13	26	0	0	26	0	0
7	50272707	.	G	A	1	3	4	0	0	4	0	0
7	50272779	.	A	G	3	2	5	0	0	5	0	0
7	50295736	.	A	G	1	2	3	0	0	3	0	0
7	50295823	.	G	A	10	9	19	0	0	19	0	0
7	50295974	.	G	T	5	18	23	0	0	23	0	0
7	50295997	.	T	A	5	10	15	0	2	17	0	0
7	50296016	.	A	G	4	8	12	0	0	12	0	0
7	50296545	.	T	G	5	4	9	0	0	9	0	0
7	50296981	.	A	G	11	4	15	0	0	15	0	0
7	50299379	.	G	A	3	4	7	0	1	8	0	0
7	50323793	.	A	G	2	1	3	0	0	3	0	0
7	50323967	.	C	T	0	1	1	0	0	1	0	0
7	50333581	.	T	C	1	1	2	0	0	2	0	0
7	50333629	.	T	C	1	2	3	0	0	3	0	0
7	50348175	.	A	G	1	2	3	0	0	3	0	0
7	50376214	.	T	C	2	4	6	0	2	8	0	0
7	50376243	.	G	A	4	3	7	0	0	7	0	0
7	50376255	.	A	G	5	3	8	0	0	8	0	0
7	50376395	.	G	A	4	6	10	0	0	10	0	0
7	50376720	.	A	T	5	4	9	0	0	9	0	0
7	50376751	.	G	A	7	4	11	0	0	11	0	0
7	50377025	.	A	G	6	9	15	0	0	15	0	0
7	50377045	.	C	T	0	8	8	0	7	15	0	0
7	50383553	.	C	T	2	1	3	0	0	3	0	0
7	50388859	.	C	T	0	2	2	0	0	2	0	0
7	50388889	.	G	A	0	2	2	0	0	2	0	0
7	50395947	.	T	G	2	3	5	0	0	5	0	0
7	50399782	.	T	C	4	2	6	0	0	6	0	0
7	50400267	.	A	G	2	4	6	0	0	6	0	0
7	50407469	.	A	G	8	16	24	0	0	24	0	0
7	50407532	.	T	C	11	3	14	0	7	21	0	0
7	50407587	.	T	C	12	11	23	0	0	23	0	0
7	50407588	.	C	A	8	11	19	0	4	23	0	0
7	50407724	.	C	T	9	10	19	0	1	20	0	0
7	50410394	.	T	A	22	18	40	0	2	42	0	0
7	50410475	.	T	C	10	8	18	0	1	19	0	0
7	50476004	.	A	G	1	3	4	0	0	4	0	0
7	50476306	.	A	T	2	2	4	0	0	4	0	0
7	50476510	.	T	C	1	3	4	0	1	5	0	0
7	50548086	.	A	G	1	2	3	0	0	3	0	0
7	50833943	.	C	A	0	2	2	0	0	2	0	0
7	50836382	.	C	T	1	2	3	0	0	3	0	0
7	50836424	.	C	T	2	4	6	0	0	6	0	0
7	50837949	.	G	A	3	2	5	0	0	5	0	0
7	50838135	.	G	C	0	1	1	0	1	2	0	0
7	50838251	.	C	T	1	2	3	0	0	3	0	0
7	50840428	.	G	A	5	5	10	0	0	10	0	0
7	50841072	.	G	A	6	4	10	0	0	10	0	0
7	50841237	.	C	T	8	11	19	0	0	19	0	0
7	50841690	.	G	A	0	7	7	0	2	9	0	0
7	50841693	.	A	T	2	7	9	0	0	9	0	0
7	50843813	.	C	A	4	2	6	0	0	6	0	0
7	50843827	.	A	G	5	2	7	0	2	9	0	0
7	50844117	.	G	A	0	11	11	0	11	22	0	0
7	50844142	.	G	A	10	6	16	0	1	17	0	0
7	50844165	.	C	T	3	6	9	0	1	10	0	0
7	50844830	.	G	T	5	10	15	0	1	16	0	0
7	50844834	.	G	A	0	5	5	0	11	16	0	0
7	50844895	.	A	T	7	4	11	0	1	12	0	0
7	50844936	.	A	T	5	9	14	0	1	15	0	0
7	50845000	.	G	A	12	8	20	0	0	20	0	0
7	50845105	.	A	T	17	12	29	0	0	29	0	0
7	50845158	.	A	G	8	8	16	0	0	16	0	0
7	50845210	.	A	G	7	11	18	0	0	18	0	0
7	50845331	.	G	A	0	3	3	0	4	7	0	0
7	50845486	.	A	T	4	11	15	0	0	15	0	0
7	50845646	.	C	T	11	4	15	0	0	15	0	0
7	50845892	.	C	A	13	16	29	0	3	32	0	0
7	50846055	.	T	C	11	13	24	0	1	25	0	0
7	50846081	.	T	A	13	14	27	0	0	27	0	0
7	50877064	.	T	C	2	12	14	0	0	14	0	0
7	50878385	.	T	C	8	3	11	0	0	11	0	0
7	50878473	.	A	C	1	3	4	0	0	4	0	0
7	50878864	.	A	T	1	1	2	0	1	3	0	0
7	50911223	.	T	A	12	10	22	0	1	23	0	0
7	50911278	.	C	T	17	20	37	0	4	41	0	0
7	50912212	.	C	T	8	8	16	0	1	17	0	0
7	50912227	.	C	G	7	6	13	0	0	13	0	0
7	50917219	.	C	T	3	2	5	0	0	5	0	0
7	51219420	.	C	G	6	7	13	0	4	17	0	0
7	51219436	.	A	C	10	2	12	0	2	14	0	0
7	51220739	.	A	G	6	6	12	0	1	13	0	0
7	51220740	.	C	A	0	7	7	0	6	13	0	0
7	51221475	.	C	T	5	5	10	0	1	11	0	0
7	51222115	.	G	A	7	5	12	0	0	12	0	0
7	51222187	.	T	A	5	2	7	0	0	7	0	0
7	51222297	.	G	A	2	1	3	0	0	3	0	0
7	51246426	.	G	A	4	2	6	0	0	6	0	0
7	51246457	.	G	T	3	3	6	0	1	7	0	0
7	51246573	.	T	C	3	5	8	0	0	8	0	0
7	51320835	.	G	T	1	2	3	0	0	3	0	0
7	51353421	.	C	T	3	6	9	0	0	9	0	0
7	51353447	.	G	T	4	4	8	0	0	8	0	0
7	51353989	.	G	T	3	2	5	0	0	5	0	0
7	51354066	.	G	A	0	2	2	0	2	4	0	0
7	51354306	.	T	C	3	2	5	0	0	5	0	0
7	51354424	.	T	A	1	6	7	0	0	7	0	0
7	51354442	.	C	A	1	4	5	0	0	5	0	0
7	51355437	.	A	G	1	4	5	0	1	6	0	0
7	51355515	.	A	T	4	5	9	0	0	9	0	0
7	51355531	.	T	A	4	5	9	0	0	9	0	0
7	51356100	.	A	T	7	3	10	0	2	12	0	0
7	51356542	.	C	G	13	10	23	0	0	23	0	0
7	51356625	.	C	A	13	7	20	0	0	20	0	0
7	51356733	.	G	T	1	9	10	0	2	12	0	0
7	51356767	.	C	A	3	5	8	0	0	8	0	0
7	51468119	.	C	T	21	14	35	0	0	35	0	0
7	51468241	.	C	T	23	13	36	0	1	37	0	0
7	51468389	.	C	T	0	18	18	0	14	32	0	0
7	51468411	.	A	T	11	12	23	0	0	23	0	0
7	51468577	.	C	A	19	19	38	0	3	41	0	0
7	51469048	.	T	G	22	20	42	0	0	42	0	0
7	51469166	.	A	T	19	12	31	0	2	33	0	0
7	51469267	.	G	C	6	12	18	0	2	20	0	0
7	51469304	.	T	A	10	6	16	0	0	16	0	0
7	51469518	.	T	A	6	11	17	0	4	21	0	0
7	51469578	.	T	G	7	8	15	0	0	15	0	0
7	51469814	.	C	T	0	4	4	0	8	12	0	0
7	51469897	.	A	G	4	10	14	0	1	15	0	0
7	51470569	.	G	T	7	5	12	0	1	13	0	0
7	51471189	.	T	C	9	0	9	0	4	13	0	0
7	51471195	.	T	C	7	4	11	0	1	12	0	0
7	51471379	.	G	A	6	5	11	0	0	11	0	0
7	51471554	.	T	C	1	0	1	0	6	7	0	0
7	51471591	.	T	C	5	2	7	0	0	7	0	0
7	51471714	.	A	G	4	3	7	0	0	7	0	0
7	51472534	.	T	A	5	2	7	0	1	8	0	0
7	51472536	.	T	A	5	2	7	0	1	8	0	0
7	51472853	.	G	A	4	3	7	0	0	7	0	0
7	51473814	.	C	T	3	1	4	0	0	4	0	0
7	51473831	.	T	G	3	3	6	0	0	6	0	0
7	51474300	.	G	T	1	2	3	0	0	3	0	0
7	51475180	.	A	G	0	2	2	0	0	2	0	0
7	51634285	.	C	T	15	14	29	0	1	30	0	0
7	51634480	.	G	A	33	29	62	0	6	69	1	0
7	51635615	.	A	G	15	10	25	0	0	25	0	0
7	51643163	.	A	G	3	4	7	0	0	7	0	0
7	51643212	.	G	A	5	3	8	0	0	8	0	0
7	51643409	.	C	A	1	4	5	0	0	5	0	0
7	51656256	.	G	A	2	3	5	0	1	6	0	0
7	51656560	.	A	T	2	3	5	0	0	5	0	0
7	51705806	.	C	G	3	3	6	0	0	6	0	0
7	51709223	.	A	G	0	1	1	0	0	1	0	0
7	51709914	.	C	A	1	2	3	0	1	4	0	0
7	51713257	.	G	A	4	5	9	0	0	9	0	0
7	51713267	.	G	A	5	3	8	0	0	8	0	0
7	51779628	.	G	A	2	3	5	0	0	5	0	0
7	51779636	.	T	C	1	3	4	0	0	4	0	0
7	51788227	.	T	G	4	6	10	0	0	10	0	0
7	51788756	.	A	C	9	8	17	0	0	17	0	0
7	51811165	.	G	A	2	3	5	0	0	5	0	0
7	51813776	.	A	G	1	0	1	0	8	9	0	0
7	51813946	.	T	G	2	2	4	0	0	4	0	0
7	51814287	.	C	G	4	4	8	0	3	11	0	0
7	51814445	.	T	A	10	4	14	0	0	14	0	0
7	51814512	.	C	T	6	7	13	0	0	13	0	0
7	52151265	.	T	G	1	0	1	0	0	1	0	0
7	52156113	.	G	A	0	1	1	0	1	2	0	0
7	52156137	.	T	A	1	1	2	0	0	2	0	0
7	52157845	.	A	T	4	5	9	0	1	10	0	0
7	52165631	.	C	T	2	3	5	0	0	5	0	0
7	52173207	.	G	A	3	4	7	0	1	8	0	0
7	52173228	.	A	G	1	2	3	0	1	4	0	0
7	52285027	.	T	C	7	8	15	0	0	15	0	0
7	52285035	.	C	T	4	4	8	0	1	9	0	0
7	52285113	.	C	G	6	9	15	0	3	18	0	0
7	52285257	.	T	G	1	3	4	0	1	5	0	0
7	52293935	.	C	T	6	4	10	0	0	10	0	0
7	52294009	.	G	T	5	5	10	0	1	11	0	0
7	52294540	.	A	T	14	9	23	0	1	24	0	0
7	52294579	.	C	T	8	5	13	0	1	14	0	0
7	52294756	.	A	T	6	5	11	0	2	13	0	0
7	52295016	.	C	T	0	9	9	0	14	23	0	0
7	52295183	.	G	A	9	19	28	0	2	30	0	0
7	52295795	.	C	T	0	6	6	0	6	12	0	0
7	52296018	.	T	C	9	4	13	0	0	13	0	0
7	52296221	.	G	A	6	5	11	0	1	12	0	0
7	52296281	.	T	C	6	3	9	0	1	10	0	0
7	52296320	.	G	A	4	3	7	0	1	8	0	0
7	52296352	.	G	T	7	2	9	0	0	9	0	0
7	52296791	.	G	A	6	8	14	0	1	15	0	0
7	52309924	.	G	A	0	1	1	0	0	1	0	0
7	52517759	.	G	A	2	7	9	0	0	9	0	0
7	52518529	.	T	G	7	3	10	0	0	10	0	0
7	52518813	.	C	T	10	5	15	0	1	16	0	0
7	52519015	.	T	C	1	6	7	0	1	8	0	0
7	52521352	.	G	A	1	2	3	0	0	3	0	0
7	52522182	.	T	C	6	6	12	0	2	14	0	0
7	52716875	.	C	A	0	0	0	0	1	1	0	0
7	52717095	.	T	C	2	3	5	0	0	5	0	0
7	52750565	.	C	T	9	10	19	0	3	22	0	0
7	52750656	.	G	A	9	9	18	0	1	19	0	0
7	52750776	.	G	T	13	8	21	0	0	21	0	0
7	52750847	.	C	T	11	13	24	0	1	25	0	0
7	52751016	.	C	T	8	15	23	0	2	25	0	0
7	52751306	.	T	C	0	7	7	0	0	7	0	0
7	52793313	.	C	T	2	0	2	0	0	2	0	0
7	52820092	.	G	C	2	2	4	0	2	6	0	0
7	52820320	.	C	T	4	5	9	0	1	10	0	0
7	52821446	.	T	C	4	7	11	0	0	11	0	0
7	52821451	.	A	T	0	7	7	0	1	12	4	0
7	52821658	.	C	A	2	2	4	0	1	5	0	0
7	52821904	.	G	A	7	3	10	0	1	11	0	0
7	52822136	.	G	A	10	9	19	0	1	20	0	0
7	52822217	.	T	A	9	6	15	0	2	17	0	0
7	52822351	.	A	T	10	7	17	0	1	18	0	0
7	52822493	.	A	C	7	3	10	0	3	13	0	0
7	52822773	.	C	T	6	6	12	0	3	15	0	0
7	52822860	.	A	G	5	5	10	0	0	10	0	0
7	52823161	.	G	A	9	10	19	0	0	19	0	0
7	52823210	.	C	G	7	10	17	0	1	18	0	0
7	52823377	.	T	A	8	5	13	0	0	13	0	0
7	52823388	.	C	T	6	4	10	0	2	12	0	0
7	52823429	.	A	T	5	10	15	0	1	16	0	0
7	52830447	.	G	T	2	5	7	0	2	9	0	0
7	52830591	.	A	T	22	19	41	0	1	42	0	0
7	52830601	.	T	G	19	19	38	0	4	42	0	0
7	52830639	.	C	T	18	21	39	0	8	47	0	0
7	52831053	.	G	T	18	18	36	0	8	44	0	0
7	52831198	.	T	A	7	16	23	0	1	24	0	0
7	52831236	.	A	G	9	16	25	0	2	27	0	0
7	52831430	.	C	T	19	8	27	0	1	28	0	0
7	52833126	.	C	G	5	9	14	0	1	15	0	0
7	52833248	.	A	T	6	6	12	0	3	15	0	0
7	52833329	.	G	T	13	8	21	0	0	21	0	0
7	52833682	.	T	A	8	7	15	0	1	16	0	0
7	52833792	.	G	A	13	8	21	0	1	22	0	0
7	52834334	.	T	G	7	4	11	0	0	11	0	0
7	52836325	.	C	T	12	19	31	0	0	31	0	0
7	52836403	.	A	G	16	8	24	0	8	32	0	0
7	52836451	.	C	T	8	19	27	0	1	28	0	0
7	52837644	.	G	A	8	7	15	0	1	16	0	0
7	52837686	.	C	A	4	8	12	0	0	12	0	0
7	52837687	.	T	A	4	8	12	0	0	12	0	0
7	52840871	.	T	A	12	14	26	0	4	30	0	0
7	52841276	.	A	G	3	3	6	0	1	7	0	0
7	52900987	.	C	T	7	3	10	0	1	11	0	0
7	52921521	.	C	A	8	11	19	0	0	19	0	0
7	52924873	.	T	A	7	7	14	0	0	14	0	0
7	52929182	.	G	A	4	11	15	0	4	19	0	0
7	52933088	.	C	A	33	13	46	0	2	48	0	0
7	52933191	.	C	T	3	7	10	0	0	10	0	0
7	52937334	.	G	A	4	5	9	0	2	11	0	0
7	52942312	.	G	T	4	3	7	0	0	7	0	0
7	52944199	.	G	A	5	4	9	0	0	9	0	0
7	52959270	.	G	T	2	2	4	0	0	4	0	0
7	53010124	.	T	C	0	2	2	0	0	2	0	0
7	53162425	.	T	C	1	3	4	0	2	6	0	0
7	53626549	.	T	C	4	2	6	0	0	6	0	0
7	54486819	.	T	C	3	2	5	0	1	6	0	0
7	54498267	.	G	A	3	3	6	0	0	6	0	0
7	54655025	.	A	T	7	9	16	0	1	17	0	0
7	54655245	.	C	T	2	3	5	0	1	6	0	0
7	55530884	.	G	C	1	1	2	0	0	5	3	0
7	55635202	.	T	C	0	1	1	0	0	1	0	0
7	55635355	.	G	A	0	1	1	0	1	2	0	0
7	55660269	.	G	A	6	5	11	0	1	12	0	0
7	55669479	.	G	A	1	0	1	0	0	1	0	0
7	55675577	.	G	A	0	1	1	0	1	2	0	0
7	56037600	.	T	C	2	2	4	0	0	4	0	0
7	56037601	.	G	A	1	2	3	0	1	4	0	0
7	56152686	.	G	C	12	9	21	0	1	22	0	0
7	56158111	.	G	A	5	5	10	0	0	10	0	0
7	56158197	.	G	A	3	6	9	0	1	10	0	0
7	56172458	.	T	C	2	3	5	0	0	5	0	0
7	56174222	.	T	C	1	2	3	0	0	3	0	0
7	56395283	.	A	G	2	2	4	0	1	5	0	0
7	56397859	.	G	A	3	2	5	0	1	6	0	0
7	56398522	.	A	T	4	2	6	0	0	6	0	0
7	56398651	.	C	T	1	1	2	0	1	3	0	0
7	56405508	.	T	C	3	7	10	0	0	10	0	0
7	56484426	.	G	A	18	11	29	0	0	29	0	0
7	56523233	.	A	G	1	0	1	0	0	1	0	0
7	56528494	.	C	T	2	0	2	0	0	2	0	0
7	56528922	.	G	A	1	1	2	0	1	3	0	0
7	56721953	.	G	A	0	2	2	0	2	4	0	0
7	56721963	.	T	A	2	2	4	0	0	4	0	0
7	56743837	.	G	C	0	1	1	0	0	1	0	0
7	56746311	.	C	T	5	6	11	0	0	11	0	0
7	56751971	.	A	G	16	14	30	0	0	30	0	0
7	56752243	.	G	A	2	4	6	0	0	6	0	0
7	56766115	.	C	T	0	3	3	0	7	10	0	0
7	56766282	.	A	C	1	1	2	0	6	8	0	0
7	56778235	.	T	A	15	22	37	0	4	41	0	0
7	56778251	.	T	C	12	20	32	0	3	35	0	0
7	56778282	.	C	T	0	15	15	0	16	31	0	0
7	56778305	.	G	A	13	15	28	0	0	28	0	0
7	56778672	.	G	T	13	15	28	0	2	30	0	0
7	56778721	.	G	T	13	12	25	0	4	29	0	0
7	56778822	.	A	T	15	11	26	0	0	26	0	0
7	56778895	.	A	G	13	9	22	0	2	24	0	0
7	56784070	.	A	T	11	7	18	0	1	19	0	0
7	56785006	.	T	C	7	3	10	0	1	11	0	0
7	56785308	.	C	T	6	5	11	0	0	11	0	0
7	56785315	.	G	A	4	6	10	0	0	10	0	0
7	56787414	.	A	T	7	7	14	0	4	19	1	0
7	56787483	.	T	A	6	15	21	0	1	22	0	0
7	56787527	.	C	T	7	10	17	0	2	19	0	0
7	57049308	.	T	C	0	1	1	0	1	2	0	0
7	57049578	.	C	T	2	3	5	0	0	5	0	0
7	57050003	.	A	G	4	1	5	0	1	6	0	0
7	57071707	.	C	T	2	1	3	0	0	3	0	0
7	57081143	.	C	T	1	3	4	0	0	4	0	0
7	57081146	.	T	C	0	3	3	0	1	4	0	0
7	57086153	.	C	T	4	6	10	0	1	11	0	0
7	57086216	.	G	A	0	7	7	0	7	14	0	0
7	57086383	.	C	A	7	5	12	0	0	12	0	0
7	57129474	.	A	G	0	2	2	0	1	3	0	0
7	57129518	.	C	T	1	4	5	0	0	5	0	0
7	57129520	.	A	T	1	4	5	0	0	5	0	0
7	57129553	.	C	A	4	3	7	0	0	7	0	0
7	57129656	.	G	A	1	3	4	0	0	4	0	0
7	57129729	.	G	T	4	5	9	0	0	9	0	0
7	57129766	.	A	T	2	6	8	0	0	8	0	0
7	57485710	.	T	C	4	10	14	0	2	16	0	0
7	57485736	.	A	G	2	10	12	0	0	12	0	0
7	57485766	.	A	G	1	6	7	0	0	7	0	0
7	57485847	.	G	A	0	3	3	0	1	4	0	0
7	57497353	.	T	C	4	4	8	0	0	8	0	0
7	57497455	.	C	G	2	0	2	0	0	2	0	0
7	57504905	.	C	G	3	3	6	0	0	6	0	0
7	57629503	.	G	A	1	2	3	0	0	3	0	0
7	57874026	.	G	A	0	1	1	0	0	1	0	0
7	57874038	.	A	C	0	1	1	0	0	1	0	0
7	57874083	.	G	A	0	1	1	0	0	1	0	0
7	57876512	.	T	C	4	5	9	0	0	9	0	0
7	57878712	.	T	C	2	7	9	0	0	9	0	0
7	57878726	.	A	T	1	6	7	0	0	7	0	0
7	57878885	.	C	T	5	3	8	0	0	8	0	0
7	57879205	.	C	T	3	4	7	0	2	9	0	0
7	57879245	.	C	T	4	3	7	0	2	9	0	0
7	57879396	.	T	A	17	10	27	0	2	29	0	0
7	57879431	.	G	T	0	10	10	0	16	26	0	0
7	57879436	.	C	A	14	9	23	0	1	24	0	0
7	57879576	.	C	A	13	14	27	0	3	30	0	0
7	57879601	.	T	C	16	6	22	0	2	24	0	0
7	57879959	.	C	A	12	6	18	0	2	20	0	0
7	57879992	.	G	A	16	8	24	0	0	24	0	0
7	57880099	.	T	C	3	3	6	0	0	6	0	0
7	57886347	.	C	A	22	20	42	0	3	45	0	0
7	57886392	.	T	A	26	20	46	0	1	47	0	0
7	57886964	.	T	G	15	32	47	0	4	51	0	0
7	57887480	.	C	T	13	22	35	0	3	38	0	0
7	57898605	.	G	A	8	6	14	0	1	15	0	0
7	57898623	.	C	T	16	10	26	0	1	27	0	0
7	57898650	.	T	C	16	24	40	0	2	42	0	0
7	57898658	.	C	G	18	25	43	0	5	48	0	0
7	57900948	.	T	A	0	3	3	0	0	3	0	0
7	57913558	.	C	A	13	22	35	0	2	37	0	0
7	57914155	.	T	G	10	16	26	0	4	30	0	0
7	57918590	.	A	G	9	5	14	0	0	14	0	0
7	57918799	.	G	A	22	22	44	0	2	46	0	0
7	57919087	.	T	G	17	12	29	0	4	33	0	0
7	57919241	.	G	A	14	13	27	0	1	28	0	0
7	57919249	.	T	C	15	0	15	0	13	28	0	0
7	57919567	.	T	C	15	10	25	0	0	25	0	0
7	57920608	.	A	T	5	8	13	0	1	14	0	0
7	57920908	.	A	G	7	1	8	0	0	8	0	0
7	57921094	.	A	G	11	13	24	0	0	24	0	0
7	57921335	.	A	G	10	4	14	0	3	17	0	0
7	57921914	.	G	A	3	3	6	0	1	7	0	0
7	57922480	.	G	A	4	7	11	0	0	11	0	0
7	57922555	.	G	T	3	6	9	0	0	9	0	0
7	57922793	.	G	T	8	4	12	0	0	12	0	0
7	57922827	.	C	T	3	11	14	0	0	14	0	0
7	57922828	.	A	G	3	10	13	0	1	14	0	0
7	57928407	.	A	T	4	2	6	0	0	6	0	0
7	57936171	.	G	A	3	5	8	0	0	8	0	0
7	57952714	.	T	C	1	1	2	0	0	2	0	0
7	57954099	.	G	A	0	1	1	0	0	1	0	0
7	57954123	.	A	C	0	3	3	0	0	3	0	0
7	58007916	.	G	T	1	1	2	0	0	2	0	0
7	58142814	.	A	T	4	3	7	0	0	7	0	0
7	58142939	.	G	A	1	2	3	0	2	5	0	0
7	58143045	.	T	C	1	5	6	0	0	6	0	0
7	58143067	.	G	A	1	5	6	0	0	6	0	0
7	58143104	.	A	G	3	3	6	0	0	6	0	0
7	58143123	.	G	C	3	2	5	0	0	5	0	0
7	58144163	.	G	A	2	2	4	0	0	4	0	0
7	58188252	.	A	G	3	4	7	0	0	7	0	0
7	58188253	.	A	C	3	4	7	0	0	7	0	0
7	58259472	.	C	T	7	6	13	0	2	15	0	0
7	58259494	.	T	A	10	5	15	0	0	15	0	0
7	58259561	.	A	G	6	7	13	0	1	14	0	0
7	58259808	.	C	T	0	1	1	0	3	4	0	0
7	58264129	.	T	C	4	3	7	0	0	7	0	0
7	58265533	.	G	A	2	1	3	0	0	3	0	0
7	58687138	.	G	A	3	7	10	0	0	10	0	0
7	58695379	.	A	C	5	6	11	0	1	12	0	0
7	58695441	.	C	A	20	13	33	0	2	35	0	0
7	58695599	.	G	T	14	12	26	0	1	27	0	0
7	58720718	.	T	C	1	1	2	0	1	3	0	0
7	58748871	.	A	C	16	10	26	0	1	27	0	0
7	58748891	.	T	C	11	8	19	0	1	20	0	0
7	58750327	.	A	C	25	21	46	0	5	51	0	0
7	58841391	.	T	C	3	0	3	0	6	9	0	0
7	58841552	.	T	G	0	2	2	0	0	2	0	0
7	58843134	.	T	C	5	6	11	0	0	11	0	0
7	59030020	.	T	G	0	2	2	0	1	3	0	0
7	59030933	.	C	T	1	2	3	0	0	3	0	0
7	59037972	.	C	T	1	7	8	0	0	8	0	0
7	59041504	.	A	G	0	3	3	0	0	3	0	0
7	59041531	.	A	G	0	1	1	0	2	3	0	0
7	59043421	.	T	C	0	0	0	0	1	1	0	0
7	59046711	.	T	A	4	3	7	0	0	7	0	0
7	59046966	.	T	A	2	9	11	0	0	11	0	0
7	59048307	.	C	T	0	9	9	0	13	22	0	0
7	59048907	.	G	A	3	1	4	0	0	4	0	0
7	59069079	.	G	A	7	6	13	0	0	13	0	0
7	59069080	.	T	G	6	6	12	0	1	13	0	0
7	59203097	.	A	G	3	3	6	0	0	6	0	0
7	59203289	.	G	A	1	0	1	0	2	3	0	0
7	59210423	.	T	A	1	2	3	0	0	3	0	0
7	59245594	.	G	T	4	2	6	0	1	8	1	0
7	59245612	.	G	T	6	4	10	0	0	10	0	0
7	59469015	.	G	A	2	4	6	0	0	6	0	0
7	59574175	.	A	G	1	2	3	0	0	3	0	0
7	60149599	.	C	T	3	0	3	0	0	3	0	0
7	60240748	.	T	C	1	2	3	0	0	3	0	0
7	60244637	.	A	G	6	7	13	0	0	13	0	0
7	60244868	.	C	T	3	4	7	0	0	7	0	0
7	60245180	.	G	T	1	5	6	0	1	7	0	0
7	60359574	.	G	A	0	2	2	0	2	4	0	0
7	60359584	.	C	T	3	2	5	0	0	5	0	0
7	60409230	.	T	C	2	2	4	0	0	4	0	0
7	60415928	.	T	C	4	9	13	0	0	13	0	0
7	60415945	.	A	T	5	5	10	0	1	11	0	0
7	60416010	.	T	C	6	9	15	0	3	18	0	0
7	60416016	.	A	G	5	11	16	0	3	19	0	0
7	60416175	.	C	T	3	14	17	0	0	17	0	0
7	60416317	.	A	G	2	0	2	0	7	9	0	0
7	60416327	.	C	T	1	7	8	0	1	9	0	0
7	60416379	.	G	A	5	7	12	0	1	13	0	0
7	60416383	.	C	T	5	9	14	0	1	15	0	0
7	60416439	.	A	G	6	18	24	0	1	25	0	0
7	60416724	.	A	G	3	7	10	0	0	10	0	0
7	60416764	.	T	G	2	10	12	0	0	12	0	0
7	60417176	.	T	A	9	5	14	0	0	14	0	0
7	60551171	.	A	C	8	8	16	0	1	17	0	0
7	60551471	.	A	G	5	4	9	0	0	9	0	0
7	60585523	.	A	G	6	0	6	0	11	17	0	0
7	60585599	.	G	A	5	5	10	0	1	11	0	0
7	60585702	.	G	A	1	1	2	0	0	2	0	0
7	60585748	.	G	T	1	3	4	0	1	5	0	0
7	60585818	.	G	C	3	5	8	0	0	8	0	0
7	60586187	.	T	C	10	11	21	0	4	25	0	0
7	60586364	.	A	C	11	6	17	0	1	18	0	0
7	60586771	.	C	T	6	7	13	0	0	13	0	0
7	60586784	.	A	T	9	6	15	0	0	15	0	0
7	60586835	.	C	T	3	10	13	0	0	13	0	0
7	60586874	.	G	A	0	9	9	0	7	16	0	0
7	60586976	.	C	T	8	8	16	0	3	19	0	0
7	60597482	.	G	A	12	11	23	0	3	26	0	0
7	60597500	.	T	G	14	12	26	0	1	27	0	0
7	60597863	.	C	T	9	17	26	0	3	29	0	0
7	60598265	.	T	A	18	21	39	0	1	40	0	0
7	61586641	.	C	G	4	4	8	0	0	8	0	0
7	61586910	.	C	T	3	4	7	0	1	8	0	0
7	61587138	.	A	G	1	5	6	0	0	6	0	0
7	61587143	.	T	A	1	5	6	0	0	6	0	0
7	61587740	.	G	A	1	2	3	0	0	3	0	0
7	61594696	.	C	A	1	1	2	0	0	2	0	0
7	61771497	.	C	T	1	2	3	0	0	3	0	0
7	61804880	.	A	T	2	5	7	0	0	7	0	0
7	61804909	.	C	A	5	3	8	1	0	9	0	0
7	61805102	.	G	A	4	3	7	0	2	9	0	0
7	61805104	.	T	A	6	3	9	0	0	9	0	0
7	61921320	.	G	A	1	1	2	0	0	2	0	0
7	61921463	.	C	T	1	1	2	0	0	2	0	0
7	61921465	.	T	A	1	1	2	0	0	2	0	0
7	61934189	.	T	A	1	1	2	0	0	2	0	0
7	61961063	.	G	A	1	0	1	0	1	2	0	0
7	61961229	.	T	C	3	4	7	0	0	7	0	0
7	61961664	.	A	G	2	2	4	0	0	4	0	0
7	61962002	.	A	G	1	8	9	0	0	9	0	0
7	61962040	.	T	C	5	9	14	0	1	15	0	0
7	61962292	.	G	T	4	3	7	0	0	7	0	0
7	61977499	.	T	C	5	10	15	0	1	16	0	0
7	61977514	.	G	A	4	12	16	0	0	16	0	0
7	61981934	.	G	C	1	0	1	0	0	1	0	0
7	62004146	.	C	T	15	12	27	0	1	28	0	0
7	62009630	.	T	A	9	6	15	0	1	16	0	0
7	62009677	.	G	A	0	10	10	0	7	17	0	0
7	64740893	.	T	C	2	0	2	0	6	8	0	0
7	64978891	.	A	C	3	3	6	0	0	6	0	0
7	64980793	.	A	G	0	1	1	0	0	1	0	0
7	64980820	.	A	G	1	5	6	1	0	7	0	0
7	64988061	.	A	G	3	1	4	0	1	5	0	0
7	65024082	.	C	T	0	2	2	0	0	2	0	0
7	65035275	.	A	G	4	5	9	0	0	9	0	0
7	65035416	.	G	T	1	6	7	0	0	7	0	0
7	65035437	.	C	T	1	5	6	0	1	7	0	0
7	65039374	.	T	A	3	5	8	0	1	9	0	0
7	65039436	.	A	C	7	0	7	0	10	17	0	0
7	65049706	.	C	T	0	1	1	0	1	2	0	0
7	65050312	.	A	T	1	0	1	0	0	1	0	0
7	65132884	.	C	T	0	0	0	0	1	1	0	0
7	65138868	.	A	G	1	0	1	0	0	1	0	0
7	65144861	.	G	T	0	0	0	0	1	1	0	0
7	65152036	.	C	A	1	0	1	0	0	1	0	0
7	65157397	.	A	C	6	5	11	0	0	11	0	0
7	65162339	.	G	A	0	2	2	0	4	6	0	0
7	65173289	.	A	T	14	13	27	0	1	28	0	0
7	65173534	.	C	T	12	7	19	0	3	22	0	0
7	65173768	.	G	A	2	6	8	0	0	8	0	0
7	65173829	.	A	T	4	4	8	0	0	8	0	0
7	65177521	.	A	G	1	2	3	0	0	3	0	0
7	65177585	.	G	T	0	2	2	0	2	4	0	0
7	65178135	.	C	T	2	5	7	0	5	12	0	0
7	65178270	.	C	T	1	0	1	0	2	3	0	0
7	65178462	.	C	T	1	1	2	0	0	2	0	0
7	65178465	.	A	G	1	1	2	0	0	2	0	0
7	65297041	.	A	T	1	3	4	0	0	4	0	0
7	65297313	.	G	T	2	2	4	0	0	4	0	0
7	65306067	.	T	C	7	3	10	0	0	10	0	0
7	65306229	.	G	A	5	4	9	0	2	11	0	0
7	65443348	.	T	C	0	1	1	0	0	1	0	0
7	65443396	.	G	A	0	2	2	0	0	2	0	0
7	65451324	.	T	A	7	2	9	0	1	10	0	0
7	65452005	.	G	A	0	4	4	0	3	7	0	0
7	65452017	.	G	A	3	3	6	0	0	6	0	0
7	65453057	.	G	A	0	3	3	0	7	10	0	0
7	65463165	.	C	A	7	8	15	0	1	16	0	0
7	65463297	.	G	T	0	6	6	0	16	22	0	0
7	65463511	.	G	A	2	19	21	0	19	40	0	0
7	65463586	.	C	T	10	8	18	0	1	19	0	0
7	65463906	.	T	C	14	7	21	0	0	21	0	0
7	65464120	.	T	G	5	6	11	0	0	11	0	0
7	65464132	.	T	G	5	0	5	0	5	10	0	0
7	65473137	.	G	T	15	15	30	0	4	34	0	0
7	65473421	.	G	C	19	24	43	0	2	46	1	0
7	65473775	.	G	T	14	25	39	0	2	41	0	0
7	65473814	.	T	C	24	14	38	0	2	40	0	0
7	65473972	.	T	C	13	22	35	0	2	37	0	0
7	65475422	.	T	G	3	9	12	0	0	12	0	0
7	65475708	.	T	G	13	6	19	0	2	21	0	0
7	65491835	.	G	A	14	13	27	0	0	27	0	0
7	65608114	.	A	T	1	2	3	0	0	3	0	0
7	65918566	.	A	G	2	2	4	0	0	4	0	0
7	65918569	.	T	C	2	2	4	0	0	4	0	0
7	65919940	.	T	G	1	0	1	0	2	3	0	0
7	65919942	.	T	A	1	2	3	0	0	3	0	0
7	65921467	.	G	C	3	3	6	0	0	6	0	0
7	65921726	.	G	T	0	3	3	0	3	6	0	0
7	65923238	.	C	T	3	3	6	0	1	7	0	0
7	65923921	.	T	C	2	4	6	0	1	7	0	0
7	65923944	.	T	G	3	4	7	0	1	8	0	0
7	65924471	.	T	A	6	3	9	0	0	9	0	0
7	65924476	.	G	T	6	2	8	0	0	8	0	0
7	65924554	.	A	G	10	4	14	0	0	14	0	0
7	65924558	.	C	T	9	4	13	0	1	14	0	0
7	65924621	.	T	C	3	0	3	0	1	4	0	0
7	65924634	.	A	G	2	0	2	0	1	3	0	0
7	66105498	.	C	T	5	4	9	0	0	9	0	0
7	66105752	.	C	T	3	4	7	0	1	8	0	0
7	66105804	.	G	A	0	2	2	0	4	6	0	0
7	66112702	.	T	C	3	6	9	0	1	10	0	0
7	66259315	.	G	A	2	2	4	0	0	4	0	0
7	66259325	.	C	T	1	2	3	0	0	3	0	0
7	66276243	.	G	A	7	12	19	0	0	19	0	0
7	66361984	.	A	G	6	5	11	0	2	13	0	0
7	67434693	.	A	C	1	1	2	0	0	2	0	0
7	67435587	.	T	C	2	1	3	0	0	3	0	0
7	67436273	.	C	T	5	8	13	0	0	13	0	0
7	67439428	.	A	C	3	1	4	0	1	5	0	0
7	67439496	.	T	A	5	7	12	0	0	12	0	0
7	67439520	.	T	A	2	2	4	0	0	4	0	0
7	67439742	.	T	C	6	4	10	0	0	10	0	0
7	67439743	.	C	T	6	3	9	0	1	10	0	0
7	67439781	.	T	C	4	1	5	0	0	5	0	0
7	67443766	.	T	C	2	2	4	0	0	4	0	0
7	67444837	.	G	A	1	2	3	0	0	3	0	0
7	67446295	.	C	T	16	7	23	0	3	26	0	0
7	67448338	.	T	C	16	13	29	0	2	31	0	0
7	67448363	.	A	T	14	17	31	0	2	33	0	0
7	67448373	.	T	A	18	16	34	0	0	34	0	0
7	67462908	.	C	T	1	2	3	0	0	3	0	0
7	67476376	.	T	C	34	26	60	0	5	65	0	0
7	67743603	.	T	A	1	4	5	0	0	5	0	0
7	67743604	.	G	T	1	3	4	0	1	5	0	0
7	67743646	.	A	G	3	1	4	0	0	5	1	0
7	67743878	.	T	C	3	1	4	0	0	4	0	0
7	67743901	.	A	G	2	2	4	0	0	4	0	0
7	67744341	.	A	G	10	4	14	0	3	17	0	0
7	67747404	.	T	A	5	6	11	0	0	11	0	0
7	67747819	.	T	C	11	10	21	0	0	21	0	0
7	67747826	.	T	G	9	7	16	0	3	19	0	0
7	67747869	.	G	C	8	4	12	0	2	14	0	0
7	67760437	.	G	C	0	1	1	0	1	2	0	0
7	67795367	.	T	C	1	3	4	0	1	5	0	0
7	67795429	.	G	A	3	4	7	0	0	7	0	0
7	67796075	.	G	T	5	4	9	0	0	9	0	0
7	67796413	.	C	A	3	1	4	0	0	4	0	0
7	67796437	.	G	T	4	2	6	0	0	6	0	0
7	67796494	.	G	A	0	4	4	1	8	13	0	0
7	67797037	.	C	G	6	5	11	0	1	12	0	0
7	67797087	.	G	T	6	8	14	0	0	14	0	0
7	67797097	.	C	T	6	8	14	0	0	14	0	0
7	67817399	.	C	T	1	2	3	0	1	4	0	0
7	67833051	.	G	A	3	3	6	0	1	7	0	0
7	67835264	.	A	G	0	1	1	0	0	1	0	0
7	67835269	.	A	C	0	1	1	0	0	1	0	0
7	67842641	.	G	T	1	2	3	0	0	3	0	0
7	67846087	.	T	C	1	0	1	0	0	1	0	0
7	67865220	.	G	C	0	1	1	0	0	1	0	0
7	67876771	.	C	T	0	2	2	0	1	3	0	0
7	68215451	.	A	T	28	12	40	0	3	43	0	0
7	68215990	.	T	G	15	18	33	0	3	36	0	0
7	68216504	.	C	A	0	3	3	0	6	9	0	0
7	68216781	.	G	C	1	4	5	0	1	6	0	0
7	68217387	.	G	A	2	11	13	0	0	13	0	0
7	68218940	.	T	C	0	1	1	0	0	1	0	0
7	68219412	.	T	A	5	14	19	0	3	22	0	0
7	68220824	.	A	C	3	2	5	0	0	5	0	0
7	68541265	.	A	G	1	3	4	0	0	4	0	0
7	68542517	.	C	T	4	2	6	0	0	6	0	0
7	68542538	.	C	T	3	4	7	0	0	7	0	0
7	69143989	.	T	C	4	5	9	0	2	11	0	0
7	69143992	.	T	C	3	0	3	0	9	12	0	0
7	69145138	.	T	C	1	3	4	0	1	5	0	0
7	69145394	.	T	C	4	2	6	0	0	6	0	0
7	69145553	.	T	C	1	2	3	0	1	4	0	0
7	69145554	.	T	C	1	3	4	0	0	4	0	0
7	69145836	.	T	C	7	3	10	0	0	10	0	0
7	69146417	.	T	C	3	0	3	0	3	6	0	0
7	69146421	.	T	C	1	5	6	0	0	6	0	0
7	69313357	.	T	G	2	0	2	0	1	3	0	0
7	69437422	.	A	C	0	3	3	0	2	5	0	0
7	69437472	.	T	C	1	5	6	0	0	6	0	0
7	69437495	.	C	A	0	2	2	0	0	2	0	0
7	69439580	.	A	G	3	1	4	0	0	4	0	0
7	69439587	.	A	G	3	0	3	0	1	4	0	0
7	69442261	.	T	G	2	3	5	0	0	5	0	0
7	69442374	.	C	T	1	0	1	0	0	1	0	0
7	69447324	.	G	A	2	2	4	0	0	4	0	0
7	69447352	.	T	C	7	6	13	0	0	13	0	0
7	69447469	.	C	G	5	4	9	0	0	9	0	0
7	69447516	.	A	G	7	5	12	0	0	12	0	0
7	69447520	.	G	A	7	5	12	0	0	12	0	0
7	69458611	.	T	C	3	1	4	0	0	4	0	0
7	69467145	.	A	G	4	5	9	0	1	10	0	0
7	69467228	.	G	A	4	1	5	0	0	5	0	0
7	69467267	.	A	G	5	7	12	0	1	13	0	0
7	69467383	.	T	G	2	1	3	0	8	11	0	0
7	69477283	.	T	G	22	15	37	0	7	46	2	0
7	69477303	.	A	G	16	0	16	0	32	48	0	0
7	69477361	.	T	C	18	30	48	0	6	54	0	0
7	69477437	.	A	G	23	25	48	0	0	48	0	0
7	69477464	.	T	C	26	25	51	0	4	55	0	0
7	69492100	.	T	C	1	0	1	0	0	1	0	0
7	69496521	.	C	A	17	17	34	0	0	34	0	0
7	69496537	.	A	T	14	15	29	0	4	33	0	0
7	69496572	.	A	G	10	18	28	0	1	29	0	0
7	69497048	.	A	T	11	11	22	0	1	23	0	0
7	69497493	.	G	T	19	13	32	0	0	32	0	0
7	69497637	.	G	A	7	3	10	0	0	10	0	0
7	69501040	.	A	G	5	3	8	0	0	8	0	0
7	69501300	.	A	G	5	7	12	0	0	12	0	0
7	69501345	.	G	T	5	11	16	0	2	18	0	0
7	69566119	.	A	G	2	0	2	0	0	2	0	0
7	69566848	.	G	A	1	0	1	0	0	1	0	0
7	69576019	.	C	A	1	1	2	0	0	2	0	0
7	69583133	.	A	T	2	1	3	0	0	3	0	0
7	69583139	.	C	T	2	1	3	0	0	3	0	0
7	69934781	.	A	C	1	1	2	0	0	2	0	0
7	69946805	.	C	T	1	2	3	0	0	3	0	0
7	69950322	.	G	A	1	2	3	0	0	3	0	0
7	69950666	.	T	C	1	2	3	0	0	3	0	0
7	71792765	.	T	C	5	8	13	0	1	14	0	0
7	71792772	.	T	C	0	11	11	0	0	11	0	0
7	72028742	.	A	G	24	9	33	0	0	33	0	0
7	72034521	.	T	C	17	7	24	0	0	24	0	0
7	72034534	.	T	C	3	13	16	0	4	20	0	0
7	72415298	.	A	T	0	1	1	0	1	2	0	0
7	72416996	.	T	G	1	0	1	0	0	1	0	0
7	72417089	.	G	A	0	3	3	0	0	3	0	0
7	72417095	.	C	T	0	0	0	0	3	3	0	0
7	72549193	.	A	G	2	2	4	0	0	4	0	0
7	72578005	.	C	G	3	0	3	0	0	3	0	0
7	73084736	.	G	A	0	6	6	0	8	14	0	0
7	73084738	.	C	G	7	0	7	0	7	14	0	0
7	73084948	.	T	C	4	4	8	0	0	8	0	0
7	73085083	.	G	A	6	3	9	0	0	9	0	0
7	73085188	.	A	T	4	2	6	0	0	6	0	0
7	73085190	.	A	C	4	2	6	0	0	6	0	0
7	73085478	.	T	C	1	1	2	0	2	4	0	0
7	73085482	.	G	C	0	2	2	0	1	3	0	0
7	73085777	.	T	C	1	5	6	0	0	6	0	0
7	73085868	.	A	G	1	3	4	0	1	5	0	0
7	73085889	.	T	C	1	4	5	0	1	6	0	0
7	73085914	.	A	G	0	3	3	0	1	4	0	0
7	73086051	.	T	G	4	4	8	0	0	8	0	0
7	73086061	.	A	T	3	4	7	0	0	7	0	0
7	73086217	.	A	G	2	3	5	0	0	5	0	0
7	73086326	.	T	C	5	2	7	0	0	7	0	0
7	73086522	.	A	G	3	3	6	1	1	8	0	0
7	73086615	.	A	G	3	5	8	0	1	9	0	0
7	73086632	.	G	A	0	3	3	0	3	6	0	0
7	73086656	.	T	G	3	4	7	0	2	9	0	0
7	73087208	.	A	G	6	11	17	0	0	17	0	0
7	73087209	.	T	C	6	11	17	0	0	17	0	0
7	73087250	.	A	C	7	6	13	0	0	13	0	0
7	73087266	.	G	A	7	7	14	0	0	14	0	0
7	73087329	.	T	G	4	6	10	0	1	11	0	0
7	73087344	.	T	C	6	7	13	0	1	14	0	0
7	73087374	.	A	T	10	7	17	0	2	19	0	0
7	73087479	.	A	C	7	10	17	0	1	18	0	0
7	73087491	.	G	A	7	6	13	0	4	17	0	0
7	73087528	.	T	C	12	3	15	0	1	16	0	0
7	73087702	.	A	G	7	0	7	0	10	17	0	0
7	73087741	.	G	C	0	7	7	0	9	16	0	0
7	73087895	.	A	C	7	19	26	0	1	27	0	0
7	73088489	.	C	T	9	14	23	0	0	23	0	0
7	73401946	.	C	T	8	14	22	0	0	22	0	0
7	73613555	.	G	T	2	3	5	0	0	5	0	0
7	73616027	.	A	G	1	3	4	0	0	4	0	0
7	73616547	.	T	A	5	4	9	0	2	11	0	0
7	73616711	.	T	C	3	5	8	0	1	9	0	0
7	73617717	.	A	G	2	6	8	0	1	9	0	0
7	73617759	.	G	A	0	5	5	0	3	8	0	0
7	73617792	.	A	G	3	3	6	0	0	6	0	0
7	73617828	.	T	C	0	2	2	0	0	2	0	0
7	73617836	.	A	T	0	1	1	0	0	1	0	0
7	73617880	.	A	G	2	7	9	0	0	9	0	0
7	73618004	.	G	A	2	13	15	0	2	17	0	0
7	73618220	.	C	A	2	2	4	0	0	4	0	0
7	73618264	.	A	G	1	5	6	0	0	6	0	0
7	73618327	.	A	G	2	2	4	0	0	4	0	0
7	73618340	.	T	G	1	3	4	0	0	4	0	0
7	73618549	.	G	A	10	2	12	0	1	13	0	0
7	73618565	.	A	G	7	0	7	0	5	12	0	0
7	73618841	.	A	G	2	7	9	0	2	11	0	0
7	73619153	.	T	A	9	7	16	0	1	17	0	0
7	73619587	.	A	C	12	12	24	0	0	24	0	0
7	73620129	.	C	T	12	17	29	0	1	30	0	0
7	73630951	.	G	C	9	15	24	0	2	26	0	0
7	73630955	.	G	A	0	12	12	0	11	23	0	0
7	73651959	.	C	A	23	20	43	0	2	46	1	0
7	73652321	.	T	A	25	19	44	0	5	49	0	0
7	73652715	.	A	T	12	16	28	0	0	28	0	0
7	73652819	.	C	T	4	12	16	0	2	18	0	0
7	73652873	.	G	T	10	14	24	0	3	27	0	0
7	73652892	.	A	G	12	1	13	0	19	32	0	0
7	73653241	.	T	C	17	21	38	0	4	42	0	0
7	73653373	.	C	A	17	22	39	0	1	40	0	0
7	73653994	.	G	A	12	7	19	0	0	19	0	0
7	73654065	.	T	C	5	9	14	0	1	15	0	0
7	73654505	.	C	T	22	19	41	0	1	42	0	0
7	73654647	.	C	G	24	0	24	0	37	61	0	0
7	73654652	.	G	A	29	23	52	0	8	60	0	0
7	73654693	.	A	C	29	31	60	0	5	65	0	0
7	73654742	.	C	A	28	34	62	0	5	67	0	0
7	73654827	.	A	G	24	32	56	0	1	57	0	0
7	73654878	.	C	T	26	25	51	0	4	55	0	0
7	73654896	.	G	A	27	26	53	0	5	58	0	0
7	73655474	.	T	G	34	23	57	0	7	64	0	0
7	73655580	.	G	A	35	24	59	0	4	63	0	0
7	73655698	.	A	G	24	15	39	0	3	42	0	0
7	73655775	.	T	C	12	12	24	0	3	27	0	0
7	73655997	.	C	T	28	32	60	0	4	64	0	0
7	73655998	.	T	C	31	27	58	0	6	64	0	0
7	73656075	.	T	C	40	24	64	0	10	74	0	0
7	73656136	.	G	A	35	25	60	0	1	61	0	0
7	73656361	.	G	A	5	5	10	0	0	10	0	0
7	74056970	.	G	A	3	2	5	0	0	5	0	0
7	74056976	.	C	G	0	3	3	0	0	3	0	0
7	74135779	.	G	T	9	10	19	0	5	24	0	0
8	5733	.	T	C	21	23	44	0	1	45	0	0
8	6265	.	C	T	35	21	56	0	6	62	0	0
8	6368	.	T	C	30	8	38	0	4	49	7	0
8	6440	.	A	T	18	11	29	0	2	31	0	0
8	6468	.	G	A	0	8	8	0	19	27	0	0
8	7184	.	T	C	8	4	12	0	0	12	0	0
8	7276	.	G	A	6	6	12	0	0	12	0	0
8	7346	.	G	T	4	4	8	0	2	10	0	0
8	41751	.	G	C	4	6	10	0	1	11	0	0
8	41754	.	C	T	3	6	9	0	1	10	0	0
8	41925	.	T	C	10	0	10	0	19	29	0	0
8	41948	.	A	G	10	21	31	0	0	31	0	0
8	43800	.	A	G	6	3	9	0	0	9	0	0
8	44337	.	G	A	0	2	2	0	0	2	0	0
8	56225	.	T	G	0	1	1	0	0	1	0	0
8	57732	.	C	T	0	5	5	0	6	11	0	0
8	58399	.	C	G	2	10	12	0	0	12	0	0
8	61833	.	G	A	0	2	2	0	0	2	0	0
8	75188	.	C	A	6	9	15	0	1	16	0	0
8	75446	.	G	T	0	4	4	0	5	9	0	0
8	75646	.	G	C	0	3	3	0	3	6	0	0
8	109489	.	T	C	0	0	0	0	1	1	0	0
8	115080	.	T	C	0	1	1	0	0	1	0	0
8	118378	.	T	C	1	2	3	0	0	3	0	0
8	120282	.	G	A	0	1	1	0	0	1	0	0
8	120839	.	G	A	0	6	6	0	4	10	0	0
8	120896	.	T	C	6	5	11	0	2	13	0	0
8	173841	.	A	G	3	1	4	0	1	5	0	0
8	174020	.	G	A	1	1	2	0	1	3	0	0
8	261498	.	T	C	1	1	2	0	0	2	0	0
8	262012	.	C	T	1	3	4	0	0	4	0	0
8	262054	.	C	A	0	2	2	0	0	2	0	0
8	268215	.	G	A	1	1	2	0	0	2	0	0
8	276277	.	C	T	1	2	3	0	0	3	0	0
8	276334	.	A	G	5	4	9	0	1	10	0	0
8	286192	.	A	G	11	7	18	0	1	19	0	0
8	286251	.	C	T	10	12	22	0	1	23	0	0
8	286302	.	G	A	9	15	24	0	2	26	0	0
8	387915	.	A	G	10	4	14	0	0	14	0	0
8	387926	.	G	A	8	3	11	0	0	11	0	0
8	388885	.	C	T	19	11	30	0	2	32	0	0
8	392047	.	G	T	10	13	23	0	0	23	0	0
8	392160	.	C	A	7	4	11	0	0	11	0	0
8	392389	.	T	C	7	0	7	0	7	14	0	0
8	392689	.	C	T	0	16	16	0	16	32	0	0
8	395281	.	C	A	0	5	5	0	11	16	0	0
8	395287	.	C	T	8	6	14	0	2	16	0	0
8	395428	.	G	A	3	5	8	0	0	8	0	0
8	397338	.	T	C	6	7	13	0	1	14	0	0
8	397341	.	C	T	0	6	6	0	7	13	0	0
8	406330	.	T	G	6	5	11	0	0	11	0	0
8	406432	.	A	C	2	5	7	0	1	8	0	0
8	412089	.	A	C	9	9	18	0	1	19	0	0
8	412090	.	C	T	1	8	9	0	10	19	0	0
8	412296	.	T	C	19	0	19	0	11	30	0	0
8	412303	.	G	A	19	6	25	0	4	29	0	0
8	412355	.	A	G	15	9	24	0	2	26	0	0
8	412358	.	A	G	15	10	25	0	1	26	0	0
8	412504	.	T	C	20	0	20	0	8	28	0	0
8	417849	.	A	G	6	3	9	0	1	10	0	0
8	418575	.	A	G	0	1	1	0	0	1	0	0
8	423723	.	C	T	16	9	25	0	2	27	0	0
8	423920	.	T	C	9	8	17	1	3	21	0	0
8	424969	.	G	A	11	9	20	0	0	20	0	0
8	434955	.	C	G	0	2	2	0	1	3	0	0
8	473773	.	G	A	1	0	1	0	0	1	0	0
8	478707	.	C	T	0	2	2	0	1	3	0	0
8	478844	.	T	C	4	5	9	0	1	10	0	0
8	478889	.	G	T	1	4	5	0	0	5	0	0
8	482033	.	A	G	6	3	9	0	0	9	0	0
8	484740	.	A	G	2	1	3	0	3	6	0	0
8	484746	.	T	C	2	4	6	0	0	6	0	0
8	484780	.	A	G	5	1	6	0	3	9	0	0
8	487241	.	T	C	2	5	7	0	0	7	0	0
8	489120	.	C	T	2	3	5	0	2	7	0	0
8	489135	.	C	T	1	3	4	0	2	6	0	0
8	541376	.	C	A	2	5	7	0	0	7	0	0
8	543762	.	A	G	0	0	0	0	3	3	0	0
8	543766	.	T	A	0	4	4	0	0	4	0	0
8	705549	.	C	T	0	3	3	0	0	3	0	0
8	926772	.	G	A	9	2	11	0	0	11	0	0
8	926779	.	C	T	0	3	3	0	10	13	0	0
8	928341	.	G	A	10	8	18	0	0	18	0	0
8	943953	.	G	C	2	1	3	0	0	3	0	0
8	1094388	.	G	A	0	2	2	0	0	2	0	0
8	1094542	.	T	C	3	9	12	0	0	12	0	0
8	1094910	.	T	A	2	6	8	0	0	8	0	0
8	1100463	.	C	T	8	10	18	0	1	19	0	0
8	1102404	.	T	C	6	5	11	0	0	11	0	0
8	1106149	.	C	T	10	11	21	0	1	22	0	0
8	1106494	.	C	A	1	5	6	0	3	9	0	0
8	1129838	.	T	C	1	1	2	0	2	4	0	0
8	1130331	.	C	T	4	2	6	0	0	6	0	0
8	1130450	.	C	G	4	0	4	0	9	13	0	0
8	1130544	.	T	C	4	6	10	0	0	10	0	0
8	1133753	.	C	G	1	3	4	0	0	4	0	0
8	1151416	.	T	C	1	0	1	0	0	1	0	0
8	1222356	.	A	T	1	3	4	0	0	4	0	0
8	1222357	.	G	A	1	3	4	0	0	4	0	0
8	1222504	.	T	C	11	0	11	0	24	35	0	0
8	1222558	.	A	G	14	25	39	0	1	40	0	0
8	1253651	.	G	A	10	7	17	0	1	18	0	0
8	1254337	.	C	T	5	7	12	0	0	12	0	0
8	1255292	.	C	G	0	2	2	0	3	5	0	0
8	1255304	.	G	A	1	1	2	0	0	2	0	0
8	1259023	.	G	A	4	3	7	0	0	7	0	0
8	1264645	.	A	G	4	1	5	0	1	6	0	0
8	1852056	.	A	G	1	3	4	0	0	4	0	0
8	1852067	.	A	G	1	3	4	0	0	4	0	0
8	1852138	.	A	G	1	0	1	0	0	1	0	0
8	1852145	.	A	G	0	2	2	0	0	2	0	0
8	1852185	.	A	G	0	3	3	0	0	3	0	0
8	1852253	.	A	G	1	0	1	0	4	5	0	0
8	1852948	.	A	G	2	6	8	0	0	8	0	0
8	1852951	.	A	G	4	4	8	0	0	8	0	0
8	1853004	.	A	G	4	3	7	0	0	7	0	0
8	1853474	.	A	G	2	3	5	0	0	5	0	0
8	1856090	.	A	G	4	2	6	0	0	6	0	0
8	2215965	.	T	A	2	4	6	0	0	6	0	0
8	2216013	.	A	G	5	2	7	0	0	7	0	0
8	2219604	.	G	A	1	1	2	0	0	2	0	0
8	2229821	.	G	A	1	3	4	0	0	4	0	0
8	2261052	.	T	C	1	2	3	0	0	3	0	0
8	2412800	.	C	T	33	0	33	0	1	34	0	0
8	2412911	.	G	A	24	30	54	0	4	58	0	0
8	2413133	.	T	G	39	29	68	0	3	71	0	0
8	2416886	.	G	A	13	26	39	0	1	40	0	0
8	2416931	.	C	T	0	6	6	0	4	10	0	0
8	2421318	.	T	C	11	15	26	0	2	28	0	0
8	2421342	.	C	A	15	13	28	0	2	30	0	0
8	2426500	.	A	G	1	4	5	0	0	5	0	0
8	2456933	.	C	T	1	3	4	0	0	4	0	0
8	2456953	.	C	G	4	3	7	0	0	7	0	0
8	2467230	.	A	G	7	0	7	0	6	13	0	0
8	2467233	.	A	G	10	3	13	0	0	13	0	0
8	2469292	.	G	A	12	8	20	0	1	21	0	0
8	2469377	.	G	C	7	4	11	0	0	11	0	0
8	2469401	.	C	T	4	3	7	0	0	7	0	0
8	2487329	.	T	C	2	1	3	0	1	4	0	0
8	2490968	.	C	T	20	28	48	0	3	51	0	0
8	2491338	.	G	A	11	13	24	0	0	24	0	0
8	2502037	.	G	A	17	21	38	0	9	47	0	0
8	2502067	.	C	T	33	36	69	0	4	73	0	0
8	2502088	.	A	G	26	21	47	0	2	49	0	0
8	2502112	.	A	G	15	8	23	0	0	23	0	0
8	2525435	.	A	G	0	0	0	0	1	1	0	0
8	2525450	.	T	C	2	0	2	0	0	2	0	0
8	2529817	.	T	A	1	0	1	0	0	1	0	0
8	2530118	.	G	A	5	3	8	0	1	9	0	0
8	2535588	.	T	A	15	8	23	0	0	23	0	0
8	2535642	.	T	C	10	8	18	0	1	19	0	0
8	2536673	.	A	G	1	4	5	0	0	5	0	0
8	2536761	.	G	C	5	4	9	0	0	9	0	0
8	2555046	.	C	G	0	3	3	0	1	4	0	0
8	2560848	.	A	G	0	3	3	0	0	3	0	0
8	2566882	.	G	T	2	2	4	0	0	4	0	0
8	2567788	.	T	C	1	4	5	0	0	5	0	0
8	2567818	.	C	T	1	5	6	0	0	6	0	0
8	2574463	.	A	G	7	1	8	0	2	10	0	0
8	2574470	.	T	G	7	4	11	0	0	11	0	0
8	2574514	.	A	C	3	6	9	0	0	9	0	0
8	2574524	.	A	C	4	6	10	0	0	10	0	0
8	2585329	.	G	C	7	9	16	0	4	20	0	0
8	2585681	.	C	A	17	18	35	0	1	36	0	0
8	2588348	.	A	G	19	27	46	0	3	49	0	0
8	2588354	.	C	A	1	28	29	0	22	51	0	0
8	2595746	.	C	T	1	2	3	0	1	4	0	0
8	2606435	.	A	T	7	3	10	0	1	11	0	0
8	2606519	.	T	A	2	2	4	0	1	5	0	0
8	2789592	.	T	C	2	3	5	0	0	5	0	0
8	2789748	.	T	A	1	2	3	0	0	3	0	0
8	2789757	.	G	T	2	3	5	0	1	6	0	0
8	3099585	.	G	A	0	3	3	0	6	9	0	0
8	3099890	.	A	T	2	2	4	0	0	4	0	0
8	3100184	.	G	C	1	1	2	0	1	3	0	0
8	3101241	.	G	T	2	11	13	0	0	13	0	0
8	3101277	.	T	C	2	12	14	0	3	17	0	0
8	3434203	.	G	A	2	2	4	0	0	4	0	0
8	3434245	.	C	T	2	2	4	0	1	5	0	0
8	3439164	.	G	A	2	2	4	0	0	4	0	0
8	3439309	.	C	T	1	2	3	0	0	3	0	0
8	3569907	.	C	T	1	2	3	0	0	3	0	0
8	3594308	.	A	G	2	0	2	0	5	7	0	0
8	3595161	.	G	A	0	0	0	0	1	1	0	0
8	3595359	.	C	T	1	1	2	0	0	2	0	0
8	3597233	.	T	C	1	3	4	0	0	4	0	0
8	3612263	.	T	A	1	0	1	0	0	1	0	0
8	3612308	.	A	T	4	3	7	0	0	7	0	0
8	3624208	.	G	C	2	2	4	0	1	5	0	0
8	3628683	.	C	T	1	2	3	0	0	3	0	0
8	3628747	.	C	A	8	6	14	0	3	17	0	0
8	3628758	.	T	A	9	6	15	0	0	16	1	0
8	3628782	.	G	A	0	6	6	0	12	18	0	0
8	3631371	.	T	C	0	1	1	0	0	1	0	0
8	3631932	.	C	T	0	5	5	0	1	6	0	0
8	3641218	.	G	C	8	6	14	0	1	15	0	0
8	3643299	.	T	C	15	14	29	0	0	29	0	0
8	3659979	.	T	C	1	2	3	0	0	3	0	0
8	3660034	.	C	T	6	2	8	0	0	8	0	0
8	3883831	.	C	G	2	2	4	0	0	4	0	0
8	3889662	.	G	A	0	1	1	0	1	2	0	0
8	3915909	.	G	A	1	0	1	0	0	1	0	0
8	3932974	.	A	G	5	6	11	0	0	11	0	0
8	3932990	.	A	G	4	7	11	0	1	12	0	0
8	3933498	.	T	A	7	12	19	0	0	19	0	0
8	3949558	.	G	T	2	3	5	0	0	5	0	0
8	3950039	.	C	G	5	5	10	0	0	10	0	0
8	3950317	.	G	A	3	2	5	0	1	6	0	0
8	3950529	.	C	T	1	2	3	0	0	3	0	0
8	4044888	.	T	A	1	3	4	0	0	4	0	0
8	4368586	.	T	G	1	2	3	0	0	3	0	0
8	4368714	.	C	G	4	4	8	0	0	8	0	0
8	4369021	.	A	C	1	2	3	0	0	3	0	0
8	4398425	.	A	T	1	0	1	0	1	2	0	0
8	4398737	.	C	T	4	9	13	0	0	13	0	0
8	4398762	.	A	G	5	8	13	0	1	14	0	0
8	4398981	.	G	A	0	3	3	0	5	8	0	0
8	4399093	.	A	G	1	7	8	0	0	8	0	0
8	4399105	.	A	G	5	3	8	0	0	8	0	0
8	4399288	.	C	T	1	2	3	0	0	3	0	0
8	4399366	.	G	A	0	2	2	0	5	7	0	0
8	4399394	.	C	G	7	4	11	0	0	11	0	0
8	4399754	.	T	A	0	5	5	0	3	8	0	0
8	4400337	.	A	G	2	1	3	0	1	4	0	0
8	4400699	.	C	A	5	6	11	0	0	11	0	0
8	4400861	.	T	C	5	7	12	0	1	13	0	0
8	4400872	.	G	A	0	6	6	0	5	11	0	0
8	4401053	.	T	G	5	7	12	0	0	12	0	0
8	4401068	.	C	T	6	6	12	0	0	12	0	0
8	4401374	.	G	A	0	8	8	0	3	11	0	0
8	4401514	.	A	T	6	12	18	0	0	18	0	0
8	4401687	.	G	A	16	13	29	0	2	31	0	0
8	4401708	.	C	T	18	12	30	0	5	35	0	0
8	4401813	.	G	T	16	24	40	0	3	43	0	0
8	4401913	.	T	G	8	11	19	0	0	19	0	0
8	4401931	.	T	C	8	9	17	0	1	18	0	0
8	4440720	.	T	C	2	0	2	0	0	2	0	0
8	4444201	.	A	G	5	2	7	0	0	7	0	0
8	4446247	.	A	C	2	0	2	0	2	4	0	0
8	4446266	.	C	T	0	3	3	0	3	6	0	0
8	4446303	.	T	C	4	5	9	0	1	10	0	0
8	4516962	.	G	A	3	4	7	0	0	7	0	0
8	4519116	.	C	T	0	0	0	0	1	1	0	0
8	4519161	.	C	T	0	0	0	0	1	1	0	0
8	4522035	.	T	A	4	2	6	0	0	6	0	0
8	4533171	.	A	G	0	2	2	0	1	3	0	0
8	4541242	.	C	G	0	1	1	0	0	1	0	0
8	4577965	.	A	T	2	2	4	0	0	4	0	0
8	4589148	.	A	G	22	20	42	0	0	42	0	0
8	4589169	.	T	G	25	15	40	0	2	42	0	0
8	4589216	.	A	T	25	13	38	0	3	41	0	0
8	4589402	.	C	T	26	30	56	0	1	57	0	0
8	4596649	.	T	A	2	5	7	0	2	9	0	0
8	4618536	.	G	A	10	6	16	0	1	17	0	0
8	4618562	.	C	T	0	5	5	0	11	16	0	0
8	4621454	.	A	G	3	5	8	0	0	8	0	0
8	4621544	.	G	A	3	4	7	0	0	7	0	0
8	4622023	.	T	A	3	4	7	0	0	7	0	0
8	4622032	.	A	G	2	3	5	0	0	5	0	0
8	4698518	.	G	A	0	2	2	0	1	3	0	0
8	4771987	.	C	T	4	3	7	0	0	7	0	0
8	4776243	.	A	T	11	19	30	0	5	35	0	0
8	4779959	.	A	G	1	2	3	0	0	3	0	0
8	4779962	.	G	T	1	2	3	0	0	3	0	0
8	4780127	.	A	T	7	4	11	0	0	11	0	0
8	4780368	.	T	A	2	7	9	0	0	9	0	0
8	4780552	.	C	T	0	4	4	0	14	18	0	0
8	4788763	.	A	G	2	0	2	0	0	2	0	0
8	4799921	.	C	T	1	4	5	0	0	5	0	0
8	4800185	.	C	T	2	2	4	0	0	4	0	0
8	4800407	.	C	T	2	2	4	0	0	4	0	0
8	4800683	.	G	A	0	2	2	0	2	4	0	0
8	4964521	.	G	A	8	6	14	0	2	16	0	0
8	5845042	.	C	T	1	2	3	0	1	4	0	0
8	5845060	.	T	G	2	2	4	0	0	4	0	0
8	5845891	.	T	C	1	2	3	0	0	3	0	0
8	6863822	.	G	A	4	10	14	0	0	14	0	0
8	6864062	.	C	G	3	5	8	0	1	9	0	0
8	6864077	.	T	C	4	7	11	0	0	11	0	0
8	6864416	.	C	A	8	5	13	0	0	13	0	0
8	6865247	.	T	A	0	1	1	0	0	1	0	0
8	6865357	.	C	T	10	5	15	0	0	15	0	0
8	6865542	.	C	T	13	5	18	0	2	20	0	0
8	6865834	.	A	G	13	12	25	0	1	26	0	0
8	6866083	.	G	A	14	16	30	0	2	32	0	0
8	6866592	.	G	T	22	17	39	0	0	39	0	0
8	6866835	.	T	G	10	8	18	0	1	19	0	0
8	6874937	.	C	T	6	12	18	0	3	21	0	0
8	6874968	.	A	G	7	15	22	0	1	23	0	0
8	6875061	.	G	T	10	11	21	0	1	22	0	0
8	6875300	.	C	T	10	11	21	0	1	22	0	0
8	6875354	.	T	C	1	3	4	0	0	4	0	0
8	6875562	.	C	T	7	3	10	0	0	10	0	0
8	6875563	.	C	T	7	3	10	0	0	10	0	0
8	6875722	.	A	G	11	6	17	0	3	20	0	0
8	6876297	.	T	C	0	1	1	0	0	1	0	0
8	6876381	.	A	G	7	7	14	0	1	15	0	0
8	6876705	.	A	C	3	6	9	0	0	9	0	0
8	6903650	.	A	G	2	4	6	0	0	6	0	0
8	6920909	.	A	G	15	7	22	0	5	27	0	0
8	6921117	.	C	G	1	24	25	0	27	52	0	0
8	6921344	.	A	C	18	18	36	0	6	42	0	0
8	6921421	.	T	A	19	12	31	0	1	33	1	0
8	6921581	.	A	C	21	22	43	0	2	45	0	0
8	6921671	.	G	A	8	12	20	0	0	20	0	0
8	6927428	.	T	C	5	11	16	0	2	18	0	0
8	6935642	.	A	T	11	8	19	0	0	19	0	0
8	6970040	.	G	A	1	0	1	0	0	1	0	0
8	7018017	.	G	A	0	7	7	0	0	7	0	0
8	7018068	.	A	G	0	3	3	0	0	3	0	0
8	7022083	.	G	T	2	3	5	0	1	6	0	0
8	7022216	.	T	A	6	4	10	0	1	11	0	0
8	7022227	.	A	G	5	6	11	0	0	11	0	0
8	7022305	.	C	T	7	7	14	0	1	15	0	0
8	7118809	.	G	A	2	1	3	0	0	3	0	0
8	7119013	.	G	A	1	4	5	0	2	7	0	0
8	7120014	.	C	A	1	2	3	0	0	3	0	0
8	7120395	.	G	A	0	2	2	0	1	3	0	0
8	7120479	.	A	T	1	2	3	0	0	3	0	0
8	7120498	.	A	G	2	4	6	0	0	6	0	0
8	7120546	.	A	G	6	3	9	0	2	11	0	0
8	7120604	.	T	C	4	2	6	0	0	6	0	0
8	7121011	.	T	A	9	7	16	0	1	17	0	0
8	7121312	.	C	T	2	3	5	0	0	5	0	0
8	7121347	.	A	T	1	3	4	0	1	5	0	0
8	7122171	.	A	T	2	2	4	0	0	4	0	0
8	7122186	.	T	C	3	2	5	0	0	5	0	0
8	7122332	.	A	G	1	8	9	0	0	9	0	0
8	7122396	.	C	A	7	4	11	1	2	14	0	0
8	7122459	.	A	G	5	4	9	0	0	9	0	0
8	7122460	.	A	T	5	4	9	0	0	9	0	0
8	7122931	.	G	A	0	6	6	0	11	17	0	0
8	7123010	.	A	G	6	23	29	0	1	30	0	0
8	7123045	.	C	G	20	9	29	0	1	30	0	0
8	7123171	.	G	C	0	13	13	0	12	25	0	0
8	7123233	.	A	T	21	6	27	0	0	27	0	0
8	7123257	.	T	C	10	4	14	0	7	21	0	0
8	7123323	.	C	A	7	4	11	0	1	12	0	0
8	7123326	.	A	G	7	5	12	0	0	12	0	0
8	7123414	.	G	A	0	7	7	0	10	17	0	0
8	7123415	.	G	C	9	7	16	0	1	17	0	0
8	7123452	.	G	A	10	8	18	0	3	21	0	0
8	7123472	.	A	G	14	8	22	0	0	22	0	0
8	7123491	.	T	C	16	11	27	0	1	28	0	0
8	7123538	.	G	A	9	13	22	0	0	22	0	0
8	7742196	.	C	T	0	3	3	0	0	3	0	0
8	7746030	.	C	T	4	0	4	0	0	4	0	0
8	7765230	.	G	A	0	5	5	0	6	11	0	0
8	7772097	.	C	T	4	4	8	0	1	9	0	0
8	7855697	.	G	T	0	1	1	0	4	5	0	0
8	7863603	.	C	T	3	1	4	0	2	6	0	0
8	7872053	.	A	T	11	6	17	0	0	17	0	0
8	7872056	.	C	T	11	6	17	0	0	17	0	0
8	7872311	.	T	A	2	1	3	0	0	3	0	0
8	7908520	.	A	G	1	2	3	0	0	3	0	0
8	7908897	.	G	A	1	1	2	0	1	3	0	0
8	7908934	.	A	G	2	2	4	0	1	5	0	0
8	7908943	.	A	G	3	0	3	0	2	5	0	0
8	7912216	.	A	C	6	10	16	0	2	18	0	0
8	7912267	.	C	G	4	0	4	0	8	12	0	0
8	7912394	.	G	A	3	11	14	0	3	17	0	0
8	7912647	.	A	T	4	2	6	0	0	6	0	0
8	8298291	.	A	G	2	1	3	0	0	3	0	0
8	8298472	.	C	T	9	4	13	0	1	14	0	0
8	8325553	.	T	A	2	4	6	0	0	6	0	0
8	8331823	.	A	T	9	6	15	0	2	17	0	0
8	8334428	.	C	T	5	5	10	0	0	10	0	0
8	8338969	.	C	T	12	15	27	0	0	27	0	0
8	8341155	.	G	A	3	2	5	0	0	5	0	0
8	8341170	.	G	A	2	2	4	0	0	4	0	0
8	8341313	.	T	C	5	14	19	0	1	20	0	0
8	8341340	.	A	C	8	11	19	0	0	19	0	0
8	8341383	.	T	C	4	7	11	0	0	11	0	0
8	8341486	.	A	C	4	10	14	0	1	15	0	0
8	8341617	.	A	C	3	3	6	0	0	6	0	0
8	8341619	.	T	C	3	0	3	0	3	6	0	0
8	8343217	.	T	G	5	15	20	0	1	21	0	0
8	8362684	.	G	A	1	2	3	0	0	3	0	0
8	8389011	.	A	G	1	3	4	0	0	4	0	0
8	8390797	.	A	G	2	3	5	0	0	5	0	0
8	8478367	.	T	G	1	2	3	0	0	3	0	0
8	8483898	.	A	T	1	2	3	0	0	3	0	0
8	8686413	.	T	C	2	3	5	0	0	5	0	0
8	8846877	.	C	T	2	2	4	0	1	5	0	0
8	8847341	.	T	A	1	5	6	0	1	7	0	0
8	8847410	.	A	G	3	2	5	0	0	5	0	0
8	8847593	.	T	C	3	3	6	0	0	6	0	0
8	8847648	.	T	A	7	5	12	0	0	12	0	0
8	8847676	.	G	C	6	4	10	0	2	12	0	0
8	8847788	.	A	C	5	2	7	0	0	7	0	0
8	8847821	.	C	T	4	2	6	0	0	6	0	0
8	8847857	.	T	C	6	4	10	0	0	10	0	0
8	8847860	.	T	C	5	4	9	0	1	10	0	0
8	8848122	.	C	A	6	5	11	0	0	11	0	0
8	8905416	.	T	C	10	10	20	0	0	20	0	0
8	8914899	.	T	C	7	10	17	0	1	18	0	0
8	8914911	.	C	T	6	11	17	0	2	19	0	0
8	8919045	.	G	A	0	13	13	0	12	25	0	0
8	8922367	.	T	A	21	19	40	0	1	41	0	0
8	8975926	.	T	C	0	2	2	0	0	2	0	0
8	8977919	.	G	A	1	2	3	0	0	3	0	0
8	9011843	.	G	A	2	1	3	0	0	3	0	0
8	9029047	.	C	A	3	2	5	0	0	5	0	0
8	9052123	.	C	T	2	4	6	0	1	7	0	0
8	9052184	.	A	T	3	5	8	0	1	9	0	0
8	9059491	.	C	T	0	2	2	0	0	2	0	0
8	9222862	.	C	T	0	11	11	0	5	16	0	0
8	9222867	.	T	A	6	14	20	0	0	20	0	0
8	9222988	.	G	C	8	8	16	0	1	17	0	0
8	9223044	.	A	G	11	3	14	0	0	14	0	0
8	9275165	.	C	T	0	2	2	0	1	3	0	0
8	9275180	.	G	A	0	1	1	0	2	3	0	0
8	9369304	.	A	G	1	0	1	0	0	1	0	0
8	9731233	.	A	G	0	2	2	0	0	2	0	0
8	9733153	.	G	A	0	2	2	0	0	2	0	0
8	9733174	.	G	A	0	3	3	0	0	3	0	0
8	9743081	.	A	T	1	0	1	0	0	1	0	0
8	9748783	.	A	G	0	1	1	0	0	1	0	0
8	9755411	.	A	G	3	2	5	0	2	7	0	0
8	9761116	.	A	C	1	1	2	0	0	2	0	0
8	9791976	.	T	C	5	4	9	0	1	10	0	0
8	9791977	.	G	A	5	5	10	0	0	10	0	0
8	9961673	.	T	C	3	2	5	0	0	5	0	0
8	9985326	.	C	T	9	8	17	0	4	21	0	0
8	9985458	.	T	C	3	2	5	0	0	5	0	0
8	10306283	.	T	C	0	4	4	0	0	4	0	0
8	10307170	.	C	T	13	9	22	0	2	24	0	0
8	10307686	.	G	T	9	10	19	0	6	25	0	0
8	10307730	.	C	G	8	0	8	0	15	23	0	0
8	10308684	.	T	G	3	0	3	0	7	10	0	0
8	10562400	.	A	C	8	6	14	0	0	14	0	0
8	10823080	.	G	A	0	2	2	0	1	3	0	0
8	10823100	.	G	C	1	3	4	0	0	4	0	0
8	10856883	.	A	C	1	3	4	0	0	4	0	0
8	10856915	.	T	C	1	7	8	0	0	8	0	0
8	10882877	.	A	C	2	2	4	0	0	4	0	0
8	10884489	.	T	C	1	5	6	0	0	6	0	0
8	10890013	.	C	T	3	1	4	0	1	5	0	0
8	10890318	.	T	C	3	3	6	0	0	6	0	0
8	10890325	.	C	G	3	0	3	0	3	6	0	0
8	10894887	.	C	T	4	2	6	0	0	6	0	0
8	10895135	.	T	A	5	4	9	0	1	10	0	0
8	10895162	.	G	A	5	3	8	0	0	8	0	0
8	10937661	.	A	G	2	1	3	0	2	5	0	0
8	10937696	.	A	T	4	5	9	0	1	10	0	0
8	10937990	.	T	A	2	2	4	0	0	4	0	0
8	10938191	.	A	G	1	2	3	0	0	3	0	0
8	10938225	.	T	C	1	2	3	0	0	3	0	0
8	10956747	.	G	A	6	6	12	0	0	12	0	0
8	10956824	.	A	G	12	4	16	0	0	16	0	0
8	10957045	.	G	T	9	8	17	0	2	20	1	0
8	10957168	.	A	C	9	0	9	0	6	15	0	0
8	10967342	.	T	C	9	0	9	0	15	24	0	0
8	10969651	.	T	A	7	4	11	0	2	13	0	0
8	10972414	.	G	A	0	2	2	0	1	3	0	0
8	10978029	.	T	C	3	4	7	0	1	8	0	0
8	10978101	.	A	G	7	5	12	0	1	13	0	0
8	10980909	.	A	G	2	1	3	0	0	3	0	0
8	10981277	.	A	T	1	2	3	0	0	3	0	0
8	10987348	.	A	G	2	0	2	0	1	3	0	0
8	10988903	.	C	T	0	2	2	0	0	2	0	0
8	11004625	.	A	G	3	2	5	0	1	6	0	0
8	11009117	.	T	C	6	6	12	0	1	13	0	0
8	11016720	.	A	C	4	6	10	0	0	10	0	0
8	11019273	.	A	T	4	7	11	0	0	11	0	0
8	11027931	.	G	A	1	4	5	0	0	5	0	0
8	11027948	.	G	A	1	4	5	0	1	6	0	0
8	11114825	.	A	G	0	1	1	0	1	2	0	0
8	11114894	.	T	G	4	2	6	0	0	6	0	0
8	11114901	.	C	A	3	2	5	0	1	6	0	0
8	11115117	.	A	T	4	3	7	0	0	7	0	0
8	11146856	.	T	C	2	2	4	0	0	4	0	0
8	11146883	.	T	G	2	4	6	0	0	6	0	0
8	11179228	.	T	A	6	3	9	0	1	10	0	0
8	11180061	.	C	T	8	3	11	0	0	11	0	0
8	11180063	.	T	G	7	3	10	0	1	11	0	0
8	11180115	.	G	C	6	2	8	0	0	8	0	0
8	11182273	.	G	A	4	9	13	0	3	16	0	0
8	11182825	.	G	A	9	4	13	0	1	14	0	0
8	11183284	.	T	G	2	2	4	0	0	4	0	0
8	11183289	.	C	G	2	1	3	0	1	4	0	0
8	11183508	.	T	A	3	4	7	0	0	7	0	0
8	11183555	.	G	T	4	7	11	0	0	11	0	0
8	11183576	.	A	T	5	4	9	0	0	9	0	0
8	11183670	.	G	T	6	7	13	0	0	13	0	0
8	11183690	.	T	C	4	5	9	0	1	10	0	0
8	11183708	.	G	A	4	5	9	0	1	10	0	0
8	11183773	.	T	G	2	3	5	0	0	5	0	0
8	11183787	.	G	A	1	2	3	0	0	3	0	0
8	11184030	.	C	A	3	2	5	0	0	5	0	0
8	11185209	.	C	T	2	2	4	0	0	4	0	0
8	11185453	.	T	A	1	3	4	0	0	4	0	0
8	11185625	.	C	T	2	2	4	0	0	4	0	0
8	11189117	.	C	G	1	2	3	0	0	3	0	0
8	11338579	.	A	G	2	2	4	0	0	4	0	0
8	11338742	.	A	G	4	5	9	0	0	9	0	0
8	11734317	.	C	T	1	7	8	0	0	8	0	0
8	13852663	.	A	C	0	0	0	0	4	4	0	0
8	14170863	.	C	A	17	4	21	0	2	23	0	0
8	14441120	.	A	G	6	6	12	0	1	13	0	0
8	14441524	.	A	G	3	10	13	0	0	13	0	0
8	14441596	.	A	G	15	6	21	0	2	23	0	0
8	14983211	.	A	G	3	2	5	0	1	6	0	0
8	16275036	.	C	T	7	3	10	0	4	14	0	0
8	17086043	.	C	T	2	7	9	0	1	10	0	0
8	17396815	.	T	A	10	5	15	1	0	16	0	0
8	17787492	.	A	G	6	2	8	0	0	8	0	0
8	18562570	.	C	T	13	12	25	0	2	27	0	0
8	18562576	.	G	A	16	11	27	0	1	28	0	0
8	18565921	.	A	T	1	2	3	0	0	3	0	0
8	18840576	.	C	T	0	3	3	0	0	3	0	0
8	20871596	.	A	G	0	1	1	0	1	2	0	0
8	21104793	.	T	A	0	6	6	0	1	7	0	0
8	21251605	.	A	G	7	5	12	0	1	13	0	0
8	21413542	.	A	G	1	0	1	0	1	2	0	0
8	21672995	.	A	G	2	3	5	0	0	5	0	0
8	21672996	.	A	G	1	4	5	0	0	5	0	0
8	22011057	.	A	G	1	1	2	0	0	2	0	0
8	22511718	.	G	A	1	7	8	0	0	8	0	0
8	22951406	.	T	A	0	36	36	0	1	37	0	0
8	23151740	.	A	T	2	2	4	0	0	4	0	0
8	23763809	.	T	C	1	4	5	0	0	5	0	0
8	24293525	.	A	C	1	0	1	0	0	1	0	0
8	25293008	.	A	G	17	13	30	0	1	31	0	0
8	25821105	.	T	A	0	3	3	0	0	3	0	0
8	25951626	.	T	C	1	3	4	0	2	6	0	0
8	25970772	.	A	G	16	6	22	0	2	24	0	0
8	27623973	.	A	G	5	0	5	0	16	21	0	0
8	29718850	.	G	A	3	2	5	0	0	5	0	0
8	29718974	.	G	T	4	7	11	0	4	15	0	0
8	29719073	.	G	T	5	3	8	0	2	10	0	0
8	29719074	.	C	T	0	5	5	0	5	10	0	0
8	29734525	.	T	A	2	3	5	0	2	7	0	0
8	29734615	.	T	A	2	2	4	0	0	4	0	0
8	29734631	.	C	A	0	2	2	0	0	2	0	0
8	29760980	.	G	A	0	0	0	0	1	1	0	0
8	29763390	.	G	C	1	3	4	0	1	5	0	0
8	29763621	.	G	T	2	8	10	0	0	10	0	0
8	29763822	.	A	G	7	0	7	0	8	15	0	0
8	29763954	.	A	G	3	7	10	0	0	10	0	0
8	29764103	.	G	A	5	6	11	0	0	11	0	0
8	29764150	.	A	T	3	6	9	0	0	9	0	0
8	29764843	.	A	G	2	3	5	0	0	5	0	0
8	29764926	.	T	C	10	4	14	0	0	14	0	0
8	29765010	.	G	C	0	7	7	0	3	10	0	0
8	29765016	.	C	T	1	9	10	0	2	12	0	0
8	29765158	.	G	A	0	5	5	0	3	8	0	0
8	29765219	.	G	C	3	6	9	0	0	9	0	0
8	29765235	.	G	T	1	5	6	0	1	7	0	0
8	29765493	.	A	G	2	7	9	0	0	9	0	0
8	29770511	.	C	T	27	30	57	0	2	59	0	0
8	29770644	.	T	A	23	31	54	0	3	58	1	0
8	29770650	.	T	A	22	31	53	0	6	59	0	0
8	29770734	.	T	A	24	19	43	0	7	50	0	0
8	29770771	.	A	C	29	19	48	0	3	51	0	0
8	29771032	.	T	A	23	9	32	0	3	35	0	0
8	29771053	.	A	G	9	20	29	0	2	31	0	0
8	29771516	.	C	A	3	3	6	0	1	7	0	0
8	29771774	.	G	A	3	2	5	0	0	5	0	0
8	29771938	.	C	T	0	4	4	0	3	7	0	0
8	29772253	.	G	A	15	7	22	0	0	22	0	0
8	29772268	.	T	C	13	3	16	0	1	17	0	0
8	29772652	.	G	A	1	2	3	0	0	3	0	0
8	29772910	.	G	T	2	2	4	0	0	4	0	0
8	29773164	.	G	A	7	17	24	0	1	25	0	0
8	29773263	.	G	A	13	15	28	0	2	30	0	0
8	29773444	.	A	G	17	12	29	0	3	32	0	0
8	29774268	.	C	T	7	10	17	0	1	18	0	0
8	29774528	.	C	T	0	8	8	0	6	14	0	0
8	29774570	.	C	T	5	4	9	0	1	10	0	0
8	29799045	.	C	T	0	2	2	0	1	3	0	0
8	29801150	.	C	G	0	2	2	0	0	2	0	0
8	29875544	.	A	T	3	2	5	0	0	5	0	0
8	29875593	.	C	G	2	3	5	0	0	5	0	0
8	29898947	.	T	C	9	6	15	0	1	16	0	0
8	29899027	.	G	A	5	3	8	0	0	8	0	0
8	29899373	.	G	A	14	4	18	0	0	18	0	0
8	29899477	.	C	G	3	8	11	0	0	11	0	0
8	29899543	.	A	G	0	3	3	0	0	3	0	0
8	29904949	.	G	A	0	2	2	0	0	2	0	0
8	29904952	.	C	A	0	2	2	0	0	2	0	0
8	29911381	.	G	T	2	5	7	0	1	8	0	0
8	29925561	.	T	A	0	1	1	0	0	1	0	0
8	29930754	.	T	A	2	2	4	0	0	4	0	0
8	30159560	.	A	C	3	0	3	0	5	8	0	0
8	30330667	.	C	T	2	2	4	0	0	4	0	0
8	30425723	.	T	A	4	4	8	0	0	8	0	0
8	30425782	.	G	T	3	1	4	0	0	4	0	0
8	30570674	.	T	C	0	2	2	0	0	2	0	0
8	30591955	.	T	C	1	1	2	0	0	2	0	0
8	30591991	.	G	T	1	2	3	0	0	3	0	0
8	30600606	.	T	A	1	3	4	0	0	4	0	0
8	30600668	.	G	C	0	1	1	0	0	1	0	0
8	30661568	.	G	A	0	10	10	0	2	12	0	0
8	30661645	.	G	A	2	12	14	0	1	15	0	0
8	30662417	.	C	T	6	3	9	0	3	12	0	0
8	30662649	.	T	C	3	2	5	0	0	5	0	0
8	30730722	.	G	C	1	3	4	0	0	4	0	0
8	30730974	.	A	G	2	9	11	0	0	11	0	0
8	30730983	.	A	C	2	3	5	0	3	8	0	0
8	30734941	.	A	G	0	3	3	0	1	4	0	0
8	30742075	.	C	T	1	4	5	0	1	6	0	0
8	30743321	.	T	C	7	5	12	0	1	13	0	0
8	30745463	.	T	C	2	4	6	0	0	6	0	0
8	30928987	.	C	T	5	3	8	0	1	9	0	0
8	30929006	.	T	A	5	6	11	0	0	11	0	0
8	30929143	.	T	A	9	8	17	0	0	17	0	0
8	30929261	.	C	T	4	5	9	0	1	10	0	0
8	30929313	.	C	T	12	3	15	0	1	16	0	0
8	30929886	.	A	G	13	7	20	0	1	21	0	0
8	30929958	.	T	A	11	20	31	0	0	31	0	0
8	30930764	.	C	A	7	7	14	0	2	16	0	0
8	30938396	.	T	C	5	2	7	0	1	8	0	0
8	30938408	.	T	A	8	5	13	0	0	13	0	0
8	30940027	.	T	A	1	2	3	0	0	3	0	0
8	31008514	.	G	C	3	3	6	0	0	6	0	0
8	31008525	.	A	T	3	3	6	0	0	6	0	0
8	31010648	.	T	C	2	5	7	0	0	7	0	0
8	31010988	.	T	A	10	10	20	0	2	22	0	0
8	31012993	.	C	T	17	9	26	0	1	27	0	0
8	31013027	.	C	T	6	12	18	0	0	18	0	0
8	31013525	.	A	T	3	2	5	0	0	5	0	0
8	31013547	.	A	G	1	2	3	0	1	4	0	0
8	31030717	.	A	C	3	4	7	0	1	8	0	0
8	31030914	.	A	T	17	19	36	0	2	38	0	0
8	31031069	.	A	T	20	7	27	0	3	30	0	0
8	31031180	.	T	G	10	14	24	0	2	26	0	0
8	31031269	.	T	G	3	5	8	0	2	10	0	0
8	31031272	.	T	C	3	7	10	0	1	11	0	0
8	31031535	.	G	A	4	3	7	0	0	7	0	0
8	31031603	.	A	T	5	8	13	0	1	14	0	0
8	31031639	.	C	T	1	6	7	0	8	15	0	0
8	31031993	.	G	A	9	6	15	0	1	16	0	0
8	31032379	.	C	T	3	3	6	0	0	6	0	0
8	31032510	.	G	A	3	2	5	0	1	6	0	0
8	31036126	.	G	A	10	8	18	0	0	18	0	0
8	31037647	.	A	G	0	2	2	0	1	3	0	0
8	31040157	.	G	A	2	2	4	0	0	4	0	0
8	31040988	.	C	A	1	1	2	0	0	2	0	0
8	31041221	.	A	G	1	1	2	0	0	2	0	0
8	31045790	.	A	G	1	1	2	0	0	2	0	0
8	31119730	.	A	G	1	3	4	0	0	4	0	0
8	31119865	.	T	C	1	5	6	0	0	6	0	0
8	31119909	.	T	G	1	1	2	0	3	5	0	0
8	31131277	.	A	G	1	0	1	0	1	2	0	0
8	31131394	.	A	C	0	3	3	0	0	3	0	0
8	31135892	.	A	G	5	5	10	0	2	12	0	0
8	31135934	.	C	T	1	1	2	0	1	3	0	0
8	31139439	.	C	T	1	0	1	0	0	1	0	0
8	31142311	.	C	T	24	11	35	0	5	40	0	0
8	31145897	.	C	T	23	28	51	0	6	57	0	0
8	31145940	.	G	C	25	26	51	0	5	56	0	0
8	31145948	.	G	A	23	22	45	0	11	56	0	0
8	31146748	.	G	A	10	32	42	0	7	49	0	0
8	31146805	.	T	C	14	28	42	0	1	43	0	0
8	31146862	.	T	A	18	29	47	0	0	47	0	0
8	31146913	.	G	A	21	25	46	0	1	47	0	0
8	31147159	.	C	T	25	33	58	0	3	61	0	0
8	31147208	.	C	A	26	29	55	0	1	56	0	0
8	31147241	.	A	T	25	30	55	0	0	55	0	0
8	31147315	.	C	T	21	21	42	0	7	49	0	0
8	31147380	.	T	G	19	18	37	0	1	38	0	0
8	31147651	.	C	T	23	27	50	0	2	52	0	0
8	31147898	.	G	A	22	28	50	0	1	51	0	0
8	31249080	.	A	C	2	3	5	0	0	5	0	0
8	31249365	.	G	A	5	4	9	0	1	10	0	0
8	31250032	.	A	G	4	0	4	0	7	11	0	0
8	31250823	.	G	A	9	10	19	0	1	20	0	0
8	31251091	.	A	G	10	10	20	0	0	20	0	0
8	31251222	.	T	C	16	13	29	0	1	30	0	0
8	31251282	.	A	C	12	14	26	0	1	28	1	0
8	31251873	.	T	C	20	13	33	0	1	34	0	0
8	31367747	.	T	C	2	4	6	0	0	6	0	0
8	31368279	.	T	G	5	3	8	0	1	9	0	0
8	31368865	.	T	A	1	5	6	0	0	6	0	0
8	31375195	.	A	G	6	8	14	0	0	14	0	0
8	31375434	.	T	A	12	15	27	0	0	27	0	0
8	31375457	.	A	G	16	7	23	0	0	23	0	0
8	31376117	.	T	G	7	14	21	0	3	24	0	0
8	31376125	.	A	T	12	11	23	0	1	24	0	0
8	31387695	.	A	G	10	6	16	0	2	18	0	0
8	31387833	.	C	T	0	5	5	0	7	12	0	0
8	31388280	.	C	T	2	2	4	0	0	5	1	0
8	31393220	.	G	A	3	4	7	0	0	7	0	0
8	31393235	.	G	A	3	2	5	0	1	6	0	0
8	31393424	.	C	T	0	2	2	0	1	3	0	0
8	31393451	.	G	T	1	2	3	0	0	3	0	0
8	31395606	.	C	T	0	2	2	0	4	6	0	0
8	31395632	.	A	C	2	3	5	0	0	5	0	0
8	31395644	.	T	C	4	1	5	0	0	5	0	0
8	31395749	.	C	G	1	4	5	0	0	5	0	0
8	31395795	.	G	A	2	2	4	0	0	4	0	0
8	31407126	.	A	T	14	8	22	0	1	23	0	0
8	31407168	.	C	A	9	8	17	0	0	17	0	0
8	31410872	.	C	T	5	6	11	0	0	11	0	0
8	31410887	.	G	A	1	2	3	0	0	3	0	0
8	31411089	.	C	T	1	9	10	0	4	14	0	0
8	31411176	.	T	G	4	5	9	0	1	10	0	0
8	31411638	.	G	T	1	4	5	0	1	6	0	0
8	31411858	.	A	G	5	5	10	0	0	10	0	0
8	31437497	.	G	C	2	2	4	0	0	4	0	0
8	31437626	.	C	T	6	3	9	0	2	11	0	0
8	31437671	.	T	C	0	0	0	0	1	1	0	0
8	31441870	.	T	C	13	12	25	0	1	26	0	0
8	31442523	.	C	G	8	11	19	0	0	19	0	0
8	31442595	.	G	A	16	9	25	0	0	25	0	0
8	31442794	.	G	T	15	9	24	0	2	26	0	0
8	31442835	.	T	A	1	29	30	0	6	36	0	0
8	31716001	.	G	T	1	3	4	0	0	4	0	0
8	31719059	.	C	T	2	1	3	0	0	3	0	0
8	31719077	.	T	C	1	2	3	0	0	3	0	0
8	31730419	.	G	T	1	8	9	0	0	9	0	0
8	31733870	.	C	T	2	3	5	0	0	5	0	0
8	31756865	.	T	C	1	1	2	0	0	2	0	0
8	31756940	.	T	C	4	3	7	0	1	8	0	0
8	31756946	.	T	C	4	1	5	0	2	7	0	0
8	31818022	.	G	A	0	16	16	0	19	35	0	0
8	31818083	.	A	T	13	15	28	0	1	29	0	0
8	31818371	.	A	G	17	11	28	0	2	30	0	0
8	31818425	.	A	C	11	7	18	0	4	22	0	0
8	31818456	.	A	G	6	4	10	0	1	11	0	0
8	31818745	.	C	T	21	9	30	0	0	30	0	0
8	31850955	.	A	T	9	11	20	0	0	20	0	0
8	31851150	.	A	C	3	3	6	0	2	8	0	0
8	31851594	.	T	C	1	5	6	0	1	7	0	0
8	31861425	.	A	G	11	9	20	0	1	21	0	0
8	31861479	.	C	T	14	14	28	0	0	28	0	0
8	31861580	.	G	C	12	14	26	0	2	28	0	0
8	31861615	.	A	C	20	9	29	0	1	30	0	0
8	31861742	.	G	A	21	13	34	0	2	36	0	0
8	31862165	.	C	T	16	10	26	0	4	30	0	0
8	31862384	.	A	G	19	16	35	0	4	39	0	0
8	31862407	.	G	A	21	18	39	0	4	43	0	0
8	31862584	.	G	T	17	12	29	0	1	30	0	0
8	31862670	.	T	A	15	12	27	0	7	34	0	0
8	31887845	.	G	A	2	2	4	0	3	7	0	0
8	31887859	.	G	T	2	3	5	0	1	6	0	0
8	31898706	.	C	T	4	5	9	0	0	9	0	0
8	31901659	.	A	G	7	12	19	0	3	22	0	0
8	31914427	.	A	T	8	2	10	0	0	10	0	0
8	31919101	.	G	C	3	4	7	0	0	7	0	0
8	31919451	.	G	T	6	7	13	0	1	14	0	0
8	31919548	.	C	T	16	4	20	0	2	22	0	0
8	31941904	.	T	A	3	3	6	0	0	6	0	0
8	31942099	.	C	T	6	4	10	0	1	11	0	0
8	31942174	.	G	A	0	6	6	0	8	14	0	0
8	31942723	.	G	A	6	8	14	0	1	15	0	0
8	32028856	.	G	T	4	6	10	0	0	10	0	0
8	32028921	.	T	A	8	6	14	0	0	14	0	0
8	32029267	.	G	A	4	5	9	0	0	9	0	0
8	32030087	.	G	A	1	2	3	0	0	3	0	0
8	32030107	.	G	A	1	2	3	0	0	3	0	0
8	32030538	.	G	A	1	2	3	0	0	3	0	0
8	32030771	.	T	G	5	4	9	0	0	9	0	0
8	32482851	.	C	T	17	15	32	0	3	35	0	0
8	32483536	.	C	T	4	4	8	0	0	8	0	0
8	32486956	.	C	T	0	13	13	0	6	19	0	0
8	32497629	.	G	T	7	4	11	0	0	11	0	0
8	32501541	.	A	G	2	2	4	0	1	5	0	0
8	32506175	.	G	T	2	5	7	0	0	7	0	0
8	32506183	.	A	G	4	2	6	0	0	6	0	0
8	32596634	.	A	T	1	2	3	0	0	3	0	0
8	32599363	.	T	C	9	4	13	0	1	14	0	0
8	32599421	.	T	C	11	13	24	0	1	25	0	0
8	32599432	.	T	G	10	16	26	0	0	26	0	0
8	32599556	.	C	G	12	9	21	0	0	21	0	0
8	32599743	.	A	G	6	5	11	0	0	11	0	0
8	32914694	.	C	T	4	9	13	0	2	15	0	0
8	32914748	.	G	T	13	4	17	0	0	17	0	0
8	32914782	.	T	A	5	6	11	0	0	11	0	0
8	32914813	.	A	T	2	3	5	0	0	5	0	0
8	32916957	.	T	A	2	0	2	0	0	2	0	0
8	32925670	.	T	G	2	4	6	0	1	7	0	0
8	32930837	.	C	T	4	2	6	0	0	6	0	0
8	33084515	.	A	G	2	0	2	0	0	2	0	0
8	33896326	.	A	T	19	13	32	0	3	35	0	0
8	33896698	.	A	G	15	18	33	0	2	35	0	0
8	33896922	.	G	A	14	16	30	0	5	35	0	0
8	33897274	.	C	T	2	17	19	0	24	43	0	0
8	33918631	.	C	T	8	4	12	0	0	12	0	0
8	33924432	.	C	T	0	15	15	0	10	25	0	0
8	34051719	.	G	A	11	7	18	0	2	20	0	0
8	34051795	.	T	C	5	8	13	0	0	13	0	0
8	34051930	.	T	G	8	10	18	0	2	20	0	0
8	34342376	.	G	A	7	11	18	0	1	19	0	0
8	34342409	.	A	G	8	5	13	0	0	13	0	0
8	34345285	.	G	A	2	4	6	0	0	6	0	0
8	35759444	.	C	T	6	4	10	0	0	10	0	0
8	35759999	.	C	T	4	10	14	0	0	14	0	0
8	35760328	.	C	T	4	2	6	0	0	6	0	0
8	35760338	.	T	C	2	4	6	0	0	6	0	0
8	36058873	.	T	A	1	2	3	0	0	3	0	0
8	36058882	.	A	C	1	2	3	0	0	3	0	0
8	36059335	.	G	T	1	2	3	0	0	3	0	0
8	36466904	.	T	A	5	3	8	1	0	9	0	0
8	36473141	.	G	T	1	2	3	0	0	3	0	0
8	36473144	.	A	G	1	2	3	0	0	3	0	0
8	36507567	.	C	A	2	2	4	0	0	4	0	0
8	36563192	.	G	A	0	2	2	0	0	2	0	0
8	36564746	.	C	T	0	1	1	0	3	4	0	0
8	36566353	.	T	C	6	4	10	0	1	11	0	0
8	36567193	.	T	A	10	11	21	0	0	21	0	0
8	36567208	.	A	T	12	15	27	0	3	30	0	0
8	36567316	.	T	C	17	9	26	0	1	27	0	0
8	36567349	.	A	C	6	3	9	0	6	15	0	0
8	36568304	.	C	T	19	12	31	0	0	31	0	0
8	36568492	.	T	C	1	1	2	0	0	2	0	0
8	36568561	.	A	G	8	3	11	0	0	11	0	0
8	36568755	.	T	C	0	1	1	0	0	1	0	0
8	36570965	.	C	T	2	2	4	0	0	4	0	0
8	36571018	.	A	C	1	1	2	0	0	2	0	0
8	36573796	.	C	T	3	2	5	0	0	5	0	0
8	36577332	.	G	A	2	1	3	0	0	3	0	0
8	36583834	.	T	C	2	1	3	0	0	3	0	0
8	36583877	.	C	A	4	3	7	0	0	7	0	0
8	36587934	.	A	G	9	5	14	0	0	14	0	0
8	36587936	.	A	G	9	0	9	0	5	14	0	0
8	36587970	.	C	A	13	11	24	0	2	26	0	0
8	36587981	.	G	T	11	11	22	0	2	24	0	0
8	36588600	.	G	T	0	1	1	0	3	4	0	0
8	36589226	.	T	C	6	6	12	0	3	15	0	0
8	36592011	.	A	G	9	7	16	0	0	16	0	0
8	36592018	.	A	G	9	8	17	0	0	17	0	0
8	36592101	.	T	C	3	0	3	0	8	11	0	0
8	36592237	.	T	C	6	15	21	0	1	22	0	0
8	36592374	.	A	G	5	3	8	0	0	8	0	0
8	36600801	.	C	G	2	11	13	0	0	13	0	0
8	36600803	.	T	G	2	11	13	0	0	13	0	0
8	36600840	.	T	C	2	0	2	0	18	20	0	0
8	36602459	.	C	T	3	2	5	0	0	5	0	0
8	36613882	.	G	T	3	8	11	0	0	11	0	0
8	36617619	.	G	A	3	0	3	0	1	4	0	0
8	36617635	.	C	G	2	3	5	0	0	5	0	0
8	36617669	.	A	G	4	6	10	0	1	11	0	0
8	36803574	.	C	A	5	2	7	0	0	7	0	0
8	36951346	.	C	T	3	4	7	0	1	8	0	0
8	36951481	.	C	T	2	6	8	0	0	8	0	0
8	36951610	.	T	C	0	4	4	0	0	4	0	0
8	36952015	.	A	G	5	0	5	0	16	21	0	0
8	36953884	.	A	G	1	1	2	0	0	2	0	0
8	36953947	.	C	T	2	2	4	0	0	4	0	0
8	36953950	.	G	C	2	2	4	0	0	4	0	0
8	36956254	.	C	T	8	7	15	0	0	15	0	0
8	36956269	.	T	C	8	6	14	0	0	14	0	0
8	36956516	.	G	A	0	1	1	0	1	2	0	0
8	36956540	.	C	A	1	5	6	0	1	7	0	0
8	36964126	.	G	A	5	5	10	0	1	11	0	0
8	36974076	.	C	A	11	8	19	0	2	21	0	0
8	36976089	.	T	C	5	11	16	0	0	16	0	0
8	36976288	.	T	A	3	4	7	0	0	7	0	0
8	36976557	.	G	A	15	20	35	0	1	36	0	0
8	36976966	.	C	T	26	15	41	0	2	43	0	0
8	36977170	.	C	T	21	16	37	0	3	40	0	0
8	37007527	.	T	C	1	0	1	0	0	1	0	0
8	37010662	.	T	C	6	0	6	0	1	7	0	0
8	37010668	.	C	T	6	1	7	0	0	7	0	0
8	37012762	.	T	A	5	3	8	0	1	9	0	0
8	37012825	.	C	T	1	2	3	0	0	3	0	0
8	37013093	.	A	G	6	4	10	0	0	10	0	0
8	37013255	.	T	C	3	3	6	0	1	7	0	0
8	37013282	.	T	C	4	4	8	0	0	8	0	0
8	37013833	.	C	T	2	6	8	0	2	10	0	0
8	37014582	.	T	C	2	4	6	0	0	6	0	0
8	37016584	.	G	T	0	12	12	0	10	22	0	0
8	37016658	.	C	A	16	7	23	0	3	26	0	0
8	37016752	.	A	G	7	10	17	0	0	17	0	0
8	37016790	.	T	C	5	10	15	0	2	17	0	0
8	37017149	.	G	A	1	2	3	0	0	3	0	0
8	37017159	.	C	T	1	1	2	0	0	2	0	0
8	37019059	.	G	A	16	12	28	0	2	30	0	0
8	37019113	.	G	A	15	13	28	0	1	29	0	0
8	37025566	.	C	T	12	12	24	0	2	26	0	0
8	37025576	.	A	T	12	10	22	0	0	22	0	0
8	37025614	.	T	A	3	6	9	0	2	11	0	0
8	37025633	.	A	G	1	0	1	0	2	3	0	0
8	37025896	.	T	C	6	13	19	0	4	23	0	0
8	37033173	.	T	G	0	1	1	0	0	1	0	0
8	37033185	.	A	T	0	1	1	0	0	1	0	0
8	37059934	.	A	C	1	3	4	0	0	4	0	0
8	37059952	.	A	G	1	3	4	0	0	4	0	0
8	37060149	.	G	T	3	3	6	0	1	7	0	0
8	37060234	.	T	A	3	6	9	0	0	9	0	0
8	37060305	.	C	T	0	4	4	0	4	8	0	0
8	37060412	.	C	T	0	3	3	0	2	5	0	0
8	37060434	.	C	A	4	4	8	0	0	8	0	0
8	37060580	.	G	A	7	9	16	0	0	16	0	0
8	37060595	.	A	T	8	9	17	0	2	19	0	0
8	37060702	.	C	T	7	6	13	0	2	15	0	0
8	37101346	.	T	C	1	2	3	0	0	3	0	0
8	37101370	.	G	C	2	2	4	0	0	4	0	0
8	37230447	.	C	T	1	2	3	0	0	3	0	0
8	37230678	.	C	T	1	2	3	0	0	3	0	0
8	37230700	.	C	A	0	2	2	0	1	3	0	0
8	37232289	.	T	A	9	12	21	0	2	23	0	0
8	37232312	.	G	C	13	9	22	0	2	24	0	0
8	37232419	.	G	A	11	9	20	0	3	23	0	0
8	37232487	.	A	C	21	20	41	0	3	44	0	0
8	37242374	.	A	T	3	1	4	0	1	5	0	0
8	37242438	.	T	C	1	3	4	0	0	4	0	0
8	37280748	.	T	C	5	8	13	0	0	13	0	0
8	37280752	.	C	T	5	7	12	0	0	12	0	0
8	37280809	.	G	T	7	11	18	0	0	18	0	0
8	37280845	.	G	A	8	11	19	0	0	19	0	0
8	37280865	.	C	T	6	10	16	0	1	17	0	0
8	37280923	.	T	A	5	5	10	0	1	11	0	0
8	37281109	.	T	C	2	4	6	0	1	7	0	0
8	37281382	.	A	T	1	1	2	0	1	3	0	0
8	37281440	.	T	A	9	10	19	0	0	19	0	0
8	37281444	.	T	A	7	12	19	0	2	21	0	0
8	37281547	.	G	A	6	12	18	0	1	19	0	0
8	37282088	.	C	T	3	2	5	0	0	5	0	0
8	37282110	.	A	T	2	4	6	0	0	6	0	0
8	37282126	.	G	T	2	3	5	0	0	5	0	0
8	37282407	.	G	A	13	9	22	0	0	22	0	0
8	37282848	.	C	T	8	7	15	0	0	15	0	0
8	37282888	.	G	A	5	5	10	0	0	10	0	0
8	37282911	.	G	T	4	5	9	0	0	9	0	0
8	37282950	.	T	G	2	2	4	0	2	6	0	0
8	37282986	.	G	A	5	3	8	0	0	8	0	0
8	37283016	.	T	A	6	5	11	0	0	11	0	0
8	37283054	.	A	G	2	3	5	0	3	8	0	0
8	37283070	.	T	A	2	4	6	0	0	6	0	0
8	37284386	.	A	G	9	7	16	0	0	16	0	0
8	37284428	.	T	G	10	7	17	0	1	18	0	0
8	37284478	.	A	G	11	6	17	0	1	18	0	0
8	37305515	.	G	C	0	1	1	0	0	1	0	0
8	37447683	.	T	A	4	3	7	0	0	7	0	0
8	37447696	.	C	T	3	3	6	0	1	7	0	0
8	37447751	.	C	T	1	1	2	0	0	2	0	0
8	37453430	.	T	A	4	2	6	0	1	7	0	0
8	37453646	.	T	A	1	2	3	0	1	4	0	0
8	37456522	.	A	T	0	1	1	0	0	1	0	0
8	37460616	.	A	T	3	1	4	0	0	4	0	0
8	37460743	.	T	C	1	0	1	0	0	1	0	0
8	37460746	.	C	T	0	0	0	0	1	1	0	0
8	37701364	.	C	T	1	1	2	0	0	2	0	0
8	38190775	.	T	C	2	3	5	0	0	5	0	0
8	38190785	.	T	C	3	2	5	0	0	5	0	0
8	38191562	.	G	C	1	0	1	0	2	3	0	0
8	38191564	.	G	C	0	2	2	0	1	3	0	0
8	38421515	.	C	A	3	5	8	0	1	9	0	0
8	38421535	.	A	C	3	5	8	0	0	8	0	0
8	38421627	.	T	A	1	2	3	0	0	3	0	0
8	38421640	.	A	T	2	2	4	0	0	4	0	0
8	38421820	.	C	T	10	11	21	0	2	23	0	0
8	38422058	.	G	A	4	7	11	0	2	13	0	0
8	38422439	.	G	A	5	7	12	0	2	14	0	0
8	38422748	.	C	G	3	1	4	0	1	5	0	0
8	38423210	.	A	G	7	4	11	0	2	13	0	0
8	38423250	.	G	A	6	7	13	0	2	15	0	0
8	38423297	.	A	G	3	8	11	0	0	11	0	0
8	38423373	.	A	T	4	3	7	0	0	7	0	0
8	38423462	.	A	G	3	10	13	0	1	14	0	0
8	38423529	.	C	G	0	5	5	0	4	9	0	0
8	38423617	.	C	T	2	4	6	0	0	6	0	0
8	38423641	.	A	G	1	0	1	0	0	1	0	0
8	38565008	.	A	G	7	6	13	0	1	14	0	0
8	38565040	.	C	T	7	9	16	0	1	17	0	0
8	38571041	.	T	A	2	0	2	0	0	2	0	0
8	38572620	.	C	T	0	3	3	0	0	3	0	0
8	38572885	.	T	C	3	2	5	0	0	5	0	0
8	38651053	.	A	C	0	2	2	0	0	2	0	0
8	39646768	.	G	A	3	7	10	0	1	11	0	0
8	39646781	.	T	C	3	4	7	0	4	11	0	0
8	39676552	.	C	T	4	3	7	0	0	7	0	0
8	39693130	.	C	T	5	3	8	0	0	8	0	0
8	39760860	.	C	T	28	24	52	0	1	53	0	0
8	39765798	.	A	G	44	27	71	0	2	73	0	0
8	39816887	.	C	G	2	2	4	0	0	4	0	0
8	39816893	.	G	A	2	2	4	0	0	4	0	0
8	39816992	.	C	T	5	8	13	0	0	13	0	0
8	39817011	.	A	G	3	7	10	0	0	10	0	0
8	39817031	.	T	G	2	5	7	0	1	8	0	0
8	39817054	.	A	T	0	2	2	0	0	2	0	0
8	39848745	.	G	C	11	5	16	0	0	16	0	0
8	39848967	.	A	T	2	7	9	0	0	9	0	0
8	39849336	.	A	G	2	1	3	0	0	3	0	0
8	39849354	.	C	T	1	3	4	0	0	4	0	0
8	39849373	.	A	T	2	6	8	0	0	8	0	0
8	39849394	.	C	G	2	6	8	0	1	9	0	0
8	39849422	.	T	G	3	6	9	0	0	9	0	0
8	39849439	.	G	T	1	3	4	0	0	4	0	0
8	39849524	.	C	T	7	5	12	0	0	12	0	0
8	39849617	.	A	G	1	3	4	0	0	4	0	0
8	39849728	.	A	T	2	1	3	0	1	4	0	0
8	39849767	.	A	T	3	5	8	0	0	8	0	0
8	39849791	.	A	G	4	5	9	0	1	10	0	0
8	39850149	.	C	T	2	3	5	0	2	7	0	0
8	39850157	.	A	G	1	4	5	0	1	6	0	0
8	39850251	.	C	T	2	4	6	0	1	7	0	0
8	39850455	.	G	A	3	3	6	0	0	6	0	0
8	39850500	.	C	G	3	2	5	0	0	5	0	0
8	39850625	.	T	A	3	4	7	0	0	7	0	0
8	39850759	.	C	T	2	4	6	0	1	7	0	0
8	39850776	.	A	T	5	2	7	0	0	7	0	0
8	39851514	.	A	G	3	3	6	0	1	7	0	0
8	39851966	.	T	G	1	3	4	0	0	4	0	0
8	39852036	.	G	T	1	2	3	0	0	3	0	0
8	39852514	.	C	T	1	2	3	0	0	3	0	0
8	39890197	.	T	C	4	2	6	0	1	7	0	0
8	39951571	.	G	A	3	2	5	0	1	6	0	0
8	39976817	.	C	T	13	8	21	0	2	23	0	0
8	39977153	.	C	G	14	11	25	0	0	25	0	0
8	39977333	.	G	A	15	7	22	0	1	23	0	0
8	39978559	.	A	G	1	0	1	0	0	1	0	0
8	40028680	.	A	G	2	3	5	0	0	5	0	0
8	40163223	.	C	T	8	15	23	0	1	24	0	0
8	40186581	.	A	G	1	2	3	0	0	3	0	0
8	40186747	.	A	G	4	6	10	0	0	10	0	0
8	40186982	.	A	T	1	6	7	0	0	7	0	0
8	40189738	.	A	T	0	2	2	0	0	2	0	0
8	40192696	.	T	A	1	0	1	0	1	2	0	0
8	40192708	.	G	A	2	0	2	0	0	2	0	0
8	40196220	.	T	C	2	2	4	0	0	4	0	0
8	40201496	.	G	A	1	2	3	0	0	3	0	0
8	40217948	.	G	A	1	4	5	0	0	5	0	0
8	40226297	.	T	C	2	1	3	0	0	3	0	0
8	40234640	.	C	T	5	2	7	0	0	7	0	0
8	40234764	.	C	T	3	5	8	0	1	9	0	0
8	40234830	.	A	G	6	5	11	0	3	14	0	0
8	40234831	.	T	A	7	7	14	0	0	14	0	0
8	40235184	.	A	T	5	5	10	0	0	10	0	0
8	40235244	.	C	T	5	9	14	0	0	14	0	0
8	40235281	.	G	A	3	8	11	0	0	11	0	0
8	40235348	.	G	C	6	4	10	0	1	11	0	0
8	40235717	.	A	G	3	2	5	0	0	5	0	0
8	40235720	.	A	G	2	3	5	0	0	5	0	0
8	40238057	.	G	A	1	2	3	0	0	3	0	0
8	40239180	.	T	A	3	3	6	0	1	7	0	0
8	40239190	.	T	A	3	4	7	0	0	7	0	0
8	40239238	.	C	T	1	2	3	0	0	3	0	0
8	40240922	.	C	G	14	5	19	0	2	21	0	0
8	40241161	.	A	G	20	17	37	0	3	40	0	0
8	40241304	.	C	T	1	23	24	0	18	42	0	0
8	40241364	.	T	G	21	25	46	0	1	47	0	0
8	40241441	.	A	G	11	15	26	8	3	37	0	0
8	40241446	.	A	G	9	19	28	8	3	39	0	0
8	40241640	.	A	T	14	8	22	2	1	25	0	0
8	40241681	.	A	G	10	6	16	0	8	24	0	0
8	40241695	.	T	A	14	7	21	0	1	22	0	0
8	40241718	.	T	C	11	7	18	0	0	18	0	0
8	40241976	.	C	A	23	16	39	0	1	40	0	0
8	40242005	.	T	G	22	12	34	0	3	37	0	0
8	40242107	.	A	T	18	10	28	0	1	29	0	0
8	40242131	.	A	C	14	14	28	0	0	28	0	0
8	40242243	.	A	C	23	10	33	0	3	36	0	0
8	40242424	.	T	A	13	10	23	0	1	24	0	0
8	40242453	.	G	A	11	11	22	0	0	22	0	0
8	40242613	.	T	A	3	6	9	0	2	11	0	0
8	40242653	.	C	T	5	6	11	0	0	11	0	0
8	40242683	.	A	C	4	3	7	0	0	7	0	0
8	40243052	.	G	C	16	7	23	0	2	25	0	0
8	40243148	.	T	C	17	10	27	0	1	28	0	0
8	40248373	.	T	G	5	5	10	0	1	11	0	0
8	40248976	.	G	T	1	1	2	0	0	2	0	0
8	40250747	.	C	A	0	7	7	0	10	17	0	0
8	40250798	.	G	A	9	11	20	0	1	21	0	0
8	40251045	.	A	T	6	7	13	0	0	13	0	0
8	40251380	.	G	T	3	10	13	0	1	14	0	0
8	40251700	.	C	G	1	2	3	0	0	3	0	0
8	40254366	.	A	G	4	5	9	0	0	9	0	0
8	40254375	.	T	G	3	4	7	0	1	8	0	0
8	40270856	.	G	A	3	2	5	0	0	5	0	0
8	40270905	.	A	G	8	4	12	0	0	12	0	0
8	40325798	.	C	T	10	8	18	0	0	18	0	0
8	40326072	.	A	T	12	21	33	0	2	35	0	0
8	40326087	.	A	T	13	15	28	0	6	34	0	0
8	40326128	.	C	T	10	13	23	0	3	26	0	0
8	40326736	.	A	G	1	3	4	0	1	5	0	0
8	40327227	.	A	G	1	1	2	0	1	3	0	0
8	40427540	.	T	C	1	3	4	0	0	4	0	0
8	40428486	.	C	A	1	3	4	0	0	4	0	0
8	40632305	.	C	T	4	5	9	0	0	9	0	0
8	40632499	.	T	C	7	3	10	0	0	10	0	0
8	40632509	.	C	A	7	6	13	0	0	13	0	0
8	40632545	.	C	T	6	6	12	0	0	12	0	0
8	40632758	.	A	C	10	7	17	0	0	17	0	0
8	40632793	.	A	T	9	4	13	0	1	14	0	0
8	40645084	.	T	C	5	3	8	0	0	8	0	0
8	40645113	.	C	T	4	2	6	0	0	6	0	0
8	40645524	.	A	T	1	2	3	0	0	3	0	0
8	40645602	.	A	G	7	6	13	0	2	15	0	0
8	41243772	.	T	C	1	0	1	0	0	1	0	0
8	41255573	.	T	C	12	8	20	0	4	24	0	0
8	41255750	.	G	A	5	3	8	0	1	9	0	0
8	41261002	.	A	G	24	19	43	0	2	45	0	0
8	41261092	.	T	A	22	28	50	0	2	52	0	0
8	41274394	.	T	C	1	2	3	0	0	3	0	0
8	41274561	.	T	C	3	2	5	0	0	5	0	0
8	41274617	.	G	A	3	1	4	0	2	6	0	0
8	41462497	.	A	G	2	0	2	0	21	23	0	0
8	41468868	.	C	T	1	2	3	0	2	5	0	0
8	41474547	.	T	C	4	2	6	0	0	6	0	0
8	41474556	.	G	A	4	2	6	0	0	6	0	0
8	41485993	.	A	G	1	1	2	0	0	2	0	0
8	41533605	.	T	C	1	2	3	0	1	4	0	0
8	41533738	.	A	T	1	2	3	0	1	4	0	0
8	42642120	.	C	A	0	11	11	0	8	19	0	0
8	42642199	.	T	G	9	13	22	0	1	23	0	0
8	42642247	.	G	C	14	11	25	0	0	25	0	0
8	42642434	.	C	T	11	6	17	0	2	19	0	0
8	42642641	.	A	T	4	2	6	0	0	6	0	0
8	42642671	.	T	A	5	2	7	0	1	8	0	0
8	42642879	.	G	A	4	4	8	0	0	8	0	0
8	42642941	.	G	T	3	3	6	0	0	6	0	0
8	42643153	.	G	T	4	3	7	0	0	7	0	0
8	42649431	.	G	C	3	0	3	0	0	3	0	0
8	42649485	.	G	A	6	7	13	0	1	14	0	0
8	42650538	.	T	C	0	1	1	0	0	1	0	0
8	42653389	.	A	G	2	2	4	0	0	4	0	0
8	42655774	.	G	T	1	2	3	0	0	3	0	0
8	42688884	.	C	G	2	3	5	0	0	5	0	0
8	42689483	.	A	T	1	1	2	0	0	2	0	0
8	42689492	.	G	A	1	2	3	0	0	3	0	0
8	42689805	.	T	C	1	2	3	0	0	3	0	0
8	42689922	.	A	T	1	2	3	0	0	3	0	0
8	42689924	.	C	T	1	1	2	0	1	3	0	0
8	42690067	.	T	A	2	4	6	0	0	6	0	0
8	42690499	.	G	T	2	1	3	0	1	4	0	0
8	42690749	.	G	A	1	2	3	0	0	3	0	0
8	42834146	.	T	C	5	5	10	0	1	11	0	0
8	44602209	.	G	A	6	2	8	0	0	8	0	0
8	45396028	.	T	C	4	0	4	0	4	8	0	0
8	45427189	.	C	A	1	3	4	0	0	4	0	0
8	45428039	.	C	T	12	9	21	0	0	21	0	0
8	45430757	.	G	A	2	7	9	0	0	9	0	0
8	45755117	.	G	A	1	7	8	0	2	10	0	0
8	45755185	.	T	C	2	7	9	0	0	9	0	0
8	45755212	.	G	T	2	3	5	0	0	5	0	0
8	45755577	.	G	A	1	3	4	0	0	4	0	0
8	45755816	.	T	C	34	35	69	0	1	70	0	0
8	45755973	.	C	G	11	23	34	0	1	35	0	0
8	45756191	.	A	G	23	35	58	0	8	66	0	0
8	45756206	.	G	A	24	28	52	0	5	57	0	0
8	45760071	.	A	C	3	1	4	0	10	14	0	0
8	45762619	.	A	G	2	2	4	0	0	4	0	0
8	45763374	.	T	C	1	2	3	0	0	3	0	0
8	45763562	.	G	A	16	15	31	1	3	35	0	0
8	45763991	.	A	G	21	21	42	0	0	42	0	0
8	45764006	.	G	C	24	22	46	0	1	47	0	0
8	45764118	.	C	T	0	18	18	0	21	39	0	0
8	45764697	.	T	C	13	5	18	0	0	18	0	0
8	45764939	.	G	A	22	10	32	0	4	36	0	0
8	45764988	.	A	T	22	12	34	0	0	34	0	0
8	45765023	.	T	A	23	7	30	0	2	32	0	0
8	45765024	.	T	A	23	6	29	0	3	32	0	0
8	45765305	.	G	A	6	7	13	0	3	16	0	0
8	45772915	.	C	A	7	10	17	0	2	19	0	0
8	45774471	.	C	T	0	0	0	0	1	1	0	0
8	45775047	.	C	T	3	2	5	0	0	5	0	0
8	45775068	.	A	T	2	2	4	0	0	4	0	0
8	45775304	.	G	A	1	2	3	0	0	3	0	0
8	45775319	.	G	T	2	3	5	0	1	6	0	0
8	45779729	.	A	C	4	3	7	0	0	7	0	0
8	45786186	.	C	T	0	2	2	0	2	4	0	0
8	45786528	.	A	G	0	1	1	0	0	1	0	0
8	45786615	.	A	G	3	4	7	0	0	7	0	0
8	45834940	.	G	A	1	2	3	0	0	3	0	0
8	45853288	.	A	C	0	2	2	0	0	2	0	0
8	45853344	.	T	A	2	4	6	0	1	7	0	0
8	45853626	.	G	A	3	3	6	0	0	6	0	0
8	45871782	.	A	G	3	3	6	0	0	6	0	0
8	45944896	.	T	A	4	2	6	0	0	6	0	0
8	45944983	.	G	A	2	3	5	0	0	5	0	0
8	45951974	.	G	A	0	6	6	0	5	11	0	0
8	45952152	.	A	T	8	6	14	0	0	14	0	0
8	45952281	.	C	T	6	6	12	0	1	13	0	0
8	45952352	.	G	C	6	4	10	0	0	10	0	0
8	45952437	.	G	A	0	10	10	0	6	16	0	0
8	45952461	.	G	A	0	5	5	0	6	11	0	0
8	45952492	.	C	A	1	4	5	0	0	5	0	0
8	45952547	.	G	T	1	1	2	0	0	2	0	0
8	46077879	.	C	A	5	9	14	0	0	14	0	0
8	46078168	.	C	A	6	3	9	0	0	9	0	0
8	46078241	.	A	T	10	6	16	0	5	21	0	0
8	46078264	.	A	T	9	9	18	0	3	21	0	0
8	46078287	.	A	G	11	6	17	0	0	17	0	0
8	46078342	.	C	G	6	5	11	0	0	11	0	0
8	46089052	.	T	C	0	3	3	0	0	3	0	0
8	46094790	.	G	A	1	0	1	0	0	1	0	0
8	46123731	.	G	A	1	2	3	0	0	3	0	0
8	46220600	.	C	T	1	1	2	0	0	2	0	0
8	46348145	.	G	T	2	3	5	0	0	5	0	0
8	46356282	.	G	A	0	1	1	0	0	1	0	0
8	46362082	.	G	A	1	2	3	0	0	3	0	0
8	46362083	.	G	T	1	2	3	0	0	3	0	0
8	46362293	.	G	A	1	1	2	0	0	2	0	0
8	46367300	.	C	T	4	1	5	0	0	5	0	0
8	46367312	.	G	A	4	1	5	0	0	5	0	0
8	46367371	.	G	A	0	1	1	0	0	1	0	0
8	46406145	.	C	A	1	2	3	0	0	3	0	0
8	46431453	.	A	T	4	3	7	0	0	7	0	0
8	46431631	.	G	C	1	1	2	0	0	2	0	0
8	46433637	.	T	C	3	2	5	0	1	6	0	0
8	46853005	.	A	T	0	5	5	0	0	5	0	0
8	46853015	.	A	T	0	3	3	0	1	4	0	0
8	46855313	.	G	A	2	3	5	0	0	5	0	0
8	46881326	.	G	T	4	2	6	0	0	6	0	0
8	47145008	.	A	G	7	10	17	0	3	20	0	0
8	47147333	.	A	T	38	29	67	0	0	67	0	0
8	47159323	.	C	T	2	2	4	0	0	4	0	0
8	47159514	.	G	A	4	1	5	0	0	5	0	0
8	47159557	.	C	A	2	1	3	0	0	3	0	0
8	47163244	.	G	A	1	0	1	0	0	1	0	0
8	47163283	.	G	A	0	0	0	0	1	1	0	0
8	47835146	.	T	C	1	5	6	0	1	7	0	0
8	47835148	.	C	T	1	6	7	0	0	7	0	0
8	47835307	.	A	T	1	3	4	0	0	4	0	0
8	47843557	.	T	A	1	1	2	0	1	3	0	0
8	47917304	.	C	T	1	1	2	0	0	2	0	0
8	47932442	.	G	A	0	2	2	0	0	2	0	0
8	47937152	.	T	C	3	1	4	0	3	7	0	0
8	47937156	.	A	G	4	0	4	0	3	7	0	0
8	47937263	.	T	C	4	5	9	0	0	9	0	0
8	47946517	.	T	C	11	8	19	0	1	20	0	0
8	47946674	.	G	A	3	3	6	0	0	6	0	0
8	47946753	.	C	T	9	11	20	0	0	20	0	0
8	47946776	.	T	C	7	11	18	0	2	20	0	0
8	47946833	.	A	G	6	8	14	0	2	16	0	0
8	47946846	.	A	G	6	7	13	0	2	15	0	0
8	47947052	.	A	C	6	3	9	0	1	10	0	0
8	47947297	.	C	T	13	7	20	0	0	20	0	0
8	47947341	.	C	A	8	9	17	0	1	18	0	0
8	47947649	.	T	A	21	13	34	0	0	34	0	0
8	47947772	.	A	G	10	1	11	0	16	27	0	0
8	47947996	.	T	G	15	12	27	0	0	27	0	0
8	47948102	.	T	A	16	10	26	0	1	27	0	0
8	47948141	.	G	T	13	14	27	0	0	27	0	0
8	47948162	.	T	C	12	8	20	0	1	22	1	0
8	47948602	.	G	A	0	19	19	0	19	38	0	0
8	47948755	.	C	T	14	21	35	0	4	39	0	0
8	47948820	.	A	C	8	11	19	0	4	23	0	0
8	47948866	.	C	A	4	5	9	0	1	10	0	0
8	48093139	.	T	C	3	4	7	0	1	8	0	0
8	48603552	.	T	C	2	1	3	0	0	3	0	0
8	48603788	.	G	C	0	7	7	0	8	15	0	0
8	48603978	.	T	A	3	7	10	0	0	10	0	0
8	48604114	.	T	A	8	4	12	0	2	14	0	0
8	48629668	.	G	A	3	3	6	0	0	6	0	0
8	48629797	.	C	A	5	3	8	0	2	10	0	0
8	48629946	.	A	T	3	5	8	0	1	9	0	0
8	48629969	.	T	C	2	0	2	0	6	8	0	0
8	48630017	.	A	G	0	2	2	0	0	2	0	0
8	48642433	.	G	A	1	2	3	0	0	3	0	0
8	48642496	.	A	G	1	2	3	0	1	4	0	0
8	48809531	.	C	G	4	4	8	0	0	8	0	0
8	48809570	.	G	A	4	2	6	0	0	6	0	0
8	48809587	.	T	G	3	1	4	0	0	4	0	0
8	48816412	.	C	G	1	4	5	0	0	5	0	0
8	48816474	.	G	A	1	2	3	0	0	3	0	0
8	48836142	.	T	C	0	0	0	0	1	1	0	0
8	48836148	.	G	A	0	1	1	0	0	1	0	0
8	48958387	.	A	C	0	3	3	0	0	3	0	0
8	48958392	.	T	C	0	3	3	0	1	4	0	0
8	48958637	.	A	G	0	9	9	0	2	11	0	0
8	48958822	.	C	T	15	10	25	0	2	27	0	0
8	48959047	.	G	A	4	7	11	0	3	14	0	0
8	49038025	.	C	T	1	0	1	0	0	1	0	0
8	49038026	.	A	G	0	0	0	0	1	1	0	0
8	49076847	.	T	A	1	2	3	0	0	3	0	0
8	49076849	.	C	G	1	2	3	0	0	3	0	0
8	49078827	.	A	C	0	2	2	0	0	2	0	0
8	49086105	.	G	T	3	1	4	0	0	4	0	0
8	49092108	.	C	T	3	2	5	0	0	5	0	0
8	49092129	.	C	T	1	1	2	0	0	2	0	0
8	49096541	.	G	T	1	6	7	0	0	7	0	0
8	49108347	.	A	T	8	12	20	0	1	21	0	0
8	49170190	.	T	A	9	6	15	0	1	16	0	0
8	49170366	.	T	A	6	9	15	0	1	16	0	0
8	49172338	.	A	G	5	3	8	0	0	8	0	0
8	49310830	.	C	T	1	4	5	0	0	5	0	0
8	49310928	.	T	C	1	2	3	0	0	3	0	0
8	49311090	.	C	T	3	14	17	0	3	20	0	0
8	49311355	.	T	C	15	10	25	0	0	25	0	0
8	49311396	.	C	A	12	11	23	0	0	23	0	0
8	49311398	.	G	C	12	10	22	0	1	23	0	0
8	49345191	.	T	C	5	4	9	0	0	9	0	0
8	49345212	.	G	T	4	3	7	0	0	7	0	0
8	49345272	.	A	G	3	2	5	0	0	5	0	0
8	49404152	.	G	T	20	23	43	0	8	51	0	0
8	49404262	.	C	T	30	33	63	0	2	65	0	0
8	49404502	.	C	T	24	36	60	0	2	62	0	0
8	49404928	.	C	T	30	38	68	0	4	72	0	0
8	49405248	.	A	G	4	2	6	0	0	6	0	0
8	49406062	.	G	C	2	2	4	0	0	4	0	0
8	49413417	.	G	T	32	28	60	0	4	64	0	0
8	49413444	.	G	A	18	30	48	0	9	57	0	0
8	49413459	.	G	A	23	26	49	0	6	55	0	0
8	49415718	.	G	C	2	1	3	0	1	4	0	0
8	49435964	.	C	G	2	0	2	0	1	3	0	0
8	49443191	.	A	G	2	0	2	0	5	7	0	0
8	49447458	.	A	T	3	0	3	0	1	4	0	0
8	49447519	.	G	A	4	7	11	0	0	11	0	0
8	49447657	.	C	A	2	5	7	0	0	7	0	0
8	49478133	.	A	T	1	2	3	0	0	3	0	0
8	49478176	.	G	A	1	2	3	0	0	3	0	0
8	49710686	.	G	A	1	0	1	0	0	1	0	0
8	49722313	.	T	C	3	7	10	0	0	10	0	0
8	49745727	.	T	G	3	3	6	0	0	6	0	0
8	49746224	.	T	C	3	9	12	0	1	13	0	0
8	49746256	.	G	A	5	14	19	0	0	19	0	0
8	49746440	.	T	C	19	16	35	0	5	40	0	0
8	49746456	.	T	G	17	14	31	0	1	32	0	0
8	49755801	.	A	C	12	14	26	0	3	29	0	0
8	49755867	.	A	T	15	13	28	0	1	29	0	0
8	49756121	.	A	T	8	13	21	0	1	22	0	0
8	49759453	.	A	G	5	0	5	0	0	5	0	0
8	49768420	.	C	T	2	2	4	0	0	4	0	0
8	49768925	.	G	A	1	3	4	0	1	5	0	0
8	49769496	.	G	A	4	4	8	0	1	9	0	0
8	49845392	.	A	G	3	2	5	0	0	5	0	0
8	49860718	.	C	T	3	3	6	0	0	6	0	0
8	49864212	.	C	T	3	3	6	0	1	7	0	0
8	49864232	.	G	A	3	2	5	0	0	5	0	0
8	49864531	.	G	A	0	3	3	0	2	5	0	0
8	49864610	.	G	A	0	3	3	0	2	5	0	0
8	49865070	.	G	A	3	3	6	0	0	6	0	0
8	49947483	.	C	T	1	3	4	0	1	5	0	0
8	49949798	.	C	T	0	2	2	0	0	2	0	0
8	49969037	.	C	T	4	3	7	0	2	9	0	0
8	49969135	.	G	C	0	4	4	0	1	5	0	0
8	50170889	.	T	C	1	6	7	0	0	7	0	0
8	50179868	.	T	A	6	10	16	0	1	17	0	0
8	50731973	.	A	G	0	10	10	0	0	10	0	0
8	50812321	.	G	A	2	2	4	0	0	4	0	0
8	50818102	.	G	T	0	5	5	0	0	5	0	0
8	50818180	.	C	T	2	3	5	0	1	6	0	0
8	50837603	.	C	T	2	2	4	0	0	4	0	0
8	50837684	.	G	C	2	3	5	0	0	5	0	0
8	50845104	.	T	C	0	0	0	0	1	1	0	0
8	50890422	.	A	T	4	2	6	0	0	6	0	0
8	50942296	.	T	G	6	3	9	0	1	10	0	0
8	50947386	.	G	C	3	0	3	0	1	4	0	0
8	50947648	.	T	A	14	7	21	0	0	21	0	0
8	50947807	.	C	T	3	2	5	0	1	6	0	0
8	50948620	.	A	G	7	0	7	1	12	20	0	0
8	50948623	.	T	C	7	11	18	1	2	21	0	0
8	50949040	.	T	A	7	16	23	0	2	25	0	0
8	50949086	.	T	A	3	8	11	0	0	11	0	0
8	50949128	.	T	C	4	10	14	0	0	14	0	0
8	50949160	.	A	T	13	6	19	0	1	20	0	0
8	50949188	.	C	T	12	10	22	0	1	23	0	0
8	50949430	.	T	A	27	13	40	0	2	42	0	0
8	50949479	.	A	G	14	33	47	0	1	48	0	0
8	50949501	.	A	T	31	18	49	0	1	50	0	0
8	50949570	.	G	A	19	19	38	0	4	42	0	0
8	50949573	.	G	A	18	21	39	0	1	40	0	0
8	50949639	.	C	T	16	18	34	0	4	38	0	0
8	50949766	.	C	T	6	8	14	0	1	15	0	0
8	50960443	.	C	A	12	13	25	0	0	25	0	0
8	50960542	.	T	C	5	2	7	0	0	7	0	0
8	50962536	.	T	C	2	3	5	0	0	5	0	0
8	50967774	.	C	G	2	7	9	0	1	10	0	0
8	50967890	.	C	T	3	9	12	0	0	12	0	0
8	50969141	.	T	C	3	3	6	0	1	7	0	0
8	50969150	.	A	G	4	3	7	0	1	8	0	0
8	50969367	.	G	A	3	2	5	0	1	6	0	0
8	50969493	.	T	A	4	5	9	0	0	9	0	0
8	50971524	.	G	A	4	3	7	0	0	7	0	0
8	50972267	.	C	T	2	2	4	0	0	4	0	0
8	50981034	.	A	G	0	1	1	0	0	1	0	0
8	51165572	.	T	C	10	12	22	0	2	24	0	0
8	51165786	.	C	A	1	8	9	0	11	20	0	0
8	51173843	.	A	G	3	4	7	0	1	8	0	0
8	51308433	.	C	A	1	3	4	0	1	5	0	0
8	51309145	.	T	G	9	8	17	0	1	18	0	0
8	51309311	.	A	G	4	2	6	0	0	6	0	0
8	51314087	.	G	A	7	7	14	0	0	14	0	0
8	51320547	.	C	T	3	2	5	0	1	6	0	0
8	51320652	.	C	T	3	2	5	0	0	5	0	0
8	51325510	.	T	G	5	1	6	0	1	7	0	0
8	51330776	.	T	C	0	4	4	0	0	4	0	0
8	51330836	.	A	T	2	2	4	0	0	4	0	0
8	51351121	.	C	T	10	8	18	0	0	18	0	0
8	51351155	.	T	A	10	2	12	0	0	13	1	0
8	51351200	.	A	T	15	6	21	0	2	23	0	0
8	51352480	.	A	G	7	12	19	0	1	20	0	0
8	51352525	.	A	T	0	3	3	0	0	3	0	0
8	51358769	.	G	A	2	0	2	0	0	2	0	0
8	51364515	.	T	C	7	3	10	0	0	10	0	0
8	51364644	.	C	A	0	12	12	0	11	23	0	0
8	51364665	.	T	C	9	10	19	0	2	21	0	0
8	51364696	.	C	G	4	5	9	0	1	10	0	0
8	51364713	.	C	A	0	1	1	0	1	2	0	0
8	51367178	.	A	T	3	1	4	0	0	4	0	0
8	51367206	.	C	T	5	1	6	0	0	6	0	0
8	51367217	.	C	T	8	1	9	0	0	9	0	0
8	51367267	.	A	T	6	7	13	0	0	13	0	0
8	51375405	.	T	G	10	9	19	0	0	19	0	0
8	51431477	.	G	A	1	4	5	0	1	6	0	0
8	51431526	.	A	T	2	4	6	0	0	6	0	0
8	51431561	.	A	G	1	4	5	0	1	6	0	0
8	51431573	.	A	T	3	3	6	0	0	6	0	0
8	51431805	.	T	A	2	3	5	0	1	6	0	0
8	51432107	.	T	C	0	4	4	0	0	4	0	0
8	51433088	.	C	T	3	2	5	0	0	5	0	0
8	51434289	.	C	T	1	3	4	0	0	4	0	0
8	51573293	.	A	G	1	2	3	0	0	3	0	0
8	51576856	.	C	T	0	2	2	0	2	4	0	0
8	51576887	.	C	T	0	3	3	0	5	8	0	0
8	51721300	.	C	T	0	2	2	0	1	3	0	0
8	51723164	.	C	T	1	3	4	0	1	5	0	0
8	51723249	.	A	G	2	3	5	2	0	7	0	0
8	51723984	.	A	T	1	4	5	0	0	5	0	0
8	51724029	.	T	G	1	5	6	0	0	6	0	0
8	51724067	.	C	T	1	1	2	0	1	3	0	0
8	51724288	.	G	A	3	2	5	0	0	5	0	0
8	51724857	.	G	A	2	3	5	0	0	5	0	0
8	51724974	.	G	A	1	4	5	0	1	6	0	0
8	51725058	.	G	T	2	5	7	0	0	7	0	0
8	51725237	.	C	G	4	2	6	0	0	6	0	0
8	51725241	.	G	T	3	3	6	0	2	8	0	0
8	51726166	.	C	T	3	3	6	0	1	7	0	0
8	51726260	.	C	G	2	4	6	0	0	6	0	0
8	51726299	.	T	A	3	4	7	0	1	8	0	0
8	52336870	.	T	C	0	0	0	0	1	1	0	0
8	52342586	.	A	C	3	3	6	0	0	6	0	0
8	52345733	.	T	C	3	1	4	0	0	4	0	0
8	52345751	.	T	C	4	4	8	0	0	8	0	0
8	52345915	.	T	C	1	7	8	0	0	8	0	0
8	52346035	.	T	C	2	2	4	0	1	5	0	0
8	52346225	.	A	T	2	2	4	0	0	4	0	0
8	52347460	.	C	T	2	7	9	0	1	10	0	0
8	52348648	.	A	G	6	2	8	0	0	8	0	0
8	52348685	.	T	C	6	3	9	0	0	9	0	0
8	52349080	.	T	G	4	4	8	0	0	8	0	0
8	52349604	.	A	G	15	11	26	0	1	27	0	0
8	52349607	.	A	G	5	22	27	0	1	28	0	0
8	52350101	.	A	G	9	0	9	0	11	22	2	0
8	52350251	.	A	G	14	12	26	0	2	28	0	0
8	52350322	.	T	G	4	5	9	0	2	11	0	0
8	52408619	.	G	A	14	24	38	0	3	41	0	0
8	52411451	.	T	C	5	4	9	0	1	10	0	0
8	52412982	.	A	G	8	12	20	0	0	20	0	0
8	52412985	.	C	G	8	10	18	0	2	20	0	0
8	52455588	.	A	G	1	1	2	0	0	2	0	0
8	52455610	.	A	G	2	2	4	0	0	4	0	0
8	52455638	.	C	G	2	2	4	0	0	4	0	0
8	52491586	.	G	A	3	2	5	0	0	5	0	0
8	52509559	.	C	A	3	2	5	0	1	6	0	0
8	52509568	.	C	A	3	1	4	0	0	4	0	0
8	52527359	.	C	G	2	4	6	0	0	6	0	0
8	52527391	.	A	T	3	4	7	0	0	7	0	0
8	52527486	.	G	A	5	2	7	0	0	7	0	0
8	52527547	.	A	C	4	2	6	0	0	6	0	0
8	52528717	.	A	G	8	7	15	0	0	15	0	0
8	52528766	.	A	G	10	4	14	0	0	14	0	0
8	52528856	.	C	G	2	2	4	0	0	4	0	0
8	52529206	.	T	C	10	5	15	0	0	15	0	0
8	52529397	.	A	G	15	4	19	0	0	19	0	0
8	52534158	.	A	G	1	0	1	0	0	1	0	0
8	52538042	.	A	T	1	2	3	0	0	3	0	0
8	52543717	.	C	A	0	3	3	0	0	3	0	0
8	52547038	.	T	G	3	7	10	0	1	11	0	0
8	52547091	.	T	C	7	4	11	0	2	13	0	0
8	52547356	.	A	G	4	7	11	0	2	13	0	0
8	52547522	.	C	T	5	2	7	0	0	7	0	0
8	52547523	.	G	A	0	2	2	0	5	7	0	0
8	52547569	.	T	A	10	4	14	0	0	14	0	0
8	52547664	.	A	C	2	4	6	0	0	6	0	0
8	52547677	.	C	T	2	4	6	0	0	6	0	0
8	52547706	.	A	T	2	3	5	0	1	6	0	0
8	52547727	.	G	C	2	2	4	0	0	4	0	0
8	52547787	.	T	A	1	4	5	0	0	5	0	0
8	52547829	.	T	G	2	3	5	0	0	5	0	0
8	52550462	.	A	G	4	5	9	0	1	10	0	0
8	52550502	.	T	A	8	4	12	0	1	13	0	0
8	52553193	.	A	T	2	6	8	0	4	12	0	0
8	52553197	.	A	G	2	8	10	0	0	10	0	0
8	52554937	.	T	G	4	5	9	0	0	9	0	0
8	52554983	.	C	T	6	4	10	0	2	12	0	0
8	52555018	.	T	G	5	8	13	0	1	14	0	0
8	52555050	.	G	A	5	10	15	0	2	17	0	0
8	52555077	.	C	G	3	13	16	0	1	17	0	0
8	52555112	.	G	T	5	9	14	0	1	15	0	0
8	52555137	.	G	A	8	8	16	0	2	18	0	0
8	52557454	.	G	T	2	0	2	0	0	2	0	0
8	52562746	.	C	T	0	2	2	0	0	2	0	0
8	52564816	.	T	C	1	1	2	0	0	2	0	0
8	52564922	.	C	T	1	2	3	0	0	3	0	0
8	52565319	.	T	C	4	2	6	0	0	6	0	0
8	52571198	.	T	C	1	1	2	0	0	2	0	0
8	52580094	.	A	G	1	0	1	0	0	1	0	0
8	52580169	.	A	G	1	3	4	0	0	4	0	0
8	52580196	.	A	T	0	1	1	0	0	1	0	0
8	52630142	.	G	T	1	1	2	0	1	3	0	0
8	52630193	.	A	G	1	3	4	0	0	4	0	0
8	53398564	.	A	G	4	7	11	0	1	12	0	0
8	53398992	.	A	G	5	2	7	0	0	7	0	0
8	53399003	.	A	G	4	2	6	0	0	6	0	0
8	53401230	.	C	A	0	4	4	2	0	6	0	0
8	53401234	.	G	A	0	1	1	0	1	2	0	0
8	54130268	.	A	G	5	2	7	0	1	8	0	0
8	54130354	.	A	G	6	3	9	0	1	10	0	0
8	54221390	.	T	C	20	5	25	0	5	30	0	0
8	54303407	.	A	G	2	4	6	0	0	6	0	0
9	38298	.	A	G	0	0	0	0	1	1	0	0
9	38326	.	C	T	0	7	7	0	0	7	0	0
9	85318	.	T	C	1	6	7	0	0	7	0	0
9	168626	.	T	C	1	8	9	0	0	9	0	0
9	168629	.	T	C	1	7	8	0	0	8	0	0
9	169030	.	T	C	3	2	5	0	0	5	0	0
9	462959	.	T	G	10	2	12	0	4	16	0	0
9	529156	.	G	A	1	3	4	0	0	4	0	0
9	1577542	.	C	A	0	4	4	0	0	4	0	0
9	2483509	.	A	G	8	3	11	0	1	12	0	0
9	2564111	.	G	A	6	11	17	0	1	18	0	0
9	2564178	.	C	A	11	17	28	0	2	30	0	0
9	2564656	.	G	T	7	1	8	0	1	9	0	0
9	2564699	.	A	G	10	8	18	0	0	18	0	0
9	2564790	.	A	T	2	0	2	0	0	2	0	0
9	2567323	.	G	A	13	7	20	0	1	21	0	0
9	2568670	.	T	A	11	2	13	0	1	14	0	0
9	2568768	.	G	T	3	9	12	0	3	15	0	0
9	2572737	.	C	A	6	3	9	0	0	9	0	0
9	2572756	.	A	T	3	8	11	0	0	11	0	0
9	2574159	.	T	C	1	2	3	0	0	3	0	0
9	2574225	.	T	C	4	3	7	0	1	8	0	0
9	2574227	.	A	G	4	3	7	0	1	8	0	0
9	2586259	.	A	G	9	4	13	0	1	14	0	0
9	2592518	.	A	T	7	4	11	0	2	13	0	0
9	2592519	.	T	A	5	6	11	0	2	13	0	0
9	2592675	.	G	A	10	12	22	0	1	23	0	0
9	2592933	.	T	C	2	6	8	0	0	8	0	0
9	2592960	.	A	G	3	6	9	0	0	9	0	0
9	3135171	.	T	C	2	0	2	0	5	7	0	0
9	3135794	.	A	G	0	2	2	0	0	2	0	0
9	3135809	.	A	G	2	2	4	0	1	5	0	0
9	3136107	.	C	T	0	3	3	0	1	4	0	0
9	3149541	.	T	C	3	4	7	0	0	7	0	0
9	3149595	.	A	G	3	3	6	0	1	7	0	0
9	3149600	.	A	T	3	5	8	0	0	8	0	0
9	3228214	.	C	T	1	0	1	0	0	1	0	0
9	3231242	.	C	T	1	4	5	0	0	5	0	0
9	3231378	.	C	A	0	13	13	0	1	14	0	0
9	3231675	.	C	T	2	2	4	0	0	4	0	0
9	3231778	.	G	T	0	2	2	0	2	4	0	0
9	3231795	.	T	C	3	2	5	0	0	5	0	0
9	3231978	.	C	A	1	3	4	0	1	5	0	0
9	3232180	.	T	A	4	2	6	0	0	6	0	0
9	3232198	.	C	T	2	2	4	0	0	4	0	0
9	3232523	.	T	G	11	5	16	0	0	16	0	0
9	3232607	.	T	A	3	9	12	0	1	13	0	0
9	3232672	.	C	T	6	5	11	0	0	11	0	0
9	3232763	.	T	C	4	7	11	0	0	11	0	0
9	3286386	.	G	A	1	1	2	0	1	3	0	0
9	3313920	.	G	T	9	13	22	0	1	23	0	0
9	3388974	.	C	T	4	0	4	0	0	4	0	0
9	3389545	.	G	A	0	1	1	0	0	1	0	0
9	3390035	.	G	A	17	4	21	0	0	21	0	0
9	3397526	.	G	A	3	2	5	0	0	5	0	0
9	3397558	.	G	A	5	3	8	0	0	8	0	0
9	3397648	.	A	C	6	4	10	0	2	12	0	0
9	3398243	.	T	A	7	6	13	0	1	14	0	0
9	3398247	.	G	A	9	6	15	0	0	15	0	0
9	3398328	.	C	A	1	9	10	0	11	21	0	0
9	3398354	.	T	C	7	1	8	0	9	17	0	0
9	3465350	.	A	T	1	1	2	0	0	2	0	0
9	3465357	.	A	G	1	0	1	0	1	2	0	0
9	3474856	.	T	C	1	0	1	0	0	1	0	0
9	3480057	.	A	G	2	3	5	0	0	5	0	0
9	3480076	.	C	T	1	2	3	0	1	4	0	0
9	3483164	.	T	C	2	3	5	0	1	6	0	0
9	3485822	.	G	A	0	6	6	0	3	9	0	0
9	3485867	.	A	T	4	2	6	0	0	6	0	0
9	3485868	.	T	C	3	1	4	0	2	6	0	0
9	3486134	.	T	G	4	5	9	0	1	11	1	0
9	3486220	.	C	T	2	3	5	0	0	5	0	0
9	3486223	.	C	T	2	3	5	0	0	5	0	0
9	3509076	.	A	G	0	0	0	0	1	1	0	0
9	3605652	.	C	T	8	8	16	0	0	16	0	0
9	3608867	.	T	A	15	9	24	0	0	24	0	0
9	3621980	.	T	C	4	3	7	0	0	7	0	0
9	3627189	.	T	C	2	4	6	0	0	6	0	0
9	3635791	.	G	A	1	1	2	0	0	2	0	0
9	3666541	.	A	C	16	11	27	0	0	27	0	0
9	3666601	.	A	T	16	7	23	0	0	23	0	0
9	3666666	.	T	C	13	15	28	0	3	31	0	0
9	3666947	.	G	A	9	2	11	0	1	12	0	0
9	3666948	.	T	C	5	0	5	0	7	12	0	0
9	3667136	.	G	A	9	13	22	0	0	22	0	0
9	3667338	.	T	A	9	8	17	0	1	18	0	0
9	3667377	.	C	A	7	4	11	0	2	13	0	0
9	3667398	.	C	A	4	6	10	0	3	13	0	0
9	3667459	.	C	T	2	4	6	0	0	6	0	0
9	3668198	.	A	C	5	3	8	0	1	9	0	0
9	3668199	.	G	C	5	3	8	0	1	9	0	0
9	3898275	.	T	C	4	7	11	0	0	11	0	0
9	3898276	.	T	C	4	0	4	0	7	11	0	0
9	3900878	.	T	A	2	3	5	0	3	8	0	0
9	3901007	.	A	T	5	4	9	0	1	10	0	0
9	3901081	.	C	T	7	7	14	0	0	14	0	0
9	3901118	.	A	C	10	7	17	0	1	18	0	0
9	3901187	.	T	A	5	1	6	0	0	6	0	0
9	3905921	.	G	A	3	3	6	0	0	6	0	0
9	3912739	.	G	A	1	2	3	0	0	3	0	0
9	4267062	.	T	C	0	1	1	0	0	1	0	0
9	4267072	.	T	C	1	2	3	0	0	3	0	0
9	4267101	.	C	G	1	2	3	0	0	3	0	0
9	4310069	.	C	T	0	3	3	0	0	3	0	0
9	4323147	.	C	T	2	3	5	0	0	5	0	0
9	4323249	.	C	T	1	2	3	0	0	3	0	0
9	4332223	.	C	T	2	3	5	0	0	5	0	0
9	4336543	.	A	G	1	1	2	0	0	2	0	0
9	4336585	.	T	C	1	1	2	0	0	2	0	0
9	4344553	.	C	T	4	3	7	0	0	7	0	0
9	5042724	.	G	T	3	2	5	0	0	5	0	0
9	5042772	.	C	T	2	1	3	0	0	3	0	0
9	5345770	.	G	A	2	2	4	0	0	4	0	0
9	7092424	.	T	C	8	4	12	0	1	13	0	0
9	7092457	.	T	C	9	7	16	0	0	16	0	0
9	7094898	.	T	C	13	6	19	0	1	20	0	0
9	7228348	.	C	A	10	20	30	0	2	32	0	0
9	7228544	.	C	T	2	2	4	0	1	5	0	0
9	7228753	.	T	G	8	11	19	0	1	20	0	0
9	7228805	.	T	A	7	3	10	0	1	11	0	0
9	7229210	.	C	T	12	14	26	0	2	28	0	0
9	7229218	.	G	A	13	16	29	0	2	31	0	0
9	7229248	.	G	A	17	14	31	0	1	32	0	0
9	7229262	.	C	G	17	10	27	0	1	28	0	0
9	7229512	.	C	T	12	11	23	0	1	24	0	0
9	7234618	.	A	C	7	0	7	0	8	15	0	0
9	7234642	.	G	A	8	8	16	0	0	16	0	0
9	7238498	.	C	T	8	4	12	0	1	13	0	0
9	7238502	.	C	A	9	4	13	0	1	14	0	0
9	7241118	.	G	A	2	3	5	0	1	6	0	0
9	7241409	.	G	T	5	5	10	0	0	10	0	0
9	7241658	.	A	T	0	3	3	0	0	3	0	0
9	7241663	.	A	C	1	3	4	0	0	4	0	0
9	7242076	.	A	G	3	5	8	0	0	8	0	0
9	7242309	.	T	A	1	2	3	0	0	3	0	0
9	7245004	.	C	T	2	3	5	0	0	5	0	0
9	7245218	.	C	T	1	3	4	0	0	4	0	0
9	7245226	.	A	G	1	2	3	0	1	4	0	0
9	7245307	.	A	T	2	2	4	0	0	4	0	0
9	7245327	.	C	T	3	2	5	0	0	5	0	0
9	7245445	.	C	A	2	2	4	0	1	5	0	0
9	7245472	.	A	G	2	2	4	0	0	4	0	0
9	7245681	.	C	G	2	1	3	0	0	3	0	0
9	7248984	.	C	T	1	3	4	0	1	5	0	0
9	7249016	.	C	T	1	2	3	0	0	3	0	0
9	7276259	.	G	A	3	2	5	0	0	5	0	0
9	7499322	.	G	A	0	3	3	0	3	6	0	0
9	7516095	.	G	T	2	2	4	0	1	5	0	0
9	7570891	.	T	A	8	7	15	0	1	16	0	0
9	7574042	.	T	A	1	4	5	0	1	6	0	0
9	7574126	.	C	T	2	2	4	0	0	5	1	0
9	7574135	.	A	T	1	2	3	0	0	3	0	0
9	7575309	.	G	A	5	3	8	0	0	8	0	0
9	7575545	.	A	C	1	2	3	0	0	3	0	0
9	7578595	.	G	C	0	1	1	0	1	2	0	0
9	7604524	.	G	A	6	9	15	0	2	17	0	0
9	7618903	.	A	C	12	7	19	0	0	19	0	0
9	7618906	.	T	C	12	7	19	0	1	20	0	0
9	7621877	.	C	T	3	3	6	0	1	7	0	0
9	7635922	.	A	G	0	3	3	0	0	3	0	0
9	7635925	.	G	A	0	3	3	0	0	3	0	0
9	7671165	.	G	A	1	4	5	0	1	6	0	0
9	8121041	.	C	T	2	2	4	0	0	4	0	0
9	8121128	.	C	T	5	3	8	0	0	8	0	0
9	8121855	.	G	T	1	4	5	0	0	5	0	0
9	8121939	.	G	T	2	2	4	0	0	4	0	0
9	8122095	.	A	T	7	4	11	0	0	11	0	0
9	8429899	.	A	G	15	8	23	0	5	28	0	0
9	8430558	.	A	C	7	7	14	0	0	14	0	0
9	8430787	.	A	G	3	9	12	0	0	12	0	0
9	8430831	.	C	T	0	4	4	0	6	10	0	0
9	8431031	.	A	G	18	8	26	0	0	26	0	0
9	8431214	.	C	T	0	9	9	0	9	18	0	0
9	8431256	.	G	A	5	9	14	0	1	15	0	0
9	8431345	.	A	C	3	0	3	0	4	7	0	0
9	8431450	.	A	G	5	8	13	0	0	13	0	0
9	8431541	.	A	T	10	5	15	0	0	15	0	0
9	8431714	.	G	T	7	4	11	0	0	11	0	0
9	8431772	.	C	T	9	4	13	0	2	15	0	0
9	8431814	.	A	G	5	10	15	0	1	16	0	0
9	8431837	.	T	C	4	10	14	0	0	14	0	0
9	8431854	.	T	C	5	8	13	0	1	14	0	0
9	8431894	.	A	G	6	7	13	0	1	14	0	0
9	8432695	.	C	T	4	3	7	0	1	8	0	0
9	8432768	.	A	T	6	3	9	0	0	9	0	0
9	8432996	.	G	A	5	8	13	0	0	13	0	0
9	8433189	.	C	T	5	2	7	0	1	8	0	0
9	8450740	.	G	A	1	5	6	0	0	6	0	0
9	8450788	.	G	A	2	4	6	0	1	7	0	0
9	8451326	.	T	C	3	2	5	0	0	5	0	0
9	8451386	.	C	T	0	3	3	0	2	5	0	0
9	8451540	.	C	T	1	3	4	0	1	5	0	0
9	8888388	.	A	G	3	4	7	0	0	7	0	0
9	8899665	.	C	T	3	3	6	0	0	6	0	0
9	8899704	.	C	T	2	7	9	0	0	9	0	0
9	8914657	.	G	C	1	3	4	0	1	5	0	0
9	8923188	.	A	T	5	7	12	0	1	13	0	0
9	8929848	.	G	T	3	3	6	0	1	7	0	0
9	8929905	.	G	A	0	8	8	0	4	12	0	0
9	8964977	.	C	T	4	2	6	0	0	6	0	0
9	8964997	.	C	T	5	3	8	0	0	8	0	0
9	8965027	.	A	G	4	5	9	0	0	9	0	0
9	8967442	.	G	A	14	14	28	0	1	29	0	0
9	8967459	.	C	T	13	14	27	0	5	32	0	0
9	8971713	.	G	A	18	10	28	0	0	28	0	0
9	8971995	.	A	C	9	13	22	0	5	27	0	0
9	8972429	.	T	A	13	11	24	0	0	24	0	0
9	8973080	.	G	A	4	4	8	0	0	8	0	0
9	8973093	.	C	T	2	4	6	0	0	6	0	0
9	8973227	.	T	C	4	1	5	0	1	6	0	0
9	8973581	.	G	A	0	2	2	0	1	3	0	0
9	8973627	.	C	A	5	4	9	0	0	9	0	0
9	8973629	.	G	A	5	3	8	0	1	9	0	0
9	8974152	.	G	A	8	7	15	0	0	15	0	0
9	9116101	.	C	T	1	0	1	0	0	1	0	0
9	9118363	.	A	C	2	1	3	0	0	3	0	0
9	9118602	.	G	A	4	2	6	0	1	7	0	0
9	9118991	.	C	T	5	5	10	0	0	10	0	0
9	9118994	.	C	T	5	5	10	0	0	10	0	0
9	9119546	.	A	G	0	2	2	0	0	2	0	0
9	9119671	.	G	C	1	2	3	0	1	4	0	0
9	9119755	.	G	T	3	3	6	0	1	7	0	0
9	9119771	.	T	A	2	3	5	0	1	6	0	0
9	9119830	.	A	T	1	2	3	0	0	3	0	0
9	9119877	.	G	A	5	3	8	0	0	8	0	0
9	9120271	.	T	C	6	5	11	0	1	12	0	0
9	9120517	.	A	T	6	3	9	0	0	9	0	0
9	9120847	.	G	A	7	4	11	0	4	15	0	0
9	9121242	.	T	C	11	4	15	0	1	16	0	0
9	9121382	.	G	A	6	10	16	0	1	17	0	0
9	9183874	.	C	T	19	11	30	0	0	30	0	0
9	9183969	.	T	A	20	17	37	0	1	38	0	0
9	9184092	.	G	A	14	25	39	0	0	39	0	0
9	9184177	.	G	A	23	20	43	0	1	44	0	0
9	9184397	.	G	A	10	15	25	0	1	26	0	0
9	9184488	.	G	A	9	4	13	0	1	14	0	0
9	9184536	.	T	C	9	9	18	0	3	21	0	0
9	9184566	.	G	A	13	18	31	0	0	31	0	0
9	9184593	.	T	C	16	9	25	0	4	29	0	0
9	9193044	.	A	C	1	3	4	0	0	4	0	0
9	9195964	.	C	T	6	8	14	0	1	15	0	0
9	9198139	.	A	G	1	0	1	0	0	1	0	0
9	9198202	.	A	C	10	10	20	0	3	23	0	0
9	9198208	.	G	A	11	10	21	0	1	22	0	0
9	9206612	.	C	G	3	3	6	0	1	7	0	0
9	9208714	.	C	A	4	4	8	0	0	8	0	0
9	9208759	.	A	T	9	4	13	0	1	14	0	0
9	9225717	.	C	T	4	2	6	0	0	6	0	0
9	9238577	.	G	A	1	5	6	0	1	7	0	0
9	9238583	.	G	A	1	6	7	0	0	7	0	0
9	9322733	.	G	A	7	4	11	0	1	12	0	0
9	9322782	.	C	G	0	5	5	0	6	11	0	0
9	9322795	.	A	G	4	6	10	0	0	10	0	0
9	9327588	.	G	A	5	2	7	0	0	7	0	0
9	9327705	.	C	T	2	2	4	0	0	4	0	0
9	9342835	.	T	A	3	4	7	0	1	8	0	0
9	9342892	.	C	T	4	5	9	0	0	9	0	0
9	9345134	.	G	A	5	2	7	0	0	7	0	0
9	9555267	.	G	C	0	1	1	0	0	1	0	0
9	9578598	.	G	T	21	23	44	0	3	47	0	0
9	9578936	.	T	G	20	18	38	0	3	41	0	0
9	9579027	.	C	A	21	24	45	0	3	48	0	0
9	9579076	.	G	C	11	20	31	0	1	32	0	0
9	9579165	.	C	T	17	13	30	0	4	35	1	0
9	9579297	.	G	C	12	14	26	0	0	26	0	0
9	9580103	.	G	A	9	12	21	0	4	25	0	0
9	9592779	.	C	A	4	2	6	0	0	6	0	0
9	9671134	.	G	T	1	3	4	0	0	4	0	0
9	9671208	.	G	A	2	5	7	0	0	7	0	0
9	9719301	.	C	T	2	2	4	0	0	4	0	0
9	9719311	.	T	A	2	1	3	0	0	3	0	0
9	9719349	.	G	A	1	2	3	0	0	3	0	0
9	9736317	.	G	T	10	11	21	0	1	22	0	0
9	9736406	.	C	A	4	9	13	0	1	14	0	0
9	9736436	.	G	T	6	6	12	0	2	14	0	0
9	9736647	.	A	C	6	0	6	0	0	6	0	0
9	9736653	.	C	G	4	1	5	0	1	6	0	0
9	9736815	.	T	A	5	13	18	0	0	18	0	0
9	9736870	.	T	G	5	7	12	0	0	12	0	0
9	9736918	.	G	C	4	6	10	0	1	11	0	0
9	9737060	.	T	G	5	9	14	0	1	15	0	0
9	9737219	.	C	G	7	5	12	0	0	12	0	0
9	9737248	.	G	A	6	2	8	0	0	8	0	0
9	9737432	.	A	T	3	5	8	0	0	8	0	0
9	9737437	.	T	C	2	0	2	0	6	8	0	0
9	9738137	.	T	A	3	2	5	0	0	5	0	0
9	9738158	.	T	G	2	5	7	0	0	7	0	0
9	9738174	.	G	A	2	4	6	0	0	6	0	0
9	9738304	.	C	T	0	2	2	0	2	4	0	0
9	9738325	.	A	T	6	3	9	0	0	9	0	0
9	9738449	.	C	T	2	2	4	0	0	4	0	0
9	9738450	.	T	A	2	2	4	0	0	4	0	0
9	9738707	.	G	A	2	2	4	0	0	4	0	0
9	9738739	.	A	G	2	5	7	0	0	7	0	0
9	9738758	.	T	A	1	4	5	0	1	6	0	0
9	9739135	.	T	C	2	2	4	0	1	5	0	0
9	9771333	.	C	G	0	1	1	0	0	1	0	0
9	9771351	.	A	G	0	2	2	0	0	2	0	0
9	9930554	.	G	C	1	2	3	0	0	3	0	0
9	9942914	.	T	C	0	1	1	0	0	1	0	0
9	9945569	.	G	C	2	1	3	0	0	3	0	0
9	10014875	.	C	A	1	2	3	0	0	3	0	0
9	10043130	.	T	C	0	1	1	0	0	1	0	0
9	10043201	.	C	G	2	2	4	0	0	4	0	0
9	10043217	.	T	A	2	2	4	0	0	4	0	0
9	10043415	.	C	T	3	3	6	0	0	6	0	0
9	10051935	.	T	A	6	5	11	0	1	12	0	0
9	10138486	.	G	A	1	3	4	0	1	5	0	0
9	10153091	.	C	T	2	2	4	0	1	5	0	0
9	10153342	.	T	A	10	6	16	0	0	17	1	0
9	10153590	.	A	C	11	6	17	0	2	19	0	0
9	10153606	.	A	G	9	12	21	0	1	22	0	0
9	10153689	.	G	C	7	10	17	0	2	19	0	0
9	10153705	.	A	T	10	8	18	0	2	20	0	0
9	10154013	.	G	T	10	13	23	0	1	24	0	0
9	10154014	.	C	T	10	14	24	0	0	24	0	0
9	10154138	.	T	C	4	6	10	0	0	10	0	0
9	10154195	.	A	T	5	2	7	0	1	8	0	0
9	10154344	.	T	A	7	4	11	0	1	12	0	0
9	10154461	.	C	T	11	12	23	0	0	23	0	0
9	10154490	.	A	T	0	12	12	0	0	12	0	0
9	10154565	.	G	A	0	4	4	0	1	5	0	0
9	10155977	.	G	A	0	4	4	0	0	4	0	0
9	10156145	.	C	A	4	4	8	0	0	8	0	0
9	10156261	.	C	T	4	2	6	0	0	6	0	0
9	10156326	.	G	A	1	3	4	0	3	7	0	0
9	10157193	.	C	G	5	5	10	0	0	10	0	0
9	10168945	.	C	T	0	1	1	0	1	2	0	0
9	10175785	.	A	G	1	3	4	0	0	4	0	0
9	10175812	.	G	A	2	3	5	0	0	5	0	0
9	10183289	.	C	T	0	1	1	0	0	1	0	0
9	11532306	.	A	G	1	5	6	0	0	6	0	0
9	11532307	.	C	A	0	5	5	0	1	6	0	0
9	11532589	.	T	C	11	7	18	0	0	18	0	0
9	11532682	.	T	C	9	3	12	0	2	14	0	0
9	11532775	.	A	G	4	7	11	0	0	11	0	0
9	11532826	.	T	C	6	5	11	0	0	11	0	0
9	11906956	.	A	G	8	9	17	0	2	19	0	0
9	11907424	.	C	T	0	5	5	0	13	18	0	0
9	11907445	.	C	T	7	7	14	0	3	17	0	0
9	11907469	.	T	A	6	6	12	0	2	14	0	0
9	11907497	.	G	A	4	2	6	0	0	6	0	0
9	11908200	.	A	T	2	3	5	0	0	5	0	0
9	11908394	.	A	T	2	3	5	0	0	5	0	0
9	11908548	.	A	C	3	5	8	0	2	10	0	0
9	11909097	.	C	T	1	3	4	0	0	4	0	0
9	11909318	.	A	C	4	3	7	0	0	7	0	0
9	11909575	.	A	G	2	2	4	0	0	4	0	0
9	12263000	.	G	A	2	4	6	0	0	6	0	0
9	12263071	.	T	C	7	2	9	0	1	10	0	0
9	12265446	.	G	A	0	1	1	0	0	1	0	0
9	12269871	.	C	T	2	1	3	0	0	3	0	0
9	12455193	.	A	T	8	2	10	0	3	13	0	0
9	12864702	.	T	A	1	3	4	0	0	4	0	0
9	12864711	.	G	A	1	3	4	0	0	4	0	0
9	12865947	.	C	A	1	2	3	0	0	3	0	0
9	12868364	.	G	A	2	3	5	0	0	5	0	0
9	12871592	.	T	A	0	1	1	0	0	1	0	0
9	12871640	.	G	A	1	3	4	0	0	4	0	0
9	12874167	.	T	C	0	3	3	0	1	4	0	0
9	12874402	.	A	T	4	2	6	0	0	6	0	0
9	12874441	.	C	A	2	5	7	0	0	7	0	0
9	12944511	.	T	G	2	2	4	0	1	5	0	0
9	12944546	.	G	C	2	5	7	0	0	7	0	0
9	12944994	.	A	G	1	2	3	0	1	4	0	0
9	12945032	.	C	T	2	2	4	0	0	4	0	0
9	12945033	.	A	G	2	2	4	0	0	4	0	0
9	12945384	.	G	T	2	2	4	0	0	4	0	0
9	12945720	.	T	G	1	2	3	0	0	3	0	0
9	12946824	.	A	G	2	2	4	0	0	4	0	0
9	12947217	.	A	G	6	4	10	0	1	11	0	0
9	12947529	.	A	G	4	7	11	0	1	12	0	0
9	12947649	.	A	T	2	2	4	0	2	6	0	0
9	12948021	.	G	A	4	3	7	0	0	7	0	0
9	12948133	.	G	A	1	2	3	0	2	5	0	0
9	12948144	.	A	G	3	3	6	0	0	6	0	0
9	12948451	.	A	G	3	2	5	0	1	6	0	0
9	12948656	.	A	G	2	7	9	0	2	11	0	0
9	12948753	.	G	C	5	3	8	0	0	8	0	0
9	12948859	.	A	C	2	3	5	0	0	5	0	0
9	12951293	.	G	A	0	0	0	0	6	6	0	0
9	12953810	.	T	C	2	2	4	0	1	5	0	0
9	13107399	.	G	T	5	4	9	0	0	9	0	0
9	13107423	.	A	G	1	4	5	0	1	6	0	0
9	13107633	.	A	G	2	2	4	0	0	4	0	0
9	13783810	.	A	G	1	0	1	0	2	3	0	0
9	13783811	.	C	G	1	0	1	0	2	3	0	0
9	14023457	.	C	G	4	4	8	0	0	8	0	0
9	14023493	.	T	A	6	3	9	0	1	10	0	0
9	14023856	.	A	G	3	3	6	0	2	8	0	0
9	14027874	.	T	A	1	6	7	0	0	7	0	0
9	14027889	.	A	G	0	4	4	0	2	6	0	0
9	14028057	.	A	T	8	6	14	0	0	14	0	0
9	14028114	.	T	C	8	7	15	0	0	15	0	0
9	14037508	.	C	G	6	13	19	0	0	19	0	0
9	14037569	.	T	C	3	8	11	0	1	12	0	0
9	14038479	.	A	G	2	2	4	0	0	4	0	0
9	14038509	.	T	A	1	2	3	0	2	5	0	0
9	14040972	.	T	C	2	3	5	0	0	5	0	0
9	14112784	.	T	A	8	6	14	0	0	14	0	0
9	14136851	.	T	C	1	3	4	0	0	4	0	0
9	14196563	.	A	G	2	2	4	0	0	4	0	0
9	14196763	.	A	C	2	2	4	0	1	5	0	0
9	14196866	.	G	A	0	2	2	0	1	3	0	0
9	14196941	.	C	T	1	5	6	0	0	6	0	0
9	14196978	.	A	T	3	3	6	0	1	7	0	0
9	14197063	.	A	G	8	6	14	0	1	15	0	0
9	14197103	.	A	G	15	4	19	0	0	19	0	0
9	14367775	.	C	T	8	6	14	0	0	14	0	0
9	14367837	.	T	G	9	9	18	0	1	19	0	0
9	14367878	.	C	T	12	16	28	0	1	29	0	0
9	14368350	.	T	C	9	12	21	0	2	23	0	0
9	14368378	.	A	T	10	9	19	0	1	20	0	0
9	14368527	.	A	G	4	3	7	0	0	7	0	0
9	14368590	.	G	A	3	4	7	0	1	8	0	0
9	14368676	.	A	G	5	4	9	0	0	9	0	0
9	14368788	.	T	C	14	7	21	0	0	21	0	0
9	14368892	.	C	T	5	4	9	0	0	9	0	0
9	14368988	.	G	A	9	6	15	0	3	18	0	0
9	14369084	.	G	A	9	4	13	0	2	15	0	0
9	14369150	.	T	A	8	7	15	0	3	18	0	0
9	14381060	.	G	A	1	0	1	0	1	2	0	0
9	14411677	.	C	A	2	4	6	0	0	6	0	0
9	14433931	.	A	T	1	1	2	0	0	2	0	0
9	14442341	.	A	G	1	2	3	0	0	3	0	0
9	16128102	.	C	T	2	2	4	0	0	4	0	0
9	16128736	.	C	T	3	4	7	0	0	7	0	0
9	16128742	.	T	A	2	4	6	0	1	7	0	0
9	16547926	.	A	C	1	3	4	0	0	4	0	0
9	18005806	.	A	G	19	9	28	0	0	28	0	0
9	19407483	.	G	T	0	3	3	0	0	3	0	0
9	19549620	.	C	T	1	4	5	1	2	8	0	0
9	20501589	.	C	T	4	1	5	0	1	6	0	0
9	24120358	.	A	T	1	2	3	0	0	3	0	0
9	24189198	.	A	G	1	6	7	0	0	7	0	0
9	25167433	.	A	T	5	2	7	0	0	7	0	0
9	25837206	.	A	T	2	2	4	0	1	5	0	0
9	27381934	.	A	C	2	1	3	0	0	3	0	0
9	27381941	.	A	G	2	1	3	0	0	3	0	0
9	27691970	.	A	G	1	8	9	0	0	9	0	0
9	27692017	.	T	C	3	9	12	0	0	12	0	0
9	27692075	.	G	T	7	4	11	0	1	12	0	0
9	27692121	.	C	A	0	3	3	0	7	10	0	0
9	27692325	.	A	G	7	6	13	0	0	13	0	0
9	27692329	.	G	T	6	6	12	0	0	12	0	0
9	27692389	.	A	G	6	9	15	0	0	15	0	0
9	27692402	.	G	T	5	10	15	0	1	16	0	0
9	27692471	.	C	T	0	5	5	0	4	9	0	0
9	27692699	.	C	G	0	6	6	0	12	18	0	0
9	27694630	.	T	C	5	5	10	0	0	10	0	0
9	27694690	.	C	A	0	0	0	0	1	1	0	0
9	27716762	.	A	G	3	2	5	0	0	5	0	0
9	27741271	.	G	T	2	1	3	0	0	3	0	0
9	27741286	.	C	T	1	2	3	0	0	3	0	0
9	27757831	.	C	T	5	8	13	0	0	13	0	0
9	27757893	.	A	G	4	0	4	0	7	11	0	0
9	27860734	.	C	T	0	6	6	0	13	19	0	0
9	27861186	.	G	T	2	4	6	0	0	6	0	0
9	27861293	.	C	G	0	9	9	0	10	19	0	0
9	27863828	.	G	T	3	4	7	0	0	7	0	0
9	27894444	.	G	T	1	2	3	0	0	3	0	0
9	27894656	.	T	C	5	3	8	0	0	8	0	0
9	27909933	.	C	T	4	2	6	0	0	6	0	0
9	28115901	.	A	G	2	4	6	0	0	6	0	0
9	28116064	.	T	C	1	5	6	0	0	6	0	0
9	28124661	.	G	A	1	4	5	0	1	6	0	0
9	28124775	.	A	G	1	0	1	0	0	1	0	0
9	28127471	.	A	G	7	10	17	0	5	22	0	0
9	28127513	.	A	C	8	7	15	0	2	17	0	0
9	28127532	.	A	C	5	7	12	0	1	13	0	0
9	28127706	.	C	G	13	6	19	0	3	22	0	0
9	28150896	.	C	T	1	2	3	0	0	3	0	0
9	28204036	.	C	A	1	2	3	0	0	3	0	0
9	28204412	.	C	T	1	4	5	0	1	6	0	0
9	28205484	.	C	A	1	2	3	0	0	3	0	0
9	28205703	.	T	C	2	3	5	0	0	5	0	0
9	28206947	.	A	T	9	5	14	0	1	15	0	0
9	28207392	.	T	A	5	3	8	0	0	8	0	0
9	28207647	.	C	T	1	3	4	0	1	5	0	0
9	28238302	.	C	T	6	4	10	0	2	12	0	0
9	28238305	.	C	T	0	6	6	0	9	15	0	0
9	28245874	.	G	A	4	3	7	0	1	8	0	0
9	28254633	.	C	T	2	4	6	0	1	7	0	0
9	28254783	.	C	T	0	4	4	0	6	10	0	0
9	28254810	.	G	A	2	6	8	0	0	8	0	0
9	28263971	.	C	T	5	7	12	0	2	14	0	0
9	28267158	.	G	A	4	9	13	0	3	16	0	0
9	28268543	.	G	A	1	2	3	0	0	3	0	0
9	28341235	.	T	A	0	2	2	0	1	3	0	0
9	28341330	.	C	A	0	11	11	0	9	20	0	0
9	28341382	.	G	A	6	11	17	0	0	17	0	0
9	28341591	.	C	A	6	22	28	0	0	28	0	0
9	28341593	.	T	A	5	19	24	0	4	28	0	0
9	28342963	.	G	A	8	6	14	0	2	16	0	0
9	28343054	.	G	A	9	12	21	0	2	23	0	0
9	28343100	.	A	G	6	12	18	0	0	18	0	0
9	28343121	.	T	G	5	14	19	0	0	19	0	0
9	28343549	.	C	T	6	4	10	0	0	10	0	0
9	28343590	.	G	A	3	6	9	0	0	9	0	0
9	28343681	.	T	G	0	1	1	0	4	5	0	0
9	28343684	.	G	C	3	1	4	0	1	5	0	0
9	28344026	.	T	C	1	3	4	0	0	4	0	0
9	28344126	.	A	C	2	3	5	0	1	6	0	0
9	28344320	.	T	G	3	1	4	0	1	5	0	0
9	28345531	.	T	C	4	2	6	0	1	7	0	0
9	28345844	.	T	A	1	2	3	0	0	3	0	0
9	28398942	.	G	C	2	2	4	0	1	5	0	0
9	28689032	.	G	A	10	3	13	0	0	13	0	0
9	28689033	.	C	A	10	3	13	0	0	13	0	0
9	28691645	.	T	C	3	4	7	0	0	7	0	0
9	28696610	.	A	C	3	6	9	0	0	9	0	0
9	28696643	.	A	G	1	1	2	0	0	2	0	0
9	28818498	.	A	T	3	6	9	0	1	10	0	0
9	28839811	.	T	C	0	1	1	0	0	1	0	0
9	28839859	.	G	A	5	4	9	0	0	9	0	0
9	28839879	.	T	A	5	5	10	0	1	11	0	0
9	28867421	.	A	C	3	2	5	0	0	5	0	0
9	28867426	.	A	C	3	1	4	0	0	4	0	0
9	28871367	.	A	T	5	2	7	0	1	8	0	0
9	28872083	.	A	G	1	3	4	0	0	4	0	0
9	28872341	.	G	A	0	1	1	0	0	1	0	0
9	28875319	.	C	T	3	1	4	0	0	4	0	0
9	28879348	.	C	T	0	1	1	0	1	2	0	0
9	28940998	.	G	A	18	18	36	0	1	37	0	0
9	28941003	.	T	C	16	0	16	0	18	34	0	0
9	28941061	.	A	C	16	10	26	0	2	28	0	0
9	28941179	.	A	G	7	9	16	0	2	18	0	0
9	28941189	.	G	A	4	8	12	0	3	15	0	0
9	28941234	.	C	T	4	5	9	0	0	9	0	0
9	28941414	.	A	G	18	13	31	0	1	32	0	0
9	28941446	.	A	G	14	19	33	0	2	35	0	0
9	28941488	.	T	A	13	16	29	0	1	30	0	0
9	28941498	.	C	G	11	17	28	0	0	28	0	0
9	28941629	.	G	A	3	10	13	0	2	15	0	0
9	28941630	.	G	A	2	11	13	0	2	15	0	0
9	28941684	.	C	G	2	7	9	0	0	9	0	0
9	28941709	.	G	C	1	7	8	0	0	8	0	0
9	28941723	.	A	G	1	7	8	0	0	8	0	0
9	28941832	.	A	G	2	5	7	0	3	10	0	0
9	28941879	.	A	T	4	4	8	0	0	8	0	0
9	28941897	.	T	G	4	5	9	0	1	10	0	0
9	28942018	.	G	A	6	4	10	0	0	10	0	0
9	28942542	.	T	A	14	10	24	0	0	24	0	0
9	28942553	.	T	A	12	9	21	0	0	21	0	0
9	28946132	.	A	T	3	4	7	0	0	7	0	0
9	28952959	.	G	A	4	2	6	0	0	6	0	0
9	28964849	.	C	A	6	3	9	0	0	9	0	0
9	28967048	.	A	G	0	1	1	0	0	1	0	0
9	29035572	.	T	C	6	5	11	0	0	11	0	0
9	29035575	.	A	G	6	6	12	0	0	12	0	0
9	29035614	.	A	C	5	4	9	0	1	10	0	0
9	29049712	.	T	C	2	3	5	0	0	5	0	0
9	29122231	.	T	G	7	5	12	0	1	13	0	0
9	29122536	.	T	A	8	4	12	0	0	12	0	0
9	29122725	.	C	T	3	7	10	0	0	10	0	0
9	29122849	.	A	G	7	8	15	0	1	16	0	0
9	29230754	.	A	G	1	1	2	0	0	2	0	0
9	29339133	.	G	C	2	4	6	0	0	6	0	0
9	29339139	.	A	T	2	3	5	0	1	6	0	0
9	29458550	.	A	C	0	1	1	0	0	1	0	0
9	29458562	.	T	C	0	2	2	0	0	2	0	0
9	29477021	.	G	C	4	2	6	0	0	6	0	0
9	29481518	.	T	C	10	6	16	0	1	17	0	0
9	29481708	.	A	G	4	1	5	0	0	5	0	0
9	29481747	.	G	A	0	4	4	0	7	11	0	0
9	29481795	.	T	C	7	4	11	0	0	11	0	0
9	29482135	.	T	A	3	5	8	0	0	8	0	0
9	29484238	.	G	A	9	6	15	0	0	15	0	0
9	29484291	.	T	G	9	4	13	0	0	13	0	0
9	29487130	.	C	T	1	2	3	0	0	3	0	0
9	29487163	.	C	T	4	3	7	0	0	7	0	0
9	29489797	.	A	G	9	3	12	0	0	12	0	0
9	29497181	.	C	T	0	1	1	0	1	2	0	0
9	29497200	.	A	T	1	1	2	0	0	2	0	0
9	29520819	.	A	G	13	6	19	0	4	23	0	0
9	29523552	.	T	G	2	0	2	0	7	9	0	0
9	29542822	.	T	C	1	2	3	0	0	3	0	0
9	29602959	.	T	C	1	2	3	0	0	3	0	0
9	29615087	.	C	G	23	17	40	0	1	41	0	0
9	29615238	.	T	A	19	9	28	0	1	29	0	0
9	29615575	.	C	T	15	13	28	0	1	29	0	0
9	29630650	.	C	T	1	1	2	0	0	2	0	0
9	29630668	.	T	C	1	1	2	0	0	2	0	0
9	29647469	.	G	A	23	10	33	0	1	34	0	0
9	29647470	.	C	T	24	10	34	0	0	34	0	0
9	29649571	.	C	A	25	24	49	0	3	52	0	0
9	29731041	.	T	C	0	1	1	0	0	1	0	0
9	29992145	.	A	G	1	0	1	0	1	2	0	0
9	29992332	.	G	A	3	4	7	0	0	7	0	0
9	30106009	.	G	A	6	4	10	0	1	11	0	0
9	30108779	.	T	C	0	1	1	0	0	1	0	0
9	30110026	.	T	C	0	1	1	0	0	1	0	0
9	30110217	.	T	C	1	8	9	0	0	9	0	0
9	30110930	.	C	T	2	2	4	0	0	4	0	0
9	30114853	.	A	G	4	3	7	0	0	7	0	0
9	30121155	.	C	A	9	14	23	0	2	25	0	0
9	30121167	.	C	T	3	14	17	0	7	24	0	0
9	30128084	.	C	G	27	26	53	0	5	58	0	0
9	30128085	.	C	T	27	30	57	0	1	58	0	0
9	30218140	.	C	T	4	1	5	0	0	5	0	0
9	30218310	.	G	A	2	4	6	0	0	6	0	0
9	30218323	.	A	G	2	3	5	0	1	6	0	0
9	30220931	.	C	T	0	1	1	0	0	1	0	0
9	30220968	.	T	A	4	6	10	0	1	11	0	0
9	30220975	.	C	T	3	8	11	0	1	12	0	0
9	30245731	.	A	G	6	5	11	0	0	11	0	0
9	30245756	.	C	A	11	6	17	0	0	17	0	0
9	30246172	.	C	G	6	5	11	0	1	12	0	0
9	30247941	.	A	G	10	7	17	0	0	17	0	0
9	30249039	.	C	T	0	4	4	0	2	6	0	0
9	30255146	.	C	G	1	0	1	0	0	1	0	0
9	30326377	.	A	G	0	2	2	0	0	2	0	0
9	30375082	.	T	A	1	3	4	0	0	4	0	0
9	30375150	.	C	T	1	2	3	0	0	3	0	0
9	30375174	.	C	T	1	3	4	0	0	4	0	0
9	30375470	.	A	T	3	11	14	0	1	15	0	0
9	30381813	.	C	G	0	2	2	0	1	3	0	0
9	30484621	.	C	A	2	3	5	0	0	5	0	0
9	30487596	.	C	A	2	3	5	0	0	5	0	0
9	30487599	.	T	C	2	3	5	0	0	5	0	0
9	30489813	.	A	G	1	1	2	0	0	2	0	0
9	30490669	.	G	A	5	0	5	0	4	9	0	0
9	30490673	.	A	G	6	2	8	0	1	9	0	0
9	30490949	.	G	T	1	6	7	0	2	9	0	0
9	30491053	.	T	C	11	5	16	0	0	16	0	0
9	30491197	.	G	A	5	5	10	0	1	11	0	0
9	30491560	.	C	T	0	4	4	0	3	7	0	0
9	30494498	.	C	G	0	5	5	0	6	11	0	0
9	30494854	.	T	A	4	2	6	0	0	6	0	0
9	30494965	.	G	A	7	3	10	0	1	11	0	0
9	30495139	.	C	T	0	5	5	0	4	9	0	0
9	30496325	.	C	T	4	5	9	0	1	10	0	0
9	30496377	.	A	G	2	4	6	0	0	6	0	0
9	30496436	.	A	G	4	2	6	0	0	6	0	0
9	30496446	.	G	T	5	2	7	0	0	7	0	0
9	30496952	.	A	G	0	2	2	0	0	2	0	0
9	30543686	.	C	T	0	2	2	0	2	4	0	0
9	30543744	.	G	A	2	2	4	0	0	4	0	0
9	30562659	.	A	G	1	3	4	0	0	4	0	0
9	30562689	.	A	T	1	4	5	0	0	5	0	0
9	30562911	.	T	A	3	4	7	0	0	7	0	0
9	30562947	.	A	G	2	4	6	0	0	6	0	0
9	30581779	.	G	C	1	2	3	0	1	4	0	0
9	30581942	.	C	T	1	6	7	0	0	7	0	0
9	30800990	.	C	T	6	5	11	0	0	11	0	0
9	30806492	.	A	G	4	3	7	0	0	7	0	0
9	30806642	.	G	T	2	4	6	0	0	6	0	0
9	30807944	.	C	T	1	3	4	0	0	4	0	0
9	30990731	.	T	C	1	2	3	0	0	3	0	0
9	30990845	.	A	G	3	0	3	0	0	3	0	0
9	31042584	.	T	C	2	3	5	1	0	6	0	0
9	31062518	.	T	A	19	16	35	0	0	35	0	0
9	31062588	.	G	A	18	17	35	0	1	36	0	0
9	31062589	.	G	A	17	17	34	0	2	36	0	0
9	31258832	.	G	A	9	6	15	0	1	16	0	0
9	31268856	.	G	T	0	2	2	0	1	3	0	0
9	31276912	.	C	T	8	13	21	0	1	22	0	0
9	31510724	.	T	A	1	0	1	0	0	1	0	0
9	31595634	.	C	T	12	12	24	0	0	24	0	0
9	31604943	.	G	A	1	3	4	0	0	4	0	0
9	31606333	.	C	T	3	2	5	0	0	5	0	0
9	31617687	.	A	G	0	1	1	0	0	1	0	0
9	31619998	.	A	G	1	2	3	0	0	3	0	0
9	32169182	.	A	G	6	8	14	0	0	14	0	0
9	32169287	.	G	A	21	18	39	0	2	41	0	0
9	32187866	.	A	T	5	6	11	0	0	11	0	0
9	32286804	.	C	G	4	7	11	0	1	12	0	0
9	32286858	.	C	T	8	9	17	0	0	17	0	0
9	32287162	.	A	G	18	8	26	0	0	26	0	0
9	32287208	.	A	C	21	19	40	0	2	42	0	0
9	32287418	.	A	G	22	14	36	0	1	37	0	0
9	32287419	.	A	G	21	14	35	0	2	37	0	0
9	32287481	.	T	C	21	13	34	0	1	35	0	0
9	32287688	.	A	G	7	8	15	0	1	16	0	0
9	32289064	.	C	A	0	14	14	0	14	28	0	0
9	32289281	.	G	A	8	10	18	0	2	20	0	0
9	32290957	.	G	A	3	4	7	0	0	7	0	0
9	32297376	.	G	A	2	2	4	0	1	5	0	0
9	32304476	.	G	A	12	9	21	0	1	22	0	0
9	32304643	.	C	T	3	2	5	0	1	8	2	0
9	32304655	.	A	G	3	4	7	0	0	7	0	0
9	32304701	.	A	T	1	2	3	0	1	4	0	0
9	32308523	.	A	C	3	2	5	0	1	6	0	0
9	32312472	.	C	T	30	19	49	0	2	51	0	0
9	32312683	.	C	A	13	22	35	0	3	38	0	0
9	32313626	.	C	T	4	3	7	0	0	7	0	0
9	32316348	.	C	G	8	3	11	0	1	12	0	0
9	32316526	.	T	C	2	1	3	0	3	6	0	0
9	32316532	.	T	C	4	1	5	0	2	7	0	0
9	32441800	.	T	C	3	4	7	0	0	7	0	0
9	32457192	.	C	T	9	8	17	0	0	17	0	0
9	32641131	.	T	A	9	9	18	0	0	18	0	0
9	32641175	.	T	G	12	9	21	0	1	22	0	0
9	32641278	.	A	T	12	12	24	0	1	25	0	0
9	32641294	.	G	T	15	12	27	0	1	28	0	0
9	32641424	.	G	A	11	7	18	0	2	20	0	0
9	32641442	.	G	C	9	8	17	0	3	20	0	0
9	32641548	.	T	A	6	9	15	0	2	17	0	0
9	32641600	.	A	G	4	14	18	0	0	18	0	0
9	32641682	.	A	G	12	12	24	0	0	24	0	0
9	32641731	.	C	A	14	11	25	0	0	25	0	0
9	32641737	.	A	G	14	11	25	0	1	26	0	0
9	32641802	.	T	C	10	8	18	0	2	20	0	0
9	32641805	.	A	G	12	8	20	0	0	20	0	0
9	32642342	.	A	G	5	7	12	0	3	15	0	0
9	32643643	.	G	A	1	1	2	0	2	4	0	0
9	32645615	.	G	C	8	8	16	0	0	16	0	0
9	32645939	.	T	C	3	2	5	0	1	6	0	0
9	32651241	.	A	T	2	5	7	0	0	7	0	0
9	32651334	.	C	T	2	0	2	0	0	2	0	0
9	32651527	.	C	A	1	0	1	0	0	1	0	0
9	32651826	.	T	C	1	3	4	0	0	4	0	0
9	32652072	.	T	C	1	3	4	0	0	4	0	0
9	32652129	.	C	T	4	3	7	0	0	7	0	0
9	32674841	.	T	C	0	2	2	0	0	2	0	0
9	32681804	.	A	T	1	2	3	0	0	3	0	0
9	32681877	.	A	C	3	1	4	0	0	4	0	0
9	32681880	.	A	C	3	1	4	0	1	5	0	0
9	32728896	.	G	C	4	7	11	0	2	13	0	0
9	32728969	.	A	G	8	5	13	0	0	13	0	0
9	32728984	.	C	A	5	6	11	0	2	13	0	0
9	32729022	.	T	C	2	4	6	0	4	10	0	0
9	32729072	.	G	A	2	6	8	0	1	9	0	0
9	32729183	.	T	G	4	4	8	0	1	9	0	0
9	32751579	.	A	G	3	2	5	0	0	5	0	0
9	32751640	.	A	G	8	18	26	0	3	29	0	0
9	32751812	.	A	G	14	13	27	0	2	29	0	0
9	32751825	.	C	T	12	13	25	0	2	27	0	0
9	32752272	.	C	T	20	15	35	0	1	36	0	0
9	32752555	.	C	T	11	8	19	0	2	21	0	0
9	32752794	.	A	C	6	0	6	0	6	12	0	0
9	32752824	.	G	T	7	10	17	0	2	19	0	0
9	32752864	.	G	T	11	9	20	0	1	21	0	0
9	32752995	.	T	C	0	3	3	0	0	3	0	0
9	32753016	.	C	G	0	1	1	0	0	1	0	0
9	32873544	.	G	T	0	6	6	0	8	14	0	0
9	32873788	.	C	A	2	4	6	0	0	6	0	0
9	32873792	.	C	A	1	3	4	0	1	5	0	0
9	32873834	.	A	T	3	8	11	0	1	12	0	0
9	32874222	.	T	G	9	7	16	0	0	16	0	0
9	32874603	.	G	A	1	8	9	0	14	23	0	0
9	32895294	.	A	T	1	2	3	0	0	3	0	0
9	32895297	.	T	C	1	0	1	0	1	2	0	0
9	32897304	.	C	T	2	2	4	0	0	4	0	0
9	32899796	.	C	T	4	2	6	0	0	6	0	0
9	32900267	.	C	T	0	1	1	0	2	3	0	0
9	32901173	.	A	G	3	1	4	0	0	4	0	0
9	32901176	.	T	A	3	2	5	0	0	5	0	0
9	32981252	.	C	T	6	5	11	0	0	11	0	0
9	32981302	.	C	T	5	4	9	0	1	10	0	0
9	32981317	.	T	C	6	3	9	0	0	9	0	0
9	33411227	.	C	A	3	0	3	0	0	3	0	0
9	33411228	.	A	G	3	0	3	0	0	3	0	0
9	33661399	.	A	G	13	15	28	0	1	29	0	0
9	33661424	.	G	A	7	15	22	0	2	24	0	0
9	33661645	.	A	T	8	6	14	0	0	14	0	0
9	33661691	.	A	T	7	7	14	0	0	14	0	0
9	33661714	.	G	A	6	6	12	0	0	12	0	0
9	33661765	.	C	T	3	7	10	0	2	12	0	0
9	33661773	.	A	C	4	8	12	0	0	12	0	0
9	33661939	.	T	A	6	3	9	0	2	11	0	0
9	33662043	.	A	G	2	6	8	1	0	9	0	0
9	33662134	.	C	T	3	9	12	0	4	16	0	0
9	33662158	.	A	G	3	12	15	0	2	17	0	0
9	33662175	.	T	G	4	11	15	0	1	16	0	0
9	33662223	.	A	T	1	7	8	0	0	8	0	0
9	33663300	.	G	A	4	5	9	0	0	9	0	0
9	33663331	.	A	G	4	5	9	0	0	9	0	0
9	33663455	.	A	G	4	2	6	0	0	6	0	0
9	33678095	.	G	A	1	3	4	0	0	4	0	0
9	33678124	.	A	G	1	4	5	0	0	5	0	0
9	33678164	.	T	G	0	2	2	0	0	2	0	0
9	33783731	.	T	A	5	4	9	0	1	10	0	0
9	33783761	.	T	A	7	2	9	0	1	10	0	0
9	33783800	.	A	T	10	9	19	0	0	19	0	0
9	33783822	.	T	A	17	10	27	0	3	30	0	0
9	33783852	.	A	G	25	9	34	0	3	37	0	0
9	33783956	.	T	C	27	20	47	0	1	48	0	0
9	33784689	.	T	G	8	4	12	0	0	12	0	0
9	33853510	.	A	G	3	0	3	0	6	9	0	0
9	33857776	.	C	T	2	2	4	0	0	4	0	0
9	33858088	.	G	A	5	7	12	0	1	13	0	0
9	33858111	.	T	C	4	7	11	0	0	11	0	0
9	33861813	.	A	T	6	3	9	0	1	10	0	0
9	34090715	.	T	A	1	2	3	0	0	3	0	0
9	34113140	.	G	A	3	3	6	0	1	7	0	0
9	34116933	.	A	G	2	1	3	0	0	3	0	0
9	34117293	.	A	C	4	3	7	0	0	7	0	0
9	34154428	.	A	C	1	3	4	0	0	4	0	0
9	34161749	.	G	A	2	4	6	0	0	6	0	0
9	34161893	.	T	A	2	2	4	0	0	4	0	0
9	34161933	.	C	T	5	4	9	0	0	9	0	0
9	34174561	.	C	T	5	4	9	0	0	9	0	0
9	34174682	.	G	A	4	3	7	0	0	7	0	0
9	34191597	.	G	A	0	1	1	0	0	1	0	0
9	34200253	.	T	A	4	2	6	0	0	6	0	0
9	34201156	.	G	A	1	3	4	0	0	4	0	0
9	34222113	.	C	T	12	10	22	0	1	23	0	0
9	34225055	.	A	G	4	4	8	0	0	8	0	0
9	34225316	.	G	C	6	4	10	0	0	10	0	0
9	34226884	.	G	A	24	22	46	0	2	48	0	0
9	34226888	.	G	A	2	24	26	0	23	49	0	0
9	34226960	.	A	C	11	30	41	0	2	43	0	0
9	34227016	.	A	T	10	20	30	0	2	32	0	0
9	34227020	.	C	G	10	20	30	0	3	33	0	0
9	34227054	.	C	T	14	18	32	0	1	33	0	0
9	34227074	.	C	A	14	17	31	0	0	31	0	0
9	34243122	.	G	C	1	3	4	0	0	4	0	0
9	34243567	.	G	T	3	2	5	0	0	5	0	0
9	34246473	.	G	A	5	6	11	0	0	11	0	0
9	34246524	.	G	A	13	6	19	0	0	19	0	0
9	34246555	.	T	G	8	8	16	0	0	16	0	0
9	34246628	.	G	A	5	4	9	0	3	12	0	0
9	34246710	.	G	A	11	11	22	0	3	25	0	0
9	34246932	.	A	G	9	13	22	0	1	23	0	0
9	34247356	.	G	A	2	3	5	0	0	5	0	0
9	34251632	.	G	A	2	6	8	0	0	8	0	0
9	34251707	.	C	G	8	8	16	0	1	17	0	0
9	34251752	.	G	A	4	5	9	0	0	9	0	0
9	34251764	.	G	A	2	3	5	0	1	6	0	0
9	34251963	.	A	G	7	5	12	0	0	12	0	0
9	34254896	.	G	A	0	1	1	0	0	1	0	0
9	34258384	.	A	G	1	3	4	0	0	4	0	0
9	34259406	.	T	A	2	3	5	0	0	5	0	0
9	34259418	.	T	A	1	3	4	0	0	4	0	0
9	34260101	.	G	C	1	4	5	0	0	5	0	0
9	34260164	.	C	T	1	4	5	0	0	5	0	0
9	34349379	.	T	C	0	1	1	0	0	1	0	0
9	34352271	.	G	A	2	5	7	0	0	7	0	0
9	34380503	.	T	A	1	4	5	0	0	5	0	0
9	34380525	.	T	A	1	3	4	0	1	5	0	0
9	34382946	.	A	T	7	10	17	0	1	18	0	0
9	34385396	.	A	G	11	0	11	0	15	26	0	0
9	34388882	.	G	A	7	19	26	0	2	28	0	0
9	34389077	.	T	C	12	14	26	0	2	28	0	0
9	34389101	.	C	G	8	14	22	0	2	24	0	0
9	34389288	.	T	G	8	12	20	0	0	20	0	0
9	34389427	.	C	T	9	27	36	0	3	39	0	0
9	34389666	.	A	G	20	17	37	0	3	40	0	0
9	34389701	.	A	T	22	18	40	0	0	40	0	0
9	34389704	.	G	C	21	17	38	0	2	40	0	0
9	34389743	.	G	T	14	19	33	0	1	34	0	0
9	34389748	.	A	C	14	19	33	0	1	34	0	0
9	34389791	.	A	G	4	14	18	0	1	19	0	0
9	34410156	.	G	A	2	2	4	0	0	4	0	0
9	34410237	.	T	C	0	1	1	0	0	1	0	0
9	34415308	.	T	C	2	8	10	0	1	11	0	0
9	34416575	.	A	T	3	2	5	0	0	5	0	0
9	34423397	.	C	A	8	11	19	0	2	21	0	0
9	34423415	.	T	A	10	12	22	0	0	22	0	0
9	34423468	.	T	A	10	8	18	0	0	18	0	0
9	34423474	.	A	G	11	0	11	0	7	18	0	0
9	34423794	.	T	C	1	3	4	0	0	4	0	0
9	34423822	.	T	A	1	2	3	0	2	5	0	0
9	34425920	.	C	T	5	5	10	0	0	10	0	0
9	34427760	.	A	G	1	5	6	0	0	6	0	0
9	34482462	.	G	A	0	1	1	0	0	1	0	0
9	34647415	.	A	G	4	0	4	0	16	20	0	0
9	34647427	.	A	C	5	13	18	0	2	20	0	0
9	34866579	.	T	G	5	4	9	0	1	10	0	0
9	34866684	.	T	A	2	3	5	0	0	5	0	0
9	34866888	.	C	T	8	11	19	0	0	19	0	0
9	34867007	.	C	A	0	8	8	0	10	18	0	0
9	34867015	.	T	C	7	0	7	0	10	17	0	0
9	34869699	.	A	G	2	11	13	0	0	13	0	0
9	34869813	.	G	A	5	2	7	0	2	9	0	0
9	34869945	.	G	A	1	1	2	0	0	2	0	0
9	34877315	.	G	A	2	3	5	0	0	5	0	0
9	34903218	.	T	G	27	13	40	0	6	46	0	0
9	34906337	.	C	G	29	24	53	0	4	57	0	0
9	34912626	.	A	T	6	7	13	0	0	13	0	0
9	34912695	.	T	C	3	0	3	0	3	6	0	0
9	34912895	.	T	A	10	9	19	0	1	20	0	0
9	34920395	.	G	A	2	7	9	0	1	10	0	0
9	34922670	.	C	T	0	1	1	0	0	1	0	0
9	34922898	.	A	G	0	3	3	0	1	4	0	0
9	34938795	.	C	T	10	11	21	0	1	22	0	0
9	34939336	.	A	G	5	4	9	0	1	10	0	0
9	34939800	.	T	C	8	5	13	0	0	13	0	0
9	34967565	.	A	G	4	3	7	0	0	7	0	0
9	34967647	.	C	T	8	3	11	0	0	11	0	0
9	34967649	.	C	T	7	4	11	0	0	11	0	0
9	34967733	.	A	G	6	3	9	0	0	9	0	0
9	34967743	.	A	C	5	4	9	0	1	10	0	0
9	34968005	.	A	G	6	8	14	0	1	15	0	0
9	35022050	.	A	G	1	2	3	0	0	3	0	0
9	35024459	.	G	C	0	6	6	0	7	13	0	0
9	35025183	.	C	T	7	11	18	0	1	19	0	0
9	35025243	.	A	T	10	6	16	0	0	16	0	0
9	35025430	.	C	T	2	4	6	0	1	7	0	0
9	35026736	.	T	A	27	33	60	0	2	62	0	0
9	35026941	.	T	C	28	24	52	0	7	59	0	0
9	35027262	.	A	G	32	25	57	0	3	60	0	0
9	35027309	.	T	C	20	0	20	0	25	46	1	0
9	35027333	.	A	G	23	21	44	0	2	46	0	0
9	35027365	.	G	T	22	18	40	0	2	43	1	0
9	35027371	.	G	T	23	24	47	0	0	47	0	0
9	35027402	.	G	A	23	29	52	0	1	53	0	0
9	35027549	.	T	G	30	23	53	0	4	57	0	0
9	35027705	.	G	A	23	5	28	0	3	33	2	0
9	35028086	.	T	C	26	2	28	0	39	67	0	0
9	35030977	.	G	A	28	22	50	0	4	54	0	0
9	35032640	.	A	G	3	4	7	0	1	8	0	0
9	35032643	.	A	G	3	5	8	0	2	10	0	0
9	35033347	.	C	T	7	16	23	0	1	24	0	0
9	35039175	.	T	C	10	11	21	0	2	23	0	0
9	35048839	.	G	C	13	10	23	0	4	27	0	0
9	35048840	.	A	C	13	11	24	0	3	27	0	0
9	35170671	.	G	A	13	11	24	0	2	26	0	0
9	35176030	.	A	G	11	10	21	0	0	21	0	0
9	35228165	.	G	A	3	1	4	0	0	4	0	0
9	35254679	.	G	A	1	1	2	0	0	2	0	0
9	35838477	.	T	A	15	13	28	0	0	28	0	0
9	35840713	.	G	A	5	7	12	0	1	13	0	0
9	35840782	.	T	C	2	5	7	0	0	7	0	0
9	35841279	.	G	T	4	9	13	0	1	14	0	0
9	35841282	.	A	G	5	9	14	0	0	14	0	0
9	35841663	.	G	T	6	6	12	0	1	13	0	0
9	35841994	.	A	G	6	9	15	0	0	15	0	0
9	35842164	.	T	A	10	14	24	0	5	29	0	0
9	35842209	.	G	T	9	12	21	0	0	21	0	0
9	35862177	.	T	A	1	1	2	0	0	2	0	0
9	35862184	.	A	T	1	1	2	0	0	2	0	0
9	35862299	.	G	A	8	10	18	0	1	19	0	0
9	35863132	.	C	T	5	11	16	0	3	19	0	0
9	35863555	.	T	C	10	12	22	0	0	22	0	0
9	35863603	.	T	C	11	13	24	0	1	25	0	0
9	35863798	.	C	T	13	12	25	0	5	30	0	0
9	35863968	.	A	T	7	13	20	0	3	23	0	0
9	35864155	.	A	T	13	6	19	0	0	19	0	0
9	35864210	.	C	T	7	5	12	0	0	12	0	0
9	35864266	.	C	A	2	7	9	0	0	9	0	0
9	35864277	.	C	T	2	5	7	0	0	7	0	0
9	35864416	.	A	C	1	2	3	0	0	3	0	0
9	35864486	.	C	T	3	0	3	0	0	3	0	0
9	35864565	.	A	G	7	0	7	0	0	7	0	0
9	35864598	.	C	T	7	4	11	0	1	12	0	0
9	35865073	.	C	T	17	20	37	0	4	41	0	0
9	35865162	.	G	T	13	10	23	0	0	23	0	0
9	35865270	.	C	G	15	11	26	0	3	29	0	0
9	35872927	.	G	A	11	5	16	0	0	16	0	0
9	35872942	.	G	A	11	4	15	0	1	16	0	0
9	35872993	.	A	T	7	6	13	0	4	17	0	0
9	35909842	.	A	G	1	2	3	0	1	4	0	0
9	35910390	.	C	G	1	0	1	0	0	1	0	0
9	35912447	.	A	T	1	3	4	0	0	4	0	0
9	35912459	.	G	A	1	4	5	0	0	5	0	0
9	35915557	.	G	A	0	4	4	0	0	4	0	0
9	35916518	.	T	G	1	1	2	0	0	2	0	0
9	35916786	.	G	A	2	1	3	0	0	3	0	0
9	35922046	.	T	G	14	13	27	0	1	28	0	0
9	35922115	.	T	C	8	5	13	0	1	14	0	0
9	36659702	.	T	G	4	2	6	0	0	6	0	0
9	36896432	.	T	C	3	2	5	0	0	5	0	0
9	36898724	.	C	T	6	2	8	0	0	8	0	0
9	36899065	.	C	T	0	4	4	0	3	7	0	0
9	36973751	.	T	C	4	4	8	0	0	8	0	0
9	36974170	.	G	T	1	5	6	0	1	7	0	0
9	36974191	.	T	C	2	5	7	0	0	7	0	0
9	36974233	.	A	T	1	4	5	0	0	5	0	0
9	37296075	.	T	G	2	2	4	0	0	4	0	0
9	37296235	.	G	T	2	2	4	0	0	4	0	0
9	37371515	.	A	T	1	0	1	0	0	1	0	0
9	37451809	.	A	G	3	5	8	0	1	9	0	0
9	37452012	.	A	T	9	6	15	0	0	15	0	0
9	37452223	.	C	T	5	4	9	0	3	12	0	0
9	37452432	.	G	A	3	12	15	0	2	17	0	0
9	37452499	.	T	G	12	2	14	0	1	15	0	0
9	37452515	.	G	T	11	3	14	0	1	15	0	0
9	37452616	.	T	G	16	15	31	0	0	31	0	0
9	37452819	.	G	C	7	7	14	0	1	15	0	0
9	37452862	.	T	C	12	9	21	0	1	22	0	0
9	37452924	.	C	G	8	9	17	0	5	22	0	0
9	37840024	.	G	T	6	3	9	0	0	9	0	0
9	37850479	.	G	C	2	2	4	0	0	4	0	0
9	37853970	.	A	C	3	2	5	0	1	6	0	0
9	37856541	.	C	T	4	10	14	0	0	14	0	0
9	37856895	.	T	A	2	4	6	0	0	6	0	0
9	37859807	.	G	T	6	5	11	0	0	11	0	0
9	37859881	.	T	G	10	14	24	0	0	24	0	0
9	37860116	.	T	C	2	6	8	0	2	10	0	0
9	37861763	.	G	T	0	2	2	0	0	2	0	0
9	37861834	.	G	A	8	3	11	0	0	11	0	0
9	37861844	.	G	A	2	6	8	0	1	9	0	0
9	37862065	.	T	G	2	0	2	0	7	9	0	0
9	37862121	.	A	G	7	0	7	0	2	9	0	0
9	37862124	.	C	T	7	2	9	0	0	9	0	0
9	37862333	.	C	A	2	2	4	0	0	4	0	0
9	38030131	.	A	T	19	13	32	0	1	33	0	0
9	38030366	.	A	T	6	8	14	0	0	14	0	0
9	38030485	.	A	T	6	10	16	0	0	16	0	0
9	38030503	.	C	T	0	8	8	0	7	15	0	0
9	38030574	.	G	A	9	13	22	0	1	23	0	0
9	38033363	.	T	C	5	0	5	0	11	16	0	0
9	38033578	.	A	G	0	2	2	0	2	4	0	0
9	38042752	.	G	A	1	1	2	0	2	4	0	0
9	38061699	.	T	C	4	2	6	0	0	6	0	0
9	38061788	.	T	C	1	4	5	0	0	5	0	0
9	38063688	.	C	A	6	3	9	0	1	10	0	0
9	38063689	.	C	A	6	3	9	0	1	10	0	0
9	38064165	.	A	T	4	4	8	0	1	9	0	0
9	38064268	.	T	C	3	5	8	0	0	8	0	0
9	38064420	.	T	G	4	6	10	0	1	11	0	0
9	38064421	.	C	A	2	7	9	0	2	11	0	0
9	38064672	.	A	C	4	7	11	0	0	11	0	0
9	38140963	.	C	A	0	3	3	0	1	4	0	0
9	38161842	.	C	T	4	6	10	0	1	11	0	0
9	38161905	.	G	A	2	5	7	0	0	7	0	0
9	38238917	.	G	A	0	1	1	0	0	1	0	0
9	38251409	.	T	C	2	2	4	0	0	4	0	0
9	38273171	.	G	A	4	4	8	0	1	9	0	0
9	38273264	.	T	A	3	2	5	0	0	5	0	0
9	38277513	.	A	G	1	3	4	0	1	5	0	0
9	38278121	.	A	G	0	2	2	0	0	2	0	0
9	38278289	.	C	T	9	5	14	0	1	15	0	0
9	38278301	.	T	C	6	4	10	0	2	12	0	0
9	38278337	.	T	C	3	1	4	0	1	5	0	0
9	38283647	.	G	A	5	9	14	0	1	15	0	0
9	38283659	.	C	T	4	8	12	0	2	14	0	0
9	38285598	.	A	G	3	3	6	0	0	6	0	0
9	38286823	.	G	A	7	7	14	0	0	14	0	0
9	38290165	.	C	T	14	10	24	0	1	25	0	0
9	38290210	.	A	G	14	11	25	0	3	28	0	0
9	38290220	.	T	G	17	0	17	0	12	29	0	0
9	38290245	.	C	T	11	10	21	0	4	25	0	0
9	38290414	.	A	G	15	7	22	0	1	23	0	0
9	38290517	.	A	C	7	7	14	0	0	15	1	0
9	38290530	.	A	T	6	6	12	0	1	13	0	0
9	38290777	.	G	T	0	14	14	0	18	32	0	0
9	38290959	.	A	C	18	26	44	0	0	44	0	0
9	38291439	.	G	T	15	14	29	0	1	30	0	0
9	38291616	.	C	T	12	14	26	0	2	28	0	0
9	38291737	.	C	A	7	7	14	0	6	20	0	0
9	38316758	.	G	A	0	4	4	0	0	4	0	0
9	38316769	.	T	C	0	3	3	0	0	3	0	0
9	38351016	.	T	C	4	5	9	0	0	9	0	0
9	38353794	.	T	C	9	5	14	0	1	15	0	0
9	38354000	.	T	C	8	6	14	0	1	15	0	0
9	38354224	.	A	G	2	3	5	0	0	5	0	0
9	38354689	.	G	A	3	1	4	0	0	4	0	0
9	38359737	.	G	A	1	0	1	0	0	1	0	0
9	38360102	.	C	T	0	1	1	0	1	2	0	0
9	38362354	.	G	A	5	2	7	0	0	7	0	0
9	38362380	.	C	T	3	2	5	0	1	6	0	0
9	38368055	.	A	G	0	2	2	0	0	2	0	0
9	38388492	.	C	T	8	5	13	0	0	13	0	0
9	38388493	.	C	T	5	5	10	0	3	13	0	0
9	38388703	.	T	C	5	7	12	0	4	16	0	0
9	38389026	.	T	A	2	6	8	1	0	9	0	0
9	38389194	.	C	T	9	10	19	0	2	21	0	0
9	38389263	.	T	A	6	6	12	0	2	14	0	0
9	38389426	.	G	A	13	9	22	0	0	22	0	0
9	38389603	.	A	G	11	1	12	0	8	20	0	0
9	38389616	.	C	T	12	9	21	0	1	22	0	0
9	38389644	.	A	T	8	10	18	0	1	19	0	0
9	38389722	.	G	T	9	7	16	0	1	17	0	0
9	38389746	.	T	C	10	8	18	0	3	21	0	0
9	38389835	.	A	G	7	3	10	0	0	10	0	0
9	38389886	.	C	T	6	9	15	0	0	15	0	0
9	38391179	.	C	T	1	2	3	0	0	3	0	0
9	38400232	.	T	A	2	2	4	0	1	5	0	0
9	38400233	.	T	C	2	3	5	0	0	5	0	0
9	38405238	.	A	G	3	4	7	0	0	7	0	0
9	38405271	.	G	C	3	3	6	0	0	6	0	0
9	38413298	.	C	T	1	2	3	0	0	3	0	0
9	38418864	.	T	C	2	3	5	0	0	5	0	0
9	38429624	.	G	T	1	1	2	0	0	2	0	0
9	38470665	.	T	G	1	1	2	0	0	2	0	0
9	38476780	.	G	C	3	2	5	0	1	6	0	0
9	38476810	.	T	G	2	2	4	0	0	4	0	0
9	38478164	.	T	C	1	1	2	0	1	3	0	0
9	38478252	.	A	G	1	1	2	0	0	2	0	0
9	38478643	.	A	T	2	7	9	0	1	10	0	0
9	38479579	.	A	G	1	0	1	0	5	6	0	0
9	38497393	.	C	T	2	3	5	0	0	5	0	0
9	38600006	.	G	A	0	2	2	0	2	4	0	0
9	38620058	.	C	T	12	4	16	0	0	16	0	0
9	38620673	.	A	G	19	15	34	0	0	34	0	0
9	38636797	.	T	C	2	2	4	0	2	6	0	0
9	38637072	.	G	T	4	2	6	0	0	6	0	0
9	38638452	.	A	T	3	3	6	0	1	7	0	0
9	38638461	.	C	G	3	4	7	0	0	7	0	0
9	38638518	.	T	C	3	3	6	0	0	6	0	0
9	38638743	.	T	C	5	4	9	0	1	10	0	0
9	38638862	.	C	T	5	3	8	0	1	9	0	0
9	38638863	.	C	A	5	3	8	0	1	9	0	0
9	38639846	.	C	T	3	4	7	0	1	8	0	0
9	38639907	.	A	C	4	7	11	0	1	12	0	0
9	38639999	.	C	T	5	4	9	0	1	10	0	0
9	38640114	.	T	A	7	7	14	0	0	14	0	0
9	38640186	.	T	C	10	3	13	0	0	13	0	0
9	38640193	.	T	C	9	3	12	0	0	12	0	0
9	38640598	.	A	G	4	1	5	0	6	11	0	0
9	38640773	.	A	T	3	3	6	0	0	6	0	0
9	38641111	.	C	T	3	5	8	0	0	8	0	0
9	38761700	.	G	A	0	1	1	0	1	2	0	0
9	38761708	.	A	G	1	2	3	0	0	3	0	0
9	38765158	.	C	T	1	3	4	0	0	4	0	0
9	38765179	.	A	G	0	0	0	0	3	3	0	0
9	40928199	.	T	C	3	4	7	0	1	8	0	0
9	40928245	.	T	C	9	5	14	0	3	17	0	0
9	40928284	.	T	C	12	0	12	0	6	18	0	0
9	40928650	.	T	C	5	4	9	0	1	10	0	0
9	40928669	.	T	C	3	2	5	0	2	7	0	0
9	40928706	.	T	C	3	4	7	0	0	7	0	0
9	40928717	.	T	C	3	2	5	0	2	7	0	0
9	41479980	.	A	G	3	3	6	0	0	6	0	0
9	41481164	.	A	G	2	2	4	0	0	4	0	0
9	41679684	.	A	T	2	1	3	0	2	5	0	0
9	41680581	.	A	G	20	10	30	0	0	30	0	0
9	42125881	.	A	T	4	1	5	0	1	6	0	0
9	42126308	.	A	T	9	2	11	0	0	11	0	0
9	42360743	.	C	G	3	3	6	0	2	8	0	0
9	42421044	.	G	T	5	3	8	0	0	8	0	0
9	42649583	.	A	G	2	2	4	0	1	5	0	0
9	42649636	.	T	A	3	2	5	0	0	5	0	0
9	42649653	.	T	C	4	4	8	0	0	8	0	0
9	42649739	.	C	T	6	5	11	0	1	12	0	0
9	42649743	.	A	G	7	5	12	0	0	12	0	0
9	42649923	.	A	G	3	6	9	0	1	10	0	0
9	42657418	.	A	T	1	2	3	0	0	3	0	0
9	42660036	.	T	C	2	2	4	0	0	4	0	0
9	43082398	.	A	G	3	3	6	0	0	6	0	0
9	43082519	.	C	A	0	3	3	0	2	5	0	0
9	43082541	.	A	C	2	0	2	0	0	2	0	0
9	43082717	.	T	G	1	2	3	0	1	4	0	0
9	43085471	.	G	C	4	4	8	0	1	9	0	0
9	43085728	.	A	C	5	5	10	0	1	11	0	0
9	43085879	.	C	T	7	2	9	0	0	9	0	0
9	43085949	.	A	C	1	2	3	0	1	4	0	0
9	43107246	.	A	G	1	2	3	0	0	3	0	0
9	43150018	.	T	A	7	12	19	0	0	19	0	0
9	43150278	.	T	G	9	7	16	0	2	18	0	0
9	43150604	.	A	G	17	15	32	0	0	32	0	0
9	43150817	.	C	T	0	11	11	0	15	26	0	0
9	43153287	.	C	T	2	4	6	0	1	7	0	0
9	43154841	.	C	T	1	3	4	0	0	4	0	0
9	43202097	.	T	C	1	0	1	0	1	2	0	0
9	43243224	.	T	G	2	4	6	0	0	6	0	0
9	43552604	.	C	A	10	7	17	0	1	18	0	0
9	43552687	.	A	C	13	9	22	0	0	22	0	0
9	43553036	.	G	T	11	18	29	1	0	30	0	0
9	43559501	.	A	C	12	5	17	0	1	18	0	0
9	43612482	.	T	G	1	2	3	0	0	3	0	0
9	43617899	.	A	G	1	0	1	0	0	1	0	0
9	43617962	.	A	G	6	2	8	0	1	9	0	0
9	44080411	.	C	T	2	2	4	0	0	4	0	0
9	44094445	.	T	A	1	2	3	0	1	4	0	0
9	44097854	.	C	T	0	0	0	0	1	1	0	0
9	44109589	.	T	C	3	0	3	0	5	8	0	0
9	44109595	.	T	C	2	0	2	0	6	8	0	0
9	44292737	.	T	C	21	27	48	0	2	50	0	0
9	44292909	.	C	T	1	34	35	0	24	59	0	0
9	44293488	.	C	T	16	28	44	0	1	45	0	0
9	44294792	.	A	G	2	2	4	0	0	4	0	0
9	44400580	.	G	A	1	2	3	0	0	3	0	0
9	44411647	.	A	G	2	2	4	0	1	5	0	0
9	44411652	.	C	A	2	4	6	0	0	6	0	0
9	44419652	.	T	A	0	1	1	0	2	3	0	0
9	44419793	.	C	A	1	3	4	0	1	5	0	0
9	44431117	.	G	A	5	6	11	0	2	13	0	0
9	44486011	.	A	G	5	6	11	0	0	11	0	0
9	44488578	.	T	A	3	7	10	0	0	10	0	0
9	44488620	.	G	A	1	4	5	0	0	5	0	0
9	44489843	.	G	A	0	6	6	0	13	19	0	0
9	44489844	.	T	A	13	6	19	0	0	19	0	0
9	44498332	.	T	C	2	6	8	0	0	8	0	0
9	44511218	.	C	T	1	0	1	0	0	1	0	0
9	45551273	.	T	C	8	15	23	0	2	25	0	0
9	45552338	.	T	G	10	12	22	0	3	25	0	0
9	45552364	.	G	A	0	11	11	0	7	18	0	0
9	45552386	.	C	G	11	16	27	0	1	28	0	0
9	45552567	.	G	A	2	20	22	0	19	41	0	0
9	45552715	.	C	T	19	18	37	0	1	38	0	0
9	45552806	.	G	A	0	23	23	0	11	34	0	0
9	45552881	.	T	C	13	20	33	0	0	33	0	0
9	45552924	.	C	A	13	15	28	0	1	29	0	0
9	45552957	.	C	T	18	16	34	0	0	34	0	0
9	45623346	.	C	T	1	2	3	0	0	3	0	0
9	45623446	.	A	G	3	3	6	0	0	6	0	0
9	45666600	.	G	A	2	1	3	0	1	4	0	0
9	45667103	.	C	T	0	2	2	0	0	2	0	0
9	45884711	.	G	A	1	2	3	0	0	3	0	0
9	46409361	.	G	C	0	2	2	0	0	2	0	0
9	46683760	.	C	A	0	3	3	0	0	3	0	0
9	46683861	.	A	C	2	2	4	0	0	4	0	0
9	46692261	.	T	G	21	22	43	0	6	49	0	0
9	46820808	.	C	T	0	3	3	0	5	8	0	0
9	46821464	.	C	T	11	9	20	0	1	21	0	0
9	46821685	.	A	G	2	4	6	0	0	6	0	0
9	46821853	.	G	A	0	3	3	0	0	3	0	0
9	46821855	.	G	T	0	3	3	0	0	3	0	0
9	46821905	.	A	G	4	5	9	0	1	10	0	0
9	46821916	.	A	T	3	8	11	0	1	12	0	0
9	46822002	.	T	C	4	5	9	0	0	9	0	0
9	46822079	.	C	T	8	4	12	0	3	15	0	0
9	46822120	.	C	T	0	9	9	0	5	14	0	0
9	46822144	.	T	C	5	6	11	0	2	13	0	0
9	46822417	.	C	T	0	2	2	0	4	6	0	0
9	46823198	.	C	T	6	10	16	0	0	16	0	0
9	46823325	.	G	A	11	7	18	0	1	19	0	0
9	46823366	.	T	C	7	12	19	0	3	22	0	0
9	46823524	.	A	G	8	10	18	0	2	20	0	0
9	46824110	.	A	G	5	9	14	0	1	15	0	0
9	46824160	.	T	A	4	3	7	0	0	7	0	0
9	48054753	.	G	A	12	12	24	0	3	27	0	0
9	48060592	.	G	C	10	13	23	0	2	25	0	0
9	48076973	.	C	T	13	10	23	0	2	25	0	0
9	48127200	.	G	A	4	1	5	0	0	5	0	0
9	48127452	.	G	A	1	0	1	0	0	1	0	0
9	48128027	.	G	T	0	2	2	0	2	4	0	0
9	48131814	.	A	T	3	6	9	0	1	10	0	0
9	48131865	.	G	A	1	5	6	0	0	6	0	0
9	48131883	.	A	G	1	3	4	0	1	5	0	0
9	48132095	.	A	C	7	3	10	0	2	12	0	0
9	48132156	.	A	C	4	8	12	0	1	13	0	0
9	48132176	.	C	T	5	9	14	0	0	14	0	0
9	48132194	.	G	T	6	5	11	0	0	11	0	0
9	48132309	.	G	T	2	3	5	0	2	7	0	0
9	48132336	.	C	T	1	5	6	0	1	7	0	0
9	48132439	.	G	A	4	4	8	0	0	8	0	0
9	48132441	.	A	G	4	4	8	0	0	8	0	0
9	48132531	.	G	A	2	3	5	0	0	5	0	0
9	48132592	.	G	T	5	5	10	0	1	11	0	0
9	48133013	.	T	C	0	2	2	0	4	6	0	0
9	48133105	.	G	T	5	5	10	0	0	10	0	0
9	48133541	.	T	C	4	3	7	0	1	8	0	0
9	48133687	.	A	G	2	3	5	0	1	6	0	0
9	48133900	.	G	T	8	3	11	0	0	11	0	0
9	48134012	.	T	A	1	2	3	0	0	3	0	0
9	48134201	.	A	T	1	3	4	0	1	5	0	0
9	48134351	.	G	A	5	3	8	0	3	11	0	0
9	48134568	.	G	A	1	6	7	0	3	10	0	0
9	48134678	.	A	T	3	0	3	0	0	3	0	0
9	48189403	.	C	G	0	0	0	0	1	1	0	0
9	48227847	.	T	A	1	2	3	0	0	3	0	0
9	48227885	.	T	G	3	2	5	0	1	6	0	0
9	48227953	.	T	C	2	3	5	0	0	5	0	0
9	48228950	.	T	C	1	0	1	0	0	1	0	0
9	48284901	.	T	C	7	11	18	0	0	18	0	0
9	48284917	.	C	A	0	9	9	0	8	17	0	0
9	48284972	.	T	C	7	4	11	0	1	12	0	0
9	48285019	.	G	A	2	2	4	0	0	4	0	0
9	48286702	.	G	A	2	2	4	0	0	4	0	0
9	48287441	.	G	A	1	5	6	0	0	6	0	0
9	48289758	.	G	A	1	1	2	0	0	2	0	0
9	48289797	.	A	T	1	1	2	0	0	2	0	0
9	48289961	.	A	G	2	3	5	0	0	5	0	0
9	48289991	.	T	C	4	4	8	0	0	8	0	0
9	48668834	.	C	G	2	4	6	0	0	6	0	0
9	48670747	.	T	G	4	0	4	0	4	8	0	0
9	48670748	.	T	C	4	4	8	0	0	8	0	0
9	48671052	.	A	G	3	2	5	0	0	5	0	0
9	48831028	.	A	T	2	1	3	0	0	3	0	0
9	48870578	.	T	C	9	0	9	0	12	21	0	0
9	48870593	.	A	T	12	11	23	0	0	23	0	0
9	48870627	.	T	A	13	9	22	0	0	22	0	0
9	48870680	.	A	G	6	5	11	0	1	12	0	0
9	48870886	.	C	T	13	7	20	0	1	21	0	0
9	48871080	.	G	C	9	4	13	0	0	13	0	0
9	48871966	.	T	G	8	4	12	0	2	14	0	0
9	48871973	.	A	C	6	7	13	0	0	13	0	0
9	48872039	.	C	G	0	4	4	0	2	6	0	0
9	48872050	.	C	T	0	5	5	0	0	5	0	0
9	48872890	.	C	A	6	3	9	0	0	9	0	0
9	48872924	.	A	G	6	4	10	0	2	12	0	0
9	48872926	.	C	T	0	6	6	0	6	12	0	0
9	48873371	.	A	G	2	2	4	0	0	4	0	0
9	48873522	.	C	G	3	2	5	0	0	5	0	0
9	48874562	.	G	A	5	5	10	0	0	10	0	0
9	48874577	.	G	A	4	2	6	0	1	7	0	0
9	48875510	.	T	C	3	2	5	0	1	6	0	0
9	48875516	.	G	A	1	4	5	0	1	6	0	0
9	48876158	.	C	A	2	1	3	0	0	3	0	0
9	48876161	.	A	G	1	2	3	0	0	3	0	0
9	48876587	.	A	G	2	3	5	0	0	5	0	0
9	50755144	.	A	T	1	3	4	0	0	4	0	0
9	51302422	.	A	G	2	3	5	0	0	5	0	0
9	51430886	.	G	C	5	3	8	0	1	9	0	0
9	51431179	.	C	G	8	9	17	0	1	18	0	0
9	51432279	.	T	G	5	6	11	0	1	12	0	0
9	51432381	.	C	T	0	2	2	0	6	8	0	0
9	51996212	.	A	T	6	7	13	0	1	14	0	0
9	51996246	.	C	T	1	8	9	0	6	15	0	0
9	51996280	.	T	A	10	7	17	0	0	17	0	0
9	51996281	.	G	A	10	7	17	0	0	17	0	0
9	51996444	.	T	G	14	10	24	0	3	27	0	0
9	51996469	.	C	T	0	13	13	0	12	25	0	0
9	51996788	.	A	G	1	3	4	0	1	5	0	0
9	51996868	.	T	A	0	4	4	0	0	4	0	0
9	51996876	.	A	G	5	2	7	0	0	7	0	0
9	51998648	.	C	T	6	4	10	0	0	10	0	0
9	51998761	.	C	G	2	8	10	0	0	10	0	0
9	51998866	.	A	T	0	9	9	0	0	9	0	0
9	51998887	.	T	G	2	6	8	0	0	8	0	0
9	51999991	.	A	G	1	2	3	0	0	3	0	0
9	52000088	.	G	A	1	2	3	0	1	4	0	0
9	52000248	.	T	A	5	2	7	0	0	7	0	0
9	52000335	.	A	T	4	3	7	0	0	7	0	0
9	52000665	.	A	G	1	3	4	0	0	4	0	0
9	52378697	.	A	G	20	17	37	0	0	37	0	0
9	52378832	.	T	A	5	17	22	0	0	22	0	0
9	52432669	.	T	C	0	0	0	0	1	1	0	0
9	52435058	.	G	C	2	2	4	0	0	4	0	0
9	52435100	.	G	A	2	1	3	0	0	3	0	0
9	52435112	.	C	T	2	1	3	0	0	3	0	0
9	52439166	.	G	A	0	2	2	0	0	2	0	0
9	52439171	.	C	A	0	2	2	0	0	2	0	0
9	52479199	.	T	C	0	4	4	0	0	4	0	0
9	52487494	.	T	A	1	2	3	0	0	3	0	0
9	52492641	.	A	C	2	2	4	0	0	4	0	0
9	52492705	.	A	G	2	8	10	0	2	12	0	0
9	52493059	.	A	T	6	1	7	0	0	7	0	0
9	52493231	.	A	T	3	8	11	0	1	12	0	0
9	52532370	.	C	G	7	1	8	0	1	9	0	0
9	52539290	.	G	A	0	4	4	0	3	7	0	0
9	52539453	.	C	T	11	16	27	0	1	28	0	0
9	52539629	.	C	T	13	4	17	0	0	17	0	0
9	52564622	.	T	C	1	0	1	0	0	1	0	0
9	52572609	.	C	G	5	3	8	0	0	8	0	0
9	52574737	.	C	G	3	2	5	0	0	5	0	0
9	52628995	.	G	A	2	3	5	0	0	5	0	0
9	52629113	.	C	T	2	2	4	0	1	5	0	0
9	52629119	.	C	T	3	2	5	0	0	5	0	0
9	52633151	.	C	T	1	2	3	0	0	3	0	0
9	52633184	.	C	G	1	2	3	0	0	3	0	0
9	52642012	.	G	A	1	0	1	0	0	1	0	0
9	53276550	.	A	C	3	3	6	0	0	6	0	0
9	53276681	.	G	A	0	2	2	0	2	4	0	0
9	53276976	.	C	T	4	6	10	0	0	10	0	0
9	53276978	.	A	G	6	4	10	0	0	10	0	0
9	53277068	.	C	G	4	0	4	0	10	14	0	0
9	53277131	.	A	T	5	9	14	0	0	14	0	0
9	53277453	.	G	A	0	6	6	0	10	18	2	0
9	53277493	.	A	T	11	12	23	0	3	26	0	0
9	53709003	.	C	T	1	3	4	0	0	4	0	0
9	53709184	.	T	C	3	4	7	0	0	7	0	0
9	53709365	.	C	T	1	3	4	0	0	4	0	0
9	53715525	.	G	A	3	1	4	0	0	4	0	0
9	53719342	.	T	C	11	7	18	0	0	18	0	0
9	53843404	.	C	T	8	14	22	0	0	22	0	0
9	53843590	.	A	T	5	7	12	0	3	15	0	0
9	53843737	.	T	C	6	1	7	0	4	11	0	0
9	53843909	.	C	T	0	4	4	0	4	8	0	0
9	53844188	.	T	C	4	0	4	0	2	6	0	0
9	53845537	.	A	G	8	4	12	0	0	12	0	0
9	53849389	.	T	C	2	1	3	0	4	7	0	0
9	53849440	.	G	A	2	4	6	0	1	7	0	0
9	53853614	.	C	T	0	1	1	0	0	1	0	0
9	53853615	.	T	C	0	1	1	0	0	1	0	0
9	53867508	.	A	G	1	1	2	0	0	2	0	0
9	53867511	.	A	G	1	1	2	0	0	2	0	0
9	53869247	.	G	A	2	2	4	0	2	6	0	0
9	53869344	.	T	C	3	2	5	0	0	5	0	0
9	53890345	.	G	T	2	2	4	0	0	4	0	0
9	54113954	.	C	T	0	3	3	0	1	4	0	0
9	54256221	.	C	G	1	2	3	0	0	3	0	0
9	54256286	.	C	A	0	2	2	0	2	4	0	0
9	54264236	.	T	C	3	4	7	0	1	8	0	0
9	54264245	.	T	C	2	4	6	0	0	6	0	0
9	54264272	.	C	T	3	2	5	0	0	5	0	0
9	54270348	.	T	A	2	1	3	0	0	3	0	0
9	54273514	.	G	T	0	1	1	0	1	2	0	0
9	54273797	.	C	T	1	0	1	0	1	2	0	0
9	54315617	.	T	G	2	3	5	0	0	5	0	0
9	54331768	.	G	A	0	1	1	0	0	1	0	0
9	54336738	.	A	G	1	1	2	0	0	2	0	0
9	54711020	.	G	T	9	12	21	0	1	22	0	0
9	54711496	.	C	A	3	0	3	1	0	4	0	0
9	54712342	.	C	T	4	5	9	0	0	9	0	0
9	54712366	.	T	G	4	7	11	0	1	12	0	0
9	54712384	.	T	C	6	8	14	0	1	15	0	0
9	54712650	.	T	C	4	13	17	0	1	18	0	0
9	54712704	.	A	G	7	4	11	0	2	13	0	0
9	54712745	.	T	C	5	12	17	0	2	19	0	0
9	54712751	.	C	T	8	11	19	0	1	20	0	0
9	54712917	.	A	T	10	11	21	0	1	22	0	0
9	54712945	.	G	A	6	10	16	0	1	17	0	0
9	54712985	.	A	C	6	11	17	0	1	18	0	0
9	54715157	.	T	C	1	3	4	0	1	5	0	0
9	54716349	.	G	A	3	4	7	0	0	7	0	0
9	54722553	.	T	C	2	2	4	0	0	4	0	0
9	54738987	.	C	T	4	2	6	0	0	6	0	0
9	54739015	.	A	T	2	5	7	0	0	7	0	0
9	54739181	.	C	G	0	3	3	0	0	3	0	0
9	54739182	.	C	A	0	3	3	0	0	3	0	0
9	54739539	.	C	A	1	3	4	0	0	4	0	0
9	54751753	.	T	C	2	5	7	0	0	7	0	0
9	54763977	.	T	A	2	2	4	0	1	5	0	0
9	54764349	.	G	A	2	2	4	0	0	4	0	0
9	54940662	.	T	C	1	6	7	0	2	9	0	0
9	55748855	.	C	A	2	4	6	0	1	7	0	0
9	55749108	.	T	C	4	4	8	0	0	8	0	0
9	55750151	.	C	T	3	3	6	0	0	6	0	0
9	55750306	.	C	T	0	5	5	0	1	6	0	0
9	55750357	.	A	C	2	0	2	0	2	4	0	0
9	55750367	.	G	A	2	1	3	0	2	5	0	0
9	55750649	.	G	C	4	3	7	0	0	7	0	0
9	55750792	.	C	T	1	6	7	0	4	11	0	0
9	55771841	.	C	T	2	3	5	0	0	5	0	0
9	55860127	.	C	T	0	4	4	0	1	5	0	0
9	55870475	.	G	A	0	2	2	0	1	3	0	0
9	55874397	.	A	C	1	5	6	0	0	6	0	0
9	55874548	.	A	T	3	8	11	0	1	12	0	0
9	55874753	.	T	G	2	3	5	0	1	6	0	0
9	56225740	.	T	A	8	11	19	0	1	20	0	0
9	56225849	.	A	G	11	4	15	0	0	15	0	0
9	56225850	.	A	G	11	4	15	0	0	15	0	0
9	56226132	.	T	C	4	3	7	0	1	8	0	0
9	56230655	.	A	G	18	14	32	0	0	32	0	0
9	56230676	.	G	T	22	25	47	0	0	47	0	0
9	56231322	.	T	C	14	9	23	0	3	26	0	0
9	56231325	.	A	G	17	9	26	0	0	26	0	0
9	56237727	.	T	C	2	2	4	0	0	4	0	0
9	56237883	.	T	C	2	4	6	0	0	6	0	0
9	56350968	.	C	T	0	4	4	0	5	9	0	0
9	56351059	.	C	T	7	9	16	0	1	17	0	0
9	56353479	.	G	A	6	2	8	0	0	8	0	0
9	56363292	.	T	A	2	6	8	0	1	9	0	0
9	56369168	.	G	T	1	1	2	0	1	3	0	0
9	56369252	.	G	A	4	7	11	0	1	12	0	0
9	56369319	.	C	A	1	0	1	0	1	2	0	0
9	56389303	.	A	G	0	3	3	0	0	3	0	0
9	56456064	.	C	T	1	10	11	0	0	11	0	0
9	56456065	.	G	C	0	10	10	0	1	11	0	0
9	56457309	.	A	T	11	8	19	0	0	19	0	0
