contig	position	variantID	refAllele	altAllele	refCount	altCount	totalCount	lowMAPQDepth	lowBaseQDepth	rawDepth	otherBases	improperPairs
1	208564	.	T	C	3	2	5	0	1	6	0	0
1	209147	.	T	C	3	8	11	0	0	11	0	0
1	209162	.	T	C	7	5	12	0	0	12	0	0
1	474273	.	C	G	0	4	4	0	0	4	0	0
1	474286	.	T	A	1	3	4	0	0	4	0	0
1	504977	.	A	G	5	6	11	0	0	11	0	0
1	505212	.	T	C	1	5	6	0	0	6	0	0
1	618671	.	T	C	19	4	23	0	4	27	0	0
1	620063	.	G	T	7	10	17	1	2	20	0	0
1	970637	.	C	T	4	9	13	0	1	14	0	0
1	970638	.	G	T	0	7	7	0	7	14	0	0
1	970803	.	C	A	4	5	9	0	0	9	0	0
1	1609386	.	G	A	0	2	2	0	1	3	0	0
1	1614481	.	C	T	4	4	8	0	0	8	0	0
1	1627461	.	G	A	1	3	4	0	0	4	0	0
1	1629006	.	C	G	0	1	1	0	0	1	0	0
1	1721251	.	G	C	0	2	2	0	2	4	0	0
1	1723403	.	C	T	1	4	5	0	0	5	0	0
1	1723442	.	C	T	1	2	3	0	1	4	0	0
1	1724080	.	G	A	0	1	1	0	0	1	0	0
1	1724149	.	G	A	3	3	6	0	1	7	0	0
1	1724527	.	C	T	3	4	7	0	1	8	0	0
1	1890351	.	T	C	10	5	15	0	0	15	0	0
1	1893253	.	G	A	1	1	2	0	3	5	0	0
1	1893363	.	T	C	2	2	4	0	0	4	0	0
1	2214937	.	G	C	2	3	5	0	0	5	0	0
1	2215093	.	T	C	9	5	14	0	1	15	0	0
1	2215744	.	T	A	5	6	11	0	1	12	0	0
1	2216744	.	G	A	0	6	6	0	5	11	0	0
1	2217267	.	A	T	27	20	47	0	0	47	0	0
1	2279245	.	G	T	1	2	3	0	0	3	0	0
1	2285262	.	G	A	3	1	4	0	0	4	0	0
1	2288740	.	C	T	2	1	3	0	0	3	0	0
1	2294576	.	T	C	4	5	9	0	0	9	0	0
1	2294582	.	T	C	5	4	9	0	0	9	0	0
1	2296791	.	A	C	8	13	21	0	3	24	0	0
1	2296806	.	C	T	12	6	18	0	1	19	0	0
1	2298752	.	T	A	10	5	15	0	3	18	0	0
1	2298889	.	T	A	11	2	13	0	0	13	0	0
1	2299051	.	C	G	14	13	27	0	2	29	0	0
1	2299188	.	T	A	14	16	30	0	1	31	0	0
1	2299486	.	G	A	11	4	15	0	1	16	0	0
1	2443832	.	G	A	4	5	9	0	0	9	0	0
1	2443868	.	T	C	4	5	9	0	0	9	0	0
1	6185259	.	T	G	5	15	20	0	0	20	0	0
1	6234077	.	A	G	1	2	3	0	0	3	0	0
1	6234090	.	C	T	1	2	3	0	0	3	0	0
1	6241379	.	G	T	0	1	1	0	6	7	0	0
1	6241427	.	T	G	1	0	1	0	0	1	0	0
1	6243620	.	T	C	5	5	10	0	0	10	0	0
1	6243626	.	A	C	4	4	8	0	1	9	0	0
1	6252887	.	T	C	1	0	1	0	0	1	0	0
1	6266294	.	C	T	3	3	6	0	0	6	0	0
1	6272029	.	C	T	2	1	3	0	1	4	0	0
1	6404659	.	G	A	3	2	5	0	0	5	0	0
1	7518644	.	C	T	1	2	3	0	0	3	0	0
1	7528289	.	G	C	0	8	8	0	12	20	0	0
1	7530123	.	C	T	0	1	1	0	0	1	0	0
1	7538822	.	C	T	9	13	22	0	1	23	0	0
1	7538971	.	T	C	23	23	46	0	5	51	0	0
1	7539000	.	C	A	20	18	38	0	8	46	0	0
1	7539053	.	G	C	17	12	29	0	2	31	0	0
1	7539074	.	A	C	15	14	29	0	1	30	0	0
1	7560705	.	T	A	12	15	27	0	4	31	0	0
1	7632221	.	C	T	3	2	5	0	0	5	0	0
1	7662275	.	T	C	17	20	37	0	3	40	0	0
1	7662628	.	G	A	16	23	39	0	2	41	0	0
1	7662880	.	A	T	17	16	33	0	1	34	0	0
1	7662949	.	C	T	19	17	36	0	2	38	0	0
1	7668211	.	A	G	14	13	27	0	1	28	0	0
1	7668298	.	C	T	11	9	20	0	2	22	0	0
1	7673070	.	C	T	2	5	7	0	2	9	0	0
1	7673129	.	C	A	3	6	9	0	0	9	0	0
1	7682912	.	A	C	5	11	16	0	2	18	0	0
1	7682923	.	A	G	7	8	15	0	2	17	0	0
1	7682949	.	G	A	4	8	12	0	1	13	0	0
1	7853375	.	T	G	3	1	4	0	1	5	0	0
1	8017585	.	G	A	0	1	1	0	0	1	0	0
1	8022503	.	T	A	14	10	24	0	1	25	0	0
1	8022505	.	T	C	14	10	24	0	1	25	0	0
1	8022817	.	T	A	17	19	36	0	3	39	0	0
1	8023471	.	A	T	8	4	12	0	1	13	0	0
1	8023490	.	A	C	5	3	8	0	2	10	0	0
1	8023559	.	A	T	10	9	19	0	1	20	0	0
1	8023587	.	A	G	11	9	20	0	1	21	0	0
1	8023639	.	C	A	7	3	10	0	1	11	0	0
1	8023658	.	A	T	4	5	9	0	0	9	0	0
1	8023730	.	C	T	12	8	20	0	0	20	0	0
1	8026146	.	C	T	0	5	5	0	1	6	0	0
1	8026148	.	T	G	1	5	6	0	0	6	0	0
1	8026415	.	C	T	0	6	6	0	3	9	0	0
1	8028626	.	T	G	2	2	4	0	0	4	0	0
1	8128710	.	G	A	3	2	5	0	0	5	0	0
1	8165609	.	C	T	9	14	23	0	0	23	0	0
1	8165667	.	T	C	5	7	12	0	0	12	0	0
1	8165769	.	T	A	1	6	7	0	2	9	0	0
1	8165802	.	C	T	5	5	10	0	2	12	0	0
1	8165937	.	G	A	4	5	9	0	1	10	0	0
1	8165947	.	C	T	4	5	9	0	0	9	0	0
1	8166992	.	A	G	5	9	14	0	1	15	0	0
1	8167383	.	G	A	4	3	7	0	0	7	0	0
1	8167526	.	C	T	3	3	6	0	0	6	0	0
1	8167668	.	G	A	2	7	9	0	0	9	0	0
1	8169361	.	G	A	4	1	5	0	1	6	0	0
1	8189518	.	G	T	0	1	1	0	0	1	0	0
1	8417896	.	T	C	7	9	16	0	0	16	0	0
1	8422521	.	A	G	3	5	8	0	0	8	0	0
1	8424735	.	G	A	2	3	5	0	0	5	0	0
1	8557075	.	G	A	5	4	9	0	0	9	0	0
1	8557159	.	T	A	2	0	2	0	1	3	0	0
1	8560237	.	C	T	1	2	3	0	0	3	0	0
1	8560266	.	C	T	1	3	4	0	0	4	0	0
1	8560289	.	C	T	2	2	4	0	0	4	0	0
1	8602025	.	A	G	0	2	2	0	0	2	0	0
1	8639877	.	G	A	1	0	1	0	0	1	0	0
1	8642800	.	C	T	2	2	4	0	0	4	0	0
1	8642824	.	A	T	1	2	3	0	0	3	0	0
1	8642953	.	C	T	2	4	6	0	0	6	0	0
1	8649726	.	A	G	9	8	17	0	2	19	0	0
1	8649865	.	C	T	15	20	35	0	1	36	0	0
1	8649988	.	A	G	12	8	20	0	0	20	0	0
1	8649994	.	A	T	9	5	14	0	1	15	0	0
1	8650317	.	G	A	15	21	36	0	0	36	0	0
1	8650371	.	C	T	14	27	41	0	0	41	0	0
1	8651036	.	G	A	15	15	30	0	0	30	0	0
1	8651060	.	T	C	8	7	15	0	0	15	0	0
1	8651576	.	G	A	10	12	22	0	0	22	0	0
1	8662553	.	G	A	2	6	8	0	0	8	0	0
1	8663048	.	G	A	0	4	4	0	2	6	0	0
1	8663195	.	T	G	2	3	5	0	1	6	0	0
1	8663295	.	T	C	5	3	8	0	0	8	0	0
1	8667606	.	C	T	4	3	7	0	0	7	0	0
1	8668166	.	T	C	13	16	29	0	2	31	0	0
1	8668238	.	G	T	10	6	16	0	2	18	0	0
1	8669533	.	G	T	8	2	10	0	1	11	0	0
1	8669669	.	A	G	13	6	19	0	3	22	0	0
1	8669673	.	A	G	16	5	21	0	3	24	0	0
1	8669717	.	T	G	9	12	21	0	0	21	0	0
1	8669718	.	T	C	9	11	20	0	1	21	0	0
1	8669753	.	T	A	11	11	22	0	3	25	0	0
1	8669847	.	G	T	13	20	33	0	3	36	0	0
1	8670031	.	T	C	18	33	51	0	1	52	0	0
1	8670032	.	G	T	0	17	17	0	35	52	0	0
1	8670159	.	T	C	28	20	48	0	3	51	0	0
1	8670180	.	T	C	24	22	46	0	9	55	0	0
1	8670402	.	G	A	20	23	43	0	0	43	0	0
1	8670460	.	A	G	2	3	5	0	3	8	0	0
1	8694404	.	G	A	3	4	7	0	0	7	0	0
1	8698765	.	T	C	11	4	15	0	0	15	0	0
1	8698799	.	C	T	8	11	19	0	0	19	0	0
1	8698834	.	T	A	5	4	9	0	1	10	0	0
1	8701623	.	C	T	14	9	23	0	2	25	0	0
1	8701747	.	G	A	14	7	21	1	0	22	0	0
1	8702154	.	G	A	11	4	15	0	1	16	0	0
1	8702158	.	G	A	12	4	16	0	1	17	0	0
1	8702325	.	G	T	14	15	29	0	2	31	0	0
1	8763824	.	A	G	7	10	17	0	0	17	0	0
1	8763832	.	A	C	7	0	7	0	12	19	0	0
1	8764123	.	C	T	7	6	13	0	0	13	0	0
1	8764443	.	T	A	1	2	3	0	0	3	0	0
1	8764612	.	T	C	9	0	9	0	14	23	0	0
1	8764661	.	T	A	15	13	28	0	1	29	0	0
1	8764729	.	C	T	18	11	29	0	0	29	0	0
1	8764760	.	G	A	17	8	25	0	0	25	0	0
1	8764811	.	C	T	0	4	4	0	8	12	0	0
1	8764812	.	G	A	8	4	12	0	0	12	0	0
1	8765315	.	A	G	20	12	32	0	2	34	0	0
1	8765422	.	G	A	10	16	26	0	2	28	0	0
1	8765713	.	A	C	14	20	34	0	3	37	0	0
1	8765724	.	A	G	14	20	34	0	3	37	0	0
1	8766267	.	T	C	3	0	3	0	7	10	0	0
1	8766453	.	C	T	3	2	5	0	0	5	0	0
1	8766471	.	C	T	0	3	3	0	2	5	0	0
1	8766501	.	C	T	3	2	5	0	0	5	0	0
1	8767002	.	C	T	1	3	4	0	0	4	0	0
1	8767260	.	T	C	2	2	4	0	1	5	0	0
1	8767395	.	A	G	1	2	3	0	0	3	0	0
1	8974620	.	A	G	1	4	5	0	1	6	0	0
1	8974695	.	A	T	1	2	3	0	0	3	0	0
1	9064611	.	T	C	1	4	5	0	0	5	0	0
1	9074440	.	T	C	4	5	9	0	0	9	0	0
1	9118497	.	T	A	8	13	21	0	0	21	0	0
1	9123262	.	A	G	3	2	5	0	0	5	0	0
1	9145260	.	C	T	1	1	2	0	1	3	0	0
1	9145541	.	T	C	3	8	11	0	0	11	0	0
1	9145696	.	A	T	2	3	5	0	0	5	0	0
1	9214635	.	C	T	1	3	4	0	0	4	0	0
1	9262077	.	A	G	5	9	14	0	0	14	0	0
1	9262080	.	A	G	5	8	13	0	0	13	0	0
1	9265578	.	T	C	2	2	4	0	0	4	0	0
1	9273947	.	G	C	1	2	3	0	0	3	0	0
1	9277858	.	T	C	3	3	6	0	0	6	0	0
1	9293041	.	C	T	2	6	8	0	0	8	0	0
1	9293117	.	G	A	1	6	7	0	8	15	0	0
1	9293156	.	G	A	7	11	18	0	1	19	0	0
1	9293185	.	T	C	5	13	18	0	1	19	0	0
1	9293215	.	G	A	6	14	20	0	3	23	0	0
1	9293495	.	A	G	6	11	17	0	3	20	0	0
1	9293580	.	C	T	11	10	21	0	1	22	0	0
1	9293740	.	T	C	7	10	17	0	0	17	0	0
1	9293889	.	C	A	3	5	8	0	1	9	0	0
1	9499764	.	C	T	13	10	23	0	3	26	0	0
1	9500312	.	A	T	2	6	8	0	0	8	0	0
1	9500361	.	T	C	0	2	2	0	0	2	0	0
1	9500371	.	T	C	0	0	0	0	1	1	0	0
1	9500502	.	G	T	4	3	7	0	0	7	0	0
1	9500508	.	C	A	2	3	5	0	2	8	1	0
1	9500835	.	A	G	4	6	10	0	0	10	0	0
1	9500947	.	G	T	2	6	8	0	1	9	0	0
1	9500984	.	A	T	0	4	4	0	0	4	0	0
1	9501229	.	C	T	4	6	10	0	2	12	0	0
1	9501231	.	G	A	8	4	12	0	0	12	0	0
1	9501394	.	T	A	3	5	8	0	0	8	0	0
1	9741123	.	G	A	2	4	6	0	1	7	0	0
1	9793219	.	C	T	2	1	3	0	0	3	0	0
1	9793220	.	T	C	2	0	2	0	1	3	0	0
1	9808324	.	A	G	2	0	2	0	0	2	0	0
1	9808345	.	T	A	2	0	2	0	0	2	0	0
1	9866634	.	C	A	2	0	2	0	0	2	0	0
1	9866637	.	G	A	2	1	3	0	0	3	0	0
1	9873607	.	A	T	2	2	4	0	4	8	0	0
1	9873616	.	T	C	4	0	4	0	5	9	0	0
1	9873787	.	G	A	0	2	2	0	0	2	0	0
1	10315016	.	A	T	6	3	9	0	0	9	0	0
1	10683955	.	A	G	3	2	5	0	1	6	0	0
1	10683974	.	A	C	3	2	5	0	1	6	0	0
1	10684105	.	G	A	1	2	3	0	4	7	0	0
1	10736181	.	G	A	1	1	2	0	0	2	0	0
1	10738176	.	A	G	4	3	7	0	0	7	0	0
1	10738177	.	A	G	5	2	7	0	0	7	0	0
1	10738509	.	T	C	20	15	35	0	0	35	0	0
1	10738535	.	G	A	17	15	32	0	2	34	0	0
1	10738863	.	C	A	23	26	49	0	1	50	0	0
1	10739190	.	A	G	17	10	27	0	4	31	0	0
1	10841254	.	T	C	7	6	13	0	0	13	0	0
1	10841275	.	T	C	9	4	13	0	0	13	0	0
1	10841356	.	G	A	0	2	2	0	0	2	0	0
1	11670963	.	T	C	7	3	10	0	1	11	0	0
1	11671042	.	T	C	4	2	6	0	0	6	0	0
1	11671059	.	A	G	6	4	10	0	0	10	0	0
1	11671355	.	C	A	4	7	11	0	1	12	0	0
1	11671527	.	G	A	10	7	17	0	1	18	0	0
1	11671580	.	C	T	3	7	10	0	1	11	0	0
1	11783388	.	T	C	3	8	11	0	1	12	0	0
1	11783650	.	T	C	7	9	16	0	0	16	0	0
1	11784679	.	T	C	2	11	13	0	2	15	0	0
1	13951733	.	C	T	1	3	4	0	0	4	0	0
1	15253397	.	C	G	1	2	3	0	1	4	0	0
1	16127926	.	C	T	0	9	9	0	0	9	0	0
1	17523030	.	A	G	8	0	8	0	16	24	0	0
1	17535859	.	A	G	4	7	11	0	1	12	0	0
1	17538085	.	T	C	3	0	3	0	7	10	0	0
1	17538116	.	C	T	1	1	2	0	1	3	0	0
1	17538198	.	T	C	17	5	22	0	2	24	0	0
1	19882538	.	C	A	0	1	1	0	0	1	0	0
1	19886333	.	A	T	1	3	4	0	0	4	0	0
1	20063843	.	C	A	0	9	9	0	6	15	0	0
1	20065156	.	A	G	1	2	3	0	0	3	0	0
1	20140042	.	G	T	0	2	2	0	1	3	0	0
1	20140048	.	A	T	1	2	3	0	0	3	0	0
1	20140200	.	C	T	2	0	2	0	0	2	0	0
1	20140363	.	T	G	3	3	6	0	0	6	0	0
1	20140951	.	G	A	0	6	6	0	7	13	0	0
1	20140952	.	G	A	6	6	12	0	1	13	0	0
1	20141070	.	C	A	3	4	7	0	1	8	0	0
1	20141106	.	A	G	2	4	6	0	2	8	0	0
1	20141310	.	G	A	16	6	22	0	0	22	0	0
1	20141411	.	A	T	18	7	25	0	0	25	0	0
1	20141572	.	G	A	0	7	7	0	6	13	0	0
1	20141611	.	T	C	5	6	11	0	0	11	0	0
1	20147248	.	T	A	7	12	19	0	1	20	0	0
1	20160882	.	T	A	4	5	9	0	1	10	0	0
1	20166536	.	C	A	3	5	8	0	1	9	0	0
1	20166600	.	A	G	5	3	8	0	0	8	0	0
1	20212239	.	G	A	1	1	2	0	0	2	0	0
1	20212284	.	C	T	1	2	3	0	0	3	0	0
1	20556179	.	G	A	6	1	7	0	1	8	0	0
1	20557447	.	G	A	4	4	8	0	0	8	0	0
1	20557650	.	C	T	3	3	6	0	1	7	0	0
1	20678674	.	G	C	3	0	3	0	0	3	0	0
1	20694955	.	A	G	7	4	11	0	0	11	0	0
1	20695073	.	G	A	0	1	1	0	8	9	0	0
1	20700473	.	T	C	18	16	34	0	1	35	0	0
1	20700524	.	G	A	0	10	10	0	11	21	0	0
1	20704896	.	T	C	9	13	22	0	0	22	0	0
1	20705237	.	C	T	17	16	33	0	1	34	0	0
1	20705863	.	A	G	20	20	40	0	0	40	0	0
1	20866886	.	C	T	15	9	24	0	3	27	0	0
1	20866996	.	T	G	24	32	56	0	2	58	0	0
1	20867057	.	A	T	20	36	56	0	2	58	0	0
1	20867092	.	C	T	28	22	50	0	4	54	0	0
1	20867185	.	A	T	10	18	28	0	0	29	1	0
1	20867186	.	G	T	8	17	25	0	4	29	0	0
1	20867321	.	C	T	2	14	16	0	23	39	0	0
1	20867345	.	C	T	22	12	34	0	3	37	0	0
1	20867359	.	C	T	26	10	36	0	2	38	0	0
1	20867623	.	T	C	37	27	64	0	3	67	0	0
1	20867968	.	T	G	43	16	59	0	3	62	0	0
1	20868165	.	C	G	30	24	54	0	2	56	0	0
1	20868242	.	T	A	20	27	47	0	2	49	0	0
1	20868258	.	T	A	25	19	44	0	2	46	0	0
1	20868301	.	A	G	25	21	46	0	2	48	0	0
1	20868309	.	C	G	19	24	43	0	5	48	0	0
1	20868338	.	G	T	28	20	48	0	1	49	0	0
1	20868504	.	T	C	24	25	49	0	0	49	0	0
1	20868530	.	C	T	25	21	46	0	2	48	0	0
1	20868546	.	G	A	22	19	41	0	3	44	0	0
1	20868684	.	A	T	25	26	51	1	2	54	0	0
1	20868802	.	T	G	1	16	17	1	0	18	0	0
1	20868825	.	G	A	5	23	28	0	3	31	0	0
1	20868850	.	G	A	16	24	40	0	2	42	0	0
1	20868927	.	A	G	17	22	39	0	3	42	0	0
1	20868953	.	C	T	0	18	18	0	22	40	0	0
1	20869064	.	T	A	2	2	4	0	0	4	0	0
1	20870387	.	T	C	8	8	16	0	0	16	0	0
1	20870540	.	C	T	4	4	8	1	0	9	0	0
1	20870571	.	A	G	3	3	6	1	1	8	0	0
1	20870632	.	T	C	10	11	21	2	0	23	0	0
1	20870846	.	C	T	4	21	25	2	0	27	0	0
1	20871144	.	C	G	13	7	20	0	0	20	0	0
1	20886924	.	G	A	0	5	5	0	0	5	0	0
1	20886936	.	G	A	1	6	7	0	0	7	0	0
1	20910967	.	A	G	1	4	5	0	1	6	0	0
1	20911171	.	G	T	2	2	4	0	1	5	0	0
1	20916898	.	G	A	4	2	6	0	1	7	0	0
1	20916928	.	T	A	5	5	10	0	1	11	0	0
1	21138623	.	T	C	4	4	8	0	0	8	0	0
1	21139142	.	G	A	2	3	5	0	1	6	0	0
1	21139355	.	G	A	2	2	4	0	0	4	0	0
1	21139367	.	G	A	2	2	4	0	0	4	0	0
1	21139456	.	G	C	2	1	3	0	0	3	0	0
1	21141701	.	A	G	4	4	8	0	0	8	0	0
1	21141894	.	C	T	0	3	3	0	4	7	0	0
1	21141930	.	T	G	3	4	7	0	0	7	0	0
1	21141999	.	G	A	2	3	5	0	0	5	0	0
1	21309461	.	A	T	2	3	5	0	0	5	0	0
1	21312067	.	A	G	1	1	2	0	0	2	0	0
1	21312112	.	C	T	11	6	17	0	0	17	0	0
1	21313828	.	T	A	2	5	7	0	0	7	0	0
1	21313914	.	T	A	1	2	3	0	0	3	0	0
1	21333205	.	C	G	0	16	16	0	12	28	0	0
1	21333223	.	A	T	12	10	22	0	2	24	0	0
1	21333337	.	G	C	9	12	21	0	1	22	0	0
1	21344500	.	G	A	5	8	13	0	0	13	0	0
1	21344518	.	C	G	1	7	8	0	3	11	0	0
1	21346015	.	T	C	2	2	4	0	0	4	0	0
1	21368014	.	C	A	1	3	4	0	1	5	0	0
1	21423093	.	A	T	4	3	7	0	0	7	0	0
1	21423307	.	C	T	6	8	14	0	0	14	0	0
1	21423756	.	A	G	2	4	6	0	1	7	0	0
1	21423765	.	C	A	2	2	4	0	1	5	0	0
1	21500209	.	T	A	2	5	7	0	0	7	0	0
1	21500451	.	G	T	2	2	4	0	0	4	0	0
1	21516249	.	C	G	1	1	2	0	0	2	0	0
1	21576958	.	A	G	2	3	5	0	0	5	0	0
1	21579197	.	T	C	2	1	3	0	0	3	0	0
1	21610564	.	T	C	7	2	9	0	1	10	0	0
1	21611043	.	T	C	5	1	6	0	1	7	0	0
1	21612153	.	T	G	1	4	5	0	0	5	0	0
1	22236891	.	A	T	6	2	8	0	0	8	0	0
1	22236990	.	G	A	1	2	3	0	0	3	0	0
1	22389122	.	C	T	8	5	13	0	0	13	0	0
1	22389246	.	C	T	0	7	7	0	6	13	0	0
1	22389264	.	T	A	6	10	16	0	0	16	0	0
1	22389395	.	T	C	0	1	1	0	0	1	0	0
1	22542770	.	C	A	1	3	4	0	0	4	0	0
1	22542771	.	T	C	1	0	1	0	3	4	0	0
1	22543834	.	A	C	2	2	4	0	0	4	0	0
1	22647772	.	T	C	2	6	8	0	3	11	0	0
1	22648037	.	T	A	30	24	54	1	1	56	0	0
1	22648038	.	A	C	27	25	52	1	3	56	0	0
1	22651934	.	T	A	1	2	3	0	0	3	0	0
1	22770608	.	A	T	20	12	32	0	0	32	0	0
1	22770723	.	C	T	18	7	25	0	0	25	0	0
1	22770810	.	C	T	5	6	11	0	3	14	0	0
1	22771305	.	T	G	5	8	13	0	0	13	0	0
1	22771437	.	G	A	8	7	15	0	0	15	0	0
1	22771677	.	C	T	0	2	2	0	0	2	0	0
1	22771911	.	A	T	4	3	7	0	0	7	0	0
1	22771936	.	C	T	3	3	6	0	0	6	0	0
1	22772308	.	C	T	4	4	8	0	0	8	0	0
1	22772545	.	A	T	5	6	11	0	1	12	0	0
1	22772711	.	G	A	1	3	4	0	0	4	0	0
1	22805615	.	C	T	12	12	24	0	2	26	0	0
1	22805630	.	G	C	9	10	19	0	4	23	0	0
1	22805906	.	A	C	2	6	8	0	1	9	0	0
1	22805927	.	C	A	3	7	10	0	1	11	0	0
1	22806089	.	C	T	14	4	18	0	1	19	0	0
1	22806108	.	A	G	5	16	21	0	2	23	0	0
1	22806643	.	C	A	11	19	30	0	2	32	0	0
1	22806825	.	C	T	0	5	5	0	3	8	0	0
1	22806845	.	C	A	2	2	4	0	0	4	0	0
1	22806936	.	C	T	0	1	1	0	2	3	0	0
1	22807169	.	A	G	2	5	7	0	0	7	0	0
1	22807238	.	G	A	3	2	5	0	0	5	0	0
1	22807275	.	C	G	1	3	4	0	0	4	0	0
1	22807304	.	C	G	4	5	9	0	0	9	0	0
1	22807321	.	G	A	7	5	12	0	0	12	0	0
1	22807433	.	G	T	4	5	9	0	1	10	0	0
1	22807632	.	C	T	3	2	5	0	0	5	0	0
1	22807639	.	G	A	2	2	4	0	1	5	0	0
1	22807744	.	G	T	4	3	7	0	0	7	0	0
1	22808009	.	G	T	1	2	3	0	0	3	0	0
1	22808090	.	C	A	1	2	3	0	0	3	0	0
1	22808149	.	T	A	1	2	3	0	0	3	0	0
1	22808264	.	T	G	1	3	4	0	0	4	0	0
1	22808444	.	G	A	1	3	4	0	0	4	0	0
1	22814910	.	A	G	3	1	4	0	0	4	0	0
1	22845919	.	A	G	0	1	1	0	0	1	0	0
1	22856087	.	C	T	3	2	5	0	0	5	0	0
1	22857979	.	C	T	16	8	24	0	0	24	0	0
1	22857995	.	A	G	9	12	21	0	4	25	0	0
1	22858194	.	G	A	19	20	39	0	1	40	0	0
1	22858275	.	T	C	19	20	39	0	3	42	0	0
1	22858397	.	G	A	22	20	42	0	3	45	0	0
1	22858478	.	G	A	13	18	31	0	0	31	0	0
1	22861267	.	G	A	2	0	2	0	0	2	0	0
1	22864011	.	C	T	1	0	1	0	0	1	0	0
1	22943748	.	G	A	11	21	32	0	2	34	0	0
1	22944056	.	C	T	0	26	26	0	20	46	0	0
1	22944068	.	C	T	29	18	47	0	3	50	0	0
1	22944386	.	A	C	17	25	42	0	4	46	0	0
1	22945054	.	T	C	14	9	23	0	0	23	0	0
1	22945173	.	T	G	7	12	19	0	0	19	0	0
1	22945190	.	G	T	7	11	18	0	0	18	0	0
1	22945444	.	G	A	11	11	22	0	1	23	0	0
1	22945519	.	C	T	5	5	10	0	1	11	0	0
1	22945903	.	T	C	3	3	6	0	1	7	0	0
1	22946108	.	C	T	2	4	6	0	0	6	0	0
1	23072461	.	G	A	1	2	3	0	0	3	0	0
1	23072533	.	G	A	1	2	3	0	0	3	0	0
1	23094638	.	C	T	0	1	1	0	0	1	0	0
1	23243230	.	A	G	3	3	6	0	1	7	0	0
1	23243733	.	C	T	1	2	3	0	0	3	0	0
1	23271345	.	G	A	8	3	11	0	0	11	0	0
1	23271500	.	G	A	6	9	15	0	2	17	0	0
1	23271608	.	G	A	1	1	2	0	0	2	0	0
1	23271770	.	T	G	7	9	16	0	1	17	0	0
1	23274820	.	G	A	0	1	1	0	0	1	0	0
1	23284094	.	T	A	1	2	3	0	0	3	0	0
1	23297750	.	A	G	3	5	8	0	1	9	0	0
1	23298642	.	A	T	2	2	4	0	0	4	0	0
1	23323181	.	G	C	2	2	4	0	0	4	0	0
1	23506660	.	C	A	14	12	26	0	1	27	0	0
1	23506711	.	A	T	10	11	21	1	4	26	0	0
1	23506787	.	A	T	25	17	42	0	3	45	0	0
1	23506865	.	C	A	20	20	40	0	4	44	0	0
1	23508009	.	G	T	19	17	36	0	4	40	0	0
1	23526644	.	T	C	4	2	6	0	0	6	0	0
1	23530438	.	C	T	2	5	7	0	1	8	0	0
1	23535880	.	C	T	0	6	6	0	5	11	0	0
1	23536012	.	T	C	1	5	6	0	0	6	0	0
1	23536222	.	T	A	1	4	5	0	0	5	0	0
1	23573460	.	T	C	0	2	2	0	2	4	0	0
1	23573582	.	C	T	10	5	15	0	2	17	0	0
1	23573823	.	A	T	4	8	12	0	0	12	0	0
1	23586025	.	C	T	0	2	2	0	1	3	0	0
1	23909090	.	A	G	4	11	15	0	3	18	0	0
1	23909522	.	A	C	3	7	10	0	0	10	0	0
1	23909748	.	A	T	3	2	5	0	0	5	0	0
1	23920983	.	C	T	0	16	16	0	9	25	0	0
1	23921071	.	A	T	11	10	21	0	2	23	0	0
1	23921284	.	T	C	5	6	11	0	0	11	0	0
1	23921302	.	C	A	6	6	12	0	0	12	0	0
1	23921564	.	T	A	4	3	7	0	0	7	0	0
1	23921793	.	A	C	1	4	5	0	0	5	0	0
1	23943726	.	G	A	2	2	4	0	0	4	0	0
1	24076890	.	A	G	1	2	3	0	1	4	0	0
1	24077791	.	G	A	0	25	25	0	9	34	0	0
1	24077902	.	A	G	6	6	12	0	0	12	0	0
1	24357931	.	C	T	8	10	18	0	1	19	0	0
1	24520679	.	T	C	4	3	7	0	0	7	0	0
1	24557510	.	G	A	2	2	4	0	1	5	0	0
1	24558336	.	C	G	3	3	6	0	0	6	0	0
1	24558410	.	T	A	2	7	9	0	0	9	0	0
1	25305290	.	A	T	5	2	7	0	0	7	0	0
1	25310899	.	C	A	3	3	6	0	0	6	0	0
1	25310912	.	T	A	2	3	5	0	0	5	0	0
1	25313056	.	C	T	3	6	9	0	0	9	0	0
1	25313261	.	T	C	0	1	1	0	0	1	0	0
1	25313300	.	G	A	0	1	1	0	0	1	0	0
1	25399634	.	G	A	2	2	4	0	0	4	0	0
1	25741901	.	A	G	4	2	6	0	0	6	0	0
1	25798792	.	T	A	4	2	6	0	1	7	0	0
1	25798863	.	G	C	8	14	22	0	0	22	0	0
1	25798983	.	A	C	4	7	11	0	0	11	0	0
1	25863511	.	G	A	1	2	3	0	0	3	0	0
1	26046323	.	A	G	3	6	9	0	0	9	0	0
1	26046950	.	T	A	3	11	14	0	2	16	0	0
1	26046996	.	A	T	6	8	14	0	0	14	0	0
1	26096270	.	C	T	6	3	9	0	0	9	0	0
1	26096522	.	G	T	5	10	15	0	0	15	0	0
1	26109464	.	T	C	3	2	5	0	1	6	0	0
1	26109479	.	T	C	3	2	5	0	0	5	0	0
1	26127339	.	A	G	4	8	12	0	0	12	0	0
1	26127856	.	A	T	12	8	20	0	0	20	0	0
1	26251906	.	T	G	4	4	8	0	0	8	0	0
1	26252033	.	C	T	0	6	6	0	3	9	0	0
1	26383466	.	G	A	2	4	6	0	1	7	0	0
1	26384629	.	C	T	1	2	3	0	0	3	0	0
1	26385222	.	C	G	2	3	5	0	1	6	0	0
1	26385939	.	A	G	4	6	10	0	0	10	0	0
1	26391649	.	C	T	0	6	6	0	3	9	0	0
1	26391698	.	A	G	9	4	13	0	0	13	0	0
1	26463467	.	A	T	1	3	4	0	0	4	0	0
1	26463671	.	T	A	2	2	4	0	0	4	0	0
1	26463692	.	C	T	3	2	5	0	0	5	0	0
1	26463779	.	T	A	1	3	4	0	0	4	0	0
1	26464353	.	A	G	5	7	12	0	0	12	0	0
1	26464758	.	T	A	12	8	20	0	1	21	0	0
1	26465041	.	G	T	10	13	23	0	1	24	0	0
1	26465047	.	A	C	13	7	20	0	2	22	0	0
1	26465224	.	T	A	13	11	24	0	1	25	0	0
1	26498400	.	C	T	4	3	7	0	0	7	0	0
1	26498657	.	G	A	0	2	2	0	8	10	0	0
1	26504998	.	G	A	4	3	7	0	0	7	0	0
1	26505282	.	T	C	6	14	20	0	0	20	0	0
1	26505291	.	C	T	6	13	19	0	3	22	0	0
1	26507356	.	G	A	6	10	16	0	1	17	0	0
1	26507392	.	T	A	2	3	5	0	0	5	0	0
1	26507582	.	G	A	6	9	15	0	1	16	0	0
1	26827238	.	A	G	3	4	7	0	0	7	0	0
1	26827449	.	T	C	1	2	3	0	0	3	0	0
1	26827519	.	G	A	7	4	11	0	3	14	0	0
1	27209904	.	T	G	2	3	5	0	0	5	0	0
1	27210057	.	T	C	3	2	5	0	0	5	0	0
1	27210073	.	T	C	3	3	6	0	0	6	0	0
1	27210231	.	C	T	2	4	6	0	1	7	0	0
1	27210929	.	C	T	10	5	15	0	2	17	0	0
1	27809162	.	T	C	2	3	5	0	0	5	0	0
1	27826651	.	T	C	5	9	14	0	0	14	0	0
1	27842373	.	G	A	0	1	1	0	2	3	0	0
1	27860743	.	T	A	8	6	14	0	0	14	0	0
1	27893097	.	T	C	0	1	1	0	0	1	0	0
1	27893920	.	A	T	3	2	5	0	0	5	0	0
1	28018821	.	C	T	14	8	22	0	3	25	0	0
1	28018988	.	T	A	9	5	14	0	0	14	0	0
1	28035590	.	T	C	0	2	2	0	0	2	0	0
1	28035786	.	C	T	2	2	4	0	0	4	0	0
1	28036159	.	A	C	4	2	6	0	0	6	0	0
1	28046218	.	T	C	13	15	28	0	0	28	0	0
1	28046224	.	A	G	13	1	14	0	14	28	0	0
1	28046717	.	T	A	1	4	5	0	0	5	0	0
1	28391882	.	C	G	3	2	5	0	0	5	0	0
1	28834209	.	A	T	1	2	3	0	0	3	0	0
1	28835669	.	T	C	7	12	19	0	1	20	0	0
1	28847677	.	C	T	0	2	2	0	3	5	0	0
1	28899350	.	G	A	1	7	8	0	0	8	0	0
1	28899483	.	G	A	5	3	8	0	0	8	0	0
1	28899530	.	T	C	3	5	8	0	0	8	0	0
1	28961924	.	C	T	0	0	0	1	0	1	0	0
1	29201933	.	G	C	5	5	10	0	3	13	0	0
1	29202110	.	T	C	1	4	5	0	0	5	0	0
1	29202368	.	G	A	0	2	2	0	0	2	0	0
1	29202379	.	A	G	1	0	1	0	4	5	0	0
1	29227642	.	T	A	2	2	4	0	0	4	0	0
1	29752319	.	T	C	2	5	7	0	0	7	0	0
1	29754673	.	A	G	3	3	6	0	0	6	0	0
1	29754963	.	G	A	3	2	5	0	0	5	0	0
1	29754981	.	A	G	3	2	5	0	0	5	0	0
1	29779300	.	G	C	4	6	10	0	1	11	0	0
1	29781462	.	G	A	0	2	2	0	0	2	0	0
1	29781597	.	A	T	2	1	3	0	1	4	0	0
1	29786570	.	G	A	6	3	9	0	1	10	0	0
1	29787397	.	G	A	3	4	7	0	0	7	0	0
1	29789889	.	C	T	6	8	14	0	0	14	0	0
1	29790030	.	A	T	6	3	9	0	0	9	0	0
1	29795692	.	G	A	11	6	17	0	1	18	0	0
1	29797191	.	T	C	2	1	3	0	1	4	0	0
1	29797344	.	G	T	10	10	20	0	0	20	0	0
1	29797345	.	A	T	11	10	21	0	0	21	0	0
1	29797387	.	A	C	12	11	23	0	2	25	0	0
1	29797699	.	T	G	9	6	15	0	1	16	0	0
1	29820831	.	C	T	12	6	18	0	2	20	0	0
1	29823603	.	T	C	10	11	21	0	0	21	0	0
1	29823690	.	T	A	18	16	34	0	3	37	0	0
1	29823701	.	A	G	15	14	29	0	6	36	1	0
1	29860326	.	T	A	6	3	9	0	0	9	0	0
1	29860506	.	A	G	1	2	3	0	0	3	0	0
1	29916178	.	G	A	2	1	3	0	0	3	0	0
1	29952918	.	A	T	7	4	11	0	0	11	0	0
1	29953069	.	G	A	5	6	11	0	0	11	0	0
1	29953239	.	G	T	1	8	9	0	13	22	0	0
1	29953433	.	A	T	4	6	10	0	0	10	0	0
1	29953616	.	A	T	7	6	13	0	0	13	0	0
1	29954795	.	A	C	6	5	11	0	0	11	0	0
1	29954844	.	T	C	6	3	9	0	1	10	0	0
1	29954972	.	C	T	8	9	17	0	0	17	0	0
1	29955006	.	G	A	7	7	14	0	2	16	0	0
1	29955171	.	G	A	7	8	15	0	0	15	0	0
1	29955179	.	A	G	8	6	14	0	0	14	0	0
1	29955228	.	C	T	2	5	7	0	0	7	0	0
1	29955249	.	A	G	1	0	1	0	0	1	0	0
1	30212461	.	G	A	2	0	2	0	0	2	0	0
1	30250557	.	T	C	3	1	4	0	0	4	0	0
1	30255365	.	G	A	1	7	8	0	0	8	0	0
1	30255458	.	A	C	4	2	6	0	1	7	0	0
1	30282841	.	G	T	1	1	2	0	0	2	0	0
1	30343967	.	T	G	10	8	18	0	2	20	0	0
1	30344842	.	A	G	3	5	8	0	0	8	0	0
1	30345026	.	T	C	2	6	8	0	0	8	0	0
1	30345029	.	C	T	2	6	8	0	0	8	0	0
1	30345075	.	G	T	5	6	11	0	0	11	0	0
1	30345131	.	C	T	0	5	5	0	4	9	0	0
1	30345838	.	C	T	4	0	4	0	1	5	0	0
1	30345839	.	C	T	5	0	5	0	0	5	0	0
1	30346042	.	G	A	4	3	7	0	0	7	0	0
1	30346845	.	G	T	2	2	4	0	0	5	1	0
1	30346906	.	C	A	4	2	6	0	0	6	0	0
1	30440286	.	T	A	0	2	2	0	1	3	0	0
1	30589258	.	C	A	0	1	1	0	0	1	0	0
1	30589308	.	A	G	2	0	2	0	0	2	0	0
1	30688901	.	G	A	2	2	4	0	1	5	0	0
1	30718538	.	C	G	11	3	14	0	3	17	0	0
1	30718567	.	A	C	8	0	8	0	3	11	0	0
1	30736716	.	G	T	1	2	3	0	0	3	0	0
1	30736725	.	C	G	1	2	3	0	1	4	0	0
1	31072348	.	A	C	2	5	7	0	1	8	0	0
1	31072604	.	A	C	1	2	3	0	0	3	0	0
1	31072843	.	C	T	3	2	5	0	0	5	0	0
1	31072863	.	A	G	1	2	3	0	0	3	0	0
1	31117686	.	G	A	5	3	8	0	1	9	0	0
1	31119296	.	C	T	7	5	12	0	1	13	0	0
1	31122596	.	G	A	15	16	31	0	3	34	0	0
1	31130005	.	T	C	32	13	45	0	1	46	0	0
1	31130028	.	T	C	29	14	43	0	2	45	0	0
1	31130094	.	G	A	0	14	14	0	26	40	0	0
1	31130176	.	T	C	5	9	14	0	1	15	0	0
1	31136018	.	G	A	2	4	6	0	0	6	0	0
1	31374780	.	A	T	8	6	14	0	1	15	0	0
1	31667491	.	C	T	2	3	5	0	1	6	0	0
1	31671721	.	C	T	2	4	6	0	0	6	0	0
1	31671746	.	C	A	4	2	6	0	0	6	0	0
1	31672078	.	G	A	1	3	4	0	0	4	0	0
1	31797386	.	A	G	1	0	1	0	0	1	0	0
1	31798974	.	G	C	5	5	10	0	2	12	0	0
1	31798980	.	C	T	4	5	9	0	2	11	0	0
1	31799112	.	C	A	1	6	7	0	0	7	0	0
1	31799185	.	T	A	1	3	4	1	1	6	0	0
1	31809496	.	G	A	2	3	5	0	0	5	0	0
1	31867264	.	T	A	6	4	10	0	0	10	0	0
1	31867314	.	C	T	2	3	5	0	0	5	0	0
1	31867449	.	C	T	3	4	7	0	0	7	0	0
1	32385352	.	C	T	1	8	9	0	0	9	0	0
1	33384062	.	G	A	1	0	1	0	1	2	0	0
1	33457733	.	C	T	1	2	3	0	0	3	0	0
1	33484129	.	C	G	1	7	8	0	0	8	0	0
1	33484288	.	T	C	3	5	8	0	2	10	0	0
1	33484293	.	C	A	3	5	8	0	0	8	0	0
1	33484354	.	G	A	4	3	7	0	1	8	0	0
1	33484404	.	C	T	5	2	7	0	0	7	0	0
1	33484652	.	T	C	9	6	15	0	1	16	0	0
1	33485692	.	A	G	10	0	10	0	24	34	0	0
1	33548282	.	A	T	0	9	9	0	3	12	0	0
1	33561544	.	C	T	3	6	9	0	0	9	0	0
1	33568153	.	A	T	7	9	16	0	1	17	0	0
1	33568211	.	A	G	2	0	2	0	8	10	0	0
1	33568260	.	A	C	5	5	10	0	0	10	0	0
1	33568266	.	G	A	5	4	9	0	0	9	0	0
1	33568303	.	G	A	0	5	5	0	2	7	0	0
1	33568454	.	G	T	5	5	10	0	0	10	0	0
1	33568520	.	G	A	7	7	14	0	1	15	0	0
1	33568836	.	T	G	0	15	15	0	2	17	0	0
1	33568976	.	G	T	1	19	20	0	16	36	0	0
1	33657793	.	A	G	1	2	3	0	1	4	0	0
1	33658945	.	C	T	5	3	8	0	0	8	0	0
1	33658971	.	C	T	4	4	8	0	0	8	0	0
1	33659374	.	C	T	0	1	1	0	0	1	0	0
1	33687177	.	A	T	2	3	5	0	2	7	0	0
1	33693919	.	C	A	4	3	7	0	0	7	0	0
1	33694198	.	T	A	2	5	7	0	0	7	0	0
1	33694327	.	C	T	9	8	17	0	0	17	0	0
1	33694357	.	T	A	4	15	19	0	0	19	0	0
1	33694517	.	T	A	2	9	11	0	0	11	0	0
1	34199906	.	G	T	21	19	40	0	2	42	0	0
1	34199913	.	C	T	19	23	42	0	4	46	0	0
1	34232407	.	A	G	1	5	6	0	0	6	0	0
1	34232551	.	A	C	3	3	6	0	0	6	0	0
1	34232744	.	T	A	9	8	17	0	1	18	0	0
1	34232761	.	A	G	9	7	16	0	0	16	0	0
1	34232879	.	T	C	6	8	14	0	0	14	0	0
1	34232929	.	C	T	11	5	16	0	0	16	0	0
1	34232931	.	G	A	10	5	15	0	1	16	0	0
1	34233096	.	C	A	15	14	29	0	0	29	0	0
1	34233145	.	G	T	7	6	13	0	0	13	0	0
1	34233198	.	C	A	5	2	7	0	1	8	0	0
1	34233238	.	A	G	4	4	8	0	0	8	0	0
1	34261230	.	A	T	9	7	16	0	1	17	0	0
1	34261393	.	G	A	0	15	15	0	7	22	0	0
1	34261654	.	T	C	5	7	12	0	1	13	0	0
1	34296321	.	T	C	1	8	9	0	0	9	0	0
1	34296606	.	A	T	6	3	9	0	0	9	0	0
1	34297112	.	C	A	3	3	6	0	1	7	0	0
1	34297135	.	C	T	4	7	11	0	0	11	0	0
1	34297336	.	T	A	1	2	3	0	2	5	0	0
1	34555559	.	C	T	4	3	7	0	0	7	0	0
1	34556148	.	T	A	6	5	11	0	0	11	0	0
1	34556241	.	A	C	7	5	12	0	1	13	0	0
1	34556298	.	G	A	0	4	4	0	1	5	0	0
1	34556301	.	G	T	0	4	4	0	1	5	0	0
1	34617680	.	C	A	1	3	4	0	0	4	0	0
1	34679431	.	A	G	1	1	2	0	0	2	0	0
1	34693831	.	C	T	5	6	11	0	1	12	0	0
1	34695423	.	G	A	3	6	9	0	1	10	0	0
1	34695476	.	G	A	4	6	10	0	2	12	0	0
1	34703048	.	T	A	5	3	8	0	0	8	0	0
1	34703272	.	A	G	4	4	8	0	1	9	0	0
1	34706526	.	G	A	13	6	19	0	2	21	0	0
1	34706773	.	A	G	3	4	7	0	2	9	0	0
1	34706782	.	C	T	0	4	4	0	0	4	0	0
1	34707958	.	T	C	14	10	24	0	6	30	0	0
1	34708145	.	C	T	2	21	23	0	27	50	0	0
1	34712097	.	A	G	0	2	2	0	2	4	0	0
1	35232834	.	C	A	1	2	3	0	0	3	0	0
1	35485056	.	G	A	4	3	7	0	0	7	0	0
1	35485105	.	G	A	0	5	5	0	3	8	0	0
1	35485263	.	C	A	2	2	4	0	0	4	0	0
1	35485289	.	C	T	2	2	4	0	0	4	0	0
1	35485378	.	C	T	8	4	12	0	0	12	0	0
1	35488211	.	A	T	7	3	10	0	0	10	0	0
1	35488332	.	G	A	3	3	6	0	2	8	0	0
1	35608308	.	C	T	1	2	3	0	0	3	0	0
1	35609192	.	A	G	3	4	7	0	0	7	0	0
1	35609431	.	T	C	4	5	9	0	0	9	0	0
1	35609474	.	G	A	4	5	9	0	0	9	0	0
1	35834307	.	T	A	2	4	6	0	0	6	0	0
1	35834554	.	G	T	6	3	9	0	2	11	0	0
1	35835237	.	G	A	0	11	11	0	6	17	0	0
1	35835371	.	A	C	11	12	23	0	3	26	0	0
1	35835502	.	C	T	8	12	20	0	3	23	0	0
1	35959826	.	T	C	0	1	1	0	1	2	0	0
1	35963306	.	G	A	0	2	2	0	1	3	0	0
1	35963822	.	C	T	5	3	8	0	0	8	0	0
1	35969716	.	G	A	4	2	6	0	1	7	0	0
1	35969836	.	G	C	14	11	25	0	0	25	0	0
1	35969878	.	C	T	13	10	23	0	2	25	0	0
1	36017970	.	C	A	3	0	3	0	0	3	0	0
1	36018610	.	T	A	12	4	16	0	0	16	0	0
1	36019227	.	C	T	5	3	8	0	0	8	0	0
1	36019361	.	T	C	8	0	8	0	11	19	0	0
1	36019416	.	G	T	18	9	27	0	0	27	0	0
1	36020492	.	T	G	1	2	3	0	0	3	0	0
1	36020642	.	T	A	4	2	6	0	0	6	0	0
1	36021110	.	G	A	2	1	3	0	1	4	0	0
1	36021399	.	A	G	1	3	4	0	0	4	0	0
1	36194799	.	G	T	0	0	0	0	1	1	0	0
1	36200014	.	C	T	1	0	1	0	0	1	0	0
1	36438671	.	T	A	4	12	16	0	1	17	0	0
1	36438882	.	T	A	17	10	27	0	3	30	0	0
1	36439186	.	T	A	14	9	23	0	3	26	0	0
1	36439204	.	G	T	9	13	22	0	1	23	0	0
1	36439248	.	G	A	9	7	16	0	2	18	0	0
1	36439380	.	G	T	15	13	28	0	2	30	0	0
1	36701999	.	C	T	9	6	15	0	0	15	0	0
1	36740252	.	A	G	1	2	3	0	0	3	0	0
1	36740253	.	A	G	1	2	3	0	0	3	0	0
1	36740882	.	G	A	0	2	2	0	1	3	0	0
1	36740896	.	G	A	2	3	5	0	0	5	0	0
1	36740930	.	A	G	0	5	5	0	1	6	0	0
1	36741087	.	T	A	4	5	9	0	0	9	0	0
1	36741110	.	G	T	3	6	9	0	0	9	0	0
1	36741319	.	A	G	2	2	4	0	1	5	0	0
1	36741396	.	T	G	2	3	5	0	1	6	0	0
1	36741422	.	A	C	2	2	4	0	0	4	0	0
1	36741581	.	C	T	4	5	9	0	0	9	0	0
1	36741602	.	A	C	3	4	7	0	2	9	0	0
1	36741761	.	A	T	6	4	10	0	0	10	0	0
1	36741796	.	T	G	8	5	13	0	0	13	0	0
1	36741863	.	A	C	8	4	12	0	0	12	0	0
1	36746225	.	A	T	6	5	11	0	0	11	0	0
1	36749872	.	T	C	0	2	2	0	0	2	0	0
1	36911491	.	A	C	4	1	5	0	0	5	0	0
1	36911647	.	A	T	1	6	7	0	0	7	0	0
1	36911788	.	G	A	0	4	4	0	4	8	0	0
1	36911932	.	C	G	5	2	7	0	0	7	0	0
1	36912176	.	G	A	6	7	13	0	0	13	0	0
1	37304354	.	C	A	5	2	7	0	1	8	0	0
1	37304494	.	T	A	4	2	6	0	1	7	0	0
1	37304510	.	T	G	4	2	6	0	0	6	0	0
1	37304536	.	G	A	6	2	8	0	0	8	0	0
1	37304929	.	G	A	4	4	8	0	1	9	0	0
1	37305148	.	C	T	1	2	3	0	0	3	0	0
1	37305222	.	A	G	2	2	4	0	1	5	0	0
1	37306726	.	G	T	0	9	9	0	16	25	0	0
1	37306913	.	T	A	12	12	24	0	1	25	0	0
1	37306942	.	A	C	9	13	22	0	1	23	0	0
1	37359071	.	C	T	3	2	5	0	1	6	0	0
1	37359352	.	A	G	2	3	5	0	1	6	0	0
1	37361554	.	A	G	4	3	7	0	0	7	0	0
1	37361879	.	T	A	4	4	8	0	0	8	0	0
1	38125431	.	C	A	4	3	7	0	0	7	0	0
1	38125684	.	T	C	3	5	8	0	2	10	0	0
1	38131058	.	C	T	10	10	20	0	4	24	0	0
1	38131073	.	T	C	9	13	22	0	2	24	0	0
1	38131094	.	G	A	11	10	21	0	2	23	0	0
1	38131288	.	G	A	19	11	30	0	2	32	0	0
1	38131360	.	G	A	16	31	47	0	2	49	0	0
1	38131486	.	G	A	24	8	32	0	2	34	0	0
1	38131812	.	T	C	2	4	6	0	0	6	0	0
1	38131873	.	C	T	5	3	8	0	0	8	0	0
1	38163017	.	C	T	1	3	4	0	0	4	0	0
1	38163132	.	G	A	2	2	4	0	1	5	0	0
1	38166009	.	G	C	9	8	17	0	1	18	0	0
1	38166268	.	A	C	12	11	23	0	3	26	0	0
1	38166429	.	T	C	22	15	37	0	5	42	0	0
1	38166431	.	T	G	23	17	40	0	2	42	0	0
1	38166520	.	A	G	17	19	36	0	0	36	0	0
1	38166663	.	A	T	0	15	15	0	0	15	0	0
1	38169771	.	T	A	7	3	10	0	2	12	0	0
1	38169972	.	T	G	16	20	36	0	0	36	0	0
1	38170553	.	G	A	1	3	4	0	0	4	0	0
1	38346578	.	G	T	2	3	5	0	0	5	0	0
1	38346739	.	G	A	1	2	3	0	0	3	0	0
1	38374317	.	G	A	3	2	5	0	2	7	0	0
1	38416352	.	G	C	5	3	8	0	1	9	0	0
1	38416477	.	G	A	5	4	9	0	1	10	0	0
1	38416536	.	A	G	5	7	12	0	0	12	0	0
1	38417116	.	A	T	0	1	1	0	2	3	0	0
1	38417332	.	A	G	4	9	13	0	0	13	0	0
1	38417370	.	G	A	4	6	10	0	1	11	0	0
1	38417531	.	G	T	3	4	7	0	0	7	0	0
1	38417571	.	G	T	3	3	6	0	1	7	0	0
1	38417588	.	T	G	2	3	5	0	0	5	0	0
1	38418087	.	C	T	1	3	4	0	0	4	0	0
1	38649340	.	A	G	27	38	65	0	2	67	0	0
1	38649947	.	G	A	38	26	64	0	4	68	0	0
1	38650132	.	G	T	25	27	52	0	3	55	0	0
1	38650298	.	G	A	23	16	39	0	1	40	0	0
1	38650382	.	G	C	23	20	43	0	6	49	0	0
1	38650467	.	A	G	24	29	53	0	8	61	0	0
1	38650510	.	G	C	21	26	47	0	7	54	0	0
1	38650516	.	T	C	25	26	51	0	4	55	0	0
1	38650545	.	T	C	30	28	58	0	7	65	0	0
1	38651063	.	G	T	32	4	36	0	2	38	0	0
1	38651065	.	T	A	33	4	37	0	1	38	0	0
1	38651361	.	C	T	5	2	7	0	0	7	0	0
1	38651370	.	G	A	5	2	7	0	0	7	0	0
1	38657689	.	G	A	4	1	5	0	2	7	0	0
1	38791569	.	C	T	0	1	1	0	0	1	0	0
1	38797663	.	A	C	5	3	8	0	0	8	0	0
1	38799513	.	G	A	3	0	3	0	0	3	0	0
1	38799585	.	A	G	1	1	2	0	0	2	0	0
1	38799588	.	T	A	1	1	2	0	0	2	0	0
1	38802537	.	G	A	7	7	14	0	0	14	0	0
1	38802703	.	A	G	8	14	22	0	1	23	0	0
1	38802718	.	G	A	15	9	24	0	1	25	0	0
1	38802855	.	C	A	4	10	14	0	0	14	0	0
1	38803033	.	T	C	4	4	8	0	0	8	0	0
1	38803042	.	A	C	3	3	6	0	0	6	0	0
1	38803092	.	C	T	2	5	7	0	0	7	0	0
1	38803127	.	C	T	5	9	14	0	0	14	0	0
1	38803154	.	T	A	6	5	11	0	2	13	0	0
1	38803205	.	A	T	6	3	9	0	0	9	0	0
1	38803404	.	A	G	12	5	17	0	1	18	0	0
1	38805128	.	G	T	5	3	8	0	1	9	0	0
1	38805135	.	C	T	6	3	9	0	0	9	0	0
1	38805439	.	G	A	10	14	24	0	2	26	0	0
1	38805450	.	A	G	11	16	27	0	0	27	0	0
1	38805506	.	G	A	15	11	26	0	1	27	0	0
1	38807255	.	G	C	1	3	4	0	0	4	0	0
1	38808379	.	C	T	0	1	1	0	1	2	0	0
1	38820219	.	G	A	0	7	7	0	3	10	0	0
1	38822092	.	A	T	5	8	13	0	1	14	0	0
1	38851111	.	C	T	0	2	2	0	6	8	0	0
1	38851225	.	C	T	2	0	2	0	0	2	0	0
1	39774225	.	C	T	2	2	4	0	0	4	0	0
1	39774618	.	A	G	2	2	4	0	0	4	0	0
1	39774690	.	A	G	2	2	4	0	0	4	0	0
1	39774727	.	C	A	1	1	2	0	1	3	0	0
1	39774891	.	C	T	7	6	13	0	0	13	0	0
1	39774915	.	G	A	3	7	10	0	0	10	0	0
1	39775089	.	C	T	3	3	6	0	0	6	0	0
1	39775227	.	C	T	5	4	9	0	0	9	0	0
1	39776356	.	A	C	3	9	12	0	3	15	0	0
1	39777089	.	G	A	9	9	18	0	2	20	0	0
1	39777836	.	G	A	0	7	7	0	5	12	0	0
1	39777975	.	A	T	5	6	11	0	0	11	0	0
1	39778047	.	A	G	8	1	9	0	7	16	0	0
1	39778075	.	T	G	8	8	16	0	0	16	0	0
1	39778332	.	G	C	25	18	43	0	1	44	0	0
1	39778452	.	G	A	9	4	13	0	0	13	0	0
1	39778661	.	G	A	9	8	17	0	2	19	0	0
1	39778663	.	G	A	9	10	19	0	0	19	0	0
1	39778949	.	G	C	12	19	31	0	0	31	0	0
1	39779225	.	G	C	9	7	16	0	1	17	0	0
1	39779468	.	A	T	3	5	8	0	1	9	0	0
1	39869917	.	T	A	2	2	4	0	0	4	0	0
1	39869974	.	G	A	3	1	4	0	0	4	0	0
1	39870008	.	T	C	3	2	5	0	0	5	0	0
1	39882065	.	A	G	1	1	2	0	1	3	0	0
1	39882272	.	A	G	1	2	3	0	0	3	0	0
1	39882764	.	A	T	4	6	10	0	0	10	0	0
1	39882899	.	A	G	5	5	10	0	0	10	0	0
1	39882906	.	T	A	3	6	9	0	0	9	0	0
1	39899477	.	G	C	16	19	35	0	1	36	0	0
1	39899494	.	A	G	20	14	34	0	1	35	0	0
1	39899663	.	G	A	21	17	38	0	4	42	0	0
1	39900056	.	G	A	14	23	37	0	2	39	0	0
1	39900129	.	G	A	14	16	30	0	2	32	0	0
1	39900137	.	G	T	15	14	29	0	1	30	0	0
1	39900360	.	G	A	5	8	13	0	0	13	0	0
1	39900432	.	C	T	0	9	9	0	4	13	0	0
1	39900750	.	C	T	0	5	5	0	10	15	0	0
1	39901378	.	T	A	1	5	6	0	0	6	0	0
1	39901729	.	T	C	10	0	10	0	10	20	0	0
1	39908047	.	G	A	1	2	3	0	0	3	0	0
1	39981794	.	A	G	5	5	10	0	0	10	0	0
1	40002113	.	G	A	3	2	5	0	0	5	0	0
1	40002148	.	C	G	1	2	3	0	0	3	0	0
1	40008905	.	T	C	20	6	26	0	1	27	0	0
1	40008906	.	G	A	19	6	25	0	2	27	0	0
1	40009227	.	T	A	9	13	22	0	1	23	0	0
1	40009258	.	C	T	12	6	18	0	2	20	0	0
1	40009291	.	A	G	10	9	19	0	0	19	0	0
1	40009382	.	G	A	20	12	32	0	0	32	0	0
1	40009526	.	T	C	8	7	15	0	0	15	0	0
1	40009625	.	T	C	14	6	20	0	1	21	0	0
1	40009671	.	C	A	8	7	15	0	2	17	0	0
1	40009697	.	C	T	8	6	14	0	1	15	0	0
1	40015189	.	A	G	1	3	4	0	0	4	0	0
1	40015219	.	C	T	2	3	5	0	0	5	0	0
1	40015697	.	A	G	2	4	6	0	0	6	0	0
1	40051918	.	T	C	4	2	6	0	0	6	0	0
1	40051923	.	G	C	4	3	7	0	0	7	0	0
1	40051988	.	G	C	0	6	6	0	3	9	0	0
1	40052033	.	A	G	4	7	11	0	0	11	0	0
1	40052066	.	G	C	7	3	10	0	1	11	0	0
1	40052083	.	G	A	5	3	8	0	0	8	0	0
1	40052481	.	A	C	6	11	17	0	1	18	0	0
1	40052550	.	A	C	3	8	11	0	0	11	0	0
1	40052562	.	A	G	2	4	6	0	1	7	0	0
1	40052965	.	T	A	2	7	9	0	0	9	0	0
1	40057655	.	C	T	1	2	3	0	0	3	0	0
1	40057805	.	C	T	2	2	4	0	0	4	0	0
1	40107874	.	T	G	1	2	3	0	0	3	0	0
1	40111679	.	C	G	2	8	10	0	1	11	0	0
1	40111702	.	T	G	5	9	14	0	0	14	0	0
1	40111737	.	A	C	5	7	12	0	0	12	0	0
1	40111738	.	G	A	4	7	11	0	1	12	0	0
1	40111776	.	C	T	1	2	3	0	3	6	0	0
1	40111918	.	C	T	12	5	17	0	0	17	0	0
1	40112206	.	T	C	5	4	9	0	5	14	0	0
1	40112347	.	C	T	4	5	9	0	0	9	0	0
1	40112760	.	T	A	8	8	16	0	0	16	0	0
1	40112784	.	A	G	13	6	19	0	0	19	0	0
1	40112822	.	A	T	7	8	15	0	0	15	0	0
1	40112837	.	C	T	11	5	16	0	0	16	0	0
1	40112869	.	C	T	4	12	16	0	1	17	0	0
1	40112879	.	A	G	4	11	15	0	0	15	0	0
1	40112938	.	G	C	6	3	9	0	1	10	0	0
1	40114527	.	T	A	2	2	4	0	0	4	0	0
1	40116747	.	G	A	12	8	20	0	2	22	0	0
1	40116823	.	C	T	0	6	6	0	6	12	0	0
1	40116915	.	T	G	2	2	4	0	1	5	0	0
1	40116946	.	C	T	0	4	4	0	4	8	0	0
1	40117345	.	G	A	10	5	15	0	1	16	0	0
1	40123964	.	C	T	0	1	1	0	1	2	0	0
1	40210865	.	G	T	5	5	10	0	1	11	0	0
1	40211048	.	C	T	0	4	4	0	1	5	0	0
1	40211065	.	T	C	1	3	4	0	1	5	0	0
1	40212065	.	C	T	1	4	5	0	0	5	0	0
1	40252219	.	T	A	2	0	2	0	0	2	0	0
1	40257631	.	C	T	8	4	12	0	0	12	0	0
1	40257751	.	C	T	5	5	10	0	1	11	0	0
1	40263675	.	C	A	2	4	6	0	0	6	0	0
1	40266618	.	C	T	3	3	6	0	0	6	0	0
1	40269998	.	T	G	2	2	4	0	0	4	0	0
1	40270028	.	G	T	2	3	5	0	0	5	0	0
1	40270054	.	C	T	4	1	5	0	0	5	0	0
1	40270094	.	G	A	0	2	2	0	0	2	0	0
1	40270095	.	G	A	0	2	2	0	0	2	0	0
1	40337464	.	C	A	0	3	3	0	4	7	0	0
1	40410839	.	A	T	1	2	3	0	0	3	0	0
1	40410908	.	C	T	1	2	3	0	0	3	0	0
1	40568601	.	G	A	6	6	12	0	0	12	0	0
1	40568883	.	G	A	0	11	11	0	6	17	0	0
1	40568990	.	A	G	13	11	24	0	1	25	0	0
1	40569231	.	G	A	4	5	9	0	0	9	0	0
1	40569295	.	A	T	10	4	14	0	0	14	0	0
1	40569386	.	T	A	11	9	20	0	1	21	0	0
1	40569466	.	A	T	20	15	35	0	0	35	0	0
1	40569538	.	G	A	16	10	26	0	0	26	0	0
1	40569548	.	T	C	13	10	23	0	1	24	0	0
1	40573703	.	G	T	8	5	13	0	0	13	0	0
1	40590967	.	T	G	4	2	6	0	0	6	0	0
1	40591262	.	T	C	11	16	27	0	1	28	0	0
1	40591272	.	T	C	12	14	26	0	0	26	0	0
1	40594373	.	C	T	1	1	2	0	0	2	0	0
1	40594415	.	C	T	0	8	8	0	3	11	0	0
1	40594517	.	T	C	6	0	6	0	8	14	0	0
1	40594526	.	G	A	5	7	12	0	1	13	0	0
1	40597332	.	A	C	2	0	2	0	6	8	0	0
1	40600992	.	A	T	1	2	3	0	0	3	0	0
1	40601547	.	G	A	3	3	6	0	0	6	0	0
1	40638246	.	A	T	2	5	7	0	0	7	0	0
1	40795489	.	A	G	1	2	3	0	0	3	0	0
1	40796791	.	G	A	1	1	2	0	0	2	0	0
1	40796942	.	C	T	2	5	7	0	0	7	0	0
1	40796977	.	C	T	4	2	6	0	0	6	0	0
1	40796985	.	A	T	4	2	6	0	0	6	0	0
1	40992716	.	T	A	5	4	9	0	1	10	0	0
1	40992823	.	A	G	5	7	12	0	0	12	0	0
1	40992878	.	C	G	3	2	5	0	0	5	0	0
1	41132230	.	G	A	0	1	1	0	0	1	0	0
1	41133944	.	G	A	3	2	5	0	0	5	0	0
1	41140465	.	T	C	2	2	4	0	0	4	0	0
1	41140640	.	C	T	5	12	17	0	0	17	0	0
1	41215289	.	T	A	7	9	16	0	1	17	0	0
1	41215312	.	T	G	10	9	19	0	1	20	0	0
1	41215547	.	G	A	9	7	16	0	0	16	0	0
1	41215746	.	T	A	8	3	11	0	1	12	0	0
1	41215998	.	T	C	2	2	4	0	0	4	0	0
1	41294719	.	A	G	7	8	15	0	1	16	0	0
1	41294760	.	T	C	5	8	13	0	1	14	0	0
1	41294790	.	G	T	4	6	10	0	1	11	0	0
1	41297495	.	G	A	2	1	3	0	0	3	0	0
1	41470524	.	T	C	17	16	33	0	5	38	0	0
1	41471529	.	T	C	21	26	47	0	5	52	0	0
1	41487811	.	C	T	1	2	3	0	0	3	0	0
1	41488643	.	A	C	0	0	0	0	1	1	0	0
1	41489068	.	C	T	2	2	4	0	0	4	0	0
1	41491990	.	G	T	2	2	4	0	2	6	0	0
1	41492026	.	A	G	2	2	4	0	1	5	0	0
1	41492367	.	A	T	3	2	5	0	1	6	0	0
1	41605011	.	T	C	1	3	4	0	0	4	0	0
1	41605203	.	C	T	2	2	4	0	0	4	0	0
1	41605675	.	G	A	8	2	10	0	0	10	0	0
1	41616186	.	A	C	2	2	4	0	0	4	0	0
1	41616867	.	T	A	1	3	4	0	0	4	0	0
1	41616902	.	A	T	3	2	5	0	0	5	0	0
1	41770847	.	T	A	4	2	6	0	0	6	0	0
1	41770872	.	T	C	2	2	4	0	0	4	0	0
1	41865471	.	C	T	0	2	2	0	1	3	0	0
1	42776652	.	T	C	18	15	33	0	1	34	0	0
1	42776787	.	C	T	2	15	17	0	11	28	0	0
1	42776806	.	A	T	11	18	29	0	1	30	0	0
1	42776853	.	T	C	16	16	32	0	0	32	0	0
1	42776906	.	A	G	15	12	27	0	2	29	0	0
1	42777116	.	G	A	12	12	24	0	1	25	0	0
1	42777146	.	C	G	0	10	10	0	6	16	0	0
1	42777383	.	A	G	4	8	12	0	0	12	0	0
1	42777593	.	T	G	3	6	9	0	2	11	0	0
1	42777674	.	G	A	5	2	7	0	0	7	0	0
1	43023630	.	G	A	1	2	3	0	0	3	0	0
1	43034947	.	C	T	12	13	25	0	5	30	0	0
1	43035178	.	T	C	14	15	29	0	1	30	0	0
1	43035546	.	T	A	11	8	19	0	0	19	0	0
1	44228705	.	C	T	5	2	7	0	5	12	0	0
1	45094831	.	T	A	1	2	3	0	0	3	0	0
1	45095079	.	C	T	1	1	2	0	1	3	0	0
1	45570224	.	T	A	4	22	26	0	2	28	0	0
1	45868178	.	C	T	5	13	18	1	4	23	0	0
1	49271317	.	G	A	3	4	7	0	0	7	0	0
1	49289729	.	C	G	3	0	3	0	3	6	0	0
1	49293808	.	T	C	12	7	19	0	1	20	0	0
1	49293954	.	C	T	16	5	21	0	3	24	0	0
1	49294027	.	C	G	0	0	0	0	7	8	1	0
1	49294032	.	A	T	1	6	7	0	0	7	0	0
1	49294686	.	A	G	5	7	12	0	0	12	0	0
1	49423200	.	G	A	1	3	4	0	0	4	0	0
1	49429878	.	G	A	0	3	3	0	2	5	0	0
1	49429917	.	C	A	3	7	10	0	0	10	0	0
1	49429944	.	T	A	7	2	9	0	1	10	0	0
1	49473970	.	G	C	2	3	5	0	0	5	0	0
1	49474079	.	G	A	0	2	2	0	1	3	0	0
1	49475714	.	C	T	3	6	9	0	0	9	0	0
1	49480825	.	T	G	5	4	9	0	0	9	0	0
1	49481007	.	A	T	1	2	3	0	0	3	0	0
1	49481546	.	T	A	10	18	28	0	2	30	0	0
1	49481567	.	T	G	10	19	29	0	2	31	0	0
1	49481649	.	T	C	11	14	25	0	1	26	0	0
1	49481787	.	A	G	12	17	29	0	0	29	0	0
1	49481866	.	T	G	8	15	23	0	0	23	0	0
1	49481886	.	A	T	7	10	17	0	0	17	0	0
1	49482606	.	T	C	2	1	3	0	1	4	0	0
1	49482613	.	C	A	2	2	4	0	0	4	0	0
1	49482755	.	C	T	8	7	15	0	0	15	0	0
1	49482984	.	T	A	4	1	5	0	1	6	0	0
1	49483270	.	C	T	2	3	5	0	0	5	0	0
1	49483300	.	A	G	3	2	5	0	0	5	0	0
1	49483679	.	G	A	4	2	6	0	0	6	0	0
1	49483721	.	T	G	2	5	7	0	0	7	0	0
1	49483901	.	T	A	10	3	13	0	1	14	0	0
1	49484002	.	A	T	7	7	14	0	3	17	0	0
1	49484146	.	G	A	7	5	12	0	0	13	1	0
1	49606724	.	A	G	4	3	7	0	1	8	0	0
1	49607102	.	A	T	1	2	3	0	0	3	0	0
1	49607223	.	T	A	1	1	2	0	2	4	0	0
1	49607251	.	T	C	3	2	5	0	0	5	0	0
1	49902787	.	C	T	1	5	6	0	3	9	0	0
1	49909911	.	A	C	2	10	12	0	0	12	0	0
1	49912827	.	A	G	0	2	2	0	0	2	0	0
1	49912990	.	T	C	1	2	3	0	0	3	0	0
1	49913062	.	A	G	2	8	10	0	1	11	0	0
1	49913071	.	G	A	2	4	6	0	2	8	0	0
1	49913101	.	T	G	0	2	2	0	1	3	0	0
1	49915208	.	G	A	1	4	5	0	0	5	0	0
1	49915231	.	C	T	1	4	5	0	0	5	0	0
1	50035697	.	C	T	0	1	1	0	0	1	0	0
1	50178896	.	A	C	1	2	3	0	0	3	0	0
1	50198792	.	T	C	12	7	19	0	1	20	0	0
1	50198815	.	C	T	0	7	7	0	13	20	0	0
1	50199365	.	A	T	1	0	1	0	0	1	0	0
1	50199368	.	G	A	1	0	1	0	0	1	0	0
1	50221045	.	G	A	2	3	5	0	0	5	0	0
1	50301833	.	A	G	2	0	2	0	0	2	0	0
1	50303989	.	G	A	0	6	6	0	11	17	0	0
1	50319584	.	A	G	10	4	14	0	1	15	0	0
1	50487649	.	G	T	5	6	11	0	1	12	0	0
1	50487837	.	C	A	7	2	9	0	0	9	0	0
1	50487844	.	G	A	7	1	8	0	1	9	0	0
1	50487938	.	A	C	4	2	6	0	0	6	0	0
1	50488002	.	A	G	1	2	3	0	0	3	0	0
1	50496598	.	A	G	2	3	5	0	0	5	0	0
1	50594217	.	T	C	6	17	23	0	2	25	0	0
1	50594318	.	T	G	3	6	9	0	0	9	0	0
1	50594346	.	A	G	4	4	8	0	0	8	0	0
1	50594647	.	G	A	5	9	14	0	1	15	0	0
1	50594670	.	A	T	9	8	17	0	1	18	0	0
1	50595288	.	T	C	4	12	16	0	1	17	0	0
1	50595289	.	G	A	3	13	16	0	0	17	1	0
1	50595476	.	G	A	2	3	5	0	0	5	0	0
1	50595608	.	G	C	2	4	6	0	0	6	0	0
1	50595748	.	T	C	5	7	12	0	1	13	0	0
1	50595805	.	G	A	1	3	4	0	1	5	0	0
1	50595809	.	T	A	2	3	5	0	0	5	0	0
1	50596694	.	A	G	2	1	3	0	0	3	0	0
1	50598848	.	G	A	1	2	3	0	0	3	0	0
1	50608232	.	T	C	2	3	5	0	0	5	0	0
1	50702736	.	C	T	2	2	4	0	1	5	0	0
1	50847905	.	T	C	5	5	10	0	1	11	0	0
1	50848106	.	A	G	14	5	19	0	4	23	0	0
1	50848115	.	A	G	14	8	22	0	0	22	0	0
1	50848206	.	A	C	9	17	26	0	1	27	0	0
1	50848504	.	C	T	17	16	33	0	2	35	0	0
1	50848532	.	G	A	9	15	24	0	8	32	0	0
1	50848555	.	A	G	12	12	24	0	1	25	0	0
1	50848595	.	T	C	9	16	25	0	6	31	0	0
1	50848609	.	A	C	13	13	26	0	2	28	0	0
1	50848647	.	C	T	0	19	19	0	8	27	0	0
1	50848659	.	A	G	6	16	22	0	0	22	0	0
1	50848815	.	A	G	9	8	17	0	9	26	0	0
1	50848911	.	A	G	8	10	18	0	1	19	0	0
1	50848961	.	C	T	9	8	17	0	1	18	0	0
1	50849125	.	T	C	12	9	21	0	2	23	0	0
1	50849157	.	C	T	0	10	10	0	11	21	0	0
1	50849282	.	A	G	5	6	11	0	0	11	0	0
1	50849331	.	G	A	4	10	14	0	0	14	0	0
1	50849456	.	G	A	2	2	4	0	0	4	0	0
1	50849697	.	T	C	2	0	2	0	5	7	0	0
1	50849705	.	C	G	3	4	7	0	0	7	0	0
1	50850041	.	T	A	1	6	7	0	0	7	0	0
1	50850170	.	C	T	1	4	5	0	0	5	0	0
1	50929032	.	C	A	1	2	3	0	0	3	0	0
1	50929759	.	G	A	0	2	2	0	4	6	0	0
1	50969207	.	G	A	0	3	3	0	2	5	0	0
1	50977089	.	C	T	2	0	2	0	0	2	0	0
1	50977707	.	G	A	0	4	4	0	6	10	0	0
1	50979925	.	T	C	2	6	8	0	0	8	0	0
1	50985169	.	C	T	10	8	18	0	1	19	0	0
1	50986092	.	T	C	5	11	16	0	1	17	0	0
1	50986110	.	A	G	8	17	25	0	3	28	0	0
1	50986197	.	C	T	14	28	42	0	6	48	0	0
1	50987507	.	A	C	11	24	35	0	4	39	0	0
1	50990593	.	A	G	20	0	20	0	41	61	0	0
1	50990698	.	A	T	30	18	48	0	2	50	0	0
1	50990815	.	G	A	21	29	50	0	3	53	0	0
1	51021490	.	T	A	6	3	9	0	1	10	0	0
1	51021497	.	T	G	6	3	9	0	1	10	0	0
1	51021701	.	A	G	2	2	4	0	1	5	0	0
1	51041363	.	G	A	0	3	3	0	3	6	0	0
1	51042228	.	G	A	0	12	12	0	8	20	0	0
1	51073118	.	T	C	2	6	8	0	2	10	0	0
1	51230198	.	T	C	5	3	8	0	1	9	0	0
1	51230206	.	T	C	2	6	8	0	1	9	0	0
1	51230275	.	T	C	3	5	8	0	1	9	0	0
1	51405986	.	G	T	17	8	25	0	0	25	0	0
1	51406191	.	G	A	0	4	4	0	14	18	0	0
1	51406341	.	T	A	15	7	22	0	0	22	0	0
1	51406346	.	G	A	14	5	19	0	0	19	0	0
1	51406425	.	A	C	6	4	10	0	1	11	0	0
1	51406450	.	G	A	8	3	11	0	0	11	0	0
1	51425476	.	T	A	1	3	4	0	0	4	0	0
1	51427170	.	T	C	10	4	14	0	3	17	0	0
1	51427779	.	T	C	16	19	35	0	2	37	0	0
1	51427837	.	A	C	14	17	31	0	0	31	0	0
1	51444718	.	G	A	9	12	21	0	3	24	0	0
1	51445120	.	A	T	9	15	24	0	1	25	0	0
1	51445140	.	T	G	7	14	21	0	1	22	0	0
1	51445217	.	A	T	8	4	12	0	2	14	0	0
1	51445325	.	T	C	2	10	12	0	0	12	0	0
1	51445673	.	T	G	13	7	20	0	0	20	0	0
1	51445697	.	T	C	16	0	16	0	6	22	0	0
1	51445777	.	T	A	14	9	23	0	1	24	0	0
1	51446004	.	G	A	7	2	9	0	0	9	0	0
1	51446195	.	T	C	2	0	2	0	4	6	0	0
1	51446215	.	A	T	5	1	6	0	0	6	0	0
1	51447506	.	T	C	1	2	3	0	0	3	0	0
1	51448249	.	C	A	2	3	5	0	0	5	0	0
1	51557903	.	C	T	2	20	22	0	21	43	0	0
1	51558008	.	T	C	23	26	49	0	0	50	1	0
1	51558036	.	G	A	21	21	42	0	5	47	0	0
1	51558133	.	G	T	17	11	28	0	3	31	0	0
1	51558150	.	A	T	11	10	21	0	3	24	0	0
1	51558604	.	C	T	29	15	44	0	0	44	0	0
1	51558897	.	T	A	24	19	43	0	1	44	0	0
1	51559060	.	C	G	15	14	29	0	6	35	0	0
1	51559269	.	G	C	11	19	30	0	0	30	0	0
1	51559815	.	C	T	9	9	18	0	2	20	0	0
1	51562800	.	A	G	3	1	4	0	0	4	0	0
1	51562803	.	T	C	3	1	4	0	0	4	0	0
1	51567367	.	A	G	1	1	2	0	0	2	0	0
1	51591352	.	A	G	9	6	15	0	1	16	0	0
1	51594058	.	A	T	4	12	16	0	3	19	0	0
1	51594447	.	A	G	19	22	41	0	1	42	0	0
1	51594485	.	A	C	13	24	37	0	0	37	0	0
1	51594690	.	C	G	1	15	16	0	24	40	0	0
1	51594701	.	C	T	1	18	19	0	20	39	0	0
1	51606302	.	C	G	2	3	5	0	0	5	0	0
1	51608856	.	C	A	7	6	13	0	0	13	0	0
1	51609002	.	A	T	17	13	30	0	0	30	0	0
1	51702374	.	C	T	0	5	5	0	7	12	0	0
1	51710007	.	C	T	0	0	0	0	1	1	0	0
1	51723440	.	T	C	6	9	15	0	2	17	0	0
1	51723461	.	A	T	5	13	18	0	1	19	0	0
1	51729506	.	C	T	14	9	23	0	2	25	0	0
1	51729645	.	A	C	19	9	28	0	6	34	0	0
1	51729687	.	C	T	23	11	34	0	7	41	0	0
1	51729697	.	C	A	21	13	34	0	8	42	0	0
1	51729735	.	C	A	17	16	33	0	2	35	0	0
1	51729750	.	C	A	15	17	32	0	0	32	0	0
1	51729798	.	A	C	15	10	25	0	1	26	0	0
1	51734087	.	T	C	8	5	13	0	2	15	0	0
1	51734449	.	C	T	0	2	2	0	4	6	0	0
1	52111494	.	C	T	3	12	15	0	0	15	0	0
1	52121404	.	C	T	1	1	2	0	0	2	0	0
1	52121405	.	T	G	1	1	2	0	0	2	0	0
1	52135185	.	T	C	5	4	9	0	1	10	0	0
1	52135384	.	T	C	1	3	4	0	0	4	0	0
1	52135513	.	G	A	2	3	5	0	0	5	0	0
1	52135572	.	G	T	1	2	3	0	0	3	0	0
1	52135862	.	A	G	2	5	7	0	1	8	0	0
1	52135928	.	G	C	2	7	9	0	0	9	0	0
1	52135997	.	G	A	2	9	11	0	0	11	0	0
1	52136027	.	T	C	9	3	12	0	0	12	0	0
1	52136117	.	A	C	6	7	13	0	0	13	0	0
1	52136190	.	G	A	4	8	12	0	0	12	0	0
1	52136294	.	T	C	3	3	6	0	0	6	0	0
1	52136323	.	G	A	7	5	12	0	0	12	0	0
1	52136379	.	T	A	6	3	9	0	1	10	0	0
1	52136641	.	A	G	5	1	6	0	1	7	0	0
1	52136759	.	A	T	15	15	30	0	2	32	0	0
1	52136868	.	A	G	9	7	16	0	0	16	0	0
1	52136894	.	T	C	12	14	26	0	0	26	0	0
1	52136974	.	T	A	10	14	24	0	1	25	0	0
1	52149554	.	A	T	4	6	10	0	2	12	0	0
1	52149619	.	A	C	2	2	4	0	2	6	0	0
1	52149977	.	T	A	2	2	4	0	0	4	0	0
1	52150182	.	G	T	0	4	4	0	5	9	0	0
1	52150231	.	C	T	3	7	10	0	0	10	0	0
1	52152188	.	G	A	0	6	6	0	13	19	0	0
1	52152202	.	A	G	12	4	16	0	0	16	0	0
1	52152300	.	A	T	10	5	15	0	0	15	0	0
1	52152488	.	A	G	6	13	19	0	2	21	0	0
1	52152617	.	C	T	14	17	31	0	8	39	0	0
1	52179039	.	G	T	1	4	5	0	0	5	0	0
1	52452116	.	C	G	2	3	5	0	0	5	0	0
1	52452197	.	G	A	7	10	17	0	1	18	0	0
1	52452275	.	G	T	3	12	15	0	3	18	0	0
1	52455885	.	C	G	0	3	3	0	0	3	0	0
1	52455908	.	G	A	6	0	6	0	0	6	0	0
1	52455960	.	C	T	5	4	9	0	1	10	0	0
1	52456002	.	G	A	0	2	2	0	0	2	0	0
1	52460737	.	C	T	2	9	11	0	0	11	0	0
1	52460739	.	T	C	2	8	10	0	1	11	0	0
1	52460906	.	T	C	2	4	6	0	0	6	0	0
1	52460944	.	G	T	5	6	11	0	0	11	0	0
1	52461114	.	A	G	4	2	6	0	0	6	0	0
1	52461183	.	C	T	3	2	5	0	0	5	0	0
1	52461195	.	G	A	1	3	4	0	0	4	0	0
1	52478538	.	G	A	0	2	2	0	2	4	0	0
1	52489974	.	G	A	0	5	5	0	8	13	0	0
1	52538181	.	A	G	1	2	3	0	0	3	0	0
1	52618405	.	C	T	2	3	5	0	0	5	0	0
1	52625804	.	T	C	2	2	4	0	0	4	0	0
1	52626360	.	T	A	2	4	6	0	0	6	0	0
1	52626865	.	C	T	3	0	3	0	2	5	0	0
1	52626888	.	A	G	4	2	6	0	0	6	0	0
1	52627572	.	G	A	0	10	10	0	26	36	0	0
1	52627609	.	A	T	24	11	35	0	1	36	0	0
1	52627678	.	A	T	22	15	37	0	2	39	0	0
1	52627679	.	C	T	21	18	39	0	0	39	0	0
1	52628253	.	G	T	10	11	21	0	1	22	0	0
1	52628305	.	T	C	7	9	16	0	0	16	0	0
1	52764824	.	A	T	5	6	11	0	0	11	0	0
1	52764914	.	C	T	14	14	28	0	3	31	0	0
1	52773239	.	G	A	1	1	2	0	1	3	0	0
1	52773311	.	A	G	3	2	5	0	1	6	0	0
1	52775619	.	A	C	1	3	4	0	1	5	0	0
1	52782161	.	G	A	5	2	7	0	0	7	0	0
1	53865858	.	A	T	1	3	4	0	0	4	0	0
1	53865870	.	C	A	1	2	3	0	0	3	0	0
1	53866041	.	T	C	1	5	6	0	0	6	0	0
1	53866075	.	C	T	3	6	9	0	0	9	0	0
1	53866120	.	A	T	4	3	7	0	0	7	0	0
1	53866128	.	T	C	4	3	7	0	0	7	0	0
1	53866319	.	C	T	0	4	4	0	0	4	0	0
1	53871326	.	T	A	2	2	4	0	0	4	0	0
1	53872031	.	C	A	5	3	8	0	0	8	0	0
1	53872061	.	C	T	4	3	7	0	0	7	0	0
1	53872067	.	T	C	4	0	4	0	3	7	0	0
1	53873173	.	C	T	0	2	2	0	2	4	0	0
1	53873177	.	T	C	2	0	2	0	2	4	0	0
1	53912148	.	A	G	1	2	3	0	0	3	0	0
1	53930468	.	T	C	1	0	1	0	0	1	0	0
1	53932271	.	A	G	3	6	9	0	1	10	0	0
1	53934495	.	C	A	1	0	1	0	0	1	0	0
1	53935236	.	G	A	3	3	6	0	0	6	0	0
1	53935248	.	G	T	0	4	4	0	3	7	0	0
1	53935287	.	A	G	1	0	1	0	6	7	0	0
1	53935314	.	T	C	1	3	4	0	0	4	0	0
1	53937423	.	C	T	0	1	1	0	0	1	0	0
1	53939430	.	A	G	3	1	4	0	1	5	0	0
1	53939604	.	C	T	0	1	1	0	0	1	0	0
1	53954361	.	C	A	2	1	3	0	0	3	0	0
1	53958136	.	G	A	0	3	3	0	1	4	0	0
1	53958263	.	C	T	3	4	7	0	1	8	0	0
1	53962227	.	A	T	3	1	4	0	1	5	0	0
1	53962264	.	T	C	3	1	4	0	3	7	0	0
1	53963108	.	C	A	5	2	7	0	0	7	0	0
1	53963159	.	C	T	5	4	9	0	0	9	0	0
1	53963428	.	T	A	2	1	3	0	0	3	0	0
1	53963782	.	A	G	1	5	6	0	0	6	0	0
1	54025424	.	C	T	1	2	3	0	0	3	0	0
1	54048786	.	G	A	3	4	7	0	0	7	0	0
1	54061812	.	C	T	3	5	8	0	0	8	0	0
1	54061824	.	C	T	3	5	8	0	0	8	0	0
1	54062754	.	G	A	3	3	6	0	0	6	0	0
1	54062858	.	A	G	3	2	5	0	0	5	0	0
1	54080253	.	G	C	0	2	2	0	1	3	0	0
1	54080261	.	C	T	1	2	3	0	0	3	0	0
1	54080361	.	T	G	2	2	4	0	0	4	0	0
1	54084473	.	G	C	11	2	13	0	1	14	0	0
1	54142097	.	T	C	0	2	2	0	0	2	0	0
1	54142130	.	G	T	0	3	3	0	1	4	0	0
1	54144024	.	T	G	1	1	2	0	0	2	0	0
1	54146383	.	C	T	4	3	7	0	0	7	0	0
1	54178755	.	G	C	6	7	13	0	3	16	0	0
1	54184468	.	C	T	2	1	3	0	0	3	0	0
1	54248366	.	A	C	1	0	1	0	0	1	0	0
1	54274554	.	A	G	14	7	21	0	1	22	0	0
1	54274841	.	C	A	1	2	3	0	0	3	0	0
1	54683743	.	C	T	2	0	2	0	0	2	0	0
1	54685559	.	C	G	12	5	17	0	0	17	0	0
1	54685590	.	A	G	11	4	15	0	1	16	0	0
1	54685610	.	T	C	12	4	16	0	0	16	0	0
1	54685799	.	G	A	4	2	6	0	0	6	0	0
1	54687580	.	C	T	2	6	8	0	0	8	0	0
1	54687649	.	G	T	4	10	14	0	2	16	0	0
1	54687715	.	C	A	13	6	19	1	0	20	0	0
1	54687928	.	G	T	12	4	16	1	1	18	0	0
1	54701201	.	C	G	1	0	1	0	1	2	0	0
1	54701231	.	G	A	0	2	2	0	3	5	0	0
1	54707977	.	G	A	32	23	55	0	4	59	0	0
1	54708098	.	G	T	33	26	59	0	2	61	0	0
1	54708191	.	C	A	32	23	55	0	2	57	0	0
1	54708253	.	G	A	27	25	52	0	5	57	0	0
1	54708281	.	A	T	27	25	52	0	3	55	0	0
1	54708301	.	A	C	27	26	53	0	4	57	0	0
1	54708317	.	C	T	27	22	49	0	3	52	0	0
1	54708359	.	C	T	24	16	40	0	3	43	0	0
1	54708756	.	G	C	6	9	15	0	1	19	3	0
1	54708781	.	A	G	5	16	21	0	0	21	0	0
1	54708946	.	T	C	2	6	8	0	0	8	0	0
1	54709110	.	T	A	2	4	6	0	2	8	0	0
1	54709112	.	A	G	4	4	8	0	0	8	0	0
1	54709334	.	G	A	17	22	39	0	0	39	0	0
1	54753095	.	T	G	2	0	2	0	2	4	0	0
1	54753101	.	T	C	1	2	3	0	1	4	0	0
1	54754356	.	C	T	5	5	10	0	0	10	0	0
1	54754503	.	G	A	2	4	6	0	0	6	0	0
1	54754565	.	C	T	3	1	4	0	1	5	0	0
1	54754623	.	A	T	4	4	8	0	0	8	0	0
1	54754626	.	T	A	5	5	10	0	0	10	0	0
1	54754744	.	C	T	6	3	9	0	0	9	0	0
1	54754754	.	T	C	7	2	9	1	1	11	0	0
1	54755390	.	G	T	3	0	3	0	0	3	0	0
1	54758725	.	C	T	0	3	3	0	4	7	0	0
1	54758975	.	T	C	4	4	8	0	2	10	0	0
1	54759065	.	G	A	2	1	3	0	0	3	0	0
1	54762947	.	G	A	1	1	2	0	0	2	0	0
1	54762997	.	G	T	3	1	4	0	1	5	0	0
1	54763022	.	G	C	3	2	5	0	0	5	0	0
1	54765216	.	A	C	6	0	6	0	4	10	0	0
1	54765218	.	C	T	0	3	3	0	7	10	0	0
1	54907021	.	G	A	3	3	6	0	0	6	0	0
1	54907502	.	A	G	4	3	7	0	0	7	0	0
1	54907549	.	T	C	12	8	20	0	0	20	0	0
1	54907585	.	G	C	17	8	25	0	0	25	0	0
1	54907600	.	A	T	15	7	22	0	1	23	0	0
1	54907622	.	T	C	13	7	20	0	0	20	0	0
1	54907698	.	G	T	10	5	15	0	0	15	0	0
1	54907707	.	C	T	9	5	14	0	1	15	0	0
1	54927198	.	T	C	2	1	3	0	1	4	0	0
1	54929256	.	T	C	4	2	6	0	0	6	0	0
1	54929281	.	G	A	0	3	3	0	3	6	0	0
1	54929293	.	C	T	2	3	5	0	1	6	0	0
1	54930428	.	T	A	3	1	4	0	2	6	0	0
1	54930598	.	A	G	3	6	9	0	1	10	0	0
1	54930626	.	A	C	3	4	7	0	0	7	0	0
1	54930693	.	T	C	2	1	3	0	2	5	0	0
1	54930711	.	G	A	1	4	5	0	1	6	0	0
1	54930776	.	A	G	7	3	10	0	1	11	0	0
1	54931111	.	T	C	3	4	7	0	0	7	0	0
1	54931122	.	G	A	0	5	5	0	2	7	0	0
1	54931211	.	A	T	6	4	10	0	2	12	0	0
1	54931230	.	T	A	13	4	17	0	0	17	0	0
1	54931791	.	G	C	0	13	13	0	14	27	0	0
1	54931862	.	A	G	3	3	6	0	0	6	0	0
1	54936471	.	T	C	9	0	9	0	10	19	0	0
1	54938274	.	T	C	1	0	1	0	0	1	0	0
1	54939536	.	A	T	1	1	2	0	0	2	0	0
1	54943139	.	G	A	1	2	3	0	0	3	0	0
1	54950572	.	G	A	6	4	10	0	0	10	0	0
1	54950661	.	G	A	4	2	6	0	1	7	0	0
1	54950745	.	G	T	6	5	11	0	0	11	0	0
1	54955207	.	G	A	2	1	3	0	0	3	0	0
1	54955234	.	A	G	2	2	4	0	2	6	0	0
1	54958033	.	G	A	0	3	3	0	5	8	0	0
1	54958123	.	A	G	9	4	13	0	2	15	0	0
1	54958146	.	T	A	11	4	15	0	0	15	0	0
1	54960328	.	A	G	8	13	21	0	1	22	0	0
1	54960368	.	T	G	13	20	33	0	1	34	0	0
1	54960416	.	A	C	17	28	45	0	2	47	0	0
1	54960563	.	T	A	15	22	37	0	5	42	0	0
1	54960620	.	G	C	6	3	9	0	0	9	0	0
1	54960639	.	C	T	0	4	4	0	10	14	0	0
1	54960881	.	A	G	9	14	23	1	7	31	0	0
1	54962466	.	A	G	5	4	9	0	1	10	0	0
1	54963314	.	A	G	4	5	9	0	0	9	0	0
1	54964724	.	A	G	3	3	6	0	0	6	0	0
1	54974437	.	C	A	12	8	20	0	0	20	0	0
1	54974438	.	A	G	12	8	20	0	0	20	0	0
1	54974477	.	G	A	9	2	11	0	1	12	0	0
1	54974500	.	T	A	7	4	11	0	2	13	0	0
1	54974538	.	A	G	9	8	17	0	2	19	0	0
1	54974660	.	T	C	6	5	11	0	2	13	0	0
1	54974774	.	G	A	7	9	16	0	1	17	0	0
1	54974810	.	G	T	13	5	18	0	5	23	0	0
1	54975136	.	A	T	10	6	16	0	0	16	0	0
1	54975431	.	C	T	4	5	9	0	0	9	0	0
1	54975484	.	G	T	5	6	11	0	2	13	0	0
1	54975519	.	C	T	7	7	14	0	0	14	0	0
1	54975636	.	C	T	2	4	6	0	1	7	0	0
1	54975658	.	A	G	2	2	4	0	0	4	0	0
1	54975911	.	G	A	1	5	6	0	0	6	0	0
1	54976026	.	T	A	2	6	8	0	0	8	0	0
1	54976035	.	T	A	2	7	9	0	1	10	0	0
1	54976104	.	G	A	4	1	5	0	1	6	0	0
1	54977618	.	G	A	1	2	3	0	0	3	0	0
1	55008322	.	A	G	8	8	16	0	0	16	0	0
1	55008382	.	C	T	11	9	20	0	2	22	0	0
1	55008405	.	G	A	12	8	20	0	1	21	0	0
1	55008594	.	A	T	0	1	1	0	0	1	0	0
1	55008772	.	T	C	5	4	9	0	0	9	0	0
1	55010739	.	T	A	2	2	4	0	1	5	0	0
1	55010741	.	T	G	3	2	5	0	0	5	0	0
1	55010914	.	A	C	2	8	10	0	0	10	0	0
1	55011101	.	T	A	3	3	6	0	0	6	0	0
1	55011353	.	G	C	2	4	6	0	0	6	0	0
1	55011539	.	A	T	3	7	10	0	0	10	0	0
1	55011550	.	G	A	3	7	10	0	0	10	0	0
1	55011692	.	C	T	0	3	3	0	4	7	0	0
1	55013968	.	G	C	0	1	1	0	0	1	0	0
1	55046494	.	G	A	1	3	4	0	1	5	0	0
1	55046509	.	G	A	1	2	3	0	0	3	0	0
1	55046560	.	A	C	2	3	5	0	0	5	0	0
1	55046591	.	G	A	2	3	5	0	0	5	0	0
1	55089328	.	G	A	0	2	2	0	0	2	0	0
1	55089396	.	C	T	0	3	3	0	1	4	0	0
1	55099952	.	C	T	1	2	3	0	0	3	0	0
1	55100456	.	T	C	4	1	5	0	0	5	0	0
1	55101322	.	G	T	1	0	1	0	0	1	0	0
1	55101358	.	C	T	3	3	6	0	0	6	0	0
1	55103160	.	A	G	1	2	3	0	0	3	0	0
1	55105727	.	T	C	1	0	1	0	0	1	0	0
1	55109717	.	A	T	2	9	11	0	0	11	0	0
1	55161208	.	A	G	4	4	8	0	0	8	0	0
1	55161252	.	T	C	7	0	7	0	5	12	0	0
1	55161257	.	A	T	10	4	14	0	0	14	0	0
1	55161431	.	A	G	1	1	2	0	0	2	0	0
1	55161440	.	A	G	1	1	2	0	0	2	0	0
1	55161467	.	C	G	0	1	1	0	0	1	0	0
1	55169244	.	G	C	9	12	21	0	0	21	0	0
1	55169349	.	G	C	9	12	21	0	0	21	0	0
1	55169658	.	T	A	7	10	17	0	0	17	0	0
1	55169662	.	A	G	7	7	14	0	0	14	0	0
1	55169699	.	T	A	10	4	14	0	0	14	0	0
1	55169713	.	A	T	6	7	13	0	0	13	0	0
1	55169756	.	A	G	7	9	16	0	1	17	0	0
1	55169839	.	G	C	11	3	14	0	3	17	0	0
1	55169859	.	C	A	0	0	0	0	11	11	0	0
1	55169961	.	T	C	5	0	5	0	8	13	0	0
1	55169980	.	A	G	6	8	14	0	0	14	0	0
1	55169999	.	C	T	6	7	13	0	2	15	0	0
1	55170056	.	G	T	6	4	10	0	1	11	0	0
1	55170264	.	C	T	9	2	11	0	1	12	0	0
1	55170328	.	C	A	5	5	10	1	1	12	0	0
1	55170366	.	C	T	6	6	12	0	1	13	0	0
1	55170384	.	G	A	2	8	10	0	1	11	0	0
1	55171249	.	G	A	9	4	13	0	0	13	0	0
1	55179434	.	C	T	1	1	2	0	0	2	0	0
1	55179470	.	C	T	0	1	1	0	0	1	0	0
1	55182720	.	T	C	1	2	3	0	0	3	0	0
1	55182743	.	C	T	2	3	5	0	0	5	0	0
1	55264187	.	G	C	5	14	19	0	1	20	0	0
1	55264191	.	A	C	6	14	20	0	0	20	0	0
1	55264225	.	C	T	3	9	12	0	2	14	0	0
1	55264575	.	T	A	6	8	14	0	1	15	0	0
1	55745816	.	C	T	5	2	7	0	0	7	0	0
1	55762664	.	C	A	2	3	5	0	1	6	0	0
1	55776813	.	G	A	0	26	26	0	20	46	0	0
1	55776858	.	G	A	0	18	18	0	12	30	0	0
1	55776909	.	A	C	10	9	19	0	0	23	4	0
1	55776962	.	T	A	16	28	44	0	1	45	0	0
1	55783978	.	T	C	2	2	4	0	0	4	0	0
1	55785527	.	C	A	0	29	29	0	25	54	0	0
1	55785577	.	A	G	15	25	40	0	1	41	0	0
1	55785596	.	T	C	12	21	33	0	7	40	0	0
1	55785654	.	C	T	6	17	23	0	2	25	0	0
1	55787083	.	T	C	0	1	1	0	2	3	0	0
1	55787236	.	C	T	2	2	4	0	1	5	0	0
1	55787276	.	G	A	2	3	5	0	0	5	0	0
1	55787300	.	C	T	0	2	2	0	2	4	0	0
1	55787507	.	A	G	2	4	6	0	0	6	0	0
1	55789456	.	C	T	2	2	4	0	0	4	0	0
1	55843902	.	C	T	13	30	43	0	2	45	0	0
1	55843968	.	G	A	12	22	34	0	5	39	0	0
1	55844044	.	T	A	17	16	33	0	1	34	0	0
1	55844143	.	T	G	24	15	39	0	0	39	0	0
1	55851968	.	T	C	2	0	2	0	4	6	0	0
1	55853320	.	G	A	2	4	6	0	0	6	0	0
1	55872892	.	C	G	0	6	6	0	0	6	0	0
1	55878257	.	T	A	5	7	12	0	2	14	0	0
1	55878342	.	T	A	4	5	9	0	0	9	0	0
1	55878457	.	C	T	10	3	13	0	1	14	0	0
1	55878496	.	T	C	6	1	7	0	8	15	0	0
1	55878558	.	G	A	8	9	17	0	2	19	0	0
1	56217457	.	G	A	9	8	17	0	1	18	0	0
1	56217510	.	A	G	20	23	43	0	8	51	0	0
1	56217925	.	G	A	19	28	47	0	3	50	0	0
1	56218189	.	C	T	1	30	31	0	21	52	0	0
1	56218258	.	A	C	17	25	42	0	6	48	0	0
1	56220668	.	A	G	5	9	14	0	0	14	0	0
1	56422781	.	T	A	1	2	3	0	0	3	0	0
1	56422962	.	A	T	4	7	11	0	0	11	0	0
1	56422967	.	T	C	3	5	8	0	1	9	0	0
1	56423002	.	T	G	3	4	7	0	1	8	0	0
1	56423641	.	T	A	1	2	3	0	0	3	0	0
1	56423664	.	T	C	1	0	1	0	3	4	0	0
1	56425243	.	A	G	0	1	1	0	0	1	0	0
1	57170390	.	G	A	1	3	4	0	0	4	0	0
1	57170397	.	A	C	1	3	4	0	0	4	0	0
1	57278215	.	G	C	1	3	4	0	0	4	0	0
1	57278979	.	G	A	2	2	4	0	0	4	0	0
1	57280184	.	G	T	1	2	3	0	0	3	0	0
1	57306744	.	G	T	1	2	3	0	1	4	0	0
1	58013423	.	C	T	0	2	2	0	3	5	0	0
1	58013554	.	G	A	1	2	3	0	0	3	0	0
1	58545499	.	A	G	4	2	6	0	0	6	0	0
1	58545547	.	T	G	3	2	5	0	0	5	0	0
1	58545580	.	G	C	0	2	2	0	0	2	0	0
1	58593912	.	C	T	3	8	11	0	0	11	0	0
1	58594143	.	A	C	2	3	5	0	0	5	0	0
1	58594144	.	G	A	2	3	5	0	0	5	0	0
1	58594219	.	T	C	1	5	6	0	0	6	0	0
1	58594220	.	T	C	1	5	6	0	0	6	0	0
1	58594292	.	T	C	3	5	8	0	0	8	0	0
1	58594689	.	A	G	1	3	4	0	2	6	0	0
1	58594693	.	C	G	1	5	6	0	0	6	0	0
1	58595018	.	C	T	3	5	8	0	1	9	0	0
1	58595455	.	G	A	4	2	6	0	0	6	0	0
1	58598830	.	A	T	1	0	1	0	0	1	0	0
1	58612354	.	G	A	3	2	5	0	0	5	0	0
1	58612519	.	T	C	2	2	4	0	1	5	0	0
1	58612762	.	A	G	2	4	6	0	0	6	0	0
1	58613091	.	A	C	4	2	6	0	0	6	0	0
1	58617987	.	T	C	4	2	6	0	0	6	0	0
1	58618014	.	C	T	5	2	7	0	1	8	0	0
1	58618035	.	C	T	2	5	7	0	1	8	0	0
1	58618411	.	A	G	0	4	4	0	0	4	0	0
1	58618437	.	A	C	1	3	4	0	0	4	0	0
1	58631609	.	C	T	3	7	10	0	0	10	0	0
1	58631713	.	A	G	0	0	0	1	2	3	0	0
1	58677839	.	T	C	3	5	8	0	0	8	0	0
1	58677856	.	C	T	1	3	4	0	0	4	0	0
1	58678077	.	T	A	2	0	2	0	0	2	0	0
1	58680432	.	T	A	1	4	5	0	0	5	0	0
1	58680499	.	C	A	4	10	14	0	1	15	0	0
1	58680570	.	T	C	3	6	9	0	0	9	0	0
1	58680615	.	G	A	3	4	7	0	0	7	0	0
1	58680708	.	T	C	6	7	13	0	0	13	0	0
1	58680718	.	C	G	6	6	12	0	2	14	0	0
1	58680792	.	T	C	3	12	15	0	0	15	0	0
1	58680913	.	T	C	7	8	15	0	1	16	0	0
1	58681068	.	C	T	2	11	13	0	1	14	0	0
1	58681419	.	A	T	6	13	19	0	1	21	1	0
1	58850500	.	T	G	3	10	13	0	0	13	0	0
1	58850525	.	T	A	3	7	10	0	1	12	1	0
1	58850562	.	C	T	4	7	11	0	0	11	0	0
1	58984368	.	G	A	0	1	1	0	1	2	0	0
1	58984478	.	T	C	4	0	4	0	1	5	0	0
1	58984640	.	C	T	2	2	4	0	1	5	0	0
1	58985530	.	G	A	8	11	19	0	3	22	0	0
1	58985579	.	T	G	11	9	20	0	1	21	0	0
1	58985730	.	C	A	6	5	11	0	0	11	0	0
1	58999960	.	T	A	1	5	6	0	0	6	0	0
1	59009732	.	A	G	10	1	11	0	11	22	0	0
1	59015569	.	C	T	0	10	10	0	6	16	0	0
1	59015647	.	C	T	0	10	10	0	3	13	0	0
1	59018886	.	C	T	0	4	4	0	3	7	0	0
1	59019006	.	C	G	2	5	7	0	0	7	0	0
1	59019084	.	T	A	1	5	6	0	0	6	0	0
1	59019093	.	A	G	3	6	9	0	0	9	0	0
1	59062665	.	T	C	17	22	39	0	3	42	0	0
1	59065889	.	G	A	1	16	17	0	15	32	0	0
1	59141429	.	G	T	0	1	1	0	0	1	0	0
1	59146013	.	C	T	2	2	4	0	0	4	0	0
1	59149117	.	C	T	5	8	13	0	1	14	0	0
1	59149968	.	T	C	9	11	20	0	0	20	0	0
1	59150450	.	A	G	7	3	10	0	0	10	0	0
1	59150482	.	G	T	6	3	9	0	3	12	0	0
1	59150518	.	T	C	4	13	17	0	0	17	0	0
1	59150559	.	T	G	4	13	17	0	3	20	0	0
1	59150583	.	T	A	3	10	13	0	1	14	0	0
1	59150683	.	T	C	5	18	23	0	0	23	0	0
1	59150737	.	T	C	9	6	15	0	1	16	0	0
1	59150762	.	G	T	10	7	17	0	0	17	0	0
1	59150781	.	T	C	13	10	23	0	1	24	0	0
1	59158035	.	C	A	1	2	3	0	0	3	0	0
1	59172876	.	A	G	1	3	4	0	0	4	0	0
1	59172900	.	A	G	2	5	7	0	1	8	0	0
1	59172969	.	G	A	2	2	4	0	2	6	0	0
1	59173358	.	G	T	0	3	3	0	1	4	0	0
1	59174797	.	A	C	1	2	3	0	0	3	0	0
1	59174962	.	T	C	1	3	4	0	0	4	0	0
1	59175511	.	T	C	1	3	4	0	0	4	0	0
1	59175626	.	G	A	0	2	2	0	0	2	0	0
1	59175635	.	G	A	1	2	3	0	0	3	0	0
1	59218477	.	C	G	0	4	4	0	6	10	0	0
1	59218594	.	A	G	10	5	15	0	4	19	0	0
1	59226049	.	T	C	4	10	14	1	2	17	0	0
1	59226052	.	A	G	6	7	13	1	5	19	0	0
1	59226374	.	A	G	0	3	3	0	0	3	0	0
1	59228569	.	A	C	5	1	6	0	9	15	0	0
1	59229211	.	G	A	8	4	12	0	0	12	0	0
1	59232206	.	A	G	6	4	10	0	0	10	0	0
1	59232509	.	G	A	5	1	6	0	0	6	0	0
1	59235016	.	T	G	1	2	3	0	1	4	0	0
1	59237151	.	A	G	1	2	3	0	0	3	0	0
1	59244312	.	A	G	17	8	25	0	0	25	0	0
1	59244635	.	A	T	15	27	42	0	0	42	0	0
1	59244916	.	T	A	34	16	50	0	2	52	0	0
1	59244928	.	C	T	24	20	44	0	10	54	0	0
1	59245142	.	C	G	26	31	57	0	5	62	0	0
1	59245658	.	G	A	5	6	11	0	3	14	0	0
1	59245873	.	T	C	4	1	5	0	0	5	0	0
1	59245900	.	C	T	8	3	11	0	1	12	0	0
1	59247944	.	C	T	4	2	6	0	0	6	0	0
1	59248138	.	T	A	5	2	7	0	0	7	0	0
1	59251658	.	C	G	2	3	5	0	0	5	0	0
1	59302372	.	T	G	3	2	5	0	0	5	0	0
1	59303024	.	C	A	8	4	12	0	0	12	0	0
1	59303220	.	T	G	1	5	6	0	1	7	0	0
1	59304427	.	T	C	2	1	3	0	0	3	0	0
1	59304609	.	T	A	0	2	2	0	0	2	0	0
1	59304816	.	C	T	1	4	5	0	0	5	0	0
1	59305200	.	T	C	10	4	14	0	0	14	0	0
1	59305359	.	A	C	2	4	6	0	0	6	0	0
1	59314966	.	A	G	2	1	3	0	0	3	0	0
1	59321447	.	A	G	7	0	7	0	13	20	0	0
1	59324067	.	T	C	4	13	17	0	1	18	0	0
1	59328287	.	C	T	1	2	3	0	0	3	0	0
1	59328486	.	C	T	1	2	3	0	0	3	0	0
1	59329950	.	A	G	5	5	10	0	0	10	0	0
1	59330040	.	A	G	8	5	13	0	0	13	0	0
1	59330135	.	T	C	4	8	12	0	0	12	0	0
1	59330169	.	C	T	2	11	13	0	1	14	0	0
1	59409455	.	A	G	1	3	4	0	1	5	0	0
10	22333	.	C	G	9	4	13	0	2	15	0	0
10	22434	.	G	T	0	7	7	0	8	15	0	0
10	22435	.	G	T	8	7	15	0	0	15	0	0
10	22507	.	A	G	9	5	14	0	3	17	0	0
10	22543	.	T	A	7	3	10	0	1	11	0	0
10	22554	.	A	T	6	3	9	0	0	9	0	0
10	22672	.	A	T	9	5	14	0	0	14	0	0
10	24733	.	G	A	1	2	3	0	2	5	0	0
10	27705	.	A	G	6	2	8	0	0	8	0	0
10	27987	.	A	T	1	6	7	0	0	7	0	0
10	33427	.	G	A	5	6	11	0	0	11	0	0
10	33441	.	A	G	4	7	11	0	0	11	0	0
10	33630	.	A	G	6	3	9	0	1	10	0	0
10	33665	.	T	C	3	2	5	0	0	5	0	0
10	34759	.	G	A	1	2	3	0	0	3	0	0
10	56792	.	T	G	1	7	8	0	0	8	0	0
10	63587	.	A	G	7	9	16	0	1	18	1	0
10	64855	.	G	A	4	3	7	0	0	7	0	0
10	65086	.	A	G	1	0	1	0	0	1	0	0
10	66886	.	A	G	5	2	7	0	0	7	0	0
10	66967	.	A	G	3	2	5	0	0	5	0	0
10	78461	.	G	C	0	5	5	0	10	15	0	0
10	81276	.	C	T	7	6	13	0	0	13	0	0
10	81444	.	C	T	18	4	22	0	2	24	0	0
10	82213	.	T	G	22	24	46	0	5	51	0	0
10	85353	.	A	G	3	1	4	0	0	4	0	0
10	87417	.	G	A	2	8	10	0	1	11	0	0
10	87426	.	T	C	3	8	11	0	0	11	0	0
10	87592	.	C	T	0	6	6	0	4	10	0	0
10	114066	.	A	G	2	1	3	0	2	5	0	0
10	115136	.	T	C	3	6	9	0	1	10	0	0
10	115493	.	G	T	3	6	9	0	0	9	0	0
10	115506	.	T	G	3	3	6	0	0	6	0	0
10	115679	.	A	T	4	10	14	0	1	15	0	0
10	115874	.	T	A	2	5	7	0	0	7	0	0
10	115982	.	T	C	1	7	8	0	1	9	0	0
10	116015	.	T	G	1	4	5	0	1	6	0	0
10	116020	.	T	G	1	4	5	0	1	6	0	0
10	116546	.	T	A	1	2	3	0	0	3	0	0
10	116581	.	A	G	1	3	4	0	0	4	0	0
10	116884	.	G	C	1	2	3	0	0	3	0	0
10	116887	.	T	C	1	2	3	0	0	3	0	0
10	134661	.	C	T	0	3	3	0	3	6	0	0
10	134749	.	C	T	0	4	4	0	4	8	0	0
10	193726	.	A	G	3	1	4	0	0	4	0	0
10	194316	.	A	G	1	5	6	0	1	7	0	0
10	195321	.	T	C	0	0	0	0	1	1	0	0
10	195327	.	T	C	0	1	1	0	0	1	0	0
10	196051	.	G	T	0	3	3	0	10	13	0	0
10	196052	.	C	G	9	4	13	0	0	13	0	0
10	196342	.	C	G	8	8	16	0	0	16	0	0
10	196426	.	T	A	12	17	29	0	0	29	0	0
10	196429	.	A	T	11	19	30	0	0	30	0	0
10	196524	.	A	G	13	0	13	0	13	26	0	0
10	196563	.	C	G	7	9	16	0	0	16	0	0
10	196693	.	T	A	23	17	40	0	1	41	0	0
10	196773	.	T	C	6	4	10	0	0	10	0	0
10	207078	.	G	T	3	4	7	0	0	7	0	0
10	207128	.	G	A	11	9	20	0	0	20	0	0
10	207279	.	G	A	8	6	14	0	0	14	0	0
10	207992	.	T	C	11	0	11	0	7	18	0	0
10	207994	.	T	C	11	0	11	0	7	18	0	0
10	208104	.	G	A	4	3	7	0	0	7	0	0
10	208674	.	G	A	2	3	5	0	0	5	0	0
10	208714	.	C	T	0	2	2	0	3	5	0	0
10	210692	.	C	A	0	2	2	0	0	2	0	0
10	590949	.	A	G	5	4	9	0	0	9	0	0
10	591461	.	A	G	9	3	12	0	1	13	0	0
10	591476	.	A	G	5	0	5	0	10	15	0	0
10	1052728	.	C	T	0	2	2	0	1	3	0	0
10	1073456	.	T	C	1	4	5	0	1	6	0	0
10	1073519	.	G	C	0	5	5	0	4	9	0	0
10	1076116	.	C	T	1	4	5	0	0	5	0	0
10	1076251	.	T	C	1	1	2	0	0	2	0	0
10	1107441	.	G	A	0	4	4	0	12	16	0	0
10	1107540	.	C	A	12	12	24	0	1	25	0	0
10	1710017	.	G	A	1	5	6	2	0	8	0	0
10	1711502	.	T	C	1	8	9	2	1	12	0	0
10	2898260	.	T	G	4	3	7	0	1	8	0	0
10	3026294	.	C	T	5	2	7	0	0	7	0	0
10	3319357	.	A	G	3	2	5	0	1	6	0	0
10	3321262	.	A	G	18	17	35	0	4	39	0	0
10	3450861	.	A	G	1	3	4	0	0	4	0	0
10	3450863	.	A	T	1	2	3	0	1	4	0	0
10	5093140	.	T	C	7	2	9	0	0	9	0	0
10	5535047	.	A	T	6	2	8	0	0	8	0	0
10	5535048	.	C	G	6	2	8	0	0	8	0	0
10	5789806	.	C	T	5	7	12	0	1	13	0	0
10	5789846	.	G	T	5	4	9	0	1	10	0	0
10	5789850	.	C	T	5	3	8	0	2	10	0	0
10	6022033	.	A	C	1	1	2	0	0	2	0	0
10	6028157	.	A	G	1	2	3	0	1	4	0	0
10	6033469	.	A	C	1	2	3	0	0	3	0	0
10	6033612	.	G	A	0	3	3	0	5	8	0	0
10	6033627	.	A	T	5	3	8	0	0	8	0	0
10	6034194	.	A	T	6	7	13	0	1	14	0	0
10	6034362	.	G	A	0	3	3	0	2	5	0	0
10	6034376	.	G	A	1	2	3	0	0	3	0	0
10	6348571	.	C	A	3	3	6	0	0	6	0	0
10	6372915	.	G	A	3	3	6	0	0	6	0	0
10	6372964	.	T	C	1	3	4	0	0	4	0	0
10	6373430	.	G	A	1	1	2	0	0	2	0	0
10	6373891	.	C	G	5	3	8	0	0	8	0	0
10	6373975	.	A	G	4	2	6	0	1	7	0	0
10	6374279	.	G	A	0	13	13	0	15	28	0	0
10	6374352	.	C	T	11	16	27	0	0	27	0	0
10	6374372	.	A	G	10	18	28	0	1	29	0	0
10	6374597	.	A	G	12	8	20	0	0	20	0	0
10	6374771	.	C	A	8	9	17	0	3	20	0	0
10	6374906	.	C	T	14	13	27	0	2	29	0	0
10	6374982	.	A	G	7	6	13	0	1	14	0	0
10	6375041	.	T	A	0	4	4	0	0	4	0	0
10	6408986	.	A	G	5	4	9	0	2	11	0	0
10	6409067	.	T	C	4	5	9	0	0	9	0	0
10	6409120	.	G	A	4	2	6	0	0	6	0	0
10	6409380	.	A	C	5	6	11	0	2	13	0	0
10	6409453	.	G	A	4	3	7	0	0	7	0	0
10	6409455	.	T	A	4	3	7	0	0	7	0	0
10	6409488	.	C	G	3	4	7	0	0	7	0	0
10	6409515	.	T	A	4	3	7	0	0	7	0	0
10	6473293	.	A	C	4	6	10	0	2	12	0	0
10	6473412	.	C	T	1	9	10	0	17	27	0	0
10	6473544	.	T	C	9	12	21	0	1	22	0	0
10	6473553	.	G	A	11	8	19	0	1	20	0	0
10	6473685	.	T	C	8	9	17	0	1	18	0	0
10	6473704	.	C	G	7	7	14	0	0	14	0	0
10	6473851	.	A	G	6	13	19	0	0	19	0	0
10	6473908	.	A	G	4	10	14	0	0	14	0	0
10	6473996	.	T	C	8	7	15	0	0	15	0	0
10	6474014	.	C	T	6	4	10	0	2	12	0	0
10	6474057	.	T	A	2	2	4	0	0	4	0	0
10	6486330	.	T	C	1	3	4	0	1	5	0	0
10	6490083	.	A	G	3	3	6	0	1	7	0	0
10	6496294	.	C	A	9	11	20	0	4	24	0	0
10	6517593	.	T	A	33	22	55	0	0	55	0	0
10	6517726	.	C	T	20	19	39	0	2	41	0	0
10	6518039	.	T	C	1	3	4	0	3	7	0	0
10	6521877	.	A	C	10	6	16	0	0	16	0	0
10	6522232	.	A	T	1	2	3	0	0	3	0	0
10	6522297	.	C	T	0	4	4	0	6	10	0	0
10	6781372	.	T	A	15	15	30	0	7	37	0	0
10	6781742	.	G	T	7	5	12	0	0	12	0	0
10	6781786	.	A	T	9	6	15	0	0	15	0	0
10	6781976	.	C	T	12	4	16	0	0	16	0	0
10	6782020	.	G	C	4	10	14	0	2	16	0	0
10	6782220	.	A	G	5	7	12	0	0	12	0	0
10	6782454	.	C	G	8	16	24	0	0	24	0	0
10	6782489	.	T	G	6	15	21	0	0	21	0	0
10	6782636	.	T	A	14	12	26	0	1	27	0	0
10	6786326	.	C	T	0	2	2	0	4	6	0	0
10	6786386	.	G	A	4	5	9	0	0	9	0	0
10	6809681	.	C	T	0	0	0	0	1	1	0	0
10	7050408	.	A	G	1	1	2	0	1	3	0	0
10	7050718	.	A	T	1	2	3	0	0	3	0	0
10	7210001	.	G	A	0	1	1	0	3	4	0	0
10	7221810	.	A	G	1	1	2	0	1	3	0	0
10	7222213	.	T	C	1	4	5	0	0	5	0	0
10	7222289	.	C	T	1	2	3	0	0	3	0	0
10	7224964	.	A	G	1	2	3	0	1	4	0	0
10	7231914	.	A	C	7	11	18	0	1	19	0	0
10	7231964	.	G	C	14	9	23	0	0	23	0	0
10	7232083	.	C	T	6	8	14	0	1	15	0	0
10	7232640	.	C	T	12	9	21	0	0	21	0	0
10	7232896	.	A	T	7	9	16	0	1	17	0	0
10	7232897	.	A	G	8	9	17	0	0	17	0	0
10	7232971	.	C	T	12	13	25	0	1	26	0	0
10	7233203	.	G	A	19	20	39	0	4	43	0	0
10	7233440	.	A	T	24	30	54	0	4	58	0	0
10	7233631	.	T	C	22	30	52	0	4	56	0	0
10	7233649	.	A	T	24	28	52	0	7	59	0	0
10	7233854	.	A	T	22	17	39	0	6	45	0	0
10	7284282	.	A	T	1	2	3	0	1	4	0	0
10	7601552	.	G	A	5	6	11	0	1	12	0	0
10	7617113	.	A	T	29	33	62	0	5	67	0	0
10	7617241	.	T	G	23	28	51	0	6	58	1	0
10	7617242	.	G	A	30	22	52	0	6	58	0	0
10	7617327	.	A	C	18	15	33	0	5	38	0	0
10	7624022	.	T	G	1	3	4	0	0	4	0	0
10	7671425	.	G	A	3	5	8	0	1	9	0	0
10	7671473	.	A	T	5	3	8	0	0	8	0	0
10	7674079	.	T	G	2	4	6	0	0	6	0	0
10	7674136	.	C	T	1	2	3	0	0	3	0	0
10	7678121	.	T	C	0	0	0	0	1	1	0	0
10	7709761	.	T	C	1	1	2	0	1	3	0	0
10	7709800	.	C	A	1	2	3	0	1	4	0	0
10	7721459	.	A	G	3	3	6	0	0	6	0	0
10	7721746	.	G	A	1	4	5	0	0	5	0	0
10	7722595	.	A	G	1	3	4	0	1	5	0	0
10	7723004	.	T	C	3	7	10	0	1	11	0	0
10	7723157	.	A	G	12	10	22	0	0	22	0	0
10	7723218	.	T	C	8	12	20	0	0	20	0	0
10	7723275	.	C	A	9	15	24	0	1	25	0	0
10	7723337	.	C	G	4	11	15	0	0	15	0	0
10	7769959	.	G	A	2	6	8	0	0	8	0	0
10	7769965	.	A	G	3	5	8	0	1	9	0	0
10	7770111	.	G	A	1	2	3	0	0	3	0	0
10	7770200	.	A	G	1	5	6	0	2	8	0	0
10	7770201	.	G	A	2	6	8	0	0	8	0	0
10	7771002	.	A	G	1	2	3	0	0	3	0	0
10	7771039	.	G	A	1	2	3	0	0	3	0	0
10	7771634	.	T	A	8	3	11	0	1	12	0	0
10	7810461	.	A	T	8	10	18	0	1	19	0	0
10	7810565	.	G	A	5	6	11	0	1	12	0	0
10	7811935	.	A	G	2	2	4	0	0	4	0	0
10	7916820	.	G	A	7	8	15	0	1	16	0	0
10	7916888	.	A	G	6	7	13	0	1	14	0	0
10	7917036	.	A	T	12	16	28	0	0	29	1	0
10	7917072	.	A	C	19	14	33	0	1	34	0	0
10	7917331	.	A	T	9	12	21	0	1	22	0	0
10	7917411	.	C	A	0	6	6	0	14	20	0	0
10	7917538	.	G	A	9	8	17	0	2	19	0	0
10	7917551	.	A	G	14	11	25	0	2	27	0	0
10	7917592	.	T	C	19	15	34	0	2	36	0	0
10	7917686	.	T	C	15	16	31	0	4	35	0	0
10	7917690	.	A	T	16	19	35	0	1	36	0	0
10	7920865	.	G	C	7	0	7	0	10	17	0	0
10	7922294	.	C	A	6	5	11	0	0	11	0	0
10	7922309	.	G	A	4	6	10	0	0	10	0	0
10	7922514	.	A	G	6	4	10	0	1	11	0	0
10	7929469	.	A	G	5	0	5	0	0	5	0	0
10	7929611	.	C	A	0	5	5	0	3	8	0	0
10	7938629	.	C	T	1	1	2	0	0	2	0	0
10	7975692	.	T	C	19	39	58	0	2	60	0	0
10	7976105	.	C	G	26	16	42	0	1	43	0	0
10	7976316	.	G	C	19	26	45	0	2	47	0	0
10	7976343	.	C	T	20	35	55	0	2	57	0	0
10	7976574	.	A	C	2	0	2	0	0	2	0	0
10	7976851	.	G	A	19	15	34	0	2	36	0	0
10	7979229	.	A	G	7	3	10	0	0	10	0	0
10	7984479	.	C	T	1	3	4	0	8	12	0	0
10	7984482	.	A	G	8	4	12	0	1	13	0	0
10	7984677	.	A	T	0	1	1	0	0	1	0	0
10	7989000	.	C	T	5	4	9	0	0	9	0	0
10	7989082	.	T	A	7	9	16	0	0	16	0	0
10	7989132	.	T	A	12	6	18	0	2	20	0	0
10	7989162	.	T	G	4	12	16	0	0	16	0	0
10	7989237	.	G	A	7	4	11	0	0	11	0	0
10	7989287	.	G	A	8	5	13	0	0	13	0	0
10	7989290	.	G	A	4	8	12	0	1	13	0	0
10	7996021	.	G	A	1	0	1	0	0	1	0	0
10	7996022	.	C	G	0	1	1	0	0	1	0	0
10	8001365	.	A	G	1	2	3	0	0	3	0	0
10	8005785	.	T	A	2	2	4	0	0	4	0	0
10	8035093	.	G	A	1	5	6	0	0	6	0	0
10	8035702	.	C	T	2	2	4	0	1	5	0	0
10	8035752	.	A	T	3	3	6	0	0	6	0	0
10	8036813	.	C	T	2	2	4	0	0	4	0	0
10	8037351	.	C	T	1	4	5	0	0	5	0	0
10	8037519	.	G	T	1	2	3	0	0	3	0	0
10	8037542	.	A	T	2	2	4	0	1	5	0	0
10	8091212	.	G	A	3	2	5	0	0	5	0	0
10	8154892	.	C	T	5	3	8	0	1	9	0	0
10	8170083	.	C	A	2	2	4	0	0	4	0	0
10	8263045	.	G	A	6	7	13	0	1	14	0	0
10	8263081	.	T	C	5	1	6	0	0	6	0	0
10	8263919	.	C	T	3	4	7	0	1	8	0	0
10	8266248	.	C	T	0	20	20	0	23	43	0	0
10	8269224	.	G	A	9	4	13	0	0	13	0	0
10	8950055	.	G	A	3	2	5	0	0	5	0	0
10	8952018	.	T	C	4	3	7	0	0	7	0	0
10	8970757	.	T	C	1	2	3	0	0	3	0	0
10	9177175	.	T	C	1	1	2	0	0	2	0	0
10	9177608	.	C	T	3	5	8	0	0	8	0	0
10	9184533	.	C	T	8	10	18	0	1	19	0	0
10	9184556	.	A	G	8	9	17	0	0	17	0	0
10	9247771	.	A	T	3	2	5	0	0	5	0	0
10	9247804	.	C	A	2	2	4	0	0	4	0	0
10	9255670	.	G	A	0	3	3	0	0	3	0	0
10	9305465	.	T	C	3	0	3	0	8	11	0	0
10	9305534	.	A	C	5	2	7	0	0	7	0	0
10	9305543	.	C	T	3	2	5	0	1	6	0	0
10	9308057	.	C	T	3	3	6	0	1	7	0	0
10	9370210	.	T	A	2	7	9	0	0	9	0	0
10	9370274	.	G	A	4	3	7	0	0	7	0	0
10	9390767	.	T	C	1	3	4	0	0	4	0	0
10	9394247	.	A	C	1	3	4	0	0	4	0	0
10	9394918	.	G	C	8	3	11	0	1	12	0	0
10	9419821	.	G	A	14	9	23	0	4	27	0	0
10	9419901	.	T	A	10	18	28	0	0	28	0	0
10	9419902	.	A	G	10	18	28	0	0	28	0	0
10	9776699	.	C	T	2	0	2	0	0	2	0	0
10	9781455	.	G	A	3	0	3	0	0	3	0	0
10	9784238	.	G	A	0	5	5	0	4	9	0	0
10	9789262	.	C	T	2	1	3	0	0	3	0	0
10	9802804	.	C	T	8	10	18	0	0	18	0	0
10	9837191	.	A	G	5	7	12	0	1	13	0	0
10	9846285	.	T	G	5	9	14	0	1	15	0	0
10	9846602	.	C	G	0	2	2	0	2	4	0	0
10	9861038	.	A	T	1	1	2	0	0	2	0	0
10	10269930	.	T	C	0	1	1	0	0	1	0	0
10	10325451	.	T	C	3	6	9	0	1	10	0	0
10	10545496	.	C	T	3	1	4	0	0	4	0	0
10	10561112	.	T	A	1	4	5	0	0	5	0	0
10	10700532	.	C	T	2	2	4	0	0	4	0	0
10	10731381	.	C	A	0	1	1	0	0	1	0	0
10	10860852	.	A	G	5	8	13	0	0	13	0	0
10	10860932	.	A	T	5	8	13	0	4	17	0	0
10	10861085	.	G	T	4	12	16	0	0	16	0	0
10	10861504	.	G	A	3	2	5	0	0	5	0	0
10	10880188	.	T	C	1	2	3	0	0	3	0	0
10	10997711	.	T	C	1	3	4	0	0	4	0	0
10	10998496	.	T	G	2	1	3	0	1	4	0	0
10	11093968	.	T	C	1	2	3	0	0	3	0	0
10	11280146	.	C	T	3	7	10	0	0	10	0	0
10	11280441	.	G	A	2	6	8	0	0	8	0	0
10	11281821	.	A	G	2	2	4	1	0	5	0	0
10	11282072	.	G	A	0	4	4	0	0	4	0	0
10	11282109	.	G	A	0	4	4	0	4	8	0	0
10	11282110	.	T	A	4	4	8	0	0	8	0	0
10	11282335	.	A	G	4	4	8	0	0	8	0	0
10	11282933	.	T	A	3	3	6	0	1	7	0	0
10	11298852	.	G	A	2	2	4	0	1	5	0	0
10	11327406	.	T	A	4	4	8	0	0	8	0	0
10	11327521	.	C	A	4	12	16	0	4	20	0	0
10	11327674	.	G	A	3	3	6	0	2	8	0	0
10	11328246	.	G	C	5	2	7	1	1	9	0	0
10	11328334	.	G	A	4	2	6	0	1	7	0	0
10	11362275	.	C	T	12	16	28	0	1	29	0	0
10	11367979	.	C	T	11	4	15	0	3	18	0	0
10	11367980	.	T	C	13	5	18	0	0	18	0	0
10	11368106	.	T	C	3	5	8	0	0	8	0	0
10	11368249	.	A	G	5	13	18	0	0	18	0	0
10	11501181	.	C	A	3	3	6	0	1	7	0	0
10	11773751	.	T	C	1	4	5	0	0	5	0	0
10	11779259	.	G	A	1	1	2	0	0	2	0	0
10	13238028	.	A	G	4	5	9	0	0	9	0	0
10	13238055	.	G	T	7	5	12	0	0	12	0	0
10	13460494	.	A	C	8	8	16	0	1	17	0	0
10	13460615	.	C	T	12	12	24	0	1	25	0	0
10	13460730	.	C	T	6	17	23	0	2	25	0	0
10	13460765	.	C	T	17	8	25	0	2	27	0	0
10	13460813	.	A	T	9	12	21	0	0	21	0	0
10	14491139	.	C	T	2	2	4	0	0	4	0	0
10	14533352	.	A	G	4	5	9	0	1	10	0	0
10	14533359	.	T	C	5	1	6	0	1	7	0	0
10	14536393	.	G	A	2	0	2	0	2	4	0	0
10	14542942	.	C	A	8	2	10	0	3	13	0	0
10	14545572	.	A	G	6	6	12	0	0	12	0	0
10	14871245	.	T	A	17	13	30	0	2	32	0	0
10	14871292	.	G	A	12	4	16	0	5	21	0	0
10	14871758	.	C	G	13	4	17	0	1	18	0	0
10	14871768	.	A	G	15	6	21	0	2	23	0	0
10	14871801	.	A	C	16	6	22	0	2	24	0	0
10	14872258	.	T	G	1	4	5	0	0	5	0	0
10	14873175	.	T	G	3	9	12	0	1	13	0	0
10	14873220	.	A	G	3	6	9	0	1	10	0	0
10	15277481	.	T	C	0	1	1	0	0	1	0	0
10	15287883	.	C	A	2	2	4	0	1	5	0	0
10	15295913	.	T	C	6	5	11	0	0	11	0	0
10	15296219	.	G	A	0	1	1	0	1	2	0	0
10	15298458	.	G	C	3	6	9	0	2	11	0	0
10	15298518	.	G	A	4	5	9	0	1	10	0	0
10	15303975	.	A	T	5	2	7	0	0	7	0	0
10	15304167	.	A	G	3	10	13	0	2	15	0	0
10	15304331	.	C	A	16	10	26	0	2	28	0	0
10	15304782	.	A	G	16	12	28	0	3	31	0	0
10	15372708	.	G	T	3	2	5	0	1	6	0	0
10	15372726	.	G	A	5	4	9	0	0	9	0	0
10	15372889	.	G	A	1	6	7	0	1	8	0	0
10	15381782	.	C	G	4	3	7	0	1	8	0	0
10	15381784	.	A	C	5	3	8	0	0	8	0	0
10	15382352	.	A	G	8	11	19	0	0	19	0	0
10	15382546	.	A	G	7	12	19	0	1	20	0	0
10	15382669	.	G	A	11	9	20	0	0	20	0	0
10	15382681	.	A	T	13	8	21	0	0	21	0	0
10	15400027	.	G	A	4	3	7	0	1	8	0	0
10	15438451	.	G	A	1	4	5	0	0	5	0	0
10	15447471	.	T	C	0	4	4	0	1	5	0	0
10	15596752	.	C	T	4	2	6	0	0	6	0	0
10	15596767	.	C	G	4	2	6	0	0	6	0	0
10	15596958	.	G	C	2	4	6	0	0	6	0	0
10	15596995	.	C	T	4	3	7	0	0	7	0	0
10	15598303	.	A	T	2	3	5	0	1	6	0	0
10	15598358	.	T	G	3	5	8	0	0	8	0	0
10	15598412	.	T	C	11	5	16	0	0	16	0	0
10	15598472	.	A	G	5	5	10	0	0	10	0	0
10	15598480	.	A	G	4	8	12	0	1	13	0	0
10	15598598	.	T	G	5	3	8	0	2	10	0	0
10	15598681	.	G	A	0	11	11	0	5	16	0	0
10	15598921	.	T	A	13	7	20	0	3	23	0	0
10	15608373	.	T	C	2	4	6	0	0	6	0	0
10	15608756	.	T	C	0	2	2	0	0	2	0	0
10	15612238	.	C	T	12	7	19	0	0	19	0	0
10	15612675	.	T	A	19	7	26	0	2	28	0	0
10	15612705	.	C	T	17	9	26	0	2	28	0	0
10	15612758	.	G	A	14	14	28	0	8	36	0	0
10	15612859	.	G	T	0	19	19	0	13	32	0	0
10	15613076	.	G	A	0	6	6	0	12	18	0	0
10	15613174	.	A	C	4	8	12	0	0	12	0	0
10	15618168	.	G	C	2	3	5	0	0	5	0	0
10	15618411	.	A	G	2	9	11	0	0	11	0	0
10	15618606	.	A	G	2	1	3	0	0	3	0	0
10	15621499	.	A	G	3	7	10	0	0	10	0	0
10	15621529	.	C	T	0	6	6	0	2	8	0	0
10	15623124	.	T	C	1	1	2	0	0	2	0	0
10	15783934	.	T	C	2	4	6	0	0	6	0	0
10	15784613	.	G	A	0	4	4	0	7	11	0	0
10	15788562	.	A	T	9	7	16	0	0	16	0	0
10	15809215	.	C	T	9	11	20	0	1	21	0	0
10	15815984	.	A	T	2	2	4	0	1	5	0	0
10	15816029	.	T	A	2	7	9	0	1	10	0	0
10	15816577	.	C	A	0	2	2	0	1	3	0	0
10	15816852	.	C	G	0	4	4	0	6	10	0	0
10	15816879	.	G	A	4	2	6	0	0	6	0	0
10	15824645	.	A	G	2	2	4	0	0	4	0	0
10	15824648	.	A	G	2	0	2	0	2	4	0	0
10	15824684	.	C	A	0	2	2	0	1	3	0	0
10	15881732	.	G	T	4	6	10	0	3	13	0	0
10	15881819	.	T	G	5	16	21	0	0	21	0	0
10	15884833	.	G	A	4	7	11	0	1	12	0	0
10	15884872	.	T	C	2	0	2	0	8	10	0	0
10	15885056	.	C	G	1	0	1	0	0	1	0	0
10	15893372	.	G	T	2	2	4	0	0	4	0	0
10	15960967	.	T	A	6	4	10	0	1	11	0	0
10	16015332	.	G	A	0	1	1	0	0	1	0	0
10	16015509	.	C	A	0	2	2	0	1	3	0	0
10	16019902	.	C	T	0	2	2	0	0	2	0	0
10	16020028	.	T	C	3	2	5	0	0	5	0	0
10	16031378	.	T	C	2	3	5	0	0	5	0	0
10	16031555	.	C	T	9	4	13	0	0	13	0	0
10	16031648	.	C	G	4	3	7	0	1	8	0	0
10	16031690	.	A	G	1	5	6	0	0	6	0	0
10	16034782	.	A	G	9	4	13	0	0	13	0	0
10	16034796	.	C	T	10	4	14	0	0	14	0	0
10	16034887	.	G	A	2	4	6	0	1	7	0	0
10	16034901	.	A	C	3	5	8	0	0	8	0	0
10	16035084	.	G	A	8	4	12	0	1	13	0	0
10	16049522	.	T	C	3	3	6	0	0	6	0	0
10	16052536	.	T	C	2	1	3	0	0	3	0	0
10	16055878	.	C	T	4	5	9	0	0	9	0	0
10	16055906	.	C	T	3	3	6	0	0	6	0	0
10	16056137	.	T	A	2	4	6	0	0	6	0	0
10	16056145	.	A	G	3	4	7	0	0	7	0	0
10	16056181	.	T	A	7	3	10	0	2	12	0	0
10	16056511	.	T	C	12	9	21	0	0	21	0	0
10	16056739	.	A	G	1	3	4	0	0	4	0	0
10	16176906	.	G	A	1	0	1	0	0	1	0	0
10	16185685	.	A	G	4	2	6	0	0	6	0	0
10	16185915	.	T	G	3	7	10	0	0	10	0	0
10	16185927	.	C	G	3	8	11	0	0	11	0	0
10	16185984	.	T	G	4	3	7	0	1	8	0	0
10	16186158	.	T	C	3	4	7	0	2	9	0	0
10	16186405	.	T	A	10	9	19	0	0	19	0	0
10	16225603	.	A	T	3	0	3	0	0	3	0	0
10	16225872	.	C	T	1	2	3	0	0	3	0	0
10	16307651	.	T	A	1	3	4	0	0	4	0	0
10	16308206	.	T	C	1	3	4	0	0	4	0	0
10	16308272	.	A	G	7	3	10	0	0	10	0	0
10	16308643	.	G	A	0	6	6	0	6	12	0	0
10	16308648	.	G	T	0	5	5	0	6	11	0	0
10	16308923	.	G	A	0	6	6	0	13	19	0	0
10	16309001	.	T	A	10	3	13	0	1	14	0	0
10	16309017	.	G	A	10	1	11	0	0	11	0	0
10	16309167	.	T	C	10	9	19	0	6	25	0	0
10	16309364	.	A	G	0	2	2	0	0	2	0	0
10	16309434	.	T	C	2	5	7	0	1	8	0	0
10	16309498	.	C	T	7	7	14	1	4	19	0	0
10	16747280	.	T	C	2	2	4	0	0	4	0	0
10	16747281	.	A	C	1	2	3	0	1	4	0	0
10	16747465	.	A	C	3	5	8	0	0	8	0	0
10	17102971	.	C	T	41	17	58	0	2	60	0	0
10	17132501	.	C	T	5	8	13	0	0	13	0	0
10	17166889	.	C	T	0	5	5	0	5	10	0	0
10	17166955	.	A	G	9	9	18	0	0	18	0	0
10	17166982	.	A	G	8	9	17	0	2	19	0	0
10	17167637	.	A	G	9	12	21	0	1	22	0	0
10	17167733	.	T	C	14	12	26	0	0	26	0	0
10	17167757	.	G	A	11	10	21	0	2	23	0	0
10	17168039	.	C	T	6	8	14	0	0	14	0	0
10	17168096	.	A	G	1	1	2	0	1	3	0	0
10	17174687	.	C	T	2	1	3	0	0	3	0	0
10	17223867	.	T	A	3	3	6	0	0	6	0	0
10	17224218	.	G	A	3	2	5	0	2	7	0	0
10	17460743	.	A	G	3	2	5	0	0	5	0	0
10	17552889	.	A	T	5	7	12	0	0	12	0	0
10	17552976	.	T	C	6	7	13	0	1	14	0	0
10	17552994	.	T	C	4	5	9	0	1	10	0	0
10	17553184	.	T	C	2	1	3	0	0	3	0	0
10	17553271	.	G	A	2	0	2	0	1	3	0	0
10	17560030	.	G	A	1	5	6	0	0	6	0	0
10	17560390	.	T	C	0	1	1	0	0	1	0	0
10	17562978	.	G	C	0	1	1	0	0	1	0	0
10	17563180	.	A	G	0	2	2	0	0	2	0	0
10	17563279	.	C	T	1	1	2	0	0	2	0	0
10	17681252	.	G	A	0	2	2	0	0	2	0	0
10	17684736	.	C	T	2	1	3	0	0	3	0	0
10	17684739	.	C	T	2	1	3	0	0	3	0	0
10	17686174	.	T	C	2	3	5	0	0	5	0	0
10	17686216	.	T	C	1	1	2	0	0	2	0	0
10	17690998	.	C	T	8	8	16	0	1	17	0	0
10	17691127	.	T	G	8	8	16	0	0	16	0	0
10	17700365	.	A	T	3	8	11	0	1	12	0	0
10	17700458	.	T	C	2	8	10	0	0	10	0	0
10	17700484	.	A	T	4	5	9	0	0	9	0	0
10	17701002	.	C	G	4	7	11	0	0	11	0	0
10	17701003	.	C	A	0	7	7	0	4	11	0	0
10	17701222	.	C	T	0	8	8	0	6	14	0	0
10	17913424	.	A	C	1	1	2	0	0	2	0	0
10	17922444	.	A	G	6	10	16	0	0	16	0	0
10	17922540	.	A	T	7	11	18	0	0	18	0	0
10	17922582	.	C	T	3	8	11	0	0	11	0	0
10	17922651	.	G	C	4	7	11	0	0	11	0	0
10	17922718	.	C	T	4	7	11	0	0	11	0	0
10	17922807	.	A	G	2	0	2	0	7	9	0	0
10	17922894	.	T	G	5	3	8	0	0	8	0	0
10	17922955	.	A	T	1	2	3	0	0	3	0	0
10	17922973	.	T	C	2	2	4	0	0	4	0	0
10	17923490	.	A	T	3	11	14	0	0	15	1	0
10	17924398	.	A	C	3	4	7	0	0	7	0	0
10	17924420	.	T	C	2	3	5	0	0	5	0	0
10	17924740	.	T	G	5	13	18	0	0	18	0	0
10	17924779	.	G	A	4	8	12	0	3	15	0	0
10	17924836	.	T	A	8	10	18	0	1	19	0	0
10	17925146	.	T	C	11	14	25	0	1	26	0	0
10	17925301	.	T	A	7	11	18	0	1	19	0	0
10	17925302	.	G	T	7	11	18	0	1	19	0	0
10	17925951	.	T	A	1	2	3	0	0	3	0	0
10	17940303	.	G	A	0	1	1	0	7	8	0	0
10	17940352	.	G	A	13	5	18	0	0	18	0	0
10	17940356	.	A	G	12	5	17	0	2	19	0	0
10	17943696	.	G	A	3	1	4	0	0	4	0	0
10	17943714	.	T	C	7	6	13	0	0	13	0	0
10	17944017	.	C	T	7	3	10	0	1	11	0	0
10	17945447	.	A	G	27	15	42	0	7	49	0	0
10	17945522	.	C	T	10	18	28	2	4	34	0	0
10	17945581	.	G	T	25	19	44	0	5	49	0	0
10	17945629	.	T	C	30	22	52	0	5	57	0	0
10	17945725	.	A	G	25	22	47	0	2	49	0	0
10	17945738	.	T	A	23	16	39	0	2	41	0	0
10	17945779	.	T	A	21	4	25	0	0	25	0	0
10	17946030	.	A	T	6	6	12	0	2	14	0	0
10	18934291	.	T	C	2	6	8	0	0	8	0	0
10	18934590	.	A	C	6	5	11	0	0	11	0	0
10	18934683	.	T	C	4	5	9	0	0	9	0	0
10	18934963	.	G	A	0	4	4	0	5	9	0	0
10	18935271	.	C	T	12	12	24	0	0	24	0	0
10	18935874	.	T	A	3	8	11	0	0	11	0	0
10	18983512	.	C	A	2	0	2	0	1	3	0	0
10	18989018	.	C	G	2	0	2	0	0	2	0	0
10	19020475	.	A	G	5	6	11	0	0	11	0	0
10	19020537	.	G	A	11	4	15	0	0	15	0	0
10	19021102	.	C	G	11	9	20	0	1	21	0	0
10	19021211	.	G	T	2	8	10	0	0	10	0	0
10	19428498	.	C	T	2	2	4	0	0	4	0	0
10	19428509	.	T	C	2	2	4	0	0	4	0	0
10	19558489	.	C	A	0	1	1	0	0	1	0	0
10	19559274	.	C	T	3	3	6	0	0	6	0	0
10	19561232	.	C	A	1	2	3	0	0	3	0	0
10	19561837	.	G	A	10	5	15	0	3	18	0	0
10	19562006	.	T	G	4	3	7	0	0	7	0	0
10	19562015	.	A	T	5	4	9	0	1	10	0	0
10	19565704	.	A	T	15	22	37	1	3	41	0	0
10	19566142	.	A	T	31	28	59	0	2	61	0	0
10	19566373	.	C	T	15	11	26	0	2	28	0	0
10	20100205	.	C	T	3	6	9	0	0	9	0	0
10	20100234	.	C	T	4	6	10	0	0	10	0	0
10	20100269	.	A	C	6	10	16	0	0	16	0	0
10	20103359	.	C	T	8	8	16	0	1	17	0	0
10	20103392	.	A	G	8	3	11	0	1	12	0	0
10	20103601	.	G	T	2	2	4	0	1	5	0	0
10	20103662	.	C	T	5	3	8	0	1	9	0	0
10	20103731	.	C	T	7	4	11	0	0	11	0	0
10	20105210	.	T	C	3	3	6	0	0	6	0	0
10	20108575	.	T	A	2	5	7	0	0	7	0	0
10	20146535	.	C	T	11	19	30	0	3	34	1	0
10	20234074	.	C	T	3	4	7	0	2	9	0	0
10	20276868	.	T	G	1	1	2	0	0	2	0	0
10	20276898	.	A	G	1	1	2	0	1	3	0	0
10	20276904	.	G	A	1	2	3	0	0	3	0	0
10	20368862	.	T	A	2	3	5	0	0	5	0	0
10	20371402	.	A	T	7	7	14	0	2	16	0	0
10	20371419	.	A	C	8	7	15	0	1	16	0	0
10	20371478	.	C	A	10	10	20	0	1	21	0	0
10	20371715	.	T	C	5	8	13	0	1	14	0	0
10	20371723	.	A	C	4	7	11	0	0	11	0	0
10	20371827	.	C	T	13	7	20	0	5	25	0	0
10	20372029	.	G	A	0	2	2	0	5	7	0	0
10	20398930	.	T	C	1	3	4	0	0	4	0	0
10	20401360	.	C	A	3	3	6	0	0	6	0	0
10	20401699	.	A	C	2	2	4	0	0	4	0	0
10	20401702	.	C	G	2	2	4	0	0	4	0	0
10	20449009	.	C	T	5	11	16	0	0	16	0	0
10	20462884	.	G	A	1	2	3	0	0	3	0	0
10	20505467	.	T	C	0	0	0	0	2	2	0	0
10	20506482	.	T	A	0	1	1	0	0	1	0	0
10	20527553	.	G	A	7	1	8	0	0	8	0	0
10	20527571	.	C	T	7	3	10	0	0	10	0	0
10	20527653	.	C	T	3	6	9	0	0	9	0	0
10	20527736	.	C	T	0	6	6	1	7	14	0	0
10	20527837	.	C	A	0	7	7	0	9	16	0	0
10	20529384	.	G	A	6	5	11	0	1	12	0	0
10	20529389	.	G	T	7	5	12	0	2	14	0	0
10	20604548	.	A	G	7	12	19	0	1	20	0	0
10	20604703	.	G	T	7	8	15	0	0	15	0	0
10	20605150	.	C	T	18	7	25	0	1	26	0	0
10	20605171	.	A	T	8	15	23	0	5	28	0	0
10	20605592	.	C	T	1	2	3	0	0	3	0	0
10	20636072	.	A	C	2	2	4	0	1	5	0	0
10	20636082	.	C	T	2	2	4	0	0	4	0	0
10	20636211	.	G	A	1	4	5	0	0	5	0	0
10	20636262	.	T	A	1	2	3	0	0	3	0	0
10	20654817	.	A	T	1	6	7	0	0	7	0	0
10	20660387	.	G	A	2	1	3	0	0	3	0	0
10	21043461	.	G	A	1	2	3	0	1	4	0	0
10	21440486	.	T	A	2	2	4	0	3	7	0	0
10	21440786	.	A	G	1	2	3	0	0	3	0	0
10	21442994	.	T	A	22	12	34	0	0	35	1	0
10	21443135	.	G	A	1	7	8	0	10	18	0	0
10	21443193	.	T	G	16	12	28	0	1	29	0	0
10	21443347	.	T	A	8	4	12	0	0	12	0	0
10	21443476	.	T	C	16	15	31	0	0	31	0	0
10	21459017	.	G	A	0	0	0	0	2	2	0	0
10	21459403	.	G	A	0	3	3	0	2	5	0	0
10	21462585	.	A	G	5	3	8	0	0	8	0	0
10	21462612	.	T	C	3	5	8	0	0	8	0	0
10	21469977	.	G	A	0	18	18	0	17	35	0	0
10	21469997	.	A	C	19	13	32	0	1	33	0	0
10	21470192	.	G	A	0	14	14	0	16	30	0	0
10	21645994	.	G	A	1	2	3	0	0	3	0	0
10	21646222	.	G	A	10	1	11	0	1	12	0	0
10	21646225	.	G	A	10	3	13	0	2	15	0	0
10	21646400	.	C	G	13	10	23	0	0	23	0	0
10	21646621	.	C	T	12	15	27	0	2	29	0	0
10	21646668	.	T	A	8	15	23	0	2	25	0	0
10	21646797	.	C	T	9	20	29	0	4	33	0	0
10	21646802	.	A	G	11	21	32	0	0	32	0	0
10	21646848	.	A	G	13	13	26	0	1	27	0	0
10	21646908	.	C	A	13	13	26	0	0	26	0	0
10	21647008	.	A	C	21	8	29	0	1	30	0	0
10	21647200	.	C	T	15	17	32	0	5	37	0	0
10	21647539	.	T	C	27	26	53	0	3	56	0	0
10	21647582	.	C	A	29	28	57	0	1	58	0	0
10	21647614	.	A	C	30	24	54	0	3	57	0	0
10	21647691	.	G	A	31	25	56	0	5	61	0	0
10	21647898	.	C	T	22	22	44	0	6	50	0	0
10	21781524	.	C	G	4	2	6	0	1	7	0	0
10	21785677	.	C	T	4	3	7	0	0	7	0	0
10	21785734	.	C	T	1	2	3	0	1	4	0	0
10	21792332	.	C	T	5	3	8	0	1	9	0	0
10	21802959	.	T	C	2	3	5	0	0	5	0	0
10	21818916	.	C	T	27	20	47	0	3	50	0	0
10	21818978	.	G	T	30	20	50	0	5	56	1	0
10	21819019	.	G	A	1	29	30	0	22	52	0	0
10	21819038	.	C	A	21	32	53	0	3	56	0	0
10	21819105	.	G	T	20	29	49	0	3	52	0	0
10	21819214	.	G	C	27	25	52	0	3	55	0	0
10	21819506	.	G	A	23	4	27	0	2	29	0	0
10	21819653	.	T	C	31	39	70	0	1	71	0	0
10	21819966	.	A	T	14	4	18	0	2	20	0	0
10	22003847	.	T	C	4	2	6	0	1	7	0	0
10	22012534	.	G	A	6	4	10	0	0	10	0	0
10	22030798	.	C	T	7	8	15	0	0	15	0	0
10	22030827	.	G	A	13	13	26	0	2	28	0	0
10	22030887	.	T	G	18	16	34	0	0	34	0	0
10	22030985	.	T	C	18	20	38	0	0	38	0	0
10	22030986	.	C	T	17	20	37	0	1	38	0	0
10	22031034	.	C	T	21	21	42	0	2	44	0	0
10	22031375	.	A	C	21	22	43	0	1	45	1	0
10	22031805	.	G	C	11	22	33	0	5	38	0	0
10	22031806	.	G	A	12	25	37	0	1	38	0	0
10	22031854	.	G	A	17	9	26	0	1	27	0	0
10	22035638	.	A	G	0	1	1	0	0	1	0	0
10	22036169	.	A	G	0	1	1	0	0	1	0	0
10	22041546	.	C	T	4	2	6	0	0	6	0	0
10	22041717	.	T	C	0	1	1	0	0	1	0	0
10	22044982	.	C	T	4	6	10	0	0	10	0	0
10	22045014	.	G	T	2	6	8	0	1	9	0	0
10	22051201	.	A	T	4	2	6	0	0	6	0	0
10	22051436	.	A	G	6	2	8	0	0	8	0	0
10	22051465	.	G	C	3	4	7	0	0	7	0	0
10	22051474	.	A	C	5	3	8	0	0	8	0	0
10	22051548	.	C	T	0	2	2	0	3	5	0	0
10	22051933	.	A	G	2	2	4	0	0	4	0	0
10	22052133	.	T	C	4	3	7	0	0	7	0	0
10	22052361	.	C	T	0	3	3	0	3	6	0	0
10	22054106	.	G	A	3	2	5	0	0	5	0	0
10	22054149	.	T	C	1	2	3	0	0	3	0	0
10	22054158	.	A	G	1	2	3	0	0	3	0	0
10	22162187	.	T	C	11	0	11	0	19	30	0	0
10	22162575	.	G	A	7	2	9	0	2	11	0	0
10	22162576	.	A	G	6	5	11	0	0	11	0	0
10	22162673	.	T	G	0	3	3	0	2	5	0	0
10	22163144	.	A	T	2	5	7	0	0	7	0	0
10	22163165	.	A	G	2	3	5	0	2	7	0	0
10	22163235	.	C	T	0	4	4	0	2	6	0	0
10	22163244	.	C	G	2	3	5	0	0	5	0	0
10	22163660	.	C	T	1	2	3	0	0	3	0	0
10	22163801	.	A	T	2	3	5	0	0	5	0	0
10	22163867	.	T	C	3	3	6	0	0	6	0	0
10	22163928	.	C	A	2	3	5	0	0	5	0	0
10	22164421	.	T	A	1	4	5	0	1	6	0	0
10	22164621	.	T	G	1	2	3	0	0	3	0	0
10	22164622	.	G	A	1	2	3	0	0	3	0	0
10	22477952	.	A	T	1	3	4	0	0	4	0	0
10	22530812	.	T	C	2	5	7	0	0	7	0	0
10	22531946	.	T	G	11	6	17	0	0	17	0	0
10	22532139	.	C	T	8	7	15	0	3	18	0	0
10	22532211	.	G	A	4	7	11	0	4	15	0	0
10	22532287	.	T	A	17	8	25	0	0	25	0	0
10	22532918	.	A	T	9	9	18	0	3	21	0	0
10	22747995	.	T	C	1	4	5	0	2	7	0	0
10	22748201	.	G	T	1	2	3	0	0	3	0	0
10	22782648	.	A	C	11	3	14	0	4	18	0	0
10	22785632	.	C	T	1	3	4	0	0	4	0	0
10	22785820	.	C	A	8	3	11	0	1	12	0	0
10	22785983	.	C	T	10	8	18	0	1	19	0	0
10	22786044	.	C	A	17	10	27	0	0	27	0	0
10	22786054	.	A	G	15	10	25	0	0	25	0	0
10	22786227	.	C	T	5	10	15	0	0	15	0	0
10	22786281	.	G	A	1	2	3	0	0	3	0	0
10	22811197	.	C	T	5	2	7	0	0	7	0	0
10	22811322	.	T	C	3	1	4	0	0	4	0	0
10	22811542	.	A	G	5	3	8	0	1	9	0	0
10	22811596	.	C	T	4	5	9	0	0	9	0	0
10	22811633	.	C	T	3	4	7	0	0	7	0	0
10	22812056	.	A	T	2	2	4	0	0	4	0	0
10	22845286	.	C	A	2	3	5	0	2	7	0	0
10	22858361	.	T	C	0	0	0	0	1	1	0	0
10	22906434	.	C	T	0	1	1	0	1	2	0	0
10	22906783	.	T	C	5	14	19	0	3	22	0	0
10	22907242	.	A	T	9	8	17	0	5	22	0	0
10	22907330	.	G	A	3	5	8	0	0	8	0	0
10	22912540	.	A	G	0	1	1	0	1	2	0	0
10	22912547	.	C	T	1	1	2	0	0	2	0	0
10	22915421	.	C	G	0	1	1	0	0	1	0	0
10	22915777	.	T	C	4	8	12	0	0	12	0	0
10	22916422	.	A	C	13	36	49	0	4	53	0	0
10	22916426	.	T	A	14	34	48	0	3	51	0	0
10	22916490	.	G	A	9	26	35	0	0	35	0	0
10	22916520	.	T	C	14	20	34	0	2	36	0	0
10	22916661	.	G	C	35	15	50	0	1	51	0	0
10	22916664	.	C	T	31	15	46	0	5	51	0	0
10	22916730	.	A	G	24	12	36	0	2	38	0	0
10	22916739	.	G	A	22	11	33	0	1	34	0	0
10	22918122	.	A	T	24	21	45	0	1	46	0	0
10	22918124	.	A	C	24	0	24	0	22	46	0	0
10	22918164	.	T	C	10	19	29	0	2	31	0	0
10	22918174	.	G	A	10	13	23	0	1	24	0	0
10	23024360	.	C	T	1	4	5	0	0	5	0	0
10	23024405	.	T	C	1	5	6	0	0	6	0	0
10	23024584	.	A	C	3	2	5	0	0	5	0	0
10	23024660	.	A	G	2	4	6	0	0	6	0	0
10	23024708	.	T	C	2	7	9	0	0	9	0	0
10	23024762	.	A	G	6	4	10	0	0	10	0	0
10	23026025	.	T	C	17	10	27	0	1	28	0	0
10	23065084	.	G	A	2	1	3	0	0	3	0	0
10	23065247	.	T	C	0	1	1	0	1	2	0	0
10	23065295	.	C	T	0	2	2	0	0	2	0	0
10	23065777	.	T	C	2	1	3	0	1	4	0	0
10	23068630	.	A	G	9	8	17	0	1	18	0	0
10	23068962	.	A	G	13	11	24	0	0	24	0	0
10	23068963	.	C	T	13	11	24	0	0	24	0	0
10	23069068	.	C	T	8	11	19	0	2	21	0	0
10	23069120	.	T	C	5	4	9	0	1	10	0	0
10	23069253	.	T	C	4	5	9	0	0	9	0	0
10	23071697	.	G	A	2	3	5	0	0	5	0	0
10	23071705	.	G	C	1	1	2	0	1	3	0	0
10	23076290	.	A	G	1	2	3	0	0	3	0	0
10	23135655	.	C	T	2	3	5	0	0	5	0	0
10	23138428	.	G	A	0	6	6	0	5	12	1	0
10	23138641	.	G	A	2	2	4	0	0	4	0	0
10	23139845	.	A	G	10	3	13	0	0	13	0	0
10	23139846	.	A	G	9	4	13	0	0	13	0	0
10	23139994	.	G	A	0	1	1	0	3	4	0	0
10	23139997	.	G	A	2	2	4	0	1	5	0	0
10	23220530	.	T	A	1	1	2	0	0	2	0	0
10	24296626	.	T	C	1	2	3	0	0	3	0	0
10	24324014	.	G	T	10	6	16	0	2	18	0	0
10	24326236	.	C	T	3	2	5	0	0	5	0	0
10	24326242	.	C	T	2	5	7	0	0	7	0	0
10	24334810	.	G	A	1	0	1	0	1	2	0	0
10	24335402	.	C	T	1	0	1	0	0	1	0	0
10	24373239	.	C	A	2	2	4	0	1	5	0	0
10	24373255	.	C	T	3	2	5	0	0	5	0	0
10	24373647	.	C	T	0	2	2	0	0	2	0	0
10	24373657	.	A	C	0	2	2	0	0	2	0	0
10	24373701	.	A	T	5	1	6	0	0	6	0	0
10	24373721	.	G	T	4	2	6	0	0	6	0	0
10	24426038	.	A	T	1	2	3	0	1	4	0	0
10	24429342	.	T	C	4	2	6	0	0	6	0	0
10	24429357	.	T	C	1	4	5	0	0	5	0	0
10	24431479	.	C	T	7	2	9	0	1	10	0	0
10	24439753	.	T	A	1	2	3	0	0	3	0	0
10	24441916	.	C	T	13	7	20	0	0	20	0	0
10	24563892	.	T	G	1	2	3	0	0	3	0	0
10	24564040	.	T	C	2	2	4	0	1	5	0	0
10	24566124	.	T	C	2	2	4	0	0	4	0	0
10	24617156	.	G	A	1	0	1	0	0	1	0	0
10	24621543	.	G	A	1	2	3	0	1	4	0	0
10	24649813	.	T	G	5	8	13	0	0	13	0	0
10	24650194	.	A	G	2	3	5	0	0	5	0	0
10	24650889	.	T	A	2	3	5	0	1	6	0	0
10	24653833	.	G	A	1	2	3	0	0	3	0	0
10	24654319	.	A	C	3	3	6	0	0	6	0	0
10	24677119	.	A	G	6	5	11	0	0	11	0	0
10	24677136	.	T	G	4	7	11	0	0	11	0	0
10	24677227	.	G	A	2	3	5	0	1	6	0	0
10	24677253	.	T	A	3	2	5	0	0	5	0	0
10	24726302	.	A	G	1	2	3	0	0	3	0	0
10	24762377	.	G	A	9	3	12	0	0	12	0	0
10	24762427	.	C	T	2	10	12	0	1	13	0	0
10	24762510	.	A	G	13	5	18	0	0	18	0	0
10	24762579	.	T	C	2	0	2	0	5	7	0	0
10	24762589	.	G	A	2	5	7	0	0	7	0	0
10	24762759	.	T	A	2	8	10	0	1	11	0	0
10	24762774	.	T	G	2	6	8	0	0	8	0	0
10	24765589	.	A	C	0	1	1	0	0	1	0	0
10	25268086	.	C	A	1	2	3	0	0	3	0	0
10	25268087	.	C	T	1	2	3	0	0	3	0	0
10	25269325	.	T	G	4	2	6	0	1	7	0	0
10	25269413	.	A	G	5	4	9	0	0	9	0	0
10	25269530	.	T	A	5	1	6	0	1	7	0	0
10	25269742	.	C	T	10	6	16	0	3	19	0	0
10	25269946	.	G	A	1	6	7	0	14	21	0	0
10	25269952	.	C	T	8	5	13	0	6	19	0	0
10	25269983	.	A	G	10	4	14	0	3	17	0	0
10	25270125	.	A	G	16	4	20	0	0	20	0	0
10	25270395	.	A	G	8	10	18	0	0	18	0	0
10	25270470	.	A	G	4	6	10	0	2	12	0	0
10	25270471	.	A	G	5	7	12	0	0	12	0	0
10	25270618	.	C	G	8	14	22	0	1	23	0	0
10	25270803	.	A	T	15	13	28	0	3	31	0	0
10	25270942	.	G	C	13	18	31	0	2	33	0	0
10	25271051	.	T	A	14	17	31	0	2	33	0	0
10	25271121	.	G	A	18	26	44	0	1	45	0	0
10	25271338	.	T	C	7	18	25	0	2	27	0	0
10	25312828	.	T	G	9	7	16	0	2	18	0	0
10	25329587	.	G	A	2	1	3	0	0	3	0	0
10	25329648	.	G	T	8	10	18	1	11	30	0	0
10	25329649	.	A	T	16	11	27	1	2	30	0	0
10	25330646	.	G	A	11	18	29	0	1	30	0	0
10	25333961	.	C	T	0	0	0	0	2	2	0	0
10	25334178	.	T	C	8	5	13	0	0	13	0	0
10	25336095	.	G	A	2	1	3	0	1	4	0	0
10	25338585	.	C	G	1	0	1	0	0	1	0	0
10	25342889	.	A	G	6	4	10	0	1	11	0	0
10	25342915	.	A	T	5	4	9	0	0	9	0	0
10	26269728	.	G	A	3	5	8	0	0	8	0	0
10	26269842	.	T	C	4	2	6	0	0	6	0	0
10	26551492	.	A	G	1	1	2	0	0	2	0	0
10	26560260	.	C	T	4	5	9	0	0	9	0	0
10	26560366	.	G	A	0	1	1	0	3	4	0	0
10	26560392	.	C	A	4	2	6	0	0	6	0	0
10	26567127	.	G	A	0	3	3	0	9	12	0	0
10	26589072	.	C	T	1	2	3	0	0	3	0	0
10	26656240	.	C	T	2	1	3	0	0	3	0	0
10	26656500	.	G	A	8	6	14	0	0	14	0	0
10	26656527	.	A	G	11	6	17	0	0	17	0	0
10	26659245	.	C	T	7	1	8	0	1	9	0	0
10	26661469	.	T	C	4	5	9	0	0	9	0	0
10	26662046	.	G	A	6	3	9	0	0	9	0	0
10	26666823	.	C	T	14	10	24	0	1	25	0	0
10	26717156	.	T	A	15	16	31	0	3	34	0	0
10	26717237	.	C	T	12	12	24	0	4	28	0	0
10	26717582	.	T	A	5	10	15	0	2	17	0	0
10	26717687	.	G	A	6	11	17	0	3	20	0	0
10	26717783	.	A	G	7	9	16	0	2	18	0	0
10	26717954	.	G	T	5	1	6	0	0	6	0	0
10	26717963	.	G	A	1	3	4	0	0	4	0	0
10	26723422	.	C	T	0	4	4	0	3	7	0	0
10	26762944	.	T	C	2	2	4	0	1	5	0	0
10	26765526	.	T	C	0	2	2	0	0	2	0	0
10	26766154	.	C	T	2	2	4	0	0	4	0	0
10	26811039	.	G	A	4	2	6	0	0	6	0	0
10	26811046	.	A	T	3	2	5	0	0	5	0	0
10	26811229	.	C	T	2	3	5	0	0	5	0	0
10	26831923	.	G	A	4	5	9	0	1	10	0	0
10	26831965	.	G	T	10	5	15	0	3	18	0	0
10	26835066	.	A	C	1	3	4	0	0	4	0	0
10	26835316	.	G	C	4	2	6	0	0	6	0	0
10	26835389	.	A	T	2	2	4	0	0	4	0	0
10	26926741	.	A	G	7	6	13	0	0	13	0	0
10	26929459	.	C	T	6	2	8	0	0	8	0	0
10	26932632	.	C	T	8	12	20	0	1	21	0	0
10	26958470	.	G	C	1	2	3	0	0	3	0	0
10	26959662	.	T	G	1	1	2	0	0	2	0	0
10	26959744	.	G	A	1	5	6	0	0	6	0	0
10	26960212	.	A	T	1	6	7	0	0	7	0	0
10	26969077	.	G	T	0	4	4	0	4	8	0	0
10	26971300	.	T	A	2	1	3	0	0	3	0	0
10	26971782	.	C	T	1	2	3	0	0	3	0	0
10	26971982	.	C	T	7	1	8	0	0	8	0	0
10	26972009	.	T	C	8	3	11	0	1	12	0	0
10	26972018	.	C	T	9	4	13	0	0	13	0	0
10	26972409	.	G	A	6	6	12	0	0	12	0	0
10	26972429	.	A	T	2	5	7	0	0	7	0	0
10	26973406	.	C	T	2	2	4	0	1	5	0	0
10	26974414	.	T	C	0	1	1	0	0	1	0	0
10	26976990	.	G	A	1	3	4	0	1	5	0	0
10	26977132	.	G	T	0	1	1	0	1	2	0	0
10	26977154	.	G	A	0	0	0	0	2	2	0	0
10	26978031	.	C	T	2	1	3	0	0	3	0	0
10	26978271	.	C	T	1	2	3	0	0	3	0	0
10	26982572	.	C	G	4	2	6	0	0	6	0	0
10	26982786	.	C	T	0	2	2	0	1	3	0	0
10	26990140	.	C	G	1	2	3	0	0	3	0	0
10	26990333	.	G	C	1	0	1	0	0	1	0	0
10	26991514	.	C	T	4	7	11	0	1	12	0	0
10	26991917	.	A	G	1	8	9	0	0	9	0	0
10	26997147	.	C	A	5	3	8	0	0	8	0	0
10	26997218	.	G	A	6	6	12	0	2	14	0	0
10	26997222	.	A	T	8	7	15	0	1	16	0	0
10	26999102	.	C	T	0	8	8	0	4	12	0	0
10	26999359	.	T	C	12	11	23	0	4	27	0	0
10	26999360	.	T	A	14	12	26	0	1	27	0	0
10	27006447	.	T	C	15	15	30	0	1	31	0	0
10	27006490	.	A	G	15	9	24	0	1	25	0	0
10	27028146	.	A	G	15	17	32	0	3	35	0	0
10	27028334	.	G	T	13	5	18	0	2	20	0	0
10	27028346	.	A	G	15	4	19	0	2	21	0	0
10	27046400	.	T	A	3	5	8	0	1	9	0	0
10	27058678	.	G	A	3	2	5	0	1	6	0	0
10	27058740	.	C	A	3	4	7	0	0	7	0	0
10	27058756	.	A	T	3	4	7	0	0	7	0	0
10	27091930	.	C	T	2	2	4	0	0	4	0	0
10	27183328	.	T	G	14	7	21	0	6	27	0	0
10	27183580	.	T	C	7	0	7	0	10	17	0	0
10	27183685	.	A	T	6	11	17	0	2	19	0	0
10	27184069	.	G	A	12	14	26	0	0	26	0	0
10	27184237	.	A	G	14	6	20	0	0	20	0	0
10	27184351	.	C	T	5	6	11	0	3	14	0	0
10	27184384	.	C	T	5	7	12	0	0	12	0	0
10	27184789	.	G	A	2	5	7	0	0	7	0	0
10	27185104	.	G	A	3	3	6	0	0	6	0	0
10	27185134	.	A	G	1	2	3	0	0	3	0	0
10	27977579	.	A	G	2	2	4	0	0	4	0	0
10	27977673	.	C	T	5	3	8	0	0	8	0	0
10	27978002	.	A	T	2	6	8	0	0	8	0	0
10	27978055	.	T	C	2	4	6	0	0	6	0	0
10	27978084	.	T	A	2	2	4	0	0	4	0	0
10	28029950	.	T	G	0	3	3	0	1	4	0	0
10	28029970	.	A	C	3	3	6	0	0	6	0	0
10	28030753	.	A	G	14	6	20	0	0	20	0	0
10	28030843	.	C	T	6	14	20	0	0	20	0	0
10	28036119	.	G	A	4	3	7	0	0	7	0	0
10	28036370	.	G	A	7	6	13	0	2	15	0	0
10	28038008	.	A	G	2	2	4	0	0	4	0	0
10	28038926	.	G	A	2	3	5	0	1	6	0	0
10	28168295	.	C	G	1	2	3	0	0	3	0	0
10	28172354	.	C	T	0	2	2	0	1	3	0	0
10	28172501	.	T	G	1	2	3	0	0	3	0	0
10	28172672	.	A	C	1	2	3	0	0	3	0	0
10	28308799	.	C	T	4	3	7	0	0	7	0	0
10	28308865	.	A	T	3	4	7	0	0	7	0	0
10	28308886	.	A	G	2	3	5	0	0	5	0	0
10	28311301	.	C	T	27	15	42	0	2	44	0	0
10	28311553	.	G	T	23	11	34	0	5	39	0	0
10	28312156	.	T	A	28	19	47	0	2	49	0	0
10	28315096	.	A	G	8	16	24	0	0	24	0	0
10	28315149	.	G	A	8	9	17	0	1	18	0	0
10	28319552	.	G	A	0	5	5	0	1	6	0	0
10	28320381	.	A	G	0	2	2	0	0	2	0	0
10	28323048	.	T	G	1	1	2	0	1	3	0	0
10	28323054	.	A	G	1	2	3	0	0	3	0	0
10	28371045	.	A	G	1	4	5	0	0	5	0	0
10	28371284	.	G	A	13	13	26	0	3	29	0	0
10	28371407	.	C	T	0	5	5	0	9	14	0	0
10	28376814	.	T	C	2	0	2	0	5	7	0	0
10	28376895	.	C	T	5	4	9	0	0	9	0	0
10	32265259	.	C	T	1	5	6	0	0	6	0	0
10	32265331	.	A	C	1	2	3	0	0	3	0	0
10	32463473	.	A	G	1	0	1	0	0	1	0	0
10	32463497	.	C	T	0	0	0	0	1	1	0	0
10	32561615	.	C	G	1	5	6	0	0	6	0	0
10	32562267	.	C	T	3	5	8	0	2	10	0	0
10	32577621	.	G	A	8	6	14	0	0	14	0	0
10	32581221	.	G	A	15	10	25	0	1	26	0	0
10	32600809	.	A	G	17	0	17	0	7	24	0	0
10	32600810	.	T	C	16	7	23	0	1	24	0	0
10	32600927	.	C	T	23	29	52	0	4	56	0	0
10	32657586	.	A	G	3	2	5	0	0	5	0	0
10	32657591	.	C	A	2	4	6	0	0	6	0	0
10	32657893	.	G	A	13	9	22	0	1	23	0	0
10	32657980	.	A	G	8	9	17	0	0	17	0	0
10	32665098	.	C	T	1	1	2	0	0	2	0	0
10	32809986	.	G	C	13	14	27	0	1	28	0	0
10	32810279	.	T	A	6	6	12	0	2	14	0	0
10	32810340	.	A	T	10	9	19	0	0	19	0	0
10	32810593	.	A	T	5	3	8	0	0	8	0	0
10	32811010	.	C	T	0	4	4	0	6	10	0	0
10	32811102	.	T	A	2	4	6	0	0	6	0	0
10	32817924	.	C	A	0	2	2	0	2	4	0	0
10	32820577	.	T	C	3	1	4	0	1	5	0	0
10	32857386	.	C	T	5	24	29	0	1	30	0	0
10	32857478	.	T	C	2	11	13	1	2	16	0	0
10	32857557	.	T	C	6	7	13	0	1	14	0	0
10	32857738	.	A	G	4	10	14	0	2	16	0	0
10	32857898	.	C	T	4	3	7	0	0	7	0	0
10	32857948	.	T	G	6	3	9	0	0	9	0	0
10	32858020	.	C	T	6	5	11	0	0	11	0	0
10	32858023	.	C	T	6	6	12	0	0	12	0	0
10	32858107	.	A	G	2	7	9	0	0	9	0	0
10	32858158	.	C	G	5	5	10	0	1	11	0	0
10	32858215	.	T	A	3	8	11	0	1	12	0	0
10	32858361	.	T	C	5	8	13	0	1	14	0	0
10	32858425	.	G	C	7	6	13	0	0	13	0	0
10	32858607	.	C	T	5	5	10	0	2	12	0	0
10	32858612	.	T	A	4	4	8	0	2	10	0	0
10	32858642	.	G	C	3	7	10	0	1	11	0	0
10	32861106	.	G	A	1	6	7	0	0	7	0	0
10	32861118	.	T	G	1	4	5	0	1	6	0	0
10	32881787	.	C	T	0	20	20	0	15	36	1	0
10	32881823	.	G	A	10	20	30	0	7	37	0	0
10	32881884	.	C	T	15	14	29	0	2	31	0	0
10	32881904	.	A	G	13	15	28	0	4	32	0	0
10	32882022	.	A	G	5	4	9	0	0	9	0	0
10	32882056	.	G	A	7	9	16	0	0	17	1	0
10	32882080	.	A	T	5	11	16	0	1	17	0	0
10	32882156	.	T	G	13	18	31	0	4	35	0	0
10	32882495	.	T	C	2	7	9	0	0	9	0	0
10	32882515	.	C	T	0	8	8	0	0	8	0	0
10	32882683	.	G	T	7	13	20	0	0	20	0	0
10	32882686	.	A	T	7	13	20	0	0	20	0	0
10	32882732	.	C	A	8	11	19	0	1	20	0	0
10	32882977	.	C	A	0	3	3	0	10	13	0	0
10	32899276	.	T	A	12	10	22	0	1	23	0	0
10	32899807	.	T	C	4	0	4	0	0	4	0	0
10	32899986	.	T	G	9	5	14	0	0	14	0	0
10	32899988	.	T	C	9	0	9	0	5	14	0	0
10	32900021	.	T	C	7	2	9	0	0	9	0	0
10	32900469	.	T	G	3	3	6	0	0	6	0	0
10	32900642	.	A	T	2	6	8	0	0	8	0	0
10	32901915	.	A	T	1	2	3	0	0	3	0	0
10	33244455	.	G	A	0	2	2	0	1	3	0	0
10	33244848	.	C	A	0	2	2	0	0	2	0	0
10	33254786	.	C	G	5	6	11	0	0	11	0	0
10	33254930	.	G	A	4	5	9	0	1	10	0	0
10	33368774	.	G	A	3	1	4	0	1	5	0	0
10	33370284	.	A	G	2	2	4	0	0	4	0	0
10	33373568	.	C	G	0	2	2	0	6	8	0	0
10	33385363	.	G	A	10	10	20	0	1	21	0	0
10	33386316	.	G	A	6	4	10	0	0	10	0	0
10	33392111	.	T	C	16	8	24	0	0	24	0	0
10	33392199	.	A	G	4	14	18	0	0	18	0	0
10	33392263	.	A	G	11	19	30	0	1	31	0	0
10	33392396	.	T	G	16	8	24	0	1	25	0	0
10	33393129	.	A	T	2	2	4	0	0	4	0	0
10	33576509	.	T	C	3	3	6	0	0	6	0	0
10	33576518	.	T	C	3	3	6	0	0	6	0	0
10	33577656	.	A	G	3	0	3	0	0	3	0	0
10	33578719	.	A	T	2	2	4	0	1	5	0	0
10	33578981	.	T	G	3	9	12	0	0	12	0	0
10	33579037	.	C	T	1	2	3	0	0	3	0	0
10	33698487	.	G	C	1	1	2	0	0	2	0	0
10	33866987	.	T	A	6	6	12	0	1	13	0	0
10	33867032	.	G	A	5	4	9	0	0	9	0	0
10	33867160	.	G	A	0	3	3	0	5	8	0	0
10	33867394	.	G	A	5	7	12	0	0	12	0	0
10	33982165	.	G	A	1	2	3	0	1	4	0	0
10	33983870	.	A	G	1	0	1	0	0	1	0	0
10	33989820	.	G	A	3	0	3	0	2	5	0	0
10	33990957	.	C	T	3	2	5	0	0	5	0	0
10	33994475	.	C	T	5	6	11	0	0	11	0	0
10	33997759	.	A	T	24	21	45	0	5	50	0	0
10	33997970	.	T	C	11	13	24	0	2	26	0	0
10	33998010	.	C	T	14	21	35	0	0	35	0	0
10	33998106	.	G	C	4	3	7	0	0	7	0	0
10	34023841	.	T	C	1	3	4	0	0	4	0	0
10	34025104	.	C	T	2	3	5	0	0	5	0	0
10	34402852	.	A	G	2	3	5	0	0	5	0	0
10	34403349	.	C	G	5	6	11	0	0	11	0	0
10	34403615	.	A	G	1	3	4	0	0	4	0	0
10	34403668	.	A	T	9	5	14	0	0	14	0	0
10	34403965	.	A	T	5	6	11	0	0	11	0	0
10	34404015	.	G	A	2	2	4	0	0	4	0	0
10	34404028	.	T	G	2	3	5	0	0	5	0	0
10	34404149	.	G	A	0	3	3	0	2	5	0	0
10	34404158	.	T	A	2	1	3	0	2	5	0	0
10	34404552	.	T	G	14	12	26	0	2	28	0	0
10	34714789	.	C	T	2	3	5	0	0	5	0	0
10	34731660	.	C	T	10	12	22	0	2	24	0	0
10	34734714	.	A	T	15	31	46	0	6	52	0	0
10	34734743	.	T	G	16	25	41	0	6	47	0	0
10	34734784	.	G	T	0	18	18	0	26	44	0	0
10	34737599	.	G	A	25	19	44	0	4	48	0	0
10	34737919	.	T	C	24	13	37	0	2	39	0	0
10	34737959	.	G	A	17	15	32	0	5	37	0	0
10	34738213	.	C	T	1	20	21	0	28	49	0	0
10	34738378	.	T	G	5	13	18	0	3	21	0	0
10	34743910	.	G	A	1	1	2	0	0	2	0	0
10	34768261	.	T	C	0	2	2	0	1	3	0	0
10	34768418	.	G	A	2	2	4	0	0	4	0	0
10	34961244	.	G	T	15	7	22	0	0	22	0	0
10	34961309	.	A	G	7	3	10	0	4	14	0	0
10	34961311	.	T	C	7	6	13	0	1	14	0	0
10	34961403	.	T	C	4	2	6	0	0	6	0	0
10	34961405	.	C	T	4	2	6	0	0	6	0	0
10	34961480	.	C	A	3	3	6	0	0	6	0	0
10	34961669	.	A	G	8	8	16	0	1	17	0	0
10	34989149	.	T	C	8	0	8	0	11	19	0	0
10	34992565	.	A	G	0	1	1	0	0	1	0	0
10	35006385	.	C	T	0	1	1	0	0	1	0	0
10	35008963	.	C	T	1	1	2	0	0	2	0	0
10	35011337	.	A	G	3	6	9	0	0	9	0	0
10	35156268	.	C	T	1	1	2	0	0	2	0	0
10	35156473	.	C	T	1	1	2	0	0	2	0	0
10	35156485	.	A	C	1	1	2	0	0	2	0	0
10	35163358	.	T	A	0	4	4	0	0	4	0	0
10	35163406	.	G	A	5	6	11	0	3	14	0	0
10	35302425	.	T	C	0	0	0	0	1	1	0	0
10	35304014	.	C	T	4	3	7	0	1	8	0	0
10	35304323	.	G	A	1	0	1	0	0	1	0	0
10	35304332	.	C	T	1	0	1	0	0	1	0	0
10	35311926	.	C	G	7	13	20	0	1	21	0	0
10	35312021	.	A	C	5	8	13	0	1	14	0	0
10	35312143	.	A	G	1	0	1	0	6	7	0	0
10	35312190	.	A	G	6	5	11	0	1	12	0	0
10	35312253	.	C	T	4	10	14	0	0	14	0	0
10	35312682	.	C	G	5	6	11	0	1	12	0	0
10	35538879	.	T	A	12	8	20	0	1	21	0	0
10	35539607	.	A	G	5	4	9	0	0	9	0	0
10	35539631	.	G	A	4	6	10	0	0	10	0	0
10	35540422	.	T	A	3	4	7	0	1	8	0	0
10	35540603	.	C	T	1	4	5	0	3	8	0	0
10	35540675	.	T	G	6	3	9	0	0	9	0	0
10	35540705	.	T	A	5	5	10	0	0	10	0	0
10	35540732	.	T	G	2	4	6	0	0	6	0	0
10	35540847	.	T	G	1	2	3	0	0	3	0	0
10	35584806	.	T	G	14	4	18	0	2	20	0	0
10	35584815	.	A	G	10	3	13	0	2	15	0	0
10	35584855	.	T	A	4	6	10	0	1	11	0	0
10	35585057	.	A	T	3	3	6	0	0	6	0	0
10	35585195	.	G	A	4	7	11	0	1	12	0	0
10	35585197	.	A	G	5	6	11	0	1	12	0	0
10	35585284	.	C	T	1	5	6	0	9	15	0	0
10	35590076	.	T	A	1	0	1	0	0	1	0	0
10	35595653	.	C	T	1	0	1	0	0	1	0	0
10	35602678	.	G	A	2	3	5	0	0	5	0	0
10	35606506	.	C	A	1	3	4	0	0	4	0	0
10	35654268	.	C	T	8	21	29	0	2	31	0	0
10	35654290	.	A	C	8	14	22	0	9	31	0	0
10	35654305	.	T	C	12	14	26	0	4	30	0	0
10	35664612	.	G	A	1	2	3	0	0	3	0	0
10	36029893	.	T	C	15	4	19	0	1	20	0	0
10	36031316	.	C	A	2	3	5	0	0	5	0	0
10	36054226	.	C	T	3	2	5	0	1	6	0	0
10	36096022	.	T	A	0	1	1	0	0	1	0	0
10	36105097	.	G	T	1	2	3	0	0	3	0	0
10	36199990	.	T	G	1	2	3	0	0	3	0	0
10	36363557	.	A	G	13	9	22	0	1	23	0	0
10	36363611	.	C	T	19	16	35	0	3	38	0	0
10	36363818	.	G	T	1	7	8	0	0	8	0	0
10	36363937	.	G	A	16	17	33	0	2	35	0	0
10	36363971	.	C	T	0	16	16	0	17	33	0	0
10	36364172	.	A	G	13	12	25	0	2	27	0	0
10	36405921	.	C	T	5	6	11	0	1	12	0	0
10	36406039	.	G	T	2	3	5	0	0	5	0	0
10	36406210	.	G	A	2	3	5	0	0	5	0	0
10	36443018	.	T	C	1	5	6	0	0	6	0	0
10	36443541	.	T	C	7	9	16	0	1	17	0	0
10	36443676	.	G	A	1	6	7	0	5	12	0	0
10	36443714	.	G	A	4	7	11	0	0	11	0	0
10	36446799	.	A	T	1	1	2	0	0	2	0	0
10	36451615	.	T	C	2	1	3	0	0	3	0	0
10	36451661	.	G	A	5	10	15	0	3	18	0	0
10	36454567	.	C	A	10	12	22	0	0	22	0	0
10	36454649	.	A	G	15	0	15	0	14	29	0	0
10	36454650	.	C	A	18	10	28	0	1	29	0	0
10	36454902	.	G	T	13	16	29	0	3	32	0	0
10	36455146	.	C	T	16	13	29	0	2	31	0	0
10	36455215	.	T	C	11	18	29	0	1	30	0	0
10	36455229	.	C	G	12	20	32	0	1	33	0	0
10	36455344	.	A	G	14	20	34	0	4	38	0	0
10	36455847	.	G	A	0	4	4	0	6	10	0	0
10	36476481	.	C	T	0	17	17	0	18	35	0	0
10	36476529	.	C	T	13	10	23	0	1	24	0	0
10	36476639	.	C	T	0	14	14	0	11	25	0	0
10	36476717	.	A	G	12	14	26	0	0	26	0	0
10	36476834	.	G	A	11	17	28	0	1	29	0	0
10	36476852	.	A	G	13	11	24	0	3	27	0	0
10	36476922	.	C	T	1	0	1	0	0	1	0	0
10	36481915	.	A	C	4	9	13	0	1	14	0	0
10	36482588	.	G	A	9	5	14	0	1	15	0	0
10	36487530	.	G	A	3	2	5	0	0	5	0	0
10	36489882	.	A	G	1	0	1	0	1	2	0	0
10	36489893	.	A	G	2	2	4	0	0	4	0	0
10	36496595	.	G	A	1	0	1	0	0	1	0	0
10	36498379	.	C	T	0	1	1	0	1	2	0	0
10	36498397	.	G	A	0	2	2	0	0	2	0	0
10	36520945	.	A	G	1	2	3	0	0	3	0	0
10	36613095	.	T	C	2	3	5	0	0	5	0	0
10	36613145	.	G	T	3	4	7	0	1	8	0	0
10	36613276	.	C	T	3	4	7	0	0	7	0	0
10	36615367	.	G	A	0	1	1	0	0	1	0	0
10	36618435	.	C	T	0	3	3	0	2	5	0	0
10	36625258	.	C	A	0	3	3	0	4	7	0	0
10	36625602	.	C	G	2	3	5	0	1	6	0	0
10	36627414	.	C	A	2	2	4	0	0	4	0	0
10	36627657	.	A	C	1	3	4	0	1	5	0	0
10	36670116	.	A	T	0	1	1	0	0	1	0	0
10	36679577	.	C	A	0	2	2	0	1	3	0	0
10	36688455	.	C	T	1	1	2	0	0	2	0	0
10	36695781	.	G	C	3	2	5	0	0	5	0	0
10	36695785	.	C	T	3	2	5	0	0	5	0	0
10	36704842	.	A	G	4	5	9	0	0	9	0	0
10	36708453	.	C	T	2	3	5	0	0	5	0	0
10	36710559	.	A	C	3	9	12	0	1	13	0	0
10	36710599	.	C	T	6	7	13	0	3	16	0	0
10	36710871	.	G	A	0	10	10	0	15	25	0	0
10	36710893	.	G	T	0	10	10	0	12	22	0	0
10	36711260	.	T	A	2	3	5	0	0	5	0	0
10	36711329	.	T	A	2	4	6	0	2	8	0	0
10	36711613	.	C	T	12	9	21	0	0	21	0	0
10	36796131	.	T	A	2	2	4	0	0	4	0	0
10	36800465	.	G	A	4	2	6	0	0	6	0	0
10	36800518	.	C	T	5	2	7	0	1	8	0	0
10	36811815	.	A	G	4	13	17	0	0	17	0	0
10	36812214	.	A	C	6	2	8	0	0	8	0	0
10	36814912	.	G	A	2	2	4	0	0	4	0	0
10	36817355	.	C	T	0	2	2	0	1	3	0	0
10	36817530	.	C	T	3	3	6	0	0	6	0	0
10	36817940	.	T	C	1	2	3	0	0	3	0	0
10	36820736	.	G	A	1	3	4	0	0	4	0	0
10	36820769	.	T	A	4	3	7	0	0	7	0	0
10	36828110	.	A	T	5	3	8	0	0	8	0	0
10	36828227	.	T	C	11	11	22	0	0	22	0	0
10	36828265	.	G	A	9	11	20	0	0	20	0	0
10	36828295	.	G	T	10	8	18	0	0	18	0	0
10	36828469	.	T	C	1	0	1	0	7	8	0	0
10	36828475	.	C	T	8	2	10	0	0	10	0	0
10	36835641	.	A	T	2	0	2	0	0	2	0	0
10	36835740	.	G	A	3	2	5	0	0	5	0	0
10	36848872	.	G	A	1	1	2	0	0	2	0	0
10	36848938	.	A	G	1	1	2	0	0	2	0	0
10	36950935	.	A	T	3	7	10	0	1	11	0	0
10	36951044	.	A	T	7	10	17	0	0	17	0	0
10	36951076	.	G	C	6	7	13	0	0	13	0	0
10	36951223	.	A	C	7	5	12	0	1	13	0	0
10	36951378	.	A	G	1	3	4	0	0	4	0	0
10	36951582	.	C	G	5	6	11	0	1	12	0	0
10	36951660	.	T	A	3	6	9	0	1	10	0	0
10	36963456	.	G	A	0	1	1	0	1	2	0	0
10	37152081	.	G	A	2	1	3	0	0	3	0	0
10	37167151	.	G	C	7	10	17	0	0	17	0	0
10	37394478	.	G	A	1	1	2	0	0	2	0	0
10	37394486	.	G	A	1	1	2	0	0	2	0	0
10	37764473	.	C	T	2	2	4	0	0	4	0	0
10	37783323	.	A	G	1	3	4	0	1	5	0	0
10	37997567	.	C	G	2	3	5	0	0	5	0	0
10	38003011	.	A	G	11	11	22	0	0	22	0	0
10	38005466	.	A	C	1	4	5	0	0	5	0	0
10	38008162	.	C	A	1	2	3	0	0	3	0	0
10	38041451	.	G	A	2	6	8	0	2	10	0	0
10	38149713	.	C	A	0	1	1	0	2	3	0	0
10	38149715	.	A	G	2	1	3	0	0	3	0	0
10	38170573	.	G	A	6	7	13	0	0	13	0	0
10	38170574	.	A	G	6	6	12	0	1	13	0	0
10	38170737	.	G	A	10	10	20	0	1	21	0	0
10	38171196	.	G	A	9	4	13	0	2	15	0	0
10	38171207	.	C	A	6	10	16	0	2	18	0	0
10	38171356	.	A	T	10	11	21	0	1	22	0	0
10	38171490	.	T	A	8	11	19	0	2	21	0	0
10	38173383	.	C	A	0	2	2	0	5	7	0	0
10	38177999	.	C	T	0	5	5	0	4	9	0	0
10	38180732	.	A	T	2	1	3	0	0	3	0	0
10	38257295	.	G	A	3	6	9	0	4	13	0	0
10	38257337	.	G	A	6	0	6	0	0	6	0	0
10	38257509	.	C	G	0	8	8	0	6	14	0	0
10	38257558	.	C	T	4	5	9	0	0	9	0	0
10	38257870	.	T	C	10	9	19	0	2	21	0	0
10	38258729	.	C	G	5	4	9	0	0	9	0	0
10	38695152	.	A	C	6	4	10	0	3	13	0	0
10	38695510	.	A	G	16	9	25	0	3	28	0	0
10	38695656	.	A	G	11	12	23	0	1	25	1	0
10	38695877	.	C	T	9	4	13	0	1	14	0	0
10	38695888	.	C	T	7	3	10	0	0	10	0	0
10	38723491	.	T	C	2	2	4	0	0	4	0	0
10	38723539	.	T	C	1	1	2	0	0	2	0	0
10	38922043	.	G	A	0	0	0	0	1	1	0	0
10	38934391	.	A	G	0	1	1	0	0	1	0	0
10	38937260	.	C	G	1	1	2	0	1	3	0	0
10	38937272	.	T	C	1	2	3	0	0	3	0	0
10	38943265	.	C	G	3	2	5	0	1	6	0	0
10	38950430	.	G	A	0	3	3	0	2	5	0	0
10	38950538	.	T	C	0	1	1	0	0	1	0	0
10	38954126	.	C	T	4	4	8	0	2	10	0	0
10	38954141	.	T	C	6	3	9	0	1	10	0	0
10	38954798	.	T	C	3	3	6	0	0	6	0	0
10	38954801	.	C	T	3	4	7	0	0	7	0	0
10	38957061	.	T	C	8	4	12	0	1	13	0	0
10	38957127	.	G	A	0	9	9	0	9	18	0	0
10	38957193	.	C	T	2	3	5	0	0	5	0	0
10	38957748	.	A	C	5	9	14	0	0	14	0	0
10	38957754	.	A	C	4	11	15	0	0	15	0	0
10	38969552	.	A	C	31	15	46	0	3	49	0	0
10	38969598	.	A	C	28	17	45	0	1	46	0	0
10	38969629	.	C	T	25	26	51	0	1	52	0	0
10	38969685	.	A	G	22	25	47	0	3	50	0	0
10	38969778	.	C	T	20	22	42	0	3	45	0	0
10	39011484	.	C	T	9	11	20	0	2	22	0	0
10	39086382	.	C	T	0	2	2	0	0	2	0	0
10	39086981	.	G	A	15	18	33	0	2	35	0	0
10	39087625	.	T	A	31	27	58	0	3	61	0	0
10	39087659	.	T	A	32	27	59	0	1	60	0	0
10	39102776	.	T	C	1	3	4	0	0	4	0	0
10	39110452	.	G	C	1	2	3	0	1	4	0	0
10	39115595	.	G	T	2	6	8	0	1	9	0	0
10	39115596	.	T	C	2	6	8	0	1	9	0	0
10	39120132	.	T	C	7	10	17	0	0	17	0	0
10	39130460	.	C	T	11	17	28	0	2	30	0	0
10	39182310	.	C	A	6	3	9	0	0	9	0	0
10	39182342	.	A	T	5	3	8	0	0	8	0	0
10	39182401	.	C	A	10	7	17	0	1	18	0	0
10	39182497	.	C	T	8	3	11	0	0	11	0	0
10	39182602	.	G	A	0	4	4	0	6	10	0	0
10	39182640	.	T	A	5	4	9	0	1	10	0	0
10	39182659	.	G	T	3	6	9	0	0	9	0	0
10	39182877	.	G	A	6	3	9	0	0	9	0	0
10	39216625	.	C	T	1	2	3	0	0	3	0	0
10	39222134	.	A	C	1	0	1	0	0	1	0	0
10	39222182	.	A	G	3	3	6	0	0	6	0	0
10	39225504	.	A	C	5	8	13	0	0	13	0	0
10	39225555	.	T	C	3	4	7	0	0	7	0	0
10	39231387	.	G	A	3	5	8	0	0	8	0	0
10	39293335	.	T	C	2	4	6	0	0	6	0	0
10	39293358	.	G	A	1	3	4	0	0	4	0	0
10	39294315	.	T	C	0	2	2	0	0	2	0	0
10	39294524	.	G	T	0	2	2	0	0	2	0	0
10	39294545	.	T	A	1	2	3	0	1	4	0	0
10	39294562	.	T	A	1	3	4	0	0	4	0	0
10	39307378	.	T	C	1	3	4	0	0	4	0	0
10	39904851	.	A	T	2	8	10	0	0	10	0	0
10	39904915	.	A	G	6	12	18	0	2	20	0	0
10	39904966	.	T	C	4	5	9	0	0	9	0	0
10	40111952	.	C	T	2	2	4	0	0	4	0	0
10	40111964	.	C	A	2	2	4	0	0	4	0	0
10	40112096	.	C	A	1	2	3	0	0	3	0	0
10	40112121	.	A	G	1	3	4	0	2	6	0	0
10	40112157	.	G	A	1	4	5	0	0	5	0	0
10	40112159	.	T	A	1	4	5	0	0	5	0	0
10	40112638	.	C	T	1	3	4	0	0	4	0	0
10	40113161	.	C	A	1	2	3	0	0	3	0	0
10	40113197	.	G	A	0	4	4	0	2	6	0	0
10	40113408	.	A	G	1	2	3	0	0	3	0	0
10	40303980	.	A	G	1	1	2	0	0	2	0	0
10	40307553	.	T	C	0	0	0	0	1	1	0	0
10	40307622	.	C	T	1	2	3	0	0	3	0	0
10	40314175	.	A	C	2	2	4	0	0	4	0	0
10	40314177	.	A	C	2	2	4	0	0	4	0	0
10	40826589	.	C	T	1	3	4	0	0	4	0	0
10	40826590	.	A	G	1	3	4	0	0	4	0	0
10	40859503	.	G	A	1	3	4	0	0	4	0	0
10	40859512	.	C	T	1	4	5	0	1	6	0	0
10	40859722	.	A	G	1	2	3	0	1	4	0	0
10	40859968	.	T	C	3	4	7	0	0	7	0	0
10	40861563	.	C	A	1	1	2	0	0	2	0	0
10	41837039	.	T	C	3	4	7	0	0	7	0	0
10	41837486	.	T	C	4	4	8	0	0	8	0	0
10	41837528	.	A	G	4	4	8	0	0	8	0	0
10	41841119	.	G	A	1	2	3	0	0	3	0	0
10	41841209	.	C	G	5	4	9	0	1	10	0	0
10	41841284	.	C	G	2	2	4	0	1	5	0	0
10	41841286	.	A	T	3	2	5	0	0	5	0	0
10	41846770	.	A	G	0	1	1	0	0	1	0	0
10	41983482	.	A	C	7	4	11	0	0	11	0	0
10	41983674	.	C	T	3	4	7	0	0	7	0	0
10	41983798	.	A	C	2	5	7	0	0	7	0	0
10	41983800	.	T	G	1	5	6	0	1	7	0	0
10	41985911	.	G	A	4	2	6	0	0	6	0	0
10	42020422	.	C	T	2	2	4	0	0	4	0	0
10	42020565	.	C	T	1	5	6	0	0	6	0	0
10	42021611	.	C	A	5	2	7	0	0	7	0	0
10	42022014	.	C	G	6	12	18	0	0	19	1	0
10	42022425	.	A	G	4	0	4	0	10	14	0	0
10	42044272	.	C	T	1	4	5	0	0	5	0	0
10	42044278	.	A	G	2	3	5	0	1	6	0	0
10	42044337	.	C	T	12	8	20	0	1	21	0	0
10	42044409	.	A	G	18	14	32	0	1	33	0	0
10	42044497	.	A	G	16	7	23	0	0	23	0	0
10	42044745	.	T	G	17	19	36	0	3	39	0	0
10	42044746	.	C	T	17	18	35	0	4	39	0	0
10	42044809	.	T	A	22	13	35	0	1	36	0	0
10	42044859	.	G	A	20	16	36	0	1	37	0	0
10	42045041	.	G	C	18	11	29	0	2	31	0	0
10	42045370	.	G	A	12	3	15	0	0	15	0	0
10	42045534	.	A	T	2	5	7	0	0	7	0	0
10	42045578	.	C	T	2	6	8	0	0	8	0	0
10	42111610	.	A	T	4	5	9	0	1	10	0	0
10	42111669	.	C	A	9	8	17	0	3	20	0	0
10	42111673	.	G	A	11	8	19	0	1	20	0	0
10	42112062	.	T	A	1	3	4	0	0	4	0	0
10	42112227	.	G	T	4	6	10	0	1	11	0	0
10	42114366	.	G	A	2	1	3	0	0	3	0	0
10	42134649	.	T	C	6	3	9	0	0	9	0	0
10	42135079	.	G	A	4	2	6	0	0	6	0	0
10	42135081	.	T	A	4	2	6	0	0	6	0	0
10	42135366	.	G	A	0	2	2	0	0	2	0	0
10	42135472	.	A	G	2	3	5	0	0	5	0	0
10	42378334	.	A	T	37	27	64	0	3	68	1	0
10	42501067	.	A	G	11	7	18	0	0	18	0	0
10	42501175	.	T	A	6	6	12	0	0	12	0	0
10	42501365	.	A	G	12	20	32	0	1	33	0	0
10	42505845	.	T	C	3	6	9	0	0	9	0	0
10	42507081	.	T	C	3	6	9	0	0	9	0	0
10	42507120	.	T	C	2	6	8	0	0	8	0	0
10	42507141	.	A	G	4	3	7	0	2	9	0	0
10	42519641	.	C	T	1	0	1	0	0	1	0	0
10	42531713	.	C	T	3	4	7	0	0	7	0	0
10	42539630	.	C	T	16	14	30	0	1	31	0	0
10	42539849	.	C	T	19	14	33	0	1	34	0	0
10	42539955	.	T	C	9	9	18	0	2	20	0	0
10	42540132	.	A	T	15	11	26	0	0	26	0	0
10	42540172	.	A	C	16	12	28	0	0	28	0	0
10	42540726	.	A	G	7	3	10	0	2	12	0	0
10	42548210	.	A	T	0	1	1	0	0	1	0	0
10	42548213	.	A	G	0	0	0	0	1	1	0	0
10	42550828	.	C	T	1	1	2	0	0	2	0	0
10	42555728	.	G	A	0	3	3	0	6	9	0	0
10	42555732	.	G	T	5	3	8	0	1	9	0	0
10	42715853	.	C	T	24	6	30	0	1	31	0	0
10	42739589	.	G	A	9	8	17	0	0	17	0	0
10	42739593	.	T	C	9	8	17	0	0	17	0	0
10	42739938	.	C	T	5	3	8	0	0	8	0	0
10	42740111	.	G	A	0	5	5	0	12	17	0	0
10	42740386	.	A	C	14	7	21	0	2	23	0	0
10	42741417	.	T	A	22	27	49	0	7	56	0	0
10	42741469	.	T	A	35	12	47	0	2	49	0	0
10	42741661	.	C	A	0	8	8	0	37	45	0	0
10	42741815	.	G	A	22	15	37	0	1	38	0	0
10	42741840	.	T	A	17	15	32	0	5	37	0	0
10	42741872	.	A	G	16	12	28	0	5	33	0	0
10	42742319	.	A	T	3	4	7	0	0	7	0	0
10	42742600	.	C	T	4	4	8	0	0	8	0	0
10	42742692	.	A	T	7	3	10	0	1	11	0	0
10	42744912	.	C	A	3	5	8	0	0	8	0	0
10	42744951	.	G	C	2	5	7	0	0	7	0	0
10	42744970	.	T	A	2	4	6	0	0	6	0	0
10	42745147	.	A	G	1	3	4	0	0	4	0	0
10	42745151	.	C	T	2	3	5	0	0	5	0	0
10	42767123	.	G	A	8	3	11	0	1	12	0	0
10	42767252	.	C	T	0	6	6	0	5	11	0	0
10	42873937	.	T	C	3	2	5	0	0	5	0	0
10	42900909	.	G	A	0	3	3	0	3	6	0	0
10	42902618	.	T	C	1	2	3	0	0	3	0	0
10	42902666	.	G	A	0	1	1	0	0	1	0	0
10	42903745	.	T	C	3	7	10	0	0	10	0	0
10	42903854	.	G	A	3	5	8	0	0	8	0	0
10	43072939	.	A	G	2	2	4	0	0	4	0	0
10	43072943	.	T	C	2	2	4	0	0	4	0	0
10	43073044	.	C	T	2	3	5	0	2	7	0	0
10	43073103	.	A	G	3	2	5	0	0	5	0	0
10	43151516	.	G	A	0	3	3	0	2	5	0	0
10	43157401	.	C	G	5	1	6	0	0	6	0	0
10	43183798	.	A	T	3	4	7	0	0	7	0	0
10	43499974	.	T	C	4	0	4	0	0	4	0	0
10	43545284	.	A	C	9	5	14	0	0	14	0	0
10	43545288	.	C	T	9	5	14	0	0	14	0	0
10	43545434	.	G	C	6	12	18	0	2	20	0	0
10	43545475	.	A	C	9	7	16	0	0	16	0	0
10	43545577	.	C	A	0	10	10	0	6	16	0	0
10	43545681	.	C	T	3	7	10	0	0	10	0	0
10	43545747	.	A	G	3	5	8	0	1	9	0	0
10	43545757	.	C	T	0	3	3	0	4	7	0	0
10	43546889	.	T	C	2	1	3	0	1	4	0	0
10	43546890	.	T	C	2	2	4	0	0	4	0	0
10	43546985	.	T	C	3	1	4	0	0	4	0	0
10	43548194	.	C	A	2	2	4	0	0	4	0	0
10	43548195	.	C	A	2	2	4	0	0	4	0	0
10	43709084	.	T	C	7	3	10	0	1	11	0	0
10	43709085	.	G	C	7	3	10	0	1	11	0	0
10	43709204	.	A	G	14	9	23	0	1	24	0	0
10	43711059	.	T	A	1	2	3	0	0	3	0	0
10	43715981	.	G	A	7	5	12	0	1	13	0	0
10	43721415	.	C	T	5	5	10	0	1	11	0	0
10	43761719	.	T	A	9	5	14	0	0	14	0	0
10	43761755	.	A	G	12	4	16	0	0	16	0	0
10	43761996	.	G	A	1	2	3	0	0	3	0	0
10	43762021	.	C	T	4	3	7	0	0	7	0	0
10	43762142	.	C	T	0	5	5	0	3	8	0	0
10	43762519	.	A	G	5	2	7	0	0	7	0	0
10	43762654	.	A	G	2	4	6	0	0	6	0	0
10	43762717	.	A	G	7	5	12	0	0	12	0	0
10	43762755	.	A	C	5	3	8	0	1	9	0	0
10	43765291	.	G	C	0	1	1	0	1	2	0	0
10	43936313	.	A	T	1	2	3	0	0	3	0	0
10	43999511	.	T	C	4	7	11	0	1	12	0	0
10	44010073	.	C	T	0	2	2	0	1	3	0	0
10	44189322	.	G	T	1	2	3	0	0	3	0	0
10	44314569	.	C	T	1	0	1	0	0	1	0	0
10	44314579	.	A	G	0	0	0	0	1	1	0	0
10	44320823	.	G	C	4	7	11	0	0	11	0	0
10	44363242	.	G	T	4	4	8	0	0	8	0	0
10	44364604	.	A	T	1	0	1	0	0	1	0	0
10	44371710	.	G	T	0	7	7	0	9	16	0	0
10	44375785	.	G	A	0	4	4	0	4	8	0	0
10	44437145	.	T	C	6	3	9	0	0	9	0	0
10	44513232	.	T	C	3	7	10	0	0	10	0	0
10	44513307	.	T	C	1	2	3	0	1	4	0	0
10	44513402	.	T	C	4	0	4	0	10	14	0	0
10	44513421	.	C	T	0	7	7	0	5	12	0	0
10	44515911	.	G	C	1	3	4	0	0	4	0	0
10	44515927	.	T	C	0	2	2	0	1	3	0	0
10	44516001	.	C	T	0	2	2	0	0	2	0	0
10	44652510	.	C	T	1	2	3	0	0	3	0	0
10	44663025	.	C	T	1	2	3	0	0	3	0	0
10	44669825	.	T	G	3	6	9	0	0	9	0	0
10	44670380	.	C	A	2	3	5	0	0	5	0	0
10	44670437	.	A	G	5	4	9	0	0	9	0	0
10	44670894	.	C	T	3	8	11	0	0	11	0	0
10	44670923	.	T	C	4	7	11	0	0	11	0	0
10	44671818	.	A	C	11	17	28	0	2	30	0	0
10	44672009	.	T	A	17	23	40	0	1	41	0	0
10	44672036	.	T	A	20	16	36	0	3	39	0	0
10	44691707	.	A	T	1	2	3	0	0	3	0	0
10	44691708	.	T	C	1	2	3	0	0	3	0	0
10	44693556	.	C	T	13	9	22	0	1	23	0	0
10	44693769	.	C	T	13	7	20	2	0	22	0	0
10	44693868	.	G	A	1	0	1	1	1	3	0	0
10	44694096	.	A	G	11	2	13	0	3	16	0	0
10	44694141	.	T	C	0	7	7	1	1	9	0	0
10	44694354	.	G	A	0	13	13	1	3	17	0	0
10	44900901	.	T	G	1	2	3	0	0	3	0	0
10	44938486	.	A	G	1	2	3	0	0	3	0	0
10	44938490	.	A	G	0	1	1	0	1	2	0	0
10	44989378	.	C	T	1	2	3	0	0	3	0	0
10	44989384	.	T	C	1	2	3	0	1	4	0	0
10	44990917	.	C	T	3	9	12	0	0	12	0	0
10	45055879	.	G	A	3	1	4	0	1	5	0	0
10	45055948	.	G	A	1	0	1	0	0	1	0	0
10	45064957	.	C	T	2	4	6	0	2	8	0	0
10	45203385	.	T	A	1	4	5	0	0	5	0	0
10	45204568	.	G	T	1	2	3	0	0	3	0	0
10	45205166	.	A	C	6	9	15	2	0	17	0	0
10	45205175	.	A	G	7	0	7	2	6	15	0	0
10	45205284	.	A	C	10	9	19	0	0	19	0	0
10	45205400	.	C	A	5	10	15	0	0	15	0	0
10	45205506	.	A	C	2	8	10	0	0	10	0	0
10	45205518	.	T	G	4	7	11	0	0	11	0	0
10	45205757	.	C	A	8	6	14	0	1	15	0	0
10	45205758	.	A	G	8	6	14	0	1	15	0	0
10	45206103	.	C	G	9	1	10	1	0	15	4	0
10	45206182	.	G	A	6	5	11	0	1	12	0	0
10	45206199	.	A	C	6	0	6	0	4	10	0	0
10	45206217	.	C	A	7	3	10	0	0	10	0	0
10	45206241	.	T	A	10	8	18	0	1	19	0	0
10	45206326	.	G	T	6	7	13	0	0	13	0	0
10	45206450	.	T	C	9	0	9	0	10	19	0	0
10	45206478	.	G	T	17	3	20	0	1	21	0	0
10	45208153	.	A	G	1	4	5	0	0	5	0	0
10	45208667	.	C	T	0	1	1	0	2	3	0	0
10	45208875	.	G	A	3	2	5	0	0	5	0	0
10	45208899	.	C	A	2	0	2	0	0	2	0	0
10	45213798	.	C	T	0	0	0	0	2	2	0	0
10	45336565	.	T	C	3	3	6	0	0	6	0	0
10	45340930	.	G	T	0	2	2	0	1	3	0	0
10	45341762	.	A	T	1	2	3	0	0	3	0	0
10	45349924	.	G	A	11	8	19	0	1	20	0	0
10	45351037	.	C	T	7	5	12	0	3	15	0	0
10	45352231	.	C	T	21	21	42	0	4	46	0	0
10	45375714	.	G	T	2	1	3	0	0	3	0	0
11	88253	.	G	T	6	2	8	0	0	8	0	0
11	126595	.	A	T	2	1	3	0	0	3	0	0
11	185396	.	C	T	1	4	5	0	5	10	0	0
11	185624	.	T	A	15	35	50	0	2	52	0	0
11	185678	.	G	A	12	22	34	0	2	36	0	0
11	185775	.	C	T	1	15	16	0	17	33	0	0
11	185890	.	A	G	13	12	25	0	0	25	0	0
11	185902	.	A	G	14	12	26	0	0	26	0	0
11	186235	.	G	A	2	3	5	0	0	5	0	0
11	186745	.	G	T	4	5	9	0	1	10	0	0
11	186798	.	T	G	5	5	10	0	0	10	0	0
11	186939	.	A	G	7	5	12	0	1	13	0	0
11	187022	.	C	A	4	4	8	0	0	8	0	0
11	187104	.	T	A	5	6	11	0	1	12	0	0
11	187399	.	A	C	1	1	2	0	0	2	0	0
11	222488	.	C	G	6	7	13	0	1	14	0	0
11	222722	.	C	T	0	4	4	0	7	11	0	0
11	222729	.	C	T	0	5	5	0	6	11	0	0
11	222776	.	C	T	5	6	11	0	0	11	0	0
11	222787	.	A	G	4	5	9	0	0	9	0	0
11	223806	.	A	G	4	5	9	0	1	10	0	0
11	233672	.	A	T	1	3	4	0	0	4	0	0
11	233674	.	G	A	1	3	4	0	0	4	0	0
11	260909	.	G	A	19	6	25	0	6	31	0	0
11	265097	.	T	G	1	1	2	0	0	2	0	0
11	265404	.	G	A	7	5	12	0	2	14	0	0
11	265497	.	C	T	1	2	3	0	5	8	0	0
11	265506	.	G	C	7	4	11	0	0	11	0	0
11	268887	.	G	A	0	1	1	0	0	1	0	0
11	270090	.	A	G	2	6	8	0	1	9	0	0
11	281887	.	A	T	3	3	6	0	0	6	0	0
11	281961	.	A	G	9	9	18	0	0	18	0	0
11	282193	.	T	G	7	9	16	0	1	17	0	0
11	282279	.	A	T	5	11	16	0	0	16	0	0
11	282546	.	G	T	5	8	13	0	0	13	0	0
11	282553	.	A	G	5	7	12	0	1	13	0	0
11	282602	.	T	G	7	9	16	0	1	17	0	0
11	284424	.	G	T	2	1	3	0	0	3	0	0
11	304015	.	C	T	3	3	6	0	0	6	0	0
11	322076	.	G	A	0	9	9	0	4	13	0	0
11	539573	.	A	C	0	9	9	0	4	13	0	0
11	675382	.	G	C	23	24	47	0	0	47	0	0
11	676856	.	T	C	19	8	27	0	4	31	0	0
11	677100	.	A	G	4	8	12	0	0	12	0	0
11	677264	.	T	C	13	11	24	0	3	27	0	0
11	677341	.	T	C	12	7	19	0	2	21	0	0
11	682905	.	C	T	2	0	2	0	0	2	0	0
11	682926	.	A	G	3	0	3	0	0	3	0	0
11	682943	.	G	A	4	2	6	0	0	6	0	0
11	687501	.	G	A	2	0	2	0	0	2	0	0
11	718404	.	A	C	5	4	9	0	0	9	0	0
11	1148869	.	G	A	10	13	23	0	1	24	0	0
11	1148889	.	G	A	12	12	24	0	0	24	0	0
11	1149105	.	C	T	10	20	30	0	3	33	0	0
11	1149593	.	A	G	28	7	35	0	0	35	0	0
11	1149812	.	C	T	1	20	21	0	21	42	0	0
11	1163295	.	C	T	8	5	13	0	1	14	0	0
11	1165993	.	G	A	1	1	2	0	0	2	0	0
11	1198450	.	G	A	4	2	6	0	1	7	0	0
11	1222025	.	T	G	1	0	1	0	0	1	0	0
11	1339419	.	C	T	0	0	0	0	1	1	0	0
11	1342778	.	G	A	0	1	1	0	0	1	0	0
11	1342826	.	A	G	1	3	4	0	0	4	0	0
11	1348821	.	A	C	1	1	2	0	0	2	0	0
11	1351611	.	A	G	1	2	3	0	0	3	0	0
11	1396343	.	T	C	17	18	35	0	4	39	0	0
11	1403921	.	A	C	3	2	5	0	0	5	0	0
11	1404481	.	C	A	3	3	6	0	0	6	0	0
11	1435736	.	A	G	3	4	7	0	0	7	0	0
11	1467130	.	C	A	0	4	4	0	2	6	0	0
11	1469842	.	C	T	3	3	6	0	1	7	0	0
11	1469859	.	A	G	4	4	8	0	1	9	0	0
11	1469895	.	A	G	4	3	7	0	2	9	0	0
11	1470503	.	G	A	3	4	7	0	1	8	0	0
11	1470535	.	G	C	2	3	5	0	0	5	0	0
11	1474629	.	C	T	0	0	0	0	2	2	0	0
11	1522205	.	G	T	3	5	8	0	2	10	0	0
11	1522291	.	T	C	1	1	2	0	0	2	0	0
11	1525081	.	G	C	4	2	6	0	2	8	0	0
11	1525389	.	G	T	5	3	8	0	1	9	0	0
11	1525416	.	T	A	1	0	1	0	0	1	0	0
11	1526749	.	A	G	0	2	2	0	0	2	0	0
11	1529260	.	A	G	16	10	26	0	1	27	0	0
11	1529526	.	G	A	17	7	24	0	1	25	0	0
11	1529743	.	G	A	8	9	17	0	1	18	0	0
11	1529789	.	A	C	9	8	17	0	0	17	0	0
11	1529796	.	A	T	8	9	17	0	0	17	0	0
11	1529838	.	A	G	3	5	8	0	0	8	0	0
11	1530027	.	G	A	2	8	10	0	0	10	0	0
11	1530295	.	A	C	9	16	25	0	3	28	0	0
11	1530363	.	A	G	11	26	37	0	2	39	0	0
11	1530489	.	A	G	9	0	9	0	17	26	0	0
11	1530541	.	A	G	11	20	31	0	0	31	0	0
11	1530584	.	G	A	0	20	20	0	13	33	0	0
11	1530593	.	G	T	11	20	31	0	2	33	0	0
11	1530642	.	G	A	9	16	25	0	3	28	0	0
11	1543974	.	A	G	3	1	4	0	0	4	0	0
11	1545883	.	A	C	3	4	7	0	0	7	0	0
11	1829952	.	C	T	2	1	3	0	0	3	0	0
11	1838725	.	G	C	0	2	2	0	0	2	0	0
11	1841961	.	G	C	1	0	1	0	0	1	0	0
11	1843339	.	G	T	1	1	2	0	0	2	0	0
11	1843771	.	C	A	2	4	6	0	3	9	0	0
11	1843812	.	A	G	1	0	1	0	3	4	0	0
11	1843818	.	G	A	1	2	3	0	1	4	0	0
11	1863846	.	T	G	10	17	27	0	3	30	0	0
11	1864095	.	C	A	17	16	33	0	1	34	0	0
11	1864216	.	C	T	11	13	24	0	1	25	0	0
11	1919876	.	C	T	3	5	8	0	1	9	0	0
11	1920009	.	C	T	1	3	4	0	4	8	0	0
11	1920069	.	A	T	3	4	7	0	1	8	0	0
11	1945034	.	T	A	4	5	9	0	0	9	0	0
11	1945036	.	C	T	4	5	9	0	0	9	0	0
11	1945229	.	C	T	0	3	3	0	0	3	0	0
11	2111791	.	C	T	2	3	5	0	0	5	0	0
11	2111803	.	T	A	1	3	4	0	0	4	0	0
11	2111828	.	G	A	0	4	4	0	0	4	0	0
11	2112267	.	C	T	2	5	7	0	0	7	0	0
11	2112389	.	G	A	2	2	4	0	0	4	0	0
11	2112404	.	C	A	3	2	5	0	0	5	0	0
11	2112554	.	A	G	3	4	7	0	0	7	0	0
11	2240120	.	A	C	3	3	6	0	0	6	0	0
11	2249884	.	A	G	12	12	24	0	0	24	0	0
11	2249920	.	C	T	1	3	4	0	0	4	0	0
11	2253154	.	G	A	10	2	12	0	2	14	0	0
11	2254438	.	C	T	0	2	2	0	0	2	0	0
11	2255025	.	T	G	0	3	3	0	0	3	0	0
11	2255027	.	T	G	0	3	3	0	0	3	0	0
11	2263484	.	T	G	0	1	1	0	0	1	0	0
11	2462762	.	A	G	5	2	7	0	1	8	0	0
11	2462791	.	A	G	3	5	8	0	1	9	0	0
11	2462830	.	A	G	2	4	6	0	0	6	0	0
11	2462831	.	G	A	1	4	5	0	1	6	0	0
11	2541797	.	T	C	3	3	6	0	0	6	0	0
11	2542391	.	C	T	1	3	4	0	1	5	0	0
11	2545012	.	C	T	0	1	1	0	2	3	0	0
11	2545018	.	A	G	1	1	2	0	1	3	0	0
11	2571562	.	T	A	1	3	4	0	0	4	0	0
11	2576876	.	C	T	0	1	1	0	0	1	0	0
11	2616881	.	T	A	2	3	5	0	0	5	0	0
11	2616956	.	T	C	17	14	31	0	2	33	0	0
11	2617031	.	T	A	8	20	28	0	2	30	0	0
11	2617072	.	A	G	6	11	17	0	1	18	0	0
11	2618653	.	C	A	4	2	6	0	1	7	0	0
11	2619180	.	T	C	2	3	5	0	1	6	0	0
11	2619181	.	T	A	2	3	5	0	1	6	0	0
11	2619515	.	T	A	1	4	5	0	0	5	0	0
11	2678064	.	G	A	1	1	2	0	0	2	0	0
11	2678088	.	G	A	1	2	3	0	0	3	0	0
11	2680747	.	C	T	1	2	3	0	1	4	0	0
11	2682001	.	C	A	0	2	2	0	1	4	1	0
11	2682005	.	T	G	1	1	2	0	1	3	0	0
11	2682470	.	A	T	1	5	6	0	0	6	0	0
11	2682664	.	T	A	2	3	5	0	0	5	0	0
11	2682693	.	A	C	1	3	4	0	0	4	0	0
11	2682866	.	T	C	4	3	7	0	0	7	0	0
11	2683038	.	G	T	1	2	3	0	0	3	0	0
11	2690131	.	A	G	4	3	7	0	0	7	0	0
11	2690192	.	A	G	2	2	4	0	1	5	0	0
11	2690233	.	G	T	4	5	9	0	1	10	0	0
11	2690303	.	G	C	1	7	8	0	1	9	0	0
11	2690445	.	G	T	6	6	12	0	1	13	0	0
11	2690564	.	G	T	5	7	12	0	0	12	0	0
11	2690612	.	A	C	6	5	11	0	2	13	0	0
11	2690869	.	C	A	5	4	9	0	1	10	0	0
11	2690873	.	G	A	0	3	3	0	4	7	0	0
11	2692109	.	A	C	3	3	6	0	0	6	0	0
11	2692180	.	C	T	2	5	7	0	0	7	0	0
11	2692325	.	G	A	2	2	4	0	0	4	0	0
11	2702718	.	T	C	1	1	2	0	0	2	0	0
11	2702766	.	C	T	0	2	2	0	0	2	0	0
11	2702808	.	T	C	0	1	1	0	0	1	0	0
11	2705206	.	C	T	0	2	2	0	1	3	0	0
11	2705215	.	G	T	0	1	1	0	2	3	0	0
11	2705325	.	G	A	3	2	5	0	0	5	0	0
11	2705355	.	T	A	6	2	8	0	0	8	0	0
11	2706517	.	T	G	5	7	12	0	0	12	0	0
11	2706734	.	T	C	8	6	14	0	3	17	0	0
11	2706838	.	A	G	11	6	17	0	3	20	0	0
11	2706988	.	C	A	2	2	4	0	1	5	0	0
11	2758204	.	C	T	3	7	10	0	0	10	0	0
11	2759003	.	C	A	1	3	4	0	0	4	0	0
11	2759007	.	C	T	1	3	4	0	0	4	0	0
11	2759043	.	A	T	3	4	7	0	0	7	0	0
11	2759425	.	A	G	1	2	3	0	1	4	0	0
11	2759525	.	A	G	2	4	6	5	0	11	0	0
11	2759562	.	A	T	1	1	2	2	0	4	0	0
11	2759833	.	G	A	0	14	14	0	11	25	0	0
11	2759843	.	G	A	0	16	16	0	13	29	0	0
11	2759901	.	T	G	8	8	16	0	1	17	0	0
11	2759903	.	A	T	9	8	17	0	0	17	0	0
11	2759938	.	A	G	9	8	17	0	1	18	0	0
11	2815790	.	C	G	1	1	2	0	0	2	0	0
11	2815845	.	C	T	4	2	6	0	1	7	0	0
11	2820876	.	T	G	2	0	2	0	0	2	0	0
11	2820900	.	A	C	1	0	1	0	0	1	0	0
11	2821427	.	T	C	0	1	1	0	0	1	0	0
11	2821430	.	C	G	0	0	0	0	1	1	0	0
11	2826184	.	T	C	5	5	10	0	1	11	0	0
11	2826338	.	G	T	3	4	7	0	0	7	0	0
11	2826485	.	C	A	4	4	8	0	0	8	0	0
11	2828174	.	A	G	6	21	27	0	3	30	0	0
11	2828276	.	C	A	15	7	22	0	0	22	0	0
11	2828388	.	G	A	9	18	27	0	3	30	0	0
11	3238651	.	C	T	1	0	1	0	0	1	0	0
11	3240457	.	G	A	0	0	0	0	1	1	0	0
11	3243124	.	A	G	0	0	0	0	1	1	0	0
11	3246120	.	A	G	5	6	11	0	0	11	0	0
11	3246133	.	A	G	6	7	13	0	1	14	0	0
11	3249253	.	C	T	5	6	11	0	0	11	0	0
11	3249346	.	C	T	3	10	13	0	0	13	0	0
11	3249370	.	A	G	2	0	2	0	7	9	0	0
11	3317389	.	A	T	8	5	13	0	0	13	0	0
11	3323377	.	G	T	2	1	3	0	1	4	0	0
11	3336700	.	T	G	20	29	49	0	7	56	0	0
11	3336793	.	C	T	34	34	68	0	2	70	0	0
11	3337038	.	A	G	36	28	64	0	4	68	0	0
11	3337253	.	A	G	32	30	62	0	3	65	0	0
11	3337256	.	T	C	29	1	30	0	34	64	0	0
11	3337481	.	T	G	20	29	49	0	1	50	0	0
11	3337482	.	A	T	21	27	48	0	2	50	0	0
11	3337718	.	G	C	22	12	34	1	3	38	0	0
11	3338060	.	C	G	20	12	32	0	3	35	0	0
11	3338144	.	T	C	26	25	51	0	4	55	0	0
11	3338288	.	T	A	18	14	32	1	3	36	0	0
11	3338299	.	T	G	16	13	29	1	1	31	0	0
11	3338420	.	A	T	19	17	36	0	8	44	0	0
11	3338431	.	C	T	0	20	20	0	25	45	0	0
11	3338491	.	G	A	21	19	40	0	1	41	0	0
11	3338514	.	C	A	23	19	42	0	2	44	0	0
11	3338618	.	T	C	20	17	37	0	2	39	0	0
11	3338638	.	A	G	14	20	34	0	4	38	0	0
11	3338933	.	A	G	9	10	19	0	1	20	0	0
11	3339152	.	C	T	2	4	6	0	0	6	0	0
11	3345676	.	A	G	2	5	7	0	0	7	0	0
11	3345779	.	T	C	4	3	7	0	0	7	0	0
11	3345952	.	T	C	2	5	7	0	0	7	0	0
11	3345980	.	A	G	2	2	4	0	0	4	0	0
11	3346941	.	G	A	2	2	4	0	0	4	0	0
11	3367924	.	G	C	4	13	17	0	1	18	0	0
11	3367937	.	T	C	4	11	15	0	1	16	0	0
11	3369843	.	G	A	2	8	10	0	0	10	0	0
11	3373996	.	C	T	0	0	0	0	1	1	0	0
11	3520694	.	C	A	4	2	6	0	1	7	0	0
11	3523724	.	A	G	5	12	17	0	2	19	0	0
11	3523826	.	G	A	8	10	18	0	0	18	0	0
11	3523991	.	C	T	6	5	11	0	1	12	0	0
11	3524064	.	G	T	7	3	10	0	0	10	0	0
11	3524111	.	G	A	8	6	14	0	0	14	0	0
11	3524121	.	A	G	7	11	18	0	1	19	0	0
11	3524236	.	C	T	3	6	9	0	0	9	0	0
11	3524462	.	C	T	6	7	13	0	0	13	0	0
11	3524541	.	A	T	2	2	4	0	0	4	0	0
11	3524724	.	T	A	0	2	2	0	1	3	0	0
11	3524849	.	G	A	6	3	9	0	2	11	0	0
11	3525051	.	T	C	1	1	2	0	0	2	0	0
11	3526605	.	C	G	1	1	2	0	1	3	0	0
11	3528320	.	A	T	3	1	4	0	2	6	0	0
11	3551309	.	A	G	6	8	14	0	0	14	0	0
11	3551944	.	G	A	18	18	36	0	3	39	0	0
11	3563569	.	T	C	1	0	1	0	0	1	0	0
11	3563680	.	A	G	1	2	3	0	0	3	0	0
11	3593309	.	T	C	2	7	9	0	0	9	0	0
11	3593490	.	A	C	4	11	15	0	2	17	0	0
11	3593693	.	T	C	0	2	2	0	0	2	0	0
11	3593716	.	C	T	5	6	11	0	1	12	0	0
11	3593748	.	A	G	9	12	21	0	1	22	0	0
11	3593872	.	T	C	7	0	7	0	7	14	0	0
11	3593878	.	T	C	3	0	3	0	12	15	0	0
11	3593988	.	G	T	9	16	25	0	1	26	0	0
11	3594217	.	G	T	6	10	16	0	1	17	0	0
11	3594277	.	T	G	10	6	16	0	0	16	0	0
11	3594321	.	T	C	9	1	10	0	3	13	0	0
11	3594327	.	T	A	6	3	9	0	3	12	0	0
11	3594366	.	A	G	4	11	15	0	2	17	0	0
11	3594419	.	A	G	9	10	19	0	1	20	0	0
11	3594452	.	T	G	4	1	5	0	8	13	0	0
11	3594541	.	A	T	4	4	8	0	0	9	1	0
11	3594550	.	A	T	4	4	8	0	0	8	0	0
11	3594639	.	T	A	3	2	5	0	1	6	0	0
11	3594649	.	T	G	3	2	5	0	0	5	0	0
11	3848041	.	G	A	2	1	3	0	1	4	0	0
11	3848283	.	G	A	18	14	32	0	1	33	0	0
11	3848323	.	C	T	0	14	14	0	23	37	0	0
11	3848656	.	C	T	6	9	15	0	0	15	0	0
11	3893635	.	C	T	10	18	28	0	1	29	0	0
11	3893636	.	T	G	11	14	25	0	4	29	0	0
11	3893918	.	G	A	13	14	27	0	0	27	0	0
11	3893928	.	G	C	14	11	25	0	2	27	0	0
11	3894023	.	T	C	4	12	16	0	2	18	0	0
11	3898736	.	A	G	0	1	1	0	0	1	0	0
11	3899066	.	C	A	0	2	2	0	3	5	0	0
11	3899117	.	G	A	1	1	2	0	0	2	0	0
11	3901733	.	C	G	0	2	2	0	4	6	0	0
11	3904469	.	A	G	5	3	8	0	0	8	0	0
11	3904517	.	C	G	0	5	5	0	4	9	0	0
11	3904564	.	C	T	2	4	6	0	0	6	0	0
11	3917723	.	A	G	0	1	1	0	0	1	0	0
11	3921491	.	A	G	2	1	3	0	0	3	0	0
11	3921563	.	T	A	15	6	21	0	0	21	0	0
11	3922983	.	G	A	3	2	5	0	0	5	0	0
11	3925906	.	A	G	2	6	8	0	0	8	0	0
11	3925939	.	T	C	0	1	1	0	0	1	0	0
11	3931773	.	C	T	1	3	4	0	0	4	0	0
11	3965984	.	T	A	0	4	4	0	0	4	0	0
11	3967408	.	A	G	1	0	1	0	8	9	0	0
11	3967445	.	A	G	1	4	5	0	0	5	0	0
11	3968866	.	T	C	5	9	14	0	0	14	0	0
11	3968877	.	G	A	4	5	9	0	3	12	0	0
11	3968915	.	T	G	2	4	6	0	0	6	0	0
11	3968930	.	A	G	1	0	1	0	0	1	0	0
11	3993452	.	G	A	0	9	9	0	8	17	0	0
11	3993470	.	A	T	3	7	10	0	1	11	0	0
11	3994901	.	C	A	2	4	6	0	0	6	0	0
11	4006924	.	C	T	0	1	1	0	0	1	0	0
11	4006956	.	C	T	1	2	3	0	0	3	0	0
11	4010895	.	C	T	0	2	2	0	1	3	0	0
11	4128836	.	A	T	1	3	4	0	0	4	0	0
11	4131423	.	T	A	2	6	8	0	2	10	0	0
11	4132296	.	A	C	31	21	52	0	3	55	0	0
11	4132378	.	G	C	15	16	31	0	2	33	0	0
11	4132440	.	A	G	14	9	23	0	2	25	0	0
11	4132599	.	T	C	7	5	12	0	0	12	0	0
11	5484288	.	G	C	0	1	1	0	0	1	0	0
11	5484294	.	T	C	0	1	1	0	0	1	0	0
11	5489221	.	A	G	1	2	3	0	0	3	0	0
11	5489356	.	C	T	6	7	13	0	1	14	0	0
11	5489634	.	A	T	10	8	18	0	1	19	0	0
11	5489688	.	T	C	10	11	21	0	1	22	0	0
11	5489689	.	T	C	11	10	21	0	1	22	0	0
11	5489769	.	C	G	12	1	13	0	0	13	0	0
11	5489781	.	G	A	14	1	15	0	0	15	0	0
11	5489835	.	A	C	6	8	14	0	2	16	0	0
11	5489973	.	A	G	4	0	4	0	7	11	0	0
11	5489974	.	A	G	3	7	10	0	1	11	0	0
11	5513181	.	A	C	2	2	4	0	0	4	0	0
11	5514254	.	G	A	1	2	3	0	2	5	0	0
11	5514259	.	C	T	3	2	5	0	2	7	0	0
11	5514677	.	C	T	6	11	17	0	2	19	0	0
11	5515016	.	G	C	6	6	12	1	0	13	0	0
11	5582787	.	C	A	2	2	4	0	2	6	0	0
11	5582789	.	A	C	2	4	6	0	0	6	0	0
11	5659026	.	C	T	2	2	4	0	1	5	0	0
11	5674704	.	C	T	3	3	6	0	0	6	0	0
11	5821084	.	G	T	3	0	3	0	0	3	0	0
11	5821096	.	C	G	0	2	2	0	0	2	0	0
11	5825620	.	A	G	1	6	7	0	1	8	0	0
11	5844525	.	G	A	3	15	18	0	2	20	0	0
11	5844579	.	G	A	0	0	0	0	3	3	0	0
11	5847511	.	G	A	4	7	11	0	0	11	0	0
11	5923335	.	C	A	21	22	43	0	2	45	0	0
11	5923515	.	G	A	0	4	4	0	5	9	0	0
11	5934086	.	G	T	1	2	3	0	0	3	0	0
11	5934090	.	A	G	2	2	4	0	0	4	0	0
11	5945836	.	A	T	5	3	8	0	0	8	0	0
11	5945840	.	G	A	5	3	8	0	2	10	0	0
11	5945919	.	T	A	7	7	14	0	1	15	0	0
11	5946023	.	T	A	12	7	19	0	9	28	0	0
11	5946564	.	T	C	12	15	27	0	2	29	0	0
11	5946854	.	G	C	13	8	21	0	5	26	0	0
11	5947191	.	T	G	8	4	12	0	1	13	0	0
11	6013892	.	C	T	0	1	1	0	0	1	0	0
11	6034351	.	C	A	1	3	4	0	0	4	0	0
11	6034364	.	A	T	6	2	8	0	0	8	0	0
11	6051419	.	A	G	10	6	16	0	0	16	0	0
11	6051431	.	G	A	6	10	16	0	1	17	0	0
11	6051477	.	G	A	7	5	12	0	0	12	0	0
11	6051481	.	T	C	7	4	11	0	0	11	0	0
11	6051557	.	A	T	7	5	12	0	3	15	0	0
11	6051717	.	G	A	14	11	25	0	0	25	0	0
11	6051839	.	A	C	13	13	26	0	0	26	0	0
11	6052211	.	G	A	3	2	5	0	0	5	0	0
11	6065129	.	C	G	0	1	1	0	3	4	0	0
11	6065150	.	C	T	0	3	3	0	1	4	0	0
11	6072847	.	T	C	2	2	4	0	0	4	0	0
11	6072856	.	A	T	2	2	4	0	0	4	0	0
11	6074265	.	C	T	2	2	4	0	0	4	0	0
11	6443467	.	A	G	6	0	6	0	3	9	0	0
11	6443469	.	A	G	3	6	9	0	0	9	0	0
11	6456177	.	C	T	3	3	6	0	0	6	0	0
11	6456447	.	C	T	2	4	6	0	0	6	0	0
11	6456677	.	T	C	5	8	13	0	2	15	0	0
11	6456829	.	C	T	12	10	22	0	0	22	0	0
11	6457442	.	G	A	13	9	22	0	5	27	0	0
11	6457473	.	C	A	11	5	16	0	0	16	0	0
11	6457500	.	A	T	12	4	16	0	0	16	0	0
11	6457518	.	T	C	12	8	20	0	0	20	0	0
11	6457594	.	C	A	5	4	9	0	0	9	0	0
11	6457619	.	T	C	4	3	7	0	0	7	0	0
11	6859934	.	A	G	1	4	5	0	0	5	0	0
11	6859935	.	T	C	1	0	1	0	4	5	0	0
11	6860020	.	A	G	5	15	20	0	2	22	0	0
11	6860050	.	T	C	7	17	24	0	1	25	0	0
11	6868156	.	G	T	10	5	15	0	0	15	0	0
11	6869480	.	G	T	2	2	4	0	3	7	0	0
11	6870794	.	C	T	0	5	5	0	0	5	0	0
11	6874110	.	T	C	1	5	6	0	0	6	0	0
11	6890283	.	A	G	2	2	4	0	0	4	0	0
11	6941654	.	T	G	2	3	5	0	0	5	0	0
11	6941987	.	C	T	2	6	8	0	0	8	0	0
11	6942409	.	G	A	2	4	6	0	0	6	0	0
11	6942436	.	A	G	1	5	6	0	0	6	0	0
11	6942797	.	T	C	8	7	15	0	0	15	0	0
11	6942977	.	A	G	6	3	9	0	3	12	0	0
11	6943013	.	C	T	5	2	7	0	1	8	0	0
11	6943048	.	A	G	4	0	4	0	4	8	0	0
11	6943055	.	T	G	6	4	10	0	0	10	0	0
11	6943462	.	T	A	6	4	10	0	0	10	0	0
11	6943715	.	G	A	0	11	11	0	6	17	0	0
11	6944143	.	T	A	9	8	17	0	2	19	0	0
11	6977580	.	G	A	1	3	4	0	0	4	0	0
11	6980642	.	T	C	1	3	4	0	0	4	0	0
11	6980647	.	A	G	1	4	5	0	0	5	0	0
11	6980913	.	C	T	5	3	8	0	0	8	0	0
11	6981032	.	G	C	1	0	1	0	0	1	0	0
11	6987108	.	G	A	2	2	4	0	0	4	0	0
11	7041291	.	T	C	7	5	12	0	1	13	0	0
11	7041300	.	A	G	6	4	10	0	1	11	0	0
11	7041527	.	T	C	1	2	3	0	0	3	0	0
11	7041528	.	G	C	1	2	3	0	0	3	0	0
11	7041580	.	T	C	2	2	4	0	0	4	0	0
11	7041598	.	A	C	1	2	3	0	1	4	0	0
11	7041639	.	G	A	2	2	4	0	0	4	0	0
11	7041670	.	A	G	1	2	3	0	0	3	0	0
11	7041690	.	A	G	2	3	5	0	0	5	0	0
11	7042209	.	T	A	4	3	7	0	0	7	0	0
11	7042210	.	T	C	4	0	4	0	3	7	0	0
11	7103010	.	A	T	2	2	4	0	0	4	0	0
11	7150189	.	T	C	1	0	1	0	3	4	0	0
11	7150766	.	T	C	3	0	3	0	0	3	0	0
11	7151773	.	G	T	23	14	37	0	1	38	0	0
11	7151806	.	C	A	0	19	19	0	25	44	0	0
11	7151842	.	G	T	12	21	33	0	0	33	0	0
11	7151860	.	A	T	17	13	30	0	0	30	0	0
11	7151910	.	G	A	8	14	22	3	1	26	0	0
11	7152102	.	G	A	16	16	32	0	1	33	0	0
11	7152274	.	G	A	12	7	19	0	0	19	0	0
11	7152426	.	A	T	4	14	18	1	0	19	0	0
11	7152428	.	A	G	4	13	17	1	1	19	0	0
11	7152594	.	C	T	11	7	18	0	1	19	0	0
11	7152609	.	C	T	7	6	13	0	2	15	0	0
11	7152639	.	C	A	0	6	6	0	7	13	0	0
11	7175215	.	G	C	0	1	1	0	0	1	0	0
11	7178941	.	G	C	0	12	12	0	6	18	0	0
11	7179018	.	C	T	3	3	6	0	1	7	0	0
11	7179259	.	T	C	2	3	5	0	2	7	0	0
11	7179376	.	G	A	5	4	9	0	0	9	0	0
11	7179378	.	A	G	5	4	9	0	0	9	0	0
11	7198607	.	G	A	2	3	5	0	0	5	0	0
11	7201648	.	T	C	1	1	2	0	0	2	0	0
11	7202315	.	C	T	3	4	7	0	0	7	0	0
11	7202321	.	G	A	0	5	5	0	6	11	0	0
11	7211908	.	A	G	10	15	25	0	3	28	0	0
11	7277061	.	A	G	1	6	7	0	0	7	0	0
11	7277310	.	T	C	4	1	5	0	0	5	0	0
11	7277315	.	T	C	3	0	3	0	0	3	0	0
11	7279587	.	G	A	6	3	9	0	0	9	0	0
11	7340143	.	A	G	19	15	34	0	3	37	0	0
11	7341031	.	G	A	26	31	57	0	3	60	0	0
11	7735869	.	C	G	12	16	28	0	1	29	0	0
11	7735905	.	T	A	18	17	35	0	1	36	0	0
11	7735937	.	T	A	15	11	26	0	1	27	0	0
11	7736576	.	G	A	14	24	38	0	2	40	0	0
11	7736589	.	G	T	18	27	45	0	1	46	0	0
11	7981303	.	A	C	6	3	9	0	0	9	0	0
11	7981427	.	C	T	10	6	16	0	0	16	0	0
11	7981613	.	T	C	14	23	37	0	1	38	0	0
11	7982114	.	C	T	4	7	11	0	1	12	0	0
11	7982122	.	T	A	6	4	10	0	0	10	0	0
11	7982263	.	T	G	3	3	6	0	1	7	0	0
11	7982321	.	T	A	3	7	10	0	0	10	0	0
11	7982566	.	T	A	4	4	8	0	2	10	0	0
11	7982774	.	T	A	7	7	14	0	0	14	0	0
11	7982791	.	C	T	5	9	14	0	1	15	0	0
11	7982835	.	C	T	2	6	8	0	1	9	0	0
11	7982869	.	C	T	2	4	6	0	0	6	0	0
11	7983236	.	T	A	2	4	6	0	0	6	0	0
11	7983270	.	T	G	1	6	7	0	0	7	0	0
11	7983348	.	C	A	0	5	5	0	0	5	0	0
11	7983631	.	C	T	0	4	4	0	7	11	0	0
11	7983709	.	T	A	2	4	6	0	1	7	0	0
11	7984181	.	A	T	1	2	3	0	0	3	0	0
11	7984459	.	T	C	1	3	4	0	0	4	0	0
11	7984666	.	T	A	1	3	4	0	0	4	0	0
11	8012466	.	T	A	5	4	9	0	0	9	0	0
11	8012535	.	A	G	4	3	7	0	0	7	0	0
11	8153771	.	C	T	1	6	7	0	0	7	0	0
11	8156967	.	C	T	3	8	11	0	0	11	0	0
11	8156972	.	C	T	1	7	8	0	1	9	0	0
11	8565678	.	A	G	0	2	2	0	1	3	0	0
11	8674417	.	A	G	1	2	3	0	0	3	0	0
11	8674418	.	A	C	1	2	3	0	0	3	0	0
11	8681619	.	G	T	16	15	31	0	0	31	0	0
11	8681714	.	T	C	12	13	25	0	0	25	0	0
11	8681750	.	G	A	8	7	15	0	2	17	0	0
11	10388980	.	G	A	1	2	3	0	0	3	0	0
11	10389003	.	C	A	3	3	6	0	0	6	0	0
11	10402081	.	G	A	2	1	3	0	0	3	0	0
11	10669933	.	G	T	22	34	56	0	2	58	0	0
11	10670112	.	T	A	17	19	36	0	2	38	0	0
11	10670394	.	C	T	22	22	44	0	1	45	0	0
11	10670439	.	T	C	16	12	28	0	8	36	0	0
11	10671525	.	A	G	2	10	12	0	0	12	0	0
11	10671546	.	A	G	2	10	12	0	0	12	0	0
11	10671578	.	A	T	1	8	9	0	0	9	0	0
11	10672707	.	T	G	3	2	5	0	0	5	0	0
11	10672750	.	T	C	0	1	1	0	0	1	0	0
11	10835571	.	T	C	1	0	1	0	0	1	0	0
11	10842537	.	T	C	3	0	3	0	5	8	0	0
11	11597221	.	T	C	3	8	11	0	0	11	0	0
11	11597240	.	T	C	4	6	10	0	1	11	0	0
11	11597374	.	A	G	15	16	31	0	3	34	0	0
11	11597401	.	C	A	13	17	30	0	0	30	0	0
11	11597523	.	A	G	15	8	23	0	5	28	0	0
11	11597798	.	A	T	9	10	19	0	0	19	0	0
11	11597985	.	A	T	9	8	17	0	2	19	0	0
11	11598334	.	G	C	4	6	10	0	1	11	0	0
11	11598692	.	C	A	4	2	6	0	1	7	0	0
11	11605744	.	C	T	0	0	0	0	1	1	0	0
11	11607594	.	G	A	3	3	6	0	0	6	0	0
11	11780816	.	A	T	2	4	6	0	0	6	0	0
11	11918712	.	T	G	1	0	1	0	0	1	0	0
11	11922424	.	G	C	2	3	5	0	0	5	0	0
11	11983710	.	T	C	5	0	5	0	7	12	0	0
11	11983713	.	A	C	5	7	12	0	0	12	0	0
11	11983748	.	A	C	6	1	7	0	6	13	0	0
11	11983789	.	G	T	5	10	15	0	1	16	0	0
11	11983827	.	C	T	5	3	8	0	1	9	0	0
11	11983937	.	T	C	6	6	12	0	1	13	0	0
11	11984408	.	A	C	6	11	17	0	0	17	0	0
11	11984409	.	G	C	6	11	17	0	0	17	0	0
11	11984522	.	A	G	3	4	7	0	2	9	0	0
11	11984548	.	C	T	1	9	10	0	0	10	0	0
11	11984666	.	A	G	2	2	4	0	1	5	0	0
11	12004304	.	G	T	1	2	3	0	0	3	0	0
11	12011325	.	G	A	8	5	13	0	1	14	0	0
11	12016638	.	A	G	5	6	11	0	0	11	0	0
11	12118079	.	C	T	3	4	7	0	1	8	0	0
11	12118097	.	T	A	2	1	3	0	1	4	0	0
11	12727225	.	A	G	3	3	6	0	0	6	0	0
11	12727446	.	C	T	11	24	35	0	1	36	0	0
11	12727504	.	A	G	9	15	24	0	4	28	0	0
11	12727708	.	C	A	8	18	26	0	2	28	0	0
11	12727829	.	T	A	2	4	6	0	0	6	0	0
11	12727927	.	A	G	10	6	16	0	1	17	0	0
11	12727990	.	T	A	10	10	20	0	1	21	0	0
11	12727999	.	C	T	7	11	18	0	4	22	0	0
11	12732431	.	A	C	4	8	12	0	0	12	0	0
11	12732505	.	A	T	6	12	18	0	0	18	0	0
11	12732521	.	T	C	4	0	4	0	13	17	0	0
11	12732556	.	G	C	5	14	19	0	1	20	0	0
11	12732638	.	G	A	5	4	9	0	1	10	0	0
11	12732655	.	C	T	0	2	2	0	6	8	0	0
11	12732699	.	A	T	2	3	5	0	2	7	0	0
11	12733004	.	C	T	2	2	4	0	1	5	0	0
11	12733502	.	C	T	5	3	8	0	1	9	0	0
11	12733741	.	C	T	4	4	8	0	1	9	0	0
11	12733743	.	G	A	5	4	9	0	0	9	0	0
11	12733815	.	C	T	4	2	6	0	0	6	0	0
11	12733824	.	T	C	3	0	3	0	2	5	0	0
11	12733965	.	C	T	2	3	5	0	0	5	0	0
11	12734072	.	G	A	1	4	5	0	0	5	0	0
11	12751500	.	G	A	1	1	2	0	0	2	0	0
11	12759737	.	C	T	1	0	1	0	0	1	0	0
11	12767982	.	T	C	1	5	6	0	1	7	0	0
11	12768214	.	G	A	0	8	8	0	11	19	0	0
11	12768299	.	C	T	10	16	26	0	1	27	0	0
11	12782503	.	G	A	5	7	12	0	2	14	0	0
11	12782524	.	A	C	7	10	17	0	1	18	0	0
11	12782802	.	G	A	5	4	9	0	1	10	0	0
11	12782897	.	T	A	3	3	6	0	0	6	0	0
11	12782908	.	T	G	3	3	6	0	1	7	0	0
11	12783139	.	T	A	2	4	6	0	1	7	0	0
11	12845066	.	A	G	1	0	1	0	1	2	0	0
11	12845101	.	T	A	2	1	3	0	0	3	0	0
11	12845150	.	T	C	4	1	5	0	0	5	0	0
11	12845160	.	G	A	0	1	1	0	3	4	0	0
11	12858777	.	C	T	3	2	5	0	0	5	0	0
11	12858798	.	G	A	0	1	1	0	3	4	0	0
11	12859073	.	A	G	1	0	1	0	0	1	0	0
11	12988038	.	G	A	1	2	3	0	0	3	0	0
11	13055748	.	T	C	5	6	11	0	0	11	0	0
11	13085294	.	G	A	2	2	4	0	0	4	0	0
11	13094203	.	C	T	17	18	35	0	5	40	0	0
11	13094247	.	A	G	11	15	26	0	2	28	0	0
11	13094581	.	C	T	0	16	16	0	21	37	0	0
11	13094884	.	G	A	15	11	26	0	1	27	0	0
11	13094913	.	A	G	11	14	25	0	5	30	0	0
11	13094938	.	G	T	11	13	24	0	2	26	0	0
11	13104057	.	C	A	0	1	1	0	0	1	0	0
11	13189079	.	T	A	2	1	3	0	1	4	0	0
11	13208839	.	C	G	7	17	24	0	0	24	0	0
11	13209037	.	T	G	13	15	28	0	1	29	0	0
11	13209085	.	G	C	19	15	34	0	2	36	0	0
11	13210604	.	G	A	14	10	24	0	1	25	0	0
11	13210667	.	C	T	8	16	24	0	1	25	0	0
11	13210906	.	C	T	14	16	30	0	4	34	0	0
11	13212186	.	A	T	14	19	33	0	2	35	0	0
11	13212234	.	T	C	33	27	60	0	2	62	0	0
11	13212333	.	T	C	12	10	22	0	0	22	0	0
11	13212357	.	T	C	2	3	5	0	0	5	0	0
11	13212567	.	T	C	27	27	54	0	5	59	0	0
11	13212908	.	T	A	31	20	51	0	0	51	0	0
11	13280565	.	T	C	18	0	18	0	17	35	0	0
11	13280580	.	A	G	20	12	32	0	0	32	0	0
11	13280648	.	T	A	1	2	3	0	0	3	0	0
11	13280649	.	T	G	1	2	3	0	0	3	0	0
11	13281238	.	A	G	6	3	9	0	1	10	0	0
11	13281653	.	C	T	8	12	20	0	1	21	0	0
11	13281734	.	G	A	7	7	14	0	0	14	0	0
11	13282030	.	T	C	4	3	7	0	1	8	0	0
11	13282346	.	T	C	1	4	5	0	1	6	0	0
11	13282660	.	C	T	7	3	10	0	0	10	0	0
11	13282881	.	T	C	1	2	3	0	2	5	0	0
11	13282883	.	A	G	3	2	5	0	0	5	0	0
11	13283181	.	C	T	4	2	6	0	0	6	0	0
11	13283220	.	C	G	0	2	2	0	3	5	0	0
11	13283335	.	A	G	2	4	6	0	1	7	0	0
11	13283398	.	G	C	3	2	5	0	0	5	0	0
11	13505186	.	C	A	7	2	9	0	2	11	0	0
11	13505247	.	A	T	2	6	8	0	0	8	0	0
11	13532567	.	T	C	0	2	2	0	0	2	0	0
11	13533072	.	A	G	4	3	7	0	0	7	0	0
11	13533388	.	T	A	7	5	12	0	2	14	0	0
11	14062908	.	A	G	1	3	4	0	0	4	0	0
11	14064229	.	T	C	1	2	3	0	0	3	0	0
11	14064454	.	A	G	6	4	10	0	0	10	0	0
11	14064487	.	G	C	5	4	9	0	0	9	0	0
11	14073049	.	T	A	4	2	6	0	2	8	0	0
11	14073242	.	T	C	3	3	6	0	0	6	0	0
11	14073444	.	C	T	6	12	18	0	2	20	0	0
11	14073631	.	T	C	4	8	12	0	1	13	0	0
11	14073639	.	T	C	4	8	12	0	0	12	0	0
11	14073857	.	C	A	5	9	14	0	1	15	0	0
11	14073858	.	A	T	6	9	15	0	0	15	0	0
11	14074174	.	T	C	7	5	12	0	0	12	0	0
11	14074397	.	A	G	3	2	5	0	0	5	0	0
11	14074843	.	A	C	4	3	7	0	0	7	0	0
11	14132176	.	C	G	1	0	1	0	3	4	0	0
11	14137901	.	C	A	5	6	11	0	0	11	0	0
11	14137988	.	C	T	3	2	5	0	0	5	0	0
11	14138006	.	T	G	0	1	1	0	0	1	0	0
11	14143498	.	T	C	4	3	7	0	0	7	0	0
11	14159425	.	C	T	1	4	5	0	0	5	0	0
11	14159555	.	A	G	5	2	7	0	0	7	0	0
11	14160131	.	A	G	7	5	12	0	0	12	0	0
11	14160941	.	C	A	3	5	8	0	1	9	0	0
11	14161073	.	A	G	8	8	16	0	0	16	0	0
11	14161077	.	C	A	8	6	14	0	2	16	0	0
11	14161291	.	A	T	17	13	30	0	0	30	0	0
11	14161304	.	A	G	14	13	27	0	1	28	0	0
11	14291203	.	G	A	1	2	3	0	0	3	0	0
11	14318637	.	A	G	7	5	12	0	1	13	0	0
11	14318647	.	C	G	6	3	9	0	1	10	0	0
11	14341557	.	G	A	2	3	5	0	0	5	0	0
11	14341610	.	C	A	2	2	4	0	0	4	0	0
11	14345562	.	T	G	1	3	4	0	0	4	0	0
11	14345638	.	C	T	6	5	11	0	1	12	0	0
11	14345753	.	A	G	10	7	17	0	0	17	0	0
11	14345830	.	T	C	9	3	12	0	1	13	0	0
11	14345884	.	T	G	5	5	10	0	1	11	0	0
11	14345910	.	A	T	4	4	8	0	0	8	0	0
11	14345922	.	T	G	1	4	5	0	0	5	0	0
11	14639030	.	T	C	0	3	3	0	1	4	0	0
11	14640002	.	G	T	0	2	2	0	4	6	0	0
11	14751068	.	T	C	2	6	8	0	0	8	0	0
11	14957155	.	A	T	4	2	6	0	0	6	0	0
11	15586740	.	C	A	0	0	0	0	1	1	0	0
11	15586792	.	T	G	0	2	2	0	2	4	0	0
11	15833846	.	T	C	4	2	6	0	0	6	0	0
11	15910604	.	G	C	1	3	4	0	0	4	0	0
11	15915274	.	G	T	5	4	9	0	0	9	0	0
11	16006246	.	A	T	1	3	4	0	0	4	0	0
11	16006249	.	T	C	1	3	4	0	0	4	0	0
11	16011116	.	C	T	1	3	4	0	0	4	0	0
11	16011622	.	T	C	3	4	7	0	1	8	0	0
11	16011632	.	T	G	4	0	4	0	5	9	0	0
11	16011705	.	T	C	8	5	13	0	3	16	0	0
11	16011745	.	C	G	7	2	9	0	0	9	0	0
11	16011770	.	T	C	10	4	14	0	1	15	0	0
11	16011807	.	T	C	9	6	15	1	2	18	0	0
11	16012021	.	G	A	6	4	10	0	2	12	0	0
11	16012117	.	G	T	0	14	14	0	11	25	0	0
11	16012140	.	G	A	0	18	18	0	10	28	0	0
11	16012152	.	A	G	9	0	9	0	21	30	0	0
11	16012191	.	C	T	9	14	23	0	0	23	0	0
11	16012201	.	C	T	7	12	19	0	2	21	0	0
11	16012251	.	T	A	7	11	18	0	1	19	0	0
11	16012256	.	C	T	7	10	17	0	1	18	0	0
11	16012316	.	T	G	6	10	16	0	0	16	0	0
11	16012364	.	G	T	0	6	6	0	4	10	0	0
11	16012508	.	A	C	3	3	6	0	0	6	0	0
11	16012512	.	C	T	2	3	5	0	1	6	0	0
11	16012654	.	A	G	6	0	6	0	12	18	0	0
11	16012785	.	T	G	15	15	30	0	0	30	0	0
11	16012786	.	A	G	14	14	28	0	2	30	0	0
11	16012829	.	G	T	15	11	26	0	1	27	0	0
11	16012882	.	G	A	21	10	31	0	0	31	0	0
11	16013018	.	T	C	8	8	16	0	0	16	0	0
11	16019789	.	C	A	0	2	2	0	0	2	0	0
11	16019795	.	A	G	0	2	2	0	0	2	0	0
11	16099700	.	G	A	0	1	1	0	0	1	0	0
11	16104175	.	T	C	2	4	6	0	0	6	0	0
11	16115692	.	C	T	1	6	7	0	0	7	0	0
11	16143781	.	T	C	11	25	36	0	1	37	0	0
11	16143829	.	T	C	15	12	27	0	2	29	0	0
11	16158555	.	G	A	2	4	6	0	1	7	0	0
11	16159056	.	A	G	0	2	2	0	0	2	0	0
11	16159316	.	C	T	0	2	2	0	0	2	0	0
11	16159875	.	T	C	0	1	1	0	0	1	0	0
11	16159903	.	C	T	3	2	5	0	0	5	0	0
11	16165293	.	T	C	9	8	17	0	0	17	0	0
11	16165298	.	G	A	0	8	8	0	9	17	0	0
11	16165474	.	C	T	10	2	12	0	1	13	0	0
11	16165605	.	T	A	13	4	17	0	0	17	0	0
11	16165665	.	A	G	18	9	27	0	2	29	0	0
11	16165710	.	T	A	9	10	19	0	0	19	0	0
11	16165756	.	G	A	13	9	22	0	0	22	0	0
11	16180033	.	G	A	29	23	52	0	2	54	0	0
11	16184739	.	A	G	2	5	7	0	0	7	0	0
11	16587715	.	A	G	4	9	13	0	0	13	0	0
11	16587873	.	A	T	4	2	6	0	0	6	0	0
11	16739039	.	C	T	0	8	8	0	6	14	0	0
11	16849896	.	G	A	1	0	1	0	0	1	0	0
11	17511902	.	C	A	2	8	10	0	1	11	0	0
11	17512139	.	T	C	10	12	22	0	0	22	0	0
11	17512289	.	T	C	12	5	17	0	5	22	0	0
11	17597424	.	G	A	2	3	5	0	0	5	0	0
11	17757767	.	T	C	6	6	12	0	1	13	0	0
11	17763137	.	A	G	7	6	13	0	0	13	0	0
11	17763160	.	T	C	7	6	13	0	0	13	0	0
11	17763173	.	C	A	5	6	11	0	0	11	0	0
11	17763393	.	C	T	5	5	10	0	0	10	0	0
11	17765170	.	C	T	2	3	5	0	0	5	0	0
11	17769238	.	C	T	0	2	2	0	0	2	0	0
11	17769801	.	A	T	2	3	5	0	0	5	0	0
11	17770594	.	C	T	1	3	4	0	1	5	0	0
11	17770627	.	T	C	2	2	4	0	0	4	0	0
11	17771185	.	T	C	1	2	3	0	0	3	0	0
11	17785280	.	C	T	0	2	2	0	2	4	0	0
11	17785402	.	T	G	23	9	32	0	3	35	0	0
11	17785412	.	C	A	23	9	32	0	2	34	0	0
11	17785591	.	A	G	14	8	22	0	3	25	0	0
11	17789069	.	G	T	5	2	7	0	2	9	0	0
11	17789210	.	T	C	1	0	1	0	0	1	0	0
11	17792991	.	C	T	0	3	3	0	3	6	0	0
11	17796869	.	C	T	0	1	1	0	0	1	0	0
11	17984308	.	T	C	3	3	6	0	0	6	0	0
11	17987289	.	C	A	1	1	2	0	0	2	0	0
11	18223383	.	C	T	0	2	2	0	1	3	0	0
11	18238076	.	C	T	3	5	8	0	0	8	0	0
11	18244388	.	T	C	13	6	19	0	5	24	0	0
11	18271303	.	G	A	1	2	3	0	0	3	0	0
11	18287280	.	A	G	3	5	8	0	0	8	0	0
11	18287283	.	A	T	3	6	9	0	0	9	0	0
11	18287693	.	A	G	2	8	10	0	1	11	0	0
11	18287779	.	G	A	5	4	9	0	0	9	0	0
11	18287940	.	A	T	4	2	6	0	1	7	0	0
11	18288018	.	T	C	8	5	13	0	0	13	0	0
11	18288212	.	T	C	5	3	8	0	1	9	0	0
11	18290095	.	G	A	1	1	2	0	0	2	0	0
11	18345539	.	C	A	1	4	5	0	0	5	0	0
11	18345719	.	T	G	2	2	4	0	0	4	0	0
11	18535666	.	C	T	14	19	33	0	3	36	0	0
11	18535761	.	G	C	16	21	37	0	4	41	0	0
11	18537180	.	A	G	3	6	9	0	1	10	0	0
11	18537244	.	G	A	13	5	18	0	2	20	0	0
11	18537561	.	T	A	8	4	12	0	1	13	0	0
11	18537636	.	T	A	9	8	17	0	0	17	0	0
11	18538219	.	A	T	8	9	17	0	2	19	0	0
11	18538259	.	G	T	11	6	17	0	0	17	0	0
11	18538336	.	A	C	2	0	2	0	5	7	0	0
11	18538362	.	T	C	1	0	1	0	5	6	0	0
11	18546378	.	T	A	5	2	7	0	0	7	0	0
11	18547125	.	A	G	9	3	12	0	3	15	0	0
11	18551011	.	C	A	0	2	2	0	1	3	0	0
11	18568971	.	G	A	1	1	2	0	0	2	0	0
11	18572442	.	C	A	0	5	5	0	4	9	0	0
11	18572574	.	G	A	4	5	9	0	0	9	0	0
11	18572586	.	C	T	4	5	9	0	0	9	0	0
11	18572751	.	G	A	2	2	4	0	1	5	0	0
11	18575095	.	C	A	2	3	5	0	0	5	0	0
11	18577787	.	A	G	0	1	1	0	0	1	0	0
11	18697720	.	A	G	1	1	2	0	0	2	0	0
11	18697817	.	T	G	4	4	8	0	0	8	0	0
11	18697822	.	A	G	4	0	4	0	4	8	0	0
11	18698138	.	A	G	1	0	1	0	5	6	0	0
11	18698526	.	G	A	5	7	12	0	0	12	0	0
11	18699104	.	T	C	9	11	20	0	0	20	0	0
11	18704500	.	G	A	22	7	29	0	0	29	0	0
11	18704620	.	C	T	0	16	16	0	8	24	0	0
11	18705108	.	A	G	12	8	20	0	0	20	0	0
11	18784949	.	A	T	9	13	22	0	0	22	0	0
11	18785130	.	A	G	9	19	28	0	3	31	0	0
11	18785250	.	C	T	0	21	21	0	18	39	0	0
11	18785294	.	T	G	11	21	32	0	0	32	0	0
11	18785296	.	C	T	10	21	31	0	1	32	0	0
11	18785346	.	A	T	7	15	22	0	1	23	0	0
11	18785410	.	G	A	10	12	22	0	2	24	0	0
11	18785421	.	A	G	8	13	21	0	1	22	0	0
11	18785570	.	T	A	2	7	9	0	1	10	0	0
11	18785600	.	A	T	1	5	6	0	1	7	0	0
11	18785921	.	G	A	8	8	16	0	0	16	0	0
11	18785975	.	T	C	11	7	18	0	2	20	0	0
11	18785997	.	T	A	13	5	18	0	0	18	0	0
11	18786085	.	A	T	1	3	4	0	0	4	0	0
11	18786250	.	A	C	8	11	19	0	1	20	0	0
11	18786329	.	C	A	0	4	4	0	3	7	0	0
11	18802570	.	T	C	1	2	3	0	0	3	0	0
11	18802815	.	G	C	2	5	7	0	0	7	0	0
11	18802865	.	C	G	2	3	5	0	1	6	0	0
11	18802879	.	A	G	2	3	5	0	0	5	0	0
11	18803621	.	A	G	0	3	3	0	0	3	0	0
11	22363766	.	G	A	8	4	12	0	1	13	0	0
11	22630190	.	T	A	3	2	5	0	0	5	0	0
11	24887652	.	G	A	10	9	19	0	1	20	0	0
11	25615101	.	G	A	0	1	1	0	2	3	0	0
11	25712815	.	T	C	5	2	7	0	0	7	0	0
11	25713768	.	T	C	1	3	4	0	1	5	0	0
11	25713769	.	T	C	2	1	3	0	2	5	0	0
11	26229586	.	T	C	6	2	8	0	1	9	0	0
11	26229587	.	T	C	7	1	8	0	1	9	0	0
11	29918069	.	T	C	2	2	4	1	0	5	0	0
11	29918168	.	T	C	5	4	9	0	0	9	0	0
11	30106459	.	C	A	6	3	9	0	0	9	0	0
11	30107483	.	A	C	3	3	6	0	0	6	0	0
11	30107504	.	T	C	3	3	6	0	0	6	0	0
11	30366797	.	G	A	3	3	6	0	2	8	0	0
11	31558634	.	C	A	4	2	6	0	0	6	0	0
11	31602828	.	G	T	8	7	15	0	2	17	0	0
11	31603346	.	G	A	0	10	10	0	6	16	0	0
11	31667592	.	C	T	2	2	4	0	0	4	0	0
11	31667658	.	C	T	4	2	6	0	1	7	0	0
11	31669622	.	A	G	5	5	10	0	0	10	0	0
11	31670216	.	A	T	2	2	4	0	2	6	0	0
11	31671072	.	T	C	2	1	3	0	1	4	0	0
11	31671165	.	G	C	1	2	3	0	0	3	0	0
11	31671326	.	G	T	0	5	5	0	1	6	0	0
11	31671328	.	T	G	1	5	6	0	0	6	0	0
11	32576695	.	C	T	8	12	20	0	0	20	0	0
11	32577076	.	T	A	3	5	8	0	0	8	0	0
11	32577258	.	C	T	0	5	5	0	3	8	0	0
11	32577404	.	A	G	5	7	12	0	4	16	0	0
11	32577439	.	G	A	4	9	13	0	0	13	0	0
11	32577800	.	G	A	6	3	9	0	0	9	0	0
11	32577830	.	G	A	4	6	10	0	0	10	0	0
11	32578082	.	C	T	1	2	3	0	1	4	0	0
11	32578172	.	G	A	3	5	8	0	0	8	0	0
11	32720427	.	A	T	2	2	4	0	0	4	0	0
11	32721144	.	A	G	1	3	4	0	0	4	0	0
11	32721168	.	A	G	1	1	2	0	1	3	0	0
11	33551200	.	T	C	0	1	1	0	0	1	0	0
11	33553873	.	T	C	7	5	12	0	1	13	0	0
11	33554087	.	G	A	4	4	8	0	2	10	0	0
11	33554116	.	G	A	6	3	9	0	0	9	0	0
11	33554535	.	T	C	8	6	14	0	0	14	0	0
11	33598663	.	T	A	5	2	7	0	0	7	0	0
11	33598972	.	A	G	1	3	4	0	1	5	0	0
11	33599038	.	T	C	5	2	7	0	1	8	0	0
11	33599148	.	T	C	6	12	18	0	0	18	0	0
11	33599223	.	A	G	15	10	25	0	1	26	0	0
11	33599240	.	A	T	14	11	25	0	1	26	0	0
11	33599464	.	C	T	0	5	5	0	4	9	0	0
11	33827023	.	G	A	0	1	1	0	0	1	0	0
11	33829443	.	A	G	1	1	2	0	0	2	0	0
11	33829515	.	A	G	1	2	3	0	1	4	0	0
11	33832679	.	C	T	2	5	7	0	0	7	0	0
11	33834700	.	A	G	0	3	3	0	1	4	0	0
11	33835385	.	C	A	2	3	5	0	0	5	0	0
11	33835542	.	T	C	4	5	9	0	0	9	0	0
11	33841788	.	C	T	8	6	14	0	1	15	0	0
11	33841984	.	C	T	6	16	22	0	2	24	0	0
11	33842676	.	G	A	2	3	5	0	0	5	0	0
11	33846497	.	T	C	3	2	5	0	0	5	0	0
11	33846505	.	T	C	2	0	2	0	2	4	0	0
11	33846566	.	T	C	0	4	4	0	0	4	0	0
11	33846583	.	A	G	1	2	3	0	0	3	0	0
11	33870464	.	A	T	3	3	6	0	1	7	0	0
11	33871043	.	T	G	4	5	9	0	0	9	0	0
11	33871099	.	G	A	3	2	5	0	1	6	0	0
11	33871197	.	T	C	4	1	5	0	9	14	0	0
11	33871343	.	G	T	0	7	7	0	0	7	0	0
11	33871358	.	G	T	2	3	5	0	0	5	0	0
11	33871378	.	G	T	4	6	10	0	0	10	0	0
11	33871466	.	A	G	3	11	14	2	1	17	0	0
11	33871575	.	A	G	20	16	36	0	0	36	0	0
11	33871897	.	C	T	11	3	14	0	4	18	0	0
11	33871931	.	G	C	13	3	16	0	0	16	0	0
11	33871932	.	C	A	12	3	15	0	1	16	0	0
11	33872411	.	A	C	5	4	9	0	0	9	0	0
11	33872564	.	G	T	4	3	7	0	0	7	0	0
11	33872661	.	A	G	2	3	5	0	0	5	0	0
11	33872684	.	C	T	3	4	7	0	1	8	0	0
11	33872699	.	A	G	2	3	5	0	0	5	0	0
11	33872759	.	A	G	1	2	3	0	0	3	0	0
11	33872763	.	A	C	1	2	3	0	0	3	0	0
11	33872829	.	C	T	0	3	3	0	4	7	0	0
11	33873539	.	C	T	0	3	3	0	7	10	0	0
11	33997814	.	T	C	3	2	5	0	0	5	0	0
11	33997820	.	G	T	3	2	5	0	0	5	0	0
11	34235427	.	C	A	1	6	7	0	0	7	0	0
11	34235825	.	A	T	1	6	7	0	0	7	0	0
11	34235858	.	A	C	4	6	10	0	1	11	0	0
11	34236848	.	G	A	2	2	4	0	0	4	0	0
11	34779198	.	T	C	0	3	3	0	0	3	0	0
11	34780009	.	T	C	4	1	5	0	6	11	0	0
11	34780333	.	G	A	0	1	1	0	1	2	0	0
11	34910897	.	A	G	0	2	2	0	1	3	0	0
11	34911229	.	G	A	5	3	8	0	0	8	0	0
11	34911445	.	A	G	8	10	18	0	0	18	0	0
11	34911451	.	T	A	8	8	16	0	1	17	0	0
11	34912481	.	G	A	8	5	13	0	1	14	0	0
11	34912616	.	G	A	4	13	17	0	1	18	0	0
11	34912850	.	G	A	11	7	18	0	0	18	0	0
11	34913101	.	C	A	6	5	11	0	2	13	0	0
11	34913370	.	T	A	11	19	30	0	1	31	0	0
11	34913454	.	G	A	1	6	7	0	0	7	0	0
11	34914190	.	G	A	14	19	33	0	0	33	0	0
11	35034669	.	G	A	3	3	6	0	0	6	0	0
11	35038124	.	G	C	0	3	3	0	5	9	1	0
11	35439907	.	A	T	7	3	10	0	1	11	0	0
11	35759755	.	T	A	7	3	10	0	1	11	0	0
11	36208328	.	G	A	0	2	2	0	1	3	0	0
11	36214517	.	C	T	8	7	15	0	1	16	0	0
11	36214815	.	G	A	0	7	7	0	11	18	0	0
11	36214859	.	C	T	7	14	21	0	0	21	0	0
11	36214955	.	A	T	5	7	12	0	2	14	0	0
11	36215346	.	G	A	8	11	19	0	3	22	0	0
11	36215399	.	A	G	11	17	28	0	3	31	0	0
11	36255011	.	T	C	7	3	10	0	0	10	0	0
11	36269768	.	A	G	0	1	1	0	0	1	0	0
11	36269788	.	A	G	0	1	1	0	0	1	0	0
11	36281814	.	G	A	0	11	11	0	1	12	0	0
11	36281939	.	T	G	8	5	13	0	3	16	0	0
11	36281943	.	G	A	8	6	14	0	0	14	0	0
11	36282343	.	G	A	5	2	7	0	1	8	0	0
11	36282417	.	G	T	5	4	9	0	0	9	0	0
11	36282450	.	G	T	2	4	6	0	1	7	0	0
11	36282494	.	G	T	1	3	4	0	0	4	0	0
11	36282501	.	C	T	3	2	5	0	1	6	0	0
11	36282625	.	T	C	3	3	6	0	0	6	0	0
11	36282961	.	G	A	1	2	3	0	1	4	0	0
11	36343167	.	G	C	21	15	36	0	1	37	0	0
11	36343339	.	A	T	1	1	2	0	0	2	0	0
11	36374993	.	G	T	2	2	4	0	0	4	0	0
11	36375120	.	T	G	0	2	2	0	1	3	0	0
11	36375671	.	C	T	10	9	19	0	0	19	0	0
11	36375708	.	A	G	10	10	20	0	0	20	0	0
11	36375774	.	A	T	5	8	13	0	1	14	0	0
11	36375852	.	T	G	8	5	13	0	5	19	1	0
11	36393150	.	T	A	1	5	6	0	0	6	0	0
11	36395728	.	T	C	1	2	3	0	0	3	0	0
11	36398192	.	G	A	0	3	3	0	2	5	0	0
11	36398318	.	A	G	4	4	8	0	1	9	0	0
11	36398558	.	T	A	6	3	9	0	1	10	0	0
11	36398624	.	C	T	4	3	7	0	1	8	0	0
11	36452372	.	G	A	4	3	7	0	0	7	0	0
11	36452453	.	C	A	2	3	5	0	1	6	0	0
11	36452534	.	C	A	1	4	5	0	0	5	0	0
11	36456101	.	T	A	3	6	9	0	1	10	0	0
11	36456125	.	A	C	2	0	2	0	6	8	0	0
11	36460829	.	G	A	6	2	8	0	0	8	0	0
11	36464541	.	T	A	1	1	2	0	0	2	0	0
11	36470493	.	C	T	0	0	0	0	1	1	0	0
11	36489169	.	G	C	2	0	2	0	1	3	0	0
11	36489205	.	T	C	3	4	7	0	1	8	0	0
11	36489428	.	A	T	2	2	4	0	0	4	0	0
11	36489572	.	G	T	4	2	6	0	0	6	0	0
11	36489706	.	T	C	4	7	11	0	1	12	0	0
11	37031950	.	C	T	4	2	6	0	0	6	0	0
11	37032626	.	T	C	3	2	5	0	0	5	0	0
11	37033356	.	G	T	3	2	5	0	1	6	0	0
11	37033676	.	C	T	3	3	6	0	0	6	0	0
11	37033813	.	C	G	5	5	10	0	0	10	0	0
11	37033846	.	G	C	3	4	7	0	2	9	0	0
11	37033855	.	T	A	2	5	7	0	0	7	0	0
11	37034474	.	A	T	1	1	2	0	1	3	0	0
11	37035176	.	A	T	4	3	7	0	0	7	0	0
11	37035240	.	T	A	10	9	19	0	5	24	0	0
11	37035454	.	A	G	22	0	22	0	21	43	0	0
11	37169144	.	G	A	2	5	7	0	0	7	0	0
11	37169238	.	G	A	1	2	3	0	0	3	0	0
11	37297678	.	C	T	17	17	34	1	1	36	0	0
11	37297681	.	A	G	12	16	28	1	4	37	4	0
11	37297811	.	A	T	22	24	46	1	0	47	0	0
11	37297951	.	T	C	34	15	49	0	1	50	0	0
11	37298028	.	T	A	14	15	29	0	2	31	0	0
11	37298569	.	A	G	17	15	32	0	7	39	0	0
11	37298718	.	G	A	13	12	25	0	4	29	0	0
11	37298755	.	G	A	10	13	23	0	2	25	0	0
11	37299378	.	A	T	11	5	16	0	1	17	0	0
11	37431953	.	C	T	32	23	55	0	3	58	0	0
11	37434533	.	A	G	4	27	31	0	1	32	0	0
11	37442772	.	G	T	1	4	5	0	1	6	0	0
11	37613515	.	G	A	4	1	5	0	1	6	0	0
11	37613577	.	G	A	2	3	5	0	2	7	0	0
11	37613641	.	A	G	3	5	8	0	1	9	0	0
11	37616775	.	T	C	3	5	8	0	0	8	0	0
11	37710340	.	G	A	2	2	4	0	0	4	0	0
11	38505380	.	G	A	8	5	13	0	1	14	0	0
11	38505489	.	G	A	9	7	16	0	0	16	0	0
11	38540824	.	C	T	24	12	36	0	2	38	0	0
11	38541355	.	A	G	18	9	27	0	0	27	0	0
11	38542142	.	G	A	1	4	5	0	0	5	0	0
11	38545874	.	C	G	0	12	12	0	8	20	0	0
11	38853397	.	A	T	1	2	3	0	0	3	0	0
11	38868012	.	G	T	3	2	5	0	0	5	0	0
11	38874937	.	G	A	21	10	31	0	2	33	0	0
11	38875221	.	A	G	15	19	34	0	1	35	0	0
11	38875283	.	A	T	14	20	34	0	4	38	0	0
11	38875352	.	G	A	16	11	27	0	0	27	0	0
11	38875397	.	T	G	21	2	23	0	1	24	0	0
11	38875484	.	A	C	14	15	29	0	0	29	0	0
11	38875498	.	C	A	14	15	29	0	0	29	0	0
11	38875660	.	T	C	15	14	29	0	0	29	0	0
11	38875867	.	T	C	1	6	7	0	0	7	0	0
11	38876156	.	T	A	1	2	3	0	0	3	0	0
11	38876195	.	T	G	2	2	4	0	0	4	0	0
11	38876210	.	G	A	0	2	2	0	1	3	0	0
11	39076138	.	C	T	0	3	3	0	0	3	0	0
11	39107156	.	C	T	1	1	2	0	0	2	0	0
11	39109555	.	C	T	2	3	5	0	0	5	0	0
11	39112035	.	A	G	11	7	18	0	1	19	0	0
11	39112068	.	C	T	6	6	12	0	0	12	0	0
11	39141527	.	A	G	29	20	49	0	2	51	0	0
11	39141732	.	T	G	5	11	16	0	1	17	0	0
11	39141924	.	G	T	7	8	15	0	3	18	0	0
11	39147065	.	T	C	11	5	16	0	0	16	0	0
11	39147085	.	C	T	9	6	15	0	0	15	0	0
11	39147387	.	T	C	14	8	22	0	1	23	0	0
11	39147445	.	G	C	19	9	28	0	4	32	0	0
11	39147857	.	G	C	8	20	28	0	3	33	2	0
11	39147905	.	C	A	15	23	38	0	0	38	0	0
11	39147906	.	A	T	15	22	37	0	1	38	0	0
11	39147989	.	T	C	24	11	35	0	14	49	0	0
11	39148015	.	C	T	17	19	36	0	5	41	0	0
11	39922714	.	A	C	6	7	13	0	0	13	0	0
11	40020376	.	A	G	4	6	10	0	0	10	0	0
11	40622834	.	C	A	2	2	4	0	0	4	0	0
11	40657839	.	G	A	1	2	3	0	1	4	0	0
11	40657905	.	G	A	2	2	4	0	3	7	0	0
11	40658022	.	C	T	2	4	6	0	0	6	0	0
11	40658352	.	G	A	0	2	2	0	3	5	0	0
11	40661378	.	T	C	2	1	3	0	0	3	0	0
11	40665494	.	C	T	2	0	2	0	0	2	0	0
11	40665602	.	G	T	0	12	12	0	19	31	0	0
11	40673658	.	T	G	8	7	15	0	3	18	0	0
11	40673797	.	C	T	16	16	32	0	2	34	0	0
11	40677967	.	T	C	36	18	54	0	3	57	0	0
11	40843502	.	C	T	2	2	4	0	0	4	0	0
11	40844195	.	A	T	0	8	8	0	0	8	0	0
11	40845006	.	C	T	12	11	23	0	2	25	0	0
11	40845071	.	C	T	7	6	13	0	0	13	0	0
11	40845080	.	G	A	0	3	3	0	5	8	0	0
11	41066765	.	T	G	8	10	18	0	3	21	0	0
11	41066871	.	C	T	15	10	25	0	0	25	0	0
11	41066888	.	C	T	13	16	29	0	0	29	0	0
11	41066950	.	A	G	10	17	27	0	1	28	0	0
11	41067275	.	G	A	7	9	16	0	1	17	0	0
11	41067430	.	A	T	4	10	14	0	0	14	0	0
11	41067442	.	C	T	4	12	16	0	1	17	0	0
11	41078578	.	A	T	7	4	11	0	0	11	0	0
11	41078762	.	A	T	3	2	5	0	0	5	0	0
11	41101666	.	A	G	3	2	5	0	0	5	0	0
11	41105030	.	G	A	0	2	2	0	3	5	0	0
11	41111301	.	A	G	8	11	19	0	0	19	0	0
11	41111334	.	T	C	4	11	15	0	2	17	0	0
11	41111370	.	C	T	3	8	11	0	0	11	0	0
11	41111422	.	A	G	6	3	9	0	0	9	0	0
11	41111431	.	A	C	5	3	8	0	0	8	0	0
11	41216254	.	C	G	0	5	5	0	4	9	0	0
11	41216315	.	C	T	0	6	6	0	5	11	0	0
11	41216445	.	A	C	9	6	15	0	0	15	0	0
11	41216455	.	T	C	7	0	7	0	13	20	0	0
11	41216505	.	G	C	2	11	13	0	0	13	0	0
11	41216586	.	C	T	5	5	10	0	0	10	0	0
11	41222940	.	A	G	10	5	15	0	0	15	0	0
11	41459981	.	G	C	0	2	2	0	1	3	0	0
11	41461369	.	T	C	3	2	5	0	0	5	0	0
11	41461417	.	C	G	8	3	11	0	0	11	0	0
11	41468791	.	C	T	2	5	7	0	0	7	0	0
11	41474041	.	T	A	7	6	13	0	0	13	0	0
11	41474042	.	G	T	7	6	13	0	0	13	0	0
11	41844107	.	T	C	1	0	1	0	1	2	0	0
11	41845852	.	A	T	7	4	11	0	0	11	0	0
11	41846123	.	A	C	4	0	4	0	7	11	0	0
11	41846429	.	C	A	4	6	10	0	0	10	0	0
11	41846430	.	C	A	0	6	6	0	4	10	0	0
11	41850058	.	A	G	2	2	4	0	0	4	0	0
11	42305824	.	C	T	4	6	10	0	1	11	0	0
11	42306057	.	C	T	5	5	10	1	0	11	0	0
11	42306627	.	C	T	0	9	9	0	7	16	0	0
11	42306928	.	A	T	15	8	23	0	1	24	0	0
11	42307147	.	T	A	11	13	24	0	1	25	0	0
11	42307344	.	T	G	7	7	14	0	2	16	0	0
11	42307400	.	A	T	8	7	15	0	2	17	0	0
11	42315366	.	G	C	4	3	7	0	0	7	0	0
11	42319340	.	C	T	1	2	3	0	1	4	0	0
11	42329113	.	C	T	2	2	4	0	0	4	0	0
11	42355806	.	C	T	1	1	2	0	0	2	0	0
11	42502031	.	C	T	0	2	2	0	1	3	0	0
11	42502661	.	C	A	1	2	3	0	0	3	0	0
11	42506576	.	T	A	4	3	7	0	0	7	0	0
11	42521982	.	C	G	2	4	6	0	1	7	0	0
11	42521999	.	G	A	4	4	8	0	0	8	0	0
11	42557693	.	A	G	7	8	15	0	2	17	0	0
11	42561212	.	C	A	3	2	5	0	1	6	0	0
11	42730834	.	C	G	7	6	13	0	0	13	0	0
11	42730901	.	C	T	18	6	24	0	0	24	0	0
11	42731172	.	G	T	6	5	11	0	0	11	0	0
11	42732358	.	T	C	4	6	10	0	3	13	0	0
11	42809579	.	T	G	3	2	5	0	1	6	0	0
11	42816189	.	G	A	6	1	7	0	0	7	0	0
11	42816208	.	A	T	5	1	6	0	0	6	0	0
11	42816446	.	A	G	5	3	8	1	0	9	0	0
11	42816496	.	A	G	6	3	9	0	1	10	0	0
11	42816859	.	C	T	3	1	4	0	1	5	0	0
11	42816886	.	C	T	1	1	2	0	0	2	0	0
11	42816977	.	A	T	1	2	3	0	0	3	0	0
11	42817067	.	A	G	7	4	11	0	0	11	0	0
11	42817113	.	A	T	7	10	17	0	1	18	0	0
11	42817534	.	G	A	10	9	19	0	1	20	0	0
11	42817552	.	A	G	12	10	22	0	0	22	0	0
11	42912038	.	C	A	2	4	6	0	0	6	0	0
11	42912039	.	A	G	1	3	4	0	2	6	0	0
11	42912098	.	T	C	5	2	7	0	0	7	0	0
11	42912164	.	C	T	0	1	1	0	1	2	0	0
11	42912594	.	A	T	2	3	5	0	0	5	0	0
11	42912870	.	G	C	2	2	4	0	0	4	0	0
11	42933167	.	G	A	14	6	20	0	0	20	0	0
11	42933696	.	A	G	8	4	12	0	0	12	0	0
11	42933703	.	T	C	7	4	11	0	0	11	0	0
11	42933813	.	A	G	3	3	6	0	0	6	0	0
11	42933832	.	C	T	2	0	2	0	0	2	0	0
11	42942852	.	T	C	0	1	1	0	0	1	0	0
11	42942930	.	G	A	2	4	6	0	0	6	0	0
11	42974959	.	G	T	1	0	1	0	0	1	0	0
11	42974962	.	G	A	1	0	1	0	0	1	0	0
11	43115998	.	C	T	5	2	7	0	0	7	0	0
11	43137659	.	C	T	4	4	8	0	0	8	0	0
11	43151260	.	C	T	3	4	7	0	1	8	0	0
11	43387562	.	C	T	3	4	7	0	0	7	0	0
11	43387576	.	T	C	1	2	3	0	0	3	0	0
11	44144749	.	A	C	8	9	17	0	3	20	0	0
11	44144820	.	A	G	15	23	38	0	1	39	0	0
11	44144958	.	T	G	26	27	53	0	2	55	0	0
11	44145001	.	T	A	30	19	49	0	3	52	0	0
11	44149701	.	T	C	3	0	3	0	7	10	0	0
11	44152750	.	A	G	14	4	18	0	0	18	0	0
11	44152795	.	T	C	7	9	16	0	0	16	0	0
11	44155422	.	G	A	0	2	2	0	0	2	0	0
11	44155703	.	C	A	2	3	5	0	1	6	0	0
11	44155706	.	C	T	0	2	2	0	3	5	0	0
11	44328905	.	A	G	14	15	29	0	4	33	0	0
11	44328956	.	T	C	28	12	40	0	0	40	0	0
11	44329050	.	A	G	21	9	30	0	2	32	0	0
11	44334935	.	T	A	24	17	41	0	4	45	0	0
11	44359735	.	C	A	7	3	10	0	0	10	0	0
11	44401057	.	C	A	3	2	5	0	0	5	0	0
11	44401275	.	G	A	2	2	4	0	1	5	0	0
11	44445554	.	A	G	1	2	3	0	0	3	0	0
11	44445561	.	C	T	1	2	3	0	0	3	0	0
11	44452790	.	T	C	4	0	4	0	11	15	0	0
11	44452797	.	C	T	0	9	9	0	4	13	0	0
11	44452849	.	G	A	14	6	20	0	2	22	0	0
11	44466931	.	T	C	3	1	4	0	0	4	0	0
11	44468838	.	G	A	0	2	2	0	1	3	0	0
11	44468842	.	T	C	0	3	3	0	0	3	0	0
11	44522835	.	T	C	2	2	4	0	0	4	0	0
11	44523385	.	C	A	1	2	3	0	0	3	0	0
11	44523420	.	C	A	2	2	4	0	0	4	0	0
11	44524164	.	A	G	2	0	2	0	6	8	0	0
11	44524257	.	T	C	0	8	8	0	0	8	0	0
11	44524391	.	G	A	8	3	11	0	1	12	0	0
11	44524423	.	T	G	7	8	15	0	1	16	0	0
11	44524448	.	G	A	0	7	7	0	7	14	0	0
11	44524583	.	T	C	5	4	9	0	2	11	0	0
11	44524631	.	T	C	9	3	12	0	2	14	0	0
11	44524673	.	T	C	6	10	16	0	0	16	0	0
11	44524834	.	G	T	0	9	9	0	13	22	0	0
11	44527087	.	G	T	8	9	17	0	0	17	0	0
11	44527115	.	T	A	12	15	27	0	1	28	0	0
11	44527134	.	G	C	17	16	33	0	0	33	0	0
11	44527183	.	T	C	17	1	18	0	19	37	0	0
11	44527367	.	G	A	18	21	39	0	3	42	0	0
11	44527744	.	G	A	12	12	24	0	2	26	0	0
11	44528307	.	C	T	11	5	16	0	0	16	0	0
11	44528311	.	C	T	0	5	5	0	12	17	0	0
11	44528351	.	A	C	4	8	12	0	1	13	0	0
11	44528405	.	G	A	7	8	15	0	1	16	0	0
11	44528481	.	A	G	9	6	15	0	1	16	0	0
11	44528539	.	A	G	8	5	13	0	0	13	0	0
11	44528694	.	A	G	1	3	4	0	0	4	0	0
11	44528704	.	A	G	0	3	3	0	1	4	0	0
11	44528877	.	A	T	5	6	11	0	0	11	0	0
11	44528927	.	G	T	4	2	6	0	0	6	0	0
11	44529193	.	T	C	2	3	5	0	0	5	0	0
11	44529195	.	T	A	3	2	5	0	0	5	0	0
11	44529719	.	G	A	3	6	9	0	0	9	0	0
11	44606861	.	C	T	9	9	18	0	0	18	0	0
11	44606883	.	G	C	6	4	10	0	0	10	0	0
11	44606908	.	T	G	0	1	1	0	0	1	0	0
11	44607291	.	T	A	7	9	16	0	2	18	0	0
11	44607303	.	A	T	9	10	19	0	0	19	0	0
11	44634802	.	A	C	8	6	14	0	5	19	0	0
11	44634828	.	C	A	6	11	17	0	0	17	0	0
11	44637569	.	T	A	5	6	11	0	0	11	0	0
11	44637704	.	C	T	0	16	16	0	18	34	0	0
11	44637714	.	T	C	21	0	21	0	15	36	0	0
11	44637802	.	G	A	20	13	33	0	1	34	0	0
11	44637950	.	A	G	17	23	40	0	0	40	0	0
11	44637953	.	G	T	23	16	39	0	1	40	0	0
11	44638006	.	G	A	6	0	6	0	2	8	0	0
11	44643882	.	C	T	1	5	6	0	0	6	0	0
11	44723130	.	C	G	3	2	5	0	0	5	0	0
11	44723353	.	G	A	0	10	10	0	11	21	0	0
11	44723500	.	C	T	4	12	16	0	0	16	0	0
11	44723746	.	A	G	12	13	25	0	4	29	0	0
11	44725376	.	C	T	19	16	35	0	0	35	0	0
11	44726119	.	C	T	26	16	42	0	6	48	0	0
11	44854847	.	A	G	0	4	4	0	1	5	0	0
11	44854850	.	T	C	1	4	5	0	0	5	0	0
11	44855027	.	G	A	0	2	2	0	1	3	0	0
11	44880288	.	A	G	11	13	24	0	2	26	0	0
11	44880291	.	T	A	10	14	24	0	2	26	0	0
11	44880332	.	G	A	7	11	18	0	1	19	0	0
11	44880345	.	C	G	10	4	14	0	1	15	0	0
11	44887200	.	G	A	8	14	22	0	0	22	0	0
11	44887612	.	G	T	9	8	17	0	0	17	0	0
11	44891507	.	G	A	0	1	1	0	0	1	0	0
11	44892883	.	G	A	1	1	2	0	0	2	0	0
11	44892943	.	G	A	1	2	3	0	0	3	0	0
11	44897584	.	C	T	1	7	8	0	0	8	0	0
11	44897647	.	A	C	2	5	7	0	1	8	0	0
11	44901315	.	C	T	1	14	15	0	11	26	0	0
11	44901373	.	C	A	33	32	65	0	4	69	0	0
11	44912485	.	C	A	0	2	2	0	1	3	0	0
11	44935861	.	G	C	9	7	16	0	1	17	0	0
11	45127352	.	C	G	2	5	7	0	0	7	0	0
11	45139844	.	A	G	5	9	14	0	1	15	0	0
11	45139866	.	C	A	6	11	17	0	0	17	0	0
11	45140210	.	G	C	0	2	2	0	0	2	0	0
11	45141271	.	G	A	3	8	11	0	0	11	0	0
11	45159540	.	A	C	1	2	3	0	1	4	0	0
11	45161381	.	A	T	5	3	8	0	0	8	0	0
11	45161878	.	T	C	3	2	5	0	0	5	0	0
11	45161950	.	T	C	0	0	0	0	4	4	0	0
11	45161975	.	C	A	0	2	2	0	1	3	0	0
11	45167709	.	G	A	1	4	5	0	0	5	0	0
11	45244372	.	C	T	1	3	4	0	1	5	0	0
11	45244481	.	C	T	1	2	3	0	1	4	0	0
11	45245103	.	T	C	4	2	6	0	0	6	0	0
11	45245811	.	G	A	3	2	5	0	0	5	0	0
11	45262014	.	T	C	2	2	4	0	0	4	0	0
11	45262155	.	T	C	1	2	3	0	2	5	0	0
11	45262379	.	G	T	5	2	7	0	0	7	0	0
11	45290989	.	A	C	2	0	2	0	0	2	0	0
11	45292918	.	G	A	0	3	3	0	5	8	0	0
11	45294497	.	C	T	22	4	26	1	0	27	0	0
11	45294807	.	T	C	16	0	16	0	0	16	0	0
11	45343033	.	A	G	1	2	3	0	0	3	0	0
11	45344080	.	C	T	1	0	1	0	0	1	0	0
11	45344129	.	G	A	0	1	1	0	0	1	0	0
11	45350728	.	C	T	1	4	5	0	0	5	0	0
11	45355011	.	C	T	0	9	9	0	13	22	0	0
11	45355022	.	C	G	9	12	21	0	2	23	0	0
11	45355155	.	C	T	10	11	21	0	2	23	0	0
11	45355394	.	C	T	0	10	10	0	22	32	0	0
11	45355606	.	G	C	12	5	17	0	2	19	0	0
11	45356041	.	T	A	0	5	5	0	0	5	0	0
11	45356042	.	G	A	0	5	5	0	0	5	0	0
11	45356114	.	G	A	7	9	16	0	1	17	0	0
11	45356296	.	C	T	0	2	2	0	7	9	0	0
11	45356660	.	C	T	0	1	1	0	4	5	0	0
11	45359173	.	G	A	1	0	1	0	0	1	0	0
11	45362324	.	T	C	1	0	1	0	0	1	0	0
11	45391400	.	C	T	4	1	5	0	1	6	0	0
11	45391683	.	G	A	0	4	4	0	3	7	0	0
11	45391727	.	T	C	4	4	8	0	0	8	0	0
11	45391788	.	C	T	1	3	4	0	0	4	0	0
11	45393468	.	G	T	20	26	46	0	2	48	0	0
11	45395572	.	G	A	0	13	13	0	11	24	0	0
11	45399925	.	C	T	24	13	37	0	2	39	0	0
11	45399985	.	G	T	0	20	20	0	22	42	0	0
11	45403525	.	G	A	7	5	12	0	0	12	0	0
11	45454748	.	C	A	0	1	1	0	0	1	0	0
11	45460271	.	G	A	0	0	0	0	3	3	0	0
11	45463352	.	T	C	3	1	4	0	0	4	0	0
11	45463835	.	G	T	11	7	18	0	1	19	0	0
11	45464098	.	A	G	4	5	9	0	1	10	0	0
11	45464817	.	T	G	10	4	14	0	1	15	0	0
11	45464835	.	G	A	10	7	17	0	0	17	0	0
11	45464880	.	C	T	18	8	26	0	0	26	0	0
11	45465080	.	T	A	15	17	32	0	1	33	0	0
11	45468906	.	T	A	2	4	6	0	0	6	0	0
11	45468959	.	G	A	4	3	7	0	0	7	0	0
11	45469739	.	G	A	1	3	4	0	0	4	0	0
11	45470277	.	C	T	1	3	4	0	4	8	0	0
12	53328	.	G	A	0	1	1	0	0	1	0	0
12	466221	.	G	C	1	2	3	0	0	3	0	0
12	499855	.	C	T	2	1	3	0	0	3	0	0
12	499865	.	C	T	2	1	3	0	0	3	0	0
12	502221	.	C	T	4	4	8	0	0	8	0	0
12	503308	.	G	A	8	7	15	0	0	15	0	0
12	516845	.	C	T	0	2	2	0	0	2	0	0
12	518107	.	T	C	2	3	5	0	0	5	0	0
12	527402	.	A	C	19	14	33	0	1	34	0	0
12	527693	.	T	G	17	24	41	0	2	43	0	0
12	527712	.	T	C	15	17	32	0	4	36	0	0
12	550973	.	T	C	1	3	4	0	0	4	0	0
12	560710	.	G	T	2	3	5	0	0	5	0	0
12	560797	.	T	C	3	7	10	0	0	10	0	0
12	561131	.	G	T	3	2	5	0	0	5	0	0
12	562200	.	C	T	2	2	4	0	1	5	0	0
12	562203	.	C	T	0	2	2	0	2	4	0	0
12	564650	.	G	T	2	1	3	0	2	5	0	0
12	630495	.	G	A	1	4	5	0	0	5	0	0
12	847787	.	T	C	10	16	26	0	0	26	0	0
12	850303	.	T	C	1	1	2	0	0	2	0	0
12	906722	.	A	G	3	1	4	0	0	4	0	0
12	911042	.	C	T	0	2	2	0	1	3	0	0
12	911162	.	G	C	2	3	5	0	1	6	0	0
12	911180	.	A	C	2	3	5	0	0	5	0	0
12	931371	.	G	A	2	2	4	0	0	4	0	0
12	931410	.	C	A	0	2	2	0	2	4	0	0
12	964877	.	T	C	8	0	8	0	17	25	0	0
12	964888	.	T	G	7	14	21	0	1	22	0	0
12	982979	.	T	A	10	8	18	0	1	19	0	0
12	983074	.	C	T	8	1	9	0	1	10	0	0
12	983176	.	T	A	8	8	16	0	2	18	0	0
12	983222	.	G	A	6	3	9	0	1	10	0	0
12	983340	.	C	T	9	12	21	0	1	22	0	0
12	993176	.	T	C	3	2	5	0	0	5	0	0
12	993237	.	C	G	4	8	12	0	0	12	0	0
12	1014553	.	C	T	0	12	12	0	7	19	0	0
12	1014668	.	A	G	4	13	17	0	0	17	0	0
12	1015197	.	C	T	0	10	10	0	4	14	0	0
12	1015845	.	G	A	5	10	15	0	0	15	0	0
12	1019123	.	C	T	0	2	2	0	3	5	0	0
12	1019243	.	G	T	3	2	5	0	0	6	1	0
12	1019311	.	C	G	1	1	2	0	1	3	0	0
12	2744279	.	G	T	1	4	5	0	0	5	0	0
12	2744291	.	A	T	1	4	5	0	0	5	0	0
12	2849970	.	A	G	1	7	8	0	0	8	0	0
12	3271125	.	A	G	3	2	5	0	0	5	0	0
12	3271399	.	A	G	2	3	5	0	1	6	0	0
12	3271809	.	A	G	2	3	5	0	0	5	0	0
12	3272421	.	A	G	5	11	16	0	1	17	0	0
12	3272454	.	A	G	9	5	14	0	1	15	0	0
12	3287912	.	G	A	2	3	5	0	2	7	0	0
12	3574348	.	G	A	10	20	30	0	1	31	0	0
12	3574398	.	C	G	6	19	25	0	0	25	0	0
12	3574581	.	A	T	1	6	7	0	0	7	0	0
12	3714731	.	T	C	2	6	8	0	0	8	0	0
12	3714977	.	T	C	3	0	3	0	12	15	0	0
12	3715261	.	A	T	5	7	12	0	0	12	0	0
12	3715292	.	T	G	5	7	12	0	0	12	0	0
12	3715327	.	C	A	1	4	5	0	0	5	0	0
12	3715329	.	C	G	1	4	5	0	0	5	0	0
12	3723786	.	C	G	6	4	10	0	0	10	0	0
12	3723963	.	G	A	0	4	4	0	8	12	0	0
12	3731590	.	G	A	2	1	3	0	6	9	0	0
12	3731602	.	C	A	4	5	9	0	1	10	0	0
12	6543458	.	C	G	11	2	13	0	1	14	0	0
12	6549689	.	A	G	0	1	1	0	0	1	0	0
12	6576130	.	A	T	1	0	1	0	0	1	0	0
12	6766140	.	C	T	0	1	1	0	0	1	0	0
12	7193865	.	C	T	4	9	13	0	2	15	0	0
12	7193874	.	A	G	7	11	18	0	2	20	0	0
12	7194410	.	A	G	8	13	21	0	0	21	0	0
12	7194505	.	T	C	13	11	24	0	0	24	0	0
12	7194522	.	T	C	14	12	26	0	0	26	0	0
12	7194587	.	G	A	7	2	9	0	1	10	0	0
12	7194677	.	G	C	2	2	4	0	0	4	0	0
12	7194843	.	C	A	2	6	8	0	0	8	0	0
12	7195081	.	G	T	5	6	11	0	0	11	0	0
12	7195139	.	A	T	9	4	13	0	0	13	0	0
12	7195192	.	G	T	1	22	23	0	0	23	0	0
12	7195365	.	T	C	8	5	13	0	1	14	0	0
12	7195454	.	T	A	2	6	8	0	1	9	0	0
12	7195524	.	G	T	2	6	8	0	0	8	0	0
12	7195588	.	G	A	5	4	9	1	1	11	0	0
12	7195600	.	T	C	4	7	11	0	0	11	0	0
12	7195676	.	C	T	0	3	3	0	5	8	0	0
12	7195816	.	C	A	1	2	3	0	0	3	0	0
12	7195888	.	T	C	1	3	4	0	0	4	0	0
12	7196059	.	G	A	1	6	7	0	2	9	0	0
12	7196114	.	G	A	4	3	7	0	0	7	0	0
12	7196125	.	A	G	2	3	5	0	0	5	0	0
12	7196201	.	G	A	2	2	4	0	0	4	0	0
12	7196249	.	G	T	4	3	7	0	0	7	0	0
12	7237756	.	G	A	1	2	3	0	1	4	0	0
12	7263657	.	G	T	0	5	5	0	5	10	0	0
12	7263665	.	G	T	0	4	4	0	5	9	0	0
12	7512469	.	C	T	2	2	4	0	0	4	0	0
12	7512641	.	T	A	1	4	5	0	0	5	0	0
12	7512675	.	G	A	0	3	3	0	0	3	0	0
12	7512921	.	A	G	1	3	4	0	1	5	0	0
12	7512965	.	C	A	1	2	3	0	0	3	0	0
12	7589579	.	G	A	2	4	6	0	1	7	0	0
12	7589581	.	T	G	3	4	7	0	0	7	0	0
12	7589633	.	T	A	3	4	7	0	1	8	0	0
12	7589651	.	T	C	4	4	8	0	0	8	0	0
12	7589795	.	A	G	2	3	5	0	1	6	0	0
12	7589816	.	A	G	5	3	8	0	1	9	0	0
12	7589845	.	C	A	5	4	9	0	0	9	0	0
12	7589917	.	C	G	2	3	5	0	1	6	0	0
12	7589995	.	C	A	1	2	3	0	0	3	0	0
12	7590024	.	C	A	2	2	4	0	0	4	0	0
12	7595179	.	C	T	3	2	5	0	0	5	0	0
12	7610033	.	A	G	7	5	12	0	2	14	0	0
12	7610236	.	A	T	8	2	10	0	2	12	0	0
12	7610478	.	T	A	6	8	14	0	3	17	0	0
12	7610532	.	T	G	6	6	12	0	2	14	0	0
12	7610740	.	T	C	4	7	11	0	1	12	0	0
12	7611352	.	T	C	6	2	8	0	0	8	0	0
12	7612106	.	T	C	1	5	6	0	0	6	0	0
12	7853846	.	A	T	1	2	3	0	0	3	0	0
12	8877343	.	A	C	2	3	5	0	0	5	0	0
12	8877412	.	T	C	3	2	5	0	0	5	0	0
12	8881469	.	G	A	5	3	8	0	0	8	0	0
12	8881470	.	C	G	3	4	7	0	1	8	0	0
12	8881575	.	C	T	6	4	10	0	0	10	0	0
12	8882062	.	G	T	8	5	13	0	0	13	0	0
12	8882142	.	G	A	2	3	5	0	0	5	0	0
12	8882143	.	A	C	2	2	4	0	1	5	0	0
12	8968456	.	T	A	5	12	17	0	2	19	0	0
12	8968487	.	T	A	10	10	20	0	1	21	0	0
12	8968512	.	T	G	11	11	22	0	0	22	0	0
12	8968721	.	A	G	13	11	24	0	0	24	0	0
12	8968979	.	C	A	2	9	11	0	0	11	0	0
12	8969084	.	T	C	10	19	29	0	1	30	0	0
12	8969102	.	C	T	0	15	15	0	13	28	0	0
12	8969155	.	C	G	11	10	21	0	0	21	0	0
12	8969426	.	T	C	2	6	8	0	0	8	0	0
12	8969485	.	T	C	11	6	17	0	1	18	0	0
12	8969499	.	G	A	10	10	20	0	0	21	1	0
12	8987502	.	T	C	1	0	1	0	0	1	0	0
12	9010979	.	G	A	1	1	2	0	0	2	0	0
12	9010988	.	C	T	0	1	1	0	1	2	0	0
12	9206038	.	T	C	0	1	1	0	0	1	0	0
12	9206044	.	C	T	0	1	1	0	0	1	0	0
12	9210504	.	A	G	1	2	3	0	0	3	0	0
12	9210528	.	C	T	1	2	3	0	0	3	0	0
12	9217989	.	A	G	0	3	3	0	0	3	0	0
12	9218054	.	T	C	5	12	17	0	0	17	0	0
12	9218095	.	A	T	4	10	14	0	0	14	0	0
12	9218098	.	T	C	4	10	14	0	0	14	0	0
12	9218142	.	A	G	3	5	8	0	0	8	0	0
12	9623751	.	T	C	3	1	4	0	0	4	0	0
12	9626057	.	A	C	2	7	9	0	0	9	0	0
12	9627980	.	A	G	2	2	4	0	0	4	0	0
12	9628007	.	T	C	1	1	2	0	0	2	0	0
12	9630730	.	G	A	1	1	2	0	1	3	0	0
12	9630745	.	G	A	0	2	2	0	0	2	0	0
12	9633827	.	G	A	8	5	13	0	0	13	0	0
12	9636616	.	A	G	5	6	11	0	0	11	0	0
12	9658137	.	A	G	1	2	3	0	0	3	0	0
12	9749830	.	A	G	1	1	2	0	0	2	0	0
12	9781701	.	T	G	3	3	6	0	1	7	0	0
12	9781789	.	C	T	2	3	5	0	1	6	0	0
12	9782041	.	G	A	3	2	5	0	0	5	0	0
12	9782404	.	G	A	3	2	5	0	0	5	0	0
12	9817737	.	A	T	3	1	4	0	1	5	0	0
12	9817771	.	C	T	4	2	6	0	0	6	0	0
12	9824735	.	C	T	5	5	10	0	0	10	0	0
12	9824762	.	C	A	5	5	10	0	1	11	0	0
12	9824807	.	C	A	0	1	1	0	0	1	0	0
12	9829697	.	C	T	0	1	1	0	0	1	0	0
12	9830983	.	G	A	6	2	8	0	1	9	0	0
12	9830986	.	G	A	3	6	9	0	0	9	0	0
12	9883526	.	G	A	10	25	35	0	2	37	0	0
12	9883849	.	C	T	21	41	62	0	2	64	0	0
12	9883944	.	C	T	41	22	63	0	4	67	0	0
12	10169614	.	G	A	8	6	14	0	1	15	0	0
12	10169884	.	G	T	6	14	20	0	0	20	0	0
12	10175161	.	C	T	1	7	8	0	0	8	0	0
12	10199695	.	A	G	14	17	31	0	1	32	0	0
12	10199760	.	A	T	14	12	26	0	4	30	0	0
12	10199869	.	C	T	1	9	10	0	10	20	0	0
12	10200028	.	A	G	12	20	32	0	2	34	0	0
12	10209431	.	A	G	6	7	13	0	0	13	0	0
12	10209452	.	T	A	3	2	5	0	0	5	0	0
12	10217660	.	C	T	1	5	6	0	0	6	0	0
12	10368969	.	T	C	3	0	3	0	2	5	0	0
12	10368978	.	A	G	4	2	6	0	0	6	0	0
12	10369153	.	T	G	1	2	3	0	0	3	0	0
12	10369300	.	A	G	1	2	3	0	1	4	0	0
12	10382588	.	C	T	4	7	11	0	0	11	0	0
12	10384982	.	G	A	1	4	5	0	1	6	0	0
12	10387071	.	A	G	5	6	11	0	1	12	0	0
12	10391883	.	C	T	1	1	2	0	0	2	0	0
12	10424741	.	C	G	0	14	14	0	11	25	0	0
12	10425346	.	T	C	4	9	13	0	1	14	0	0
12	10425465	.	C	T	0	2	2	0	0	2	0	0
12	10425586	.	G	T	3	3	6	0	0	6	0	0
12	10425630	.	A	T	4	3	7	0	0	7	0	0
12	10429054	.	G	A	1	4	5	0	0	5	0	0
12	10429105	.	C	A	1	0	1	0	0	1	0	0
12	10430611	.	G	A	1	0	1	0	0	1	0	0
12	10439619	.	C	A	0	1	1	0	0	1	0	0
12	10439641	.	T	G	0	1	1	0	0	1	0	0
12	10444321	.	A	T	3	1	4	0	0	4	0	0
12	10465000	.	A	C	4	12	16	0	0	16	0	0
12	10465182	.	A	C	5	7	12	0	0	12	0	0
12	10471105	.	A	G	0	1	1	0	0	1	0	0
12	10478804	.	C	A	0	4	4	0	5	9	0	0
12	10478857	.	T	C	2	3	5	0	0	5	0	0
12	10478961	.	G	T	0	4	4	0	1	5	0	0
12	10482792	.	T	G	2	3	5	0	0	5	0	0
12	10679153	.	G	A	3	4	7	0	0	7	0	0
12	10679279	.	T	G	3	9	12	0	0	12	0	0
12	10679289	.	G	A	8	0	8	0	0	8	0	0
12	10682392	.	A	G	1	4	5	0	0	5	0	0
12	10685867	.	C	T	1	5	6	0	0	6	0	0
12	10688640	.	C	T	7	4	11	0	2	13	0	0
12	10688704	.	G	A	5	5	10	0	1	11	0	0
12	10705765	.	T	A	1	2	3	0	0	3	0	0
12	10705775	.	C	G	1	2	3	0	0	3	0	0
12	11389285	.	T	C	4	2	6	0	0	6	0	0
12	11762849	.	A	T	9	4	13	0	0	13	0	0
12	13189121	.	T	C	6	5	11	0	1	12	0	0
12	13473690	.	A	G	2	3	5	0	0	5	0	0
12	13474461	.	A	G	4	3	7	0	0	7	0	0
12	13475225	.	A	G	11	5	16	0	0	16	0	0
12	13811642	.	G	A	5	2	7	0	4	11	0	0
12	18717374	.	C	T	1	2	3	0	0	3	0	0
12	18913602	.	A	G	4	7	11	0	0	11	0	0
12	19144930	.	G	A	4	2	6	0	0	6	0	0
12	20653080	.	A	T	2	7	9	0	0	9	0	0
12	20653081	.	A	T	3	5	8	0	1	9	0	0
12	22310798	.	A	G	5	2	7	0	0	7	0	0
12	22529296	.	T	C	5	5	10	0	0	10	0	0
12	22529304	.	T	C	6	4	10	0	0	10	0	0
12	22529456	.	T	G	13	23	36	0	4	40	0	0
12	22529457	.	A	C	12	25	37	0	3	40	0	0
12	22529952	.	T	C	3	3	6	0	0	6	0	0
12	22531505	.	A	T	2	3	5	0	0	5	0	0
12	22533054	.	G	A	1	7	8	0	0	8	0	0
12	22533884	.	A	T	3	2	5	0	0	5	0	0
12	22534794	.	C	T	1	2	3	0	0	3	0	0
12	22570499	.	T	C	3	2	5	0	0	5	0	0
12	22570814	.	T	C	4	2	6	1	1	8	0	0
12	22571628	.	G	A	2	2	4	0	0	4	0	0
12	22572199	.	C	G	16	11	27	0	0	27	0	0
12	22572287	.	A	C	16	8	24	0	0	24	0	0
12	22572528	.	T	G	5	12	17	0	1	18	0	0
12	22572738	.	C	T	15	14	29	0	3	32	0	0
12	22573080	.	T	A	23	17	40	0	0	40	0	0
12	22573239	.	A	C	5	3	8	0	1	9	0	0
12	22643556	.	C	G	1	1	2	0	0	2	0	0
12	22644114	.	T	A	2	2	4	0	0	4	0	0
12	22644118	.	C	T	1	2	3	0	1	4	0	0
12	22644202	.	T	G	1	2	3	0	0	3	0	0
12	22644209	.	T	C	1	3	4	0	0	4	0	0
12	22644634	.	T	C	1	5	6	0	0	6	0	0
12	22644687	.	T	G	2	6	8	0	0	8	0	0
12	22644800	.	G	A	3	4	7	0	0	7	0	0
12	22644852	.	C	T	1	3	4	0	0	4	0	0
12	22927981	.	T	C	3	2	5	0	0	5	0	0
12	22932160	.	A	C	2	2	4	0	0	4	0	0
12	22932852	.	G	T	0	7	7	0	11	18	0	0
12	22932875	.	G	T	15	9	24	0	0	24	0	0
12	22962211	.	A	T	6	3	9	0	1	10	0	0
12	22962555	.	C	A	3	2	5	0	0	5	0	0
12	22962764	.	T	C	3	6	9	0	0	9	0	0
12	22962781	.	G	A	4	6	10	0	1	11	0	0
12	22962911	.	C	A	1	3	4	0	0	4	0	0
12	22962975	.	C	A	1	1	2	0	1	3	0	0
12	23176128	.	G	A	0	3	3	0	0	3	0	0
12	23176129	.	A	G	0	3	3	0	0	3	0	0
12	23400392	.	C	T	3	3	6	0	1	7	0	0
12	23400469	.	C	T	6	3	9	0	2	11	0	0
12	23403091	.	T	C	2	2	4	0	0	4	0	0
12	23411287	.	C	T	1	8	9	0	1	10	0	0
12	23415280	.	C	T	14	15	29	0	3	32	0	0
12	23415370	.	C	T	16	18	34	0	0	34	0	0
12	23415662	.	G	A	17	16	33	0	3	36	0	0
12	23415715	.	T	C	18	15	33	0	3	36	0	0
12	23415897	.	A	T	12	0	12	0	4	16	0	0
12	23429685	.	C	T	5	2	7	0	0	7	0	0
12	23430003	.	C	A	0	2	2	0	2	4	0	0
12	23430091	.	G	A	3	3	6	0	0	6	0	0
12	23430092	.	T	A	3	3	6	0	0	6	0	0
12	23674165	.	A	T	1	3	4	0	0	4	0	0
12	23674331	.	T	A	6	2	8	0	0	8	0	0
12	23674354	.	T	C	5	5	10	0	0	10	0	0
12	23674468	.	C	T	1	4	5	0	0	5	0	0
12	23787989	.	T	A	1	2	3	0	0	3	0	0
12	23795221	.	C	G	1	3	4	0	0	4	0	0
12	23917279	.	T	C	0	1	1	0	0	1	0	0
12	23923434	.	G	A	1	1	2	0	0	2	0	0
12	23932067	.	T	G	4	4	8	0	2	10	0	0
12	24038542	.	T	C	1	2	3	0	0	3	0	0
12	24041322	.	T	A	2	2	4	0	0	4	0	0
12	24043730	.	A	G	1	2	3	0	0	3	0	0
12	24051755	.	T	A	5	2	7	0	0	7	0	0
12	24052578	.	C	T	9	8	17	0	1	18	0	0
12	24052684	.	G	A	9	10	19	0	0	19	0	0
12	24465454	.	C	T	0	1	1	0	0	1	0	0
12	24465466	.	T	C	0	1	1	0	0	1	0	0
12	24465541	.	C	T	1	2	3	0	0	3	0	0
12	24465565	.	T	C	2	3	5	0	1	6	0	0
12	24484131	.	G	T	0	4	4	0	2	6	0	0
12	24484134	.	C	T	1	5	6	0	1	7	0	0
12	24606963	.	C	T	8	9	17	0	1	18	0	0
12	24636261	.	C	A	27	20	47	0	3	50	0	0
12	24636746	.	A	G	30	23	53	0	4	57	0	0
12	24637148	.	G	T	3	3	6	0	2	8	0	0
12	24796653	.	G	A	3	9	12	0	1	13	0	0
12	24797128	.	A	T	7	5	12	0	1	13	0	0
12	24797351	.	C	T	7	15	22	0	1	23	0	0
12	24797413	.	C	T	16	8	24	0	2	26	0	0
12	24797541	.	G	A	5	9	14	0	1	15	0	0
12	24797603	.	T	C	4	8	12	0	3	15	0	0
12	24797908	.	C	T	1	5	6	0	0	6	0	0
12	24842121	.	G	A	19	16	35	0	0	35	0	0
12	24842267	.	T	G	16	13	29	0	1	30	0	0
12	24843292	.	C	T	0	10	10	0	7	17	0	0
12	24843424	.	T	C	3	0	3	0	5	8	0	0
12	24847330	.	T	G	2	2	4	0	1	5	0	0
12	24848399	.	G	A	1	2	3	0	0	3	0	0
12	24851165	.	T	C	0	2	2	0	0	2	0	0
12	24851264	.	G	A	1	3	4	0	1	5	0	0
12	24851297	.	G	A	0	2	2	0	0	2	0	0
12	24906618	.	T	C	2	6	8	0	0	8	0	0
12	24913442	.	C	G	3	1	4	0	0	4	0	0
12	24913609	.	C	A	3	1	4	0	0	4	0	0
12	24957267	.	A	G	12	18	30	0	4	34	0	0
12	24957416	.	T	C	14	9	23	0	6	29	0	0
12	24957806	.	A	G	33	34	67	0	6	73	0	0
12	25094107	.	T	G	6	10	16	0	1	17	0	0
12	25094300	.	T	C	2	2	4	0	0	4	0	0
12	25094359	.	T	C	3	6	9	0	0	9	0	0
12	25094401	.	C	T	1	6	7	0	0	7	0	0
12	25094520	.	T	C	5	2	7	0	0	7	0	0
12	25094522	.	T	C	3	4	7	0	0	7	0	0
12	25205542	.	A	T	1	5	6	0	0	6	0	0
12	25377354	.	A	C	1	2	3	0	0	3	0	0
12	25467823	.	T	C	0	3	3	0	0	3	0	0
12	25472281	.	C	T	0	3	3	0	0	3	0	0
12	25472290	.	A	G	0	0	0	0	3	3	0	0
12	25484586	.	G	A	8	16	24	0	2	26	0	0
12	25484676	.	T	G	18	11	29	0	4	33	0	0
12	25485203	.	C	T	10	17	27	0	3	30	0	0
12	25485310	.	C	A	1	2	3	0	0	3	0	0
12	25485312	.	C	A	1	2	3	0	0	3	0	0
12	25602616	.	T	A	7	5	12	0	0	12	0	0
12	25602820	.	T	A	5	4	9	0	0	9	0	0
12	25602828	.	T	A	4	4	8	0	1	9	0	0
12	25714480	.	T	G	1	3	4	0	0	4	0	0
12	25754150	.	C	T	1	4	5	0	1	6	0	0
12	25758242	.	C	T	2	0	2	0	0	2	0	0
12	25768096	.	C	T	9	2	11	0	1	12	0	0
12	25768326	.	T	A	15	10	25	0	0	25	0	0
12	25768580	.	G	A	0	8	8	0	7	15	0	0
12	25768830	.	T	C	2	5	7	0	1	8	0	0
12	25769012	.	G	A	10	16	26	0	1	27	0	0
12	25769177	.	A	T	11	8	19	0	3	22	0	0
12	25769752	.	G	A	23	22	45	0	3	48	0	0
12	25769889	.	G	A	15	6	21	0	2	23	0	0
12	25829025	.	G	A	3	4	7	0	0	7	0	0
12	25829046	.	T	C	3	4	7	0	0	7	0	0
12	25829105	.	T	C	4	2	6	0	0	6	0	0
12	25829168	.	A	G	0	5	5	0	1	6	0	0
12	25861006	.	T	C	0	1	1	0	0	1	0	0
12	25872834	.	C	A	1	1	2	0	0	2	0	0
12	25872933	.	C	T	6	2	8	0	0	8	0	0
12	25872938	.	C	A	5	1	6	0	1	7	0	0
12	25881185	.	G	C	0	11	11	0	19	30	0	0
12	25881254	.	A	C	14	6	20	0	1	21	0	0
12	25881778	.	T	C	14	18	32	0	0	32	0	0
12	25952026	.	A	G	3	4	7	0	0	7	0	0
12	25952027	.	C	G	3	4	7	0	0	7	0	0
12	26409797	.	C	A	2	5	7	0	0	7	0	0
12	26476319	.	A	G	0	1	1	0	0	1	0	0
12	26486421	.	C	G	9	6	15	0	4	19	0	0
12	26486446	.	A	C	9	13	22	0	5	27	0	0
12	26486580	.	T	C	16	9	25	0	0	25	0	0
12	26486753	.	T	C	7	11	18	0	1	19	0	0
12	26486934	.	T	A	8	4	12	0	4	16	0	0
12	26487002	.	A	T	9	10	19	1	0	20	0	0
12	26487044	.	G	A	8	10	18	0	2	20	0	0
12	26487292	.	T	G	5	6	11	0	0	11	0	0
12	26489766	.	A	T	5	3	8	0	0	8	0	0
12	26491376	.	A	T	3	2	5	0	2	7	0	0
12	26491380	.	G	A	3	2	5	0	1	6	0	0
12	26493734	.	T	C	1	1	2	0	1	3	0	0
12	26493755	.	G	A	0	3	3	0	3	6	0	0
12	26493806	.	C	T	3	6	9	0	0	9	0	0
12	26493836	.	G	A	0	6	6	0	5	11	0	0
12	26493870	.	G	T	4	3	7	0	0	7	0	0
12	26494763	.	C	G	1	2	3	0	0	3	0	0
12	26545121	.	A	G	2	2	4	0	0	4	0	0
12	26546851	.	G	T	4	1	5	0	0	5	0	0
12	26546855	.	C	T	4	1	5	0	0	5	0	0
12	26546965	.	A	G	5	4	9	0	0	9	0	0
12	26546966	.	A	G	5	3	8	0	1	9	0	0
12	26547276	.	A	C	0	2	2	0	1	3	0	0
12	26547397	.	C	T	1	3	4	0	1	5	0	0
12	26586957	.	C	T	3	2	5	0	0	5	0	0
12	26587216	.	G	A	0	4	4	0	3	7	0	0
12	26611673	.	A	T	2	6	8	0	0	8	0	0
12	26612038	.	A	G	4	1	5	0	1	6	0	0
12	26612188	.	T	C	5	1	6	0	2	8	0	0
12	26612225	.	C	G	5	2	7	0	0	7	0	0
12	26612390	.	G	C	1	0	1	0	0	1	0	0
12	26704300	.	C	T	0	1	1	0	0	1	0	0
12	26708821	.	G	A	0	3	3	0	0	3	0	0
12	26724327	.	C	A	2	3	5	0	0	5	0	0
12	26724975	.	A	G	14	0	14	0	8	22	0	0
12	26724984	.	A	T	12	5	17	0	2	20	1	0
12	26725079	.	C	A	9	8	17	0	0	17	0	0
12	26725402	.	A	G	13	5	18	0	1	20	1	0
12	26725846	.	T	C	2	2	4	0	0	4	0	0
12	26750431	.	G	A	4	6	10	0	1	11	0	0
12	26750619	.	A	G	15	13	28	0	1	29	0	0
12	26751414	.	G	A	5	6	11	0	0	11	0	0
12	26751489	.	A	G	4	3	7	0	2	9	0	0
12	26752528	.	C	T	2	2	4	0	0	4	0	0
12	27025481	.	C	T	3	4	7	0	1	8	0	0
12	27026528	.	A	C	6	8	14	0	2	16	0	0
12	27029648	.	C	T	1	5	6	0	0	6	0	0
12	27059581	.	T	C	4	5	9	0	0	9	0	0
12	27059901	.	A	T	16	8	24	0	1	25	0	0
12	27059910	.	A	T	15	9	24	0	0	24	0	0
12	27060018	.	C	T	8	5	13	0	0	13	0	0
12	27060087	.	C	A	1	6	7	0	0	7	0	0
12	27060572	.	G	A	13	10	23	0	0	23	0	0
12	27086958	.	C	T	1	1	2	0	1	3	0	0
12	27087844	.	G	A	1	2	3	0	0	3	0	0
12	27088199	.	T	C	2	1	3	0	1	4	0	0
12	27088383	.	A	C	1	3	4	0	0	4	0	0
12	27088758	.	A	C	1	3	4	0	0	4	0	0
12	27088767	.	G	A	1	3	4	0	0	4	0	0
12	27089531	.	G	C	4	5	9	0	2	11	0	0
12	27089857	.	T	C	4	7	11	0	1	12	0	0
12	27090630	.	A	C	3	3	6	0	1	7	0	0
12	27090663	.	G	A	0	5	5	0	7	12	0	0
12	27090696	.	A	T	5	4	9	0	3	12	0	0
12	27090756	.	A	G	5	4	9	0	1	10	0	0
12	27090824	.	T	G	2	5	7	0	1	8	0	0
12	27090856	.	A	T	3	5	8	0	0	8	0	0
12	27090864	.	G	C	3	5	8	0	0	8	0	0
12	27090918	.	G	A	5	2	7	0	1	8	0	0
12	27091305	.	T	C	7	13	20	0	2	22	0	0
12	27207050	.	T	G	7	8	15	0	3	18	0	0
12	27207053	.	C	T	7	8	15	0	3	18	0	0
12	27207130	.	G	A	4	10	14	0	0	14	0	0
12	27207466	.	T	C	14	8	22	0	2	24	0	0
12	27219143	.	C	T	2	2	4	0	0	4	0	0
12	27219450	.	T	C	1	4	5	0	0	5	0	0
12	27219818	.	G	A	0	3	3	0	3	6	0	0
12	27220582	.	T	C	0	1	1	0	0	1	0	0
12	27221491	.	G	A	1	0	1	0	0	1	0	0
12	27221505	.	A	T	2	0	2	0	0	2	0	0
12	27229078	.	A	G	9	4	13	0	1	14	0	0
12	27229438	.	T	G	11	10	21	0	0	21	0	0
12	27229611	.	G	A	4	7	11	0	0	11	0	0
12	27243236	.	T	C	0	3	3	0	0	3	0	0
12	27303328	.	T	C	1	2	3	0	0	3	0	0
12	27568288	.	T	A	5	3	8	0	0	8	0	0
12	27570675	.	A	G	12	4	16	0	1	17	0	0
12	27570725	.	T	A	9	11	20	0	3	23	0	0
12	27570759	.	T	G	9	9	18	0	1	19	0	0
12	27570838	.	C	G	11	5	16	0	1	17	0	0
12	27570869	.	A	T	9	3	12	0	0	12	0	0
12	27571015	.	A	G	1	5	6	0	0	6	0	0
12	27571625	.	G	A	7	6	13	0	0	13	0	0
12	27573030	.	G	A	2	3	5	0	0	5	0	0
12	27593678	.	T	C	0	1	1	0	0	1	0	0
12	27622254	.	C	T	2	2	4	0	0	4	0	0
12	27622321	.	G	A	2	4	6	0	0	6	0	0
12	27622336	.	C	A	1	4	5	0	0	5	0	0
12	27627528	.	G	C	2	1	3	0	0	3	0	0
12	27665035	.	T	C	8	8	16	0	1	17	0	0
12	27665289	.	G	C	22	18	40	0	1	41	0	0
12	27665502	.	T	A	8	4	12	0	0	12	0	0
12	27665539	.	T	C	3	3	6	0	0	6	0	0
12	28072821	.	C	G	20	8	28	0	4	32	0	0
12	28299521	.	G	A	0	3	3	0	0	3	0	0
12	28350566	.	A	G	8	6	14	0	0	14	0	0
12	28351092	.	A	G	6	3	9	0	0	9	0	0
12	28351160	.	G	C	1	3	4	0	0	4	0	0
12	28355486	.	G	A	2	5	7	0	1	8	0	0
12	28355549	.	T	C	1	1	2	0	1	3	0	0
12	28369412	.	G	T	3	1	4	0	1	5	0	0
12	28369909	.	G	T	0	7	7	0	3	10	0	0
12	28369981	.	C	T	4	2	6	0	0	6	0	0
12	28370062	.	G	C	0	2	2	0	6	8	0	0
12	28370335	.	A	C	11	7	18	0	3	21	0	0
12	28377796	.	A	G	2	5	7	0	0	7	0	0
12	28377797	.	G	C	2	4	6	0	1	7	0	0
12	28377976	.	G	A	1	3	4	0	0	4	0	0
12	28378139	.	G	A	5	4	9	0	0	9	0	0
12	28378394	.	C	A	1	2	3	0	8	11	0	0
12	28378418	.	G	A	6	2	8	0	1	9	0	0
12	28559973	.	A	C	1	2	3	0	0	3	0	0
12	28560354	.	T	A	2	2	4	0	0	4	0	0
12	28560370	.	G	T	2	2	4	0	0	4	0	0
12	28560494	.	T	C	4	4	8	0	1	9	0	0
12	28560990	.	T	C	3	3	6	0	0	6	0	0
12	28668713	.	A	T	1	2	3	0	0	3	0	0
12	28676131	.	C	T	5	2	7	0	0	7	0	0
12	28676844	.	A	T	5	7	12	0	1	13	0	0
12	28677314	.	A	G	12	6	18	0	0	18	0	0
12	28677413	.	T	C	8	10	18	0	1	19	0	0
12	28677576	.	A	T	7	3	10	0	1	11	0	0
12	28797777	.	T	C	5	2	7	0	0	7	0	0
12	28806022	.	G	A	0	8	8	0	8	16	0	0
12	28806062	.	C	T	7	4	11	0	0	11	0	0
12	28806180	.	C	T	6	5	11	0	1	12	0	0
12	28806220	.	G	T	8	5	13	0	0	13	0	0
12	28806241	.	T	G	4	4	8	0	1	9	0	0
12	28806396	.	C	A	2	2	4	0	2	6	0	0
12	28806459	.	A	T	13	4	17	0	1	18	0	0
12	28806494	.	G	A	12	9	21	0	1	22	0	0
12	28806530	.	G	C	19	9	28	0	0	28	0	0
12	28827553	.	T	A	1	2	3	0	0	3	0	0
12	28828358	.	G	A	2	0	2	0	0	2	0	0
12	28830363	.	A	G	2	4	6	0	0	6	0	0
12	28835101	.	A	G	1	2	3	0	0	3	0	0
12	28844171	.	T	C	8	9	17	0	0	17	0	0
12	28863783	.	A	C	1	2	3	0	0	3	0	0
12	28863811	.	T	C	2	2	4	0	0	4	0	0
12	28864217	.	T	C	3	3	6	0	1	7	0	0
12	28864719	.	G	C	5	7	12	0	0	12	0	0
12	28864778	.	C	G	6	4	10	0	0	10	0	0
12	28864792	.	A	C	6	3	9	0	2	11	0	0
12	28864847	.	T	C	4	8	12	0	1	13	0	0
12	28865106	.	G	T	5	11	16	0	2	18	0	0
12	28865298	.	T	A	13	20	33	0	3	36	0	0
12	28865668	.	T	G	8	17	25	0	3	28	0	0
12	28865679	.	G	A	7	22	29	0	4	33	0	0
12	28865805	.	A	C	10	15	25	0	1	26	0	0
12	28870626	.	T	C	14	13	27	0	3	30	0	0
12	28870912	.	C	A	10	22	32	0	2	35	1	0
12	28871068	.	G	T	7	6	13	0	6	19	0	0
12	28871433	.	C	A	0	17	17	0	12	29	0	0
12	28878343	.	C	T	8	12	20	0	1	21	0	0
12	28900607	.	A	G	1	2	3	0	0	3	0	0
12	28901049	.	A	G	3	3	6	0	0	6	0	0
12	28927051	.	G	A	1	2	3	0	0	3	0	0
12	28930455	.	T	C	2	1	3	0	0	3	0	0
12	28932389	.	C	T	0	2	2	0	0	2	0	0
12	28932428	.	C	T	5	5	10	0	1	11	0	0
12	28932571	.	G	A	5	4	9	0	1	10	0	0
12	28932581	.	T	A	6	6	12	0	0	12	0	0
12	28948117	.	T	C	4	2	6	0	1	7	0	0
12	28960357	.	G	A	0	2	2	0	7	9	0	0
12	28960441	.	C	T	3	5	8	0	1	9	0	0
12	28960481	.	A	G	2	4	6	0	0	6	0	0
12	29209834	.	G	A	3	4	7	0	0	7	0	0
12	29209840	.	A	T	3	4	7	0	0	7	0	0
12	29210371	.	C	A	15	5	20	0	0	20	0	0
12	29210435	.	C	G	5	8	13	0	0	13	0	0
12	29210600	.	C	T	10	7	17	0	0	17	0	0
12	29210719	.	T	A	12	12	24	0	1	25	0	0
12	29210873	.	T	A	3	4	7	0	0	7	0	0
12	29210917	.	T	C	6	3	9	0	1	10	0	0
12	29211082	.	G	A	11	8	19	0	1	20	0	0
12	29211195	.	T	A	16	8	24	0	3	27	0	0
12	29211232	.	G	A	0	16	16	0	20	36	0	0
12	29211289	.	T	A	20	19	39	0	2	41	0	0
12	29211292	.	A	G	16	17	33	0	9	42	0	0
12	29223498	.	A	G	7	7	14	0	1	15	0	0
12	29223612	.	T	G	4	4	8	0	2	10	0	0
12	29223689	.	G	A	1	7	8	0	1	9	0	0
12	29223811	.	C	A	1	2	3	0	0	3	0	0
12	29223847	.	C	T	1	3	4	0	1	5	0	0
12	29223921	.	G	A	1	2	3	0	1	4	0	0
12	29224250	.	T	G	1	2	3	0	0	3	0	0
12	29224310	.	A	G	1	2	3	0	0	3	0	0
12	29224326	.	T	G	1	3	4	0	0	4	0	0
12	29266917	.	T	C	5	3	8	0	1	9	0	0
12	29269576	.	C	A	1	3	4	0	0	4	0	0
12	29269689	.	G	A	3	3	6	0	1	7	0	0
12	29269726	.	C	G	5	3	8	0	2	10	0	0
12	29269770	.	G	T	0	4	4	0	4	8	0	0
12	29269774	.	T	G	3	2	5	0	1	6	0	0
12	29350773	.	C	A	1	3	4	0	0	4	0	0
12	29351320	.	A	G	10	10	20	0	5	25	0	0
12	29351810	.	A	G	3	8	11	0	1	12	0	0
12	29358277	.	T	C	2	0	2	0	1	3	0	0
12	29358370	.	G	C	3	0	3	0	6	9	0	0
12	29358384	.	A	G	3	3	6	0	0	6	0	0
12	29358418	.	A	G	0	1	1	0	0	1	0	0
12	29624017	.	G	A	2	3	5	0	0	5	0	0
12	29843460	.	A	G	9	12	21	0	0	21	0	0
12	29844434	.	T	C	4	4	8	0	0	8	0	0
12	29957074	.	C	T	0	2	2	0	0	2	0	0
12	30217747	.	C	T	1	2	3	0	0	3	0	0
12	30217893	.	C	A	0	2	2	0	0	2	0	0
12	30217898	.	T	A	1	2	3	0	0	3	0	0
12	30218150	.	G	A	1	2	3	0	0	3	0	0
12	30218173	.	C	T	3	2	5	0	0	5	0	0
12	30219306	.	A	T	15	16	31	0	2	33	0	0
12	30219687	.	T	A	3	5	8	0	0	8	0	0
12	30219694	.	A	T	3	5	8	0	0	9	1	0
12	30219739	.	G	A	10	4	14	0	2	16	0	0
12	30219804	.	C	T	18	5	23	0	3	26	0	0
12	30302941	.	A	T	0	1	1	0	0	1	0	0
12	30418513	.	C	G	1	6	7	0	0	7	0	0
12	30419123	.	A	T	4	2	6	0	1	7	0	0
12	30419134	.	C	A	3	4	7	0	0	7	0	0
12	30419260	.	T	G	14	6	20	0	0	20	0	0
12	30419646	.	T	C	11	9	20	0	0	20	0	0
12	30419655	.	T	C	6	9	15	0	2	17	0	0
12	30419695	.	T	C	5	12	17	0	0	17	0	0
12	30419727	.	A	G	6	8	14	0	1	15	0	0
12	30442406	.	C	A	4	3	7	0	0	7	0	0
12	30459263	.	A	G	1	2	3	0	0	3	0	0
12	30459615	.	T	C	3	2	5	0	0	5	0	0
12	30805335	.	T	C	0	1	1	0	0	1	0	0
12	30805359	.	T	C	0	1	1	0	0	1	0	0
12	30806928	.	G	T	1	2	3	0	1	4	0	0
12	30807038	.	A	G	4	4	8	0	0	8	0	0
12	30807090	.	T	C	3	2	5	0	0	5	0	0
12	30807094	.	A	G	3	2	5	0	0	5	0	0
12	30807140	.	A	T	2	1	3	0	0	3	0	0
12	30807141	.	A	T	2	0	2	0	1	3	0	0
12	30807379	.	C	T	1	2	3	0	0	3	0	0
12	30807458	.	C	T	3	2	5	0	0	5	0	0
12	30807494	.	G	A	0	3	3	0	0	3	0	0
12	30807504	.	A	C	0	5	5	0	0	5	0	0
12	30807591	.	C	T	2	4	6	0	1	7	0	0
12	30807714	.	A	G	4	4	8	0	1	9	0	0
12	30807789	.	A	C	1	2	3	0	0	3	0	0
12	30807899	.	A	G	3	2	5	0	1	6	0	0
12	30808094	.	C	T	2	2	4	0	1	5	0	0
12	30808150	.	T	A	7	3	10	0	1	11	0	0
12	30808342	.	A	T	1	5	6	0	0	6	0	0
12	30808531	.	G	C	7	8	15	0	1	16	0	0
12	30808716	.	C	T	2	8	10	0	2	12	0	0
12	30808766	.	C	T	7	3	10	0	1	11	0	0
12	30808812	.	A	G	5	0	5	0	8	13	0	0
12	30808817	.	T	G	8	6	14	0	0	14	0	0
12	30979815	.	A	C	10	14	24	0	6	30	0	0
12	30980566	.	G	A	27	21	48	0	3	51	0	0
12	30980906	.	C	A	5	2	7	0	0	7	0	0
12	30981795	.	G	A	14	7	21	0	0	21	0	0
12	30986452	.	G	A	1	2	3	0	0	3	0	0
12	31435977	.	T	A	0	2	2	0	0	2	0	0
12	31438056	.	G	T	10	4	14	0	1	15	0	0
12	31438352	.	A	T	4	3	7	0	1	8	0	0
12	31442173	.	A	C	1	2	3	0	0	3	0	0
12	31479242	.	C	A	4	2	6	0	0	6	0	0
12	31479251	.	T	A	4	2	6	0	0	6	0	0
12	31532371	.	G	A	0	2	2	0	3	5	0	0
12	31532397	.	G	C	1	2	3	0	0	3	0	0
12	31532577	.	T	C	1	3	4	0	1	5	0	0
12	31532638	.	A	C	5	4	9	0	0	9	0	0
12	31629611	.	C	T	1	0	1	0	0	1	0	0
12	31630829	.	G	A	0	2	2	0	1	3	0	0
12	31631082	.	T	C	1	6	7	0	0	7	0	0
12	31631116	.	A	T	1	3	4	0	0	4	0	0
12	31709964	.	G	T	1	4	5	0	0	5	0	0
12	31720799	.	C	T	26	17	43	0	3	46	0	0
12	31721486	.	G	A	4	3	7	0	0	7	0	0
12	31722593	.	G	T	6	9	15	0	1	16	0	0
12	31722875	.	A	C	6	0	6	0	7	13	0	0
12	31724245	.	A	C	12	8	20	0	0	20	0	0
12	31724252	.	C	T	11	8	19	0	1	20	0	0
12	31740733	.	T	C	0	1	1	0	0	1	0	0
12	31764523	.	T	C	1	2	3	0	2	5	0	0
12	31764526	.	C	A	2	3	5	0	0	5	0	0
12	31765407	.	G	A	4	3	7	0	0	7	0	0
12	31765517	.	T	C	1	2	3	0	0	3	0	0
12	31765540	.	T	G	2	3	5	0	0	5	0	0
12	31789799	.	C	T	17	14	31	0	1	32	0	0
12	31794655	.	G	A	1	0	1	0	0	1	0	0
12	31909755	.	T	C	2	2	4	0	0	4	0	0
12	32039443	.	C	T	0	4	4	0	10	14	0	0
12	32039527	.	A	G	15	10	25	0	2	27	0	0
12	32039546	.	G	A	17	13	30	0	4	34	0	0
12	32039635	.	A	C	14	18	32	0	1	33	0	0
12	32039678	.	C	T	14	18	32	0	3	35	0	0
12	32039937	.	G	A	13	11	24	0	2	26	0	0
12	32040093	.	G	A	16	13	29	0	0	29	0	0
12	32045155	.	G	A	6	8	14	0	2	16	0	0
12	32045212	.	T	C	4	0	4	0	9	13	0	0
12	32066061	.	C	A	2	4	6	0	0	6	0	0
12	32068470	.	C	A	1	3	4	0	0	4	0	0
12	32068700	.	A	T	1	3	4	0	0	4	0	0
12	33818743	.	C	T	10	3	13	0	0	13	0	0
12	33966790	.	T	G	18	25	43	0	3	46	0	0
12	33966886	.	A	G	18	10	28	0	2	30	0	0
12	33966905	.	C	T	20	9	29	0	1	30	0	0
12	33967283	.	C	T	16	5	21	0	2	23	0	0
12	33968073	.	T	A	10	10	20	0	1	21	0	0
12	33988266	.	C	T	4	5	9	0	0	9	0	0
12	33988374	.	T	C	2	4	6	0	0	6	0	0
12	33988623	.	G	C	5	4	9	0	2	11	0	0
12	33988764	.	G	A	0	7	7	0	3	10	0	0
12	33991521	.	G	A	19	14	33	0	0	33	0	0
12	33991622	.	T	C	15	13	28	0	1	29	0	0
12	33991781	.	T	C	24	25	49	0	1	50	0	0
12	33991867	.	A	T	28	10	38	0	2	40	0	0
12	33991882	.	T	A	15	24	39	0	0	39	0	0
12	33991987	.	A	C	16	19	35	0	1	36	0	0
12	33992208	.	A	C	7	7	14	0	7	21	0	0
12	33992813	.	C	A	13	14	27	0	4	31	0	0
12	33993008	.	T	A	9	7	16	0	0	16	0	0
12	33993152	.	A	T	2	6	8	0	2	10	0	0
12	34180040	.	C	A	0	1	1	0	0	1	0	0
12	34180771	.	C	T	0	1	1	0	0	1	0	0
12	34192041	.	G	A	0	1	1	0	2	3	0	0
12	34192454	.	C	T	2	3	5	0	1	6	0	0
12	34192551	.	C	T	8	2	10	0	2	12	0	0
12	34192679	.	T	C	1	5	6	0	0	6	0	0
12	34192762	.	C	T	1	9	10	0	0	10	0	0
12	34434681	.	T	A	1	0	1	0	0	1	0	0
12	34563459	.	G	T	2	1	3	0	0	5	2	0
12	34563469	.	T	C	0	3	3	0	0	3	0	0
12	34564123	.	A	G	6	4	10	0	2	12	0	0
12	34564343	.	C	T	9	5	14	0	2	16	0	0
12	34564416	.	A	G	1	4	5	0	2	7	0	0
12	34564786	.	G	A	3	3	6	0	2	8	0	0
12	34565354	.	C	G	1	2	3	0	1	4	0	0
12	34566022	.	C	T	2	3	5	0	0	5	0	0
12	34732862	.	A	T	1	4	5	0	0	5	0	0
12	34845623	.	C	G	3	2	5	0	1	6	0	0
12	34845669	.	T	G	6	4	10	0	0	10	0	0
12	34891681	.	C	T	5	6	11	0	0	11	0	0
12	34891911	.	A	T	2	2	4	0	1	5	0	0
12	34892024	.	A	G	5	2	7	0	0	7	0	0
12	34892089	.	C	T	4	3	7	0	0	7	0	0
12	34892590	.	T	A	9	8	17	0	0	17	0	0
12	35012127	.	T	C	0	2	2	0	0	2	0	0
12	35018127	.	C	T	18	14	32	0	3	35	0	0
12	35018519	.	G	T	5	3	8	0	1	9	0	0
12	35051265	.	C	T	18	7	25	0	3	28	0	0
12	35098977	.	T	G	3	2	5	0	0	5	0	0
12	35334652	.	C	G	1	2	3	0	0	3	0	0
12	35346498	.	G	A	6	27	33	0	1	34	0	0
12	35346597	.	A	T	28	27	55	0	4	59	0	0
12	35346842	.	T	C	13	12	25	0	3	28	0	0
12	35346873	.	C	T	23	17	40	0	3	43	0	0
12	35347002	.	A	T	20	16	36	0	2	38	0	0
12	35347078	.	G	A	20	20	40	0	2	42	0	0
12	35347084	.	C	T	0	20	20	0	23	43	0	0
12	35347318	.	C	T	11	17	28	0	6	34	0	0
12	35347485	.	T	G	10	18	28	0	3	31	0	0
12	35347951	.	A	G	12	10	22	0	0	23	1	0
12	35350686	.	G	A	8	6	14	0	1	15	0	0
12	35351392	.	G	T	1	0	1	0	0	1	0	0
12	35386919	.	A	G	1	1	2	0	0	2	0	0
12	35543736	.	T	G	6	16	22	0	0	22	0	0
12	35543971	.	T	G	14	9	23	0	2	25	0	0
12	35544320	.	T	G	4	5	9	0	3	12	0	0
12	35544460	.	A	G	5	6	11	0	1	12	0	0
12	35544596	.	C	A	2	4	6	0	1	7	0	0
12	35544968	.	A	G	4	6	10	0	1	11	0	0
12	35593188	.	C	T	16	14	30	0	0	30	0	0
12	35593469	.	T	A	8	4	12	0	1	13	0	0
12	35593729	.	A	G	1	0	1	0	6	7	0	0
12	35594069	.	T	A	18	7	25	0	0	25	0	0
12	35594154	.	C	T	9	7	16	0	2	18	0	0
12	35594169	.	C	T	8	7	15	0	1	16	0	0
12	35594436	.	C	T	17	8	25	0	1	26	0	0
12	35594474	.	A	G	15	6	21	0	1	22	0	0
12	35594495	.	G	A	0	6	6	0	14	20	0	0
12	35594512	.	T	C	14	9	23	0	0	23	0	0
12	35594541	.	C	A	15	13	28	0	1	29	0	0
12	35594605	.	C	T	19	12	31	0	4	35	0	0
12	35594623	.	T	A	19	10	29	0	2	31	0	0
12	35674952	.	G	A	1	3	4	0	0	4	0	0
12	35689209	.	C	T	1	1	2	0	0	2	0	0
12	35689210	.	A	G	1	1	2	0	0	2	0	0
12	35704426	.	G	T	10	6	16	0	1	17	0	0
12	35704435	.	G	T	9	7	16	0	3	19	0	0
12	35704735	.	A	G	1	1	2	0	0	2	0	0
12	35704852	.	G	A	0	1	1	0	0	1	0	0
12	35704921	.	A	C	6	5	11	0	0	11	0	0
12	35705131	.	C	T	3	6	9	0	2	11	0	0
12	35705140	.	A	C	3	0	3	0	8	11	0	0
12	35705252	.	T	G	6	3	9	0	0	9	0	0
12	35705323	.	G	A	4	3	7	0	0	7	0	0
12	35705367	.	C	T	0	4	4	0	7	11	0	0
12	35705565	.	C	T	0	2	2	0	5	7	0	0
12	35706091	.	C	T	0	3	3	0	0	3	0	0
12	35837425	.	T	A	4	1	5	0	1	6	0	0
12	35837468	.	C	A	2	3	5	0	0	5	0	0
12	35837499	.	G	C	3	3	6	0	0	6	0	0
12	35837503	.	T	G	3	3	6	0	0	6	0	0
12	35837828	.	T	A	3	2	5	0	1	6	0	0
12	35837842	.	G	A	2	3	5	0	0	5	0	0
12	35839261	.	C	A	5	2	7	0	0	7	0	0
12	35963575	.	T	C	4	2	6	0	0	6	0	0
12	35980632	.	T	C	18	8	26	0	0	26	0	0
12	35980758	.	C	T	29	8	37	0	1	38	0	0
12	35980764	.	T	C	27	7	34	0	2	36	0	0
12	35980917	.	T	G	13	3	16	0	0	16	0	0
12	35981206	.	T	C	9	0	9	0	13	22	0	0
12	35981260	.	T	A	8	6	14	0	2	16	0	0
12	35981303	.	T	G	5	4	9	0	0	9	0	0
12	35981304	.	G	C	5	4	9	0	0	9	0	0
12	35981478	.	A	G	3	5	8	0	0	8	0	0
12	35981627	.	C	T	1	5	6	0	1	7	0	0
12	35981713	.	C	T	0	5	5	0	4	9	0	0
12	35981832	.	A	G	3	9	12	0	0	12	0	0
12	35988544	.	A	G	1	4	5	0	0	5	0	0
12	35988553	.	G	A	1	4	5	0	0	5	0	0
12	36105687	.	T	C	1	1	2	0	1	3	0	0
12	36158056	.	A	C	3	7	10	0	0	10	0	0
12	36158098	.	G	C	5	15	20	0	0	20	0	0
12	36158099	.	T	C	5	12	17	0	3	20	0	0
12	36158225	.	T	C	6	9	15	0	1	16	0	0
12	36158349	.	G	A	0	11	11	0	7	18	0	0
12	36158538	.	C	T	4	3	7	0	1	8	0	0
12	36159597	.	C	G	9	12	21	0	1	22	0	0
12	36424613	.	G	A	3	2	5	0	0	5	0	0
12	36424618	.	G	A	2	4	6	0	0	6	0	0
12	36462038	.	G	A	1	3	4	0	0	4	0	0
12	36670276	.	A	G	1	2	3	0	0	3	0	0
12	36671341	.	G	T	1	2	3	0	0	3	0	0
12	36895025	.	A	G	1	2	3	0	0	3	0	0
12	36960197	.	T	C	7	5	12	0	1	13	0	0
12	36960200	.	A	T	8	5	13	0	0	13	0	0
12	37005350	.	T	C	2	3	5	0	0	5	0	0
12	37275799	.	T	G	2	1	3	0	1	4	0	0
12	37275800	.	T	G	2	2	4	0	0	4	0	0
12	37275898	.	T	C	1	3	4	0	0	4	0	0
12	37407392	.	T	A	2	6	8	0	0	8	0	0
12	37407477	.	T	C	3	5	8	0	0	8	0	0
12	37407524	.	C	A	4	6	10	0	0	10	0	0
12	37407632	.	T	A	2	3	5	0	0	5	0	0
12	37407813	.	C	T	3	6	9	0	0	9	0	0
12	37497149	.	G	A	1	2	3	0	0	3	0	0
12	38561258	.	C	A	0	2	2	0	0	2	0	0
12	38802875	.	T	C	1	2	3	0	1	4	0	0
12	38804314	.	C	T	1	5	6	0	0	6	0	0
12	38804350	.	G	A	2	3	5	0	0	5	0	0
12	38804374	.	T	C	1	3	4	0	0	4	0	0
12	38804406	.	T	C	1	2	3	0	0	3	0	0
12	38804466	.	G	A	0	5	5	0	0	5	0	0
12	38855601	.	G	A	3	3	6	0	0	6	0	0
12	40518043	.	T	C	3	4	7	0	1	8	0	0
12	40518088	.	C	T	5	8	13	0	0	13	0	0
12	40518094	.	T	C	4	7	11	0	1	12	0	0
12	41000900	.	G	A	0	2	2	0	1	3	0	0
12	41000969	.	A	G	2	0	2	0	3	5	0	0
12	41000993	.	A	C	1	4	5	0	0	5	0	0
12	41037024	.	A	C	3	4	7	0	0	7	0	0
12	41071775	.	T	C	3	2	5	0	0	5	0	0
12	41071841	.	T	C	3	0	3	0	2	5	0	0
12	41112962	.	C	T	2	2	4	0	0	4	0	0
12	41113007	.	T	C	6	9	15	0	0	15	0	0
12	41113040	.	G	A	7	9	16	0	1	17	0	0
12	41113049	.	C	A	8	6	14	0	1	15	0	0
12	41113313	.	A	T	6	18	24	0	0	24	0	0
12	41113489	.	G	T	1	12	13	0	6	19	0	0
12	41437046	.	G	A	0	1	1	0	0	1	0	0
12	41461321	.	A	T	1	4	5	0	0	5	0	0
12	41549404	.	C	G	1	2	3	0	0	3	0	0
12	41549413	.	G	T	2	1	3	0	0	3	0	0
12	41549476	.	T	C	3	2	5	0	0	5	0	0
12	41581092	.	A	G	14	8	22	0	0	22	0	0
12	41581257	.	A	T	12	10	22	0	0	22	0	0
12	41631608	.	C	A	1	2	3	0	0	3	0	0
12	41631703	.	A	T	12	5	17	0	0	17	0	0
12	41632117	.	A	G	4	17	21	0	0	21	0	0
12	41636655	.	C	T	14	2	16	0	1	17	0	0
12	41636658	.	G	T	14	3	17	0	0	17	0	0
12	41643177	.	T	A	3	4	7	0	1	8	0	0
12	41643178	.	C	T	1	5	6	0	2	8	0	0
12	41643214	.	C	T	3	5	8	0	0	8	0	0
12	41643217	.	G	A	3	5	8	0	0	8	0	0
12	41647273	.	T	C	1	3	4	0	0	4	0	0
12	41647312	.	C	T	6	6	12	0	1	13	0	0
12	41653151	.	G	A	2	4	6	0	0	6	0	0
12	41684634	.	G	A	1	5	6	0	0	6	0	0
12	41723148	.	T	A	5	3	8	0	1	9	0	0
12	41723310	.	C	T	0	8	8	0	14	22	0	0
12	41723457	.	G	A	8	14	22	0	1	23	0	0
12	41723608	.	T	A	10	9	19	0	0	19	0	0
12	41723747	.	C	T	3	6	9	0	0	9	0	0
12	41731908	.	G	A	0	1	1	0	0	1	0	0
12	42186478	.	A	G	1	1	2	0	0	2	0	0
12	42195697	.	A	T	6	5	11	0	0	11	0	0
12	42369685	.	C	T	0	10	10	0	11	21	0	0
12	42369848	.	G	A	7	12	19	0	0	19	0	0
12	42369912	.	A	G	9	9	18	0	2	20	0	0
12	42384900	.	G	T	4	4	8	0	1	9	0	0
12	42404984	.	C	G	1	2	3	0	0	3	0	0
12	42405963	.	T	G	1	2	3	0	1	4	0	0
12	42407225	.	A	T	1	2	3	0	0	3	0	0
12	42576815	.	C	T	8	8	16	0	0	16	0	0
12	42577187	.	C	T	6	6	12	0	6	18	0	0
12	42578117	.	A	T	4	5	9	0	0	9	0	0
12	42578505	.	A	T	23	20	43	0	2	45	0	0
12	42578958	.	A	G	3	7	10	0	1	13	2	0
12	42578996	.	T	A	5	15	20	0	6	26	0	0
12	43376709	.	C	T	1	14	15	0	8	23	0	0
12	43377049	.	G	T	1	4	5	0	3	8	0	0
12	43377281	.	G	C	3	7	10	0	0	10	0	0
12	43377505	.	A	T	3	4	7	0	1	8	0	0
12	43377558	.	T	C	3	3	6	0	2	8	0	0
12	46629332	.	T	C	0	4	4	0	0	4	0	0
12	46629345	.	A	G	0	3	3	0	0	3	0	0
12	47332185	.	A	G	1	4	5	0	0	5	0	0
12	47332389	.	G	A	7	2	9	0	0	9	0	0
12	47332827	.	C	T	3	3	6	0	0	6	0	0
12	47335472	.	C	T	3	0	3	0	0	3	0	0
12	47344423	.	T	C	8	6	14	0	1	15	0	0
12	47480299	.	A	C	1	0	1	0	1	2	0	0
12	47480536	.	A	C	1	3	4	0	0	4	0	0
12	47480728	.	A	G	1	0	1	0	7	8	0	0
12	47480731	.	T	A	2	4	6	0	2	8	0	0
12	47481229	.	G	C	0	1	1	0	4	5	0	0
12	47505208	.	G	A	0	1	1	0	0	1	0	0
12	47523795	.	A	C	6	3	9	0	0	9	0	0
12	47540933	.	T	C	20	28	48	0	0	48	0	0
12	47540934	.	C	T	20	26	46	0	2	48	0	0
12	47540999	.	A	C	11	20	31	0	4	35	0	0
12	47544354	.	C	A	0	4	4	0	8	12	0	0
12	47922396	.	C	T	0	1	1	0	2	3	0	0
12	48094399	.	A	T	2	3	5	0	0	5	0	0
12	48118165	.	G	A	1	3	4	0	1	5	0	0
12	48118581	.	T	C	2	7	9	0	1	10	0	0
12	48118598	.	A	T	2	4	6	0	1	7	0	0
12	48118981	.	G	A	2	4	6	0	0	6	0	0
12	48119048	.	G	A	2	3	5	0	1	6	0	0
12	48119153	.	T	G	1	5	6	0	0	6	0	0
12	48137949	.	G	A	3	1	4	0	0	4	0	0
12	48143336	.	G	A	1	3	4	0	0	4	0	0
12	48220624	.	C	G	1	1	2	0	0	2	0	0
12	48228265	.	A	C	1	1	2	0	0	2	0	0
12	48231039	.	G	A	0	5	5	0	3	8	0	0
12	48231108	.	G	T	4	5	9	0	0	9	0	0
12	48239927	.	C	T	2	5	7	0	0	7	0	0
12	48319235	.	A	T	0	1	1	0	0	1	0	0
12	48327550	.	T	G	10	9	19	0	2	21	0	0
12	48340578	.	G	A	1	0	1	0	1	2	0	0
12	48341936	.	G	A	0	14	14	0	7	21	0	0
12	48349836	.	C	T	0	2	2	0	4	6	0	0
12	48367442	.	T	G	1	0	1	0	0	1	0	0
12	48469825	.	C	T	16	12	28	0	3	31	0	0
12	48476965	.	A	T	12	10	22	0	3	25	0	0
12	48680110	.	C	G	0	1	1	0	0	1	0	0
12	48681826	.	A	T	5	7	12	0	0	12	0	0
12	48681827	.	T	A	5	7	12	0	0	12	0	0
12	48682002	.	A	G	4	6	10	0	0	10	0	0
12	48682089	.	G	T	3	2	5	0	0	5	0	0
12	48682317	.	A	G	5	3	8	0	2	10	0	0
12	48682530	.	G	C	13	5	18	0	0	18	0	0
12	48796831	.	C	T	1	0	1	0	0	1	0	0
12	48799261	.	C	T	2	3	5	0	1	6	0	0
12	48803126	.	G	C	4	3	7	0	0	7	0	0
12	48810338	.	C	T	2	3	5	0	0	5	0	0
12	48810557	.	G	T	0	6	6	0	14	20	0	0
12	48810558	.	C	T	13	7	20	0	0	20	0	0
12	48810865	.	C	T	7	10	17	0	1	18	0	0
12	48811035	.	T	C	9	16	25	0	1	26	0	0
12	48833090	.	T	C	1	2	3	0	0	3	0	0
12	48836348	.	A	G	6	7	13	0	1	14	0	0
12	48836482	.	G	A	8	6	14	0	1	15	0	0
12	48959393	.	A	G	4	1	5	0	1	6	0	0
12	48959630	.	G	A	2	5	7	0	0	7	0	0
12	48975613	.	G	A	0	2	2	0	0	2	0	0
12	48979161	.	T	C	2	0	2	0	3	5	0	0
12	48979219	.	T	C	2	0	2	0	4	6	0	0
12	48979234	.	T	C	1	0	1	0	4	5	0	0
12	48979648	.	C	T	0	2	2	0	0	2	0	0
12	49005119	.	G	T	2	4	6	0	0	6	0	0
12	49005150	.	T	C	0	3	3	0	0	3	0	0
12	49035182	.	G	A	0	2	2	0	1	3	0	0
12	49114550	.	G	T	0	8	8	0	6	14	0	0
12	49114592	.	A	G	6	0	6	0	6	12	0	0
12	49125725	.	C	A	1	2	3	0	0	3	0	0
12	49125898	.	C	T	3	1	4	0	0	4	0	0
12	49125949	.	A	G	2	2	4	0	0	4	0	0
12	49148399	.	A	G	1	0	1	0	0	1	0	0
12	49149457	.	C	T	0	0	0	0	1	1	0	0
12	49160120	.	G	A	0	2	2	0	1	3	0	0
12	49166926	.	C	T	7	6	13	0	0	13	0	0
13	10935	.	C	T	1	6	7	0	0	7	0	0
13	11028	.	A	G	0	0	0	0	7	7	0	0
13	11043	.	G	C	3	2	5	0	0	5	0	0
13	12252	.	C	G	3	3	6	0	1	7	0	0
13	40594	.	A	G	3	2	5	0	0	5	0	0
13	40622	.	C	G	2	2	4	0	0	4	0	0
13	40668	.	T	C	2	0	2	0	4	6	0	0
13	40676	.	A	C	2	1	3	0	1	4	0	0
13	40868	.	A	T	8	10	18	0	1	19	0	0
13	40965	.	T	G	9	11	20	0	0	20	0	0
13	42123	.	C	T	2	3	5	0	0	5	0	0
13	42182	.	C	G	1	2	3	0	0	3	0	0
13	46540	.	T	C	1	7	8	0	0	8	0	0
13	46625	.	T	C	9	0	9	0	18	27	0	0
13	46637	.	G	A	8	16	24	0	1	25	0	0
13	83970	.	C	T	0	0	0	0	5	5	0	0
13	111804	.	C	T	7	5	12	0	0	12	0	0
13	112666	.	C	G	6	4	10	0	1	11	0	0
13	214111	.	C	G	3	0	3	0	0	3	0	0
13	216407	.	T	C	4	1	5	0	12	17	0	0
13	216562	.	A	G	10	16	26	0	3	29	0	0
13	217848	.	A	C	4	10	14	0	0	14	0	0
13	220842	.	T	C	6	1	7	0	16	23	0	0
13	220874	.	T	A	5	16	21	0	0	21	0	0
13	221131	.	C	A	7	5	12	0	1	13	0	0
13	221478	.	G	C	10	10	20	0	2	22	0	0
13	236612	.	G	A	4	0	4	0	0	4	0	0
13	237954	.	T	C	4	2	6	0	0	6	0	0
13	269861	.	C	T	0	7	7	0	7	14	0	0
13	270083	.	G	A	14	8	22	0	0	22	0	0
13	270110	.	C	T	1	12	13	0	8	21	0	0
13	281330	.	T	C	14	9	23	0	1	24	0	0
13	281405	.	T	G	9	1	10	0	14	24	0	0
13	321752	.	C	T	0	6	6	0	3	9	0	0
13	322033	.	G	A	0	1	1	0	0	1	0	0
13	325797	.	G	A	3	3	6	0	0	6	0	0
13	329876	.	C	T	2	5	7	0	1	8	0	0
13	343143	.	T	C	2	1	3	0	7	10	0	0
13	343336	.	G	T	7	7	14	0	0	14	0	0
13	343363	.	T	C	6	0	6	0	2	8	0	0
13	343510	.	C	T	0	2	2	0	4	6	0	0
13	343530	.	G	T	3	2	5	0	1	6	0	0
13	343604	.	C	T	0	1	1	0	0	1	0	0
13	353686	.	C	T	4	6	10	0	0	10	0	0
13	421350	.	G	T	0	2	2	0	2	4	0	0
13	422990	.	T	C	0	0	0	0	1	1	0	0
13	428646	.	G	A	2	3	5	0	0	5	0	0
13	428766	.	C	T	7	8	15	0	0	15	0	0
13	428841	.	C	T	4	8	12	0	0	12	0	0
13	429087	.	C	T	14	4	18	0	2	20	0	0
13	429144	.	A	G	9	0	9	0	15	24	0	0
13	429429	.	A	G	11	0	11	0	18	29	0	0
13	429514	.	C	T	14	9	23	0	0	23	0	0
13	429846	.	C	A	20	13	33	0	0	33	0	0
13	450040	.	C	T	0	2	2	0	2	4	0	0
13	450101	.	C	T	8	4	12	0	2	14	0	0
13	452598	.	C	A	2	1	3	0	1	4	0	0
13	452615	.	G	T	1	4	5	0	0	5	0	0
13	454846	.	C	A	0	3	3	0	4	7	0	0
13	454919	.	A	G	1	2	3	0	0	3	0	0
13	514385	.	C	T	8	10	18	0	0	18	0	0
13	514664	.	G	A	8	11	19	0	2	21	0	0
13	514790	.	T	A	4	2	6	0	0	6	0	0
13	516347	.	G	C	10	10	20	0	1	21	0	0
13	516358	.	T	G	10	10	20	0	2	22	0	0
13	517163	.	G	T	2	6	8	0	0	8	0	0
13	518113	.	T	C	5	0	5	0	7	12	0	0
13	518915	.	G	A	5	5	10	0	0	10	0	0
13	522036	.	G	T	1	0	1	0	1	2	0	0
13	526943	.	G	A	1	0	1	0	0	1	0	0
13	527832	.	C	T	0	2	2	0	0	2	0	0
13	555325	.	C	T	4	5	9	0	1	10	0	0
13	555326	.	G	A	5	4	9	0	1	10	0	0
13	662727	.	G	A	0	2	2	0	0	2	0	0
13	663719	.	C	T	3	2	5	0	0	5	0	0
13	663752	.	A	G	1	0	1	0	6	7	0	0
13	663791	.	A	T	2	6	8	0	0	8	0	0
13	663805	.	G	A	6	0	6	0	1	7	0	0
13	664012	.	G	A	2	4	6	0	0	6	0	0
13	664139	.	C	T	2	1	3	0	0	3	0	0
13	664143	.	C	T	2	1	3	0	0	3	0	0
13	664196	.	A	G	1	0	1	0	8	9	0	0
13	677590	.	A	C	1	0	1	0	0	1	0	0
13	709009	.	G	T	1	2	3	0	0	3	0	0
13	718183	.	T	C	1	1	2	0	1	3	0	0
13	719316	.	C	T	1	1	2	0	0	2	0	0
13	719334	.	C	G	1	1	2	0	0	2	0	0
13	721290	.	C	T	3	6	9	0	0	9	0	0
13	721332	.	G	A	8	9	17	0	1	18	0	0
13	721617	.	C	T	1	2	3	0	1	4	0	0
13	724194	.	A	G	4	3	7	0	0	7	0	0
13	724249	.	C	T	0	3	3	0	0	3	0	0
13	763754	.	G	T	0	2	2	0	1	3	0	0
13	802925	.	C	T	4	2	6	0	0	6	0	0
13	808324	.	A	G	1	0	1	0	2	3	0	0
13	808325	.	G	A	1	2	3	0	0	3	0	0
13	808461	.	G	A	4	2	6	0	0	6	0	0
13	808530	.	A	C	2	2	4	0	0	4	0	0
13	808638	.	G	A	1	2	3	0	1	4	0	0
13	809369	.	G	T	4	2	6	0	0	6	0	0
13	809779	.	A	G	3	5	8	0	0	8	0	0
13	809917	.	T	C	1	4	5	0	0	5	0	0
13	809992	.	C	T	1	2	3	0	0	3	0	0
13	810158	.	A	G	2	0	2	0	3	5	0	0
13	813926	.	C	T	2	8	10	0	0	10	0	0
13	813930	.	G	T	2	8	10	0	1	11	0	0
13	814038	.	G	A	5	9	14	0	0	14	0	0
13	814191	.	G	C	3	5	8	0	0	8	0	0
13	814290	.	G	C	7	3	10	0	0	10	0	0
13	814459	.	G	A	4	4	8	0	0	8	0	0
13	814501	.	T	C	3	6	9	0	1	10	0	0
13	814719	.	G	A	7	3	10	0	0	10	0	0
13	826134	.	A	G	27	14	41	0	3	44	0	0
13	854419	.	G	A	0	2	2	0	0	2	0	0
13	854458	.	T	C	0	1	1	0	1	2	0	0
13	854627	.	G	A	2	4	6	0	0	6	0	0
13	1115091	.	C	T	3	1	4	0	1	5	0	0
13	1115106	.	C	T	4	1	5	0	0	5	0	0
13	1125197	.	C	T	3	9	12	0	0	12	0	0
13	1125199	.	C	A	3	8	11	0	1	12	0	0
13	1125292	.	T	A	7	10	17	0	2	19	0	0
13	1125331	.	G	C	18	12	30	0	0	30	0	0
13	1129255	.	G	C	2	4	6	0	1	7	0	0
13	1129261	.	T	C	1	3	4	0	1	5	0	0
13	1129902	.	T	C	9	5	14	0	1	15	0	0
13	1138357	.	C	T	2	2	4	0	0	4	0	0
13	1139908	.	A	C	1	2	3	0	1	4	0	0
13	1140659	.	C	G	5	3	8	0	2	10	0	0
13	1140941	.	C	T	6	4	10	0	0	10	0	0
13	1140987	.	G	T	10	4	14	0	0	14	0	0
13	1140992	.	C	T	10	5	15	0	0	15	0	0
13	1141064	.	T	C	9	2	11	0	1	12	0	0
13	1141067	.	T	C	9	2	11	0	1	12	0	0
13	1142775	.	G	C	7	7	14	0	1	15	0	0
13	1142839	.	C	A	2	4	6	0	18	24	0	0
13	1142841	.	T	A	17	4	21	0	2	24	1	0
13	1142918	.	G	A	11	17	28	0	8	36	0	0
13	1146062	.	A	G	0	3	3	0	0	3	0	0
13	1146101	.	C	T	5	10	15	0	1	16	0	0
13	1394938	.	G	A	0	1	1	0	2	3	0	0
13	1394941	.	G	A	1	1	2	0	1	3	0	0
13	1415315	.	C	G	0	6	6	0	3	9	0	0
13	1416074	.	C	A	3	3	6	0	0	6	0	0
13	1416098	.	G	A	2	5	7	0	0	7	0	0
13	1627605	.	G	A	1	1	2	0	0	2	0	0
13	1632106	.	G	A	4	2	6	0	0	6	0	0
13	1641762	.	C	T	0	1	1	0	0	1	0	0
13	1655426	.	T	C	0	2	2	0	0	2	0	0
13	1667865	.	T	A	2	2	4	0	0	4	0	0
13	1676895	.	G	A	0	0	0	0	6	6	0	0
13	1677009	.	G	T	0	1	1	0	2	3	0	0
13	1677859	.	G	T	1	2	3	0	0	3	0	0
13	1677913	.	C	T	8	7	15	0	1	16	0	0
13	1677958	.	A	G	3	0	3	0	6	9	0	0
13	1682856	.	T	C	1	4	5	0	1	6	0	0
13	1685150	.	G	C	5	6	11	0	0	11	0	0
13	1685192	.	A	T	7	5	12	0	1	13	0	0
13	1691983	.	T	A	2	0	2	0	0	2	0	0
13	1693284	.	G	A	0	1	1	0	7	8	0	0
13	1693312	.	C	A	9	7	16	0	0	16	0	0
13	1693386	.	C	T	2	5	7	0	0	7	0	0
13	1693392	.	C	T	1	5	6	0	0	6	0	0
13	1694395	.	C	A	4	7	11	0	4	15	0	0
13	1694417	.	C	A	3	10	13	0	0	13	0	0
13	1719777	.	G	A	0	28	28	0	15	43	0	0
13	2254461	.	T	A	2	2	4	0	0	4	0	0
13	2254668	.	A	C	5	1	6	0	1	10	3	0
13	2255239	.	G	A	2	3	5	0	1	6	0	0
13	2391818	.	A	G	10	7	17	0	4	21	0	0
13	2391948	.	G	A	0	9	9	0	12	21	0	0
13	2392397	.	G	A	7	5	12	0	1	13	0	0
13	2392434	.	G	A	8	5	13	0	0	13	0	0
13	2427331	.	T	C	1	4	5	0	0	5	0	0
13	2427540	.	T	C	18	9	27	0	0	27	0	0
13	2427569	.	T	C	13	1	14	0	17	31	0	0
13	2427702	.	T	C	22	0	22	0	31	53	0	0
13	2429080	.	C	A	14	26	40	0	1	41	0	0
13	2429300	.	A	G	4	3	7	0	1	8	0	0
13	2434335	.	G	T	13	3	16	0	0	16	0	0
13	2439886	.	C	T	0	1	1	0	0	1	0	0
13	2814352	.	G	A	1	2	3	0	0	3	0	0
13	2826397	.	T	C	5	6	11	0	0	11	0	0
13	2826445	.	G	C	0	5	5	0	10	15	0	0
13	2826746	.	G	T	5	2	7	0	2	9	0	0
13	2826747	.	T	G	6	3	9	0	0	9	0	0
13	2827560	.	A	C	10	15	25	0	4	29	0	0
13	2827578	.	C	A	11	17	28	0	2	30	0	0
13	2827605	.	G	T	16	22	38	0	1	39	0	0
13	2827700	.	G	C	14	22	36	0	3	39	0	0
13	2827808	.	A	G	21	5	26	0	0	26	0	0
13	2827867	.	A	G	13	21	34	0	1	35	0	0
13	2827918	.	A	T	11	9	20	0	2	22	0	0
13	2827998	.	G	A	13	15	28	0	1	29	0	0
13	2828028	.	T	C	11	23	34	0	3	37	0	0
13	2899483	.	G	A	2	2	4	0	1	5	0	0
13	2913844	.	T	C	14	11	25	0	3	28	0	0
13	2927832	.	T	A	1	2	3	0	1	4	0	0
13	3915333	.	A	G	6	10	16	0	0	16	0	0
13	3915383	.	C	A	10	5	15	0	3	18	0	0
13	3915476	.	A	C	15	15	30	0	2	32	0	0
13	3915644	.	A	C	19	8	27	0	0	27	0	0
13	3919353	.	T	G	4	3	7	0	0	7	0	0
13	3919632	.	A	G	3	4	7	0	0	7	0	0
13	3919672	.	T	G	3	3	6	0	0	6	0	0
13	3919686	.	G	A	4	2	6	0	0	6	0	0
13	3942055	.	G	A	0	2	2	0	5	7	0	0
13	3945643	.	C	T	0	2	2	0	0	2	0	0
13	3950007	.	G	A	7	6	13	0	0	15	2	0
13	3950044	.	A	G	14	6	20	0	0	20	0	0
13	3950307	.	A	G	8	8	16	0	0	16	0	0
13	3950577	.	C	G	8	11	19	0	3	22	0	0
13	3950669	.	T	A	9	11	20	0	2	22	0	0
13	3966055	.	T	A	16	11	27	0	2	29	0	0
13	3980349	.	C	T	0	4	4	0	5	9	0	0
13	3980947	.	T	C	4	0	4	0	9	13	0	0
13	3980962	.	G	A	4	7	11	0	1	12	0	0
13	3980993	.	C	T	0	10	10	0	7	17	0	0
13	4226678	.	C	A	5	4	9	0	1	10	0	0
13	4231368	.	G	T	0	9	9	0	18	27	0	0
13	4231396	.	C	T	16	11	27	0	0	27	0	0
13	4231438	.	T	A	5	7	12	0	0	12	0	0
13	4231643	.	T	A	5	5	10	0	1	11	0	0
13	4231652	.	A	G	4	7	11	0	0	11	0	0
13	4231787	.	A	G	6	8	14	0	0	14	0	0
13	4232014	.	T	A	3	3	6	0	1	8	1	0
13	4232016	.	G	A	0	3	3	0	5	8	0	0
13	4232112	.	A	G	9	5	14	0	0	14	0	0
13	4232171	.	C	T	8	19	27	0	1	28	0	0
13	4232396	.	G	A	9	6	15	0	2	17	0	0
13	4232737	.	A	G	12	11	23	0	4	27	0	0
13	4233030	.	C	T	0	19	19	0	17	36	0	0
13	4233033	.	G	A	17	14	31	0	4	35	0	0
13	4233361	.	G	T	8	9	17	0	0	17	0	0
13	4233365	.	G	A	9	8	17	0	2	19	0	0
13	4233625	.	T	A	3	11	14	0	1	15	0	0
13	4233779	.	G	A	5	6	11	0	0	11	0	0
13	4233889	.	G	A	3	3	6	0	2	8	0	0
13	4233911	.	G	C	4	5	9	0	0	9	0	0
13	4233970	.	A	G	3	7	10	0	1	11	0	0
13	4234139	.	A	T	0	5	5	1	0	6	0	0
13	4234349	.	G	T	1	8	9	0	0	9	0	0
13	4234402	.	A	T	1	5	6	0	1	7	0	0
13	4307782	.	C	T	14	10	24	0	5	29	0	0
13	4308714	.	C	A	10	7	17	0	0	17	0	0
13	4309166	.	T	G	7	5	12	0	0	12	0	0
13	4309607	.	T	C	6	4	10	0	0	10	0	0
13	4309778	.	T	A	5	3	8	0	1	9	0	0
13	4309866	.	T	C	2	2	4	0	0	4	0	0
13	4310247	.	G	A	2	3	5	0	2	7	0	0
13	4310349	.	T	A	5	2	7	0	3	10	0	0
13	4310367	.	C	G	0	4	4	0	7	11	0	0
13	4310511	.	C	T	1	2	3	0	5	8	0	0
13	4310610	.	C	T	7	2	9	0	1	10	0	0
13	4311912	.	C	T	3	2	5	0	0	5	0	0
13	4339078	.	A	G	2	2	4	0	0	4	0	0
13	4339638	.	T	C	6	0	6	0	10	16	0	0
13	4343183	.	C	T	0	3	3	0	3	6	0	0
13	4343437	.	C	T	0	4	4	0	6	10	0	0
13	4343468	.	T	A	5	4	9	0	1	10	0	0
13	4343490	.	G	A	5	5	10	0	0	10	0	0
13	4344378	.	A	T	1	2	3	0	0	3	0	0
13	4344800	.	T	C	2	1	3	0	2	5	0	0
13	4344938	.	T	C	2	3	5	0	0	5	0	0
13	4366741	.	G	T	1	2	3	0	0	3	0	0
13	4366805	.	T	C	2	2	4	0	0	4	0	0
13	4399661	.	A	G	5	3	8	0	0	8	0	0
13	4951747	.	T	C	6	5	11	0	1	12	0	0
13	4956118	.	G	A	3	2	5	0	0	5	0	0
13	4956151	.	C	T	0	2	2	0	0	2	0	0
13	4968421	.	A	G	1	2	3	0	0	3	0	0
13	4968583	.	T	A	7	7	14	0	1	15	0	0
13	4968849	.	A	G	11	11	22	0	1	23	0	0
13	4968890	.	T	C	6	12	18	0	3	21	0	0
13	4968905	.	T	C	8	16	24	0	2	26	0	0
13	4969239	.	A	G	24	12	36	0	0	36	0	0
13	4973701	.	T	A	9	8	17	0	1	18	0	0
13	4973775	.	C	A	6	3	9	0	1	10	0	0
13	4973856	.	C	T	0	5	5	0	7	12	0	0
13	4973979	.	A	G	6	4	10	0	0	10	0	0
13	4977950	.	C	T	1	0	1	0	0	1	0	0
13	4977962	.	A	G	1	0	1	0	0	1	0	0
13	4978680	.	A	G	6	5	11	0	0	11	0	0
13	4978707	.	T	C	4	1	5	0	5	10	0	0
13	4978716	.	A	G	5	4	9	0	0	9	0	0
13	4979642	.	C	T	2	2	4	0	1	5	0	0
13	4995638	.	G	T	0	11	11	0	8	19	0	0
13	4995902	.	A	G	8	6	14	0	1	15	0	0
13	4995916	.	T	A	6	3	9	0	0	9	0	0
13	5000490	.	G	A	0	3	3	0	4	7	0	0
13	5000606	.	G	A	6	3	9	0	1	10	0	0
13	5000615	.	T	A	3	2	5	0	2	7	0	0
13	5013813	.	T	C	0	1	1	0	0	1	0	0
13	5013999	.	A	G	4	2	6	0	0	6	0	0
13	5017657	.	A	G	3	6	9	0	0	9	0	0
13	5017699	.	G	A	3	6	9	0	2	11	0	0
13	5246113	.	G	A	1	4	5	0	0	5	0	0
13	5491234	.	G	A	22	25	47	0	4	51	0	0
13	5531709	.	A	G	5	5	10	0	0	10	0	0
13	5936742	.	A	T	1	2	3	0	2	5	0	0
13	5987712	.	A	G	2	1	3	0	0	3	0	0
13	5988145	.	A	G	5	3	8	0	0	8	0	0
13	6205004	.	C	T	6	3	9	0	3	12	0	0
13	7063446	.	T	C	2	3	5	0	0	5	0	0
13	7063494	.	G	T	0	4	4	0	4	8	0	0
13	7063602	.	C	G	3	5	8	0	0	8	0	0
13	7170061	.	C	T	2	2	4	0	0	4	0	0
13	7170087	.	C	T	3	3	6	0	0	6	0	0
13	7258946	.	T	C	2	10	12	0	1	13	0	0
13	7313703	.	C	T	2	2	4	0	1	5	0	0
13	7314736	.	A	C	5	5	10	0	0	10	0	0
13	7314859	.	C	A	3	5	8	0	1	9	0	0
13	7315123	.	C	T	3	5	8	0	1	9	0	0
13	7315174	.	C	A	9	5	14	0	0	14	0	0
13	7315234	.	A	G	7	5	12	0	1	13	0	0
13	7316463	.	G	A	4	4	8	0	1	9	0	0
13	7316746	.	A	G	8	0	8	0	12	20	0	0
13	7316784	.	G	A	4	8	12	0	1	13	0	0
13	7316830	.	C	G	6	7	13	0	0	13	0	0
13	7316849	.	A	T	4	5	9	0	1	10	0	0
13	7346655	.	C	A	13	2	15	0	0	15	0	0
13	7346683	.	A	G	13	8	21	0	1	22	0	0
13	7346798	.	A	G	17	14	31	0	2	33	0	0
13	7346928	.	A	C	20	7	27	0	1	28	0	0
13	7347026	.	A	G	14	10	24	0	0	24	0	0
13	7347060	.	G	T	9	10	19	0	0	19	0	0
13	7347061	.	A	T	9	10	19	0	0	19	0	0
13	7347125	.	G	A	5	2	7	0	1	8	0	0
13	7744624	.	T	G	1	5	6	0	0	6	0	0
13	7747513	.	C	G	2	7	9	0	0	9	0	0
13	7747760	.	T	C	4	10	14	0	2	16	0	0
13	7747831	.	T	G	12	5	17	0	0	17	0	0
13	7748218	.	T	C	10	9	19	0	0	19	0	0
13	7748424	.	T	C	1	3	4	0	0	4	0	0
13	7748497	.	T	G	3	4	7	0	1	9	1	0
13	7748882	.	A	T	13	17	30	0	1	31	0	0
13	7748995	.	T	A	13	15	28	0	1	29	0	0
13	7749000	.	G	C	10	14	24	0	3	27	0	0
13	7759403	.	T	C	1	7	8	0	0	8	0	0
13	8152771	.	T	C	0	1	1	0	0	1	0	0
13	8777993	.	A	T	22	4	26	0	6	35	3	0
13	8777995	.	A	G	19	2	21	0	12	35	2	0
13	9315178	.	T	C	39	15	54	0	1	55	0	0
13	9315192	.	T	C	21	30	51	0	0	51	0	0
13	9829197	.	T	C	2	2	4	0	0	4	0	0
13	9829855	.	C	T	2	3	5	0	0	5	0	0
13	9830089	.	T	C	1	4	5	0	1	6	0	0
13	9830591	.	A	T	2	4	6	0	0	6	0	0
13	9830597	.	C	A	4	2	6	0	0	6	0	0
13	9844440	.	G	A	1	1	2	0	0	2	0	0
13	9848385	.	G	A	3	3	6	0	0	6	0	0
13	9848577	.	A	G	21	19	40	0	3	43	0	0
13	9855508	.	G	T	18	15	33	0	1	34	0	0
13	9855874	.	G	A	15	14	29	0	0	29	0	0
13	9856319	.	A	G	10	7	17	0	1	18	0	0
13	9856427	.	A	G	8	4	12	0	0	12	0	0
13	9856493	.	A	T	14	15	29	0	2	31	0	0
13	9856658	.	A	G	13	16	29	0	2	31	0	0
13	10235142	.	T	A	2	2	4	0	0	4	0	0
13	10361335	.	A	G	1	3	4	0	0	4	0	0
13	12635862	.	C	A	2	2	4	0	0	4	0	0
13	12665699	.	T	C	2	2	4	0	1	5	0	0
13	12665745	.	T	C	1	2	3	0	0	3	0	0
13	12994738	.	A	T	9	4	13	0	1	14	0	0
13	12994743	.	G	T	5	6	11	0	1	12	0	0
13	12997845	.	C	T	3	3	6	0	1	7	0	0
13	13096526	.	T	C	1	3	4	0	0	4	0	0
13	13099606	.	G	A	1	3	4	0	0	4	0	0
13	13099625	.	T	C	1	3	4	0	0	4	0	0
13	13213863	.	G	A	12	2	14	0	0	14	0	0
13	13214412	.	G	A	7	9	16	0	3	19	0	0
13	13216381	.	T	A	4	2	6	0	0	6	0	0
13	13733417	.	G	T	6	10	16	0	1	17	0	0
13	14002735	.	A	C	3	2	5	0	0	5	0	0
13	14003099	.	A	G	1	4	5	0	0	5	0	0
13	14004141	.	C	T	4	8	12	0	0	12	0	0
13	14004209	.	C	T	8	5	13	0	1	14	0	0
13	14004246	.	T	A	5	9	14	0	1	15	0	0
13	14116632	.	C	T	1	0	1	0	0	1	0	0
13	14181912	.	A	C	7	3	10	0	0	11	1	0
13	14181952	.	T	C	1	6	7	0	0	7	0	0
13	14190780	.	C	T	0	17	17	0	15	32	0	0
13	14191033	.	T	C	15	15	30	0	2	32	0	0
13	14191045	.	G	C	16	14	30	0	1	31	0	0
13	14192067	.	T	C	5	3	8	0	0	8	0	0
13	14192110	.	T	C	6	3	9	0	0	9	0	0
13	14192178	.	A	T	2	1	3	0	0	3	0	0
13	14192376	.	A	G	2	3	5	0	0	5	0	0
13	14194660	.	G	A	3	6	9	0	0	9	0	0
13	14194968	.	T	A	2	4	6	0	0	6	0	0
13	14199220	.	A	T	1	2	3	0	0	3	0	0
13	14902500	.	C	A	6	3	9	0	1	10	0	0
13	14902507	.	T	C	5	3	8	0	1	9	0	0
13	14902546	.	C	T	7	7	14	0	1	15	0	0
13	14906587	.	G	C	6	4	10	0	1	11	0	0
13	14906614	.	G	A	9	5	14	0	1	15	0	0
13	14906754	.	A	G	0	1	1	0	0	1	0	0
13	14908880	.	A	G	2	3	5	0	0	5	0	0
13	14908903	.	T	C	3	2	5	0	0	5	0	0
13	15213130	.	A	T	6	2	8	0	0	8	0	0
13	15215789	.	A	T	4	1	5	0	1	6	0	0
13	15580864	.	T	A	2	2	4	0	0	4	0	0
13	15647444	.	A	G	1	1	2	0	0	2	0	0
13	15657987	.	A	G	5	16	21	0	2	23	0	0
13	15668124	.	A	T	4	7	11	0	0	11	0	0
13	15713086	.	G	A	0	2	2	0	0	2	0	0
13	15762515	.	T	C	2	13	15	0	1	16	0	0
13	15763061	.	G	T	0	2	2	0	0	2	0	0
13	15801705	.	T	A	1	1	2	0	0	2	0	0
13	15801726	.	T	C	3	2	5	0	0	5	0	0
13	15814429	.	A	G	4	1	5	0	0	5	0	0
13	15814724	.	T	A	4	4	8	0	0	8	0	0
13	15849541	.	T	C	1	2	3	0	0	3	0	0
13	15882860	.	A	C	8	4	12	0	0	12	0	0
13	16191517	.	A	T	0	1	1	0	0	1	0	0
13	16313525	.	G	C	1	1	2	0	0	2	0	0
13	16326333	.	G	T	1	5	6	0	1	7	0	0
13	16479914	.	T	A	0	2	2	0	0	2	0	0
13	16496377	.	G	A	0	5	5	0	2	7	0	0
13	16496770	.	T	A	15	13	28	0	0	28	0	0
13	16856045	.	T	A	3	3	6	0	0	6	0	0
13	16878895	.	A	C	3	4	7	0	2	9	0	0
13	16886040	.	C	T	6	6	12	0	0	12	0	0
13	16886068	.	C	T	8	5	13	0	0	13	0	0
13	17470079	.	C	T	7	4	11	0	1	12	0	0
13	17470430	.	T	C	5	11	16	0	0	16	0	0
13	17703164	.	A	T	2	2	4	0	0	4	0	0
13	17705633	.	C	T	1	1	2	0	0	2	0	0
13	17714530	.	C	A	28	18	46	0	4	50	0	0
13	17714905	.	T	C	26	11	37	0	1	38	0	0
13	17714942	.	A	G	14	15	29	0	5	34	0	0
13	17717608	.	G	A	1	1	2	0	0	2	0	0
13	17752932	.	A	T	5	14	19	0	1	20	0	0
13	17753144	.	A	C	5	0	5	0	8	13	0	0
13	17753319	.	T	C	4	2	6	0	1	7	0	0
13	17753668	.	A	C	13	4	17	0	2	19	0	0
13	17753732	.	A	T	11	6	17	0	0	17	0	0
13	17753821	.	A	T	5	6	11	0	0	11	0	0
13	17754275	.	G	T	1	2	3	0	1	4	0	0
13	17754700	.	T	C	0	1	1	0	0	1	0	0
13	17754720	.	A	T	0	2	2	0	0	2	0	0
13	18024418	.	C	T	2	3	5	0	0	5	0	0
13	18024419	.	A	G	2	3	5	0	0	5	0	0
13	18033073	.	T	G	1	2	3	0	0	3	0	0
13	18073433	.	A	G	11	14	25	0	2	27	0	0
13	18073524	.	G	T	10	9	19	0	4	23	0	0
13	18073582	.	G	T	6	9	15	0	4	20	1	0
13	18073706	.	G	A	11	3	14	0	2	16	0	0
13	18076710	.	T	G	5	5	10	0	0	10	0	0
13	18076788	.	G	C	8	10	18	0	2	20	0	0
13	18076818	.	G	A	8	10	18	0	0	18	0	0
13	18076996	.	C	T	11	8	19	0	0	19	0	0
13	18077056	.	G	T	6	10	16	0	0	16	0	0
13	18077116	.	G	A	8	8	16	0	0	16	0	0
13	18077191	.	C	G	6	5	11	0	0	11	0	0
13	18083415	.	G	A	1	1	2	0	1	3	0	0
13	18088276	.	T	G	1	1	2	0	0	2	0	0
13	18104890	.	C	T	0	1	1	0	0	1	0	0
13	18104929	.	A	T	2	3	5	0	0	5	0	0
13	18179391	.	G	C	1	0	1	0	8	9	0	0
13	18179521	.	A	G	2	3	5	0	0	5	0	0
13	18179535	.	G	T	2	3	5	0	1	6	0	0
13	18179757	.	T	C	1	11	12	0	1	13	0	0
13	18179859	.	C	A	6	9	15	0	3	18	0	0
13	18185457	.	A	C	1	0	1	0	2	3	0	0
13	18185463	.	C	A	1	1	2	0	0	2	0	0
13	18321156	.	T	C	2	2	4	0	0	4	0	0
13	18323464	.	A	G	7	7	14	0	0	14	0	0
13	18323595	.	G	A	0	6	6	0	7	13	0	0
13	18323653	.	A	G	8	0	8	0	9	17	0	0
13	18323787	.	T	A	8	9	17	0	2	19	0	0
13	18358890	.	G	C	10	11	21	0	1	22	0	0
13	18359112	.	G	C	16	19	35	0	4	39	0	0
13	18359304	.	A	T	4	9	13	0	2	15	0	0
13	18359374	.	C	T	14	8	22	0	6	28	0	0
13	18359507	.	A	T	7	9	16	0	0	16	0	0
13	18418337	.	C	A	0	1	1	0	2	3	0	0
13	18418528	.	G	A	2	2	4	0	0	4	0	0
13	18428103	.	A	G	3	4	7	0	1	8	0	0
13	18431278	.	T	A	4	3	7	0	0	7	0	0
13	18431301	.	C	T	5	4	9	0	0	9	0	0
13	18431430	.	C	T	1	4	5	0	0	5	0	0
13	18434427	.	C	T	8	8	16	0	1	17	0	0
13	18434519	.	C	A	5	5	10	0	1	11	0	0
13	18434520	.	G	C	0	4	4	0	7	11	0	0
13	18434818	.	C	G	9	15	24	0	0	24	0	0
13	18434902	.	C	T	6	10	16	0	1	17	0	0
13	18434957	.	G	A	10	7	17	0	0	17	0	0
13	18434962	.	A	G	10	5	15	0	0	15	0	0
13	18499807	.	A	G	2	2	4	0	0	4	0	0
13	18510319	.	C	A	1	5	6	0	0	6	0	0
13	18510324	.	A	G	1	4	5	0	0	5	0	0
13	18511023	.	C	T	5	3	8	0	0	8	0	0
13	18511637	.	A	C	3	5	8	0	3	11	0	0
13	18511763	.	T	A	6	6	12	0	0	12	0	0
13	18511996	.	A	T	10	14	24	0	2	26	0	0
13	18512030	.	A	T	12	16	28	0	0	28	0	0
13	18512082	.	C	G	8	10	18	0	2	20	0	0
13	18663947	.	G	A	4	6	10	0	0	10	0	0
13	19304688	.	A	G	4	9	13	0	1	14	0	0
13	19316930	.	G	C	4	13	17	0	0	17	0	0
13	19317016	.	T	A	3	7	10	0	0	10	0	0
13	19317018	.	C	G	3	7	10	0	0	10	0	0
13	19317051	.	T	G	3	8	11	0	1	12	0	0
13	19799192	.	A	G	3	1	4	0	1	5	0	0
13	19799522	.	C	T	8	3	11	0	4	15	0	0
13	19799535	.	T	A	9	7	16	0	1	17	0	0
13	19799623	.	T	C	8	8	16	0	0	16	0	0
13	19799646	.	C	A	0	10	10	0	7	17	0	0
13	19799705	.	A	G	8	3	11	0	3	14	0	0
13	20401263	.	C	A	0	1	1	0	1	2	0	0
13	21676271	.	G	A	1	1	2	0	0	2	0	0
13	21681224	.	A	T	1	0	1	0	0	1	0	0
13	21683057	.	A	C	2	3	5	0	1	6	0	0
13	21683077	.	T	C	2	2	4	0	0	4	0	0
13	21683488	.	A	T	19	19	38	0	0	38	0	0
13	21683511	.	T	G	14	19	33	0	1	34	0	0
13	21683546	.	C	T	13	16	29	0	0	29	0	0
13	21689373	.	G	A	1	2	3	0	1	4	0	0
13	21689438	.	A	C	6	10	16	0	1	17	0	0
13	21689439	.	C	T	6	11	17	0	0	17	0	0
13	21689530	.	A	T	13	5	18	0	1	19	0	0
13	21689839	.	C	T	3	12	15	0	0	15	0	0
13	21689854	.	C	T	13	0	13	0	0	13	0	0
13	21690096	.	C	G	4	3	7	0	1	8	0	0
13	21690229	.	A	C	1	3	4	2	0	6	0	0
13	21690374	.	G	A	10	7	17	1	2	20	0	0
13	21690530	.	C	T	0	5	5	0	7	12	0	0
13	21690724	.	A	T	2	5	7	0	0	7	0	0
13	21690907	.	G	A	0	1	1	1	1	3	0	0
13	21691416	.	G	A	4	3	7	0	0	7	0	0
13	21770891	.	T	C	6	9	15	0	0	15	0	0
13	21775469	.	C	T	6	11	17	0	2	19	0	0
13	21775697	.	C	T	5	10	15	0	0	15	0	0
13	21776213	.	G	A	0	2	2	0	0	2	0	0
13	21821299	.	G	T	5	2	7	0	1	8	0	0
13	21821393	.	A	C	4	3	7	0	1	8	0	0
13	21870467	.	G	C	0	3	3	0	4	7	0	0
13	21870608	.	A	T	3	4	7	0	1	8	0	0
13	21874107	.	C	T	2	2	4	0	0	4	0	0
13	21874149	.	G	T	0	7	7	0	4	11	0	0
13	21874649	.	C	T	7	4	11	0	0	11	0	0
13	21884298	.	C	T	7	10	17	0	1	18	0	0
13	21884328	.	G	A	5	12	17	0	0	17	0	0
13	21884407	.	T	C	6	10	16	0	0	16	0	0
13	21884408	.	C	T	6	9	15	0	1	16	0	0
13	21884979	.	T	C	9	15	24	0	3	27	0	0
13	21884980	.	C	T	9	18	27	0	0	27	0	0
13	21885143	.	C	A	16	15	31	0	1	32	0	0
13	21885198	.	T	A	25	18	43	0	1	44	0	0
13	22087098	.	C	T	1	2	3	0	0	3	0	0
13	22087508	.	C	T	4	5	9	0	1	10	0	0
13	22094800	.	T	C	4	8	12	0	0	12	0	0
13	22094871	.	T	G	7	8	15	0	1	16	0	0
13	22095589	.	G	A	5	11	16	0	0	16	0	0
13	22095594	.	T	A	7	9	16	0	1	17	0	0
13	22238125	.	C	A	0	3	3	0	0	3	0	0
13	22238209	.	T	C	2	6	8	0	0	8	0	0
13	22238233	.	G	A	2	3	5	0	1	6	0	0
13	22240672	.	T	A	1	1	2	0	0	2	0	0
13	22241103	.	T	A	2	7	9	0	0	9	0	0
13	22241123	.	G	T	0	3	3	0	4	7	0	0
13	22241374	.	A	C	6	11	17	0	1	20	2	0
13	22241482	.	G	C	5	2	7	0	1	8	0	0
13	22241648	.	T	G	16	13	29	0	0	29	0	0
13	22241730	.	G	C	22	11	33	0	1	34	0	0
13	22241731	.	A	T	21	9	30	0	4	34	0	0
13	22242197	.	G	C	17	17	34	0	3	37	0	0
13	22242299	.	C	G	11	20	31	0	4	35	0	0
13	22242394	.	C	G	17	20	37	0	1	38	0	0
13	22242837	.	T	G	22	20	42	0	2	44	0	0
13	22243211	.	A	C	15	13	28	0	2	30	0	0
13	22364908	.	T	C	1	4	5	0	1	6	0	0
13	22365016	.	C	T	3	6	9	0	1	10	0	0
13	22365461	.	A	G	2	3	5	0	0	5	0	0
13	22367600	.	C	A	0	4	4	0	0	4	0	0
13	22369295	.	T	C	1	2	3	0	0	3	0	0
13	22369349	.	C	T	4	3	7	0	0	7	0	0
13	22371981	.	G	A	0	7	7	0	7	14	0	0
13	22372015	.	C	G	7	9	16	0	3	19	0	0
13	22372075	.	T	C	9	6	15	0	2	17	0	0
13	22372105	.	G	A	1	9	10	0	6	16	0	0
13	22372126	.	C	T	6	14	20	0	1	21	0	0
13	22372205	.	A	G	9	11	20	0	2	22	0	0
13	22551447	.	A	G	3	2	5	0	0	5	0	0
13	22619157	.	C	T	4	5	9	0	1	10	0	0
13	22659195	.	C	G	3	0	3	0	11	14	0	0
13	22659196	.	A	G	3	11	14	0	0	14	0	0
13	22659231	.	G	A	0	10	10	0	3	13	0	0
13	22659291	.	A	G	10	6	16	0	0	16	0	0
13	22659363	.	G	A	1	0	1	0	0	1	0	0
13	22669319	.	T	C	2	7	9	0	0	9	0	0
13	22679537	.	C	G	1	2	3	0	0	3	0	0
13	22679837	.	G	A	3	4	7	0	0	7	0	0
13	22735063	.	T	C	4	5	9	0	0	9	0	0
13	22735139	.	A	G	5	6	11	0	2	13	0	0
13	22868017	.	G	A	1	2	3	0	0	3	0	0
13	22871989	.	A	G	4	2	6	0	1	7	0	0
13	22876576	.	T	C	4	0	4	0	14	18	0	0
13	22876623	.	G	A	5	12	17	0	1	18	0	0
13	22876678	.	A	T	9	11	20	0	3	23	0	0
13	22877076	.	C	T	6	13	19	0	3	22	0	0
13	22877130	.	G	T	7	14	21	0	1	22	0	0
13	22878754	.	G	A	0	2	2	0	0	2	0	0
13	22879149	.	A	T	6	5	11	0	0	11	0	0
13	22898042	.	A	G	0	2	2	0	0	2	0	0
13	22924509	.	C	T	1	2	3	0	0	3	0	0
13	22924522	.	A	C	1	2	3	0	0	3	0	0
13	22973314	.	A	G	28	30	58	0	0	58	0	0
13	22973348	.	A	G	24	26	50	0	2	52	0	0
13	22973531	.	T	C	13	0	13	0	26	39	0	0
13	22973895	.	A	G	12	17	29	0	3	32	0	0
13	22974033	.	A	G	15	16	31	0	3	34	0	0
13	22974108	.	C	T	4	4	8	0	2	10	0	0
13	22976067	.	C	A	7	8	15	0	1	16	0	0
13	22976070	.	G	A	7	7	14	0	1	15	0	0
13	22977283	.	G	A	2	4	6	0	0	6	0	0
13	22977319	.	A	G	3	8	11	0	0	11	0	0
13	22977343	.	A	G	2	6	8	0	0	8	0	0
13	22978059	.	T	C	3	0	3	0	2	5	0	0
13	22978062	.	G	A	3	2	5	0	0	5	0	0
13	23037831	.	C	A	6	5	11	0	0	11	0	0
13	23042321	.	A	G	0	1	1	0	0	1	0	0
13	23042387	.	C	G	5	3	8	1	2	11	0	0
13	23042676	.	A	G	4	3	7	0	1	8	0	0
13	23042745	.	G	A	6	2	8	0	0	8	0	0
13	23070895	.	T	C	1	9	10	0	1	11	0	0
13	23070994	.	A	G	2	3	5	0	0	5	0	0
13	23084177	.	C	G	9	18	27	0	1	28	0	0
13	23084841	.	G	C	2	8	10	0	2	12	0	0
13	23090190	.	A	C	3	4	7	0	0	7	0	0
13	23120698	.	T	C	0	1	1	0	0	1	0	0
13	23128675	.	A	G	3	0	3	0	2	5	0	0
13	23128685	.	A	G	3	2	5	0	0	5	0	0
13	23223675	.	C	A	2	2	4	0	0	4	0	0
13	23223699	.	A	G	1	0	1	0	2	3	0	0
13	23224470	.	G	A	3	3	6	0	0	6	0	0
13	23224605	.	G	T	4	4	8	0	0	8	0	0
13	23224727	.	C	T	3	6	9	0	0	9	0	0
13	23224735	.	A	G	3	5	8	0	1	9	0	0
13	23224821	.	T	A	2	7	9	0	0	9	0	0
13	23224860	.	T	A	6	5	11	0	0	11	0	0
13	23225541	.	T	C	10	8	18	0	1	19	0	0
13	23225776	.	T	A	6	4	10	0	1	11	0	0
13	23226114	.	G	A	0	10	10	0	11	21	0	0
13	23226213	.	A	C	13	10	23	0	0	23	0	0
13	23234499	.	A	G	2	4	6	0	0	6	0	0
13	23314904	.	T	G	4	5	9	0	0	9	0	0
13	23382393	.	G	A	3	1	4	0	0	4	0	0
13	23387252	.	T	C	7	4	11	0	1	12	0	0
13	23692572	.	C	T	0	1	1	0	0	1	0	0
13	23703048	.	G	C	2	2	4	0	0	4	0	0
13	23703053	.	T	C	2	1	3	0	1	4	0	0
13	23709532	.	C	T	5	2	7	0	0	7	0	0
13	23709562	.	T	C	6	6	12	0	1	13	0	0
13	23709592	.	A	G	8	10	18	0	2	20	0	0
13	23711937	.	G	A	5	7	12	0	2	14	0	0
13	23730801	.	G	A	1	2	3	0	0	3	0	0
13	23898015	.	A	T	4	4	8	0	0	8	0	0
13	23898045	.	T	G	4	4	8	0	0	8	0	0
13	23901334	.	C	T	5	9	14	0	1	15	0	0
13	23901349	.	T	C	7	7	14	0	4	18	0	0
13	23901502	.	A	G	10	11	21	0	2	23	0	0
13	23901555	.	A	G	13	0	13	0	8	21	0	0
13	23901570	.	T	C	15	7	22	0	0	22	0	0
13	23996192	.	G	A	4	2	6	0	0	6	0	0
13	23999129	.	G	A	1	1	2	0	0	2	0	0
13	23999264	.	G	C	1	2	3	0	0	3	0	0
13	23999274	.	T	A	2	2	4	0	0	4	0	0
13	24000394	.	G	A	2	1	3	0	0	3	0	0
13	24056221	.	C	T	3	4	7	0	0	7	0	0
13	24068790	.	C	T	0	14	14	0	11	25	0	0
13	24069624	.	C	A	7	6	13	0	2	15	0	0
13	24069902	.	A	T	1	9	10	0	1	11	0	0
13	24070242	.	C	T	0	5	5	0	5	10	0	0
13	24070730	.	C	T	1	3	4	0	0	4	0	0
13	24234815	.	C	A	1	2	3	0	1	4	0	0
13	24276354	.	A	G	4	2	6	0	1	7	0	0
13	24276366	.	C	T	6	2	8	0	0	8	0	0
13	24290140	.	A	G	1	1	2	0	0	2	0	0
13	24292374	.	A	G	1	3	4	0	0	4	0	0
13	24292675	.	A	G	5	6	11	0	1	12	0	0
13	24292727	.	G	A	12	17	29	0	0	29	0	0
13	24292796	.	T	A	14	18	32	0	2	34	0	0
13	24292800	.	A	T	13	20	33	0	1	34	0	0
13	24292947	.	A	T	4	7	11	0	1	12	0	0
13	24293381	.	A	T	6	14	20	0	1	21	0	0
13	24293465	.	C	T	7	14	21	0	8	29	0	0
13	24293516	.	G	A	10	21	31	0	5	36	0	0
13	24293518	.	C	A	14	21	35	0	1	36	0	0
13	24293615	.	G	A	9	19	28	0	17	45	0	0
13	24293698	.	C	T	24	8	32	0	3	35	0	0
13	24294046	.	A	G	11	8	19	0	0	19	0	0
13	24296198	.	A	T	0	3	3	0	0	3	0	0
13	24381350	.	A	G	1	1	2	0	0	2	0	0
13	24382137	.	G	A	0	2	2	0	2	4	0	0
13	24382152	.	T	C	2	2	4	0	0	4	0	0
13	24382539	.	T	C	3	2	5	0	0	5	0	0
13	24383589	.	T	G	2	4	6	0	0	6	0	0
13	24401626	.	G	C	0	3	3	0	0	3	0	0
13	24401663	.	C	A	0	2	2	0	0	2	0	0
13	24402560	.	T	C	0	3	3	0	0	3	0	0
13	24411029	.	A	G	18	8	26	0	2	28	0	0
13	24431365	.	T	G	2	6	8	0	0	8	0	0
13	24432096	.	C	T	8	5	13	0	1	14	0	0
13	24432162	.	G	C	3	7	10	0	1	11	0	0
13	24432350	.	C	T	0	6	6	0	7	13	0	0
13	24523425	.	A	G	3	2	5	0	0	5	0	0
13	24523469	.	G	A	0	3	3	0	7	10	0	0
13	24524206	.	G	A	4	8	12	0	2	14	0	0
13	24524305	.	T	G	2	3	5	0	0	5	0	0
13	24580411	.	G	A	3	4	7	0	0	7	0	0
13	24580705	.	C	T	2	2	4	0	1	5	0	0
13	24580756	.	G	C	0	0	0	0	3	3	0	0
13	24580869	.	T	C	1	2	3	0	0	3	0	0
13	24580941	.	T	C	0	2	2	0	0	2	0	0
13	24581274	.	G	A	2	1	3	0	0	3	0	0
13	24581316	.	C	A	3	7	10	0	1	11	0	0
13	24581334	.	G	C	8	2	10	0	0	10	0	0
13	24581358	.	T	C	1	1	2	0	0	2	0	0
13	24581748	.	A	C	7	7	14	0	1	15	0	0
13	24581798	.	T	A	7	5	12	0	3	15	0	0
13	24581840	.	T	G	12	10	22	0	1	23	0	0
13	24581854	.	C	T	13	12	25	0	0	25	0	0
13	24582047	.	A	G	7	11	18	0	1	19	0	0
13	24582110	.	C	T	11	10	21	0	2	23	0	0
13	24582122	.	T	C	10	9	19	0	1	20	0	0
13	24582211	.	C	T	3	11	14	0	3	17	0	0
13	24582213	.	G	A	11	3	14	0	3	17	0	0
13	24586121	.	A	C	3	2	5	0	0	5	0	0
13	24586123	.	C	T	3	2	5	0	0	5	0	0
13	24664317	.	T	G	2	2	4	0	0	4	0	0
13	24665421	.	G	T	2	4	6	0	0	6	0	0
13	24665759	.	T	G	2	0	2	0	0	2	0	0
13	24702033	.	C	A	0	9	9	0	4	13	0	0
13	24702114	.	T	C	13	6	19	0	3	22	0	0
13	24702415	.	T	C	6	6	12	0	3	15	0	0
13	24702478	.	T	G	6	3	9	0	1	10	0	0
13	24702602	.	T	A	5	2	7	0	1	8	0	0
13	24702652	.	A	T	6	2	8	0	0	8	0	0
13	24702883	.	A	T	1	6	7	0	0	7	0	0
13	24741258	.	G	A	0	2	2	0	1	3	0	0
13	24745122	.	G	T	0	0	0	0	1	1	0	0
13	24745169	.	A	G	1	2	3	0	0	3	0	0
13	24781536	.	G	A	8	8	16	0	1	17	0	0
13	24781580	.	T	C	11	7	18	0	0	18	0	0
13	24781605	.	T	C	15	7	22	0	1	23	0	0
13	24781640	.	G	A	10	10	20	0	1	21	0	0
13	24781713	.	A	G	11	8	19	0	0	19	0	0
13	24781885	.	G	A	8	8	16	0	0	16	0	0
13	24786900	.	T	A	5	3	8	0	0	8	0	0
13	24837627	.	A	G	9	16	25	0	0	25	0	0
13	24837876	.	T	C	3	7	10	0	0	10	0	0
13	24871866	.	A	G	7	4	11	0	2	13	0	0
13	24872667	.	A	G	2	2	4	0	0	4	0	0
13	24873141	.	C	A	0	2	2	0	2	4	0	0
13	24873480	.	A	G	2	4	6	0	0	6	0	0
13	24918814	.	T	A	7	11	18	0	0	18	0	0
13	24918820	.	T	C	7	10	17	0	1	18	0	0
13	24986203	.	G	A	0	1	1	0	0	1	0	0
13	24986238	.	G	T	2	2	4	0	0	4	0	0
13	25208276	.	A	G	2	2	4	0	0	4	0	0
13	25208484	.	T	G	2	3	5	0	0	5	0	0
13	25208692	.	A	T	0	1	1	0	0	1	0	0
13	25214739	.	G	A	1	1	2	0	0	2	0	0
13	25366380	.	T	G	1	1	2	0	0	2	0	0
13	25378924	.	T	G	9	4	13	1	0	14	0	0
13	25379263	.	A	T	11	18	29	0	2	31	0	0
13	25379304	.	A	G	12	0	12	0	15	27	0	0
13	25379352	.	A	C	5	11	16	0	3	19	0	0
13	25384281	.	T	C	1	2	3	0	0	3	0	0
13	25388389	.	G	A	5	3	8	0	0	8	0	0
13	25388764	.	T	G	2	0	2	0	6	8	0	0
13	25388842	.	T	C	1	2	3	0	0	3	0	0
13	25429048	.	T	A	1	2	3	0	0	3	0	0
13	25429158	.	G	A	2	5	7	0	0	7	0	0
13	25436360	.	A	T	11	10	21	0	0	21	0	0
13	25449688	.	A	C	0	2	2	0	2	4	0	0
13	25450460	.	A	C	4	5	9	0	0	9	0	0
13	25472336	.	G	A	23	20	43	0	6	49	0	0
13	25472735	.	G	A	11	10	21	0	0	21	0	0
13	25472859	.	G	A	15	9	24	0	1	25	0	0
13	25473084	.	T	A	22	15	37	0	1	38	0	0
13	25473325	.	G	A	3	2	5	0	2	7	0	0
13	25474019	.	G	T	9	9	18	0	2	20	0	0
13	25475904	.	A	G	0	1	1	0	0	1	0	0
13	25477304	.	A	G	1	3	4	0	0	4	0	0
13	25497575	.	T	C	2	4	6	0	0	6	0	0
13	25497581	.	C	T	2	5	7	0	0	7	0	0
13	25497700	.	G	C	4	5	9	0	2	11	0	0
13	25497769	.	T	A	5	2	7	0	0	7	0	0
13	25532857	.	A	G	2	4	6	0	0	6	0	0
13	25533233	.	G	A	4	5	9	0	0	9	0	0
13	25533258	.	T	A	6	7	13	0	1	14	0	0
13	25533452	.	A	T	4	5	9	0	0	9	0	0
13	25533767	.	G	T	10	10	20	0	0	20	0	0
13	25533846	.	G	A	11	5	16	0	1	17	0	0
13	25533897	.	C	T	7	5	12	0	0	12	0	0
13	25534172	.	T	A	5	7	12	0	2	14	0	0
13	25534551	.	G	A	2	5	7	0	0	7	0	0
13	25535405	.	G	A	1	2	3	0	0	3	0	0
13	25563221	.	C	A	3	2	5	0	0	5	0	0
13	25565379	.	T	C	3	8	11	0	0	11	0	0
13	25565985	.	G	A	1	8	9	0	1	10	0	0
13	25565988	.	A	C	2	5	7	0	2	9	0	0
13	25566205	.	A	T	6	7	13	0	1	14	0	0
13	25566222	.	C	T	5	7	12	0	1	13	0	0
13	25569940	.	A	C	2	6	8	0	1	9	0	0
13	25570044	.	C	T	0	5	5	0	1	6	0	0
13	25570104	.	C	T	5	0	5	0	0	5	0	0
13	25570164	.	A	C	1	1	2	0	2	4	0	0
13	25570410	.	A	G	7	6	13	0	0	13	0	0
13	25570618	.	A	T	5	2	7	0	0	7	0	0
13	25570854	.	A	T	2	3	5	0	0	6	1	0
13	25571274	.	C	T	3	4	7	0	1	8	0	0
13	25726201	.	C	T	3	10	13	0	1	14	0	0
13	25726308	.	A	C	4	2	6	0	1	7	0	0
13	25728453	.	A	C	4	3	7	0	1	8	0	0
13	25824718	.	C	T	18	17	35	0	4	39	0	0
13	25825016	.	G	A	20	17	37	0	0	37	0	0
13	25825445	.	A	T	4	3	7	0	0	7	0	0
13	25827421	.	G	A	7	4	11	0	1	12	0	0
13	25850442	.	A	G	2	2	4	0	0	4	0	0
13	25924388	.	C	T	2	2	4	0	0	4	0	0
13	27038163	.	G	A	1	2	3	0	0	3	0	0
13	27232456	.	A	G	0	3	3	0	1	4	0	0
13	27296278	.	A	G	1	2	3	0	0	3	0	0
13	27296291	.	T	C	1	2	3	0	0	3	0	0
13	27296433	.	A	G	3	3	6	0	0	6	0	0
13	27296576	.	C	T	3	5	8	0	0	8	0	0
13	27296616	.	T	C	2	3	5	0	0	5	0	0
13	27296869	.	T	C	1	2	3	0	0	3	0	0
13	27309080	.	C	T	0	1	1	0	0	1	0	0
13	27309143	.	C	T	1	2	3	0	0	3	0	0
13	27312888	.	G	A	2	3	5	0	0	5	0	0
13	27313236	.	A	G	3	2	5	0	0	5	0	0
13	27313258	.	G	T	1	5	6	0	0	6	0	0
13	27317499	.	C	T	5	9	14	0	0	14	0	0
13	27320574	.	T	C	11	7	18	0	0	18	0	0
13	27320583	.	C	T	10	8	18	0	2	20	0	0
13	27320628	.	T	A	7	13	20	0	1	21	0	0
13	27320849	.	T	C	7	11	18	0	0	18	0	0
13	27321211	.	C	T	11	21	32	0	4	36	0	0
13	27321271	.	G	A	0	18	18	0	17	35	0	0
13	27323970	.	G	A	0	15	15	0	10	25	0	0
13	27323976	.	G	A	0	11	11	0	17	28	0	0
13	27324341	.	A	T	26	25	51	0	1	52	0	0
13	27324346	.	T	C	27	25	52	0	3	55	0	0
13	27632915	.	C	T	0	26	26	0	16	42	0	0
13	27633628	.	G	A	20	16	36	0	2	38	0	0
13	27633833	.	A	G	14	13	27	0	0	27	0	0
13	27633906	.	A	G	16	17	33	0	0	33	0	0
13	27634634	.	A	G	10	10	20	0	1	21	0	0
13	27634670	.	G	T	13	13	26	0	1	27	0	0
13	27634678	.	G	T	15	14	29	0	0	29	0	0
13	27634789	.	A	G	7	8	15	0	3	18	0	0
13	27634903	.	A	G	5	6	11	0	0	11	0	0
13	27650537	.	G	A	6	7	13	0	0	13	0	0
13	27653458	.	C	A	0	1	1	0	0	1	0	0
13	27668056	.	G	T	7	4	11	0	0	11	0	0
13	27674408	.	C	T	2	1	3	0	0	3	0	0
13	27685552	.	G	A	2	3	5	0	0	5	0	0
13	27685583	.	C	T	0	1	1	0	4	5	0	0
13	27686252	.	G	A	1	1	2	0	0	2	0	0
13	27770607	.	T	C	3	0	3	0	0	3	0	0
13	27776846	.	A	G	3	5	8	0	0	8	0	0
13	27782086	.	C	A	2	8	10	0	0	10	0	0
13	27782192	.	A	T	2	2	4	0	1	5	0	0
13	27782193	.	G	A	2	3	5	0	0	5	0	0
13	27782448	.	G	A	0	2	2	0	2	4	0	0
13	27782585	.	G	A	6	5	11	0	1	12	0	0
13	27951758	.	T	A	3	2	5	0	0	5	0	0
13	27952207	.	G	A	2	10	12	0	1	13	0	0
13	27952330	.	G	T	9	7	16	0	0	16	0	0
13	27963912	.	T	C	7	7	14	0	1	15	0	0
13	28009108	.	C	T	12	17	29	0	0	30	1	0
13	28009159	.	G	A	10	11	21	0	1	22	0	0
13	28009178	.	A	C	6	13	19	0	2	21	0	0
13	28009246	.	A	T	16	21	37	0	2	40	1	0
13	28009302	.	G	A	0	22	22	0	19	41	0	0
13	28009567	.	G	A	19	11	30	0	1	31	0	0
13	28010214	.	C	A	8	25	33	0	30	64	1	0
13	28010572	.	C	A	16	17	33	0	6	40	1	0
13	28062552	.	T	G	0	1	1	0	0	1	0	0
13	28498812	.	G	A	2	1	3	0	0	3	0	0
13	28500674	.	T	C	1	0	1	0	0	1	0	0
13	28501360	.	C	T	5	8	13	0	2	15	0	0
13	28513036	.	T	C	2	3	5	0	0	5	0	0
13	28513240	.	G	A	2	2	4	0	0	4	0	0
13	28561244	.	G	C	6	2	8	0	0	8	0	0
13	28615556	.	C	T	6	5	11	0	1	12	0	0
13	28650349	.	A	T	9	6	15	0	1	16	0	0
13	28650416	.	G	C	11	5	16	0	0	16	0	0
13	28650683	.	A	G	8	10	18	0	0	18	0	0
13	28651365	.	A	G	9	11	20	0	2	22	0	0
13	28676034	.	G	A	0	3	3	0	1	4	0	0
13	28678176	.	C	G	6	1	7	0	0	7	0	0
13	28680879	.	T	C	11	12	23	0	2	25	0	0
13	28692778	.	C	T	1	7	8	0	0	8	0	0
13	28694447	.	G	A	4	2	6	0	0	6	0	0
13	28741042	.	A	T	1	0	1	0	0	1	0	0
13	28744690	.	C	T	12	8	20	0	1	21	0	0
13	28744831	.	C	T	3	4	7	0	0	7	0	0
13	28745188	.	G	A	13	7	20	0	4	24	0	0
13	28745825	.	G	A	4	9	13	0	1	14	0	0
13	28745899	.	A	G	4	12	16	0	0	16	0	0
13	28745963	.	C	T	6	15	21	0	3	24	0	0
13	28746070	.	G	A	4	3	7	0	0	7	0	0
13	28746083	.	T	C	4	2	6	0	0	6	0	0
13	28746129	.	T	A	2	2	4	0	0	4	0	0
13	28866485	.	A	G	6	3	9	0	1	10	0	0
13	28866518	.	C	A	3	6	9	0	2	11	0	0
13	28866553	.	A	G	4	6	10	0	1	11	0	0
13	28866590	.	A	G	7	5	12	0	0	12	0	0
13	28866615	.	C	T	6	7	13	0	1	14	0	0
13	28866722	.	T	C	3	6	9	0	0	9	0	0
13	28866857	.	G	T	0	4	4	0	6	10	0	0
13	28867071	.	G	T	10	6	16	0	1	17	0	0
13	28901463	.	T	A	22	25	47	0	2	49	0	0
13	28901714	.	T	A	27	26	53	0	6	59	0	0
13	28901871	.	A	T	19	12	31	0	1	32	0	0
13	28901957	.	A	G	9	23	32	0	2	34	0	0
13	28901996	.	T	C	9	24	33	0	1	34	0	0
13	28902058	.	C	T	19	11	30	0	4	34	0	0
13	29347034	.	A	G	3	5	8	0	0	8	0	0
13	29347252	.	T	C	2	5	7	0	1	8	0	0
13	29402669	.	C	T	2	1	3	0	0	3	0	0
13	29403953	.	A	C	4	10	14	0	0	14	0	0
13	29403957	.	C	T	10	4	14	0	1	15	0	0
13	29404145	.	T	C	5	7	12	0	0	12	0	0
13	29404217	.	A	T	0	11	11	0	0	11	0	0
13	29404218	.	T	A	1	10	11	0	0	11	0	0
13	29404323	.	G	T	13	14	27	0	2	29	0	0
13	29404399	.	A	T	10	15	25	0	3	28	0	0
13	29404400	.	C	T	8	15	23	0	5	28	0	0
13	29404576	.	A	G	13	20	33	0	2	35	0	0
13	29404633	.	C	T	16	26	42	0	0	42	0	0
13	29404660	.	T	G	18	0	18	0	20	38	0	0
13	29404754	.	T	A	3	9	12	0	0	12	0	0
13	29407196	.	C	T	7	9	16	0	0	16	0	0
13	29407397	.	C	A	0	3	3	0	4	7	0	0
13	29407896	.	A	G	6	2	8	0	0	8	0	0
13	29408009	.	G	T	3	3	6	0	0	6	0	0
13	29408052	.	G	T	2	3	5	0	0	5	0	0
13	29408192	.	T	A	1	6	7	0	0	7	0	0
13	29408650	.	A	G	2	3	5	0	2	7	0	0
13	29408677	.	T	A	3	6	9	0	2	11	0	0
13	29408989	.	G	A	3	2	5	0	0	5	0	0
13	29422391	.	A	C	2	5	7	0	1	8	0	0
13	29422459	.	C	T	4	2	6	0	0	6	0	0
13	29422511	.	T	A	2	2	4	0	1	5	0	0
13	29804075	.	T	C	5	1	6	0	2	8	0	0
13	29804178	.	T	A	2	2	4	0	0	4	0	0
13	29804207	.	C	A	2	2	4	0	0	4	0	0
13	29935371	.	A	G	3	2	5	0	1	6	0	0
13	29935678	.	T	G	3	3	6	0	0	6	0	0
13	29935682	.	T	C	3	3	6	0	0	6	0	0
13	29935885	.	C	A	4	5	9	0	2	11	0	0
13	29935983	.	C	G	1	4	5	0	0	5	0	0
13	29952902	.	C	T	2	3	5	0	1	6	0	0
13	29952914	.	G	A	3	4	7	0	0	7	0	0
13	29952972	.	C	T	6	9	15	0	1	16	0	0
13	29952973	.	A	T	7	8	15	0	1	16	0	0
13	29953265	.	T	G	5	6	11	0	1	13	1	0
13	29953267	.	C	A	5	6	11	0	1	13	1	0
13	29953522	.	T	C	6	2	8	0	4	12	0	0
13	29958513	.	T	A	3	3	6	0	2	8	0	0
13	29958551	.	G	A	4	3	7	0	0	7	0	0
13	29958725	.	A	G	0	1	1	0	0	1	0	0
13	30008116	.	G	A	1	6	7	0	0	7	0	0
13	30008147	.	G	A	1	3	4	0	0	4	0	0
13	30008596	.	A	T	23	20	43	0	3	46	0	0
13	30008631	.	T	C	17	17	34	0	4	38	0	0
13	30008737	.	T	C	22	13	35	0	1	36	0	0
13	30009021	.	T	A	1	2	3	0	0	3	0	0
13	30009818	.	A	C	16	13	29	0	2	31	0	0
13	30009968	.	T	C	12	6	18	2	2	22	0	0
13	30010059	.	C	A	18	13	31	0	1	33	1	0
13	30021321	.	T	A	0	0	0	0	1	1	0	0
13	30039013	.	C	T	4	3	7	0	0	7	0	0
13	30041662	.	G	A	2	0	2	0	0	2	0	0
13	30112396	.	C	T	1	0	1	0	1	2	0	0
13	30112414	.	T	A	1	0	1	0	0	1	0	0
13	30115125	.	A	G	1	1	2	0	0	2	0	0
13	30128388	.	A	T	0	1	1	0	0	1	0	0
13	30131722	.	G	T	6	11	17	0	3	20	0	0
13	30131804	.	G	A	6	8	14	0	0	14	0	0
13	30132190	.	T	C	17	16	33	0	1	34	0	0
13	30139748	.	G	A	1	1	2	0	0	2	0	0
13	30139773	.	G	A	1	1	2	0	0	2	0	0
13	30145000	.	A	C	2	3	5	0	0	5	0	0
13	30145217	.	A	G	2	5	7	0	1	8	0	0
13	30145514	.	T	A	1	2	3	0	0	3	0	0
13	30145616	.	T	A	2	3	5	0	0	5	0	0
13	30145660	.	T	C	2	2	4	0	1	5	0	0
13	30145662	.	C	A	1	3	4	0	1	5	0	0
13	30146447	.	T	A	2	0	2	0	1	3	0	0
13	30152310	.	A	C	6	10	16	0	0	16	0	0
13	30152502	.	G	C	13	9	22	0	0	22	0	0
13	30155934	.	C	T	1	5	6	0	0	6	0	0
13	30155973	.	T	A	1	1	2	0	0	2	0	0
13	30156176	.	T	C	3	3	6	0	0	6	0	0
13	30156347	.	A	T	0	3	3	0	0	3	0	0
13	30161553	.	T	A	4	2	6	0	0	6	0	0
13	30166340	.	C	A	4	3	7	0	0	7	0	0
13	30167430	.	T	G	9	9	18	0	0	18	0	0
13	30167432	.	A	G	9	9	18	0	0	18	0	0
13	30167711	.	G	A	14	10	24	0	1	25	0	0
13	30167716	.	T	C	15	13	28	0	1	29	0	0
13	30167807	.	G	A	0	16	16	0	15	31	0	0
13	30168662	.	T	A	10	8	18	0	5	23	0	0
13	30199107	.	T	G	2	1	3	0	0	3	0	0
13	30199148	.	G	A	2	3	5	0	0	5	0	0
13	30199190	.	T	C	1	3	4	0	0	4	0	0
13	30199210	.	T	C	3	2	5	0	0	5	0	0
13	30229090	.	A	G	25	3	28	0	28	56	0	0
13	30233353	.	A	G	1	5	6	0	0	6	0	0
13	30234351	.	A	C	5	5	10	0	0	10	0	0
13	30568875	.	A	G	3	4	7	0	2	9	0	0
13	30569650	.	A	C	3	4	7	0	1	8	0	0
13	30569687	.	A	G	4	5	9	0	0	9	0	0
13	30575452	.	C	A	3	4	7	0	0	7	0	0
13	30575637	.	T	A	4	7	11	0	0	11	0	0
13	30579552	.	A	G	4	4	8	0	1	9	0	0
13	30579565	.	A	G	5	4	9	0	0	9	0	0
13	30579792	.	T	C	4	1	5	0	5	10	0	0
13	30580966	.	T	G	1	3	4	0	1	5	0	0
13	30817983	.	T	C	4	2	6	0	1	7	0	0
13	30818107	.	C	G	6	6	12	0	1	13	0	0
13	30818246	.	C	T	7	6	13	0	2	15	0	0
13	30818319	.	A	T	5	6	11	0	0	11	0	0
13	30818849	.	A	G	4	3	7	0	0	7	0	0
13	30818876	.	C	T	5	3	8	0	0	8	0	0
13	30818986	.	T	A	4	4	8	0	0	8	0	0
13	30819133	.	G	C	11	12	23	0	1	24	0	0
13	30819334	.	T	C	11	11	22	0	2	24	0	0
13	30819444	.	A	T	4	5	9	0	0	9	0	0
13	30819445	.	T	G	4	5	9	0	0	9	0	0
13	30819645	.	T	C	1	4	5	0	1	6	0	0
13	30905716	.	T	C	6	5	11	0	0	11	0	0
13	30906190	.	A	T	1	0	1	0	0	1	0	0
13	30908977	.	T	C	2	7	9	0	0	9	0	0
13	30909449	.	G	T	5	3	8	0	0	8	0	0
13	30909624	.	T	A	5	4	9	0	0	9	0	0
13	30964041	.	G	T	0	0	0	0	1	1	0	0
13	31925701	.	A	G	3	5	8	0	0	8	0	0
13	32150245	.	A	C	1	3	4	0	0	4	0	0
13	32453661	.	G	T	3	7	10	0	0	10	0	0
13	32453721	.	A	C	3	3	6	0	0	6	0	0
13	32453730	.	C	T	3	2	5	0	1	6	0	0
13	32454381	.	A	T	2	4	6	0	0	6	0	0
13	32455943	.	A	G	3	6	9	0	2	11	0	0
13	32456312	.	C	G	9	6	15	0	0	15	0	0
13	32575822	.	G	C	2	2	4	0	0	4	0	0
13	32580556	.	T	G	8	5	13	0	0	13	0	0
13	32580572	.	A	C	9	6	15	0	0	15	0	0
13	32580616	.	G	A	9	6	15	0	0	15	0	0
13	32580618	.	C	G	9	6	15	0	0	15	0	0
13	32583864	.	C	T	5	6	11	0	0	11	0	0
13	32583930	.	A	G	5	6	11	0	0	11	0	0
13	32638670	.	T	C	3	4	7	0	1	8	0	0
13	32640975	.	C	A	5	6	11	0	2	13	0	0
13	32641146	.	A	T	4	5	9	0	0	9	0	0
13	32641165	.	G	A	4	4	8	0	0	8	0	0
13	32642047	.	G	C	2	5	7	0	0	7	0	0
13	32642050	.	G	C	2	5	7	0	0	7	0	0
13	32642238	.	A	G	3	5	8	0	1	9	0	0
13	32642284	.	C	A	5	4	9	0	0	9	0	0
13	32642293	.	A	G	6	5	11	0	0	11	0	0
13	32642488	.	A	G	6	8	14	0	1	15	0	0
13	32643696	.	T	G	1	3	4	0	0	4	0	0
13	32660774	.	T	C	1	2	3	0	0	3	0	0
13	32660782	.	G	A	1	2	3	0	0	3	0	0
13	32665008	.	A	C	3	4	7	0	2	9	0	0
13	32679934	.	A	G	0	2	2	0	0	2	0	0
13	32679964	.	C	T	1	2	3	0	0	3	0	0
13	32794413	.	T	C	1	2	3	0	0	3	0	0
13	32794999	.	C	T	1	2	3	0	0	3	0	0
13	32815668	.	G	A	6	6	12	0	3	15	0	0
13	32815884	.	T	C	11	6	17	0	2	19	0	0
13	32815981	.	A	T	16	11	27	0	1	28	0	0
13	32816055	.	G	C	6	12	18	0	1	19	0	0
13	32816128	.	T	G	14	11	25	0	2	27	0	0
13	32816338	.	C	G	7	8	15	0	2	17	0	0
13	32825086	.	C	T	1	2	3	0	0	3	0	0
13	32825137	.	G	A	5	4	9	0	0	9	0	0
13	32825503	.	A	G	0	2	2	0	0	2	0	0
13	32826978	.	A	G	2	0	2	0	0	2	0	0
13	32830255	.	G	T	0	1	1	0	0	1	0	0
13	32901468	.	A	C	3	4	7	0	0	7	0	0
13	33028797	.	A	G	3	5	8	0	2	10	0	0
13	33029624	.	G	T	0	6	6	0	4	10	0	0
13	33031915	.	A	G	1	0	1	0	0	1	0	0
13	33033354	.	A	G	15	15	30	0	1	31	0	0
13	33059182	.	C	T	0	1	1	0	0	1	0	0
13	33059257	.	T	C	0	0	0	0	1	1	0	0
13	33059260	.	A	G	0	0	0	0	1	1	0	0
13	33062352	.	G	C	5	5	10	0	0	10	0	0
13	33065614	.	A	C	8	9	17	0	1	18	0	0
13	33065670	.	G	A	12	7	19	0	1	20	0	0
13	33066629	.	T	C	2	2	4	0	0	4	0	0
13	33066691	.	C	A	1	5	6	0	5	11	0	0
13	33066778	.	T	C	4	2	6	0	0	6	0	0
13	33066782	.	G	T	4	1	5	0	1	6	0	0
13	33066882	.	A	C	2	2	4	0	0	4	0	0
13	33066893	.	A	T	2	2	4	0	0	4	0	0
13	33066923	.	G	A	1	4	5	0	0	5	0	0
13	33067406	.	A	C	4	0	4	0	3	7	0	0
13	33067413	.	A	G	5	3	8	0	0	8	0	0
13	33122594	.	G	A	2	3	5	0	0	5	0	0
13	33122941	.	C	T	6	14	20	0	1	21	0	0
13	33122949	.	G	C	8	6	14	0	2	16	0	0
13	36054289	.	A	G	2	18	20	0	1	21	0	0
13	36606260	.	A	T	9	2	11	0	2	13	0	0
13	36691543	.	T	C	9	11	20	0	1	21	0	0
13	36705895	.	G	A	4	2	6	0	1	7	0	0
13	36706013	.	T	G	6	2	8	0	2	10	0	0
13	36764791	.	C	T	4	6	10	0	0	10	0	0
13	36764838	.	C	G	0	2	2	0	0	2	0	0
13	36771815	.	G	A	1	5	6	0	1	7	0	0
13	36781068	.	G	C	0	5	5	0	6	11	0	0
13	36781407	.	A	G	20	1	21	0	18	39	0	0
13	36783998	.	G	A	0	18	18	0	28	46	0	0
13	36784262	.	G	A	0	9	9	0	21	30	0	0
13	36800799	.	C	T	3	3	6	0	0	6	0	0
13	36868450	.	C	T	1	2	3	0	0	3	0	0
13	36868564	.	G	A	16	21	37	0	1	38	0	0
13	36868635	.	T	G	22	14	36	0	1	37	0	0
13	36868938	.	C	A	19	20	39	1	6	46	0	0
13	36869639	.	C	T	1	21	22	0	23	45	0	0
13	36872777	.	A	G	7	10	17	0	1	18	0	0
13	36879965	.	T	C	5	0	5	0	8	13	0	0
13	36879983	.	G	A	5	9	14	0	0	14	0	0
13	36898229	.	G	A	1	0	1	0	0	1	0	0
13	36932289	.	G	A	6	6	12	0	0	12	0	0
13	36932970	.	T	G	2	5	7	0	0	7	0	0
13	36933279	.	A	T	1	3	4	0	0	4	0	0
13	36997724	.	C	T	1	2	3	0	0	3	0	0
13	37075501	.	T	A	6	6	12	0	0	12	0	0
13	37075528	.	T	A	1	2	3	0	0	3	0	0
13	37075547	.	T	A	2	2	4	0	0	4	0	0
13	37075970	.	A	G	6	4	10	0	0	10	0	0
13	37075986	.	C	G	3	2	5	0	2	7	0	0
13	37076093	.	A	T	3	9	12	0	0	12	0	0
13	37076269	.	T	C	7	3	10	0	1	11	0	0
13	37076332	.	T	C	10	4	14	0	0	14	0	0
13	37076337	.	T	C	7	4	11	0	0	11	0	0
13	37076373	.	T	G	3	6	9	0	1	10	0	0
13	37076382	.	C	T	0	5	5	0	5	10	0	0
13	37076415	.	T	C	4	3	7	0	2	9	0	0
13	37076710	.	C	T	1	4	5	0	0	5	0	0
13	37077127	.	T	C	3	4	7	0	2	9	0	0
13	37077903	.	A	G	5	2	7	0	0	7	0	0
13	37421509	.	C	T	0	22	22	0	7	29	0	0
13	37421604	.	A	C	9	26	35	0	1	36	0	0
13	37422417	.	C	T	0	15	15	0	20	35	0	0
13	37469340	.	C	G	1	3	4	0	0	4	0	0
13	37470777	.	C	A	1	3	4	0	0	4	0	0
13	37653780	.	T	C	6	2	8	0	0	8	0	0
13	37672082	.	T	G	5	4	9	0	0	9	0	0
13	37672087	.	A	C	4	4	8	0	1	9	0	0
13	37672129	.	G	A	0	3	3	0	2	5	0	0
13	37672133	.	G	A	2	3	5	0	0	5	0	0
13	37672716	.	C	T	10	10	20	0	1	21	0	0
13	37672777	.	A	G	11	12	23	0	2	25	0	0
13	37673230	.	A	T	4	7	11	0	0	11	0	0
13	38304739	.	C	A	2	2	4	0	0	4	0	0
13	40352476	.	A	G	5	7	12	0	0	12	0	0
13	40747137	.	T	C	3	2	5	0	0	5	0	0
13	42481256	.	A	G	11	14	25	0	2	27	0	0
13	42481575	.	T	C	9	15	24	1	0	25	0	0
13	42485110	.	G	A	9	4	13	0	2	15	0	0
13	42487319	.	T	C	2	2	4	0	0	4	0	0
13	42500513	.	A	T	2	1	3	0	0	3	0	0
13	42615073	.	T	G	1	2	3	0	0	3	0	0
13	42616301	.	A	C	3	0	3	0	0	3	0	0
13	42616527	.	C	A	2	7	9	0	0	9	0	0
13	42622013	.	C	T	3	5	8	0	1	9	0	0
13	42626622	.	C	T	0	1	1	0	2	3	0	0
13	42626763	.	C	T	3	3	6	0	0	6	0	0
13	42626766	.	T	A	2	3	5	0	0	5	0	0
13	42672885	.	T	G	0	1	1	0	0	1	0	0
13	42676516	.	C	A	1	0	1	0	0	1	0	0
13	42678806	.	C	T	14	13	27	0	3	30	0	0
13	42680950	.	T	A	0	2	2	0	0	2	0	0
13	42681514	.	G	A	5	8	13	0	0	13	0	0
13	42681759	.	G	T	11	11	22	0	1	23	0	0
13	42691626	.	A	G	5	0	5	0	1	6	0	0
13	42691644	.	G	A	4	1	5	0	0	5	0	0
13	43223722	.	T	G	7	10	17	0	2	19	0	0
13	43223961	.	G	A	2	4	6	0	0	6	0	0
13	43226429	.	C	T	0	8	8	0	10	18	0	0
13	43229923	.	G	A	7	7	14	0	0	14	0	0
13	43237120	.	A	G	2	2	4	0	0	4	0	0
13	43237153	.	G	A	3	3	6	0	0	6	0	0
13	43238513	.	C	A	1	1	2	0	0	2	0	0
13	43323220	.	G	A	2	2	4	0	1	5	0	0
13	43323224	.	G	A	3	2	5	0	0	5	0	0
13	43508674	.	A	T	7	9	16	0	0	16	0	0
13	43509318	.	G	A	8	11	19	0	1	20	0	0
13	43509609	.	G	A	3	6	9	0	2	11	0	0
13	43512320	.	C	T	0	1	1	0	0	1	0	0
13	43647035	.	T	C	2	3	5	0	0	5	0	0
13	43650627	.	A	T	1	1	2	0	0	2	0	0
13	43658881	.	G	A	14	4	18	0	1	19	0	0
13	43659018	.	C	T	12	13	25	0	2	27	0	0
13	43659107	.	G	A	0	12	12	0	20	32	0	0
13	43659357	.	G	T	10	12	22	0	1	23	0	0
13	44808632	.	A	G	3	4	7	0	1	8	0	0
13	44860837	.	T	A	0	1	1	0	0	1	0	0
13	44888282	.	C	T	3	5	8	0	0	8	0	0
13	44888309	.	A	C	4	5	9	0	2	11	0	0
13	45015443	.	T	C	15	24	39	0	2	41	0	0
13	45015503	.	T	C	12	16	28	0	1	29	0	0
13	45015655	.	T	G	12	12	24	0	1	25	0	0
13	45015776	.	T	C	25	36	61	0	3	64	0	0
13	45016119	.	G	A	25	25	50	0	2	52	0	0
13	45018600	.	A	G	21	21	42	0	7	49	0	0
13	45018732	.	G	A	7	15	22	0	3	25	0	0
13	45018738	.	T	C	6	1	7	0	12	19	0	0
13	45019001	.	A	C	8	0	8	0	11	19	0	0
13	45039294	.	G	A	0	2	2	0	0	2	0	0
13	45468451	.	G	T	18	7	25	0	0	26	1	0
13	45468567	.	A	T	20	48	68	0	1	69	0	0
13	45468827	.	G	C	5	1	6	0	19	26	1	0
13	45470601	.	A	G	27	31	58	0	4	62	0	0
13	45470764	.	T	C	30	24	54	0	4	58	0	0
13	45470831	.	G	T	24	17	41	0	1	42	0	0
13	45470865	.	G	A	24	13	37	0	2	39	0	0
13	45470867	.	C	A	23	14	37	0	2	39	0	0
13	45470982	.	C	T	8	13	21	0	2	23	0	0
13	45470983	.	A	G	9	14	23	0	0	23	0	0
13	45471048	.	A	G	5	8	13	0	0	13	0	0
13	45471052	.	A	G	4	8	12	0	2	14	0	0
13	45471243	.	G	A	25	16	41	0	5	46	0	0
13	45471367	.	A	T	20	16	36	0	5	42	1	0
13	45471615	.	A	G	26	19	45	0	6	51	0	0
13	45471624	.	T	C	26	20	46	0	4	50	0	0
13	45471888	.	C	T	0	17	17	0	20	37	0	0
13	45472124	.	T	G	2	3	5	0	0	5	0	0
13	45473011	.	G	A	28	20	48	0	8	56	0	0
13	45475145	.	G	A	15	4	19	0	4	23	0	0
13	45475204	.	T	C	23	3	26	0	0	26	0	0
13	45475208	.	A	C	22	3	25	0	0	25	0	0
13	45476400	.	C	T	2	4	6	0	0	6	0	0
13	45476731	.	A	T	1	0	1	0	1	2	0	0
13	45481475	.	G	A	12	10	22	0	1	23	0	0
13	45481703	.	G	T	8	9	17	0	2	19	0	0
13	45481836	.	C	T	2	2	4	0	0	4	0	0
13	45494573	.	C	T	9	20	29	0	3	32	0	0
13	45494757	.	G	A	17	20	37	0	1	38	0	0
13	45494769	.	C	A	18	18	36	0	1	37	0	0
13	45495189	.	G	T	0	9	9	0	23	32	0	0
13	45524500	.	T	C	0	2	2	0	1	3	0	0
13	45570338	.	A	T	4	3	7	0	1	8	0	0
13	45991772	.	T	C	13	12	25	0	1	26	0	0
13	45991801	.	C	T	12	6	18	0	1	19	0	0
13	45999530	.	G	A	1	9	10	0	14	24	0	0
13	45999723	.	C	T	18	18	36	0	6	42	0	0
13	46000060	.	G	A	1	6	7	0	4	11	0	0
13	46179682	.	C	T	26	3	29	0	10	39	0	0
13	46179689	.	G	A	30	8	38	0	1	39	0	0
13	46179806	.	T	A	22	24	46	0	2	48	0	0
13	46179814	.	A	G	19	26	45	0	6	51	0	0
13	46298763	.	C	T	6	7	13	0	1	14	0	0
13	46298775	.	T	G	6	8	14	0	0	14	0	0
13	46298843	.	G	C	1	3	4	0	0	4	0	0
13	46299968	.	C	G	0	1	1	0	1	4	2	0
13	46299989	.	A	T	1	1	2	0	1	3	0	0
13	46300247	.	A	T	2	2	4	0	1	5	0	0
13	46520845	.	T	C	2	3	5	0	0	5	0	0
13	46520899	.	T	G	7	5	12	0	1	13	0	0
13	46520985	.	G	A	4	4	8	0	0	8	0	0
13	46521542	.	C	T	1	4	5	0	4	9	0	0
13	46521633	.	G	A	7	4	11	0	2	13	0	0
13	46521664	.	C	A	7	4	11	0	0	11	0	0
13	46988414	.	C	T	8	11	19	0	0	19	0	0
13	46988445	.	C	T	5	3	8	0	1	9	0	0
13	46988457	.	C	A	0	2	2	0	1	3	0	0
13	48067195	.	G	T	0	1	1	0	0	1	0	0
13	48105417	.	T	C	0	2	2	0	0	2	0	0
13	48105447	.	C	T	2	2	4	0	0	4	0	0
13	48105669	.	C	T	0	2	2	0	1	3	0	0
13	48106535	.	G	A	3	2	5	0	0	5	0	0
13	48533161	.	A	G	0	1	1	0	2	3	0	0
13	48747570	.	G	A	4	1	5	0	0	5	0	0
13	48748722	.	A	G	3	2	5	0	0	5	0	0
13	49444210	.	C	G	5	12	17	0	0	17	0	0
13	49444446	.	C	A	4	7	11	0	0	11	0	0
13	49444517	.	G	A	5	5	10	0	0	10	0	0
13	49544833	.	C	T	17	12	29	0	3	32	0	0
13	49544873	.	T	A	17	21	38	0	0	38	0	0
13	49545039	.	A	G	2	6	8	1	0	9	0	0
13	49575322	.	A	G	0	2	2	0	0	2	0	0
13	49585301	.	T	C	10	14	24	0	3	27	0	0
13	49585341	.	T	A	7	12	19	0	1	20	0	0
13	49585344	.	A	T	5	11	16	0	3	19	0	0
13	49585384	.	T	G	1	3	4	0	0	4	0	0
13	50168991	.	T	A	5	5	10	0	0	10	0	0
13	50169193	.	G	T	1	3	4	0	0	4	0	0
13	50169618	.	A	G	6	5	11	0	1	12	0	0
13	50169649	.	C	T	4	4	8	0	0	8	0	0
13	50170092	.	G	A	2	3	5	0	1	6	0	0
13	50236437	.	C	T	3	4	7	0	1	8	0	0
13	50236475	.	C	T	0	1	1	0	3	4	0	0
13	50243381	.	C	A	1	3	4	0	1	5	0	0
13	50243387	.	A	C	3	1	4	0	0	4	0	0
13	50247598	.	A	C	5	3	8	0	0	8	0	0
13	50247628	.	T	C	1	2	3	0	1	4	0	0
13	50349020	.	G	A	3	2	5	0	0	5	0	0
13	50349058	.	T	G	3	2	5	0	0	5	0	0
13	50349099	.	G	A	3	4	7	0	0	7	0	0
13	50349475	.	A	C	8	11	19	0	0	19	0	0
13	50349532	.	G	A	12	6	18	0	1	19	0	0
13	50349586	.	C	T	7	7	14	0	1	15	0	0
13	50352780	.	G	C	4	11	15	0	0	15	0	0
13	50352965	.	A	G	2	2	4	0	1	5	0	0
13	50371951	.	A	G	3	4	7	0	0	7	0	0
13	50372985	.	G	A	0	2	2	0	2	4	0	0
13	50670911	.	G	C	1	2	3	0	0	3	0	0
13	50670959	.	C	G	1	1	2	0	0	2	0	0
13	51583019	.	C	A	7	3	10	0	0	10	0	0
13	51583043	.	T	C	7	4	11	0	2	13	0	0
13	51720126	.	C	A	2	2	4	0	0	4	0	0
13	51720142	.	A	G	1	2	3	0	0	3	0	0
13	51721143	.	T	C	3	5	8	0	1	9	0	0
13	51728165	.	G	C	2	1	3	0	2	5	0	0
13	51728227	.	G	A	7	6	13	0	1	14	0	0
13	51728782	.	C	G	4	7	11	0	0	11	0	0
13	51728937	.	A	G	4	19	23	0	2	25	0	0
13	51729970	.	A	G	3	2	5	0	0	5	0	0
13	51893754	.	A	T	7	15	22	0	1	23	0	0
13	51893981	.	C	T	1	14	15	1	19	35	0	0
13	51894152	.	A	T	10	4	14	0	1	15	0	0
13	51894204	.	C	T	7	13	20	0	1	21	0	0
13	51894264	.	C	T	0	12	12	0	15	27	0	0
13	51899727	.	G	A	1	6	7	0	2	9	0	0
13	51903034	.	A	G	0	2	2	0	0	2	0	0
13	51961780	.	T	C	1	3	4	0	0	4	0	0
13	51961978	.	C	T	6	3	9	0	0	9	0	0
13	51963039	.	C	T	5	8	13	0	0	13	0	0
13	51963071	.	T	C	4	9	13	0	1	14	0	0
13	51982730	.	A	G	1	0	1	0	1	2	0	0
13	51982742	.	A	G	0	0	0	0	5	5	0	0
13	51982853	.	C	A	1	4	5	0	1	6	0	0
13	52013739	.	T	C	1	2	3	0	2	5	0	0
13	52108574	.	A	G	2	4	6	0	0	6	0	0
14	863552	.	G	A	1	2	3	0	2	5	0	0
14	1177827	.	A	G	4	2	6	0	1	7	0	0
14	1889644	.	T	C	6	1	7	0	0	7	0	0
14	1889668	.	G	A	0	8	8	2	0	10	0	0
14	2384096	.	T	G	1	3	4	0	0	4	0	0
14	4193501	.	T	C	4	2	6	0	0	6	0	0
14	5852486	.	T	C	1	4	5	0	0	5	0	0
14	6214845	.	G	A	0	1	1	0	0	1	0	0
14	6332872	.	T	C	1	5	6	0	1	7	0	0
14	6333022	.	T	C	3	5	8	0	0	8	0	0
14	6337141	.	C	T	0	3	3	0	1	4	0	0
14	6624543	.	A	G	6	4	10	0	1	11	0	0
14	6624558	.	A	G	4	0	4	0	5	9	0	0
14	6624621	.	A	G	4	15	19	0	1	20	0	0
14	6624625	.	A	G	13	9	22	0	0	22	0	0
14	6625002	.	A	C	2	9	11	3	2	16	0	0
14	6625521	.	G	C	25	26	51	0	4	55	0	0
14	7170558	.	T	C	0	8	8	0	1	9	0	0
14	7170559	.	T	C	0	9	9	0	0	9	0	0
14	7965318	.	G	T	2	2	4	0	0	4	0	0
14	8496257	.	A	G	2	2	4	0	1	5	0	0
14	9592608	.	A	G	2	2	4	0	1	5	0	0
14	9595330	.	T	C	2	4	6	0	0	6	0	0
14	11266530	.	A	T	3	5	8	0	0	8	0	0
14	11266531	.	A	T	4	3	7	0	1	8	0	0
14	12486255	.	C	T	1	1	2	0	1	3	0	0
14	12486275	.	G	T	11	4	15	0	1	16	0	0
14	12554812	.	T	C	0	1	1	0	0	1	0	0
14	14647047	.	C	G	1	1	2	0	1	3	0	0
14	15664468	.	T	C	3	3	6	0	0	6	0	0
14	15972549	.	T	C	5	1	6	0	0	6	0	0
14	15972596	.	T	C	1	0	1	0	4	5	0	0
14	15972660	.	C	G	3	3	6	0	0	6	0	0
14	15972666	.	G	A	3	3	6	0	0	6	0	0
14	15973273	.	C	A	1	2	3	0	0	3	0	0
14	15973845	.	C	A	2	2	4	0	0	4	0	0
14	16042530	.	C	A	2	2	4	0	0	4	0	0
14	16044274	.	A	C	1	3	4	0	0	4	0	0
14	16044638	.	G	A	0	15	15	0	10	25	0	0
14	16068929	.	C	T	2	4	6	0	0	6	0	0
14	16069264	.	A	C	2	2	4	0	0	4	0	0
14	16090764	.	T	C	7	7	14	0	2	16	0	0
14	16090800	.	T	A	5	2	7	0	0	7	0	0
14	16090828	.	A	T	4	2	6	0	0	6	0	0
14	16090897	.	C	T	10	4	14	0	0	14	0	0
14	16090939	.	A	C	8	4	12	0	2	14	0	0
14	16091563	.	C	T	5	8	13	0	5	18	0	0
14	16091586	.	T	A	6	8	14	0	2	16	0	0
14	16091709	.	T	G	5	9	14	0	0	14	0	0
14	16095683	.	A	G	1	2	3	0	0	3	0	0
14	16122866	.	T	C	13	14	27	0	0	27	0	0
14	16123055	.	G	C	0	17	17	0	21	38	0	0
14	16130167	.	C	G	1	0	1	0	1	2	0	0
14	16132423	.	T	G	2	2	4	0	0	4	0	0
14	16203904	.	A	T	4	2	6	0	0	6	0	0
14	16208059	.	T	G	4	1	5	0	0	5	0	0
14	16288166	.	A	C	2	2	4	0	0	4	0	0
14	16432788	.	C	T	4	4	8	0	0	8	0	0
14	16433098	.	A	T	15	16	31	0	6	37	0	0
14	16433473	.	C	A	0	17	17	0	16	33	0	0
14	16433496	.	A	G	14	16	30	0	3	33	0	0
14	16433623	.	T	G	5	2	7	0	2	9	0	0
14	16433943	.	C	T	0	13	13	0	6	19	0	0
14	16434131	.	G	C	9	9	18	0	4	22	0	0
14	16434179	.	T	C	14	9	23	0	1	24	0	0
14	16434363	.	C	A	4	3	7	0	0	7	0	0
14	16434791	.	A	G	5	8	13	0	1	14	0	0
14	16434981	.	T	C	7	0	7	0	16	23	0	0
14	16434990	.	T	A	8	10	18	0	6	24	0	0
14	16484069	.	C	T	5	3	8	0	0	8	0	0
14	16484429	.	C	T	8	4	12	0	3	15	0	0
14	16484558	.	A	T	5	4	9	0	0	9	0	0
14	16484713	.	A	G	2	2	4	0	0	4	0	0
14	16766053	.	C	T	2	2	4	0	0	4	0	0
14	16769067	.	A	G	4	2	6	0	0	6	0	0
14	16769189	.	C	T	6	3	9	0	0	9	0	0
14	16769246	.	C	T	6	5	11	0	0	11	0	0
14	16769478	.	A	G	11	1	12	0	0	12	0	0
14	16770260	.	C	T	7	5	12	0	3	15	0	0
14	16770338	.	T	A	7	8	15	0	0	15	0	0
14	16770646	.	C	A	8	7	15	0	1	16	0	0
14	16770847	.	C	T	12	10	22	0	4	26	0	0
14	16771137	.	G	T	4	3	7	0	0	7	0	0
14	16771194	.	A	T	1	2	3	0	0	3	0	0
14	16771265	.	A	T	13	10	23	0	1	24	0	0
14	16777673	.	T	C	2	0	2	0	2	4	0	0
14	16777677	.	A	C	2	1	3	0	1	4	0	0
14	16777708	.	T	C	1	2	3	0	0	3	0	0
14	16778080	.	C	T	0	3	3	0	2	5	0	0
14	17025109	.	A	T	4	3	7	0	1	8	0	0
14	17025151	.	T	A	5	6	11	0	0	11	0	0
14	17025200	.	G	A	3	2	5	0	0	5	0	0
14	17025262	.	G	A	1	3	4	0	2	6	0	0
14	17025751	.	T	A	1	2	3	0	0	3	0	0
14	17025752	.	T	C	1	2	3	0	0	3	0	0
14	17026488	.	G	A	3	8	11	0	1	12	0	0
14	17026572	.	T	G	4	7	11	0	1	12	0	0
14	17026724	.	T	C	9	14	23	0	2	25	0	0
14	17026840	.	T	C	4	6	10	0	0	10	0	0
14	17026881	.	G	T	2	8	10	0	2	12	0	0
14	17027207	.	G	A	10	8	18	0	1	19	0	0
14	17199990	.	A	G	14	18	32	0	1	33	0	0
14	17200351	.	A	T	3	2	5	0	0	5	0	0
14	17200407	.	C	A	4	5	9	0	0	9	0	0
14	17200653	.	A	C	13	14	27	0	2	29	0	0
14	17230387	.	C	T	0	2	2	0	4	6	0	0
14	17230601	.	A	G	8	6	14	0	0	14	0	0
14	17233598	.	C	A	9	6	15	0	2	17	0	0
14	17240587	.	A	G	0	2	2	0	0	2	0	0
14	17275648	.	G	A	2	4	6	0	0	6	0	0
14	17275708	.	C	G	1	4	5	0	1	6	0	0
14	17281761	.	A	G	3	4	7	0	0	7	0	0
14	17282061	.	C	T	1	2	3	0	0	3	0	0
14	17305587	.	G	A	1	2	3	0	2	5	0	0
14	17305604	.	G	A	2	1	3	0	2	5	0	0
14	17349409	.	C	T	1	3	4	0	0	4	0	0
14	17349420	.	G	A	1	2	3	0	0	3	0	0
14	17349444	.	T	G	1	2	3	0	0	3	0	0
14	17443283	.	C	T	4	4	8	0	0	8	0	0
14	17567851	.	C	T	7	2	9	0	1	10	0	0
14	17568099	.	A	G	6	6	12	0	1	13	0	0
14	17572743	.	T	C	1	0	1	0	0	1	0	0
14	17575607	.	G	T	1	3	4	0	0	4	0	0
14	17575868	.	G	A	1	3	4	0	0	4	0	0
14	17580685	.	G	A	20	15	35	0	3	38	0	0
14	17580922	.	C	A	29	23	52	0	5	57	0	0
14	17581084	.	A	T	20	21	41	0	3	44	0	0
14	17581214	.	A	T	27	16	43	0	2	45	0	0
14	17586693	.	G	A	2	1	3	0	0	3	0	0
14	17588131	.	G	T	4	5	9	0	1	10	0	0
14	17593429	.	T	C	6	7	13	0	1	14	0	0
14	17593444	.	G	T	6	9	15	0	1	16	0	0
14	17593490	.	A	G	6	10	16	0	1	17	0	0
14	17593554	.	A	T	1	4	5	0	1	6	0	0
14	17593610	.	A	G	1	4	5	0	0	5	0	0
14	17593720	.	C	T	11	9	20	0	4	24	0	0
14	17593767	.	A	T	13	9	22	0	1	23	0	0
14	17593783	.	T	A	9	10	19	0	1	20	0	0
14	17593823	.	A	T	15	11	26	0	1	27	0	0
14	17593992	.	T	A	5	5	10	0	3	13	0	0
14	17594137	.	G	A	2	3	5	0	1	6	0	0
14	17594527	.	A	G	2	3	5	0	0	5	0	0
14	17595539	.	T	C	3	3	6	0	0	6	0	0
14	17596070	.	G	T	1	2	3	0	0	3	0	0
14	18667485	.	C	A	10	3	13	0	1	14	0	0
14	18667852	.	T	C	9	13	22	0	3	25	0	0
14	18669481	.	C	A	4	7	11	0	3	14	0	0
14	20898376	.	T	C	2	2	4	0	0	4	0	0
14	21750970	.	C	T	4	3	7	0	0	7	0	0
14	21779102	.	C	T	6	2	8	0	0	8	0	0
14	21779241	.	G	A	7	6	13	0	0	13	0	0
14	21779300	.	T	G	4	2	6	0	0	6	0	0
14	21779518	.	C	T	5	2	7	0	0	7	0	0
14	21779582	.	T	C	3	2	5	0	1	6	0	0
14	21779741	.	A	T	0	2	2	0	0	2	0	0
14	21780155	.	C	G	10	9	19	0	1	20	0	0
14	21780206	.	A	G	14	7	21	0	1	22	0	0
14	21780274	.	A	C	14	7	21	0	1	22	0	0
14	21780321	.	T	C	7	7	14	0	2	16	0	0
14	21797819	.	T	C	0	2	2	0	0	2	0	0
14	21816373	.	C	T	14	16	30	0	2	32	0	0
14	21816388	.	T	C	19	12	31	0	2	33	0	0
14	21816467	.	G	A	12	16	28	0	1	29	0	0
14	21842735	.	A	C	2	2	4	0	2	6	0	0
14	21844187	.	T	A	3	3	6	0	0	6	0	0
14	21844486	.	C	T	3	2	5	0	0	5	0	0
14	21844668	.	A	C	3	4	7	0	1	8	0	0
14	21844679	.	T	A	5	3	8	0	2	10	0	0
14	21845129	.	T	A	7	6	13	0	1	14	0	0
14	21845363	.	A	G	4	0	4	0	13	17	0	0
14	21845822	.	A	C	11	8	19	1	2	22	0	0
14	21924299	.	A	G	3	3	6	0	0	6	0	0
14	21924547	.	G	A	3	3	6	0	0	6	0	0
14	21980762	.	G	A	1	4	5	0	0	5	0	0
14	21980769	.	C	T	0	4	4	0	2	6	0	0
14	21980871	.	C	A	1	3	4	0	0	4	0	0
14	22102371	.	A	G	12	12	24	0	2	26	0	0
14	22102381	.	A	G	13	14	27	0	1	28	0	0
14	22104906	.	T	C	3	3	6	0	1	7	0	0
14	22104948	.	G	A	1	1	2	0	0	2	0	0
14	22106125	.	G	A	2	2	4	0	0	4	0	0
14	22106126	.	T	C	2	0	2	0	2	4	0	0
14	22108215	.	C	T	5	9	14	0	0	14	0	0
14	22132473	.	T	C	13	9	22	0	0	22	0	0
14	22132536	.	A	T	2	5	7	0	0	7	0	0
14	22139153	.	G	A	0	3	3	0	0	3	0	0
14	22139254	.	G	A	16	26	42	0	2	44	0	0
14	22139358	.	G	A	19	22	41	0	3	44	0	0
14	22139398	.	T	A	28	22	50	0	1	51	0	0
14	22139668	.	G	A	0	20	20	0	35	55	0	0
14	22140417	.	T	C	8	4	12	0	0	12	0	0
14	22151875	.	G	A	9	4	13	0	1	14	0	0
14	22151879	.	C	T	0	5	5	0	10	15	0	0
14	22151913	.	C	T	8	11	19	0	3	22	0	0
14	22172138	.	C	T	2	2	4	0	0	4	0	0
14	22249344	.	G	A	0	1	1	0	1	2	0	0
14	22254184	.	T	C	3	1	4	0	1	5	0	0
14	22272120	.	A	G	6	0	6	0	13	19	0	0
14	22272340	.	G	A	16	13	29	0	2	31	0	0
14	22272351	.	G	A	18	13	31	0	1	32	0	0
14	22367389	.	T	G	1	2	3	0	0	3	0	0
14	22367485	.	A	G	1	1	2	0	0	2	0	0
14	22367615	.	A	G	1	5	6	0	0	6	0	0
14	22440004	.	G	T	0	3	3	0	2	5	0	0
14	22441634	.	G	A	0	2	2	0	8	10	0	0
14	22441650	.	C	T	5	2	7	0	4	11	0	0
14	22441730	.	A	G	5	6	11	0	0	11	0	0
14	22441929	.	C	T	2	3	5	0	1	6	0	0
14	22478282	.	G	A	3	2	5	0	0	5	0	0
14	22478294	.	T	C	4	2	6	0	0	6	0	0
14	22478348	.	C	T	2	1	3	0	1	4	0	0
14	22478380	.	C	T	1	2	3	0	0	3	0	0
14	22478426	.	T	C	2	2	4	0	0	4	0	0
14	22523524	.	C	G	5	1	6	0	0	6	0	0
14	22523584	.	A	G	5	3	8	0	1	9	0	0
14	22523633	.	T	C	3	4	7	0	0	7	0	0
14	22523644	.	C	T	4	3	7	0	0	7	0	0
14	22523749	.	T	A	1	4	5	0	0	5	0	0
14	22708389	.	C	T	6	6	12	0	1	13	0	0
14	22708401	.	C	A	8	6	14	0	2	16	0	0
14	23348762	.	G	C	2	1	3	0	0	3	0	0
14	23409848	.	C	T	0	1	1	0	0	1	0	0
14	23409971	.	A	G	1	3	4	0	0	4	0	0
14	23455989	.	G	A	6	3	9	0	0	9	0	0
14	23463681	.	G	A	0	0	0	0	3	3	0	0
14	23463708	.	A	G	3	0	3	0	0	3	0	0
14	23463717	.	A	G	3	0	3	0	0	3	0	0
14	23665987	.	G	A	3	4	7	0	0	7	0	0
14	23666203	.	T	C	4	3	7	0	0	7	0	0
14	23666266	.	C	A	6	9	15	0	0	15	0	0
14	23666326	.	C	T	3	4	7	0	1	8	0	0
14	23666431	.	G	A	7	4	11	0	0	11	0	0
14	23666451	.	A	G	8	4	12	0	0	12	0	0
14	23666625	.	C	T	3	4	7	0	0	7	0	0
14	23668714	.	T	C	1	1	2	0	0	2	0	0
14	23668724	.	C	A	1	1	2	0	0	2	0	0
14	23671197	.	A	G	5	0	5	0	6	11	0	0
14	23671361	.	C	G	5	6	11	0	1	12	0	0
14	23679393	.	T	A	6	4	10	0	0	10	0	0
14	23679394	.	C	A	6	4	10	0	0	10	0	0
14	23702323	.	G	A	0	6	6	0	2	8	0	0
14	23702703	.	G	A	1	0	1	0	0	1	0	0
14	23702730	.	G	A	6	3	9	0	0	9	0	0
14	23704771	.	G	C	0	7	7	0	7	14	0	0
14	23722030	.	C	T	2	2	4	0	1	5	0	0
14	23725824	.	T	A	7	5	12	0	1	13	0	0
14	23726124	.	G	T	19	19	38	0	2	40	0	0
14	23726393	.	C	A	25	20	45	0	4	49	0	0
14	23732299	.	C	T	0	3	3	0	9	12	0	0
14	23732508	.	C	T	2	4	6	0	0	6	0	0
14	23737569	.	A	T	3	2	5	0	0	5	0	0
14	23747360	.	T	A	22	12	34	0	2	36	0	0
14	23748436	.	G	A	2	4	6	0	0	6	0	0
14	23752335	.	C	T	3	0	3	0	0	3	0	0
14	23756716	.	T	A	2	4	6	0	0	6	0	0
14	23968564	.	T	A	3	1	4	0	0	4	0	0
14	23968612	.	A	T	2	2	4	0	0	4	0	0
14	23968619	.	T	A	2	1	3	0	0	3	0	0
14	23968678	.	T	G	3	3	6	0	0	6	0	0
14	23968720	.	G	A	3	3	6	0	1	7	0	0
14	23968743	.	C	T	4	1	5	0	1	6	0	0
14	23968774	.	T	C	5	3	8	0	0	8	0	0
14	23968781	.	C	A	5	2	7	0	0	7	0	0
14	23968815	.	A	G	4	2	6	0	2	8	0	0
14	23969086	.	G	A	0	2	2	0	0	2	0	0
14	23969152	.	G	A	3	4	7	0	3	10	0	0
14	23969443	.	G	C	0	4	4	0	0	4	0	0
14	23969446	.	T	C	1	4	5	0	0	5	0	0
14	23969485	.	G	A	2	4	6	0	1	7	0	0
14	23969568	.	G	A	3	2	5	0	0	5	0	0
14	23969779	.	C	G	3	4	7	0	0	7	0	0
14	23969796	.	T	C	4	3	7	0	0	7	0	0
14	23976245	.	C	T	1	0	1	0	1	2	0	0
14	23981999	.	T	C	1	3	4	0	0	4	0	0
14	23991588	.	G	A	10	7	17	0	0	17	0	0
14	23993958	.	G	A	11	6	17	0	2	19	0	0
14	23998961	.	C	A	11	14	25	0	1	27	1	0
14	23999002	.	G	C	12	17	29	0	3	32	0	0
14	23999021	.	C	T	18	14	32	0	1	33	0	0
14	23999086	.	G	A	24	13	37	0	1	38	0	0
14	23999225	.	A	G	15	23	38	0	2	40	0	0
14	23999239	.	G	C	1	21	22	0	13	35	0	0
14	23999315	.	A	G	24	13	37	0	0	37	0	0
14	23999459	.	A	C	12	11	23	0	3	26	0	0
14	23999466	.	C	A	10	12	22	0	1	23	0	0
14	24097523	.	C	T	10	11	21	0	1	22	0	0
14	24098470	.	C	G	1	2	3	0	0	3	0	0
14	24098648	.	G	A	3	8	11	0	0	11	0	0
14	24098694	.	G	T	8	4	12	0	0	12	0	0
14	24098912	.	C	T	0	5	5	0	4	9	0	0
14	24099059	.	A	T	2	3	5	0	1	6	0	0
14	24220659	.	A	C	4	3	7	0	0	7	0	0
14	24220959	.	A	T	4	15	19	0	2	21	0	0
14	24221053	.	G	A	7	10	17	0	1	18	0	0
14	24221194	.	T	A	8	27	35	0	0	35	0	0
14	24221356	.	G	A	0	10	10	0	13	23	0	0
14	24243246	.	T	C	1	2	3	0	0	3	0	0
14	24243895	.	T	C	3	1	4	0	1	5	0	0
14	24248398	.	C	A	3	2	5	0	0	5	0	0
14	24248575	.	C	T	0	2	2	0	0	2	0	0
14	24268222	.	G	T	4	2	6	0	2	8	0	0
14	24268262	.	A	G	11	7	18	0	0	18	0	0
14	24268374	.	G	A	4	3	7	0	0	7	0	0
14	24268505	.	G	A	6	11	17	0	1	18	0	0
14	24268676	.	A	T	8	8	16	0	0	16	0	0
14	24268712	.	C	T	0	11	11	0	7	18	0	0
14	24268781	.	G	A	3	10	13	0	1	14	0	0
14	24274783	.	G	A	1	4	5	0	0	5	0	0
14	24276634	.	C	T	4	2	6	0	0	6	0	0
14	24278234	.	A	G	8	5	13	0	0	13	0	0
14	24278882	.	C	A	15	9	24	0	4	28	0	0
14	24278917	.	G	A	15	9	24	0	1	25	0	0
14	24279011	.	A	C	15	14	29	0	1	30	0	0
14	24279126	.	A	G	16	21	37	0	2	39	0	0
14	24279148	.	G	A	10	15	25	0	4	29	0	0
14	24279367	.	A	T	11	14	25	0	0	25	0	0
14	24279701	.	C	G	13	18	31	0	3	34	0	0
14	24280842	.	T	C	28	21	49	0	3	52	0	0
14	24280918	.	T	G	21	21	42	0	0	42	0	0
14	24303104	.	G	C	3	2	5	0	0	5	0	0
14	24303504	.	C	T	8	7	15	0	1	16	0	0
14	24303735	.	G	C	5	3	8	0	1	9	0	0
14	24303767	.	C	G	1	2	3	0	0	3	0	0
14	24303786	.	A	T	1	2	3	0	0	3	0	0
14	24303851	.	C	A	2	5	7	0	0	7	0	0
14	24304298	.	A	C	4	8	12	0	1	13	0	0
14	24304309	.	G	A	8	5	13	0	1	14	0	0
14	24304480	.	A	C	3	5	8	0	1	9	0	0
14	24304591	.	T	A	17	8	25	0	1	26	0	0
14	24304753	.	T	C	7	7	14	0	2	16	0	0
14	24304823	.	A	G	6	7	13	0	3	16	0	0
14	24316809	.	A	T	7	18	25	0	0	25	0	0
14	24317266	.	A	T	19	30	49	0	6	55	0	0
14	24317272	.	G	A	21	30	51	0	2	53	0	0
14	24317314	.	T	C	31	21	52	0	2	54	0	0
14	24317316	.	C	T	23	31	54	0	0	54	0	0
14	24317576	.	A	G	26	22	48	0	4	53	1	0
14	24317685	.	T	A	22	23	45	0	0	45	0	0
14	24317717	.	T	A	23	13	36	0	1	37	0	0
14	24317804	.	C	T	14	14	28	0	0	28	0	0
14	24317830	.	T	A	11	16	27	0	0	27	0	0
14	24318685	.	G	A	4	10	14	0	0	14	0	0
14	24318723	.	T	C	6	7	13	0	0	13	0	0
14	24318726	.	T	C	6	0	6	0	7	13	0	0
14	24326937	.	G	A	1	1	2	0	0	2	0	0
14	24327917	.	G	A	1	3	4	0	0	4	0	0
14	24328142	.	T	C	2	2	4	0	1	5	0	0
14	24369500	.	C	T	2	6	8	0	0	8	0	0
14	24376787	.	G	A	4	4	8	0	1	9	0	0
14	24401077	.	C	T	0	23	23	0	12	35	0	0
14	24401209	.	T	G	10	9	19	0	1	20	0	0
14	24401393	.	A	G	7	10	17	0	2	19	0	0
14	24401700	.	C	A	0	21	21	0	12	33	0	0
14	24401844	.	T	A	10	13	23	0	1	24	0	0
14	24409293	.	C	A	0	2	2	0	3	5	0	0
14	24491911	.	G	A	4	3	7	0	0	7	0	0
14	24492154	.	C	T	3	7	10	0	0	10	0	0
14	24492226	.	C	A	0	4	4	0	6	10	0	0
14	24998203	.	C	T	2	4	6	0	0	6	0	0
14	24998395	.	C	T	1	1	2	0	1	3	0	0
14	24998459	.	C	A	4	2	6	0	0	6	0	0
14	24998565	.	T	C	5	7	12	0	2	14	0	0
14	24998616	.	A	C	6	4	10	0	0	10	0	0
14	24998619	.	A	C	6	3	9	0	0	9	0	0
14	24998656	.	T	A	3	2	5	0	0	5	0	0
14	24998804	.	A	G	1	0	1	0	1	2	0	0
14	24998930	.	C	G	2	4	6	0	0	6	0	0
14	25000109	.	A	G	10	6	16	0	1	17	0	0
14	25000621	.	A	G	9	15	24	0	3	27	0	0
14	25000623	.	A	C	10	14	24	0	3	27	0	0
14	25000686	.	T	A	8	11	19	0	0	19	0	0
14	25000803	.	T	G	7	13	20	0	0	20	0	0
14	25034986	.	A	G	2	1	3	0	0	3	0	0
14	25065972	.	T	C	1	0	1	0	0	1	0	0
14	25066010	.	T	A	1	0	1	0	0	1	0	0
14	25067463	.	G	T	5	4	9	0	0	9	0	0
14	25067905	.	C	T	15	16	31	0	2	33	0	0
14	25072447	.	A	G	14	15	29	0	2	31	0	0
14	25072468	.	C	T	14	15	29	0	1	30	0	0
14	25072489	.	T	G	15	14	29	0	0	29	0	0
14	25072662	.	T	C	10	1	11	0	11	22	0	0
14	25072737	.	C	T	4	12	16	0	0	16	0	0
14	25072843	.	A	T	5	10	15	0	0	15	0	0
14	25073178	.	C	G	0	0	0	0	1	1	0	0
14	25073412	.	G	A	0	2	2	0	0	2	0	0
14	25077642	.	G	A	4	3	7	0	0	7	0	0
14	25079821	.	C	A	1	2	3	0	1	4	0	0
14	25084872	.	A	G	21	19	40	0	2	42	0	0
14	25090031	.	C	T	3	0	3	0	0	3	0	0
14	25090999	.	T	G	11	8	19	0	1	20	0	0
14	25091043	.	C	G	10	7	17	0	1	18	0	0
14	25091453	.	C	T	4	5	9	0	0	9	0	0
14	25091840	.	C	T	3	4	7	0	0	7	0	0
14	25092940	.	A	C	1	2	3	0	0	3	0	0
14	25093710	.	G	A	3	1	4	0	2	6	0	0
14	25500594	.	T	A	3	2	5	0	0	5	0	0
14	25501405	.	C	T	3	2	5	0	0	5	0	0
14	25501581	.	T	C	3	4	7	0	1	8	0	0
14	25501772	.	C	T	6	3	9	0	0	9	0	0
14	25501851	.	T	G	6	8	14	0	0	14	0	0
14	25501870	.	C	A	7	9	16	0	0	16	0	0
14	25502142	.	T	C	8	8	16	0	0	16	0	0
14	25536965	.	T	C	5	3	8	0	1	9	0	0
14	25538355	.	A	T	1	3	4	0	1	5	0	0
14	25538364	.	A	C	1	4	5	0	0	5	0	0
14	25908843	.	A	T	3	3	6	0	0	6	0	0
14	25908901	.	C	T	1	1	2	0	2	4	0	0
14	25910037	.	T	A	2	4	6	0	1	7	0	0
14	25910249	.	G	A	5	2	7	0	1	8	0	0
14	25910314	.	A	T	5	4	9	0	0	9	0	0
14	25910407	.	A	G	7	3	10	0	2	12	0	0
14	25910542	.	C	T	8	6	14	0	0	14	0	0
14	25910636	.	G	C	3	5	8	0	0	8	0	0
14	25910825	.	A	C	11	11	22	0	1	23	0	0
14	25911098	.	G	A	0	8	8	0	14	22	0	0
14	25923458	.	T	A	3	3	6	0	0	6	0	0
14	25923510	.	C	G	3	4	7	0	2	9	0	0
14	25923729	.	T	A	3	11	14	0	1	15	0	0
14	25923745	.	G	A	3	8	11	0	2	13	0	0
14	25923771	.	A	G	3	8	11	0	0	11	0	0
14	25923809	.	G	A	1	4	5	0	2	7	0	0
14	25923829	.	C	T	0	3	3	0	3	6	0	0
14	25923844	.	T	G	4	4	8	0	0	8	0	0
14	25924218	.	C	T	0	1	1	0	1	2	0	0
14	25924240	.	A	G	1	2	3	0	0	3	0	0
14	25924384	.	A	G	1	2	3	0	0	3	0	0
14	25924625	.	A	T	1	2	3	0	0	3	0	0
14	25924661	.	T	C	3	2	5	0	0	5	0	0
14	25924685	.	A	G	3	3	6	0	0	6	0	0
14	25924700	.	A	C	4	3	7	0	0	7	0	0
14	25924764	.	A	T	1	5	6	0	0	6	0	0
14	25924796	.	A	T	0	2	2	0	1	3	0	0
14	25925028	.	G	A	5	2	7	0	0	7	0	0
14	25925973	.	T	A	6	6	12	0	0	12	0	0
14	25926041	.	G	A	3	8	11	0	0	11	0	0
14	25926134	.	G	A	10	9	19	0	1	20	0	0
14	25926276	.	G	A	11	7	18	0	1	19	0	0
14	25926351	.	G	A	4	2	6	0	1	7	0	0
14	25935090	.	G	T	0	1	1	0	0	1	0	0
14	25939493	.	T	C	9	15	24	0	0	24	0	0
14	25942653	.	G	A	1	1	2	0	0	2	0	0
14	25983160	.	G	A	11	6	17	0	0	17	0	0
14	25983210	.	T	A	12	4	16	0	1	17	0	0
14	26065490	.	G	A	0	2	2	0	0	2	0	0
14	26065498	.	G	A	0	2	2	0	0	2	0	0
14	26066909	.	T	G	3	4	7	0	0	7	0	0
14	26066938	.	G	T	2	2	4	0	0	4	0	0
14	26067337	.	A	G	1	2	3	0	0	3	0	0
14	26067366	.	G	A	1	3	4	0	0	4	0	0
14	26067378	.	T	G	1	3	4	0	0	4	0	0
14	26067435	.	A	G	2	3	5	0	0	5	0	0
14	26067563	.	A	G	1	7	8	0	0	8	0	0
14	26067657	.	A	G	5	8	13	0	1	14	0	0
14	26067674	.	T	C	8	9	17	0	1	18	0	0
14	26067797	.	A	T	6	5	11	0	2	13	0	0
14	26067798	.	A	G	7	5	12	0	1	13	0	0
14	26103439	.	A	T	0	6	6	0	1	7	0	0
14	26103511	.	T	G	13	10	23	0	0	23	0	0
14	26104293	.	G	A	18	17	35	0	2	37	0	0
14	26104299	.	A	G	19	15	34	0	3	37	0	0
14	26104614	.	A	C	2	13	15	0	1	16	0	0
14	26105221	.	A	G	9	3	12	0	1	13	0	0
14	26106155	.	T	C	4	8	12	0	1	13	0	0
14	26106170	.	C	T	0	11	11	0	3	14	0	0
14	26106231	.	G	T	2	7	9	0	0	9	0	0
14	26106493	.	C	T	4	8	12	0	1	13	0	0
14	26106500	.	C	A	4	9	13	0	1	14	0	0
14	26106697	.	C	T	0	4	4	0	4	8	0	0
14	26106892	.	A	G	1	3	4	0	0	4	0	0
14	26227791	.	A	C	2	3	5	0	0	5	0	0
14	26381469	.	A	G	3	2	5	0	0	5	0	0
14	26381471	.	A	G	3	2	5	0	0	5	0	0
14	26385496	.	G	A	3	3	6	0	0	6	0	0
14	26404803	.	C	T	13	11	24	0	1	25	0	0
14	26404830	.	C	A	11	4	15	0	3	18	0	0
14	26405152	.	G	T	1	3	4	0	0	4	0	0
14	26405153	.	A	G	1	3	4	0	0	4	0	0
14	26405686	.	A	C	9	11	20	0	1	21	0	0
14	26405861	.	C	T	3	2	5	0	2	7	0	0
14	26413681	.	A	C	27	4	31	0	2	33	0	0
14	26413800	.	G	T	11	19	30	0	1	31	0	0
14	26414205	.	G	T	7	10	17	0	1	18	0	0
14	26414226	.	C	G	5	9	14	0	0	14	0	0
14	26415876	.	G	C	2	1	3	0	0	3	0	0
14	26427161	.	C	T	1	1	2	0	1	3	0	0
14	26427363	.	C	A	2	3	5	0	1	6	0	0
14	26427836	.	T	A	2	1	3	0	0	3	0	0
14	26427848	.	T	C	2	1	3	0	0	3	0	0
14	26428078	.	T	C	1	2	3	0	0	3	0	0
14	26450421	.	T	A	3	6	9	0	1	10	0	0
14	26453167	.	G	C	6	12	18	0	1	20	1	0
14	26453375	.	C	T	8	4	12	0	0	12	0	0
14	26456225	.	A	G	1	1	2	0	0	2	0	0
14	26456274	.	T	C	5	8	13	0	0	13	0	0
14	26456379	.	G	A	0	1	1	0	1	2	0	0
14	26458019	.	C	T	3	3	6	0	1	7	0	0
14	26458040	.	A	G	2	1	3	0	1	4	0	0
14	26511605	.	G	A	4	4	8	0	0	8	0	0
14	26716139	.	T	C	2	1	3	0	1	4	0	0
14	26718737	.	A	G	16	0	16	0	5	21	0	0
14	26718753	.	T	G	16	5	21	0	0	21	0	0
14	26729141	.	C	A	23	26	49	0	1	50	0	0
14	26796049	.	G	T	3	4	7	0	0	7	0	0
14	26995454	.	T	C	12	22	34	0	4	38	0	0
14	26995551	.	T	A	7	11	18	0	2	20	0	0
14	26995773	.	G	A	14	15	29	0	1	30	0	0
14	26996096	.	T	G	1	3	4	0	1	5	0	0
14	26996299	.	C	A	5	2	7	0	0	7	0	0
14	26996301	.	A	T	5	2	7	0	0	7	0	0
14	26996543	.	A	C	6	3	9	0	0	9	0	0
14	26996926	.	T	A	7	2	9	0	1	10	0	0
14	26996954	.	G	C	8	3	11	0	0	11	0	0
14	26996974	.	A	C	6	4	10	0	0	10	0	0
14	26997003	.	G	A	3	5	8	0	1	9	0	0
14	26997272	.	C	A	2	2	4	0	0	5	1	0
14	27281038	.	C	G	4	5	9	0	0	9	0	0
14	27281182	.	T	C	1	1	2	0	1	3	0	0
14	27999228	.	C	A	14	19	33	0	1	34	0	0
14	27999252	.	C	T	13	18	31	0	4	35	0	0
14	27999422	.	G	T	9	14	23	0	5	28	0	0
14	27999471	.	C	T	7	15	22	0	4	26	0	0
14	27999591	.	G	A	9	24	33	0	3	36	0	0
14	28001696	.	G	A	0	1	1	0	0	1	0	0
14	28052187	.	G	A	2	3	5	0	0	5	0	0
14	28366021	.	A	G	2	1	3	0	0	3	0	0
14	28385564	.	G	A	1	2	3	0	0	3	0	0
14	28453257	.	A	C	0	1	1	0	0	1	0	0
14	28453269	.	C	T	0	1	1	0	0	1	0	0
14	28457968	.	G	A	0	6	6	0	5	11	0	0
14	28458110	.	T	C	4	9	13	0	0	13	0	0
14	28458199	.	T	C	3	6	9	0	0	9	0	0
14	28458270	.	T	C	9	7	16	0	1	17	0	0
14	28458456	.	C	A	4	3	7	0	0	7	0	0
14	28458533	.	G	A	8	6	14	0	0	14	0	0
14	28458656	.	A	T	8	8	16	0	1	17	0	0
14	28458974	.	A	G	4	7	11	0	1	12	0	0
14	28458980	.	C	G	4	6	10	0	1	11	0	0
14	28459275	.	A	C	16	17	33	0	0	33	0	0
14	28459613	.	T	A	8	7	15	0	0	15	0	0
14	28463598	.	C	A	0	1	1	0	0	1	0	0
14	28464821	.	C	T	2	3	5	0	1	6	0	0
14	28476731	.	C	A	0	1	1	0	0	1	0	0
14	28480476	.	A	G	1	1	2	0	0	2	0	0
14	28482743	.	A	G	8	1	9	0	5	14	0	0
14	28482752	.	A	G	10	1	11	0	3	14	0	0
14	28482808	.	C	T	10	3	13	0	1	14	0	0
14	28482920	.	G	A	6	2	8	0	0	8	0	0
14	28514094	.	T	C	0	2	2	0	0	2	0	0
14	28514142	.	T	C	0	2	2	0	0	2	0	0
14	28515941	.	C	T	3	4	7	0	0	7	0	0
14	28518305	.	G	A	0	6	6	0	5	11	0	0
14	28520213	.	T	C	1	1	2	0	1	3	0	0
14	28525353	.	C	T	4	4	8	0	0	8	0	0
14	28525948	.	C	T	4	2	6	0	0	6	0	0
14	28526046	.	C	T	12	7	19	0	2	21	0	0
14	28526081	.	G	A	7	3	10	0	5	15	0	0
14	28526797	.	C	T	10	12	22	0	0	22	0	0
14	28526950	.	T	C	17	11	28	0	0	28	0	0
14	29757958	.	A	T	7	6	13	0	0	13	0	0
14	29758103	.	C	T	3	6	9	0	0	9	0	0
14	29758333	.	G	A	0	5	5	0	6	11	0	0
14	29758526	.	T	C	4	3	7	0	1	8	0	0
14	29759439	.	A	T	1	2	3	0	0	3	0	0
14	29759570	.	A	T	3	3	6	0	1	7	0	0
14	29807562	.	T	C	10	5	15	0	0	15	0	0
14	29808086	.	C	T	2	3	5	0	0	5	0	0
14	29808251	.	C	A	5	3	8	0	0	8	0	0
14	29808743	.	C	T	1	3	4	0	3	7	0	0
14	29808785	.	C	A	0	3	3	0	1	4	0	0
14	29808812	.	T	C	0	2	2	0	0	2	0	0
14	29821164	.	G	A	2	3	5	0	0	5	0	0
14	29822513	.	T	A	4	2	6	0	0	6	0	0
14	29987769	.	G	A	0	2	2	0	1	3	0	0
14	30357099	.	C	T	2	4	6	0	0	6	0	0
14	30357283	.	C	T	2	3	5	0	0	5	0	0
14	30359276	.	C	T	1	5	6	0	0	6	0	0
14	30407577	.	G	C	0	1	1	0	1	2	0	0
14	30411143	.	C	T	3	2	5	0	0	5	0	0
14	30411825	.	G	A	2	5	7	0	0	7	0	0
14	30411895	.	T	A	2	8	10	0	0	10	0	0
14	30412056	.	T	C	1	3	4	0	0	4	0	0
14	30412086	.	C	T	1	2	3	0	0	3	0	0
14	30428193	.	G	T	1	4	5	0	1	6	0	0
14	30428225	.	C	T	0	4	4	0	5	9	0	0
14	30428272	.	T	A	3	5	8	0	0	8	0	0
14	30428319	.	A	G	0	2	2	0	1	3	0	0
14	30428322	.	A	G	0	1	1	0	0	1	0	0
14	30435578	.	G	A	1	0	1	0	0	1	0	0
14	30454527	.	C	T	0	8	8	0	5	13	0	0
14	30454731	.	T	C	1	2	3	0	0	3	0	0
14	30454917	.	C	T	0	2	2	0	6	8	0	0
14	30454983	.	T	A	2	1	3	0	0	3	0	0
14	30455134	.	T	A	3	3	6	0	0	6	0	0
14	30456254	.	T	A	3	2	5	0	0	5	0	0
14	30460630	.	G	A	1	2	3	0	0	3	0	0
14	30551712	.	G	T	4	4	8	0	1	9	0	0
14	30551775	.	C	T	0	5	5	0	4	9	0	0
14	30569108	.	G	A	0	4	4	0	2	6	0	0
14	30580844	.	C	T	2	4	6	0	0	6	0	0
14	30581000	.	A	C	2	0	2	0	8	10	0	0
14	30581152	.	G	A	6	4	10	0	2	12	0	0
14	30581308	.	C	T	0	7	7	0	6	13	0	0
14	30581329	.	C	A	5	12	17	0	0	17	0	0
14	30581485	.	C	T	0	3	3	0	2	5	0	0
14	30581910	.	A	G	3	3	6	0	0	6	0	0
14	30620229	.	G	C	13	12	25	0	3	28	0	0
14	30637866	.	T	C	21	0	21	0	28	49	0	0
14	30637907	.	G	A	24	19	43	0	5	48	0	0
14	30638016	.	G	A	21	22	43	0	3	46	0	0
14	30638018	.	G	A	22	23	45	0	1	46	0	0
14	30638336	.	C	T	20	20	40	0	0	40	0	0
14	30638599	.	G	A	7	2	9	0	0	9	0	0
14	30639165	.	A	G	13	13	26	0	2	28	0	0
14	30641256	.	G	A	2	4	6	0	0	6	0	0
14	30641872	.	A	G	2	5	7	0	0	7	0	0
14	30642757	.	T	G	5	8	13	0	0	13	0	0
14	30670132	.	T	C	3	3	6	0	0	6	0	0
14	30717305	.	T	C	1	0	1	0	0	1	0	0
14	30731987	.	C	A	6	4	10	0	0	10	0	0
14	30732828	.	T	G	4	4	8	0	0	8	0	0
14	30733008	.	C	T	2	3	5	0	0	5	0	0
14	30733164	.	G	A	4	3	7	0	1	8	0	0
14	30733685	.	G	A	16	3	19	0	0	19	0	0
14	30733689	.	G	A	15	4	19	0	1	20	0	0
14	30733783	.	C	A	6	10	16	0	0	16	0	0
14	30733964	.	C	T	10	9	19	0	5	24	0	0
14	30733990	.	T	C	12	15	27	0	1	28	0	0
14	30734183	.	C	T	21	16	37	0	0	37	0	0
14	30734900	.	G	A	5	7	12	0	2	14	0	0
14	30739687	.	T	C	1	3	4	0	0	4	0	0
14	30740364	.	T	A	1	3	4	0	0	4	0	0
14	30740454	.	T	A	2	2	4	0	0	4	0	0
14	30740472	.	A	G	1	2	3	0	0	3	0	0
14	30758891	.	T	C	2	2	4	0	0	4	0	0
14	30793402	.	G	T	1	0	1	0	0	1	0	0
14	30793472	.	C	T	1	1	2	0	1	3	0	0
14	30793625	.	C	T	1	5	6	0	0	6	0	0
14	30793925	.	C	G	5	3	8	0	0	8	0	0
14	30793962	.	A	G	3	7	10	0	0	10	0	0
14	30795633	.	T	C	6	4	10	0	0	10	0	0
14	30799000	.	T	C	21	22	43	0	1	44	0	0
14	30800528	.	T	C	5	8	13	0	0	13	0	0
14	30801043	.	C	A	36	21	57	0	5	62	0	0
14	30801329	.	G	A	18	20	38	0	3	41	0	0
14	30801379	.	G	A	18	13	31	0	3	34	0	0
14	30801389	.	A	G	17	11	28	0	5	33	0	0
14	30801451	.	G	C	12	18	30	0	1	31	0	0
14	30801552	.	C	A	1	10	11	0	0	11	0	0
14	30802953	.	G	A	2	5	7	0	4	11	0	0
14	30803026	.	G	A	3	4	7	0	0	7	0	0
14	30803058	.	C	A	0	3	3	0	3	6	0	0
14	30803072	.	A	G	3	2	5	0	0	5	0	0
14	30803794	.	C	G	1	2	3	0	0	3	0	0
14	30803902	.	T	C	1	3	4	0	0	4	0	0
14	30803904	.	G	C	1	0	1	0	3	4	0	0
14	30854742	.	A	C	25	18	43	0	6	49	0	0
14	30855117	.	A	C	30	18	48	0	4	52	0	0
14	30855649	.	C	A	14	22	36	0	0	36	0	0
14	30855668	.	A	T	9	21	30	0	2	32	0	0
14	30855767	.	G	T	16	11	27	0	1	28	0	0
14	30855824	.	T	A	11	12	23	0	5	28	0	0
14	30855973	.	T	G	6	8	14	0	0	14	0	0
14	30876670	.	A	T	3	2	5	0	0	5	0	0
14	30879736	.	T	C	1	3	4	0	0	4	0	0
14	30879801	.	G	T	1	2	3	0	0	3	0	0
14	30879805	.	C	A	1	2	3	0	0	3	0	0
14	30902508	.	C	T	1	1	2	0	1	3	0	0
14	30916902	.	G	A	2	7	9	0	0	9	0	0
14	30975479	.	G	T	21	21	42	0	2	44	0	0
14	30978589	.	G	T	11	10	21	0	2	23	0	0
14	30978661	.	T	C	9	7	16	0	0	16	0	0
14	30978700	.	T	C	8	3	11	0	1	12	0	0
14	30978706	.	G	A	9	3	12	0	0	12	0	0
14	30982248	.	T	C	9	0	9	0	13	22	0	0
14	30982468	.	A	G	7	4	11	0	2	13	0	0
14	30987167	.	G	T	22	12	34	0	3	37	0	0
14	30988280	.	T	C	7	0	7	0	8	15	0	0
14	30988627	.	A	G	6	4	10	0	0	10	0	0
14	30988644	.	G	A	4	2	6	0	0	6	0	0
14	30988664	.	C	T	4	5	9	0	0	9	0	0
14	30989292	.	C	G	0	2	2	0	1	3	0	0
14	30989908	.	A	G	6	2	8	0	2	10	0	0
14	30990321	.	T	A	2	5	7	0	0	7	0	0
14	31082400	.	T	C	8	10	18	0	0	18	0	0
14	31082474	.	G	T	2	5	7	0	1	8	0	0
14	31082745	.	A	T	3	7	10	0	0	10	0	0
14	31082975	.	A	G	4	6	10	0	0	10	0	0
14	31083110	.	C	A	5	4	9	0	0	9	0	0
14	31083206	.	C	A	5	2	7	0	1	8	0	0
14	31087245	.	T	A	2	2	4	0	0	4	0	0
14	31090259	.	C	T	3	5	8	0	2	10	0	0
14	31090339	.	C	T	6	7	13	0	1	14	0	0
14	31090935	.	C	T	4	4	8	0	2	10	0	0
14	31091264	.	C	T	0	3	3	0	1	4	0	0
14	31477482	.	A	G	4	5	9	0	0	9	0	0
14	31498392	.	G	A	0	2	2	0	3	5	0	0
14	31498413	.	T	C	3	4	7	0	1	8	0	0
14	31507476	.	A	G	6	1	7	0	4	11	0	0
14	31519213	.	C	T	5	4	9	0	0	9	0	0
14	31519241	.	A	G	4	5	9	0	0	9	0	0
14	31519340	.	G	A	7	3	10	0	0	10	0	0
14	31519730	.	T	A	2	2	4	0	0	4	0	0
14	31519948	.	T	C	2	8	10	0	0	10	0	0
14	31520119	.	T	C	5	9	14	0	0	14	0	0
14	31520483	.	T	C	9	18	27	0	0	27	0	0
14	31520555	.	T	C	1	7	8	0	0	8	0	0
14	31520590	.	A	G	1	0	1	0	9	10	0	0
14	31520750	.	T	C	3	8	11	0	0	11	0	0
14	31521442	.	G	A	1	2	3	0	0	3	0	0
14	31521446	.	T	C	0	2	2	0	1	3	0	0
14	31530350	.	A	G	1	2	3	0	1	4	0	0
14	31530388	.	T	C	1	2	3	0	0	3	0	0
14	31541122	.	A	T	0	1	1	0	0	1	0	0
14	31544842	.	C	T	3	6	9	0	1	10	0	0
14	31545181	.	A	T	6	9	15	0	1	16	0	0
14	31545272	.	C	T	7	6	13	0	0	13	0	0
14	31545433	.	A	T	1	6	7	0	0	7	0	0
14	31545794	.	A	G	8	7	15	0	0	15	0	0
14	31545795	.	G	A	8	7	15	0	0	15	0	0
14	31545902	.	T	A	17	5	22	0	3	25	0	0
14	31545919	.	A	T	15	6	21	0	0	21	0	0
14	31546137	.	T	A	9	9	18	0	3	21	0	0
14	31546320	.	C	T	15	6	21	0	1	22	0	0
14	31546470	.	A	T	8	18	26	0	1	27	0	0
14	31546493	.	A	G	10	0	10	0	14	24	0	0
14	31556263	.	T	C	8	4	12	0	1	13	0	0
14	31556308	.	G	A	9	9	18	0	2	20	0	0
14	31556326	.	T	C	14	1	15	0	9	24	0	0
14	31556344	.	A	G	12	8	20	0	0	20	0	0
14	31556371	.	A	G	13	6	19	0	2	21	0	0
14	31558943	.	A	G	8	5	13	0	0	13	0	0
14	31559000	.	T	G	8	3	11	0	0	11	0	0
14	31615629	.	G	A	6	3	9	0	0	9	0	0
14	31615658	.	C	T	8	6	14	0	1	15	0	0
14	31616139	.	G	T	7	20	27	0	1	28	0	0
14	31616151	.	C	T	7	16	23	0	2	25	0	0
14	31616186	.	C	T	8	9	17	0	0	17	0	0
14	31642476	.	T	G	1	2	3	0	1	4	0	0
14	31644229	.	C	G	4	0	4	0	4	8	0	0
14	31644239	.	G	C	3	3	6	0	1	7	0	0
14	31644859	.	T	A	5	2	7	0	0	7	0	0
14	31645683	.	A	T	3	2	5	0	0	5	0	0
14	31645989	.	T	A	1	2	3	0	0	3	0	0
14	31646039	.	C	A	0	2	2	0	0	2	0	0
14	31646217	.	C	A	5	5	10	0	0	10	0	0
14	31646275	.	C	A	5	3	8	0	0	8	0	0
14	31646486	.	A	T	2	2	4	0	0	4	0	0
14	31646655	.	T	C	12	5	17	0	1	18	0	0
14	31646830	.	G	T	2	7	9	0	1	10	0	0
14	31646831	.	A	G	3	7	10	0	0	10	0	0
14	31647135	.	A	T	9	11	20	0	1	21	0	0
14	31647217	.	A	G	9	5	14	0	2	16	0	0
14	31647291	.	G	C	12	8	20	0	0	20	0	0
14	31647335	.	G	T	14	3	17	0	1	18	0	0
14	31647553	.	G	T	5	10	15	0	0	15	0	0
14	31647682	.	A	G	14	9	23	0	1	24	0	0
14	31668024	.	A	C	1	2	3	0	0	3	0	0
14	31668646	.	G	A	11	12	23	0	0	23	0	0
14	31668719	.	C	T	0	9	9	0	15	24	0	0
14	31668758	.	G	A	14	10	24	0	0	24	0	0
14	31668859	.	T	A	11	9	20	0	0	20	0	0
14	31669103	.	A	T	7	6	13	0	1	14	0	0
14	31669304	.	C	A	4	3	7	0	0	7	0	0
14	31669376	.	T	G	5	5	10	0	1	11	0	0
14	31669377	.	G	T	5	5	10	0	1	11	0	0
14	31669466	.	C	G	5	7	12	0	0	12	0	0
14	31669488	.	A	G	7	5	12	0	1	13	0	0
14	31669646	.	G	A	3	2	5	0	0	5	0	0
14	31675852	.	G	T	2	2	4	0	0	4	0	0
14	31675891	.	T	C	2	2	4	0	0	4	0	0
14	31682168	.	T	C	0	1	1	0	0	1	0	0
14	31779716	.	A	G	1	3	4	0	0	4	0	0
14	31780273	.	G	T	0	3	3	0	4	7	0	0
14	31780311	.	A	G	2	0	2	0	6	8	0	0
14	31800090	.	T	C	5	5	10	0	2	12	0	0
14	31800175	.	G	T	9	5	14	0	0	14	0	0
14	31800378	.	T	C	6	5	11	0	0	11	0	0
14	31800589	.	G	A	6	6	12	0	1	13	0	0
14	31800870	.	C	G	1	2	3	0	0	3	0	0
14	31800875	.	G	A	1	1	2	0	1	3	0	0
14	31801428	.	C	G	3	3	6	0	1	7	0	0
14	31801483	.	A	G	3	3	6	0	0	6	0	0
14	31801715	.	A	G	4	3	7	0	1	8	0	0
14	31801904	.	A	G	3	2	5	0	0	5	0	0
14	31801979	.	T	C	1	3	4	0	1	5	0	0
14	31803148	.	A	G	0	2	2	0	1	3	0	0
14	31803150	.	T	C	1	2	3	0	0	3	0	0
14	31856891	.	G	T	9	12	21	0	10	31	0	0
14	31857773	.	T	A	10	9	19	0	1	20	0	0
14	31858123	.	G	A	18	19	37	0	0	37	0	0
14	31858492	.	T	G	4	5	9	0	0	9	0	0
14	31882192	.	G	A	1	2	3	0	0	3	0	0
14	31883519	.	G	C	0	3	3	0	5	8	0	0
14	32011834	.	C	A	17	12	29	0	2	31	0	0
14	32011993	.	T	C	18	13	31	0	4	35	0	0
14	32025140	.	A	T	1	5	6	0	1	7	0	0
14	32025466	.	T	G	1	2	3	0	0	3	0	0
14	32057595	.	T	C	1	4	5	0	0	5	0	0
14	32184469	.	C	T	19	17	36	0	2	38	0	0
14	32184927	.	C	A	11	10	21	0	3	24	0	0
14	32185036	.	C	A	0	17	17	0	13	30	0	0
14	32185199	.	A	G	7	3	10	0	1	11	0	0
14	32443522	.	G	A	7	2	9	0	1	10	0	0
14	32443529	.	A	G	9	2	11	0	0	11	0	0
14	32443696	.	A	G	9	11	20	0	2	22	0	0
14	32443734	.	A	T	14	12	26	0	0	26	0	0
14	32443811	.	A	C	6	7	13	0	0	13	0	0
14	32443841	.	A	T	7	3	10	0	0	10	0	0
14	32444121	.	C	T	12	7	19	0	0	19	0	0
14	32444168	.	T	G	13	4	17	0	1	18	0	0
14	32444496	.	G	T	5	5	10	0	0	10	0	0
14	32444608	.	G	C	8	7	15	0	2	17	0	0
14	32444854	.	G	T	3	4	7	0	2	9	0	0
14	32447872	.	C	A	2	0	2	0	0	2	0	0
14	32461224	.	G	A	2	0	2	0	0	2	0	0
14	32665206	.	T	C	4	4	8	0	0	8	0	0
14	32742955	.	A	T	4	3	7	0	1	8	0	0
14	32858004	.	G	C	0	4	4	0	8	12	0	0
14	32858012	.	C	T	6	7	13	0	0	13	0	0
14	32858080	.	C	A	7	5	12	0	1	13	0	0
14	32858244	.	T	C	8	8	16	0	1	17	0	0
14	32858301	.	C	T	10	3	13	0	1	14	0	0
14	32858364	.	C	T	6	8	14	0	0	14	0	0
14	32858570	.	C	T	9	10	19	0	1	20	0	0
14	32858578	.	C	G	10	10	20	0	2	22	0	0
14	32858638	.	G	A	10	6	16	0	0	16	0	0
14	32858701	.	C	T	14	8	22	0	2	24	0	0
14	32859554	.	C	T	8	10	18	0	0	18	0	0
14	32859908	.	G	T	13	10	23	0	1	24	0	0
14	32860345	.	A	G	9	3	12	0	0	12	0	0
14	32860374	.	T	C	8	1	9	0	6	15	0	0
14	32860434	.	C	T	13	6	19	0	0	19	0	0
14	32860692	.	T	A	1	2	3	0	0	3	0	0
14	32860704	.	G	A	1	2	3	0	0	3	0	0
14	32884065	.	C	T	0	7	7	0	6	13	0	0
14	32885319	.	T	A	4	2	6	0	0	6	0	0
14	32885453	.	G	T	2	2	4	0	0	4	0	0
14	32952043	.	C	T	2	4	6	0	0	6	0	0
14	32952312	.	A	T	5	10	15	0	0	15	0	0
14	32952467	.	C	T	3	5	8	0	0	8	0	0
14	32952493	.	G	A	3	2	5	0	1	6	0	0
14	32952576	.	C	T	3	8	11	0	0	11	0	0
14	32952825	.	C	T	0	3	3	0	2	5	0	0
14	32984084	.	G	A	1	5	6	0	0	6	0	0
14	33068654	.	C	T	0	2	2	0	3	5	0	0
14	33220216	.	A	G	5	2	7	0	3	10	0	0
14	33220247	.	T	C	5	4	9	0	0	9	0	0
14	33267946	.	T	C	7	17	24	0	1	25	0	0
14	33268115	.	T	G	5	2	7	0	0	7	0	0
14	33268170	.	C	T	7	2	9	0	1	10	0	0
14	33268219	.	A	G	7	12	19	0	1	20	0	0
14	33268254	.	C	A	8	16	24	0	1	25	0	0
14	33268297	.	T	C	9	15	24	0	3	27	0	0
14	33280818	.	C	T	12	19	31	0	1	32	0	0
14	33281690	.	A	G	18	7	25	0	0	25	0	0
14	33281816	.	C	T	0	7	7	0	30	37	0	0
14	33281856	.	T	A	25	13	38	0	2	41	1	0
14	33281892	.	C	A	19	17	36	0	1	37	0	0
14	33281907	.	T	A	13	15	28	0	6	34	0	0
14	33281964	.	T	C	14	4	18	0	2	20	0	0
14	33282119	.	A	G	14	18	32	0	3	35	0	0
14	33282245	.	A	T	13	19	32	0	1	33	0	0
14	33282246	.	A	C	13	19	32	0	1	33	0	0
14	33282347	.	C	T	0	10	10	0	22	32	0	0
14	33288448	.	A	G	4	3	7	0	1	8	0	0
14	33297882	.	A	T	10	8	18	0	3	21	0	0
14	33298098	.	C	A	8	8	16	0	2	19	1	0
14	33298397	.	T	C	4	4	8	0	0	8	0	0
14	33298436	.	C	T	5	7	12	0	1	13	0	0
14	33299087	.	T	C	13	8	21	0	1	22	0	0
14	33302380	.	T	C	4	2	6	0	0	6	0	0
14	33302381	.	G	A	4	2	6	0	0	6	0	0
14	33306583	.	T	C	8	5	13	0	0	13	0	0
14	33307831	.	C	T	3	7	10	0	0	10	0	0
14	33308039	.	A	G	14	12	26	0	0	26	0	0
14	33308120	.	G	A	1	12	13	0	0	13	0	0
14	33314102	.	G	A	2	3	5	0	1	6	0	0
14	33316828	.	A	G	0	1	1	0	0	1	0	0
14	33331256	.	T	C	1	3	4	0	0	4	0	0
14	33333741	.	A	G	14	21	35	0	3	38	0	0
14	33333986	.	G	A	0	0	0	0	1	1	0	0
14	33339530	.	G	A	3	4	7	0	0	7	0	0
14	33339617	.	C	T	5	12	17	0	0	17	0	0
14	33339791	.	G	T	5	4	9	0	0	9	0	0
14	33339895	.	G	A	4	4	8	0	0	8	0	0
14	33344463	.	A	G	5	3	8	0	0	8	0	0
14	33344536	.	T	G	4	3	7	0	0	7	0	0
14	33414060	.	G	C	0	4	4	0	2	6	0	0
14	33414105	.	T	A	11	11	22	0	1	23	0	0
14	33414168	.	C	T	25	15	40	0	3	43	0	0
14	33414590	.	G	A	5	2	7	0	1	8	0	0
14	33414596	.	C	T	5	3	8	0	0	8	0	0
14	33418525	.	G	C	6	2	8	0	1	9	0	0
14	33418766	.	A	G	13	18	31	0	1	32	0	0
14	33419714	.	G	A	5	2	7	0	0	7	0	0
14	33424626	.	T	C	10	13	23	0	2	25	0	0
14	33424931	.	T	C	23	17	40	0	2	42	0	0
14	33425008	.	A	T	9	15	24	0	0	24	0	0
14	33434018	.	A	T	3	4	7	0	0	7	0	0
14	33434076	.	A	T	2	6	8	0	0	8	0	0
14	33434976	.	T	C	3	5	8	0	0	8	0	0
14	33435415	.	A	G	4	2	6	0	12	18	0	0
14	33435540	.	T	A	6	13	19	0	0	19	0	0
14	33435573	.	T	A	7	14	21	0	0	21	0	0
14	33435686	.	T	C	6	15	21	0	0	21	0	0
14	33435714	.	G	A	4	12	16	0	2	18	0	0
14	33435768	.	C	A	6	3	9	0	1	10	0	0
14	33435893	.	C	T	0	7	7	0	9	16	0	0
14	33435916	.	T	G	10	12	22	0	1	23	0	0
14	33435948	.	G	A	13	11	24	0	0	24	0	0
14	33435967	.	C	T	14	13	27	0	0	27	0	0
14	33436091	.	A	T	15	9	24	0	0	24	0	0
14	33436311	.	A	G	10	20	30	0	3	33	0	0
14	33436514	.	G	A	15	10	25	0	1	26	0	0
14	33436650	.	A	T	10	25	35	0	2	37	0	0
14	33437009	.	G	T	7	6	13	0	1	14	0	0
14	33437056	.	C	A	5	5	10	0	0	10	0	0
14	33437252	.	A	G	5	10	15	0	1	16	0	0
14	33437262	.	T	G	5	11	16	0	3	19	0	0
14	33437294	.	C	G	5	20	25	0	1	26	0	0
14	33437305	.	A	G	5	22	27	0	0	27	0	0
14	33442066	.	T	C	2	4	6	0	0	6	0	0
14	33442069	.	C	T	2	3	5	0	1	6	0	0
14	33469268	.	A	G	6	6	12	0	1	13	0	0
14	33469281	.	G	A	3	6	9	0	0	9	0	0
14	33469370	.	C	T	3	2	5	0	0	5	0	0
14	33469609	.	C	T	3	5	8	0	0	8	0	0
14	33469636	.	A	G	4	2	6	0	2	8	0	0
14	33469949	.	T	A	1	4	5	0	0	5	0	0
14	33469950	.	C	A	1	4	5	0	0	5	0	0
14	33474809	.	T	C	4	0	4	0	7	11	0	0
14	33501922	.	A	G	6	4	10	0	0	10	0	0
14	33504572	.	A	G	6	9	15	0	0	15	0	0
14	33504633	.	C	A	9	6	15	0	1	16	0	0
14	33505055	.	G	C	8	8	16	0	2	18	0	0
14	33505058	.	A	G	8	0	8	0	10	19	1	0
14	33505500	.	A	C	15	12	27	0	3	30	0	0
14	33515983	.	C	T	3	9	12	0	0	12	0	0
14	33516015	.	G	A	3	11	14	0	2	16	0	0
14	33516237	.	C	T	7	9	16	0	0	16	0	0
14	33516619	.	A	G	1	2	3	0	2	5	0	0
14	33517333	.	T	C	1	2	3	0	0	3	0	0
14	33517334	.	T	A	1	2	3	0	0	3	0	0
14	33562482	.	C	T	3	1	4	0	0	4	0	0
14	33562504	.	G	C	3	1	4	0	0	4	0	0
14	33564916	.	C	T	4	2	6	0	0	6	0	0
14	33564955	.	C	T	7	3	10	0	1	11	0	0
14	33564956	.	T	G	8	2	10	0	1	11	0	0
14	33565153	.	T	C	2	3	5	0	0	5	0	0
14	33565170	.	C	T	1	3	4	0	1	5	0	0
14	33565275	.	C	A	1	4	5	0	0	5	0	0
14	33565296	.	C	A	2	3	5	0	1	6	0	0
14	33565477	.	G	T	6	5	11	0	0	11	0	0
14	33565665	.	T	C	2	4	6	0	0	6	0	0
14	33565675	.	T	G	2	2	4	0	0	4	0	0
14	33566542	.	A	T	11	13	24	0	1	25	0	0
14	33566578	.	G	C	15	8	23	0	1	24	0	0
14	33566613	.	G	A	13	8	21	0	0	21	0	0
14	33566945	.	C	T	22	12	34	0	0	34	0	0
14	33567085	.	A	G	14	6	20	0	1	21	0	0
14	33569135	.	T	C	1	2	3	0	0	3	0	0
14	33569138	.	T	A	1	2	3	0	0	3	0	0
14	33591862	.	T	A	2	3	5	0	0	5	0	0
14	33754549	.	G	A	1	2	3	0	0	3	0	0
14	33755394	.	A	C	3	2	5	0	0	5	0	0
14	33755590	.	T	C	2	3	5	0	0	5	0	0
14	33755677	.	C	A	6	2	8	0	2	10	0	0
14	33755810	.	A	C	9	2	11	0	0	11	0	0
14	33755813	.	C	A	3	5	8	0	3	11	0	0
14	33755847	.	T	C	7	7	14	0	3	17	0	0
14	33756950	.	G	A	23	19	42	0	0	42	0	0
14	33757152	.	A	C	28	18	46	0	5	51	0	0
14	33757169	.	A	C	24	22	46	0	5	51	0	0
14	33826317	.	C	T	0	10	10	0	16	26	0	0
14	33826371	.	T	C	8	13	21	0	3	24	0	0
14	33826385	.	A	G	11	15	26	0	2	28	0	0
14	33826453	.	G	A	6	9	15	0	0	15	0	0
14	33826491	.	T	G	9	8	17	0	3	20	0	0
14	33826621	.	T	C	7	2	9	0	0	9	0	0
14	33826827	.	C	T	1	3	4	0	0	4	0	0
14	33826990	.	T	C	5	2	7	0	0	7	0	0
14	33826997	.	T	C	2	6	8	0	0	8	0	0
14	33827170	.	T	C	1	4	5	0	0	5	0	0
14	33827188	.	C	T	1	5	6	0	0	6	0	0
14	33827224	.	T	C	3	4	7	0	0	7	0	0
14	33827584	.	C	G	2	3	5	0	0	5	0	0
14	33828777	.	C	A	2	2	4	0	0	4	0	0
14	33860372	.	T	C	19	7	26	0	0	26	0	0
14	33860468	.	G	A	7	21	28	0	1	29	0	0
14	33860477	.	G	A	10	19	29	0	0	29	0	0
14	33864388	.	G	A	4	5	9	0	0	9	0	0
14	33865704	.	A	G	1	3	4	0	1	5	0	0
14	33865954	.	C	T	2	2	4	0	0	4	0	0
14	33868723	.	G	A	2	2	4	0	1	5	0	0
14	33892153	.	T	C	7	10	17	0	1	18	0	0
14	33892490	.	G	A	1	2	3	0	2	5	0	0
14	33892501	.	C	T	3	2	5	0	0	5	0	0
14	33899629	.	C	T	16	24	40	0	5	45	0	0
14	33900150	.	A	C	22	12	34	0	0	34	0	0
14	33900278	.	A	C	7	1	8	0	3	11	0	0
14	33900289	.	C	T	5	4	9	0	0	9	0	0
14	33900552	.	A	T	9	13	22	0	1	23	0	0
14	33900561	.	T	A	10	9	19	0	0	19	0	0
14	33901267	.	C	A	1	4	5	0	0	5	0	0
14	33903006	.	C	A	2	1	3	0	0	3	0	0
14	33910014	.	T	A	0	2	2	0	0	2	0	0
14	33916671	.	C	T	0	1	1	0	1	2	0	0
14	33941087	.	A	C	2	1	3	0	1	4	0	0
14	33941169	.	G	A	4	3	7	0	0	7	0	0
14	33941266	.	G	A	2	4	6	0	1	7	0	0
14	33983741	.	G	T	11	10	21	0	0	21	0	0
14	33983904	.	T	C	20	34	54	0	4	58	0	0
14	33987455	.	T	A	2	5	7	0	0	7	0	0
14	34003447	.	G	A	2	3	5	0	0	5	0	0
14	34064313	.	C	T	2	2	4	0	0	4	0	0
14	34064371	.	A	T	3	2	5	0	0	5	0	0
14	34065178	.	G	A	3	3	6	0	0	6	0	0
14	34065290	.	T	C	7	7	14	0	1	15	0	0
14	34065442	.	A	G	13	7	20	0	0	20	0	0
14	34065454	.	G	A	13	7	20	0	1	21	0	0
14	34065596	.	T	A	9	5	14	0	1	15	0	0
14	34065785	.	G	A	3	5	8	0	1	10	1	0
14	34065879	.	G	A	6	4	10	0	0	10	0	0
14	34079362	.	G	A	0	1	1	0	0	1	0	0
14	34082287	.	G	A	1	1	2	0	0	2	0	0
14	34082311	.	G	A	2	3	5	0	0	5	0	0
14	34089559	.	C	A	4	2	6	0	0	6	0	0
14	34089864	.	C	T	2	4	6	0	0	6	0	0
14	34089900	.	G	A	4	2	6	0	0	6	0	0
14	34089941	.	A	G	5	4	9	0	0	9	0	0
14	34090034	.	A	T	0	2	2	0	0	2	0	0
14	34090228	.	G	A	1	2	3	0	0	3	0	0
14	34090422	.	A	G	1	2	3	0	0	3	0	0
14	34090591	.	A	T	4	2	6	0	0	6	0	0
14	34091717	.	T	G	11	10	21	0	0	21	0	0
14	34091805	.	C	A	11	6	17	0	2	19	0	0
14	34091851	.	C	T	7	9	16	0	0	16	0	0
14	34091971	.	G	A	8	13	21	0	2	23	0	0
14	34092722	.	A	T	1	4	5	0	0	5	0	0
14	34125983	.	T	A	5	5	10	0	0	10	0	0
14	34126061	.	T	A	7	3	10	0	2	12	0	0
14	34127017	.	A	G	5	7	12	0	0	12	0	0
14	34127445	.	A	G	0	9	9	0	1	10	0	0
14	34127457	.	C	T	3	9	12	0	2	14	0	0
14	34127492	.	G	T	7	9	16	0	1	17	0	0
14	34127507	.	T	G	7	6	13	0	1	14	0	0
14	34127675	.	A	G	3	2	5	0	2	7	0	0
14	34127686	.	A	T	2	3	5	0	0	5	0	0
14	34127967	.	C	T	2	3	5	0	0	5	0	0
14	34128399	.	A	C	7	5	12	0	0	12	0	0
14	34128516	.	C	T	3	10	13	0	0	13	0	0
14	34128565	.	T	G	2	7	9	0	0	9	0	0
14	34128744	.	G	A	2	4	6	0	0	6	0	0
14	34128799	.	C	T	0	2	2	0	4	6	0	0
14	34128901	.	G	A	5	3	8	0	0	8	0	0
14	34128902	.	T	G	5	2	7	0	1	8	0	0
14	34129092	.	C	T	0	4	4	0	5	9	0	0
14	34129103	.	A	G	4	4	8	0	0	8	0	0
14	34129159	.	T	C	3	5	8	0	0	8	0	0
14	34129433	.	T	G	1	4	5	0	0	5	0	0
14	34129578	.	G	A	1	2	3	0	0	3	0	0
14	34129724	.	C	T	1	3	4	0	0	4	0	0
14	34487972	.	C	T	5	0	5	0	1	6	0	0
14	34488456	.	T	C	2	18	20	0	2	22	0	0
14	34488655	.	A	G	12	5	17	0	0	17	0	0
14	34488687	.	C	A	9	8	17	0	3	20	0	0
14	34488929	.	C	T	3	4	7	0	0	7	0	0
14	34556826	.	C	G	4	5	9	0	0	9	0	0
14	34556986	.	C	T	2	4	6	0	0	6	0	0
14	34634281	.	T	C	2	2	4	0	0	4	0	0
14	34634415	.	T	A	1	2	3	0	0	3	0	0
14	34634584	.	C	A	8	4	12	0	0	12	0	0
14	34635144	.	C	T	5	2	7	0	2	9	0	0
14	34635565	.	G	A	3	3	6	0	1	7	0	0
14	34794940	.	A	T	1	2	3	0	0	3	0	0
14	34797681	.	G	T	2	5	7	0	1	8	0	0
14	34797711	.	T	C	3	8	11	0	1	12	0	0
14	34797734	.	C	A	1	8	9	0	0	9	0	0
14	34797810	.	C	A	9	7	16	1	0	17	0	0
14	34797908	.	T	C	0	9	9	0	0	9	0	0
14	34797972	.	C	T	2	5	7	0	1	8	0	0
14	34798017	.	C	T	3	10	13	0	0	13	0	0
14	34798031	.	C	T	4	8	12	0	0	12	0	0
14	34798095	.	T	A	5	2	7	0	1	8	0	0
14	34825745	.	T	C	4	2	6	0	1	7	0	0
14	34825761	.	A	G	3	1	4	0	1	5	0	0
14	35008780	.	T	A	1	3	4	0	0	4	0	0
14	35008804	.	T	C	1	2	3	0	0	3	0	0
14	35009651	.	T	C	5	9	14	0	1	15	0	0
14	35009652	.	G	T	5	10	15	0	0	15	0	0
14	35009736	.	A	T	3	5	8	0	0	8	0	0
14	35009739	.	A	G	3	5	8	0	0	8	0	0
14	35010230	.	C	T	1	5	6	0	0	6	0	0
14	35010236	.	A	T	2	5	7	0	0	7	0	0
14	35010875	.	A	G	4	2	6	0	0	6	0	0
14	35010936	.	T	A	2	4	6	0	0	6	0	0
14	35011140	.	G	A	2	3	5	0	0	5	0	0
14	35011174	.	C	T	3	3	6	0	1	7	0	0
14	35011301	.	C	T	1	5	6	0	1	7	0	0
14	35011398	.	G	T	9	6	15	0	2	17	0	0
14	35011445	.	C	A	9	1	10	1	0	11	0	0
14	35011570	.	C	T	10	14	24	0	3	27	0	0
14	35011857	.	G	A	5	7	12	0	7	19	0	0
14	35011944	.	G	A	13	15	28	0	1	29	0	0
14	35387769	.	G	A	3	4	7	0	0	7	0	0
14	35392909	.	T	C	4	0	4	0	2	6	0	0
14	35392914	.	T	C	3	2	5	0	0	5	0	0
14	35393022	.	G	A	5	3	8	0	0	8	0	0
14	35393061	.	G	C	4	3	7	0	0	7	0	0
14	35400320	.	C	T	0	2	2	0	2	4	0	0
14	35407463	.	A	C	1	3	4	0	0	4	0	0
14	35409510	.	A	G	11	4	15	0	0	15	0	0
14	35409635	.	G	C	7	0	7	0	3	10	0	0
14	35409643	.	A	G	7	2	9	0	0	9	0	0
14	35409784	.	T	G	12	4	16	0	0	16	0	0
14	35409838	.	A	T	5	5	10	0	0	10	0	0
14	35409903	.	A	T	3	2	5	0	0	5	0	0
14	35410166	.	C	A	0	2	2	0	0	2	0	0
14	35410583	.	G	A	3	3	6	0	0	6	0	0
14	35410992	.	G	A	3	2	5	0	0	5	0	0
14	35500249	.	G	T	13	11	24	0	0	24	0	0
14	35505312	.	C	A	1	6	7	0	7	14	0	0
14	35505376	.	C	A	2	6	8	0	0	8	0	0
14	35692149	.	A	G	2	0	2	0	0	2	0	0
14	35699039	.	G	A	1	1	2	0	0	2	0	0
14	35715815	.	T	C	1	0	1	0	0	1	0	0
14	35719354	.	G	A	8	4	12	0	1	13	0	0
14	35731558	.	C	T	23	25	48	0	5	53	0	0
14	35732110	.	C	T	19	19	38	0	1	39	0	0
14	35732189	.	C	T	3	8	11	0	1	12	0	0
14	35732195	.	C	T	7	4	11	0	1	12	0	0
14	35804592	.	T	C	1	0	1	0	0	1	0	0
14	35811971	.	C	T	18	17	35	0	1	36	0	0
14	35812355	.	G	A	20	15	35	0	1	36	0	0
14	35812718	.	C	A	8	11	19	0	1	20	0	0
14	35813121	.	T	A	1	15	16	0	5	21	0	0
14	35813367	.	C	A	27	23	50	0	0	50	0	0
14	35813384	.	G	A	0	26	26	0	31	57	0	0
14	35813407	.	C	T	21	33	54	0	6	60	0	0
14	35813424	.	C	T	22	31	53	0	4	57	0	0
14	35813479	.	T	A	35	19	54	0	2	56	0	0
14	35895983	.	G	A	2	3	5	0	0	5	0	0
14	35905907	.	T	C	2	1	3	0	0	3	0	0
14	35906286	.	A	T	4	1	5	0	0	5	0	0
14	35906312	.	T	C	5	2	7	0	0	7	0	0
14	35906345	.	C	A	2	3	5	0	1	6	0	0
14	35906399	.	A	G	3	1	4	0	0	4	0	0
14	36268424	.	T	C	0	1	1	0	1	2	0	0
14	36268426	.	T	C	0	2	2	0	0	2	0	0
14	38689112	.	C	T	3	2	5	0	0	5	0	0
14	38875638	.	T	C	1	3	4	0	0	4	0	0
14	40746034	.	A	G	1	2	3	0	0	3	0	0
14	40852732	.	T	C	2	3	5	0	0	5	0	0
14	40853268	.	C	G	0	2	2	0	0	2	0	0
14	40857881	.	T	C	1	2	3	0	0	3	0	0
14	40857977	.	C	T	2	2	4	0	0	4	0	0
14	40860291	.	T	A	2	3	5	0	0	5	0	0
14	40860354	.	C	T	7	12	19	0	2	21	0	0
14	40863062	.	A	G	12	12	24	0	1	25	0	0
14	40863161	.	T	C	3	11	14	0	1	16	1	0
14	40863176	.	A	G	1	9	10	0	1	11	0	0
14	40869331	.	C	A	11	10	21	0	5	26	0	0
14	40874026	.	G	T	5	7	12	0	0	12	0	0
14	41276516	.	T	A	12	9	21	0	3	24	0	0
14	41276608	.	G	A	6	6	12	0	3	15	0	0
14	41277391	.	A	T	4	12	16	0	0	16	0	0
14	41277556	.	A	G	24	19	43	0	4	47	0	0
14	41277624	.	A	T	25	22	47	0	0	47	0	0
14	41278238	.	T	A	13	13	26	0	2	28	0	0
14	41278255	.	A	G	16	11	27	0	1	28	0	0
14	41278658	.	T	G	3	5	8	0	1	9	0	0
14	41279133	.	C	T	7	9	16	0	0	16	0	0
14	41279214	.	C	T	9	5	14	0	0	14	0	0
14	41279277	.	G	C	9	9	18	0	3	21	0	0
14	41279527	.	C	T	0	3	3	0	2	5	0	0
14	41279542	.	C	A	1	3	4	0	4	8	0	0
14	41279974	.	T	G	4	6	10	0	0	10	0	0
14	41279977	.	G	T	3	7	10	0	1	11	0	0
14	41280013	.	G	A	0	3	3	0	3	6	0	0
14	41280149	.	G	A	4	8	12	0	0	12	0	0
14	41280228	.	A	G	12	5	17	0	0	17	0	0
14	41293435	.	A	T	0	2	2	0	1	3	0	0
14	41339820	.	G	C	3	4	7	0	0	7	0	0
14	41340042	.	A	C	4	2	6	0	1	7	0	0
14	41340054	.	T	A	5	2	7	0	0	7	0	0
14	41340081	.	A	T	2	3	5	0	0	5	0	0
14	41340172	.	A	C	7	3	10	0	0	10	0	0
14	41340231	.	G	A	3	2	5	0	0	5	0	0
14	41340284	.	C	T	0	2	2	0	0	2	0	0
14	41340570	.	G	A	0	2	2	0	0	2	0	0
14	41361985	.	C	T	0	13	13	0	6	19	0	0
14	41362007	.	G	A	4	13	17	0	1	18	0	0
14	41366823	.	G	A	17	12	29	0	0	29	0	0
14	41366889	.	C	A	0	0	0	0	1	1	0	0
14	41385823	.	G	A	2	4	6	0	0	6	0	0
14	41385895	.	C	T	0	4	4	0	3	7	0	0
14	41388120	.	G	A	2	3	5	0	1	6	0	0
14	41435662	.	C	T	3	3	6	0	0	6	0	0
14	41436773	.	T	A	3	2	5	0	0	5	0	0
14	41438005	.	G	A	8	5	13	0	1	14	0	0
14	41466522	.	G	A	9	4	13	0	0	13	0	0
14	41466922	.	T	A	8	13	21	0	1	22	0	0
14	41467152	.	T	C	2	13	15	0	0	15	0	0
14	41467356	.	C	G	3	3	6	0	1	7	0	0
14	41469575	.	T	A	6	4	10	0	0	10	0	0
14	41469662	.	C	A	4	2	6	0	1	7	0	0
14	41469761	.	G	T	6	2	8	0	1	10	1	0
14	41469925	.	T	A	0	7	7	0	0	7	0	0
14	41469935	.	C	T	0	5	5	0	1	6	0	0
14	41470032	.	C	T	0	4	4	0	2	6	0	0
14	41470037	.	A	T	2	3	5	0	0	5	0	0
14	41513448	.	G	A	2	2	4	0	0	4	0	0
14	41514767	.	C	T	1	2	3	0	0	3	0	0
14	42178503	.	C	T	8	9	17	0	0	17	0	0
14	42178728	.	G	A	8	4	12	0	0	12	0	0
14	42178974	.	G	A	10	11	21	0	1	22	0	0
14	42179574	.	G	T	2	5	7	0	2	9	0	0
14	42179697	.	G	A	3	4	7	0	1	8	0	0
14	42978975	.	A	G	16	14	30	0	0	30	0	0
14	42978980	.	A	C	15	14	29	0	1	30	0	0
14	42979087	.	A	T	8	15	23	0	0	23	0	0
14	42979090	.	T	A	8	14	22	0	1	23	0	0
14	42979655	.	A	G	15	17	32	0	2	34	0	0
14	42997943	.	G	A	4	8	12	0	0	12	0	0
14	42998353	.	G	A	3	5	8	0	0	8	0	0
14	42998879	.	G	A	3	2	5	0	0	5	0	0
14	42999314	.	C	T	3	3	6	0	0	6	0	0
14	43577346	.	C	T	0	13	13	0	9	22	0	0
14	43577704	.	G	A	6	6	12	0	0	12	0	0
14	43577916	.	G	A	2	0	2	0	1	3	0	0
14	43580985	.	G	T	3	2	5	0	0	5	0	0
14	43582551	.	C	G	0	1	1	0	0	1	0	0
14	43582567	.	G	A	0	1	1	0	0	1	0	0
14	43582602	.	C	T	0	1	1	0	0	1	0	0
14	43591152	.	G	T	2	10	12	0	0	12	0	0
14	43591188	.	G	A	6	15	21	0	1	22	0	0
14	43605214	.	T	C	7	5	12	0	0	12	0	0
14	43605462	.	C	T	4	7	11	0	0	11	0	0
14	43605510	.	G	A	5	4	9	0	1	10	0	0
14	44589212	.	T	A	3	2	5	0	1	6	0	0
14	44589624	.	C	T	2	4	6	0	0	6	0	0
14	44589723	.	C	T	3	5	8	0	0	8	0	0
14	44590297	.	G	C	2	7	9	0	2	11	0	0
14	44590301	.	A	G	3	0	3	0	9	12	0	0
14	44590644	.	C	T	17	12	29	0	0	29	0	0
14	44590838	.	T	A	11	7	18	0	0	18	0	0
14	44590935	.	G	A	0	8	8	0	16	24	0	0
14	44590992	.	A	G	8	11	19	0	2	21	0	0
14	44769683	.	T	A	2	2	4	0	0	4	0	0
14	45071319	.	G	T	1	1	2	0	0	2	0	0
14	45634960	.	C	T	12	19	31	1	11	43	0	0
14	45929409	.	C	T	2	2	4	0	0	4	0	0
14	45930135	.	T	C	4	2	6	0	0	6	0	0
14	45930196	.	A	C	2	2	4	0	0	4	0	0
14	45930399	.	C	T	2	2	4	0	0	4	0	0
14	45930508	.	A	G	0	0	0	0	1	1	0	0
14	45930515	.	G	A	0	2	2	0	0	2	0	0
14	45930572	.	A	G	2	2	4	0	0	4	0	0
14	45930573	.	T	G	2	2	4	0	0	4	0	0
14	45930617	.	A	G	0	1	1	0	1	2	0	0
14	45930794	.	G	A	1	4	5	0	2	7	0	0
14	45931079	.	C	G	6	5	11	0	0	11	0	0
14	45931194	.	G	T	5	6	11	0	1	12	0	0
14	45931504	.	C	G	4	12	16	0	1	17	0	0
14	45931637	.	C	T	8	8	16	0	0	16	0	0
14	45931899	.	C	T	6	11	17	0	3	20	0	0
14	45932128	.	T	G	15	3	18	0	0	18	0	0
14	46009611	.	G	A	1	1	2	0	0	2	0	0
14	46010909	.	T	C	2	1	3	0	0	3	0	0
14	46013121	.	A	T	1	2	3	0	0	3	0	0
14	46013402	.	C	T	4	3	7	0	0	7	0	0
14	46015888	.	C	A	0	1	1	0	0	1	0	0
14	46016107	.	A	G	3	2	5	0	0	5	0	0
14	46017969	.	G	A	9	15	24	0	0	24	0	0
14	46018029	.	C	T	10	12	22	0	0	22	0	0
14	46018548	.	A	G	5	21	26	0	0	26	0	0
14	46018560	.	A	G	10	11	21	0	1	22	0	0
14	46041861	.	A	T	2	5	7	0	0	7	0	0
14	46048115	.	T	A	1	3	4	0	0	4	0	0
14	46048396	.	A	G	4	4	8	0	0	8	0	0
14	46048644	.	C	T	0	10	10	0	5	15	0	0
14	46048704	.	C	G	0	5	5	0	7	12	0	0
14	46048875	.	T	C	13	6	19	0	0	19	0	0
14	46052172	.	T	A	3	6	9	0	1	10	0	0
14	46052244	.	G	T	4	2	6	0	0	6	0	0
14	46074433	.	C	T	15	6	21	0	1	22	0	0
14	46074473	.	T	A	12	6	18	0	0	18	0	0
14	46074489	.	A	G	8	5	13	0	0	13	0	0
14	46074626	.	C	G	7	3	10	0	0	11	1	0
14	46074646	.	G	T	9	3	12	0	1	13	0	0
14	46075085	.	T	C	3	2	5	0	1	6	0	0
14	46075749	.	A	G	4	2	6	0	0	6	0	0
14	46075903	.	C	A	4	3	7	0	0	7	0	0
14	46075937	.	T	A	3	4	7	0	1	8	0	0
14	46088595	.	T	A	4	4	8	0	0	8	0	0
14	46088921	.	A	G	14	8	22	0	1	23	0	0
14	46089176	.	C	T	7	4	11	0	1	12	0	0
14	46089297	.	A	C	4	3	7	0	0	7	0	0
14	46089433	.	T	G	5	3	8	0	0	8	0	0
14	46091627	.	T	C	2	2	4	0	0	4	0	0
14	46094922	.	C	T	11	13	24	0	2	26	0	0
14	46095043	.	A	G	21	13	34	0	2	36	0	0
14	46095058	.	A	G	20	7	27	0	3	30	0	0
14	46095108	.	A	G	20	25	45	0	4	49	0	0
14	46104150	.	C	T	6	6	12	0	1	13	0	0
14	46104222	.	C	T	0	3	3	0	5	8	0	0
14	46104935	.	G	A	4	3	7	0	0	7	0	0
14	46113296	.	T	G	9	12	21	0	2	23	0	0
14	46113309	.	C	G	0	6	6	0	10	16	0	0
14	46114929	.	G	A	1	1	2	0	0	2	0	0
14	46116576	.	A	G	8	2	10	0	0	10	0	0
14	46117279	.	G	T	5	3	8	0	1	9	0	0
14	46154358	.	C	A	6	11	17	0	0	17	0	0
14	46154713	.	A	G	8	8	16	0	2	18	0	0
14	46154899	.	A	C	11	12	23	0	3	26	0	0
14	46154966	.	T	A	10	2	12	0	2	14	0	0
14	46154969	.	T	A	9	3	12	0	1	13	0	0
14	46187317	.	A	G	1	1	2	0	1	3	0	0
14	46679356	.	T	C	6	11	17	1	0	18	0	0
14	47003023	.	T	G	13	12	25	0	0	25	0	0
14	47003330	.	A	C	17	15	32	0	2	34	0	0
14	47003696	.	G	T	16	15	31	0	0	31	0	0
14	47003908	.	C	T	0	21	21	0	16	37	0	0
14	47003958	.	T	A	11	19	30	0	5	35	0	0
14	47004090	.	T	G	12	7	19	0	0	19	0	0
14	47004365	.	G	A	2	6	8	0	0	8	0	0
14	47004959	.	T	G	3	3	6	0	0	6	0	0
14	47027767	.	G	A	0	1	1	0	0	1	0	0
14	47066764	.	G	A	1	2	3	0	0	3	0	0
14	48933958	.	T	C	3	1	4	0	1	5	0	0
14	48934010	.	T	C	9	3	12	0	0	12	0	0
14	48934639	.	T	C	8	0	8	0	2	10	0	0
14	49211001	.	A	G	1	2	3	0	0	3	0	0
14	49430817	.	A	G	6	14	20	0	0	20	0	0
14	49430844	.	A	G	13	5	18	0	3	21	0	0
14	50815344	.	C	A	1	4	5	0	0	5	0	0
14	50815375	.	A	T	1	3	4	0	0	4	0	0
14	50815384	.	A	G	1	0	1	0	4	5	0	0
14	52518002	.	A	G	8	15	23	0	1	24	0	0
14	52574497	.	C	A	0	1	1	0	1	2	0	0
14	52576055	.	A	G	0	3	3	0	4	7	0	0
15	93401	.	A	G	1	3	4	0	1	5	0	0
15	1033435	.	A	T	8	4	12	0	0	12	0	0
15	1033564	.	G	T	7	6	13	0	0	13	0	0
15	1033955	.	C	T	0	2	2	0	4	6	0	0
15	1036825	.	T	C	3	1	4	0	0	4	0	0
15	1162040	.	A	G	1	1	2	0	0	2	0	0
15	1162048	.	T	C	1	2	3	0	0	3	0	0
15	1176447	.	G	A	0	2	2	0	1	3	0	0
15	1178927	.	C	A	5	3	8	0	0	8	0	0
15	1181477	.	G	T	6	5	11	0	1	12	0	0
15	1181480	.	C	T	0	6	6	0	6	12	0	0
15	1186181	.	A	G	3	5	8	0	0	8	0	0
15	1189664	.	C	T	5	4	9	0	1	10	0	0
15	1191750	.	A	G	1	1	2	0	0	2	0	0
15	1191792	.	G	A	0	5	5	0	5	10	0	0
15	1194590	.	A	G	11	4	15	0	2	18	1	0
15	1194619	.	G	A	0	7	7	0	14	21	0	0
15	1194633	.	A	G	11	5	16	0	2	18	0	0
15	1417032	.	G	A	0	7	7	0	5	12	0	0
15	1417104	.	C	T	1	0	1	0	0	1	0	0
15	1434192	.	T	A	7	8	15	0	0	15	0	0
15	1434228	.	T	C	9	7	16	0	1	17	0	0
15	1434627	.	T	G	0	2	2	0	0	2	0	0
15	1434885	.	T	C	4	6	10	0	0	10	0	0
15	1435024	.	T	C	14	11	25	0	1	26	0	0
15	1435047	.	A	G	15	10	25	0	0	25	0	0
15	1435176	.	A	G	14	0	14	0	13	27	0	0
15	1435265	.	C	T	20	11	31	0	1	32	0	0
15	1435266	.	A	G	21	10	31	0	1	32	0	0
15	1435368	.	T	A	11	9	20	0	0	20	0	0
15	1435462	.	G	A	0	13	13	0	9	22	0	0
15	1436041	.	C	A	11	9	20	1	0	21	0	0
15	1436072	.	T	A	15	16	31	0	2	33	0	0
15	1436154	.	T	C	7	29	36	0	0	36	0	0
15	1436386	.	G	A	0	21	21	0	23	44	0	0
15	1436457	.	C	A	14	11	25	0	22	47	0	0
15	1436461	.	A	G	13	18	31	0	13	44	0	0
15	1436537	.	C	T	15	30	45	0	2	47	0	0
15	1436629	.	T	C	4	6	10	0	2	12	0	0
15	1453118	.	C	T	1	2	3	0	0	3	0	0
15	1453153	.	T	C	1	2	3	0	0	3	0	0
15	1453457	.	T	A	1	2	3	0	0	3	0	0
15	1453468	.	A	T	1	2	3	0	0	3	0	0
15	1471406	.	C	G	0	3	3	0	1	4	0	0
15	1471421	.	G	A	1	4	5	0	0	5	0	0
15	1497353	.	G	A	5	9	14	0	0	14	0	0
15	1497398	.	C	G	8	6	14	0	3	17	0	0
15	1497443	.	A	G	5	5	10	0	1	11	0	0
15	1497982	.	T	A	1	1	2	0	0	2	0	0
15	1499732	.	C	T	2	4	6	0	1	7	0	0
15	1506392	.	A	G	1	0	1	0	0	1	0	0
15	1506503	.	C	T	0	1	1	0	2	3	0	0
15	1606802	.	G	C	2	0	2	0	5	7	0	0
15	1607707	.	G	A	1	0	1	0	0	1	0	0
15	1612770	.	T	C	0	1	1	0	0	1	0	0
15	1631209	.	T	C	3	1	4	0	15	19	0	0
15	1631241	.	C	G	13	6	19	0	1	20	0	0
15	1661684	.	T	C	0	1	1	0	0	1	0	0
15	1661732	.	T	C	0	1	1	0	0	1	0	0
15	1669719	.	C	T	2	2	4	0	0	4	0	0
15	1672050	.	G	A	0	3	3	0	1	4	0	0
15	1672060	.	G	A	2	3	5	0	0	5	0	0
15	1750044	.	G	C	6	7	13	0	1	14	0	0
15	1750047	.	A	C	7	7	14	0	0	14	0	0
15	1782156	.	T	C	3	2	5	0	0	5	0	0
15	1789281	.	T	A	6	8	14	0	3	17	0	0
15	1789302	.	T	C	6	6	12	0	1	13	0	0
15	1792532	.	T	G	11	13	24	0	1	25	0	0
15	1828388	.	C	T	2	6	8	0	1	9	0	0
15	1829166	.	C	T	10	11	21	0	1	22	0	0
15	1830259	.	T	C	2	1	3	0	0	3	0	0
15	1830275	.	A	G	2	2	4	0	0	4	0	0
15	1830452	.	G	A	3	2	5	0	1	6	0	0
15	1831210	.	A	G	1	6	7	0	0	7	0	0
15	1834326	.	A	G	13	17	30	0	0	30	0	0
15	1837854	.	T	G	6	4	10	0	0	10	0	0
15	1837878	.	G	T	2	2	4	0	0	4	0	0
15	1847299	.	G	A	8	4	12	0	1	13	0	0
15	1847310	.	T	A	8	5	13	0	1	14	0	0
15	1847358	.	A	G	9	9	18	0	2	20	0	0
15	1847432	.	A	C	14	9	23	0	2	25	0	0
15	1847533	.	C	T	9	5	14	0	0	14	0	0
15	1847679	.	A	G	3	2	5	0	0	5	0	0
15	1847728	.	G	A	5	5	10	0	0	10	0	0
15	1847755	.	G	T	6	4	10	0	0	10	0	0
15	1847908	.	A	C	6	7	13	0	0	13	0	0
15	1847931	.	G	A	2	6	8	0	2	10	0	0
15	1847951	.	G	A	2	4	6	0	0	6	0	0
15	1848098	.	T	C	2	6	8	0	0	8	0	0
15	1848106	.	T	C	2	3	5	0	2	7	0	0
15	1848202	.	G	T	3	3	6	0	1	7	0	0
15	1899401	.	A	T	3	7	10	0	0	10	0	0
15	1899831	.	G	A	11	13	24	0	2	26	0	0
15	1899878	.	T	C	6	10	16	0	0	16	0	0
15	1900087	.	T	C	3	3	6	0	0	6	0	0
15	1900092	.	T	C	2	1	3	0	0	3	0	0
15	1902259	.	A	G	2	1	3	0	1	4	0	0
15	1902271	.	C	T	2	2	4	0	0	4	0	0
15	1903029	.	A	G	1	8	9	0	0	9	0	0
15	1905364	.	T	G	3	4	7	0	0	7	0	0
15	1905412	.	T	C	2	4	6	0	0	6	0	0
15	1908147	.	G	C	1	2	3	0	2	5	0	0
15	2414214	.	A	G	5	6	11	0	0	11	0	0
15	2414216	.	A	G	6	5	11	0	0	11	0	0
15	2414870	.	A	G	5	3	8	0	0	8	0	0
15	2415228	.	A	G	2	3	5	0	1	6	0	0
15	2729971	.	T	C	1	6	7	0	0	7	0	0
15	2730289	.	T	C	1	5	6	0	0	6	0	0
15	2730358	.	T	C	2	4	6	0	0	6	0	0
15	2730412	.	T	C	3	2	5	0	0	5	0	0
15	3089383	.	G	A	17	19	36	0	1	37	0	0
15	3089461	.	C	G	0	8	8	0	15	23	0	0
15	3782635	.	C	A	1	2	3	0	0	3	0	0
15	3782640	.	C	A	1	1	2	0	0	2	0	0
15	3924349	.	C	G	3	2	5	0	0	5	0	0
15	3925206	.	G	T	0	5	5	0	7	12	0	0
15	3925403	.	T	G	1	2	3	0	0	3	0	0
15	3927252	.	G	A	3	4	7	0	0	7	0	0
15	3927437	.	G	A	2	2	4	0	0	4	0	0
15	3927438	.	G	A	2	2	4	0	0	4	0	0
15	3927857	.	G	C	1	2	3	0	0	3	0	0
15	3927930	.	G	A	2	1	3	0	1	4	0	0
15	4104675	.	A	G	4	3	7	0	0	7	0	0
15	4104711	.	G	T	3	4	7	0	0	7	0	0
15	4105009	.	A	G	9	3	12	0	0	12	0	0
15	4105164	.	C	T	0	8	8	0	4	12	0	0
15	4105262	.	A	G	8	4	12	0	0	12	0	0
15	4105328	.	A	G	4	2	6	0	0	6	0	0
15	4105416	.	G	T	4	6	10	0	0	10	0	0
15	4112233	.	C	T	1	1	2	0	0	2	0	0
15	4353311	.	G	T	32	13	45	0	3	48	0	0
15	4353965	.	G	A	23	31	54	0	6	60	0	0
15	4354082	.	G	A	27	28	55	0	5	60	0	0
15	4371833	.	T	C	2	2	4	0	0	4	0	0
15	4371863	.	C	T	0	1	1	0	1	2	0	0
15	4422222	.	A	G	3	5	8	0	0	8	0	0
15	4422293	.	G	C	3	1	4	0	4	8	0	0
15	4422383	.	A	T	1	2	3	0	0	3	0	0
15	4426474	.	C	T	2	3	5	0	0	5	0	0
15	5916651	.	A	T	3	2	5	0	1	6	0	0
15	6519686	.	G	A	1	0	1	0	0	1	0	0
15	6652600	.	T	C	4	9	13	0	0	13	0	0
15	6653094	.	T	G	2	0	2	0	0	2	0	0
15	6653209	.	G	T	0	1	1	0	0	1	0	0
15	6653282	.	C	G	0	1	1	0	0	1	0	0
15	6654587	.	C	A	5	13	18	0	1	19	0	0
15	6659159	.	G	A	7	5	12	0	1	13	0	0
15	6661390	.	G	A	5	18	23	0	1	24	0	0
15	6661449	.	T	C	13	10	23	0	1	24	0	0
15	6661499	.	G	A	1	1	2	0	0	2	0	0
15	6778483	.	A	G	3	2	5	0	0	5	0	0
15	6778813	.	A	G	1	1	2	0	0	2	0	0
15	6778825	.	A	G	1	2	3	0	0	3	0	0
15	6778856	.	C	A	2	3	5	0	0	5	0	0
15	6778877	.	A	G	2	3	5	0	0	5	0	0
15	6784093	.	T	C	2	4	6	0	0	6	0	0
15	6784118	.	C	T	1	3	4	0	1	5	0	0
15	6806712	.	G	C	13	9	22	0	1	23	0	0
15	6806836	.	G	A	11	12	23	0	1	24	0	0
15	6806912	.	T	G	5	9	14	0	0	14	0	0
15	6806931	.	T	G	3	8	11	0	0	11	0	0
15	6807406	.	C	A	1	3	4	0	0	4	0	0
15	6807500	.	C	G	9	10	19	0	3	22	0	0
15	6807514	.	G	A	11	7	18	0	3	21	0	0
15	6807563	.	A	T	14	14	28	0	0	28	0	0
15	6807874	.	C	T	5	14	19	0	1	20	0	0
15	6838154	.	T	A	2	5	7	0	0	7	0	0
15	6838771	.	T	C	1	4	5	0	2	7	0	0
15	6838786	.	T	C	3	4	7	0	0	7	0	0
15	6841506	.	G	T	0	2	2	0	0	2	0	0
15	6957221	.	C	G	2	6	8	0	1	9	0	0
15	8799004	.	A	G	16	10	26	0	0	26	0	0
15	8799007	.	A	G	7	19	26	0	2	28	0	0
15	8799135	.	A	G	17	4	21	0	1	22	0	0
15	9235460	.	T	G	16	4	20	0	3	23	0	0
15	9235461	.	T	G	9	12	21	0	2	23	0	0
15	10001500	.	C	T	3	3	6	0	1	7	0	0
15	11218828	.	T	C	7	3	10	0	0	10	0	0
15	11218865	.	T	C	8	2	10	0	0	10	0	0
15	11218866	.	T	C	7	2	9	0	1	10	0	0
15	13107454	.	T	A	12	3	15	0	2	17	0	0
15	13107498	.	C	T	6	11	17	0	3	20	0	0
15	13107561	.	T	C	12	7	19	0	2	21	0	0
15	13107562	.	G	A	9	8	17	0	4	21	0	0
15	13127035	.	A	G	2	3	5	0	0	5	0	0
15	13127248	.	T	C	8	5	13	0	0	13	0	0
15	13129937	.	A	G	8	3	11	0	0	11	0	0
15	13138074	.	A	C	1	5	6	0	0	6	0	0
15	13985578	.	T	C	4	3	7	0	0	7	0	0
15	13985827	.	C	G	2	2	4	0	0	4	0	0
15	13986233	.	G	T	6	8	14	0	1	15	0	0
15	13986279	.	A	T	4	9	13	0	0	13	0	0
15	14076096	.	T	C	4	5	9	0	0	9	0	0
15	14076223	.	A	T	2	4	6	0	0	6	0	0
15	14076329	.	T	G	8	4	12	0	0	12	0	0
15	14079784	.	G	A	1	1	2	0	0	2	0	0
15	14082347	.	G	T	2	0	2	0	0	2	0	0
15	14085241	.	C	T	1	2	3	0	0	3	0	0
15	14085276	.	T	G	3	7	10	0	2	12	0	0
15	14085800	.	T	C	3	2	5	0	0	5	0	0
15	14085847	.	G	T	3	5	8	0	0	8	0	0
15	14085914	.	G	A	2	5	7	0	0	7	0	0
15	14088146	.	G	A	7	4	11	0	2	13	0	0
15	14093020	.	G	A	1	2	3	0	1	4	0	0
15	14093032	.	A	G	1	2	3	0	0	3	0	0
15	14093110	.	T	A	3	2	5	0	0	5	0	0
15	14205971	.	T	C	2	2	4	0	0	4	0	0
15	14206480	.	A	G	2	6	8	0	0	8	0	0
15	14206505	.	T	C	1	6	7	0	0	7	0	0
15	14317040	.	G	A	0	2	2	0	0	2	0	0
15	14417492	.	T	C	1	2	3	0	0	3	0	0
15	14420177	.	C	T	6	6	12	0	0	12	0	0
15	14420501	.	A	C	1	3	4	0	0	4	0	0
15	14436646	.	G	A	1	2	3	0	0	3	0	0
15	14436655	.	T	C	0	0	0	0	2	2	0	0
15	14554634	.	G	A	1	4	5	0	1	6	0	0
15	14554769	.	C	T	0	2	2	0	4	6	0	0
15	14598807	.	T	C	1	2	3	0	0	3	0	0
15	14598823	.	G	A	0	2	2	0	2	4	0	0
15	14598930	.	G	A	0	4	4	0	5	9	0	0
15	14599152	.	T	C	2	2	4	0	3	7	0	0
15	14599167	.	G	A	0	3	3	0	2	5	0	0
15	14599203	.	A	G	4	3	7	0	0	7	0	0
15	14599486	.	G	A	3	3	6	0	0	6	0	0
15	14631242	.	A	G	8	4	12	0	0	12	0	0
15	14631258	.	C	T	9	4	13	0	0	13	0	0
15	14631289	.	T	C	6	3	9	0	0	9	0	0
15	14631531	.	T	C	1	0	1	0	4	5	0	0
15	14631535	.	T	C	0	4	4	0	1	5	0	0
15	14631969	.	A	G	5	3	8	0	1	9	0	0
15	14632135	.	C	T	0	4	4	0	3	7	0	0
15	14632160	.	A	T	4	2	6	0	0	6	0	0
15	14632189	.	T	C	4	2	6	0	0	6	0	0
15	14632197	.	G	T	6	2	8	0	0	8	0	0
15	14632293	.	T	A	1	3	4	0	0	4	0	0
15	14632510	.	G	A	3	2	5	0	0	5	0	0
15	14632543	.	C	T	2	4	6	0	0	6	0	0
15	14632713	.	T	A	0	2	2	0	1	3	0	0
15	14632834	.	G	C	1	0	1	0	2	3	0	0
15	14632842	.	G	A	1	2	3	0	0	3	0	0
15	14633011	.	T	C	3	0	3	0	2	5	0	0
15	14633404	.	C	T	0	2	2	0	1	3	0	0
15	14654476	.	A	T	2	0	2	0	0	2	0	0
15	14665761	.	T	C	0	2	2	0	0	2	0	0
15	14666922	.	G	A	5	3	8	0	0	8	0	0
15	14855219	.	C	A	0	2	2	0	0	2	0	0
15	14856803	.	A	T	3	0	3	0	0	3	0	0
15	15297800	.	T	G	3	3	6	0	0	6	0	0
15	15348767	.	C	T	5	2	7	0	3	10	0	0
15	15349693	.	C	T	23	32	55	0	5	60	0	0
15	15349780	.	C	T	24	30	54	0	7	61	0	0
15	15349860	.	T	A	29	23	52	0	6	58	0	0
15	15445769	.	T	C	11	0	11	0	4	15	0	0
15	15445876	.	T	C	0	7	7	0	0	7	0	0
15	15445899	.	T	C	2	7	9	0	1	10	0	0
15	15446104	.	T	C	9	5	14	0	1	15	0	0
15	15446484	.	C	T	0	8	8	0	6	14	0	0
15	15446590	.	G	A	6	5	11	0	0	11	0	0
15	15446609	.	C	A	4	4	8	0	2	10	0	0
15	15447037	.	C	T	0	2	2	0	2	4	0	0
15	15447109	.	G	A	4	7	11	0	0	11	0	0
15	15447118	.	T	C	4	0	4	0	6	10	0	0
15	15459212	.	C	A	2	2	4	0	0	4	0	0
15	15460593	.	A	G	1	2	3	0	0	3	0	0
15	15589504	.	C	T	3	6	9	0	0	9	0	0
15	15591783	.	G	A	6	2	8	0	0	8	0	0
15	15591868	.	T	A	6	5	11	0	0	11	0	0
15	15592318	.	G	A	12	12	24	0	0	24	0	0
15	15592504	.	C	T	11	12	23	0	3	26	0	0
15	15592537	.	A	T	14	13	27	0	1	28	0	0
15	15592629	.	T	C	8	9	17	0	1	18	0	0
15	15592784	.	C	A	12	18	30	0	0	30	0	0
15	15592879	.	C	T	6	4	10	0	2	12	0	0
15	15592991	.	G	A	25	10	35	0	3	38	0	0
15	15593128	.	G	A	16	11	27	0	4	31	0	0
15	15786389	.	T	C	2	2	4	0	0	4	0	0
15	15810922	.	G	C	0	1	1	0	5	6	0	0
15	15813810	.	C	T	8	5	13	0	0	13	0	0
15	15876974	.	T	C	6	4	10	0	1	11	0	0
15	15877019	.	T	C	8	10	18	0	0	18	0	0
15	15877600	.	G	A	17	11	28	0	0	28	0	0
15	15877616	.	G	C	14	13	27	0	1	28	0	0
15	15886202	.	C	A	9	10	19	0	1	20	0	0
15	15886346	.	A	G	8	1	9	0	3	12	0	0
15	15886502	.	A	G	11	3	14	0	0	14	0	0
15	15886564	.	A	G	7	5	12	0	1	13	0	0
15	15886697	.	T	C	3	7	10	0	1	11	0	0
15	15886701	.	C	T	0	7	7	0	3	10	0	0
15	15886803	.	C	T	0	7	7	0	6	13	0	0
15	15886806	.	T	C	8	4	12	0	1	13	0	0
15	15906718	.	G	A	0	3	3	0	0	3	0	0
15	15906766	.	C	T	2	6	8	0	0	8	0	0
15	15916216	.	G	A	2	3	5	0	1	6	0	0
15	15923499	.	G	A	3	1	4	0	1	5	0	0
15	15944045	.	C	T	0	2	2	0	1	3	0	0
15	15944435	.	G	A	1	4	5	0	0	5	0	0
15	15950223	.	A	C	0	1	1	0	0	1	0	0
15	16066453	.	A	G	17	28	45	0	1	46	0	0
15	16066459	.	C	T	17	29	46	0	1	47	0	0
15	16066508	.	C	T	0	24	24	0	30	54	0	0
15	16067051	.	G	A	24	19	43	0	3	46	0	0
15	16072281	.	A	C	27	24	51	0	3	54	0	0
15	16072690	.	T	C	16	32	48	0	0	48	0	0
15	16072822	.	T	A	23	15	38	0	2	40	0	0
15	16073046	.	C	A	11	5	16	0	1	17	0	0
15	16073055	.	A	C	7	3	10	0	5	16	1	0
15	16073081	.	A	G	13	4	17	0	4	21	0	0
15	16079709	.	T	G	27	20	47	0	2	50	1	0
15	16079733	.	G	T	26	17	43	0	0	43	0	0
15	16080258	.	G	A	14	10	24	0	0	24	0	0
15	16086528	.	G	A	1	1	2	0	1	3	0	0
15	16086600	.	G	T	12	7	19	0	1	20	0	0
15	16101332	.	G	A	0	3	3	0	1	4	0	0
15	16123356	.	C	T	3	4	7	0	1	8	0	0
15	16123358	.	A	G	5	2	7	0	1	8	0	0
15	16123735	.	G	C	7	5	12	0	0	12	0	0
15	16123873	.	G	A	5	5	10	0	0	10	0	0
15	16123921	.	T	C	6	9	15	0	2	17	0	0
15	16124125	.	G	A	5	7	12	0	1	13	0	0
15	16124210	.	C	T	0	2	2	0	4	6	0	0
15	16125799	.	T	C	0	1	1	0	0	1	0	0
15	16127139	.	C	T	1	1	2	0	0	2	0	0
15	16130244	.	G	A	3	3	6	0	1	7	0	0
15	16144013	.	G	A	1	2	3	0	0	3	0	0
15	16191907	.	T	C	1	2	3	0	0	3	0	0
15	16191913	.	G	A	0	2	2	0	1	3	0	0
15	16194155	.	A	T	16	14	30	0	1	31	0	0
15	16194208	.	G	A	13	3	16	0	1	17	0	0
15	16194254	.	G	C	5	11	16	0	3	19	0	0
15	16194369	.	G	A	12	7	19	0	1	20	0	0
15	16194741	.	T	A	6	12	18	0	1	19	0	0
15	16226598	.	G	A	0	1	1	0	0	1	0	0
15	16328623	.	C	T	14	18	32	0	3	35	0	0
15	16332592	.	C	T	4	0	4	0	0	4	0	0
15	16332643	.	T	A	5	0	5	0	0	5	0	0
15	16332844	.	C	A	4	2	6	0	0	6	0	0
15	16377555	.	C	T	4	10	14	0	1	15	0	0
15	16378219	.	T	C	1	2	3	0	0	3	0	0
15	16378545	.	C	T	2	2	4	0	0	4	0	0
15	16401668	.	A	G	1	0	1	0	0	1	0	0
15	16406279	.	T	C	1	1	2	0	1	3	0	0
15	16406604	.	G	T	10	2	12	0	1	13	0	0
15	16407354	.	A	G	13	11	24	0	2	26	0	0
15	16407575	.	G	T	9	12	21	0	1	22	0	0
15	16407723	.	G	A	20	10	30	0	6	36	0	0
15	16935759	.	G	T	8	10	18	0	0	18	0	0
15	16935806	.	C	T	6	6	12	0	1	13	0	0
15	16935867	.	C	T	6	9	15	0	3	18	0	0
15	16936495	.	A	T	3	3	6	0	0	6	0	0
15	16936716	.	C	T	4	5	9	0	0	9	0	0
15	16937179	.	T	C	2	4	6	0	0	6	0	0
15	16937203	.	T	C	1	6	7	0	0	7	0	0
15	16937375	.	T	C	1	5	6	0	0	6	0	0
15	17091418	.	G	A	0	3	3	0	2	5	0	0
15	17095457	.	C	T	11	14	25	0	2	27	0	0
15	17123040	.	G	T	2	3	5	0	0	5	0	0
15	17123063	.	A	G	1	3	4	0	1	5	0	0
15	17123290	.	A	G	1	3	4	0	1	5	0	0
15	17123937	.	T	A	8	4	12	0	0	12	0	0
15	17123968	.	C	A	8	3	11	0	3	14	0	0
15	17124084	.	A	G	3	5	8	0	0	8	0	0
15	17124124	.	C	A	5	2	7	0	0	7	0	0
15	17124246	.	A	G	3	5	8	0	0	8	0	0
15	17124253	.	G	T	6	2	8	0	0	8	0	0
15	17124437	.	A	C	2	2	4	0	0	4	0	0
15	17124439	.	T	G	2	2	4	0	0	4	0	0
15	17124484	.	T	A	2	3	5	0	1	6	0	0
15	17124580	.	A	G	6	4	10	0	1	11	0	0
15	17124586	.	C	T	6	4	10	0	0	10	0	0
15	17124654	.	T	G	4	6	10	0	0	10	0	0
15	17124768	.	G	C	10	10	20	0	1	21	0	0
15	17124884	.	T	C	8	2	10	0	1	11	0	0
15	17124950	.	G	T	2	3	5	0	1	6	0	0
15	17125030	.	A	G	2	2	4	0	1	5	0	0
15	17125102	.	A	T	4	2	6	0	0	6	0	0
15	17125108	.	C	T	4	2	6	0	0	6	0	0
15	17128418	.	T	C	8	0	8	0	18	26	0	0
15	17128468	.	G	A	3	4	7	0	1	8	0	0
15	17131785	.	C	T	7	8	15	0	0	15	0	0
15	17134701	.	C	T	0	9	9	0	9	18	0	0
15	17147400	.	G	A	3	2	5	0	0	5	0	0
15	17268268	.	A	T	1	2	3	0	0	3	0	0
15	17280064	.	G	A	2	3	5	0	0	5	0	0
15	17317008	.	T	A	1	3	4	0	0	4	0	0
15	17317044	.	C	T	2	2	4	0	1	5	0	0
15	17318566	.	T	C	2	1	3	0	0	3	0	0
15	17319345	.	C	T	3	2	5	0	0	5	0	0
15	17320851	.	T	C	3	4	7	0	0	7	0	0
15	17321302	.	A	T	1	0	1	0	0	1	0	0
15	17324793	.	C	T	3	3	6	0	0	6	0	0
15	17327501	.	C	T	19	17	36	0	2	38	0	0
15	17339078	.	C	T	26	24	50	0	1	51	0	0
15	17339719	.	T	C	32	19	51	0	2	53	0	0
15	17340104	.	A	C	22	11	33	0	0	33	0	0
15	17372580	.	C	A	10	7	17	0	1	18	0	0
15	17372721	.	A	T	2	3	5	0	2	7	0	0
15	17372934	.	C	T	6	7	13	0	0	13	0	0
15	17423913	.	A	C	4	13	17	0	1	18	0	0
15	17424011	.	T	C	14	4	18	0	2	20	0	0
15	17424185	.	T	G	5	10	15	0	1	16	0	0
15	17424397	.	G	A	4	6	10	0	1	11	0	0
15	17424472	.	A	T	17	11	28	0	0	28	0	0
15	17424493	.	T	C	12	7	19	0	3	22	0	0
15	17424515	.	A	T	9	8	17	0	1	18	0	0
15	17424581	.	A	T	6	8	14	0	1	15	0	0
15	17486715	.	C	T	2	3	5	0	0	5	0	0
15	17486725	.	G	T	3	5	8	0	0	8	0	0
15	17487544	.	A	G	5	5	10	0	0	10	0	0
15	17487717	.	T	A	4	4	8	0	1	9	0	0
15	17488513	.	C	T	4	9	13	0	0	13	0	0
15	17488672	.	A	G	11	7	18	0	2	20	0	0
15	17488698	.	A	T	12	8	20	0	1	21	0	0
15	17488834	.	A	C	7	12	19	0	0	19	0	0
15	17489033	.	C	T	8	5	13	0	2	15	0	0
15	17489049	.	A	T	11	2	13	0	0	13	0	0
15	17489165	.	G	A	0	10	10	0	9	19	0	0
15	17489191	.	A	G	3	0	3	0	10	13	0	0
15	17489203	.	G	A	0	13	13	0	3	16	0	0
15	17489360	.	A	C	15	21	36	0	0	36	0	0
15	17489440	.	G	C	14	16	30	0	1	31	0	0
15	17489505	.	G	A	12	7	19	0	0	19	0	0
15	17489573	.	G	T	7	3	10	0	0	10	0	0
15	17489575	.	C	G	7	3	10	0	0	10	0	0
15	17866447	.	C	A	7	4	11	0	1	12	0	0
15	17866976	.	T	C	10	10	20	0	0	20	0	0
15	17867929	.	A	G	7	12	19	0	0	19	0	0
15	17868250	.	G	A	5	7	12	0	0	12	0	0
15	17868448	.	T	C	9	3	12	0	0	12	0	0
15	17868601	.	T	G	6	2	8	0	0	8	0	0
15	17948616	.	C	G	1	3	4	0	0	4	0	0
15	18102357	.	T	C	5	2	7	0	0	7	0	0
15	18102777	.	C	G	11	14	25	0	1	26	0	0
15	18102898	.	T	C	11	6	17	0	1	18	0	0
15	18103009	.	T	A	4	9	13	0	0	13	0	0
15	18103248	.	T	C	12	8	20	0	0	20	0	0
15	18103363	.	G	A	7	4	11	0	0	11	0	0
15	18106754	.	A	G	2	1	3	0	0	3	0	0
15	18107049	.	A	G	1	4	5	0	0	5	0	0
15	18107081	.	G	A	1	2	3	0	1	4	0	0
15	18130119	.	G	A	2	2	4	0	0	4	0	0
15	18130190	.	A	G	3	3	6	0	0	6	0	0
15	18130305	.	T	C	1	3	4	0	0	4	0	0
15	18141117	.	G	A	4	6	10	0	2	12	0	0
15	18143517	.	A	T	1	1	2	0	0	2	0	0
15	18148889	.	G	A	12	8	20	0	1	21	0	0
15	18148892	.	A	G	12	9	21	0	0	21	0	0
15	18148928	.	A	G	0	0	0	0	3	3	0	0
15	18155273	.	C	T	7	10	17	0	2	19	0	0
15	18155297	.	T	C	9	13	22	0	1	23	0	0
15	18155322	.	G	T	5	14	19	0	3	22	0	0
15	18155342	.	T	A	7	15	22	0	0	22	0	0
15	18155392	.	G	A	11	11	22	0	2	24	0	0
15	18155394	.	C	T	12	12	24	0	0	24	0	0
15	18155588	.	C	T	16	6	22	0	1	23	0	0
15	18155638	.	G	A	25	14	39	0	3	42	0	0
15	18155730	.	A	G	22	24	46	0	2	48	0	0
15	18253900	.	G	A	9	7	16	0	1	17	0	0
15	18254148	.	G	A	13	7	20	0	0	20	0	0
15	18254985	.	C	T	9	5	14	0	1	15	0	0
15	18255292	.	A	G	2	4	6	0	0	6	0	0
15	18371418	.	T	A	1	2	3	0	0	3	0	0
15	19037534	.	A	G	12	10	22	0	1	23	0	0
15	19037618	.	A	G	19	14	33	0	2	35	0	0
15	19037626	.	G	C	17	16	33	0	2	35	0	0
15	19037895	.	T	C	7	7	14	0	1	15	0	0
15	19038092	.	A	T	2	2	4	0	0	4	0	0
15	19038143	.	G	T	4	11	15	0	0	15	0	0
15	19038218	.	G	A	6	14	20	0	0	20	0	0
15	19039025	.	A	G	4	4	8	0	2	10	0	0
15	19039985	.	C	A	1	2	3	0	0	3	0	0
15	19132077	.	A	G	17	25	42	0	2	44	0	0
15	19132178	.	G	A	22	16	38	0	1	39	0	0
15	19132203	.	A	T	19	21	40	0	0	40	0	0
15	19132659	.	G	T	2	3	5	0	0	5	0	0
15	19132667	.	T	C	2	0	2	0	3	6	1	0
15	19133310	.	C	T	5	8	13	0	0	13	0	0
15	19133374	.	G	T	2	11	13	0	0	13	0	0
15	19133437	.	A	T	6	8	14	0	1	15	0	0
15	19133647	.	C	T	12	10	22	0	0	22	0	0
15	19133750	.	A	G	6	7	13	0	2	15	0	0
15	19134109	.	T	C	4	0	4	0	8	12	0	0
15	19135351	.	G	A	1	2	3	0	0	3	0	0
15	19311631	.	C	T	3	4	7	0	0	7	0	0
15	19312545	.	G	A	0	2	2	0	0	2	0	0
15	19316500	.	G	T	4	4	8	0	0	8	0	0
15	19316573	.	T	C	5	4	9	0	0	9	0	0
15	19318445	.	T	G	5	0	5	0	2	7	0	0
15	19319051	.	G	A	3	2	5	0	1	6	0	0
15	19319128	.	A	C	2	2	4	0	1	5	0	0
15	19319227	.	C	G	4	8	12	0	1	13	0	0
15	19319250	.	T	C	4	7	11	0	2	13	0	0
15	19319272	.	G	C	8	4	12	0	1	13	0	0
15	19319376	.	C	T	6	7	13	0	0	13	0	0
15	19319429	.	G	A	3	4	7	0	0	7	0	0
15	19319613	.	A	G	3	7	10	0	0	10	0	0
15	19319691	.	A	T	6	4	10	0	3	13	0	0
15	19329908	.	G	A	3	1	4	0	0	4	0	0
15	19330408	.	C	T	4	7	11	0	1	12	0	0
15	19330607	.	T	A	7	4	11	0	1	12	0	0
15	19330897	.	A	C	4	3	7	0	2	9	0	0
15	19332719	.	C	T	1	2	3	0	0	3	0	0
15	19337247	.	A	C	0	2	2	0	0	2	0	0
15	19339789	.	T	A	0	0	0	0	2	2	0	0
15	19584132	.	G	T	2	0	2	0	0	2	0	0
15	19584187	.	T	C	2	2	4	0	1	5	0	0
15	19595508	.	C	T	3	1	4	0	0	4	0	0
15	19595509	.	T	G	1	0	1	0	3	4	0	0
15	19595782	.	G	A	3	4	7	0	0	7	0	0
15	19600214	.	C	T	9	10	19	0	0	19	0	0
15	19600390	.	A	T	1	4	5	0	2	7	0	0
15	19661619	.	A	T	16	6	22	0	0	22	0	0
15	19661664	.	T	A	15	10	25	0	0	25	0	0
15	19661756	.	T	A	17	9	26	0	0	26	0	0
15	19661820	.	G	T	12	8	20	0	2	22	0	0
15	19727286	.	T	A	1	3	4	0	0	4	0	0
15	19727897	.	T	C	2	3	5	0	0	5	0	0
15	19727899	.	T	C	2	3	5	0	0	5	0	0
15	19728127	.	A	T	8	9	17	0	0	17	0	0
15	19728307	.	C	T	15	28	43	0	3	46	0	0
15	19728853	.	T	A	6	18	24	0	1	25	0	0
15	19878323	.	C	T	0	2	2	0	2	4	0	0
15	19878805	.	T	A	1	4	5	0	0	5	0	0
15	19878869	.	G	A	6	2	8	0	0	8	0	0
15	19878877	.	C	A	7	2	9	0	0	9	0	0
15	19895304	.	T	A	2	5	7	0	0	7	0	0
15	19896052	.	A	C	9	9	18	0	0	18	0	0
15	19896072	.	C	A	9	7	16	0	2	18	0	0
15	19896589	.	C	T	7	6	13	0	2	15	0	0
15	19907146	.	C	T	1	2	3	0	0	3	0	0
15	19907161	.	G	A	1	3	4	0	0	4	0	0
15	19908328	.	T	A	4	4	8	0	0	8	0	0
15	19908777	.	A	T	12	6	18	0	0	18	0	0
15	19932674	.	G	A	0	14	14	0	19	33	0	0
15	20005301	.	A	G	8	7	15	0	1	16	0	0
15	20005665	.	C	A	1	2	3	0	1	4	0	0
15	20005863	.	T	A	10	6	16	0	1	17	0	0
15	20007033	.	T	A	1	2	3	0	1	4	0	0
15	20008357	.	C	T	2	3	5	0	0	5	0	0
15	20061367	.	G	A	13	7	20	0	1	21	0	0
15	20065029	.	T	C	4	3	7	0	0	7	0	0
15	20065074	.	G	A	4	3	7	0	2	9	0	0
15	20065125	.	A	G	0	1	1	0	0	1	0	0
15	20066656	.	A	T	9	4	13	0	0	13	0	0
15	20074261	.	T	A	2	6	8	0	0	8	0	0
15	20204850	.	T	G	2	4	6	0	0	6	0	0
15	20204873	.	C	T	4	2	6	0	1	7	0	0
15	20205014	.	G	A	2	2	4	0	2	6	0	0
15	20350535	.	G	A	2	2	4	0	0	4	0	0
15	20363079	.	A	C	1	3	4	0	0	4	0	0
15	20376393	.	A	G	1	0	1	0	0	1	0	0
15	20378479	.	T	C	3	3	6	0	0	6	0	0
15	20382472	.	C	T	0	2	2	0	0	2	0	0
15	20383967	.	G	T	1	3	4	0	2	6	0	0
15	20384310	.	A	G	5	6	11	0	2	13	0	0
15	20386212	.	A	G	8	7	15	0	0	15	0	0
15	20394788	.	G	A	0	11	11	0	10	21	0	0
15	20394877	.	G	A	14	16	30	0	9	39	0	0
15	20394915	.	G	A	0	19	19	0	14	34	1	0
15	20407488	.	A	G	0	2	2	0	0	2	0	0
15	20475865	.	G	A	4	8	12	0	1	13	0	0
15	20476016	.	C	G	5	11	16	0	0	16	0	0
15	20476058	.	A	G	10	13	23	0	1	24	0	0
15	20476075	.	A	G	8	14	22	0	1	23	0	0
15	20478820	.	G	A	7	4	11	0	1	12	0	0
15	20489854	.	C	T	0	1	1	0	0	1	0	0
15	20652744	.	A	G	0	2	2	0	0	2	0	0
15	20652746	.	G	A	2	0	2	0	0	2	0	0
15	20652787	.	G	A	8	13	21	0	2	23	0	0
15	20653005	.	T	A	18	16	34	0	12	46	0	0
15	20653048	.	A	T	8	12	20	0	3	23	0	0
15	20653074	.	T	A	5	4	9	0	0	9	0	0
15	20653258	.	T	A	25	18	43	0	3	46	0	0
15	20709058	.	G	A	5	5	10	0	0	10	0	0
15	20709292	.	A	C	3	10	13	1	0	14	0	0
15	20830937	.	A	G	3	2	5	0	0	5	0	0
15	20830965	.	G	A	2	3	5	0	0	5	0	0
15	20830981	.	A	G	2	2	4	0	1	5	0	0
15	20883238	.	C	A	0	2	2	0	0	2	0	0
15	20893300	.	C	A	1	2	3	0	0	3	0	0
15	20893320	.	C	A	7	0	7	0	0	7	0	0
15	20893481	.	A	G	5	5	10	0	0	10	0	0
15	20893592	.	C	T	5	9	14	0	0	14	0	0
15	20893644	.	A	G	8	8	16	0	0	16	0	0
15	20894129	.	C	G	14	12	26	0	1	27	0	0
15	20894464	.	T	C	24	17	41	0	0	41	0	0
15	20894604	.	C	T	11	14	25	0	2	27	0	0
15	20901009	.	C	T	19	15	34	0	0	34	0	0
15	20901053	.	T	C	21	15	36	0	3	39	0	0
15	20901133	.	A	G	16	25	41	0	0	41	0	0
15	20901261	.	G	T	11	20	31	0	0	31	0	0
15	20901358	.	A	G	15	12	27	0	1	28	0	0
15	20901366	.	T	A	14	15	29	0	0	29	0	0
15	20901540	.	C	T	0	7	7	0	7	14	0	0
15	20901562	.	G	A	7	8	15	0	0	15	0	0
15	20907603	.	A	G	1	1	2	0	0	2	0	0
15	20907958	.	C	T	1	1	2	0	1	3	0	0
15	20907970	.	C	T	0	1	1	0	2	3	0	0
15	20941485	.	A	T	6	7	13	0	2	15	0	0
15	20943064	.	T	C	3	3	6	0	0	6	0	0
15	20943072	.	G	A	3	4	7	0	0	7	0	0
15	20943651	.	T	C	2	3	5	0	1	6	0	0
15	20944004	.	T	A	2	2	4	0	0	4	0	0
15	20944005	.	G	T	2	2	4	0	0	4	0	0
15	20944217	.	C	A	1	1	2	0	1	3	0	0
15	20944556	.	A	G	3	2	5	0	0	5	0	0
15	20944562	.	G	A	3	2	5	0	0	5	0	0
15	21253462	.	C	T	0	1	1	0	0	1	0	0
15	21255145	.	T	C	1	0	1	0	0	1	0	0
15	21258288	.	C	T	3	4	7	0	0	7	0	0
15	21262268	.	C	T	9	6	15	0	0	15	0	0
15	21266018	.	A	G	1	1	2	0	0	2	0	0
15	21269869	.	A	T	1	1	2	0	0	2	0	0
15	21275486	.	T	C	2	6	8	0	0	8	0	0
15	21319739	.	T	A	1	1	2	0	0	2	0	0
15	21320097	.	T	C	1	5	6	0	2	8	0	0
15	21320475	.	A	T	7	5	12	0	0	12	0	0
15	21320558	.	T	A	5	2	7	0	1	8	0	0
15	21521891	.	A	G	1	6	7	4	0	11	0	0
15	21541201	.	C	T	5	7	12	0	2	14	0	0
15	21541620	.	C	T	3	2	5	5	1	11	0	0
15	21541695	.	T	G	2	4	6	0	0	6	0	0
15	21542210	.	G	C	0	0	0	0	6	6	0	0
15	21542542	.	T	C	6	7	13	0	1	14	0	0
15	21542559	.	C	A	5	8	13	1	0	14	0	0
15	21542884	.	C	A	0	5	5	0	3	8	0	0
15	21545866	.	C	T	3	2	5	0	0	5	0	0
15	21545921	.	C	T	0	4	4	0	5	9	0	0
15	21546399	.	A	G	0	2	2	0	0	2	0	0
15	21556193	.	A	G	2	0	2	0	0	2	0	0
15	21684546	.	T	A	16	6	22	0	0	22	0	0
15	21684558	.	C	G	13	5	18	0	2	20	0	0
15	21684701	.	T	C	2	4	6	0	2	8	0	0
15	21684704	.	T	G	4	4	8	0	0	8	0	0
15	21684933	.	A	G	7	6	13	0	1	14	0	0
15	21685195	.	T	A	15	15	30	0	3	33	0	0
15	21685217	.	C	T	1	18	19	0	17	36	0	0
15	21685357	.	G	A	17	11	28	0	1	29	0	0
15	21685418	.	C	T	13	11	24	0	0	24	0	0
15	21685484	.	A	G	13	3	16	0	0	16	0	0
15	21715339	.	C	T	5	4	9	0	0	9	0	0
15	21715508	.	A	G	4	9	13	0	1	14	0	0
15	21716476	.	C	G	1	1	2	0	1	3	0	0
15	21716856	.	C	T	1	4	5	0	0	5	0	0
15	21716919	.	A	G	1	2	3	0	0	3	0	0
15	21718825	.	A	C	1	1	2	0	0	2	0	0
15	21757433	.	C	T	0	5	5	0	0	5	0	0
15	21769619	.	T	C	2	1	3	0	0	3	0	0
15	21769640	.	G	A	4	3	7	0	1	8	0	0
15	21771835	.	A	T	12	22	34	0	1	35	0	0
15	21772073	.	T	C	25	14	39	0	1	40	0	0
15	21772112	.	T	C	25	22	47	0	0	47	0	0
15	21772174	.	T	C	20	26	46	0	2	48	0	0
15	21772208	.	T	C	14	23	37	0	2	39	0	0
15	21772689	.	C	A	32	28	60	0	1	61	0	0
15	21782020	.	G	A	16	22	38	0	4	42	0	0
15	21782028	.	G	A	17	23	40	0	2	42	0	0
15	21782057	.	T	C	20	19	39	0	1	40	0	0
15	21782154	.	C	A	0	9	9	0	16	25	0	0
15	21782171	.	G	A	12	14	26	0	2	28	0	0
15	21782238	.	A	G	12	7	19	0	1	20	0	0
15	21782946	.	C	G	4	9	13	0	0	13	0	0
15	21783681	.	G	A	1	3	4	0	2	6	0	0
15	21784042	.	G	T	6	3	9	0	3	12	0	0
15	21791872	.	G	T	2	5	7	0	0	7	0	0
15	21791878	.	C	T	0	5	5	0	2	7	0	0
15	22047389	.	T	C	1	3	4	0	0	4	0	0
15	22319797	.	C	T	1	2	3	0	0	3	0	0
15	22324760	.	A	G	9	8	17	0	1	18	0	0
15	22324948	.	T	C	5	6	11	0	1	12	0	0
15	22325617	.	G	T	10	14	24	1	0	25	0	0
15	22325687	.	A	C	10	4	14	0	0	14	0	0
15	22443282	.	C	T	3	2	5	0	1	6	0	0
15	22443289	.	A	T	4	3	7	0	0	7	0	0
15	22443520	.	A	G	4	3	7	0	0	7	0	0
15	22443798	.	A	G	14	10	24	0	0	24	0	0
15	22443858	.	A	G	14	5	19	0	3	22	0	0
15	22443934	.	G	A	0	11	11	0	11	22	0	0
15	22444062	.	A	G	13	15	28	0	1	29	0	0
15	22444239	.	G	A	0	18	18	0	12	30	0	0
15	22444266	.	A	G	15	17	32	0	1	33	0	0
15	22444310	.	T	A	17	12	29	0	3	32	0	0
15	22444331	.	G	A	12	18	30	0	0	30	0	0
15	22444483	.	T	G	6	0	6	0	8	14	0	0
15	22444486	.	A	T	6	7	13	0	1	14	0	0
15	22444524	.	T	C	3	8	11	0	0	11	0	0
15	22444636	.	C	T	5	3	8	0	0	8	0	0
15	22526258	.	C	T	1	0	1	0	0	1	0	0
15	22533518	.	G	A	1	1	2	0	1	3	0	0
15	22536756	.	C	T	4	1	5	0	2	7	0	0
15	22536795	.	G	C	0	3	3	0	2	5	0	0
15	22537008	.	T	A	1	3	4	0	1	5	0	0
15	22537096	.	T	C	1	15	16	0	1	17	0	0
15	23187879	.	T	A	2	3	5	0	0	5	0	0
15	23187902	.	T	G	1	0	1	0	4	5	0	0
15	23188188	.	T	G	6	3	9	0	0	9	0	0
15	23188190	.	C	T	6	3	9	0	0	9	0	0
15	23188245	.	T	A	11	3	14	0	1	15	0	0
15	23264945	.	T	C	1	3	4	0	0	4	0	0
15	23265217	.	C	T	1	2	3	0	0	3	0	0
15	23369217	.	T	C	1	3	4	0	0	4	0	0
15	23423674	.	C	T	1	3	4	0	0	4	0	0
15	23426717	.	T	A	0	1	1	0	0	1	0	0
15	23468157	.	A	G	2	3	5	0	0	5	0	0
15	23468224	.	C	A	5	3	8	0	0	8	0	0
15	23468340	.	C	G	0	5	5	0	4	9	0	0
15	23468501	.	G	T	4	2	6	0	0	6	0	0
15	23468522	.	A	T	3	2	5	0	0	5	0	0
15	23468965	.	A	T	3	4	7	0	0	7	0	0
15	23474815	.	C	G	3	3	6	0	1	7	0	0
15	23512078	.	A	T	2	2	4	0	0	4	0	0
15	23531933	.	G	A	3	2	5	0	0	5	0	0
15	23532146	.	A	T	3	3	6	0	0	6	0	0
15	23532336	.	A	T	2	2	4	0	0	4	0	0
15	23541529	.	A	T	3	2	5	0	0	5	0	0
15	23541533	.	A	G	2	0	2	0	2	4	0	0
15	23541616	.	C	T	2	2	4	0	0	4	0	0
15	23541751	.	C	A	4	3	7	0	0	7	0	0
15	23541788	.	C	A	10	3	13	0	0	13	0	0
15	23541793	.	C	A	11	3	14	0	0	14	0	0
15	23620511	.	G	A	1	4	5	0	0	5	0	0
15	23620541	.	C	T	1	5	6	0	1	7	0	0
15	23640374	.	T	A	3	10	13	0	6	19	0	0
15	23640807	.	C	T	21	8	29	0	2	31	0	0
15	23641057	.	C	T	17	8	25	0	1	26	0	0
15	23641102	.	T	G	6	13	19	0	5	24	0	0
15	23641107	.	G	C	16	7	23	0	4	27	0	0
15	23641426	.	G	A	8	13	21	0	3	24	0	0
15	23677373	.	A	T	4	2	6	0	0	6	0	0
15	23677376	.	G	A	0	2	2	0	4	6	0	0
15	23693929	.	C	T	1	2	3	0	0	3	0	0
15	23709660	.	G	A	7	8	15	0	1	16	0	0
15	23710339	.	T	C	5	5	10	0	0	10	0	0
15	23710465	.	C	T	6	6	12	0	0	12	0	0
15	23710490	.	G	T	9	4	13	0	3	16	0	0
15	23710515	.	G	A	5	6	11	0	0	11	0	0
15	23710539	.	T	C	4	2	6	0	1	7	0	0
15	23710811	.	A	G	3	3	6	0	1	7	0	0
15	23724153	.	G	A	0	2	2	0	0	2	0	0
15	23733485	.	C	A	0	5	5	0	0	5	0	0
15	23738914	.	C	T	18	7	25	0	0	25	0	0
15	23738915	.	G	C	0	7	7	0	18	25	0	0
15	23739032	.	C	T	0	1	1	0	1	2	0	0
15	23745659	.	G	A	1	3	4	0	0	4	0	0
15	23780791	.	A	T	5	3	8	0	0	8	0	0
15	23780834	.	G	T	4	3	7	0	0	7	0	0
15	23780887	.	A	G	1	2	3	0	0	3	0	0
15	23781320	.	G	A	0	1	1	0	0	1	0	0
15	23784896	.	C	T	0	1	1	0	0	1	0	0
15	23788266	.	G	A	2	1	3	0	0	3	0	0
15	23817403	.	T	A	10	14	24	0	1	25	0	0
15	23817517	.	G	A	10	9	19	0	3	22	0	0
15	23817901	.	C	T	0	9	9	0	11	20	0	0
15	23818460	.	T	C	2	7	9	0	0	9	0	0
15	23818472	.	T	C	2	6	8	0	0	8	0	0
15	23818496	.	T	C	3	2	5	0	0	5	0	0
15	23819423	.	G	A	2	2	4	0	0	4	0	0
15	23922994	.	G	T	6	3	9	0	0	9	0	0
15	23923261	.	T	G	1	3	4	0	0	4	0	0
15	23925372	.	G	C	1	0	1	0	0	1	0	0
15	23931187	.	A	G	0	1	1	0	0	1	0	0
15	24084728	.	A	G	0	2	2	0	1	3	0	0
15	24084737	.	T	A	3	1	4	0	1	5	0	0
15	24084773	.	C	T	3	3	6	0	0	6	0	0
15	24094697	.	T	C	1	0	1	0	0	1	0	0
15	24096657	.	C	A	1	3	4	0	0	4	0	0
15	24104648	.	C	T	0	1	1	0	0	1	0	0
15	24106821	.	C	T	2	3	5	0	1	6	0	0
15	24119372	.	A	G	4	5	9	0	0	9	0	0
15	24119391	.	C	T	5	4	9	0	0	9	0	0
15	24119571	.	T	C	4	7	11	0	0	11	0	0
15	24120490	.	G	A	0	3	3	0	8	11	0	0
15	24120588	.	C	T	6	8	14	0	1	15	0	0
15	24543991	.	C	T	0	0	0	0	1	1	0	0
15	24557432	.	A	G	1	2	3	0	0	3	0	0
15	24557540	.	G	A	2	3	5	0	0	5	0	0
15	24561055	.	T	C	0	1	1	0	0	1	0	0
15	24561414	.	G	A	2	4	6	0	0	6	0	0
15	24561501	.	C	T	5	12	17	0	0	17	0	0
15	24583933	.	C	G	1	5	6	0	0	6	0	0
15	24673723	.	T	A	4	11	15	0	2	17	0	0
15	24673997	.	A	G	4	1	5	0	0	5	0	0
15	24686282	.	C	T	4	4	8	0	1	9	0	0
15	24686450	.	G	A	0	1	1	0	2	3	0	0
15	24689592	.	G	A	1	8	9	0	12	21	0	0
15	24689701	.	G	A	0	13	13	0	13	26	0	0
15	24689948	.	T	C	9	11	20	0	0	20	0	0
15	24733689	.	G	A	4	1	5	0	1	6	0	0
15	24733791	.	T	G	2	4	6	0	0	6	0	0
15	24733896	.	G	A	2	1	3	0	0	3	0	0
15	24733932	.	T	C	0	2	2	0	0	2	0	0
15	24735111	.	G	T	4	2	6	0	0	6	0	0
15	24735219	.	C	T	4	1	5	0	0	5	0	0
15	24735341	.	C	T	3	4	7	0	1	8	0	0
15	24735472	.	T	C	1	2	3	0	1	4	0	0
15	24735677	.	G	T	11	9	20	0	0	20	0	0
15	24735935	.	T	G	2	2	4	0	0	4	0	0
15	24736187	.	G	A	3	3	6	0	2	8	0	0
15	24736525	.	A	G	10	4	14	0	0	15	1	0
15	24736814	.	C	A	3	2	5	0	1	6	0	0
15	24737745	.	A	G	2	2	4	0	0	4	0	0
15	24742930	.	G	A	0	4	4	0	8	12	0	0
15	24743843	.	G	A	2	2	4	0	1	5	0	0
15	24744691	.	G	C	15	15	30	0	1	31	0	0
15	24744724	.	A	T	10	12	22	0	5	27	0	0
15	24749895	.	G	A	0	5	5	0	14	19	0	0
15	24751322	.	C	T	12	6	18	0	0	18	0	0
15	24754524	.	G	A	15	13	28	0	0	28	0	0
15	24794104	.	C	T	4	6	10	0	1	11	0	0
15	24794441	.	T	A	5	11	16	0	0	16	0	0
15	24837105	.	G	A	0	12	12	0	5	17	0	0
15	24837402	.	C	T	5	14	19	0	0	19	0	0
15	24837474	.	A	G	8	8	16	0	1	17	0	0
15	24845500	.	G	T	2	2	4	0	0	4	0	0
15	24946807	.	C	T	0	8	8	0	4	12	0	0
15	24946864	.	A	G	1	2	3	0	2	5	0	0
15	24946887	.	C	T	3	3	6	0	0	6	0	0
15	25096386	.	G	T	3	2	5	0	2	7	0	0
15	25096677	.	T	C	3	3	6	0	0	6	0	0
15	25097179	.	T	A	2	2	4	0	0	4	0	0
15	25101042	.	C	T	3	4	7	0	1	8	0	0
15	25101083	.	A	G	2	5	7	0	1	8	0	0
15	25101085	.	T	G	1	5	6	0	2	8	0	0
15	25101260	.	T	C	7	2	9	0	1	10	0	0
15	25101267	.	A	G	6	4	10	0	0	10	0	0
15	25101302	.	G	A	2	7	9	0	3	12	0	0
15	25101538	.	G	A	8	5	13	0	1	14	0	0
15	25101619	.	A	G	3	5	8	0	1	9	0	0
15	25101740	.	C	A	7	8	15	0	0	15	0	0
15	25101990	.	A	G	5	2	7	0	0	7	0	0
15	25173015	.	C	T	0	11	11	0	3	14	0	0
15	25173157	.	A	G	5	8	13	0	1	14	0	0
15	25173188	.	A	T	8	12	20	0	0	20	0	0
15	25173494	.	A	C	3	16	19	0	0	19	0	0
15	25173759	.	T	C	7	4	11	0	0	11	0	0
15	25173877	.	C	T	1	2	3	0	0	3	0	0
15	25173898	.	G	A	3	3	6	0	0	6	0	0
15	25173920	.	G	A	3	5	8	0	0	8	0	0
15	25174634	.	G	A	3	2	5	0	0	5	0	0
15	25214272	.	T	C	3	4	7	0	0	7	0	0
15	25214384	.	A	G	7	7	14	0	2	16	0	0
15	25273187	.	C	T	7	7	14	0	0	14	0	0
15	25274918	.	T	G	6	2	8	0	0	8	0	0
15	25278986	.	A	G	2	2	4	0	0	4	0	0
15	25281387	.	G	A	0	1	1	0	0	1	0	0
15	25321982	.	A	C	4	10	14	0	0	14	0	0
15	25322410	.	C	A	0	5	5	0	7	12	0	0
15	25322607	.	T	G	9	8	17	0	0	17	0	0
15	25322853	.	C	T	5	4	9	0	1	10	0	0
15	25323064	.	G	C	3	3	6	0	0	6	0	0
15	25485207	.	A	G	1	2	3	0	0	3	0	0
15	25498645	.	G	C	0	4	4	0	4	8	0	0
15	25498718	.	C	A	2	2	4	0	0	4	0	0
15	25498946	.	C	T	3	5	8	0	0	8	0	0
15	25504064	.	A	G	4	2	6	0	0	6	0	0
15	25504397	.	A	C	6	0	6	0	3	9	0	0
15	25504399	.	T	A	6	3	9	0	0	9	0	0
15	25504902	.	C	G	0	3	3	0	2	5	0	0
15	25509498	.	G	A	2	0	2	0	0	2	0	0
15	25509500	.	C	T	0	0	0	0	2	2	0	0
15	25537860	.	C	A	1	2	3	0	0	3	0	0
15	25538178	.	A	G	5	3	8	0	1	9	0	0
15	25538381	.	T	C	5	5	10	0	1	11	0	0
15	25538793	.	G	A	1	5	6	0	8	14	0	0
15	25576970	.	A	G	2	2	4	0	0	4	0	0
15	25588805	.	A	G	15	18	33	0	1	34	0	0
15	25588836	.	A	C	25	18	43	0	2	45	0	0
15	25588840	.	T	C	26	0	26	0	19	45	0	0
15	25589119	.	G	T	6	11	17	0	1	18	0	0
15	25589197	.	T	A	12	14	26	0	2	28	0	0
15	25589280	.	G	T	14	18	32	0	1	33	0	0
15	25589321	.	A	G	12	8	20	0	4	24	0	0
15	25589438	.	C	G	10	15	25	0	0	25	0	0
15	25589582	.	G	C	7	9	16	0	1	17	0	0
15	25589624	.	C	T	10	9	19	0	0	19	0	0
15	25589640	.	T	C	7	7	14	0	3	17	0	0
15	25589812	.	A	T	4	2	6	0	1	7	0	0
15	25589979	.	T	A	2	4	6	0	0	6	0	0
15	25589983	.	C	T	1	4	5	0	1	6	0	0
15	25590022	.	A	G	2	5	7	0	0	7	0	0
15	25590129	.	A	G	4	3	7	0	1	8	0	0
15	25590155	.	T	C	6	3	9	0	0	9	0	0
15	25590297	.	A	G	3	8	11	0	2	13	0	0
15	25590394	.	T	A	5	3	8	0	1	9	0	0
15	25590474	.	G	A	4	7	11	0	0	11	0	0
15	25591541	.	A	T	2	3	5	0	0	5	0	0
15	25591553	.	A	C	3	2	5	0	0	5	0	0
15	25650100	.	T	G	1	1	2	0	0	2	0	0
15	25656103	.	C	T	8	14	22	0	2	24	0	0
15	25910655	.	A	C	4	2	6	0	0	6	0	0
15	26400900	.	C	T	3	2	5	0	0	5	0	0
15	26401101	.	A	G	3	3	6	0	1	7	0	0
15	26401194	.	T	G	3	4	7	0	0	7	0	0
15	26401200	.	C	T	3	3	6	0	1	7	0	0
15	26401623	.	A	T	4	4	8	0	0	8	0	0
15	26401779	.	A	G	3	6	9	0	0	9	0	0
15	26401888	.	G	C	2	3	5	0	0	5	0	0
15	26402167	.	G	A	10	10	20	0	0	20	0	0
15	26498400	.	T	G	2	4	6	0	0	6	0	0
15	26498455	.	A	T	4	7	11	0	5	16	0	0
15	26498615	.	C	T	14	15	29	0	1	30	0	0
15	26498621	.	C	A	15	15	30	0	2	32	0	0
15	26498716	.	A	G	18	7	25	0	1	26	0	0
15	26498749	.	A	T	14	18	32	0	3	35	0	0
15	26498820	.	T	G	6	15	21	0	1	23	1	0
15	26505495	.	C	A	4	1	5	0	1	6	0	0
15	26515021	.	C	T	0	2	2	0	2	4	0	0
15	26553093	.	A	T	6	9	15	0	1	16	0	0
15	26553095	.	T	C	7	9	16	0	0	16	0	0
15	26554162	.	A	G	2	6	8	0	0	8	0	0
15	26561468	.	C	T	0	5	5	0	1	6	0	0
15	26678917	.	C	A	0	3	3	0	2	5	0	0
15	26678932	.	T	A	2	3	5	0	0	5	0	0
15	26686855	.	A	G	1	0	1	0	1	2	0	0
15	26686864	.	G	A	1	0	1	0	1	2	0	0
15	26849054	.	T	A	2	6	8	0	0	8	0	0
15	26849351	.	A	G	2	2	4	0	0	4	0	0
15	26904430	.	A	G	9	6	15	0	1	16	0	0
15	26904838	.	A	G	1	3	4	0	0	4	0	0
15	26905118	.	T	G	2	3	5	0	0	5	0	0
15	26915384	.	T	A	3	2	5	0	0	5	0	0
15	26915531	.	A	G	2	5	7	0	0	7	0	0
15	26919255	.	T	C	0	2	2	0	0	2	0	0
15	26924056	.	T	C	1	3	4	0	2	6	0	0
15	26926653	.	A	C	1	0	1	0	0	1	0	0
15	26938324	.	A	C	3	2	5	0	1	6	0	0
15	26939031	.	C	A	6	8	14	0	0	14	0	0
15	26939224	.	G	T	7	3	10	0	0	10	0	0
15	26939233	.	A	C	4	9	13	0	0	13	0	0
15	26939279	.	G	A	0	11	11	0	7	18	0	0
15	27352608	.	G	A	1	2	3	0	1	4	0	0
15	27353222	.	T	C	1	2	3	0	1	4	0	0
15	27353481	.	G	A	4	5	9	0	0	9	0	0
15	27353611	.	C	A	1	2	3	0	0	3	0	0
15	27354412	.	T	A	22	9	31	0	2	33	0	0
15	27703845	.	A	G	15	9	24	0	1	25	0	0
15	27704220	.	C	A	0	10	10	0	12	22	0	0
15	28124642	.	C	T	0	1	1	0	0	1	0	0
15	28124913	.	T	C	1	0	1	0	0	1	0	0
15	28125146	.	A	G	1	0	1	0	3	4	0	0
15	28125186	.	A	G	1	3	4	0	0	4	0	0
15	28189029	.	T	A	2	5	7	0	1	8	0	0
15	28189046	.	T	G	2	6	8	0	0	8	0	0
15	28189409	.	A	C	3	1	4	0	0	4	0	0
15	28189589	.	T	C	1	0	1	0	4	5	0	0
15	28189591	.	T	C	1	3	4	0	1	5	0	0
15	28189945	.	T	G	2	1	3	0	0	3	0	0
15	28192706	.	A	G	5	1	6	0	1	7	0	0
15	28249301	.	G	T	2	3	5	0	0	5	0	0
15	28251094	.	T	A	0	1	1	0	0	1	0	0
15	28252597	.	T	C	4	3	7	0	0	7	0	0
15	28252599	.	A	G	4	3	7	0	0	7	0	0
15	28253171	.	C	A	0	2	2	0	1	3	0	0
15	28254202	.	G	T	0	1	1	0	0	1	0	0
15	28352138	.	T	C	12	4	16	0	0	16	0	0
15	28352168	.	C	A	10	7	17	0	0	17	0	0
15	28432697	.	C	A	4	19	23	0	1	24	0	0
15	28432739	.	C	T	9	8	17	0	1	18	0	0
15	28432741	.	A	T	9	9	18	0	0	18	0	0
15	28432871	.	T	C	5	5	10	0	1	11	0	0
15	28432993	.	C	T	0	6	6	0	9	15	0	0
15	28433073	.	A	G	3	6	9	0	0	9	0	0
15	28433102	.	C	A	2	6	8	0	2	10	0	0
15	28433126	.	G	T	3	5	8	0	0	8	0	0
15	28433161	.	T	C	3	3	6	0	0	6	0	0
15	28433282	.	G	A	7	5	12	0	1	13	0	0
15	28433947	.	A	G	5	4	9	0	1	10	0	0
15	28437178	.	G	T	0	1	1	0	0	1	0	0
15	28453081	.	C	A	0	1	1	0	0	1	0	0
15	28538199	.	T	C	1	3	4	0	0	4	0	0
15	28538239	.	G	T	1	2	3	0	0	3	0	0
15	28538405	.	T	C	2	2	4	0	0	4	0	0
15	28538761	.	A	G	3	3	6	0	0	6	0	0
15	28538765	.	C	T	3	3	6	0	0	6	0	0
15	28539523	.	T	C	4	5	9	0	0	9	0	0
15	28539556	.	G	A	4	5	9	0	0	9	0	0
15	28549003	.	G	A	8	3	11	0	0	11	0	0
15	28549347	.	G	T	3	4	7	0	1	8	0	0
15	28549348	.	T	A	4	3	7	0	1	8	0	0
15	28549392	.	A	C	5	4	9	0	0	9	0	0
15	28549665	.	T	C	2	0	2	0	6	8	0	0
15	28634719	.	G	A	12	12	24	0	1	25	0	0
15	28646687	.	G	A	1	0	1	0	0	1	0	0
15	28646696	.	T	C	1	0	1	0	1	2	0	0
15	28686433	.	A	T	1	2	3	0	1	4	0	0
15	28758907	.	G	C	0	2	2	0	1	3	0	0
15	28758920	.	T	C	1	1	2	0	0	2	0	0
15	28759246	.	G	C	0	2	2	0	2	4	0	0
15	28762440	.	C	T	6	8	14	0	1	15	0	0
15	28763124	.	T	C	13	9	22	0	2	24	0	0
15	28763134	.	T	C	13	6	19	0	0	19	0	0
15	28763677	.	C	A	2	3	5	0	0	5	0	0
15	28763770	.	T	C	5	6	11	0	1	12	0	0
15	28763927	.	G	A	0	7	7	0	11	18	0	0
15	28763986	.	G	A	0	4	4	0	11	15	0	0
15	28764206	.	G	T	0	5	5	0	5	10	0	0
15	28764252	.	A	G	7	0	7	0	13	20	0	0
15	28766069	.	A	G	2	5	7	0	0	7	0	0
15	28881717	.	G	A	3	5	8	0	0	8	0	0
15	28882675	.	T	A	5	7	12	0	0	12	0	0
15	28882687	.	A	G	4	5	9	0	0	9	0	0
15	29001556	.	C	T	3	2	5	0	0	5	0	0
15	29001583	.	T	C	3	1	4	0	1	5	0	0
15	29005346	.	T	A	1	5	6	0	0	6	0	0
15	29005869	.	A	T	6	3	9	0	1	10	0	0
15	29005935	.	C	T	6	3	9	0	0	9	0	0
15	29006097	.	C	T	3	5	8	0	1	9	0	0
15	29089143	.	T	A	6	7	13	0	3	16	0	0
15	29089279	.	C	A	10	11	21	0	0	22	1	0
15	29089317	.	A	G	9	11	20	0	1	21	0	0
15	29089392	.	A	G	7	9	16	0	3	19	0	0
15	29089524	.	T	C	12	14	26	0	5	31	0	0
15	29089788	.	G	A	19	10	29	0	2	31	0	0
15	29089827	.	G	T	0	18	18	0	22	40	0	0
15	29089870	.	C	T	23	22	45	0	2	47	0	0
15	29090181	.	A	G	21	23	44	0	9	53	0	0
15	29091565	.	G	A	26	18	44	0	5	49	0	0
15	29092871	.	C	T	5	7	12	0	0	12	0	0
15	29093073	.	C	A	6	2	8	0	0	8	0	0
15	29097640	.	A	G	10	2	12	0	0	12	0	0
15	29100623	.	G	A	1	0	1	0	1	2	0	0
15	29104050	.	G	A	1	1	2	0	0	2	0	0
15	29116264	.	A	G	1	1	2	0	0	2	0	0
15	29119813	.	A	C	2	0	2	0	1	3	0	0
15	29119829	.	A	C	2	1	3	0	0	3	0	0
15	29122072	.	T	A	7	4	11	0	0	11	0	0
15	29122825	.	T	A	1	0	1	0	2	3	0	0
15	29122827	.	C	A	0	2	2	0	1	3	0	0
15	29152041	.	G	T	7	3	10	0	0	10	0	0
15	29383764	.	T	A	2	2	4	0	1	5	0	0
15	29465874	.	T	C	0	2	2	0	0	2	0	0
15	29469851	.	G	T	0	1	1	0	0	1	0	0
15	29481884	.	A	G	6	4	10	0	0	10	0	0
15	29481921	.	G	A	0	4	4	0	6	10	0	0
15	29482286	.	G	C	5	4	9	0	0	9	0	0
15	29483326	.	G	A	0	3	3	0	2	5	0	0
15	29483434	.	G	C	6	6	12	0	0	12	0	0
15	29483608	.	A	T	4	6	10	0	0	10	0	0
15	29483851	.	G	T	13	13	26	0	2	28	0	0
15	29712210	.	G	A	0	2	2	0	5	7	0	0
15	29772299	.	T	A	5	4	9	0	1	10	0	0
15	30134489	.	G	A	4	3	7	0	0	7	0	0
15	30135206	.	G	A	0	2	2	0	2	4	0	0
15	30136445	.	G	A	2	2	4	0	1	5	0	0
15	30136472	.	A	G	4	2	6	0	0	6	0	0
15	30136512	.	T	A	0	2	2	0	1	3	0	0
15	30136962	.	A	G	6	0	6	0	12	18	0	0
15	30137561	.	C	T	19	17	36	0	2	38	0	0
15	30252414	.	T	C	1	0	1	0	0	1	0	0
15	30265017	.	C	T	1	1	2	0	0	2	0	0
15	30311016	.	C	T	3	2	5	0	0	5	0	0
15	30311062	.	G	T	1	2	3	0	5	8	0	0
15	30311616	.	T	G	1	4	5	0	0	5	0	0
15	30354513	.	G	T	6	6	12	0	1	13	0	0
15	30354603	.	A	T	7	5	12	0	0	12	0	0
15	30838455	.	C	G	11	4	15	0	1	16	0	0
15	30838498	.	G	A	0	15	15	0	1	16	0	0
15	30838777	.	G	A	16	15	31	0	0	31	0	0
15	30838867	.	C	T	15	12	27	0	1	28	0	0
15	30839168	.	A	T	4	7	11	0	0	11	0	0
15	30839485	.	C	A	4	2	6	0	0	6	0	0
15	30839487	.	T	A	4	2	6	0	0	6	0	0
15	30861987	.	C	A	0	6	6	0	5	11	0	0
15	30862251	.	A	T	3	7	10	0	1	11	0	0
15	30862449	.	A	G	7	3	10	0	2	12	0	0
15	30862452	.	G	T	6	5	11	0	0	11	0	0
15	30862712	.	G	A	6	5	11	0	0	11	0	0
15	30862997	.	T	G	3	2	5	0	0	5	0	0
15	30863059	.	T	C	1	1	2	0	3	5	0	0
15	30863242	.	T	C	3	2	5	0	1	6	0	0
15	30863354	.	C	T	1	4	5	0	0	5	0	0
15	30863535	.	G	T	4	4	8	0	1	9	0	0
15	30863569	.	G	A	6	5	11	0	0	11	0	0
15	30909308	.	G	A	0	2	2	0	3	5	0	0
15	30909572	.	C	A	4	8	12	0	2	14	0	0
15	30909639	.	A	G	5	3	8	0	0	8	0	0
15	30909771	.	T	C	0	6	6	0	3	9	0	0
15	30909798	.	A	G	1	0	1	0	7	8	0	0
15	30909824	.	A	C	1	6	7	0	0	7	0	0
15	30909884	.	C	T	3	3	6	0	0	6	0	0
15	30909931	.	T	C	5	2	7	0	1	8	0	0
15	30919478	.	C	T	2	2	4	0	0	4	0	0
15	30919676	.	G	T	1	2	3	0	0	3	0	0
15	30920135	.	A	G	1	2	3	0	0	3	0	0
15	30920698	.	C	A	9	10	19	0	3	22	0	0
15	30920780	.	T	C	6	5	11	0	1	12	0	0
15	30920795	.	A	G	7	5	12	0	1	13	0	0
15	31162074	.	T	A	17	16	33	0	4	37	0	0
15	31162122	.	A	G	20	14	34	0	2	36	0	0
15	31162186	.	G	C	18	22	40	0	2	42	0	0
15	31162795	.	G	A	14	7	21	0	1	22	0	0
15	31162836	.	A	G	16	7	23	0	2	25	0	0
15	31163089	.	G	A	2	7	9	0	1	10	0	0
15	31163335	.	A	T	12	8	20	0	0	20	0	0
15	31163621	.	T	A	13	12	25	0	1	26	0	0
15	31166755	.	C	A	3	2	5	0	0	5	0	0
15	31203002	.	A	G	0	2	2	0	0	2	0	0
15	31513561	.	G	A	27	25	52	0	3	55	0	0
15	31513842	.	A	G	30	17	47	0	1	48	0	0
15	31513848	.	T	C	29	14	43	0	1	44	0	0
15	31513893	.	C	A	0	2	2	0	4	6	0	0
15	31514325	.	A	G	12	11	23	0	1	24	0	0
15	31706200	.	G	C	0	1	1	0	0	1	0	0
15	31732502	.	A	G	3	8	11	0	0	11	0	0
15	31905040	.	G	A	3	9	12	0	0	12	0	0
15	31909454	.	A	C	12	10	22	0	1	23	0	0
15	32196093	.	G	A	0	3	3	0	2	5	0	0
15	32196731	.	A	C	4	2	6	0	0	6	0	0
15	32197458	.	T	C	2	2	4	0	0	4	0	0
15	32249188	.	G	A	6	4	10	0	0	10	0	0
15	32261461	.	G	C	0	5	5	0	3	8	0	0
15	32261464	.	T	C	5	2	7	0	2	9	0	0
15	32265889	.	T	C	6	6	12	0	0	12	0	0
15	32266557	.	A	T	12	6	18	0	1	19	0	0
15	32266921	.	G	A	0	14	14	0	20	34	0	0
15	32267078	.	A	G	12	9	21	0	0	21	0	0
15	32267120	.	C	A	4	5	9	0	0	9	0	0
15	32349980	.	A	G	0	3	3	0	0	3	0	0
15	32353825	.	C	A	3	2	5	0	0	5	0	0
15	32887858	.	A	G	2	2	4	0	0	4	0	0
15	33864266	.	G	A	8	6	14	0	2	16	0	0
15	33864585	.	G	A	6	4	10	0	1	11	0	0
15	33891869	.	G	T	4	3	7	0	0	7	0	0
15	33891979	.	T	C	5	2	7	0	0	7	0	0
15	33896117	.	G	T	2	3	5	0	1	6	0	0
15	33896177	.	T	C	3	3	6	0	0	6	0	0
15	33970854	.	C	T	10	5	15	0	0	15	0	0
15	33970907	.	C	T	2	2	4	0	1	5	0	0
15	33971097	.	G	C	7	10	17	0	0	17	0	0
15	33977716	.	A	T	11	12	23	0	2	25	0	0
15	33977942	.	A	C	6	3	9	0	0	9	0	0
15	33978526	.	A	T	1	1	2	0	1	3	0	0
15	34173746	.	T	A	3	10	13	0	0	13	0	0
15	34174532	.	T	A	9	9	18	0	0	18	0	0
15	34174568	.	T	A	5	8	13	0	0	13	0	0
15	34174635	.	T	C	5	4	9	0	0	9	0	0
15	34175101	.	T	C	21	14	35	0	1	36	0	0
15	34175359	.	G	A	2	5	7	0	0	7	0	0
15	34175426	.	T	A	6	10	16	0	1	17	0	0
15	34175718	.	G	A	1	2	3	0	0	3	0	0
15	34175917	.	C	T	3	6	9	0	1	10	0	0
15	34175929	.	C	T	6	7	13	0	1	14	0	0
15	34176203	.	A	T	8	7	15	0	3	18	0	0
15	34176214	.	C	T	6	8	14	0	0	14	0	0
15	34176379	.	A	C	4	5	9	0	1	10	0	0
15	34176993	.	G	A	1	2	3	0	1	4	0	0
15	34215835	.	A	T	1	1	2	0	0	2	0	0
15	34334909	.	A	T	1	1	2	0	1	3	0	0
15	34335272	.	C	T	1	1	2	0	0	2	0	0
15	34534245	.	C	G	2	0	2	0	0	2	0	0
15	34534265	.	C	T	0	1	1	0	0	1	0	0
15	34573337	.	C	T	5	4	9	0	1	10	0	0
15	34573343	.	A	G	6	6	12	0	0	12	0	0
15	34573597	.	A	T	5	6	11	0	0	11	0	0
15	34573664	.	G	T	2	5	7	0	1	8	0	0
15	34573952	.	T	A	2	3	5	0	0	5	0	0
15	34573959	.	A	T	2	3	5	0	0	5	0	0
15	34574116	.	G	A	8	4	12	0	1	13	0	0
15	34586304	.	A	G	0	1	1	0	0	1	0	0
15	34618456	.	T	G	10	6	16	0	1	17	0	0
15	34618669	.	A	T	22	13	35	0	2	37	0	0
15	34618906	.	C	A	13	13	26	0	0	26	0	0
15	34618948	.	T	G	11	9	20	0	1	21	0	0
15	34618958	.	G	A	14	8	22	0	0	22	0	0
15	34621868	.	G	A	2	10	12	0	0	12	0	0
15	34621875	.	G	A	10	2	12	0	1	13	0	0
15	34627792	.	T	A	1	1	2	0	0	2	0	0
15	34627874	.	T	C	0	3	3	0	0	3	0	0
15	35103129	.	T	C	3	3	6	0	0	6	0	0
15	35103145	.	T	C	2	4	6	0	0	6	0	0
15	35156554	.	T	G	2	2	4	0	0	4	0	0
15	35156573	.	A	T	2	2	4	0	0	4	0	0
15	35157052	.	T	A	3	4	7	0	0	7	0	0
15	35157054	.	G	A	3	4	7	0	0	7	0	0
15	35158661	.	T	G	1	2	3	0	1	4	0	0
15	35214784	.	T	A	11	7	18	0	1	19	0	0
15	35214901	.	G	A	10	11	21	0	1	22	0	0
15	35217475	.	T	C	5	4	9	0	0	9	0	0
15	35217487	.	C	A	0	5	5	0	6	11	0	0
15	35224269	.	G	C	0	3	3	0	0	3	0	0
15	35227221	.	A	T	8	2	10	0	4	14	0	0
15	35247678	.	A	T	3	6	9	0	1	10	0	0
15	35247687	.	A	G	2	10	12	0	1	13	0	0
15	35247729	.	A	G	2	7	9	0	2	11	0	0
15	35247762	.	T	C	3	6	9	0	0	9	0	0
15	35761516	.	T	C	3	2	5	0	0	5	0	0
15	35889443	.	G	T	1	1	2	0	0	2	0	0
15	35889474	.	G	A	1	3	4	0	0	4	0	0
15	35890046	.	G	A	4	3	7	0	0	7	0	0
15	35941400	.	A	G	3	1	4	0	0	4	0	0
15	35941410	.	T	C	3	2	5	0	0	5	0	0
15	37227033	.	T	G	14	11	25	0	0	25	0	0
15	37227059	.	A	G	10	0	10	0	20	30	0	0
15	37227509	.	A	G	9	0	9	0	15	24	0	0
15	37227714	.	A	G	18	0	18	0	18	36	0	0
15	37227770	.	G	A	15	10	25	0	2	29	2	0
15	37228164	.	A	G	12	21	33	0	1	34	0	0
15	37228236	.	C	T	11	18	29	0	1	30	0	0
15	37228266	.	T	C	14	17	31	0	0	31	0	0
15	37228301	.	T	A	12	14	26	0	0	26	0	0
15	37228338	.	T	A	10	6	16	0	2	18	0	0
15	37228620	.	G	C	22	30	52	0	3	55	0	0
15	37228626	.	G	A	23	27	50	0	3	54	1	0
15	37228665	.	C	G	16	27	43	0	2	45	0	0
15	37228843	.	T	A	30	18	48	1	0	49	0	0
15	37228845	.	T	G	30	17	47	1	1	49	0	0
15	37229346	.	T	G	33	18	51	0	3	54	0	0
15	37229871	.	A	T	25	40	65	0	4	70	1	0
15	37229991	.	C	A	28	35	63	0	2	65	0	0
15	37230038	.	G	A	26	36	62	0	2	64	0	0
15	37230100	.	G	A	27	41	68	0	3	71	0	0
15	38296467	.	A	G	4	2	6	0	1	7	0	0
15	39278501	.	G	T	6	4	10	0	0	11	1	0
15	39281923	.	A	G	10	4	14	0	1	15	0	0
15	39282070	.	A	G	3	5	8	0	0	8	0	0
15	39282091	.	G	A	0	1	1	0	0	1	0	0
15	39294391	.	C	T	4	5	9	0	1	10	0	0
15	39296706	.	A	G	4	2	6	0	1	7	0	0
15	39297081	.	A	G	1	3	4	0	0	4	0	0
15	39299622	.	A	G	2	3	5	0	1	6	0	0
15	39967275	.	G	A	15	12	27	0	2	29	0	0
15	39969923	.	T	G	21	9	30	0	1	31	0	0
15	40005318	.	T	A	0	3	3	0	1	4	0	0
15	40005466	.	C	T	6	15	21	0	0	21	0	0
15	40005545	.	T	C	8	7	15	0	0	16	1	0
15	40006090	.	A	C	10	15	25	0	0	26	1	0
15	40017054	.	C	T	3	2	5	0	0	5	0	0
15	40018239	.	G	A	0	1	1	0	4	5	0	0
15	40018290	.	C	T	2	1	3	0	0	3	0	0
15	40027138	.	C	T	16	23	39	0	5	44	0	0
15	40027279	.	T	C	25	25	50	0	3	53	0	0
15	40027484	.	T	G	19	0	19	0	26	45	0	0
15	40027540	.	A	C	17	21	38	0	6	44	0	0
15	40027717	.	A	G	23	13	36	0	2	38	0	0
15	40028280	.	A	G	38	11	49	0	4	54	1	0
15	40028457	.	T	G	27	26	53	0	6	59	0	0
15	40028568	.	G	A	25	23	48	0	2	50	0	0
15	40028574	.	A	G	21	22	43	0	11	54	0	0
15	40099844	.	T	C	0	3	3	0	0	3	0	0
15	40115676	.	C	T	0	1	1	0	1	2	0	0
15	40122221	.	A	G	0	2	2	0	1	3	0	0
15	40122625	.	G	A	1	0	1	0	2	3	0	0
15	40126698	.	A	G	4	0	4	0	4	8	0	0
15	40128979	.	C	G	1	6	7	0	0	7	0	0
15	40129543	.	G	C	5	5	10	0	1	11	0	0
15	40129594	.	T	G	3	14	17	0	2	19	0	0
15	40129604	.	A	T	6	15	21	0	0	21	0	0
15	40129810	.	A	C	8	4	12	0	1	13	0	0
15	40130181	.	G	A	1	5	6	0	3	9	0	0
15	40130208	.	G	A	3	3	6	0	1	7	0	0
15	40130548	.	A	G	1	7	8	0	0	8	0	0
15	40130563	.	A	G	6	0	6	0	4	10	0	0
15	40130630	.	A	G	1	4	5	0	1	6	0	0
15	40130631	.	A	G	2	3	5	0	1	6	0	0
15	40130717	.	A	G	6	9	15	0	1	16	0	0
15	40130719	.	G	T	7	9	16	0	0	16	0	0
15	40130759	.	A	G	1	10	11	0	2	13	0	0
15	40131001	.	G	A	0	4	4	0	4	8	0	0
15	40131060	.	A	G	2	6	8	0	1	9	0	0
15	40131112	.	C	A	8	10	18	0	0	18	0	0
15	40131139	.	T	A	12	12	24	0	1	25	0	0
15	40131157	.	A	G	7	14	21	0	3	24	0	0
15	40131216	.	G	A	10	4	14	0	2	16	0	0
15	40131232	.	C	T	8	2	10	0	1	11	0	0
15	40131276	.	C	G	10	8	18	0	1	19	0	0
15	40131297	.	C	G	14	9	23	0	0	23	0	0
15	40131316	.	C	A	16	12	28	0	0	28	0	0
15	40131363	.	G	T	0	15	15	0	17	32	0	0
15	40131498	.	A	G	17	0	17	0	28	45	0	0
15	40131500	.	A	G	17	26	43	0	2	45	0	0
15	40131547	.	T	C	19	24	43	0	2	45	0	0
15	40131560	.	T	A	20	23	43	0	1	44	0	0
15	40131586	.	C	T	20	24	44	0	2	46	0	0
15	40131619	.	T	C	17	30	47	0	3	50	0	0
15	40131624	.	T	A	17	31	48	0	2	50	0	0
15	40131769	.	T	C	12	13	25	0	3	28	0	0
15	40202354	.	T	G	10	9	19	0	1	21	1	0
15	40202393	.	C	T	7	1	8	0	0	8	0	0
15	40211507	.	T	C	2	3	5	0	1	6	0	0
15	40211591	.	A	C	17	17	34	0	4	38	0	0
15	40211618	.	A	G	15	1	16	0	19	35	0	0
15	40211741	.	C	G	24	17	41	0	1	42	0	0
15	40211954	.	G	T	12	9	21	0	0	21	0	0
15	40989690	.	A	G	0	3	3	0	1	4	0	0
15	41170289	.	A	G	15	24	39	0	0	39	0	0
15	41170445	.	G	T	20	16	36	0	0	36	0	0
15	41170710	.	G	A	14	15	29	0	1	30	0	0
15	41170992	.	G	A	12	11	23	0	1	24	0	0
15	41171135	.	A	G	7	13	20	0	1	21	0	0
15	41171335	.	A	T	2	7	9	0	0	9	0	0
15	41171448	.	A	C	11	17	28	0	1	29	0	0
15	41171471	.	G	T	12	16	28	0	0	28	0	0
15	41171516	.	C	A	0	11	11	0	15	26	0	0
15	41172893	.	A	C	4	4	8	0	0	8	0	0
15	41172904	.	G	C	4	5	9	0	0	9	0	0
15	41173093	.	A	T	5	6	11	0	0	11	0	0
15	41173109	.	C	T	5	4	9	0	1	10	0	0
15	41173142	.	G	A	1	4	5	0	0	5	0	0
15	41173261	.	T	G	3	3	6	0	0	6	0	0
15	41173326	.	C	T	7	3	10	0	1	11	0	0
15	41173620	.	G	A	1	1	2	0	0	2	0	0
15	41291817	.	C	T	1	2	3	0	1	4	0	0
15	42981069	.	C	T	2	4	6	0	0	6	0	0
15	42981137	.	C	A	7	3	10	0	0	10	0	0
15	42981223	.	A	G	2	2	4	0	0	4	0	0
15	42981281	.	A	T	2	3	5	0	0	5	0	0
15	43604150	.	G	C	1	2	3	0	0	3	0	0
15	43604903	.	C	G	3	2	5	0	1	6	0	0
15	43604928	.	A	G	2	2	4	0	0	4	0	0
15	43934780	.	T	C	0	1	1	0	0	1	0	0
15	43938527	.	C	T	0	2	2	0	0	2	0	0
15	43938539	.	C	G	0	2	2	0	0	2	0	0
15	44140991	.	T	C	1	2	3	0	0	3	0	0
15	44141518	.	T	C	0	2	2	0	0	2	0	0
15	44141644	.	A	C	2	3	5	0	0	5	0	0
15	44255212	.	A	C	4	3	7	0	0	7	0	0
15	44255467	.	C	T	3	7	10	0	0	10	0	0
15	44255473	.	T	C	3	7	10	0	0	10	0	0
15	44255503	.	A	T	5	2	7	0	1	8	0	0
15	44295044	.	G	A	2	2	4	0	0	4	0	0
15	44336923	.	A	T	4	2	6	0	1	7	0	0
15	44440314	.	G	T	1	2	3	0	0	3	0	0
15	44440352	.	G	A	2	0	2	0	0	2	0	0
15	44445243	.	C	T	9	4	13	0	0	13	0	0
15	44499653	.	T	A	27	14	41	0	5	46	0	0
15	44559749	.	A	G	1	2	3	0	0	3	0	0
15	44646664	.	G	A	5	3	8	0	0	8	0	0
15	44676968	.	G	A	1	1	2	0	0	2	0	0
15	45555208	.	A	T	2	2	4	0	0	4	0	0
15	45595456	.	A	T	0	1	1	0	0	1	0	0
15	45617160	.	A	T	1	4	5	0	0	5	0	0
15	45634793	.	G	A	4	5	9	0	1	10	0	0
15	45635375	.	A	G	3	2	5	0	0	5	0	0
15	45635952	.	T	C	4	2	6	0	0	6	0	0
15	45635999	.	G	A	4	5	9	0	0	9	0	0
15	45636504	.	G	T	3	2	5	0	0	5	0	0
15	45637224	.	A	G	21	22	43	0	4	47	0	0
15	45637406	.	C	T	6	3	9	0	0	9	0	0
15	46643768	.	T	C	9	9	18	0	3	21	0	0
15	46649525	.	A	G	1	12	13	0	0	13	0	0
15	46652124	.	A	G	4	9	13	0	0	13	0	0
15	46662143	.	C	T	6	5	11	0	1	12	0	0
15	46662353	.	T	C	6	9	15	0	2	17	0	0
15	46722863	.	G	A	3	8	11	0	1	12	0	0
15	46722881	.	A	T	1	5	6	0	0	6	0	0
15	46726371	.	T	C	2	3	5	0	0	5	0	0
15	46727382	.	G	A	0	1	1	0	0	1	0	0
15	46727571	.	G	A	1	2	3	0	0	3	0	0
15	47336295	.	G	A	9	8	17	0	1	18	0	0
15	47410231	.	C	A	1	0	1	0	0	1	0	0
15	47418627	.	G	A	2	1	3	0	0	3	0	0
15	47419090	.	G	A	0	4	4	0	6	10	0	0
15	47419096	.	C	T	3	5	8	0	3	11	0	0
15	47419240	.	C	T	8	9	17	0	2	19	0	0
15	47419394	.	C	T	3	9	12	0	0	12	0	0
15	47419395	.	A	T	3	9	12	0	0	12	0	0
15	47420838	.	T	A	22	16	38	0	1	39	0	0
15	47421203	.	T	C	14	10	24	0	1	25	0	0
15	47421329	.	A	G	9	7	16	0	0	16	0	0
15	47421669	.	C	T	10	13	23	0	3	26	0	0
15	47421675	.	G	C	11	11	22	0	2	24	0	0
15	47452875	.	G	A	3	3	6	0	1	7	0	0
15	47452895	.	C	A	3	2	5	0	0	5	0	0
15	47830665	.	C	T	4	4	8	0	1	9	0	0
15	47830783	.	C	T	5	2	7	0	2	9	0	0
15	47830837	.	G	T	2	3	5	0	1	6	0	0
15	47830973	.	C	A	6	9	15	0	0	15	0	0
15	47831096	.	C	T	5	10	15	0	1	16	0	0
15	47831195	.	G	C	11	5	16	0	1	17	0	0
15	47831249	.	C	T	5	5	10	0	0	10	0	0
15	47831265	.	T	A	3	4	7	0	1	8	0	0
15	47831495	.	C	G	5	6	11	0	1	12	0	0
15	47831511	.	C	T	0	7	7	0	6	13	0	0
15	47831565	.	C	A	14	5	19	0	0	19	0	0
15	47831731	.	T	G	3	4	7	0	0	7	0	0
15	47831765	.	G	A	0	3	3	0	1	4	0	0
15	47832424	.	T	G	1	5	6	0	0	6	0	0
15	47832930	.	C	T	2	2	4	0	0	4	0	0
15	47832931	.	C	T	0	2	2	0	2	4	0	0
15	47833126	.	C	A	0	2	2	0	0	2	0	0
15	47833128	.	G	T	0	2	2	0	0	2	0	0
15	47845908	.	A	G	2	0	2	0	0	2	0	0
15	47847373	.	G	A	2	2	4	0	1	5	0	0
15	47848495	.	C	T	18	16	34	0	3	37	0	0
15	47851205	.	T	A	29	24	53	0	0	53	0	0
15	47851342	.	C	G	40	13	53	1	3	57	0	0
15	47851455	.	T	G	24	36	60	0	1	61	0	0
15	47851486	.	G	A	19	34	53	0	2	55	0	0
15	47851522	.	C	T	0	26	26	0	30	56	0	0
15	47851751	.	A	G	27	14	41	0	1	42	0	0
15	47851828	.	G	A	16	12	28	0	4	32	0	0
15	47851978	.	C	T	4	2	6	0	0	6	0	0
15	47851979	.	A	G	4	1	5	0	1	6	0	0
15	47855085	.	A	G	6	13	19	1	1	21	0	0
15	47855169	.	G	A	9	3	12	1	0	13	0	0
15	47856418	.	T	C	4	2	6	0	0	6	0	0
15	47860443	.	C	T	0	24	24	0	18	42	0	0
16	51458	.	C	T	0	2	2	0	1	3	0	0
16	68254	.	A	G	1	2	3	0	1	4	0	0
16	68355	.	T	C	2	2	4	0	0	4	0	0
16	68356	.	C	T	2	2	4	0	0	4	0	0
16	68477	.	G	A	0	2	2	0	3	5	0	0
16	68513	.	G	C	0	3	3	0	5	8	0	0
16	68812	.	A	G	1	3	4	0	0	4	0	0
16	68854	.	T	C	3	4	7	0	0	7	0	0
16	69005	.	T	A	8	5	13	0	3	16	0	0
16	70697	.	T	C	15	9	24	0	3	27	0	0
16	70881	.	A	G	16	7	23	0	3	26	0	0
16	221747	.	G	A	0	2	2	0	0	2	0	0
16	224707	.	A	G	12	5	17	0	3	20	0	0
16	224734	.	C	G	14	9	23	0	1	24	0	0
16	224743	.	C	A	13	9	22	0	0	22	0	0
16	224837	.	A	C	15	8	23	0	1	24	0	0
16	224886	.	G	A	0	14	14	0	21	35	0	0
16	224974	.	A	T	16	9	25	0	0	25	0	0
16	225005	.	T	C	13	17	30	0	1	31	0	0
16	225304	.	C	A	20	12	32	0	5	37	0	0
16	225564	.	T	C	19	15	34	0	3	37	0	0
16	225615	.	A	G	24	19	43	0	1	44	0	0
16	225660	.	C	G	22	22	44	0	3	47	0	0
16	226192	.	A	C	20	16	36	0	0	36	0	0
16	226361	.	C	G	22	31	53	0	5	59	1	0
16	226374	.	T	A	20	36	56	0	2	58	0	0
16	226526	.	A	G	10	20	30	0	3	33	0	0
16	227590	.	A	T	3	4	7	0	0	7	0	0
16	250422	.	T	A	1	2	3	0	0	3	0	0
16	559050	.	T	A	4	7	11	0	4	15	0	0
16	560755	.	G	A	1	4	5	0	1	6	0	0
16	2102683	.	C	T	1	2	3	0	2	5	0	0
16	2103167	.	C	T	3	2	5	0	0	5	0	0
16	2103209	.	C	T	5	3	8	0	0	8	0	0
16	2103241	.	T	A	3	3	6	0	1	7	0	0
16	2103268	.	A	T	5	3	8	0	0	8	0	0
16	2103307	.	T	C	10	7	17	0	0	17	0	0
16	2104181	.	T	A	1	2	3	0	0	3	0	0
16	2104312	.	A	C	8	5	13	0	1	14	0	0
16	2104400	.	T	C	15	9	24	0	1	25	0	0
16	2104597	.	T	C	28	22	50	0	3	53	0	0
16	2104604	.	A	G	28	0	28	0	26	54	0	0
16	2105035	.	A	G	5	7	12	0	0	12	0	0
16	2353020	.	C	A	3	5	8	0	1	9	0	0
16	2353023	.	T	C	3	4	7	0	0	7	0	0
16	2365716	.	G	A	1	1	2	0	0	2	0	0
16	2484064	.	C	T	0	2	2	0	2	4	0	0
16	2568847	.	G	A	0	4	4	0	5	9	0	0
16	2574963	.	C	T	0	1	1	0	0	1	0	0
16	2577717	.	T	A	1	0	1	0	0	1	0	0
16	2580255	.	T	A	13	19	32	0	1	33	0	0
16	2580340	.	G	A	3	8	11	0	1	12	0	0
16	2637597	.	A	T	2	3	5	0	0	5	0	0
16	2637703	.	C	A	4	2	6	0	0	6	0	0
16	4126903	.	C	A	1	2	3	0	0	3	0	0
16	4190052	.	A	T	1	2	3	0	0	3	0	0
16	4190292	.	G	A	2	3	5	0	0	5	0	0
16	4190349	.	C	G	1	2	3	0	0	3	0	0
16	4190672	.	A	G	3	2	5	0	1	6	0	0
16	4190691	.	T	G	1	2	3	0	1	4	0	0
16	4197130	.	T	A	10	11	21	0	0	21	0	0
16	4202038	.	C	T	7	5	12	0	0	12	0	0
16	4202081	.	T	C	4	3	7	0	0	7	0	0
16	4287704	.	C	A	7	1	8	0	1	9	0	0
16	4287757	.	C	G	7	7	14	0	0	14	0	0
16	4287783	.	C	T	6	3	9	0	2	11	0	0
16	4513775	.	A	G	6	8	14	0	0	14	0	0
16	4513876	.	A	T	7	11	18	0	1	19	0	0
16	4513901	.	T	C	7	15	22	0	1	23	0	0
16	4513920	.	C	G	8	13	21	0	3	24	0	0
16	4514221	.	T	C	3	5	8	1	0	9	0	0
16	4514439	.	G	A	3	2	5	0	0	5	0	0
16	4514467	.	A	T	4	6	10	0	0	10	0	0
16	4514633	.	T	C	5	2	7	0	1	8	0	0
16	4531827	.	A	G	1	2	3	0	0	3	0	0
16	4531847	.	A	T	1	2	3	0	0	3	0	0
16	4533768	.	T	C	4	9	13	0	1	14	0	0
16	4538422	.	A	G	4	4	8	0	0	8	0	0
16	4540805	.	G	T	10	12	22	0	1	23	0	0
16	4540864	.	G	C	6	9	15	0	3	18	0	0
16	4541022	.	A	C	2	10	12	0	0	12	0	0
16	4541061	.	T	G	1	9	10	0	0	10	0	0
16	4541085	.	T	C	3	9	12	0	0	12	0	0
16	4541233	.	T	C	8	12	20	0	0	20	0	0
16	4541250	.	C	T	7	12	19	0	0	19	0	0
16	4541281	.	A	T	4	3	7	0	0	7	0	0
16	4541931	.	A	C	5	1	6	0	2	8	0	0
16	4541936	.	G	C	4	4	8	0	0	8	0	0
16	4542518	.	C	T	1	7	8	0	11	19	0	0
16	4615769	.	C	A	5	2	7	1	0	8	0	0
16	4615993	.	C	A	13	6	19	0	2	21	0	0
16	4616071	.	A	T	6	9	15	0	2	17	0	0
16	4619598	.	A	T	0	1	1	0	0	1	0	0
16	4619614	.	A	G	0	1	1	0	0	1	0	0
16	4697821	.	G	A	0	0	0	0	1	1	0	0
16	4700766	.	T	C	1	2	3	0	0	3	0	0
16	4707211	.	G	T	0	6	6	0	7	13	0	0
16	4707480	.	G	A	5	4	9	0	0	9	0	0
16	4711342	.	A	T	1	2	3	0	0	3	0	0
16	4755816	.	A	T	2	5	7	0	0	7	0	0
16	4867445	.	C	T	0	3	3	0	0	3	0	0
16	4867487	.	C	T	0	2	2	0	0	2	0	0
16	4867496	.	A	G	0	2	2	0	0	2	0	0
16	4869973	.	G	A	2	3	5	0	0	5	0	0
16	4885458	.	T	A	0	1	1	0	1	2	0	0
16	5086725	.	G	A	0	1	1	0	0	1	0	0
16	5110647	.	A	G	1	2	3	0	0	3	0	0
16	5145459	.	T	C	7	8	15	0	0	15	0	0
16	5145599	.	C	A	18	13	31	0	1	32	0	0
16	5145622	.	G	A	19	14	33	0	1	34	0	0
16	5149298	.	T	C	2	1	3	0	0	3	0	0
16	5153956	.	T	C	10	6	16	0	2	18	0	0
16	5166015	.	G	A	0	3	3	0	4	7	0	0
16	5166030	.	C	T	5	5	10	0	0	10	0	0
16	5166288	.	G	A	7	6	13	0	0	13	0	0
16	5166332	.	T	A	16	8	24	0	0	24	0	0
16	5166351	.	T	C	15	9	24	0	1	25	0	0
16	5166546	.	G	A	6	7	13	0	0	13	0	0
16	5166645	.	A	C	10	6	16	0	1	17	0	0
16	5166719	.	A	G	4	3	7	0	0	7	0	0
16	5166805	.	A	G	2	0	2	0	9	11	0	0
16	5166889	.	G	T	4	7	11	0	1	12	0	0
16	5167148	.	A	G	1	2	3	0	0	3	0	0
16	5221622	.	T	A	3	3	6	0	0	6	0	0
16	5223206	.	G	A	1	5	6	0	0	6	0	0
16	5223740	.	C	T	1	4	5	0	0	5	0	0
16	5223880	.	G	C	0	4	4	0	5	9	0	0
16	5224429	.	A	T	0	2	2	0	0	2	0	0
16	5230627	.	G	A	1	14	15	0	9	24	0	0
16	5230782	.	A	T	10	7	17	0	3	20	0	0
16	5251770	.	G	A	2	4	6	0	0	6	0	0
16	5496522	.	T	C	1	1	2	0	0	2	0	0
16	5496874	.	C	A	3	2	5	0	0	5	0	0
16	5604765	.	A	T	2	2	4	0	0	4	0	0
16	5700646	.	T	C	0	2	2	0	1	3	0	0
16	5702891	.	T	G	0	2	2	0	0	2	0	0
16	5702906	.	T	C	0	2	2	0	0	2	0	0
16	5776274	.	T	C	7	8	15	0	0	15	0	0
16	5776356	.	C	T	11	13	24	0	2	26	0	0
16	5776371	.	T	G	10	11	21	0	0	21	0	0
16	5778882	.	A	G	14	19	33	0	1	34	0	0
16	5778913	.	T	C	15	24	39	0	2	41	0	0
16	5786889	.	C	T	1	1	2	0	0	2	0	0
16	5786890	.	A	G	1	1	2	0	0	2	0	0
16	5786945	.	G	A	5	4	9	0	0	9	0	0
16	5786989	.	C	T	0	10	10	0	5	15	0	0
16	5787185	.	A	T	7	5	12	0	3	15	0	0
16	5787396	.	A	G	6	2	8	0	8	16	0	0
16	5787399	.	T	A	7	9	16	0	0	16	0	0
16	5787435	.	T	C	3	10	13	0	2	15	0	0
16	5787506	.	T	A	11	10	21	0	0	21	0	0
16	5787562	.	G	A	6	6	12	0	0	12	0	0
16	5787671	.	G	C	4	9	13	0	0	13	0	0
16	5787870	.	T	G	2	4	6	0	0	6	0	0
16	5787872	.	A	T	0	4	4	0	2	6	0	0
16	5787981	.	T	C	5	2	7	0	0	7	0	0
16	5788079	.	A	G	1	5	6	0	0	6	0	0
16	5788405	.	A	T	1	2	3	0	0	3	0	0
16	5788410	.	A	T	1	2	3	0	0	3	0	0
16	6126525	.	T	C	3	3	6	0	0	6	0	0
16	6183022	.	A	C	21	15	36	0	3	39	0	0
16	6183658	.	T	G	19	29	48	0	0	48	0	0
16	6191622	.	C	G	16	12	28	0	2	30	0	0
16	6192811	.	A	G	3	3	6	0	0	6	0	0
16	6387037	.	G	A	19	24	43	0	5	48	0	0
16	6387121	.	G	A	17	16	33	0	1	34	0	0
16	6387157	.	A	C	5	4	9	0	0	9	0	0
16	6395740	.	T	A	1	3	4	0	1	5	0	0
16	6395904	.	A	G	3	2	5	0	0	5	0	0
16	6395906	.	A	G	3	2	5	0	0	5	0	0
16	6787491	.	G	A	0	0	0	0	1	1	0	0
16	6793333	.	C	G	0	1	1	0	0	1	0	0
16	6796195	.	A	G	3	5	8	0	1	9	0	0
16	6796279	.	T	C	2	0	2	0	0	2	0	0
16	6800033	.	G	A	3	4	7	0	0	7	0	0
16	6800263	.	G	A	5	4	9	0	0	9	0	0
16	6800289	.	G	A	3	2	5	0	0	5	0	0
16	6803429	.	T	C	8	3	11	0	0	11	0	0
16	6803725	.	T	C	14	8	22	0	0	22	0	0
16	6803736	.	G	C	13	8	21	0	2	23	0	0
16	6803887	.	A	G	7	10	17	0	1	18	0	0
16	6809872	.	A	G	5	5	10	0	0	10	0	0
16	6820725	.	G	A	13	11	24	0	1	25	0	0
16	6821332	.	A	G	9	5	14	0	1	15	0	0
16	6821465	.	C	T	0	7	7	0	5	12	0	0
16	6947998	.	T	C	7	11	18	0	0	18	0	0
16	7376648	.	C	T	2	2	4	0	0	4	0	0
16	7376900	.	A	G	11	3	14	0	1	15	0	0
16	7415215	.	G	A	10	6	16	0	1	17	0	0
16	7415254	.	T	A	9	5	14	0	0	14	0	0
16	7415423	.	C	A	7	11	18	0	0	18	0	0
16	7415435	.	G	A	9	12	21	0	0	21	0	0
16	7415542	.	A	T	3	7	10	0	1	11	0	0
16	7415559	.	C	A	4	7	11	0	3	14	0	0
16	7415761	.	G	A	8	6	14	0	0	14	0	0
16	7415793	.	G	A	9	6	15	0	1	16	0	0
16	7416236	.	C	T	11	8	19	0	2	21	0	0
16	7416320	.	C	T	12	10	22	0	4	26	0	0
16	7416352	.	T	A	6	7	13	0	1	14	0	0
16	7416478	.	G	A	2	2	4	0	0	4	0	0
16	7635527	.	C	T	0	1	1	0	0	1	0	0
16	7635721	.	T	A	1	1	2	0	0	2	0	0
16	7638788	.	T	C	9	3	12	0	1	13	0	0
16	7638815	.	A	T	8	7	15	0	0	15	0	0
16	7638866	.	A	T	14	4	18	0	0	18	0	0
16	7638979	.	C	T	12	5	17	0	0	17	0	0
16	7638984	.	C	A	10	5	15	0	1	16	0	0
16	7639100	.	T	A	11	5	16	0	3	19	0	0
16	7639125	.	A	G	17	9	26	0	1	27	0	0
16	7639401	.	A	C	16	16	32	0	3	35	0	0
16	7639527	.	C	T	11	14	25	0	0	25	0	0
16	7639534	.	G	C	0	13	13	0	13	26	0	0
16	7639621	.	C	T	6	15	21	0	0	21	0	0
16	7639643	.	A	T	7	14	21	0	1	22	0	0
16	7639684	.	A	G	10	9	19	0	1	20	0	0
16	7639774	.	T	A	13	12	25	0	1	26	0	0
16	7639856	.	T	C	8	20	28	0	2	30	0	0
16	7640116	.	A	G	20	15	35	0	1	36	0	0
16	7640127	.	G	A	0	15	15	0	21	36	0	0
16	7640390	.	C	T	24	8	32	0	1	33	0	0
16	7640410	.	A	G	25	13	38	0	1	39	0	0
16	7640425	.	T	A	24	22	46	0	1	47	0	0
16	7640757	.	T	A	16	14	30	0	4	34	0	0
16	7640999	.	G	A	5	5	10	0	1	11	0	0
16	7725555	.	A	T	1	1	2	0	0	2	0	0
16	7743286	.	T	A	7	4	11	0	1	12	0	0
16	7743398	.	C	T	0	5	5	0	4	9	0	0
16	7743598	.	T	A	2	4	6	0	0	6	0	0
16	7803023	.	T	C	7	11	18	0	3	21	0	0
16	7803298	.	T	C	6	3	9	0	1	10	0	0
16	7803560	.	A	G	5	3	8	0	1	9	0	0
16	7803627	.	T	A	7	3	10	0	0	10	0	0
16	7803782	.	C	A	0	2	2	0	6	8	0	0
16	7803923	.	T	A	4	2	6	0	0	6	0	0
16	7803971	.	T	A	3	2	5	0	0	5	0	0
16	7999499	.	C	A	1	2	3	0	0	3	0	0
16	8040833	.	C	G	8	3	11	0	0	11	0	0
16	8041173	.	G	A	5	8	13	0	0	13	0	0
16	8041179	.	A	G	5	8	13	0	1	14	0	0
16	8041234	.	G	A	0	2	2	0	6	8	0	0
16	8051941	.	T	C	7	0	7	0	20	27	0	0
16	8052033	.	T	C	9	18	27	0	1	28	0	0
16	8052049	.	G	A	10	14	24	1	3	28	0	0
16	8052145	.	C	A	19	19	38	0	3	41	0	0
16	8052537	.	C	T	10	7	17	0	1	18	0	0
16	8052606	.	T	C	5	0	5	0	9	14	0	0
16	8052651	.	T	C	9	9	18	0	2	20	0	0
16	8052747	.	A	G	3	5	8	0	2	10	0	0
16	8052831	.	T	A	6	9	15	0	1	16	0	0
16	8052866	.	C	A	0	4	4	0	5	9	0	0
16	8052909	.	T	A	1	3	4	1	0	5	0	0
16	8053206	.	T	G	2	7	9	0	1	10	0	0
16	8053403	.	C	T	6	4	10	0	0	10	0	0
16	8053485	.	C	T	7	4	11	0	1	12	0	0
16	8053716	.	A	G	1	4	5	0	1	6	0	0
16	8053717	.	T	C	1	5	6	0	0	6	0	0
16	8161591	.	G	A	1	3	4	0	0	4	0	0
16	8162248	.	T	C	2	2	4	0	0	4	0	0
16	8298607	.	C	T	1	2	3	0	0	3	0	0
16	8298915	.	T	C	3	3	6	0	0	6	0	0
16	8299025	.	T	A	6	2	8	0	1	9	0	0
16	8299037	.	A	T	9	2	11	0	0	11	0	0
16	8299123	.	T	A	4	1	5	0	0	5	0	0
16	8299302	.	G	A	0	1	1	0	1	2	0	0
16	8299308	.	T	A	1	2	3	0	0	3	0	0
16	8299410	.	T	A	3	2	5	0	0	5	0	0
16	8299705	.	G	A	1	2	3	0	0	3	0	0
16	8299793	.	T	A	1	4	5	0	0	5	0	0
16	8299794	.	G	A	1	4	5	0	0	5	0	0
16	8530910	.	T	C	1	1	2	0	1	3	0	0
16	8530992	.	A	T	4	5	9	0	0	9	0	0
16	8531299	.	C	T	1	3	4	0	0	4	0	0
16	8752017	.	T	A	2	7	9	0	1	10	0	0
16	8752091	.	A	G	7	7	14	0	0	14	0	0
16	8752223	.	C	T	3	3	6	0	0	6	0	0
16	8752316	.	G	T	2	2	4	0	1	5	0	0
16	8752334	.	C	T	0	2	2	0	1	3	0	0
16	8759975	.	G	A	2	4	6	0	1	7	0	0
16	9267427	.	T	C	1	2	3	0	0	3	0	0
16	9276020	.	C	T	8	5	13	0	0	13	0	0
16	9281534	.	G	A	0	1	1	0	0	1	0	0
16	9282707	.	C	T	0	1	1	0	0	1	0	0
16	9286997	.	G	A	0	1	1	0	0	1	0	0
16	9412401	.	C	T	2	3	5	0	1	6	0	0
16	9412994	.	G	T	2	2	4	0	0	4	0	0
16	9415063	.	C	T	0	1	1	0	0	1	0	0
16	9415106	.	C	T	1	1	2	0	0	2	0	0
16	9415116	.	A	G	1	1	2	0	0	2	0	0
16	9415697	.	T	C	0	1	1	0	0	1	0	0
16	9415749	.	G	A	3	2	5	0	1	6	0	0
16	9415793	.	C	T	6	4	10	0	0	10	0	0
16	9420003	.	G	A	1	1	2	0	0	2	0	0
16	9420260	.	A	G	3	3	6	0	0	6	0	0
16	9420278	.	A	C	3	3	6	0	0	6	0	0
16	9433915	.	C	T	0	5	5	0	4	9	0	0
16	9437789	.	G	A	1	1	2	0	0	2	0	0
16	9596127	.	C	T	1	2	3	0	0	3	0	0
16	9602508	.	C	T	1	4	5	0	0	5	0	0
16	9602523	.	G	A	2	4	6	0	0	6	0	0
16	9602643	.	T	C	1	1	2	0	0	2	0	0
16	9605436	.	A	T	2	2	4	0	0	4	0	0
16	9605619	.	T	C	2	3	5	0	0	5	0	0
16	9605728	.	G	C	2	5	7	0	0	7	0	0
16	9605823	.	A	T	4	4	8	0	1	9	0	0
16	9605850	.	A	G	4	6	10	0	1	11	0	0
16	9605947	.	A	G	7	11	18	0	1	19	0	0
16	9605982	.	C	A	8	16	24	0	1	25	0	0
16	9606011	.	G	T	6	9	15	0	2	17	0	0
16	9606024	.	C	T	5	7	12	0	0	12	0	0
16	9606048	.	G	A	3	2	5	0	0	5	0	0
16	9725137	.	A	T	1	3	4	0	1	5	0	0
16	9759605	.	A	T	1	2	3	0	0	3	0	0
16	9759698	.	A	C	2	1	3	0	1	4	0	0
16	9759820	.	T	A	1	4	5	0	0	5	0	0
16	9759842	.	A	G	2	3	5	0	0	5	0	0
16	9760006	.	C	T	4	4	8	0	0	8	0	0
16	9760083	.	T	C	5	3	8	0	1	9	0	0
16	9760085	.	C	A	5	4	9	0	0	9	0	0
16	9760248	.	T	C	4	5	9	0	1	10	0	0
16	9760894	.	A	T	3	5	8	0	0	8	0	0
16	9761141	.	G	A	1	7	8	0	9	17	0	0
16	9761246	.	A	G	4	0	4	0	8	12	0	0
16	9761339	.	A	C	4	4	8	0	4	14	2	0
16	9766586	.	A	C	2	1	3	0	0	3	0	0
16	9766774	.	T	C	3	3	6	0	1	7	0	0
16	9769846	.	C	T	1	0	1	0	0	1	0	0
16	9774187	.	G	A	6	8	14	0	0	14	0	0
16	9777497	.	T	C	13	23	36	0	3	39	0	0
16	9777589	.	A	T	15	12	27	0	0	27	0	0
16	9777716	.	A	G	4	7	11	0	0	11	0	0
16	9785990	.	G	A	2	5	7	0	0	7	0	0
16	9787891	.	T	G	8	8	16	0	1	17	0	0
16	9788486	.	G	A	1	4	5	0	1	6	0	0
16	9789007	.	A	T	1	6	7	0	0	7	0	0
16	9789097	.	C	T	4	2	6	0	0	6	0	0
16	9789513	.	C	G	12	13	25	0	1	26	0	0
16	9789984	.	T	C	14	14	28	0	4	32	0	0
16	9825756	.	T	G	1	2	3	0	0	3	0	0
16	9833315	.	T	A	2	2	4	0	0	4	0	0
16	9833794	.	T	A	19	26	45	0	0	45	0	0
16	9833887	.	T	A	22	13	35	1	1	37	0	0
16	9833974	.	G	A	17	18	35	0	1	36	0	0
16	9834135	.	A	C	23	8	31	0	2	33	0	0
16	9834271	.	C	T	7	17	24	0	1	25	0	0
16	9834491	.	T	A	9	5	14	0	1	15	0	0
16	9834518	.	T	G	9	6	15	0	2	17	0	0
16	9834541	.	G	A	9	7	16	0	3	19	0	0
16	9834595	.	A	T	8	6	14	0	0	14	0	0
16	9834748	.	G	C	3	9	12	0	0	12	0	0
16	9834802	.	C	A	4	7	11	0	1	12	0	0
16	9834960	.	G	A	7	7	14	0	1	15	0	0
16	9835250	.	C	G	3	3	6	0	0	6	0	0
16	9847149	.	G	A	1	2	3	0	0	3	0	0
16	9978438	.	G	A	10	8	18	0	0	18	0	0
16	10027167	.	G	C	0	0	0	0	1	1	0	0
16	10055745	.	C	A	7	2	9	0	0	9	0	0
16	10098447	.	A	G	1	1	2	0	0	2	0	0
16	10205161	.	G	T	1	4	5	0	0	5	0	0
16	10210470	.	T	G	0	1	1	0	0	1	0	0
16	10283438	.	C	A	0	3	3	0	0	3	0	0
16	10284480	.	T	A	0	3	3	0	1	4	0	0
16	10284486	.	T	A	0	4	4	0	0	4	0	0
16	10284582	.	A	T	7	7	14	0	0	14	0	0
16	10287699	.	A	G	2	8	10	0	0	10	0	0
16	10287996	.	G	A	4	2	6	0	0	6	0	0
16	10288022	.	C	A	2	3	5	0	1	6	0	0
16	10288121	.	C	T	3	2	5	0	1	6	0	0
16	10288230	.	A	G	5	4	9	0	1	10	0	0
16	10288260	.	C	T	4	8	12	0	0	12	0	0
16	10326092	.	C	T	4	4	8	0	2	10	0	0
16	10341816	.	A	C	3	2	5	0	0	5	0	0
16	10342169	.	C	T	3	3	6	0	0	6	0	0
16	10345223	.	T	C	5	0	5	0	1	6	0	0
16	10345595	.	A	G	8	5	13	0	0	13	0	0
16	10345720	.	A	G	5	10	15	0	0	15	0	0
16	10413777	.	T	A	1	2	3	0	0	3	0	0
16	10417124	.	G	C	1	10	11	0	0	11	0	0
16	10428853	.	C	T	1	2	3	0	0	3	0	0
16	10447923	.	C	A	0	1	1	0	0	1	0	0
16	10454950	.	G	A	0	1	1	0	0	1	0	0
16	10461712	.	A	T	0	0	0	0	1	1	0	0
16	10464571	.	C	T	3	2	5	0	0	5	0	0
16	10475645	.	C	T	8	8	16	0	0	16	0	0
16	10475646	.	A	G	8	8	16	0	0	16	0	0
16	10477836	.	C	T	0	9	9	0	11	20	0	0
16	10481425	.	C	T	5	4	9	0	0	9	0	0
16	10481488	.	C	T	0	5	5	0	3	8	0	0
16	10489410	.	G	A	2	0	2	0	0	2	0	0
16	10635338	.	A	T	2	2	4	0	0	4	0	0
16	10635401	.	T	G	1	2	3	0	0	3	0	0
16	10635838	.	T	C	2	2	4	0	0	4	0	0
16	10636168	.	C	T	8	6	14	0	0	14	0	0
16	10636698	.	T	A	2	3	5	0	0	5	0	0
16	10636882	.	C	T	4	4	8	0	1	9	0	0
16	10637259	.	A	G	11	10	21	0	2	23	0	0
16	10637329	.	C	A	10	5	15	0	0	15	0	0
16	10637379	.	T	A	11	7	18	0	2	20	0	0
16	10637705	.	A	C	6	4	10	0	0	10	0	0
16	10732313	.	C	A	3	2	5	0	0	5	0	0
16	10733751	.	A	G	1	3	4	0	0	4	0	0
16	10733829	.	G	C	6	3	9	0	1	10	0	0
16	10734032	.	A	C	4	2	6	0	0	6	0	0
16	10734190	.	T	C	5	10	15	0	0	15	0	0
16	10807360	.	T	A	2	2	4	0	0	4	0	0
16	10813138	.	A	C	8	5	13	0	0	13	0	0
16	10813372	.	C	T	2	3	5	0	1	6	0	0
16	10815877	.	T	C	6	4	10	0	2	12	0	0
16	10820157	.	G	A	1	24	25	0	39	64	0	0
16	10820215	.	A	T	28	24	52	0	1	53	0	0
16	10820224	.	T	A	31	18	49	0	2	51	0	0
16	10820803	.	C	T	31	22	53	0	7	60	0	0
16	10820866	.	A	G	13	11	24	0	4	28	0	0
16	10828887	.	T	C	1	2	3	0	1	4	0	0
16	10829276	.	T	A	4	2	6	0	0	6	0	0
16	10829569	.	A	T	14	6	20	0	1	21	0	0
16	10829633	.	A	T	9	4	13	0	1	14	0	0
16	10829635	.	A	C	8	3	11	0	3	14	0	0
16	10829737	.	G	A	2	2	4	0	0	4	0	0
16	10829968	.	T	G	9	2	11	0	2	13	0	0
16	10830013	.	T	G	5	6	11	0	1	12	0	0
16	10830145	.	T	G	3	5	8	0	0	8	0	0
16	10830147	.	T	A	3	5	8	0	0	8	0	0
16	10830309	.	T	A	5	5	10	0	1	11	0	0
16	10830328	.	T	C	6	3	9	0	0	9	0	0
16	10830625	.	G	C	2	0	2	0	0	2	0	0
16	10841193	.	T	C	1	2	3	0	0	3	0	0
16	10841612	.	T	C	3	1	4	0	1	5	0	0
16	10846654	.	A	G	3	5	8	0	0	8	0	0
16	10855924	.	A	G	6	15	21	0	4	25	0	0
16	10856130	.	A	G	4	7	11	0	0	11	0	0
16	10856235	.	C	G	11	6	17	0	5	22	0	0
16	10856406	.	A	T	2	2	4	0	0	4	0	0
16	10858395	.	C	T	3	3	6	0	0	6	0	0
16	10858554	.	G	A	4	3	7	0	0	7	0	0
16	10858656	.	A	G	5	2	7	0	0	7	0	0
16	10859434	.	C	T	26	17	43	0	4	47	0	0
16	10859435	.	T	C	27	18	45	0	2	47	0	0
16	10859857	.	T	C	25	22	47	0	2	49	0	0
16	10861956	.	A	G	22	18	40	0	3	43	0	0
16	10861971	.	T	A	25	15	40	0	1	41	0	0
16	10862331	.	C	G	11	15	26	0	5	31	0	0
16	10862627	.	G	A	4	19	23	0	38	61	0	0
16	10862762	.	C	T	28	22	50	0	0	51	1	0
16	10862773	.	T	C	27	22	49	0	3	52	0	0
16	10919245	.	T	A	1	2	3	0	1	4	0	0
16	10919251	.	G	T	2	2	4	0	0	4	0	0
16	10919317	.	C	T	0	2	2	0	2	4	0	0
16	11140391	.	G	A	3	3	6	0	0	6	0	0
16	11140397	.	T	A	3	2	5	0	1	6	0	0
16	11140427	.	A	G	3	2	5	0	0	5	0	0
16	11141196	.	T	C	3	3	6	0	0	6	0	0
16	11141776	.	C	G	8	2	10	0	1	11	0	0
16	11141836	.	G	A	6	4	10	0	0	10	0	0
16	11142032	.	A	T	5	6	11	0	0	11	0	0
16	11142428	.	A	G	6	14	20	0	0	20	0	0
16	11142451	.	A	C	5	13	18	0	2	20	0	0
16	11199533	.	C	T	1	2	3	0	1	4	0	0
16	11206313	.	A	C	3	1	4	0	0	4	0	0
16	11206316	.	C	T	3	2	5	0	0	5	0	0
16	11206723	.	T	C	5	2	7	0	0	7	0	0
16	11212111	.	C	A	2	8	10	0	2	12	0	0
16	11215162	.	T	C	3	7	10	0	0	10	0	0
16	11215163	.	T	C	3	5	8	0	2	10	0	0
16	11215504	.	C	T	6	6	12	0	2	14	0	0
16	11221153	.	A	C	8	11	19	0	0	19	0	0
16	11221667	.	A	G	10	10	20	0	0	20	0	0
16	11222031	.	T	A	16	4	20	0	2	22	0	0
16	11222139	.	G	A	10	14	24	0	2	26	0	0
16	11222738	.	G	A	2	19	21	0	25	46	0	0
16	11227434	.	C	T	4	4	8	0	1	9	0	0
16	11227526	.	T	G	2	12	14	0	0	14	0	0
16	11227537	.	G	A	1	10	11	0	1	12	0	0
16	11227611	.	G	A	2	4	6	0	1	7	0	0
16	11228358	.	C	A	0	5	5	0	3	8	0	0
16	11290975	.	A	C	7	4	11	0	0	11	0	0
16	11291799	.	T	C	25	7	32	0	2	34	0	0
16	11291803	.	G	A	27	7	34	0	1	35	0	0
16	11774345	.	G	A	12	8	20	0	0	20	0	0
16	11774355	.	C	T	0	8	8	0	10	18	0	0
16	11774456	.	G	A	4	7	11	0	1	12	0	0
16	11774948	.	T	A	5	7	12	0	2	14	0	0
16	11775084	.	G	T	1	5	6	0	1	7	0	0
16	11775200	.	A	G	3	4	7	0	1	8	0	0
16	11775279	.	T	C	2	5	7	0	2	9	0	0
16	11775683	.	T	C	4	8	12	0	0	12	0	0
16	11778275	.	C	T	0	1	1	0	3	4	0	0
16	11839999	.	C	T	1	3	4	0	0	4	0	0
16	11974658	.	G	A	0	1	1	0	0	1	0	0
16	11978094	.	A	C	3	3	6	0	0	6	0	0
16	11982323	.	G	A	0	1	1	0	0	1	0	0
16	12052690	.	G	A	0	2	2	0	0	2	0	0
16	12052735	.	G	A	0	1	1	0	0	1	0	0
16	12065410	.	A	G	4	6	10	0	2	12	0	0
16	12076492	.	A	G	3	3	6	0	0	6	0	0
16	12102947	.	C	A	25	17	42	0	1	43	0	0
16	12103263	.	A	T	16	31	47	0	1	48	0	0
16	12103292	.	A	T	12	30	42	0	4	46	0	0
16	12103344	.	A	G	16	27	43	0	0	43	0	0
16	12103421	.	T	A	21	18	39	0	2	41	0	0
16	12103530	.	G	A	25	12	37	0	4	41	0	0
16	12103873	.	C	T	0	12	12	0	13	25	0	0
16	12103881	.	G	A	11	14	25	0	1	26	0	0
16	12103934	.	C	T	12	11	23	0	3	26	0	0
16	12103941	.	A	G	13	10	23	0	4	27	0	0
16	12104042	.	C	T	11	19	30	0	0	30	0	0
16	12104043	.	A	T	11	19	30	0	0	30	0	0
16	12104083	.	C	T	10	10	20	0	2	22	0	0
16	12104231	.	C	G	15	6	21	0	0	21	0	0
16	12104350	.	T	C	1	9	10	0	0	10	0	0
16	12104384	.	C	T	9	6	15	0	0	15	0	0
16	12104388	.	T	C	9	5	14	0	0	14	0	0
16	12104509	.	G	A	15	11	26	3	0	29	0	0
16	12104601	.	G	A	13	7	20	0	3	23	0	0
16	12104665	.	A	G	6	13	19	0	1	20	0	0
16	12104943	.	A	T	13	4	17	0	1	18	0	0
16	12104944	.	T	G	13	5	18	0	0	18	0	0
16	12105196	.	C	A	2	4	6	0	0	6	0	0
16	12105206	.	A	G	2	3	5	0	1	6	0	0
16	12105265	.	T	A	6	2	8	0	1	9	0	0
16	12105365	.	A	G	6	3	9	0	1	10	0	0
16	12105384	.	G	A	5	3	8	0	1	9	0	0
16	12105689	.	C	T	0	2	2	0	3	5	0	0
16	12105796	.	C	T	0	5	5	0	5	10	0	0
16	12105854	.	A	G	3	9	12	0	1	13	0	0
16	12108607	.	G	A	3	5	8	0	3	11	0	0
16	12108622	.	A	G	3	6	9	0	3	12	0	0
16	12174949	.	G	T	4	3	7	0	0	7	0	0
16	12175007	.	A	T	5	2	7	0	0	7	0	0
16	12175281	.	G	A	1	3	4	0	0	4	0	0
16	12243571	.	C	T	6	7	13	0	0	13	0	0
16	12245691	.	G	A	1	7	8	0	0	8	0	0
16	12245760	.	T	C	1	4	5	0	1	6	0	0
16	12245954	.	C	T	2	3	5	0	0	5	0	0
16	12259023	.	T	C	3	4	7	0	1	8	0	0
16	12259072	.	C	T	6	3	9	0	0	9	0	0
16	12263223	.	A	G	0	2	2	0	1	3	0	0
16	12263358	.	C	T	0	2	2	0	3	5	0	0
16	12273636	.	G	A	0	0	0	0	2	2	0	0
16	12273653	.	A	G	6	4	10	0	1	11	0	0
16	12276065	.	A	T	15	13	28	0	0	28	0	0
16	12286250	.	G	A	2	4	6	0	0	6	0	0
16	12286460	.	A	T	0	1	1	0	0	1	0	0
16	12294273	.	G	A	7	8	15	0	1	16	0	0
16	12738324	.	G	A	1	0	1	0	1	2	0	0
16	12743927	.	G	A	0	3	3	0	1	4	0	0
16	12748568	.	T	C	6	10	16	0	1	17	0	0
16	12748944	.	A	G	7	2	9	0	1	10	0	0
16	12754621	.	A	G	14	0	14	0	18	32	0	0
16	12754849	.	T	C	13	9	22	0	3	25	0	0
16	12754858	.	G	T	0	8	8	0	15	23	0	0
16	12755011	.	G	A	5	17	22	0	2	24	0	0
16	12756051	.	G	T	23	20	43	0	1	44	0	0
16	12794075	.	C	G	5	5	10	0	1	11	0	0
16	12816975	.	G	A	0	1	1	0	0	1	0	0
16	12821106	.	C	T	13	18	31	0	1	32	0	0
16	12821221	.	G	A	12	22	34	0	1	35	0	0
16	12821370	.	A	T	19	4	23	0	0	23	0	0
16	12821371	.	G	A	19	2	21	0	2	23	0	0
16	12821497	.	T	C	13	23	36	0	4	40	0	0
16	12882543	.	A	G	21	23	44	0	5	49	0	0
16	12882612	.	C	T	0	13	13	0	28	41	0	0
16	12883126	.	G	A	11	22	33	0	5	38	0	0
16	12883484	.	G	C	6	13	19	0	0	19	0	0
16	12883618	.	C	T	9	6	15	0	1	16	0	0
16	12884054	.	A	T	6	3	9	0	1	10	0	0
16	12963061	.	T	C	2	2	4	0	1	5	0	0
16	12963109	.	A	G	5	6	11	0	2	13	0	0
16	12963274	.	A	T	6	4	10	0	0	10	0	0
16	12963368	.	G	A	12	9	21	0	1	22	0	0
16	12963384	.	C	T	0	9	9	0	17	26	0	0
16	12963405	.	A	G	16	5	21	0	3	24	0	0
16	12963696	.	T	G	20	15	35	0	6	41	0	0
16	12967855	.	G	A	6	5	11	0	1	12	0	0
16	12981637	.	G	A	0	1	1	0	0	1	0	0
16	12984488	.	C	G	1	2	3	0	1	4	0	0
16	13180175	.	T	C	3	3	6	0	0	6	0	0
16	13180298	.	T	C	5	9	14	0	1	15	0	0
16	13180389	.	T	C	2	13	15	0	2	17	0	0
16	13599957	.	G	A	12	6	18	0	0	18	0	0
16	13600680	.	A	C	6	12	18	0	2	20	0	0
16	13601026	.	T	C	6	7	13	0	1	14	0	0
16	13601961	.	T	A	4	5	9	0	1	10	0	0
16	13601965	.	G	A	4	5	9	0	1	10	0	0
16	13602454	.	T	A	3	2	5	0	0	5	0	0
16	13602488	.	T	C	1	2	3	0	0	3	0	0
16	13610726	.	T	A	3	3	6	0	0	6	0	0
16	13616621	.	A	C	1	10	11	0	1	12	0	0
16	13617023	.	C	T	0	9	9	0	9	18	0	0
16	13617152	.	C	T	4	16	20	0	1	21	0	0
16	13617291	.	G	A	2	6	8	0	0	8	0	0
16	13617329	.	T	G	3	6	9	0	0	9	0	0
16	13617767	.	G	T	3	2	5	0	0	5	0	0
16	13618170	.	A	G	5	5	10	0	0	10	0	0
16	13618172	.	C	G	3	5	8	0	2	10	0	0
16	13618374	.	A	T	1	5	6	0	0	6	0	0
16	13618644	.	T	A	3	2	5	0	0	5	0	0
16	13619001	.	A	C	3	3	6	0	0	6	0	0
16	13623641	.	A	C	5	4	9	0	1	10	0	0
16	13636760	.	G	A	2	1	3	0	0	3	0	0
16	13643523	.	A	G	1	1	2	0	0	2	0	0
16	13673143	.	T	C	7	11	18	0	4	22	0	0
16	13673181	.	T	C	7	0	7	0	2	9	0	0
16	13673188	.	C	A	7	1	8	0	0	8	0	0
16	13673243	.	T	C	1	3	4	0	0	4	0	0
16	13673244	.	T	C	1	3	4	0	0	4	0	0
16	13673734	.	A	C	3	3	6	0	1	7	0	0
16	13674581	.	C	T	5	3	8	0	0	8	0	0
16	13679037	.	A	G	0	1	1	0	0	1	0	0
16	13701482	.	C	T	2	2	4	0	2	6	0	0
16	13701599	.	A	G	0	4	4	0	0	4	0	0
16	13706061	.	G	A	1	0	1	0	0	1	0	0
16	13706207	.	G	C	4	5	9	0	2	11	0	0
16	13729810	.	C	T	1	0	1	0	0	1	0	0
16	13826195	.	C	T	2	2	4	0	1	5	0	0
16	13841360	.	T	A	3	4	7	0	0	7	0	0
16	13845368	.	G	A	0	14	14	0	13	27	0	0
16	13845846	.	A	G	10	11	21	0	1	22	0	0
16	13870685	.	A	C	1	6	7	0	0	7	0	0
16	13883968	.	C	A	2	4	6	0	0	6	0	0
16	13883980	.	A	C	1	3	4	0	2	6	0	0
16	13911867	.	C	G	4	2	6	0	0	6	0	0
16	13911896	.	A	G	3	6	9	0	0	9	0	0
16	13912179	.	C	T	1	1	2	0	0	2	0	0
16	14021817	.	G	T	4	2	6	0	0	6	0	0
16	14021886	.	C	T	1	4	5	0	0	5	0	0
16	14021907	.	T	A	0	2	2	0	0	2	0	0
16	14022035	.	A	C	3	0	3	0	0	3	0	0
16	14022445	.	T	C	7	12	19	0	1	20	0	0
16	14022585	.	C	A	6	7	13	0	0	13	0	0
16	14022697	.	T	A	8	4	12	0	1	13	0	0
16	14022767	.	T	A	6	2	8	0	0	8	0	0
16	14022774	.	C	T	6	2	8	0	0	8	0	0
16	14022842	.	A	G	1	2	3	0	0	3	0	0
16	14022975	.	G	T	1	3	4	0	0	4	0	0
16	14022976	.	T	A	1	3	4	0	0	4	0	0
16	14051150	.	G	C	2	3	5	0	1	6	0	0
16	14051249	.	T	C	2	3	5	0	2	7	0	0
16	14093909	.	T	A	5	6	11	0	0	11	0	0
16	14094219	.	A	G	4	4	8	0	0	8	0	0
16	14094222	.	C	A	4	3	7	0	1	8	0	0
16	14094364	.	A	C	3	4	7	0	1	8	0	0
16	14094422	.	C	G	7	9	16	0	1	17	0	0
16	14094601	.	G	A	15	14	29	0	1	30	0	0
16	14094604	.	T	A	16	15	31	0	0	31	0	0
16	14094640	.	G	T	13	13	26	0	1	27	0	0
16	14094668	.	T	A	7	10	17	0	1	18	0	0
16	14094801	.	C	T	10	0	10	0	0	10	0	0
16	14094806	.	G	A	8	0	8	0	2	10	0	0
16	14095097	.	C	T	0	3	3	0	3	6	0	0
16	14095176	.	A	T	2	2	4	0	1	5	0	0
16	14095183	.	G	C	1	3	4	0	0	4	0	0
16	14095279	.	C	A	6	10	16	0	0	16	0	0
16	14095397	.	A	C	3	12	15	0	0	15	0	0
16	14095563	.	A	C	3	0	3	0	4	7	0	0
16	14098014	.	C	T	6	4	10	0	0	10	0	0
16	14101832	.	G	A	0	2	2	0	0	2	0	0
16	14101864	.	T	C	1	3	4	0	1	5	0	0
16	14126267	.	C	T	2	2	4	0	0	4	0	0
16	14126294	.	T	C	2	2	4	0	0	4	0	0
16	14133317	.	G	A	1	2	3	0	0	3	0	0
16	14133521	.	G	A	3	2	5	0	0	5	0	0
16	14133721	.	C	T	1	5	6	0	0	6	0	0
16	14133734	.	A	C	1	5	6	0	0	6	0	0
16	14154240	.	T	A	2	2	4	0	0	4	0	0
16	14209195	.	G	A	0	4	4	0	0	4	0	0
16	14209348	.	T	C	4	2	6	0	1	7	0	0
16	14212079	.	G	C	0	4	4	0	9	13	0	0
16	14214534	.	G	A	0	1	1	0	0	1	0	0
16	14214543	.	A	G	0	1	1	0	0	1	0	0
16	14214643	.	A	T	1	1	2	0	0	2	0	0
16	14230077	.	A	G	2	0	2	0	2	4	0	0
16	14230078	.	A	G	1	3	4	0	0	4	0	0
16	14231135	.	G	A	0	3	3	0	11	14	0	0
16	14231138	.	C	T	11	3	14	0	0	14	0	0
16	14231207	.	T	A	3	4	7	0	0	7	0	0
16	14231730	.	G	A	7	19	26	0	1	27	0	0
16	14242688	.	C	T	0	1	1	0	2	3	0	0
16	14269975	.	C	T	1	2	3	0	0	3	0	0
16	14278173	.	C	T	2	2	4	0	2	6	0	0
16	14280312	.	C	A	2	3	5	0	0	5	0	0
16	14281031	.	C	T	1	2	3	0	0	3	0	0
16	14416520	.	C	T	11	5	16	0	0	16	0	0
16	14416599	.	C	T	9	8	17	0	0	17	0	0
16	14416622	.	C	T	7	5	12	0	3	15	0	0
16	14674718	.	T	G	5	4	9	0	0	9	0	0
16	14674855	.	A	G	1	2	3	0	0	3	0	0
16	14674930	.	A	G	1	3	4	0	0	4	0	0
16	14675101	.	T	A	3	2	5	0	0	5	0	0
16	14675373	.	A	C	7	7	14	0	0	14	0	0
16	14675413	.	G	T	0	3	3	0	8	11	0	0
16	14675513	.	A	C	6	8	14	0	1	15	0	0
16	14675572	.	G	A	4	6	10	0	1	11	0	0
16	14675658	.	A	G	6	11	17	0	2	19	0	0
16	14675697	.	A	T	10	9	19	0	1	20	0	0
16	14675780	.	A	G	9	4	13	0	1	14	0	0
16	15034906	.	C	T	1	1	2	0	0	2	0	0
16	15048561	.	G	T	5	2	7	0	1	8	0	0
16	15050195	.	T	C	3	4	7	0	2	9	0	0
16	15050367	.	C	A	17	13	30	0	2	32	0	0
16	15140987	.	G	A	0	3	3	0	3	6	0	0
16	15943424	.	C	T	9	6	15	0	0	15	0	0
16	16042986	.	T	C	1	5	6	0	1	7	0	0
16	16165179	.	T	A	34	30	64	0	1	65	0	0
16	16165361	.	A	G	41	30	71	0	2	73	0	0
16	16165418	.	C	T	39	31	70	0	3	73	0	0
16	16165725	.	A	C	31	36	67	0	4	71	0	0
16	16232963	.	T	C	2	3	5	0	0	5	0	0
16	16233520	.	C	T	7	6	13	0	2	15	0	0
16	16233538	.	A	T	4	7	11	0	0	11	0	0
16	16234309	.	C	A	0	6	6	0	4	10	0	0
16	16234840	.	A	T	2	5	7	0	0	7	0	0
16	16284057	.	T	C	1	2	3	0	0	3	0	0
16	16284159	.	G	A	0	6	6	0	6	12	0	0
16	16284192	.	C	A	7	5	12	0	1	13	0	0
16	16289121	.	C	T	2	3	5	0	0	5	0	0
16	16297057	.	G	A	0	1	1	0	0	1	0	0
16	16302166	.	T	C	1	9	10	0	1	11	0	0
16	16302247	.	A	T	6	9	15	0	0	15	0	0
16	16302371	.	A	C	6	5	11	0	0	11	0	0
16	16302426	.	T	A	6	8	14	0	3	17	0	0
16	16302477	.	G	A	0	8	8	0	11	19	0	0
16	16302835	.	T	C	9	7	16	0	1	17	0	0
16	16303025	.	C	T	12	22	34	0	1	35	0	0
16	16303065	.	A	G	12	11	23	0	2	25	0	0
16	16303086	.	T	A	12	10	22	0	2	24	0	0
16	16303163	.	G	A	0	20	20	0	10	30	0	0
16	16303196	.	A	G	12	0	12	0	17	29	0	0
16	16303293	.	T	G	11	13	24	0	0	24	0	0
16	16553899	.	C	T	7	3	10	0	1	11	0	0
16	16555611	.	A	G	4	7	11	0	1	12	0	0
16	16555975	.	T	A	3	2	5	0	0	5	0	0
16	16598049	.	T	C	0	2	2	0	0	2	0	0
16	16941741	.	C	T	3	3	6	0	1	7	0	0
16	16942200	.	C	T	2	2	4	0	0	4	0	0
16	16942293	.	T	A	3	2	5	0	0	5	0	0
16	16942867	.	A	G	3	7	10	0	1	11	0	0
16	16942906	.	C	G	2	7	9	0	0	9	0	0
16	16943258	.	C	A	4	4	8	0	0	8	0	0
16	16943348	.	C	A	3	3	6	0	0	6	0	0
16	16943388	.	T	A	4	3	7	0	0	7	0	0
16	16943651	.	A	T	3	8	11	0	0	11	0	0
16	16944023	.	G	T	5	9	14	0	0	14	0	0
16	16944066	.	T	C	4	4	8	0	2	10	0	0
16	16944142	.	A	T	2	8	10	0	2	12	0	0
16	16944150	.	T	C	3	10	13	0	0	13	0	0
16	16944884	.	A	G	5	11	16	0	1	18	1	0
16	16945261	.	A	G	3	3	6	0	0	6	0	0
16	16945328	.	G	A	6	6	12	0	2	14	0	0
16	16945365	.	T	G	9	12	21	0	1	22	0	0
16	16945585	.	A	C	5	1	6	0	3	9	0	0
16	17252774	.	G	T	4	9	13	0	1	14	0	0
16	17253189	.	T	A	3	5	8	0	0	8	0	0
16	17253223	.	A	G	2	4	6	0	0	6	0	0
16	17253274	.	T	C	4	4	8	0	0	8	0	0
16	17254696	.	A	T	1	2	3	0	0	3	0	0
16	17256120	.	C	T	2	3	5	0	0	5	0	0
16	17256165	.	G	A	2	4	6	0	0	6	0	0
16	17549087	.	G	A	5	3	8	0	0	8	0	0
16	17549176	.	G	T	4	4	8	0	1	9	0	0
16	17639989	.	T	A	10	9	19	0	1	20	0	0
16	17640297	.	G	A	10	6	16	0	0	16	0	0
16	18569708	.	G	T	12	3	15	0	2	17	0	0
16	19145102	.	C	T	2	0	2	0	0	2	0	0
16	19150643	.	A	T	4	0	4	0	0	4	0	0
16	19150814	.	T	A	2	3	5	0	0	5	0	0
16	19150973	.	A	G	3	2	5	0	0	5	0	0
16	19151174	.	C	A	1	4	5	0	2	7	0	0
16	19151187	.	T	G	2	4	6	0	0	6	0	0
16	19151336	.	C	A	3	4	7	0	0	7	0	0
16	19151355	.	G	C	2	3	5	0	1	6	0	0
16	19151534	.	T	C	7	5	12	0	1	13	0	0
16	19151656	.	G	T	5	6	11	0	2	13	0	0
16	19151694	.	T	C	3	2	5	0	0	5	0	0
16	19539036	.	G	A	1	2	3	0	0	3	0	0
16	19539235	.	C	A	1	2	3	0	0	3	0	0
16	19733699	.	C	T	0	1	1	0	0	1	0	0
16	19840867	.	A	G	17	13	30	0	1	31	0	0
16	19841082	.	C	G	0	14	14	0	23	37	0	0
16	19841135	.	C	T	14	12	26	0	1	27	0	0
16	19841213	.	G	A	7	15	22	0	1	23	0	0
16	19841215	.	C	T	8	14	22	0	1	23	0	0
16	19841290	.	A	T	6	5	11	0	0	11	0	0
16	19841358	.	C	T	8	6	14	0	0	14	0	0
16	19841502	.	A	T	2	7	9	0	0	9	0	0
16	19841548	.	T	C	7	4	11	0	2	13	0	0
16	19841720	.	A	G	6	3	9	0	1	10	0	0
16	19841786	.	A	T	3	2	5	0	2	7	0	0
16	19841890	.	G	A	2	2	4	0	1	5	0	0
16	19842493	.	G	A	0	3	3	0	0	3	0	0
16	19853125	.	A	T	2	4	6	0	1	7	0	0
16	20151309	.	C	T	2	5	7	0	0	7	0	0
16	20151397	.	C	T	5	5	10	0	4	14	0	0
16	20151460	.	C	T	5	4	9	0	0	9	0	0
16	20151936	.	A	G	9	9	18	0	0	18	0	0
16	20151991	.	G	A	10	11	21	0	1	22	0	0
16	20152106	.	A	T	4	9	13	0	0	13	0	0
16	20152128	.	G	A	0	7	7	0	4	11	0	0
16	20152250	.	T	C	6	6	12	0	0	12	0	0
16	20152476	.	C	A	7	2	9	0	1	10	0	0
16	20164361	.	G	T	0	3	3	0	3	6	0	0
16	20164370	.	C	G	1	0	1	0	1	2	0	0
16	20265936	.	T	A	2	5	7	0	0	7	0	0
16	20266202	.	T	C	5	4	9	0	0	9	0	0
16	20266215	.	G	T	7	2	9	0	0	9	0	0
16	20267340	.	T	C	2	1	3	0	1	4	0	0
16	20324891	.	A	G	0	1	1	0	0	1	0	0
16	20328092	.	C	T	0	1	1	0	1	2	0	0
16	20512661	.	T	C	1	9	10	0	0	10	0	0
16	20514738	.	G	A	5	4	9	0	0	9	0	0
16	20792982	.	T	A	0	1	1	0	0	1	0	0
16	20806006	.	C	T	8	3	11	0	0	11	0	0
16	20806487	.	C	T	21	20	41	0	3	44	0	0
16	20806747	.	A	G	15	14	29	0	0	29	0	0
16	20815743	.	A	G	4	0	4	0	0	4	0	0
16	20826703	.	G	A	2	1	3	0	0	3	0	0
16	20836206	.	C	T	2	1	3	0	0	3	0	0
16	20855636	.	C	T	2	3	5	0	0	5	0	0
16	20874252	.	T	C	2	1	3	0	0	3	0	0
16	20889292	.	G	A	9	4	13	0	0	13	0	0
16	21038585	.	A	T	2	3	5	0	0	5	0	0
16	21038697	.	A	C	8	7	15	0	0	15	0	0
16	21038801	.	T	A	12	8	20	0	1	21	0	0
16	21038832	.	T	A	14	11	25	0	3	28	0	0
16	21038924	.	G	A	10	5	15	0	0	15	0	0
16	21417168	.	C	G	2	0	2	0	0	2	0	0
16	21442772	.	A	T	3	1	4	0	1	5	0	0
16	21443193	.	C	T	1	2	3	0	0	3	0	0
16	21443197	.	A	C	1	2	3	0	0	3	0	0
16	21444560	.	T	G	2	2	4	0	0	4	0	0
16	21444572	.	T	G	2	2	4	0	0	4	0	0
16	21548398	.	T	C	3	5	8	0	0	8	0	0
16	21548456	.	C	T	4	3	7	0	0	7	0	0
16	21548547	.	G	A	8	9	17	0	3	20	0	0
16	21548556	.	G	A	9	9	18	0	0	18	0	0
16	21548625	.	G	T	7	4	11	0	0	11	0	0
16	21548776	.	C	T	3	6	9	0	1	10	0	0
16	21548881	.	T	C	8	3	11	0	1	12	0	0
16	21548891	.	A	T	8	2	10	0	1	11	0	0
16	21549022	.	C	T	1	6	7	0	9	16	0	0
16	21549231	.	T	A	2	2	4	0	0	4	0	0
16	21549520	.	C	T	0	6	6	0	6	12	0	0
16	21549539	.	A	C	4	3	7	0	1	8	0	0
16	21652059	.	T	A	2	2	4	0	0	4	0	0
16	21655611	.	G	A	0	1	1	0	0	1	0	0
16	21673726	.	A	G	3	4	7	0	0	7	0	0
16	21673735	.	G	A	4	2	6	0	1	7	0	0
16	21734574	.	A	G	0	1	1	0	0	1	0	0
16	21763843	.	G	A	5	12	17	0	0	17	0	0
16	21769044	.	G	A	2	1	3	0	0	3	0	0
16	21780023	.	G	A	5	6	11	0	0	11	0	0
16	21782076	.	C	A	0	2	2	0	0	2	0	0
16	21892068	.	G	A	6	4	10	0	1	11	0	0
16	21892173	.	G	A	9	7	16	0	0	16	0	0
16	21892304	.	T	C	13	0	13	0	5	18	0	0
16	21892312	.	C	A	13	3	16	0	2	18	0	0
16	21898159	.	T	A	5	3	8	0	1	9	0	0
16	21898267	.	A	T	2	0	2	0	0	2	0	0
16	21898279	.	C	T	0	1	1	0	0	1	0	0
16	21899384	.	C	G	1	1	2	0	5	7	0	0
16	21900294	.	A	G	3	9	12	0	0	12	0	0
16	21900333	.	C	A	0	13	13	0	6	19	0	0
16	21901015	.	G	A	0	1	1	0	0	1	0	0
16	21903845	.	C	T	1	2	3	0	0	3	0	0
16	21905814	.	G	A	3	2	5	0	0	5	0	0
16	21913069	.	T	A	7	2	9	0	0	9	0	0
16	21913091	.	T	A	2	6	8	0	0	8	0	0
16	21913221	.	A	C	6	2	8	0	1	9	0	0
16	21913227	.	G	C	6	3	9	0	1	10	0	0
16	21917148	.	A	C	1	5	6	0	0	6	0	0
16	22363956	.	G	A	11	7	18	0	1	19	0	0
16	22363957	.	G	A	12	7	19	0	0	19	0	0
16	22364064	.	C	T	13	12	25	0	0	25	0	0
16	22364067	.	T	G	12	12	24	0	1	25	0	0
16	22364241	.	A	C	11	8	19	0	0	19	0	0
16	22673234	.	C	T	0	2	2	0	0	2	0	0
16	22673528	.	C	G	1	2	3	0	0	3	0	0
16	22675574	.	T	C	1	2	3	0	3	6	0	0
16	22675663	.	T	C	2	4	6	0	0	6	0	0
16	22676052	.	G	T	1	3	4	0	1	5	0	0
16	22676589	.	G	T	1	3	4	0	0	4	0	0
16	22676671	.	T	A	4	6	10	0	0	10	0	0
16	22677037	.	C	A	4	8	12	0	0	12	0	0
16	22677086	.	G	A	13	9	22	0	1	23	0	0
16	22677206	.	C	A	16	11	27	0	0	27	0	0
16	22677276	.	A	G	13	12	25	0	0	25	0	0
16	22677537	.	A	G	4	10	14	0	1	15	0	0
16	22677658	.	T	C	3	2	5	0	0	5	0	0
16	22750244	.	A	T	11	21	32	0	1	33	0	0
16	22750263	.	A	T	13	27	40	0	0	40	0	0
16	22750460	.	T	C	14	0	14	0	19	33	0	0
16	22750483	.	T	C	17	17	34	0	4	38	0	0
16	22750506	.	A	G	13	23	36	0	2	38	0	0
16	22750754	.	G	A	10	10	20	0	0	20	0	0
16	22750839	.	A	G	5	6	11	0	1	12	0	0
16	22751679	.	T	A	0	4	4	0	0	4	0	0
16	22752154	.	G	A	8	3	11	0	0	11	0	0
16	22753574	.	C	T	0	0	0	0	3	3	0	0
16	22753583	.	T	C	2	0	2	0	0	2	0	0
16	22753626	.	C	T	3	7	10	0	0	10	0	0
16	22753631	.	C	T	2	5	7	0	3	10	0	0
16	22754238	.	A	G	2	3	5	0	1	6	0	0
16	22757795	.	T	C	0	3	3	0	1	4	0	0
16	22782175	.	G	T	3	4	7	0	0	7	0	0
16	22782784	.	T	C	11	9	20	0	0	20	0	0
16	23963257	.	G	A	22	20	42	0	1	43	0	0
16	23963315	.	G	T	16	14	30	0	3	33	0	0
16	23973477	.	G	A	13	22	35	0	3	38	0	0
16	23973501	.	A	G	13	25	38	0	4	42	0	0
16	23973691	.	C	T	1	4	5	0	2	7	0	0
16	24190496	.	A	G	7	3	10	0	0	10	0	0
16	24190626	.	C	T	6	1	7	0	0	7	0	0
16	24190674	.	C	T	4	1	5	0	1	6	0	0
16	24190772	.	C	T	1	2	3	0	0	3	0	0
16	24191468	.	T	C	15	28	43	0	2	45	0	0
16	24191564	.	G	A	19	25	44	0	3	47	0	0
16	24194217	.	A	C	20	8	28	0	0	28	0	0
16	24261594	.	C	G	1	0	1	0	0	1	0	0
16	24552032	.	G	A	4	9	13	0	3	16	0	0
16	24552368	.	A	T	5	2	7	0	0	7	0	0
16	24552369	.	A	T	5	1	6	0	1	7	0	0
16	24552801	.	A	G	1	2	3	0	0	3	0	0
16	24552931	.	G	T	7	2	9	0	0	9	0	0
16	24553018	.	G	T	3	2	5	0	0	5	0	0
16	24553082	.	T	A	4	2	6	0	0	6	0	0
16	24553141	.	T	A	3	4	7	0	1	8	0	0
16	24590541	.	C	T	2	4	6	0	1	7	0	0
16	24590950	.	T	A	9	10	19	0	0	19	0	0
16	24590999	.	A	G	10	7	17	0	3	20	0	0
16	24591010	.	G	A	11	8	19	0	2	21	0	0
16	24591036	.	T	C	10	7	17	0	1	18	0	0
16	24591207	.	T	G	7	5	12	0	0	12	0	0
16	24591287	.	C	T	0	5	5	0	5	10	0	0
16	24591330	.	A	G	7	4	11	0	1	12	0	0
16	24591360	.	G	A	8	3	11	0	1	12	0	0
16	24591379	.	C	T	6	3	9	0	0	9	0	0
16	24591410	.	G	A	6	3	9	0	0	9	0	0
16	24591422	.	C	A	5	3	8	0	0	8	0	0
16	24591693	.	G	C	11	10	21	0	4	25	0	0
16	24591751	.	C	T	8	6	14	0	0	14	0	0
16	24596192	.	C	T	1	0	1	0	0	1	0	0
16	24601285	.	A	C	4	9	13	0	0	13	0	0
16	24601306	.	C	T	5	7	12	0	0	12	0	0
16	24632329	.	T	A	1	1	2	0	0	2	0	0
16	24639396	.	G	A	4	3	7	0	0	7	0	0
16	24642327	.	T	C	5	4	9	0	1	10	0	0
16	24645240	.	C	T	2	0	2	0	0	2	0	0
16	24645448	.	C	G	5	4	9	0	0	9	0	0
16	24645476	.	A	T	5	7	12	0	2	14	0	0
16	24645888	.	G	T	7	3	10	0	1	11	0	0
16	24645895	.	C	G	5	5	10	0	2	12	0	0
16	24646620	.	T	C	5	8	13	0	4	17	0	0
16	24646684	.	C	A	2	4	6	0	0	6	0	0
16	24729093	.	G	C	1	0	1	0	0	1	0	0
16	24732869	.	G	T	6	11	17	0	1	18	0	0
16	24733125	.	A	G	7	11	18	0	1	19	0	0
16	24733127	.	A	G	7	12	19	0	0	19	0	0
16	24991164	.	G	T	0	2	2	0	4	6	0	0
16	24991225	.	C	G	2	4	6	0	0	6	0	0
16	24991239	.	G	A	0	3	3	0	2	5	0	0
16	24991333	.	T	C	4	2	6	0	0	6	0	0
16	24991391	.	T	C	4	1	5	0	1	6	0	0
16	24991593	.	A	T	7	3	10	0	0	10	0	0
16	24991695	.	T	G	4	3	7	0	0	7	0	0
16	24991741	.	T	C	1	4	5	0	1	6	0	0
16	24991919	.	T	A	2	6	8	0	0	8	0	0
16	24992477	.	C	G	1	3	4	0	1	5	0	0
16	24992721	.	A	T	1	1	2	0	2	4	0	0
16	24992762	.	C	G	0	2	2	0	2	4	0	0
16	25038011	.	T	C	7	11	18	0	0	18	0	0
16	25038185	.	A	T	8	6	14	0	1	15	0	0
16	25038762	.	C	A	3	2	5	0	3	8	0	0
16	25070693	.	A	G	3	3	6	0	0	6	0	0
16	25071443	.	A	C	3	5	8	0	1	9	0	0
16	25071518	.	C	A	5	6	11	0	1	12	0	0
16	25071533	.	A	G	6	5	11	0	0	11	0	0
16	25071614	.	C	T	5	5	10	0	1	11	0	0
16	25072355	.	G	A	15	6	21	0	1	22	0	0
16	25078815	.	G	C	3	3	6	0	0	6	0	0
16	25080190	.	T	A	4	4	8	0	0	8	0	0
16	25080207	.	C	T	4	3	7	0	1	8	0	0
16	25080236	.	G	T	4	3	7	0	1	8	0	0
16	25080252	.	A	T	5	5	10	0	0	10	0	0
16	25080306	.	T	C	4	4	8	0	0	8	0	0
16	25080367	.	G	A	4	5	9	0	1	10	0	0
16	25080842	.	G	A	4	3	7	0	0	7	0	0
16	25104196	.	A	G	2	11	13	0	1	14	0	0
16	25104226	.	A	G	6	9	15	0	0	15	0	0
16	25104595	.	C	T	8	9	17	0	1	18	0	0
16	25104899	.	T	G	10	13	23	0	2	25	0	0
16	25104970	.	T	C	14	17	31	0	2	33	0	0
16	25111899	.	G	A	1	2	3	0	0	3	0	0
16	25111920	.	G	A	0	2	2	0	1	3	0	0
16	25123058	.	A	G	2	4	6	0	0	6	0	0
16	25123075	.	A	G	5	0	5	0	5	10	0	0
16	25123129	.	A	G	0	3	3	0	1	4	0	0
16	25123130	.	A	G	2	2	4	0	0	4	0	0
16	25123382	.	G	T	2	7	9	0	0	9	0	0
16	25123424	.	A	G	1	3	4	0	0	4	0	0
16	25123435	.	A	G	1	2	3	0	0	3	0	0
16	25123884	.	C	G	4	5	9	0	0	9	0	0
16	25124750	.	G	A	3	6	9	0	0	9	0	0
16	25124763	.	A	T	4	5	9	0	0	9	0	0
16	25161292	.	A	G	0	3	3	0	0	3	0	0
16	25161693	.	G	A	5	3	8	0	2	10	0	0
16	25161739	.	T	C	4	5	9	0	0	9	0	0
16	25161873	.	G	A	0	4	4	0	7	11	0	0
16	25162163	.	G	T	0	2	2	0	1	3	0	0
16	25162514	.	G	A	0	7	7	0	6	13	0	0
16	25162516	.	T	C	6	7	13	0	0	13	0	0
16	25162563	.	G	A	5	5	10	0	0	10	0	0
16	25164326	.	C	A	1	0	1	0	0	1	0	0
16	25168548	.	G	A	1	4	5	0	0	5	0	0
16	25169003	.	A	G	8	6	14	0	0	14	0	0
16	25169501	.	T	A	4	6	10	0	0	10	0	0
16	25169616	.	A	T	1	4	5	0	0	5	0	0
16	25232250	.	T	C	1	3	4	0	0	4	0	0
16	25232262	.	G	A	1	4	5	0	0	5	0	0
16	25275984	.	C	T	0	7	7	0	7	14	0	0
16	25276281	.	G	A	5	9	14	0	0	14	0	0
16	25285506	.	G	A	7	6	13	0	0	13	0	0
16	25285507	.	G	A	7	6	13	0	0	13	0	0
16	25308516	.	C	T	3	1	4	0	0	4	0	0
16	25311038	.	A	T	0	1	1	0	0	1	0	0
16	25311394	.	G	A	8	3	11	0	0	11	0	0
16	25311772	.	G	A	6	5	11	0	0	11	0	0
16	25314682	.	C	T	1	3	4	0	0	4	0	0
16	25314933	.	G	C	1	3	4	0	0	4	0	0
16	25314974	.	T	C	2	4	6	0	0	6	0	0
16	25314996	.	A	G	2	1	3	0	1	4	0	0
16	25317000	.	G	A	1	3	4	0	0	4	0	0
16	25334326	.	A	G	1	3	4	0	1	5	0	0
16	25334333	.	G	A	3	4	7	0	0	7	0	0
16	25354336	.	G	A	1	2	3	0	0	3	0	0
16	25354502	.	A	T	1	3	4	0	0	4	0	0
16	25357980	.	T	A	2	4	6	0	0	6	0	0
16	25357989	.	C	T	2	3	5	0	1	6	0	0
16	25360557	.	T	A	1	2	3	0	0	3	0	0
16	25360605	.	C	A	3	9	12	0	0	13	1	0
16	25373900	.	A	C	2	8	10	0	0	10	0	0
16	25373924	.	G	A	5	10	15	0	0	15	0	0
16	25374135	.	G	A	2	6	8	0	0	8	0	0
16	25374139	.	T	A	2	5	7	0	0	7	0	0
16	25374365	.	T	C	4	5	9	0	0	9	0	0
16	25374417	.	C	T	0	5	5	0	5	10	0	0
16	25374507	.	T	C	4	0	4	0	4	8	0	0
16	25374508	.	T	G	4	4	8	0	0	8	0	0
16	25374648	.	G	A	1	7	8	0	0	8	0	0
16	25375095	.	A	G	1	2	3	0	0	3	0	0
16	25395154	.	G	T	2	12	14	0	2	16	0	0
16	25395700	.	A	T	1	5	6	0	0	6	0	0
16	25395702	.	G	T	1	5	6	0	0	6	0	0
16	25399585	.	A	T	0	3	3	0	0	3	0	0
16	25399588	.	A	T	0	3	3	0	0	3	0	0
16	25399877	.	A	G	0	1	1	0	0	1	0	0
16	25504192	.	G	C	14	20	34	0	1	35	0	0
16	25504337	.	G	A	19	7	26	0	2	28	0	0
16	25504425	.	G	T	8	16	24	0	1	25	0	0
16	25504467	.	G	A	10	11	21	0	4	25	0	0
16	25504792	.	G	C	25	21	46	0	3	49	0	0
16	25504900	.	G	A	28	20	48	0	2	50	0	0
16	25527520	.	C	T	1	0	1	0	0	1	0	0
16	25527541	.	T	G	3	0	3	0	0	3	0	0
16	25555775	.	G	A	18	10	28	0	2	30	0	0
16	25558135	.	C	T	3	2	5	0	1	6	0	0
16	25558595	.	C	T	3	3	6	0	2	8	0	0
16	25642663	.	G	A	7	10	17	0	0	17	0	0
16	25643452	.	T	A	2	8	10	0	0	10	0	0
16	25644357	.	C	A	3	4	7	0	0	7	0	0
16	25673880	.	T	C	6	6	12	0	0	12	0	0
16	25683018	.	T	C	4	6	10	0	0	10	0	0
16	25698449	.	A	C	1	2	3	0	0	3	0	0
16	26141004	.	A	G	1	3	4	0	0	4	0	0
16	26141748	.	T	C	2	1	3	0	5	8	0	0
16	26141994	.	T	C	2	3	5	0	0	5	0	0
16	26142105	.	C	T	1	2	3	0	0	3	0	0
16	26142311	.	A	C	5	14	19	0	0	19	0	0
16	26146174	.	G	A	3	3	6	0	0	6	0	0
16	26234460	.	C	T	2	4	6	0	0	6	0	0
16	26234761	.	A	C	3	4	7	0	0	7	0	0
16	26235461	.	A	G	1	4	5	0	0	5	0	0
16	26236200	.	A	C	1	3	4	0	0	4	0	0
16	26236208	.	G	C	1	3	4	0	0	4	0	0
16	26380784	.	C	T	0	17	17	0	11	28	0	0
16	26380866	.	G	A	7	8	15	0	0	15	0	0
16	26381192	.	T	G	8	7	15	0	1	16	0	0
16	26381271	.	C	T	6	5	11	0	0	11	0	0
16	26381344	.	T	G	5	7	12	0	2	14	0	0
16	26381463	.	C	T	0	11	11	0	13	24	0	0
16	26381538	.	T	A	6	5	11	0	0	11	0	0
16	26382084	.	T	C	1	5	6	0	3	9	0	0
16	26382225	.	A	T	9	8	17	0	0	17	0	0
16	26382243	.	G	A	9	9	18	0	0	18	0	0
16	26382308	.	T	C	9	14	23	0	2	25	0	0
16	26382942	.	T	C	1	4	5	0	0	5	0	0
16	26383016	.	C	T	0	3	3	0	6	9	0	0
16	26445458	.	T	C	2	2	4	0	1	5	0	0
16	26445676	.	A	G	4	0	4	0	6	10	0	0
16	26445990	.	G	A	2	5	7	0	0	7	0	0
16	26446163	.	T	A	1	2	3	0	0	3	0	0
16	26510740	.	C	A	1	3	4	0	0	4	0	0
16	26643598	.	G	C	3	3	6	0	2	8	0	0
16	26702745	.	T	C	4	3	7	0	0	7	0	0
16	26702870	.	T	C	2	4	6	0	2	8	0	0
16	26706820	.	C	T	5	0	5	0	0	5	0	0
16	26710900	.	C	A	13	11	24	0	3	27	0	0
16	26710954	.	A	T	19	12	31	0	0	31	0	0
16	26710957	.	G	A	19	11	30	0	1	31	0	0
16	26713964	.	G	T	14	8	22	0	2	25	1	0
16	26717457	.	C	A	4	9	13	0	1	14	0	0
16	26816852	.	G	T	2	2	4	0	0	4	0	0
16	26817069	.	C	T	0	2	2	0	1	3	0	0
16	26817823	.	A	T	1	1	2	0	1	3	0	0
16	26850833	.	C	T	4	4	8	0	0	8	0	0
16	26850845	.	T	C	4	7	11	0	0	11	0	0
16	26850870	.	G	A	5	11	16	0	0	16	0	0
16	26850885	.	C	T	6	12	18	0	0	18	0	0
16	26851161	.	C	T	0	3	3	0	3	6	0	0
16	26851191	.	C	T	9	3	12	0	0	12	0	0
16	26855859	.	C	A	0	5	5	0	6	11	0	0
16	26855909	.	A	G	2	4	6	0	0	6	0	0
16	27100222	.	T	C	14	18	32	0	1	33	0	0
16	27127959	.	G	A	1	4	5	0	0	5	0	0
16	27136541	.	A	G	1	1	2	0	0	2	0	0
16	27216207	.	C	G	2	3	5	0	0	5	0	0
16	27216398	.	G	T	1	4	5	0	0	5	0	0
16	27224450	.	G	C	5	0	5	0	0	5	0	0
16	27225215	.	C	A	2	4	6	0	0	6	0	0
16	27231416	.	C	T	17	38	55	0	1	56	0	0
16	27368086	.	T	C	0	2	2	0	1	3	0	0
16	27368168	.	A	G	3	0	3	0	5	8	0	0
16	27368290	.	G	A	0	2	2	0	5	7	0	0
16	27369057	.	T	C	1	4	5	0	0	5	0	0
16	27417415	.	C	A	5	5	10	0	1	11	0	0
16	27417707	.	T	A	9	1	10	0	5	15	0	0
16	27417907	.	T	C	11	0	11	0	15	26	0	0
16	27428048	.	G	A	1	0	1	0	0	1	0	0
16	27508505	.	G	A	10	4	14	0	2	16	0	0
16	27513694	.	T	C	5	3	8	0	0	8	0	0
16	27522744	.	T	C	2	0	2	0	0	2	0	0
16	27524890	.	A	T	0	2	2	0	0	2	0	0
16	27524893	.	A	T	0	1	1	0	0	1	0	0
16	27529856	.	G	A	2	3	5	0	0	5	0	0
16	27548076	.	A	G	2	0	2	0	0	2	0	0
16	27554909	.	C	G	7	7	14	0	1	15	0	0
16	27555010	.	T	C	8	7	15	0	1	16	0	0
16	27555011	.	A	C	8	8	16	0	0	16	0	0
16	27555069	.	C	T	15	8	23	0	0	23	0	0
16	27555221	.	C	T	1	1	2	0	0	2	0	0
16	27558680	.	A	T	6	3	9	0	0	9	0	0
16	27562192	.	A	G	1	2	3	0	0	3	0	0
16	27578391	.	T	C	1	1	2	0	0	2	0	0
16	27578538	.	C	A	1	0	1	0	0	1	0	0
16	27578607	.	T	A	1	1	2	0	0	2	0	0
16	27621830	.	T	G	6	11	17	0	0	17	0	0
16	27622109	.	G	A	3	3	6	0	0	6	0	0
16	27626228	.	G	A	2	2	4	0	0	4	0	0
16	27626240	.	A	G	6	7	13	0	2	15	0	0
16	27628860	.	A	T	3	11	14	0	0	14	0	0
16	27629052	.	C	T	19	12	31	0	2	33	0	0
16	27629187	.	A	G	5	5	10	0	2	12	0	0
16	27629455	.	T	G	11	12	23	0	4	27	0	0
16	27629639	.	C	A	10	10	20	0	0	20	0	0
16	27629798	.	A	T	13	11	24	0	0	24	0	0
16	27630087	.	C	T	0	10	10	0	11	21	0	0
16	27630209	.	T	C	2	3	5	0	3	8	0	0
16	27630399	.	G	T	6	5	11	0	1	12	0	0
16	27630663	.	G	A	1	5	6	0	1	7	0	0
16	27630785	.	G	A	2	4	6	0	0	6	0	0
16	27632705	.	G	A	1	4	5	0	0	5	0	0
16	27660271	.	A	G	11	5	16	0	1	17	0	0
16	27660321	.	G	A	8	7	15	0	3	18	0	0
16	27660441	.	T	C	1	2	3	0	0	3	0	0
16	27660658	.	A	T	7	5	12	0	1	13	0	0
16	27660868	.	A	G	2	1	3	0	1	4	0	0
16	27660934	.	C	T	1	10	11	0	0	11	0	0
16	27661074	.	A	T	6	6	12	0	0	12	0	0
16	27669912	.	T	C	2	0	2	0	2	4	0	0
16	28112797	.	A	G	4	2	6	0	0	6	0	0
16	28276383	.	T	C	1	1	2	0	0	2	0	0
16	28280057	.	T	C	0	3	3	0	0	3	0	0
16	28370465	.	C	T	7	13	20	0	1	21	0	0
16	28370513	.	G	C	8	11	19	0	1	20	0	0
16	28370566	.	A	C	12	8	20	0	0	20	0	0
16	28370703	.	A	G	2	5	7	0	0	7	0	0
16	28370835	.	G	T	4	2	6	0	0	6	0	0
16	28370872	.	T	A	3	6	9	0	0	9	0	0
16	28371138	.	T	C	18	12	30	0	0	30	0	0
16	28371148	.	A	G	17	10	27	0	1	28	0	0
16	28573871	.	A	C	2	1	3	0	1	4	0	0
16	28573957	.	T	A	1	3	4	0	0	4	0	0
16	28574403	.	C	T	2	3	5	0	0	5	0	0
16	28574664	.	G	A	1	2	3	0	1	4	0	0
16	28580884	.	T	C	0	1	1	0	0	1	0	0
16	28591186	.	T	A	7	5	12	0	0	12	0	0
16	28591277	.	A	G	8	14	22	0	2	24	0	0
16	28591353	.	A	C	4	7	11	0	2	13	0	0
16	28591385	.	C	G	5	5	10	0	1	11	0	0
16	28591459	.	G	A	0	5	5	0	4	9	0	0
16	28591498	.	G	T	10	4	14	0	1	15	0	0
16	28592648	.	A	T	7	5	12	0	0	12	0	0
16	28592719	.	T	C	8	10	18	0	1	19	0	0
16	28592871	.	A	G	2	4	6	0	1	7	0	0
16	28593056	.	C	T	1	2	3	0	0	3	0	0
16	28593430	.	G	A	3	3	6	0	0	6	0	0
16	28593502	.	G	A	1	2	3	0	0	3	0	0
16	28593802	.	T	C	4	2	6	0	0	6	0	0
16	28593952	.	T	C	1	0	1	0	0	1	0	0
16	28599150	.	C	T	16	19	35	0	2	37	0	0
16	28626743	.	A	G	5	2	7	0	0	7	0	0
16	28627240	.	G	A	1	2	3	0	0	3	0	0
16	28627467	.	C	T	1	4	5	0	1	6	0	0
16	28627485	.	C	T	2	3	5	0	1	6	0	0
16	28627507	.	G	A	1	2	3	0	1	4	0	0
16	28842438	.	C	T	7	4	11	0	1	12	0	0
16	28990523	.	C	G	2	2	4	0	0	4	0	0
16	29012933	.	G	T	1	2	3	0	1	4	0	0
16	29012961	.	C	T	1	2	3	0	1	4	0	0
16	29013188	.	C	T	1	3	4	0	0	4	0	0
16	29014091	.	A	T	1	4	5	0	0	5	0	0
16	29014109	.	T	C	1	5	6	0	0	6	0	0
16	29017221	.	T	C	5	5	10	0	0	10	0	0
16	29019039	.	G	A	5	5	10	0	1	11	0	0
16	29020482	.	G	T	5	4	9	0	0	9	0	0
16	29022955	.	C	A	11	5	16	0	0	16	0	0
16	29022963	.	A	G	10	3	13	0	2	15	0	0
16	29023266	.	A	T	5	4	9	0	0	9	0	0
16	29024181	.	A	G	5	1	6	0	2	8	0	0
16	29024341	.	T	C	4	5	9	0	1	10	0	0
16	29024405	.	C	T	6	8	14	0	1	15	0	0
16	29024409	.	C	T	5	9	14	0	1	15	0	0
16	29030383	.	G	C	5	3	8	0	0	8	0	0
16	29052914	.	G	A	3	2	5	0	0	5	0	0
16	29052991	.	C	T	1	4	5	0	0	5	0	0
16	29053045	.	T	A	1	5	6	0	0	6	0	0
16	29053166	.	A	G	1	2	3	0	0	3	0	0
16	29053663	.	G	T	1	4	5	0	0	5	0	0
16	29053781	.	A	T	12	10	22	0	2	24	0	0
16	29053798	.	C	G	14	0	14	0	13	27	0	0
16	29053923	.	C	A	6	6	12	0	2	14	0	0
16	29073092	.	T	A	0	3	3	0	0	3	0	0
16	29073539	.	C	T	10	8	18	0	7	25	0	0
16	29073621	.	T	A	6	3	9	0	2	11	0	0
16	29074254	.	G	A	24	16	40	0	1	41	0	0
16	29074535	.	A	G	11	7	18	0	1	19	0	0
16	29074688	.	A	G	15	8	23	0	0	23	0	0
16	29075222	.	T	A	0	4	4	0	3	7	0	0
16	29075343	.	G	A	5	2	7	0	0	7	0	0
16	29075674	.	C	A	6	3	9	0	0	9	0	0
16	29075870	.	G	T	1	5	6	0	0	6	0	0
16	29076407	.	C	T	0	3	3	0	3	6	0	0
16	29076575	.	C	G	1	6	7	0	2	9	0	0
16	29222033	.	T	C	8	9	17	0	2	19	0	0
16	29222167	.	G	A	1	2	3	0	1	4	0	0
16	29225902	.	G	C	5	9	14	0	1	15	0	0
16	29266067	.	G	T	4	2	6	0	1	7	0	0
16	29266115	.	G	A	2	1	3	0	0	3	0	0
16	29266140	.	A	C	3	1	4	0	0	4	0	0
16	29310150	.	T	A	4	2	6	0	0	6	0	0
16	29310206	.	A	G	7	4	11	0	0	11	0	0
16	29310213	.	C	A	7	4	11	0	0	11	0	0
16	29310281	.	C	G	18	7	25	0	2	27	0	0
16	29310455	.	C	T	21	9	30	0	2	32	0	0
16	29310530	.	C	A	19	8	27	0	3	30	0	0
16	29311367	.	C	A	6	3	9	0	1	10	0	0
16	29311381	.	G	A	6	3	9	0	0	9	0	0
16	29311489	.	A	G	6	4	10	0	2	12	0	0
16	29320647	.	A	G	1	2	3	0	0	3	0	0
16	29371124	.	G	A	1	2	3	0	0	3	0	0
16	29380945	.	C	T	1	2	3	0	0	3	0	0
16	29381369	.	G	A	2	2	4	0	0	4	0	0
16	29383834	.	A	C	0	0	0	0	1	1	0	0
16	29384090	.	T	C	2	2	4	0	0	4	0	0
16	29384099	.	T	A	2	2	4	0	0	4	0	0
16	29384139	.	G	A	2	5	7	0	0	7	0	0
16	29384182	.	C	T	2	7	9	0	0	9	0	0
16	29384187	.	T	C	2	7	9	0	0	9	0	0
16	29407754	.	C	T	8	5	13	0	0	13	0	0
16	29408060	.	T	C	20	27	47	0	5	52	0	0
16	29408172	.	T	A	35	31	66	0	1	68	1	0
16	29408926	.	A	T	8	8	16	0	0	16	0	0
16	29409181	.	T	A	1	2	3	0	0	3	0	0
16	29409476	.	T	C	9	11	20	0	2	22	0	0
16	29409480	.	T	C	10	9	19	0	1	20	0	0
16	29409533	.	T	G	6	4	10	0	0	10	0	0
16	29409544	.	T	C	6	3	9	0	1	10	0	0
16	29409732	.	T	G	13	8	21	0	3	24	0	0
16	29409918	.	T	G	8	4	12	0	0	12	0	0
16	29410032	.	A	G	3	5	8	0	0	8	0	0
16	29410033	.	G	A	3	5	8	0	0	8	0	0
16	29410107	.	A	C	17	13	30	0	1	31	0	0
16	29410129	.	C	T	22	13	35	0	1	36	0	0
16	29410418	.	C	T	0	8	8	0	8	16	0	0
16	29410425	.	A	G	7	10	17	0	1	18	0	0
16	29410679	.	T	G	0	5	5	0	1	6	0	0
16	29410921	.	G	A	4	4	8	0	0	8	0	0
16	29411196	.	A	G	2	9	11	0	0	11	0	0
16	29411436	.	G	C	5	4	9	0	0	9	0	0
16	29413166	.	C	T	1	3	4	0	0	4	0	0
16	29456131	.	T	A	2	2	4	0	0	4	0	0
16	30268660	.	A	G	2	2	4	0	1	5	0	0
16	30521244	.	C	A	1	3	4	0	0	4	0	0
16	31261003	.	A	T	1	7	8	0	0	8	0	0
16	31548160	.	G	C	1	2	3	0	0	3	0	0
16	31602170	.	A	G	0	1	1	0	0	1	0	0
16	31608967	.	G	T	0	2	2	0	0	2	0	0
16	31609241	.	C	T	0	1	1	0	0	1	0	0
16	31610375	.	C	T	1	0	1	0	0	1	0	0
16	31615114	.	G	A	0	2	2	0	0	2	0	0
16	31762960	.	C	T	17	17	34	0	0	34	0	0
16	31763316	.	T	C	12	14	26	0	0	26	0	0
16	31763318	.	C	T	12	14	26	0	0	26	0	0
16	31763668	.	C	G	9	7	16	0	2	18	0	0
16	31763743	.	T	A	18	11	29	0	2	31	0	0
16	31763751	.	A	C	16	11	27	0	1	29	1	0
16	31763785	.	G	A	13	16	29	0	2	31	0	0
16	31763786	.	C	A	13	17	30	0	1	31	0	0
16	31763880	.	A	G	10	18	28	0	2	30	0	0
16	31764987	.	C	T	1	1	2	0	0	2	0	0
16	31766937	.	T	A	0	1	1	0	0	1	0	0
16	31767152	.	A	G	1	4	5	0	0	5	0	0
16	31767163	.	G	A	1	4	5	0	0	5	0	0
16	31768343	.	C	G	5	3	8	0	0	8	0	0
16	31768394	.	T	C	2	3	5	0	1	6	0	0
16	31768436	.	T	C	7	4	11	0	1	12	0	0
16	31769317	.	G	A	1	3	4	0	0	4	0	0
16	31769395	.	A	G	2	3	5	0	0	5	0	0
16	31815638	.	C	T	13	12	25	0	1	26	0	0
16	31815878	.	G	A	10	5	15	0	0	15	0	0
16	31816005	.	C	A	7	4	11	0	1	12	0	0
16	31816336	.	C	T	0	3	3	0	5	8	0	0
16	31816596	.	C	T	4	13	17	0	1	18	0	0
16	31827642	.	T	A	4	8	12	0	0	12	0	0
16	31827703	.	C	T	7	8	15	0	0	15	0	0
16	31832606	.	A	G	14	1	15	0	20	35	0	0
16	31859112	.	A	G	3	6	9	0	0	9	0	0
16	31859227	.	T	C	11	5	16	0	1	17	0	0
16	31859341	.	C	T	9	14	23	0	1	24	0	0
16	31859371	.	T	C	13	16	29	0	1	30	0	0
16	31859416	.	T	C	7	13	20	0	3	23	0	0
16	31859425	.	C	T	4	11	15	0	4	19	0	0
16	31859686	.	G	A	4	7	11	0	0	11	0	0
16	31868443	.	G	A	15	16	31	0	7	38	0	0
16	31922892	.	A	G	5	3	8	0	0	8	0	0
16	31923083	.	G	A	26	19	45	0	1	46	0	0
16	31923435	.	A	G	27	33	60	0	2	62	0	0
16	31924485	.	T	C	20	25	45	0	0	45	0	0
16	31924501	.	A	C	22	23	45	0	2	47	0	0
16	31925727	.	G	A	0	2	2	0	0	2	0	0
16	31959156	.	G	A	6	3	9	0	0	9	0	0
16	31959179	.	T	G	4	3	7	0	1	8	0	0
16	31959225	.	G	A	2	3	5	0	0	5	0	0
16	31959231	.	A	T	2	2	4	0	1	5	0	0
16	31959612	.	G	A	4	3	7	0	0	7	0	0
16	31960037	.	G	A	0	8	8	0	9	17	0	0
16	31960064	.	G	C	7	7	14	0	1	15	0	0
16	31960145	.	C	T	9	8	17	0	3	20	0	0
16	31960152	.	C	T	5	6	11	0	5	16	0	0
16	32011649	.	C	T	1	4	5	0	0	5	0	0
16	32013272	.	G	A	1	2	3	0	0	3	0	0
16	32025648	.	T	A	2	8	10	0	2	12	0	0
16	32025978	.	G	A	5	7	12	0	0	12	0	0
16	32025987	.	T	A	6	7	13	0	1	14	0	0
16	32026063	.	G	A	0	4	4	0	11	15	0	0
16	32026105	.	T	A	8	4	12	0	0	12	0	0
16	32026154	.	T	G	1	3	4	0	1	5	0	0
16	32052004	.	T	G	3	1	4	0	0	4	0	0
16	32052283	.	T	A	1	1	2	0	0	2	0	0
16	32052307	.	T	C	2	5	7	0	0	7	0	0
16	32052328	.	T	A	5	6	11	0	0	11	0	0
16	32052404	.	G	T	0	4	4	0	3	7	0	0
16	32055726	.	T	G	9	6	15	0	1	16	0	0
16	32057809	.	T	C	12	11	23	0	0	23	0	0
16	32057853	.	G	A	0	6	6	0	10	16	0	0
16	32058167	.	T	G	2	2	4	0	0	4	0	0
16	32073301	.	A	C	3	4	7	0	2	9	0	0
16	32073507	.	A	C	5	5	10	0	0	10	0	0
16	32073555	.	A	G	7	7	14	0	0	14	0	0
16	32073760	.	G	A	4	4	8	0	1	9	0	0
16	32074041	.	G	A	5	8	13	0	0	13	0	0
16	32074293	.	T	A	10	8	18	0	0	18	0	0
16	32074294	.	A	G	9	6	15	0	3	18	0	0
16	32080069	.	G	T	0	6	6	0	7	13	0	0
16	32080099	.	G	A	1	4	5	0	0	5	0	0
16	32080196	.	T	C	1	5	6	0	2	8	0	0
16	32080206	.	T	C	1	7	8	0	0	8	0	0
16	32080306	.	T	A	9	2	11	0	2	13	0	0
16	32080508	.	T	A	10	8	18	0	2	20	0	0
16	32082589	.	G	A	1	1	2	0	0	2	0	0
16	32082597	.	G	A	1	2	3	0	0	3	0	0
16	32082642	.	G	A	1	1	2	0	3	5	0	0
16	32085319	.	T	A	0	1	1	0	0	1	0	0
16	32086136	.	C	T	3	3	6	0	0	6	0	0
16	32088580	.	T	A	1	1	2	0	0	2	0	0
16	32090349	.	C	T	15	4	19	0	2	21	0	0
16	32090425	.	G	C	15	11	26	0	1	27	0	0
16	32110659	.	A	G	13	9	22	0	0	22	0	0
16	32111246	.	G	T	7	16	23	0	2	25	0	0
16	32113155	.	G	A	7	3	10	0	0	10	0	0
16	32113218	.	G	A	2	2	4	0	0	4	0	0
16	32117345	.	T	A	3	1	4	0	0	4	0	0
16	32119581	.	C	A	1	3	4	0	0	4	0	0
16	32119618	.	C	T	4	2	6	0	0	6	0	0
16	32120138	.	G	T	3	3	6	0	2	8	0	0
16	32120141	.	T	C	4	0	4	0	4	8	0	0
16	32120173	.	G	A	2	5	7	0	0	7	0	0
16	32141544	.	A	G	1	0	1	0	4	5	0	0
16	32141565	.	A	C	2	2	4	0	0	4	0	0
16	32144337	.	T	C	2	3	5	0	1	6	0	0
16	32144989	.	T	C	2	6	8	0	0	8	0	0
16	32145160	.	T	A	4	3	7	0	0	7	0	0
16	32145636	.	A	G	3	8	11	0	1	12	0	0
16	32197969	.	C	T	0	2	2	0	0	2	0	0
16	32274935	.	G	A	0	1	1	0	0	1	0	0
16	32275601	.	T	A	5	4	9	0	0	9	0	0
16	32275628	.	A	T	3	2	5	0	1	6	0	0
16	32561618	.	T	C	1	4	5	0	1	6	0	0
16	32562817	.	A	T	2	1	3	0	1	4	0	0
16	33004366	.	A	T	2	2	4	0	0	4	0	0
16	33004387	.	C	T	3	2	5	0	1	6	0	0
16	33102463	.	C	T	42	12	54	0	3	57	0	0
16	33735849	.	A	T	1	2	3	0	0	3	0	0
16	33736174	.	A	T	1	3	4	0	0	4	0	0
16	33736196	.	A	C	1	4	5	0	0	5	0	0
16	33774324	.	T	G	2	2	4	0	0	4	0	0
16	33923421	.	G	T	1	3	4	0	0	4	0	0
16	33923448	.	G	T	5	3	8	0	0	8	0	0
16	33923514	.	G	A	3	4	7	0	1	8	0	0
16	33925356	.	G	A	0	5	5	0	3	8	0	0
16	33926074	.	C	T	1	2	3	0	0	3	0	0
16	33933213	.	C	T	2	1	3	0	0	3	0	0
16	33933496	.	G	C	4	2	6	0	0	6	0	0
16	33933498	.	C	T	2	4	6	0	0	6	0	0
16	33933732	.	G	A	0	2	2	0	2	4	0	0
16	33939824	.	T	C	1	1	2	0	0	2	0	0
16	33940098	.	G	A	2	3	5	0	0	5	0	0
16	33940122	.	G	A	1	4	5	0	0	5	0	0
16	33940140	.	T	C	0	5	5	0	0	5	0	0
16	33940379	.	T	A	5	6	11	0	1	12	0	0
16	33985050	.	G	T	0	10	10	0	6	16	0	0
16	33985362	.	C	T	3	8	11	0	0	11	0	0
16	33986179	.	A	T	16	6	22	0	2	24	0	0
16	33986452	.	T	G	23	17	40	0	2	42	0	0
16	33989933	.	G	A	0	2	2	0	1	3	0	0
16	34004562	.	G	A	0	4	4	0	4	8	0	0
16	34004595	.	T	C	6	5	11	0	0	11	0	0
16	34004862	.	C	T	1	2	3	0	0	3	0	0
16	34005290	.	C	T	7	6	13	0	1	14	0	0
16	34005415	.	C	T	1	4	5	0	1	6	0	0
16	34005500	.	C	A	3	5	8	0	0	8	0	0
16	34005669	.	C	T	4	5	9	0	0	9	0	0
16	34005686	.	C	T	4	6	10	0	0	10	0	0
16	34005812	.	T	A	12	5	17	0	0	17	0	0
16	34005981	.	A	G	4	2	6	0	0	6	0	0
16	34006020	.	G	C	3	4	7	0	0	7	0	0
16	34006108	.	A	G	0	2	2	0	0	2	0	0
16	34055534	.	T	C	1	2	3	0	0	3	0	0
16	34055599	.	T	A	1	3	4	0	0	4	0	0
16	34173331	.	G	A	1	1	2	0	1	3	0	0
16	34185906	.	A	T	5	3	8	0	2	10	0	0
16	34200704	.	C	T	0	4	4	0	0	4	0	0
16	34201023	.	A	G	3	5	8	0	0	8	0	0
16	34208582	.	T	C	5	0	5	0	6	11	0	0
16	34208696	.	A	G	7	6	13	0	1	14	0	0
16	34212477	.	A	G	4	4	8	0	1	9	0	0
16	34212516	.	A	G	7	5	12	0	0	12	0	0
16	34212565	.	G	A	5	4	9	0	2	11	0	0
16	34212567	.	G	C	7	3	10	0	1	11	0	0
16	34222439	.	T	G	0	3	3	0	1	4	0	0
16	34225472	.	G	A	1	2	3	0	0	3	0	0
16	34321568	.	A	T	4	14	18	0	0	18	0	0
16	34322036	.	G	T	4	7	11	0	0	11	0	0
16	34322346	.	G	A	9	16	25	0	1	26	0	0
16	34322372	.	C	T	0	17	17	0	12	29	0	0
16	34331489	.	A	G	1	3	4	0	1	5	0	0
16	34337976	.	A	T	6	5	11	0	1	12	0	0
16	34338475	.	A	G	4	3	7	0	0	7	0	0
16	34339432	.	A	T	4	1	5	0	2	7	0	0
16	34500167	.	A	G	4	2	6	0	0	6	0	0
16	34500199	.	A	G	1	2	3	0	1	4	0	0
16	34500507	.	T	C	3	8	11	0	1	12	0	0
16	34500899	.	G	A	7	8	15	0	3	18	0	0
16	34501348	.	C	T	10	8	18	0	1	19	0	0
16	34501380	.	C	T	13	9	22	0	0	22	0	0
16	34501496	.	G	A	0	8	8	0	15	23	0	0
16	34525621	.	C	A	15	9	24	0	6	31	1	0
16	34526092	.	C	G	27	30	57	0	4	61	0	0
16	34526093	.	A	C	21	32	53	0	7	61	1	0
16	34526795	.	A	T	31	33	64	0	1	66	1	0
16	34526926	.	A	T	25	22	47	0	16	63	0	0
16	35409483	.	C	T	0	12	12	0	25	37	0	0
16	35409783	.	G	A	5	1	6	0	0	6	0	0
16	35414455	.	A	G	5	1	6	0	0	6	0	0
16	35414470	.	T	C	3	1	4	0	0	4	0	0
16	35414991	.	C	T	2	5	7	0	0	7	0	0
16	35416113	.	A	G	6	4	10	0	0	10	0	0
16	35416786	.	A	G	4	3	7	0	1	8	0	0
16	35536574	.	C	A	5	10	15	0	1	16	0	0
16	35536576	.	G	A	0	10	10	0	6	16	0	0
16	35536848	.	G	A	4	7	11	0	0	11	0	0
16	35536900	.	A	G	8	2	10	0	1	11	0	0
16	35536960	.	T	C	13	7	20	0	2	22	0	0
16	35536990	.	C	T	9	14	23	0	0	23	0	0
16	35537153	.	G	A	9	9	18	0	0	18	0	0
16	35537270	.	C	A	20	15	35	0	1	36	0	0
16	35556192	.	C	T	0	2	2	0	4	6	0	0
16	35556303	.	C	T	1	3	4	0	0	4	0	0
16	35661979	.	A	G	1	2	3	0	0	3	0	0
16	35662078	.	T	G	1	1	2	0	0	2	0	0
16	35743849	.	A	T	1	1	2	0	0	2	0	0
16	35750714	.	T	A	5	9	14	0	0	14	0	0
16	35752670	.	C	T	3	7	10	0	2	12	0	0
16	35752785	.	T	C	13	11	24	0	1	25	0	0
16	35773005	.	A	G	1	20	21	0	0	21	0	0
16	36074270	.	C	A	2	2	4	0	0	4	0	0
16	36074772	.	T	G	1	2	3	0	0	3	0	0
16	36075471	.	G	A	7	6	13	0	3	16	0	0
16	36075478	.	T	A	11	5	16	0	1	17	0	0
16	36075677	.	C	A	6	4	10	0	2	12	0	0
16	36075999	.	A	G	4	3	7	0	0	7	0	0
16	36076082	.	G	A	6	5	11	0	1	12	0	0
16	36080364	.	C	T	5	2	7	0	0	7	0	0
16	36080376	.	A	C	4	2	6	0	0	6	0	0
16	36150707	.	C	T	0	4	4	0	1	5	0	0
16	36159928	.	T	C	7	4	11	0	1	12	0	0
16	36162013	.	C	T	4	14	18	0	2	20	0	0
16	36162201	.	A	G	5	5	10	0	1	11	0	0
16	36162584	.	G	C	0	6	6	0	10	16	0	0
16	36162650	.	T	C	11	11	22	0	1	23	0	0
16	36162727	.	A	G	10	12	22	0	0	22	0	0
16	36162754	.	A	G	10	12	22	0	0	22	0	0
16	36162938	.	G	T	12	5	17	0	1	18	0	0
16	36163005	.	G	A	9	10	19	0	3	22	0	0
16	36163006	.	A	C	9	12	21	0	1	22	0	0
16	36168251	.	C	T	4	4	8	0	1	9	0	0
16	36168317	.	G	C	15	5	20	0	0	20	0	0
16	36168416	.	T	C	6	6	12	0	0	12	0	0
16	36168450	.	A	T	5	4	9	0	0	9	0	0
16	36168510	.	A	T	4	8	12	0	0	12	0	0
16	36168575	.	T	G	3	2	5	0	1	6	0	0
16	36169150	.	T	C	2	4	6	0	1	7	0	0
16	36169568	.	G	T	1	3	4	0	0	4	0	0
16	36172961	.	A	G	2	0	2	0	0	2	0	0
16	36172982	.	C	T	2	0	2	0	1	3	0	0
16	36721560	.	A	T	7	7	14	0	3	17	0	0
16	36721589	.	T	G	7	9	16	0	0	16	0	0
16	36724010	.	C	G	0	6	6	0	6	12	0	0
16	36729322	.	A	T	3	2	5	0	0	5	0	0
16	36729373	.	A	G	6	3	9	0	2	11	0	0
16	36731307	.	A	G	3	6	9	0	3	12	0	0
16	36766180	.	T	G	17	12	29	0	0	30	1	0
16	36766467	.	G	T	3	7	10	0	2	12	0	0
16	36926775	.	C	A	2	0	2	0	0	2	0	0
16	36926779	.	A	C	1	0	1	0	0	1	0	0
16	36928169	.	A	T	1	2	3	0	0	3	0	0
16	36928179	.	A	C	1	2	3	0	0	3	0	0
16	36928429	.	A	G	1	2	3	0	1	4	0	0
16	36931728	.	T	C	12	5	17	0	0	17	0	0
16	36931822	.	T	C	6	3	9	0	1	10	0	0
16	36934191	.	T	A	3	2	5	0	1	6	0	0
16	36934398	.	G	C	4	2	6	1	2	9	0	0
16	36940045	.	C	T	2	3	5	0	0	5	0	0
16	36974719	.	T	C	1	0	1	0	0	1	0	0
16	36975141	.	G	A	3	6	9	0	0	9	0	0
16	36975146	.	C	T	0	5	5	0	2	7	0	0
16	36975318	.	T	A	3	6	9	0	0	9	0	0
16	36976721	.	A	G	8	5	13	0	0	13	0	0
16	36977387	.	A	G	1	2	3	0	0	3	0	0
16	36979518	.	G	A	10	5	15	0	0	15	0	0
16	36979521	.	A	G	10	4	14	0	1	15	0	0
16	37167545	.	T	A	1	8	9	0	0	9	0	0
16	37167784	.	C	G	5	3	8	0	0	8	0	0
16	37306905	.	G	A	2	2	4	0	0	4	0	0
16	37617738	.	T	C	6	6	12	0	0	12	0	0
16	37627762	.	G	A	0	15	15	0	12	27	0	0
16	37627997	.	T	G	12	29	41	0	2	44	1	0
16	37948242	.	C	G	1	4	5	0	0	5	0	0
16	37948624	.	G	A	1	2	3	0	1	4	0	0
16	37948625	.	G	A	1	3	4	0	0	4	0	0
16	38135699	.	T	C	3	3	6	0	0	6	0	0
16	38135763	.	A	G	4	2	6	0	1	7	0	0
16	38136117	.	C	T	7	7	14	0	1	15	0	0
16	38136278	.	C	T	11	8	19	0	0	19	0	0
16	38136317	.	G	A	10	11	21	0	1	22	0	0
16	38136346	.	C	T	11	7	18	0	1	19	0	0
16	38136491	.	G	C	8	13	21	0	2	23	0	0
16	38157102	.	T	A	1	2	3	0	0	3	0	0
16	38199647	.	G	A	3	5	8	0	1	9	0	0
16	38351061	.	T	A	0	1	1	0	1	2	0	0
16	38355299	.	G	A	3	6	9	0	0	9	0	0
16	38454535	.	A	G	2	4	6	0	1	7	0	0
16	38556912	.	G	A	10	15	25	0	1	26	0	0
16	38556922	.	C	G	0	15	15	0	14	29	0	0
16	38568644	.	G	C	11	5	16	0	0	16	0	0
16	38729548	.	G	A	4	10	14	0	0	14	0	0
16	38729551	.	G	T	0	4	4	0	10	14	0	0
16	38943253	.	C	T	0	1	1	0	0	1	0	0
16	38943547	.	A	G	3	0	3	0	6	9	0	0
16	39154953	.	G	A	0	1	1	0	1	2	0	0
16	39157751	.	C	A	6	8	14	0	1	15	0	0
16	39157885	.	T	A	1	3	4	0	0	4	0	0
16	39160458	.	A	C	1	1	2	0	0	2	0	0
16	39162786	.	C	T	6	10	16	0	1	17	0	0
16	39164213	.	G	A	0	1	1	0	0	1	0	0
16	39166773	.	C	T	19	17	36	0	1	37	0	0
16	39166854	.	C	T	22	24	46	0	1	47	0	0
16	39167028	.	C	A	16	8	24	0	0	24	0	0
16	39167088	.	C	T	9	11	20	0	1	21	0	0
16	39185580	.	G	A	9	5	14	0	1	15	0	0
16	39238368	.	A	G	1	3	4	0	0	4	0	0
16	39238437	.	A	C	1	0	1	0	4	5	0	0
16	39244286	.	T	C	8	9	17	0	2	19	0	0
16	39248745	.	T	A	3	2	5	0	0	5	0	0
16	39248765	.	G	C	1	3	4	0	1	5	0	0
16	39248811	.	C	G	3	2	5	0	0	5	0	0
16	39248813	.	T	A	2	2	4	0	1	5	0	0
16	39248976	.	G	A	5	7	12	0	0	12	0	0
16	39249056	.	G	A	2	2	4	0	0	4	0	0
16	39249104	.	A	G	4	2	6	0	0	6	0	0
16	39249527	.	A	T	2	1	3	0	0	3	0	0
16	39271394	.	G	C	3	2	5	0	0	5	0	0
16	39323716	.	C	T	1	3	4	0	0	4	0	0
16	39362312	.	G	T	0	3	3	0	1	4	0	0
16	39372735	.	G	C	0	7	7	0	11	18	0	0
16	39372780	.	C	A	6	5	11	0	0	11	0	0
16	39382047	.	C	G	9	7	16	0	0	16	0	0
16	39382084	.	C	T	11	9	20	0	0	20	0	0
16	39382098	.	G	A	10	8	18	0	0	18	0	0
16	39382208	.	T	C	4	4	8	0	1	9	0	0
16	39382467	.	C	G	5	8	13	0	0	13	0	0
16	39382482	.	G	A	1	8	9	0	1	10	0	0
16	39385348	.	G	A	1	3	4	0	0	4	0	0
16	39385353	.	C	G	1	0	1	0	3	4	0	0
16	39386184	.	T	C	19	9	28	0	3	31	0	0
16	39386239	.	T	A	13	17	30	0	0	30	0	0
16	39386915	.	C	T	9	4	13	0	1	14	0	0
16	39390139	.	T	C	8	0	8	0	13	21	0	0
16	39390175	.	G	A	9	6	15	0	0	15	0	0
16	39393370	.	A	G	1	3	4	0	0	4	0	0
16	39394630	.	A	G	3	5	8	0	2	10	0	0
16	40073960	.	C	T	1	4	5	0	0	5	0	0
16	40153135	.	A	T	0	2	2	0	1	3	0	0
16	40153313	.	G	C	2	5	7	0	1	8	0	0
16	40343747	.	T	C	0	2	2	0	1	3	0	0
16	40353892	.	A	G	2	4	6	0	1	7	0	0
16	40495482	.	C	T	0	3	3	0	2	5	0	0
16	40503994	.	G	A	1	2	3	0	0	3	0	0
16	40954866	.	T	C	3	5	8	0	0	8	0	0
16	40954983	.	A	C	5	8	13	0	1	14	0	0
16	40955515	.	G	T	11	6	17	0	0	17	0	0
16	40955525	.	C	T	8	8	16	0	3	19	0	0
16	41029588	.	G	A	0	1	1	0	0	1	0	0
16	41030017	.	A	C	8	6	14	0	3	17	0	0
16	41030137	.	A	G	12	6	18	0	1	19	0	0
16	41030560	.	T	C	3	2	5	0	0	5	0	0
16	41112493	.	C	T	3	9	12	0	2	14	0	0
16	41112571	.	T	C	13	7	20	0	1	21	0	0
16	41112861	.	G	C	1	0	1	0	5	6	0	0
16	41113698	.	A	T	0	2	2	0	0	2	0	0
16	41345674	.	A	T	14	11	25	0	0	25	0	0
16	41345826	.	G	T	9	4	13	0	0	13	0	0
16	41346007	.	C	A	0	7	7	0	11	18	0	0
16	41353140	.	G	A	1	8	9	0	1	10	0	0
16	41468848	.	T	G	2	6	8	0	0	8	0	0
16	41469008	.	G	A	4	2	6	0	0	6	0	0
16	41469130	.	T	A	2	4	6	0	0	6	0	0
16	41469305	.	A	G	1	1	2	0	0	2	0	0
16	41469329	.	G	A	1	4	5	0	2	7	0	0
16	41469390	.	A	C	2	2	4	0	0	4	0	0
16	41473020	.	C	T	1	2	3	0	0	3	0	0
16	41532971	.	T	A	1	2	3	0	0	3	0	0
16	41532997	.	A	C	1	2	3	0	0	3	0	0
16	41533016	.	T	C	1	1	2	0	0	2	0	0
16	41685952	.	T	C	3	2	5	0	0	5	0	0
16	41691555	.	C	A	0	1	1	0	0	1	0	0
16	41717666	.	G	A	0	6	6	0	4	10	0	0
16	41720587	.	T	C	0	1	1	0	0	1	0	0
16	41732009	.	G	T	2	2	4	0	0	4	0	0
16	41732031	.	G	T	0	2	2	0	2	4	0	0
16	41732067	.	T	C	1	1	2	0	2	4	0	0
16	41732262	.	T	C	3	3	6	0	1	7	0	0
16	41732295	.	G	T	3	3	6	0	0	6	0	0
16	41740924	.	A	G	2	1	3	0	3	6	0	0
16	41741050	.	C	T	0	5	5	0	2	7	0	0
16	41741199	.	A	T	2	2	4	0	0	4	0	0
16	41794900	.	C	A	0	12	12	0	17	30	1	0
16	41873797	.	G	A	1	2	3	0	0	3	0	0
16	41891572	.	C	T	3	11	14	0	3	17	0	0
16	41891662	.	A	C	4	6	10	0	0	10	0	0
16	41896361	.	G	A	6	8	14	0	1	15	0	0
16	41897244	.	A	G	5	5	10	0	2	12	0	0
16	41897332	.	A	G	6	8	14	0	1	15	0	0
16	41897347	.	G	A	8	9	17	0	0	17	0	0
16	41897375	.	A	T	8	6	14	0	1	15	0	0
16	41897452	.	C	A	8	8	16	0	0	16	0	0
16	41903475	.	A	T	12	5	17	0	1	18	0	0
16	41903686	.	G	A	11	7	18	0	1	19	0	0
16	41903770	.	T	C	6	9	15	0	0	15	0	0
16	41903801	.	T	G	9	7	16	0	0	16	0	0
16	41903957	.	T	C	5	14	19	0	0	19	0	0
16	41904121	.	T	G	6	5	11	0	0	11	0	0
16	41904209	.	T	C	7	7	14	0	1	15	0	0
16	41904261	.	G	A	11	7	18	0	0	18	0	0
16	41904430	.	C	A	11	7	18	0	0	18	0	0
16	41904440	.	C	A	1	6	7	0	9	16	0	0
16	41904650	.	G	A	9	3	12	0	0	12	0	0
16	41904879	.	A	T	2	3	5	0	0	5	0	0
16	41904961	.	A	G	6	4	10	0	0	10	0	0
16	41905631	.	A	G	1	5	6	0	1	7	0	0
16	41905666	.	A	G	2	2	4	0	0	4	0	0
16	41905682	.	G	T	4	2	6	0	0	6	0	0
16	41905807	.	G	C	4	2	6	0	2	8	0	0
16	41916819	.	A	G	2	0	2	0	0	2	0	0
16	42072207	.	T	A	9	16	25	0	1	26	0	0
16	42072719	.	A	C	10	12	22	0	2	24	0	0
16	42073086	.	A	G	1	2	3	0	0	3	0	0
16	42083039	.	G	A	1	1	2	0	0	2	0	0
16	42156594	.	C	T	2	2	4	0	0	4	0	0
16	42177840	.	C	T	1	2	3	0	0	3	0	0
16	42178002	.	C	T	0	2	2	0	9	11	0	0
16	42178012	.	A	G	9	2	11	0	0	11	0	0
16	42179879	.	C	A	10	2	12	0	1	13	0	0
16	42186022	.	G	A	1	3	4	0	0	4	0	0
16	42186043	.	A	T	1	3	4	0	0	4	0	0
16	42322458	.	T	G	31	44	75	0	0	75	0	0
16	42373933	.	A	C	15	12	27	0	1	28	0	0
16	42374020	.	C	T	0	12	12	0	7	19	0	0
16	42374080	.	G	T	5	12	17	0	4	21	0	0
16	42374254	.	C	T	8	12	20	0	1	21	0	0
16	42374290	.	G	A	15	11	26	0	4	30	0	0
16	42374425	.	A	G	4	12	16	0	1	17	0	0
16	42374434	.	A	C	3	11	14	0	1	15	0	0
16	42423761	.	A	G	7	6	13	0	5	18	0	0
16	42424240	.	G	A	7	10	17	0	1	18	0	0
16	42424348	.	T	C	4	5	9	0	0	9	0	0
16	42424352	.	G	A	4	5	9	0	0	9	0	0
16	42424504	.	C	A	4	5	9	0	1	10	0	0
16	42424505	.	A	C	5	5	10	0	0	10	0	0
16	42424653	.	G	C	1	2	3	0	0	3	0	0
16	42424762	.	G	A	4	5	9	0	1	10	0	0
16	42472715	.	C	T	2	6	8	0	0	8	0	0
16	42482418	.	A	T	0	1	1	0	2	3	0	0
16	42487947	.	A	G	2	4	6	0	3	9	0	0
16	42490255	.	C	T	5	4	9	0	0	9	0	0
16	42490264	.	T	C	5	5	10	0	0	10	0	0
16	42493796	.	G	C	0	17	17	0	13	30	0	0
16	42493900	.	A	T	12	2	14	0	1	15	0	0
16	42494084	.	G	A	0	5	5	0	7	12	0	0
16	42494143	.	A	T	7	6	13	0	1	14	0	0
16	42842991	.	G	C	17	14	31	0	0	31	0	0
16	42842995	.	A	G	17	14	31	0	0	31	0	0
16	42843128	.	G	A	3	8	11	0	1	12	0	0
16	42900326	.	T	G	5	3	8	0	0	10	2	0
16	42900334	.	G	A	0	7	7	0	3	10	0	0
16	42900598	.	G	A	0	4	4	0	2	6	0	0
16	42938992	.	G	T	4	5	9	0	2	11	0	0
16	42939088	.	C	A	4	3	7	0	0	7	0	0
16	42939097	.	A	G	3	4	7	0	0	7	0	0
16	42939124	.	T	A	6	5	11	0	0	11	0	0
16	42939343	.	C	T	0	10	10	0	13	23	0	0
16	42939351	.	T	C	11	10	21	0	2	23	0	0
16	42939411	.	G	C	0	2	2	0	5	7	0	0
16	42939479	.	A	G	11	13	24	0	2	26	0	0
16	42939480	.	C	T	0	9	9	0	17	26	0	0
16	42939561	.	G	C	13	8	21	0	0	21	0	0
16	42939695	.	A	G	1	5	6	0	0	6	0	0
16	42940336	.	A	G	3	3	6	0	0	6	0	0
16	42941322	.	C	A	1	3	4	0	0	4	0	0
16	43001246	.	G	C	5	0	5	0	10	15	0	0
16	43003080	.	A	G	3	7	10	0	0	10	0	0
16	43028153	.	T	A	5	5	10	0	0	11	1	0
16	43028156	.	G	A	5	6	11	0	0	11	0	0
16	43028295	.	T	C	7	4	11	0	1	12	0	0
16	43028303	.	C	T	7	2	9	0	2	11	0	0
16	43028542	.	A	T	3	2	5	0	1	6	0	0
16	43028546	.	C	T	3	2	5	0	0	5	0	0
16	43031834	.	C	G	1	2	3	0	0	3	0	0
16	43126424	.	A	T	4	7	11	0	2	13	0	0
16	43126425	.	C	T	5	7	12	0	1	13	0	0
16	43126502	.	G	T	2	11	13	0	1	14	0	0
16	43126566	.	G	A	4	4	8	0	0	8	0	0
16	43126603	.	A	T	4	3	7	0	0	7	0	0
16	43126886	.	A	G	2	8	10	0	0	10	0	0
16	43126887	.	C	T	0	7	7	0	3	10	0	0
16	43149664	.	C	T	1	2	3	0	0	3	0	0
16	43149687	.	C	G	2	3	5	0	0	5	0	0
16	43149940	.	G	C	1	3	4	0	0	4	0	0
16	43228942	.	C	T	1	3	4	0	0	4	0	0
16	43228945	.	T	C	1	3	4	0	0	4	0	0
16	44338921	.	T	A	18	23	41	0	4	45	0	0
16	44339284	.	C	T	0	7	7	1	13	21	0	0
16	44339466	.	A	G	7	10	17	0	0	17	0	0
16	44339475	.	A	G	7	8	15	0	0	15	0	0
16	44342679	.	C	T	3	2	5	0	0	5	0	0
16	44379120	.	A	G	7	3	10	0	1	11	0	0
16	44379168	.	T	C	4	4	8	0	0	8	0	0
16	44379219	.	T	A	6	3	9	0	0	9	0	0
16	46086357	.	A	G	1	6	7	0	0	7	0	0
16	46087759	.	T	A	1	2	3	0	1	4	0	0
16	46198265	.	A	G	5	3	8	0	0	8	0	0
16	46464219	.	G	A	4	2	6	0	0	6	0	0
16	49604710	.	A	G	0	0	0	0	3	3	0	0
16	51183892	.	A	T	3	4	7	0	1	8	0	0
16	51885808	.	G	A	27	19	46	0	4	50	0	0
16	51885855	.	A	T	4	11	15	0	2	17	0	0
16	51888929	.	C	T	9	18	27	0	1	28	0	0
16	51950697	.	T	A	13	7	20	0	4	24	0	0
16	51950726	.	C	A	13	20	33	0	2	35	0	0
16	51950754	.	C	T	15	30	45	0	1	46	0	0
16	51950814	.	A	T	27	0	27	0	0	27	0	0
16	51950877	.	G	C	26	19	45	0	2	47	0	0
16	51951690	.	T	C	3	11	14	0	0	14	0	0
16	51951691	.	T	C	6	8	14	0	0	14	0	0
16	51952002	.	T	G	7	15	22	0	2	24	0	0
16	51952023	.	A	T	7	14	21	0	2	23	0	0
16	51952063	.	A	C	5	14	19	0	0	19	0	0
16	51952582	.	T	A	2	3	5	0	0	5	0	0
16	51952592	.	T	A	3	4	7	0	0	7	0	0
16	51953009	.	G	A	9	10	19	0	1	20	0	0
16	51953048	.	T	C	11	15	26	0	3	29	0	0
16	51953057	.	T	A	11	14	25	0	0	25	0	0
16	51953189	.	G	T	5	2	7	0	0	7	0	0
16	51955675	.	G	A	4	1	5	0	1	6	0	0
16	51955696	.	G	A	3	2	5	0	0	5	0	0
16	51962068	.	A	G	1	4	5	0	1	6	0	0
16	51962089	.	C	T	7	2	9	0	0	9	0	0
16	51966774	.	C	G	0	0	0	0	1	1	0	0
16	52926256	.	T	C	5	3	8	0	2	10	0	0
16	52926398	.	T	C	2	9	11	0	1	12	0	0
16	52926399	.	T	C	1	0	1	0	11	12	0	0
16	53224473	.	G	C	0	2	2	0	2	4	0	0
16	53224629	.	C	T	8	4	12	0	0	12	0	0
16	53247178	.	C	T	5	14	19	0	0	19	0	0
16	53516147	.	T	G	15	9	24	0	1	25	0	0
16	53516232	.	G	A	11	24	35	0	4	39	0	0
16	53516303	.	T	C	8	9	17	0	1	18	0	0
16	53529665	.	T	C	2	1	3	0	1	4	0	0
16	53530490	.	A	T	0	5	5	0	0	5	0	0
16	53539389	.	G	A	4	1	5	0	1	6	0	0
16	53539399	.	T	C	1	2	3	0	2	5	0	0
16	53541879	.	A	G	15	7	22	0	1	23	0	0
16	53541963	.	T	A	5	11	16	0	2	18	0	0
16	53591872	.	G	A	2	4	6	0	0	6	0	0
16	53591908	.	C	G	3	9	12	0	0	12	0	0
16	53592058	.	T	A	3	4	7	0	1	8	0	0
16	53596872	.	C	T	3	3	6	0	0	6	0	0
16	53601486	.	A	G	6	0	6	0	21	27	0	0
16	53701171	.	A	C	5	10	15	0	2	17	0	0
16	53708312	.	C	G	29	34	63	0	4	67	0	0
16	53734044	.	C	T	2	3	5	0	0	5	0	0
16	53734064	.	T	A	1	4	5	0	0	5	0	0
16	53734226	.	C	T	0	4	4	0	2	6	0	0
16	53734303	.	A	G	2	3	5	0	0	5	0	0
16	54245609	.	C	T	3	4	7	0	0	7	0	0
16	54245812	.	T	C	1	2	3	0	0	3	0	0
16	54245832	.	A	C	1	2	3	0	0	3	0	0
16	54314226	.	G	A	0	0	0	0	1	1	0	0
16	54314463	.	C	G	1	1	2	0	0	2	0	0
16	54320243	.	A	G	3	5	8	0	0	8	0	0
16	54805173	.	G	A	1	4	5	0	0	5	0	0
16	54829650	.	C	T	15	20	35	0	2	37	0	0
16	54829656	.	A	G	16	18	34	0	4	38	0	0
16	54837250	.	T	C	6	8	14	0	1	15	0	0
16	54843723	.	C	T	32	21	53	0	5	58	0	0
16	54843798	.	A	G	7	0	7	0	24	31	0	0
16	54930903	.	A	G	1	4	5	0	0	5	0	0
16	54930916	.	T	A	1	3	4	0	0	4	0	0
16	54931133	.	T	C	1	2	3	0	0	3	0	0
16	54947827	.	T	G	2	2	4	0	1	5	0	0
16	54947978	.	G	A	10	4	14	0	0	14	0	0
16	54948227	.	A	G	7	6	13	0	2	15	0	0
16	54948369	.	T	A	6	3	9	0	1	10	0	0
16	54948467	.	C	A	9	6	15	0	0	15	0	0
16	54948483	.	T	A	4	5	9	0	2	12	1	0
16	54948511	.	C	A	0	3	3	0	4	7	0	0
16	54949140	.	G	A	10	9	19	0	6	25	0	0
16	54952935	.	G	A	5	7	12	0	1	13	0	0
16	54953031	.	C	T	0	5	5	0	6	11	0	0
16	54953067	.	G	A	2	2	4	0	0	4	0	0
16	54956620	.	C	T	3	1	4	0	0	4	0	0
16	55004634	.	C	A	5	3	8	0	2	10	0	0
16	55004655	.	A	T	12	7	19	0	1	20	0	0
16	55004716	.	T	C	12	0	12	0	16	28	0	0
16	55007670	.	G	A	4	5	9	0	0	9	0	0
16	55106111	.	A	C	1	2	3	0	0	3	0	0
16	55106207	.	T	C	8	10	18	0	0	18	0	0
16	55106223	.	A	G	8	10	18	0	1	19	0	0
16	55106279	.	C	A	16	17	33	0	3	36	0	0
16	55106367	.	A	C	7	11	18	0	3	21	0	0
16	55106405	.	G	A	4	3	7	0	1	8	0	0
16	55106443	.	C	T	4	6	10	0	0	10	0	0
16	55106474	.	C	T	0	5	5	0	3	8	0	0
16	55108828	.	C	T	2	3	5	0	0	5	0	0
16	55122779	.	T	C	4	9	13	0	1	14	0	0
16	55182217	.	G	A	3	3	6	0	0	6	0	0
16	55182249	.	A	T	1	4	5	0	0	5	0	0
17	70497	.	G	C	2	2	4	0	0	4	0	0
17	70858	.	C	A	1	2	3	0	0	3	0	0
17	71012	.	A	T	2	3	5	0	0	5	0	0
17	132695	.	G	A	2	2	4	0	0	4	0	0
17	132932	.	A	C	2	3	5	0	0	5	0	0
17	133001	.	C	G	4	5	9	0	0	9	0	0
17	133232	.	G	A	2	5	7	0	5	12	0	0
17	136304	.	A	G	2	4	6	0	1	7	0	0
17	136599	.	G	A	6	12	18	0	3	21	0	0
17	139048	.	G	C	3	1	4	0	0	4	0	0
17	139103	.	C	T	2	6	8	0	0	8	0	0
17	445759	.	A	G	2	3	5	0	0	5	0	0
17	445770	.	A	G	1	4	5	0	0	5	0	0
17	660242	.	A	G	2	2	4	0	1	5	0	0
17	660617	.	C	A	1	19	20	0	24	44	0	0
17	681127	.	G	A	5	7	12	0	0	12	0	0
17	734235	.	T	C	7	0	7	0	8	15	0	0
17	734244	.	T	C	6	5	11	0	1	12	0	0
17	742225	.	C	T	7	8	15	0	0	15	0	0
17	742274	.	A	T	8	12	20	0	0	20	0	0
17	743576	.	T	A	4	8	12	0	1	13	0	0
17	743851	.	C	A	5	7	12	0	1	13	0	0
17	860339	.	G	A	7	8	15	0	2	17	0	0
17	860451	.	C	G	6	4	10	0	2	12	0	0
17	860501	.	G	A	7	4	11	0	0	11	0	0
17	860645	.	C	T	1	4	5	0	3	8	0	0
17	860852	.	A	G	4	4	8	0	0	8	0	0
17	861065	.	G	A	2	3	5	0	0	5	0	0
17	945704	.	G	C	1	1	2	0	1	3	0	0
17	945731	.	T	C	1	2	3	0	0	3	0	0
17	974838	.	G	T	0	3	3	0	0	3	0	0
17	1069048	.	G	T	3	3	6	0	0	6	0	0
17	1122515	.	G	A	0	1	1	0	0	1	0	0
17	1122530	.	T	G	1	0	1	0	0	1	0	0
17	1355243	.	T	G	3	2	5	0	0	5	0	0
17	1355509	.	T	C	9	4	13	0	0	13	0	0
17	1355561	.	A	T	6	4	10	0	3	13	0	0
17	1355562	.	C	T	9	4	13	0	0	13	0	0
17	1355621	.	T	A	1	7	8	0	0	8	0	0
17	1362295	.	G	T	0	0	0	0	2	2	0	0
17	1369251	.	T	A	1	2	3	0	0	3	0	0
17	2063925	.	A	G	21	26	47	0	0	47	0	0
17	2091858	.	G	A	0	5	5	0	4	9	0	0
17	2095454	.	T	C	12	20	32	0	1	33	0	0
17	2109014	.	C	T	0	18	18	0	8	27	1	0
17	2110588	.	G	A	19	13	32	0	2	34	0	0
17	2110642	.	C	G	8	20	28	0	2	30	0	0
17	2110657	.	T	C	10	1	11	0	24	35	0	0
17	2115464	.	A	T	2	3	5	0	0	5	0	0
17	2121955	.	T	A	1	3	4	0	0	4	0	0
17	2122175	.	A	G	0	3	3	0	0	3	0	0
17	2122252	.	C	T	6	8	14	0	0	14	0	0
17	2902210	.	G	T	0	3	3	0	0	3	0	0
17	2902226	.	G	A	0	3	3	0	0	3	0	0
17	2902815	.	G	T	4	6	10	0	0	10	0	0
17	2902880	.	A	G	2	4	6	0	0	6	0	0
17	2902911	.	T	G	4	2	6	0	0	6	0	0
17	3290700	.	A	G	1	3	4	0	0	4	0	0
17	3514131	.	C	T	1	2	3	0	0	3	0	0
17	3566811	.	A	G	3	2	5	0	0	5	0	0
17	3566844	.	T	A	4	3	7	0	1	8	0	0
17	3569047	.	T	C	7	4	11	0	2	13	0	0
17	3569050	.	A	C	7	5	12	0	1	13	0	0
17	3569264	.	A	C	11	5	16	0	1	17	0	0
17	4227454	.	C	T	3	2	5	0	0	5	0	0
17	4227661	.	G	A	1	2	3	0	0	3	0	0
17	4239482	.	T	A	1	2	3	0	0	3	0	0
17	4239711	.	A	G	18	16	34	0	3	37	0	0
17	4239975	.	C	T	15	11	26	0	1	27	0	0
17	4240034	.	A	T	17	15	32	0	0	32	0	0
17	4240188	.	G	T	5	19	24	0	3	27	0	0
17	4297551	.	A	C	4	2	6	0	0	6	0	0
17	4297600	.	T	C	5	4	9	0	0	9	0	0
17	4297608	.	G	T	3	4	7	0	0	7	0	0
17	4298287	.	A	G	2	3	5	0	1	6	0	0
17	4298306	.	T	G	1	3	4	0	1	5	0	0
17	4369304	.	T	C	2	3	5	0	0	5	0	0
17	4385860	.	C	T	1	4	5	0	2	7	0	0
17	4385871	.	T	C	3	5	8	0	0	8	0	0
17	4385982	.	C	T	2	3	5	0	0	5	0	0
17	5071257	.	G	A	0	1	1	0	0	1	0	0
17	5079084	.	T	C	3	5	8	0	0	8	0	0
17	5081406	.	A	C	1	3	4	0	0	4	0	0
17	5090829	.	G	A	0	9	9	0	5	14	0	0
17	5094355	.	T	C	9	8	17	0	0	17	0	0
17	5101234	.	A	G	12	0	12	0	10	22	0	0
17	5105828	.	T	C	9	12	21	0	1	22	0	0
17	5162027	.	A	G	3	3	6	0	0	6	0	0
17	5162080	.	T	A	3	4	7	0	0	7	0	0
17	5162096	.	T	C	4	0	4	0	7	11	0	0
17	5215192	.	T	G	3	1	4	0	0	4	0	0
17	5217050	.	T	C	1	0	1	0	1	2	0	0
17	5766286	.	A	C	0	1	1	0	0	1	0	0
17	5768681	.	A	T	0	1	1	0	0	1	0	0
17	5768712	.	A	G	0	5	5	0	0	5	0	0
17	5768722	.	C	T	0	4	4	0	2	6	0	0
17	5821476	.	G	A	5	7	12	0	1	13	0	0
17	5821853	.	T	C	5	5	10	0	0	10	0	0
17	5896025	.	G	A	4	2	6	0	1	7	0	0
17	5916287	.	T	C	6	5	11	0	0	11	0	0
17	5916392	.	A	G	1	2	3	0	0	3	0	0
17	5926722	.	T	C	17	18	35	0	1	36	0	0
17	5926729	.	A	G	17	17	34	0	1	35	0	0
17	5926981	.	A	T	13	19	32	0	2	34	0	0
17	5927085	.	C	A	21	14	35	0	0	35	0	0
17	5927101	.	T	C	17	8	25	0	0	25	0	0
17	6101114	.	G	A	3	2	5	0	0	5	0	0
17	6101565	.	G	A	1	4	5	0	0	5	0	0
17	6279806	.	C	A	3	3	6	0	1	7	0	0
17	6279876	.	G	T	0	10	10	0	16	26	0	0
17	6438334	.	A	G	3	2	5	0	2	7	0	0
17	6438630	.	T	A	4	4	8	0	1	9	0	0
17	6444514	.	T	A	1	2	3	0	1	4	0	0
17	6447234	.	A	G	0	1	1	0	1	2	0	0
17	6460449	.	A	C	0	1	1	0	0	1	0	0
17	6462023	.	A	T	1	4	5	0	0	5	0	0
17	6462228	.	G	A	3	5	8	0	1	9	0	0
17	6555836	.	G	A	2	2	4	0	0	4	0	0
17	6555837	.	C	T	2	2	4	0	0	4	0	0
17	6715755	.	T	A	13	10	23	0	0	23	0	0
17	6716412	.	G	T	16	20	36	0	1	37	0	0
17	6716472	.	G	A	13	19	32	0	5	37	0	0
17	6730114	.	G	A	3	7	10	0	1	11	0	0
17	6737970	.	C	A	0	1	1	0	3	4	0	0
17	6808796	.	A	G	5	12	17	0	1	18	0	0
17	6935687	.	T	C	2	2	4	0	0	4	0	0
17	7802799	.	A	G	0	1	1	0	0	1	0	0
17	7844994	.	G	A	7	7	14	0	4	18	0	0
17	7845364	.	G	C	16	16	32	0	3	35	0	0
17	7845412	.	T	C	14	21	35	0	1	36	0	0
17	7845566	.	C	T	7	21	28	0	2	30	0	0
17	7861124	.	C	T	15	15	30	0	2	32	0	0
17	7868632	.	G	A	1	0	1	0	0	1	0	0
17	7879348	.	T	C	2	4	6	0	1	7	0	0
17	7882941	.	G	A	7	5	12	0	0	12	0	0
17	7882998	.	G	A	7	8	15	0	0	15	0	0
17	7885662	.	A	G	2	5	7	0	0	7	0	0
17	7894976	.	T	A	2	2	4	0	0	4	0	0
17	7895023	.	G	A	1	0	1	0	1	2	0	0
17	7896356	.	C	T	0	5	5	0	8	13	0	0
17	7896390	.	C	T	0	7	7	0	6	13	0	0
17	7896478	.	C	T	1	1	2	0	0	2	0	0
17	7901137	.	C	T	3	2	5	0	0	5	0	0
17	7906568	.	G	T	4	4	8	0	1	9	0	0
17	7906612	.	G	A	1	5	6	0	0	6	0	0
17	7906646	.	T	A	1	1	2	0	0	2	0	0
17	7907851	.	C	T	2	3	5	0	2	7	0	0
17	7917997	.	G	A	2	0	2	0	0	2	0	0
17	7926040	.	G	A	1	1	2	0	0	2	0	0
17	7926076	.	C	T	2	1	3	0	2	5	0	0
17	7942366	.	T	G	1	0	1	0	0	1	0	0
17	7945421	.	C	G	0	3	3	0	1	4	0	0
17	7945485	.	A	G	0	1	1	0	0	1	0	0
17	8204818	.	A	G	8	4	12	0	0	12	0	0
17	8204935	.	T	C	10	4	14	0	1	15	0	0
17	8204962	.	C	T	8	3	11	0	0	11	0	0
17	8205340	.	A	T	8	5	13	0	0	13	0	0
17	8205697	.	A	G	2	3	5	0	2	7	0	0
17	8209315	.	T	C	0	1	1	0	0	1	0	0
17	8209327	.	C	T	2	2	4	0	0	4	0	0
17	8209837	.	T	A	9	6	15	0	1	16	0	0
17	8209931	.	C	A	7	3	10	0	0	10	0	0
17	8209944	.	A	G	5	7	12	0	0	12	0	0
17	8210203	.	G	A	9	4	13	0	1	14	0	0
17	8210242	.	C	T	11	6	17	0	2	19	0	0
17	8210411	.	A	G	5	9	14	0	0	14	0	0
17	8229964	.	C	T	1	3	4	0	0	4	0	0
17	8245868	.	G	A	1	2	3	0	0	3	0	0
17	8248987	.	A	G	1	0	1	0	0	1	0	0
17	8597174	.	T	A	14	14	28	0	3	31	0	0
17	8597702	.	A	T	15	15	30	0	3	33	0	0
17	8597965	.	T	A	15	18	33	0	1	34	0	0
17	8611580	.	G	A	3	4	7	0	1	8	0	0
17	8623396	.	G	A	4	2	6	0	0	6	0	0
17	8623456	.	T	C	3	11	14	0	0	14	0	0
17	8727654	.	A	T	0	1	1	0	0	1	0	0
17	8791907	.	A	G	1	0	1	0	6	7	0	0
17	8934223	.	G	A	8	12	20	0	0	20	0	0
17	8934307	.	C	T	2	3	5	0	0	6	1	0
17	8937918	.	G	A	5	2	7	0	0	7	0	0
17	8937954	.	G	A	10	5	15	0	0	15	0	0
17	8938023	.	C	T	3	1	4	0	1	5	0	0
17	8938249	.	T	C	8	8	16	0	0	16	0	0
17	8938269	.	G	A	9	13	22	0	0	22	0	0
17	8938305	.	T	A	14	13	27	0	2	29	0	0
17	8941309	.	T	C	9	5	14	0	0	14	0	0
17	8941320	.	C	T	6	5	11	0	0	11	0	0
17	8951606	.	C	G	0	4	4	0	15	19	0	0
17	8951644	.	C	T	0	18	18	0	8	26	0	0
17	8951655	.	T	C	8	18	26	0	3	29	0	0
17	8951867	.	C	T	0	4	4	0	4	8	0	0
17	8964520	.	G	A	7	6	13	0	0	13	0	0
17	8969278	.	A	G	3	5	8	0	0	8	0	0
17	8969296	.	G	A	4	6	10	0	0	10	0	0
17	9255547	.	G	C	3	2	5	0	0	5	0	0
17	9266298	.	C	T	9	11	20	0	2	22	0	0
17	9266501	.	G	T	0	15	15	0	23	38	0	0
17	9944725	.	A	G	5	6	11	0	0	11	0	0
17	9944848	.	T	A	8	6	14	0	0	14	0	0
17	9945176	.	T	A	6	9	15	0	0	15	0	0
17	9945178	.	T	G	6	9	15	0	0	15	0	0
17	9951885	.	G	A	5	7	12	0	0	12	0	0
17	9952033	.	C	T	0	4	4	0	14	18	0	0
17	9963519	.	G	A	5	8	13	0	2	15	0	0
17	9963938	.	C	A	8	2	10	0	2	12	0	0
17	9964125	.	T	A	1	3	4	0	2	6	0	0
17	9964177	.	C	A	6	2	8	0	1	9	0	0
17	9964359	.	T	C	0	2	2	0	0	3	1	0
17	9964361	.	A	G	0	2	2	0	1	3	0	0
17	10144456	.	A	G	2	4	6	0	0	6	0	0
17	10144467	.	A	G	3	3	6	0	0	6	0	0
17	12060587	.	A	G	4	2	6	0	0	6	0	0
17	12060631	.	G	A	0	3	3	0	2	5	0	0
17	12072890	.	C	T	6	9	15	0	1	16	0	0
17	12072977	.	T	C	10	10	20	0	3	23	0	0
17	12073037	.	C	T	10	5	15	0	1	16	0	0
17	12073096	.	C	T	2	7	9	0	2	11	0	0
17	12221891	.	G	A	8	4	12	0	0	12	0	0
17	12221903	.	C	T	0	5	5	0	6	11	0	0
17	12222005	.	T	G	3	5	8	0	2	10	0	0
17	12222226	.	A	G	8	8	16	0	2	18	0	0
17	12222235	.	G	T	6	8	14	0	1	15	0	0
17	12223743	.	G	A	4	3	7	0	0	7	0	0
17	12223883	.	C	G	1	1	2	0	0	2	0	0
17	12223884	.	T	A	1	1	2	0	0	2	0	0
17	12223971	.	G	A	5	7	12	0	0	12	0	0
17	12223989	.	C	A	0	6	6	0	9	15	0	0
17	12224976	.	G	A	7	8	15	0	1	16	0	0
17	12225070	.	G	A	7	3	10	0	1	11	0	0
17	12225292	.	C	T	0	2	2	0	2	4	0	0
17	12225418	.	T	G	4	2	6	0	1	7	0	0
17	12225756	.	C	A	2	2	4	0	0	4	0	0
17	12225843	.	T	G	2	1	3	0	0	3	0	0
17	12225867	.	C	T	0	1	1	0	1	2	0	0
17	12227778	.	T	A	1	2	3	0	0	3	0	0
17	12227780	.	C	G	0	1	1	0	2	3	0	0
17	12298106	.	G	T	29	34	63	0	13	76	0	0
17	12302409	.	G	A	25	26	51	0	7	58	0	0
17	12418130	.	C	A	3	4	7	0	0	7	0	0
17	12422850	.	T	A	12	6	18	0	1	19	0	0
17	12422905	.	C	T	1	3	4	0	0	4	0	0
17	12422914	.	A	T	1	3	4	0	0	4	0	0
17	12700653	.	A	G	2	0	2	0	0	2	0	0
17	12702780	.	C	T	8	7	15	0	2	17	0	0
17	12702801	.	A	G	7	0	7	0	4	11	0	0
17	12702831	.	C	A	3	2	5	0	1	6	0	0
17	12708393	.	A	G	4	7	11	0	0	11	0	0
17	12708404	.	C	A	3	5	8	0	0	8	0	0
17	12708903	.	T	C	16	19	35	0	2	37	0	0
17	12709244	.	T	G	10	10	20	0	0	20	0	0
17	12741500	.	T	C	1	2	3	0	0	3	0	0
17	12741518	.	C	T	1	3	4	0	0	4	0	0
17	12753717	.	A	C	3	1	4	0	0	4	0	0
17	12753792	.	G	A	11	11	22	0	3	25	0	0
17	12753823	.	A	G	15	6	21	0	1	22	0	0
17	12753916	.	T	A	6	8	14	0	0	14	0	0
17	12753940	.	A	T	5	8	13	0	0	13	0	0
17	12754071	.	A	G	14	7	21	0	1	22	0	0
17	12754158	.	A	T	5	8	13	0	0	13	0	0
17	12754198	.	A	T	3	5	8	0	0	8	0	0
17	12758557	.	G	A	7	3	10	0	0	10	0	0
17	12758559	.	T	G	7	3	10	0	0	10	0	0
17	12759135	.	C	T	1	1	2	0	0	2	0	0
17	12764004	.	C	T	0	2	2	0	9	11	0	0
17	12858658	.	G	C	3	3	6	0	0	6	0	0
17	12858765	.	A	G	3	3	6	0	0	6	0	0
17	12867975	.	G	A	2	2	4	0	0	4	0	0
17	12881590	.	G	A	0	3	3	0	1	4	0	0
17	12922678	.	A	G	7	5	12	0	1	13	0	0
17	12923028	.	A	G	11	18	29	0	2	31	0	0
17	12923303	.	A	G	13	0	13	0	21	34	0	0
17	12923509	.	A	T	8	12	20	0	2	22	0	0
17	12925020	.	G	A	3	3	6	0	0	6	0	0
17	12958744	.	G	A	3	2	5	0	0	5	0	0
17	12963571	.	G	A	4	3	7	0	0	7	0	0
17	12972906	.	T	G	1	2	3	0	0	3	0	0
17	12972969	.	A	G	5	4	9	0	1	10	0	0
17	12977682	.	T	C	2	0	2	0	0	2	0	0
17	13019988	.	T	A	12	15	27	0	0	27	0	0
17	13020090	.	G	A	9	10	19	0	2	21	0	0
17	13020187	.	A	C	7	9	16	0	0	16	0	0
17	13020472	.	T	C	7	11	18	0	1	19	0	0
17	13020476	.	T	A	8	11	19	0	1	20	0	0
17	13020601	.	C	T	0	5	5	0	7	12	0	0
17	13020733	.	C	G	5	9	14	0	0	14	0	0
17	13023022	.	G	A	1	0	1	0	0	1	0	0
17	13023407	.	A	C	1	2	3	0	0	3	0	0
17	13026599	.	A	T	1	3	4	0	0	4	0	0
17	13045540	.	G	T	6	6	12	0	2	14	0	0
17	13045559	.	A	C	7	4	11	0	1	12	0	0
17	13045794	.	T	A	11	8	19	0	0	19	0	0
17	13045882	.	A	T	8	4	12	0	1	13	0	0
17	13046058	.	T	G	4	6	10	0	1	11	0	0
17	13046099	.	G	A	5	7	12	0	1	13	0	0
17	13061839	.	T	C	1	0	1	0	0	1	0	0
17	13061849	.	C	G	1	1	2	0	0	2	0	0
17	13091660	.	T	G	4	3	7	0	0	7	0	0
17	13108626	.	G	T	15	18	33	0	2	35	0	0
17	13109010	.	A	G	13	23	36	0	1	37	0	0
17	13109042	.	T	C	16	13	29	0	6	35	0	0
17	13109097	.	A	T	12	12	24	0	2	26	0	0
17	13109409	.	C	T	16	15	31	0	1	32	0	0
17	13109793	.	A	C	11	9	20	0	5	25	0	0
17	13109818	.	T	C	15	14	29	0	1	30	0	0
17	13109910	.	A	G	17	0	17	0	15	33	1	0
17	13109928	.	G	T	0	19	19	0	18	37	0	0
17	13109990	.	T	A	17	19	36	0	2	38	0	0
17	13110003	.	C	G	14	19	33	0	5	39	1	0
17	13110043	.	C	T	7	11	18	0	4	22	0	0
17	13110087	.	G	A	5	0	5	0	3	8	0	0
17	13110090	.	A	T	3	3	6	0	0	6	0	0
17	15633301	.	T	C	6	5	11	0	0	11	0	0
17	15633303	.	T	C	4	7	11	0	0	11	0	0
17	15633377	.	T	C	1	11	12	0	0	12	0	0
17	15633379	.	T	C	3	9	12	0	0	12	0	0
17	16804958	.	C	A	1	3	4	0	2	6	0	0
17	18070138	.	G	A	5	10	15	0	0	15	0	0
17	19420197	.	C	T	14	16	30	0	2	32	0	0
17	19420434	.	C	T	0	9	9	0	9	18	0	0
17	19420563	.	T	G	10	7	17	0	2	19	0	0
17	19421109	.	C	G	7	3	10	0	1	11	0	0
17	19421248	.	T	G	7	8	15	0	0	16	1	0
17	19421636	.	T	C	4	0	4	0	7	11	0	0
17	19421667	.	A	G	4	5	9	0	0	9	0	0
17	19421948	.	C	T	3	3	6	0	1	7	0	0
17	19421955	.	A	T	4	5	9	0	1	10	0	0
17	19510714	.	G	A	4	3	7	0	0	7	0	0
17	19607654	.	A	T	2	5	7	0	3	10	0	0
17	19607835	.	T	A	6	6	12	0	0	12	0	0
17	19715899	.	T	C	2	2	4	0	0	4	0	0
17	19754364	.	G	A	1	3	4	0	0	4	0	0
17	19757478	.	T	C	1	3	4	0	0	4	0	0
17	20147804	.	C	A	1	2	3	0	1	4	0	0
17	20189047	.	A	T	6	9	15	0	2	17	0	0
17	20191941	.	A	G	0	1	1	0	0	1	0	0
17	20191956	.	A	G	1	0	1	0	0	1	0	0
17	20214550	.	C	T	1	2	3	0	0	3	0	0
17	20214570	.	C	A	3	1	4	0	2	6	0	0
17	20214757	.	T	C	3	2	5	0	0	5	0	0
17	20214766	.	T	C	1	0	1	0	2	3	0	0
17	20215498	.	G	A	2	2	4	0	0	4	0	0
17	20243035	.	A	G	5	0	5	0	3	8	0	0
17	20243375	.	C	A	18	21	39	0	5	44	0	0
17	20243564	.	G	A	14	14	28	0	3	31	0	0
17	20243611	.	G	A	12	17	29	0	3	32	0	0
17	20248398	.	A	G	5	3	8	0	0	8	0	0
17	20248455	.	A	T	6	8	14	0	1	15	0	0
17	20248479	.	T	C	5	10	15	0	2	17	0	0
17	20248500	.	C	G	0	6	6	0	6	12	0	0
17	20321730	.	C	T	2	2	4	0	0	4	0	0
17	20517926	.	A	G	2	2	4	0	0	4	0	0
17	20517930	.	C	T	0	4	4	0	0	4	0	0
17	20518147	.	G	A	2	3	5	0	0	5	0	0
17	20587321	.	A	C	2	1	3	0	1	4	0	0
17	20587947	.	T	A	2	2	4	0	0	4	0	0
17	20653983	.	T	C	5	3	8	0	0	8	0	0
17	20654017	.	A	T	9	3	12	0	0	12	0	0
17	20654023	.	G	A	7	1	8	0	4	12	0	0
17	20654140	.	G	A	0	5	5	0	0	5	0	0
17	20674063	.	C	T	9	6	15	0	2	17	0	0
17	20674489	.	T	C	12	0	12	0	16	28	0	0
17	20674768	.	T	A	4	5	9	0	0	9	0	0
17	20674794	.	C	T	4	9	13	0	3	16	0	0
17	20674889	.	T	A	8	10	18	0	0	18	0	0
17	20684685	.	A	T	5	4	9	0	0	9	0	0
17	20701602	.	A	G	18	20	38	0	3	41	0	0
17	20701999	.	G	A	13	8	21	0	0	21	0	0
17	20702030	.	C	T	0	7	7	0	7	14	0	0
17	20702056	.	G	A	3	3	6	0	0	6	0	0
17	20719067	.	G	C	4	4	8	0	0	8	0	0
17	20719746	.	G	T	2	3	5	0	0	5	0	0
17	20720046	.	C	T	1	3	4	0	4	8	0	0
17	20720121	.	G	T	6	2	8	0	0	8	0	0
17	20720334	.	C	T	4	3	7	0	0	7	0	0
17	20720581	.	G	A	1	2	3	0	1	4	0	0
17	20722113	.	C	A	4	3	7	0	0	7	0	0
17	20723407	.	A	G	1	2	3	0	0	3	0	0
17	20963653	.	T	C	9	12	21	0	2	23	0	0
17	20963664	.	T	C	7	7	14	0	2	16	0	0
17	20964978	.	A	G	4	3	7	0	0	7	0	0
17	20965018	.	C	T	2	2	4	0	0	4	0	0
17	20978673	.	A	G	3	2	5	0	1	6	0	0
17	21120781	.	G	A	2	3	5	0	0	5	0	0
17	21151945	.	C	A	1	3	4	0	0	4	0	0
17	21151996	.	C	T	1	2	3	0	0	3	0	0
17	21152145	.	A	C	1	2	3	0	0	3	0	0
17	21154691	.	A	G	6	8	14	0	1	15	0	0
17	21154957	.	C	A	7	4	11	0	1	12	0	0
17	21155425	.	C	A	6	7	13	0	1	14	0	0
17	21155817	.	T	C	6	5	11	0	0	11	0	0
17	21156162	.	A	G	3	4	7	0	1	8	0	0
17	21156207	.	A	C	3	4	7	0	0	7	0	0
17	21156220	.	C	T	1	3	4	0	1	5	0	0
17	21156720	.	A	C	1	4	5	0	0	5	0	0
17	21372616	.	C	T	0	10	10	0	12	22	0	0
17	21372810	.	G	T	21	28	49	0	1	50	0	0
17	21372950	.	A	T	1	22	23	0	4	27	0	0
17	21373062	.	G	A	14	14	28	0	3	31	0	0
17	21373105	.	C	G	0	18	18	0	20	38	0	0
17	21377133	.	G	A	2	3	5	0	0	5	0	0
17	21396399	.	A	G	0	2	2	0	0	2	0	0
17	21433014	.	C	T	0	5	5	0	4	9	0	0
17	21433074	.	G	A	5	16	21	0	3	24	0	0
17	21433396	.	C	T	0	4	4	0	2	6	0	0
17	21433425	.	A	G	1	5	6	0	0	6	0	0
17	21433680	.	C	A	3	3	6	0	1	7	0	0
17	21560706	.	A	T	6	4	10	0	0	10	0	0
17	21560738	.	A	G	4	5	9	0	0	9	0	0
17	21560763	.	T	C	6	4	10	0	0	10	0	0
17	21560877	.	T	C	10	3	13	0	0	13	0	0
17	21562474	.	A	T	1	2	3	0	0	3	0	0
17	21562932	.	A	G	2	2	4	0	0	4	0	0
17	21820366	.	C	T	0	2	2	0	0	2	0	0
17	21820657	.	C	A	2	2	4	0	0	4	0	0
17	21820772	.	A	G	1	1	2	0	1	3	0	0
17	21820879	.	C	T	1	4	5	0	0	5	0	0
17	21821381	.	A	G	3	3	6	0	0	6	0	0
17	21821405	.	T	C	2	6	8	0	0	8	0	0
17	21821653	.	T	C	1	4	5	0	0	5	0	0
17	21821856	.	C	T	9	8	17	0	0	17	0	0
17	21904009	.	G	A	0	2	2	0	3	5	0	0
17	21911999	.	T	C	10	10	20	0	1	21	0	0
17	21912381	.	T	C	5	6	11	0	1	12	0	0
17	21912489	.	T	C	3	7	10	0	1	11	0	0
17	21912517	.	T	C	4	3	7	0	0	7	0	0
17	21912554	.	G	T	7	5	12	0	0	12	0	0
17	21912597	.	C	A	8	5	13	0	4	17	0	0
17	21912622	.	C	A	8	2	10	0	0	10	0	0
17	21912676	.	A	T	7	8	15	0	0	15	0	0
17	21912708	.	T	A	11	9	20	0	1	21	0	0
17	21912797	.	T	C	9	5	14	0	1	15	0	0
17	21912874	.	A	G	22	16	38	0	1	39	0	0
17	21912890	.	G	T	20	15	35	0	3	38	0	0
17	21913042	.	G	T	1	2	3	0	1	4	0	0
17	21958945	.	A	G	2	0	2	0	5	7	0	0
17	21959239	.	A	T	1	2	3	0	2	5	0	0
17	21959338	.	C	T	1	2	3	0	0	3	0	0
17	21959342	.	A	T	1	2	3	0	0	3	0	0
17	21975525	.	G	A	0	2	2	0	0	2	0	0
17	21975528	.	C	G	0	1	1	0	1	2	0	0
17	22003324	.	A	T	1	2	3	0	0	3	0	0
17	22032345	.	T	A	3	3	6	0	0	6	0	0
17	22047883	.	C	T	0	2	2	0	1	3	0	0
17	22091044	.	T	G	4	4	8	0	0	8	0	0
17	22091067	.	G	A	4	2	6	0	1	7	0	0
17	22091118	.	T	A	0	3	3	0	0	3	0	0
17	22108065	.	G	A	11	8	19	0	0	19	0	0
17	22108207	.	A	T	0	1	1	0	0	1	0	0
17	22113050	.	T	C	2	1	3	0	0	3	0	0
17	22500972	.	A	C	1	2	3	0	0	3	0	0
17	22501645	.	G	T	2	3	5	0	0	5	0	0
17	22582313	.	C	T	2	0	2	0	0	2	0	0
17	22584847	.	G	A	19	9	28	0	4	32	0	0
17	22585264	.	T	A	26	13	39	0	3	42	0	0
17	22585273	.	C	T	13	23	36	0	6	42	0	0
17	22585337	.	T	A	15	20	35	0	1	36	0	0
17	22658245	.	A	G	1	2	3	0	0	3	0	0
17	22669012	.	G	A	0	1	1	0	1	2	0	0
17	22669060	.	C	T	2	4	6	0	1	7	0	0
17	22669511	.	A	C	4	3	7	0	0	7	0	0
17	22687408	.	C	A	15	9	24	0	3	27	0	0
17	22687409	.	C	G	17	9	26	0	1	27	0	0
17	22687451	.	T	C	15	8	23	0	1	24	0	0
17	22687500	.	T	G	8	8	16	0	2	18	0	0
17	22687558	.	T	A	18	19	37	0	0	37	0	0
17	22687561	.	G	A	17	18	35	0	2	37	0	0
17	22687729	.	T	C	22	20	42	0	3	45	0	0
17	22687842	.	T	A	13	17	30	0	3	33	0	0
17	22713696	.	C	T	5	7	12	0	0	12	0	0
17	22723479	.	T	C	10	4	14	0	1	15	0	0
17	22723515	.	C	T	4	4	8	0	2	10	0	0
17	22729079	.	T	C	2	1	3	0	0	3	0	0
17	22729772	.	T	A	8	11	19	0	2	21	0	0
17	22729796	.	G	A	0	14	14	0	10	24	0	0
17	22729886	.	C	T	0	2	2	0	0	2	0	0
17	22738350	.	G	A	7	9	16	0	1	17	0	0
17	22741044	.	C	T	11	16	27	0	0	27	0	0
17	22741070	.	G	A	0	13	13	0	10	23	0	0
17	22741096	.	A	T	6	14	20	0	0	20	0	0
17	22741437	.	A	T	18	14	32	0	1	33	0	0
17	22916905	.	C	T	1	2	3	0	0	3	0	0
17	22918230	.	G	A	0	2	2	0	0	2	0	0
17	22937684	.	A	T	5	3	8	0	1	9	0	0
17	22937719	.	A	T	2	3	5	0	0	5	0	0
17	22944875	.	A	G	5	0	5	0	1	6	0	0
17	22944887	.	A	G	6	1	7	0	0	7	0	0
17	22946926	.	C	T	3	6	9	0	0	9	0	0
17	22946930	.	A	G	2	5	7	0	1	8	0	0
17	23215411	.	T	C	1	0	1	0	0	1	0	0
17	23224626	.	C	T	1	2	3	0	0	3	0	0
17	23224680	.	G	A	2	3	5	0	0	5	0	0
17	23226667	.	C	T	4	5	9	0	2	11	0	0
17	23231130	.	C	T	4	5	9	1	0	10	0	0
17	23301102	.	C	T	3	2	5	0	0	5	0	0
17	23301303	.	G	A	9	15	24	0	0	24	0	0
17	23301372	.	C	T	6	16	22	0	0	22	0	0
17	23301390	.	G	A	0	7	7	0	17	24	0	0
17	23301799	.	A	G	7	4	11	0	2	13	0	0
17	23549710	.	G	T	3	3	6	0	0	6	0	0
17	23551512	.	T	C	3	3	6	0	0	6	0	0
17	23551536	.	C	T	4	2	6	0	0	6	0	0
17	23551928	.	G	A	0	4	4	0	2	6	0	0
17	23575413	.	A	G	2	3	5	0	0	5	0	0
17	23656034	.	A	C	11	0	11	0	16	27	0	0
17	23656112	.	C	T	0	6	6	0	10	16	0	0
17	23659853	.	C	T	3	5	8	0	2	10	0	0
17	23711184	.	A	T	6	6	12	0	2	14	0	0
17	23711421	.	A	C	3	7	10	0	1	11	0	0
17	23711775	.	C	T	0	8	8	0	2	10	0	0
17	23722882	.	A	T	0	1	1	0	0	1	0	0
17	23762900	.	T	A	3	2	5	0	0	5	0	0
17	23764591	.	T	C	4	6	10	0	3	13	0	0
17	23820614	.	A	G	7	8	15	0	0	15	0	0
17	23821410	.	C	T	3	4	7	0	0	7	0	0
17	23935259	.	C	T	5	3	8	0	0	8	0	0
17	23948365	.	A	G	8	7	15	0	0	15	0	0
17	23948396	.	C	T	2	3	5	0	0	5	0	0
17	23952672	.	G	C	2	15	17	0	0	17	0	0
17	23954987	.	C	G	3	3	6	0	0	6	0	0
17	23956882	.	G	A	9	20	29	0	3	32	0	0
17	23956925	.	G	A	0	23	23	0	10	33	0	0
17	23964690	.	T	A	1	6	7	0	0	7	0	0
17	23964719	.	A	G	2	5	7	0	1	8	0	0
17	23964732	.	T	C	2	5	7	0	3	10	0	0
17	23965241	.	G	T	4	2	6	0	0	6	0	0
17	23965475	.	G	C	2	4	6	0	1	7	0	0
17	23965983	.	C	A	5	2	7	0	1	8	0	0
17	23986153	.	A	G	4	1	5	0	4	9	0	0
17	23986585	.	T	C	11	8	19	0	1	20	0	0
17	24222649	.	G	A	3	2	5	0	2	7	0	0
17	24222730	.	T	A	1	1	2	0	1	3	0	0
17	24222752	.	A	T	1	1	2	0	2	4	0	0
17	24222771	.	G	T	2	3	5	0	0	5	0	0
17	24247670	.	G	T	2	0	2	0	0	2	0	0
17	24254467	.	G	A	0	3	3	0	2	5	0	0
17	24268278	.	G	A	4	2	6	0	2	8	0	0
17	24313974	.	T	A	1	3	4	0	0	4	0	0
17	24314331	.	A	G	4	10	14	0	2	16	0	0
17	24314468	.	A	T	3	5	8	0	0	8	0	0
17	24444239	.	T	G	4	5	9	0	1	10	0	0
17	24464939	.	A	C	3	2	5	0	1	6	0	0
17	24464987	.	A	T	1	2	3	0	0	3	0	0
17	24469255	.	G	A	1	1	2	0	0	2	0	0
17	24469752	.	A	C	5	4	9	0	0	9	0	0
17	24470146	.	C	A	10	12	22	0	1	23	0	0
17	24470756	.	A	C	1	2	3	0	1	4	0	0
17	24537442	.	G	T	1	1	2	0	1	3	0	0
17	24537450	.	T	A	1	2	3	0	0	3	0	0
17	24600976	.	G	A	1	6	7	0	0	7	0	0
17	24601072	.	G	A	0	3	3	0	4	7	0	0
17	24601579	.	T	A	8	5	13	0	2	15	0	0
17	24601924	.	C	T	11	7	18	0	1	19	0	0
17	24612661	.	G	T	8	6	14	0	0	14	0	0
17	24612726	.	A	G	6	4	10	0	2	12	0	0
17	24614468	.	C	T	28	23	51	0	6	57	0	0
17	24617888	.	C	A	8	23	31	0	1	32	0	0
17	24618912	.	C	T	4	2	6	0	0	6	0	0
17	24618945	.	C	T	1	1	2	0	0	2	0	0
17	24619650	.	A	G	1	4	5	0	0	5	0	0
17	24622623	.	G	T	5	10	15	0	0	15	0	0
17	24622644	.	G	A	7	13	20	0	1	21	0	0
17	24631128	.	T	C	3	3	6	0	1	7	0	0
17	24631156	.	C	T	4	3	7	0	1	8	0	0
17	24685850	.	C	T	8	2	10	0	0	10	0	0
17	24686352	.	C	T	3	5	8	0	1	9	0	0
17	24686443	.	A	T	5	7	12	0	1	13	0	0
17	24686511	.	G	A	4	8	12	0	0	12	0	0
17	24686574	.	A	G	4	2	6	0	0	6	0	0
17	24686575	.	C	G	4	2	6	0	0	6	0	0
17	24687392	.	C	A	2	3	5	0	0	5	0	0
17	24690615	.	G	A	2	2	4	0	1	5	0	0
17	24691987	.	C	T	2	2	4	0	0	4	0	0
17	24692030	.	A	C	2	3	5	0	0	5	0	0
17	24693207	.	T	C	1	0	1	0	0	1	0	0
17	24694145	.	A	G	5	6	11	0	0	11	0	0
17	24694573	.	T	A	1	3	4	0	1	5	0	0
17	24694877	.	C	G	6	4	10	0	0	10	0	0
17	24695096	.	C	A	4	7	11	0	0	11	0	0
17	24695683	.	T	A	7	7	14	0	1	15	0	0
17	24695743	.	G	A	7	10	17	0	0	17	0	0
17	24695815	.	G	C	9	1	10	0	13	23	0	0
17	24696047	.	G	T	21	6	27	0	1	28	0	0
17	24696142	.	A	C	0	6	6	0	0	6	0	0
17	24696658	.	C	A	5	6	11	0	0	11	0	0
17	24696716	.	A	G	4	12	16	0	0	16	0	0
17	24701496	.	C	T	4	6	10	0	1	11	0	0
17	24701767	.	T	C	1	2	3	0	3	6	0	0
17	24701793	.	C	G	0	1	1	0	2	3	0	0
17	24721378	.	C	A	1	1	2	0	1	3	0	0
17	24721384	.	G	A	1	2	3	0	0	3	0	0
17	24725877	.	C	A	9	11	20	0	0	20	0	0
17	24726035	.	A	T	6	4	10	0	0	10	0	0
17	24726134	.	A	G	5	0	5	0	8	13	0	0
17	24726239	.	G	T	8	9	17	0	0	17	0	0
17	24726276	.	A	G	10	6	16	0	1	17	0	0
17	24726533	.	T	A	7	6	13	0	2	15	0	0
17	24726585	.	C	T	13	4	17	0	1	18	0	0
17	24726613	.	G	A	3	11	14	0	2	16	0	0
17	24726637	.	A	G	5	7	12	0	0	12	0	0
17	24726737	.	T	C	7	16	23	0	1	24	0	0
17	24726753	.	G	A	6	14	20	0	0	20	0	0
17	24726996	.	A	G	13	14	27	0	1	28	0	0
17	24727037	.	C	T	17	13	30	0	1	31	0	0
17	24727130	.	T	G	11	0	11	0	14	25	0	0
17	24727186	.	C	G	6	13	19	0	0	19	0	0
17	24815324	.	G	C	2	2	4	0	0	4	0	0
17	24817636	.	A	G	1	2	3	0	0	3	0	0
17	24820401	.	C	T	0	2	2	0	1	3	0	0
17	24835158	.	A	T	5	7	12	0	1	13	0	0
17	24835251	.	G	C	6	8	14	0	0	14	0	0
17	24835547	.	A	T	11	4	15	0	0	15	0	0
17	24855867	.	T	G	5	3	8	0	1	9	0	0
17	24856019	.	G	A	19	16	35	0	0	35	0	0
17	24856088	.	C	G	15	13	28	0	2	30	0	0
17	24856338	.	T	C	6	5	11	0	0	11	0	0
17	24856648	.	G	T	0	5	5	0	0	5	0	0
17	24861176	.	C	T	0	7	7	0	6	13	0	0
17	24861252	.	G	A	3	2	5	0	1	6	0	0
17	24861558	.	A	G	2	5	7	0	0	7	0	0
17	24869963	.	G	A	2	2	4	0	1	5	0	0
17	24869990	.	T	A	2	2	4	0	1	5	0	0
17	24872642	.	G	A	2	1	3	0	0	3	0	0
17	24872714	.	T	A	2	1	3	0	0	3	0	0
17	24880613	.	G	A	5	3	8	0	0	8	0	0
17	24887118	.	T	C	1	1	2	0	0	2	0	0
17	24936070	.	T	C	1	1	2	0	0	2	0	0
17	25298003	.	T	G	7	3	10	0	0	10	0	0
17	25306107	.	G	A	0	5	5	0	0	5	0	0
17	25311113	.	A	T	1	1	2	0	0	2	0	0
17	25336507	.	T	C	1	2	3	0	0	3	0	0
17	25341745	.	T	A	1	6	7	0	0	7	0	0
17	25341751	.	A	C	1	5	6	0	0	6	0	0
17	25341840	.	G	A	1	3	4	0	0	4	0	0
17	25341844	.	A	C	1	3	4	0	0	4	0	0
17	25341977	.	A	T	4	2	6	0	0	6	0	0
17	25342003	.	T	A	2	3	5	0	0	5	0	0
17	25412052	.	C	A	1	3	4	0	0	4	0	0
17	25412090	.	C	T	2	6	8	0	0	8	0	0
17	25412123	.	T	C	1	5	6	0	0	6	0	0
17	25412133	.	G	A	2	6	8	0	0	8	0	0
17	25420151	.	A	G	2	3	5	0	0	5	0	0
17	25420937	.	C	T	2	4	6	0	3	9	0	0
17	25424205	.	C	A	3	8	11	0	0	11	0	0
17	25424239	.	C	T	8	4	12	0	0	12	0	0
17	25424330	.	T	A	12	7	19	0	0	19	0	0
17	25424331	.	C	A	12	7	19	0	0	19	0	0
17	25424462	.	G	T	5	7	12	0	2	14	0	0
17	25424568	.	A	G	10	7	17	0	2	19	0	0
17	25424597	.	C	T	14	4	18	0	1	19	0	0
17	25424664	.	G	A	13	12	25	0	6	31	0	0
17	25424770	.	G	A	0	5	5	0	6	11	0	0
17	25424771	.	A	G	6	5	11	0	0	11	0	0
17	25425081	.	G	T	4	7	11	0	2	13	0	0
17	25425094	.	A	G	3	11	14	0	1	15	0	0
17	25425146	.	T	A	15	11	26	0	1	27	0	0
17	25434250	.	G	T	1	0	1	0	0	1	0	0
17	25435992	.	A	G	23	20	43	0	4	47	0	0
17	25436073	.	T	C	23	26	49	0	1	50	0	0
17	25436591	.	A	T	12	18	30	0	2	32	0	0
17	25439909	.	G	A	30	19	49	0	1	50	0	0
17	25439949	.	C	T	31	9	40	0	4	44	0	0
17	25439950	.	C	A	30	9	39	0	5	44	0	0
17	25440339	.	G	A	2	4	6	0	0	6	0	0
17	25478896	.	C	T	2	2	4	0	0	4	0	0
17	25478897	.	T	G	2	2	4	0	0	4	0	0
17	25479147	.	T	A	2	4	6	0	0	6	0	0
17	25479151	.	A	C	2	3	5	0	1	6	0	0
17	25479594	.	T	A	6	8	14	0	0	14	0	0
17	25479640	.	A	G	9	9	18	0	1	19	0	0
17	25479792	.	G	A	13	9	22	0	0	22	0	0
17	25479874	.	T	A	11	9	20	0	1	21	0	0
17	25479920	.	A	G	5	6	11	0	1	12	0	0
17	25548992	.	G	A	0	1	1	0	1	2	0	0
17	25549001	.	G	T	0	1	1	0	2	3	0	0
17	25550449	.	G	A	1	0	1	0	0	1	0	0
17	25550450	.	G	A	1	0	1	0	0	1	0	0
17	25555209	.	G	A	1	0	1	0	0	1	0	0
17	25558916	.	G	A	2	3	5	0	0	5	0	0
17	25559072	.	G	A	1	0	1	0	1	2	0	0
17	25559162	.	A	T	3	0	3	0	0	3	0	0
17	25559491	.	A	G	1	0	1	0	0	1	0	0
17	25563542	.	G	A	0	2	2	0	0	2	0	0
17	25585750	.	G	T	4	4	8	0	0	8	0	0
17	25585755	.	A	C	4	4	8	0	0	8	0	0
17	25593945	.	G	A	0	0	0	0	1	1	0	0
17	25602744	.	C	T	1	1	2	0	0	2	0	0
17	25606154	.	G	A	0	10	10	0	11	21	0	0
17	25606161	.	C	T	11	12	23	0	2	25	0	0
17	25606421	.	T	A	9	8	17	0	0	17	0	0
17	25610895	.	G	T	6	8	14	0	1	15	0	0
17	25610975	.	C	T	0	6	6	0	6	12	0	0
17	25610989	.	C	T	5	4	9	0	0	9	0	0
17	25611011	.	A	G	6	3	9	0	0	9	0	0
17	25611067	.	A	C	5	5	10	0	2	12	0	0
17	25611091	.	C	A	0	4	4	0	5	9	0	0
17	25612941	.	G	C	4	2	6	0	0	6	0	0
17	25612978	.	G	A	1	0	1	0	0	1	0	0
17	25615493	.	A	G	2	1	3	0	0	3	0	0
17	25615609	.	T	A	2	1	3	0	0	3	0	0
17	25636167	.	G	A	19	28	47	0	1	48	0	0
17	25636381	.	C	T	2	29	31	0	35	66	0	0
17	25636412	.	A	G	32	23	55	0	7	62	0	0
17	25636539	.	T	C	27	6	33	0	38	71	0	0
17	25636594	.	C	T	2	41	43	0	25	68	0	0
17	25636679	.	C	T	1	24	25	0	38	63	0	0
17	25637106	.	A	C	19	26	45	0	3	48	0	0
17	25637676	.	T	C	11	0	11	0	20	31	0	0
17	25640476	.	G	A	1	3	4	0	0	4	0	0
17	25885415	.	T	A	3	3	6	0	1	7	0	0
17	25885418	.	C	G	3	4	7	0	0	7	0	0
17	26352256	.	T	C	0	2	2	0	0	2	0	0
17	26362130	.	G	A	13	5	18	0	3	21	0	0
17	26362500	.	C	T	2	4	6	0	1	7	0	0
17	26362512	.	A	C	7	3	10	0	0	11	1	0
17	26362539	.	C	T	8	4	12	0	0	12	0	0
17	26362741	.	C	T	3	5	8	0	0	8	0	0
17	26477743	.	A	C	11	6	17	0	2	19	0	0
17	26477747	.	T	A	10	9	19	0	2	21	0	0
17	26477795	.	A	C	10	9	19	0	1	20	0	0
17	26477857	.	T	C	12	13	25	0	0	25	0	0
17	26477860	.	C	T	9	12	21	0	5	26	0	0
17	26478023	.	T	C	14	7	21	0	1	22	0	0
17	26478403	.	T	G	4	6	10	0	1	11	0	0
17	26478544	.	A	T	2	5	7	0	0	7	0	0
17	26478563	.	C	T	6	5	11	0	0	11	0	0
17	26478592	.	A	G	10	11	21	0	0	21	0	0
17	26478818	.	T	C	2	0	2	0	7	9	0	0
17	26478952	.	G	A	7	8	15	0	2	17	0	0
17	26478986	.	A	G	8	4	12	0	1	13	0	0
17	26479063	.	A	G	6	8	14	0	1	15	0	0
17	26479145	.	T	C	6	7	13	0	1	14	0	0
17	26480421	.	A	G	2	2	4	0	1	5	0	0
17	26480423	.	T	C	2	2	4	0	1	5	0	0
17	26480926	.	T	G	2	2	4	0	0	4	0	0
17	26585316	.	C	T	1	2	3	0	0	3	0	0
17	26585727	.	C	T	1	2	3	0	0	3	0	0
17	26585763	.	T	A	5	4	9	0	0	9	0	0
17	26590001	.	T	G	7	4	11	0	0	11	0	0
17	26590054	.	C	T	1	2	3	0	0	3	0	0
17	26590091	.	C	T	1	2	3	0	0	3	0	0
17	26590330	.	T	C	4	2	6	0	1	7	0	0
17	26590650	.	G	T	2	2	4	0	0	4	0	0
17	26657852	.	T	C	1	2	3	0	0	3	0	0
17	26683526	.	C	T	5	3	8	0	0	8	0	0
17	26689753	.	G	A	11	7	18	0	3	21	0	0
17	26689768	.	C	A	11	6	17	0	1	18	0	0
17	26689792	.	C	A	6	11	17	0	1	18	0	0
17	26690112	.	T	A	15	18	33	0	1	34	0	0
17	26690250	.	C	T	11	9	20	0	0	20	0	0
17	26690276	.	C	T	13	10	23	0	0	23	0	0
17	26690478	.	C	T	12	10	22	0	4	26	0	0
17	26690558	.	G	A	0	16	16	0	23	39	0	0
17	26714009	.	C	T	30	22	52	0	4	56	0	0
17	26744748	.	T	A	2	2	4	0	0	4	0	0
17	26744862	.	G	A	1	2	3	0	1	4	0	0
17	26745106	.	T	C	3	3	6	0	0	6	0	0
17	26745110	.	C	T	2	3	5	0	0	5	0	0
17	26745203	.	C	A	2	2	4	0	0	4	0	0
17	26810380	.	C	T	4	6	10	0	0	10	0	0
17	26813285	.	T	C	3	19	22	0	9	31	0	0
17	26846901	.	T	G	4	6	10	0	0	10	0	0
17	26847905	.	C	A	2	2	4	0	0	4	0	0
17	26879854	.	A	C	12	20	32	0	0	32	0	0
17	26879869	.	A	G	14	15	29	0	0	29	0	0
17	26879893	.	A	G	21	21	42	0	1	43	0	0
17	26880107	.	G	A	22	16	38	0	3	41	0	0
17	26880231	.	T	C	27	23	50	0	1	51	0	0
17	26880424	.	T	C	20	17	37	0	2	39	0	0
17	26880964	.	A	G	17	21	38	0	3	41	0	0
17	26881131	.	T	A	17	8	25	0	2	27	0	0
17	26881354	.	A	G	13	6	19	0	0	19	0	0
17	26881777	.	A	G	8	10	18	0	0	18	0	0
17	26911747	.	A	G	3	5	8	0	0	8	0	0
17	26929475	.	T	C	5	2	7	0	0	7	0	0
17	26929577	.	C	A	6	5	11	0	0	11	0	0
17	26929649	.	A	G	1	2	3	0	0	3	0	0
17	26929654	.	T	A	2	1	3	0	0	3	0	0
17	26929776	.	C	T	1	4	5	0	0	5	0	0
17	26929893	.	G	A	1	1	2	0	0	2	0	0
17	26985473	.	G	A	1	2	3	0	0	3	0	0
17	27169561	.	T	G	1	3	4	0	1	5	0	0
17	27170017	.	G	A	0	7	7	0	2	9	0	0
17	27170153	.	A	T	3	2	5	0	2	7	0	0
17	27170516	.	G	A	0	5	5	0	9	14	0	0
17	27170549	.	G	A	8	3	11	0	1	12	0	0
17	27170605	.	T	G	6	10	16	0	0	16	0	0
17	27170678	.	C	A	3	10	13	0	0	13	0	0
17	27170730	.	T	G	2	9	11	0	3	14	0	0
17	27170746	.	A	T	3	11	14	0	0	14	0	0
17	27170961	.	T	C	1	2	3	0	0	3	0	0
17	27171314	.	A	C	4	4	8	0	0	8	0	0
17	27178296	.	G	A	0	2	2	0	1	3	0	0
17	27181048	.	C	G	2	6	8	0	0	8	0	0
17	27181129	.	G	A	2	5	7	0	1	8	0	0
17	27181130	.	G	A	2	6	8	0	0	8	0	0
17	27181257	.	A	C	4	2	6	0	0	6	0	0
17	27181427	.	C	T	2	3	5	0	0	5	0	0
17	27182006	.	G	T	6	1	7	0	0	7	0	0
17	27182039	.	T	C	6	7	13	0	0	13	0	0
17	27182114	.	A	G	2	5	7	0	0	7	0	0
17	27182146	.	C	T	1	6	7	0	0	7	0	0
17	27182232	.	T	G	3	2	5	0	1	6	0	0
17	27182331	.	T	G	2	5	7	0	0	7	0	0
17	27182340	.	C	T	2	5	7	0	0	7	0	0
17	27182449	.	G	T	3	6	9	0	0	9	0	0
17	27182484	.	T	C	4	7	11	0	0	11	0	0
17	27182645	.	G	T	15	12	27	0	1	28	0	0
17	27182649	.	A	G	15	12	27	0	2	29	0	0
17	27182769	.	A	G	2	6	8	0	2	10	0	0
17	27182894	.	T	C	7	3	10	0	0	10	0	0
17	27182925	.	A	T	3	6	9	0	0	9	0	0
17	27182979	.	C	T	7	8	15	0	0	15	0	0
17	27192756	.	G	C	2	2	4	0	0	4	0	0
17	27272913	.	T	C	4	3	7	0	0	7	0	0
17	27273013	.	C	T	3	2	5	0	0	5	0	0
17	27401038	.	A	T	11	12	23	0	4	27	0	0
17	27408386	.	A	G	7	11	18	0	1	19	0	0
17	27408472	.	C	T	10	6	16	0	2	18	0	0
17	27408523	.	G	T	4	4	8	0	0	8	0	0
17	27408531	.	T	A	2	3	5	0	1	6	0	0
17	27408836	.	T	G	4	4	8	0	1	9	0	0
17	27408889	.	T	C	0	5	5	0	1	6	0	0
17	27413564	.	T	C	1	0	1	0	0	1	0	0
17	27413705	.	T	C	3	6	9	0	0	9	0	0
17	27414215	.	C	T	0	4	4	0	5	9	0	0
17	27414367	.	A	G	2	2	4	0	0	4	0	0
17	27414658	.	T	C	1	2	3	0	0	3	0	0
17	27807455	.	T	C	3	7	10	0	0	10	0	0
17	27808335	.	A	G	7	10	17	0	0	17	0	0
17	27808686	.	G	A	3	3	6	0	0	6	0	0
17	27808700	.	G	A	2	4	6	0	0	6	0	0
17	27808987	.	G	T	0	17	17	0	27	44	0	0
17	27809127	.	T	G	1	1	2	0	19	21	0	0
17	27809548	.	T	A	8	6	14	0	2	16	0	0
17	27809631	.	G	T	0	3	3	0	10	13	0	0
17	27809779	.	C	A	17	20	37	1	1	39	0	0
17	27809885	.	A	G	25	16	41	0	3	44	0	0
17	27811199	.	T	A	2	2	4	0	0	4	0	0
17	27811209	.	A	G	2	2	4	0	0	4	0	0
17	27812525	.	A	C	23	7	30	0	4	34	0	0
17	27812562	.	G	A	1	6	7	0	24	31	0	0
17	27812702	.	A	T	12	9	21	0	1	22	0	0
17	27812780	.	T	A	1	2	3	0	0	3	0	0
17	27812885	.	C	T	2	3	5	0	1	6	0	0
17	27813221	.	C	T	13	10	23	0	0	23	0	0
17	27813222	.	A	G	12	10	22	0	1	23	0	0
17	27813549	.	C	G	8	4	12	0	2	14	0	0
17	27813553	.	C	G	6	4	10	0	2	12	0	0
17	28069170	.	G	A	1	4	5	0	0	5	0	0
17	28069341	.	G	T	1	2	3	0	0	3	0	0
17	28069342	.	T	C	1	2	3	0	0	3	0	0
17	28069645	.	G	T	3	2	5	0	0	5	0	0
17	28069716	.	G	C	1	9	10	0	2	12	0	0
17	28069787	.	G	A	0	6	6	0	6	12	0	0
17	28070078	.	G	C	6	2	8	0	2	10	0	0
17	28070167	.	C	T	2	6	8	0	0	8	0	0
17	28070284	.	G	A	1	3	4	0	1	5	0	0
17	28070286	.	A	C	2	3	5	0	0	5	0	0
17	28070481	.	T	A	7	10	17	0	0	17	0	0
17	28070600	.	C	A	3	4	7	0	1	8	0	0
17	28070840	.	G	A	4	3	7	0	0	7	0	0
17	28070879	.	T	G	4	3	7	0	1	8	0	0
17	28071260	.	A	G	5	5	10	0	0	10	0	0
17	28084592	.	C	T	7	8	15	0	0	15	0	0
17	28084733	.	T	C	19	14	33	0	3	36	0	0
17	28084869	.	A	C	18	24	42	0	3	45	0	0
17	28084996	.	A	T	24	11	35	0	0	35	0	0
17	28100598	.	C	T	0	4	4	0	5	9	0	0
17	28166980	.	C	T	3	9	12	0	0	12	0	0
17	28167235	.	T	C	5	0	5	0	6	11	0	0
17	28167439	.	G	A	7	7	14	0	0	14	0	0
17	28560736	.	T	C	0	3	3	0	0	3	0	0
17	28563725	.	G	A	6	5	11	0	1	12	0	0
17	28666381	.	C	T	0	1	1	0	0	1	0	0
17	28701100	.	G	A	13	5	18	0	3	21	0	0
17	28707268	.	T	A	1	2	3	0	0	3	0	0
17	28741467	.	G	A	0	8	8	0	4	12	0	0
17	28741752	.	C	T	8	5	13	0	0	13	0	0
17	28741934	.	C	T	6	2	8	0	2	10	0	0
17	28742263	.	G	C	9	16	25	0	3	28	0	0
17	28742385	.	T	A	12	7	19	0	1	20	0	0
17	28742505	.	T	G	24	17	41	0	1	42	0	0
17	28742559	.	C	T	20	14	34	0	1	35	0	0
17	28742681	.	C	T	2	7	9	0	0	9	0	0
17	28771228	.	T	A	2	1	3	0	0	3	0	0
17	28778186	.	C	T	1	0	1	0	0	1	0	0
17	28784090	.	G	T	1	2	3	0	0	3	0	0
17	28785010	.	G	A	1	2	3	0	0	3	0	0
17	28968461	.	T	C	13	19	32	0	3	35	0	0
17	28968969	.	A	G	7	3	10	0	4	14	0	0
17	29117355	.	G	A	7	3	10	0	0	10	0	0
17	29227594	.	G	A	2	2	4	0	1	5	0	0
17	29227600	.	G	A	1	2	3	0	1	4	0	0
17	29227691	.	T	A	3	2	5	0	0	5	0	0
17	29252043	.	C	T	5	5	10	0	1	11	0	0
17	29252122	.	C	A	4	9	13	0	1	14	0	0
17	29252218	.	C	T	7	7	14	0	1	15	0	0
17	29252254	.	C	T	6	4	10	0	0	10	0	0
17	29252308	.	T	G	4	2	6	0	0	6	0	0
17	29252352	.	C	T	2	1	3	0	1	4	0	0
17	29252754	.	C	G	0	4	4	0	3	7	0	0
17	29339149	.	T	G	5	7	12	0	0	12	0	0
17	29341079	.	C	T	3	3	6	0	0	6	0	0
17	29341118	.	C	T	2	4	6	0	0	6	0	0
17	29341597	.	T	C	2	6	8	0	0	8	0	0
17	29342904	.	G	A	0	4	4	0	1	5	0	0
17	29342947	.	C	T	4	8	12	0	0	12	0	0
17	29343143	.	T	C	17	15	32	0	1	33	0	0
17	29343153	.	G	A	19	15	34	0	0	34	0	0
17	29343358	.	A	G	17	8	25	0	1	26	0	0
17	29343494	.	A	G	8	9	17	0	3	20	0	0
17	29369213	.	T	G	1	3	4	0	0	4	0	0
17	29369604	.	A	G	1	1	2	0	0	2	0	0
17	29369612	.	A	G	2	2	4	0	0	4	0	0
17	30468730	.	G	T	0	1	1	0	1	2	0	0
17	30468735	.	G	T	2	3	5	0	0	5	0	0
17	30469200	.	C	A	1	3	4	0	1	5	0	0
17	30470034	.	C	T	1	2	3	0	2	5	0	0
17	30474161	.	A	G	2	3	5	0	0	5	0	0
17	30479359	.	T	C	0	2	2	0	0	2	0	0
17	30493290	.	T	C	2	3	5	0	0	5	0	0
17	30590020	.	A	G	2	3	5	0	2	7	0	0
17	30590271	.	G	T	4	7	11	0	3	14	0	0
17	30590273	.	C	G	5	8	13	0	1	14	0	0
17	30590325	.	C	T	1	9	10	0	0	10	0	0
17	30590367	.	G	A	5	4	9	0	1	10	0	0
17	30590838	.	T	C	8	8	16	0	2	18	0	0
17	30590842	.	C	A	8	9	17	0	0	17	0	0
17	30817119	.	T	A	3	2	5	0	0	5	0	0
17	30857288	.	A	G	11	11	22	0	2	24	0	0
17	30858809	.	C	T	0	13	13	0	4	17	0	0
17	30860630	.	G	T	1	4	5	0	0	5	0	0
17	30862909	.	A	G	6	4	10	0	0	10	0	0
17	30900986	.	C	A	4	2	6	0	1	7	0	0
17	30936802	.	C	T	0	7	7	0	5	12	0	0
17	30979170	.	T	C	10	14	24	0	0	24	0	0
17	30979208	.	T	C	10	10	20	0	1	21	0	0
17	30979339	.	T	C	12	6	18	0	0	18	0	0
17	30979391	.	T	C	4	1	5	0	18	23	0	0
17	30979518	.	G	A	7	6	13	0	0	13	0	0
17	30980336	.	A	G	3	4	7	0	2	9	0	0
17	30986712	.	G	T	2	4	6	0	0	6	0	0
17	30995008	.	G	A	2	3	5	0	0	5	0	0
17	31201207	.	C	T	2	4	6	0	0	6	0	0
17	31201523	.	A	T	4	3	7	0	0	7	0	0
17	31201894	.	A	C	2	4	6	0	3	9	0	0
17	31201954	.	A	G	6	5	11	0	1	12	0	0
17	31205375	.	T	A	3	2	5	0	0	5	0	0
17	31205614	.	G	A	7	3	10	0	0	10	0	0
17	31217113	.	T	A	0	1	1	0	0	1	0	0
17	31222505	.	A	T	3	8	11	0	1	12	0	0
17	31228767	.	G	C	22	8	30	0	2	32	0	0
17	31228801	.	C	T	16	7	23	0	1	24	0	0
17	31228837	.	G	A	0	15	15	0	16	31	0	0
17	31228900	.	T	C	6	8	14	0	2	16	0	0
17	31228942	.	G	A	2	4	6	0	0	6	0	0
17	31277169	.	A	T	10	18	28	0	2	30	0	0
17	31277443	.	A	G	15	17	32	0	1	33	0	0
17	31277820	.	C	A	9	9	18	0	0	18	0	0
17	31277855	.	G	A	8	8	16	0	3	19	0	0
17	31278022	.	G	A	7	6	13	0	1	14	0	0
17	31278433	.	C	A	7	15	22	0	1	23	0	0
17	31346575	.	A	G	1	3	4	0	1	5	0	0
17	31346582	.	T	C	1	3	4	0	1	5	0	0
17	31346653	.	C	T	3	11	14	0	1	15	0	0
17	31346695	.	A	G	6	6	12	0	1	13	0	0
17	31346712	.	G	A	5	7	12	0	1	13	0	0
17	31346840	.	A	G	3	7	10	0	1	11	0	0
17	31347029	.	T	A	10	20	30	0	1	31	0	0
17	31347046	.	T	G	10	15	25	0	8	33	0	0
17	31347193	.	A	C	9	12	21	0	1	22	0	0
17	31347254	.	A	G	7	10	17	0	1	18	0	0
17	31347344	.	C	G	4	6	10	0	0	10	0	0
17	31360854	.	G	A	1	2	3	0	0	3	0	0
17	31393786	.	T	C	1	2	3	0	0	3	0	0
17	31535903	.	T	G	3	2	5	0	0	5	0	0
17	31535967	.	A	G	7	2	9	0	0	9	0	0
17	31540138	.	C	T	0	1	1	0	0	1	0	0
17	31546169	.	G	A	3	1	4	0	1	5	0	0
17	31590984	.	G	A	1	4	5	0	0	5	0	0
17	31590986	.	A	G	1	4	5	0	0	5	0	0
17	31606944	.	A	C	3	1	4	0	0	4	0	0
17	31616799	.	T	C	2	2	4	0	1	5	0	0
17	31618624	.	C	T	0	1	1	0	0	1	0	0
17	31618636	.	T	C	1	2	3	0	1	4	0	0
17	31618953	.	T	C	13	22	35	0	0	35	0	0
17	31618962	.	A	G	13	18	31	0	3	34	0	0
17	31621894	.	C	T	4	3	7	0	0	7	0	0
17	31621921	.	C	A	4	4	8	0	0	8	0	0
17	31622024	.	C	A	5	5	10	0	1	11	0	0
17	31622083	.	A	C	4	8	12	0	2	14	0	0
17	31622123	.	C	A	5	10	15	0	0	15	0	0
17	31622233	.	T	A	1	0	1	0	0	1	0	0
17	31622367	.	A	G	8	2	10	0	0	10	0	0
17	31622662	.	C	T	5	2	7	0	0	7	0	0
17	31622690	.	A	C	3	1	4	0	1	5	0	0
17	31622715	.	T	C	2	3	5	0	1	6	0	0
17	31622765	.	G	A	1	2	3	0	1	4	0	0
17	31623588	.	A	G	4	5	9	0	1	10	0	0
17	31623635	.	C	T	7	3	10	0	2	12	0	0
17	31623646	.	A	G	9	5	14	0	1	15	0	0
17	31623829	.	G	C	13	11	24	0	3	27	0	0
17	31624119	.	A	T	7	3	10	0	1	11	0	0
17	31624604	.	A	G	8	6	14	0	0	15	1	0
17	31624652	.	C	T	0	7	7	0	11	18	0	0
17	31624682	.	A	G	10	6	16	0	0	16	0	0
17	31624716	.	T	A	5	12	17	0	1	18	0	0
17	31628953	.	G	T	1	2	3	0	1	4	0	0
17	31632751	.	C	T	3	4	7	0	0	7	0	0
17	31633186	.	C	T	5	5	10	0	0	10	0	0
17	31668688	.	G	A	4	2	6	0	0	6	0	0
17	31697126	.	G	T	3	4	7	0	0	7	0	0
17	31697158	.	A	G	5	4	9	0	0	9	0	0
17	31721451	.	G	A	0	1	1	0	2	3	0	0
17	31746341	.	T	A	0	3	3	0	0	3	0	0
17	31746833	.	G	A	1	3	4	0	0	4	0	0
17	31796240	.	C	T	9	8	17	0	1	18	0	0
17	31796481	.	T	G	15	7	22	0	0	22	0	0
17	31796576	.	G	A	5	6	11	0	0	11	0	0
17	31796821	.	T	A	5	11	16	0	0	16	0	0
17	31806710	.	T	C	1	3	4	0	0	4	0	0
17	31820605	.	T	C	1	4	5	0	0	5	0	0
17	31823547	.	C	T	1	6	7	0	0	7	0	0
17	32366387	.	A	G	2	3	5	0	2	7	0	0
17	32366543	.	A	G	0	5	5	0	0	5	0	0
17	32367193	.	A	G	1	3	4	0	0	4	0	0
17	32367238	.	A	C	2	2	4	0	0	4	0	0
17	32500495	.	G	A	1	0	1	0	1	2	0	0
17	32516973	.	T	C	5	6	11	0	0	11	0	0
17	32524654	.	C	T	22	16	38	0	3	41	0	0
17	32524695	.	A	G	36	14	50	0	4	54	0	0
17	32524851	.	T	G	30	33	63	0	4	67	0	0
17	32535870	.	C	A	0	1	1	0	0	1	0	0
17	32536401	.	C	T	1	0	1	0	0	1	0	0
17	32549402	.	T	C	1	2	3	0	0	3	0	0
17	32549416	.	G	A	2	4	6	0	0	6	0	0
17	32549725	.	C	G	3	4	7	0	0	7	0	0
17	32551164	.	G	T	1	4	5	0	0	5	0	0
17	32551176	.	T	C	1	3	4	0	1	5	0	0
17	32623004	.	T	G	2	2	4	0	0	4	0	0
17	32623009	.	T	G	2	2	4	0	0	4	0	0
17	32624653	.	A	C	3	3	6	0	0	6	0	0
17	32624668	.	A	T	2	3	5	0	1	6	0	0
17	32624910	.	T	C	1	2	3	0	0	3	0	0
17	32624916	.	A	T	1	2	3	0	0	3	0	0
17	32629418	.	T	A	4	2	6	0	0	6	0	0
17	32629885	.	C	T	7	0	7	0	1	8	0	0
17	32629918	.	G	T	21	0	21	0	1	22	0	0
17	32631400	.	C	T	3	6	9	0	1	10	0	0
17	32631533	.	A	G	6	3	9	0	0	9	0	0
17	32631560	.	G	T	4	7	11	0	0	11	0	0
17	32631603	.	C	G	1	4	5	0	0	5	0	0
17	33306121	.	A	G	2	6	8	0	0	8	0	0
17	33307917	.	C	T	1	1	2	0	1	3	0	0
17	33709164	.	G	A	0	4	4	0	1	5	0	0
17	37445729	.	G	A	3	3	6	0	0	6	0	0
17	37445924	.	G	A	4	10	14	0	1	15	0	0
17	37446208	.	A	T	5	6	11	0	0	11	0	0
17	37446443	.	T	G	4	2	6	0	0	6	0	0
17	37446555	.	T	A	1	7	8	0	0	8	0	0
17	37446563	.	G	A	1	8	9	0	1	10	0	0
17	37446735	.	G	A	2	9	11	0	1	12	0	0
17	37446788	.	A	C	4	4	8	0	0	8	0	0
17	37606011	.	G	A	0	3	3	0	2	5	0	0
17	37606101	.	G	A	0	2	2	0	5	7	0	0
17	37606116	.	G	A	1	2	3	0	0	3	0	0
17	37618028	.	C	G	4	4	8	0	0	8	0	0
17	37618143	.	T	C	4	9	13	0	0	13	0	0
17	37618157	.	A	C	6	4	10	0	2	12	0	0
17	37618316	.	C	T	3	2	5	0	0	5	0	0
17	37618485	.	C	T	6	10	16	0	4	20	0	0
17	38232211	.	A	T	2	2	4	0	0	4	0	0
17	38232359	.	C	A	2	3	5	0	1	6	0	0
17	38264044	.	G	T	7	5	12	0	1	13	0	0
17	38264348	.	T	C	0	3	3	0	0	3	0	0
17	38303423	.	C	T	3	6	9	0	3	12	0	0
17	38303607	.	A	G	1	1	2	0	0	2	0	0
17	38303652	.	G	A	0	1	1	0	1	2	0	0
17	38713334	.	G	T	1	2	3	0	0	3	0	0
17	38714125	.	A	T	4	2	6	0	0	6	0	0
17	38714133	.	G	T	4	2	6	0	0	6	0	0
17	38714446	.	A	G	1	3	4	0	0	4	0	0
17	38714578	.	A	T	1	1	2	0	0	2	0	0
17	38740533	.	T	C	1	3	4	0	0	4	0	0
17	38740626	.	G	A	3	2	5	0	0	5	0	0
17	38740684	.	T	C	4	10	14	0	1	15	0	0
17	38740698	.	A	T	4	8	12	0	0	12	0	0
17	38751711	.	T	A	2	0	2	0	0	2	0	0
17	38754897	.	A	G	1	5	6	0	0	6	0	0
17	38754900	.	T	C	1	0	1	0	5	6	0	0
17	38755038	.	A	G	2	2	4	0	1	5	0	0
17	38756777	.	T	G	3	2	5	0	0	5	0	0
17	38760619	.	G	A	0	1	1	0	0	1	0	0
17	38769924	.	T	A	3	1	4	0	0	4	0	0
17	38769975	.	G	A	3	1	4	0	0	4	0	0
17	38784642	.	T	C	1	6	7	0	0	7	0	0
17	39728239	.	C	T	3	1	4	0	0	4	0	0
17	39728261	.	G	T	3	2	5	0	0	5	0	0
17	39728423	.	T	A	1	2	3	0	1	4	0	0
17	39728672	.	A	T	2	4	6	0	2	8	0	0
17	39728677	.	A	G	0	0	0	0	8	8	0	0
17	39729014	.	G	A	7	4	11	0	0	11	0	0
17	39732573	.	C	A	6	3	9	0	0	9	0	0
17	39732584	.	G	A	3	6	9	0	0	9	0	0
17	39736088	.	T	A	5	3	8	0	0	8	0	0
17	39736103	.	G	A	4	5	9	0	0	9	0	0
17	39736130	.	T	C	5	7	12	0	0	12	0	0
17	39739842	.	A	T	8	9	17	0	2	19	0	0
17	40900146	.	T	A	2	2	4	0	0	4	0	0
17	40901609	.	G	A	2	3	5	0	0	5	0	0
17	40901695	.	G	C	3	6	9	0	0	9	0	0
17	40901712	.	C	G	2	5	7	0	1	8	0	0
17	40902005	.	C	A	4	4	8	0	2	10	0	0
17	40902065	.	G	A	2	2	4	0	0	4	0	0
17	40902148	.	G	T	2	3	5	0	0	5	0	0
17	40902180	.	G	C	2	4	6	0	0	6	0	0
17	40902297	.	A	G	1	2	3	0	1	4	0	0
17	40902598	.	G	A	5	9	14	0	0	14	0	0
17	40902629	.	A	T	3	9	12	0	0	12	0	0
17	40902657	.	A	C	9	6	15	0	1	16	0	0
17	40902830	.	A	T	7	6	13	0	1	14	0	0
17	40903162	.	C	T	5	9	14	0	0	14	0	0
17	40990061	.	T	A	4	6	10	0	0	10	0	0
17	40990097	.	T	A	3	1	4	0	0	4	0	0
17	40999460	.	A	G	18	9	27	0	1	28	0	0
17	40999697	.	C	G	9	8	17	0	2	19	0	0
17	40999700	.	C	A	10	8	18	0	0	18	0	0
17	40999732	.	A	G	5	11	16	0	0	16	0	0
17	40999964	.	G	T	2	2	4	0	0	4	0	0
17	41254741	.	C	T	1	0	1	0	0	1	0	0
17	41264045	.	T	A	1	2	3	0	0	3	0	0
17	41264054	.	G	A	2	1	3	0	1	4	0	0
17	41264165	.	C	A	2	4	6	0	0	6	0	0
17	41317234	.	A	G	4	0	4	0	6	10	0	0
17	41317494	.	G	A	8	9	17	0	3	20	0	0
17	41317999	.	G	A	4	14	18	0	3	21	0	0
17	41318310	.	A	G	11	8	19	0	1	20	0	0
17	41318392	.	G	A	1	2	3	0	1	4	0	0
17	41465504	.	A	C	2	5	7	0	0	7	0	0
17	41465922	.	G	A	6	4	10	0	1	11	0	0
17	41475863	.	T	C	10	12	22	0	1	23	0	0
17	41476104	.	T	C	11	0	11	0	25	36	0	0
17	41476161	.	A	G	20	19	39	1	1	41	0	0
17	41476279	.	G	A	13	9	22	0	2	24	0	0
17	41476298	.	T	A	9	11	20	0	3	23	0	0
17	41476393	.	G	T	8	4	12	0	1	13	0	0
17	41476833	.	T	C	1	6	7	0	0	7	0	0
17	41476906	.	A	C	1	0	1	0	3	4	0	0
17	41476917	.	C	T	0	3	3	0	1	4	0	0
17	41476970	.	T	C	1	4	5	0	0	5	0	0
17	41476994	.	G	A	2	7	9	0	0	9	0	0
17	41477007	.	C	T	0	5	5	0	5	10	0	0
17	41477324	.	G	A	5	4	9	0	0	9	0	0
17	42027915	.	C	T	2	2	4	0	0	4	0	0
17	42095539	.	A	T	2	3	5	0	0	5	0	0
17	42095602	.	A	G	3	4	7	0	0	7	0	0
17	42095620	.	C	T	2	3	5	0	2	7	0	0
17	42566169	.	C	T	0	2	2	0	3	5	0	0
17	42566189	.	T	G	2	2	4	0	0	4	0	0
17	42871419	.	G	T	1	3	4	0	0	4	0	0
17	43013675	.	G	A	3	1	4	0	1	5	0	0
17	43017672	.	C	T	5	3	8	0	1	9	0	0
17	43017687	.	G	A	8	3	11	0	0	11	0	0
17	43017863	.	A	C	2	2	4	0	0	4	0	0
17	43018037	.	G	A	0	8	8	0	7	15	0	0
17	43018124	.	A	G	15	0	15	0	1	16	0	0
17	43018273	.	G	A	15	16	31	0	1	32	0	0
17	43018382	.	T	G	13	13	26	0	2	28	0	0
17	43018502	.	T	A	13	19	32	0	0	33	1	0
17	43018549	.	C	G	5	21	26	0	2	28	0	0
17	43018638	.	A	T	18	17	35	0	2	37	0	0
17	43018815	.	A	G	18	16	34	0	5	39	0	0
17	43018899	.	T	A	16	22	38	0	1	39	0	0
17	43030737	.	T	G	4	6	10	0	1	11	0	0
17	43030828	.	G	A	2	4	6	0	0	6	0	0
17	43031495	.	G	A	1	1	2	0	0	2	0	0
17	43033177	.	G	A	8	4	12	0	0	12	0	0
17	43035798	.	T	C	15	19	34	0	5	39	0	0
17	43035996	.	G	T	11	16	27	0	0	27	0	0
17	43036025	.	A	G	9	15	24	0	1	25	0	0
17	43036055	.	T	C	14	5	19	0	1	20	0	0
17	43036075	.	T	G	8	8	16	0	1	17	0	0
17	43036109	.	A	G	5	6	11	0	1	12	0	0
17	43075560	.	G	T	0	1	1	0	0	1	0	0
17	43075561	.	G	A	0	1	1	0	0	1	0	0
17	43302492	.	G	A	1	0	1	0	2	3	0	0
17	43309164	.	C	T	0	2	2	0	0	2	0	0
17	43437305	.	G	C	6	3	9	0	2	11	0	0
17	43437365	.	C	G	2	1	3	0	3	6	0	0
17	43439720	.	G	T	4	5	9	0	1	10	0	0
17	43441575	.	A	T	0	1	1	0	0	1	0	0
17	43453507	.	T	C	1	1	2	0	1	3	0	0
17	43453531	.	G	A	2	1	3	0	1	4	0	0
17	43456921	.	T	C	1	3	4	0	0	4	0	0
17	43461181	.	G	A	0	1	1	0	0	1	0	0
17	43473913	.	T	C	4	1	5	0	0	5	0	0
17	43475577	.	G	A	0	8	8	0	6	14	0	0
17	43475619	.	A	G	4	0	4	0	9	13	0	0
17	43476046	.	C	T	6	3	9	0	5	14	0	0
17	43476137	.	T	A	7	8	15	0	0	15	0	0
17	43476241	.	A	G	1	2	3	0	0	3	0	0
17	43513109	.	G	A	15	6	21	0	0	21	0	0
17	43516464	.	T	A	1	1	2	0	0	2	0	0
17	43516502	.	G	T	1	3	4	0	0	4	0	0
17	43516506	.	A	C	1	3	4	0	0	4	0	0
17	43516548	.	A	G	1	2	3	0	0	3	0	0
17	43519741	.	C	T	5	2	7	0	0	7	0	0
17	43520136	.	G	A	3	2	5	0	0	5	0	0
17	43520158	.	A	G	4	2	6	0	1	7	0	0
17	43520191	.	G	A	6	4	10	0	1	11	0	0
17	43538018	.	A	C	1	3	4	0	0	4	0	0
17	43612005	.	G	T	1	2	3	0	0	3	0	0
17	43612007	.	T	A	1	1	2	0	1	3	0	0
17	43660232	.	G	A	2	3	5	0	1	6	0	0
17	43660779	.	T	C	1	5	6	0	1	7	0	0
17	43661106	.	T	G	3	6	9	0	0	9	0	0
17	43661291	.	G	T	4	1	5	0	2	7	0	0
17	43661293	.	A	T	4	1	5	0	2	7	0	0
17	43663611	.	T	G	2	4	6	0	0	6	0	0
17	43663789	.	A	C	14	15	29	0	2	31	0	0
17	43663870	.	G	A	17	16	33	0	1	34	0	0
17	43664128	.	G	C	9	13	22	0	3	25	0	0
17	43664580	.	A	G	2	9	11	0	1	12	0	0
17	43664605	.	G	A	3	4	7	0	2	9	0	0
17	43708546	.	C	T	1	8	9	0	1	10	0	0
17	43708649	.	T	C	3	5	8	0	0	8	0	0
17	43711557	.	C	T	0	1	1	0	0	1	0	0
17	43715851	.	T	C	2	3	5	0	0	5	0	0
17	43716727	.	A	G	1	1	2	0	0	2	0	0
17	43851013	.	A	G	8	12	20	0	1	21	0	0
17	43853767	.	A	G	1	6	7	0	1	8	0	0
17	43853778	.	C	T	0	3	3	0	4	7	0	0
17	43854007	.	G	A	2	2	4	0	0	4	0	0
17	43854010	.	T	G	1	2	3	0	1	4	0	0
17	43863609	.	A	C	3	3	6	0	0	6	0	0
17	43863655	.	G	C	2	1	3	0	0	3	0	0
17	43863656	.	C	T	2	1	3	0	0	3	0	0
17	43883634	.	C	T	1	1	2	0	0	2	0	0
17	43987048	.	A	G	4	3	7	0	0	7	0	0
17	43996483	.	G	A	1	4	5	0	0	5	0	0
17	43996485	.	G	A	1	3	4	0	1	5	0	0
17	43996620	.	A	T	0	1	1	0	0	1	0	0
17	43996667	.	G	A	1	5	6	0	0	6	0	0
17	44001540	.	A	G	17	15	32	0	0	32	0	0
17	44001584	.	T	C	15	14	29	0	1	30	0	0
17	44002032	.	A	T	11	11	22	0	0	22	0	0
17	45138458	.	T	C	6	2	8	0	0	8	0	0
17	45138591	.	T	C	4	2	6	0	1	7	0	0
17	45138733	.	T	C	9	6	15	0	0	15	0	0
17	45138741	.	T	C	8	6	14	0	2	16	0	0
17	45402422	.	A	G	4	4	8	0	2	10	0	0
17	45402602	.	A	T	3	3	6	0	0	6	0	0
17	45402640	.	C	A	1	4	5	0	0	5	0	0
17	45402713	.	T	A	3	2	5	0	0	5	0	0
17	45402714	.	C	T	3	2	5	0	0	5	0	0
17	45402811	.	A	G	2	3	5	0	0	5	0	0
17	45402895	.	A	C	2	3	5	0	0	5	0	0
17	45731991	.	T	C	8	9	17	0	0	17	0	0
17	45732147	.	T	C	7	16	23	0	0	23	0	0
17	45732173	.	C	T	0	15	15	0	10	25	0	0
17	45732327	.	G	A	7	8	15	0	0	15	0	0
17	45738138	.	A	G	1	2	3	0	0	3	0	0
17	45762487	.	G	A	0	1	1	0	2	3	0	0
17	45773982	.	T	G	7	3	10	0	1	11	0	0
17	45774110	.	G	A	0	5	5	0	6	11	0	0
17	45774378	.	G	A	1	4	5	0	3	8	0	0
17	45983626	.	G	A	1	2	3	0	0	3	0	0
17	45987358	.	G	A	2	4	6	0	0	6	0	0
17	45988742	.	T	C	1	3	4	0	0	4	0	0
17	45988991	.	G	C	4	2	6	0	1	7	0	0
17	45989032	.	G	T	4	5	9	0	1	10	0	0
17	46457321	.	G	C	1	2	3	0	1	4	0	0
17	46457326	.	C	A	0	3	3	0	1	4	0	0
17	47189003	.	A	G	3	8	11	0	0	11	0	0
17	47189025	.	C	A	5	3	8	0	0	8	0	0
17	47189283	.	A	T	4	4	8	0	0	8	0	0
17	47189725	.	G	A	6	7	13	0	0	13	0	0
17	47189919	.	G	T	6	6	12	0	0	12	0	0
17	47190032	.	C	T	8	3	11	0	0	11	0	0
17	47190045	.	C	A	0	6	6	0	4	10	0	0
17	47190264	.	C	T	0	3	3	0	5	8	0	0
17	47191013	.	T	C	1	1	2	0	1	3	0	0
17	48908911	.	A	G	1	0	1	0	0	1	0	0
17	49018508	.	C	G	3	3	6	0	2	8	0	0
17	49018575	.	G	A	4	3	7	0	0	7	0	0
17	49019177	.	C	A	12	6	18	0	0	18	0	0
17	49306256	.	C	T	15	6	21	0	3	24	0	0
17	49416044	.	T	G	8	3	11	0	1	12	0	0
17	49416151	.	T	C	7	0	7	0	11	18	0	0
17	49416327	.	T	C	7	5	12	0	3	15	0	0
17	49416992	.	G	A	2	6	8	0	1	9	0	0
17	49417137	.	C	T	3	2	5	0	0	5	0	0
17	49417148	.	A	T	2	2	4	0	0	4	0	0
17	49417414	.	T	A	3	4	7	0	3	10	0	0
17	49417569	.	T	C	4	5	9	0	0	9	0	0
17	49417599	.	G	C	2	4	6	0	0	6	0	0
17	49418122	.	C	G	1	2	3	0	0	3	0	0
17	49527456	.	A	G	2	0	2	0	2	4	0	0
17	49528441	.	A	T	0	4	4	0	0	4	0	0
17	49528442	.	G	A	0	4	4	0	0	4	0	0
17	49983202	.	A	T	9	9	18	0	1	19	0	0
17	49983273	.	C	T	16	21	37	0	3	40	0	0
17	49983315	.	C	T	16	15	31	0	0	31	0	0
17	49992629	.	G	A	9	6	15	0	0	15	0	0
17	49998171	.	T	C	8	6	14	0	0	14	0	0
17	49998221	.	G	A	8	5	13	0	1	14	0	0
17	49998734	.	G	A	8	10	18	0	0	18	0	0
17	49998804	.	C	A	16	11	27	0	1	28	0	0
17	49999037	.	G	T	9	4	13	0	1	14	0	0
17	50002381	.	A	G	7	5	12	0	0	12	0	0
17	50010011	.	A	G	1	2	3	0	0	3	0	0
17	50010015	.	C	T	1	2	3	0	0	3	0	0
17	50111397	.	A	G	2	3	5	0	0	5	0	0
17	50111406	.	G	A	1	2	3	0	1	4	0	0
17	50111573	.	C	T	5	1	6	0	0	6	0	0
17	50111613	.	T	A	2	3	5	0	0	5	0	0
17	50112413	.	C	A	1	2	3	0	0	3	0	0
17	50112425	.	T	C	1	2	3	0	0	3	0	0
17	50113148	.	C	T	2	7	9	0	0	9	0	0
17	50113196	.	G	A	0	4	4	0	6	10	0	0
17	50113336	.	C	T	3	5	8	0	1	9	0	0
17	50113404	.	C	T	6	5	11	0	0	11	0	0
17	50185665	.	T	A	3	2	5	0	1	6	0	0
17	50185841	.	A	T	4	4	8	0	0	8	0	0
17	50186011	.	G	A	0	2	2	0	1	3	0	0
17	50186097	.	G	A	0	4	4	0	0	4	0	0
17	50245400	.	G	A	5	9	14	0	0	14	0	0
17	50245580	.	G	A	15	18	33	0	1	34	0	0
17	50245673	.	T	C	17	16	33	0	0	33	0	0
17	50245715	.	C	G	17	14	31	0	3	34	0	0
17	50245772	.	C	T	4	5	9	0	0	9	0	0
17	50284899	.	T	A	5	3	8	0	0	8	0	0
17	50285401	.	A	C	7	0	7	0	0	7	0	0
17	50415378	.	C	A	4	6	10	0	0	10	0	0
17	50415476	.	C	T	1	3	4	0	3	7	0	0
17	50415722	.	C	T	0	1	1	0	0	1	0	0
17	50415844	.	C	T	1	5	6	0	0	6	0	0
17	50415858	.	A	G	4	3	7	0	1	8	0	0
17	50415948	.	G	A	3	2	5	0	0	5	0	0
17	50415960	.	G	C	0	4	4	0	0	4	0	0
17	50416079	.	T	C	1	2	3	0	0	3	0	0
17	50416269	.	C	T	0	4	4	0	1	5	0	0
17	50416414	.	T	A	2	4	6	0	0	6	0	0
17	50416456	.	C	T	2	3	5	0	0	5	0	0
17	50416789	.	G	A	1	3	4	0	0	4	0	0
17	50424455	.	T	C	1	0	1	0	6	7	0	0
17	50424555	.	A	T	2	9	11	0	1	12	0	0
17	50424556	.	A	T	2	10	12	0	0	12	0	0
17	50424596	.	A	T	3	14	17	0	2	19	0	0
17	50424662	.	A	G	2	9	11	0	1	12	0	0
17	50424663	.	A	G	2	10	12	0	0	12	0	0
17	50424961	.	T	A	2	2	4	0	0	4	0	0
17	50425042	.	C	G	0	10	10	0	0	10	0	0
17	50425171	.	A	T	1	7	8	0	1	9	0	0
17	50425321	.	C	T	4	3	7	0	0	7	0	0
17	50425388	.	A	T	4	6	10	0	0	10	0	0
17	50425393	.	T	C	4	5	9	0	0	9	0	0
17	50425478	.	C	T	2	2	4	0	0	4	0	0
17	50425488	.	A	G	2	2	4	0	0	4	0	0
17	50425854	.	C	T	0	3	3	0	3	6	0	0
17	50425858	.	T	A	3	3	6	0	0	6	0	0
17	50688480	.	T	C	1	3	4	0	0	4	0	0
17	50689755	.	G	A	0	3	3	0	2	5	0	0
17	50689787	.	T	A	2	3	5	0	0	5	0	0
17	50689811	.	A	C	1	4	5	0	0	5	0	0
17	50689842	.	A	G	3	2	5	0	1	6	0	0
17	50690874	.	T	G	2	2	4	0	0	4	0	0
17	51020214	.	A	G	8	6	14	0	1	15	0	0
17	51206760	.	T	C	13	5	18	0	2	20	0	0
17	51206851	.	T	C	14	8	22	0	2	24	0	0
17	51231633	.	T	C	6	8	14	0	2	16	0	0
17	51231980	.	T	C	7	4	11	0	0	11	0	0
17	51823617	.	G	T	5	5	10	0	0	10	0	0
17	51824061	.	G	A	7	2	9	0	0	9	0	0
17	51824096	.	T	C	3	3	6	0	0	6	0	0
17	52533036	.	C	G	3	2	5	0	0	5	0	0
17	52533073	.	C	T	0	2	2	0	0	2	0	0
17	52534241	.	G	A	0	5	5	0	5	10	0	0
17	52534343	.	G	A	0	2	2	0	2	4	0	0
17	52541342	.	G	A	0	7	7	0	5	12	0	0
17	52553107	.	C	A	14	19	33	0	5	38	0	0
17	52553141	.	T	C	20	15	35	0	3	38	0	0
17	52553270	.	G	A	18	21	39	0	1	40	0	0
17	52624707	.	T	C	1	2	3	0	0	3	0	0
17	52624758	.	A	G	1	2	3	0	0	3	0	0
17	52629991	.	T	A	2	3	5	0	0	5	0	0
17	52630641	.	A	G	5	8	13	0	2	15	0	0
17	52630719	.	T	G	6	6	12	0	0	12	0	0
17	52630752	.	A	C	0	0	0	0	6	6	0	0
17	52630907	.	A	T	5	5	10	0	2	12	0	0
17	52632139	.	A	G	4	5	9	0	1	10	0	0
17	52632151	.	G	C	5	3	8	0	0	8	0	0
17	52632404	.	G	A	0	1	1	0	0	1	0	0
17	52635258	.	A	G	5	4	9	0	0	9	0	0
17	52635261	.	C	T	0	4	4	0	6	10	0	0
17	52639729	.	C	T	0	18	18	0	14	32	0	0
17	52640311	.	G	A	18	22	40	0	1	41	0	0
17	52640385	.	G	C	13	26	39	0	0	39	0	0
17	52640419	.	C	T	0	17	17	0	15	32	0	0
17	52640540	.	C	T	0	17	17	0	12	29	0	0
17	52640645	.	T	G	3	15	18	0	0	18	0	0
17	52641091	.	A	T	6	7	13	0	0	13	0	0
17	52641724	.	A	C	5	6	11	0	0	11	0	0
17	52840328	.	A	C	6	7	13	0	1	14	0	0
17	52919954	.	C	T	17	29	46	0	1	47	0	0
17	52920291	.	A	T	15	17	32	0	3	35	0	0
17	52920792	.	C	T	22	26	48	1	2	51	0	0
17	52940710	.	T	C	3	2	5	0	0	5	0	0
17	52941075	.	T	C	1	3	4	0	1	5	0	0
17	53298000	.	C	G	2	0	2	0	2	4	0	0
17	53298033	.	C	T	1	2	3	0	0	3	0	0
17	53302527	.	T	C	0	1	1	0	0	1	0	0
17	53303258	.	G	A	0	2	2	0	5	7	0	0
17	53303980	.	G	C	6	7	13	0	0	13	0	0
17	53304566	.	G	A	5	6	11	0	2	13	0	0
17	53305318	.	G	C	10	7	17	0	1	18	0	0
17	53305327	.	C	T	9	4	13	0	0	13	0	0
17	53307346	.	G	A	5	3	8	0	1	9	0	0
17	53307580	.	C	G	11	15	26	0	0	26	0	0
17	53308737	.	T	C	10	11	21	0	0	21	0	0
17	53308820	.	C	T	1	5	6	0	0	6	0	0
17	53315422	.	C	T	7	3	10	0	0	10	0	0
17	53315604	.	G	A	5	4	9	0	1	10	0	0
17	53315750	.	C	G	2	4	6	0	0	6	0	0
17	53317065	.	C	T	0	1	1	0	0	1	0	0
17	53317123	.	T	C	5	6	11	0	0	11	0	0
17	53317175	.	G	A	0	3	3	0	4	7	0	0
17	53317663	.	T	C	4	5	9	0	2	11	0	0
17	53317664	.	C	A	4	4	8	0	3	11	0	0
17	53317844	.	G	A	0	7	7	0	6	13	0	0
17	53317891	.	A	G	9	4	13	0	0	13	0	0
17	53317917	.	A	G	3	5	8	0	0	8	0	0
17	53346549	.	G	A	0	2	2	0	0	2	0	0
17	53346648	.	C	A	1	3	4	0	0	4	0	0
17	53393165	.	G	A	14	17	31	0	0	31	0	0
18	1689	.	A	C	7	7	14	0	1	15	0	0
18	1983	.	T	C	1	3	4	0	0	4	0	0
18	17639	.	G	A	2	1	3	0	0	3	0	0
18	17786	.	G	A	2	1	3	0	1	4	0	0
18	17795	.	G	A	3	1	4	0	2	6	0	0
18	18606	.	T	A	2	3	5	0	1	6	0	0
18	22746	.	A	G	1	4	5	0	0	5	0	0
18	35814	.	T	A	1	6	7	0	1	8	0	0
18	35841	.	T	C	2	2	4	0	0	4	0	0
18	35863	.	A	G	1	3	4	0	2	6	0	0
18	55219	.	C	A	1	2	3	0	0	3	0	0
18	60408	.	T	C	2	2	4	0	0	4	0	0
18	73394	.	C	G	2	4	6	0	0	6	0	0
18	73410	.	A	T	2	3	5	0	0	5	0	0
18	73510	.	G	T	4	6	10	0	0	10	0	0
18	73543	.	T	A	12	9	21	0	1	22	0	0
18	73584	.	G	A	28	12	40	0	1	41	0	0
18	73714	.	C	G	19	10	29	0	3	32	0	0
18	73839	.	A	G	18	3	21	0	0	21	0	0
18	74095	.	T	C	11	3	14	0	1	15	0	0
18	74263	.	A	C	6	0	6	0	4	10	0	0
18	74267	.	G	A	6	4	10	0	0	10	0	0
18	74788	.	C	T	1	4	5	0	12	17	0	0
18	74866	.	C	T	13	9	22	0	2	24	0	0
18	74994	.	A	G	8	4	12	0	0	13	1	0
18	100944	.	G	A	0	2	2	0	2	4	0	0
18	104405	.	G	A	0	2	2	0	1	3	0	0
18	106814	.	T	C	5	7	12	0	0	12	0	0
18	107015	.	T	C	3	15	18	0	1	19	0	0
18	107135	.	A	T	8	13	21	0	1	22	0	0
18	107345	.	A	G	16	1	17	0	20	37	0	0
18	114089	.	A	C	13	11	24	0	2	26	0	0
18	114713	.	A	T	4	3	7	0	0	7	0	0
18	117788	.	G	A	3	4	7	0	0	7	0	0
18	118729	.	G	A	5	6	11	0	0	11	0	0
18	173694	.	C	T	3	4	7	0	0	7	0	0
18	184917	.	T	C	3	2	5	0	0	5	0	0
18	193689	.	A	C	3	4	7	0	1	8	0	0
18	193982	.	C	T	4	12	16	0	0	16	0	0
18	194006	.	A	G	5	0	5	0	12	17	0	0
18	194078	.	C	T	17	9	26	0	0	26	0	0
18	194162	.	G	C	0	12	12	0	17	29	0	0
18	194318	.	A	G	9	9	18	0	0	18	0	0
18	194460	.	C	G	7	3	10	0	1	11	0	0
18	194464	.	C	T	5	5	10	0	2	12	0	0
18	194799	.	T	C	4	8	12	0	0	12	0	0
18	204828	.	G	A	22	19	41	0	0	41	0	0
18	204866	.	T	A	18	20	38	0	11	50	1	0
18	204980	.	C	T	18	20	38	0	2	40	0	0
18	204982	.	G	A	15	18	33	0	7	40	0	0
18	205095	.	C	T	0	14	14	0	17	31	0	0
18	205105	.	A	G	15	21	36	0	0	36	0	0
18	205152	.	G	A	22	11	33	0	2	35	0	0
18	205179	.	G	A	17	12	29	0	5	34	0	0
18	207172	.	T	C	1	2	3	0	0	3	0	0
18	207184	.	G	A	1	5	6	0	0	6	0	0
18	209321	.	T	G	0	1	1	0	0	1	0	0
18	209382	.	A	G	1	1	2	0	0	2	0	0
18	210385	.	T	A	7	7	14	0	0	14	0	0
18	210899	.	T	A	9	4	13	0	1	14	0	0
18	211101	.	G	A	16	10	26	0	1	27	0	0
18	211186	.	T	A	21	25	46	0	2	48	0	0
18	211304	.	T	C	14	0	14	0	18	32	0	0
18	211346	.	C	T	0	12	12	0	14	26	0	0
18	211380	.	G	A	13	13	26	0	0	26	0	0
18	211399	.	T	C	12	16	28	0	2	30	0	0
18	211438	.	T	A	13	12	25	0	0	25	0	0
18	211469	.	C	A	13	11	24	0	0	24	0	0
18	211483	.	A	T	14	8	22	0	3	25	0	0
18	211605	.	A	G	16	9	25	0	3	28	0	0
18	211610	.	T	C	17	0	17	0	12	29	0	0
18	211812	.	T	A	10	10	20	0	0	20	0	0
18	212305	.	A	G	21	6	27	0	0	27	0	0
18	214688	.	A	G	5	5	10	0	0	10	0	0
18	214717	.	T	C	5	7	12	0	1	13	0	0
18	216775	.	G	A	2	1	3	0	1	4	0	0
18	216779	.	G	A	2	2	4	0	0	4	0	0
18	334298	.	T	C	1	3	4	0	0	4	0	0
18	609877	.	G	A	3	8	11	0	1	12	0	0
18	609935	.	G	A	0	7	7	0	12	19	0	0
18	610126	.	A	T	12	7	19	0	0	19	0	0
18	610148	.	A	T	7	6	13	0	1	14	0	0
18	610631	.	T	A	9	8	17	0	0	18	1	0
18	610721	.	A	C	1	2	3	0	0	3	0	0
18	643517	.	C	T	1	0	1	0	0	1	0	0
18	790247	.	T	C	1	2	3	0	0	3	0	0
18	790301	.	T	A	2	4	6	0	0	6	0	0
18	790962	.	T	G	5	5	10	0	3	13	0	0
18	791137	.	T	A	3	5	8	0	1	9	0	0
18	791171	.	G	C	2	2	4	0	1	5	0	0
18	791246	.	G	A	4	3	7	0	0	7	0	0
18	791449	.	T	G	1	6	7	0	0	7	0	0
18	809012	.	G	T	7	11	18	0	1	19	0	0
18	826190	.	A	T	5	3	8	0	0	8	0	0
18	826574	.	C	T	0	4	4	0	1	5	0	0
18	827129	.	A	C	5	2	7	1	1	9	0	0
18	925088	.	C	T	1	4	5	0	1	6	0	0
18	925100	.	A	C	0	3	3	0	1	4	0	0
18	933299	.	G	A	2	1	3	0	0	3	0	0
18	936728	.	C	T	7	10	17	0	0	17	0	0
18	939430	.	C	T	5	6	11	0	1	12	0	0
18	951004	.	A	T	31	18	49	0	1	50	0	0
18	951005	.	T	C	32	17	49	0	1	50	0	0
18	1151536	.	C	A	1	3	4	0	1	5	0	0
18	1151618	.	A	C	0	4	4	0	0	4	0	0
18	1152220	.	G	A	3	4	7	0	0	7	0	0
18	1161085	.	A	G	5	10	15	0	0	15	0	0
18	1161750	.	A	G	4	12	16	0	1	17	0	0
18	1173819	.	G	A	2	3	5	0	0	5	0	0
18	1173856	.	G	A	12	15	27	0	0	27	0	0
18	1173898	.	A	G	17	17	34	0	5	39	0	0
18	1292100	.	C	T	0	9	9	0	6	15	0	0
18	1292164	.	G	A	6	4	10	0	0	10	0	0
18	1292668	.	T	C	0	0	0	0	2	2	0	0
18	1293182	.	G	A	3	2	5	0	0	5	0	0
18	2180603	.	A	G	1	0	1	0	0	1	0	0
18	2205302	.	T	A	5	2	7	0	0	7	0	0
18	2211091	.	T	C	1	2	3	0	0	3	0	0
18	2225632	.	C	T	3	0	3	0	1	4	0	0
18	2225661	.	C	T	8	4	12	0	1	13	0	0
18	2225947	.	T	C	3	2	5	0	0	5	0	0
18	2378495	.	T	A	0	2	2	0	0	2	0	0
18	2378513	.	T	C	0	1	1	0	0	1	0	0
18	2378713	.	T	G	1	4	5	0	0	5	0	0
18	2378722	.	C	T	0	1	1	0	3	4	0	0
18	2603576	.	T	G	4	4	8	0	0	8	0	0
18	2603786	.	A	G	1	6	7	0	0	7	0	0
18	2612259	.	A	G	1	3	4	0	0	4	0	0
18	2612293	.	A	G	2	3	5	0	0	5	0	0
18	2681965	.	G	A	10	15	25	0	3	28	0	0
18	2682182	.	C	T	1	15	16	0	10	26	0	0
18	2682203	.	A	T	9	12	21	0	0	21	0	0
18	2682610	.	T	C	13	14	27	0	2	29	0	0
18	2682683	.	C	T	7	13	20	0	0	20	0	0
18	2682700	.	T	C	11	8	19	0	0	19	0	0
18	2685297	.	A	G	1	2	3	0	0	3	0	0
18	2685312	.	G	A	1	2	3	0	0	3	0	0
18	2934938	.	C	T	1	2	3	0	1	4	0	0
18	2935480	.	C	T	4	2	6	0	0	6	0	0
18	3039440	.	A	G	28	12	40	0	4	44	0	0
18	3049752	.	T	G	2	0	2	0	0	2	0	0
18	3049756	.	A	G	1	2	3	0	0	3	0	0
18	3087776	.	G	A	3	2	5	0	0	5	0	0
18	3089906	.	T	C	1	2	3	0	1	4	0	0
18	3096656	.	T	A	2	2	4	0	0	4	0	0
18	3096698	.	A	G	2	2	4	0	0	4	0	0
18	3096873	.	G	A	3	3	6	0	0	6	0	0
18	3096914	.	A	C	2	3	5	0	0	5	0	0
18	3096926	.	C	T	4	1	5	0	0	5	0	0
18	3100651	.	A	G	1	1	2	0	0	2	0	0
18	3142685	.	A	G	0	4	4	0	0	4	0	0
18	3144677	.	G	A	0	2	2	0	1	3	0	0
18	3144742	.	A	T	2	1	3	0	0	3	0	0
18	3153072	.	G	C	4	1	5	0	0	5	0	0
18	3153231	.	A	T	1	1	2	0	1	3	0	0
18	3158739	.	A	G	4	18	22	0	1	23	0	0
18	3158776	.	G	A	14	7	21	0	1	22	0	0
18	3158896	.	C	T	2	3	5	1	1	7	0	0
18	3159249	.	C	A	1	2	3	0	0	3	0	0
18	3159711	.	A	C	2	4	6	0	0	6	0	0
18	3159712	.	C	A	2	4	6	0	0	6	0	0
18	3160148	.	C	G	0	2	2	0	1	3	0	0
18	3160218	.	C	T	0	2	2	0	2	4	0	0
18	3160354	.	C	T	0	2	2	0	1	3	0	0
18	3259736	.	C	T	8	5	13	0	1	14	0	0
18	3259807	.	C	A	3	6	9	0	0	9	0	0
18	3259847	.	C	T	7	4	11	0	1	12	0	0
18	3276085	.	G	C	10	3	13	0	3	16	0	0
18	3276187	.	A	G	0	0	0	0	1	1	0	0
18	3283882	.	T	C	26	17	43	0	2	45	0	0
18	3536868	.	A	T	3	4	7	0	0	7	0	0
18	3536937	.	T	C	1	0	1	0	0	1	0	0
18	3539989	.	C	T	0	1	1	0	1	2	0	0
18	3540027	.	C	T	1	0	1	0	0	1	0	0
18	3556542	.	A	G	0	1	1	0	0	1	0	0
18	3556626	.	C	T	0	10	10	0	11	21	0	0
18	3556935	.	C	T	1	2	3	0	0	3	0	0
18	3557043	.	A	T	1	2	3	0	0	3	0	0
18	3572547	.	G	A	1	4	5	0	0	5	0	0
18	3575938	.	C	A	2	6	8	0	0	8	0	0
18	3576104	.	C	T	14	6	20	0	1	21	0	0
18	3576212	.	A	C	3	3	6	0	0	6	0	0
18	3617759	.	C	T	1	0	1	0	0	1	0	0
18	5167603	.	A	G	15	14	29	0	0	29	0	0
18	5167604	.	A	G	13	15	28	0	1	29	0	0
18	5170063	.	A	G	30	12	42	0	2	44	0	0
18	5170069	.	A	G	16	0	16	0	30	46	0	0
18	5234937	.	C	A	0	16	16	0	20	36	0	0
18	5234990	.	T	G	13	7	20	0	2	22	0	0
18	5235033	.	C	T	0	2	2	0	2	4	0	0
18	5242329	.	G	A	8	8	16	0	1	17	0	0
18	5243234	.	A	G	6	2	8	0	0	8	0	0
18	5243255	.	T	C	6	2	8	0	0	8	0	0
18	5244632	.	G	A	2	2	4	0	2	6	0	0
18	5245480	.	G	A	1	2	3	0	0	3	0	0
18	5245503	.	G	A	1	4	5	0	0	5	0	0
18	5245806	.	T	C	9	10	19	0	0	19	0	0
18	5245818	.	C	T	1	10	11	0	7	18	0	0
18	5308441	.	T	G	2	5	7	0	0	7	0	0
18	5316537	.	A	G	1	7	8	0	0	8	0	0
18	5316708	.	C	G	2	4	6	0	0	6	0	0
18	5454381	.	G	A	5	6	11	0	1	12	0	0
18	5455161	.	C	T	1	0	1	0	1	2	0	0
18	5455347	.	G	T	0	1	1	0	0	1	0	0
18	5456883	.	C	T	3	2	5	0	0	5	0	0
18	5456940	.	G	A	1	4	5	0	1	6	0	0
18	5491697	.	G	A	4	4	8	0	1	9	0	0
18	5494980	.	A	G	4	5	9	0	1	10	0	0
18	5495903	.	T	C	14	20	34	0	3	37	0	0
18	5506578	.	C	T	4	5	9	0	0	9	0	0
18	5509426	.	G	C	2	3	5	0	1	6	0	0
18	5518108	.	C	T	2	1	3	0	0	3	0	0
18	5518809	.	T	G	3	3	6	0	0	6	0	0
18	5519052	.	C	T	2	3	5	0	0	5	0	0
18	5519119	.	A	G	2	5	7	0	0	7	0	0
18	5519269	.	T	C	8	6	14	0	3	17	0	0
18	5519534	.	T	A	6	4	10	0	2	12	0	0
18	5531611	.	A	T	0	4	4	0	0	4	0	0
18	5624614	.	A	G	1	1	2	0	1	3	0	0
18	5624654	.	T	A	7	5	12	0	0	12	0	0
18	5626583	.	G	A	2	0	2	0	0	2	0	0
18	5626661	.	A	C	1	1	2	0	0	2	0	0
18	5692205	.	A	G	0	5	5	0	0	5	0	0
18	5692222	.	A	T	0	2	2	0	0	2	0	0
18	6868483	.	A	G	14	6	20	0	0	20	0	0
18	7099981	.	A	G	0	2	2	0	1	3	0	0
18	7571684	.	A	C	3	2	5	0	0	5	0	0
18	7571712	.	G	T	1	2	3	0	2	5	0	0
18	10693077	.	G	A	3	3	6	0	1	7	0	0
18	10693085	.	T	A	3	4	7	0	0	7	0	0
18	10693123	.	C	T	4	5	9	0	0	9	0	0
18	10693155	.	T	A	6	3	9	0	0	9	0	0
18	10693322	.	A	T	3	4	7	0	0	7	0	0
18	10698083	.	T	C	2	4	6	0	0	6	0	0
18	10698161	.	T	G	2	5	7	0	0	7	0	0
18	10698215	.	T	C	1	3	4	0	0	4	0	0
18	10921408	.	A	T	3	4	7	0	0	7	0	0
18	10921734	.	T	C	3	2	5	0	1	6	0	0
18	10921791	.	T	C	3	3	6	0	1	7	0	0
18	10921855	.	T	C	4	8	12	0	1	13	0	0
18	10921857	.	G	A	0	9	9	0	4	13	0	0
18	11557106	.	G	A	2	2	4	0	0	4	0	0
18	11557118	.	G	T	2	2	4	0	0	4	0	0
18	12113515	.	C	A	1	2	3	0	0	3	0	0
18	12113516	.	C	T	1	2	3	0	0	3	0	0
18	12236351	.	C	T	3	2	5	0	2	7	0	0
18	12238082	.	G	A	4	3	7	0	0	7	0	0
18	12240740	.	G	C	2	0	2	0	0	2	0	0
18	12276859	.	C	T	16	5	21	0	0	21	0	0
18	12277052	.	A	G	11	12	23	0	2	25	0	0
18	12277206	.	G	C	4	14	18	0	3	21	0	0
18	12277490	.	G	A	21	10	31	0	0	31	0	0
18	12280269	.	C	T	9	7	16	0	0	16	0	0
18	12292017	.	G	A	8	7	15	0	2	17	0	0
18	12776727	.	C	T	0	2	2	0	0	2	0	0
18	12779357	.	T	A	1	3	4	0	0	4	0	0
18	14866506	.	G	A	2	3	5	0	1	6	0	0
18	14866508	.	C	T	2	3	5	0	1	6	0	0
18	14867144	.	A	C	2	0	2	0	2	4	0	0
18	14867153	.	C	T	1	2	3	0	0	3	0	0
18	14928681	.	T	C	3	2	5	0	0	5	0	0
18	15125122	.	G	A	1	0	1	0	0	1	0	0
18	15125193	.	A	C	0	1	1	0	0	1	0	0
18	15128960	.	T	C	1	2	3	0	0	3	0	0
18	15139150	.	G	A	1	7	8	0	0	8	0	0
18	15139540	.	C	T	7	5	12	0	0	12	0	0
18	15139757	.	G	A	7	4	11	0	0	11	0	0
18	15139784	.	T	C	7	3	10	0	0	10	0	0
18	15148021	.	T	C	1	3	4	0	0	4	0	0
18	15383683	.	C	T	0	2	2	0	1	3	0	0
18	15395535	.	A	G	1	0	1	0	0	1	0	0
18	15459835	.	T	A	2	2	4	0	0	4	0	0
18	15469783	.	A	G	1	1	2	0	0	2	0	0
18	15469798	.	T	C	1	0	1	0	2	3	0	0
18	15483351	.	C	T	1	0	1	0	0	1	0	0
18	15792294	.	T	G	12	17	29	0	1	30	0	0
18	15792368	.	G	C	18	17	35	0	5	40	0	0
18	15792459	.	A	C	19	23	42	0	3	45	0	0
18	15792596	.	T	A	22	18	40	0	0	40	0	0
18	15792611	.	A	G	21	15	36	0	4	40	0	0
18	15792743	.	T	A	16	20	36	0	2	38	0	0
18	15793064	.	A	G	8	11	19	0	1	20	0	0
18	15829588	.	A	G	0	1	1	0	0	1	0	0
18	15836917	.	A	G	1	3	4	0	1	5	0	0
18	16127885	.	A	G	5	5	10	0	1	11	0	0
18	16127927	.	A	C	5	1	6	0	2	8	0	0
18	16128730	.	A	G	3	4	7	0	0	7	0	0
18	16128960	.	T	G	10	6	16	0	0	16	0	0
18	16129210	.	A	C	12	10	22	0	3	25	0	0
18	16129583	.	T	A	15	21	36	0	1	37	0	0
18	16129862	.	C	T	23	21	44	0	3	47	0	0
18	16140337	.	G	T	0	3	3	0	6	9	0	0
18	16145618	.	T	G	18	14	32	0	3	35	0	0
18	16145621	.	C	T	19	16	35	0	1	36	0	0
18	16145994	.	C	G	5	6	11	0	0	11	0	0
18	16722124	.	G	A	3	10	13	0	1	14	0	0
18	16722584	.	G	A	5	8	13	0	0	13	0	0
18	16723514	.	T	C	5	5	10	0	2	12	0	0
18	16723520	.	A	G	6	0	6	0	6	12	0	0
18	16723785	.	A	G	5	0	5	0	4	9	0	0
18	16725225	.	G	A	0	12	12	0	9	21	0	0
18	16725309	.	C	T	7	5	12	0	0	12	0	0
18	16725323	.	C	T	6	3	9	0	0	9	0	0
18	16725917	.	A	G	14	12	26	0	1	27	0	0
18	16726011	.	C	T	7	14	21	0	4	25	0	0
18	16755962	.	C	A	4	8	12	0	0	12	0	0
18	16756001	.	C	T	5	4	9	0	1	10	0	0
18	16756058	.	T	A	6	7	13	0	0	13	0	0
18	16756065	.	G	A	5	7	12	0	0	12	0	0
18	16876903	.	A	G	7	3	10	0	2	12	0	0
18	16918725	.	G	A	1	2	3	0	0	3	0	0
18	16918760	.	C	A	1	2	3	0	0	3	0	0
18	16929772	.	G	A	9	9	18	0	1	19	0	0
18	16936758	.	T	C	3	3	6	0	0	6	0	0
18	16936787	.	A	G	3	3	6	0	0	6	0	0
18	16962778	.	A	G	0	2	2	0	0	2	0	0
18	16962783	.	C	T	0	2	2	0	0	2	0	0
18	16962823	.	C	T	0	1	1	0	0	1	0	0
18	16966911	.	T	C	1	1	2	0	1	3	0	0
18	16968314	.	T	C	1	6	7	0	0	7	0	0
18	16970455	.	A	T	4	7	11	0	0	11	0	0
18	16970459	.	G	A	0	8	8	0	5	13	0	0
18	16970598	.	C	T	10	6	16	0	0	16	0	0
18	16970683	.	C	A	2	1	3	0	0	3	0	0
18	16970684	.	A	G	2	1	3	0	0	3	0	0
18	16970795	.	A	T	7	4	11	1	0	12	0	0
18	16970997	.	G	C	0	11	11	0	18	29	0	0
18	16971129	.	C	T	19	14	33	0	1	34	0	0
18	16971155	.	A	T	15	9	24	0	0	24	0	0
18	16988142	.	C	G	1	3	4	0	1	5	0	0
18	16988160	.	A	T	1	3	4	0	0	4	0	0
18	16990122	.	C	T	0	3	3	0	7	10	0	0
18	16990150	.	G	T	7	3	10	0	0	10	0	0
18	16990385	.	A	C	2	1	3	0	3	6	0	0
18	16990550	.	A	G	2	1	3	0	0	3	0	0
18	17002653	.	A	G	7	5	12	0	0	12	0	0
18	17003602	.	A	G	2	0	2	0	0	2	0	0
18	17051417	.	G	A	2	3	5	0	0	5	0	0
18	17062323	.	G	A	0	3	3	0	0	3	0	0
18	17062336	.	T	C	1	3	4	0	1	5	0	0
18	17062364	.	T	G	2	3	5	0	0	5	0	0
18	17062611	.	C	T	1	2	3	0	0	3	0	0
18	17078575	.	A	T	1	2	3	0	0	3	0	0
18	17078593	.	T	C	1	3	4	0	0	4	0	0
18	17079541	.	T	C	16	8	24	0	1	25	0	0
18	17080089	.	G	C	3	7	10	0	0	10	0	0
18	17080122	.	A	G	5	6	11	0	0	11	0	0
18	17080131	.	T	C	4	0	4	0	5	9	0	0
18	17084489	.	C	T	0	0	0	0	1	1	0	0
18	17098562	.	T	A	1	0	1	0	0	1	0	0
18	17994415	.	A	G	5	21	26	0	0	26	0	0
18	19045035	.	A	G	1	8	9	0	1	10	0	0
18	19419307	.	C	T	1	3	4	0	0	4	0	0
18	19441492	.	C	G	3	6	9	0	0	9	0	0
18	19441561	.	T	C	1	1	2	0	0	2	0	0
18	19441585	.	C	A	0	1	1	0	0	1	0	0
18	19450486	.	T	C	12	11	23	0	4	27	0	0
18	19450563	.	A	T	16	35	51	0	1	52	0	0
18	19450642	.	A	T	21	16	37	0	1	38	0	0
18	19450692	.	A	G	13	25	38	0	2	40	0	0
18	19450755	.	A	G	26	31	57	0	1	58	0	0
18	19451023	.	C	T	14	25	39	0	1	40	0	0
18	19451117	.	C	T	8	9	17	0	4	21	0	0
18	19451427	.	G	A	23	14	37	0	3	40	0	0
18	19451430	.	T	C	24	2	26	0	15	41	0	0
18	19451477	.	G	A	24	25	49	0	3	52	0	0
18	19452126	.	T	A	14	7	21	0	1	22	0	0
18	19452594	.	G	A	16	26	42	0	3	45	0	0
18	19452639	.	A	G	14	18	32	0	2	34	0	0
18	19487779	.	G	A	21	20	41	0	0	41	0	0
18	19490515	.	C	T	3	8	11	0	3	14	0	0
18	19698833	.	T	C	3	4	7	0	0	7	0	0
18	19698854	.	G	A	6	7	13	0	0	13	0	0
18	19812874	.	T	C	8	6	14	0	1	15	0	0
18	19812943	.	A	T	10	9	19	0	0	19	0	0
18	19813002	.	A	G	11	9	20	0	2	22	0	0
18	19815743	.	A	T	2	1	3	0	0	3	0	0
18	19817682	.	G	A	3	2	5	0	0	5	0	0
18	19817717	.	G	A	3	3	6	0	0	6	0	0
18	19883812	.	G	T	0	5	5	0	7	12	0	0
18	19981584	.	C	T	1	5	6	0	0	6	0	0
18	20042088	.	C	T	13	10	23	0	1	24	0	0
18	20044847	.	T	C	11	15	26	0	2	28	0	0
18	20045197	.	T	C	2	3	5	0	0	5	0	0
18	20249005	.	G	T	0	2	2	0	2	4	0	0
18	20254384	.	C	T	2	2	4	0	0	4	0	0
18	20254398	.	G	A	0	2	2	0	2	4	0	0
18	20256275	.	C	T	4	6	10	0	3	13	0	0
18	20256379	.	A	G	5	3	8	0	0	8	0	0
18	20256491	.	T	A	3	6	9	0	0	9	0	0
18	20256492	.	A	T	4	3	7	0	2	9	0	0
18	20256539	.	G	A	2	6	8	0	2	10	0	0
18	20257005	.	G	A	0	15	15	0	14	29	0	0
18	20257159	.	C	G	10	12	22	0	0	22	0	0
18	20257200	.	A	T	11	11	22	0	1	24	1	0
18	20475854	.	C	T	5	4	9	0	0	9	0	0
18	20491073	.	C	A	2	2	4	0	0	4	0	0
18	20516863	.	A	C	3	4	7	0	0	8	1	0
18	20516869	.	T	G	3	5	8	0	0	8	0	0
18	20535074	.	T	A	2	3	5	0	0	5	0	0
18	20539548	.	G	A	0	4	4	0	3	7	0	0
18	20539703	.	T	A	2	2	4	0	1	5	0	0
18	20539844	.	T	A	4	2	6	0	0	6	0	0
18	20539979	.	T	A	4	2	6	0	0	6	0	0
18	20540144	.	G	A	1	3	4	0	0	4	0	0
18	20540270	.	C	T	4	0	4	0	0	4	0	0
18	20540313	.	G	T	6	2	8	0	0	8	0	0
18	20540581	.	G	T	2	6	8	0	1	9	0	0
18	20540606	.	A	T	1	6	7	0	0	7	0	0
18	20541575	.	A	C	6	13	19	0	0	19	0	0
18	20541644	.	G	A	9	4	13	0	1	14	0	0
18	20541735	.	A	G	9	7	16	0	0	16	0	0
18	20542107	.	C	T	0	8	8	0	6	14	0	0
18	20542128	.	T	G	7	7	14	0	1	15	0	0
18	20542214	.	A	T	4	7	11	0	1	12	0	0
18	20542388	.	T	G	4	11	15	0	1	16	0	0
18	20542398	.	A	C	5	11	16	0	0	16	0	0
18	20542503	.	G	A	7	15	22	0	4	26	0	0
18	20542562	.	T	G	14	9	23	0	2	25	0	0
18	20542647	.	C	T	3	10	13	0	1	14	0	0
18	20543466	.	T	A	2	4	6	0	0	6	0	0
18	20544691	.	G	A	1	0	1	0	0	1	0	0
18	20582109	.	G	A	10	12	22	0	0	22	0	0
18	20582222	.	G	A	7	5	12	0	0	12	0	0
18	20582303	.	C	T	0	4	4	0	4	8	0	0
18	20582314	.	C	G	3	0	3	0	3	6	0	0
18	20582356	.	C	T	7	3	10	0	0	10	0	0
18	20582361	.	T	C	7	3	10	0	0	10	0	0
18	20582392	.	C	T	0	2	2	0	8	10	0	0
18	20582629	.	T	C	1	3	4	0	0	4	0	0
18	20583127	.	C	T	3	2	5	0	0	5	0	0
18	20583154	.	G	T	4	3	7	0	0	7	0	0
18	20583398	.	C	T	1	2	3	0	0	3	0	0
18	20583763	.	A	G	2	3	5	0	0	5	0	0
18	20584542	.	T	C	4	2	6	0	0	6	0	0
18	20584797	.	G	A	2	1	3	0	1	4	0	0
18	20584801	.	C	T	2	2	4	0	0	4	0	0
18	20726304	.	T	C	17	0	17	0	32	49	0	0
18	20729281	.	C	T	0	6	6	0	2	8	0	0
18	20739298	.	C	T	1	1	2	0	0	2	0	0
18	20742029	.	C	G	0	1	1	0	0	1	0	0
18	20744164	.	T	C	3	1	4	0	0	4	0	0
18	20752848	.	G	A	2	1	3	0	0	3	0	0
18	20755787	.	G	T	2	2	4	0	0	4	0	0
18	20757663	.	G	A	1	1	2	0	0	2	0	0
18	20757934	.	C	T	0	2	2	0	0	2	0	0
18	20757977	.	A	C	2	0	2	0	2	4	0	0
18	20757979	.	G	A	2	2	4	0	0	4	0	0
18	20768407	.	C	T	2	1	3	0	3	6	0	0
18	20853444	.	T	G	2	2	4	0	0	4	0	0
18	21075715	.	A	C	2	0	2	0	0	2	0	0
18	21105722	.	G	A	1	2	3	0	1	4	0	0
18	21119498	.	G	A	8	6	14	0	0	14	0	0
18	21119562	.	G	A	9	10	19	0	0	19	0	0
18	21119579	.	A	T	10	8	18	0	0	18	0	0
18	21119854	.	T	C	9	6	15	0	0	15	0	0
18	21136948	.	C	T	2	1	3	0	1	4	0	0
18	21143473	.	A	T	4	8	12	0	2	14	0	0
18	21143787	.	C	A	3	8	11	0	0	11	0	0
18	21143938	.	C	G	9	5	14	0	1	15	0	0
18	21143998	.	C	T	9	8	17	0	1	18	0	0
18	21144005	.	C	A	7	9	16	0	1	17	0	0
18	21144060	.	G	A	2	13	15	0	14	29	0	0
18	21144800	.	A	T	6	4	10	0	0	10	0	0
18	21144880	.	G	T	9	8	17	0	0	17	0	0
18	21144965	.	G	C	0	3	3	0	5	8	0	0
18	21145142	.	A	G	6	10	16	0	4	20	0	0
18	21145290	.	G	T	13	4	17	0	0	17	0	0
18	21179325	.	T	C	4	0	4	0	4	8	0	0
18	21179730	.	A	G	1	3	4	0	0	4	0	0
18	21198961	.	G	T	23	13	36	0	1	37	0	0
18	21199165	.	G	T	17	8	25	0	2	27	0	0
18	21199515	.	T	C	2	3	5	0	0	5	0	0
18	21214976	.	T	C	0	2	2	0	1	3	0	0
18	21218734	.	G	A	4	3	7	0	1	8	0	0
18	21257657	.	T	C	7	17	24	0	2	26	0	0
18	21257867	.	G	A	5	13	18	0	4	22	0	0
18	21617864	.	G	A	0	8	8	0	4	12	0	0
18	21618343	.	C	T	8	9	17	0	1	18	0	0
18	21618379	.	A	G	7	7	14	0	1	15	0	0
18	21618496	.	G	A	7	6	13	0	0	13	0	0
18	21618659	.	C	A	10	4	14	0	0	14	0	0
18	21618731	.	G	T	9	8	17	0	0	17	0	0
18	21618910	.	G	T	7	14	21	0	2	23	0	0
18	21619011	.	C	T	8	8	16	0	3	19	0	0
18	21619018	.	A	T	11	9	20	0	0	20	0	0
18	21619055	.	G	T	11	7	18	0	2	20	0	0
18	21619260	.	C	T	12	7	19	0	0	19	0	0
18	21619284	.	G	T	8	7	15	0	0	15	0	0
18	21619672	.	A	G	8	15	23	0	0	23	0	0
18	21619686	.	G	A	7	10	17	0	2	19	0	0
18	21619777	.	A	G	22	6	28	0	1	29	0	0
18	21619799	.	T	G	21	11	32	0	1	33	0	0
18	21619948	.	C	T	16	13	29	1	0	30	0	0
18	21620082	.	A	T	16	9	25	0	2	27	0	0
18	21620376	.	A	C	19	27	46	0	2	48	0	0
18	21620426	.	G	A	1	31	32	0	20	52	0	0
18	21645492	.	G	A	8	6	14	0	4	18	0	0
18	21645627	.	A	G	9	6	15	0	0	15	0	0
18	21645965	.	G	A	5	3	8	0	1	9	0	0
18	21645989	.	T	G	2	2	4	0	0	4	0	0
18	21647419	.	T	C	1	0	1	0	0	1	0	0
18	21648582	.	A	G	3	3	6	0	0	6	0	0
18	21648627	.	C	T	2	1	3	0	0	3	0	0
18	21648633	.	A	T	2	0	2	0	0	2	0	0
18	21653937	.	C	T	1	2	3	0	0	3	0	0
18	21654145	.	C	T	1	2	3	0	0	3	0	0
18	21662298	.	C	T	0	0	0	0	2	2	0	0
18	21662301	.	C	A	0	2	2	0	0	2	0	0
18	21689043	.	G	C	3	4	7	0	0	7	0	0
18	21689052	.	A	G	4	5	9	0	0	9	0	0
18	21689079	.	G	A	11	7	18	0	1	19	0	0
18	21693120	.	A	G	8	1	9	0	0	9	0	0
18	21693213	.	G	A	2	12	14	0	0	14	0	0
18	21693441	.	G	A	4	3	7	0	0	7	0	0
18	21697776	.	C	T	4	4	8	0	0	8	0	0
18	21698855	.	G	T	3	3	6	0	1	7	0	0
18	21860755	.	C	T	13	8	21	0	0	21	0	0
18	21861134	.	T	A	6	10	16	0	1	17	0	0
18	21861225	.	T	A	8	9	17	0	0	17	0	0
18	21861381	.	G	T	5	7	12	0	2	14	0	0
18	21861497	.	A	T	3	4	7	0	1	8	0	0
18	21862000	.	G	C	3	2	5	0	1	6	0	0
18	21862076	.	C	T	0	1	1	0	5	6	0	0
18	21862141	.	T	C	1	0	1	0	5	6	0	0
18	21862175	.	C	T	0	2	2	0	2	4	0	0
18	21862237	.	G	T	1	2	3	0	0	3	0	0
18	21862346	.	T	A	5	2	7	0	0	7	0	0
18	21913799	.	A	T	11	5	16	0	0	16	0	0
18	21913907	.	G	C	10	7	17	0	2	19	0	0
18	21913988	.	C	A	8	13	21	0	1	22	0	0
18	21914018	.	C	A	13	12	25	0	2	27	0	0
18	21914225	.	C	T	0	6	6	0	10	16	0	0
18	21914281	.	G	A	5	4	9	0	0	9	0	0
18	21914283	.	C	A	5	4	9	0	0	9	0	0
18	22255005	.	C	T	1	0	1	0	0	1	0	0
18	22272969	.	C	A	3	3	6	0	0	6	0	0
18	22275051	.	T	C	2	4	6	0	1	7	0	0
18	22282766	.	A	T	2	5	7	0	1	8	0	0
18	22282809	.	A	T	12	5	17	0	0	17	0	0
18	22282923	.	G	T	8	11	19	0	1	20	0	0
18	22282960	.	C	T	12	10	22	0	0	22	0	0
18	22282961	.	A	G	12	10	22	0	0	22	0	0
18	22283087	.	C	A	8	7	15	0	0	15	0	0
18	22283116	.	T	A	7	8	15	0	0	15	0	0
18	22288650	.	T	C	3	2	5	0	0	5	0	0
18	22288659	.	C	T	3	1	4	0	0	4	0	0
18	22289075	.	T	C	1	3	4	0	0	4	0	0
18	22290900	.	G	A	1	3	4	0	0	4	0	0
18	22290933	.	C	T	4	4	8	0	1	9	0	0
18	22292215	.	A	T	10	9	19	0	0	19	0	0
18	22292286	.	G	A	12	10	22	0	3	25	0	0
18	22292339	.	A	T	12	10	22	0	0	22	0	0
18	22293191	.	T	G	5	2	7	0	0	7	0	0
18	22356989	.	C	T	4	3	7	0	1	8	0	0
18	22376947	.	A	C	3	0	3	0	8	11	0	0
18	22377096	.	A	T	15	18	33	0	1	34	0	0
18	22377372	.	G	A	0	15	15	0	22	37	0	0
18	22377471	.	C	T	13	11	24	0	2	26	0	0
18	22385900	.	G	A	25	30	55	0	5	60	0	0
18	22405895	.	A	T	5	5	10	0	0	10	0	0
18	22406162	.	C	T	1	6	7	0	1	8	0	0
18	22406311	.	T	A	2	3	5	0	0	5	0	0
18	22406324	.	G	A	2	1	3	0	0	3	0	0
18	22406375	.	T	A	0	2	2	0	1	3	0	0
18	22406379	.	G	A	1	1	2	0	1	3	0	0
18	22420551	.	A	T	1	2	3	0	0	3	0	0
18	22424532	.	T	C	0	1	1	0	0	1	0	0
18	22424536	.	A	G	0	0	0	0	1	1	0	0
18	22486123	.	T	C	3	2	5	0	0	5	0	0
18	22685608	.	C	A	2	2	4	0	0	4	0	0
18	22686320	.	G	A	1	3	4	0	0	4	0	0
18	22686358	.	G	A	1	2	3	0	0	3	0	0
18	22686723	.	C	T	1	3	4	0	0	4	0	0
18	22686789	.	G	A	2	6	8	0	1	9	0	0
18	22686795	.	C	G	2	6	8	0	1	9	0	0
18	22686927	.	G	A	0	3	3	0	0	3	0	0
18	22687312	.	G	A	11	8	19	0	1	20	0	0
18	22687527	.	G	C	14	16	30	0	1	31	0	0
18	22687575	.	T	A	13	26	39	0	0	40	1	0
18	22687599	.	A	T	25	11	36	0	0	36	0	0
18	22687666	.	C	T	16	16	32	0	0	32	0	0
18	22732391	.	A	G	1	0	1	0	0	1	0	0
18	22921942	.	C	T	6	2	8	0	0	8	0	0
18	22921950	.	T	C	6	2	8	0	0	8	0	0
18	22975090	.	T	C	19	15	34	0	4	38	0	0
18	22975297	.	A	C	26	18	44	0	1	45	0	0
18	23071744	.	C	A	1	2	3	0	0	3	0	0
18	23071769	.	G	C	1	2	3	0	0	3	0	0
18	23072049	.	C	T	1	2	3	0	0	3	0	0
18	23072050	.	T	A	1	2	3	0	0	3	0	0
18	23072164	.	G	A	2	2	4	0	0	4	0	0
18	23869784	.	T	A	20	17	37	0	0	37	0	0
18	23875111	.	A	C	2	2	4	0	0	4	0	0
18	24929720	.	C	T	7	2	9	0	0	9	0	0
18	24930530	.	T	C	1	6	7	0	3	10	0	0
18	24931326	.	G	A	5	9	14	0	0	14	0	0
18	24931699	.	T	C	10	16	26	0	2	28	0	0
18	24933638	.	C	G	14	11	25	0	1	26	0	0
18	24933769	.	C	A	12	13	25	0	1	26	0	0
18	24933799	.	A	G	16	13	29	0	1	30	0	0
18	24934333	.	A	T	7	8	15	0	3	18	0	0
18	24934713	.	C	A	9	3	12	0	0	12	0	0
18	24934950	.	G	A	7	3	10	0	0	10	0	0
18	24935099	.	A	G	9	10	19	0	1	20	0	0
18	24938805	.	A	G	2	8	10	0	1	11	0	0
18	24938871	.	T	C	2	5	7	0	2	9	0	0
18	24938919	.	C	T	1	1	2	0	0	2	0	0
18	24944039	.	A	T	1	1	2	0	0	2	0	0
18	24944045	.	T	C	0	1	1	0	0	1	0	0
18	24946637	.	T	C	2	2	4	0	0	4	0	0
18	24946727	.	T	A	1	2	3	0	0	3	0	0
18	25009326	.	C	A	5	6	11	0	1	12	0	0
18	25009407	.	T	C	1	11	12	0	1	13	0	0
18	25752722	.	G	A	4	3	7	0	0	7	0	0
18	26097091	.	G	T	37	27	64	0	4	69	1	0
18	26097428	.	G	A	9	9	18	0	1	19	0	0
18	26099274	.	A	T	20	18	38	0	0	38	0	0
18	26393716	.	C	A	1	2	3	0	1	4	0	0
18	26401680	.	T	C	2	2	4	0	0	4	0	0
18	26401719	.	T	C	1	2	3	0	2	5	0	0
18	26425376	.	G	A	0	1	1	0	0	1	0	0
18	26679646	.	G	T	1	3	4	0	0	4	0	0
18	26785160	.	A	C	3	2	5	0	0	5	0	0
18	26785162	.	T	A	3	2	5	0	0	5	0	0
18	26790510	.	A	T	5	3	8	0	0	8	0	0
18	26800148	.	A	C	5	4	9	0	1	10	0	0
18	26800167	.	C	G	5	6	11	0	2	13	0	0
18	26804218	.	G	A	1	2	3	0	0	3	0	0
18	26804233	.	T	A	0	2	2	0	1	3	0	0
18	26870137	.	G	A	1	1	2	0	0	2	0	0
18	26876449	.	A	C	1	3	4	0	0	4	0	0
18	26899453	.	T	C	1	3	4	0	0	4	0	0
18	26919226	.	C	T	8	7	15	0	3	18	0	0
18	26919227	.	T	A	8	7	15	0	3	18	0	0
18	26919865	.	T	C	10	4	14	0	0	14	0	0
18	26919989	.	T	A	24	25	49	0	2	51	0	0
18	26920116	.	T	C	3	4	7	0	1	8	0	0
18	26968799	.	G	A	6	4	10	0	0	10	0	0
18	26971513	.	G	A	5	3	8	0	0	8	0	0
18	27085217	.	A	T	1	3	4	0	0	4	0	0
18	27254790	.	T	A	1	2	3	0	0	3	0	0
18	27288580	.	G	A	1	1	2	0	0	2	0	0
18	27309512	.	T	C	1	8	9	0	0	9	0	0
18	27309713	.	C	A	2	1	3	0	1	5	1	0
18	27309716	.	G	A	2	2	4	0	1	5	0	0
18	27309873	.	C	T	11	9	20	0	2	22	0	0
18	27335583	.	T	C	1	2	3	0	0	3	0	0
18	27335597	.	G	A	1	1	2	0	1	3	0	0
18	27335780	.	A	T	2	11	13	0	0	13	0	0
18	27335828	.	A	G	2	6	8	0	0	8	0	0
18	27335935	.	T	A	5	7	12	0	0	12	0	0
18	33981658	.	C	A	13	5	18	0	3	21	0	0
18	36598337	.	A	G	4	2	6	0	0	6	0	0
18	36598439	.	A	G	11	4	15	0	1	16	0	0
18	36869676	.	A	G	6	7	13	0	1	14	0	0
18	36869677	.	A	G	6	6	12	0	2	14	0	0
18	40387506	.	C	T	6	5	11	0	0	11	0	0
18	40387606	.	G	A	5	5	10	0	0	10	0	0
18	40387650	.	T	A	3	12	15	0	0	15	0	0
18	40387811	.	T	A	2	4	6	0	1	7	0	0
18	40489539	.	G	A	1	7	8	0	0	8	0	0
18	40492253	.	T	C	1	3	4	0	1	5	0	0
18	41300057	.	T	G	0	1	1	0	1	2	0	0
18	41300063	.	A	G	1	0	1	0	1	2	0	0
18	41305867	.	C	T	1	2	3	0	0	3	0	0
18	41309305	.	G	A	1	8	9	0	1	10	0	0
18	41310196	.	A	G	3	1	4	0	6	10	0	0
18	41310464	.	G	A	0	13	13	0	23	36	0	0
18	41365236	.	C	A	1	2	3	0	0	3	0	0
18	41495859	.	A	G	8	6	14	0	0	14	0	0
18	41495865	.	A	T	6	4	10	0	2	12	0	0
18	41499590	.	T	C	0	1	1	0	0	1	0	0
18	41499679	.	A	G	2	3	5	0	1	6	0	0
18	41499683	.	T	C	3	1	4	0	3	7	0	0
18	41499789	.	C	T	5	2	7	0	1	8	0	0
18	41503578	.	C	A	15	15	30	0	3	33	0	0
18	41505624	.	A	G	15	1	16	0	19	35	0	0
18	41509564	.	C	G	22	13	35	0	0	35	0	0
18	41509716	.	G	T	20	8	28	0	1	29	0	0
18	41512217	.	C	T	2	5	7	0	0	7	0	0
18	41512370	.	G	A	2	2	4	0	0	4	0	0
18	41524354	.	G	A	9	11	20	0	2	22	0	0
18	41524364	.	C	A	10	10	20	0	1	21	0	0
18	41525864	.	T	C	20	19	39	0	2	41	0	0
18	41525880	.	G	A	0	24	24	0	17	41	0	0
18	41526014	.	C	G	11	0	11	0	22	33	0	0
18	41526026	.	A	G	13	19	32	0	2	34	0	0
18	41526247	.	T	A	11	26	37	0	1	38	0	0
18	41526299	.	T	A	13	18	31	0	2	33	0	0
18	41526318	.	A	G	16	20	36	0	0	36	0	0
18	41526380	.	C	T	3	8	11	0	7	18	0	0
18	41526381	.	T	C	8	8	16	0	2	18	0	0
18	41533072	.	C	T	1	4	5	0	2	7	0	0
18	41538770	.	G	A	7	11	18	0	1	19	0	0
18	41538795	.	A	G	5	8	13	0	0	13	0	0
18	41538856	.	G	A	4	4	8	0	0	8	0	0
18	41542632	.	A	G	1	2	3	0	0	3	0	0
18	41543076	.	C	T	4	5	9	0	1	10	0	0
18	41546938	.	C	G	4	2	6	0	0	6	0	0
18	41547273	.	T	G	1	3	4	0	2	6	0	0
18	41556239	.	G	A	0	1	1	0	1	2	0	0
18	41558711	.	C	T	3	6	9	0	1	10	0	0
18	41559028	.	C	T	2	2	4	0	0	4	0	0
18	41559141	.	A	G	1	2	3	0	0	3	0	0
18	41574002	.	G	A	2	3	5	0	0	5	0	0
18	41574005	.	G	A	2	2	4	0	1	5	0	0
18	41579975	.	T	A	2	2	4	0	0	4	0	0
18	41586440	.	T	C	0	3	3	0	0	3	0	0
18	41591256	.	G	T	12	3	15	0	1	16	0	0
18	41648941	.	T	C	5	15	20	0	3	23	0	0
18	41649061	.	C	T	10	7	17	0	0	17	0	0
18	41649571	.	A	G	3	5	8	0	0	8	0	0
18	41649949	.	C	T	0	3	3	0	1	4	0	0
18	41650222	.	C	T	1	4	5	0	1	6	0	0
18	41757350	.	C	A	16	14	30	0	4	34	0	0
18	41757373	.	G	C	21	22	43	0	2	45	0	0
18	41757449	.	G	A	21	23	44	0	1	45	0	0
18	41757454	.	G	A	19	25	44	0	1	45	0	0
18	41757669	.	C	T	8	8	16	0	0	16	0	0
18	41808695	.	T	C	4	3	7	0	0	7	0	0
18	42151412	.	A	C	12	0	12	0	17	29	0	0
18	42201141	.	C	G	1	1	2	0	0	2	0	0
18	43225614	.	T	C	1	2	3	0	0	3	0	0
18	43225650	.	C	T	3	2	5	0	0	5	0	0
18	43225683	.	C	T	2	2	4	0	1	5	0	0
18	43225896	.	C	T	3	7	10	0	2	12	0	0
18	44321063	.	A	G	2	3	5	0	0	5	0	0
18	44321260	.	T	A	8	7	15	0	2	17	0	0
18	44321323	.	C	T	7	2	9	0	0	9	0	0
18	44321424	.	A	C	2	2	4	0	0	4	0	0
18	44321909	.	G	A	3	6	9	0	1	10	0	0
18	44321949	.	T	C	1	4	5	0	0	5	0	0
18	44321950	.	T	C	3	2	5	0	0	5	0	0
18	44322000	.	T	A	2	2	4	0	0	4	0	0
18	44322003	.	G	A	1	3	4	0	0	4	0	0
18	44322043	.	T	A	2	3	5	0	0	5	0	0
18	44322280	.	T	C	1	3	4	0	0	4	0	0
18	44327944	.	A	G	1	1	2	0	0	2	0	0
18	44327953	.	G	A	1	1	2	0	0	2	0	0
18	44364647	.	C	A	28	33	61	0	3	64	0	0
18	44365064	.	C	A	21	25	46	0	2	48	0	0
18	44365114	.	T	A	31	29	60	0	1	61	0	0
18	44365223	.	T	C	10	24	34	0	1	35	0	0
18	44365553	.	A	G	8	4	12	0	0	12	0	0
18	44365650	.	T	C	17	19	36	0	0	36	0	0
18	44365714	.	C	A	21	26	47	0	0	47	0	0
18	44365717	.	A	G	21	24	45	0	1	46	0	0
18	44365977	.	T	C	3	17	20	0	2	22	0	0
18	44365987	.	T	A	4	18	22	0	0	22	0	0
18	44366124	.	T	C	1	6	7	0	1	8	0	0
18	44367241	.	A	T	2	2	4	0	0	4	0	0
18	44367426	.	C	T	14	10	24	0	1	25	0	0
18	44367488	.	G	A	3	6	9	0	0	9	0	0
18	44425105	.	C	T	0	1	1	0	0	1	0	0
18	44425150	.	A	C	1	2	3	0	0	3	0	0
18	44587777	.	C	A	1	0	1	0	0	1	0	0
18	44589770	.	G	C	8	3	11	0	0	11	0	0
18	44597048	.	G	A	4	2	6	0	2	8	0	0
18	44597308	.	C	A	29	19	48	0	1	49	0	0
18	44597850	.	A	G	6	12	18	0	1	19	0	0
18	44597884	.	G	A	9	8	17	0	1	18	0	0
18	44598234	.	C	T	0	14	14	0	6	20	0	0
18	44598371	.	C	T	4	8	12	0	0	12	0	0
18	44599804	.	T	G	2	0	2	0	9	11	0	0
18	44599837	.	G	A	3	5	8	0	0	8	0	0
18	44611093	.	G	A	0	4	4	0	1	5	0	0
18	44615685	.	G	A	10	12	22	0	1	23	0	0
18	44615770	.	G	A	8	19	27	0	3	30	0	0
18	44615819	.	T	C	14	12	26	0	3	29	0	0
18	44615861	.	A	T	5	9	14	0	0	14	0	0
18	44618795	.	G	T	7	3	10	0	1	11	0	0
18	44619049	.	T	G	3	5	8	0	0	8	0	0
18	44637898	.	G	A	0	2	2	0	0	2	0	0
18	44645008	.	A	T	5	6	11	0	1	12	0	0
18	44645782	.	G	C	3	9	12	0	1	13	0	0
18	44645870	.	T	A	8	5	13	0	0	13	0	0
18	44646048	.	C	T	3	3	6	0	0	6	0	0
18	44646215	.	C	T	4	4	8	0	1	9	0	0
18	44646467	.	A	C	10	13	23	0	0	23	0	0
18	44646504	.	C	T	15	8	23	0	3	26	0	0
18	44646587	.	G	A	0	17	17	0	14	31	0	0
18	44646678	.	C	T	11	16	27	0	4	31	0	0
18	44646781	.	A	G	16	10	26	0	0	26	0	0
18	44696319	.	A	C	5	5	10	0	1	11	0	0
18	44696451	.	A	T	2	2	4	0	0	4	0	0
18	44783771	.	C	T	1	1	2	0	0	2	0	0
18	44790635	.	A	G	1	2	3	0	0	3	0	0
18	44790722	.	G	A	2	2	4	0	0	4	0	0
18	44826427	.	C	T	0	8	8	1	21	30	0	0
18	44826554	.	T	G	15	11	26	0	0	26	0	0
18	44826910	.	C	T	1	7	8	0	1	9	0	0
18	44830217	.	C	T	2	3	5	0	2	7	0	0
18	44830247	.	G	A	5	4	9	0	1	10	0	0
18	44832693	.	C	A	3	4	7	0	0	7	0	0
18	44838342	.	G	A	4	5	9	0	0	9	0	0
18	44843407	.	G	A	1	0	1	0	0	1	0	0
18	44873083	.	C	T	0	2	2	0	0	2	0	0
18	44873993	.	G	T	2	3	5	0	0	5	0	0
18	44913653	.	G	T	4	5	9	0	0	9	0	0
18	44913760	.	A	G	3	2	5	0	0	5	0	0
18	45259886	.	T	C	1	0	1	0	2	3	0	0
18	45261210	.	T	A	0	5	5	0	0	5	0	0
18	45261319	.	A	T	2	1	3	0	2	5	0	0
18	45261369	.	G	T	3	3	6	0	0	6	0	0
18	45261845	.	T	A	3	2	5	0	0	5	0	0
18	45262227	.	C	T	2	2	4	0	1	5	0	0
18	45262351	.	C	T	5	6	11	0	1	12	0	0
18	45262687	.	G	T	4	10	14	0	0	14	0	0
18	45262855	.	A	C	4	13	17	0	3	20	0	0
18	45262865	.	T	C	6	15	21	0	1	22	0	0
18	45550831	.	G	C	0	4	4	0	4	8	0	0
18	45550839	.	A	C	3	4	7	0	1	8	0	0
18	45561677	.	G	T	0	1	1	0	0	1	0	0
18	45569037	.	G	A	0	6	6	0	2	8	0	0
18	45569075	.	C	A	1	5	6	0	0	6	0	0
18	45569092	.	A	G	0	0	0	0	3	3	0	0
18	45574140	.	A	G	2	8	10	0	0	10	0	0
18	45574275	.	A	T	2	2	4	0	0	4	0	0
18	45581704	.	C	A	4	4	8	0	1	9	0	0
18	45581784	.	C	T	0	1	1	0	0	1	0	0
18	45583038	.	A	C	3	4	7	0	1	8	0	0
18	45583042	.	G	A	0	5	5	0	3	8	0	0
18	45584036	.	C	T	5	3	8	0	0	8	0	0
18	45584368	.	T	C	14	10	24	0	1	25	0	0
18	45588336	.	C	T	12	3	15	0	1	16	0	0
18	45591836	.	A	T	16	8	24	0	3	27	0	0
18	45591929	.	G	A	16	10	26	0	5	31	0	0
18	45647838	.	G	A	0	2	2	0	0	2	0	0
18	45647940	.	C	T	3	3	6	0	0	6	0	0
18	45649613	.	C	T	5	2	7	0	1	8	0	0
18	45649658	.	G	T	11	5	16	0	3	19	0	0
18	45651032	.	C	T	5	4	9	0	0	9	0	0
18	45651559	.	T	A	4	4	8	0	0	8	0	0
18	45656062	.	T	C	11	7	18	0	1	19	0	0
18	45656089	.	T	C	2	3	5	0	0	5	0	0
18	45697623	.	A	G	2	2	4	0	1	5	0	0
18	45697833	.	A	T	3	2	5	0	0	5	0	0
18	45697999	.	T	C	3	3	6	0	0	6	0	0
18	45698143	.	G	A	0	2	2	0	1	3	0	0
18	45734477	.	T	C	8	7	15	0	1	16	0	0
18	45742051	.	C	A	12	6	18	0	0	18	0	0
18	45742059	.	G	A	12	5	17	0	0	17	0	0
18	45743518	.	G	A	1	3	4	0	0	4	0	0
18	45743522	.	G	A	1	3	4	0	0	4	0	0
18	45743555	.	C	A	1	2	3	0	1	4	0	0
18	45745504	.	A	T	1	2	3	0	0	3	0	0
18	45750912	.	A	C	3	0	3	0	4	7	0	0
18	45750915	.	A	G	3	4	7	0	0	7	0	0
18	45752094	.	C	T	0	1	1	0	1	2	0	0
18	45759309	.	G	T	7	8	15	0	1	16	0	0
18	45784225	.	A	G	34	35	69	0	5	74	0	0
18	45818602	.	C	T	3	2	5	0	0	5	0	0
18	45820588	.	A	G	0	2	2	0	0	2	0	0
18	45824315	.	C	T	2	2	4	0	1	5	0	0
18	45835115	.	C	T	0	4	4	0	0	4	0	0
18	45840471	.	T	A	8	4	12	0	1	14	1	0
18	45840504	.	C	T	11	7	18	0	1	19	0	0
18	45842491	.	T	C	6	2	8	0	0	8	0	0
18	45842679	.	G	A	0	8	8	0	4	12	0	0
18	45844458	.	C	T	10	12	22	0	2	24	0	0
18	45844473	.	A	T	10	13	23	0	1	24	0	0
18	45848355	.	C	T	1	1	2	0	0	2	0	0
18	45849283	.	C	T	6	7	13	0	3	16	0	0
18	45851540	.	G	A	0	4	4	0	6	10	0	0
18	45962500	.	A	G	0	1	1	0	0	1	0	0
18	45962668	.	C	T	5	5	10	0	1	11	0	0
18	45969252	.	C	A	0	1	1	0	0	1	0	0
18	45979887	.	C	T	4	4	8	0	0	8	0	0
18	45983268	.	A	C	13	12	25	0	0	25	0	0
18	46005023	.	T	A	1	2	3	0	0	3	0	0
18	46367733	.	G	A	5	3	8	0	0	8	0	0
18	46367772	.	C	G	0	5	5	0	5	10	0	0
18	46417181	.	C	T	2	3	5	0	0	5	0	0
18	46417342	.	A	G	8	9	17	0	0	17	0	0
18	46417402	.	G	A	5	13	18	0	0	18	0	0
18	46417624	.	T	C	7	6	13	0	0	13	0	0
18	46417714	.	G	C	6	3	9	0	0	9	0	0
18	46419056	.	C	T	2	3	5	0	0	5	0	0
18	46419124	.	T	C	1	4	5	0	0	5	0	0
18	46419616	.	T	C	1	3	4	0	0	4	0	0
18	46699773	.	G	A	4	4	8	0	0	8	0	0
18	47301204	.	T	C	3	4	7	0	0	7	0	0
18	47305433	.	A	G	2	1	3	0	1	4	0	0
18	47306602	.	A	C	3	3	6	0	0	6	0	0
18	47306605	.	A	G	3	2	5	0	1	6	0	0
18	47306677	.	T	G	4	3	7	0	0	7	0	0
18	47306782	.	A	G	6	3	9	0	0	9	0	0
18	48808985	.	T	A	1	2	3	0	0	3	0	0
18	48809189	.	G	A	5	8	13	0	1	14	0	0
18	48809268	.	T	A	4	3	7	0	0	7	0	0
18	48809276	.	A	G	2	0	2	0	3	5	0	0
18	48921166	.	C	G	3	2	5	0	0	5	0	0
18	48921175	.	A	C	1	1	2	0	0	2	0	0
18	48928342	.	A	G	3	0	3	0	7	10	0	0
18	48928387	.	T	A	4	3	7	0	1	8	0	0
18	48928552	.	C	T	7	3	10	0	0	10	0	0
18	48928843	.	C	T	6	5	11	0	0	11	0	0
18	48934524	.	T	C	2	6	8	0	1	9	0	0
18	48934593	.	T	C	0	3	3	0	0	3	0	0
18	48934805	.	A	G	7	6	13	0	1	14	0	0
18	48934833	.	T	C	6	11	17	0	0	17	0	0
18	48935279	.	T	G	16	11	27	0	5	32	0	0
18	48951382	.	C	T	2	2	4	0	0	4	0	0
18	48972490	.	A	T	3	3	6	0	0	6	0	0
18	49002199	.	T	G	0	2	2	0	1	3	0	0
18	49002215	.	G	C	1	2	3	0	0	3	0	0
18	49006805	.	G	A	2	0	2	0	1	3	0	0
18	49127233	.	C	T	9	3	12	0	0	12	0	0
18	49127234	.	C	G	9	3	12	0	0	12	0	0
18	49153651	.	T	C	5	2	7	0	0	7	0	0
18	49153710	.	A	C	0	2	2	0	2	4	0	0
18	49153735	.	G	A	0	2	2	0	1	3	0	0
18	49153900	.	C	T	3	3	6	0	1	7	0	0
18	49153977	.	G	C	0	3	3	0	8	11	0	0
18	49153984	.	G	T	0	6	6	0	5	11	0	0
18	49154079	.	A	G	6	3	9	0	0	9	0	0
18	49154082	.	A	G	6	2	8	0	1	9	0	0
18	49154328	.	G	A	2	6	8	0	0	8	0	0
18	49154458	.	G	T	2	5	7	0	0	7	0	0
18	49154483	.	G	T	0	9	9	0	3	12	0	0
18	49154525	.	C	T	3	15	18	0	0	18	0	0
18	49154527	.	T	C	2	15	17	0	1	18	0	0
18	49154722	.	A	G	7	7	14	0	0	14	0	0
18	49154760	.	G	A	0	2	2	0	6	8	0	0
18	49154774	.	T	A	5	2	7	0	0	7	0	0
18	49155190	.	C	G	10	5	15	0	0	15	0	0
18	49155211	.	C	A	5	7	12	0	1	13	0	0
18	49155303	.	G	A	1	2	3	0	1	4	0	0
18	49155491	.	T	C	2	2	4	0	1	5	0	0
18	49155520	.	A	G	2	2	4	0	0	4	0	0
18	49155776	.	G	A	8	4	12	0	0	12	0	0
18	49155941	.	C	T	7	9	16	0	1	17	0	0
18	49156113	.	A	G	7	3	10	0	2	12	0	0
18	49156128	.	A	G	2	4	6	0	1	7	0	0
18	49156567	.	T	C	8	10	18	0	1	19	0	0
18	49156773	.	G	T	11	5	16	0	1	17	0	0
18	49214198	.	T	C	4	3	7	0	0	7	0	0
18	49214231	.	G	A	2	4	6	0	0	6	0	0
18	49246605	.	A	T	1	4	5	0	0	5	0	0
18	49246618	.	T	C	2	3	5	0	1	6	0	0
18	49265220	.	G	C	0	2	2	0	3	5	0	0
18	49266575	.	G	A	1	3	4	0	1	5	0	0
18	49266589	.	A	G	2	4	6	0	2	9	1	0
18	49266646	.	C	A	2	7	9	0	0	9	0	0
18	49266649	.	A	G	2	0	2	0	6	8	0	0
18	49267274	.	A	G	4	3	7	0	0	7	0	0
18	49267547	.	A	G	0	2	2	1	1	4	0	0
18	49267701	.	A	T	7	8	15	0	0	15	0	0
18	49267832	.	A	G	2	5	7	0	0	7	0	0
18	49274050	.	C	T	2	2	4	0	0	4	0	0
18	49274053	.	A	G	1	2	3	0	1	4	0	0
18	49274093	.	C	A	0	3	3	0	2	5	0	0
18	49447008	.	C	A	1	1	2	0	1	3	0	0
18	49447041	.	G	A	0	3	3	0	2	5	0	0
18	50039536	.	G	A	0	9	9	0	4	13	0	0
18	50039852	.	G	T	9	7	16	0	1	17	0	0
18	50039939	.	C	T	9	3	12	0	0	12	0	0
18	50039979	.	A	T	1	2	3	0	3	6	0	0
18	50040021	.	G	T	3	3	6	0	1	7	0	0
18	50099441	.	A	G	1	3	4	0	0	4	0	0
18	50124802	.	G	A	3	4	7	0	0	7	0	0
18	50124803	.	T	A	3	4	7	0	0	7	0	0
18	50124843	.	A	T	2	2	4	0	0	4	0	0
18	50124847	.	T	C	2	2	4	0	0	4	0	0
18	50276476	.	C	G	2	2	4	0	0	4	0	0
18	50276681	.	T	G	3	3	6	0	0	6	0	0
18	50279044	.	T	C	15	14	29	0	0	29	0	0
18	50279182	.	G	A	0	10	10	0	17	27	0	0
18	50353568	.	A	C	24	22	46	0	2	48	0	0
18	50353598	.	C	T	22	25	47	0	4	51	0	0
18	50356632	.	T	C	22	27	49	0	4	53	0	0
18	50538289	.	T	C	5	6	11	0	1	12	0	0
18	50538340	.	T	C	3	5	8	0	0	8	0	0
18	50538442	.	T	C	5	3	8	0	0	8	0	0
18	50538449	.	T	C	5	0	5	0	2	7	0	0
18	50708755	.	T	A	0	6	6	0	0	6	0	0
18	50709147	.	C	A	2	2	4	0	9	13	0	0
18	50942403	.	G	A	5	2	7	0	0	7	0	0
19	372170	.	A	G	1	4	5	0	0	5	0	0
19	372766	.	A	G	8	3	11	0	2	13	0	0
19	768152	.	A	G	4	2	6	0	0	6	0	0
19	860993	.	T	A	4	3	7	0	2	9	0	0
19	861077	.	T	A	3	3	6	0	1	7	0	0
19	1407104	.	A	C	2	3	5	0	0	5	0	0
19	2003150	.	T	C	3	1	4	0	2	6	0	0
19	2003158	.	C	T	5	2	7	0	0	7	0	0
19	2003634	.	T	C	3	2	5	0	3	8	0	0
19	2003767	.	C	T	7	12	19	0	1	20	0	0
19	2003803	.	C	G	10	0	10	0	16	26	0	0
19	2003902	.	A	T	9	10	19	0	1	20	0	0
19	2003962	.	G	T	0	19	19	0	6	25	0	0
19	2004046	.	G	C	10	10	20	0	4	24	0	0
19	2019147	.	C	T	0	0	0	0	1	1	0	0
19	2315489	.	A	T	1	1	2	0	0	3	1	0
19	2315511	.	C	T	0	2	2	0	2	4	0	0
19	2315531	.	G	C	0	4	4	0	0	4	0	0
19	2315707	.	A	G	0	2	2	0	0	2	0	0
19	2396647	.	C	T	3	2	5	0	0	5	0	0
19	2396708	.	C	T	2	2	4	0	0	4	0	0
19	2397381	.	G	C	1	2	3	0	0	3	0	0
19	2397559	.	T	C	2	3	5	0	1	6	0	0
19	2400403	.	G	A	0	1	1	0	0	1	0	0
19	2551727	.	C	T	2	2	4	0	0	4	0	0
19	2561048	.	A	C	4	1	5	0	1	6	0	0
19	2561739	.	G	A	0	7	7	0	6	13	0	0
19	2562530	.	A	G	6	14	20	0	1	21	0	0
19	2562542	.	A	G	7	11	18	0	2	20	0	0
19	2651272	.	A	G	1	0	1	0	0	1	0	0
19	2663609	.	A	G	5	4	9	0	0	9	0	0
19	2664125	.	G	A	1	4	5	0	2	7	0	0
19	2664394	.	C	T	15	8	23	0	0	23	0	0
19	2664613	.	T	C	9	6	15	0	2	17	0	0
19	2695314	.	G	A	7	9	16	0	1	17	0	0
19	2695351	.	A	G	3	0	3	0	3	6	0	0
19	2695358	.	G	A	2	2	4	0	1	5	0	0
19	2857849	.	T	C	4	3	7	0	0	7	0	0
19	2857957	.	G	C	0	3	3	0	0	3	0	0
19	2871511	.	A	G	4	4	8	0	1	9	0	0
19	2871553	.	C	T	3	2	5	0	0	5	0	0
19	2871559	.	G	A	2	2	4	0	0	4	0	0
19	2884200	.	G	A	0	1	1	0	0	1	0	0
19	2884207	.	C	T	0	2	2	0	0	2	0	0
19	2887046	.	G	C	0	3	3	0	4	7	0	0
19	2930451	.	G	A	4	3	7	0	2	9	0	0
19	2930521	.	T	C	5	6	11	0	0	11	0	0
19	2930597	.	A	G	7	7	14	0	1	15	0	0
19	3082102	.	C	T	2	2	4	0	0	4	0	0
19	3137727	.	C	T	0	28	28	0	14	42	0	0
19	3137761	.	C	A	8	21	29	0	1	30	0	0
19	3137803	.	A	T	11	8	19	0	1	20	0	0
19	3138325	.	A	C	1	2	3	0	0	3	0	0
19	3215468	.	A	G	0	1	1	0	0	1	0	0
19	3229424	.	A	G	0	1	1	0	0	1	0	0
19	3231206	.	T	C	2	3	5	0	0	5	0	0
19	3238395	.	T	A	13	19	32	0	1	33	0	0
19	3238425	.	T	C	13	20	33	0	1	34	0	0
19	3238721	.	T	A	28	14	42	0	0	42	0	0
19	3240409	.	G	C	6	9	15	0	0	15	0	0
19	3385683	.	C	T	0	2	2	0	1	3	0	0
19	3386141	.	C	T	1	3	4	0	0	4	0	0
19	3386258	.	T	A	15	14	29	0	1	30	0	0
19	3386358	.	A	G	10	13	23	0	0	23	0	0
19	3386485	.	C	A	10	6	16	0	0	16	0	0
19	3386580	.	T	A	5	2	7	0	1	8	0	0
19	3386873	.	C	T	7	10	17	0	1	18	0	0
19	3387040	.	C	A	0	12	12	0	12	24	0	0
19	3387068	.	A	C	8	10	18	0	2	20	0	0
19	3387097	.	C	G	8	17	25	0	0	25	0	0
19	3387506	.	G	A	10	10	20	0	0	20	0	0
19	3387713	.	G	A	6	8	14	0	2	16	0	0
19	3388617	.	G	A	6	3	9	0	0	9	0	0
19	3390203	.	G	A	2	4	6	0	0	6	0	0
19	3577953	.	A	C	3	2	5	0	0	5	0	0
19	3577994	.	A	G	2	3	5	0	0	5	0	0
19	3577997	.	A	G	2	3	5	0	0	5	0	0
19	3578087	.	A	T	2	2	4	0	0	4	0	0
19	3707235	.	A	G	1	4	5	0	0	5	0	0
19	3707562	.	T	A	3	3	6	0	0	6	0	0
19	3707576	.	C	T	1	3	4	0	0	4	0	0
19	3707625	.	G	A	0	3	3	0	6	9	0	0
19	3718110	.	A	T	16	11	27	0	0	27	0	0
19	3718222	.	G	A	10	23	33	0	3	36	0	0
19	3718251	.	C	A	11	18	29	0	5	34	0	0
19	3718281	.	A	C	11	21	32	0	1	33	0	0
19	3718330	.	G	A	24	12	36	0	0	36	0	0
19	3718415	.	G	T	14	12	26	0	3	29	0	0
19	3718675	.	C	A	13	14	27	0	2	29	0	0
19	3865928	.	C	T	0	6	6	0	10	16	0	0
19	3866029	.	C	T	1	9	10	0	0	10	0	0
19	3866031	.	G	A	1	9	10	0	0	10	0	0
19	3866075	.	T	C	6	6	12	0	0	12	0	0
19	3866102	.	A	G	10	9	19	0	1	20	0	0
19	3866165	.	T	C	15	6	21	0	1	22	0	0
19	3866206	.	T	A	9	2	11	0	0	11	0	0
19	3866289	.	C	G	3	4	7	0	1	8	0	0
19	3866424	.	A	T	10	12	22	0	0	22	0	0
19	3866727	.	C	T	0	5	5	0	13	18	0	0
19	3868535	.	T	C	9	3	12	0	4	17	1	0
19	3868541	.	C	T	0	5	5	0	13	18	0	0
19	3872833	.	C	T	3	4	7	0	0	7	0	0
19	3873055	.	C	T	1	0	1	0	0	1	0	0
19	3873955	.	G	A	3	2	5	0	0	5	0	0
19	3874195	.	A	G	1	2	3	0	0	3	0	0
19	3937971	.	T	C	14	21	35	0	3	38	0	0
19	3939887	.	C	T	10	3	13	0	3	16	0	0
19	3939902	.	G	T	10	8	18	0	3	21	0	0
19	3940022	.	C	T	0	10	10	0	13	23	0	0
19	3945750	.	G	T	4	4	8	0	2	10	0	0
19	4010175	.	C	A	1	2	3	0	0	3	0	0
19	4090283	.	C	T	2	2	4	0	0	4	0	0
19	4090292	.	A	T	2	0	2	0	1	3	0	0
19	4443334	.	T	C	1	3	4	0	0	4	0	0
19	4443403	.	T	C	2	4	6	0	1	7	0	0
19	4445154	.	T	C	3	2	5	0	0	5	0	0
19	4445317	.	T	C	1	1	2	0	1	3	0	0
19	4445329	.	T	A	1	2	3	0	0	3	0	0
19	4447322	.	G	T	1	0	1	0	1	2	0	0
19	4447347	.	G	A	2	3	5	0	1	6	0	0
19	4447502	.	T	A	7	10	17	0	0	17	0	0
19	4866919	.	T	C	2	2	4	0	1	5	0	0
19	4877141	.	T	C	3	2	5	0	0	5	0	0
19	4881345	.	G	T	1	0	1	0	0	1	0	0
19	4888756	.	G	A	0	3	3	0	8	11	0	0
19	4892154	.	G	A	2	3	5	0	2	7	0	0
19	4892287	.	A	C	1	1	2	0	20	22	0	0
19	4892292	.	A	C	3	2	5	0	14	19	0	0
19	4892530	.	G	T	0	9	9	0	7	16	0	0
19	4892590	.	C	T	2	5	7	0	0	7	0	0
19	4892946	.	A	T	7	11	18	0	5	23	0	0
19	4903907	.	C	T	8	4	12	0	0	12	0	0
19	4903971	.	A	T	9	10	19	0	0	19	0	0
19	4904042	.	A	T	1	2	3	0	1	4	0	0
19	4904503	.	C	T	3	4	7	0	0	7	0	0
19	4904529	.	T	A	4	2	6	0	1	7	0	0
19	4904569	.	T	C	1	3	4	0	0	4	0	0
19	4905088	.	G	T	9	6	15	0	1	16	0	0
19	4905239	.	C	T	10	12	22	0	2	24	0	0
19	4905309	.	A	T	2	3	5	0	0	5	0	0
19	4961950	.	A	T	11	14	25	0	0	25	0	0
19	4961977	.	A	T	10	9	19	0	0	19	0	0
19	4984668	.	T	G	2	2	4	0	0	4	0	0
19	4984739	.	G	A	3	3	6	0	0	6	0	0
19	4998339	.	G	A	1	2	3	0	0	3	0	0
19	4998341	.	C	T	1	2	3	0	0	3	0	0
19	5001119	.	C	T	0	9	9	0	11	20	0	0
19	5003359	.	T	G	4	1	5	0	2	7	0	0
19	5007465	.	G	A	5	4	9	0	1	10	0	0
19	5007549	.	G	A	15	20	35	0	2	37	0	0
19	5009353	.	G	A	4	4	8	0	0	8	0	0
19	5009489	.	G	A	2	2	4	0	0	4	0	0
19	5016257	.	G	C	1	0	1	0	6	7	0	0
19	5019697	.	G	C	7	4	11	0	1	12	0	0
19	5019712	.	A	T	5	4	9	0	0	9	0	0
19	5019736	.	A	G	1	3	4	0	0	4	0	0
19	5022301	.	C	T	6	2	8	0	2	10	0	0
19	5024424	.	G	A	2	0	2	0	1	3	0	0
19	5024436	.	C	T	4	1	5	0	0	5	0	0
19	5024685	.	T	C	0	1	1	0	0	1	0	0
19	5030214	.	G	T	0	1	1	0	0	1	0	0
19	5030274	.	G	A	1	3	4	0	0	4	0	0
19	5077167	.	A	G	1	4	5	0	0	5	0	0
19	5081758	.	T	C	7	6	13	0	1	14	0	0
19	5089900	.	C	G	19	0	19	0	34	53	0	0
19	5090035	.	C	G	22	22	44	0	2	46	0	0
19	5091587	.	G	C	23	30	53	0	3	56	0	0
19	5094389	.	C	T	4	4	8	0	0	8	0	0
19	5094405	.	C	A	0	5	5	0	8	13	0	0
19	5094471	.	T	C	6	9	15	0	1	16	0	0
19	5094504	.	A	G	4	10	14	0	0	14	0	0
19	5094591	.	C	T	9	10	19	0	0	19	0	0
19	5094616	.	C	T	0	12	12	0	11	23	0	0
19	5100191	.	G	A	2	5	7	0	1	8	0	0
19	5149867	.	C	T	6	9	15	0	1	16	0	0
19	5158572	.	G	A	25	27	52	0	4	56	0	0
19	5158657	.	G	A	43	30	73	0	7	80	0	0
19	5158795	.	A	G	27	38	65	0	8	73	0	0
19	5159120	.	C	T	32	31	63	0	3	66	0	0
19	5159399	.	T	A	17	33	50	0	1	51	0	0
19	5160048	.	C	G	26	23	49	0	1	50	0	0
19	5160121	.	T	C	28	0	28	0	17	45	0	0
19	5160133	.	C	A	0	13	13	0	25	38	0	0
19	5160201	.	A	G	17	14	31	0	4	35	0	0
19	5160302	.	T	C	16	0	16	0	14	30	0	0
19	5160310	.	C	T	0	15	15	0	17	32	0	0
19	5160379	.	T	A	26	12	38	0	3	41	0	0
19	5160996	.	A	T	10	12	22	0	1	23	0	0
19	5161750	.	A	G	8	13	21	0	1	22	0	0
19	5162521	.	G	A	4	5	9	0	0	9	0	0
19	5162679	.	A	G	4	7	11	0	0	11	0	0
19	5163409	.	G	A	5	7	12	0	0	12	0	0
19	5163910	.	T	C	4	6	10	0	0	10	0	0
19	5611772	.	G	A	3	5	8	0	2	10	0	0
19	5611856	.	A	T	6	8	14	0	0	14	0	0
19	5615654	.	T	C	1	2	3	0	0	3	0	0
19	5619892	.	G	A	6	5	11	0	1	12	0	0
19	5619926	.	G	A	0	5	5	0	5	10	0	0
19	5620094	.	A	T	9	7	16	0	0	16	0	0
19	5620175	.	T	G	14	5	19	0	0	19	0	0
19	5620208	.	G	T	8	6	14	0	2	16	0	0
19	5620370	.	T	C	7	10	17	0	1	18	0	0
19	5620419	.	G	A	16	8	24	0	2	26	0	0
19	5620459	.	T	C	7	17	24	0	2	26	0	0
19	5620636	.	T	G	14	5	19	0	1	20	0	0
19	5620640	.	G	T	14	5	19	0	0	19	0	0
19	5621165	.	G	A	16	16	32	0	1	33	0	0
19	5621269	.	C	T	7	7	14	0	1	15	0	0
19	5779170	.	C	T	8	5	13	0	2	15	0	0
19	5779271	.	A	G	7	12	19	0	1	20	0	0
19	5779829	.	G	T	9	6	15	0	0	15	0	0
19	5779835	.	C	T	9	6	15	0	0	15	0	0
19	5779897	.	T	C	9	18	27	0	2	29	0	0
19	5780032	.	C	G	0	4	4	0	4	8	0	0
19	5780293	.	A	T	5	9	14	0	0	14	0	0
19	5780312	.	A	T	4	10	14	0	1	15	0	0
19	5780517	.	A	G	3	1	4	0	1	5	0	0
19	5780527	.	G	A	6	2	8	0	0	8	0	0
19	5780585	.	G	T	4	3	7	0	0	7	0	0
19	5780688	.	A	C	4	4	8	0	2	10	0	0
19	5781259	.	A	T	4	4	8	0	1	9	0	0
19	5793484	.	C	G	2	3	5	0	0	5	0	0
19	5801151	.	G	A	0	2	2	0	0	2	0	0
19	6060281	.	T	A	7	6	13	0	1	14	0	0
19	6060309	.	A	T	6	8	14	0	0	15	1	0
19	6060415	.	C	A	0	4	4	0	4	8	0	0
19	6086441	.	C	G	13	22	35	0	5	40	0	0
19	6086577	.	C	T	0	14	14	0	15	29	0	0
19	6087130	.	T	A	6	4	10	0	0	10	0	0
19	6087146	.	C	T	0	5	5	0	8	13	0	0
19	6087186	.	A	T	4	6	10	0	0	10	0	0
19	6087619	.	T	C	3	0	3	0	6	9	0	0
19	6087894	.	G	A	5	4	9	0	0	9	0	0
19	6088000	.	C	T	0	6	6	0	4	10	0	0
19	6088368	.	A	G	2	9	11	0	0	11	0	0
19	6090702	.	T	C	1	3	4	0	1	5	0	0
19	6090732	.	T	A	0	2	2	0	0	2	0	0
19	6094162	.	A	C	1	2	3	0	0	3	0	0
19	6097473	.	C	A	0	4	4	0	0	4	0	0
19	6100295	.	A	G	1	2	3	0	1	4	0	0
19	6102732	.	T	C	0	1	1	0	0	1	0	0
19	6142187	.	C	A	0	4	4	0	9	13	0	0
19	6142669	.	T	A	2	9	11	0	0	11	0	0
19	6142714	.	A	T	4	7	11	0	1	12	0	0
19	6142802	.	G	T	6	4	10	0	2	12	0	0
19	6142803	.	A	G	7	4	11	0	1	12	0	0
19	6143608	.	C	T	0	3	3	0	3	6	0	0
19	6214598	.	G	A	3	3	6	0	0	6	0	0
19	6328442	.	T	C	33	8	41	0	42	83	0	0
19	6328514	.	A	C	48	25	73	0	3	76	0	0
19	6328533	.	A	G	43	32	75	0	8	83	0	0
19	6328830	.	T	G	36	25	61	0	9	70	0	0
19	6328859	.	G	A	25	27	52	0	3	56	1	0
19	6328889	.	C	T	0	30	30	0	24	54	0	0
19	6328906	.	G	A	25	30	55	0	1	56	0	0
19	6328963	.	T	C	30	28	58	0	3	61	0	0
19	6329062	.	A	T	27	20	47	0	2	50	1	0
19	6329381	.	A	T	31	11	42	0	2	44	0	0
19	6329382	.	T	G	33	9	42	0	2	44	0	0
19	6329533	.	C	T	0	28	28	0	28	56	0	0
19	6329813	.	G	A	24	32	56	0	4	60	0	0
19	6330239	.	C	A	0	5	5	0	10	15	0	0
19	6332902	.	C	A	0	2	2	0	4	6	0	0
19	6332947	.	C	T	0	3	3	0	7	10	0	0
19	6332973	.	G	A	2	1	3	0	1	4	0	0
19	6338207	.	A	G	0	2	2	0	0	2	0	0
19	6338261	.	A	G	0	3	3	0	0	3	0	0
19	6342278	.	G	T	2	1	3	0	0	3	0	0
19	6352379	.	A	G	0	1	1	0	0	1	0	0
19	6907716	.	C	T	0	1	1	0	0	1	0	0
19	6907740	.	T	C	0	2	2	0	0	2	0	0
19	6908520	.	T	C	0	1	1	0	0	1	0	0
19	6908566	.	A	G	0	1	1	1	0	2	0	0
19	6908574	.	T	A	0	2	2	1	0	3	0	0
19	6916158	.	C	A	1	2	3	0	0	3	0	0
19	6923050	.	T	A	2	2	4	0	0	4	0	0
19	6923055	.	T	A	2	2	4	0	0	4	0	0
19	6933808	.	G	C	1	3	4	0	0	4	0	0
19	6934166	.	C	T	1	2	3	0	0	3	0	0
19	6955130	.	C	T	4	3	7	0	1	8	0	0
19	6955131	.	C	T	5	3	8	0	0	8	0	0
19	6955198	.	C	A	6	8	14	0	0	14	0	0
19	6955475	.	T	C	2	3	5	0	0	5	0	0
19	6955609	.	C	G	4	4	8	0	0	8	0	0
19	6955620	.	G	A	0	5	5	0	4	9	0	0
19	6955920	.	G	A	5	5	10	0	0	10	0	0
19	6956058	.	T	C	8	11	19	0	0	19	0	0
19	6956060	.	G	A	8	11	19	0	0	19	0	0
19	6956135	.	A	G	13	4	17	0	2	19	0	0
19	6956665	.	C	A	9	7	16	0	1	17	0	0
19	6956728	.	T	A	7	8	15	0	0	15	0	0
19	6956829	.	T	A	3	9	12	0	2	14	0	0
19	6956835	.	C	G	5	8	13	0	2	15	0	0
19	6956881	.	T	C	5	7	12	0	1	13	0	0
19	6956892	.	T	A	5	5	10	0	1	11	0	0
19	6956956	.	A	G	4	5	9	0	0	9	0	0
19	6956959	.	A	G	4	5	9	0	0	9	0	0
19	6957127	.	A	T	20	18	38	0	1	39	0	0
19	6957131	.	C	A	19	17	36	0	2	38	0	0
19	6960653	.	C	A	7	12	19	0	0	19	0	0
19	6961095	.	G	A	6	3	9	0	0	9	0	0
19	6961211	.	T	C	4	4	8	0	0	8	0	0
19	6961421	.	T	A	10	3	13	0	1	14	0	0
19	6961610	.	G	A	1	6	7	0	1	8	0	0
19	6961674	.	A	G	8	5	13	0	0	13	0	0
19	7014863	.	T	G	2	2	4	0	1	5	0	0
19	7014909	.	C	A	2	4	6	0	2	8	0	0
19	7014912	.	G	A	2	3	5	0	2	7	0	0
19	7022107	.	G	A	1	2	3	0	0	3	0	0
19	7022128	.	G	A	1	2	3	0	0	3	0	0
19	7100564	.	A	T	4	4	8	0	0	8	0	0
19	7131154	.	G	C	0	1	1	0	1	2	0	0
19	7152971	.	G	T	0	3	3	0	1	4	0	0
19	7152974	.	G	A	1	3	4	0	0	4	0	0
19	7154729	.	A	G	10	12	22	0	3	25	0	0
19	7154770	.	A	C	8	12	20	0	2	22	0	0
19	7155001	.	A	T	7	17	24	0	2	26	0	0
19	7155034	.	A	G	9	17	26	0	2	28	0	0
19	7155065	.	T	C	9	17	26	0	1	27	0	0
19	7158469	.	C	T	2	3	5	0	0	5	0	0
19	7163872	.	C	T	4	4	8	0	0	8	0	0
19	7163908	.	A	G	4	6	10	0	1	11	0	0
19	7164022	.	G	A	0	2	2	0	0	2	0	0
19	7166211	.	C	T	4	2	6	0	0	6	0	0
19	7166454	.	C	A	0	2	2	0	1	3	0	0
19	7169204	.	A	C	4	3	7	0	0	7	0	0
19	7169228	.	C	T	6	5	11	0	1	12	0	0
19	7169304	.	G	A	7	3	10	0	1	11	0	0
19	7169770	.	A	C	7	7	14	0	1	15	0	0
19	7169809	.	C	T	9	8	17	0	1	18	0	0
19	7169880	.	T	C	5	9	14	0	1	15	0	0
19	7169886	.	G	A	6	8	14	0	0	14	0	0
19	7169929	.	G	A	8	6	14	0	1	15	0	0
19	7170014	.	A	C	8	5	13	0	0	13	0	0
19	7170015	.	T	C	8	5	13	0	0	13	0	0
19	7170128	.	A	G	6	5	11	0	1	12	0	0
19	7170228	.	A	T	4	6	10	0	0	10	0	0
19	7174417	.	C	A	0	2	2	0	0	2	0	0
19	7174669	.	T	C	3	1	4	0	0	4	0	0
19	7179606	.	G	A	5	1	6	0	0	6	0	0
19	7179612	.	G	A	5	1	6	0	0	6	0	0
19	7276063	.	A	T	1	5	6	0	0	7	1	0
19	7276106	.	G	A	12	18	30	0	2	32	0	0
19	7276149	.	A	G	21	27	48	0	2	50	0	0
19	7276194	.	T	A	29	26	55	0	2	57	0	0
19	7276559	.	G	A	30	26	56	0	3	59	0	0
19	7276610	.	G	A	24	20	44	0	2	46	0	0
19	7279235	.	A	G	15	9	24	0	2	26	0	0
19	7279721	.	A	G	3	2	5	0	1	6	0	0
19	7282541	.	C	T	2	5	7	0	0	7	0	0
19	7282554	.	G	A	7	7	14	0	0	14	0	0
19	7283427	.	C	A	10	4	14	0	1	15	0	0
19	7284840	.	C	T	0	2	2	0	5	7	0	0
19	7286301	.	A	G	4	1	5	0	1	6	0	0
19	7286355	.	A	G	8	5	13	0	1	14	0	0
19	7286421	.	T	A	3	1	4	0	0	4	0	0
19	7286742	.	A	G	3	2	5	0	0	5	0	0
19	7287600	.	T	C	4	3	7	0	0	7	0	0
19	7287603	.	G	A	4	2	6	0	0	6	0	0
19	7288195	.	A	G	1	2	3	0	0	3	0	0
19	7290214	.	A	G	4	2	6	0	0	6	0	0
19	7295279	.	G	A	2	4	6	0	0	6	0	0
19	7295843	.	T	A	1	3	4	0	1	5	0	0
19	7309154	.	G	A	10	18	28	0	2	30	0	0
19	7309391	.	C	A	24	22	46	0	3	49	0	0
19	7309522	.	G	C	27	12	39	0	3	42	0	0
19	7309556	.	T	A	17	9	26	0	0	26	0	0
19	7309557	.	T	A	17	9	26	0	0	26	0	0
19	7309754	.	T	G	11	8	19	0	1	20	0	0
19	7309929	.	A	T	19	13	32	0	0	32	0	0
19	7309968	.	G	T	15	7	22	0	1	23	0	0
19	7310117	.	T	C	8	0	8	0	13	21	0	0
19	7310131	.	C	T	9	11	20	0	1	21	0	0
19	7310154	.	A	T	7	10	17	0	0	17	0	0
19	7311678	.	T	G	2	0	2	0	0	2	0	0
19	7313933	.	C	G	4	3	7	0	0	7	0	0
19	7327462	.	A	G	1	2	3	0	0	3	0	0
19	7327519	.	C	T	2	5	7	0	0	7	0	0
19	7327564	.	G	T	1	1	2	0	0	2	0	0
19	7327570	.	T	C	1	1	2	0	0	2	0	0
19	7338402	.	C	T	0	3	3	0	2	5	0	0
19	7338425	.	T	C	3	4	7	0	0	7	0	0
19	7338978	.	T	C	1	0	1	0	3	4	0	0
19	7339008	.	T	G	1	2	3	0	0	3	0	0
19	7341300	.	G	A	1	1	2	0	2	4	0	0
19	7412062	.	T	C	0	1	1	0	0	1	0	0
19	7412320	.	C	T	7	11	18	0	0	18	0	0
19	7412358	.	A	T	5	11	16	0	0	16	0	0
19	7412490	.	T	C	5	3	8	0	1	9	0	0
19	7426967	.	T	C	7	4	11	0	0	11	0	0
19	7427099	.	C	A	0	1	1	0	0	1	0	0
19	7430160	.	T	C	15	8	23	0	1	24	0	0
19	7430607	.	G	A	0	11	11	0	13	24	0	0
19	7430652	.	C	T	7	13	20	0	2	22	0	0
19	7430700	.	A	G	8	0	8	0	10	18	0	0
19	7430715	.	C	A	8	7	15	0	2	17	0	0
19	7432922	.	G	A	3	2	5	0	0	5	0	0
19	7433454	.	G	A	2	2	4	0	0	4	0	0
19	7433598	.	C	T	1	2	3	0	0	3	0	0
19	7433601	.	T	C	1	2	3	0	0	3	0	0
19	7433637	.	C	A	1	2	3	0	0	3	0	0
19	7433689	.	G	A	3	2	5	0	0	5	0	0
19	7433746	.	A	C	3	2	5	0	0	5	0	0
19	7434161	.	G	T	1	2	3	0	0	3	0	0
19	7434813	.	G	A	1	3	4	0	0	4	0	0
19	7434866	.	C	T	3	2	5	0	0	5	0	0
19	7445676	.	G	A	7	5	12	0	3	15	0	0
19	7445897	.	C	T	21	32	53	0	5	58	0	0
19	7446050	.	T	C	21	22	43	0	4	47	0	0
19	7446137	.	G	T	16	24	40	0	4	45	1	0
19	7446286	.	G	T	19	22	41	0	1	42	0	0
19	7446495	.	G	T	18	26	44	0	14	58	0	0
19	7446621	.	C	A	21	32	53	0	0	53	0	0
19	7446702	.	T	C	1	0	1	0	1	2	0	0
19	7450572	.	G	A	9	16	25	0	1	26	0	0
19	7450658	.	T	C	6	10	16	0	1	17	0	0
19	7456364	.	T	C	0	4	4	0	0	4	0	0
19	7456371	.	A	C	0	3	3	0	0	3	0	0
19	7456722	.	C	G	1	2	3	0	0	3	0	0
19	7456793	.	A	G	0	6	6	0	0	6	0	0
19	7468580	.	C	T	1	9	10	0	0	10	0	0
19	7474242	.	T	C	1	6	7	0	0	7	0	0
19	7474245	.	T	G	1	0	1	0	4	5	0	0
19	7478159	.	A	G	9	15	24	0	2	26	0	0
19	7478283	.	C	T	4	11	15	0	1	17	1	0
19	7478356	.	G	A	11	11	22	0	0	22	0	0
19	7482931	.	C	T	1	5	6	0	0	6	0	0
19	7483059	.	A	T	1	4	5	0	0	5	0	0
19	7495867	.	A	T	2	2	4	0	2	6	0	0
19	7498046	.	T	C	7	6	13	0	0	13	0	0
19	7498079	.	A	G	10	6	16	0	3	19	0	0
19	7498103	.	A	G	9	7	16	0	1	17	0	0
19	7505591	.	A	G	4	7	11	0	1	12	0	0
19	7506097	.	T	C	3	2	5	0	2	7	0	0
19	7507833	.	A	T	2	5	7	0	0	7	0	0
19	7512406	.	C	G	3	2	5	0	0	5	0	0
19	7513085	.	C	T	2	3	5	0	0	5	0	0
19	7513406	.	A	T	3	4	7	0	0	7	0	0
19	7513631	.	A	G	1	2	3	0	1	4	0	0
19	7514512	.	T	C	2	4	6	0	0	6	0	0
19	7514538	.	C	G	2	2	4	0	0	4	0	0
19	7514693	.	A	G	6	2	8	0	0	8	0	0
19	7515423	.	A	G	7	8	15	0	1	16	0	0
19	7515787	.	A	T	8	4	12	0	1	13	0	0
19	7515829	.	C	T	11	5	16	0	0	16	0	0
19	7515845	.	A	T	8	8	16	0	2	18	0	0
19	7516035	.	A	G	15	15	30	0	0	30	0	0
19	7516063	.	A	C	20	12	32	0	2	34	0	0
19	7516169	.	C	A	16	14	30	0	1	31	0	0
19	7516183	.	T	G	11	12	23	0	1	24	0	0
19	7557538	.	T	C	1	2	3	0	1	4	0	0
19	7557619	.	A	T	2	3	5	0	1	6	0	0
19	7557793	.	G	C	4	2	6	0	1	7	0	0
19	7565142	.	G	A	4	6	10	0	2	12	0	0
19	7565244	.	A	G	8	9	17	0	2	19	0	0
19	7566488	.	A	T	4	3	7	0	2	9	0	0
19	7567021	.	T	A	12	20	32	0	1	33	0	0
19	7567196	.	A	C	4	3	7	0	0	7	0	0
19	7590501	.	T	C	2	2	4	0	0	4	0	0
19	7590506	.	G	A	2	2	4	0	0	4	0	0
19	7590773	.	A	T	1	2	3	0	0	3	0	0
19	7631700	.	G	A	0	3	3	0	5	8	0	0
19	7631784	.	A	G	5	4	9	0	0	9	0	0
19	7631829	.	C	A	4	4	8	0	0	8	0	0
19	7631860	.	T	C	7	4	11	0	0	11	0	0
19	7632056	.	C	T	0	2	2	0	1	3	0	0
19	7632216	.	C	T	7	3	10	0	2	12	0	0
19	7632348	.	G	A	0	8	8	0	11	19	0	0
19	7632470	.	C	T	3	7	10	0	1	11	0	0
19	7632526	.	T	C	8	7	15	0	0	15	0	0
19	7632837	.	C	T	15	7	22	0	2	24	0	0
19	7779165	.	T	C	1	5	6	0	2	8	0	0
19	7779167	.	A	G	1	4	5	0	3	8	0	0
19	7784681	.	T	A	3	0	3	0	0	3	0	0
19	7784684	.	T	A	3	0	3	0	0	3	0	0
19	7794887	.	C	T	9	12	21	0	2	23	0	0
19	7796398	.	C	T	12	10	22	0	4	26	0	0
19	7796842	.	C	A	3	15	18	0	3	22	1	0
19	7796888	.	G	A	13	7	20	0	2	22	0	0
19	7796986	.	A	T	17	3	20	0	3	23	0	0
19	7797259	.	T	A	17	14	31	0	0	31	0	0
19	7797534	.	C	T	17	23	40	0	3	43	0	0
19	7797651	.	G	T	1	8	9	0	0	9	0	0
19	7797805	.	G	A	0	2	2	0	4	6	0	0
19	7802873	.	G	A	1	0	1	0	0	1	0	0
19	7803424	.	C	A	6	2	8	0	0	8	0	0
19	7803459	.	C	T	2	3	5	0	0	5	0	0
19	7803460	.	G	T	3	2	5	0	0	5	0	0
19	7803685	.	C	A	6	8	14	0	0	14	0	0
19	7804785	.	A	C	3	1	4	0	0	4	0	0
19	7819991	.	G	A	14	3	17	0	3	20	0	0
19	7820040	.	T	C	4	11	15	0	2	17	0	0
19	7820079	.	T	A	3	11	14	0	1	15	0	0
19	7820107	.	G	A	2	7	9	0	0	9	0	0
19	7820665	.	T	A	11	12	23	0	3	26	0	0
19	7820980	.	C	T	6	5	11	0	0	11	0	0
19	7823306	.	G	A	1	1	2	0	0	2	0	0
19	7828576	.	G	A	1	2	3	0	0	3	0	0
19	7837810	.	T	C	1	2	3	0	0	3	0	0
19	7837811	.	A	T	1	2	3	0	0	3	0	0
19	7837859	.	G	T	1	2	3	0	0	3	0	0
19	8144609	.	G	A	1	4	5	0	0	5	0	0
19	8336642	.	C	T	6	6	12	0	1	13	0	0
19	8336689	.	G	A	2	4	6	0	1	7	0	0
19	8338559	.	A	G	4	4	8	0	0	8	0	0
19	8338616	.	T	A	3	11	14	0	0	14	0	0
19	8338649	.	T	A	3	11	14	0	0	14	0	0
19	8338711	.	C	G	3	4	7	0	0	7	0	0
19	8339202	.	T	A	17	10	27	0	0	27	0	0
19	8501019	.	G	A	0	2	2	0	1	3	0	0
19	8501490	.	G	T	4	3	7	0	2	9	0	0
19	8501961	.	G	A	0	2	2	0	1	3	0	0
19	8501962	.	G	A	0	3	3	0	0	3	0	0
19	8502104	.	C	G	5	4	9	0	0	9	0	0
19	8502133	.	C	T	8	4	12	0	0	12	0	0
19	8502166	.	G	T	1	10	11	0	9	20	0	0
19	8502225	.	T	A	9	5	14	0	0	14	0	0
19	8502244	.	G	A	8	4	12	0	0	12	0	0
19	8534126	.	G	C	7	6	13	0	0	13	0	0
19	8582763	.	T	C	0	4	4	0	0	4	0	0
19	8583065	.	A	G	2	4	6	0	3	9	0	0
19	8583170	.	G	T	3	2	5	0	0	5	0	0
19	8747688	.	G	A	18	20	38	0	4	42	0	0
19	8817006	.	T	A	2	2	4	0	0	4	0	0
19	8817074	.	G	T	2	3	5	0	2	7	0	0
19	8817121	.	C	A	6	8	14	0	1	15	0	0
19	8817608	.	G	A	17	24	41	0	2	43	0	0
19	8831895	.	T	C	3	0	3	0	2	5	0	0
19	8831907	.	C	T	0	1	1	0	1	2	0	0
19	8834529	.	A	G	5	4	9	0	0	9	0	0
19	8834583	.	T	C	8	4	12	0	1	13	0	0
19	8836805	.	C	T	1	0	1	0	1	2	0	0
19	8880614	.	C	G	0	2	2	0	0	2	0	0
19	8894119	.	T	A	8	9	17	0	1	18	0	0
19	8894138	.	A	G	5	9	14	0	1	15	0	0
19	8928718	.	G	A	6	6	12	0	1	13	0	0
19	8928767	.	G	C	10	10	20	0	1	21	0	0
19	8929860	.	T	C	2	3	5	0	1	6	0	0
19	8939917	.	C	T	1	2	3	0	0	3	0	0
19	8958797	.	C	T	8	7	15	0	0	15	0	0
19	8958892	.	A	G	15	12	27	0	2	29	0	0
19	8962835	.	C	T	6	3	9	0	0	9	0	0
19	8989992	.	G	A	0	1	1	0	1	2	0	0
19	8997629	.	G	A	3	0	3	0	0	3	0	0
19	8997903	.	C	T	2	1	3	0	0	3	0	0
19	9000665	.	C	T	9	24	33	0	2	35	0	0
19	9000674	.	T	C	13	20	33	0	2	35	0	0
19	9000907	.	A	G	7	0	7	0	21	28	0	0
19	9001058	.	C	T	15	15	30	0	2	32	0	0
19	9001100	.	C	T	14	12	26	0	1	27	0	0
19	9001151	.	C	T	12	13	25	0	5	30	0	0
19	9001246	.	C	T	12	14	26	0	1	27	0	0
19	9001315	.	C	T	16	9	25	0	1	26	0	0
19	9001317	.	G	A	9	17	26	0	0	26	0	0
19	9048614	.	C	T	1	0	1	0	0	1	0	0
19	9050305	.	G	A	3	4	7	0	0	7	0	0
19	9050319	.	C	T	3	3	6	0	2	8	0	0
19	9050737	.	G	C	1	2	3	0	0	3	0	0
19	9050745	.	A	G	1	1	2	0	1	3	0	0
19	9055793	.	C	T	1	3	4	0	0	4	0	0
19	9062125	.	G	T	0	1	1	0	2	3	0	0
19	9064759	.	T	C	1	2	3	0	0	3	0	0
19	9064777	.	C	A	1	3	4	0	0	4	0	0
19	9067211	.	G	A	5	1	6	0	0	6	0	0
19	9070546	.	T	G	1	0	1	0	6	7	0	0
19	9077465	.	C	T	2	5	7	0	0	7	0	0
19	9084688	.	T	C	10	6	16	0	2	18	0	0
19	9085359	.	A	T	16	3	19	0	1	20	0	0
19	9085423	.	G	A	7	11	18	0	2	20	0	0
19	9085757	.	A	C	10	18	28	0	0	28	0	0
19	9086084	.	T	A	16	14	30	0	0	30	0	0
19	9086132	.	C	A	17	20	37	0	0	37	0	0
19	9086416	.	T	A	2	2	4	0	1	5	0	0
19	9086429	.	G	T	3	7	10	0	1	11	0	0
19	9135053	.	C	T	1	2	3	0	0	3	0	0
19	9135754	.	A	T	5	5	10	0	0	10	0	0
19	9138850	.	C	A	0	3	3	0	0	3	0	0
19	9140507	.	A	G	3	1	4	0	0	4	0	0
19	9140618	.	C	T	2	2	4	0	0	4	0	0
19	9140675	.	A	T	10	15	25	0	1	27	1	0
19	9144234	.	C	T	7	3	10	0	1	11	0	0
19	9161595	.	G	A	4	6	10	0	1	11	0	0
19	9161621	.	C	T	3	4	7	0	2	9	0	0
19	9161631	.	T	G	3	3	6	0	0	6	0	0
19	9161824	.	T	C	12	11	23	0	0	23	0	0
19	9161830	.	C	T	9	9	18	0	2	20	0	0
19	9166374	.	G	A	1	5	6	0	0	6	0	0
19	9168513	.	C	T	21	22	43	0	0	43	0	0
19	9168622	.	C	T	12	19	31	0	4	35	0	0
19	9168947	.	G	T	1	23	24	0	22	46	0	0
19	9169099	.	G	A	14	20	34	0	0	34	0	0
19	9169162	.	G	C	5	9	14	0	2	16	0	0
19	9216201	.	T	A	3	1	4	0	1	5	0	0
19	9216221	.	A	C	3	1	4	0	0	4	0	0
19	9216367	.	G	A	1	0	1	0	0	1	0	0
19	9217143	.	C	T	7	5	12	0	0	12	0	0
19	9220813	.	C	T	1	5	6	0	0	6	0	0
19	9220828	.	C	T	1	5	6	0	0	7	1	0
19	9220939	.	T	C	2	5	7	0	0	7	0	0
19	9223369	.	T	C	16	8	24	0	0	24	0	0
19	9225585	.	G	A	3	6	9	0	1	10	0	0
19	9228196	.	T	G	24	17	41	0	2	43	0	0
19	9228378	.	A	G	15	1	16	0	11	27	0	0
19	9228380	.	C	T	15	11	26	0	1	27	0	0
19	9228428	.	G	T	14	1	15	0	5	20	0	0
19	9268433	.	C	T	1	1	2	0	0	2	0	0
19	9268619	.	C	A	2	1	3	0	0	3	0	0
19	9273768	.	T	A	2	5	7	0	2	9	0	0
19	9274248	.	T	A	3	6	9	0	0	9	0	0
19	9274500	.	T	C	1	3	4	0	2	6	0	0
19	9274574	.	C	T	6	2	8	0	0	8	0	0
19	9274705	.	C	T	4	7	11	0	0	11	0	0
19	9274844	.	A	C	7	7	14	0	0	14	0	0
19	9458166	.	A	G	5	0	5	0	4	9	0	0
19	9458181	.	A	C	5	3	8	0	0	8	0	0
19	9458328	.	T	C	5	2	7	0	0	7	0	0
19	9458421	.	G	A	1	2	3	0	1	4	0	0
19	9458463	.	C	T	7	2	9	0	0	9	0	0
19	9459325	.	T	A	17	15	32	0	2	34	0	0
19	9459330	.	C	T	18	8	26	0	3	29	0	0
19	9459597	.	G	A	0	13	13	0	23	36	0	0
19	9459673	.	G	A	0	12	12	0	28	40	0	0
19	9459820	.	T	C	13	12	25	0	1	26	0	0
19	9460128	.	A	C	21	11	32	0	4	36	0	0
19	9460196	.	A	G	19	16	35	0	3	38	0	0
19	9460499	.	A	G	29	17	46	0	6	52	0	0
19	9460531	.	G	T	27	29	56	0	3	59	0	0
19	9461072	.	A	G	34	13	47	0	0	47	0	0
19	9461141	.	T	G	17	22	39	0	1	40	0	0
19	9461376	.	A	G	12	20	32	0	2	34	0	0
19	9461841	.	A	G	21	14	35	0	0	35	0	0
19	9462810	.	T	A	0	0	0	0	1	1	0	0
19	9462822	.	T	G	0	0	0	0	1	1	0	0
19	9471066	.	G	A	13	17	30	0	4	34	0	0
19	9472865	.	G	A	8	5	13	0	0	13	0	0
19	9503356	.	T	G	1	2	3	0	0	3	0	0
19	9513443	.	T	C	7	11	18	0	0	18	0	0
19	9513572	.	A	C	8	6	14	0	1	15	0	0
19	9513863	.	A	C	6	6	12	0	1	13	0	0
19	9513869	.	A	C	9	4	13	0	1	14	0	0
19	9516869	.	A	G	2	3	5	0	0	5	0	0
19	9598119	.	C	A	2	0	2	0	0	2	0	0
19	9603160	.	G	A	0	5	5	0	5	10	0	0
19	9603233	.	G	T	0	4	4	0	5	9	0	0
19	9603425	.	C	T	7	6	13	0	0	13	0	0
19	9603432	.	T	A	7	7	14	0	0	14	0	0
19	9685506	.	A	G	10	12	22	0	3	25	0	0
19	9685695	.	A	G	22	21	43	0	0	43	0	0
19	9686123	.	G	T	10	6	16	0	1	17	0	0
19	9686128	.	A	G	13	5	18	0	1	19	0	0
19	9686160	.	T	C	9	6	15	0	3	18	0	0
19	9686163	.	C	A	10	9	19	0	1	20	0	0
19	9686421	.	G	T	6	9	15	0	0	15	0	0
19	9686515	.	T	A	10	3	13	0	1	14	0	0
19	9686519	.	G	A	10	4	14	0	0	14	0	0
19	9686615	.	T	C	4	9	13	0	1	14	0	0
19	9686627	.	T	C	4	10	14	0	1	15	0	0
19	9686678	.	T	A	4	9	13	0	0	13	0	0
19	9687146	.	T	C	11	4	15	0	0	15	0	0
19	9687206	.	T	A	8	3	11	0	0	11	0	0
19	9687306	.	G	A	10	3	13	0	2	15	0	0
19	9813781	.	C	A	0	5	5	0	7	12	0	0
19	9813905	.	A	G	7	9	16	0	1	17	0	0
19	9813942	.	A	G	7	13	20	0	2	22	0	0
19	9813989	.	T	A	8	10	18	0	0	18	0	0
19	9813990	.	T	A	6	10	16	0	2	18	0	0
19	9814291	.	C	T	0	20	20	0	22	42	0	0
19	9814336	.	T	C	25	13	38	0	4	42	0	0
19	9814423	.	A	G	16	23	39	0	1	40	0	0
19	9814444	.	G	A	15	22	37	0	3	40	0	0
19	9814504	.	G	A	15	18	33	0	2	35	0	0
19	9814516	.	A	G	15	16	31	0	2	33	0	0
19	9814549	.	T	C	16	16	32	0	2	34	0	0
19	9814611	.	A	G	7	4	11	0	0	11	0	0
19	9814621	.	C	T	0	4	4	0	6	10	0	0
19	9822566	.	G	C	5	2	7	0	0	7	0	0
19	9822610	.	G	A	3	6	9	0	1	10	0	0
19	9840924	.	C	T	2	6	8	0	0	8	0	0
19	9841006	.	A	G	8	6	14	0	1	15	0	0
19	9841035	.	G	A	5	5	10	0	0	10	0	0
19	9841203	.	A	T	6	4	10	0	0	10	0	0
19	9841450	.	C	G	5	5	10	0	1	11	0	0
19	9841523	.	G	A	1	4	5	0	0	5	0	0
19	9842252	.	T	C	2	5	7	0	1	8	0	0
19	9910842	.	G	A	9	13	22	0	3	25	0	0
19	9911264	.	A	G	1	3	4	0	0	4	0	0
19	9911566	.	T	A	2	4	6	0	1	7	0	0
19	9911587	.	T	G	2	2	4	0	0	4	0	0
19	9911904	.	A	T	3	2	5	0	1	6	0	0
19	9911948	.	G	A	2	2	4	0	0	4	0	0
19	9911955	.	T	A	2	2	4	0	0	4	0	0
19	9912113	.	A	C	1	8	9	0	0	9	0	0
19	9912117	.	C	T	1	5	6	0	3	9	0	0
19	9912663	.	G	C	1	0	1	0	4	5	0	0
19	9912665	.	G	T	2	3	5	0	0	5	0	0
19	9916197	.	C	T	2	2	4	0	0	4	0	0
19	9916630	.	G	T	3	2	5	0	0	5	0	0
19	10177382	.	C	A	5	4	9	0	0	9	0	0
19	10177951	.	A	G	5	3	8	0	0	8	0	0
19	10201566	.	T	G	7	17	24	0	1	25	0	0
19	10201719	.	A	G	12	18	30	0	0	30	0	0
19	10202598	.	T	C	3	0	3	0	10	13	0	0
19	10203420	.	T	C	2	6	8	0	0	8	0	0
19	10203480	.	C	T	0	3	3	0	4	7	0	0
19	10203936	.	T	G	1	2	3	0	1	4	0	0
19	10218136	.	T	A	13	14	27	0	1	28	0	0
19	10218807	.	C	T	2	2	4	0	8	12	0	0
19	10219051	.	T	A	6	6	12	0	0	12	0	0
19	10219186	.	C	A	7	10	17	0	1	19	1	0
19	10219209	.	T	G	6	6	12	0	1	13	0	0
19	10219387	.	T	C	7	11	18	0	1	19	0	0
19	10220013	.	G	A	8	5	13	0	2	15	0	0
19	10220283	.	T	G	8	5	13	0	1	14	0	0
19	10236569	.	T	C	1	2	3	0	0	3	0	0
19	10237446	.	A	T	1	3	4	0	0	4	0	0
19	10252413	.	T	C	15	14	29	0	1	30	0	0
19	10252679	.	A	T	2	5	7	0	0	7	0	0
19	10252803	.	T	C	3	6	9	0	0	9	0	0
19	10253058	.	A	T	3	5	8	0	1	9	0	0
19	10253087	.	T	G	2	7	9	0	0	9	0	0
19	10253140	.	A	T	5	4	9	0	0	9	0	0
19	10253160	.	G	A	4	3	7	0	1	8	0	0
19	10253516	.	T	A	1	2	3	0	1	4	0	0
19	10253517	.	C	A	2	2	4	0	0	4	0	0
19	10253915	.	T	C	2	2	4	0	0	4	0	0
19	10254772	.	C	T	1	2	3	0	0	3	0	0
19	10299174	.	A	C	9	9	18	1	1	20	0	0
19	10299383	.	G	A	19	10	29	0	4	33	0	0
19	10299579	.	C	A	8	10	18	0	0	18	0	0
19	10299593	.	A	G	6	5	11	0	1	12	0	0
19	10299706	.	C	T	0	16	16	0	11	27	0	0
19	10301236	.	T	C	4	5	9	0	0	9	0	0
19	10352067	.	G	A	3	2	5	0	1	6	0	0
19	10352070	.	G	A	1	4	5	0	1	6	0	0
19	10376610	.	A	C	15	4	19	0	2	21	0	0
19	10377097	.	C	T	13	16	29	0	0	29	0	0
19	10377534	.	G	T	5	3	8	0	0	8	0	0
19	10377633	.	A	G	5	16	21	0	3	24	0	0
19	10377777	.	T	C	18	10	28	0	0	28	0	0
19	10377815	.	A	C	7	18	25	0	0	25	0	0
19	10377892	.	A	C	10	10	20	0	2	22	0	0
19	10377911	.	A	T	10	9	19	0	1	20	0	0
19	10378192	.	G	A	10	17	27	0	1	28	0	0
19	10378457	.	A	T	6	3	9	0	2	11	0	0
19	10378544	.	C	T	13	6	19	0	1	20	0	0
19	10378599	.	T	C	7	3	10	0	1	11	0	0
19	10378618	.	C	T	3	5	8	0	0	8	0	0
19	10378682	.	C	A	0	3	3	0	0	3	0	0
19	10378700	.	A	G	2	6	8	0	0	8	0	0
19	10378848	.	C	T	4	8	12	0	0	12	0	0
19	10378889	.	C	T	9	4	13	0	0	13	0	0
19	10378959	.	C	A	6	8	14	0	0	14	0	0
19	10379011	.	T	C	5	3	8	0	0	8	0	0
19	10379183	.	C	A	3	2	5	0	2	7	0	0
19	10379192	.	C	T	5	5	10	0	0	10	0	0
19	10379314	.	C	T	0	4	4	0	4	8	0	0
19	10379321	.	C	T	4	3	7	0	1	8	0	0
19	10379369	.	C	T	3	6	9	0	0	9	0	0
19	10379475	.	A	G	9	3	12	0	0	12	0	0
19	10379555	.	T	G	4	3	7	0	1	8	0	0
19	10379821	.	T	A	7	9	16	0	1	17	0	0
19	10379833	.	T	G	7	9	16	0	0	16	0	0
19	10379873	.	A	G	3	7	10	0	0	10	0	0
19	10379965	.	T	C	4	2	6	0	0	6	0	0
19	10386619	.	C	T	2	2	4	0	0	4	0	0
19	10407312	.	C	T	5	7	12	0	0	12	0	0
19	10407546	.	A	T	24	28	52	0	5	57	0	0
19	10407732	.	T	A	21	35	56	0	5	61	0	0
19	10407767	.	G	T	19	38	57	0	0	57	0	0
19	10565385	.	C	T	1	0	1	0	0	1	0	0
19	10575315	.	T	C	5	4	9	0	0	9	0	0
19	10575318	.	G	T	5	4	9	0	0	9	0	0
19	10575824	.	T	G	4	4	8	0	1	9	0	0
19	10576482	.	C	T	3	7	10	0	1	11	0	0
19	10576520	.	T	C	3	5	8	0	0	8	0	0
19	10576909	.	G	A	11	5	16	0	2	18	0	0
19	10576970	.	A	T	15	8	23	0	0	23	0	0
19	10577194	.	T	A	9	11	20	0	0	20	0	0
19	10577253	.	T	A	5	11	16	0	0	16	0	0
19	10649711	.	T	A	3	4	7	0	1	8	0	0
19	10649722	.	T	C	3	7	10	0	0	10	0	0
19	10649830	.	G	T	6	3	9	0	1	10	0	0
19	10653644	.	C	T	2	2	4	0	0	4	0	0
19	10841477	.	G	T	6	10	16	0	2	18	0	0
19	10870361	.	C	T	4	5	9	0	2	11	0	0
19	10870602	.	G	A	1	3	4	0	0	4	0	0
19	10870677	.	A	G	0	0	0	0	4	4	0	0
19	10870845	.	C	T	5	3	8	0	0	8	0	0
19	10871235	.	G	A	3	4	7	0	0	7	0	0
19	10871259	.	A	T	2	3	5	0	0	5	0	0
19	10871719	.	A	G	6	6	12	0	1	13	0	0
19	10871803	.	C	T	0	9	9	0	19	28	0	0
19	10871823	.	A	G	19	7	26	0	3	29	0	0
19	10872397	.	C	T	5	2	7	0	1	8	0	0
19	10875854	.	A	G	13	7	20	0	1	21	0	0
19	10876446	.	C	T	2	1	3	0	1	4	0	0
19	10987674	.	A	C	0	1	1	0	2	3	0	0
19	10987679	.	T	A	1	2	3	0	0	3	0	0
19	10987940	.	G	A	1	2	3	0	0	3	0	0
19	10987959	.	A	T	1	2	3	0	0	3	0	0
19	10989189	.	A	C	7	9	16	0	0	16	0	0
19	10989343	.	T	A	10	14	24	0	5	29	0	0
19	10989457	.	T	C	11	8	19	0	2	21	0	0
19	10989511	.	A	G	9	4	13	0	1	14	0	0
19	10989653	.	C	A	7	11	18	0	2	20	0	0
19	10997042	.	C	T	4	0	4	0	0	4	0	0
19	11014636	.	G	A	3	3	6	0	0	6	0	0
19	11014675	.	A	G	1	4	5	0	0	5	0	0
19	11039530	.	G	T	1	3	4	0	0	4	0	0
19	11039829	.	G	C	9	12	21	0	0	21	0	0
19	11040493	.	A	T	7	11	18	0	1	19	0	0
19	11045254	.	G	A	1	0	1	0	0	1	0	0
19	11045311	.	C	A	0	6	6	0	7	13	0	0
19	11045323	.	C	T	5	6	11	0	2	13	0	0
19	11048822	.	C	T	0	2	2	0	2	4	0	0
19	11231386	.	C	A	9	11	20	0	1	21	0	0
19	11237043	.	A	G	1	2	3	0	1	4	0	0
19	11237049	.	T	C	1	4	5	0	0	5	0	0
19	12937792	.	T	C	6	3	9	0	0	9	0	0
19	13151155	.	A	G	1	0	1	0	8	9	0	0
19	13397169	.	A	T	9	2	11	0	1	12	0	0
19	17515297	.	T	A	2	4	6	0	2	8	0	0
19	17515753	.	T	A	7	3	10	0	1	11	0	0
19	19338837	.	A	G	1	0	1	0	0	1	0	0
19	20404494	.	C	A	11	4	15	0	1	16	0	0
19	21413001	.	G	T	9	3	12	0	0	12	0	0
19	21825896	.	T	C	1	1	2	0	0	2	0	0
19	21825921	.	A	C	0	8	8	0	1	9	0	0
19	25156242	.	T	A	10	3	13	0	1	14	0	0
19	26235150	.	A	T	4	2	6	0	1	7	0	0
19	26810623	.	T	C	1	2	3	0	0	3	0	0
19	27357352	.	G	T	10	2	12	0	2	14	0	0
19	29296514	.	T	A	1	2	3	0	0	3	0	0
19	31560775	.	G	A	16	10	26	0	1	27	0	0
19	31569338	.	A	G	1	3	4	0	0	4	0	0
19	31569535	.	C	T	1	2	3	0	1	4	0	0
19	31571563	.	T	C	1	1	2	0	0	2	0	0
19	31571572	.	G	A	1	1	2	0	0	2	0	0
19	31579783	.	T	A	22	16	38	0	1	40	1	0
19	31579860	.	G	T	22	20	42	0	2	44	0	0
19	31580071	.	C	A	0	17	17	0	17	34	0	0
19	31580103	.	A	T	15	20	35	0	4	39	0	0
19	31580160	.	T	A	20	17	37	0	3	40	0	0
19	31580186	.	T	G	13	19	32	0	1	33	0	0
19	31580328	.	A	C	18	2	20	0	28	48	0	0
19	31583137	.	A	G	1	5	6	0	0	6	0	0
19	31584018	.	T	G	5	3	8	0	1	9	0	0
19	31590512	.	T	C	2	2	4	0	0	4	0	0
19	31593594	.	C	A	2	3	5	0	0	5	0	0
19	31593595	.	C	A	2	3	5	0	0	5	0	0
19	31771335	.	T	A	9	9	18	0	0	18	0	0
19	31789666	.	C	T	15	15	30	0	8	38	0	0
19	31790042	.	C	A	24	11	35	0	8	43	0	0
19	31790079	.	A	G	37	15	52	0	1	53	0	0
19	31790097	.	C	T	34	14	48	0	3	51	0	0
19	31790115	.	C	A	11	34	45	0	1	46	0	0
19	31790283	.	G	C	44	26	70	0	3	73	0	0
19	31790385	.	A	G	20	25	45	0	6	51	0	0
19	31797778	.	G	A	8	3	11	0	0	11	0	0
19	31797834	.	G	T	5	7	12	0	1	13	0	0
19	31798203	.	C	G	1	3	4	0	0	4	0	0
19	31798660	.	G	A	3	4	7	0	0	7	0	0
19	31798713	.	A	T	2	3	5	0	0	5	0	0
19	31798722	.	C	A	0	1	1	0	2	3	0	0
19	31882114	.	G	A	1	2	3	0	1	4	0	0
19	31938817	.	T	C	1	2	3	0	0	3	0	0
19	32049055	.	A	G	11	10	21	0	0	21	0	0
19	32049443	.	T	C	8	8	16	0	0	16	0	0
19	32049485	.	A	T	5	9	14	0	2	16	0	0
19	32049775	.	G	A	7	13	20	0	0	20	0	0
19	32049850	.	A	G	12	11	23	0	1	24	0	0
19	32049891	.	A	G	10	6	16	0	2	18	0	0
19	32050174	.	T	G	7	2	9	0	1	10	0	0
19	32050535	.	A	T	9	15	24	0	3	27	0	0
19	32050536	.	T	A	10	16	26	0	1	27	0	0
19	32050665	.	T	C	4	2	6	0	0	6	0	0
19	32050679	.	C	A	3	2	5	0	0	5	0	0
19	32050811	.	C	A	2	2	4	0	0	4	0	0
19	32050944	.	A	T	9	6	15	0	1	16	0	0
19	32051218	.	C	A	2	2	4	0	0	4	0	0
19	32051226	.	G	A	2	2	4	0	0	4	0	0
19	32149988	.	A	C	0	3	3	0	0	3	0	0
19	32167216	.	T	C	1	1	2	0	0	2	0	0
19	32473399	.	A	G	2	3	5	0	1	6	0	0
19	32489056	.	G	A	0	1	1	0	0	1	0	0
19	32497388	.	C	T	2	0	2	0	0	2	0	0
19	32499736	.	G	A	0	1	1	0	0	1	0	0
19	32499983	.	G	A	2	2	4	0	0	4	0	0
19	32505825	.	C	T	2	5	7	0	0	7	0	0
19	32505846	.	C	A	3	5	8	0	1	9	0	0
19	32505875	.	C	T	0	8	8	0	5	13	0	0
19	32505927	.	G	T	5	7	12	0	1	13	0	0
19	32572647	.	T	C	4	4	8	0	2	10	0	0
19	32573173	.	T	C	5	0	5	0	7	12	0	0
19	32573193	.	A	G	3	5	8	0	0	8	0	0
19	32573269	.	T	C	5	3	8	0	0	8	0	0
19	32575190	.	G	A	2	2	4	0	0	4	0	0
19	32623259	.	G	A	7	6	13	0	0	13	0	0
19	32623687	.	G	A	28	25	53	0	2	55	0	0
19	32624048	.	A	C	20	9	29	0	1	30	0	0
19	32624138	.	G	A	14	10	24	0	2	26	0	0
19	32624247	.	A	G	10	14	24	0	2	26	0	0
19	32638212	.	G	A	7	7	14	0	1	15	0	0
19	32767889	.	A	G	5	4	9	0	0	9	0	0
19	32767891	.	T	A	4	3	7	0	2	9	0	0
19	32767965	.	C	T	5	8	13	0	0	13	0	0
19	32768397	.	C	G	3	5	8	0	0	8	0	0
19	32768434	.	T	C	3	4	7	0	1	8	0	0
19	32768935	.	T	G	1	2	3	0	0	3	0	0
19	32768985	.	G	A	2	2	4	0	0	4	0	0
19	32769271	.	G	T	3	2	5	0	0	5	0	0
19	32818910	.	G	A	0	2	2	0	1	3	0	0
19	32819234	.	G	A	12	7	19	0	0	19	0	0
19	32819303	.	T	C	4	11	15	0	0	15	0	0
19	32819347	.	C	T	10	10	20	0	1	21	0	0
19	32819640	.	A	G	5	8	13	0	0	13	0	0
19	32819703	.	C	A	4	5	9	0	0	9	0	0
19	32819760	.	A	T	5	2	7	0	0	7	0	0
19	32819952	.	T	C	4	4	8	0	2	10	0	0
19	32838396	.	T	A	8	6	14	0	1	15	0	0
19	32860668	.	G	T	9	4	13	0	1	14	0	0
19	32864963	.	T	G	11	15	26	0	1	27	0	0
19	32865113	.	G	A	18	12	30	0	2	32	0	0
19	32865276	.	A	T	7	3	10	0	0	10	0	0
19	32865337	.	C	A	15	9	24	0	1	25	0	0
19	32865347	.	C	T	13	11	24	0	4	28	0	0
19	32865504	.	G	T	7	3	10	0	2	12	0	0
19	32866126	.	A	C	2	4	6	0	3	9	0	0
19	32866234	.	T	G	0	2	2	0	1	3	0	0
19	32866322	.	A	G	2	3	5	0	0	5	0	0
19	32866475	.	T	A	7	3	10	0	1	11	0	0
19	32867274	.	A	T	4	3	7	0	1	8	0	0
19	32872674	.	A	G	2	1	3	0	0	3	0	0
19	32895622	.	C	A	12	5	17	0	0	17	0	0
19	32895748	.	G	T	18	15	33	0	2	35	0	0
19	32895873	.	T	A	3	6	9	0	3	12	0	0
19	32896001	.	G	A	6	8	14	0	5	19	0	0
19	32896336	.	G	T	6	2	8	0	0	8	0	0
19	32896427	.	C	A	0	7	7	0	4	11	0	0
19	32896499	.	T	G	8	17	25	0	1	26	0	0
19	32896519	.	T	C	9	15	24	0	0	24	0	0
19	32899313	.	T	A	3	0	3	0	0	3	0	0
19	32899328	.	T	A	1	0	1	0	0	1	0	0
19	32899452	.	A	G	1	0	1	0	0	1	0	0
19	32918241	.	T	A	13	4	17	0	1	18	0	0
19	32918807	.	T	C	4	7	11	0	0	11	0	0
19	32919074	.	A	G	0	4	4	0	1	5	0	0
19	32931100	.	A	T	20	16	36	0	2	38	0	0
19	32931101	.	C	T	0	16	16	0	22	38	0	0
19	32933891	.	C	A	19	26	45	0	0	45	0	0
19	32935480	.	G	C	10	3	13	0	1	14	0	0
19	32936989	.	T	C	5	2	7	0	1	8	0	0
19	32937663	.	C	A	3	3	6	0	0	6	0	0
19	32944034	.	A	G	3	4	7	0	0	7	0	0
19	33071055	.	C	G	6	9	15	0	2	17	0	0
19	33071126	.	G	T	12	7	19	0	0	19	0	0
19	33071172	.	G	T	8	5	13	0	0	13	0	0
19	33071249	.	G	C	15	4	19	0	2	21	0	0
19	33071635	.	A	T	5	5	10	0	0	10	0	0
19	33071795	.	A	T	12	24	36	0	2	38	0	0
19	33131666	.	C	T	0	2	2	0	1	3	0	0
19	33137436	.	A	G	20	1	21	0	25	46	0	0
19	33140322	.	T	C	3	3	6	0	0	6	0	0
19	33258624	.	C	A	1	3	4	0	0	4	0	0
19	33258705	.	A	G	1	2	3	0	0	3	0	0
19	33514655	.	G	A	3	2	5	0	0	5	0	0
19	33756009	.	G	T	1	3	4	0	0	4	0	0
19	33783332	.	A	T	3	5	8	0	0	8	0	0
19	33784896	.	T	C	13	7	20	0	2	22	0	0
19	33784897	.	C	T	13	8	21	0	1	22	0	0
19	33784966	.	C	T	6	12	18	0	1	19	0	0
19	33784986	.	T	C	7	13	20	0	3	23	0	0
19	33785094	.	C	T	10	9	19	0	0	19	0	0
19	33785109	.	C	T	11	10	21	0	0	21	0	0
19	33785175	.	G	A	4	6	10	0	1	11	0	0
19	33785197	.	G	A	0	8	8	0	6	14	0	0
19	33785234	.	A	G	8	0	8	0	11	19	0	0
19	33785240	.	T	C	8	12	20	0	1	21	0	0
19	33785357	.	C	A	9	11	20	0	2	22	0	0
19	33785379	.	G	A	12	12	24	0	0	24	0	0
19	33785512	.	T	C	9	14	23	0	1	24	0	0
19	33785704	.	G	T	20	20	40	0	4	44	0	0
19	33836605	.	G	A	10	6	16	0	0	16	0	0
19	33837007	.	G	T	11	6	17	0	1	18	0	0
19	33837178	.	G	C	1	0	1	0	0	1	0	0
19	33837183	.	G	A	1	0	1	0	0	1	0	0
19	33868335	.	T	C	0	1	1	0	0	1	0	0
19	33871868	.	C	T	1	1	2	0	0	2	0	0
19	33872816	.	T	G	6	9	15	0	0	15	0	0
19	33872859	.	G	A	0	4	4	0	4	8	0	0
19	33888520	.	A	C	20	9	29	0	1	30	0	0
19	33888881	.	T	G	2	3	5	0	0	5	0	0
19	33902586	.	G	A	3	1	4	0	0	4	0	0
19	34074028	.	G	A	5	11	16	0	1	17	0	0
19	34074072	.	A	G	8	10	18	0	0	18	0	0
19	34074386	.	T	G	12	7	19	0	0	19	0	0
19	34696829	.	T	A	0	1	1	0	0	1	0	0
19	34696921	.	C	T	1	1	2	0	1	3	0	0
19	34742818	.	C	T	1	1	2	0	0	2	0	0
19	34744060	.	T	G	0	1	1	0	0	1	0	0
19	34744231	.	T	C	3	0	3	0	0	3	0	0
19	34744288	.	C	A	0	0	0	0	0	1	1	0
19	34746659	.	G	A	6	5	11	0	0	11	0	0
19	34746810	.	T	G	1	5	6	0	0	6	0	0
19	34960061	.	A	T	10	6	16	0	3	19	0	0
19	34960099	.	A	G	11	4	15	0	2	17	0	0
19	34960190	.	C	G	0	12	12	0	26	38	0	0
19	34960198	.	T	C	17	14	31	0	4	35	0	0
19	34960315	.	T	A	12	13	25	0	1	26	0	0
19	34960562	.	G	A	1	2	3	0	1	4	0	0
19	34961152	.	C	T	2	3	5	0	0	5	0	0
19	35002450	.	G	A	1	2	3	0	1	4	0	0
19	35002714	.	A	C	1	1	2	0	0	2	0	0
19	35002723	.	T	C	1	1	2	0	0	2	0	0
19	35004117	.	A	C	2	2	4	0	1	5	0	0
19	35005136	.	A	C	4	2	6	0	0	6	0	0
19	35005137	.	A	T	4	2	6	0	0	6	0	0
19	35005318	.	G	A	7	13	20	0	5	25	0	0
19	35007220	.	G	A	0	3	3	0	0	3	0	0
19	35007235	.	G	A	1	4	5	0	0	5	0	0
19	35013806	.	C	T	12	15	27	0	3	30	0	0
19	35016477	.	C	T	2	1	3	0	0	3	0	0
19	35016553	.	T	G	7	16	23	0	1	24	0	0
19	35016646	.	A	T	17	13	30	0	9	39	0	0
19	35016696	.	T	G	13	14	27	0	2	29	0	0
19	35016835	.	C	T	15	10	25	0	2	27	0	0
19	35016962	.	T	A	8	7	15	0	0	15	0	0
19	35019490	.	T	A	3	3	6	0	0	6	0	0
19	35019560	.	A	G	1	2	3	0	0	3	0	0
19	35040003	.	G	T	5	5	10	0	3	13	0	0
19	35041158	.	T	A	16	18	34	0	2	36	0	0
19	35041308	.	A	G	19	20	39	0	1	40	0	0
19	35052411	.	G	T	6	4	10	0	0	10	0	0
19	35055889	.	A	G	6	3	9	0	0	9	0	0
19	35058232	.	T	C	2	1	3	0	0	3	0	0
19	35060217	.	A	C	5	10	15	0	0	15	0	0
19	35067367	.	G	A	1	4	5	0	0	5	0	0
19	35076301	.	C	T	0	2	2	0	1	3	0	0
19	35083010	.	G	A	0	1	1	0	0	1	0	0
19	35083019	.	C	T	0	1	1	0	0	1	0	0
19	35359341	.	C	T	15	20	35	0	2	37	0	0
19	35419202	.	A	G	1	2	3	0	1	4	0	0
19	35422354	.	T	C	0	1	1	0	0	1	0	0
19	35428735	.	G	A	0	3	3	0	0	3	0	0
19	35459414	.	A	G	15	6	21	1	4	26	0	0
19	35459737	.	G	A	22	18	40	0	1	41	0	0
19	35459801	.	A	T	20	19	39	0	0	39	0	0
19	35473080	.	C	A	0	1	1	0	2	3	0	0
19	36115210	.	G	A	1	2	3	0	0	3	0	0
19	36378314	.	G	A	1	5	6	0	0	6	0	0
19	37133533	.	C	A	2	4	6	0	1	7	0	0
19	37133825	.	G	A	3	3	6	0	0	6	0	0
19	37133872	.	T	C	1	3	4	0	1	5	0	0
19	37138388	.	G	A	0	1	1	0	3	4	0	0
19	37138643	.	G	A	0	5	5	0	6	11	0	0
19	37138955	.	A	G	5	4	9	0	5	14	0	0
19	37501935	.	A	G	21	23	44	0	2	46	0	0
19	37502105	.	A	G	7	4	11	0	0	11	0	0
19	37505808	.	G	A	4	1	5	0	0	5	0	0
19	37775889	.	C	T	1	2	3	0	0	3	0	0
19	37926003	.	C	T	4	6	10	0	1	11	0	0
19	37926066	.	C	A	6	6	12	0	0	12	0	0
19	37926653	.	A	T	2	13	15	0	1	16	0	0
19	37926666	.	C	A	4	11	15	0	0	15	0	0
19	37926816	.	T	G	18	18	36	0	2	38	0	0
19	37926865	.	G	A	18	15	33	0	1	34	0	0
19	37927304	.	G	T	0	21	21	0	15	36	0	0
19	38216247	.	A	G	3	2	5	0	0	5	0	0
19	38327377	.	A	T	1	2	3	0	0	3	0	0
19	38327593	.	C	T	1	3	4	0	0	4	0	0
19	38467142	.	T	G	1	2	3	0	0	3	0	0
19	40026661	.	T	C	10	11	21	0	2	23	0	0
19	40031002	.	G	A	2	5	7	0	1	8	0	0
19	40039603	.	G	A	2	11	13	0	1	14	0	0
19	40039606	.	T	A	2	9	11	0	2	13	0	0
19	40053055	.	A	G	22	0	22	0	27	49	0	0
19	40053061	.	A	T	24	23	47	0	3	50	0	0
19	40055030	.	A	G	6	4	10	0	1	11	0	0
19	40055318	.	A	G	1	9	10	0	0	10	0	0
19	40110840	.	G	A	0	2	2	0	1	3	0	0
19	40113425	.	C	A	6	9	15	0	0	15	0	0
19	40113549	.	T	G	6	8	14	0	2	16	0	0
19	40113677	.	C	G	6	10	16	0	0	16	0	0
19	40113692	.	G	T	2	9	11	0	2	13	0	0
19	40156870	.	T	C	2	1	3	0	0	3	0	0
19	40160049	.	T	C	3	5	8	0	0	8	0	0
19	40162945	.	C	A	9	3	12	0	1	13	0	0
19	40163256	.	C	T	0	4	4	0	2	6	0	0
19	40165405	.	A	G	19	10	29	0	0	29	0	0
19	40177762	.	T	C	0	2	2	0	0	2	0	0
19	40179858	.	C	A	2	0	2	0	0	2	0	0
19	40180011	.	C	T	5	2	7	0	0	7	0	0
19	40180100	.	A	G	2	5	7	0	0	7	0	0
19	40182571	.	T	A	1	3	4	0	0	4	0	0
19	40182574	.	C	T	1	3	4	0	0	4	0	0
19	40340319	.	A	G	2	2	4	0	0	4	0	0
19	40345966	.	G	T	4	3	7	0	1	8	0	0
19	40347600	.	T	G	5	0	5	0	3	8	0	0
19	40347702	.	T	A	31	9	40	0	5	45	0	0
19	40347760	.	T	A	31	13	44	0	3	47	0	0
19	40347785	.	A	T	30	9	39	0	3	42	0	0
19	40347842	.	G	T	1	14	15	0	5	20	0	0
19	40685448	.	C	T	1	2	3	0	1	4	0	0
19	40685845	.	G	A	2	2	4	0	0	4	0	0
19	40685935	.	A	G	2	2	4	0	0	4	0	0
19	40717137	.	G	A	1	2	3	0	0	3	0	0
19	40859147	.	C	A	10	11	21	0	1	22	0	0
19	40895829	.	C	T	2	2	4	0	2	6	0	0
19	40898468	.	C	T	6	9	15	0	1	16	0	0
19	40900205	.	T	C	3	0	3	0	10	13	0	0
19	41031941	.	G	A	0	8	8	0	1	9	0	0
19	41033898	.	C	T	8	6	14	0	1	15	0	0
19	41033929	.	C	A	8	6	14	0	1	15	0	0
19	41038855	.	C	T	22	14	36	0	4	40	0	0
19	41038942	.	C	A	18	32	50	0	2	52	0	0
19	41038961	.	A	C	35	14	49	0	2	52	1	0
19	41039012	.	G	C	10	1	11	0	21	32	0	0
19	41052229	.	G	A	4	11	15	0	1	16	0	0
19	41052274	.	G	A	13	14	27	0	4	31	0	0
19	41060384	.	C	T	0	4	4	0	4	8	0	0
19	41060856	.	A	G	1	2	3	0	0	3	0	0
19	41069442	.	G	A	0	2	2	0	0	2	0	0
19	42118441	.	T	A	0	8	8	0	0	8	0	0
19	42562308	.	G	A	2	2	4	0	0	4	0	0
19	42562309	.	G	T	2	2	4	0	0	4	0	0
19	42802294	.	T	A	6	3	9	0	1	10	0	0
19	42802295	.	G	A	5	3	8	0	2	10	0	0
19	42843596	.	A	G	2	6	8	0	0	8	0	0
19	42843837	.	A	G	9	3	12	0	0	12	0	0
19	42843851	.	A	G	8	6	14	0	0	14	0	0
19	42843894	.	A	G	13	8	21	0	1	22	0	0
19	42844126	.	A	G	7	3	10	0	1	11	0	0
19	42997263	.	G	A	0	20	20	0	1	21	0	0
19	43900223	.	A	G	6	4	10	0	0	10	0	0
19	43901062	.	A	T	3	2	5	0	1	6	0	0
19	45856213	.	T	C	6	4	10	0	1	11	0	0
19	45856295	.	A	G	19	5	24	0	5	29	0	0
19	45856414	.	A	G	14	18	32	0	2	34	0	0
19	45859824	.	C	T	8	12	20	0	1	21	0	0
19	45868237	.	A	C	2	1	3	0	0	3	0	0
19	45883626	.	C	A	7	3	10	0	1	11	0	0
19	45962080	.	T	G	1	2	3	0	0	3	0	0
19	45962161	.	A	C	2	4	6	0	0	6	0	0
19	45962171	.	A	G	2	5	7	0	0	7	0	0
19	45967297	.	C	G	6	0	6	0	6	12	0	0
19	45967306	.	A	T	5	4	9	0	1	10	0	0
19	45967372	.	G	A	11	7	18	0	0	18	0	0
19	45967596	.	T	A	2	7	9	0	0	9	0	0
19	46019603	.	G	A	5	7	12	0	2	14	0	0
19	46019616	.	G	T	5	8	13	0	1	14	0	0
19	46019803	.	A	G	19	13	32	0	2	34	0	0
19	46020228	.	G	A	4	10	14	0	0	14	0	0
19	46020453	.	C	A	5	7	12	0	0	12	0	0
19	46020471	.	G	T	5	7	12	0	1	13	0	0
19	46022418	.	A	G	4	2	6	0	0	6	0	0
19	46022453	.	C	T	0	6	6	0	4	10	0	0
19	46238395	.	C	T	5	2	7	0	2	9	0	0
19	47405935	.	C	T	6	5	11	0	0	11	0	0
19	47405946	.	G	T	5	5	10	0	1	11	0	0
19	47431220	.	C	T	3	3	6	0	0	6	0	0
19	47431230	.	G	A	3	2	5	0	1	6	0	0
19	47431333	.	G	A	9	5	14	0	0	14	0	0
19	47431459	.	C	T	9	7	16	0	0	16	0	0
19	47431501	.	C	T	0	4	4	0	10	14	0	0
19	47431510	.	A	G	7	5	12	0	0	12	0	0
19	47438149	.	C	G	5	2	7	0	0	7	0	0
19	47448486	.	G	A	0	1	1	0	0	1	0	0
19	47464500	.	A	G	1	4	5	0	0	5	0	0
19	47464513	.	A	G	1	3	4	0	1	5	0	0
19	47465242	.	C	T	0	1	1	0	0	1	0	0
19	47465577	.	A	G	1	1	2	0	0	2	0	0
19	47465652	.	C	T	5	2	7	0	0	7	0	0
19	47478108	.	G	A	3	2	5	0	0	5	0	0
19	47478842	.	C	T	5	3	8	0	1	9	0	0
19	47479051	.	G	T	0	3	3	0	0	3	0	0
19	47479084	.	A	G	1	3	4	0	0	4	0	0
19	47481235	.	C	T	2	5	7	0	0	7	0	0
19	47784172	.	C	T	1	5	6	0	0	6	0	0
19	47802932	.	A	G	1	3	4	0	0	4	0	0
19	47808002	.	G	T	1	2	3	0	0	3	0	0
19	47808044	.	A	G	1	2	3	0	0	3	0	0
19	47820986	.	G	A	1	3	4	0	0	4	0	0
19	47821025	.	A	G	0	1	1	0	1	2	0	0
19	47910483	.	A	T	0	1	1	0	0	1	0	0
19	47910488	.	C	T	0	1	1	0	0	1	0	0
19	47914773	.	C	G	1	3	4	0	0	4	0	0
19	47976325	.	C	T	27	28	55	0	4	59	0	0
19	47980813	.	C	T	7	14	21	0	2	23	0	0
19	47982822	.	C	T	0	7	7	0	5	12	0	0
19	47982843	.	G	A	5	6	11	0	1	12	0	0
19	47982891	.	G	T	7	7	14	0	0	14	0	0
19	47983859	.	G	A	1	1	2	0	0	2	0	0
19	47984970	.	G	A	6	4	10	0	0	10	0	0
19	47986411	.	G	A	2	2	4	0	1	5	0	0
19	47987084	.	C	T	0	1	1	0	3	4	0	0
19	47997402	.	C	T	0	2	2	0	4	6	0	0
19	48013584	.	G	A	0	2	2	0	1	3	0	0
19	48022023	.	G	A	0	1	1	0	0	1	0	0
19	48030734	.	C	T	3	3	6	0	0	6	0	0
19	48033564	.	T	C	2	2	4	0	0	4	0	0
19	48033631	.	A	G	2	2	4	0	0	4	0	0
19	48036716	.	C	T	0	3	3	0	0	3	0	0
19	48055131	.	G	A	0	8	8	0	3	11	0	0
19	48058778	.	C	T	23	17	40	0	0	40	0	0
19	48064551	.	C	T	1	3	4	0	0	4	0	0
19	48064790	.	C	T	1	2	3	0	0	3	0	0
19	48065917	.	A	C	2	2	4	0	0	4	0	0
19	48065970	.	C	T	3	4	7	0	0	7	0	0
19	48067046	.	C	T	1	2	3	0	0	3	0	0
19	48067256	.	C	T	0	0	0	0	1	1	0	0
19	48102652	.	C	T	2	2	4	0	1	5	0	0
19	48114098	.	G	A	0	5	5	0	5	10	0	0
19	48114268	.	G	A	0	7	7	0	15	22	0	0
19	48119203	.	T	C	9	5	14	1	0	15	0	0
19	48120142	.	G	T	0	24	24	0	27	51	0	0
19	48284234	.	A	T	1	3	4	0	0	4	0	0
19	48364835	.	T	A	4	10	14	0	0	14	0	0
19	48364848	.	C	T	0	8	8	0	5	13	0	0
19	48364870	.	T	C	11	15	26	0	0	26	0	0
2	177241	.	G	T	20	0	20	0	0	20	0	0
2	177243	.	G	C	20	0	20	0	0	20	0	0
2	1220802	.	T	C	1	2	3	0	1	4	0	0
2	1595275	.	T	C	5	17	22	0	0	22	0	0
2	1597510	.	T	C	3	3	6	0	0	6	0	0
2	1597617	.	T	C	2	3	5	0	0	5	0	0
2	3027065	.	T	A	2	5	7	0	0	7	0	0
2	3027066	.	A	T	2	5	7	0	0	7	0	0
2	3028893	.	A	G	0	7	7	0	0	7	0	0
2	3028908	.	A	T	0	3	3	0	1	4	0	0
2	4045399	.	T	C	3	2	5	0	1	6	0	0
2	4045667	.	T	C	2	4	6	0	0	6	0	0
2	4900798	.	T	C	22	24	46	0	2	48	0	0
2	4902586	.	T	C	0	0	0	0	5	5	0	0
2	4902590	.	T	C	1	4	5	0	0	5	0	0
2	5407070	.	A	G	5	2	7	0	0	7	0	0
2	5407489	.	A	G	5	4	9	0	0	9	0	0
2	5480576	.	C	T	3	2	5	0	0	5	0	0
2	5480710	.	A	G	3	7	10	0	2	12	0	0
2	5480733	.	C	T	4	6	10	0	0	10	0	0
2	5480972	.	A	C	1	4	5	0	0	5	0	0
2	5481067	.	G	A	8	4	12	0	0	12	0	0
2	5482112	.	T	A	0	3	3	0	0	3	0	0
2	5482157	.	G	A	0	6	6	0	0	6	0	0
2	5482175	.	A	G	0	5	5	0	0	5	0	0
2	5544025	.	C	G	3	2	5	0	1	6	0	0
2	5544261	.	C	G	2	3	5	0	0	5	0	0
2	5546933	.	T	C	2	0	2	0	1	3	0	0
2	5555349	.	C	A	2	2	4	0	0	4	0	0
2	5578936	.	A	T	1	2	3	0	0	3	0	0
2	5580140	.	G	A	3	4	7	0	0	7	0	0
2	5580249	.	A	G	4	4	8	0	0	8	0	0
2	5580267	.	T	G	3	5	8	0	1	9	0	0
2	5580439	.	T	C	10	4	14	0	0	14	0	0
2	5580510	.	C	T	3	5	8	0	0	8	0	0
2	5580544	.	A	G	8	5	13	0	0	13	0	0
2	5580592	.	C	T	9	8	17	0	0	17	0	0
2	5580887	.	G	T	5	3	8	0	0	8	0	0
2	5581063	.	G	A	0	7	7	0	5	12	0	0
2	5581073	.	A	G	5	5	10	0	1	11	0	0
2	5581233	.	C	T	5	10	15	0	2	17	0	0
2	5581234	.	G	T	0	10	10	0	7	17	0	0
2	5581482	.	T	A	9	14	23	0	0	23	0	0
2	5581612	.	A	G	13	6	19	0	4	23	0	0
2	5581660	.	T	A	7	12	19	0	1	20	0	0
2	5601282	.	A	T	1	4	5	0	0	5	0	0
2	5621176	.	A	T	5	3	8	0	0	8	0	0
2	5621360	.	C	T	6	2	8	0	0	8	0	0
2	5644548	.	C	T	3	1	4	0	0	4	0	0
2	5677650	.	C	T	6	5	11	0	1	12	0	0
2	5681049	.	A	C	18	17	35	0	4	39	0	0
2	5681388	.	T	G	12	0	12	0	24	36	0	0
2	5681446	.	T	C	12	19	31	0	1	32	0	0
2	5709663	.	C	G	11	8	19	0	1	20	0	0
2	5709670	.	T	A	14	9	23	0	1	24	0	0
2	5709746	.	T	A	11	4	15	0	1	16	0	0
2	5709762	.	T	C	11	0	11	0	0	11	0	0
2	5709782	.	C	T	7	6	13	0	1	14	0	0
2	5709843	.	C	A	5	16	21	0	1	22	0	0
2	5709850	.	T	G	7	11	18	0	1	19	0	0
2	5711684	.	C	A	4	7	11	0	1	12	0	0
2	5714194	.	A	G	7	8	15	0	0	15	0	0
2	5714303	.	G	T	10	5	15	0	1	16	0	0
2	5714789	.	C	T	0	0	0	0	1	1	0	0
2	5714813	.	C	T	1	1	2	0	4	6	0	0
2	5716793	.	T	C	8	8	16	0	3	19	0	0
2	5721008	.	C	T	0	1	1	0	2	3	0	0
2	5723497	.	A	G	0	2	2	0	0	2	0	0
2	5723515	.	A	G	1	3	4	0	1	5	0	0
2	5811620	.	A	C	3	3	6	0	0	6	0	0
2	5811687	.	A	T	3	3	6	0	1	7	0	0
2	5811863	.	A	G	1	2	3	0	0	3	0	0
2	5812046	.	A	G	8	4	12	0	0	12	0	0
2	5812133	.	T	C	1	4	5	0	1	6	0	0
2	5814004	.	C	T	0	2	2	0	0	2	0	0
2	5844235	.	A	G	0	2	2	0	0	2	0	0
2	5844242	.	T	A	0	1	1	0	0	1	0	0
2	5880396	.	G	A	3	2	5	0	0	5	0	0
2	5882726	.	T	C	3	4	7	0	0	7	0	0
2	5884008	.	C	T	2	4	6	0	0	6	0	0
2	5884019	.	A	T	1	3	4	0	0	4	0	0
2	5884127	.	A	C	2	1	3	0	1	4	0	0
2	5884322	.	C	T	4	14	18	0	2	20	0	0
2	5923178	.	G	C	0	1	1	0	1	2	0	0
2	5933999	.	C	A	0	5	5	0	6	11	0	0
2	5934000	.	G	A	6	5	11	0	0	11	0	0
2	5934076	.	T	A	2	4	6	4	1	11	0	0
2	5934256	.	A	T	3	8	11	0	1	12	0	0
2	5934781	.	G	A	0	4	4	0	0	4	0	0
2	5934806	.	C	T	4	3	7	0	2	9	0	0
2	5934828	.	A	T	4	5	9	0	1	10	0	0
2	5934920	.	G	C	2	6	8	0	0	8	0	0
2	5937051	.	C	T	1	1	2	0	0	2	0	0
2	6258712	.	A	G	1	1	2	0	0	2	0	0
2	7150995	.	T	A	0	4	4	0	0	4	0	0
2	7150997	.	T	G	0	4	4	0	0	4	0	0
2	7764894	.	C	T	0	19	19	0	17	36	0	0
2	7765145	.	A	G	6	3	9	0	2	11	0	0
2	7765215	.	G	A	1	1	2	0	1	3	0	0
2	7765308	.	A	T	4	2	6	0	1	7	0	0
2	7765613	.	C	T	7	2	9	0	0	9	0	0
2	7765685	.	A	G	8	6	14	0	0	14	0	0
2	7924183	.	A	T	24	11	35	0	1	36	0	0
2	7924713	.	T	C	13	18	31	0	7	38	0	0
2	7924867	.	G	A	13	18	31	0	2	33	0	0
2	7937238	.	C	T	0	3	3	0	3	6	0	0
2	7943854	.	G	A	2	6	8	0	0	8	0	0
2	7954914	.	G	A	2	4	6	0	0	6	0	0
2	7956982	.	T	C	0	1	1	0	0	1	0	0
2	7979881	.	T	C	2	2	4	0	0	4	0	0
2	8112516	.	C	T	2	3	5	0	0	5	0	0
2	8112679	.	C	A	0	3	3	0	1	4	0	0
2	8112687	.	A	T	0	3	3	0	1	4	0	0
2	8113705	.	T	C	17	6	23	0	0	23	0	0
2	8114005	.	G	T	0	17	17	0	9	26	0	0
2	9841894	.	T	A	0	12	12	0	5	18	1	0
2	10149883	.	C	A	7	0	7	0	8	17	2	0
2	10604787	.	A	T	1	2	3	0	1	4	0	0
2	10605096	.	T	G	3	3	6	0	0	6	0	0
2	10606297	.	C	T	4	3	7	0	1	8	0	0
2	10606315	.	G	C	3	4	7	0	0	7	0	0
2	10606346	.	G	T	1	2	3	0	0	3	0	0
2	10686209	.	G	A	0	4	4	0	2	6	0	0
2	10686277	.	A	C	3	2	5	0	0	5	0	0
2	10686280	.	G	A	3	2	5	0	0	5	0	0
2	10686341	.	A	C	1	6	7	0	0	7	0	0
2	10686898	.	G	C	3	5	8	0	2	10	0	0
2	10687002	.	G	T	1	3	4	0	0	4	0	0
2	10698150	.	T	C	7	3	10	0	2	12	0	0
2	10791702	.	A	G	5	1	6	0	0	6	0	0
2	10813088	.	G	A	4	4	8	0	0	8	0	0
2	10813148	.	G	C	2	2	4	0	2	6	0	0
2	10813152	.	C	T	2	5	7	0	1	8	0	0
2	10813298	.	T	A	1	2	3	0	0	3	0	0
2	10813499	.	C	T	0	3	3	0	2	5	0	0
2	10813500	.	G	T	2	3	5	0	0	5	0	0
2	10841536	.	T	A	1	0	1	0	0	1	0	0
2	10857439	.	G	T	3	4	7	0	0	7	0	0
2	10857833	.	A	G	2	6	8	0	1	9	0	0
2	10914340	.	C	A	1	3	4	0	0	4	0	0
2	10916419	.	T	C	0	2	2	0	0	2	0	0
2	10926449	.	T	C	5	6	11	0	0	11	0	0
2	10931675	.	C	G	7	8	15	0	0	15	0	0
2	11110222	.	A	G	0	1	1	0	1	2	0	0
2	11125896	.	C	A	2	3	5	0	0	5	0	0
2	11126039	.	A	C	1	4	5	0	0	5	0	0
2	11209756	.	G	A	2	3	5	0	2	7	0	0
2	11508771	.	A	G	8	5	13	0	0	13	0	0
2	11508780	.	G	A	8	9	17	0	0	17	0	0
2	11509016	.	A	G	18	13	31	0	8	39	0	0
2	11654370	.	G	A	2	2	4	0	0	4	0	0
2	11661234	.	G	A	1	3	4	0	1	5	0	0
2	11831253	.	G	A	0	3	3	0	1	4	0	0
2	11832162	.	C	G	1	3	4	0	0	4	0	0
2	11832876	.	A	C	11	2	13	0	1	14	0	0
2	11849167	.	A	G	8	11	19	1	0	20	0	0
2	11849190	.	T	C	6	15	21	1	0	22	0	0
2	11849637	.	G	A	2	2	4	0	0	4	0	0
2	11850350	.	A	T	6	2	8	1	0	9	0	0
2	11850525	.	A	G	1	3	4	0	0	4	0	0
2	11850528	.	T	C	1	0	1	0	3	4	0	0
2	11945684	.	A	T	4	3	7	0	0	7	0	0
2	11945688	.	A	T	5	2	7	0	0	7	0	0
2	11945864	.	G	C	4	3	7	0	1	8	0	0
2	11965262	.	G	A	2	2	4	0	0	4	0	0
2	11976603	.	T	C	9	1	10	0	11	21	0	0
2	11976633	.	A	G	9	11	20	0	1	21	0	0
2	11976700	.	G	T	9	8	17	0	0	17	0	0
2	11976741	.	C	T	0	3	3	0	7	10	0	0
2	11976980	.	A	G	5	6	11	0	1	12	0	0
2	11977104	.	C	T	0	7	7	0	4	11	0	0
2	11977146	.	A	T	3	4	7	0	2	10	1	0
2	11977163	.	T	C	4	5	9	0	1	10	0	0
2	11977495	.	A	G	3	5	8	0	0	8	0	0
2	11991153	.	T	C	0	1	1	0	1	2	0	0
2	11993409	.	A	G	1	4	5	0	0	5	0	0
2	11998037	.	C	T	3	2	5	0	0	5	0	0
2	11998058	.	T	C	1	0	1	0	0	1	0	0
2	12002385	.	T	A	5	4	9	0	1	10	0	0
2	12002697	.	A	T	4	7	11	0	0	11	0	0
2	12002766	.	A	G	6	5	11	0	0	11	0	0
2	12002797	.	A	G	5	5	10	0	1	11	0	0
2	12002885	.	T	C	4	3	7	0	0	7	0	0
2	12002899	.	T	G	4	2	6	0	1	7	0	0
2	12002945	.	A	T	2	2	4	0	0	4	0	0
2	12002950	.	T	C	2	2	4	0	0	4	0	0
2	12002993	.	C	G	1	4	5	0	0	5	0	0
2	12104948	.	T	A	15	13	28	0	0	28	0	0
2	12104949	.	C	T	14	13	27	0	1	28	0	0
2	12105078	.	A	T	7	4	11	0	0	11	0	0
2	12105245	.	T	A	4	2	6	0	0	6	0	0
2	12106289	.	A	G	12	8	20	0	0	20	0	0
2	12106508	.	A	T	4	4	8	0	0	8	0	0
2	12106603	.	C	T	3	2	5	0	0	5	0	0
2	12106701	.	G	T	4	4	8	0	0	8	0	0
2	12106721	.	G	A	6	3	9	0	1	10	0	0
2	12106792	.	A	G	2	4	6	0	0	6	0	0
2	12106828	.	C	T	1	2	3	0	0	3	0	0
2	12106846	.	A	T	1	2	3	0	0	3	0	0
2	12279203	.	A	G	3	2	5	0	0	5	0	0
2	12279303	.	C	T	6	2	8	0	0	8	0	0
2	12279328	.	T	C	4	2	6	0	0	6	0	0
2	12279540	.	T	C	5	2	7	0	0	7	0	0
2	12279594	.	A	C	0	2	2	0	0	2	0	0
2	12386865	.	A	G	2	4	6	0	0	6	0	0
2	12394650	.	A	G	1	0	1	0	3	4	0	0
2	12404169	.	A	C	8	11	19	0	1	20	0	0
2	12404411	.	T	C	6	10	16	0	0	16	0	0
2	12405310	.	G	A	1	7	8	0	7	15	0	0
2	12406022	.	A	T	22	14	36	0	0	36	0	0
2	12407106	.	G	A	21	5	26	0	1	27	0	0
2	12407113	.	C	G	20	4	24	0	0	24	0	0
2	12407188	.	A	C	29	9	38	0	2	40	0	0
2	12407586	.	G	T	13	13	26	0	0	26	0	0
2	12407610	.	G	A	13	9	22	0	4	26	0	0
2	12407626	.	T	A	15	9	24	0	3	27	0	0
2	12407799	.	C	T	14	9	23	0	1	24	0	0
2	12407992	.	T	C	29	9	38	0	0	38	0	0
2	12408081	.	T	G	11	3	14	0	2	16	0	0
2	12408085	.	G	A	9	2	11	0	4	15	0	0
2	12410548	.	A	G	4	1	5	0	0	5	0	0
2	13035942	.	C	A	4	5	9	0	0	9	0	0
2	13036154	.	T	A	9	5	14	0	0	14	0	0
2	13036649	.	G	C	0	5	5	0	7	12	0	0
2	13187003	.	T	A	6	6	12	0	1	13	0	0
2	13187634	.	A	G	4	2	6	0	0	6	0	0
2	13215694	.	C	A	5	3	8	0	1	9	0	0
2	13215967	.	G	A	2	2	4	0	0	4	0	0
2	13224229	.	C	T	1	3	4	0	0	4	0	0
2	13256795	.	G	C	1	2	3	0	1	4	0	0
2	14278412	.	A	C	7	5	12	0	0	12	0	0
2	14655769	.	C	G	1	2	3	0	0	3	0	0
2	14998679	.	A	T	2	1	3	0	0	3	0	0
2	14998699	.	T	A	4	3	7	0	0	7	0	0
2	14998764	.	A	G	1	1	2	0	1	3	0	0
2	15035425	.	A	G	4	4	8	0	0	8	0	0
2	15035928	.	A	T	2	4	6	0	0	6	0	0
2	15112025	.	G	T	1	2	3	0	0	3	0	0
2	15343317	.	A	G	1	2	3	0	0	3	0	0
2	15343342	.	T	C	1	2	3	0	0	3	0	0
2	15344081	.	A	G	1	2	3	0	0	3	0	0
2	15864586	.	C	T	1	3	4	0	0	4	0	0
2	15942544	.	A	G	4	9	13	0	2	15	0	0
2	15942637	.	A	G	7	4	11	0	0	11	0	0
2	15942671	.	G	A	6	6	12	0	0	12	0	0
2	15942674	.	A	T	6	5	11	0	0	11	0	0
2	15942774	.	G	A	8	6	14	0	0	14	0	0
2	15942817	.	T	C	8	3	11	0	1	12	0	0
2	15942843	.	C	T	8	3	11	0	0	11	0	0
2	15942897	.	C	G	7	10	17	0	0	17	0	0
2	15942964	.	T	C	1	6	7	0	0	7	0	0
2	15943022	.	C	T	4	4	8	0	1	9	0	0
2	15943048	.	G	T	4	5	9	0	1	10	0	0
2	15943120	.	T	G	6	3	9	0	1	10	0	0
2	15943267	.	G	A	0	6	6	0	5	11	0	0
2	15993631	.	A	G	3	2	5	0	0	5	0	0
2	15993696	.	T	A	1	2	3	1	1	5	0	0
2	16169397	.	A	G	1	2	3	0	0	3	0	0
2	16172088	.	T	G	3	7	10	0	0	10	0	0
2	16172096	.	A	T	3	5	8	0	1	9	0	0
2	16172160	.	T	C	2	5	7	0	0	7	0	0
2	16181251	.	C	T	0	1	1	0	0	1	0	0
2	16181258	.	A	G	0	1	1	0	1	2	0	0
2	16191718	.	G	A	0	5	5	0	4	9	0	0
2	16191748	.	A	G	6	12	18	0	1	19	0	0
2	16191829	.	C	T	14	8	22	0	2	24	0	0
2	16191892	.	T	G	2	0	2	0	2	4	0	0
2	16194018	.	A	G	12	0	12	0	8	20	0	0
2	16194019	.	T	C	12	8	20	0	0	20	0	0
2	16198807	.	T	C	6	6	12	0	1	13	0	0
2	16198932	.	A	G	14	20	34	0	2	36	0	0
2	16199018	.	G	A	23	28	51	0	5	56	0	0
2	16204689	.	T	G	0	3	3	0	0	3	0	0
2	16206840	.	C	T	13	14	27	0	1	28	0	0
2	16207151	.	G	A	5	3	8	0	1	9	0	0
2	16207346	.	T	C	5	6	11	0	0	11	0	0
2	16209406	.	T	C	8	6	14	0	1	15	0	0
2	16387964	.	G	A	1	2	3	0	0	3	0	0
2	16393337	.	T	C	1	1	2	0	0	2	0	0
2	16393720	.	C	T	1	0	1	0	0	1	0	0
2	16449803	.	C	T	0	2	2	0	0	2	0	0
2	16472243	.	T	C	2	1	3	0	0	3	0	0
2	16475469	.	C	A	2	0	2	0	0	2	0	0
2	16478577	.	G	A	0	9	9	0	5	14	0	0
2	16478587	.	A	G	4	10	14	0	0	14	0	0
2	16479015	.	A	G	17	12	29	0	0	29	0	0
2	16547866	.	T	C	16	10	26	0	4	30	0	0
2	16548120	.	A	T	11	8	19	0	0	19	0	0
2	16548178	.	C	T	0	6	6	0	5	11	0	0
2	16548236	.	T	G	12	5	17	0	1	18	0	0
2	16548286	.	T	C	16	0	16	0	16	32	0	0
2	16548289	.	C	T	16	14	30	0	2	32	0	0
2	16548514	.	T	C	15	12	27	0	1	28	0	0
2	16646222	.	C	T	3	3	6	0	0	6	0	0
2	16646275	.	G	C	2	4	6	0	0	6	0	0
2	16646475	.	T	C	2	7	9	0	0	9	0	0
2	16646556	.	G	A	0	6	6	0	2	8	0	0
2	16646593	.	T	C	6	4	10	0	2	12	0	0
2	16646714	.	T	A	2	6	8	0	0	8	0	0
2	16647219	.	T	G	2	2	4	0	0	4	0	0
2	16698384	.	C	A	1	0	1	0	0	1	0	0
2	16699560	.	C	T	2	6	8	0	0	8	0	0
2	16699565	.	A	T	2	6	8	0	0	8	0	0
2	16699595	.	T	C	1	4	5	0	1	6	0	0
2	16706549	.	A	C	18	17	35	0	5	40	0	0
2	16706563	.	T	C	20	20	40	0	2	42	0	0
2	16706618	.	G	A	4	20	24	0	20	44	0	0
2	16706737	.	G	A	2	13	15	0	13	28	0	0
2	16706878	.	T	A	18	6	24	0	1	25	0	0
2	16706880	.	C	A	19	6	25	0	0	25	0	0
2	16707290	.	G	T	6	5	11	0	1	12	0	0
2	16707329	.	A	C	11	7	18	0	0	18	0	0
2	16707371	.	C	T	8	18	26	0	2	28	0	0
2	16707374	.	C	A	8	20	28	0	2	30	0	0
2	16707582	.	T	A	14	19	33	0	1	34	0	0
2	16707631	.	C	G	14	12	26	0	2	28	0	0
2	16728507	.	T	C	0	2	2	0	1	3	0	0
2	16735052	.	G	T	2	6	8	0	1	9	0	0
2	16735160	.	G	A	3	5	8	0	0	8	0	0
2	16735262	.	G	A	0	4	4	0	4	8	0	0
2	16736612	.	C	T	4	1	5	1	0	6	0	0
2	16736678	.	T	C	10	8	18	0	3	21	0	0
2	16736941	.	T	A	13	8	21	0	0	21	0	0
2	16736964	.	T	C	12	7	19	0	0	19	0	0
2	16737086	.	C	T	14	7	21	0	4	25	0	0
2	16826899	.	T	C	0	1	1	0	0	1	0	0
2	16833650	.	C	A	3	2	5	0	0	5	0	0
2	16837849	.	C	T	7	6	13	0	1	14	0	0
2	17450367	.	C	T	0	3	3	0	1	4	0	0
2	17450368	.	A	G	0	0	0	0	4	4	0	0
2	17450424	.	T	A	3	8	11	0	0	11	0	0
2	17450642	.	C	T	4	5	9	0	0	9	0	0
2	17450744	.	G	A	4	4	8	0	3	11	0	0
2	17450841	.	A	T	3	1	4	0	0	4	0	0
2	17450859	.	C	A	0	3	3	0	4	7	0	0
2	17451233	.	T	C	3	10	13	0	2	15	0	0
2	17451387	.	T	C	3	4	7	0	0	7	0	0
2	17477335	.	G	T	1	3	4	0	0	4	0	0
2	17578480	.	A	T	2	2	4	0	1	5	0	0
2	17578593	.	A	G	10	26	36	0	0	36	0	0
2	17578658	.	T	A	8	32	40	0	0	40	0	0
2	17578853	.	C	T	10	27	37	0	1	38	0	0
2	17579639	.	G	A	3	5	8	0	0	8	0	0
2	17651466	.	A	G	2	5	7	0	0	7	0	0
2	17651565	.	C	T	1	2	3	0	1	4	0	0
2	18698517	.	C	A	20	16	36	0	1	37	0	0
2	18698560	.	T	A	16	18	34	0	3	37	0	0
2	18698648	.	G	A	7	8	15	0	2	17	0	0
2	18698659	.	G	T	8	4	12	0	2	14	0	0
2	18698686	.	C	T	14	5	19	0	3	22	0	0
2	18698912	.	C	G	13	11	24	0	1	25	0	0
2	18698920	.	G	A	14	12	26	0	1	27	0	0
2	18698957	.	A	T	14	15	29	0	2	31	0	0
2	18699071	.	G	A	14	9	23	0	4	27	0	0
2	18699192	.	C	T	9	8	17	0	0	17	0	0
2	18699315	.	C	G	13	15	28	0	0	28	0	0
2	18699474	.	G	T	7	19	26	0	0	26	0	0
2	18699533	.	T	A	7	21	28	0	4	32	0	0
2	18699586	.	G	T	7	15	22	0	2	24	0	0
2	18699590	.	G	T	10	14	24	0	0	24	0	0
2	18700102	.	T	A	1	2	3	0	2	5	0	0
2	18700148	.	G	A	3	7	10	0	0	10	0	0
2	18700194	.	T	A	2	11	13	0	0	13	0	0
2	18700673	.	A	T	1	2	3	0	0	3	0	0
2	18700750	.	G	A	1	3	4	0	0	4	0	0
2	18700753	.	G	A	1	2	3	0	1	4	0	0
2	18701033	.	G	A	2	5	7	0	0	7	0	0
2	18701576	.	T	C	1	2	3	0	0	3	0	0
2	18701609	.	C	T	0	2	2	0	3	5	0	0
2	18701779	.	T	C	2	5	7	0	1	8	0	0
2	18701827	.	A	C	2	2	4	0	2	6	0	0
2	18701924	.	A	T	2	4	6	0	0	6	0	0
2	18702222	.	G	T	0	3	3	0	0	3	0	0
2	18702359	.	G	T	1	2	3	1	0	4	0	0
2	18702657	.	G	T	7	7	14	0	0	14	0	0
2	18702710	.	T	C	7	0	7	0	12	19	0	0
2	18702716	.	A	C	6	11	17	0	1	18	0	0
2	18702772	.	G	A	5	9	14	0	0	14	0	0
2	18702825	.	T	G	4	7	11	0	2	13	0	0
2	18703265	.	T	A	10	14	24	0	5	29	0	0
2	18703273	.	A	G	13	16	29	0	3	32	0	0
2	18703344	.	A	T	20	7	27	0	0	27	0	0
2	18703345	.	T	G	19	7	26	0	1	27	0	0
2	18714519	.	A	G	4	5	9	0	0	9	0	0
2	18725918	.	G	A	3	3	6	0	0	6	0	0
2	18735032	.	A	G	2	5	7	0	0	7	0	0
2	18735038	.	A	G	2	5	7	0	1	8	0	0
2	18830386	.	A	G	1	2	3	0	1	4	0	0
2	18990241	.	G	C	10	6	16	0	0	16	0	0
2	18991317	.	T	C	3	2	5	0	3	8	0	0
2	18991362	.	T	C	12	15	27	0	2	29	0	0
2	18992144	.	G	C	27	14	41	0	1	42	0	0
2	19100786	.	A	T	9	5	14	1	0	15	0	0
2	19100788	.	A	T	9	5	14	1	0	15	0	0
2	19101393	.	A	T	6	4	10	0	0	10	0	0
2	19101950	.	A	G	5	3	8	0	0	8	0	0
2	19273550	.	C	A	1	2	3	0	1	4	0	0
2	19280915	.	A	T	2	3	5	0	0	5	0	0
2	19794484	.	C	T	8	9	17	0	2	19	0	0
2	19794753	.	A	G	10	16	26	0	1	27	0	0
2	19794937	.	C	T	12	13	25	0	2	27	0	0
2	19795249	.	C	T	9	14	23	0	0	23	0	0
2	19795301	.	A	G	9	14	23	0	2	25	0	0
2	19795333	.	G	C	14	18	32	0	0	32	0	0
2	19795344	.	G	A	1	19	20	0	17	37	0	0
2	19795400	.	A	G	20	13	33	0	4	37	0	0
2	20368761	.	T	C	8	3	11	0	0	11	0	0
2	20369162	.	A	C	3	4	7	0	1	8	0	0
2	20369240	.	T	G	8	6	14	0	0	14	0	0
2	20370012	.	C	T	7	10	17	0	0	17	0	0
2	20438219	.	G	A	1	4	5	0	0	5	0	0
2	20438373	.	A	G	1	4	5	0	0	5	0	0
2	20438876	.	A	C	1	6	7	0	0	7	0	0
2	20439070	.	A	G	1	0	1	0	8	9	0	0
2	20439223	.	G	T	3	10	13	0	0	13	0	0
2	20439490	.	A	G	6	10	16	0	0	16	0	0
2	20442735	.	G	A	3	17	20	0	1	21	0	0
2	20511713	.	C	A	2	2	4	0	0	4	0	0
2	20511725	.	T	C	3	2	5	0	0	5	0	0
2	20511770	.	C	T	1	1	2	0	0	2	0	0
2	20515013	.	G	A	2	2	4	0	0	4	0	0
2	20515056	.	G	A	0	1	1	0	0	1	0	0
2	20515307	.	C	T	0	1	1	0	0	1	0	0
2	20520618	.	T	C	6	7	13	0	0	13	0	0
2	20520636	.	T	C	4	5	9	0	2	11	0	0
2	20523002	.	C	T	2	4	6	0	0	6	0	0
2	20523004	.	C	T	2	4	6	0	0	6	0	0
2	20523351	.	T	A	5	8	13	0	1	14	0	0
2	20523364	.	A	G	6	13	19	0	0	19	0	0
2	20526411	.	T	C	13	17	30	0	3	33	0	0
2	20526592	.	A	G	20	0	20	0	14	34	0	0
2	20526599	.	T	A	20	14	34	0	1	35	0	0
2	20662405	.	C	G	1	3	4	0	0	4	0	0
2	20811728	.	A	T	3	4	7	0	1	8	0	0
2	20811739	.	A	G	3	4	7	0	0	7	0	0
2	20811792	.	A	C	6	4	10	0	0	10	0	0
2	20814291	.	T	G	11	4	15	0	1	16	0	0
2	20814419	.	T	C	1	1	2	0	0	2	0	0
2	20814488	.	C	T	15	14	29	0	0	29	0	0
2	20819762	.	G	T	5	13	18	0	3	21	0	0
2	20828235	.	C	T	0	1	1	0	0	1	0	0
2	20828322	.	A	G	5	6	11	0	1	12	0	0
2	20830336	.	A	G	1	0	1	0	0	1	0	0
2	20830342	.	C	T	1	0	1	0	0	1	0	0
2	20830387	.	A	G	3	2	5	0	0	5	0	0
2	20830405	.	A	G	1	4	5	0	2	7	0	0
2	20830993	.	C	G	0	4	4	0	1	5	0	0
2	20840328	.	T	C	1	2	3	0	0	3	0	0
2	20872069	.	A	T	1	1	2	0	0	2	0	0
2	20872079	.	A	G	1	1	2	0	0	2	0	0
2	20875175	.	A	G	0	2	2	0	1	3	0	0
2	20875860	.	A	G	2	5	7	0	0	7	0	0
2	20882966	.	T	A	1	2	3	0	0	3	0	0
2	20882967	.	C	A	1	2	3	0	0	3	0	0
2	20883528	.	G	C	2	3	5	0	0	5	0	0
2	20883546	.	T	C	2	3	5	0	0	5	0	0
2	20916935	.	C	A	0	2	2	0	1	3	0	0
2	20973794	.	A	T	2	2	4	0	0	4	0	0
2	20974640	.	C	T	2	2	4	0	0	4	0	0
2	20975255	.	G	C	7	7	14	0	0	14	0	0
2	20975283	.	C	T	7	6	13	0	0	13	0	0
2	20975451	.	T	C	11	8	19	0	3	22	0	0
2	20975460	.	T	C	11	6	17	0	1	18	0	0
2	20980280	.	C	G	8	4	12	0	0	12	0	0
2	20980356	.	T	C	9	5	14	0	1	15	0	0
2	21076466	.	G	T	3	6	9	0	1	10	0	0
2	21076499	.	T	G	4	3	7	0	0	7	0	0
2	21077101	.	A	T	1	5	6	0	0	6	0	0
2	21077182	.	G	A	18	18	36	0	0	36	0	0
2	21077208	.	C	G	18	19	37	0	0	37	0	0
2	21077268	.	G	T	17	10	27	0	3	30	0	0
2	21077299	.	C	T	15	10	25	0	3	28	0	0
2	21077385	.	C	T	10	4	14	0	2	16	0	0
2	21077389	.	C	T	0	3	3	0	13	16	0	0
2	21077466	.	C	A	5	3	8	0	2	10	0	0
2	21077967	.	G	A	15	11	26	0	0	26	0	0
2	21079612	.	T	C	11	6	17	0	2	19	0	0
2	21080291	.	G	A	4	7	11	0	0	11	0	0
2	21081087	.	T	A	3	5	8	0	0	8	0	0
2	21082460	.	C	A	7	6	13	0	0	13	0	0
2	21156809	.	T	A	1	2	3	0	0	3	0	0
2	21165176	.	G	A	13	12	25	0	3	28	0	0
2	21166042	.	A	G	1	0	1	0	0	1	0	0
2	21167395	.	G	A	2	0	2	0	0	2	0	0
2	21179651	.	A	G	10	2	12	0	1	13	0	0
2	21179866	.	T	G	13	10	23	0	2	25	0	0
2	21179939	.	A	G	15	16	31	0	6	37	0	0
2	21182335	.	T	C	7	14	21	0	1	22	0	0
2	21182345	.	T	C	8	14	22	0	0	22	0	0
2	21182451	.	G	T	6	8	14	0	1	15	0	0
2	21320837	.	A	G	2	2	4	0	0	4	0	0
2	21338095	.	G	A	1	2	3	0	0	3	0	0
2	21338146	.	C	A	5	2	7	0	0	7	0	0
2	21463923	.	A	T	6	7	13	0	0	13	0	0
2	21468732	.	T	G	8	8	16	0	1	17	0	0
2	21468807	.	G	A	14	7	21	0	2	23	0	0
2	21468953	.	C	T	7	9	16	0	2	18	0	0
2	21469080	.	T	G	4	6	10	0	1	11	0	0
2	21469405	.	T	C	6	11	17	0	0	17	0	0
2	21469577	.	A	G	10	12	22	0	2	24	0	0
2	21469579	.	T	G	12	10	22	0	2	24	0	0
2	21469830	.	T	A	4	4	8	0	0	8	0	0
2	21502540	.	G	C	1	2	3	0	0	3	0	0
2	21503584	.	A	G	0	3	3	0	0	3	0	0
2	21608710	.	T	A	6	7	13	0	1	14	0	0
2	21608781	.	T	G	4	4	8	0	1	9	0	0
2	21608880	.	T	A	2	3	5	0	0	5	0	0
2	21610233	.	G	A	0	3	3	0	0	3	0	0
2	21612356	.	T	G	0	1	1	0	4	5	0	0
2	21620412	.	A	G	6	3	9	0	1	10	0	0
2	21620469	.	T	C	4	0	4	0	11	15	0	0
2	21620691	.	G	A	2	8	10	0	0	10	0	0
2	21620856	.	C	T	3	2	5	0	1	6	0	0
2	21621507	.	T	C	1	3	4	0	0	4	0	0
2	21621606	.	C	T	0	2	2	0	0	2	0	0
2	21765814	.	G	A	0	3	3	0	0	3	0	0
2	21766212	.	A	G	10	6	16	0	2	18	0	0
2	21766785	.	G	A	7	6	13	0	0	13	0	0
2	21767244	.	A	T	4	5	9	0	0	9	0	0
2	21768392	.	A	C	0	4	4	0	0	4	0	0
2	21768821	.	T	A	3	4	7	0	0	7	0	0
2	21770888	.	T	C	0	2	2	0	0	2	0	0
2	21771245	.	A	T	1	1	2	0	0	2	0	0
2	21821936	.	A	G	27	23	50	0	2	52	0	0
2	21822304	.	A	G	18	13	31	0	6	37	0	0
2	21823100	.	C	A	17	21	38	0	1	39	0	0
2	21827276	.	A	G	9	5	14	0	1	15	0	0
2	21869023	.	T	C	4	8	12	0	0	12	0	0
2	21877560	.	G	A	5	2	7	0	0	7	0	0
2	21877743	.	T	G	3	4	7	0	2	9	0	0
2	21877774	.	A	G	2	3	5	0	2	7	0	0
2	21877795	.	T	C	1	2	3	0	0	3	0	0
2	21877931	.	T	A	3	3	6	0	1	7	0	0
2	21878053	.	T	C	19	10	29	0	5	34	0	0
2	21878147	.	C	T	11	13	24	0	1	25	0	0
2	21878155	.	T	A	12	12	24	0	1	25	0	0
2	21878197	.	T	C	14	12	26	0	1	27	0	0
2	21878258	.	A	T	13	14	27	0	2	29	0	0
2	21878462	.	T	C	8	20	28	0	1	29	0	0
2	22058098	.	C	T	0	1	1	0	0	1	0	0
2	22071062	.	A	C	1	2	3	0	1	4	0	0
2	22101657	.	C	T	11	12	23	0	0	23	0	0
2	22101699	.	A	C	4	6	10	0	0	10	0	0
2	22104292	.	C	T	9	24	33	0	0	33	0	0
2	22104309	.	C	G	10	24	34	0	0	34	0	0
2	22104912	.	T	C	24	14	38	0	1	39	0	0
2	22104999	.	A	G	20	24	44	0	2	46	0	0
2	22208514	.	G	T	5	5	10	0	1	11	0	0
2	22208767	.	G	A	10	9	19	0	1	20	0	0
2	22208778	.	A	G	14	10	24	0	0	24	0	0
2	22209722	.	C	T	3	4	7	0	0	7	0	0
2	22209743	.	A	G	2	2	4	0	0	4	0	0
2	22209914	.	C	T	0	6	6	0	1	7	0	0
2	22209943	.	G	C	3	6	9	0	0	9	0	0
2	22353522	.	T	C	15	0	15	0	19	34	0	0
2	22353662	.	A	C	21	20	41	0	1	42	0	0
2	22353722	.	T	A	24	28	52	0	1	53	0	0
2	22353768	.	A	C	21	24	45	0	3	48	0	0
2	22353769	.	A	C	23	23	46	0	2	48	0	0
2	22353993	.	T	C	5	1	6	0	0	6	0	0
2	22362347	.	T	C	0	0	0	0	3	3	0	0
2	22396421	.	G	A	1	3	4	0	0	4	0	0
2	22396425	.	A	G	1	3	4	0	0	4	0	0
2	22397185	.	C	T	4	3	7	0	0	7	0	0
2	22397527	.	G	T	8	3	11	0	0	11	0	0
2	22397534	.	A	G	7	2	9	0	3	12	0	0
2	22397564	.	G	A	8	3	11	0	0	11	0	0
2	22397571	.	T	C	8	2	10	0	1	11	0	0
2	22480272	.	T	C	5	0	5	0	15	20	0	0
2	22480321	.	G	T	6	13	19	0	0	19	0	0
2	22480759	.	G	A	22	10	32	0	3	35	0	0
2	22483222	.	G	A	3	3	6	0	1	7	0	0
2	22483351	.	A	G	3	3	6	0	1	7	0	0
2	22483423	.	C	T	1	3	4	0	2	6	0	0
2	22483444	.	A	G	2	2	4	0	0	4	0	0
2	22507132	.	T	A	12	6	18	0	0	18	0	0
2	22517039	.	G	A	1	2	3	0	1	4	0	0
2	22517203	.	G	A	3	2	5	0	0	5	0	0
2	22565341	.	C	A	1	0	1	0	0	1	0	0
2	22602653	.	A	G	1	2	3	0	0	3	0	0
2	22602808	.	C	T	1	1	2	0	0	2	0	0
2	22612623	.	T	C	2	0	2	0	0	2	0	0
2	22614355	.	G	A	2	4	6	0	1	7	0	0
2	22614529	.	C	T	8	6	14	0	0	14	0	0
2	22614959	.	A	T	10	9	19	0	1	20	0	0
2	22614988	.	T	C	8	9	17	0	0	17	0	0
2	22615055	.	T	A	12	16	28	1	0	29	0	0
2	22615155	.	G	A	7	6	13	0	0	13	0	0
2	22617836	.	A	G	12	5	17	0	2	19	0	0
2	22617848	.	A	G	15	7	22	0	2	24	0	0
2	22617932	.	G	A	20	13	33	0	5	38	0	0
2	22626878	.	T	A	11	5	16	0	1	17	0	0
2	22628981	.	A	G	18	8	26	0	0	26	0	0
2	22629684	.	C	T	0	2	2	0	6	8	0	0
2	22633869	.	G	A	2	3	5	0	0	5	0	0
2	22634040	.	T	G	6	3	9	0	0	9	0	0
2	22634070	.	A	G	3	1	4	0	0	4	0	0
2	22656651	.	G	A	2	2	4	0	1	5	0	0
2	22656708	.	T	C	2	0	2	0	1	3	0	0
2	22756245	.	T	G	1	3	4	0	0	4	0	0
2	22756289	.	A	G	4	2	6	0	0	6	0	0
2	22756528	.	C	T	0	2	2	0	0	2	0	0
2	22801899	.	A	T	10	9	19	0	2	21	0	0
2	22802030	.	G	A	2	7	9	0	17	26	0	0
2	22803110	.	T	A	14	31	45	0	4	49	0	0
2	22803190	.	C	T	20	22	42	0	4	46	0	0
2	22803366	.	C	T	29	30	59	0	1	60	0	0
2	22803467	.	A	G	24	1	25	0	32	57	0	0
2	22860632	.	T	C	0	2	2	0	0	2	0	0
2	22932684	.	G	C	5	4	9	0	0	9	0	0
2	22932715	.	T	C	7	3	10	0	0	10	0	0
2	22932725	.	G	A	5	3	8	0	0	8	0	0
2	22932931	.	A	G	4	2	6	0	0	6	0	0
2	22933539	.	G	A	3	2	5	0	1	6	0	0
2	22933554	.	G	A	2	2	4	0	0	4	0	0
2	22970361	.	A	G	3	2	5	0	0	5	0	0
2	22970363	.	C	A	3	2	5	0	0	5	0	0
2	22970413	.	G	A	5	8	13	0	1	14	0	0
2	22970485	.	A	G	1	4	5	0	0	5	0	0
2	22970603	.	A	C	1	4	5	0	1	6	0	0
2	22994264	.	T	G	10	5	15	0	0	15	0	0
2	22994412	.	C	T	3	8	11	0	0	11	0	0
2	22996520	.	A	T	0	4	4	0	0	4	0	0
2	23004226	.	A	C	1	1	2	0	1	3	0	0
2	23004238	.	T	C	1	2	3	0	0	3	0	0
2	23023465	.	G	A	3	2	5	0	0	5	0	0
2	23023675	.	G	A	3	8	11	0	0	11	0	0
2	23023890	.	G	T	2	2	4	0	1	5	0	0
2	23024697	.	T	A	1	2	3	0	0	3	0	0
2	23024747	.	G	T	2	2	4	0	0	4	0	0
2	23061791	.	T	C	0	3	3	0	0	3	0	0
2	23073536	.	A	G	2	2	4	0	1	5	0	0
2	23077432	.	A	G	6	2	8	0	1	9	0	0
2	23077839	.	A	C	6	10	16	0	3	19	0	0
2	23078082	.	A	G	6	5	11	0	2	13	0	0
2	23078244	.	T	C	16	21	37	0	2	39	0	0
2	23098916	.	T	C	5	2	7	0	0	7	0	0
2	23099104	.	T	C	1	2	3	0	0	3	0	0
2	23099141	.	G	A	1	3	4	0	0	4	0	0
2	23099369	.	G	C	5	6	11	0	2	13	0	0
2	23165830	.	G	A	1	2	3	0	0	3	0	0
2	23292262	.	G	A	4	4	8	0	0	8	0	0
2	23292429	.	A	T	6	4	10	0	0	10	0	0
2	23292516	.	G	A	1	8	9	0	8	17	0	0
2	23292549	.	C	A	4	3	7	0	0	7	0	0
2	23292690	.	T	A	1	4	5	0	0	5	0	0
2	23293123	.	G	C	10	4	14	0	0	14	0	0
2	23293230	.	A	T	3	11	14	0	1	15	0	0
2	23293246	.	T	C	4	11	15	0	0	15	0	0
2	23361784	.	A	T	11	5	16	0	1	17	0	0
2	23379532	.	G	A	4	5	9	0	0	9	0	0
2	23379588	.	C	T	7	4	11	0	0	11	0	0
2	23379861	.	G	A	4	3	7	0	0	7	0	0
2	23723648	.	A	T	1	2	3	0	1	4	0	0
2	23725075	.	G	A	2	2	4	0	0	4	0	0
2	23725184	.	C	A	3	3	6	0	0	6	0	0
2	23725239	.	C	T	3	5	8	0	0	8	0	0
2	23725834	.	G	C	2	3	5	0	3	8	0	0
2	23725872	.	T	C	4	2	6	0	3	9	0	0
2	23726155	.	C	A	7	7	14	0	1	15	0	0
2	23726162	.	C	A	8	7	15	0	0	15	0	0
2	23726230	.	A	T	12	9	21	0	0	21	0	0
2	23819640	.	T	A	1	2	3	0	0	3	0	0
2	23819862	.	A	C	4	5	9	0	0	9	0	0
2	23937159	.	T	C	1	2	3	0	0	3	0	0
2	23937631	.	T	G	1	2	3	0	0	3	0	0
2	24218922	.	A	T	4	3	7	0	1	8	0	0
2	24219115	.	G	A	4	2	6	0	0	6	0	0
2	24222069	.	A	C	3	1	4	0	0	4	0	0
2	24223991	.	A	G	2	3	5	0	1	6	0	0
2	24238809	.	A	G	1	1	2	0	0	2	0	0
2	24248498	.	C	T	10	12	22	0	3	25	0	0
2	24248619	.	T	G	11	7	18	0	2	20	0	0
2	24248677	.	A	T	14	6	20	0	1	21	0	0
2	24248702	.	T	C	12	9	21	0	0	21	0	0
2	24248767	.	T	C	5	4	9	0	2	11	0	0
2	24248768	.	A	G	6	0	6	0	5	11	0	0
2	24248809	.	C	T	6	12	18	0	1	19	0	0
2	24248871	.	A	G	12	0	12	0	13	25	0	0
2	24249044	.	A	C	13	8	21	0	1	22	0	0
2	24249083	.	T	A	11	6	17	0	0	17	0	0
2	24249299	.	A	G	8	8	16	0	1	17	0	0
2	24249320	.	A	G	7	0	7	0	12	19	0	0
2	24249397	.	G	T	0	12	12	0	12	24	0	0
2	24249411	.	T	A	10	14	24	0	4	28	0	0
2	24249662	.	A	G	16	10	26	0	5	31	0	0
2	24249669	.	A	G	21	0	21	0	11	32	0	0
2	24250001	.	G	T	2	4	6	0	1	7	0	0
2	24250097	.	T	C	6	5	11	0	1	12	0	0
2	24250140	.	T	C	3	3	6	0	0	6	0	0
2	24250147	.	G	A	0	3	3	0	3	6	0	0
2	24250303	.	C	T	11	4	15	0	1	16	0	0
2	24250419	.	C	T	8	3	11	0	1	16	4	0
2	24250577	.	A	T	9	17	26	0	3	29	0	0
2	24250625	.	T	A	9	11	20	0	0	20	0	0
2	24250681	.	T	C	11	13	24	0	3	27	0	0
2	24250879	.	T	G	14	27	41	0	1	43	1	0
2	24250972	.	C	A	23	19	42	0	2	44	0	0
2	24251690	.	G	A	29	23	52	0	2	54	0	0
2	24251909	.	A	T	37	29	66	0	2	68	0	0
2	24252078	.	A	T	42	30	72	0	1	73	0	0
2	24252088	.	C	T	36	28	64	0	5	69	0	0
2	24252192	.	T	A	31	18	49	0	2	51	0	0
2	24252196	.	G	T	4	17	21	0	29	50	0	0
2	24310739	.	G	T	8	5	13	0	0	13	0	0
2	24310850	.	G	C	14	18	32	0	2	34	0	0
2	24310897	.	G	A	15	22	37	0	4	41	0	0
2	24311218	.	T	A	11	8	19	0	1	20	0	0
2	24311296	.	G	C	14	10	24	0	4	28	0	0
2	24311703	.	A	G	13	1	14	0	4	18	0	0
2	24313884	.	T	C	3	7	10	0	1	11	0	0
2	24313896	.	G	A	4	8	12	0	0	12	0	0
2	24314221	.	T	C	3	2	5	0	1	6	0	0
2	24316503	.	C	T	0	1	1	0	1	2	0	0
2	24317537	.	G	A	7	9	16	0	0	16	0	0
2	24319740	.	A	G	13	14	27	0	2	29	0	0
2	24320173	.	C	T	9	10	19	0	0	19	0	0
2	24321853	.	T	C	5	1	6	0	4	10	0	0
2	24322189	.	G	C	7	6	13	0	3	16	0	0
2	24326455	.	A	G	4	5	9	0	0	9	0	0
2	24381963	.	A	G	0	1	1	0	2	3	0	0
2	24385210	.	C	T	2	2	4	0	0	4	0	0
2	24385361	.	T	C	3	2	5	0	0	5	0	0
2	24385402	.	A	G	5	3	8	0	0	8	0	0
2	24385685	.	T	C	3	7	10	0	0	10	0	0
2	24385837	.	A	G	3	0	3	0	7	10	0	0
2	24410851	.	C	T	18	19	37	0	1	38	0	0
2	24410882	.	G	A	19	20	39	0	3	42	0	0
2	24411053	.	A	G	8	22	30	0	1	31	0	0
2	24411056	.	C	T	0	23	23	0	9	32	0	0
2	24411501	.	T	G	9	7	16	0	2	18	0	0
2	24411781	.	T	A	14	8	22	0	1	23	0	0
2	24411886	.	A	G	10	11	21	0	0	21	0	0
2	24411897	.	C	T	0	11	11	0	11	22	0	0
2	24411989	.	C	T	1	3	4	0	0	4	0	0
2	24412097	.	A	G	5	5	10	0	0	10	0	0
2	24412107	.	G	C	6	0	6	0	7	13	0	0
2	24412908	.	C	A	1	2	3	0	0	3	0	0
2	24413710	.	T	C	2	2	4	0	1	5	0	0
2	24413882	.	T	C	1	4	5	0	2	7	0	0
2	24414032	.	G	C	1	2	3	0	0	3	0	0
2	24432661	.	C	T	1	3	4	0	0	4	0	0
2	24558570	.	C	T	7	4	11	0	0	11	0	0
2	24558836	.	T	C	4	6	10	0	0	10	0	0
2	24559652	.	T	A	4	2	6	0	0	6	0	0
2	24560248	.	A	G	1	3	4	0	0	4	0	0
2	24560359	.	G	A	4	2	6	0	0	6	0	0
2	24560455	.	T	C	2	3	5	0	0	5	0	0
2	24683093	.	A	G	2	2	4	0	2	6	0	0
2	24683311	.	G	A	6	4	10	0	0	10	0	0
2	24751948	.	C	T	1	2	3	0	0	3	0	0
2	24751986	.	T	G	1	0	1	0	4	5	0	0
2	24751991	.	A	G	1	4	5	0	0	5	0	0
2	24752181	.	T	A	2	3	5	0	0	5	0	0
2	24752193	.	C	T	2	5	7	0	0	7	0	0
2	24752293	.	C	T	1	3	4	0	1	5	0	0
2	24754226	.	T	A	1	3	4	0	0	4	0	0
2	24754796	.	A	C	22	13	35	0	1	36	0	0
2	24755018	.	T	C	17	14	31	0	2	33	0	0
2	24767285	.	T	C	2	2	4	0	0	4	0	0
2	24767291	.	C	T	2	2	4	0	0	4	0	0
2	24770755	.	G	C	1	2	3	0	0	3	0	0
2	24773724	.	A	G	1	1	2	0	0	2	0	0
2	24773726	.	G	A	0	1	1	0	1	2	0	0
2	24774452	.	C	T	0	2	2	0	0	2	0	0
2	24778317	.	C	T	0	1	1	0	0	1	0	0
2	24865360	.	T	C	3	2	5	0	1	6	0	0
2	24865961	.	A	G	3	3	6	0	0	6	0	0
2	24866075	.	G	C	3	6	9	0	2	11	0	0
2	24866568	.	C	T	2	6	8	0	0	8	0	0
2	24877010	.	A	G	4	3	7	0	0	7	0	0
2	24877227	.	C	T	4	2	6	0	0	6	0	0
2	24877276	.	A	C	4	2	6	0	0	6	0	0
2	24878026	.	G	T	0	12	12	0	12	24	0	0
2	24878211	.	C	T	19	9	28	0	1	29	0	0
2	24878265	.	G	T	6	7	13	0	0	13	0	0
2	24878632	.	A	T	1	1	2	0	1	3	0	0
2	24943717	.	C	T	3	7	10	0	1	11	0	0
2	24943855	.	C	A	9	9	18	0	1	19	0	0
2	24944112	.	T	G	9	9	18	0	2	20	0	0
2	24944485	.	T	G	6	12	18	0	0	18	0	0
2	24944487	.	G	A	5	12	17	0	1	18	0	0
2	24947372	.	T	C	2	0	2	0	5	7	0	0
2	24949891	.	G	A	3	0	3	0	0	3	0	0
2	24952607	.	T	C	1	0	1	0	0	1	0	0
2	24991149	.	G	A	16	8	24	0	1	25	0	0
2	24991153	.	T	C	15	7	22	0	5	27	0	0
2	24991476	.	G	A	18	6	24	0	1	25	0	0
2	24991564	.	A	C	3	0	3	0	14	17	0	0
2	24991573	.	A	G	3	12	15	0	0	15	0	0
2	24991639	.	G	A	7	3	10	0	0	10	0	0
2	24991825	.	G	A	8	7	15	0	0	15	0	0
2	24992110	.	G	A	2	3	5	0	2	7	0	0
2	24992185	.	T	C	3	5	8	0	1	9	0	0
2	24992242	.	C	T	0	3	3	0	6	9	0	0
2	24992352	.	G	A	1	2	3	0	1	4	0	0
2	24992407	.	G	A	1	2	3	0	0	3	0	0
2	24992422	.	G	A	2	3	5	0	0	5	0	0
2	25105681	.	G	T	3	4	7	0	0	7	0	0
2	25105683	.	C	T	3	4	7	0	0	7	0	0
2	25106671	.	A	C	0	2	2	0	2	4	0	0
2	25106874	.	A	C	0	3	3	0	0	3	0	0
2	25107571	.	G	T	0	2	2	0	0	2	0	0
2	25107617	.	G	T	3	4	7	0	0	7	0	0
2	25107673	.	T	G	8	5	13	0	0	13	0	0
2	25107851	.	G	A	8	13	21	0	0	21	0	0
2	25107869	.	C	T	10	15	25	0	0	25	0	0
2	25107942	.	C	A	17	3	20	0	1	21	0	0
2	25108042	.	A	G	14	4	18	0	3	21	0	0
2	25108137	.	C	T	14	11	25	0	4	30	1	0
2	25108377	.	T	A	14	9	23	0	2	25	0	0
2	25108597	.	T	A	0	2	2	0	0	2	0	0
2	25108633	.	C	T	0	5	5	0	7	12	0	0
2	25119637	.	A	G	0	4	4	0	0	4	0	0
2	25119667	.	G	T	0	4	4	0	0	4	0	0
2	25127042	.	G	T	1	2	3	0	0	3	0	0
2	25127897	.	T	C	5	2	7	0	2	9	0	0
2	25128328	.	G	A	4	2	6	0	0	6	0	0
2	25128668	.	C	T	4	9	13	0	0	13	0	0
2	25128997	.	C	G	6	0	6	0	7	13	0	0
2	25129116	.	A	T	3	8	11	0	0	11	0	0
2	25631553	.	G	A	1	2	3	0	0	3	0	0
2	25809736	.	C	T	0	1	1	0	0	1	0	0
2	25814694	.	C	T	1	2	3	0	0	3	0	0
2	25815329	.	G	C	1	3	4	0	0	4	0	0
2	25815407	.	A	T	8	7	15	0	4	19	0	0
2	25815452	.	G	A	7	8	15	0	2	17	0	0
2	25815758	.	C	T	8	5	13	0	0	13	0	0
2	25988378	.	C	A	2	3	5	0	0	5	0	0
2	25988551	.	A	T	1	2	3	0	0	3	0	0
2	25988874	.	T	C	4	6	10	0	0	10	0	0
2	25989134	.	A	G	2	3	5	0	0	5	0	0
2	25989142	.	T	G	2	3	5	0	0	5	0	0
2	25989213	.	T	G	2	4	6	0	1	7	0	0
2	25989241	.	T	C	3	2	5	0	1	6	0	0
2	25989610	.	C	T	8	7	15	0	0	15	0	0
2	25989827	.	C	T	4	3	7	0	0	7	0	0
2	25989884	.	T	A	0	2	2	0	0	2	0	0
2	25989905	.	C	A	1	2	3	0	0	3	0	0
2	25990180	.	C	T	10	9	19	0	6	25	0	0
2	25990302	.	A	G	11	10	21	0	0	21	0	0
2	25990447	.	G	A	17	10	27	0	1	28	0	0
2	25990563	.	A	G	6	4	10	0	0	10	0	0
2	25990772	.	T	C	21	7	28	2	3	33	0	0
2	26207080	.	G	C	2	2	4	0	0	4	0	0
2	26207350	.	G	A	1	2	3	0	0	3	0	0
2	26207368	.	A	G	1	2	3	0	0	3	0	0
2	26207944	.	T	C	6	4	10	0	1	11	0	0
2	26207977	.	G	A	0	4	4	0	5	9	0	0
2	26208369	.	A	G	10	4	14	0	1	15	0	0
2	26208416	.	G	A	7	5	12	0	1	13	0	0
2	26208425	.	G	A	6	6	12	0	2	14	0	0
2	26208480	.	A	C	8	5	13	0	0	13	0	0
2	26208520	.	A	G	7	5	12	0	0	12	0	0
2	26208589	.	A	G	11	11	22	0	1	23	0	0
2	26208621	.	T	C	13	9	22	0	1	23	0	0
2	26208815	.	G	T	12	14	26	0	2	29	1	0
2	26208832	.	C	G	15	0	15	0	17	32	0	0
2	26208904	.	T	C	17	18	35	0	1	36	0	0
2	26208987	.	G	A	1	8	9	0	15	24	0	0
2	26209030	.	G	A	15	13	28	0	0	28	0	0
2	26209058	.	C	T	11	14	25	0	2	27	0	0
2	26209169	.	C	T	13	8	21	0	0	21	0	0
2	26209266	.	A	C	5	5	10	0	1	11	0	0
2	26240805	.	T	C	7	9	16	0	1	17	0	0
2	26240930	.	A	T	7	4	11	0	0	11	0	0
2	26278044	.	G	A	0	1	1	0	0	1	0	0
2	26282688	.	C	T	14	11	25	0	2	27	0	0
2	26282814	.	T	C	13	17	30	0	1	31	0	0
2	26283181	.	C	T	19	11	30	0	2	32	0	0
2	26283922	.	T	G	22	21	43	0	7	50	0	0
2	26284223	.	G	A	3	2	5	0	0	5	0	0
2	26300016	.	T	C	2	5	7	0	0	7	0	0
2	26300291	.	C	T	2	2	4	0	0	4	0	0
2	26422332	.	C	T	1	2	3	0	0	3	0	0
2	26443211	.	A	C	5	8	13	0	1	14	0	0
2	26443476	.	C	T	4	5	9	0	2	11	0	0
2	26443859	.	A	G	13	8	21	0	0	21	0	0
2	26444170	.	T	C	7	9	16	0	1	17	0	0
2	26463124	.	T	G	4	5	9	0	3	12	0	0
2	26463193	.	A	C	6	0	6	0	10	16	0	0
2	26463329	.	G	A	6	11	17	0	1	18	0	0
2	26463348	.	C	G	0	9	9	0	9	18	0	0
2	26463459	.	C	T	0	9	9	0	5	14	0	0
2	26463598	.	T	C	3	0	3	0	6	9	0	0
2	26463622	.	A	G	4	5	9	0	1	10	0	0
2	26468243	.	G	A	1	1	2	0	0	2	0	0
2	26470087	.	A	G	1	5	6	0	0	6	0	0
2	26470208	.	G	A	18	19	37	0	2	39	0	0
2	26470237	.	G	T	12	17	29	0	2	32	1	0
2	26470267	.	G	A	13	19	32	0	1	33	0	0
2	26470666	.	A	G	18	13	31	0	0	31	0	0
2	26473078	.	A	G	0	1	1	0	0	1	0	0
2	26473361	.	C	T	1	3	4	0	1	5	0	0
2	26479824	.	T	C	2	2	4	0	0	4	0	0
2	26489681	.	T	C	5	3	8	0	0	8	0	0
2	26491457	.	G	C	2	2	4	0	0	4	0	0
2	26491667	.	G	A	6	1	7	0	0	7	0	0
2	26491830	.	C	G	4	4	8	0	0	8	0	0
2	26612624	.	G	C	8	10	18	0	1	19	0	0
2	26612676	.	A	T	21	18	39	0	0	39	0	0
2	26612893	.	T	C	9	14	23	0	4	27	0	0
2	26613106	.	G	A	20	18	38	0	2	40	0	0
2	26617098	.	A	G	3	4	7	0	0	7	0	0
2	26619786	.	C	T	4	4	8	0	0	8	0	0
2	26620441	.	C	T	1	2	3	0	0	3	0	0
2	26623587	.	C	T	21	18	39	0	3	42	0	0
2	26623832	.	T	C	19	17	36	0	2	38	0	0
2	26627301	.	C	A	16	9	25	0	1	26	0	0
2	26627332	.	T	A	3	3	6	0	1	7	0	0
2	26630587	.	C	T	0	16	16	0	13	29	0	0
2	26630855	.	A	G	8	6	14	0	0	14	0	0
2	26631084	.	G	A	1	2	3	0	1	4	0	0
2	26639217	.	A	G	1	3	4	0	0	4	0	0
2	26665517	.	A	T	4	1	5	0	1	6	0	0
2	26665794	.	A	G	1	2	3	0	0	3	0	0
2	26665796	.	G	A	0	2	2	0	1	3	0	0
2	26672266	.	A	G	13	11	24	0	1	25	0	0
2	26672320	.	G	A	14	12	26	0	2	28	0	0
2	26672395	.	G	A	11	5	16	0	0	16	0	0
2	26672440	.	A	G	10	6	16	0	2	18	0	0
2	26672672	.	G	A	17	12	29	0	0	29	0	0
2	26672761	.	T	G	2	0	2	0	9	11	0	0
2	26677125	.	C	G	2	2	4	0	0	4	0	0
2	26681064	.	A	T	2	3	5	0	1	6	0	0
2	26681076	.	A	G	1	3	4	0	2	6	0	0
2	26681472	.	G	T	0	2	2	0	4	6	0	0
2	26681773	.	C	T	4	2	6	0	1	7	0	0
2	26681837	.	G	A	10	8	18	0	0	18	0	0
2	26682031	.	G	T	0	4	4	0	15	19	0	0
2	26686340	.	A	T	2	3	5	0	0	5	0	0
2	26686752	.	T	C	2	4	6	0	0	6	0	0
2	26688691	.	A	T	4	11	15	0	0	15	0	0
2	26688737	.	G	A	2	6	8	0	2	10	0	0
2	26688747	.	A	G	2	0	2	0	7	9	0	0
2	27064687	.	T	C	1	3	4	0	0	4	0	0
2	27075980	.	G	A	0	4	4	0	2	6	0	0
2	27377590	.	T	C	2	2	4	0	0	4	0	0
2	27378266	.	A	G	2	5	7	0	0	7	0	0
2	27378840	.	T	C	2	1	3	0	1	4	0	0
2	27379170	.	C	T	0	3	3	0	1	4	0	0
2	27380114	.	A	G	1	4	5	0	0	5	0	0
2	27380292	.	G	T	5	3	8	0	2	10	0	0
2	27380336	.	G	A	2	5	7	0	0	7	0	0
2	27380500	.	G	T	1	1	2	0	0	2	0	0
2	27542058	.	A	G	6	0	6	0	3	9	0	0
2	27542083	.	G	A	8	4	12	0	0	12	0	0
2	27543478	.	G	A	0	4	4	0	4	8	0	0
2	27543499	.	C	A	4	3	7	0	1	8	0	0
2	27614082	.	G	C	0	2	2	0	0	2	0	0
2	27659018	.	T	C	3	1	4	0	0	4	0	0
2	27663616	.	T	G	4	3	7	0	0	7	0	0
2	27663649	.	A	G	6	3	9	0	2	11	0	0
2	27664105	.	G	C	1	8	9	0	0	9	0	0
2	27664317	.	G	T	6	2	8	0	0	8	0	0
2	27664380	.	G	A	6	3	9	0	1	10	0	0
2	27664482	.	G	C	2	3	5	0	0	5	0	0
2	27664665	.	A	C	4	8	12	0	2	14	0	0
2	27670884	.	T	G	7	2	9	0	1	10	0	0
2	27670886	.	T	C	7	0	7	0	3	10	0	0
2	27671172	.	C	T	5	3	8	0	0	8	0	0
2	27671290	.	G	T	3	3	6	0	0	6	0	0
2	27671334	.	T	C	2	3	5	0	1	6	0	0
2	27672705	.	A	G	1	2	3	0	0	3	0	0
2	27812578	.	G	A	1	1	2	0	0	2	0	0
2	27933764	.	G	T	5	3	8	0	0	8	0	0
2	27957786	.	T	A	3	4	7	0	0	7	0	0
2	28049445	.	T	C	11	17	28	0	4	32	0	0
2	28049996	.	A	G	4	7	11	0	0	11	0	0
2	28050933	.	G	A	1	3	4	0	0	4	0	0
2	28649912	.	T	G	4	6	10	0	1	11	0	0
2	28649944	.	A	T	6	0	6	0	2	8	0	0
2	28650238	.	A	G	4	3	7	0	0	7	0	0
2	28650248	.	C	A	4	3	7	0	0	7	0	0
2	28650273	.	C	A	4	2	6	0	0	6	0	0
2	28650309	.	A	T	4	5	9	0	1	10	0	0
2	28650352	.	A	C	4	4	8	0	0	8	0	0
2	28650358	.	T	A	3	4	7	0	2	9	0	0
2	28650422	.	T	C	3	6	9	0	0	9	0	0
2	28650504	.	T	C	3	3	6	0	1	7	0	0
2	28650521	.	G	A	5	2	7	0	0	8	1	0
2	28651077	.	C	G	0	5	5	0	6	11	0	0
2	28651128	.	T	A	1	5	6	0	1	7	0	0
2	28651193	.	A	G	3	4	7	0	0	7	0	0
2	28651497	.	G	A	0	2	2	0	1	3	0	0
2	29310996	.	G	A	0	1	1	0	1	2	0	0
2	29317718	.	G	A	4	2	6	0	0	6	0	0
2	29352333	.	G	A	0	7	7	0	8	15	0	0
2	29352479	.	C	T	5	9	14	0	0	14	0	0
2	29477538	.	A	G	1	2	3	0	0	3	0	0
2	29477733	.	A	T	10	18	28	0	3	31	0	0
2	29477769	.	G	T	8	18	26	0	2	28	0	0
2	29477895	.	A	T	12	8	20	0	0	20	0	0
2	29477979	.	T	G	7	4	11	0	0	11	0	0
2	29484113	.	A	G	3	4	7	0	1	8	0	0
2	29485046	.	G	A	1	2	3	0	0	3	0	0
2	29485381	.	T	C	2	2	4	0	0	4	0	0
2	29726806	.	A	T	0	1	1	0	0	1	0	0
2	29905111	.	T	A	1	1	2	0	1	3	0	0
2	29976960	.	T	A	5	3	8	0	0	8	0	0
2	29986517	.	T	C	1	2	3	0	0	3	0	0
2	30106271	.	A	G	4	3	7	0	1	8	0	0
2	30108443	.	T	C	3	4	7	0	0	7	0	0
2	30108456	.	T	C	5	5	10	0	0	10	0	0
2	30109678	.	C	T	2	2	4	0	1	5	0	0
2	30116206	.	C	T	7	6	13	0	0	13	0	0
2	30116688	.	A	C	1	3	4	0	0	4	0	0
2	30116711	.	G	A	0	3	3	0	2	5	0	0
2	30117169	.	T	C	4	2	6	0	1	7	0	0
2	30178100	.	C	T	2	7	9	0	0	9	0	0
2	30194777	.	C	T	7	3	10	0	2	12	0	0
2	30194938	.	G	A	3	4	7	0	0	7	0	0
2	30195040	.	A	G	0	1	1	0	0	1	0	0
2	30245900	.	G	C	5	15	20	0	1	21	0	0
2	30245922	.	T	C	8	21	29	0	1	30	0	0
2	30246029	.	T	A	19	14	33	0	1	34	0	0
2	30251864	.	G	T	4	3	7	0	0	7	0	0
2	30252029	.	T	C	3	8	11	0	0	11	0	0
2	30252071	.	G	A	0	5	5	0	6	11	0	0
2	30252206	.	T	C	2	2	4	0	1	5	0	0
2	30291072	.	A	C	7	8	15	0	2	17	0	0
2	30295288	.	A	G	1	3	4	0	0	4	0	0
2	30429710	.	A	T	8	4	12	0	0	12	0	0
2	30429711	.	T	C	8	3	11	0	1	12	0	0
2	30458754	.	G	A	25	10	35	0	1	36	0	0
2	30460135	.	A	G	2	3	5	0	2	7	0	0
2	30524966	.	C	T	7	9	16	0	0	16	0	0
2	30524992	.	T	C	8	10	18	0	0	18	0	0
2	30525062	.	A	G	6	7	13	0	1	14	0	0
2	30525105	.	A	G	7	6	13	0	1	14	0	0
2	30525117	.	C	T	11	8	19	0	0	19	0	0
2	30525169	.	G	T	0	3	3	0	11	14	0	0
2	30525378	.	C	A	1	3	4	0	1	5	0	0
2	30525596	.	A	G	9	0	9	0	14	23	0	0
2	30525970	.	A	G	19	11	30	0	0	30	0	0
2	30526671	.	G	T	4	2	6	0	2	8	0	0
2	30554512	.	G	A	12	15	27	0	2	29	0	0
2	30555882	.	T	A	6	3	9	0	0	9	0	0
2	30556102	.	C	A	0	11	11	0	6	17	0	0
2	30556103	.	G	T	6	10	16	0	1	17	0	0
2	30556386	.	G	A	4	5	9	0	3	12	0	0
2	30556419	.	G	T	6	4	10	0	2	12	0	0
2	30561285	.	T	C	2	3	5	0	0	5	0	0
2	30741192	.	C	T	2	4	6	0	0	6	0	0
2	30747874	.	G	T	5	4	9	0	1	10	0	0
2	30752796	.	G	A	2	5	7	0	1	8	0	0
2	30753813	.	G	A	3	9	12	0	0	12	0	0
2	30753888	.	A	G	2	4	6	0	0	6	0	0
2	30753899	.	C	T	2	4	6	0	0	6	0	0
2	30754030	.	A	T	3	6	9	0	1	10	0	0
2	30754306	.	G	A	9	7	16	0	1	17	0	0
2	30754733	.	A	G	3	2	5	0	0	5	0	0
2	30754741	.	A	G	4	2	6	0	0	6	0	0
2	30754885	.	A	T	4	4	8	0	0	8	0	0
2	30754894	.	A	T	3	3	6	0	1	7	0	0
2	30755272	.	T	C	1	0	1	0	5	6	0	0
2	30755278	.	C	A	0	3	3	0	2	5	0	0
2	30755345	.	T	G	2	3	5	0	0	5	0	0
2	30755359	.	A	T	3	3	6	0	0	6	0	0
2	30755482	.	A	T	2	2	4	0	0	4	0	0
2	30755733	.	A	T	2	2	4	0	0	4	0	0
2	30756726	.	G	A	1	2	3	0	0	3	0	0
2	30794792	.	T	C	1	0	1	0	0	1	0	0
2	30821859	.	G	A	6	12	18	0	0	18	0	0
2	30821965	.	C	T	8	5	13	0	1	14	0	0
2	30846719	.	A	G	23	12	35	0	3	38	0	0
2	30897990	.	C	T	1	3	4	0	0	4	0	0
2	30898196	.	T	C	2	0	2	0	0	2	0	0
2	30900945	.	G	C	2	11	13	0	1	14	0	0
2	30900994	.	T	A	11	12	23	0	0	24	1	0
2	30901060	.	A	G	10	1	11	0	10	21	0	0
2	30904137	.	G	A	2	4	6	0	0	6	0	0
2	30905298	.	G	A	2	2	4	0	0	4	0	0
2	30906386	.	C	T	1	0	1	0	0	1	0	0
2	30907655	.	T	A	13	10	23	0	1	24	0	0
2	30908006	.	A	T	7	3	10	0	0	10	0	0
2	30982409	.	T	C	3	3	6	0	0	6	0	0
2	30982612	.	T	C	5	4	9	0	0	9	0	0
2	30982640	.	A	G	4	4	8	0	1	9	0	0
2	30982897	.	A	G	3	6	9	0	0	9	0	0
2	30982929	.	T	A	2	3	5	0	1	6	0	0
2	30983267	.	G	A	7	3	10	0	2	13	1	0
2	30983294	.	T	C	11	6	17	0	0	17	0	0
2	31297980	.	A	G	16	14	30	0	5	35	0	0
2	31298077	.	A	G	10	23	33	0	4	37	0	0
2	31298280	.	A	G	21	14	35	0	0	35	0	0
2	31298342	.	G	A	22	16	38	0	4	42	0	0
2	31298483	.	C	A	20	14	34	0	2	36	0	0
2	31298550	.	T	C	11	10	21	0	0	21	0	0
2	31298703	.	T	G	12	12	24	0	0	24	0	0
2	31298723	.	C	T	14	12	26	0	0	26	0	0
2	31298824	.	A	C	18	15	33	0	0	33	0	0
2	31299241	.	A	C	6	2	8	0	1	9	0	0
2	31362285	.	A	G	8	4	12	0	1	13	0	0
2	31362642	.	T	C	4	4	8	0	0	8	0	0
2	31362681	.	T	C	3	1	4	0	1	5	0	0
2	31362730	.	A	T	3	6	9	0	0	9	0	0
2	31362859	.	T	A	4	7	11	0	3	14	0	0
2	31362896	.	T	C	7	10	17	0	0	17	0	0
2	31363190	.	C	T	16	16	32	0	1	33	0	0
2	31363322	.	A	T	7	4	11	0	0	11	0	0
2	31451568	.	C	T	1	2	3	0	0	3	0	0
2	31451778	.	G	T	7	6	13	0	1	14	0	0
2	31451871	.	T	A	6	6	12	0	0	12	0	0
2	31452078	.	C	T	11	15	26	0	1	27	0	0
2	31452226	.	T	C	23	19	42	0	1	43	0	0
2	31452354	.	C	T	25	25	50	0	0	51	1	0
2	31511760	.	C	A	4	2	6	0	0	6	0	0
2	31511763	.	C	T	4	1	5	0	1	6	0	0
2	31511945	.	G	A	1	3	4	0	1	5	0	0
2	31511946	.	G	A	1	4	5	0	0	5	0	0
2	31627150	.	C	A	9	8	17	0	0	18	1	0
2	31627173	.	C	T	11	10	21	0	0	21	0	0
2	31627212	.	C	G	13	9	22	0	1	23	0	0
2	31627219	.	C	T	14	8	22	0	1	23	0	0
2	31627423	.	C	G	1	5	6	0	3	9	0	0
2	31630129	.	A	T	5	4	9	0	0	9	0	0
2	31630443	.	G	A	0	1	1	0	0	1	0	0
2	31634870	.	A	G	3	6	9	0	0	9	0	0
2	31634929	.	A	C	6	6	12	0	0	12	0	0
2	31635007	.	A	T	5	5	10	0	1	11	0	0
2	31635161	.	A	G	5	2	7	0	0	7	0	0
2	31635229	.	C	T	6	5	11	0	0	11	0	0
2	31635287	.	T	C	9	6	15	0	2	17	0	0
2	31635395	.	T	G	5	4	9	0	1	10	0	0
2	31635490	.	A	T	5	8	13	0	1	14	0	0
2	31635599	.	T	C	8	5	13	0	0	13	0	0
2	31635803	.	G	T	1	10	11	0	3	14	0	0
2	31635824	.	C	T	4	3	7	0	1	8	0	0
2	31638004	.	C	T	0	4	4	0	0	4	0	0
2	31638064	.	G	A	2	5	7	0	1	8	0	0
2	31638111	.	G	T	3	2	5	0	0	5	0	0
2	31638124	.	G	A	4	3	7	0	0	7	0	0
2	31687697	.	G	A	2	5	7	0	0	7	0	0
2	31690434	.	T	A	6	16	22	0	0	22	0	0
2	31690442	.	A	C	6	10	16	0	4	20	0	0
2	31692370	.	T	C	1	2	3	0	0	3	0	0
2	31700250	.	A	C	2	4	6	0	1	7	0	0
2	31700352	.	A	T	2	4	6	0	0	6	0	0
2	31700378	.	T	G	1	1	2	0	0	2	0	0
2	31703368	.	T	A	0	3	3	0	0	3	0	0
2	31703407	.	A	G	2	4	6	0	0	6	0	0
2	31703443	.	C	T	2	1	3	0	0	3	0	0
2	31735068	.	T	G	2	3	5	0	0	5	0	0
2	31806920	.	C	T	1	2	3	0	0	3	0	0
2	31820830	.	T	C	3	4	7	0	1	8	0	0
2	31821290	.	C	A	1	2	3	0	1	4	0	0
2	31826750	.	C	T	16	22	38	0	2	40	0	0
2	31826925	.	C	A	0	4	4	0	2	6	0	0
2	31826929	.	C	A	2	3	5	0	2	7	0	0
2	31827649	.	A	G	8	9	17	0	0	17	0	0
2	31830252	.	C	T	2	2	4	0	1	5	0	0
2	31830367	.	A	G	3	3	6	0	0	6	0	0
2	31830382	.	C	A	4	5	9	0	0	9	0	0
2	31830410	.	G	A	6	3	9	0	0	9	0	0
2	31833082	.	C	T	1	4	5	0	0	5	0	0
2	31834187	.	C	T	3	4	7	0	0	7	0	0
2	31836113	.	T	G	8	8	16	0	2	18	0	0
2	31836119	.	G	T	0	7	7	0	10	17	0	0
2	31836307	.	T	A	25	13	38	0	0	38	0	0
2	31836588	.	T	C	4	4	8	0	0	8	0	0
2	31891344	.	T	A	16	16	32	0	0	34	2	0
2	31891447	.	A	T	24	16	40	0	2	42	0	0
2	31891513	.	T	C	14	27	41	0	3	44	0	0
2	31891549	.	C	A	18	27	45	0	4	49	0	0
2	31891618	.	A	G	31	20	51	0	1	52	0	0
2	31892076	.	A	G	20	12	32	0	1	33	0	0
2	31892100	.	C	T	0	20	20	0	23	43	0	0
2	31894220	.	T	C	7	3	10	0	0	10	0	0
2	31901953	.	T	C	2	2	4	0	0	4	0	0
2	31902939	.	G	A	2	1	3	0	0	3	0	0
2	31902954	.	C	T	2	3	5	0	0	5	0	0
2	31919171	.	G	A	1	1	2	0	0	2	0	0
2	31943187	.	A	G	1	3	4	0	0	4	0	0
2	31948424	.	A	G	1	4	5	0	0	5	0	0
2	31948438	.	A	G	0	5	5	0	1	6	0	0
2	31948459	.	C	T	1	5	6	0	1	7	0	0
2	31987352	.	A	C	1	1	2	0	0	2	0	0
2	31987360	.	C	T	1	1	2	0	0	2	0	0
2	31989876	.	T	C	3	3	6	0	0	6	0	0
2	31993886	.	T	C	2	1	3	0	0	3	0	0
2	32005371	.	G	A	8	6	14	0	2	16	0	0
2	32018077	.	A	C	4	12	16	0	1	17	0	0
2	32018141	.	A	G	3	0	3	0	6	9	0	0
2	32264412	.	C	T	5	1	6	0	1	7	0	0
2	32264879	.	G	A	7	8	15	0	1	16	0	0
2	32264927	.	T	A	11	5	16	0	0	16	0	0
2	32265437	.	T	A	9	7	16	0	0	16	0	0
2	32265508	.	T	C	5	5	10	0	0	10	0	0
2	32265543	.	A	T	4	4	8	0	0	8	0	0
2	32265890	.	G	T	7	2	9	0	0	9	0	0
2	32266064	.	G	C	4	5	9	0	0	9	0	0
2	32266101	.	T	G	2	1	3	0	0	3	0	0
2	32266383	.	C	T	1	0	1	0	1	2	0	0
2	32266711	.	C	T	0	4	4	0	3	7	0	0
2	32266895	.	A	G	1	4	5	0	0	5	0	0
2	32267105	.	T	G	2	10	12	0	0	12	0	0
2	32267117	.	C	T	0	10	10	0	3	13	0	0
2	32267506	.	T	C	1	2	3	0	0	3	0	0
2	32270976	.	T	C	2	2	4	0	0	4	0	0
2	32357811	.	G	A	18	8	26	0	2	28	0	0
2	32358059	.	T	C	9	0	9	0	15	24	0	0
2	32358081	.	A	T	9	12	21	0	2	23	0	0
2	32361446	.	A	T	2	5	7	0	0	7	0	0
2	32361447	.	G	T	2	5	7	0	0	7	0	0
2	32366137	.	T	C	1	2	3	0	0	3	0	0
2	32366191	.	C	T	8	6	14	0	1	15	0	0
2	32392166	.	A	G	1	2	3	0	0	3	0	0
2	32392244	.	C	G	1	2	3	0	0	3	0	0
2	32392724	.	A	G	3	3	6	0	1	7	0	0
2	32392988	.	T	C	3	3	6	0	1	7	0	0
2	32393062	.	A	T	3	2	5	0	0	5	0	0
2	32393064	.	G	T	3	2	5	0	0	5	0	0
2	32393259	.	A	G	1	3	4	0	1	5	0	0
2	32393281	.	T	A	2	3	5	0	0	5	0	0
2	32393579	.	T	C	1	2	3	0	0	3	0	0
2	32475941	.	A	T	3	9	12	0	0	12	0	0
2	32476288	.	C	T	8	18	26	0	2	28	0	0
2	32479556	.	T	C	3	0	3	0	9	12	0	0
2	32479616	.	G	A	1	0	1	0	0	1	0	0
2	32485832	.	A	G	2	2	4	0	0	4	0	0
2	32485895	.	C	T	0	5	5	0	3	8	0	0
2	32505664	.	G	A	4	9	13	0	2	15	0	0
2	32505713	.	A	G	11	4	15	1	4	20	0	0
2	32505715	.	A	G	15	0	15	1	4	20	0	0
2	32509247	.	G	A	4	2	6	0	0	6	0	0
2	32515897	.	C	T	4	5	9	0	1	10	0	0
2	32515909	.	A	C	6	6	12	0	0	12	0	0
2	32516268	.	C	A	0	10	10	0	9	19	0	0
2	32516509	.	A	T	5	4	9	0	0	9	0	0
2	32519690	.	G	A	2	2	4	0	0	4	0	0
2	32561572	.	T	A	9	2	11	0	1	12	0	0
2	32577552	.	C	A	9	12	21	0	1	22	0	0
2	32578124	.	A	T	11	10	21	0	1	22	0	0
2	32578330	.	A	G	5	7	12	0	0	12	0	0
2	32578519	.	C	T	3	4	7	1	1	9	0	0
2	32578642	.	A	G	9	11	20	0	1	21	0	0
2	32579109	.	C	T	2	4	6	0	1	7	0	0
2	32579165	.	G	A	2	0	2	0	1	3	0	0
2	32579166	.	C	A	5	0	5	0	0	5	0	0
2	32583600	.	A	G	2	2	4	0	0	4	0	0
2	32583629	.	A	C	2	0	2	0	3	5	0	0
2	32583639	.	T	C	2	0	2	0	3	5	0	0
2	32590861	.	A	G	1	2	3	0	0	3	0	0
2	32624026	.	A	T	1	0	1	0	0	1	0	0
2	32624027	.	C	T	0	0	0	0	1	1	0	0
2	32637102	.	T	A	1	3	4	0	0	4	0	0
2	32637145	.	G	C	2	2	4	0	0	4	0	0
2	32637352	.	T	C	1	1	2	0	0	2	0	0
2	32637366	.	G	A	1	1	2	0	0	2	0	0
2	32654034	.	A	G	8	6	14	0	1	15	0	0
2	32654040	.	T	C	9	0	9	0	11	20	0	0
2	32654570	.	T	C	23	11	34	0	1	35	0	0
2	32655542	.	T	C	10	0	10	0	18	28	0	0
2	32824526	.	A	G	1	2	3	0	0	3	0	0
2	32828704	.	C	T	1	2	3	0	0	3	0	0
2	32830129	.	A	G	0	1	1	0	0	1	0	0
2	32833524	.	T	C	4	1	5	0	0	5	0	0
2	32833563	.	T	G	2	2	4	0	0	4	0	0
2	32833590	.	C	T	1	0	1	0	1	2	0	0
2	33645157	.	A	G	2	2	4	0	0	4	0	0
2	33681337	.	A	T	19	10	29	0	5	34	0	0
2	34022992	.	T	A	0	2	2	0	0	2	0	0
2	34024832	.	A	G	1	3	4	0	0	4	0	0
2	34025167	.	G	A	1	5	6	0	1	7	0	0
2	34122985	.	C	T	2	1	3	0	0	3	0	0
2	34126040	.	T	C	2	2	4	0	0	4	0	0
2	34126514	.	G	T	2	4	6	0	0	6	0	0
2	34173253	.	C	T	3	4	7	0	0	7	0	0
2	34173335	.	A	C	6	4	10	0	0	10	0	0
2	34173336	.	G	A	6	4	10	0	0	10	0	0
2	34381013	.	T	G	2	9	11	0	0	11	0	0
2	34381032	.	T	C	4	8	12	0	1	13	0	0
2	34381066	.	C	T	7	5	12	0	0	12	0	0
2	34924412	.	A	G	4	5	9	0	0	9	0	0
2	34982392	.	C	T	2	1	3	0	1	4	0	0
2	34982398	.	G	A	2	2	4	0	0	4	0	0
2	35473715	.	G	A	0	2	2	0	2	4	0	0
2	35593848	.	T	C	10	10	20	0	2	22	0	0
2	35594003	.	G	A	9	8	17	0	2	19	0	0
2	35595551	.	A	T	5	2	7	0	0	7	0	0
2	35595561	.	A	G	3	2	5	0	0	5	0	0
2	35596842	.	A	G	4	11	15	0	0	15	0	0
2	35598219	.	A	T	1	3	4	0	0	4	0	0
2	35598257	.	C	G	1	1	2	0	1	3	0	0
2	35605429	.	C	T	1	2	3	0	0	3	0	0
2	35607077	.	G	C	0	1	1	0	0	1	0	0
2	35607191	.	C	T	1	2	3	0	0	3	0	0
2	35607206	.	C	T	1	2	3	0	0	3	0	0
2	35607472	.	T	C	2	1	3	0	1	4	0	0
2	35610541	.	T	C	4	22	26	0	0	26	0	0
2	35610598	.	T	C	7	17	24	0	1	25	0	0
2	35611279	.	C	T	13	17	30	0	2	32	0	0
2	35611595	.	T	G	17	20	37	0	0	37	0	0
2	35731054	.	A	T	4	2	6	0	0	6	0	0
2	35837510	.	G	A	0	2	2	0	0	2	0	0
2	35842020	.	G	A	2	1	3	0	2	5	0	0
2	35843812	.	G	A	7	5	12	0	2	14	0	0
2	35844433	.	A	G	3	9	12	0	1	13	0	0
2	35846511	.	A	G	2	0	2	0	2	4	0	0
2	35851152	.	C	T	5	4	9	0	0	9	0	0
2	35861746	.	T	C	0	1	1	0	0	1	0	0
2	35862971	.	T	C	2	0	2	0	1	3	0	0
2	35866515	.	T	G	1	4	5	0	1	6	0	0
2	35866593	.	G	A	3	0	3	0	0	3	0	0
2	35866787	.	T	C	1	0	1	0	0	1	0	0
2	35868275	.	T	G	1	1	2	0	0	2	0	0
2	35868319	.	A	G	4	3	7	0	1	8	0	0
2	35868568	.	G	A	1	1	2	0	1	3	0	0
2	35868896	.	A	G	5	2	7	0	0	7	0	0
2	36028957	.	G	A	4	4	8	0	0	8	0	0
2	36040733	.	T	C	5	7	12	0	0	12	0	0
2	36067842	.	A	C	2	2	4	0	0	4	0	0
2	36067849	.	A	G	1	0	1	0	3	4	0	0
2	36076419	.	T	G	3	3	6	0	0	6	0	0
2	36077384	.	A	G	1	5	6	0	6	12	0	0
2	36077542	.	T	C	8	13	21	0	2	23	0	0
2	36077543	.	T	G	9	0	9	0	14	23	0	0
2	36077664	.	C	T	9	10	19	0	1	20	0	0
2	36078370	.	T	G	19	15	34	0	3	37	0	0
2	36664493	.	T	G	17	10	27	0	1	28	0	0
2	36664545	.	A	G	17	11	28	0	4	32	0	0
2	36664679	.	C	G	15	10	25	0	4	29	0	0
2	36664799	.	G	T	16	14	30	0	1	31	0	0
2	36668765	.	G	A	4	5	9	0	0	9	0	0
2	36670595	.	A	G	5	2	7	0	1	8	0	0
2	36670778	.	G	A	3	2	5	0	0	5	0	0
2	36670785	.	T	G	3	3	6	0	0	6	0	0
2	36673643	.	T	A	0	2	2	0	0	2	0	0
2	36673805	.	C	T	5	4	9	0	0	9	0	0
2	36673866	.	G	T	6	4	10	0	1	11	0	0
2	36919311	.	T	C	2	3	5	0	0	5	0	0
2	36920626	.	G	A	6	2	8	0	2	10	0	0
2	37124443	.	C	A	15	4	19	0	2	21	0	0
2	37124546	.	G	A	4	3	7	0	5	12	0	0
2	38153929	.	G	A	0	2	2	0	1	3	0	0
2	38214974	.	T	G	9	2	11	3	2	17	1	0
2	39554863	.	A	G	24	6	30	0	1	32	1	0
2	39554873	.	A	G	21	6	27	0	1	28	0	0
2	39584876	.	C	A	6	2	8	0	0	8	0	0
2	39731366	.	A	C	0	6	6	0	6	12	0	0
2	39733552	.	T	C	5	2	7	0	0	7	0	0
2	43595847	.	A	G	2	1	3	0	0	3	0	0
2	44925081	.	A	G	3	2	5	0	0	5	0	0
2	47955423	.	T	C	8	4	12	0	2	14	0	0
2	47955510	.	T	C	6	5	11	0	0	11	0	0
2	47955535	.	T	C	4	5	9	0	0	9	0	0
2	49007869	.	T	C	25	7	32	0	1	33	0	0
2	49008049	.	G	T	6	0	6	0	7	13	0	0
2	49008124	.	T	A	1	8	9	0	0	9	0	0
2	50099823	.	G	T	3	2	5	0	0	5	0	0
2	52060070	.	T	G	1	2	3	0	0	3	0	0
2	52060365	.	C	T	0	1	1	0	0	1	0	0
2	52060390	.	T	C	1	2	3	0	0	3	0	0
2	52060409	.	A	G	4	2	6	0	1	7	0	0
2	52060450	.	G	A	4	3	7	0	3	10	0	0
2	52060492	.	A	T	2	0	2	0	1	3	0	0
2	52062918	.	G	A	0	10	10	0	12	22	0	0
2	52062989	.	T	A	5	6	11	0	0	11	0	0
2	52063101	.	T	A	3	4	7	0	0	7	0	0
2	52063126	.	T	C	3	2	5	0	0	5	0	0
2	52063207	.	T	C	5	8	13	0	1	14	0	0
2	52063208	.	C	T	4	8	12	0	2	14	0	0
2	52063250	.	C	G	7	9	16	0	0	16	0	0
2	53720058	.	G	C	0	1	1	0	1	2	0	0
2	53720098	.	A	G	1	0	1	0	1	2	0	0
2	53750707	.	C	T	2	3	5	0	0	5	0	0
2	53750719	.	C	T	1	3	4	0	1	5	0	0
2	54777537	.	A	T	4	2	6	0	0	6	0	0
2	54832298	.	A	G	2	2	4	0	1	5	0	0
2	55444825	.	C	G	1	4	5	0	0	5	0	0
2	55444831	.	A	G	1	4	5	0	0	5	0	0
2	55489383	.	T	A	6	3	9	0	0	9	0	0
2	55490232	.	T	C	4	5	9	0	4	13	0	0
2	55490313	.	C	T	5	3	8	0	0	8	0	0
2	55490348	.	G	A	8	5	13	0	0	13	0	0
2	55490434	.	A	G	5	0	5	0	7	12	0	0
2	55490521	.	T	C	10	4	14	0	0	14	0	0
2	55490841	.	T	C	3	4	7	1	1	9	0	0
2	55490857	.	T	A	3	5	8	1	0	9	0	0
2	55490934	.	G	T	11	9	20	0	0	20	0	0
2	55491471	.	C	T	14	19	33	0	4	37	0	0
2	55491666	.	G	A	13	11	24	0	2	26	0	0
2	55491717	.	G	A	15	18	33	0	0	33	0	0
2	55491754	.	C	A	16	20	36	0	0	36	0	0
2	55491884	.	T	C	8	21	29	0	6	35	0	0
2	55491893	.	T	C	10	20	30	0	1	31	0	0
2	55491945	.	A	T	17	15	32	0	0	32	0	0
2	55492064	.	T	C	17	14	31	0	8	39	0	0
2	55492104	.	T	C	15	12	27	0	1	28	0	0
2	55492108	.	A	G	15	0	15	0	14	29	0	0
2	55492285	.	T	C	3	4	7	0	0	7	0	0
2	55492286	.	C	T	2	4	6	0	1	7	0	0
2	55670614	.	G	C	5	4	9	0	0	9	0	0
2	55670652	.	C	A	6	3	9	0	0	9	0	0
2	55967188	.	T	C	2	4	6	0	0	6	0	0
2	55967233	.	C	T	1	3	4	0	0	4	0	0
2	55967471	.	A	T	2	6	8	0	0	8	0	0
2	55967638	.	T	A	7	5	12	0	0	12	0	0
2	55967667	.	C	T	6	7	13	0	1	14	0	0
2	55967758	.	T	C	3	8	11	0	0	11	0	0
2	55967987	.	T	G	2	2	4	0	0	4	0	0
2	55968123	.	C	A	5	1	6	0	0	6	0	0
2	55968147	.	T	C	5	3	8	0	0	8	0	0
2	55968204	.	A	G	1	4	5	0	1	6	0	0
2	55968240	.	C	T	5	5	10	0	1	11	0	0
2	55968294	.	G	T	3	4	7	0	1	8	0	0
2	55968383	.	A	C	6	7	13	0	1	14	0	0
2	55970499	.	T	A	4	5	9	0	0	9	0	0
2	55970504	.	C	G	3	4	7	0	2	9	0	0
2	55970662	.	C	T	16	4	20	0	1	21	0	0
2	55970684	.	C	T	16	7	23	0	1	24	0	0
2	56060821	.	G	A	2	3	5	0	1	6	0	0
2	56060838	.	G	A	2	2	4	0	0	4	0	0
2	56125231	.	G	A	7	12	19	0	1	20	0	0
2	56125687	.	T	C	17	20	37	0	1	38	0	0
2	56125744	.	G	C	13	0	13	0	28	41	0	0
2	56125821	.	G	T	12	11	23	0	1	24	0	0
2	56125837	.	C	T	0	10	10	0	10	20	0	0
2	56125859	.	A	T	9	8	17	0	1	18	0	0
2	56127612	.	G	A	3	2	5	0	0	5	0	0
2	56127693	.	T	G	5	4	9	0	0	9	0	0
2	56127720	.	C	G	5	2	7	0	0	7	0	0
2	56127962	.	T	C	1	2	3	0	0	3	0	0
2	56128025	.	A	G	3	2	5	0	0	5	0	0
2	56128029	.	A	T	3	2	5	0	0	5	0	0
2	56128582	.	A	G	2	2	4	0	2	6	0	0
2	56128895	.	T	A	1	1	2	0	1	3	0	0
2	56129175	.	G	C	1	5	6	0	0	6	0	0
2	56129285	.	G	T	2	3	5	0	1	6	0	0
2	56129299	.	G	A	1	3	4	0	0	4	0	0
2	56129613	.	T	C	2	2	4	0	0	4	0	0
2	56130259	.	A	G	3	2	5	0	0	5	0	0
2	56130260	.	C	G	3	1	4	0	1	5	0	0
2	56130296	.	C	A	2	2	4	0	1	5	0	0
2	56162404	.	C	G	5	3	8	0	0	8	0	0
2	56226369	.	C	G	2	3	5	0	0	5	0	0
2	56226372	.	A	G	2	0	2	0	4	6	0	0
2	56226444	.	T	C	2	0	2	0	0	2	0	0
2	56233498	.	C	G	7	1	8	0	0	8	0	0
2	56233508	.	G	T	7	1	8	0	1	9	0	0
2	56234749	.	T	C	15	17	32	0	0	32	0	0
2	56339104	.	T	G	16	20	36	0	1	37	0	0
2	56344833	.	A	G	6	6	12	0	4	16	0	0
2	56472472	.	C	T	0	2	2	0	0	2	0	0
2	56472553	.	C	T	1	4	5	0	0	5	0	0
2	56476113	.	G	A	0	4	4	0	3	7	0	0
2	56476573	.	G	T	0	16	16	0	18	34	0	0
2	56476732	.	C	T	23	15	38	0	4	42	0	0
2	56476762	.	A	G	14	12	26	0	3	29	0	0
2	56476812	.	A	G	5	25	30	0	2	32	0	0
2	56476909	.	A	C	5	8	13	0	4	17	0	0
2	56508570	.	A	C	14	9	23	0	2	25	0	0
2	56508695	.	T	C	29	19	48	0	2	50	0	0
2	56508878	.	A	G	11	15	26	0	2	28	0	0
2	56508880	.	C	T	12	12	24	0	4	28	0	0
2	56509097	.	T	A	8	4	12	0	0	12	0	0
2	56509098	.	A	T	8	4	12	0	0	12	0	0
2	56511064	.	G	T	3	3	6	0	1	7	0	0
2	56511877	.	C	T	1	2	3	0	0	3	0	0
2	56511917	.	C	T	1	4	5	0	0	5	0	0
2	56512115	.	T	G	0	4	4	1	1	6	0	0
2	56512133	.	A	T	0	6	6	0	0	6	0	0
2	56512162	.	C	T	2	4	6	0	0	6	0	0
2	56512173	.	A	C	2	6	8	0	0	8	0	0
2	56513742	.	C	A	3	4	7	0	0	7	0	0
2	56513795	.	G	T	2	1	3	0	2	5	0	0
2	56645018	.	G	A	27	31	58	0	1	59	0	0
2	56649806	.	A	G	2	6	8	0	0	8	0	0
2	56910752	.	G	A	0	3	3	0	0	3	0	0
2	57151194	.	G	A	6	5	11	0	1	12	0	0
2	57151242	.	G	T	8	10	18	0	2	20	0	0
2	57151326	.	A	G	2	0	2	0	9	11	0	0
2	57152858	.	T	G	9	17	26	0	0	26	0	0
2	57156050	.	C	A	11	12	23	0	1	24	0	0
2	57156092	.	C	A	7	8	15	0	1	16	0	0
2	57157952	.	C	T	11	9	20	0	4	24	0	0
2	57159557	.	G	A	9	9	18	0	1	19	0	0
2	57159668	.	G	A	15	23	38	0	3	41	0	0
2	57160272	.	C	T	19	15	34	0	2	36	0	0
2	57164902	.	A	G	15	5	20	0	0	20	0	0
2	57165001	.	C	T	19	18	37	0	3	40	0	0
2	57165544	.	C	T	18	29	47	0	0	47	0	0
2	57165565	.	C	T	27	23	50	0	2	52	0	0
2	57240340	.	A	T	3	5	8	0	1	9	0	0
2	57240345	.	C	T	4	5	9	0	0	9	0	0
2	57240518	.	G	T	6	3	9	0	0	9	0	0
2	57240544	.	A	G	7	6	13	0	0	13	0	0
2	57240570	.	A	T	4	4	8	0	1	9	0	0
2	57240649	.	C	T	0	8	8	0	4	12	0	0
2	57240736	.	G	A	1	3	4	0	0	4	0	0
2	57247280	.	C	A	0	8	8	0	5	13	0	0
2	57268868	.	G	A	23	21	44	0	1	45	0	0
2	57268877	.	T	A	20	23	43	0	0	43	0	0
2	57269031	.	C	G	21	23	44	0	4	48	0	0
2	57269136	.	T	A	4	14	18	0	0	18	0	0
2	57284550	.	A	T	1	3	4	0	1	5	0	0
2	57416930	.	T	C	0	2	2	0	0	2	0	0
2	57416951	.	T	A	1	2	3	0	0	3	0	0
2	57417092	.	A	C	3	2	5	0	0	5	0	0
2	57417223	.	G	A	3	1	4	0	3	7	0	0
2	57870286	.	G	A	8	1	9	0	1	10	0	0
2	57870295	.	C	T	7	1	8	0	0	8	0	0
2	57893346	.	G	A	2	4	6	1	0	7	0	0
2	58013448	.	G	A	1	5	6	0	1	7	0	0
2	58013477	.	A	T	0	4	4	0	1	5	0	0
2	58013485	.	G	A	1	2	3	0	1	4	0	0
2	58412124	.	G	A	0	0	0	0	3	3	0	0
2	58516445	.	C	A	1	5	6	0	1	7	0	0
2	58523710	.	C	A	0	4	4	0	2	6	0	0
2	58541939	.	G	A	1	6	7	0	1	8	0	0
2	58541981	.	C	G	4	9	13	0	0	13	0	0
2	58546893	.	G	A	3	4	7	0	0	7	0	0
2	58739467	.	T	C	2	5	7	0	0	7	0	0
2	58742652	.	G	A	0	5	5	0	5	10	0	0
2	58778264	.	G	A	1	1	2	0	1	3	0	0
2	58789112	.	G	A	2	1	3	0	0	3	0	0
2	58868190	.	G	A	4	5	9	0	0	9	0	0
2	58868679	.	G	A	6	5	11	0	0	11	0	0
2	58869166	.	G	A	2	2	4	0	1	5	0	0
2	58869268	.	A	G	1	3	4	0	0	4	0	0
2	58878612	.	C	T	5	4	9	0	0	9	0	0
2	58887817	.	C	T	0	11	11	0	13	24	0	0
2	59056203	.	C	T	8	19	27	0	0	27	0	0
2	59056212	.	G	A	5	17	22	0	0	22	0	0
2	59057670	.	C	T	8	10	18	0	2	20	0	0
2	59063227	.	T	C	8	4	12	0	2	14	0	0
2	59136490	.	C	T	1	3	4	0	0	4	0	0
2	59136518	.	T	C	1	8	9	0	1	10	0	0
2	59136533	.	G	A	1	9	10	0	0	10	0	0
2	59136859	.	T	C	2	4	6	0	0	6	0	0
2	59136919	.	T	G	2	2	4	0	1	5	0	0
2	59137050	.	T	A	4	4	8	1	0	9	0	0
2	59137182	.	G	T	4	6	10	0	0	10	0	0
2	59137184	.	G	T	4	5	9	0	1	10	0	0
20	944315	.	T	C	2	3	5	0	0	5	0	0
20	1178897	.	G	A	1	3	4	0	0	4	0	0
20	1241522	.	T	C	5	3	8	0	0	8	0	0
20	1241535	.	T	C	5	3	8	0	0	8	0	0
20	1294585	.	A	G	9	3	12	0	0	12	0	0
20	1295739	.	T	C	4	0	4	0	2	6	0	0
20	2290470	.	G	A	3	3	6	0	1	7	0	0
20	2293263	.	C	A	0	10	10	0	4	14	0	0
20	2295532	.	G	A	8	13	21	0	3	24	0	0
20	2295640	.	A	G	4	7	11	0	3	14	0	0
20	2359155	.	T	A	1	3	4	0	0	4	0	0
20	2361074	.	G	A	0	1	1	0	0	1	0	0
20	2361194	.	C	T	2	2	4	0	0	4	0	0
20	2361200	.	C	T	0	2	2	0	2	4	0	0
20	2479225	.	C	T	3	3	6	0	0	6	0	0
20	2479309	.	C	T	3	2	5	0	0	5	0	0
20	2499652	.	C	A	1	2	3	0	0	3	0	0
20	2499748	.	T	G	2	6	8	0	0	8	0	0
20	2499749	.	G	T	3	5	8	0	0	8	0	0
20	2499995	.	C	T	18	13	31	0	4	35	0	0
20	2500083	.	G	A	7	3	10	0	1	11	0	0
20	2506085	.	G	T	3	6	9	0	0	9	0	0
20	2513660	.	C	A	2	1	3	0	0	3	0	0
20	2515903	.	G	A	2	0	2	0	0	2	0	0
20	2519064	.	G	A	0	1	1	0	0	1	0	0
20	2519079	.	A	G	0	1	1	0	0	1	0	0
20	2519136	.	G	A	1	2	3	0	1	4	0	0
20	2682068	.	C	G	2	1	3	0	0	3	0	0
20	2716055	.	A	G	4	3	7	0	1	8	0	0
20	2716234	.	A	G	11	13	24	0	0	24	0	0
20	2716614	.	A	G	6	2	8	0	0	8	0	0
20	2718643	.	C	T	1	0	1	0	0	1	0	0
20	2718866	.	G	A	4	5	9	0	0	9	0	0
20	2721834	.	G	A	4	5	9	0	0	9	0	0
20	2725716	.	C	T	4	4	8	0	1	9	0	0
20	2737535	.	G	A	3	0	3	0	0	3	0	0
20	2738620	.	C	T	2	0	2	0	1	3	0	0
20	2739065	.	C	T	6	8	14	0	0	14	0	0
20	2739543	.	T	C	4	4	8	0	0	8	0	0
20	2739760	.	A	T	4	1	5	0	0	5	0	0
20	2744280	.	A	T	11	3	14	0	1	15	0	0
20	2744455	.	A	T	13	6	19	0	4	23	0	0
20	2744759	.	G	T	7	12	19	0	3	22	0	0
20	2744945	.	C	A	11	9	20	0	2	22	0	0
20	2976909	.	C	A	3	4	7	0	0	7	0	0
20	2977089	.	A	G	3	0	3	0	3	6	0	0
20	2977257	.	C	T	6	12	18	0	1	19	0	0
20	2977417	.	C	A	6	0	6	0	0	6	0	0
20	2977418	.	C	A	4	0	4	0	2	6	0	0
20	2982464	.	C	T	3	3	6	0	1	7	0	0
20	2982755	.	G	T	11	12	23	0	1	24	0	0
20	2982943	.	T	C	3	5	8	1	0	9	0	0
20	2983673	.	G	T	2	3	5	0	1	6	0	0
20	2986822	.	G	C	2	3	5	0	0	5	0	0
20	2986861	.	G	A	3	4	7	0	0	7	0	0
20	2996564	.	A	C	1	0	1	0	1	2	0	0
20	3005876	.	G	T	16	19	35	0	6	41	0	0
20	3017445	.	C	T	2	2	4	0	0	4	0	0
20	3017513	.	C	A	0	4	4	0	3	7	0	0
20	3020281	.	A	T	1	3	4	0	0	4	0	0
20	3020423	.	G	A	1	2	3	0	1	4	0	0
20	3121778	.	C	T	1	2	3	0	0	3	0	0
20	3121947	.	G	A	1	2	3	0	1	4	0	0
20	3239324	.	C	T	0	5	5	0	5	10	0	0
20	3239470	.	T	G	10	8	18	0	1	19	0	0
20	3242661	.	C	T	2	2	4	0	0	4	0	0
20	3242664	.	T	A	2	3	5	0	0	5	0	0
20	3242887	.	T	A	1	1	2	0	0	2	0	0
20	3242944	.	A	G	0	1	1	0	0	1	0	0
20	3246643	.	A	G	3	3	6	0	0	6	0	0
20	3248766	.	G	A	4	6	10	0	2	12	0	0
20	3249029	.	G	A	7	4	11	0	0	11	0	0
20	3283313	.	C	T	1	0	1	0	0	1	0	0
20	3284553	.	C	T	1	4	5	0	0	5	0	0
20	3286355	.	G	A	1	1	2	0	2	4	0	0
20	3287847	.	A	G	1	0	1	0	0	3	2	0
20	3288058	.	C	T	1	4	5	0	0	5	0	0
20	3290265	.	G	T	1	2	3	0	0	3	0	0
20	3290271	.	C	A	2	2	4	0	0	4	0	0
20	3290378	.	G	T	9	4	13	0	0	13	0	0
20	3290462	.	G	A	13	7	20	0	1	21	0	0
20	3290744	.	G	A	3	1	4	0	0	4	0	0
20	3292039	.	C	T	1	0	1	0	1	2	0	0
20	3295009	.	T	C	3	1	4	0	0	4	0	0
20	3298096	.	T	C	1	2	3	0	1	4	0	0
20	3298321	.	T	C	0	1	1	0	0	1	0	0
20	3312965	.	T	G	7	6	13	0	0	13	0	0
20	3312997	.	T	C	4	6	10	0	1	11	0	0
20	3313037	.	C	G	7	6	13	0	2	15	0	0
20	3313205	.	G	T	5	4	9	0	1	10	0	0
20	3313206	.	C	T	5	5	10	0	0	10	0	0
20	3313282	.	C	T	4	7	11	0	0	11	0	0
20	3344696	.	G	T	1	3	4	0	3	7	0	0
20	3344735	.	A	C	4	6	10	0	1	11	0	0
20	3344975	.	T	C	4	5	9	0	1	10	0	0
20	3345151	.	G	A	0	2	2	0	4	6	0	0
20	3345417	.	A	T	1	4	5	0	1	6	0	0
20	3346490	.	A	T	11	11	22	0	4	26	0	0
20	3346497	.	C	A	0	12	12	0	10	22	0	0
20	3346599	.	G	A	11	15	26	0	1	27	0	0
20	3346629	.	C	T	15	7	22	0	1	23	0	0
20	3346710	.	C	T	14	11	25	0	2	27	0	0
20	3346865	.	C	G	0	3	3	0	5	8	0	0
20	3346907	.	C	T	1	2	3	0	0	3	0	0
20	3349049	.	A	G	5	2	7	0	2	9	0	0
20	3349067	.	T	A	8	4	12	0	0	12	0	0
20	3351627	.	A	T	5	6	11	0	0	11	0	0
20	3351661	.	A	C	3	3	6	0	0	6	0	0
20	3353337	.	C	T	3	6	9	0	0	9	0	0
20	3357024	.	C	T	0	3	3	0	0	3	0	0
20	3361480	.	A	T	1	3	4	0	1	5	0	0
20	3921127	.	A	T	1	2	3	0	0	3	0	0
20	3921202	.	T	C	1	1	2	0	0	2	0	0
20	3923983	.	G	A	0	2	2	0	2	4	0	0
20	3924098	.	A	T	6	2	8	0	0	8	0	0
20	3924430	.	G	A	0	3	3	0	3	6	0	0
20	3925537	.	T	C	2	3	5	0	1	6	0	0
20	3925546	.	T	C	9	0	9	0	0	9	0	0
20	3925934	.	C	T	0	1	1	2	0	3	0	0
20	3925942	.	A	G	0	1	1	0	1	2	0	0
20	3926337	.	C	T	1	3	4	2	0	6	0	0
20	3926907	.	T	G	15	13	28	0	3	31	0	0
20	3926928	.	T	A	23	15	38	0	1	39	0	0
20	3926951	.	A	G	25	16	41	0	2	43	0	0
20	3927267	.	C	A	23	12	35	0	6	42	1	0
20	3927326	.	A	G	14	22	36	0	3	39	0	0
20	3927446	.	C	G	12	15	27	0	1	28	0	0
20	3953593	.	T	C	2	2	4	0	0	4	0	0
20	3954813	.	G	C	2	4	6	0	0	6	0	0
20	4009491	.	C	T	0	2	2	0	1	3	0	0
20	4010075	.	C	T	4	2	6	0	0	6	0	0
20	4010211	.	G	T	2	2	4	0	1	5	0	0
20	4010217	.	C	T	3	2	5	0	0	5	0	0
20	4010256	.	T	C	2	8	10	0	0	10	0	0
20	4010462	.	C	T	3	11	14	0	1	15	0	0
20	4035769	.	A	T	4	2	6	0	0	6	0	0
20	4036375	.	A	G	1	2	3	0	0	3	0	0
20	4036462	.	A	G	1	1	2	0	0	2	0	0
20	4036789	.	A	T	2	1	3	0	0	3	0	0
20	4036795	.	T	C	1	3	4	0	0	4	0	0
20	4036889	.	A	T	1	3	4	0	0	4	0	0
20	4037349	.	T	C	0	3	3	0	0	3	0	0
20	4712880	.	G	A	11	12	23	0	0	23	0	0
20	4712979	.	A	T	22	10	32	0	6	38	0	0
20	4713027	.	T	A	14	13	27	0	1	28	0	0
20	4713033	.	C	T	14	13	27	0	1	28	0	0
20	4713169	.	G	T	15	14	29	0	7	36	0	0
20	4713654	.	G	A	10	8	18	0	0	18	0	0
20	4713716	.	G	A	11	16	27	0	0	27	0	0
20	4713956	.	C	T	11	8	19	0	2	21	0	0
20	4716436	.	A	G	1	1	2	0	0	2	0	0
20	4717647	.	C	T	4	3	7	0	1	8	0	0
20	4726955	.	A	T	3	7	10	0	1	11	0	0
20	4726973	.	A	G	4	8	12	0	0	12	0	0
20	4728808	.	C	T	9	4	13	0	0	13	0	0
20	4734412	.	C	T	2	0	2	0	0	2	0	0
20	4738004	.	T	C	5	5	10	0	0	10	0	0
20	4745754	.	T	C	10	5	15	0	3	18	0	0
20	4747480	.	G	T	1	3	4	0	0	4	0	0
20	4751311	.	T	G	3	1	4	0	0	4	0	0
20	4769923	.	G	A	2	5	7	0	0	7	0	0
20	4769924	.	T	G	2	4	6	0	1	7	0	0
20	4769969	.	T	A	2	3	5	0	0	5	0	0
20	4887996	.	G	T	1	1	2	0	1	3	0	0
20	4888004	.	A	G	2	1	3	0	0	3	0	0
20	4888037	.	T	C	0	1	1	0	0	1	0	0
20	4895176	.	A	C	0	1	1	0	0	1	0	0
20	4895955	.	C	T	6	10	16	0	0	16	0	0
20	4896240	.	A	C	8	8	16	0	0	16	0	0
20	4896297	.	T	G	1	3	4	0	0	4	0	0
20	4896300	.	T	A	1	1	2	0	1	3	0	0
20	4898126	.	A	G	1	3	4	0	0	4	0	0
20	4898515	.	C	T	20	20	40	0	0	40	0	0
20	4898575	.	A	T	17	15	32	0	0	32	0	0
20	4898631	.	A	T	20	5	25	0	0	25	0	0
20	4898855	.	C	T	0	16	16	0	10	26	0	0
20	4899342	.	T	G	15	8	23	0	0	23	0	0
20	4899479	.	A	G	6	6	12	0	0	12	0	0
20	4899935	.	A	T	6	6	12	0	0	12	0	0
20	4899969	.	T	G	6	5	11	0	2	13	0	0
20	4900697	.	T	C	2	3	5	0	0	5	0	0
20	4901013	.	C	T	2	2	4	0	0	4	0	0
20	5069212	.	C	G	0	0	0	0	10	10	0	0
20	5069252	.	T	A	4	6	10	0	0	10	0	0
20	5069389	.	G	A	8	4	12	0	2	14	0	0
20	5093872	.	A	T	2	4	6	0	1	7	0	0
20	5093882	.	G	A	2	4	6	0	1	7	0	0
20	5094205	.	A	C	6	4	10	0	1	11	0	0
20	5158552	.	A	T	1	2	3	0	0	3	0	0
20	5158590	.	C	G	0	3	3	0	0	3	0	0
20	5330859	.	C	G	7	14	21	0	2	23	0	0
20	5330875	.	A	G	14	8	22	0	1	23	0	0
20	5330990	.	T	A	1	6	7	0	0	7	0	0
20	5331095	.	A	G	3	5	8	0	0	8	0	0
20	5331112	.	G	C	4	2	6	0	0	6	0	0
20	5390784	.	A	T	1	2	3	0	0	3	0	0
20	5391138	.	G	T	4	3	7	0	0	7	0	0
20	5394584	.	G	A	0	1	1	0	1	2	0	0
20	5921278	.	T	C	1	2	3	0	0	3	0	0
20	6308648	.	G	A	4	4	8	0	0	8	0	0
20	6803497	.	C	T	1	2	3	0	0	3	0	0
20	6809612	.	C	T	1	2	3	0	0	3	0	0
20	7588957	.	A	G	2	0	2	0	2	4	0	0
20	7966006	.	A	T	3	4	7	0	0	7	0	0
20	7966049	.	T	G	2	3	5	0	0	5	0	0
20	7966090	.	T	G	2	3	5	0	1	6	0	0
20	7966127	.	G	A	2	2	4	0	2	6	0	0
20	7966135	.	A	C	4	2	6	0	0	6	0	0
20	9096451	.	T	A	1	1	2	0	1	3	0	0
20	9096456	.	A	G	1	1	2	0	0	2	0	0
20	9097597	.	T	A	2	8	10	0	0	10	0	0
20	9097639	.	A	G	3	4	7	0	1	8	0	0
20	9097666	.	T	C	2	1	3	0	1	4	0	0
20	9102068	.	T	C	1	1	2	0	0	2	0	0
20	9105204	.	C	G	3	3	6	0	0	6	0	0
20	9111228	.	A	G	0	2	2	0	0	2	0	0
20	9113147	.	G	T	0	1	1	0	0	1	0	0
20	9124503	.	A	T	4	2	6	0	1	7	0	0
20	9124759	.	C	T	1	3	4	0	0	4	0	0
20	9125070	.	G	A	1	2	3	0	0	3	0	0
20	9148121	.	G	C	11	3	14	0	0	14	0	0
20	9172399	.	T	A	1	2	3	0	0	3	0	0
20	9174014	.	T	C	14	14	28	0	3	31	0	0
20	9183159	.	T	G	0	1	1	0	0	1	0	0
20	9184708	.	C	T	6	3	9	0	0	9	0	0
20	9185479	.	G	T	4	4	8	0	0	8	0	0
20	9185515	.	T	C	0	3	3	0	0	3	0	0
20	9186200	.	A	G	4	1	5	0	1	6	0	0
20	9190767	.	T	C	2	2	4	0	1	5	0	0
20	9190768	.	T	C	2	3	5	0	0	5	0	0
20	9191255	.	T	C	1	0	1	0	2	3	0	0
20	9191267	.	T	A	1	1	2	0	0	2	0	0
20	9191461	.	C	T	3	2	5	0	0	5	0	0
20	9420974	.	A	T	15	13	28	0	2	30	0	0
20	9420976	.	C	T	17	12	29	0	1	30	0	0
20	10099521	.	T	G	5	2	7	0	0	7	0	0
20	10099602	.	C	A	3	1	4	0	4	8	0	0
20	10099603	.	C	A	3	5	8	0	0	8	0	0
20	10099640	.	G	A	4	6	10	0	0	10	0	0
20	10099932	.	C	A	5	5	10	0	0	10	0	0
20	10102593	.	G	A	4	4	8	0	0	8	0	0
20	10353797	.	A	G	1	2	3	0	0	3	0	0
20	10353798	.	A	T	1	1	2	0	1	3	0	0
20	10489564	.	A	G	2	4	6	0	1	7	0	0
20	11098255	.	G	A	4	3	7	0	0	7	0	0
20	11098301	.	T	C	3	2	5	0	0	5	0	0
20	11098710	.	C	A	5	4	9	0	0	9	0	0
20	11098851	.	G	A	3	3	6	0	0	6	0	0
20	11098859	.	G	A	3	3	6	0	0	6	0	0
20	11098960	.	G	A	3	3	6	0	0	6	0	0
20	11098979	.	T	C	0	4	4	0	0	4	0	0
20	11099013	.	G	A	3	2	5	0	1	6	0	0
20	11099064	.	C	T	3	2	5	0	1	6	0	0
20	13567497	.	T	C	5	3	8	0	0	8	0	0
20	13567521	.	T	C	3	2	5	0	0	5	0	0
20	14459088	.	G	A	1	1	2	0	1	3	0	0
20	17819235	.	G	A	1	1	2	0	2	4	0	0
20	18249646	.	T	C	3	3	6	0	1	7	0	0
20	18255673	.	G	T	7	6	13	0	2	15	0	0
20	18255748	.	A	G	9	5	14	0	0	14	0	0
20	18255755	.	A	G	10	5	15	0	0	15	0	0
20	18255929	.	A	G	13	0	13	0	14	27	0	0
20	18255931	.	A	T	12	13	25	0	2	27	0	0
20	18256068	.	C	T	4	1	5	0	0	5	0	0
20	18256077	.	A	C	1	1	2	0	0	2	0	0
20	18256170	.	G	A	10	4	14	0	0	14	0	0
20	18312860	.	C	T	4	0	4	0	1	5	0	0
20	18354627	.	C	T	6	6	12	0	1	13	0	0
20	18391917	.	T	C	4	2	6	0	0	6	0	0
20	18392845	.	C	T	13	12	25	0	1	26	0	0
20	18393249	.	T	C	6	10	16	0	1	17	0	0
20	18393359	.	A	T	8	7	15	0	1	16	0	0
20	18393376	.	C	T	8	10	18	0	0	18	0	0
20	18396134	.	A	G	2	1	3	0	0	3	0	0
20	18417768	.	G	A	1	2	3	0	0	3	0	0
20	18417777	.	T	C	1	2	3	0	0	3	0	0
20	18551728	.	T	A	5	3	8	0	0	8	0	0
20	18591704	.	G	A	5	11	16	0	1	17	0	0
20	18591716	.	A	C	6	9	15	0	0	15	0	0
20	18591743	.	A	T	4	3	7	0	0	7	0	0
20	18594958	.	C	A	17	14	31	0	1	32	0	0
20	18672064	.	C	T	2	13	15	0	0	15	0	0
20	18672733	.	A	T	3	10	13	0	0	13	0	0
20	18673132	.	C	T	1	10	11	0	2	13	0	0
20	18683158	.	T	C	2	6	8	0	0	8	0	0
20	18683177	.	A	G	0	0	0	0	3	3	0	0
20	18684760	.	G	A	5	11	16	0	1	17	0	0
20	18684769	.	G	A	5	15	20	0	0	20	0	0
20	18685235	.	C	G	12	10	22	0	1	23	0	0
20	18685256	.	G	A	6	10	16	0	0	16	0	0
20	18685279	.	G	C	0	7	7	0	4	11	0	0
20	18708770	.	T	C	15	9	24	0	3	27	0	0
20	18713016	.	C	T	14	32	46	0	2	49	1	0
20	18713067	.	T	C	9	13	22	0	5	27	0	0
20	18722565	.	A	T	1	2	3	0	0	3	0	0
20	18723105	.	C	T	2	4	6	0	0	6	0	0
20	18723459	.	T	C	0	2	2	0	1	3	0	0
20	18755985	.	A	G	4	2	6	0	0	6	0	0
20	18756047	.	A	T	4	2	6	0	0	6	0	0
20	18756069	.	A	G	3	3	6	0	0	6	0	0
20	18774599	.	C	A	1	2	3	0	0	3	0	0
20	18983543	.	T	G	2	4	6	0	0	6	0	0
20	18983567	.	T	C	4	3	7	0	0	7	0	0
20	18983625	.	G	A	4	3	7	0	1	8	0	0
20	18983755	.	T	C	1	2	3	0	0	3	0	0
20	18983767	.	T	C	1	3	4	0	0	4	0	0
20	18996133	.	T	A	3	2	5	0	0	5	0	0
20	18996844	.	C	T	1	3	4	0	0	4	0	0
20	18997610	.	A	G	9	12	21	0	1	22	0	0
20	18997853	.	G	C	13	15	28	1	2	31	0	0
20	19007198	.	G	T	1	1	2	0	0	2	0	0
20	19007210	.	C	A	1	1	2	0	0	2	0	0
20	19018520	.	G	A	2	2	4	0	1	5	0	0
20	19058188	.	A	G	7	5	12	0	0	12	0	0
20	19058194	.	T	C	6	7	13	0	0	13	0	0
20	19058241	.	A	C	9	9	18	0	0	18	0	0
20	19058326	.	A	G	2	7	9	0	0	9	0	0
20	19058475	.	T	G	2	6	8	0	2	10	0	0
20	19058500	.	A	G	2	6	8	0	0	8	0	0
20	19078159	.	T	G	0	2	2	0	0	2	0	0
20	19277551	.	C	T	0	2	2	0	1	3	0	0
20	19373510	.	A	T	8	5	13	0	0	13	0	0
20	19373511	.	G	T	8	5	13	0	0	13	0	0
20	19373597	.	G	A	14	4	18	0	0	18	0	0
20	19373852	.	A	G	9	6	15	0	0	15	0	0
20	19373919	.	A	G	7	6	13	0	1	14	0	0
20	19373939	.	G	A	10	6	16	0	2	18	0	0
20	19374415	.	C	T	0	2	2	0	5	7	0	0
20	19374728	.	G	A	1	4	5	0	0	5	0	0
20	19391677	.	T	A	1	2	3	0	0	3	0	0
20	19415161	.	A	G	1	0	1	0	0	1	0	0
20	19430736	.	A	G	1	0	1	0	7	8	0	0
20	19431012	.	T	C	5	3	8	0	0	8	0	0
20	19431385	.	A	G	6	3	9	0	0	9	0	0
20	19431477	.	T	A	3	3	6	0	1	7	0	0
20	19431665	.	G	A	6	6	12	0	1	13	0	0
20	19432213	.	A	G	7	6	13	0	1	14	0	0
20	19436440	.	G	A	5	9	14	0	2	16	0	0
20	19436577	.	C	G	5	5	10	0	2	12	0	0
20	19437969	.	A	G	4	1	5	0	0	5	0	0
20	19438425	.	G	A	1	1	2	0	1	3	0	0
20	19443060	.	C	T	0	2	2	0	0	2	0	0
20	19513093	.	G	A	0	3	3	0	0	3	0	0
20	19516009	.	A	G	3	3	6	0	0	6	0	0
20	19516096	.	T	A	7	9	16	0	0	16	0	0
20	19516206	.	T	A	5	6	11	0	0	11	0	0
20	19516713	.	C	A	7	5	12	0	0	12	0	0
20	19516746	.	A	G	7	8	15	0	1	16	0	0
20	19516803	.	T	C	6	8	14	0	0	14	0	0
20	19516850	.	T	C	8	16	24	0	1	25	0	0
20	19519403	.	C	G	2	9	11	0	1	12	0	0
20	19519454	.	T	G	3	4	7	0	1	8	0	0
20	19521387	.	G	A	0	1	1	0	0	1	0	0
20	19562736	.	G	T	4	2	6	0	0	6	0	0
20	19562743	.	G	T	1	4	5	0	0	5	0	0
20	19580091	.	A	T	3	13	16	0	1	17	0	0
20	19580205	.	G	T	10	6	16	0	0	16	0	0
20	19580234	.	C	T	12	4	16	0	0	16	0	0
20	19580397	.	A	G	0	4	4	0	4	8	0	0
20	19580405	.	G	A	1	6	7	0	1	8	0	0
20	19580441	.	A	G	4	2	6	0	0	6	0	0
20	19580654	.	C	T	6	7	13	0	0	13	0	0
20	19582896	.	G	A	6	2	8	0	2	10	0	0
20	19582955	.	C	T	11	4	15	0	0	15	0	0
20	19583028	.	C	G	1	2	3	0	0	3	0	0
20	19588759	.	G	A	3	3	6	0	1	7	0	0
20	20231857	.	C	T	7	6	13	0	1	14	0	0
20	20231919	.	A	G	10	16	26	0	1	27	0	0
20	20232456	.	G	T	9	9	18	0	2	20	0	0
20	20275088	.	G	A	4	4	8	0	0	8	0	0
20	20275193	.	A	T	10	6	16	0	2	18	0	0
20	20275196	.	C	A	9	6	15	0	3	18	0	0
20	20275244	.	G	T	7	10	17	0	0	17	0	0
20	20275609	.	T	A	4	7	11	0	1	12	0	0
20	20275674	.	A	G	14	10	24	0	0	24	0	0
20	20276529	.	A	T	1	1	2	0	0	2	0	0
20	20276607	.	T	G	4	2	6	0	0	6	0	0
20	20277162	.	T	C	0	4	4	0	0	4	0	0
20	20277183	.	T	C	0	2	2	0	0	2	0	0
20	20601985	.	T	C	10	8	18	0	1	19	0	0
20	20602167	.	T	C	3	2	5	0	0	5	0	0
20	20729975	.	C	T	12	6	18	0	2	20	0	0
20	20730008	.	C	G	18	23	41	0	2	43	0	0
20	20730141	.	A	T	18	18	36	0	2	38	0	0
20	20730151	.	G	A	17	18	35	0	2	37	0	0
20	20730182	.	T	A	11	13	24	0	0	24	0	0
20	20807987	.	C	T	6	2	8	0	0	8	0	0
20	20809702	.	T	C	4	5	9	0	0	9	0	0
20	20812680	.	C	T	9	26	35	0	4	39	0	0
20	20812852	.	C	A	14	5	19	0	0	19	0	0
20	20812876	.	C	T	14	5	19	0	0	19	0	0
20	20813116	.	A	T	8	20	28	0	0	28	0	0
20	20813270	.	C	T	9	25	34	0	0	34	0	0
20	20813336	.	T	C	9	21	30	0	1	31	0	0
20	20813367	.	A	C	29	8	37	0	2	39	0	0
20	20813570	.	G	A	32	12	44	0	1	45	0	0
20	20813685	.	A	T	20	8	28	0	2	30	0	0
20	20813731	.	T	C	2	7	9	0	2	11	0	0
20	20816875	.	G	A	35	42	77	0	6	83	0	0
20	20817011	.	G	A	30	28	58	0	7	65	0	0
20	20817263	.	A	G	18	13	31	0	3	34	0	0
20	20818523	.	A	G	17	22	39	0	4	43	0	0
20	20927973	.	A	C	8	0	8	0	7	15	0	0
20	20928272	.	C	T	14	18	32	0	7	39	0	0
20	20928536	.	G	A	18	11	29	0	1	30	0	0
20	20928932	.	A	G	5	9	14	0	1	15	0	0
20	20929166	.	G	A	11	8	19	0	1	20	0	0
20	20930149	.	G	A	1	2	3	0	0	3	0	0
20	20980716	.	C	T	3	2	5	0	0	5	0	0
20	21015747	.	A	C	3	2	5	0	0	5	0	0
20	21015748	.	G	A	0	3	3	0	2	5	0	0
20	21016348	.	C	T	4	3	7	0	0	7	0	0
20	21016521	.	T	A	2	5	7	0	1	8	0	0
20	21016545	.	C	A	2	2	4	0	2	6	0	0
20	21473674	.	C	T	4	3	7	0	0	7	0	0
20	21474159	.	T	C	2	2	4	0	1	5	0	0
20	21474664	.	A	G	5	0	5	0	7	12	0	0
20	21474877	.	A	T	8	2	10	0	2	12	0	0
20	21475432	.	A	T	3	9	12	0	0	12	0	0
20	21638903	.	T	C	2	2	4	0	0	4	0	0
20	21815659	.	G	T	11	7	18	0	1	19	0	0
20	21815986	.	C	T	1	14	15	0	10	25	0	0
20	21816061	.	C	G	1	12	13	0	2	15	0	0
20	21819062	.	T	C	8	9	17	0	0	17	0	0
20	21839504	.	G	A	1	0	1	0	0	1	0	0
20	21841312	.	G	A	0	2	2	0	0	2	0	0
20	21841316	.	G	T	0	2	2	0	0	2	0	0
20	21855195	.	T	C	1	3	4	0	0	4	0	0
20	22179962	.	T	A	6	10	16	0	0	16	0	0
20	22180340	.	G	A	13	4	17	0	2	19	0	0
20	22186632	.	G	A	12	10	22	0	0	22	0	0
20	22186738	.	G	A	17	9	26	0	0	26	0	0
20	22186765	.	C	G	13	9	22	0	0	22	0	0
20	22186886	.	A	G	6	6	12	0	1	13	0	0
20	22186914	.	A	G	8	5	13	0	0	13	0	0
20	22186971	.	C	T	7	4	11	0	0	11	0	0
20	22186973	.	C	T	7	4	11	0	0	11	0	0
20	22191361	.	A	T	2	5	7	0	0	7	0	0
20	22191376	.	A	G	2	4	6	0	0	6	0	0
20	22194285	.	C	T	0	3	3	0	10	13	0	0
20	22194385	.	A	T	4	4	8	0	2	10	0	0
20	22194395	.	G	A	4	4	8	0	0	8	0	0
20	22722200	.	C	A	2	4	6	0	0	6	0	0
20	22722255	.	G	C	3	3	6	0	0	6	0	0
20	22730689	.	C	G	5	1	6	0	0	6	0	0
20	22734031	.	G	A	0	3	3	0	6	9	0	0
20	22734052	.	G	A	0	2	2	0	7	9	0	0
20	22736673	.	C	T	14	10	24	0	2	26	0	0
20	22738204	.	C	A	3	10	13	0	1	14	0	0
20	22739946	.	C	A	15	13	28	0	1	29	0	0
20	22740056	.	C	T	10	20	30	0	0	30	0	0
20	22740140	.	C	T	15	15	30	0	2	32	0	0
20	22740230	.	A	G	18	22	40	0	2	42	0	0
20	22740533	.	A	T	20	15	35	0	0	35	0	0
20	22740567	.	A	G	19	0	19	0	24	43	0	0
20	23017227	.	T	C	1	0	1	0	0	1	0	0
20	23023085	.	A	T	2	1	3	0	0	3	0	0
20	23023089	.	G	A	0	3	3	0	0	3	0	0
20	23023364	.	G	A	6	9	15	0	0	15	0	0
20	23023471	.	C	T	7	12	19	0	0	19	0	0
20	23023482	.	A	G	12	7	19	0	0	19	0	0
20	23023623	.	G	A	5	7	12	0	0	12	0	0
20	23023641	.	A	G	8	3	11	0	2	13	0	0
20	23023670	.	T	C	4	0	4	0	11	15	0	0
20	23023835	.	A	G	8	6	14	0	0	14	0	0
20	23024096	.	G	A	4	2	6	0	1	7	0	0
20	23205102	.	T	C	10	5	15	0	2	17	0	0
20	23205868	.	T	C	11	6	17	0	2	19	0	0
20	23205879	.	G	A	12	9	21	0	0	21	0	0
20	23245852	.	C	T	9	3	12	0	0	12	0	0
20	23246215	.	G	A	5	3	8	0	0	8	0	0
20	23248635	.	T	C	4	11	15	0	1	16	0	0
20	23389772	.	T	C	0	2	2	0	0	2	0	0
20	23395404	.	C	T	1	1	2	0	0	2	0	0
20	23406545	.	T	A	3	4	7	0	0	7	0	0
20	23418228	.	G	A	4	3	7	0	0	7	0	0
20	23418291	.	C	G	3	5	8	0	0	8	0	0
20	23420784	.	A	T	11	5	16	0	6	22	0	0
20	23421695	.	T	C	28	15	43	0	0	43	0	0
20	23422061	.	T	C	19	18	37	0	1	38	0	0
20	23422205	.	A	T	10	8	18	0	0	18	0	0
20	23446698	.	G	A	8	9	17	0	0	17	0	0
20	23446854	.	C	T	4	9	13	0	3	16	0	0
20	23447540	.	C	T	3	4	7	0	1	8	0	0
20	23447564	.	C	G	3	8	11	0	1	12	0	0
20	23475496	.	A	T	1	1	2	0	1	3	0	0
20	23477436	.	C	T	5	3	8	0	1	9	0	0
20	23478231	.	C	T	4	3	7	0	1	8	0	0
20	23648724	.	T	C	7	1	8	0	1	9	0	0
20	23648828	.	G	A	8	3	11	0	2	13	0	0
20	23651156	.	C	A	3	5	8	0	0	8	0	0
20	23651253	.	T	C	0	3	3	0	1	4	0	0
20	23651254	.	G	A	1	3	4	0	0	4	0	0
20	23655749	.	A	T	2	0	2	0	0	2	0	0
20	23655767	.	C	T	0	0	0	0	1	1	0	0
20	23656454	.	A	G	1	3	4	0	0	4	0	0
20	23665793	.	G	T	0	5	5	0	5	10	0	0
20	23665863	.	G	A	1	3	4	0	12	16	0	0
20	23666055	.	T	A	2	4	6	1	0	7	0	0
20	23666135	.	G	A	3	2	5	0	1	6	0	0
20	23666137	.	G	T	2	4	6	0	0	6	0	0
20	23666346	.	C	T	4	5	9	0	0	9	0	0
20	23689902	.	T	C	1	2	3	0	0	3	0	0
20	23689933	.	G	C	1	2	3	0	0	3	0	0
20	23692094	.	T	C	2	1	3	0	1	4	0	0
20	23694005	.	C	T	1	1	2	0	0	2	0	0
20	23694299	.	G	T	0	3	3	0	4	7	0	0
20	23713122	.	G	A	0	12	12	0	3	15	0	0
20	23713197	.	A	G	3	0	3	0	8	11	0	0
20	23713433	.	T	C	0	3	3	0	0	3	0	0
20	23713435	.	T	C	1	2	3	0	0	3	0	0
20	23713475	.	T	A	2	1	3	0	3	6	0	0
20	23713497	.	G	T	6	6	12	0	1	13	0	0
20	23713512	.	A	T	5	6	11	0	1	12	0	0
20	23713535	.	A	G	5	3	8	0	3	11	0	0
20	23713763	.	G	A	9	7	16	0	0	16	0	0
20	23713824	.	A	G	9	7	16	0	0	16	0	0
20	23713858	.	T	G	5	0	5	0	6	11	0	0
20	23713883	.	A	G	3	0	3	0	10	13	0	0
20	23829170	.	C	T	0	1	1	0	0	1	0	0
20	23833193	.	G	T	1	0	1	0	0	1	0	0
20	23835228	.	C	T	0	1	1	0	0	1	0	0
20	23835472	.	C	T	3	3	6	0	0	6	0	0
20	23835988	.	C	A	1	4	5	0	0	5	0	0
20	23836009	.	G	T	1	4	5	0	0	5	0	0
20	23836037	.	G	A	0	2	2	0	1	3	0	0
20	23836310	.	A	T	4	2	6	0	0	6	0	0
20	23836685	.	A	T	12	7	19	0	0	19	0	0
20	23836688	.	C	A	8	11	19	0	0	19	0	0
20	23836756	.	G	A	0	6	6	0	8	14	0	0
20	23836880	.	C	T	6	4	10	0	2	12	0	0
20	23855673	.	C	T	1	8	9	0	0	9	0	0
20	23855675	.	T	A	1	8	9	0	0	9	0	0
20	23856345	.	A	T	6	4	10	0	0	10	0	0
20	23857214	.	G	C	3	12	15	0	2	17	0	0
20	23857407	.	C	A	3	0	3	0	0	3	0	0
20	23857559	.	G	A	0	10	10	0	1	11	0	0
20	23857592	.	C	T	0	1	1	0	0	1	0	0
20	23877623	.	G	A	3	3	6	0	0	6	0	0
20	23882437	.	C	T	0	1	1	0	0	1	0	0
20	23886277	.	A	G	2	0	2	0	0	2	0	0
20	23886358	.	A	G	0	1	1	0	0	1	0	0
20	23890478	.	C	T	0	1	1	0	2	3	0	0
20	23890489	.	C	T	1	2	3	0	0	3	0	0
20	23955237	.	C	G	1	2	3	0	0	3	0	0
20	24151599	.	C	T	0	10	10	0	9	19	0	0
20	24152098	.	G	A	2	2	4	0	0	4	0	0
20	24152821	.	G	A	6	4	10	0	1	11	0	0
20	24152822	.	G	A	5	6	11	0	0	11	0	0
20	24175892	.	A	G	0	1	1	0	0	1	0	0
20	24818238	.	T	A	8	3	11	0	3	14	0	0
20	24818673	.	G	A	7	9	16	0	2	18	0	0
20	24819091	.	A	G	2	5	7	0	0	7	0	0
20	24819152	.	C	G	0	2	2	0	2	4	0	0
20	24819582	.	C	T	0	4	4	0	5	9	0	0
20	24819646	.	C	T	1	3	4	0	0	4	0	0
20	24819858	.	T	C	0	3	3	0	1	4	0	0
20	24819861	.	T	C	0	4	4	0	0	4	0	0
20	24819929	.	T	C	3	3	6	0	0	6	0	0
20	24820032	.	T	C	1	4	5	0	0	5	0	0
20	24820885	.	C	T	0	2	2	0	3	5	0	0
20	24821048	.	C	A	1	3	4	0	0	4	0	0
20	25269827	.	T	A	1	2	3	0	0	3	0	0
20	25271776	.	T	A	3	0	3	0	1	4	0	0
20	25342721	.	C	T	6	4	10	0	2	12	0	0
20	25368871	.	C	T	4	6	10	0	0	10	0	0
20	25371869	.	A	G	1	2	3	0	0	3	0	0
20	25371914	.	C	T	0	2	2	0	0	2	0	0
20	25440724	.	G	T	6	4	10	0	2	13	1	0
20	25441033	.	G	T	7	6	13	0	3	16	0	0
20	25509772	.	C	T	2	1	3	0	0	3	0	0
20	25509842	.	C	A	2	2	4	0	1	5	0	0
20	25509851	.	A	T	2	2	4	0	0	4	0	0
20	25510481	.	A	G	1	4	5	0	0	5	0	0
20	25510586	.	A	G	2	4	6	0	0	6	0	0
20	25510630	.	G	A	4	5	9	0	2	11	0	0
20	25510897	.	G	C	4	4	8	0	0	8	0	0
20	25511312	.	T	A	5	5	10	0	1	11	0	0
20	25511609	.	T	C	16	9	25	0	2	27	0	0
20	25511785	.	T	C	5	7	12	0	0	12	0	0
20	25511940	.	G	A	1	8	9	0	8	17	0	0
20	25511957	.	A	T	10	12	22	0	0	22	0	0
20	25511997	.	A	G	7	6	13	0	1	14	0	0
20	25516185	.	C	T	0	3	3	0	0	3	0	0
20	25618336	.	A	C	8	7	15	0	1	16	0	0
20	25618601	.	T	A	6	11	17	0	0	17	0	0
20	25623770	.	A	T	0	2	2	0	0	2	0	0
20	25623778	.	A	T	2	1	3	0	0	3	0	0
20	25625969	.	A	G	3	1	4	0	0	4	0	0
20	25636002	.	A	G	0	3	3	0	0	3	0	0
20	25660033	.	T	A	4	2	6	0	0	6	0	0
20	25661199	.	A	G	13	7	20	0	1	21	0	0
20	25661509	.	G	A	12	10	22	0	2	24	0	0
20	25663590	.	T	G	1	0	1	0	0	1	0	0
20	25665101	.	G	T	6	7	13	0	0	13	0	0
20	25665115	.	G	T	5	7	12	0	1	13	0	0
20	25665144	.	G	T	8	8	16	0	0	16	0	0
20	25665195	.	G	A	7	8	15	0	0	15	0	0
20	25665506	.	C	T	1	2	3	0	0	3	0	0
20	25665515	.	C	T	1	2	3	0	0	3	0	0
20	25665822	.	G	A	2	2	4	0	0	4	0	0
20	25665927	.	T	C	3	3	6	0	0	6	0	0
20	25666142	.	C	T	3	4	7	0	0	7	0	0
20	25666812	.	T	A	8	8	16	0	1	17	0	0
20	25666947	.	C	T	7	4	11	0	0	11	0	0
20	25853191	.	T	C	1	2	3	0	0	3	0	0
20	25853228	.	T	C	4	2	6	0	0	6	0	0
20	25853767	.	A	G	11	15	26	0	2	28	0	0
20	25855561	.	G	A	0	2	2	0	0	2	0	0
20	25859494	.	C	T	4	7	11	0	0	11	0	0
20	25909462	.	T	C	1	3	4	0	0	4	0	0
20	25909699	.	C	T	6	9	15	0	3	18	0	0
20	25909765	.	A	C	8	4	12	0	1	13	0	0
20	25910133	.	G	A	5	6	11	0	1	12	0	0
20	25910298	.	A	T	6	5	11	0	0	11	0	0
20	25910366	.	A	T	3	7	10	0	0	10	0	0
20	25910368	.	A	T	3	6	9	0	1	10	0	0
20	25910522	.	G	T	4	3	7	0	0	7	0	0
20	25910531	.	G	A	5	2	7	0	0	7	0	0
20	25926474	.	G	A	1	2	3	0	0	3	0	0
20	25926505	.	T	C	1	2	3	0	0	3	0	0
20	25926792	.	T	G	1	2	3	0	0	3	0	0
20	25926793	.	T	G	1	2	3	0	0	3	0	0
20	25927126	.	C	A	13	7	20	0	1	21	0	0
20	25927259	.	C	G	5	0	5	0	13	19	1	0
20	25927283	.	T	G	10	12	22	0	1	23	0	0
20	25927310	.	A	G	9	5	14	0	3	17	0	0
20	25928098	.	C	T	13	18	31	0	1	32	0	0
20	25929913	.	T	A	15	8	23	0	2	25	0	0
20	25930671	.	T	C	1	4	5	0	0	5	0	0
20	25953538	.	T	C	1	2	3	0	1	4	0	0
20	26004160	.	T	A	1	2	3	0	1	4	0	0
20	26024196	.	G	A	16	17	33	0	2	35	0	0
20	26024432	.	C	T	11	17	28	0	5	33	0	0
20	26024434	.	A	G	13	18	31	0	2	33	0	0
20	26024565	.	G	A	0	15	15	0	18	33	0	0
20	26027048	.	C	T	0	11	11	0	11	22	0	0
20	26027434	.	G	T	6	6	12	0	2	14	0	0
20	26027630	.	C	T	3	3	6	0	0	6	0	0
20	26030641	.	G	T	3	4	7	0	0	7	0	0
20	26035649	.	A	G	1	1	2	0	0	2	0	0
20	26047462	.	G	A	4	2	6	0	0	6	0	0
20	26049961	.	G	A	1	3	4	0	0	4	0	0
20	26320288	.	T	C	2	1	3	0	0	3	0	0
20	26325671	.	A	G	1	1	2	0	1	3	0	0
20	26326345	.	T	C	5	3	8	0	1	9	0	0
20	26331595	.	A	G	2	2	4	0	0	4	0	0
20	26336921	.	C	G	0	1	1	0	0	1	0	0
20	26337036	.	C	T	3	4	7	0	0	7	0	0
20	26337733	.	C	T	7	10	17	0	0	17	0	0
20	26342889	.	C	T	2	4	6	0	0	6	0	0
20	26344835	.	A	G	1	1	2	0	0	2	0	0
20	26345856	.	T	A	8	10	18	0	1	19	0	0
20	26346710	.	C	T	9	18	27	0	3	30	0	0
20	26348838	.	G	A	0	5	5	0	3	8	0	0
20	26351914	.	T	G	12	0	12	0	12	24	0	0
20	26353751	.	T	C	7	6	13	0	3	16	0	0
20	26353770	.	A	G	9	13	22	0	0	22	0	0
20	26353793	.	T	C	9	17	26	0	2	28	0	0
20	26358574	.	T	C	26	18	44	0	2	46	0	0
20	26360192	.	C	T	4	4	8	0	0	8	0	0
20	26387181	.	G	A	3	6	9	0	0	9	0	0
20	26387288	.	T	A	3	4	7	0	1	8	0	0
20	26387413	.	A	T	3	3	6	0	2	8	0	0
20	26405356	.	A	T	3	2	5	0	0	5	0	0
20	26405857	.	G	A	0	2	2	0	1	3	0	0
20	26406195	.	T	C	5	3	8	0	0	8	0	0
20	26406198	.	C	T	5	3	8	0	0	8	0	0
20	26406352	.	T	C	2	3	5	0	0	5	0	0
20	26406369	.	G	A	1	2	3	0	0	3	0	0
20	26406640	.	G	T	0	3	3	0	3	6	0	0
20	26409295	.	C	A	10	3	13	0	1	14	0	0
20	26409310	.	A	T	9	3	12	0	1	13	0	0
20	26409471	.	C	T	1	11	12	0	8	20	0	0
20	26409599	.	C	T	10	14	24	0	2	26	0	0
20	26409922	.	T	C	15	7	22	0	0	22	0	0
20	26409931	.	C	T	14	6	20	0	1	21	0	0
20	26410275	.	G	A	4	2	6	0	0	6	0	0
20	26410341	.	A	G	5	4	9	0	0	9	0	0
20	26410344	.	A	C	5	4	9	0	0	9	0	0
20	26412372	.	T	A	4	2	6	0	1	7	0	0
20	26412501	.	G	A	2	2	4	0	0	4	0	0
20	26412579	.	C	A	1	3	4	0	0	4	0	0
20	26412830	.	G	T	2	7	9	0	0	9	0	0
20	26412831	.	G	T	1	7	8	0	1	9	0	0
20	26412876	.	G	A	2	7	9	0	1	10	0	0
20	26413311	.	C	T	1	2	3	0	0	3	0	0
20	26576333	.	C	T	0	2	2	0	4	6	0	0
20	26807385	.	G	A	1	4	5	0	0	5	0	0
20	26822449	.	A	G	0	1	1	0	2	3	0	0
20	26918523	.	G	T	1	0	1	0	0	1	0	0
20	26921070	.	T	C	2	2	4	0	1	5	0	0
20	26921313	.	T	C	7	5	12	0	0	12	0	0
20	26921527	.	T	A	1	3	4	0	0	4	0	0
20	26944106	.	G	A	5	8	13	0	0	13	0	0
20	26944311	.	G	A	15	6	21	0	1	22	0	0
20	26944576	.	C	T	6	7	13	0	1	14	0	0
20	26944762	.	C	T	8	8	16	0	0	16	0	0
20	26944971	.	G	A	3	9	12	0	0	12	0	0
20	26945120	.	A	T	3	2	5	0	1	6	0	0
20	26945180	.	T	A	2	3	5	0	0	5	0	0
20	26945394	.	C	T	3	12	15	0	0	15	0	0
20	26945735	.	C	T	9	8	17	0	1	18	0	0
20	26945913	.	T	C	7	26	33	0	0	33	0	0
20	26960619	.	A	G	3	2	5	0	0	5	0	0
20	26960802	.	T	C	4	4	8	0	0	8	0	0
20	26961149	.	A	G	2	2	4	0	1	5	0	0
20	26961719	.	T	A	3	2	5	0	1	6	0	0
20	26961758	.	A	T	0	2	2	0	0	2	0	0
20	26961769	.	T	A	1	1	2	0	0	2	0	0
20	26961799	.	C	T	2	1	3	0	1	4	0	0
20	26961832	.	T	G	5	0	5	0	2	7	0	0
20	26961907	.	A	G	7	6	13	0	0	13	0	0
20	26962077	.	G	A	0	6	6	0	12	18	0	0
20	26962095	.	T	C	10	8	18	0	1	19	0	0
20	26962385	.	T	A	7	4	11	0	0	11	0	0
20	26962455	.	G	A	0	2	2	0	7	9	0	0
20	26973754	.	T	A	1	5	6	0	0	6	0	0
20	26973890	.	T	C	0	6	6	0	0	6	0	0
20	26999506	.	T	A	0	2	2	0	0	2	0	0
20	27001816	.	A	C	2	6	8	0	2	10	0	0
20	27001864	.	T	A	3	7	10	0	2	12	0	0
20	27001867	.	C	T	4	7	11	0	0	11	0	0
20	27001903	.	C	T	6	4	10	0	1	11	0	0
20	27001915	.	T	C	7	3	10	0	1	12	1	0
20	27002007	.	A	G	4	3	7	0	1	8	0	0
20	27020221	.	G	A	1	4	5	0	0	5	0	0
20	27020294	.	T	A	3	5	8	0	0	8	0	0
20	27020442	.	G	T	0	2	2	0	0	2	0	0
20	27020446	.	G	A	0	1	1	0	0	1	0	0
20	27033700	.	C	T	1	1	2	0	0	2	0	0
20	27033847	.	A	T	15	23	38	0	2	40	0	0
20	27033914	.	A	G	13	15	28	0	1	29	0	0
20	27039364	.	G	T	0	20	20	0	27	47	0	0
20	27039400	.	G	A	29	23	52	0	2	54	0	0
20	27039498	.	C	T	17	28	45	0	3	48	0	0
20	27039550	.	A	T	21	17	38	0	1	39	0	0
20	27039577	.	C	T	16	16	32	0	1	33	0	0
20	27045649	.	T	G	17	2	19	0	35	54	0	0
20	27045703	.	A	G	12	19	31	0	4	35	0	0
20	27045719	.	T	C	12	15	27	0	7	34	0	0
20	27045875	.	T	C	7	4	11	0	2	13	0	0
20	27089717	.	C	T	1	2	3	0	1	4	0	0
20	27089858	.	A	T	1	3	4	0	1	5	0	0
20	27090134	.	G	T	5	2	7	0	0	7	0	0
20	27090340	.	A	G	3	2	5	0	1	6	0	0
20	27090401	.	C	T	5	9	14	0	1	15	0	0
20	27090525	.	T	G	2	5	7	0	1	8	0	0
20	27090551	.	A	T	1	4	5	0	0	5	0	0
20	27091143	.	G	A	8	8	16	0	1	17	0	0
20	27092182	.	C	T	5	6	11	0	0	11	0	0
20	27092245	.	A	G	7	5	12	0	0	12	0	0
20	27096469	.	G	T	0	1	1	0	2	3	0	0
20	27100005	.	T	C	3	3	6	0	1	7	0	0
20	27107173	.	A	C	9	7	16	0	4	20	0	0
20	27107241	.	C	A	8	3	11	0	0	11	0	0
20	27107545	.	G	T	1	2	3	0	5	8	0	0
20	27107572	.	C	G	5	3	8	0	1	9	0	0
20	27281678	.	A	C	2	2	4	0	0	4	0	0
20	27282267	.	A	T	0	5	5	0	1	6	0	0
20	27282437	.	A	G	3	3	6	0	0	6	0	0
20	27282438	.	G	A	3	3	6	0	0	6	0	0
20	27282561	.	T	C	6	7	13	0	0	13	0	0
20	27282592	.	A	G	7	10	17	0	0	17	0	0
20	27282598	.	T	A	6	9	15	0	2	17	0	0
20	27283206	.	C	A	6	3	9	0	0	9	0	0
20	27358777	.	C	A	2	2	4	0	0	4	0	0
20	27366597	.	T	G	8	4	12	0	0	12	0	0
20	27368882	.	A	C	1	0	1	0	0	1	0	0
20	27370340	.	G	A	8	10	18	0	0	18	0	0
20	27371629	.	T	C	6	30	36	0	1	37	0	0
20	27371642	.	A	C	9	29	38	0	1	39	0	0
20	27371693	.	T	A	10	14	24	0	2	26	0	0
20	27371735	.	A	G	6	15	21	0	2	23	0	0
20	27371737	.	T	C	7	0	7	0	16	23	0	0
20	27371821	.	C	A	16	12	28	0	1	29	0	0
20	27374961	.	C	T	8	7	15	0	1	16	0	0
20	27375008	.	C	T	0	9	9	0	6	15	0	0
20	27378174	.	C	T	4	4	8	0	1	9	0	0
20	27378252	.	A	T	2	3	5	0	0	5	0	0
20	27378321	.	G	T	1	5	6	0	1	7	0	0
20	27396384	.	T	A	8	14	22	0	0	22	0	0
20	27396385	.	A	T	6	14	20	0	2	22	0	0
20	27396478	.	A	T	5	10	15	0	0	15	0	0
20	27396489	.	C	T	4	8	12	0	0	12	0	0
20	27551563	.	T	C	1	3	4	0	0	4	0	0
20	27551624	.	C	T	1	2	3	0	0	3	0	0
20	27717055	.	T	A	2	2	4	0	0	4	0	0
20	27719088	.	A	G	3	6	9	0	0	9	0	0
20	27719099	.	A	G	2	4	6	0	1	7	0	0
20	27719578	.	T	C	2	2	4	0	2	6	0	0
20	27719763	.	G	A	12	6	18	0	4	22	0	0
20	27719859	.	T	C	7	5	12	0	0	12	0	0
20	27732832	.	A	G	3	3	6	0	0	6	0	0
20	28354549	.	T	A	7	6	13	0	2	16	1	0
20	28354588	.	A	G	5	10	15	0	4	19	0	0
20	28354951	.	A	G	5	3	8	0	0	8	0	0
20	28357028	.	A	G	3	3	6	0	0	6	0	0
20	28357463	.	A	G	1	5	6	0	1	7	0	0
20	28357610	.	A	G	2	2	4	0	0	4	0	0
20	28399924	.	A	G	2	2	4	0	0	4	0	0
20	28400455	.	A	C	3	4	7	0	0	7	0	0
20	28400481	.	A	G	3	4	7	0	1	8	0	0
20	28400619	.	G	A	4	10	14	0	2	16	0	0
20	28401147	.	A	G	2	1	3	0	1	4	0	0
20	28418587	.	C	T	1	2	3	0	0	3	0	0
20	28418939	.	T	C	1	3	4	0	1	5	0	0
20	28419015	.	A	T	3	4	7	0	0	7	0	0
20	28419767	.	C	A	2	2	4	0	0	4	0	0
20	28419807	.	T	A	4	2	6	0	0	6	0	0
20	28420010	.	C	T	2	5	7	0	0	7	0	0
20	28420142	.	A	T	1	2	3	0	0	3	0	0
20	28420438	.	C	G	16	9	25	0	0	25	0	0
20	28420496	.	C	T	5	12	17	0	1	18	0	0
20	28423035	.	G	T	4	3	7	0	0	7	0	0
20	28423062	.	G	A	6	4	10	0	0	10	0	0
20	28423072	.	A	T	6	3	9	0	0	9	0	0
20	28476107	.	T	C	0	1	1	0	0	1	0	0
20	28650323	.	T	C	14	15	29	0	1	30	0	0
20	28650328	.	A	C	16	14	30	0	1	31	0	0
20	28650394	.	G	A	5	6	11	1	3	15	0	0
20	28650945	.	A	T	16	4	20	0	1	21	0	0
20	28650946	.	T	G	16	4	20	0	1	21	0	0
20	28651194	.	C	T	10	15	25	0	0	25	0	0
20	28651239	.	A	G	11	13	24	0	3	27	0	0
20	28651368	.	C	G	19	10	29	0	0	29	0	0
20	28651372	.	G	A	17	10	27	0	1	28	0	0
20	28651454	.	G	A	16	7	23	0	1	24	0	0
20	28652449	.	G	C	4	3	7	0	0	7	0	0
20	28783046	.	T	C	15	15	30	0	2	32	0	0
20	28783327	.	T	C	3	8	11	0	0	11	0	0
20	28783502	.	C	G	7	5	12	0	1	13	0	0
20	28783607	.	T	C	7	0	7	0	7	14	0	0
20	28783627	.	T	C	8	7	15	0	0	15	0	0
20	28783688	.	C	A	10	9	19	0	3	22	0	0
20	28784045	.	G	T	5	3	8	0	0	8	0	0
20	28800961	.	A	G	1	3	4	0	1	5	0	0
20	28814902	.	T	C	0	2	2	0	0	2	0	0
20	28817492	.	A	G	0	1	1	0	0	1	0	0
20	28822696	.	T	A	4	1	5	0	0	5	0	0
20	28823116	.	T	C	2	1	3	0	0	3	0	0
20	28825375	.	C	T	8	6	14	0	1	15	0	0
20	28827208	.	A	G	0	1	1	0	0	1	0	0
20	28827350	.	T	C	6	7	13	0	1	14	0	0
20	28827388	.	C	A	11	10	21	0	1	22	0	0
20	28827416	.	C	T	11	11	22	0	0	22	0	0
20	28827433	.	A	C	10	9	19	0	2	21	0	0
20	28827633	.	T	C	5	4	9	0	0	9	0	0
20	28833245	.	C	T	11	18	29	0	2	31	0	0
20	28833312	.	C	A	18	19	37	0	4	41	0	0
20	28833793	.	A	G	14	25	39	0	0	39	0	0
20	28834008	.	C	T	13	19	32	0	5	37	0	0
20	28834536	.	C	A	3	3	6	0	0	6	0	0
20	28870806	.	C	G	26	19	45	0	0	45	0	0
20	28870843	.	T	C	35	11	46	0	3	49	0	0
20	28871512	.	C	A	10	2	12	0	1	13	0	0
20	28871830	.	G	A	22	27	49	0	3	52	0	0
20	28875824	.	T	C	5	1	6	0	6	12	0	0
20	28886159	.	A	T	11	10	21	0	1	22	0	0
20	28886311	.	T	C	23	18	41	0	1	42	0	0
20	28886530	.	C	T	12	5	17	0	1	18	0	0
20	28886608	.	C	A	5	3	8	0	0	8	0	0
20	28886735	.	T	C	9	5	14	0	2	16	0	0
20	28887091	.	C	A	1	3	4	0	0	4	0	0
20	28887092	.	T	A	1	3	4	0	0	4	0	0
20	28887498	.	T	A	6	9	15	0	1	16	0	0
20	28887590	.	G	C	3	5	8	0	0	8	0	0
20	28888072	.	A	C	9	4	13	0	0	13	0	0
20	28888076	.	C	A	0	4	4	0	9	13	0	0
20	28888161	.	A	T	3	3	6	0	1	7	0	0
20	28888331	.	T	A	2	4	6	0	0	6	0	0
20	28888743	.	T	A	2	2	4	0	0	4	0	0
20	28888856	.	A	G	1	2	3	0	1	4	0	0
20	28973834	.	T	C	3	4	7	0	0	7	0	0
20	29216103	.	G	T	1	2	3	0	0	3	0	0
20	29268260	.	A	G	2	2	4	0	0	4	0	0
20	29269119	.	T	C	5	9	14	0	1	15	0	0
20	30894408	.	C	T	1	1	2	0	0	2	0	0
20	30894427	.	C	T	0	3	3	0	0	3	0	0
20	30922687	.	G	A	6	11	17	0	1	18	0	0
20	30922688	.	A	T	6	10	16	0	1	18	1	0
20	30922808	.	T	A	3	6	9	0	0	9	0	0
20	30922836	.	C	A	8	4	12	0	1	14	1	0
20	30923101	.	T	C	3	4	7	0	0	7	0	0
20	30931671	.	G	A	12	11	23	0	3	26	0	0
20	30939177	.	T	C	9	4	13	0	0	13	0	0
20	30940566	.	C	G	1	3	4	0	1	5	0	0
20	30947353	.	T	C	39	14	53	0	4	57	0	0
20	30947433	.	T	C	11	13	24	0	4	28	0	0
20	31192720	.	C	T	1	0	1	0	0	1	0	0
20	31193826	.	C	T	5	3	8	0	1	9	0	0
20	31197217	.	G	T	4	6	10	0	0	10	0	0
20	31197307	.	G	A	0	3	3	0	3	6	0	0
20	31197465	.	T	C	7	6	13	0	0	13	0	0
20	31199655	.	G	A	1	0	1	0	0	1	0	0
20	31204173	.	T	C	5	7	12	0	1	13	0	0
20	31204191	.	A	C	8	6	14	0	0	15	1	0
20	31206649	.	A	G	2	3	5	0	0	5	0	0
20	31211701	.	T	A	16	9	25	0	0	25	0	0
20	31211710	.	A	G	14	8	22	0	2	24	0	0
20	31212156	.	G	A	0	12	12	0	19	31	0	0
20	31212390	.	G	C	13	7	20	0	1	21	0	0
20	31223282	.	C	T	1	1	2	0	0	2	0	0
20	31223336	.	C	T	1	2	3	0	0	3	0	0
20	31233189	.	T	C	2	0	2	0	1	3	0	0
20	31233199	.	C	T	0	1	1	0	2	3	0	0
20	31233623	.	T	C	1	2	3	0	0	3	0	0
20	31233679	.	A	G	2	3	5	0	0	5	0	0
20	31429700	.	T	C	18	4	22	0	2	24	0	0
20	31430115	.	A	T	1	5	6	0	1	7	0	0
20	31431561	.	A	G	0	3	3	0	1	4	0	0
20	31436483	.	C	T	1	2	3	0	0	3	0	0
20	31747695	.	G	C	5	11	16	0	0	16	0	0
20	31747860	.	C	T	0	3	3	0	4	7	0	0
20	31748183	.	C	T	3	2	5	0	0	5	0	0
20	31748448	.	A	G	1	3	4	0	1	5	0	0
20	31748518	.	C	T	5	2	7	0	0	7	0	0
20	31749118	.	A	G	1	4	5	0	1	6	0	0
20	32136584	.	T	A	3	2	5	0	0	5	0	0
20	32136588	.	G	T	3	1	4	0	0	4	0	0
20	32138171	.	T	C	3	7	10	0	2	12	0	0
20	32138478	.	A	G	10	8	18	0	1	19	0	0
20	32138692	.	G	A	15	16	31	0	0	31	0	0
20	32138754	.	T	C	7	13	20	0	1	21	0	0
20	32138828	.	C	T	14	24	38	0	0	38	0	0
20	32138965	.	A	T	6	3	9	0	0	9	0	0
20	32138977	.	G	A	0	3	3	0	5	8	0	0
20	32141822	.	A	T	1	3	4	0	0	4	0	0
20	32141959	.	T	A	1	3	4	0	0	4	0	0
20	32144809	.	G	C	3	2	5	0	0	5	0	0
20	32224485	.	C	A	1	2	3	0	0	3	0	0
20	32228863	.	G	A	7	5	12	0	0	12	0	0
20	32228936	.	A	C	4	2	6	0	0	6	0	0
20	32229004	.	G	A	10	7	17	0	2	19	0	0
20	32229053	.	C	T	8	7	15	0	1	16	0	0
20	32229095	.	T	C	5	4	9	0	0	9	0	0
20	32230168	.	T	C	17	16	33	0	1	34	0	0
20	32230301	.	T	C	4	2	6	0	0	6	0	0
20	32230376	.	T	C	8	7	15	0	1	16	0	0
20	32230574	.	T	A	13	15	28	0	0	28	0	0
20	32230592	.	T	A	15	15	30	0	2	32	0	0
20	32230620	.	C	T	14	15	29	0	3	32	0	0
20	32230680	.	A	G	17	12	29	0	1	30	0	0
20	32230720	.	C	G	13	10	23	0	2	25	0	0
20	32230776	.	G	A	15	15	30	0	1	31	0	0
20	32230781	.	G	C	14	16	30	0	2	32	0	0
20	32230836	.	T	C	15	9	24	0	1	25	0	0
20	32286800	.	C	T	0	3	3	0	6	9	0	0
20	32286877	.	A	C	6	5	11	0	1	12	0	0
20	32286923	.	A	T	6	6	12	0	0	12	0	0
20	32286960	.	A	C	4	6	10	0	0	10	0	0
20	32287181	.	C	T	1	4	5	0	2	7	0	0
20	32287317	.	C	T	4	6	10	0	1	11	0	0
20	32288318	.	T	A	2	2	4	0	0	4	0	0
20	32337625	.	T	C	6	3	9	0	0	9	0	0
20	32337734	.	A	C	1	2	3	0	1	4	0	0
20	32432315	.	G	T	7	8	15	0	0	15	0	0
20	32432657	.	A	G	12	1	13	0	14	27	0	0
20	32437987	.	C	T	2	3	5	0	0	5	0	0
20	32437993	.	G	T	2	3	5	0	0	5	0	0
20	32498635	.	C	A	4	2	6	0	0	6	0	0
20	32498639	.	C	A	4	2	6	0	0	6	0	0
20	32498771	.	C	G	3	2	5	0	0	5	0	0
20	32498813	.	A	T	2	3	5	0	0	5	0	0
20	32499166	.	G	A	0	5	5	0	6	11	0	0
20	32499199	.	T	C	4	4	8	0	0	8	0	0
20	32513235	.	G	A	1	2	3	0	1	4	0	0
20	32520330	.	T	C	6	6	12	0	1	13	0	0
20	32520351	.	A	G	6	0	6	0	7	13	0	0
20	32520365	.	A	G	7	0	7	0	8	15	0	0
20	32520673	.	A	G	4	5	9	0	1	10	0	0
20	32520852	.	A	G	4	5	9	0	1	10	0	0
20	32521203	.	C	T	7	15	22	0	0	22	0	0
20	32521377	.	C	T	7	6	13	0	0	13	0	0
20	32521686	.	A	C	21	19	40	0	2	42	0	0
20	32521719	.	A	C	21	22	43	0	2	45	0	0
20	32521742	.	G	A	21	24	45	0	1	46	0	0
20	32756790	.	G	A	0	2	2	0	3	5	0	0
20	32758490	.	A	G	9	17	26	0	0	26	0	0
20	32758558	.	T	C	13	8	21	0	0	21	0	0
20	33189631	.	G	A	7	8	15	0	2	17	0	0
20	33297776	.	A	C	2	2	4	0	0	4	0	0
20	33298651	.	G	A	6	7	13	0	0	13	0	0
20	33468040	.	T	G	14	19	33	0	5	38	0	0
20	33471085	.	G	A	1	2	3	0	0	3	0	0
20	33471127	.	A	T	6	4	10	0	1	11	0	0
20	33471166	.	C	T	0	6	6	0	5	11	0	0
20	33494064	.	A	G	12	7	19	0	4	23	0	0
20	33494436	.	C	T	19	19	38	0	4	43	1	0
20	33748921	.	T	A	4	4	8	0	0	8	0	0
20	33809783	.	C	A	13	11	24	0	1	25	0	0
20	33809846	.	G	C	13	20	33	0	2	35	0	0
20	33809927	.	T	A	11	14	25	0	2	27	0	0
20	33810496	.	G	A	1	3	4	0	0	4	0	0
20	33811435	.	G	A	3	2	5	0	0	5	0	0
20	33811436	.	C	A	3	1	4	0	1	5	0	0
20	33811622	.	A	G	3	7	10	0	1	11	0	0
20	34007128	.	G	A	1	2	3	0	0	3	0	0
20	34007589	.	G	C	1	0	1	0	0	1	0	0
20	34009363	.	G	A	0	0	0	0	1	1	0	0
20	34009947	.	A	G	6	14	20	0	1	21	0	0
20	34009952	.	C	A	6	14	20	0	1	21	0	0
20	34010028	.	A	G	3	3	6	0	1	7	0	0
20	34012649	.	T	A	1	5	6	0	0	6	0	0
20	34012916	.	A	T	13	6	19	0	0	19	0	0
20	34015845	.	C	T	11	7	18	0	1	19	0	0
20	34020861	.	T	A	1	1	2	0	0	2	0	0
20	34039408	.	A	C	6	5	11	0	0	11	0	0
20	34042070	.	A	G	5	6	11	0	0	11	0	0
20	34042209	.	A	G	3	4	7	0	0	7	0	0
20	34044813	.	G	A	3	6	9	0	1	10	0	0
20	34049141	.	G	A	3	0	3	0	0	3	0	0
20	34051417	.	G	A	3	2	5	0	0	5	0	0
20	34053787	.	T	A	1	0	1	0	0	1	0	0
20	34054401	.	C	T	0	1	1	0	0	1	0	0
20	34154118	.	T	C	2	0	2	0	0	2	0	0
20	34155025	.	C	T	6	11	17	0	1	18	0	0
20	34155134	.	G	A	4	7	11	0	0	11	0	0
20	34155339	.	C	A	12	14	26	0	3	29	0	0
20	34155428	.	A	G	13	11	24	0	1	25	0	0
20	34608390	.	C	T	2	1	3	0	1	4	0	0
20	34738198	.	G	A	17	16	33	0	1	34	0	0
20	34738314	.	G	A	11	17	28	0	6	34	0	0
20	34738397	.	G	T	13	10	23	0	0	23	0	0
20	34738473	.	T	G	8	15	23	0	0	23	0	0
20	34738756	.	A	G	9	7	16	0	0	16	0	0
20	34742840	.	G	A	2	2	4	0	0	4	0	0
20	34745872	.	A	G	1	3	4	0	0	4	0	0
20	34746019	.	G	A	3	1	4	0	0	4	0	0
20	34749747	.	G	A	2	1	3	0	1	4	0	0
20	34794668	.	T	C	3	6	9	0	0	9	0	0
20	34794939	.	C	T	26	27	53	0	4	57	0	0
20	34795111	.	C	A	38	24	62	0	6	68	0	0
20	34795126	.	A	G	38	23	61	0	6	67	0	0
20	34795296	.	T	C	19	32	51	0	3	54	0	0
20	34795379	.	T	C	34	23	57	0	4	61	0	0
20	34795473	.	C	T	1	29	30	0	27	57	0	0
20	34795689	.	C	T	22	29	51	0	5	56	0	0
20	34797252	.	G	T	24	30	54	0	1	55	0	0
20	34797598	.	A	T	20	25	45	0	4	49	0	0
20	34955791	.	C	T	34	21	55	0	6	61	0	0
20	34967476	.	T	C	7	0	7	0	10	17	0	0
20	34969773	.	A	T	6	5	11	0	0	11	0	0
20	34975831	.	G	A	2	0	2	0	0	2	0	0
20	34980452	.	T	C	2	1	3	0	0	3	0	0
20	34982018	.	C	T	1	0	1	0	0	1	0	0
20	34982323	.	T	A	1	2	3	0	0	3	0	0
20	34985569	.	A	C	1	1	2	0	1	3	0	0
20	34991739	.	T	A	1	1	2	0	1	3	0	0
20	35064469	.	T	C	6	6	12	0	0	12	0	0
20	35064808	.	C	T	2	0	2	0	0	2	0	0
20	35065345	.	G	A	0	2	2	0	3	5	0	0
20	35065573	.	A	C	4	4	8	0	6	14	0	0
20	35066821	.	G	A	0	4	4	0	17	21	0	0
20	35066935	.	G	A	0	21	21	0	16	37	0	0
20	35068064	.	A	G	11	0	11	0	11	22	0	0
20	35068790	.	A	T	6	5	11	0	0	11	0	0
20	35069063	.	A	C	3	6	9	0	1	10	0	0
20	35069756	.	A	G	8	10	18	0	1	19	0	0
20	35069963	.	A	C	19	18	37	0	2	39	0	0
20	35070176	.	C	T	11	24	35	0	3	38	0	0
20	35070217	.	T	G	24	20	44	0	5	49	0	0
20	35205061	.	C	T	3	6	9	0	0	9	0	0
20	35205182	.	T	C	4	5	9	0	0	9	0	0
20	35205600	.	A	T	13	8	21	0	0	21	0	0
20	35205680	.	A	G	2	4	6	0	0	6	0	0
20	35206101	.	A	T	4	3	7	0	0	7	0	0
20	35208046	.	A	G	3	6	9	0	0	9	0	0
20	35209012	.	G	A	2	7	9	0	0	9	0	0
20	35209201	.	C	T	8	6	14	0	0	14	0	0
20	35209405	.	C	T	13	12	25	0	1	26	0	0
20	35209481	.	G	A	15	8	23	0	3	26	0	0
20	35210175	.	C	A	9	7	16	0	0	16	0	0
20	35210212	.	G	T	6	7	13	0	1	14	0	0
20	35210229	.	A	C	6	4	10	0	0	10	0	0
20	35210282	.	T	C	1	0	1	0	9	10	0	0
20	35210489	.	C	T	0	2	2	0	2	4	0	0
20	35210538	.	C	G	1	3	4	0	1	5	0	0
20	35210690	.	A	G	1	2	3	0	0	3	0	0
20	35210853	.	A	T	2	2	4	0	1	5	0	0
20	35210909	.	T	C	3	3	6	0	0	6	0	0
20	35296980	.	T	C	2	2	4	0	1	5	0	0
20	35297417	.	T	G	8	4	12	0	0	12	0	0
20	35297693	.	G	A	4	7	11	0	0	11	0	0
20	35297699	.	A	G	3	8	11	0	0	11	0	0
20	35392100	.	C	T	4	4	8	0	0	8	0	0
20	35427409	.	G	C	13	22	35	0	0	35	0	0
20	35427676	.	T	G	11	0	11	0	25	36	0	0
20	35427745	.	A	G	17	0	17	0	36	53	0	0
20	35427782	.	T	C	14	34	48	0	3	51	0	0
20	35427907	.	C	G	14	22	36	0	0	36	0	0
20	35427946	.	A	G	17	0	17	0	20	37	0	0
20	35428035	.	A	G	28	15	43	0	2	45	0	0
20	35428085	.	A	G	21	10	31	0	2	33	0	0
20	35428128	.	A	T	27	16	43	0	3	46	0	0
20	35428436	.	G	A	21	22	43	0	3	46	0	0
20	35428633	.	T	C	27	24	51	0	10	61	0	0
20	35428802	.	A	G	17	43	60	0	4	64	0	0
20	35429017	.	T	A	31	7	38	0	4	42	0	0
20	35429610	.	A	T	44	38	82	0	0	82	0	0
20	35433311	.	A	G	7	0	7	0	13	20	0	0
20	35798043	.	T	A	2	2	4	0	0	4	0	0
20	35798370	.	G	A	10	19	29	0	5	34	0	0
20	35798697	.	A	T	2	7	9	0	0	9	0	0
20	35798973	.	T	A	2	8	10	0	1	11	0	0
20	35799001	.	A	G	2	8	10	0	1	11	0	0
20	35799135	.	G	A	6	3	9	0	1	10	0	0
20	35799534	.	T	C	3	3	6	0	1	7	0	0
20	35799612	.	A	T	3	3	6	0	0	6	0	0
20	35799673	.	T	A	1	7	8	0	0	8	0	0
20	35799729	.	T	A	9	3	12	0	0	12	0	0
20	35800098	.	G	A	3	9	12	0	2	14	0	0
20	35979899	.	G	T	1	4	5	0	0	5	0	0
20	35979910	.	T	G	1	4	5	0	0	5	0	0
20	35980021	.	C	T	4	3	7	0	0	7	0	0
20	36297356	.	G	A	0	5	5	0	4	9	0	0
20	36297418	.	C	A	5	4	9	0	1	10	0	0
20	36394423	.	T	C	1	0	1	0	0	1	0	0
20	36394431	.	C	G	1	2	3	0	0	3	0	0
20	36420218	.	A	C	18	16	34	0	1	35	0	0
20	36420713	.	C	T	0	12	12	0	15	27	0	0
20	36420753	.	T	A	11	13	24	0	1	25	0	0
20	36420804	.	G	T	9	10	19	0	4	23	0	0
20	36421219	.	G	A	6	3	9	0	1	10	0	0
20	36421238	.	C	T	3	7	10	0	2	12	0	0
20	36421757	.	C	T	0	4	4	0	3	7	0	0
20	36422098	.	C	A	12	4	16	0	3	19	0	0
20	36422146	.	G	C	11	4	15	0	0	15	0	0
20	36422291	.	G	T	3	2	5	0	0	5	0	0
20	36440113	.	C	T	0	1	1	0	3	4	0	0
20	36516994	.	A	T	1	2	3	0	0	3	0	0
20	36516995	.	C	T	0	2	2	0	1	3	0	0
20	36626195	.	A	G	9	0	9	0	18	27	0	0
20	36626218	.	C	T	8	15	23	0	3	26	0	0
20	36626248	.	G	A	5	20	25	0	0	25	0	0
20	36626335	.	C	T	11	7	18	0	2	20	0	0
20	36626354	.	C	A	13	6	19	0	0	19	0	0
20	36626465	.	C	T	1	8	9	0	1	10	0	0
20	36637604	.	T	A	1	4	5	0	0	5	0	0
20	36637657	.	A	C	4	4	8	0	0	8	0	0
20	36637829	.	T	C	4	3	7	0	0	7	0	0
20	36637999	.	G	A	3	5	8	0	1	9	0	0
20	36638033	.	G	T	2	8	10	0	1	11	0	0
20	36638138	.	C	G	1	4	5	0	1	6	0	0
20	36638169	.	T	C	3	4	7	0	0	7	0	0
20	36675294	.	G	C	5	0	5	0	6	11	0	0
20	36675456	.	G	A	6	3	9	0	0	9	0	0
20	36675468	.	C	T	5	3	8	0	1	9	0	0
20	36677574	.	G	A	0	2	2	0	0	2	0	0
20	36798128	.	T	A	5	4	9	0	0	9	0	0
20	36798154	.	C	G	7	6	13	0	1	14	0	0
20	36816471	.	G	A	1	2	3	0	0	3	0	0
20	36816522	.	G	A	2	3	5	0	0	5	0	0
20	36816972	.	C	T	2	3	5	0	0	5	0	0
20	36817184	.	G	A	0	2	2	0	2	4	0	0
20	36828833	.	T	C	2	2	4	0	0	4	0	0
20	36828948	.	A	C	1	2	3	0	0	4	1	0
20	36829040	.	T	C	3	5	8	0	0	8	0	0
20	36829208	.	T	C	5	0	5	0	4	9	0	0
20	36838717	.	C	T	9	6	15	0	1	16	0	0
20	36838805	.	C	T	3	4	7	0	1	8	0	0
20	36838871	.	C	T	12	12	24	0	0	24	0	0
20	36838896	.	A	G	10	12	22	0	0	22	0	0
20	36915481	.	G	A	11	16	27	0	1	28	0	0
20	36915529	.	G	A	12	13	25	0	1	26	0	0
20	36916004	.	G	A	15	7	22	0	0	22	0	0
20	36916050	.	A	G	11	6	17	0	0	17	0	0
20	37914001	.	A	G	3	2	5	0	1	6	0	0
20	41998507	.	T	C	5	4	9	0	0	9	0	0
20	42221216	.	C	A	0	6	6	0	5	11	0	0
20	42221387	.	A	T	4	4	8	0	0	8	0	0
20	42221438	.	C	A	4	8	12	0	0	13	1	0
20	42221439	.	A	T	4	9	13	0	0	13	0	0
20	42221555	.	C	T	20	15	35	0	3	38	0	0
20	42221731	.	T	G	5	10	15	0	1	16	0	0
20	42222546	.	A	T	3	3	6	0	1	7	0	0
20	42222549	.	A	T	3	3	6	0	1	7	0	0
20	42222769	.	T	C	6	3	9	0	1	10	0	0
20	42222770	.	T	C	5	5	10	0	0	10	0	0
20	42296982	.	A	C	1	1	2	0	1	3	0	0
20	42968811	.	C	T	0	6	6	0	4	10	0	0
20	42968857	.	T	A	2	4	6	0	0	6	0	0
20	43016669	.	G	C	1	3	4	0	0	4	0	0
20	43016739	.	C	T	1	4	5	0	0	5	0	0
20	43016890	.	T	A	2	5	7	0	0	7	0	0
20	43017007	.	T	C	1	2	3	0	0	3	0	0
20	43120256	.	T	G	16	6	22	0	1	23	0	0
20	43120658	.	T	G	9	11	20	0	4	24	0	0
20	43120718	.	C	T	0	11	11	0	9	20	0	0
20	43120753	.	A	T	7	12	19	0	0	19	0	0
20	43133228	.	G	C	0	2	2	0	0	2	0	0
20	43133322	.	G	C	2	3	5	0	1	6	0	0
20	43689138	.	T	A	6	3	9	0	0	9	0	0
20	43689254	.	C	A	7	7	14	0	0	14	0	0
20	43689360	.	C	T	5	14	19	1	2	22	0	0
20	43689418	.	G	A	0	8	8	0	7	15	0	0
20	43715032	.	T	A	5	5	10	0	0	10	0	0
20	43746738	.	A	G	1	2	3	0	0	3	0	0
20	43746749	.	C	T	0	2	2	0	2	4	0	0
20	43746890	.	T	C	5	0	5	0	10	15	0	0
20	43750362	.	A	G	7	8	15	0	0	15	0	0
20	43750680	.	A	G	6	8	14	0	0	14	0	0
20	43776373	.	T	C	20	22	42	0	3	45	0	0
20	43776456	.	T	A	25	21	46	0	2	48	0	0
20	43776841	.	G	A	27	17	44	0	3	47	0	0
20	43776842	.	A	G	17	29	46	0	1	47	0	0
20	43786415	.	T	C	1	3	4	0	1	5	0	0
20	43793065	.	T	C	4	7	11	0	2	13	0	0
20	43793193	.	G	A	19	16	35	0	2	37	0	0
20	43793329	.	C	T	16	6	22	0	2	24	0	0
20	43793410	.	C	A	0	11	11	0	17	28	0	0
20	43793428	.	G	A	17	13	30	0	1	31	0	0
20	43793666	.	C	T	1	4	5	0	6	11	0	0
20	43793683	.	G	A	6	4	10	0	0	10	0	0
20	43793702	.	C	T	5	6	11	0	0	11	0	0
20	43793867	.	A	C	5	14	19	0	1	20	0	0
20	43793901	.	A	G	5	15	20	0	2	22	0	0
20	43793960	.	A	T	11	8	19	0	1	20	0	0
20	43794004	.	G	A	11	8	19	0	2	21	0	0
20	43794053	.	A	T	17	10	27	0	2	29	0	0
20	43794312	.	C	T	0	3	3	0	3	6	0	0
20	43794488	.	A	G	4	2	6	0	0	6	0	0
20	44347598	.	A	G	1	2	3	0	0	3	0	0
20	44347612	.	A	T	2	3	5	0	0	5	0	0
20	44372902	.	A	T	14	5	19	0	0	19	0	0
20	44372973	.	C	A	4	4	8	0	1	9	0	0
20	44372977	.	C	T	3	4	7	0	1	8	0	0
20	44373231	.	C	A	0	3	3	0	13	16	0	0
20	44373235	.	T	A	8	3	11	0	5	16	0	0
20	44386452	.	C	T	1	8	9	0	9	18	0	0
20	44386561	.	G	A	0	0	0	0	1	1	0	0
20	44464875	.	G	T	14	6	20	0	2	22	0	0
20	44567107	.	T	C	1	2	3	0	1	4	0	0
20	44799458	.	T	A	7	2	9	0	0	9	0	0
20	45406735	.	C	A	2	1	3	0	4	10	3	0
20	45406783	.	C	T	8	5	13	0	0	13	0	0
20	45406870	.	G	A	14	15	29	0	1	30	0	0
20	45407313	.	T	A	4	9	13	0	2	15	0	0
20	45407994	.	T	G	6	2	8	0	0	8	0	0
20	45408179	.	G	C	4	2	6	0	1	7	0	0
20	45408436	.	G	A	1	3	4	0	4	8	0	0
20	45644227	.	G	A	2	4	6	0	0	6	0	0
20	45644275	.	G	A	2	0	2	0	0	2	0	0
20	45745523	.	C	T	2	2	4	0	0	4	0	0
20	45746150	.	G	A	2	5	7	0	0	7	0	0
20	45746402	.	G	A	4	5	9	0	0	9	0	0
20	45746432	.	C	T	4	4	8	0	1	9	0	0
20	45746486	.	T	C	8	5	13	0	0	13	0	0
20	45746674	.	C	A	7	6	13	0	0	13	0	0
20	45746678	.	C	T	7	5	12	0	0	12	0	0
20	45746936	.	C	G	6	7	13	0	1	14	0	0
20	45747032	.	G	C	0	10	10	0	14	24	0	0
20	45747125	.	G	A	0	3	3	0	0	3	0	0
20	45751304	.	T	C	2	0	2	0	0	2	0	0
20	45751364	.	T	A	16	7	23	0	0	23	0	0
20	45751466	.	G	A	6	13	19	0	4	23	0	0
20	45751526	.	T	G	18	10	28	0	0	28	0	0
20	45751563	.	T	C	22	13	35	0	1	36	0	0
20	45751668	.	G	A	9	5	14	0	0	14	0	0
20	45898727	.	C	T	3	7	10	0	0	10	0	0
20	46352444	.	G	C	2	3	5	0	0	5	0	0
20	46352460	.	A	T	3	2	5	0	0	5	0	0
20	46442459	.	A	G	13	10	23	0	1	24	0	0
20	46451592	.	G	A	1	3	4	0	0	4	0	0
20	46457175	.	A	T	7	4	11	0	1	12	0	0
20	46457376	.	A	G	1	3	4	0	0	4	0	0
20	46466934	.	G	T	2	1	3	0	0	3	0	0
20	46467174	.	A	C	2	3	5	0	0	5	0	0
20	46508767	.	C	T	1	3	4	0	0	4	0	0
20	46509343	.	A	G	0	0	0	0	1	1	0	0
20	46515680	.	C	T	2	2	4	0	0	4	0	0
20	46517173	.	A	T	1	1	2	0	0	2	0	0
20	46517429	.	C	T	0	2	2	0	0	2	0	0
20	46519076	.	A	G	1	1	2	0	0	2	0	0
20	46519082	.	G	A	0	1	1	0	3	4	0	0
20	46523196	.	G	A	10	7	17	0	0	17	0	0
20	46525639	.	T	A	4	5	9	0	0	9	0	0
20	46528643	.	T	C	0	1	1	0	0	1	0	0
20	46529398	.	G	A	1	5	6	0	0	6	0	0
20	46536906	.	T	G	21	16	37	0	4	41	0	0
20	46536936	.	G	T	19	19	38	0	0	38	0	0
20	46536981	.	C	T	26	15	41	0	1	42	0	0
20	46537143	.	A	T	31	12	43	1	4	48	0	0
20	46537231	.	C	G	18	14	32	0	1	33	0	0
20	46537563	.	A	G	17	18	35	0	1	36	0	0
20	46537636	.	G	A	14	6	20	0	1	21	0	0
20	46553020	.	T	G	25	23	48	0	2	50	0	0
20	46553274	.	G	C	22	21	43	0	2	45	0	0
20	46553995	.	T	A	1	2	3	0	0	3	0	0
20	46572589	.	T	C	1	0	1	0	0	1	0	0
20	46594507	.	C	T	5	3	8	0	0	8	0	0
20	46724740	.	C	T	0	4	4	0	2	6	0	0
20	46730654	.	T	C	3	3	6	0	0	6	0	0
20	46730663	.	G	A	3	3	6	0	0	6	0	0
20	46730734	.	C	T	4	2	6	0	0	6	0	0
20	46731010	.	T	A	3	2	5	0	1	6	0	0
20	46732062	.	G	T	1	2	3	0	0	3	0	0
20	46732336	.	T	G	1	0	1	0	7	8	0	0
20	46732359	.	T	C	0	3	3	0	0	3	0	0
20	46732848	.	T	A	8	10	18	0	1	19	0	0
20	46732887	.	C	T	9	8	17	0	1	18	0	0
20	46733096	.	C	T	3	2	5	0	2	7	0	0
20	46733764	.	A	G	8	12	20	0	3	23	0	0
20	46733809	.	G	A	18	9	27	0	1	28	0	0
20	46831124	.	T	C	11	14	25	0	1	26	0	0
20	46957559	.	G	T	28	22	50	0	0	50	0	0
20	46957575	.	C	G	22	26	48	0	2	50	0	0
20	46957600	.	T	A	18	17	35	0	4	39	0	0
20	46957650	.	A	T	23	20	43	0	2	45	0	0
20	46957803	.	T	A	22	16	38	0	2	40	0	0
20	46958136	.	C	T	8	6	14	0	2	16	0	0
20	46958478	.	T	C	9	1	10	0	12	22	0	0
20	46958705	.	G	T	6	12	18	0	1	19	0	0
20	46958766	.	T	A	3	10	13	0	0	13	0	0
20	46959135	.	T	C	3	10	13	0	1	14	0	0
20	46959147	.	A	T	4	9	13	0	1	14	0	0
20	46959504	.	T	C	1	3	4	0	0	4	0	0
20	46959525	.	T	C	2	0	2	0	4	6	0	0
20	46959543	.	A	T	3	5	8	0	0	8	0	0
20	47290466	.	A	T	10	3	13	0	1	14	0	0
20	47290698	.	T	A	5	2	7	0	1	8	0	0
20	47290705	.	T	C	5	1	6	0	0	6	0	0
20	47383913	.	A	G	0	5	5	0	0	5	0	0
20	47435018	.	T	A	7	3	10	0	1	11	0	0
20	47435065	.	G	T	0	3	3	0	3	6	0	0
20	47471391	.	A	G	16	0	16	0	6	22	0	0
20	47689570	.	A	G	3	3	6	0	0	6	0	0
20	47689621	.	A	T	10	10	20	0	0	20	0	0
20	47689647	.	A	C	10	0	10	0	9	19	0	0
20	47689671	.	T	C	7	6	13	0	0	13	0	0
20	47689801	.	C	T	10	11	21	0	1	22	0	0
20	47700055	.	C	T	1	1	2	0	1	3	0	0
20	47718458	.	T	C	11	10	21	0	2	23	0	0
20	47931995	.	A	G	1	2	3	0	0	3	0	0
20	47932268	.	G	T	19	14	33	0	0	33	0	0
20	47932424	.	T	C	14	18	32	0	0	32	0	0
20	47932867	.	T	C	3	4	7	0	0	7	0	0
20	47938981	.	C	T	0	1	1	0	0	1	0	0
20	47942600	.	G	A	1	1	2	0	1	3	0	0
20	47942651	.	A	G	0	2	2	0	0	2	0	0
20	47944151	.	G	A	0	2	2	0	0	2	0	0
20	47973272	.	T	C	0	1	1	0	0	1	0	0
20	48296314	.	T	C	3	0	3	0	2	5	0	0
20	48296315	.	A	G	3	2	5	0	0	5	0	0
20	48298716	.	C	T	0	2	2	0	0	2	0	0
20	49725935	.	A	G	3	2	5	0	0	5	0	0
20	49726690	.	A	G	2	3	5	0	0	5	0	0
20	49916653	.	T	C	1	0	1	0	1	2	0	0
20	49928292	.	C	A	4	8	12	0	0	12	0	0
20	49928295	.	A	G	4	0	4	0	8	12	0	0
20	49928358	.	A	T	1	3	4	0	1	5	0	0
20	50022384	.	A	G	0	1	1	0	0	1	0	0
20	50022393	.	G	C	0	1	1	0	0	1	0	0
20	50049078	.	C	A	17	6	23	0	0	23	0	0
20	50074173	.	C	T	5	4	9	0	0	9	0	0
20	50074212	.	C	T	3	3	6	0	0	6	0	0
20	50079019	.	C	G	5	2	7	0	0	7	0	0
20	50079067	.	T	C	5	3	8	0	0	8	0	0
20	50079070	.	A	G	5	3	8	0	0	8	0	0
20	50079154	.	T	C	1	0	1	0	1	2	0	0
20	50082425	.	A	G	3	3	6	0	0	6	0	0
20	50082861	.	T	C	3	5	8	0	0	8	0	0
20	50085935	.	T	A	5	1	6	0	1	7	0	0
20	50989199	.	A	G	3	0	3	0	6	9	0	0
20	50996515	.	G	T	0	7	7	0	6	13	0	0
20	50998672	.	T	A	13	17	30	0	4	34	0	0
20	50998746	.	A	G	17	13	30	0	1	31	0	0
20	50998858	.	C	T	17	33	50	0	2	52	0	0
20	50999311	.	T	C	1	4	5	0	2	7	0	0
20	51069996	.	T	C	4	3	7	0	0	7	0	0
20	51073358	.	C	G	2	2	4	0	0	4	0	0
20	51073670	.	A	T	6	4	10	0	0	10	0	0
20	51073730	.	G	A	4	6	10	0	2	12	0	0
20	51073791	.	C	T	9	8	17	0	0	17	0	0
20	51073799	.	T	A	8	5	13	0	2	15	0	0
20	51074170	.	C	T	1	2	3	0	0	3	0	0
20	51074209	.	G	T	1	2	3	0	0	3	0	0
20	51074463	.	T	C	5	3	8	0	0	8	0	0
20	51074517	.	G	A	0	4	4	0	4	8	0	0
20	51074535	.	C	T	4	4	8	0	0	8	0	0
20	51088683	.	G	A	19	23	42	0	2	44	0	0
20	51088920	.	C	T	20	24	44	0	3	47	0	0
20	51088967	.	C	A	17	29	46	0	2	48	0	0
20	51089243	.	T	C	12	19	31	0	1	32	0	0
20	51089328	.	C	T	1	17	18	0	23	41	0	0
20	51089487	.	A	C	18	19	37	0	2	39	0	0
20	51089495	.	C	G	18	17	35	0	2	37	0	0
20	51089559	.	G	A	25	14	39	0	4	43	0	0
20	51089831	.	A	G	29	10	39	0	2	41	0	0
20	51117661	.	A	C	6	7	13	0	0	13	0	0
20	51118227	.	A	G	6	0	6	0	7	13	0	0
20	51118281	.	C	A	23	26	49	0	1	50	0	0
20	51122939	.	C	T	14	12	26	0	1	27	0	0
20	51123109	.	G	C	14	11	25	0	2	27	0	0
20	51123151	.	A	T	22	12	34	0	2	36	0	0
20	51123229	.	C	T	1	7	8	0	1	9	0	0
20	51132284	.	A	G	24	12	36	0	10	46	0	0
20	51141284	.	C	T	0	10	10	0	13	23	0	0
20	51141347	.	A	G	9	11	20	0	0	20	0	0
20	51145837	.	A	G	4	5	9	0	2	11	0	0
20	51145888	.	T	C	7	0	7	0	13	20	0	0
20	51146153	.	G	A	10	10	20	0	2	22	0	0
20	51150029	.	G	T	6	11	17	0	2	19	0	0
20	51151647	.	G	A	2	1	3	0	0	3	0	0
20	51157010	.	T	G	1	4	5	0	1	6	0	0
20	51157109	.	C	T	16	10	26	0	0	26	0	0
20	51157204	.	G	A	8	9	17	0	0	17	0	0
20	51168502	.	T	C	2	2	4	0	0	4	0	0
20	51168559	.	A	T	1	0	1	0	0	1	0	0
20	51199791	.	T	C	9	5	14	0	1	15	0	0
20	51207672	.	C	T	26	40	66	0	5	71	0	0
20	51211455	.	G	A	9	47	56	0	30	86	0	0
20	51211459	.	A	G	33	12	45	0	36	82	1	0
20	51274618	.	G	T	1	7	8	0	0	8	0	0
20	51333283	.	T	A	1	3	4	0	0	4	0	0
20	51333289	.	A	G	0	0	0	0	4	4	0	0
20	51334266	.	T	A	5	3	8	0	0	8	0	0
20	51334286	.	A	G	3	5	8	0	0	8	0	0
20	51334434	.	G	A	3	2	5	0	1	6	0	0
20	51344526	.	A	C	0	0	0	0	1	1	0	0
20	51363773	.	A	G	5	2	7	0	0	7	0	0
20	51370329	.	C	T	13	13	26	0	2	28	0	0
20	51377075	.	C	T	0	2	2	0	1	3	0	0
20	51377158	.	G	A	3	9	12	0	1	13	0	0
20	51377261	.	G	A	8	5	13	0	0	13	0	0
20	51383706	.	C	T	0	4	4	0	2	6	0	0
20	51386487	.	G	A	2	2	4	0	0	4	0	0
20	51476691	.	T	C	2	2	4	0	0	4	0	0
20	51647836	.	A	G	6	2	8	0	1	9	0	0
20	51647872	.	A	T	7	7	14	0	0	14	0	0
20	51647978	.	G	A	7	8	15	0	0	15	0	0
20	51648008	.	A	G	6	7	13	0	1	14	0	0
20	51648019	.	A	T	5	7	12	0	0	12	0	0
20	51648114	.	T	G	2	6	8	0	0	8	0	0
20	51648625	.	A	G	3	2	5	0	0	5	0	0
20	51649521	.	A	C	2	2	4	0	0	4	0	0
20	51649533	.	A	G	2	2	4	0	0	4	0	0
20	51704001	.	C	T	1	1	2	0	0	2	0	0
20	51745943	.	G	A	2	3	5	0	1	6	0	0
20	51753384	.	A	T	6	5	11	1	0	12	0	0
20	51753512	.	G	T	6	10	16	0	1	17	0	0
20	51753728	.	T	A	3	2	5	0	1	6	0	0
20	51758608	.	A	C	13	7	20	0	1	22	1	0
20	51758611	.	A	C	16	7	23	0	0	23	0	0
20	51758975	.	A	G	7	10	17	0	1	18	0	0
20	51759562	.	G	A	11	6	17	0	0	17	0	0
20	51787380	.	A	G	1	0	1	0	0	1	0	0
20	51787392	.	T	C	1	0	1	0	0	1	0	0
20	51798112	.	T	C	1	2	3	0	1	4	0	0
20	51802242	.	G	A	1	0	1	0	0	1	0	0
20	52333008	.	C	T	0	3	3	0	0	3	0	0
20	52333009	.	A	T	0	3	3	0	0	3	0	0
20	52333177	.	T	C	1	0	1	0	6	7	0	0
20	52333202	.	T	C	1	7	8	0	1	9	0	0
20	52333385	.	G	A	0	3	3	0	0	3	0	0
20	52333388	.	A	G	0	3	3	0	0	3	0	0
20	52486247	.	G	A	1	0	1	0	0	1	0	0
20	52544394	.	G	T	0	6	6	0	2	8	0	0
20	52544491	.	A	C	10	4	14	0	0	14	0	0
20	52544559	.	T	C	12	10	22	0	0	22	0	0
20	52544612	.	G	T	4	5	9	0	0	9	0	0
20	52554022	.	G	T	6	4	10	0	1	11	0	0
20	52554065	.	A	C	3	9	12	0	3	15	0	0
20	52554547	.	A	C	17	11	28	0	3	31	0	0
20	52554685	.	A	G	3	3	6	0	0	6	0	0
20	52561670	.	A	G	14	11	25	0	3	28	0	0
20	52563215	.	C	A	1	0	1	0	1	2	0	0
20	52568373	.	C	G	0	1	1	0	1	2	0	0
20	52574813	.	G	A	0	15	15	0	21	36	0	0
20	52575377	.	T	C	17	13	30	0	2	32	0	0
20	52725230	.	A	G	1	2	3	0	0	3	0	0
20	53069778	.	C	T	0	2	2	0	3	5	0	0
20	53069784	.	G	A	3	3	6	0	0	6	0	0
20	53183510	.	C	T	0	1	1	0	0	1	0	0
20	53230903	.	G	T	0	3	3	0	5	8	0	0
20	53262237	.	G	T	0	10	10	0	7	17	0	0
20	53262283	.	C	T	5	10	15	0	1	16	0	0
20	53391922	.	G	T	1	2	3	0	0	3	0	0
20	53393594	.	T	C	2	2	4	0	0	4	0	0
20	53393669	.	C	A	2	3	5	0	0	5	0	0
20	53396160	.	G	A	0	0	0	0	1	1	0	0
20	53398790	.	C	T	5	10	15	0	0	15	0	0
20	53408532	.	G	A	1	2	3	0	0	3	0	0
20	53640199	.	A	T	0	1	1	0	0	1	0	0
20	53640200	.	T	C	0	1	1	0	0	1	0	0
20	53641462	.	T	C	8	14	22	0	0	22	0	0
20	53898770	.	C	T	0	17	17	0	19	36	0	0
20	53898930	.	G	A	9	8	17	0	1	18	0	0
20	53898968	.	A	T	15	10	25	0	0	26	1	0
20	53899023	.	G	C	13	9	22	0	3	26	1	0
20	53899035	.	G	A	13	8	21	0	2	23	0	0
20	53899063	.	G	A	6	11	17	0	1	18	0	0
20	53899104	.	A	C	4	0	4	0	12	16	0	0
20	53968126	.	A	G	26	23	49	0	2	51	0	0
20	53970281	.	C	T	14	7	21	1	1	23	0	0
20	53974508	.	T	C	2	5	7	0	1	8	0	0
20	53974565	.	G	A	2	5	7	0	1	8	0	0
20	53974580	.	G	A	2	5	7	0	0	7	0	0
20	54067414	.	G	A	6	2	8	0	0	8	0	0
20	54085851	.	T	C	12	4	16	0	4	20	0	0
20	54196791	.	T	C	15	1	16	0	13	29	0	0
20	54197263	.	G	C	15	9	24	0	1	25	0	0
20	54197287	.	A	T	12	13	25	0	1	26	0	0
20	54197383	.	G	A	12	13	25	0	0	25	0	0
20	54197473	.	A	G	7	10	17	0	2	19	0	0
20	54205704	.	C	T	7	8	15	0	2	17	0	0
20	54215115	.	A	G	13	16	29	0	6	35	0	0
20	54219286	.	T	C	4	0	4	0	1	5	0	0
20	54232738	.	A	G	9	8	17	0	1	18	0	0
20	54249577	.	G	C	5	12	17	0	1	18	0	0
20	54251406	.	T	C	5	5	10	0	0	10	0	0
20	54274516	.	T	C	2	4	6	0	0	6	0	0
20	54274521	.	A	T	3	4	7	0	0	7	0	0
20	54283695	.	A	G	0	2	2	0	2	4	0	0
20	54286145	.	A	G	10	14	24	0	1	25	0	0
20	54286797	.	G	T	12	9	21	0	1	22	0	0
20	54343720	.	A	T	2	5	7	0	0	7	0	0
20	54343866	.	G	A	4	3	7	0	0	7	0	0
20	54344373	.	T	G	5	5	10	0	3	13	0	0
20	54344386	.	T	A	4	3	7	0	2	9	0	0
20	54344533	.	G	A	8	3	11	0	1	12	0	0
20	54344795	.	G	A	4	7	11	0	0	11	0	0
20	54344815	.	G	T	1	5	6	0	0	6	0	0
20	54344900	.	T	G	3	5	8	0	0	8	0	0
20	54345798	.	C	T	5	2	7	0	0	7	0	0
20	54345895	.	C	T	14	12	26	0	3	29	0	0
20	54346124	.	A	T	14	10	24	0	1	25	0	0
20	54346361	.	A	G	1	2	3	0	0	3	0	0
20	54350102	.	C	T	0	1	1	0	0	1	0	0
20	54355807	.	A	G	6	0	6	0	6	12	0	0
20	54357955	.	C	T	5	3	8	0	0	8	0	0
20	54357979	.	T	C	0	1	1	0	0	1	0	0
20	54360143	.	G	A	3	9	12	0	0	12	0	0
20	54360148	.	G	T	0	6	6	0	3	9	0	0
20	54402157	.	G	T	0	2	2	0	4	6	0	0
20	54402211	.	G	A	0	8	8	0	3	11	0	0
20	54402346	.	G	A	3	4	7	0	0	7	0	0
20	54402400	.	C	G	2	0	2	0	7	9	0	0
20	54402553	.	C	T	3	3	6	0	0	6	0	0
20	54406954	.	G	A	8	12	20	0	1	21	0	0
20	54407196	.	G	A	0	23	23	0	8	31	0	0
20	54422636	.	G	A	23	16	39	0	2	41	0	0
20	54422780	.	C	G	13	11	24	0	2	26	0	0
20	54422868	.	T	G	12	9	21	0	0	21	0	0
20	54422884	.	G	A	13	5	18	0	1	19	0	0
20	54422909	.	C	T	7	12	19	0	2	21	0	0
20	54422929	.	G	A	7	15	22	0	1	23	0	0
20	54423005	.	T	C	8	7	15	0	1	16	0	0
20	54423217	.	C	T	0	9	9	0	11	20	0	0
20	54434895	.	G	A	3	7	10	0	0	10	0	0
20	54434918	.	C	T	5	11	16	0	0	16	0	0
20	54446877	.	G	A	5	10	15	0	2	17	0	0
20	54462151	.	G	C	3	4	7	0	0	7	0	0
20	54563425	.	A	G	4	4	8	0	0	8	0	0
20	54563995	.	G	A	2	2	4	0	0	4	0	0
20	54563998	.	G	C	2	2	4	0	0	4	0	0
20	54670836	.	C	G	1	2	3	0	2	5	0	0
20	54670966	.	A	G	2	2	4	0	0	4	0	0
20	54672869	.	T	C	2	2	4	0	0	4	0	0
20	54672891	.	T	C	1	2	3	0	0	3	0	0
20	54672974	.	G	A	0	2	2	0	5	7	0	0
20	54673175	.	T	C	2	4	6	0	1	7	0	0
20	54673198	.	T	A	4	4	8	0	2	10	0	0
20	54675294	.	T	C	6	8	14	0	0	14	0	0
20	54675308	.	C	G	7	0	7	0	11	18	0	0
20	54675356	.	C	T	9	13	22	0	0	22	0	0
20	54675391	.	T	C	6	7	13	0	0	13	0	0
20	54676529	.	A	G	5	1	6	0	16	22	0	0
20	54676532	.	T	G	5	20	25	0	0	25	0	0
20	54681734	.	G	A	10	11	21	0	1	22	0	0
20	54681797	.	T	A	8	14	22	0	2	24	0	0
20	54681944	.	A	T	10	5	15	0	0	15	0	0
20	54708193	.	T	C	1	2	3	0	0	3	0	0
20	54708277	.	G	A	0	2	2	0	3	5	0	0
20	54711535	.	G	C	1	2	3	0	0	3	0	0
20	54740904	.	G	A	5	13	18	0	0	18	0	0
20	54740907	.	A	G	6	0	6	0	12	18	0	0
20	54740955	.	C	T	3	6	9	0	0	9	0	0
20	54740976	.	G	T	1	2	3	0	5	8	0	0
20	54741763	.	G	A	3	5	8	0	0	8	0	0
20	54742641	.	C	G	9	3	12	0	0	12	0	0
20	54742765	.	A	C	9	4	13	0	0	13	0	0
20	54742912	.	A	C	6	10	16	0	1	17	0	0
20	54743001	.	C	T	3	1	4	0	0	4	0	0
20	54743565	.	T	C	17	13	30	2	4	36	0	0
20	54743917	.	G	A	21	9	30	0	4	34	0	0
20	54743937	.	C	T	18	8	26	0	0	26	0	0
20	54744230	.	C	T	14	15	29	0	4	33	0	0
20	54744419	.	A	G	15	23	38	0	7	45	0	0
20	54744451	.	A	G	25	8	33	0	0	33	0	0
21	40609	.	T	C	16	14	30	0	1	31	0	0
21	41914	.	A	G	3	3	6	0	0	6	0	0
21	173536	.	A	G	4	4	8	0	0	8	0	0
21	173545	.	T	C	5	5	10	0	0	10	0	0
21	178062	.	T	C	1	3	4	0	0	4	0	0
21	178129	.	G	A	5	6	11	0	0	11	0	0
21	178193	.	T	A	4	4	8	0	1	9	0	0
21	178227	.	G	A	0	4	4	0	7	11	0	0
21	178247	.	G	T	4	5	9	0	0	9	0	0
21	178559	.	T	C	1	8	9	0	2	11	0	0
21	178697	.	A	T	2	2	4	1	2	7	0	0
21	178703	.	A	T	0	2	2	1	3	6	0	0
21	217974	.	T	C	8	8	16	0	1	17	0	0
21	218795	.	A	G	4	2	6	0	1	7	0	0
21	219250	.	C	T	0	2	2	0	5	7	0	0
21	219259	.	T	C	4	0	4	0	3	7	0	0
21	233123	.	G	C	9	10	19	0	0	19	0	0
21	237246	.	G	C	2	1	3	0	0	3	0	0
21	247942	.	T	C	9	3	12	0	1	13	0	0
21	248156	.	C	G	14	9	23	0	4	27	0	0
21	248284	.	A	C	4	5	9	0	1	10	0	0
21	248286	.	A	C	5	5	10	0	0	10	0	0
21	248396	.	C	T	7	7	14	0	2	16	0	0
21	262572	.	C	G	1	1	2	0	1	3	0	0
21	267717	.	T	C	2	1	3	0	0	3	0	0
21	269053	.	G	C	3	6	9	0	15	24	0	0
21	269057	.	G	A	15	6	21	0	3	24	0	0
21	269117	.	T	C	14	8	22	0	0	22	0	0
21	269328	.	G	A	1	4	5	0	9	14	0	0
21	269348	.	A	G	8	6	14	0	0	14	0	0
21	269391	.	G	A	2	6	8	0	0	8	0	0
21	269634	.	T	C	9	6	15	0	1	16	0	0
21	269676	.	C	T	8	4	12	0	1	13	0	0
21	269693	.	A	T	8	4	12	0	0	12	0	0
21	269727	.	C	T	11	3	14	0	1	15	0	0
21	269789	.	A	G	6	7	13	0	0	13	0	0
21	269840	.	A	T	6	4	10	0	0	10	0	0
21	269858	.	G	A	4	2	6	0	0	6	0	0
21	272086	.	G	A	2	2	4	0	0	4	0	0
21	272159	.	T	C	1	2	3	0	1	4	0	0
21	272206	.	T	C	1	2	3	0	0	3	0	0
21	301298	.	G	A	10	9	19	0	4	23	0	0
21	303310	.	G	A	4	3	7	0	0	7	0	0
21	409978	.	G	A	0	6	6	0	9	15	0	0
21	409986	.	G	A	8	5	13	0	2	15	0	0
21	410025	.	T	A	7	4	11	0	0	11	0	0
21	410048	.	T	C	10	8	18	1	2	21	0	0
21	410139	.	A	G	6	9	15	0	0	15	0	0
21	410268	.	A	G	7	6	13	0	2	15	0	0
21	410281	.	C	T	7	8	15	0	0	15	0	0
21	410320	.	T	G	9	5	14	0	0	14	0	0
21	520628	.	G	A	1	4	5	0	0	5	0	0
21	522633	.	A	T	1	2	3	0	0	3	0	0
21	734876	.	A	G	17	5	22	0	1	23	0	0
21	735222	.	A	G	38	1	39	0	23	62	0	0
21	1604351	.	G	A	0	2	2	0	2	4	0	0
21	1610710	.	C	A	1	2	3	0	0	3	0	0
21	1610719	.	A	T	1	2	3	0	0	3	0	0
21	1991007	.	G	T	5	7	12	0	0	12	0	0
21	1991097	.	A	G	11	3	14	0	2	16	0	0
21	1991118	.	G	A	11	4	15	0	1	16	0	0
21	1991160	.	G	A	4	1	5	0	0	5	0	0
21	1996944	.	T	C	1	1	2	0	0	2	0	0
21	2120193	.	A	G	1	2	3	0	0	3	0	0
21	2180408	.	C	T	0	2	2	0	1	3	0	0
21	2236114	.	T	C	0	3	3	0	0	3	0	0
21	2281135	.	C	T	1	3	4	0	0	4	0	0
21	2949861	.	A	G	2	2	4	0	0	4	0	0
21	2958040	.	C	T	2	3	5	0	0	5	0	0
21	5368346	.	G	A	5	5	10	0	1	11	0	0
21	5368417	.	C	T	1	11	12	0	6	18	0	0
21	5368461	.	C	T	0	11	11	0	7	18	0	0
21	5368510	.	C	T	0	8	8	0	7	15	0	0
21	5370451	.	T	A	5	6	11	0	1	12	0	0
21	5781134	.	C	T	27	31	58	0	6	64	0	0
21	5789938	.	G	A	13	13	26	0	0	26	0	0
21	5796060	.	T	C	16	13	29	0	1	30	0	0
21	5798978	.	T	A	12	11	23	0	0	23	0	0
21	5802878	.	A	G	2	4	6	0	0	6	0	0
21	5803495	.	T	C	1	1	2	0	2	4	0	0
21	5807177	.	A	C	10	16	26	0	0	26	0	0
21	5884836	.	G	A	1	16	17	0	28	45	0	0
21	5884897	.	T	A	22	30	52	0	1	53	0	0
21	5884945	.	G	A	20	21	41	0	4	45	0	0
21	5885071	.	T	G	1	4	5	1	1	7	0	0
21	5920530	.	A	C	1	4	5	0	0	5	0	0
21	5920535	.	G	A	1	4	5	0	0	5	0	0
21	5929158	.	C	T	3	2	5	0	0	5	0	0
21	5932610	.	C	T	1	4	5	0	0	5	0	0
21	5938291	.	T	C	3	1	4	0	0	4	0	0
21	5938303	.	A	T	1	4	5	0	0	5	0	0
21	5938329	.	T	A	0	5	5	0	1	6	0	0
21	5938439	.	A	G	1	0	1	0	4	5	0	0
21	5942661	.	G	T	9	7	16	0	1	17	0	0
21	5942868	.	T	G	11	7	18	0	0	18	0	0
21	5942906	.	C	A	12	8	20	0	1	21	0	0
21	5942927	.	C	T	7	14	21	0	0	21	0	0
21	5971630	.	C	A	3	0	3	0	1	4	0	0
21	5971638	.	C	A	2	2	4	0	1	5	0	0
21	5971839	.	A	T	3	3	6	0	1	7	0	0
21	5971949	.	A	T	10	4	14	0	0	14	0	0
21	5971983	.	C	T	6	8	14	0	0	14	0	0
21	5972087	.	G	T	0	6	6	0	16	22	0	0
21	5972092	.	T	C	14	5	19	0	0	19	0	0
21	5972252	.	A	G	11	4	15	0	0	15	0	0
21	6133588	.	T	C	2	3	5	0	0	5	0	0
21	6133996	.	T	G	0	3	3	0	0	3	0	0
21	6134095	.	G	A	3	2	5	0	0	5	0	0
21	6134098	.	A	T	2	3	5	0	0	5	0	0
21	6134234	.	T	C	1	4	5	0	0	5	0	0
21	6134238	.	G	T	0	4	4	0	1	5	0	0
21	6134276	.	A	T	0	4	4	0	0	4	0	0
21	6134289	.	G	A	1	3	4	0	0	4	0	0
21	6134348	.	A	T	4	4	8	1	0	9	0	0
21	6149938	.	T	C	9	24	33	0	1	34	0	0
21	6150504	.	A	G	1	1	2	0	4	6	0	0
21	7127667	.	C	A	1	13	14	0	0	14	0	0
21	7832258	.	C	T	5	2	7	0	0	7	0	0
21	11493661	.	A	G	9	11	20	0	1	21	0	0
21	11494536	.	A	G	7	0	7	0	27	34	0	0
21	11501975	.	A	G	12	25	37	0	4	41	0	0
21	11502056	.	A	G	44	12	56	0	2	58	0	0
21	11502143	.	A	G	9	48	57	0	2	59	0	0
21	11883142	.	A	G	1	2	3	0	0	3	0	0
21	11883145	.	A	G	1	3	4	0	0	4	0	0
21	13330967	.	G	T	6	3	9	0	0	9	0	0
21	13611849	.	G	A	2	2	4	0	1	5	0	0
21	13611930	.	G	T	1	3	4	0	0	4	0	0
21	13611990	.	C	T	0	2	2	0	3	5	0	0
21	13612174	.	T	A	2	3	5	0	1	6	0	0
21	13612559	.	A	T	1	5	6	0	0	6	0	0
21	13686042	.	A	T	1	3	4	0	0	4	0	0
21	13686054	.	C	T	1	3	4	0	0	4	0	0
21	13702751	.	A	T	11	7	18	0	2	20	0	0
21	13714602	.	T	C	7	5	12	0	0	12	0	0
21	13714603	.	G	A	6	5	11	0	1	12	0	0
21	13715285	.	T	A	0	1	1	0	0	1	0	0
21	13715347	.	T	A	2	3	5	0	0	5	0	0
21	13715356	.	A	G	2	2	4	0	0	4	0	0
21	13751205	.	G	C	1	2	3	0	0	3	0	0
21	13796033	.	G	A	1	1	2	0	0	2	0	0
21	13796165	.	G	A	1	2	3	0	0	3	0	0
21	13796743	.	A	G	11	16	27	0	2	29	0	0
21	13895741	.	C	T	3	0	3	0	0	3	0	0
21	13895799	.	C	A	5	5	10	0	0	10	0	0
21	13895849	.	G	A	0	2	2	0	0	2	0	0
21	13909005	.	T	C	4	5	9	0	0	9	0	0
21	13919482	.	C	T	9	12	21	0	8	29	0	0
21	13919498	.	C	A	10	14	24	0	6	30	0	0
21	13920204	.	G	C	1	16	17	0	48	65	0	0
21	13920308	.	C	T	25	15	40	0	8	48	0	0
21	13920510	.	G	A	4	40	44	0	28	72	0	0
21	13920648	.	G	A	1	35	36	0	26	62	0	0
21	13924202	.	T	C	1	2	3	0	0	3	0	0
21	13980445	.	T	A	5	11	16	0	0	16	0	0
21	13980490	.	T	C	6	10	16	0	1	17	0	0
21	13980516	.	G	A	7	5	12	0	3	15	0	0
21	13980743	.	A	G	2	2	4	0	0	4	0	0
21	13983649	.	G	T	1	2	3	0	0	3	0	0
21	14217519	.	C	A	6	4	10	0	0	11	1	0
21	14217595	.	T	C	3	4	7	0	3	10	0	0
21	14217657	.	T	G	12	5	17	0	0	17	0	0
21	14217664	.	T	C	4	0	4	0	13	17	0	0
21	14217762	.	G	T	11	4	15	0	0	15	0	0
21	14226571	.	T	A	3	5	8	0	1	9	0	0
21	14226601	.	C	T	0	5	5	0	5	10	0	0
21	14226685	.	C	T	0	1	1	0	0	1	0	0
21	14644258	.	A	T	3	2	5	0	0	5	0	0
21	14644363	.	T	C	10	6	16	0	0	16	0	0
21	14644567	.	G	A	4	3	7	1	1	9	0	0
21	14644702	.	A	T	14	7	21	0	0	21	0	0
21	14644704	.	A	T	8	12	20	0	1	21	0	0
21	14644814	.	C	T	15	5	20	0	1	21	0	0
21	14644869	.	C	G	11	17	28	0	1	29	0	0
21	14644885	.	A	T	12	19	31	0	0	31	0	0
21	14644917	.	T	G	12	8	20	0	4	24	0	0
21	14644949	.	C	T	0	11	11	0	10	21	0	0
21	14644969	.	A	G	12	10	22	0	1	23	0	0
21	14645006	.	G	A	7	8	15	0	2	17	0	0
21	14645021	.	G	A	3	12	15	0	4	19	0	0
21	14645125	.	A	G	0	5	5	0	1	6	0	0
21	14645399	.	C	T	2	9	11	0	2	13	0	0
21	14645401	.	C	T	2	11	13	0	0	13	0	0
21	14645490	.	C	T	5	4	9	0	0	9	0	0
21	14645574	.	C	T	8	5	13	0	0	13	0	0
21	14645724	.	G	T	4	10	14	0	1	15	0	0
21	14645728	.	A	G	5	10	15	0	1	16	0	0
21	14645873	.	C	T	3	5	8	0	0	8	0	0
21	14654497	.	G	A	1	2	3	0	0	3	0	0
21	14701803	.	G	A	0	1	1	0	0	1	0	0
21	14701890	.	A	G	4	3	7	0	0	7	0	0
21	14701897	.	G	A	3	2	5	0	1	6	0	0
21	17258362	.	A	G	1	2	3	0	1	4	0	0
21	17258486	.	C	T	5	3	8	0	1	9	0	0
21	17259279	.	G	T	0	4	4	0	1	5	0	0
21	17259332	.	T	C	8	2	10	0	2	12	0	0
21	17259466	.	A	T	5	11	16	0	1	17	0	0
21	17325413	.	G	A	0	1	1	0	0	1	0	0
21	17335664	.	G	A	1	2	3	0	1	4	0	0
21	17335676	.	G	A	0	3	3	0	2	5	0	0
21	17335709	.	C	T	1	2	3	0	0	3	0	0
21	17337694	.	G	A	0	2	2	0	5	7	0	0
21	17337865	.	C	T	2	3	5	0	0	5	0	0
21	17337898	.	A	T	1	5	6	0	0	6	0	0
21	17338141	.	T	G	2	6	8	0	0	8	0	0
21	17338593	.	G	A	3	4	7	0	0	7	0	0
21	17338963	.	T	C	3	4	7	0	0	7	0	0
21	17339001	.	C	A	7	4	11	0	1	12	0	0
21	17339002	.	A	T	7	5	12	0	0	12	0	0
21	17339044	.	C	A	5	8	13	0	0	13	0	0
21	17339132	.	G	A	0	6	6	0	5	11	0	0
21	17339767	.	A	T	4	4	8	0	4	12	0	0
21	17413852	.	C	T	2	5	7	0	0	7	0	0
21	17420492	.	G	A	1	2	3	0	1	4	0	0
21	17420960	.	A	C	1	3	4	0	0	4	0	0
21	17478656	.	G	C	4	4	8	0	0	8	0	0
21	17480167	.	G	A	5	8	13	0	0	13	0	0
21	17480216	.	C	T	1	4	5	0	0	5	0	0
21	17482201	.	A	G	4	3	7	0	0	7	0	0
21	17482237	.	A	G	2	4	6	0	0	6	0	0
21	17568543	.	A	G	5	4	9	0	1	10	0	0
21	19008193	.	A	T	2	7	9	0	1	10	0	0
21	19008368	.	C	T	1	2	3	0	0	3	0	0
21	19008602	.	G	A	6	5	11	0	0	11	0	0
21	19008689	.	G	A	5	4	9	0	0	9	0	0
21	19008845	.	C	T	6	4	10	0	1	11	0	0
21	19009346	.	T	C	7	9	16	0	0	16	0	0
21	19009693	.	A	C	21	17	38	0	2	40	0	0
21	19010069	.	G	A	17	24	41	0	3	44	0	0
21	19010097	.	A	T	15	28	43	0	3	46	0	0
21	19010108	.	G	A	12	33	45	0	6	51	0	0
21	19013853	.	T	A	17	3	20	0	6	26	0	0
21	19013875	.	G	A	7	27	34	0	3	37	0	0
21	19014036	.	T	G	18	15	33	0	2	35	0	0
21	19014179	.	C	T	18	7	25	0	0	25	0	0
21	19014341	.	C	A	24	28	52	0	4	56	0	0
21	19014420	.	C	T	30	21	51	0	2	53	0	0
21	19014567	.	C	T	24	26	50	0	1	51	0	0
21	19014634	.	A	T	19	30	49	0	0	49	0	0
21	19014714	.	G	A	18	22	40	0	1	42	1	0
21	19014980	.	C	T	19	7	26	0	1	27	0	0
21	19015035	.	A	G	13	11	24	0	1	25	0	0
21	19015508	.	C	T	6	8	14	0	0	14	0	0
21	19017370	.	T	A	1	3	4	0	0	4	0	0
21	19018116	.	A	G	7	4	11	0	1	12	0	0
21	19018224	.	A	C	7	7	14	0	0	14	0	0
21	19018434	.	T	A	3	6	9	0	1	10	0	0
21	19062228	.	C	T	0	0	0	0	2	2	0	0
21	19063337	.	T	G	9	10	19	0	1	20	0	0
21	19066878	.	C	T	12	15	27	0	1	28	0	0
21	19067092	.	A	G	18	21	39	0	2	41	0	0
21	19073046	.	A	T	0	2	2	0	1	3	0	0
21	19073629	.	T	C	1	6	7	0	0	7	0	0
21	19329072	.	C	T	8	7	15	0	1	16	0	0
21	19329285	.	C	T	2	2	4	0	0	4	0	0
21	19329813	.	G	T	3	5	8	0	0	8	0	0
21	19341581	.	C	T	0	1	1	0	1	2	0	0
21	19345608	.	A	G	1	2	3	0	0	3	0	0
21	19356552	.	G	A	2	1	3	0	0	3	0	0
21	19763668	.	C	T	22	18	40	0	1	41	0	0
21	19763692	.	A	T	26	20	46	0	1	47	0	0
21	19763942	.	G	A	28	22	50	0	0	50	0	0
21	19764230	.	C	T	29	28	57	0	3	60	0	0
21	19764316	.	T	G	21	20	41	0	1	42	0	0
21	19764397	.	G	C	20	22	42	0	2	44	0	0
21	19764431	.	C	T	17	22	39	0	0	39	0	0
21	19764432	.	G	A	22	17	39	0	0	39	0	0
21	19764516	.	G	A	10	14	24	0	4	28	0	0
21	19764608	.	C	T	5	4	9	0	0	9	0	0
21	19765039	.	G	A	2	3	5	0	1	6	0	0
21	19785355	.	G	T	7	7	14	0	2	16	0	0
21	19785379	.	A	T	7	7	14	0	0	14	0	0
21	19872727	.	A	T	5	5	10	0	0	10	0	0
21	19872739	.	T	C	5	3	8	0	0	8	0	0
21	19911433	.	G	T	1	4	5	0	0	5	0	0
21	20103068	.	G	A	0	1	1	0	0	1	0	0
21	20108282	.	T	A	3	4	7	0	1	8	0	0
21	20108354	.	G	T	1	1	2	0	0	2	0	0
21	20108359	.	T	A	1	1	2	0	0	2	0	0
21	20108673	.	A	G	1	2	3	0	0	3	0	0
21	20113659	.	A	G	1	2	3	0	0	3	0	0
21	20113857	.	T	C	1	2	3	0	1	4	0	0
21	20113912	.	A	T	2	2	4	0	0	4	0	0
21	20118979	.	C	T	1	3	4	0	0	4	0	0
21	20306848	.	T	A	1	4	5	0	0	5	0	0
21	20339796	.	C	T	2	20	22	0	12	34	0	0
21	20340157	.	G	A	5	7	12	0	0	12	0	0
21	20394522	.	C	A	1	3	4	0	0	4	0	0
21	20395242	.	C	T	1	2	3	0	0	3	0	0
21	20395560	.	T	C	3	2	5	0	0	5	0	0
21	20395790	.	G	A	1	3	4	0	1	5	0	0
21	20395811	.	C	T	4	2	6	0	0	6	0	0
21	20635320	.	T	A	3	2	5	0	1	6	0	0
21	20635369	.	T	A	1	2	3	0	0	3	0	0
21	20636119	.	T	C	3	3	6	0	0	6	0	0
21	20636130	.	G	T	3	3	6	0	0	6	0	0
21	20636690	.	C	T	2	7	9	0	0	9	0	0
21	20915065	.	C	T	9	8	17	0	0	17	0	0
21	20915736	.	C	T	5	2	7	0	0	7	0	0
21	20933504	.	A	T	10	6	16	0	3	19	0	0
21	20933759	.	G	A	8	3	11	0	3	14	0	0
21	20933798	.	C	T	11	4	15	0	1	16	0	0
21	20938354	.	T	A	1	4	5	0	0	5	0	0
21	20938976	.	T	C	0	3	3	0	0	3	0	0
21	20938981	.	C	A	0	4	4	0	1	5	0	0
21	20950679	.	T	C	0	3	3	0	1	4	0	0
21	20950835	.	G	A	0	2	2	0	1	3	0	0
21	20951231	.	G	A	0	3	3	0	3	6	0	0
21	21013693	.	C	G	7	4	11	0	8	19	0	0
21	21017484	.	G	C	8	2	10	0	0	10	0	0
21	21017513	.	C	T	6	15	21	0	0	21	0	0
21	21017606	.	G	A	6	8	14	0	1	15	0	0
21	21028097	.	G	C	0	0	0	0	1	1	0	0
21	21239969	.	A	G	1	4	5	0	0	5	0	0
21	21240927	.	C	G	2	4	6	0	0	6	0	0
21	21241412	.	A	T	3	3	6	0	0	6	0	0
21	21241747	.	T	C	8	6	14	0	2	16	0	0
21	21269737	.	A	G	2	4	6	0	0	6	0	0
21	21272549	.	C	T	1	0	1	0	0	1	0	0
21	21277052	.	C	A	3	2	5	0	1	6	0	0
21	21277089	.	G	A	0	3	3	0	1	4	0	0
21	21294260	.	C	T	2	3	5	0	1	6	0	0
21	21295195	.	A	C	1	0	1	0	0	1	0	0
21	21297635	.	C	T	5	6	11	0	1	12	0	0
21	21297849	.	C	T	4	2	6	0	0	6	0	0
21	21298249	.	T	C	5	6	11	0	1	12	0	0
21	21298427	.	G	A	8	7	15	0	1	16	0	0
21	21298488	.	C	T	10	5	15	0	2	17	0	0
21	21298633	.	G	A	16	4	20	0	1	21	0	0
21	21298703	.	C	A	11	10	21	0	0	21	0	0
21	21298811	.	A	T	15	6	21	0	2	23	0	0
21	21298824	.	G	A	14	5	19	0	1	20	0	0
21	21343266	.	A	G	4	2	6	0	0	6	0	0
21	21343442	.	A	G	2	2	4	0	1	5	0	0
21	21344067	.	A	G	3	4	7	0	1	8	0	0
21	21451025	.	C	A	2	2	4	0	0	4	0	0
21	21525664	.	T	C	2	1	3	0	0	3	0	0
21	21615351	.	T	G	3	5	8	0	2	10	0	0
21	21633558	.	A	G	3	3	6	0	1	7	0	0
21	21633559	.	C	A	3	4	7	0	0	7	0	0
21	21633774	.	G	A	2	2	4	0	0	4	0	0
21	21754470	.	T	C	3	3	6	0	0	6	0	0
21	21820136	.	A	G	2	3	5	0	0	5	0	0
21	22014223	.	A	T	2	1	3	0	0	3	0	0
21	22082257	.	C	T	8	12	20	0	2	22	0	0
21	22099610	.	A	G	3	9	12	0	2	14	0	0
21	22101271	.	A	G	16	18	34	0	0	34	0	0
21	22101304	.	G	A	18	17	35	0	1	36	0	0
21	22101387	.	A	T	16	20	36	0	0	36	0	0
21	22101471	.	G	A	25	15	40	0	1	41	0	0
21	22101540	.	G	A	15	18	33	0	3	36	0	0
21	22101637	.	T	C	7	0	7	0	11	18	0	0
21	22101665	.	G	C	9	7	16	0	0	16	0	0
21	22101776	.	G	A	7	8	15	0	0	15	0	0
21	22101827	.	C	G	0	14	14	0	12	26	0	0
21	22101917	.	A	T	13	15	28	0	1	29	0	0
21	22102037	.	G	A	11	10	21	0	1	22	0	0
21	22102044	.	C	T	0	11	11	0	13	24	0	0
21	22102154	.	C	A	9	9	18	0	1	19	0	0
21	22102261	.	G	T	9	6	15	0	2	17	0	0
21	22102281	.	A	C	9	5	14	0	1	15	0	0
21	22102361	.	C	G	5	4	9	0	0	9	0	0
21	22102377	.	T	G	5	4	9	0	0	9	0	0
21	22102405	.	C	T	4	4	8	0	1	9	0	0
21	22102515	.	T	A	1	9	10	0	1	11	0	0
21	22102542	.	C	T	4	8	12	0	0	12	0	0
21	22102653	.	A	G	2	6	8	0	0	8	0	0
21	22102838	.	T	G	6	7	13	0	0	13	0	0
21	22102931	.	A	G	3	4	7	0	2	9	0	0
21	22116260	.	A	T	2	2	4	0	0	4	0	0
21	22116516	.	G	C	1	0	1	0	3	4	0	0
21	22116522	.	C	G	3	2	5	0	0	5	0	0
21	22116586	.	G	A	1	5	6	0	0	6	0	0
21	22116611	.	C	T	3	4	7	0	0	7	0	0
21	22117018	.	A	G	1	3	4	0	0	4	0	0
21	22138571	.	C	G	5	3	8	0	1	9	0	0
21	22140654	.	C	G	1	1	2	0	0	2	0	0
21	22140937	.	C	A	2	2	4	0	0	4	0	0
21	22142362	.	A	G	4	11	15	0	0	15	0	0
21	22142820	.	G	A	0	8	8	0	2	10	0	0
21	22158882	.	A	T	0	1	1	0	0	1	0	0
21	22346512	.	G	T	2	3	5	0	1	6	0	0
21	22347182	.	T	C	3	3	6	0	0	6	0	0
21	22347765	.	C	T	3	4	7	0	0	7	0	0
21	22347903	.	T	C	2	2	4	0	0	4	0	0
21	22422149	.	T	C	6	13	19	0	3	22	0	0
21	22422184	.	A	G	10	8	18	0	2	20	0	0
21	22422243	.	G	A	8	14	22	0	5	27	0	0
21	22422407	.	T	G	12	9	21	0	2	23	0	0
21	22447164	.	T	C	3	3	6	0	1	7	0	0
21	22447329	.	A	C	3	3	6	0	0	6	0	0
21	22447370	.	T	C	5	4	9	0	0	9	0	0
21	22447373	.	G	C	5	4	9	0	0	9	0	0
21	22448380	.	C	G	3	5	8	0	1	9	0	0
21	22448574	.	A	G	1	1	2	0	1	3	0	0
21	22448961	.	C	T	1	1	2	0	1	3	0	0
21	22549891	.	C	G	0	3	3	0	2	5	0	0
21	22552794	.	G	A	1	2	3	0	0	3	0	0
21	22630715	.	A	T	1	2	3	0	0	3	0	0
21	22633734	.	A	G	2	5	7	0	1	8	0	0
21	22633773	.	T	C	8	9	17	0	1	18	0	0
21	22634136	.	C	G	5	5	10	0	1	11	0	0
21	22634205	.	G	T	7	5	12	0	1	13	0	0
21	22634243	.	G	A	13	4	17	0	1	18	0	0
21	22634289	.	C	T	19	6	25	0	2	27	0	0
21	22699471	.	T	C	2	2	4	0	0	4	0	0
21	22699491	.	T	C	2	2	4	0	0	4	0	0
21	22699512	.	T	C	2	2	4	0	1	5	0	0
21	22699556	.	A	G	1	3	4	0	0	4	0	0
21	22699563	.	C	T	1	3	4	0	0	4	0	0
21	22699595	.	C	A	1	4	5	0	0	5	0	0
21	22699608	.	T	C	1	2	3	0	0	3	0	0
21	22699631	.	C	T	1	4	5	0	0	5	0	0
21	22699916	.	G	A	3	4	7	0	0	7	0	0
21	22699956	.	T	G	4	1	5	0	2	7	0	0
21	22702816	.	T	C	5	5	10	0	1	11	0	0
21	22704853	.	T	C	1	2	3	0	1	4	0	0
21	22704918	.	G	A	2	0	2	0	0	2	0	0
21	22704924	.	C	T	1	0	1	0	0	1	0	0
21	22706480	.	G	A	0	1	1	0	0	1	0	0
21	22789131	.	G	A	0	2	2	0	2	4	0	0
21	22795009	.	T	C	4	3	7	0	0	7	0	0
21	22795107	.	G	A	0	2	2	0	0	2	0	0
21	22795324	.	C	T	4	3	7	0	1	8	0	0
21	22795358	.	T	G	5	4	9	0	0	9	0	0
21	22795392	.	A	T	2	4	6	0	1	7	0	0
21	22795534	.	T	C	3	3	6	0	0	6	0	0
21	22847059	.	G	C	2	5	7	0	2	9	0	0
21	22847069	.	A	G	4	4	8	0	0	8	0	0
21	22847128	.	G	C	0	3	3	0	1	4	0	0
21	22847163	.	A	G	1	6	7	0	0	7	0	0
21	22847174	.	G	C	2	6	8	0	0	8	0	0
21	22847207	.	A	G	2	4	6	0	0	6	0	0
21	22847234	.	A	G	1	4	5	0	1	6	0	0
21	22847246	.	G	A	2	5	7	0	0	7	0	0
21	22847969	.	C	T	12	19	31	0	1	32	0	0
21	22847984	.	A	T	14	17	31	0	0	31	0	0
21	22848047	.	C	T	14	15	29	0	2	31	0	0
21	22848293	.	C	T	1	3	4	0	0	4	0	0
21	22848424	.	C	T	6	3	9	0	0	9	0	0
21	22850242	.	G	A	2	4	6	0	1	7	0	0
21	22850422	.	G	A	20	18	38	0	0	38	0	0
21	22878844	.	A	C	2	6	8	0	0	8	0	0
21	22878856	.	G	A	3	8	11	0	1	12	0	0
21	22878880	.	C	A	9	10	19	0	1	20	0	0
21	22878994	.	T	C	1	10	11	0	1	12	0	0
21	22879925	.	T	A	15	5	20	0	0	20	0	0
21	22886365	.	G	A	2	1	3	0	0	3	0	0
21	22887883	.	C	T	9	9	18	0	1	19	0	0
21	22887951	.	A	G	8	15	23	0	1	24	0	0
21	22888260	.	G	T	1	2	3	0	0	3	0	0
21	22889238	.	A	C	1	2	3	0	0	3	0	0
21	22961178	.	T	C	1	5	6	0	0	6	0	0
21	22961233	.	A	T	2	5	7	0	0	7	0	0
21	22965838	.	G	A	1	5	6	0	0	6	0	0
21	22965844	.	G	A	1	5	6	0	0	6	0	0
21	22965891	.	C	A	1	1	2	0	0	2	0	0
21	23019836	.	T	G	14	15	29	0	3	32	0	0
21	23019988	.	G	A	18	8	26	0	5	31	0	0
21	23020102	.	C	G	19	14	33	0	1	34	0	0
21	23024996	.	A	G	4	3	7	0	0	7	0	0
21	23027023	.	A	T	0	3	3	0	2	5	0	0
21	23028399	.	C	T	0	4	4	0	3	7	0	0
21	23028432	.	G	A	3	5	8	0	1	9	0	0
21	23036340	.	T	G	3	4	7	0	0	7	0	0
21	23036393	.	A	T	2	3	5	0	0	5	0	0
21	23036534	.	G	A	6	8	14	0	0	14	0	0
21	23037906	.	T	C	7	9	16	0	1	17	0	0
21	23040993	.	T	G	4	2	6	0	0	6	0	0
21	23160851	.	A	T	10	12	22	0	3	25	0	0
21	23161061	.	G	A	14	9	23	0	0	23	0	0
21	23162023	.	C	T	4	3	7	0	0	7	0	0
21	23163564	.	T	A	2	3	5	0	0	5	0	0
21	23163841	.	A	T	0	2	2	0	0	2	0	0
21	23163938	.	G	T	2	2	4	0	2	6	0	0
21	23169835	.	G	A	2	1	3	0	0	3	0	0
21	23175440	.	C	T	0	0	0	0	1	1	0	0
21	23367200	.	C	T	6	2	8	0	1	9	0	0
21	23367218	.	T	G	9	3	12	0	0	12	0	0
21	24531725	.	A	T	2	2	4	0	0	4	0	0
21	24531816	.	G	T	1	2	3	0	0	3	0	0
21	24536365	.	G	T	1	3	4	0	0	4	0	0
21	24536809	.	G	A	6	8	14	0	0	14	0	0
21	24536943	.	T	C	6	8	14	0	1	15	0	0
21	24539908	.	T	A	1	4	5	0	1	6	0	0
21	24539983	.	A	G	3	2	5	0	0	5	0	0
21	24540379	.	C	A	0	4	4	0	2	6	0	0
21	25044738	.	A	T	2	5	7	0	0	7	0	0
21	25044766	.	G	A	3	3	6	0	0	6	0	0
21	25044876	.	A	T	1	2	3	0	0	3	0	0
21	25046210	.	G	C	1	4	5	0	0	5	0	0
21	25046672	.	A	G	2	4	6	0	0	6	0	0
21	25046840	.	C	T	9	3	12	0	0	12	0	0
21	25092333	.	T	G	1	2	3	0	0	3	0	0
21	25103396	.	C	A	0	1	1	0	1	2	0	0
21	25103676	.	T	A	0	2	2	0	1	3	0	0
21	25117887	.	G	T	8	7	15	0	0	15	0	0
21	25117926	.	T	C	8	9	17	0	0	17	0	0
21	25117959	.	G	A	10	9	19	0	1	20	0	0
21	25118065	.	G	A	12	12	24	0	1	25	0	0
21	25118108	.	T	C	9	8	17	0	2	19	0	0
21	25118122	.	G	A	7	5	12	0	0	12	0	0
21	25142536	.	T	A	7	5	12	0	1	13	0	0
21	25156379	.	C	T	5	2	7	0	0	7	0	0
21	25171692	.	T	C	7	6	13	0	0	13	0	0
21	25181643	.	T	A	2	0	2	0	1	3	0	0
21	25182086	.	G	A	6	8	14	0	4	18	0	0
21	25182091	.	C	A	7	10	17	0	1	18	0	0
21	25182207	.	A	T	9	8	17	0	0	17	0	0
21	25182552	.	A	T	5	2	7	0	0	7	0	0
21	25182595	.	T	C	3	1	4	0	0	4	0	0
21	25182598	.	G	A	3	2	5	0	0	5	0	0
21	25182858	.	A	C	1	3	4	0	0	4	0	0
21	25183180	.	T	C	8	11	19	0	1	20	0	0
21	25183224	.	T	A	10	9	19	0	0	19	0	0
21	25183225	.	A	G	8	9	17	0	2	19	0	0
21	25207925	.	A	G	3	1	4	0	0	4	0	0
21	25207931	.	A	G	3	1	4	0	0	4	0	0
21	25210921	.	A	G	2	2	4	0	0	4	0	0
21	25247236	.	C	T	0	2	2	0	3	5	0	0
21	25247433	.	C	A	0	4	4	0	2	6	0	0
21	25250497	.	C	T	0	2	2	0	1	3	0	0
21	25250983	.	G	A	1	5	6	0	0	6	0	0
21	25380817	.	T	A	4	2	6	0	2	8	0	0
21	25384076	.	T	C	4	0	4	0	0	4	0	0
21	25386752	.	T	C	4	0	4	0	0	4	0	0
21	25399873	.	A	G	15	19	34	0	1	35	0	0
21	25407216	.	C	G	7	8	15	0	0	15	0	0
21	25425204	.	T	C	2	3	5	0	0	5	0	0
21	25425528	.	C	A	6	12	18	0	1	19	0	0
21	25425773	.	C	A	15	4	19	0	2	21	0	0
21	25425798	.	T	C	6	12	18	0	1	19	0	0
21	25425826	.	G	T	10	8	18	0	1	19	0	0
21	25425848	.	C	A	0	7	7	0	11	18	0	0
21	25425873	.	A	T	9	9	18	0	2	20	0	0
21	25440049	.	G	A	8	9	17	0	1	18	0	0
21	25440079	.	A	C	12	0	12	0	15	27	0	0
21	25440085	.	G	A	13	15	28	0	1	29	0	0
21	25450846	.	G	A	0	4	4	0	0	4	0	0
21	25452558	.	G	A	1	4	5	0	1	6	0	0
21	25458902	.	T	A	2	2	4	0	0	4	0	0
21	25460713	.	G	A	1	1	2	0	1	3	0	0
21	25460734	.	G	A	0	4	4	0	0	4	0	0
21	25541272	.	A	G	1	2	3	0	0	3	0	0
21	25542356	.	C	A	3	5	8	0	0	8	0	0
21	25542391	.	T	C	4	3	7	0	0	7	0	0
21	25542966	.	G	T	3	2	5	0	0	5	0	0
21	25543258	.	A	G	3	4	7	0	0	7	0	0
21	25561586	.	G	A	17	8	25	0	0	25	0	0
21	25561775	.	T	C	6	1	7	0	10	17	0	0
21	25570323	.	G	A	8	4	12	0	3	15	0	0
21	25570434	.	G	A	4	3	7	0	0	7	0	0
21	25571392	.	G	A	2	2	4	0	0	4	0	0
21	25572145	.	C	T	1	1	2	0	0	2	0	0
21	25601289	.	C	A	8	3	11	0	0	11	0	0
21	25605647	.	A	G	0	3	3	0	0	3	0	0
21	25606796	.	C	T	1	3	4	0	0	4	0	0
21	25606971	.	A	G	0	1	1	0	0	1	0	0
21	25609470	.	A	T	1	3	4	0	1	5	0	0
21	25620446	.	T	C	3	2	5	0	1	6	0	0
21	25645217	.	A	C	5	3	8	0	0	8	0	0
21	25645555	.	T	G	5	3	8	0	1	9	0	0
21	25645655	.	G	C	3	6	9	0	2	11	0	0
21	25663198	.	A	G	4	3	7	0	1	8	0	0
21	25663199	.	G	C	3	1	4	0	4	8	0	0
21	25677015	.	T	G	2	2	4	0	0	4	0	0
21	25819439	.	G	A	3	4	7	0	0	7	0	0
21	26023146	.	G	A	1	5	6	0	5	11	0	0
21	26023147	.	T	A	6	5	11	0	0	11	0	0
21	26023231	.	G	A	2	4	6	0	1	7	0	0
21	26033800	.	C	T	1	2	3	0	0	3	0	0
21	26041741	.	C	T	0	1	1	0	0	1	0	0
21	26050415	.	T	G	1	1	2	0	1	3	0	0
21	26053929	.	C	A	7	5	12	0	0	12	0	0
21	26054453	.	A	G	1	0	1	0	5	6	0	0
21	26057490	.	T	A	7	10	17	0	0	17	0	0
21	26057707	.	C	T	5	9	14	0	4	18	0	0
21	26057864	.	T	A	11	4	15	0	1	17	1	0
21	26058121	.	C	T	8	16	24	0	4	29	1	0
21	26058204	.	G	A	6	9	15	0	12	27	0	0
21	26058275	.	G	T	18	13	31	0	5	36	0	0
21	26058378	.	C	T	7	14	21	0	3	24	0	0
21	26058386	.	C	A	9	12	21	0	6	27	0	0
21	26073115	.	A	T	6	8	14	0	2	16	0	0
21	26080547	.	A	G	6	4	10	0	0	10	0	0
21	26152855	.	A	G	3	2	5	0	0	5	0	0
21	26389462	.	C	T	6	1	7	0	0	7	0	0
21	26390614	.	G	A	10	7	17	0	1	18	0	0
21	26390620	.	A	G	8	7	15	0	1	16	0	0
21	26392047	.	T	A	1	2	3	0	0	3	0	0
21	26392050	.	T	A	0	1	1	0	1	2	0	0
21	26401602	.	C	A	2	6	8	0	0	8	0	0
21	26415195	.	C	T	3	5	8	0	0	8	0	0
21	26522682	.	G	A	4	3	7	0	0	7	0	0
21	26523233	.	C	T	1	1	2	0	0	2	0	0
21	26527782	.	G	A	0	5	5	0	4	9	0	0
21	26530332	.	G	A	0	0	0	0	2	2	0	0
21	26530663	.	T	A	1	0	1	0	0	1	0	0
21	26530723	.	G	T	8	7	15	0	1	16	0	0
21	26530737	.	G	C	7	9	16	0	2	18	0	0
21	26530758	.	T	C	5	8	13	0	1	14	0	0
21	26531014	.	G	A	10	6	16	0	0	16	0	0
21	26531102	.	A	G	4	14	18	0	1	19	0	0
21	26531299	.	T	A	7	5	12	0	3	15	0	0
21	26549764	.	A	G	0	1	1	0	0	1	0	0
21	26553406	.	C	T	3	2	5	0	0	5	0	0
21	26553425	.	T	C	5	2	7	0	0	7	0	0
21	26553466	.	A	G	3	2	5	0	0	5	0	0
21	26553554	.	A	C	4	2	6	0	0	6	0	0
21	26553577	.	A	T	3	4	7	0	0	7	0	0
21	26553794	.	C	T	15	4	19	0	0	19	0	0
21	26553857	.	T	A	9	5	14	0	2	16	0	0
21	26553879	.	G	T	10	3	13	0	2	15	0	0
21	26553971	.	A	T	4	2	6	0	0	6	0	0
21	26554116	.	T	C	6	5	11	0	2	13	0	0
21	26554139	.	C	T	4	3	7	0	0	7	0	0
21	26662745	.	G	A	10	5	15	0	1	16	0	0
21	26663161	.	G	C	0	0	0	0	1	1	0	0
21	26664625	.	C	T	18	22	40	0	2	42	0	0
21	26664770	.	C	T	18	15	33	0	4	37	0	0
21	26665046	.	G	T	2	2	4	0	0	4	0	0
21	26665092	.	C	T	1	9	10	0	2	12	0	0
21	26665364	.	T	A	8	8	16	0	0	16	0	0
21	26665661	.	A	G	0	3	3	0	0	3	0	0
21	26665745	.	C	A	1	13	14	0	13	27	0	0
21	26665790	.	G	A	7	9	16	0	1	17	0	0
21	26665808	.	C	T	6	5	11	0	0	11	0	0
21	26665986	.	C	A	1	1	2	0	0	2	0	0
21	26668766	.	T	A	2	2	4	0	0	4	0	0
21	26678906	.	G	A	4	2	6	0	0	6	0	0
21	26678965	.	C	T	0	3	3	0	8	11	0	0
21	26679023	.	T	C	5	5	10	0	1	11	0	0
21	26697686	.	G	T	24	22	46	2	5	53	0	0
21	26706481	.	C	T	33	23	56	0	9	65	0	0
21	26706482	.	C	T	31	27	58	0	7	65	0	0
21	26706805	.	C	T	23	29	52	0	2	54	0	0
21	26706846	.	T	A	23	13	36	0	2	38	0	0
21	26710071	.	A	G	14	14	28	0	0	28	0	0
21	26710194	.	T	A	9	21	30	0	3	33	0	0
21	26710239	.	G	A	10	15	25	0	3	28	0	0
21	26710496	.	C	A	11	17	28	0	2	30	0	0
21	26714361	.	C	T	0	2	2	0	0	2	0	0
21	26721403	.	A	T	1	4	5	0	0	5	0	0
21	26722269	.	C	T	2	4	6	0	0	6	0	0
21	26722347	.	G	A	4	4	8	0	0	8	0	0
21	26722625	.	C	T	1	2	3	0	0	3	0	0
21	26724723	.	G	A	6	11	17	0	2	19	0	0
21	26724833	.	A	G	10	8	18	0	2	20	0	0
21	26725403	.	T	C	18	12	30	0	3	33	0	0
21	26726997	.	C	A	9	14	23	0	2	25	0	0
21	26731236	.	C	A	29	23	52	0	5	57	0	0
21	26731925	.	C	A	24	27	51	0	8	59	0	0
21	26908810	.	G	A	18	10	28	0	2	30	0	0
21	26914870	.	T	G	3	5	8	0	1	9	0	0
21	26914915	.	T	G	4	2	6	0	3	9	0	0
21	26961177	.	C	T	2	2	4	0	0	4	0	0
21	26961515	.	C	T	1	1	2	0	1	3	0	0
21	26965918	.	A	T	3	6	9	0	2	11	0	0
21	26966193	.	A	T	6	6	12	0	0	12	0	0
21	26966918	.	C	T	6	4	10	0	0	10	0	0
21	26967230	.	C	T	2	5	7	0	1	8	0	0
21	26967265	.	T	A	5	6	11	0	0	11	0	0
21	26967426	.	G	A	16	7	23	0	0	23	0	0
21	26967899	.	A	C	9	22	31	0	3	34	0	0
21	26968042	.	G	A	14	10	24	0	5	29	0	0
21	26968127	.	G	T	18	18	36	0	2	38	0	0
21	26968264	.	G	A	21	16	37	0	3	40	0	0
21	26968344	.	G	A	13	13	26	0	2	28	0	0
21	26968478	.	G	A	10	4	14	0	0	14	0	0
21	26995869	.	G	A	4	4	8	0	2	10	0	0
21	26996005	.	A	G	13	16	29	0	5	34	0	0
21	26996849	.	C	A	0	28	28	0	18	46	0	0
21	27189570	.	C	A	5	1	6	0	0	6	0	0
21	27190033	.	G	A	0	0	0	0	1	1	0	0
21	27198018	.	T	G	10	10	20	0	1	21	0	0
21	27198159	.	C	T	0	13	13	0	18	31	0	0
21	27198227	.	G	T	19	19	38	0	0	38	0	0
21	27198405	.	C	T	10	11	21	0	2	23	0	0
21	27198967	.	A	G	2	3	5	0	0	5	0	0
21	27199893	.	G	A	1	4	5	0	0	5	0	0
21	27205050	.	G	A	8	7	15	0	1	16	0	0
21	27213101	.	G	A	1	1	2	0	2	4	0	0
21	27213212	.	A	G	4	4	8	0	2	10	0	0
21	27224112	.	T	C	4	2	6	0	0	6	0	0
21	27305739	.	T	G	2	2	4	0	2	6	0	0
21	27305794	.	C	T	2	3	5	0	0	5	0	0
21	27312644	.	A	G	3	8	11	0	0	11	0	0
21	27312962	.	G	A	4	2	6	0	0	6	0	0
21	27318274	.	G	T	7	6	13	0	0	13	0	0
21	27351007	.	C	T	5	3	8	0	0	8	0	0
21	27351316	.	T	C	1	2	3	0	0	3	0	0
21	27353478	.	A	G	3	4	7	0	0	7	0	0
21	27354142	.	C	A	9	8	17	0	0	17	0	0
21	27354147	.	T	C	9	7	16	0	2	18	0	0
21	27354434	.	C	A	12	12	24	0	1	25	0	0
21	27354505	.	T	C	13	8	21	0	3	24	0	0
21	27354602	.	G	T	6	4	10	0	1	11	0	0
21	27354621	.	T	G	3	2	5	0	1	6	0	0
21	27375199	.	A	G	2	4	6	0	1	7	0	0
21	27375247	.	C	T	0	4	4	0	1	5	0	0
21	27377354	.	C	A	4	2	6	0	3	9	0	0
21	27378011	.	A	C	2	4	6	0	1	7	0	0
21	27378269	.	T	A	3	4	7	0	0	7	0	0
21	27378607	.	T	A	5	6	11	0	0	11	0	0
21	27378663	.	G	A	0	4	4	0	1	5	0	0
21	27407929	.	C	T	1	2	3	0	1	4	0	0
21	27536026	.	G	A	0	1	1	0	1	2	0	0
21	27549667	.	G	A	1	2	3	0	0	3	0	0
21	27552349	.	A	G	0	0	0	0	2	2	0	0
21	27553372	.	C	A	2	1	3	0	0	3	0	0
21	27554837	.	T	C	8	4	12	0	2	14	0	0
21	27554904	.	A	G	7	9	16	0	0	16	0	0
21	27555331	.	G	A	2	7	9	0	1	10	0	0
21	27636733	.	C	A	9	16	25	0	3	28	0	0
21	27636739	.	G	A	8	19	27	0	1	28	0	0
21	27637171	.	C	T	0	12	12	0	9	21	0	0
21	27637701	.	G	A	5	3	8	0	0	8	0	0
21	27637729	.	C	A	0	3	3	0	7	10	0	0
21	27637912	.	G	A	11	5	16	0	1	17	0	0
21	27637951	.	A	G	8	6	14	0	0	14	0	0
21	27637993	.	G	A	4	4	8	0	2	10	0	0
21	28496276	.	T	C	14	6	20	0	1	21	0	0
21	28500394	.	A	G	24	36	60	0	0	60	0	0
21	28500561	.	C	T	11	30	41	0	5	46	0	0
21	28512642	.	C	T	7	12	19	0	2	21	0	0
21	28512800	.	G	T	9	7	16	0	2	18	0	0
21	29075234	.	T	G	16	12	28	0	2	30	0	0
21	30025205	.	T	C	0	0	0	0	5	5	0	0
21	30693906	.	A	G	4	2	6	0	1	7	0	0
21	30973912	.	G	A	1	2	3	0	0	3	0	0
21	31183501	.	T	C	1	3	4	0	0	4	0	0
21	31183734	.	T	C	1	2	3	0	0	3	0	0
21	31233103	.	T	A	11	5	16	0	0	16	0	0
21	31233389	.	A	G	4	4	8	0	3	11	0	0
21	31233579	.	G	C	10	3	13	0	0	13	0	0
21	31233657	.	G	A	11	9	20	0	0	20	0	0
21	31237428	.	A	G	1	2	3	0	0	3	0	0
21	31274312	.	G	T	4	2	6	0	1	7	0	0
21	31274317	.	G	A	4	2	6	0	1	7	0	0
21	32281076	.	G	A	10	10	20	0	0	20	0	0
21	32281122	.	G	A	8	20	28	0	1	29	0	0
21	32281155	.	G	A	12	17	29	0	2	31	0	0
21	32283519	.	G	A	0	3	3	0	0	3	0	0
21	32284398	.	A	G	5	3	8	0	0	8	0	0
21	32285080	.	C	T	3	3	6	0	0	6	0	0
21	32285161	.	A	G	2	3	5	0	2	7	0	0
21	32343453	.	C	T	4	5	9	0	1	10	0	0
21	32343577	.	T	C	2	6	8	0	1	9	0	0
21	32343649	.	C	A	2	4	6	0	1	7	0	0
21	32345162	.	T	C	6	3	9	0	1	10	0	0
21	32345318	.	G	A	0	8	8	0	8	16	0	0
21	32345499	.	A	G	5	7	12	0	1	13	0	0
21	32345607	.	C	T	6	12	18	0	0	18	0	0
21	32345724	.	A	G	4	8	12	0	1	13	0	0
21	32345749	.	A	G	7	5	12	0	0	12	0	0
21	32345774	.	A	T	6	8	14	0	1	15	0	0
21	32345827	.	C	A	3	4	7	0	0	7	0	0
21	32345899	.	G	A	0	3	3	0	5	8	0	0
21	32346021	.	A	C	5	5	10	0	0	10	0	0
21	32346273	.	G	A	14	19	33	0	0	33	0	0
21	32346603	.	G	C	8	17	25	0	1	26	0	0
21	32346630	.	T	C	6	13	19	0	0	19	0	0
21	32346674	.	T	A	5	12	17	0	0	17	0	0
21	32346689	.	A	G	5	9	14	0	2	16	0	0
21	32346799	.	G	A	3	9	12	0	0	12	0	0
21	32346800	.	T	A	3	8	11	0	1	12	0	0
21	32346899	.	A	G	9	5	14	0	1	15	0	0
21	32346901	.	A	G	9	6	15	0	0	15	0	0
21	32347134	.	T	A	7	10	17	0	1	18	0	0
21	32347569	.	G	T	3	9	12	0	0	12	0	0
21	32347855	.	T	C	3	4	7	0	0	7	0	0
21	32348600	.	C	T	4	3	7	0	0	7	0	0
21	32348919	.	C	T	0	2	2	0	1	3	0	0
21	32349023	.	G	C	4	2	6	0	0	6	0	0
21	32349055	.	C	T	2	3	5	0	0	5	0	0
21	32457785	.	T	C	14	19	33	0	1	35	1	0
21	32457923	.	C	A	18	6	24	0	0	24	0	0
21	32457931	.	T	G	16	4	20	0	4	24	0	0
21	32457983	.	G	A	16	11	27	0	2	29	0	0
21	32458261	.	A	G	16	20	36	0	1	37	0	0
21	32458315	.	T	A	20	17	37	0	1	38	0	0
21	32460782	.	G	C	1	0	1	0	1	2	0	0
21	32460912	.	A	G	9	6	15	0	0	15	0	0
21	32466140	.	G	C	2	3	5	0	0	5	0	0
21	32467660	.	A	G	1	1	2	0	1	3	0	0
21	32467724	.	T	C	3	4	7	0	0	7	0	0
21	32476760	.	A	G	19	23	42	0	3	45	0	0
21	32477584	.	T	C	12	24	36	0	3	39	0	0
21	32477967	.	C	T	13	11	24	0	1	25	0	0
21	32477987	.	A	T	14	9	23	0	3	26	0	0
21	32478227	.	G	T	9	9	18	0	0	18	0	0
21	32482797	.	C	T	4	2	6	0	0	6	0	0
21	32482854	.	T	C	11	0	11	0	13	24	0	0
21	32758351	.	C	T	2	8	10	0	0	10	0	0
21	32758584	.	G	A	6	7	13	0	0	13	0	0
21	33058940	.	G	C	13	9	22	0	0	22	0	0
21	33066214	.	T	G	3	1	4	0	1	5	0	0
21	33069896	.	A	G	3	0	3	0	0	3	0	0
21	33211266	.	A	G	3	2	5	0	0	5	0	0
21	33211296	.	T	C	1	2	3	0	1	4	0	0
21	33211506	.	T	A	7	13	20	0	0	20	0	0
21	33211568	.	C	T	10	7	17	0	0	17	0	0
21	33211664	.	T	G	6	6	12	0	2	14	0	0
21	33211809	.	A	T	6	14	20	0	2	22	0	0
21	33213315	.	C	T	3	2	5	0	0	5	0	0
21	33213384	.	G	A	2	1	3	0	0	3	0	0
21	33447251	.	A	G	12	13	25	0	1	26	0	0
21	34001982	.	C	T	12	6	18	0	0	18	0	0
21	34002041	.	C	A	10	9	19	0	1	20	0	0
21	34002154	.	A	C	6	11	17	0	1	18	0	0
21	34002155	.	A	T	7	10	17	0	1	18	0	0
21	34002455	.	G	A	3	5	8	0	0	8	0	0
21	34002507	.	A	G	4	6	10	0	2	12	0	0
21	34057611	.	T	G	1	5	6	0	0	6	0	0
21	34074618	.	A	G	5	12	17	0	0	17	0	0
21	34074684	.	G	A	5	8	13	0	1	14	0	0
21	34074712	.	T	C	4	9	13	0	0	13	0	0
21	34074978	.	T	A	1	1	2	0	0	2	0	0
21	34128660	.	A	G	1	5	6	0	0	6	0	0
21	34129073	.	G	C	8	16	24	0	1	25	0	0
21	34129195	.	G	T	13	12	25	0	1	26	0	0
21	34129279	.	A	G	11	20	31	0	2	33	0	0
21	34129401	.	T	A	7	3	10	0	0	10	0	0
21	34129629	.	A	G	3	3	6	0	0	6	0	0
21	34199704	.	T	C	1	2	3	0	0	3	0	0
21	34211093	.	G	A	0	5	5	0	7	12	0	0
21	34364472	.	T	A	10	9	19	0	1	21	1	0
21	34364595	.	G	A	3	3	6	0	1	7	0	0
21	34365167	.	T	A	5	4	9	0	1	10	0	0
21	34391104	.	C	T	3	3	6	0	0	6	0	0
21	34391155	.	T	C	2	2	4	0	0	4	0	0
21	34424086	.	C	T	0	0	0	0	1	1	0	0
21	34424116	.	A	G	3	1	4	0	0	4	0	0
21	34430533	.	A	G	4	1	5	0	1	6	0	0
21	34430544	.	A	G	4	2	6	0	0	6	0	0
21	35306037	.	C	T	1	3	4	0	0	4	0	0
21	37107035	.	T	A	8	10	18	0	0	18	0	0
21	37107307	.	G	A	2	3	5	0	2	7	0	0
21	37107432	.	A	T	6	8	14	0	0	14	0	0
21	37107861	.	T	C	10	13	23	0	1	24	0	0
21	37108022	.	A	G	8	14	22	0	1	23	0	0
21	37108204	.	A	T	18	15	33	0	1	34	0	0
21	38587140	.	T	A	6	1	7	0	2	9	0	0
21	38587477	.	T	C	2	3	5	0	0	5	0	0
21	38587924	.	C	T	0	6	6	0	0	6	0	0
21	39453940	.	G	A	2	48	50	0	12	62	0	0
21	41599060	.	T	C	1	10	11	0	2	13	0	0
21	41599147	.	G	A	15	4	19	0	2	21	0	0
21	41599208	.	T	C	5	3	8	0	3	11	0	0
21	41599559	.	A	T	0	8	8	0	0	8	0	0
21	41599605	.	T	C	7	3	10	0	1	11	0	0
21	41600360	.	T	C	0	2	2	0	0	2	0	0
21	41600361	.	T	C	0	2	2	0	0	2	0	0
21	42046839	.	T	A	1	11	12	0	0	12	0	0
21	42046871	.	T	C	19	1	20	0	0	20	0	0
21	42046874	.	G	A	18	1	19	0	1	20	0	0
21	42971463	.	T	C	25	15	40	0	11	51	0	0
21	42971464	.	T	C	36	14	50	0	1	51	0	0
21	42971545	.	T	C	19	28	47	0	3	50	0	0
21	42971550	.	T	C	21	24	45	0	2	47	0	0
21	43476276	.	T	C	9	7	16	0	2	18	0	0
21	43477445	.	T	C	1	11	12	0	1	13	0	0
21	43477856	.	T	C	2	3	5	0	1	6	0	0
21	43477894	.	T	C	3	5	8	0	1	9	0	0
21	45352211	.	G	A	3	17	20	0	1	22	1	0
21	45352212	.	G	A	3	15	18	0	4	22	0	0
21	45363566	.	G	C	1	0	1	0	0	1	0	0
21	45374928	.	A	G	6	3	9	0	0	9	0	0
21	45673667	.	T	A	0	38	38	0	3	41	0	0
21	45715611	.	A	G	8	2	10	0	6	16	0	0
21	45838192	.	T	A	0	3	3	0	0	3	0	0
22	336325	.	T	C	13	11	24	0	1	25	0	0
22	336982	.	C	T	10	8	18	0	1	19	0	0
22	337121	.	A	C	5	0	5	0	18	23	0	0
22	337127	.	A	C	6	0	6	0	17	23	0	0
22	337540	.	A	T	12	16	28	0	1	29	0	0
22	337970	.	C	G	4	12	16	0	1	17	0	0
22	338187	.	G	A	4	12	16	1	0	17	0	0
22	338199	.	G	T	0	12	12	0	2	14	0	0
22	338226	.	C	T	2	8	10	0	0	10	0	0
22	338431	.	C	T	10	18	28	0	2	30	0	0
22	338564	.	C	A	4	5	9	0	0	9	0	0
22	711071	.	A	G	27	24	51	0	2	53	0	0
22	711475	.	T	C	3	4	7	0	0	7	0	0
22	711787	.	A	T	15	20	35	0	1	36	0	0
22	712187	.	G	T	6	6	12	0	0	12	0	0
22	728171	.	G	A	0	1	1	0	2	3	0	0
22	729619	.	C	A	1	0	1	0	0	1	0	0
22	732142	.	G	A	0	1	1	0	2	3	0	0
22	732149	.	G	T	0	2	2	0	1	3	0	0
22	732718	.	C	T	1	3	4	0	0	4	0	0
22	732725	.	T	A	4	3	7	0	0	7	0	0
22	744646	.	T	C	1	1	2	0	0	2	0	0
22	745380	.	C	T	6	4	10	0	0	10	0	0
22	748837	.	C	T	3	10	13	0	1	14	0	0
22	750695	.	T	C	3	2	5	0	0	5	0	0
22	750699	.	G	A	0	3	3	0	3	6	0	0
22	750759	.	C	A	4	9	13	0	2	15	0	0
22	750770	.	C	G	5	9	14	0	3	17	0	0
22	750863	.	T	C	2	4	6	0	0	6	0	0
22	751075	.	A	G	0	2	2	0	0	2	0	0
22	753210	.	C	T	6	8	14	0	1	15	0	0
22	753219	.	T	C	6	8	14	0	1	15	0	0
22	774949	.	G	C	18	7	25	0	1	26	0	0
22	775044	.	T	C	10	0	10	0	17	27	0	0
22	775085	.	G	A	3	12	15	0	0	15	0	0
22	776875	.	T	G	8	6	14	0	1	15	0	0
22	777072	.	G	A	2	0	2	0	0	2	0	0
22	786611	.	T	C	1	2	3	0	0	3	0	0
22	799712	.	C	T	1	1	2	0	0	2	0	0
22	806155	.	C	T	3	4	7	0	0	7	0	0
22	808015	.	T	A	7	6	13	0	1	14	0	0
22	808032	.	T	C	6	9	15	0	0	15	0	0
22	808069	.	T	A	7	6	13	0	3	16	0	0
22	808077	.	A	G	7	0	7	0	7	14	0	0
22	808346	.	C	T	18	15	33	0	3	36	0	0
22	819787	.	G	A	6	2	8	0	0	8	0	0
22	820459	.	G	T	1	3	4	0	0	4	0	0
22	820660	.	A	G	2	3	5	0	0	5	0	0
22	825091	.	T	A	6	9	15	0	0	15	0	0
22	825130	.	G	A	4	8	12	0	2	14	0	0
22	827309	.	G	A	2	3	5	0	2	7	0	0
22	828235	.	C	G	2	2	4	0	0	4	0	0
22	831533	.	G	A	1	2	3	0	0	3	0	0
22	857328	.	C	T	1	2	3	0	0	3	0	0
22	857511	.	C	G	2	6	8	0	0	8	0	0
22	857572	.	A	T	4	2	6	0	0	6	0	0
22	857662	.	C	T	4	2	6	0	1	7	0	0
22	857720	.	A	G	9	7	16	0	0	16	0	0
22	860224	.	G	A	1	2	3	0	0	3	0	0
22	868098	.	A	G	3	5	8	0	0	8	0	0
22	868195	.	C	A	13	9	22	0	0	22	0	0
22	868321	.	T	C	5	10	15	0	1	16	0	0
22	1042716	.	C	G	0	2	2	0	1	3	0	0
22	1203320	.	A	T	15	9	24	0	2	26	0	0
22	1203373	.	A	T	8	13	21	0	1	22	0	0
22	1793842	.	A	G	1	2	3	0	0	3	0	0
22	1794099	.	A	G	1	4	5	0	0	5	0	0
22	1794342	.	T	G	3	2	5	0	0	5	0	0
22	2897681	.	A	G	15	15	30	0	3	33	0	0
22	2897742	.	G	A	8	14	22	0	0	22	0	0
22	2897997	.	G	C	10	9	19	0	3	22	0	0
22	2898089	.	C	A	1	13	14	0	8	22	0	0
22	2900999	.	G	A	3	6	9	0	0	9	0	0
22	2908264	.	T	G	0	1	1	0	0	1	0	0
22	2911576	.	G	A	5	2	7	0	1	8	0	0
22	2912869	.	G	T	1	0	1	0	0	1	0	0
22	2919501	.	C	T	3	4	7	0	0	7	0	0
22	2931544	.	T	A	7	6	13	0	0	13	0	0
22	2933861	.	G	C	5	3	8	0	3	11	0	0
22	2937428	.	A	G	1	2	3	0	0	3	0	0
22	2941886	.	C	T	1	0	1	0	0	1	0	0
22	2941888	.	C	T	1	0	1	0	0	1	0	0
22	3077768	.	G	A	1	2	3	0	0	3	0	0
22	3121191	.	T	G	13	4	17	1	0	18	0	0
22	3121451	.	C	A	0	7	7	0	13	20	0	0
22	3121531	.	A	T	3	4	7	0	0	7	0	0
22	3121683	.	T	A	4	6	10	0	0	10	0	0
22	3121725	.	T	G	8	4	12	0	1	13	0	0
22	3121789	.	A	T	9	11	20	0	2	22	0	0
22	3122004	.	A	G	1	4	5	0	0	5	0	0
22	3122258	.	C	T	11	13	24	0	0	24	0	0
22	3124031	.	G	A	3	2	5	0	0	5	0	0
22	3124132	.	G	T	4	2	6	0	0	6	0	0
22	3161346	.	C	T	5	5	10	0	0	10	0	0
22	3162335	.	T	C	1	2	3	0	0	3	0	0
22	3162405	.	G	A	4	2	6	0	1	7	0	0
22	3208281	.	A	G	3	6	9	0	0	9	0	0
22	3214150	.	A	G	2	2	4	0	0	4	0	0
22	3214309	.	G	A	7	2	9	0	0	9	0	0
22	3231677	.	T	G	4	5	9	0	1	10	0	0
22	3249782	.	T	C	1	6	7	0	0	7	0	0
22	3262925	.	C	T	0	5	5	0	11	16	0	0
22	3263129	.	T	C	12	6	18	0	1	19	0	0
22	3263672	.	G	T	1	6	7	0	1	8	0	0
22	3263760	.	G	A	3	5	8	0	2	10	0	0
22	3263776	.	T	G	4	6	10	0	0	10	0	0
22	3384831	.	G	A	17	29	46	0	2	48	0	0
22	3384844	.	C	T	18	25	43	0	3	46	0	0
22	3387859	.	G	A	4	6	10	0	1	11	0	0
22	4445393	.	T	C	1	2	3	0	0	3	0	0
22	4445401	.	A	G	1	0	1	0	2	3	0	0
22	4453459	.	G	T	0	3	3	0	3	6	0	0
22	4453504	.	C	T	0	2	2	0	0	2	0	0
22	4457622	.	G	C	3	3	6	0	1	7	0	0
22	4459772	.	T	C	1	1	2	0	0	2	0	0
22	4460297	.	A	G	6	2	8	0	3	11	0	0
22	4462713	.	C	G	1	1	2	0	0	2	0	0
22	4462800	.	T	C	6	3	9	0	3	12	0	0
22	4462889	.	A	G	5	4	9	0	3	12	0	0
22	4462890	.	C	A	8	4	12	0	0	12	0	0
22	4463041	.	A	G	5	2	7	0	0	7	0	0
22	4463160	.	C	T	8	3	11	0	0	11	0	0
22	4463192	.	G	A	0	6	6	0	4	10	0	0
22	4726694	.	A	G	2	1	3	0	0	3	0	0
22	4728730	.	C	T	1	2	3	0	0	3	0	0
22	4730881	.	G	A	3	2	5	0	0	5	0	0
22	4730882	.	A	T	3	2	5	0	0	5	0	0
22	4732627	.	C	A	8	8	16	0	1	17	0	0
22	4745227	.	C	T	13	7	20	0	3	23	0	0
22	4745421	.	A	G	20	15	35	0	0	35	0	0
22	4745642	.	G	A	13	15	28	0	0	28	0	0
22	4745677	.	C	G	10	11	21	0	3	24	0	0
22	4745682	.	A	T	10	12	22	0	2	24	0	0
22	4745779	.	C	T	0	11	11	0	12	23	0	0
22	4746120	.	A	T	7	16	23	0	2	25	0	0
22	4746577	.	C	A	4	3	7	0	0	7	0	0
22	4746721	.	C	T	4	8	12	0	1	13	0	0
22	4746750	.	C	T	5	9	14	0	0	14	0	0
22	4747456	.	C	A	2	2	4	0	1	5	0	0
22	4762663	.	C	T	1	11	12	0	21	33	0	0
22	4762664	.	A	G	12	19	31	0	2	33	0	0
22	4762773	.	T	C	16	17	33	0	3	36	0	0
22	4763125	.	G	A	3	5	8	0	3	11	0	0
22	4763474	.	C	A	0	7	7	0	7	14	0	0
22	4766818	.	C	T	1	2	3	0	0	3	0	0
22	4767738	.	C	G	0	2	2	0	1	3	0	0
22	4767754	.	C	T	0	3	3	0	0	3	0	0
22	4957729	.	C	T	0	2	2	0	2	4	0	0
22	4962472	.	T	A	2	5	7	0	1	8	0	0
22	4962550	.	A	C	9	3	12	0	8	20	0	0
22	4962559	.	G	A	13	11	24	0	1	25	0	0
22	4962590	.	A	G	12	7	19	0	2	21	0	0
22	4962610	.	A	T	13	9	22	0	0	22	0	0
22	4962635	.	A	G	9	9	18	0	1	19	0	0
22	4962878	.	G	A	8	17	25	0	0	25	0	0
22	4967354	.	G	T	1	2	3	0	1	4	0	0
22	4968955	.	A	G	4	2	6	0	0	6	0	0
22	4969021	.	A	G	7	7	14	0	2	16	0	0
22	4970797	.	G	C	3	3	6	0	0	6	0	0
22	4972848	.	T	G	3	3	6	0	0	6	0	0
22	4975236	.	T	A	1	5	6	0	1	7	0	0
22	4979470	.	C	T	1	2	3	0	0	3	0	0
22	5056607	.	A	G	8	5	13	0	0	13	0	0
22	5056760	.	T	G	9	19	28	0	2	30	0	0
22	5056978	.	A	T	3	3	6	0	0	6	0	0
22	5057160	.	C	A	1	2	3	0	2	5	0	0
22	5057421	.	C	A	0	6	6	0	4	10	0	0
22	5057504	.	T	A	6	4	10	0	1	11	0	0
22	5057562	.	G	T	3	7	10	0	0	10	0	0
22	5062457	.	G	A	0	0	0	0	1	1	0	0
22	5120172	.	C	T	2	3	5	0	1	6	0	0
22	5144566	.	G	C	1	3	4	0	1	5	0	0
22	5144750	.	T	A	3	2	5	0	0	5	0	0
22	5144882	.	T	G	4	3	7	0	0	7	0	0
22	5144981	.	T	C	7	6	13	0	1	14	0	0
22	5145109	.	C	A	3	8	11	0	3	14	0	0
22	5145330	.	C	T	4	8	12	0	0	12	0	0
22	5209139	.	A	G	1	0	1	0	0	1	0	0
22	5229861	.	A	G	1	2	3	0	0	3	0	0
22	5230455	.	A	C	1	2	3	0	0	3	0	0
22	5230794	.	T	A	2	2	4	0	0	4	0	0
22	5231145	.	T	C	2	2	4	0	1	5	0	0
22	5231263	.	A	G	5	6	11	0	1	12	0	0
22	5231696	.	A	G	11	9	20	0	1	21	0	0
22	5232088	.	T	G	7	7	14	0	1	15	0	0
22	5233560	.	C	T	9	3	12	0	1	13	0	0
22	5233657	.	C	T	0	3	3	0	5	8	0	0
22	5233712	.	C	A	7	5	12	0	0	12	0	0
22	5233920	.	T	C	4	7	11	0	0	11	0	0
22	5233975	.	T	C	2	3	5	0	1	6	0	0
22	5234042	.	T	A	5	3	8	0	0	8	0	0
22	5577139	.	T	C	1	2	3	0	0	3	0	0
22	5586896	.	T	C	17	12	29	0	2	31	0	0
22	5586902	.	C	T	16	14	30	0	1	31	0	0
22	5587039	.	C	T	5	21	26	0	3	29	0	0
22	5587075	.	C	A	5	18	23	0	5	28	0	0
22	5587077	.	C	T	5	20	25	0	3	28	0	0
22	5587124	.	G	A	8	23	31	0	3	34	0	0
22	5587285	.	A	C	7	8	15	0	4	19	0	0
22	5587355	.	T	C	1	4	5	0	0	5	0	0
22	5587826	.	T	C	26	25	51	0	4	55	0	0
22	5587930	.	T	C	24	23	47	0	5	52	0	0
22	5657155	.	G	A	17	7	24	0	1	25	0	0
22	5657191	.	C	T	0	9	9	0	19	28	0	0
22	5657365	.	C	T	8	8	16	0	1	17	0	0
22	5657456	.	T	C	4	0	4	0	6	10	0	0
22	5657704	.	T	C	7	4	11	0	2	13	0	0
22	5657731	.	T	C	4	0	4	0	7	11	0	0
22	5657800	.	T	A	4	3	7	0	0	7	0	0
22	5667596	.	T	G	12	6	18	0	1	19	0	0
22	5667629	.	T	C	5	5	10	0	0	10	0	0
22	5752305	.	T	C	0	1	1	0	0	1	0	0
22	5752315	.	G	A	0	1	1	0	0	1	0	0
22	5756066	.	G	A	4	6	10	0	3	13	0	0
22	5756317	.	C	T	13	4	17	0	1	18	0	0
22	5756340	.	A	T	12	3	15	0	0	15	0	0
22	5758678	.	C	T	11	13	24	0	1	25	0	0
22	5758689	.	A	T	10	9	19	0	5	24	0	0
22	7676489	.	A	C	2	3	5	0	0	5	0	0
22	7676515	.	G	A	1	3	4	0	0	4	0	0
22	7677356	.	C	T	1	2	3	0	0	3	0	0
22	8769431	.	A	G	3	3	6	0	0	6	0	0
22	8769518	.	G	C	3	2	5	0	0	5	0	0
22	8769579	.	T	G	2	4	6	0	0	6	0	0
22	8769633	.	A	C	0	2	2	0	0	2	0	0
22	8769952	.	A	T	3	4	7	0	1	8	0	0
22	8769954	.	G	A	4	4	8	0	0	8	0	0
22	8770013	.	G	A	0	7	7	0	3	10	0	0
22	8787764	.	A	T	3	2	5	0	0	5	0	0
22	8994906	.	G	A	0	2	2	0	1	3	0	0
22	8994922	.	T	G	2	2	4	0	2	6	0	0
22	8994946	.	A	C	4	3	7	0	1	8	0	0
22	8995042	.	A	G	7	3	10	0	0	10	0	0
22	8996198	.	A	T	6	3	9	0	4	13	0	0
22	9512885	.	T	G	1	2	3	0	1	4	0	0
22	9513048	.	T	C	1	2	3	0	0	3	0	0
22	9535191	.	T	C	0	5	5	0	0	5	0	0
22	9535290	.	C	T	0	10	10	0	0	10	0	0
22	9536984	.	C	T	1	10	11	0	0	11	0	0
22	9537583	.	T	C	14	8	22	0	12	34	0	0
22	9537637	.	T	C	16	15	31	0	6	37	0	0
22	9537779	.	A	G	4	5	9	0	19	28	0	0
22	9835604	.	G	A	2	2	4	0	1	5	0	0
22	9835622	.	A	G	1	2	3	0	0	3	0	0
22	9835885	.	T	C	1	2	3	0	0	3	0	0
22	9868095	.	C	G	1	0	1	0	4	5	0	0
22	9868134	.	A	G	3	5	8	0	0	8	0	0
22	9868136	.	A	T	1	5	6	0	2	8	0	0
22	9868366	.	A	C	2	3	5	0	1	6	0	0
22	9868421	.	G	A	1	1	2	0	1	3	0	0
22	9877095	.	A	G	7	2	9	0	0	9	0	0
22	9877115	.	G	A	9	2	11	0	0	11	0	0
22	9877501	.	C	G	5	4	9	0	0	9	0	0
22	9877610	.	C	T	3	2	5	0	0	5	0	0
22	9877612	.	T	C	3	2	5	0	0	5	0	0
22	9877956	.	C	T	6	3	9	0	1	10	0	0
22	9878045	.	T	C	2	3	5	0	0	5	0	0
22	9878047	.	A	T	2	2	4	0	1	5	0	0
22	9878148	.	T	A	4	3	7	0	0	7	0	0
22	9878366	.	T	A	7	3	10	0	1	11	0	0
22	9887054	.	A	T	2	2	4	0	0	4	0	0
22	9898190	.	A	C	1	2	3	0	0	3	0	0
22	9898271	.	C	T	0	2	2	0	0	2	0	0
22	9898277	.	C	T	0	1	1	0	0	1	0	0
22	9898733	.	T	A	1	4	5	0	0	5	0	0
22	9898775	.	A	C	1	2	3	0	0	3	0	0
22	9898776	.	G	A	1	2	3	0	0	3	0	0
22	10196508	.	T	A	2	3	5	0	0	5	0	0
22	10196621	.	C	A	1	6	7	0	0	7	0	0
22	10196951	.	C	A	0	2	2	0	0	2	0	0
22	10197146	.	C	T	3	6	9	0	0	9	0	0
22	10197180	.	T	A	9	3	12	0	2	14	0	0
22	10197195	.	T	C	8	4	12	0	0	12	0	0
22	10197395	.	G	T	0	8	8	0	11	19	0	0
22	10197796	.	G	C	0	3	3	0	5	8	0	0
22	10197972	.	C	G	3	13	16	0	3	19	0	0
22	10198018	.	A	C	5	12	17	0	0	17	0	0
22	10198178	.	A	T	2	3	5	0	1	6	0	0
22	10198283	.	T	C	11	2	13	0	0	13	0	0
22	10198359	.	G	A	16	14	30	0	4	34	0	0
22	10198737	.	G	A	19	8	27	0	1	28	0	0
22	10198779	.	G	C	12	4	16	0	1	17	0	0
22	10207978	.	A	T	1	0	1	0	0	1	0	0
22	10208011	.	T	C	2	3	5	0	0	5	0	0
22	10208032	.	A	C	5	3	8	0	0	8	0	0
22	10208089	.	C	T	10	10	20	0	0	20	0	0
22	10208101	.	T	G	12	11	23	0	0	23	0	0
22	10208134	.	G	A	10	9	19	0	0	19	0	0
22	10208182	.	C	T	11	12	23	0	0	23	0	0
22	10208212	.	C	T	5	9	14	0	1	15	0	0
22	10208404	.	C	T	7	4	11	0	0	11	0	0
22	10211754	.	C	T	8	16	24	0	0	24	0	0
22	10212230	.	C	G	21	24	45	0	1	46	0	0
22	10212307	.	C	T	28	13	41	0	4	45	0	0
22	10212416	.	T	A	5	7	12	0	0	12	0	0
22	10212417	.	T	A	7	5	12	0	0	12	0	0
22	10261723	.	A	G	4	5	9	0	0	9	0	0
22	10261840	.	T	C	8	8	16	0	2	18	0	0
22	10261853	.	G	A	9	10	19	0	1	20	0	0
22	10261888	.	C	T	7	11	18	0	2	20	0	0
22	10261905	.	T	C	13	9	22	0	0	22	0	0
22	10261949	.	G	A	17	8	25	0	0	25	0	0
22	10261963	.	T	A	16	10	26	0	1	27	0	0
22	10262216	.	A	T	8	16	24	0	0	24	0	0
22	10262236	.	T	G	10	13	23	0	0	23	0	0
22	10262296	.	C	T	1	3	4	0	0	4	0	0
22	10361324	.	T	C	9	4	13	0	0	13	0	0
22	10361787	.	C	G	10	8	18	0	1	20	1	0
22	10361889	.	A	G	11	8	19	0	1	20	0	0
22	10361892	.	A	G	12	8	20	0	0	20	0	0
22	10362003	.	T	G	2	11	13	0	0	13	0	0
22	10362072	.	G	A	9	7	16	0	2	18	0	0
22	10362174	.	C	T	0	5	5	0	3	8	0	0
22	10362229	.	A	T	4	3	7	0	1	8	0	0
22	10364681	.	A	G	0	0	0	0	1	1	0	0
22	10368054	.	A	T	3	0	3	0	0	3	0	0
22	10373099	.	C	T	0	1	1	0	2	3	0	0
22	10430252	.	A	G	4	3	7	0	0	7	0	0
22	10430572	.	G	A	1	2	3	0	0	3	0	0
22	10430709	.	T	C	0	1	1	0	0	1	0	0
22	10434738	.	C	A	1	2	3	0	0	3	0	0
22	10514154	.	T	A	5	5	10	0	0	10	0	0
22	10540812	.	G	T	10	7	17	0	1	18	0	0
22	10545267	.	C	T	1	2	3	0	0	3	0	0
22	10553526	.	G	A	4	3	7	0	0	7	0	0
22	10553532	.	C	T	4	3	7	0	0	7	0	0
22	10553620	.	G	T	2	5	7	0	0	7	0	0
22	10553626	.	G	A	1	6	7	0	1	8	0	0
22	10557870	.	T	G	0	3	3	0	0	3	0	0
22	10557898	.	C	T	1	3	4	0	0	4	0	0
22	10558913	.	G	A	0	3	3	0	3	6	0	0
22	10561255	.	A	T	9	8	17	0	0	17	0	0
22	10561514	.	A	G	2	5	7	0	0	7	0	0
22	10561758	.	A	G	10	4	14	0	0	14	0	0
22	10592056	.	A	G	5	4	9	0	0	9	0	0
22	10592059	.	A	G	4	3	7	0	1	8	0	0
22	10592426	.	C	A	4	4	8	0	0	8	0	0
22	10592535	.	C	A	4	3	7	0	0	7	0	0
22	10592545	.	G	A	3	3	6	0	0	6	0	0
22	10592719	.	T	C	7	6	13	0	0	13	0	0
22	10593310	.	A	G	1	0	1	0	0	1	0	0
22	10593527	.	A	G	6	3	9	0	0	9	0	0
22	10593531	.	G	A	6	3	9	0	0	9	0	0
22	10593990	.	A	G	3	5	8	0	2	10	0	0
22	10594008	.	G	T	2	4	6	0	1	7	0	0
22	10594074	.	C	T	5	4	9	0	0	9	0	0
22	10594098	.	G	A	4	3	7	0	1	8	0	0
22	10594170	.	A	G	4	5	9	0	0	9	0	0
22	10599510	.	A	G	2	1	3	0	0	3	0	0
22	10637232	.	A	G	6	9	15	0	2	17	0	0
22	10637253	.	T	C	6	6	12	0	0	12	0	0
22	10637298	.	C	A	3	6	9	0	0	9	0	0
22	10637669	.	G	T	5	2	7	0	0	7	0	0
22	10637729	.	T	C	6	6	12	0	1	13	0	0
22	10638536	.	A	T	12	6	18	0	0	18	0	0
22	10638887	.	T	C	7	12	19	0	0	19	0	0
22	10638974	.	G	A	2	8	10	0	0	10	0	0
22	10657947	.	T	C	2	3	5	0	0	5	0	0
22	10657980	.	A	G	3	4	7	0	0	7	0	0
22	10658007	.	T	A	3	3	6	0	0	6	0	0
22	10658042	.	A	C	2	3	5	0	0	5	0	0
22	10660261	.	A	T	5	5	10	0	0	10	0	0
22	10662886	.	C	T	6	7	13	0	0	13	0	0
22	10662952	.	C	T	0	1	1	0	0	1	0	0
22	10663090	.	G	T	0	3	3	0	6	9	0	0
22	10663390	.	T	G	10	9	19	0	0	19	0	0
22	10663433	.	A	T	5	7	12	0	4	16	0	0
22	10663469	.	T	A	4	6	10	0	2	12	0	0
22	10663504	.	T	A	12	10	22	0	1	23	0	0
22	10663567	.	A	T	16	16	32	0	1	33	0	0
22	10689488	.	C	T	1	2	3	0	0	3	0	0
22	10690497	.	T	A	1	1	2	0	1	3	0	0
22	10706586	.	T	G	3	2	5	0	2	7	0	0
22	10706603	.	G	A	0	6	6	0	4	10	0	0
22	10733512	.	C	T	2	2	4	0	2	6	0	0
22	10733554	.	G	A	4	2	6	0	0	6	0	0
22	10734916	.	G	A	4	3	7	0	0	7	0	0
22	10734941	.	C	T	3	2	5	0	4	9	0	0
22	10734967	.	A	T	5	5	10	0	1	11	0	0
22	10735015	.	C	A	0	6	6	0	0	6	0	0
22	10735119	.	T	A	0	2	2	0	3	5	0	0
22	10735140	.	A	T	0	4	4	0	1	5	0	0
22	10755600	.	A	G	7	15	22	0	0	22	0	0
22	10755652	.	T	A	8	6	14	0	0	14	0	0
22	10755746	.	G	T	24	12	36	0	1	37	0	0
22	10755888	.	T	C	22	13	35	0	3	38	0	0
22	10771195	.	C	T	0	8	8	0	11	19	0	0
22	10771284	.	T	C	7	10	17	0	4	21	0	0
22	10771369	.	G	A	10	13	23	0	0	23	0	0
22	10771415	.	A	T	10	9	19	0	1	20	0	0
22	10771628	.	T	C	8	4	12	0	1	13	0	0
22	10771743	.	C	G	7	8	15	0	0	15	0	0
22	10771752	.	G	A	7	8	15	0	0	15	0	0
22	10771919	.	T	C	3	0	3	0	2	5	0	0
22	10795696	.	C	G	2	2	4	0	0	4	0	0
22	11071053	.	A	G	4	4	8	0	0	8	0	0
22	11071059	.	C	T	3	4	7	0	0	7	0	0
22	11071505	.	A	G	2	1	3	0	1	4	0	0
22	11071568	.	C	A	2	1	3	0	0	3	0	0
22	11071698	.	T	G	3	2	5	0	0	5	0	0
22	11123770	.	C	T	29	20	49	0	4	53	0	0
22	11123889	.	T	C	23	15	38	1	3	42	0	0
22	11124524	.	T	C	1	0	1	0	0	1	0	0
22	11126857	.	A	G	5	4	9	0	2	11	0	0
22	11126866	.	G	A	6	5	11	0	1	12	0	0
22	11129995	.	G	A	6	3	9	0	1	10	0	0
22	11134731	.	T	C	3	2	5	0	0	5	0	0
22	11135446	.	G	A	3	2	5	0	0	5	0	0
22	11136606	.	G	A	0	1	1	0	0	1	0	0
22	11161201	.	T	C	3	2	5	0	0	5	0	0
22	11170954	.	T	C	2	2	4	0	1	5	0	0
22	11170966	.	T	G	2	0	2	0	2	4	0	0
22	11171086	.	G	A	6	3	9	0	0	9	0	0
22	11188598	.	C	T	2	4	6	0	0	6	0	0
22	11199942	.	T	A	23	8	31	0	1	32	0	0
22	11200160	.	C	T	2	2	4	0	0	4	0	0
22	11200242	.	T	G	4	5	9	0	0	9	0	0
22	11200401	.	G	A	0	8	8	0	20	28	0	0
22	12641723	.	G	A	5	2	7	0	0	7	0	0
22	12641724	.	G	A	5	2	7	0	0	7	0	0
22	13459294	.	A	G	7	15	22	0	0	22	0	0
22	13459472	.	T	A	2	11	13	0	0	13	0	0
22	13459596	.	T	C	6	1	7	0	8	15	0	0
22	13459611	.	A	G	6	8	14	0	3	17	0	0
22	13459636	.	G	T	7	13	20	0	0	20	0	0
22	13459718	.	A	G	5	9	14	0	0	14	0	0
22	13459865	.	G	C	4	0	4	0	9	13	0	0
22	13460191	.	T	C	8	5	13	0	1	14	0	0
22	13460406	.	T	C	4	6	10	0	0	10	0	0
22	13460483	.	A	G	2	5	7	0	0	7	0	0
22	13460509	.	T	G	1	3	4	0	0	4	0	0
22	13461012	.	A	G	2	4	6	0	0	6	0	0
22	13461073	.	C	G	1	2	3	0	0	3	0	0
22	13461084	.	C	T	1	2	3	0	1	4	0	0
22	13461146	.	C	T	0	2	2	0	1	3	0	0
22	13462863	.	T	C	4	4	8	0	1	9	0	0
22	13463071	.	A	G	4	10	14	0	0	14	0	0
22	15345546	.	T	C	2	2	4	0	1	5	0	0
22	15345580	.	G	A	1	2	3	0	0	3	0	0
22	15345592	.	T	C	0	0	0	0	1	1	0	0
22	15350053	.	T	C	4	3	7	0	0	7	0	0
22	15351505	.	A	G	8	3	11	0	0	11	0	0
22	15352257	.	T	C	5	4	9	0	0	9	0	0
22	15352382	.	T	C	5	2	7	0	1	8	0	0
22	15437173	.	C	A	4	2	6	0	0	6	0	0
22	15552046	.	G	T	10	8	18	0	0	18	0	0
22	15552081	.	C	T	2	2	4	0	0	4	0	0
22	15552082	.	T	C	2	1	3	0	1	4	0	0
22	15552139	.	C	A	0	2	2	0	0	2	0	0
22	15552297	.	G	A	2	3	5	0	1	6	0	0
22	15552304	.	T	A	2	4	6	0	0	6	0	0
22	15629686	.	T	C	1	3	4	0	0	4	0	0
22	15630115	.	T	G	5	1	6	0	5	11	0	0
22	15697354	.	G	A	17	9	26	0	1	27	0	0
22	15701545	.	A	T	10	10	20	0	1	21	0	0
22	15719440	.	A	G	2	2	4	0	3	7	0	0
22	15719444	.	T	C	3	4	7	0	0	7	0	0
22	15719547	.	C	A	6	1	7	0	0	7	0	0
22	15719821	.	A	C	5	2	7	0	0	7	0	0
22	15719891	.	T	C	12	11	23	0	1	24	0	0
22	15720199	.	A	G	3	2	5	0	1	6	0	0
22	15720200	.	C	A	0	2	2	0	4	6	0	0
22	15720608	.	T	C	5	10	15	0	0	15	0	0
22	15720666	.	G	A	6	10	16	0	2	18	0	0
22	15720925	.	T	A	12	13	25	0	2	27	0	0
22	15721408	.	G	A	0	13	13	0	9	22	0	0
22	15721466	.	G	T	6	3	9	0	1	12	2	0
22	15721534	.	C	T	11	6	17	0	1	18	0	0
22	15721584	.	T	G	15	7	22	0	2	24	0	0
22	15721696	.	A	T	4	3	7	0	0	7	0	0
22	15721730	.	C	A	6	2	8	0	0	8	0	0
22	15929136	.	A	G	0	1	1	0	0	1	0	0
22	16038660	.	G	A	12	12	24	0	1	25	0	0
22	16038749	.	A	G	8	11	19	0	1	20	0	0
22	16038858	.	T	G	5	6	11	0	2	13	0	0
22	16039194	.	C	A	4	4	8	0	1	9	0	0
22	16120728	.	A	G	1	1	2	0	0	2	0	0
22	16120766	.	T	C	2	1	3	0	0	3	0	0
22	16120828	.	A	G	4	4	8	0	0	8	0	0
22	16121157	.	C	A	5	3	8	0	0	8	0	0
22	16121281	.	C	A	2	4	6	0	0	6	0	0
22	16123437	.	T	G	7	4	11	0	2	13	0	0
22	16123931	.	A	G	1	3	4	0	0	4	0	0
22	16171544	.	C	A	1	2	3	0	0	3	0	0
22	16171869	.	G	A	2	10	12	0	0	12	0	0
22	16171871	.	A	G	2	10	12	0	0	12	0	0
22	16173380	.	T	G	4	3	7	0	0	7	0	0
22	16174191	.	A	G	1	0	1	0	1	2	0	0
22	16191841	.	T	C	3	0	3	0	4	7	0	0
22	16191845	.	T	G	2	3	5	0	1	6	0	0
22	16282571	.	T	A	4	8	12	0	0	12	0	0
22	16282636	.	T	G	7	4	11	0	0	11	0	0
22	16282757	.	C	G	0	7	7	0	4	11	0	0
22	16285578	.	G	A	1	2	3	0	0	3	0	0
22	16305164	.	A	C	6	12	18	0	0	18	0	0
22	16312075	.	T	C	3	3	6	0	1	7	0	0
22	16312085	.	T	C	4	0	4	0	2	6	0	0
22	16312228	.	A	G	0	2	2	0	0	2	0	0
22	16312278	.	C	T	0	2	2	0	0	2	0	0
22	16312399	.	A	G	2	1	3	0	0	3	0	0
22	16312755	.	T	C	0	2	2	0	0	2	0	0
22	16312783	.	C	T	0	2	2	0	1	3	0	0
22	16313005	.	T	A	3	3	6	0	0	6	0	0
22	16350811	.	T	G	23	18	41	0	3	44	0	0
22	16351199	.	C	G	12	9	21	0	4	25	0	0
22	16351204	.	C	T	0	10	10	0	15	25	0	0
22	16351353	.	G	A	5	2	7	0	0	7	0	0
22	16351552	.	A	T	3	3	6	0	0	6	0	0
22	16352215	.	A	G	4	2	6	0	1	7	0	0
22	16352349	.	A	G	6	3	9	0	0	9	0	0
22	16352528	.	G	A	3	3	6	0	0	6	0	0
22	16407115	.	A	T	1	2	3	0	0	3	0	0
22	16424576	.	T	C	0	4	4	0	0	4	0	0
22	16430672	.	C	T	17	6	23	0	1	24	0	0
22	16432627	.	C	T	21	8	29	0	0	29	0	0
22	16432628	.	A	T	21	8	29	0	0	29	0	0
22	16433078	.	G	A	14	11	25	0	0	25	0	0
22	16433096	.	A	G	15	8	23	0	1	24	0	0
22	16433131	.	T	G	9	5	14	0	1	15	0	0
22	16433250	.	G	A	1	3	4	0	0	4	0	0
22	16433940	.	C	T	4	2	6	0	0	6	0	0
22	16434056	.	G	A	5	8	13	0	1	14	0	0
22	16484277	.	T	A	6	7	13	0	5	18	0	0
22	16484877	.	A	T	3	7	10	0	0	10	0	0
22	16484938	.	A	G	7	8	15	0	1	16	0	0
22	16484944	.	T	C	7	6	13	0	1	14	0	0
22	16485035	.	A	G	5	7	12	0	1	13	0	0
22	16485538	.	T	C	1	0	1	0	4	5	0	0
22	16485563	.	A	T	1	2	3	0	0	3	0	0
22	16485962	.	C	G	7	1	8	0	1	9	0	0
22	16485994	.	C	A	3	2	5	0	1	6	0	0
22	16486112	.	T	C	3	2	5	0	1	6	0	0
22	16491942	.	G	A	3	3	6	0	0	6	0	0
22	16492000	.	T	A	2	0	2	0	0	2	0	0
22	16497953	.	G	A	5	5	10	0	0	10	0	0
22	16498155	.	G	C	0	4	4	0	7	11	0	0
22	16498317	.	A	G	14	10	24	0	4	28	0	0
22	16543627	.	C	T	4	8	12	0	1	13	0	0
22	16543714	.	T	C	5	6	11	0	1	12	0	0
22	16544186	.	A	G	2	3	5	0	0	5	0	0
22	16544197	.	A	G	3	3	6	0	1	7	0	0
22	16544243	.	C	T	6	5	11	0	0	11	0	0
22	16544260	.	C	T	6	3	9	0	1	10	0	0
22	16544308	.	A	G	2	5	7	2	0	9	0	0
22	16544384	.	G	A	3	10	13	0	0	13	0	0
22	16544400	.	T	G	4	9	13	0	0	13	0	0
22	16544560	.	A	C	14	7	21	0	0	21	0	0
22	16544561	.	A	G	14	0	14	0	7	21	0	0
22	16544674	.	T	G	11	12	23	0	3	26	0	0
22	16544780	.	A	T	13	13	26	0	2	28	0	0
22	16544800	.	G	A	15	6	21	0	0	21	0	0
22	16775306	.	C	T	9	7	16	0	0	16	0	0
22	18231256	.	T	A	5	3	8	0	0	8	0	0
22	18384173	.	T	C	4	2	6	0	0	6	0	0
22	20954438	.	G	A	1	2	3	0	2	5	0	0
22	21676215	.	A	G	0	2	2	0	0	2	0	0
22	21676233	.	G	A	0	5	5	0	1	6	0	0
22	22314852	.	A	T	3	2	5	0	2	7	0	0
22	24360615	.	G	T	3	1	4	0	1	5	0	0
22	24361095	.	A	G	12	5	17	0	0	17	0	0
22	24621873	.	A	G	3	2	5	0	1	6	0	0
22	24975369	.	A	G	4	7	11	0	1	12	0	0
22	24975398	.	C	A	0	7	7	0	7	14	0	0
22	24975457	.	G	A	3	2	5	0	0	5	0	0
22	24975613	.	C	T	1	4	5	0	0	5	0	0
22	25025208	.	G	A	15	19	34	0	2	36	0	0
22	25028424	.	G	A	4	5	9	0	1	10	0	0
22	25028751	.	A	G	3	2	5	0	1	6	0	0
22	25029136	.	T	A	6	2	8	0	0	8	0	0
22	25029193	.	C	G	0	2	2	0	2	4	0	0
22	25032293	.	T	C	3	2	5	0	0	5	0	0
22	25032532	.	C	G	8	6	14	0	0	14	0	0
22	25032572	.	G	A	1	6	7	0	4	11	0	0
22	25032620	.	A	C	3	6	9	0	3	12	0	0
22	25032693	.	T	C	7	7	14	0	0	14	0	0
22	25032857	.	G	A	1	4	5	0	6	11	0	0
22	25032863	.	A	G	7	4	11	0	0	11	0	0
22	25032921	.	A	T	8	4	12	0	0	12	0	0
22	25032986	.	T	A	3	3	6	0	0	6	0	0
22	25033004	.	T	C	0	4	4	0	0	4	0	0
22	25038315	.	C	T	0	4	4	0	1	5	0	0
22	25038360	.	T	C	2	7	9	0	1	10	0	0
22	25038387	.	A	G	3	7	10	0	1	11	0	0
22	25038432	.	T	C	2	4	6	0	0	6	0	0
22	25063474	.	C	T	0	1	1	0	0	1	0	0
22	25066583	.	A	G	3	10	13	0	0	13	0	0
22	25066585	.	G	A	3	10	13	0	0	13	0	0
22	25069856	.	G	A	2	2	4	0	0	4	0	0
22	25069884	.	C	A	1	2	3	0	0	3	0	0
22	25581699	.	A	G	0	1	1	0	0	1	0	0
22	25581722	.	T	C	0	1	1	0	0	1	0	0
22	25586963	.	C	T	2	5	7	0	1	8	0	0
22	25845010	.	C	T	2	2	4	0	0	4	0	0
22	25845419	.	G	A	1	2	3	0	0	3	0	0
22	25845521	.	A	G	1	2	3	0	0	3	0	0
22	25938882	.	T	C	1	5	6	0	0	6	0	0
22	25942390	.	A	C	0	0	0	0	1	1	0	0
22	25942586	.	G	T	6	3	9	0	2	12	1	0
22	25942659	.	A	G	1	2	3	0	2	5	0	0
22	25942660	.	A	G	3	2	5	0	0	5	0	0
22	25942769	.	T	C	6	4	10	0	2	12	0	0
22	25942822	.	A	G	3	4	7	0	0	7	0	0
22	25942829	.	A	C	3	5	8	0	0	8	0	0
22	25942940	.	A	G	6	8	14	0	0	14	0	0
22	25942985	.	G	T	5	6	11	0	1	12	0	0
22	25942997	.	T	G	4	4	8	0	2	10	0	0
22	26239602	.	T	C	4	7	11	0	1	12	0	0
22	26239610	.	G	A	5	7	12	0	0	12	0	0
22	26239681	.	C	T	0	10	10	0	3	13	0	0
22	26239774	.	T	A	5	8	13	0	1	14	0	0
22	26243236	.	A	C	2	0	2	0	6	8	0	0
22	26243242	.	C	T	3	5	8	0	1	9	0	0
22	26244704	.	C	T	2	2	4	0	0	4	0	0
22	26264690	.	T	C	4	2	6	0	2	8	0	0
22	26264805	.	T	A	3	1	4	0	0	4	0	0
22	26264807	.	A	G	3	1	4	0	0	4	0	0
22	26265477	.	C	T	0	3	3	0	0	3	0	0
22	26265498	.	A	T	0	3	3	0	0	3	0	0
22	26266765	.	C	T	4	3	7	0	1	8	0	0
22	26266798	.	C	A	1	2	3	0	1	4	0	0
22	26266956	.	C	A	1	0	1	0	0	1	0	0
22	26278273	.	G	A	0	1	1	0	1	2	0	0
22	26290324	.	C	T	4	7	11	0	0	11	0	0
22	26290762	.	A	G	6	5	11	0	1	12	0	0
22	26290771	.	A	C	7	4	11	0	0	11	0	0
22	26301324	.	G	A	1	0	1	0	0	1	0	0
22	26311254	.	A	G	2	4	6	0	0	6	0	0
22	26524910	.	A	T	5	6	11	0	2	13	0	0
22	26525112	.	T	C	7	3	10	0	0	10	0	0
22	26525118	.	C	T	0	3	3	0	8	11	0	0
22	26525935	.	T	G	4	6	10	0	0	10	0	0
22	26525960	.	A	G	3	5	8	0	0	8	0	0
22	26525979	.	C	T	4	2	6	0	0	6	0	0
22	26526119	.	C	T	2	5	7	0	0	7	0	0
22	26526249	.	A	T	2	2	4	0	0	4	0	0
22	26526412	.	G	A	1	3	4	0	0	4	0	0
22	26526471	.	A	G	1	2	3	0	0	3	0	0
22	26526564	.	T	C	0	1	1	0	1	2	0	0
22	26786013	.	A	G	4	2	6	0	1	7	0	0
22	26787710	.	G	T	2	4	6	0	0	6	0	0
22	26787911	.	C	T	7	6	13	0	2	15	0	0
22	26788340	.	G	A	4	5	9	0	0	9	0	0
22	26788449	.	T	C	2	8	10	0	0	10	0	0
22	26788565	.	T	C	9	8	17	0	0	17	0	0
22	26788885	.	C	A	5	6	11	0	4	15	0	0
22	26789228	.	G	A	0	8	8	0	16	24	0	0
22	26789465	.	A	G	11	0	11	0	14	25	0	0
22	26789742	.	G	A	2	2	4	0	0	4	0	0
22	26789813	.	A	T	6	12	18	0	0	18	0	0
22	26790074	.	C	T	17	13	30	0	1	31	0	0
22	26790436	.	A	T	19	13	32	0	3	35	0	0
22	26800113	.	T	A	1	2	3	0	0	3	0	0
22	26813620	.	A	T	2	2	4	0	1	5	0	0
22	26813642	.	A	T	1	2	3	0	0	3	0	0
22	26813670	.	G	A	3	2	5	0	0	5	0	0
22	26813851	.	T	G	2	3	5	0	0	5	0	0
22	26814164	.	C	G	3	3	6	0	1	7	0	0
22	26814320	.	C	T	0	0	0	0	1	1	0	0
22	26818086	.	G	A	1	10	11	0	12	23	0	0
22	26818700	.	T	C	5	4	9	0	1	10	0	0
22	26818851	.	T	A	4	11	15	0	3	18	0	0
22	26818907	.	A	G	6	0	6	0	12	18	0	0
22	26832125	.	G	A	7	7	14	0	1	15	0	0
22	26832906	.	T	C	1	3	4	0	0	4	0	0
22	26839502	.	T	A	3	5	8	0	3	11	0	0
22	26839505	.	G	A	3	6	9	0	0	9	0	0
22	26839538	.	T	G	2	5	7	0	0	7	0	0
22	26844260	.	G	A	5	6	11	0	0	11	0	0
22	26844345	.	A	C	5	2	7	0	0	7	0	0
22	26851904	.	A	C	1	1	2	0	0	2	0	0
22	26854965	.	A	G	2	2	4	0	0	4	0	0
22	26856023	.	A	G	1	4	5	0	0	5	0	0
22	26856059	.	A	T	2	6	8	0	0	8	0	0
22	26857762	.	A	G	1	1	2	0	1	3	0	0
22	26858002	.	A	G	6	2	8	0	1	9	0	0
22	26858037	.	T	C	9	8	17	0	1	18	0	0
22	26858066	.	T	C	1	15	16	0	2	18	0	0
22	26858161	.	T	C	3	2	5	0	1	6	0	0
22	26858174	.	T	C	5	3	8	0	0	8	0	0
22	26858216	.	T	C	7	7	14	0	0	14	0	0
22	26860639	.	C	T	0	12	12	0	11	23	0	0
22	26860753	.	T	C	4	9	13	0	1	14	0	0
22	26929826	.	C	A	15	16	31	0	0	31	0	0
22	26929931	.	A	T	16	8	24	0	2	26	0	0
22	26929969	.	A	G	19	11	30	0	2	32	0	0
22	26930076	.	A	G	12	9	21	0	1	22	0	0
22	26930079	.	G	T	12	10	22	0	0	22	0	0
22	26930133	.	G	C	6	8	14	0	0	14	0	0
22	26930164	.	A	T	5	3	8	0	0	8	0	0
22	26930214	.	G	A	5	1	6	0	0	6	0	0
22	26930223	.	A	G	4	2	6	0	0	6	0	0
22	26930335	.	A	T	3	3	6	0	1	7	0	0
22	26930390	.	C	T	5	3	8	0	0	8	0	0
22	26930460	.	A	G	1	2	3	0	0	3	0	0
22	26930489	.	C	G	4	3	7	0	0	7	0	0
22	26930527	.	T	A	5	3	8	0	0	8	0	0
22	27098736	.	G	A	1	3	4	0	0	4	0	0
22	28244972	.	A	G	1	2	3	0	1	4	0	0
22	28255495	.	T	C	0	3	3	0	0	3	0	0
22	28255514	.	C	G	0	0	0	0	1	1	0	0
22	28265596	.	T	G	3	4	7	0	0	7	0	0
22	28284646	.	A	C	2	5	7	0	1	8	0	0
22	28284659	.	C	T	2	2	4	0	0	4	0	0
22	28287669	.	T	C	0	2	2	0	0	2	0	0
22	28303025	.	C	T	6	9	15	0	0	15	0	0
22	28303091	.	C	A	7	10	17	0	0	17	0	0
22	28481641	.	G	A	0	2	2	0	2	4	0	0
22	28642555	.	G	A	2	3	5	0	0	5	0	0
22	28642695	.	A	C	3	5	8	0	1	9	0	0
22	28642715	.	C	A	0	5	5	0	4	9	0	0
22	28642777	.	G	A	1	4	5	0	0	5	0	0
22	28837231	.	A	G	2	6	8	0	2	10	0	0
22	28839917	.	A	C	2	4	6	0	0	6	0	0
22	28840101	.	C	A	4	2	6	0	0	6	0	0
22	28840154	.	A	G	6	3	9	0	0	9	0	0
22	28847988	.	G	A	9	6	15	0	0	15	0	0
22	28848724	.	A	T	8	8	16	0	1	17	0	0
22	28848735	.	T	C	7	7	14	0	1	15	0	0
22	28848920	.	A	G	7	4	11	0	0	11	0	0
22	28859346	.	G	A	3	1	4	0	0	4	0	0
22	28859409	.	A	G	4	3	7	0	1	8	0	0
22	28859618	.	A	G	2	3	5	0	0	5	0	0
22	29075278	.	C	T	4	6	10	0	1	11	0	0
22	29076058	.	T	G	2	2	4	0	0	4	0	0
22	29076126	.	A	G	1	6	7	0	1	8	0	0
22	29076172	.	G	A	3	11	14	0	1	15	0	0
22	29076236	.	T	C	6	7	13	0	2	15	0	0
22	29076381	.	G	C	6	8	14	0	3	17	0	0
22	29076389	.	A	G	6	8	14	0	3	17	0	0
22	29076444	.	G	C	4	4	8	0	1	9	0	0
22	29077023	.	T	A	4	2	6	0	0	6	0	0
22	29079761	.	T	C	1	2	3	0	0	3	0	0
22	29114351	.	G	A	1	3	4	0	1	5	0	0
22	29121765	.	C	T	1	2	3	0	0	3	0	0
22	29125660	.	C	T	3	2	5	0	1	6	0	0
22	29125699	.	T	A	3	3	6	0	0	6	0	0
22	29125791	.	T	A	1	3	4	0	0	4	0	0
22	29168879	.	G	A	24	27	51	0	5	56	0	0
22	29168940	.	T	A	31	22	53	0	1	54	0	0
22	29858936	.	T	C	10	14	24	1	0	25	0	0
22	33191097	.	A	G	2	2	4	0	0	4	0	0
22	33191831	.	C	A	2	2	4	0	0	4	0	0
22	33192496	.	G	A	3	5	8	0	0	8	0	0
22	33193261	.	C	T	2	3	5	0	1	6	0	0
22	33193368	.	G	C	7	7	14	0	1	15	0	0
22	33193369	.	A	G	7	6	13	0	2	15	0	0
22	33194475	.	C	T	2	2	4	0	0	4	0	0
22	33535881	.	C	T	0	1	1	0	1	2	0	0
22	33535884	.	C	T	0	1	1	0	1	2	0	0
22	33592309	.	T	C	2	3	5	0	0	5	0	0
22	33791235	.	G	A	0	1	1	0	0	1	0	0
22	34431166	.	T	C	3	2	5	0	1	6	0	0
22	36598444	.	C	T	0	1	1	0	0	1	0	0
22	36598459	.	G	C	0	1	1	0	0	1	0	0
22	36601758	.	A	G	3	0	3	0	4	7	0	0
22	36601761	.	A	C	4	3	7	0	0	7	0	0
22	36634127	.	T	C	7	4	11	0	1	12	0	0
22	36634210	.	G	C	4	2	6	0	1	7	0	0
22	36634213	.	G	A	0	1	1	0	5	6	0	0
22	36673766	.	G	A	2	2	4	0	0	4	0	0
22	36674186	.	G	A	31	12	43	0	8	51	0	0
22	36674646	.	A	G	4	7	11	0	0	11	0	0
22	36674658	.	G	A	5	9	14	0	4	18	0	0
22	36679390	.	G	A	7	6	13	0	1	14	0	0
22	36681357	.	T	G	2	7	9	0	1	10	0	0
22	36681359	.	A	G	3	7	10	0	0	10	0	0
22	36684170	.	A	G	1	3	4	0	0	4	0	0
22	36685729	.	C	T	9	3	12	0	0	12	0	0
22	36685768	.	T	C	2	1	3	0	6	9	0	0
22	36686658	.	G	A	12	3	15	0	1	16	0	0
22	36686828	.	G	A	0	2	2	0	0	2	0	0
22	36686867	.	G	A	1	3	4	0	0	4	0	0
22	36686870	.	A	G	1	1	2	0	2	4	0	0
22	36687418	.	C	T	0	4	4	0	1	5	0	0
22	36687541	.	T	C	1	0	1	0	0	1	0	0
22	36755973	.	T	G	1	2	3	0	0	3	0	0
22	36756005	.	T	C	1	3	4	0	0	4	0	0
22	36756154	.	A	T	3	3	6	0	0	6	0	0
22	36758365	.	A	T	1	0	1	0	0	1	0	0
22	36795038	.	A	G	1	5	6	0	0	6	0	0
22	36795040	.	G	A	1	5	6	0	0	6	0	0
22	36795279	.	C	T	3	5	8	0	0	8	0	0
22	36795755	.	G	C	5	4	9	0	0	9	0	0
22	36795845	.	G	T	4	3	7	0	1	8	0	0
22	36835966	.	C	T	1	1	2	0	0	2	0	0
22	36836043	.	T	A	1	2	3	0	0	3	0	0
22	36891142	.	G	A	2	0	2	0	0	2	0	0
22	36893330	.	T	C	1	2	3	0	0	3	0	0
22	36893411	.	A	C	1	1	2	0	0	2	0	0
22	36898727	.	T	C	1	1	2	0	0	2	0	0
22	36899574	.	A	G	7	3	10	0	1	11	0	0
22	36899611	.	C	A	10	4	14	0	1	15	0	0
22	36947797	.	G	T	4	9	13	0	2	15	0	0
22	36947836	.	C	A	6	9	15	0	1	16	0	0
22	36947841	.	A	G	5	5	10	0	3	13	0	0
22	36947963	.	T	C	9	1	10	0	10	20	0	0
22	36947997	.	A	G	4	12	16	0	0	16	0	0
22	36948052	.	T	G	6	4	10	0	0	10	0	0
22	36948131	.	G	T	5	2	7	0	0	7	0	0
22	36948177	.	C	A	5	6	11	0	0	11	0	0
22	36948202	.	C	A	7	4	11	0	1	12	0	0
22	36948237	.	A	T	6	3	9	0	1	10	0	0
22	36948242	.	A	G	5	3	8	0	0	9	1	0
22	36948410	.	G	A	7	3	10	0	0	10	0	0
22	37276451	.	G	A	3	4	7	0	1	8	0	0
22	37276606	.	C	A	5	9	14	0	2	16	0	0
22	37276717	.	A	G	5	7	12	0	0	12	0	0
22	37276790	.	G	A	4	4	8	0	0	8	0	0
22	37278141	.	G	A	1	2	3	0	0	3	0	0
22	37278146	.	A	C	1	2	3	0	0	3	0	0
22	37278634	.	C	T	1	1	2	0	0	2	0	0
22	37278638	.	C	G	0	1	1	0	0	1	0	0
22	37352700	.	C	G	3	0	3	0	0	3	0	0
22	37534114	.	T	C	0	2	2	0	1	3	0	0
22	37534122	.	C	G	2	3	5	0	0	5	0	0
22	37543457	.	A	G	11	5	16	0	1	17	0	0
22	37543656	.	A	G	3	3	6	0	1	7	0	0
22	37551029	.	A	G	1	7	8	0	0	8	0	0
22	37551369	.	G	T	3	3	6	0	2	8	0	0
22	37551496	.	T	C	5	2	7	0	1	8	0	0
22	37552717	.	G	A	3	4	7	0	1	8	0	0
22	37553015	.	C	T	1	2	3	0	0	3	0	0
22	37555120	.	T	C	2	0	2	0	0	2	0	0
22	37555126	.	A	G	2	0	2	0	0	2	0	0
22	37588819	.	A	T	26	15	41	0	4	45	0	0
22	37588926	.	G	T	16	10	26	0	4	30	0	0
22	37589002	.	T	G	24	11	35	0	4	39	0	0
22	37589131	.	A	G	28	13	41	0	1	42	0	0
22	37589273	.	T	A	18	18	36	0	2	38	0	0
22	37589275	.	A	C	18	19	37	0	1	38	0	0
22	37589430	.	T	C	10	5	15	0	2	17	0	0
22	37589634	.	C	T	11	5	16	0	2	18	0	0
22	37589848	.	T	A	7	3	10	0	1	11	0	0
22	37589898	.	A	T	3	6	9	0	0	9	0	0
22	37590037	.	C	A	3	2	5	0	0	5	0	0
22	37590339	.	A	T	10	4	14	0	1	15	0	0
22	37590470	.	A	T	3	3	6	0	1	7	0	0
22	37590486	.	C	T	3	6	9	0	1	10	0	0
22	37590535	.	C	T	3	9	12	0	0	12	0	0
22	37591444	.	T	C	1	0	1	0	2	3	0	0
22	37646226	.	T	A	1	1	2	0	0	2	0	0
22	37652850	.	C	T	4	2	6	0	1	7	0	0
22	37691852	.	C	T	0	2	2	0	0	2	0	0
22	37710178	.	G	T	1	1	2	0	0	2	0	0
22	37710223	.	A	G	4	3	7	0	0	7	0	0
22	37710241	.	A	G	4	3	7	0	0	7	0	0
22	37712558	.	A	G	10	12	22	0	2	24	0	0
22	37716493	.	G	C	6	6	12	0	1	13	0	0
22	37823332	.	C	A	0	0	0	0	2	2	0	0
22	37834045	.	G	T	0	4	4	0	0	4	0	0
22	37834215	.	T	C	0	3	3	0	0	3	0	0
22	37834218	.	G	A	0	3	3	0	0	3	0	0
22	37881433	.	G	T	2	18	20	0	1	21	0	0
22	38014843	.	A	G	1	2	3	0	0	3	0	0
22	38041893	.	C	T	11	5	16	0	1	17	0	0
22	38041959	.	C	T	2	3	5	0	0	5	0	0
22	38045009	.	T	A	7	10	17	0	3	20	0	0
22	38191778	.	T	G	3	2	5	0	0	5	0	0
22	38195229	.	C	T	6	8	14	0	1	15	0	0
22	38197900	.	C	T	8	30	38	0	2	40	0	0
22	38199702	.	A	C	12	10	22	0	1	23	0	0
22	38199716	.	C	T	14	15	29	0	1	30	0	0
22	38468595	.	C	T	1	3	4	0	1	5	0	0
22	38468644	.	C	T	4	2	6	0	1	7	0	0
22	38469884	.	G	A	0	3	3	0	0	3	0	0
22	38471854	.	T	A	6	3	9	0	0	9	0	0
22	38475664	.	A	T	1	0	1	0	0	1	0	0
22	38507285	.	G	A	1	0	1	0	0	1	0	0
22	38507288	.	G	C	1	1	2	0	0	2	0	0
22	38520867	.	A	T	14	14	28	0	0	28	0	0
22	38521095	.	T	C	9	21	30	0	5	35	0	0
22	38521154	.	G	C	12	9	21	0	2	23	0	0
22	38521353	.	G	C	8	7	15	0	0	15	0	0
22	38521630	.	A	G	2	14	16	0	1	17	0	0
22	38522291	.	T	A	7	5	12	0	1	13	0	0
22	38522431	.	T	A	2	3	5	0	0	5	0	0
22	38522899	.	T	A	4	2	6	0	0	6	0	0
22	38523616	.	C	G	3	4	7	0	0	7	0	0
22	38523658	.	A	T	3	5	8	0	1	9	0	0
22	38523865	.	C	G	0	3	3	0	0	3	0	0
22	38525146	.	A	G	1	2	3	0	0	3	0	0
22	38525155	.	A	T	0	2	2	0	0	2	0	0
22	38617884	.	G	A	1	2	3	0	0	3	0	0
22	38796656	.	T	A	5	6	11	0	0	11	0	0
22	38796689	.	G	A	5	2	7	0	0	7	0	0
22	38913423	.	A	T	2	2	4	0	0	4	0	0
22	38913661	.	G	A	1	2	3	0	0	3	0	0
22	38928475	.	C	T	4	2	6	0	1	7	0	0
22	38928517	.	T	A	3	2	5	0	1	6	0	0
22	38928738	.	G	A	3	2	5	0	1	6	0	0
22	38928940	.	C	A	3	2	5	0	0	5	0	0
22	38928979	.	T	G	3	2	5	0	2	7	0	0
22	38929112	.	T	C	7	5	12	0	0	12	0	0
22	38929165	.	G	A	3	5	8	0	0	8	0	0
22	38929347	.	T	A	1	4	5	0	0	5	0	0
22	38932327	.	G	A	5	7	12	0	0	12	0	0
22	38943838	.	C	G	1	2	3	0	0	3	0	0
22	38946287	.	A	G	1	2	3	0	0	3	0	0
22	38946553	.	T	C	5	10	15	0	0	15	0	0
22	38946576	.	T	C	8	13	21	0	1	22	0	0
22	38946608	.	A	C	8	16	24	0	1	25	0	0
22	38946833	.	T	C	19	7	26	0	0	26	0	0
22	38946953	.	T	A	14	9	23	0	1	24	0	0
22	38947013	.	G	A	11	10	21	0	0	21	0	0
22	38947040	.	G	A	11	9	20	0	0	20	0	0
22	38951130	.	A	T	4	2	6	0	0	6	0	0
22	38951137	.	C	A	4	2	6	0	0	6	0	0
22	39028712	.	C	T	1	4	5	0	0	5	0	0
22	39028725	.	A	G	1	2	3	0	2	5	0	0
22	39032814	.	A	G	3	2	5	0	0	5	0	0
22	39032915	.	C	T	4	3	7	0	0	7	0	0
22	39032925	.	A	G	3	3	6	0	0	6	0	0
22	39033036	.	C	G	4	3	7	0	0	7	0	0
22	39033053	.	C	T	5	4	9	0	0	9	0	0
22	39033134	.	C	T	10	6	16	0	1	17	0	0
22	39033637	.	C	G	6	10	16	0	0	16	0	0
22	39077407	.	C	G	1	0	1	0	5	6	0	0
22	39079231	.	T	C	2	3	5	0	0	5	0	0
22	39079356	.	A	C	3	3	6	0	0	6	0	0
22	39079379	.	C	A	4	3	7	0	0	7	0	0
22	39079470	.	G	A	0	3	3	0	5	8	0	0
22	39080035	.	C	G	5	4	9	0	0	9	0	0
22	39080043	.	G	C	2	5	7	0	1	8	0	0
22	39080300	.	A	T	5	4	9	0	1	10	0	0
22	39080774	.	C	G	10	9	19	0	1	20	0	0
22	39081169	.	A	G	17	0	17	0	15	32	0	0
22	39081177	.	C	T	15	14	29	0	4	33	0	0
22	39081259	.	T	A	6	15	21	0	1	22	0	0
22	39084943	.	G	A	1	1	2	0	1	3	0	0
22	39084966	.	A	T	1	2	3	0	0	3	0	0
22	39093984	.	T	C	2	2	4	0	0	4	0	0
22	39095966	.	T	C	4	3	7	0	1	8	0	0
22	39096080	.	C	A	5	2	7	0	0	7	0	0
22	39096117	.	A	C	5	5	10	0	0	10	0	0
22	39103941	.	T	C	1	5	6	0	0	6	0	0
23	251477	.	T	C	9	3	12	0	0	12	0	0
23	458254	.	T	C	5	12	17	0	2	19	0	0
23	495804	.	A	G	4	2	6	0	0	6	0	0
23	587114	.	A	G	2	0	2	0	5	7	0	0
23	587161	.	A	G	3	6	9	0	0	9	0	0
23	587412	.	A	G	6	5	11	0	3	14	0	0
23	863405	.	T	C	2	1	3	0	5	8	0	0
23	1719384	.	A	G	0	1	1	0	1	2	0	0
23	1723992	.	C	T	2	2	4	0	0	4	0	0
23	1725664	.	G	A	3	2	5	0	0	5	0	0
23	1725785	.	G	C	4	6	10	0	2	12	0	0
23	1725803	.	G	C	7	3	10	0	0	10	0	0
23	1725959	.	C	T	22	6	28	0	1	29	0	0
23	1725974	.	T	A	24	9	33	0	1	34	0	0
23	1726080	.	T	C	23	11	34	0	0	34	0	0
23	1726467	.	T	A	8	5	13	0	0	13	0	0
23	2053305	.	A	G	1	2	3	0	0	3	0	0
23	2053414	.	A	G	3	8	11	0	1	12	0	0
23	2053418	.	C	A	3	10	13	0	0	13	0	0
23	2249537	.	A	G	0	0	0	0	1	1	0	0
23	2252812	.	G	A	3	5	8	0	0	8	0	0
23	2256142	.	G	C	2	1	3	0	1	4	0	0
23	2256348	.	C	T	2	11	13	0	1	14	0	0
23	2256349	.	A	T	3	10	13	0	1	14	0	0
23	2438388	.	G	A	3	8	11	0	1	12	0	0
23	2438463	.	G	T	0	4	4	0	3	7	0	0
23	2438641	.	A	T	8	11	19	0	1	20	0	0
23	2440698	.	G	A	1	3	4	0	1	5	0	0
23	2443160	.	C	T	12	10	22	0	1	23	0	0
23	2443613	.	C	T	15	22	37	0	4	41	0	0
23	2443772	.	T	C	7	7	14	0	0	14	0	0
23	2443782	.	T	C	7	7	14	0	0	14	0	0
23	2717852	.	A	C	9	11	20	0	0	20	0	0
23	2717867	.	T	G	5	8	13	0	3	16	0	0
23	2718009	.	C	G	11	10	21	0	1	22	0	0
23	2721348	.	T	C	1	2	3	0	0	3	0	0
23	2721539	.	A	G	13	15	28	0	2	30	0	0
23	2725095	.	A	C	9	12	21	0	2	23	0	0
23	2757876	.	T	A	1	1	2	0	0	2	0	0
23	2762007	.	A	G	0	2	2	0	0	2	0	0
23	2870732	.	T	A	3	2	5	0	0	5	0	0
23	2871684	.	C	T	5	5	10	0	0	10	0	0
23	2871699	.	G	A	6	5	11	0	0	11	0	0
23	2871908	.	A	G	6	4	10	0	0	10	0	0
23	2871994	.	T	C	11	11	22	0	1	23	0	0
23	2872206	.	T	C	10	11	21	0	1	22	0	0
23	2872517	.	G	T	25	28	53	0	1	54	0	0
23	2873327	.	A	T	2	9	11	0	1	12	0	0
23	2877144	.	C	T	0	8	8	0	5	13	0	0
23	2879040	.	A	G	1	3	4	0	0	4	0	0
23	2906312	.	A	G	2	3	5	0	0	5	0	0
23	2925357	.	T	C	0	1	1	0	0	1	0	0
23	2927144	.	A	G	3	0	3	0	0	3	0	0
23	2931288	.	T	A	3	2	5	0	1	6	0	0
23	2931321	.	G	A	3	4	7	0	0	7	0	0
23	2931329	.	C	A	2	5	7	0	0	7	0	0
23	2931358	.	C	T	7	1	8	0	0	8	0	0
23	2931409	.	C	T	10	3	13	0	0	13	0	0
23	2931461	.	A	G	2	0	2	0	7	9	0	0
23	2931836	.	C	A	7	4	11	0	2	13	0	0
23	2931970	.	T	A	8	7	15	0	0	15	0	0
23	2932241	.	A	T	6	7	13	0	3	16	0	0
23	3406094	.	C	A	9	7	16	0	0	16	0	0
23	3406708	.	T	C	4	9	13	0	4	17	0	0
23	3406729	.	A	G	9	11	20	0	2	22	0	0
23	3406811	.	T	C	14	12	26	0	3	29	0	0
23	3406950	.	T	G	2	2	4	0	1	6	1	0
23	3407285	.	T	A	9	11	20	0	2	22	0	0
23	3407305	.	C	A	10	10	20	0	1	21	0	0
23	3517621	.	T	G	1	2	3	0	0	3	0	0
23	3520120	.	C	T	3	2	5	0	0	5	0	0
23	3653478	.	G	T	9	4	13	0	0	13	0	0
23	3653846	.	T	C	5	0	5	0	0	5	0	0
23	3653859	.	G	A	4	0	4	0	0	4	0	0
23	3654534	.	T	C	3	2	5	0	0	6	1	0
23	3654747	.	C	T	0	2	2	0	5	7	0	0
23	3655139	.	T	A	5	2	7	0	0	7	0	0
23	3657557	.	T	C	6	3	9	0	0	9	0	0
23	3660674	.	A	G	3	2	5	0	0	5	0	0
23	3660713	.	G	A	1	0	1	0	0	1	0	0
23	3662210	.	G	A	1	5	6	0	0	6	0	0
23	3662246	.	C	T	0	3	3	0	1	4	0	0
23	3664306	.	A	G	1	1	2	0	1	3	0	0
23	3667257	.	T	C	1	5	6	0	0	6	0	0
23	3740379	.	T	A	7	6	13	0	2	15	0	0
23	3744621	.	C	T	1	3	4	0	0	4	0	0
23	3744654	.	A	C	4	6	10	0	0	10	0	0
23	3751965	.	A	G	21	17	38	0	3	41	0	0
23	3751990	.	A	G	21	13	34	0	1	35	0	0
23	3752305	.	C	G	13	13	26	0	2	28	0	0
23	3752394	.	C	T	0	6	6	0	15	21	0	0
23	3752992	.	T	A	2	7	9	0	0	9	0	0
23	3951804	.	T	C	6	2	8	0	1	9	0	0
23	3951942	.	G	C	9	3	12	0	1	13	0	0
23	3951948	.	G	T	8	3	11	0	0	11	0	0
23	4019600	.	T	C	1	2	3	0	0	3	0	0
23	4086692	.	G	A	2	2	4	0	0	4	0	0
23	4086705	.	T	C	2	2	4	0	0	4	0	0
23	4086772	.	G	A	2	3	5	0	0	5	0	0
23	4086817	.	T	G	3	2	5	0	1	6	0	0
23	4087020	.	T	A	1	0	1	0	0	1	0	0
23	4216472	.	C	T	3	7	10	0	0	10	0	0
23	4254105	.	G	T	0	17	17	0	5	22	0	0
23	4254192	.	A	C	4	7	11	0	1	12	0	0
23	4259194	.	A	G	18	22	40	0	1	41	0	0
23	4259369	.	T	G	15	19	34	0	2	36	0	0
23	4259626	.	G	A	21	16	37	0	4	41	0	0
23	4259635	.	G	C	0	15	15	0	24	39	0	0
23	4259674	.	G	T	11	10	21	0	0	21	0	0
23	4269780	.	C	G	1	1	2	0	0	2	0	0
23	4270928	.	T	C	5	0	5	0	0	5	0	0
23	4271333	.	A	G	32	19	51	0	2	53	0	0
23	4280719	.	C	T	1	2	3	0	0	3	0	0
23	4280818	.	G	C	0	2	2	0	1	3	0	0
23	4280821	.	C	T	0	2	2	0	0	2	0	0
23	4280877	.	A	C	0	4	4	0	0	4	0	0
23	4312033	.	T	G	3	5	8	0	0	8	0	0
23	4314691	.	G	A	7	8	15	0	1	16	0	0
23	4364914	.	C	T	0	2	2	0	0	2	0	0
23	4390180	.	G	T	4	2	6	0	0	6	0	0
23	5756600	.	G	A	1	3	4	0	0	4	0	0
23	5756847	.	C	T	3	8	11	0	3	14	0	0
23	5757010	.	G	A	2	2	4	0	0	4	0	0
23	5757047	.	A	T	2	2	4	0	0	4	0	0
23	6421776	.	T	C	5	4	9	0	1	10	0	0
23	6421954	.	G	A	0	0	0	0	1	1	0	0
23	6952261	.	T	C	1	0	1	0	2	3	0	0
23	6955860	.	G	A	3	3	6	0	0	6	0	0
23	6958166	.	A	G	1	0	1	0	0	1	0	0
23	7000372	.	C	A	14	3	17	0	2	19	0	0
23	7003744	.	C	T	3	1	4	0	0	4	0	0
23	7007480	.	C	T	2	2	4	0	2	6	0	0
23	7029600	.	G	A	4	1	5	0	0	5	0	0
23	7029741	.	G	A	1	2	3	0	0	3	0	0
23	7029777	.	A	T	0	1	1	0	0	1	0	0
23	7032435	.	C	A	3	2	5	0	0	5	0	0
23	7578710	.	T	C	10	6	16	0	0	16	0	0
23	7735649	.	C	T	4	6	10	0	0	10	0	0
23	7735809	.	A	T	4	3	7	0	0	7	0	0
23	7762045	.	A	G	4	4	8	0	0	8	0	0
23	7789930	.	C	T	0	2	2	0	1	3	0	0
23	8285094	.	G	T	7	4	11	0	1	12	0	0
23	8285236	.	G	T	11	17	28	0	1	29	0	0
23	8285297	.	C	T	0	18	18	0	13	31	0	0
23	8285365	.	G	A	14	16	30	0	3	33	0	0
23	8285468	.	T	C	3	7	10	0	1	11	0	0
23	8285585	.	A	T	6	3	9	0	1	10	0	0
23	8285640	.	C	T	5	5	10	0	0	10	0	0
23	8286192	.	T	C	2	0	2	0	5	7	0	0
23	8286237	.	G	A	2	4	6	0	2	8	0	0
23	8719074	.	T	C	8	11	19	0	3	22	0	0
23	8724467	.	G	A	7	6	13	0	0	13	0	0
23	9013597	.	T	C	2	4	6	0	0	6	0	0
23	9013843	.	G	A	4	4	8	0	0	8	0	0
23	9013876	.	T	A	5	5	10	0	1	11	0	0
23	9014122	.	G	A	0	5	5	0	7	12	0	0
23	9014259	.	G	A	10	12	22	0	0	22	0	0
23	9014844	.	T	G	4	4	8	0	0	8	0	0
23	9058213	.	C	T	1	2	3	0	0	3	0	0
23	9062895	.	A	G	2	3	5	0	0	5	0	0
23	9069798	.	G	A	2	2	4	0	3	7	0	0
23	9069816	.	G	A	4	5	9	0	1	10	0	0
23	9069900	.	A	G	0	0	0	0	1	1	0	0
23	9081490	.	T	G	3	2	5	0	0	5	0	0
23	9268466	.	T	C	3	1	4	0	0	4	0	0
23	9287619	.	G	A	3	2	5	0	0	5	0	0
23	9287629	.	C	A	2	2	4	0	0	4	0	0
23	9288047	.	T	A	9	3	12	0	0	12	0	0
23	9288062	.	C	G	11	3	14	0	1	15	0	0
23	9288200	.	G	T	6	3	9	0	0	9	0	0
23	9794733	.	T	C	9	3	12	0	1	13	0	0
23	9794959	.	T	A	13	17	30	0	1	31	0	0
23	9795057	.	A	G	19	17	36	0	3	39	0	0
23	9795097	.	C	T	0	21	21	0	21	42	0	0
23	9795663	.	A	C	8	7	15	0	0	15	0	0
23	9795908	.	C	T	8	8	16	0	1	17	0	0
23	9800761	.	T	G	2	3	5	0	1	6	0	0
23	9800993	.	G	T	1	3	4	0	0	4	0	0
23	9809863	.	A	G	14	21	35	0	3	38	0	0
23	9809977	.	C	T	0	8	8	0	14	22	0	0
23	9810491	.	C	G	11	3	14	0	0	14	0	0
23	9938315	.	A	C	1	0	1	0	6	7	0	0
23	9938349	.	T	C	2	6	8	0	1	9	0	0
23	9938497	.	G	A	3	6	9	0	0	9	0	0
23	9938595	.	T	A	1	2	3	0	0	3	0	0
23	9938714	.	G	T	2	3	5	0	2	7	0	0
23	9938869	.	C	T	5	5	10	0	0	10	0	0
23	9939602	.	T	C	2	4	6	0	0	6	0	0
23	10174422	.	A	G	3	2	5	0	0	5	0	0
23	10174426	.	T	C	3	2	5	0	0	5	0	0
23	10174961	.	A	G	1	2	3	0	0	3	0	0
23	10250357	.	G	A	6	5	11	0	0	11	0	0
23	10252499	.	A	G	2	2	4	0	0	4	0	0
23	10252526	.	G	A	2	2	4	0	0	4	0	0
23	10419933	.	A	C	1	3	4	0	1	5	0	0
23	10421216	.	A	C	0	1	1	0	0	1	0	0
23	10423909	.	C	G	0	0	0	0	1	1	0	0
23	10426291	.	C	T	0	2	2	0	0	2	0	0
23	10448936	.	C	T	7	13	20	0	3	23	0	0
23	10449063	.	T	C	10	3	13	0	1	14	0	0
23	10449185	.	C	T	4	7	11	0	0	11	0	0
23	10638386	.	A	G	1	3	4	0	0	4	0	0
23	10638430	.	T	A	3	3	6	0	0	6	0	0
23	10639121	.	G	A	3	3	6	0	0	6	0	0
23	10725320	.	T	C	0	3	3	0	0	3	0	0
23	10725334	.	T	C	0	2	2	0	2	4	0	0
23	10725638	.	A	T	3	2	5	0	0	5	0	0
23	10725919	.	C	A	5	2	7	0	0	7	0	0
23	10727563	.	G	A	4	3	7	0	0	7	0	0
23	10762922	.	G	A	8	12	20	0	2	22	0	0
23	10825541	.	T	A	2	2	4	0	0	4	0	0
23	10825556	.	C	T	2	2	4	0	0	4	0	0
23	10826427	.	C	T	7	3	10	0	0	10	0	0
23	10826718	.	C	A	9	6	15	0	0	15	0	0
23	10826754	.	C	T	8	5	13	0	2	15	0	0
23	11859294	.	C	T	2	1	3	0	0	3	0	0
23	11865055	.	T	A	6	6	12	0	3	15	0	0
23	11865934	.	C	T	4	12	16	0	2	18	0	0
23	11866086	.	G	A	12	13	25	0	1	26	0	0
23	11866183	.	G	A	14	9	23	0	0	23	0	0
23	11866259	.	T	C	8	7	15	0	1	16	0	0
23	11870203	.	A	T	2	2	4	0	0	4	0	0
23	12162034	.	G	A	3	5	8	0	0	8	0	0
23	12162163	.	C	T	2	4	6	0	0	6	0	0
23	12162386	.	A	C	5	3	8	0	1	9	0	0
23	12232873	.	G	A	4	3	7	0	1	8	0	0
23	12233117	.	G	A	13	9	22	0	1	23	0	0
23	12233121	.	C	T	0	12	12	0	9	21	0	0
23	12245729	.	A	C	3	5	8	0	1	9	0	0
23	12259026	.	C	T	1	6	7	0	10	17	0	0
23	12345695	.	G	A	1	5	6	0	1	7	0	0
23	12487331	.	C	T	0	4	4	0	1	5	0	0
23	13598094	.	C	T	0	1	1	0	0	1	0	0
23	13598632	.	T	C	6	7	13	0	0	13	0	0
23	13598679	.	C	T	9	5	14	0	1	15	0	0
23	13599008	.	G	A	4	5	9	0	0	9	0	0
23	13833376	.	T	A	3	2	5	0	0	5	0	0
23	13840297	.	G	A	2	0	2	0	0	2	0	0
23	13840362	.	C	T	0	2	2	0	2	4	0	0
23	13845114	.	A	C	8	9	17	0	0	17	0	0
23	13845131	.	G	A	11	7	18	0	0	18	0	0
23	13845149	.	T	G	8	14	22	0	1	23	0	0
23	13845201	.	A	G	4	8	12	0	0	12	0	0
23	13845247	.	G	T	2	2	4	0	0	4	0	0
23	13845389	.	C	A	3	4	7	0	0	7	0	0
23	13845411	.	G	T	6	4	10	0	1	11	0	0
23	13845447	.	T	C	9	7	16	0	2	18	0	0
23	13846885	.	A	G	1	2	3	0	0	3	0	0
23	13846917	.	T	G	0	4	4	0	0	4	0	0
23	13846938	.	G	T	1	2	3	0	0	3	0	0
23	13846953	.	C	A	0	2	2	0	1	3	0	0
23	13847220	.	T	C	1	2	3	0	0	3	0	0
23	13941275	.	C	T	5	4	9	0	0	9	0	0
23	13946174	.	C	T	0	4	4	0	5	9	0	0
23	13949110	.	C	T	0	2	2	0	4	6	0	0
23	14193676	.	A	G	10	11	21	0	1	22	0	0
23	14193777	.	C	T	9	20	29	0	0	29	0	0
23	14193880	.	C	T	9	8	17	0	4	21	0	0
23	14193923	.	A	C	5	14	19	0	0	19	0	0
23	14193940	.	C	T	6	12	18	0	2	20	0	0
23	14194035	.	C	G	6	20	26	0	0	26	0	0
23	14194058	.	G	A	7	21	28	0	1	29	0	0
23	14198137	.	G	A	3	3	6	0	1	7	0	0
23	14208718	.	A	G	2	2	4	0	0	4	0	0
23	14208817	.	A	T	2	1	3	0	0	3	0	0
23	14209024	.	T	G	2	2	4	0	0	4	0	0
23	14211707	.	C	T	2	1	3	0	0	3	0	0
23	14786429	.	A	T	0	3	3	0	0	3	0	0
23	14787318	.	T	A	0	1	1	0	0	1	0	0
23	14787409	.	G	A	0	0	0	0	2	2	0	0
23	14787426	.	G	A	1	0	1	0	0	1	0	0
23	14790827	.	G	A	2	2	4	0	0	4	0	0
23	14803800	.	G	T	3	4	7	0	0	7	0	0
23	14808490	.	G	A	2	3	5	0	0	5	0	0
23	14808537	.	G	T	4	9	13	0	0	13	0	0
23	14808545	.	A	G	9	4	13	0	0	13	0	0
23	14809613	.	C	A	4	2	6	0	0	6	0	0
23	14819798	.	G	A	1	2	3	0	0	3	0	0
23	14832549	.	A	T	1	4	5	0	2	7	0	0
23	14832677	.	G	A	22	23	45	0	3	48	0	0
23	14832774	.	G	A	24	24	48	0	2	50	0	0
23	14832835	.	C	T	33	30	63	0	2	65	0	0
23	14832866	.	C	T	32	26	58	0	6	64	0	0
23	14832926	.	A	T	27	23	50	0	5	55	0	0
23	14833032	.	C	T	30	21	51	0	4	55	0	0
23	14833142	.	A	T	22	24	46	0	2	48	0	0
23	14833143	.	A	T	20	20	40	0	8	48	0	0
23	14833189	.	A	C	26	18	44	0	3	47	0	0
23	14833552	.	T	C	27	20	47	0	2	49	0	0
23	14833664	.	G	A	28	20	48	0	3	51	0	0
23	14833765	.	G	A	27	30	57	0	1	58	0	0
23	14853342	.	G	A	2	2	4	0	2	6	0	0
23	14853411	.	C	T	2	0	2	0	0	2	0	0
23	14853414	.	C	T	0	0	0	0	2	2	0	0
23	14993140	.	T	C	9	0	9	0	14	23	0	0
23	14993200	.	A	T	7	17	24	0	0	24	0	0
23	14993936	.	A	T	1	2	3	0	0	3	0	0
23	14999053	.	C	T	2	5	7	0	0	7	0	0
23	14999095	.	C	T	1	6	7	0	1	8	0	0
23	15204222	.	C	T	1	20	21	0	20	41	0	0
23	15204321	.	T	A	13	10	23	0	1	24	0	0
23	15204324	.	T	A	13	11	24	0	1	25	0	0
23	15204417	.	A	G	8	6	14	0	1	16	1	0
23	15204936	.	G	T	4	4	8	0	1	9	0	0
23	15205428	.	A	T	1	8	9	0	0	9	0	0
23	15205487	.	C	G	9	5	14	0	0	14	0	0
23	15205994	.	G	A	9	11	20	0	0	20	0	0
23	15206057	.	A	G	1	4	5	0	0	5	0	0
23	15206061	.	G	C	1	3	4	0	1	5	0	0
23	15206612	.	A	T	2	0	2	0	0	2	0	0
23	15211253	.	G	C	6	5	11	0	0	11	0	0
23	15216664	.	G	T	0	1	1	0	0	1	0	0
23	16648643	.	A	G	3	2	5	0	0	5	0	0
23	16648656	.	A	G	4	1	5	0	1	6	0	0
23	16648950	.	T	A	13	14	27	0	3	30	0	0
23	16649012	.	C	T	13	5	18	0	1	19	0	0
23	16649021	.	C	G	15	0	15	0	2	18	1	0
23	16649599	.	G	T	16	14	30	0	6	36	0	0
23	16649855	.	T	C	11	1	12	0	13	25	0	0
23	16650074	.	G	A	4	4	8	0	0	8	0	0
23	16654424	.	A	G	2	6	8	0	1	9	0	0
23	16748903	.	A	T	1	2	3	0	0	3	0	0
23	16748915	.	T	A	1	2	3	0	0	3	0	0
23	16757528	.	G	T	9	3	12	0	0	12	0	0
23	16822464	.	G	A	0	3	3	0	5	8	0	0
23	16822469	.	T	C	6	3	9	0	0	9	0	0
23	16831822	.	G	A	0	3	3	0	3	6	0	0
23	16834080	.	G	A	1	2	3	0	0	3	0	0
23	16849056	.	T	C	2	2	4	0	0	4	0	0
23	16849341	.	C	T	5	6	11	0	0	11	0	0
23	16849383	.	A	G	3	3	6	0	0	6	0	0
23	16883764	.	A	T	2	2	4	0	1	5	0	0
23	16883822	.	G	T	5	3	8	0	0	8	0	0
23	16883836	.	C	A	6	2	8	0	1	9	0	0
23	16883860	.	C	T	4	2	6	0	1	7	0	0
23	16883961	.	G	A	0	1	1	1	0	2	0	0
23	16961626	.	T	C	3	2	5	0	0	5	0	0
23	17113842	.	A	G	1	1	2	0	0	2	0	0
23	17354662	.	T	C	4	3	7	0	0	7	0	0
23	17354693	.	G	T	2	2	4	0	0	4	0	0
23	17354718	.	A	T	2	3	5	0	1	6	0	0
23	17354853	.	G	A	2	3	5	0	0	5	0	0
23	17354868	.	C	A	2	3	5	0	0	5	0	0
23	17355063	.	C	T	2	3	5	0	0	5	0	0
23	17355109	.	C	T	5	2	7	0	1	8	0	0
23	17384981	.	A	G	2	2	4	0	0	4	0	0
23	17428153	.	C	T	26	30	56	0	8	64	0	0
23	17429632	.	C	T	0	6	6	0	12	18	0	0
23	17431644	.	A	T	24	21	45	0	1	46	0	0
23	17431707	.	T	A	24	14	38	0	1	39	0	0
23	17431734	.	C	T	15	11	26	0	3	29	0	0
23	17432036	.	T	C	9	17	26	0	1	27	0	0
23	17432133	.	A	C	4	8	12	0	1	13	0	0
23	17432169	.	T	A	1	9	10	0	1	11	0	0
23	17432412	.	T	C	6	7	13	0	1	14	0	0
23	17473187	.	C	T	20	19	39	0	4	43	0	0
23	17473309	.	G	A	13	19	32	0	0	32	0	0
23	17473365	.	T	C	8	13	21	0	4	25	0	0
23	17473398	.	G	T	10	9	19	0	3	22	0	0
23	17473611	.	C	G	8	12	20	0	0	20	0	0
23	17473632	.	C	A	9	1	10	0	1	11	0	0
23	17473649	.	T	A	5	7	12	0	0	12	0	0
23	17473795	.	A	C	21	18	39	0	4	43	0	0
23	17473857	.	A	G	20	16	36	0	0	36	0	0
23	17473899	.	C	T	20	7	27	0	4	31	0	0
23	17473981	.	G	A	21	8	29	0	4	33	0	0
23	17474167	.	G	A	3	2	5	0	0	5	0	0
23	17474206	.	A	T	3	4	7	0	1	8	0	0
23	17474532	.	T	C	3	6	9	0	0	9	0	0
23	17474928	.	C	G	10	6	16	0	2	18	0	0
23	17475329	.	G	C	3	0	3	0	1	6	2	0
23	17475349	.	A	T	4	3	7	0	0	7	0	0
23	17475808	.	G	T	2	3	5	0	1	6	0	0
23	17475951	.	C	T	2	2	4	0	3	7	0	0
23	17516889	.	C	T	9	3	12	0	1	13	0	0
23	17516897	.	C	T	10	3	13	0	0	13	0	0
23	17520025	.	C	G	7	10	17	0	1	18	0	0
23	17520245	.	T	C	13	11	24	0	1	25	0	0
23	17520311	.	T	G	10	14	24	0	1	25	0	0
23	17520338	.	G	A	10	16	26	0	8	34	0	0
23	17520632	.	A	T	5	3	8	0	1	9	0	0
23	17520870	.	T	C	5	6	11	1	0	12	0	0
23	17656654	.	G	A	6	3	9	0	1	10	0	0
23	17657265	.	G	C	1	3	4	0	0	4	0	0
23	17782767	.	G	A	4	2	6	0	0	6	0	0
23	17812711	.	C	T	6	7	13	0	0	13	0	0
23	17812720	.	T	A	8	9	17	0	0	17	0	0
23	17812755	.	G	T	6	10	16	0	0	16	0	0
23	17813057	.	G	A	5	6	11	0	0	11	0	0
23	17813717	.	G	A	11	24	35	0	0	35	0	0
23	17813811	.	C	T	4	16	20	0	1	21	0	0
23	17813952	.	G	T	11	6	17	0	0	17	0	0
23	17814056	.	G	A	16	22	38	0	2	40	0	0
23	17814223	.	C	T	8	19	27	0	15	42	0	0
23	17814281	.	G	T	15	25	40	0	0	40	0	0
23	17814299	.	A	C	16	24	40	0	0	40	0	0
23	17814408	.	A	C	14	13	27	0	1	28	0	0
23	17846622	.	A	C	0	1	1	0	0	1	0	0
23	17848361	.	G	T	2	3	5	0	0	5	0	0
23	17848364	.	A	G	2	3	5	0	0	5	0	0
23	17849275	.	T	G	11	6	17	0	1	18	0	0
23	17849296	.	C	G	1	6	7	0	12	19	0	0
23	17849627	.	C	T	6	5	11	0	0	11	0	0
23	17849699	.	C	G	2	1	3	0	1	4	0	0
23	17851768	.	C	T	0	3	3	0	7	10	0	0
23	17853145	.	T	G	1	0	1	0	0	1	0	0
23	17873750	.	C	A	27	22	49	0	2	51	0	0
23	17879152	.	A	T	2	4	6	0	0	6	0	0
23	17879153	.	A	C	3	2	5	0	1	6	0	0
23	17879299	.	G	A	4	1	5	0	0	5	0	0
23	17880800	.	C	T	5	6	11	0	0	11	0	0
23	17881252	.	T	C	8	8	16	0	1	17	0	0
23	17994274	.	C	G	8	4	12	0	0	12	0	0
23	17994354	.	T	C	2	9	11	0	0	11	0	0
23	17994359	.	C	T	8	2	10	0	2	12	0	0
23	18032762	.	T	C	4	1	5	0	0	5	0	0
23	18032772	.	G	A	3	2	5	0	0	5	0	0
23	18032799	.	A	C	0	2	2	0	1	3	0	0
23	18032912	.	A	C	8	6	14	0	0	14	0	0
23	18032924	.	T	A	5	4	9	0	1	10	0	0
23	18118922	.	G	A	18	21	39	0	4	43	0	0
23	18119166	.	C	T	17	12	29	0	2	31	0	0
23	18119192	.	T	C	8	0	8	0	16	24	0	0
23	18119399	.	A	G	9	9	18	0	1	19	0	0
23	18372124	.	A	T	2	2	4	0	0	4	0	0
23	18372135	.	C	T	3	3	6	0	0	6	0	0
23	18387709	.	T	A	21	24	45	0	2	47	0	0
23	18388004	.	G	A	9	18	27	0	1	28	0	0
23	18388166	.	T	A	6	8	14	0	1	15	0	0
23	18388555	.	A	G	5	7	12	0	2	14	0	0
23	18388620	.	A	C	4	5	9	0	2	11	0	0
23	18388685	.	G	A	4	5	9	0	1	10	0	0
23	18389594	.	G	T	2	2	4	0	0	4	0	0
23	18390402	.	G	A	4	3	7	0	0	7	0	0
23	18390635	.	G	A	3	3	6	0	0	6	0	0
23	18561051	.	T	C	12	7	19	0	2	21	0	0
23	18561289	.	T	A	17	21	38	0	1	39	0	0
23	18561434	.	C	T	0	8	8	0	18	26	0	0
23	18562427	.	C	T	3	3	6	0	1	7	0	0
23	18562484	.	G	A	2	4	6	0	0	6	0	0
23	18562522	.	A	C	0	2	2	0	0	2	0	0
23	18562623	.	C	T	5	3	8	0	0	8	0	0
23	18562811	.	G	T	1	5	6	0	0	6	0	0
23	18563951	.	G	T	5	2	7	0	0	7	0	0
23	18563952	.	T	C	5	0	5	0	2	7	0	0
23	18569380	.	T	A	6	7	13	0	0	13	0	0
23	18569399	.	C	A	1	7	8	0	6	14	0	0
23	18569455	.	T	G	8	4	12	0	3	15	0	0
23	18569462	.	T	A	8	5	13	0	0	13	0	0
23	18569543	.	T	C	11	18	29	0	2	31	0	0
23	18569625	.	A	G	25	10	35	0	2	37	0	0
23	18572547	.	T	A	2	3	5	0	0	5	0	0
23	18572605	.	T	A	0	3	3	0	0	3	0	0
23	18574353	.	G	A	15	17	32	0	1	33	0	0
23	18574720	.	T	C	15	16	31	0	0	31	0	0
23	18574800	.	C	T	0	14	14	0	12	26	0	0
23	18580933	.	C	A	1	1	2	0	0	2	0	0
23	18580939	.	C	A	0	2	2	0	1	3	0	0
23	18581835	.	G	A	2	2	4	0	0	4	0	0
23	18581933	.	T	G	3	5	8	0	0	8	0	0
23	18588969	.	C	T	1	2	3	0	1	4	0	0
23	18616517	.	A	T	4	3	7	0	1	8	0	0
23	18616880	.	T	A	5	3	8	0	2	10	0	0
23	18617300	.	G	A	2	5	7	0	0	7	0	0
23	18622541	.	T	G	2	4	6	0	0	6	0	0
23	18703170	.	C	T	4	0	4	0	1	5	0	0
23	18759802	.	C	A	13	6	19	0	1	20	0	0
23	18759827	.	T	C	7	9	16	0	0	16	0	0
23	18759944	.	C	T	0	5	5	0	0	5	0	0
23	18759973	.	T	G	7	2	9	0	0	9	0	0
23	18760049	.	T	A	5	10	15	0	1	16	0	0
23	18760519	.	T	A	2	2	4	0	0	4	0	0
23	18795055	.	T	C	5	8	13	0	1	14	0	0
23	18795620	.	A	G	14	13	27	0	0	27	0	0
23	18795721	.	C	T	7	3	10	0	0	10	0	0
23	18801275	.	G	A	3	5	8	0	0	8	0	0
23	18944543	.	G	A	0	1	1	0	2	3	0	0
23	18947344	.	C	A	5	6	11	0	1	12	0	0
23	18947385	.	G	C	6	5	11	0	0	11	0	0
23	18950968	.	T	C	10	15	25	0	0	25	0	0
23	18950970	.	T	A	10	15	25	0	0	25	0	0
23	18951010	.	G	A	9	12	21	0	1	22	0	0
23	18954023	.	A	G	4	2	6	0	0	6	0	0
23	18954100	.	A	G	4	6	10	0	0	10	0	0
23	18954151	.	G	A	4	4	8	0	1	9	0	0
23	18954759	.	T	G	6	2	8	0	0	8	0	0
23	18979342	.	C	T	4	4	8	0	0	8	0	0
23	18979561	.	G	A	2	3	5	0	0	5	0	0
23	18986338	.	G	A	8	5	13	0	0	13	0	0
23	18986344	.	G	A	5	6	11	0	1	12	0	0
23	18990914	.	C	T	0	4	4	0	3	7	0	0
23	18993525	.	T	C	5	4	9	0	0	9	0	0
23	18996030	.	C	T	0	3	3	0	0	3	0	0
23	19003263	.	A	G	0	1	1	0	0	1	0	0
23	19005486	.	T	C	1	1	2	0	0	2	0	0
23	19198348	.	A	T	1	2	3	0	0	3	0	0
23	19198588	.	A	T	2	1	3	0	0	3	0	0
23	19200168	.	G	A	3	2	5	0	1	6	0	0
23	19201103	.	C	A	8	6	14	0	0	14	0	0
23	19201148	.	G	T	3	4	7	0	1	8	0	0
23	19206052	.	C	T	4	3	7	0	0	7	0	0
23	19474823	.	G	T	8	10	18	0	2	20	0	0
23	19577464	.	G	A	0	3	3	0	6	9	0	0
23	19582481	.	T	C	6	7	13	0	0	13	0	0
23	19582559	.	G	T	10	3	13	0	0	13	0	0
23	19582668	.	T	C	7	8	15	0	1	16	0	0
23	19582678	.	C	T	8	12	20	0	0	20	0	0
23	19583208	.	G	A	0	8	8	0	16	24	0	0
23	19583252	.	C	T	8	8	16	0	1	17	0	0
23	19603630	.	T	C	9	9	18	0	2	20	0	0
23	19603753	.	T	C	23	25	48	0	2	50	0	0
23	19603803	.	T	C	21	16	37	0	1	38	0	0
23	19603880	.	A	T	10	20	30	0	5	35	0	0
23	19603994	.	G	A	21	18	39	0	4	43	0	0
23	19604263	.	A	G	9	0	9	0	25	34	0	0
23	19604351	.	G	T	12	8	20	0	3	23	0	0
23	19672720	.	T	C	1	4	5	0	1	6	0	0
23	19673170	.	C	T	10	11	21	0	1	22	0	0
23	19673376	.	C	T	14	10	24	0	1	25	0	0
23	19680158	.	C	G	1	2	3	0	1	4	0	0
23	19712898	.	G	A	21	20	41	0	3	44	0	0
23	19713291	.	A	G	15	15	30	0	0	30	0	0
23	19713324	.	A	G	29	24	53	0	3	56	0	0
23	19808022	.	C	T	8	6	14	0	2	16	0	0
23	19808078	.	T	C	9	9	18	0	1	19	0	0
23	19808691	.	G	A	0	13	13	0	13	26	0	0
23	19821150	.	C	T	1	3	4	0	0	4	0	0
23	19821277	.	A	C	2	3	5	0	0	5	0	0
23	19821408	.	C	T	2	4	6	0	0	6	0	0
23	19821470	.	G	A	0	2	2	0	1	3	0	0
23	19821489	.	A	T	2	2	4	0	0	4	0	0
23	19821549	.	C	A	1	2	3	0	1	4	0	0
23	19825653	.	G	C	2	2	4	0	0	4	0	0
23	19835308	.	T	C	31	18	49	0	5	54	0	0
23	19836260	.	C	T	15	19	34	0	0	34	0	0
23	19837080	.	T	C	11	12	23	0	1	24	0	0
23	19837503	.	G	A	5	3	8	0	0	8	0	0
23	19838458	.	A	T	1	2	3	0	0	3	0	0
23	19838459	.	A	C	1	2	3	0	0	3	0	0
23	19893409	.	A	T	2	2	4	0	1	5	0	0
23	19969136	.	C	A	6	2	8	0	1	9	0	0
23	19969420	.	A	T	3	3	6	0	0	6	0	0
23	19969710	.	G	A	5	6	11	0	0	11	0	0
23	19981119	.	C	T	1	2	3	0	0	3	0	0
23	19981124	.	T	C	1	2	3	0	0	3	0	0
23	19981510	.	G	T	11	8	19	0	1	20	0	0
23	19981554	.	T	C	8	6	14	0	2	16	0	0
23	19981608	.	A	T	5	3	8	0	3	11	0	0
23	19985054	.	A	G	3	2	5	0	0	5	0	0
23	19985403	.	T	C	2	3	5	0	0	5	0	0
23	20113599	.	T	C	16	16	32	0	2	34	0	0
23	20113848	.	G	T	18	15	33	0	2	35	0	0
23	20114327	.	C	A	6	1	7	0	1	8	0	0
23	20117830	.	A	G	1	1	2	0	0	2	0	0
23	20117938	.	A	C	1	0	1	0	3	4	0	0
23	20121326	.	G	A	3	4	7	0	0	7	0	0
23	20139362	.	T	C	0	1	1	0	0	1	0	0
23	20145420	.	T	A	14	16	30	0	1	32	1	0
23	20145823	.	T	C	5	11	16	0	0	16	0	0
23	20146080	.	A	G	8	8	16	0	0	16	0	0
23	20152477	.	T	C	5	1	6	0	0	6	0	0
23	20152640	.	G	A	0	5	5	0	0	5	0	0
23	20931095	.	C	A	1	2	3	0	1	4	0	0
23	20931119	.	C	T	2	3	5	0	0	5	0	0
23	20936395	.	T	A	2	3	5	0	0	5	0	0
23	21276362	.	T	C	2	3	5	0	0	5	0	0
23	21277208	.	G	A	3	2	5	0	0	5	0	0
23	21277247	.	T	A	3	3	6	0	0	6	0	0
23	21363039	.	C	A	1	1	2	0	0	2	0	0
23	21364449	.	G	A	0	2	2	0	0	2	0	0
23	21364725	.	C	T	0	0	0	0	1	1	0	0
23	21366743	.	A	C	0	1	1	0	0	1	0	0
23	21367861	.	A	G	2	0	2	0	0	2	0	0
23	21367994	.	A	T	0	1	1	0	0	1	0	0
23	21368078	.	C	T	6	2	8	0	1	9	0	0
23	21368090	.	G	A	6	3	9	0	0	9	0	0
23	21368183	.	G	A	1	1	2	0	0	2	0	0
23	21369126	.	G	C	0	1	1	0	1	2	0	0
23	21369678	.	T	C	6	13	19	0	1	20	0	0
23	21369703	.	C	A	6	13	19	0	2	21	0	0
23	21369750	.	C	T	2	4	6	0	0	6	0	0
23	21371462	.	A	T	1	2	3	0	0	3	0	0
23	21376413	.	T	A	16	11	27	0	2	29	0	0
23	21376570	.	C	T	17	13	30	0	1	31	0	0
23	21376678	.	G	T	13	7	20	0	2	22	0	0
23	21376689	.	C	T	15	5	20	0	1	21	0	0
23	21376787	.	C	G	10	6	16	0	0	16	0	0
23	21452700	.	C	T	1	6	7	0	3	10	0	0
23	21488630	.	A	C	2	3	5	0	0	5	0	0
23	21489121	.	C	T	4	4	8	0	0	8	0	0
23	21489233	.	T	C	3	6	9	0	0	9	0	0
23	21489567	.	T	C	5	6	11	0	0	11	0	0
23	21490211	.	G	A	0	5	5	0	6	11	0	0
23	21661227	.	C	T	2	6	8	0	2	10	0	0
23	21661483	.	G	A	0	3	3	0	7	10	0	0
23	21721568	.	T	C	0	2	2	0	0	2	0	0
23	21721868	.	G	A	1	2	3	0	0	3	0	0
23	22051380	.	C	T	0	1	1	0	0	1	0	0
23	22054542	.	C	A	0	1	1	0	0	1	0	0
23	22060088	.	T	A	5	4	9	0	3	12	0	0
23	22064493	.	A	G	2	6	8	0	0	8	0	0
23	22067865	.	G	T	2	0	2	0	0	2	0	0
23	22496525	.	C	A	5	4	9	0	0	9	0	0
23	22496589	.	A	G	13	9	22	0	0	22	0	0
23	22496785	.	A	G	5	8	13	0	1	14	0	0
23	22497049	.	A	T	3	4	7	0	1	8	0	0
23	22497550	.	A	G	5	4	9	0	2	11	0	0
23	22635284	.	G	A	8	4	12	0	0	12	0	0
23	22635466	.	T	C	1	3	4	0	0	4	0	0
23	22635490	.	C	G	1	2	3	0	0	3	0	0
23	22667247	.	C	T	9	9	18	0	2	20	0	0
23	22674704	.	C	T	2	4	6	0	0	6	0	0
23	22677394	.	A	C	6	12	18	0	1	19	0	0
23	22677496	.	C	T	26	41	67	0	3	70	0	0
23	22677638	.	C	T	31	28	59	0	3	62	0	0
23	22922775	.	A	C	3	2	5	0	2	7	0	0
23	22922795	.	G	T	1	2	3	0	1	4	0	0
23	22923021	.	A	C	3	5	8	0	1	9	0	0
23	22923033	.	C	T	5	6	11	0	0	11	0	0
23	22923198	.	C	T	2	6	8	0	0	8	0	0
23	22923339	.	C	T	5	5	10	0	1	11	0	0
23	22923603	.	T	C	2	0	2	0	0	2	0	0
23	22925490	.	C	A	1	0	1	0	0	1	0	0
23	23122955	.	G	T	1	1	2	0	0	2	0	0
23	23123146	.	G	T	6	4	10	0	2	12	0	0
23	23126589	.	A	C	1	2	3	0	0	3	0	0
23	23136745	.	G	A	0	2	2	0	0	2	0	0
23	23154388	.	T	A	1	0	1	0	0	1	0	0
23	23210288	.	A	G	1	4	5	0	0	5	0	0
23	23210303	.	A	G	1	3	4	0	1	5	0	0
23	23212257	.	C	T	2	1	3	0	0	3	0	0
23	23212567	.	C	T	9	5	14	0	0	14	0	0
23	23213219	.	T	C	9	11	20	0	0	20	0	0
23	23213437	.	G	A	0	7	7	0	5	12	0	0
23	23213582	.	C	A	11	11	22	0	0	22	0	0
23	23213613	.	T	A	14	13	27	0	0	27	0	0
23	23213657	.	G	A	18	14	32	0	2	34	0	0
23	23213757	.	G	A	21	15	36	0	0	36	0	0
23	23213800	.	G	A	0	10	10	0	12	22	0	0
23	23213917	.	T	A	6	17	23	0	2	25	0	0
23	23213939	.	T	A	9	17	26	0	0	26	0	0
23	23214070	.	C	T	6	4	10	0	3	13	0	0
23	23214417	.	C	T	14	3	17	0	3	20	0	0
23	23399987	.	T	C	3	3	6	0	0	6	0	0
23	23891551	.	G	A	0	1	1	0	1	2	0	0
23	23903278	.	G	A	0	3	3	0	2	5	0	0
23	23903432	.	C	T	2	2	4	0	2	6	0	0
23	23912720	.	G	T	8	9	17	0	1	18	0	0
23	23912723	.	C	A	7	11	18	0	0	18	0	0
23	23912900	.	C	G	7	6	13	0	0	13	0	0
23	23913240	.	G	T	15	19	34	0	0	34	0	0
23	23913818	.	A	T	17	17	34	0	1	35	0	0
23	23913858	.	A	C	27	19	46	0	4	50	0	0
23	23914017	.	G	A	2	20	22	0	15	37	0	0
23	23914176	.	A	T	13	21	34	0	4	38	0	0
23	23983662	.	A	T	1	3	4	0	0	4	0	0
23	23983677	.	C	T	1	3	4	0	0	4	0	0
23	23995382	.	G	T	3	2	5	0	0	5	0	0
23	24112973	.	C	A	3	4	7	0	0	7	0	0
23	24170870	.	G	A	13	7	20	0	0	20	0	0
23	24202602	.	C	T	2	2	4	0	1	5	0	0
23	24202858	.	C	T	2	2	4	0	0	4	0	0
23	24227315	.	T	C	3	4	7	0	0	7	0	0
23	24227352	.	A	T	12	6	18	0	1	19	0	0
23	24227380	.	A	G	14	13	27	0	0	27	0	0
23	24227458	.	T	C	11	14	25	0	3	28	0	0
23	24227673	.	C	A	18	23	41	0	4	45	0	0
23	24228767	.	G	A	7	7	14	0	0	14	0	0
23	24229110	.	G	A	3	8	11	0	2	13	0	0
23	24231222	.	A	G	0	1	1	0	0	1	0	0
23	24233458	.	A	G	1	2	3	0	0	3	0	0
23	24233831	.	A	G	2	1	3	0	0	3	0	0
23	24238551	.	G	A	2	4	6	0	0	6	0	0
23	24240979	.	G	T	6	3	9	0	1	10	0	0
23	24243168	.	G	A	0	2	2	0	0	2	0	0
23	24300958	.	T	A	1	2	3	0	0	3	0	0
23	24439480	.	G	T	9	11	20	0	4	24	0	0
23	24439780	.	G	A	11	11	22	0	0	22	0	0
23	24442787	.	T	G	1	0	1	0	1	2	0	0
23	24443576	.	A	G	3	3	6	0	0	6	0	0
23	24444291	.	A	G	6	3	9	0	0	9	0	0
23	24444344	.	C	G	3	3	6	0	0	6	0	0
23	24445112	.	G	T	3	2	5	0	0	5	0	0
23	24445584	.	A	G	0	2	2	0	0	2	0	0
23	24445876	.	A	G	0	2	2	0	2	4	0	0
23	24508155	.	A	T	4	7	11	0	0	11	0	0
23	24595748	.	T	C	0	1	1	0	0	1	0	0
23	24599004	.	A	T	2	2	4	0	0	4	0	0
23	24600513	.	C	T	1	1	2	0	0	2	0	0
23	24600947	.	T	C	2	6	8	0	0	8	0	0
23	24604042	.	C	T	6	3	9	0	1	10	0	0
23	24604323	.	C	T	0	1	1	0	0	1	0	0
23	24605243	.	T	A	0	3	3	0	0	3	0	0
23	24608805	.	G	A	2	3	5	0	1	6	0	0
23	24608847	.	G	A	0	8	8	0	10	18	0	0
23	24669381	.	C	T	0	7	7	0	11	18	0	0
23	24669633	.	T	C	13	1	14	0	11	25	0	0
23	24693600	.	G	T	0	1	1	0	2	3	0	0
23	24693704	.	A	T	2	1	3	0	0	4	1	0
23	24694242	.	C	A	15	8	23	0	1	24	0	0
23	24694763	.	T	A	1	0	1	0	0	1	0	0
23	24749584	.	A	C	3	0	3	0	0	3	0	0
23	24750339	.	C	A	2	3	5	0	0	5	0	0
23	24803130	.	C	T	4	2	6	0	1	7	0	0
23	24934567	.	T	C	2	2	4	0	0	4	0	0
23	24934597	.	C	G	1	2	3	0	1	4	0	0
23	24938290	.	T	A	2	1	3	0	4	7	0	0
23	24960740	.	T	G	1	2	3	0	0	3	0	0
23	24960741	.	G	T	1	2	3	0	0	3	0	0
23	24965393	.	C	T	3	2	5	0	0	5	0	0
23	24965396	.	G	A	3	2	5	0	0	5	0	0
23	24968676	.	C	A	3	2	5	0	0	5	0	0
23	24970372	.	G	A	5	3	8	0	2	10	0	0
23	24970451	.	T	C	4	2	6	0	0	6	0	0
23	24970589	.	A	G	4	2	6	0	0	6	0	0
23	24970593	.	G	A	3	2	5	0	1	6	0	0
23	24973871	.	T	C	1	2	3	0	0	3	0	0
23	24984969	.	A	C	1	1	2	0	0	2	0	0
23	25757012	.	G	A	0	1	1	0	0	1	0	0
23	25767757	.	G	A	0	3	3	0	3	6	0	0
23	25768384	.	C	T	1	3	4	0	0	4	0	0
23	25796410	.	T	A	4	3	7	0	0	7	0	0
23	25797011	.	T	A	1	2	3	0	1	4	0	0
23	25797216	.	G	A	3	2	5	0	0	5	0	0
23	25871764	.	C	A	1	1	2	0	0	2	0	0
23	25873444	.	C	A	1	5	6	0	0	6	0	0
23	25874249	.	A	G	11	0	11	0	15	26	0	0
23	25874261	.	T	A	9	14	23	0	1	24	0	0
23	25874334	.	C	G	3	3	6	0	0	6	0	0
23	25874355	.	A	T	3	4	7	0	0	7	0	0
23	25874459	.	A	T	3	6	9	0	0	9	0	0
23	25874498	.	G	A	2	5	7	0	1	8	0	0
23	25874615	.	G	A	1	2	3	0	1	4	0	0
23	25879930	.	A	C	2	2	4	0	0	4	0	0
23	25930689	.	C	T	2	1	3	0	0	3	0	0
23	25942399	.	T	G	8	1	9	0	13	22	0	0
23	25942559	.	T	A	5	4	9	0	0	9	0	0
23	25946530	.	A	G	2	3	5	0	0	5	0	0
23	25946732	.	A	G	1	2	3	0	0	3	0	0
23	26063179	.	A	T	2	3	5	0	0	5	0	0
23	26063372	.	G	A	16	3	19	0	2	21	0	0
23	26063560	.	A	T	23	28	51	0	5	56	0	0
23	26063614	.	A	C	29	25	54	0	1	55	0	0
23	26063734	.	G	A	21	27	48	0	0	48	0	0
23	26063843	.	G	A	23	26	49	0	0	49	0	0
23	26063985	.	A	T	28	18	46	0	2	48	0	0
23	26064050	.	T	A	20	22	42	0	1	43	0	0
23	26064122	.	T	A	12	5	17	0	1	18	0	0
23	26064124	.	T	A	10	7	17	0	1	18	0	0
23	26064649	.	T	G	16	13	29	0	2	31	0	0
23	26064680	.	T	C	11	9	20	0	4	24	0	0
23	26064923	.	T	C	25	0	25	0	16	41	0	0
23	26064948	.	T	G	19	16	35	0	1	36	0	0
23	26064989	.	A	G	14	15	29	0	4	33	0	0
23	26065079	.	T	C	20	17	37	0	2	39	0	0
23	26088845	.	A	G	2	3	5	0	0	5	0	0
23	26093933	.	A	T	7	2	9	0	0	9	0	0
23	26094063	.	A	G	5	4	9	0	0	9	0	0
23	26094533	.	A	G	5	8	13	0	1	14	0	0
23	26094589	.	G	C	8	17	25	0	1	26	0	0
23	26094617	.	T	C	8	21	29	0	1	30	0	0
23	26094626	.	T	C	8	0	8	0	27	35	0	0
23	26094877	.	A	G	4	11	15	0	0	15	0	0
23	26094932	.	G	A	8	4	12	0	0	12	0	0
23	26094938	.	C	A	8	3	11	0	0	11	0	0
23	26095081	.	G	A	5	9	14	0	4	18	0	0
23	26095096	.	C	T	8	11	19	0	1	20	0	0
23	26095153	.	G	A	7	8	15	0	0	15	0	0
23	26095285	.	T	A	5	7	12	0	1	13	0	0
23	26095400	.	C	T	6	11	17	0	2	19	0	0
23	26095416	.	T	G	5	8	13	0	1	14	0	0
23	26110735	.	G	A	1	7	8	0	0	8	0	0
23	26111090	.	C	G	1	0	1	0	0	1	0	0
23	26187735	.	C	T	1	1	2	0	0	2	0	0
23	26232509	.	C	A	5	3	8	0	0	8	0	0
23	26504202	.	A	T	34	17	51	0	1	52	0	0
23	26504254	.	G	A	29	9	38	0	5	43	0	0
23	26504264	.	C	T	30	11	41	0	2	43	0	0
23	26507741	.	G	A	24	24	48	0	5	53	0	0
23	26509764	.	G	A	8	23	31	0	2	33	0	0
23	26522647	.	A	G	0	2	2	0	1	3	0	0
23	26522892	.	G	A	5	6	11	0	1	12	0	0
23	26763798	.	A	T	4	3	7	0	0	7	0	0
23	27003630	.	T	A	2	1	3	0	0	3	0	0
23	27003720	.	G	A	10	4	14	0	0	14	0	0
23	27003801	.	T	C	5	8	13	0	2	15	0	0
23	27004310	.	C	T	7	9	16	0	0	16	0	0
23	27004339	.	C	T	11	7	18	0	2	20	0	0
23	27004347	.	G	A	12	7	19	0	1	20	0	0
23	27004383	.	C	T	9	7	16	0	1	17	0	0
23	27004397	.	T	C	6	7	13	0	1	14	0	0
23	27004665	.	T	C	7	8	15	0	1	16	0	0
23	27005195	.	G	A	15	20	35	0	2	37	0	0
23	27052123	.	C	A	1	0	1	0	0	1	0	0
23	27052125	.	C	T	1	0	1	0	0	1	0	0
23	27054361	.	C	T	0	2	2	0	0	2	0	0
23	27059120	.	G	A	0	12	12	0	9	21	0	0
23	27059376	.	T	A	17	8	25	0	1	27	1	0
23	27059422	.	C	T	13	11	24	0	3	27	0	0
23	27059459	.	A	G	14	0	14	0	18	32	0	0
23	27059526	.	G	A	0	15	15	0	21	36	0	0
23	27251789	.	G	C	10	7	17	0	0	17	0	0
23	27251859	.	G	A	16	6	22	0	2	24	0	0
23	27251872	.	C	T	1	9	10	0	15	25	0	0
23	27252425	.	G	A	5	13	18	0	1	19	0	0
23	27252833	.	A	G	4	4	8	0	1	9	0	0
23	27279476	.	G	A	1	3	4	0	1	5	0	0
23	27358990	.	A	T	5	8	13	0	2	15	0	0
23	27359203	.	A	G	11	12	23	0	1	24	0	0
23	27359410	.	G	A	8	5	13	0	2	15	0	0
23	27359526	.	T	C	3	9	12	0	0	12	0	0
23	27359755	.	C	T	0	3	3	0	5	8	0	0
23	27359825	.	C	A	10	3	13	0	0	13	0	0
23	27359867	.	A	C	2	5	7	0	1	8	0	0
23	27360007	.	G	A	1	8	9	0	0	9	0	0
23	27361210	.	A	T	0	2	2	0	0	2	0	0
23	27361216	.	G	A	0	2	2	0	0	2	0	0
23	27364018	.	C	T	2	2	4	0	1	5	0	0
23	27497757	.	G	A	2	2	4	0	0	4	0	0
23	27497811	.	T	A	1	2	3	0	0	3	0	0
23	27497960	.	A	T	12	7	19	0	0	19	0	0
23	27498027	.	A	T	11	11	22	0	0	22	0	0
23	27498040	.	C	G	11	12	23	0	0	23	0	0
23	27498195	.	A	T	17	7	24	0	3	27	0	0
23	27498441	.	A	T	7	2	9	0	2	11	0	0
23	27498798	.	C	T	0	16	16	0	12	28	0	0
23	27499096	.	G	A	8	7	15	0	0	15	0	0
23	27499195	.	A	T	7	11	18	0	1	19	0	0
23	27499246	.	G	A	3	6	9	0	0	9	0	0
23	27499306	.	C	T	3	4	7	0	0	7	0	0
23	27513952	.	A	G	1	1	2	0	0	2	0	0
23	27515931	.	G	A	1	0	1	0	0	1	0	0
23	27591834	.	C	T	7	3	10	0	1	11	0	0
23	27591859	.	C	T	5	5	10	0	0	10	0	0
23	27591939	.	A	G	2	8	10	0	0	10	0	0
23	27592411	.	A	C	3	5	8	0	0	8	0	0
23	27592796	.	T	C	3	0	3	0	5	8	0	0
23	27599110	.	A	C	0	2	2	0	0	2	0	0
23	27622036	.	T	A	12	16	28	0	1	29	0	0
23	27622212	.	C	A	4	9	13	0	0	13	0	0
23	27622258	.	T	C	12	7	19	0	0	19	0	0
23	27622324	.	T	C	6	8	14	0	0	14	0	0
23	27677263	.	G	A	23	16	39	0	3	42	0	0
23	27677278	.	G	A	12	18	30	0	4	34	0	0
23	27788768	.	G	A	2	3	5	0	0	5	0	0
23	27793510	.	T	C	4	3	7	0	0	7	0	0
23	27800681	.	G	T	4	6	10	0	1	11	0	0
23	27800954	.	A	C	10	9	19	0	0	19	0	0
23	27800977	.	C	T	10	9	19	0	0	19	0	0
23	27801104	.	T	C	8	3	11	0	0	11	0	0
23	27801237	.	T	C	9	8	17	0	2	19	0	0
23	27801268	.	C	A	13	10	23	0	2	25	0	0
23	27801629	.	C	T	4	3	7	0	0	7	0	0
23	27801849	.	G	A	5	4	9	0	0	9	0	0
23	27807294	.	A	G	1	3	4	0	0	4	0	0
23	28023784	.	T	C	8	10	18	0	4	22	0	0
23	28131285	.	C	T	1	3	4	0	0	4	0	0
23	28131320	.	G	A	1	2	3	0	0	3	0	0
23	28136167	.	G	T	4	4	8	0	0	8	0	0
23	28139515	.	C	T	2	6	8	0	1	9	0	0
23	28139564	.	A	G	1	12	13	0	0	13	0	0
23	28139633	.	T	C	2	6	8	0	1	9	0	0
23	28374570	.	G	A	7	3	10	0	1	11	0	0
23	28374711	.	C	A	5	7	12	0	1	13	0	0
23	28374756	.	A	G	5	4	9	0	0	9	0	0
23	28382953	.	C	T	7	6	13	0	0	13	0	0
23	28388013	.	C	A	13	12	25	0	5	30	0	0
23	28388318	.	C	T	20	25	45	0	0	45	0	0
23	28388325	.	T	C	19	22	41	0	3	44	0	0
23	28541683	.	G	T	1	2	3	0	0	3	0	0
23	28561502	.	C	A	9	9	18	0	2	20	0	0
23	28561836	.	C	T	2	6	8	0	0	8	0	0
23	28564191	.	C	A	10	12	22	0	2	24	0	0
23	28681558	.	G	C	6	5	11	0	0	11	0	0
23	28681559	.	C	A	6	5	11	0	0	11	0	0
23	28681723	.	T	A	7	4	11	0	0	11	0	0
23	28687561	.	C	T	0	2	2	0	0	2	0	0
23	28687637	.	G	T	6	3	9	0	0	9	0	0
23	28710429	.	T	C	1	2	3	0	0	3	0	0
23	28725847	.	A	G	1	2	3	0	1	4	0	0
23	28726521	.	A	G	5	4	9	0	0	9	0	0
23	28726634	.	A	C	7	10	17	0	1	18	0	0
23	28726985	.	A	T	3	3	6	0	0	6	0	0
23	28731489	.	A	C	12	15	27	0	4	31	0	0
23	28731499	.	C	T	14	14	28	0	1	29	0	0
23	28731834	.	C	T	19	25	44	0	3	47	0	0
23	28731914	.	T	C	39	17	56	0	2	58	0	0
23	28803167	.	A	G	5	5	10	0	1	11	0	0
23	28803302	.	T	C	8	7	15	0	1	16	0	0
23	28803305	.	C	T	8	7	15	0	0	15	0	0
23	28803343	.	T	C	3	3	6	0	0	6	0	0
23	28806278	.	A	G	2	2	4	0	0	4	0	0
23	28923717	.	T	A	2	1	3	0	1	4	0	0
23	28923962	.	A	G	3	2	5	0	0	5	0	0
23	28924117	.	G	C	1	2	3	0	0	3	0	0
23	28924399	.	C	G	2	3	5	0	0	5	0	0
23	28924672	.	C	T	0	5	5	0	1	6	0	0
23	28925275	.	T	C	5	6	11	0	1	12	0	0
23	28925354	.	T	C	3	11	14	0	0	14	0	0
23	28925441	.	G	A	3	8	11	0	0	11	0	0
23	28925451	.	A	T	5	7	12	0	2	14	0	0
23	28925620	.	A	G	0	3	3	0	0	3	0	0
23	29358241	.	G	A	0	4	4	0	10	14	0	0
23	29359664	.	T	A	4	2	6	0	1	7	0	0
23	29360407	.	G	T	0	8	8	0	7	15	0	0
23	29360687	.	G	T	3	3	6	0	0	6	0	0
23	29360707	.	G	T	3	4	7	0	0	7	0	0
23	29361357	.	C	A	11	17	28	0	2	30	0	0
23	29361365	.	A	C	12	17	29	0	0	29	0	0
23	29361557	.	A	T	8	5	13	0	0	13	0	0
23	29376410	.	C	T	4	3	7	0	0	7	0	0
23	29381612	.	C	A	11	7	18	0	1	19	0	0
23	29396452	.	C	T	2	24	26	0	31	57	0	0
23	29397116	.	C	G	17	13	30	0	6	36	0	0
23	29397230	.	T	A	19	23	42	0	0	42	0	0
23	29397501	.	C	T	12	13	25	0	6	31	0	0
23	29397506	.	T	G	14	17	31	0	1	32	0	0
23	29397563	.	C	T	0	16	16	0	12	28	0	0
23	29397665	.	T	G	9	12	21	0	0	21	0	0
23	29397816	.	G	A	14	10	24	0	2	26	0	0
23	29397907	.	T	C	24	14	38	0	0	38	0	0
23	29398065	.	T	C	12	9	21	0	1	22	0	0
23	29398544	.	C	A	0	5	5	0	7	12	0	0
23	29398548	.	A	G	7	5	12	0	0	12	0	0
23	29403306	.	T	G	2	2	4	0	0	4	0	0
23	29403437	.	G	A	0	2	2	0	0	2	0	0
23	29403491	.	C	A	1	2	3	0	0	3	0	0
23	29403515	.	A	C	0	1	1	0	0	1	0	0
23	29405829	.	A	G	2	2	4	0	0	4	0	0
23	29412411	.	A	G	4	2	6	0	0	6	0	0
23	29432040	.	A	G	0	2	2	0	0	2	0	0
23	29432055	.	G	A	0	2	2	0	0	2	0	0
23	29507723	.	A	T	16	15	31	0	0	32	1	0
23	29507825	.	T	C	10	0	10	0	13	23	0	0
23	29507859	.	T	G	7	12	19	0	2	21	0	0
23	29507883	.	G	A	7	11	18	0	2	20	0	0
23	29508247	.	G	C	2	1	3	0	8	11	0	0
23	29516726	.	T	C	3	3	6	0	0	6	0	0
23	29519565	.	G	A	1	0	1	0	0	1	0	0
23	29519769	.	G	C	1	4	5	0	0	5	0	0
23	29523602	.	G	A	0	1	1	0	0	1	0	0
23	29570627	.	C	G	1	3	4	0	0	4	0	0
23	29574311	.	C	G	1	2	3	0	0	3	0	0
23	29582416	.	T	C	9	23	32	0	4	36	0	0
23	29582420	.	T	C	9	27	36	0	1	37	0	0
23	29582634	.	C	A	24	14	38	0	1	39	0	0
23	29582673	.	A	G	24	13	37	0	3	40	0	0
23	29583417	.	T	A	9	10	19	0	3	22	0	0
23	29583708	.	G	A	13	14	27	0	2	29	0	0
23	29583814	.	T	A	16	18	34	0	0	34	0	0
23	29583882	.	A	G	19	20	39	0	2	41	0	0
23	29583960	.	G	A	18	8	26	0	2	28	0	0
23	29586380	.	G	A	4	6	10	0	0	10	0	0
23	29589392	.	A	G	1	8	9	0	0	9	0	0
23	29592708	.	G	A	2	3	5	0	0	5	0	0
23	29592741	.	C	T	0	4	4	0	0	4	0	0
23	29601269	.	C	T	0	1	1	0	0	1	0	0
23	29711788	.	G	A	15	14	29	0	2	31	0	0
23	29711911	.	C	T	15	16	31	0	1	32	0	0
23	29711998	.	G	A	16	14	30	0	2	33	1	0
23	29712140	.	G	A	6	7	13	0	0	13	0	0
23	29712465	.	G	A	9	9	18	0	1	19	0	0
23	29712493	.	C	T	0	6	6	0	7	13	0	0
23	29712670	.	G	A	9	2	11	0	1	12	0	0
23	29712922	.	C	A	2	6	8	0	1	9	0	0
23	29756865	.	A	T	9	5	14	0	2	16	0	0
23	29757038	.	G	A	5	8	13	0	1	14	0	0
23	29757099	.	A	T	2	4	6	0	0	6	0	0
23	29758088	.	A	G	3	6	9	0	1	10	0	0
23	29829115	.	A	G	0	1	1	0	0	1	0	0
23	29840274	.	C	A	2	1	3	0	1	4	0	0
23	29841374	.	T	C	9	4	13	0	0	13	0	0
23	29843067	.	A	T	1	2	3	0	0	3	0	0
23	29861645	.	A	T	5	8	13	0	0	13	0	0
23	29861973	.	A	G	11	15	26	0	0	26	0	0
23	29861976	.	T	C	12	0	12	0	13	25	0	0
23	29886897	.	G	C	13	11	24	0	1	25	0	0
23	29886937	.	T	A	13	12	25	0	0	25	0	0
23	30061605	.	A	C	24	6	30	0	3	33	0	0
23	30061763	.	C	T	0	22	22	0	24	46	0	0
23	30061804	.	A	C	13	26	39	0	1	41	1	0
23	30061960	.	T	C	16	1	17	0	24	41	0	0
23	30062364	.	T	A	11	17	28	0	1	29	0	0
23	30062792	.	C	T	6	9	15	0	1	16	0	0
23	30062888	.	C	T	0	6	6	0	6	12	0	0
23	30063216	.	T	C	2	0	2	0	7	9	0	0
23	30063217	.	T	G	2	6	8	0	1	9	0	0
23	30063527	.	G	A	3	3	6	0	0	6	0	0
23	30063578	.	A	G	3	5	8	0	0	8	0	0
23	30064743	.	C	A	4	2	6	0	0	6	0	0
23	30718514	.	T	A	5	2	7	0	0	7	0	0
23	30724698	.	T	A	4	4	8	0	1	9	0	0
23	30724828	.	G	C	2	3	5	0	0	5	0	0
23	30750183	.	G	A	0	4	4	0	2	6	0	0
23	30750402	.	C	A	2	4	6	0	0	6	0	0
23	30752095	.	C	A	18	16	34	0	1	35	0	0
23	30752233	.	T	G	4	4	8	1	0	9	0	0
23	30752352	.	A	T	10	8	18	0	0	18	0	0
23	30761144	.	G	A	0	3	3	0	0	3	0	0
23	30770193	.	A	G	3	3	6	0	0	6	0	0
23	30772902	.	C	T	2	0	2	0	1	3	0	0
23	30775273	.	T	C	1	2	3	0	0	3	0	0
23	31248605	.	A	T	1	3	4	0	1	5	0	0
23	31358342	.	A	T	13	24	37	0	2	39	0	0
23	31358344	.	A	T	13	25	38	0	1	39	0	0
23	31358489	.	T	G	26	21	47	0	2	49	0	0
23	31358631	.	G	A	26	28	54	0	3	57	0	0
23	31381425	.	C	T	1	2	3	0	0	3	0	0
23	31405570	.	A	C	1	3	4	0	0	4	0	0
23	31422768	.	A	G	3	2	5	0	2	7	0	0
23	31423091	.	T	C	2	4	6	0	1	7	0	0
23	31423145	.	G	A	0	4	4	0	11	15	0	0
23	31423392	.	C	A	11	9	20	0	3	23	0	0
23	31423427	.	A	G	16	1	17	0	18	35	0	0
23	31423432	.	C	A	14	15	29	0	4	33	0	0
23	31432102	.	A	G	4	0	4	0	11	15	0	0
23	31604900	.	C	T	7	8	15	0	1	16	0	0
23	31604912	.	G	T	7	8	15	0	0	15	0	0
23	31640363	.	A	G	3	2	5	0	0	5	0	0
23	31641153	.	C	A	14	13	27	0	5	32	0	0
23	31641197	.	A	G	14	15	29	0	2	31	0	0
23	31641270	.	G	A	16	18	34	0	1	35	0	0
23	31643818	.	A	G	3	6	9	0	0	10	1	0
23	31644368	.	A	G	3	3	6	0	0	6	0	0
23	31644602	.	T	G	2	2	4	0	0	4	0	0
23	31684352	.	G	A	1	2	3	0	1	4	0	0
23	31752909	.	A	G	1	5	6	0	2	8	0	0
23	31756210	.	G	A	1	4	5	0	0	5	0	0
23	31756216	.	C	T	0	4	4	0	1	5	0	0
23	31768596	.	T	C	6	6	12	0	0	12	0	0
23	31771282	.	T	C	0	1	1	0	0	1	0	0
23	31940681	.	C	A	3	2	5	0	0	5	0	0
23	31940775	.	T	A	3	5	8	0	0	8	0	0
23	31940776	.	A	G	2	5	7	0	1	8	0	0
23	31940818	.	C	T	3	2	5	0	1	6	0	0
23	31953518	.	C	T	4	3	7	0	0	7	0	0
23	31953537	.	A	C	4	2	6	0	0	6	0	0
23	31962971	.	T	C	8	6	14	0	1	15	0	0
23	31963226	.	C	T	6	6	12	0	0	12	0	0
23	31963360	.	A	G	1	3	4	0	0	4	0	0
23	31964680	.	C	T	1	1	2	0	0	2	0	0
23	31997582	.	G	A	2	2	4	0	0	4	0	0
23	32003354	.	T	A	4	5	9	0	1	10	0	0
23	32003808	.	T	C	2	4	6	0	1	7	0	0
23	32003820	.	G	T	2	3	5	0	0	5	0	0
23	32007376	.	T	G	8	5	13	0	0	13	0	0
23	32007445	.	T	A	8	8	16	0	0	16	0	0
23	32007520	.	T	C	5	7	12	0	1	13	0	0
23	32007526	.	C	G	5	9	14	0	0	14	0	0
23	32017734	.	T	G	2	1	3	0	1	4	0	0
23	32017766	.	A	G	2	2	4	0	0	4	0	0
23	32026927	.	T	C	1	3	4	0	1	5	0	0
23	32026978	.	C	T	3	4	7	0	1	8	0	0
23	32026996	.	G	A	0	1	1	0	2	4	1	0
23	32081708	.	C	T	1	2	3	0	0	3	0	0
23	32081717	.	T	C	1	2	3	0	0	3	0	0
23	32128785	.	T	A	2	4	6	0	0	6	0	0
23	32128799	.	G	A	2	5	7	0	0	7	0	0
23	32129476	.	G	T	0	1	1	0	0	1	0	0
23	32151669	.	A	C	18	15	33	0	2	35	0	0
23	32152022	.	C	T	7	12	19	0	0	19	0	0
23	32154021	.	G	T	1	1	2	0	0	2	0	0
23	32155975	.	C	T	2	4	6	0	0	6	0	0
23	32200517	.	C	A	3	2	5	0	1	6	0	0
23	32239474	.	A	G	3	5	8	0	0	8	0	0
23	32239672	.	G	A	13	3	16	0	0	16	0	0
23	32239688	.	C	A	13	4	17	0	0	17	0	0
23	32239708	.	G	A	14	5	19	0	1	20	0	0
23	32239824	.	G	A	7	8	15	0	2	17	0	0
23	32240258	.	C	T	3	2	5	0	0	5	0	0
23	32240290	.	A	G	2	4	6	0	0	6	0	0
23	32242086	.	C	A	1	1	2	0	0	2	0	0
23	32309187	.	T	C	8	20	28	0	2	30	0	0
23	32309193	.	G	A	8	17	25	0	2	27	0	0
23	32309323	.	G	A	12	15	27	0	2	29	0	0
23	32309533	.	A	G	8	10	18	0	0	18	0	0
23	32309600	.	T	A	11	4	15	0	1	16	0	0
23	32309659	.	C	A	0	8	8	0	9	17	0	0
23	32309709	.	G	A	5	7	12	0	0	12	0	0
23	32309787	.	A	C	7	6	13	0	4	17	0	0
23	32309846	.	T	A	4	4	8	0	3	11	0	0
23	32309860	.	C	T	2	4	6	0	1	7	0	0
23	32310293	.	C	A	4	2	6	0	0	6	0	0
23	32310301	.	T	A	1	2	3	0	1	4	0	0
23	32311555	.	G	C	8	4	12	0	0	12	0	0
23	32311612	.	G	A	6	2	8	0	0	8	0	0
23	32318047	.	A	G	2	2	4	0	0	4	0	0
23	33447740	.	A	T	2	5	7	0	0	7	0	0
23	33447741	.	T	G	1	4	5	0	2	7	0	0
23	33657205	.	A	G	10	26	36	0	4	40	0	0
23	33657451	.	A	G	16	20	36	0	0	36	0	0
23	33658013	.	T	G	4	4	8	0	0	8	0	0
23	33658031	.	A	C	4	4	8	0	1	9	0	0
23	33658052	.	G	A	4	4	8	0	0	8	0	0
23	33663285	.	C	T	3	1	4	0	0	4	0	0
23	33664546	.	C	T	2	2	4	0	0	4	0	0
23	34753803	.	A	G	3	3	6	0	0	6	0	0
23	35027189	.	T	C	3	2	5	0	0	5	0	0
23	35027480	.	T	G	6	5	11	0	0	11	0	0
23	35027518	.	T	A	4	3	7	0	2	9	0	0
23	35027541	.	A	G	3	2	5	0	2	7	0	0
23	35362951	.	C	T	7	13	20	0	0	20	0	0
23	35362973	.	G	T	8	9	17	0	1	18	0	0
23	35363024	.	A	T	8	6	14	0	4	18	0	0
23	35363067	.	A	T	3	7	10	0	4	14	0	0
23	35363106	.	G	A	6	15	21	0	0	21	0	0
23	35363111	.	C	G	7	15	22	0	0	22	0	0
23	35363182	.	G	T	17	15	32	0	0	32	0	0
23	35363185	.	T	A	15	14	29	0	3	32	0	0
23	35363341	.	A	G	14	7	21	0	0	21	0	0
23	35369733	.	G	A	3	1	4	0	0	4	0	0
23	35469135	.	T	C	4	5	9	0	0	9	0	0
23	35469136	.	G	A	3	4	7	0	2	9	0	0
23	35469479	.	A	G	3	7	10	0	2	12	0	0
23	35469668	.	G	T	6	6	12	0	1	13	0	0
23	35537291	.	T	A	8	2	10	0	1	11	0	0
23	35537293	.	A	G	8	1	9	0	2	11	0	0
23	35537390	.	C	T	12	5	17	0	3	20	0	0
23	35537599	.	G	A	9	14	23	0	6	29	0	0
23	35537617	.	G	A	9	12	21	0	2	23	0	0
23	35537693	.	A	C	6	5	11	0	0	11	0	0
23	35642195	.	C	T	5	8	13	0	0	13	0	0
23	35642327	.	T	G	6	7	13	0	1	14	0	0
23	35691989	.	G	A	0	0	0	1	0	1	0	0
23	35709839	.	T	C	15	17	32	0	1	33	0	0
23	35709857	.	C	T	16	7	23	0	4	27	0	0
23	35710179	.	A	C	14	16	30	2	2	35	1	0
23	35710620	.	A	C	29	30	59	2	3	64	0	0
23	35714883	.	T	C	0	2	2	0	0	2	0	0
23	35782311	.	T	C	3	2	5	0	0	5	0	0
23	35787110	.	T	A	4	2	6	0	0	6	0	0
23	35787449	.	A	G	2	2	4	0	0	4	0	0
23	35787573	.	A	G	3	2	5	0	0	5	0	0
23	35788256	.	G	A	4	2	6	0	0	6	0	0
23	35788328	.	G	A	5	4	9	0	0	9	0	0
23	35800550	.	C	T	0	2	2	0	4	6	0	0
23	35960683	.	G	A	0	3	3	0	0	3	0	0
23	35982441	.	A	G	5	5	10	0	1	11	0	0
23	35982533	.	G	A	5	6	11	0	1	12	0	0
23	35982637	.	G	A	4	3	7	0	1	8	0	0
23	35982726	.	C	G	2	2	4	0	0	4	0	0
23	35983029	.	A	G	3	6	9	0	0	9	0	0
23	35993540	.	T	A	0	2	2	0	1	3	0	0
23	36297367	.	C	T	0	3	3	0	0	3	0	0
23	36297471	.	C	T	2	7	9	0	1	10	0	0
23	36297916	.	C	T	4	1	5	0	2	7	0	0
23	36298320	.	T	A	14	15	29	0	2	31	0	0
23	36298327	.	A	T	17	14	31	0	1	32	0	0
23	36298375	.	T	C	13	18	31	0	2	33	0	0
23	36298719	.	G	A	8	14	22	0	1	23	0	0
23	36301544	.	G	A	2	3	5	0	0	5	0	0
23	36301679	.	A	G	4	4	8	0	2	10	0	0
23	36307656	.	A	T	14	12	26	0	2	28	0	0
23	36307779	.	C	T	2	1	3	0	1	4	0	0
23	36307906	.	C	G	2	0	2	0	0	2	0	0
23	36310375	.	C	T	0	2	2	0	0	2	0	0
23	36343467	.	T	C	3	3	6	0	0	6	0	0
23	36353698	.	A	G	12	10	22	0	3	25	0	0
23	36353869	.	C	G	10	16	26	0	1	27	0	0
23	36353876	.	G	T	0	11	11	0	18	29	0	0
23	36353979	.	G	T	0	3	3	0	19	22	0	0
23	36401591	.	T	C	1	3	4	0	0	4	0	0
23	36401844	.	A	G	4	4	8	0	0	8	0	0
23	36401926	.	T	C	6	8	14	0	0	14	0	0
23	36401930	.	A	G	6	6	12	0	1	13	0	0
23	36401986	.	G	C	3	6	9	0	0	9	0	0
23	36404967	.	A	G	1	1	2	0	1	3	0	0
23	36443511	.	A	T	6	4	10	0	2	12	0	0
23	36445967	.	C	G	1	1	2	0	0	2	0	0
23	36446023	.	G	A	1	3	4	0	0	4	0	0
23	36446132	.	A	G	2	2	4	0	0	4	0	0
23	36487865	.	C	T	2	3	5	0	0	5	0	0
23	36487925	.	A	T	2	2	4	0	0	4	0	0
23	36491169	.	C	G	0	5	5	0	3	8	0	0
23	36627793	.	C	T	5	5	10	0	1	11	0	0
23	36638542	.	G	A	3	2	5	0	0	5	0	0
23	36644423	.	T	G	15	18	33	0	1	34	0	0
23	36644907	.	C	T	18	13	31	0	3	34	0	0
23	36661216	.	T	C	2	2	4	0	0	4	0	0
23	36662273	.	G	A	2	2	4	0	1	5	0	0
23	36662327	.	T	A	1	2	3	0	0	3	0	0
23	36662400	.	A	G	1	2	3	0	0	3	0	0
23	36662449	.	A	C	4	3	7	0	0	7	0	0
23	36663407	.	G	A	1	3	4	0	0	4	0	0
23	36679751	.	C	T	12	21	33	0	2	35	0	0
23	36679829	.	G	C	14	0	14	0	25	39	0	0
23	36679874	.	T	C	8	0	8	0	10	18	0	0
23	36681545	.	C	T	0	3	3	0	2	5	0	0
23	36681557	.	A	G	1	5	6	0	1	7	0	0
23	36681927	.	T	C	0	0	0	0	2	2	0	0
23	36683801	.	G	A	3	4	7	0	1	8	0	0
23	36689677	.	C	T	5	3	8	0	0	8	0	0
23	36690595	.	G	A	5	3	8	0	1	9	0	0
23	36690641	.	T	A	7	6	13	0	2	15	0	0
23	36700836	.	T	G	0	0	0	0	1	1	0	0
23	36700891	.	G	A	1	3	4	0	0	4	0	0
23	36700896	.	T	A	1	3	4	0	0	4	0	0
23	36749380	.	G	A	0	16	16	0	11	27	0	0
23	36750005	.	C	G	11	14	25	0	0	25	0	0
23	36753191	.	A	G	2	0	2	0	3	6	1	0
23	36772018	.	G	A	0	7	7	0	7	14	0	0
23	36798184	.	C	T	9	14	23	0	0	23	0	0
23	36798220	.	G	A	12	13	25	0	2	27	0	0
23	36798612	.	G	A	0	6	6	0	15	21	0	0
23	36816698	.	G	T	1	2	3	0	1	4	0	0
23	37089162	.	C	T	3	2	5	0	2	7	0	0
23	37089192	.	C	T	2	3	5	0	0	5	0	0
23	37089568	.	C	T	4	2	6	0	0	6	0	0
23	37089609	.	T	G	3	4	7	0	1	8	0	0
23	37089852	.	A	T	8	8	16	0	1	17	0	0
23	37090003	.	T	C	3	7	10	0	0	10	0	0
23	37277157	.	A	G	4	2	6	0	0	6	0	0
23	37277289	.	G	A	0	0	0	0	1	1	0	0
23	37280658	.	C	T	0	1	1	0	0	1	0	0
23	37324009	.	A	G	2	0	2	0	2	4	0	0
23	37324638	.	A	C	10	3	13	0	0	13	0	0
23	37324848	.	G	A	9	6	15	0	1	16	0	0
23	37324868	.	G	C	9	3	12	0	1	13	0	0
23	37324990	.	A	G	12	10	22	0	1	23	0	0
23	37325026	.	C	T	16	10	26	0	3	29	0	0
23	37325570	.	A	C	19	16	35	0	4	39	0	0
23	37325817	.	T	G	11	17	28	0	1	29	0	0
23	37458748	.	G	A	1	1	2	0	0	2	0	0
23	37458791	.	A	T	0	1	1	0	0	1	0	0
23	37464661	.	T	A	1	1	2	0	0	2	0	0
23	37465007	.	T	C	1	2	3	0	0	3	0	0
23	37465276	.	A	T	3	3	6	0	0	6	0	0
23	37469842	.	C	T	1	2	3	0	0	3	0	0
23	37469845	.	C	G	1	2	3	0	0	3	0	0
23	37478227	.	G	T	1	2	3	0	0	3	0	0
23	38151520	.	C	T	12	6	18	0	2	20	0	0
23	38379786	.	C	T	1	12	13	0	10	24	1	0
23	38380005	.	C	T	9	13	22	0	0	22	0	0
23	38380047	.	G	A	6	8	14	0	2	16	0	0
23	38381281	.	T	C	2	2	4	0	0	4	0	0
23	38817745	.	G	A	1	2	3	0	0	3	0	0
23	38818001	.	G	A	2	2	4	0	0	4	0	0
23	38818004	.	G	A	2	2	4	0	0	4	0	0
23	38818067	.	A	T	2	2	4	0	0	4	0	0
23	38818094	.	G	A	2	2	4	0	0	4	0	0
23	39596776	.	T	C	1	2	3	0	0	3	0	0
23	39597119	.	G	T	3	2	5	0	0	5	0	0
23	39597309	.	G	A	0	4	4	0	5	9	0	0
23	39597566	.	T	C	4	5	9	0	0	9	0	0
23	39607439	.	A	G	2	6	8	0	2	10	0	0
23	39615689	.	G	C	0	2	2	0	0	2	0	0
23	39615706	.	C	A	1	2	3	0	0	3	0	0
23	39621173	.	G	C	0	1	1	0	0	1	0	0
23	39623042	.	G	A	0	3	3	0	3	6	0	0
23	39626230	.	G	C	6	7	13	0	1	14	0	0
23	39626311	.	C	T	7	8	15	0	0	15	0	0
23	39626395	.	C	T	7	5	12	0	1	13	0	0
23	39626525	.	G	A	6	7	13	0	1	14	0	0
23	39626554	.	G	A	4	4	8	0	1	9	0	0
23	39632901	.	A	G	5	6	11	0	2	13	0	0
23	39633114	.	C	T	1	6	7	0	3	10	0	0
23	39635959	.	C	T	0	0	0	0	1	1	0	0
23	39636079	.	G	T	5	3	8	0	1	9	0	0
23	39636181	.	C	T	2	2	4	0	0	4	0	0
23	39744788	.	T	A	7	0	7	0	1	8	0	0
23	39744943	.	A	T	10	9	19	0	1	20	0	0
23	39756650	.	G	A	5	3	8	0	0	8	0	0
23	39756666	.	A	G	4	8	12	0	0	12	0	0
23	39756775	.	T	G	11	11	22	0	1	23	0	0
23	39756887	.	T	C	10	7	17	0	0	17	0	0
23	39756958	.	A	G	4	12	16	0	0	16	0	0
23	39757017	.	A	G	3	5	8	0	1	9	0	0
23	39767894	.	A	G	2	3	5	0	0	5	0	0
23	39808332	.	G	A	24	5	29	0	2	31	0	0
23	39808337	.	G	C	25	5	30	0	0	30	0	0
23	39808439	.	A	G	21	18	39	0	2	41	0	0
23	39808644	.	A	C	24	10	34	0	1	35	0	0
23	39808705	.	A	G	13	11	24	0	1	25	0	0
23	39808818	.	T	G	12	0	12	0	0	12	0	0
23	39809381	.	A	T	7	5	12	5	0	17	0	0
23	39809437	.	A	G	5	5	10	0	1	11	0	0
23	39809454	.	T	G	3	2	5	0	0	5	0	0
23	39809876	.	C	T	0	8	8	0	6	14	0	0
23	39811187	.	C	T	0	2	2	0	3	5	0	0
23	39811191	.	C	A	3	3	6	0	0	6	0	0
23	39811242	.	T	C	3	5	8	0	0	8	0	0
23	39811269	.	T	A	2	4	6	0	0	6	0	0
23	39811324	.	A	G	1	4	5	0	0	5	0	0
23	39811548	.	A	G	1	2	3	0	0	3	0	0
23	39811587	.	G	A	1	1	2	0	0	2	0	0
23	39811741	.	G	A	2	5	7	0	0	7	0	0
23	39812003	.	A	G	4	3	7	0	0	7	0	0
23	39812131	.	T	C	4	2	6	0	1	7	0	0
23	39812142	.	C	G	4	3	7	0	0	7	0	0
23	39812633	.	A	T	4	8	12	0	1	13	0	0
23	39812643	.	C	T	0	8	8	0	4	12	0	0
23	40189411	.	T	A	0	3	3	0	1	4	0	0
23	40526760	.	G	A	3	3	6	0	0	6	0	0
23	40528019	.	C	T	1	2	3	0	0	3	0	0
23	42289260	.	C	A	2	3	5	0	0	5	0	0
23	42330063	.	C	T	1	4	5	0	0	5	0	0
23	42330090	.	C	G	2	5	7	0	0	7	0	0
23	42330213	.	A	T	2	3	5	0	0	5	0	0
23	42330330	.	T	A	5	4	9	0	0	9	0	0
23	42330334	.	G	T	5	4	9	0	0	9	0	0
23	42372294	.	A	C	1	2	3	0	1	4	0	0
23	42641879	.	T	C	3	3	6	0	0	6	0	0
23	42641921	.	T	C	4	2	6	0	0	6	0	0
23	42642044	.	G	A	6	3	9	0	1	10	0	0
23	42642593	.	T	G	4	3	7	0	0	7	0	0
23	42642623	.	C	A	4	2	6	0	1	7	0	0
23	42642629	.	T	G	3	3	6	0	0	6	0	0
23	42642659	.	T	G	7	1	8	0	2	10	0	0
23	42642780	.	G	T	6	5	11	0	1	12	0	0
23	43650505	.	T	A	1	2	3	0	0	3	0	0
23	43652261	.	A	G	4	4	8	0	0	8	0	0
23	43652912	.	G	T	0	2	2	0	4	6	0	0
23	43690394	.	A	G	0	2	2	0	0	2	0	0
23	43690506	.	C	A	2	3	5	0	0	5	0	0
23	43690715	.	T	C	3	3	6	0	0	6	0	0
23	43691045	.	T	C	3	2	5	0	1	6	0	0
23	43691069	.	G	A	1	4	5	0	0	5	0	0
23	43691117	.	T	G	1	2	3	0	0	3	0	0
23	43691595	.	A	G	0	2	2	0	1	3	0	0
23	43691810	.	A	T	2	2	4	0	0	4	0	0
23	43695927	.	C	A	1	11	12	0	9	21	0	0
23	43696095	.	G	A	21	11	32	0	3	35	0	0
23	43696211	.	G	T	17	19	36	0	4	40	0	0
23	43696355	.	G	A	10	17	27	0	0	27	0	0
23	43699846	.	A	G	7	12	19	0	1	20	0	0
23	43700064	.	T	C	4	0	4	0	8	12	0	0
23	43700114	.	G	A	2	7	9	0	0	9	0	0
23	43700121	.	G	A	2	6	8	0	0	8	0	0
23	43705961	.	G	T	1	8	9	0	1	10	0	0
23	43706003	.	A	G	4	13	17	0	0	17	0	0
23	43706102	.	T	G	0	9	9	0	0	9	0	0
23	43718169	.	T	A	1	3	4	0	0	4	0	0
23	43718185	.	T	A	1	3	4	0	0	4	0	0
23	43723615	.	G	A	2	1	3	0	0	3	0	0
23	43723633	.	C	T	2	2	4	0	0	4	0	0
23	43723765	.	C	T	3	8	11	0	0	11	0	0
23	43770319	.	T	G	1	2	3	0	0	3	0	0
23	43784985	.	C	T	4	9	13	0	0	13	0	0
23	43800723	.	G	A	0	2	2	0	1	3	0	0
23	43800968	.	T	G	1	1	2	0	1	3	0	0
23	43801090	.	A	C	2	2	4	0	0	4	0	0
23	43802158	.	A	T	4	2	6	0	1	7	0	0
23	43830185	.	T	C	1	4	5	0	0	5	0	0
23	44092766	.	C	T	1	0	1	0	0	1	0	0
23	44236502	.	T	C	3	2	5	0	0	5	0	0
23	44521330	.	A	G	4	7	11	0	1	12	0	0
23	44713115	.	C	T	0	3	3	0	2	5	0	0
23	45423068	.	C	T	1	6	7	0	4	12	1	0
23	45423138	.	A	C	5	2	7	0	0	7	0	0
23	45423167	.	T	C	4	3	7	0	0	7	0	0
23	45423324	.	G	T	5	6	11	0	0	11	0	0
23	45424107	.	G	A	1	2	3	0	0	3	0	0
23	45515555	.	C	G	1	3	4	0	0	4	0	0
23	45515570	.	C	G	1	1	2	0	0	2	0	0
23	45516336	.	C	T	3	4	7	0	1	8	0	0
23	45521246	.	G	C	2	3	5	0	0	5	0	0
23	45521557	.	A	G	2	5	7	0	0	7	0	0
23	45521811	.	A	G	3	2	5	0	0	5	0	0
23	45521816	.	T	A	3	2	5	0	0	5	0	0
23	45521853	.	G	A	6	7	13	0	1	14	0	0
23	45521857	.	G	A	6	6	12	0	2	14	0	0
23	45521942	.	A	G	10	3	13	0	0	13	0	0
23	45522046	.	G	A	6	2	8	0	0	8	0	0
23	45522110	.	A	T	3	2	5	0	0	5	0	0
23	45522166	.	T	G	6	4	10	0	1	11	0	0
23	45522170	.	T	G	5	4	9	0	2	11	0	0
23	45522238	.	A	G	6	6	12	0	4	16	0	0
23	45522434	.	G	A	5	7	12	0	0	12	0	0
23	45523295	.	C	T	12	4	16	1	2	19	0	0
23	45523409	.	T	C	18	11	29	0	1	30	0	0
23	45523619	.	C	T	8	9	17	0	1	18	0	0
23	45523669	.	A	T	11	11	22	0	1	23	0	0
23	45579547	.	A	G	12	13	25	0	0	25	0	0
23	45579629	.	A	C	9	10	19	0	1	20	0	0
23	45580052	.	C	T	6	13	19	0	1	20	0	0
23	45580442	.	C	T	15	30	45	0	1	46	0	0
23	45580508	.	C	T	29	23	52	0	2	54	0	0
23	45580562	.	C	T	21	33	54	0	2	56	0	0
23	45581181	.	C	T	25	28	53	0	2	55	0	0
23	45596217	.	C	T	0	1	1	0	0	1	0	0
23	46208578	.	T	G	17	20	37	0	2	39	0	0
23	46208611	.	T	G	20	25	45	0	3	48	0	0
23	46208718	.	G	A	19	26	45	0	2	47	0	0
23	46217045	.	C	A	5	3	8	0	0	8	0	0
24	24470	.	T	C	2	2	4	0	0	4	0	0
24	24473	.	C	T	1	2	3	0	0	3	0	0
24	167149	.	A	T	1	2	3	0	1	4	0	0
24	167177	.	A	G	0	1	1	0	0	1	0	0
24	178693	.	G	A	0	4	4	0	0	4	0	0
24	184800	.	A	G	4	0	4	0	7	11	0	0
24	184818	.	C	T	5	3	8	0	0	8	0	0
24	187371	.	T	A	4	15	19	0	3	22	0	0
24	187414	.	T	A	5	14	19	0	1	20	0	0
24	187686	.	T	A	5	11	16	0	1	17	0	0
24	187811	.	A	T	3	6	9	0	0	9	0	0
24	187960	.	A	G	6	3	9	0	1	10	0	0
24	187971	.	A	G	4	3	7	0	0	7	0	0
24	188155	.	C	G	6	4	10	0	0	10	0	0
24	188191	.	T	A	4	6	10	0	0	10	0	0
24	188363	.	G	A	20	8	28	0	5	33	0	0
24	188382	.	G	A	0	16	16	0	16	32	0	0
24	188423	.	T	C	12	18	30	0	4	34	0	0
24	188425	.	A	T	12	20	32	0	1	34	1	0
24	188464	.	T	C	10	31	41	0	3	44	0	0
24	788384	.	A	G	2	6	8	0	1	9	0	0
24	945478	.	C	T	0	5	5	0	7	12	0	0
24	945494	.	G	C	9	0	9	0	0	9	0	0
24	945706	.	T	C	20	15	35	0	1	36	0	0
24	945841	.	T	G	8	6	14	0	1	15	0	0
24	947503	.	G	C	3	7	10	0	1	11	0	0
24	947518	.	C	T	1	8	9	0	3	12	0	0
24	947611	.	C	T	1	6	7	0	5	12	0	0
24	947680	.	T	C	5	0	5	0	5	10	0	0
24	947957	.	C	A	2	8	10	0	0	10	0	0
24	947984	.	G	C	4	8	12	0	1	13	0	0
24	948080	.	A	G	6	2	8	0	0	8	0	0
24	948360	.	A	G	6	1	7	0	4	11	0	0
24	948438	.	T	C	5	10	15	0	2	17	0	0
24	948466	.	C	G	4	11	15	0	3	18	0	0
24	948503	.	C	T	5	8	13	0	2	15	0	0
24	948565	.	T	C	7	4	11	0	1	12	0	0
24	948571	.	G	A	6	4	10	0	2	12	0	0
24	948806	.	G	A	1	3	4	0	1	5	0	0
24	985094	.	A	T	11	8	19	0	6	25	0	0
24	985740	.	C	G	9	7	16	0	0	16	0	0
24	1000112	.	G	A	4	4	8	0	0	8	0	0
24	1002664	.	T	C	4	2	6	0	1	7	0	0
24	1003551	.	C	A	0	2	2	0	1	3	0	0
24	1011355	.	A	T	2	3	5	0	0	5	0	0
24	1011372	.	G	A	2	3	5	0	0	5	0	0
24	1011439	.	T	C	5	3	8	0	1	9	0	0
24	1013290	.	G	C	1	2	3	0	0	3	0	0
24	1013303	.	G	A	1	2	3	0	0	3	0	0
24	1015029	.	C	T	0	2	2	0	5	7	0	0
24	1015292	.	T	C	12	1	13	0	20	33	0	0
24	1018672	.	T	C	6	1	7	0	9	16	0	0
24	1110150	.	T	C	9	14	23	0	1	24	0	0
24	1110152	.	T	A	9	15	24	0	0	24	0	0
24	1110227	.	G	A	3	9	12	0	0	12	0	0
24	1110325	.	C	A	7	8	15	0	0	15	0	0
24	1110492	.	C	T	2	1	3	0	0	3	0	0
24	1110512	.	C	T	0	0	0	0	2	3	1	0
24	1110527	.	C	T	1	1	2	0	0	2	0	0
24	1110595	.	G	C	4	4	8	0	2	10	0	0
24	1110601	.	G	A	5	6	11	0	0	11	0	0
24	1110748	.	T	C	1	2	3	0	0	3	0	0
24	1111102	.	G	T	0	2	2	0	1	3	0	0
24	1163061	.	G	A	1	6	7	0	2	9	0	0
24	1166957	.	G	A	1	2	3	0	0	3	0	0
24	2284456	.	A	T	19	12	31	0	2	33	0	0
24	2284647	.	C	T	0	3	3	0	8	11	0	0
24	2346758	.	A	G	5	2	7	0	0	7	0	0
24	2346825	.	A	T	3	2	5	0	0	5	0	0
24	2346826	.	A	T	3	2	5	0	0	5	0	0
24	3470108	.	T	C	5	5	10	0	0	10	0	0
24	3470181	.	T	C	6	3	9	0	0	9	0	0
24	3470415	.	T	C	4	4	8	0	0	8	0	0
24	3470608	.	T	C	1	4	5	0	0	5	0	0
24	3471477	.	T	C	3	4	7	0	1	8	0	0
24	6011154	.	A	T	1	2	3	0	0	3	0	0
24	6513996	.	G	A	3	3	6	0	0	6	0	0
24	6514012	.	C	T	2	3	5	0	1	6	0	0
24	6514882	.	A	T	2	3	5	0	0	5	0	0
24	6515019	.	C	T	0	2	2	0	4	6	0	0
24	6515245	.	G	A	1	1	2	0	2	4	0	0
24	6515327	.	G	A	2	5	7	0	1	8	0	0
24	6515364	.	A	T	3	2	5	0	0	5	0	0
24	6546863	.	T	C	2	0	2	0	2	4	0	0
24	9594999	.	T	C	3	2	5	0	1	6	0	0
24	9596350	.	G	A	3	3	6	0	0	6	0	0
24	9596423	.	T	C	2	4	6	0	0	6	0	0
24	9676144	.	T	C	5	4	9	0	2	11	0	0
24	9676147	.	T	A	5	6	11	0	0	11	0	0
24	9676204	.	C	A	1	2	3	0	1	4	0	0
24	9678514	.	A	T	8	4	12	0	3	15	0	0
24	9689709	.	G	T	2	3	5	0	1	6	0	0
24	9730098	.	G	A	4	1	5	0	0	5	0	0
24	10309532	.	T	A	5	4	9	0	0	9	0	0
24	10309740	.	G	A	3	2	5	0	1	6	0	0
24	10349671	.	C	T	2	3	5	0	0	5	0	0
24	10349818	.	G	A	1	5	6	0	0	6	0	0
24	10349865	.	T	G	2	8	10	0	1	11	0	0
24	10349898	.	T	C	5	8	13	0	0	13	0	0
24	10350089	.	T	A	2	4	6	0	0	6	0	0
24	10350135	.	A	T	2	3	5	0	0	5	0	0
24	10350239	.	T	A	1	4	5	0	1	6	0	0
24	10406464	.	C	G	1	2	3	0	0	3	0	0
24	10414039	.	T	C	2	1	3	0	0	3	0	0
24	10414439	.	G	T	0	4	4	0	1	5	0	0
24	10415193	.	A	G	3	9	12	0	1	13	0	0
24	10415370	.	G	C	7	6	13	0	1	14	0	0
24	10797306	.	T	C	1	0	1	0	0	1	0	0
24	10824235	.	C	T	1	0	1	0	1	2	0	0
24	10828512	.	A	G	1	0	1	0	0	1	0	0
24	10901467	.	A	C	3	12	15	0	1	16	0	0
24	10901696	.	C	G	20	32	52	1	3	56	0	0
24	10901759	.	G	T	27	21	48	0	5	53	0	0
24	10901946	.	C	T	12	15	27	0	1	28	0	0
24	10902065	.	T	G	7	11	18	0	5	23	0	0
24	10902192	.	T	A	7	4	11	0	0	11	0	0
24	10902268	.	G	A	4	10	14	0	3	17	0	0
24	10902688	.	G	A	12	10	22	0	2	24	0	0
24	10907000	.	T	C	1	2	3	0	0	3	0	0
24	10907473	.	C	T	4	10	14	0	1	15	0	0
24	10917040	.	C	T	0	1	1	0	0	1	0	0
24	10917046	.	C	T	0	2	2	0	0	2	0	0
24	10919519	.	A	G	1	1	2	0	0	2	0	0
24	10924880	.	C	T	1	2	3	0	0	3	0	0
24	11049421	.	G	A	1	2	3	0	0	3	0	0
24	11083860	.	C	T	2	1	3	0	2	5	0	0
24	11086679	.	T	A	3	4	7	0	0	7	0	0
24	11112153	.	T	A	7	9	16	0	0	16	0	0
24	11112290	.	G	A	4	8	12	0	2	14	0	0
24	11112474	.	A	G	11	12	23	0	0	23	0	0
24	11112839	.	G	A	11	10	21	0	0	21	0	0
24	11113027	.	T	C	5	5	10	0	0	10	0	0
24	11113110	.	C	T	2	10	12	0	0	12	0	0
24	11113243	.	G	A	3	4	7	0	1	8	0	0
24	11113293	.	A	T	3	4	7	0	2	9	0	0
24	11113900	.	A	T	0	5	5	0	2	7	0	0
24	11113912	.	A	T	3	4	7	0	1	8	0	0
24	11113966	.	T	C	6	7	13	0	0	13	0	0
24	11113972	.	C	G	6	8	14	0	1	15	0	0
24	11114024	.	T	C	3	3	6	0	1	7	0	0
24	11114184	.	G	T	2	4	6	0	1	7	0	0
24	11114236	.	A	T	2	2	4	0	0	4	0	0
24	11114584	.	T	C	2	3	5	0	0	5	0	0
24	11115806	.	A	G	1	1	2	0	1	3	0	0
24	11473845	.	T	G	4	7	11	0	0	11	0	0
24	11473857	.	C	A	9	4	13	0	0	13	0	0
24	11473968	.	T	C	4	0	4	0	6	10	0	0
24	11474167	.	T	C	9	4	13	0	1	14	0	0
24	11474257	.	G	A	4	4	8	0	3	11	0	0
24	11490060	.	C	T	1	3	4	0	0	4	0	0
24	11529966	.	C	T	3	4	7	0	2	9	0	0
24	11888799	.	T	C	11	10	21	0	1	22	0	0
24	11888854	.	T	C	5	12	17	0	0	17	0	0
24	11889038	.	C	G	1	8	9	0	0	9	0	0
24	11889579	.	T	C	3	2	5	0	1	6	0	0
24	11889600	.	T	C	3	2	5	0	0	5	0	0
24	11893428	.	G	A	1	3	4	0	0	4	0	0
24	11919170	.	A	G	4	3	7	0	0	7	0	0
24	12252675	.	G	T	9	6	15	0	1	16	0	0
24	12253067	.	G	A	7	11	18	0	1	19	0	0
24	12253154	.	T	G	6	9	15	0	0	16	1	0
24	12630352	.	A	G	2	6	8	0	2	10	0	0
24	12634439	.	C	T	1	3	4	0	0	4	0	0
24	12748448	.	T	A	3	4	7	0	0	7	0	0
24	12749046	.	G	A	4	3	7	0	0	7	0	0
24	12764550	.	A	T	0	1	1	0	0	1	0	0
24	12966730	.	C	T	8	5	13	0	2	15	0	0
24	12966981	.	G	A	10	4	14	0	0	14	0	0
24	12967041	.	C	T	1	0	1	0	0	1	0	0
24	12967163	.	G	A	5	5	10	0	1	11	0	0
24	12970814	.	A	T	2	0	2	0	0	2	0	0
24	13015843	.	C	G	3	2	5	0	0	5	0	0
24	13026060	.	G	A	6	9	15	0	1	16	0	0
24	13026449	.	T	C	0	1	1	0	2	3	0	0
24	13101143	.	C	A	20	24	44	0	3	47	0	0
24	13229408	.	G	A	12	4	16	0	2	18	0	0
24	13239040	.	C	T	5	17	22	0	14	36	0	0
24	13239045	.	A	T	28	6	34	0	6	40	0	0
24	13239712	.	G	T	1	39	40	0	26	67	1	0
24	13239934	.	G	T	22	27	49	0	4	53	0	0
24	13239985	.	G	C	32	12	44	0	2	46	0	0
24	13251801	.	A	C	7	7	14	0	0	14	0	0
24	13255400	.	C	T	2	3	5	0	0	5	0	0
24	14014748	.	C	T	1	2	3	0	0	3	0	0
24	14233840	.	T	G	0	2	2	0	0	2	0	0
24	14233841	.	G	A	0	2	2	0	0	2	0	0
24	14234518	.	T	A	5	7	12	0	1	13	0	0
24	14234567	.	A	T	2	4	6	0	2	8	0	0
24	14234594	.	A	C	1	3	4	0	0	4	0	0
24	14443257	.	G	A	3	2	5	0	0	5	0	0
24	14443291	.	C	T	2	3	5	0	1	6	0	0
24	14443592	.	C	G	3	3	6	0	0	6	0	0
24	14542501	.	A	G	5	2	7	0	0	7	0	0
24	14550242	.	T	G	1	1	2	0	0	2	0	0
24	14550305	.	T	A	0	2	2	0	1	3	0	0
24	14550479	.	G	A	4	9	13	0	0	13	0	0
24	14550487	.	A	T	5	10	15	0	0	15	0	0
24	14550545	.	C	T	12	6	18	0	1	19	0	0
24	14559391	.	A	G	13	14	27	0	2	29	0	0
24	14560155	.	G	A	24	22	46	0	5	51	0	0
24	14568300	.	G	T	20	23	43	0	8	51	0	0
24	14575607	.	G	A	4	6	10	0	0	10	0	0
24	14576693	.	A	G	8	7	15	0	0	15	0	0
24	14576782	.	A	G	6	7	13	0	0	13	0	0
24	14597264	.	G	A	2	4	6	0	1	7	0	0
24	14597311	.	C	T	1	10	11	0	1	12	0	0
24	14597313	.	G	A	1	10	11	0	1	12	0	0
24	14600137	.	G	A	3	2	5	0	0	5	0	0
24	14600191	.	C	T	1	2	3	0	0	3	0	0
24	14713865	.	A	G	4	7	11	0	0	11	0	0
24	14713927	.	T	C	3	0	3	0	0	3	0	0
24	14718476	.	A	G	2	2	4	0	0	4	0	0
24	14725323	.	T	C	18	23	41	0	3	45	1	0
24	15061866	.	G	A	0	1	1	0	0	1	0	0
24	15124818	.	C	T	3	6	9	0	0	9	0	0
24	15124937	.	T	G	0	1	1	0	0	1	0	0
24	15127487	.	A	T	1	4	5	0	0	5	0	0
24	15127581	.	G	T	0	3	3	0	0	3	0	0
24	16615706	.	A	G	0	1	1	0	0	1	0	0
24	16696741	.	T	C	2	3	5	0	0	5	0	0
24	16702886	.	G	T	0	3	3	0	3	6	0	0
24	16705890	.	A	C	7	13	20	0	0	20	0	0
24	16705948	.	C	T	13	14	27	0	2	29	0	0
24	16705949	.	A	G	14	14	28	0	1	29	0	0
24	16706349	.	T	C	8	13	21	0	0	21	0	0
24	16853304	.	C	T	0	2	2	0	1	3	0	0
24	16905265	.	A	C	2	6	8	0	0	8	0	0
24	16905292	.	C	T	2	6	8	0	0	8	0	0
24	16908771	.	A	C	5	3	8	0	1	9	0	0
24	16908827	.	G	A	8	11	19	0	2	21	0	0
24	16908848	.	C	T	8	6	14	0	0	14	0	0
24	16908908	.	C	T	2	4	6	0	1	7	0	0
24	16911940	.	G	C	15	12	27	0	3	30	0	0
24	16911949	.	T	A	14	10	24	0	0	24	0	0
24	16912086	.	G	A	0	0	0	0	5	5	0	0
24	16912188	.	G	A	0	26	26	0	17	43	0	0
24	16912191	.	G	A	25	15	40	0	1	41	0	0
24	16912710	.	G	A	18	20	38	0	1	39	0	0
24	16913077	.	G	A	4	5	9	0	0	9	0	0
24	16913143	.	A	T	1	7	8	0	0	8	0	0
24	16913144	.	G	T	1	7	8	0	0	8	0	0
24	16914728	.	A	C	1	0	1	0	3	4	0	0
24	16964353	.	C	A	5	6	11	0	2	13	0	0
24	16964452	.	G	A	5	4	9	0	0	9	0	0
24	16964750	.	T	C	1	2	3	0	0	3	0	0
24	16964787	.	T	A	2	2	4	0	0	4	0	0
24	16964943	.	A	T	2	3	5	0	1	7	1	0
24	16965020	.	C	T	2	4	6	0	2	8	0	0
24	16965032	.	G	A	3	5	8	0	0	8	0	0
24	16965503	.	G	A	4	4	8	0	0	8	0	0
24	16966176	.	G	A	1	2	3	0	0	3	0	0
24	16966185	.	T	C	1	0	1	0	2	3	0	0
24	16992440	.	A	G	6	5	11	0	0	11	0	0
24	16992506	.	A	C	0	0	0	0	1	1	0	0
24	16999057	.	T	G	21	20	41	0	3	44	0	0
24	17017060	.	T	C	2	0	2	0	0	2	0	0
24	17020761	.	T	A	0	2	2	0	0	2	0	0
24	17020764	.	A	T	0	2	2	0	0	2	0	0
24	17022028	.	A	G	0	7	7	0	2	9	0	0
24	17022029	.	T	A	0	9	9	0	0	9	0	0
24	17027464	.	G	A	16	16	32	0	2	34	0	0
24	17027484	.	C	A	24	17	41	0	2	43	0	0
24	17028990	.	C	T	0	2	2	0	0	2	0	0
24	17040803	.	A	T	5	2	7	0	0	7	0	0
24	17124124	.	C	T	3	3	6	0	0	6	0	0
24	17125418	.	A	G	4	1	5	0	1	6	0	0
24	17125503	.	G	A	5	5	10	0	0	10	0	0
24	17126069	.	G	A	10	15	25	0	2	27	0	0
24	17126391	.	T	C	14	11	25	0	0	25	0	0
24	17126738	.	T	A	26	20	46	0	1	47	0	0
24	17214629	.	T	C	10	9	19	1	1	21	0	0
24	17215855	.	C	T	2	3	5	0	6	11	0	0
24	17259535	.	G	T	14	0	14	0	1	15	0	0
24	17266382	.	G	A	4	3	7	0	1	8	0	0
24	17266876	.	G	A	10	7	17	0	2	19	0	0
24	17341338	.	G	T	3	1	4	0	1	5	0	0
24	17364010	.	G	A	0	7	7	0	6	13	0	0
24	17365081	.	A	G	14	5	19	0	7	26	0	0
24	17368343	.	T	A	1	1	2	0	0	2	0	0
24	17368816	.	G	A	1	1	2	0	1	3	0	0
24	17372074	.	G	A	0	2	2	0	0	2	0	0
24	17377871	.	G	A	0	4	4	0	0	4	0	0
24	17377874	.	G	A	0	4	4	0	0	4	0	0
24	17381017	.	G	A	4	1	5	0	2	7	0	0
24	17417535	.	T	G	18	20	38	0	1	39	0	0
24	17417899	.	G	C	5	6	11	0	1	12	0	0
24	17417947	.	A	G	4	5	9	0	0	9	0	0
24	17418024	.	C	A	6	7	13	0	0	13	0	0
24	17418292	.	T	A	3	3	6	0	0	6	0	0
24	17418460	.	T	C	5	3	8	0	0	8	0	0
24	17418993	.	C	T	0	4	4	0	2	6	0	0
24	17420989	.	T	C	1	0	1	0	6	7	0	0
24	17421311	.	G	C	9	10	19	0	3	22	0	0
24	17465715	.	C	T	0	2	2	0	0	2	0	0
24	17465722	.	A	T	0	2	2	0	0	2	0	0
24	18376840	.	G	A	0	2	2	0	0	2	0	0
24	18444095	.	A	C	5	6	11	0	0	11	0	0
24	18444265	.	A	T	12	24	36	0	4	40	0	0
24	18444334	.	G	T	11	13	24	0	1	25	0	0
24	18444373	.	C	T	3	5	8	0	1	9	0	0
24	18444399	.	C	T	1	3	4	0	1	5	0	0
24	18444429	.	A	C	2	3	5	0	0	5	0	0
24	18444434	.	T	C	2	3	5	0	0	5	0	0
24	18444476	.	A	G	2	5	7	0	1	8	0	0
24	18444499	.	A	G	2	6	8	0	0	8	0	0
24	18446527	.	T	A	5	7	12	0	0	12	0	0
24	18448348	.	G	A	1	5	6	0	0	6	0	0
24	18486053	.	A	G	2	2	4	0	0	4	0	0
24	18486345	.	T	C	3	2	5	0	0	5	0	0
24	18521384	.	T	A	2	3	5	0	4	9	0	0
24	18549388	.	A	G	0	2	2	0	0	2	0	0
24	18563714	.	A	G	0	1	1	0	0	1	0	0
24	18618371	.	A	G	1	2	3	0	0	3	0	0
24	18618372	.	G	T	1	2	3	0	0	3	0	0
24	18731918	.	G	A	0	3	3	0	2	5	0	0
24	18731951	.	T	C	1	5	6	0	0	6	0	0
24	18732055	.	A	G	1	3	4	0	0	4	0	0
24	18732085	.	T	G	1	3	4	0	1	5	0	0
24	18732190	.	T	G	2	2	4	0	0	4	0	0
24	18732216	.	A	T	2	2	4	0	0	4	0	0
24	18737876	.	C	T	4	7	11	0	0	11	0	0
24	18749985	.	A	G	4	8	12	0	2	14	0	0
24	18751785	.	G	A	5	2	7	0	0	7	0	0
24	18752695	.	C	T	1	3	4	0	1	5	0	0
24	18769625	.	C	G	1	1	2	0	1	3	0	0
24	18776192	.	T	A	0	1	1	0	0	1	0	0
24	19402505	.	G	T	5	3	8	0	1	9	0	0
24	19402645	.	C	T	4	7	11	0	0	11	0	0
24	19708366	.	C	T	1	3	4	0	0	4	0	0
24	19708448	.	G	T	3	4	7	0	0	7	0	0
24	20064892	.	G	A	5	1	6	0	1	7	0	0
24	20064924	.	A	G	1	4	5	0	0	5	0	0
24	20065258	.	T	C	1	2	3	0	0	3	0	0
24	20196172	.	A	G	1	7	8	0	0	8	0	0
24	20328821	.	C	A	3	5	8	0	0	8	0	0
24	20328999	.	T	A	3	2	5	0	0	5	0	0
24	20329493	.	G	A	3	8	11	0	0	11	0	0
24	20329589	.	G	C	1	1	2	0	0	2	0	0
24	20332145	.	A	G	3	4	7	0	1	8	0	0
24	20332187	.	A	T	5	5	10	0	0	10	0	0
24	20332265	.	A	G	1	2	3	0	0	3	0	0
24	20332268	.	T	A	1	2	3	0	0	3	0	0
24	20336784	.	G	A	1	2	3	0	0	3	0	0
24	20531624	.	C	A	1	2	3	0	0	3	0	0
24	20552393	.	A	T	4	5	9	0	1	10	0	0
24	20554732	.	A	G	15	13	28	0	2	30	0	0
24	20554812	.	T	A	14	12	26	0	2	28	0	0
24	20643765	.	T	C	7	4	11	0	0	11	0	0
24	20644063	.	A	C	8	5	13	0	4	17	0	0
24	20644123	.	A	C	17	8	25	0	0	25	0	0
24	20644685	.	C	T	0	1	1	0	3	4	0	0
24	20645101	.	T	C	14	15	29	0	4	33	0	0
24	20645273	.	T	C	17	13	30	0	1	31	0	0
24	20646270	.	T	A	5	7	12	0	1	13	0	0
24	20647394	.	C	T	1	4	5	0	0	5	0	0
24	20648942	.	C	T	0	2	2	0	1	3	0	0
24	20648945	.	T	C	3	0	3	0	0	3	0	0
24	20649039	.	T	G	2	3	5	0	0	5	0	0
24	20658386	.	C	A	0	1	1	0	0	1	0	0
24	20916841	.	C	A	1	2	3	0	0	3	0	0
24	20921431	.	C	T	7	11	18	0	0	18	0	0
24	20924996	.	C	T	0	1	1	0	0	1	0	0
24	20931626	.	G	A	2	2	4	0	0	4	0	0
24	20934528	.	G	A	15	16	31	0	0	31	0	0
24	20934616	.	T	C	0	2	2	0	0	2	0	0
24	20934619	.	A	T	0	2	2	0	0	2	0	0
24	20941540	.	G	A	5	8	13	0	2	15	0	0
24	20941605	.	A	G	7	6	13	0	0	13	0	0
24	20946263	.	G	A	1	1	2	0	0	2	0	0
24	20954109	.	G	A	1	3	4	0	0	4	0	0
24	20987732	.	C	T	6	7	13	0	1	14	0	0
24	20987798	.	T	C	1	3	4	0	0	4	0	0
24	20987834	.	G	A	1	3	4	0	0	4	0	0
24	20987865	.	A	G	1	2	3	0	0	3	0	0
24	21005546	.	C	T	3	3	6	0	1	7	0	0
24	21006053	.	A	G	11	14	25	0	2	27	0	0
24	21006082	.	G	A	6	17	23	0	0	23	0	0
24	21006188	.	T	G	8	10	18	0	1	19	0	0
24	21154160	.	G	A	5	9	14	0	3	17	0	0
24	21154203	.	C	T	15	11	26	0	3	29	0	0
24	21154419	.	T	G	10	11	21	0	3	24	0	0
24	21154496	.	C	A	2	19	21	0	23	44	0	0
24	21154586	.	T	C	23	26	49	0	3	52	0	0
24	21157712	.	G	A	6	19	25	0	2	27	0	0
24	21182642	.	G	A	6	5	11	0	2	13	0	0
24	21182783	.	C	T	4	7	11	0	3	14	0	0
24	21182834	.	G	A	0	9	9	0	11	20	0	0
24	21182911	.	G	A	0	5	5	0	5	10	0	0
24	21183474	.	G	A	12	5	17	0	1	18	0	0
24	21201380	.	T	C	2	3	5	0	0	5	0	0
24	21201860	.	G	A	0	10	10	0	9	19	0	0
24	21202067	.	G	T	2	2	4	0	0	4	0	0
24	21202203	.	A	G	5	5	10	0	0	10	0	0
24	21202225	.	C	T	5	3	8	0	2	10	0	0
24	21202256	.	G	T	4	5	9	0	0	9	0	0
24	21202310	.	C	A	1	4	5	0	0	5	0	0
24	21206352	.	G	T	3	5	8	0	0	8	0	0
24	21206401	.	T	C	1	4	5	0	0	5	0	0
24	21214898	.	G	A	1	2	3	0	0	3	0	0
24	21371481	.	T	C	17	18	35	0	2	37	0	0
24	21371520	.	G	C	12	17	29	0	5	34	0	0
24	21371547	.	T	C	18	20	38	0	2	40	0	0
24	21371599	.	C	T	22	19	41	0	4	45	0	0
24	21371801	.	T	G	19	18	37	0	2	39	0	0
24	21371919	.	G	A	12	8	20	0	10	30	0	0
24	21372417	.	A	G	14	10	24	0	0	24	0	0
24	21372435	.	G	A	7	7	14	0	1	15	0	0
24	21411463	.	G	A	1	0	1	0	0	1	0	0
24	21411514	.	G	A	1	2	3	0	0	3	0	0
24	21411876	.	T	A	1	3	4	0	1	5	0	0
24	21438161	.	G	A	0	3	3	0	0	3	0	0
24	21502007	.	A	G	7	8	15	0	0	15	0	0
24	21502069	.	G	A	6	15	21	0	0	21	0	0
24	21502133	.	T	C	7	0	7	0	13	20	0	0
24	21502305	.	A	G	11	12	23	0	0	23	0	0
24	21502817	.	C	A	3	2	5	0	0	5	0	0
24	21502842	.	T	A	7	4	11	0	0	11	0	0
24	21502880	.	G	T	8	4	12	0	1	13	0	0
24	21502973	.	G	A	4	4	8	0	0	8	0	0
24	21502999	.	G	A	5	5	10	0	2	12	0	0
24	21503043	.	G	T	4	6	10	0	1	11	0	0
24	21503575	.	A	G	1	2	3	0	0	3	0	0
24	21503793	.	G	A	1	1	2	0	1	3	0	0
24	21538568	.	A	C	12	16	28	0	0	28	0	0
24	21538628	.	C	T	6	7	13	0	0	13	0	0
24	21539131	.	T	G	10	10	20	0	2	22	0	0
24	21561074	.	C	T	1	1	2	0	0	2	0	0
24	21575273	.	T	A	1	0	1	0	0	1	0	0
24	21575311	.	G	C	2	7	9	0	0	9	0	0
24	21577239	.	G	A	1	1	2	0	2	4	0	0
24	21577394	.	C	A	13	6	19	0	0	19	0	0
24	21577573	.	T	G	4	4	8	0	1	9	0	0
24	21577638	.	A	G	8	4	12	0	1	13	0	0
24	21577898	.	C	A	3	4	7	0	0	7	0	0
24	21600984	.	C	A	14	19	33	0	1	34	0	0
24	21606035	.	G	A	7	7	14	0	2	16	0	0
24	21606325	.	C	T	0	1	1	0	2	3	0	0
24	21610064	.	G	A	0	0	0	0	1	1	0	0
24	21625149	.	C	T	32	26	58	0	8	66	0	0
24	21646375	.	G	A	8	11	19	0	1	20	0	0
24	21646802	.	A	C	17	18	35	0	0	35	0	0
24	21646805	.	C	G	0	17	17	0	17	34	0	0
24	21657567	.	C	G	5	5	10	0	0	10	0	0
24	21657639	.	G	A	6	3	9	0	0	9	0	0
24	21657642	.	G	A	6	2	8	0	2	10	0	0
24	21659792	.	C	T	0	1	1	0	3	4	0	0
24	21659819	.	G	A	3	2	5	0	0	5	0	0
24	21671114	.	G	A	1	3	4	0	0	4	0	0
24	21671506	.	G	A	1	3	4	0	0	4	0	0
24	21680747	.	C	G	2	5	7	0	0	7	0	0
24	21680970	.	A	C	7	4	11	0	1	12	0	0
24	21681112	.	T	A	1	6	7	0	1	8	0	0
24	21681162	.	C	T	4	6	10	0	1	11	0	0
24	21681353	.	T	A	1	2	3	0	0	3	0	0
24	21747316	.	T	G	4	4	8	0	1	9	0	0
24	21747325	.	T	C	4	1	5	0	4	9	0	0
24	21747368	.	T	C	3	5	8	0	1	9	0	0
24	21747376	.	C	T	3	6	9	0	0	9	0	0
24	21748249	.	T	C	21	13	34	0	0	34	0	0
24	21748279	.	C	T	12	19	31	0	0	31	0	0
24	21748374	.	T	C	7	7	14	0	2	16	0	0
24	21927377	.	T	C	1	3	4	0	0	4	0	0
24	21927503	.	A	G	4	3	7	0	2	9	0	0
24	21927638	.	G	A	4	5	9	0	0	9	0	0
24	21960293	.	C	T	3	12	15	0	0	15	0	0
24	21960299	.	G	A	3	12	15	0	0	15	0	0
24	21960347	.	C	T	3	10	13	0	0	13	0	0
24	21960639	.	G	C	5	3	8	0	0	8	0	0
24	21960930	.	C	T	1	3	4	0	0	4	0	0
24	21978470	.	A	G	11	10	21	0	2	23	0	0
24	21978524	.	C	T	13	6	19	0	3	22	0	0
24	21978531	.	A	G	15	7	22	0	1	23	0	0
24	21978647	.	C	G	9	15	24	0	3	27	0	0
24	21978733	.	C	T	18	16	34	0	0	34	0	0
24	21978790	.	T	C	5	25	30	0	1	31	0	0
24	21978805	.	T	C	22	4	26	0	0	26	0	0
24	21986794	.	A	G	0	1	1	0	0	1	0	0
24	21986802	.	C	T	0	1	1	0	0	1	0	0
24	22070477	.	A	G	5	16	21	0	2	23	0	0
24	22070877	.	G	A	2	5	7	0	3	10	0	0
24	22070878	.	A	G	4	4	8	0	2	10	0	0
24	22071146	.	G	C	1	3	4	0	0	4	0	0
24	22071644	.	G	T	20	13	33	0	6	39	0	0
24	22122812	.	G	A	3	10	13	0	11	24	0	0
24	22122922	.	C	T	0	9	9	0	15	24	0	0
24	22122929	.	G	A	9	14	23	0	3	26	0	0
24	22123024	.	G	A	5	4	9	0	0	9	0	0
24	22123115	.	C	T	0	6	6	0	21	27	0	0
24	22123176	.	T	A	10	10	20	0	4	24	0	0
24	22123434	.	G	C	6	4	10	0	3	13	0	0
24	22123446	.	A	G	7	7	14	0	2	16	0	0
24	22123640	.	A	G	8	8	16	0	1	17	0	0
24	22124020	.	G	A	8	5	13	0	0	13	0	0
24	22275403	.	A	T	0	2	2	0	0	2	0	0
24	22395255	.	T	C	1	2	3	0	0	3	0	0
24	22740552	.	T	C	5	0	5	0	3	8	0	0
24	22740589	.	T	C	6	12	18	0	0	18	0	0
24	22740897	.	A	T	12	15	27	0	2	29	0	0
24	22740949	.	A	G	16	4	20	0	1	21	0	0
24	22740996	.	C	T	7	3	10	0	0	10	0	0
24	22741051	.	G	A	4	5	9	0	0	9	0	0
24	22741088	.	C	T	7	5	12	0	1	13	0	0
24	22741403	.	T	A	6	6	12	0	2	14	0	0
24	22741453	.	C	T	5	7	12	0	1	13	0	0
24	22744502	.	A	G	0	5	5	0	0	5	0	0
24	22746843	.	T	G	2	1	3	0	0	3	0	0
24	22769225	.	A	T	13	9	22	0	2	24	0	0
24	22769333	.	A	G	4	1	5	0	10	15	0	0
24	22769447	.	G	A	7	6	13	0	0	13	0	0
24	22769484	.	C	T	6	2	8	0	1	9	0	0
24	22769593	.	C	A	4	8	12	0	0	12	0	0
24	22769595	.	T	A	8	4	12	0	0	12	0	0
24	22769689	.	G	C	5	13	18	0	0	18	0	0
24	22769914	.	A	G	2	2	4	0	0	4	0	0
24	23243257	.	A	G	3	4	7	0	0	7	0	0
24	23243872	.	A	T	3	9	12	0	0	12	0	0
24	23243946	.	C	A	6	4	10	0	0	10	0	0
24	23243947	.	A	C	6	4	10	0	0	10	0	0
24	23244161	.	T	A	5	7	12	0	0	12	0	0
24	24017837	.	C	T	2	4	6	0	0	6	0	0
24	24027914	.	T	A	4	1	5	0	0	5	0	0
24	24027990	.	A	T	6	8	14	0	1	15	0	0
24	24028059	.	T	A	14	9	23	0	0	23	0	0
24	24111606	.	T	A	2	3	5	0	0	5	0	0
24	24177074	.	A	G	3	5	8	0	0	8	0	0
24	25404485	.	A	T	3	2	5	0	0	5	0	0
24	25448810	.	T	C	6	2	8	0	0	8	0	0
24	25694871	.	G	T	1	1	2	0	1	3	0	0
24	26901831	.	C	T	1	3	4	0	0	4	0	0
24	26941996	.	A	G	7	9	16	0	1	17	0	0
24	26942242	.	C	G	6	8	14	0	2	16	0	0
24	26942614	.	C	T	0	6	6	0	8	14	0	0
24	26948933	.	A	T	7	4	11	0	0	11	0	0
24	26949229	.	T	C	5	5	10	0	0	10	0	0
24	26949426	.	A	C	2	4	6	0	2	8	0	0
24	26949555	.	T	G	2	5	7	0	0	7	0	0
24	27013469	.	A	T	2	3	5	0	0	5	0	0
24	27185574	.	A	G	2	2	4	0	0	4	0	0
24	27222574	.	G	A	3	5	8	0	0	8	0	0
24	27222610	.	A	C	5	6	11	0	1	12	0	0
24	27222662	.	C	T	3	7	10	0	0	10	0	0
24	27222713	.	A	G	4	0	4	0	4	8	0	0
24	27222731	.	A	G	4	0	4	0	4	8	0	0
24	27222937	.	G	A	0	3	3	0	10	13	0	0
24	27223018	.	C	T	2	1	3	0	0	3	0	0
24	27223036	.	A	G	1	1	2	0	3	5	0	0
24	27224383	.	T	A	15	22	37	0	6	43	0	0
24	27224415	.	G	A	11	19	30	0	5	35	0	0
24	27224484	.	A	T	13	26	39	0	4	43	0	0
24	27224598	.	G	A	8	5	13	0	0	13	0	0
24	27224842	.	G	A	18	16	34	0	3	37	0	0
24	27224990	.	G	A	15	17	32	0	5	37	0	0
24	27225423	.	C	A	12	7	19	0	1	20	0	0
24	27225842	.	A	G	2	9	11	0	2	13	0	0
24	27226044	.	A	G	4	2	6	0	2	8	0	0
24	27236653	.	C	T	4	4	8	0	0	8	0	0
24	27236716	.	T	C	5	4	9	0	1	10	0	0
24	27714331	.	C	T	1	2	3	0	0	3	0	0
24	27714338	.	C	T	2	2	4	0	0	4	0	0
24	27784102	.	C	G	3	2	5	0	0	5	0	0
24	27784129	.	A	G	6	3	9	0	0	9	0	0
24	27784444	.	G	A	1	2	3	0	0	3	0	0
24	28252605	.	C	T	10	5	15	0	2	17	0	0
24	28252608	.	C	T	4	11	15	0	2	17	0	0
24	28252677	.	T	A	8	6	14	0	1	15	0	0
24	28252699	.	G	A	13	4	17	0	2	19	0	0
24	28253646	.	A	T	2	1	3	0	0	3	0	0
24	28253663	.	G	A	4	1	5	0	0	5	0	0
24	28253782	.	A	T	6	14	20	0	0	20	0	0
24	28258991	.	G	A	0	1	1	0	0	1	0	0
24	28259011	.	G	A	0	1	1	0	0	1	0	0
24	28259128	.	C	T	3	2	5	0	0	5	0	0
24	28426131	.	A	T	5	6	11	0	2	13	0	0
24	28426244	.	G	C	9	6	15	0	5	20	0	0
24	28426597	.	G	A	19	20	39	0	4	43	0	0
24	28426617	.	C	T	0	17	17	0	22	39	0	0
24	28432465	.	C	T	4	6	10	0	0	10	0	0
24	28686815	.	C	T	0	2	2	0	3	5	0	0
24	28686864	.	T	A	3	3	6	0	0	6	0	0
24	28686911	.	C	T	0	3	3	0	1	4	0	0
24	28687245	.	A	C	1	0	1	0	4	5	0	0
24	28687253	.	G	A	1	5	6	0	0	6	0	0
24	28687424	.	C	T	0	10	10	0	7	17	0	0
24	28687783	.	G	T	3	5	8	0	1	9	0	0
24	28688416	.	G	A	0	2	2	0	1	3	0	0
24	28949511	.	G	A	4	2	6	0	0	6	0	0
24	28966006	.	G	T	0	3	3	0	0	3	0	0
24	28966892	.	T	C	4	9	13	0	0	13	0	0
24	30352234	.	C	T	0	1	1	0	0	1	0	0
24	30352907	.	T	C	9	11	20	0	1	21	0	0
24	30352940	.	T	A	11	8	19	0	1	20	0	0
24	30353036	.	T	A	7	5	12	0	2	14	0	0
24	30353065	.	G	A	11	7	18	0	3	21	0	0
24	30353083	.	G	A	11	11	22	0	0	22	0	0
24	30353298	.	A	G	11	7	18	0	0	18	0	0
24	30353447	.	T	C	8	5	13	0	2	15	0	0
24	30353683	.	A	G	8	6	14	0	2	16	0	0
24	30353893	.	C	A	14	12	26	0	1	27	0	0
24	30353918	.	C	T	13	18	31	0	0	31	0	0
24	31098720	.	A	G	2	5	7	0	0	7	0	0
24	31098874	.	G	T	1	5	6	0	0	6	0	0
24	31170558	.	T	A	9	7	16	0	0	16	0	0
24	31170981	.	C	T	2	1	3	0	1	4	0	0
24	31171000	.	G	C	3	2	5	0	0	5	0	0
24	31171417	.	G	A	1	4	5	0	1	6	0	0
24	31171468	.	A	T	1	3	4	0	0	4	0	0
24	31310849	.	T	A	9	11	20	0	0	20	0	0
24	31311323	.	C	G	0	4	4	0	5	9	0	0
24	31311334	.	G	C	5	1	6	0	1	7	0	0
24	31315985	.	A	G	0	0	0	0	1	1	0	0
24	31334313	.	A	G	5	3	8	0	1	9	0	0
24	31340819	.	A	T	3	5	8	0	0	8	0	0
24	31346647	.	G	T	16	15	31	0	2	33	0	0
24	31367891	.	C	T	1	3	4	0	0	4	0	0
24	31397840	.	G	A	1	2	3	0	1	4	0	0
24	31398002	.	A	G	1	2	3	0	0	3	0	0
24	31404580	.	C	G	6	5	11	0	1	12	0	0
24	31447302	.	G	A	2	1	3	0	0	3	0	0
24	31447308	.	A	G	1	1	2	0	0	2	0	0
24	31832549	.	G	A	7	7	14	0	2	16	0	0
24	31832615	.	T	G	6	4	10	0	0	10	0	0
24	31832657	.	G	A	3	3	6	0	1	7	0	0
24	31833114	.	A	T	3	2	5	0	0	5	0	0
24	31834286	.	A	G	1	3	4	0	0	4	0	0
24	32152862	.	A	G	2	2	4	0	0	4	0	0
24	32152877	.	T	G	4	2	6	0	0	6	0	0
24	32163896	.	C	A	0	3	3	0	2	5	0	0
24	32164027	.	C	T	4	1	5	0	1	6	0	0
24	32164054	.	A	G	2	3	5	0	0	5	0	0
24	32176448	.	C	T	1	2	3	0	0	3	0	0
24	32176499	.	T	C	4	3	7	0	0	7	0	0
24	32180747	.	C	T	1	9	10	0	1	11	0	0
24	32192518	.	G	A	0	19	19	0	21	40	0	0
24	32192529	.	T	C	19	19	38	0	1	39	0	0
24	32192558	.	G	A	16	19	35	0	1	36	0	0
24	32192622	.	T	C	14	14	28	0	3	31	0	0
24	32473291	.	C	T	3	3	6	0	1	7	0	0
24	32473386	.	C	T	11	6	17	0	0	17	0	0
24	32473464	.	T	C	6	4	10	0	3	13	0	0
24	32473594	.	C	G	3	4	7	0	1	8	0	0
24	32474070	.	G	C	3	2	5	0	0	5	0	0
24	32474439	.	A	T	1	5	6	0	0	6	0	0
24	32474546	.	A	C	7	9	16	0	2	18	0	0
24	32519528	.	C	T	0	24	24	0	13	37	0	0
24	32522526	.	A	G	12	16	28	0	5	33	0	0
24	32522577	.	A	T	6	4	10	0	0	10	0	0
24	32548038	.	A	C	3	2	5	0	0	5	0	0
24	32668834	.	G	A	1	5	6	0	0	6	0	0
24	32668880	.	T	A	4	5	9	0	0	9	0	0
24	32674686	.	T	A	7	11	18	0	1	19	0	0
24	32674798	.	T	G	8	0	8	0	14	22	0	0
24	32674886	.	A	G	8	7	15	0	2	17	0	0
24	33279954	.	G	T	1	3	4	0	0	4	0	0
24	33290618	.	T	G	2	1	3	0	0	3	0	0
24	33291690	.	C	A	0	2	2	0	1	3	0	0
24	33291698	.	G	A	1	2	3	0	0	3	0	0
24	33709247	.	C	G	23	32	55	0	4	59	0	0
24	33714797	.	A	G	8	8	16	0	0	16	0	0
24	33714854	.	G	A	1	2	3	0	1	4	0	0
24	33723289	.	C	A	0	2	2	0	2	4	0	0
24	33755683	.	C	T	4	4	8	0	0	8	0	0
24	33768346	.	T	A	1	2	3	0	0	3	0	0
24	33768705	.	A	G	2	0	2	0	0	2	0	0
24	33784409	.	A	C	1	1	2	0	1	3	0	0
24	33785898	.	G	A	1	1	2	0	1	3	0	0
24	33836490	.	T	A	2	2	4	0	1	5	0	0
24	33837636	.	G	T	5	2	7	0	0	7	0	0
24	33837788	.	A	G	4	0	4	0	2	6	0	0
24	33837790	.	A	G	2	4	6	0	0	6	0	0
24	33837991	.	A	G	3	1	4	0	0	4	0	0
24	33838012	.	A	C	1	3	4	0	2	6	0	0
24	33838486	.	G	A	0	3	3	0	4	7	0	0
24	33838533	.	T	G	1	0	1	0	5	6	0	0
24	33838954	.	A	C	8	4	12	0	0	12	0	0
24	33839031	.	G	A	12	9	21	0	3	24	0	0
24	33839211	.	T	C	7	3	10	0	0	10	0	0
24	33839221	.	A	C	7	2	9	0	1	10	0	0
24	34284596	.	G	T	0	2	2	0	0	2	0	0
24	34610293	.	A	G	4	5	9	0	0	9	0	0
24	34610515	.	G	A	6	6	12	0	0	12	0	0
24	34610655	.	G	A	0	3	3	0	4	7	0	0
24	34610874	.	A	G	4	14	18	0	2	20	0	0
24	34610920	.	A	T	2	10	12	0	1	13	0	0
24	34611151	.	T	C	10	8	18	0	2	20	0	0
24	34611211	.	G	A	7	14	21	0	2	23	0	0
24	34611236	.	G	A	0	13	13	0	7	20	0	0
24	34611378	.	G	T	12	12	24	0	2	26	0	0
24	34611407	.	G	C	10	10	20	0	0	20	0	0
24	34611445	.	A	G	10	5	15	0	1	16	0	0
24	34611536	.	G	A	7	9	16	0	1	17	0	0
24	34611623	.	A	G	2	14	16	0	1	17	0	0
24	34611681	.	C	T	15	6	21	0	0	21	0	0
24	34611757	.	T	G	2	3	5	0	0	5	0	0
24	34611915	.	A	G	5	0	5	0	7	12	0	0
24	34612187	.	C	A	13	15	28	0	2	30	0	0
24	34612317	.	G	A	17	13	30	0	0	30	0	0
24	34612327	.	A	T	9	18	27	0	1	28	0	0
24	34991185	.	A	G	3	5	8	0	0	8	0	0
24	34993400	.	A	G	2	0	2	0	0	2	0	0
24	34993406	.	T	C	2	0	2	0	0	2	0	0
24	34996173	.	C	T	8	4	12	0	0	12	0	0
24	35002871	.	G	A	0	1	1	0	0	1	0	0
24	35196205	.	C	G	3	1	4	0	0	4	0	0
24	35216541	.	C	T	10	8	18	0	0	18	0	0
24	35216973	.	C	T	5	8	13	0	1	14	0	0
24	35217222	.	A	T	8	15	23	0	3	26	0	0
24	35217302	.	T	G	7	7	14	0	2	16	0	0
24	35217426	.	C	T	9	8	17	0	8	25	0	0
24	35522379	.	A	T	14	10	24	0	2	26	0	0
24	35522417	.	C	A	15	8	23	0	0	23	0	0
24	35522568	.	C	T	26	25	51	0	1	52	0	0
24	35522962	.	A	G	23	13	36	0	5	41	0	0
24	35523088	.	A	T	17	24	41	0	10	51	0	0
24	35523134	.	T	A	33	9	42	0	0	42	0	0
24	35530249	.	T	G	10	5	15	0	0	15	0	0
24	35536875	.	T	A	2	3	5	0	2	7	0	0
24	35536906	.	C	A	3	3	6	0	0	6	0	0
24	35536927	.	T	A	3	3	6	0	0	6	0	0
24	35537156	.	G	A	0	1	1	0	0	1	0	0
24	35681625	.	G	A	7	10	17	0	0	17	0	0
24	35681753	.	G	A	1	2	3	0	0	3	0	0
24	35683349	.	T	C	2	3	5	0	0	5	0	0
24	35683883	.	A	G	9	5	14	0	0	14	0	0
24	35686180	.	A	G	4	5	9	0	0	9	0	0
24	35692741	.	C	T	0	2	2	0	0	2	0	0
24	35906191	.	G	A	0	3	3	0	5	8	0	0
24	35918445	.	C	G	2	1	3	0	1	4	0	0
24	35930005	.	A	C	5	6	11	0	0	11	0	0
24	35930056	.	T	G	4	4	8	0	0	8	0	0
24	36027212	.	T	C	10	7	17	0	2	19	0	0
24	36166121	.	T	G	2	2	4	0	0	4	0	0
24	36166196	.	A	G	3	3	6	0	0	6	0	0
24	36175078	.	G	A	1	0	1	0	0	1	0	0
24	36175205	.	G	A	3	1	4	0	0	4	0	0
24	36175208	.	C	T	3	2	5	0	0	5	0	0
24	36177597	.	A	C	11	8	19	0	1	20	0	0
24	36177609	.	T	C	11	8	19	0	2	21	0	0
24	36178063	.	C	G	4	3	7	0	0	7	0	0
24	36213074	.	T	C	1	2	3	0	0	3	0	0
24	36220106	.	A	T	0	1	1	0	0	1	0	0
24	36223627	.	T	C	2	4	6	0	1	7	0	0
24	36247261	.	A	T	0	2	2	0	0	2	0	0
24	36249910	.	G	T	1	1	2	0	0	2	0	0
24	36250403	.	T	C	1	1	2	0	0	2	0	0
24	36253324	.	C	T	26	23	49	0	3	52	0	0
24	36261445	.	T	C	3	2	5	0	0	5	0	0
24	36261666	.	T	C	3	6	9	0	0	9	0	0
24	36261730	.	C	T	0	5	5	0	1	6	0	0
24	36275987	.	C	T	2	3	5	0	0	5	0	0
24	36276035	.	A	C	1	2	3	0	0	3	0	0
24	36276087	.	A	G	3	2	5	0	0	5	0	0
24	36280272	.	A	G	1	1	2	0	0	2	0	0
24	36280296	.	T	G	1	1	2	0	0	2	0	0
24	36284470	.	G	A	1	1	2	0	0	2	0	0
24	36325256	.	C	G	1	0	1	0	0	1	0	0
24	36325262	.	C	G	1	0	1	0	0	1	0	0
24	36329292	.	A	G	3	0	3	0	0	3	0	0
24	36329516	.	A	G	1	3	4	0	0	4	0	0
24	36331134	.	T	A	1	2	3	0	1	4	0	0
24	36331150	.	A	G	1	3	4	0	0	4	0	0
24	36331180	.	G	C	2	4	6	0	0	6	0	0
24	36331298	.	A	G	2	3	5	0	0	5	0	0
24	36334589	.	G	A	0	1	1	0	0	1	0	0
24	36334677	.	T	C	3	6	9	0	0	9	0	0
24	36334848	.	A	G	5	7	12	0	0	12	0	0
24	36334857	.	G	A	4	6	10	0	1	11	0	0
24	36335024	.	C	G	4	2	6	0	0	6	0	0
24	36335196	.	C	G	2	1	3	0	1	4	0	0
24	36364454	.	A	G	2	3	5	0	0	5	0	0
24	37195514	.	T	A	7	4	11	0	0	11	0	0
24	37257922	.	T	G	18	6	24	0	2	27	1	0
24	37261221	.	A	G	4	0	4	0	1	5	0	0
24	37274840	.	C	T	7	4	11	0	0	11	0	0
24	37302011	.	T	A	14	10	24	0	1	25	0	0
24	37302045	.	A	G	7	5	12	0	0	12	0	0
24	37302047	.	T	A	7	5	12	0	0	12	0	0
24	37302539	.	G	A	21	19	40	0	4	44	0	0
24	37302747	.	G	A	14	23	37	0	1	38	0	0
24	37302764	.	G	T	13	23	36	0	4	40	0	0
24	37303266	.	A	G	6	5	11	0	2	13	0	0
24	37303275	.	G	T	9	5	14	0	2	16	0	0
24	37310338	.	A	C	2	3	5	0	1	6	0	0
24	37312146	.	T	C	2	3	5	0	0	5	0	0
24	37312173	.	A	G	2	2	4	0	0	4	0	0
24	37329390	.	A	G	4	4	8	0	0	8	0	0
24	37329476	.	T	A	4	3	7	0	0	7	0	0
24	37338980	.	T	C	1	0	1	0	0	1	0	0
24	37340846	.	A	T	1	1	2	0	0	2	0	0
24	37344146	.	A	T	9	13	22	0	0	22	0	0
24	37344164	.	G	A	7	11	18	0	2	20	0	0
24	37347937	.	A	C	3	3	6	0	1	7	0	0
24	37347946	.	T	C	4	4	8	0	0	8	0	0
24	37370207	.	T	G	1	1	2	0	1	3	0	0
24	37469699	.	G	A	1	6	7	0	0	7	0	0
24	37474110	.	A	G	2	7	9	0	0	9	0	0
24	37476633	.	A	C	1	1	2	0	0	2	0	0
24	37476735	.	A	C	3	4	7	0	1	8	0	0
24	37476759	.	T	C	1	3	4	0	1	5	0	0
24	37476955	.	A	G	4	4	8	0	1	9	0	0
24	37477036	.	C	T	0	3	3	0	0	3	0	0
24	37521171	.	A	G	0	2	2	0	0	2	0	0
24	37567342	.	C	T	17	11	28	0	3	31	0	0
24	37567734	.	C	T	0	19	19	0	19	38	0	0
24	37567953	.	A	G	17	13	30	0	3	33	0	0
24	37568186	.	A	C	12	8	20	0	3	23	0	0
24	37568349	.	T	G	3	2	5	0	1	6	0	0
24	37631701	.	G	A	1	3	4	0	0	4	0	0
24	37631702	.	A	C	1	3	4	0	0	4	0	0
24	37631842	.	G	A	2	3	5	0	0	5	0	0
24	37655018	.	T	C	1	1	2	0	0	2	0	0
24	37657974	.	T	C	4	3	7	0	0	7	0	0
24	37660472	.	C	T	4	3	7	0	0	7	0	0
24	37685942	.	C	T	0	2	2	0	4	6	0	0
24	37688804	.	C	T	0	1	1	0	0	1	0	0
24	37688810	.	A	C	0	1	1	0	0	1	0	0
24	37689919	.	T	C	22	14	36	0	1	37	0	0
24	37692529	.	G	A	12	14	26	0	1	27	0	0
24	37696427	.	G	A	3	5	8	0	1	9	0	0
24	37700263	.	A	G	1	0	1	0	0	1	0	0
24	37708288	.	A	C	3	5	8	0	0	8	0	0
24	37793725	.	C	T	2	2	4	0	0	4	0	0
24	37818511	.	G	A	4	2	6	0	0	6	0	0
24	37893466	.	G	A	1	1	2	0	1	3	0	0
24	37896875	.	C	T	3	1	4	0	1	5	0	0
24	37901014	.	A	G	4	3	7	0	0	7	0	0
24	37901035	.	T	G	2	4	6	0	0	6	0	0
24	37901178	.	C	T	10	5	15	0	0	15	0	0
24	37941862	.	C	T	0	8	8	0	6	14	0	0
24	37941958	.	A	G	11	11	22	0	0	22	0	0
24	37942032	.	C	T	6	9	15	0	1	16	0	0
24	37942183	.	A	T	5	3	8	0	0	8	0	0
24	38073271	.	G	A	1	2	3	0	0	3	0	0
24	38190768	.	G	A	2	2	4	0	0	4	0	0
24	38190789	.	C	T	2	2	4	0	0	4	0	0
24	38191537	.	C	T	1	6	7	0	0	7	0	0
24	38191841	.	C	T	5	4	9	0	0	9	0	0
24	38191900	.	A	G	2	3	5	0	2	7	0	0
24	38369559	.	T	A	4	6	10	0	0	10	0	0
24	38369819	.	A	G	4	4	8	0	1	9	0	0
24	38369873	.	G	A	4	5	9	0	0	9	0	0
24	38370325	.	A	G	0	2	2	0	2	4	0	0
24	38370404	.	T	A	3	3	6	0	1	8	1	0
24	38815105	.	T	A	4	6	10	0	1	11	0	0
24	38816010	.	G	T	3	6	9	0	0	9	0	0
24	39052386	.	A	G	1	2	3	0	0	3	0	0
24	39075534	.	T	C	1	2	3	0	0	3	0	0
24	39151004	.	A	T	1	3	4	0	1	5	0	0
24	39151040	.	C	T	2	2	4	0	1	5	0	0
24	39151637	.	G	C	5	4	9	0	0	9	0	0
24	39151675	.	T	C	3	2	5	0	0	5	0	0
24	39151796	.	A	G	4	2	6	0	0	6	0	0
24	39152001	.	A	G	2	3	5	0	0	5	0	0
24	39152523	.	A	G	1	3	4	0	1	5	0	0
24	39153635	.	T	C	1	4	5	0	0	5	0	0
24	39153647	.	G	A	1	4	5	0	0	5	0	0
24	39153857	.	G	T	1	3	4	0	0	4	0	0
24	39153890	.	A	G	4	1	5	0	2	7	0	0
24	39153911	.	G	T	6	0	6	0	0	6	0	0
24	39153995	.	A	G	8	6	14	0	0	14	0	0
24	39154001	.	C	T	8	5	13	0	0	13	0	0
24	39154044	.	G	A	9	8	17	0	3	20	0	0
24	39154315	.	C	T	15	25	40	0	2	42	0	0
24	39154551	.	C	A	16	15	31	0	0	31	0	0
24	39154620	.	C	T	18	12	30	0	1	31	0	0
24	39154865	.	C	A	16	13	29	0	2	31	0	0
24	39154892	.	T	G	12	11	23	0	1	24	0	0
24	39172141	.	T	C	12	18	30	0	0	30	0	0
24	39172222	.	A	G	15	7	22	0	1	23	0	0
24	39174437	.	T	C	3	2	5	0	2	7	0	0
24	39174570	.	C	T	33	33	66	0	3	69	0	0
24	39175002	.	A	C	16	12	28	0	3	31	0	0
24	39175044	.	A	G	15	27	42	0	1	43	0	0
24	39175047	.	T	C	16	25	41	0	1	42	0	0
24	39175083	.	C	G	19	19	38	0	4	42	0	0
24	39175109	.	T	A	29	20	49	0	2	51	0	0
24	39175143	.	C	T	31	27	58	0	1	59	0	0
24	39175207	.	A	G	26	2	28	0	32	60	0	0
24	39178516	.	T	G	3	6	9	0	0	9	0	0
24	39178591	.	C	A	0	5	5	0	2	7	0	0
24	39178627	.	C	A	0	3	3	0	2	5	0	0
24	39180594	.	A	G	1	3	4	0	0	4	0	0
24	39180637	.	T	G	1	2	3	0	0	3	0	0
24	39322945	.	G	T	0	3	3	0	7	10	0	0
24	39323791	.	C	T	5	4	9	0	0	9	0	0
24	39333916	.	C	T	5	2	7	0	0	7	0	0
24	39333972	.	A	C	18	15	33	0	0	33	0	0
24	39334054	.	A	G	23	15	38	0	0	38	0	0
24	39334187	.	G	A	1	11	12	0	24	36	0	0
24	39334388	.	A	G	22	23	45	0	4	49	0	0
24	39334400	.	G	A	0	25	25	0	25	50	0	0
24	39510079	.	C	T	3	2	5	0	0	5	0	0
24	39510891	.	T	C	6	3	9	0	0	9	0	0
24	39511016	.	T	C	7	4	11	0	0	11	0	0
24	39511034	.	G	A	9	4	13	0	0	13	0	0
24	39511157	.	G	A	10	4	14	0	1	15	0	0
24	39514056	.	T	C	1	1	2	0	0	2	0	0
24	39514296	.	C	G	5	3	8	0	1	9	0	0
24	39533836	.	C	T	3	2	5	0	0	5	0	0
24	39559356	.	C	T	0	2	2	0	0	2	0	0
24	39579989	.	G	A	0	3	3	0	4	7	0	0
24	39586778	.	A	T	4	1	5	0	0	5	0	0
24	39593009	.	T	C	2	1	3	0	0	3	0	0
24	39593038	.	G	A	0	3	3	0	4	7	0	0
24	39595866	.	A	C	0	3	3	0	0	3	0	0
24	39606237	.	G	A	20	17	37	0	1	38	0	0
24	39610535	.	G	T	4	12	16	0	0	16	0	0
24	39615584	.	C	G	9	1	10	1	0	11	0	0
24	39616170	.	C	A	7	9	16	0	0	16	0	0
24	39638642	.	G	A	6	8	14	0	2	16	0	0
24	39642072	.	A	T	7	3	10	0	1	11	0	0
24	39642220	.	A	G	7	7	14	0	1	15	0	0
24	39642229	.	A	G	8	8	16	0	1	17	0	0
24	39642336	.	C	A	6	7	13	0	0	13	0	0
24	39642361	.	G	T	7	7	14	0	1	15	0	0
24	39644259	.	T	C	3	2	5	0	1	6	0	0
24	39646762	.	C	T	10	8	18	0	0	18	0	0
24	39647021	.	C	T	2	2	4	0	0	4	0	0
24	39647042	.	G	C	6	8	14	0	0	14	0	0
24	39648806	.	C	T	2	13	15	0	0	15	0	0
24	39651567	.	T	G	23	21	44	0	3	47	0	0
24	39651612	.	A	T	8	19	27	0	1	28	0	0
24	39653626	.	G	A	27	15	42	7	0	49	0	0
24	39660219	.	C	T	2	1	3	0	0	3	0	0
24	39662074	.	T	C	1	0	1	0	0	1	0	0
24	39663197	.	A	G	2	1	3	0	0	3	0	0
24	39667348	.	T	C	6	4	10	0	1	11	0	0
24	39778970	.	C	T	3	2	5	0	0	5	0	0
24	39779108	.	G	T	4	2	6	0	0	6	0	0
24	40001569	.	T	C	4	3	7	0	0	7	0	0
24	40001698	.	C	T	5	3	8	0	0	8	0	0
24	41290550	.	G	A	1	1	2	0	0	2	0	0
24	41291588	.	C	T	1	2	3	0	0	3	0	0
24	41293409	.	G	A	2	5	7	0	0	7	0	0
24	41299560	.	T	C	5	4	9	0	0	9	0	0
24	41299597	.	A	C	3	4	7	0	0	7	0	0
24	41299603	.	T	A	3	3	6	0	0	6	0	0
24	41317090	.	A	T	22	3	25	0	10	35	0	0
24	41317350	.	G	C	3	0	3	0	14	17	0	0
24	41473627	.	G	A	1	0	1	0	0	1	0	0
24	41781968	.	C	T	1	1	2	0	0	2	0	0
24	41781988	.	G	A	1	1	2	0	0	2	0	0
24	41786281	.	C	G	1	2	3	0	0	3	0	0
24	41786304	.	G	A	1	3	4	0	0	4	0	0
24	41964613	.	A	C	1	1	2	0	0	2	0	0
24	41965147	.	T	C	3	2	5	0	0	5	0	0
24	41969781	.	C	A	2	2	4	0	0	4	0	0
24	41972519	.	A	G	5	4	9	0	0	9	0	0
24	41972633	.	C	G	2	0	2	0	2	4	0	0
24	41972638	.	A	T	2	2	4	0	0	4	0	0
24	41974769	.	C	T	2	3	5	0	1	6	0	0
24	41981865	.	A	G	4	1	5	0	1	6	0	0
24	41986626	.	G	C	1	11	12	0	17	29	0	0
24	41986704	.	C	T	18	26	44	0	2	46	0	0
24	41990532	.	A	G	3	2	5	0	0	5	0	0
24	41990626	.	A	T	1	1	2	0	1	3	0	0
24	41994096	.	G	A	3	3	6	0	0	6	0	0
24	41994147	.	G	T	6	8	14	0	1	15	0	0
24	42083876	.	A	G	3	4	7	0	0	7	0	0
24	42141605	.	G	A	4	2	6	0	1	7	0	0
24	42141770	.	T	C	15	7	22	0	1	23	0	0
24	42153241	.	A	G	7	8	15	0	0	15	0	0
25	136857	.	C	T	21	8	29	0	2	31	0	0
25	137367	.	T	G	5	1	6	0	3	12	3	0
25	146198	.	C	T	6	6	12	0	2	14	0	0
25	146237	.	G	A	5	8	13	0	0	13	0	0
25	146282	.	C	T	2	3	5	0	0	5	0	0
25	146778	.	C	T	3	5	8	0	0	8	0	0
25	146918	.	G	A	6	7	13	0	0	13	0	0
25	158958	.	C	T	1	1	2	0	0	2	0	0
25	160490	.	C	T	3	3	6	0	0	6	0	0
25	187121	.	G	A	0	1	1	0	1	2	0	0
25	187241	.	T	G	4	2	6	0	1	7	0	0
25	241694	.	C	T	2	3	5	0	0	5	0	0
25	241695	.	A	G	2	3	5	0	0	5	0	0
25	244115	.	C	T	4	12	16	0	0	16	0	0
25	244305	.	G	C	2	6	8	0	1	9	0	0
25	265570	.	A	G	1	2	3	0	1	4	0	0
25	314758	.	T	A	8	5	13	0	0	13	0	0
25	314781	.	A	T	8	5	13	0	0	13	0	0
25	314962	.	G	A	4	2	6	0	0	6	0	0
25	314964	.	A	G	4	2	6	0	0	6	0	0
25	315124	.	G	C	2	3	5	0	0	5	0	0
25	315157	.	C	T	2	3	5	0	0	5	0	0
25	403935	.	T	G	1	2	3	0	0	3	0	0
25	469932	.	G	T	32	19	51	0	0	51	0	0
25	469983	.	C	T	10	4	14	0	1	15	0	0
25	472843	.	A	T	4	1	5	0	0	5	0	0
25	474766	.	G	C	11	9	20	0	3	23	0	0
25	474938	.	T	A	19	19	38	0	3	41	0	0
25	474981	.	A	C	29	15	44	0	6	51	1	0
25	474983	.	A	C	19	30	49	0	2	51	0	0
25	485418	.	T	A	5	17	22	0	1	23	0	0
25	485437	.	C	T	22	10	32	0	0	32	0	0
25	485653	.	A	G	38	16	54	0	1	55	0	0
25	485772	.	C	A	13	18	31	0	1	32	0	0
25	485802	.	T	C	20	15	35	0	1	36	0	0
25	485863	.	A	T	23	20	43	0	2	45	0	0
25	486276	.	A	T	13	16	29	0	1	30	0	0
25	486284	.	G	A	12	15	27	0	4	31	0	0
25	486363	.	T	G	17	6	23	0	1	24	0	0
25	487045	.	C	T	8	4	12	0	3	15	0	0
25	487360	.	C	T	0	3	3	0	7	10	0	0
25	488817	.	G	T	5	5	10	0	0	10	0	0
25	489904	.	G	T	1	2	3	0	1	4	0	0
25	495366	.	G	A	1	1	2	0	0	2	0	0
25	505214	.	C	T	1	2	3	0	0	3	0	0
25	626817	.	C	T	1	1	2	0	0	2	0	0
25	640440	.	G	A	0	3	3	0	1	4	0	0
25	663178	.	C	T	1	0	1	0	0	1	0	0
25	663214	.	C	T	4	2	6	0	2	8	0	0
25	663284	.	G	A	0	1	1	0	1	2	0	0
25	763197	.	C	T	2	5	7	0	0	7	0	0
25	763774	.	T	C	2	2	4	0	0	4	0	0
25	764745	.	G	A	17	12	29	0	3	32	0	0
25	769484	.	A	G	1	4	5	0	0	5	0	0
25	1088800	.	A	G	2	2	4	0	0	4	0	0
25	1091760	.	A	G	5	8	13	0	0	13	0	0
25	1091806	.	G	A	2	1	3	0	0	3	0	0
25	1092442	.	C	A	0	6	6	0	5	11	0	0
25	1093526	.	A	G	5	4	9	0	1	10	0	0
25	1094460	.	T	G	7	5	12	0	0	12	0	0
25	1101431	.	A	G	2	1	3	0	0	3	0	0
25	1101659	.	A	G	1	4	5	0	0	5	0	0
25	1103369	.	G	T	1	2	3	0	0	3	0	0
25	1103486	.	C	T	2	0	2	0	1	3	0	0
25	1106247	.	C	G	1	2	3	0	0	3	0	0
25	1107992	.	G	A	4	2	6	0	0	6	0	0
25	1132496	.	C	G	6	4	10	0	0	10	0	0
25	1132611	.	A	T	8	7	15	0	1	16	0	0
25	1133793	.	G	A	0	9	9	0	14	23	0	0
25	1133797	.	T	G	9	11	20	0	2	22	0	0
25	1220400	.	G	T	1	1	2	0	0	2	0	0
25	1339403	.	C	T	7	4	11	0	1	12	0	0
25	1339601	.	G	T	0	3	3	0	3	6	0	0
25	1339760	.	C	T	3	2	5	0	1	6	0	0
25	1340088	.	T	C	1	1	2	0	2	4	0	0
25	1340215	.	G	A	3	7	10	0	1	11	0	0
25	1592111	.	G	A	4	8	12	0	1	13	0	0
25	1608857	.	C	G	0	2	2	0	0	2	0	0
25	1624547	.	C	A	8	9	17	0	0	17	0	0
25	1624777	.	G	A	10	13	23	0	2	25	0	0
25	1635419	.	G	A	10	6	16	0	1	17	0	0
25	1635714	.	C	G	17	6	23	0	1	24	0	0
25	1635783	.	G	A	9	16	25	0	4	29	0	0
25	1635786	.	C	T	0	14	14	0	14	28	0	0
25	1635879	.	G	A	9	6	15	0	0	15	0	0
25	1639932	.	G	T	5	3	8	0	1	9	0	0
25	1642319	.	C	A	3	4	7	0	0	7	0	0
25	1652138	.	C	T	0	2	2	0	2	4	0	0
25	1652294	.	G	A	1	3	4	0	0	4	0	0
25	1652591	.	A	G	1	4	5	0	0	5	0	0
25	1655502	.	G	A	1	2	3	0	0	3	0	0
25	1655535	.	G	C	1	0	1	0	0	1	0	0
25	1655537	.	G	A	1	0	1	0	0	1	0	0
25	2003351	.	C	A	4	2	6	0	0	6	0	0
25	2264302	.	G	A	1	3	4	0	0	4	0	0
25	2273945	.	C	T	0	2	2	0	0	2	0	0
25	2276704	.	C	T	0	3	3	0	2	5	0	0
25	2276770	.	T	C	3	4	7	0	0	7	0	0
25	2276781	.	A	G	2	2	4	0	1	5	0	0
25	2282846	.	A	C	6	12	18	0	0	18	0	0
25	2286066	.	C	T	4	9	13	0	0	13	0	0
25	2286120	.	G	A	3	7	10	0	0	10	0	0
25	2286328	.	T	G	1	0	1	0	0	1	0	0
25	2286376	.	T	C	1	3	4	0	0	4	0	0
25	2286502	.	T	C	6	10	16	0	0	16	0	0
25	2286600	.	A	T	11	13	24	0	0	24	0	0
25	2286762	.	A	C	12	6	18	0	4	22	0	0
25	2286798	.	A	C	19	13	32	0	1	33	0	0
25	2286837	.	C	T	17	16	33	0	2	35	0	0
25	2286841	.	C	A	18	15	33	0	0	33	0	0
25	2702718	.	A	G	2	0	2	0	3	5	0	0
25	2702722	.	A	G	2	3	5	0	0	5	0	0
25	2702767	.	A	G	0	5	5	0	0	5	0	0
25	3451196	.	T	A	2	14	16	0	1	17	0	0
25	3451250	.	A	C	10	15	25	0	1	26	0	0
25	3451760	.	A	C	2	4	6	0	0	6	0	0
25	3451779	.	A	G	1	2	3	0	0	3	0	0
25	3454644	.	G	A	3	4	7	0	0	7	0	0
25	3454719	.	G	A	6	3	9	0	0	9	0	0
25	3457756	.	G	A	1	2	3	0	1	4	0	0
25	3513274	.	G	A	1	1	2	0	0	2	0	0
25	3557470	.	G	A	0	3	3	0	3	6	0	0
25	3560066	.	G	A	0	1	1	0	0	1	0	0
25	3562517	.	A	C	4	4	8	0	0	8	0	0
25	3573283	.	A	G	3	4	7	0	0	7	0	0
25	3573350	.	G	A	6	7	13	0	0	13	0	0
25	3573624	.	G	C	3	7	10	0	0	10	0	0
25	3573635	.	A	T	1	6	7	0	2	9	0	0
25	3573796	.	C	A	0	8	8	0	10	18	0	0
25	3573815	.	G	A	7	8	15	0	1	16	0	0
25	3579429	.	A	C	8	4	12	0	1	13	0	0
25	3579459	.	C	A	7	4	11	0	0	11	0	0
25	3582443	.	A	G	1	8	9	0	0	9	0	0
25	3583975	.	C	T	2	1	3	0	0	3	0	0
25	3583983	.	G	T	2	1	3	0	0	3	0	0
25	3584053	.	G	A	3	9	12	0	1	13	0	0
25	3584803	.	C	T	0	5	5	0	4	9	0	0
25	3590931	.	G	A	0	2	2	0	1	3	0	0
25	3594911	.	T	C	1	3	4	0	1	5	0	0
25	3595118	.	G	A	2	2	4	0	1	5	0	0
25	3595120	.	C	T	0	2	2	0	3	5	0	0
25	3596361	.	T	G	2	3	5	0	0	5	0	0
25	3682789	.	G	A	3	7	10	0	2	12	0	0
25	3682795	.	A	C	4	8	12	0	1	13	0	0
25	3683247	.	G	A	6	14	20	0	1	21	0	0
25	3683297	.	C	T	9	14	23	0	1	24	0	0
25	3683386	.	C	T	8	19	27	0	1	28	0	0
25	3683527	.	G	A	0	7	7	0	12	19	0	0
25	3683796	.	A	T	2	3	5	0	0	5	0	0
25	3683887	.	C	T	11	6	17	0	1	18	0	0
25	3684141	.	C	A	19	17	36	0	3	39	0	0
25	3684148	.	A	G	20	17	37	0	4	41	0	0
25	3684195	.	G	A	0	13	13	0	14	27	0	0
25	3684409	.	G	T	0	10	10	1	42	53	0	0
25	3684741	.	A	G	20	28	48	0	1	49	0	0
25	3708429	.	G	T	8	2	10	0	1	11	0	0
25	3713724	.	T	C	0	2	2	0	0	2	0	0
25	3719888	.	G	T	8	4	12	0	1	13	0	0
25	3750509	.	T	A	2	2	4	0	0	4	0	0
25	3750545	.	A	T	2	11	13	0	1	14	0	0
25	3750559	.	T	C	5	13	18	0	2	20	0	0
25	3750655	.	C	T	8	14	22	0	4	26	0	0
25	3754606	.	G	A	2	4	6	0	0	6	0	0
25	3755271	.	G	A	1	7	8	0	0	8	0	0
25	3755303	.	A	G	1	2	3	0	1	4	0	0
25	3757584	.	G	A	1	1	2	0	0	2	0	0
25	3757606	.	G	A	2	1	3	0	0	3	0	0
25	3772165	.	T	C	1	3	4	0	0	4	0	0
25	3784679	.	C	T	4	0	4	0	1	5	0	0
25	3789004	.	G	A	1	2	3	0	4	7	0	0
25	3790279	.	G	A	0	4	4	0	2	6	0	0
25	3792945	.	A	G	7	1	8	0	1	9	0	0
25	3801505	.	T	G	3	2	5	0	1	6	0	0
25	3801726	.	A	G	11	9	20	0	0	20	0	0
25	3801737	.	T	C	11	12	23	0	2	25	0	0
25	3804410	.	A	G	2	3	5	0	0	5	0	0
25	3807526	.	C	T	0	2	2	0	3	5	0	0
25	3881747	.	T	A	2	2	4	0	0	4	0	0
25	3887287	.	C	T	0	4	4	0	3	7	0	0
25	3891940	.	A	T	11	8	19	0	1	20	0	0
25	4126771	.	G	A	1	2	3	0	0	3	0	0
25	4129165	.	C	A	1	3	4	0	0	4	0	0
25	4133498	.	T	C	15	17	32	0	1	33	0	0
25	4133647	.	C	A	10	17	27	0	2	29	0	0
25	4133648	.	T	C	12	1	13	0	16	29	0	0
25	4133708	.	T	G	21	4	25	0	1	26	0	0
25	4133720	.	C	A	17	4	21	0	0	21	0	0
25	4136001	.	C	A	5	6	11	0	1	12	0	0
25	4136292	.	A	G	1	6	7	0	0	7	0	0
25	4141629	.	G	A	2	1	3	0	0	3	0	0
25	4460441	.	G	A	1	1	2	0	1	3	0	0
25	4689524	.	A	G	2	3	5	0	0	5	0	0
25	4848808	.	C	T	0	1	1	0	0	1	0	0
25	4849422	.	T	A	1	0	1	0	0	1	0	0
25	4850989	.	G	A	1	4	5	0	1	6	0	0
25	4877781	.	C	A	2	4	6	0	1	7	0	0
25	4879937	.	T	A	2	2	4	0	0	4	0	0
25	4879964	.	C	T	2	5	7	0	1	8	0	0
25	4879973	.	A	C	3	3	6	0	0	6	0	0
25	4880030	.	G	A	1	3	4	0	0	4	0	0
25	4880138	.	A	C	5	2	7	0	1	8	0	0
25	4880144	.	A	G	6	0	6	0	2	8	0	0
25	4880363	.	C	T	3	6	9	0	0	9	0	0
25	4880372	.	T	A	3	5	8	0	0	8	0	0
25	4891272	.	G	A	31	25	56	0	2	58	0	0
25	4891286	.	A	T	30	28	58	0	3	61	0	0
25	4891350	.	C	T	19	41	60	0	2	62	0	0
25	4891538	.	A	G	15	29	44	0	4	48	0	0
25	4891597	.	G	A	14	27	41	0	0	41	0	0
25	4891762	.	C	G	11	21	32	0	0	32	0	0
25	4892172	.	G	T	11	19	30	0	4	34	0	0
25	4892203	.	T	A	10	23	33	0	2	35	0	0
25	4892348	.	A	G	6	14	20	0	2	22	0	0
25	4892356	.	G	A	9	10	19	0	0	19	0	0
25	4892537	.	A	G	3	8	11	0	1	12	0	0
25	4892830	.	C	T	2	8	10	0	0	10	0	0
25	4892982	.	T	C	1	3	4	0	0	4	0	0
25	4892985	.	T	C	1	3	4	0	0	4	0	0
25	4893398	.	T	C	8	4	12	0	0	12	0	0
25	4893435	.	C	T	8	6	14	0	0	14	0	0
25	4896182	.	A	G	1	5	6	0	0	6	0	0
25	4902538	.	A	T	1	3	4	0	0	4	0	0
25	5025212	.	T	A	1	2	3	0	0	3	0	0
25	5702160	.	G	T	1	1	2	0	0	2	0	0
25	5709328	.	T	G	2	1	3	0	0	3	0	0
25	5713704	.	G	C	0	0	0	0	1	1	0	0
25	5777674	.	G	A	0	3	3	0	1	4	0	0
25	5780633	.	T	C	0	2	2	0	0	2	0	0
25	5783309	.	T	C	0	2	2	0	0	2	0	0
25	5783523	.	C	T	10	8	18	0	0	18	0	0
25	5783598	.	T	A	7	10	17	0	0	17	0	0
25	5786668	.	T	C	3	9	12	0	1	13	0	0
25	5786755	.	T	C	2	2	4	0	0	4	0	0
25	5787684	.	C	T	12	19	31	0	0	31	0	0
25	5787966	.	C	A	6	13	19	0	2	21	0	0
25	5788310	.	T	C	3	2	5	0	1	6	0	0
25	5788321	.	C	T	4	4	8	0	1	9	0	0
25	5788384	.	C	T	8	6	14	0	0	14	0	0
25	5788432	.	A	G	9	8	17	0	0	17	0	0
25	5788519	.	G	T	6	8	14	0	0	14	0	0
25	5788670	.	C	T	0	5	5	0	9	14	0	0
25	5788783	.	G	C	8	5	13	0	0	13	0	0
25	5788838	.	A	G	3	2	5	0	1	6	0	0
25	5788842	.	C	T	0	2	2	0	3	5	0	0
25	5789734	.	G	C	3	2	5	0	0	5	0	0
25	5789937	.	A	C	2	2	4	0	0	4	0	0
25	5790050	.	T	G	2	4	6	0	0	6	0	0
25	5835564	.	T	C	1	2	3	0	0	3	0	0
25	5936080	.	C	T	6	11	17	0	2	19	0	0
25	5936556	.	A	T	10	9	19	0	0	19	0	0
25	5936725	.	T	A	16	11	27	0	3	30	0	0
25	5936764	.	C	A	10	13	23	0	0	23	0	0
25	5936886	.	C	T	0	7	7	0	7	14	0	0
25	5937092	.	C	T	0	4	4	0	8	12	0	0
25	5937113	.	G	A	6	3	9	0	0	9	0	0
25	5937424	.	T	G	4	3	7	0	2	9	0	0
25	5937516	.	C	T	0	6	6	0	9	15	0	0
25	5990107	.	A	C	19	17	36	0	3	39	0	0
25	6016708	.	G	A	3	3	6	0	0	6	0	0
25	6016829	.	C	T	7	7	14	0	0	14	0	0
25	6017382	.	A	T	8	5	13	0	2	15	0	0
25	6017623	.	C	T	0	2	2	0	0	2	0	0
25	6025326	.	G	T	4	2	6	0	0	6	0	0
25	6028947	.	G	A	2	2	4	0	0	4	0	0
25	6065026	.	A	T	1	5	6	0	0	6	0	0
25	6069190	.	G	A	1	2	3	0	0	3	0	0
25	6152324	.	G	A	1	5	6	0	0	6	0	0
25	6152363	.	A	C	1	3	4	0	0	4	0	0
25	6152487	.	A	G	3	3	6	0	0	6	0	0
25	6152501	.	A	G	1	0	1	0	5	6	0	0
25	6205703	.	C	T	16	12	28	0	4	32	0	0
25	6216349	.	A	C	2	9	11	0	0	11	0	0
25	6222555	.	G	A	2	4	6	0	1	7	0	0
25	6222600	.	C	A	0	7	7	0	4	11	0	0
25	6228616	.	G	A	6	7	13	0	0	13	0	0
25	6228651	.	A	G	4	10	14	0	1	15	0	0
25	6230616	.	G	A	5	12	17	0	2	19	0	0
25	6230721	.	T	C	4	1	5	0	1	6	0	0
25	6230736	.	T	G	2	0	2	0	0	2	0	0
25	6230935	.	T	C	6	4	10	0	1	11	0	0
25	6233485	.	C	T	3	6	9	0	0	9	0	0
25	6307064	.	T	C	2	10	12	0	2	14	0	0
25	6312955	.	A	C	15	17	32	0	1	33	0	0
25	6313069	.	G	A	0	7	7	0	9	16	0	0
25	6313075	.	T	C	8	3	11	0	0	11	0	0
25	6337111	.	G	A	0	15	15	0	13	28	0	0
25	6337136	.	C	T	15	22	37	0	2	39	0	0
25	6337253	.	A	T	19	24	43	0	0	43	0	0
25	6337271	.	C	A	17	24	41	0	2	43	0	0
25	6351282	.	A	G	2	9	11	0	0	11	0	0
25	6351283	.	C	G	2	9	11	0	0	11	0	0
25	6357227	.	C	T	1	2	3	0	0	3	0	0
25	6357245	.	C	T	0	1	1	0	1	2	0	0
25	6357451	.	T	C	3	4	7	0	0	7	0	0
25	6360225	.	T	C	1	2	3	0	1	4	0	0
25	6431914	.	C	A	2	2	4	0	1	5	0	0
25	6435447	.	C	T	1	3	4	0	0	4	0	0
25	6435955	.	A	G	5	5	10	0	0	10	0	0
25	6436199	.	G	C	9	7	16	0	2	18	0	0
25	6437716	.	A	G	1	2	3	0	0	3	0	0
25	6437735	.	A	G	1	0	1	0	1	2	0	0
25	6437945	.	C	T	1	1	2	0	0	2	0	0
25	7324580	.	C	T	2	1	3	0	0	3	0	0
25	7334915	.	T	C	5	12	17	0	0	17	0	0
25	7334957	.	G	A	0	17	17	0	11	28	0	0
25	7334987	.	G	C	6	8	14	0	0	14	0	0
25	7428944	.	T	C	1	9	10	0	1	11	0	0
25	7428971	.	A	T	2	5	7	0	1	8	0	0
25	7429028	.	C	A	1	0	1	0	0	1	0	0
25	7431430	.	A	G	0	0	0	0	5	5	0	0
25	7454578	.	T	C	2	2	4	0	0	4	0	0
25	7456535	.	C	A	1	1	2	0	0	2	0	0
25	7456843	.	G	A	0	2	2	0	0	2	0	0
25	7456860	.	G	A	0	0	0	0	1	1	0	0
25	7480949	.	G	C	4	3	7	0	1	8	0	0
25	7481063	.	C	A	6	10	16	0	1	17	0	0
25	7481123	.	G	A	0	14	14	0	3	17	0	0
25	7481159	.	C	T	11	6	17	0	3	20	0	0
25	7485073	.	G	A	2	3	5	0	0	5	0	0
25	7485527	.	C	T	7	13	20	0	1	21	0	0
25	7485588	.	A	G	2	2	4	0	0	4	0	0
25	7487809	.	T	C	21	24	45	0	2	47	0	0
25	7488310	.	T	A	0	15	15	0	0	15	0	0
25	7488749	.	T	G	17	18	35	0	0	35	0	0
25	7488753	.	C	T	16	18	34	0	2	36	0	0
25	7488812	.	G	A	28	17	45	0	3	48	0	0
25	7488813	.	G	T	28	17	45	0	3	48	0	0
25	7489034	.	G	A	2	28	30	0	32	62	0	0
25	7489082	.	A	G	27	21	48	0	4	52	0	0
25	7489085	.	G	C	27	19	46	0	5	51	0	0
25	7502022	.	G	C	14	9	23	0	0	23	0	0
25	7502201	.	G	A	5	2	7	0	0	7	0	0
25	7502204	.	T	G	5	2	7	0	0	7	0	0
25	7502241	.	G	A	0	2	2	0	0	2	0	0
25	7502251	.	C	T	4	0	4	0	2	6	0	0
25	7520131	.	G	A	1	3	4	0	0	4	0	0
25	7520753	.	G	T	2	2	4	0	0	4	0	0
25	7520796	.	A	T	2	2	4	0	0	4	0	0
25	7562272	.	C	A	1	5	6	0	0	6	0	0
25	7562301	.	T	A	5	10	15	0	0	15	0	0
25	7562418	.	G	A	0	3	3	0	9	12	0	0
25	7562921	.	C	T	12	17	29	0	3	32	0	0
25	7562925	.	A	T	14	19	33	0	0	33	0	0
25	7562975	.	A	G	17	21	38	0	3	41	0	0
25	7586915	.	A	G	2	1	3	0	1	4	0	0
25	7589915	.	A	G	5	0	5	0	15	20	0	0
25	7589951	.	C	T	6	10	16	0	2	18	0	0
25	7590702	.	C	T	2	5	7	0	0	7	0	0
25	7590731	.	A	G	4	5	9	0	0	9	0	0
25	7667923	.	G	A	6	3	9	0	0	9	0	0
25	7667943	.	T	C	3	4	7	0	1	8	0	0
25	7668161	.	A	G	3	1	4	0	0	4	0	0
25	7668166	.	C	T	0	3	3	0	1	4	0	0
25	7678180	.	A	T	22	15	37	0	0	37	0	0
25	7693511	.	T	C	2	3	5	0	0	5	0	0
25	7719778	.	A	G	0	2	2	0	0	2	0	0
25	7892297	.	T	C	1	3	4	0	0	4	0	0
25	8478814	.	T	C	3	19	22	0	2	24	0	0
25	8482771	.	G	A	1	1	2	0	0	2	0	0
25	8482837	.	C	T	1	7	8	0	0	8	0	0
25	8486622	.	C	T	0	8	8	0	5	13	0	0
25	8486631	.	A	C	4	0	4	0	9	13	0	0
25	8486705	.	A	G	1	6	7	0	2	9	0	0
25	8486736	.	A	G	1	2	3	0	0	3	0	0
25	8486884	.	T	A	3	9	12	0	0	12	0	0
25	8495246	.	A	G	1	3	4	0	0	4	0	0
25	8497786	.	G	A	1	2	3	0	0	3	0	0
25	8627940	.	G	A	8	8	16	0	1	17	0	0
25	8627943	.	T	C	4	11	15	0	1	16	0	0
25	8628139	.	G	C	3	3	6	0	2	8	0	0
25	8630910	.	A	G	1	0	1	0	2	3	0	0
25	8631015	.	A	T	2	0	2	0	0	2	0	0
25	8631017	.	C	T	0	2	2	0	0	2	0	0
25	8642262	.	C	T	0	3	3	0	0	3	0	0
25	8740545	.	G	A	0	0	0	0	2	2	0	0
25	8740550	.	G	C	1	0	1	0	1	2	0	0
25	8741303	.	C	T	1	5	6	0	0	6	0	0
25	8741469	.	T	A	0	1	1	0	1	2	0	0
25	8741471	.	C	T	1	1	2	0	0	2	0	0
25	8741758	.	C	T	1	2	3	0	0	3	0	0
25	8741759	.	G	T	0	2	2	0	1	3	0	0
25	8741877	.	G	C	4	9	13	0	0	13	0	0
25	8741968	.	G	C	6	11	17	0	1	18	0	0
25	8742126	.	T	C	15	12	27	1	3	31	0	0
25	8742148	.	T	A	15	11	26	0	2	28	0	0
25	8756099	.	T	C	6	14	20	0	0	20	0	0
25	8757038	.	A	C	3	0	3	0	6	9	0	0
25	8767925	.	A	G	3	14	17	0	0	17	0	0
25	8834967	.	T	G	1	1	2	0	0	2	0	0
25	8834968	.	G	C	1	0	1	0	1	2	0	0
25	8908297	.	C	T	0	2	2	0	1	3	0	0
25	8925678	.	C	A	2	2	4	0	0	4	0	0
25	8948978	.	C	A	5	3	8	0	1	9	0	0
25	8949062	.	A	T	7	5	12	0	0	12	0	0
25	8949124	.	C	T	3	7	10	0	1	11	0	0
25	9678666	.	G	A	1	2	3	0	1	4	0	0
25	9679242	.	G	A	2	3	5	0	0	5	0	0
25	10482925	.	A	T	11	3	14	0	0	14	0	0
25	11704574	.	G	A	1	2	3	0	0	3	0	0
25	11796579	.	T	A	17	8	25	0	2	27	0	0
25	11796728	.	A	T	12	9	21	0	2	23	0	0
25	11796860	.	T	C	8	7	15	0	0	15	0	0
25	11796987	.	A	G	5	5	10	0	0	10	0	0
25	11797056	.	G	C	3	4	7	0	0	7	0	0
25	11797550	.	G	T	1	3	4	0	0	4	0	0
25	11797912	.	T	A	1	3	4	0	0	4	0	0
25	11798215	.	A	C	2	2	4	0	1	5	0	0
25	11798227	.	T	A	1	2	3	0	0	3	0	0
25	11798381	.	T	A	3	3	6	0	0	6	0	0
25	11798509	.	A	T	2	2	4	0	2	6	0	0
25	11798511	.	C	A	0	3	3	0	3	6	0	0
25	11798659	.	A	T	1	2	3	0	0	3	0	0
25	11798922	.	A	G	1	2	3	0	0	3	0	0
25	12695449	.	A	T	2	3	5	0	0	5	0	0
25	12717574	.	C	T	2	4	6	0	2	8	0	0
25	12816683	.	G	A	1	0	1	0	1	2	0	0
25	12816913	.	G	A	2	4	6	0	0	6	0	0
25	12818948	.	T	G	2	4	6	0	0	6	0	0
25	12853166	.	G	T	0	2	2	0	1	3	0	0
25	12853211	.	C	T	0	2	2	0	4	6	0	0
25	12853243	.	C	T	3	2	5	0	3	8	0	0
25	12853407	.	A	T	28	23	51	0	2	53	0	0
25	12853519	.	A	G	20	20	40	0	1	41	0	0
25	12853602	.	T	C	20	30	50	0	1	51	0	0
25	12853611	.	T	A	19	32	51	0	0	51	0	0
25	12853691	.	C	T	26	18	44	0	3	47	0	0
25	12853850	.	A	C	7	17	24	0	0	24	0	0
25	12853971	.	T	A	33	11	44	0	1	45	0	0
25	12854016	.	G	A	19	14	33	0	0	33	0	0
25	12854021	.	T	A	17	16	33	0	3	36	0	0
25	12854099	.	C	A	14	20	34	0	1	35	0	0
25	12854112	.	C	T	25	7	32	0	6	38	0	0
25	12854230	.	T	G	18	9	27	0	0	27	0	0
25	12854266	.	A	T	17	11	28	0	1	29	0	0
25	12854279	.	T	G	18	13	31	0	2	33	0	0
25	12854393	.	T	C	12	11	23	0	0	23	0	0
25	12856663	.	G	A	2	3	5	0	0	5	0	0
25	12906814	.	G	A	0	5	5	0	2	7	0	0
25	13332406	.	A	T	34	35	69	0	3	72	0	0
25	13332531	.	C	T	34	32	66	0	4	70	0	0
25	13332693	.	G	A	34	37	71	0	4	75	0	0
25	13333191	.	G	T	38	32	70	0	1	71	0	0
25	13333463	.	G	A	35	32	67	0	11	78	0	0
25	13333508	.	A	T	37	26	63	0	3	66	0	0
25	13333665	.	C	T	27	31	58	2	3	63	0	0
25	13333839	.	A	T	23	15	38	0	6	45	1	0
25	13333986	.	T	A	17	38	55	0	2	57	0	0
25	13334229	.	A	G	18	13	31	0	3	34	0	0
25	13334236	.	T	C	18	15	33	0	1	34	0	0
25	13334269	.	G	A	13	13	26	0	0	26	0	0
25	13334275	.	A	T	14	9	23	0	2	25	0	0
25	13334304	.	T	C	12	0	12	0	4	16	0	0
25	13334487	.	A	T	22	14	36	0	3	39	0	0
25	13334729	.	C	T	25	20	45	0	4	49	0	0
25	13334977	.	A	T	21	25	46	0	2	48	0	0
25	13335012	.	A	G	22	32	54	0	0	55	1	0
25	13335021	.	G	T	26	19	45	0	5	50	0	0
25	13335185	.	A	G	14	10	24	0	1	25	0	0
25	13335225	.	T	C	17	10	27	0	0	27	0	0
25	13335378	.	T	C	11	16	27	0	2	29	0	0
25	13335432	.	T	A	4	11	15	0	0	15	0	0
25	13335441	.	G	A	4	11	15	0	1	16	0	0
25	13335469	.	T	G	9	6	15	0	2	17	0	0
25	13335505	.	C	A	6	5	11	0	1	12	0	0
25	13335558	.	G	T	14	11	25	0	1	26	0	0
25	13335562	.	G	A	13	15	28	0	1	29	0	0
25	13336277	.	G	A	6	11	17	0	2	19	0	0
25	13336323	.	T	G	11	14	25	0	0	25	0	0
25	13336343	.	T	C	16	10	26	0	1	27	0	0
25	13336493	.	A	G	18	15	33	0	0	33	0	0
25	13336545	.	T	C	12	10	22	0	1	23	0	0
25	13336598	.	C	G	18	13	31	0	1	32	0	0
25	13336672	.	G	A	0	2	2	0	1	3	0	0
25	13336815	.	T	A	16	16	32	0	0	32	0	0
25	13336846	.	T	C	15	7	22	0	1	23	0	0
25	13336861	.	A	G	14	5	19	0	2	21	0	0
25	13336967	.	T	A	9	9	18	0	2	20	0	0
25	13337272	.	G	A	6	14	20	0	0	20	0	0
25	13337338	.	G	A	3	9	12	0	2	14	0	0
25	13363206	.	C	T	0	0	0	0	1	1	0	0
25	13470123	.	T	C	11	11	22	0	2	24	0	0
25	13470424	.	C	T	12	6	18	0	3	21	0	0
25	13471079	.	A	C	16	16	32	0	1	33	0	0
25	13474362	.	C	G	11	7	18	0	2	20	0	0
25	13478185	.	G	T	0	5	5	0	0	5	0	0
25	13478217	.	T	G	5	9	14	0	0	14	0	0
25	13479710	.	G	A	2	0	2	0	0	2	0	0
25	13484787	.	A	G	2	1	3	0	0	3	0	0
25	13484791	.	T	C	3	0	3	0	0	3	0	0
25	13525848	.	A	T	2	4	6	0	0	6	0	0
25	13525864	.	G	A	3	2	5	0	1	6	0	0
25	13526171	.	A	C	0	3	3	0	0	3	0	0
25	13528361	.	G	A	3	2	5	0	0	5	0	0
25	13529294	.	A	G	3	3	6	0	0	6	0	0
25	13559168	.	T	G	8	6	14	0	0	14	0	0
25	13559194	.	G	A	9	9	18	0	0	18	0	0
25	13559548	.	T	A	5	3	8	0	1	9	0	0
25	13559950	.	G	A	3	4	7	0	0	7	0	0
25	13559953	.	A	T	4	1	5	0	2	7	0	0
25	13560342	.	T	C	5	5	10	0	1	11	0	0
25	13643476	.	G	A	1	9	10	0	1	11	0	0
25	13645911	.	C	T	5	2	7	0	0	7	0	0
25	13685714	.	G	A	3	2	5	0	0	5	0	0
25	13689440	.	G	A	1	3	4	0	1	5	0	0
25	13689945	.	G	A	1	2	3	0	1	4	0	0
25	13689972	.	G	A	1	2	3	0	0	3	0	0
25	13745665	.	A	G	25	27	52	0	1	53	0	0
25	13745776	.	A	G	3	11	14	0	1	15	0	0
25	13750695	.	G	A	0	2	2	0	0	2	0	0
25	13750734	.	T	A	6	2	8	0	0	8	0	0
25	13762759	.	G	C	2	3	5	0	0	5	0	0
25	13763641	.	C	T	0	1	1	0	0	1	0	0
25	13799158	.	A	C	1	5	6	0	1	7	0	0
25	13799172	.	G	A	2	3	5	0	1	6	0	0
25	13799359	.	A	C	2	3	5	0	0	5	0	0
25	13799434	.	T	C	10	19	29	0	0	29	0	0
25	13799458	.	T	C	12	17	29	0	2	31	0	0
25	13799537	.	G	C	11	5	16	0	2	18	0	0
25	13799689	.	C	T	16	11	27	0	2	29	0	0
25	13799830	.	A	G	16	26	42	0	2	44	0	0
25	13801768	.	C	A	6	8	14	0	0	14	0	0
25	13801895	.	G	C	19	13	32	0	2	34	0	0
25	13801933	.	C	T	12	17	29	0	1	30	0	0
25	13802100	.	C	T	17	19	36	0	7	43	0	0
25	13802451	.	A	G	13	14	27	0	2	29	0	0
25	13802673	.	C	T	0	8	8	0	7	15	0	0
25	13802688	.	C	A	10	5	15	0	2	17	0	0
25	13802710	.	C	T	10	6	16	0	1	17	0	0
25	13802876	.	G	A	7	14	21	0	5	26	0	0
25	13802901	.	G	A	18	12	30	0	1	31	0	0
25	13802918	.	A	G	23	10	33	0	1	34	0	0
25	13802940	.	A	T	21	15	36	0	0	36	0	0
25	13803710	.	A	G	6	8	14	0	0	14	0	0
25	13803712	.	T	G	6	7	13	0	1	14	0	0
25	13803895	.	A	G	3	7	10	0	2	12	0	0
25	13804000	.	A	C	4	1	5	0	4	9	0	0
25	13804056	.	C	T	4	8	12	0	3	15	0	0
25	13804093	.	A	G	4	8	12	0	3	15	0	0
25	13804216	.	C	T	6	8	14	0	0	14	0	0
25	13813824	.	G	T	2	1	3	0	0	3	0	0
25	13813827	.	A	G	2	1	3	0	0	3	0	0
25	13816589	.	A	G	1	3	4	0	0	4	0	0
25	13847301	.	C	T	0	8	8	0	8	16	0	0
25	13847533	.	A	G	4	6	10	0	1	11	0	0
25	14017834	.	G	A	0	2	2	0	1	3	0	0
25	14019501	.	G	T	2	6	8	0	0	8	0	0
25	14019879	.	A	T	8	6	14	0	0	14	0	0
25	14019921	.	G	A	0	4	4	0	4	8	0	0
25	14020279	.	G	A	10	16	26	0	0	26	0	0
25	14020806	.	T	A	9	4	13	0	1	14	0	0
25	14033268	.	T	C	16	12	28	0	3	31	0	0
25	14033711	.	T	A	7	5	12	0	2	14	0	0
25	14033719	.	T	C	7	0	7	0	9	16	0	0
25	14033867	.	A	G	2	4	6	0	0	6	0	0
25	14033914	.	G	A	3	3	6	0	0	6	0	0
25	14034240	.	G	C	6	4	10	0	0	10	0	0
25	14034320	.	T	A	7	2	9	0	2	11	0	0
25	14034354	.	T	G	2	6	8	0	0	8	0	0
25	14034620	.	A	G	2	6	8	0	2	10	0	0
25	14034637	.	G	A	5	2	7	0	1	8	0	0
25	14034929	.	G	A	5	2	7	0	1	8	0	0
25	14036187	.	A	T	1	2	3	0	0	3	0	0
25	14125236	.	A	G	0	1	1	0	0	1	0	0
25	14361812	.	C	T	1	2	3	0	0	3	0	0
25	14361815	.	T	C	1	1	2	0	1	3	0	0
25	14365618	.	C	T	7	4	11	0	0	11	0	0
25	14369506	.	A	G	2	3	5	0	0	5	0	0
25	14369587	.	G	T	6	8	14	0	0	15	1	0
25	14369883	.	T	C	12	6	18	0	6	24	0	0
25	14381564	.	A	G	13	12	25	0	2	27	0	0
25	14381583	.	A	G	13	12	25	0	2	27	0	0
25	14387391	.	G	A	1	2	3	0	0	3	0	0
25	14388955	.	A	T	3	4	7	0	0	7	0	0
25	14393438	.	T	C	4	0	4	0	6	10	0	0
25	14393509	.	A	G	3	2	5	0	0	5	0	0
25	14393511	.	G	A	2	3	5	0	0	5	0	0
25	14406494	.	G	A	17	18	35	0	1	36	0	0
25	14406530	.	T	A	12	14	26	0	0	26	0	0
25	14406608	.	A	C	11	10	21	0	0	21	0	0
25	14409642	.	G	A	0	1	1	0	0	1	0	0
25	14702821	.	C	T	3	2	5	0	0	5	0	0
25	14733824	.	C	T	1	2	3	0	0	3	0	0
25	14738132	.	C	T	2	3	5	0	0	5	0	0
25	14738499	.	T	G	3	4	7	0	0	7	0	0
25	14738716	.	T	C	4	2	6	0	2	8	0	0
25	15029575	.	C	T	5	11	16	0	1	17	0	0
25	15029639	.	A	T	8	3	11	0	0	11	0	0
25	15038561	.	C	T	1	3	4	0	0	4	0	0
25	15284862	.	T	C	7	8	15	0	2	17	0	0
25	15284979	.	T	A	8	10	18	0	1	19	0	0
25	15285092	.	T	C	9	7	16	0	0	16	0	0
25	15285105	.	C	A	7	9	16	0	0	16	0	0
25	15285202	.	A	C	12	7	19	0	1	20	0	0
25	15285213	.	G	C	8	13	21	0	0	21	0	0
25	15285255	.	C	A	11	4	15	0	0	15	0	0
25	15285256	.	T	A	4	11	15	0	0	15	0	0
25	15285374	.	A	G	17	11	28	0	0	29	1	0
25	15285384	.	G	A	18	10	28	0	2	30	0	0
25	15285470	.	C	T	8	6	14	0	0	14	0	0
25	15285471	.	C	A	6	6	12	0	2	14	0	0
25	15350058	.	A	G	2	2	4	0	0	4	0	0
25	15351088	.	A	G	10	10	20	0	1	21	0	0
25	15472103	.	C	T	11	6	17	0	0	17	0	0
25	15472286	.	C	A	6	13	19	0	0	19	0	0
25	15477186	.	G	A	0	3	3	0	3	6	0	0
25	15478092	.	A	G	3	11	14	0	0	14	0	0
25	15478474	.	T	C	2	1	3	0	0	3	0	0
25	15480676	.	G	A	1	7	8	0	9	17	0	0
25	15480712	.	T	C	17	16	33	0	1	34	0	0
25	15481040	.	C	T	11	3	14	0	0	14	0	0
25	15481481	.	T	G	10	13	23	0	2	25	0	0
25	15482014	.	A	T	9	7	16	0	0	16	0	0
25	16785151	.	A	T	0	2	2	0	0	2	0	0
25	16963161	.	T	C	2	4	6	0	0	6	0	0
25	16963173	.	T	C	0	3	3	0	1	4	0	0
25	16963906	.	T	C	3	2	5	0	0	5	0	0
25	17850204	.	T	C	5	2	7	0	0	7	0	0
25	18908651	.	A	G	5	2	7	0	2	9	0	0
25	18908661	.	A	G	7	3	10	0	0	10	0	0
25	18961695	.	C	T	1	2	3	0	0	3	0	0
25	18961724	.	C	T	1	2	3	0	0	3	0	0
25	18961792	.	A	T	1	3	4	0	0	4	0	0
25	18977092	.	A	G	4	3	7	0	0	7	0	0
25	18977429	.	A	G	2	3	5	0	0	5	0	0
25	19127512	.	C	T	0	1	1	0	0	1	0	0
25	19357346	.	A	C	28	23	51	0	4	55	0	0
25	19357359	.	T	G	25	23	48	0	3	51	0	0
25	19357782	.	G	C	17	14	31	0	3	34	0	0
25	19357800	.	T	C	17	15	32	0	0	32	0	0
25	19357934	.	G	A	10	10	20	0	1	21	0	0
25	19358565	.	C	T	3	2	5	0	0	5	0	0
25	19358924	.	T	A	1	9	10	0	2	12	0	0
25	19359314	.	G	A	3	3	6	0	0	6	0	0
25	19359402	.	A	G	5	2	7	0	0	7	0	0
25	19359640	.	C	T	0	12	12	0	4	16	0	0
25	19359734	.	A	G	8	6	14	0	0	14	0	0
25	19372175	.	C	T	5	6	11	0	1	12	0	0
25	19373330	.	G	A	4	2	6	0	0	6	0	0
25	19442955	.	G	A	3	1	4	0	0	4	0	0
25	19443356	.	C	T	15	19	34	0	2	36	0	0
25	19486270	.	C	T	0	5	5	0	3	8	0	0
25	19486287	.	G	T	4	4	8	0	1	9	0	0
25	19520684	.	G	A	1	2	3	0	0	3	0	0
25	19535374	.	G	A	4	2	6	0	0	6	0	0
25	19535883	.	C	T	2	2	4	0	0	4	0	0
25	19556775	.	A	G	1	5	6	0	1	7	0	0
25	19560744	.	C	T	6	3	9	0	1	10	0	0
25	19562558	.	G	A	1	2	3	0	0	3	0	0
25	19562756	.	C	T	0	3	3	0	0	3	0	0
25	19585916	.	C	A	5	2	7	0	4	11	0	0
25	19586249	.	A	T	2	2	4	0	0	4	0	0
25	19591549	.	C	T	1	3	4	0	0	4	0	0
25	19591844	.	T	C	1	0	1	0	0	1	0	0
25	19610021	.	C	T	0	2	2	0	4	6	0	0
25	19610438	.	T	C	0	2	2	0	0	2	0	0
25	19610569	.	C	T	0	4	4	0	2	6	0	0
25	19667602	.	G	C	0	3	3	0	7	10	0	0
25	19676276	.	C	A	4	3	7	0	0	7	0	0
25	20669202	.	T	G	3	1	4	0	1	5	0	0
25	20724822	.	G	A	0	2	2	0	0	2	0	0
25	20724879	.	G	A	6	4	10	0	1	11	0	0
25	20726609	.	C	T	1	0	1	0	0	1	0	0
25	20726626	.	G	A	0	1	1	0	0	1	0	0
25	20730154	.	T	A	0	4	4	0	0	4	0	0
25	20730499	.	C	T	0	0	0	0	1	1	0	0
25	20730660	.	T	A	3	1	4	0	0	4	0	0
25	20730663	.	A	G	3	1	4	0	0	4	0	0
25	20997813	.	C	T	0	4	4	0	3	7	0	0
25	20997876	.	T	G	6	5	11	0	2	13	0	0
25	20998037	.	A	G	4	8	12	0	0	12	0	0
25	20999203	.	A	G	1	3	4	0	0	4	0	0
25	21064337	.	A	T	3	6	9	0	0	9	0	0
25	21064361	.	C	G	5	5	10	0	0	10	0	0
25	21064519	.	T	A	7	6	13	0	0	13	0	0
25	21065071	.	G	A	1	2	3	0	1	4	0	0
25	21065345	.	A	G	2	3	5	0	0	5	0	0
25	21075383	.	C	T	0	2	2	0	2	4	0	0
25	21075410	.	G	T	0	2	2	0	1	3	0	0
25	21114926	.	T	C	4	3	7	0	1	8	0	0
25	21115672	.	T	C	16	16	32	0	1	33	0	0
25	21115761	.	A	G	15	15	30	0	3	33	0	0
25	21115784	.	C	A	19	16	35	0	0	35	0	0
25	21117001	.	A	T	1	4	5	0	0	5	0	0
25	21119687	.	G	A	3	10	13	0	1	14	0	0
25	21121788	.	A	G	9	7	16	0	0	16	0	0
25	21121964	.	C	T	1	2	3	0	1	4	0	0
25	21122011	.	A	G	8	4	12	0	1	13	0	0
25	21122194	.	T	C	11	11	22	0	0	22	0	0
25	21122266	.	T	A	3	4	7	0	0	7	0	0
25	21122490	.	C	T	2	1	3	0	1	4	0	0
25	21122535	.	A	T	1	0	1	0	1	2	0	0
25	21124889	.	A	T	7	5	12	0	0	12	0	0
25	21125108	.	A	G	2	2	4	0	0	4	0	0
25	21125289	.	C	G	5	5	10	0	2	12	0	0
25	21125391	.	T	C	1	4	5	0	2	7	0	0
25	21125676	.	T	A	1	2	3	0	0	3	0	0
25	21194387	.	C	T	0	2	2	0	0	2	0	0
25	21202349	.	C	T	1	1	2	0	0	2	0	0
25	21208597	.	G	A	1	1	2	0	0	2	0	0
25	21213122	.	G	T	4	3	7	0	0	7	0	0
25	21222077	.	T	C	5	11	16	0	4	20	0	0
25	21222128	.	G	A	0	2	2	0	0	2	0	0
25	21229668	.	G	C	3	3	6	0	1	7	0	0
25	21229677	.	G	A	3	3	6	0	0	6	0	0
25	21239861	.	A	G	5	4	9	0	2	11	0	0
25	21239870	.	G	A	2	4	6	0	1	7	0	0
25	21240198	.	G	A	0	6	6	0	4	10	0	0
25	21240258	.	G	A	0	4	4	0	3	7	0	0
25	21253106	.	C	T	14	8	22	0	1	23	0	0
25	21277839	.	T	C	2	2	4	0	1	5	0	0
25	21277858	.	T	C	3	0	3	0	3	6	0	0
25	21277892	.	C	A	0	6	6	0	6	12	0	0
25	21278235	.	G	A	1	3	4	0	0	4	0	0
25	21278244	.	A	G	1	3	4	0	0	4	0	0
25	21298540	.	C	T	0	2	2	0	0	2	0	0
25	21308490	.	T	C	0	1	1	0	0	1	0	0
25	21341712	.	T	A	0	2	2	0	0	2	0	0
25	21343250	.	A	C	3	2	5	0	0	5	0	0
25	21343340	.	G	C	5	2	7	0	0	7	0	0
25	21343358	.	C	T	2	5	7	0	0	7	0	0
25	21343476	.	G	A	2	5	7	0	0	7	0	0
25	21343843	.	C	T	14	10	24	0	0	24	0	0
25	21344201	.	T	G	15	23	38	0	3	41	0	0
25	21344417	.	A	G	8	10	18	0	0	18	0	0
25	21738460	.	G	A	1	0	1	0	0	1	0	0
25	21739116	.	T	C	3	3	6	0	0	6	0	0
25	21743630	.	G	A	2	3	5	0	1	6	0	0
25	21743739	.	C	T	1	4	5	0	0	5	0	0
25	21833163	.	A	G	5	4	9	0	0	9	0	0
25	21833307	.	C	T	10	7	17	0	4	21	0	0
25	21833308	.	G	T	3	8	11	0	10	21	0	0
25	21834976	.	G	A	0	1	1	0	1	2	0	0
25	21835093	.	T	C	10	9	19	0	1	20	0	0
25	21835126	.	A	T	6	4	10	0	0	10	0	0
25	21838627	.	A	T	3	1	4	0	0	4	0	0
25	21838951	.	G	A	2	1	3	0	1	4	0	0
25	21838963	.	A	G	2	2	4	0	0	4	0	0
25	21838993	.	T	C	2	0	2	0	2	4	0	0
25	21841487	.	G	A	3	1	4	0	0	4	0	0
25	21847233	.	C	T	38	31	69	0	2	71	0	0
25	23555815	.	C	T	0	8	8	0	6	14	0	0
25	23555852	.	T	C	6	0	6	0	11	17	0	0
25	23555998	.	A	T	7	9	16	0	1	17	0	0
25	23556047	.	G	A	3	2	5	0	0	5	0	0
25	23556254	.	C	T	9	4	13	0	0	13	0	0
25	23556378	.	C	G	6	4	10	0	2	12	0	0
25	23562487	.	C	T	0	3	3	0	3	6	0	0
25	24609463	.	T	A	2	1	3	0	0	3	0	0
25	24723129	.	G	A	4	3	7	0	0	7	0	0
25	24736314	.	T	G	2	3	5	0	0	5	0	0
25	24736579	.	A	T	7	12	19	0	2	21	0	0
25	24736669	.	A	C	5	7	12	0	0	12	0	0
25	24736828	.	A	T	5	8	13	0	1	14	0	0
25	24736921	.	G	A	6	8	14	0	1	15	0	0
25	24737739	.	A	C	1	1	2	0	1	3	0	0
25	24737748	.	A	C	1	1	2	0	0	2	0	0
25	24737940	.	A	C	1	2	3	0	0	3	0	0
25	24738892	.	G	A	1	2	3	0	0	3	0	0
25	24739029	.	A	G	0	1	1	0	0	1	0	0
25	25127673	.	G	A	0	7	7	0	4	11	0	0
25	25130749	.	G	C	10	8	18	0	3	21	0	0
25	25130782	.	G	A	13	14	27	0	1	28	0	0
25	25130908	.	C	T	18	27	45	0	2	47	0	0
25	25130968	.	C	T	14	26	40	0	2	42	0	0
25	25131165	.	G	A	5	8	13	1	0	14	0	0
25	25131298	.	A	T	19	18	37	0	1	38	0	0
25	25131427	.	G	A	24	17	41	0	2	43	0	0
25	25132971	.	T	A	10	5	15	0	0	15	0	0
25	25133030	.	G	A	6	4	10	0	1	11	0	0
25	25133104	.	G	A	5	7	12	0	2	14	0	0
25	25133123	.	T	G	7	7	14	0	2	16	0	0
25	25133171	.	A	G	4	9	13	0	3	16	0	0
25	25133353	.	G	A	8	5	13	0	0	13	0	0
25	25133365	.	T	A	8	7	15	0	2	17	0	0
25	25133509	.	A	G	3	2	5	0	1	6	0	0
25	25133721	.	G	A	3	5	8	0	2	10	0	0
25	25142127	.	G	T	1	1	2	0	1	3	0	0
25	25396237	.	T	C	7	8	15	0	4	19	0	0
25	25396295	.	T	C	1	3	4	0	0	4	0	0
25	25488772	.	T	G	1	2	3	0	0	3	0	0
25	25540058	.	T	A	2	1	3	0	1	4	0	0
25	25540060	.	G	A	2	2	4	0	0	4	0	0
25	25540245	.	A	G	1	2	3	0	0	3	0	0
25	25540312	.	C	A	0	1	1	0	0	1	0	0
25	25540954	.	G	A	3	7	10	0	0	10	0	0
25	25542708	.	C	T	1	2	3	0	0	3	0	0
25	25544468	.	C	T	6	3	9	0	2	11	0	0
25	25545007	.	G	A	3	1	4	0	0	4	0	0
25	25545913	.	C	T	2	2	4	0	1	5	0	0
25	25547137	.	C	A	5	3	8	0	0	8	0	0
25	25547228	.	G	A	3	3	6	0	0	6	0	0
25	25548032	.	G	T	2	5	7	0	0	7	0	0
25	25823529	.	T	C	6	2	8	0	2	10	0	0
25	26739161	.	G	T	5	2	7	0	0	7	0	0
25	26739184	.	T	C	2	2	4	0	1	5	0	0
25	26827246	.	A	G	2	2	4	0	1	5	0	0
25	26827274	.	T	C	0	1	1	0	0	1	0	0
25	26827435	.	T	C	0	3	3	0	2	5	0	0
25	26827440	.	A	G	2	3	5	0	1	6	0	0
25	26829261	.	C	T	1	4	5	0	0	5	0	0
25	26829266	.	G	T	0	5	5	0	1	6	0	0
25	26829918	.	A	G	0	3	3	0	0	3	0	0
25	26840452	.	G	T	3	10	13	0	2	15	0	0
25	26877783	.	A	T	4	10	14	0	2	16	0	0
25	26877865	.	A	T	9	3	12	0	0	12	0	0
25	26877966	.	A	G	6	3	9	0	1	10	0	0
25	26879592	.	T	C	5	6	11	0	0	11	0	0
25	26884286	.	G	A	3	3	6	0	0	6	0	0
25	26888170	.	A	G	2	1	3	0	0	3	0	0
25	26909392	.	A	T	3	2	5	0	0	5	0	0
25	26909618	.	A	C	2	3	5	0	1	6	0	0
25	26911216	.	C	T	3	4	7	0	0	7	0	0
25	26911428	.	A	C	2	3	5	0	0	5	0	0
25	26911554	.	T	A	8	4	12	0	2	15	1	0
25	26911605	.	C	A	5	9	14	0	2	16	0	0
25	26911768	.	A	G	3	3	6	0	1	7	0	0
25	26911792	.	G	A	4	5	9	0	0	9	0	0
25	26912037	.	C	T	12	7	19	0	1	20	0	0
25	26912062	.	C	T	2	6	8	0	1	9	0	0
25	27174323	.	C	T	3	3	6	0	0	6	0	0
25	27715164	.	T	G	7	14	21	0	1	22	0	0
25	27715468	.	G	A	5	6	11	0	0	11	0	0
25	27715499	.	T	A	3	4	7	0	0	7	0	0
25	27715535	.	C	G	1	2	3	0	0	3	0	0
25	27716110	.	C	A	0	1	1	0	3	4	0	0
25	27716374	.	G	A	1	1	2	0	0	2	0	0
25	27763514	.	A	T	2	0	2	0	0	2	0	0
25	27795086	.	G	A	4	0	4	0	1	5	0	0
25	27801759	.	T	G	0	0	0	0	13	13	0	0
25	27802122	.	C	A	6	8	14	0	0	14	0	0
25	27802149	.	G	A	2	3	5	0	1	6	0	0
25	27806800	.	C	T	3	5	8	0	2	10	0	0
25	27811761	.	C	T	9	16	25	0	1	26	0	0
25	28222152	.	T	C	1	1	2	0	0	2	0	0
25	28269651	.	G	T	15	3	18	0	2	20	0	0
25	28269735	.	T	C	6	4	10	0	0	10	0	0
25	28335632	.	C	A	1	6	7	0	1	8	0	0
25	28335744	.	G	A	0	3	3	0	8	11	0	0
25	28357358	.	G	C	0	1	1	0	0	1	0	0
25	28640526	.	G	A	14	5	19	0	0	19	0	0
25	28640599	.	G	A	16	13	29	0	2	31	0	0
25	28640662	.	G	A	13	23	36	0	0	36	0	0
25	28640724	.	T	G	27	20	47	0	2	49	0	0
25	28640890	.	T	G	13	24	37	0	2	39	0	0
25	28641005	.	A	C	11	12	23	0	1	24	0	0
25	28641207	.	A	T	6	11	17	0	2	19	0	0
25	28641215	.	A	T	11	4	15	0	2	17	0	0
25	28641261	.	T	A	19	12	31	0	1	32	0	0
25	28641321	.	T	G	15	17	32	0	0	32	0	0
25	28648078	.	A	G	4	2	6	0	0	6	0	0
25	28648166	.	G	A	17	13	30	1	2	33	0	0
25	28650812	.	G	A	9	8	17	0	8	25	0	0
25	28652511	.	G	A	13	10	23	0	3	26	0	0
25	28655056	.	G	A	0	0	0	0	1	1	0	0
25	28656024	.	G	C	1	1	2	0	1	3	0	0
25	28661227	.	T	C	2	5	7	0	0	7	0	0
25	28661279	.	T	C	5	6	11	0	0	11	0	0
25	28661626	.	G	A	1	1	2	0	0	2	0	0
25	28665386	.	T	A	3	4	7	0	0	7	0	0
25	28665464	.	A	C	3	0	3	0	0	3	0	0
25	28668627	.	G	A	5	3	8	0	0	8	0	0
25	28668746	.	G	T	5	2	7	0	1	8	0	0
25	28714616	.	A	G	8	4	12	0	0	12	0	0
25	28719957	.	T	G	2	1	3	0	0	3	0	0
25	28726537	.	C	A	0	3	3	0	0	3	0	0
25	28826630	.	A	G	0	0	0	0	2	2	0	0
25	28846383	.	G	T	0	11	11	0	10	21	0	0
25	28893713	.	C	A	1	3	4	0	0	4	0	0
25	28893956	.	C	T	1	3	4	0	0	4	0	0
25	28903105	.	A	C	6	4	10	0	1	11	0	0
25	28907971	.	T	C	3	1	4	0	3	7	0	0
25	28907997	.	A	G	5	5	10	0	0	10	0	0
25	28908158	.	G	T	2	4	6	0	1	7	0	0
25	29076852	.	T	A	3	0	3	0	0	3	0	0
25	29212851	.	G	T	1	2	3	0	0	3	0	0
25	29319097	.	A	G	24	36	60	0	2	62	0	0
25	29319239	.	A	T	17	19	36	0	2	38	0	0
25	29319706	.	T	C	32	1	33	0	26	59	0	0
25	29319712	.	A	G	27	23	50	0	6	56	0	0
25	29319831	.	A	G	22	24	46	0	2	48	0	0
25	29319849	.	G	A	17	15	32	0	2	34	0	0
25	29329949	.	A	G	14	17	31	0	1	32	0	0
25	29427950	.	A	C	16	3	19	0	2	21	0	0
25	29427954	.	A	C	13	3	16	0	4	20	0	0
25	29428094	.	A	G	21	15	36	0	4	40	0	0
25	29428300	.	C	A	19	16	35	0	1	36	0	0
25	29428638	.	A	G	16	15	31	0	2	33	0	0
25	29428806	.	T	A	8	9	17	0	2	19	0	0
25	29428963	.	G	A	11	16	27	0	2	29	0	0
25	29429420	.	G	A	5	11	16	0	4	20	0	0
25	29429569	.	T	C	8	0	8	0	4	12	0	0
25	29429589	.	G	T	7	2	9	0	0	9	0	0
25	29429984	.	T	C	7	0	7	0	4	11	0	0
25	29664955	.	T	C	3	0	3	0	0	3	0	0
25	29665705	.	G	A	0	5	5	0	2	7	0	0
25	29666299	.	A	G	12	7	19	0	0	19	0	0
25	29666607	.	G	T	1	1	2	0	1	3	0	0
25	29666640	.	T	A	4	5	9	0	0	9	0	0
25	29666797	.	T	A	9	11	20	0	1	21	0	0
25	29698922	.	A	T	1	3	4	0	0	4	0	0
25	29711597	.	A	T	10	5	15	0	0	15	0	0
25	29711754	.	C	A	7	12	19	0	3	22	0	0
25	30449361	.	A	G	2	2	4	0	0	4	0	0
25	32739555	.	G	T	4	2	6	0	1	7	0	0
25	35713260	.	G	A	0	2	2	0	0	2	0	0
25	35713263	.	G	C	0	1	1	0	0	1	0	0
25	36197750	.	A	G	3	2	5	0	1	7	1	0
25	36198944	.	T	C	4	7	11	0	0	11	0	0
25	36269766	.	G	A	1	1	2	0	0	2	0	0
25	37336710	.	A	G	7	5	12	0	1	13	0	0
25	37336715	.	A	G	7	4	11	0	1	12	0	0
25	37365168	.	A	G	1	4	5	0	0	5	0	0
3	13937	.	C	T	0	4	4	0	0	4	0	0
3	1130299	.	C	A	3	9	12	0	0	12	0	0
3	1133861	.	G	C	0	4	4	0	0	4	0	0
3	1180043	.	A	C	5	0	5	0	4	9	0	0
3	1192757	.	T	C	0	12	12	1	1	14	0	0
3	1215179	.	A	C	2	2	4	0	8	12	0	0
3	1323815	.	T	C	9	3	12	0	0	12	0	0
3	1323823	.	C	G	9	2	11	0	1	12	0	0
3	1323879	.	T	A	8	3	11	0	0	11	0	0
3	1324045	.	C	A	15	6	21	0	1	22	0	0
3	1324064	.	C	A	11	6	17	0	0	17	0	0
3	1324281	.	G	T	6	1	7	0	0	7	0	0
3	1324300	.	T	C	4	0	4	0	0	4	0	0
3	4506897	.	A	G	3	3	6	0	0	6	0	0
3	4508042	.	A	C	1	3	4	0	0	4	0	0
3	4508093	.	C	A	2	2	4	0	0	4	0	0
3	4508120	.	C	T	1	1	2	0	0	2	0	0
3	4511052	.	T	C	0	2	2	0	0	2	0	0
3	4514030	.	G	A	1	0	1	0	0	1	0	0
3	4530061	.	G	A	1	1	2	0	3	5	0	0
3	4530118	.	T	A	3	5	8	0	1	9	0	0
3	5021432	.	G	A	7	1	8	0	0	8	0	0
3	5053060	.	C	T	0	8	8	0	7	15	0	0
3	5053454	.	T	A	1	6	7	0	0	7	0	0
3	5053934	.	G	A	6	8	14	0	0	14	0	0
3	5053988	.	C	G	1	5	6	0	0	6	0	0
3	5056247	.	G	A	5	4	9	0	0	9	0	0
3	5062827	.	C	T	0	1	1	0	0	1	0	0
3	5130791	.	C	A	3	4	7	0	0	7	0	0
3	5130851	.	T	C	1	1	2	0	0	2	0	0
3	5134669	.	T	C	2	2	4	0	0	4	0	0
3	5141152	.	C	T	1	1	2	0	0	2	0	0
3	5267221	.	G	A	3	3	6	0	0	6	0	0
3	5267251	.	C	T	4	8	12	0	0	12	0	0
3	5270274	.	C	T	0	4	4	0	2	6	0	0
3	5624487	.	C	T	0	7	7	0	3	10	0	0
3	5633056	.	A	G	4	12	16	0	3	19	0	0
3	5633089	.	G	A	5	12	17	0	0	17	0	0
3	5633122	.	A	G	4	7	11	0	0	11	0	0
3	5634976	.	A	G	1	4	5	0	0	5	0	0
3	5637213	.	A	C	0	2	2	0	0	2	0	0
3	5637222	.	A	G	0	1	1	0	0	1	0	0
3	5778981	.	G	A	15	9	24	0	1	25	0	0
3	5779044	.	T	A	14	13	27	0	2	29	0	0
3	5779093	.	G	T	7	9	16	0	2	18	0	0
3	5782501	.	A	G	5	1	6	0	0	6	0	0
3	5782715	.	A	G	1	1	2	0	0	2	0	0
3	5812205	.	C	T	0	1	1	0	0	1	0	0
3	5823477	.	G	A	3	1	4	0	0	4	0	0
3	5823483	.	C	A	0	1	1	0	3	4	0	0
3	5824826	.	T	C	0	1	1	0	0	1	0	0
3	5824858	.	C	T	0	1	1	0	0	1	0	0
3	5824870	.	C	T	1	0	1	0	0	1	0	0
3	5886917	.	C	T	1	17	18	0	15	33	0	0
3	5887223	.	T	C	10	6	16	0	0	16	0	0
3	5887463	.	T	G	5	7	12	0	1	13	0	0
3	5887715	.	T	C	3	4	7	0	0	7	0	0
3	5887841	.	T	A	3	4	7	0	2	9	0	0
3	5887931	.	A	T	8	4	12	0	0	12	0	0
3	5888245	.	C	T	6	3	9	0	0	9	0	0
3	6380368	.	T	C	17	20	37	0	2	39	0	0
3	6417172	.	G	A	6	14	20	0	3	23	0	0
3	6466036	.	C	T	0	0	0	0	1	1	0	0
3	6474593	.	A	G	1	5	6	0	0	6	0	0
3	6477596	.	G	C	1	1	2	0	0	2	0	0
3	6504814	.	T	A	0	1	1	0	0	1	0	0
3	6666080	.	A	G	2	4	6	0	0	6	0	0
3	6666194	.	G	C	3	6	9	0	1	10	0	0
3	6666283	.	A	T	4	7	11	0	0	11	0	0
3	6666342	.	A	G	4	2	6	0	0	6	0	0
3	6666362	.	G	A	1	5	6	0	0	6	0	0
3	6667060	.	G	C	15	9	24	0	1	26	1	0
3	6667209	.	C	T	9	12	21	0	1	22	0	0
3	6667781	.	G	T	2	2	4	0	0	4	0	0
3	6667959	.	A	C	3	2	5	0	0	5	0	0
3	6669474	.	T	C	1	2	3	0	0	3	0	0
3	6721278	.	A	G	5	8	13	0	1	14	0	0
3	6721286	.	G	C	5	9	14	0	1	15	0	0
3	6721421	.	T	G	5	12	17	0	0	18	1	0
3	6721456	.	A	T	4	8	12	0	1	13	0	0
3	6721497	.	T	A	1	10	11	0	0	11	0	0
3	6721504	.	A	T	1	10	11	0	1	12	0	0
3	6721763	.	T	C	3	3	6	0	0	6	0	0
3	6721773	.	T	G	3	3	6	0	0	6	0	0
3	6722021	.	T	A	3	6	9	0	0	9	0	0
3	6722070	.	C	G	1	2	3	0	0	3	0	0
3	6722333	.	C	A	0	5	5	0	0	5	0	0
3	6722341	.	G	A	1	5	6	0	0	6	0	0
3	6722401	.	T	C	9	4	13	0	0	13	0	0
3	6723257	.	A	G	1	3	4	0	0	4	0	0
3	7099049	.	C	T	0	4	4	0	1	5	0	0
3	7099160	.	A	G	3	6	9	0	1	10	0	0
3	7099600	.	T	C	1	2	3	0	0	3	0	0
3	7112697	.	A	G	1	1	2	0	0	2	0	0
3	7112701	.	C	G	0	2	2	0	2	4	0	0
3	7112990	.	C	T	0	9	9	0	2	11	0	0
3	7113036	.	G	T	3	9	12	0	1	13	0	0
3	7113075	.	T	G	8	5	13	0	2	15	0	0
3	7113126	.	A	G	7	7	14	0	1	15	0	0
3	7113327	.	T	C	6	0	6	0	7	13	0	0
3	7113330	.	T	C	5	5	10	0	2	12	0	0
3	7113433	.	T	C	0	5	5	0	0	5	0	0
3	7113465	.	A	G	0	3	3	0	0	3	0	0
3	7113574	.	G	T	7	2	9	0	0	9	0	0
3	7113575	.	T	G	6	2	8	0	1	9	0	0
3	7113660	.	A	G	2	2	4	0	0	4	0	0
3	7113669	.	C	T	2	2	4	0	0	4	0	0
3	7113720	.	G	A	2	5	7	0	0	7	0	0
3	7114043	.	T	G	2	2	4	0	0	4	0	0
3	7133388	.	G	A	2	4	6	0	0	6	0	0
3	7133435	.	T	G	1	4	5	0	4	9	0	0
3	7133743	.	A	G	3	3	6	1	0	7	0	0
3	7133751	.	A	G	3	3	6	1	1	8	0	0
3	7134079	.	T	G	5	2	7	0	0	7	0	0
3	7141846	.	G	A	1	2	3	0	0	3	0	0
3	7141981	.	C	T	3	2	5	0	0	5	0	0
3	7142011	.	G	A	1	2	3	0	0	3	0	0
3	7155039	.	T	C	2	4	6	0	2	8	0	0
3	7155156	.	C	T	0	3	3	0	0	3	0	0
3	7155196	.	T	A	1	7	8	0	0	8	0	0
3	7155198	.	A	G	1	5	6	0	2	8	0	0
3	7155428	.	G	A	2	2	4	0	2	6	0	0
3	11585488	.	T	A	10	11	21	0	2	23	0	0
3	11585492	.	G	A	11	9	20	0	1	21	0	0
3	11585527	.	T	C	1	5	6	0	2	8	0	0
3	11585549	.	T	C	2	6	8	0	0	8	0	0
3	11585815	.	A	G	5	3	8	0	0	8	0	0
3	11585852	.	T	A	4	4	8	0	0	8	0	0
3	11585937	.	G	A	6	9	15	0	2	17	0	0
3	11586227	.	C	A	3	3	6	0	0	6	0	0
3	11586331	.	C	T	0	5	5	0	11	16	0	0
3	11586346	.	C	T	13	6	19	0	0	19	0	0
3	11586382	.	G	A	13	12	25	0	1	26	0	0
3	11586635	.	A	G	8	8	16	0	0	16	0	0
3	11590280	.	A	G	1	4	5	0	1	6	0	0
3	11614970	.	T	C	1	0	1	0	1	2	0	0
3	11615224	.	A	G	4	2	6	0	0	6	0	0
3	11781003	.	A	C	8	5	13	0	1	14	0	0
3	11781079	.	T	C	10	1	11	0	2	13	0	0
3	11781113	.	G	A	10	10	20	0	4	24	0	0
3	11784743	.	G	A	4	7	11	0	1	12	0	0
3	11937295	.	C	T	4	4	8	0	0	8	0	0
3	11946847	.	T	G	6	8	14	0	2	16	0	0
3	11946884	.	A	G	3	6	9	0	0	9	0	0
3	11946885	.	A	G	5	4	9	0	0	9	0	0
3	11947323	.	C	G	7	7	14	0	0	15	1	0
3	11947401	.	A	T	12	12	24	0	1	25	0	0
3	11947462	.	G	A	15	4	19	0	0	19	0	0
3	12345351	.	T	C	12	10	22	0	1	23	0	0
3	12345373	.	G	T	14	15	29	0	1	30	0	0
3	12349672	.	A	G	4	7	11	0	0	11	0	0
3	12586148	.	T	G	5	2	7	0	0	7	0	0
3	12689613	.	T	A	0	1	1	0	0	1	0	0
3	12692858	.	G	T	6	3	9	0	0	9	0	0
3	12692859	.	T	G	6	3	9	0	0	9	0	0
3	12698831	.	A	T	11	4	15	0	0	15	0	0
3	12698890	.	T	C	6	7	13	0	2	15	0	0
3	12698897	.	A	G	8	7	15	0	0	15	0	0
3	12698976	.	C	A	7	10	17	0	1	18	0	0
3	12699026	.	T	A	7	6	13	0	0	13	0	0
3	12699044	.	T	C	8	7	15	0	0	15	0	0
3	12699073	.	T	A	9	7	16	0	0	16	0	0
3	12699260	.	A	G	11	9	20	0	0	20	0	0
3	12699274	.	C	T	11	7	18	0	0	18	0	0
3	12699311	.	A	T	15	7	22	0	0	22	0	0
3	12699525	.	C	T	18	13	31	0	2	33	0	0
3	12699645	.	G	C	23	13	36	0	0	36	0	0
3	12699662	.	C	T	24	12	36	0	2	38	0	0
3	13166930	.	T	C	1	2	3	0	0	3	0	0
3	13488455	.	T	C	5	2	7	0	0	7	0	0
3	13860363	.	G	A	1	4	5	0	2	7	0	0
3	14496722	.	T	C	21	15	36	0	2	38	0	0
3	14605750	.	T	C	3	6	9	0	0	9	0	0
3	14605841	.	A	T	1	2	3	0	0	3	0	0
3	14692201	.	T	C	12	26	38	0	2	40	0	0
3	14692204	.	T	C	12	0	12	0	27	39	0	0
3	14694835	.	G	A	12	12	24	0	0	24	0	0
3	15041021	.	C	T	2	2	4	0	2	6	0	0
3	15057191	.	A	T	1	2	3	0	0	3	0	0
3	15057321	.	T	C	1	2	3	0	0	3	0	0
3	15058003	.	C	G	1	2	3	0	0	3	0	0
3	15058161	.	T	C	2	4	6	0	0	6	0	0
3	15085669	.	A	G	13	9	22	0	2	24	0	0
3	15085673	.	G	A	8	13	21	0	1	22	0	0
3	15085784	.	G	C	9	13	22	0	1	23	0	0
3	15134326	.	G	A	2	2	4	0	2	6	0	0
3	15134327	.	G	A	4	2	6	0	0	6	0	0
3	15137023	.	C	T	1	0	1	0	1	2	0	0
3	15137045	.	A	G	3	3	6	0	0	6	0	0
3	15149810	.	A	G	3	2	5	0	0	5	0	0
3	15193773	.	T	A	14	7	21	0	0	21	0	0
3	15198701	.	A	G	3	3	6	0	0	6	0	0
3	15203329	.	C	A	15	9	24	0	0	24	0	0
3	15203371	.	A	C	10	11	21	0	2	23	0	0
3	15203388	.	T	G	14	9	23	0	1	24	0	0
3	15203977	.	G	A	0	2	2	0	0	2	0	0
3	15214252	.	A	C	9	9	18	0	0	18	0	0
3	15214300	.	T	A	7	8	15	0	0	15	0	0
3	15214462	.	C	A	10	10	20	0	0	20	0	0
3	15214475	.	T	A	9	9	18	0	0	18	0	0
3	15215625	.	G	A	1	4	5	0	0	5	0	0
3	15232447	.	A	G	9	13	22	0	3	25	0	0
3	15232481	.	G	A	11	6	17	0	0	17	0	0
3	15232498	.	G	A	5	13	18	0	0	18	0	0
3	15246060	.	T	C	2	1	3	0	0	3	0	0
3	15246871	.	C	T	1	0	1	0	0	1	0	0
3	15258676	.	G	A	1	1	2	0	0	2	0	0
3	15274320	.	G	A	4	2	6	0	0	6	0	0
3	15274649	.	G	A	0	0	0	0	2	2	0	0
3	15274691	.	T	C	2	5	7	0	1	8	0	0
3	15278931	.	A	G	2	0	2	0	4	6	0	0
3	15279045	.	C	G	6	13	19	0	0	19	0	0
3	15282328	.	C	T	1	3	4	0	0	4	0	0
3	15284041	.	C	T	2	8	10	0	2	12	0	0
3	15284047	.	C	T	3	10	13	0	0	13	0	0
3	15284513	.	C	A	4	10	14	0	20	35	1	0
3	15284604	.	G	A	0	11	11	0	12	23	0	0
3	15332476	.	C	A	16	24	40	0	1	41	0	0
3	15332601	.	G	T	8	16	24	0	12	36	0	0
3	15332641	.	C	T	16	21	37	0	1	38	0	0
3	15332881	.	G	A	14	17	31	0	0	31	0	0
3	15332902	.	C	A	2	17	19	0	13	32	0	0
3	15332923	.	G	A	21	16	37	0	1	38	0	0
3	15333065	.	G	A	12	18	30	0	1	31	0	0
3	15416645	.	G	A	0	1	1	0	7	8	0	0
3	15419098	.	C	T	6	8	14	0	1	15	0	0
3	15455662	.	A	G	3	7	10	0	0	10	0	0
3	15458554	.	G	A	2	4	6	0	0	6	0	0
3	15476843	.	G	A	7	5	12	0	0	12	0	0
3	15476891	.	G	T	6	7	13	0	1	14	0	0
3	15477827	.	T	C	0	4	4	0	0	4	0	0
3	15480386	.	A	T	7	2	9	0	0	9	0	0
3	15480437	.	G	T	2	3	5	0	0	5	0	0
3	15489831	.	T	C	0	1	1	0	2	3	0	0
3	15489862	.	G	A	1	3	4	0	0	4	0	0
3	15490026	.	A	C	4	8	12	0	1	13	0	0
3	15490681	.	T	G	4	6	10	0	0	10	0	0
3	15491473	.	G	A	1	2	3	0	0	3	0	0
3	15505359	.	T	C	10	4	14	0	4	18	0	0
3	15505394	.	T	C	7	1	8	0	4	12	0	0
3	15505658	.	G	A	12	6	18	0	1	19	0	0
3	15505700	.	A	G	3	2	5	0	0	5	0	0
3	15505703	.	C	G	3	2	5	0	0	5	0	0
3	15505856	.	A	T	9	8	17	0	1	18	0	0
3	15505864	.	G	A	0	12	12	0	9	21	0	0
3	15505910	.	C	T	12	8	20	0	1	21	0	0
3	15505911	.	G	A	0	8	8	0	13	21	0	0
3	15629022	.	T	C	3	2	5	0	0	5	0	0
3	15988113	.	A	G	29	9	38	0	0	38	0	0
3	15988337	.	A	G	9	9	18	0	1	19	0	0
3	16389180	.	G	T	4	8	12	0	0	12	0	0
3	16389230	.	C	T	7	12	19	0	1	20	0	0
3	16389517	.	C	T	1	2	3	0	0	3	0	0
3	16391695	.	G	A	1	5	6	0	0	6	0	0
3	16395548	.	A	G	2	1	3	0	0	3	0	0
3	16650129	.	G	A	2	2	4	0	0	4	0	0
3	16671903	.	G	A	0	1	1	0	1	2	0	0
3	16679136	.	C	T	5	7	12	0	0	12	0	0
3	16679248	.	C	T	5	4	9	0	0	9	0	0
3	16679331	.	T	C	4	9	13	0	2	15	0	0
3	16679349	.	G	A	3	7	10	0	0	10	0	0
3	16679387	.	G	A	3	5	8	0	0	8	0	0
3	16679520	.	G	A	8	9	17	0	3	20	0	0
3	16679556	.	G	A	0	10	10	0	12	22	0	0
3	16679561	.	A	G	11	0	11	0	9	20	0	0
3	16679820	.	C	T	7	9	16	0	0	16	0	0
3	16696215	.	G	A	2	0	2	0	0	2	0	0
3	16741179	.	A	C	4	2	6	0	1	7	0	0
3	16741830	.	A	G	1	2	3	0	0	3	0	0
3	16741851	.	T	C	2	2	4	0	1	5	0	0
3	16746796	.	G	A	5	3	8	0	0	8	0	0
3	16746947	.	A	T	18	16	34	0	4	38	0	0
3	16747229	.	A	G	3	0	3	0	8	11	0	0
3	16747233	.	G	T	0	6	6	0	3	9	0	0
3	16972949	.	T	A	6	7	13	0	0	13	0	0
3	16972991	.	T	C	9	11	20	0	2	22	0	0
3	17603313	.	A	G	3	2	5	0	0	5	0	0
3	17650983	.	G	A	18	15	33	0	0	33	0	0
3	17651208	.	C	A	17	11	28	0	7	35	0	0
3	17651508	.	G	A	16	18	34	0	1	35	0	0
3	17651718	.	C	T	20	20	40	0	7	47	0	0
3	17651837	.	C	T	16	20	36	0	0	36	0	0
3	17651847	.	C	A	17	9	26	0	4	30	0	0
3	17673386	.	C	T	2	0	2	0	0	2	0	0
3	17867319	.	A	G	2	2	4	0	0	4	0	0
3	17867334	.	A	G	3	3	6	0	0	6	0	0
3	17867440	.	T	C	13	7	20	0	0	20	0	0
3	17867716	.	C	A	2	4	6	0	0	6	0	0
3	17867748	.	T	C	0	2	2	0	0	2	0	0
3	17868949	.	G	C	4	3	7	0	0	7	0	0
3	17869300	.	G	A	0	1	1	0	0	1	0	0
3	17878505	.	A	G	0	2	2	0	0	2	0	0
3	17886528	.	G	A	0	1	1	0	0	1	0	0
3	18376403	.	A	T	9	17	26	0	2	28	0	0
3	18377514	.	T	C	1	8	9	0	0	9	0	0
3	18774631	.	G	A	4	3	7	0	0	7	0	0
3	18838547	.	C	T	4	4	8	0	0	8	0	0
3	18838559	.	T	A	4	3	7	0	0	7	0	0
3	18838595	.	T	A	4	7	11	0	1	12	0	0
3	18838878	.	C	T	6	4	10	0	0	10	0	0
3	18838900	.	T	A	3	5	8	0	1	9	0	0
3	18839017	.	C	T	12	4	16	0	0	16	0	0
3	18923082	.	C	G	2	2	4	0	0	4	0	0
3	18923246	.	A	G	1	3	4	0	0	4	0	0
3	18923536	.	C	T	6	2	8	0	0	8	0	0
3	18923644	.	C	T	1	3	4	0	0	4	0	0
3	18923880	.	T	A	1	2	3	0	0	3	0	0
3	19006388	.	G	A	5	8	13	0	0	13	0	0
3	19210238	.	T	C	5	7	12	0	0	12	0	0
3	19210352	.	A	G	7	9	16	0	3	19	0	0
3	19264751	.	A	G	2	3	5	0	1	6	0	0
3	19264760	.	T	A	2	4	6	0	0	6	0	0
3	19264787	.	G	T	4	4	8	0	1	9	0	0
3	19267552	.	C	T	1	0	1	0	0	1	0	0
3	19267564	.	T	C	1	0	1	0	0	1	0	0
3	19267963	.	A	G	1	0	1	0	0	1	0	0
3	19270732	.	C	T	2	1	3	0	0	3	0	0
3	19271549	.	A	G	9	11	20	0	0	20	0	0
3	19273907	.	A	G	10	16	26	0	0	26	0	0
3	19274532	.	C	G	4	13	17	0	2	19	0	0
3	19274544	.	A	C	5	16	21	0	2	23	0	0
3	19274688	.	T	C	9	6	15	0	0	15	0	0
3	19277027	.	A	G	6	5	11	0	0	11	0	0
3	19277084	.	T	A	1	0	1	0	0	1	0	0
3	19278247	.	T	C	3	6	9	0	0	9	0	0
3	19278796	.	C	T	1	1	2	0	1	3	0	0
3	19281259	.	G	A	1	14	15	0	6	21	0	0
3	19281295	.	A	G	14	20	34	0	1	35	0	0
3	19281310	.	T	A	12	22	34	0	0	34	0	0
3	19336553	.	T	A	4	2	6	0	0	6	0	0
3	19338599	.	C	T	1	2	3	0	0	3	0	0
3	19339594	.	T	C	0	1	1	0	0	1	0	0
3	19346162	.	C	G	2	1	3	0	0	3	0	0
3	19346376	.	C	T	0	1	1	0	0	1	0	0
3	19346394	.	C	T	0	1	1	0	0	1	0	0
3	19354657	.	G	C	12	7	19	0	0	19	0	0
3	19354768	.	A	C	5	6	11	0	2	13	0	0
3	19354902	.	T	C	8	5	13	0	2	15	0	0
3	19465779	.	A	T	2	2	4	0	0	4	0	0
3	19609897	.	A	C	2	2	4	0	0	4	0	0
3	19610648	.	A	T	2	8	10	0	0	10	0	0
3	19610655	.	G	T	1	7	8	0	1	9	0	0
3	19610865	.	A	C	13	16	29	0	1	30	0	0
3	19678310	.	C	T	1	0	1	0	0	1	0	0
3	19702224	.	T	C	2	1	3	0	0	3	0	0
3	19706564	.	A	G	1	3	4	0	0	4	0	0
3	19707181	.	G	A	0	2	2	0	0	2	0	0
3	19717079	.	T	C	6	6	12	0	2	14	0	0
3	19717171	.	T	A	10	5	15	0	2	17	0	0
3	19717459	.	C	T	12	12	24	0	1	25	0	0
3	19717541	.	G	C	7	3	10	0	2	34	22	0
3	19717589	.	T	G	15	4	19	0	19	38	0	0
3	19717656	.	T	C	13	14	27	0	4	31	0	0
3	19717669	.	G	A	9	14	23	0	7	30	0	0
3	19851289	.	G	T	11	9	20	0	2	22	0	0
3	19851325	.	T	C	12	7	19	0	2	21	0	0
3	19914453	.	A	G	3	2	5	0	0	5	0	0
3	19969409	.	C	T	4	3	7	0	0	7	0	0
3	19969416	.	G	C	4	3	7	0	0	7	0	0
3	19969909	.	C	T	4	2	6	0	0	6	0	0
3	19970589	.	G	A	0	4	4	0	5	9	0	0
3	19970828	.	T	A	7	5	12	0	0	12	0	0
3	19971063	.	T	G	5	9	14	0	1	15	0	0
3	19971316	.	A	G	8	6	14	0	1	15	0	0
3	19971719	.	A	C	9	7	16	0	3	19	0	0
3	20015458	.	G	T	1	2	3	0	0	3	0	0
3	20021477	.	C	T	2	3	5	0	1	6	0	0
3	20026042	.	G	T	8	13	21	0	3	24	0	0
3	20026106	.	G	A	16	16	32	0	0	32	0	0
3	20026148	.	G	A	12	10	22	0	1	23	0	0
3	20035849	.	C	T	0	1	1	0	0	1	0	0
3	20042325	.	A	T	29	14	43	0	6	49	0	0
3	20042453	.	G	C	18	23	41	0	0	41	0	0
3	20042476	.	C	T	20	18	38	0	3	41	0	0
3	20042679	.	A	G	2	4	6	0	1	7	0	0
3	20042681	.	A	G	2	5	7	0	0	7	0	0
3	20042824	.	A	G	14	15	29	0	2	31	0	0
3	20042965	.	T	C	11	19	30	0	0	30	0	0
3	20043024	.	A	G	13	16	29	0	0	29	0	0
3	20043069	.	C	A	9	5	14	0	1	15	0	0
3	20043121	.	A	T	12	9	21	0	0	21	0	0
3	20043279	.	A	T	5	4	9	0	1	10	0	0
3	20043556	.	C	T	5	3	8	0	2	10	0	0
3	20045679	.	A	G	6	8	14	0	0	14	0	0
3	20051185	.	G	A	0	1	1	0	0	1	0	0
3	20063757	.	A	G	3	11	14	0	2	16	0	0
3	20063917	.	G	A	1	7	8	0	1	9	0	0
3	20063978	.	T	C	4	2	6	0	0	6	0	0
3	20064002	.	C	T	5	2	7	0	0	7	0	0
3	20064090	.	A	C	1	4	5	0	0	5	0	0
3	20108424	.	A	T	23	26	49	0	0	49	0	0
3	20108636	.	A	T	8	19	27	0	1	28	0	0
3	20108643	.	G	T	7	21	28	0	0	28	0	0
3	20108790	.	T	C	15	14	29	0	2	31	0	0
3	20109421	.	T	C	5	13	18	0	0	18	0	0
3	20109861	.	G	A	4	17	21	0	3	24	0	0
3	20109951	.	C	A	11	6	17	0	1	18	0	0
3	20110268	.	T	C	9	6	15	0	0	15	0	0
3	20110269	.	T	C	10	5	15	0	0	15	0	0
3	20110346	.	A	G	10	4	14	0	0	14	0	0
3	20110444	.	C	A	5	3	8	0	1	9	0	0
3	20110557	.	A	G	9	11	20	0	1	21	0	0
3	20229235	.	A	G	2	2	4	0	0	4	0	0
3	20229260	.	G	A	1	3	4	0	0	4	0	0
3	20229479	.	A	G	1	2	3	0	1	4	0	0
3	20229503	.	T	A	1	3	4	0	0	4	0	0
3	20231025	.	T	G	2	1	3	0	0	3	0	0
3	20231060	.	C	T	7	4	11	0	0	11	0	0
3	20231080	.	G	A	0	7	7	0	10	17	0	0
3	20231288	.	G	A	6	5	11	0	0	11	0	0
3	20231289	.	C	T	5	5	10	0	1	11	0	0
3	20231385	.	C	T	13	13	26	0	1	27	0	0
3	20231483	.	T	A	14	6	20	0	0	20	0	0
3	20231510	.	G	A	12	6	18	0	1	19	0	0
3	20231539	.	C	G	11	8	19	0	2	21	0	0
3	20658235	.	C	T	13	10	23	0	0	23	0	0
3	20658333	.	G	T	19	18	37	0	1	38	0	0
3	20658653	.	C	G	16	7	23	0	1	24	0	0
3	20658809	.	C	T	11	8	19	0	0	19	0	0
3	20658899	.	T	A	6	6	12	0	0	12	0	0
3	20659051	.	T	G	7	10	17	0	0	17	0	0
3	20677240	.	A	G	1	1	2	0	0	2	0	0
3	20677261	.	C	A	1	2	3	0	0	3	0	0
3	20950366	.	C	T	23	17	40	0	0	40	0	0
3	20950529	.	T	C	16	30	46	0	2	48	0	0
3	20956926	.	C	A	12	15	27	0	1	28	0	0
3	20956957	.	G	A	10	9	19	0	3	22	0	0
3	21025709	.	A	T	19	15	34	0	2	36	0	0
3	21025986	.	A	T	14	17	31	0	4	35	0	0
3	21026079	.	A	G	26	11	37	0	1	38	0	0
3	21026293	.	A	G	14	20	34	0	2	36	0	0
3	21026370	.	T	C	4	15	19	0	1	20	0	0
3	21027101	.	A	T	7	6	13	0	1	14	0	0
3	21027504	.	C	T	6	3	9	0	0	9	0	0
3	21027715	.	C	T	4	6	10	0	1	11	0	0
3	21027749	.	A	T	7	8	15	0	1	16	0	0
3	21029813	.	C	A	15	11	26	0	1	27	0	0
3	21029902	.	T	G	7	14	21	0	0	21	0	0
3	21030101	.	G	A	18	8	26	0	2	28	0	0
3	21030293	.	C	T	18	24	42	0	4	46	0	0
3	21030318	.	A	C	24	20	44	0	2	47	1	0
3	21030730	.	T	C	20	12	32	0	3	35	0	0
3	21044189	.	G	A	4	10	14	0	1	15	0	0
3	21066745	.	A	T	10	13	23	0	1	24	0	0
3	21067384	.	A	G	6	8	14	0	3	17	0	0
3	21067565	.	A	G	3	5	8	0	0	8	0	0
3	21067606	.	A	T	6	5	11	0	0	11	0	0
3	21067718	.	T	A	4	6	10	0	0	10	0	0
3	21067911	.	G	T	2	5	7	0	4	11	0	0
3	21068176	.	G	A	2	5	7	0	1	8	0	0
3	21068205	.	G	T	2	4	6	0	1	7	0	0
3	21096057	.	T	C	0	5	5	0	0	5	0	0
3	21096176	.	C	T	6	5	11	0	2	13	0	0
3	21096487	.	G	A	12	17	29	0	1	30	0	0
3	21096693	.	T	A	16	11	27	0	1	28	0	0
3	21104470	.	A	G	3	2	5	0	1	6	0	0
3	21111671	.	C	T	0	1	1	0	0	1	0	0
3	21111680	.	T	C	0	1	1	0	0	1	0	0
3	21113913	.	C	A	4	8	12	0	0	12	0	0
3	21125687	.	G	T	17	19	36	0	2	38	0	0
3	21126015	.	C	T	25	31	56	0	2	58	0	0
3	21139754	.	T	C	9	5	14	0	1	15	0	0
3	21141184	.	C	T	4	5	9	0	0	9	0	0
3	21240878	.	A	T	5	5	10	0	0	10	0	0
3	21240971	.	C	G	3	1	4	0	2	6	0	0
3	21241269	.	A	G	2	6	8	0	2	10	0	0
3	21241413	.	C	A	0	6	6	0	1	7	0	0
3	21241416	.	A	G	1	5	6	0	0	6	0	0
3	21241461	.	G	A	1	2	3	0	0	3	0	0
3	21251642	.	A	T	2	2	4	0	0	4	0	0
3	21251873	.	A	G	4	3	7	0	0	7	0	0
3	21251924	.	G	A	4	2	6	0	1	7	0	0
3	21252172	.	C	G	1	2	3	0	0	3	0	0
3	21281178	.	C	A	4	2	6	0	0	6	0	0
3	21281483	.	G	C	14	8	22	0	0	22	0	0
3	21281677	.	C	T	0	13	13	0	19	32	0	0
3	21281926	.	A	C	2	2	4	0	0	4	0	0
3	21281927	.	T	A	2	2	4	0	0	4	0	0
3	21282299	.	T	A	2	5	7	0	0	7	0	0
3	21282340	.	A	G	5	9	14	0	0	14	0	0
3	21282546	.	G	A	5	2	7	0	1	8	0	0
3	21283509	.	C	A	1	2	3	0	0	3	0	0
3	21284794	.	G	T	1	2	3	0	0	3	0	0
3	22050263	.	G	A	1	2	3	0	0	3	0	0
3	22054724	.	T	C	6	3	9	0	2	11	0	0
3	22054793	.	A	C	11	8	19	0	1	20	0	0
3	22054856	.	G	A	4	3	7	0	1	8	0	0
3	22055128	.	A	G	4	0	4	0	6	10	0	0
3	22055216	.	T	A	7	9	16	0	0	16	0	0
3	22146900	.	G	C	0	2	2	0	3	5	0	0
3	22153412	.	A	C	4	2	6	0	0	6	0	0
3	22153885	.	A	G	1	2	3	0	2	5	0	0
3	22153983	.	A	G	0	3	3	0	0	3	0	0
3	22154274	.	C	G	1	2	3	0	0	3	0	0
3	22154306	.	G	T	0	2	2	0	2	4	0	0
3	22154382	.	T	C	3	7	10	0	0	10	0	0
3	22154610	.	A	C	4	10	14	0	1	15	0	0
3	22158373	.	G	T	30	16	46	0	6	52	0	0
3	22158416	.	G	C	32	18	50	0	3	53	0	0
3	22158551	.	T	C	30	34	64	0	0	64	0	0
3	22158768	.	T	G	25	27	52	0	2	54	0	0
3	22158904	.	A	T	30	10	40	0	0	40	0	0
3	22159569	.	A	G	11	7	18	0	1	19	0	0
3	22159584	.	C	A	0	4	4	0	11	15	0	0
3	22159697	.	A	G	2	13	15	0	4	19	0	0
3	22159797	.	G	A	2	7	9	0	0	9	0	0
3	22160042	.	T	G	4	5	9	0	0	9	0	0
3	22160131	.	C	G	2	2	4	0	0	4	0	0
3	22160421	.	C	T	3	7	10	0	1	11	0	0
3	22160436	.	A	C	4	12	16	0	0	16	0	0
3	22160767	.	G	T	3	5	8	0	1	9	0	0
3	22160779	.	C	T	5	6	11	0	0	11	0	0
3	22160947	.	C	A	2	1	3	0	0	3	0	0
3	22161389	.	T	A	0	5	5	0	0	5	0	0
3	22161588	.	C	T	1	1	2	0	1	3	0	0
3	22172765	.	A	G	4	4	8	0	0	8	0	0
3	22172837	.	G	A	0	4	4	0	0	4	0	0
3	22547779	.	C	T	1	1	2	0	1	3	0	0
3	22548052	.	G	A	1	2	3	0	1	4	0	0
3	22548388	.	G	A	1	2	3	0	0	3	0	0
3	22548666	.	C	G	9	6	15	0	1	16	0	0
3	22548677	.	C	T	8	4	12	0	1	13	0	0
3	22548903	.	A	C	9	10	19	0	3	22	0	0
3	22548928	.	T	A	9	8	17	0	1	18	0	0
3	22783277	.	A	G	1	3	4	0	0	4	0	0
3	22811835	.	G	A	0	3	3	0	3	6	0	0
3	22812753	.	A	G	5	0	5	0	6	11	0	0
3	22812759	.	C	A	5	4	9	0	1	10	0	0
3	22813052	.	G	A	0	7	7	0	7	14	0	0
3	22813515	.	T	A	4	7	11	0	0	11	0	0
3	22813563	.	G	T	5	4	9	0	1	10	0	0
3	22813569	.	T	G	6	2	8	0	0	8	0	0
3	22813628	.	C	A	7	5	12	0	0	12	0	0
3	22813629	.	T	A	7	5	12	0	0	12	0	0
3	22813778	.	C	T	5	7	12	0	0	12	0	0
3	22813998	.	T	G	4	6	10	0	0	10	0	0
3	22814109	.	G	A	5	9	14	0	0	14	0	0
3	22814147	.	G	A	0	12	12	0	9	21	0	0
3	22814209	.	T	C	16	11	27	0	1	28	0	0
3	22814230	.	A	G	16	0	16	0	10	26	0	0
3	22814453	.	A	G	12	12	24	0	5	29	0	0
3	22814478	.	A	G	13	10	23	0	2	25	0	0
3	22814546	.	G	A	9	19	28	0	0	28	0	0
3	22815395	.	C	T	11	2	13	0	2	15	0	0
3	22815400	.	C	A	1	3	4	0	12	16	0	0
3	22815994	.	C	T	0	6	6	0	11	17	0	0
3	22816030	.	A	G	6	4	10	0	0	10	0	0
3	22816166	.	T	C	4	3	7	0	0	7	0	0
3	22816167	.	G	A	4	3	7	0	0	7	0	0
3	22816360	.	A	G	2	2	4	0	0	4	0	0
3	22816368	.	T	A	1	2	3	0	0	3	0	0
3	22816652	.	A	G	3	2	5	0	1	6	0	0
3	22816676	.	T	C	2	2	4	0	0	4	0	0
3	22993279	.	A	C	2	5	7	0	0	7	0	0
3	22993614	.	C	T	3	2	5	0	0	5	0	0
3	22994078	.	G	T	0	11	11	0	12	23	0	0
3	22994344	.	G	T	1	7	8	0	5	13	0	0
3	23095572	.	G	T	0	2	2	0	0	2	0	0
3	23324746	.	T	A	1	2	3	0	0	3	0	0
3	23325207	.	A	C	1	3	4	0	0	4	0	0
3	23326711	.	G	A	9	5	14	0	1	15	0	0
3	23327282	.	C	T	13	23	36	0	0	36	0	0
3	23429169	.	A	C	15	17	32	0	2	34	0	0
3	23429262	.	A	T	14	10	24	0	1	25	0	0
3	23429263	.	T	C	14	7	21	0	4	25	0	0
3	23429433	.	A	G	6	4	10	0	1	11	0	0
3	23429696	.	A	G	9	7	16	0	3	19	0	0
3	23429763	.	A	C	10	0	10	0	15	25	0	0
3	23430011	.	G	A	4	8	12	0	1	13	0	0
3	23430067	.	A	G	6	7	13	0	3	16	0	0
3	23430116	.	T	A	5	3	8	0	0	8	0	0
3	23430119	.	C	T	0	2	2	0	6	8	0	0
3	23436305	.	T	A	4	0	4	0	0	4	0	0
3	23442923	.	A	G	1	3	4	0	0	4	0	0
3	23444539	.	A	T	0	1	1	0	0	1	0	0
3	23444551	.	T	G	0	2	2	0	0	2	0	0
3	23464828	.	T	C	1	2	3	0	1	4	0	0
3	23464865	.	T	C	2	5	7	0	0	7	0	0
3	23464894	.	G	A	6	5	11	0	0	11	0	0
3	23464911	.	C	T	5	5	10	0	1	11	0	0
3	23465292	.	T	C	1	3	4	0	0	4	0	0
3	23466160	.	A	G	2	6	8	0	0	8	0	0
3	23469391	.	C	T	1	4	5	0	0	5	0	0
3	23469438	.	A	G	2	5	7	0	1	8	0	0
3	23469472	.	T	C	1	3	4	0	0	4	0	0
3	23469848	.	T	A	1	6	7	0	0	7	0	0
3	23493694	.	T	C	5	2	7	0	0	7	0	0
3	23495767	.	T	C	12	20	32	0	0	32	0	0
3	23495872	.	T	C	9	12	21	0	1	22	0	0
3	23495905	.	G	T	7	10	17	0	1	18	0	0
3	23495908	.	A	G	8	10	18	0	0	18	0	0
3	23518249	.	G	A	2	2	4	0	1	5	0	0
3	23518281	.	A	T	1	2	3	0	0	3	0	0
3	23584128	.	G	A	7	8	15	0	1	16	0	0
3	23584577	.	A	C	11	9	20	0	0	20	0	0
3	23584703	.	A	T	9	5	14	0	0	14	0	0
3	23584704	.	T	A	9	5	14	0	0	14	0	0
3	23584748	.	C	A	4	5	9	0	3	12	0	0
3	23599844	.	A	C	7	9	16	0	2	18	0	0
3	24071108	.	T	C	12	9	21	0	0	21	0	0
3	24109865	.	T	A	1	3	4	0	0	4	0	0
3	24111146	.	T	C	6	7	13	0	0	13	0	0
3	24137967	.	G	A	4	2	6	0	0	6	0	0
3	24137968	.	T	A	4	2	6	0	0	6	0	0
3	24142965	.	C	T	2	4	6	0	0	6	0	0
3	24144037	.	A	G	4	3	7	0	1	8	0	0
3	24144716	.	C	T	5	7	12	0	3	15	0	0
3	24145191	.	G	A	0	5	5	0	5	10	0	0
3	24196092	.	C	T	1	2	3	0	0	3	0	0
3	24196204	.	T	C	1	4	5	0	0	5	0	0
3	24196365	.	T	G	4	7	11	0	1	12	0	0
3	24196576	.	T	G	3	4	7	0	2	9	0	0
3	24198970	.	G	A	10	10	20	0	0	20	0	0
3	24200563	.	T	A	6	9	15	0	3	18	0	0
3	24203310	.	A	G	3	4	7	0	0	7	0	0
3	24203504	.	A	G	1	3	4	0	2	6	0	0
3	24203588	.	T	C	3	2	5	0	0	5	0	0
3	24209715	.	T	A	2	2	4	0	0	4	0	0
3	24214534	.	G	T	0	0	0	0	1	1	0	0
3	24216029	.	A	G	3	0	3	0	0	3	0	0
3	24216161	.	T	C	1	1	2	0	0	2	0	0
3	24218282	.	C	T	4	7	11	0	1	12	0	0
3	24218564	.	A	C	5	3	8	0	0	8	0	0
3	24361257	.	T	C	11	9	20	0	1	21	0	0
3	24434494	.	T	A	24	26	50	0	7	57	0	0
3	24434512	.	C	G	24	31	55	0	4	59	0	0
3	24434601	.	C	T	26	26	52	0	3	55	0	0
3	24487821	.	A	G	2	4	6	0	0	6	0	0
3	24501686	.	G	C	5	3	8	0	0	8	0	0
3	24501772	.	G	A	5	2	7	0	0	7	0	0
3	24565930	.	G	A	0	1	1	0	0	1	0	0
3	24692005	.	G	T	0	4	4	0	6	10	0	0
3	24692014	.	T	C	6	4	10	0	0	10	0	0
3	24973667	.	T	A	4	11	15	0	1	16	0	0
3	24973867	.	T	A	11	20	31	0	0	31	0	0
3	24973912	.	T	C	8	0	8	0	15	23	0	0
3	24974298	.	G	A	7	12	19	0	0	19	0	0
3	24990641	.	G	A	0	13	13	0	8	21	0	0
3	24990746	.	A	C	10	7	17	0	1	18	0	0
3	24993657	.	G	C	12	20	32	0	1	33	0	0
3	24993682	.	A	G	18	18	36	0	0	36	0	0
3	24994253	.	T	C	17	27	44	0	4	48	0	0
3	24997055	.	A	T	15	17	32	0	4	36	0	0
3	24997955	.	A	T	7	7	14	0	0	14	0	0
3	24998204	.	C	G	4	4	8	0	1	9	0	0
3	24998533	.	A	G	7	5	12	0	0	12	0	0
3	24998536	.	A	G	7	4	11	0	1	12	0	0
3	24998797	.	C	T	2	6	8	0	0	8	0	0
3	24998833	.	C	T	2	3	5	0	1	6	0	0
3	24998860	.	C	T	4	3	7	0	0	7	0	0
3	24999601	.	C	T	0	3	3	0	4	7	0	0
3	24999636	.	A	C	2	3	5	0	1	6	0	0
3	24999916	.	A	G	1	2	3	0	2	5	0	0
3	25000114	.	G	A	1	4	5	0	0	5	0	0
3	25059771	.	A	G	6	6	12	0	1	13	0	0
3	25060009	.	C	T	4	4	8	0	0	8	0	0
3	25097047	.	C	A	7	9	16	0	4	20	0	0
3	25097218	.	T	A	0	1	1	0	0	1	0	0
3	25097257	.	T	C	0	1	1	0	0	1	0	0
3	25099018	.	A	G	2	2	4	0	0	4	0	0
3	25099883	.	T	C	6	5	11	0	0	11	0	0
3	25099988	.	T	A	16	19	35	0	2	37	0	0
3	25100004	.	A	G	21	19	40	0	2	42	0	0
3	25100182	.	A	T	15	14	29	0	1	30	0	0
3	25100222	.	G	A	0	18	18	0	17	35	0	0
3	25100311	.	C	G	20	16	36	0	2	38	0	0
3	25100379	.	A	T	29	12	41	0	2	43	0	0
3	25100565	.	T	G	4	1	5	0	8	13	0	0
3	25102030	.	A	T	16	14	30	0	6	36	0	0
3	25102095	.	A	G	22	6	28	0	2	30	0	0
3	25105097	.	A	C	2	0	2	0	3	5	0	0
3	25107705	.	T	C	3	3	6	0	1	7	0	0
3	25107729	.	A	T	3	5	8	0	0	8	0	0
3	25136479	.	C	T	0	17	17	0	15	32	0	0
3	25136571	.	G	A	6	7	13	0	0	13	0	0
3	25136655	.	T	A	8	7	15	0	1	16	0	0
3	25136819	.	T	G	8	5	13	0	0	13	0	0
3	25136855	.	G	T	10	4	14	0	2	16	0	0
3	25136868	.	A	G	9	5	14	0	3	17	0	0
3	25137144	.	G	T	3	2	5	0	0	5	0	0
3	25138264	.	G	T	7	2	9	0	0	9	0	0
3	25138306	.	C	T	5	3	8	0	1	9	0	0
3	25167162	.	A	G	3	3	6	0	0	6	0	0
3	25167238	.	C	A	2	4	6	0	1	7	0	0
3	25167332	.	A	C	2	2	4	0	1	5	0	0
3	25167351	.	A	C	3	3	6	0	0	6	0	0
3	25168907	.	A	T	2	10	12	0	0	12	0	0
3	25168994	.	C	T	4	8	12	0	3	15	0	0
3	25169181	.	C	T	1	2	3	0	0	3	0	0
3	25269936	.	A	C	1	18	19	0	3	22	0	0
3	25269960	.	A	G	6	27	33	0	2	35	0	0
3	25270023	.	A	G	15	19	34	0	1	35	0	0
3	25270048	.	G	T	13	23	36	0	1	37	0	0
3	25270058	.	A	C	15	19	34	0	1	35	0	0
3	25270311	.	A	G	28	21	49	0	15	64	0	0
3	25270320	.	A	G	35	20	55	0	13	68	0	0
3	25270602	.	C	G	26	34	60	0	14	74	0	0
3	25270680	.	C	T	37	27	64	0	2	66	0	0
3	25270710	.	A	C	34	26	60	0	3	63	0	0
3	25270752	.	A	G	27	28	55	0	3	58	0	0
3	25271209	.	T	A	28	29	57	0	3	60	0	0
3	25271579	.	C	T	14	13	27	0	1	28	0	0
3	25271653	.	T	C	17	16	33	0	0	33	0	0
3	25272051	.	T	A	3	5	8	0	0	8	0	0
3	25272623	.	C	T	17	17	34	0	3	37	0	0
3	25272859	.	T	A	11	16	27	0	1	28	0	0
3	25273463	.	G	A	13	5	18	0	0	18	0	0
3	25273524	.	G	C	1	0	1	0	1	2	0	0
3	25273648	.	A	G	4	2	6	0	0	6	0	0
3	25286050	.	G	A	0	3	3	0	0	3	0	0
3	25379483	.	C	A	0	22	22	0	19	41	0	0
3	25379546	.	A	G	18	16	34	0	6	40	0	0
3	25381494	.	G	A	18	17	35	0	1	36	0	0
3	25393308	.	A	G	9	7	16	0	4	20	0	0
3	25396677	.	G	T	5	11	16	0	1	17	0	0
3	25404038	.	G	A	1	2	3	0	0	3	0	0
3	25404045	.	A	G	1	2	3	0	0	3	0	0
3	25436893	.	T	G	1	3	4	0	2	6	0	0
3	25437284	.	G	T	12	8	20	0	2	22	0	0
3	26351448	.	A	G	14	9	23	0	2	25	0	0
3	27767284	.	A	G	2	9	11	0	0	11	0	0
3	27767288	.	A	G	6	4	10	0	0	10	0	0
3	27833009	.	T	C	13	6	19	0	0	19	0	0
3	27834131	.	T	C	4	3	7	0	0	7	0	0
3	27834134	.	T	C	5	2	7	0	0	7	0	0
3	27834305	.	T	C	3	2	5	0	2	7	0	0
3	27834412	.	T	C	2	4	6	0	1	7	0	0
3	27834552	.	T	C	3	4	7	0	0	7	0	0
3	28626468	.	A	T	3	2	5	0	0	5	0	0
3	28627044	.	T	A	6	7	13	0	2	15	0	0
3	28634549	.	A	G	2	2	4	0	0	4	0	0
3	28635106	.	G	A	3	3	6	0	1	7	0	0
3	28640608	.	C	T	0	2	2	0	0	2	0	0
3	28719506	.	C	G	9	3	12	0	1	13	0	0
3	28719592	.	T	G	6	4	10	0	0	10	0	0
3	28719636	.	T	A	6	3	9	0	0	9	0	0
3	28719649	.	C	T	3	6	9	0	1	10	0	0
3	28719730	.	G	T	5	7	12	0	1	13	0	0
3	28719852	.	T	C	2	3	5	0	0	5	0	0
3	28719878	.	G	A	3	4	7	0	2	9	0	0
3	28719905	.	C	A	0	3	3	0	6	9	0	0
3	28719971	.	C	A	0	3	3	0	1	4	0	0
3	29845010	.	C	T	11	3	14	0	0	14	0	0
3	29950927	.	T	C	8	7	15	0	0	15	0	0
3	29951384	.	T	C	6	6	12	0	0	12	0	0
3	30870409	.	G	A	2	3	5	0	0	5	0	0
3	30890630	.	T	A	7	10	17	0	2	19	0	0
3	30890869	.	G	A	10	19	29	0	4	33	0	0
3	30891201	.	A	G	6	4	10	0	4	14	0	0
3	30894281	.	A	G	3	2	5	0	0	5	0	0
3	30926689	.	A	G	0	2	2	0	0	2	0	0
3	31044205	.	A	G	4	4	8	0	1	9	0	0
3	31044579	.	A	G	3	5	8	0	1	9	0	0
3	31044649	.	T	C	2	3	5	0	0	5	0	0
3	31044916	.	G	C	2	2	4	0	0	4	0	0
3	31044923	.	A	G	2	2	4	0	0	4	0	0
3	31044986	.	G	T	1	2	3	0	1	4	0	0
3	31045335	.	C	G	1	2	3	0	0	3	0	0
3	31060366	.	C	T	2	3	5	0	0	5	0	0
3	31063319	.	A	G	1	2	3	0	0	3	0	0
3	31063625	.	A	T	4	3	7	0	0	7	0	0
3	31069634	.	T	C	10	8	18	0	1	19	0	0
3	31070892	.	A	G	2	3	5	0	0	5	0	0
3	31082995	.	T	A	0	0	0	0	1	1	0	0
3	31104046	.	T	C	1	2	3	0	0	3	0	0
3	31104065	.	T	C	1	3	4	0	0	4	0	0
3	31104104	.	G	C	2	4	6	0	1	7	0	0
3	31104127	.	A	T	3	5	8	0	1	9	0	0
3	31104382	.	C	T	6	2	8	0	0	8	0	0
3	31104652	.	G	A	4	2	6	0	1	7	0	0
3	31104655	.	G	T	3	2	5	0	2	7	0	0
3	31104943	.	C	T	0	4	4	0	1	5	0	0
3	31104969	.	G	A	5	5	10	0	0	10	0	0
3	31105259	.	A	C	27	24	51	0	3	54	0	0
3	31120249	.	C	T	8	6	14	0	1	15	0	0
3	31122581	.	T	G	5	6	11	0	1	12	0	0
3	31604053	.	G	A	2	2	4	0	0	4	0	0
3	31604834	.	A	T	4	3	7	0	2	9	0	0
3	31605033	.	A	G	3	1	4	0	0	4	0	0
3	31605039	.	C	T	3	2	5	0	0	5	0	0
3	31698887	.	G	A	1	2	3	0	0	3	0	0
3	31706607	.	C	A	15	6	21	0	0	21	0	0
3	31706966	.	T	C	5	2	7	0	1	8	0	0
3	31709010	.	C	T	11	12	23	0	0	23	0	0
3	31709079	.	G	A	6	4	10	0	0	10	0	0
3	31711526	.	T	C	2	1	3	0	0	3	0	0
3	31722101	.	A	T	11	5	16	0	0	16	0	0
3	31722342	.	A	G	2	4	6	0	0	6	0	0
3	31725824	.	C	T	9	11	20	0	1	21	0	0
3	31726066	.	T	C	13	11	24	0	0	24	0	0
3	31726395	.	G	A	0	6	6	0	6	12	0	0
3	31726541	.	A	T	5	9	14	0	2	16	0	0
3	31726829	.	C	T	10	19	29	0	1	30	0	0
3	31729087	.	T	G	1	5	6	0	0	6	0	0
3	31729160	.	T	A	3	3	6	0	0	6	0	0
3	31729177	.	G	C	1	3	4	0	0	4	0	0
3	31729328	.	A	G	1	4	5	0	1	6	0	0
3	31729531	.	C	T	4	3	7	0	1	8	0	0
3	31792683	.	G	T	6	4	10	0	1	11	0	0
3	31792856	.	G	A	4	4	8	0	1	9	0	0
3	31879513	.	T	A	6	5	11	0	1	13	1	0
3	31879626	.	G	A	6	7	13	0	1	14	0	0
3	31879725	.	T	A	5	8	13	0	0	13	0	0
3	31879726	.	C	A	5	8	13	0	0	13	0	0
3	31879880	.	G	T	12	9	21	0	0	21	0	0
3	31879911	.	T	C	9	12	21	0	0	21	0	0
3	31880184	.	C	G	0	7	7	0	11	18	0	0
3	31880641	.	C	T	0	9	9	0	7	16	0	0
3	31881082	.	G	T	1	1	2	0	0	2	0	0
3	31916624	.	T	G	3	1	4	0	11	15	0	0
3	31916701	.	A	T	7	11	18	0	3	21	0	0
3	31916724	.	A	G	11	11	22	0	0	22	0	0
3	31916787	.	G	T	13	7	20	0	3	23	0	0
3	31916863	.	T	C	17	9	26	0	1	27	0	0
3	31917075	.	T	G	12	0	12	0	14	26	0	0
3	31917279	.	G	T	11	8	19	0	1	20	0	0
3	31939272	.	A	G	0	0	0	0	1	1	0	0
3	31939473	.	G	T	0	7	7	0	7	14	0	0
3	31939566	.	C	A	9	9	18	0	1	19	0	0
3	31941152	.	C	T	1	7	8	0	0	8	0	0
3	31944357	.	A	T	17	9	26	0	0	26	0	0
3	31951034	.	A	C	1	3	4	0	0	4	0	0
3	32098194	.	C	T	3	3	6	0	0	6	0	0
3	32100183	.	G	T	6	3	9	0	1	10	0	0
3	32100206	.	T	C	3	3	6	0	2	8	0	0
3	32100755	.	T	C	16	11	27	0	3	30	0	0
3	32105746	.	C	A	3	5	8	0	0	8	0	0
3	32139671	.	G	A	2	3	5	0	1	6	0	0
3	32139701	.	C	G	2	3	5	0	0	5	0	0
3	32160490	.	G	A	12	3	15	0	0	15	0	0
3	32169545	.	G	A	0	1	1	0	0	1	0	0
3	32169677	.	C	T	3	3	6	0	0	6	0	0
3	32172667	.	A	G	1	2	3	0	0	3	0	0
3	32172669	.	G	T	1	2	3	0	0	3	0	0
3	32294745	.	G	A	14	12	26	0	1	27	0	0
3	32294869	.	C	G	0	7	7	0	13	20	0	0
3	32295151	.	C	T	6	4	10	0	2	12	0	0
3	32295294	.	G	A	6	5	11	0	1	12	0	0
3	32295519	.	A	C	5	4	9	0	1	10	0	0
3	32296122	.	C	T	1	3	4	0	1	5	0	0
3	32296124	.	A	G	0	5	5	0	0	5	0	0
3	32296306	.	G	A	3	2	5	0	0	5	0	0
3	32296379	.	A	G	3	3	6	0	0	6	0	0
3	32296559	.	G	A	2	3	5	0	0	5	0	0
3	32296708	.	C	T	2	3	5	0	0	5	0	0
3	32296709	.	A	C	2	3	5	0	0	5	0	0
3	32296873	.	G	A	4	2	6	0	0	6	0	0
3	32303045	.	G	A	0	2	2	0	1	3	0	0
3	32325218	.	A	G	2	11	13	0	2	15	0	0
3	32329167	.	A	T	8	11	19	0	0	19	0	0
3	32357596	.	C	T	11	14	25	0	9	34	0	0
3	32357799	.	A	C	10	31	41	0	3	44	0	0
3	32360978	.	G	A	2	2	4	0	0	4	0	0
3	32361669	.	G	A	3	2	5	0	3	8	0	0
3	32400967	.	C	T	23	27	50	0	12	62	0	0
3	32401159	.	C	A	32	35	67	0	4	71	0	0
3	32401252	.	C	T	23	28	51	0	7	58	0	0
3	32405865	.	G	C	9	6	15	0	0	15	0	0
3	32405910	.	C	T	10	11	21	0	2	23	0	0
3	32406447	.	T	C	34	18	52	0	2	54	0	0
3	32406547	.	T	C	21	20	41	0	1	42	0	0
3	32406618	.	G	A	22	25	47	0	5	52	0	0
3	32406631	.	C	G	22	23	45	0	2	47	0	0
3	32438425	.	A	C	1	2	3	0	0	3	0	0
3	32440805	.	A	G	2	2	4	0	0	4	0	0
3	32441297	.	C	A	7	4	11	0	0	11	0	0
3	32441385	.	G	C	4	5	9	0	2	11	0	0
3	32441532	.	G	A	1	4	5	0	0	5	0	0
3	32441779	.	C	T	8	6	14	0	1	15	0	0
3	32447386	.	G	A	13	6	19	0	1	20	0	0
3	32447505	.	G	T	19	14	33	0	4	37	0	0
3	32447674	.	C	G	21	13	34	0	2	36	0	0
3	32447800	.	T	C	3	5	8	0	0	8	0	0
3	32450399	.	T	C	9	10	19	0	2	21	0	0
3	32453727	.	G	A	5	6	11	0	3	14	0	0
3	32457325	.	G	A	0	1	1	0	6	7	0	0
3	32457620	.	T	C	12	11	23	0	2	25	0	0
3	32457686	.	T	C	8	16	24	0	4	28	0	0
3	32458627	.	C	T	12	7	19	0	2	21	0	0
3	32476803	.	T	G	0	2	2	0	0	2	0	0
3	32482834	.	A	G	2	2	4	0	0	4	0	0
3	32484034	.	A	G	1	0	1	0	4	5	0	0
3	32484039	.	A	G	1	0	1	0	4	5	0	0
3	32484204	.	T	C	4	5	9	0	1	10	0	0
3	32484676	.	T	G	3	5	8	0	0	8	0	0
3	32484892	.	A	G	2	3	5	0	1	6	0	0
3	32485306	.	A	G	9	8	17	0	0	17	0	0
3	32485324	.	C	T	8	10	18	0	1	19	0	0
3	32485366	.	A	G	5	9	14	0	1	15	0	0
3	32485519	.	A	C	7	3	10	0	3	13	0	0
3	32485967	.	C	A	17	5	22	0	8	30	0	0
3	32486049	.	A	T	14	12	26	0	2	28	0	0
3	32486069	.	C	G	11	0	11	0	12	23	0	0
3	32489613	.	C	T	20	16	36	0	4	40	0	0
3	32490098	.	C	T	18	11	29	0	2	31	0	0
3	32490251	.	G	T	23	12	35	0	1	36	0	0
3	32490264	.	G	A	16	11	27	0	3	30	0	0
3	32490487	.	G	T	10	16	26	0	1	27	0	0
3	32534263	.	A	G	0	3	3	0	0	3	0	0
3	32534353	.	C	T	3	1	4	0	0	4	0	0
3	32534365	.	T	A	2	0	2	0	0	2	0	0
3	32587304	.	C	T	4	5	9	0	0	9	0	0
3	32643512	.	G	A	10	4	14	0	3	17	0	0
3	32647124	.	T	C	8	11	19	0	1	20	0	0
3	32647194	.	C	T	6	7	13	0	0	13	0	0
3	32647252	.	G	A	6	7	13	0	3	16	0	0
3	32647308	.	G	C	12	6	18	0	2	20	0	0
3	32647414	.	A	G	2	0	2	0	0	2	0	0
3	32649846	.	C	T	6	18	24	0	1	25	0	0
3	32649960	.	G	A	12	12	24	0	0	24	0	0
3	32650004	.	A	G	10	17	27	0	3	30	0	0
3	32650199	.	C	A	7	9	16	0	2	18	0	0
3	32667118	.	A	C	3	5	8	0	1	9	0	0
3	32668806	.	A	G	8	3	11	0	1	12	0	0
3	32668818	.	A	G	6	4	10	0	2	12	0	0
3	32669040	.	C	G	4	2	6	0	1	7	0	0
3	32669077	.	T	A	2	4	6	0	1	7	0	0
3	32675236	.	G	A	8	4	12	0	0	12	0	0
3	32679267	.	T	A	6	6	12	0	0	12	0	0
3	32679289	.	T	A	9	10	19	0	2	21	0	0
3	32679332	.	C	T	15	12	27	0	0	27	0	0
3	32679528	.	C	A	7	8	15	0	1	16	0	0
3	32685708	.	A	G	3	0	3	0	6	9	0	0
3	32698500	.	A	G	1	4	5	0	2	7	0	0
3	32700697	.	A	G	1	3	4	0	0	4	0	0
3	32700758	.	A	G	4	3	7	0	1	8	0	0
3	32700988	.	C	T	5	4	9	0	0	9	0	0
3	32702596	.	T	A	8	3	11	0	1	12	0	0
3	32707219	.	G	A	5	10	15	0	1	16	0	0
3	32707267	.	T	C	8	8	16	0	1	17	0	0
3	32707272	.	C	A	8	7	15	0	0	15	0	0
3	32707480	.	C	T	6	10	16	0	3	19	0	0
3	32707621	.	C	G	20	13	33	0	1	34	0	0
3	32707813	.	C	G	21	13	34	0	3	37	0	0
3	32708077	.	T	C	9	9	18	0	5	23	0	0
3	32709139	.	G	A	1	1	2	0	0	2	0	0
3	32710705	.	A	G	12	5	17	0	0	17	0	0
3	32710812	.	G	A	0	2	2	0	2	4	0	0
3	32710999	.	C	A	11	4	15	0	0	15	0	0
3	32711117	.	T	C	1	3	4	0	0	4	0	0
3	32711147	.	T	A	1	5	6	0	0	6	0	0
3	32729663	.	C	T	3	2	5	0	0	5	0	0
3	32731418	.	C	T	1	2	3	0	2	5	0	0
3	32741137	.	G	A	0	6	6	0	4	10	0	0
3	32741385	.	G	A	0	6	6	0	6	12	0	0
3	32777481	.	A	C	6	8	14	0	0	14	0	0
3	32777733	.	G	T	5	12	17	0	0	17	0	0
3	32808185	.	T	C	1	2	3	0	1	4	0	0
3	32808214	.	G	A	2	4	6	0	0	6	0	0
3	32808338	.	A	C	3	11	14	0	1	15	0	0
3	32808554	.	T	G	2	5	7	0	0	7	0	0
3	32808771	.	G	A	1	2	3	0	2	5	0	0
3	32808772	.	G	C	1	3	4	0	1	5	0	0
3	32808979	.	T	G	3	2	5	0	0	5	0	0
3	32809154	.	A	T	1	2	3	0	0	3	0	0
3	32809368	.	G	A	2	9	11	0	2	13	0	0
3	32809410	.	G	A	2	8	10	0	1	11	0	0
3	32809432	.	T	A	3	5	8	0	0	8	0	0
3	32809548	.	T	C	1	3	4	0	0	4	0	0
3	32809561	.	G	A	1	4	5	0	0	5	0	0
3	32809836	.	A	G	4	0	4	0	8	12	0	0
3	32809927	.	T	C	1	10	11	0	1	12	0	0
3	32810011	.	T	A	7	5	12	0	1	13	0	0
3	32810580	.	C	T	16	17	33	0	1	34	0	0
3	32810715	.	A	G	17	14	31	0	1	32	0	0
3	32811094	.	A	T	7	7	14	0	2	16	0	0
3	32837514	.	G	A	11	7	18	0	0	18	0	0
3	32837643	.	G	A	12	6	18	0	7	25	0	0
3	32837904	.	A	G	20	1	21	0	16	38	1	0
3	32838033	.	G	A	0	7	7	0	4	11	0	0
3	32838039	.	A	G	4	6	10	0	0	10	0	0
3	32842163	.	C	T	5	8	13	0	0	13	0	0
3	32842235	.	G	T	9	9	18	0	3	21	0	0
3	32842318	.	C	T	6	4	10	0	0	10	0	0
3	32854276	.	T	C	2	2	4	0	0	4	0	0
3	32854533	.	T	C	4	4	8	0	1	9	0	0
3	32854743	.	C	G	5	0	5	0	11	16	0	0
3	32854744	.	A	G	7	9	16	0	0	16	0	0
3	32855066	.	G	A	10	12	22	0	0	22	0	0
3	32867711	.	C	A	2	0	2	0	0	2	0	0
3	32868114	.	G	T	0	3	3	0	0	3	0	0
3	32868143	.	C	T	0	3	3	0	0	3	0	0
3	32868519	.	G	T	4	7	11	0	0	11	0	0
3	32868590	.	C	T	4	5	9	0	0	9	0	0
3	32868593	.	A	G	4	4	8	0	1	9	0	0
3	32869770	.	C	T	2	4	6	0	2	8	0	0
3	32869773	.	G	A	2	6	8	0	0	8	0	0
3	32870564	.	G	C	1	4	5	0	0	5	0	0
3	32870572	.	C	A	1	4	5	0	0	5	0	0
3	32870756	.	A	G	3	0	3	0	5	8	0	0
3	32870766	.	G	A	3	4	7	0	0	7	0	0
3	32870947	.	A	G	1	2	3	0	0	3	0	0
3	32871023	.	G	C	2	4	6	0	0	6	0	0
3	32871202	.	T	C	1	2	3	0	1	4	0	0
3	32871350	.	T	C	2	2	4	0	0	4	0	0
3	32871532	.	A	T	3	5	8	0	0	8	0	0
3	32890002	.	G	T	10	18	28	0	1	29	0	0
3	32890058	.	A	G	7	11	18	0	2	20	0	0
3	32892061	.	G	A	2	4	6	0	0	6	0	0
3	32892422	.	A	G	2	3	5	0	0	5	0	0
3	32924643	.	G	A	0	3	3	0	2	5	0	0
3	32924836	.	T	A	2	2	4	0	0	4	0	0
3	32941242	.	G	A	1	3	4	0	1	5	0	0
3	32944203	.	C	A	3	5	8	0	0	8	0	0
3	32944668	.	C	A	2	9	11	0	1	12	0	0
3	32944854	.	C	T	5	4	9	0	1	10	0	0
3	32947971	.	T	C	1	1	2	0	2	4	0	0
3	32950959	.	G	A	1	13	14	0	0	14	0	0
3	32950977	.	G	A	0	12	12	0	3	15	0	0
3	32951001	.	G	T	0	10	10	0	6	16	0	0
3	32951394	.	G	A	19	20	39	0	3	42	0	0
3	32951564	.	A	C	7	9	16	0	0	16	0	0
3	32951637	.	G	A	13	9	22	0	1	23	0	0
3	32951778	.	C	T	15	18	33	0	4	37	0	0
3	32951891	.	T	C	17	13	30	0	2	32	0	0
3	33065950	.	T	C	7	2	9	0	0	9	0	0
3	33066155	.	C	T	0	7	7	0	4	11	0	0
3	33066241	.	C	T	0	2	2	0	2	4	0	0
3	33066292	.	C	T	8	1	9	0	0	9	0	0
3	33066714	.	A	T	2	2	4	0	0	4	0	0
3	33066804	.	T	C	4	0	4	0	3	7	0	0
3	33066809	.	C	G	5	2	7	0	1	8	0	0
3	33341072	.	T	A	1	2	3	0	0	3	0	0
3	33344470	.	T	A	5	8	13	0	0	13	0	0
3	33344636	.	A	T	2	4	6	0	0	6	0	0
3	33424010	.	C	T	1	6	7	0	10	17	0	0
3	33424420	.	G	A	17	20	37	0	6	43	0	0
3	33426513	.	G	A	10	3	13	0	2	15	0	0
3	33433621	.	G	A	4	6	10	0	0	10	0	0
3	33449405	.	C	T	1	1	2	0	0	2	0	0
3	33452168	.	C	T	9	6	15	0	1	16	0	0
3	33455809	.	G	A	0	4	4	0	5	9	0	0
3	33458803	.	C	T	9	15	24	0	4	28	0	0
3	33458911	.	A	T	12	13	25	0	0	25	0	0
3	33459394	.	T	A	5	4	9	0	0	9	0	0
3	33459489	.	C	T	2	5	7	0	2	9	0	0
3	33459517	.	C	T	3	9	12	0	0	12	0	0
3	33459532	.	G	A	5	10	15	0	0	15	0	0
3	33461366	.	C	T	0	18	18	0	14	32	0	0
3	33461646	.	C	T	0	9	9	0	11	20	0	0
3	33461796	.	A	T	12	6	18	0	0	18	0	0
3	33469614	.	T	A	1	1	2	0	0	2	0	0
3	33761597	.	C	T	8	12	20	0	0	20	0	0
3	33761705	.	G	A	0	8	8	0	17	25	0	0
3	33761834	.	G	A	21	9	30	0	2	32	0	0
3	33761835	.	A	T	21	9	30	0	2	32	0	0
3	33762068	.	A	G	12	8	20	0	3	23	0	0
3	33762278	.	A	G	18	17	35	0	3	38	0	0
3	33762310	.	C	A	18	10	28	0	3	31	0	0
3	33762408	.	T	A	11	17	28	0	2	30	0	0
3	33762480	.	C	T	9	13	22	0	1	23	0	0
3	33773294	.	A	G	1	3	4	0	0	4	0	0
3	33777317	.	T	G	0	2	2	0	0	2	0	0
3	33777425	.	A	G	4	2	6	0	0	6	0	0
3	33777807	.	A	G	1	1	2	0	0	2	0	0
3	33918611	.	A	G	4	2	6	0	0	6	0	0
3	33921663	.	A	C	10	5	15	0	0	15	0	0
3	33922233	.	T	A	1	2	3	0	0	3	0	0
3	33922245	.	T	C	2	2	4	0	0	4	0	0
3	33922269	.	A	G	3	2	5	0	0	5	0	0
3	33922413	.	T	A	6	8	14	0	1	15	0	0
3	33922415	.	G	A	6	9	15	0	0	15	0	0
3	33922471	.	T	C	9	4	13	0	1	14	0	0
3	33932170	.	C	T	0	2	2	0	3	5	0	0
3	33948686	.	A	T	3	2	5	0	0	5	0	0
3	33948734	.	T	C	2	3	5	0	0	5	0	0
3	34129941	.	C	T	0	7	7	0	14	21	0	0
3	34135868	.	C	T	1	1	2	0	0	2	0	0
3	34146882	.	G	T	6	6	12	0	0	12	0	0
3	34146955	.	A	G	3	3	6	0	0	6	0	0
3	34166288	.	C	A	1	3	4	0	0	4	0	0
3	34170913	.	G	A	5	10	15	0	1	16	0	0
3	34182164	.	C	T	6	4	10	0	0	10	0	0
3	34182306	.	G	C	9	8	17	0	1	18	0	0
3	34182376	.	A	C	5	11	16	0	1	17	0	0
3	34182386	.	G	A	0	12	12	0	5	17	0	0
3	34244901	.	G	C	10	12	22	0	0	22	0	0
3	34258965	.	G	A	15	20	35	0	1	36	0	0
3	34259013	.	C	G	19	17	36	0	7	43	0	0
3	34259060	.	C	T	35	16	51	0	0	51	0	0
3	34259869	.	T	G	6	2	8	0	9	18	1	0
3	34260325	.	T	C	4	7	11	0	0	11	0	0
3	34261204	.	T	C	1	2	3	0	0	3	0	0
3	34261354	.	A	G	7	12	19	0	0	19	0	0
3	34262639	.	G	A	3	1	4	0	1	5	0	0
3	34337389	.	A	G	6	1	7	0	0	7	0	0
3	34588493	.	A	G	3	4	7	0	0	7	0	0
3	34588788	.	G	A	6	6	12	0	0	12	0	0
3	34604202	.	A	G	1	1	2	0	1	3	0	0
3	34697461	.	G	A	5	7	12	0	0	12	0	0
3	34697514	.	T	C	1	0	1	0	15	16	0	0
3	34767112	.	G	T	23	39	62	0	4	66	0	0
3	34767662	.	T	G	28	30	58	0	3	61	0	0
3	34767669	.	G	A	26	30	56	0	1	57	0	0
3	34772941	.	T	G	14	15	29	0	0	29	0	0
3	34775942	.	G	A	22	12	34	0	0	34	0	0
3	34776115	.	T	G	0	0	0	0	1	1	0	0
3	34776133	.	G	C	1	2	3	0	0	3	0	0
3	34776151	.	C	A	1	2	3	0	0	3	0	0
3	34781074	.	A	G	6	6	12	0	0	12	0	0
3	34781095	.	C	T	5	7	12	0	2	14	0	0
3	34781448	.	T	C	0	1	1	0	0	1	0	0
3	34804427	.	A	G	8	13	21	0	0	21	0	0
3	34822049	.	C	T	6	2	8	0	0	8	0	0
3	34822214	.	T	C	1	2	3	0	0	3	0	0
3	34977497	.	A	G	2	0	2	0	5	7	0	0
3	34977508	.	A	G	1	0	1	0	1	2	0	0
3	34981394	.	T	C	6	8	14	0	0	14	0	0
3	34994140	.	C	T	23	36	59	0	2	61	0	0
3	34994750	.	A	G	16	13	29	0	2	31	0	0
3	35225160	.	A	G	1	0	1	0	4	5	0	0
3	35225202	.	C	T	6	4	10	0	0	10	0	0
3	35248470	.	T	C	1	4	5	0	0	5	0	0
3	35248492	.	T	A	1	4	5	0	0	5	0	0
3	35249369	.	T	C	9	15	24	0	1	25	0	0
3	35249535	.	T	C	10	16	26	0	3	29	0	0
3	35250145	.	A	T	17	24	41	0	0	41	0	0
3	35250188	.	A	G	8	9	17	0	5	22	0	0
3	35264406	.	T	G	11	6	17	0	2	19	0	0
3	35264460	.	C	T	13	10	23	0	2	25	0	0
3	35264951	.	G	A	7	6	13	0	1	14	0	0
3	35265350	.	T	C	10	11	21	0	4	25	0	0
3	35265419	.	T	G	13	12	25	0	3	28	0	0
3	35265654	.	G	A	1	25	26	0	28	54	0	0
3	35266006	.	G	A	4	4	8	0	0	8	0	0
3	35374719	.	C	T	2	7	9	0	0	9	0	0
3	35375112	.	G	A	7	10	17	0	2	19	0	0
3	35375162	.	T	A	8	15	23	0	1	24	0	0
3	35375279	.	A	T	10	6	16	0	0	16	0	0
3	35375306	.	T	C	12	5	17	0	0	17	0	0
3	35375638	.	T	A	17	13	30	0	4	34	0	0
3	35419683	.	A	T	4	8	12	0	1	13	0	0
3	35420588	.	A	G	7	6	13	0	2	15	0	0
3	35420604	.	C	T	8	8	16	0	0	16	0	0
3	35529040	.	T	C	2	6	8	0	0	8	0	0
3	35531018	.	T	C	5	1	6	0	2	8	0	0
3	35531028	.	T	C	7	3	10	0	2	12	0	0
3	35531328	.	G	A	0	2	2	0	5	7	0	0
3	35531329	.	A	T	5	2	7	0	0	7	0	0
3	35531671	.	A	T	4	6	10	0	1	11	0	0
3	35531866	.	T	A	8	12	20	0	1	21	0	0
3	35531985	.	G	A	21	12	33	0	0	33	0	0
3	35532074	.	A	T	13	12	25	0	1	26	0	0
3	35532452	.	A	T	16	21	37	0	1	38	0	0
3	35532665	.	C	T	13	16	29	0	2	31	0	0
3	35532736	.	A	C	12	6	18	0	2	20	0	0
3	35535484	.	G	A	2	2	4	0	0	4	0	0
3	35535695	.	A	C	2	2	4	0	0	4	0	0
3	35535702	.	G	T	2	2	4	0	0	4	0	0
3	35536115	.	C	G	15	9	24	0	2	26	0	0
3	35536269	.	G	A	0	2	2	0	0	2	0	0
3	35541273	.	A	G	21	18	39	0	3	42	0	0
3	35551047	.	A	T	18	15	33	0	2	35	0	0
3	35551190	.	C	T	0	14	14	0	8	22	0	0
3	35589548	.	C	T	24	21	45	0	0	45	0	0
3	35589881	.	T	C	17	16	33	0	3	36	0	0
3	35589908	.	A	G	20	11	31	0	5	36	0	0
3	35589918	.	G	A	21	11	32	0	2	34	0	0
3	35602007	.	A	C	3	0	3	0	6	9	0	0
3	35602047	.	A	G	5	4	9	0	2	11	0	0
3	35635039	.	C	T	5	3	8	0	1	9	0	0
3	35635248	.	A	G	1	2	3	0	0	3	0	0
3	35636157	.	A	G	5	3	8	0	0	8	0	0
3	35636387	.	A	G	3	1	4	0	1	5	0	0
3	35636388	.	A	G	2	3	5	0	0	5	0	0
3	35638008	.	T	A	11	10	21	0	2	23	0	0
3	35638119	.	A	C	25	9	34	0	1	35	0	0
3	35638201	.	A	G	12	14	26	0	3	29	0	0
3	35638240	.	C	T	13	14	27	0	0	27	0	0
3	35638366	.	T	C	9	6	15	0	1	16	0	0
3	35638450	.	T	A	3	3	6	0	1	7	0	0
3	35638513	.	G	A	13	8	21	0	1	22	0	0
3	35638908	.	C	T	0	13	13	0	23	36	0	0
3	35638986	.	C	A	12	18	30	0	1	31	0	0
3	35639020	.	A	G	12	10	22	0	1	23	0	0
3	35639021	.	G	A	12	11	23	0	0	23	0	0
3	35639194	.	T	C	15	14	29	0	1	30	0	0
3	35639621	.	A	C	7	9	16	0	1	17	0	0
3	35639817	.	T	A	4	4	8	0	1	9	0	0
3	35639862	.	G	T	4	8	12	0	0	12	0	0
3	35639884	.	T	C	1	0	1	0	9	10	0	0
3	35639958	.	T	C	1	2	3	0	3	6	0	0
3	35640042	.	A	G	4	9	13	0	1	14	0	0
3	35640122	.	G	T	3	7	10	0	0	10	0	0
3	35640441	.	C	A	2	2	4	0	0	4	0	0
3	35640784	.	T	C	2	3	5	0	0	5	0	0
3	35640828	.	A	G	1	2	3	0	0	3	0	0
3	35641173	.	C	T	2	0	2	0	0	2	0	0
3	35641371	.	C	T	0	3	3	0	2	5	0	0
3	35641382	.	G	A	1	3	4	0	0	4	0	0
3	35641595	.	A	T	2	3	5	0	0	5	0	0
3	35643320	.	G	A	3	10	13	0	1	14	0	0
3	35643357	.	G	A	2	2	4	0	1	5	0	0
3	35643359	.	G	A	1	2	3	0	2	5	0	0
3	35643540	.	G	A	4	5	9	0	1	10	0	0
3	35643546	.	A	T	3	2	5	0	0	5	0	0
3	35645380	.	T	C	5	0	5	0	11	16	0	0
3	35645411	.	G	A	8	3	11	0	0	11	0	0
3	35645661	.	T	G	7	3	10	0	0	10	0	0
3	35646025	.	G	T	2	3	5	0	0	5	0	0
3	35646160	.	G	T	1	2	3	0	0	3	0	0
3	35800738	.	T	C	1	3	4	0	0	4	0	0
3	35800936	.	A	C	1	3	4	0	0	4	0	0
3	35845735	.	A	G	0	0	0	0	1	1	0	0
3	35845774	.	T	C	1	2	3	0	1	4	0	0
3	35846120	.	C	G	6	4	10	0	2	12	0	0
3	35846410	.	A	T	3	3	6	0	0	6	0	0
3	35846440	.	G	A	2	4	6	0	0	6	0	0
3	35846823	.	A	G	8	7	15	0	2	17	0	0
3	35850254	.	G	A	2	6	8	0	0	8	0	0
3	35850364	.	A	G	6	2	8	0	0	8	0	0
3	35850380	.	C	T	5	2	7	0	1	8	0	0
3	36026294	.	C	G	0	4	4	0	1	5	0	0
3	36120186	.	T	C	1	0	1	0	0	1	0	0
3	36125256	.	C	G	0	4	4	0	5	9	0	0
3	36127055	.	T	A	1	2	3	0	0	3	0	0
3	36127108	.	G	A	1	2	3	0	0	3	0	0
3	36131883	.	T	A	1	2	3	0	0	3	0	0
3	36132099	.	C	T	0	1	1	0	0	1	0	0
3	36132740	.	T	C	5	3	8	0	0	8	0	0
3	36135084	.	A	G	1	3	4	0	0	4	0	0
3	36135867	.	A	C	2	3	5	0	0	5	0	0
3	36136609	.	T	C	4	2	6	0	0	6	0	0
3	36173633	.	T	C	18	9	27	0	0	27	0	0
3	36174175	.	C	A	11	12	23	0	2	25	0	0
3	36174248	.	C	G	7	9	16	0	1	17	0	0
3	36188400	.	A	G	0	2	2	0	1	3	0	0
3	36229823	.	G	A	6	4	10	0	0	10	0	0
3	36232218	.	A	G	3	3	6	0	0	6	0	0
3	36232331	.	C	T	4	3	7	0	2	9	0	0
3	36232368	.	A	C	3	3	6	0	0	6	0	0
3	36242239	.	C	T	0	0	0	0	2	2	0	0
3	36248869	.	T	C	4	23	27	0	0	27	0	0
3	36249419	.	G	A	17	5	22	0	1	23	0	0
3	36249476	.	T	A	20	16	36	0	0	36	0	0
3	36249516	.	T	A	13	8	21	0	1	22	0	0
3	36249518	.	A	C	13	8	21	0	1	22	0	0
3	36255436	.	A	G	2	1	3	0	2	5	0	0
3	36259855	.	T	C	4	5	9	0	0	9	0	0
3	36263099	.	T	C	11	0	11	0	18	29	0	0
3	36263151	.	A	G	11	21	32	0	2	34	0	0
3	36263163	.	C	T	9	24	33	0	2	35	0	0
3	36263464	.	C	A	13	9	22	0	1	23	0	0
3	36263557	.	A	G	10	11	21	0	0	21	0	0
3	36263563	.	T	A	9	12	21	0	0	21	0	0
3	36263596	.	T	C	4	0	4	0	11	15	0	0
3	36263824	.	T	C	15	12	27	0	2	29	0	0
3	36263895	.	A	T	8	16	24	0	2	26	0	0
3	36264204	.	T	G	1	4	5	0	0	5	0	0
3	36264217	.	A	C	2	6	8	0	0	8	0	0
3	36264248	.	T	C	3	5	8	0	2	10	0	0
3	36264498	.	G	A	3	4	7	0	0	7	0	0
3	36292481	.	G	C	0	1	1	0	0	1	0	0
3	36305854	.	A	G	15	25	40	0	4	44	0	0
3	36305860	.	A	G	18	0	18	0	28	46	0	0
3	36305971	.	T	A	17	14	31	0	0	31	0	0
3	36327060	.	G	A	0	2	2	0	2	4	0	0
3	36327061	.	A	C	2	2	4	0	0	4	0	0
3	36327129	.	G	A	1	2	3	0	0	3	0	0
3	36327872	.	G	A	4	6	10	0	1	11	0	0
3	36327906	.	G	T	6	5	11	0	0	11	0	0
3	36327909	.	G	T	0	5	5	0	6	11	0	0
3	36328083	.	G	T	4	2	6	0	0	6	0	0
3	36328204	.	C	A	7	3	10	0	0	10	0	0
3	36328218	.	G	A	5	4	9	0	3	12	0	0
3	36328339	.	G	A	6	6	12	0	0	12	0	0
3	36407283	.	C	A	1	0	1	0	0	1	0	0
3	36428145	.	T	A	3	2	5	0	0	5	0	0
3	36428612	.	T	A	14	17	31	0	4	35	0	0
3	36428620	.	T	A	16	15	31	0	6	37	0	0
3	36431380	.	T	C	0	4	4	0	0	4	0	0
3	36441465	.	G	A	5	3	8	0	1	9	0	0
3	36441484	.	T	C	8	2	10	0	2	12	0	0
3	36442021	.	T	C	0	3	3	0	0	3	0	0
3	36442029	.	A	G	0	2	2	0	0	2	0	0
3	36442551	.	C	T	0	11	11	0	6	17	0	0
3	36442661	.	T	G	6	6	12	0	1	13	0	0
3	36442726	.	A	G	7	8	15	0	1	16	0	0
3	36584643	.	A	T	2	2	4	0	0	4	0	0
3	37107093	.	C	T	1	3	4	0	1	5	0	0
3	37107240	.	G	T	5	3	8	0	1	9	0	0
3	37559334	.	A	T	24	23	47	0	1	48	0	0
3	37559905	.	A	C	11	12	23	0	1	24	0	0
3	37560289	.	G	A	6	4	10	0	1	11	0	0
3	37564769	.	G	A	4	1	5	0	1	6	0	0
3	37649598	.	G	C	0	1	1	0	0	1	0	0
3	37660307	.	G	A	6	4	10	0	1	11	0	0
3	37664117	.	A	T	13	16	29	0	0	29	0	0
3	37664635	.	A	G	19	10	29	0	0	29	0	0
3	37665855	.	G	A	10	9	19	0	3	22	0	0
3	37666774	.	C	T	0	6	6	0	6	12	0	0
3	37667562	.	C	T	0	13	13	0	12	25	0	0
3	37667608	.	G	C	10	10	20	0	1	21	0	0
3	37667646	.	C	T	8	3	11	0	1	12	0	0
3	37667952	.	C	T	0	11	11	0	4	15	0	0
3	37668578	.	T	A	3	3	6	0	1	7	0	0
3	37738024	.	A	G	4	4	8	0	0	8	0	0
3	37738050	.	C	G	3	5	8	0	1	9	0	0
3	37738089	.	G	A	2	6	8	0	1	9	0	0
3	37742116	.	A	C	1	0	1	0	0	1	0	0
3	37742152	.	T	C	4	3	7	0	0	7	0	0
3	37742245	.	C	T	5	2	7	0	0	7	0	0
3	37742247	.	A	G	4	2	6	0	1	7	0	0
3	37742338	.	C	G	4	2	6	0	0	6	0	0
3	37742363	.	C	T	3	2	5	0	1	6	0	0
3	37776713	.	T	C	2	7	9	0	0	9	0	0
3	37777309	.	A	T	6	6	12	0	2	14	0	0
3	37777590	.	C	T	3	5	8	0	2	10	0	0
3	37777811	.	C	T	0	6	6	0	2	8	0	0
3	37788401	.	T	C	3	1	4	1	0	5	0	0
3	37792648	.	T	C	0	2	2	0	0	2	0	0
3	38624823	.	G	A	2	2	4	0	0	4	0	0
3	38625605	.	G	A	7	3	10	0	0	10	0	0
3	38625751	.	A	C	3	2	5	0	0	5	0	0
3	38648004	.	A	T	1	2	3	0	0	3	0	0
3	38649991	.	A	T	4	3	7	0	0	7	0	0
3	38763153	.	T	A	14	7	21	0	0	21	0	0
3	38763391	.	A	G	9	11	20	0	2	22	0	0
3	38763527	.	C	T	0	1	1	0	9	10	0	0
3	38763564	.	C	A	5	5	10	0	0	10	0	0
3	39181635	.	C	T	1	5	6	0	0	6	0	0
3	39181699	.	G	A	1	2	3	0	0	3	0	0
3	39181823	.	A	G	2	2	4	0	0	4	0	0
3	39181849	.	A	G	2	3	5	0	0	5	0	0
3	39184180	.	C	T	0	2	2	0	0	2	0	0
3	39238579	.	C	A	8	11	19	0	0	19	0	0
3	39238580	.	C	A	7	10	17	0	2	19	0	0
3	39239380	.	A	G	4	4	8	0	0	8	0	0
3	39241350	.	G	T	0	1	1	0	0	1	0	0
3	39248863	.	A	G	1	3	4	0	0	4	0	0
3	39313310	.	A	G	6	12	18	0	3	21	0	0
3	39313625	.	T	C	4	7	11	0	1	12	0	0
3	39314028	.	C	T	6	9	15	0	1	16	0	0
3	39314101	.	T	C	6	5	11	0	2	13	0	0
3	39314146	.	C	G	3	2	5	0	1	6	0	0
3	39314260	.	A	G	1	2	3	0	0	3	0	0
3	39314502	.	G	C	1	2	3	0	1	4	0	0
3	39314631	.	C	T	0	3	3	0	2	5	0	0
3	39314677	.	C	T	1	2	3	0	0	3	0	0
3	39316996	.	A	G	1	2	3	0	0	3	0	0
3	39568368	.	T	G	1	1	2	0	0	2	0	0
3	39568856	.	A	G	5	3	8	0	1	9	0	0
3	39574883	.	C	A	11	18	29	0	2	31	0	0
3	39574961	.	G	A	15	34	49	0	4	53	0	0
3	39576621	.	T	G	24	0	24	0	27	51	0	0
3	39576866	.	T	C	27	14	41	0	3	44	0	0
3	39592640	.	T	G	0	2	2	0	0	2	0	0
3	39592797	.	C	T	0	2	2	0	0	2	0	0
3	39592800	.	G	C	0	2	2	0	1	3	0	0
3	39612261	.	T	A	8	9	17	0	0	17	0	0
3	39612430	.	T	C	10	5	15	0	1	16	0	0
3	39612579	.	G	C	9	9	18	0	1	19	0	0
3	39612715	.	A	T	13	4	17	0	1	18	0	0
3	39613024	.	T	C	11	15	26	0	2	28	0	0
3	39689216	.	T	C	2	2	4	0	0	4	0	0
3	39689234	.	G	T	3	3	6	0	0	6	0	0
3	39691795	.	C	T	1	4	5	0	0	5	0	0
3	39691978	.	C	G	5	5	10	0	0	10	0	0
3	39692008	.	G	T	5	4	9	0	3	12	0	0
3	39692165	.	A	T	4	3	7	0	0	7	0	0
3	39692196	.	C	T	0	6	6	0	4	10	0	0
3	39692206	.	C	T	1	3	4	0	3	7	0	0
3	39692235	.	C	A	4	5	9	0	1	10	0	0
3	39692265	.	G	A	3	6	9	0	0	9	0	0
3	39692307	.	A	G	2	5	7	0	0	7	0	0
3	39949650	.	G	A	0	1	1	0	0	1	0	0
3	39950276	.	A	C	4	4	8	0	1	9	0	0
3	39950414	.	T	C	3	3	6	0	0	6	0	0
3	39950954	.	T	C	3	2	5	0	0	5	0	0
3	39951124	.	C	T	5	8	13	0	0	13	0	0
3	39951216	.	T	C	2	2	4	0	0	4	0	0
3	39951703	.	A	T	4	3	7	0	0	7	0	0
3	39952025	.	T	C	2	8	10	0	2	12	0	0
3	39952272	.	A	G	4	5	9	0	1	10	0	0
3	39952273	.	A	T	4	6	10	0	0	10	0	0
3	39962981	.	T	C	4	14	18	0	0	18	0	0
3	39963053	.	T	C	5	6	11	0	3	14	0	0
3	39963089	.	A	G	2	3	5	0	3	8	0	0
3	39970555	.	G	A	6	8	14	0	1	15	0	0
3	39970568	.	C	A	9	3	12	0	1	13	0	0
3	39970641	.	T	G	8	6	14	0	0	14	0	0
3	39971335	.	T	A	2	2	4	0	0	4	0	0
3	39971349	.	T	C	1	3	4	0	0	4	0	0
3	39971499	.	T	C	5	2	7	0	0	7	0	0
3	39971894	.	T	C	1	3	4	0	0	4	0	0
3	39971943	.	T	C	2	4	6	0	1	7	0	0
3	40207086	.	T	C	8	11	19	0	1	20	0	0
3	40207232	.	T	C	5	8	13	0	1	14	0	0
3	40278023	.	C	T	0	17	17	0	16	33	0	0
3	40280034	.	T	C	1	1	2	0	0	2	0	0
3	40284447	.	T	A	2	5	7	0	0	7	0	0
3	40284860	.	G	T	7	9	16	0	0	16	0	0
3	40284982	.	T	C	4	4	8	0	1	9	0	0
3	40287185	.	G	C	0	3	3	0	15	18	0	0
3	40287188	.	G	A	13	5	18	0	0	18	0	0
3	40287227	.	C	T	2	2	4	0	1	5	0	0
3	40287538	.	C	T	3	2	5	0	1	6	0	0
3	40287691	.	T	C	2	4	6	0	1	7	0	0
3	40287712	.	T	A	2	6	8	0	1	9	0	0
3	40294179	.	G	A	0	7	7	0	0	7	0	0
3	40294260	.	A	T	4	4	8	0	0	8	0	0
3	40294511	.	G	C	7	10	17	0	2	19	0	0
3	40294953	.	A	G	8	5	13	0	2	15	0	0
3	40297428	.	G	A	21	19	40	0	2	42	0	0
3	40297479	.	C	T	5	3	8	0	3	11	0	0
3	40299995	.	G	A	6	7	13	0	2	15	0	0
3	40301233	.	A	G	0	2	2	0	0	2	0	0
3	40348839	.	T	C	7	10	17	0	1	18	0	0
3	40349310	.	A	G	10	11	21	0	2	23	0	0
3	40349354	.	T	G	11	6	17	0	0	17	0	0
3	40404508	.	T	A	3	3	6	0	0	6	0	0
3	40449696	.	C	T	1	5	6	0	0	6	0	0
3	40481346	.	G	A	0	0	0	0	1	1	0	0
3	40481459	.	C	T	3	2	5	0	0	5	0	0
3	40481930	.	T	A	1	1	2	0	1	3	0	0
3	40482289	.	C	A	1	2	3	0	0	3	0	0
3	40484376	.	A	T	2	0	2	0	0	2	0	0
3	40485360	.	C	A	2	2	4	0	0	4	0	0
3	40485378	.	T	G	1	3	4	0	1	5	0	0
3	40485422	.	G	T	1	4	5	0	5	10	0	0
3	40485499	.	G	A	5	2	7	0	0	7	0	0
3	40487095	.	G	T	5	8	13	0	1	14	0	0
3	40487162	.	A	C	6	4	10	0	0	10	0	0
3	40487385	.	T	A	11	6	17	0	1	18	0	0
3	40487704	.	T	C	20	8	28	0	2	30	0	0
3	40487820	.	A	G	19	21	40	0	1	41	0	0
3	40487821	.	G	C	19	21	40	0	1	41	0	0
3	40488212	.	C	T	18	17	35	0	2	37	0	0
3	40488264	.	C	T	5	26	31	0	14	45	0	0
3	40488630	.	T	C	1	6	7	0	0	7	0	0
3	40488640	.	T	C	1	7	8	0	0	8	0	0
3	40527028	.	G	A	18	18	36	0	4	40	0	0
3	40527512	.	G	A	30	32	62	0	3	65	0	0
3	40527575	.	G	A	11	3	14	0	3	17	0	0
3	40527665	.	A	G	10	6	16	0	2	18	0	0
3	40527727	.	G	A	5	11	16	0	3	19	0	0
3	40528241	.	A	T	16	18	34	0	0	34	0	0
3	40577032	.	C	T	3	5	8	0	0	8	0	0
3	40583989	.	C	G	0	6	6	0	1	7	0	0
3	40584318	.	T	A	4	4	8	0	0	8	0	0
3	40587967	.	C	T	17	23	40	0	1	41	0	0
3	40588109	.	A	T	19	24	43	0	0	43	0	0
3	40588195	.	T	C	13	26	39	0	2	41	0	0
3	40588363	.	C	T	22	15	37	0	0	37	0	0
3	40588410	.	C	A	22	19	41	0	3	44	0	0
3	40588467	.	T	C	15	11	26	1	2	29	0	0
3	40588595	.	A	C	16	23	39	0	1	40	0	0
3	40588746	.	C	G	18	19	37	0	2	39	0	0
3	40588845	.	A	G	19	17	36	0	1	37	0	0
3	40589147	.	T	C	25	30	55	0	0	55	0	0
3	40589179	.	C	A	22	31	53	0	5	58	0	0
3	40589191	.	T	G	23	29	52	0	5	58	1	0
3	40589214	.	C	A	25	28	53	0	3	56	0	0
3	40589232	.	A	G	26	32	58	0	1	59	0	0
3	40589266	.	C	T	18	28	46	0	6	52	0	0
3	40589348	.	A	G	26	22	48	0	0	48	0	0
3	40589356	.	A	G	26	23	49	0	1	50	0	0
3	40690901	.	G	A	1	1	2	0	2	4	0	0
3	40690937	.	T	A	3	4	7	0	0	7	0	0
3	40691448	.	A	G	2	5	7	0	0	7	0	0
3	40691473	.	A	T	4	3	7	0	1	8	0	0
3	40691969	.	C	T	3	5	8	0	0	8	0	0
3	40692064	.	A	T	4	2	6	0	0	6	0	0
3	40698481	.	A	G	2	2	4	0	0	4	0	0
3	40804286	.	T	G	29	5	34	0	6	40	0	0
3	40821871	.	A	T	8	8	16	0	0	16	0	0
3	40821953	.	C	A	0	11	11	0	7	18	0	0
3	40876757	.	G	A	3	4	7	0	0	7	0	0
3	40902163	.	C	T	0	3	3	0	6	9	0	0
3	40969547	.	C	T	0	1	1	0	1	2	0	0
3	40979791	.	G	C	4	4	8	0	1	9	0	0
3	41705949	.	G	A	2	1	3	0	1	4	0	0
3	41721916	.	G	A	2	0	2	0	1	3	0	0
3	41723437	.	G	A	3	9	12	0	0	12	0	0
3	41724806	.	G	A	20	13	33	0	2	35	0	0
3	41925154	.	C	T	1	2	3	0	0	3	0	0
3	41925663	.	C	T	2	2	4	0	0	4	0	0
3	41925694	.	A	C	2	3	5	0	1	6	0	0
3	41925823	.	C	T	1	2	3	0	0	3	0	0
3	41926557	.	G	A	4	1	5	0	1	6	0	0
3	41926695	.	T	C	2	3	5	0	0	5	0	0
3	41955449	.	A	G	1	2	3	0	0	3	0	0
3	41955526	.	C	T	2	4	6	0	0	6	0	0
3	41955613	.	G	T	24	19	43	0	2	45	0	0
3	41955911	.	C	G	11	15	26	0	1	27	0	0
3	41956040	.	G	T	11	17	28	0	1	29	0	0
3	41956299	.	T	C	6	7	13	0	0	13	0	0
3	41956792	.	A	T	2	2	4	0	2	6	0	0
3	41956818	.	T	C	2	3	5	0	0	5	0	0
3	41956837	.	T	G	2	2	4	0	0	4	0	0
3	41956978	.	G	A	4	3	7	0	0	7	0	0
3	41957580	.	G	T	3	2	5	0	0	5	0	0
3	41961651	.	G	A	1	2	3	0	0	3	0	0
3	42918924	.	C	A	7	4	11	0	1	12	0	0
3	42919474	.	C	T	10	3	13	0	1	14	0	0
3	42919510	.	C	T	6	4	10	0	1	11	0	0
3	42919664	.	C	T	1	1	2	0	0	2	0	0
3	42919846	.	T	G	8	6	14	0	0	14	0	0
3	42919849	.	C	T	8	7	15	0	0	15	0	0
3	42919881	.	C	T	7	5	12	0	0	12	0	0
3	42919895	.	A	G	5	5	10	0	1	11	0	0
3	42919943	.	G	C	4	2	6	0	0	6	0	0
3	42919959	.	A	T	4	2	6	0	0	6	0	0
3	43052230	.	T	C	1	2	3	0	0	3	0	0
3	43059153	.	A	G	1	4	5	0	0	5	0	0
3	43060866	.	T	C	5	7	12	0	1	13	0	0
3	43373954	.	T	A	1	1	2	0	2	4	0	0
3	43373955	.	T	C	1	2	3	0	1	4	0	0
3	43380283	.	C	T	2	4	6	0	0	6	0	0
3	43392755	.	T	A	4	7	11	0	0	11	0	0
3	43392795	.	C	A	6	12	18	0	0	18	0	0
3	43475325	.	A	G	1	2	3	0	0	3	0	0
3	43476411	.	A	T	1	2	3	0	0	3	0	0
3	43476435	.	G	T	1	3	4	0	0	4	0	0
3	43476514	.	A	C	0	2	2	0	1	3	0	0
3	43476698	.	A	G	0	1	1	0	0	1	0	0
3	43476880	.	C	T	3	4	7	0	0	7	0	0
3	43476887	.	T	G	3	4	7	0	0	7	0	0
3	43477255	.	T	A	2	3	5	0	0	5	0	0
3	43477287	.	A	T	1	2	3	0	0	3	0	0
3	43477705	.	T	A	1	2	3	0	0	3	0	0
3	43477749	.	G	C	3	0	3	0	0	3	0	0
3	43477975	.	T	G	0	2	2	0	0	2	0	0
3	43478137	.	T	C	6	8	14	0	0	14	0	0
3	43478238	.	C	T	8	3	11	0	0	11	0	0
3	43478310	.	T	G	7	6	13	0	1	14	0	0
3	43478321	.	A	G	8	0	8	0	6	14	0	0
3	43478433	.	A	T	16	5	21	0	0	21	0	0
3	43478586	.	C	T	6	3	9	0	1	10	0	0
3	43579820	.	C	T	0	15	15	0	19	34	0	0
3	43580055	.	A	G	12	12	24	0	0	24	0	0
3	43580195	.	A	T	11	7	18	0	0	18	0	0
3	43580583	.	T	C	7	6	13	0	1	14	0	0
3	43581272	.	A	C	4	3	7	0	1	8	0	0
3	43584453	.	T	C	2	4	6	0	0	6	0	0
3	43594256	.	A	G	0	1	1	0	0	1	0	0
3	43594358	.	C	T	4	5	9	0	0	9	0	0
3	43594376	.	C	T	0	4	4	0	4	8	0	0
3	43594577	.	G	A	3	2	5	0	0	5	0	0
3	43594655	.	C	T	0	2	2	0	5	7	0	0
3	43594658	.	G	A	3	3	6	0	1	7	0	0
3	43791284	.	T	C	1	3	4	0	0	4	0	0
3	43791317	.	G	A	2	3	5	0	0	5	0	0
3	43801338	.	C	T	1	1	2	0	1	3	0	0
3	43807512	.	T	C	5	6	11	0	0	11	0	0
3	43807921	.	C	A	10	17	27	0	1	28	0	0
3	43807945	.	T	A	9	9	18	0	1	22	3	0
3	43828870	.	T	C	2	3	5	0	0	5	0	0
3	43829154	.	G	C	2	3	5	0	0	5	0	0
3	43829179	.	G	C	2	3	5	0	0	5	0	0
3	43829370	.	A	C	1	4	5	0	0	5	0	0
3	43944611	.	A	G	0	1	1	0	0	1	0	0
3	43985859	.	T	A	0	2	2	0	0	2	0	0
3	43986937	.	G	A	0	2	2	0	3	5	0	0
3	44077508	.	C	T	3	4	7	0	1	8	0	0
3	44077543	.	G	T	3	2	5	0	0	5	0	0
3	44082200	.	A	G	0	1	1	0	0	1	0	0
3	44082239	.	T	G	0	1	1	0	0	1	0	0
3	44082427	.	A	G	2	1	3	0	0	3	0	0
3	44082439	.	A	G	2	1	3	0	0	3	0	0
3	44089225	.	T	G	0	1	1	0	0	1	0	0
3	45717180	.	C	T	8	4	12	0	3	15	0	0
3	45776520	.	T	C	20	0	20	0	21	41	0	0
3	45776721	.	T	C	10	9	19	0	0	19	0	0
3	45815997	.	G	A	0	3	3	0	1	4	0	0
3	45816004	.	C	T	1	3	4	0	0	4	0	0
3	45816549	.	A	G	7	6	13	0	0	13	0	0
3	45816618	.	T	C	2	2	4	0	0	4	0	0
3	45845905	.	T	C	1	0	1	0	0	1	0	0
3	46114398	.	A	G	1	3	4	0	1	5	0	0
3	46114491	.	C	A	1	3	4	0	0	4	0	0
3	46377497	.	A	T	5	7	12	0	0	12	0	0
3	46377528	.	C	A	5	5	10	0	1	11	0	0
3	46379820	.	A	G	1	1	2	0	1	3	0	0
3	46380144	.	A	C	1	1	2	0	1	3	0	0
3	46380189	.	A	G	2	4	6	0	0	6	0	0
3	46380194	.	T	A	2	3	5	0	1	6	0	0
3	46389009	.	C	T	1	3	4	0	0	4	0	0
3	46463113	.	T	C	1	2	3	0	1	4	0	0
3	46463156	.	C	T	1	5	6	0	0	6	0	0
3	46463213	.	A	C	1	5	6	0	0	6	0	0
3	46463240	.	C	T	0	2	2	0	0	2	0	0
3	46473292	.	G	A	7	8	15	0	2	17	0	0
3	46552993	.	A	G	3	3	6	0	0	6	0	0
3	46553206	.	T	G	1	2	3	0	0	3	0	0
3	46553534	.	C	T	3	4	7	0	0	7	0	0
3	46553540	.	C	A	3	4	7	0	0	7	0	0
3	46553711	.	A	C	1	2	3	0	0	3	0	0
3	46553720	.	C	A	1	2	3	0	0	3	0	0
3	46553986	.	A	T	4	3	7	0	0	7	0	0
3	46554085	.	G	T	2	2	4	0	2	6	0	0
3	46554177	.	C	A	4	0	4	0	0	4	0	0
3	46554181	.	C	A	0	4	4	0	0	4	0	0
3	46554307	.	T	A	1	2	3	0	0	3	0	0
3	46554458	.	G	T	3	4	7	0	2	9	0	0
3	46554564	.	A	G	7	6	13	0	1	14	0	0
3	46554648	.	T	A	11	3	14	0	1	15	0	0
3	46554711	.	G	A	13	5	18	0	3	21	0	0
3	46586327	.	C	A	1	2	3	0	0	3	0	0
3	46586834	.	A	G	1	2	3	0	0	3	0	0
3	46586852	.	A	G	1	2	3	0	0	3	0	0
3	46752643	.	A	T	1	2	3	0	0	3	0	0
3	46753613	.	T	C	4	2	6	0	0	6	0	0
3	46753619	.	G	A	4	2	6	0	0	6	0	0
3	46754078	.	T	A	26	20	46	0	2	48	0	0
3	46754296	.	A	T	4	5	9	0	1	10	0	0
3	46767646	.	T	C	1	1	2	0	0	2	0	0
3	46778789	.	G	T	1	4	5	0	3	8	0	0
3	46795113	.	G	T	2	3	5	0	0	5	0	0
3	46800490	.	A	T	26	31	57	0	1	58	0	0
3	46800692	.	G	A	20	20	40	0	5	45	0	0
3	46800940	.	C	T	15	23	38	0	5	43	0	0
3	46800946	.	T	G	16	25	41	0	0	41	0	0
3	47114558	.	G	A	2	2	4	0	0	4	0	0
3	47114573	.	A	G	2	2	4	0	0	4	0	0
3	47114734	.	A	G	0	2	2	0	0	2	0	0
3	47114746	.	G	A	1	2	3	0	0	3	0	0
3	47119964	.	C	T	0	1	1	0	3	4	0	0
3	47166295	.	C	T	1	2	3	0	0	3	0	0
3	47205507	.	G	A	3	9	12	0	0	12	0	0
3	47205534	.	A	G	1	0	1	0	10	11	0	0
3	47205585	.	A	T	2	3	5	0	1	6	0	0
3	47205597	.	C	T	2	1	3	0	0	3	0	0
3	47209370	.	T	C	2	4	6	0	1	7	0	0
3	47209433	.	T	C	3	2	5	0	0	5	0	0
3	47209445	.	A	T	2	2	4	0	0	4	0	0
3	47213067	.	C	G	4	2	6	0	0	6	0	0
3	48305837	.	C	G	2	0	2	0	0	2	0	0
3	48305841	.	G	A	0	2	2	0	0	2	0	0
3	48305898	.	C	G	0	2	2	0	0	2	0	0
3	48327002	.	G	A	1	1	2	0	0	2	0	0
3	48480333	.	T	C	1	0	1	0	0	1	0	0
3	48488909	.	G	T	4	3	7	0	2	9	0	0
3	48488993	.	T	C	2	2	4	0	1	5	0	0
3	48489154	.	A	G	2	0	2	0	7	9	0	0
3	48550676	.	G	A	26	23	49	0	3	52	0	0
3	48557707	.	T	C	1	0	1	0	2	3	0	0
3	48584800	.	A	T	10	12	22	0	0	22	0	0
3	48585222	.	C	T	0	14	14	0	15	29	0	0
3	48585236	.	C	A	12	14	26	0	1	27	0	0
3	48585271	.	A	C	11	11	22	0	2	24	0	0
3	48585331	.	A	G	15	7	22	1	1	24	0	0
3	48585377	.	G	T	15	13	28	0	2	30	0	0
3	48585411	.	G	T	13	12	25	0	1	26	0	0
3	48586985	.	A	G	4	5	9	0	1	10	0	0
3	48587176	.	C	A	6	1	7	0	2	9	0	0
3	48587191	.	C	T	4	3	7	0	0	7	0	0
3	48588830	.	A	G	2	2	4	0	1	5	0	0
3	48588884	.	A	G	1	4	5	0	0	5	0	0
3	48591825	.	G	T	1	0	1	0	0	1	0	0
3	48594098	.	T	C	1	0	1	0	6	7	0	0
3	48612038	.	A	G	1	0	1	0	0	1	0	0
3	49151187	.	G	A	3	3	6	0	0	6	0	0
3	49425931	.	A	G	2	4	6	0	0	6	0	0
3	49426063	.	G	A	12	11	23	0	0	23	0	0
3	49426184	.	G	A	7	8	15	0	2	17	0	0
3	49440129	.	G	T	1	1	2	0	0	2	0	0
3	49460230	.	C	T	1	5	6	0	0	6	0	0
3	49559444	.	C	T	32	32	64	0	6	70	0	0
3	49559523	.	C	T	39	21	60	0	7	67	0	0
3	49559527	.	G	T	37	18	55	0	9	64	0	0
3	49559637	.	G	T	28	33	61	0	6	67	0	0
3	49559703	.	G	A	36	26	62	0	5	67	0	0
3	49559904	.	G	A	30	20	50	0	5	55	0	0
3	49559979	.	A	G	20	30	50	0	3	53	0	0
3	49559988	.	T	A	18	29	47	0	4	51	0	0
3	49560084	.	A	G	15	29	44	0	0	44	0	0
3	49560204	.	G	C	12	17	29	0	4	33	0	0
3	49560276	.	T	G	16	18	34	0	2	36	0	0
3	49560420	.	C	T	11	18	29	0	1	31	1	0
3	49560507	.	G	A	9	11	20	0	0	20	0	0
3	50054578	.	C	G	9	6	15	0	2	17	0	0
3	50054619	.	A	T	12	4	16	0	0	16	0	0
3	50059143	.	A	T	7	6	13	0	2	15	0	0
3	50063458	.	C	T	6	3	9	0	0	9	0	0
3	50063491	.	C	T	0	4	4	0	4	8	0	0
3	50066373	.	A	G	5	6	11	0	0	11	0	0
3	50066402	.	G	A	5	5	10	0	3	13	0	0
3	50077150	.	A	T	1	8	9	0	0	9	0	0
3	50077311	.	A	G	3	6	9	0	1	10	0	0
3	50077364	.	T	A	6	2	8	0	0	8	0	0
3	50077371	.	G	A	1	6	7	0	1	8	0	0
3	50081696	.	G	A	2	0	2	0	0	2	0	0
3	50083980	.	C	A	1	0	1	0	0	1	0	0
3	50084011	.	A	G	3	2	5	0	0	5	0	0
3	50087361	.	C	A	0	3	3	0	1	4	0	0
3	50087370	.	G	A	1	3	4	0	1	5	0	0
3	50089113	.	G	A	1	1	2	0	0	2	0	0
3	50089470	.	T	C	1	1	2	0	0	2	0	0
3	50123650	.	C	A	0	11	11	0	20	31	0	0
3	50123709	.	A	G	15	12	27	0	2	29	0	0
3	50123758	.	A	G	12	23	35	0	3	38	0	0
3	50123760	.	C	A	20	13	33	0	5	38	0	0
3	50123936	.	G	A	5	11	16	0	0	16	0	0
3	50124107	.	A	G	1	2	3	0	1	4	0	0
3	50124108	.	C	G	1	2	3	0	1	4	0	0
3	50124401	.	A	G	3	3	6	0	0	6	0	0
3	50124425	.	G	A	1	2	3	0	0	3	0	0
3	50124472	.	G	A	2	2	4	0	0	4	0	0
3	50159659	.	C	G	5	3	8	0	0	8	0	0
3	50166550	.	T	C	1	1	2	0	0	2	0	0
3	50170236	.	A	G	0	0	0	0	7	7	0	0
3	50170338	.	T	A	3	3	6	0	1	7	0	0
3	50170354	.	C	T	1	0	1	0	0	1	0	0
3	50172725	.	G	C	3	6	9	0	1	10	0	0
3	50172735	.	T	A	7	6	13	0	0	13	0	0
3	50172788	.	C	T	4	1	5	0	1	6	0	0
3	50175940	.	G	T	5	4	9	0	1	10	0	0
3	50176620	.	G	T	6	5	11	0	0	11	0	0
3	50256938	.	A	C	2	0	2	0	0	2	0	0
3	50265903	.	A	C	1	2	3	0	0	3	0	0
3	50265906	.	T	C	1	2	3	0	0	3	0	0
3	50266384	.	A	G	1	2	3	0	0	3	0	0
3	50266394	.	T	A	1	2	3	0	0	3	0	0
3	50267256	.	T	A	1	4	5	0	0	5	0	0
3	50267460	.	G	A	2	3	5	0	0	5	0	0
3	50267686	.	T	C	1	3	4	0	0	4	0	0
3	50267860	.	A	T	1	9	10	0	0	10	0	0
3	50267981	.	G	C	5	4	9	0	0	9	0	0
3	50267992	.	T	A	5	4	9	0	0	9	0	0
3	50268016	.	T	C	2	5	7	0	0	7	0	0
3	50268052	.	A	T	4	1	5	0	1	6	0	0
3	50268073	.	A	G	6	2	8	0	1	9	0	0
3	50268106	.	G	T	4	4	8	0	0	8	0	0
3	50268146	.	T	A	4	7	11	0	1	12	0	0
3	50268220	.	C	T	6	5	11	0	0	11	0	0
3	50268422	.	G	A	3	5	8	0	0	8	0	0
3	50268535	.	A	C	9	6	15	0	3	18	0	0
3	50268715	.	C	T	9	8	17	0	0	17	0	0
3	50268744	.	G	A	10	6	16	0	1	17	0	0
3	50272273	.	G	A	8	3	11	0	2	13	0	0
3	50272435	.	T	G	7	3	10	0	1	11	0	0
3	50272438	.	T	G	8	3	11	0	0	11	0	0
3	50273026	.	G	A	3	10	13	0	2	15	0	0
3	50273031	.	C	T	4	10	14	0	1	15	0	0
3	50273469	.	C	T	0	1	1	0	2	3	0	0
3	50418826	.	G	C	5	5	10	0	1	11	0	0
3	50419155	.	C	T	9	3	12	0	1	13	0	0
3	50419759	.	C	T	3	4	7	0	0	7	0	0
3	50419791	.	T	C	2	5	7	0	1	8	0	0
3	50419803	.	C	A	7	3	10	0	0	10	0	0
3	50419866	.	T	C	2	1	3	0	0	4	1	0
3	50420087	.	A	G	1	3	4	0	0	4	0	0
3	50420152	.	G	T	1	2	3	0	0	3	0	0
3	50420191	.	A	T	2	3	5	0	3	8	0	0
3	50420194	.	T	A	3	3	6	0	2	8	0	0
3	50951299	.	C	A	2	7	9	0	0	9	0	0
3	50951644	.	C	G	4	1	5	0	1	6	0	0
3	51653411	.	G	A	1	2	3	0	0	3	0	0
3	51656720	.	G	A	1	3	4	0	0	4	0	0
3	51656726	.	C	A	1	4	5	0	0	5	0	0
3	51656762	.	G	A	3	5	8	0	0	8	0	0
3	51656921	.	T	C	3	2	5	0	0	5	0	0
3	51656931	.	G	A	4	2	6	0	1	7	0	0
3	51657082	.	C	T	5	4	9	0	0	9	0	0
3	51657291	.	G	A	6	13	19	0	2	21	0	0
3	51657314	.	G	A	5	10	15	0	1	16	0	0
3	51657339	.	C	T	4	9	13	0	1	14	0	0
3	51657382	.	G	C	7	5	12	0	0	12	0	0
3	51657439	.	A	G	9	6	15	0	1	16	0	0
3	51657456	.	C	T	9	7	16	0	2	18	0	0
3	51891785	.	A	G	3	0	3	0	3	6	0	0
3	51891787	.	C	T	2	2	4	0	2	6	0	0
3	51892136	.	A	T	4	4	8	0	0	8	0	0
3	51892162	.	A	G	5	5	10	0	0	10	0	0
3	51892176	.	T	A	5	9	14	0	0	14	0	0
3	51892212	.	A	G	5	6	11	0	1	12	0	0
3	51892225	.	T	A	5	7	12	0	0	12	0	0
3	51892573	.	T	C	5	2	7	0	1	8	0	0
3	51899872	.	C	T	0	3	3	0	3	6	0	0
3	51900357	.	C	A	4	5	9	0	0	9	0	0
3	51900400	.	A	G	6	1	7	0	0	7	0	0
3	51900415	.	T	C	3	2	5	0	0	5	0	0
3	51900487	.	A	C	6	4	10	0	2	12	0	0
3	51900552	.	A	G	1	2	3	0	1	4	0	0
3	51900587	.	C	T	2	2	4	0	0	4	0	0
3	51900589	.	A	C	2	2	4	0	0	4	0	0
3	51900693	.	C	G	2	5	7	0	1	8	0	0
3	51900702	.	C	A	0	6	6	0	1	7	0	0
3	51900768	.	T	A	2	6	8	0	0	8	0	0
3	51900784	.	T	C	2	0	2	0	4	6	0	0
3	51901092	.	A	T	3	4	7	0	0	7	0	0
3	51901127	.	A	G	7	4	11	0	0	11	0	0
3	51901178	.	T	A	3	2	5	0	0	5	0	0
3	51901309	.	G	A	2	1	3	0	0	3	0	0
3	51901344	.	T	C	3	3	6	0	0	6	0	0
3	51901670	.	C	T	2	4	6	0	1	7	0	0
3	51901799	.	T	C	2	8	10	0	0	10	0	0
3	51901835	.	G	A	2	8	10	0	0	10	0	0
3	51901873	.	A	G	1	4	5	0	0	5	0	0
3	51901885	.	T	C	2	4	6	0	0	6	0	0
3	51902454	.	T	A	4	3	7	0	0	7	0	0
3	51902471	.	C	T	3	2	5	0	0	5	0	0
3	51902987	.	A	G	0	2	2	0	1	3	0	0
3	52584332	.	C	T	2	2	4	0	0	4	0	0
3	52584428	.	C	T	6	2	8	0	0	8	0	0
3	52588941	.	C	T	1	2	3	0	1	4	0	0
3	52594760	.	G	A	8	3	11	0	0	11	0	0
3	52594966	.	T	C	4	5	9	0	0	9	0	0
3	52603216	.	A	C	12	10	22	0	2	24	0	0
3	52647283	.	A	G	4	2	6	0	4	10	0	0
3	52647284	.	A	T	3	6	9	0	1	10	0	0
3	52668542	.	G	A	5	2	7	0	1	8	0	0
3	52668679	.	C	T	0	1	1	0	4	5	0	0
3	52669995	.	G	A	2	0	2	0	0	2	0	0
3	52673834	.	T	A	2	4	6	0	1	7	0	0
3	52673854	.	A	T	3	2	5	0	2	7	0	0
3	52674017	.	T	A	1	3	4	0	1	5	0	0
3	52677087	.	C	T	1	4	5	0	6	11	0	0
3	52677279	.	G	A	2	4	6	0	0	6	0	0
3	52677281	.	C	T	2	4	6	0	0	6	0	0
3	52677492	.	C	G	3	1	4	0	0	4	0	0
3	52677501	.	T	C	2	1	3	0	1	4	0	0
3	52699441	.	G	A	2	1	3	0	0	3	0	0
3	52699449	.	G	T	0	1	1	0	2	3	0	0
3	52699775	.	C	T	2	1	3	0	0	3	0	0
3	52699995	.	T	C	4	8	12	0	1	13	0	0
3	52895631	.	G	A	0	5	5	0	0	5	0	0
3	52895667	.	G	A	1	5	6	0	0	6	0	0
3	52895688	.	C	T	0	4	4	0	1	5	0	0
3	52895725	.	C	G	1	1	2	0	0	2	0	0
3	52898922	.	G	A	2	1	3	0	0	3	0	0
3	52898927	.	T	A	2	1	3	0	0	3	0	0
3	52937419	.	T	C	1	1	2	0	0	2	0	0
3	52937723	.	G	T	2	1	3	0	0	3	0	0
3	52937747	.	G	A	0	1	1	0	1	2	0	0
3	53074317	.	C	T	8	7	15	0	0	15	0	0
3	53074581	.	C	T	6	7	13	0	0	13	0	0
3	53075050	.	C	A	5	3	8	0	1	9	0	0
3	53075475	.	T	G	7	5	12	0	0	12	0	0
3	53076037	.	A	T	18	11	29	0	0	29	0	0
3	53076160	.	G	T	0	24	24	1	24	49	0	0
3	53203782	.	A	G	0	1	1	0	0	1	0	0
3	53206260	.	A	G	1	2	3	0	0	3	0	0
3	53211032	.	A	G	1	2	3	0	0	3	0	0
3	53211168	.	G	C	1	1	2	0	2	4	0	0
3	53211170	.	T	C	2	2	4	0	0	4	0	0
3	53214615	.	T	C	1	1	2	0	0	2	0	0
3	53218471	.	C	T	3	4	7	0	0	7	0	0
3	53223110	.	T	C	5	3	8	0	0	8	0	0
3	53223290	.	G	A	3	3	6	0	1	7	0	0
3	53223415	.	C	T	6	5	11	0	0	11	0	0
3	53223686	.	G	T	8	4	12	0	1	13	0	0
3	53223691	.	G	T	8	4	12	0	2	14	0	0
3	53223783	.	C	T	6	3	9	0	1	10	0	0
3	53223973	.	A	C	9	6	15	0	0	15	0	0
3	53224029	.	G	A	11	5	16	0	1	17	0	0
3	53224181	.	A	G	14	11	25	0	1	26	0	0
3	53224231	.	C	G	8	6	14	0	0	14	0	0
3	53228771	.	T	A	0	1	1	0	1	2	0	0
3	53229021	.	G	A	2	4	6	0	0	6	0	0
3	53229036	.	T	A	1	4	5	0	0	6	1	0
3	53230980	.	T	C	2	7	9	0	0	9	0	0
3	53342706	.	C	A	1	1	2	0	0	2	0	0
3	53344694	.	T	C	1	1	2	0	0	2	0	0
3	53344968	.	C	T	1	3	4	0	0	4	0	0
3	53447960	.	C	T	1	0	1	0	1	2	0	0
3	53449227	.	C	A	5	2	7	0	1	8	0	0
3	53476654	.	T	C	3	1	4	0	0	4	0	0
3	53527681	.	T	C	4	3	7	0	0	7	0	0
3	53528017	.	T	C	5	3	8	0	1	9	0	0
3	53528039	.	G	A	4	3	7	0	2	9	0	0
3	53528190	.	T	C	2	2	4	0	0	4	0	0
3	53687679	.	C	T	1	2	3	0	0	3	0	0
3	53687983	.	C	T	2	3	5	0	0	5	0	0
3	53688047	.	A	T	5	4	9	0	0	9	0	0
3	53688077	.	C	G	0	2	2	0	4	6	0	0
3	53688309	.	T	G	2	3	5	0	0	5	0	0
3	53688315	.	T	C	2	0	2	0	3	5	0	0
3	54168318	.	T	C	1	1	2	0	0	2	0	0
3	54207610	.	C	T	6	5	11	0	2	13	0	0
3	54223504	.	G	A	2	2	4	0	0	4	0	0
3	54236621	.	T	G	3	3	6	0	0	6	0	0
3	54236657	.	C	A	6	6	12	0	0	12	0	0
3	54236750	.	A	G	11	12	23	0	3	26	0	0
3	54236996	.	G	A	0	16	16	0	32	48	0	0
3	54237347	.	C	T	25	23	48	0	0	48	0	0
3	54237443	.	G	C	13	19	32	0	1	33	0	0
3	54237472	.	T	C	13	17	30	0	4	34	0	0
3	54434322	.	A	G	1	2	3	0	1	4	0	0
3	54434344	.	A	T	3	1	4	0	1	5	0	0
3	54434378	.	A	T	2	4	6	0	0	6	0	0
3	54434398	.	C	T	0	3	3	0	2	5	0	0
3	54435336	.	C	G	0	3	3	0	3	6	0	0
3	54435453	.	G	A	1	0	1	0	0	1	0	0
3	54561375	.	A	G	3	2	5	0	1	6	0	0
3	54567186	.	G	A	2	1	3	0	0	3	0	0
3	54567303	.	T	A	2	5	7	0	0	7	0	0
3	54567463	.	T	A	2	6	8	0	0	8	0	0
3	54567502	.	G	A	9	6	15	0	0	15	0	0
3	54567715	.	A	C	8	3	11	0	1	12	0	0
3	54567856	.	A	C	1	4	5	0	0	5	0	0
3	54567857	.	C	T	1	3	4	0	1	5	0	0
3	54583742	.	C	T	0	3	3	0	1	4	0	0
3	54585281	.	A	G	3	1	4	0	0	4	0	0
3	54585359	.	C	T	2	7	9	0	1	10	0	0
3	54585637	.	T	C	22	15	37	0	1	38	0	0
3	54585685	.	C	T	3	6	9	0	2	11	0	0
3	54586125	.	T	C	2	1	3	0	0	3	0	0
3	54589582	.	T	C	14	9	23	0	2	25	0	0
3	54591385	.	G	A	8	4	12	0	1	13	0	0
3	54591432	.	A	C	6	8	14	0	2	16	0	0
3	54591677	.	G	A	7	8	15	0	0	15	0	0
3	54591701	.	A	G	5	2	7	0	0	7	0	0
3	54591849	.	G	A	5	8	13	0	0	13	0	0
3	54592322	.	G	A	7	4	11	0	1	12	0	0
3	54592376	.	A	T	7	4	11	0	0	11	0	0
3	54592986	.	T	C	4	0	4	0	5	9	0	0
3	54593034	.	A	T	5	6	11	0	0	11	0	0
3	54593046	.	C	T	4	4	8	0	1	9	0	0
3	54594865	.	T	A	2	3	5	0	0	5	0	0
3	54594880	.	T	C	1	3	4	0	0	4	0	0
3	54595071	.	G	A	2	2	4	0	0	4	0	0
3	54595233	.	C	T	1	3	4	0	0	4	0	0
3	54595257	.	G	A	0	3	3	0	0	3	0	0
3	54596362	.	A	G	2	2	4	0	0	4	0	0
3	54596385	.	C	T	1	1	2	0	0	2	0	0
3	54596634	.	G	A	1	1	2	0	0	2	0	0
3	54596651	.	G	A	1	1	2	0	0	2	0	0
3	54596935	.	A	G	1	2	3	0	0	3	0	0
3	54597183	.	G	A	5	2	7	0	0	7	0	0
3	54834084	.	C	T	1	2	3	0	0	3	0	0
3	54834785	.	A	T	0	3	3	0	0	3	0	0
3	54834801	.	A	C	0	2	2	0	0	2	0	0
3	54871588	.	T	A	1	3	4	0	0	4	0	0
3	54872003	.	C	G	1	3	4	0	0	4	0	0
3	54872172	.	T	A	5	2	7	0	0	7	0	0
3	54872494	.	A	G	1	1	2	0	0	2	0	0
3	54872520	.	C	G	1	2	3	0	0	3	0	0
3	54873055	.	C	A	3	3	6	0	0	6	0	0
3	54873844	.	T	C	10	9	19	0	0	19	0	0
3	54874245	.	C	T	4	8	12	0	1	13	0	0
3	54874371	.	C	T	9	16	25	0	2	27	0	0
3	54874477	.	A	G	16	17	33	0	3	36	0	0
3	54874631	.	G	A	18	19	37	0	0	37	0	0
3	54874660	.	C	T	17	15	32	0	7	39	0	0
3	54874711	.	G	A	4	15	19	0	0	19	0	0
3	54896371	.	A	G	2	2	4	0	0	4	0	0
3	54896372	.	G	T	2	2	4	0	0	4	0	0
3	54896748	.	A	C	4	0	4	0	5	9	0	0
3	54896985	.	A	G	1	6	7	0	1	8	0	0
3	54897039	.	G	A	3	5	8	0	0	8	0	0
3	54897099	.	G	T	5	6	11	0	0	11	0	0
3	55045602	.	T	A	5	2	7	0	0	7	0	0
3	55045709	.	G	T	4	2	6	0	1	7	0	0
3	55045854	.	A	G	6	3	9	0	2	11	0	0
3	55045980	.	A	T	5	2	7	0	1	8	0	0
3	55045993	.	T	C	5	2	7	0	0	7	0	0
3	55046165	.	A	G	2	5	7	0	0	7	0	0
3	55050175	.	A	G	5	2	7	0	0	7	0	0
3	55050191	.	T	A	1	5	6	0	0	6	0	0
3	55093893	.	G	A	1	4	5	0	0	5	0	0
3	55093923	.	T	C	3	2	5	0	0	5	0	0
3	55093980	.	T	C	1	1	2	0	0	2	0	0
3	55100228	.	T	C	9	0	9	0	0	9	0	0
3	55100522	.	A	G	8	8	16	0	2	18	0	0
3	55100590	.	T	G	9	10	19	0	0	19	0	0
3	55100795	.	A	G	22	18	40	0	2	42	0	0
3	55103453	.	A	G	7	3	10	0	2	12	0	0
3	55105254	.	T	C	6	11	17	0	1	18	0	0
3	55105479	.	C	T	4	9	13	0	0	13	0	0
3	55105886	.	A	G	15	11	26	0	3	29	0	0
3	55219205	.	G	A	0	1	1	0	0	1	0	0
3	55422011	.	G	A	2	2	4	0	0	4	0	0
3	55422153	.	T	C	3	8	11	0	0	11	0	0
3	55422831	.	G	A	5	5	10	0	1	11	0	0
3	55422850	.	G	T	5	4	9	0	0	9	0	0
3	55422926	.	C	A	0	5	5	0	3	8	0	0
3	55422980	.	T	C	1	2	3	0	0	3	0	0
3	55423430	.	T	C	7	2	9	0	0	9	0	0
3	55423611	.	G	A	2	6	8	0	2	10	0	0
3	55423663	.	A	G	4	2	6	0	0	6	0	0
3	56408875	.	C	T	7	7	14	0	0	14	0	0
3	57463903	.	G	A	1	3	4	1	0	5	0	0
3	57463932	.	C	T	0	2	2	0	1	3	0	0
3	58197600	.	A	G	0	0	0	3	0	3	0	0
3	58710351	.	T	A	0	4	4	1	0	5	0	0
3	59961399	.	G	A	3	3	6	0	0	6	0	0
3	59986181	.	G	T	3	9	12	0	0	12	0	0
3	59994744	.	G	A	2	7	9	0	3	12	0	0
3	59995019	.	T	G	7	13	20	0	0	20	0	0
3	59995028	.	C	T	4	13	17	0	2	19	0	0
3	60002951	.	T	C	1	2	3	0	0	3	0	0
3	60003007	.	T	A	8	8	16	0	1	17	0	0
3	60074157	.	G	A	0	3	3	0	0	3	0	0
3	60099130	.	G	A	3	2	5	0	0	5	0	0
3	60526316	.	C	T	0	4	4	0	6	10	0	0
3	60526385	.	G	C	3	3	6	0	0	6	0	0
3	60526426	.	A	G	3	2	5	0	0	5	0	0
3	60526504	.	T	A	0	3	3	0	2	5	0	0
3	60575823	.	T	A	3	3	6	0	0	6	0	0
3	60575990	.	T	C	0	2	2	0	0	2	0	0
3	60576048	.	T	C	2	2	4	0	0	4	0	0
3	60576053	.	T	C	2	2	4	0	0	4	0	0
3	60577258	.	A	T	1	2	3	0	1	4	0	0
3	60596647	.	A	G	2	0	2	0	1	3	0	0
3	60596808	.	A	C	2	2	4	0	0	4	0	0
3	60732673	.	A	C	1	4	5	0	0	5	0	0
3	60732761	.	G	T	0	3	3	0	0	3	0	0
3	60732889	.	G	T	2	2	4	0	0	4	0	0
3	60732896	.	A	G	1	2	3	0	1	4	0	0
3	60982492	.	A	C	1	2	3	0	0	3	0	0
3	60985817	.	T	C	1	1	2	0	0	2	0	0
3	60994742	.	G	T	0	1	1	0	1	2	0	0
3	61004295	.	G	A	0	1	1	0	0	1	0	0
3	61004442	.	G	T	1	2	3	0	0	3	0	0
3	61030699	.	G	C	2	11	13	0	3	16	0	0
3	61030800	.	G	A	0	4	4	0	2	6	0	0
3	61033183	.	C	T	10	19	29	0	1	30	0	0
3	61033697	.	T	C	7	22	29	0	2	31	0	0
3	61033979	.	C	A	8	22	30	0	1	31	0	0
3	61034024	.	T	C	14	38	52	0	3	55	0	0
3	61034060	.	T	G	15	0	15	0	41	56	0	0
3	61034096	.	T	C	9	37	46	0	2	48	0	0
3	61034139	.	A	C	13	1	14	0	23	37	0	0
3	61280198	.	G	T	1	3	4	0	0	4	0	0
3	61280326	.	G	T	0	2	2	0	1	3	0	0
3	61285200	.	G	T	8	1	9	0	1	10	0	0
3	61285224	.	T	A	9	3	12	0	0	12	0	0
3	61285260	.	C	T	3	1	4	0	0	4	0	0
3	61285437	.	C	T	1	4	5	0	0	5	0	0
3	61285444	.	A	G	1	4	5	0	0	5	0	0
3	61285663	.	A	G	1	3	4	0	0	4	0	0
3	61286143	.	C	G	1	4	5	0	0	5	0	0
3	61286468	.	C	T	5	5	10	0	1	11	0	0
3	61286639	.	G	T	4	1	5	0	1	6	0	0
3	61286878	.	T	C	6	5	11	0	0	11	0	0
3	61287260	.	G	T	6	4	10	0	1	11	0	0
3	61287343	.	G	T	9	9	18	0	0	18	0	0
3	61287383	.	T	A	14	11	25	0	1	26	0	0
3	61287395	.	G	A	13	8	21	0	1	22	0	0
3	61287491	.	T	A	6	7	13	0	2	16	1	0
3	61287496	.	T	C	7	9	16	0	1	17	0	0
3	61287590	.	G	T	5	11	16	0	0	16	0	0
3	61288097	.	G	T	13	13	26	0	2	28	0	0
3	61317185	.	C	T	1	1	2	0	0	2	0	0
3	61317188	.	C	G	0	1	1	0	1	2	0	0
3	61342032	.	C	T	0	4	4	0	3	7	0	0
3	61342225	.	G	A	4	3	7	0	0	7	0	0
3	61342341	.	G	T	1	3	4	0	0	4	0	0
3	61342368	.	T	C	1	3	4	0	0	4	0	0
3	61342387	.	G	A	0	5	5	0	0	5	0	0
3	61342423	.	G	C	0	9	9	0	1	10	0	0
3	61349734	.	G	A	6	4	10	0	0	10	0	0
3	61349931	.	G	T	2	6	8	0	0	8	0	0
3	61350600	.	T	C	2	2	4	0	0	4	0	0
3	61350648	.	G	A	2	2	4	0	1	5	0	0
3	61350667	.	C	T	1	1	2	0	1	3	0	0
3	61358195	.	T	C	3	3	6	0	0	6	0	0
3	61358196	.	T	C	3	3	6	0	0	6	0	0
3	61358265	.	C	T	3	6	9	0	0	9	0	0
3	61358269	.	G	A	6	3	9	0	0	9	0	0
3	61358739	.	A	C	3	2	5	0	0	5	0	0
3	61365135	.	G	A	0	2	2	0	1	3	0	0
3	61372060	.	T	G	3	2	5	0	1	6	0	0
3	61383835	.	C	T	1	2	3	0	0	3	0	0
3	61383841	.	G	T	1	2	3	0	0	3	0	0
3	61397141	.	G	T	2	4	6	0	1	7	0	0
3	61397294	.	C	T	4	2	6	0	0	6	0	0
3	62328846	.	G	C	0	1	1	0	0	1	0	0
4	316946	.	A	T	10	22	32	0	2	34	0	0
4	317091	.	A	G	10	19	29	0	2	31	0	0
4	317217	.	T	A	13	11	24	0	0	24	0	0
4	317275	.	G	T	5	7	12	0	1	13	0	0
4	317938	.	G	A	1	4	5	0	0	5	0	0
4	325073	.	C	T	4	2	6	0	0	6	0	0
4	325126	.	G	A	7	7	14	0	0	14	0	0
4	325136	.	G	A	8	7	15	0	1	16	0	0
4	325161	.	A	C	10	0	10	0	8	18	0	0
4	352289	.	T	C	3	3	6	0	0	6	0	0
4	353049	.	A	T	1	2	3	0	0	3	0	0
4	353064	.	C	G	1	2	3	0	0	3	0	0
4	385092	.	C	T	9	5	14	0	6	20	0	0
4	385625	.	A	T	1	4	5	0	1	6	0	0
4	385668	.	G	A	6	4	10	0	1	11	0	0
4	385710	.	T	C	9	5	14	0	0	14	0	0
4	386014	.	A	C	26	10	36	0	5	41	0	0
4	386037	.	T	G	26	12	38	0	1	39	0	0
4	386085	.	G	A	15	10	25	0	1	26	0	0
4	386124	.	C	A	3	4	7	0	4	11	0	0
4	386537	.	T	A	14	17	31	0	7	38	0	0
4	386538	.	T	A	20	18	38	0	5	43	0	0
4	386839	.	A	G	26	0	26	0	6	32	0	0
4	386961	.	G	A	16	13	29	0	1	30	0	0
4	386998	.	G	T	4	11	15	0	11	26	0	0
4	394020	.	T	C	16	14	30	0	2	32	0	0
4	397913	.	A	G	12	7	19	0	0	19	0	0
4	660649	.	T	A	2	1	3	0	0	3	0	0
4	660655	.	G	A	0	2	2	0	2	4	0	0
4	660715	.	T	C	3	2	5	0	0	5	0	0
4	674838	.	T	C	4	4	8	0	1	9	0	0
4	675080	.	T	C	1	6	7	0	1	8	0	0
4	676885	.	A	G	9	9	18	0	0	18	0	0
4	676942	.	A	G	2	0	2	0	0	2	0	0
4	678853	.	C	T	3	5	8	0	1	9	0	0
4	680314	.	G	T	7	3	10	0	1	11	0	0
4	680320	.	C	T	8	4	12	0	0	12	0	0
4	680404	.	G	A	1	0	1	0	0	1	0	0
4	681595	.	G	A	2	2	4	0	0	4	0	0
4	694718	.	G	A	2	0	2	0	0	2	0	0
4	694741	.	T	G	2	0	2	0	0	2	0	0
4	694757	.	A	T	1	0	1	0	0	1	0	0
4	700281	.	A	C	7	3	10	0	1	11	0	0
4	700284	.	G	T	0	3	3	0	8	11	0	0
4	700563	.	G	T	6	5	11	0	0	11	0	0
4	700569	.	G	A	0	4	4	0	5	9	0	0
4	700598	.	A	T	1	3	4	0	0	4	0	0
4	700606	.	T	C	0	1	1	0	1	2	0	0
4	700634	.	A	C	1	2	3	0	0	3	0	0
4	700665	.	G	T	1	2	3	0	1	4	0	0
4	702061	.	C	G	3	8	11	0	2	13	0	0
4	702130	.	G	A	0	0	0	0	1	1	0	0
4	736442	.	A	G	4	2	6	0	1	7	0	0
4	737636	.	A	T	7	6	13	0	0	13	0	0
4	740435	.	A	T	0	1	1	0	0	1	0	0
4	740921	.	T	C	3	3	6	0	0	6	0	0
4	740965	.	T	G	2	2	4	0	1	5	0	0
4	749803	.	G	A	3	2	5	0	0	5	0	0
4	750661	.	C	T	0	2	2	0	1	3	0	0
4	751640	.	T	G	1	2	3	0	1	4	0	0
4	765112	.	A	G	3	5	8	0	1	9	0	0
4	766575	.	G	A	4	4	8	0	0	8	0	0
4	766588	.	G	A	4	4	8	0	1	9	0	0
4	766613	.	A	C	3	5	8	0	0	8	0	0
4	769533	.	A	T	1	1	2	0	0	2	0	0
4	772363	.	C	T	1	2	3	0	0	3	0	0
4	783816	.	G	T	14	27	41	0	4	45	0	0
4	783835	.	A	G	16	24	40	0	3	43	0	0
4	784002	.	T	A	30	18	48	0	2	51	1	0
4	784177	.	T	C	26	21	47	0	3	50	0	0
4	784325	.	A	T	12	12	24	0	3	27	0	0
4	784373	.	T	A	3	6	9	0	0	9	0	0
4	784435	.	G	T	3	3	6	0	0	6	0	0
4	784472	.	T	C	5	3	8	0	0	8	0	0
4	784473	.	A	C	5	3	8	0	0	8	0	0
4	784733	.	T	A	4	3	7	0	0	7	0	0
4	784854	.	C	A	3	4	7	0	0	7	0	0
4	784990	.	T	A	7	13	20	0	2	22	0	0
4	785132	.	G	A	18	14	32	0	1	33	0	0
4	789589	.	A	G	1	2	3	0	0	3	0	0
4	798804	.	G	A	14	12	26	0	4	30	0	0
4	798850	.	A	C	17	17	34	0	2	36	0	0
4	798861	.	G	T	17	17	34	0	3	37	0	0
4	799006	.	G	T	20	18	38	0	1	39	0	0
4	799090	.	T	C	20	12	32	0	3	35	0	0
4	799127	.	T	G	15	16	31	0	3	34	0	0
4	799245	.	G	A	9	8	17	0	0	17	0	0
4	799385	.	C	G	2	2	4	0	0	4	0	0
4	799475	.	A	G	7	13	20	0	0	20	0	0
4	799513	.	G	A	10	11	21	0	2	23	0	0
4	799620	.	C	T	15	6	21	0	3	24	0	0
4	799643	.	T	A	18	7	25	0	2	27	0	0
4	799933	.	C	T	17	9	26	0	1	27	0	0
4	800027	.	C	T	9	11	20	0	0	20	0	0
4	800094	.	A	G	7	9	16	0	0	16	0	0
4	800113	.	A	G	5	9	14	0	1	15	0	0
4	800363	.	C	T	0	11	11	0	14	25	0	0
4	800520	.	T	C	5	4	9	0	1	10	0	0
4	802909	.	T	A	10	2	12	0	1	13	0	0
4	806319	.	G	A	2	2	4	0	0	4	0	0
4	806322	.	T	C	2	2	4	0	0	4	0	0
4	807895	.	C	G	0	1	1	0	1	2	0	0
4	807898	.	A	G	0	2	2	0	0	2	0	0
4	809456	.	A	G	3	2	5	0	0	5	0	0
4	813157	.	G	A	2	1	3	0	0	3	0	0
4	844545	.	C	A	3	3	6	0	0	6	0	0
4	844547	.	T	C	2	3	5	0	1	6	0	0
4	844819	.	G	A	2	2	4	0	0	4	0	0
4	861474	.	G	A	1	2	3	0	0	3	0	0
4	861856	.	T	A	2	7	9	0	0	9	0	0
4	862009	.	A	G	7	3	10	0	0	10	0	0
4	864324	.	T	A	3	2	5	0	0	5	0	0
4	864712	.	C	T	3	7	10	0	2	12	0	0
4	864739	.	G	C	3	5	8	0	0	8	0	0
4	867454	.	A	G	2	4	6	0	0	6	0	0
4	867601	.	G	C	2	0	2	0	0	2	0	0
4	873763	.	C	G	5	2	7	0	0	7	0	0
4	874241	.	G	T	1	2	3	0	0	3	0	0
4	874323	.	C	T	1	1	2	0	0	2	0	0
4	875350	.	A	G	1	1	2	0	0	2	0	0
4	958978	.	A	T	4	4	8	0	0	8	0	0
4	959015	.	T	C	1	7	8	0	1	9	0	0
4	961542	.	G	A	1	1	2	0	0	2	0	0
4	968001	.	G	A	0	3	3	0	2	5	0	0
4	975735	.	G	C	0	1	1	0	0	1	0	0
4	975758	.	C	T	4	0	4	0	1	5	0	0
4	975792	.	G	C	0	7	7	0	2	9	0	0
4	975938	.	T	C	1	0	1	0	0	1	0	0
4	982892	.	G	A	2	5	7	0	1	8	0	0
4	982893	.	T	C	5	3	8	0	0	8	0	0
4	982938	.	C	G	4	6	10	0	0	10	0	0
4	986133	.	A	G	3	4	7	0	0	7	0	0
4	986350	.	C	A	0	3	3	0	3	6	0	0
4	1054775	.	G	A	23	11	34	0	1	35	0	0
4	1055081	.	C	T	16	5	21	0	1	22	0	0
4	1055095	.	T	A	14	5	19	0	1	20	0	0
4	1055724	.	C	T	19	15	34	0	1	35	0	0
4	1055770	.	A	G	17	7	24	0	2	26	0	0
4	1389106	.	C	T	7	2	9	0	1	10	0	0
4	1392957	.	G	A	5	5	10	0	0	10	0	0
4	1393032	.	T	A	3	2	5	0	1	6	0	0
4	1469788	.	T	C	4	3	7	0	0	7	0	0
4	1470000	.	C	T	3	3	6	0	0	6	0	0
4	1565461	.	A	C	2	2	4	0	0	4	0	0
4	1565462	.	A	C	2	2	4	0	0	4	0	0
4	1565587	.	G	A	5	4	9	0	0	9	0	0
4	1565673	.	T	C	1	2	3	0	0	3	0	0
4	1565832	.	G	A	1	1	2	0	1	3	0	0
4	1566427	.	C	A	14	7	21	0	0	21	0	0
4	1566501	.	T	C	6	7	13	0	3	16	0	0
4	1566502	.	T	G	6	0	6	0	10	16	0	0
4	1647789	.	G	A	10	3	13	0	2	15	0	0
4	1845002	.	C	T	1	2	3	0	0	3	0	0
4	2044213	.	A	G	18	6	24	0	4	29	1	0
4	2044222	.	T	C	10	0	10	0	21	31	0	0
4	2044359	.	A	C	18	17	35	0	0	35	0	0
4	2044379	.	T	A	21	17	38	0	1	39	0	0
4	2044409	.	A	G	23	22	45	0	0	45	0	0
4	2044517	.	A	G	9	19	28	0	3	31	0	0
4	2044541	.	T	C	9	0	9	0	23	32	0	0
4	2045000	.	T	A	1	2	3	0	0	3	0	0
4	2051929	.	T	G	22	9	31	0	2	33	0	0
4	2055019	.	G	A	11	9	20	0	0	20	0	0
4	2055318	.	G	A	5	1	6	0	0	6	0	0
4	2056607	.	G	A	2	5	7	0	0	7	0	0
4	2060125	.	T	C	1	1	2	0	0	2	0	0
4	2061214	.	G	A	6	2	8	0	0	8	0	0
4	2061217	.	G	A	2	5	7	0	1	8	0	0
4	2062085	.	A	G	7	8	15	0	0	15	0	0
4	2062088	.	G	A	7	7	14	0	0	14	0	0
4	2151664	.	T	A	3	5	8	0	0	8	0	0
4	2151743	.	G	A	1	4	5	0	0	5	0	0
4	2160995	.	G	A	1	3	4	0	0	4	0	0
4	2162639	.	G	A	0	1	1	0	0	1	0	0
4	2162726	.	C	G	0	7	7	0	5	12	0	0
4	2162798	.	G	A	1	3	4	0	1	5	0	0
4	2162804	.	A	G	1	4	5	0	0	5	0	0
4	2210437	.	T	G	2	3	5	0	1	6	0	0
4	2210459	.	C	T	1	4	5	0	1	6	0	0
4	2210553	.	A	G	1	1	2	0	0	2	0	0
4	2210583	.	A	G	0	0	0	0	1	1	0	0
4	2259067	.	G	A	5	2	7	0	0	7	0	0
4	2259071	.	T	C	5	0	5	0	2	7	0	0
4	2260515	.	T	C	1	0	1	0	0	1	0	0
4	2261176	.	A	G	0	1	1	0	0	1	0	0
4	2361733	.	G	A	0	2	2	0	0	2	0	0
4	2362945	.	C	A	0	4	4	0	6	10	0	0
4	2936792	.	T	C	2	1	3	0	1	4	0	0
4	2989464	.	G	A	1	3	4	0	0	4	0	0
4	3338195	.	A	G	2	1	3	0	1	4	0	0
4	3474618	.	A	G	1	2	3	0	1	4	0	0
4	3474738	.	A	G	3	3	6	0	0	6	0	0
4	3474744	.	A	G	2	4	6	0	0	6	0	0
4	4106645	.	G	A	0	5	5	0	6	11	0	0
4	4111070	.	A	G	6	5	11	0	0	11	0	0
4	4111180	.	C	T	5	3	8	0	0	8	0	0
4	4111229	.	A	T	7	8	15	0	2	17	0	0
4	4111396	.	T	C	4	11	15	0	0	15	0	0
4	4117174	.	A	C	2	2	4	0	0	4	0	0
4	4120632	.	C	T	1	3	4	0	0	4	0	0
4	4120825	.	C	T	1	3	4	0	0	4	0	0
4	4120854	.	C	T	1	5	6	0	0	6	0	0
4	4120872	.	A	G	2	8	10	0	0	10	0	0
4	4122652	.	C	T	1	3	4	0	0	4	0	0
4	4126426	.	A	G	0	1	1	0	0	1	0	0
4	4126432	.	C	T	0	1	1	0	0	1	0	0
4	4228518	.	C	A	4	0	4	0	0	4	0	0
4	4232578	.	T	A	1	3	4	0	0	4	0	0
4	4232705	.	A	T	1	2	3	0	0	3	0	0
4	4232994	.	T	C	4	2	6	0	0	6	0	0
4	4233088	.	T	C	2	3	5	0	0	5	0	0
4	4235162	.	A	G	21	13	34	0	9	43	0	0
4	4238175	.	C	T	0	3	3	0	0	3	0	0
4	4240177	.	T	C	0	4	4	0	0	4	0	0
4	4243084	.	G	A	1	4	5	0	0	5	0	0
4	4249690	.	G	A	1	0	1	0	1	2	0	0
4	4258927	.	T	C	0	2	2	0	0	2	0	0
4	4356626	.	G	A	3	2	5	0	0	5	0	0
4	4357073	.	A	G	1	6	7	0	2	9	0	0
4	4357173	.	C	T	2	2	4	0	0	4	0	0
4	4357175	.	G	A	2	2	4	0	0	4	0	0
4	4357757	.	C	T	2	2	4	0	0	4	0	0
4	4358471	.	C	T	9	8	17	0	0	17	0	0
4	4358580	.	A	G	6	8	14	0	0	14	0	0
4	4358610	.	C	A	15	9	24	0	0	24	0	0
4	4484788	.	A	G	6	6	12	0	3	15	0	0
4	4484914	.	T	A	10	8	18	0	1	19	0	0
4	4485186	.	A	T	12	9	21	0	1	22	0	0
4	4485247	.	A	T	10	8	18	0	1	19	0	0
4	4485306	.	T	C	5	7	12	0	0	12	0	0
4	4485650	.	A	T	1	3	4	0	0	4	0	0
4	4488207	.	G	A	0	1	1	0	1	2	0	0
4	4516310	.	G	C	0	5	5	0	3	8	0	0
4	4516313	.	A	G	3	0	3	0	5	8	0	0
4	4516346	.	C	T	4	2	6	0	1	7	0	0
4	4519688	.	G	A	6	2	8	0	1	9	0	0
4	4519697	.	T	C	4	0	4	0	0	4	0	0
4	4523403	.	C	G	10	9	19	0	3	22	0	0
4	4523579	.	T	C	14	25	39	0	3	42	0	0
4	4523885	.	A	C	7	11	18	0	0	18	0	0
4	4524215	.	T	A	5	6	11	0	0	11	0	0
4	4635691	.	C	G	5	10	15	0	0	15	0	0
4	4640605	.	G	A	3	4	7	0	0	7	0	0
4	4640614	.	G	A	3	3	6	0	1	7	0	0
4	4647977	.	A	G	1	2	3	0	0	3	0	0
4	6646023	.	G	T	5	2	7	0	0	7	0	0
4	8027183	.	A	T	0	4	4	0	0	4	0	0
4	8046099	.	C	T	14	5	19	0	3	22	0	0
4	8609608	.	T	A	1	12	13	0	1	14	0	0
4	9334196	.	A	G	1	4	5	0	3	8	0	0
4	9618867	.	A	C	4	0	4	0	0	4	0	0
4	9817327	.	C	T	0	6	6	0	1	7	0	0
4	9999865	.	T	G	3	3	6	0	0	6	0	0
4	10044777	.	A	G	1	1	2	0	1	3	0	0
4	10045599	.	C	T	1	0	1	0	0	1	0	0
4	10045605	.	A	G	1	0	1	0	0	1	0	0
4	10558510	.	T	C	1	3	4	0	0	4	0	0
4	10560246	.	G	A	6	3	9	0	0	9	0	0
4	10560253	.	A	T	8	4	12	0	0	12	0	0
4	10560284	.	C	T	7	8	15	0	3	18	0	0
4	10560437	.	A	C	8	5	13	0	2	15	0	0
4	10560507	.	C	T	6	5	11	0	3	14	0	0
4	10560607	.	A	G	9	5	14	0	1	15	0	0
4	10560820	.	T	G	2	2	4	0	2	6	0	0
4	10560916	.	C	T	13	5	18	0	2	20	0	0
4	10561101	.	T	A	8	29	37	0	2	39	0	0
4	10614856	.	T	C	6	6	12	0	2	14	0	0
4	10614862	.	T	C	7	5	12	0	3	15	0	0
4	10905246	.	C	T	1	1	2	0	0	2	0	0
4	10908001	.	C	T	9	9	18	0	1	19	0	0
4	10908182	.	T	C	4	8	12	0	0	12	0	0
4	10908294	.	C	T	3	9	12	0	0	12	0	0
4	10908726	.	T	C	8	5	13	0	0	13	0	0
4	10974650	.	C	T	4	3	7	0	0	7	0	0
4	10974722	.	G	A	5	2	7	0	0	7	0	0
4	10974747	.	A	T	3	3	6	0	0	6	0	0
4	10982339	.	T	G	1	2	3	0	1	4	0	0
4	11053851	.	G	A	0	2	2	0	3	5	0	0
4	11054484	.	A	C	2	3	5	0	0	5	0	0
4	11054509	.	G	C	1	3	4	0	1	5	0	0
4	11366848	.	A	G	6	3	9	0	0	9	0	0
4	11366868	.	T	A	7	3	10	0	0	10	0	0
4	11366984	.	T	A	3	6	9	0	0	9	0	0
4	11367668	.	T	A	5	7	12	0	0	12	0	0
4	11367884	.	C	T	11	5	16	0	2	18	0	0
4	11367896	.	A	G	11	7	18	0	0	18	0	0
4	11368076	.	G	T	16	19	35	0	3	38	0	0
4	11368143	.	C	T	16	21	37	0	3	40	0	0
4	11368171	.	G	A	0	23	23	0	17	40	0	0
4	11368432	.	A	T	2	6	8	0	1	9	0	0
4	11414799	.	T	C	3	3	6	0	0	6	0	0
4	11414937	.	A	G	1	2	3	0	0	3	0	0
4	11441789	.	T	A	2	2	4	0	1	5	0	0
4	11444209	.	C	A	5	2	7	0	0	7	0	0
4	11445978	.	T	C	5	4	9	0	0	9	0	0
4	11446365	.	A	T	13	7	20	0	0	20	0	0
4	11446703	.	C	T	4	5	9	0	1	10	0	0
4	11446853	.	A	G	5	2	7	0	0	7	0	0
4	11447144	.	G	A	6	12	18	0	1	19	0	0
4	11447226	.	T	G	3	0	3	0	7	10	0	0
4	11447251	.	T	C	7	6	13	0	2	15	0	0
4	11447599	.	C	T	16	15	31	0	2	33	0	0
4	11447632	.	C	G	20	12	32	0	1	33	0	0
4	11448403	.	G	A	0	32	32	0	21	53	0	0
4	11448680	.	A	G	17	17	34	0	0	34	0	0
4	11461479	.	C	T	3	0	3	0	0	3	0	0
4	11461865	.	T	A	4	7	11	0	0	11	0	0
4	11461914	.	A	G	5	0	5	0	0	5	0	0
4	11462054	.	A	T	2	0	2	0	0	2	0	0
4	11470854	.	A	G	1	0	1	0	0	1	0	0
4	11470920	.	C	T	3	1	4	0	0	4	0	0
4	11471203	.	T	C	2	2	4	0	0	4	0	0
4	11472674	.	T	C	3	1	4	0	0	4	0	0
4	11476406	.	T	C	4	5	9	0	1	10	0	0
4	11476472	.	G	A	0	26	26	0	15	41	0	0
4	11476487	.	C	T	11	29	40	0	3	43	0	0
4	11476740	.	C	T	21	16	37	0	7	44	0	0
4	11477566	.	G	A	22	19	41	0	3	44	0	0
4	11480866	.	C	T	0	2	2	0	0	2	0	0
4	11482235	.	G	A	0	4	4	0	1	5	0	0
4	11482259	.	G	A	1	4	5	0	1	6	0	0
4	11482358	.	T	G	0	1	1	0	0	1	0	0
4	11573918	.	C	T	3	2	5	0	0	5	0	0
4	11728959	.	G	A	0	1	1	0	0	1	0	0
4	11729471	.	A	T	4	8	12	0	0	12	0	0
4	11729719	.	G	A	5	5	10	0	1	11	0	0
4	11729792	.	G	A	4	8	12	0	1	13	0	0
4	11730033	.	G	A	0	4	4	0	7	11	0	0
4	11730088	.	A	T	10	4	14	0	1	15	0	0
4	11730199	.	C	T	4	7	11	0	0	11	0	0
4	11730317	.	T	G	5	7	12	0	1	13	0	0
4	11730515	.	C	A	12	8	20	0	2	22	0	0
4	11732213	.	G	A	8	3	11	0	1	12	0	0
4	11732222	.	G	A	9	3	12	0	1	13	0	0
4	11732764	.	G	A	2	2	4	0	1	5	0	0
4	11732975	.	G	A	2	2	4	0	0	4	0	0
4	11765902	.	C	T	0	2	2	0	0	2	0	0
4	11804932	.	G	A	7	8	15	0	1	16	0	0
4	11805095	.	G	T	4	7	11	0	0	11	0	0
4	11805149	.	C	A	8	8	16	0	0	16	0	0
4	11805396	.	G	T	1	5	6	0	0	6	0	0
4	11806965	.	G	C	0	1	1	0	0	1	0	0
4	11814055	.	C	T	0	25	25	0	17	42	0	0
4	11814074	.	T	A	17	28	45	0	0	45	0	0
4	11814264	.	A	C	8	6	14	0	0	14	0	0
4	11814407	.	G	A	6	8	14	0	2	16	0	0
4	11814429	.	A	T	10	7	17	0	0	17	0	0
4	11814471	.	G	A	10	4	14	0	1	15	0	0
4	11814494	.	C	T	5	8	13	0	0	13	0	0
4	11814641	.	T	A	3	7	10	0	0	10	0	0
4	11814723	.	A	C	14	4	18	0	1	19	0	0
4	11814997	.	G	A	9	8	17	0	2	19	0	0
4	11815137	.	G	T	6	8	14	0	0	14	0	0
4	11815143	.	C	G	6	8	14	0	0	14	0	0
4	11815324	.	A	C	4	5	9	0	0	9	0	0
4	11815413	.	A	G	6	5	11	0	0	11	0	0
4	11815417	.	T	A	6	5	11	0	0	11	0	0
4	11816687	.	C	T	3	2	5	0	0	5	0	0
4	12023382	.	C	T	1	0	1	0	0	1	0	0
4	12025771	.	G	A	0	9	9	0	1	10	0	0
4	12026098	.	G	A	7	2	9	0	0	9	0	0
4	12026305	.	T	C	18	16	34	0	2	36	0	0
4	12026363	.	G	A	9	14	23	0	3	26	0	0
4	12026369	.	G	T	15	8	23	0	0	23	0	0
4	12026429	.	C	A	9	10	19	0	3	22	0	0
4	12026488	.	T	C	2	3	5	0	0	5	0	0
4	12026500	.	C	T	1	2	3	0	0	3	0	0
4	12103602	.	G	A	5	3	8	0	2	10	0	0
4	12103675	.	G	T	10	5	15	0	2	18	1	0
4	12104100	.	T	C	1	2	3	0	0	3	0	0
4	12232124	.	C	T	1	3	4	0	0	4	0	0
4	12232125	.	A	G	1	3	4	0	0	4	0	0
4	12232164	.	C	G	2	2	4	0	0	4	0	0
4	12232253	.	G	T	3	4	7	0	0	7	0	0
4	12232328	.	A	T	1	3	4	0	0	4	0	0
4	12234755	.	C	A	2	3	5	0	0	5	0	0
4	12234792	.	A	G	4	2	6	0	0	6	0	0
4	12234828	.	C	T	1	3	4	0	0	4	0	0
4	12235123	.	G	A	4	5	9	0	0	9	0	0
4	12235763	.	G	A	3	2	5	0	0	5	0	0
4	12235770	.	T	C	4	2	6	0	0	6	0	0
4	12235838	.	T	A	1	2	3	0	0	3	0	0
4	12236178	.	T	G	5	3	8	0	0	8	0	0
4	12236429	.	T	A	3	4	7	0	0	7	0	0
4	12236519	.	A	G	3	2	5	0	0	5	0	0
4	12236584	.	C	T	1	1	2	0	0	2	0	0
4	12236592	.	T	A	1	1	2	0	0	2	0	0
4	12237689	.	C	A	6	6	12	0	1	13	0	0
4	12237849	.	C	T	9	9	18	0	1	19	0	0
4	12238064	.	G	T	13	11	24	0	3	27	0	0
4	12238065	.	C	A	14	9	23	0	4	27	0	0
4	12238161	.	C	T	9	14	23	0	5	28	0	0
4	12238800	.	G	A	2	2	4	0	0	4	0	0
4	12238904	.	G	A	5	9	14	0	0	14	0	0
4	12243754	.	T	G	6	3	9	0	0	9	0	0
4	12243779	.	T	C	6	3	9	0	0	9	0	0
4	12243881	.	T	G	5	9	14	0	7	21	0	0
4	12243930	.	T	C	12	2	14	0	2	16	0	0
4	12244071	.	T	C	13	10	23	0	1	24	0	0
4	12244086	.	T	G	10	14	24	0	4	28	0	0
4	12244373	.	G	A	12	10	22	0	0	22	0	0
4	12245324	.	T	A	4	2	6	0	2	8	0	0
4	12298513	.	A	T	1	4	5	0	0	5	0	0
4	12304561	.	C	T	8	4	12	0	0	12	0	0
4	12306880	.	G	A	8	10	18	0	0	18	0	0
4	12317645	.	C	G	7	4	11	0	3	14	0	0
4	12317674	.	A	T	10	4	14	0	1	15	0	0
4	12382234	.	C	T	4	2	6	0	1	7	0	0
4	12382433	.	G	C	5	2	7	0	0	7	0	0
4	12382712	.	G	A	6	7	13	0	1	14	0	0
4	12382889	.	T	G	2	7	9	0	3	12	0	0
4	12382921	.	G	A	3	4	7	0	0	7	0	0
4	12382943	.	T	G	2	6	8	0	0	8	0	0
4	12382961	.	T	C	4	6	10	0	0	10	0	0
4	12382979	.	A	T	4	7	11	0	0	11	0	0
4	12383030	.	C	T	4	7	11	0	1	12	0	0
4	12384831	.	A	G	0	5	5	0	1	6	0	0
4	12388419	.	T	C	1	4	5	0	1	6	0	0
4	12415902	.	C	T	0	1	1	0	1	2	0	0
4	12620983	.	G	A	2	1	3	0	0	3	0	0
4	12657838	.	G	A	0	8	8	0	6	14	0	0
4	12657905	.	G	C	4	9	13	0	0	13	0	0
4	12678204	.	C	G	14	22	36	0	3	39	0	0
4	12678676	.	C	A	17	19	36	0	1	37	0	0
4	12678885	.	T	C	29	22	51	0	1	52	0	0
4	12679190	.	C	T	3	3	6	0	1	7	0	0
4	12715800	.	C	T	2	10	12	0	1	13	0	0
4	12715830	.	C	T	2	8	10	0	0	10	0	0
4	12715837	.	G	A	2	8	10	0	1	11	0	0
4	12755207	.	C	A	2	4	6	0	0	6	0	0
4	12755275	.	G	T	0	3	3	0	0	3	0	0
4	12772832	.	T	C	2	2	4	0	0	4	0	0
4	12772846	.	C	A	2	2	4	0	1	5	0	0
4	12793632	.	G	A	5	7	12	0	0	12	0	0
4	12793806	.	G	A	4	2	6	0	1	7	0	0
4	12793914	.	T	A	1	2	3	0	0	3	0	0
4	12793943	.	C	G	2	3	5	0	0	5	0	0
4	12795394	.	G	A	2	1	3	0	0	3	0	0
4	12893073	.	T	C	2	3	5	0	0	5	0	0
4	13422116	.	G	A	0	1	1	0	1	2	0	0
4	13424839	.	G	A	8	18	26	0	1	27	0	0
4	13424968	.	A	C	13	12	25	0	0	25	0	0
4	13458703	.	C	G	1	3	4	0	0	4	0	0
4	13458800	.	C	T	2	2	4	0	0	4	0	0
4	13459602	.	T	G	1	3	4	0	0	4	0	0
4	13459753	.	G	T	1	3	4	0	0	4	0	0
4	13459823	.	G	A	3	7	10	0	1	11	0	0
4	13459964	.	A	T	2	2	4	0	0	4	0	0
4	13460125	.	G	A	8	6	14	0	1	15	0	0
4	13460244	.	A	G	4	5	9	0	1	10	0	0
4	13460653	.	G	A	10	4	14	0	0	14	0	0
4	13461216	.	T	A	11	10	21	0	4	25	0	0
4	13551447	.	G	A	1	3	4	0	0	4	0	0
4	13592863	.	G	A	1	1	2	0	0	2	0	0
4	13593060	.	G	A	0	2	2	0	1	3	0	0
4	13595838	.	G	A	0	2	2	0	3	5	0	0
4	13597547	.	A	G	1	2	3	0	0	3	0	0
4	13599365	.	G	T	4	1	5	0	0	5	0	0
4	13599410	.	C	T	4	1	5	0	0	5	0	0
4	13599840	.	C	T	6	5	11	0	1	12	0	0
4	13628328	.	G	T	1	2	3	0	0	3	0	0
4	13642486	.	C	T	6	7	13	0	1	14	0	0
4	13642715	.	A	T	4	11	15	0	0	15	0	0
4	13642897	.	A	G	4	3	7	0	0	7	0	0
4	13643349	.	A	T	3	7	10	0	0	10	0	0
4	13643427	.	G	A	10	2	12	0	1	13	0	0
4	13643461	.	G	A	0	7	7	0	5	12	0	0
4	13643547	.	C	T	3	3	6	0	0	6	0	0
4	13747793	.	C	A	3	2	5	0	0	5	0	0
4	13747799	.	C	T	0	2	2	0	3	5	0	0
4	13748217	.	C	T	1	2	3	0	0	3	0	0
4	13748521	.	T	G	3	2	5	0	3	8	0	0
4	13753404	.	G	A	10	5	15	0	0	15	0	0
4	13753561	.	A	T	2	1	3	0	1	4	0	0
4	13753717	.	C	T	4	4	8	0	0	8	0	0
4	13753738	.	C	G	1	0	1	0	1	2	0	0
4	13753864	.	T	C	12	5	17	0	0	17	0	0
4	13754405	.	C	T	8	15	23	0	1	24	0	0
4	13754456	.	A	C	8	14	22	0	3	25	0	0
4	13755213	.	G	A	5	5	10	0	1	11	0	0
4	13755392	.	G	A	0	6	6	0	14	20	0	0
4	13756222	.	T	G	2	10	12	0	2	14	0	0
4	13756324	.	T	C	15	7	22	0	1	23	0	0
4	13905926	.	T	A	9	8	17	0	6	23	0	0
4	13905985	.	C	T	6	6	12	0	1	13	0	0
4	13906107	.	G	A	1	2	3	0	0	3	0	0
4	13906217	.	G	T	1	2	3	0	0	3	0	0
4	13906547	.	G	C	7	4	11	0	0	11	0	0
4	13906766	.	G	A	10	8	18	0	2	20	0	0
4	13906847	.	C	T	0	6	6	0	10	16	0	0
4	13925593	.	T	C	2	0	2	0	6	8	0	0
4	13925621	.	A	G	5	2	7	0	1	8	0	0
4	13925714	.	C	T	1	5	6	0	0	6	0	0
4	13935669	.	T	C	2	1	3	0	1	4	0	0
4	13950946	.	C	T	0	1	1	0	0	1	0	0
4	13953957	.	C	A	1	3	4	0	1	5	0	0
4	13954031	.	C	T	1	1	2	0	1	3	0	0
4	13963045	.	T	C	7	10	17	0	2	19	0	0
4	13963048	.	T	A	11	7	18	0	0	18	0	0
4	13964769	.	A	T	1	3	4	0	0	4	0	0
4	14193462	.	G	T	5	8	13	0	0	13	0	0
4	14193473	.	C	A	4	6	10	0	0	10	0	0
4	14194426	.	G	A	6	3	9	0	2	11	0	0
4	14196368	.	T	C	1	1	2	0	0	2	0	0
4	14247890	.	G	C	17	21	38	0	7	45	0	0
4	14248128	.	G	A	24	28	52	0	2	54	0	0
4	14248332	.	C	A	2	26	28	0	26	54	0	0
4	14248615	.	T	A	31	20	51	0	1	52	0	0
4	14248643	.	A	G	18	29	47	0	1	48	0	0
4	14248750	.	T	G	32	7	39	0	1	40	0	0
4	14248751	.	A	G	30	7	37	0	3	40	0	0
4	14248804	.	G	A	15	27	42	1	1	44	0	0
4	14248906	.	C	T	18	11	29	0	0	29	0	0
4	14248948	.	A	G	12	8	20	0	1	21	0	0
4	14248969	.	T	G	10	6	16	0	0	16	0	0
4	14249043	.	C	T	12	4	16	0	1	17	0	0
4	14249151	.	T	C	6	3	9	0	0	9	0	0
4	14249159	.	T	G	5	2	7	0	1	8	0	0
4	14249247	.	A	T	4	6	10	0	0	10	0	0
4	14249269	.	T	C	4	4	8	0	4	12	0	0
4	14250024	.	T	A	5	3	8	0	2	10	0	0
4	14250678	.	G	A	5	3	8	0	0	8	0	0
4	14250831	.	G	A	4	4	8	0	2	10	0	0
4	14282301	.	C	T	0	1	1	0	0	1	0	0
4	14305901	.	G	A	1	0	1	0	0	1	0	0
4	14372785	.	C	T	3	4	7	0	3	10	0	0
4	14449276	.	A	C	6	4	10	0	1	11	0	0
4	14449297	.	G	A	9	10	19	0	1	20	0	0
4	14449492	.	G	C	9	0	9	0	16	25	0	0
4	14449762	.	T	A	4	2	6	0	0	6	0	0
4	14450330	.	T	C	2	0	2	0	5	7	0	0
4	14450355	.	A	T	4	3	7	0	0	7	0	0
4	14450377	.	T	C	8	3	11	0	0	11	0	0
4	14450501	.	G	A	1	3	4	0	1	5	0	0
4	14700843	.	A	T	0	1	1	0	0	1	0	0
4	14711984	.	G	T	0	1	1	0	0	1	0	0
4	14728640	.	T	A	2	7	9	0	1	10	0	0
4	14734276	.	A	T	6	8	14	0	0	14	0	0
4	14734336	.	C	T	18	17	35	0	0	35	0	0
4	14736369	.	G	A	15	12	27	0	1	28	0	0
4	14736506	.	G	T	6	4	10	0	0	10	0	0
4	14736546	.	C	T	7	5	12	0	0	12	0	0
4	14736571	.	G	C	6	2	8	0	0	8	0	0
4	14906291	.	G	A	1	3	4	0	1	5	0	0
4	14909532	.	T	C	1	2	3	0	0	3	0	0
4	14918473	.	G	A	1	0	1	0	0	1	0	0
4	14918476	.	A	G	1	0	1	0	0	1	0	0
4	14926967	.	C	T	4	2	6	0	1	7	0	0
4	14928973	.	G	A	0	1	1	0	0	1	0	0
4	14929107	.	T	G	4	2	6	0	0	6	0	0
4	14932200	.	T	C	16	12	28	0	3	31	0	0
4	14932676	.	A	T	4	2	6	0	1	7	0	0
4	14932821	.	G	C	10	7	17	0	0	17	0	0
4	14932915	.	C	G	7	5	12	0	1	13	0	0
4	14933337	.	A	G	4	3	7	0	2	9	0	0
4	14933513	.	G	T	1	4	5	0	0	5	0	0
4	14992080	.	A	G	3	2	5	0	0	5	0	0
4	14992081	.	T	C	3	2	5	0	0	5	0	0
4	14992353	.	T	C	5	2	7	0	0	7	0	0
4	14992423	.	T	C	4	3	7	0	0	7	0	0
4	14992426	.	T	C	1	5	6	0	1	7	0	0
4	14992592	.	T	C	1	2	3	0	0	3	0	0
4	14993263	.	A	C	3	3	6	0	1	7	0	0
4	15009947	.	G	A	1	3	4	0	1	5	0	0
4	15009971	.	A	T	3	5	8	0	0	8	0	0
4	15010172	.	T	A	2	1	3	0	0	3	0	0
4	15010557	.	A	G	7	1	8	0	7	15	0	0
4	15010680	.	A	G	3	6	9	0	0	9	0	0
4	15058352	.	A	G	4	7	11	0	0	11	0	0
4	15058663	.	A	C	9	6	15	1	0	16	0	0
4	15058968	.	T	G	6	1	7	0	5	12	0	0
4	15059019	.	A	G	5	3	8	0	0	8	0	0
4	15059070	.	A	T	6	3	9	0	1	10	0	0
4	15059147	.	A	G	12	4	16	0	3	19	0	0
4	15059367	.	A	G	8	0	8	0	0	8	0	0
4	15059498	.	T	A	9	9	18	0	0	18	0	0
4	15059823	.	A	T	10	17	27	0	0	27	0	0
4	15081490	.	C	T	6	12	18	0	1	19	0	0
4	15081703	.	G	A	10	6	16	0	0	16	0	0
4	15081829	.	T	C	8	7	15	0	1	16	0	0
4	15081871	.	C	T	11	12	23	0	0	23	0	0
4	15081985	.	T	C	14	9	23	0	3	26	0	0
4	15218134	.	T	C	21	0	21	0	19	40	0	0
4	15218258	.	A	G	12	17	29	0	6	35	0	0
4	15218342	.	T	A	19	23	42	0	3	45	0	0
4	15218389	.	C	T	17	26	43	0	3	46	0	0
4	15218505	.	C	T	8	21	29	0	1	30	0	0
4	15218595	.	T	C	2	4	6	0	1	7	0	0
4	15218656	.	G	A	6	5	11	0	0	11	0	0
4	15218772	.	C	A	15	9	24	0	1	25	0	0
4	15219368	.	C	T	0	7	7	0	12	19	0	0
4	15219533	.	T	A	5	9	14	0	0	14	0	0
4	15219787	.	T	C	7	7	14	0	0	14	0	0
4	15219840	.	G	T	12	8	20	0	0	20	0	0
4	15219955	.	G	A	7	7	14	0	2	16	0	0
4	15220001	.	A	T	8	10	18	0	0	18	0	0
4	15220022	.	A	G	8	6	14	0	0	14	0	0
4	15220467	.	T	G	1	2	3	0	0	3	0	0
4	15500617	.	G	T	0	1	1	0	0	1	0	0
4	15500720	.	T	C	0	0	0	0	1	1	0	0
4	15603487	.	G	C	3	2	5	0	0	5	0	0
4	15916291	.	A	T	1	2	3	0	0	3	0	0
4	15981260	.	A	G	6	9	15	0	0	15	0	0
4	15981266	.	C	T	5	7	12	0	1	13	0	0
4	15981362	.	T	C	7	6	13	0	1	14	0	0
4	15981428	.	C	T	7	7	14	0	0	14	0	0
4	15989142	.	G	A	0	1	1	0	0	1	0	0
4	15989643	.	T	C	0	1	1	0	0	1	0	0
4	15989661	.	A	G	0	1	1	0	0	1	0	0
4	15989988	.	C	T	1	1	2	0	0	2	0	0
4	15991026	.	C	T	3	1	4	0	0	4	0	0
4	15992146	.	G	A	7	10	17	0	0	17	0	0
4	15992206	.	T	C	6	9	15	0	0	15	0	0
4	15993801	.	C	T	3	5	8	0	1	9	0	0
4	15993917	.	G	C	4	1	5	0	1	6	0	0
4	15993959	.	C	T	10	9	19	0	2	21	0	0
4	15995876	.	A	G	13	12	25	0	0	25	0	0
4	15996044	.	T	C	10	6	16	0	7	23	0	0
4	15996066	.	C	G	10	10	20	0	2	22	0	0
4	16077260	.	T	C	19	19	38	0	2	40	0	0
4	16077663	.	G	A	3	4	7	0	6	13	0	0
4	16078080	.	A	T	11	12	23	0	2	25	0	0
4	16078203	.	C	T	11	24	35	0	1	36	0	0
4	16078979	.	A	G	15	8	23	0	1	24	0	0
4	16081306	.	G	T	5	6	11	0	1	12	0	0
4	16085420	.	T	G	3	2	5	0	0	5	0	0
4	16088673	.	C	T	0	2	2	0	0	2	0	0
4	16090262	.	A	G	4	5	9	0	0	9	0	0
4	16111890	.	A	T	1	2	3	0	0	3	0	0
4	16319839	.	T	A	4	3	7	0	2	9	0	0
4	16319954	.	T	C	1	3	4	0	0	4	0	0
4	16319961	.	T	C	0	3	3	0	1	4	0	0
4	16320319	.	T	A	6	2	8	0	1	9	0	0
4	16368805	.	T	C	5	0	5	0	10	15	0	0
4	16368977	.	G	A	4	5	9	0	0	9	0	0
4	16369033	.	T	A	9	3	12	0	1	13	0	0
4	16536946	.	C	A	17	24	41	0	0	41	0	0
4	16537045	.	T	C	18	12	30	0	9	39	0	0
4	16537099	.	A	T	28	14	42	0	2	44	0	0
4	16537575	.	T	G	17	13	30	0	1	31	0	0
4	16537770	.	G	A	15	20	35	0	0	35	0	0
4	16538055	.	T	A	6	9	15	0	0	15	0	0
4	16539253	.	A	G	6	6	12	0	2	14	0	0
4	16615258	.	C	T	3	3	6	0	0	6	0	0
4	16632415	.	G	A	3	4	7	0	1	8	0	0
4	16632650	.	A	T	9	6	15	0	0	15	0	0
4	16632762	.	A	T	6	3	9	0	1	10	0	0
4	16632907	.	T	A	4	2	6	0	0	6	0	0
4	16650057	.	G	A	6	2	8	0	2	10	0	0
4	16650142	.	A	T	1	6	7	0	1	8	0	0
4	16650433	.	A	C	14	11	25	0	1	26	0	0
4	16650482	.	T	C	11	5	16	0	0	16	0	0
4	16650611	.	T	G	12	7	19	0	1	20	0	0
4	16650618	.	A	G	13	8	21	0	1	22	0	0
4	16650898	.	C	A	3	1	4	0	0	4	0	0
4	16651046	.	G	C	5	3	8	0	2	10	0	0
4	16652890	.	A	G	0	1	1	0	0	1	0	0
4	16654337	.	G	C	3	1	4	0	0	4	0	0
4	16654349	.	C	T	0	1	1	0	3	4	0	0
4	16741979	.	T	G	5	4	9	0	1	10	0	0
4	16742444	.	G	C	17	15	32	0	1	33	0	0
4	16784840	.	G	T	10	6	16	0	0	16	0	0
4	16784876	.	C	T	1	0	1	0	0	1	0	0
4	16785393	.	A	G	16	25	41	0	2	43	0	0
4	16785664	.	A	T	19	10	29	0	1	30	0	0
4	16786002	.	C	A	2	4	6	0	1	7	0	0
4	16786018	.	A	T	1	4	5	0	0	5	0	0
4	16786059	.	T	C	4	3	7	0	1	8	0	0
4	16786077	.	G	A	4	5	9	0	1	10	0	0
4	16786208	.	C	T	6	6	12	0	0	12	0	0
4	16788485	.	C	T	1	1	2	0	0	2	0	0
4	16788500	.	G	A	0	0	0	0	2	2	0	0
4	16791616	.	G	A	1	0	1	0	0	1	0	0
4	16791780	.	A	G	6	0	6	0	9	15	0	0
4	16791781	.	G	C	6	9	15	0	0	15	0	0
4	16791883	.	T	A	6	7	13	0	0	13	0	0
4	16791934	.	C	T	0	1	1	0	2	3	0	0
4	16829355	.	T	C	29	35	64	0	2	66	0	0
4	16829387	.	T	G	23	37	60	0	6	66	0	0
4	16829651	.	G	A	23	32	55	0	11	66	0	0
4	16831399	.	A	T	8	6	14	0	1	15	0	0
4	16832124	.	C	A	0	4	4	0	4	8	0	0
4	16832894	.	G	A	2	1	3	0	0	3	0	0
4	16858074	.	A	T	3	4	7	0	0	7	0	0
4	16858075	.	A	G	3	4	7	0	0	7	0	0
4	16858155	.	G	A	2	2	4	0	1	5	0	0
4	16858442	.	C	G	0	3	3	0	3	6	0	0
4	16877387	.	C	T	1	20	21	0	20	41	0	0
4	16879505	.	T	C	10	0	10	0	13	23	0	0
4	16881865	.	T	G	0	2	2	0	0	2	0	0
4	16899273	.	T	C	0	1	1	0	0	1	0	0
4	16904521	.	C	G	7	4	11	0	1	12	0	0
4	16904527	.	A	G	7	0	7	0	6	13	0	0
4	16905090	.	T	C	8	4	12	0	0	12	0	0
4	16905119	.	T	C	11	10	21	0	2	23	0	0
4	16905184	.	T	C	7	16	23	0	0	23	0	0
4	16905224	.	A	G	4	9	13	0	0	13	0	0
4	16905684	.	T	G	7	7	14	0	0	14	0	0
4	16905708	.	T	A	4	9	13	0	0	13	0	0
4	16905723	.	C	A	3	10	13	0	1	14	0	0
4	16905853	.	T	A	9	11	20	0	1	21	0	0
4	16906173	.	C	A	10	17	27	0	3	30	0	0
4	16906198	.	C	A	10	19	29	0	1	31	1	0
4	16906244	.	A	T	18	19	37	0	1	38	0	0
4	16906562	.	G	A	16	32	48	0	0	48	0	0
4	16982269	.	G	A	10	10	20	0	2	22	0	0
4	16982682	.	C	A	8	5	13	0	1	14	0	0
4	16983131	.	A	G	3	3	6	0	0	6	0	0
4	16984252	.	C	G	1	2	3	0	0	3	0	0
4	17253737	.	A	G	6	6	12	0	1	13	0	0
4	17253758	.	C	T	7	4	11	0	1	12	0	0
4	17253813	.	A	C	9	5	14	0	0	14	0	0
4	17253818	.	A	G	8	5	13	0	1	14	0	0
4	17253925	.	T	A	10	8	18	0	4	22	0	0
4	17253927	.	T	A	12	9	21	0	1	22	0	0
4	17254046	.	A	G	11	15	26	0	1	27	0	0
4	17256855	.	C	T	0	2	2	0	0	2	0	0
4	17257386	.	G	A	2	2	4	0	0	4	0	0
4	17257458	.	C	T	2	2	4	0	0	4	0	0
4	17288964	.	T	C	3	5	8	0	0	8	0	0
4	17291024	.	A	G	3	5	8	0	0	8	0	0
4	17292575	.	C	A	3	2	5	0	0	5	0	0
4	17292770	.	G	A	9	2	11	0	0	11	0	0
4	17292789	.	A	C	10	5	15	0	0	15	0	0
4	17292837	.	A	G	12	15	27	0	1	28	0	0
4	17294947	.	T	C	1	1	2	0	0	2	0	0
4	17296974	.	A	G	3	10	13	0	1	14	0	0
4	17297086	.	C	A	12	20	32	0	2	34	0	0
4	17297338	.	T	G	3	11	14	0	1	15	0	0
4	17336693	.	G	A	2	3	5	0	0	5	0	0
4	17337593	.	A	T	2	3	5	0	0	5	0	0
4	17338664	.	T	C	4	5	9	0	1	10	0	0
4	17369451	.	T	C	1	2	3	0	0	3	0	0
4	17380828	.	C	A	2	2	4	0	0	4	0	0
4	17382878	.	G	A	0	1	1	0	1	2	0	0
4	17383774	.	G	C	0	0	0	0	1	1	0	0
4	17384624	.	A	T	2	2	4	0	0	4	0	0
4	17533769	.	C	T	1	2	3	0	1	4	0	0
4	17536140	.	T	G	2	1	3	0	1	4	0	0
4	17537639	.	A	G	5	8	13	0	1	14	0	0
4	17537939	.	G	T	0	5	5	0	9	14	0	0
4	17539157	.	G	A	1	2	3	0	0	3	0	0
4	17541666	.	A	G	1	1	2	0	0	2	0	0
4	17545083	.	A	G	0	0	0	0	2	2	0	0
4	17572583	.	C	T	8	13	21	0	2	23	0	0
4	17572589	.	C	A	8	9	17	0	2	19	0	0
4	17572898	.	T	C	6	7	13	1	1	15	0	0
4	17572901	.	A	C	5	8	13	1	1	15	0	0
4	17573071	.	A	T	2	6	8	0	1	9	0	0
4	17573081	.	G	C	4	6	10	0	2	12	0	0
4	17573464	.	A	G	3	3	6	0	1	7	0	0
4	17573465	.	A	G	2	3	5	0	2	7	0	0
4	17573594	.	T	A	1	4	5	0	1	6	0	0
4	17573616	.	A	G	4	3	7	0	0	7	0	0
4	17573802	.	T	C	4	3	7	0	1	8	0	0
4	17573841	.	A	G	4	4	8	0	2	10	0	0
4	17573865	.	T	A	1	4	5	0	1	6	0	0
4	17573982	.	A	T	3	2	5	0	0	5	0	0
4	17574093	.	A	G	8	3	11	0	1	12	0	0
4	17574390	.	C	T	6	4	10	0	1	11	0	0
4	17580468	.	A	T	0	1	1	0	0	1	0	0
4	17634398	.	C	T	0	2	2	0	2	4	0	0
4	17634636	.	C	T	1	3	4	0	1	5	0	0
4	17634668	.	G	A	1	2	3	0	0	3	0	0
4	17644913	.	A	G	1	1	2	0	0	2	0	0
4	17645890	.	A	C	1	0	1	0	0	1	0	0
4	17645962	.	C	T	2	1	3	0	0	3	0	0
4	17653340	.	T	C	2	2	4	0	1	5	0	0
4	17653516	.	T	A	2	3	5	0	0	5	0	0
4	17653517	.	A	C	2	3	5	0	0	5	0	0
4	17660723	.	C	T	4	4	8	0	1	9	0	0
4	17660732	.	A	G	4	3	7	0	1	8	0	0
4	17661061	.	A	G	3	0	3	0	2	5	0	0
4	17661062	.	A	G	2	3	5	0	0	5	0	0
4	17661102	.	T	G	5	2	7	0	0	7	0	0
4	17661265	.	A	G	7	1	8	0	0	8	0	0
4	17661354	.	T	G	7	2	9	0	0	9	0	0
4	17661387	.	A	G	4	2	6	0	1	7	0	0
4	17661399	.	A	T	5	2	7	0	0	7	0	0
4	17688874	.	T	C	2	2	4	0	0	4	0	0
4	17688897	.	C	T	2	1	3	0	0	3	0	0
4	17704067	.	G	A	0	1	1	0	0	1	0	0
4	17704123	.	T	C	2	2	4	0	0	4	0	0
4	17704393	.	A	T	3	2	5	0	0	5	0	0
4	17704560	.	A	G	3	2	5	0	0	5	0	0
4	17704722	.	G	T	2	1	3	0	1	4	0	0
4	17704885	.	T	C	1	3	4	0	0	4	0	0
4	17707727	.	T	A	4	3	7	0	0	7	0	0
4	17707739	.	A	G	3	2	5	0	0	5	0	0
4	17708230	.	T	C	2	5	7	0	1	8	0	0
4	17873351	.	A	G	1	3	4	0	2	6	0	0
4	17873530	.	T	G	8	5	13	0	0	13	0	0
4	17873590	.	G	C	5	0	5	0	1	6	0	0
4	17873591	.	C	T	4	2	6	0	0	6	0	0
4	17873711	.	A	T	8	7	15	0	2	17	0	0
4	17873743	.	C	T	5	6	11	0	0	11	0	0
4	17873787	.	G	A	0	6	6	0	2	8	0	0
4	17873808	.	G	C	2	5	7	0	0	7	0	0
4	17886974	.	G	A	19	24	43	0	2	45	0	0
4	17887059	.	T	C	22	12	34	0	2	36	0	0
4	17887388	.	A	T	20	16	36	0	1	37	0	0
4	17887826	.	C	T	16	22	38	0	2	40	0	0
4	17887885	.	A	C	18	14	32	0	2	34	0	0
4	17887966	.	C	T	0	10	10	4	6	20	0	0
4	17902098	.	A	G	11	6	17	0	1	18	0	0
4	17915070	.	G	A	2	1	3	0	0	3	0	0
4	17949261	.	C	T	3	3	6	0	0	6	0	0
4	18207890	.	T	C	2	2	4	0	0	4	0	0
4	18208005	.	A	G	9	4	13	0	3	16	0	0
4	18208044	.	A	G	8	5	13	0	3	16	0	0
4	18208068	.	A	G	11	10	21	0	0	21	0	0
4	18208347	.	C	G	5	3	8	0	4	12	0	0
4	18208939	.	C	T	4	2	6	0	0	6	0	0
4	18209107	.	G	C	3	4	7	0	1	8	0	0
4	18209185	.	A	T	7	1	8	0	0	8	0	0
4	18213267	.	C	T	1	5	6	0	0	6	0	0
4	18216182	.	A	G	1	1	2	0	0	2	0	0
4	18216332	.	A	G	3	3	6	0	0	6	0	0
4	18235106	.	T	C	2	2	4	0	0	4	0	0
4	18240536	.	G	T	2	2	4	0	0	4	0	0
4	18240546	.	C	T	0	2	2	0	2	4	0	0
4	18287263	.	T	C	3	0	3	0	1	4	0	0
4	18287449	.	T	G	2	2	4	0	1	5	0	0
4	18287739	.	T	G	2	2	4	0	0	4	0	0
4	18287744	.	A	G	2	2	4	0	0	4	0	0
4	18454352	.	A	G	8	7	15	0	2	17	0	0
4	18454363	.	T	A	7	8	15	0	1	16	0	0
4	18454400	.	C	T	0	3	3	0	3	6	0	0
4	18592863	.	A	C	2	3	5	0	0	5	0	0
4	18593839	.	G	A	10	7	17	0	2	19	0	0
4	18593989	.	T	A	2	2	4	0	1	5	0	0
4	18594019	.	G	T	3	2	5	0	1	6	0	0
4	18594125	.	T	A	4	4	8	0	1	9	0	0
4	18597841	.	C	G	15	11	26	0	0	26	0	0
4	18606501	.	G	T	3	4	7	0	1	8	0	0
4	18606512	.	C	T	3	8	11	0	0	11	0	0
4	18609613	.	T	G	1	2	3	0	0	3	0	0
4	18609759	.	C	G	2	2	4	0	1	5	0	0
4	18609769	.	A	G	2	2	4	0	0	4	0	0
4	18609855	.	G	C	0	3	3	0	1	4	0	0
4	18614208	.	C	T	2	1	3	0	1	4	0	0
4	18614232	.	A	G	2	2	4	0	0	4	0	0
4	18623708	.	A	G	1	4	5	0	0	5	0	0
4	18707376	.	C	T	0	2	2	0	1	3	0	0
4	18720871	.	C	T	3	5	8	0	2	10	0	0
4	18720942	.	C	T	0	4	4	0	1	5	0	0
4	18720947	.	G	T	1	4	5	0	1	6	0	0
4	18837898	.	A	T	4	4	8	0	0	8	0	0
4	18853153	.	C	T	3	4	7	0	0	7	0	0
4	18853972	.	C	G	13	6	19	0	0	19	0	0
4	18854501	.	T	A	7	1	8	0	3	11	0	0
4	18979820	.	T	A	1	0	1	0	0	1	0	0
4	18985807	.	T	A	14	16	30	0	1	31	0	0
4	18985846	.	A	G	11	12	23	0	4	27	0	0
4	18985995	.	G	A	10	8	18	0	1	19	0	0
4	18986107	.	C	T	1	2	3	0	1	4	0	0
4	18986293	.	T	G	3	4	7	0	2	9	0	0
4	18986413	.	G	A	8	10	18	0	0	18	0	0
4	18986497	.	C	T	1	10	11	0	5	16	0	0
4	18986893	.	C	G	1	3	4	0	0	4	0	0
4	18986897	.	T	A	1	3	4	0	0	4	0	0
4	18987523	.	T	C	2	3	5	0	1	6	0	0
4	18988084	.	G	A	1	3	4	0	0	4	0	0
4	19397641	.	A	T	15	5	20	0	1	21	0	0
4	19414905	.	G	A	0	2	2	0	0	2	0	0
4	19493773	.	G	T	2	5	7	0	0	7	0	0
4	19493808	.	G	A	3	3	6	0	0	6	0	0
4	19535841	.	T	G	3	3	6	0	0	6	0	0
4	19536917	.	C	T	9	6	15	0	2	17	0	0
4	19537703	.	A	G	21	13	34	0	3	37	0	0
4	19539017	.	C	T	4	9	13	0	2	15	0	0
4	19611694	.	G	A	1	1	2	0	0	2	0	0
4	19611739	.	T	G	2	1	3	0	1	4	0	0
4	19947781	.	G	T	3	2	5	0	0	5	0	0
4	19948131	.	G	A	5	4	9	0	0	9	0	0
4	19948312	.	A	G	2	2	4	0	1	5	0	0
4	19948313	.	A	G	2	2	4	0	1	5	0	0
4	19948602	.	C	A	1	3	4	0	0	4	0	0
4	19949148	.	T	C	5	4	9	0	1	10	0	0
4	19949178	.	A	T	4	4	8	0	1	9	0	0
4	20049543	.	C	T	20	25	45	0	5	50	0	0
4	20051021	.	A	G	14	15	29	0	0	29	0	0
4	20051092	.	C	T	0	9	9	1	8	18	0	0
4	20053199	.	T	C	7	7	14	0	1	15	0	0
4	20053211	.	A	G	7	8	15	0	0	15	0	0
4	20053901	.	C	T	14	7	21	0	4	25	0	0
4	20054036	.	C	T	15	13	28	0	3	31	0	0
4	20054135	.	A	G	12	7	19	0	0	19	0	0
4	20054243	.	A	G	5	4	9	0	0	9	0	0
4	20054516	.	C	T	10	3	13	0	0	13	0	0
4	20060589	.	A	G	0	0	0	0	1	1	0	0
4	20068149	.	T	G	1	3	4	0	0	4	0	0
4	20068185	.	A	G	1	4	5	0	0	5	0	0
4	20068446	.	G	A	4	5	9	0	1	10	0	0
4	20068470	.	C	G	5	4	9	0	1	10	0	0
4	20068717	.	G	A	4	2	6	0	0	6	0	0
4	20068890	.	G	A	1	3	4	0	0	4	0	0
4	20068903	.	T	C	1	5	6	0	0	6	0	0
4	20069091	.	T	C	3	3	6	0	0	6	0	0
4	20069343	.	C	A	8	8	16	0	2	18	0	0
4	20071344	.	A	T	7	9	16	0	2	18	0	0
4	20071401	.	G	T	10	9	19	0	0	19	0	0
4	20071877	.	C	T	0	2	2	0	1	3	0	0
4	20071905	.	A	G	2	2	4	0	0	4	0	0
4	20071916	.	A	G	2	2	4	0	0	4	0	0
4	20072394	.	C	G	3	5	8	0	0	8	0	0
4	20072429	.	T	G	3	5	8	0	0	8	0	0
4	20099864	.	G	A	4	1	5	0	0	5	0	0
4	20101105	.	G	T	5	4	9	0	0	9	0	0
4	20127909	.	C	T	1	1	2	0	0	2	0	0
4	20229626	.	C	T	0	1	1	0	1	2	0	0
4	20229920	.	C	A	0	6	6	0	2	8	0	0
4	20230213	.	G	A	2	2	4	0	0	4	0	0
4	20303545	.	T	C	2	2	4	0	1	5	0	0
4	20305520	.	G	T	2	2	4	0	0	4	0	0
4	20480734	.	G	A	2	3	5	0	0	5	0	0
4	20482150	.	T	C	2	2	4	0	0	4	0	0
4	20482425	.	A	G	6	6	12	0	0	12	0	0
4	20482726	.	A	G	1	2	3	0	0	3	0	0
4	20483881	.	C	T	1	3	4	0	0	4	0	0
4	20483901	.	G	A	1	3	4	0	0	4	0	0
4	20483918	.	A	G	1	3	4	0	0	4	0	0
4	20496653	.	A	G	4	3	7	0	1	8	0	0
4	20496655	.	C	T	5	3	8	0	0	8	0	0
4	20499421	.	G	C	2	3	5	0	1	6	0	0
4	20499440	.	A	G	6	3	9	0	1	10	0	0
4	20499516	.	G	T	7	2	9	0	2	11	0	0
4	20499557	.	G	A	4	4	8	0	1	9	0	0
4	20507121	.	T	A	4	5	9	0	1	10	0	0
4	20507155	.	A	C	3	4	7	0	2	9	0	0
4	20508913	.	A	G	1	3	4	0	1	5	0	0
4	20508928	.	A	G	1	3	4	0	0	4	0	0
4	21290798	.	G	A	1	1	2	0	2	4	0	0
4	21297417	.	A	C	1	2	3	0	2	5	0	0
4	21312642	.	T	C	4	6	10	0	2	12	0	0
4	21312981	.	C	T	8	12	20	0	4	24	0	0
4	21313120	.	A	G	10	0	10	0	24	34	0	0
4	21313136	.	T	C	10	24	34	0	0	34	0	0
4	21313779	.	T	G	28	15	43	0	4	47	0	0
4	21313805	.	G	A	1	20	21	0	34	55	0	0
4	21314120	.	T	C	11	17	28	0	3	31	0	0
4	21314204	.	G	T	12	10	22	0	2	24	0	0
4	21314338	.	G	T	33	26	59	0	3	62	0	0
4	21314583	.	T	C	26	29	55	0	3	58	0	0
4	21323095	.	G	T	4	2	6	0	0	6	0	0
4	21323098	.	G	A	4	2	6	0	0	6	0	0
4	21323215	.	T	C	1	0	1	0	2	3	0	0
4	21323216	.	T	G	1	2	3	0	0	3	0	0
4	21323363	.	G	C	0	3	3	0	0	3	0	0
4	21323454	.	A	G	1	5	6	0	0	6	0	0
4	21323467	.	G	C	1	6	7	0	0	7	0	0
4	21323532	.	C	T	0	3	3	0	2	5	0	0
4	21323536	.	T	C	2	2	4	0	0	4	0	0
4	21489550	.	A	G	11	1	12	0	1	13	0	0
4	21489629	.	G	T	18	9	27	0	1	28	0	0
4	21490320	.	T	C	5	8	13	0	0	13	0	0
4	21490344	.	A	G	8	6	14	0	1	15	0	0
4	21499521	.	G	A	1	1	2	0	0	2	0	0
4	21507026	.	G	A	1	2	3	0	0	3	0	0
4	21508353	.	C	T	2	4	6	0	0	6	0	0
4	21512191	.	C	T	3	5	8	0	0	8	0	0
4	21523541	.	A	T	2	1	3	0	0	3	0	0
4	21523789	.	T	G	2	2	4	0	0	4	0	0
4	21649505	.	G	A	8	18	26	0	3	29	0	0
4	21651486	.	G	A	18	13	31	0	1	32	0	0
4	21752284	.	G	A	10	3	13	0	0	13	0	0
4	21752291	.	C	T	10	3	13	0	1	14	0	0
4	21752372	.	T	A	3	4	7	0	0	7	0	0
4	21752493	.	T	C	1	3	4	0	0	4	0	0
4	21752495	.	C	G	1	3	4	0	0	4	0	0
4	21752688	.	G	C	6	0	6	0	12	18	0	0
4	21752736	.	T	C	7	5	12	0	2	14	0	0
4	21752941	.	T	A	8	3	11	0	2	13	0	0
4	21752969	.	C	T	5	5	10	0	1	11	0	0
4	21752984	.	C	A	5	7	12	0	0	12	0	0
4	21753139	.	C	T	2	5	7	0	0	7	0	0
4	21753185	.	T	C	3	6	9	0	1	10	0	0
4	21753316	.	T	C	4	4	8	0	1	9	0	0
4	21753344	.	G	A	5	2	7	0	1	8	0	0
4	21761688	.	A	T	0	3	3	0	0	3	0	0
4	21958043	.	A	G	18	12	30	0	1	31	0	0
4	21958150	.	C	T	12	16	28	0	2	30	0	0
4	21958226	.	T	G	15	14	29	0	4	33	0	0
4	21958276	.	C	T	0	17	17	0	20	37	0	0
4	21973713	.	T	C	0	2	2	0	0	2	0	0
4	21975248	.	G	A	1	3	4	0	0	4	0	0
4	21975679	.	T	C	3	2	5	0	0	5	0	0
4	21981118	.	T	C	3	3	6	0	1	7	0	0
4	22006507	.	C	A	0	1	1	0	0	1	0	0
4	22299747	.	G	A	2	1	3	0	0	3	0	0
4	22299954	.	C	T	5	4	9	0	0	9	0	0
4	22300045	.	G	C	1	4	5	0	0	5	0	0
4	22300125	.	A	C	7	4	11	0	2	13	0	0
4	22300153	.	T	A	4	5	9	0	0	9	0	0
4	22300178	.	C	T	3	1	4	0	3	7	0	0
4	22312936	.	A	T	2	2	4	0	2	6	0	0
4	22313107	.	A	T	7	7	14	0	1	15	0	0
4	22313195	.	G	C	17	8	25	0	1	26	0	0
4	22313216	.	T	G	14	4	18	0	2	20	0	0
4	22313244	.	G	A	15	6	21	0	0	21	0	0
4	22313582	.	T	C	3	1	4	0	3	7	0	0
4	22313722	.	A	C	3	2	5	0	0	5	0	0
4	22314001	.	A	T	3	2	5	0	0	5	0	0
4	22314085	.	G	A	2	3	5	0	1	6	0	0
4	22316624	.	A	T	4	3	7	0	0	7	0	0
4	22319133	.	G	A	2	3	5	0	0	5	0	0
4	22350831	.	A	C	1	2	3	0	0	3	0	0
4	22350908	.	G	A	0	2	2	0	1	3	0	0
4	22365152	.	C	T	2	3	5	0	0	5	0	0
4	22365163	.	G	C	2	3	5	0	0	5	0	0
4	22365747	.	C	T	5	6	11	0	3	14	0	0
4	22419473	.	C	A	15	34	49	0	4	53	0	0
4	22419483	.	G	T	16	29	45	0	4	49	0	0
4	22419663	.	T	G	8	7	15	0	0	15	0	0
4	22419739	.	A	G	0	0	0	0	2	2	0	0
4	22424854	.	G	A	15	15	30	0	2	32	0	0
4	22424891	.	A	G	21	17	38	0	0	38	0	0
4	22425115	.	G	A	10	19	29	0	0	29	0	0
4	22428110	.	G	A	2	1	3	0	0	3	0	0
4	22756239	.	T	C	4	6	10	0	0	10	0	0
4	23773192	.	A	T	3	4	7	0	0	7	0	0
4	23773210	.	T	A	3	3	6	0	0	6	0	0
4	23773977	.	A	G	3	3	6	0	0	6	0	0
4	23773982	.	T	G	3	3	6	0	0	6	0	0
4	23887175	.	G	A	0	4	4	1	0	5	0	0
4	23887318	.	C	T	0	3	3	0	3	6	0	0
4	23888406	.	A	T	2	2	4	0	0	4	0	0
4	23892998	.	G	A	1	2	3	0	1	4	0	0
4	23893052	.	C	A	0	1	1	0	1	2	0	0
4	25054826	.	G	A	20	10	30	1	2	33	0	0
4	25055230	.	G	A	23	14	37	0	4	41	0	0
4	25055479	.	C	G	2	5	7	0	14	21	0	0
4	25055602	.	A	G	28	20	48	0	1	50	1	0
4	25084487	.	T	G	15	5	20	0	1	21	0	0
4	25084744	.	A	G	4	8	12	0	1	13	0	0
4	25105502	.	G	T	2	4	6	0	0	6	0	0
4	25173387	.	T	C	15	13	28	0	2	30	0	0
4	25173396	.	A	G	14	12	26	0	1	27	0	0
4	25176093	.	A	G	8	9	17	0	3	20	0	0
4	25176420	.	C	T	19	19	38	0	1	39	0	0
4	25178069	.	G	T	0	3	3	0	0	3	0	0
4	25178402	.	G	C	2	4	6	0	1	7	0	0
4	25179897	.	A	G	1	1	2	0	1	3	0	0
4	25179948	.	C	T	0	4	4	0	5	9	0	0
4	25179996	.	A	G	2	2	4	0	0	4	0	0
4	25184718	.	G	A	3	0	3	0	0	3	0	0
4	25185797	.	T	C	2	3	5	0	1	6	0	0
4	25473316	.	T	G	3	4	7	0	0	7	0	0
4	25473934	.	T	G	6	4	10	0	0	10	0	0
4	25474177	.	T	C	6	6	12	0	4	16	0	0
4	25474301	.	T	C	5	4	9	0	1	10	0	0
4	25474305	.	A	T	6	3	9	0	1	10	0	0
4	25474417	.	G	A	5	7	12	0	1	13	0	0
4	25474419	.	C	T	0	7	7	0	6	13	0	0
4	25476524	.	A	T	1	2	3	0	0	3	0	0
4	25497398	.	G	A	4	3	7	0	1	8	0	0
4	25506417	.	G	A	3	3	6	0	0	6	0	0
4	25511562	.	T	C	1	0	1	0	0	1	0	0
4	25700800	.	A	T	2	2	4	0	0	4	0	0
4	25702919	.	C	T	1	0	1	0	0	1	0	0
4	25755137	.	C	T	6	4	10	0	0	10	0	0
4	25755191	.	T	A	4	3	7	0	2	9	0	0
4	25755194	.	A	G	4	3	7	0	2	9	0	0
4	25755269	.	C	T	2	5	7	0	0	7	0	0
4	25756387	.	T	G	1	3	4	0	0	4	0	0
4	25756432	.	A	G	1	3	4	0	0	4	0	0
4	25829939	.	G	A	7	18	25	0	2	27	0	0
4	25833146	.	A	G	3	2	5	0	0	5	0	0
4	25833221	.	G	A	1	4	5	0	0	5	0	0
4	25839737	.	G	A	6	7	13	0	0	13	0	0
4	25839832	.	A	G	6	4	10	0	0	10	0	0
4	25839911	.	G	C	5	3	8	0	1	9	0	0
4	25839931	.	C	T	0	5	5	0	4	9	0	0
4	25842788	.	C	T	3	3	6	0	0	6	0	0
4	25860634	.	C	T	1	3	4	0	0	4	0	0
4	26021910	.	A	G	5	6	11	0	0	11	0	0
4	26021970	.	C	A	10	4	14	0	3	17	0	0
4	26022052	.	T	C	3	2	5	0	0	5	0	0
4	26022076	.	T	C	0	0	0	0	3	3	0	0
4	26022351	.	C	G	4	2	6	0	0	6	0	0
4	26022637	.	T	C	3	2	5	0	0	5	0	0
4	26022640	.	C	T	0	2	2	0	3	5	0	0
4	26077483	.	T	C	1	2	3	0	0	3	0	0
4	26077671	.	A	T	1	2	3	0	0	3	0	0
4	26078008	.	T	C	1	1	2	0	1	3	0	0
4	26079096	.	A	C	1	6	7	0	0	7	0	0
4	26079116	.	T	C	1	5	6	0	0	6	0	0
4	26079838	.	A	G	2	3	5	0	0	5	0	0
4	26080294	.	A	G	4	9	13	0	0	13	0	0
4	26080321	.	A	G	9	4	13	0	0	13	0	0
4	26080387	.	T	A	10	4	14	0	1	15	0	0
4	26080441	.	C	T	6	12	18	0	0	18	0	0
4	26080593	.	T	C	3	3	6	0	1	7	0	0
4	26080651	.	G	A	1	3	4	0	1	5	0	0
4	26304240	.	T	G	11	14	25	0	2	27	0	0
4	26304451	.	T	C	15	8	23	0	3	26	0	0
4	26305286	.	C	A	4	4	8	0	0	8	0	0
4	26305309	.	T	A	5	6	11	0	2	13	0	0
4	26305324	.	C	T	5	4	9	0	0	9	0	0
4	26306209	.	A	G	3	3	6	0	0	6	0	0
4	26321216	.	A	G	2	2	4	0	0	4	0	0
4	26322721	.	C	T	0	3	3	0	2	5	0	0
4	26762524	.	G	T	7	2	9	0	1	10	0	0
4	26763424	.	A	T	3	2	5	0	0	5	0	0
4	26764217	.	C	T	4	5	9	0	0	9	0	0
4	27082166	.	T	C	6	5	11	0	0	11	0	0
4	27082234	.	G	A	3	2	5	0	0	5	0	0
4	27112663	.	T	A	1	3	4	0	1	5	0	0
4	27113093	.	A	G	2	3	5	0	0	5	0	0
4	27114157	.	T	C	1	2	3	0	0	3	0	0
4	27147712	.	C	T	3	2	5	0	1	6	0	0
4	27147752	.	A	G	2	2	4	0	1	5	0	0
4	27148291	.	G	T	2	2	4	0	0	4	0	0
4	27148417	.	T	C	1	5	6	0	0	6	0	0
4	27148425	.	A	T	1	5	6	0	1	7	0	0
4	27148943	.	A	C	6	5	11	0	1	12	0	0
4	27149017	.	G	A	0	6	6	0	3	9	0	0
4	27149634	.	A	T	4	3	7	0	1	8	0	0
4	27149680	.	G	T	9	6	15	0	3	18	0	0
4	27252027	.	T	C	5	11	16	0	2	18	0	0
4	27252096	.	C	T	6	11	17	0	0	17	0	0
4	27252178	.	C	T	0	10	10	0	15	25	0	0
4	27252581	.	G	A	10	12	22	0	0	22	0	0
4	27350432	.	G	T	1	3	4	0	0	4	0	0
4	27627569	.	C	T	1	3	4	0	0	4	0	0
4	27628190	.	T	A	2	3	5	0	0	5	0	0
4	27628540	.	G	A	1	2	3	0	0	3	0	0
4	28062846	.	T	A	1	2	3	0	0	3	0	0
4	28191712	.	G	A	1	3	4	0	0	4	0	0
4	28191752	.	C	T	0	4	4	0	3	7	0	0
4	28195380	.	A	C	1	0	1	0	0	1	0	0
4	28195396	.	T	C	1	2	3	0	0	3	0	0
4	28423499	.	A	T	2	2	4	0	0	4	0	0
4	28423547	.	C	T	6	5	11	0	0	11	0	0
4	28423595	.	A	G	3	1	4	0	2	6	0	0
4	28423735	.	C	T	7	6	13	0	0	13	0	0
4	28423786	.	A	T	3	4	7	0	0	7	0	0
4	28423886	.	A	C	3	3	6	0	0	6	0	0
4	28423923	.	T	C	2	2	4	0	0	4	0	0
4	28423952	.	G	C	2	1	3	0	1	4	0	0
4	28424026	.	G	A	1	3	4	0	1	5	0	0
4	28821416	.	G	A	0	2	2	0	3	5	0	0
4	28821417	.	A	T	2	2	4	0	1	5	0	0
4	29040223	.	T	C	2	2	4	0	0	4	0	0
4	29040548	.	A	G	4	3	7	0	0	7	0	0
4	29285430	.	T	C	0	1	1	0	2	3	0	0
4	29287803	.	C	A	5	3	8	0	1	9	0	0
4	50756495	.	G	A	1	2	3	0	0	3	0	0
4	65727802	.	C	T	1	3	4	0	0	4	0	0
4	65727822	.	G	A	1	3	4	0	0	4	0	0
4	70850966	.	G	T	3	5	8	0	2	10	0	0
4	70851017	.	C	T	0	5	5	0	4	9	0	0
4	70851028	.	C	G	2	6	8	0	0	8	0	0
4	70855939	.	C	T	0	4	4	0	4	8	0	0
4	72217285	.	T	C	2	4	6	0	0	6	0	0
4	72217405	.	C	T	1	2	3	0	0	3	0	0
4	72217438	.	A	C	0	2	2	0	1	3	0	0
4	72217495	.	C	A	1	4	5	0	0	5	0	0
4	72217508	.	C	T	1	4	5	0	0	5	0	0
4	72217813	.	T	C	1	4	5	0	2	7	0	0
4	72217847	.	G	A	0	4	4	0	4	8	0	0
4	72272239	.	G	A	3	2	5	0	0	5	0	0
4	72272461	.	C	T	1	2	3	0	0	3	0	0
4	72547717	.	G	A	3	2	5	0	0	5	0	0
4	72559171	.	G	T	1	2	3	0	0	3	0	0
4	72559396	.	G	A	4	2	6	0	0	6	0	0
4	72559558	.	A	G	1	4	5	0	0	5	0	0
4	72559585	.	A	G	2	4	6	0	0	6	0	0
4	72559612	.	A	G	3	3	6	0	0	6	0	0
4	72603483	.	C	A	5	2	7	0	0	7	0	0
4	72603620	.	G	A	4	2	6	0	0	6	0	0
4	72603653	.	G	A	2	2	4	0	1	5	0	0
4	72630231	.	G	A	1	2	3	0	0	3	0	0
4	72754244	.	C	T	7	7	14	0	0	14	0	0
4	72772769	.	T	C	10	6	16	0	1	17	0	0
4	72775687	.	C	A	3	3	6	0	0	6	0	0
4	72784800	.	T	C	17	4	21	0	4	25	0	0
4	72785313	.	C	T	1	3	4	0	0	4	0	0
4	72785425	.	C	T	2	2	4	0	0	4	0	0
4	72785692	.	C	G	0	3	3	0	1	4	0	0
4	72785903	.	G	A	5	3	8	0	0	8	0	0
4	73059149	.	C	T	1	3	4	0	0	4	0	0
4	73063318	.	C	G	4	2	6	0	0	6	0	0
4	73064480	.	A	G	0	4	4	0	0	4	0	0
4	73277122	.	A	G	1	1	2	0	1	3	0	0
4	73335956	.	G	A	1	3	4	0	0	4	0	0
4	73335990	.	T	A	2	3	5	0	2	7	0	0
4	73336084	.	T	C	5	2	7	0	0	7	0	0
4	73336441	.	C	T	2	2	4	0	0	4	0	0
4	73336618	.	C	T	1	3	4	0	0	4	0	0
4	73336629	.	C	T	1	3	4	0	0	4	0	0
4	73336690	.	T	C	1	0	1	0	3	4	0	0
4	73336700	.	T	C	1	4	5	0	0	5	0	0
4	73337244	.	A	G	5	0	5	0	0	5	0	0
4	73337248	.	G	A	4	0	4	0	0	4	0	0
4	73337316	.	G	C	2	3	5	0	0	5	0	0
4	73337327	.	T	C	2	2	4	0	1	5	0	0
4	73418744	.	A	T	3	9	12	0	1	13	0	0
4	73418823	.	T	C	2	7	9	0	0	9	0	0
4	73419209	.	G	T	1	1	2	0	1	3	0	0
4	73419217	.	G	A	0	3	3	0	2	5	0	0
4	73419550	.	G	A	2	2	4	0	0	4	0	0
4	73499231	.	T	A	5	2	7	0	0	7	0	0
4	73499235	.	T	A	5	2	7	0	0	7	0	0
4	73499736	.	T	A	1	2	3	0	0	3	0	0
4	73500038	.	T	C	2	1	3	0	0	3	0	0
4	73500041	.	T	C	2	2	4	0	0	4	0	0
4	73542536	.	G	A	6	4	10	0	1	11	0	0
4	73542582	.	A	G	2	4	6	0	0	6	0	0
4	73542757	.	C	A	1	4	5	0	1	6	0	0
4	73542775	.	C	T	0	3	3	0	2	5	0	0
4	73542913	.	A	G	2	3	5	0	0	5	0	0
4	73550610	.	A	T	5	2	7	0	1	8	0	0
4	73551507	.	A	G	1	3	4	0	0	4	0	0
4	73573697	.	C	T	2	4	6	0	0	6	0	0
4	73573820	.	T	A	3	2	5	0	0	5	0	0
4	73574374	.	G	A	2	4	6	0	0	6	0	0
4	73574386	.	T	A	1	3	4	0	1	5	0	0
4	73681574	.	A	G	1	4	5	0	0	5	0	0
4	73681663	.	T	A	1	2	3	0	0	3	0	0
4	73690525	.	A	T	4	3	7	0	0	7	0	0
4	73690547	.	A	G	6	0	6	0	4	10	0	0
4	73690572	.	G	T	3	4	7	0	0	7	0	0
4	73690653	.	T	C	2	1	3	0	0	3	0	0
4	73713850	.	G	T	1	1	2	0	1	3	0	0
4	73729896	.	A	G	1	2	3	0	0	3	0	0
4	73729899	.	A	G	1	2	3	0	0	3	0	0
4	73740301	.	G	A	12	6	18	0	1	19	0	0
4	73740391	.	C	G	10	6	16	0	0	16	0	0
4	73740409	.	C	A	9	6	15	0	0	15	0	0
4	73740487	.	C	G	5	2	7	0	0	7	0	0
4	73740651	.	G	C	4	3	7	0	0	7	0	0
4	73740691	.	T	A	3	2	5	0	0	5	0	0
4	73740879	.	A	C	5	4	9	0	0	9	0	0
4	73741212	.	C	T	1	2	3	0	0	3	0	0
4	73741217	.	T	C	1	0	1	0	2	3	0	0
4	73741749	.	G	T	1	2	3	0	0	3	0	0
4	73758107	.	G	C	2	3	5	0	0	5	0	0
4	73758321	.	T	C	0	3	3	0	0	3	0	0
4	73759983	.	A	G	3	2	5	0	0	5	0	0
4	73815136	.	T	G	1	2	3	0	0	3	0	0
4	73815178	.	C	T	1	1	2	0	2	4	0	0
4	73899317	.	A	G	1	2	3	0	1	4	0	0
4	73899739	.	C	A	1	2	3	0	0	3	0	0
4	73983003	.	A	G	2	4	6	0	0	6	0	0
4	74087781	.	G	A	5	3	8	0	1	9	0	0
4	74087785	.	G	C	6	3	9	0	0	9	0	0
4	74088060	.	T	G	3	8	11	0	0	11	0	0
4	74092153	.	T	C	1	1	2	0	0	2	0	0
4	74182382	.	G	C	1	1	2	0	0	2	0	0
4	74182389	.	G	T	1	0	1	0	0	1	0	0
4	74193480	.	C	G	2	1	3	0	0	3	0	0
4	74196686	.	T	C	2	0	2	0	0	2	0	0
4	74196764	.	G	T	1	5	6	0	0	6	0	0
4	74200391	.	C	T	0	1	1	0	0	1	0	0
4	74204177	.	T	C	3	5	8	0	2	10	0	0
4	74204236	.	G	T	0	5	5	0	8	13	0	0
4	74204387	.	G	T	3	3	6	0	0	6	0	0
4	74204494	.	A	T	3	5	8	0	1	9	0	0
4	74204842	.	A	G	4	9	13	0	1	14	0	0
4	74267225	.	A	G	2	5	7	0	0	7	0	0
4	74267519	.	A	G	7	14	21	0	1	22	0	0
4	74267540	.	G	A	0	6	6	0	16	22	0	0
4	74267582	.	T	G	4	15	19	0	1	20	0	0
4	74267639	.	T	A	14	10	24	0	0	24	0	0
4	74267733	.	A	T	17	9	26	0	1	27	0	0
4	74267748	.	C	T	8	16	24	0	4	28	0	0
4	74267865	.	A	C	4	8	12	0	0	12	0	0
4	74268182	.	C	T	2	7	9	0	1	10	0	0
4	74271251	.	G	A	6	2	8	0	0	8	0	0
4	74278079	.	T	G	4	2	6	0	0	6	0	0
4	74278093	.	C	T	0	2	2	0	4	6	0	0
4	74282709	.	C	T	0	1	1	0	1	2	0	0
4	74284790	.	A	C	0	1	1	0	0	1	0	0
4	74943202	.	A	T	2	1	3	0	0	3	0	0
4	74952660	.	G	T	0	9	9	0	11	20	0	0
4	74960826	.	C	T	11	13	24	0	3	27	0	0
4	74961011	.	C	T	10	9	19	0	2	21	0	0
4	74961075	.	G	A	14	11	25	0	0	25	0	0
4	74961520	.	T	A	5	9	14	0	2	16	0	0
4	75138707	.	G	A	7	5	12	0	2	14	0	0
4	75138750	.	A	G	11	9	20	0	1	21	0	0
4	75138987	.	C	T	9	7	16	0	2	18	0	0
4	75139002	.	A	T	6	4	10	0	1	11	0	0
4	75139264	.	T	C	7	15	22	0	2	24	0	0
4	75142269	.	G	A	6	5	11	0	0	11	0	0
4	75149056	.	C	T	6	10	16	0	1	17	0	0
4	75149071	.	T	A	5	10	15	0	0	15	0	0
4	75149125	.	C	A	0	2	2	0	3	5	0	0
4	75149149	.	C	T	0	0	0	0	2	2	0	0
4	75150806	.	T	G	3	6	9	0	0	9	0	0
4	75157262	.	A	T	0	1	1	0	0	1	0	0
4	75270438	.	G	C	0	2	2	0	1	3	0	0
4	75419653	.	G	A	1	2	3	0	1	4	0	0
4	75419819	.	C	G	2	6	8	0	0	8	0	0
4	75419822	.	A	C	2	6	8	0	0	8	0	0
4	75419961	.	A	C	8	2	10	0	2	12	0	0
4	75419970	.	G	A	0	4	4	0	8	12	0	0
4	75420159	.	T	C	5	3	8	0	0	8	0	0
4	75420270	.	A	G	5	7	12	0	1	13	0	0
4	75420318	.	T	A	9	9	18	0	0	18	0	0
4	75420384	.	A	G	8	4	12	0	0	12	0	0
4	75420558	.	A	T	7	3	10	0	2	12	0	0
4	75420754	.	T	A	5	2	7	0	0	7	0	0
4	75420778	.	A	T	4	2	6	0	0	6	0	0
4	75472025	.	T	G	0	1	1	0	5	6	0	0
4	76320798	.	C	G	0	1	1	0	0	1	0	0
4	76322882	.	G	A	0	2	2	0	1	3	0	0
4	76335026	.	A	T	1	3	4	0	0	4	0	0
4	76347126	.	T	C	2	1	3	0	0	3	0	0
4	76347148	.	A	G	3	2	5	0	0	5	0	0
4	76347163	.	A	G	1	3	4	0	1	5	0	0
4	76347460	.	A	G	5	2	7	0	4	11	0	0
4	76347508	.	T	G	6	3	9	0	3	12	0	0
4	76347977	.	A	T	0	1	1	1	2	4	0	0
4	76348088	.	T	A	2	2	4	0	0	4	0	0
4	76360062	.	T	C	2	2	4	0	0	4	0	0
4	76361624	.	T	A	6	4	10	0	0	10	0	0
4	76361627	.	G	A	0	4	4	0	6	10	0	0
4	76362977	.	T	G	1	2	3	0	0	3	0	0
4	76363195	.	C	T	0	1	1	0	2	3	0	0
4	76363204	.	A	C	2	2	4	0	0	4	0	0
4	76409565	.	G	A	0	3	3	0	0	3	0	0
4	76410940	.	G	T	2	1	3	0	0	3	0	0
4	76410955	.	C	T	1	2	3	0	0	3	0	0
4	76411517	.	T	C	1	5	6	0	1	7	0	0
4	76411757	.	A	T	3	3	6	0	0	6	0	0
4	76411759	.	A	T	3	3	6	0	0	6	0	0
4	76411990	.	A	G	3	1	4	0	2	6	0	0
4	76412107	.	C	T	3	1	4	0	1	5	0	0
4	76412108	.	T	G	3	2	5	0	0	5	0	0
4	76412570	.	G	A	4	2	6	0	1	7	0	0
4	76412625	.	C	A	1	1	2	0	0	2	0	0
4	76412697	.	A	G	3	2	5	0	0	5	0	0
4	76422231	.	G	A	0	4	4	0	1	5	0	0
4	76422891	.	A	G	4	0	4	0	3	7	0	0
4	76422895	.	A	G	0	5	5	0	0	5	0	0
4	76423234	.	G	A	4	2	6	0	1	7	0	0
4	76423537	.	C	T	5	3	8	0	0	8	0	0
4	76429202	.	A	C	1	3	4	0	0	4	0	0
4	76430256	.	G	A	3	4	7	0	1	8	0	0
4	76430257	.	A	G	3	5	8	0	0	8	0	0
4	76430388	.	C	G	2	3	5	0	0	5	0	0
4	76430404	.	A	G	2	4	6	0	0	6	0	0
4	76474430	.	A	G	3	0	3	0	2	5	0	0
4	76480573	.	T	C	1	3	4	0	0	4	0	0
4	76480694	.	C	A	3	4	7	0	0	7	0	0
4	76480756	.	C	A	1	3	4	0	0	4	0	0
4	76481087	.	C	A	0	1	1	0	4	5	0	0
4	76481103	.	T	C	5	3	8	0	0	8	0	0
4	76481262	.	A	G	4	5	9	0	0	9	0	0
4	76481403	.	T	A	5	4	9	0	0	9	0	0
4	76481409	.	T	G	6	4	10	0	0	10	0	0
4	76481665	.	A	T	2	2	4	0	0	4	0	0
4	76504227	.	T	A	1	7	8	0	0	8	0	0
4	76587462	.	T	C	1	2	3	0	0	3	0	0
4	76587474	.	C	T	1	1	2	0	0	2	0	0
4	76588177	.	T	C	3	3	6	0	0	6	0	0
4	76588256	.	G	C	12	4	16	0	0	16	0	0
4	76588295	.	G	T	5	5	10	0	0	10	0	0
4	76866860	.	A	G	3	2	5	0	2	7	0	0
4	76867743	.	T	C	13	5	18	2	1	21	0	0
4	76867829	.	C	G	9	5	14	0	1	15	0	0
4	76960625	.	T	C	3	1	4	0	1	5	0	0
4	77057671	.	G	A	2	3	5	0	0	5	0	0
4	77057695	.	C	G	1	0	1	0	3	4	0	0
4	77058097	.	T	C	1	2	3	0	0	3	0	0
4	77058108	.	A	G	1	2	3	0	0	3	0	0
4	77058162	.	G	A	1	1	2	0	0	2	0	0
4	77058167	.	A	T	0	0	0	0	1	1	0	0
4	77058420	.	C	G	2	1	3	0	1	4	0	0
4	77058436	.	A	T	2	3	5	0	0	5	0	0
4	77058503	.	G	C	1	6	7	0	0	7	0	0
4	77058543	.	G	A	0	3	3	0	1	4	0	0
4	77058723	.	A	G	1	6	7	0	1	8	0	0
4	77058754	.	T	C	3	6	9	0	0	9	0	0
4	77059969	.	C	T	6	3	9	0	1	10	0	0
4	77060002	.	A	G	6	4	10	0	0	10	0	0
4	77065152	.	G	A	1	3	4	0	0	4	0	0
4	77065304	.	A	T	3	3	6	0	0	6	0	0
4	77065342	.	A	T	3	2	5	0	0	5	0	0
4	77065465	.	A	G	4	1	5	0	0	5	0	0
4	77065472	.	G	A	0	3	3	0	2	5	0	0
4	77149729	.	G	A	1	2	3	0	0	3	0	0
4	77149761	.	A	G	2	1	3	0	0	3	0	0
4	77149765	.	C	T	2	2	4	0	0	4	0	0
4	77149805	.	A	T	2	2	4	0	1	5	0	0
4	77149888	.	C	T	5	6	11	0	1	12	0	0
4	77207768	.	G	C	4	4	8	0	0	8	0	0
4	77207903	.	C	T	0	4	4	0	2	6	0	0
4	77209054	.	A	G	0	2	2	0	4	6	0	0
4	77211866	.	G	A	1	0	1	0	0	1	0	0
4	77211872	.	G	A	2	0	2	0	0	2	0	0
4	77212126	.	G	T	1	4	5	0	0	5	0	0
4	77219373	.	T	G	4	3	7	0	0	7	0	0
4	77219421	.	C	G	5	2	7	0	0	7	0	0
4	77219769	.	T	C	2	4	6	0	0	6	0	0
4	77229551	.	C	G	0	2	2	0	1	3	0	0
4	77229875	.	G	A	3	4	7	0	0	7	0	0
4	77229916	.	T	C	2	4	6	0	0	6	0	0
4	77349338	.	G	A	1	2	3	0	0	3	0	0
4	77349372	.	A	G	2	4	6	0	0	6	0	0
4	77349374	.	G	A	2	3	5	0	1	6	0	0
4	77349501	.	G	A	1	4	5	0	0	5	0	0
4	77389776	.	A	C	3	2	5	0	0	5	0	0
4	77390006	.	G	A	8	7	15	0	2	17	0	0
4	77390083	.	A	T	2	2	4	0	1	5	0	0
4	77390164	.	G	T	2	2	4	0	0	4	0	0
4	77390174	.	C	T	1	2	3	0	1	4	0	0
4	77390254	.	T	G	1	3	4	0	0	4	0	0
4	77390288	.	A	C	1	4	5	0	0	5	0	0
4	77390314	.	A	G	0	4	4	0	0	4	0	0
4	77390347	.	G	C	2	4	6	0	0	6	0	0
4	77390400	.	G	A	2	3	5	0	0	5	0	0
4	77928526	.	G	C	1	5	6	0	0	6	0	0
4	77928565	.	T	C	5	11	16	0	0	16	0	0
4	77931408	.	G	A	2	1	3	0	0	3	0	0
4	77932143	.	C	T	9	7	16	0	0	16	0	0
4	77932186	.	T	C	13	13	26	0	2	28	0	0
4	77932198	.	A	G	10	17	27	0	3	30	0	0
4	77932221	.	A	G	6	18	24	0	2	26	0	0
4	77932408	.	G	C	11	10	21	0	3	24	0	0
4	77932414	.	T	C	11	10	21	0	2	23	0	0
4	77959109	.	T	C	2	3	5	0	0	5	0	0
4	77960215	.	T	A	0	4	4	0	0	4	0	0
4	77963270	.	A	G	1	2	3	0	0	3	0	0
4	77963819	.	C	T	3	3	6	0	0	6	0	0
4	77964574	.	C	A	8	11	19	0	0	19	0	0
4	77964609	.	G	A	0	5	5	0	6	11	0	0
4	77967545	.	C	T	1	3	4	0	0	4	0	0
4	77967578	.	G	C	1	5	6	0	0	6	0	0
4	77968472	.	C	T	1	4	5	0	1	6	0	0
4	77974552	.	C	G	1	2	3	0	0	3	0	0
4	77974573	.	C	T	1	3	4	0	0	4	0	0
4	77974587	.	C	G	1	3	4	0	0	4	0	0
4	77975404	.	C	G	0	2	2	0	2	4	0	0
4	77993916	.	G	A	8	8	16	0	0	16	0	0
4	77995476	.	T	C	2	8	10	0	1	11	0	0
4	77995941	.	C	T	1	1	2	0	0	2	0	0
4	77995990	.	C	G	4	4	8	0	0	8	0	0
4	77996032	.	C	A	2	1	3	0	0	3	0	0
4	77996171	.	C	T	1	0	1	0	0	1	0	0
4	78022570	.	A	G	5	4	9	0	1	10	0	0
4	78024247	.	A	G	14	15	29	0	0	29	0	0
4	78024558	.	C	T	0	12	12	0	13	25	0	0
4	78025040	.	C	T	11	5	16	0	2	18	0	0
4	78025052	.	T	G	10	5	15	0	1	16	0	0
4	78025223	.	C	T	0	9	9	0	14	23	0	0
5	318077	.	G	A	0	1	1	0	0	1	0	0
5	440106	.	T	C	1	4	5	0	0	5	0	0
5	905263	.	C	A	1	1	2	0	0	2	0	0
5	917336	.	C	T	1	2	3	0	0	3	0	0
5	1055103	.	C	T	1	0	1	0	0	1	0	0
5	1068116	.	T	A	4	4	8	0	0	8	0	0
5	1072981	.	A	G	2	3	5	0	0	5	0	0
5	1079480	.	C	T	0	2	2	0	0	2	0	0
5	1083203	.	G	C	2	6	8	0	0	8	0	0
5	1083283	.	G	T	0	1	1	0	1	2	0	0
5	1083340	.	C	T	1	6	7	0	1	8	0	0
5	1083389	.	C	T	0	3	3	0	1	4	0	0
5	1083679	.	G	A	0	5	5	0	6	11	0	0
5	1205869	.	C	G	1	0	1	0	0	1	0	0
5	1207835	.	C	T	5	10	15	0	2	17	0	0
5	1216536	.	C	T	0	3	3	0	4	7	0	0
5	1218781	.	G	A	2	1	3	0	0	3	0	0
5	1219263	.	C	T	7	5	12	0	0	12	0	0
5	1219318	.	C	A	5	4	9	0	2	11	0	0
5	1219331	.	T	G	6	3	9	0	2	11	0	0
5	1219381	.	G	A	4	5	9	0	2	11	0	0
5	1223368	.	A	T	15	9	24	0	1	25	0	0
5	1223369	.	C	T	15	10	25	0	0	25	0	0
5	1223460	.	G	A	12	6	18	0	2	20	0	0
5	1223487	.	G	T	12	8	20	0	0	20	0	0
5	1311041	.	G	A	0	1	1	0	0	1	0	0
5	1420729	.	A	G	3	5	8	0	0	8	0	0
5	1461953	.	C	T	0	1	1	0	0	1	0	0
5	1519571	.	G	C	2	3	5	0	0	5	0	0
5	1519574	.	T	A	2	2	4	0	0	4	0	0
5	1653920	.	C	T	10	9	19	0	0	19	0	0
5	1653989	.	T	C	4	2	6	0	0	6	0	0
5	1950783	.	G	A	42	38	80	0	3	83	0	0
5	1952857	.	T	C	11	3	14	0	0	14	0	0
5	1952872	.	A	G	16	9	25	0	3	28	0	0
5	1952940	.	A	G	36	38	74	0	2	76	0	0
5	1953019	.	C	A	13	6	19	0	1	20	0	0
5	1955757	.	G	A	22	27	49	0	1	50	0	0
5	1957996	.	G	A	10	23	33	0	4	37	0	0
5	1958120	.	T	A	3	11	14	0	1	15	0	0
5	1962010	.	G	A	7	5	12	0	1	13	0	0
5	1990040	.	A	C	1	3	4	0	1	5	0	0
5	1997902	.	A	G	17	6	23	0	0	23	0	0
5	1997957	.	A	G	25	9	34	0	1	35	0	0
5	1997958	.	G	A	25	9	34	0	1	35	0	0
5	1998153	.	A	T	1	3	4	0	0	4	0	0
5	1998863	.	C	T	2	2	4	0	0	4	0	0
5	1999199	.	G	A	15	17	32	0	0	32	0	0
5	1999289	.	C	T	7	21	28	0	2	30	0	0
5	1999419	.	T	C	3	2	5	0	0	5	0	0
5	2047132	.	A	C	2	3	5	0	2	7	0	0
5	2047372	.	G	T	0	9	9	0	5	14	0	0
5	2067504	.	C	T	3	5	8	0	0	8	0	0
5	2067557	.	T	C	2	1	3	0	4	7	0	0
5	2067597	.	T	G	4	2	6	0	1	7	0	0
5	2067621	.	G	A	3	5	8	0	0	8	0	0
5	2067714	.	T	A	2	1	3	0	0	3	0	0
5	2067718	.	T	G	0	2	2	0	0	2	0	0
5	2067781	.	G	A	1	3	4	0	0	5	1	0
5	2067832	.	C	T	3	2	5	0	1	6	0	0
5	2067842	.	T	A	2	3	5	0	1	6	0	0
5	2068180	.	G	T	2	2	4	0	0	4	0	0
5	2068183	.	A	G	2	2	4	0	0	4	0	0
5	2068318	.	G	T	1	1	2	0	0	3	1	0
5	2068959	.	A	T	9	3	12	0	6	18	0	0
5	2410610	.	G	A	3	3	6	0	0	6	0	0
5	2413134	.	G	A	2	7	9	0	0	9	0	0
5	2419100	.	G	A	0	2	2	0	0	2	0	0
5	2451222	.	G	A	1	2	3	0	0	3	0	0
5	2451276	.	C	T	0	1	1	0	0	1	0	0
5	2454780	.	C	G	2	2	4	0	0	4	0	0
5	2454791	.	C	T	2	2	4	0	0	4	0	0
5	2709533	.	A	G	1	3	4	0	0	4	0	0
5	2713967	.	A	G	19	24	43	0	4	47	0	0
5	2714042	.	C	T	19	23	42	0	1	43	0	0
5	2714135	.	C	T	25	26	51	0	2	53	0	0
5	2714237	.	G	A	28	19	47	0	3	50	0	0
5	2714495	.	G	A	22	13	35	0	6	41	0	0
5	2714507	.	A	G	27	14	41	0	2	43	0	0
5	2716930	.	G	A	8	4	12	0	0	12	0	0
5	2716963	.	G	A	8	5	13	0	0	13	0	0
5	2717014	.	G	A	6	9	15	0	2	17	0	0
5	2717022	.	G	A	7	9	16	0	1	17	0	0
5	2717260	.	T	C	3	0	3	0	0	3	0	0
5	2717611	.	C	T	3	1	4	0	0	4	0	0
5	2717623	.	A	G	0	0	0	0	1	1	0	0
5	2717960	.	A	G	3	0	3	0	0	3	0	0
5	2742577	.	G	A	2	2	4	0	0	4	0	0
5	3118842	.	A	G	7	5	12	0	1	13	0	0
5	3127488	.	T	A	3	3	6	0	0	6	0	0
5	3362996	.	G	A	1	4	5	0	0	5	0	0
5	3363014	.	C	T	1	4	5	0	1	6	0	0
5	3501954	.	C	A	6	9	15	0	1	16	0	0
5	3544098	.	C	T	2	4	6	0	0	6	0	0
5	3544380	.	C	T	18	16	34	0	2	36	0	0
5	3544955	.	T	C	8	15	23	0	4	27	0	0
5	3545011	.	T	A	14	13	27	0	3	30	0	0
5	3568363	.	G	C	7	1	8	0	1	9	0	0
5	3568386	.	C	T	0	2	2	0	2	6	2	0
5	3568401	.	G	A	2	3	5	0	2	7	0	0
5	3568494	.	C	T	4	11	15	0	1	16	0	0
5	3568518	.	G	T	4	6	10	0	0	10	0	0
5	3898074	.	G	A	1	2	3	0	0	3	0	0
5	3906272	.	C	T	1	4	5	0	0	5	0	0
5	3914668	.	C	T	20	11	31	0	1	32	0	0
5	3914701	.	G	A	9	7	16	0	1	17	0	0
5	4037469	.	C	T	5	2	7	0	0	7	0	0
5	4040153	.	G	A	3	4	7	0	0	7	0	0
5	4041671	.	C	A	1	9	10	0	0	10	0	0
5	4048760	.	A	G	5	18	23	0	0	23	0	0
5	4048820	.	C	T	2	6	8	0	0	8	0	0
5	4051551	.	C	T	4	2	6	0	0	6	0	0
5	4254061	.	C	T	0	9	9	0	15	24	0	0
5	4260672	.	G	A	9	10	19	0	1	20	0	0
5	4263154	.	G	C	4	3	7	0	1	8	0	0
5	4263241	.	G	T	17	19	36	0	1	37	0	0
5	4263297	.	G	T	4	14	18	0	2	20	0	0
5	4263322	.	C	T	1	5	6	0	0	6	0	0
5	4265441	.	G	A	9	6	15	0	2	17	0	0
5	4265468	.	C	T	0	8	8	0	5	13	0	0
5	4269325	.	G	T	2	4	6	0	0	6	0	0
5	4273144	.	T	C	3	2	5	0	0	5	0	0
5	4273159	.	T	C	6	2	8	0	0	8	0	0
5	4273216	.	G	A	8	8	16	0	0	16	0	0
5	4278433	.	G	A	7	4	11	0	0	11	0	0
5	4308861	.	G	A	1	0	1	0	0	1	0	0
5	4373684	.	C	T	9	10	19	0	0	19	0	0
5	4373701	.	G	T	2	10	12	0	4	16	0	0
5	4387137	.	T	G	2	1	3	0	0	3	0	0
5	4482992	.	G	A	1	1	2	0	0	2	0	0
5	4493427	.	C	G	0	3	3	0	3	6	0	0
5	5708595	.	C	G	3	5	8	0	0	8	0	0
5	5720021	.	G	A	1	3	4	0	0	4	0	0
5	5731919	.	C	T	1	2	3	0	0	3	0	0
5	6858540	.	T	A	16	7	23	0	2	25	0	0
5	6858779	.	G	T	0	6	6	0	12	18	0	0
5	6863577	.	C	T	8	8	16	0	0	16	0	0
5	6863647	.	C	T	17	20	37	0	5	42	0	0
5	6863768	.	G	C	9	25	34	0	2	37	1	0
5	6863793	.	G	A	23	13	36	0	3	39	0	0
5	6863855	.	G	A	9	14	23	0	0	23	0	0
5	6863912	.	A	C	12	7	19	0	2	21	0	0
5	6864010	.	C	T	3	12	15	0	1	16	0	0
5	8015165	.	G	A	1	7	8	0	0	8	0	0
5	10766286	.	G	A	11	14	25	0	1	26	0	0
5	10766505	.	A	G	10	14	24	0	1	25	0	0
5	10766529	.	G	A	14	10	24	0	1	25	0	0
5	10766879	.	A	G	7	4	11	0	3	14	0	0
5	10767113	.	C	T	6	13	19	0	2	21	0	0
5	10767259	.	A	G	12	11	23	0	0	23	0	0
5	11836437	.	T	C	3	2	5	0	0	5	0	0
5	11864255	.	A	T	1	2	3	0	1	4	0	0
5	11864258	.	G	C	1	2	3	0	0	3	0	0
5	11864323	.	T	C	0	2	2	0	1	3	0	0
5	11864572	.	C	G	3	2	5	0	0	5	0	0
5	11864593	.	A	G	5	4	9	0	0	9	0	0
5	11864774	.	T	G	9	6	15	0	1	16	0	0
5	11869576	.	C	A	0	4	4	0	2	6	0	0
5	11917125	.	C	T	8	9	17	0	2	19	0	0
5	11917405	.	G	A	8	4	12	0	2	14	0	0
5	11917436	.	G	A	2	9	11	0	0	11	0	0
5	11917485	.	G	A	7	5	12	0	0	12	0	0
5	11917596	.	C	A	0	12	12	0	8	20	0	0
5	11933155	.	A	G	4	5	9	0	0	9	0	0
5	11949244	.	G	T	2	6	8	0	2	10	0	0
5	11959776	.	G	T	0	14	14	0	13	27	0	0
5	11959777	.	C	T	12	13	25	0	2	27	0	0
5	11959818	.	C	T	18	14	32	0	1	33	0	0
5	11959966	.	C	G	17	8	25	0	1	26	0	0
5	11959988	.	G	A	0	17	17	0	11	28	0	0
5	11982950	.	C	A	4	4	8	0	0	8	0	0
5	11983017	.	T	C	4	4	8	0	0	8	0	0
5	11983085	.	C	T	0	2	2	0	3	5	0	0
5	11983395	.	T	A	2	2	4	0	0	4	0	0
5	11983548	.	C	G	5	3	8	0	2	10	0	0
5	11984020	.	G	A	1	2	3	0	0	3	0	0
5	11984086	.	T	C	1	3	4	1	0	5	0	0
5	12284075	.	C	T	18	12	30	0	2	33	1	0
5	12288511	.	T	C	2	2	4	0	2	6	0	0
5	12288541	.	A	G	1	3	4	0	0	4	0	0
5	12322321	.	G	A	1	0	1	0	0	1	0	0
5	12549258	.	C	T	4	4	8	0	2	10	0	0
5	12549326	.	C	T	5	5	10	0	0	10	0	0
5	12724121	.	C	T	11	12	23	0	4	27	0	0
5	12724224	.	G	A	14	11	25	0	0	25	0	0
5	12724249	.	A	C	9	8	17	0	1	18	0	0
5	12724292	.	C	A	8	3	11	0	1	12	0	0
5	12724307	.	A	G	2	7	9	1	2	12	0	0
5	12724412	.	A	G	2	0	2	0	0	2	0	0
5	12724450	.	C	T	1	3	4	0	3	7	0	0
5	12724505	.	C	A	3	8	11	0	0	11	0	0
5	12724518	.	G	C	4	0	4	0	9	13	0	0
5	12724567	.	A	G	7	14	21	0	0	21	0	0
5	12724694	.	C	T	1	10	11	0	9	20	0	0
5	12725930	.	G	A	2	5	7	0	0	7	0	0
5	12726842	.	A	G	0	5	5	0	0	5	0	0
5	12729397	.	C	T	1	1	2	0	0	2	0	0
5	12734883	.	G	T	1	2	3	0	0	3	0	0
5	12734910	.	T	C	1	2	3	0	0	3	0	0
5	12802341	.	A	T	1	2	3	0	0	3	0	0
5	12802353	.	G	T	1	2	3	0	0	3	0	0
5	12837064	.	G	A	1	3	4	0	0	4	0	0
5	12859258	.	T	C	10	8	18	0	4	22	0	0
5	12905911	.	A	C	1	2	3	0	0	3	0	0
5	12906273	.	C	T	1	5	6	0	0	6	0	0
5	12956918	.	T	C	1	0	1	0	0	1	0	0
5	12956960	.	C	T	0	1	1	0	0	1	0	0
5	12975532	.	C	T	0	2	2	0	0	2	0	0
5	12979889	.	C	T	1	6	7	0	0	7	0	0
5	13105020	.	C	T	3	8	11	0	2	13	0	0
5	13105070	.	C	A	0	6	6	0	5	11	0	0
5	13212448	.	G	A	1	2	3	0	0	3	0	0
5	13308959	.	G	A	3	3	6	0	0	6	0	0
5	13308985	.	T	C	1	4	5	0	1	6	0	0
5	13308997	.	G	T	2	6	8	0	0	8	0	0
5	13309215	.	C	T	5	5	10	0	0	10	0	0
5	13309273	.	C	T	5	12	17	0	0	17	0	0
5	13309309	.	G	A	7	10	17	0	1	18	0	0
5	13309402	.	A	G	6	8	14	0	0	14	0	0
5	13309435	.	A	T	4	10	14	0	0	14	0	0
5	13309522	.	G	A	7	5	12	0	0	12	0	0
5	13312671	.	A	T	1	0	1	0	0	1	0	0
5	13312746	.	G	A	4	6	10	0	0	10	0	0
5	13315490	.	G	C	0	3	3	0	0	3	0	0
5	13315526	.	T	C	1	3	4	0	0	4	0	0
5	13335333	.	G	A	0	2	2	0	0	2	0	0
5	13337803	.	C	T	10	18	28	0	1	29	0	0
5	13337883	.	T	A	14	25	39	0	2	41	0	0
5	13338441	.	C	T	0	18	18	0	15	33	0	0
5	13338762	.	A	T	11	7	18	0	0	18	0	0
5	13339038	.	G	C	12	10	22	0	7	29	0	0
5	13419418	.	T	C	0	1	1	0	0	1	0	0
5	13465095	.	T	C	2	1	3	0	0	3	0	0
5	13468108	.	G	T	0	4	4	0	1	5	0	0
5	13468574	.	G	A	2	1	3	0	1	4	0	0
5	13468655	.	G	A	3	4	7	0	0	7	0	0
5	13468656	.	A	T	3	4	7	0	0	7	0	0
5	13469105	.	T	A	3	2	5	0	0	5	0	0
5	13469137	.	C	A	2	5	7	0	0	7	0	0
5	13643325	.	G	A	31	10	41	0	0	41	0	0
5	13643411	.	C	T	0	27	27	0	28	55	0	0
5	13643824	.	G	A	9	8	17	0	0	17	0	0
5	13644126	.	A	T	21	18	39	0	0	39	0	0
5	13644185	.	T	G	11	14	25	0	0	25	0	0
5	13644189	.	T	G	10	11	21	0	3	24	0	0
5	13644227	.	A	G	6	11	17	0	2	19	0	0
5	13644256	.	A	T	9	4	13	0	2	15	0	0
5	13644581	.	T	G	13	3	16	0	7	24	1	0
5	13644602	.	T	A	17	5	22	0	1	23	0	0
5	13644781	.	C	T	6	3	9	0	0	9	0	0
5	13644797	.	A	G	3	5	8	0	0	8	0	0
5	13645047	.	C	G	5	6	11	0	1	12	0	0
5	13645746	.	A	G	5	3	8	0	3	11	0	0
5	13645885	.	T	C	5	4	9	0	0	9	0	0
5	13649518	.	C	T	4	6	10	0	0	10	0	0
5	13671899	.	C	G	2	8	10	0	1	11	0	0
5	13672004	.	C	T	0	11	11	0	6	17	0	0
5	13672211	.	C	T	8	10	18	0	0	18	0	0
5	13672232	.	C	T	5	9	14	0	2	16	0	0
5	13673016	.	C	G	0	4	4	0	3	7	0	0
5	13684502	.	C	A	4	5	9	0	1	10	0	0
5	13684983	.	G	T	2	3	5	0	0	5	0	0
5	14309820	.	T	C	4	2	6	0	0	6	0	0
5	15356919	.	A	G	3	0	3	0	17	20	0	0
5	15356934	.	A	G	10	11	21	0	1	22	0	0
5	15357517	.	A	G	3	4	7	0	1	8	0	0
5	17751119	.	G	A	1	2	3	0	1	4	0	0
5	17751681	.	G	A	0	3	3	0	3	6	0	0
5	17752702	.	C	T	3	8	11	0	1	12	0	0
5	17753529	.	A	T	12	19	31	0	2	33	0	0
5	18913004	.	T	C	2	2	4	0	0	4	0	0
5	18913313	.	G	C	6	6	12	0	1	13	0	0
5	18913480	.	C	A	0	1	1	0	3	4	0	0
5	18913580	.	C	T	5	3	8	0	0	8	0	0
5	18913587	.	T	G	3	2	5	0	2	7	0	0
5	18913772	.	T	A	3	4	7	0	0	7	0	0
5	18913792	.	T	A	2	1	3	0	0	3	0	0
5	18914639	.	G	T	0	2	2	0	0	2	0	0
5	18914661	.	T	C	1	3	4	0	0	4	0	0
5	18925680	.	G	A	0	2	2	0	1	3	0	0
5	18927356	.	G	A	2	0	2	0	0	2	0	0
5	18927381	.	G	A	0	2	2	0	1	3	0	0
5	18927412	.	A	C	0	2	2	0	1	3	0	0
5	18934879	.	C	T	9	3	12	0	0	12	0	0
5	18935168	.	A	G	4	5	9	0	0	9	0	0
5	18935217	.	C	G	1	2	3	0	0	3	0	0
5	18935317	.	G	A	0	9	9	0	0	9	0	0
5	18935327	.	G	A	1	7	8	0	0	8	0	0
5	18935437	.	G	T	8	5	13	0	0	13	0	0
5	18935553	.	A	T	3	2	5	0	0	5	0	0
5	18935752	.	C	T	5	3	8	0	0	8	0	0
5	18935832	.	G	A	0	5	5	0	8	13	0	0
5	18936157	.	A	G	0	6	6	0	0	6	0	0
5	18965845	.	G	A	3	3	6	0	1	7	0	0
5	18970983	.	G	A	1	2	3	0	0	3	0	0
5	19007201	.	G	A	5	8	13	0	0	13	0	0
5	19007282	.	C	T	9	3	12	0	0	12	0	0
5	19007306	.	A	G	2	5	7	0	1	8	0	0
5	19007355	.	C	T	2	2	4	0	0	4	0	0
5	19007374	.	T	A	3	2	5	0	0	5	0	0
5	19007392	.	G	A	4	3	7	0	0	7	0	0
5	19007452	.	T	A	11	6	17	0	1	18	0	0
5	19007498	.	C	T	10	11	21	0	2	23	0	0
5	19007606	.	G	A	8	12	20	0	0	20	0	0
5	19007686	.	C	T	6	6	12	0	0	12	0	0
5	19007702	.	C	T	8	6	14	0	1	15	0	0
5	19007760	.	G	A	8	5	13	0	0	13	0	0
5	19008334	.	A	G	21	1	22	0	8	30	0	0
5	19008335	.	A	G	19	7	26	0	4	30	0	0
5	19008379	.	G	A	15	17	32	0	0	32	0	0
5	19021922	.	C	T	0	5	5	0	0	5	0	0
5	19022146	.	T	C	13	11	24	0	1	25	0	0
5	19022250	.	C	T	13	14	27	0	2	29	0	0
5	19031187	.	G	C	0	2	2	0	0	2	0	0
5	19035299	.	T	C	4	2	6	0	0	6	0	0
5	19313268	.	T	C	1	2	3	0	0	3	0	0
5	19325641	.	G	T	3	6	9	0	0	9	0	0
5	19326549	.	G	C	2	2	4	0	1	5	0	0
5	19327072	.	G	C	9	8	17	0	2	19	0	0
5	19327221	.	G	A	10	10	20	0	0	20	0	0
5	19327700	.	A	T	10	5	15	0	1	16	0	0
5	19327815	.	T	A	5	7	12	0	0	12	0	0
5	19327979	.	G	T	3	3	6	0	0	6	0	0
5	19328135	.	G	A	16	18	34	0	2	37	1	0
5	19328216	.	A	G	11	14	25	0	3	28	0	0
5	19386084	.	C	T	1	2	3	0	1	4	0	0
5	19436667	.	T	C	8	0	8	0	7	15	0	0
5	19436677	.	G	A	7	6	13	0	0	13	0	0
5	19436704	.	C	G	3	7	10	0	0	10	0	0
5	19437002	.	C	G	5	9	14	0	0	14	0	0
5	19437013	.	A	T	5	8	13	0	1	14	0	0
5	19437213	.	G	A	5	6	11	0	2	13	0	0
5	19437253	.	G	A	5	9	14	0	0	14	0	0
5	19437608	.	G	A	4	2	6	0	0	6	0	0
5	19437640	.	T	C	6	2	8	0	0	8	0	0
5	19437678	.	T	A	3	2	5	0	0	5	0	0
5	19438084	.	C	T	0	2	2	0	4	6	0	0
5	19438458	.	G	T	4	2	6	0	0	6	0	0
5	19438954	.	A	T	1	3	4	0	0	4	0	0
5	19439468	.	C	T	0	2	2	0	0	2	0	0
5	19489821	.	C	A	4	2	6	0	0	6	0	0
5	19492344	.	G	A	2	0	2	0	0	2	0	0
5	19962154	.	T	C	3	8	11	0	0	11	0	0
5	19962284	.	A	T	9	11	20	0	0	20	0	0
5	19962349	.	A	T	4	4	8	0	0	8	0	0
5	19962395	.	C	T	0	3	3	0	0	3	0	0
5	19962527	.	G	T	2	7	9	0	1	10	0	0
5	19962590	.	C	A	7	13	20	0	0	20	0	0
5	19962721	.	T	A	6	17	23	0	0	23	0	0
5	19962959	.	G	T	5	8	13	0	0	13	0	0
5	19963023	.	A	G	6	15	21	0	2	23	0	0
5	19963065	.	A	T	5	13	18	0	0	18	0	0
5	20103255	.	C	A	5	2	7	0	0	7	0	0
5	20103410	.	G	A	2	2	4	0	1	5	0	0
5	20103416	.	T	A	2	1	3	0	1	4	0	0
5	20105039	.	A	G	1	3	4	0	0	4	0	0
5	20108008	.	C	G	3	3	6	0	0	6	0	0
5	20108424	.	A	C	1	2	3	0	0	3	0	0
5	20112853	.	T	C	1	3	4	0	0	4	0	0
5	20125939	.	T	A	5	2	7	0	0	7	0	0
5	20170985	.	T	C	7	12	19	0	3	22	0	0
5	20171088	.	G	C	2	4	6	0	0	6	0	0
5	20197881	.	G	T	0	2	2	0	0	2	0	0
5	20787190	.	T	C	4	5	9	0	1	10	0	0
5	20933332	.	T	C	0	0	0	0	28	28	0	0
5	21295883	.	G	A	5	9	14	0	2	16	0	0
5	21296298	.	C	G	1	3	4	0	0	4	0	0
5	21296527	.	A	G	3	9	12	0	0	12	0	0
5	21296693	.	G	T	5	6	11	0	0	11	0	0
5	21296720	.	T	A	1	2	3	0	0	3	0	0
5	21297188	.	A	T	3	1	4	0	1	5	0	0
5	22012345	.	T	C	2	3	5	0	0	5	0	0
5	22012452	.	T	C	4	4	8	0	0	8	0	0
5	22012459	.	T	C	2	6	8	0	0	8	0	0
5	22013658	.	G	A	5	2	7	0	0	7	0	0
5	22013913	.	C	T	0	2	2	0	0	2	0	0
5	22021447	.	A	T	3	3	6	0	0	6	0	0
5	22021509	.	A	T	1	2	3	0	0	3	0	0
5	22073989	.	A	T	22	17	39	0	5	44	0	0
5	22074040	.	C	T	16	14	30	0	6	36	0	0
5	22074118	.	A	T	14	21	35	0	0	35	0	0
5	22074132	.	T	C	11	19	30	0	1	31	0	0
5	22074376	.	C	T	0	20	20	0	17	37	0	0
5	22074407	.	C	T	8	20	28	0	3	31	0	0
5	22115256	.	G	A	5	6	11	0	0	11	0	0
5	22115277	.	A	G	8	3	11	0	0	11	0	0
5	22115319	.	C	T	9	3	12	0	1	13	0	0
5	22115579	.	A	G	3	6	9	0	0	9	0	0
5	22121467	.	G	A	2	8	10	0	1	11	0	0
5	22173409	.	G	A	2	8	10	0	0	10	0	0
5	22173691	.	T	A	2	12	14	0	1	15	0	0
5	22173875	.	T	G	9	0	9	0	11	20	0	0
5	22173999	.	C	T	6	9	15	0	4	19	0	0
5	22465206	.	A	G	1	2	3	0	0	3	0	0
5	22473746	.	C	T	1	2	3	0	1	4	0	0
5	22489369	.	A	G	1	1	2	0	1	3	0	0
5	22489390	.	G	A	1	2	3	0	0	3	0	0
5	22550983	.	G	A	14	16	30	0	0	30	0	0
5	22550990	.	A	G	16	16	32	0	0	32	0	0
5	22560446	.	G	A	2	1	3	0	0	3	0	0
5	22562118	.	A	G	3	3	6	0	0	6	0	0
5	22562154	.	T	C	4	0	4	0	4	8	0	0
5	22562177	.	T	A	7	3	10	0	0	10	0	0
5	22593801	.	A	G	11	8	19	0	1	20	0	0
5	22593877	.	G	A	12	24	36	0	1	37	0	0
5	22593882	.	T	A	12	23	35	0	3	38	0	0
5	22593930	.	A	G	24	21	45	0	1	46	0	0
5	22596067	.	T	C	4	12	16	0	1	17	0	0
5	22683531	.	C	T	10	14	24	0	1	25	0	0
5	22683556	.	G	A	10	14	24	0	3	27	0	0
5	22683732	.	G	T	19	16	35	0	1	36	0	0
5	22683836	.	G	A	10	25	35	0	1	36	0	0
5	22852200	.	C	T	10	7	17	0	0	17	0	0
5	22852263	.	G	A	1	3	4	0	1	5	0	0
5	22856713	.	C	T	1	0	1	0	1	2	0	0
5	22856939	.	T	G	4	4	8	0	1	9	0	0
5	22857069	.	T	G	4	2	6	0	1	7	0	0
5	22872067	.	A	C	18	17	35	1	1	37	0	0
5	22872627	.	A	T	12	12	24	0	3	27	0	0
5	22876443	.	T	A	1	0	1	0	0	1	0	0
5	22888231	.	G	A	1	2	3	0	0	3	0	0
5	22971270	.	G	A	0	2	2	0	2	4	0	0
5	22971463	.	T	C	9	9	18	0	1	19	0	0
5	22972573	.	A	G	25	29	54	0	5	59	0	0
5	22972597	.	A	C	22	23	45	0	7	52	0	0
5	23026604	.	G	A	6	5	11	0	0	11	0	0
5	23027642	.	A	C	11	10	21	0	2	23	0	0
5	23027770	.	T	C	8	19	27	0	1	28	0	0
5	23027937	.	C	T	21	18	39	0	1	40	0	0
5	23028131	.	C	A	12	6	18	0	1	19	0	0
5	23056697	.	A	G	1	3	4	0	0	4	0	0
5	23082721	.	C	T	3	7	10	0	0	10	0	0
5	23082845	.	G	A	3	6	9	0	1	10	0	0
5	23082847	.	T	A	3	7	10	0	0	10	0	0
5	23107927	.	C	T	10	8	18	0	1	19	0	0
5	23108019	.	G	A	8	12	20	0	3	23	0	0
5	23108042	.	T	A	11	14	25	0	1	26	0	0
5	23108128	.	G	A	16	21	37	0	1	38	0	0
5	23110281	.	A	G	4	8	12	0	0	12	0	0
5	23110311	.	C	T	1	3	4	0	1	5	0	0
5	23127418	.	C	T	3	3	6	0	2	8	0	0
5	23127451	.	A	G	4	3	7	0	0	7	0	0
5	23128135	.	T	C	0	1	1	0	1	2	0	0
5	23128651	.	A	C	2	2	4	0	1	5	0	0
5	23129161	.	C	T	5	4	9	0	0	9	0	0
5	23129902	.	G	T	2	5	7	0	0	7	0	0
5	23130629	.	T	C	6	6	12	0	0	12	0	0
5	23130970	.	C	T	13	6	19	0	0	19	0	0
5	23131106	.	G	C	11	14	25	0	1	26	0	0
5	23131147	.	T	C	10	17	27	0	1	28	0	0
5	23136584	.	T	C	0	2	2	0	0	2	0	0
5	23136635	.	G	A	2	4	6	0	0	6	0	0
5	23140527	.	T	G	2	1	3	0	0	3	0	0
5	23140548	.	A	G	0	0	0	0	1	1	0	0
5	23143755	.	C	T	6	5	11	0	0	11	0	0
5	23146414	.	T	C	0	7	7	0	0	7	0	0
5	23146537	.	G	A	0	9	9	0	8	17	0	0
5	23146576	.	T	A	4	12	16	0	1	17	0	0
5	23146790	.	G	T	10	15	25	0	1	26	0	0
5	23146897	.	T	G	2	3	5	0	1	6	0	0
5	23147007	.	A	T	2	2	4	0	0	4	0	0
5	23147008	.	T	A	2	2	4	0	0	4	0	0
5	23147118	.	C	A	3	4	7	0	0	7	0	0
5	23147127	.	T	C	3	4	7	0	2	9	0	0
5	23147185	.	T	A	7	8	15	0	0	15	0	0
5	23147479	.	C	G	11	20	31	0	0	31	0	0
5	23230692	.	C	T	1	2	3	0	2	5	0	0
5	23230950	.	T	C	3	2	5	0	0	5	0	0
5	23230966	.	T	A	3	2	5	0	1	6	0	0
5	23231042	.	A	G	5	4	9	0	0	9	0	0
5	23231125	.	C	A	4	3	7	0	0	7	0	0
5	23268370	.	A	C	33	29	62	0	1	63	0	0
5	23268371	.	C	A	33	28	61	0	2	63	0	0
5	23268542	.	T	G	28	36	64	0	10	75	1	0
5	23268785	.	C	G	31	44	75	0	5	80	0	0
5	23272981	.	T	G	0	1	1	0	1	2	0	0
5	23273487	.	G	A	6	11	17	0	4	21	0	0
5	23275945	.	G	A	1	0	1	0	0	1	0	0
5	23276037	.	G	A	9	6	15	0	0	15	0	0
5	23277139	.	G	A	6	4	10	0	0	10	0	0
5	23277816	.	C	A	3	3	6	0	0	6	0	0
5	23284014	.	T	C	18	15	33	0	5	38	0	0
5	23284867	.	A	G	2	5	7	0	1	8	0	0
5	23285133	.	T	C	10	9	19	0	0	19	0	0
5	23285206	.	G	A	6	6	12	0	0	12	0	0
5	23285546	.	A	G	9	15	24	0	1	25	0	0
5	23285554	.	A	G	13	15	28	0	0	28	0	0
5	23285611	.	G	A	12	21	33	0	0	33	0	0
5	23286004	.	A	G	4	5	9	0	1	10	0	0
5	23286376	.	G	A	4	3	7	0	0	7	0	0
5	23353648	.	A	G	14	23	37	0	1	38	0	0
5	23389025	.	C	T	0	5	5	0	2	7	0	0
5	23389190	.	A	G	4	4	8	0	0	8	0	0
5	23389268	.	G	A	1	2	3	0	0	3	0	0
5	24130706	.	T	C	2	2	4	0	0	4	0	0
5	24130715	.	C	T	2	3	5	0	0	5	0	0
5	24130809	.	C	T	1	5	6	0	1	7	0	0
5	24131320	.	A	C	1	3	4	0	0	4	0	0
5	24131611	.	A	G	9	6	15	0	0	15	0	0
5	24132457	.	G	A	2	5	7	0	0	7	0	0
5	24132615	.	T	C	5	4	9	0	0	9	0	0
5	24133732	.	G	A	0	11	11	0	4	15	0	0
5	24134952	.	A	T	3	0	3	0	0	3	0	0
5	24134997	.	A	T	9	7	16	0	2	18	0	0
5	24135361	.	G	T	0	22	22	0	21	43	0	0
5	24138964	.	G	A	4	7	11	0	0	11	0	0
5	24147460	.	C	T	1	0	1	0	0	1	0	0
5	24147508	.	C	G	7	7	14	0	0	14	0	0
5	24147529	.	A	G	9	6	15	0	1	16	0	0
5	24153253	.	G	C	2	4	6	0	0	6	0	0
5	24153289	.	T	C	2	0	2	0	5	7	0	0
5	24153331	.	T	C	3	0	3	0	6	9	0	0
5	24153403	.	C	T	4	3	7	0	0	7	0	0
5	24153441	.	T	C	5	2	7	0	1	8	0	0
5	24153523	.	T	G	1	2	3	0	0	3	0	0
5	24153524	.	C	T	0	2	2	0	1	3	0	0
5	24153887	.	C	T	0	1	1	0	0	1	0	0
5	24162191	.	T	G	1	3	4	0	0	4	0	0
5	24163000	.	T	A	1	3	4	0	0	4	0	0
5	24163143	.	A	C	1	2	3	0	0	3	0	0
5	24184988	.	A	T	1	2	3	0	0	3	0	0
5	24185470	.	C	A	2	2	4	0	0	4	0	0
5	24199739	.	T	C	8	8	16	1	0	17	0	0
5	24199757	.	T	A	6	9	15	1	1	17	0	0
5	24199987	.	C	A	2	2	4	0	1	5	0	0
5	24200017	.	C	A	2	3	5	0	0	5	0	0
5	24200259	.	T	C	1	2	3	0	0	3	0	0
5	24200592	.	G	A	2	3	5	0	0	5	0	0
5	24200611	.	G	A	1	4	5	0	0	5	0	0
5	24208781	.	G	C	37	26	63	0	2	65	0	0
5	24208900	.	G	C	15	0	15	0	27	42	0	0
5	24209088	.	C	T	10	21	31	0	2	33	0	0
5	24209293	.	A	T	27	15	42	0	2	44	0	0
5	24209460	.	A	G	25	19	44	0	6	50	0	0
5	24213273	.	T	G	12	13	25	0	0	25	0	0
5	24221540	.	G	A	1	1	2	0	0	2	0	0
5	24240866	.	C	T	1	1	2	0	0	2	0	0
5	24252744	.	A	G	1	1	2	0	0	2	0	0
5	24256387	.	G	A	3	10	13	0	1	14	0	0
5	24259980	.	T	G	6	6	12	0	1	13	0	0
5	24330025	.	A	G	3	2	5	0	0	5	0	0
5	24330493	.	A	G	9	3	12	0	3	15	0	0
5	24330527	.	T	C	2	0	2	0	9	11	0	0
5	24330840	.	G	T	3	3	6	0	0	6	0	0
5	24330932	.	C	A	3	6	9	0	0	9	0	0
5	24331724	.	G	C	1	1	2	0	0	2	0	0
5	24511111	.	C	T	0	14	14	0	23	37	0	0
5	24513193	.	G	A	0	1	1	0	0	1	0	0
5	24521812	.	G	A	2	3	5	0	0	5	0	0
5	24522206	.	A	T	6	9	15	0	0	15	0	0
5	24530663	.	A	T	8	11	19	0	0	19	0	0
5	24530853	.	C	T	5	4	9	0	2	11	0	0
5	24531370	.	C	T	10	8	18	0	9	27	0	0
5	24531538	.	T	G	10	10	20	0	1	21	0	0
5	24531854	.	A	T	1	1	2	0	0	2	0	0
5	24534303	.	T	C	2	1	3	0	0	3	0	0
5	24535421	.	G	T	1	2	3	0	0	3	0	0
5	24566917	.	A	G	2	3	5	0	0	5	0	0
5	24567269	.	A	T	6	4	10	0	0	10	0	0
5	24567297	.	C	T	4	7	11	0	2	13	0	0
5	24567351	.	G	A	0	4	4	0	5	9	0	0
5	24567460	.	C	A	2	2	4	0	0	4	0	0
5	24567692	.	T	C	2	3	5	0	0	5	0	0
5	24578500	.	C	A	0	1	1	0	0	1	0	0
5	24756844	.	G	A	2	21	23	0	5	28	0	0
5	24756845	.	A	G	11	12	23	0	5	28	0	0
5	24756967	.	A	T	20	13	33	0	3	36	0	0
5	24757494	.	A	C	1	3	4	0	1	5	0	0
5	24757497	.	C	A	1	2	3	0	2	5	0	0
5	24757561	.	A	T	8	5	13	0	0	13	0	0
5	24757656	.	A	G	5	6	11	0	1	12	0	0
5	24757916	.	G	A	5	8	13	0	0	13	0	0
5	24757952	.	A	T	3	4	7	0	2	9	0	0
5	24757976	.	G	A	4	3	7	0	0	7	0	0
5	24758013	.	C	T	0	2	2	0	1	3	0	0
5	24816449	.	C	A	8	8	16	0	0	16	0	0
5	24816854	.	T	A	1	7	8	0	2	10	0	0
5	24817014	.	C	G	10	14	24	0	2	26	0	0
5	24817142	.	A	T	1	4	5	0	0	5	0	0
5	24817445	.	A	G	3	4	7	0	0	7	0	0
5	24817450	.	T	C	4	3	7	0	0	7	0	0
5	24817947	.	C	T	1	2	3	0	0	3	0	0
5	24818523	.	T	C	3	2	5	0	0	5	0	0
5	24875494	.	A	G	10	14	24	2	0	26	0	0
5	24878138	.	C	T	7	3	10	0	0	10	0	0
5	24886066	.	T	C	1	1	2	0	0	2	0	0
5	24887238	.	G	C	1	4	5	0	1	6	0	0
5	24887340	.	C	T	1	2	3	0	3	6	0	0
5	24887472	.	T	G	3	6	9	0	2	11	0	0
5	24887541	.	G	T	4	8	12	0	2	14	0	0
5	24887707	.	C	T	7	4	11	0	1	12	0	0
5	24887828	.	A	G	2	7	9	0	1	10	0	0
5	24887830	.	T	A	2	7	9	0	1	10	0	0
5	25046430	.	C	A	0	4	4	0	0	4	0	0
5	25047223	.	T	C	0	1	1	0	0	1	0	0
5	25047527	.	G	A	2	1	3	0	0	3	0	0
5	25074812	.	C	T	12	4	16	0	0	16	0	0
5	25074917	.	C	T	13	7	20	0	1	21	0	0
5	25075040	.	G	A	5	10	15	0	0	15	0	0
5	25077792	.	G	A	2	6	8	0	1	9	0	0
5	25089174	.	A	G	4	3	7	0	1	8	0	0
5	25089212	.	C	T	0	4	4	0	6	10	0	0
5	25094191	.	G	A	1	0	1	0	0	1	0	0
5	25094203	.	G	T	2	2	4	0	0	4	0	0
5	25100142	.	C	T	3	2	5	0	2	7	0	0
5	25311388	.	T	A	3	3	6	0	0	6	0	0
5	25314181	.	C	G	2	11	13	0	2	15	0	0
5	25314213	.	G	A	7	3	10	0	1	11	0	0
5	25578601	.	T	G	1	4	5	0	0	5	0	0
5	25693550	.	C	A	7	3	10	0	1	11	0	0
5	25693551	.	G	A	3	6	9	0	2	11	0	0
5	25693790	.	T	C	8	16	24	0	0	24	0	0
5	25726755	.	C	T	2	2	4	0	0	4	0	0
5	25726838	.	T	G	1	2	3	0	0	3	0	0
5	25729849	.	A	G	0	1	1	0	0	1	0	0
5	25753265	.	C	A	4	3	7	0	0	7	0	0
5	25754054	.	T	C	2	4	6	0	0	6	0	0
5	25754092	.	T	C	3	5	8	0	0	8	0	0
5	25754913	.	T	C	0	11	11	0	0	11	0	0
5	25755051	.	G	A	1	4	5	0	0	5	0	0
5	25755078	.	T	C	3	2	5	0	0	5	0	0
5	25755123	.	A	T	3	6	9	0	2	11	0	0
5	26077444	.	T	A	0	1	1	0	0	1	0	0
5	26082485	.	G	T	5	8	13	0	0	13	0	0
5	26082537	.	T	A	6	8	14	0	0	14	0	0
5	26092042	.	G	A	0	2	2	0	0	2	0	0
5	26093962	.	A	T	1	4	5	0	1	6	0	0
5	26100912	.	A	T	3	3	6	0	0	6	0	0
5	26101332	.	T	C	3	5	8	0	0	8	0	0
5	26101353	.	C	T	3	5	8	0	1	9	0	0
5	26102115	.	A	G	1	3	4	0	0	4	0	0
5	26135809	.	G	T	1	2	3	0	0	3	0	0
5	26136229	.	G	A	0	2	2	0	0	2	0	0
5	26145378	.	G	T	2	2	4	0	0	4	0	0
5	26145402	.	G	A	0	2	2	0	2	4	0	0
5	26162632	.	G	A	2	3	5	0	0	5	0	0
5	26167933	.	G	A	2	1	3	0	0	3	0	0
5	26168758	.	A	T	1	0	1	0	0	1	0	0
5	26189514	.	C	A	0	2	2	0	3	5	0	0
5	26200679	.	T	G	1	2	3	0	0	3	0	0
5	26202863	.	T	A	9	5	14	0	0	14	0	0
5	26202898	.	T	C	5	5	10	0	0	10	0	0
5	26202914	.	T	A	7	4	11	0	0	11	0	0
5	26203055	.	A	T	3	2	5	0	1	6	0	0
5	26232765	.	G	C	6	2	8	0	0	8	0	0
5	26232790	.	A	T	6	4	10	0	0	10	0	0
5	26232915	.	C	A	4	3	7	0	1	8	0	0
5	26232936	.	C	A	5	4	9	0	0	9	0	0
5	26232952	.	T	A	3	5	8	0	0	8	0	0
5	26234797	.	C	T	1	0	1	0	0	1	0	0
5	26234819	.	C	T	0	0	0	0	1	1	0	0
5	26235156	.	A	G	2	2	4	0	0	4	0	0
5	26263562	.	T	A	20	23	43	0	1	44	0	0
5	26274540	.	C	T	0	1	1	0	4	5	0	0
5	26274582	.	C	T	4	1	5	0	0	5	0	0
5	26281262	.	G	T	1	2	3	0	0	3	0	0
5	26281331	.	T	C	0	0	0	0	1	1	0	0
5	26721601	.	T	C	1	2	3	0	0	3	0	0
5	26721659	.	A	G	1	3	4	0	0	4	0	0
5	26721663	.	A	G	1	3	4	0	0	4	0	0
5	26721966	.	T	G	4	3	7	0	0	7	0	0
5	26722268	.	T	G	6	10	16	0	1	17	0	0
5	26722361	.	T	C	4	4	8	0	0	8	0	0
5	26722434	.	G	A	3	4	7	0	0	7	0	0
5	26756210	.	A	C	1	3	4	0	0	4	0	0
5	26756338	.	C	T	5	3	8	0	0	8	0	0
5	26756560	.	A	G	2	5	7	0	0	7	0	0
5	26787426	.	A	G	6	3	9	0	1	10	0	0
5	26787666	.	A	G	2	3	5	0	1	6	0	0
5	26787668	.	A	G	3	3	6	0	0	6	0	0
5	26789576	.	T	C	2	2	4	0	0	4	0	0
5	26790339	.	T	C	1	2	3	0	0	3	0	0
5	26790342	.	C	A	1	1	2	0	0	2	0	0
5	26805207	.	C	T	2	3	5	0	0	5	0	0
5	26805212	.	A	T	2	3	5	0	0	5	0	0
5	26805636	.	T	C	2	1	3	0	0	3	0	0
5	26805746	.	G	T	1	5	6	0	0	6	0	0
5	26805748	.	C	A	1	4	5	0	1	6	0	0
5	26823191	.	G	A	2	1	3	0	0	3	0	0
5	26823636	.	C	G	2	6	8	0	0	8	0	0
5	26851872	.	G	T	5	3	8	0	0	8	0	0
5	26868223	.	T	C	1	3	4	0	0	4	0	0
5	26868351	.	C	A	2	2	4	0	1	5	0	0
5	26869044	.	G	C	6	13	19	0	0	19	0	0
5	26884770	.	C	T	3	3	6	0	1	7	0	0
5	26884809	.	C	T	6	5	11	0	1	12	0	0
5	26884825	.	A	G	5	5	10	0	0	10	0	0
5	26884957	.	T	C	1	2	3	0	0	3	0	0
5	26885199	.	A	G	4	2	6	0	1	7	0	0
5	26885569	.	T	A	1	2	3	0	0	3	0	0
5	26887993	.	T	C	1	2	3	0	0	3	0	0
5	27424323	.	G	A	0	2	2	0	0	2	0	0
5	27866921	.	G	A	12	8	20	1	2	23	0	0
5	27867129	.	G	A	21	14	35	0	0	35	0	0
5	29491219	.	T	C	5	4	9	0	0	9	0	0
5	29491363	.	A	G	4	4	8	0	0	8	0	0
5	29491467	.	A	T	7	8	15	0	2	17	0	0
5	29549047	.	C	T	4	4	8	0	0	8	0	0
5	29549064	.	G	A	5	5	10	0	0	10	0	0
5	29549090	.	C	T	6	3	9	0	1	10	0	0
5	29549279	.	A	G	9	5	14	0	1	15	0	0
5	29551150	.	A	G	2	1	3	0	2	5	0	0
5	29598008	.	A	G	4	18	22	0	1	23	0	0
5	29598312	.	C	T	0	25	25	0	35	60	0	0
5	29598386	.	A	G	20	19	39	0	7	46	0	0
5	29598425	.	G	A	11	28	39	0	2	41	0	0
5	29598513	.	G	A	16	22	38	0	5	43	0	0
5	29599023	.	A	G	18	22	40	0	2	42	0	0
5	29599236	.	T	C	9	15	24	0	2	26	0	0
5	29599315	.	T	C	14	0	14	0	18	32	0	0
5	29599429	.	A	G	14	21	35	0	2	37	0	0
5	29599754	.	A	T	19	19	38	0	2	40	0	0
5	29599784	.	C	T	19	26	45	0	0	45	0	0
5	29599878	.	A	C	15	12	27	0	1	28	0	0
5	29611084	.	G	A	17	12	29	0	0	29	0	0
5	29614090	.	G	A	2	4	6	0	0	6	0	0
5	29619159	.	T	C	3	3	6	0	0	6	0	0
5	29619464	.	G	T	3	4	7	0	0	7	0	0
5	29619500	.	A	G	2	2	4	0	0	4	0	0
5	29622609	.	A	T	2	2	4	0	0	4	0	0
5	29628856	.	A	T	0	1	1	0	0	1	0	0
5	29663745	.	T	C	1	2	3	0	0	3	0	0
5	29666599	.	T	C	1	1	2	0	0	2	0	0
5	29666947	.	G	C	4	3	7	0	0	7	0	0
5	29667260	.	T	C	4	6	10	0	0	10	0	0
5	29667305	.	G	A	8	6	14	0	0	14	0	0
5	29667470	.	A	C	4	2	6	0	0	6	0	0
5	29668519	.	G	A	5	8	13	0	2	15	0	0
5	29668551	.	G	A	9	9	18	0	0	18	0	0
5	29668570	.	G	A	12	6	18	0	1	19	0	0
5	29668676	.	T	C	14	6	20	0	4	24	0	0
5	29668691	.	G	A	16	6	22	0	0	22	0	0
5	29668754	.	C	T	12	10	22	0	0	22	0	0
5	29668867	.	G	A	15	13	28	0	1	29	0	0
5	29746404	.	T	A	3	8	11	0	1	12	0	0
5	29746419	.	T	C	5	11	16	0	1	17	0	0
5	29746642	.	A	G	5	7	12	0	1	13	0	0
5	29746706	.	A	T	3	8	11	0	0	11	0	0
5	29747027	.	C	T	14	11	25	0	6	31	0	0
5	29747121	.	G	T	21	23	44	0	2	46	0	0
5	29749734	.	T	C	6	9	15	0	1	16	0	0
5	29750074	.	G	A	6	3	9	0	0	9	0	0
5	29817549	.	A	C	2	3	5	0	0	5	0	0
5	30053125	.	G	A	3	3	6	0	0	6	0	0
5	30053182	.	G	A	4	5	9	0	0	9	0	0
5	30053533	.	G	C	0	2	2	0	1	3	0	0
5	30054122	.	T	A	5	5	10	0	0	10	0	0
5	30056162	.	G	T	1	4	5	0	0	5	0	0
5	30056993	.	G	C	2	2	4	0	0	4	0	0
5	30070497	.	C	T	1	2	3	0	0	3	0	0
5	30081359	.	G	A	7	12	19	0	3	22	0	0
5	30081495	.	G	A	10	12	22	0	0	22	0	0
5	30081737	.	C	T	1	2	3	0	0	3	0	0
5	30087954	.	G	A	2	3	5	0	0	5	0	0
5	30090364	.	C	A	5	7	12	0	1	13	0	0
5	30415236	.	A	G	10	13	23	0	1	24	0	0
5	30502862	.	A	G	10	6	16	0	3	19	0	0
5	30503022	.	A	G	1	4	5	0	1	6	0	0
5	30503194	.	C	A	3	3	6	0	0	6	0	0
5	30507329	.	T	G	1	0	1	0	0	1	0	0
5	30534910	.	G	A	5	14	19	0	1	20	0	0
5	30537647	.	A	G	4	7	11	0	1	12	0	0
5	30538110	.	G	T	1	0	1	0	0	1	0	0
5	30542683	.	A	G	2	2	4	0	0	4	0	0
5	30542695	.	C	T	2	2	4	0	0	4	0	0
5	30544147	.	T	C	1	0	1	0	0	1	0	0
5	30549756	.	G	A	0	2	2	0	1	3	0	0
5	30554108	.	C	A	0	1	1	0	0	1	0	0
5	30554110	.	T	G	0	1	1	0	0	1	0	0
5	30606225	.	A	G	2	2	4	0	0	4	0	0
5	30699337	.	A	T	20	20	40	0	1	41	0	0
5	30702796	.	G	A	0	4	4	0	0	4	0	0
5	30702903	.	A	T	7	8	15	0	1	16	0	0
5	30704029	.	C	T	1	1	2	0	0	2	0	0
5	30704188	.	G	A	3	4	7	0	0	7	0	0
5	30704229	.	C	T	1	2	3	0	1	4	0	0
5	30764629	.	T	G	1	1	2	0	0	2	0	0
5	30764820	.	A	G	1	1	2	0	0	2	0	0
5	30766804	.	T	C	1	0	1	0	0	1	0	0
5	30770617	.	C	T	0	3	3	0	0	3	0	0
5	30770735	.	A	C	1	3	4	0	0	4	0	0
5	30770757	.	T	C	1	3	4	0	0	4	0	0
5	30804287	.	G	A	4	7	11	0	1	12	0	0
5	30805072	.	T	A	1	3	4	0	0	4	0	0
5	30805623	.	A	G	9	7	16	0	0	16	0	0
5	30891443	.	A	G	8	13	21	0	0	21	0	0
5	30891565	.	A	C	9	11	20	0	0	20	0	0
5	30924101	.	T	C	11	10	21	0	0	21	0	0
5	30924247	.	T	A	9	4	13	0	0	13	0	0
5	30994105	.	T	A	5	5	10	0	0	10	0	0
5	30994256	.	C	T	5	3	8	0	1	9	0	0
5	30994610	.	T	C	8	10	18	0	1	19	0	0
5	30994818	.	C	T	5	6	11	0	2	13	0	0
5	30994843	.	G	T	5	4	9	0	0	9	0	0
5	30994862	.	C	T	3	3	6	0	0	6	0	0
5	30994882	.	C	T	2	1	3	0	0	3	0	0
5	31021450	.	C	T	0	1	1	0	0	1	0	0
5	31029089	.	G	A	1	1	2	0	0	2	0	0
5	31029471	.	G	A	0	3	3	0	7	10	0	0
5	31029520	.	G	A	0	4	4	0	3	7	0	0
5	31029701	.	G	T	4	2	6	0	0	6	0	0
5	31029702	.	G	T	3	2	5	0	1	6	0	0
5	31029766	.	C	T	2	6	8	0	1	9	0	0
5	31029886	.	A	C	5	2	7	0	0	7	0	0
5	31029898	.	A	G	5	2	7	0	0	7	0	0
5	31030037	.	T	A	7	3	10	0	0	10	0	0
5	31092294	.	T	C	1	2	3	0	0	3	0	0
5	31108800	.	A	G	4	0	4	0	3	7	0	0
5	31108804	.	T	C	3	3	6	0	1	7	0	0
5	31108922	.	A	G	2	2	4	0	0	4	0	0
5	31264263	.	C	T	2	2	4	0	0	4	0	0
5	31266676	.	T	C	3	4	7	0	0	7	0	0
5	31267009	.	C	G	2	1	3	0	2	5	0	0
5	31267164	.	A	G	6	4	10	0	1	11	0	0
5	31267233	.	A	C	2	4	6	0	0	6	0	0
5	31267254	.	A	G	2	4	6	0	0	6	0	0
5	31267313	.	T	A	4	6	10	0	2	12	0	0
5	31267336	.	G	A	7	6	13	0	3	16	0	0
5	31267655	.	C	T	10	11	21	0	1	22	0	0
5	31267975	.	T	C	5	10	15	0	0	15	0	0
5	31268104	.	A	T	14	16	30	0	0	30	0	0
5	31268417	.	A	G	18	31	49	0	1	50	0	0
5	31268489	.	T	C	6	15	21	0	4	25	0	0
5	31268601	.	G	A	20	15	35	0	1	36	0	0
5	31269004	.	C	T	17	23	40	0	13	53	0	0
5	31644517	.	T	A	12	7	19	0	2	22	1	0
5	31644614	.	T	G	13	28	41	0	5	46	0	0
5	31644709	.	C	T	1	14	15	0	15	30	0	0
5	31644867	.	A	G	19	15	34	0	4	38	0	0
5	31649757	.	G	A	9	12	21	0	0	21	0	0
5	31658294	.	C	T	3	1	4	0	0	4	0	0
5	31658303	.	T	C	0	1	1	0	1	2	0	0
5	31711869	.	C	G	1	3	4	0	0	4	0	0
5	31714550	.	C	T	11	14	25	0	1	26	0	0
5	31714742	.	A	C	11	18	29	0	2	31	0	0
5	31714914	.	T	C	6	9	15	0	3	18	0	0
5	32380030	.	A	T	0	2	2	0	1	3	0	0
5	32796788	.	T	C	1	2	3	0	0	3	0	0
5	33329786	.	A	G	4	10	14	0	1	15	0	0
5	35124479	.	C	T	0	0	0	0	5	5	0	0
5	35124859	.	C	T	2	3	5	0	1	6	0	0
5	35202876	.	A	T	9	7	16	0	3	20	1	0
5	35202958	.	G	A	7	7	14	0	1	15	0	0
5	35202959	.	A	T	8	5	13	0	2	15	0	0
5	35203092	.	G	A	11	8	19	0	1	20	0	0
5	35203486	.	C	A	5	3	8	0	3	11	0	0
5	35203629	.	C	T	0	8	8	0	5	13	0	0
5	35204077	.	T	G	3	6	9	0	1	10	0	0
5	35204159	.	C	T	4	7	11	0	1	12	0	0
5	35204280	.	A	T	3	4	7	0	0	7	0	0
5	35204322	.	A	G	2	5	7	0	1	8	0	0
5	35204390	.	G	A	1	3	4	0	0	4	0	0
5	35204681	.	A	C	1	2	3	0	0	3	0	0
5	35204689	.	A	C	1	0	1	0	2	3	0	0
5	35204754	.	C	T	2	7	9	0	0	9	0	0
5	35205005	.	G	A	3	3	6	0	0	6	0	0
5	35207914	.	T	G	1	3	4	0	0	4	0	0
5	35258647	.	A	G	2	1	3	0	0	3	0	0
5	35271001	.	C	T	20	10	30	0	6	36	0	0
5	35271154	.	A	T	21	17	38	0	2	40	0	0
5	35271181	.	A	G	29	19	48	0	1	49	0	0
5	35271194	.	G	A	26	23	49	0	4	53	0	0
5	35271309	.	T	A	23	28	51	0	1	52	0	0
5	35271465	.	T	C	21	21	42	0	3	45	0	0
5	35271824	.	C	A	16	8	24	0	1	25	0	0
5	35272032	.	G	A	6	5	11	0	0	11	0	0
5	35272560	.	T	G	2	2	4	0	0	4	0	0
5	35273062	.	G	A	5	13	18	0	3	21	0	0
5	35273447	.	A	G	2	2	4	0	0	4	0	0
5	35273509	.	A	T	3	3	6	0	0	6	0	0
5	35273546	.	A	T	4	2	6	0	0	6	0	0
5	35273564	.	G	A	3	2	5	0	0	5	0	0
5	35274398	.	G	A	1	3	4	0	1	5	0	0
5	35275103	.	C	T	1	2	3	0	0	3	0	0
5	35276154	.	A	G	1	2	3	0	0	3	0	0
5	35278977	.	T	G	0	4	4	0	1	5	0	0
5	35279007	.	C	T	0	3	3	0	0	3	0	0
5	35279065	.	A	G	1	3	4	0	0	4	0	0
5	35279230	.	T	G	3	7	10	0	0	10	0	0
5	35279275	.	T	G	5	7	12	0	2	14	0	0
5	35422324	.	T	C	2	4	6	0	0	6	0	0
5	35422402	.	A	G	3	3	6	0	1	7	0	0
5	35422530	.	C	T	4	2	6	0	0	6	0	0
5	35431641	.	A	G	3	2	5	0	1	6	0	0
5	35431703	.	T	G	1	1	2	0	0	2	0	0
5	35454464	.	C	T	1	3	4	0	0	4	0	0
5	35487030	.	A	G	4	3	7	0	0	7	0	0
5	35487407	.	A	T	2	1	3	0	0	3	0	0
5	35487416	.	G	C	2	3	5	0	0	5	0	0
5	35487781	.	C	G	3	3	6	0	0	6	0	0
5	35487881	.	A	G	1	2	3	0	0	3	0	0
5	35751977	.	A	G	0	4	4	0	1	5	0	0
5	35754424	.	T	C	15	9	24	0	1	25	0	0
5	35754431	.	A	G	15	0	15	0	10	25	0	0
5	35754503	.	A	C	12	14	26	0	0	26	0	0
5	35754599	.	T	A	17	16	33	0	0	33	0	0
5	35754663	.	A	G	7	16	23	0	2	25	0	0
5	35955514	.	T	C	3	4	7	0	1	8	0	0
5	35967234	.	C	T	7	8	15	0	0	15	0	0
5	35967270	.	T	A	6	11	17	0	0	17	0	0
5	35967500	.	A	G	3	1	4	0	5	9	0	0
5	35967910	.	A	G	2	3	5	0	0	5	0	0
5	36416204	.	A	G	7	9	16	0	2	18	0	0
5	36416307	.	C	G	4	0	4	0	5	9	0	0
5	36416367	.	G	A	0	5	5	0	13	18	0	0
5	36416478	.	G	T	9	8	17	0	0	17	0	0
5	36416583	.	C	T	15	9	24	0	1	25	0	0
5	36421991	.	G	A	0	7	7	0	10	17	0	0
5	36536665	.	T	C	4	3	7	0	0	7	0	0
5	36536742	.	C	T	9	7	16	0	1	17	0	0
5	36536910	.	G	A	3	3	6	0	0	6	0	0
5	36537020	.	A	G	5	3	8	0	1	9	0	0
5	36537021	.	T	A	6	3	9	0	0	9	0	0
5	36537057	.	G	A	3	4	7	0	0	7	0	0
5	36537073	.	A	C	3	5	8	0	0	8	0	0
5	36537231	.	A	T	11	4	15	0	1	16	0	0
5	36537334	.	A	T	9	3	12	0	0	12	0	0
5	36537611	.	C	A	7	6	13	0	2	15	0	0
5	36537672	.	C	A	5	5	10	0	0	10	0	0
5	36537927	.	T	C	1	5	6	0	0	6	0	0
5	36558059	.	G	A	10	4	14	0	0	14	0	0
5	36558348	.	A	G	14	13	27	0	2	29	0	0
5	36558369	.	G	A	15	10	25	0	2	27	0	0
5	36558441	.	C	T	10	6	16	0	1	17	0	0
5	36563257	.	T	C	2	2	4	0	0	4	0	0
5	36567750	.	C	A	0	3	3	0	1	4	0	0
5	36595772	.	A	T	1	5	6	0	0	6	0	0
5	36596397	.	T	A	1	2	3	0	0	3	0	0
5	36609412	.	G	A	1	3	4	0	0	4	0	0
5	36609442	.	G	A	0	2	2	0	4	6	0	0
5	36609469	.	T	C	1	2	3	0	1	4	0	0
5	36609546	.	A	G	2	2	4	0	0	4	0	0
5	36609547	.	T	C	2	2	4	0	0	4	0	0
5	36653522	.	G	A	2	1	3	0	0	3	0	0
5	36654147	.	G	A	0	6	6	0	5	11	0	0
5	36654334	.	A	T	1	2	3	0	1	4	0	0
5	36654344	.	G	A	1	2	3	0	1	4	0	0
5	36665351	.	C	T	10	11	21	0	0	21	0	0
5	36665680	.	C	T	1	2	3	0	0	3	0	0
5	36673347	.	C	T	3	5	8	0	0	8	0	0
5	36673470	.	C	A	3	3	6	0	1	7	0	0
5	36673609	.	A	G	2	3	5	0	0	5	0	0
5	36673687	.	A	T	3	5	8	0	0	8	0	0
5	36674796	.	G	C	5	9	14	0	1	15	0	0
5	36674831	.	C	T	4	10	14	0	0	14	0	0
5	36674911	.	C	T	1	3	4	0	0	4	0	0
5	36674925	.	T	C	1	2	3	0	0	3	0	0
5	36701362	.	A	T	1	2	3	0	1	4	0	0
5	36732199	.	G	C	0	4	4	0	0	4	0	0
5	36732217	.	A	G	0	4	4	0	0	4	0	0
5	36739134	.	T	C	13	6	19	0	1	20	0	0
5	36739310	.	T	A	9	11	20	0	0	20	0	0
5	36739316	.	T	C	11	9	20	0	1	21	0	0
5	36739352	.	T	A	10	10	20	0	5	25	0	0
5	36739361	.	T	C	10	9	19	0	4	23	0	0
5	36832565	.	A	G	0	1	1	0	1	2	0	0
5	36853849	.	C	G	2	3	5	0	0	5	0	0
5	36854450	.	T	C	20	3	23	0	0	23	0	0
5	36854485	.	G	A	1	5	6	0	17	23	0	0
5	36854494	.	G	T	16	5	21	0	0	21	0	0
5	36898476	.	C	T	4	7	11	0	1	12	0	0
5	36898668	.	A	G	6	0	6	0	11	17	0	0
5	36902628	.	T	C	3	0	3	0	0	3	0	0
5	36907111	.	G	A	5	2	7	0	0	7	0	0
5	36907117	.	C	T	5	2	7	0	0	7	0	0
5	36908004	.	G	T	19	11	30	0	3	33	0	0
5	36908034	.	T	C	14	11	25	0	1	26	0	0
5	36913916	.	A	T	1	2	3	0	0	3	0	0
5	36916257	.	C	A	0	1	1	0	1	2	0	0
5	36916615	.	C	T	2	3	5	0	0	5	0	0
5	36945327	.	T	G	9	13	22	0	0	22	0	0
5	36945378	.	T	A	20	22	42	0	1	43	0	0
5	36945518	.	T	G	25	22	47	0	3	50	0	0
5	36945608	.	G	A	28	32	60	0	6	66	0	0
5	36945680	.	T	C	29	40	69	0	2	71	0	0
5	36945927	.	A	C	17	40	57	0	1	58	0	0
5	36945937	.	C	T	18	38	56	0	0	56	0	0
5	36946133	.	A	G	21	39	60	0	0	60	0	0
5	36946244	.	A	G	26	28	54	0	4	58	0	0
5	36997133	.	A	G	4	8	12	0	0	12	0	0
5	37032280	.	C	G	1	2	3	0	1	4	0	0
5	37032446	.	T	C	2	6	8	0	0	8	0	0
5	37032500	.	A	G	2	3	5	0	2	7	0	0
5	37032717	.	A	C	2	7	9	0	0	9	0	0
5	37032782	.	G	A	5	2	7	0	0	7	0	0
5	37032959	.	A	G	0	1	1	0	0	1	0	0
5	37036421	.	G	A	1	5	6	0	0	6	0	0
5	37036562	.	A	T	3	10	13	0	0	13	0	0
5	37037232	.	A	G	8	12	20	0	1	21	0	0
5	37037256	.	G	T	7	11	18	0	1	19	0	0
5	37037284	.	C	T	7	10	17	0	1	18	0	0
5	37037325	.	G	A	5	3	8	0	0	8	0	0
5	37037392	.	G	T	2	4	6	0	0	6	0	0
5	37037489	.	A	C	8	6	14	0	0	14	0	0
5	37037669	.	T	G	22	15	37	0	1	38	0	0
5	37037742	.	A	T	20	19	39	0	0	39	0	0
5	37037987	.	A	C	16	13	29	0	4	33	0	0
5	37038017	.	T	C	14	8	22	0	3	25	0	0
5	37065508	.	T	C	7	5	12	0	0	12	0	0
5	37065537	.	T	C	4	5	9	0	0	9	0	0
5	37065729	.	C	T	7	2	9	0	0	9	0	0
5	37093389	.	T	A	1	2	3	0	0	3	0	0
5	37094944	.	T	A	5	6	11	0	0	11	0	0
5	37095008	.	A	C	3	2	5	0	1	6	0	0
5	37757608	.	T	C	1	2	3	0	1	4	0	0
5	37851742	.	G	A	3	4	7	0	0	7	0	0
5	37851758	.	T	A	3	6	9	0	0	9	0	0
5	37851876	.	C	T	5	2	7	0	1	8	0	0
5	37851962	.	C	T	1	2	3	0	1	4	0	0
5	37851970	.	A	C	2	2	4	0	0	4	0	0
5	37852037	.	G	A	3	1	4	0	1	5	0	0
5	37852048	.	A	T	3	2	5	0	0	5	0	0
5	37852117	.	T	A	2	2	4	0	0	4	0	0
5	37852216	.	G	A	1	2	3	0	0	3	0	0
5	37864789	.	G	A	5	8	13	0	0	13	0	0
5	37864982	.	T	A	1	6	7	0	0	7	0	0
5	37865429	.	T	A	2	7	9	0	0	9	0	0
5	37865628	.	T	C	1	3	4	0	0	4	0	0
5	37865744	.	C	G	1	2	3	0	0	3	0	0
5	37912292	.	T	A	19	18	37	0	0	37	0	0
5	37912442	.	A	G	5	6	11	0	0	11	0	0
5	37912489	.	T	A	7	8	15	0	0	15	0	0
5	37912748	.	A	T	7	6	13	0	0	13	0	0
5	37912859	.	A	C	8	7	15	0	0	15	0	0
5	37912970	.	A	C	4	3	7	0	0	7	0	0
5	37913041	.	C	G	5	4	9	0	2	11	0	0
5	37913064	.	T	C	6	8	14	0	0	14	0	0
5	37963259	.	C	T	2	2	4	0	0	4	0	0
5	37963262	.	G	T	2	2	4	0	0	4	0	0
5	37987325	.	C	T	0	3	3	0	4	7	0	0
5	37987369	.	G	A	3	1	4	0	0	4	0	0
5	37989090	.	G	A	1	4	5	0	0	5	0	0
5	37989443	.	A	C	0	2	2	0	0	2	0	0
5	37989447	.	A	G	0	2	2	0	0	2	0	0
5	38302158	.	C	A	5	36	41	0	0	41	0	0
5	38302159	.	A	C	17	22	39	0	2	41	0	0
5	39386667	.	A	G	4	2	6	0	0	6	0	0
5	39386685	.	A	G	4	2	6	0	0	6	0	0
5	39386709	.	T	A	3	3	6	0	0	6	0	0
5	39386721	.	A	T	2	2	4	0	2	6	0	0
5	39386791	.	C	A	1	2	3	0	0	3	0	0
5	39504190	.	C	A	1	3	4	0	0	4	0	0
5	39508009	.	C	T	8	9	17	0	2	19	0	0
5	39508059	.	T	A	8	12	20	0	0	20	0	0
5	39707424	.	G	A	2	1	3	0	1	4	0	0
5	39707825	.	G	A	5	8	13	0	2	15	0	0
5	39708565	.	A	T	6	7	13	0	2	15	0	0
5	39708576	.	G	T	5	9	14	0	2	16	0	0
5	39708658	.	T	C	6	8	14	0	0	14	0	0
5	39708686	.	G	A	4	5	9	0	0	9	0	0
5	39708711	.	G	A	2	3	5	0	0	5	0	0
5	39715249	.	G	A	0	4	4	0	0	4	0	0
5	39730575	.	C	T	0	1	1	0	1	2	0	0
5	40203540	.	G	A	2	2	4	0	0	4	0	0
5	40273080	.	T	A	4	2	6	0	0	6	0	0
5	40273606	.	C	T	0	2	2	0	0	2	0	0
5	40273727	.	T	A	1	3	4	0	0	4	0	0
5	40501035	.	G	A	10	14	24	0	0	24	0	0
5	40505124	.	C	T	0	3	3	0	3	6	0	0
5	40728852	.	A	G	2	4	6	0	1	7	0	0
5	40729147	.	T	C	4	5	9	0	1	10	0	0
5	40729408	.	G	A	11	4	15	0	0	15	0	0
5	41083917	.	T	C	15	5	20	0	2	22	0	0
5	41799169	.	C	T	5	2	7	0	3	10	0	0
5	42067588	.	G	A	1	0	1	0	0	1	0	0
5	43798423	.	G	T	1	1	2	0	0	2	0	0
5	43801223	.	T	C	0	0	0	0	1	1	0	0
5	43804235	.	T	C	2	0	2	0	6	8	0	0
5	43804251	.	G	A	3	4	7	0	2	9	0	0
5	43804475	.	T	C	1	0	1	0	6	7	0	0
5	43807070	.	G	A	0	3	3	0	2	5	0	0
5	43807340	.	T	C	3	1	4	0	0	4	0	0
5	43807494	.	G	C	1	0	1	0	0	1	0	0
5	43808965	.	T	C	13	10	23	0	2	25	0	0
5	43810302	.	G	A	2	2	4	0	1	5	0	0
5	43819422	.	T	A	5	2	7	0	0	7	0	0
5	43861561	.	A	T	18	10	28	0	0	28	0	0
5	43861922	.	A	T	8	5	13	0	2	15	0	0
5	43862069	.	C	T	0	6	6	0	6	12	0	0
5	43862449	.	G	A	5	3	8	0	0	8	0	0
5	43862557	.	A	C	12	0	12	0	3	15	0	0
5	43862562	.	G	A	10	2	12	0	3	15	0	0
5	43862628	.	G	A	3	2	5	0	1	6	0	0
5	43862649	.	C	T	3	2	5	0	0	5	0	0
5	43862725	.	T	A	4	4	8	0	0	8	0	0
5	43862737	.	C	T	5	4	9	0	1	10	0	0
5	43862924	.	A	G	9	7	16	0	1	17	0	0
5	43862954	.	A	T	10	4	14	0	1	15	0	0
5	43863052	.	C	T	3	4	7	0	0	7	0	0
5	43863222	.	A	T	1	5	6	0	0	6	0	0
5	43863241	.	G	A	4	4	8	0	1	9	0	0
5	43863304	.	T	C	3	3	6	0	0	6	0	0
5	43863315	.	G	A	3	3	6	0	0	6	0	0
5	44262496	.	C	T	3	3	6	0	0	6	0	0
5	44263024	.	T	A	1	4	5	0	0	5	0	0
5	44263204	.	C	A	10	5	15	0	0	15	0	0
5	44263851	.	T	A	11	9	20	0	1	21	0	0
5	44352300	.	T	C	1	2	3	0	0	3	0	0
5	44354265	.	C	A	1	1	2	0	0	2	0	0
5	44365957	.	T	A	0	1	1	0	0	1	0	0
5	44366090	.	G	A	0	1	1	0	0	1	0	0
5	44366621	.	T	C	1	0	1	0	0	1	0	0
5	44370681	.	A	G	5	0	5	0	5	10	0	0
5	44370828	.	C	T	9	12	21	0	0	21	0	0
5	44370910	.	C	T	13	17	30	0	0	30	0	0
5	44370943	.	G	A	8	11	19	0	1	20	0	0
5	44370998	.	G	A	7	10	17	0	0	17	0	0
5	44371043	.	C	T	5	8	13	0	1	14	0	0
5	44495224	.	A	T	1	3	4	0	0	4	0	0
5	44495591	.	G	A	1	2	3	0	0	3	0	0
5	44495822	.	G	A	3	3	6	0	0	6	0	0
5	44794606	.	C	G	7	3	10	0	2	12	0	0
5	44794613	.	G	T	0	5	5	0	6	11	0	0
5	44794816	.	C	T	3	7	10	0	0	10	0	0
5	44795297	.	A	G	6	1	7	0	21	28	0	0
5	44795308	.	A	G	11	16	27	0	4	31	0	0
5	44795467	.	T	G	7	12	19	0	1	20	0	0
5	44795468	.	A	T	6	13	19	0	1	20	0	0
5	44795598	.	G	A	0	8	8	0	12	20	0	0
5	44806446	.	G	A	3	3	6	0	0	6	0	0
5	44808553	.	C	T	3	4	7	0	0	7	0	0
5	44810341	.	T	C	5	1	6	0	1	7	0	0
5	44833492	.	C	A	1	3	4	0	0	4	0	0
5	44833496	.	T	C	1	3	4	0	0	4	0	0
5	45224048	.	C	T	2	2	4	0	0	4	0	0
5	45269380	.	A	G	3	1	4	0	1	5	0	0
5	45269386	.	A	G	2	2	4	0	1	5	0	0
5	45271966	.	C	A	2	2	4	0	0	4	0	0
5	45272009	.	A	G	4	0	4	0	5	9	0	0
5	45272035	.	C	T	4	2	6	0	0	6	0	0
5	45274429	.	G	A	5	2	7	0	1	8	0	0
5	45283074	.	G	A	0	4	4	0	6	10	0	0
5	45283117	.	A	C	3	6	9	0	0	9	0	0
5	45283274	.	T	C	1	7	8	0	1	9	0	0
5	45283284	.	T	C	2	8	10	0	0	10	0	0
5	45283365	.	G	A	7	5	12	0	0	12	0	0
5	45283446	.	A	G	9	8	17	0	0	17	0	0
5	45283645	.	C	T	4	2	6	0	0	6	0	0
5	45283765	.	T	A	2	3	5	0	0	5	0	0
5	45747236	.	T	G	3	3	6	0	0	6	0	0
5	45747455	.	C	T	9	7	16	0	1	17	0	0
5	45747475	.	C	T	2	5	7	0	4	11	0	0
5	45747647	.	A	G	3	6	9	0	1	10	0	0
5	45748339	.	T	G	2	3	5	0	0	5	0	0
5	45754899	.	G	A	3	3	6	0	1	7	0	0
5	45890036	.	A	T	9	8	17	0	2	19	0	0
5	45890625	.	C	T	10	8	18	0	2	20	0	0
5	45890663	.	T	A	6	12	18	0	1	19	0	0
5	45890908	.	C	T	0	4	4	0	7	11	0	0
5	45891074	.	A	G	5	4	9	0	0	9	0	0
5	45891147	.	T	A	4	4	8	0	0	8	0	0
5	45891431	.	C	T	1	2	3	0	0	3	0	0
5	45914359	.	G	T	2	2	4	0	1	5	0	0
5	46327798	.	G	T	4	7	11	0	0	11	0	0
5	46328215	.	C	T	3	2	5	0	0	5	0	0
5	46328218	.	A	T	3	3	6	0	0	6	0	0
5	46328314	.	C	T	3	6	9	0	0	9	0	0
5	46328611	.	C	T	1	2	3	0	1	4	0	0
5	46328797	.	G	A	2	3	5	0	0	5	0	0
5	46492091	.	A	T	1	2	3	0	0	3	0	0
5	46659063	.	C	T	18	19	37	0	2	39	0	0
5	46659285	.	T	G	15	13	28	0	5	33	0	0
5	46659805	.	C	T	21	20	41	0	1	42	0	0
5	46659812	.	C	T	0	18	18	0	21	39	0	0
5	46659950	.	C	T	12	12	24	0	2	26	0	0
5	46659984	.	A	G	12	9	21	0	4	25	0	0
5	46660116	.	C	T	6	8	14	0	0	14	0	0
5	46660162	.	C	G	6	10	16	0	2	18	0	0
5	46660201	.	A	G	9	11	20	0	0	20	0	0
5	46660259	.	T	C	10	18	28	0	1	29	0	0
5	46660429	.	G	A	19	10	29	0	4	33	0	0
5	46660431	.	C	T	0	13	13	0	20	33	0	0
5	46660524	.	T	C	12	10	22	0	1	23	0	0
5	46660541	.	T	C	10	10	20	0	1	21	0	0
5	46660577	.	T	C	6	3	9	0	0	13	4	0
5	46660681	.	A	G	8	12	20	0	0	20	0	0
5	46660727	.	T	C	2	8	10	0	0	11	1	0
5	46660735	.	G	C	3	11	14	0	0	14	0	0
5	46660780	.	A	G	15	11	26	0	2	28	0	0
5	46660819	.	A	G	20	6	26	0	2	28	0	0
5	46660906	.	A	G	2	8	10	0	3	13	0	0
5	46660940	.	G	A	2	9	11	0	1	12	0	0
5	46661073	.	G	A	2	4	6	0	0	6	0	0
5	46661213	.	A	G	1	2	3	0	0	3	0	0
5	46661348	.	G	C	5	5	10	0	1	11	0	0
5	46661349	.	G	A	6	5	11	0	0	11	0	0
5	46661418	.	T	C	5	8	13	0	1	14	0	0
5	46662271	.	A	G	4	3	7	0	0	7	0	0
5	47727760	.	C	T	0	18	18	0	18	36	0	0
5	47950082	.	A	C	1	1	2	0	0	2	0	0
5	47977042	.	T	G	3	3	6	0	1	7	0	0
5	47977254	.	T	G	1	2	3	0	0	3	0	0
5	48028112	.	G	A	7	6	13	0	1	14	0	0
5	48028451	.	T	A	8	3	11	0	0	11	0	0
5	48182021	.	A	G	5	6	11	0	1	12	0	0
5	48182030	.	T	C	8	1	9	0	5	14	0	0
5	48182066	.	C	G	7	7	14	0	0	14	0	0
5	48182088	.	A	G	5	1	6	0	2	8	0	0
5	48182725	.	T	C	3	5	8	0	1	9	0	0
5	48672641	.	A	G	2	2	4	0	0	4	0	0
5	48672752	.	C	T	0	8	8	0	13	21	0	0
5	48673093	.	C	A	1	4	5	0	0	5	0	0
5	48929274	.	G	A	0	2	2	0	2	4	0	0
5	48936032	.	C	T	3	1	4	0	1	5	0	0
5	48986109	.	G	A	8	9	17	0	2	19	0	0
5	48986398	.	T	C	21	11	32	2	0	34	0	0
5	48986626	.	A	T	6	22	28	0	1	29	0	0
5	48986937	.	T	C	0	9	9	0	13	22	0	0
5	48987356	.	G	T	7	2	9	0	3	12	0	0
5	48987772	.	G	A	9	6	15	0	0	15	0	0
5	49019328	.	C	T	0	2	2	0	3	5	0	0
5	49019451	.	G	A	3	5	8	0	2	10	0	0
5	49019572	.	G	T	1	4	5	0	2	7	0	0
5	49019594	.	C	A	7	1	8	0	0	8	0	0
5	49734708	.	G	T	9	11	20	0	3	23	0	0
5	49734709	.	G	A	10	10	20	0	3	23	0	0
5	49735077	.	T	C	4	2	6	0	0	6	0	0
5	49735453	.	T	C	2	4	6	0	0	6	0	0
5	49735700	.	C	A	2	4	6	0	0	6	0	0
5	49750765	.	C	T	14	10	24	0	2	26	0	0
5	49750834	.	A	C	6	5	11	0	6	17	0	0
5	49755368	.	G	C	2	2	4	0	0	4	0	0
5	49773649	.	C	T	4	2	6	0	1	7	0	0
5	49773801	.	A	T	1	4	5	0	1	6	0	0
5	50435897	.	G	A	4	3	7	0	0	7	0	0
5	50436127	.	C	T	7	5	12	0	0	12	0	0
5	50443292	.	G	A	12	9	21	0	1	22	0	0
5	51617022	.	T	C	4	2	6	0	0	6	0	0
5	51775052	.	A	G	4	8	12	0	0	12	0	0
5	51775291	.	A	T	14	23	37	0	0	37	0	0
5	51775391	.	A	G	20	13	33	0	7	40	0	0
5	51775501	.	T	G	17	15	32	0	4	37	1	0
5	51775715	.	G	A	9	10	19	0	1	20	0	0
5	51775805	.	A	G	16	9	25	0	4	29	0	0
5	51775837	.	G	C	11	12	23	0	0	23	0	0
5	51775997	.	A	T	8	15	23	0	2	25	0	0
5	51776171	.	T	C	1	5	6	0	0	6	0	0
5	51776183	.	C	A	1	5	6	0	0	6	0	0
5	51793031	.	C	T	0	7	7	0	0	7	0	0
5	51843021	.	G	T	2	3	5	0	0	5	0	0
5	51942131	.	G	A	1	0	1	0	0	1	0	0
5	51947551	.	T	C	14	12	26	0	2	28	0	0
5	51947621	.	T	A	5	11	16	0	1	17	0	0
5	51947759	.	G	T	10	7	17	0	0	17	0	0
5	51947927	.	T	C	4	0	4	0	4	8	0	0
5	51948076	.	G	A	3	3	6	0	0	6	0	0
5	51948189	.	T	G	2	8	10	0	1	11	0	0
5	51948222	.	G	C	7	3	10	0	0	10	0	0
5	51948289	.	G	A	10	5	15	0	0	15	0	0
5	51948389	.	A	T	5	3	8	0	0	8	0	0
5	51948762	.	G	A	3	4	7	0	0	7	0	0
5	51948858	.	T	A	6	6	12	0	0	12	0	0
5	51949071	.	T	A	5	3	8	0	1	9	0	0
5	52005851	.	G	T	1	0	1	0	0	1	0	0
5	52190868	.	G	T	1	2	3	0	0	3	0	0
5	52190948	.	G	T	2	4	6	0	0	6	0	0
5	52190969	.	A	G	2	4	6	0	1	7	0	0
5	52191263	.	T	C	7	8	15	0	1	16	0	0
5	52191270	.	C	T	7	7	14	0	2	16	0	0
5	52191329	.	T	G	2	7	9	0	1	10	0	0
5	52191525	.	A	T	0	4	4	0	0	4	0	0
5	52191758	.	C	T	1	5	6	0	0	6	0	0
5	52227269	.	T	A	0	2	2	0	0	2	0	0
5	52227393	.	T	C	1	0	1	0	0	1	0	0
5	52227660	.	T	A	1	2	3	0	0	3	0	0
5	52257463	.	T	C	6	11	17	0	4	21	0	0
5	52257530	.	A	G	12	11	23	0	2	25	0	0
5	52257905	.	A	G	8	6	14	0	2	16	0	0
5	52258036	.	G	A	5	5	10	0	1	11	0	0
5	52258068	.	C	T	0	6	6	0	6	12	0	0
5	52258801	.	T	A	1	3	4	0	0	4	0	0
5	54459854	.	T	C	1	2	3	0	0	3	0	0
5	54459855	.	T	C	1	2	3	0	0	3	0	0
5	54460259	.	G	A	1	2	3	0	0	3	0	0
5	56305458	.	C	A	1	0	1	0	1	2	0	0
5	56309445	.	C	T	9	17	26	0	2	28	0	0
5	56309506	.	G	A	10	8	18	0	1	19	0	0
5	56309677	.	C	A	7	8	15	0	2	17	0	0
5	56313246	.	C	T	8	8	16	0	0	16	0	0
5	56317470	.	C	T	1	1	2	0	0	2	0	0
5	56317473	.	T	G	1	0	1	0	1	2	0	0
5	56325194	.	A	G	1	0	1	0	0	1	0	0
5	56343032	.	C	T	0	1	1	0	2	3	0	0
5	56343053	.	G	A	1	2	3	0	0	3	0	0
5	56915422	.	G	A	5	2	7	0	0	7	0	0
5	56951034	.	G	A	9	12	21	0	2	23	0	0
5	56951229	.	C	T	20	11	31	0	1	32	0	0
5	56951769	.	A	G	4	7	11	0	1	12	0	0
5	56952316	.	A	G	6	6	12	0	2	14	0	0
5	56955460	.	C	T	10	4	14	0	1	15	0	0
5	56955508	.	T	G	4	0	4	0	1	5	0	0
5	56956359	.	G	A	5	4	9	0	0	9	0	0
5	56961194	.	A	G	1	0	1	0	0	1	0	0
5	57219496	.	G	A	1	2	3	0	0	3	0	0
5	57231089	.	C	T	7	8	15	0	0	15	0	0
5	57325118	.	C	A	27	26	53	0	2	55	0	0
5	57325123	.	G	T	26	28	54	0	3	57	0	0
5	57325204	.	T	G	29	0	29	0	33	62	0	0
5	57325210	.	G	A	27	31	58	0	3	61	0	0
5	57325381	.	A	T	23	34	57	0	0	57	0	0
5	57325537	.	C	T	5	9	14	0	4	18	0	0
5	57353531	.	A	T	1	2	3	0	1	4	0	0
5	57354452	.	C	T	5	5	10	0	1	11	0	0
5	57354552	.	C	T	3	2	5	0	0	5	0	0
5	57354596	.	C	T	5	3	8	0	0	8	0	0
5	57354786	.	G	T	7	13	20	0	1	21	0	0
5	57359699	.	G	T	10	6	16	0	0	16	0	0
5	57422146	.	A	T	2	4	6	0	0	6	0	0
5	57451036	.	A	T	2	6	8	0	1	9	0	0
5	57453635	.	T	C	3	4	7	0	2	9	0	0
5	57489777	.	T	C	9	0	9	0	14	23	0	0
5	57489821	.	G	A	6	13	19	0	2	21	0	0
5	57490344	.	C	A	1	5	6	0	9	15	0	0
5	57490371	.	C	T	0	8	8	0	6	14	0	0
5	57499990	.	T	C	0	0	0	0	2	2	0	0
5	57505050	.	C	T	1	3	4	0	0	4	0	0
5	57693802	.	G	A	1	3	4	0	0	4	0	0
5	57693810	.	C	G	0	3	3	0	1	4	0	0
5	57718488	.	A	C	6	8	14	0	0	15	1	0
5	57718716	.	T	C	11	4	15	0	0	15	0	0
5	57718739	.	T	C	4	4	8	0	0	8	0	0
5	57718794	.	T	C	1	1	2	0	1	3	0	0
5	57737919	.	T	A	3	2	5	0	0	5	0	0
5	57755422	.	T	C	1	2	3	0	0	3	0	0
5	57759107	.	C	T	0	2	2	0	0	2	0	0
5	57759159	.	G	A	0	6	6	0	6	12	0	0
5	57762423	.	A	T	6	7	13	0	0	13	0	0
5	57762608	.	A	G	9	1	10	0	21	31	0	0
5	57762986	.	C	G	19	20	39	0	1	40	0	0
5	57797086	.	C	T	17	6	23	0	2	25	0	0
5	58382267	.	G	A	24	23	47	0	2	49	0	0
5	58382415	.	C	T	17	18	35	0	4	39	0	0
5	58382474	.	T	A	13	8	21	0	4	25	0	0
5	58417186	.	C	T	2	4	6	0	0	6	0	0
5	58696115	.	G	A	2	2	4	0	1	5	0	0
5	58696118	.	T	A	3	2	5	0	0	5	0	0
5	58851232	.	G	A	14	13	27	0	3	30	0	0
5	59008759	.	T	A	9	8	17	0	0	17	0	0
5	59008762	.	G	C	8	6	14	0	3	17	0	0
5	59079732	.	A	C	5	3	8	0	1	9	0	0
5	59079806	.	C	A	1	3	4	0	0	4	0	0
5	59080452	.	G	T	0	3	3	0	4	7	0	0
5	59080526	.	T	A	1	3	4	0	0	4	0	0
5	59080682	.	A	T	1	3	4	0	0	4	0	0
5	59082758	.	G	T	9	13	22	0	1	23	0	0
5	59082761	.	C	T	9	14	23	0	0	23	0	0
5	59095793	.	C	T	3	5	8	0	0	8	0	0
5	59100577	.	G	A	2	1	3	0	0	3	0	0
5	59103052	.	A	G	1	3	4	0	0	4	0	0
5	59201427	.	C	G	1	3	4	0	1	5	0	0
5	59201609	.	A	T	1	3	4	0	0	4	0	0
5	59201624	.	C	T	1	3	4	0	1	5	0	0
5	59201825	.	G	A	3	5	8	0	0	8	0	0
5	59201883	.	T	G	6	6	12	0	0	12	0	0
5	59201914	.	G	A	5	10	15	0	1	16	0	0
5	59201918	.	G	C	5	9	14	0	1	15	0	0
5	59239773	.	C	G	2	3	5	0	0	5	0	0
5	59248031	.	T	C	7	5	12	0	1	13	0	0
5	59248094	.	A	T	2	2	4	0	1	5	0	0
5	59388586	.	T	A	7	5	12	0	0	12	0	0
5	59388604	.	T	C	9	5	14	0	2	16	0	0
5	59388852	.	T	A	2	2	4	0	0	4	0	0
5	59388932	.	C	T	6	3	9	0	0	9	0	0
5	59389002	.	G	A	8	9	17	0	0	17	0	0
5	59389079	.	A	G	6	0	6	0	8	14	0	0
5	59389210	.	T	A	1	4	5	0	0	5	0	0
5	59389440	.	T	A	2	4	6	0	0	6	0	0
5	59389693	.	A	T	12	9	21	0	0	21	0	0
5	59420096	.	T	C	1	2	3	0	0	3	0	0
5	59420321	.	A	C	1	2	3	0	0	3	0	0
5	59420366	.	T	C	1	2	3	0	0	3	0	0
5	59420375	.	C	T	1	2	3	0	0	3	0	0
5	59466930	.	A	G	1	0	1	0	0	1	0	0
5	59473728	.	T	C	0	1	1	0	1	2	0	0
5	59473885	.	A	C	3	2	5	0	1	6	0	0
5	59544291	.	T	C	2	1	3	0	0	3	0	0
5	59548976	.	C	G	2	1	3	0	0	3	0	0
5	59549354	.	T	C	5	3	8	0	0	8	0	0
5	59549528	.	T	A	8	2	10	0	0	10	0	0
5	59550365	.	G	A	8	5	13	0	1	14	0	0
5	59550636	.	A	T	9	9	18	0	1	19	0	0
5	59550713	.	T	C	4	2	6	0	0	6	0	0
5	59584548	.	G	A	0	1	1	0	0	1	0	0
5	59593773	.	G	C	0	2	2	0	1	3	0	0
5	59593795	.	T	A	1	2	3	0	0	3	0	0
5	59594199	.	T	C	1	2	3	0	0	3	0	0
5	59594437	.	T	A	6	6	12	0	0	12	0	0
5	59594551	.	A	G	14	0	14	0	8	22	0	0
5	59594729	.	A	G	6	3	9	0	1	10	0	0
5	59594763	.	T	G	5	4	9	0	1	10	0	0
5	59594878	.	C	T	5	2	7	0	1	8	0	0
5	59594893	.	C	T	3	2	5	0	1	6	0	0
5	59595241	.	T	C	6	7	13	0	2	15	0	0
5	59595252	.	C	T	6	10	16	0	2	18	0	0
5	59595502	.	T	C	10	7	17	0	0	17	0	0
5	60686452	.	C	T	1	3	4	0	0	4	0	0
5	60686473	.	C	T	5	3	8	0	0	8	0	0
5	60686541	.	A	G	5	2	7	0	1	8	0	0
5	60686603	.	C	T	4	4	8	0	0	8	0	0
5	60686910	.	G	T	8	6	14	0	1	15	0	0
5	60686918	.	A	T	8	7	15	0	0	15	0	0
5	60687344	.	A	T	4	11	15	0	2	17	0	0
5	60687362	.	A	G	6	14	20	0	2	22	0	0
5	60687537	.	T	C	6	10	16	0	0	16	0	0
5	60866063	.	G	T	0	1	1	0	0	1	0	0
5	60867948	.	A	C	3	6	9	0	0	9	0	0
5	60869015	.	C	A	2	0	2	0	0	2	0	0
5	60871969	.	C	T	3	3	6	0	0	6	0	0
5	60872126	.	G	A	8	9	17	0	1	18	0	0
5	60872320	.	T	C	4	4	8	0	0	8	0	0
5	60872472	.	G	A	8	11	19	0	1	20	0	0
5	61951038	.	A	G	6	13	19	0	0	19	0	0
5	62290448	.	A	T	0	2	2	0	0	2	0	0
5	62639596	.	G	A	6	9	15	0	1	16	0	0
5	62642989	.	A	G	11	3	14	0	1	15	0	0
5	62806599	.	T	A	8	2	10	0	3	13	0	0
5	62806675	.	A	G	13	7	20	0	1	21	0	0
5	62806701	.	A	G	12	9	21	0	0	21	0	0
5	62806786	.	C	A	2	2	4	0	1	5	0	0
5	62806951	.	A	G	2	5	7	0	0	7	0	0
5	62807258	.	T	A	4	2	6	0	0	6	0	0
5	62807263	.	G	A	3	2	5	0	0	5	0	0
5	62807294	.	G	A	1	4	5	0	0	5	0	0
5	62868243	.	C	T	2	2	4	0	0	4	0	0
5	62889651	.	C	T	2	2	4	0	0	4	0	0
5	62994131	.	G	T	0	1	1	0	0	1	0	0
5	63335216	.	C	A	1	1	2	0	0	2	0	0
5	63338422	.	C	T	2	2	4	1	0	5	0	0
5	63338518	.	A	T	3	5	8	0	0	8	0	0
5	63338557	.	C	T	3	4	7	0	0	7	0	0
5	63338563	.	A	G	1	4	5	0	0	5	0	0
5	63363010	.	G	A	1	2	3	0	0	3	0	0
5	63363058	.	C	T	3	2	5	0	0	5	0	0
5	63373157	.	T	C	0	1	1	0	0	1	0	0
5	63373731	.	T	C	2	4	6	0	0	6	0	0
5	63394174	.	C	A	3	6	9	0	0	9	0	0
5	63398847	.	T	C	5	6	11	0	2	13	0	0
5	63398973	.	G	A	11	12	23	0	5	28	0	0
5	63399066	.	G	C	11	14	25	0	3	28	0	0
5	63399111	.	T	A	13	18	31	0	2	33	0	0
5	63400476	.	G	A	2	2	4	0	0	4	0	0
5	63400524	.	T	G	4	3	7	0	0	7	0	0
5	63400624	.	A	T	4	0	4	0	1	5	0	0
5	63400643	.	T	C	5	2	7	0	0	7	0	0
5	63407169	.	G	A	1	2	3	0	0	3	0	0
5	63411031	.	A	G	0	2	2	0	0	2	0	0
5	63411033	.	A	G	0	2	2	0	0	2	0	0
5	63510713	.	C	G	0	2	2	0	3	5	0	0
5	63510908	.	G	T	5	11	16	0	0	16	0	0
5	63511264	.	A	G	4	2	6	0	0	6	0	0
5	63511315	.	A	G	1	5	6	0	0	6	0	0
5	63648811	.	A	G	2	2	4	0	0	4	0	0
5	63655829	.	T	C	0	0	0	0	1	1	0	0
5	63730115	.	G	A	0	4	4	0	3	7	0	0
5	63739912	.	A	G	13	22	35	0	1	36	0	0
5	63740093	.	C	T	7	15	22	0	1	23	0	0
5	63740097	.	T	A	7	14	21	0	0	21	0	0
5	63740149	.	T	C	9	9	18	0	0	18	0	0
5	63740167	.	A	G	6	10	16	0	2	18	0	0
5	63740815	.	A	C	16	33	49	0	1	50	0	0
5	63740874	.	A	C	20	21	41	0	3	44	0	0
5	63740895	.	A	C	18	19	37	0	3	40	0	0
5	63740910	.	A	G	17	26	43	0	1	44	0	0
5	63741023	.	T	A	12	21	33	0	2	35	0	0
5	63741077	.	A	T	10	21	31	0	2	33	0	0
5	63863651	.	C	G	3	0	3	0	2	5	0	0
5	63863656	.	G	A	3	2	5	0	0	5	0	0
5	63863945	.	G	C	1	4	5	0	0	5	0	0
5	63864117	.	C	T	4	9	13	0	1	14	0	0
5	63864150	.	T	C	4	7	11	0	0	11	0	0
5	67188350	.	C	T	7	8	15	0	0	15	0	0
5	67188515	.	C	G	0	3	3	0	2	5	0	0
5	67188524	.	G	A	2	1	3	0	0	3	0	0
5	67205474	.	T	C	1	0	1	0	0	1	0	0
5	67211634	.	T	C	2	0	2	0	3	5	0	0
5	67211643	.	T	C	3	0	3	0	3	6	0	0
5	67254234	.	C	T	0	3	3	0	4	7	0	0
5	67254601	.	T	G	5	3	8	0	0	8	0	0
5	67254648	.	G	T	4	3	7	0	0	7	0	0
5	67254861	.	G	A	1	2	3	0	1	4	0	0
5	67255049	.	C	T	0	3	3	0	0	3	0	0
5	67260308	.	C	A	1	2	3	0	0	3	0	0
5	67272686	.	T	G	1	3	4	0	0	4	0	0
5	67272745	.	C	T	2	2	4	0	0	4	0	0
5	67272835	.	T	C	4	2	6	0	0	6	0	0
5	67272901	.	T	G	1	3	4	0	0	4	0	0
5	67278712	.	T	C	8	13	21	0	1	22	0	0
5	67280269	.	C	T	1	21	22	0	26	48	0	0
5	67280329	.	C	A	0	12	12	0	7	19	0	0
5	67280332	.	G	T	5	12	17	0	1	18	0	0
5	67288662	.	A	G	1	5	6	0	0	6	0	0
5	67292110	.	C	T	0	0	0	0	2	2	0	0
5	67292599	.	A	T	2	5	7	0	0	7	0	0
5	67439340	.	T	C	2	2	4	0	0	4	0	0
5	67474362	.	T	C	7	4	11	0	6	17	0	0
5	67474365	.	A	G	9	5	14	0	3	17	0	0
5	67484657	.	C	T	1	1	2	0	0	2	0	0
5	67484741	.	A	T	1	4	5	0	1	6	0	0
5	67839973	.	C	G	0	2	2	0	0	2	0	0
5	67839975	.	A	T	0	2	2	0	0	2	0	0
5	67855969	.	G	A	0	0	0	0	3	3	0	0
5	67857796	.	A	G	3	2	5	0	0	5	0	0
5	67857877	.	T	C	5	3	8	0	1	9	0	0
5	67858727	.	G	A	2	2	4	0	0	4	0	0
5	67859619	.	A	G	2	0	2	0	2	4	0	0
5	67860007	.	A	G	8	6	14	0	0	14	0	0
5	67874988	.	C	T	1	2	3	0	1	4	0	0
5	67884293	.	C	T	3	2	5	0	0	5	0	0
5	67884361	.	A	G	7	8	15	0	0	15	0	0
5	67884436	.	A	G	7	6	13	0	0	13	0	0
5	67884508	.	G	A	5	2	7	0	4	11	0	0
5	67884583	.	G	A	1	7	8	0	0	8	0	0
5	67884688	.	G	T	2	3	5	0	0	5	0	0
5	67884701	.	T	C	3	4	7	0	0	7	0	0
5	67884737	.	A	T	2	4	6	0	0	6	0	0
5	67884779	.	G	A	2	2	4	0	0	4	0	0
5	67885131	.	T	A	4	4	8	0	0	8	0	0
5	67885142	.	G	A	4	5	9	0	0	9	0	0
5	67885294	.	A	G	2	3	5	0	1	6	0	0
5	67885302	.	T	C	3	4	7	0	0	7	0	0
5	67885444	.	G	A	2	5	7	0	0	7	0	0
5	67885526	.	C	T	0	4	4	0	7	11	0	0
5	67910829	.	T	A	1	3	4	0	0	4	0	0
5	67974188	.	C	T	3	3	6	0	0	6	0	0
5	67974464	.	C	T	5	5	10	0	1	11	0	0
5	67974485	.	C	T	3	4	7	0	1	8	0	0
5	67977911	.	G	T	3	4	7	0	0	7	0	0
5	67977914	.	C	T	1	5	6	0	3	9	0	0
5	67978636	.	G	A	6	2	8	0	0	8	0	0
5	67978662	.	G	T	2	2	4	0	5	9	0	0
5	67980543	.	C	T	3	4	7	0	0	7	0	0
5	67980580	.	A	C	4	5	9	0	0	9	0	0
5	67980719	.	G	A	4	3	7	0	0	7	0	0
5	67980720	.	T	A	3	3	6	0	1	7	0	0
5	67982853	.	G	A	0	1	1	0	0	1	0	0
5	68060143	.	T	A	6	13	19	0	2	21	0	0
5	68060365	.	A	T	11	5	16	0	1	17	0	0
5	68060406	.	A	T	6	5	11	0	0	11	0	0
5	68060407	.	C	G	6	4	10	0	1	11	0	0
5	68060578	.	T	C	11	7	18	0	1	19	0	0
5	68060634	.	T	C	3	6	9	0	3	12	0	0
5	68060721	.	T	C	8	0	8	0	11	19	0	0
5	68060789	.	T	G	5	6	11	0	0	11	0	0
5	68066856	.	C	T	9	11	20	0	1	21	0	0
5	68068550	.	C	T	0	6	6	0	13	19	0	0
5	68068574	.	A	G	10	2	12	0	0	12	0	0
5	68069003	.	C	T	0	4	4	0	4	8	0	0
5	68074508	.	G	A	2	4	6	0	0	6	0	0
5	68074565	.	A	G	4	4	8	0	1	9	0	0
5	68076925	.	T	A	13	21	34	0	3	37	0	0
5	68090104	.	G	A	3	9	12	0	0	12	0	0
5	68093051	.	A	C	4	1	5	0	8	13	0	0
5	68409956	.	C	T	0	5	5	0	7	12	0	0
5	68409977	.	T	C	7	1	8	0	6	14	0	0
5	68415142	.	C	T	1	2	3	0	0	3	0	0
5	68552044	.	A	G	1	1	2	0	0	2	0	0
5	68892515	.	A	C	0	2	2	0	0	2	0	0
5	68892872	.	T	C	2	5	7	0	0	7	0	0
5	68892875	.	T	C	4	3	7	0	0	7	0	0
5	69140946	.	A	G	1	2	3	0	0	3	0	0
5	69557616	.	G	A	0	4	4	0	0	4	0	0
5	69607398	.	T	C	0	2	2	0	0	2	0	0
5	69608211	.	G	A	1	1	2	0	0	2	0	0
5	69608223	.	G	A	1	1	2	0	0	2	0	0
5	69708928	.	A	C	0	1	1	0	0	1	0	0
5	69783716	.	A	G	2	6	8	0	1	9	0	0
5	71253179	.	C	T	0	2	2	0	4	6	0	0
5	71253188	.	C	T	3	3	6	0	0	6	0	0
5	71253235	.	A	G	3	2	5	0	0	5	0	0
5	71253236	.	T	C	3	0	3	0	2	5	0	0
6	29439	.	T	C	5	8	13	0	1	14	0	0
6	37919	.	C	T	4	5	9	0	0	9	0	0
6	38264	.	C	G	8	5	13	0	1	14	0	0
6	41065	.	A	T	10	8	18	0	0	18	0	0
6	41164	.	A	G	5	7	12	0	5	17	0	0
6	68277	.	A	T	1	6	7	0	0	7	0	0
6	92359	.	T	G	3	1	4	0	0	4	0	0
6	93840	.	T	C	7	4	11	0	2	13	0	0
6	119616	.	C	A	1	2	3	0	0	3	0	0
6	121239	.	C	T	4	3	7	0	0	7	0	0
6	132157	.	G	C	5	8	13	0	3	16	0	0
6	134267	.	C	G	1	2	3	0	0	3	0	0
6	134270	.	C	T	0	2	2	0	1	3	0	0
6	152680	.	T	A	8	13	21	0	3	24	0	0
6	184361	.	C	T	4	13	17	0	0	17	0	0
6	184382	.	A	G	2	0	2	0	8	10	0	0
6	265188	.	G	T	7	4	11	0	0	11	0	0
6	265191	.	A	T	7	4	11	0	0	11	0	0
6	267412	.	C	T	9	7	16	0	0	16	0	0
6	267417	.	C	G	8	6	14	0	1	15	0	0
6	267501	.	G	C	2	2	4	0	0	4	0	0
6	267564	.	A	G	11	1	12	0	0	12	0	0
6	267568	.	A	G	8	3	11	0	1	12	0	0
6	267645	.	C	T	7	4	11	0	3	14	0	0
6	267669	.	C	T	8	4	12	0	2	14	0	0
6	267732	.	A	G	5	4	9	0	0	9	0	0
6	267817	.	G	A	6	5	11	0	0	11	0	0
6	267884	.	T	C	5	6	11	0	1	12	0	0
6	267886	.	T	C	5	7	12	0	0	12	0	0
6	271793	.	C	A	24	21	45	0	3	48	0	0
6	272041	.	C	T	18	21	39	0	4	44	1	0
6	272056	.	A	G	18	19	37	0	5	42	0	0
6	272298	.	G	A	0	23	23	0	26	49	0	0
6	272503	.	T	C	15	12	27	0	1	28	0	0
6	322371	.	C	T	0	1	1	0	0	1	0	0
6	331909	.	T	A	3	3	6	0	1	7	0	0
6	331912	.	C	T	3	4	7	0	0	7	0	0
6	340480	.	A	C	9	4	13	0	0	13	0	0
6	340488	.	T	C	6	5	11	0	1	12	0	0
6	340670	.	A	G	8	14	22	0	1	23	0	0
6	340800	.	T	G	5	6	11	0	0	11	0	0
6	340839	.	A	G	1	6	7	0	1	8	0	0
6	341882	.	G	A	19	18	37	0	1	38	0	0
6	341933	.	G	A	23	26	49	0	2	51	0	0
6	341953	.	C	T	21	32	53	0	1	54	0	0
6	342017	.	T	A	18	24	42	0	2	44	0	0
6	342123	.	C	T	19	15	34	0	2	36	0	0
6	374956	.	T	A	8	9	17	0	1	19	1	0
6	374988	.	G	T	12	8	20	0	1	21	0	0
6	375007	.	A	C	12	7	19	0	1	20	0	0
6	375051	.	T	C	5	3	8	0	0	8	0	0
6	840792	.	C	G	13	22	35	0	2	37	0	0
6	841511	.	T	C	8	8	16	0	0	16	0	0
6	841557	.	A	G	7	6	13	0	3	16	0	0
6	841851	.	T	C	12	15	27	0	0	27	0	0
6	841941	.	G	A	8	7	15	0	1	16	0	0
6	842009	.	G	A	10	10	20	0	1	21	0	0
6	842010	.	C	T	0	11	11	0	10	21	0	0
6	842241	.	T	C	5	6	11	0	0	11	0	0
6	842301	.	T	C	5	1	6	0	1	7	0	0
6	842309	.	T	A	6	3	9	0	0	9	0	0
6	842343	.	C	T	2	5	7	0	0	7	0	0
6	842791	.	C	A	5	6	11	0	1	12	0	0
6	842816	.	A	C	5	6	11	0	0	11	0	0
6	843745	.	C	A	4	2	6	0	1	7	0	0
6	843978	.	T	A	0	2	2	0	0	2	0	0
6	844388	.	A	G	1	3	4	0	1	5	0	0
6	858128	.	C	T	0	2	2	0	2	4	0	0
6	1511685	.	A	G	3	4	7	0	1	8	0	0
6	1554299	.	T	G	3	4	7	0	0	7	0	0
6	1554922	.	A	T	3	3	6	0	0	6	0	0
6	2121397	.	A	T	1	5	6	0	0	6	0	0
6	2121446	.	C	T	1	4	5	0	0	5	0	0
6	2121461	.	C	T	2	2	4	0	1	5	0	0
6	2165566	.	T	C	3	4	7	0	1	8	0	0
6	2165955	.	A	G	1	5	6	0	0	6	0	0
6	2166074	.	G	A	1	2	3	0	0	3	0	0
6	2166085	.	T	G	1	3	4	0	0	4	0	0
6	2166157	.	G	A	4	2	6	0	1	7	0	0
6	2166240	.	T	C	9	0	9	0	2	11	0	0
6	2166287	.	A	T	1	0	1	0	0	1	0	0
6	2206884	.	G	A	4	8	12	0	0	12	0	0
6	2207189	.	G	T	0	2	2	0	0	2	0	0
6	2208479	.	T	G	1	4	5	0	0	5	0	0
6	2208522	.	T	C	2	4	6	0	0	6	0	0
6	2208562	.	C	T	5	3	8	0	1	9	0	0
6	2208609	.	C	T	1	5	6	0	0	6	0	0
6	2453730	.	T	C	1	1	2	0	0	2	0	0
6	2453751	.	A	C	2	2	4	0	0	4	0	0
6	2620078	.	C	G	2	5	7	0	1	8	0	0
6	2621637	.	C	G	0	2	2	0	2	4	0	0
6	2621656	.	G	A	5	3	8	0	1	9	0	0
6	2621677	.	C	T	6	3	9	0	1	10	0	0
6	2621719	.	T	A	2	4	6	0	0	6	0	0
6	2623378	.	G	C	0	1	1	0	0	1	0	0
6	2624527	.	G	C	3	2	5	0	0	5	0	0
6	3197028	.	C	T	1	4	5	0	0	5	0	0
6	3205538	.	T	C	2	2	4	0	0	4	0	0
6	3270011	.	G	A	5	3	8	0	0	8	0	0
6	3273341	.	T	A	6	7	13	0	0	13	0	0
6	3273379	.	A	G	6	8	14	0	0	14	0	0
6	3273588	.	A	T	6	9	15	0	3	18	0	0
6	3273826	.	A	T	21	12	33	0	2	35	0	0
6	3273965	.	C	T	17	22	39	0	3	42	0	0
6	3273986	.	T	C	18	20	38	0	1	39	0	0
6	3274114	.	G	C	1	21	22	0	18	40	0	0
6	3274289	.	C	T	20	20	40	0	1	41	0	0
6	3398906	.	A	G	0	3	3	0	0	3	0	0
6	3404956	.	G	A	0	2	2	0	2	4	0	0
6	3405191	.	G	C	4	3	7	0	0	7	0	0
6	3405244	.	A	G	2	6	8	0	0	8	0	0
6	3405245	.	C	A	2	5	7	0	1	8	0	0
6	3514481	.	A	C	15	21	36	0	4	40	0	0
6	3704391	.	G	A	0	1	1	0	1	2	0	0
6	3707095	.	A	G	3	3	6	0	0	6	0	0
6	3707116	.	G	A	5	5	10	0	0	10	0	0
6	3707371	.	G	A	0	8	8	0	10	18	0	0
6	3707372	.	A	G	9	6	15	0	3	18	0	0
6	3707407	.	T	C	9	7	16	0	1	17	0	0
6	3708061	.	A	G	5	9	14	0	0	14	0	0
6	3708149	.	T	C	6	12	18	0	1	19	0	0
6	3712136	.	G	A	1	4	5	0	0	5	0	0
6	3712713	.	C	G	1	3	4	0	0	4	0	0
6	3724870	.	A	C	0	5	5	0	1	6	0	0
6	3725767	.	C	A	5	7	12	0	1	13	0	0
6	3727891	.	C	T	7	9	16	0	0	16	0	0
6	3728295	.	A	T	4	4	8	0	0	8	0	0
6	3728559	.	G	C	4	7	11	0	0	11	0	0
6	3834630	.	G	C	4	5	9	0	0	9	0	0
6	3853120	.	T	G	7	0	7	0	11	18	0	0
6	3853165	.	T	C	7	11	18	0	1	19	0	0
6	3862018	.	A	G	10	11	21	0	5	26	0	0
6	3869454	.	G	A	0	1	1	0	0	1	0	0
6	3869891	.	C	T	2	1	3	0	0	3	0	0
6	3871982	.	T	A	3	3	6	0	0	6	0	0
6	3874504	.	G	A	0	16	16	0	20	36	0	0
6	3874533	.	C	T	14	21	35	0	1	36	0	0
6	3874686	.	A	G	14	10	24	0	0	24	0	0
6	3878593	.	A	G	4	7	11	0	1	12	0	0
6	3878831	.	G	C	4	4	8	0	1	9	0	0
6	3878983	.	A	T	6	4	10	0	3	13	0	0
6	3879247	.	C	A	0	11	11	0	7	18	0	0
6	3879314	.	C	G	0	2	2	0	9	11	0	0
6	3879335	.	C	T	4	4	8	0	1	9	0	0
6	3879367	.	G	A	2	3	5	0	0	5	0	0
6	3881078	.	G	A	4	2	6	0	0	6	0	0
6	3881194	.	C	T	1	1	2	0	0	2	0	0
6	3961387	.	G	A	9	6	15	0	0	15	0	0
6	3962132	.	G	A	14	13	27	0	1	28	0	0
6	3962192	.	A	T	10	4	14	0	0	14	0	0
6	3984909	.	T	A	5	3	8	0	1	9	0	0
6	3985083	.	G	A	8	10	18	0	1	19	0	0
6	3985137	.	G	A	10	14	24	0	1	25	0	0
6	3987131	.	A	G	1	2	3	0	0	3	0	0
6	4185678	.	G	A	3	5	8	0	1	9	0	0
6	4247442	.	C	G	1	3	4	0	0	4	0	0
6	4249420	.	C	T	0	6	6	0	0	6	0	0
6	4249437	.	A	G	0	4	4	0	0	4	0	0
6	4249684	.	A	G	3	6	9	0	0	9	0	0
6	4250046	.	A	T	2	3	5	0	1	6	0	0
6	4386999	.	C	T	2	2	4	0	0	4	0	0
6	4397173	.	G	A	9	6	15	0	2	17	0	0
6	4397181	.	C	A	7	11	18	0	1	19	0	0
6	4397262	.	C	T	2	0	2	0	0	2	0	0
6	4398906	.	C	T	3	6	9	0	1	10	0	0
6	4398939	.	A	C	0	4	4	0	2	6	0	0
6	4400652	.	A	T	4	4	8	0	0	8	0	0
6	4400803	.	T	A	3	5	8	0	0	8	0	0
6	4400999	.	C	T	5	3	8	0	1	9	0	0
6	4401087	.	T	A	0	6	6	0	0	6	0	0
6	4401088	.	A	T	0	5	5	0	1	6	0	0
6	4416859	.	G	A	5	4	9	0	0	9	0	0
6	4541178	.	T	C	1	3	4	0	0	4	0	0
6	4542573	.	A	C	11	4	15	0	0	15	0	0
6	6231186	.	C	A	3	1	4	0	0	4	0	0
6	6231244	.	T	C	2	4	6	0	0	6	0	0
6	6231321	.	C	A	1	3	4	0	0	4	0	0
6	6231337	.	A	C	1	3	4	0	0	4	0	0
6	6232301	.	A	C	23	11	34	0	5	39	0	0
6	6234779	.	A	G	0	0	0	0	0	0	0	0
6	6270882	.	G	C	2	3	5	0	1	6	0	0
6	6273345	.	C	T	28	36	64	0	3	67	0	0
6	6273396	.	C	T	27	32	59	0	5	64	0	0
6	6275599	.	A	G	2	5	7	0	1	8	0	0
6	6275667	.	C	T	1	9	10	0	0	10	0	0
6	6275668	.	A	G	1	9	10	0	0	10	0	0
6	6284114	.	A	G	4	3	7	0	1	8	0	0
6	6459235	.	T	C	2	2	4	0	1	5	0	0
6	6459315	.	G	A	1	1	2	0	0	2	0	0
6	6665965	.	G	A	1	3	4	0	0	4	0	0
6	6671545	.	G	C	3	3	6	0	1	7	0	0
6	6737391	.	C	T	12	18	30	0	3	33	0	0
6	6737401	.	G	T	13	13	26	0	0	26	0	0
6	6737982	.	T	A	12	11	23	0	1	24	0	0
6	6737998	.	C	T	0	12	12	0	12	24	0	0
6	6769345	.	T	A	4	4	8	0	2	10	0	0
6	6769716	.	C	T	2	3	5	0	2	7	0	0
6	6769719	.	T	C	2	2	4	0	2	6	0	0
6	6769782	.	A	G	1	0	1	0	0	1	0	0
6	6785788	.	G	A	1	1	2	0	0	2	0	0
6	6793164	.	C	T	8	5	13	0	0	13	0	0
6	6793224	.	G	A	0	2	2	0	4	6	0	0
6	6795520	.	T	A	3	2	5	0	0	5	0	0
6	6795526	.	C	T	2	3	5	0	0	5	0	0
6	6795664	.	T	C	5	11	16	0	1	17	0	0
6	6797583	.	A	G	6	6	12	0	1	13	0	0
6	6797598	.	T	C	8	7	15	0	1	16	0	0
6	6797694	.	T	A	6	7	13	0	0	13	0	0
6	6800031	.	G	T	4	4	8	0	0	8	0	0
6	6800091	.	A	G	2	4	6	0	0	6	0	0
6	6800107	.	T	A	1	5	6	0	0	6	0	0
6	6803534	.	T	A	0	1	1	0	0	1	0	0
6	6803726	.	T	A	2	3	5	0	0	5	0	0
6	6805275	.	G	A	6	5	11	0	0	11	0	0
6	6805477	.	T	C	3	6	9	0	0	9	0	0
6	6805572	.	G	T	8	18	26	0	0	26	0	0
6	6808217	.	A	G	1	2	3	0	0	3	0	0
6	6808431	.	C	G	4	5	9	0	0	9	0	0
6	6921577	.	C	T	7	8	15	0	2	17	0	0
6	6921581	.	T	C	8	6	14	0	1	15	0	0
6	6921802	.	G	A	16	19	35	1	2	38	0	0
6	6921889	.	T	A	13	15	28	0	2	30	0	0
6	6922072	.	G	T	11	16	27	0	1	28	0	0
6	6922187	.	T	C	12	16	28	0	1	29	0	0
6	6973009	.	A	T	12	12	24	0	1	25	0	0
6	6973383	.	G	T	4	5	9	0	2	11	0	0
6	7086134	.	G	C	3	2	5	0	0	5	0	0
6	7105400	.	C	T	1	2	3	0	0	3	0	0
6	7110148	.	C	T	10	7	17	0	2	19	0	0
6	7110434	.	C	T	6	10	16	0	1	17	0	0
6	7110435	.	T	G	7	10	17	0	0	17	0	0
6	7110551	.	C	T	17	14	31	0	0	31	0	0
6	7113001	.	T	G	0	1	1	0	1	2	0	0
6	7114482	.	C	T	1	0	1	0	0	1	0	0
6	7114937	.	A	G	0	0	0	0	1	1	0	0
6	7115967	.	T	C	1	1	2	0	0	2	0	0
6	7251362	.	A	T	1	4	5	0	0	5	0	0
6	7251426	.	A	G	5	2	7	0	1	8	0	0
6	7251627	.	A	G	2	3	5	0	0	5	0	0
6	7251694	.	G	A	1	4	5	0	0	5	0	0
6	7265179	.	G	A	0	1	1	0	0	1	0	0
6	7270355	.	T	C	7	3	10	0	0	10	0	0
6	7273021	.	C	T	1	1	2	0	0	2	0	0
6	7273512	.	T	A	3	2	5	0	1	6	0	0
6	7273518	.	G	A	0	3	3	0	2	5	0	0
6	7276139	.	T	C	2	7	9	0	1	10	0	0
6	7276178	.	T	A	5	12	17	0	0	17	0	0
6	7276212	.	C	T	6	8	14	0	2	16	0	0
6	7276263	.	G	A	0	9	9	0	9	18	0	0
6	7276776	.	A	C	6	2	8	0	0	8	0	0
6	7435565	.	C	T	1	3	4	0	0	4	0	0
6	7438474	.	C	T	3	4	7	0	0	7	0	0
6	7451563	.	T	G	1	1	2	0	0	2	0	0
6	7545794	.	C	T	1	2	3	0	0	3	0	0
6	7545824	.	T	C	2	2	4	0	0	4	0	0
6	7549967	.	G	A	3	5	8	0	0	8	0	0
6	7550405	.	C	T	12	9	21	0	2	23	0	0
6	7551087	.	C	A	3	8	11	0	2	13	0	0
6	7626457	.	C	T	0	2	2	0	0	2	0	0
6	7636811	.	A	T	1	4	5	0	0	5	0	0
6	7637195	.	C	T	2	2	4	0	0	4	0	0
6	7638717	.	G	A	4	3	7	0	0	7	0	0
6	7646039	.	A	G	3	1	4	0	0	4	0	0
6	7646102	.	G	A	7	4	11	0	1	12	0	0
6	7646111	.	G	C	6	3	9	0	0	9	0	0
6	7652458	.	C	T	7	4	11	0	0	11	0	0
6	7652470	.	A	C	6	3	9	0	0	9	0	0
6	7652896	.	G	A	0	14	14	0	7	21	0	0
6	7652959	.	C	T	9	9	18	0	1	19	0	0
6	7652989	.	C	T	5	4	9	0	0	9	0	0
6	7656932	.	A	G	13	14	27	0	3	30	0	0
6	7657177	.	C	T	11	5	16	0	0	16	0	0
6	7657793	.	A	C	16	13	29	0	1	30	0	0
6	7657886	.	T	A	16	15	31	0	3	34	0	0
6	7657887	.	G	T	17	17	34	0	0	34	0	0
6	7657972	.	T	G	18	10	28	0	0	28	0	0
6	7658076	.	G	A	20	10	30	0	2	32	0	0
6	7659915	.	G	A	12	10	22	0	0	22	0	0
6	7660063	.	C	A	7	1	8	0	0	8	0	0
6	7660119	.	A	G	7	11	18	0	0	18	0	0
6	7660369	.	T	C	1	2	3	0	0	3	0	0
6	7660594	.	C	T	4	4	8	0	2	10	0	0
6	7660659	.	C	A	0	4	4	0	2	6	0	0
6	7688757	.	A	C	2	0	2	0	7	9	0	0
6	7697573	.	G	A	0	1	1	0	0	1	0	0
6	7713350	.	A	T	7	4	11	0	0	11	0	0
6	7713433	.	G	A	24	20	44	0	2	46	0	0
6	7721530	.	T	A	5	6	11	0	1	12	0	0
6	7721860	.	G	A	4	2	6	0	0	6	0	0
6	7721906	.	G	A	4	15	19	0	1	20	0	0
6	7721958	.	C	A	7	13	20	0	0	20	0	0
6	7722143	.	G	T	14	4	18	0	1	19	0	0
6	7722159	.	A	T	14	5	19	0	3	22	0	0
6	7722195	.	G	T	8	9	17	0	0	17	0	0
6	7722205	.	G	A	9	8	17	0	0	17	0	0
6	7722387	.	T	C	6	4	10	0	2	12	0	0
6	7722402	.	T	C	4	4	8	0	4	12	0	0
6	7722577	.	C	T	0	10	10	0	4	14	0	0
6	7723008	.	G	T	2	4	6	0	0	6	0	0
6	7723155	.	A	C	2	3	5	0	0	5	0	0
6	7723232	.	A	T	4	2	6	0	0	6	0	0
6	7795698	.	C	T	3	1	4	0	0	4	0	0
6	8177399	.	T	C	1	2	3	0	0	3	0	0
6	8178113	.	T	C	3	3	6	0	1	7	0	0
6	8178351	.	G	A	2	3	5	0	0	5	0	0
6	8179022	.	G	T	0	6	6	0	5	11	0	0
6	8179205	.	A	T	5	9	14	0	0	14	0	0
6	8179373	.	G	A	12	10	22	0	2	24	0	0
6	8210404	.	C	T	2	9	11	0	0	11	0	0
6	8210487	.	T	C	1	3	4	0	0	4	0	0
6	8210488	.	G	A	1	3	4	0	0	4	0	0
6	8211075	.	C	T	4	3	7	0	0	7	0	0
6	8211143	.	A	T	4	2	6	0	0	6	0	0
6	8211154	.	T	C	4	2	6	0	0	6	0	0
6	8211253	.	G	A	3	4	7	0	1	8	0	0
6	8214044	.	G	A	1	0	1	0	0	1	0	0
6	8214045	.	T	G	1	0	1	0	0	1	0	0
6	8265214	.	G	A	5	5	10	0	1	11	0	0
6	8265282	.	G	A	8	6	14	0	1	15	0	0
6	8267266	.	A	G	8	7	15	0	2	17	0	0
6	8267284	.	G	A	4	7	11	0	1	12	0	0
6	8267307	.	G	C	2	4	6	0	0	6	0	0
6	8267352	.	A	T	3	2	5	0	1	6	0	0
6	8267519	.	G	A	5	5	10	0	5	15	0	0
6	8267563	.	G	T	8	9	17	0	0	17	0	0
6	8267635	.	T	C	4	8	12	0	1	13	0	0
6	8268529	.	A	G	1	2	3	0	0	3	0	0
6	8315076	.	A	G	2	0	2	0	0	2	0	0
6	8315078	.	A	G	2	0	2	0	0	2	0	0
6	8328181	.	G	T	9	15	24	0	1	25	0	0
6	8365753	.	T	C	3	3	6	0	1	7	0	0
6	8366006	.	A	T	7	7	14	0	2	16	0	0
6	8366167	.	C	T	16	14	30	0	3	33	0	0
6	8370489	.	T	C	7	5	12	0	1	13	0	0
6	8374716	.	G	A	3	11	14	0	0	14	0	0
6	8375089	.	C	T	12	11	23	1	1	25	0	0
6	8380433	.	G	C	1	2	3	0	0	3	0	0
6	9130575	.	A	G	4	17	21	0	2	23	0	0
6	9130596	.	A	G	4	0	4	0	7	11	0	0
6	9455329	.	A	T	4	2	6	0	1	7	0	0
6	9668582	.	A	G	3	2	5	0	0	5	0	0
6	10000936	.	A	C	0	2	2	0	0	2	0	0
6	10008398	.	A	G	11	5	16	0	1	17	0	0
6	10008407	.	C	T	9	4	13	0	1	14	0	0
6	10009850	.	C	T	12	14	26	0	1	27	0	0
6	10009903	.	A	T	17	12	29	0	0	29	0	0
6	10015602	.	T	C	16	14	30	0	6	36	0	0
6	10015794	.	A	T	18	8	26	1	5	32	0	0
6	10015902	.	A	T	29	24	53	0	2	55	0	0
6	10015952	.	C	A	35	22	57	0	1	58	0	0
6	10015992	.	A	C	28	26	54	0	4	58	0	0
6	10015993	.	G	A	28	27	55	0	4	59	0	0
6	10016114	.	C	T	27	14	41	0	3	44	0	0
6	10016116	.	C	A	26	15	41	0	3	44	0	0
6	10016174	.	T	G	19	15	34	0	9	43	0	0
6	10016363	.	T	G	29	16	45	0	4	53	4	0
6	10020055	.	G	A	9	8	17	0	3	20	0	0
6	10026677	.	C	T	1	7	8	0	0	8	0	0
6	10050050	.	G	A	2	5	7	0	0	7	0	0
6	10056466	.	G	T	17	21	38	0	1	39	0	0
6	10248530	.	A	G	2	2	4	0	0	4	0	0
6	10248546	.	T	C	0	0	0	0	2	2	0	0
6	10248980	.	A	G	2	5	7	0	1	8	0	0
6	10701627	.	C	T	6	2	8	0	1	9	0	0
6	10701642	.	C	A	0	6	6	0	1	7	0	0
6	10705814	.	C	T	0	2	2	0	2	4	0	0
6	10705815	.	G	T	2	2	4	0	0	4	0	0
6	10706871	.	A	G	1	2	3	0	0	3	0	0
6	10709697	.	A	G	0	0	0	0	1	1	0	0
6	10721767	.	C	T	18	0	18	0	0	18	0	0
6	10721971	.	T	G	5	9	14	0	0	14	0	0
6	10724275	.	G	A	2	3	5	0	0	5	0	0
6	10724591	.	G	T	5	3	8	0	0	8	0	0
6	10724645	.	A	T	1	4	5	0	0	5	0	0
6	10741432	.	G	T	2	5	7	0	0	7	0	0
6	10741616	.	A	G	1	3	4	0	0	4	0	0
6	10741853	.	T	G	1	2	3	0	2	5	0	0
6	10741916	.	G	C	9	9	18	0	1	19	0	0
6	10742120	.	T	C	17	11	28	0	0	28	0	0
6	10742121	.	G	A	17	11	28	0	0	28	0	0
6	10742306	.	A	G	13	17	30	0	2	32	0	0
6	10742318	.	G	A	12	10	22	0	2	24	0	0
6	10831093	.	G	A	25	25	50	0	1	51	0	0
6	10833078	.	T	C	16	0	16	0	19	35	0	0
6	10834821	.	G	C	4	2	6	0	0	6	0	0
6	10838690	.	C	T	0	2	2	0	5	7	0	0
6	10838716	.	A	C	4	3	7	0	0	7	0	0
6	10838741	.	G	A	2	3	5	0	0	5	0	0
6	10838753	.	T	C	1	4	5	0	1	6	0	0
6	10839885	.	C	A	0	8	8	0	8	16	0	0
6	10846001	.	G	A	1	0	1	0	0	1	0	0
6	10879525	.	T	C	5	3	8	0	0	8	0	0
6	10879633	.	T	C	13	14	27	0	2	29	0	0
6	10879679	.	G	A	14	10	24	0	1	25	0	0
6	10879816	.	A	T	7	14	21	0	2	23	0	0
6	10879833	.	A	G	12	0	12	0	18	30	0	0
6	10910684	.	G	A	5	13	18	0	3	21	0	0
6	10910784	.	C	A	21	22	43	0	5	48	0	0
6	10911066	.	T	C	30	22	52	0	3	55	0	0
6	10911198	.	A	G	15	16	31	0	1	32	0	0
6	10912341	.	G	A	13	10	23	0	2	25	0	0
6	10982902	.	A	G	4	6	10	0	0	10	0	0
6	10982984	.	G	T	2	2	4	0	1	5	0	0
6	10983066	.	T	C	1	2	3	0	1	4	0	0
6	10983433	.	A	C	1	2	3	0	0	3	0	0
6	11067480	.	A	G	1	2	3	0	0	3	0	0
6	11071222	.	A	G	12	27	39	0	7	46	0	0
6	11259970	.	C	A	7	6	13	0	3	16	0	0
6	11265612	.	G	T	0	9	9	0	9	18	0	0
6	11265681	.	T	A	11	12	23	0	1	24	0	0
6	11265717	.	T	C	9	14	23	0	0	23	0	0
6	11265899	.	A	G	11	1	12	0	2	14	0	0
6	11266104	.	A	G	4	14	18	0	0	18	0	0
6	11266111	.	A	G	8	0	8	0	12	20	0	0
6	11266255	.	C	T	16	13	29	0	2	31	0	0
6	11266490	.	A	T	7	5	12	0	0	12	0	0
6	11266496	.	T	C	6	4	10	0	1	11	0	0
6	11276827	.	T	A	4	3	7	0	1	8	0	0
6	11276912	.	A	G	2	0	2	0	0	2	0	0
6	11279804	.	T	C	4	4	8	0	0	8	0	0
6	11279815	.	T	C	3	2	5	0	0	5	0	0
6	11281923	.	A	G	2	2	4	0	0	4	0	0
6	11282371	.	A	T	1	2	3	0	0	3	0	0
6	11285310	.	C	T	3	2	5	0	1	6	0	0
6	11285583	.	C	T	5	3	8	0	0	8	0	0
6	11285716	.	G	A	4	3	7	0	0	7	0	0
6	11299909	.	C	T	1	2	3	0	0	3	0	0
6	11410523	.	C	T	3	2	5	0	0	5	0	0
6	11413532	.	A	T	1	0	1	0	0	1	0	0
6	11414715	.	C	T	4	8	12	0	0	12	0	0
6	11414748	.	G	A	6	3	9	0	1	10	0	0
6	11415220	.	A	C	20	18	38	0	1	40	1	0
6	11765506	.	A	G	22	19	41	0	4	45	0	0
6	11766190	.	T	A	13	7	20	0	0	20	0	0
6	11766267	.	G	A	6	12	18	0	1	19	0	0
6	11766276	.	A	G	7	13	20	0	1	21	0	0
6	11766765	.	T	C	0	1	1	0	0	1	0	0
6	12529247	.	C	T	1	1	2	0	0	2	0	0
6	12550437	.	G	A	2	2	4	0	0	4	0	0
6	12550764	.	G	A	9	5	14	0	0	14	0	0
6	12550934	.	C	T	11	19	30	0	1	31	0	0
6	13277694	.	A	T	6	1	7	0	1	8	0	0
6	13869343	.	A	C	0	11	11	0	3	14	0	0
6	13908627	.	T	C	4	2	6	0	0	6	0	0
6	14951854	.	C	T	10	6	16	0	2	18	0	0
6	14952579	.	T	C	6	12	18	0	1	19	0	0
6	15023688	.	G	A	7	4	11	0	1	12	0	0
6	15023713	.	A	G	5	1	6	0	0	6	0	0
6	15037258	.	A	G	0	2	2	0	0	2	0	0
6	15127591	.	G	A	0	2	2	0	4	6	0	0
6	15130982	.	G	A	0	4	4	0	1	5	0	0
6	15242680	.	C	T	1	6	7	0	1	8	0	0
6	15242693	.	G	A	3	6	9	0	0	9	0	0
6	15243129	.	T	C	1	3	4	0	1	5	0	0
6	15243137	.	A	C	3	1	4	0	0	4	0	0
6	15434544	.	T	A	7	15	22	0	0	22	0	0
6	15446948	.	G	A	1	0	1	0	0	1	0	0
6	15447202	.	T	C	3	2	5	0	0	5	0	0
6	15447203	.	A	G	3	0	3	0	2	5	0	0
6	15447603	.	G	A	1	3	4	0	1	5	0	0
6	15752417	.	A	C	1	3	4	0	0	4	0	0
6	15824535	.	A	G	1	2	3	0	0	3	0	0
6	16043999	.	T	C	17	15	32	0	1	33	0	0
6	16044282	.	A	G	11	11	22	0	2	24	0	0
6	16044664	.	T	C	11	9	20	0	1	21	0	0
6	16045511	.	G	A	5	7	12	0	0	12	0	0
6	16045516	.	G	C	5	9	14	0	0	14	0	0
6	16045798	.	T	C	3	2	5	0	1	6	0	0
6	16045912	.	T	C	1	0	1	0	8	9	0	0
6	16046025	.	T	A	2	6	8	0	1	9	0	0
6	16046110	.	T	C	4	4	8	0	1	9	0	0
6	16046115	.	T	C	7	2	9	0	0	9	0	0
6	16046547	.	A	T	2	2	4	0	1	6	1	0
6	16046554	.	G	C	2	2	4	0	3	7	0	0
6	16046761	.	A	C	3	1	4	0	1	5	0	0
6	16046934	.	A	C	4	6	10	0	0	10	0	0
6	16047197	.	C	T	0	2	2	0	1	3	0	0
6	16474381	.	T	C	1	2	3	0	0	3	0	0
6	16475185	.	C	T	8	7	15	0	1	16	0	0
6	16475269	.	C	G	2	5	7	0	0	7	0	0
6	16475611	.	A	C	1	3	4	0	1	5	0	0
6	16485073	.	A	T	2	4	6	0	0	6	0	0
6	16491056	.	G	A	4	3	7	0	0	7	0	0
6	16493415	.	T	C	7	6	13	0	0	13	0	0
6	16499206	.	G	A	4	2	6	0	0	6	0	0
6	16499422	.	A	G	2	1	3	0	2	5	0	0
6	16499428	.	G	A	3	3	6	0	0	6	0	0
6	17726078	.	G	A	2	2	4	0	5	9	0	0
6	18203782	.	C	A	19	17	36	0	4	40	0	0
6	18203812	.	C	A	0	16	16	0	20	36	0	0
6	18204420	.	A	G	6	3	9	0	1	10	0	0
6	18244879	.	A	T	1	6	7	0	0	7	0	0
6	18274076	.	G	A	0	1	1	0	1	2	0	0
6	18361444	.	C	G	2	7	9	0	1	10	0	0
6	18361729	.	G	C	3	4	7	0	0	7	0	0
6	18364090	.	T	C	4	3	7	0	2	9	0	0
6	18364543	.	A	T	8	2	10	0	0	10	0	0
6	18388835	.	C	A	6	5	11	0	0	11	0	0
6	18388975	.	G	A	2	3	5	0	1	6	0	0
6	18389655	.	G	A	1	3	4	0	0	4	0	0
6	18436500	.	C	T	0	1	1	0	0	1	0	0
6	18436880	.	C	A	1	1	2	0	0	2	0	0
6	18436966	.	G	A	3	4	7	0	1	8	0	0
6	18436969	.	T	C	4	4	8	0	0	8	0	0
6	18439222	.	C	T	9	6	15	0	0	15	0	0
6	18439481	.	A	T	6	8	14	0	0	14	0	0
6	18439540	.	G	A	9	3	12	0	0	12	0	0
6	18439576	.	A	G	5	8	13	0	2	15	0	0
6	18439683	.	C	T	6	9	15	0	1	16	0	0
6	18439723	.	G	A	7	4	11	0	3	14	0	0
6	18440051	.	A	G	1	3	4	0	1	5	0	0
6	18526754	.	G	T	1	0	1	0	0	1	0	0
6	18529457	.	G	A	1	0	1	0	0	1	0	0
6	18540911	.	T	C	2	5	7	0	0	7	0	0
6	18540932	.	C	T	1	4	5	0	1	6	0	0
6	18543253	.	G	A	0	2	2	0	4	6	0	0
6	18543385	.	C	T	6	10	16	0	1	17	0	0
6	18543735	.	A	G	2	7	9	0	2	11	0	0
6	18544060	.	C	T	5	3	8	0	1	9	0	0
6	18544301	.	T	A	12	8	20	0	0	20	0	0
6	18554208	.	G	A	6	4	10	0	0	10	0	0
6	18554482	.	A	T	1	1	2	0	1	3	0	0
6	18554580	.	C	T	2	3	5	0	0	5	0	0
6	18589067	.	C	T	1	1	2	0	0	2	0	0
6	18589090	.	T	C	3	2	5	0	0	5	0	0
6	18592209	.	G	A	2	6	8	0	0	8	0	0
6	18594539	.	A	C	8	3	11	0	2	13	0	0
6	18594604	.	C	T	3	6	9	0	0	9	0	0
6	18594656	.	T	C	2	5	7	0	0	7	0	0
6	18594867	.	G	A	1	2	3	0	0	3	0	0
6	18595346	.	G	A	1	3	4	0	0	4	0	0
6	18595391	.	C	A	1	4	5	0	0	5	0	0
6	18600213	.	A	G	2	5	7	0	1	8	0	0
6	18600234	.	T	G	3	3	6	0	0	6	0	0
6	18600288	.	C	T	0	2	2	0	3	5	0	0
6	18606135	.	T	G	10	12	22	0	0	22	0	0
6	18606230	.	G	T	12	20	32	0	3	35	0	0
6	18607151	.	G	A	9	9	18	0	1	19	0	0
6	18607557	.	C	T	5	12	17	0	1	18	0	0
6	18618051	.	C	T	6	2	8	0	0	8	0	0
6	18623673	.	C	G	1	4	5	0	0	5	0	0
6	18624371	.	A	G	3	2	5	0	0	5	0	0
6	18624426	.	C	T	7	3	10	0	1	11	0	0
6	18624464	.	T	A	7	5	12	0	0	12	0	0
6	18625021	.	G	A	4	4	8	0	0	8	0	0
6	18625062	.	G	A	2	4	6	0	1	7	0	0
6	18714845	.	A	C	1	2	3	0	0	3	0	0
6	18715090	.	A	G	1	2	3	0	0	3	0	0
6	18716551	.	T	C	1	2	3	0	0	3	0	0
6	18936455	.	T	C	5	1	6	0	8	14	0	0
6	19295015	.	T	A	11	22	33	0	0	33	0	0
6	19295044	.	A	T	14	21	35	0	0	35	0	0
6	19295087	.	A	T	18	15	33	0	1	34	0	0
6	19295169	.	C	T	0	11	11	0	14	25	0	0
6	19295454	.	C	T	18	11	29	0	4	33	0	0
6	19295625	.	T	A	11	9	20	0	0	20	0	0
6	19334715	.	C	T	0	1	1	0	4	5	0	0
6	19334753	.	T	A	5	1	6	0	0	6	0	0
6	19334899	.	A	G	3	3	6	0	0	6	0	0
6	19344862	.	T	C	6	4	10	0	0	10	0	0
6	19344950	.	C	T	5	10	15	0	2	17	0	0
6	19667869	.	C	T	1	2	3	0	0	3	0	0
6	19667892	.	T	C	2	2	4	0	0	4	0	0
6	19715552	.	G	A	0	2	2	0	2	4	0	0
6	19802145	.	G	T	0	4	4	0	8	12	0	0
6	19802148	.	C	A	8	3	11	0	0	11	0	0
6	19804213	.	A	C	2	3	5	0	0	5	0	0
6	19804743	.	A	T	4	7	11	0	1	12	0	0
6	19804875	.	A	G	4	2	6	0	0	6	0	0
6	19804882	.	C	T	4	2	6	0	0	6	0	0
6	19805628	.	T	C	3	2	5	0	1	6	0	0
6	20766136	.	C	T	8	10	18	0	2	20	0	0
6	20766299	.	G	A	20	18	38	0	2	40	0	0
6	20766352	.	C	T	16	18	34	0	0	34	0	0
6	20766449	.	G	A	13	12	25	0	2	27	0	0
6	20766565	.	C	G	0	19	19	0	15	34	0	0
6	20767167	.	C	A	10	6	16	0	1	17	0	0
6	20767502	.	A	G	12	13	25	0	0	25	0	0
6	20767537	.	A	G	18	13	31	0	1	32	0	0
6	20767910	.	A	G	4	3	7	0	0	7	0	0
6	20767994	.	T	C	3	5	8	0	0	8	0	0
6	20768061	.	A	G	5	6	11	0	0	11	0	0
6	20768239	.	A	G	2	5	7	0	3	10	0	0
6	20768407	.	A	T	3	3	6	0	0	6	0	0
6	20918615	.	C	T	3	2	5	0	0	5	0	0
6	20921724	.	T	G	13	10	23	0	1	24	0	0
6	20921888	.	T	C	6	5	11	0	0	11	0	0
6	20921919	.	G	A	3	7	10	0	1	11	0	0
6	20921974	.	A	G	5	8	13	0	0	13	0	0
6	20922057	.	A	T	9	4	13	0	0	13	0	0
6	20922271	.	G	T	4	1	5	0	1	6	0	0
6	20996705	.	C	T	3	2	5	0	0	5	0	0
6	20996733	.	A	C	2	3	5	0	7	12	0	0
6	20997166	.	C	T	8	3	11	0	0	11	0	0
6	20997529	.	A	T	2	4	6	0	1	7	0	0
6	21009270	.	T	A	2	3	5	0	0	5	0	0
6	21009340	.	G	A	1	2	3	0	1	4	0	0
6	21119949	.	T	C	0	2	2	0	0	2	0	0
6	21146633	.	G	A	1	2	3	0	0	3	0	0
6	21146648	.	G	A	1	1	2	0	1	3	0	0
6	21149337	.	G	A	0	1	1	0	0	1	0	0
6	21149353	.	G	C	0	1	1	0	0	1	0	0
6	21150661	.	T	C	2	2	4	0	0	4	0	0
6	21150772	.	A	T	7	6	13	0	0	13	0	0
6	21150958	.	A	G	2	4	6	0	0	6	0	0
6	21151027	.	A	G	3	4	7	0	2	10	1	0
6	21151078	.	T	C	6	4	10	0	0	10	0	0
6	21151379	.	A	C	1	4	5	0	1	6	0	0
6	21151415	.	T	C	3	5	8	0	1	9	0	0
6	21151459	.	T	C	5	3	8	0	0	8	0	0
6	21151474	.	C	T	5	2	7	0	0	7	0	0
6	21151664	.	T	G	1	0	1	0	0	1	0	0
6	21151751	.	C	T	7	9	16	0	1	17	0	0
6	21153285	.	G	A	0	6	6	0	5	11	0	0
6	21154996	.	T	A	1	4	5	0	0	5	0	0
6	21392126	.	A	G	1	2	3	0	0	3	0	0
6	21393635	.	G	A	0	4	4	0	7	11	0	0
6	21513767	.	G	T	0	7	7	0	1	8	0	0
6	21525887	.	C	A	10	11	21	0	2	23	0	0
6	21525916	.	A	G	11	17	28	0	2	30	0	0
6	21525943	.	T	A	21	11	32	0	2	34	0	0
6	21525980	.	T	C	20	5	25	0	2	27	0	0
6	21526047	.	C	A	3	8	11	0	0	11	0	0
6	21526069	.	T	C	3	0	3	0	9	12	0	0
6	21526109	.	A	G	2	9	11	0	1	12	0	0
6	21526322	.	A	G	9	21	30	0	2	32	0	0
6	21526364	.	T	C	4	19	23	0	1	24	0	0
6	21526395	.	A	G	7	15	22	0	0	22	0	0
6	21526783	.	G	A	1	0	1	0	1	2	0	0
6	21529253	.	C	A	3	4	7	0	0	7	0	0
6	21529767	.	A	T	1	2	3	0	0	3	0	0
6	21578760	.	C	T	0	2	2	0	1	3	0	0
6	21588285	.	C	T	9	12	21	0	2	23	0	0
6	21588594	.	C	A	0	4	4	0	5	9	0	0
6	21588597	.	T	G	4	2	6	0	2	8	0	0
6	21588727	.	T	A	1	5	6	0	0	6	0	0
6	21589111	.	G	T	3	3	6	0	2	8	0	0
6	21598085	.	C	T	1	4	5	0	0	5	0	0
6	21693589	.	G	T	0	1	1	0	0	1	0	0
6	21693969	.	C	T	1	2	3	0	0	3	0	0
6	21694369	.	T	A	2	4	6	0	1	7	0	0
6	21694401	.	C	A	6	4	10	0	0	10	0	0
6	21694486	.	C	A	6	6	12	0	0	13	1	0
6	21694591	.	C	A	8	6	14	0	2	16	0	0
6	21694624	.	C	A	6	8	14	0	2	16	0	0
6	21694652	.	T	A	10	6	16	0	2	18	0	0
6	21694917	.	C	A	10	6	16	0	1	17	0	0
6	21695033	.	C	A	12	4	16	0	1	17	0	0
6	21695034	.	C	T	11	4	15	0	2	17	0	0
6	21699689	.	A	T	1	3	4	0	0	4	0	0
6	21700138	.	G	A	0	2	2	0	1	3	0	0
6	21700212	.	A	G	2	2	4	0	0	4	0	0
6	21861526	.	T	G	16	19	35	0	2	37	0	0
6	21861590	.	G	T	14	3	17	0	0	17	0	0
6	21861725	.	A	T	0	6	6	0	0	6	0	0
6	21861771	.	G	A	4	4	8	0	0	8	0	0
6	21861949	.	G	A	21	9	30	0	0	30	0	0
6	21862158	.	G	C	20	11	31	0	0	31	0	0
6	21862288	.	G	A	21	13	34	0	1	35	0	0
6	21862460	.	A	G	19	16	35	0	1	36	0	0
6	21862486	.	G	A	20	18	38	0	1	39	0	0
6	21871928	.	T	C	0	1	1	0	0	1	0	0
6	21871931	.	G	T	0	1	1	0	0	1	0	0
6	21875373	.	C	G	0	7	7	0	6	13	0	0
6	21875741	.	G	T	3	6	9	0	2	11	0	0
6	21876131	.	T	A	4	2	6	0	1	8	1	0
6	21996281	.	C	A	1	2	3	0	0	3	0	0
6	21996320	.	A	G	3	3	6	0	0	6	0	0
6	21999860	.	A	T	1	3	4	0	1	5	0	0
6	22007420	.	G	A	3	0	3	0	0	3	0	0
6	22035222	.	G	A	0	6	6	0	6	12	0	0
6	22035352	.	A	G	5	4	9	0	2	11	0	0
6	22035519	.	G	A	1	7	8	0	0	8	0	0
6	22037517	.	A	G	3	1	4	0	5	9	0	0
6	22037553	.	G	A	3	6	9	0	0	9	0	0
6	22037565	.	A	G	4	0	4	0	9	13	0	0
6	22037625	.	C	T	4	10	14	0	1	15	0	0
6	22037715	.	A	T	3	2	5	0	0	5	0	0
6	22037743	.	C	T	0	2	2	0	0	2	0	0
6	22048636	.	A	G	0	1	1	0	0	1	0	0
6	22101476	.	G	A	4	1	5	0	0	5	0	0
6	22118165	.	T	C	17	24	41	0	0	41	0	0
6	22118216	.	G	A	20	26	46	0	4	50	0	0
6	22118497	.	G	C	15	13	28	0	1	29	0	0
6	22118590	.	A	G	30	15	45	0	1	46	0	0
6	22118690	.	C	T	12	8	20	0	1	21	0	0
6	22118885	.	T	G	24	0	24	0	19	43	0	0
6	22119056	.	C	T	18	35	53	0	4	57	0	0
6	22119376	.	A	C	26	14	40	0	3	43	0	0
6	22119516	.	T	C	9	26	35	0	1	36	0	0
6	22119668	.	T	C	5	4	9	0	0	9	0	0
6	22120074	.	C	T	12	12	24	0	0	24	0	0
6	22120445	.	A	G	8	5	13	0	1	14	0	0
6	22120877	.	A	G	3	4	7	0	0	7	0	0
6	22128520	.	G	A	0	3	3	0	0	3	0	0
6	22137403	.	C	T	0	2	2	0	0	2	0	0
6	22330400	.	A	T	6	1	7	0	0	7	0	0
6	22344003	.	A	T	1	0	1	0	0	1	0	0
6	22347259	.	G	A	4	3	7	0	0	7	0	0
6	22348271	.	T	A	5	7	12	0	0	12	0	0
6	22348274	.	G	C	3	7	10	0	1	11	0	0
6	22351692	.	T	C	13	26	39	0	3	43	1	0
6	22351727	.	T	C	16	24	40	0	1	41	0	0
6	22351780	.	T	A	21	17	38	0	3	41	0	0
6	22352539	.	C	T	9	28	37	0	4	41	0	0
6	22354738	.	C	A	1	0	1	0	0	1	0	0
6	22354759	.	A	G	1	4	5	0	0	5	0	0
6	22463274	.	A	C	2	2	4	0	0	4	0	0
6	22519988	.	T	G	2	3	5	0	0	5	0	0
6	22615546	.	G	A	9	8	17	0	0	17	0	0
6	22628073	.	T	G	7	7	14	0	0	14	0	0
6	22628112	.	A	G	1	2	3	0	3	6	0	0
6	22628483	.	G	A	0	20	20	0	16	36	0	0
6	22628779	.	T	C	11	15	26	0	1	27	0	0
6	22629099	.	A	T	5	4	9	0	0	9	0	0
6	22629182	.	A	G	0	2	2	0	0	2	0	0
6	22683228	.	C	T	1	6	7	6	0	13	0	0
6	22683362	.	A	G	5	9	14	0	0	14	0	0
6	22966966	.	C	A	1	1	2	0	0	2	0	0
6	22986191	.	A	C	1	1	2	0	0	2	0	0
6	22998653	.	C	A	0	1	1	0	0	1	0	0
6	23024242	.	T	C	2	3	5	0	0	5	0	0
6	23053129	.	C	T	3	4	7	0	0	7	0	0
6	23053374	.	G	A	0	3	3	0	10	13	0	0
6	23053784	.	A	G	4	2	6	0	0	6	0	0
6	23053824	.	T	C	5	6	11	0	0	11	0	0
6	23053968	.	A	G	3	14	17	0	1	18	0	0
6	23054267	.	A	G	15	0	15	0	11	26	0	0
6	23054334	.	A	T	11	13	24	0	1	25	0	0
6	23054389	.	A	G	8	6	14	0	0	14	0	0
6	23137335	.	T	A	0	2	2	0	0	2	0	0
6	23812768	.	T	A	1	2	3	0	1	4	0	0
6	23812771	.	C	G	1	2	3	0	1	4	0	0
6	23813361	.	G	A	0	9	9	0	12	21	0	0
6	23813767	.	C	A	14	14	28	0	2	30	0	0
6	23938829	.	G	A	1	2	3	0	0	3	0	0
6	24055743	.	T	A	7	13	20	0	0	20	0	0
6	24055784	.	G	A	9	14	23	0	1	24	0	0
6	24055866	.	G	T	0	5	5	0	2	9	2	0
6	24056261	.	T	A	7	2	9	0	4	13	0	0
6	24056319	.	T	C	5	3	8	0	0	8	0	0
6	24066253	.	T	C	2	1	3	0	4	7	0	0
6	24066345	.	A	G	1	2	3	0	0	3	0	0
6	24066547	.	C	T	0	2	2	0	3	5	0	0
6	24153075	.	G	A	22	17	39	0	7	46	0	0
6	24153114	.	A	G	26	18	44	0	2	46	0	0
6	24153297	.	T	C	18	16	34	0	0	34	0	0
6	24155357	.	C	T	10	10	20	0	4	24	0	0
6	24155459	.	T	G	3	5	8	0	0	8	0	0
6	24155766	.	T	C	1	6	7	0	1	8	0	0
6	24329685	.	C	T	4	4	8	0	1	9	0	0
6	24330029	.	C	T	8	8	16	0	3	19	0	0
6	24330196	.	G	A	7	17	24	0	0	24	0	0
6	24330229	.	G	A	5	12	17	0	0	17	0	0
6	24340631	.	G	A	2	1	3	0	0	3	0	0
6	24340688	.	G	T	1	2	3	0	1	4	0	0
6	24358608	.	T	A	3	2	5	0	0	5	0	0
6	24358720	.	C	T	0	2	2	0	1	3	0	0
6	24364878	.	G	T	5	5	10	0	8	18	0	0
6	24365102	.	C	G	7	6	13	0	1	14	0	0
6	24365205	.	T	A	4	5	9	0	0	9	0	0
6	24365276	.	C	A	6	11	17	0	0	17	0	0
6	24365453	.	G	A	6	4	10	0	1	11	0	0
6	24370637	.	C	T	6	4	10	0	0	10	0	0
6	24370646	.	T	C	5	6	11	0	1	12	0	0
6	24379865	.	G	A	6	9	15	0	3	18	0	0
6	24380335	.	C	A	2	4	6	0	1	7	0	0
6	24382063	.	A	T	2	4	6	0	0	6	0	0
6	24392498	.	G	A	3	3	6	0	0	6	0	0
6	24682721	.	C	T	1	2	3	0	0	3	0	0
6	24682913	.	A	T	2	2	4	0	0	4	0	0
6	24682925	.	T	C	2	2	4	0	0	4	0	0
6	24683354	.	C	T	3	2	5	0	1	6	0	0
6	24691366	.	C	T	2	2	4	0	1	5	0	0
6	24691791	.	A	T	5	6	11	0	0	11	0	0
6	24691845	.	A	T	6	6	12	0	0	12	0	0
6	24692075	.	G	A	1	3	4	0	0	4	0	0
6	24692307	.	A	G	8	5	13	0	2	15	0	0
6	24697940	.	G	C	11	9	20	0	2	22	0	0
6	24818037	.	G	T	1	2	3	0	0	3	0	0
6	24818048	.	G	T	3	1	4	0	1	5	0	0
6	24818240	.	C	A	3	7	10	0	2	12	0	0
6	24818312	.	C	G	13	5	18	0	0	18	0	0
6	24821551	.	C	A	1	5	6	0	2	8	0	0
6	24821631	.	G	A	5	5	10	0	3	13	0	0
6	25933917	.	T	C	25	1	26	0	21	47	0	0
6	25934214	.	A	G	13	11	24	0	1	29	4	0
6	25934313	.	A	T	14	15	29	0	0	29	0	0
6	26558837	.	C	T	0	20	20	0	10	30	0	0
6	26558927	.	C	T	0	12	12	0	13	25	0	0
6	26559179	.	T	C	7	0	7	0	16	23	0	0
6	26559807	.	A	G	2	2	4	0	0	4	0	0
6	26875804	.	C	A	6	6	12	0	2	14	0	0
6	26875944	.	T	A	14	12	26	0	0	26	0	0
6	26891891	.	A	G	1	2	3	0	0	3	0	0
6	27038507	.	A	T	4	3	7	0	1	8	0	0
6	27041886	.	T	C	7	7	14	0	1	15	0	0
6	27041988	.	C	T	6	5	11	0	0	11	0	0
6	27045205	.	G	A	15	6	21	0	2	23	0	0
6	27045238	.	A	G	9	0	9	0	0	9	0	0
6	27048800	.	T	A	3	11	14	0	2	16	0	0
6	27048976	.	A	G	2	2	4	0	1	5	0	0
6	27051710	.	G	A	1	0	1	0	0	1	0	0
6	27051749	.	C	T	1	4	5	0	0	5	0	0
6	27051836	.	G	A	0	1	1	0	0	1	0	0
6	27057438	.	A	G	0	2	2	0	0	2	0	0
6	27088076	.	G	C	5	5	10	0	1	11	0	0
6	27088260	.	A	G	8	7	15	0	0	15	0	0
6	27104458	.	G	C	5	7	12	0	1	13	0	0
6	27104584	.	T	C	9	12	21	0	0	21	0	0
6	27104752	.	A	G	5	9	14	0	0	14	0	0
6	27104898	.	A	T	2	4	6	0	0	6	0	0
6	27104906	.	C	G	3	2	5	0	1	6	0	0
6	27108716	.	T	A	1	2	3	0	0	3	0	0
6	27146872	.	C	T	1	2	3	0	0	3	0	0
6	27269612	.	T	A	2	4	6	0	0	6	0	0
6	27269664	.	T	C	3	4	7	0	1	8	0	0
6	27270288	.	A	C	2	3	5	0	0	5	0	0
6	27270653	.	G	A	3	6	9	0	0	9	0	0
6	27270664	.	T	A	3	5	8	0	2	10	0	0
6	27271114	.	A	G	13	0	13	0	6	19	0	0
6	27271115	.	A	T	13	6	19	0	0	19	0	0
6	27271208	.	A	G	9	0	9	0	8	17	0	0
6	27271390	.	T	A	11	8	19	0	0	20	1	0
6	27271498	.	C	T	9	18	27	0	0	27	0	0
6	27271803	.	A	G	25	14	39	0	2	41	0	0
6	27271813	.	A	G	25	11	36	0	2	38	0	0
6	27272081	.	T	G	25	19	44	0	1	45	0	0
6	27272487	.	A	T	6	9	15	0	1	16	0	0
6	27272488	.	T	C	6	10	16	0	0	16	0	0
6	27272555	.	T	C	12	19	31	1	3	35	0	0
6	27450462	.	T	A	1	4	5	0	0	5	0	0
6	27614446	.	T	C	2	2	4	0	0	4	0	0
6	27614989	.	A	T	2	3	5	0	0	5	0	0
6	27614993	.	T	C	2	3	5	0	0	5	0	0
6	27667415	.	A	C	2	3	5	0	0	5	0	0
6	28913815	.	A	T	1	1	2	0	2	4	0	0
6	29705597	.	T	C	9	3	12	0	1	13	0	0
6	30628651	.	G	A	0	3	3	0	0	3	0	0
6	30714240	.	T	C	2	3	5	0	1	6	0	0
6	31428908	.	G	T	0	7	7	0	2	9	0	0
6	31432391	.	T	A	2	2	4	0	0	4	0	0
6	33663690	.	T	C	2	7	9	0	0	9	0	0
6	33663701	.	T	C	6	4	10	0	0	10	0	0
6	34811130	.	A	T	7	4	11	0	1	12	0	0
6	35100084	.	G	A	1	8	9	0	1	10	0	0
6	35366544	.	A	G	3	2	5	0	2	7	0	0
6	38789903	.	A	T	10	5	15	0	15	30	0	0
6	38789908	.	G	T	13	3	16	0	11	27	0	0
6	38859938	.	A	G	9	5	14	0	1	15	0	0
6	39162607	.	C	T	2	17	19	0	1	20	0	0
6	39187295	.	T	A	2	0	2	0	0	2	0	0
6	39252565	.	A	G	5	2	7	0	0	7	0	0
6	39994107	.	A	T	0	9	9	3	1	13	0	0
6	40707276	.	T	A	5	2	7	0	0	7	0	0
6	40708212	.	T	A	3	2	5	0	1	6	0	0
6	40762029	.	T	C	5	2	7	0	0	7	0	0
6	41435866	.	A	G	8	4	12	0	0	12	0	0
6	41460563	.	A	T	0	6	6	0	0	6	0	0
6	44007178	.	C	A	8	3	11	0	1	12	0	0
6	44977406	.	G	A	11	4	15	0	1	16	0	0
6	46422955	.	G	A	3	3	6	0	0	6	0	0
6	46423470	.	C	A	0	3	3	0	0	3	0	0
6	46423593	.	G	T	2	6	8	0	1	9	0	0
6	46428452	.	A	T	1	1	2	0	1	3	0	0
6	46431113	.	G	A	0	10	10	0	8	19	1	0
6	46431950	.	A	G	6	12	18	0	1	19	0	0
6	46432016	.	G	A	1	3	4	0	0	4	0	0
6	46450487	.	C	G	28	15	43	0	1	44	0	0
6	46450547	.	T	C	24	13	37	0	4	41	0	0
6	46450804	.	C	T	12	7	19	0	1	20	0	0
6	46452997	.	C	T	4	1	5	0	0	5	0	0
6	46454103	.	C	A	15	10	25	0	0	25	0	0
6	46454148	.	G	A	13	11	24	0	0	24	0	0
6	46454173	.	T	G	21	11	32	0	2	34	0	0
6	46454396	.	T	A	23	26	49	0	1	50	0	0
6	46454816	.	T	A	2	3	5	0	0	5	0	0
6	46718103	.	T	G	1	3	4	0	0	4	0	0
6	46718193	.	G	T	2	2	4	0	0	4	0	0
6	46722670	.	G	A	4	2	6	0	0	6	0	0
6	46722671	.	G	T	4	2	6	0	0	6	0	0
6	46722783	.	G	T	0	2	2	0	4	6	0	0
6	46722786	.	C	G	4	2	6	0	0	6	0	0
6	46722883	.	T	G	3	4	7	0	0	7	0	0
6	46726080	.	A	G	6	4	10	0	0	10	0	0
6	46726234	.	T	G	2	5	7	0	0	7	0	0
6	47006611	.	A	G	0	2	2	0	1	3	0	0
6	47032679	.	C	T	4	1	5	0	1	6	0	0
6	47530828	.	C	T	0	2	2	0	2	4	0	0
6	47809905	.	T	G	2	2	4	0	1	5	0	0
6	47810323	.	A	G	7	7	14	0	0	14	0	0
6	47810671	.	T	A	6	7	13	0	1	14	0	0
6	47810804	.	A	T	2	4	6	0	1	7	0	0
6	47810810	.	T	A	4	2	6	0	0	6	0	0
6	47811024	.	G	A	2	2	4	0	0	4	0	0
6	47865322	.	C	T	1	4	5	0	0	5	0	0
6	47865391	.	C	T	2	2	4	0	0	4	0	0
6	47865588	.	T	C	2	1	3	0	1	4	0	0
6	47865626	.	G	T	2	2	4	0	0	4	0	0
6	47865770	.	A	C	0	2	2	0	1	3	0	0
6	47865780	.	C	G	1	3	4	0	0	4	0	0
6	48052458	.	A	C	0	0	0	0	1	1	0	0
6	48057928	.	C	T	6	9	15	0	0	15	0	0
6	48058628	.	A	G	9	9	18	0	0	18	0	0
6	48058719	.	A	G	6	0	6	0	8	14	0	0
6	48058720	.	C	T	8	6	14	0	0	14	0	0
6	48294637	.	A	G	3	3	6	0	0	6	0	0
6	48323184	.	A	C	3	6	9	0	0	9	0	0
6	48323373	.	A	T	15	12	27	0	1	28	0	0
6	48325997	.	C	G	7	4	11	0	1	12	0	0
6	48369018	.	G	C	0	1	1	0	0	1	0	0
6	48369069	.	A	T	1	7	8	0	0	8	0	0
6	48370800	.	T	C	1	1	2	0	0	2	0	0
6	48375954	.	T	G	8	2	10	0	0	10	0	0
6	48383142	.	C	A	2	2	4	0	0	4	0	0
6	48383149	.	A	T	2	1	3	0	0	3	0	0
6	48426566	.	C	T	3	2	5	0	0	5	0	0
6	48689312	.	T	G	10	13	23	0	1	24	0	0
6	48689484	.	G	A	7	11	18	0	2	20	0	0
6	49105852	.	G	T	2	2	4	0	0	4	0	0
6	49106155	.	A	T	4	7	11	0	0	11	0	0
6	49106450	.	C	T	12	11	23	0	1	24	0	0
6	49106605	.	C	T	20	19	39	0	2	41	0	0
6	49106744	.	C	T	12	7	19	0	0	19	0	0
6	49107156	.	A	C	18	31	49	0	3	52	0	0
6	49107390	.	G	A	26	20	46	0	3	49	0	0
6	49107477	.	T	G	14	13	27	0	9	36	0	0
6	49107668	.	T	C	36	12	48	0	3	51	0	0
6	49108078	.	T	C	6	2	8	0	0	8	0	0
6	49108244	.	T	A	1	3	4	0	0	4	0	0
6	49108313	.	T	C	5	9	14	0	1	15	0	0
6	49108352	.	A	T	8	17	25	0	0	25	0	0
6	49108355	.	T	G	8	14	22	0	4	26	0	0
6	49108604	.	T	C	9	8	17	0	1	18	0	0
6	49108739	.	T	C	9	10	19	0	2	21	0	0
6	49108838	.	A	T	12	10	22	0	1	23	0	0
6	49108954	.	C	G	8	8	16	1	0	17	0	0
6	49108970	.	T	C	5	6	11	1	3	15	0	0
6	49109347	.	T	C	12	11	23	0	1	24	0	0
6	49109366	.	G	A	13	13	26	0	0	26	0	0
6	49520723	.	C	T	1	7	8	0	5	13	0	0
6	49577873	.	C	T	2	3	5	0	0	5	0	0
6	49583348	.	C	T	1	3	4	0	0	4	0	0
6	49605308	.	G	A	0	2	2	0	6	8	0	0
6	49628476	.	T	C	1	1	2	0	0	2	0	0
6	49635461	.	G	A	14	11	25	0	0	25	0	0
6	49636372	.	T	C	6	10	16	0	2	18	0	0
6	49636508	.	T	A	9	7	16	0	1	17	0	0
6	49737477	.	T	A	1	3	4	0	0	4	0	0
6	49738159	.	A	G	1	2	3	0	0	3	0	0
6	49738479	.	A	G	3	3	6	0	0	6	0	0
6	49738863	.	A	G	4	0	4	0	8	12	0	0
6	49739084	.	G	A	1	5	6	0	1	7	0	0
6	49739151	.	A	G	2	3	5	0	1	6	0	0
6	49739698	.	A	T	6	4	10	0	0	10	0	0
6	49739845	.	T	C	13	5	18	0	0	18	0	0
6	49739868	.	A	G	16	4	20	0	0	20	0	0
6	49740059	.	A	G	8	9	17	0	0	17	0	0
6	49740067	.	C	A	7	8	15	0	2	17	0	0
6	49740247	.	G	A	11	14	25	0	1	26	0	0
6	49749689	.	G	A	0	1	1	0	0	1	0	0
6	49760016	.	T	C	0	1	1	0	0	1	0	0
6	49760278	.	G	C	14	10	24	0	0	24	0	0
6	49760581	.	A	T	12	10	22	0	2	24	0	0
6	49760609	.	A	G	14	10	24	0	1	25	0	0
6	49760740	.	A	G	8	10	18	0	1	22	3	0
6	49782021	.	A	T	1	1	2	0	1	3	0	0
6	49812476	.	G	A	4	4	8	0	1	9	0	0
6	49901591	.	C	T	3	6	9	0	0	9	0	0
6	49914387	.	T	C	1	2	3	0	1	4	0	0
6	49919063	.	A	G	1	0	1	0	0	1	0	0
6	49919211	.	C	T	11	9	20	0	0	20	0	0
6	49919232	.	A	T	11	7	18	0	1	19	0	0
6	49919326	.	T	A	10	7	17	0	1	18	0	0
6	49919358	.	C	T	13	9	22	0	0	22	0	0
6	49920119	.	C	A	7	5	12	0	1	13	0	0
6	49920159	.	T	A	5	7	12	0	1	13	0	0
6	49920218	.	A	T	15	16	31	0	0	31	0	0
6	49920253	.	A	G	12	1	13	0	13	26	0	0
6	49920433	.	A	G	2	0	2	0	4	6	0	0
6	49920442	.	C	T	2	5	7	0	0	7	0	0
6	49920468	.	G	A	2	12	14	0	0	14	0	0
6	49920498	.	T	A	1	11	12	0	1	13	0	0
6	49920614	.	T	C	2	3	5	0	0	5	0	0
6	49920626	.	T	A	2	1	3	0	0	3	0	0
6	49921770	.	G	A	0	3	3	0	5	8	0	0
6	49921853	.	T	A	4	4	8	0	0	8	0	0
6	50389352	.	C	T	8	7	15	0	1	16	0	0
6	50389424	.	G	A	2	1	3	0	0	3	0	0
6	50390067	.	A	C	4	3	7	0	2	9	0	0
6	50401756	.	T	A	14	18	32	0	1	33	0	0
6	50402037	.	T	G	12	22	34	0	6	40	0	0
6	50402294	.	G	A	7	5	12	0	1	13	0	0
6	50404635	.	T	A	6	8	14	0	0	14	0	0
6	50404677	.	A	G	9	12	21	0	0	21	0	0
6	50408885	.	G	A	0	2	2	0	1	3	0	0
6	50413410	.	G	A	13	6	19	0	2	21	0	0
6	50413422	.	C	A	13	9	22	0	3	25	0	0
6	50413449	.	T	A	12	11	23	0	1	24	0	0
6	50414033	.	C	A	8	16	24	1	0	25	0	0
6	50414089	.	A	G	6	6	12	0	1	13	0	0
6	50581134	.	C	T	3	4	7	0	0	7	0	0
6	50581261	.	A	G	8	4	12	0	1	13	0	0
6	50581320	.	C	G	0	6	6	0	14	20	0	0
6	50581346	.	C	A	9	8	17	0	1	18	0	0
6	50581794	.	G	T	9	5	14	0	1	15	0	0
6	50581851	.	C	T	0	3	3	0	3	6	0	0
6	50582087	.	A	T	1	3	4	0	0	4	0	0
6	50582513	.	G	A	4	8	12	0	1	13	0	0
6	50582597	.	C	G	0	2	2	0	1	3	0	0
6	50695569	.	T	C	1	2	3	0	1	4	0	0
6	51529305	.	G	C	3	3	6	0	0	6	0	0
6	51529336	.	A	G	5	6	11	0	1	12	0	0
6	51529477	.	A	T	7	4	11	0	1	12	0	0
6	51529725	.	G	A	2	6	8	0	1	9	0	0
6	51529747	.	A	C	4	3	7	0	1	8	0	0
6	51576055	.	A	T	18	10	28	0	2	30	0	0
6	51576177	.	T	G	23	12	35	0	1	36	0	0
6	51576374	.	A	T	17	10	27	0	2	29	0	0
6	51576375	.	C	G	1	11	12	0	17	29	0	0
6	51577678	.	C	T	0	3	3	0	1	4	0	0
6	51578224	.	A	G	3	3	6	0	0	6	0	0
6	51578436	.	A	C	1	2	3	0	1	4	0	0
6	51666397	.	C	A	2	2	4	0	0	4	0	0
6	51666427	.	T	C	2	2	4	0	0	4	0	0
6	51666438	.	T	C	3	2	5	0	0	5	0	0
6	51770340	.	C	T	16	11	27	0	1	28	0	0
6	51770436	.	C	T	0	4	4	0	18	22	0	0
6	51770503	.	A	G	15	6	21	0	1	22	0	0
6	51806186	.	T	A	1	3	4	0	2	6	0	0
6	51806238	.	T	G	8	7	15	0	1	16	0	0
6	51809065	.	T	A	1	4	5	0	0	5	0	0
6	51810896	.	A	G	2	2	4	0	1	5	0	0
6	51810987	.	T	G	1	2	3	0	0	3	0	0
6	52082811	.	A	G	3	2	5	0	0	5	0	0
6	52082832	.	A	G	3	2	5	0	0	5	0	0
6	52220316	.	G	A	0	15	15	0	14	29	0	0
6	52222481	.	G	T	17	16	33	0	1	34	0	0
6	52222564	.	C	T	23	23	46	0	3	49	0	0
6	52222654	.	G	A	0	20	20	0	31	51	0	0
6	52223247	.	G	A	0	30	30	0	27	57	0	0
6	52223369	.	T	C	6	15	21	0	2	23	0	0
6	52223936	.	A	G	16	3	19	0	1	20	0	0
6	52224090	.	A	G	15	11	26	0	0	26	0	0
6	52224376	.	T	C	37	11	48	0	1	49	0	0
6	52224525	.	T	C	10	14	24	0	2	26	0	0
6	52224539	.	A	T	11	12	23	0	3	27	1	0
6	52224590	.	A	G	20	16	36	0	2	38	0	0
6	52225266	.	T	A	2	2	4	0	1	5	0	0
6	52227568	.	C	A	2	1	3	0	1	4	0	0
6	52239573	.	T	C	28	26	54	0	6	60	0	0
6	52239613	.	G	C	19	13	32	0	3	35	0	0
6	52248802	.	T	C	4	3	7	0	0	7	0	0
6	52248847	.	A	C	1	4	5	0	0	5	0	0
6	52253402	.	T	C	4	3	7	0	0	7	0	0
6	52253411	.	T	G	3	2	5	0	0	5	0	0
6	52254417	.	A	G	4	3	7	0	0	7	0	0
6	52254597	.	A	C	1	5	6	0	0	6	0	0
6	52254604	.	G	A	1	6	7	0	1	8	0	0
6	52339684	.	A	G	4	4	8	0	0	8	0	0
6	52339728	.	G	A	4	1	5	0	0	5	0	0
6	52339847	.	T	C	3	0	3	0	0	3	0	0
6	52341721	.	G	A	0	1	1	0	0	1	0	0
6	52341742	.	A	G	1	2	3	0	0	3	0	0
6	52351748	.	A	C	1	3	4	0	0	4	0	0
6	52352971	.	C	T	1	2	3	0	0	3	0	0
6	52354259	.	A	T	2	3	5	0	1	6	0	0
6	52354536	.	T	C	4	6	10	0	0	10	0	0
6	52354694	.	A	T	3	15	18	0	0	18	0	0
6	52354698	.	C	T	4	13	17	0	1	18	0	0
6	52354783	.	T	C	4	8	12	0	3	15	0	0
6	52354830	.	G	A	1	7	8	0	1	9	0	0
6	52354852	.	A	T	2	9	11	0	0	11	0	0
6	52354909	.	A	G	3	5	8	0	1	9	0	0
6	52356457	.	C	G	3	2	5	0	0	5	0	0
6	52356755	.	G	C	7	6	13	0	2	15	0	0
6	52533195	.	G	A	3	0	3	0	0	3	0	0
6	52663242	.	C	G	6	16	22	0	3	25	0	0
6	52715746	.	C	A	1	4	5	0	0	5	0	0
6	52716053	.	T	C	4	2	6	0	1	7	0	0
6	52716119	.	T	G	18	4	22	0	0	22	0	0
6	52716714	.	G	T	2	11	13	0	3	16	0	0
6	52720695	.	G	A	1	1	2	0	0	2	0	0
6	52830561	.	G	A	0	2	2	0	5	7	0	0
6	52830566	.	T	A	5	2	7	0	0	7	0	0
6	52840313	.	G	A	0	4	4	0	3	7	0	0
6	52845670	.	T	G	3	3	6	0	0	6	0	0
6	52845851	.	A	T	2	3	5	0	0	5	0	0
6	53050517	.	G	A	27	21	48	0	2	50	0	0
6	53050589	.	G	A	19	21	40	0	1	41	0	0
6	53050847	.	G	A	17	10	27	0	0	27	0	0
6	53050895	.	C	T	17	18	35	0	3	38	0	0
6	53052693	.	C	T	7	8	15	0	0	15	0	0
6	53052741	.	G	A	1	0	1	0	0	1	0	0
6	53055338	.	T	C	1	0	1	0	2	3	0	0
6	53264192	.	T	C	30	24	54	0	3	57	0	0
6	53271887	.	T	C	13	9	22	0	1	23	0	0
6	53272571	.	A	G	13	10	23	0	1	24	0	0
6	53272637	.	G	C	18	12	30	0	2	32	0	0
6	53279886	.	G	T	4	1	5	0	0	5	0	0
6	53305888	.	T	C	20	11	31	0	6	37	0	0
6	53305968	.	C	G	2	12	14	0	0	14	0	0
6	53306034	.	A	T	4	21	25	0	0	25	0	0
6	53306170	.	T	G	5	18	23	0	1	25	1	0
6	53326383	.	G	C	0	1	1	0	0	1	0	0
6	53334082	.	T	G	4	2	6	0	0	6	0	0
6	53350105	.	A	T	1	2	3	0	0	3	0	0
6	53361818	.	T	C	1	1	2	0	0	2	0	0
6	54078764	.	G	T	0	2	2	0	4	6	0	0
6	54079657	.	T	C	5	2	7	0	0	7	0	0
6	54079807	.	G	A	12	3	15	0	0	15	0	0
6	54079816	.	A	C	8	4	12	0	3	15	0	0
6	54117367	.	A	G	9	11	20	0	0	20	0	0
6	54149554	.	C	T	1	4	5	0	0	5	0	0
6	54150488	.	T	C	3	4	7	0	0	7	0	0
6	54150640	.	C	G	3	8	11	0	1	12	0	0
6	54150730	.	G	A	2	4	6	0	6	12	0	0
6	54151318	.	G	C	2	8	10	0	0	10	0	0
6	54151406	.	G	A	7	6	13	0	0	13	0	0
6	54151408	.	T	G	6	7	13	0	0	13	0	0
6	54151615	.	C	G	8	5	13	0	0	13	0	0
6	54151768	.	G	A	3	17	20	1	1	22	0	0
6	54151798	.	A	C	19	3	22	0	2	24	0	0
6	54152151	.	T	A	14	6	20	2	3	25	0	0
6	54152492	.	C	T	13	20	33	0	3	36	0	0
6	54152529	.	T	A	16	13	29	0	2	31	0	0
6	54175384	.	A	G	6	4	10	0	0	10	0	0
6	54179724	.	C	G	9	6	15	0	0	15	0	0
6	54179733	.	G	A	11	11	22	0	1	23	0	0
6	54266317	.	T	C	3	4	7	0	1	8	0	0
6	54266337	.	T	A	3	4	7	0	1	8	0	0
6	54270296	.	G	A	2	6	8	0	1	9	0	0
6	54270760	.	C	T	1	4	5	0	1	6	0	0
6	54270773	.	T	A	2	5	7	0	1	8	0	0
6	54271196	.	A	T	5	4	9	0	0	9	0	0
6	54325234	.	A	G	4	3	7	0	0	7	0	0
6	54325658	.	C	A	3	2	5	0	0	5	0	0
6	54438466	.	G	A	10	12	22	0	0	22	0	0
6	54704691	.	T	G	2	2	4	0	0	4	0	0
6	54807312	.	T	G	0	2	2	0	0	2	0	0
6	54838467	.	G	A	15	9	24	0	1	25	0	0
6	54838496	.	T	C	10	9	19	0	0	19	0	0
6	54843108	.	T	G	6	2	8	0	0	8	0	0
6	55218137	.	A	G	2	15	17	0	1	18	0	0
6	55277487	.	G	T	2	3	5	0	0	5	0	0
6	55291948	.	C	T	1	3	4	0	0	4	0	0
6	55291981	.	G	A	0	2	2	0	0	2	0	0
6	55294429	.	C	T	0	2	2	0	0	2	0	0
6	55328622	.	C	T	0	2	2	0	1	3	0	0
6	55393020	.	C	T	11	6	17	0	1	18	0	0
6	55393047	.	C	T	9	6	15	0	0	15	0	0
6	55397150	.	T	A	3	3	6	0	2	8	0	0
6	55397302	.	T	C	3	3	6	0	1	7	0	0
6	55429885	.	A	C	10	6	16	0	0	16	0	0
6	55429903	.	C	T	5	2	7	0	1	8	0	0
6	55432278	.	C	G	4	0	4	0	13	17	0	0
6	55432787	.	A	G	20	22	42	0	3	45	0	0
6	55432811	.	T	C	19	24	43	0	5	48	0	0
6	55434178	.	C	T	8	5	13	0	0	13	0	0
6	55436386	.	G	A	30	29	59	0	3	62	0	0
6	55436644	.	C	T	14	33	47	0	4	51	0	0
6	55436665	.	C	T	15	32	47	0	4	51	0	0
6	55436701	.	C	T	20	25	45	0	3	48	0	0
6	55436881	.	A	C	23	8	31	0	1	32	0	0
6	56116724	.	C	T	1	4	5	0	0	5	0	0
6	56116741	.	C	T	0	2	2	0	0	2	0	0
6	56132360	.	A	G	1	3	4	0	0	4	0	0
6	56138404	.	C	T	9	4	13	0	0	13	0	0
6	56138953	.	T	A	1	2	3	0	0	3	0	0
6	56139130	.	A	G	4	0	4	0	8	12	0	0
6	56139188	.	T	A	8	7	15	0	0	15	0	0
6	56139224	.	A	T	7	5	12	0	0	12	0	0
6	56139272	.	T	A	3	2	5	0	0	5	0	0
6	57436347	.	A	G	3	4	7	0	0	7	0	0
6	57439021	.	T	C	3	1	4	0	0	4	0	0
6	57455557	.	T	C	1	1	2	0	0	2	0	0
6	57455680	.	G	A	0	1	1	0	0	1	0	0
6	57455683	.	G	A	0	1	1	0	0	1	0	0
6	57479486	.	C	G	0	2	2	0	1	3	0	0
6	57492086	.	G	A	1	6	7	0	0	7	0	0
6	57492141	.	G	A	1	3	4	0	1	5	0	0
6	58522689	.	C	G	2	0	2	0	4	6	0	0
6	58522695	.	A	G	3	3	6	0	0	6	0	0
6	58528602	.	A	G	2	1	3	0	0	3	0	0
6	58553387	.	G	A	2	1	3	0	0	3	0	0
6	58553424	.	T	C	3	5	8	0	1	9	0	0
6	58560795	.	C	T	11	12	23	0	0	23	0	0
6	58561003	.	C	T	1	6	7	0	1	8	0	0
6	58561080	.	T	G	8	8	16	0	0	16	0	0
6	58561186	.	A	C	4	5	9	0	0	9	0	0
6	58561190	.	C	G	4	6	10	0	1	11	0	0
6	58562114	.	G	A	10	4	14	0	3	17	0	0
6	58562146	.	T	A	11	4	15	0	5	20	0	0
6	58562407	.	T	A	8	6	14	0	2	17	1	0
6	58562483	.	T	C	6	3	9	1	2	12	0	0
6	58562484	.	G	A	7	3	10	1	1	12	0	0
6	58562935	.	G	A	24	16	40	0	3	43	0	0
6	58563093	.	T	A	15	31	46	0	0	46	0	0
6	58563157	.	T	C	19	25	44	0	7	51	0	0
6	58563159	.	G	A	19	29	48	0	3	51	0	0
6	58563229	.	A	C	25	6	31	0	0	31	0	0
6	58563302	.	A	T	24	16	40	0	2	42	0	0
6	58563305	.	G	A	2	15	17	0	23	40	0	0
6	58563374	.	C	T	19	10	29	0	1	30	0	0
6	58563527	.	G	A	1	1	2	0	1	3	0	0
6	58725930	.	T	C	2	5	7	0	0	7	0	0
6	58726066	.	G	A	0	4	4	0	5	9	0	0
6	58728670	.	G	A	0	1	1	0	1	2	0	0
6	58728907	.	C	T	1	3	4	0	0	4	0	0
6	58728915	.	G	T	1	3	4	0	0	4	0	0
6	58730208	.	A	T	3	3	6	0	2	8	0	0
6	58730269	.	A	C	6	4	10	0	1	11	0	0
6	58773647	.	T	G	0	3	3	0	0	3	0	0
6	58773785	.	C	T	0	2	2	0	6	8	0	0
6	58773788	.	A	G	6	2	8	0	0	8	0	0
6	58780811	.	C	T	0	3	3	0	0	3	0	0
6	58852853	.	G	A	0	1	1	0	0	1	0	0
6	58856151	.	C	T	0	0	0	0	1	1	0	0
6	58862328	.	A	G	7	0	7	0	9	16	0	0
6	58863294	.	T	C	0	5	5	0	1	6	0	0
6	58867018	.	A	G	19	0	19	0	22	41	0	0
6	58867090	.	A	T	16	19	35	0	2	37	0	0
6	58867093	.	C	T	14	22	36	0	2	38	0	0
6	58867240	.	A	G	12	5	17	0	1	18	0	0
6	58867282	.	G	A	5	6	11	0	0	11	0	0
6	58867329	.	G	C	12	7	19	0	2	21	0	0
6	58867372	.	A	T	17	9	26	0	1	27	0	0
6	58867409	.	A	G	28	9	37	0	2	39	0	0
6	58918095	.	T	C	1	1	2	0	1	3	0	0
6	58923246	.	T	C	5	6	11	0	1	12	0	0
6	58931376	.	G	A	1	1	2	0	0	2	0	0
6	58939261	.	T	C	1	1	2	0	0	2	0	0
6	58942857	.	G	T	1	3	4	0	0	4	0	0
6	59971580	.	A	G	26	10	36	0	0	36	0	0
6	59971598	.	A	G	21	16	37	0	5	42	0	0
6	59971964	.	G	A	3	5	8	0	0	8	0	0
7	742828	.	T	C	5	26	31	0	1	32	0	0
7	1603116	.	T	G	2	0	2	0	4	6	0	0
7	1606334	.	C	T	3	1	4	0	2	6	0	0
7	1613117	.	T	C	4	5	9	0	1	10	0	0
7	1613131	.	A	G	5	6	11	0	1	12	0	0
7	1613230	.	T	G	3	2	5	0	1	6	0	0
7	1615439	.	C	T	3	2	5	0	0	5	0	0
7	1617209	.	T	A	4	9	13	0	0	13	0	0
7	1617218	.	T	C	0	1	1	0	0	1	0	0
7	1617433	.	A	C	0	14	14	0	0	14	0	0
7	1618863	.	T	C	19	9	28	0	1	29	0	0
7	1618865	.	G	A	9	18	27	0	2	29	0	0
7	1619124	.	A	T	2	5	7	0	2	9	0	0
7	1620135	.	G	A	0	3	3	0	1	4	0	0
7	1620804	.	A	C	2	2	4	0	0	4	0	0
7	3930869	.	A	T	8	1	9	0	1	10	0	0
7	3931029	.	A	G	36	19	55	0	1	57	1	0
7	3931264	.	C	T	26	24	50	0	4	54	0	0
7	3931396	.	A	T	28	26	54	0	2	56	0	0
7	3931543	.	A	T	23	16	39	0	2	41	0	0
7	3931598	.	G	T	21	22	43	0	2	45	0	0
7	3931644	.	T	C	27	1	28	0	17	45	0	0
7	3932044	.	T	C	8	5	13	0	0	13	0	0
7	3932209	.	A	T	7	15	22	0	1	23	0	0
7	3932402	.	T	C	5	10	15	0	2	17	0	0
7	3932405	.	A	T	5	12	17	0	0	17	0	0
7	3932463	.	T	G	1	4	5	0	4	9	0	0
7	3932694	.	G	A	9	9	18	0	0	18	0	0
7	3932698	.	T	C	8	10	18	0	2	20	0	0
7	3932731	.	C	A	12	11	23	0	2	25	0	0
7	3932870	.	T	C	2	3	5	0	1	6	0	0
7	3932935	.	C	A	10	6	16	0	2	18	0	0
7	3933121	.	G	A	24	9	33	0	1	34	0	0
7	3933243	.	C	A	7	5	12	0	1	13	0	0
7	3933271	.	C	T	5	7	12	0	0	12	0	0
7	3933481	.	T	C	8	0	8	0	6	14	0	0
7	3933483	.	C	T	0	6	6	0	8	14	0	0
7	3933998	.	C	T	7	5	12	0	1	13	0	0
7	3934038	.	A	T	3	3	6	0	1	7	0	0
7	3934069	.	T	C	0	5	5	0	0	5	0	0
7	3934208	.	T	C	7	5	12	0	2	14	0	0
7	3934387	.	C	T	4	6	10	0	0	10	0	0
7	3934428	.	G	T	7	5	12	0	1	13	0	0
7	3935737	.	C	T	0	3	3	0	3	6	0	0
7	3936702	.	A	G	0	2	2	0	1	3	0	0
7	4088334	.	C	T	17	19	36	0	2	38	0	0
7	4088545	.	C	T	0	20	20	0	12	32	0	0
7	4088680	.	G	A	11	17	28	0	3	32	1	0
7	4088727	.	A	T	24	13	37	0	2	39	0	0
7	4088832	.	A	G	14	23	37	0	2	39	0	0
7	4089042	.	A	G	19	8	27	0	2	29	0	0
7	4089090	.	G	A	6	6	12	0	3	15	0	0
7	4100967	.	G	A	6	4	10	0	1	11	0	0
7	4183996	.	C	T	1	2	3	0	0	3	0	0
7	4186532	.	G	A	0	1	1	1	1	3	0	0
7	4186553	.	T	C	0	2	2	0	0	2	0	0
7	4186611	.	A	G	7	2	9	0	1	10	0	0
7	4186629	.	C	T	2	7	9	0	1	10	0	0
7	5324903	.	T	C	4	4	8	0	0	8	0	0
7	7039312	.	A	G	2	3	5	0	0	5	0	0
7	7039328	.	A	G	1	3	4	0	0	4	0	0
7	7039446	.	T	A	4	2	6	0	0	6	0	0
7	7042115	.	A	G	14	6	20	0	4	24	0	0
7	7042160	.	A	G	7	8	15	0	1	16	0	0
7	7042604	.	C	T	13	24	37	0	0	38	1	0
7	7042626	.	T	G	11	18	29	0	2	31	0	0
7	7248813	.	G	C	1	1	2	0	0	2	0	0
7	7248819	.	C	A	1	2	3	0	0	3	0	0
7	7248849	.	A	G	2	2	4	0	0	4	0	0
7	7248862	.	A	G	2	1	3	0	0	3	0	0
7	7249515	.	T	A	8	5	13	0	0	13	0	0
7	7364442	.	C	T	0	2	2	0	0	2	0	0
7	7364737	.	C	A	2	3	5	0	0	5	0	0
7	7368228	.	T	A	2	4	6	0	0	6	0	0
7	7368264	.	T	C	1	10	11	0	6	17	0	0
7	7372404	.	A	G	10	7	17	0	0	17	0	0
7	7372694	.	A	G	10	26	36	0	2	38	0	0
7	7372892	.	A	G	17	13	30	0	2	32	0	0
7	7466164	.	T	A	2	3	5	0	1	6	0	0
7	7466227	.	A	T	6	8	14	0	1	15	0	0
7	7466495	.	A	G	14	9	23	0	0	23	0	0
7	7466603	.	C	T	0	14	14	0	11	25	0	0
7	7466706	.	A	G	9	6	15	0	2	17	0	0
7	7466827	.	A	T	8	5	13	0	0	13	0	0
7	7467303	.	A	T	5	4	9	0	0	9	0	0
7	7467308	.	C	T	5	5	10	0	0	10	0	0
7	7467376	.	A	G	5	5	10	0	0	10	0	0
7	7467386	.	G	A	3	5	8	0	1	9	0	0
7	7467413	.	G	A	2	3	5	0	0	5	0	0
7	7467476	.	T	C	1	4	5	0	0	5	0	0
7	7467509	.	C	A	1	7	8	0	0	8	0	0
7	7467906	.	T	A	2	5	7	0	2	9	0	0
7	7477411	.	T	C	3	1	4	0	1	5	0	0
7	7477594	.	A	T	13	15	28	0	2	30	0	0
7	7478105	.	A	G	1	3	4	0	0	4	0	0
7	7478137	.	A	G	2	5	7	0	0	7	0	0
7	7478308	.	G	T	1	3	4	0	0	4	0	0
7	7478654	.	T	C	6	6	12	0	0	12	0	0
7	7478717	.	T	G	8	11	19	0	0	19	0	0
7	7478806	.	G	A	8	8	16	0	0	16	0	0
7	7507176	.	A	C	1	4	5	0	0	5	0	0
7	7617861	.	G	A	0	4	4	0	1	5	0	0
7	7624082	.	A	G	4	2	6	0	1	7	0	0
7	7641230	.	A	T	4	6	10	0	2	12	0	0
7	7641240	.	T	G	7	5	12	0	0	12	0	0
7	7641351	.	G	A	6	6	12	0	0	12	0	0
7	7641353	.	G	A	6	6	12	0	0	12	0	0
7	7641481	.	C	T	7	8	15	0	0	15	0	0
7	7641504	.	G	A	0	5	5	0	6	11	0	0
7	7641678	.	T	A	0	6	6	0	1	7	0	0
7	7641765	.	T	C	0	3	3	0	0	3	0	0
7	7642554	.	T	A	10	12	22	0	0	22	0	0
7	7642578	.	A	G	6	0	6	0	5	11	0	0
7	7642787	.	A	T	8	15	23	0	2	25	0	0
7	7643277	.	T	C	16	24	40	0	2	42	0	0
7	7643313	.	T	C	17	25	42	0	3	46	1	0
7	7643488	.	A	G	27	22	49	0	6	55	0	0
7	7643676	.	G	A	6	21	27	0	29	56	0	0
7	7643711	.	C	A	19	22	41	0	4	45	0	0
7	7643712	.	T	C	19	25	44	0	1	45	0	0
7	7643820	.	C	T	12	3	15	0	1	16	0	0
7	7643867	.	C	T	2	4	6	0	0	6	0	0
7	7662467	.	C	G	12	8	20	0	0	20	0	0
7	7663132	.	A	G	10	11	21	0	0	21	0	0
7	7663453	.	A	T	9	6	15	0	0	15	0	0
7	7663902	.	G	T	1	3	4	0	0	4	0	0
7	7664708	.	T	A	1	7	8	0	0	8	0	0
7	7664760	.	G	T	1	5	6	0	1	7	0	0
7	7664815	.	C	A	2	2	4	0	0	4	0	0
7	7664838	.	G	T	2	2	4	0	0	4	0	0
7	7666388	.	G	A	2	2	4	0	1	5	0	0
7	7705993	.	C	G	2	0	2	0	3	5	0	0
7	7706005	.	C	T	2	5	7	0	0	7	0	0
7	7706950	.	A	G	8	5	13	0	0	13	0	0
7	7707029	.	T	G	8	4	12	0	0	12	0	0
7	7708572	.	T	C	1	4	5	0	1	6	0	0
7	7708666	.	A	C	1	3	4	0	0	4	0	0
7	7785604	.	C	T	1	1	2	0	0	2	0	0
7	8890460	.	T	A	2	3	5	0	1	6	0	0
7	8890495	.	C	T	0	4	4	0	3	7	0	0
7	8890736	.	T	C	8	4	12	0	0	12	0	0
7	8890884	.	A	G	21	18	39	0	0	39	0	0
7	8890903	.	G	A	17	15	32	0	3	35	0	0
7	8890983	.	C	A	0	11	11	0	11	22	0	0
7	8891057	.	A	T	8	11	19	0	0	19	0	0
7	8891062	.	G	T	10	8	18	0	0	19	1	0
7	8891236	.	C	G	2	11	13	0	0	13	0	0
7	8891710	.	A	G	3	3	6	0	1	7	0	0
7	8891717	.	A	G	4	3	7	0	0	7	0	0
7	8891755	.	T	G	3	2	5	0	0	5	0	0
7	9302796	.	A	G	14	10	24	0	2	26	0	0
7	9302841	.	A	G	15	13	28	0	2	30	0	0
7	9322216	.	A	G	19	9	28	0	1	29	0	0
7	10582510	.	T	C	5	3	8	0	0	8	0	0
7	10582829	.	A	T	3	3	6	0	1	7	0	0
7	10582851	.	T	C	3	2	5	0	0	5	0	0
7	10701814	.	C	A	0	2	2	0	1	3	0	0
7	10873567	.	C	T	4	3	7	0	0	7	0	0
7	10874170	.	A	T	2	2	4	0	0	4	0	0
7	10874231	.	T	C	4	5	9	0	0	9	0	0
7	10874252	.	A	C	4	3	7	0	0	7	0	0
7	10874377	.	A	T	5	7	12	0	1	13	0	0
7	10874424	.	T	C	2	3	5	0	1	6	0	0
7	10874753	.	T	C	1	1	2	0	0	2	0	0
7	10874761	.	A	T	1	2	3	0	0	3	0	0
7	10874949	.	A	G	3	0	3	0	10	13	0	0
7	10875089	.	A	G	6	8	14	0	1	15	0	0
7	10875164	.	A	G	7	0	7	0	5	12	0	0
7	10875246	.	A	T	6	2	8	0	1	9	0	0
7	10875386	.	A	G	11	6	17	0	0	17	0	0
7	10875539	.	A	G	4	3	7	0	0	7	0	0
7	10875552	.	A	G	6	2	8	0	1	9	0	0
7	10875626	.	A	G	6	0	6	0	9	15	0	0
7	10875627	.	T	C	6	8	14	0	1	15	0	0
7	10875692	.	G	C	0	12	12	0	10	22	0	0
7	10875761	.	A	G	8	3	11	0	0	11	0	0
7	10875992	.	G	A	4	3	7	0	0	7	0	0
7	10876209	.	T	C	1	6	7	0	1	8	0	0
7	10876340	.	G	C	4	4	8	0	1	9	0	0
7	10876347	.	C	T	3	4	7	0	1	8	0	0
7	10876464	.	A	G	12	9	21	0	2	23	0	0
7	10876503	.	C	A	13	18	31	0	2	33	0	0
7	10876643	.	A	G	24	19	43	0	2	45	0	0
7	10876719	.	T	C	12	23	35	0	2	37	0	0
7	10876726	.	T	C	15	23	38	0	3	41	0	0
7	10876870	.	A	G	20	0	20	0	0	20	0	0
7	10876890	.	A	T	18	5	23	0	0	23	0	0
7	10876997	.	A	G	16	1	17	0	22	39	0	0
7	10877036	.	A	C	29	6	35	0	1	36	0	0
7	10877229	.	A	G	36	19	55	0	4	59	0	0
7	10877337	.	C	T	12	5	17	0	3	20	0	0
7	10912108	.	T	C	1	2	3	0	1	4	0	0
7	11004820	.	A	G	8	1	9	0	2	11	0	0
7	11004869	.	C	G	0	6	6	0	2	8	0	0
7	11004885	.	T	C	0	8	8	0	0	8	0	0
7	11005098	.	A	C	5	8	13	0	1	14	0	0
7	11005270	.	G	A	0	7	7	0	5	12	0	0
7	11005603	.	G	A	6	6	12	0	0	12	0	0
7	11005693	.	G	T	5	3	8	0	0	8	0	0
7	11340487	.	C	T	1	3	4	0	1	5	0	0
7	11340696	.	C	G	4	3	7	0	0	7	0	0
7	11340697	.	C	T	3	3	6	0	1	7	0	0
7	11340995	.	C	T	0	3	3	0	0	3	0	0
7	11341472	.	T	G	10	3	13	0	4	17	0	0
7	11341521	.	T	C	7	5	12	0	1	13	0	0
7	11341809	.	T	C	2	6	8	0	1	9	0	0
7	11341815	.	T	A	3	5	8	0	0	8	0	0
7	11341951	.	A	C	2	2	4	0	0	4	0	0
7	11341952	.	T	A	2	2	4	0	0	4	0	0
7	11342252	.	G	T	7	1	8	0	0	8	0	0
7	11378961	.	A	T	14	11	25	0	0	25	0	0
7	11379135	.	T	C	4	4	8	0	0	8	0	0
7	11384178	.	A	G	6	6	12	0	2	14	0	0
7	12062314	.	C	T	11	8	19	0	1	20	0	0
7	12062340	.	A	G	12	10	22	0	2	24	0	0
7	12063789	.	G	A	2	4	6	0	0	6	0	0
7	12064002	.	A	G	6	11	17	0	1	18	0	0
7	12065319	.	A	T	3	5	8	0	1	9	0	0
7	12141093	.	A	C	8	3	11	0	0	11	0	0
7	12141188	.	T	C	3	4	7	0	1	8	0	0
7	12141254	.	C	A	6	3	9	0	1	10	0	0
7	12141333	.	G	A	0	2	2	0	1	3	0	0
7	12141334	.	G	A	1	2	3	0	0	3	0	0
7	12141420	.	T	C	2	4	6	0	0	6	0	0
7	12141496	.	C	A	3	3	6	0	1	7	0	0
7	12142025	.	C	T	4	3	7	0	0	7	0	0
7	12142048	.	T	C	6	2	8	0	0	8	0	0
7	12142118	.	G	C	1	2	3	0	0	3	0	0
7	13486841	.	A	T	6	6	12	0	0	12	0	0
7	13677516	.	T	C	4	2	6	0	0	6	0	0
7	13677805	.	A	G	7	3	10	0	0	10	0	0
7	13858725	.	T	C	1	3	4	0	0	4	0	0
7	13858831	.	G	A	5	4	9	0	1	10	0	0
7	13897192	.	C	T	1	2	3	0	1	4	0	0
7	13897636	.	C	T	2	2	4	0	0	4	0	0
7	13900964	.	A	G	1	2	3	0	0	3	0	0
7	13900967	.	G	A	1	2	3	0	0	3	0	0
7	14205503	.	G	A	2	2	4	0	0	4	0	0
7	14205527	.	G	C	2	2	4	0	0	4	0	0
7	14205559	.	T	C	0	1	1	0	2	3	0	0
7	14206383	.	C	T	3	2	5	0	2	7	0	0
7	14206428	.	A	T	2	3	5	0	1	6	0	0
7	14206499	.	T	A	1	4	5	0	0	6	1	0
7	14206790	.	T	G	6	8	14	0	1	15	0	0
7	14206847	.	C	A	5	2	7	0	0	7	0	0
7	14265966	.	A	T	1	3	4	0	0	4	0	0
7	14394839	.	G	C	1	7	8	0	0	8	0	0
7	14394860	.	A	C	3	6	9	0	1	10	0	0
7	14394891	.	G	A	6	3	9	0	0	9	0	0
7	14394925	.	A	G	6	1	7	0	2	9	0	0
7	14394991	.	G	A	1	4	5	0	0	5	0	0
7	14395029	.	A	G	1	3	4	0	0	4	0	0
7	14512064	.	G	A	2	9	11	0	1	12	0	0
7	14512081	.	A	C	4	9	13	0	0	13	0	0
7	14512099	.	C	G	4	6	10	0	3	13	0	0
7	14532066	.	T	C	2	1	3	0	1	4	0	0
7	14534326	.	T	C	2	0	2	0	7	9	0	0
7	14534789	.	T	C	0	1	1	0	0	1	0	0
7	14535719	.	T	C	1	0	1	0	0	1	0	0
7	14535749	.	T	A	3	2	5	0	0	5	0	0
7	14535782	.	G	T	7	6	13	0	0	13	0	0
7	14539470	.	T	C	0	2	2	0	0	2	0	0
7	14542854	.	C	T	5	3	8	0	0	8	0	0
7	14542893	.	C	T	4	5	9	0	1	10	0	0
7	14543002	.	T	C	9	7	16	0	0	16	0	0
7	14543031	.	G	A	6	6	12	0	1	13	0	0
7	14543128	.	A	T	1	2	3	0	1	4	0	0
7	14543156	.	T	G	2	3	5	0	0	5	0	0
7	14543391	.	A	G	1	5	6	0	0	6	0	0
7	14543454	.	G	T	3	4	7	0	0	7	0	0
7	14543463	.	T	C	2	5	7	0	0	7	0	0
7	14905516	.	G	C	1	2	3	0	0	3	0	0
7	14934738	.	G	A	2	3	5	0	0	5	0	0
7	14938134	.	C	T	13	9	22	0	2	24	0	0
7	14938404	.	C	T	6	4	10	0	0	10	0	0
7	15087643	.	G	A	4	4	8	0	0	8	0	0
7	15087831	.	A	T	1	2	3	0	0	3	0	0
7	15087833	.	G	A	0	2	2	0	1	3	0	0
7	15607650	.	C	T	1	6	7	0	0	7	0	0
7	15607809	.	A	G	4	3	7	0	0	7	0	0
7	15608620	.	G	A	1	2	3	0	1	4	0	0
7	15608767	.	T	A	2	2	4	0	0	4	0	0
7	15608774	.	C	G	2	2	4	0	0	4	0	0
7	15609137	.	A	C	2	6	8	0	0	8	0	0
7	15609387	.	T	A	6	4	10	0	0	10	0	0
7	15609469	.	C	T	11	15	26	0	2	28	0	0
7	15609520	.	G	A	3	5	8	0	1	9	0	0
7	15609673	.	C	A	4	2	6	0	0	6	0	0
7	15609675	.	G	C	4	2	6	0	0	6	0	0
7	15609826	.	C	T	7	7	14	0	0	14	0	0
7	15609961	.	C	T	14	10	24	0	1	25	0	0
7	15653514	.	G	A	1	1	2	0	2	4	0	0
7	15896959	.	G	C	1	2	3	0	0	3	0	0
7	15898712	.	C	A	2	3	5	0	0	5	0	0
7	15899189	.	T	C	1	2	3	0	1	4	0	0
7	15899191	.	A	G	2	2	4	0	0	4	0	0
7	15899286	.	A	G	2	4	6	0	1	7	0	0
7	15899468	.	A	T	6	5	11	0	0	11	0	0
7	15899532	.	T	A	9	5	14	0	1	15	0	0
7	15900102	.	G	A	3	5	8	0	0	8	0	0
7	16456854	.	C	T	1	0	1	0	0	1	0	0
7	16460093	.	C	T	3	7	10	0	1	11	0	0
7	16460252	.	G	A	1	7	8	0	1	9	0	0
7	16461094	.	G	T	2	2	4	0	1	5	0	0
7	16545638	.	C	T	2	4	6	0	3	9	0	0
7	16545777	.	T	A	1	3	4	0	2	6	0	0
7	16545790	.	A	G	1	4	5	0	0	5	0	0
7	16545860	.	G	T	2	2	4	0	0	4	0	0
7	16546048	.	T	A	5	4	9	0	1	10	0	0
7	16546052	.	G	C	0	5	5	0	5	10	0	0
7	17013899	.	C	T	2	5	7	0	0	7	0	0
7	17014219	.	A	G	2	3	5	0	0	5	0	0
7	17014301	.	T	C	2	3	5	0	1	6	0	0
7	17014453	.	A	C	6	4	10	0	0	10	0	0
7	17014531	.	C	A	5	9	14	0	1	15	0	0
7	17014548	.	G	T	7	9	16	0	0	16	0	0
7	17014621	.	T	A	6	7	13	0	2	15	0	0
7	17014653	.	C	T	9	7	16	0	0	16	0	0
7	17014748	.	T	C	6	8	14	0	0	14	0	0
7	17014809	.	A	C	11	4	15	0	1	16	0	0
7	17014815	.	T	C	10	6	16	0	2	18	0	0
7	17014914	.	A	G	3	7	10	0	2	12	0	0
7	17096421	.	T	C	3	1	4	0	1	5	0	0
7	17102964	.	G	T	4	3	7	0	2	9	0	0
7	17103021	.	A	G	1	7	8	0	0	8	0	0
7	17251126	.	A	T	0	3	3	0	0	3	0	0
7	17251222	.	G	A	0	4	4	0	6	10	0	0
7	17251234	.	A	G	9	6	15	0	0	15	0	0
7	17251325	.	C	T	0	4	4	0	1	5	0	0
7	17692797	.	G	A	2	5	7	0	0	7	0	0
7	17692857	.	T	C	3	2	5	0	0	5	0	0
7	17695039	.	C	T	0	2	2	0	1	3	0	0
7	17754299	.	G	A	2	4	6	0	0	6	0	0
7	17755831	.	T	C	1	7	8	0	0	8	0	0
7	17757019	.	A	G	33	20	53	0	5	58	0	0
7	17757024	.	C	T	23	29	52	0	7	59	0	0
7	17757078	.	A	G	29	28	57	0	2	59	0	0
7	17757243	.	T	G	33	16	49	0	2	51	0	0
7	17757261	.	T	G	0	40	40	0	7	47	0	0
7	17757371	.	T	C	30	26	56	0	3	59	0	0
7	17757408	.	G	A	32	35	67	0	1	68	0	0
7	17760943	.	C	T	2	2	4	0	0	4	0	0
7	17760955	.	C	T	5	2	7	0	0	7	0	0
7	17761063	.	A	C	3	4	7	0	0	7	0	0
7	17761117	.	T	G	3	5	8	0	0	8	0	0
7	17762433	.	C	T	2	2	4	0	0	4	0	0
7	17762455	.	C	G	0	2	2	0	3	5	0	0
7	17801064	.	A	C	1	2	3	0	0	3	0	0
7	17801896	.	T	G	2	2	4	0	0	4	0	0
7	17801900	.	A	G	2	0	2	0	2	4	0	0
7	17802968	.	T	C	1	5	6	0	0	6	0	0
7	17803056	.	T	G	1	2	3	0	0	3	0	0
7	17805595	.	T	A	5	2	7	0	0	7	0	0
7	17805706	.	C	G	6	5	11	0	0	11	0	0
7	17809860	.	C	T	0	2	2	0	0	2	0	0
7	17810581	.	C	T	5	6	11	0	0	11	0	0
7	17810611	.	G	A	4	4	8	0	1	9	0	0
7	17810624	.	C	T	5	2	7	0	0	7	0	0
7	17811052	.	T	C	0	1	1	0	0	1	0	0
7	17812892	.	T	A	4	2	6	0	0	6	0	0
7	17813283	.	A	G	2	2	4	0	0	4	0	0
7	17933314	.	C	G	0	2	2	0	0	2	0	0
7	17933323	.	C	T	0	2	2	0	0	2	0	0
7	17938069	.	C	A	1	2	3	0	1	4	0	0
7	17941936	.	C	T	2	7	9	0	0	9	0	0
7	17942370	.	G	A	2	4	6	0	0	6	0	0
7	17942451	.	A	C	4	2	6	0	0	6	0	0
7	17942482	.	A	G	2	2	4	0	1	5	0	0
7	17942883	.	T	G	5	8	13	0	2	15	0	0
7	17943078	.	A	G	8	8	16	0	1	17	0	0
7	17943133	.	C	T	13	6	19	0	1	20	0	0
7	17943170	.	G	A	0	9	9	0	22	31	0	0
7	17943376	.	C	G	11	15	26	0	0	26	0	0
7	17943509	.	A	G	23	0	23	0	26	49	0	0
7	17943851	.	G	C	3	5	8	0	1	9	0	0
7	17965749	.	G	A	0	2	2	0	0	2	0	0
7	17969145	.	C	T	2	3	5	0	0	5	0	0
7	17969792	.	A	G	5	2	7	0	0	7	0	0
7	17969793	.	A	G	5	1	6	0	1	7	0	0
7	17969851	.	A	G	3	5	8	0	0	8	0	0
7	17969883	.	G	C	0	3	3	0	2	5	0	0
7	17969949	.	A	G	2	4	6	0	0	6	0	0
7	17970186	.	G	A	6	4	10	0	0	10	0	0
7	17970391	.	A	C	1	8	9	0	1	10	0	0
7	17970654	.	G	A	5	4	9	0	2	11	0	0
7	17970790	.	A	G	1	5	6	0	0	6	0	0
7	18072797	.	T	G	1	3	4	0	0	4	0	0
7	18072888	.	C	T	1	2	3	0	0	3	0	0
7	18072889	.	C	T	1	2	3	0	0	3	0	0
7	18114316	.	G	A	0	14	14	0	16	30	0	0
7	18114495	.	C	T	2	7	9	0	2	11	0	0
7	18114518	.	A	T	3	2	5	0	4	9	0	0
7	18115220	.	T	A	14	13	27	0	3	30	0	0
7	18115261	.	G	T	9	13	22	0	2	24	0	0
7	18115302	.	G	A	0	8	8	0	10	18	0	0
7	18115470	.	C	T	15	15	30	0	2	32	0	0
7	18115584	.	T	G	5	18	23	0	0	23	0	0
7	18115721	.	G	A	0	12	12	0	29	41	0	0
7	18116037	.	C	T	8	13	21	0	2	23	0	0
7	18116204	.	G	A	30	21	51	0	8	59	0	0
7	18122445	.	C	G	9	13	22	0	1	23	0	0
7	18122541	.	G	C	18	1	19	0	31	51	1	0
7	18124218	.	C	T	6	7	13	0	0	13	0	0
7	18124314	.	C	T	10	10	20	0	0	20	0	0
7	18124329	.	T	A	6	5	11	0	2	13	0	0
7	18137325	.	C	T	0	6	6	0	20	26	0	0
7	18146699	.	T	G	10	2	12	0	1	13	0	0
7	18168253	.	T	A	7	5	12	0	0	12	0	0
7	18412722	.	A	C	0	0	0	0	5	5	0	0
7	18412779	.	A	G	3	6	9	0	0	9	0	0
7	18413585	.	A	C	3	3	6	0	1	7	0	0
7	18413745	.	G	A	2	3	5	0	0	5	0	0
7	18462420	.	A	T	1	3	4	0	1	5	0	0
7	18462466	.	T	C	1	3	4	0	0	4	0	0
7	18462498	.	A	G	1	4	5	0	0	5	0	0
7	18462531	.	A	T	0	3	3	0	0	3	0	0
7	18462543	.	C	G	3	3	6	0	0	6	0	0
7	18462587	.	G	A	2	3	5	0	0	5	0	0
7	18462600	.	A	G	2	4	6	0	0	6	0	0
7	18462733	.	G	A	7	6	13	0	0	13	0	0
7	18463132	.	T	A	2	3	5	0	0	5	0	0
7	18464919	.	C	T	1	3	4	0	0	4	0	0
7	18465000	.	G	A	5	2	7	0	0	7	0	0
7	18465096	.	A	G	2	2	4	0	0	4	0	0
7	18474994	.	C	T	1	3	4	0	0	4	0	0
7	18550499	.	C	T	1	2	3	0	0	3	0	0
7	18558504	.	C	T	15	8	23	0	3	26	0	0
7	18558806	.	A	T	18	10	28	0	1	29	0	0
7	18558871	.	G	A	7	13	20	0	2	22	0	0
7	18558906	.	T	G	8	14	22	0	4	26	0	0
7	18559197	.	G	T	5	5	10	0	0	10	0	0
7	18559212	.	C	A	4	5	9	0	1	10	0	0
7	18559258	.	A	G	3	9	12	0	0	12	0	0
7	18559402	.	G	T	1	4	5	0	2	7	0	0
7	18559576	.	A	G	3	2	5	0	0	5	0	0
7	18559594	.	G	A	3	2	5	0	1	6	0	0
7	18560013	.	C	A	1	6	7	0	0	7	0	0
7	18560047	.	G	A	1	3	4	0	1	5	0	0
7	18560397	.	C	T	0	2	2	0	1	3	0	0
7	18564045	.	A	G	1	1	2	0	0	2	0	0
7	18564072	.	T	C	1	1	2	0	0	2	0	0
7	18606967	.	A	G	2	5	7	0	0	7	0	0
7	18618113	.	T	A	6	12	18	0	5	23	0	0
7	18618776	.	T	C	2	7	9	0	0	9	0	0
7	18618859	.	A	G	3	2	5	0	0	5	0	0
7	18618860	.	T	C	1	0	1	0	4	5	0	0
7	18618927	.	T	C	6	10	16	0	1	17	0	0
7	18657422	.	G	A	1	2	3	0	1	4	0	0
7	18705665	.	G	A	3	2	5	0	1	6	0	0
7	18705728	.	G	A	1	1	2	0	0	2	0	0
7	18780119	.	A	G	4	3	7	0	1	8	0	0
7	18780196	.	A	G	8	5	13	0	0	13	0	0
7	18810710	.	C	T	3	2	5	0	0	5	0	0
7	18971066	.	G	T	1	2	3	0	0	3	0	0
7	18971068	.	C	A	0	1	1	0	2	3	0	0
7	18980857	.	T	C	1	5	6	0	0	6	0	0
7	18983123	.	G	A	0	2	2	0	1	3	0	0
7	19055605	.	C	T	9	8	17	0	1	18	0	0
7	19065861	.	A	G	0	1	1	0	0	1	0	0
7	19070994	.	C	T	0	9	9	0	19	28	0	0
7	19073379	.	T	A	1	2	3	0	0	3	0	0
7	19073380	.	A	T	1	2	3	0	0	3	0	0
7	19179977	.	C	T	0	3	3	0	3	6	0	0
7	19180024	.	T	C	4	0	4	0	4	8	0	0
7	19180029	.	A	G	4	5	9	0	0	9	0	0
7	19180152	.	T	A	2	5	7	0	0	7	0	0
7	19180589	.	C	T	3	2	5	0	1	6	0	0
7	20529578	.	A	C	1	1	2	0	0	2	0	0
7	20529725	.	C	T	1	6	7	0	0	7	0	0
7	20529728	.	G	A	1	6	7	0	0	7	0	0
7	20529760	.	C	T	3	3	6	0	1	7	0	0
7	20529773	.	T	C	6	5	11	0	0	11	0	0
7	20530284	.	A	T	2	10	12	0	0	12	0	0
7	20530314	.	G	A	2	7	9	0	3	12	0	0
7	20530338	.	C	T	5	7	12	0	1	13	0	0
7	20530373	.	T	A	9	7	16	0	0	16	0	0
7	20593682	.	G	A	0	1	1	0	1	2	0	0
7	20593809	.	G	A	2	1	3	0	1	4	0	0
7	20597033	.	G	A	4	3	7	0	0	7	0	0
7	20597132	.	C	T	3	15	18	0	0	18	0	0
7	20600211	.	T	A	2	0	2	0	0	2	0	0
7	20600398	.	C	T	10	8	18	0	0	18	0	0
7	20600447	.	A	G	10	0	10	0	11	21	0	0
7	20601052	.	G	A	5	3	8	0	0	8	0	0
7	20601072	.	T	C	3	2	5	0	2	7	0	0
7	20601192	.	C	T	5	3	8	0	0	8	0	0
7	20601250	.	A	G	1	2	3	0	2	5	0	0
7	20601325	.	A	G	2	4	6	0	1	7	0	0
7	20601410	.	T	A	2	2	4	0	0	4	0	0
7	20601524	.	G	A	1	1	2	0	1	3	0	0
7	20601539	.	T	C	3	2	5	0	0	5	0	0
7	20601578	.	T	C	2	2	4	0	0	4	0	0
7	20601583	.	T	C	2	2	4	0	0	4	0	0
7	20601713	.	A	T	2	2	4	0	0	4	0	0
7	20629792	.	G	A	1	5	6	0	0	6	0	0
7	20629801	.	A	G	1	5	6	0	0	6	0	0
7	20629844	.	A	G	3	2	5	0	0	5	0	0
7	20634498	.	T	A	1	2	3	0	0	3	0	0
7	20634577	.	T	G	2	3	5	0	2	7	0	0
7	20636344	.	A	G	3	7	10	0	0	10	0	0
7	20636379	.	A	T	5	6	11	0	1	12	0	0
7	20636410	.	C	T	3	10	13	0	0	13	0	0
7	20636414	.	T	G	2	10	12	0	3	15	0	0
7	20636464	.	G	A	3	12	15	0	1	16	0	0
7	20636465	.	A	G	3	13	16	0	0	16	0	0
7	20636802	.	T	G	4	15	19	0	0	19	0	0
7	20636844	.	T	A	2	21	23	0	2	25	0	0
7	20693673	.	G	T	4	5	9	0	0	9	0	0
7	20695949	.	G	T	4	2	6	0	0	6	0	0
7	20712555	.	C	T	1	1	2	0	0	2	0	0
7	20712817	.	G	A	5	2	7	0	0	7	0	0
7	20772180	.	G	A	2	2	4	0	0	4	0	0
7	20780285	.	G	A	4	4	8	0	1	9	0	0
7	20780317	.	C	T	1	6	7	0	1	8	0	0
7	20780337	.	A	C	2	4	6	0	0	7	1	0
7	20780356	.	A	G	4	3	7	0	0	7	0	0
7	20780424	.	A	T	8	9	17	0	0	17	0	0
7	20780453	.	C	A	5	9	14	0	1	15	0	0
7	20780732	.	A	C	4	5	9	0	0	9	0	0
7	20780918	.	C	T	0	4	4	0	6	10	0	0
7	20780987	.	G	A	5	3	8	0	2	10	0	0
7	20781253	.	T	C	5	3	8	0	0	8	0	0
7	20781327	.	A	G	1	2	3	0	0	3	0	0
7	20781549	.	C	G	2	4	6	0	0	6	0	0
7	20781996	.	T	G	1	2	3	0	0	3	0	0
7	20859446	.	G	C	4	9	13	0	0	13	0	0
7	20859823	.	T	A	2	4	6	0	1	7	0	0
7	20859975	.	G	A	5	2	7	0	1	8	0	0
7	20864097	.	A	G	1	0	1	0	0	1	0	0
7	20864256	.	T	C	0	1	1	0	0	1	0	0
7	20935684	.	C	T	0	1	1	0	0	1	0	0
7	20935737	.	T	A	1	2	3	0	0	3	0	0
7	20935765	.	A	G	1	0	1	0	0	1	0	0
7	21626312	.	G	A	2	6	8	0	1	9	0	0
7	21768334	.	C	A	2	2	4	0	1	5	0	0
7	21773542	.	C	T	1	3	4	0	0	4	0	0
7	21773626	.	C	T	1	2	3	0	0	3	0	0
7	21774127	.	G	A	3	1	4	0	0	4	0	0
7	21776426	.	C	T	0	3	3	0	0	3	0	0
7	21776683	.	G	A	4	2	6	0	1	7	0	0
7	21776693	.	T	C	6	2	8	0	0	8	0	0
7	21777720	.	G	A	10	13	23	0	4	27	0	0
7	21777978	.	T	G	12	15	27	0	2	29	0	0
7	21778055	.	G	A	3	5	8	0	1	9	0	0
7	21778070	.	T	C	2	4	6	0	1	7	0	0
7	21876652	.	T	C	1	2	3	0	0	3	0	0
7	21879728	.	A	G	1	2	3	0	0	3	0	0
7	21881863	.	C	T	2	2	4	0	1	5	0	0
7	21887797	.	A	T	1	1	2	0	0	2	0	0
7	21887967	.	C	T	15	9	24	0	3	27	0	0
7	21888084	.	T	A	22	13	35	0	0	35	0	0
7	21888274	.	T	A	13	16	29	0	0	29	0	0
7	21890998	.	C	T	1	2	3	0	0	3	0	0
7	21940965	.	T	G	1	14	15	0	0	15	0	0
7	21940992	.	A	G	5	20	25	0	0	25	0	0
7	21941016	.	T	G	13	22	35	0	0	35	0	0
7	21941460	.	G	A	15	11	26	0	3	29	0	0
7	21941477	.	C	A	14	13	27	0	2	29	0	0
7	21941568	.	C	T	13	12	25	0	0	25	0	0
7	21941579	.	A	C	11	7	18	0	3	21	0	0
7	21942378	.	C	T	7	12	19	0	1	20	0	0
7	21942513	.	A	T	6	12	18	0	1	20	1	0
7	21942644	.	T	A	8	4	12	0	1	13	0	0
7	21942672	.	C	T	13	5	18	0	1	19	0	0
7	21943553	.	A	G	3	3	6	0	0	6	0	0
7	21943772	.	T	C	1	4	5	0	0	5	0	0
7	22295624	.	G	A	0	1	1	0	0	1	0	0
7	22295636	.	T	G	0	0	0	0	1	1	0	0
7	22323821	.	A	G	2	4	6	0	0	6	0	0
7	22323934	.	C	T	6	2	8	0	1	9	0	0
7	22323976	.	C	T	3	2	5	0	0	5	0	0
7	22323998	.	A	G	3	2	5	0	0	5	0	0
7	22324029	.	G	A	0	4	4	0	4	8	0	0
7	22324261	.	C	T	5	6	11	0	1	12	0	0
7	22324727	.	A	G	7	4	11	0	0	11	0	0
7	22626525	.	A	T	4	2	6	0	0	6	0	0
7	22630003	.	T	A	18	25	43	0	0	43	0	0
7	22630087	.	A	G	16	18	34	0	4	38	0	0
7	22630096	.	T	C	16	0	16	0	16	32	0	0
7	22630189	.	C	T	28	18	46	0	0	46	0	0
7	22630297	.	A	G	9	19	28	0	1	29	0	0
7	22630581	.	C	T	2	23	25	0	17	42	0	0
7	22630655	.	T	C	10	0	10	0	14	24	0	0
7	22630670	.	A	G	8	8	16	0	0	16	0	0
7	22632253	.	T	A	3	7	10	0	0	10	0	0
7	22735394	.	C	A	1	3	4	0	1	5	0	0
7	22735421	.	A	T	1	2	3	0	0	3	0	0
7	22760761	.	G	T	17	16	33	0	2	35	0	0
7	22795566	.	G	A	3	6	9	0	0	9	0	0
7	22795583	.	T	C	2	3	5	0	1	6	0	0
7	22800390	.	G	T	1	10	11	0	1	12	0	0
7	22806668	.	G	A	0	10	10	0	27	37	0	0
7	22809956	.	G	A	1	2	3	0	0	3	0	0
7	22816078	.	G	A	0	4	4	0	9	13	0	0
7	22819933	.	T	A	8	12	20	0	5	25	0	0
7	22819975	.	A	T	7	8	15	0	17	32	0	0
7	22820704	.	C	G	1	1	2	0	4	6	0	0
7	22838359	.	T	C	2	0	2	0	0	2	0	0
7	22843256	.	A	G	1	1	2	0	1	3	0	0
7	22843310	.	A	T	5	5	10	0	0	10	0	0
7	22849948	.	A	T	12	10	22	0	4	26	0	0
7	22849949	.	C	T	15	11	26	0	0	26	0	0
7	22850098	.	T	C	11	13	24	0	2	26	0	0
7	22850137	.	T	A	8	13	21	0	2	23	0	0
7	22850277	.	A	T	4	2	6	0	1	7	0	0
7	22850365	.	C	T	6	9	15	0	0	15	0	0
7	22850446	.	C	A	13	10	23	0	3	26	0	0
7	22850767	.	G	T	5	2	7	0	0	7	0	0
7	22851036	.	C	T	11	15	26	0	0	26	0	0
7	22851133	.	C	T	22	10	32	0	1	33	0	0
7	22851739	.	A	C	27	26	53	0	3	56	0	0
7	22911938	.	T	C	2	3	5	0	0	5	0	0
7	22911984	.	G	T	3	3	6	0	0	6	0	0
7	23492644	.	T	C	1	3	4	0	0	4	0	0
7	23493485	.	T	G	1	2	3	0	0	3	0	0
7	23493841	.	T	C	2	3	5	0	0	5	0	0
7	23494082	.	T	G	4	2	6	0	0	6	0	0
7	23494107	.	A	T	4	4	8	0	0	8	0	0
7	23539951	.	G	A	0	2	2	0	2	4	0	0
7	23540540	.	A	G	3	0	3	0	6	9	0	0
7	23540643	.	A	G	3	2	5	0	1	6	0	0
7	23540887	.	G	A	4	7	11	0	1	12	0	0
7	23541083	.	C	T	1	6	7	0	0	7	0	0
7	23541508	.	T	G	6	3	9	0	0	9	0	0
7	23541696	.	G	T	7	15	22	0	1	23	0	0
7	23541847	.	G	C	11	8	19	0	1	20	0	0
7	23541852	.	T	C	8	10	18	0	0	18	0	0
7	23542151	.	T	G	8	6	14	0	0	14	0	0
7	23542543	.	C	T	19	14	33	0	1	34	0	0
7	23542586	.	G	T	19	13	32	0	1	33	0	0
7	23542678	.	C	A	18	15	33	0	0	33	0	0
7	23542785	.	T	G	20	0	20	0	15	35	0	0
7	23542794	.	T	C	19	12	31	0	1	32	0	0
7	23704869	.	G	A	1	0	1	0	0	1	0	0
7	23710275	.	T	A	1	5	6	0	0	6	0	0
7	23710311	.	C	T	4	7	11	0	0	11	0	0
7	23713828	.	G	T	1	4	5	0	0	5	0	0
7	23718778	.	C	G	0	1	1	0	0	1	0	0
7	23718924	.	A	G	2	5	7	0	0	7	0	0
7	23724311	.	T	A	5	8	13	0	1	14	0	0
7	23724418	.	C	T	5	9	14	0	1	15	0	0
7	23724556	.	C	A	4	12	16	0	0	16	0	0
7	23724607	.	C	T	9	9	18	0	1	19	0	0
7	23725239	.	C	T	14	9	23	0	2	25	0	0
7	23725276	.	T	C	9	14	23	0	0	23	0	0
7	23725285	.	A	T	7	12	19	0	2	21	0	0
7	23725366	.	T	A	10	14	24	0	0	24	0	0
7	23725426	.	C	A	16	12	28	0	0	28	0	0
7	23728297	.	C	G	2	2	4	0	0	4	0	0
7	23728312	.	A	G	3	1	4	0	1	5	0	0
7	23728504	.	T	C	3	1	4	0	0	4	0	0
7	23731275	.	A	C	3	2	5	0	1	6	0	0
7	23731278	.	A	G	3	2	5	0	0	5	0	0
7	23749277	.	G	A	17	14	31	0	0	31	0	0
7	23749490	.	G	A	16	18	34	0	3	38	1	0
7	23749513	.	A	T	17	13	30	0	2	32	0	0
7	23749679	.	A	G	8	12	20	0	0	20	0	0
7	23749831	.	C	A	3	14	17	0	1	18	0	0
7	23749954	.	A	T	13	17	30	0	0	30	0	0
7	23750491	.	T	C	9	4	13	0	0	13	0	0
7	23750665	.	C	T	6	3	9	0	0	9	0	0
7	23750955	.	C	T	2	3	5	0	0	5	0	0
7	23750962	.	A	T	2	2	4	0	0	4	0	0
7	23750992	.	T	A	0	4	4	0	1	5	0	0
7	23751043	.	C	T	5	9	14	0	0	14	0	0
7	23751866	.	C	G	1	3	4	0	1	5	0	0
7	23752246	.	T	C	4	2	6	0	0	6	0	0
7	23753341	.	T	A	3	1	4	0	0	4	0	0
7	23756208	.	T	C	1	2	3	0	0	3	0	0
7	23883399	.	G	A	1	3	4	0	0	4	0	0
7	23883548	.	A	C	3	16	19	0	2	21	0	0
7	23883970	.	C	T	9	10	19	0	0	19	0	0
7	23884004	.	G	A	5	11	16	0	2	18	0	0
7	23884058	.	T	C	9	12	21	0	0	21	0	0
7	23884061	.	C	G	7	12	19	0	3	22	0	0
7	23884445	.	C	T	22	25	47	0	4	51	0	0
7	23884641	.	A	G	16	0	16	0	26	43	1	0
7	23884667	.	C	A	14	24	38	0	2	40	0	0
7	23887738	.	T	G	12	4	16	0	0	16	0	0
7	23887784	.	C	T	10	7	17	0	1	18	0	0
7	23887865	.	T	C	11	14	25	0	1	26	0	0
7	23888099	.	A	G	3	4	7	0	2	10	1	0
7	23888155	.	T	G	9	11	20	0	1	21	0	0
7	23889947	.	C	T	7	4	11	0	1	12	0	0
7	23892884	.	G	A	0	1	1	0	0	1	0	0
7	23894605	.	G	A	1	2	3	0	1	4	0	0
7	23907784	.	G	T	2	4	6	0	0	6	0	0
7	23909735	.	T	C	5	3	8	0	3	11	0	0
7	23909757	.	C	T	7	4	11	0	1	12	0	0
7	23909975	.	A	G	9	6	15	0	1	16	0	0
7	23915203	.	C	T	16	19	35	0	4	39	0	0
7	23915359	.	G	A	0	15	15	0	26	41	0	0
7	23915485	.	A	T	21	25	46	0	4	50	0	0
7	23915700	.	G	T	11	19	30	0	3	33	0	0
7	23915916	.	T	A	22	30	52	0	4	57	1	0
7	23967878	.	G	A	11	18	29	0	1	30	0	0
7	23968108	.	G	A	13	6	19	0	1	20	0	0
7	23968267	.	A	C	5	9	14	0	0	14	0	0
7	23968292	.	T	G	7	5	12	0	2	14	0	0
7	23968330	.	C	G	6	4	10	0	2	12	0	0
7	23968344	.	C	T	7	5	12	0	0	12	0	0
7	23969361	.	G	A	2	4	6	0	0	6	0	0
7	23969535	.	G	A	5	2	7	0	1	8	0	0
7	23970320	.	G	T	1	6	7	0	0	7	0	0
7	23970331	.	G	A	1	3	4	0	0	4	0	0
7	24012794	.	T	C	1	2	3	0	2	5	0	0
7	24013044	.	A	G	3	0	3	0	6	9	0	0
7	24013269	.	G	A	3	9	12	0	0	12	0	0
7	24013274	.	A	C	9	3	12	0	0	12	0	0
7	24013489	.	G	A	0	7	7	0	4	11	0	0
7	24013560	.	T	C	10	3	13	0	1	14	0	0
7	24013662	.	C	A	11	8	19	0	0	19	0	0
7	24034008	.	C	T	1	2	3	0	0	3	0	0
7	24034112	.	G	A	1	3	4	0	0	4	0	0
7	24039773	.	T	C	3	4	7	0	2	9	0	0
7	24039800	.	C	A	5	3	8	0	0	8	0	0
7	24067359	.	C	T	1	4	5	0	0	5	0	0
7	24067611	.	C	T	4	5	9	0	0	9	0	0
7	24067906	.	C	A	9	4	13	0	0	13	0	0
7	24067907	.	T	A	9	4	13	0	0	13	0	0
7	24068224	.	A	T	6	4	10	0	2	12	0	0
7	24068230	.	C	T	7	6	13	0	0	13	0	0
7	24068491	.	C	T	7	8	15	0	2	17	0	0
7	24068523	.	C	A	11	7	18	0	1	19	0	0
7	24068586	.	C	T	2	2	4	0	0	4	0	0
7	24068722	.	T	C	3	2	5	0	1	6	0	0
7	24068761	.	G	T	13	4	17	0	0	17	0	0
7	24068904	.	T	A	5	2	7	0	0	7	0	0
7	24076329	.	C	T	1	5	6	0	0	6	0	0
7	24084887	.	G	A	0	1	1	0	1	2	0	0
7	24091054	.	G	A	8	5	13	0	2	15	0	0
7	24091249	.	A	G	7	7	14	0	0	14	0	0
7	24093102	.	C	T	17	13	30	0	1	31	0	0
7	24093105	.	C	T	15	14	29	0	2	31	0	0
7	24093165	.	C	G	17	6	23	0	0	23	0	0
7	24093372	.	A	G	0	2	2	0	0	2	0	0
7	24095515	.	C	G	11	18	29	0	0	29	0	0
7	24095776	.	G	A	7	15	22	0	1	23	0	0
7	24095926	.	A	C	6	15	21	0	2	23	0	0
7	24096015	.	C	T	25	9	34	0	0	34	0	0
7	24096165	.	T	C	24	15	39	0	2	41	0	0
7	24096195	.	C	G	23	13	36	0	4	40	0	0
7	24096399	.	C	A	15	19	34	0	0	34	0	0
7	24096447	.	T	G	15	20	35	0	1	36	0	0
7	24096505	.	G	A	0	7	7	0	13	20	0	0
7	24096541	.	C	T	0	16	16	0	2	19	1	0
7	24096767	.	A	C	18	26	44	0	7	51	0	0
7	24100511	.	G	A	1	2	3	0	0	3	0	0
7	24115186	.	G	A	0	1	1	0	0	1	0	0
7	24124479	.	C	T	3	2	5	0	0	5	0	0
7	24161648	.	G	A	0	6	6	0	5	11	0	0
7	24161776	.	C	G	5	10	15	0	0	15	0	0
7	24161786	.	G	C	5	9	14	0	1	15	0	0
7	24162047	.	T	A	2	4	6	0	0	6	0	0
7	24162267	.	G	T	6	6	12	0	1	13	0	0
7	24162457	.	T	C	12	6	18	0	1	19	0	0
7	24162485	.	C	T	11	4	15	0	1	16	0	0
7	24162782	.	G	A	5	4	9	0	1	10	0	0
7	24197574	.	C	A	1	4	5	0	1	6	0	0
7	24197622	.	G	T	1	3	4	0	0	4	0	0
7	24198029	.	G	A	4	2	6	0	0	6	0	0
7	24198041	.	C	A	4	3	7	0	0	7	0	0
7	24198334	.	C	T	3	4	7	0	0	7	0	0
7	24198335	.	C	T	0	4	4	0	3	7	0	0
7	24201447	.	A	T	0	2	2	0	0	2	0	0
7	24201453	.	G	A	0	2	2	0	0	2	0	0
7	24205077	.	C	A	10	4	14	0	0	14	0	0
7	24207520	.	A	C	10	25	35	0	1	36	0	0
7	24207590	.	A	T	18	15	33	0	2	35	0	0
7	24207632	.	G	C	20	10	30	0	1	31	0	0
7	24210422	.	T	C	12	15	27	0	2	29	0	0
7	24210913	.	T	C	6	0	6	0	16	22	0	0
7	24211015	.	A	T	8	4	12	0	0	12	0	0
7	24211027	.	G	T	3	4	7	0	0	7	0	0
7	24211054	.	G	A	2	6	8	0	0	8	0	0
7	24211081	.	T	A	5	11	16	0	0	16	0	0
7	24211104	.	C	T	0	9	9	0	8	17	0	0
7	24211978	.	G	A	8	6	14	0	1	15	0	0
7	24212159	.	G	C	4	1	5	0	4	9	0	0
7	24214655	.	C	T	1	0	1	0	0	1	0	0
7	24357396	.	C	T	0	2	2	0	2	4	0	0
7	24357403	.	C	T	2	3	5	0	0	5	0	0
7	24378464	.	T	C	4	2	6	0	1	7	0	0
7	24457647	.	A	T	29	30	59	0	1	60	0	0
7	24457845	.	T	C	34	10	44	0	1	45	0	0
7	24458128	.	G	C	26	16	42	0	2	44	0	0
7	24458282	.	C	T	14	19	33	0	2	35	0	0
7	24458345	.	C	A	11	24	35	0	1	36	0	0
7	24458349	.	A	C	12	24	36	0	1	37	0	0
7	24458513	.	T	C	16	10	26	0	2	28	0	0
7	24458713	.	T	C	7	0	7	0	7	14	0	0
7	24458717	.	G	A	7	5	12	0	1	13	0	0
7	24458794	.	T	A	9	3	12	0	2	14	0	0
7	24458866	.	T	C	8	6	14	0	2	16	0	0
7	24458894	.	T	A	9	8	17	0	2	19	0	0
7	24459667	.	T	A	10	11	21	0	0	21	0	0
7	24459847	.	A	G	7	7	14	0	0	14	0	0
7	24459932	.	T	C	9	7	16	0	0	16	0	0
7	24460443	.	G	A	1	6	7	0	0	7	0	0
7	24460461	.	G	A	5	4	9	0	1	10	0	0
7	24461420	.	C	A	1	2	3	0	0	3	0	0
7	24461601	.	A	G	2	3	5	0	0	5	0	0
7	24462394	.	A	G	2	2	4	0	0	4	0	0
7	24486345	.	A	G	28	22	50	0	1	51	0	0
7	24486515	.	A	C	28	31	59	0	5	64	0	0
7	24486721	.	G	A	36	31	67	0	1	68	0	0
7	24491382	.	G	A	7	2	9	0	0	9	0	0
7	24498912	.	C	T	1	1	2	0	0	2	0	0
7	24501156	.	T	C	0	2	2	0	0	2	0	0
7	24501168	.	T	C	0	1	1	0	0	1	0	0
7	24502858	.	G	A	0	7	7	0	9	16	0	0
7	24502867	.	C	T	6	8	14	0	1	15	0	0
7	24502948	.	C	T	2	1	3	0	0	3	0	0
7	24504508	.	C	T	2	4	6	0	0	6	0	0
7	24504875	.	C	T	6	11	17	0	1	18	0	0
7	24505063	.	A	G	3	4	7	0	0	7	0	0
7	24505321	.	T	C	2	9	11	0	0	11	0	0
7	25348396	.	A	T	2	2	4	0	0	4	0	0
7	25854290	.	A	G	2	2	4	0	0	4	0	0
7	25870065	.	C	T	0	3	3	0	1	4	0	0
7	25870068	.	T	C	1	3	4	0	0	4	0	0
7	25876947	.	A	C	3	7	10	0	0	10	0	0
7	25877109	.	A	T	9	4	13	0	0	13	0	0
7	25877215	.	C	A	5	8	13	0	4	17	0	0
7	25877541	.	T	A	2	2	4	0	0	4	0	0
7	25877553	.	G	A	0	2	2	0	1	3	0	0
7	25878282	.	G	A	17	23	40	0	2	42	0	0
7	25878432	.	C	T	7	4	11	0	0	11	0	0
7	25878901	.	G	A	13	28	41	0	0	41	0	0
7	25878977	.	A	G	17	21	38	0	2	40	0	0
7	25879116	.	T	G	22	20	42	0	5	47	0	0
7	25879130	.	G	C	24	21	45	0	2	47	0	0
7	25879534	.	C	T	13	16	29	0	0	29	0	0
7	25879637	.	A	G	18	7	25	0	3	28	0	0
7	25879787	.	C	G	7	8	15	0	3	18	0	0
7	25879936	.	G	T	10	9	19	0	1	20	0	0
7	25880046	.	C	A	4	5	9	0	0	9	0	0
7	25880207	.	T	A	4	6	10	0	0	10	0	0
7	25880313	.	T	A	12	6	18	0	0	18	0	0
7	25880730	.	G	T	4	4	8	0	2	10	0	0
7	25880737	.	C	T	0	2	2	0	8	10	0	0
7	25880979	.	C	G	6	8	14	0	1	15	0	0
7	25881103	.	T	G	4	3	7	0	1	8	0	0
7	25881303	.	C	T	6	2	8	0	0	8	0	0
7	25881912	.	T	C	4	0	4	0	3	7	0	0
7	25881915	.	T	C	4	0	4	0	1	5	0	0
7	25917046	.	A	G	10	13	23	0	1	24	0	0
7	25917473	.	G	A	0	36	36	0	28	64	0	0
7	25917634	.	A	T	24	37	61	0	2	63	0	0
7	25918101	.	T	G	29	0	29	0	34	63	0	0
7	25918112	.	A	T	25	31	56	0	1	57	0	0
7	25979372	.	C	T	1	0	1	0	0	1	0	0
7	25979417	.	C	T	1	2	3	0	1	4	0	0
7	25979468	.	C	T	5	5	10	0	0	10	0	0
7	25986099	.	C	T	1	3	4	0	0	4	0	0
7	25988324	.	C	A	0	1	1	0	1	2	0	0
7	25998602	.	C	T	4	2	6	0	0	6	0	0
7	26002812	.	T	C	10	16	26	0	0	26	0	0
7	26003424	.	G	A	26	15	41	0	4	45	0	0
7	26003853	.	C	T	1	3	4	0	0	4	0	0
7	26004014	.	G	T	1	4	5	0	0	5	0	0
7	26004391	.	C	A	4	13	17	0	3	20	0	0
7	26004519	.	G	A	10	8	18	0	2	20	0	0
7	26005574	.	A	T	2	3	5	0	0	5	0	0
7	26015523	.	T	C	1	0	1	0	0	1	0	0
7	26020078	.	T	C	1	0	1	0	0	1	0	0
7	26020174	.	A	T	2	2	4	0	0	4	0	0
7	26026220	.	A	T	12	10	22	0	1	23	0	0
7	26026330	.	A	T	7	9	16	0	1	17	0	0
7	26026358	.	A	C	6	5	11	0	0	11	0	0
7	26026375	.	G	A	5	4	9	0	0	9	0	0
7	26026491	.	T	G	1	3	4	0	0	4	0	0
7	26073519	.	A	T	6	4	10	0	0	10	0	0
7	26074160	.	C	A	4	6	10	0	0	10	0	0
7	26076368	.	A	G	0	4	4	0	0	4	0	0
7	26078243	.	A	C	13	13	26	0	2	28	0	0
7	26078284	.	C	T	11	8	19	0	2	21	0	0
7	26078435	.	G	T	7	7	14	0	2	16	0	0
7	26078516	.	T	A	8	4	12	0	1	13	0	0
7	26078967	.	A	G	12	7	19	0	4	23	0	0
7	26078983	.	G	A	10	6	16	0	1	17	0	0
7	26081171	.	C	T	3	2	5	0	0	5	0	0
7	26081546	.	T	G	2	3	5	0	0	5	0	0
7	26116445	.	A	G	1	2	3	0	0	3	0	0
7	26116586	.	G	A	1	4	5	0	1	6	0	0
7	26116600	.	C	A	1	4	5	0	0	5	0	0
7	26142489	.	G	A	2	3	5	0	0	5	0	0
7	26142606	.	G	A	0	2	2	0	1	3	0	0
7	26145158	.	C	T	1	2	3	0	0	3	0	0
7	26145161	.	G	A	1	2	3	0	0	3	0	0
7	26145252	.	A	C	3	2	5	0	0	5	0	0
7	26145267	.	T	A	2	3	5	0	0	5	0	0
7	26145329	.	T	A	3	5	8	0	0	8	0	0
7	26145441	.	C	G	3	8	11	0	0	11	0	0
7	26145451	.	A	G	3	7	10	0	1	11	0	0
7	26145491	.	G	A	4	5	9	0	0	9	0	0
7	26145492	.	G	A	3	5	8	0	1	9	0	0
7	26146176	.	A	C	5	12	17	0	3	20	0	0
7	26146188	.	T	C	7	11	18	0	1	19	0	0
7	26146411	.	T	C	11	12	23	0	0	23	0	0
7	26146952	.	A	G	22	19	41	0	1	42	0	0
7	26146998	.	G	A	0	19	19	0	24	43	0	0
7	26147167	.	T	C	17	17	34	0	1	35	0	0
7	26147756	.	C	T	24	29	53	0	5	59	1	0
7	26148169	.	C	T	28	24	52	0	2	54	0	0
7	26148181	.	A	C	25	24	49	0	2	52	1	0
7	26148263	.	A	G	37	10	47	0	3	50	0	0
7	26148312	.	T	G	24	16	40	0	0	40	0	0
7	26148567	.	T	C	34	14	48	0	0	48	0	0
7	26148796	.	C	T	3	4	7	0	2	9	0	0
7	26149067	.	C	T	15	12	27	0	0	27	0	0
7	26149069	.	A	T	15	12	27	0	0	27	0	0
7	26177355	.	T	A	2	2	4	0	0	4	0	0
7	26177491	.	G	A	0	1	1	0	1	2	0	0
7	26224320	.	A	G	3	2	5	0	0	5	0	0
7	26226772	.	G	C	0	2	2	0	1	3	0	0
7	26226977	.	C	T	4	4	8	0	0	8	0	0
7	26227149	.	C	T	6	2	8	0	0	8	0	0
7	26228639	.	T	C	14	13	27	0	3	30	0	0
7	26229449	.	G	A	8	15	23	0	5	28	0	0
7	26229551	.	T	A	19	25	44	0	6	50	0	0
7	26229584	.	G	A	0	24	24	0	25	49	0	0
7	26229640	.	T	C	22	23	45	0	5	50	0	0
7	26229935	.	C	T	20	12	32	0	2	34	0	0
7	26229979	.	A	G	12	12	24	1	0	25	0	0
7	26245318	.	T	A	22	14	36	0	1	37	0	0
7	26245668	.	T	C	10	9	19	0	1	20	0	0
7	26245714	.	A	T	9	10	19	0	2	21	0	0
7	26265832	.	C	A	0	2	2	0	2	4	0	0
7	26266069	.	G	C	7	6	13	0	0	13	0	0
7	26266096	.	A	G	3	4	7	0	0	7	0	0
7	26266126	.	T	C	2	0	2	0	1	3	0	0
7	26300184	.	A	G	1	2	3	0	1	4	0	0
7	26300359	.	A	G	9	6	15	0	1	16	0	0
7	26366778	.	G	A	7	11	18	0	1	19	0	0
7	26366846	.	C	T	1	9	10	0	9	19	0	0
7	26366897	.	A	C	11	3	14	0	0	14	0	0
7	26366919	.	G	A	10	5	15	0	1	16	0	0
7	26366991	.	C	T	0	6	6	0	13	19	0	0
7	26367111	.	T	C	7	4	11	0	3	14	0	0
7	26367218	.	G	C	9	6	15	0	1	16	0	0
7	26367260	.	A	T	11	3	14	0	0	14	0	0
7	26367328	.	T	A	1	3	4	0	0	4	0	0
7	26367486	.	A	C	2	3	5	0	0	5	0	0
7	26367525	.	A	G	2	5	7	0	0	7	0	0
7	26367944	.	G	A	3	4	7	0	0	7	0	0
7	26368087	.	G	C	8	4	12	0	1	13	0	0
7	26368240	.	C	A	2	2	4	0	1	5	0	0
7	26368291	.	A	C	3	2	5	0	0	5	0	0
7	26394208	.	A	T	11	15	26	0	2	28	0	0
7	26394285	.	A	T	8	14	22	0	5	27	0	0
7	26394382	.	C	T	1	11	12	0	13	25	0	0
7	26394476	.	G	A	16	14	30	0	1	31	0	0
7	26394848	.	G	A	10	13	23	0	0	23	0	0
7	26395359	.	G	A	7	7	14	0	1	15	0	0
7	26395380	.	A	C	6	7	13	0	0	13	0	0
7	26395538	.	T	C	5	5	10	0	1	11	0	0
7	26395778	.	T	G	2	2	4	0	1	5	0	0
7	26395816	.	T	C	0	5	5	0	0	5	0	0
7	26396013	.	T	A	6	6	12	0	0	12	0	0
7	26396418	.	A	T	1	5	6	0	0	6	0	0
7	26396783	.	C	G	0	3	3	0	6	9	0	0
7	26397365	.	A	T	1	4	5	0	0	5	0	0
7	26397760	.	C	T	5	2	7	0	0	7	0	0
7	26431942	.	G	A	2	3	5	0	2	7	0	0
7	26432073	.	G	C	2	2	4	0	1	5	0	0
7	26472622	.	T	C	0	3	3	0	0	3	0	0
7	26472663	.	T	G	1	2	3	0	0	3	0	0
7	26472676	.	A	G	1	3	4	0	0	4	0	0
7	26473163	.	G	A	3	2	5	0	1	6	0	0
7	26511439	.	A	T	17	18	35	0	5	40	0	0
7	26511691	.	G	A	20	9	29	0	4	33	0	0
7	26511760	.	A	G	14	16	30	0	0	30	0	0
7	26511801	.	T	G	12	16	28	0	2	30	0	0
7	26519052	.	A	G	8	5	13	0	0	13	0	0
7	26519150	.	A	T	14	15	29	0	1	30	0	0
7	26522358	.	T	C	4	3	7	0	0	7	0	0
7	26522364	.	C	T	4	3	7	0	0	7	0	0
7	26523169	.	A	G	1	0	1	0	0	1	0	0
7	27682874	.	A	G	5	2	7	0	0	7	0	0
7	28430478	.	T	C	2	0	2	0	1	3	0	0
7	29051871	.	A	G	3	4	7	0	1	8	0	0
7	29051893	.	A	G	2	0	2	0	2	4	0	0
7	29080302	.	C	T	1	1	2	0	3	5	0	0
7	29182733	.	A	G	0	2	2	0	0	2	0	0
7	29186433	.	T	C	7	9	16	0	1	17	0	0
7	29186453	.	A	C	9	9	18	0	1	19	0	0
7	29186483	.	C	T	7	11	18	0	1	19	0	0
7	29186504	.	T	C	3	13	16	0	3	19	0	0
7	29186549	.	T	C	5	11	16	0	0	16	0	0
7	29186589	.	C	G	6	0	6	0	7	13	0	0
7	29186605	.	T	C	11	4	15	0	0	15	0	0
7	29186640	.	G	A	5	12	17	0	1	18	0	0
7	29186677	.	C	T	10	7	17	0	0	17	0	0
7	29186717	.	G	A	4	1	5	0	2	7	0	0
7	29189503	.	C	A	15	17	32	0	4	36	0	0
7	29192331	.	C	T	0	11	11	0	19	31	1	0
7	29205418	.	T	G	4	2	6	0	0	6	0	0
7	29309315	.	A	C	1	5	6	0	0	6	0	0
7	29309726	.	G	A	1	1	2	0	2	4	0	0
7	29309897	.	T	C	1	5	6	0	0	6	0	0
7	29309946	.	T	C	4	3	7	0	1	8	0	0
7	29310537	.	C	T	7	11	18	0	2	20	0	0
7	29310543	.	G	A	0	11	11	0	9	20	0	0
7	29310618	.	G	A	3	13	16	0	0	16	0	0
7	29310654	.	C	T	2	7	9	0	2	11	0	0
7	29310700	.	G	A	4	6	10	0	0	10	0	0
7	29463057	.	T	G	3	2	5	0	0	5	0	0
7	29540207	.	A	G	0	3	3	0	1	4	0	0
7	29540311	.	A	C	5	7	12	0	1	13	0	0
7	29540536	.	A	T	3	4	7	0	0	7	0	0
7	29540537	.	C	T	0	4	4	0	3	7	0	0
7	29540885	.	T	A	6	5	11	0	0	11	0	0
7	29540999	.	A	G	5	5	10	0	0	10	0	0
7	29553338	.	G	A	1	2	3	0	0	3	0	0
7	29629772	.	C	A	2	2	4	0	0	4	0	0
7	29629781	.	G	A	1	2	3	0	0	3	0	0
7	29633693	.	T	C	5	9	14	0	0	14	0	0
7	29653521	.	C	T	0	3	3	0	0	3	0	0
7	29944366	.	G	C	0	3	3	0	5	8	0	0
7	29944881	.	G	C	0	2	2	0	2	4	0	0
7	29945609	.	C	A	9	4	13	0	1	14	0	0
7	29945732	.	C	G	14	6	20	0	0	20	0	0
7	29945758	.	G	A	15	6	21	0	0	21	0	0
7	29945881	.	A	T	9	19	28	0	1	29	0	0
7	29961038	.	G	A	1	2	3	1	0	4	0	0
7	29961106	.	C	T	4	6	10	0	0	10	0	0
7	29961455	.	G	C	7	4	11	0	1	12	0	0
7	29961479	.	A	T	7	4	11	0	1	12	0	0
7	29961567	.	C	T	18	11	29	0	2	31	0	0
7	29961649	.	G	A	4	3	7	0	0	7	0	0
7	29961658	.	T	A	2	2	4	0	0	4	0	0
7	29969555	.	A	G	2	3	5	0	0	5	0	0
7	29969724	.	A	C	3	2	5	0	0	5	0	0
7	29969774	.	T	C	5	2	7	0	1	8	0	0
7	29969777	.	G	T	5	3	8	0	0	8	0	0
7	29969996	.	A	T	7	3	10	0	1	11	0	0
7	29970194	.	T	G	3	5	8	0	0	8	0	0
7	29970195	.	C	T	3	5	8	0	0	8	0	0
7	29970240	.	G	A	1	2	3	0	1	4	0	0
7	30075430	.	G	A	7	12	19	0	2	21	0	0
7	30075631	.	C	A	7	18	25	0	2	27	0	0
7	30075823	.	C	T	9	10	19	0	1	20	0	0
7	30075845	.	T	C	9	14	23	0	2	25	0	0
7	30075974	.	A	G	14	19	33	0	1	34	0	0
7	30075983	.	G	A	11	19	30	0	2	32	0	0
7	30076036	.	A	C	9	11	20	0	2	22	0	0
7	30076083	.	A	T	4	8	12	0	2	14	0	0
7	30076141	.	T	G	5	2	7	0	4	11	0	0
7	30076217	.	T	C	12	5	17	0	0	17	0	0
7	30076241	.	G	T	14	6	20	0	1	21	0	0
7	30076591	.	G	A	15	7	22	0	0	22	0	0
7	30076608	.	T	G	14	4	18	0	0	18	0	0
7	30076653	.	C	A	9	9	18	0	1	19	0	0
7	30076692	.	C	T	9	17	26	0	1	27	0	0
7	30076744	.	G	A	8	18	26	0	1	27	0	0
7	30076852	.	A	T	7	18	25	0	1	26	0	0
7	30076872	.	T	C	2	0	2	0	13	15	0	0
7	30076962	.	A	T	3	5	8	0	1	9	0	0
7	30076966	.	A	G	3	6	9	0	0	9	0	0
7	30080166	.	A	G	3	0	3	0	0	3	0	0
7	30086732	.	T	C	1	3	4	0	0	4	0	0
7	30136304	.	C	G	10	8	18	0	1	19	0	0
7	30179577	.	C	G	1	0	1	0	0	1	0	0
7	30188324	.	T	C	1	0	1	0	0	1	0	0
7	30188459	.	C	T	4	5	9	0	0	9	0	0
7	30210151	.	T	A	13	6	19	0	1	20	0	0
7	30210359	.	C	T	6	13	19	0	0	19	0	0
7	30210362	.	T	C	6	10	16	0	2	18	0	0
7	30210445	.	C	G	0	13	13	0	12	25	0	0
7	30210579	.	G	T	9	6	15	0	3	18	0	0
7	30210659	.	T	C	7	7	14	0	0	14	0	0
7	30210741	.	G	A	5	3	8	0	0	8	0	0
7	30210840	.	T	C	2	2	4	0	0	4	0	0
7	30211530	.	T	A	3	2	5	0	0	5	0	0
7	30213948	.	A	G	4	3	7	0	0	7	0	0
7	30275668	.	A	T	2	5	7	0	0	7	0	0
7	30275676	.	A	T	6	2	8	0	0	8	0	0
7	30280856	.	C	G	5	6	11	0	0	11	0	0
7	30286678	.	A	G	4	3	7	0	1	8	0	0
7	30326708	.	G	A	1	2	3	0	0	3	0	0
7	30327330	.	A	T	3	3	6	0	0	6	0	0
7	30327708	.	C	T	0	4	4	0	0	4	0	0
7	30409210	.	C	A	4	2	6	0	1	7	0	0
7	30410687	.	T	A	4	4	8	0	0	8	0	0
7	30411052	.	C	T	1	2	3	0	1	4	0	0
7	30411187	.	T	C	2	3	5	0	0	5	0	0
7	30412857	.	C	T	0	2	2	0	0	2	0	0
7	30535113	.	G	T	2	3	5	0	0	5	0	0
7	30535162	.	T	G	1	3	4	0	0	4	0	0
7	30535163	.	G	T	1	3	4	0	0	4	0	0
7	30536377	.	T	A	2	5	7	0	0	7	0	0
7	30536396	.	C	G	7	2	9	0	0	9	0	0
7	30536958	.	T	A	3	7	10	0	1	11	0	0
7	30537014	.	G	A	5	10	15	0	0	15	0	0
7	30537114	.	T	C	8	5	13	0	0	13	0	0
7	30537365	.	G	T	9	2	11	0	1	12	0	0
7	30537370	.	T	A	4	8	12	0	0	12	0	0
7	30537783	.	A	T	12	5	17	0	1	18	0	0
7	30537804	.	C	T	6	11	17	0	1	18	0	0
7	30537858	.	G	A	21	8	29	0	1	30	0	0
7	30538280	.	G	A	10	5	15	0	3	18	0	0
7	30541693	.	G	A	8	16	24	0	2	26	0	0
7	30542295	.	C	T	9	6	15	0	1	16	0	0
7	30543682	.	T	C	17	16	33	0	4	37	0	0
7	30552992	.	G	A	2	2	4	0	0	4	0	0
7	30562290	.	C	T	0	7	7	0	5	12	0	0
7	30562552	.	T	A	6	5	11	0	0	11	0	0
7	30632737	.	G	T	7	7	14	0	0	14	0	0
7	30770971	.	T	A	3	6	9	0	0	9	0	0
7	30773168	.	T	A	2	5	7	0	0	7	0	0
7	30773169	.	T	A	2	5	7	0	0	7	0	0
7	30782104	.	C	T	3	3	6	0	1	7	0	0
7	30782476	.	T	A	5	2	7	0	2	9	0	0
7	30782478	.	A	G	6	3	9	0	0	9	0	0
7	30782669	.	A	G	6	4	10	0	2	12	0	0
7	30782802	.	G	A	0	4	4	0	2	6	0	0
7	30867006	.	C	T	2	2	4	0	0	4	0	0
7	30867658	.	T	A	3	2	5	0	0	5	0	0
7	30867670	.	A	G	5	0	5	0	2	7	0	0
7	30867775	.	T	G	4	2	6	0	0	6	0	0
7	30868009	.	C	T	6	6	12	0	0	12	0	0
7	30875257	.	G	A	1	1	2	0	0	2	0	0
7	30911937	.	C	T	0	1	1	0	0	1	0	0
7	30914622	.	C	T	10	10	20	0	0	20	0	0
7	30914706	.	C	T	14	9	23	0	4	27	0	0
7	30915040	.	A	G	4	8	12	0	1	13	0	0
7	30915306	.	G	A	23	24	47	0	3	50	0	0
7	30915388	.	A	G	31	17	48	0	0	48	0	0
7	30915542	.	A	C	11	18	29	1	4	34	0	0
7	30915823	.	G	A	0	29	29	0	30	59	0	0
7	30923638	.	C	T	0	3	3	0	2	5	0	0
7	30923658	.	C	A	1	2	3	0	0	3	0	0
7	30923842	.	T	C	6	2	8	0	0	8	0	0
7	30924646	.	T	A	1	2	3	0	0	3	0	0
7	31120906	.	C	A	5	8	13	0	3	16	0	0
7	31121005	.	C	T	5	9	14	0	1	15	0	0
7	31125653	.	C	T	1	2	3	0	0	3	0	0
7	31125776	.	G	A	0	4	4	0	4	8	0	0
7	31125860	.	T	C	5	6	11	0	1	12	0	0
7	31125980	.	C	A	5	2	7	0	0	7	0	0
7	31128396	.	T	C	2	6	8	0	2	10	0	0
7	31128475	.	A	C	4	3	7	0	2	9	0	0
7	31130285	.	T	C	3	1	4	0	0	4	0	0
7	31140479	.	C	A	6	2	8	0	0	8	0	0
7	31140594	.	G	A	9	4	13	0	1	14	0	0
7	31140634	.	A	C	1	7	8	0	0	8	0	0
7	31140976	.	A	C	7	5	12	0	0	12	0	0
7	31141044	.	C	T	6	9	15	0	0	15	0	0
7	31141372	.	T	C	12	11	23	0	4	27	0	0
7	31141747	.	T	A	11	13	24	0	0	24	0	0
7	31142030	.	C	T	14	11	25	0	1	26	0	0
7	31326795	.	G	A	1	2	3	0	0	3	0	0
7	31326862	.	T	C	2	3	5	0	0	5	0	0
7	31335951	.	A	C	2	2	4	0	1	5	0	0
7	31336149	.	G	C	4	7	11	0	0	11	0	0
7	31336153	.	T	A	4	7	11	0	0	11	0	0
7	31339344	.	T	C	4	3	7	0	1	8	0	0
7	31359003	.	T	C	1	0	1	0	0	1	0	0
7	31364072	.	C	T	4	5	9	0	0	9	0	0
7	31366684	.	C	T	6	3	9	0	0	9	0	0
7	31367057	.	A	G	13	10	23	0	0	23	0	0
7	31367667	.	A	T	3	11	14	0	0	14	0	0
7	31367668	.	C	T	3	10	13	0	1	14	0	0
7	31367777	.	C	G	22	17	39	0	0	39	0	0
7	31367850	.	C	T	12	16	28	0	2	30	0	0
7	31381713	.	C	T	0	0	0	0	1	1	0	0
7	31388206	.	C	T	1	0	1	0	0	1	0	0
7	31391429	.	C	T	3	2	5	0	0	5	0	0
7	31391784	.	G	A	7	3	10	0	0	10	0	0
7	31392315	.	T	A	5	7	12	0	1	13	0	0
7	31392485	.	A	G	9	7	16	0	1	17	0	0
7	31392492	.	G	A	8	7	15	0	0	15	0	0
7	31393266	.	T	C	7	3	10	0	0	10	0	0
7	31427812	.	T	C	1	1	2	0	0	2	0	0
7	31431507	.	T	C	1	3	4	0	1	5	0	0
7	31431548	.	T	A	2	1	3	0	2	5	0	0
7	31431745	.	C	G	6	9	15	0	3	18	0	0
7	31431898	.	T	C	8	5	13	0	0	13	0	0
7	31495021	.	T	A	5	5	10	0	1	11	0	0
7	31495208	.	A	G	12	11	23	0	0	23	0	0
7	31495329	.	C	T	5	5	10	0	0	10	0	0
7	31495353	.	C	T	7	4	11	0	3	14	0	0
7	31495377	.	C	T	7	8	15	0	1	16	0	0
7	31497662	.	T	C	1	2	3	0	0	3	0	0
7	31776224	.	G	A	16	13	29	0	3	32	0	0
7	31776645	.	T	A	7	6	13	0	0	13	0	0
7	31776706	.	G	A	13	6	19	0	0	19	0	0
7	31776735	.	T	C	10	6	16	0	5	21	0	0
7	31776877	.	C	T	2	7	9	0	0	9	0	0
7	31777227	.	T	C	1	5	6	0	0	6	0	0
7	31777528	.	C	T	4	2	6	0	0	6	0	0
7	31777556	.	A	T	0	2	2	0	0	2	0	0
7	31777569	.	G	C	0	0	0	0	5	5	0	0
7	31796453	.	G	A	13	14	27	0	1	28	0	0
7	31796845	.	A	G	8	3	11	0	0	11	0	0
7	31796861	.	T	G	7	4	11	0	1	12	0	0
7	31796990	.	C	T	0	3	3	0	3	6	0	0
7	31802890	.	C	T	1	3	4	0	0	4	0	0
7	31802938	.	A	T	0	2	2	0	0	2	0	0
7	31902535	.	G	T	7	8	15	0	0	15	0	0
7	31902536	.	A	T	7	8	15	0	0	15	0	0
7	31902633	.	T	A	13	10	23	0	1	24	0	0
7	31902757	.	T	A	23	19	42	0	1	43	0	0
7	31903205	.	T	A	4	3	7	0	0	7	0	0
7	31903554	.	A	T	3	8	11	0	1	12	0	0
7	31903993	.	A	T	0	2	2	0	1	3	0	0
7	31904146	.	G	A	4	2	6	0	1	7	0	0
7	31904180	.	G	A	5	2	7	0	2	9	0	0
7	31904192	.	G	T	5	3	8	0	1	9	0	0
7	31904381	.	C	A	6	2	8	0	0	8	0	0
7	31904442	.	T	G	4	3	7	0	0	7	0	0
7	31905217	.	T	A	1	3	4	0	0	4	0	0
7	31905392	.	G	A	1	3	4	0	2	6	0	0
7	31925975	.	C	T	25	19	44	0	0	44	0	0
7	32142302	.	A	C	4	10	14	0	0	14	0	0
7	32459107	.	C	A	2	3	5	0	1	6	0	0
7	32459126	.	G	T	2	2	4	0	2	6	0	0
7	32459256	.	G	T	5	2	7	0	0	7	0	0
7	32459411	.	C	T	4	2	6	0	0	6	0	0
7	32624814	.	T	A	10	10	20	0	7	27	0	0
7	32624823	.	G	A	17	12	29	0	0	29	0	0
7	32624892	.	C	T	7	19	26	0	3	29	0	0
7	32629309	.	C	A	0	1	1	0	1	2	0	0
7	32629349	.	G	T	3	3	6	0	0	6	0	0
7	32644881	.	G	A	3	7	10	0	0	10	0	0
7	32714459	.	T	A	2	2	4	0	0	4	0	0
7	32714833	.	C	T	4	2	6	0	1	7	0	0
7	32742572	.	G	A	1	3	4	0	0	4	0	0
7	32743918	.	G	C	2	5	7	0	0	7	0	0
7	32743959	.	A	C	2	4	6	0	0	6	0	0
7	32743961	.	A	G	2	4	6	0	0	6	0	0
7	32744027	.	T	C	1	2	3	0	0	3	0	0
7	32744459	.	T	A	3	3	6	1	1	8	0	0
7	32744485	.	A	G	1	2	3	1	0	4	0	0
7	32744540	.	T	C	2	4	6	0	0	6	0	0
7	32744542	.	A	G	2	0	2	0	4	6	0	0
7	32744648	.	A	G	2	8	10	0	0	10	0	0
7	32744663	.	T	A	2	5	7	0	0	7	0	0
7	32744856	.	G	A	1	4	5	0	1	6	0	0
7	32744906	.	T	C	4	4	8	0	0	8	0	0
7	32744919	.	T	G	4	3	7	0	0	7	0	0
7	32744958	.	T	A	3	3	6	0	0	6	0	0
7	32744974	.	G	C	1	3	4	0	2	6	0	0
7	32745025	.	T	C	1	3	4	0	0	4	0	0
7	32745190	.	T	C	1	2	3	0	0	3	0	0
7	32746213	.	A	G	3	3	6	0	0	6	0	0
7	32746324	.	G	A	10	9	19	0	2	21	0	0
7	32746327	.	A	C	10	10	20	0	1	21	0	0
7	32746370	.	C	T	9	2	11	0	1	12	0	0
7	32746457	.	A	C	8	6	14	0	0	14	0	0
7	32746584	.	C	T	6	7	13	0	2	15	0	0
7	32746614	.	C	T	9	6	15	0	1	16	0	0
7	32746732	.	A	G	8	3	11	0	0	11	0	0
7	32747424	.	T	A	1	2	3	0	0	3	0	0
7	32747973	.	A	G	10	19	29	0	2	31	0	0
7	32748006	.	T	C	12	18	30	1	3	34	0	0
7	32748203	.	A	G	22	9	31	0	3	34	0	0
7	32748319	.	C	A	17	26	43	0	1	44	0	0
7	32748486	.	A	T	8	14	22	0	2	24	0	0
7	32748725	.	G	A	19	20	39	0	2	41	0	0
7	32748914	.	G	A	14	25	39	0	3	42	0	0
7	32749048	.	T	A	27	19	46	0	4	50	0	0
7	32749144	.	T	C	22	21	43	0	4	47	0	0
7	32749146	.	A	G	25	22	47	0	0	47	0	0
7	32812361	.	A	G	22	28	50	0	2	52	0	0
7	32812472	.	G	A	9	18	27	0	0	27	0	0
7	32812804	.	G	A	3	20	23	0	11	34	0	0
7	32813004	.	T	C	12	14	26	0	1	27	0	0
7	32813366	.	A	G	11	6	17	0	3	20	0	0
7	32813689	.	C	T	6	2	8	0	1	9	0	0
7	32814139	.	C	G	3	1	4	0	1	5	0	0
7	32814141	.	G	C	3	1	4	0	1	5	0	0
7	32814451	.	C	T	0	4	4	0	3	7	0	0
7	32814542	.	C	T	7	4	11	0	0	11	0	0
7	32814600	.	C	G	7	5	12	0	0	12	0	0
7	32814636	.	A	G	9	4	13	0	0	13	0	0
7	32814830	.	A	G	6	3	9	0	0	9	0	0
7	32815506	.	A	G	2	3	5	0	0	5	0	0
7	32815910	.	C	T	0	4	4	0	4	8	0	0
7	32834376	.	A	T	4	3	7	0	0	7	0	0
7	32834412	.	A	G	5	8	13	0	1	14	0	0
7	32834445	.	G	T	4	7	11	0	0	11	0	0
7	32834650	.	C	A	8	7	15	0	2	17	0	0
7	32834674	.	G	A	8	7	15	0	2	17	0	0
7	32834835	.	G	A	2	6	8	0	0	8	0	0
7	32834912	.	C	G	7	4	11	0	0	11	0	0
7	32835042	.	T	G	5	7	12	0	2	14	0	0
7	32835053	.	T	C	6	5	11	0	0	11	0	0
7	32835182	.	G	A	9	6	15	0	1	16	0	0
7	32835349	.	A	G	4	2	6	0	0	6	0	0
7	32835491	.	A	G	3	2	5	0	1	6	0	0
7	32835501	.	A	T	2	2	4	0	0	4	0	0
7	32836032	.	T	C	2	2	4	0	1	5	0	0
7	32836227	.	A	G	1	2	3	0	1	4	0	0
7	32895388	.	A	C	1	4	5	0	1	6	0	0
7	32898640	.	A	T	1	4	5	0	0	5	0	0
7	32898696	.	C	T	4	8	12	0	0	12	0	0
7	32898744	.	C	T	3	8	11	0	0	11	0	0
7	32898747	.	T	A	2	7	9	0	1	10	0	0
7	32898827	.	C	A	2	7	9	0	1	10	0	0
7	32899602	.	A	T	8	14	22	0	1	23	0	0
7	32899744	.	A	G	11	9	20	0	0	20	0	0
7	32928369	.	G	A	2	5	7	0	0	7	0	0
7	32983726	.	T	A	24	24	48	1	6	55	0	0
7	32983948	.	A	C	32	3	35	0	25	60	0	0
7	32984127	.	T	A	26	22	48	0	3	51	0	0
7	32984604	.	C	T	15	26	41	0	2	43	0	0
7	32984625	.	T	A	18	18	36	0	2	38	0	0
7	32984804	.	T	A	15	24	39	0	0	39	0	0
7	32984812	.	C	A	15	21	36	0	0	36	0	0
7	32985013	.	A	T	13	7	20	0	0	20	0	0
7	32985128	.	T	C	17	16	33	0	2	35	0	0
7	32985274	.	A	T	5	4	9	0	0	9	0	0
7	32985282	.	T	A	2	4	6	0	1	7	0	0
7	32985602	.	G	A	8	7	15	0	0	15	0	0
7	32985616	.	A	T	4	9	13	0	1	14	0	0
7	32985716	.	A	G	6	6	12	0	0	12	0	0
7	32985847	.	A	G	9	5	14	0	3	17	0	0
7	32986043	.	T	A	9	8	17	0	1	18	0	0
7	32986311	.	T	G	6	6	12	0	3	15	0	0
7	32986422	.	G	T	2	2	4	0	1	5	0	0
7	33028564	.	T	G	1	2	3	0	0	3	0	0
7	33068640	.	T	C	3	5	8	0	0	8	0	0
7	33068718	.	A	G	7	5	12	0	0	12	0	0
7	33084991	.	T	C	0	2	2	0	0	2	0	0
7	33084992	.	A	T	0	2	2	0	0	2	0	0
7	33085039	.	G	A	0	2	2	0	0	2	0	0
7	33085212	.	C	T	2	4	6	0	0	6	0	0
7	33085667	.	T	A	1	2	3	0	0	3	0	0
7	33086384	.	C	T	7	7	14	0	2	16	0	0
7	33086491	.	T	C	8	8	16	0	0	16	0	0
7	33086564	.	G	C	5	6	11	0	1	12	0	0
7	33086569	.	T	A	5	8	13	0	0	13	0	0
7	33086865	.	G	T	0	9	9	1	20	30	0	0
7	33087209	.	T	G	22	15	37	0	1	38	0	0
7	33087334	.	A	T	24	15	39	0	3	42	0	0
7	33087472	.	A	G	14	6	20	0	3	23	0	0
7	33087841	.	T	G	18	20	38	0	1	39	0	0
7	33088052	.	G	A	16	6	22	0	2	24	0	0
7	33328542	.	C	G	1	2	3	0	0	3	0	0
7	33340747	.	C	T	2	2	4	0	0	4	0	0
7	33341082	.	A	C	1	3	4	0	0	4	0	0
7	33341124	.	T	A	1	3	4	0	0	5	1	0
7	33341143	.	T	G	1	2	3	0	0	3	0	0
7	33341465	.	A	C	0	4	4	0	0	4	0	0
7	33341722	.	C	T	1	8	9	0	0	9	0	0
7	33346451	.	C	T	12	19	31	0	2	33	0	0
7	33347436	.	T	C	9	6	15	0	0	15	0	0
7	33442639	.	C	A	4	2	6	0	0	6	0	0
7	33442680	.	T	C	5	5	10	0	0	10	0	0
7	33442795	.	G	A	3	3	6	0	1	7	0	0
7	33443246	.	A	T	0	6	6	0	0	6	0	0
7	33443587	.	T	A	2	2	4	0	0	4	0	0
7	33443593	.	G	A	2	1	3	0	0	3	0	0
7	33443684	.	A	G	5	11	16	0	0	16	0	0
7	33443748	.	C	G	8	8	16	0	0	16	0	0
7	33443808	.	T	C	10	6	16	0	0	16	0	0
7	33645876	.	A	T	9	17	26	0	2	28	0	0
7	33645932	.	C	A	2	18	20	0	16	36	0	0
7	33646044	.	G	C	13	10	23	0	2	25	0	0
7	33646409	.	C	T	7	18	25	0	1	26	0	0
7	33646459	.	G	A	8	12	20	0	2	22	0	0
7	33646920	.	G	C	8	6	14	0	1	15	0	0
7	33649963	.	G	A	7	6	13	0	1	14	0	0
7	33801112	.	T	A	2	4	6	0	0	6	0	0
7	33801322	.	T	C	2	5	7	0	0	7	0	0
7	33883436	.	A	T	4	3	7	0	0	7	0	0
7	33883852	.	C	A	3	0	3	0	0	3	0	0
7	33954855	.	G	C	2	3	5	0	0	5	0	0
7	33971021	.	A	T	3	3	6	0	0	6	0	0
7	33971304	.	A	C	10	10	20	0	2	22	0	0
7	34183237	.	T	A	5	6	11	0	2	13	0	0
7	34183285	.	A	T	5	5	10	0	0	10	0	0
7	34240336	.	T	A	4	7	11	0	0	11	0	0
7	34241477	.	C	A	1	2	3	0	2	5	0	0
7	34241707	.	C	T	3	2	5	0	0	5	0	0
7	34241719	.	T	C	3	2	5	0	0	5	0	0
7	34241815	.	G	A	3	3	6	0	0	6	0	0
7	34242358	.	C	T	0	1	1	0	1	2	0	0
7	34291960	.	G	A	2	2	4	0	1	5	0	0
7	34314672	.	T	A	1	2	3	0	0	3	0	0
7	34317746	.	C	T	0	27	27	0	26	53	0	0
7	34318485	.	G	A	24	18	42	0	4	46	0	0
7	34318619	.	C	T	0	21	21	0	22	43	0	0
7	34318750	.	A	G	16	17	33	0	5	38	0	0
7	34321638	.	C	T	4	4	8	0	0	8	0	0
7	34321735	.	G	A	3	4	7	0	1	8	0	0
7	34342266	.	G	C	1	1	2	0	1	3	0	0
7	34351132	.	A	G	1	0	1	0	0	1	0	0
7	34415865	.	G	T	9	7	16	0	1	17	0	0
7	34416106	.	G	A	13	6	19	0	0	19	0	0
7	34416967	.	T	A	5	2	7	0	0	7	0	0
7	34417846	.	T	C	0	3	3	0	1	4	0	0
7	34418457	.	G	T	1	2	3	0	0	3	0	0
7	34418623	.	T	A	2	2	4	0	0	4	0	0
7	34496344	.	C	T	0	2	2	0	0	2	0	0
7	34544751	.	T	A	4	3	7	0	0	7	0	0
7	34545068	.	C	T	3	3	6	0	0	6	0	0
7	34617503	.	A	T	1	2	3	0	0	3	0	0
7	34617516	.	C	A	0	4	4	0	0	4	0	0
7	34617540	.	G	T	2	2	4	0	0	4	0	0
7	34652081	.	C	G	8	6	14	0	1	15	0	0
7	34776487	.	T	C	2	4	6	0	0	6	0	0
7	34823861	.	A	G	4	6	10	0	0	10	0	0
7	34824131	.	A	T	4	3	7	0	0	7	0	0
7	34824322	.	G	A	3	2	5	0	0	5	0	0
7	34824695	.	C	A	5	3	8	0	0	8	0	0
7	34825735	.	A	T	2	2	4	0	0	4	0	0
7	34825773	.	G	A	2	2	4	0	0	4	0	0
7	34965049	.	G	A	5	2	7	0	0	7	0	0
7	34965064	.	T	C	5	2	7	0	1	8	0	0
7	34965199	.	A	G	6	0	6	0	9	15	0	0
7	34965445	.	G	A	1	4	5	0	0	5	0	0
7	35081270	.	G	A	1	2	3	0	0	3	0	0
7	35086461	.	C	T	3	2	5	0	0	5	0	0
7	35091293	.	G	A	1	0	1	0	1	2	0	0
7	35091365	.	T	A	6	4	10	0	0	10	0	0
7	35093784	.	C	T	2	2	4	0	0	4	0	0
7	35093968	.	A	C	20	25	45	0	1	46	0	0
7	35094025	.	T	A	11	25	36	0	9	45	0	0
7	35094218	.	T	C	24	22	46	0	3	49	0	0
7	35094292	.	T	G	28	0	28	0	6	34	0	0
7	35094604	.	T	G	16	17	33	0	0	33	0	0
7	35094647	.	T	C	16	20	36	0	0	36	0	0
7	35094682	.	T	C	39	0	39	0	1	40	0	0
7	35094859	.	C	T	13	8	21	0	1	22	0	0
7	35112396	.	C	A	1	2	3	0	0	3	0	0
7	35112864	.	C	T	1	3	4	0	2	6	0	0
7	35112919	.	T	C	2	3	5	0	1	6	0	0
7	35113143	.	A	G	3	2	5	0	0	5	0	0
7	35208379	.	G	A	0	2	2	0	0	2	0	0
7	35208381	.	C	T	0	2	2	0	0	2	0	0
7	35210921	.	C	G	5	2	7	0	1	8	0	0
7	35210924	.	C	A	5	3	8	0	0	8	0	0
7	35211010	.	T	G	2	6	8	0	1	9	0	0
7	35211073	.	A	C	3	2	5	0	0	5	0	0
7	35211680	.	A	G	1	5	6	0	0	6	0	0
7	35211776	.	A	G	5	4	9	0	0	9	0	0
7	35211825	.	G	A	1	3	4	0	8	12	0	0
7	35212066	.	C	T	1	4	5	0	0	5	0	0
7	35212070	.	T	A	1	2	3	0	1	4	0	0
7	35212252	.	G	A	9	7	16	0	2	18	0	0
7	35212255	.	C	T	10	5	15	0	4	19	0	0
7	35212360	.	A	G	2	2	4	0	2	6	0	0
7	35212376	.	A	G	2	2	4	0	0	4	0	0
7	35241776	.	G	A	0	2	2	0	3	5	0	0
7	35283238	.	T	A	2	2	4	0	0	4	0	0
7	37585016	.	T	A	1	2	3	0	0	3	0	0
7	38276692	.	G	A	0	2	2	0	1	3	0	0
7	38456516	.	C	A	1	4	5	0	2	8	1	0
7	38456517	.	C	T	3	5	8	0	0	8	0	0
7	38456578	.	T	C	9	3	12	0	1	13	0	0
7	38456592	.	A	T	8	4	12	0	0	12	0	0
7	38456699	.	T	C	6	5	11	0	1	12	0	0
7	38456944	.	T	C	2	0	2	0	5	7	0	0
7	38527761	.	A	T	1	2	3	0	0	3	0	0
7	38532904	.	G	A	0	2	2	0	0	2	0	0
7	38532906	.	G	A	0	2	2	0	0	2	0	0
7	38536370	.	C	T	21	20	41	0	3	44	0	0
7	38536416	.	C	T	27	12	39	0	0	39	0	0
7	38536697	.	A	G	17	9	26	0	2	28	0	0
7	38536703	.	A	T	15	10	25	0	2	27	0	0
7	38536889	.	G	T	16	15	31	0	0	31	0	0
7	38537085	.	T	A	10	9	19	0	2	21	0	0
7	38537345	.	C	T	8	18	26	0	2	28	0	0
7	38537657	.	C	T	12	7	19	0	1	20	0	0
7	38594474	.	A	C	14	17	31	0	6	37	0	0
7	38594510	.	G	C	18	14	32	0	1	33	0	0
7	38600226	.	A	G	24	16	40	0	2	42	0	0
7	38600265	.	T	C	30	17	47	0	1	48	0	0
7	38600483	.	A	G	10	13	23	0	4	27	0	0
7	38600585	.	C	T	0	15	15	0	18	33	0	0
7	38600892	.	G	A	16	11	27	0	4	31	0	0
7	38600982	.	G	A	28	21	49	0	3	52	0	0
7	38601067	.	G	T	34	9	43	0	4	47	0	0
7	38601156	.	G	T	19	8	27	0	6	33	0	0
7	38601374	.	C	T	21	24	45	0	3	48	0	0
7	38601391	.	T	A	18	30	48	0	3	51	0	0
7	38601417	.	A	C	15	27	42	0	2	44	0	0
7	38601625	.	C	A	16	9	25	0	5	30	0	0
7	38601646	.	G	A	16	16	32	0	2	34	0	0
7	38601751	.	T	C	20	14	34	0	3	37	0	0
7	38601759	.	C	G	23	15	38	0	2	40	0	0
7	38601823	.	C	A	0	7	7	0	18	25	0	0
7	38602123	.	C	T	16	12	28	0	1	30	1	0
7	38602160	.	A	T	20	13	33	0	0	33	0	0
7	38602623	.	T	C	8	8	16	0	0	16	0	0
7	38602656	.	G	A	4	6	10	0	0	10	0	0
7	38602917	.	A	T	6	7	13	0	0	13	0	0
7	38653761	.	G	A	1	2	3	0	1	4	0	0
7	38677497	.	T	C	15	14	29	0	0	29	0	0
7	38677880	.	G	T	23	11	34	0	1	35	0	0
7	38677999	.	A	T	9	18	27	0	1	28	0	0
7	38681322	.	C	T	0	0	0	0	1	1	0	0
7	38683503	.	C	A	0	1	1	0	0	1	0	0
7	38683834	.	T	C	5	3	8	0	0	8	0	0
7	38684830	.	C	T	14	10	24	0	1	25	0	0
7	38684970	.	C	T	16	17	33	0	1	34	0	0
7	38696163	.	A	G	32	33	65	0	3	68	0	0
7	38703598	.	C	T	9	6	15	0	1	16	0	0
7	38704006	.	G	A	5	4	9	0	0	9	0	0
7	38704009	.	G	A	5	4	9	0	0	9	0	0
7	38704063	.	T	C	1	7	8	0	0	8	0	0
7	38704622	.	C	A	4	2	6	0	0	6	0	0
7	38704623	.	T	C	4	0	4	0	2	6	0	0
7	38704754	.	C	T	1	4	5	0	0	5	0	0
7	38705012	.	A	T	2	2	4	0	1	5	0	0
7	38734152	.	G	A	0	4	4	0	3	7	0	0
7	38734431	.	C	A	1	3	4	0	0	4	0	0
7	38734527	.	T	C	5	3	8	0	0	8	0	0
7	38734573	.	A	G	1	6	7	0	2	9	0	0
7	38734626	.	G	T	5	6	11	0	1	12	0	0
7	38735363	.	A	G	4	10	14	0	1	15	0	0
7	38735406	.	C	T	0	11	11	0	1	12	0	0
7	38735460	.	G	T	6	16	22	0	0	22	0	0
7	38735465	.	A	C	6	13	19	0	2	21	0	0
7	38735501	.	T	C	3	7	10	0	1	11	0	0
7	38735711	.	G	A	3	2	5	0	0	5	0	0
7	38735727	.	A	T	4	2	6	0	0	6	0	0
7	38735827	.	A	C	5	9	14	0	0	14	0	0
7	38736320	.	G	C	15	14	29	0	6	35	0	0
7	38736526	.	C	T	4	4	8	0	2	10	0	0
7	38736912	.	T	C	0	1	1	0	1	2	0	0
7	38736917	.	T	C	2	1	3	0	0	3	0	0
7	38737020	.	T	C	2	9	11	0	1	12	0	0
7	38737224	.	C	T	9	7	16	0	0	16	0	0
7	38737286	.	C	T	9	8	17	0	4	21	0	0
7	38783718	.	A	G	11	8	19	0	0	19	0	0
7	38783742	.	G	A	13	10	23	0	2	25	0	0
7	38783799	.	A	T	14	8	22	0	0	22	0	0
7	38783881	.	T	A	5	7	12	0	0	12	0	0
7	38783972	.	T	C	3	7	10	0	0	10	0	0
7	38783984	.	G	T	0	5	5	0	5	10	0	0
7	38784415	.	A	G	1	0	1	0	18	19	0	0
7	38784439	.	A	G	4	9	13	0	0	13	0	0
7	38784486	.	T	C	5	14	19	0	1	20	0	0
7	38784494	.	A	G	4	0	4	0	15	19	0	0
7	38784648	.	A	G	17	21	38	0	2	40	0	0
7	38784681	.	G	A	21	19	40	0	2	42	0	0
7	38784725	.	A	T	19	12	31	0	0	31	0	0
7	38784728	.	A	T	16	10	26	0	4	30	0	0
7	38784766	.	C	A	15	18	33	0	0	33	0	0
7	38784818	.	G	A	17	17	34	0	3	37	0	0
7	38784985	.	T	G	15	17	32	0	0	32	0	0
7	38785182	.	G	C	0	20	20	0	26	46	0	0
7	38794233	.	C	T	0	18	18	0	17	35	0	0
7	38794235	.	C	T	16	17	33	0	2	35	0	0
7	38794411	.	A	G	15	11	26	0	2	28	0	0
7	38794562	.	A	G	16	12	28	0	1	29	0	0
7	38807714	.	G	A	2	2	4	0	0	4	0	0
7	38807723	.	A	T	2	2	4	0	0	4	0	0
7	38809865	.	G	T	0	7	7	0	4	11	0	0
7	38810084	.	A	C	2	5	7	0	0	7	0	0
7	38810173	.	C	A	4	2	6	0	2	8	0	0
7	38821790	.	G	C	2	2	4	0	0	4	0	0
7	38822365	.	T	A	6	7	13	0	0	13	0	0
7	38822368	.	A	T	6	7	13	0	0	13	0	0
7	39154181	.	A	T	1	3	4	0	0	4	0	0
7	39155508	.	A	T	3	2	5	0	1	6	0	0
7	39155940	.	T	A	1	2	3	0	1	4	0	0
7	39155943	.	T	C	2	1	3	0	1	4	0	0
7	39156101	.	T	G	6	5	11	0	0	11	0	0
7	39156140	.	T	C	4	4	8	0	0	8	0	0
7	39156207	.	T	C	2	3	5	0	1	6	0	0
7	39156376	.	A	G	2	5	7	0	2	9	0	0
7	39156553	.	C	A	9	4	13	0	2	15	0	0
7	39156567	.	G	C	9	4	13	0	1	14	0	0
7	39156673	.	A	T	5	2	7	0	0	7	0	0
7	39156698	.	G	A	1	5	6	0	4	10	0	0
7	39156736	.	A	G	9	2	11	0	0	11	0	0
7	39156760	.	A	G	3	12	15	0	2	17	0	0
7	39156846	.	T	C	11	8	19	0	0	19	0	0
7	39156969	.	T	C	12	6	18	0	0	18	0	0
7	39157219	.	G	A	0	7	7	0	17	24	0	0
7	39174052	.	T	C	0	4	4	0	0	4	0	0
7	39174145	.	T	C	3	3	6	0	1	7	0	0
7	39174452	.	G	A	1	13	14	0	8	22	0	0
7	39176739	.	A	T	14	11	25	0	1	26	0	0
7	39176790	.	T	G	13	9	22	0	2	25	1	0
7	39176881	.	G	A	25	12	37	0	3	40	0	0
7	39176922	.	T	A	16	9	25	0	1	26	0	0
7	39176940	.	A	G	12	8	20	0	1	21	0	0
7	39176957	.	A	G	8	9	17	0	0	17	0	0
7	39176983	.	T	C	7	3	10	0	3	13	0	0
7	39177132	.	A	T	2	2	4	0	0	4	0	0
7	39177527	.	G	A	20	11	31	0	2	33	0	0
7	39177558	.	T	C	17	10	27	0	3	30	0	0
7	39177601	.	C	A	13	14	27	0	1	28	0	0
7	39177679	.	C	T	20	6	26	0	2	28	0	0
7	39177822	.	A	T	15	8	23	0	1	24	0	0
7	39181264	.	T	C	7	0	7	0	19	26	0	0
7	39181347	.	G	A	9	13	22	0	1	23	0	0
7	39181853	.	C	A	1	4	5	0	0	5	0	0
7	39463681	.	G	A	1	2	3	0	0	4	1	0
7	39463701	.	T	G	1	4	5	0	0	5	0	0
7	39464015	.	T	C	2	8	10	0	0	10	0	0
7	39471520	.	G	A	1	6	7	0	0	7	0	0
7	39477304	.	G	A	1	2	3	0	0	3	0	0
7	39481598	.	C	T	0	2	2	0	1	3	0	0
7	39537983	.	C	G	2	7	9	0	0	9	0	0
7	39541293	.	T	G	1	0	1	0	0	1	0	0
7	39658730	.	G	T	0	6	6	0	2	8	0	0
7	39660240	.	A	T	13	10	23	0	1	24	0	0
7	39660249	.	A	C	12	18	30	0	0	30	0	0
7	39660304	.	A	G	22	25	47	0	3	50	0	0
7	39660624	.	C	A	18	15	33	0	2	35	0	0
7	39676776	.	C	G	9	6	15	0	0	15	0	0
7	39676833	.	T	C	4	7	11	0	0	11	0	0
7	39676948	.	T	G	5	2	7	0	1	8	0	0
7	39677549	.	T	C	8	10	18	0	2	20	0	0
7	39677625	.	G	T	15	5	20	0	2	22	0	0
7	39677755	.	C	T	4	6	10	0	0	10	0	0
7	39677878	.	G	C	15	11	26	0	1	27	0	0
7	39677924	.	A	G	18	9	27	0	2	29	0	0
7	39677998	.	C	G	7	12	19	0	1	20	0	0
7	39698963	.	T	C	3	5	8	0	2	10	0	0
7	39704085	.	A	G	1	3	4	0	0	4	0	0
7	39704216	.	T	C	3	3	6	0	1	7	0	0
7	39704223	.	A	G	3	4	7	0	0	7	0	0
7	39704254	.	G	A	4	2	6	0	1	7	0	0
7	39704267	.	C	A	3	2	5	0	1	6	0	0
7	39704506	.	T	G	2	4	6	0	0	6	0	0
7	39704510	.	T	A	2	4	6	0	0	6	0	0
7	39705194	.	A	G	9	4	13	0	1	14	0	0
7	39705601	.	A	G	12	11	23	0	0	23	0	0
7	39742334	.	G	A	0	3	3	0	4	7	0	0
7	39742784	.	A	G	3	7	10	0	0	10	0	0
7	39742820	.	T	G	3	3	6	0	1	7	0	0
7	39743014	.	A	G	4	1	5	0	5	10	0	0
7	39743038	.	T	G	3	1	4	0	5	9	0	0
7	39743163	.	T	A	2	4	6	0	1	7	0	0
7	39743181	.	T	C	2	5	7	0	0	7	0	0
7	39744494	.	G	A	8	9	17	0	2	19	0	0
7	39745091	.	T	C	3	6	9	0	0	9	0	0
7	39745580	.	A	G	0	2	2	0	0	2	0	0
7	40091010	.	A	T	2	3	5	0	1	6	0	0
7	40092005	.	G	T	2	3	5	0	0	5	0	0
7	40492740	.	T	A	6	1	7	0	0	7	0	0
7	40492764	.	G	C	0	1	1	0	4	5	0	0
7	40492789	.	T	C	1	1	2	0	0	2	0	0
7	40492800	.	G	T	1	1	2	0	0	2	0	0
7	41331048	.	T	C	1	5	6	0	0	6	0	0
7	41714385	.	T	C	6	9	15	0	0	15	0	0
7	41714453	.	T	C	8	10	18	0	1	19	0	0
7	41900402	.	G	C	0	2	2	0	0	2	0	0
7	41901245	.	A	G	4	2	6	0	2	8	0	0
7	43760754	.	T	C	15	4	19	0	3	22	0	0
7	44588458	.	A	G	10	3	13	0	1	14	0	0
7	46487662	.	C	A	5	5	10	0	0	10	0	0
7	47265729	.	T	C	2	2	4	0	1	5	0	0
7	47265859	.	A	T	8	7	15	0	0	15	0	0
7	47265934	.	G	A	0	2	2	0	1	3	0	0
7	47413517	.	C	A	4	2	6	0	0	6	0	0
7	47414348	.	C	T	1	5	6	0	0	6	0	0
7	47416061	.	C	T	8	8	16	0	1	17	0	0
7	47416358	.	T	A	2	3	5	0	0	5	0	0
7	47416407	.	A	C	2	6	8	0	0	8	0	0
7	47416496	.	T	A	1	2	3	0	1	4	0	0
7	47417195	.	T	A	8	15	23	0	0	23	0	0
7	47417821	.	C	T	8	12	20	0	2	22	0	0
7	47417934	.	T	A	13	16	29	0	0	29	0	0
7	47418320	.	C	T	11	6	17	0	0	17	0	0
7	47418526	.	T	C	11	8	19	0	0	19	0	0
7	47418575	.	G	T	5	9	14	0	1	15	0	0
7	47418657	.	G	A	4	12	16	0	0	16	0	0
7	47419070	.	T	A	5	4	9	0	0	9	0	0
7	47419177	.	A	C	4	0	4	0	5	10	1	0
7	47419250	.	T	G	3	3	6	0	0	6	0	0
7	47419653	.	G	A	1	3	4	0	1	5	0	0
7	47420019	.	A	G	2	3	5	0	0	5	0	0
7	48291166	.	G	A	4	1	5	0	0	5	0	0
7	48291844	.	A	G	3	2	5	0	0	5	0	0
7	48295783	.	C	A	6	0	6	0	5	11	0	0
7	48295797	.	G	T	6	0	6	0	7	13	0	0
7	48295850	.	A	T	13	8	21	0	0	21	0	0
7	48300607	.	G	A	0	2	2	0	0	2	0	0
7	48302925	.	A	G	2	4	6	0	0	6	0	0
7	48303497	.	A	G	1	2	3	0	1	4	0	0
7	48303814	.	G	A	0	1	1	0	5	6	0	0
7	48303838	.	C	T	6	2	8	0	1	9	0	0
7	48303954	.	T	C	5	4	9	0	0	9	0	0
7	48304060	.	C	G	2	4	6	0	0	6	0	0
7	48304396	.	G	A	2	4	6	0	0	6	0	0
7	48304419	.	A	G	2	7	9	0	1	10	0	0
7	48304457	.	T	G	10	7	17	0	1	18	0	0
7	48304554	.	G	A	2	4	6	0	1	7	0	0
7	48347478	.	T	G	19	14	33	0	0	33	0	0
7	48347562	.	G	T	8	7	15	0	1	16	0	0
7	48348006	.	A	G	10	8	18	0	1	19	0	0
7	48348062	.	C	T	6	8	14	0	1	15	0	0
7	48348148	.	T	A	5	3	8	0	1	9	0	0
7	48348149	.	C	A	5	4	9	0	0	9	0	0
7	48348485	.	A	G	2	4	6	0	0	6	0	0
7	48348486	.	A	C	2	4	6	0	0	6	0	0
7	48353844	.	G	A	2	1	3	0	0	3	0	0
7	48483513	.	T	A	6	6	12	0	1	13	0	0
7	48484621	.	C	T	4	12	16	0	3	19	0	0
7	48484736	.	A	G	14	11	25	0	2	27	0	0
7	48663980	.	T	A	5	5	10	0	0	10	0	0
7	48664032	.	A	G	3	4	7	0	0	7	0	0
7	48720818	.	A	C	1	1	2	0	1	3	0	0
7	48720824	.	T	C	0	2	2	0	1	3	0	0
7	48720877	.	G	A	1	2	3	0	0	3	0	0
7	48720887	.	A	G	1	2	3	0	0	3	0	0
7	48788369	.	T	C	11	16	27	0	0	27	0	0
7	48788498	.	T	A	11	15	26	0	2	28	0	0
7	48788622	.	G	A	2	2	4	0	1	5	0	0
7	48790794	.	A	C	2	2	4	0	0	4	0	0
7	48790824	.	A	G	2	2	4	0	0	4	0	0
7	48820773	.	C	T	1	2	3	0	0	3	0	0
7	48821065	.	T	C	3	2	5	0	0	5	0	0
7	48821331	.	T	C	2	1	3	0	0	3	0	0
7	48823809	.	A	T	2	0	2	0	0	2	0	0
7	48829569	.	G	C	15	11	26	0	3	29	0	0
7	48829820	.	A	T	10	3	13	0	0	13	0	0
7	49052377	.	A	T	1	3	4	0	0	4	0	0
7	49052402	.	T	A	1	2	3	0	0	3	0	0
7	49052414	.	A	T	1	2	3	0	0	3	0	0
7	49052777	.	C	T	1	4	5	0	0	5	0	0
7	49052840	.	T	G	2	1	3	0	2	5	0	0
7	49053445	.	A	G	4	6	10	0	0	10	0	0
7	49053454	.	T	A	4	4	8	0	1	9	0	0
7	49053627	.	C	T	2	4	6	0	0	6	0	0
7	49053677	.	G	A	0	4	4	0	3	7	0	0
7	49053785	.	G	C	4	7	11	0	1	12	0	0
7	49053817	.	C	T	3	6	9	0	1	10	0	0
7	49053835	.	A	T	4	5	9	0	0	9	0	0
7	49053858	.	A	G	4	5	9	0	0	9	0	0
7	49054161	.	G	A	1	2	3	0	0	3	0	0
7	49054212	.	C	A	1	1	2	0	1	3	0	0
7	49054268	.	T	C	1	2	3	0	0	3	0	0
7	49054382	.	T	A	1	3	4	0	3	7	0	0
7	49054394	.	G	A	2	2	4	0	1	5	0	0
7	49055197	.	C	T	4	6	10	0	0	10	0	0
7	49055254	.	T	A	2	2	4	0	2	6	0	0
7	49055256	.	T	C	3	2	5	0	1	6	0	0
7	49055371	.	A	C	6	8	14	0	4	18	0	0
7	49055411	.	T	C	7	7	14	0	4	18	0	0
7	49055631	.	T	C	2	3	5	0	0	5	0	0
7	49055930	.	A	C	1	3	4	0	0	4	0	0
7	49257686	.	G	T	3	4	7	0	0	7	0	0
7	49257774	.	C	T	7	5	12	0	0	12	0	0
7	49257841	.	C	T	5	6	11	0	1	12	0	0
7	49258279	.	C	T	6	4	10	0	1	11	0	0
7	49266497	.	G	A	1	0	1	0	0	1	0	0
7	49269896	.	A	G	10	1	11	0	5	16	0	0
7	49269913	.	A	G	5	1	6	0	3	9	0	0
7	49271105	.	G	T	13	13	26	0	0	26	0	0
7	49320778	.	C	A	2	2	4	0	0	4	0	0
7	49320779	.	A	C	2	2	4	0	0	4	0	0
7	49325319	.	T	C	5	5	10	0	0	10	0	0
7	49325346	.	A	G	4	4	8	0	1	9	0	0
7	49338309	.	G	A	4	2	6	0	0	6	0	0
7	49338336	.	G	A	5	2	7	0	2	9	0	0
7	49342391	.	G	A	1	2	3	0	0	3	0	0
7	49638880	.	T	G	2	2	4	0	0	5	1	0
7	49639272	.	G	T	6	7	13	0	0	13	0	0
7	49639370	.	A	G	1	2	3	0	0	3	0	0
7	49639701	.	T	C	3	4	7	0	1	8	0	0
7	49640040	.	G	A	11	7	18	0	2	20	0	0
7	49716898	.	T	C	2	2	4	0	0	4	0	0
7	49716935	.	T	A	4	3	7	0	1	8	0	0
7	49799305	.	G	C	7	2	9	0	0	9	0	0
7	49799470	.	A	T	7	4	11	0	0	11	0	0
7	49799526	.	T	A	8	3	11	0	0	11	0	0
7	49799584	.	G	A	5	2	7	0	0	7	0	0
7	49799805	.	A	T	3	2	5	0	0	5	0	0
7	49799890	.	T	C	2	2	4	0	0	4	0	0
7	49844446	.	C	G	1	2	3	0	0	3	0	0
7	50110585	.	C	T	1	2	3	0	0	3	0	0
7	50112025	.	C	T	5	6	11	0	1	12	0	0
7	50112039	.	T	G	6	8	14	0	0	14	0	0
7	50112063	.	G	A	4	5	9	0	1	10	0	0
7	50112196	.	A	G	1	0	1	0	1	7	5	0
7	50112286	.	T	C	4	3	7	0	0	7	0	0
7	50112383	.	G	A	8	9	17	0	2	19	0	0
7	50112460	.	C	T	8	14	22	0	0	22	0	0
7	50112825	.	A	T	7	11	18	0	0	18	0	0
7	50112922	.	C	A	2	1	3	0	1	4	0	0
7	50228314	.	C	A	8	8	16	0	0	16	0	0
7	50228326	.	T	C	5	0	5	0	10	15	0	0
7	50228355	.	C	T	8	13	21	0	1	22	0	0
7	50228463	.	G	A	3	8	11	0	0	11	0	0
7	50228487	.	T	C	4	3	7	0	1	8	0	0
7	50228517	.	G	T	2	2	4	0	0	4	0	0
7	50228548	.	T	C	2	4	6	0	0	6	0	0
7	50228785	.	C	G	1	4	5	0	1	6	0	0
7	50229223	.	T	C	6	6	12	0	2	14	0	0
7	50277869	.	T	A	1	2	3	0	0	3	0	0
7	50277915	.	C	T	1	3	4	0	0	4	0	0
7	50295823	.	G	A	11	6	17	0	2	19	0	0
7	50295974	.	G	T	9	4	13	0	3	16	0	0
7	50295997	.	T	A	5	5	10	0	2	12	0	0
7	50296016	.	A	G	8	3	11	0	1	12	0	0
7	50296545	.	T	G	7	3	10	0	1	11	0	0
7	50296612	.	G	C	2	3	5	0	0	5	0	0
7	50296981	.	A	G	5	9	14	0	2	16	0	0
7	50299379	.	G	A	1	6	7	0	0	7	0	0
7	50376101	.	T	A	3	3	6	0	0	6	0	0
7	50376214	.	T	C	9	4	13	0	0	13	0	0
7	50376518	.	C	A	2	3	5	0	2	7	0	0
7	50376720	.	A	T	3	2	5	0	1	6	0	0
7	50376751	.	G	A	4	5	9	0	0	9	0	0
7	50377025	.	A	G	2	5	7	0	0	7	0	0
7	50377045	.	C	T	0	3	3	0	5	8	0	0
7	50383553	.	C	T	0	1	1	0	1	2	0	0
7	50400267	.	A	G	0	1	1	0	0	1	0	0
7	50407469	.	A	G	11	12	23	0	1	24	0	0
7	50407532	.	T	C	10	5	15	0	4	19	0	0
7	50407587	.	T	C	11	15	26	0	4	30	0	0
7	50407588	.	C	A	10	16	26	0	4	30	0	0
7	50407724	.	C	T	7	12	19	0	3	22	0	0
7	50410394	.	T	A	23	14	37	0	0	37	0	0
7	50410475	.	T	C	10	7	17	0	0	17	0	0
7	50836382	.	C	T	1	1	2	0	1	3	0	0
7	50841072	.	G	A	5	4	9	0	0	9	0	0
7	50841237	.	C	T	2	3	5	0	0	5	0	0
7	50843813	.	C	A	3	1	4	0	0	4	0	0
7	50843827	.	A	G	3	1	4	0	1	5	0	0
7	50844117	.	G	A	0	4	4	0	8	12	0	0
7	50844142	.	G	A	5	3	8	0	0	8	0	0
7	50844165	.	C	T	2	6	8	0	0	8	0	0
7	50844830	.	G	T	6	5	11	0	2	13	0	0
7	50844834	.	G	A	0	6	6	0	9	15	0	0
7	50844895	.	A	T	7	7	14	0	0	14	0	0
7	50844936	.	A	T	7	4	11	0	2	13	0	0
7	50845000	.	G	A	9	15	24	0	0	24	0	0
7	50845105	.	A	T	9	13	22	0	1	23	0	0
7	50845158	.	A	G	10	7	17	0	2	19	0	0
7	50845210	.	A	G	9	13	22	0	1	23	0	0
7	50845331	.	G	A	0	2	2	0	1	3	0	0
7	50845486	.	A	T	3	5	8	0	0	8	0	0
7	50845646	.	C	T	5	6	11	0	0	11	0	0
7	50845892	.	C	A	13	16	29	0	4	33	0	0
7	50846055	.	T	C	14	16	30	0	2	32	0	0
7	50846081	.	T	A	13	13	26	0	2	28	0	0
7	50876966	.	T	C	7	9	16	0	0	16	0	0
7	50876969	.	T	C	5	9	14	0	1	15	0	0
7	50877064	.	T	C	4	4	8	0	3	11	0	0
7	50877100	.	T	C	3	3	6	0	0	6	0	0
7	50880885	.	C	A	1	2	3	0	0	3	0	0
7	50911193	.	C	A	4	2	6	0	0	6	0	0
7	50911223	.	T	A	7	7	14	0	1	15	0	0
7	50911278	.	C	T	20	16	36	0	4	40	0	0
7	50912212	.	C	T	6	5	11	0	0	11	0	0
7	50912227	.	C	G	4	6	10	0	0	10	0	0
7	51219420	.	C	G	3	7	10	0	3	13	0	0
7	51219436	.	A	C	10	2	12	0	0	12	0	0
7	51219972	.	T	C	14	5	19	0	1	20	0	0
7	51220739	.	A	G	7	5	12	0	0	12	0	0
7	51220740	.	C	A	0	5	5	0	7	12	0	0
7	51353421	.	C	T	1	2	3	0	0	3	0	0
7	51354424	.	T	A	1	3	4	0	0	4	0	0
7	51354442	.	C	A	1	2	3	0	0	3	0	0
7	51354641	.	C	A	1	5	6	0	1	7	0	0
7	51355437	.	A	G	2	3	5	0	1	6	0	0
7	51356303	.	G	A	2	3	5	0	1	6	0	0
7	51356319	.	G	A	0	3	3	0	3	6	0	0
7	51356542	.	C	G	16	8	24	0	0	24	0	0
7	51356625	.	C	A	14	9	23	0	0	23	0	0
7	51356733	.	G	T	7	4	11	0	0	11	0	0
7	51356767	.	C	A	4	5	9	0	0	9	0	0
7	51468119	.	C	T	22	17	39	0	4	43	0	0
7	51468241	.	C	T	17	22	39	0	3	42	0	0
7	51468389	.	C	T	0	22	22	0	12	34	0	0
7	51468411	.	A	T	10	12	22	0	2	24	0	0
7	51468577	.	C	A	17	20	37	0	1	38	0	0
7	51469048	.	T	G	9	23	32	0	1	33	0	0
7	51469166	.	A	T	14	11	25	0	2	27	0	0
7	51469267	.	G	C	8	13	21	0	1	22	0	0
7	51469304	.	T	A	4	11	15	0	0	15	0	0
7	51469518	.	T	A	8	10	18	0	0	18	0	0
7	51469578	.	T	G	8	7	15	0	0	15	0	0
7	51469814	.	C	T	0	5	5	0	3	8	0	0
7	51469897	.	A	G	3	2	5	0	0	5	0	0
7	51470569	.	G	T	2	3	5	0	0	5	0	0
7	51471554	.	T	C	2	0	2	0	4	6	0	0
7	51471560	.	T	C	3	3	6	0	0	6	0	0
7	51471591	.	T	C	3	2	5	0	1	6	0	0
7	51634285	.	C	T	23	9	32	0	1	33	0	0
7	51634480	.	G	A	29	37	66	0	3	69	0	0
7	51635615	.	A	G	9	14	23	0	4	27	0	0
7	51643163	.	A	G	7	4	11	0	1	12	0	0
7	51643212	.	G	A	5	2	7	0	2	9	0	0
7	51643409	.	C	A	5	2	7	0	0	7	0	0
7	51656256	.	G	A	1	5	6	0	0	6	0	0
7	51656560	.	A	T	5	2	7	0	0	7	0	0
7	51656576	.	A	G	1	2	3	0	0	3	0	0
7	51779628	.	G	A	2	1	3	0	0	3	0	0
7	51779636	.	T	C	2	1	3	0	0	3	0	0
7	51788227	.	T	G	5	4	9	0	1	10	0	0
7	51788756	.	A	C	4	6	10	0	0	10	0	0
7	51814287	.	C	G	3	7	10	0	0	10	0	0
7	51814445	.	T	A	5	6	11	0	0	11	0	0
7	51814512	.	C	T	6	7	13	0	0	13	0	0
7	52150793	.	A	T	1	3	4	0	0	4	0	0
7	52151265	.	T	G	0	1	1	0	0	1	0	0
7	52156137	.	T	A	1	2	3	0	0	3	0	0
7	52157810	.	T	C	1	2	3	0	1	4	0	0
7	52157814	.	G	T	3	1	4	0	0	4	0	0
7	52157845	.	A	T	3	3	6	0	0	6	0	0
7	52165601	.	C	T	0	2	2	0	0	2	0	0
7	52173228	.	A	G	3	2	5	0	0	5	0	0
7	52285027	.	T	C	11	9	20	0	0	20	0	0
7	52285035	.	C	T	10	6	16	0	1	17	0	0
7	52285113	.	C	G	3	9	12	0	2	14	0	0
7	52295016	.	C	T	0	3	3	0	4	7	0	0
7	52295183	.	G	A	9	9	18	0	1	19	0	0
7	52295795	.	C	T	0	2	2	0	0	2	0	0
7	52296297	.	G	A	2	2	4	0	0	4	0	0
7	52296791	.	G	A	2	2	4	0	0	4	0	0
7	52432249	.	G	A	1	2	3	0	0	3	0	0
7	52517759	.	G	A	3	2	5	0	1	6	0	0
7	52518529	.	T	G	1	6	7	0	0	7	0	0
7	52519015	.	T	C	1	4	5	0	0	5	0	0
7	52750565	.	C	T	10	13	23	0	2	25	0	0
7	52750656	.	G	A	5	8	13	0	1	14	0	0
7	52750776	.	G	T	12	10	22	0	0	22	0	0
7	52750847	.	C	T	17	9	26	0	1	27	0	0
7	52751016	.	C	T	12	5	17	0	2	19	0	0
7	52751306	.	T	C	1	6	7	0	0	7	0	0
7	52761496	.	G	T	0	2	2	0	0	2	0	0
7	52821904	.	G	A	4	3	7	0	0	7	0	0
7	52822136	.	G	A	4	3	7	0	0	7	0	0
7	52822351	.	A	T	10	3	13	0	0	13	0	0
7	52822493	.	A	C	5	5	10	0	1	11	0	0
7	52822773	.	C	T	5	6	11	0	0	11	0	0
7	52822860	.	A	G	2	4	6	0	0	6	0	0
7	52823161	.	G	A	7	12	19	0	1	20	0	0
7	52823210	.	C	G	6	9	15	0	0	15	0	0
7	52823377	.	T	A	8	6	14	0	0	14	0	0
7	52823388	.	C	T	8	6	14	0	2	16	0	0
7	52823429	.	A	T	13	9	22	0	3	25	0	0
7	52830447	.	G	T	2	4	6	0	2	8	0	0
7	52830591	.	A	T	19	24	43	0	0	43	0	0
7	52830601	.	T	G	23	20	43	0	3	46	0	0
7	52830639	.	C	T	23	27	50	0	2	52	0	0
7	52831053	.	G	T	21	17	38	0	5	43	0	0
7	52831198	.	T	A	6	9	15	0	1	16	0	0
7	52831236	.	A	G	10	8	18	0	1	19	0	0
7	52831430	.	C	T	11	16	27	0	1	28	0	0
7	52833126	.	C	G	1	4	5	0	0	5	0	0
7	52833329	.	G	T	2	5	7	0	0	7	0	0
7	52833682	.	T	A	2	4	6	0	0	6	0	0
7	52836403	.	A	G	9	4	13	0	1	14	0	0
7	52837644	.	G	A	2	2	4	0	0	4	0	0
7	52840871	.	T	A	16	16	32	0	3	35	0	0
7	52841276	.	A	G	3	2	5	0	0	5	0	0
7	52921521	.	C	A	5	4	9	0	0	9	0	0
7	52924873	.	T	A	6	7	13	0	0	13	0	0
7	52929182	.	G	A	7	5	12	0	2	14	0	0
7	52933088	.	C	A	29	17	46	0	0	46	0	0
7	52937334	.	G	A	4	4	8	0	1	9	0	0
7	52942312	.	G	T	1	2	3	0	0	3	0	0
7	52959270	.	G	T	0	2	2	0	1	3	0	0
7	52962765	.	T	C	4	0	4	0	6	10	0	0
7	54088322	.	A	G	4	2	6	0	1	7	0	0
7	54088850	.	A	G	3	1	4	0	0	4	0	0
7	54088988	.	G	A	10	3	13	0	1	14	0	0
7	54089192	.	A	T	3	11	14	0	0	14	0	0
7	54092602	.	A	T	10	7	17	0	0	17	0	0
7	54102884	.	T	A	1	3	4	0	0	4	0	0
7	54104318	.	A	G	1	2	3	0	0	3	0	0
7	54307268	.	G	C	1	3	4	0	0	4	0	0
7	54307826	.	G	T	6	4	10	0	0	10	0	0
7	54323986	.	T	C	3	0	3	0	10	13	0	0
7	54324019	.	C	T	3	8	11	0	0	11	0	0
7	54486819	.	T	C	1	2	3	0	0	3	0	0
7	54498690	.	A	T	1	1	2	0	1	3	0	0
7	54655025	.	A	T	4	8	12	0	0	12	0	0
7	54655172	.	T	A	2	2	4	0	0	4	0	0
7	54655264	.	G	A	5	3	8	0	0	8	0	0
7	54670384	.	C	T	5	4	9	0	0	9	0	0
7	54671038	.	C	T	0	3	3	0	0	3	0	0
7	55058697	.	A	T	2	2	4	0	0	4	0	0
7	55530884	.	G	C	2	1	3	0	1	6	2	0
7	55635202	.	T	C	0	1	1	0	0	1	0	0
7	55637122	.	C	A	1	1	2	0	0	2	0	0
7	55660269	.	G	A	2	2	4	0	0	4	0	0
7	56037659	.	C	G	1	3	4	0	0	4	0	0
7	56152686	.	G	C	14	6	20	0	1	21	0	0
7	56158197	.	G	A	4	2	6	0	0	6	0	0
7	56158823	.	A	G	3	3	6	0	0	6	0	0
7	56398651	.	C	T	1	2	3	0	0	3	0	0
7	56405508	.	T	C	3	4	7	0	0	7	0	0
7	56484426	.	G	A	15	14	29	0	0	29	0	0
7	56529352	.	T	C	2	3	5	0	0	5	0	0
7	57129590	.	G	T	0	3	3	0	1	4	0	0
7	57468893	.	G	T	1	3	4	0	0	4	0	0
7	57485461	.	T	C	8	6	14	0	2	16	0	0
7	57485484	.	T	C	7	12	19	0	1	20	0	0
7	57485710	.	T	C	4	6	10	0	0	10	0	0
7	57485736	.	A	G	4	4	8	0	1	9	0	0
7	57485766	.	A	G	4	7	11	0	1	12	0	0
7	57494115	.	C	T	7	9	16	0	0	16	0	0
7	57504905	.	C	G	1	3	4	0	0	4	0	0
7	57879302	.	A	T	9	3	12	0	0	12	0	0
7	57879396	.	T	A	8	10	18	0	4	22	0	0
7	57879431	.	G	T	0	8	8	0	12	20	0	0
7	57879436	.	C	A	11	8	19	0	0	19	0	0
7	57879576	.	C	A	18	10	28	0	0	28	0	0
7	57879601	.	T	C	22	6	28	0	1	29	0	0
7	57879959	.	C	A	11	4	15	0	1	16	0	0
7	57879992	.	G	A	13	6	19	0	3	22	0	0
7	57880073	.	G	C	6	3	9	0	0	9	0	0
7	57880099	.	T	C	1	2	3	0	0	3	0	0
7	57886347	.	C	A	30	18	48	0	5	53	0	0
7	57886392	.	T	A	28	24	52	0	0	52	0	0
7	57886964	.	T	G	28	21	49	0	2	51	0	0
7	57887480	.	C	T	20	17	37	0	1	38	0	0
7	57898605	.	G	A	4	3	7	0	2	9	0	0
7	57898623	.	C	T	11	8	19	0	1	20	0	0
7	57898650	.	T	C	14	15	29	0	4	34	1	0
7	57898658	.	C	G	17	21	38	0	2	40	0	0
7	57900948	.	T	A	1	0	1	0	0	1	0	0
7	57913558	.	C	A	12	14	26	0	0	26	0	0
7	57914155	.	T	G	13	12	25	0	2	27	0	0
7	57918590	.	A	G	3	4	7	0	0	7	0	0
7	57918799	.	G	A	17	15	32	0	3	35	0	0
7	57919087	.	T	G	8	8	16	0	6	22	0	0
7	57919241	.	G	A	5	11	16	0	1	17	0	0
7	57919249	.	T	C	5	0	5	0	7	12	0	0
7	57919567	.	T	C	6	5	11	0	0	11	0	0
7	57920608	.	A	T	3	5	8	0	0	8	0	0
7	57920908	.	A	G	1	2	3	0	0	3	0	0
7	57921094	.	A	G	7	4	11	0	2	13	0	0
7	57921335	.	A	G	1	2	3	0	3	6	0	0
7	57921914	.	G	A	3	2	5	0	0	5	0	0
7	57922480	.	G	A	1	2	3	0	0	3	0	0
7	58142814	.	A	T	3	4	7	0	0	7	0	0
7	58142842	.	A	T	1	4	5	0	0	5	0	0
7	58143104	.	A	G	1	10	11	0	1	12	0	0
7	58143123	.	G	C	1	10	11	0	1	12	0	0
7	58150120	.	A	T	1	6	7	0	0	7	0	0
7	58188252	.	A	G	4	3	7	0	0	7	0	0
7	58188253	.	A	C	4	3	7	0	0	7	0	0
7	58199935	.	A	G	0	1	1	0	0	1	0	0
7	58259557	.	A	G	5	2	7	0	0	7	0	0
7	58259561	.	A	G	4	3	7	0	0	7	0	0
7	58695379	.	A	C	3	6	9	0	0	9	0	0
7	58695441	.	C	A	10	15	25	0	1	26	0	0
7	58695599	.	G	T	10	9	19	0	2	21	0	0
7	58720696	.	T	A	1	2	3	0	0	3	0	0
7	58748871	.	A	C	6	16	22	0	0	22	0	0
7	58748891	.	T	C	5	11	16	0	0	16	0	0
7	58750327	.	A	C	25	22	47	0	3	50	0	0
7	58841552	.	T	G	2	0	2	0	0	2	0	0
7	58843134	.	T	C	2	1	3	0	0	3	0	0
7	59041471	.	A	G	1	4	5	0	0	5	0	0
7	59041504	.	A	G	1	1	2	0	0	2	0	0
7	59043246	.	C	A	1	4	5	0	0	5	0	0
7	59046711	.	T	A	4	3	7	0	1	8	0	0
7	59046795	.	G	A	1	3	4	0	0	4	0	0
7	59046966	.	T	A	4	4	8	0	1	9	0	0
7	59048307	.	C	T	0	9	9	0	5	14	0	0
7	59048907	.	G	A	4	4	8	0	0	8	0	0
7	59068932	.	T	C	1	2	3	0	1	4	0	0
7	59068948	.	G	A	3	3	6	0	1	7	0	0
7	59069079	.	G	A	10	3	13	0	1	14	0	0
7	59069080	.	T	G	8	3	11	0	3	14	0	0
7	59202989	.	A	T	3	6	9	0	0	9	0	0
7	59203097	.	A	G	2	4	6	0	0	6	0	0
7	59203289	.	G	A	1	1	2	0	0	2	0	0
7	59245594	.	G	T	1	2	3	0	0	3	0	0
7	59245612	.	G	T	1	4	5	0	0	5	0	0
7	59574426	.	T	A	1	2	3	0	0	3	0	0
7	60149599	.	C	T	3	0	3	0	0	3	0	0
7	60244637	.	A	G	5	3	8	0	0	8	0	0
7	60244868	.	C	T	1	2	3	0	0	3	0	0
7	60359719	.	A	T	2	2	4	0	0	4	0	0
7	60409230	.	T	C	2	3	5	0	0	5	0	0
7	60415571	.	G	T	2	10	12	0	1	13	0	0
7	60415928	.	T	C	4	7	11	0	2	13	0	0
7	60415945	.	A	T	3	9	12	0	1	13	0	0
7	60416010	.	T	C	6	10	16	0	2	18	0	0
7	60416016	.	A	G	5	7	12	0	4	16	0	0
7	60416074	.	T	A	4	4	8	0	0	8	0	0
7	60416317	.	A	G	6	0	6	0	10	16	0	0
7	60416327	.	C	T	7	11	18	0	0	18	0	0
7	60416379	.	G	A	7	14	21	0	0	21	0	0
7	60416383	.	C	T	8	13	21	0	0	21	0	0
7	60416439	.	A	G	5	22	27	0	1	28	0	0
7	60416764	.	T	G	1	8	9	0	0	9	0	0
7	60417176	.	T	A	3	10	13	0	1	14	0	0
7	60551171	.	A	C	2	2	4	0	0	4	0	0
7	60585599	.	G	A	1	3	4	0	0	4	0	0
7	60586187	.	T	C	3	2	5	0	1	6	0	0
7	60586364	.	A	C	3	2	5	0	0	5	0	0
7	60586771	.	C	T	1	2	3	0	0	3	0	0
7	60586784	.	A	T	3	3	6	0	0	6	0	0
7	60586835	.	C	T	3	6	9	0	0	9	0	0
7	60586874	.	G	A	0	4	4	0	3	7	0	0
7	60586976	.	C	T	3	5	8	0	1	9	0	0
7	60597482	.	G	A	8	6	14	0	0	14	0	0
7	60597500	.	T	G	7	7	14	0	2	16	0	0
7	60597863	.	C	T	9	11	20	0	2	22	0	0
7	60598265	.	T	A	20	15	35	0	4	39	0	0
7	61522609	.	A	C	3	0	3	0	2	5	0	0
7	61586641	.	C	G	5	3	8	0	0	8	0	0
7	61586719	.	C	T	0	3	3	0	6	9	0	0
7	61586910	.	C	T	9	5	14	0	0	14	0	0
7	61962002	.	A	G	3	3	6	0	2	8	0	0
7	61962040	.	T	C	3	4	7	0	2	9	0	0
7	61962238	.	G	T	0	5	5	0	4	9	0	0
7	61962292	.	G	T	1	4	5	0	1	6	0	0
7	61977170	.	G	C	5	5	10	0	0	10	0	0
7	61977229	.	C	T	5	6	11	0	1	12	0	0
7	61977256	.	A	T	6	4	10	0	1	11	0	0
7	61977744	.	G	A	4	2	6	0	0	6	0	0
7	61989033	.	A	C	1	2	3	0	0	3	0	0
7	62004146	.	C	T	9	10	19	0	2	21	0	0
7	62009630	.	T	A	5	8	13	0	1	14	0	0
7	62009652	.	G	A	0	9	9	0	10	19	0	0
7	62009701	.	C	T	7	4	11	0	1	12	0	0
7	63328746	.	G	T	1	6	7	0	0	7	0	0
7	63328764	.	G	A	0	2	2	0	7	9	0	0
7	64988061	.	A	G	1	2	3	0	0	3	0	0
7	65169335	.	G	A	0	11	11	0	11	22	0	0
7	65169795	.	G	A	0	11	11	0	8	19	0	0
7	65173289	.	A	T	20	12	32	0	1	33	0	0
7	65306085	.	C	T	5	2	7	0	1	8	0	0
7	65306229	.	G	A	8	7	15	0	0	15	0	0
7	65306255	.	A	G	6	6	12	0	2	14	0	0
7	65452005	.	G	A	0	1	1	0	1	2	0	0
7	65457103	.	A	G	0	0	0	0	2	2	0	0
7	65463165	.	C	A	4	7	11	0	0	11	0	0
7	65463169	.	G	A	4	7	11	0	0	11	0	0
7	65463297	.	G	T	0	6	6	0	8	14	0	0
7	65464010	.	C	T	8	7	15	0	1	16	0	0
7	65464164	.	G	T	15	7	22	0	2	24	0	0
7	65464189	.	A	T	26	6	32	0	1	33	0	0
7	65464204	.	G	A	0	8	8	0	21	29	0	0
7	65464288	.	G	T	6	10	16	0	0	16	0	0
7	65473186	.	A	T	13	28	41	0	3	45	1	0
7	65473364	.	T	C	18	21	39	0	3	42	0	0
7	65473700	.	G	C	21	16	37	0	1	38	0	0
7	65473775	.	G	T	15	16	31	0	3	34	0	0
7	65473814	.	T	C	17	11	28	0	1	29	0	0
7	65473902	.	T	A	3	7	10	0	2	15	3	0
7	65473933	.	C	A	8	6	14	0	1	15	0	0
7	65473972	.	T	C	9	4	13	0	2	15	0	0
7	65474100	.	C	T	7	16	23	0	4	27	0	0
7	65474103	.	A	G	7	20	27	0	2	29	0	0
7	65475708	.	T	G	1	5	6	0	0	6	0	0
7	65923044	.	T	A	0	1	1	0	2	3	0	0
7	66259353	.	C	T	4	3	7	0	0	7	0	0
7	66259574	.	A	T	4	7	11	0	0	11	0	0
7	66276243	.	G	A	7	8	15	0	0	15	0	0
7	66642286	.	T	A	3	1	4	0	0	4	0	0
7	66652907	.	G	C	1	0	1	0	0	1	0	0
7	66652919	.	C	G	2	1	3	0	1	4	0	0
7	66653019	.	G	A	14	8	22	0	0	22	0	0
7	66653335	.	G	C	10	10	20	0	1	21	0	0
7	66653442	.	G	T	0	13	13	0	20	33	0	0
7	66653469	.	T	G	18	10	28	0	3	31	0	0
7	66653529	.	T	C	11	8	19	0	5	24	0	0
7	66653785	.	G	A	0	10	10	0	8	18	0	0
7	66653840	.	T	A	15	14	29	0	1	30	0	0
7	66653929	.	T	C	8	18	26	0	3	29	0	0
7	66653950	.	C	T	10	24	34	0	2	36	0	0
7	66655801	.	C	G	6	6	12	0	0	12	0	0
7	66655845	.	A	T	4	4	8	0	1	9	0	0
7	66655930	.	G	T	5	5	10	0	0	10	0	0
7	66655938	.	A	T	5	4	9	0	1	10	0	0
7	66656242	.	C	T	0	13	13	0	11	24	0	0
7	66660481	.	T	C	1	0	1	0	0	1	0	0
7	66664405	.	C	T	6	6	12	0	0	12	0	0
7	66670802	.	A	G	0	1	1	0	0	1	0	0
7	67165438	.	G	A	0	0	0	0	2	2	0	0
7	67170837	.	A	T	3	6	9	0	0	9	0	0
7	67171186	.	G	T	1	2	3	0	10	13	0	0
7	67220614	.	C	T	2	8	10	0	0	10	0	0
7	67248773	.	A	G	0	2	2	0	0	2	0	0
7	67251973	.	T	A	0	0	0	0	1	1	0	0
7	67252044	.	A	C	1	2	3	0	1	4	0	0
7	67310028	.	G	T	5	9	14	0	0	14	0	0
7	67310030	.	T	A	5	9	14	0	0	14	0	0
7	67310144	.	G	T	13	12	25	0	1	26	0	0
7	67310147	.	T	C	13	1	14	0	11	25	0	0
7	67310200	.	T	G	11	9	20	0	7	28	1	0
7	67310269	.	G	A	12	13	25	0	0	25	0	0
7	67310429	.	A	T	10	19	29	0	2	31	0	0
7	67310507	.	T	C	14	25	39	0	0	39	0	0
7	67310690	.	A	G	16	9	25	0	3	28	0	0
7	67314142	.	A	G	0	1	1	0	0	1	0	0
7	67435587	.	T	C	1	1	2	0	0	2	0	0
7	67436273	.	C	T	3	4	7	0	0	7	0	0
7	67444837	.	G	A	0	3	3	0	0	3	0	0
7	67446295	.	C	T	9	13	22	0	1	23	0	0
7	67448338	.	T	C	22	15	37	0	2	39	0	0
7	67448363	.	A	T	15	17	32	0	1	33	0	0
7	67448373	.	T	A	14	19	33	0	0	33	0	0
7	67471561	.	C	T	22	28	50	0	2	52	0	0
7	67743901	.	A	G	1	2	3	0	0	3	0	0
7	67747819	.	T	C	14	9	23	0	0	23	0	0
7	67747826	.	T	G	14	7	21	0	1	22	0	0
7	67747869	.	G	C	11	5	16	0	0	16	0	0
7	67747915	.	G	A	3	6	9	0	2	11	0	0
7	67747916	.	A	T	5	6	11	0	0	11	0	0
7	67795429	.	G	A	1	7	8	0	0	8	0	0
7	67796413	.	C	A	1	2	3	0	0	3	0	0
7	67796494	.	G	A	0	6	6	0	3	9	0	0
7	67797037	.	C	G	7	6	13	0	0	13	0	0
7	67797087	.	G	T	5	11	16	0	1	17	0	0
7	67797097	.	C	T	6	11	17	0	1	18	0	0
7	67842641	.	G	T	1	3	4	0	0	4	0	0
7	68215451	.	A	T	15	23	38	0	2	40	0	0
7	68215990	.	T	G	9	13	22	0	2	24	0	0
7	68216504	.	C	A	0	4	4	0	4	8	0	0
7	68216781	.	G	C	3	2	5	0	0	5	0	0
7	68217387	.	G	A	3	7	10	0	0	10	0	0
7	68542421	.	T	A	1	2	3	0	0	3	0	0
7	68542538	.	C	T	2	2	4	0	0	4	0	0
7	68542618	.	T	C	1	4	5	0	0	5	0	0
7	69143989	.	T	C	1	5	6	0	0	6	0	0
7	69143992	.	T	C	1	0	1	0	5	6	0	0
7	69144036	.	T	C	1	1	2	0	1	3	0	0
7	69144037	.	T	C	1	1	2	0	1	3	0	0
7	69437472	.	T	C	2	1	3	0	0	3	0	0
7	69437495	.	C	A	1	0	1	0	0	1	0	0
7	69439580	.	A	G	1	3	4	0	0	4	0	0
7	69439587	.	A	G	1	0	1	0	3	4	0	0
7	69447324	.	G	A	3	4	7	0	0	7	0	0
7	69447352	.	T	C	6	6	12	0	0	12	0	0
7	69447469	.	C	G	1	4	5	0	2	7	0	0
7	69447516	.	A	G	3	3	6	0	0	6	0	0
7	69447520	.	G	A	3	3	6	0	0	6	0	0
7	69467267	.	A	G	2	4	6	0	2	8	0	0
7	69477283	.	T	G	22	17	39	1	1	43	2	0
7	69477303	.	A	G	20	0	20	0	27	47	0	0
7	69477361	.	T	C	16	34	50	0	2	52	0	0
7	69477437	.	A	G	19	25	44	0	5	49	0	0
7	69477464	.	T	C	29	16	45	0	2	47	0	0
7	69496521	.	C	A	13	10	23	0	2	26	1	0
7	69496537	.	A	T	15	12	27	0	3	30	0	0
7	69496572	.	A	G	12	18	30	0	1	31	0	0
7	69497048	.	A	T	3	10	13	0	0	13	0	0
7	69497493	.	G	T	7	9	16	0	1	17	0	0
7	69497637	.	G	A	3	4	7	0	1	8	0	0
7	69501040	.	A	G	2	0	2	0	0	2	0	0
7	69501300	.	A	G	3	2	5	0	0	5	0	0
7	69501345	.	G	T	3	3	6	0	0	6	0	0
7	69950785	.	G	C	0	3	3	0	3	6	0	0
7	70267378	.	G	A	1	3	4	0	0	4	0	0
7	70267390	.	A	G	1	2	3	0	0	3	0	0
7	70267426	.	T	C	3	3	6	0	0	6	0	0
7	70267453	.	A	G	4	3	7	0	0	7	0	0
7	72024634	.	C	T	1	0	1	0	0	1	0	0
7	72024642	.	T	C	0	4	4	0	0	4	0	0
7	72028326	.	A	G	18	8	26	0	0	26	0	0
7	72028746	.	A	G	0	0	0	0	1	1	0	0
7	72032989	.	T	A	0	8	8	0	0	8	0	0
7	73087329	.	T	G	1	3	4	0	0	4	0	0
7	73087344	.	T	C	1	4	5	0	0	5	0	0
7	73087374	.	A	T	1	3	4	0	0	4	0	0
7	73087479	.	A	C	2	4	6	0	1	8	1	0
7	73087491	.	G	A	3	3	6	0	3	9	0	0
7	73087528	.	T	C	3	2	5	0	0	5	0	0
7	73087702	.	A	G	5	0	5	0	7	12	0	0
7	73087741	.	G	C	1	5	6	0	4	10	0	0
7	73087895	.	A	C	7	12	19	0	1	20	0	0
7	73088489	.	C	T	14	14	28	0	0	28	0	0
7	73401946	.	C	T	6	5	11	0	0	11	0	0
7	73617817	.	A	G	1	2	3	0	1	4	0	0
7	73618382	.	T	C	1	2	3	0	0	3	0	0
7	73618713	.	A	G	1	0	1	0	2	3	0	0
7	73618733	.	G	A	0	3	3	0	2	5	0	0
7	73619153	.	T	A	5	5	10	0	1	11	0	0
7	73619587	.	A	C	8	8	16	0	0	16	0	0
7	73620129	.	C	T	21	19	40	0	5	45	0	0
7	73630951	.	G	C	2	2	4	0	0	4	0	0
7	73630955	.	G	A	0	2	2	0	2	4	0	0
7	73651959	.	C	A	9	8	17	0	0	17	0	0
7	73652321	.	T	A	6	5	11	0	0	11	0	0
7	73652715	.	A	T	2	5	7	0	0	7	0	0
7	73652819	.	C	T	5	2	7	0	0	7	0	0
7	73653025	.	T	G	3	1	4	0	0	4	0	0
7	73653072	.	T	G	6	3	9	0	0	9	0	0
7	73653241	.	T	C	6	6	12	0	3	15	0	0
7	73653373	.	C	A	8	6	14	0	1	15	0	0
7	73653994	.	G	A	3	3	6	0	1	7	0	0
7	73654065	.	T	C	3	3	6	0	0	6	0	0
7	73654505	.	C	T	10	8	18	0	0	18	0	0
7	73654647	.	C	G	20	1	21	0	23	44	0	0
7	73654652	.	G	A	20	21	41	0	1	42	0	0
7	73654693	.	A	C	19	19	38	0	2	40	0	0
7	73654742	.	C	A	18	14	32	0	6	38	0	0
7	73654827	.	A	G	13	15	28	0	1	29	0	0
7	73654878	.	C	T	12	18	30	0	3	33	0	0
7	73654896	.	G	A	15	10	25	0	4	29	0	0
7	73655474	.	T	G	32	19	51	0	5	56	0	0
7	73655580	.	G	A	28	18	46	0	4	50	0	0
7	73655698	.	A	G	14	23	37	0	1	38	0	0
7	73655775	.	T	C	12	11	23	0	1	24	0	0
7	73655997	.	C	T	24	39	63	0	2	65	0	0
7	73655998	.	T	C	26	35	61	0	4	65	0	0
7	73656075	.	T	C	32	38	70	0	4	74	0	0
7	73656136	.	G	A	23	28	51	0	4	55	0	0
7	73656361	.	G	A	7	5	12	0	5	17	0	0
7	74084304	.	C	A	1	2	3	0	0	3	0	0
7	74084370	.	G	A	1	1	2	0	0	2	0	0
7	74085487	.	C	T	0	2	2	0	2	4	0	0
7	74134988	.	T	C	2	6	8	0	0	8	0	0
7	74135136	.	G	A	0	8	8	0	12	20	0	0
7	74135375	.	C	T	15	17	32	0	8	40	0	0
7	74135462	.	A	G	14	21	35	0	1	36	0	0
7	74141299	.	T	C	0	1	1	0	0	1	0	0
7	74154066	.	C	T	4	4	8	0	0	8	0	0
8	41751	.	G	C	3	7	10	0	0	10	0	0
8	41754	.	C	T	3	6	9	0	0	9	0	0
8	41925	.	T	C	10	0	10	0	13	23	0	0
8	41948	.	A	G	10	15	25	0	0	25	0	0
8	43800	.	A	G	5	3	8	0	0	8	0	0
8	44337	.	G	A	1	3	4	0	0	4	0	0
8	56285	.	A	G	2	7	9	0	0	9	0	0
8	56884	.	C	T	0	3	3	0	1	4	0	0
8	57732	.	C	T	0	4	4	0	4	8	0	0
8	58399	.	C	G	3	5	8	0	0	8	0	0
8	75188	.	C	A	4	6	10	0	2	12	0	0
8	75446	.	G	T	0	4	4	0	8	12	0	0
8	75646	.	G	C	0	2	2	0	2	4	0	0
8	75669	.	C	G	0	0	0	0	1	1	0	0
8	120839	.	G	A	0	2	2	0	1	3	0	0
8	174020	.	G	A	2	1	3	0	0	3	0	0
8	268215	.	G	A	1	2	3	0	0	3	0	0
8	276277	.	C	T	2	2	4	0	0	4	0	0
8	276334	.	A	G	3	3	6	0	0	6	0	0
8	286192	.	A	G	5	10	15	0	0	15	0	0
8	286251	.	C	T	11	16	27	0	0	27	0	0
8	286302	.	G	A	10	13	23	0	3	26	0	0
8	387692	.	G	A	1	2	3	0	0	3	0	0
8	388020	.	G	C	3	7	10	0	0	10	0	0
8	388885	.	C	T	12	11	23	0	2	25	0	0
8	389114	.	T	A	6	15	21	0	2	24	1	0
8	391712	.	T	C	11	5	16	0	1	17	0	0
8	391715	.	T	C	12	4	16	0	0	16	0	0
8	391988	.	C	A	9	7	16	0	2	18	0	0
8	392047	.	G	T	8	8	16	0	2	18	0	0
8	395281	.	C	A	0	2	2	0	3	5	0	0
8	395287	.	C	T	2	1	3	0	1	4	0	0
8	397341	.	C	T	0	4	4	0	3	7	0	0
8	412303	.	G	A	7	9	16	0	1	17	0	0
8	412504	.	T	C	10	0	10	0	13	23	0	0
8	423533	.	T	C	6	11	17	0	2	19	0	0
8	423723	.	C	T	11	10	21	0	5	26	0	0
8	423815	.	C	A	19	12	31	0	2	33	0	0
8	424123	.	G	A	7	10	17	0	1	18	0	0
8	424969	.	G	A	3	8	11	0	0	11	0	0
8	481970	.	C	T	7	2	9	0	0	9	0	0
8	481976	.	G	C	6	2	8	0	2	10	0	0
8	487208	.	G	A	2	5	7	0	0	7	0	0
8	487241	.	T	C	5	6	11	0	1	12	0	0
8	489169	.	C	T	3	7	10	0	1	11	0	0
8	489194	.	T	A	11	4	15	0	0	15	0	0
8	541376	.	C	A	5	5	10	0	1	11	0	0
8	927337	.	G	A	14	9	23	0	5	28	0	0
8	941369	.	T	C	0	1	1	0	0	1	0	0
8	941378	.	C	T	0	1	1	0	0	1	0	0
8	1102404	.	T	C	1	2	3	0	0	3	0	0
8	1102533	.	G	T	2	5	7	0	0	7	0	0
8	1102551	.	C	T	3	3	6	0	0	6	0	0
8	1106494	.	C	A	0	2	2	0	0	2	0	0
8	1130331	.	C	T	1	3	4	0	0	4	0	0
8	1130450	.	C	G	1	0	1	0	7	8	0	0
8	1130526	.	C	A	1	4	5	0	0	5	0	0
8	1130574	.	G	A	2	5	7	0	1	8	0	0
8	1130590	.	A	T	3	5	8	0	0	8	0	0
8	1133753	.	C	G	3	4	7	0	0	7	0	0
8	1151416	.	T	C	1	1	2	0	0	2	0	0
8	1222417	.	T	C	5	0	5	0	8	13	0	0
8	1222504	.	T	C	14	0	14	0	19	33	0	0
8	1255292	.	C	G	0	3	3	0	3	6	0	0
8	1255304	.	G	A	0	2	2	0	0	2	0	0
8	1259023	.	G	A	1	2	3	0	0	3	0	0
8	1852056	.	A	G	1	2	3	0	0	3	0	0
8	1854724	.	A	G	5	2	7	0	0	7	0	0
8	1855312	.	A	G	10	7	17	0	2	19	0	0
8	1856254	.	A	G	14	8	22	0	2	24	0	0
8	1856265	.	A	G	8	19	27	0	0	27	0	0
8	3101241	.	G	T	2	2	4	0	0	4	0	0
8	3595359	.	C	T	0	2	2	0	0	2	0	0
8	3624208	.	G	C	0	2	2	0	1	3	0	0
8	3628683	.	C	T	1	3	4	0	0	4	0	0
8	3628747	.	C	A	1	4	5	0	0	5	0	0
8	3628758	.	T	A	1	2	3	0	0	3	0	0
8	3631371	.	T	C	0	1	1	0	0	1	0	0
8	3631932	.	C	T	2	3	5	0	0	5	0	0
8	3641218	.	G	C	8	10	18	0	0	18	0	0
8	3643299	.	T	C	12	18	30	0	1	31	0	0
8	3859383	.	T	A	1	1	2	0	1	3	0	0
8	3932974	.	A	G	2	5	7	0	0	7	0	0
8	3932990	.	A	G	2	8	10	0	1	11	0	0
8	3933498	.	T	A	8	5	13	0	1	14	0	0
8	4398981	.	G	A	0	3	3	0	5	8	0	0
8	4400699	.	C	A	4	2	6	0	0	6	0	0
8	4401053	.	T	G	2	2	4	0	3	7	0	0
8	4401068	.	C	T	4	6	10	0	0	10	0	0
8	4401374	.	G	A	0	6	6	0	8	14	0	0
8	4401514	.	A	T	6	10	16	0	0	16	0	0
8	4401687	.	G	A	11	21	32	0	0	32	0	0
8	4401708	.	C	T	13	22	35	0	2	37	0	0
8	4401813	.	G	T	8	23	31	0	7	38	0	0
8	4401913	.	T	G	11	14	25	0	2	27	0	0
8	4401931	.	T	C	10	9	19	0	1	20	0	0
8	4444313	.	G	A	0	3	3	0	4	7	0	0
8	4446266	.	C	T	0	3	3	0	4	7	0	0
8	4446303	.	T	C	3	2	5	0	0	5	0	0
8	4446389	.	C	T	2	6	8	0	0	8	0	0
8	4446407	.	T	C	2	0	2	0	5	7	0	0
8	4516885	.	C	T	0	2	2	0	1	3	0	0
8	4516962	.	G	A	8	2	10	0	1	11	0	0
8	4525072	.	G	A	2	0	2	0	0	2	0	0
8	4525174	.	A	G	1	2	3	0	0	3	0	0
8	4589148	.	A	G	18	23	41	0	1	42	0	0
8	4589169	.	T	G	24	18	42	0	5	47	0	0
8	4589216	.	A	T	24	12	36	0	3	39	0	0
8	4589402	.	C	T	34	24	58	0	0	58	0	0
8	4596649	.	T	A	3	8	11	0	0	11	0	0
8	4621454	.	A	G	2	4	6	0	1	7	0	0
8	4621495	.	A	T	5	2	7	0	0	7	0	0
8	4621496	.	C	T	5	2	7	0	0	7	0	0
8	4621817	.	G	T	3	2	5	0	0	5	0	0
8	4776243	.	A	T	12	15	27	0	0	27	0	0
8	4780127	.	A	T	5	6	11	0	0	11	0	0
8	4780197	.	T	C	0	10	10	0	3	13	0	0
8	4780238	.	T	A	2	5	7	0	1	10	2	0
8	4780368	.	T	A	2	4	6	0	2	8	0	0
8	4780552	.	C	T	0	6	6	0	6	12	0	0
8	4780637	.	G	T	4	2	6	0	0	6	0	0
8	4813635	.	G	A	1	2	3	0	0	3	0	0
8	4848815	.	A	G	1	3	4	0	0	4	0	0
8	4848818	.	G	T	0	3	3	0	1	4	0	0
8	4848920	.	G	A	2	5	7	0	0	7	0	0
8	7123014	.	A	G	11	3	14	0	0	14	0	0
8	7378464	.	A	G	27	12	39	0	3	42	0	0
8	7912664	.	A	T	4	2	6	0	1	7	0	0
8	11204699	.	C	T	4	2	6	0	0	6	0	0
8	11234333	.	A	C	2	0	2	0	6	8	0	0
8	11234334	.	T	G	2	6	8	0	0	8	0	0
8	11234489	.	T	C	4	0	4	0	7	11	0	0
8	11234573	.	A	G	3	6	9	0	2	11	0	0
8	11245918	.	C	T	0	0	0	0	1	1	0	0
8	11338659	.	A	G	1	0	1	0	3	4	0	0
8	11338731	.	A	G	1	3	4	0	0	4	0	0
8	11338934	.	A	T	6	3	9	0	0	9	0	0
8	11338941	.	G	A	0	2	2	0	6	8	0	0
8	11339307	.	T	C	7	11	18	0	0	18	0	0
8	11339379	.	A	T	7	3	10	0	0	10	0	0
8	11339453	.	T	G	4	0	4	0	3	7	0	0
8	11339458	.	A	T	4	2	6	0	1	7	0	0
8	11483097	.	G	A	0	4	4	0	5	9	0	0
8	11488414	.	C	T	3	3	6	0	0	6	0	0
8	11491308	.	A	G	5	6	11	0	1	12	0	0
8	11491332	.	C	T	2	5	7	0	1	8	0	0
8	11491347	.	G	C	0	3	3	0	1	4	0	0
8	11520599	.	C	T	1	1	2	0	1	3	0	0
8	11521244	.	A	G	3	0	3	0	0	3	0	0
8	11535261	.	A	G	5	5	10	0	0	10	0	0
8	11540815	.	G	T	0	1	1	0	0	1	0	0
8	11541829	.	A	G	8	11	19	0	1	20	0	0
8	11541844	.	C	A	8	11	19	0	1	20	0	0
8	11541880	.	T	C	3	9	12	0	0	12	0	0
8	11542921	.	C	A	1	2	3	0	0	3	0	0
8	11740220	.	T	C	4	2	6	0	0	6	0	0
8	11740370	.	G	A	8	8	16	0	1	17	0	0
8	11746684	.	A	G	1	3	4	0	1	5	0	0
8	11746701	.	G	T	1	4	5	0	0	5	0	0
8	11885082	.	T	C	1	1	2	0	1	3	0	0
8	11987931	.	C	T	1	4	5	0	1	6	0	0
8	12016451	.	T	C	4	6	10	0	2	12	0	0
8	12111198	.	C	T	6	8	14	0	1	15	0	0
8	12452284	.	C	T	0	3	3	0	3	6	0	0
8	12574533	.	A	G	1	1	2	0	0	2	0	0
8	12947928	.	A	T	1	2	3	0	1	4	0	0
8	13068315	.	C	T	1	1	2	0	1	3	0	0
8	13093662	.	G	A	0	1	1	0	0	1	0	0
8	13093677	.	C	T	0	2	2	0	0	2	0	0
8	13097535	.	C	T	8	4	12	0	4	16	0	0
8	13097538	.	C	A	8	7	15	0	1	16	0	0
8	13159280	.	T	A	2	5	7	0	0	7	0	0
8	13159411	.	G	A	0	2	2	0	0	2	0	0
8	13352100	.	C	A	0	20	20	0	15	35	0	0
8	13352103	.	T	A	11	21	32	0	2	34	0	0
8	13352166	.	T	C	11	17	28	0	3	31	0	0
8	13352318	.	G	A	17	11	28	0	0	28	0	0
8	13352428	.	A	G	14	20	34	0	3	37	0	0
8	13355949	.	C	T	8	7	15	0	1	16	0	0
8	13362699	.	T	C	10	12	22	0	2	24	0	0
8	13644084	.	G	A	4	2	6	0	0	6	0	0
8	13782862	.	C	G	6	4	10	0	1	11	0	0
8	13782902	.	C	A	6	4	10	0	2	12	0	0
8	13784177	.	A	G	1	3	4	0	0	4	0	0
8	13784180	.	G	A	1	3	4	0	0	4	0	0
8	13784219	.	C	T	5	2	7	0	3	10	0	0
8	13784231	.	A	G	6	4	10	0	0	10	0	0
8	13784288	.	A	T	1	2	3	0	0	3	0	0
8	13786944	.	G	C	8	10	18	0	0	18	0	0
8	13787132	.	G	A	2	5	7	0	1	8	0	0
8	13787150	.	A	T	4	3	7	0	1	8	0	0
8	13787345	.	G	A	8	4	12	0	0	12	0	0
8	13852774	.	C	T	5	5	10	0	2	12	0	0
8	13852795	.	T	C	4	2	6	0	3	9	0	0
8	13852864	.	T	C	4	6	10	0	0	10	0	0
8	13852930	.	G	A	5	3	8	0	1	9	0	0
8	13910234	.	C	A	1	3	4	0	0	4	0	0
8	13944193	.	T	C	4	3	7	0	0	7	0	0
8	13991378	.	A	G	0	2	2	0	0	2	0	0
8	13991564	.	A	C	5	2	7	0	0	7	0	0
8	13991875	.	C	A	3	3	6	0	0	6	0	0
8	13998316	.	A	G	8	3	11	0	0	11	0	0
8	13998483	.	A	C	3	2	5	0	0	5	0	0
8	13998502	.	C	A	3	3	6	0	1	7	0	0
8	14003374	.	G	A	18	27	45	0	2	47	0	0
8	14012346	.	C	T	1	2	3	0	8	11	0	0
8	14018790	.	C	T	0	1	1	0	0	1	0	0
8	14020571	.	A	G	5	4	9	0	0	9	0	0
8	14027241	.	A	C	0	1	1	0	0	1	0	0
8	14041319	.	A	G	2	2	4	0	0	4	0	0
8	14043810	.	A	G	2	3	5	0	0	5	0	0
8	14049447	.	G	A	1	3	4	0	1	5	0	0
8	14049462	.	A	G	2	2	4	0	2	6	0	0
8	14063418	.	T	A	5	8	13	0	0	13	0	0
8	14064374	.	G	A	2	2	4	0	1	5	0	0
8	14070490	.	T	C	4	1	5	0	0	5	0	0
8	14075809	.	C	T	5	6	11	0	0	11	0	0
8	14076340	.	T	G	2	2	4	0	1	5	0	0
8	14163845	.	A	G	3	4	7	0	0	7	0	0
8	14170428	.	C	A	5	10	15	0	0	15	0	0
8	14170546	.	A	T	4	5	9	0	1	10	0	0
8	14170712	.	C	T	18	17	35	0	1	36	0	0
8	14170789	.	A	T	18	14	32	0	2	34	0	0
8	14170863	.	C	A	17	4	21	0	1	22	0	0
8	14171076	.	A	T	19	4	23	0	4	27	0	0
8	14171346	.	T	C	9	15	24	0	0	24	0	0
8	14171414	.	G	A	5	25	30	0	1	31	0	0
8	14171660	.	T	C	13	23	36	0	0	36	0	0
8	14171825	.	C	T	0	10	10	0	11	21	0	0
8	14171875	.	G	T	12	20	32	0	1	33	0	0
8	14171955	.	T	C	16	9	25	0	1	26	0	0
8	14172113	.	A	T	5	8	13	0	2	15	0	0
8	14174231	.	G	A	9	9	18	0	0	18	0	0
8	14176574	.	T	C	1	0	1	0	0	1	0	0
8	14176592	.	A	G	1	2	3	0	0	3	0	0
8	14184198	.	C	T	0	4	4	0	11	15	0	0
8	14184246	.	A	G	9	11	20	0	1	21	0	0
8	14211960	.	A	G	7	6	13	0	0	13	0	0
8	14212264	.	T	G	5	5	10	0	1	11	0	0
8	14212545	.	T	C	3	0	3	0	9	12	0	0
8	14212676	.	A	G	3	4	7	0	2	9	0	0
8	14217986	.	T	C	1	2	3	0	0	3	0	0
8	14225269	.	G	A	1	2	3	0	0	3	0	0
8	14244494	.	A	G	2	4	6	0	0	6	0	0
8	14246405	.	G	A	2	2	4	0	0	4	0	0
8	14246411	.	A	G	2	0	2	0	1	3	0	0
8	14247431	.	A	G	1	1	2	0	0	2	0	0
8	14440564	.	A	G	1	4	5	0	2	7	0	0
8	14440580	.	C	A	2	5	7	0	0	7	0	0
8	14440754	.	C	A	1	2	3	0	0	3	0	0
8	14441120	.	A	G	8	2	10	0	2	12	0	0
8	14441344	.	C	T	10	4	14	0	3	17	0	0
8	14441416	.	C	A	16	8	24	0	0	24	0	0
8	14441524	.	A	G	5	7	12	0	0	12	0	0
8	14441527	.	A	G	9	4	13	0	0	13	0	0
8	14441596	.	A	G	16	4	20	0	4	24	0	0
8	14441656	.	A	C	6	12	18	0	1	19	0	0
8	14441657	.	C	A	6	13	19	0	0	19	0	0
8	14441728	.	A	C	3	5	8	0	0	8	0	0
8	14454425	.	G	T	2	2	4	0	0	4	0	0
8	14559476	.	A	G	3	8	11	0	0	11	0	0
8	14559709	.	T	A	7	2	9	0	2	11	0	0
8	14560242	.	A	C	1	5	6	0	0	6	0	0
8	14560252	.	A	G	1	6	7	0	0	7	0	0
8	14560612	.	G	A	1	3	4	0	0	4	0	0
8	14561063	.	C	A	2	2	4	0	1	5	0	0
8	14982477	.	A	C	6	2	8	0	1	9	0	0
8	14982775	.	T	C	1	2	3	0	0	3	0	0
8	14982786	.	T	G	1	2	3	0	0	3	0	0
8	14982919	.	C	T	5	2	7	0	0	7	0	0
8	14982962	.	A	T	5	2	7	0	0	7	0	0
8	14983176	.	A	G	2	2	4	0	0	4	0	0
8	14983191	.	A	G	2	2	4	0	0	4	0	0
8	14983211	.	A	G	2	3	5	0	0	5	0	0
8	14983866	.	C	T	8	13	21	0	0	21	0	0
8	15080566	.	A	G	8	3	11	0	1	12	0	0
8	15094588	.	G	C	2	2	4	0	0	4	0	0
8	15094599	.	C	A	0	2	2	0	2	4	0	0
8	15252141	.	A	G	5	0	5	0	0	5	0	0
8	15252250	.	C	G	17	8	25	0	1	26	0	0
8	15252306	.	G	A	4	3	7	0	0	7	0	0
8	15253365	.	C	A	3	0	3	0	0	3	0	0
8	15253384	.	T	C	3	1	4	0	0	4	0	0
8	15253496	.	G	A	7	2	9	0	0	9	0	0
8	15275665	.	T	C	3	3	6	0	0	6	0	0
8	15276587	.	T	A	5	12	17	0	1	18	0	0
8	15276588	.	C	G	5	11	16	0	2	18	0	0
8	15276678	.	G	A	7	7	14	0	0	14	0	0
8	15276684	.	G	A	0	6	6	0	6	12	0	0
8	15276864	.	A	T	1	1	2	0	1	3	0	0
8	15276944	.	T	G	2	4	6	0	1	7	0	0
8	15312985	.	A	G	1	1	2	0	0	2	0	0
8	16054374	.	C	T	4	3	7	0	1	8	0	0
8	16054389	.	T	C	3	2	5	0	3	8	0	0
8	16112107	.	G	A	0	7	7	0	3	10	0	0
8	16112212	.	C	T	6	6	12	0	2	14	0	0
8	16113850	.	C	A	10	8	18	0	2	20	0	0
8	16115682	.	C	T	8	15	23	0	9	32	0	0
8	16275011	.	G	C	4	3	7	0	3	10	0	0
8	16294511	.	G	A	10	6	16	0	0	16	0	0
8	16411832	.	G	A	1	2	3	0	0	3	0	0
8	16425038	.	C	T	5	2	7	0	0	7	0	0
8	16425079	.	C	T	0	5	5	0	3	8	0	0
8	16425383	.	T	C	1	4	5	0	1	6	0	0
8	16519102	.	T	G	1	6	7	0	0	7	0	0
8	16582470	.	T	A	12	19	31	0	6	37	0	0
8	16582608	.	G	A	23	25	48	0	0	48	0	0
8	16583043	.	G	A	7	6	13	0	2	15	0	0
8	16583127	.	C	T	7	11	18	0	1	19	0	0
8	16583142	.	A	C	13	8	21	0	1	22	0	0
8	16583174	.	C	A	9	10	19	0	1	20	0	0
8	16583447	.	C	T	6	10	16	0	0	16	0	0
8	16583528	.	C	T	10	4	14	1	2	19	2	0
8	16583534	.	G	A	8	3	11	1	0	18	6	0
8	16584037	.	C	T	0	4	4	0	4	8	0	0
8	16587510	.	T	A	6	3	9	0	0	9	0	0
8	16588157	.	A	G	2	2	4	0	0	4	0	0
8	16588421	.	C	T	4	2	6	0	0	6	0	0
8	16592465	.	G	C	6	3	9	0	0	9	0	0
8	16597215	.	C	T	1	3	4	0	0	4	0	0
8	16597252	.	G	A	1	3	4	0	0	4	0	0
8	16610196	.	A	G	1	3	4	0	0	4	0	0
8	16615802	.	T	C	8	5	13	0	1	14	0	0
8	16615866	.	T	C	1	5	6	0	1	7	0	0
8	16615929	.	A	T	12	10	22	0	4	26	0	0
8	16616190	.	C	A	8	10	18	0	0	18	0	0
8	16616899	.	G	A	3	1	4	0	0	4	0	0
8	16625575	.	C	A	2	3	5	0	0	5	0	0
8	16685439	.	C	T	2	1	3	0	0	3	0	0
8	16685757	.	G	A	2	1	3	0	0	3	0	0
8	16702707	.	G	A	1	0	1	0	0	1	0	0
8	16729938	.	A	G	18	10	28	0	1	29	0	0
8	16729941	.	G	A	18	11	29	0	1	30	0	0
8	16734037	.	A	T	2	8	10	0	2	12	0	0
8	16734074	.	C	G	6	4	10	0	0	11	1	0
8	16734247	.	C	A	3	8	11	0	1	12	0	0
8	16736489	.	A	T	1	2	3	0	0	3	0	0
8	16738054	.	G	A	1	5	6	0	0	6	0	0
8	16738149	.	G	T	3	5	8	0	1	9	0	0
8	16740977	.	C	T	1	1	2	0	0	2	0	0
8	16755381	.	G	A	6	4	10	0	1	11	0	0
8	16756847	.	G	C	7	4	11	0	0	11	0	0
8	16768992	.	A	G	1	0	1	0	7	8	0	0
8	16769126	.	C	T	3	4	7	0	0	7	0	0
8	16769641	.	G	A	2	6	8	0	0	8	0	0
8	17055751	.	C	T	19	13	32	0	9	41	0	0
8	17055802	.	C	T	0	17	17	0	25	42	0	0
8	17067268	.	A	T	3	5	8	0	1	9	0	0
8	17079902	.	C	T	1	3	4	0	0	4	0	0
8	17081758	.	C	T	5	5	10	0	0	10	0	0
8	17081782	.	C	T	2	4	6	0	2	8	0	0
8	17081863	.	G	A	2	1	3	0	0	3	0	0
8	17084733	.	C	G	7	3	10	0	1	11	0	0
8	17086002	.	C	T	14	9	23	0	3	26	0	0
8	17163611	.	A	G	16	11	27	0	1	28	0	0
8	17164208	.	G	A	16	19	35	0	3	38	0	0
8	17164302	.	A	G	4	3	7	0	2	9	0	0
8	17191921	.	A	G	2	2	4	0	0	4	0	0
8	17396056	.	G	T	10	24	34	0	2	36	0	0
8	17396186	.	T	G	25	14	39	0	7	46	0	0
8	17396303	.	G	A	19	15	34	0	2	36	0	0
8	17396447	.	A	C	3	5	8	0	2	10	0	0
8	17396566	.	T	C	1	3	4	0	0	4	0	0
8	17396567	.	C	T	0	3	3	0	1	4	0	0
8	17396815	.	T	A	5	2	7	0	0	7	0	0
8	17397995	.	A	T	6	5	11	0	0	11	0	0
8	17398113	.	C	T	0	3	3	0	1	4	0	0
8	17398229	.	A	T	1	2	3	0	1	4	0	0
8	17398712	.	G	A	1	2	3	0	0	3	0	0
8	17398775	.	G	A	6	2	8	0	1	9	0	0
8	17399586	.	T	A	4	4	8	0	0	8	0	0
8	17534858	.	G	T	0	2	2	0	0	2	0	0
8	17534887	.	C	T	0	3	3	0	0	3	0	0
8	17781076	.	G	A	0	3	3	0	3	6	0	0
8	17781096	.	C	A	1	3	4	0	0	4	0	0
8	17781165	.	A	G	2	2	4	0	1	5	0	0
8	17781537	.	T	C	4	3	7	0	0	7	0	0
8	17781555	.	C	T	1	3	4	0	1	5	0	0
8	17783735	.	G	A	4	2	6	0	0	6	0	0
8	17783775	.	C	T	2	8	10	0	1	11	0	0
8	17784308	.	A	G	8	4	12	0	0	12	0	0
8	17784426	.	T	G	5	9	14	0	1	15	0	0
8	17787833	.	A	T	1	3	4	0	1	5	0	0
8	17983772	.	C	A	7	2	9	0	0	9	0	0
8	17983773	.	C	A	6	2	8	0	1	9	0	0
8	17983938	.	T	G	2	3	5	0	0	5	0	0
8	17984265	.	T	G	1	2	3	0	0	3	0	0
8	17984266	.	C	G	1	2	3	0	0	3	0	0
8	18035129	.	A	T	7	3	10	0	1	11	0	0
8	18035231	.	T	A	4	5	9	0	0	9	0	0
8	18035290	.	T	C	8	4	12	0	4	16	0	0
8	18035303	.	T	A	8	7	15	0	0	15	0	0
8	18035371	.	T	C	10	4	14	0	3	17	0	0
8	18035428	.	G	A	8	6	14	0	0	14	0	0
8	18035946	.	T	A	10	9	19	0	1	20	0	0
8	18035963	.	T	C	8	12	20	0	1	21	0	0
8	18036592	.	G	A	11	6	17	0	1	18	0	0
8	18036610	.	C	T	6	4	10	0	0	10	0	0
8	18039741	.	A	G	4	4	8	0	0	8	0	0
8	18196462	.	A	G	13	7	20	0	1	21	0	0
8	18204369	.	T	C	2	3	5	0	0	5	0	0
8	18204443	.	T	C	1	0	1	0	0	1	0	0
8	18206726	.	C	G	1	1	2	0	0	2	0	0
8	18207056	.	T	G	1	3	4	0	0	4	0	0
8	18242762	.	G	T	4	2	6	0	0	6	0	0
8	18243760	.	A	G	0	5	5	0	0	5	0	0
8	18243810	.	C	T	1	2	3	0	0	3	0	0
8	18356141	.	T	C	0	4	4	0	2	6	0	0
8	18518964	.	G	A	0	2	2	0	0	2	0	0
8	18562153	.	A	G	8	3	11	0	0	11	0	0
8	18562283	.	G	A	0	12	12	0	11	23	0	0
8	18562317	.	C	T	8	11	19	0	0	19	0	0
8	18562570	.	C	T	12	5	17	0	3	20	0	0
8	18562576	.	G	A	15	3	18	0	2	20	0	0
8	18565921	.	A	T	4	3	7	0	1	8	0	0
8	18566970	.	C	A	8	6	14	0	0	14	0	0
8	18567020	.	G	A	10	9	19	0	1	20	0	0
8	18567059	.	A	G	10	5	15	0	1	16	0	0
8	18567064	.	T	A	11	4	15	0	0	15	0	0
8	18567260	.	A	G	4	1	5	0	11	16	0	0
8	18567342	.	G	A	9	5	14	0	0	14	0	0
8	18567559	.	C	T	3	3	6	0	1	7	0	0
8	18567577	.	G	T	4	5	9	0	1	10	0	0
8	18568022	.	G	C	3	3	6	0	0	6	0	0
8	18568167	.	G	T	3	3	6	0	0	6	0	0
8	18568189	.	C	A	4	1	5	0	0	5	0	0
8	18568264	.	T	A	2	2	4	0	0	4	0	0
8	18568677	.	C	T	0	3	3	0	4	7	0	0
8	18568687	.	A	G	4	3	7	0	0	7	0	0
8	18568739	.	T	A	4	3	7	0	0	7	0	0
8	18568740	.	C	A	0	3	3	0	4	7	0	0
8	18568800	.	A	G	5	2	7	0	0	7	0	0
8	18569856	.	T	C	2	3	5	0	0	5	0	0
8	18569871	.	G	A	2	3	5	0	2	7	0	0
8	18598351	.	A	T	8	9	17	0	0	17	0	0
8	18598391	.	T	A	4	9	13	0	1	14	0	0
8	18598533	.	G	A	3	3	6	0	0	6	0	0
8	18598544	.	T	C	3	3	6	0	0	6	0	0
8	18598590	.	T	G	5	0	5	0	3	8	0	0
8	18598593	.	C	G	5	3	8	0	0	8	0	0
8	18598782	.	T	C	14	10	24	0	1	25	0	0
8	18598915	.	A	G	17	8	25	0	0	25	0	0
8	18598920	.	G	C	17	9	26	0	0	26	0	0
8	18598997	.	G	T	12	9	21	0	1	22	0	0
8	18599014	.	G	T	0	9	9	0	12	21	0	0
8	18599088	.	C	A	15	12	27	0	1	28	0	0
8	18599123	.	T	C	12	11	23	0	0	23	0	0
8	18599147	.	A	G	12	15	27	0	1	28	0	0
8	18601780	.	T	C	2	1	3	0	1	4	0	0
8	18601787	.	C	T	0	2	2	0	2	4	0	0
8	18647252	.	A	G	3	3	6	0	0	6	0	0
8	18837494	.	C	A	0	3	3	0	3	6	0	0
8	18840295	.	A	G	5	0	5	0	8	13	0	0
8	19258761	.	G	A	2	2	4	0	0	4	0	0
8	19401508	.	C	T	0	24	24	0	21	45	0	0
8	19472131	.	C	G	3	5	8	0	2	10	0	0
8	19499851	.	C	G	4	2	6	0	1	7	0	0
8	19499929	.	A	G	2	2	4	0	1	5	0	0
8	19511480	.	G	A	0	9	9	0	7	16	0	0
8	19511673	.	C	G	12	8	20	0	0	20	0	0
8	19511674	.	C	A	10	8	18	0	2	20	0	0
8	19511770	.	A	C	3	12	15	0	1	16	0	0
8	19512186	.	A	G	9	0	9	0	16	25	0	0
8	19512187	.	C	A	10	14	24	0	1	25	0	0
8	19676049	.	A	C	1	2	3	0	0	3	0	0
8	20059302	.	A	C	1	2	3	0	0	3	0	0
8	20073213	.	T	C	3	6	9	0	1	10	0	0
8	20073257	.	C	T	3	4	7	0	0	7	0	0
8	20184698	.	T	C	2	2	4	0	0	4	0	0
8	20185793	.	G	A	0	3	3	0	2	5	0	0
8	20185796	.	G	C	2	3	5	0	0	5	0	0
8	20187793	.	T	C	0	1	1	0	0	1	0	0
8	20187829	.	A	T	2	6	8	0	0	8	0	0
8	20187835	.	A	G	2	0	2	0	6	8	0	0
8	20190489	.	A	G	4	6	10	0	0	10	0	0
8	20190764	.	G	C	7	2	9	0	0	9	0	0
8	20190790	.	T	C	5	8	13	0	1	14	0	0
8	20190809	.	G	C	4	14	18	0	1	19	0	0
8	20190876	.	A	G	8	8	16	0	3	19	0	0
8	20190967	.	G	A	0	12	12	0	10	22	0	0
8	20191067	.	T	C	3	6	9	0	0	9	0	0
8	20191301	.	C	A	13	13	26	0	5	31	0	0
8	20191354	.	A	G	10	14	24	0	1	25	0	0
8	20191561	.	A	G	15	16	31	0	2	33	0	0
8	20191651	.	T	C	22	18	40	0	4	44	0	0
8	20191965	.	T	A	24	20	44	0	1	45	0	0
8	20191999	.	C	T	15	13	28	0	4	32	0	0
8	20192046	.	A	G	13	0	13	0	14	27	0	0
8	20192049	.	G	A	12	16	28	0	1	29	0	0
8	20194246	.	C	T	1	2	3	0	0	3	0	0
8	20194583	.	C	T	8	11	19	0	2	21	0	0
8	20194647	.	T	C	6	9	15	0	4	19	0	0
8	20194787	.	T	C	7	1	8	0	0	8	0	0
8	20195228	.	A	G	3	3	6	0	2	8	0	0
8	20195674	.	T	G	2	2	4	0	1	5	0	0
8	20195688	.	A	G	4	2	6	0	0	6	0	0
8	20449590	.	G	A	2	2	4	0	0	4	0	0
8	20449614	.	A	G	2	2	4	0	0	4	0	0
8	20449847	.	A	G	0	6	6	0	0	6	0	0
8	20449851	.	T	A	0	7	7	0	0	7	0	0
8	20450168	.	C	T	4	7	11	0	0	11	0	0
8	20450249	.	T	A	4	2	6	0	1	7	0	0
8	20471387	.	G	A	6	8	14	0	0	14	0	0
8	20471480	.	C	T	4	4	8	0	2	10	0	0
8	20559103	.	T	C	7	12	19	2	3	24	0	0
8	20559169	.	A	G	8	1	9	0	26	35	0	0
8	20559202	.	A	G	15	0	15	0	25	40	0	0
8	20559211	.	T	A	13	22	35	0	5	40	0	0
8	20559270	.	A	G	13	27	40	0	3	43	0	0
8	20559373	.	G	A	15	10	25	0	3	28	0	0
8	20559682	.	G	A	17	23	40	0	2	42	0	0
8	20559683	.	A	G	16	22	38	0	4	42	0	0
8	20846257	.	T	A	2	2	4	0	1	5	0	0
8	20846303	.	G	T	1	4	5	0	0	6	1	0
8	20846336	.	C	T	4	4	8	0	0	8	0	0
8	20846615	.	C	G	1	3	4	0	0	4	0	0
8	20846625	.	C	G	1	1	2	0	1	3	0	0
8	20853149	.	A	G	5	17	22	0	0	22	0	0
8	20853314	.	A	G	16	13	29	0	0	29	0	0
8	20853803	.	G	A	4	5	9	0	0	9	0	0
8	20853900	.	G	A	5	8	13	0	1	14	0	0
8	20853951	.	G	C	2	5	7	0	0	7	0	0
8	20853987	.	C	G	2	2	4	0	1	5	0	0
8	20856365	.	T	G	1	4	5	0	1	6	0	0
8	20856383	.	G	A	2	9	11	0	0	11	0	0
8	20856505	.	A	G	5	6	11	0	1	12	0	0
8	20856646	.	C	A	3	1	4	0	0	4	0	0
8	20863148	.	C	A	1	2	3	0	1	4	0	0
8	20870301	.	G	A	0	1	1	0	0	1	0	0
8	20870439	.	A	T	2	1	3	0	0	3	0	0
8	20873011	.	G	A	0	2	2	0	3	5	0	0
8	20873113	.	C	T	2	6	8	0	2	10	0	0
8	20873183	.	C	T	3	0	3	0	0	3	0	0
8	20876466	.	C	T	7	5	12	0	12	24	0	0
8	21071433	.	G	A	0	1	1	0	1	2	0	0
8	21095506	.	G	A	4	8	12	0	3	15	0	0
8	21104767	.	A	G	2	6	8	0	1	9	0	0
8	21104837	.	G	A	2	6	8	0	1	9	0	0
8	21105045	.	G	A	2	8	10	0	2	12	0	0
8	21105504	.	G	A	7	3	10	0	0	10	0	0
8	21130746	.	T	C	2	3	5	0	0	5	0	0
8	21131702	.	A	G	1	3	4	0	0	4	0	0
8	21131926	.	A	G	2	3	5	0	0	5	0	0
8	21132300	.	C	T	11	8	19	0	1	20	0	0
8	21132318	.	G	A	10	12	22	0	0	22	0	0
8	21132445	.	A	C	11	15	26	0	0	26	0	0
8	21132538	.	C	G	15	10	25	0	4	29	0	0
8	21132696	.	C	T	10	14	24	0	2	26	0	0
8	21132956	.	G	A	10	6	16	0	0	16	0	0
8	21132979	.	T	A	6	5	11	0	0	11	0	0
8	21134088	.	G	T	7	4	11	0	2	13	0	0
8	21135606	.	T	C	4	3	7	0	0	7	0	0
8	21137733	.	T	C	3	4	7	0	0	7	0	0
8	21139989	.	G	A	4	5	9	0	2	11	0	0
8	21140175	.	G	T	1	2	3	0	0	3	0	0
8	21140181	.	G	T	1	2	3	0	0	3	0	0
8	21140910	.	C	T	1	2	3	0	0	3	0	0
8	21140913	.	T	G	1	2	3	0	0	3	0	0
8	21155871	.	T	C	0	1	1	0	0	1	0	0
8	21159196	.	A	G	2	4	6	0	0	6	0	0
8	21162191	.	C	T	6	6	12	0	0	12	0	0
8	21162209	.	T	C	6	5	11	0	0	11	0	0
8	21162278	.	G	A	0	3	3	0	9	12	0	0
8	21241122	.	T	C	0	1	1	0	0	1	0	0
8	21250183	.	T	A	6	7	13	0	0	13	0	0
8	21250709	.	C	A	10	10	20	0	0	20	0	0
8	21250897	.	G	A	0	7	7	0	7	14	0	0
8	21250982	.	G	A	4	4	8	0	0	8	0	0
8	21250988	.	C	T	5	3	8	0	2	10	0	0
8	21251171	.	C	G	20	14	34	0	3	37	0	0
8	21251172	.	C	T	21	16	37	0	0	37	0	0
8	21251241	.	G	A	23	14	37	0	1	38	0	0
8	21251325	.	C	A	14	16	30	0	0	30	0	0
8	21251732	.	C	T	14	15	29	0	3	32	0	0
8	21251820	.	A	T	9	7	16	0	2	18	0	0
8	21251856	.	G	A	15	8	23	0	1	24	0	0
8	21251993	.	A	C	5	5	10	0	1	11	0	0
8	21252042	.	G	T	3	10	13	0	0	14	1	0
8	21252163	.	A	G	20	30	50	0	7	57	0	0
8	21252472	.	C	G	24	22	46	0	4	50	0	0
8	21368033	.	A	T	2	1	3	0	0	3	0	0
8	21368351	.	A	G	2	3	5	0	0	5	0	0
8	21368734	.	C	T	2	2	4	0	1	5	0	0
8	21413092	.	G	A	4	2	6	0	1	7	0	0
8	21672329	.	T	A	2	2	4	0	0	4	0	0
8	21673880	.	A	C	0	1	1	0	1	2	0	0
8	21673886	.	A	G	1	0	1	0	2	3	0	0
8	21675551	.	A	G	1	3	4	0	1	5	0	0
8	21978302	.	A	C	6	3	9	0	0	9	0	0
8	21978306	.	G	A	5	3	8	0	0	8	0	0
8	22278411	.	T	C	1	2	3	1	0	4	0	0
8	22284262	.	C	T	5	5	10	0	1	11	0	0
8	22284306	.	C	T	6	3	9	0	0	9	0	0
8	22284425	.	G	A	4	6	10	0	0	10	0	0
8	22284509	.	T	C	6	3	9	0	1	10	0	0
8	22284570	.	T	G	8	5	13	0	1	14	0	0
8	22286820	.	G	A	7	5	12	0	1	13	0	0
8	22329678	.	T	C	1	1	2	0	0	2	0	0
8	22335414	.	A	G	1	1	2	0	0	2	0	0
8	22335420	.	T	C	0	1	1	0	1	2	0	0
8	22337337	.	G	A	0	2	2	0	4	6	0	0
8	22337436	.	T	C	12	4	16	0	0	16	0	0
8	22346502	.	C	T	1	0	1	0	0	1	0	0
8	22346508	.	T	C	1	0	1	0	0	1	0	0
8	22488380	.	A	G	1	0	1	0	1	2	0	0
8	22488389	.	C	A	2	2	4	0	0	4	0	0
8	22488422	.	T	A	1	7	8	0	1	9	0	0
8	22488425	.	C	T	2	7	9	0	0	9	0	0
8	22499724	.	T	G	2	2	4	0	0	4	0	0
8	22499765	.	C	T	0	2	2	0	3	5	0	0
8	22499839	.	C	T	7	5	12	0	1	13	0	0
8	22500150	.	T	A	3	6	9	0	1	10	0	0
8	22500274	.	C	T	0	5	5	0	7	12	0	0
8	22500307	.	A	C	3	1	4	0	3	7	0	0
8	22500406	.	A	T	2	4	6	0	0	6	0	0
8	22500436	.	G	A	5	4	9	0	0	9	0	0
8	22502731	.	C	T	1	1	2	0	0	2	0	0
8	22503469	.	G	C	0	3	3	0	1	4	0	0
8	22510967	.	C	T	1	2	3	0	1	4	0	0
8	22511045	.	G	A	2	3	5	0	1	6	0	0
8	22511375	.	C	T	5	3	8	0	1	9	0	0
8	22511471	.	C	T	3	6	9	0	1	10	0	0
8	22511654	.	C	T	0	2	2	0	6	8	0	0
8	22512539	.	T	A	1	0	1	0	0	1	0	0
8	22512567	.	C	T	1	0	1	0	1	2	0	0
8	22521792	.	G	C	16	12	28	0	0	28	0	0
8	22522136	.	A	G	24	13	37	0	2	39	0	0
8	22522397	.	G	A	3	9	12	0	2	14	0	0
8	22522688	.	G	A	12	11	23	0	3	26	0	0
8	22522699	.	C	G	1	7	8	0	12	23	3	0
8	22522742	.	T	C	14	9	23	0	1	24	0	0
8	22522913	.	T	A	10	10	20	0	0	20	0	0
8	22523118	.	G	A	11	11	22	0	0	22	0	0
8	22524820	.	C	T	2	5	7	0	0	7	0	0
8	22525773	.	C	T	0	4	4	0	5	9	0	0
8	22525978	.	C	T	3	3	6	0	1	7	0	0
8	22526355	.	T	G	3	1	4	0	0	4	0	0
8	22530423	.	T	C	0	2	2	0	0	2	0	0
8	22530480	.	G	A	2	1	3	0	0	3	0	0
8	22531978	.	G	A	0	2	2	0	0	2	0	0
8	22533535	.	C	T	1	2	3	0	0	3	0	0
8	22604028	.	C	T	2	2	4	0	0	4	0	0
8	22927035	.	T	A	2	3	5	0	0	5	0	0
8	22945572	.	T	C	2	4	6	0	1	7	0	0
8	22947209	.	C	T	22	10	32	0	2	34	0	0
8	22951203	.	A	T	14	22	36	0	2	38	0	0
8	22951730	.	G	A	13	19	32	0	4	36	0	0
8	22951847	.	A	T	21	20	41	0	3	44	0	0
8	22951919	.	C	T	29	14	43	0	4	47	0	0
8	22951979	.	T	G	28	26	54	0	1	56	1	0
8	22952330	.	A	T	32	31	63	3	0	66	0	0
8	22953441	.	A	G	1	2	3	0	1	4	0	0
8	23022762	.	A	G	1	1	2	0	0	2	0	0
8	23041461	.	C	T	0	3	3	0	4	7	0	0
8	23044620	.	G	A	2	3	5	0	0	5	0	0
8	23102830	.	C	T	7	3	10	0	0	10	0	0
8	23102846	.	C	T	4	4	8	0	0	8	0	0
8	23102951	.	T	A	1	6	7	0	0	7	0	0
8	23109554	.	C	A	3	5	8	0	1	9	0	0
8	23119100	.	T	A	3	7	10	0	0	10	0	0
8	23122265	.	T	C	3	2	5	0	0	5	0	0
8	23149956	.	G	A	0	4	4	0	4	8	0	0
8	23165835	.	G	T	0	3	3	0	1	4	0	0
8	23177298	.	C	T	3	2	5	0	1	6	0	0
8	23179659	.	G	T	6	8	14	0	1	15	0	0
8	23179702	.	T	G	8	18	26	0	0	26	0	0
8	23206939	.	C	T	1	0	1	0	0	1	0	0
8	23210492	.	T	C	12	5	17	0	1	18	0	0
8	23210579	.	G	A	7	9	16	0	0	16	0	0
8	23210652	.	G	A	7	9	16	0	1	17	0	0
8	23210955	.	C	T	5	7	12	0	0	12	0	0
8	23211109	.	G	T	0	5	5	0	0	5	0	0
8	23211120	.	C	T	4	4	8	0	0	8	0	0
8	23211200	.	G	T	16	4	20	0	0	20	0	0
8	23211233	.	G	T	5	19	24	0	0	24	0	0
8	23211402	.	T	C	10	17	27	0	2	29	0	0
8	23211424	.	C	A	12	18	30	0	0	30	0	0
8	23211446	.	A	C	13	15	28	0	1	29	0	0
8	23211624	.	A	G	2	2	4	0	0	4	0	0
8	23215697	.	G	A	0	11	11	0	10	21	0	0
8	23380726	.	G	A	2	2	4	0	0	4	0	0
8	23384003	.	G	A	2	4	6	0	0	6	0	0
8	23389692	.	A	C	2	4	6	0	0	6	0	0
8	23580286	.	C	A	2	3	5	0	0	5	0	0
8	23631692	.	C	T	2	0	2	0	0	2	0	0
8	23636779	.	A	C	8	1	9	0	4	13	0	0
8	23636901	.	C	A	5	7	12	0	0	12	0	0
8	23636923	.	C	T	7	3	10	0	0	10	0	0
8	23637140	.	A	G	9	6	15	0	0	15	0	0
8	23637395	.	C	T	3	4	7	0	0	7	0	0
8	23637680	.	C	T	1	2	3	0	1	4	0	0
8	23651328	.	C	T	1	3	4	0	0	4	0	0
8	23651370	.	C	T	2	2	4	0	0	4	0	0
8	23655968	.	C	T	3	6	9	0	0	9	0	0
8	23656125	.	G	T	5	4	9	0	1	10	0	0
8	23656212	.	A	T	11	4	15	0	0	15	0	0
8	23656321	.	C	A	10	9	19	0	0	19	0	0
8	23669276	.	C	T	3	3	6	0	0	6	0	0
8	23669617	.	T	C	8	4	12	0	0	12	0	0
8	23669642	.	C	T	4	9	13	0	2	15	0	0
8	23669736	.	A	T	6	5	11	0	0	11	0	0
8	23669802	.	C	A	7	6	13	0	0	13	0	0
8	23669821	.	G	A	0	6	6	0	3	9	0	0
8	23669885	.	G	T	5	6	11	0	1	12	0	0
8	23669933	.	C	A	4	3	7	0	1	8	0	0
8	23669968	.	C	T	4	1	5	0	2	7	0	0
8	23669983	.	T	C	5	5	10	0	0	10	0	0
8	23670019	.	T	C	5	6	11	0	0	11	0	0
8	23670115	.	T	C	1	2	3	0	0	3	0	0
8	23670202	.	A	G	8	3	11	0	0	11	0	0
8	23672295	.	A	G	1	2	3	0	0	3	0	0
8	23672740	.	G	C	2	2	4	0	0	4	0	0
8	23672802	.	A	G	1	3	4	0	1	5	0	0
8	23672812	.	G	A	0	5	5	0	1	6	0	0
8	23724045	.	A	C	3	6	9	0	1	10	0	0
8	23724620	.	G	A	0	6	6	0	3	9	0	0
8	23736063	.	G	A	0	6	6	0	3	9	0	0
8	23740519	.	G	A	4	6	10	0	2	12	0	0
8	23753566	.	T	A	5	3	8	0	0	8	0	0
8	23753793	.	C	T	0	3	3	0	3	6	0	0
8	23753834	.	C	G	0	3	3	0	2	5	0	0
8	23756089	.	A	T	1	2	3	0	0	3	0	0
8	23756221	.	T	A	4	7	11	0	1	12	0	0
8	23756536	.	C	G	0	5	5	0	4	9	0	0
8	23756749	.	G	C	2	1	3	0	0	3	0	0
8	23781056	.	A	T	3	3	6	0	0	6	0	0
8	23781425	.	A	G	3	0	3	0	3	6	0	0
8	23781426	.	A	G	3	3	6	0	0	6	0	0
8	23857845	.	T	C	0	2	2	0	0	2	0	0
8	23857997	.	G	A	1	1	2	0	0	2	0	0
8	23860200	.	G	A	3	2	5	0	1	6	0	0
8	23878905	.	T	A	1	8	9	0	0	9	0	0
8	23879044	.	T	A	9	9	18	0	0	18	0	0
8	23879238	.	T	A	8	15	23	0	1	24	0	0
8	23879365	.	G	A	15	9	24	0	1	25	0	0
8	24108887	.	A	G	2	9	11	0	0	11	0	0
8	24108899	.	T	C	2	8	10	0	1	11	0	0
8	24109317	.	T	A	3	4	7	0	1	8	0	0
8	24120176	.	T	A	4	4	8	0	0	8	0	0
8	24120187	.	A	T	4	4	8	0	0	8	0	0
8	24292976	.	C	T	1	2	3	0	0	3	0	0
8	24323336	.	T	C	1	7	8	0	0	8	0	0
8	24325363	.	A	G	3	9	12	0	0	12	0	0
8	24740168	.	C	A	4	2	6	0	0	6	0	0
8	24741031	.	A	T	5	5	10	0	1	11	0	0
8	24743676	.	A	T	3	3	6	0	0	6	0	0
8	24788514	.	C	T	3	2	5	0	0	5	0	0
8	24880220	.	G	A	1	2	3	0	0	3	0	0
8	24886251	.	A	G	0	2	2	0	0	2	0	0
8	24889403	.	C	T	11	29	40	0	4	44	0	0
8	24889482	.	A	T	7	18	25	0	1	26	0	0
8	24889586	.	C	T	4	15	19	0	0	19	0	0
8	24889629	.	A	G	4	16	20	0	3	23	0	0
8	24889638	.	T	A	5	20	25	0	2	27	0	0
8	24889796	.	G	A	4	16	20	0	0	20	0	0
8	24890084	.	T	A	0	4	4	0	2	6	0	0
8	24972006	.	T	C	22	19	41	0	3	44	0	0
8	24972137	.	G	T	16	17	33	0	11	44	0	0
8	24972413	.	A	C	3	3	6	0	0	6	0	0
8	24972594	.	T	C	18	15	33	0	0	33	0	0
8	24972595	.	T	A	18	15	33	0	0	33	0	0
8	24972746	.	T	A	12	17	29	0	2	31	0	0
8	24973088	.	G	C	6	5	11	0	0	11	0	0
8	24973239	.	T	A	7	11	18	0	0	18	0	0
8	24973276	.	A	G	7	8	15	0	0	15	0	0
8	24973462	.	A	G	4	7	11	0	0	11	0	0
8	25036520	.	T	C	3	4	7	0	0	7	0	0
8	25036523	.	A	G	3	0	3	0	4	7	0	0
8	25036694	.	C	G	3	1	4	0	1	5	0	0
8	25039704	.	T	C	6	5	11	0	1	12	0	0
8	25039967	.	C	A	6	4	10	0	0	10	0	0
8	25040295	.	A	G	8	7	15	0	2	17	0	0
8	25040349	.	A	G	5	4	9	0	2	11	0	0
8	25040479	.	T	C	2	4	6	0	0	6	0	0
8	25040499	.	T	G	1	3	4	0	0	4	0	0
8	25042269	.	T	C	5	7	12	0	2	14	0	0
8	25042275	.	T	C	5	9	14	0	1	15	0	0
8	25042328	.	A	G	8	6	14	0	1	15	0	0
8	25042352	.	G	A	5	8	13	0	0	13	0	0
8	25042474	.	T	C	6	0	6	0	10	16	0	0
8	25042578	.	A	G	9	8	17	0	2	19	0	0
8	25043021	.	A	G	3	5	8	0	1	9	0	0
8	25043069	.	T	C	9	2	11	0	0	11	0	0
8	25043125	.	A	G	4	5	9	0	0	9	0	0
8	25043167	.	A	T	6	6	12	0	0	12	0	0
8	25045766	.	T	C	1	1	2	0	0	2	0	0
8	25103407	.	C	T	3	5	8	0	0	8	0	0
8	25103581	.	C	T	1	6	7	0	1	8	0	0
8	25103719	.	T	C	8	6	14	0	1	15	0	0
8	25103731	.	T	C	8	5	13	0	0	13	0	0
8	25176257	.	T	C	2	1	3	0	1	4	0	0
8	25176303	.	A	G	1	3	4	0	0	4	0	0
8	25176677	.	T	C	1	4	5	0	0	5	0	0
8	25176957	.	C	G	2	2	4	0	0	4	0	0
8	25177285	.	A	G	4	3	7	0	0	7	0	0
8	25225949	.	T	A	1	2	3	0	1	4	0	0
8	25226843	.	T	C	0	1	1	0	0	1	0	0
8	25289180	.	C	T	1	2	3	0	0	3	0	0
8	25291573	.	C	A	1	5	6	0	0	6	0	0
8	25291597	.	A	G	3	2	5	0	0	5	0	0
8	25291651	.	A	G	1	2	3	0	0	3	0	0
8	25291662	.	A	G	3	2	5	0	0	5	0	0
8	25291742	.	A	C	2	4	6	0	0	6	0	0
8	25291912	.	A	T	5	7	12	0	0	12	0	0
8	25292188	.	C	T	5	4	9	0	0	9	0	0
8	25292370	.	A	G	4	5	9	0	1	10	0	0
8	25292407	.	G	T	9	5	14	0	2	16	0	0
8	25292482	.	T	C	6	7	13	0	0	13	0	0
8	25292492	.	A	T	5	6	11	0	0	11	0	0
8	25292608	.	T	C	15	5	20	0	3	23	0	0
8	25292865	.	G	C	6	13	19	0	1	20	0	0
8	25293008	.	A	G	6	16	22	0	3	25	0	0
8	25293064	.	C	T	12	13	25	0	0	25	0	0
8	25293111	.	G	T	14	15	29	0	2	31	0	0
8	25293184	.	C	T	14	20	34	0	0	34	0	0
8	25293225	.	T	A	14	15	29	0	0	29	0	0
8	25293275	.	A	G	18	2	20	0	23	43	0	0
8	25293346	.	C	T	19	18	37	0	0	37	0	0
8	25293445	.	T	C	4	7	11	0	1	12	0	0
8	25293459	.	T	C	3	3	6	0	0	6	0	0
8	25297326	.	A	G	3	1	4	0	12	16	0	0
8	25297371	.	T	C	1	4	5	0	0	5	0	0
8	25297617	.	G	C	15	22	37	0	1	38	0	0
8	25297741	.	C	T	12	16	28	0	4	32	0	0
8	25297842	.	T	A	10	25	35	0	1	36	0	0
8	25297864	.	A	G	9	21	30	0	0	30	0	0
8	25300749	.	T	C	1	2	3	0	0	3	0	0
8	25301185	.	T	C	5	5	10	0	1	11	0	0
8	25301280	.	A	G	12	11	23	0	1	24	0	0
8	25301350	.	A	G	7	9	16	0	1	17	0	0
8	25301389	.	G	A	0	10	10	0	8	18	0	0
8	25301450	.	T	C	8	6	14	0	0	14	0	0
8	25301512	.	G	T	7	9	16	0	1	17	0	0
8	25301524	.	A	G	10	7	17	0	0	17	0	0
8	25301547	.	G	A	11	4	15	0	2	17	0	0
8	25301583	.	C	A	14	5	19	0	2	22	1	0
8	25301590	.	A	C	14	7	21	0	1	22	0	0
8	25329606	.	T	A	6	5	11	0	0	11	0	0
8	25329981	.	A	T	16	5	21	0	0	21	0	0
8	25330065	.	T	A	10	9	19	0	0	19	0	0
8	25330181	.	C	T	12	6	18	0	0	18	0	0
8	25330293	.	C	T	12	4	16	0	1	17	0	0
8	25330295	.	T	A	11	4	15	0	2	17	0	0
8	25330334	.	T	A	9	4	13	0	0	13	0	0
8	25330367	.	A	C	6	5	11	0	0	11	0	0
8	25330390	.	A	G	11	5	16	0	0	16	0	0
8	25330498	.	G	A	23	26	49	0	2	51	0	0
8	25332708	.	C	T	8	12	20	0	4	24	0	0
8	25332900	.	A	G	1	5	6	0	1	7	0	0
8	25332945	.	G	A	17	22	39	0	2	41	0	0
8	25335063	.	G	A	16	8	24	0	3	27	0	0
8	25336097	.	T	A	10	7	17	0	0	17	0	0
8	25336102	.	T	G	10	7	17	0	0	17	0	0
8	25367091	.	C	T	6	9	15	0	0	15	0	0
8	25368374	.	A	G	0	2	2	0	0	2	0	0
8	25424272	.	C	T	10	11	21	0	1	22	0	0
8	25424375	.	C	A	9	5	14	0	1	15	0	0
8	25424411	.	T	A	10	5	15	0	0	15	0	0
8	25424721	.	A	G	2	6	8	0	0	8	0	0
8	25424734	.	T	A	2	6	8	0	0	8	0	0
8	25425453	.	G	A	3	2	5	0	0	5	0	0
8	25708263	.	A	G	5	2	7	0	0	7	0	0
8	25708998	.	C	T	1	1	2	0	1	3	0	0
8	25709259	.	G	A	4	2	6	0	0	6	0	0
8	25709521	.	T	A	3	1	4	0	1	5	0	0
8	25709522	.	A	C	3	0	3	0	2	5	0	0
8	25709694	.	T	G	1	3	4	0	1	5	0	0
8	25713053	.	G	A	5	1	6	0	0	6	0	0
8	25715118	.	A	C	0	1	1	0	2	3	0	0
8	25716000	.	C	A	2	3	5	0	0	5	0	0
8	25745724	.	C	T	2	2	4	0	0	4	0	0
8	25747425	.	A	T	2	2	4	0	0	4	0	0
8	25748283	.	G	T	4	2	6	0	0	6	0	0
8	25748421	.	T	G	9	7	16	0	0	16	0	0
8	25764192	.	T	C	7	6	13	0	1	14	0	0
8	25765647	.	G	A	1	8	9	0	6	15	0	0
8	25765788	.	G	A	1	13	14	0	9	23	0	0
8	25765794	.	G	A	10	9	19	0	3	22	0	0
8	25766098	.	G	A	9	5	14	0	0	14	0	0
8	25766131	.	T	C	9	8	17	0	0	17	0	0
8	25766188	.	A	C	3	12	15	0	2	17	0	0
8	25812075	.	T	C	19	11	30	0	2	32	0	0
8	25812327	.	G	A	11	6	17	0	0	17	0	0
8	25813979	.	G	A	2	5	7	0	0	7	0	0
8	25814003	.	C	T	0	0	0	0	2	2	0	0
8	25816811	.	T	A	1	5	6	0	1	7	0	0
8	25816849	.	G	A	3	9	12	0	1	13	0	0
8	25816863	.	G	A	3	9	12	0	1	13	0	0
8	25816889	.	T	C	2	6	8	0	2	10	0	0
8	25816904	.	T	G	3	7	10	0	0	10	0	0
8	25816959	.	G	T	4	9	13	0	1	14	0	0
8	25818670	.	T	G	3	6	9	0	0	9	0	0
8	25818836	.	C	T	0	12	12	0	20	32	0	0
8	25819057	.	T	A	14	10	24	0	1	25	0	0
8	25819090	.	G	T	8	1	9	0	0	9	0	0
8	25819095	.	A	T	7	1	8	0	2	10	0	0
8	25819128	.	A	G	8	1	9	0	1	10	0	0
8	25819137	.	T	C	7	0	7	0	0	7	0	0
8	25819318	.	G	A	4	2	6	0	0	6	0	0
8	25819349	.	A	G	1	5	6	0	1	7	0	0
8	25819430	.	A	T	4	7	11	0	3	14	0	0
8	25819434	.	C	G	4	9	13	0	0	13	0	0
8	25819548	.	C	G	11	17	28	0	2	30	0	0
8	25821426	.	T	C	3	8	11	0	0	11	0	0
8	25893610	.	C	G	0	2	2	0	0	2	0	0
8	25893655	.	T	C	0	2	2	0	0	2	0	0
8	25894080	.	C	G	3	3	6	0	0	6	0	0
8	25897130	.	T	A	16	0	16	0	1	17	0	0
8	25897861	.	G	A	2	5	7	0	2	9	0	0
8	25898011	.	T	A	7	4	11	0	0	11	0	0
8	25898067	.	G	T	5	2	7	0	0	7	0	0
8	25902955	.	T	C	12	11	23	0	0	23	0	0
8	25905686	.	T	A	17	26	43	0	0	43	0	0
8	25905919	.	T	C	5	11	16	0	1	17	0	0
8	25951378	.	C	G	4	3	7	0	0	7	0	0
8	25951411	.	C	T	7	3	10	0	0	10	0	0
8	25963150	.	A	G	1	3	4	0	0	4	0	0
8	25963151	.	C	A	1	3	4	0	0	4	0	0
8	25969188	.	C	T	1	2	3	0	0	3	0	0
8	25969466	.	C	T	3	2	5	0	1	6	0	0
8	25969498	.	A	G	4	2	6	0	1	7	0	0
8	25969506	.	G	A	0	3	3	0	4	7	0	0
8	25969778	.	T	A	2	2	4	0	2	6	0	0
8	25969840	.	A	G	3	2	5	0	0	5	0	0
8	25970719	.	A	T	5	5	10	0	1	11	0	0
8	25970816	.	G	T	8	7	15	0	0	15	0	0
8	25970932	.	G	A	11	12	23	0	0	23	0	0
8	25971143	.	C	A	10	5	15	0	4	19	0	0
8	25971306	.	T	A	10	19	29	0	3	32	0	0
8	25971367	.	C	T	4	16	20	0	4	24	0	0
8	25971397	.	G	A	5	13	18	0	2	20	0	0
8	26030660	.	C	A	3	2	5	0	0	5	0	0
8	26034654	.	A	G	1	2	3	0	0	3	0	0
8	26034676	.	C	T	1	2	3	0	0	3	0	0
8	26056801	.	G	A	19	16	35	0	0	35	0	0
8	26056891	.	T	G	12	19	31	0	3	34	0	0
8	26056935	.	T	C	19	19	38	0	4	42	0	0
8	26056970	.	T	C	14	16	30	0	3	33	0	0
8	26056990	.	T	C	12	22	34	0	4	38	0	0
8	26057014	.	T	C	17	19	36	0	7	43	0	0
8	26078551	.	C	T	13	7	20	0	1	21	0	0
8	26078825	.	A	G	6	5	11	0	1	12	0	0
8	26078826	.	A	G	6	6	12	0	0	12	0	0
8	26078879	.	T	G	7	5	12	0	1	13	0	0
8	26083987	.	C	T	2	2	4	0	0	4	0	0
8	26092050	.	A	G	1	2	3	0	0	3	0	0
8	26092176	.	T	A	2	2	4	0	0	4	0	0
8	26097399	.	T	C	22	15	37	0	3	40	0	0
8	26097749	.	C	T	7	13	20	0	1	21	0	0
8	26097895	.	C	A	11	8	19	0	0	19	0	0
8	26233584	.	C	A	0	2	2	0	0	2	0	0
8	26234114	.	G	T	0	3	3	0	2	5	0	0
8	26234123	.	T	A	3	3	6	0	0	6	0	0
8	26234599	.	A	T	1	2	3	0	0	3	0	0
8	26235117	.	A	C	3	4	7	0	0	7	0	0
8	26235164	.	T	C	3	3	6	0	0	6	0	0
8	26235275	.	C	T	10	4	14	0	0	14	0	0
8	26235471	.	A	G	5	3	8	0	0	8	0	0
8	26239916	.	G	A	0	5	5	0	7	12	0	0
8	26239919	.	T	A	7	5	12	0	0	12	0	0
8	26240007	.	C	T	13	8	21	0	0	21	0	0
8	26240047	.	T	G	11	5	16	0	2	18	0	0
8	26240196	.	C	T	7	6	13	0	5	18	0	0
8	26240346	.	G	A	1	6	7	0	8	15	0	0
8	26240348	.	A	T	8	7	15	0	0	15	0	0
8	26324773	.	T	C	2	2	4	0	0	4	0	0
8	26324905	.	A	G	7	6	13	0	2	15	0	0
8	26325332	.	T	A	23	14	37	0	0	37	0	0
8	26325333	.	A	T	23	14	37	0	0	37	0	0
8	26325519	.	A	T	8	8	16	0	0	16	0	0
8	26325600	.	T	C	12	8	20	0	0	20	0	0
8	26325679	.	C	T	19	16	35	0	2	37	0	0
8	26326046	.	G	A	19	10	29	0	3	32	0	0
8	26326152	.	T	C	25	18	43	0	3	46	0	0
8	26326498	.	G	A	0	2	2	0	1	3	0	0
8	26330666	.	T	C	3	3	6	0	0	6	0	0
8	26357826	.	A	G	0	1	1	0	0	1	0	0
8	26367891	.	T	G	10	10	20	0	1	21	0	0
8	26368025	.	C	T	22	16	38	0	0	38	0	0
8	26368150	.	C	T	30	10	40	0	4	44	0	0
8	26368171	.	T	C	30	17	47	0	2	49	0	0
8	26368446	.	A	T	5	3	8	0	2	10	0	0
8	26382991	.	A	G	1	2	3	0	0	3	0	0
8	26383000	.	T	C	1	2	3	0	0	3	0	0
8	26426163	.	T	C	1	0	1	0	0	1	0	0
8	26426596	.	T	G	5	4	9	0	1	10	0	0
8	26426621	.	C	T	4	4	8	0	0	8	0	0
8	26426771	.	C	T	6	2	8	0	1	9	0	0
8	26426978	.	A	C	8	5	13	0	0	13	0	0
8	26427081	.	C	T	5	6	11	0	1	12	0	0
8	26427125	.	C	T	4	2	6	0	3	9	0	0
8	26444741	.	T	C	1	0	1	0	0	1	0	0
8	26449341	.	T	C	4	2	6	0	0	6	0	0
8	26449383	.	G	A	4	3	7	0	0	7	0	0
8	26573519	.	T	C	1	2	3	0	1	4	0	0
8	26586900	.	G	T	0	2	2	0	0	2	0	0
8	26863804	.	C	A	5	2	7	0	3	10	0	0
8	26864150	.	G	C	6	2	8	0	0	8	0	0
8	26864195	.	G	C	7	2	9	0	1	10	0	0
8	26881205	.	T	G	1	0	1	0	4	5	0	0
8	26884298	.	T	C	7	4	11	0	0	11	0	0
8	26884313	.	A	G	4	4	8	0	2	10	0	0
8	26884619	.	C	T	11	22	33	0	0	33	0	0
8	26884767	.	C	T	18	18	36	0	2	38	0	0
8	26884903	.	T	A	5	11	16	0	0	16	0	0
8	26885382	.	C	A	13	14	27	0	5	32	0	0
8	26886025	.	C	T	15	10	25	0	1	26	0	0
8	26886177	.	T	C	14	21	35	0	1	36	0	0
8	26886259	.	A	G	15	12	27	0	0	27	0	0
8	26886399	.	C	G	24	9	33	0	0	33	0	0
8	26886667	.	T	A	30	18	48	0	3	53	2	0
8	26886766	.	T	C	20	24	44	0	5	49	0	0
8	26886972	.	A	T	21	23	44	0	6	50	0	0
8	26887013	.	T	C	16	27	43	0	1	44	0	0
8	26887122	.	A	C	13	19	32	0	2	34	0	0
8	26902641	.	C	T	0	3	3	0	3	6	0	0
8	27361846	.	G	A	8	6	14	0	0	14	0	0
8	27362288	.	C	G	2	1	3	0	0	3	0	0
8	27515239	.	T	C	2	2	4	0	1	5	0	0
8	27624026	.	T	A	20	15	35	0	1	36	0	0
8	27624027	.	T	C	20	16	36	0	0	36	0	0
8	27813611	.	C	A	4	4	8	0	0	8	0	0
8	27816560	.	C	A	24	28	52	0	6	58	0	0
8	27816680	.	C	T	16	25	41	0	3	44	0	0
8	28399129	.	G	A	6	2	8	0	0	8	0	0
8	29336744	.	C	A	0	1	1	0	0	1	0	0
8	29587262	.	C	A	4	3	7	0	0	7	0	0
8	29587500	.	C	A	4	2	6	0	1	7	0	0
8	29651951	.	A	G	6	7	13	0	0	13	0	0
8	29652143	.	A	G	6	8	14	0	0	14	0	0
8	29652174	.	G	A	4	8	12	0	0	12	0	0
8	29719073	.	G	T	6	7	13	0	1	14	0	0
8	29719306	.	C	T	0	2	2	0	2	4	0	0
8	29764138	.	C	T	1	4	5	0	0	5	0	0
8	29764150	.	A	T	1	3	4	0	0	4	0	0
8	29765411	.	A	G	5	2	7	0	0	7	0	0
8	29765414	.	A	G	3	4	7	0	0	7	0	0
8	29765872	.	A	C	3	4	7	0	0	7	0	0
8	29770371	.	T	A	24	36	60	0	4	65	1	0
8	29773127	.	T	A	4	2	6	0	0	6	0	0
8	29871800	.	T	C	1	2	3	0	0	3	0	0
8	29876237	.	G	A	2	2	4	0	0	4	0	0
8	29899087	.	G	C	3	1	4	0	4	8	0	0
8	29899209	.	T	C	4	2	6	0	0	6	0	0
8	29899248	.	T	C	4	2	6	0	0	6	0	0
8	29899302	.	C	T	0	3	3	0	5	8	0	0
8	29899318	.	T	C	4	5	9	0	1	10	0	0
8	29904855	.	T	C	1	0	1	0	0	1	0	0
8	30159420	.	C	T	2	6	8	0	0	8	0	0
8	30326228	.	G	A	1	6	7	0	0	7	0	0
8	30338926	.	C	T	1	3	4	0	0	4	0	0
8	30449074	.	G	A	1	1	2	0	1	3	0	0
8	30631147	.	C	T	1	1	2	0	0	2	0	0
8	30661270	.	C	T	1	2	3	0	1	4	0	0
8	30662366	.	A	T	4	4	8	0	0	8	0	0
8	30662481	.	T	C	12	11	23	0	0	23	0	0
8	30662505	.	A	T	8	14	22	0	1	23	0	0
8	30731187	.	A	G	5	8	13	0	1	14	0	0
8	30735082	.	T	A	5	3	8	0	0	8	0	0
8	30743321	.	T	C	3	4	7	0	0	7	0	0
8	30743345	.	A	G	5	4	9	0	2	11	0	0
8	30744468	.	G	A	0	7	7	0	4	11	0	0
8	30744528	.	C	T	4	0	4	0	0	4	0	0
8	30745437	.	A	G	3	1	4	0	0	4	0	0
8	30746092	.	A	T	0	5	5	0	0	5	0	0
8	30746127	.	C	T	1	4	5	0	0	5	0	0
8	31142074	.	G	A	3	3	6	0	3	9	0	0
8	31146748	.	G	A	13	16	29	0	2	31	0	0
8	31146913	.	G	A	13	21	34	0	1	35	0	0
8	31147380	.	T	G	17	24	41	0	1	42	0	0
8	31147526	.	G	A	22	23	45	0	3	48	0	0
8	31251091	.	A	G	2	4	6	0	2	8	0	0
8	31251129	.	G	A	1	3	4	0	1	5	0	0
8	31251222	.	T	C	2	4	6	0	2	8	0	0
8	31251354	.	T	C	5	2	7	0	3	10	0	0
8	31251426	.	T	C	6	5	11	0	0	11	0	0
8	31251510	.	C	A	5	6	11	0	0	11	0	0
8	31251555	.	G	A	0	13	13	0	8	21	0	0
8	31251792	.	G	C	0	9	9	0	15	24	0	0
8	31253722	.	T	C	8	13	21	0	0	21	0	0
8	31254046	.	C	A	13	10	23	0	2	25	0	0
8	31254176	.	A	T	17	16	33	0	1	34	0	0
8	31254219	.	T	C	5	14	19	0	1	20	0	0
8	31367747	.	T	C	3	4	7	0	0	7	0	0
8	31368010	.	G	A	12	13	25	0	2	27	0	0
8	31368279	.	T	G	6	8	14	0	1	15	0	0
8	31368524	.	C	T	7	7	14	0	0	14	0	0
8	31368557	.	A	G	7	5	12	0	1	13	0	0
8	31369071	.	G	C	5	1	6	0	1	7	0	0
8	31375338	.	T	C	3	2	5	0	0	5	0	0
8	31375400	.	C	T	6	7	13	0	0	13	0	0
8	31375405	.	T	C	5	7	12	0	0	12	0	0
8	31375529	.	T	C	8	3	11	0	1	12	0	0
8	31375549	.	C	T	10	0	10	0	0	10	0	0
8	31375670	.	T	G	5	23	28	0	0	28	0	0
8	31379542	.	C	T	0	0	0	0	1	1	0	0
8	31407126	.	A	T	10	10	20	0	2	22	0	0
8	31407153	.	C	T	9	12	21	0	2	23	0	0
8	31407294	.	A	G	6	4	10	0	0	10	0	0
8	31411089	.	C	T	0	8	8	0	9	17	0	0
8	31411578	.	G	A	3	6	9	0	1	10	0	0
8	31437497	.	G	C	3	3	6	0	0	6	0	0
8	31437611	.	C	T	4	7	11	0	0	11	0	0
8	31437768	.	C	G	1	4	5	0	0	5	0	0
8	31441698	.	C	A	4	9	13	0	2	15	0	0
8	31441724	.	G	T	7	7	14	0	1	15	0	0
8	31441733	.	C	A	8	9	17	0	1	18	0	0
8	31441850	.	T	C	19	6	25	0	1	26	0	0
8	31442000	.	G	A	20	8	28	0	1	29	0	0
8	31442595	.	G	A	10	20	30	0	0	30	0	0
8	31442886	.	T	C	20	12	32	0	3	35	0	0
8	31443023	.	A	C	29	27	56	0	6	62	0	0
8	31704897	.	T	A	3	2	5	0	1	6	0	0
8	31705267	.	G	A	16	14	30	0	2	32	0	0
8	31760785	.	C	T	0	2	2	0	0	2	0	0
8	31817931	.	A	C	1	0	1	0	1	2	0	0
8	31818018	.	T	C	11	15	26	0	0	26	0	0
8	31818022	.	G	A	0	15	15	0	11	26	0	0
8	31818083	.	A	T	11	14	25	0	0	25	0	0
8	31818196	.	G	A	16	19	35	0	0	35	0	0
8	31818267	.	T	G	9	20	29	0	0	29	0	0
8	31818273	.	T	A	9	19	28	0	0	28	0	0
8	31818335	.	G	A	10	14	24	0	0	24	0	0
8	31818349	.	A	C	11	13	24	0	2	26	0	0
8	31818460	.	A	G	5	4	9	0	0	9	0	0
8	31818549	.	C	T	5	5	10	0	0	10	0	0
8	31818748	.	T	C	8	14	22	0	0	22	0	0
8	31818800	.	G	A	8	9	17	0	0	17	0	0
8	31818835	.	T	G	12	7	19	0	1	20	0	0
8	31850976	.	G	T	2	2	4	0	0	4	0	0
8	31851150	.	A	C	1	3	4	0	0	4	0	0
8	31851270	.	G	A	3	1	4	0	1	5	0	0
8	31851333	.	G	T	2	5	7	0	0	7	0	0
8	31851336	.	A	G	2	4	6	0	0	6	0	0
8	31851582	.	A	G	3	1	4	0	0	4	0	0
8	31851594	.	T	C	0	0	0	0	1	1	0	0
8	31861425	.	A	G	7	3	10	0	0	10	0	0
8	31861580	.	G	A	2	10	12	0	1	13	0	0
8	31861616	.	T	A	8	12	20	0	0	20	0	0
8	31861746	.	C	T	9	15	24	0	0	24	0	0
8	31862063	.	T	C	12	18	30	0	3	33	0	0
8	31862179	.	A	G	11	13	24	0	3	27	0	0
8	31862584	.	G	T	15	10	25	0	2	27	0	0
8	31888723	.	C	T	1	2	3	0	0	3	0	0
8	31901757	.	T	C	2	3	5	0	0	5	0	0
8	31901760	.	C	T	1	3	4	0	1	5	0	0
8	31901925	.	G	A	12	11	23	0	1	24	0	0
8	31906886	.	G	A	0	2	2	0	0	2	0	0
8	31906910	.	C	A	6	5	11	0	1	12	0	0
8	31906927	.	G	A	8	9	17	0	1	18	0	0
8	31919558	.	A	C	4	2	6	0	0	6	0	0
8	31941853	.	C	T	2	2	4	0	0	4	0	0
8	31942771	.	C	T	5	10	15	0	0	15	0	0
8	31943276	.	G	A	6	7	13	0	1	14	0	0
8	31943301	.	T	G	4	4	8	0	1	9	0	0
8	31943357	.	T	C	3	2	5	0	1	6	0	0
8	32028856	.	G	T	12	4	16	0	0	16	0	0
8	32028921	.	T	A	9	3	12	0	0	12	0	0
8	32029044	.	T	G	6	5	11	0	1	12	0	0
8	32029766	.	T	G	1	2	3	0	0	3	0	0
8	32030341	.	A	G	1	3	4	0	0	4	0	0
8	32030771	.	T	G	4	4	8	0	0	8	0	0
8	32483905	.	G	C	0	1	1	0	0	1	0	0
8	32486956	.	C	T	0	4	4	0	6	10	0	0
8	32516296	.	A	G	1	2	3	0	0	3	0	0
8	32577794	.	G	A	2	2	4	0	0	4	0	0
8	32588542	.	G	T	0	1	1	0	0	1	0	0
8	32598954	.	A	G	2	3	5	0	2	7	0	0
8	32598963	.	C	G	2	0	2	0	5	7	0	0
8	32599147	.	G	A	13	5	18	0	0	18	0	0
8	32599288	.	T	C	1	2	3	0	0	3	0	0
8	32599295	.	A	G	1	4	5	0	0	5	0	0
8	32599413	.	T	C	8	13	21	0	3	24	0	0
8	32599586	.	C	T	6	8	14	0	0	14	0	0
8	32599795	.	G	A	2	4	6	0	0	6	0	0
8	33896450	.	A	G	3	9	12	0	1	13	0	0
8	33896524	.	G	T	14	5	19	0	0	19	0	0
8	33896585	.	C	T	16	24	40	0	2	42	0	0
8	33896698	.	A	G	13	21	34	0	0	34	0	0
8	33896902	.	G	A	13	15	28	0	2	30	0	0
8	33896964	.	T	G	14	9	23	0	5	28	0	0
8	33910017	.	G	A	5	10	15	0	1	16	0	0
8	33918520	.	C	T	7	3	10	0	0	10	0	0
8	33924333	.	G	T	8	3	11	0	0	11	0	0
8	34051619	.	G	T	2	5	7	0	0	7	0	0
8	34342146	.	G	A	11	6	17	0	1	18	0	0
8	34342214	.	A	T	9	8	17	0	0	17	0	0
8	34342462	.	A	G	7	6	13	0	1	14	0	0
8	34345285	.	G	A	2	2	4	0	0	4	0	0
8	34687161	.	G	A	1	2	3	0	0	3	0	0
8	35759726	.	C	T	3	3	6	0	0	6	0	0
8	35760218	.	C	T	5	4	9	0	1	10	0	0
8	35760423	.	C	T	1	5	6	0	0	6	0	0
8	36058800	.	T	A	1	2	3	0	0	3	0	0
8	36059033	.	G	A	1	2	3	0	0	3	0	0
8	36561942	.	A	T	4	2	6	0	2	8	0	0
8	36566125	.	C	T	7	4	11	0	0	11	0	0
8	36566167	.	G	A	12	6	18	0	1	19	0	0
8	36566182	.	T	C	12	8	20	0	3	23	0	0
8	36566353	.	T	C	3	4	7	0	0	7	0	0
8	36567283	.	C	T	14	6	20	0	1	21	0	0
8	36568561	.	A	G	7	2	9	0	0	9	0	0
8	36568755	.	T	C	2	0	2	0	0	2	0	0
8	36569810	.	T	C	5	2	7	0	1	8	0	0
8	36569924	.	C	A	10	9	19	0	4	23	0	0
8	36569925	.	T	A	11	10	21	0	2	23	0	0
8	36569968	.	A	C	13	6	19	0	2	21	0	0
8	36569990	.	A	G	16	6	22	0	0	22	0	0
8	36571018	.	A	C	1	1	2	0	0	2	0	0
8	36575325	.	T	C	1	0	1	0	1	2	0	0
8	36577083	.	T	C	2	0	2	0	0	2	0	0
8	36577143	.	C	T	5	3	8	0	0	8	0	0
8	36577158	.	T	C	4	3	7	0	0	7	0	0
8	36578796	.	T	C	3	4	7	0	0	7	0	0
8	36578813	.	C	T	2	4	6	0	0	6	0	0
8	36579387	.	T	C	3	3	6	0	1	7	0	0
8	36583834	.	T	C	1	3	4	0	0	4	0	0
8	36587934	.	A	G	2	6	8	0	0	8	0	0
8	36587936	.	A	G	1	0	1	0	7	8	0	0
8	36587970	.	C	A	2	12	14	0	0	14	0	0
8	36588124	.	G	A	3	1	4	0	1	5	0	0
8	36589197	.	C	T	6	10	16	0	1	17	0	0
8	36591868	.	A	C	7	5	12	0	1	13	0	0
8	36591985	.	C	T	9	7	16	0	0	16	0	0
8	36592018	.	A	G	6	8	14	0	1	15	0	0
8	36592021	.	C	A	0	8	8	0	7	15	0	0
8	36592159	.	A	G	2	3	5	0	1	6	0	0
8	36592160	.	A	G	1	4	5	0	1	6	0	0
8	36592297	.	G	A	4	5	9	0	2	11	0	0
8	36592374	.	A	G	6	1	7	0	0	7	0	0
8	36594481	.	T	G	1	0	1	0	0	1	0	0
8	36594509	.	G	A	1	0	1	0	0	1	0	0
8	36598441	.	C	T	0	5	5	0	4	9	0	0
8	36600867	.	C	T	3	3	6	0	0	6	0	0
8	36600879	.	G	A	2	2	4	0	0	4	0	0
8	36602459	.	C	T	0	2	2	0	0	2	0	0
8	36617669	.	A	G	3	2	5	0	0	5	0	0
8	36803717	.	G	A	0	2	2	0	2	4	0	0
8	36956254	.	C	T	1	2	3	0	0	3	0	0
8	36956269	.	T	C	1	2	3	0	0	3	0	0
8	36969205	.	T	C	1	0	1	0	0	1	0	0
8	36974328	.	C	T	2	4	6	0	2	8	0	0
8	36974514	.	C	T	4	2	6	0	0	6	0	0
8	36975826	.	A	G	5	4	9	0	0	9	0	0
8	36975928	.	T	C	4	8	12	0	0	12	0	0
8	36976089	.	T	C	2	2	4	0	2	6	0	0
8	36976352	.	G	T	0	2	2	0	2	4	0	0
8	36976388	.	A	T	6	6	12	0	0	12	0	0
8	36976432	.	T	A	11	8	19	0	1	20	0	0
8	36976557	.	G	A	7	8	15	0	2	17	0	0
8	36976836	.	C	A	11	16	27	0	1	28	0	0
8	36977178	.	A	G	19	21	40	0	0	40	0	0
8	36977199	.	C	A	13	22	35	0	5	40	0	0
8	36977520	.	G	A	25	14	39	0	1	40	0	0
8	36977848	.	T	C	9	19	28	0	0	28	0	0
8	37007868	.	A	G	1	0	1	0	0	1	0	0
8	37012762	.	T	A	1	2	3	0	0	3	0	0
8	37012825	.	C	T	1	3	4	0	0	4	0	0
8	37014582	.	T	C	2	2	4	0	0	4	0	0
8	37016584	.	G	T	0	5	5	0	6	11	0	0
8	37016616	.	C	T	4	5	9	0	1	10	0	0
8	37016638	.	A	G	6	3	9	0	0	9	0	0
8	37016784	.	G	A	0	3	3	0	5	8	0	0
8	37016790	.	T	C	4	3	7	0	0	7	0	0
8	37017149	.	G	A	1	1	2	0	0	2	0	0
8	37017159	.	C	T	0	1	1	0	0	1	0	0
8	37019048	.	G	A	4	9	13	0	0	13	0	0
8	37019062	.	C	A	8	13	21	0	1	22	0	0
8	37025576	.	A	T	11	8	19	0	0	19	0	0
8	37025614	.	T	A	6	3	9	0	0	9	0	0
8	37025896	.	T	C	14	5	19	0	0	19	0	0
8	37026130	.	G	A	11	9	20	0	2	22	0	0
8	37059976	.	A	G	1	7	8	0	1	9	0	0
8	37060595	.	A	C	7	7	14	0	2	16	0	0
8	37060640	.	A	G	3	3	6	0	0	6	0	0
8	37232122	.	C	T	0	9	9	0	10	19	0	0
8	37232189	.	A	C	11	0	11	0	11	22	0	0
8	37232442	.	A	C	12	1	13	0	12	25	0	0
8	37232487	.	A	C	18	24	42	0	3	45	0	0
8	37239141	.	C	T	0	2	2	0	3	5	0	0
8	37241078	.	A	G	1	1	2	0	0	2	0	0
8	37242438	.	T	C	2	2	4	0	0	4	0	0
8	37280726	.	C	T	1	3	4	0	0	4	0	0
8	37280805	.	G	A	1	1	2	0	1	3	0	0
8	37280811	.	T	A	2	2	4	0	0	4	0	0
8	37280858	.	C	T	2	3	5	0	0	5	0	0
8	37281109	.	T	C	1	2	3	0	0	3	0	0
8	37447696	.	C	T	4	8	12	0	0	12	0	0
8	37453403	.	A	G	3	3	6	0	0	6	0	0
8	37456826	.	C	A	4	3	7	0	0	7	0	0
8	39816893	.	G	A	4	3	7	0	0	7	0	0
8	39819518	.	T	A	1	1	2	0	0	2	0	0
8	39848745	.	G	C	8	4	12	0	0	12	0	0
8	39848967	.	A	T	3	5	8	0	0	8	0	0
8	39849466	.	A	C	1	2	3	0	1	4	0	0
8	39849617	.	A	G	2	2	4	0	0	4	0	0
8	39849686	.	C	G	1	1	2	0	1	3	0	0
8	39849688	.	T	C	1	2	3	0	0	3	0	0
8	39849728	.	A	T	1	3	4	0	0	4	0	0
8	39849767	.	A	T	3	4	7	0	0	7	0	0
8	39849791	.	A	G	1	2	3	0	2	5	0	0
8	39850031	.	C	A	3	3	6	0	0	6	0	0
8	39850475	.	C	T	3	2	5	0	1	6	0	0
8	39850500	.	C	G	4	2	6	0	0	6	0	0
8	40234830	.	A	G	2	4	6	0	0	6	0	0
8	40234831	.	T	A	2	4	6	0	0	6	0	0
8	40235184	.	A	T	0	5	5	0	0	5	0	0
8	40235219	.	A	G	5	1	6	0	1	7	0	0
8	40235244	.	C	T	2	4	6	0	0	6	0	0
8	40235281	.	G	A	1	2	3	0	0	3	0	0
8	40235348	.	G	C	1	4	5	0	2	7	0	0
8	40235419	.	T	A	1	2	3	0	0	3	0	0
8	40237906	.	C	T	1	16	17	0	0	17	0	0
8	40240922	.	C	G	20	15	35	0	1	36	0	0
8	40241441	.	A	G	12	15	27	11	1	39	0	0
8	40241446	.	A	G	14	13	27	11	0	38	0	0
8	40241681	.	A	G	19	8	27	0	1	28	0	0
8	40241695	.	T	A	19	7	26	0	0	26	0	0
8	40242103	.	G	A	14	11	25	0	0	25	0	0
8	40242453	.	G	A	6	7	13	0	0	13	0	0
8	40242683	.	A	C	0	3	3	0	0	3	0	0
8	40243052	.	G	C	6	9	15	0	0	15	0	0
8	40248373	.	T	G	3	4	7	0	0	7	0	0
8	40248976	.	G	T	0	0	0	0	1	1	0	0
8	40254366	.	A	G	3	4	7	0	0	7	0	0
8	40254375	.	T	G	3	4	7	0	0	7	0	0
8	40325709	.	G	T	13	5	18	0	0	18	0	0
8	40326039	.	A	G	11	8	19	0	0	19	0	0
8	40326128	.	C	T	9	11	20	0	3	23	0	0
8	40326736	.	A	G	1	2	3	0	0	3	0	0
8	40427489	.	T	C	3	4	7	0	0	7	0	0
8	40427500	.	T	C	3	3	6	0	0	6	0	0
8	40427912	.	T	C	1	2	3	0	0	3	0	0
8	40632534	.	G	A	5	7	12	0	0	12	0	0
8	40633172	.	G	C	4	5	9	0	0	9	0	0
8	41462497	.	A	G	2	1	3	0	16	19	0	0
8	42642058	.	A	T	11	4	15	0	2	17	0	0
8	42642120	.	C	A	0	4	4	0	6	10	0	0
8	42642139	.	T	C	8	4	12	0	2	14	0	0
8	42642235	.	A	G	11	12	23	0	2	25	0	0
8	42642683	.	G	A	1	2	3	0	0	3	0	0
8	42642879	.	G	A	2	2	4	0	0	4	0	0
8	42642941	.	G	T	1	2	3	0	0	3	0	0
8	42650592	.	G	A	1	2	3	0	0	3	0	0
8	42689922	.	A	T	2	2	4	0	0	4	0	0
8	42689924	.	C	T	2	2	4	0	0	4	0	0
8	43379779	.	T	C	15	28	43	0	3	46	0	0
8	43380067	.	G	A	15	20	35	0	1	36	0	0
8	43380290	.	A	T	9	13	22	0	0	22	0	0
8	43380543	.	T	G	7	10	17	0	1	18	0	0
8	43380781	.	C	T	0	4	4	0	10	14	0	0
8	43380905	.	A	T	5	7	12	0	1	13	0	0
8	43380923	.	C	T	0	6	6	0	4	10	0	0
8	43381239	.	A	T	5	3	8	0	0	8	0	0
8	43381306	.	A	T	10	11	21	0	0	21	0	0
8	43381417	.	T	G	2	5	7	0	1	8	0	0
8	43381500	.	A	G	5	2	7	0	0	7	0	0
8	43382046	.	A	T	7	3	10	0	1	11	0	0
8	43386194	.	G	A	1	5	6	0	0	6	0	0
8	43393575	.	C	A	0	2	2	0	1	3	0	0
8	43400880	.	G	A	2	2	4	0	0	4	0	0
8	43668521	.	A	G	6	3	9	0	0	9	0	0
8	43668716	.	T	G	8	8	16	0	4	20	0	0
8	43671871	.	C	T	4	3	7	0	0	7	0	0
8	43934966	.	G	A	7	4	11	0	3	14	0	0
8	43935120	.	A	G	13	21	34	0	0	34	0	0
8	43935351	.	A	T	5	4	9	0	0	9	0	0
8	43935481	.	C	T	6	11	17	0	0	17	0	0
8	43935552	.	A	G	3	10	13	0	3	16	0	0
8	43935731	.	C	T	5	5	10	0	0	10	0	0
8	43935879	.	C	G	5	5	10	0	0	10	0	0
8	44296672	.	G	A	4	5	9	0	0	9	0	0
8	44296985	.	G	A	1	2	3	0	0	3	0	0
8	44297609	.	G	A	1	3	4	0	0	4	0	0
8	44602132	.	G	A	0	1	1	0	1	2	0	0
8	44602264	.	A	G	5	2	7	0	0	7	0	0
8	44617902	.	G	A	3	5	8	0	1	9	0	0
8	44617903	.	A	T	4	5	9	0	0	9	0	0
8	44618024	.	C	T	2	4	6	0	0	6	0	0
8	44695043	.	A	C	7	3	10	0	0	10	0	0
8	44695140	.	A	C	2	3	5	0	1	6	0	0
8	44695230	.	A	T	4	4	8	0	0	8	0	0
8	44894337	.	G	T	4	5	9	0	0	9	0	0
8	44894575	.	T	A	4	3	7	0	0	7	0	0
8	44894604	.	C	T	3	7	10	0	0	10	0	0
8	44894631	.	G	C	4	6	10	0	0	10	0	0
8	44897853	.	C	A	0	0	0	0	1	1	0	0
8	44923622	.	T	G	0	1	1	0	0	1	0	0
8	44975939	.	G	C	1	6	7	0	0	7	0	0
8	44976047	.	G	T	1	2	3	0	0	3	0	0
8	44976120	.	G	A	1	2	3	0	0	3	0	0
8	45298603	.	G	A	0	1	1	0	0	1	0	0
8	45308963	.	A	C	4	1	5	0	0	5	0	0
8	45311761	.	T	G	2	4	6	0	0	6	0	0
8	45313023	.	A	C	1	4	5	0	0	5	0	0
8	45315444	.	T	C	2	3	5	0	0	5	0	0
8	45317898	.	A	T	0	1	1	0	0	1	0	0
8	45317976	.	G	A	0	1	1	0	4	5	0	0
8	45325269	.	G	C	8	5	13	0	1	14	0	0
8	45328278	.	T	A	9	7	16	0	2	18	0	0
8	45361816	.	A	G	3	3	6	0	0	6	0	0
8	45365789	.	T	C	5	4	9	0	1	10	0	0
8	45374151	.	A	T	10	9	19	0	0	19	0	0
8	45374477	.	A	G	8	7	15	0	1	16	0	0
8	45374665	.	T	A	7	16	23	0	2	25	0	0
8	45374828	.	A	C	11	10	21	0	3	24	0	0
8	45374884	.	T	G	19	11	30	0	1	31	0	0
8	45374966	.	G	T	4	5	9	0	1	10	0	0
8	45374970	.	A	G	6	5	11	0	0	11	0	0
8	45392034	.	G	A	0	2	2	0	2	4	0	0
8	45395024	.	C	A	1	2	3	0	1	4	0	0
8	45395114	.	T	A	11	6	17	0	2	19	0	0
8	45395127	.	C	T	10	4	14	0	0	14	0	0
8	45396028	.	T	C	1	1	2	0	3	5	0	0
8	45427189	.	C	A	0	2	2	0	0	2	0	0
8	45428039	.	C	T	4	4	8	0	1	9	0	0
8	45430757	.	G	A	1	2	3	0	0	3	0	0
8	45755732	.	C	T	23	28	51	0	6	57	0	0
8	45755973	.	C	G	19	14	33	0	3	36	0	0
8	45759960	.	C	T	5	9	14	0	2	16	0	0
8	45763350	.	C	T	1	2	3	0	0	3	0	0
8	45763511	.	T	G	0	3	3	0	2	5	0	0
8	45763537	.	A	T	9	9	18	0	0	18	0	0
8	45763562	.	G	A	14	19	33	0	2	35	0	0
8	45763670	.	C	T	27	13	40	0	1	41	0	0
8	45763872	.	T	A	13	9	22	0	5	27	0	0
8	45763991	.	A	G	13	22	35	0	2	37	0	0
8	45764006	.	G	C	22	12	34	0	1	35	0	0
8	45764697	.	T	C	8	4	12	0	0	12	0	0
8	45764873	.	T	C	2	2	4	0	0	4	0	0
8	45764893	.	T	C	3	4	7	0	0	7	0	0
8	45765170	.	C	T	0	5	5	0	3	8	0	0
8	45765188	.	A	T	2	3	5	0	0	5	0	0
8	45765326	.	G	A	5	12	17	0	1	18	0	0
8	45772961	.	G	C	2	4	6	0	0	6	0	0
8	45797305	.	G	A	1	0	1	0	0	1	0	0
8	45853626	.	G	A	1	2	3	0	0	3	0	0
8	45944896	.	T	A	1	2	3	0	0	3	0	0
8	45944983	.	G	A	0	2	2	0	1	3	0	0
8	45948718	.	G	A	2	2	4	0	0	4	0	0
8	45952152	.	A	T	2	4	6	0	0	6	0	0
8	45952231	.	T	C	5	6	11	0	1	12	0	0
8	45952352	.	G	C	7	4	11	0	0	11	0	0
8	45952423	.	A	G	8	7	15	0	0	15	0	0
8	45952500	.	A	G	4	0	4	0	8	12	0	0
8	45961976	.	T	A	3	3	6	0	0	6	0	0
8	45961998	.	C	A	3	1	4	0	1	5	0	0
8	45962391	.	G	C	1	3	4	0	0	4	0	0
8	46010960	.	T	C	2	0	2	0	2	4	0	0
8	46014147	.	T	C	2	3	5	0	0	5	0	0
8	46077675	.	A	G	7	6	13	0	0	13	0	0
8	46077757	.	C	T	15	7	22	0	3	25	0	0
8	46077819	.	G	A	16	4	20	0	3	23	0	0
8	46077879	.	C	A	11	4	15	0	2	17	0	0
8	46078264	.	A	T	5	8	13	0	4	17	0	0
8	46078287	.	A	G	5	9	14	0	1	15	0	0
8	46078309	.	C	T	3	7	10	0	1	11	0	0
8	46078342	.	C	G	5	8	13	0	1	14	0	0
8	46085480	.	A	T	10	1	11	0	1	12	0	0
8	46089037	.	G	T	0	2	2	0	0	2	0	0
8	46089052	.	T	C	0	2	2	0	0	2	0	0
8	46089634	.	C	T	7	10	17	0	0	17	0	0
8	46123731	.	G	A	0	0	0	0	1	1	0	0
8	46348083	.	A	T	5	3	8	0	0	8	0	0
8	46348121	.	G	A	0	3	3	0	6	9	0	0
8	46348178	.	A	G	2	3	5	0	1	6	0	0
8	46353290	.	G	C	2	1	3	0	1	4	0	0
8	46356282	.	G	A	0	1	1	0	0	1	0	0
8	47947418	.	A	G	2	12	14	0	2	16	0	0
8	47947445	.	A	G	2	15	17	0	3	20	0	0
8	47948045	.	T	A	10	13	23	0	1	24	0	0
8	49722313	.	T	C	5	3	8	0	0	8	0	0
8	49728659	.	T	A	0	1	1	0	0	1	0	0
8	49745727	.	T	G	2	2	4	0	2	6	0	0
8	49746224	.	T	C	7	14	21	0	1	22	0	0
8	49746256	.	G	A	11	10	21	0	1	22	0	0
8	49746440	.	T	C	15	16	31	0	6	37	0	0
8	49746456	.	T	G	12	13	25	0	2	27	0	0
8	49755801	.	A	C	9	11	20	0	1	21	0	0
8	49755867	.	A	T	5	10	15	0	1	16	0	0
8	49756121	.	A	T	6	5	11	0	0	11	0	0
8	49759453	.	A	G	0	3	3	0	0	3	0	0
8	49769237	.	G	A	2	2	4	0	0	4	0	0
8	49769496	.	G	A	2	6	8	0	0	8	0	0
8	49864232	.	G	A	1	2	3	0	1	4	0	0
8	49864531	.	G	A	0	2	2	0	2	4	0	0
8	49865099	.	T	G	1	2	3	0	0	3	0	0
8	49912682	.	G	A	1	1	2	0	0	2	0	0
8	49969037	.	C	T	7	5	12	0	0	12	0	0
8	49969135	.	G	C	0	7	7	0	2	9	0	0
8	50170889	.	T	C	2	2	4	0	0	4	0	0
8	50179868	.	T	A	2	7	9	0	0	9	0	0
8	50179944	.	T	G	7	7	14	0	0	14	0	0
8	50520253	.	G	T	1	2	3	0	0	3	0	0
8	50818180	.	C	T	4	5	9	0	0	9	0	0
8	50838854	.	G	A	3	5	8	0	0	8	0	0
8	50849973	.	C	T	0	0	0	0	1	1	0	0
8	50890053	.	G	A	2	2	4	0	0	4	0	0
8	50890057	.	A	T	2	2	4	0	0	4	0	0
8	50890422	.	A	T	1	1	2	0	0	2	0	0
8	50947386	.	G	C	0	2	2	0	1	3	0	0
8	50947648	.	T	A	4	10	14	0	1	15	0	0
8	50948620	.	A	G	2	0	2	1	13	16	0	0
8	50948623	.	T	C	2	11	13	1	3	17	0	0
8	50949040	.	T	A	10	11	21	0	2	23	0	0
8	50949160	.	A	T	3	7	10	0	0	10	0	0
8	50949188	.	C	T	4	11	15	0	0	15	0	0
8	50949419	.	A	T	21	7	28	0	2	30	0	0
8	50949430	.	T	A	19	9	28	0	2	30	0	0
8	50949479	.	A	G	12	22	34	0	2	37	1	0
8	50949501	.	A	T	26	14	40	0	1	41	0	0
8	50949570	.	G	A	12	21	33	0	3	36	0	0
8	50949573	.	G	A	19	13	32	0	3	35	0	0
8	50949639	.	C	T	14	11	25	0	3	28	0	0
8	50949766	.	C	T	5	9	14	0	1	15	0	0
8	50960443	.	C	A	4	15	19	0	0	19	0	0
8	50960542	.	T	C	0	3	3	0	1	4	0	0
8	50962536	.	T	C	1	3	4	0	0	4	0	0
8	50967890	.	C	T	3	5	8	0	0	8	0	0
8	50969141	.	T	C	1	4	5	0	0	5	0	0
8	50969150	.	A	G	1	5	6	0	0	6	0	0
8	50969493	.	T	A	1	3	4	0	0	4	0	0
8	51165572	.	T	C	8	7	15	0	0	15	0	0
8	51165786	.	C	A	0	5	5	0	11	16	0	0
8	51173843	.	A	G	4	3	7	0	1	8	0	0
8	51308433	.	C	A	2	2	4	0	0	4	0	0
8	51309145	.	T	G	6	8	14	0	0	14	0	0
8	51309311	.	A	G	0	4	4	0	0	4	0	0
8	51314087	.	G	A	4	3	7	0	0	7	0	0
8	51325510	.	T	G	1	2	3	0	0	3	0	0
8	51351121	.	C	T	13	5	18	0	0	18	0	0
8	51351155	.	T	A	11	5	16	0	0	16	0	0
8	51351200	.	A	T	7	10	17	0	0	17	0	0
8	51352480	.	A	G	9	10	19	0	1	20	0	0
8	51352525	.	A	T	3	1	4	0	1	5	0	0
8	51358769	.	G	A	1	2	3	0	0	3	0	0
8	51367178	.	A	T	1	1	2	0	0	2	0	0
8	51367206	.	C	T	3	1	4	0	0	4	0	0
8	51367217	.	C	T	3	2	5	0	1	6	0	0
8	51367267	.	A	T	2	5	7	0	0	7	0	0
8	51431396	.	C	T	0	2	2	0	2	4	0	0
8	51576856	.	C	T	0	2	2	0	1	3	0	0
8	51576887	.	C	T	0	2	2	0	2	4	0	0
8	51576907	.	C	T	0	2	2	0	2	4	0	0
8	51782044	.	A	G	0	1	1	0	1	2	0	0
8	51935625	.	T	A	1	2	3	0	0	3	0	0
8	51992393	.	C	A	8	3	11	0	0	11	0	0
8	51992501	.	G	T	9	12	21	0	0	21	0	0
8	51996707	.	A	G	4	10	14	0	0	14	0	0
8	51996727	.	A	G	4	7	11	0	0	11	0	0
8	52002903	.	C	T	0	11	11	0	8	19	0	0
8	52002945	.	T	A	4	4	8	0	0	8	0	0
8	52005582	.	A	C	3	3	6	0	1	7	0	0
8	52006139	.	C	T	0	2	2	0	1	3	0	0
8	52010799	.	T	C	1	1	2	0	0	2	0	0
8	52012737	.	T	A	1	2	3	0	0	3	0	0
8	52015712	.	G	T	0	2	2	0	0	2	0	0
8	52016128	.	G	A	1	1	2	0	0	2	0	0
8	52030143	.	G	T	1	1	2	0	0	2	0	0
8	52107898	.	T	G	3	5	8	0	0	8	0	0
8	52108329	.	T	C	0	2	2	0	3	5	0	0
8	52109730	.	T	G	2	6	8	0	0	8	0	0
8	52342586	.	A	C	1	0	1	0	0	1	0	0
8	52348685	.	T	C	2	1	3	0	1	4	0	0
8	52349142	.	A	G	2	2	4	0	0	4	0	0
8	52349607	.	A	G	2	10	12	0	0	12	0	0
8	52350101	.	A	G	10	0	10	0	19	30	1	0
8	52350146	.	A	G	10	0	10	0	23	33	0	0
8	52350251	.	A	G	15	14	29	0	1	30	0	0
8	52350322	.	T	G	5	5	10	0	0	10	0	0
8	52408619	.	G	A	15	12	27	0	3	30	0	0
8	52411451	.	T	C	1	2	3	0	0	3	0	0
8	52412982	.	A	G	4	5	9	0	0	9	0	0
8	52412985	.	C	G	4	5	9	0	0	9	0	0
8	52528665	.	A	G	6	4	10	0	0	10	0	0
8	52528717	.	A	G	5	8	13	0	0	13	0	0
8	52529108	.	G	A	3	1	4	0	0	4	0	0
8	52529123	.	C	T	3	2	5	0	0	5	0	0
8	52529206	.	T	C	6	7	13	0	0	13	0	0
8	52529235	.	G	A	7	11	18	0	0	18	0	0
8	52529397	.	A	G	6	12	18	0	0	18	0	0
8	52529549	.	T	C	2	3	5	0	0	5	0	0
8	52547038	.	T	G	4	3	7	0	0	7	0	0
8	52547091	.	T	C	6	3	9	0	2	11	0	0
8	52547356	.	A	G	5	2	7	0	2	9	0	0
8	52547519	.	C	G	2	0	2	0	6	8	0	0
8	52547569	.	T	A	4	6	10	0	0	10	0	0
8	52547664	.	A	C	2	3	5	0	2	7	0	0
8	52547727	.	G	C	4	5	9	0	0	9	0	0
8	52547787	.	T	A	2	2	4	0	0	4	0	0
8	52547829	.	T	G	1	3	4	0	0	4	0	0
8	52550361	.	C	T	7	6	13	0	0	13	0	0
8	52550462	.	A	G	8	6	14	0	0	14	0	0
8	52554799	.	T	A	6	3	9	0	0	9	0	0
8	52555050	.	G	A	4	4	8	0	0	8	0	0
8	52555077	.	C	G	2	4	6	0	0	6	0	0
8	52555137	.	G	A	8	6	14	0	2	16	0	0
8	52559996	.	G	T	1	2	3	0	0	3	0	0
8	52560034	.	T	C	1	2	3	0	0	3	0	0
8	52560058	.	T	C	0	1	1	0	0	1	0	0
8	52561397	.	C	T	1	0	1	0	0	1	0	0
8	52561421	.	C	A	0	1	1	0	0	1	0	0
8	52563364	.	C	T	3	4	7	0	0	7	0	0
8	52565222	.	C	A	1	1	2	0	0	2	0	0
8	52565319	.	T	C	0	3	3	0	0	3	0	0
8	52580094	.	A	G	0	1	1	0	0	1	0	0
8	52630849	.	A	G	2	3	5	0	0	5	0	0
8	52630866	.	T	C	1	3	4	0	0	4	0	0
8	52713677	.	T	G	27	29	56	0	10	66	0	0
8	52713776	.	G	A	29	21	50	0	7	57	0	0
8	52713932	.	G	A	26	23	49	0	1	50	0	0
8	52713974	.	A	G	26	24	50	0	1	51	0	0
8	52713989	.	G	A	18	22	40	0	5	45	0	0
8	52714343	.	T	G	17	10	27	0	1	28	0	0
8	52715821	.	C	T	9	8	17	0	0	17	0	0
8	53398556	.	A	G	4	3	7	0	0	7	0	0
8	53398564	.	A	G	2	3	5	0	0	5	0	0
8	53401230	.	C	A	0	3	3	2	2	7	0	0
8	54220949	.	T	C	33	9	42	0	3	45	0	0
8	54221074	.	T	C	22	14	36	0	2	38	0	0
8	54221390	.	T	C	13	6	19	0	5	24	0	0
8	54303407	.	A	G	15	14	29	0	2	31	0	0
9	462959	.	T	G	8	3	11	0	4	15	0	0
9	529012	.	G	T	1	2	3	0	0	3	0	0
9	529628	.	C	G	2	2	4	0	0	4	0	0
9	529675	.	A	G	1	3	4	0	0	4	0	0
9	529849	.	G	A	0	2	2	0	2	4	0	0
9	529930	.	G	A	4	2	6	0	2	8	0	0
9	529957	.	C	T	1	3	4	0	0	4	0	0
9	531411	.	T	C	2	2	4	0	0	4	0	0
9	531432	.	A	T	2	3	5	0	0	5	0	0
9	531460	.	G	A	5	2	7	0	0	7	0	0
9	531629	.	G	A	4	3	7	0	0	7	0	0
9	585887	.	A	G	0	1	1	0	0	1	0	0
9	701934	.	T	C	0	1	1	0	0	1	0	0
9	704662	.	T	A	1	1	2	0	1	3	0	0
9	723428	.	T	A	0	1	1	0	0	1	0	0
9	724664	.	G	C	0	2	2	0	0	2	0	0
9	724670	.	A	C	0	1	1	0	0	1	0	0
9	732227	.	C	T	1	0	1	0	0	1	0	0
9	781460	.	A	C	1	2	3	0	0	3	0	0
9	781983	.	G	C	5	5	10	0	0	10	0	0
9	881735	.	A	T	4	2	6	0	0	6	0	0
9	881999	.	C	T	6	3	9	0	0	9	0	0
9	882143	.	T	C	5	0	5	0	11	16	0	0
9	901137	.	A	G	4	4	8	0	0	8	0	0
9	902265	.	T	C	0	0	0	0	1	1	0	0
9	902877	.	A	G	0	1	1	0	0	1	0	0
9	904118	.	A	T	3	6	9	0	0	9	0	0
9	907564	.	A	G	2	1	3	0	0	3	0	0
9	910882	.	C	T	4	5	9	0	2	11	0	0
9	913874	.	T	C	18	35	53	0	2	55	0	0
9	913882	.	C	T	18	36	54	0	3	57	0	0
9	913909	.	G	A	1	34	35	0	15	50	0	0
9	914097	.	G	T	4	3	7	0	0	7	0	0
9	914190	.	C	T	1	2	3	0	0	3	0	0
9	914445	.	T	C	2	2	4	0	1	5	0	0
9	914616	.	C	G	7	3	10	0	1	11	0	0
9	914675	.	C	T	9	3	12	0	0	12	0	0
9	914702	.	A	T	12	3	15	0	1	16	0	0
9	922715	.	A	G	5	3	8	0	0	8	0	0
9	1463287	.	T	C	2	1	3	0	1	4	0	0
9	1579792	.	T	C	7	8	15	0	0	15	0	0
9	1579894	.	T	C	1	3	4	0	0	4	0	0
9	1643427	.	T	G	4	1	5	0	0	5	0	0
9	1643451	.	C	T	0	1	1	0	4	5	0	0
9	1644349	.	T	C	5	4	9	0	0	9	0	0
9	1644531	.	C	T	1	2	3	0	0	3	0	0
9	1644564	.	T	G	2	2	4	0	1	5	0	0
9	1682740	.	G	C	0	7	7	0	8	15	0	0
9	1693082	.	A	C	15	7	22	0	1	23	0	0
9	1693092	.	G	A	13	9	22	0	1	23	0	0
9	1693443	.	G	A	13	8	21	0	2	23	0	0
9	1693494	.	T	G	15	12	27	0	1	28	0	0
9	1694277	.	A	G	3	1	4	0	0	4	0	0
9	2045265	.	G	A	5	3	8	0	0	8	0	0
9	2334164	.	C	T	2	1	3	0	0	3	0	0
9	2337291	.	C	T	2	2	4	0	0	4	0	0
9	2340561	.	G	A	5	2	7	0	0	7	0	0
9	2340564	.	G	A	4	3	7	0	1	8	0	0
9	2340618	.	C	T	24	18	42	0	3	45	0	0
9	2340776	.	C	T	36	30	66	0	1	68	1	0
9	2340964	.	G	A	37	14	51	0	1	52	0	0
9	2341035	.	T	C	18	21	39	0	1	40	0	0
9	2341053	.	T	C	15	16	31	0	1	32	0	0
9	2452697	.	T	C	2	7	9	0	0	9	0	0
9	2558355	.	G	T	4	3	7	0	0	7	0	0
9	2559138	.	C	T	4	3	7	0	0	7	0	0
9	2559640	.	A	T	1	3	4	0	0	4	0	0
9	2559856	.	A	C	3	8	11	0	0	11	0	0
9	2561135	.	C	T	1	1	2	0	1	3	0	0
9	2561182	.	A	G	1	2	3	0	1	4	0	0
9	2561322	.	T	A	1	2	3	0	1	4	0	0
9	2561604	.	C	T	10	16	26	0	1	27	0	0
9	2561632	.	A	T	13	12	25	0	0	25	0	0
9	2564178	.	C	A	11	13	24	0	3	27	0	0
9	2564699	.	A	G	7	3	10	0	1	11	0	0
9	2564788	.	A	T	1	3	4	0	0	4	0	0
9	2567323	.	G	A	5	2	7	0	0	7	0	0
9	2568670	.	T	A	6	4	10	0	2	12	0	0
9	2568768	.	G	T	5	3	8	0	1	9	0	0
9	2568777	.	C	T	3	5	8	0	1	9	0	0
9	2569372	.	T	G	1	3	4	0	0	4	0	0
9	2572316	.	G	A	3	2	5	0	0	5	0	0
9	2582003	.	G	A	0	2	2	0	1	3	0	0
9	2592246	.	C	T	15	12	27	0	1	28	0	0
9	2592933	.	T	C	1	2	3	0	0	3	0	0
9	2593260	.	C	G	1	2	3	0	0	3	0	0
9	3135171	.	T	C	0	0	0	0	4	4	0	0
9	3135809	.	A	G	1	0	1	0	1	2	0	0
9	3136107	.	C	T	0	1	1	0	0	1	0	0
9	3231378	.	C	A	0	6	6	0	0	6	0	0
9	3231396	.	C	G	2	5	7	0	0	7	0	0
9	3232180	.	T	A	1	3	4	0	0	4	0	0
9	3232198	.	C	T	1	4	5	0	0	5	0	0
9	3232523	.	T	G	3	5	8	0	1	9	0	0
9	3232607	.	T	A	2	6	8	0	1	9	0	0
9	3232672	.	C	T	4	4	8	0	0	8	0	0
9	3232763	.	T	C	4	2	6	0	0	6	0	0
9	3232949	.	A	G	3	6	9	0	0	9	0	0
9	3286386	.	G	A	1	0	1	0	0	1	0	0
9	3313920	.	G	T	11	12	23	0	2	25	0	0
9	3389921	.	A	G	5	0	5	0	9	14	0	0
9	3397648	.	A	C	3	5	8	0	1	9	0	0
9	3398243	.	T	A	1	4	5	0	1	6	0	0
9	3398247	.	G	A	1	5	6	0	1	7	0	0
9	3398328	.	C	A	0	4	4	0	4	8	0	0
9	3477113	.	T	G	0	2	2	0	0	2	0	0
9	3480057	.	A	G	0	3	3	0	0	3	0	0
9	3480076	.	C	T	0	2	2	0	0	2	0	0
9	3483164	.	T	C	3	2	5	0	0	5	0	0
9	3485822	.	G	A	0	3	3	0	2	5	0	0
9	3485867	.	A	T	1	0	1	0	0	1	0	0
9	3485868	.	T	C	1	0	1	0	0	1	0	0
9	3486134	.	T	G	2	5	7	0	0	7	0	0
9	3501269	.	A	G	1	3	4	0	0	4	0	0
9	3534748	.	G	A	0	2	2	0	0	2	0	0
9	3534947	.	C	T	2	2	4	0	0	4	0	0
9	3605652	.	C	T	2	2	4	0	1	5	0	0
9	3608867	.	T	A	12	8	20	0	0	20	0	0
9	3627189	.	T	C	1	1	2	0	0	2	0	0
9	3666541	.	A	C	13	19	32	0	0	32	0	0
9	3666601	.	A	T	17	7	24	0	2	26	0	0
9	3666666	.	T	C	11	17	28	0	4	32	0	0
9	3666947	.	G	A	3	2	5	0	0	5	0	0
9	3666948	.	T	C	1	0	1	0	4	5	0	0
9	3667136	.	G	A	6	8	14	0	1	15	0	0
9	3667377	.	C	A	12	5	17	0	1	18	0	0
9	3667398	.	C	A	13	4	17	0	1	18	0	0
9	3667572	.	A	C	2	2	4	0	0	4	0	0
9	3667575	.	T	C	1	3	4	0	0	4	0	0
9	3898275	.	T	C	3	8	11	0	3	14	0	0
9	3898276	.	T	C	2	0	2	0	12	14	0	0
9	3901007	.	A	T	2	2	4	0	0	4	0	0
9	3901081	.	C	T	1	8	9	0	0	9	0	0
9	3901118	.	A	C	1	7	8	0	0	8	0	0
9	3905921	.	G	A	0	2	2	0	1	3	0	0
9	4336585	.	T	C	2	0	2	0	0	2	0	0
9	5041315	.	T	A	2	2	4	0	0	4	0	0
9	5893773	.	C	T	1	5	6	0	0	6	0	0
9	6109544	.	A	G	1	0	1	0	1	2	0	0
9	6123490	.	G	T	3	3	6	0	1	7	0	0
9	6123742	.	A	C	2	2	4	0	0	4	0	0
9	6124759	.	T	A	4	2	6	0	2	8	0	0
9	6124761	.	T	G	3	4	7	0	1	8	0	0
9	6125859	.	T	A	2	7	9	0	0	9	0	0
9	6125901	.	T	G	1	6	7	0	0	7	0	0
9	6125927	.	G	A	1	6	7	0	0	7	0	0
9	6126074	.	T	A	6	3	9	0	1	10	0	0
9	6126288	.	A	C	7	7	14	0	0	14	0	0
9	6126410	.	G	A	6	8	14	0	3	17	0	0
9	6126469	.	G	A	6	5	11	0	1	12	0	0
9	6126781	.	T	G	7	18	25	0	2	27	0	0
9	6126900	.	C	T	2	11	13	0	0	13	0	0
9	6127075	.	G	A	0	27	27	0	24	51	0	0
9	6127346	.	C	A	22	8	30	0	3	33	0	0
9	6127357	.	C	T	20	16	36	0	1	37	0	0
9	6256541	.	G	A	0	4	4	0	4	8	0	0
9	6395679	.	C	G	11	12	23	0	1	24	0	0
9	6395713	.	G	A	7	7	14	0	1	15	0	0
9	6395792	.	T	A	12	7	19	0	2	21	0	0
9	6395957	.	C	T	2	4	6	0	0	6	0	0
9	6396181	.	G	A	4	8	12	0	1	13	0	0
9	6396235	.	A	G	6	6	12	0	2	14	0	0
9	6396242	.	G	A	5	6	11	0	1	12	0	0
9	6396354	.	A	G	1	3	4	0	0	4	0	0
9	6396477	.	A	G	1	2	3	0	0	3	0	0
9	6399610	.	A	G	0	1	1	0	0	1	0	0
9	6415385	.	G	A	1	1	2	0	0	2	0	0
9	7092403	.	T	C	7	1	8	0	5	13	0	0
9	7092424	.	T	C	7	8	15	0	0	15	0	0
9	7092457	.	T	C	13	6	19	0	1	20	0	0
9	7094141	.	T	C	5	3	8	0	1	9	0	0
9	7094142	.	T	C	6	2	8	0	1	9	0	0
9	7094349	.	A	G	0	2	2	0	0	2	0	0
9	7094357	.	T	C	2	0	2	0	1	3	0	0
9	7094898	.	T	C	6	3	9	0	0	9	0	0
9	7228348	.	C	A	15	18	33	0	0	33	0	0
9	7228487	.	C	A	3	4	7	0	1	8	0	0
9	7228544	.	C	T	2	2	4	0	0	4	0	0
9	7228805	.	T	A	11	3	14	0	0	14	0	0
9	7229053	.	G	A	4	10	14	0	2	16	0	0
9	7229069	.	G	A	8	3	11	0	1	12	0	0
9	7229210	.	C	T	10	9	19	0	1	20	0	0
9	7229218	.	G	A	9	9	18	0	1	19	0	0
9	7229248	.	G	A	7	5	12	0	1	13	0	0
9	7229262	.	C	G	8	10	18	0	2	20	0	0
9	7229512	.	C	T	7	10	17	0	1	18	0	0
9	7238498	.	C	T	2	3	5	0	0	5	0	0
9	7238502	.	C	A	2	3	5	0	0	5	0	0
9	7241118	.	G	A	0	4	4	0	2	6	0	0
9	7241159	.	G	A	2	2	4	0	3	7	0	0
9	7241257	.	C	G	3	2	5	0	0	5	0	0
9	7241409	.	G	T	1	4	5	0	0	5	0	0
9	7241809	.	C	T	0	3	3	0	2	5	0	0
9	7516034	.	G	T	3	2	5	0	0	5	0	0
9	7575309	.	G	A	1	0	1	0	0	1	0	0
9	7575545	.	A	C	0	1	1	0	0	1	0	0
9	7604524	.	G	A	4	2	6	0	0	6	0	0
9	7618903	.	A	C	7	6	13	0	0	13	0	0
9	7618906	.	T	C	7	8	15	0	1	16	0	0
9	7621877	.	C	T	1	2	3	0	0	3	0	0
9	8429899	.	A	G	11	5	16	0	2	18	0	0
9	8430558	.	A	C	4	3	7	0	1	8	0	0
9	8430787	.	A	G	3	3	6	0	0	6	0	0
9	8431031	.	A	G	9	3	12	0	0	12	0	0
9	8431214	.	C	T	0	4	4	0	1	5	0	0
9	8431256	.	G	A	3	5	8	0	0	8	0	0
9	8431345	.	A	C	2	0	2	0	3	5	0	0
9	8431362	.	G	T	3	2	5	0	1	6	0	0
9	8431382	.	T	C	2	2	4	0	0	4	0	0
9	8431541	.	A	T	3	2	5	0	0	5	0	0
9	8432768	.	A	T	2	5	7	0	0	7	0	0
9	8432996	.	G	A	5	3	8	0	0	8	0	0
9	8433189	.	C	T	0	2	2	0	0	2	0	0
9	8888388	.	A	G	2	1	3	0	1	4	0	0
9	8899665	.	C	T	0	2	2	0	1	3	0	0
9	8914657	.	G	C	0	1	1	0	0	1	0	0
9	8923188	.	A	T	7	9	16	0	0	16	0	0
9	8967442	.	G	A	12	21	33	0	1	34	0	0
9	8967459	.	C	T	19	12	31	0	6	37	0	0
9	8971713	.	G	A	8	11	19	0	0	19	0	0
9	8971984	.	T	G	9	0	9	0	18	27	0	0
9	8971995	.	A	C	6	8	14	0	8	22	0	0
9	8972429	.	T	A	13	9	22	0	1	23	0	0
9	8973080	.	G	A	3	3	6	0	0	6	0	0
9	8973093	.	C	T	1	3	4	0	0	4	0	0
9	8973227	.	T	C	4	2	6	0	0	6	0	0
9	8973379	.	T	G	3	3	6	0	1	7	0	0
9	8973627	.	C	A	3	2	5	0	0	5	0	0
9	8973629	.	G	A	3	2	5	0	0	5	0	0
9	9119830	.	A	T	2	3	5	0	0	5	0	0
9	9119877	.	G	A	2	2	4	0	0	4	0	0
9	9120271	.	T	C	2	3	5	0	1	6	0	0
9	9120517	.	A	T	3	3	6	0	0	6	0	0
9	9120847	.	G	A	4	6	10	0	1	11	0	0
9	9121242	.	T	C	7	4	11	0	0	11	0	0
9	9121382	.	G	A	5	7	12	0	2	14	0	0
9	9183874	.	C	T	10	12	22	0	0	22	0	0
9	9183969	.	T	A	18	19	37	0	0	37	0	0
9	9184092	.	G	A	19	18	37	0	0	37	0	0
9	9184177	.	G	A	25	17	42	0	2	44	0	0
9	9184397	.	G	A	10	9	19	0	1	20	0	0
9	9184488	.	G	A	7	9	16	0	2	18	0	0
9	9184536	.	T	C	15	11	26	0	1	27	0	0
9	9184566	.	G	A	14	13	27	0	0	27	0	0
9	9184593	.	T	C	12	12	24	0	1	25	0	0
9	9193044	.	A	C	3	1	4	0	0	4	0	0
9	9195964	.	C	T	2	1	3	0	0	3	0	0
9	9198139	.	A	G	0	1	1	0	0	1	0	0
9	9198202	.	A	C	2	5	7	0	0	7	0	0
9	9198208	.	G	A	1	4	5	0	1	6	0	0
9	9206612	.	C	G	0	1	1	0	0	1	0	0
9	9208714	.	C	A	1	1	2	0	0	2	0	0
9	9208759	.	A	T	1	3	4	0	1	5	0	0
9	9238577	.	G	A	1	3	4	0	2	6	0	0
9	9238583	.	G	A	1	4	5	0	1	6	0	0
9	9322733	.	G	A	2	5	7	0	0	7	0	0
9	9322782	.	C	G	0	6	6	0	3	9	0	0
9	9322795	.	A	G	2	6	8	0	0	8	0	0
9	9327705	.	C	T	1	2	3	0	0	3	0	0
9	9342892	.	C	T	1	4	5	0	0	5	0	0
9	9578598	.	G	T	19	20	39	0	1	40	0	0
9	9578936	.	T	G	19	10	29	0	2	31	0	0
9	9579027	.	C	A	24	17	41	0	4	45	0	0
9	9579033	.	T	C	17	0	17	0	28	45	0	0
9	9579076	.	G	C	8	13	21	0	1	22	0	0
9	9579165	.	C	T	10	13	23	0	4	27	0	0
9	9579297	.	G	C	8	7	15	0	0	15	0	0
9	9580103	.	G	A	2	7	9	0	0	9	0	0
9	9685440	.	G	A	0	2	2	0	1	3	0	0
9	9736317	.	G	T	7	7	14	0	2	16	0	0
9	9736406	.	C	A	5	4	9	0	1	10	0	0
9	9736436	.	G	T	5	6	11	0	3	14	0	0
9	9736727	.	A	G	1	3	4	0	0	4	0	0
9	9736815	.	T	A	4	7	11	0	1	12	0	0
9	9736870	.	T	G	1	8	9	0	0	9	0	0
9	9736918	.	G	C	3	3	6	0	0	6	0	0
9	9737060	.	T	G	2	4	6	0	0	6	0	0
9	9737219	.	C	G	2	5	7	0	0	7	0	0
9	9737248	.	G	A	1	4	5	0	0	5	0	0
9	9738325	.	A	T	1	2	3	0	1	4	0	0
9	9937808	.	T	C	0	1	1	0	0	1	0	0
9	9945569	.	G	C	2	2	4	0	0	4	0	0
9	9948145	.	C	T	0	3	3	0	1	4	0	0
9	9950013	.	C	T	3	3	6	0	0	6	0	0
9	10051935	.	T	A	1	4	5	0	1	6	0	0
9	10138338	.	G	A	4	3	7	0	0	7	0	0
9	10153091	.	C	T	2	3	5	0	0	5	0	0
9	10153342	.	T	A	8	2	10	0	1	11	0	0
9	10153590	.	A	C	13	6	19	0	3	22	0	0
9	10153606	.	A	G	9	12	21	0	1	22	0	0
9	10153689	.	G	C	9	5	14	0	2	16	0	0
9	10153705	.	A	T	6	11	17	0	1	18	0	0
9	10154013	.	G	T	7	9	16	0	1	17	0	0
9	10154014	.	C	T	6	8	14	0	3	17	0	0
9	10154195	.	A	T	2	2	4	0	1	5	0	0
9	10154344	.	T	A	3	2	5	0	0	6	1	0
9	10154461	.	C	T	5	3	8	0	0	8	0	0
9	11532306	.	A	G	0	2	2	0	1	3	0	0
9	11532307	.	C	A	1	2	3	0	0	3	0	0
9	11532682	.	T	C	4	1	5	0	2	7	0	0
9	11532775	.	A	G	1	3	4	0	0	4	0	0
9	11532826	.	T	C	4	4	8	0	0	8	0	0
9	11906956	.	A	G	2	5	7	0	1	8	0	0
9	11907445	.	C	T	2	4	6	0	0	6	0	0
9	11907497	.	G	A	2	2	4	0	0	4	0	0
9	12263071	.	T	C	2	2	4	0	0	4	0	0
9	12263245	.	T	A	2	2	4	0	0	4	0	0
9	12865947	.	C	A	2	2	4	0	0	4	0	0
9	12868364	.	G	A	3	4	7	0	1	8	0	0
9	12871592	.	T	A	0	0	0	0	1	1	0	0
9	12871640	.	G	A	0	3	3	0	0	3	0	0
9	12932313	.	A	G	1	0	1	0	0	1	0	0
9	12945508	.	G	A	1	2	3	0	0	3	0	0
9	12946824	.	A	G	0	2	2	0	1	3	0	0
9	12947217	.	A	G	1	4	5	0	0	5	0	0
9	12947414	.	G	A	2	3	5	0	0	5	0	0
9	12948021	.	G	A	1	2	3	0	0	3	0	0
9	12948656	.	A	G	2	3	5	0	0	5	0	0
9	12948753	.	G	C	2	2	4	0	0	4	0	0
9	12951293	.	G	A	0	2	2	0	1	3	0	0
9	14023493	.	T	A	1	2	3	0	0	3	0	0
9	14023856	.	A	G	1	2	3	0	0	3	0	0
9	14027874	.	T	A	3	3	6	0	0	6	0	0
9	14027889	.	A	G	2	3	5	0	0	5	0	0
9	14028114	.	T	C	3	1	4	0	1	5	0	0
9	14037508	.	C	G	4	4	8	0	2	10	0	0
9	14037569	.	T	C	2	7	9	0	1	10	0	0
9	14038176	.	C	A	4	5	9	0	1	10	0	0
9	14112784	.	T	A	4	8	12	0	2	14	0	0
9	14196978	.	A	T	2	2	4	0	0	4	0	0
9	14197063	.	A	G	1	5	6	0	1	7	0	0
9	14367775	.	C	T	5	11	16	0	2	18	0	0
9	14367837	.	T	G	8	18	26	0	1	27	0	0
9	14367878	.	C	T	16	16	32	0	3	35	0	0
9	14368350	.	T	C	7	5	12	0	1	13	0	0
9	14368378	.	A	T	9	6	15	0	1	16	0	0
9	14368590	.	G	A	7	4	11	0	0	11	0	0
9	14368676	.	A	G	3	5	8	0	0	8	0	0
9	14368788	.	T	C	8	6	14	0	0	14	0	0
9	14368892	.	C	T	5	4	9	0	1	10	0	0
9	14368988	.	G	A	7	5	12	0	2	14	0	0
9	14369084	.	G	A	5	4	9	0	0	9	0	0
9	14369150	.	T	A	0	9	9	0	3	12	0	0
9	14381060	.	G	A	2	0	2	0	0	2	0	0
9	16247916	.	C	T	1	2	3	0	1	4	0	0
9	18005806	.	A	G	11	5	16	0	0	16	0	0
9	18278324	.	A	G	1	5	6	0	1	7	0	0
9	19073997	.	T	A	3	2	5	0	0	5	0	0
9	20501589	.	C	T	2	2	4	0	0	4	0	0
9	24189198	.	A	G	4	2	6	0	1	7	0	0
9	24189407	.	A	G	8	3	11	0	1	12	0	0
9	25837206	.	A	T	1	3	4	0	1	5	0	0
9	27381934	.	A	C	1	0	1	0	0	1	0	0
9	27691970	.	A	G	2	4	6	0	0	6	0	0
9	27692005	.	C	A	4	2	6	0	1	7	0	0
9	27692325	.	A	G	4	2	6	0	1	7	0	0
9	27692329	.	G	T	5	3	8	0	0	8	0	0
9	27692699	.	C	G	0	4	4	0	2	6	0	0
9	27757831	.	C	T	1	2	3	0	0	3	0	0
9	27860734	.	C	T	0	9	9	0	10	19	0	0
9	27861293	.	C	G	0	5	5	0	3	8	0	0
9	27863828	.	G	T	3	3	6	0	0	6	0	0
9	27894656	.	T	C	3	2	5	0	1	6	0	0
9	28124661	.	G	A	3	2	5	0	0	5	0	0
9	28127471	.	A	G	9	8	17	0	3	20	0	0
9	28127513	.	A	C	13	5	18	0	1	19	0	0
9	28127532	.	A	C	14	5	19	0	1	20	0	0
9	28127706	.	C	G	15	10	25	0	3	28	0	0
9	28206684	.	C	T	4	2	6	0	0	6	0	0
9	28206692	.	A	G	4	2	6	0	0	6	0	0
9	28206947	.	A	T	2	2	4	0	0	4	0	0
9	28207033	.	C	T	2	2	4	0	0	4	0	0
9	28207339	.	T	A	2	7	9	0	0	9	0	0
9	28207392	.	T	A	4	5	9	0	0	9	0	0
9	28207647	.	C	T	0	2	2	0	2	4	0	0
9	28238302	.	C	T	5	0	5	0	1	6	0	0
9	28238305	.	C	T	0	2	2	0	6	8	0	0
9	28245874	.	G	A	1	3	4	0	1	5	0	0
9	28254633	.	C	T	2	5	7	0	0	7	0	0
9	28254783	.	C	T	0	5	5	0	3	8	0	0
9	28254810	.	G	A	3	2	5	0	0	5	0	0
9	28263971	.	C	T	2	6	8	0	0	8	0	0
9	28268543	.	G	A	0	2	2	0	0	2	0	0
9	28341330	.	C	A	0	5	5	0	10	15	0	0
9	28341382	.	G	A	10	8	18	0	2	20	0	0
9	28341591	.	C	A	12	22	34	0	2	36	0	0
9	28341593	.	T	A	15	19	34	0	2	36	0	0
9	28342963	.	G	A	2	3	5	0	0	5	0	0
9	28343054	.	G	A	4	3	7	0	2	9	0	0
9	28343100	.	A	G	2	4	6	0	0	6	0	0
9	28343121	.	T	G	1	4	5	0	0	5	0	0
9	28344126	.	A	C	1	2	3	0	0	3	0	0
9	28344320	.	T	G	4	2	6	0	0	6	0	0
9	28689032	.	G	A	2	3	5	0	0	5	0	0
9	28689033	.	C	A	2	3	5	0	0	5	0	0
9	28691645	.	T	C	3	2	5	0	0	5	0	0
9	28693734	.	A	T	1	2	3	0	0	3	0	0
9	28693737	.	C	T	0	1	1	0	1	2	0	0
9	28696610	.	A	C	3	5	8	0	0	8	0	0
9	28696643	.	A	G	1	0	1	0	0	1	0	0
9	28871367	.	A	T	3	6	9	0	0	9	0	0
9	28940998	.	G	A	16	17	33	0	1	34	0	0
9	28941003	.	T	C	15	0	15	0	16	31	0	0
9	28941061	.	A	C	12	10	22	0	1	23	0	0
9	28941179	.	A	G	8	8	16	0	0	16	0	0
9	28941189	.	G	A	9	6	15	0	0	15	0	0
9	28941414	.	A	G	11	14	25	0	2	27	0	0
9	28941446	.	A	G	13	16	29	0	3	32	0	0
9	28941488	.	T	A	19	10	29	0	0	29	0	0
9	28941498	.	C	G	16	8	24	0	2	26	0	0
9	28941629	.	G	A	6	5	11	0	1	12	0	0
9	28941630	.	G	A	6	5	11	0	1	12	0	0
9	28941684	.	C	G	2	5	7	0	1	8	0	0
9	28941709	.	G	C	1	4	5	0	1	6	0	0
9	28941723	.	A	G	1	3	4	0	0	4	0	0
9	28942018	.	G	A	0	4	4	0	1	5	0	0
9	28942542	.	T	A	5	12	17	0	0	17	0	0
9	28942553	.	T	A	4	11	15	0	0	15	0	0
9	28946132	.	A	T	2	3	5	0	0	5	0	0
9	28952959	.	G	A	1	4	5	0	0	5	0	0
9	29122231	.	T	G	7	8	15	0	1	16	0	0
9	29122536	.	T	A	6	7	13	0	2	15	0	0
9	29122849	.	A	G	2	6	8	0	0	8	0	0
9	29481518	.	T	C	5	6	11	0	1	12	0	0
9	29481708	.	A	G	1	2	3	0	0	3	0	0
9	29481732	.	A	G	1	5	6	0	0	6	0	0
9	29481795	.	T	C	4	2	6	0	0	6	0	0
9	29482135	.	T	A	1	2	3	0	0	3	0	0
9	29520819	.	A	G	9	5	14	0	4	18	0	0
9	29602959	.	T	C	0	1	1	0	0	1	0	0
9	29615087	.	C	G	28	15	43	0	3	46	0	0
9	29615238	.	T	A	12	13	25	0	1	26	0	0
9	29615575	.	C	T	15	16	31	0	0	31	0	0
9	29636837	.	C	A	6	2	8	0	0	8	0	0
9	29647469	.	G	A	9	13	22	0	1	23	0	0
9	29647470	.	C	T	9	11	20	0	3	23	0	0
9	29649571	.	C	A	25	28	53	0	1	54	0	0
9	29652546	.	T	C	2	1	3	0	2	5	0	0
9	29718559	.	T	C	5	2	7	0	0	7	0	0
9	29992332	.	G	A	1	6	7	0	0	7	0	0
9	30106009	.	G	A	4	3	7	0	0	7	0	0
9	30110217	.	T	C	3	3	6	0	0	6	0	0
9	30110930	.	C	T	4	2	6	0	0	6	0	0
9	30121155	.	C	A	4	7	11	0	0	11	0	0
9	30121167	.	C	T	2	5	7	0	1	8	0	0
9	30126136	.	A	G	6	0	6	0	4	10	0	0
9	30128084	.	C	G	32	15	47	0	3	50	0	0
9	30128085	.	C	T	31	16	47	0	3	50	0	0
9	30218140	.	C	T	2	3	5	0	0	5	0	0
9	30218310	.	G	A	3	4	7	0	0	7	0	0
9	30218323	.	A	G	4	4	8	0	0	8	0	0
9	30220931	.	C	T	1	3	4	0	0	4	0	0
9	30220968	.	T	A	2	8	10	0	0	10	0	0
9	30220975	.	C	T	2	8	10	0	0	10	0	0
9	30226160	.	T	C	1	0	1	0	5	6	0	0
9	30226583	.	T	C	0	0	0	0	4	4	0	0
9	30245731	.	A	G	3	2	5	0	0	5	0	0
9	30245756	.	C	A	11	4	15	0	0	15	0	0
9	30247941	.	A	G	3	3	6	0	0	6	0	0
9	30249039	.	C	T	0	3	3	0	3	6	0	0
9	30489813	.	A	G	2	2	4	0	0	4	0	0
9	30490949	.	G	T	5	4	9	0	0	9	0	0
9	30491053	.	T	C	1	4	5	0	0	5	0	0
9	30491560	.	C	T	0	2	2	0	1	3	0	0
9	30494498	.	C	G	0	3	3	0	3	6	0	0
9	30494839	.	A	G	3	4	7	0	0	7	0	0
9	30494854	.	T	A	3	2	5	0	0	5	0	0
9	30494965	.	G	A	2	5	7	0	0	7	0	0
9	30562659	.	A	G	2	3	5	0	0	5	0	0
9	30562689	.	A	T	2	3	5	0	0	5	0	0
9	30563056	.	C	T	1	2	3	0	0	3	0	0
9	30581779	.	G	C	2	2	4	0	0	4	0	0
9	30581942	.	C	T	3	1	4	0	0	4	0	0
9	31042584	.	T	C	1	0	1	0	0	1	0	0
9	31062518	.	T	A	15	6	21	0	1	22	0	0
9	31062588	.	G	A	18	9	27	0	4	31	0	0
9	31062589	.	G	A	19	9	28	0	3	31	0	0
9	31248923	.	C	T	0	5	5	0	1	6	0	0
9	31258832	.	G	A	9	8	17	1	0	18	0	0
9	31276912	.	C	T	12	7	19	0	0	19	0	0
9	31282487	.	A	T	4	2	6	0	0	6	0	0
9	31286397	.	A	T	1	2	3	0	0	3	0	0
9	31510724	.	T	A	1	2	3	0	0	3	0	0
9	31595634	.	C	T	5	2	7	0	1	8	0	0
9	32169182	.	A	G	8	5	13	0	0	13	0	0
9	32169287	.	G	A	12	16	28	0	2	30	0	0
9	32286804	.	C	G	10	3	13	0	0	13	0	0
9	32286858	.	C	T	13	5	18	0	1	19	0	0
9	32287162	.	A	G	11	13	24	0	0	24	0	0
9	32287208	.	A	C	17	23	40	0	2	43	1	0
9	32287481	.	T	C	20	9	29	0	0	29	0	0
9	32287688	.	A	G	9	3	12	0	1	13	0	0
9	32289064	.	C	A	0	9	9	0	17	26	0	0
9	32289281	.	G	A	6	4	10	0	0	10	0	0
9	32290957	.	G	A	0	2	2	0	0	2	0	0
9	32297472	.	T	C	3	2	5	0	0	5	0	0
9	32297487	.	C	T	4	3	7	0	0	7	0	0
9	32304476	.	G	A	10	6	16	0	0	16	0	0
9	32304655	.	A	G	1	3	4	0	0	4	0	0
9	32308523	.	A	C	2	0	2	0	0	2	0	0
9	32312472	.	C	T	25	25	50	0	2	52	0	0
9	32312683	.	C	A	13	20	33	0	2	35	0	0
9	32313260	.	T	C	6	5	11	0	1	12	0	0
9	32313626	.	C	T	1	2	3	0	1	4	0	0
9	32313875	.	G	T	2	2	4	0	0	4	0	0
9	32316733	.	T	C	2	2	4	0	1	5	0	0
9	32316788	.	G	T	4	2	6	0	0	6	0	0
9	32641131	.	T	A	6	9	15	0	2	17	0	0
9	32641175	.	T	G	13	13	26	0	0	26	0	0
9	32641278	.	A	T	10	13	23	0	0	23	0	0
9	32641294	.	G	T	11	16	27	0	1	28	0	0
9	32641424	.	G	A	9	6	15	0	1	16	0	0
9	32641442	.	G	C	10	7	17	0	1	18	0	0
9	32641548	.	T	A	4	7	11	0	1	12	0	0
9	32641600	.	A	G	4	9	13	0	0	13	0	0
9	32641682	.	A	G	7	9	16	0	0	16	0	0
9	32641731	.	C	A	7	4	11	0	1	12	0	0
9	32641737	.	A	G	8	4	12	0	1	13	0	0
9	32641802	.	T	C	4	7	11	0	1	12	0	0
9	32641805	.	A	G	5	7	12	0	0	12	0	0
9	32642342	.	A	G	2	4	6	0	0	6	0	0
9	32643643	.	G	A	0	0	0	0	1	1	0	0
9	32645615	.	G	C	3	4	7	0	1	8	0	0
9	32645939	.	T	C	0	2	2	0	0	2	0	0
9	32651334	.	C	T	1	0	1	0	0	1	0	0
9	32651826	.	T	C	1	3	4	0	0	4	0	0
9	32652059	.	A	G	2	0	2	0	5	7	0	0
9	32652072	.	T	C	2	3	5	0	2	7	0	0
9	32652129	.	C	T	2	3	5	0	0	5	0	0
9	32681877	.	A	C	0	3	3	0	0	3	0	0
9	32681880	.	A	C	0	3	3	0	0	3	0	0
9	32728896	.	G	C	8	4	12	0	0	12	0	0
9	32728969	.	A	G	10	6	16	0	1	17	0	0
9	32728984	.	C	A	5	3	8	0	2	10	0	0
9	32729022	.	T	C	2	3	5	0	0	5	0	0
9	32729072	.	G	A	1	4	5	0	1	6	0	0
9	32729183	.	T	G	1	3	4	0	0	4	0	0
9	32751640	.	A	G	6	15	21	0	1	22	0	0
9	32751812	.	A	G	11	6	17	0	1	18	0	0
9	32751825	.	C	T	11	8	19	0	1	20	0	0
9	32752094	.	T	A	11	3	14	0	0	14	0	0
9	32752272	.	C	T	9	14	23	0	0	23	0	0
9	32752555	.	C	T	3	2	5	0	0	5	0	0
9	32873064	.	T	C	1	1	2	0	0	2	0	0
9	32873834	.	A	T	4	3	7	0	0	7	0	0
9	32874222	.	T	G	4	3	7	0	2	9	0	0
9	32874603	.	G	A	0	5	5	0	9	14	0	0
9	32981252	.	C	T	5	3	8	0	1	9	0	0
9	32981302	.	C	T	6	6	12	0	0	12	0	0
9	32981317	.	T	C	6	6	12	0	0	12	0	0
9	33321034	.	G	A	1	2	3	0	0	3	0	0
9	33321038	.	C	A	1	2	3	0	0	3	0	0
9	33353581	.	C	T	14	3	17	0	3	20	0	0
9	33411227	.	C	A	1	0	1	0	0	1	0	0
9	33411228	.	A	G	1	0	1	0	0	1	0	0
9	33661399	.	A	G	17	7	24	0	2	26	0	0
9	33661424	.	G	A	14	9	23	0	1	24	0	0
9	33661645	.	A	T	8	5	13	0	0	13	0	0
9	33661691	.	A	T	4	4	8	0	0	8	0	0
9	33661714	.	G	A	4	4	8	0	0	8	0	0
9	33661765	.	C	T	5	5	10	0	0	10	0	0
9	33661773	.	A	C	5	5	10	0	0	10	0	0
9	33661939	.	T	A	6	4	10	0	0	10	0	0
9	33662043	.	A	G	1	2	3	0	0	3	0	0
9	33662134	.	C	T	2	3	5	0	1	6	0	0
9	33662158	.	A	G	2	6	8	0	0	8	0	0
9	33662175	.	T	G	1	6	7	0	0	7	0	0
9	33663300	.	G	A	7	4	11	0	0	11	0	0
9	33663331	.	A	G	7	3	10	0	0	10	0	0
9	33663455	.	A	G	1	3	4	0	0	4	0	0
9	33783800	.	A	T	9	9	18	0	0	18	0	0
9	33783822	.	T	A	18	12	30	0	1	31	0	0
9	33783852	.	A	G	29	9	38	0	1	39	0	0
9	33783956	.	T	C	31	25	56	0	2	58	0	0
9	33784689	.	T	G	6	5	11	0	1	12	0	0
9	33853510	.	A	G	2	0	2	0	6	8	0	0
9	33857776	.	C	T	2	0	2	0	0	2	0	0
9	33858088	.	G	A	7	3	10	0	0	10	0	0
9	33858111	.	T	C	6	3	9	0	0	9	0	0
9	33861813	.	A	T	7	3	10	0	1	11	0	0
9	34112699	.	T	A	1	2	3	0	0	3	0	0
9	34112981	.	T	C	5	3	8	0	1	9	0	0
9	34113008	.	A	T	3	5	8	0	0	8	0	0
9	34113140	.	G	A	5	3	8	0	0	8	0	0
9	34155005	.	T	G	1	1	2	0	0	2	0	0
9	34161749	.	G	A	2	4	6	0	0	6	0	0
9	34161933	.	C	T	2	7	9	0	1	10	0	0
9	34225055	.	A	G	2	4	6	0	1	7	0	0
9	34225316	.	G	C	2	6	8	0	0	8	0	0
9	34226884	.	G	A	19	25	44	0	3	47	0	0
9	34226888	.	G	A	1	27	28	0	19	47	0	0
9	34226960	.	A	C	15	25	40	0	0	40	0	0
9	34227016	.	A	T	9	17	26	0	1	27	0	0
9	34227020	.	C	G	10	17	27	0	1	28	0	0
9	34227054	.	C	T	10	14	24	0	0	24	0	0
9	34227074	.	C	A	9	11	20	0	1	21	0	0
9	34246473	.	G	A	8	3	11	0	0	11	0	0
9	34246524	.	G	A	11	11	22	0	0	22	0	0
9	34246555	.	T	G	15	11	26	0	0	26	0	0
9	34246628	.	G	A	4	8	12	0	1	13	0	0
9	34246710	.	G	A	5	7	12	0	3	15	0	0
9	34246932	.	A	G	8	6	14	0	1	15	0	0
9	34247356	.	G	A	1	1	2	0	0	2	0	0
9	34251632	.	G	A	2	1	3	0	0	3	0	0
9	34251707	.	C	G	6	3	9	0	1	10	0	0
9	34251963	.	A	G	2	2	4	0	0	4	0	0
9	34259406	.	T	A	1	2	3	0	0	3	0	0
9	34259418	.	T	A	2	2	4	0	0	4	0	0
9	34382946	.	A	T	2	2	4	0	1	5	0	0
9	34385396	.	A	G	4	0	4	0	7	11	0	0
9	34388882	.	G	A	6	9	15	0	0	15	0	0
9	34389077	.	T	C	4	6	10	0	0	10	0	0
9	34389101	.	C	G	4	5	9	0	0	9	0	0
9	34389288	.	T	G	7	11	18	0	2	20	0	0
9	34389427	.	C	T	15	22	37	0	2	39	0	0
9	34389602	.	A	G	15	0	15	0	25	40	0	0
9	34389666	.	A	G	18	22	40	0	1	41	0	0
9	34389701	.	A	T	18	19	37	0	0	37	0	0
9	34389704	.	G	C	15	18	33	0	4	37	0	0
9	34389743	.	G	T	17	19	36	0	0	36	0	0
9	34389748	.	A	C	18	20	38	0	1	39	0	0
9	34389791	.	A	G	12	15	27	0	0	27	0	0
9	34415308	.	T	C	2	6	8	0	0	8	0	0
9	34416575	.	A	T	1	2	3	0	0	3	0	0
9	34423397	.	C	A	7	5	12	0	2	14	0	0
9	34423415	.	T	A	10	6	16	0	0	16	0	0
9	34423468	.	T	A	9	4	13	0	0	13	0	0
9	34423474	.	A	G	9	1	10	0	5	15	0	0
9	34423593	.	G	T	1	2	3	0	0	3	0	0
9	34424121	.	T	G	1	2	3	0	0	3	0	0
9	34426197	.	T	C	1	1	2	0	0	2	0	0
9	34647415	.	A	G	6	0	6	0	5	11	0	0
9	34647427	.	A	C	7	3	10	0	0	11	1	0
9	34866888	.	C	T	2	3	5	0	0	5	0	0
9	34869945	.	G	A	1	1	2	0	0	2	0	0
9	34877315	.	G	A	1	2	3	0	0	3	0	0
9	34903218	.	T	G	21	20	41	0	2	43	0	0
9	34906337	.	C	G	18	20	38	0	2	40	0	0
9	34912626	.	A	T	3	6	9	0	0	9	0	0
9	34912695	.	T	C	2	0	2	0	2	4	0	0
9	34912895	.	T	A	5	6	11	0	0	11	0	0
9	34920395	.	G	A	5	6	11	0	1	12	0	0
9	34922898	.	A	G	2	0	2	0	0	2	0	0
9	34938795	.	C	T	12	8	20	0	1	21	0	0
9	34939336	.	A	G	2	5	7	0	0	7	0	0
9	34939800	.	T	C	0	3	3	0	1	4	0	0
9	34967565	.	A	G	2	4	6	0	0	6	0	0
9	34967647	.	C	T	3	2	5	0	1	6	0	0
9	34967649	.	C	T	3	2	5	0	1	6	0	0
9	34967733	.	A	G	3	4	7	0	0	7	0	0
9	34967743	.	A	C	2	3	5	0	0	5	0	0
9	34968005	.	A	G	2	3	5	0	0	5	0	0
9	35014847	.	C	G	0	1	1	0	0	1	0	0
9	35024459	.	G	C	0	5	5	0	6	11	0	0
9	35025183	.	C	T	7	10	17	0	1	18	0	0
9	35025243	.	A	T	8	7	15	0	0	15	0	0
9	35026418	.	G	T	2	4	6	0	1	7	0	0
9	35026736	.	T	A	28	29	57	0	2	59	0	0
9	35026941	.	T	C	31	21	52	0	5	57	0	0
9	35027262	.	A	G	24	28	52	0	5	57	0	0
9	35027309	.	T	C	27	0	27	0	24	51	0	0
9	35027333	.	A	G	29	15	44	0	6	50	0	0
9	35027365	.	G	T	28	11	39	0	2	41	0	0
9	35027371	.	G	T	29	12	41	0	4	45	0	0
9	35027402	.	G	A	26	15	41	0	1	42	0	0
9	35027549	.	T	G	28	20	48	0	0	48	0	0
9	35027705	.	G	A	16	2	18	0	0	19	1	0
9	35030977	.	G	A	14	10	24	0	0	24	0	0
9	35032640	.	A	G	2	0	2	0	0	2	0	0
9	35032643	.	A	G	2	0	2	0	0	2	0	0
9	35039175	.	T	C	1	3	4	0	0	4	0	0
9	35048839	.	G	C	1	4	5	0	0	5	0	0
9	35048840	.	A	C	1	4	5	0	0	5	0	0
9	35170671	.	G	A	6	3	9	0	0	9	0	0
9	35176030	.	A	G	6	6	12	0	0	12	0	0
9	35838477	.	T	A	9	6	15	0	0	15	0	0
9	35840713	.	G	A	3	2	5	0	0	5	0	0
9	35840782	.	T	C	4	4	8	0	0	8	0	0
9	35841279	.	G	T	2	5	7	0	3	10	0	0
9	35841282	.	A	G	4	6	10	0	0	10	0	0
9	35841663	.	G	T	4	9	13	0	0	13	0	0
9	35841879	.	T	A	10	6	16	0	1	17	0	0
9	35842164	.	T	A	18	8	26	0	0	26	0	0
9	35842209	.	G	T	12	9	21	0	0	21	0	0
9	35862299	.	G	A	2	2	4	0	0	4	0	0
9	35863132	.	C	T	3	8	11	0	0	11	0	0
9	35863555	.	T	C	4	7	11	0	0	11	0	0
9	35863603	.	T	C	6	5	11	0	0	11	0	0
9	35863798	.	C	T	8	8	16	0	2	18	0	0
9	35863968	.	A	T	9	6	15	0	3	18	0	0
9	35864155	.	A	T	6	5	11	0	0	11	0	0
9	35864210	.	C	T	8	4	12	0	0	12	0	0
9	35864266	.	C	A	5	4	9	0	1	10	0	0
9	35864277	.	C	T	5	3	8	0	0	8	0	0
9	35864486	.	C	T	2	0	2	0	0	2	0	0
9	35864565	.	A	G	2	1	3	0	0	3	0	0
9	35864598	.	C	T	4	2	6	0	0	6	0	0
9	35865073	.	C	T	16	16	32	0	4	36	0	0
9	35865162	.	G	T	12	11	23	0	2	25	0	0
9	35865270	.	C	G	13	20	33	0	2	35	0	0
9	35872927	.	G	A	4	5	9	0	0	9	0	0
9	35872942	.	G	A	5	4	9	0	0	9	0	0
9	35872993	.	A	T	5	2	7	0	1	8	0	0
9	35901654	.	T	A	0	1	1	0	0	1	0	0
9	35915548	.	C	T	2	4	6	0	0	6	0	0
9	35915557	.	G	A	0	4	4	0	2	6	0	0
9	35916518	.	T	G	0	1	1	0	0	1	0	0
9	35922046	.	T	G	16	17	33	0	0	33	0	0
9	35922115	.	T	C	4	8	12	0	4	16	0	0
9	36426844	.	G	C	1	2	3	0	0	3	0	0
9	36656011	.	A	G	1	0	1	0	0	1	0	0
9	36973147	.	T	C	1	3	4	0	0	4	0	0
9	36973898	.	A	G	2	2	4	0	1	5	0	0
9	36974170	.	G	T	2	2	4	0	0	4	0	0
9	36974191	.	T	C	1	2	3	0	0	3	0	0
9	36974460	.	C	T	2	2	4	0	0	4	0	0
9	37296124	.	A	G	4	2	6	0	0	6	0	0
9	37341551	.	T	C	3	2	5	0	0	5	0	0
9	37341554	.	T	C	3	2	5	0	0	5	0	0
9	37341614	.	T	C	0	2	2	0	0	2	0	0
9	37451609	.	T	G	2	2	4	0	0	4	0	0
9	37451809	.	A	G	3	3	6	0	0	6	0	0
9	37452012	.	A	T	6	5	11	0	0	11	0	0
9	37452223	.	C	T	5	4	9	0	1	10	0	0
9	37452432	.	G	A	4	15	19	0	1	20	0	0
9	37452499	.	T	G	9	8	17	0	0	17	0	0
9	37452515	.	G	T	8	10	18	0	0	18	0	0
9	37452616	.	T	G	19	7	26	0	1	27	0	0
9	37452819	.	G	C	11	4	15	0	1	16	0	0
9	37452862	.	T	C	14	5	19	0	0	19	0	0
9	37452924	.	C	G	13	13	26	0	0	26	0	0
9	37853970	.	A	C	0	1	1	0	1	2	0	0
9	37856541	.	C	T	2	3	5	0	1	6	0	0
9	37859807	.	G	T	1	2	3	0	0	3	0	0
9	37859881	.	T	G	10	6	16	0	4	20	0	0
9	37860116	.	T	C	2	2	4	0	1	5	0	0
9	37861392	.	T	G	0	1	1	0	2	3	0	0
9	37861458	.	T	G	2	4	6	0	0	6	0	0
9	37861468	.	A	G	1	3	4	0	0	4	0	0
9	37861834	.	G	A	2	4	6	0	0	6	0	0
9	37861844	.	G	A	3	4	7	0	0	7	0	0
9	37862065	.	T	G	3	0	3	0	9	13	1	0
9	37862193	.	G	A	0	3	3	0	1	4	0	0
9	38030131	.	A	T	11	10	21	0	2	23	0	0
9	38030366	.	A	T	5	9	14	0	0	14	0	0
9	38030503	.	C	T	0	3	3	0	1	4	0	0
9	38030574	.	G	A	3	7	10	0	2	12	0	0
9	38033578	.	A	G	0	3	3	0	0	3	0	0
9	38063688	.	C	A	0	1	1	0	1	2	0	0
9	38063689	.	C	A	1	1	2	0	0	2	0	0
9	38063858	.	T	C	2	3	5	0	0	5	0	0
9	38063859	.	T	A	2	3	5	0	0	5	0	0
9	38064165	.	A	T	2	3	5	0	0	5	0	0
9	38064268	.	T	C	1	2	3	0	1	4	0	0
9	38064420	.	T	G	2	4	6	0	0	6	0	0
9	38064421	.	C	A	2	4	6	0	0	6	0	0
9	38140963	.	C	A	0	2	2	0	2	4	0	0
9	38161842	.	C	T	6	3	9	0	0	9	0	0
9	38161905	.	G	A	1	2	3	0	1	4	0	0
9	38161975	.	T	G	1	1	2	0	1	3	0	0
9	38273264	.	T	A	1	2	3	0	0	3	0	0
9	38277513	.	A	G	0	1	1	0	0	1	0	0
9	38278121	.	A	G	1	0	1	0	0	1	0	0
9	38278289	.	C	T	2	3	5	0	0	5	0	0
9	38278301	.	T	C	2	3	5	0	0	5	0	0
9	38278337	.	T	C	1	2	3	0	0	3	0	0
9	38283647	.	G	A	3	3	6	0	0	6	0	0
9	38283659	.	C	T	3	2	5	0	0	5	0	0
9	38285598	.	A	G	1	3	4	0	0	4	0	0
9	38286823	.	G	A	1	7	8	0	0	8	0	0
9	38290165	.	C	T	8	9	17	0	1	18	0	0
9	38290210	.	A	G	6	7	13	0	2	15	0	0
9	38290220	.	T	G	5	0	5	0	8	13	0	0
9	38290245	.	C	T	5	4	9	0	2	11	0	0
9	38290414	.	A	G	13	6	19	0	1	20	0	0
9	38290777	.	G	T	0	11	11	0	17	28	0	0
9	38290959	.	A	C	17	21	38	0	2	40	0	0
9	38291439	.	G	T	21	17	38	0	1	39	0	0
9	38291616	.	C	T	19	12	31	0	1	32	0	0
9	38291737	.	C	A	4	10	14	0	7	21	0	0
9	38308512	.	G	A	0	1	1	0	1	2	0	0
9	38315128	.	T	G	2	2	4	0	0	4	0	0
9	38353794	.	T	C	7	9	16	0	2	18	0	0
9	38354000	.	T	C	4	3	7	0	0	7	0	0
9	38354224	.	A	G	2	0	2	0	0	2	0	0
9	38354689	.	G	A	2	0	2	0	0	2	0	0
9	38359737	.	G	A	0	1	1	0	0	1	0	0
9	38360102	.	C	T	0	2	2	0	0	2	0	0
9	38362354	.	G	A	2	0	2	0	0	2	0	0
9	38388017	.	G	A	2	2	4	0	0	4	0	0
9	38388151	.	T	A	1	3	4	0	0	4	0	0
9	38388492	.	C	T	8	3	11	0	1	12	0	0
9	38388493	.	C	T	3	3	6	0	6	12	0	0
9	38388703	.	T	C	8	3	11	0	3	14	0	0
9	38389026	.	T	A	2	2	4	0	1	5	0	0
9	38389194	.	C	T	5	9	14	0	0	14	0	0
9	38389263	.	T	A	9	4	13	0	3	16	0	0
9	38389426	.	G	A	8	13	21	0	3	24	0	0
9	38389603	.	A	G	10	0	10	0	6	16	0	0
9	38389616	.	C	T	10	5	15	0	0	15	0	0
9	38389644	.	A	T	7	8	15	0	1	16	0	0
9	38389722	.	G	T	10	3	13	0	2	15	0	0
9	38389746	.	T	C	11	5	16	0	2	18	0	0
9	38389886	.	C	T	3	11	14	0	0	14	0	0
9	38405238	.	A	G	3	2	5	0	0	5	0	0
9	38418864	.	T	C	3	2	5	0	0	5	0	0
9	38433354	.	C	A	1	2	3	0	1	4	0	0
9	38456091	.	A	C	2	0	2	0	0	2	0	0
9	38456111	.	T	C	2	0	2	0	0	2	0	0
9	38476748	.	G	A	1	2	3	0	0	3	0	0
9	38476780	.	G	C	1	2	3	0	0	3	0	0
9	38476810	.	T	G	1	2	3	0	0	3	0	0
9	38478643	.	A	T	4	2	6	0	0	6	0	0
9	38481034	.	G	A	1	3	4	0	0	4	0	0
9	38497393	.	C	T	1	2	3	0	0	3	0	0
9	38620058	.	C	T	7	5	12	0	2	14	0	0
9	38620308	.	C	A	3	3	6	0	0	6	0	0
9	38620673	.	A	G	14	9	23	0	3	26	0	0
9	38639799	.	T	C	1	5	6	0	1	7	0	0
9	38639846	.	C	T	2	5	7	0	0	7	0	0
9	38639999	.	C	T	5	3	8	0	0	8	0	0
9	38640186	.	T	C	2	4	6	0	0	6	0	0
9	38640193	.	T	C	2	3	5	0	0	5	0	0
9	38640598	.	A	G	3	0	3	0	8	11	0	0
9	38640773	.	A	T	2	5	7	0	0	7	0	0
9	38641111	.	C	T	12	6	18	0	0	18	0	0
9	38641196	.	C	G	1	3	4	0	0	4	0	0
9	38765158	.	C	T	1	1	2	0	0	2	0	0
9	40928199	.	T	C	5	4	9	0	0	9	0	0
9	40928245	.	T	C	12	7	19	0	1	20	0	0
9	41479980	.	A	G	2	3	5	0	0	5	0	0
9	41679298	.	A	C	4	2	6	0	1	7	0	0
9	41679615	.	A	T	1	1	2	0	1	3	0	0
9	41680441	.	A	G	19	6	25	0	1	26	0	0
9	41680578	.	A	G	29	11	40	0	1	41	0	0
9	41680581	.	A	G	22	18	40	0	1	41	0	0
9	42360893	.	C	T	0	2	2	0	0	2	0	0
9	42649583	.	A	G	4	2	6	0	0	6	0	0
9	42649636	.	T	A	3	2	5	0	0	5	0	0
9	42649653	.	T	C	4	2	6	0	1	7	0	0
9	42649739	.	C	T	8	7	15	0	0	15	0	0
9	42649743	.	A	G	6	7	13	0	2	15	0	0
9	42649923	.	A	G	7	4	11	0	1	12	0	0
9	42653475	.	A	T	3	2	5	0	0	5	0	0
9	43082319	.	T	A	0	2	2	0	0	2	0	0
9	43082373	.	A	T	3	2	5	0	0	5	0	0
9	43082398	.	A	G	5	2	7	0	0	7	0	0
9	43082541	.	A	C	0	2	2	0	1	3	0	0
9	43082717	.	T	G	1	2	3	0	0	3	0	0
9	43082729	.	G	A	3	2	5	0	0	5	0	0
9	43085369	.	G	T	2	2	4	0	0	4	0	0
9	43085471	.	G	C	2	2	4	0	1	5	0	0
9	43085527	.	A	T	4	2	6	0	0	6	0	0
9	43085949	.	A	C	2	1	3	0	1	4	0	0
9	43150018	.	T	A	3	12	15	0	1	16	0	0
9	43150278	.	T	G	9	10	19	0	3	22	0	0
9	43150604	.	A	G	12	7	19	0	2	21	0	0
9	43150817	.	C	T	0	15	15	0	7	22	0	0
9	43153287	.	C	T	3	2	5	0	1	6	0	0
9	43154841	.	C	T	2	2	4	0	0	4	0	0
9	43243265	.	A	C	2	2	4	0	0	4	0	0
9	43243266	.	T	C	2	2	4	0	0	4	0	0
9	43552604	.	C	A	7	6	13	0	0	13	0	0
9	43552687	.	A	C	12	9	21	0	0	21	0	0
9	43553036	.	G	T	5	19	24	0	2	26	0	0
9	43559501	.	A	C	3	10	13	0	1	14	0	0
9	43612482	.	T	G	1	3	4	0	0	4	0	0
9	43617899	.	A	G	1	0	1	0	0	1	0	0
9	43617962	.	A	G	0	4	4	0	1	5	0	0
9	44080411	.	C	T	4	3	7	0	0	7	0	0
9	44097854	.	C	T	0	1	1	0	1	2	0	0
9	44109260	.	A	G	1	2	3	0	0	3	0	0
9	44109589	.	T	C	1	0	1	0	3	4	0	0
9	44292285	.	A	C	24	0	24	0	31	55	0	0
9	44292737	.	T	C	25	24	49	0	2	51	0	0
9	44292909	.	C	T	0	30	30	0	24	54	0	0
9	44293488	.	C	T	9	9	18	0	4	22	0	0
9	44294792	.	A	G	1	2	3	0	0	3	0	0
9	44485958	.	G	A	0	6	6	0	15	21	0	0
9	44485964	.	G	A	0	5	5	0	16	21	0	0
9	44488578	.	T	A	3	3	6	0	0	6	0	0
9	44488620	.	G	A	0	0	0	0	1	1	0	0
9	44489843	.	G	A	0	7	7	0	8	15	0	0
9	44489844	.	T	A	8	7	15	0	0	15	0	0
9	44526546	.	G	A	0	1	1	0	0	1	0	0
9	45551273	.	T	C	7	9	16	1	2	19	0	0
9	45552266	.	A	T	14	9	23	0	0	23	0	0
9	45552338	.	T	G	3	16	19	0	1	20	0	0
9	45552364	.	G	A	0	9	9	0	3	12	0	0
9	45552386	.	C	G	6	12	18	0	0	18	0	0
9	45552567	.	G	A	0	16	16	0	13	29	0	0
9	45552715	.	C	T	20	12	32	0	2	34	0	0
9	45552806	.	G	A	0	21	21	0	16	37	0	0
9	45552881	.	T	C	19	17	36	0	0	36	0	0
9	45552924	.	C	A	10	13	23	0	1	24	0	0
9	45552957	.	C	T	12	13	25	0	2	28	1	0
9	46692261	.	T	G	20	24	44	0	4	48	0	0
9	46821464	.	C	T	5	3	8	0	1	9	0	0
9	46821853	.	G	A	2	4	6	0	1	7	0	0
9	46821855	.	G	T	3	4	7	0	0	7	0	0
9	46821905	.	A	G	3	5	8	0	0	8	0	0
9	46821916	.	A	T	4	3	7	0	2	9	0	0
9	46823198	.	C	T	8	5	13	0	2	15	0	0
9	46823325	.	G	A	0	4	4	0	0	4	0	0
9	46823366	.	T	C	4	4	8	0	0	8	0	0
9	46823524	.	A	G	0	2	2	0	0	2	0	0
9	46824110	.	A	G	1	3	4	0	0	4	0	0
9	48054753	.	G	A	8	6	14	0	2	16	0	0
9	48060592	.	G	C	8	2	10	0	0	10	0	0
9	48076973	.	C	T	3	3	6	0	1	7	0	0
9	48123142	.	G	A	3	2	5	0	0	5	0	0
9	48123222	.	G	C	1	3	4	0	1	5	0	0
9	48127200	.	G	A	1	0	1	0	0	1	0	0
9	48128027	.	G	T	0	2	2	0	2	4	0	0
9	48131637	.	T	A	5	3	8	0	0	8	0	0
9	48131814	.	A	T	5	4	9	0	2	11	0	0
9	48131865	.	G	A	2	3	5	0	1	6	0	0
9	48131883	.	A	G	2	2	4	0	1	5	0	0
9	48131956	.	G	A	5	3	8	0	0	8	0	0
9	48131997	.	C	T	1	5	6	0	3	9	0	0
9	48132029	.	T	C	4	0	4	0	7	11	0	0
9	48132037	.	T	A	4	8	12	0	0	12	0	0
9	48132095	.	A	C	7	13	20	0	1	21	0	0
9	48132156	.	A	C	3	7	10	0	0	10	0	0
9	48132176	.	C	T	3	6	9	0	0	9	0	0
9	48132194	.	G	T	3	5	8	0	0	8	0	0
9	48132309	.	G	T	2	2	4	0	1	5	0	0
9	48132336	.	C	T	0	2	2	0	4	6	0	0
9	48132439	.	G	A	3	8	11	0	0	11	0	0
9	48132441	.	A	G	4	7	11	0	0	11	0	0
9	48132592	.	G	T	3	4	7	0	0	7	0	0
9	48133105	.	G	T	3	5	8	0	0	8	0	0
9	48133687	.	A	G	1	3	4	0	0	4	0	0
9	48134351	.	G	A	4	3	7	0	0	7	0	0
9	48134568	.	G	A	1	4	5	0	4	9	0	0
9	48134678	.	A	T	6	2	8	0	0	8	0	0
9	48186519	.	C	A	1	5	6	0	0	6	0	0
9	48226057	.	A	G	2	1	3	0	0	3	0	0
9	48226073	.	A	G	1	1	2	0	0	2	0	0
9	48227847	.	T	A	1	2	3	0	0	3	0	0
9	48227885	.	T	G	2	5	7	0	0	7	0	0
9	48227953	.	T	C	1	1	2	0	0	2	0	0
9	48229074	.	T	C	2	1	3	0	0	3	0	0
9	48230669	.	C	T	4	3	7	0	0	7	0	0
9	48267159	.	C	T	2	3	5	0	0	5	0	0
9	48267190	.	A	T	2	4	6	0	1	7	0	0
9	48284901	.	T	C	8	10	18	0	2	20	0	0
9	48284917	.	C	A	0	13	13	0	10	23	0	0
9	48284972	.	T	C	7	10	17	0	1	18	0	0
9	48285019	.	G	A	0	1	1	0	0	1	0	0
9	48286702	.	G	A	1	3	4	0	0	4	0	0
9	48287441	.	G	A	1	2	3	0	0	3	0	0
9	48289797	.	A	T	1	0	1	0	0	1	0	0
9	48670395	.	A	C	1	3	4	0	0	4	0	0
9	48670454	.	T	G	1	3	4	0	0	4	0	0
9	48670660	.	G	A	0	3	3	0	3	6	0	0
9	48671052	.	A	G	1	2	3	0	0	3	0	0
9	48671167	.	A	C	4	4	8	0	1	9	0	0
9	48706302	.	C	T	2	4	6	0	0	6	0	0
9	48706305	.	C	T	2	2	4	0	1	5	0	0
9	48870578	.	T	C	11	0	11	0	12	23	0	0
9	48870593	.	A	T	13	12	25	0	0	25	0	0
9	48870627	.	T	A	12	6	18	0	1	19	0	0
9	48870680	.	A	G	5	2	7	0	0	7	0	0
9	48870886	.	C	T	11	8	19	0	0	19	0	0
9	48871080	.	G	C	8	4	12	0	2	14	0	0
9	48871109	.	A	T	6	5	11	0	0	11	0	0
9	48871966	.	T	G	4	3	7	0	0	7	0	0
9	48872039	.	C	G	0	4	4	0	0	4	0	0
9	48872050	.	C	T	0	4	4	0	0	4	0	0
9	48872688	.	A	T	2	2	4	0	0	4	0	0
9	48872694	.	A	G	2	1	3	0	0	3	0	0
9	48872890	.	C	A	4	3	7	0	0	7	0	0
9	48872924	.	A	G	2	2	4	0	1	5	0	0
9	48872926	.	C	T	0	3	3	0	2	5	0	0
9	48873371	.	A	G	1	1	2	0	1	3	0	0
9	50755144	.	A	T	1	2	3	0	0	3	0	0
9	51429469	.	A	C	0	0	0	0	3	3	0	0
9	51430737	.	C	T	0	2	2	0	5	7	0	0
9	51430767	.	T	A	2	5	7	0	0	7	0	0
9	51430886	.	G	C	2	2	4	0	1	5	0	0
9	51431179	.	C	G	16	8	24	0	3	27	0	0
9	51431642	.	A	C	7	1	8	0	6	14	0	0
9	51432279	.	T	G	2	3	5	0	0	5	0	0
9	51432381	.	C	T	0	2	2	0	2	4	0	0
9	51996212	.	A	T	11	6	17	0	0	17	0	0
9	51996246	.	C	T	0	7	7	0	10	17	0	0
9	51996280	.	T	A	17	7	24	0	0	24	0	0
9	51996281	.	G	A	16	7	23	0	1	24	0	0
9	51996444	.	T	G	12	12	24	0	2	26	0	0
9	51996469	.	C	T	0	13	13	0	13	26	0	0
9	51996868	.	T	A	0	1	1	0	0	1	0	0
9	51996876	.	A	G	2	1	3	0	0	3	0	0
9	52378682	.	C	T	21	10	31	0	0	31	0	0
9	52378697	.	A	G	19	19	38	0	0	38	0	0
9	52378832	.	T	A	10	16	26	0	0	26	0	0
9	52435058	.	G	C	1	3	4	0	0	4	0	0
9	52435100	.	G	A	0	2	2	0	0	2	0	0
9	52435112	.	C	T	0	1	1	0	0	1	0	0
9	52439166	.	G	A	0	1	1	0	0	1	0	0
9	52492705	.	A	G	1	2	3	0	0	3	0	0
9	52539290	.	G	A	0	1	1	0	1	2	0	0
9	52539453	.	C	T	6	8	14	0	1	15	0	0
9	52539629	.	C	T	6	3	9	0	0	9	0	0
9	52564622	.	T	C	0	1	1	0	0	1	0	0
9	53276976	.	C	T	4	2	6	0	0	6	0	0
9	53276978	.	A	G	2	4	6	0	0	6	0	0
9	53277068	.	C	G	3	0	3	0	5	8	0	0
9	53277131	.	A	T	4	5	9	0	0	9	0	0
9	53277453	.	G	A	0	8	8	0	7	15	0	0
9	54711802	.	A	G	6	3	9	0	0	9	0	0
9	54712645	.	T	C	7	8	15	0	4	19	0	0
9	56225603	.	T	C	8	5	13	0	0	13	0	0
9	56225617	.	A	G	9	2	11	0	1	12	0	0
9	56225849	.	A	G	5	6	11	0	0	11	0	0
9	56225850	.	A	G	5	6	11	0	0	11	0	0
