contig	position	variantID	refAllele	altAllele	refCount	altCount	totalCount	lowMAPQDepth	lowBaseQDepth	rawDepth	otherBases	improperPairs
1	209063	.	T	C	14	8	22	0	0	22	0	0
1	209113	.	T	C	9	7	16	0	0	16	0	0
1	209147	.	T	C	12	7	19	0	1	20	0	0
1	209162	.	T	C	19	8	27	0	0	27	0	0
1	442456	.	T	C	4	2	6	2	1	9	0	0
1	474195	.	A	G	0	1	1	0	0	1	0	0
1	474273	.	C	G	0	2	2	0	0	2	0	0
1	474286	.	T	A	1	2	3	0	0	3	0	0
1	474329	.	C	T	4	2	6	0	1	7	0	0
1	504696	.	A	G	6	0	6	0	12	18	0	0
1	504977	.	A	G	9	6	15	0	0	15	0	0
1	591248	.	A	C	0	0	0	0	5	5	0	0
1	591249	.	C	G	0	0	0	0	5	5	0	0
1	618671	.	T	C	20	7	27	0	3	30	0	0
1	619764	.	C	T	2	12	14	0	1	15	0	0
1	2216377	.	T	A	1	3	4	1	0	5	0	0
1	4150636	.	C	T	4	1	5	0	0	5	0	0
1	4150679	.	T	C	3	2	5	0	0	5	0	0
1	4151098	.	C	T	3	4	7	0	0	7	0	0
1	4151353	.	C	T	3	5	8	0	0	8	0	0
1	4151747	.	T	G	1	2	3	0	0	3	0	0
1	4151838	.	G	A	0	5	5	0	0	5	0	0
1	4151954	.	C	T	4	2	6	0	0	6	0	0
1	4152166	.	G	A	3	5	8	0	0	8	0	0
1	4152309	.	T	G	4	4	8	0	0	8	0	0
1	4152562	.	C	T	4	2	6	0	0	6	0	0
1	4152724	.	T	C	3	8	11	0	0	11	0	0
1	4152967	.	A	G	2	0	2	0	3	5	0	0
1	4153036	.	T	C	1	6	7	0	0	7	0	0
1	4153840	.	C	T	3	8	11	0	0	11	0	0
1	4153903	.	G	A	0	7	7	0	4	11	0	0
1	4154070	.	C	T	2	4	6	0	0	6	0	0
1	5357405	.	T	C	11	21	32	0	0	32	0	0
1	6166479	.	G	T	0	7	7	0	2	9	0	0
1	6210567	.	C	T	4	3	7	0	1	8	0	0
1	6226388	.	A	G	3	0	3	0	6	9	0	0
1	6231058	.	G	A	0	3	3	0	2	5	0	0
1	6234126	.	G	A	0	1	1	0	0	1	0	0
1	6236844	.	A	G	3	0	3	0	3	6	0	0
1	6238639	.	C	T	6	2	8	0	0	8	0	0
1	6241379	.	G	T	0	5	5	0	3	8	0	0
1	6241427	.	T	G	4	0	4	0	1	5	0	0
1	6243549	.	A	G	0	0	0	0	1	1	0	0
1	6243620	.	T	C	4	8	12	0	0	12	0	0
1	6243626	.	A	C	3	8	11	0	1	12	0	0
1	6243962	.	C	T	2	4	6	0	0	6	0	0
1	6243975	.	T	G	4	2	6	0	0	6	0	0
1	6244044	.	C	T	1	3	4	0	0	4	0	0
1	6244279	.	A	T	1	2	3	0	0	3	0	0
1	6244281	.	G	C	1	2	3	0	0	3	0	0
1	6252869	.	A	G	3	0	3	0	5	8	0	0
1	6252887	.	T	C	4	2	6	0	0	6	0	0
1	6262918	.	C	T	0	1	1	0	0	1	0	0
1	6264973	.	C	A	7	2	9	0	0	9	0	0
1	6266294	.	C	T	3	3	6	0	0	6	0	0
1	6365673	.	A	G	4	5	9	0	0	9	0	0
1	6365711	.	T	G	8	5	13	0	0	13	0	0
1	6365793	.	A	C	1	3	4	0	0	4	0	0
1	6366000	.	T	A	1	5	6	0	0	6	0	0
1	6366024	.	A	C	1	5	6	0	0	6	0	0
1	6366061	.	C	T	2	3	5	0	0	5	0	0
1	6403672	.	G	A	1	5	6	0	0	6	0	0
1	6404145	.	G	C	3	2	5	0	0	5	0	0
1	6404205	.	A	T	3	6	9	0	1	10	0	0
1	6404250	.	G	A	3	6	9	0	1	10	0	0
1	6429260	.	C	T	0	1	1	0	2	3	0	0
1	6494126	.	A	G	1	2	3	0	0	3	0	0
1	6494215	.	T	G	2	2	4	0	0	4	0	0
1	6918862	.	C	T	3	2	5	0	0	5	0	0
1	6918865	.	G	A	2	3	5	0	0	5	0	0
1	6924578	.	C	T	5	7	12	0	0	12	0	0
1	6924761	.	G	A	0	3	3	0	1	4	0	0
1	6924858	.	G	C	5	4	9	0	1	10	0	0
1	7447344	.	A	G	1	2	3	0	0	3	0	0
1	7518644	.	C	T	10	8	18	0	0	18	0	0
1	7523258	.	A	C	1	2	3	0	0	3	0	0
1	7523264	.	C	T	2	5	7	0	0	7	0	0
1	7526839	.	G	A	3	5	8	0	0	8	0	0
1	7528289	.	G	C	2	19	21	0	19	40	0	0
1	7530123	.	C	T	0	3	3	0	0	3	0	0
1	7538822	.	C	T	10	14	24	0	2	26	0	0
1	7538971	.	T	C	19	24	43	0	2	45	0	0
1	7539000	.	C	A	18	19	37	0	4	41	0	0
1	7539053	.	G	C	12	20	32	0	1	33	0	0
1	7539074	.	A	C	9	20	29	0	1	30	0	0
1	7560705	.	T	A	15	12	27	0	0	27	0	0
1	7632221	.	C	T	2	2	4	0	1	5	0	0
1	7634807	.	G	A	2	2	4	0	0	4	0	0
1	7662275	.	T	C	20	11	31	0	0	31	0	0
1	7662628	.	G	A	20	16	36	0	0	36	0	0
1	7662880	.	A	T	15	20	35	0	0	35	0	0
1	7662949	.	C	T	25	17	42	0	2	44	0	0
1	7668211	.	A	G	16	15	31	0	0	31	0	0
1	7668298	.	C	T	12	11	23	0	1	24	0	0
1	7673070	.	C	T	22	18	40	0	4	44	0	0
1	7673129	.	C	A	16	8	24	0	0	24	0	0
1	7682912	.	A	C	7	8	15	0	0	15	0	0
1	7682923	.	A	G	7	5	12	0	1	13	0	0
1	7682949	.	G	A	4	5	9	0	1	10	0	0
1	7853399	.	G	A	1	2	3	0	0	3	0	0
1	7853465	.	C	A	4	2	6	0	0	6	0	0
1	7864780	.	A	G	2	3	5	0	0	5	0	0
1	7872256	.	C	T	0	2	2	0	0	2	0	0
1	7872292	.	G	A	0	3	3	0	0	3	0	0
1	7894186	.	C	T	2	2	4	0	0	4	0	0
1	8022503	.	T	A	7	6	13	0	3	16	0	0
1	8022505	.	T	C	8	7	15	0	1	16	0	0
1	8022817	.	T	A	11	14	25	0	2	27	0	0
1	8023471	.	A	T	6	4	10	0	0	10	0	0
1	8023490	.	A	C	6	3	9	0	0	9	0	0
1	8023559	.	A	T	10	7	17	0	0	17	0	0
1	8023587	.	A	G	3	9	12	0	1	13	0	0
1	8023639	.	C	A	3	8	11	0	0	11	0	0
1	8023658	.	A	T	12	2	14	0	1	15	0	0
1	8023730	.	C	T	5	14	19	0	2	21	0	0
1	8026148	.	T	G	9	10	19	0	0	19	0	0
1	8026404	.	T	A	13	14	27	0	0	27	0	0
1	8026415	.	C	T	0	11	11	0	13	24	0	0
1	8026478	.	T	C	21	0	21	0	8	29	0	0
1	8026975	.	T	C	4	6	10	0	0	10	0	0
1	8028177	.	T	A	4	11	15	0	0	15	0	0
1	8028696	.	G	T	16	11	27	0	2	29	0	0
1	8028912	.	G	C	12	5	17	0	0	17	0	0
1	8028925	.	C	A	3	11	14	0	0	14	0	0
1	8028979	.	G	A	4	5	9	0	0	9	0	0
1	8029002	.	T	A	3	4	7	0	1	8	0	0
1	8032956	.	G	C	7	2	9	0	0	9	0	0
1	8049495	.	C	T	0	3	3	0	3	6	0	0
1	8051513	.	G	A	7	5	12	0	0	13	1	0
1	8051528	.	C	T	0	6	6	0	7	13	0	0
1	8055927	.	T	C	3	0	3	0	4	7	0	0
1	8162990	.	G	A	0	1	1	0	1	2	0	0
1	8165609	.	C	T	8	3	11	0	0	11	0	0
1	8165667	.	T	C	4	2	6	0	0	6	0	0
1	8165769	.	T	A	2	4	6	0	0	6	0	0
1	8165802	.	C	T	4	3	7	0	0	7	0	0
1	8166788	.	A	T	4	2	6	0	1	7	0	0
1	8166992	.	A	G	5	3	8	0	0	8	0	0
1	8167319	.	A	G	0	2	2	0	0	2	0	0
1	8167383	.	G	A	7	4	11	0	0	11	0	0
1	8167526	.	C	T	5	8	13	0	2	15	0	0
1	8167668	.	G	A	11	10	21	0	0	21	0	0
1	8169262	.	C	T	0	2	2	0	0	2	0	0
1	8169268	.	C	T	1	1	2	0	2	4	0	0
1	8189518	.	G	T	2	0	2	0	0	2	0	0
1	8417896	.	T	C	15	19	34	0	0	34	0	0
1	8418058	.	T	A	10	7	17	0	0	17	0	0
1	8422521	.	A	G	11	19	30	0	0	30	0	0
1	8424735	.	G	A	18	14	32	0	0	32	0	0
1	8524300	.	A	C	1	2	3	0	0	3	0	0
1	8524315	.	G	A	1	2	3	0	0	3	0	0
1	8527007	.	G	A	3	4	7	0	0	7	0	0
1	8527205	.	G	T	2	1	3	0	0	3	0	0
1	8530764	.	A	T	2	5	7	0	0	7	0	0
1	8531505	.	T	C	1	6	7	0	0	7	0	0
1	8531665	.	C	A	2	3	5	0	0	5	0	0
1	8531852	.	G	A	1	4	5	0	0	5	0	0
1	8531943	.	C	T	3	2	5	0	0	5	0	0
1	8532003	.	G	C	1	3	4	0	0	4	0	0
1	8539878	.	A	T	2	2	4	0	0	4	0	0
1	8544483	.	G	A	1	0	1	0	0	1	0	0
1	8544495	.	G	C	1	0	1	0	0	1	0	0
1	8546663	.	G	A	1	2	3	0	0	3	0	0
1	8550062	.	A	G	2	4	6	0	0	6	0	0
1	8557075	.	G	A	5	3	8	0	1	9	0	0
1	8557159	.	T	A	2	0	2	0	0	2	0	0
1	8560237	.	C	T	4	2	6	0	0	6	0	0
1	8560266	.	C	T	6	4	10	0	0	10	0	0
1	8560289	.	C	T	5	5	10	0	0	10	0	0
1	8560408	.	T	C	0	0	0	0	1	1	0	0
1	8562005	.	G	C	1	3	4	0	0	4	0	0
1	8563792	.	G	A	2	3	5	0	1	6	0	0
1	8566467	.	G	A	2	2	4	0	0	4	0	0
1	8566485	.	T	C	4	3	7	0	0	7	0	0
1	8601971	.	A	T	11	4	15	0	2	17	0	0
1	8601990	.	A	T	14	6	20	0	2	22	0	0
1	8606561	.	C	T	1	2	3	0	0	3	0	0
1	8606632	.	C	T	4	13	17	0	1	18	0	0
1	8606767	.	G	A	4	5	9	0	4	13	0	0
1	8607547	.	C	T	7	4	11	0	1	12	0	0
1	8607556	.	T	C	6	5	11	0	1	12	0	0
1	8608300	.	C	T	5	8	13	0	0	13	0	0
1	8638537	.	T	G	4	3	7	0	0	7	0	0
1	8642938	.	A	G	3	4	7	0	0	7	0	0
1	8642953	.	C	T	3	5	8	0	0	8	0	0
1	8643784	.	G	T	1	1	2	0	2	4	0	0
1	8649726	.	A	G	11	13	24	0	0	24	0	0
1	8649865	.	C	T	21	17	38	0	1	39	0	0
1	8649988	.	A	G	11	9	20	0	0	20	0	0
1	8649994	.	A	T	10	8	18	0	0	18	0	0
1	8650317	.	G	A	25	31	56	0	1	57	0	0
1	8650371	.	C	T	32	38	70	0	1	71	0	0
1	8650830	.	T	G	9	4	13	0	0	13	0	0
1	8651036	.	G	A	25	24	49	0	1	50	0	0
1	8651060	.	T	C	16	16	32	0	2	34	0	0
1	8651576	.	G	A	14	22	36	0	3	39	0	0
1	8652655	.	C	T	0	2	2	0	1	3	0	0
1	8662553	.	G	A	12	24	36	0	2	38	0	0
1	8663048	.	G	A	1	27	28	0	15	43	0	0
1	8663195	.	T	G	19	20	39	0	0	39	0	0
1	8663295	.	T	C	16	19	35	0	1	36	0	0
1	8667377	.	G	A	11	8	19	0	0	19	0	0
1	8667606	.	C	T	17	17	34	0	1	35	0	0
1	8668166	.	T	C	17	30	47	0	2	49	0	0
1	8668238	.	G	T	32	13	45	0	0	45	0	0
1	8668452	.	C	A	7	2	9	0	0	9	0	0
1	8668532	.	C	A	2	2	4	0	0	4	0	0
1	8668930	.	A	T	2	3	5	0	0	5	0	0
1	8669543	.	A	G	4	4	8	0	0	8	0	0
1	8669669	.	A	G	8	13	21	0	0	21	0	0
1	8669717	.	T	G	13	17	30	0	1	31	0	0
1	8669718	.	T	C	13	18	31	0	0	31	0	0
1	8669753	.	T	A	12	18	30	0	2	32	0	0
1	8669847	.	G	T	21	24	45	0	0	45	0	0
1	8670031	.	T	C	23	30	53	0	6	59	0	0
1	8670032	.	G	T	2	24	26	0	33	59	0	0
1	8670402	.	G	A	15	20	35	0	0	35	0	0
1	8694404	.	G	A	17	14	31	0	2	33	0	0
1	8698765	.	T	C	13	22	35	0	0	35	0	0
1	8698799	.	C	T	20	12	32	0	0	32	0	0
1	8698834	.	T	A	12	5	17	0	0	17	0	0
1	8699040	.	C	T	1	2	3	0	0	3	0	0
1	8701548	.	A	G	20	0	20	0	21	41	0	0
1	8701623	.	C	T	21	25	46	0	2	48	0	0
1	8701747	.	G	A	16	12	28	1	2	31	0	0
1	8702325	.	G	T	15	15	30	0	0	30	0	0
1	8763824	.	A	G	3	4	7	0	0	7	0	0
1	8763832	.	A	C	3	0	3	0	5	8	0	0
1	8764123	.	C	T	5	6	11	0	0	11	0	0
1	8764612	.	T	C	5	0	5	0	3	8	0	0
1	8764729	.	C	T	10	6	16	0	1	17	0	0
1	8764760	.	G	A	6	10	16	0	3	19	0	0
1	8764811	.	C	T	0	9	9	0	9	18	0	0
1	8764812	.	G	A	7	11	18	0	0	18	0	0
1	8765315	.	A	G	14	15	29	0	0	29	0	0
1	8765422	.	G	A	8	9	17	0	0	17	0	0
1	8765713	.	A	C	17	18	35	0	1	36	0	0
1	8765724	.	A	G	17	18	35	0	0	35	0	0
1	8766267	.	T	C	11	1	12	0	7	19	0	0
1	8766453	.	C	T	13	10	23	0	2	25	0	0
1	8766471	.	C	T	1	12	13	0	12	25	0	0
1	8766501	.	C	T	13	13	26	0	0	26	0	0
1	8766693	.	G	A	2	12	14	0	2	16	0	0
1	8767002	.	C	T	11	9	20	0	0	20	0	0
1	8767080	.	G	A	16	9	25	0	0	25	0	0
1	8767155	.	C	T	8	11	19	0	3	22	0	0
1	8767185	.	T	C	8	10	18	0	1	20	1	0
1	8767260	.	T	C	8	7	15	0	0	15	0	0
1	8767395	.	A	G	3	11	14	0	0	14	0	0
1	8767536	.	T	C	5	0	5	0	7	12	0	0
1	8767629	.	G	A	10	6	16	0	0	16	0	0
1	8767725	.	T	C	3	5	8	0	0	8	0	0
1	8768307	.	A	G	5	5	10	0	0	10	0	0
1	8770773	.	G	A	3	1	4	0	0	4	0	0
1	8771020	.	T	G	6	3	9	0	0	9	0	0
1	8773269	.	T	C	8	6	14	0	1	15	0	0
1	8773320	.	G	A	7	4	11	0	0	11	0	0
1	8773383	.	A	G	0	3	3	0	0	3	0	0
1	8776497	.	A	G	3	3	6	0	1	7	0	0
1	8810701	.	T	G	3	2	5	0	0	5	0	0
1	8810917	.	A	C	1	0	1	0	7	8	0	0
1	8917623	.	C	T	4	5	9	0	0	9	0	0
1	8966015	.	C	T	1	1	2	0	0	2	0	0
1	8974576	.	C	T	1	6	7	0	0	7	0	0
1	8974620	.	A	G	2	5	7	0	0	7	0	0
1	8974695	.	A	T	4	16	20	0	0	20	0	0
1	8975415	.	T	C	2	6	8	0	0	8	0	0
1	9004942	.	T	C	12	11	23	0	1	24	0	0
1	9044245	.	G	A	0	2	2	0	1	3	0	0
1	9044745	.	C	T	7	6	13	0	0	13	0	0
1	9051092	.	T	C	5	6	11	0	0	11	0	0
1	9056045	.	T	G	3	2	5	0	0	5	0	0
1	9056886	.	T	C	12	8	20	0	0	20	0	0
1	9064611	.	T	C	5	6	11	0	0	11	0	0
1	9064864	.	T	C	2	2	4	0	1	5	0	0
1	9064885	.	C	A	0	2	2	0	1	3	0	0
1	9074440	.	T	C	15	16	31	0	0	31	0	0
1	9118497	.	T	A	8	13	21	0	1	22	0	0
1	9118544	.	G	A	1	2	3	0	0	3	0	0
1	9118556	.	C	A	1	2	3	0	0	3	0	0
1	9123262	.	A	G	6	5	11	0	0	11	0	0
1	9145049	.	G	C	1	4	5	0	0	5	0	0
1	9145541	.	T	C	1	5	6	0	0	6	0	0
1	9262077	.	A	G	6	7	13	0	0	13	0	0
1	9262080	.	A	G	9	5	14	0	1	15	0	0
1	9265578	.	T	C	0	1	1	0	0	1	0	0
1	9270198	.	T	C	2	0	2	0	0	2	0	0
1	9273347	.	A	G	2	1	3	0	0	3	0	0
1	9273947	.	G	C	1	4	5	0	0	5	0	0
1	9276360	.	T	C	2	0	2	0	2	4	0	0
1	9276420	.	C	T	2	2	4	0	0	4	0	0
1	9277858	.	T	C	12	10	22	0	0	22	0	0
1	9278150	.	G	A	4	3	7	0	0	7	0	0
1	9290500	.	G	T	4	3	7	0	0	7	0	0
1	9293041	.	C	T	7	8	15	0	3	18	0	0
1	9293117	.	G	A	0	5	5	0	16	21	0	0
1	9293156	.	G	A	11	11	22	0	1	23	0	0
1	9293185	.	T	C	6	11	17	0	2	19	0	0
1	9293215	.	G	A	7	14	21	0	1	22	0	0
1	9293495	.	A	G	7	10	17	0	3	20	0	0
1	9293580	.	C	T	14	5	19	0	0	19	0	0
1	9293740	.	T	C	6	4	10	0	0	10	0	0
1	9293889	.	C	A	10	3	13	0	0	13	0	0
1	9499764	.	C	T	8	5	13	0	0	13	0	0
1	9500312	.	A	T	5	5	10	0	1	11	0	0
1	9500332	.	T	C	1	2	3	0	0	3	0	0
1	9500508	.	C	A	2	8	10	0	0	10	0	0
1	9500585	.	T	G	3	4	7	0	0	7	0	0
1	9500598	.	T	G	3	1	4	0	1	5	0	0
1	9500835	.	A	G	6	3	9	0	1	10	0	0
1	9500867	.	T	C	6	6	12	0	1	13	0	0
1	9500947	.	G	T	6	5	11	0	0	11	0	0
1	9500984	.	A	T	4	3	7	0	0	7	0	0
1	9501011	.	T	C	3	5	8	0	0	8	0	0
1	9501031	.	C	T	4	3	7	0	0	7	0	0
1	9501229	.	C	T	8	11	19	0	1	20	0	0
1	9501231	.	G	A	12	7	19	0	1	20	0	0
1	9501365	.	T	C	8	1	9	0	10	19	0	0
1	9501394	.	T	A	8	4	12	0	0	12	0	0
1	9508752	.	T	A	9	8	17	0	0	17	0	0
1	9510571	.	A	G	0	2	2	0	0	2	0	0
1	9510574	.	G	A	0	2	2	0	0	2	0	0
1	9512342	.	C	T	1	1	2	0	0	2	0	0
1	9516905	.	A	C	6	0	6	0	0	6	0	0
1	9517048	.	A	G	2	1	3	0	0	3	0	0
1	9517102	.	G	A	3	3	6	0	0	6	0	0
1	9519935	.	G	A	1	0	1	0	0	1	0	0
1	9520435	.	G	A	0	1	1	0	0	1	0	0
1	9523283	.	C	T	0	3	3	0	1	4	0	0
1	9527076	.	T	A	3	6	9	0	0	9	0	0
1	9557242	.	G	T	0	2	2	0	1	3	0	0
1	9557456	.	T	C	1	2	3	0	0	3	0	0
1	9618241	.	A	G	2	1	3	0	0	3	0	0
1	9708707	.	T	C	3	2	5	0	0	5	0	0
1	9708747	.	C	A	4	2	6	0	0	6	0	0
1	9708818	.	G	T	1	3	4	0	0	4	0	0
1	9708918	.	C	T	2	2	4	0	0	4	0	0
1	9709280	.	G	A	4	2	6	0	0	6	0	0
1	9710759	.	C	T	2	4	6	0	1	7	0	0
1	9710853	.	T	C	5	2	7	0	0	7	0	0
1	9711740	.	G	C	2	2	4	0	1	5	0	0
1	9712111	.	G	A	0	7	7	0	4	11	0	0
1	9712253	.	T	A	0	3	3	0	0	3	0	0
1	9712266	.	G	T	0	2	2	0	0	2	0	0
1	9740643	.	G	A	1	2	3	0	0	3	0	0
1	9740989	.	T	A	0	2	2	0	0	2	0	0
1	9741123	.	G	A	1	2	3	0	0	3	0	0
1	9808345	.	T	A	0	1	1	0	0	1	0	0
1	9808365	.	C	T	0	1	1	0	0	1	0	0
1	9858447	.	C	T	0	2	2	0	0	2	0	0
1	9858451	.	G	A	0	1	1	0	1	2	0	0
1	9863320	.	G	A	0	0	0	0	1	1	0	0
1	9873485	.	G	A	6	4	10	0	0	10	0	0
1	9873509	.	G	A	7	3	10	0	1	11	0	0
1	9873607	.	A	T	3	4	7	0	6	13	0	0
1	9873616	.	T	C	3	1	4	0	10	14	0	0
1	9873787	.	G	A	1	2	3	0	1	4	0	0
1	9877335	.	A	G	1	2	3	0	0	3	0	0
1	9877576	.	C	T	0	1	1	0	2	3	0	0
1	9880387	.	A	G	4	5	9	0	1	10	0	0
1	9883339	.	T	C	2	2	4	0	0	4	0	0
1	9893616	.	T	C	2	0	2	0	0	2	0	0
1	9920038	.	A	G	1	2	3	0	0	3	0	0
1	9920359	.	G	A	1	1	2	0	0	2	0	0
1	9920631	.	G	A	1	0	1	0	0	1	0	0
1	10645529	.	C	T	1	2	3	0	0	3	0	0
1	10646944	.	A	G	1	3	4	0	1	5	0	0
1	10646981	.	C	T	2	2	4	0	0	4	0	0
1	10646983	.	G	T	2	2	4	0	0	4	0	0
1	10667832	.	C	T	0	3	3	0	4	7	0	0
1	10667856	.	A	G	2	4	6	0	0	6	0	0
1	10683868	.	A	T	8	21	29	0	1	30	0	0
1	10683955	.	A	G	18	20	38	0	2	40	0	0
1	10683974	.	A	C	17	18	35	0	1	36	0	0
1	10684037	.	A	G	13	2	15	0	18	33	0	0
1	10684105	.	G	A	3	14	17	0	19	36	0	0
1	10688731	.	T	G	2	0	2	0	4	6	0	0
1	10692078	.	T	C	12	8	20	0	0	20	0	0
1	10692090	.	G	A	10	6	16	0	0	16	0	0
1	10736181	.	G	A	10	5	15	0	1	16	0	0
1	10738176	.	A	G	11	6	17	0	0	17	0	0
1	10738177	.	A	G	10	7	17	0	0	17	0	0
1	10738509	.	T	C	25	28	53	0	0	53	0	0
1	10738535	.	G	A	25	30	55	0	1	56	0	0
1	10738568	.	A	G	26	1	27	0	34	61	0	0
1	10738863	.	C	A	23	35	58	0	6	64	0	0
1	10739190	.	A	G	35	15	50	0	1	51	0	0
1	10841254	.	T	C	11	10	21	0	0	21	0	0
1	10841275	.	T	C	11	8	19	0	1	20	0	0
1	10841356	.	G	A	0	2	2	0	0	2	0	0
1	10885173	.	A	C	3	1	4	0	0	4	0	0
1	10885266	.	T	A	5	3	8	0	1	9	0	0
1	10901325	.	G	A	1	1	2	0	0	2	0	0
1	10952835	.	G	T	2	1	3	0	0	3	0	0
1	11125149	.	C	T	0	1	1	0	2	3	0	0
1	11127938	.	G	A	2	2	4	0	0	4	0	0
1	11130713	.	G	A	3	1	4	0	0	4	0	0
1	11136648	.	G	A	3	2	5	0	0	5	0	0
1	11141082	.	C	T	0	2	2	0	0	2	0	0
1	11144295	.	T	C	1	1	2	0	0	2	0	0
1	11180740	.	C	T	1	2	3	0	0	3	0	0
1	11275073	.	A	G	1	2	3	0	0	3	0	0
1	11275171	.	T	C	1	0	1	0	3	4	0	0
1	11280839	.	C	A	1	1	2	0	0	2	0	0
1	11280856	.	G	A	1	1	2	0	0	2	0	0
1	11364423	.	G	A	1	3	4	0	1	5	0	0
1	11364435	.	T	A	2	2	4	0	0	4	0	0
1	11671042	.	T	C	3	4	7	0	0	7	0	0
1	11671059	.	A	G	4	7	11	0	0	11	0	0
1	11671355	.	C	A	6	3	9	0	1	10	0	0
1	11671527	.	G	A	9	3	12	0	0	12	0	0
1	11671580	.	C	T	4	4	8	0	0	8	0	0
1	11783388	.	T	C	18	15	33	0	1	34	0	0
1	11783410	.	T	C	21	10	31	0	0	31	0	0
1	11783504	.	T	C	12	15	27	0	0	27	0	0
1	11783530	.	T	C	11	5	16	0	2	18	0	0
1	11783650	.	T	C	21	20	41	0	0	41	0	0
1	11784522	.	T	C	36	10	46	0	4	50	0	0
1	11784609	.	T	C	24	8	32	0	3	35	0	0
1	11994646	.	A	T	1	2	3	0	0	3	0	0
1	13958010	.	G	A	6	2	8	0	0	8	0	0
1	14142461	.	A	G	5	3	8	0	0	8	0	0
1	15203042	.	C	G	3	0	3	0	32	38	3	0
1	15254084	.	A	G	3	4	7	0	1	8	0	0
1	15254249	.	A	G	6	0	6	0	6	12	0	0
1	17381444	.	T	C	2	2	4	0	0	4	0	0
1	17523030	.	A	G	17	2	19	0	7	26	0	0
1	17523603	.	A	G	16	6	22	0	0	22	0	0
1	17535858	.	A	G	6	0	6	0	7	13	0	0
1	17535859	.	A	G	3	10	13	0	0	13	0	0
1	17538198	.	T	C	17	5	22	0	0	22	0	0
1	19760680	.	A	T	2	2	4	0	0	4	0	0
1	19785208	.	A	C	0	1	1	0	0	1	0	0
1	19872148	.	C	T	0	2	2	0	0	2	0	0
1	19874550	.	G	A	3	0	3	0	0	3	0	0
1	19882538	.	C	A	0	2	2	0	0	2	0	0
1	19886159	.	A	C	1	2	3	0	0	3	0	0
1	19886292	.	T	A	4	6	10	0	0	10	0	0
1	19936259	.	G	T	0	7	7	0	4	11	0	0
1	19936298	.	G	A	4	6	10	0	0	10	0	0
1	19936358	.	T	C	5	7	12	0	0	12	0	0
1	19936418	.	T	A	5	10	15	0	1	16	0	0
1	19936511	.	T	C	7	5	12	0	1	13	0	0
1	19936682	.	C	T	8	6	14	0	0	14	0	0
1	19937090	.	A	G	3	0	3	0	6	9	0	0
1	19950478	.	A	T	7	12	19	0	4	23	0	0
1	19955706	.	C	T	1	0	1	0	0	1	0	0
1	19966416	.	C	T	11	3	14	0	0	14	0	0
1	19984448	.	C	T	4	4	8	0	0	8	0	0
1	19988952	.	C	G	9	10	19	0	1	20	0	0
1	19989008	.	T	G	12	14	26	0	1	27	0	0
1	19989023	.	G	A	0	17	17	0	13	30	0	0
1	20063843	.	C	A	0	3	3	0	3	6	0	0
1	20065156	.	A	G	3	2	5	0	0	5	0	0
1	20068075	.	A	C	6	3	9	0	0	9	0	0
1	20068092	.	T	A	3	2	5	0	0	5	0	0
1	20092616	.	T	A	1	5	6	0	1	7	0	0
1	20094234	.	G	A	0	2	2	0	0	2	0	0
1	20094327	.	G	T	0	4	4	0	0	4	0	0
1	20095274	.	A	G	1	0	1	0	0	1	0	0
1	20117629	.	T	C	4	5	9	0	0	9	0	0
1	20129562	.	C	T	2	3	5	0	1	6	0	0
1	20129652	.	T	C	1	1	2	0	0	2	0	0
1	20138674	.	C	A	1	3	4	0	0	4	0	0
1	20138901	.	A	G	7	3	10	0	0	10	0	0
1	20139168	.	T	C	6	4	10	0	0	10	0	0
1	20139187	.	A	C	2	4	6	0	2	8	0	0
1	20139247	.	C	G	4	2	6	0	0	6	0	0
1	20139488	.	T	C	4	3	7	0	1	8	0	0
1	20139551	.	G	A	5	6	11	0	0	11	0	0
1	20139566	.	A	G	6	9	15	0	0	15	0	0
1	20139636	.	A	C	6	4	10	0	1	11	0	0
1	20139658	.	T	A	7	7	14	0	0	14	0	0
1	20139815	.	T	C	3	5	8	0	0	8	0	0
1	20139962	.	A	T	9	3	12	0	0	12	0	0
1	20140042	.	G	T	0	4	4	0	8	12	0	0
1	20140048	.	A	T	8	4	12	0	0	12	0	0
1	20140120	.	C	T	3	9	12	0	1	13	0	0
1	20140133	.	T	C	2	9	11	0	1	12	0	0
1	20140200	.	C	T	7	1	8	0	1	9	0	0
1	20140363	.	T	G	13	5	18	0	0	18	0	0
1	20140419	.	G	A	7	3	10	0	1	11	0	0
1	20140445	.	T	C	5	4	9	0	0	9	0	0
1	20140951	.	G	A	0	14	14	0	15	29	0	0
1	20140952	.	G	A	15	13	28	0	1	29	0	0
1	20141070	.	C	A	16	8	24	0	0	24	0	0
1	20141106	.	A	G	8	9	17	0	1	18	0	0
1	20141218	.	T	G	12	3	15	0	1	16	0	0
1	20141232	.	T	A	14	4	18	0	0	18	0	0
1	20141253	.	G	A	16	9	25	0	0	25	0	0
1	20141310	.	G	A	14	11	25	0	1	26	0	0
1	20141378	.	C	G	14	0	14	0	12	26	0	0
1	20141411	.	A	T	14	14	28	0	1	29	0	0
1	20141572	.	G	A	0	6	6	0	2	8	0	0
1	20141611	.	T	C	4	3	7	0	0	7	0	0
1	20141661	.	A	C	3	9	12	0	0	12	0	0
1	20141834	.	G	C	4	2	6	0	0	6	0	0
1	20147248	.	T	A	5	5	10	0	0	10	0	0
1	20160882	.	T	A	6	4	10	0	1	11	0	0
1	20166536	.	C	A	17	11	28	0	1	29	0	0
1	20166600	.	A	G	4	7	11	0	1	12	0	0
1	20173954	.	A	G	3	6	9	0	0	9	0	0
1	20194118	.	C	T	6	3	9	0	0	9	0	0
1	20212239	.	G	A	1	9	10	0	0	10	0	0
1	20212284	.	C	T	9	4	13	0	0	13	0	0
1	20212362	.	G	A	3	2	5	0	0	5	0	0
1	20221498	.	G	A	2	6	8	0	0	8	0	0
1	20270080	.	G	A	4	3	7	0	0	7	0	0
1	20270486	.	A	T	7	5	12	0	0	12	0	0
1	20270779	.	G	A	11	8	19	0	0	19	0	0
1	20557447	.	G	A	18	17	35	0	0	35	0	0
1	20557625	.	A	C	8	0	8	0	18	26	0	0
1	20557650	.	C	T	7	17	24	0	0	24	0	0
1	20558143	.	T	C	8	15	23	0	0	23	0	0
1	20558523	.	G	A	3	6	9	0	0	9	0	0
1	20558594	.	C	A	0	6	6	0	4	10	0	0
1	20558691	.	A	C	2	3	5	0	0	5	0	0
1	20558888	.	C	A	8	3	11	0	0	11	0	0
1	20559010	.	A	G	3	5	8	0	0	8	0	0
1	20559321	.	T	C	6	1	7	0	2	9	0	0
1	20559324	.	T	A	5	3	8	0	0	8	0	0
1	20559538	.	G	A	13	9	22	0	1	23	0	0
1	20559902	.	A	G	7	5	12	0	1	14	1	0
1	20564770	.	T	G	5	8	13	0	0	13	0	0
1	20581101	.	A	G	2	1	3	0	0	3	0	0
1	20581454	.	A	G	2	3	5	0	0	5	0	0
1	20581502	.	A	G	1	3	4	0	0	4	0	0
1	20581743	.	A	G	3	2	5	0	0	5	0	0
1	20678674	.	G	C	9	12	21	0	0	21	0	0
1	20694916	.	G	A	0	9	9	0	9	18	0	0
1	20694955	.	A	G	12	26	38	0	0	38	0	0
1	20695073	.	G	A	1	9	10	0	13	23	0	0
1	20700473	.	T	C	20	27	47	0	2	49	0	0
1	20700524	.	G	A	1	15	16	0	13	29	0	0
1	20704896	.	T	C	16	16	32	0	2	34	0	0
1	20705237	.	C	T	12	24	36	0	0	36	0	0
1	20705863	.	A	G	16	12	28	0	1	29	0	0
1	20733146	.	A	G	1	3	4	0	0	4	0	0
1	20733161	.	T	C	2	3	5	0	0	5	0	0
1	20866886	.	C	T	11	11	22	0	4	26	0	0
1	20866996	.	T	G	24	29	53	0	0	53	0	0
1	20867057	.	A	T	26	29	55	0	1	56	0	0
1	20867092	.	C	T	24	24	48	0	2	50	0	0
1	20867185	.	A	T	11	23	34	0	0	34	0	0
1	20867186	.	G	T	10	22	32	0	2	34	0	0
1	20867321	.	C	T	3	16	19	0	29	48	0	0
1	20867345	.	C	T	33	16	49	0	2	51	0	0
1	20867359	.	C	T	30	14	44	0	2	46	0	0
1	20867623	.	T	C	29	41	70	0	3	73	0	0
1	20867968	.	T	G	27	28	55	5	3	63	0	0
1	20868165	.	C	G	23	34	57	0	4	61	0	0
1	20868242	.	T	A	26	36	62	0	0	62	0	0
1	20868258	.	T	A	38	24	62	0	1	63	0	0
1	20868301	.	A	G	34	23	57	0	3	60	0	0
1	20868309	.	C	G	23	35	58	0	6	64	0	0
1	20868338	.	G	T	31	29	60	0	5	65	0	0
1	20868504	.	T	C	26	30	56	0	2	58	0	0
1	20868530	.	C	T	25	26	51	0	1	52	0	0
1	20868546	.	G	A	25	19	44	0	6	50	0	0
1	20868684	.	A	T	33	22	55	0	7	62	0	0
1	20868802	.	T	G	9	14	23	4	2	29	0	0
1	20868825	.	G	A	18	27	45	0	1	46	0	0
1	20868850	.	G	A	29	28	57	0	1	58	0	0
1	20868927	.	A	G	27	27	54	0	4	58	0	0
1	20868953	.	C	T	1	25	26	0	32	58	0	0
1	20869064	.	T	A	6	7	13	0	0	13	0	0
1	20870387	.	T	C	14	16	30	1	0	31	0	0
1	20870632	.	T	C	16	13	29	0	3	32	0	0
1	20870846	.	C	T	12	30	42	1	0	43	0	0
1	20871144	.	C	G	16	20	36	0	4	40	0	0
1	20886924	.	G	A	13	13	26	0	2	28	0	0
1	20886936	.	G	A	22	18	40	0	1	41	0	0
1	20910967	.	A	G	31	33	64	0	5	69	0	0
1	20911171	.	G	T	26	37	63	0	5	68	0	0
1	20916898	.	G	A	4	7	11	0	0	11	0	0
1	20916928	.	T	A	8	4	12	0	0	12	0	0
1	20925532	.	G	A	1	2	3	0	0	3	0	0
1	20925544	.	G	T	1	2	3	0	0	3	0	0
1	20925896	.	A	G	0	3	3	0	1	4	0	0
1	20932137	.	T	A	4	2	6	0	1	7	0	0
1	20932138	.	C	T	4	2	6	0	1	7	0	0
1	20941573	.	G	A	1	4	5	0	0	5	0	0
1	20946897	.	A	G	0	1	1	0	0	1	0	0
1	20956239	.	G	A	1	1	2	0	0	2	0	0
1	20970109	.	G	T	7	5	12	0	0	12	0	0
1	20970202	.	G	A	6	3	9	0	0	9	0	0
1	21139108	.	A	G	3	3	6	0	0	6	0	0
1	21139142	.	G	A	5	6	11	0	0	11	0	0
1	21139355	.	G	A	1	3	4	0	0	4	0	0
1	21139367	.	G	A	1	3	4	0	0	4	0	0
1	21141701	.	A	G	4	2	6	0	0	6	0	0
1	21141894	.	C	T	0	4	4	0	2	6	0	0
1	21141930	.	T	G	5	5	10	0	0	10	0	0
1	21141999	.	G	A	6	4	10	0	0	10	0	0
1	21146729	.	C	G	0	2	2	0	4	6	0	0
1	21151784	.	A	G	1	0	1	0	0	1	0	0
1	21154156	.	C	T	3	2	5	0	0	5	0	0
1	21157638	.	T	C	4	0	4	0	1	5	0	0
1	21159366	.	T	C	1	0	1	0	4	5	0	0
1	21160853	.	G	A	1	1	2	0	0	2	0	0
1	21163422	.	C	T	0	2	2	0	0	2	0	0
1	21243000	.	T	C	1	0	1	0	3	4	0	0
1	21309424	.	G	T	1	2	3	0	0	3	0	0
1	21312067	.	A	G	3	3	6	0	0	6	0	0
1	21312112	.	C	T	11	8	19	0	1	20	0	0
1	21313861	.	T	A	2	3	5	0	1	6	0	0
1	21313914	.	T	A	2	2	4	0	0	4	0	0
1	21333205	.	C	G	0	10	10	0	23	33	0	0
1	21333223	.	A	T	11	18	29	0	1	30	0	0
1	21333337	.	G	C	16	11	27	0	1	29	1	0
1	21341577	.	T	C	1	7	8	0	0	8	0	0
1	21344500	.	G	A	16	24	40	0	0	40	0	0
1	21344518	.	C	G	0	22	22	0	12	34	0	0
1	21346015	.	T	C	7	8	15	0	0	15	0	0
1	21346051	.	C	T	0	1	1	0	0	1	0	0
1	21368014	.	C	A	13	7	20	0	0	20	0	0
1	21368074	.	C	A	21	18	39	0	0	39	0	0
1	21368206	.	G	T	2	0	2	0	0	2	0	0
1	21423093	.	A	T	3	6	9	0	2	11	0	0
1	21423307	.	C	T	6	8	14	0	0	14	0	0
1	21423756	.	A	G	4	8	12	0	0	12	0	0
1	21423765	.	C	A	5	4	9	0	0	9	0	0
1	21449804	.	A	G	8	8	16	0	0	16	0	0
1	21495883	.	C	T	1	2	3	0	0	3	0	0
1	21495980	.	T	C	1	2	3	0	0	3	0	0
1	21500451	.	G	T	1	0	1	0	0	1	0	0
1	21513826	.	G	A	1	4	5	0	0	5	0	0
1	21514069	.	G	A	1	2	3	0	0	3	0	0
1	21515903	.	G	T	3	2	5	0	0	5	0	0
1	21516249	.	C	G	0	1	1	0	0	1	0	0
1	21518503	.	G	A	1	3	4	0	0	4	0	0
1	21529432	.	A	G	2	1	3	0	0	3	0	0
1	21546319	.	C	T	1	0	1	0	0	1	0	0
1	21576919	.	G	A	2	2	4	0	0	4	0	0
1	21576958	.	A	G	1	1	2	0	0	2	0	0
1	21576967	.	T	G	0	1	1	0	0	1	0	0
1	21610651	.	A	G	2	2	4	0	0	4	0	0
1	21611043	.	T	C	2	3	5	0	0	5	0	0
1	21612127	.	C	T	4	5	9	0	0	9	0	0
1	21612153	.	T	G	5	6	11	0	0	11	0	0
1	21612400	.	G	A	6	6	12	0	0	12	0	0
1	21612418	.	G	C	3	7	10	0	0	10	0	0
1	21769410	.	G	A	0	1	1	0	0	1	0	0
1	21769421	.	G	A	0	1	1	0	0	1	0	0
1	21944599	.	C	G	1	2	3	0	0	3	0	0
1	21944731	.	C	T	2	3	5	0	0	5	0	0
1	21945383	.	C	A	0	2	2	0	0	2	0	0
1	22205940	.	A	G	2	2	4	0	0	4	0	0
1	22236735	.	T	G	3	6	9	0	0	9	0	0
1	22236891	.	A	T	4	7	11	0	1	12	0	0
1	22236990	.	G	A	2	3	5	0	0	5	0	0
1	22389122	.	C	T	4	2	6	0	0	6	0	0
1	22389246	.	C	T	0	9	9	0	6	15	0	0
1	22389264	.	T	A	7	9	16	0	0	16	0	0
1	22389395	.	T	C	4	2	6	0	0	6	0	0
1	22401851	.	A	G	0	1	1	0	0	1	0	0
1	22412005	.	G	A	7	8	15	0	0	15	0	0
1	22490565	.	C	T	0	4	4	0	4	8	0	0
1	22490795	.	C	T	0	3	3	2	2	7	0	0
1	22511963	.	T	A	3	5	8	0	0	8	0	0
1	22542770	.	C	A	4	3	7	0	0	7	0	0
1	22542771	.	T	C	4	0	4	0	3	7	0	0
1	22543084	.	A	G	1	2	3	0	0	3	0	0
1	22543467	.	A	T	1	2	3	0	0	3	0	0
1	22547064	.	T	G	0	2	2	0	0	2	0	0
1	22647772	.	T	C	6	4	10	0	0	10	0	0
1	22648037	.	T	A	28	26	54	0	0	54	0	0
1	22648038	.	A	C	28	25	53	0	1	54	0	0
1	22651348	.	C	A	0	3	3	0	1	4	0	0
1	22651934	.	T	A	2	2	4	0	1	5	0	0
1	22652028	.	C	T	2	5	7	0	0	7	0	0
1	22664294	.	A	C	0	2	2	0	0	2	0	0
1	22664350	.	G	A	0	4	4	0	0	4	0	0
1	22664372	.	C	T	0	3	3	0	0	3	0	0
1	22664454	.	A	T	1	3	4	0	0	4	0	0
1	22664924	.	A	T	3	2	5	0	0	5	0	0
1	22713000	.	A	T	5	4	9	0	0	9	0	0
1	22713010	.	A	T	5	4	9	0	1	10	0	0
1	22713058	.	C	T	0	3	3	0	4	7	0	0
1	22713095	.	A	C	2	0	2	0	1	3	0	0
1	22713143	.	A	G	2	1	3	0	0	3	0	0
1	22713595	.	G	C	6	3	9	0	0	9	0	0
1	22713635	.	T	C	1	2	3	0	0	3	0	0
1	22713674	.	C	T	3	3	6	0	1	7	0	0
1	22713974	.	G	A	1	2	3	0	0	3	0	0
1	22756881	.	T	C	2	2	4	0	0	4	0	0
1	22756895	.	A	T	1	2	3	0	0	3	0	0
1	22756930	.	G	A	1	2	3	0	0	3	0	0
1	22770608	.	A	T	13	10	23	0	0	23	0	0
1	22770723	.	C	T	6	11	17	0	0	17	0	0
1	22770810	.	C	T	5	7	12	0	0	12	0	0
1	22771305	.	T	G	11	18	29	0	0	29	0	0
1	22771437	.	G	A	10	5	15	0	0	15	0	0
1	22771677	.	C	T	0	10	10	0	8	18	0	0
1	22771911	.	A	T	6	10	16	0	2	18	0	0
1	22771936	.	C	T	9	10	19	0	0	19	0	0
1	22771952	.	A	T	15	10	25	0	0	25	0	0
1	22772213	.	C	A	6	9	15	0	1	16	0	0
1	22772308	.	C	T	5	13	18	0	1	19	0	0
1	22772545	.	A	T	10	14	24	0	1	25	0	0
1	22772711	.	G	A	15	10	25	0	1	26	0	0
1	22777201	.	G	A	3	1	4	0	0	4	0	0
1	22805615	.	C	T	12	11	23	0	0	23	0	0
1	22805630	.	G	C	11	7	18	0	0	18	0	0
1	22805750	.	T	A	2	5	7	0	1	8	0	0
1	22805861	.	G	A	1	5	6	0	1	7	0	0
1	22805906	.	A	C	2	7	9	0	0	9	0	0
1	22805927	.	C	A	4	6	10	0	0	10	0	0
1	22806089	.	C	T	11	9	20	0	0	20	0	0
1	22806108	.	A	G	9	10	19	0	2	21	0	0
1	22806156	.	T	C	3	6	9	0	1	12	2	0
1	22806166	.	G	A	1	8	9	0	0	9	0	0
1	22806207	.	A	G	2	6	8	0	0	8	0	0
1	22806254	.	T	C	8	3	11	0	0	11	0	0
1	22806643	.	C	A	10	13	23	0	0	23	0	0
1	22806825	.	C	T	0	8	8	0	9	17	0	0
1	22806980	.	G	A	7	3	10	0	1	11	0	0
1	22807043	.	G	A	8	3	11	0	1	12	0	0
1	22807169	.	A	G	7	9	16	0	1	17	0	0
1	22807238	.	G	A	5	5	10	0	0	10	0	0
1	22807275	.	C	G	0	9	9	0	0	9	0	0
1	22807304	.	C	G	3	17	20	0	0	20	0	0
1	22807321	.	G	A	5	20	25	0	1	26	0	0
1	22807632	.	C	T	8	8	16	0	0	16	0	0
1	22807639	.	G	A	8	8	16	0	1	17	0	0
1	22807744	.	G	T	3	5	8	0	0	8	0	0
1	22808009	.	G	T	7	8	15	0	0	15	0	0
1	22808090	.	C	A	9	4	13	0	0	13	0	0
1	22808093	.	T	A	3	8	11	0	0	11	0	0
1	22808149	.	T	A	4	8	12	0	0	12	0	0
1	22808181	.	T	C	9	0	9	0	4	13	0	0
1	22808264	.	T	G	3	9	12	0	0	12	0	0
1	22808296	.	A	T	1	1	2	0	0	4	2	0
1	22808301	.	C	G	0	1	1	0	1	2	0	0
1	22808384	.	C	T	0	3	3	0	4	7	0	0
1	22808444	.	G	A	4	5	9	0	0	9	0	0
1	22808479	.	G	T	3	5	8	0	0	8	0	0
1	22808514	.	A	T	3	3	6	0	0	6	0	0
1	22808665	.	C	T	3	12	15	0	1	16	0	0
1	22814910	.	A	G	10	9	19	0	0	20	1	0
1	22829325	.	G	A	2	5	7	0	1	8	0	0
1	22845919	.	A	G	1	1	2	0	0	2	0	0
1	22851065	.	G	T	7	1	8	0	0	8	0	0
1	22851380	.	T	C	9	7	16	0	0	16	0	0
1	22851422	.	T	A	4	4	8	0	0	8	0	0
1	22851828	.	A	T	9	8	17	0	0	17	0	0
1	22856087	.	C	T	6	7	13	0	0	13	0	0
1	22857979	.	C	T	9	8	17	0	2	19	0	0
1	22857995	.	A	G	11	11	22	0	1	23	0	0
1	22858194	.	G	A	21	21	42	0	2	44	0	0
1	22858275	.	T	C	26	15	41	0	2	43	0	0
1	22858397	.	G	A	24	12	36	0	6	42	0	0
1	22858478	.	G	A	24	16	40	0	2	42	0	0
1	22861253	.	G	A	1	1	2	0	0	2	0	0
1	22861267	.	G	A	3	4	7	0	0	7	0	0
1	22864011	.	C	T	3	5	8	0	0	8	0	0
1	22943748	.	G	A	6	7	13	0	1	14	0	0
1	22944056	.	C	T	0	28	28	0	16	44	0	0
1	22944068	.	C	T	29	16	45	0	0	45	0	0
1	22944386	.	A	C	20	20	40	0	0	40	0	0
1	22945054	.	T	C	14	23	37	0	0	37	0	0
1	22945173	.	T	G	20	12	32	0	0	32	0	0
1	22945190	.	G	T	17	14	31	0	0	31	0	0
1	22945444	.	G	A	25	16	41	0	0	41	0	0
1	22945519	.	C	T	13	16	29	0	2	31	0	0
1	22945888	.	G	C	20	0	20	0	27	47	0	0
1	22945903	.	T	C	19	29	48	0	1	49	0	0
1	22946108	.	C	T	10	13	23	0	0	23	0	0
1	22956429	.	C	T	0	5	5	0	6	11	0	0
1	22966877	.	C	A	5	10	15	0	1	16	0	0
1	22987960	.	A	G	3	1	4	0	0	4	0	0
1	22992058	.	G	A	13	11	24	0	0	24	0	0
1	22996606	.	G	A	16	9	25	0	0	25	0	0
1	23072224	.	G	A	8	12	20	0	1	21	0	0
1	23072278	.	G	A	8	6	14	0	0	14	0	0
1	23072304	.	G	T	9	3	12	0	2	14	0	0
1	23072461	.	G	A	7	6	13	0	0	13	0	0
1	23072533	.	G	A	5	6	11	0	0	11	0	0
1	23072683	.	T	C	9	0	9	0	7	16	0	0
1	23072746	.	T	A	2	1	3	0	0	3	0	0
1	23094638	.	C	T	3	1	4	0	0	4	0	0
1	23094677	.	G	A	3	3	6	0	0	6	0	0
1	23110816	.	T	C	1	2	3	0	0	3	0	0
1	23206282	.	A	T	2	1	3	0	1	4	0	0
1	23243230	.	A	G	3	3	6	0	0	6	0	0
1	23243733	.	C	T	2	6	8	0	0	8	0	0
1	23251104	.	C	T	1	1	2	0	0	2	0	0
1	23254504	.	G	A	2	1	3	0	0	3	0	0
1	23254712	.	G	A	4	6	10	0	0	10	0	0
1	23259276	.	T	C	1	2	3	0	0	3	0	0
1	23261829	.	C	T	0	4	4	0	3	7	0	0
1	23261838	.	A	G	3	4	7	0	0	7	0	0
1	23261992	.	G	T	1	2	3	0	0	3	0	0
1	23270968	.	A	C	1	2	3	0	0	3	0	0
1	23271345	.	G	A	6	9	15	0	0	15	0	0
1	23271500	.	G	A	10	12	22	0	0	22	0	0
1	23271608	.	G	A	1	1	2	0	0	2	0	0
1	23271770	.	T	G	10	11	21	0	1	22	0	0
1	23274820	.	G	A	5	6	11	0	0	11	0	0
1	23275228	.	C	G	10	8	18	0	0	18	0	0
1	23277619	.	A	G	3	0	3	0	2	5	0	0
1	23283938	.	G	A	0	2	2	0	1	3	0	0
1	23287163	.	T	C	1	2	3	0	0	3	0	0
1	23297750	.	A	G	6	4	10	0	0	10	0	0
1	23298011	.	A	T	1	2	3	0	0	3	0	0
1	23298642	.	A	T	7	5	12	0	0	12	0	0
1	23298892	.	A	G	3	4	7	0	0	7	0	0
1	23298921	.	G	A	5	4	9	0	1	10	0	0
1	23301687	.	A	T	5	7	12	0	0	12	0	0
1	23308208	.	A	C	7	4	11	0	0	11	0	0
1	23311750	.	G	A	3	2	5	0	0	5	0	0
1	23311756	.	T	A	4	3	7	0	0	7	0	0
1	23311908	.	C	A	0	5	5	0	1	6	0	0
1	23311938	.	A	T	4	2	6	0	0	6	0	0
1	23311946	.	G	T	3	2	5	0	0	6	1	0
1	23373462	.	A	C	1	2	3	0	0	3	0	0
1	23388325	.	C	T	1	0	1	0	0	1	0	0
1	23506660	.	C	A	6	8	14	0	0	14	0	0
1	23506711	.	A	T	6	3	9	0	1	10	0	0
1	23506787	.	A	T	19	11	30	0	1	31	0	0
1	23506865	.	C	A	14	18	32	0	2	34	0	0
1	23508009	.	G	T	17	15	32	0	3	35	0	0
1	23526644	.	T	C	3	3	6	0	2	8	0	0
1	23528066	.	C	T	9	7	16	0	0	16	0	0
1	23530438	.	C	T	3	3	6	0	0	6	0	0
1	23535880	.	C	T	0	15	15	0	10	25	0	0
1	23536012	.	T	C	7	5	12	0	0	12	0	0
1	23536222	.	T	A	4	2	6	0	0	6	0	0
1	23573823	.	A	T	12	6	18	0	0	18	0	0
1	23578438	.	G	C	3	3	6	0	0	6	0	0
1	23578478	.	C	T	3	3	6	0	0	6	0	0
1	23578490	.	G	A	3	3	6	0	0	6	0	0
1	23578839	.	A	C	5	2	7	0	1	8	0	0
1	23579365	.	C	T	2	3	5	0	0	5	0	0
1	23581737	.	T	C	1	0	1	0	4	5	0	0
1	23585275	.	C	T	4	4	8	0	0	8	0	0
1	23585802	.	C	A	0	4	4	0	4	8	0	0
1	23586025	.	C	T	0	3	3	0	3	6	0	0
1	23586133	.	A	G	2	2	4	0	0	4	0	0
1	23586581	.	G	A	5	4	9	0	0	9	0	0
1	23586780	.	C	T	0	2	2	0	4	6	0	0
1	23589017	.	C	T	3	6	9	0	0	9	0	0
1	23589080	.	G	T	4	5	9	0	0	9	0	0
1	23589162	.	T	C	0	0	0	0	2	2	0	0
1	23889642	.	T	A	4	1	5	0	0	5	0	0
1	23889648	.	A	G	1	2	3	0	0	3	0	0
1	23909090	.	A	G	12	7	19	0	4	23	0	0
1	23909522	.	A	C	2	5	7	0	0	7	0	0
1	23909748	.	A	T	7	7	14	0	0	14	0	0
1	23920983	.	C	T	0	7	7	0	5	12	0	0
1	23921071	.	A	T	8	10	18	0	0	18	0	0
1	23921284	.	T	C	8	5	13	0	0	13	0	0
1	23921302	.	C	A	6	7	13	0	0	13	0	0
1	23921427	.	T	C	2	0	2	0	6	8	0	0
1	23921564	.	T	A	1	3	4	0	1	5	0	0
1	23921793	.	A	C	4	3	7	0	1	8	0	0
1	23936154	.	C	T	4	4	8	0	0	8	0	0
1	23943726	.	G	A	3	1	4	0	0	4	0	0
1	23947833	.	A	C	4	0	4	0	2	6	0	0
1	23947881	.	T	A	5	3	8	0	0	8	0	0
1	24023560	.	T	C	1	2	3	0	0	3	0	0
1	24076890	.	A	G	9	12	21	0	2	23	0	0
1	24077274	.	A	G	12	1	13	0	9	22	0	0
1	24077791	.	G	A	0	29	29	0	13	42	0	0
1	24077902	.	A	G	6	6	12	0	0	12	0	0
1	24092454	.	G	A	2	2	4	0	0	4	0	0
1	24197375	.	C	T	0	2	2	0	3	5	0	0
1	24227531	.	C	T	5	2	7	0	0	7	0	0
1	24228509	.	C	T	1	2	3	0	1	4	0	0
1	24357931	.	C	T	8	9	17	0	3	20	0	0
1	24523415	.	T	C	0	1	1	0	0	1	0	0
1	24540619	.	C	T	1	0	1	0	1	2	0	0
1	24540959	.	A	G	0	2	2	0	0	2	0	0
1	24557100	.	A	G	1	0	1	0	0	1	0	0
1	24557510	.	G	A	2	4	6	0	1	7	0	0
1	24558336	.	C	G	2	7	9	0	0	9	0	0
1	24558410	.	T	A	3	3	6	0	0	6	0	0
1	24871075	.	A	G	12	7	19	0	1	20	0	0
1	24871079	.	A	G	11	7	18	0	2	20	0	0
1	24879994	.	C	T	4	5	9	0	0	9	0	0
1	24902745	.	T	C	7	1	8	0	7	15	0	0
1	24908001	.	T	C	6	0	6	0	10	16	0	0
1	25024060	.	T	C	2	0	2	0	3	5	0	0
1	25024066	.	C	T	0	0	0	0	5	5	0	0
1	25215992	.	A	T	3	2	5	0	0	5	0	0
1	25281601	.	A	C	1	2	3	0	0	3	0	0
1	25296797	.	C	T	9	12	21	0	1	22	0	0
1	25296831	.	C	T	9	6	15	0	0	15	0	0
1	25305290	.	A	T	7	9	16	0	1	17	0	0
1	25305446	.	T	G	12	1	13	0	7	20	0	0
1	25310899	.	C	A	2	5	7	0	1	8	0	0
1	25310912	.	T	A	3	2	5	0	1	6	0	0
1	25313056	.	C	T	9	6	15	0	0	15	0	0
1	25313261	.	T	C	0	1	1	0	1	2	0	0
1	25313300	.	G	A	1	1	2	0	0	2	0	0
1	25322961	.	A	G	2	2	4	0	0	4	0	0
1	25327222	.	G	A	3	4	7	0	0	7	0	0
1	25327267	.	A	C	2	0	2	0	3	5	0	0
1	25400814	.	T	A	2	4	6	0	0	6	0	0
1	25401158	.	T	C	1	0	1	0	3	4	0	0
1	25401181	.	G	A	2	2	4	0	0	4	0	0
1	25402203	.	C	T	0	3	3	0	5	8	0	0
1	25402229	.	T	C	2	3	5	0	0	5	0	0
1	25419911	.	T	G	1	3	4	0	1	5	0	0
1	25419936	.	A	G	1	3	4	0	0	4	0	0
1	25419973	.	T	G	1	2	3	0	0	3	0	0
1	25438705	.	G	A	2	2	4	0	0	4	0	0
1	25443085	.	G	A	1	4	5	0	0	5	0	0
1	25448465	.	A	T	1	3	4	0	0	4	0	0
1	25654976	.	C	T	0	1	1	0	0	1	0	0
1	25741901	.	A	G	1	2	3	0	0	3	0	0
1	25742951	.	C	T	2	4	6	0	0	6	0	0
1	25748406	.	G	A	1	2	3	0	0	3	0	0
1	25798792	.	T	A	2	6	8	0	1	9	0	0
1	25798863	.	G	C	5	4	9	0	0	9	0	0
1	25798983	.	A	C	1	4	5	0	0	5	0	0
1	25811411	.	T	C	8	6	14	0	3	17	0	0
1	25812658	.	C	T	2	2	4	0	1	5	0	0
1	25863511	.	G	A	4	5	9	0	2	11	0	0
1	25863638	.	A	T	10	4	14	0	0	14	0	0
1	25911481	.	T	C	5	2	7	0	0	7	0	0
1	25918405	.	C	T	2	3	5	0	0	5	0	0
1	26012748	.	G	T	3	2	5	0	0	5	0	0
1	26012755	.	G	A	3	1	4	0	0	4	0	0
1	26044934	.	G	T	7	3	10	0	1	11	0	0
1	26046323	.	A	G	6	4	10	0	0	10	0	0
1	26046950	.	T	A	6	17	23	0	0	23	0	0
1	26046996	.	A	T	9	19	28	0	0	28	0	0
1	26063007	.	G	T	4	6	10	0	0	10	0	0
1	26063030	.	G	A	5	8	13	0	0	13	0	0
1	26071949	.	A	T	4	4	8	0	0	8	0	0
1	26096270	.	C	T	2	2	4	0	0	4	0	0
1	26096522	.	G	T	8	11	19	0	0	19	0	0
1	26108487	.	C	T	1	2	3	0	0	3	0	0
1	26127339	.	A	G	8	11	19	0	0	19	0	0
1	26127856	.	A	T	11	6	17	0	0	17	0	0
1	26252033	.	C	T	0	9	9	0	6	15	0	0
1	26252215	.	T	C	5	3	8	0	1	9	0	0
1	26252308	.	G	C	4	3	7	0	0	7	0	0
1	26252323	.	A	T	2	2	4	0	0	4	0	0
1	26252814	.	C	T	5	3	8	0	0	9	1	0
1	26252877	.	G	A	6	4	10	0	0	10	0	0
1	26375404	.	C	A	8	5	13	0	1	14	0	0
1	26376176	.	G	A	2	4	6	0	0	6	0	0
1	26376327	.	C	T	3	7	10	0	0	10	0	0
1	26376816	.	A	T	4	3	7	0	0	7	0	0
1	26377593	.	G	A	2	2	4	0	1	5	0	0
1	26382809	.	A	T	13	9	22	0	1	23	0	0
1	26383281	.	G	T	0	9	9	0	6	15	0	0
1	26383466	.	G	A	2	6	8	0	1	9	0	0
1	26384629	.	C	T	3	2	5	0	1	6	0	0
1	26384638	.	G	A	3	3	6	0	0	6	0	0
1	26384682	.	G	A	0	4	4	0	0	4	0	0
1	26384721	.	A	G	1	3	4	0	1	5	0	0
1	26385222	.	C	G	6	5	11	0	0	11	0	0
1	26385939	.	A	G	3	8	11	0	1	12	0	0
1	26391533	.	T	C	2	2	4	0	0	4	0	0
1	26391649	.	C	T	0	3	3	0	5	8	0	0
1	26391698	.	A	G	4	2	6	0	0	6	0	0
1	26391891	.	A	G	1	2	3	0	0	3	0	0
1	26394436	.	A	C	3	0	3	0	1	4	0	0
1	26445032	.	C	A	4	5	9	0	0	9	0	0
1	26454576	.	G	C	2	2	4	0	0	4	0	0
1	26463488	.	T	G	4	0	4	0	7	11	0	0
1	26463671	.	T	A	4	9	13	0	0	13	0	0
1	26463692	.	C	T	9	6	15	0	0	15	0	0
1	26463779	.	T	A	2	4	6	0	0	6	0	0
1	26463931	.	A	T	4	9	13	0	0	13	0	0
1	26464175	.	G	A	1	4	5	0	0	5	0	0
1	26464259	.	C	T	9	3	12	0	0	12	0	0
1	26464353	.	A	G	9	6	15	0	0	15	0	0
1	26464446	.	G	A	5	10	15	0	0	15	0	0
1	26464758	.	T	A	11	8	19	0	0	20	1	0
1	26465041	.	G	T	15	8	23	0	0	23	0	0
1	26465047	.	A	C	9	16	25	0	1	26	0	0
1	26465224	.	T	A	8	14	22	0	1	23	0	0
1	26467125	.	T	A	2	8	10	0	0	10	0	0
1	26467243	.	G	A	1	2	3	0	0	3	0	0
1	26480970	.	G	C	0	3	3	0	0	3	0	0
1	26489854	.	G	A	5	4	9	0	0	9	0	0
1	26498400	.	C	T	4	5	9	0	0	9	0	0
1	26498657	.	G	A	0	9	9	0	6	15	0	0
1	26504998	.	G	A	3	4	7	0	0	7	0	0
1	26505282	.	T	C	11	17	28	0	1	29	0	0
1	26505291	.	C	T	14	14	28	0	0	28	0	0
1	26507356	.	G	A	8	3	11	0	0	11	0	0
1	26507392	.	T	A	7	6	13	0	0	13	0	0
1	26507582	.	G	A	4	7	11	0	1	12	0	0
1	26507764	.	A	G	11	0	11	0	5	16	0	0
1	26638053	.	G	C	3	4	7	0	0	7	0	0
1	26827238	.	A	G	4	2	6	0	0	6	0	0
1	26827519	.	G	A	5	6	11	0	0	11	0	0
1	27207986	.	A	G	9	0	9	0	5	14	0	0
1	27208703	.	A	T	2	2	4	0	0	4	0	0
1	27209628	.	A	C	3	7	10	0	0	10	0	0
1	27209904	.	T	G	2	7	9	0	1	10	0	0
1	27210057	.	T	C	4	5	9	0	0	9	0	0
1	27210073	.	T	C	5	3	8	0	1	9	0	0
1	27210231	.	C	T	4	7	11	0	0	11	0	0
1	27210578	.	G	A	6	5	11	0	1	12	0	0
1	27210929	.	C	T	9	7	16	0	0	16	0	0
1	27809162	.	T	C	8	11	19	0	0	19	0	0
1	27826090	.	C	A	4	9	13	0	1	14	0	0
1	27826198	.	C	T	6	13	19	0	3	22	0	0
1	27826651	.	T	C	17	13	30	0	1	31	0	0
1	27842373	.	G	A	0	4	4	0	2	6	0	0
1	27893097	.	T	C	1	1	2	0	0	2	0	0
1	27893550	.	T	A	3	4	7	0	0	7	0	0
1	27893920	.	A	T	2	3	5	0	0	5	0	0
1	28018821	.	C	T	10	18	28	0	0	28	0	0
1	28018988	.	T	A	5	4	9	0	0	9	0	0
1	28035590	.	T	C	1	1	2	0	0	2	0	0
1	28035786	.	C	T	4	2	6	0	0	6	0	0
1	28036159	.	A	C	5	3	8	0	0	8	0	0
1	28046218	.	T	C	13	10	23	0	0	23	0	0
1	28046224	.	A	G	15	1	16	0	9	25	0	0
1	28067976	.	T	A	3	3	6	0	0	6	0	0
1	28195137	.	T	C	1	2	3	0	0	3	0	0
1	28391882	.	C	G	8	8	16	0	1	17	0	0
1	28391914	.	C	T	0	4	4	0	8	12	0	0
1	28422569	.	C	T	1	2	3	0	0	3	0	0
1	28724010	.	G	T	2	3	5	0	0	5	0	0
1	28788272	.	G	A	3	4	7	0	0	7	0	0
1	28809127	.	A	C	1	0	1	0	0	1	0	0
1	28833740	.	T	G	2	4	6	0	0	6	0	0
1	28834148	.	T	C	3	1	4	0	0	4	0	0
1	28834156	.	C	T	2	2	4	0	0	4	0	0
1	28834209	.	A	T	1	2	3	0	0	3	0	0
1	28835311	.	C	T	1	2	3	0	1	4	0	0
1	28835669	.	T	C	3	7	10	0	1	11	0	0
1	28874819	.	C	T	1	3	4	0	0	4	0	0
1	28899224	.	C	A	0	4	4	0	0	4	0	0
1	28899350	.	G	A	6	4	10	0	0	10	0	0
1	28899483	.	G	A	4	4	8	0	0	8	0	0
1	28899530	.	T	C	4	2	6	0	0	6	0	0
1	28964703	.	A	G	5	0	5	0	0	5	0	0
1	28964708	.	A	T	0	2	2	0	0	2	0	0
1	28965095	.	G	A	5	6	11	0	0	11	0	0
1	28979080	.	A	C	1	0	1	0	0	1	0	0
1	28979161	.	G	C	22	0	22	0	19	41	0	0
1	28986486	.	C	T	11	23	34	0	2	36	0	0
1	29045226	.	G	A	19	20	39	0	1	40	0	0
1	29141070	.	G	A	2	2	4	0	0	4	0	0
1	29162674	.	G	A	0	2	2	0	2	4	0	0
1	29178897	.	C	T	1	0	1	0	0	1	0	0
1	29201933	.	G	C	5	5	10	0	0	10	0	0
1	29202110	.	T	C	2	3	5	0	0	5	0	0
1	29202368	.	G	A	1	0	1	0	2	3	0	0
1	29202379	.	A	G	3	0	3	0	2	5	0	0
1	29211619	.	T	A	5	1	6	0	1	7	0	0
1	29211636	.	T	C	3	3	6	0	0	6	0	0
1	29211895	.	T	A	2	4	6	0	0	6	0	0
1	29212165	.	T	C	4	3	7	0	0	7	0	0
1	29213107	.	A	G	12	0	12	0	4	16	0	0
1	29227642	.	T	A	4	2	6	0	0	6	0	0
1	29227770	.	C	T	3	2	5	0	0	5	0	0
1	29227880	.	G	T	1	2	3	0	0	3	0	0
1	29228390	.	A	T	3	1	4	0	0	4	0	0
1	29270942	.	C	T	3	4	7	0	1	8	0	0
1	29282145	.	C	T	3	4	7	0	0	7	0	0
1	29282836	.	C	T	2	5	7	0	1	8	0	0
1	29389975	.	T	C	3	5	8	0	0	8	0	0
1	29389987	.	C	T	5	3	8	0	0	8	0	0
1	29608585	.	T	C	0	2	2	0	0	2	0	0
1	29731965	.	T	G	3	5	8	0	0	8	0	0
1	29732217	.	C	T	2	2	4	0	0	4	0	0
1	29732256	.	T	C	0	1	1	0	0	1	0	0
1	29740821	.	T	C	2	0	2	0	6	8	0	0
1	29745171	.	G	T	1	1	2	0	0	2	0	0
1	29752319	.	T	C	9	7	16	0	0	16	0	0
1	29752421	.	A	G	6	5	11	0	0	11	0	0
1	29754673	.	A	G	9	5	14	0	1	15	0	0
1	29754963	.	G	A	4	3	7	0	0	7	0	0
1	29754981	.	A	G	4	3	7	0	0	7	0	0
1	29757083	.	G	A	3	4	7	0	1	8	0	0
1	29758042	.	G	A	5	7	12	0	0	12	0	0
1	29770360	.	T	A	1	2	3	0	0	3	0	0
1	29772391	.	A	G	3	6	9	0	0	9	0	0
1	29772615	.	T	C	0	1	1	0	0	1	0	0
1	29772741	.	C	T	3	1	4	0	0	4	0	0
1	29775664	.	C	A	10	4	14	0	0	14	0	0
1	29779300	.	G	C	6	11	17	0	0	17	0	0
1	29779402	.	G	A	0	6	6	0	2	8	0	0
1	29781462	.	G	A	3	3	6	0	0	6	0	0
1	29781597	.	A	T	4	7	11	0	1	12	0	0
1	29786570	.	G	A	10	4	14	0	2	16	0	0
1	29786659	.	T	G	6	1	7	0	9	16	0	0
1	29786704	.	A	G	11	6	17	0	0	17	0	0
1	29787397	.	G	A	6	4	10	0	2	12	0	0
1	29789889	.	C	T	7	9	16	0	0	16	0	0
1	29790030	.	A	T	8	10	18	0	1	19	0	0
1	29795692	.	G	A	11	6	17	0	0	17	0	0
1	29797191	.	T	C	2	5	7	0	0	7	0	0
1	29797344	.	G	T	8	11	19	0	1	20	0	0
1	29797345	.	A	T	8	12	20	0	0	20	0	0
1	29797387	.	A	C	6	9	15	0	0	15	0	0
1	29797699	.	T	G	6	10	16	0	0	16	0	0
1	29798203	.	A	G	13	8	21	0	0	21	0	0
1	29798262	.	T	C	14	5	19	0	0	19	0	0
1	29798324	.	G	T	1	7	8	0	8	16	0	0
1	29798340	.	G	A	0	9	9	0	10	19	0	0
1	29804658	.	A	T	1	1	2	0	0	2	0	0
1	29805251	.	C	T	3	8	11	0	0	11	0	0
1	29806547	.	C	T	6	7	13	0	2	15	0	0
1	29813246	.	C	A	2	1	3	0	0	3	0	0
1	29813276	.	C	T	10	5	15	0	1	16	0	0
1	29817451	.	C	A	6	6	12	0	1	13	0	0
1	29820831	.	C	T	18	21	39	0	0	39	0	0
1	29823603	.	T	C	11	18	29	0	1	30	0	0
1	29823690	.	T	A	25	11	36	0	3	39	0	0
1	29823701	.	A	G	23	14	37	0	3	40	0	0
1	29860326	.	T	A	6	4	10	0	0	11	1	0
1	29891937	.	C	T	1	0	1	0	0	1	0	0
1	29916178	.	G	A	4	3	7	0	0	7	0	0
1	29952918	.	A	T	4	4	8	0	0	8	0	0
1	29953069	.	G	A	8	5	13	0	0	13	0	0
1	29953239	.	G	T	0	6	6	0	9	15	0	0
1	29953253	.	A	G	11	0	11	0	7	18	0	0
1	29954844	.	T	C	4	4	8	0	0	8	0	0
1	29954972	.	C	T	12	10	22	0	0	22	0	0
1	29955006	.	G	A	6	8	14	0	3	17	0	0
1	29955171	.	G	A	10	10	20	0	0	20	0	0
1	29955179	.	A	G	9	7	16	0	1	17	0	0
1	29955228	.	C	T	4	4	8	0	0	8	0	0
1	29955249	.	A	G	1	3	4	0	0	4	0	0
1	30038844	.	A	C	5	9	14	0	1	15	0	0
1	30039302	.	T	A	6	4	10	0	0	10	0	0
1	30103483	.	C	A	1	2	3	0	0	3	0	0
1	30180924	.	G	A	0	0	0	0	1	1	0	0
1	30180929	.	T	A	0	1	1	0	0	1	0	0
1	30183309	.	C	G	0	2	2	0	0	2	0	0
1	30212461	.	G	A	4	4	8	0	0	8	0	0
1	30212793	.	G	A	2	3	5	0	0	5	0	0
1	30250557	.	T	C	2	5	7	0	0	7	0	0
1	30255365	.	G	A	16	9	25	0	0	25	0	0
1	30255458	.	A	C	1	3	4	0	0	4	0	0
1	30282841	.	G	T	2	2	4	0	0	4	0	0
1	30343967	.	T	G	9	9	18	0	0	18	0	0
1	30344842	.	A	G	7	7	14	0	0	14	0	0
1	30345026	.	T	C	6	5	11	0	0	11	0	0
1	30345029	.	C	T	6	5	11	0	0	11	0	0
1	30345075	.	G	T	7	6	13	0	0	13	0	0
1	30345239	.	G	C	7	3	10	0	0	10	0	0
1	30345243	.	T	C	6	3	9	0	0	9	0	0
1	30345421	.	C	T	3	2	5	0	0	5	0	0
1	30345485	.	A	C	2	2	4	0	0	4	0	0
1	30345531	.	A	G	2	4	6	0	0	6	0	0
1	30345635	.	T	G	2	4	6	0	2	8	0	0
1	30345669	.	T	G	4	6	10	0	0	10	0	0
1	30345838	.	C	T	3	1	4	0	0	4	0	0
1	30345839	.	C	T	3	0	3	0	1	4	0	0
1	30346042	.	G	A	3	5	8	0	0	8	0	0
1	30346112	.	T	C	3	2	5	0	0	5	0	0
1	30346124	.	T	A	3	3	6	0	0	6	0	0
1	30346233	.	G	A	5	3	8	0	1	9	0	0
1	30346377	.	G	A	5	3	8	0	0	8	0	0
1	30346385	.	G	A	3	6	9	0	0	9	0	0
1	30346432	.	T	G	8	3	11	0	0	11	0	0
1	30346456	.	G	A	2	5	7	0	0	7	0	0
1	30346845	.	G	T	6	6	12	0	0	12	0	0
1	30346906	.	C	A	1	12	13	0	1	14	0	0
1	30346977	.	C	A	8	14	22	0	1	23	0	0
1	30347027	.	C	A	11	7	18	0	0	18	0	0
1	30347043	.	T	C	10	0	10	0	6	17	1	0
1	30347586	.	C	T	4	6	10	0	1	11	0	0
1	30366800	.	T	A	3	10	13	0	1	14	0	0
1	30540065	.	G	A	2	5	7	0	0	7	0	0
1	30540092	.	T	A	2	5	7	0	0	7	0	0
1	30540535	.	C	T	3	1	4	0	1	5	0	0
1	30557628	.	G	T	0	1	1	0	0	1	0	0
1	30568183	.	C	T	0	4	4	0	2	6	0	0
1	30568197	.	G	A	2	2	4	0	0	4	0	0
1	30589258	.	C	A	0	1	1	0	0	1	0	0
1	30641002	.	G	A	3	1	4	0	0	4	0	0
1	30688453	.	G	A	2	7	9	0	1	10	0	0
1	30688606	.	C	T	2	6	8	0	3	11	0	0
1	30688802	.	G	A	1	3	4	0	0	4	0	0
1	30688924	.	G	T	7	4	11	0	0	11	0	0
1	30718394	.	T	C	2	0	2	0	2	4	0	0
1	30718538	.	C	G	7	13	20	0	1	21	0	0
1	30718567	.	A	C	2	0	2	0	8	10	0	0
1	30733871	.	G	A	0	2	2	0	1	3	0	0
1	30747216	.	C	T	0	0	0	0	1	1	0	0
1	30955972	.	C	A	2	2	4	0	0	4	0	0
1	31063836	.	T	C	2	2	4	0	0	4	0	0
1	31064308	.	C	T	1	4	5	0	0	5	0	0
1	31072348	.	A	C	6	9	15	0	0	15	0	0
1	31072589	.	C	T	3	2	5	0	0	5	0	0
1	31072604	.	A	C	2	3	5	0	0	5	0	0
1	31072843	.	C	T	3	6	9	0	0	9	0	0
1	31072863	.	A	G	4	3	7	0	0	7	0	0
1	31075158	.	C	T	0	2	2	0	4	6	0	0
1	31079822	.	C	T	2	0	2	0	0	2	0	0
1	31083169	.	C	T	0	0	0	0	3	3	0	0
1	31083271	.	G	A	3	3	6	0	0	6	0	0
1	31085882	.	C	T	0	5	5	0	0	5	0	0
1	31086137	.	T	C	0	8	8	0	0	8	0	0
1	31090873	.	G	A	6	2	8	0	0	8	0	0
1	31091313	.	T	C	1	2	3	0	0	3	0	0
1	31091473	.	C	T	1	1	2	0	1	3	0	0
1	31091616	.	C	T	7	3	10	0	0	10	0	0
1	31091995	.	T	A	0	1	1	0	0	1	0	0
1	31102588	.	T	C	2	0	2	0	2	4	0	0
1	31102677	.	T	C	4	3	7	0	0	7	0	0
1	31102986	.	C	T	3	3	6	0	0	6	0	0
1	31103311	.	A	G	1	3	4	0	0	4	0	0
1	31103376	.	G	A	2	3	5	0	0	5	0	0
1	31103427	.	C	A	0	5	5	0	0	5	0	0
1	31103890	.	C	A	1	3	4	0	0	4	0	0
1	31112466	.	G	C	8	10	18	0	0	18	0	0
1	31112468	.	G	A	8	9	17	0	1	18	0	0
1	31117686	.	G	A	26	16	42	0	2	44	0	0
1	31117695	.	T	C	27	16	43	0	0	43	0	0
1	31119296	.	C	T	23	21	44	0	0	44	0	0
1	31122596	.	G	A	31	24	55	0	0	55	0	0
1	31130005	.	T	C	23	17	40	0	0	40	0	0
1	31130028	.	T	C	19	20	39	0	1	40	0	0
1	31130094	.	G	A	1	12	13	0	21	34	0	0
1	31130176	.	T	C	4	8	12	0	0	12	0	0
1	31136018	.	G	A	2	5	7	0	0	7	0	0
1	31136477	.	A	G	1	5	6	0	1	7	0	0
1	31349556	.	G	A	1	1	2	0	2	4	0	0
1	31374780	.	A	T	11	7	18	0	0	18	0	0
1	31386255	.	T	C	12	6	18	0	0	18	0	0
1	31423014	.	C	T	0	4	4	0	14	18	0	0
1	31423099	.	G	T	3	3	6	0	0	6	0	0
1	31428150	.	G	A	8	7	15	0	0	15	0	0
1	31430665	.	A	G	1	2	3	0	0	3	0	0
1	31445770	.	A	G	5	9	14	0	0	14	0	0
1	31445874	.	T	A	7	4	11	0	1	12	0	0
1	31472033	.	A	G	8	7	15	0	0	15	0	0
1	31509549	.	T	C	1	1	2	0	0	2	0	0
1	31642058	.	C	T	0	1	1	0	0	1	0	0
1	31642061	.	C	T	0	1	1	0	0	1	0	0
1	31657604	.	T	C	5	0	5	0	0	5	0	0
1	31659981	.	A	C	1	3	4	0	0	4	0	0
1	31660952	.	A	G	1	0	1	0	1	2	0	0
1	31661165	.	T	C	5	3	8	0	0	8	0	0
1	31664892	.	C	T	3	1	4	0	0	4	0	0
1	31667491	.	C	T	4	4	8	0	0	8	0	0
1	31671721	.	C	T	4	2	6	0	0	6	0	0
1	31671746	.	C	A	3	3	6	0	0	6	0	0
1	31671958	.	G	A	0	11	11	0	4	15	0	0
1	31672078	.	G	A	3	4	7	0	0	7	0	0
1	31690131	.	G	A	0	2	2	0	0	2	0	0
1	31706694	.	C	A	1	0	1	0	0	1	0	0
1	31709574	.	A	G	0	5	5	0	0	5	0	0
1	31711918	.	G	A	0	1	1	0	0	1	0	0
1	31789260	.	G	A	0	1	1	0	0	1	0	0
1	31793920	.	A	G	1	0	1	0	1	2	0	0
1	31797386	.	A	G	1	3	4	0	0	4	0	0
1	31797488	.	C	T	7	2	9	0	1	10	0	0
1	31797503	.	G	A	1	5	6	0	1	7	0	0
1	31797533	.	C	T	1	2	3	0	0	3	0	0
1	31798794	.	T	C	1	2	3	0	1	4	0	0
1	31798821	.	C	T	2	4	6	0	0	6	0	0
1	31809184	.	A	T	3	6	9	0	2	11	0	0
1	31809302	.	G	A	2	5	7	0	0	7	0	0
1	31809332	.	G	A	1	6	7	0	0	7	0	0
1	31809496	.	G	A	9	11	20	0	0	20	0	0
1	31813229	.	A	G	4	1	5	0	0	5	0	0
1	31813283	.	A	G	10	7	17	0	0	17	0	0
1	31813355	.	T	C	1	2	3	0	0	3	0	0
1	31818237	.	G	A	9	4	13	0	0	13	0	0
1	31865172	.	G	A	1	5	6	0	2	8	0	0
1	31865387	.	G	A	10	4	14	0	0	14	0	0
1	31866684	.	G	A	1	1	2	0	0	2	0	0
1	31867264	.	T	A	13	16	29	0	0	29	0	0
1	31867314	.	C	T	12	8	20	0	0	20	0	0
1	31867449	.	C	T	9	9	18	0	0	18	0	0
1	31867589	.	G	A	7	6	13	0	0	13	0	0
1	31943042	.	T	G	7	0	7	0	9	16	0	0
1	33281948	.	A	G	2	4	6	0	0	6	0	0
1	33327007	.	C	A	1	2	3	0	0	3	0	0
1	33332069	.	T	C	1	2	3	0	0	3	0	0
1	33355834	.	T	G	1	5	6	0	0	6	0	0
1	33356259	.	A	T	3	1	4	0	3	7	0	0
1	33356316	.	A	C	2	2	4	0	0	4	0	0
1	33356398	.	T	C	4	3	7	0	0	7	0	0
1	33356430	.	A	G	6	2	8	0	1	9	0	0
1	33384062	.	G	A	6	4	10	0	1	11	0	0
1	33404001	.	A	G	1	1	2	0	0	2	0	0
1	33449334	.	C	A	3	0	3	0	0	3	0	0
1	33457733	.	C	T	5	7	12	0	0	12	0	0
1	33484129	.	C	G	6	6	12	0	0	12	0	0
1	33484288	.	T	C	9	11	20	0	1	21	0	0
1	33484293	.	C	A	9	12	21	0	0	21	0	0
1	33484404	.	C	T	11	5	16	0	0	16	0	0
1	33484652	.	T	C	10	7	17	0	0	17	0	0
1	33485692	.	A	G	13	0	13	0	11	24	0	0
1	33548262	.	A	T	1	4	5	0	0	5	0	0
1	33556056	.	G	A	5	6	11	0	1	12	0	0
1	33561520	.	A	G	3	0	3	0	6	9	0	0
1	33561544	.	C	T	8	12	20	0	0	20	0	0
1	33568153	.	A	T	15	9	24	0	1	25	0	0
1	33568211	.	A	G	6	0	6	0	10	16	0	0
1	33568260	.	A	C	4	7	11	0	0	11	0	0
1	33568266	.	G	A	7	4	11	0	0	11	0	0
1	33568303	.	G	A	0	5	5	0	8	13	0	0
1	33568454	.	G	T	5	8	13	0	0	13	0	0
1	33568520	.	G	A	12	7	19	0	1	20	0	0
1	33568836	.	T	G	0	20	20	0	1	21	0	0
1	33568976	.	G	T	0	17	17	0	14	31	0	0
1	33634191	.	T	C	0	2	2	0	0	2	0	0
1	33634299	.	T	C	1	2	3	0	0	3	0	0
1	33634326	.	C	T	1	2	3	0	0	3	0	0
1	33634356	.	C	T	2	2	4	0	0	4	0	0
1	33634380	.	G	T	1	3	4	0	0	4	0	0
1	33635121	.	C	T	1	3	4	0	0	4	0	0
1	33656317	.	A	T	6	2	8	0	1	9	0	0
1	33656560	.	C	G	0	5	5	0	0	5	0	0
1	33656831	.	G	A	2	5	7	0	0	7	0	0
1	33656900	.	T	G	4	2	6	0	0	6	0	0
1	33657793	.	A	G	5	3	8	0	0	8	0	0
1	33657904	.	G	A	0	3	3	0	7	10	0	0
1	33658030	.	G	A	0	6	6	0	4	10	0	0
1	33658065	.	T	G	7	4	11	0	0	11	0	0
1	33658669	.	A	G	2	0	2	0	5	7	0	0
1	33658852	.	C	A	1	7	8	0	1	9	0	0
1	33658945	.	C	T	6	3	9	0	0	9	0	0
1	33658971	.	C	T	5	5	10	0	0	10	0	0
1	33659374	.	C	T	0	2	2	0	0	2	0	0
1	33686477	.	G	A	1	4	5	0	0	5	0	0
1	33686513	.	G	T	6	6	12	0	1	13	0	0
1	33687177	.	A	T	10	7	17	0	2	19	0	0
1	33693919	.	C	A	3	3	6	0	0	6	0	0
1	33694198	.	T	A	2	9	11	0	0	11	0	0
1	33694327	.	C	T	8	7	15	0	0	15	0	0
1	33694357	.	T	A	7	8	15	0	0	15	0	0
1	33694517	.	T	A	3	6	9	0	0	9	0	0
1	33701368	.	C	T	0	1	1	0	0	1	0	0
1	33722249	.	A	T	1	2	3	0	0	3	0	0
1	33722251	.	A	T	1	2	3	0	0	3	0	0
1	33969170	.	C	G	12	5	17	0	0	17	0	0
1	33969389	.	A	T	3	6	9	0	0	9	0	0
1	33969445	.	G	T	5	6	11	0	0	11	0	0
1	34043394	.	T	C	9	11	20	0	0	20	0	0
1	34134691	.	G	A	0	7	7	0	13	20	0	0
1	34137711	.	T	C	11	11	22	0	1	23	0	0
1	34137741	.	T	C	6	7	13	0	1	14	0	0
1	34137768	.	A	C	3	1	4	0	0	4	0	0
1	34176504	.	C	T	0	5	5	0	0	5	0	0
1	34176808	.	A	T	2	1	3	0	0	3	0	0
1	34199906	.	G	T	14	17	31	0	0	31	0	0
1	34199913	.	C	T	13	22	35	0	0	35	0	0
1	34232407	.	A	G	7	4	11	0	0	11	0	0
1	34232514	.	G	A	5	5	10	0	0	10	0	0
1	34232551	.	A	C	5	9	14	0	0	14	0	0
1	34232744	.	T	A	12	15	27	0	0	27	0	0
1	34232761	.	A	G	12	12	24	0	1	25	0	0
1	34232879	.	T	C	13	10	23	0	0	23	0	0
1	34232929	.	C	T	10	5	15	0	1	16	0	0
1	34232931	.	G	A	11	5	16	0	0	16	0	0
1	34233096	.	C	A	15	8	23	0	1	24	0	0
1	34233145	.	G	T	6	10	16	0	2	18	0	0
1	34233198	.	C	A	6	6	12	0	0	12	0	0
1	34233238	.	A	G	7	5	12	0	0	12	0	0
1	34233301	.	A	G	12	0	12	0	4	16	0	0
1	34233548	.	T	G	1	6	7	0	1	8	0	0
1	34258077	.	C	A	3	4	7	0	0	7	0	0
1	34258971	.	C	T	6	8	14	0	0	14	0	0
1	34259411	.	A	T	3	3	6	0	0	6	0	0
1	34259452	.	T	A	4	4	8	0	1	9	0	0
1	34259750	.	A	T	5	2	7	0	0	7	0	0
1	34259759	.	T	C	2	3	5	0	1	6	0	0
1	34261230	.	A	T	12	6	18	0	0	18	0	0
1	34261358	.	A	G	15	0	15	0	9	24	0	0
1	34261393	.	G	A	0	10	10	0	5	15	0	0
1	34261654	.	T	C	8	5	13	0	0	13	0	0
1	34296606	.	A	T	18	16	34	0	0	34	0	0
1	34297112	.	C	A	7	6	13	0	1	14	0	0
1	34297135	.	C	T	8	7	15	0	2	17	0	0
1	34540552	.	C	G	3	0	3	0	4	7	0	0
1	34540564	.	G	A	0	2	2	0	3	5	0	0
1	34540606	.	G	A	3	4	7	0	0	7	0	0
1	34540714	.	G	A	0	2	2	0	2	4	0	0
1	34540750	.	G	T	4	3	7	0	0	7	0	0
1	34555559	.	C	T	4	2	6	0	0	6	0	0
1	34556148	.	T	A	2	3	5	0	0	5	0	0
1	34556241	.	A	C	1	5	6	0	1	7	0	0
1	34617680	.	C	A	4	1	5	0	0	5	0	0
1	34685529	.	C	G	7	7	14	0	0	14	0	0
1	34685603	.	A	G	4	2	6	0	0	6	0	0
1	34688988	.	C	T	10	6	16	0	1	17	0	0
1	34689001	.	T	C	10	6	16	0	1	17	0	0
1	34693831	.	C	T	7	6	13	0	1	14	0	0
1	34695423	.	G	A	7	18	25	0	1	26	0	0
1	34695476	.	G	A	6	22	28	0	2	30	0	0
1	34696017	.	G	A	1	0	1	0	0	1	0	0
1	34703048	.	T	A	1	2	3	0	0	3	0	0
1	34703272	.	A	G	2	1	3	0	0	3	0	0
1	34706526	.	G	A	10	6	16	0	1	17	0	0
1	34706773	.	A	G	3	2	5	0	0	5	0	0
1	34707958	.	T	C	13	11	24	0	2	26	0	0
1	34708145	.	C	T	1	27	28	0	31	59	0	0
1	34712097	.	A	G	3	3	6	0	0	6	0	0
1	34806975	.	A	T	2	2	4	0	0	4	0	0
1	35232521	.	A	C	5	4	9	0	0	9	0	0
1	35232834	.	C	A	5	5	10	0	0	10	0	0
1	35475879	.	G	A	1	2	3	0	0	3	0	0
1	35479501	.	A	G	0	0	0	0	1	1	0	0
1	35481768	.	T	C	4	4	8	0	0	8	0	0
1	35481777	.	G	A	3	4	7	0	1	8	0	0
1	35482482	.	G	A	0	0	0	0	2	2	0	0
1	35482485	.	C	T	2	0	2	0	0	2	0	0
1	35484358	.	C	T	5	3	8	0	0	8	0	0
1	35484931	.	T	C	3	2	5	0	0	5	0	0
1	35484977	.	A	T	3	2	5	0	0	5	0	0
1	35485056	.	G	A	7	6	13	0	0	13	0	0
1	35485105	.	G	A	0	5	5	0	8	13	0	0
1	35485175	.	A	C	8	6	14	0	0	14	0	0
1	35485263	.	C	A	1	4	5	0	0	5	0	0
1	35485289	.	C	T	2	3	5	0	0	5	0	0
1	35485378	.	C	T	4	6	10	0	0	10	0	0
1	35488211	.	A	T	5	4	9	0	0	9	0	0
1	35488332	.	G	A	3	2	5	0	0	5	0	0
1	35586579	.	C	A	0	1	1	0	0	1	0	0
1	35607830	.	G	A	7	8	15	0	0	15	0	0
1	35608041	.	G	A	0	5	5	0	10	15	0	0
1	35608308	.	C	T	8	3	11	0	0	11	0	0
1	35608619	.	T	C	1	2	3	0	0	3	0	0
1	35608821	.	G	A	3	3	6	0	0	6	0	0
1	35608826	.	G	T	3	1	4	0	1	5	0	0
1	35608941	.	A	C	4	4	8	0	0	8	0	0
1	35609192	.	A	G	3	3	6	0	0	6	0	0
1	35609431	.	T	C	6	3	9	0	0	9	0	0
1	35609474	.	G	A	4	7	11	0	0	11	0	0
1	35609530	.	T	A	2	2	4	0	0	4	0	0
1	35810172	.	C	A	1	2	3	0	0	3	0	0
1	35811779	.	C	A	1	1	2	0	0	2	0	0
1	35811854	.	C	T	3	6	9	0	0	9	0	0
1	35812128	.	T	C	3	3	6	0	0	6	0	0
1	35812155	.	T	C	1	0	1	0	0	1	0	0
1	35815706	.	A	C	1	0	1	0	0	1	0	0
1	35834554	.	G	T	3	5	8	0	0	8	0	0
1	35834712	.	A	C	1	3	4	0	1	5	0	0
1	35835237	.	G	A	0	10	10	0	8	18	0	0
1	35835371	.	A	C	12	9	21	0	0	21	0	0
1	35835502	.	C	T	7	7	14	0	0	14	0	0
1	35897407	.	G	C	3	1	4	0	0	4	0	0
1	35897408	.	C	T	3	1	4	0	0	4	0	0
1	35897450	.	G	C	2	4	6	0	0	6	0	0
1	35898075	.	G	A	2	4	6	0	0	6	0	0
1	35908381	.	T	C	3	0	3	0	5	8	0	0
1	35908404	.	T	A	6	2	8	0	0	8	0	0
1	35949654	.	G	A	0	2	2	0	0	2	0	0
1	35949667	.	C	T	1	1	2	0	0	2	0	0
1	35949969	.	C	A	7	7	14	0	0	14	0	0
1	35950082	.	T	G	2	9	11	0	0	11	0	0
1	35950100	.	T	G	1	7	8	0	0	8	0	0
1	35956508	.	C	G	7	4	11	0	0	11	0	0
1	35956549	.	C	T	8	4	12	0	1	13	0	0
1	35959826	.	T	C	4	2	6	0	0	6	0	0
1	35962990	.	C	T	1	1	2	0	0	2	0	0
1	35963306	.	G	A	0	0	0	0	4	4	0	0
1	35963822	.	C	T	6	4	10	0	0	10	0	0
1	35969716	.	G	A	2	2	4	0	0	4	0	0
1	35969836	.	G	C	10	11	21	0	1	22	0	0
1	35969878	.	C	T	11	14	25	0	1	26	0	0
1	36018610	.	T	A	10	6	16	0	0	16	0	0
1	36018817	.	T	C	8	0	8	0	10	18	0	0
1	36019227	.	C	T	9	4	13	0	0	13	0	0
1	36019361	.	T	C	6	0	6	0	16	22	0	0
1	36019416	.	G	T	12	12	24	0	0	24	0	0
1	36020097	.	A	C	2	5	7	0	0	7	0	0
1	36020154	.	T	C	8	6	14	0	0	14	0	0
1	36020492	.	T	G	8	8	16	0	0	16	0	0
1	36020642	.	T	A	3	6	9	0	0	9	0	0
1	36021110	.	G	A	6	9	15	0	0	15	0	0
1	36021158	.	C	G	6	8	14	0	0	14	0	0
1	36021399	.	A	G	19	16	35	0	1	36	0	0
1	36057147	.	G	A	0	2	2	0	1	3	0	0
1	36057303	.	A	G	5	1	6	0	0	6	0	0
1	36057306	.	C	T	5	1	6	0	0	6	0	0
1	36078513	.	G	A	3	6	9	0	1	10	0	0
1	36104830	.	C	T	0	2	2	0	1	3	0	0
1	36105018	.	A	C	6	0	6	0	9	15	0	0
1	36105117	.	C	T	1	4	5	0	6	11	0	0
1	36119094	.	C	T	0	7	7	0	4	11	0	0
1	36119106	.	A	G	1	8	9	0	0	9	0	0
1	36151450	.	A	G	1	5	6	0	0	6	0	0
1	36194799	.	G	T	0	0	0	0	1	1	0	0
1	36194942	.	G	A	1	2	3	0	0	3	0	0
1	36200014	.	C	T	6	1	7	0	0	7	0	0
1	36438671	.	T	A	12	16	28	0	0	28	0	0
1	36438882	.	T	A	12	17	29	0	1	30	0	0
1	36439186	.	T	A	14	14	28	0	1	29	0	0
1	36439204	.	G	T	11	15	26	0	0	26	0	0
1	36439248	.	G	A	10	13	23	0	0	23	0	0
1	36439380	.	G	T	11	17	28	0	0	28	0	0
1	36701999	.	C	T	8	8	16	0	0	16	0	0
1	36725468	.	T	C	1	4	5	0	0	5	0	0
1	36735123	.	C	T	1	3	4	0	1	5	0	0
1	36735144	.	G	A	4	2	6	0	0	6	0	0
1	36737712	.	T	C	4	2	6	0	0	6	0	0
1	36738164	.	T	C	2	3	5	0	0	5	0	0
1	36738356	.	C	T	1	3	4	0	0	4	0	0
1	36738459	.	G	A	0	2	2	0	1	3	0	0
1	36738574	.	C	A	7	3	10	0	0	10	0	0
1	36738595	.	A	T	9	3	12	0	0	12	0	0
1	36738747	.	T	A	5	2	7	0	1	8	0	0
1	36738810	.	C	T	6	6	12	0	0	12	0	0
1	36739086	.	A	T	2	2	4	0	0	4	0	0
1	36739104	.	C	T	1	3	4	0	0	4	0	0
1	36739124	.	G	A	0	3	3	0	2	5	0	0
1	36740205	.	A	G	2	2	4	0	0	4	0	0
1	36740324	.	G	C	1	2	3	0	0	3	0	0
1	36740359	.	C	A	2	3	5	0	0	5	0	0
1	36740365	.	T	G	2	3	5	0	0	5	0	0
1	36740404	.	G	A	1	0	1	0	1	2	0	0
1	36740431	.	A	G	1	2	3	0	0	3	0	0
1	36740468	.	T	A	3	1	4	0	1	5	0	0
1	36740764	.	C	A	4	4	8	0	1	9	0	0
1	36740961	.	G	T	0	5	5	0	5	10	0	0
1	36740995	.	G	C	6	4	10	0	0	10	0	0
1	36741087	.	T	A	8	5	13	0	1	14	0	0
1	36741110	.	G	T	4	4	8	0	1	9	0	0
1	36741149	.	A	C	5	0	5	1	0	6	0	0
1	36741279	.	T	C	5	4	9	0	1	10	0	0
1	36741396	.	T	G	3	5	8	0	0	8	0	0
1	36741422	.	A	C	2	3	5	0	0	5	0	0
1	36741581	.	C	T	4	5	9	0	0	9	0	0
1	36741602	.	A	C	1	4	5	0	1	6	0	0
1	36741616	.	A	T	3	1	4	0	0	4	0	0
1	36741642	.	T	C	1	2	3	0	0	3	0	0
1	36741863	.	A	C	2	2	4	0	0	4	0	0
1	36742074	.	G	C	1	2	3	0	0	3	0	0
1	36742075	.	G	A	1	2	3	0	0	3	0	0
1	36755165	.	G	T	0	3	3	0	0	3	0	0
1	36755327	.	C	T	4	3	7	0	0	7	0	0
1	36761757	.	A	G	4	2	6	0	0	6	0	0
1	36763718	.	T	G	5	1	6	0	0	6	0	0
1	36769270	.	G	A	3	3	6	0	0	6	0	0
1	36772210	.	G	C	0	2	2	0	1	3	0	0
1	36772291	.	G	T	0	2	2	0	2	4	0	0
1	36841058	.	G	A	2	2	4	0	0	4	0	0
1	36887880	.	C	A	2	6	8	0	1	9	0	0
1	36903175	.	T	A	1	4	5	1	0	6	0	0
1	36911491	.	A	C	0	2	2	0	0	2	0	0
1	36911647	.	A	T	2	5	7	0	0	7	0	0
1	36911788	.	G	A	0	3	3	0	2	5	0	0
1	36912176	.	G	A	1	3	4	0	1	5	0	0
1	36935559	.	T	C	2	4	6	0	1	7	0	0
1	36938228	.	T	G	2	3	5	0	0	5	0	0
1	36963429	.	T	A	5	4	9	0	0	9	0	0
1	36969133	.	C	T	3	3	6	0	0	6	0	0
1	37083463	.	G	A	1	5	6	0	0	6	0	0
1	37083817	.	C	T	0	4	4	0	7	11	0	0
1	37083879	.	C	T	2	6	8	0	1	9	0	0
1	37084087	.	T	C	2	0	2	0	6	8	0	0
1	37087670	.	G	A	2	2	4	0	0	4	0	0
1	37087725	.	G	C	5	4	9	0	0	9	0	0
1	37195941	.	T	A	4	7	11	0	0	11	0	0
1	37195950	.	G	A	3	7	10	0	1	11	0	0
1	37196220	.	T	A	10	4	14	0	0	14	0	0
1	37196228	.	A	G	3	9	12	0	0	12	0	0
1	37212301	.	T	A	2	8	10	0	0	10	0	0
1	37212331	.	C	T	2	8	10	0	0	10	0	0
1	37284382	.	C	T	0	1	1	0	0	1	0	0
1	37287291	.	A	T	1	2	3	0	0	3	0	0
1	37287294	.	G	A	1	3	4	0	0	4	0	0
1	37291884	.	A	C	4	1	5	0	0	5	0	0
1	37304354	.	C	A	18	9	27	0	2	29	0	0
1	37304439	.	C	T	11	11	22	0	2	24	0	0
1	37304494	.	T	A	11	10	21	0	0	21	0	0
1	37304510	.	T	G	11	7	18	0	1	19	0	0
1	37304536	.	G	A	14	5	19	0	0	19	0	0
1	37304929	.	G	A	3	10	13	0	0	13	0	0
1	37305148	.	C	T	6	3	9	0	1	10	0	0
1	37306726	.	G	T	0	20	20	0	11	31	0	0
1	37306913	.	T	A	19	7	26	0	1	27	0	0
1	37306942	.	A	C	11	8	19	0	1	20	0	0
1	37344832	.	T	C	6	5	11	0	0	11	0	0
1	37353355	.	C	T	2	3	5	0	0	5	0	0
1	37355591	.	G	A	5	7	12	0	0	12	0	0
1	37355606	.	C	T	6	4	10	0	0	10	0	0
1	37359071	.	C	T	5	5	10	0	0	10	0	0
1	37359221	.	G	C	3	3	6	0	0	6	0	0
1	37359352	.	A	G	4	2	6	0	0	6	0	0
1	37361554	.	A	G	7	7	14	0	1	15	0	0
1	37361759	.	C	T	5	4	9	0	0	9	0	0
1	37399434	.	T	C	2	2	4	0	0	4	0	0
1	37411160	.	C	T	2	3	5	0	0	5	0	0
1	37752326	.	T	C	3	3	6	0	0	6	0	0
1	37752392	.	A	G	4	0	4	0	6	10	0	0
1	37752478	.	G	C	6	3	9	0	0	9	0	0
1	37753024	.	G	A	0	1	1	0	0	1	0	0
1	38125431	.	C	A	6	9	15	0	1	16	0	0
1	38125684	.	T	C	6	9	15	0	1	17	1	0
1	38131058	.	C	T	17	8	25	0	0	25	0	0
1	38131073	.	T	C	9	15	24	0	0	24	0	0
1	38131094	.	G	A	13	8	21	0	1	22	0	0
1	38131288	.	G	A	22	7	29	0	1	30	0	0
1	38131360	.	G	A	16	23	39	0	0	39	0	0
1	38131486	.	G	A	16	9	25	0	1	26	0	0
1	38142998	.	G	T	6	4	10	0	0	10	0	0
1	38146192	.	G	T	2	1	3	0	1	4	0	0
1	38150605	.	A	C	2	5	7	0	1	8	0	0
1	38163017	.	C	T	3	1	4	0	0	4	0	0
1	38163132	.	G	A	2	3	5	0	0	5	0	0
1	38166009	.	G	C	6	7	13	0	1	14	0	0
1	38166268	.	A	C	14	12	26	0	2	29	1	0
1	38166429	.	T	C	14	19	33	0	0	33	0	0
1	38166431	.	T	G	14	19	33	0	0	33	0	0
1	38166520	.	A	G	19	12	31	0	0	31	0	0
1	38166663	.	A	T	0	10	10	0	0	10	0	0
1	38169972	.	T	G	15	16	31	0	1	32	0	0
1	38170553	.	G	A	2	4	6	0	0	6	0	0
1	38346065	.	T	C	1	2	3	0	0	3	0	0
1	38346162	.	C	T	0	2	2	0	5	7	0	0
1	38346475	.	C	T	0	2	2	0	3	5	0	0
1	38346578	.	G	T	5	6	11	0	1	12	0	0
1	38346649	.	C	T	0	5	5	0	3	8	0	0
1	38346739	.	G	A	3	7	10	0	0	10	0	0
1	38354049	.	G	A	0	1	1	0	0	1	0	0
1	38372101	.	G	A	0	0	0	0	1	1	0	0
1	38372109	.	G	A	1	1	2	0	0	2	0	0
1	38416536	.	A	G	3	5	8	0	0	8	0	0
1	38417221	.	T	C	0	5	5	0	0	5	0	0
1	38417229	.	G	A	2	3	5	0	0	5	0	0
1	38417268	.	A	T	5	5	10	0	0	10	0	0
1	38417332	.	A	G	5	7	12	0	0	12	0	0
1	38417370	.	G	A	9	5	14	0	0	14	0	0
1	38417531	.	G	T	3	5	8	0	0	8	0	0
1	38417588	.	T	G	1	3	4	0	0	4	0	0
1	38417625	.	A	T	2	2	4	0	2	6	0	0
1	38417680	.	T	A	3	2	5	0	0	5	0	0
1	38417757	.	G	A	1	3	4	0	0	4	0	0
1	38417758	.	T	C	1	3	4	0	0	4	0	0
1	38418087	.	C	T	2	3	5	0	0	5	0	0
1	38418243	.	A	G	5	3	8	0	0	8	0	0
1	38418294	.	G	T	6	3	9	0	0	9	0	0
1	38466714	.	G	A	5	2	7	0	0	7	0	0
1	38649340	.	A	G	39	29	68	0	1	69	0	0
1	38649947	.	G	A	39	33	72	0	4	76	0	0
1	38650132	.	G	T	25	30	55	0	2	57	0	0
1	38650298	.	G	A	32	18	50	0	2	52	0	0
1	38650382	.	G	C	27	31	58	0	7	65	0	0
1	38650467	.	A	G	23	36	59	0	4	63	0	0
1	38650510	.	G	C	33	30	63	0	2	65	0	0
1	38650516	.	T	C	34	28	62	0	3	65	0	0
1	38650545	.	T	C	32	34	66	0	5	71	0	0
1	38651063	.	G	T	43	22	65	0	2	67	0	0
1	38651065	.	T	A	44	22	66	0	1	67	0	0
1	38651361	.	C	T	16	19	35	0	0	35	0	0
1	38651370	.	G	A	17	17	34	0	0	34	0	0
1	38651469	.	C	A	17	28	45	0	2	47	0	0
1	38651822	.	G	A	8	2	10	0	0	10	0	0
1	38657689	.	G	A	3	6	9	0	0	9	0	0
1	38660240	.	T	C	20	0	20	0	10	30	0	0
1	38660252	.	A	G	23	12	35	0	2	37	0	0
1	38660369	.	G	A	2	2	4	0	0	4	0	0
1	38709351	.	A	C	11	0	11	0	15	27	1	0
1	38709381	.	G	C	14	11	25	0	0	25	0	0
1	38709480	.	G	A	10	7	17	0	2	19	0	0
1	38709535	.	T	A	13	5	18	0	1	19	0	0
1	38784551	.	A	T	2	5	7	0	0	7	0	0
1	38787039	.	C	T	5	5	10	0	0	10	0	0
1	38791569	.	C	T	4	1	5	0	1	6	0	0
1	38797663	.	A	C	8	9	17	0	0	17	0	0
1	38799513	.	G	A	0	2	2	0	1	3	0	0
1	38799585	.	A	G	0	0	0	0	3	3	0	0
1	38799588	.	T	A	1	2	3	0	0	3	0	0
1	38802537	.	G	A	8	14	22	0	0	22	0	0
1	38802703	.	A	G	7	13	20	0	0	20	0	0
1	38802718	.	G	A	17	9	26	0	0	26	0	0
1	38802747	.	A	G	17	1	18	0	8	26	0	0
1	38802855	.	C	A	6	8	14	0	0	14	0	0
1	38803033	.	T	C	6	3	9	0	0	9	0	0
1	38803042	.	A	C	6	2	8	0	0	8	0	0
1	38803092	.	C	T	4	1	5	0	0	5	0	0
1	38803127	.	C	T	7	5	12	0	1	13	0	0
1	38803154	.	T	A	8	7	15	0	0	15	0	0
1	38803205	.	A	T	8	8	16	0	2	18	0	0
1	38803404	.	A	G	7	9	16	0	0	16	0	0
1	38805128	.	G	T	6	1	7	0	1	8	0	0
1	38805135	.	C	T	6	3	9	0	1	10	0	0
1	38805439	.	G	A	11	14	25	0	2	27	0	0
1	38805450	.	A	G	11	16	27	0	0	27	0	0
1	38805506	.	G	A	11	10	21	0	1	22	0	0
1	38807255	.	G	C	5	4	9	0	0	9	0	0
1	38808259	.	C	A	1	1	2	0	0	2	0	0
1	38808379	.	C	T	0	2	2	0	0	2	0	0
1	38808723	.	T	A	10	7	17	0	0	18	1	0
1	38820219	.	G	A	0	5	5	0	7	12	0	0
1	38822092	.	A	T	8	8	16	0	0	16	0	0
1	38851225	.	C	T	0	1	1	0	0	1	0	0
1	39388332	.	A	C	4	5	9	0	0	9	0	0
1	39388363	.	C	T	1	3	4	0	0	4	0	0
1	39639723	.	C	T	0	2	2	0	0	2	0	0
1	39700498	.	T	C	3	4	7	0	0	7	0	0
1	39732544	.	C	T	4	4	8	0	0	8	0	0
1	39735491	.	T	C	3	0	3	0	0	3	0	0
1	39770416	.	C	T	7	6	13	0	0	13	0	0
1	39771429	.	T	A	6	15	21	0	1	22	0	0
1	39772010	.	T	C	7	4	11	0	0	11	0	0
1	39772042	.	A	G	6	7	13	0	2	15	0	0
1	39772135	.	C	A	10	10	20	0	1	21	0	0
1	39772225	.	C	T	7	5	12	0	2	14	0	0
1	39774096	.	C	T	5	8	13	0	1	14	0	0
1	39774225	.	C	T	15	8	23	0	3	26	0	0
1	39774363	.	G	A	10	12	22	0	1	23	0	0
1	39774618	.	A	G	11	11	22	0	1	23	0	0
1	39774690	.	A	G	6	7	13	0	0	13	0	0
1	39774727	.	C	A	4	8	12	0	0	12	0	0
1	39774891	.	C	T	14	10	24	0	3	27	0	0
1	39774915	.	G	A	18	11	29	0	2	31	0	0
1	39775089	.	C	T	12	8	20	0	1	21	0	0
1	39775131	.	C	T	12	11	23	0	0	23	0	0
1	39775227	.	C	T	13	5	18	0	2	20	0	0
1	39776356	.	A	C	18	11	29	0	3	32	0	0
1	39777089	.	G	A	11	11	22	0	2	24	0	0
1	39777836	.	G	A	0	12	12	0	9	21	0	0
1	39777975	.	A	T	11	16	27	0	1	28	0	0
1	39778047	.	A	G	14	0	14	0	9	23	0	0
1	39778075	.	T	G	12	11	23	0	0	23	0	0
1	39778332	.	G	C	21	22	43	0	0	43	0	0
1	39778661	.	G	A	10	12	22	0	0	22	0	0
1	39778663	.	G	A	10	12	22	0	0	22	0	0
1	39778949	.	G	C	21	16	37	0	0	37	0	0
1	39779225	.	G	C	5	8	13	0	1	14	0	0
1	39779468	.	A	T	4	5	9	0	0	9	0	0
1	39779518	.	T	G	8	1	9	0	0	9	0	0
1	39869860	.	T	A	3	2	5	0	0	5	0	0
1	39869917	.	T	A	2	4	6	0	0	7	1	0
1	39869974	.	G	A	6	2	8	0	0	8	0	0
1	39879980	.	C	T	3	2	5	0	0	5	0	0
1	39882764	.	A	T	5	5	10	0	1	11	0	0
1	39882899	.	A	G	7	4	11	0	0	11	0	0
1	39882906	.	T	A	4	7	11	0	1	12	0	0
1	39883259	.	C	G	1	4	5	0	2	7	0	0
1	39899477	.	G	C	11	17	28	0	0	28	0	0
1	39899494	.	A	G	24	8	32	0	0	32	0	0
1	39899663	.	G	A	15	15	30	0	0	30	0	0
1	39900056	.	G	A	17	26	43	0	0	43	0	0
1	39900129	.	G	A	13	19	32	0	1	33	0	0
1	39900137	.	G	T	14	17	31	0	0	31	0	0
1	39900432	.	C	T	1	13	14	0	9	23	0	0
1	39900750	.	C	T	0	13	13	0	9	22	0	0
1	39901378	.	T	A	4	5	9	0	0	9	0	0
1	39901500	.	T	C	6	10	16	0	1	17	0	0
1	39901501	.	G	A	6	11	17	0	0	17	0	0
1	39901729	.	T	C	11	0	11	0	19	30	0	0
1	39907291	.	A	C	6	4	10	0	0	10	0	0
1	39907492	.	T	C	21	1	22	0	17	39	0	0
1	39907611	.	C	T	0	5	5	0	3	8	0	0
1	39908047	.	G	A	11	15	26	0	1	27	0	0
1	39908680	.	C	T	12	5	17	0	1	18	0	0
1	39908854	.	A	G	5	13	18	0	0	18	0	0
1	39908881	.	C	T	8	12	20	0	0	20	0	0
1	39908926	.	A	G	8	12	20	0	0	20	0	0
1	39909003	.	A	T	14	11	25	0	2	28	1	0
1	39909247	.	A	T	15	20	35	0	1	36	0	0
1	39909274	.	A	T	18	15	33	0	0	33	0	0
1	39995100	.	C	T	8	11	19	0	1	20	0	0
1	39998875	.	G	A	7	14	21	0	1	22	0	0
1	40001853	.	A	T	9	9	18	0	2	20	0	0
1	40001873	.	C	A	5	5	10	0	1	11	0	0
1	40002113	.	G	A	11	8	19	0	0	19	0	0
1	40002148	.	C	G	10	10	20	0	0	20	0	0
1	40008905	.	T	C	23	18	41	0	0	41	0	0
1	40008906	.	G	A	23	18	41	0	0	41	0	0
1	40009227	.	T	A	18	19	37	0	0	37	0	0
1	40009258	.	C	T	18	12	30	0	1	31	0	0
1	40009291	.	A	G	21	8	29	0	1	30	0	0
1	40009382	.	G	A	8	14	22	0	2	24	0	0
1	40009526	.	T	C	3	7	10	0	0	10	0	0
1	40009625	.	T	C	7	4	11	0	2	13	0	0
1	40009671	.	C	A	6	13	19	0	1	20	0	0
1	40009697	.	C	T	4	12	16	0	0	16	0	0
1	40015189	.	A	G	7	8	15	0	0	15	0	0
1	40015219	.	C	T	7	8	15	0	0	15	0	0
1	40015265	.	C	T	0	2	2	0	4	6	0	0
1	40015553	.	A	G	0	0	0	0	1	1	0	0
1	40015697	.	A	G	6	9	15	0	0	15	0	0
1	40023692	.	T	C	6	7	13	0	0	13	0	0
1	40028208	.	C	A	7	5	12	0	0	12	0	0
1	40028424	.	C	T	15	14	29	0	0	29	0	0
1	40028508	.	C	T	14	9	23	0	0	23	0	0
1	40028568	.	G	T	8	3	11	0	1	12	0	0
1	40028613	.	G	A	5	4	9	0	0	9	0	0
1	40028637	.	C	T	4	6	10	0	0	10	0	0
1	40028680	.	G	A	4	10	14	0	0	14	0	0
1	40041528	.	C	T	1	4	5	0	2	7	0	0
1	40042241	.	G	A	0	4	4	0	0	4	0	0
1	40044175	.	G	C	0	1	1	0	0	1	0	0
1	40044562	.	G	A	7	12	19	0	0	19	0	0
1	40044578	.	C	T	9	7	16	0	0	16	0	0
1	40046859	.	G	A	3	2	5	0	0	5	0	0
1	40047070	.	T	A	1	0	1	0	0	1	0	0
1	40051918	.	T	C	3	8	11	0	0	11	0	0
1	40051923	.	G	C	3	8	11	0	0	11	0	0
1	40051988	.	G	C	0	7	7	0	12	19	0	0
1	40052033	.	A	G	10	10	20	0	0	20	0	0
1	40052066	.	G	C	9	10	19	0	0	19	0	0
1	40052083	.	G	A	8	11	19	1	0	20	0	0
1	40052481	.	A	C	4	11	15	0	0	15	0	0
1	40052550	.	A	C	5	12	17	0	1	18	0	0
1	40052562	.	A	G	5	7	12	0	0	12	0	0
1	40052965	.	T	A	1	4	5	0	0	5	0	0
1	40057483	.	C	T	5	3	8	0	0	8	0	0
1	40057604	.	A	G	4	5	9	0	1	10	0	0
1	40057655	.	C	T	6	4	10	0	0	10	0	0
1	40057805	.	C	T	5	7	12	1	1	14	0	0
1	40060836	.	T	A	2	2	4	0	0	4	0	0
1	40060860	.	T	C	1	2	3	0	0	3	0	0
1	40060968	.	A	C	5	3	8	0	0	8	0	0
1	40060992	.	C	T	0	2	2	0	7	9	0	0
1	40061061	.	C	T	0	7	7	0	4	11	0	0
1	40061169	.	G	A	5	3	8	0	0	8	0	0
1	40061285	.	C	T	6	7	13	0	0	13	0	0
1	40062593	.	T	G	4	4	8	0	0	8	0	0
1	40066299	.	G	A	5	3	8	0	0	8	0	0
1	40095794	.	T	A	2	0	2	0	0	2	0	0
1	40095799	.	C	T	2	0	2	0	0	2	0	0
1	40107874	.	T	G	8	10	18	0	0	18	0	0
1	40107961	.	C	T	0	1	1	0	1	2	0	0
1	40111679	.	C	G	12	10	22	0	0	22	0	0
1	40111702	.	T	G	15	13	28	0	1	29	0	0
1	40111737	.	A	C	16	10	26	0	0	26	0	0
1	40111738	.	G	A	16	10	26	0	0	26	0	0
1	40111776	.	C	T	8	15	23	0	0	23	0	0
1	40111918	.	C	T	11	13	24	0	0	24	0	0
1	40112206	.	T	C	2	2	4	0	2	6	0	0
1	40112347	.	C	T	11	4	15	0	0	15	0	0
1	40112410	.	C	T	4	4	8	0	1	9	0	0
1	40112500	.	A	G	5	6	11	0	0	11	0	0
1	40112503	.	A	G	8	3	11	0	0	11	0	0
1	40112713	.	A	G	1	0	1	0	2	3	0	0
1	40112760	.	T	A	6	5	11	0	0	11	0	0
1	40112822	.	A	T	8	2	10	0	0	10	0	0
1	40112837	.	C	T	4	10	14	0	0	14	0	0
1	40112869	.	C	T	11	7	18	0	0	18	0	0
1	40112879	.	A	G	9	7	16	0	0	16	0	0
1	40112938	.	G	C	9	5	14	0	0	14	0	0
1	40113374	.	T	A	1	4	5	0	0	5	0	0
1	40113589	.	T	C	0	2	2	0	1	3	0	0
1	40114155	.	T	A	2	6	8	0	0	8	0	0
1	40115018	.	A	T	1	5	6	0	0	6	0	0
1	40116747	.	G	A	8	8	16	0	0	16	0	0
1	40116823	.	C	T	0	4	4	0	1	5	0	0
1	40116889	.	G	A	1	2	3	0	0	3	0	0
1	40117345	.	G	A	13	13	26	0	1	27	0	0
1	40117792	.	C	T	0	1	1	0	0	1	0	0
1	40123964	.	C	T	0	2	2	0	1	3	0	0
1	40126279	.	T	C	2	2	4	0	1	5	0	0
1	40126281	.	T	G	3	2	5	0	0	5	0	0
1	40132692	.	G	C	3	6	9	0	0	9	0	0
1	40210865	.	G	T	18	11	29	0	0	29	0	0
1	40211048	.	C	T	0	6	6	0	8	14	0	0
1	40211065	.	T	C	8	4	12	0	0	12	0	0
1	40211217	.	A	C	8	8	16	0	1	17	0	0
1	40211465	.	T	C	9	0	9	0	12	21	0	0
1	40211645	.	C	G	0	8	8	0	9	17	0	0
1	40212065	.	C	T	6	9	15	0	0	15	0	0
1	40212084	.	C	A	1	9	10	0	3	13	0	0
1	40212305	.	C	T	12	12	24	0	1	25	0	0
1	40221359	.	A	G	0	1	1	0	0	1	0	0
1	40221458	.	A	T	1	1	2	0	0	2	0	0
1	40226289	.	G	A	4	6	10	0	1	11	0	0
1	40226292	.	G	C	6	5	11	0	0	11	0	0
1	40227029	.	T	G	6	13	19	0	0	19	0	0
1	40242922	.	C	A	3	2	5	0	0	5	0	0
1	40248173	.	C	T	2	4	6	0	0	6	0	0
1	40248383	.	C	T	4	6	10	0	0	10	0	0
1	40252219	.	T	A	1	2	3	0	1	4	0	0
1	40257577	.	A	G	4	4	8	0	0	8	0	0
1	40257631	.	C	T	9	9	18	0	0	18	0	0
1	40257751	.	C	T	5	9	14	0	0	14	0	0
1	40257834	.	T	G	1	0	1	0	9	10	0	0
1	40263675	.	C	A	1	8	9	0	0	9	0	0
1	40266618	.	C	T	5	4	9	0	2	11	0	0
1	40270054	.	C	T	2	2	4	0	0	4	0	0
1	40270094	.	G	A	0	1	1	0	1	2	0	0
1	40270095	.	G	A	1	1	2	0	0	2	0	0
1	40336234	.	C	G	3	3	6	0	0	6	0	0
1	40336372	.	T	A	1	4	5	0	0	5	0	0
1	40336396	.	A	C	2	0	2	0	1	3	0	0
1	40336789	.	G	A	2	2	4	0	0	4	0	0
1	40337314	.	C	T	8	5	13	0	0	13	0	0
1	40337464	.	C	A	0	4	4	0	4	8	0	0
1	40340571	.	C	T	5	3	8	0	1	9	0	0
1	40340598	.	C	T	5	5	10	0	0	10	0	0
1	40410839	.	A	T	5	7	12	0	1	13	0	0
1	40410908	.	C	T	3	7	10	0	0	10	0	0
1	40411928	.	T	C	0	1	1	0	0	1	0	0
1	40567094	.	G	A	9	10	19	0	1	20	0	0
1	40568601	.	G	A	13	14	27	0	2	29	0	0
1	40568707	.	A	G	10	0	10	0	10	20	0	0
1	40568883	.	G	A	1	11	12	0	14	26	0	0
1	40568990	.	A	G	15	17	32	0	0	32	0	0
1	40569231	.	G	A	9	7	16	0	1	17	0	0
1	40569295	.	A	T	12	11	23	0	0	23	0	0
1	40569386	.	T	A	11	8	19	0	0	19	0	0
1	40569466	.	A	T	16	18	34	0	1	35	0	0
1	40569538	.	G	A	8	12	20	0	3	23	0	0
1	40569548	.	T	C	6	12	18	0	1	19	0	0
1	40573703	.	G	T	5	7	12	0	0	12	0	0
1	40590967	.	T	G	3	6	9	0	0	9	0	0
1	40591262	.	T	C	17	21	38	0	1	39	0	0
1	40591272	.	T	C	16	19	35	0	0	35	0	0
1	40594373	.	C	T	0	6	6	0	0	6	0	0
1	40594415	.	C	T	1	15	16	0	6	22	0	0
1	40594517	.	T	C	18	0	18	0	13	31	0	0
1	40594526	.	G	A	17	8	25	0	0	25	0	0
1	40597332	.	A	C	8	0	8	0	18	26	0	0
1	40600992	.	A	T	5	4	9	0	0	9	0	0
1	40601547	.	G	A	9	15	24	0	1	25	0	0
1	40601595	.	G	C	4	0	4	0	5	9	0	0
1	40618861	.	C	T	1	3	4	0	0	4	0	0
1	40638246	.	A	T	1	3	4	0	0	4	0	0
1	40795213	.	C	A	1	2	3	0	0	3	0	0
1	40796779	.	G	T	1	2	3	0	0	3	0	0
1	40796791	.	G	A	2	2	4	0	0	4	0	0
1	40796942	.	C	T	5	4	9	0	0	9	0	0
1	40796977	.	C	T	4	1	5	0	0	5	0	0
1	40796985	.	A	T	4	2	6	0	0	6	0	0
1	40910231	.	T	C	1	2	3	0	0	3	0	0
1	40911073	.	C	T	0	1	1	0	2	3	0	0
1	40992716	.	T	A	4	6	10	0	2	12	0	0
1	40992823	.	A	G	7	6	13	0	0	13	0	0
1	40992878	.	C	G	3	5	8	0	1	9	0	0
1	40993195	.	C	T	10	3	13	0	0	13	0	0
1	40993349	.	C	T	0	11	11	0	11	22	0	0
1	40993714	.	G	A	2	2	4	0	0	4	0	0
1	40994068	.	T	A	1	2	3	0	1	4	0	0
1	41131608	.	C	T	7	17	24	0	0	24	0	0
1	41133944	.	G	A	5	10	15	0	1	16	0	0
1	41136245	.	T	C	1	0	1	0	0	1	0	0
1	41138638	.	A	G	1	0	1	0	0	1	0	0
1	41138641	.	C	T	0	2	2	0	0	2	0	0
1	41140465	.	T	C	3	4	7	0	1	8	0	0
1	41140640	.	C	T	11	16	27	0	1	28	0	0
1	41215289	.	T	A	7	12	19	0	0	19	0	0
1	41215312	.	T	G	9	11	20	0	2	22	0	0
1	41215547	.	G	A	9	10	19	0	1	20	0	0
1	41215746	.	T	A	8	5	13	0	0	13	0	0
1	41215868	.	T	G	3	5	8	0	0	8	0	0
1	41215869	.	G	T	5	3	8	0	0	8	0	0
1	41215998	.	T	C	5	5	10	0	1	11	0	0
1	41222341	.	T	C	1	0	1	0	0	1	0	0
1	41230927	.	C	T	2	1	3	0	0	3	0	0
1	41294719	.	A	G	8	8	16	0	1	17	0	0
1	41294760	.	T	C	8	7	15	0	2	17	0	0
1	41294790	.	G	T	8	6	14	0	0	14	0	0
1	41297453	.	C	T	0	2	2	0	4	6	0	0
1	41297495	.	G	A	7	9	16	0	0	16	0	0
1	41297561	.	C	T	6	2	8	0	0	8	0	0
1	41297564	.	A	T	2	5	7	0	0	7	0	0
1	41300133	.	C	T	1	13	14	0	0	14	0	0
1	41309208	.	C	G	4	5	9	0	0	9	0	0
1	41310074	.	A	G	5	4	9	0	0	9	0	0
1	41312210	.	G	A	3	0	3	0	1	4	0	0
1	41318203	.	T	G	2	1	3	0	0	3	0	0
1	41324327	.	C	T	0	2	2	0	1	3	0	0
1	41324444	.	C	T	0	2	2	0	3	5	0	0
1	41330394	.	G	A	2	4	6	0	0	6	0	0
1	41331692	.	G	A	3	2	5	0	0	5	0	0
1	41333034	.	G	A	0	2	2	0	0	2	0	0
1	41333321	.	A	G	1	0	1	0	0	1	0	0
1	41333503	.	A	G	2	3	5	0	0	5	0	0
1	41337314	.	G	A	0	1	1	0	0	1	0	0
1	41339963	.	C	T	0	2	2	0	0	2	0	0
1	41340128	.	C	G	0	1	1	0	0	1	0	0
1	41340133	.	T	G	0	1	1	0	0	1	0	0
1	41361505	.	C	T	0	2	2	0	0	2	0	0
1	41362635	.	C	A	0	1	1	0	0	1	0	0
1	41364819	.	G	A	3	0	3	0	0	3	0	0
1	41470524	.	T	C	20	24	44	0	0	44	0	0
1	41471529	.	T	C	24	20	44	0	2	46	0	0
1	41487459	.	C	A	3	4	7	1	0	8	0	0
1	41487811	.	C	T	1	0	1	0	0	1	0	0
1	41487973	.	T	C	1	1	2	0	0	2	0	0
1	41488030	.	T	C	1	1	2	0	0	2	0	0
1	41488643	.	A	C	6	4	10	0	0	10	0	0
1	41489068	.	C	T	3	4	7	0	0	7	0	0
1	41489274	.	G	C	4	3	7	0	0	7	0	0
1	41489343	.	G	A	2	4	6	0	0	6	0	0
1	41492367	.	A	T	3	3	6	0	0	6	0	0
1	41498219	.	A	G	5	2	7	0	1	8	0	0
1	41513332	.	G	A	2	2	4	0	0	4	0	0
1	41530370	.	C	T	2	4	6	0	0	6	0	0
1	41596148	.	A	T	5	2	7	0	0	7	0	0
1	41596182	.	A	G	3	4	7	0	1	8	0	0
1	41596199	.	A	G	4	5	9	0	1	10	0	0
1	41596291	.	C	T	5	4	9	0	0	9	0	0
1	41596420	.	A	C	0	1	1	0	0	1	0	0
1	41604931	.	C	G	4	0	4	0	1	5	0	0
1	41604934	.	C	G	4	0	4	0	2	6	0	0
1	41604985	.	G	A	0	3	3	0	4	7	0	0
1	41605011	.	T	C	3	4	7	0	0	7	0	0
1	41605065	.	C	A	8	6	14	0	1	15	0	0
1	41605149	.	T	C	6	3	9	0	1	10	0	0
1	41605203	.	C	T	8	3	11	0	0	11	0	0
1	41609961	.	C	A	1	2	3	0	0	3	0	0
1	41615874	.	C	T	4	3	7	0	3	10	0	0
1	41615904	.	T	C	8	3	11	0	0	11	0	0
1	41615949	.	T	C	4	9	13	0	0	13	0	0
1	41616081	.	T	G	3	5	8	0	0	8	0	0
1	41616186	.	A	C	2	9	11	0	0	11	0	0
1	41616867	.	T	A	1	3	4	0	0	4	0	0
1	41690506	.	C	T	7	7	14	0	0	14	0	0
1	41730609	.	C	T	8	13	21	0	2	23	0	0
1	41730669	.	G	A	13	8	21	0	2	23	0	0
1	41744103	.	C	T	2	5	7	0	0	7	0	0
1	41755157	.	C	T	13	9	22	0	0	22	0	0
1	41755158	.	A	T	13	9	22	0	0	22	0	0
1	41755195	.	C	T	11	13	24	0	1	25	0	0
1	41770847	.	T	A	7	10	17	0	0	17	0	0
1	41770872	.	T	C	12	4	16	0	2	18	0	0
1	41770959	.	T	C	5	8	13	0	0	13	0	0
1	41817556	.	G	A	3	4	7	0	0	7	0	0
1	41817574	.	T	C	3	3	6	0	0	6	0	0
1	41817678	.	C	T	4	4	8	0	0	8	0	0
1	41849293	.	A	G	10	4	14	0	0	14	0	0
1	41849310	.	A	G	7	2	9	0	0	10	1	0
1	41865471	.	C	T	5	2	7	0	0	7	0	0
1	41958356	.	C	T	2	2	4	0	0	4	0	0
1	41982429	.	G	T	2	4	6	0	0	6	0	0
1	42375005	.	C	A	11	5	16	0	1	17	0	0
1	42375071	.	C	T	6	3	9	0	0	9	0	0
1	42386349	.	T	C	4	5	9	0	1	10	0	0
1	42386364	.	C	A	3	5	8	0	0	8	0	0
1	42391172	.	T	C	4	5	9	0	0	9	0	0
1	42391194	.	T	C	2	3	5	0	1	6	0	0
1	42391214	.	G	A	0	1	1	0	0	1	0	0
1	42776652	.	T	C	16	18	34	0	0	34	0	0
1	42776787	.	C	T	4	11	15	0	19	34	0	0
1	42776806	.	A	T	22	11	33	0	2	35	0	0
1	42776853	.	T	C	19	15	34	0	0	35	1	0
1	42776906	.	A	G	16	15	31	0	0	31	0	0
1	42777116	.	G	A	17	19	36	0	1	37	0	0
1	42777146	.	C	G	0	16	16	0	17	33	0	0
1	42777383	.	A	G	15	12	27	0	2	29	0	0
1	42777593	.	T	G	14	8	22	0	1	23	0	0
1	42777674	.	G	A	11	9	20	0	0	20	0	0
1	42882955	.	C	T	6	8	14	0	0	14	0	0
1	43023630	.	G	A	9	4	13	0	0	13	0	0
1	43034947	.	C	T	22	19	41	0	0	41	0	0
1	43035178	.	T	C	10	14	24	0	3	27	0	0
1	43035546	.	T	A	6	5	11	0	1	12	0	0
1	44228705	.	C	T	3	4	7	0	1	8	0	0
1	44940802	.	T	A	0	2	2	0	0	2	0	0
1	45094831	.	T	A	0	4	4	0	0	4	0	0
1	45095019	.	T	C	0	4	4	3	0	7	0	0
1	45570224	.	T	A	1	24	25	0	1	26	0	0
1	45868178	.	C	T	9	16	25	1	4	30	0	0
1	46449464	.	C	T	1	3	4	0	2	6	0	0
1	46857257	.	A	G	2	9	11	0	0	12	1	0
1	46875477	.	A	G	0	2	2	0	0	2	0	0
1	47134498	.	G	T	0	6	6	0	0	6	0	0
1	48583000	.	T	C	7	4	11	0	1	12	0	0
1	49271317	.	G	A	18	25	43	0	2	45	0	0
1	49289729	.	C	G	9	1	10	1	8	19	0	0
1	49293808	.	T	C	27	20	47	0	1	48	0	0
1	49293954	.	C	T	23	15	38	0	2	40	0	0
1	49294032	.	A	T	12	11	23	0	1	24	0	0
1	49294686	.	A	G	11	10	21	0	1	22	0	0
1	49374392	.	A	G	1	4	5	0	1	6	0	0
1	49379904	.	T	C	0	0	0	0	1	1	0	0
1	49382031	.	G	A	0	1	1	0	1	2	0	0
1	49396559	.	C	T	0	3	3	0	3	6	0	0
1	49409520	.	G	A	1	2	3	0	0	3	0	0
1	49418122	.	T	C	2	2	4	0	0	4	0	0
1	49418156	.	T	C	2	2	4	0	0	4	0	0
1	49418197	.	A	T	3	3	6	0	0	6	0	0
1	49483242	.	T	C	7	4	11	0	0	11	0	0
1	49483583	.	C	T	10	7	17	0	0	17	0	0
1	49609118	.	A	G	5	2	7	0	0	7	0	0
1	49613860	.	T	C	5	2	7	0	0	7	0	0
1	49814674	.	T	C	7	8	15	0	1	16	0	0
1	49814732	.	C	T	9	14	23	0	0	23	0	0
1	49814844	.	C	T	8	9	17	0	2	19	0	0
1	49869672	.	G	A	4	7	11	0	0	11	0	0
1	49910164	.	A	G	1	0	1	0	0	1	0	0
1	49910173	.	G	A	2	2	4	0	0	4	0	0
1	49912665	.	C	T	0	0	0	0	1	1	0	0
1	49912841	.	C	A	0	2	2	0	3	5	0	0
1	49912866	.	C	T	0	2	2	0	2	4	0	0
1	49913071	.	G	A	7	11	18	0	0	18	0	0
1	49915231	.	C	T	7	8	15	0	0	15	0	0
1	49915278	.	G	C	1	3	4	0	0	4	0	0
1	49915598	.	C	T	6	6	12	0	0	12	0	0
1	49929579	.	G	A	6	2	8	0	0	8	0	0
1	49929726	.	A	G	2	2	4	0	1	5	0	0
1	49929784	.	C	T	3	4	7	0	0	7	0	0
1	49929798	.	T	C	4	0	4	0	4	8	0	0
1	49930146	.	G	A	6	4	10	0	0	10	0	0
1	49931607	.	C	T	0	2	2	0	1	3	0	0
1	49931763	.	T	A	4	4	8	0	3	11	0	0
1	49960756	.	T	C	1	2	3	0	0	3	0	0
1	50111654	.	C	T	0	1	1	0	0	1	0	0
1	50171219	.	T	C	0	4	4	0	0	4	0	0
1	50172815	.	A	G	1	3	4	0	1	5	0	0
1	50178612	.	T	C	2	3	5	0	0	5	0	0
1	50178643	.	A	G	4	0	4	0	9	13	0	0
1	50178829	.	C	A	7	11	18	0	1	19	0	0
1	50178963	.	G	A	7	4	11	0	0	11	0	0
1	50185244	.	G	A	0	2	2	0	8	10	0	0
1	50187511	.	C	T	7	4	11	0	0	11	0	0
1	50187733	.	A	T	8	8	16	0	0	16	0	0
1	50187782	.	A	G	2	4	6	0	0	6	0	0
1	50187866	.	A	G	3	0	3	0	4	7	0	0
1	50198619	.	C	A	1	2	3	0	0	3	0	0
1	50198815	.	C	T	0	5	5	0	10	15	0	0
1	50199365	.	A	T	0	2	2	0	0	2	0	0
1	50199368	.	G	A	0	2	2	0	0	2	0	0
1	50199416	.	G	A	3	4	7	0	0	7	0	0
1	50221045	.	G	A	2	2	4	0	0	4	0	0
1	50245894	.	G	C	0	1	1	0	0	1	0	0
1	50261274	.	A	G	2	0	2	0	1	3	0	0
1	50266704	.	C	G	2	2	4	0	0	4	0	0
1	50270234	.	C	G	2	1	3	0	0	3	0	0
1	50270241	.	T	A	2	1	3	0	0	3	0	0
1	50293876	.	A	G	5	3	8	0	0	8	0	0
1	50301833	.	A	G	0	1	1	0	0	1	0	0
1	50303960	.	C	T	2	5	7	0	1	8	0	0
1	50303989	.	G	A	0	6	6	0	8	14	0	0
1	50317687	.	G	A	0	12	12	0	4	16	0	0
1	50317723	.	A	C	1	8	9	0	0	9	0	0
1	50319584	.	A	G	2	3	5	0	1	6	0	0
1	50437939	.	G	A	1	2	3	0	1	4	0	0
1	50437991	.	C	A	2	2	4	0	0	4	0	0
1	50487762	.	G	C	7	0	7	0	8	15	0	0
1	50487837	.	C	A	4	6	10	0	0	10	0	0
1	50487844	.	G	A	4	7	11	0	0	11	0	0
1	50488002	.	A	G	4	9	13	0	0	13	0	0
1	50496598	.	A	G	7	5	12	0	0	12	0	0
1	50502852	.	C	T	0	3	3	0	2	5	0	0
1	50503237	.	G	A	2	2	4	0	0	4	0	0
1	50520003	.	A	G	4	1	5	0	0	5	0	0
1	50556703	.	C	T	2	3	5	0	0	5	0	0
1	50556756	.	C	T	2	3	5	0	0	5	0	0
1	50594239	.	T	A	10	13	23	0	0	23	0	0
1	50594421	.	G	A	1	2	3	0	0	4	1	0
1	50594424	.	C	T	1	3	4	0	0	4	0	0
1	50594647	.	G	A	1	7	8	0	0	8	0	0
1	50594670	.	A	T	3	8	11	0	0	11	0	0
1	50594771	.	C	A	8	8	16	0	1	17	0	0
1	50594777	.	C	T	8	9	17	0	1	18	0	0
1	50594986	.	T	C	8	1	9	0	13	22	0	0
1	50595289	.	G	A	17	13	30	0	1	31	0	0
1	50595387	.	C	T	13	16	29	0	1	30	0	0
1	50595476	.	G	A	11	10	21	0	0	21	0	0
1	50595530	.	A	G	4	4	8	1	0	9	0	0
1	50595608	.	G	C	10	11	21	0	1	22	0	0
1	50595748	.	T	C	19	12	31	0	0	31	0	0
1	50595805	.	G	A	15	11	26	0	0	26	0	0
1	50596748	.	G	T	7	7	14	0	3	17	0	0
1	50598793	.	C	T	0	12	12	0	9	21	0	0
1	50598848	.	G	A	15	14	29	0	0	29	0	0
1	50608505	.	T	C	5	10	15	0	1	16	0	0
1	50608584	.	G	A	11	7	18	0	0	18	0	0
1	50673749	.	G	A	0	2	2	0	3	5	0	0
1	50691194	.	G	C	1	4	5	0	4	9	0	0
1	50694993	.	T	C	13	9	22	0	0	22	0	0
1	50694994	.	G	T	13	8	21	0	1	22	0	0
1	50698089	.	G	A	1	2	3	0	0	3	0	0
1	50847905	.	T	C	4	5	9	0	0	9	0	0
1	50848484	.	C	T	12	10	22	0	0	22	0	0
1	50848555	.	A	G	8	7	15	0	0	15	0	0
1	50849078	.	A	T	11	21	32	0	1	33	0	0
1	50849199	.	T	C	9	2	11	0	13	24	0	0
1	50849839	.	T	C	6	7	13	0	0	13	0	0
1	50849938	.	T	A	9	14	23	0	2	25	0	0
1	50849942	.	G	A	11	13	24	0	2	26	0	0
1	50850041	.	T	A	10	6	16	0	2	18	0	0
1	50969209	.	G	A	22	9	31	0	0	31	0	0
1	50977072	.	C	A	6	10	16	0	0	16	0	0
1	50977089	.	C	T	8	5	13	0	1	14	0	0
1	50977569	.	A	C	1	4	5	0	0	5	0	0
1	50977607	.	G	A	1	3	4	0	0	4	0	0
1	50977640	.	G	T	1	3	4	0	0	4	0	0
1	50977669	.	G	A	3	3	6	0	0	6	0	0
1	50977707	.	G	A	0	9	9	0	9	18	0	0
1	50983906	.	T	C	14	19	33	0	4	37	0	0
1	50985169	.	C	T	13	15	28	0	1	29	0	0
1	50987742	.	C	A	11	12	23	0	1	24	0	0
1	50990605	.	G	A	22	34	56	0	1	57	0	0
1	50990698	.	A	T	25	22	47	0	3	50	0	0
1	50990709	.	T	C	20	19	39	0	3	45	3	0
1	50990815	.	G	A	27	24	51	0	1	52	0	0
1	51021529	.	C	A	1	5	6	0	0	6	0	0
1	51021591	.	C	A	4	6	10	0	0	10	0	0
1	51038819	.	A	G	2	3	5	0	0	5	0	0
1	51040428	.	T	C	0	1	1	0	0	1	0	0
1	51041363	.	G	A	1	2	3	0	7	10	0	0
1	51042230	.	G	C	10	15	25	0	2	27	0	0
1	51052276	.	C	T	1	2	3	0	0	3	0	0
1	51052279	.	T	C	1	1	2	0	0	2	0	0
1	51053971	.	A	G	1	1	2	0	0	2	0	0
1	51056715	.	G	A	0	4	4	0	0	4	0	0
1	51058146	.	A	C	8	0	8	0	3	11	0	0
1	51072911	.	A	C	1	3	4	0	0	4	0	0
1	51105411	.	T	A	6	3	9	0	0	9	0	0
1	51108130	.	T	C	2	0	2	0	2	4	0	0
1	51110048	.	A	G	1	2	3	0	0	3	0	0
1	51192069	.	C	T	1	0	1	0	0	1	0	0
1	51192074	.	C	A	2	1	3	0	0	3	0	0
1	51193701	.	G	T	0	0	0	0	1	1	0	0
1	51196071	.	G	C	2	2	4	0	0	4	0	0
1	51196095	.	G	A	4	2	6	0	0	6	0	0
1	51196161	.	C	T	7	2	9	0	0	9	0	0
1	51196203	.	T	C	7	4	11	0	0	11	0	0
1	51196233	.	T	C	5	5	10	0	0	10	0	0
1	51196311	.	G	A	2	3	5	0	0	5	0	0
1	51196435	.	T	G	3	3	6	0	0	6	0	0
1	51196863	.	G	A	0	3	3	0	8	11	0	0
1	51197193	.	G	T	4	2	6	0	0	6	0	0
1	51197239	.	A	T	6	1	7	0	0	7	0	0
1	51197256	.	T	C	6	1	7	0	0	7	0	0
1	51197316	.	A	G	1	3	4	0	0	4	0	0
1	51207210	.	A	C	0	1	1	0	0	1	0	0
1	51210562	.	T	C	5	2	7	0	0	7	0	0
1	51211052	.	A	G	2	8	10	0	1	11	0	0
1	51211393	.	T	A	0	1	1	0	0	1	0	0
1	51211394	.	C	T	0	1	1	0	0	1	0	0
1	51212817	.	C	T	0	4	4	0	1	5	0	0
1	51212829	.	A	G	2	4	6	0	0	6	0	0
1	51215441	.	T	C	0	0	0	0	1	1	0	0
1	51217048	.	C	A	1	2	3	0	0	3	0	0
1	51217063	.	C	A	0	3	3	0	1	4	0	0
1	51217156	.	T	A	1	3	4	0	0	4	0	0
1	51217822	.	T	C	1	2	3	0	0	3	0	0
1	51217888	.	A	C	5	3	8	0	0	8	0	0
1	51221347	.	A	G	5	0	5	0	6	11	0	0
1	51221349	.	A	T	5	6	11	0	0	11	0	0
1	51229355	.	C	T	5	8	13	0	3	16	0	0
1	51229464	.	C	G	3	9	12	0	0	12	0	0
1	51229471	.	C	T	1	9	10	0	2	12	0	0
1	51230244	.	T	C	12	2	14	0	0	14	0	0
1	51230324	.	G	A	6	3	9	0	0	9	0	0
1	51230328	.	C	A	5	3	8	0	1	9	0	0
1	51230404	.	A	G	3	7	10	0	0	10	0	0
1	51230427	.	A	G	0	6	6	0	0	6	0	0
1	51230467	.	T	C	0	4	4	0	0	4	0	0
1	51230487	.	A	T	0	2	2	0	0	2	0	0
1	51231225	.	A	T	1	4	5	0	1	6	0	0
1	51231228	.	G	T	1	5	6	0	0	6	0	0
1	51233996	.	C	T	0	1	1	0	2	3	0	0
1	51242401	.	G	T	3	10	13	0	0	13	0	0
1	51244814	.	C	T	4	4	8	0	0	8	0	0
1	51246693	.	T	C	5	5	10	0	0	10	0	0
1	51262273	.	G	A	3	7	10	0	0	10	0	0
1	51263352	.	C	T	2	2	4	0	0	4	0	0
1	51263367	.	C	G	2	3	5	0	0	5	0	0
1	51264192	.	T	A	2	2	4	0	0	4	0	0
1	51264198	.	A	G	2	2	4	0	0	4	0	0
1	51264981	.	G	T	1	0	1	0	0	1	0	0
1	51266226	.	G	A	0	1	1	0	0	1	0	0
1	51349146	.	G	A	1	2	3	0	0	3	0	0
1	51355086	.	G	A	4	4	8	0	0	8	0	0
1	51369612	.	A	G	2	2	4	0	0	4	0	0
1	51371090	.	G	A	1	1	2	0	0	2	0	0
1	51372742	.	C	T	3	3	6	0	1	7	0	0
1	51372951	.	C	T	1	1	2	0	1	3	0	0
1	51373730	.	A	C	3	3	6	0	0	6	0	0
1	51373808	.	C	T	3	3	6	0	1	7	0	0
1	51373904	.	A	G	4	5	9	0	1	10	0	0
1	51373952	.	A	C	2	6	8	0	2	10	0	0
1	51374009	.	T	C	4	3	7	0	0	7	0	0
1	51374087	.	G	A	1	3	4	0	0	4	0	0
1	51374844	.	C	T	4	5	9	0	0	9	0	0
1	51374976	.	G	A	2	4	6	0	0	6	0	0
1	51375149	.	T	C	1	4	5	0	0	5	0	0
1	51375170	.	A	T	2	6	8	0	0	8	0	0
1	51375301	.	A	G	3	3	6	0	1	7	0	0
1	51375361	.	C	A	4	1	5	0	0	5	0	0
1	51377757	.	C	T	6	5	11	0	0	11	0	0
1	51377798	.	G	A	1	6	7	0	4	11	0	0
1	51395366	.	G	T	3	2	5	0	0	5	0	0
1	51403088	.	C	T	5	1	6	0	1	7	0	0
1	51403544	.	G	C	6	2	8	0	1	9	0	0
1	51403562	.	C	T	11	3	14	0	0	14	0	0
1	51405119	.	C	A	5	2	7	0	0	7	0	0
1	51405153	.	T	C	0	10	10	0	0	10	0	0
1	51405167	.	G	A	0	1	1	0	11	12	0	0
1	51405323	.	C	A	1	5	6	0	1	7	0	0
1	51405636	.	A	C	1	3	4	0	0	4	0	0
1	51405684	.	G	A	0	4	4	0	1	5	0	0
1	51405721	.	G	A	3	1	4	0	2	6	0	0
1	51406288	.	C	T	11	10	21	0	1	22	0	0
1	51413315	.	T	C	4	5	9	0	0	9	0	0
1	51416963	.	C	T	2	2	4	0	0	4	0	0
1	51417125	.	C	G	3	0	3	0	4	7	0	0
1	51424779	.	A	T	11	10	21	0	1	22	0	0
1	51424813	.	G	A	0	5	5	0	9	14	0	0
1	51424937	.	T	A	4	4	8	0	0	9	1	0
1	51425296	.	G	A	6	6	12	0	1	13	0	0
1	51427671	.	G	T	13	12	25	0	2	27	0	0
1	51427779	.	T	C	16	10	26	0	2	28	0	0
1	51427837	.	A	C	12	13	25	0	0	25	0	0
1	51445437	.	A	T	7	4	11	0	0	11	0	0
1	51445450	.	A	T	9	5	14	0	0	14	0	0
1	51445732	.	A	G	8	6	14	0	0	14	0	0
1	51446004	.	G	A	0	2	2	0	0	2	0	0
1	51446030	.	C	A	1	0	1	0	0	1	0	0
1	51446451	.	C	T	2	1	3	0	0	3	0	0
1	51446462	.	C	T	1	3	4	0	0	4	0	0
1	51446511	.	G	A	3	5	8	0	0	8	0	0
1	51447543	.	T	G	2	2	4	0	0	4	0	0
1	51448249	.	C	A	7	7	14	0	0	14	0	0
1	51448485	.	C	T	9	3	12	0	0	12	0	0
1	51448517	.	C	T	4	8	12	0	0	12	0	0
1	51449543	.	G	A	3	3	6	0	0	6	0	0
1	51449556	.	G	A	3	3	6	0	0	6	0	0
1	51449720	.	G	A	3	3	6	0	0	6	0	0
1	51450018	.	C	T	0	2	2	0	4	6	0	0
1	51450180	.	C	T	0	5	5	0	1	6	0	0
1	51450752	.	G	A	3	3	6	0	1	7	0	0
1	51557903	.	C	T	0	15	15	0	15	30	0	0
1	51558133	.	G	T	17	6	23	0	1	24	0	0
1	51558150	.	A	T	13	5	18	0	2	20	0	0
1	51558354	.	T	A	10	7	17	0	5	22	0	0
1	51558463	.	G	A	31	11	42	0	0	42	0	0
1	51558730	.	G	T	21	14	35	0	4	39	0	0
1	51558897	.	T	A	19	19	38	0	3	41	0	0
1	51558903	.	A	C	17	16	33	0	2	35	0	0
1	51559269	.	G	C	19	16	35	0	0	35	0	0
1	51559815	.	C	T	11	17	28	0	1	29	0	0
1	51562803	.	T	C	4	9	13	0	0	13	0	0
1	51593925	.	A	C	6	2	8	0	0	8	0	0
1	51593926	.	C	T	0	2	2	0	6	8	0	0
1	51594068	.	A	C	6	11	17	0	0	17	0	0
1	51594453	.	A	G	19	13	32	0	2	34	0	0
1	51594690	.	C	G	0	16	16	0	18	34	0	0
1	51594701	.	C	T	2	17	19	0	18	37	0	0
1	51594883	.	C	T	0	1	1	0	2	3	0	0
1	51606302	.	C	G	5	4	9	0	0	9	0	0
1	51608904	.	G	T	2	9	11	0	2	13	0	0
1	51612371	.	G	T	17	17	34	0	1	35	0	0
1	51612408	.	C	G	18	19	37	0	1	38	0	0
1	51615110	.	T	C	7	0	7	0	8	15	0	0
1	51702259	.	C	T	0	2	2	0	0	2	0	0
1	51703824	.	C	T	2	2	4	0	1	5	0	0
1	51710007	.	C	T	5	1	6	0	0	6	0	0
1	51712960	.	G	A	0	3	3	0	0	3	0	0
1	51712983	.	A	G	1	4	5	0	0	5	0	0
1	51713077	.	G	A	8	5	13	0	0	13	0	0
1	51713468	.	C	T	1	1	2	0	0	2	0	0
1	51719005	.	G	A	2	1	3	0	0	3	0	0
1	51721923	.	T	G	3	0	3	0	1	4	0	0
1	51723093	.	T	G	9	0	9	0	6	15	0	0
1	51726524	.	C	T	18	9	27	0	1	28	0	0
1	51727432	.	C	A	5	5	10	0	3	13	0	0
1	51729605	.	G	A	9	17	26	0	1	27	0	0
1	51729608	.	G	T	11	15	26	0	1	27	0	0
1	51729645	.	A	C	13	11	24	0	0	24	0	0
1	51729687	.	C	T	3	14	17	0	0	17	0	0
1	51729697	.	C	A	2	16	18	0	1	19	0	0
1	51729735	.	C	A	11	18	29	0	0	29	0	0
1	51729798	.	A	C	3	14	17	0	1	18	0	0
1	51733129	.	T	A	9	10	19	0	1	20	0	0
1	51733284	.	T	A	14	19	33	0	0	33	0	0
1	51903897	.	A	T	0	3	3	0	0	3	0	0
1	51903903	.	A	T	1	3	4	0	0	4	0	0
1	51960576	.	G	C	4	1	5	0	0	5	0	0
1	52054116	.	A	G	2	2	4	0	1	5	0	0
1	52073807	.	C	G	0	2	2	0	0	2	0	0
1	52113225	.	T	C	2	0	2	0	3	5	0	0
1	52113251	.	G	A	3	2	5	0	0	5	0	0
1	52115862	.	C	T	0	6	6	0	6	12	0	0
1	52115880	.	G	C	7	8	15	0	0	15	0	0
1	52121275	.	G	T	1	0	1	0	0	1	0	0
1	52121311	.	A	G	3	4	7	0	0	7	0	0
1	52121450	.	C	T	0	0	0	0	2	2	0	0
1	52124240	.	C	T	0	4	4	0	6	10	0	0
1	52130268	.	G	A	0	13	13	0	9	22	0	0
1	52130328	.	T	C	7	8	15	0	6	21	0	0
1	52130339	.	A	G	7	11	18	0	4	22	0	0
1	52130431	.	G	A	16	16	32	0	0	32	0	0
1	52134992	.	G	A	1	1	2	0	0	2	0	0
1	52135254	.	T	C	15	10	25	0	0	25	0	0
1	52135303	.	T	C	13	10	23	0	0	23	0	0
1	52135513	.	G	A	1	5	6	0	1	7	0	0
1	52135840	.	C	A	8	7	15	0	0	15	0	0
1	52135972	.	A	T	10	7	17	0	1	18	0	0
1	52136027	.	T	C	9	12	21	0	0	21	0	0
1	52136117	.	A	C	13	12	25	0	1	26	0	0
1	52136294	.	T	C	8	6	14	0	0	14	0	0
1	52136454	.	A	C	6	9	15	0	0	15	0	0
1	52136641	.	A	G	5	1	6	0	0	6	0	0
1	52136759	.	A	T	10	18	28	0	1	29	0	0
1	52136762	.	A	C	11	17	28	0	0	28	0	0
1	52136868	.	A	G	9	8	17	0	0	17	0	0
1	52136894	.	T	C	12	10	22	0	0	22	0	0
1	52136917	.	A	C	9	12	21	0	0	21	0	0
1	52137013	.	T	A	4	8	12	0	3	15	0	0
1	52137147	.	T	A	1	1	2	0	2	4	0	0
1	52137152	.	T	A	1	3	4	0	0	4	0	0
1	52137639	.	A	G	15	10	25	0	5	30	0	0
1	52146021	.	A	T	9	7	16	0	0	16	0	0
1	52149554	.	A	T	17	22	39	0	7	46	0	0
1	52149794	.	A	G	15	14	29	0	0	29	0	0
1	52149952	.	A	G	14	0	14	0	5	19	0	0
1	52149977	.	T	A	14	3	17	0	0	17	0	0
1	52150029	.	T	C	15	11	26	0	0	26	0	0
1	52150152	.	G	A	14	11	25	0	0	25	0	0
1	52150182	.	G	T	0	15	15	0	21	36	0	0
1	52150231	.	C	T	18	19	37	0	1	38	0	0
1	52150400	.	A	G	13	4	17	0	1	18	0	0
1	52150812	.	A	G	9	12	21	0	0	21	0	0
1	52150826	.	A	G	11	7	18	0	0	18	0	0
1	52150900	.	G	T	6	3	9	0	0	9	0	0
1	52150974	.	A	G	10	8	18	0	0	18	0	0
1	52152043	.	A	G	3	4	7	0	0	7	0	0
1	52152188	.	G	A	0	9	9	0	15	24	0	0
1	52152202	.	A	G	13	7	20	0	1	21	0	0
1	52152300	.	A	T	4	10	14	0	0	14	0	0
1	52152398	.	T	C	11	17	28	0	1	29	0	0
1	52152406	.	A	C	12	20	32	0	0	32	0	0
1	52152488	.	A	G	11	16	27	0	0	27	0	0
1	52179066	.	C	T	0	9	9	0	8	17	0	0
1	52198224	.	T	C	0	2	2	0	0	2	0	0
1	52198293	.	T	G	4	4	8	0	0	8	0	0
1	52452275	.	G	T	8	7	15	0	2	17	0	0
1	52452332	.	C	T	3	4	7	0	0	7	0	0
1	52455908	.	G	A	3	2	5	0	0	5	0	0
1	52455960	.	C	T	5	7	12	0	0	12	0	0
1	52456002	.	G	A	0	2	2	0	0	2	0	0
1	52460737	.	C	T	11	5	16	0	2	18	0	0
1	52460739	.	T	C	11	7	18	0	0	18	0	0
1	52460906	.	T	C	5	7	12	0	0	12	0	0
1	52460944	.	G	T	6	10	16	0	2	18	0	0
1	52469771	.	T	C	3	2	5	0	0	5	0	0
1	52474010	.	C	T	1	1	2	0	2	4	0	0
1	52474335	.	G	A	0	2	2	0	1	3	0	0
1	52478381	.	C	T	2	5	7	0	0	7	0	0
1	52478600	.	A	T	1	2	3	0	2	5	0	0
1	52485177	.	G	A	0	2	2	0	6	8	0	0
1	52485216	.	T	C	5	1	6	0	0	6	0	0
1	52486008	.	G	A	0	2	2	0	0	2	0	0
1	52486125	.	T	C	2	6	8	0	0	8	0	0
1	52486198	.	A	G	5	1	6	0	5	11	0	0
1	52486209	.	A	G	5	6	11	0	1	12	0	0
1	52486690	.	A	G	7	4	11	0	0	11	0	0
1	52489974	.	G	A	1	3	4	0	6	10	0	0
1	52495004	.	T	A	2	0	2	0	0	2	0	0
1	52495045	.	C	T	0	2	2	0	1	3	0	0
1	52501213	.	A	C	1	0	1	0	5	6	0	0
1	52501794	.	T	C	1	0	1	0	0	1	0	0
1	52501800	.	G	A	1	1	2	0	0	2	0	0
1	52536660	.	A	G	0	0	0	0	4	4	0	0
1	52560607	.	G	A	0	3	3	0	3	6	0	0
1	52574973	.	G	A	0	1	1	0	0	1	0	0
1	52577639	.	A	G	1	0	1	0	0	1	0	0
1	52577657	.	G	A	0	3	3	0	0	3	0	0
1	52595043	.	C	A	3	2	5	0	0	5	0	0
1	52595160	.	C	A	1	1	2	0	0	2	0	0
1	52598538	.	C	T	7	4	11	0	1	12	0	0
1	52598549	.	A	G	7	3	10	0	1	11	0	0
1	52599152	.	G	C	3	5	8	0	0	8	0	0
1	52599189	.	G	A	0	2	2	0	1	3	0	0
1	52603345	.	T	C	4	4	8	0	1	9	0	0
1	52609392	.	C	T	1	4	5	0	0	5	0	0
1	52610788	.	G	A	4	1	5	0	0	5	0	0
1	52611769	.	G	T	0	1	1	0	2	3	0	0
1	52611963	.	A	G	1	0	1	0	0	1	0	0
1	52613216	.	G	T	3	1	4	0	0	4	0	0
1	52614253	.	C	T	1	2	3	0	0	3	0	0
1	52614377	.	C	T	1	3	4	0	0	4	0	0
1	52615031	.	C	T	1	2	3	0	0	3	0	0
1	52618405	.	C	T	10	7	17	0	3	20	0	0
1	52621542	.	C	T	2	6	8	0	0	8	0	0
1	52621545	.	C	T	2	6	8	0	0	8	0	0
1	52623591	.	G	A	1	2	3	0	0	3	0	0
1	52625747	.	C	G	12	2	14	0	10	24	0	0
1	52626888	.	A	G	8	4	12	0	0	12	0	0
1	52627572	.	G	A	1	16	17	0	22	40	1	0
1	52627678	.	A	T	19	18	37	0	1	38	0	0
1	52627679	.	C	T	18	17	35	0	3	38	0	0
1	52627794	.	G	A	14	6	20	0	0	20	0	0
1	52627984	.	T	C	12	19	31	0	1	32	0	0
1	52628253	.	G	T	10	7	17	0	0	17	0	0
1	52628322	.	A	T	7	3	10	0	1	11	0	0
1	52653899	.	T	C	1	3	4	0	0	4	0	0
1	52653900	.	T	C	1	3	4	0	0	4	0	0
1	52659459	.	T	C	2	2	4	0	0	4	0	0
1	52659498	.	A	G	1	0	1	0	0	1	0	0
1	52676405	.	A	G	1	2	3	0	0	3	0	0
1	52680016	.	C	T	3	3	6	0	1	7	0	0
1	52681185	.	G	A	10	5	15	0	0	15	0	0
1	52681212	.	T	C	4	6	10	0	0	10	0	0
1	52685099	.	G	A	0	1	1	0	3	4	0	0
1	52685145	.	A	C	1	2	3	0	0	3	0	0
1	52688223	.	G	A	0	6	6	0	3	9	0	0
1	52688355	.	C	T	1	4	5	0	0	5	0	0
1	52698944	.	G	T	6	3	9	0	0	9	0	0
1	52698955	.	C	T	7	4	11	0	1	12	0	0
1	52764824	.	A	T	7	3	10	0	0	10	0	0
1	52773239	.	G	A	1	1	2	0	0	2	0	0
1	52773311	.	A	G	7	6	13	0	0	13	0	0
1	52775649	.	A	G	16	16	32	0	2	34	0	0
1	52779785	.	G	A	10	4	14	0	0	14	0	0
1	52782161	.	G	A	17	11	28	0	0	28	0	0
1	52782220	.	G	T	6	8	14	0	0	14	0	0
1	52784483	.	C	A	6	5	11	0	1	12	0	0
1	52784527	.	C	T	0	4	4	0	6	10	0	0
1	52784549	.	A	T	6	3	9	0	1	10	0	0
1	52784600	.	G	A	2	6	8	0	1	9	0	0
1	52784679	.	G	C	7	7	14	0	0	14	0	0
1	52784702	.	G	A	10	8	18	0	0	18	0	0
1	52792476	.	C	A	3	9	12	0	0	12	0	0
1	52796142	.	T	C	2	1	3	0	0	3	0	0
1	52796148	.	A	G	1	1	2	0	1	3	0	0
1	52796844	.	T	G	1	0	1	0	1	2	0	0
1	52796850	.	C	T	2	1	3	0	0	3	0	0
1	52796964	.	T	C	9	0	9	0	1	10	0	0
1	52797128	.	C	T	3	4	7	0	0	7	0	0
1	52797152	.	T	C	5	4	9	0	0	9	0	0
1	52798991	.	T	C	5	3	8	0	0	8	0	0
1	52798994	.	C	T	5	3	8	0	0	8	0	0
1	52799789	.	C	T	9	4	13	0	0	13	0	0
1	52812162	.	G	A	6	6	12	0	0	12	0	0
1	52812219	.	C	G	8	7	15	0	0	15	0	0
1	52813633	.	A	T	12	14	26	0	0	26	0	0
1	52817949	.	C	G	0	2	2	0	0	2	0	0
1	53007935	.	A	G	7	7	14	0	0	14	0	0
1	53025666	.	C	T	2	2	4	0	0	4	0	0
1	53025708	.	C	G	2	2	4	0	0	4	0	0
1	53025711	.	C	T	1	1	2	0	0	2	0	0
1	53132860	.	T	C	4	1	5	0	1	6	0	0
1	53156324	.	A	G	6	4	10	0	1	11	0	0
1	53156413	.	C	T	6	6	12	0	0	12	0	0
1	53166094	.	A	G	6	6	12	0	0	12	0	0
1	53168227	.	A	G	6	0	6	0	9	15	0	0
1	53185877	.	A	C	2	0	2	0	0	2	0	0
1	53185906	.	T	C	8	1	9	0	1	10	0	0
1	53185945	.	T	C	13	7	20	0	0	20	0	0
1	53234989	.	C	T	1	2	3	0	0	3	0	0
1	53235021	.	G	A	1	2	3	0	0	3	0	0
1	53238434	.	A	G	0	1	1	0	0	1	0	0
1	53267026	.	A	C	6	0	6	0	6	12	0	0
1	53267349	.	A	G	10	3	13	0	0	13	0	0
1	53269670	.	A	C	6	5	11	0	0	11	0	0
1	53269694	.	A	G	1	0	1	0	0	1	0	0
1	53273488	.	A	G	3	4	7	0	0	7	0	0
1	53273524	.	G	A	6	6	12	0	1	13	0	0
1	53277064	.	C	T	5	5	10	0	0	10	0	0
1	53296672	.	C	T	0	2	2	0	0	2	0	0
1	53296792	.	A	G	2	0	2	0	3	5	0	0
1	53298665	.	G	A	0	5	5	0	5	10	0	0
1	53334460	.	C	T	1	3	4	0	0	4	0	0
1	53338551	.	T	C	2	1	3	0	0	3	0	0
1	53340349	.	T	G	4	3	7	0	0	7	0	0
1	53341634	.	A	G	4	3	7	0	2	9	0	0
1	53341664	.	A	G	3	2	5	0	0	5	0	0
1	53343124	.	G	A	1	6	7	0	0	7	0	0
1	53344200	.	T	C	3	10	13	0	0	13	0	0
1	53344204	.	T	G	3	10	13	0	0	13	0	0
1	53348920	.	A	G	7	6	13	0	0	13	0	0
1	53352481	.	T	C	6	2	8	0	0	8	0	0
1	53360153	.	T	C	12	12	24	0	1	25	0	0
1	53360308	.	G	A	12	7	19	0	1	20	0	0
1	53360342	.	C	T	13	10	23	0	0	23	0	0
1	53360369	.	C	T	8	8	16	0	2	18	0	0
1	53360459	.	C	T	14	15	29	0	1	30	0	0
1	53360549	.	T	C	11	15	26	0	2	28	0	0
1	53360871	.	G	A	8	7	15	0	0	15	0	0
1	53385017	.	G	A	1	8	9	0	5	14	0	0
1	53385087	.	A	G	6	0	6	0	5	11	0	0
1	53387431	.	T	A	11	11	22	0	0	22	0	0
1	53387521	.	T	C	3	3	6	0	1	7	0	0
1	53387573	.	T	C	5	6	11	0	0	11	0	0
1	53387633	.	T	A	2	2	4	0	0	4	0	0
1	53387722	.	G	A	3	8	11	0	0	11	0	0
1	53387779	.	T	G	1	9	10	0	3	13	0	0
1	53387786	.	C	T	2	13	15	0	1	16	0	0
1	53387829	.	C	T	6	18	24	0	1	25	0	0
1	53387954	.	A	G	9	8	17	0	0	17	0	0
1	53387990	.	T	C	11	12	23	0	0	23	0	0
1	53388005	.	T	C	12	11	23	0	1	24	0	0
1	53388135	.	A	C	11	23	34	0	2	36	0	0
1	53388309	.	G	C	15	13	28	0	2	30	0	0
1	53388476	.	A	C	9	18	27	0	0	27	0	0
1	53388540	.	T	A	11	19	30	0	2	32	0	0
1	53388590	.	T	G	12	17	29	0	1	30	0	0
1	53388861	.	A	G	5	11	16	0	1	17	0	0
1	53391669	.	A	C	16	13	29	0	1	30	0	0
1	53391729	.	T	C	19	0	19	0	3	22	0	0
1	53391860	.	G	T	7	1	8	0	0	8	0	0
1	53391916	.	C	T	7	5	12	0	0	12	0	0
1	53391959	.	T	A	10	5	15	0	0	15	0	0
1	53392002	.	A	T	8	9	17	0	1	18	0	0
1	53392064	.	T	C	16	0	16	0	17	33	0	0
1	53392161	.	T	C	14	8	22	0	0	22	0	0
1	53395328	.	C	T	1	2	3	0	0	3	0	0
1	53395374	.	T	G	1	2	3	0	0	3	0	0
1	53395376	.	G	A	1	2	3	0	0	3	0	0
1	53395627	.	T	C	5	5	10	0	0	10	0	0
1	53395688	.	G	A	6	4	10	0	1	11	0	0
1	53395710	.	G	C	6	5	11	0	0	11	0	0
1	53395828	.	G	A	11	12	23	0	1	24	0	0
1	53401794	.	T	C	0	3	3	0	0	3	0	0
1	53403876	.	T	A	2	3	5	0	0	5	0	0
1	53491565	.	A	G	7	3	10	0	5	15	0	0
1	53491937	.	A	G	7	6	13	0	1	14	0	0
1	53491964	.	T	A	8	10	18	0	1	19	0	0
1	53492000	.	C	A	5	6	11	0	1	12	0	0
1	53668926	.	C	A	2	0	2	0	0	2	0	0
1	53670917	.	G	T	5	1	6	0	0	6	0	0
1	53672795	.	G	A	2	3	5	0	0	5	0	0
1	53674825	.	G	A	3	2	5	0	0	5	0	0
1	53684729	.	C	T	1	2	3	0	0	3	0	0
1	53684982	.	T	C	2	5	7	0	0	7	0	0
1	53688824	.	A	T	1	1	2	0	0	2	0	0
1	53701875	.	A	G	6	9	15	0	0	15	0	0
1	53701905	.	T	G	3	7	10	0	0	10	0	0
1	53703149	.	G	A	0	1	1	0	0	1	0	0
1	53703194	.	G	T	11	16	27	0	2	29	0	0
1	53704485	.	C	A	24	11	35	0	2	37	0	0
1	53705191	.	G	A	4	1	5	0	0	5	0	0
1	53705203	.	G	A	5	7	12	0	1	13	0	0
1	53705266	.	A	G	13	15	28	0	0	28	0	0
1	53709732	.	C	A	0	10	10	0	21	31	0	0
1	53709762	.	C	T	17	9	26	0	0	26	0	0
1	53713449	.	G	T	6	6	12	0	0	12	0	0
1	53714790	.	T	A	15	18	33	0	2	35	0	0
1	53714853	.	A	G	1	2	3	0	0	3	0	0
1	53714974	.	T	A	3	4	7	0	1	9	1	0
1	53714977	.	T	G	4	0	4	0	5	9	0	0
1	53715083	.	G	A	3	0	3	0	1	4	0	0
1	53718266	.	A	G	1	3	4	0	0	4	0	0
1	53718294	.	A	T	2	4	6	0	0	6	0	0
1	53719831	.	T	C	1	0	1	0	0	1	0	0
1	53722489	.	A	T	1	0	1	0	0	1	0	0
1	53724724	.	T	A	2	4	6	0	0	6	0	0
1	53726457	.	G	A	0	1	1	0	0	1	0	0
1	53727755	.	C	T	5	0	5	0	0	5	0	0
1	53735245	.	C	T	8	6	14	0	1	15	0	0
1	53735249	.	C	T	8	7	15	0	2	17	0	0
1	53735648	.	A	G	13	8	21	0	0	21	0	0
1	53735702	.	T	G	8	6	14	0	0	14	0	0
1	53735712	.	G	A	6	5	11	0	1	12	0	0
1	53739397	.	G	A	6	10	16	0	0	16	0	0
1	53756723	.	C	T	0	16	16	0	14	30	0	0
1	53865815	.	T	G	1	2	3	0	0	3	0	0
1	53866223	.	A	T	4	5	9	0	0	9	0	0
1	53871326	.	T	A	1	4	5	0	0	5	0	0
1	53871338	.	C	A	4	1	5	0	0	5	0	0
1	53871383	.	A	G	6	2	8	0	0	8	0	0
1	53871416	.	C	A	1	5	6	0	0	6	0	0
1	53872031	.	C	A	7	5	12	0	1	13	0	0
1	53873112	.	T	C	9	0	9	0	5	14	0	0
1	53879353	.	C	T	0	1	1	0	3	4	0	0
1	53879397	.	C	T	4	3	7	0	0	7	0	0
1	53879731	.	T	C	2	0	2	0	1	3	0	0
1	53879767	.	G	A	2	2	4	0	0	4	0	0
1	53911924	.	G	A	2	3	5	0	0	5	0	0
1	53912418	.	G	T	2	4	6	0	0	6	0	0
1	53926940	.	G	T	1	5	6	0	0	6	0	0
1	53932185	.	T	C	0	1	1	0	0	1	0	0
1	53932271	.	A	G	5	9	14	0	0	14	0	0
1	53935248	.	G	T	0	2	2	0	6	8	0	0
1	53935287	.	A	G	2	0	2	0	5	7	0	0
1	53935314	.	T	C	0	2	2	0	0	2	0	0
1	53937423	.	C	T	1	0	1	0	0	1	0	0
1	53939604	.	C	T	2	2	4	0	0	4	0	0
1	53954314	.	G	A	0	7	7	0	6	13	0	0
1	53954361	.	C	A	8	4	12	0	2	14	0	0
1	53954385	.	A	C	5	3	8	0	0	8	0	0
1	53955055	.	G	A	14	6	20	0	0	20	0	0
1	53958136	.	G	A	0	1	1	0	13	14	0	0
1	53958263	.	C	T	12	8	20	0	1	21	0	0
1	53962227	.	A	T	7	6	13	0	0	13	0	0
1	53962264	.	T	C	11	9	20	0	0	20	0	0
1	53962490	.	T	G	9	4	13	0	0	13	0	0
1	53962860	.	G	A	0	3	3	0	9	12	0	0
1	53962863	.	C	T	9	3	12	0	0	12	0	0
1	53962900	.	T	A	6	5	11	1	0	12	0	0
1	53963108	.	C	A	14	5	19	0	1	20	0	0
1	53963159	.	C	T	13	9	22	0	2	24	0	0
1	53963782	.	A	G	4	10	14	0	1	15	0	0
1	53987605	.	G	A	2	1	3	0	1	4	0	0
1	53987735	.	T	C	1	3	4	0	0	4	0	0
1	54022391	.	G	C	1	2	3	0	0	3	0	0
1	54022701	.	G	A	1	3	4	0	0	4	0	0
1	54025576	.	A	G	1	0	1	0	6	7	0	0
1	54048674	.	A	G	3	0	3	0	3	6	0	0
1	54048689	.	C	T	4	3	7	0	1	8	0	0
1	54061812	.	C	T	2	1	3	0	0	3	0	0
1	54061824	.	C	T	2	1	3	0	0	3	0	0
1	54062020	.	G	A	0	2	2	0	1	3	0	0
1	54062754	.	G	A	1	3	4	0	0	4	0	0
1	54062858	.	A	G	2	7	9	0	1	10	0	0
1	54063478	.	C	T	1	2	3	0	0	3	0	0
1	54069513	.	G	T	2	1	3	0	2	5	0	0
1	54069515	.	C	A	3	1	4	0	1	5	0	0
1	54075326	.	A	G	1	1	2	0	1	3	0	0
1	54077472	.	T	C	0	1	1	0	0	1	0	0
1	54080067	.	A	T	2	2	4	0	2	6	0	0
1	54080098	.	T	C	5	4	9	0	0	9	0	0
1	54080253	.	G	C	1	4	5	0	0	5	0	0
1	54080261	.	C	T	1	5	6	0	0	6	0	0
1	54080361	.	T	G	6	3	9	0	0	9	0	0
1	54080550	.	T	G	2	0	2	0	0	2	0	0
1	54084473	.	G	C	5	4	9	0	0	9	0	0
1	54084628	.	A	T	3	2	5	0	2	7	0	0
1	54089032	.	C	T	2	3	5	0	0	5	0	0
1	54100717	.	C	T	2	1	3	0	1	4	0	0
1	54100720	.	A	G	2	1	3	0	1	4	0	0
1	54101292	.	T	C	1	0	1	0	0	1	0	0
1	54107246	.	C	A	2	2	4	0	0	4	0	0
1	54140472	.	A	T	1	1	2	0	0	2	0	0
1	54142097	.	T	C	1	4	5	0	0	5	0	0
1	54142130	.	G	T	0	5	5	0	2	7	0	0
1	54144024	.	T	G	4	2	6	0	0	6	0	0
1	54146383	.	C	T	6	6	12	0	1	13	0	0
1	54146416	.	T	C	11	9	20	0	2	22	0	0
1	54154371	.	T	C	7	0	7	0	7	14	0	0
1	54154383	.	T	G	8	6	14	0	1	15	0	0
1	54158479	.	A	G	1	0	1	0	0	1	0	0
1	54161774	.	A	G	3	2	5	0	0	5	0	0
1	54167162	.	G	A	1	4	5	0	0	5	0	0
1	54167288	.	C	T	3	2	5	0	0	5	0	0
1	54167496	.	A	C	1	2	3	0	0	3	0	0
1	54178755	.	G	C	3	3	6	0	1	7	0	0
1	54182416	.	T	A	0	1	1	0	0	1	0	0
1	54182419	.	A	G	0	1	1	0	0	1	0	0
1	54184468	.	C	T	1	0	1	0	2	3	0	0
1	54190522	.	C	A	4	5	9	0	0	9	0	0
1	54190585	.	T	A	3	6	9	0	0	9	0	0
1	54191511	.	T	G	1	4	5	0	0	5	0	0
1	54197431	.	G	A	1	0	1	0	0	1	0	0
1	54197443	.	G	A	1	1	2	0	0	2	0	0
1	54199009	.	G	A	2	4	6	0	0	6	0	0
1	54210220	.	A	G	2	1	3	0	0	3	0	0
1	54219462	.	A	G	4	0	4	0	3	7	0	0
1	54244041	.	T	C	2	2	4	0	1	5	0	0
1	54244432	.	T	C	2	6	8	0	0	8	0	0
1	54245914	.	G	A	2	3	5	0	0	5	0	0
1	54248366	.	A	C	0	1	1	0	0	1	0	0
1	54253768	.	G	A	0	2	2	0	2	4	0	0
1	54255651	.	C	T	5	9	14	0	1	15	0	0
1	54262843	.	G	A	1	0	1	0	0	1	0	0
1	54674388	.	A	G	6	6	12	0	1	13	0	0
1	54674430	.	A	G	9	0	9	0	6	15	0	0
1	54685529	.	G	A	8	3	11	0	0	11	0	0
1	54685559	.	C	G	9	6	15	0	1	16	0	0
1	54685590	.	A	G	8	6	14	0	0	14	0	0
1	54685610	.	T	C	8	5	13	0	0	13	0	0
1	54685799	.	G	A	2	6	8	0	0	8	0	0
1	54685814	.	G	A	0	4	4	0	0	4	0	0
1	54687649	.	G	T	4	8	12	0	1	13	0	0
1	54687715	.	C	A	0	11	11	0	0	11	0	0
1	54687756	.	A	C	2	12	14	0	1	15	0	0
1	54687766	.	A	C	5	12	17	0	0	17	0	0
1	54687798	.	A	C	6	7	13	0	1	14	0	0
1	54687928	.	G	T	9	5	14	0	0	14	0	0
1	54687981	.	A	G	5	4	9	0	1	10	0	0
1	54701201	.	C	G	2	0	2	0	3	5	0	0
1	54701231	.	G	A	1	3	4	0	2	6	0	0
1	54707977	.	G	A	26	34	60	0	0	60	0	0
1	54708098	.	G	T	35	21	56	0	1	57	0	0
1	54708191	.	C	A	26	26	52	0	2	54	0	0
1	54708253	.	G	A	20	29	49	0	5	54	0	0
1	54708281	.	A	T	26	24	50	0	5	55	0	0
1	54708301	.	A	C	24	27	51	0	4	55	0	0
1	54708317	.	C	T	25	23	48	0	3	51	0	0
1	54708359	.	C	T	26	15	41	0	3	44	0	0
1	54708886	.	C	T	0	4	4	0	19	23	0	0
1	54709171	.	T	C	10	7	17	0	0	17	0	0
1	54709334	.	G	A	21	27	48	0	2	50	0	0
1	54735261	.	G	T	1	1	2	0	0	2	0	0
1	54737506	.	C	A	6	2	8	0	1	9	0	0
1	54737684	.	A	G	2	0	2	0	4	6	0	0
1	54747720	.	T	C	3	4	7	0	0	7	0	0
1	54747729	.	A	G	3	0	3	0	4	7	0	0
1	54753167	.	A	G	8	5	13	0	0	13	0	0
1	54753173	.	G	C	0	4	4	0	9	13	0	0
1	54754356	.	C	T	2	6	8	0	0	8	0	0
1	54754482	.	T	G	6	6	12	0	0	12	0	0
1	54754503	.	G	A	5	3	8	0	1	9	0	0
1	54754565	.	C	T	3	3	6	0	1	7	0	0
1	54754623	.	A	T	8	3	11	0	0	11	0	0
1	54754626	.	T	A	7	4	11	0	1	12	0	0
1	54754744	.	C	T	6	7	13	0	1	14	0	0
1	54754754	.	T	C	6	6	12	0	1	13	0	0
1	54754834	.	C	T	10	12	22	0	3	25	0	0
1	54754839	.	C	T	10	15	25	0	0	25	0	0
1	54758624	.	A	T	6	8	14	0	0	14	0	0
1	54758725	.	C	T	0	16	16	0	20	36	0	0
1	54758810	.	C	T	17	15	32	0	0	32	0	0
1	54758975	.	T	C	12	18	30	0	3	33	0	0
1	54759065	.	G	A	6	8	14	0	0	14	0	0
1	54762947	.	G	A	1	1	2	0	0	2	0	0
1	54762997	.	G	T	10	11	21	0	2	23	0	0
1	54763022	.	G	C	10	14	24	0	1	25	0	0
1	54763070	.	C	G	0	17	17	0	4	21	0	0
1	54763106	.	A	G	6	9	15	0	0	15	0	0
1	54763133	.	T	C	7	5	12	0	0	12	0	0
1	54763182	.	A	G	9	9	18	0	0	18	0	0
1	54763187	.	G	A	9	9	18	0	0	18	0	0
1	54763298	.	G	A	8	1	9	0	0	9	0	0
1	54765216	.	A	C	20	0	20	0	14	35	1	0
1	54765218	.	C	T	1	13	14	0	19	35	2	0
1	54774007	.	A	G	1	3	4	0	0	4	0	0
1	54893126	.	C	G	4	2	6	0	0	6	0	0
1	54893140	.	G	A	0	3	3	0	6	9	0	0
1	54893198	.	G	A	0	5	5	0	10	15	0	0
1	54893265	.	G	C	4	4	8	0	0	8	0	0
1	54897256	.	C	T	5	2	7	0	0	7	0	0
1	54897288	.	C	T	2	0	2	0	0	2	0	0
1	54898178	.	G	A	0	1	1	0	3	4	0	0
1	54898489	.	A	T	4	2	6	0	1	7	0	0
1	54906162	.	G	A	0	3	3	0	6	9	0	0
1	54906192	.	T	C	1	1	2	0	0	2	0	0
1	54906476	.	G	C	0	2	2	0	2	4	0	0
1	54906619	.	T	A	3	2	5	0	0	5	0	0
1	54907021	.	G	A	8	8	16	0	0	16	0	0
1	54907074	.	G	A	4	5	9	0	0	9	0	0
1	54907077	.	T	A	3	5	8	0	1	9	0	0
1	54907367	.	T	G	5	2	7	0	1	8	0	0
1	54907502	.	A	G	3	5	8	0	0	8	0	0
1	54907549	.	T	C	9	7	16	0	0	16	0	0
1	54907585	.	G	C	12	8	20	0	0	20	0	0
1	54907600	.	A	T	11	9	20	0	0	20	0	0
1	54907622	.	T	C	11	8	19	0	1	20	0	0
1	54907698	.	G	T	7	4	11	0	0	11	0	0
1	54907707	.	C	T	8	3	11	0	0	11	0	0
1	54927198	.	T	C	3	2	5	0	0	5	0	0
1	54928991	.	T	C	2	1	3	0	0	3	0	0
1	54929006	.	C	T	3	2	5	0	1	6	0	0
1	54929168	.	G	A	12	11	23	0	2	25	0	0
1	54929256	.	T	C	14	6	20	0	2	22	0	0
1	54929281	.	G	A	4	8	12	0	13	25	0	0
1	54929293	.	C	T	9	7	16	0	7	23	0	0
1	54929373	.	C	G	6	5	11	0	0	11	0	0
1	54929425	.	G	A	3	3	6	0	0	6	0	0
1	54930428	.	T	A	7	4	11	0	0	11	0	0
1	54930486	.	G	A	4	5	9	0	1	10	0	0
1	54930598	.	A	G	6	13	19	0	0	19	0	0
1	54930626	.	A	C	4	11	15	0	1	16	0	0
1	54930693	.	T	C	10	8	18	0	0	18	0	0
1	54930711	.	G	A	10	10	20	0	1	21	0	0
1	54930776	.	A	G	6	14	20	0	1	21	0	0
1	54930868	.	C	A	5	6	11	0	0	11	0	0
1	54931111	.	T	C	4	6	10	0	0	10	0	0
1	54931122	.	G	A	0	5	5	0	4	9	0	0
1	54931211	.	A	T	7	10	17	0	2	19	0	0
1	54931230	.	T	A	8	11	19	0	0	19	0	0
1	54931791	.	G	C	0	8	8	0	11	19	0	0
1	54934639	.	T	A	1	2	3	0	0	3	0	0
1	54934658	.	T	G	1	3	4	0	0	4	0	0
1	54936471	.	T	C	20	1	21	0	17	38	0	0
1	54938274	.	T	C	8	6	14	0	0	14	0	0
1	54939536	.	A	T	3	11	14	0	3	17	0	0
1	54941036	.	G	A	10	25	35	0	1	36	0	0
1	54943139	.	G	A	7	17	24	0	1	25	0	0
1	54943160	.	A	G	5	11	16	0	1	17	0	0
1	54943178	.	G	A	3	7	10	0	0	10	0	0
1	54945039	.	A	G	4	5	9	0	0	9	0	0
1	54945108	.	T	C	4	0	4	0	5	9	0	0
1	54945175	.	T	G	1	6	7	0	0	7	0	0
1	54945195	.	A	C	1	2	3	0	0	3	0	0
1	54946977	.	A	C	3	0	3	0	11	14	0	0
1	54950534	.	T	C	8	11	19	0	0	19	0	0
1	54950572	.	G	A	14	7	21	0	1	22	0	0
1	54950661	.	G	A	13	12	25	0	0	25	0	0
1	54950745	.	G	T	9	9	18	0	1	19	0	0
1	54955207	.	G	A	2	1	3	0	0	3	0	0
1	54955234	.	A	G	5	1	6	0	0	6	0	0
1	54958123	.	A	G	7	3	10	0	0	10	0	0
1	54958146	.	T	A	7	3	10	0	2	12	0	0
1	54960328	.	A	G	7	13	20	0	0	20	0	0
1	54960368	.	T	G	10	16	26	0	2	28	0	0
1	54960416	.	A	C	13	23	36	0	2	38	0	0
1	54960563	.	T	A	9	19	28	1	2	31	0	0
1	54960620	.	G	C	2	2	4	0	0	4	0	0
1	54960639	.	C	T	0	3	3	0	3	6	0	0
1	54960881	.	A	G	11	16	27	0	4	31	0	0
1	54962466	.	A	G	5	11	16	0	2	18	0	0
1	54963314	.	A	G	8	21	29	0	0	29	0	0
1	54964724	.	A	G	13	14	27	0	1	28	0	0
1	54974437	.	C	A	3	3	6	0	0	6	0	0
1	54974438	.	A	G	3	3	6	0	0	6	0	0
1	54974477	.	G	A	6	0	6	0	0	6	0	0
1	54974500	.	T	A	8	6	14	0	0	14	0	0
1	54974538	.	A	G	6	7	13	0	0	13	0	0
1	54974774	.	G	A	4	10	14	0	0	14	0	0
1	54974810	.	G	T	6	4	10	0	0	10	0	0
1	54975136	.	A	T	5	6	11	0	1	12	0	0
1	54975284	.	C	G	0	1	1	0	0	1	0	0
1	54975286	.	C	T	0	1	1	0	0	1	0	0
1	54975431	.	C	T	3	3	6	0	1	7	0	0
1	54975484	.	G	T	9	6	15	0	0	15	0	0
1	54975519	.	C	T	10	6	16	0	0	16	0	0
1	54975636	.	C	T	3	7	10	0	1	11	0	0
1	54975658	.	A	G	7	4	11	0	0	11	0	0
1	54975762	.	A	T	8	5	13	0	1	14	0	0
1	54975911	.	G	A	3	6	9	0	0	9	0	0
1	54976026	.	T	A	3	8	11	0	0	11	0	0
1	54976035	.	T	A	2	8	10	0	0	10	0	0
1	54976104	.	G	A	1	7	8	0	0	8	0	0
1	54976178	.	T	C	8	0	8	0	5	13	0	0
1	54976249	.	T	A	12	5	17	0	0	17	0	0
1	54976256	.	C	T	10	5	15	0	3	18	0	0
1	54976353	.	A	G	5	5	10	0	0	10	0	0
1	54976359	.	T	C	3	6	9	0	0	9	0	0
1	54976731	.	C	T	1	4	5	0	0	5	0	0
1	54976732	.	A	G	1	4	5	0	0	5	0	0
1	54977256	.	T	C	5	3	8	0	1	9	0	0
1	54977308	.	C	A	2	2	4	0	0	4	0	0
1	54977329	.	A	G	1	2	3	0	0	3	0	0
1	54977422	.	G	A	6	4	10	0	0	10	0	0
1	54977426	.	T	C	6	3	9	0	1	10	0	0
1	54977572	.	G	A	3	5	8	0	0	8	0	0
1	54977618	.	G	A	6	4	10	0	1	11	0	0
1	54977636	.	T	C	7	2	9	0	1	10	0	0
1	54977697	.	G	A	5	6	11	0	0	11	0	0
1	54977719	.	T	A	4	5	9	0	0	9	0	0
1	54977767	.	A	T	3	3	6	0	0	6	0	0
1	54977781	.	A	G	3	3	6	0	0	6	0	0
1	54978022	.	T	G	3	3	6	0	0	6	0	0
1	54978023	.	C	T	0	3	3	0	3	6	0	0
1	54981628	.	G	A	8	7	15	0	1	16	0	0
1	54984172	.	A	G	3	4	7	0	0	7	0	0
1	54984206	.	T	C	2	0	2	0	3	5	0	0
1	54985320	.	C	T	5	5	10	0	0	10	0	0
1	54987539	.	A	G	2	1	3	0	0	3	0	0
1	54988190	.	T	G	0	1	1	0	0	1	0	0
1	54988259	.	G	A	2	6	8	0	0	8	0	0
1	54997275	.	T	C	9	0	9	0	7	16	0	0
1	54997327	.	T	C	7	4	11	0	0	11	0	0
1	55008322	.	A	G	16	10	26	0	1	27	0	0
1	55008382	.	C	T	13	11	24	0	0	24	0	0
1	55008405	.	G	A	11	12	23	0	0	23	0	0
1	55008772	.	T	C	7	11	18	0	0	18	0	0
1	55010914	.	A	C	8	4	12	0	0	12	0	0
1	55011101	.	T	A	2	3	5	0	0	5	0	0
1	55011117	.	T	C	2	4	6	0	0	6	0	0
1	55011353	.	G	C	3	5	8	0	0	8	0	0
1	55011514	.	C	T	6	10	16	0	1	17	0	0
1	55011539	.	A	T	6	8	14	0	0	14	0	0
1	55011550	.	G	A	7	7	14	0	0	14	0	0
1	55011692	.	C	T	0	6	6	0	4	10	0	0
1	55013350	.	G	A	1	0	1	0	0	1	0	0
1	55018914	.	A	G	1	1	2	0	0	2	0	0
1	55021862	.	A	T	2	1	3	0	1	4	0	0
1	55021886	.	G	A	3	2	5	0	0	5	0	0
1	55021952	.	G	A	4	2	6	0	0	6	0	0
1	55022075	.	T	C	5	0	5	0	4	9	0	0
1	55022162	.	T	A	4	3	7	0	0	7	0	0
1	55037612	.	C	T	4	4	8	0	0	8	0	0
1	55037627	.	T	G	2	2	4	0	0	4	0	0
1	55046494	.	G	A	2	1	3	0	0	3	0	0
1	55046509	.	G	A	2	2	4	0	1	5	0	0
1	55046541	.	A	G	2	5	7	0	1	8	0	0
1	55046560	.	A	C	1	5	6	0	0	6	0	0
1	55046591	.	G	A	3	2	5	0	0	5	0	0
1	55047540	.	C	T	1	2	3	0	0	3	0	0
1	55048203	.	A	G	1	3	4	0	0	4	0	0
1	55049129	.	C	T	1	4	5	0	0	5	0	0
1	55056285	.	C	T	2	3	5	0	0	5	0	0
1	55080893	.	G	C	2	3	5	0	0	5	0	0
1	55080905	.	A	G	2	3	5	0	0	5	0	0
1	55084464	.	G	A	0	1	1	0	0	1	0	0
1	55084673	.	A	G	2	1	3	0	0	3	0	0
1	55085830	.	A	T	1	2	3	0	0	3	0	0
1	55087742	.	T	C	7	2	9	0	0	9	0	0
1	55087823	.	G	C	4	3	7	0	0	7	0	0
1	55087949	.	A	C	2	2	4	0	0	4	0	0
1	55088074	.	G	T	2	3	5	0	0	5	0	0
1	55088075	.	A	G	2	3	5	0	0	5	0	0
1	55088467	.	T	A	3	5	8	0	0	8	0	0
1	55088490	.	C	A	3	1	4	0	0	4	0	0
1	55088943	.	A	T	2	2	4	0	0	4	0	0
1	55089078	.	T	A	3	7	10	0	1	11	0	0
1	55089316	.	G	A	0	5	5	0	2	7	0	0
1	55089328	.	G	A	2	6	8	0	0	8	0	0
1	55089396	.	C	T	7	5	12	0	0	12	0	0
1	55089449	.	G	A	2	2	4	0	0	4	0	0
1	55089877	.	C	T	1	3	4	0	0	4	0	0
1	55099316	.	T	C	7	6	13	0	0	13	0	0
1	55099411	.	G	A	3	4	7	0	0	7	0	0
1	55099880	.	C	G	4	8	12	0	0	12	0	0
1	55100378	.	G	A	0	9	9	0	9	18	0	0
1	55100397	.	G	C	10	7	17	0	0	17	0	0
1	55100422	.	T	A	7	7	14	0	1	15	0	0
1	55101439	.	C	A	7	1	8	0	0	8	0	0
1	55103163	.	A	C	4	8	12	0	0	12	0	0
1	55109717	.	A	T	12	7	19	0	1	20	0	0
1	55126626	.	A	C	4	1	5	0	5	10	0	0
1	55126635	.	G	A	6	3	9	0	1	10	0	0
1	55127910	.	C	T	5	4	9	0	0	9	0	0
1	55131337	.	A	T	7	13	20	0	1	21	0	0
1	55131359	.	A	T	3	14	17	0	1	18	0	0
1	55161252	.	T	C	3	1	4	0	5	9	0	0
1	55166477	.	G	A	0	3	3	0	0	3	0	0
1	55166531	.	T	A	3	2	5	0	0	5	0	0
1	55166533	.	C	T	0	2	2	0	3	5	0	0
1	55169244	.	G	C	2	3	5	0	1	6	0	0
1	55169260	.	G	A	6	4	10	0	0	10	0	0
1	55169658	.	T	A	12	5	17	0	0	17	0	0
1	55170051	.	T	A	5	6	11	0	0	11	0	0
1	55170161	.	C	A	2	5	7	0	1	8	0	0
1	55170804	.	T	C	2	7	9	0	0	9	0	0
1	55170920	.	C	T	8	6	14	0	0	14	0	0
1	55171249	.	G	A	6	9	15	0	0	15	0	0
1	55179434	.	C	T	2	2	4	0	0	4	0	0
1	55183074	.	G	A	5	10	15	0	0	15	0	0
1	55191256	.	A	T	3	4	7	0	1	8	0	0
1	55191471	.	T	C	14	0	14	0	9	23	0	0
1	55191559	.	G	A	11	9	20	0	0	20	0	0
1	55191675	.	A	G	7	6	13	0	1	14	0	0
1	55195384	.	G	T	2	4	6	0	1	7	0	0
1	55196024	.	G	T	10	10	20	0	0	20	0	0
1	55223001	.	A	C	3	0	3	0	4	7	0	0
1	55229531	.	T	A	2	3	5	0	0	5	0	0
1	55233984	.	C	T	0	4	4	0	1	5	0	0
1	55234020	.	A	G	3	2	5	0	1	6	0	0
1	55234200	.	G	C	2	0	2	0	0	2	0	0
1	55247955	.	T	G	3	2	5	0	0	5	0	0
1	55247967	.	A	C	3	2	5	0	0	5	0	0
1	55248210	.	T	A	1	2	3	0	0	3	0	0
1	55248343	.	T	C	2	0	2	0	2	4	0	0
1	55745816	.	C	T	3	3	6	0	0	6	0	0
1	55745821	.	T	C	2	0	2	0	3	5	0	0
1	55746265	.	G	T	2	2	4	0	0	4	0	0
1	55748412	.	T	A	2	2	4	0	0	4	0	0
1	55749954	.	C	T	3	2	5	0	0	5	0	0
1	55776909	.	A	C	20	7	27	0	1	28	0	0
1	55785527	.	C	A	1	30	31	0	31	62	0	0
1	55785654	.	C	T	13	25	38	1	1	40	0	0
1	55787507	.	A	G	1	2	3	0	2	5	0	0
1	55789504	.	A	C	3	0	3	0	2	5	0	0
1	55796060	.	G	A	1	3	4	0	0	4	0	0
1	55817658	.	T	C	5	0	5	0	6	11	0	0
1	55817661	.	A	T	5	5	10	0	0	10	0	0
1	55818073	.	T	C	1	2	3	0	0	3	0	0
1	55818319	.	T	C	2	3	5	0	0	5	0	0
1	55833185	.	G	A	3	6	9	0	0	9	0	0
1	55833276	.	C	T	6	4	10	0	0	10	0	0
1	55833281	.	C	T	6	3	9	0	1	10	0	0
1	55839011	.	C	G	1	2	3	0	0	3	0	0
1	55839132	.	G	C	1	4	5	0	0	5	0	0
1	55843902	.	C	T	18	17	35	0	4	39	0	0
1	55843968	.	G	A	19	21	40	0	0	40	0	0
1	55844044	.	T	A	8	20	28	0	1	29	0	0
1	55844401	.	A	G	21	19	40	0	0	40	0	0
1	55849463	.	T	C	12	0	12	0	10	22	0	0
1	55853320	.	G	A	5	13	18	0	1	19	0	0
1	55872892	.	C	G	11	10	21	0	0	21	0	0
1	55873073	.	C	T	12	13	25	0	0	25	0	0
1	55878243	.	C	T	0	3	3	0	5	8	0	0
1	55878257	.	T	A	3	5	8	0	0	8	0	0
1	55878496	.	T	C	4	0	4	0	4	8	0	0
1	55878624	.	T	A	0	4	4	0	0	4	0	0
1	55878626	.	A	C	0	4	4	0	0	4	0	0
1	55885148	.	C	T	0	1	1	0	5	6	0	0
1	55888583	.	C	A	2	2	4	0	0	4	0	0
1	55888632	.	T	C	4	0	4	0	1	5	0	0
1	55888654	.	C	T	6	3	9	0	0	9	0	0
1	55888690	.	A	G	6	5	11	0	1	12	0	0
1	55888693	.	T	A	5	6	11	0	1	12	0	0
1	55888906	.	T	A	4	2	6	0	0	6	0	0
1	56217450	.	G	T	4	1	5	0	0	5	0	0
1	56217510	.	A	G	29	20	49	0	0	49	0	0
1	56217925	.	G	A	39	30	69	0	6	75	0	0
1	56218141	.	A	G	34	43	77	0	3	80	0	0
1	56218189	.	C	T	2	35	37	0	32	69	0	0
1	56218360	.	G	C	33	1	34	0	35	69	0	0
1	56424791	.	C	T	0	1	1	0	1	2	0	0
1	56424794	.	T	C	1	0	1	0	1	2	0	0
1	56428320	.	G	A	3	1	4	0	0	4	0	0
1	57278610	.	T	G	3	2	5	0	1	6	0	0
1	57280292	.	T	C	5	4	9	0	0	9	0	0
1	57280400	.	G	A	3	6	9	0	1	10	0	0
1	57280502	.	T	C	4	4	8	0	0	8	0	0
1	57311846	.	T	C	1	1	2	0	0	2	0	0
1	57331951	.	G	A	0	6	6	0	3	9	0	0
1	57331957	.	C	T	3	6	9	0	0	9	0	0
1	57332657	.	G	A	0	2	2	0	4	6	0	0
1	57332699	.	G	A	0	3	3	0	3	6	0	0
1	57332744	.	C	T	2	5	7	0	0	7	0	0
1	57334741	.	T	C	0	3	3	0	0	3	0	0
1	57337107	.	T	C	3	5	8	0	0	8	0	0
1	57337110	.	C	T	2	5	7	0	1	8	0	0
1	57337157	.	C	G	3	6	9	0	1	10	0	0
1	57338226	.	G	A	0	6	6	0	6	12	0	0
1	57338268	.	G	A	0	2	2	0	2	4	0	0
1	57347987	.	G	T	3	2	5	0	0	5	0	0
1	57348012	.	T	C	1	2	3	0	0	3	0	0
1	57361011	.	C	T	0	1	1	0	0	1	0	0
1	57978168	.	T	C	2	0	2	1	0	3	0	0
1	58013423	.	C	T	0	2	2	0	5	7	0	0
1	58013554	.	G	A	3	5	8	0	0	8	0	0
1	58015532	.	T	G	5	2	7	0	0	7	0	0
1	58015556	.	T	C	5	0	5	0	4	9	0	0
1	58015604	.	C	T	2	0	2	0	0	2	0	0
1	58018622	.	G	A	2	0	2	0	0	2	0	0
1	58018850	.	C	A	0	3	3	0	1	4	0	0
1	58019888	.	A	T	1	5	6	0	0	6	0	0
1	58020797	.	A	G	1	1	2	0	0	2	0	0
1	58023900	.	G	A	1	1	2	0	0	2	0	0
1	58545734	.	C	G	12	4	16	0	1	17	0	0
1	58547783	.	T	C	8	9	17	0	0	17	0	0
1	58548428	.	T	C	4	3	7	0	2	9	0	0
1	58548491	.	T	C	4	13	17	0	2	19	0	0
1	58568895	.	T	G	1	1	2	0	1	3	0	0
1	58572748	.	T	G	1	0	1	0	0	1	0	0
1	58593833	.	C	A	3	5	8	0	0	8	0	0
1	58593835	.	T	C	3	5	8	0	0	8	0	0
1	58593912	.	C	T	3	5	8	0	0	8	0	0
1	58594066	.	T	C	1	0	1	0	3	4	0	0
1	58594143	.	A	C	3	4	7	0	1	8	0	0
1	58594144	.	G	A	4	4	8	0	0	8	0	0
1	58594611	.	T	G	4	5	9	0	0	9	0	0
1	58595018	.	C	T	10	5	15	0	1	16	0	0
1	58595198	.	A	G	5	5	10	0	0	10	0	0
1	58595386	.	G	A	7	7	14	0	0	14	0	0
1	58595455	.	G	A	7	3	10	0	0	10	0	0
1	58595545	.	T	C	5	7	12	0	1	13	0	0
1	58598802	.	T	C	4	0	4	0	2	6	0	0
1	58598830	.	A	T	2	0	2	0	0	2	0	0
1	58606321	.	T	C	2	2	4	0	0	4	0	0
1	58606326	.	T	A	2	2	4	0	0	4	0	0
1	58612519	.	T	C	3	6	9	0	1	10	0	0
1	58612762	.	A	G	3	5	8	0	2	10	0	0
1	58613008	.	T	C	1	2	3	0	0	3	0	0
1	58613027	.	A	G	2	2	4	0	0	4	0	0
1	58617987	.	T	C	2	2	4	0	1	5	0	0
1	58618769	.	G	A	0	4	4	0	0	4	0	0
1	58618792	.	T	G	0	5	5	0	0	5	0	0
1	58618818	.	A	G	0	0	0	0	3	3	0	0
1	58631233	.	A	G	1	2	3	0	0	3	0	0
1	58631609	.	C	T	6	4	10	0	0	10	0	0
1	58631695	.	A	T	2	3	5	0	1	6	0	0
1	58631894	.	C	T	6	0	6	0	0	6	0	0
1	58631923	.	C	T	1	2	3	0	0	3	0	0
1	58677839	.	T	C	2	14	16	0	2	18	0	0
1	58677856	.	C	T	2	14	16	0	1	17	0	0
1	58677993	.	A	G	2	5	7	0	1	8	0	0
1	58678017	.	T	C	1	4	5	0	0	5	0	0
1	58678077	.	T	A	0	2	2	0	0	2	0	0
1	58680499	.	C	A	5	10	15	0	1	16	0	0
1	58680792	.	T	C	6	6	12	0	0	12	0	0
1	58680913	.	T	C	16	8	24	0	1	26	1	0
1	58681068	.	C	T	8	5	13	0	1	14	0	0
1	58681419	.	A	T	3	14	17	0	0	21	4	0
1	58681491	.	T	C	8	3	11	0	1	12	0	0
1	58762985	.	T	G	5	7	12	0	1	13	0	0
1	58766341	.	G	A	6	4	10	0	0	10	0	0
1	58846670	.	C	A	2	3	5	0	0	5	0	0
1	58846938	.	A	G	2	3	5	0	0	5	0	0
1	58850500	.	T	G	2	4	6	0	1	7	0	0
1	58850525	.	T	A	2	7	9	0	0	10	1	0
1	58850562	.	C	T	3	7	10	0	0	10	0	0
1	58982147	.	G	A	0	8	8	0	5	13	0	0
1	58982195	.	C	G	2	6	8	0	0	8	0	0
1	58984239	.	G	T	2	2	4	0	0	4	0	0
1	58984368	.	G	A	0	0	0	0	4	4	0	0
1	58984478	.	T	C	1	3	4	0	0	4	0	0
1	58984640	.	C	T	2	1	3	0	0	3	0	0
1	58985530	.	G	A	10	10	20	0	0	20	0	0
1	58985579	.	T	G	12	9	21	0	1	22	0	0
1	58985730	.	C	A	6	3	9	0	0	9	0	0
1	58993039	.	T	G	0	1	1	0	0	1	0	0
1	58999960	.	T	A	6	3	9	0	0	9	0	0
1	59009732	.	A	G	16	0	16	0	16	32	0	0
1	59018886	.	C	T	0	3	3	0	5	8	0	0
1	59019006	.	C	G	2	14	16	0	0	16	0	0
1	59019084	.	T	A	3	4	7	0	0	7	0	0
1	59019093	.	A	G	4	5	9	0	0	9	0	0
1	59062665	.	T	C	27	18	45	0	1	46	0	0
1	59065889	.	G	A	1	16	17	0	13	30	0	0
1	59140788	.	G	C	2	3	5	0	1	6	0	0
1	59142891	.	A	G	5	0	5	0	6	11	0	0
1	59143004	.	T	C	2	1	3	0	0	3	0	0
1	59143499	.	T	A	0	4	4	0	0	4	0	0
1	59143503	.	A	G	0	4	4	0	0	4	0	0
1	59146790	.	A	G	0	1	1	0	0	1	0	0
1	59149117	.	C	T	6	7	13	0	1	14	0	0
1	59149968	.	T	C	13	14	27	0	0	27	0	0
1	59150450	.	A	G	6	6	12	1	0	13	0	0
1	59150482	.	G	T	4	5	9	1	0	10	0	0
1	59150518	.	T	C	5	13	18	0	2	20	0	0
1	59150559	.	T	G	8	14	22	0	0	22	0	0
1	59150583	.	T	A	6	16	22	0	0	22	0	0
1	59150683	.	T	C	3	15	18	0	1	19	0	0
1	59150737	.	T	C	3	7	10	0	1	11	0	0
1	59150762	.	G	T	5	6	11	0	0	11	0	0
1	59150781	.	T	C	6	8	14	0	1	15	0	0
1	59154592	.	T	C	0	5	5	0	0	5	0	0
1	59156827	.	T	G	4	3	7	0	0	7	0	0
1	59157536	.	T	C	4	6	10	0	0	10	0	0
1	59157856	.	T	A	3	6	9	0	1	10	0	0
1	59157888	.	T	C	5	16	21	0	0	21	0	0
1	59157977	.	A	C	9	11	20	0	2	22	0	0
1	59158035	.	C	A	5	13	18	0	0	18	0	0
1	59158062	.	A	T	8	10	18	0	0	18	0	0
1	59158070	.	G	A	9	7	16	0	3	19	0	0
1	59172876	.	A	G	7	12	19	0	1	20	0	0
1	59172900	.	A	G	11	11	22	0	2	24	0	0
1	59172969	.	G	A	18	7	25	0	2	27	0	0
1	59173358	.	G	T	7	7	14	0	0	14	0	0
1	59173701	.	G	T	2	0	2	0	0	2	0	0
1	59173758	.	A	G	10	8	18	0	0	18	0	0
1	59173866	.	T	G	6	12	18	0	6	24	0	0
1	59173896	.	T	C	12	0	12	0	14	26	0	0
1	59174387	.	A	G	9	8	17	0	1	18	0	0
1	59174408	.	G	A	7	7	14	0	0	14	0	0
1	59174492	.	T	G	13	5	18	0	0	18	0	0
1	59174525	.	A	C	11	8	19	0	2	21	0	0
1	59174576	.	C	T	10	3	13	0	1	14	0	0
1	59174645	.	G	A	12	14	26	0	1	27	0	0
1	59174797	.	A	C	13	11	24	0	1	25	0	0
1	59174962	.	T	C	21	15	36	0	2	38	0	0
1	59175511	.	T	C	8	13	21	0	1	22	0	0
1	59175572	.	A	G	8	5	13	0	2	15	0	0
1	59175626	.	G	A	5	8	13	0	0	13	0	0
1	59175635	.	G	A	5	11	16	0	0	16	0	0
1	59175740	.	G	T	11	8	19	0	0	19	0	0
1	59175983	.	T	C	8	10	18	0	1	19	0	0
1	59175989	.	A	G	8	11	19	0	0	19	0	0
1	59176887	.	G	T	3	6	9	0	0	9	0	0
1	59176935	.	A	C	2	0	2	0	6	9	1	0
1	59218594	.	A	G	7	10	17	0	3	20	0	0
1	59226049	.	T	C	4	8	12	0	1	13	0	0
1	59226052	.	A	G	5	7	12	0	1	13	0	0
1	59228311	.	G	A	0	1	1	0	0	1	0	0
1	59228322	.	C	T	0	1	1	0	0	1	0	0
1	59228569	.	A	C	2	1	3	0	10	13	0	0
1	59229211	.	G	A	6	4	10	0	1	11	0	0
1	59232206	.	A	G	7	23	30	0	2	32	0	0
1	59232509	.	G	A	7	10	17	0	1	18	0	0
1	59235016	.	T	G	1	8	9	0	0	9	0	0
1	59244312	.	A	G	5	12	17	0	0	17	0	0
1	59244635	.	A	T	6	15	21	0	0	21	0	0
1	59244916	.	T	A	35	13	48	0	0	48	0	0
1	59244928	.	C	T	29	15	44	0	2	46	0	0
1	59245142	.	C	G	30	22	52	0	3	55	0	0
1	59245658	.	G	A	7	6	13	0	1	14	0	0
1	59245873	.	T	C	6	0	6	0	0	6	0	0
1	59245900	.	C	T	10	3	13	0	2	15	0	0
1	59246189	.	T	C	15	0	15	0	13	28	0	0
1	59246363	.	A	T	2	3	5	0	0	5	0	0
1	59247893	.	T	G	14	7	21	0	0	21	0	0
1	59247944	.	C	T	4	4	8	0	0	8	0	0
1	59248138	.	T	A	11	3	14	0	0	14	0	0
1	59251658	.	C	G	6	9	15	0	1	16	0	0
1	59251839	.	T	C	12	0	12	0	10	22	0	0
1	59293966	.	A	G	3	3	6	0	0	6	0	0
1	59297557	.	T	G	1	2	3	0	0	3	0	0
1	59298207	.	C	T	0	1	1	0	0	1	0	0
1	59302210	.	G	A	0	5	5	0	4	9	0	0
1	59302276	.	C	T	5	11	16	0	0	16	0	0
1	59302372	.	T	G	3	7	10	0	0	10	0	0
1	59303024	.	C	A	5	7	12	0	1	13	0	0
1	59303149	.	A	C	1	3	4	0	0	4	0	0
1	59303294	.	C	G	2	0	2	0	2	4	0	0
1	59304739	.	G	T	1	2	3	0	0	3	0	0
1	59304746	.	A	T	1	3	4	0	0	4	0	0
1	59305033	.	G	T	9	0	9	0	0	9	0	0
1	59305059	.	A	C	4	0	4	0	5	9	0	0
1	59305116	.	T	C	4	0	4	0	7	11	0	0
1	59305200	.	T	C	2	4	6	0	0	6	0	0
1	59309988	.	A	G	2	3	5	0	0	5	0	0
1	59312211	.	C	A	2	3	5	0	1	6	0	0
1	59314966	.	A	G	1	2	3	0	0	3	0	0
1	59318886	.	A	G	4	0	4	0	5	9	0	0
1	59321447	.	A	G	12	0	12	0	12	24	0	0
1	59324067	.	T	C	3	7	10	0	0	10	0	0
1	59328110	.	T	G	2	0	2	0	4	6	0	0
1	59328287	.	C	T	4	6	10	0	2	12	0	0
1	59328486	.	C	T	1	4	5	0	0	5	0	0
1	59329950	.	A	G	2	7	9	0	0	9	0	0
1	59329957	.	T	C	2	8	10	0	0	10	0	0
1	59330135	.	T	C	4	5	9	0	0	9	0	0
1	59330169	.	C	T	3	6	9	0	0	9	0	0
1	59409266	.	G	A	1	6	7	0	1	8	0	0
1	59542739	.	A	T	1	0	1	0	0	1	0	0
1	59563781	.	G	T	1	4	5	0	0	5	0	0
1	59565850	.	A	G	2	5	7	0	0	7	0	0
10	18509	.	A	G	5	4	9	0	1	10	0	0
10	18533	.	T	C	4	11	15	0	2	17	0	0
10	19217	.	G	A	3	2	5	0	0	5	0	0
10	22333	.	C	G	4	12	16	0	2	18	0	0
10	22434	.	G	T	0	4	4	0	6	10	0	0
10	22435	.	G	T	5	5	10	0	0	10	0	0
10	22507	.	A	G	2	10	12	0	0	12	0	0
10	22543	.	T	A	8	2	10	0	0	10	0	0
10	22554	.	A	T	8	2	10	0	0	10	0	0
10	24014	.	G	A	4	3	7	0	0	7	0	0
10	24733	.	G	A	4	3	7	0	0	7	0	0
10	27787	.	G	T	0	8	8	0	2	10	0	0
10	32978	.	T	C	1	0	1	0	2	3	0	0
10	32998	.	G	T	3	5	8	0	0	8	0	0
10	33237	.	T	C	4	8	12	0	0	12	0	0
10	33287	.	G	C	3	7	10	0	0	10	0	0
10	33441	.	A	G	5	9	14	0	2	16	0	0
10	33630	.	A	G	6	3	9	0	0	9	0	0
10	33634	.	G	T	5	2	7	0	1	8	0	0
10	33665	.	T	C	3	6	9	0	0	9	0	0
10	33986	.	G	T	2	7	9	0	0	9	0	0
10	34028	.	C	T	4	6	10	0	0	10	0	0
10	34206	.	A	C	5	4	9	0	0	9	0	0
10	34233	.	G	A	1	5	6	0	1	7	0	0
10	34302	.	G	T	2	5	7	0	0	7	0	0
10	34325	.	C	T	0	6	6	0	3	9	0	0
10	34725	.	G	A	4	7	11	0	1	12	0	0
10	34727	.	A	T	4	8	12	0	0	12	0	0
10	34839	.	G	C	7	7	14	0	2	16	0	0
10	38922	.	A	G	3	3	6	0	0	6	0	0
10	38924	.	A	G	3	3	6	0	0	6	0	0
10	53815	.	T	C	6	8	14	0	0	14	0	0
10	53816	.	G	A	6	8	14	0	0	14	0	0
10	53857	.	A	G	11	8	19	0	1	20	0	0
10	53930	.	T	G	5	9	14	0	0	14	0	0
10	55594	.	G	A	7	4	11	0	0	11	0	0
10	62459	.	A	C	22	1	23	0	13	36	0	0
10	62468	.	C	G	22	14	36	0	1	37	0	0
10	63587	.	A	G	15	11	26	0	4	30	0	0
10	64855	.	G	A	12	10	22	0	0	22	0	0
10	65086	.	A	G	2	4	6	0	0	6	0	0
10	67063	.	T	C	5	5	10	0	0	10	0	0
10	72381	.	A	G	8	8	16	0	0	16	0	0
10	78461	.	G	C	1	12	13	0	13	26	0	0
10	81285	.	C	T	8	3	11	0	0	11	0	0
10	81348	.	C	T	15	11	26	0	1	27	0	0
10	81508	.	A	G	16	0	16	0	11	27	0	0
10	82336	.	A	G	20	10	30	0	0	30	0	0
10	83401	.	G	A	3	3	6	0	0	6	0	0
10	85353	.	A	G	0	3	3	0	0	3	0	0
10	85404	.	G	A	0	3	3	0	0	3	0	0
10	85419	.	C	T	0	2	2	0	1	3	0	0
10	85571	.	G	C	8	5	13	0	0	13	0	0
10	85585	.	C	T	8	4	12	0	2	14	0	0
10	85927	.	A	G	6	5	11	0	0	11	0	0
10	85948	.	G	C	5	5	10	0	1	11	0	0
10	87353	.	G	A	1	2	3	0	0	3	0	0
10	87417	.	G	A	6	4	10	0	1	11	0	0
10	87426	.	T	C	6	5	11	0	0	11	0	0
10	89893	.	T	C	1	0	1	0	4	5	0	0
10	95022	.	C	T	0	2	2	0	1	3	0	0
10	110895	.	G	A	0	0	0	0	1	1	0	0
10	114066	.	A	G	4	11	15	0	0	15	0	0
10	115088	.	G	A	4	16	20	0	0	20	0	0
10	115136	.	T	C	4	16	20	0	0	20	0	0
10	115578	.	T	C	3	3	6	0	0	6	0	0
10	115967	.	A	G	5	0	5	0	5	10	0	0
10	115982	.	T	C	4	3	7	0	0	7	0	0
10	134809	.	G	A	12	18	30	0	0	30	0	0
10	193726	.	A	G	6	6	12	0	0	12	0	0
10	193853	.	G	A	8	5	13	0	9	22	0	0
10	194316	.	A	G	9	12	21	0	3	24	0	0
10	195321	.	T	C	0	2	2	0	2	4	0	0
10	195327	.	T	C	1	1	2	0	0	2	0	0
10	196054	.	C	T	9	7	16	0	0	16	0	0
10	196307	.	C	T	10	9	19	0	0	19	0	0
10	196342	.	C	G	7	5	12	0	1	13	0	0
10	196670	.	G	A	16	18	34	0	2	36	0	0
10	196693	.	T	A	16	19	35	0	0	35	0	0
10	196773	.	T	C	7	2	9	0	1	10	0	0
10	196782	.	C	A	6	2	8	0	0	8	0	0
10	207258	.	C	T	7	9	16	0	1	17	0	0
10	207259	.	C	A	0	8	8	0	9	17	0	0
10	207992	.	T	C	11	2	13	0	17	30	0	0
10	207994	.	T	C	11	2	13	0	17	30	0	0
10	208034	.	A	T	14	14	28	0	1	29	0	0
10	210568	.	A	G	11	11	22	0	0	22	0	0
10	210598	.	T	C	9	10	19	0	1	20	0	0
10	216122	.	T	C	4	4	8	0	0	8	0	0
10	286788	.	T	C	6	0	6	0	10	16	0	0
10	292655	.	C	T	0	2	2	0	5	7	0	0
10	292667	.	A	G	3	2	5	0	0	5	0	0
10	294113	.	G	A	3	7	10	0	1	11	0	0
10	294653	.	A	G	6	6	12	0	0	12	0	0
10	295070	.	A	G	1	1	2	0	1	3	0	0
10	296617	.	C	T	0	6	6	0	2	8	0	0
10	307976	.	G	T	11	7	18	0	1	19	0	0
10	307985	.	T	C	10	0	10	0	8	18	0	0
10	308288	.	T	C	6	6	12	0	3	15	0	0
10	311901	.	A	G	6	4	10	0	0	10	0	0
10	313332	.	T	C	2	1	3	0	0	3	0	0
10	406182	.	C	T	2	5	7	0	0	7	0	0
10	406189	.	C	G	2	4	6	0	0	6	0	0
10	431607	.	T	A	2	3	5	0	0	5	0	0
10	431608	.	T	C	2	3	5	0	0	5	0	0
10	474834	.	T	C	3	1	4	0	1	5	0	0
10	474896	.	T	C	4	5	9	0	1	10	0	0
10	478304	.	T	G	10	6	16	0	2	18	0	0
10	478388	.	G	A	0	19	19	0	9	28	0	0
10	478508	.	T	C	12	19	31	0	0	31	0	0
10	478661	.	C	T	12	21	33	0	1	34	0	0
10	478724	.	G	A	17	17	34	0	1	35	0	0
10	478742	.	C	T	16	16	32	0	0	32	0	0
10	479063	.	A	G	4	2	6	0	1	7	0	0
10	482335	.	G	A	6	6	12	0	1	13	0	0
10	482371	.	T	G	13	14	27	0	1	28	0	0
10	486146	.	G	A	16	13	29	0	1	30	0	0
10	486153	.	T	C	17	14	31	0	1	32	0	0
10	500114	.	A	G	6	0	6	0	6	12	0	0
10	500168	.	G	A	2	23	25	0	17	42	0	0
10	500423	.	A	G	24	0	24	0	18	42	0	0
10	500473	.	T	C	8	9	17	0	0	17	0	0
10	501833	.	C	T	4	4	8	0	0	8	0	0
10	501899	.	G	C	7	13	20	0	0	20	0	0
10	505282	.	A	G	11	18	29	0	1	30	0	0
10	505316	.	G	A	1	17	18	0	13	31	0	0
10	573789	.	T	A	5	3	8	0	0	8	0	0
10	573806	.	G	A	3	2	5	0	1	6	0	0
10	576060	.	A	G	5	7	12	0	0	12	0	0
10	577791	.	G	C	3	3	6	0	0	6	0	0
10	579989	.	A	G	1	0	1	0	6	7	0	0
10	580088	.	G	T	0	10	10	0	14	24	0	0
10	580092	.	G	A	14	6	20	0	4	24	0	0
10	586563	.	C	A	3	1	4	0	1	5	0	0
10	589487	.	G	A	11	7	18	0	0	18	0	0
10	589655	.	T	C	3	4	7	0	1	8	0	0
10	589789	.	G	A	0	2	2	0	5	7	0	0
10	589810	.	A	T	5	2	7	0	0	7	0	0
10	589875	.	T	C	5	2	7	0	0	7	0	0
10	590067	.	A	C	1	3	4	0	0	4	0	0
10	590087	.	A	G	3	3	6	0	0	6	0	0
10	590273	.	A	C	3	3	6	0	1	7	0	0
10	590314	.	G	A	0	4	4	0	5	9	0	0
10	590956	.	A	T	5	6	11	0	0	12	1	0
10	590957	.	A	G	5	6	11	0	1	12	0	0
10	590997	.	C	T	9	6	15	0	0	15	0	0
10	591017	.	T	C	15	6	21	0	0	21	0	0
10	591219	.	T	G	7	0	7	0	9	16	0	0
10	591220	.	C	T	7	9	16	0	0	16	0	0
10	591386	.	G	T	0	2	2	0	1	3	0	0
10	591434	.	G	A	5	4	9	0	0	9	0	0
10	591476	.	A	G	4	0	4	0	11	15	0	0
10	591567	.	T	A	8	5	13	0	0	13	0	0
10	591634	.	T	G	6	7	13	0	0	13	0	0
10	591716	.	C	G	7	2	9	0	1	10	0	0
10	591720	.	G	A	0	3	3	0	7	10	0	0
10	591820	.	A	G	10	0	10	0	7	17	0	0
10	600448	.	T	C	5	4	9	0	0	9	0	0
10	600450	.	T	C	5	4	9	0	0	9	0	0
10	600584	.	G	A	10	6	16	0	0	16	0	0
10	608795	.	A	G	0	4	4	0	0	4	0	0
10	609654	.	C	T	2	1	3	0	0	3	0	0
10	661362	.	C	T	0	2	2	0	1	3	0	0
10	1052692	.	A	G	5	0	5	0	4	9	0	0
10	1056227	.	A	G	3	4	7	0	0	7	0	0
10	1056409	.	A	G	0	3	3	0	0	3	0	0
10	1056460	.	T	C	8	4	12	0	1	13	0	0
10	1076251	.	T	C	2	1	3	0	0	3	0	0
10	1082985	.	T	G	4	6	10	0	0	10	0	0
10	1083030	.	T	A	1	4	5	0	0	5	0	0
10	1084628	.	A	G	0	2	2	0	0	2	0	0
10	1105953	.	C	T	10	1	11	0	0	11	0	0
10	1107460	.	C	T	10	9	19	0	0	19	0	0
10	1133195	.	G	A	0	2	2	0	0	2	0	0
10	1226809	.	T	C	1	2	3	0	0	3	0	0
10	1436596	.	C	G	0	3	3	0	2	5	0	0
10	1450286	.	G	A	6	4	10	0	0	10	0	0
10	1515816	.	C	T	4	5	9	0	0	9	0	0
10	1519606	.	T	G	2	3	5	0	2	7	0	0
10	1541411	.	G	A	2	13	15	0	0	15	0	0
10	1541492	.	C	T	1	3	4	0	0	4	0	0
10	1543805	.	C	G	0	8	8	0	3	11	0	0
10	1543848	.	G	C	1	0	1	0	4	5	0	0
10	1546088	.	T	C	1	4	5	0	0	5	0	0
10	1549088	.	C	T	0	15	15	0	4	19	0	0
10	1549179	.	A	G	14	4	18	0	0	18	0	0
10	1549189	.	A	G	13	5	18	0	0	18	0	0
10	1549494	.	G	A	2	6	8	0	3	11	0	0
10	1549532	.	A	G	2	5	7	0	1	8	0	0
10	1549714	.	G	A	3	11	14	0	0	14	0	0
10	1550478	.	G	C	3	3	6	0	0	6	0	0
10	1550499	.	G	T	6	3	9	0	0	9	0	0
10	1597396	.	G	A	10	9	19	0	0	19	0	0
10	1603967	.	T	C	2	2	4	0	0	4	0	0
10	1619723	.	G	A	2	1	3	0	0	3	0	0
10	1626579	.	T	A	1	3	4	0	0	4	0	0
10	1648044	.	T	C	2	6	8	0	1	9	0	0
10	1652260	.	G	C	0	2	2	0	2	4	0	0
10	1656257	.	C	T	7	4	11	0	0	11	0	0
10	1658184	.	T	C	1	0	1	0	0	1	0	0
10	1663101	.	T	C	5	15	20	0	0	20	0	0
10	1665572	.	A	G	2	0	2	0	0	2	0	0
10	1666500	.	A	G	6	0	6	0	6	12	0	0
10	1666525	.	G	A	0	7	7	0	4	11	0	0
10	1668159	.	C	T	10	12	22	0	0	22	0	0
10	1671442	.	A	T	7	5	12	0	1	13	0	0
10	1674291	.	C	T	0	3	3	0	0	3	0	0
10	1681712	.	A	T	7	9	16	0	0	16	0	0
10	1684563	.	T	G	6	13	19	0	1	20	0	0
10	1687547	.	C	T	21	18	39	0	1	40	0	0
10	1694456	.	T	A	8	16	24	0	0	24	0	0
10	1708197	.	T	A	21	20	41	0	1	42	0	0
10	1708230	.	T	C	20	19	39	0	1	40	0	0
10	1708239	.	A	T	20	21	41	0	1	42	0	0
10	1708412	.	A	T	30	23	53	0	0	53	0	0
10	1709165	.	T	A	24	25	49	0	0	49	0	0
10	1709331	.	T	G	30	19	49	0	0	49	0	0
10	1709731	.	G	A	31	26	57	0	0	57	0	0
10	1709783	.	G	A	20	33	53	0	2	55	0	0
10	1709836	.	T	G	17	19	36	0	1	37	0	0
10	1709855	.	C	T	16	17	33	0	0	33	0	0
10	1709871	.	G	A	18	13	31	0	1	32	0	0
10	1710270	.	A	G	22	10	32	1	1	34	0	0
10	1710358	.	C	T	18	10	28	0	5	33	0	0
10	1711061	.	T	C	22	1	23	0	13	36	0	0
10	1711136	.	T	C	21	28	49	0	0	49	0	0
10	1711188	.	T	A	22	16	38	0	1	39	0	0
10	1711211	.	C	T	21	10	31	0	2	33	0	0
10	1711599	.	T	C	9	1	10	0	9	19	0	0
10	1711854	.	G	T	4	14	18	0	5	23	0	0
10	1712091	.	G	A	7	4	11	0	0	11	0	0
10	1712100	.	T	A	8	3	11	0	0	11	0	0
10	1712306	.	G	A	11	22	33	0	2	35	0	0
10	1712316	.	C	T	10	20	30	0	2	32	0	0
10	1712658	.	G	A	21	14	35	0	3	38	0	0
10	1712757	.	A	G	18	15	33	0	1	34	0	0
10	1712899	.	A	T	19	22	41	0	0	41	0	0
10	1712964	.	T	G	32	2	34	0	0	34	0	0
10	1713418	.	T	C	7	4	11	0	0	11	0	0
10	1718294	.	C	A	27	17	44	0	1	45	0	0
10	1745541	.	A	T	3	3	6	0	1	7	0	0
10	1745738	.	T	A	6	8	14	0	0	14	0	0
10	1752113	.	T	A	1	1	2	0	0	2	0	0
10	1752122	.	C	A	1	2	3	0	1	4	0	0
10	1776112	.	G	A	2	0	2	0	0	2	0	0
10	1782662	.	C	T	1	1	2	0	1	3	0	0
10	1782953	.	C	T	0	1	1	0	2	3	0	0
10	1782968	.	C	G	1	2	3	0	0	3	0	0
10	1869266	.	G	A	6	6	12	0	0	12	0	0
10	1869313	.	G	T	8	1	9	0	1	10	0	0
10	1869328	.	C	T	6	2	8	0	0	8	0	0
10	1871634	.	G	T	1	1	2	0	5	7	0	0
10	1880470	.	A	G	6	4	10	0	0	10	0	0
10	1880734	.	C	T	5	3	8	0	1	9	0	0
10	1885891	.	A	C	6	9	15	0	1	16	0	0
10	1886113	.	G	A	0	6	6	0	4	10	0	0
10	1886119	.	T	G	8	4	12	0	0	12	0	0
10	1886182	.	C	T	7	9	16	0	1	17	0	0
10	1886265	.	C	G	10	5	15	0	1	16	0	0
10	1886587	.	T	C	5	11	16	0	3	19	0	0
10	1886590	.	T	A	6	13	19	0	1	20	0	0
10	1886764	.	T	C	10	14	24	0	0	24	0	0
10	1887238	.	C	T	10	11	21	0	0	21	0	0
10	1887364	.	C	T	9	18	27	0	0	27	0	0
10	1887496	.	A	G	8	0	8	0	15	23	0	0
10	1887811	.	A	G	11	8	19	0	1	20	0	0
10	1888135	.	G	C	11	15	26	0	1	27	0	0
10	1888222	.	C	T	9	9	18	0	0	18	0	0
10	1888225	.	G	A	9	8	17	0	0	17	0	0
10	1888303	.	C	T	14	13	27	0	0	27	0	0
10	1888414	.	T	C	17	14	31	0	0	31	0	0
10	1888438	.	C	T	18	10	28	0	2	30	0	0
10	1888487	.	T	C	14	11	25	0	0	25	0	0
10	1888515	.	C	T	16	15	31	0	0	31	0	0
10	1888824	.	C	T	16	15	31	0	0	31	0	0
10	1888893	.	C	T	14	17	31	0	0	31	0	0
10	1889171	.	G	T	17	13	30	0	1	31	0	0
10	1889179	.	A	G	15	0	15	0	10	25	0	0
10	1889255	.	C	T	9	7	16	0	0	16	0	0
10	1889296	.	C	T	7	15	22	0	0	22	0	0
10	1889882	.	A	C	20	12	32	0	0	32	0	0
10	1890313	.	A	G	21	16	37	0	1	38	0	0
10	1890949	.	T	C	22	11	33	0	0	33	0	0
10	1890961	.	G	A	21	11	32	0	3	35	0	0
10	1891018	.	G	A	0	24	24	0	15	39	0	0
10	1891660	.	G	C	20	16	36	0	0	36	0	0
10	1891724	.	G	C	23	25	48	0	2	50	0	0
10	1892516	.	G	A	14	13	27	0	1	28	0	0
10	2234379	.	C	T	0	3	3	0	0	3	0	0
10	2255014	.	T	C	0	2	2	0	0	2	0	0
10	2261897	.	A	T	1	0	1	0	1	2	0	0
10	2283976	.	T	C	4	3	7	0	0	7	0	0
10	2292380	.	G	T	3	6	9	0	0	9	0	0
10	2294325	.	G	A	7	4	11	0	0	11	0	0
10	2328740	.	C	A	8	4	12	0	2	14	0	0
10	2339274	.	C	T	9	4	13	0	1	14	0	0
10	2367762	.	C	T	1	3	4	0	0	4	0	0
10	2393715	.	G	A	17	16	33	0	3	36	0	0
10	2393763	.	G	C	12	17	29	0	2	31	0	0
10	2504174	.	G	T	12	13	25	0	3	28	0	0
10	2504210	.	C	T	1	12	13	0	7	20	0	0
10	2506081	.	G	A	17	16	33	0	3	36	0	0
10	2508347	.	T	C	3	0	3	0	4	7	0	0
10	2510397	.	C	G	0	0	0	0	5	5	0	0
10	2515351	.	T	G	12	7	19	0	0	19	0	0
10	2515447	.	T	C	11	1	12	0	5	17	0	0
10	2526413	.	A	G	1	0	1	0	0	1	0	0
10	2542000	.	C	T	0	1	1	0	0	1	0	0
10	2575204	.	A	G	1	0	1	0	4	5	0	0
10	2575369	.	T	C	9	8	17	0	0	17	0	0
10	2666322	.	C	T	3	3	6	0	0	6	0	0
10	2666324	.	C	T	3	3	6	0	0	6	0	0
10	2666480	.	A	G	6	2	8	0	0	8	0	0
10	2681622	.	C	T	2	1	3	0	0	3	0	0
10	2681771	.	G	A	9	5	14	0	0	14	0	0
10	2681800	.	C	T	3	7	10	0	8	18	0	0
10	2704752	.	G	T	1	0	1	0	0	1	0	0
10	2759276	.	G	A	14	5	19	0	3	22	0	0
10	2759329	.	T	G	13	12	25	0	0	25	0	0
10	2759381	.	G	C	9	20	29	0	0	29	0	0
10	2759391	.	A	T	12	19	31	0	1	32	0	0
10	2772036	.	G	A	6	8	14	0	0	14	0	0
10	2772057	.	G	A	5	4	9	0	0	9	0	0
10	2778444	.	G	A	1	1	2	0	0	2	0	0
10	2782761	.	G	A	0	1	1	0	0	1	0	0
10	2784391	.	A	G	2	6	8	0	1	9	0	0
10	2850533	.	A	G	7	6	13	0	0	13	0	0
10	2850546	.	A	G	8	5	13	0	0	13	0	0
10	2850675	.	A	G	3	0	3	0	5	8	0	0
10	2888166	.	C	A	1	1	2	0	0	2	0	0
10	2891905	.	G	A	6	4	10	0	1	11	0	0
10	2894148	.	G	C	2	3	5	0	1	6	0	0
10	2894193	.	T	G	2	0	2	0	2	4	0	0
10	2894545	.	C	T	5	6	11	0	1	12	0	0
10	2897110	.	A	C	6	12	18	0	1	19	0	0
10	2897720	.	T	A	3	5	8	0	0	8	0	0
10	2897817	.	T	G	8	0	8	0	8	16	0	0
10	2897897	.	A	G	1	4	5	0	2	7	0	0
10	2897911	.	G	T	3	4	7	0	0	7	0	0
10	2898087	.	T	C	1	2	3	0	0	3	0	0
10	2898212	.	T	G	1	3	4	0	0	4	0	0
10	2898213	.	C	G	1	3	4	0	0	4	0	0
10	2899345	.	A	G	1	2	3	0	1	4	0	0
10	2899399	.	C	T	3	2	5	0	0	5	0	0
10	2899425	.	G	C	0	2	2	0	2	4	0	0
10	2899436	.	C	T	2	2	4	0	0	4	0	0
10	2899631	.	A	T	1	2	3	0	0	3	0	0
10	2899632	.	C	A	1	2	3	0	0	3	0	0
10	2904624	.	C	T	1	0	1	0	0	1	0	0
10	2904638	.	G	C	1	0	1	0	0	1	0	0
10	2907362	.	T	C	0	2	2	0	0	2	0	0
10	2907413	.	A	G	4	3	7	0	0	7	0	0
10	2907422	.	T	C	4	3	7	0	0	7	0	0
10	2915462	.	G	A	0	4	4	0	2	6	0	0
10	2915495	.	C	T	3	3	6	0	0	6	0	0
10	2916931	.	A	T	1	2	3	0	0	3	0	0
10	2981073	.	C	T	2	1	3	0	0	3	0	0
10	2983307	.	G	A	1	2	3	0	0	3	0	0
10	2983514	.	C	A	2	2	4	0	0	4	0	0
10	2983662	.	G	A	0	3	3	0	1	4	0	0
10	2983715	.	C	T	1	2	3	0	0	3	0	0
10	2983736	.	A	G	1	2	3	0	0	3	0	0
10	2984902	.	T	C	1	4	5	0	0	5	0	0
10	2987020	.	A	G	1	0	1	0	1	2	0	0
10	3016263	.	T	C	3	7	10	0	0	10	0	0
10	3024637	.	C	G	5	7	12	0	0	12	0	0
10	3024706	.	C	T	6	6	12	0	1	13	0	0
10	3026264	.	A	C	11	5	16	0	2	18	0	0
10	3026376	.	A	G	5	2	7	0	0	7	0	0
10	3026484	.	G	A	0	2	2	0	3	5	0	0
10	3026521	.	A	C	1	2	3	0	0	3	0	0
10	3031670	.	T	C	6	0	6	0	6	12	0	0
10	3031760	.	A	G	4	8	12	0	0	12	0	0
10	3032353	.	T	A	5	5	10	0	0	10	0	0
10	3033231	.	G	A	1	2	3	0	0	3	0	0
10	3033247	.	A	G	1	2	3	0	0	3	0	0
10	3071280	.	G	A	2	2	4	0	0	4	0	0
10	3085411	.	G	T	1	3	4	0	0	4	0	0
10	3308482	.	G	A	0	2	2	0	3	5	0	0
10	3311737	.	T	G	7	6	13	0	3	16	0	0
10	3311800	.	A	G	5	0	5	0	9	14	0	0
10	3311845	.	G	A	5	3	8	0	0	8	0	0
10	3317976	.	G	A	0	7	7	0	8	15	0	0
10	3318005	.	G	C	0	10	10	0	7	17	0	0
10	3318060	.	G	A	4	6	10	0	1	11	0	0
10	3318941	.	A	G	5	3	8	0	0	8	0	0
10	3318944	.	A	G	5	4	9	0	0	9	0	0
10	3318978	.	A	G	16	0	16	0	4	20	0	0
10	3319873	.	A	G	7	0	7	0	9	16	0	0
10	3319890	.	G	T	0	11	11	0	7	18	0	0
10	3319938	.	C	T	8	12	20	0	1	21	0	0
10	3320007	.	C	G	6	7	13	0	0	13	0	0
10	3320015	.	T	C	6	8	14	0	1	15	0	0
10	3320151	.	A	G	9	22	31	0	1	32	0	0
10	3320194	.	G	A	11	14	25	0	3	28	0	0
10	3320229	.	G	A	10	11	21	0	0	21	0	0
10	3320287	.	T	G	13	4	17	0	1	18	0	0
10	3320465	.	C	G	10	2	12	0	1	14	1	0
10	3320495	.	A	T	15	4	19	0	1	20	0	0
10	3320506	.	C	T	6	12	18	0	1	19	0	0
10	3320705	.	G	A	10	8	18	0	1	19	0	0
10	3320776	.	C	T	9	10	19	0	1	20	0	0
10	3320850	.	C	T	16	8	24	0	0	24	0	0
10	3321416	.	T	G	8	11	19	0	1	20	0	0
10	3322194	.	A	G	22	1	23	0	8	31	0	0
10	3336838	.	C	T	3	3	6	0	0	6	0	0
10	3336846	.	T	A	4	4	8	0	0	8	0	0
10	3341412	.	C	T	2	2	4	0	0	4	0	0
10	3353607	.	C	T	0	2	2	0	0	2	0	0
10	3353622	.	A	G	0	2	2	0	0	2	0	0
10	3354048	.	A	G	1	8	9	0	2	11	0	0
10	3358897	.	A	T	8	10	18	0	0	18	0	0
10	3364772	.	A	T	5	6	11	0	1	12	0	0
10	3365063	.	C	T	0	5	5	0	12	17	0	0
10	3365312	.	T	C	5	7	12	0	0	12	0	0
10	3365726	.	A	C	19	0	19	0	0	20	1	0
10	3365834	.	A	T	10	8	18	0	0	18	0	0
10	3366095	.	C	T	1	5	6	0	12	18	0	0
10	3366199	.	C	T	0	4	4	0	3	7	0	0
10	3370680	.	G	A	3	5	8	0	0	8	0	0
10	3371866	.	G	A	0	2	2	0	0	2	0	0
10	3377087	.	G	A	2	3	5	0	0	5	0	0
10	3388200	.	T	G	2	0	2	0	0	2	0	0
10	3398029	.	A	C	1	0	1	0	2	3	0	0
10	3398215	.	G	T	1	3	4	0	0	4	0	0
10	3400126	.	A	T	6	3	9	0	0	9	0	0
10	3400216	.	C	T	3	5	8	0	0	8	0	0
10	3400225	.	T	C	3	9	12	0	1	13	0	0
10	3403764	.	C	T	0	2	2	0	3	5	0	0
10	3406168	.	A	G	0	1	1	0	0	1	0	0
10	3420097	.	A	T	16	17	33	0	1	34	0	0
10	3426363	.	G	A	13	11	24	0	1	25	0	0
10	3428230	.	G	C	2	3	5	0	0	5	0	0
10	3434883	.	C	T	1	3	4	0	0	4	0	0
10	3435321	.	T	A	2	2	4	0	0	4	0	0
10	3439018	.	A	G	1	2	3	0	0	3	0	0
10	3441973	.	T	C	4	7	11	0	0	11	0	0
10	3442030	.	T	C	4	1	5	0	0	5	0	0
10	3445818	.	C	T	7	5	12	0	1	13	0	0
10	3450861	.	A	G	10	6	16	0	1	17	0	0
10	3451091	.	G	A	6	2	8	0	1	9	0	0
10	3451429	.	G	A	0	10	10	0	12	22	0	0
10	3451672	.	A	G	3	4	7	0	0	7	0	0
10	3451688	.	C	T	3	4	7	0	2	9	0	0
10	3451848	.	G	A	0	7	7	0	4	11	0	0
10	3451864	.	C	T	8	4	12	0	0	12	0	0
10	3452045	.	G	A	8	8	16	0	0	16	0	0
10	3452073	.	A	G	6	9	15	0	2	17	0	0
10	3452124	.	A	G	13	5	18	0	0	18	0	0
10	3452183	.	G	A	6	3	9	0	0	9	0	0
10	3452185	.	T	A	6	3	9	0	0	9	0	0
10	3884936	.	G	A	2	3	5	0	0	5	0	0
10	3884957	.	G	A	3	2	5	0	0	5	0	0
10	3942996	.	T	A	3	4	7	0	0	7	0	0
10	3969027	.	G	T	0	6	6	0	5	11	0	0
10	3969491	.	G	T	1	5	6	0	0	6	0	0
10	3969887	.	C	T	2	4	6	0	1	7	0	0
10	3979744	.	G	T	3	9	12	0	0	12	0	0
10	3979870	.	G	A	2	6	8	0	1	9	0	0
10	3979876	.	C	A	2	5	7	0	1	8	0	0
10	3987505	.	T	C	0	1	1	0	0	1	0	0
10	4010300	.	A	G	3	2	5	0	0	5	0	0
10	4010345	.	G	T	0	2	2	0	5	7	0	0
10	4016017	.	G	A	1	2	3	0	0	3	0	0
10	4024798	.	G	A	1	1	2	0	0	2	0	0
10	4026443	.	T	G	2	0	2	0	3	5	0	0
10	4029455	.	C	T	5	7	12	0	0	12	0	0
10	4029507	.	T	C	8	5	13	0	0	13	0	0
10	4029634	.	A	G	4	8	12	0	0	12	0	0
10	4030211	.	A	T	3	5	8	0	0	8	0	0
10	4030349	.	C	T	3	3	6	0	0	6	0	0
10	4030352	.	C	A	2	3	5	0	0	5	0	0
10	4032623	.	C	T	3	1	4	0	1	5	0	0
10	4038772	.	G	A	13	6	19	0	0	19	0	0
10	4038898	.	A	G	6	8	14	0	1	15	0	0
10	4039123	.	C	T	12	17	29	0	2	31	0	0
10	4039129	.	C	T	12	18	30	0	0	30	0	0
10	4240887	.	T	C	13	16	29	0	0	29	0	0
10	4240899	.	C	T	15	14	29	0	2	31	0	0
10	4279623	.	C	A	1	4	5	0	0	5	0	0
10	4279695	.	T	C	1	3	4	0	0	4	0	0
10	4279800	.	A	G	3	3	6	0	0	6	0	0
10	4299542	.	T	G	0	2	2	0	0	2	0	0
10	4314971	.	G	T	0	2	2	0	0	2	0	0
10	4501733	.	G	A	3	4	7	0	0	7	0	0
10	4501817	.	A	G	0	1	1	0	0	1	0	0
10	4503291	.	G	T	8	3	11	0	0	11	0	0
10	4503736	.	C	T	1	1	2	0	0	2	0	0
10	4503901	.	C	G	1	3	4	0	0	4	0	0
10	4505886	.	T	A	8	16	24	0	1	25	0	0
10	4505887	.	T	A	8	17	25	0	0	25	0	0
10	4508492	.	T	A	12	10	22	0	0	22	0	0
10	4508518	.	G	T	1	19	20	0	9	29	0	0
10	4828597	.	A	T	0	1	1	0	0	1	0	0
10	4888387	.	C	A	2	2	4	0	2	6	0	0
10	4888457	.	A	G	3	5	8	0	1	9	0	0
10	4888582	.	A	G	3	0	3	0	5	8	0	0
10	4888832	.	G	A	0	2	2	0	3	5	0	0
10	4889119	.	A	T	1	3	4	0	0	4	0	0
10	4889159	.	C	A	1	2	3	0	0	3	0	0
10	4889228	.	C	T	5	3	8	0	0	8	0	0
10	4889248	.	T	C	6	3	9	0	1	10	0	0
10	4889302	.	C	A	4	4	8	0	1	9	0	0
10	4889704	.	A	G	6	2	8	1	1	10	0	0
10	4889923	.	A	G	2	0	2	0	4	6	0	0
10	4890027	.	C	T	5	2	7	0	0	7	0	0
10	4890082	.	G	C	1	0	1	0	0	1	0	0
10	4940895	.	A	G	1	4	5	0	1	6	0	0
10	4941113	.	A	G	7	7	14	0	1	15	0	0
10	4941342	.	G	C	7	5	12	0	1	13	0	0
10	4941421	.	T	G	5	3	8	0	0	8	0	0
10	4950824	.	G	T	1	1	2	0	0	2	0	0
10	4956906	.	C	T	6	4	10	0	0	10	0	0
10	4956966	.	G	A	10	6	16	0	0	16	0	0
10	4968900	.	G	C	1	2	3	0	0	3	0	0
10	4969014	.	T	A	12	8	20	0	1	21	0	0
10	4969036	.	T	G	9	0	9	0	6	15	0	0
10	4969069	.	C	A	8	7	15	0	0	15	0	0
10	4995808	.	C	T	1	2	3	0	0	3	0	0
10	5000719	.	C	T	2	9	11	0	13	24	0	0
10	5000753	.	C	T	2	7	9	0	16	25	0	0
10	5004215	.	C	T	5	3	8	0	0	8	0	0
10	5010287	.	G	A	11	14	25	0	2	27	0	0
10	5010344	.	T	G	23	16	39	0	1	40	0	0
10	5010407	.	G	A	2	3	5	1	0	6	0	0
10	5016797	.	G	A	22	21	43	0	4	47	0	0
10	5016917	.	C	G	19	28	47	0	0	47	0	0
10	5016922	.	A	G	20	30	50	0	0	50	0	0
10	5020320	.	G	A	31	16	47	0	0	47	0	0
10	5020326	.	T	C	15	25	40	0	1	41	0	0
10	5024410	.	C	T	27	22	49	0	2	51	0	0
10	5025848	.	C	A	8	13	21	0	0	21	0	0
10	5026058	.	C	T	4	2	6	0	0	6	0	0
10	5028877	.	A	G	9	4	13	0	1	14	0	0
10	5031869	.	T	C	3	1	4	0	0	4	0	0
10	5036521	.	G	A	0	8	8	0	7	15	0	0
10	5036522	.	A	G	6	8	14	0	1	15	0	0
10	5036729	.	C	T	8	6	14	0	0	14	0	0
10	5036881	.	A	G	3	1	4	0	1	5	0	0
10	5037119	.	T	A	7	2	9	0	0	9	0	0
10	5037147	.	C	T	3	4	7	0	1	8	0	0
10	5037181	.	T	G	6	4	10	0	0	10	0	0
10	5037372	.	A	T	13	7	20	0	0	20	0	0
10	5042113	.	C	T	8	6	14	0	0	14	0	0
10	5042217	.	A	G	6	3	9	0	0	9	0	0
10	5042239	.	G	A	6	3	9	0	0	9	0	0
10	5042469	.	G	A	1	2	3	0	0	3	0	0
10	5047452	.	A	G	4	5	9	0	1	10	0	0
10	5053518	.	C	G	1	0	1	0	0	1	0	0
10	5053556	.	T	C	2	1	3	0	1	4	0	0
10	5058715	.	C	T	0	4	4	0	5	9	0	0
10	5092764	.	T	C	7	5	12	0	0	12	0	0
10	5092772	.	A	G	6	3	9	0	0	9	0	0
10	5093222	.	A	G	8	9	17	0	1	18	0	0
10	5093240	.	C	A	11	5	16	0	0	16	0	0
10	5093274	.	A	G	3	6	9	0	0	9	0	0
10	5093592	.	G	C	2	4	6	0	0	6	0	0
10	5093615	.	G	A	2	4	6	0	0	6	0	0
10	5094649	.	C	A	1	7	8	0	1	9	0	0
10	5094778	.	G	T	4	3	7	0	0	7	0	0
10	5097478	.	G	A	4	7	11	0	0	11	0	0
10	5097520	.	A	G	6	6	12	0	3	15	0	0
10	5110761	.	A	G	2	4	6	0	0	6	0	0
10	5110777	.	G	A	2	4	6	0	0	6	0	0
10	5203569	.	G	A	1	1	2	0	0	2	0	0
10	5216204	.	T	C	1	8	9	0	0	9	0	0
10	5216249	.	A	G	1	8	9	0	0	9	0	0
10	5220608	.	C	T	10	11	21	0	0	21	0	0
10	5220835	.	G	A	0	9	9	0	3	12	0	0
10	5220940	.	T	A	5	8	13	0	0	13	0	0
10	5220992	.	C	T	6	8	14	0	0	14	0	0
10	5220997	.	C	A	9	6	15	0	1	16	0	0
10	5221039	.	G	A	6	8	14	0	1	15	0	0
10	5221199	.	T	A	6	3	9	0	1	10	0	0
10	5221238	.	C	A	3	8	11	0	0	11	0	0
10	5221292	.	C	A	13	2	15	0	0	15	0	0
10	5221297	.	T	G	12	2	14	0	0	14	0	0
10	5221336	.	G	C	6	8	14	0	0	14	0	0
10	5237199	.	C	A	1	1	2	0	0	2	0	0
10	5237213	.	C	T	1	1	2	0	0	2	0	0
10	5245143	.	G	A	0	0	0	0	2	2	0	0
10	5248247	.	T	C	3	2	5	0	0	5	0	0
10	5258914	.	T	A	7	5	12	0	0	12	0	0
10	5264458	.	G	A	3	7	10	0	0	10	0	0
10	5264534	.	C	A	1	5	6	0	1	7	0	0
10	5414339	.	C	T	1	3	4	0	0	4	0	0
10	5417480	.	A	G	1	3	4	0	1	5	0	0
10	5417841	.	A	C	1	5	6	0	0	6	0	0
10	5418509	.	A	G	5	6	11	0	0	11	0	0
10	5418569	.	C	T	5	8	13	0	0	13	0	0
10	5429905	.	G	A	0	2	2	0	1	3	0	0
10	5432576	.	T	C	1	1	2	0	1	3	0	0
10	5461988	.	C	A	7	8	15	0	3	18	0	0
10	5461994	.	T	A	9	9	18	0	0	18	0	0
10	5475406	.	A	T	4	2	6	0	0	6	0	0
10	5475526	.	T	C	6	6	12	0	0	12	0	0
10	5534179	.	T	A	6	3	9	0	0	9	0	0
10	5534369	.	T	A	3	2	5	0	0	5	0	0
10	5534483	.	T	C	1	3	4	0	0	4	0	0
10	5534487	.	C	T	0	2	2	0	2	4	0	0
10	5534527	.	G	T	2	3	5	0	1	6	0	0
10	5534539	.	G	A	2	2	4	0	0	4	0	0
10	5534611	.	C	T	5	7	12	0	0	12	0	0
10	5534612	.	A	G	5	7	12	0	0	12	0	0
10	5534646	.	A	G	6	6	12	0	0	12	0	0
10	5534878	.	C	T	11	5	16	0	1	17	0	0
10	5534946	.	A	G	12	3	15	0	0	15	0	0
10	5534950	.	A	T	12	3	15	0	0	15	0	0
10	5535359	.	A	T	9	8	17	0	0	17	0	0
10	5535368	.	T	A	8	4	12	0	0	12	0	0
10	5535483	.	A	T	3	8	11	0	1	12	0	0
10	5535540	.	T	G	2	14	16	0	4	20	0	0
10	5535561	.	T	A	7	11	18	0	0	18	0	0
10	5536240	.	T	C	2	2	4	0	0	4	0	0
10	5536256	.	G	A	2	2	4	0	0	4	0	0
10	5536534	.	T	A	1	3	4	0	0	4	0	0
10	5537048	.	G	T	6	4	10	0	0	10	0	0
10	5538302	.	T	G	1	3	4	0	1	5	0	0
10	5542152	.	T	C	1	1	2	0	0	2	0	0
10	5545438	.	C	T	1	2	3	0	0	3	0	0
10	5545465	.	T	C	2	2	4	0	1	5	0	0
10	5568128	.	G	T	2	6	8	0	0	8	0	0
10	5568155	.	T	G	2	3	5	0	0	5	0	0
10	5568212	.	G	A	11	4	15	0	0	15	0	0
10	5568319	.	A	C	5	5	10	0	0	10	0	0
10	5568329	.	A	G	5	4	9	0	0	9	0	0
10	5667439	.	A	T	3	4	7	0	0	7	0	0
10	5667467	.	T	A	3	6	9	0	1	10	0	0
10	5667605	.	C	T	1	6	7	0	0	7	0	0
10	5668135	.	G	A	4	2	6	0	0	6	0	0
10	5668218	.	G	C	7	4	11	0	0	11	0	0
10	5676520	.	T	A	1	1	2	0	0	2	0	0
10	5724020	.	T	C	0	1	1	0	0	1	0	0
10	5724095	.	T	C	2	2	4	0	0	4	0	0
10	5737757	.	G	A	4	5	9	0	0	9	0	0
10	5744934	.	C	T	6	0	6	0	0	6	0	0
10	5745015	.	C	A	17	22	39	0	1	40	0	0
10	5760455	.	T	C	19	12	31	0	0	31	0	0
10	5760461	.	A	G	19	15	34	0	0	34	0	0
10	5766958	.	A	G	8	2	10	0	0	10	0	0
10	5769541	.	G	T	5	0	5	0	0	5	0	0
10	5772568	.	A	G	4	8	12	0	1	13	0	0
10	5788755	.	A	C	6	7	13	0	0	13	0	0
10	5788806	.	G	A	7	9	16	0	0	16	0	0
10	5788877	.	G	A	2	3	5	0	0	5	0	0
10	5789155	.	G	T	4	3	7	0	1	8	0	0
10	5789758	.	G	T	4	6	10	0	1	11	0	0
10	5789806	.	C	T	9	6	15	0	1	16	0	0
10	5789995	.	C	T	4	4	8	0	0	8	0	0
10	5790001	.	C	A	2	2	4	0	0	4	0	0
10	5790080	.	A	G	3	11	14	0	1	15	0	0
10	5790097	.	G	A	2	7	9	0	1	10	0	0
10	5790210	.	C	T	4	10	14	0	3	17	0	0
10	5790278	.	G	T	8	5	13	0	0	13	0	0
10	5790570	.	A	C	5	9	14	0	0	14	0	0
10	5790640	.	T	G	3	6	9	0	0	9	0	0
10	5790866	.	A	C	3	5	8	0	0	8	0	0
10	5790913	.	A	C	4	5	9	0	0	9	0	0
10	5790922	.	C	A	4	5	9	0	0	9	0	0
10	5790956	.	C	G	0	5	5	0	5	10	0	0
10	5791030	.	A	G	6	4	10	0	1	11	0	0
10	5791044	.	C	T	0	4	4	0	10	14	0	0
10	5791184	.	G	A	7	4	11	0	0	11	0	0
10	5791224	.	C	G	7	7	14	0	0	14	0	0
10	5791238	.	A	G	7	5	12	0	0	12	0	0
10	5791377	.	A	T	8	10	18	0	0	18	0	0
10	5791387	.	G	A	7	11	18	0	0	19	1	0
10	5791417	.	C	T	0	12	12	0	5	17	0	0
10	5792512	.	A	T	0	8	8	0	0	8	0	0
10	5792533	.	A	T	2	5	7	0	0	7	0	0
10	5792573	.	G	A	5	3	8	0	0	8	0	0
10	5792615	.	A	G	5	6	11	0	0	11	0	0
10	5792667	.	G	A	6	6	12	0	0	12	0	0
10	5792757	.	A	G	4	4	8	0	0	8	0	0
10	5793197	.	G	A	2	4	6	0	0	6	0	0
10	5793827	.	A	C	2	3	5	0	0	5	0	0
10	5793863	.	A	G	1	6	7	0	0	7	0	0
10	5794423	.	C	G	2	3	5	0	0	5	0	0
10	5796929	.	C	T	0	1	1	0	1	2	0	0
10	5828645	.	A	G	2	5	7	0	0	7	0	0
10	5828660	.	A	G	2	9	11	0	0	11	0	0
10	5828704	.	C	A	0	9	9	0	2	11	0	0
10	5828840	.	A	G	6	2	8	0	0	8	0	0
10	5828945	.	A	G	7	6	13	0	0	13	0	0
10	5834171	.	C	T	4	5	9	0	0	9	0	0
10	5844763	.	A	G	2	0	2	0	0	2	0	0
10	5847731	.	A	T	2	2	4	0	0	4	0	0
10	6016242	.	G	A	5	1	6	0	1	7	0	0
10	6016545	.	G	T	2	5	7	0	1	8	0	0
10	6023750	.	A	G	2	1	3	0	0	3	0	0
10	6023946	.	T	C	7	4	11	0	0	11	0	0
10	6023958	.	G	A	5	3	8	0	0	8	0	0
10	6024159	.	A	T	1	0	1	0	0	1	0	0
10	6024248	.	G	C	2	0	2	0	0	2	0	0
10	6032880	.	A	G	4	0	4	0	9	13	0	0
10	6032886	.	G	A	3	9	12	0	1	13	0	0
10	6033452	.	T	C	2	6	8	0	0	8	0	0
10	6033469	.	A	C	3	4	7	0	1	8	0	0
10	6033612	.	G	A	0	13	13	0	3	16	0	0
10	6033627	.	A	T	4	13	17	0	0	17	0	0
10	6034194	.	A	T	8	5	13	0	1	14	0	0
10	6265475	.	A	G	0	2	2	0	0	2	0	0
10	6275517	.	G	A	1	4	5	0	1	6	0	0
10	6275577	.	C	T	2	6	8	0	1	9	0	0
10	6278202	.	A	G	1	0	1	0	0	1	0	0
10	6280939	.	G	A	0	2	2	0	2	4	0	0
10	6281946	.	A	G	2	0	2	0	3	5	0	0
10	6299736	.	G	A	0	2	2	0	4	6	0	0
10	6301828	.	C	T	0	1	1	0	0	1	0	0
10	6301930	.	C	T	3	7	10	0	1	11	0	0
10	6312954	.	A	T	4	10	14	0	0	14	0	0
10	6313465	.	A	G	0	0	0	0	2	2	0	0
10	6313643	.	C	T	5	4	9	0	0	9	0	0
10	6348571	.	C	A	6	7	13	0	0	13	0	0
10	6372501	.	C	T	10	10	20	0	1	21	0	0
10	6372915	.	G	A	6	6	12	0	0	12	0	0
10	6372964	.	T	C	7	3	10	0	1	11	0	0
10	6373079	.	C	G	6	5	11	0	0	11	0	0
10	6373332	.	A	T	3	6	9	0	0	9	0	0
10	6373336	.	C	G	3	7	10	0	0	10	0	0
10	6373378	.	A	C	5	8	13	0	0	13	0	0
10	6373472	.	T	A	4	4	8	0	0	8	0	0
10	6373524	.	A	G	3	7	10	0	1	11	0	0
10	6373679	.	A	G	13	6	19	0	1	20	0	0
10	6373708	.	A	G	15	0	15	0	10	25	0	0
10	6373758	.	A	C	9	9	18	0	0	19	1	0
10	6374017	.	A	G	7	11	18	0	0	18	0	0
10	6374041	.	A	T	3	13	16	0	2	18	0	0
10	6374068	.	G	T	4	10	14	0	2	16	0	0
10	6374235	.	T	C	9	14	23	0	0	23	0	0
10	6374279	.	G	A	1	10	11	0	16	27	0	0
10	6374352	.	C	T	15	13	28	0	1	29	0	0
10	6374372	.	A	G	14	17	31	0	0	31	0	0
10	6374388	.	C	T	10	13	23	0	1	24	0	0
10	6374486	.	A	G	11	9	20	0	1	21	0	0
10	6374501	.	A	G	5	10	15	0	2	17	0	0
10	6401577	.	A	C	4	2	6	0	0	6	0	0
10	6401834	.	G	A	2	3	5	0	1	6	0	0
10	6401884	.	T	A	1	2	3	0	1	4	0	0
10	6402213	.	T	A	8	4	12	0	1	13	0	0
10	6402593	.	G	A	0	3	3	0	4	7	0	0
10	6403362	.	G	A	0	1	1	0	1	2	0	0
10	6403383	.	C	A	0	2	2	0	0	2	0	0
10	6403398	.	T	C	1	1	2	0	0	2	0	0
10	6404272	.	G	A	0	2	2	0	1	3	0	0
10	6404312	.	A	T	2	2	4	0	0	4	0	0
10	6404331	.	A	G	1	2	3	0	1	4	0	0
10	6404764	.	G	C	2	2	4	0	0	4	0	0
10	6405321	.	A	G	1	5	6	0	1	7	0	0
10	6405897	.	T	A	2	2	4	0	0	4	0	0
10	6406635	.	C	T	3	2	5	0	0	5	0	0
10	6406677	.	A	G	5	3	8	0	0	8	0	0
10	6407559	.	A	T	8	5	13	0	1	14	0	0
10	6407605	.	C	A	4	4	8	0	1	9	0	0
10	6407732	.	A	T	0	4	4	0	0	4	0	0
10	6407833	.	T	C	3	4	7	0	1	8	0	0
10	6407871	.	A	G	2	5	7	0	0	7	0	0
10	6407904	.	C	T	9	2	11	0	0	11	0	0
10	6408955	.	T	G	6	0	6	0	4	10	0	0
10	6408986	.	A	G	9	3	12	0	0	12	0	0
10	6409145	.	G	C	5	2	7	0	0	7	0	0
10	6409171	.	T	C	3	3	6	0	0	6	0	0
10	6409267	.	C	A	5	5	10	0	0	10	0	0
10	6409379	.	A	G	5	5	10	0	0	10	0	0
10	6409448	.	C	T	5	5	10	0	0	10	0	0
10	6409455	.	T	A	5	6	11	0	0	11	0	0
10	6409506	.	A	G	9	13	22	0	0	22	0	0
10	6409583	.	C	T	3	6	9	0	0	9	0	0
10	6473544	.	T	C	14	13	27	0	0	27	0	0
10	6473685	.	T	C	9	9	18	0	0	18	0	0
10	6473704	.	C	G	11	7	18	0	0	18	0	0
10	6473851	.	A	G	9	17	26	0	0	26	0	0
10	6473862	.	C	T	0	18	18	0	10	28	0	0
10	6473908	.	A	G	13	9	22	0	1	23	0	0
10	6473996	.	T	C	11	10	21	0	0	21	0	0
10	6474057	.	T	A	4	3	7	0	0	7	0	0
10	6479444	.	T	C	13	0	13	0	10	23	0	0
10	6479471	.	C	T	0	5	5	0	9	14	0	0
10	6510756	.	T	C	10	12	22	0	3	25	0	0
10	6510786	.	T	G	20	24	44	0	1	45	0	0
10	6510825	.	T	C	12	13	25	0	0	25	0	0
10	6517593	.	T	A	34	25	59	0	2	61	0	0
10	6517663	.	A	G	25	0	25	0	17	42	0	0
10	6517726	.	C	T	19	19	38	0	1	39	0	0
10	6517959	.	A	G	23	12	35	0	2	37	0	0
10	6522267	.	A	T	4	4	8	0	0	8	0	0
10	6528005	.	A	G	0	1	1	0	0	1	0	0
10	6531002	.	A	G	2	2	4	0	0	4	0	0
10	6531297	.	T	C	1	2	3	0	0	3	0	0
10	6533850	.	T	A	3	5	8	0	0	8	0	0
10	6546851	.	A	G	0	3	3	0	0	3	0	0
10	6546929	.	C	A	0	5	5	0	1	6	0	0
10	6549360	.	C	T	4	4	8	0	0	8	0	0
10	6566670	.	C	T	0	1	1	0	0	1	0	0
10	6781278	.	T	A	5	4	9	0	0	9	0	0
10	6781286	.	G	T	4	6	10	0	0	10	0	0
10	6781362	.	G	A	13	9	22	0	0	22	0	0
10	6781372	.	T	A	16	8	24	0	2	26	0	0
10	6781450	.	T	C	16	8	24	0	0	24	0	0
10	6781506	.	A	T	10	11	21	0	0	21	0	0
10	6781664	.	A	T	10	13	23	0	0	23	0	0
10	6781742	.	G	T	1	4	5	0	1	6	0	0
10	6781786	.	A	T	3	6	9	0	0	9	0	0
10	6781867	.	C	A	7	5	12	0	1	13	0	0
10	6781903	.	T	G	5	6	11	0	1	12	0	0
10	6781918	.	A	T	7	8	15	0	0	15	0	0
10	6782020	.	G	C	7	9	16	0	0	16	0	0
10	6782036	.	T	C	6	0	6	0	7	13	0	0
10	6782088	.	T	C	7	2	9	2	0	11	0	0
10	6782267	.	T	A	0	3	3	3	0	6	0	0
10	6782279	.	A	C	1	5	6	3	0	9	0	0
10	6782454	.	C	G	10	10	20	0	0	20	0	0
10	6782489	.	T	G	8	17	25	0	1	26	0	0
10	6782624	.	A	G	14	13	27	0	2	29	0	0
10	6782636	.	T	A	12	18	30	0	2	32	0	0
10	6782664	.	A	G	15	18	33	0	0	33	0	0
10	6786326	.	C	T	0	5	5	0	1	6	0	0
10	6786564	.	A	G	9	13	22	0	0	22	0	0
10	6804756	.	T	C	7	0	7	0	5	12	0	0
10	6824761	.	A	C	5	8	13	0	0	13	0	0
10	6824845	.	A	T	6	15	21	0	0	21	0	0
10	6824877	.	T	G	1	7	8	0	0	8	0	0
10	6831298	.	C	T	0	0	0	0	1	1	0	0
10	6831446	.	T	C	1	1	2	0	0	2	0	0
10	6834065	.	A	T	1	4	5	0	0	5	0	0
10	6834341	.	G	A	6	12	18	0	0	18	0	0
10	6834380	.	C	A	0	5	5	0	6	11	0	0
10	6851184	.	C	A	4	4	8	0	0	8	0	0
10	6933742	.	G	A	0	0	0	0	2	2	0	0
10	6933802	.	G	A	1	0	1	0	0	1	0	0
10	6936471	.	G	A	0	2	2	0	0	2	0	0
10	6944199	.	G	C	5	3	8	0	0	8	0	0
10	7210001	.	G	A	0	10	10	0	13	23	0	0
10	7221810	.	A	G	4	6	10	0	0	10	0	0
10	7222213	.	T	C	8	12	20	0	0	20	0	0
10	7224964	.	A	G	0	4	4	0	1	6	1	0
10	7231728	.	T	C	19	22	41	0	0	41	0	0
10	7231821	.	T	A	24	16	40	0	0	41	1	0
10	7231964	.	G	C	26	11	37	0	1	38	0	0
10	7232043	.	T	A	12	13	25	0	2	27	0	0
10	7232058	.	G	T	0	14	14	0	14	28	0	0
10	7232104	.	A	T	20	11	31	0	1	32	0	0
10	7232320	.	T	A	9	1	10	0	0	10	0	0
10	7232416	.	T	C	9	15	24	0	2	26	0	0
10	7232420	.	T	C	9	16	25	0	4	29	0	0
10	7233038	.	T	C	18	15	33	0	1	34	0	0
10	7233218	.	A	G	20	23	43	0	2	45	0	0
10	7233440	.	A	T	22	28	50	0	3	53	0	0
10	7233457	.	C	G	23	33	56	0	3	59	0	0
10	7233518	.	T	C	22	21	43	0	4	47	0	0
10	7233854	.	A	T	15	17	32	0	1	33	0	0
10	7233939	.	C	T	3	5	8	0	0	8	0	0
10	7284182	.	T	A	3	3	6	0	0	6	0	0
10	7284403	.	C	T	9	3	12	0	0	12	0	0
10	7284629	.	T	C	7	5	12	0	0	12	0	0
10	7311997	.	T	G	1	0	1	0	0	1	0	0
10	7312057	.	A	G	1	6	7	0	0	7	0	0
10	7347192	.	C	A	0	2	2	0	2	4	0	0
10	7483671	.	A	G	7	3	10	0	0	10	0	0
10	7500025	.	A	G	1	0	1	0	0	1	0	0
10	7500033	.	A	G	1	0	1	0	0	1	0	0
10	7508077	.	T	C	0	2	2	0	0	2	0	0
10	7564294	.	C	T	10	11	21	0	2	23	0	0
10	7593246	.	A	T	9	9	18	0	0	18	0	0
10	7593349	.	C	A	13	18	31	0	2	33	0	0
10	7617113	.	A	T	28	29	57	0	1	58	0	0
10	7617126	.	T	C	27	27	54	0	2	56	0	0
10	7617242	.	G	A	26	28	54	0	4	58	0	0
10	7617327	.	A	C	13	25	38	0	10	48	0	0
10	7617350	.	A	T	19	28	47	0	9	56	0	0
10	7617636	.	A	G	16	1	17	0	18	35	0	0
10	7635687	.	G	A	2	1	3	0	0	3	0	0
10	7636274	.	G	A	6	3	9	0	0	9	0	0
10	7640501	.	C	T	2	2	4	0	0	4	0	0
10	7640676	.	G	A	20	20	40	0	0	40	0	0
10	7653581	.	C	G	0	2	2	0	2	4	0	0
10	7653750	.	T	C	2	0	2	0	4	6	0	0
10	7671368	.	T	C	15	6	21	0	2	23	0	0
10	7671425	.	G	A	12	7	19	0	1	20	0	0
10	7672832	.	A	C	2	4	6	0	0	6	0	0
10	7672853	.	G	A	6	5	11	0	1	12	0	0
10	7673819	.	C	G	3	7	10	0	0	10	0	0
10	7673849	.	A	G	4	4	8	0	0	8	0	0
10	7674079	.	T	G	2	7	9	0	0	9	0	0
10	7674429	.	C	T	3	3	6	0	1	7	0	0
10	7674471	.	A	G	7	4	11	0	1	12	0	0
10	7674506	.	A	G	7	10	17	0	0	17	0	0
10	7678121	.	T	C	1	1	2	0	0	2	0	0
10	7678154	.	C	T	0	5	5	0	6	11	0	0
10	7678525	.	C	T	0	1	1	0	0	1	0	0
10	7696900	.	G	A	1	0	1	0	0	1	0	0
10	7700564	.	T	G	5	5	10	0	0	10	0	0
10	7700615	.	A	G	6	11	17	0	1	18	0	0
10	7700676	.	G	A	0	2	2	0	0	2	0	0
10	7701852	.	A	C	1	0	1	0	0	1	0	0
10	7704413	.	A	G	2	2	4	0	0	4	0	0
10	7704436	.	G	A	0	3	3	0	5	8	0	0
10	7704484	.	C	A	3	8	11	0	0	11	0	0
10	7704490	.	G	A	3	7	10	0	0	10	0	0
10	7704548	.	C	T	2	1	3	0	0	3	0	0
10	7709761	.	T	C	2	7	9	0	0	9	0	0
10	7709975	.	A	G	3	6	9	0	1	10	0	0
10	7709978	.	T	C	4	6	10	0	0	10	0	0
10	7712180	.	T	A	6	10	16	0	0	16	0	0
10	7712206	.	G	A	5	8	13	0	1	14	0	0
10	7712228	.	C	T	3	3	6	0	0	6	0	0
10	7713924	.	A	G	2	0	2	0	2	4	0	0
10	7721459	.	A	G	4	6	10	0	0	10	0	0
10	7721746	.	G	A	2	11	13	0	0	13	0	0
10	7723004	.	T	C	1	3	4	0	0	4	0	0
10	7723061	.	C	A	2	6	8	0	0	8	0	0
10	7723157	.	A	G	15	9	24	0	0	24	0	0
10	7723218	.	T	C	10	15	25	0	0	25	0	0
10	7723275	.	C	A	13	9	22	0	0	22	0	0
10	7723337	.	C	G	2	7	9	0	1	10	0	0
10	7723413	.	T	G	1	4	5	0	0	5	0	0
10	7723430	.	G	A	0	4	4	0	0	4	0	0
10	7727505	.	T	A	3	2	5	0	0	5	0	0
10	7727598	.	A	T	2	2	4	0	1	5	0	0
10	7727704	.	T	A	2	1	3	0	0	3	0	0
10	7734316	.	T	G	0	2	2	0	0	2	0	0
10	7734401	.	G	A	3	3	6	0	0	6	0	0
10	7734465	.	C	T	5	8	13	0	0	13	0	0
10	7770257	.	A	C	5	4	9	0	0	9	0	0
10	7770264	.	A	T	6	3	9	0	0	9	0	0
10	7771634	.	T	A	3	7	10	0	0	10	0	0
10	7771735	.	A	C	1	5	6	0	1	7	0	0
10	7771769	.	C	T	4	8	12	0	0	12	0	0
10	7771778	.	G	A	4	5	9	0	0	9	0	0
10	7772012	.	T	G	5	4	9	0	0	9	0	0
10	7772272	.	C	T	4	5	9	0	0	9	0	0
10	7810461	.	A	T	22	18	40	0	2	42	0	0
10	7810565	.	G	A	13	20	33	0	0	33	0	0
10	7811062	.	T	A	4	7	11	0	0	11	0	0
10	7811075	.	T	C	3	6	9	0	0	9	0	0
10	7811935	.	A	G	10	9	19	0	1	20	0	0
10	7815118	.	G	A	10	10	20	0	0	20	0	0
10	7815187	.	G	A	4	1	5	0	0	5	0	0
10	7831879	.	C	T	4	1	5	0	0	5	0	0
10	7843594	.	G	T	2	3	5	0	0	5	0	0
10	7901065	.	T	G	3	3	6	0	0	6	0	0
10	7901666	.	A	T	2	2	4	0	0	4	0	0
10	7902045	.	T	G	5	2	7	0	0	7	0	0
10	7902255	.	A	G	2	3	5	0	0	5	0	0
10	7909269	.	C	A	3	6	9	0	0	9	0	0
10	7909665	.	T	A	3	5	8	0	0	8	0	0
10	7916836	.	A	C	6	10	16	0	0	16	0	0
10	7916930	.	C	A	7	5	12	0	0	12	0	0
10	7917036	.	A	T	10	6	16	0	0	16	0	0
10	7917114	.	T	C	14	11	25	0	1	26	0	0
10	7917411	.	C	A	0	11	11	0	6	17	0	0
10	7917483	.	C	A	4	8	12	0	2	14	0	0
10	7917551	.	A	G	11	9	20	0	0	20	0	0
10	7917592	.	T	C	19	12	31	0	0	31	0	0
10	7917686	.	T	C	14	13	27	0	1	28	0	0
10	7917690	.	A	T	13	15	28	0	0	28	0	0
10	7920910	.	T	G	11	14	25	0	1	26	0	0
10	7920913	.	C	T	11	11	22	0	3	25	0	0
10	7922210	.	G	T	7	5	12	0	1	13	0	0
10	7922294	.	C	A	7	10	17	0	1	18	0	0
10	7926899	.	A	G	2	4	6	0	0	6	0	0
10	7929647	.	T	C	7	0	7	0	8	15	0	0
10	7936283	.	T	G	8	18	26	0	0	26	0	0
10	7938629	.	C	T	4	5	9	0	1	10	0	0
10	7938659	.	A	G	4	11	15	0	0	15	0	0
10	7938683	.	T	C	6	13	19	0	0	19	0	0
10	7959655	.	T	A	1	0	1	0	0	1	0	0
10	7968274	.	G	T	4	7	11	0	0	11	0	0
10	7984677	.	A	T	2	2	4	0	0	4	0	0
10	7986217	.	T	C	5	9	14	0	1	15	0	0
10	7986307	.	C	T	0	1	1	0	2	3	0	0
10	7988956	.	C	A	1	2	3	0	0	3	0	0
10	7989000	.	C	T	3	7	10	0	1	11	0	0
10	7989162	.	T	G	7	2	9	0	1	10	0	0
10	7989287	.	G	A	10	10	20	0	1	21	0	0
10	7989348	.	C	T	8	9	17	0	0	17	0	0
10	7989576	.	C	T	5	3	8	0	2	10	0	0
10	7992197	.	T	C	14	6	20	0	1	21	0	0
10	7996021	.	G	A	2	1	3	0	0	3	0	0
10	8001365	.	A	G	4	7	11	0	0	11	0	0
10	8005785	.	T	A	6	2	8	0	0	8	0	0
10	8009996	.	A	C	3	8	11	0	0	11	0	0
10	8010064	.	A	G	1	2	3	0	0	3	0	0
10	8033234	.	T	C	0	1	1	0	0	1	0	0
10	8033259	.	C	T	1	3	4	0	0	4	0	0
10	8033328	.	A	G	3	2	5	0	0	5	0	0
10	8033332	.	T	A	3	4	7	0	0	7	0	0
10	8036884	.	C	T	1	5	6	0	2	8	0	0
10	8037387	.	A	T	1	0	1	0	1	2	0	0
10	8037752	.	T	C	3	3	6	0	0	6	0	0
10	8037797	.	T	C	1	3	4	0	0	4	0	0
10	8040536	.	T	C	0	1	1	0	0	1	0	0
10	8041412	.	G	C	2	2	4	0	0	4	0	0
10	8041863	.	C	G	2	2	4	0	0	4	0	0
10	8091212	.	G	A	7	11	18	0	0	18	0	0
10	8097929	.	C	G	22	12	34	0	1	35	0	0
10	8160813	.	T	G	2	1	3	0	0	3	0	0
10	8160888	.	G	A	3	4	7	0	0	7	0	0
10	8160891	.	T	C	3	0	3	0	4	7	0	0
10	8163440	.	G	A	4	4	8	0	0	8	0	0
10	8170468	.	C	A	0	1	1	0	1	2	0	0
10	8177559	.	C	T	0	1	1	0	2	3	0	0
10	8177748	.	A	G	3	2	5	0	0	5	0	0
10	8194893	.	G	A	4	5	9	0	0	9	0	0
10	8202517	.	C	T	2	1	3	0	0	3	0	0
10	8202523	.	C	T	2	1	3	0	0	3	0	0
10	8208610	.	G	A	2	3	5	0	0	5	0	0
10	8217029	.	T	C	0	1	1	0	0	1	0	0
10	8228235	.	T	C	0	1	1	0	0	1	0	0
10	8236048	.	T	C	1	3	4	0	1	5	0	0
10	8236775	.	T	C	5	5	10	0	1	11	0	0
10	8265917	.	A	T	4	5	9	0	0	9	0	0
10	8265922	.	T	C	4	5	9	0	0	9	0	0
10	8266248	.	C	T	1	22	23	0	20	43	0	0
10	8266383	.	A	G	13	15	28	0	3	31	0	0
10	8269224	.	G	A	5	8	13	0	0	13	0	0
10	8269377	.	G	A	1	1	2	0	0	2	0	0
10	8269439	.	C	T	0	2	2	0	1	3	0	0
10	8269459	.	T	C	1	2	3	0	0	3	0	0
10	8278160	.	T	C	11	9	20	0	5	25	0	0
10	8278214	.	A	G	9	7	16	0	1	17	0	0
10	8282705	.	T	A	3	1	4	0	0	4	0	0
10	8295026	.	C	T	0	4	4	0	13	17	0	0
10	8295196	.	T	G	11	7	18	0	0	18	0	0
10	8335312	.	C	T	0	1	1	0	0	1	0	0
10	8335315	.	T	C	0	1	1	0	1	2	0	0
10	8335402	.	A	G	2	5	7	0	0	7	0	0
10	8358022	.	C	T	2	2	4	0	0	4	0	0
10	8358373	.	A	T	1	4	5	0	0	5	0	0
10	8425216	.	T	C	1	0	1	0	1	2	0	0
10	8466538	.	T	C	0	1	1	0	0	1	0	0
10	8466562	.	G	A	0	2	2	0	0	2	0	0
10	8629373	.	T	C	9	5	14	0	0	14	0	0
10	8630102	.	C	T	14	10	24	0	1	25	0	0
10	8630428	.	A	G	15	10	25	0	0	25	0	0
10	8630527	.	G	A	7	10	17	0	0	17	0	0
10	8630585	.	A	G	5	0	5	0	9	14	0	0
10	8630631	.	T	C	6	12	18	0	0	18	0	0
10	8630690	.	G	A	4	10	14	0	1	15	0	0
10	8630702	.	T	C	4	10	14	0	0	14	0	0
10	8630808	.	G	A	6	6	12	0	1	13	0	0
10	8631103	.	G	A	0	5	5	0	1	6	0	0
10	8631135	.	A	G	4	4	8	0	1	9	0	0
10	8631201	.	A	G	8	8	16	0	2	18	0	0
10	8670121	.	A	C	5	5	10	0	0	10	0	0
10	8670139	.	G	A	5	2	7	0	0	7	0	0
10	8672510	.	A	G	13	10	23	0	4	27	0	0
10	8672519	.	T	C	16	12	28	0	0	28	0	0
10	8672672	.	C	G	14	10	24	0	1	25	0	0
10	8672707	.	A	T	16	20	36	0	0	36	0	0
10	8829791	.	T	C	0	2	2	0	0	2	0	0
10	8832344	.	A	G	1	1	2	0	0	2	0	0
10	8835208	.	G	A	0	0	0	0	1	1	0	0
10	8835269	.	C	T	1	1	2	0	0	2	0	0
10	8835272	.	A	T	1	1	2	0	0	2	0	0
10	8950022	.	T	C	3	0	3	0	2	5	0	0
10	8952018	.	T	C	6	0	6	0	3	9	0	0
10	8952019	.	A	G	6	3	9	0	0	9	0	0
10	8952601	.	A	G	3	3	6	0	0	6	0	0
10	8970802	.	T	C	0	1	1	0	0	1	0	0
10	8976450	.	T	C	2	3	5	0	0	5	0	0
10	9006634	.	T	C	9	9	18	0	0	18	0	0
10	9097330	.	A	T	2	2	4	0	0	4	0	0
10	9159424	.	T	A	1	5	6	0	1	7	0	0
10	9169479	.	C	T	4	7	11	0	0	11	0	0
10	9169613	.	C	T	0	3	3	0	0	3	0	0
10	9177363	.	T	C	2	3	5	0	2	7	0	0
10	9181508	.	T	A	0	3	3	0	0	3	0	0
10	9184326	.	T	A	5	8	13	0	0	13	0	0
10	9184327	.	A	C	7	5	12	0	0	13	1	0
10	9184533	.	C	T	9	7	16	0	1	17	0	0
10	9201143	.	G	A	0	1	1	0	0	1	0	0
10	9229570	.	C	T	3	2	5	0	0	5	0	0
10	9234056	.	T	A	1	2	3	0	0	3	0	0
10	9234145	.	C	T	1	3	4	0	0	4	0	0
10	9234153	.	T	G	1	3	4	0	0	4	0	0
10	9234279	.	G	C	4	4	8	0	1	9	0	0
10	9234742	.	G	A	0	2	2	0	4	6	0	0
10	9235180	.	G	T	0	7	7	0	3	10	0	0
10	9235184	.	G	A	0	7	7	0	3	10	0	0
10	9235217	.	A	T	1	6	7	0	1	8	0	0
10	9268737	.	C	A	1	1	2	0	0	2	0	0
10	9268746	.	A	T	1	1	2	0	0	2	0	0
10	9305219	.	A	G	3	3	6	0	0	6	0	0
10	9305246	.	T	C	3	0	3	0	3	6	0	0
10	9305305	.	C	T	4	5	9	0	0	9	0	0
10	9305433	.	A	G	6	3	9	0	1	10	0	0
10	9305465	.	T	C	6	0	6	0	5	11	0	0
10	9308133	.	G	A	0	1	1	0	0	1	0	0
10	9347928	.	C	G	4	0	4	0	4	8	0	0
10	9361037	.	C	T	3	3	6	0	0	6	0	0
10	9361891	.	G	A	1	2	3	0	0	3	0	0
10	9361924	.	G	C	2	2	4	0	0	4	0	0
10	9369466	.	A	G	3	4	7	0	0	7	0	0
10	9370210	.	T	A	6	6	12	0	1	13	0	0
10	9370755	.	A	G	2	2	4	0	0	4	0	0
10	9390746	.	T	C	1	3	4	0	1	5	0	0
10	9390767	.	T	C	3	4	7	0	0	7	0	0
10	9393537	.	T	A	4	2	6	0	0	6	0	0
10	9394247	.	A	C	5	2	7	0	0	7	0	0
10	9394365	.	G	C	2	2	4	0	0	4	0	0
10	9394918	.	G	C	1	4	5	0	0	5	0	0
10	9395012	.	C	T	5	5	10	0	0	10	0	0
10	9601542	.	T	C	1	2	3	0	0	3	0	0
10	9601620	.	T	C	3	3	6	0	1	7	0	0
10	9610388	.	A	C	1	4	5	0	0	5	0	0
10	9618313	.	T	G	0	1	1	0	0	1	0	0
10	9626934	.	A	T	3	3	6	0	1	7	0	0
10	9628988	.	A	G	0	1	1	0	1	2	0	0
10	9629268	.	G	T	0	5	5	0	1	6	0	0
10	9629301	.	A	G	0	0	0	0	2	2	0	0
10	9629314	.	A	G	0	2	2	0	0	2	0	0
10	9632265	.	G	A	0	1	1	0	1	2	0	0
10	9632336	.	A	G	0	0	0	0	1	1	0	0
10	9642674	.	T	A	0	1	1	0	0	1	0	0
10	9642717	.	T	C	1	2	3	0	0	3	0	0
10	9644669	.	T	C	4	4	8	0	0	8	0	0
10	9701905	.	C	T	8	6	14	0	0	14	0	0
10	9704514	.	A	T	4	3	7	0	0	7	0	0
10	9714771	.	T	C	4	4	8	0	0	8	0	0
10	9714819	.	A	G	6	9	15	0	0	15	0	0
10	9781509	.	G	A	5	5	10	0	0	10	0	0
10	9784087	.	C	T	9	5	14	0	0	14	0	0
10	9802771	.	T	C	14	7	21	0	0	21	0	0
10	9806731	.	A	G	8	2	10	0	14	24	0	0
10	9807014	.	T	G	12	12	24	0	1	25	0	0
10	9807203	.	G	A	16	17	33	0	0	33	0	0
10	9836752	.	C	T	3	4	7	0	0	7	0	0
10	9837024	.	G	T	0	2	2	0	1	3	0	0
10	9837027	.	T	C	1	3	4	0	0	4	0	0
10	9837100	.	T	C	1	4	5	0	0	5	0	0
10	9846240	.	A	G	2	6	8	0	0	8	0	0
10	9846261	.	G	A	5	8	13	0	0	13	0	0
10	9856390	.	T	C	2	0	2	0	10	12	0	0
10	9856416	.	A	G	4	4	8	0	0	8	0	0
10	9895348	.	G	A	9	6	15	0	1	16	0	0
10	9899302	.	G	A	4	3	7	0	0	7	0	0
10	10210583	.	C	T	2	2	4	0	1	5	0	0
10	10254730	.	C	T	5	6	11	0	0	11	0	0
10	10254751	.	A	C	4	9	13	0	0	13	0	0
10	10254787	.	A	G	7	0	7	0	10	17	0	0
10	10254922	.	A	G	4	1	5	0	0	5	0	0
10	10261887	.	G	C	2	5	7	0	0	7	0	0
10	10261893	.	C	A	2	6	8	0	0	8	0	0
10	10262013	.	T	C	5	5	10	0	0	10	0	0
10	10262157	.	A	G	7	7	14	0	0	14	0	0
10	10269930	.	T	C	2	2	4	0	0	4	0	0
10	10325451	.	T	C	11	3	14	0	1	15	0	0
10	10325493	.	G	A	1	5	6	0	10	16	0	0
10	10380074	.	G	A	1	4	5	0	0	5	0	0
10	10535877	.	C	T	1	2	3	0	1	4	0	0
10	10543981	.	G	A	3	3	6	0	0	6	0	0
10	10567262	.	A	G	1	3	4	0	1	5	0	0
10	10636799	.	C	A	2	5	7	0	0	7	0	0
10	10636896	.	G	A	0	5	5	0	8	13	0	0
10	10636946	.	A	G	8	6	14	0	1	15	0	0
10	10729064	.	G	A	7	3	10	0	0	10	0	0
10	10729097	.	C	A	4	9	13	0	0	13	0	0
10	10729212	.	A	G	0	1	1	0	0	1	0	0
10	10764601	.	T	C	2	1	3	0	0	3	0	0
10	10780483	.	T	C	2	2	4	0	0	4	0	0
10	10782513	.	G	A	6	8	14	0	0	14	0	0
10	10860819	.	A	C	8	2	10	0	1	11	0	0
10	10860852	.	A	G	2	8	10	0	2	12	0	0
10	10861011	.	A	G	6	5	11	0	1	12	0	0
10	10861504	.	G	A	3	3	6	0	1	7	0	0
10	10862232	.	C	G	1	2	3	0	1	4	0	0
10	10880659	.	C	T	2	2	4	0	0	4	0	0
10	10880791	.	T	A	1	2	3	0	0	3	0	0
10	10930086	.	A	C	1	0	1	0	0	1	0	0
10	10930143	.	G	A	3	2	5	0	0	5	0	0
10	10935396	.	C	T	1	2	3	0	0	3	0	0
10	10935432	.	C	T	3	2	5	0	0	5	0	0
10	10935661	.	G	A	1	2	3	0	1	4	0	0
10	10935748	.	T	C	2	1	3	0	0	3	0	0
10	10935974	.	C	T	0	1	1	0	2	3	0	0
10	10987263	.	T	C	2	0	2	0	0	2	0	0
10	10997286	.	A	G	1	5	6	0	0	6	0	0
10	10997585	.	C	T	3	5	8	0	0	8	0	0
10	10997618	.	C	T	3	6	9	0	0	9	0	0
10	10997671	.	T	G	4	0	4	0	3	7	0	0
10	10997711	.	T	C	3	3	6	0	0	6	0	0
10	10997997	.	A	T	1	1	2	0	1	3	0	0
10	11001720	.	T	C	2	6	8	0	0	8	0	0
10	11001867	.	A	G	2	13	15	0	0	15	0	0
10	11001967	.	T	G	3	14	17	0	0	17	0	0
10	11001968	.	A	G	3	13	16	0	1	17	0	0
10	11002005	.	T	A	3	11	14	0	1	15	0	0
10	11146361	.	A	T	4	2	6	0	0	6	0	0
10	11146585	.	A	T	4	2	6	0	0	6	0	0
10	11166798	.	G	A	1	3	4	0	0	4	0	0
10	11174413	.	G	A	2	2	4	0	0	4	0	0
10	11178600	.	C	A	3	3	6	0	0	6	0	0
10	11183242	.	A	G	1	6	7	0	0	7	0	0
10	11265395	.	G	C	1	1	2	0	0	2	0	0
10	11267530	.	C	A	4	1	5	0	1	6	0	0
10	11280942	.	A	G	1	0	1	0	4	5	0	0
10	11280999	.	A	G	5	4	9	0	0	9	0	0
10	11281005	.	T	C	5	3	8	0	0	8	0	0
10	11282194	.	A	G	5	3	8	0	1	9	0	0
10	11286830	.	C	T	9	6	15	0	0	15	0	0
10	11287343	.	A	G	9	1	10	0	6	16	0	0
10	11298651	.	G	A	1	1	2	0	0	2	0	0
10	11298652	.	A	C	1	1	2	0	0	2	0	0
10	11298955	.	T	C	4	5	9	0	0	9	0	0
10	11298975	.	C	T	4	4	8	0	0	8	0	0
10	11299042	.	G	A	0	4	4	0	0	4	0	0
10	11309859	.	C	G	1	0	1	0	3	4	0	0
10	11310041	.	G	A	2	3	5	0	0	5	0	0
10	11310500	.	G	A	5	4	9	0	0	9	0	0
10	11310501	.	C	A	5	4	9	0	0	9	0	0
10	11310618	.	A	C	7	6	13	0	0	13	0	0
10	11310648	.	G	A	7	8	15	0	0	15	0	0
10	11310682	.	G	A	3	3	6	0	0	6	0	0
10	11310739	.	G	A	3	2	5	0	0	5	0	0
10	11322985	.	T	C	3	3	6	0	0	6	0	0
10	11323032	.	G	A	11	6	17	0	0	17	0	0
10	11327406	.	T	A	2	4	6	0	0	6	0	0
10	11327444	.	G	T	4	3	7	0	0	7	0	0
10	11327604	.	T	C	6	2	8	0	0	8	0	0
10	11327674	.	G	A	4	3	7	0	0	7	0	0
10	11331922	.	C	T	1	1	2	0	4	6	0	0
10	11332206	.	A	G	1	1	2	0	0	2	0	0
10	11334547	.	A	G	1	1	2	0	0	2	0	0
10	11339235	.	G	A	8	4	12	0	1	13	0	0
10	11339319	.	C	T	0	5	5	0	2	7	0	0
10	11347906	.	G	T	2	8	10	0	1	11	0	0
10	11347909	.	A	G	2	9	11	0	0	11	0	0
10	11347961	.	G	T	2	8	10	0	1	11	0	0
10	11362275	.	C	T	16	23	39	0	0	39	0	0
10	11370596	.	C	T	1	2	3	0	0	3	0	0
10	11394922	.	C	T	5	1	6	0	0	6	0	0
10	11398168	.	T	G	7	0	7	0	8	15	0	0
10	11403954	.	T	C	3	3	6	0	0	6	0	0
10	11773751	.	T	C	1	4	5	0	3	8	0	0
10	11779259	.	G	A	1	2	3	0	0	3	0	0
10	11790947	.	T	C	8	5	13	0	0	13	0	0
10	11805601	.	T	C	2	8	10	0	1	11	0	0
10	11809444	.	A	G	7	6	13	0	0	13	0	0
10	11838927	.	C	T	0	4	4	0	1	5	0	0
10	12517338	.	C	T	1	4	5	0	0	5	0	0
10	12556390	.	C	T	1	4	5	0	0	5	0	0
10	12556417	.	T	A	2	3	5	0	0	5	0	0
10	12616396	.	A	G	2	3	5	0	0	5	0	0
10	12693314	.	A	G	2	0	2	0	2	4	0	0
10	13000879	.	A	G	1	2	3	0	0	3	0	0
10	13000889	.	A	T	1	1	2	0	0	2	0	0
10	13037686	.	A	G	1	0	1	0	3	4	0	0
10	13037899	.	G	A	2	2	4	0	0	4	0	0
10	13038022	.	T	C	5	3	8	0	1	9	0	0
10	13038025	.	A	C	4	4	8	0	1	9	0	0
10	13063611	.	A	T	2	3	5	0	1	6	0	0
10	13063921	.	C	T	3	6	9	0	0	9	0	0
10	13236384	.	A	G	2	2	4	0	2	7	1	0
10	13238028	.	A	G	7	15	22	0	0	22	0	0
10	13238055	.	G	T	6	14	20	0	1	21	0	0
10	13283594	.	C	T	7	6	13	0	1	14	0	0
10	13283729	.	C	T	1	4	5	0	0	5	0	0
10	13283741	.	G	A	0	4	4	0	2	6	0	0
10	13283792	.	T	C	2	3	5	0	1	6	0	0
10	13283891	.	G	A	0	3	3	0	7	10	0	0
10	13286430	.	C	T	10	6	16	0	0	16	0	0
10	13286472	.	T	C	9	5	14	0	0	14	0	0
10	13287031	.	A	C	6	3	9	0	0	9	0	0
10	13460381	.	A	G	3	3	6	0	0	6	0	0
10	13460494	.	A	C	3	8	11	0	2	13	0	0
10	13460671	.	G	A	11	8	19	0	0	19	0	0
10	13460745	.	C	A	0	10	10	0	13	23	0	0
10	13460940	.	A	T	12	16	28	0	1	29	0	0
10	13461080	.	T	C	17	1	18	0	22	40	0	0
10	13461150	.	G	A	12	11	23	0	0	23	0	0
10	13476010	.	A	G	9	12	21	0	1	22	0	0
10	13529270	.	T	C	13	12	25	0	1	26	0	0
10	13536790	.	T	C	6	0	6	0	7	13	0	0
10	14421522	.	G	A	0	1	1	0	0	1	0	0
10	14478899	.	A	G	2	0	2	0	0	2	0	0
10	14488177	.	C	A	1	2	3	0	0	3	0	0
10	14491139	.	C	T	6	3	9	0	1	10	0	0
10	14493798	.	T	C	5	16	21	0	1	22	0	0
10	14493819	.	A	T	9	9	18	0	2	20	0	0
10	14493878	.	G	T	0	10	10	0	16	26	0	0
10	14493967	.	G	C	0	13	13	0	15	28	0	0
10	14494083	.	A	G	4	4	8	0	0	8	0	0
10	14533337	.	G	A	7	6	13	0	0	13	0	0
10	14533352	.	A	G	8	6	14	0	1	15	0	0
10	14542886	.	A	G	10	8	18	0	1	19	0	0
10	14542962	.	G	A	4	4	8	0	0	8	0	0
10	14543044	.	A	T	11	8	19	0	3	22	0	0
10	14543256	.	A	C	8	10	18	0	1	19	0	0
10	14543259	.	G	T	8	9	17	0	2	19	0	0
10	14543307	.	C	T	15	15	30	0	0	30	0	0
10	14545572	.	A	G	14	14	28	0	1	29	0	0
10	14871409	.	T	A	8	8	16	0	3	19	0	0
10	14871412	.	T	A	10	9	19	0	1	20	0	0
10	14871768	.	A	G	16	12	28	0	0	28	0	0
10	14871801	.	A	C	13	12	25	0	0	25	0	0
10	14872258	.	T	G	2	3	5	0	0	5	0	0
10	14872703	.	G	A	8	7	15	0	2	17	0	0
10	14920777	.	G	A	7	1	8	0	0	8	0	0
10	14921086	.	A	C	7	0	7	0	9	16	0	0
10	14929560	.	G	A	15	8	23	0	1	24	0	0
10	15339153	.	G	C	5	2	7	0	0	7	0	0
10	16061731	.	T	C	2	0	2	0	3	5	0	0
10	16307210	.	C	T	2	2	4	0	1	5	0	0
10	16476487	.	T	C	3	2	5	0	2	7	0	0
10	16477575	.	T	C	3	3	6	0	0	6	0	0
10	16477611	.	T	C	3	3	6	0	0	6	0	0
10	16747740	.	A	G	7	1	8	0	2	10	0	0
10	17924546	.	A	G	17	15	32	0	0	32	0	0
10	17924547	.	A	G	19	12	31	0	0	32	1	0
10	17945513	.	A	G	26	8	34	0	1	35	0	0
10	18887819	.	A	G	1	2	3	0	0	3	0	0
10	18906617	.	C	A	7	9	16	0	9	26	1	0
10	18906618	.	A	G	9	9	18	0	8	26	0	0
10	18911166	.	A	G	4	4	8	0	0	8	0	0
10	18930403	.	T	C	6	4	10	0	0	10	0	0
10	18934147	.	T	C	4	3	7	0	0	7	0	0
10	18934215	.	C	A	7	5	12	0	0	12	0	0
10	18934291	.	T	C	7	13	20	0	2	22	0	0
10	18934323	.	A	C	11	12	23	0	2	25	0	0
10	18934499	.	C	T	3	14	17	0	0	17	0	0
10	18934530	.	A	G	1	8	9	0	1	10	0	0
10	18934590	.	A	C	12	10	22	0	1	23	0	0
10	18934634	.	G	T	8	13	21	0	1	22	0	0
10	18934683	.	T	C	10	14	24	0	0	24	0	0
10	18934821	.	A	C	10	11	21	0	1	22	0	0
10	18935246	.	T	C	9	29	38	0	2	40	0	0
10	18935316	.	C	T	16	13	29	0	1	30	0	0
10	18935413	.	C	T	14	13	27	0	0	27	0	0
10	18935430	.	A	T	14	14	28	0	0	28	0	0
10	18935874	.	T	A	6	4	10	0	0	10	0	0
10	18970673	.	C	T	15	8	23	0	1	24	0	0
10	18973079	.	C	T	4	0	4	0	0	4	0	0
10	18973124	.	A	G	7	0	7	0	4	11	0	0
10	18977233	.	G	A	0	1	1	0	4	5	0	0
10	18992413	.	T	C	26	21	47	0	1	48	0	0
10	18999895	.	C	T	2	3	5	0	0	5	0	0
10	19000051	.	A	G	2	2	4	0	1	5	0	0
10	19000191	.	G	A	0	2	2	0	0	2	0	0
10	19005803	.	A	G	2	3	5	0	1	6	0	0
10	19005845	.	A	C	1	2	3	0	0	3	0	0
10	19005965	.	A	C	1	3	4	0	0	4	0	0
10	19005983	.	A	G	1	2	3	0	0	3	0	0
10	19006076	.	G	T	2	2	4	0	0	4	0	0
10	19006154	.	C	G	1	2	3	0	0	3	0	0
10	19017316	.	C	T	1	1	2	0	0	2	0	0
10	19020475	.	A	G	8	3	11	0	0	11	0	0
10	19021192	.	A	G	5	3	8	0	1	9	0	0
10	19021235	.	G	A	0	1	1	0	7	8	0	0
10	19089892	.	A	G	1	2	3	0	0	3	0	0
10	19089906	.	C	T	1	2	3	0	0	3	0	0
10	19339859	.	C	G	7	5	12	0	0	12	0	0
10	19428949	.	T	C	1	5	6	0	0	6	0	0
10	19554673	.	A	T	20	16	36	0	0	37	1	0
10	19562120	.	C	T	6	3	9	0	0	9	0	0
10	19564401	.	G	A	14	22	36	0	0	36	0	0
10	19565771	.	T	C	20	23	43	0	1	44	0	0
10	19565988	.	G	C	33	23	56	0	1	57	0	0
10	19566400	.	T	A	11	11	22	0	1	23	0	0
10	19566445	.	T	C	7	7	14	0	1	15	0	0
10	20080481	.	A	G	0	1	1	0	0	1	0	0
10	20080671	.	C	T	4	3	7	0	0	7	0	0
10	20082038	.	C	T	2	1	3	0	0	3	0	0
10	20083053	.	C	T	1	5	6	0	0	6	0	0
10	20083140	.	A	G	6	1	7	0	0	7	0	0
10	20085200	.	A	C	2	4	6	0	0	6	0	0
10	20087388	.	T	C	0	1	1	0	0	1	0	0
10	20093329	.	G	A	0	3	3	0	3	6	0	0
10	20100205	.	C	T	1	9	10	0	0	10	0	0
10	20100234	.	C	T	5	8	13	0	1	14	0	0
10	20100269	.	A	C	8	8	16	0	1	17	0	0
10	20103242	.	G	T	2	4	6	0	0	6	0	0
10	20103359	.	C	T	9	3	12	0	1	13	0	0
10	20103482	.	C	T	10	5	15	0	0	15	0	0
10	20103639	.	A	G	1	8	9	0	0	9	0	0
10	20105210	.	T	C	4	6	10	0	0	10	0	0
10	20131937	.	G	A	2	1	3	0	0	3	0	0
10	20137862	.	A	G	0	3	3	0	0	3	0	0
10	20140951	.	T	C	2	2	4	0	1	5	0	0
10	20141059	.	A	G	1	1	2	0	3	5	0	0
10	20141099	.	T	A	1	3	4	0	0	4	0	0
10	20143850	.	T	A	2	7	9	0	0	9	0	0
10	20146535	.	C	T	14	31	45	0	2	47	0	0
10	20147452	.	A	G	4	2	6	0	14	20	0	0
10	20158976	.	T	A	3	2	5	0	0	5	0	0
10	20215064	.	G	T	2	2	4	0	0	4	0	0
10	20218342	.	C	G	6	6	12	0	0	12	0	0
10	20233964	.	A	G	23	1	24	0	14	38	0	0
10	20234074	.	C	T	15	18	33	0	6	39	0	0
10	20256640	.	C	G	1	6	7	0	0	7	0	0
10	20276868	.	T	G	1	0	1	0	0	1	0	0
10	20276898	.	A	G	1	1	2	0	0	2	0	0
10	20276904	.	G	A	1	1	2	0	0	2	0	0
10	20287251	.	C	A	0	3	3	0	2	5	0	0
10	20338998	.	G	C	0	1	1	0	0	1	0	0
10	20351930	.	T	C	3	3	6	0	1	7	0	0
10	20351975	.	C	T	1	6	7	0	1	8	0	0
10	20354622	.	A	T	0	1	1	0	0	1	0	0
10	20354633	.	A	T	0	1	1	0	0	1	0	0
10	20368862	.	T	A	10	4	14	0	1	15	0	0
10	20368883	.	C	T	10	5	15	0	0	15	0	0
10	20371402	.	A	T	21	7	28	0	1	29	0	0
10	20371419	.	A	C	23	8	31	0	0	31	0	0
10	20371478	.	C	A	16	18	34	0	1	35	0	0
10	20371675	.	A	T	8	12	20	0	1	21	0	0
10	20393172	.	C	T	3	3	6	0	0	6	0	0
10	20395629	.	T	C	4	9	13	0	1	14	0	0
10	20398930	.	T	C	4	3	7	0	0	7	0	0
10	20401360	.	C	A	2	4	6	0	0	6	0	0
10	20401613	.	C	A	0	3	3	0	0	3	0	0
10	20401649	.	G	T	2	2	4	0	1	5	0	0
10	20401699	.	A	C	1	3	4	0	1	5	0	0
10	20401702	.	C	G	2	3	5	0	0	5	0	0
10	20401813	.	A	G	3	3	6	0	0	6	0	0
10	20468843	.	T	A	6	1	7	0	1	8	0	0
10	20468952	.	G	A	4	7	11	0	0	11	0	0
10	20472614	.	C	T	1	3	4	0	0	4	0	0
10	20472926	.	T	C	13	13	26	0	3	29	0	0
10	20473147	.	C	G	0	9	9	0	11	20	0	0
10	20473366	.	C	T	8	8	16	0	0	16	0	0
10	20473409	.	G	A	7	7	14	0	1	15	0	0
10	20473517	.	G	T	6	9	15	0	1	16	0	0
10	20481653	.	C	T	1	6	7	0	8	15	0	0
10	20481656	.	G	A	8	6	14	0	1	15	0	0
10	20505467	.	T	C	0	0	0	0	3	3	0	0
10	20505679	.	T	G	0	1	1	0	0	1	0	0
10	20508791	.	T	A	1	3	4	0	0	4	0	0
10	20527553	.	G	A	3	4	7	0	0	7	0	0
10	20527639	.	G	A	11	7	18	0	0	18	0	0
10	20527736	.	C	T	0	6	6	0	9	15	0	0
10	20527837	.	C	A	1	16	17	0	10	27	0	0
10	20529450	.	T	C	4	0	4	0	5	9	0	0
10	20543294	.	T	C	7	0	7	0	4	11	0	0
10	20543336	.	G	A	5	11	16	0	0	16	0	0
10	20546530	.	G	A	3	4	7	0	0	7	0	0
10	20546548	.	C	T	2	0	2	0	0	2	0	0
10	20558156	.	G	C	0	1	1	0	0	1	0	0
10	20558270	.	G	A	0	5	5	0	0	5	0	0
10	20558300	.	G	C	1	0	1	0	8	9	0	0
10	20562894	.	C	T	2	2	4	0	0	4	0	0
10	20565260	.	C	T	1	4	5	0	7	12	0	0
10	20583799	.	C	T	5	7	12	0	1	13	0	0
10	20586604	.	A	G	4	3	7	0	0	7	0	0
10	20586613	.	A	T	4	4	8	0	0	8	0	0
10	20590317	.	T	C	10	10	20	0	0	20	0	0
10	20590372	.	T	A	10	11	21	0	2	23	0	0
10	20590436	.	A	C	8	14	22	0	1	23	0	0
10	20590461	.	G	T	10	18	28	0	2	30	0	0
10	20590547	.	T	C	5	8	13	0	0	13	0	0
10	20590569	.	C	T	3	2	5	0	0	5	0	0
10	20592420	.	C	T	10	12	22	0	1	23	0	0
10	20598177	.	C	A	3	1	4	0	0	4	0	0
10	20598267	.	A	G	4	4	8	0	0	8	0	0
10	20598270	.	G	A	4	3	7	0	0	7	0	0
10	20604548	.	A	G	8	12	20	0	1	21	0	0
10	20604555	.	T	C	9	12	21	0	3	24	0	0
10	20604703	.	G	T	7	12	19	0	0	19	0	0
10	20605171	.	A	T	12	9	21	0	2	23	0	0
10	20636027	.	C	T	8	18	26	0	1	27	0	0
10	20636168	.	A	T	16	15	31	0	2	33	0	0
10	20636177	.	G	T	20	12	32	0	2	34	0	0
10	20636273	.	T	C	13	0	13	0	13	26	0	0
10	20636346	.	T	C	5	10	15	0	1	16	0	0
10	20636479	.	T	C	3	10	13	1	1	15	0	0
10	20636542	.	G	A	11	4	15	0	0	15	0	0
10	20636600	.	T	C	4	0	4	0	2	6	0	0
10	20920664	.	A	G	12	5	17	0	2	19	0	0
10	20971685	.	A	G	9	4	13	0	0	13	0	0
10	21043902	.	G	A	3	9	12	0	3	15	0	0
10	21044286	.	A	G	2	3	5	0	0	5	0	0
10	21044316	.	A	G	1	6	7	0	0	7	0	0
10	21044337	.	T	C	3	0	3	0	6	9	0	0
10	21044361	.	A	T	3	7	10	0	1	11	0	0
10	21044385	.	G	T	4	8	12	0	0	12	0	0
10	21045123	.	A	T	12	4	16	0	0	16	0	0
10	21045126	.	T	C	12	0	12	0	4	16	0	0
10	21046033	.	C	T	0	2	2	0	0	2	0	0
10	21046442	.	G	A	5	8	13	0	0	13	0	0
10	21046493	.	T	C	6	6	12	0	2	14	0	0
10	21053520	.	G	C	2	3	5	0	0	5	0	0
10	21436810	.	T	C	3	7	10	0	0	10	0	0
10	21437255	.	A	G	3	0	3	0	6	9	0	0
10	21442229	.	T	C	0	0	0	0	1	1	0	0
10	21443135	.	G	A	0	10	10	0	12	22	0	0
10	21443193	.	T	G	15	12	27	0	1	28	0	0
10	21443347	.	T	A	5	7	12	0	0	12	0	0
10	21452340	.	T	C	5	4	9	0	0	9	0	0
10	21452376	.	G	A	0	8	8	0	9	17	0	0
10	21452403	.	G	A	8	13	21	0	1	22	0	0
10	21459017	.	G	A	0	9	9	0	9	18	0	0
10	21459439	.	G	A	9	11	20	0	0	20	0	0
10	21462612	.	T	C	9	4	13	0	0	13	0	0
10	21470192	.	G	A	0	12	12	0	9	21	0	0
10	21471710	.	C	T	2	2	4	0	0	4	0	0
10	21473938	.	A	T	2	2	4	0	0	4	0	0
10	21523624	.	A	C	6	7	13	0	1	14	0	0
10	21523639	.	C	T	8	5	13	0	0	13	0	0
10	21524679	.	G	A	10	6	16	0	1	17	0	0
10	21524682	.	G	A	10	6	16	0	1	17	0	0
10	21524919	.	C	G	8	0	8	0	9	18	1	0
10	21525243	.	A	G	11	6	17	0	0	17	0	0
10	21525276	.	T	A	12	8	20	0	0	20	0	0
10	21559809	.	G	T	0	3	3	0	1	4	0	0
10	21564230	.	A	G	1	2	3	0	0	3	0	0
10	21646033	.	C	T	17	21	38	0	1	39	0	0
10	21646621	.	C	T	31	23	54	0	3	57	0	0
10	21646668	.	T	A	32	22	54	0	2	56	0	0
10	21646797	.	C	T	22	24	46	0	1	47	0	0
10	21646802	.	A	G	21	24	45	0	1	46	0	0
10	21646844	.	A	G	21	21	42	0	2	44	0	0
10	21647241	.	T	G	23	26	49	0	0	49	0	0
10	21647291	.	G	A	0	23	23	0	23	46	0	0
10	21647691	.	G	A	23	30	53	0	2	55	0	0
10	21652148	.	C	A	2	2	4	0	0	4	0	0
10	21658567	.	G	A	4	3	7	0	0	7	0	0
10	21659134	.	A	G	1	2	3	0	1	4	0	0
10	21677891	.	A	T	2	2	4	0	0	4	0	0
10	21679442	.	T	C	5	1	6	0	0	6	0	0
10	21679496	.	G	A	2	1	3	0	0	3	0	0
10	21679497	.	C	A	2	1	3	0	0	3	0	0
10	21701576	.	T	C	2	2	4	0	0	4	0	0
10	21702304	.	A	T	3	2	5	0	0	5	0	0
10	21702544	.	T	C	2	3	5	0	1	6	0	0
10	21702685	.	T	A	4	3	7	0	0	7	0	0
10	21702770	.	A	G	3	2	5	0	0	5	0	0
10	21702846	.	A	G	2	2	4	0	0	4	0	0
10	21704073	.	G	T	4	3	7	0	0	7	0	0
10	21704090	.	A	G	4	0	4	0	0	4	0	0
10	21720833	.	A	G	2	1	3	0	0	3	0	0
10	21720867	.	G	A	0	1	1	0	0	1	0	0
10	21723092	.	A	T	1	3	4	0	0	4	0	0
10	21723140	.	A	G	1	2	3	0	0	3	0	0
10	21723263	.	C	A	1	6	7	0	0	7	0	0
10	21723293	.	C	T	2	5	7	0	0	7	0	0
10	21723536	.	A	G	1	0	1	0	4	5	0	0
10	21723656	.	C	T	2	4	6	0	0	6	0	0
10	21723674	.	G	A	1	4	5	0	0	5	0	0
10	21723932	.	T	A	3	5	8	0	0	8	0	0
10	21723962	.	T	C	1	3	4	0	0	4	0	0
10	21724095	.	A	T	1	3	4	0	0	4	0	0
10	21724154	.	C	T	1	3	4	0	0	4	0	0
10	21729191	.	T	C	0	5	5	0	0	5	0	0
10	21778321	.	G	A	1	3	4	0	0	4	0	0
10	21778980	.	C	T	5	3	8	2	0	10	0	0
10	21780612	.	A	G	2	10	12	0	0	15	3	0
10	21780615	.	A	C	2	12	14	0	0	14	0	0
10	21781308	.	A	G	2	0	2	0	1	3	0	0
10	21781313	.	C	T	4	0	4	0	0	4	0	0
10	21781677	.	G	A	0	12	12	0	9	21	0	0
10	21781710	.	T	C	10	13	23	0	1	24	0	0
10	21781722	.	G	C	3	19	22	0	1	25	2	0
10	21783252	.	C	T	11	11	22	0	0	22	0	0
10	21783727	.	C	A	11	14	25	0	0	25	0	0
10	21783733	.	T	C	10	15	25	0	0	25	0	0
10	21784071	.	T	C	10	7	17	0	1	18	0	0
10	21784130	.	G	T	0	8	8	0	10	18	0	0
10	21784132	.	C	T	9	9	18	0	0	18	0	0
10	21784186	.	A	G	7	15	22	0	1	23	0	0
10	21785677	.	C	T	8	7	15	0	1	16	0	0
10	21786705	.	G	A	10	4	14	1	1	16	0	0
10	21786713	.	G	A	9	5	14	1	0	15	0	0
10	21786792	.	C	A	11	4	15	0	0	15	0	0
10	21786817	.	G	A	8	3	11	0	1	12	0	0
10	21786832	.	C	T	9	3	12	0	0	12	0	0
10	21787255	.	A	T	2	4	6	0	0	6	0	0
10	21788022	.	A	G	9	4	13	0	0	13	0	0
10	21788038	.	T	C	9	4	13	0	0	13	0	0
10	21788254	.	C	T	0	2	2	0	0	2	0	0
10	21790076	.	A	C	7	8	15	0	0	15	0	0
10	21790121	.	C	A	12	6	18	0	1	19	0	0
10	21790137	.	G	A	12	6	18	0	2	20	0	0
10	21790295	.	A	T	4	2	6	0	0	6	0	0
10	21790323	.	G	A	2	4	6	0	0	6	0	0
10	21790648	.	T	C	8	6	14	0	0	14	0	0
10	21790769	.	A	G	9	0	9	0	5	14	0	0
10	21790775	.	A	C	10	3	13	0	1	14	0	0
10	21790934	.	T	C	8	9	17	0	0	17	0	0
10	21791090	.	G	A	10	12	22	0	0	22	0	0
10	21791375	.	G	A	13	9	22	0	1	23	0	0
10	21791552	.	G	T	6	5	11	0	0	11	0	0
10	21794285	.	G	A	3	6	9	0	0	9	0	0
10	21794302	.	G	A	0	5	5	0	3	8	0	0
10	21794410	.	T	A	5	5	10	0	0	11	1	0
10	21794598	.	A	C	8	6	14	0	0	14	0	0
10	21794797	.	A	C	3	6	9	0	0	9	0	0
10	21794800	.	A	T	3	6	9	0	1	10	0	0
10	21795065	.	C	T	6	3	9	0	1	10	0	0
10	21795190	.	T	A	4	3	7	0	0	7	0	0
10	21795216	.	G	C	3	3	6	0	0	6	0	0
10	21795337	.	C	T	1	3	4	0	0	4	0	0
10	21795655	.	A	T	2	10	12	0	0	13	1	0
10	21795805	.	G	A	6	6	12	0	0	12	0	0
10	21797164	.	G	A	0	2	2	0	4	6	0	0
10	21797207	.	G	C	14	7	21	0	1	22	0	0
10	21797247	.	C	A	12	4	16	0	1	17	0	0
10	21798215	.	C	A	5	4	9	0	0	9	0	0
10	21798372	.	G	A	4	3	7	0	0	7	0	0
10	21798571	.	C	A	6	4	10	0	1	11	0	0
10	21799320	.	A	C	6	2	8	0	0	8	0	0
10	21801256	.	C	G	7	4	11	0	1	12	0	0
10	21801267	.	C	T	8	5	13	0	2	15	0	0
10	21801339	.	T	G	5	0	5	0	6	11	0	0
10	21801352	.	T	C	7	6	13	0	0	13	0	0
10	21801573	.	C	T	4	5	9	0	0	9	0	0
10	21801590	.	A	C	4	4	8	0	0	8	0	0
10	21801611	.	G	T	3	3	6	0	0	6	0	0
10	21801718	.	G	A	0	11	11	0	10	21	0	0
10	21801856	.	C	T	5	13	18	0	0	18	0	0
10	21802057	.	A	G	8	4	12	0	1	13	0	0
10	21802086	.	A	G	6	6	12	0	1	13	0	0
10	21802291	.	C	T	7	8	15	0	3	18	0	0
10	21802326	.	C	A	8	8	16	0	0	16	0	0
10	21802355	.	C	A	5	5	10	0	1	11	0	0
10	21802380	.	G	A	0	4	4	0	4	8	0	0
10	21802539	.	C	T	7	2	9	0	0	9	0	0
10	21802661	.	C	T	8	11	19	0	1	20	0	0
10	21802701	.	A	T	5	5	10	0	0	10	0	0
10	21802713	.	T	C	1	3	4	0	0	4	0	0
10	21802959	.	T	C	10	11	21	0	1	22	0	0
10	21802989	.	T	C	10	11	21	0	1	22	0	0
10	21803004	.	G	A	11	8	19	0	1	20	0	0
10	21803031	.	G	A	3	2	5	0	0	5	0	0
10	21804785	.	G	T	0	5	5	0	3	8	0	0
10	21804786	.	G	T	2	5	7	0	1	8	0	0
10	21805019	.	A	T	2	3	5	0	0	5	0	0
10	21805020	.	A	C	2	3	5	0	0	5	0	0
10	21805085	.	A	C	1	3	4	0	1	5	0	0
10	21805090	.	G	A	1	3	4	0	2	6	0	0
10	21805762	.	C	T	6	6	12	0	0	12	0	0
10	21805900	.	G	A	0	2	2	0	8	10	0	0
10	21805942	.	G	T	0	3	3	0	5	8	0	0
10	21806060	.	G	A	3	3	6	0	0	6	0	0
10	21806789	.	G	A	4	8	12	0	0	12	0	0
10	21808897	.	G	A	1	3	4	0	0	4	0	0
10	21809227	.	T	C	1	2	3	0	0	3	0	0
10	21809253	.	C	A	2	3	5	0	0	5	0	0
10	21809314	.	A	G	1	2	3	0	0	3	0	0
10	21818522	.	C	T	49	33	82	0	1	83	0	0
10	21818595	.	T	G	36	31	67	0	0	67	0	0
10	21818762	.	A	C	21	24	45	0	1	46	0	0
10	21818916	.	C	T	27	28	55	0	2	57	0	0
10	21819019	.	G	A	1	24	25	0	28	53	0	0
10	21819038	.	C	A	31	26	57	0	1	58	0	0
10	21819105	.	G	T	20	28	48	0	1	49	0	0
10	21819214	.	G	C	30	28	58	0	1	59	0	0
10	21819523	.	T	A	26	31	57	0	0	58	1	0
10	21819577	.	C	T	25	33	58	0	4	62	0	0
10	21819653	.	T	C	36	36	72	0	2	74	0	0
10	21819772	.	T	C	25	36	61	0	2	63	0	0
10	21819966	.	A	T	5	5	10	0	0	10	0	0
10	21872639	.	A	G	3	3	6	0	0	6	0	0
10	21914928	.	A	G	1	2	3	0	0	3	0	0
10	21943777	.	G	T	3	2	5	0	0	5	0	0
10	21944067	.	T	C	0	1	1	0	0	1	0	0
10	21944950	.	C	T	1	3	4	0	0	4	0	0
10	21947511	.	G	A	1	2	3	0	0	3	0	0
10	22012534	.	G	A	8	8	16	0	1	17	0	0
10	22030798	.	C	T	10	11	21	0	0	21	0	0
10	22030881	.	A	T	19	18	37	0	1	38	0	0
10	22031375	.	A	C	12	24	36	0	0	36	0	0
10	22031493	.	G	A	28	22	50	0	0	50	0	0
10	22031572	.	A	G	20	27	47	0	0	47	0	0
10	22031635	.	A	G	15	22	37	0	1	38	0	0
10	22031666	.	A	G	16	13	29	0	1	30	0	0
10	22031755	.	T	C	19	17	36	0	0	36	0	0
10	22031759	.	T	C	18	16	34	0	1	35	0	0
10	22031854	.	G	A	10	13	23	0	0	23	0	0
10	22035638	.	A	G	0	2	2	0	0	2	0	0
10	22036235	.	T	A	2	0	2	0	0	2	0	0
10	22041529	.	G	A	2	1	3	0	0	3	0	0
10	22041717	.	T	C	0	2	2	0	0	2	0	0
10	22044699	.	G	A	8	7	15	0	0	15	0	0
10	22044921	.	T	G	7	3	10	0	1	11	0	0
10	22044982	.	C	T	4	4	8	0	1	9	0	0
10	22045014	.	G	T	5	4	9	0	0	9	0	0
10	22052247	.	C	T	0	2	2	0	2	4	0	0
10	22054106	.	G	A	1	2	3	0	0	3	0	0
10	22056845	.	C	T	4	2	6	0	0	6	0	0
10	22162575	.	G	A	9	4	13	0	0	13	0	0
10	22163002	.	G	T	4	5	9	0	0	9	0	0
10	22381984	.	A	T	7	3	10	0	1	11	0	0
10	22382167	.	G	A	1	6	7	0	11	18	0	0
10	22382427	.	T	C	9	3	12	0	1	13	0	0
10	22471425	.	C	A	5	4	9	0	0	9	0	0
10	22475679	.	C	A	9	5	14	0	2	16	0	0
10	22475799	.	G	A	0	10	10	0	9	19	0	0
10	22476535	.	C	T	6	5	11	0	1	12	0	0
10	22477229	.	A	G	4	8	12	0	1	13	0	0
10	22477610	.	A	G	11	0	11	0	6	17	0	0
10	22477661	.	C	T	7	7	14	0	0	14	0	0
10	22477880	.	A	G	13	0	13	0	12	25	0	0
10	22510354	.	C	A	1	3	4	0	0	4	0	0
10	22510577	.	C	A	2	4	6	0	3	9	0	0
10	22516643	.	C	G	11	7	18	0	1	19	0	0
10	22516710	.	G	A	6	8	14	0	0	14	0	0
10	22516876	.	A	T	2	2	4	0	0	4	0	0
10	22516903	.	A	G	3	4	7	0	0	7	0	0
10	22516957	.	T	C	3	5	8	0	0	8	0	0
10	22518237	.	G	A	0	13	13	0	10	23	0	0
10	22518267	.	T	A	9	16	25	0	0	25	0	0
10	22525652	.	G	A	2	1	3	0	2	5	0	0
10	22528077	.	C	T	1	5	6	0	0	6	0	0
10	22529683	.	G	A	0	2	2	0	2	4	0	0
10	22530043	.	C	T	3	9	12	0	0	12	0	0
10	22530058	.	A	C	3	13	16	0	0	16	0	0
10	22530136	.	A	G	3	0	3	0	3	6	0	0
10	22530812	.	T	C	6	7	13	0	1	14	0	0
10	22531003	.	T	A	4	6	10	0	0	10	0	0
10	22531189	.	A	T	5	2	7	0	0	7	0	0
10	22531472	.	T	C	6	12	18	0	0	18	0	0
10	22531906	.	A	C	16	5	21	0	0	21	0	0
10	22531912	.	G	A	15	5	20	0	1	21	0	0
10	22532133	.	G	T	4	6	10	0	0	10	0	0
10	22532316	.	G	A	12	14	26	0	2	28	0	0
10	22532347	.	C	T	7	10	17	0	1	18	0	0
10	22532547	.	T	A	20	5	25	0	1	26	0	0
10	22532610	.	A	T	11	17	28	0	0	28	0	0
10	22532817	.	C	G	21	14	35	0	0	36	1	0
10	22605394	.	T	A	1	2	3	0	0	3	0	0
10	22745285	.	T	C	3	6	9	0	0	9	0	0
10	22745661	.	C	T	9	6	15	0	1	16	0	0
10	22747289	.	G	C	0	7	7	0	9	16	0	0
10	22747913	.	T	C	6	6	12	0	0	12	0	0
10	22748442	.	G	T	1	3	4	0	0	4	0	0
10	22748834	.	A	G	3	3	6	0	0	6	0	0
10	22748964	.	G	C	5	3	8	0	0	8	0	0
10	22749466	.	T	C	1	9	10	0	0	10	0	0
10	22749623	.	C	T	4	5	9	0	0	9	0	0
10	22749681	.	G	A	5	3	8	0	1	9	0	0
10	22751095	.	G	A	3	4	7	0	0	7	0	0
10	22753455	.	G	A	4	4	8	0	0	8	0	0
10	22753883	.	A	C	3	5	8	0	1	9	0	0
10	22755164	.	C	T	2	4	6	0	0	6	0	0
10	22758016	.	G	A	4	2	6	0	1	7	0	0
10	22758094	.	A	G	5	0	5	0	3	8	0	0
10	22758303	.	A	G	2	2	4	0	1	5	0	0
10	22758481	.	A	G	7	0	7	0	3	10	0	0
10	22760653	.	G	T	9	3	12	0	1	13	0	0
10	22760658	.	A	C	5	5	10	0	1	11	0	0
10	22786128	.	T	A	9	8	17	0	0	17	0	0
10	22786227	.	C	T	2	5	7	0	0	7	0	0
10	22789534	.	T	C	1	0	1	0	3	4	0	0
10	22789733	.	G	A	2	2	4	0	0	4	0	0
10	22811406	.	T	C	2	0	2	0	3	5	0	0
10	22811621	.	A	C	5	0	5	0	11	16	0	0
10	22812500	.	A	T	4	4	8	0	0	8	0	0
10	22814750	.	G	A	3	3	6	0	0	6	0	0
10	22819508	.	T	C	3	0	3	0	2	5	0	0
10	22831410	.	T	A	4	2	6	0	0	6	0	0
10	22838530	.	C	T	2	22	24	0	33	57	0	0
10	22841955	.	G	T	13	7	20	0	2	22	0	0
10	22845293	.	C	T	0	17	17	0	15	32	0	0
10	22855033	.	G	T	7	3	10	0	0	10	0	0
10	22856192	.	G	C	1	0	1	0	0	1	0	0
10	22856201	.	T	C	1	0	1	0	0	1	0	0
10	22861834	.	A	G	6	5	11	0	0	11	0	0
10	22861836	.	C	T	6	5	11	0	0	11	0	0
10	22861945	.	T	G	3	3	6	0	0	6	0	0
10	22861947	.	A	G	3	3	6	0	0	6	0	0
10	22893992	.	A	G	8	4	12	0	0	12	0	0
10	22894100	.	G	A	2	3	5	0	1	6	0	0
10	22895312	.	T	C	3	3	6	0	0	6	0	0
10	22895327	.	T	C	3	3	6	0	1	7	0	0
10	22896782	.	C	A	4	0	4	0	1	5	0	0
10	22896950	.	C	T	2	0	2	0	0	2	0	0
10	22896959	.	G	A	0	0	0	0	2	2	0	0
10	22897187	.	C	T	5	5	10	0	1	11	0	0
10	22906434	.	C	T	3	1	4	0	0	4	0	0
10	22906844	.	C	T	9	11	20	0	0	20	0	0
10	22912283	.	G	T	0	1	1	0	0	1	0	0
10	22912547	.	C	T	1	0	1	0	0	1	0	0
10	22915875	.	A	G	2	5	7	0	1	8	0	0
10	22915897	.	G	A	3	4	7	0	0	7	0	0
10	22915914	.	C	A	2	3	5	0	0	5	0	0
10	22915993	.	T	C	2	2	4	0	0	4	0	0
10	22916324	.	A	G	17	22	39	0	6	45	0	0
10	22916339	.	A	G	14	20	34	0	2	36	0	0
10	22916422	.	A	C	17	35	52	0	1	53	0	0
10	22916426	.	T	A	16	34	50	0	1	51	0	0
10	22916664	.	C	T	28	23	51	0	7	58	0	0
10	22916730	.	A	G	22	23	45	0	0	45	0	0
10	22918164	.	T	C	37	15	52	0	1	53	0	0
10	22918190	.	C	T	18	13	31	0	0	31	0	0
10	22918214	.	T	G	4	9	13	0	0	13	0	0
10	22922089	.	A	G	1	0	1	0	4	5	0	0
10	22924978	.	A	C	4	12	16	0	1	17	0	0
10	22925049	.	G	A	0	10	10	0	11	21	0	0
10	22925851	.	T	C	2	2	4	0	0	4	0	0
10	22925983	.	A	C	3	3	6	0	0	6	0	0
10	22955718	.	A	G	2	5	7	0	1	8	0	0
10	23024405	.	T	C	13	11	24	0	0	24	0	0
10	23024660	.	A	G	16	18	34	0	1	35	0	0
10	23024708	.	T	C	22	17	39	0	0	39	0	0
10	23024762	.	A	G	22	14	36	0	0	36	0	0
10	23060740	.	G	A	2	2	4	0	0	4	0	0
10	23061326	.	G	A	0	4	4	0	7	11	0	0
10	23065777	.	T	C	8	4	12	0	0	12	0	0
10	23068553	.	G	T	9	7	16	0	0	16	0	0
10	23068630	.	A	G	5	15	20	0	0	20	0	0
10	23068907	.	T	G	10	11	21	0	0	21	0	0
10	23068962	.	A	G	9	14	23	0	0	23	0	0
10	23068963	.	C	T	9	14	23	0	0	23	0	0
10	23069253	.	T	C	4	6	10	0	0	10	0	0
10	23071322	.	G	A	3	3	6	0	0	6	0	0
10	23071524	.	G	T	10	3	13	0	0	13	0	0
10	23071619	.	A	G	4	6	10	0	0	10	0	0
10	23071697	.	G	A	1	1	2	0	0	2	0	0
10	23076290	.	A	G	3	2	5	0	1	6	0	0
10	23076306	.	T	C	2	2	4	0	0	4	0	0
10	23076327	.	G	A	3	5	8	0	0	8	0	0
10	23118829	.	G	A	0	1	1	0	0	1	0	0
10	23122855	.	T	C	1	1	2	0	0	2	0	0
10	23126558	.	T	C	0	1	1	0	0	1	0	0
10	23131977	.	C	A	2	0	2	0	0	2	0	0
10	23138428	.	G	A	0	2	2	0	5	7	0	0
10	23138486	.	A	G	2	3	5	0	0	5	0	0
10	23139020	.	A	G	1	1	2	0	0	2	0	0
10	23220533	.	A	G	6	5	11	0	1	12	0	0
10	23275265	.	G	A	3	9	12	0	1	13	0	0
10	23358248	.	C	T	0	2	2	0	4	6	0	0
10	24304492	.	C	A	1	2	3	0	0	3	0	0
10	24304497	.	T	G	1	2	3	0	0	3	0	0
10	24325590	.	C	T	2	1	3	0	0	3	0	0
10	24334999	.	T	G	4	3	7	0	0	7	0	0
10	24373429	.	T	A	3	2	5	0	0	5	0	0
10	24373647	.	C	T	1	2	3	0	0	3	0	0
10	24373657	.	A	C	2	2	4	0	1	5	0	0
10	24374895	.	A	G	2	1	3	0	0	3	0	0
10	24422052	.	C	T	9	7	16	0	0	16	0	0
10	24422070	.	T	A	10	8	18	0	1	19	0	0
10	24422236	.	C	T	13	11	24	0	1	25	0	0
10	24425257	.	A	G	9	13	22	0	0	22	0	0
10	24426924	.	A	G	7	4	11	0	0	11	0	0
10	24427010	.	G	C	4	7	11	0	0	11	0	0
10	24429282	.	A	C	4	4	8	0	2	10	0	0
10	24429342	.	T	C	4	6	10	0	0	10	0	0
10	24429386	.	C	T	2	5	7	0	2	9	0	0
10	24431719	.	A	T	15	9	24	0	0	24	0	0
10	24431795	.	T	C	2	0	2	0	0	2	0	0
10	24431807	.	C	T	1	0	1	0	0	1	0	0
10	24437128	.	A	G	3	2	5	0	0	5	0	0
10	24441916	.	C	T	7	7	14	0	3	17	0	0
10	24442466	.	C	T	4	9	13	0	0	13	0	0
10	24442490	.	A	G	1	0	1	0	6	7	0	0
10	24563892	.	T	G	3	13	16	0	0	16	0	0
10	24564935	.	C	A	6	8	14	0	0	14	0	0
10	24565137	.	G	A	0	16	16	0	11	27	0	0
10	24565139	.	A	T	11	15	26	0	1	27	0	0
10	24566124	.	T	C	8	9	17	0	0	17	0	0
10	24600128	.	A	G	9	8	17	0	3	20	0	0
10	24609175	.	G	A	3	2	5	0	0	5	0	0
10	24614636	.	A	G	3	0	3	0	1	4	0	0
10	24614707	.	A	G	5	8	13	0	0	13	0	0
10	24614709	.	T	G	4	8	12	0	1	13	0	0
10	24616839	.	C	A	2	4	6	0	0	6	0	0
10	24617156	.	G	A	5	5	10	0	1	11	0	0
10	24617624	.	G	A	0	2	2	0	0	2	0	0
10	24621354	.	A	G	13	11	24	0	1	25	0	0
10	24621534	.	T	A	13	11	24	0	2	26	0	0
10	24621722	.	C	G	2	3	5	0	0	5	0	0
10	24621730	.	A	T	1	3	4	0	1	5	0	0
10	24621757	.	T	A	2	7	9	0	0	9	0	0
10	24650192	.	A	G	2	2	4	0	0	4	0	0
10	24652174	.	A	T	1	1	2	0	0	2	0	0
10	24654142	.	A	C	7	0	7	0	11	18	0	0
10	24654319	.	A	C	6	6	12	0	1	13	0	0
10	24654376	.	G	T	5	3	8	0	1	9	0	0
10	24654906	.	T	C	6	0	6	0	6	12	0	0
10	24659337	.	T	C	1	1	2	0	0	2	0	0
10	24659361	.	A	T	2	1	3	0	0	3	0	0
10	24662393	.	G	A	1	1	2	0	0	2	0	0
10	24677136	.	T	G	3	3	6	0	0	6	0	0
10	24687044	.	T	C	1	2	3	0	0	3	0	0
10	24707740	.	G	C	2	2	4	0	0	4	0	0
10	24710172	.	T	C	3	3	6	0	0	6	0	0
10	24710173	.	T	C	4	2	6	0	0	6	0	0
10	24710977	.	G	A	3	4	7	0	1	8	0	0
10	24720889	.	C	T	0	4	4	0	1	5	0	0
10	24724011	.	C	A	1	2	3	0	0	3	0	0
10	24725871	.	C	A	5	6	11	0	1	12	0	0
10	24726211	.	T	A	5	2	7	0	1	8	0	0
10	24726264	.	G	A	1	4	5	0	1	6	0	0
10	24726302	.	A	G	2	2	4	0	0	4	0	0
10	24726440	.	A	G	3	3	6	0	0	6	0	0
10	24726712	.	T	G	3	3	6	0	0	6	0	0
10	24726809	.	A	G	6	7	13	0	0	13	0	0
10	24753217	.	G	A	2	2	4	0	0	4	0	0
10	24762402	.	C	A	8	4	12	0	0	12	0	0
10	24762462	.	T	C	5	0	5	0	5	10	0	0
10	24762543	.	G	A	6	3	9	0	1	10	0	0
10	24762553	.	G	A	6	4	10	0	1	11	0	0
10	24762623	.	T	C	10	4	14	0	0	14	0	0
10	24762707	.	T	C	6	0	6	0	6	12	0	0
10	24762723	.	A	G	5	6	11	0	1	12	0	0
10	24762774	.	T	G	9	9	18	0	0	18	0	0
10	25035588	.	G	T	1	5	6	0	0	6	0	0
10	25035589	.	G	A	1	5	6	0	0	6	0	0
10	25152315	.	G	A	2	3	5	0	0	5	0	0
10	25205354	.	A	C	6	10	16	0	0	16	0	0
10	25209612	.	G	A	5	5	10	0	0	10	0	0
10	25210125	.	C	A	6	10	16	0	0	16	0	0
10	25214346	.	C	G	2	2	4	0	0	4	0	0
10	25214627	.	C	T	3	2	5	0	0	5	0	0
10	25214648	.	G	T	0	3	3	0	2	5	0	0
10	25222392	.	G	T	6	3	9	0	0	10	1	0
10	25232341	.	G	A	0	0	0	0	4	4	0	0
10	25250373	.	C	T	0	0	0	2	0	2	0	0
10	25252474	.	C	T	4	10	14	0	1	15	0	0
10	25262150	.	T	A	5	9	14	0	1	15	0	0
10	25262279	.	C	T	12	15	27	0	0	27	0	0
10	25262336	.	C	T	2	2	4	0	0	4	0	0
10	25269245	.	C	T	12	8	20	0	1	21	0	0
10	25269310	.	G	T	25	6	31	0	0	31	0	0
10	25269325	.	T	G	24	8	32	0	1	33	0	0
10	25269492	.	A	G	15	0	15	0	15	30	0	0
10	25269599	.	C	T	22	17	39	0	1	40	0	0
10	25269742	.	C	T	5	23	28	0	2	30	0	0
10	25269747	.	T	A	23	3	26	0	1	27	0	0
10	25269901	.	T	C	0	25	25	0	2	27	0	0
10	25269983	.	A	G	9	12	21	0	2	23	0	0
10	25270096	.	T	C	14	12	26	0	0	26	0	0
10	25270166	.	A	G	17	8	25	0	2	27	0	0
10	25270643	.	A	G	26	8	34	0	1	35	0	0
10	25270803	.	A	T	11	21	32	0	5	37	0	0
10	25270958	.	C	T	10	15	25	0	0	25	0	0
10	25271323	.	A	G	14	6	20	0	3	23	0	0
10	25312733	.	T	G	6	9	15	0	0	15	0	0
10	25312879	.	T	A	7	4	11	0	1	12	0	0
10	25328680	.	A	T	0	4	4	0	0	4	0	0
10	25328686	.	A	G	1	4	5	0	0	5	0	0
10	25329811	.	C	A	0	7	7	0	10	17	0	0
10	25330646	.	G	A	15	21	36	0	0	36	0	0
10	25338762	.	G	A	9	15	24	0	1	25	0	0
10	25383637	.	G	A	1	2	3	0	0	3	0	0
10	25384133	.	A	G	2	2	4	0	1	5	0	0
10	25403139	.	G	A	5	5	10	0	0	10	0	0
10	25403280	.	C	G	0	7	7	0	3	10	0	0
10	25403402	.	C	T	2	7	9	0	3	12	0	0
10	25410276	.	T	C	3	0	3	0	10	13	0	0
10	25410288	.	A	G	6	8	14	0	0	14	0	0
10	25410389	.	A	G	4	2	6	0	0	6	0	0
10	25435194	.	A	G	3	4	7	0	0	7	0	0
10	25436452	.	A	G	1	4	5	0	0	5	0	0
10	25436557	.	C	T	0	1	1	0	0	1	0	0
10	25461335	.	C	T	0	4	4	0	3	7	0	0
10	25525853	.	G	A	3	1	4	0	0	4	0	0
10	25573218	.	A	G	8	8	16	0	0	16	0	0
10	25573333	.	G	A	6	11	17	0	1	18	0	0
10	25573365	.	C	A	7	10	17	0	0	17	0	0
10	25574159	.	T	C	7	13	20	0	0	20	0	0
10	25574181	.	C	T	0	12	12	0	7	19	0	0
10	25574316	.	A	G	11	5	16	0	0	16	0	0
10	25580370	.	T	C	3	5	8	0	0	8	0	0
10	25582029	.	A	G	5	4	9	0	1	10	0	0
10	25582074	.	G	T	1	6	7	0	0	7	0	0
10	25582656	.	C	T	4	3	7	0	0	7	0	0
10	25582920	.	T	C	2	5	7	0	0	7	0	0
10	25585179	.	A	G	7	7	14	0	0	14	0	0
10	25600712	.	A	G	3	5	8	0	1	9	0	0
10	25601799	.	T	C	4	3	7	0	0	7	0	0
10	25608132	.	T	C	2	1	3	0	0	3	0	0
10	25608133	.	C	T	2	1	3	0	0	3	0	0
10	25615597	.	A	G	0	1	1	0	0	1	0	0
10	25620868	.	A	T	4	1	5	0	1	6	0	0
10	25623600	.	C	T	1	2	3	0	0	3	0	0
10	25625001	.	C	T	1	5	6	0	0	6	0	0
10	25625266	.	C	T	2	5	7	0	0	7	0	0
10	25694920	.	G	A	2	4	6	0	0	6	0	0
10	25697655	.	A	G	10	9	19	0	2	21	0	0
10	25697715	.	G	C	9	7	16	0	0	16	0	0
10	25701659	.	G	C	11	13	24	0	0	24	0	0
10	25701673	.	T	A	10	12	22	0	4	26	0	0
10	25704345	.	C	T	1	3	4	0	2	6	0	0
10	25706228	.	G	A	2	4	6	0	0	6	0	0
10	25709379	.	A	G	1	2	3	0	0	3	0	0
10	25709764	.	T	A	1	1	2	0	0	2	0	0
10	25829724	.	C	T	0	2	2	0	2	4	0	0
10	25830373	.	A	G	4	5	9	0	0	9	0	0
10	25830544	.	T	G	5	13	18	0	1	19	0	0
10	25830687	.	A	G	4	6	10	0	0	10	0	0
10	25830723	.	T	G	2	4	6	0	1	7	0	0
10	25834681	.	G	C	1	0	1	0	2	3	0	0
10	25834684	.	A	G	1	2	3	0	0	3	0	0
10	25837613	.	A	G	3	4	7	0	1	8	0	0
10	25840993	.	C	T	1	2	3	0	0	3	0	0
10	25841059	.	T	C	2	6	8	0	0	8	0	0
10	25841242	.	G	A	6	5	11	0	0	11	0	0
10	25852305	.	T	G	1	6	7	0	0	7	0	0
10	25960676	.	A	C	11	11	22	0	1	23	0	0
10	25960718	.	T	C	15	4	19	0	2	21	0	0
10	25960728	.	G	T	14	5	19	0	1	20	0	0
10	25961396	.	T	C	4	6	10	0	0	10	0	0
10	25961397	.	T	A	4	6	10	0	0	10	0	0
10	25961454	.	G	C	6	15	21	0	0	21	0	0
10	25961510	.	A	C	16	16	32	0	0	32	0	0
10	25961778	.	A	G	9	12	21	0	1	22	0	0
10	25984351	.	C	T	3	2	5	0	0	5	0	0
10	25986958	.	G	T	0	3	3	0	3	6	0	0
10	26071350	.	C	G	3	2	5	0	0	5	0	0
10	26089224	.	C	T	1	2	3	0	2	5	0	0
10	26089230	.	T	C	2	1	3	0	1	4	0	0
10	26100228	.	C	T	2	0	2	0	0	2	0	0
10	26107729	.	G	A	0	1	1	0	1	2	0	0
10	26107881	.	A	G	2	0	2	0	1	3	0	0
10	26107888	.	G	A	1	1	2	0	0	2	0	0
10	26111451	.	T	C	1	4	5	0	0	5	0	0
10	26111487	.	T	C	2	5	7	0	0	7	0	0
10	26111631	.	T	C	0	2	2	0	1	3	0	0
10	26113230	.	C	T	5	0	5	0	0	5	0	0
10	26113239	.	T	A	5	0	5	0	0	5	0	0
10	26113370	.	G	A	3	3	6	0	0	6	0	0
10	26113931	.	C	T	2	9	11	0	0	11	0	0
10	26114472	.	G	C	2	5	7	0	2	9	0	0
10	26114474	.	T	C	2	5	7	0	2	9	0	0
10	26114508	.	A	T	2	5	7	0	0	7	0	0
10	26114509	.	C	T	2	5	7	0	0	7	0	0
10	26114562	.	C	G	1	4	5	0	0	5	0	0
10	26114894	.	A	T	3	2	5	0	0	5	0	0
10	26114922	.	A	C	2	2	4	0	1	5	0	0
10	26114952	.	A	T	3	2	5	0	0	5	0	0
10	26115225	.	C	T	2	7	9	0	1	10	0	0
10	26118717	.	G	C	3	8	11	0	0	11	0	0
10	26123308	.	A	C	4	2	6	0	1	7	0	0
10	26123649	.	A	T	7	4	11	0	0	11	0	0
10	26123667	.	A	C	7	1	8	0	0	8	0	0
10	26126639	.	C	G	7	7	14	0	0	14	0	0
10	26126643	.	T	C	8	6	14	0	1	15	0	0
10	26126995	.	A	T	6	10	16	0	1	17	0	0
10	26127054	.	G	A	5	6	11	0	1	12	0	0
10	26127075	.	T	C	4	5	9	0	0	9	0	0
10	26127291	.	T	C	10	17	27	0	0	27	0	0
10	26127479	.	C	A	6	13	19	0	0	19	0	0
10	26127484	.	C	T	5	12	17	0	1	18	0	0
10	26127731	.	C	T	7	4	11	0	0	11	0	0
10	26127968	.	G	T	10	3	13	0	0	13	0	0
10	26128067	.	A	T	8	6	14	0	0	14	0	0
10	26131166	.	G	A	11	7	18	0	0	18	0	0
10	26131195	.	C	T	0	6	6	0	13	19	0	0
10	26131551	.	C	G	11	17	28	0	1	29	0	0
10	26131622	.	T	C	12	0	12	0	14	26	0	0
10	26131653	.	C	T	13	16	29	0	3	32	0	0
10	26131717	.	A	T	13	6	19	0	2	21	0	0
10	26131719	.	T	C	12	6	18	0	3	21	0	0
10	26131806	.	A	T	6	9	15	0	1	16	0	0
10	26131989	.	C	T	11	5	16	0	1	17	0	0
10	26132084	.	G	T	12	5	17	0	0	17	0	0
10	26132221	.	T	G	0	2	2	0	0	2	0	0
10	26132356	.	A	G	5	3	8	0	0	8	0	0
10	26132437	.	A	T	14	11	25	0	1	26	0	0
10	26132553	.	A	G	17	16	33	0	0	33	0	0
10	26132630	.	C	A	0	5	5	0	7	12	0	0
10	26139304	.	G	A	19	20	39	0	3	42	0	0
10	26139352	.	A	T	5	9	14	0	0	14	0	0
10	26141198	.	C	T	2	2	4	0	0	4	0	0
10	26144153	.	T	G	10	14	24	0	0	24	0	0
10	26144180	.	A	G	13	14	27	0	0	27	0	0
10	26144243	.	A	G	15	11	26	0	2	28	0	0
10	26144249	.	C	A	15	12	27	0	0	27	0	0
10	26150862	.	A	G	7	9	16	0	0	16	0	0
10	26155871	.	T	G	6	4	10	0	1	11	0	0
10	26163911	.	G	A	2	2	4	0	0	4	0	0
10	26203499	.	T	G	4	3	7	0	0	7	0	0
10	26204834	.	C	A	4	2	6	0	0	6	0	0
10	26204886	.	A	T	3	9	12	0	0	12	0	0
10	26204897	.	G	C	4	8	12	0	0	12	0	0
10	26205057	.	A	T	1	5	6	0	0	6	0	0
10	26205169	.	G	A	3	2	5	0	1	6	0	0
10	26205176	.	A	T	3	2	5	0	0	5	0	0
10	26205206	.	A	T	4	2	6	0	0	6	0	0
10	26205715	.	G	A	1	3	4	0	0	4	0	0
10	26205805	.	A	T	1	9	10	0	0	10	0	0
10	26205909	.	C	A	11	3	14	0	0	14	0	0
10	26206371	.	A	G	0	1	1	0	0	1	0	0
10	26206509	.	C	T	0	3	3	0	2	5	0	0
10	26209385	.	C	T	5	6	11	0	1	12	0	0
10	26209400	.	C	T	5	5	10	0	0	10	0	0
10	26225398	.	T	C	4	0	4	0	2	6	0	0
10	26269180	.	C	G	1	4	5	0	0	5	0	0
10	26269186	.	A	G	2	4	6	0	0	6	0	0
10	26270388	.	C	A	3	7	10	0	0	10	0	0
10	26271018	.	G	C	3	0	3	0	8	11	0	0
10	26271159	.	G	T	3	4	7	0	0	7	0	0
10	26271168	.	G	A	3	4	7	0	0	7	0	0
10	26271357	.	C	A	2	3	5	0	1	6	0	0
10	26272155	.	C	T	2	4	6	0	2	8	0	0
10	26272236	.	C	G	2	2	4	0	0	4	0	0
10	26272338	.	C	G	0	3	3	0	4	7	0	0
10	26272756	.	T	C	1	0	1	0	6	7	0	0
10	26272842	.	G	A	3	5	8	0	0	8	0	0
10	26272941	.	A	T	1	2	3	0	0	3	0	0
10	26273046	.	T	C	3	0	3	0	2	5	0	0
10	26273076	.	T	A	2	5	7	0	0	8	1	0
10	26273094	.	G	A	3	4	7	0	0	7	0	0
10	26273139	.	C	T	0	2	2	0	0	2	0	0
10	26273521	.	C	G	0	1	1	0	0	1	0	0
10	26273557	.	T	C	2	2	4	0	0	4	0	0
10	26274166	.	G	A	1	1	2	0	1	3	0	0
10	26274180	.	T	A	2	2	4	0	0	4	0	0
10	26279620	.	T	C	1	3	4	0	0	4	0	0
10	26296545	.	G	A	1	0	1	0	0	1	0	0
10	26297430	.	G	A	1	2	3	0	1	4	0	0
10	26302705	.	C	T	0	1	1	0	1	2	0	0
10	26508081	.	T	C	1	0	1	0	2	3	0	0
10	26508150	.	A	C	3	2	5	0	0	5	0	0
10	26517207	.	A	T	1	0	1	0	0	1	0	0
10	26517214	.	C	T	1	2	3	0	0	3	0	0
10	26517557	.	C	A	3	3	6	0	0	6	0	0
10	26517569	.	G	C	0	2	2	0	4	6	0	0
10	26522813	.	G	A	0	0	0	0	2	2	0	0
10	26536177	.	C	T	11	7	18	0	1	19	0	0
10	26536231	.	A	G	1	0	1	0	2	3	0	0
10	26543567	.	A	G	4	4	8	0	0	8	0	0
10	26544599	.	G	A	6	7	13	0	0	13	0	0
10	26544626	.	C	A	1	0	1	0	0	1	0	0
10	26547356	.	C	T	9	6	15	0	1	16	0	0
10	26551197	.	T	C	11	11	22	0	1	23	0	0
10	26551242	.	A	G	3	7	10	0	0	10	0	0
10	26553007	.	T	A	6	5	11	0	20	32	1	0
10	26560166	.	T	C	2	4	6	0	0	6	0	0
10	26560260	.	C	T	20	31	51	0	2	53	0	0
10	26565704	.	T	C	19	34	53	0	1	54	0	0
10	26565760	.	G	A	0	34	34	0	20	54	0	0
10	26566054	.	G	C	0	16	16	0	28	44	0	0
10	26566267	.	T	C	20	13	33	0	6	39	0	0
10	26566354	.	A	T	12	8	20	0	0	20	0	0
10	26566369	.	A	T	10	7	17	0	1	18	0	0
10	26566715	.	T	A	8	4	12	0	1	13	0	0
10	26566749	.	G	A	8	5	13	0	2	15	0	0
10	26566785	.	T	A	13	7	20	0	0	20	0	0
10	26566787	.	A	T	13	7	20	0	0	20	0	0
10	26566855	.	A	G	15	0	15	0	13	28	0	0
10	26566970	.	T	G	8	0	8	0	11	19	0	0
10	26567238	.	A	G	9	15	24	0	1	25	0	0
10	26567337	.	C	T	16	19	35	0	5	40	0	0
10	26567376	.	C	G	8	21	29	0	1	30	0	0
10	26567500	.	C	T	19	20	39	0	0	39	0	0
10	26567656	.	G	C	20	8	28	0	2	30	0	0
10	26567810	.	C	T	7	12	19	0	0	19	0	0
10	26567889	.	T	A	9	12	21	0	0	21	0	0
10	26567958	.	T	A	10	4	14	0	1	15	0	0
10	26568154	.	A	T	11	12	23	0	2	25	0	0
10	26568166	.	C	T	10	9	19	0	1	20	0	0
10	26568201	.	A	G	2	4	6	0	3	9	0	0
10	26568239	.	C	T	2	2	4	0	0	4	0	0
10	26568429	.	A	C	14	21	35	0	0	35	0	0
10	26568498	.	T	C	23	27	50	0	2	52	0	0
10	26568523	.	G	T	20	25	45	0	2	47	0	0
10	26568726	.	A	G	23	18	41	0	2	43	0	0
10	26569098	.	A	G	13	1	14	0	25	39	0	0
10	26569099	.	A	C	13	25	38	0	1	39	0	0
10	26569248	.	C	A	13	13	26	0	2	28	0	0
10	26574004	.	T	C	4	2	6	0	0	6	0	0
10	26578528	.	T	C	1	3	4	0	0	4	0	0
10	26583978	.	C	G	2	3	5	0	0	5	0	0
10	26596020	.	T	A	25	16	41	0	3	44	0	0
10	26596075	.	C	T	20	25	45	0	0	45	0	0
10	26596080	.	T	C	17	22	39	0	1	40	0	0
10	26596568	.	A	T	3	2	5	0	0	5	0	0
10	26656135	.	A	C	0	2	2	0	0	2	0	0
10	26811199	.	C	T	4	2	6	0	0	6	0	0
10	26933176	.	G	T	6	7	13	0	0	13	0	0
10	26944511	.	C	T	4	2	6	0	0	6	0	0
10	26945269	.	G	A	2	2	4	0	0	4	0	0
10	26945274	.	A	C	2	2	4	0	0	4	0	0
10	26950644	.	T	C	5	3	8	0	0	8	0	0
10	26950662	.	A	G	3	6	9	0	0	9	0	0
10	26950702	.	T	C	5	3	8	0	2	10	0	0
10	26958093	.	A	G	8	9	17	0	1	18	0	0
10	26958150	.	G	C	6	5	11	0	1	12	0	0
10	26958457	.	A	G	9	4	13	0	0	13	0	0
10	26958491	.	C	A	7	4	11	0	0	11	0	0
10	26958928	.	A	G	3	0	3	0	2	5	0	0
10	26959424	.	T	C	1	4	5	0	0	5	0	0
10	26959523	.	T	G	1	0	1	0	0	1	0	0
10	26959528	.	T	C	1	0	1	0	0	1	0	0
10	26959894	.	C	A	2	3	5	0	1	6	0	0
10	26960281	.	A	G	5	6	11	0	0	11	0	0
10	26961970	.	T	C	3	2	5	0	0	5	0	0
10	26965971	.	G	A	7	4	11	0	0	11	0	0
10	26972152	.	T	C	14	10	24	0	2	26	0	0
10	26972392	.	A	T	3	6	9	0	0	9	0	0
10	26972877	.	C	G	1	1	2	0	0	2	0	0
10	26973406	.	C	T	3	6	9	0	0	9	0	0
10	26973454	.	T	G	1	0	1	0	4	5	0	0
10	26977154	.	G	A	1	0	1	0	0	1	0	0
10	26978169	.	C	G	4	20	24	0	0	24	0	0
10	26982258	.	G	A	1	3	4	0	0	4	0	0
10	26982262	.	A	G	1	2	3	0	1	4	0	0
10	26982455	.	C	T	3	6	9	0	0	9	0	0
10	26982495	.	T	C	3	5	8	0	0	8	0	0
10	26982532	.	G	T	3	3	6	0	0	6	0	0
10	26982565	.	G	A	3	3	6	0	0	6	0	0
10	26982572	.	C	G	3	3	6	0	0	6	0	0
10	26982828	.	G	A	3	2	5	0	0	5	0	0
10	26983012	.	A	T	1	2	3	0	0	3	0	0
10	26983388	.	C	T	1	2	3	0	0	3	0	0
10	26987399	.	T	C	8	0	8	0	10	18	0	0
10	26989543	.	T	C	5	2	7	0	0	7	0	0
10	26989828	.	A	T	12	10	22	0	1	23	0	0
10	26989843	.	A	T	12	7	19	0	1	20	0	0
10	26990140	.	C	G	2	3	5	0	0	5	0	0
10	26991487	.	T	C	1	2	3	0	0	3	0	0
10	26991785	.	C	G	7	4	11	0	0	11	0	0
10	26991875	.	A	T	4	5	9	0	2	11	0	0
10	26991876	.	C	G	6	5	11	0	0	11	0	0
10	26991914	.	A	T	11	5	16	0	1	17	0	0
10	26991984	.	G	C	4	3	7	0	0	7	0	0
10	26991990	.	T	C	3	0	3	0	3	6	0	0
10	26997077	.	C	A	11	6	17	0	0	17	0	0
10	26997139	.	G	T	19	10	29	0	2	31	0	0
10	26997294	.	T	A	2	5	7	0	0	7	0	0
10	26998433	.	T	G	1	2	3	0	0	3	0	0
10	26999165	.	T	C	16	5	21	0	17	38	0	0
10	26999341	.	C	T	13	20	33	0	1	34	0	0
10	26999407	.	A	T	6	15	21	0	1	22	0	0
10	26999414	.	A	G	7	12	19	0	0	19	0	0
10	27006512	.	T	A	10	22	32	0	1	33	0	0
10	27006721	.	T	C	4	5	9	0	3	12	0	0
10	27046400	.	T	A	16	19	35	0	2	37	0	0
10	27052736	.	T	C	1	3	4	0	0	4	0	0
10	27057605	.	G	A	0	1	1	0	0	1	0	0
10	27058678	.	G	A	1	2	3	0	0	3	0	0
10	27091840	.	C	T	1	4	5	0	0	5	0	0
10	27092015	.	T	C	3	2	5	0	0	5	0	0
10	27092323	.	T	G	3	2	5	0	0	5	0	0
10	27092649	.	A	G	2	5	7	0	0	7	0	0
10	27133380	.	A	G	1	2	3	0	0	3	0	0
10	27183328	.	T	G	8	7	15	0	1	16	0	0
10	27183418	.	C	T	8	11	19	0	3	22	0	0
10	27183735	.	C	T	0	7	7	0	14	21	0	0
10	27184069	.	G	A	19	12	31	0	5	36	0	0
10	27184237	.	A	G	18	23	41	0	0	41	0	0
10	27184456	.	A	G	14	11	25	0	0	25	0	0
10	27184600	.	G	A	7	8	15	0	0	15	0	0
10	27184678	.	C	T	0	5	5	0	12	17	0	0
10	27184729	.	C	T	11	5	16	0	3	19	0	0
10	27184843	.	G	A	16	13	29	0	1	30	0	0
10	27184864	.	T	C	12	0	12	0	18	30	0	0
10	27184891	.	T	A	18	10	28	0	1	29	0	0
10	27184905	.	C	T	0	17	17	0	9	26	0	0
10	27185134	.	A	G	5	8	13	0	0	13	0	0
10	27196623	.	C	T	0	9	9	0	13	22	0	0
10	27196699	.	G	T	11	8	19	0	3	22	0	0
10	27196704	.	C	T	0	8	8	0	12	20	0	0
10	27223120	.	A	T	1	2	3	0	0	3	0	0
10	27608655	.	G	A	3	3	6	0	0	6	0	0
10	27738467	.	C	T	3	1	4	0	1	5	0	0
10	27738752	.	G	A	2	2	4	0	1	5	0	0
10	27978002	.	A	T	2	8	10	0	0	10	0	0
10	27978055	.	T	C	1	2	3	0	0	3	0	0
10	27980508	.	C	T	0	3	3	0	1	4	0	0
10	27984459	.	T	G	2	3	5	0	0	5	0	0
10	27984519	.	C	G	4	2	6	0	1	7	0	0
10	28030710	.	C	T	0	7	7	0	2	9	0	0
10	28030729	.	T	C	4	0	4	0	6	10	0	0
10	28030753	.	A	G	6	10	16	0	0	16	0	0
10	28030843	.	C	T	4	9	13	0	0	13	0	0
10	28036119	.	G	A	2	4	6	0	0	6	0	0
10	28037735	.	C	T	2	9	11	0	2	13	0	0
10	28037759	.	C	T	3	6	9	0	0	9	0	0
10	28038167	.	G	A	3	4	7	0	0	7	0	0
10	28040705	.	G	T	8	6	14	0	1	15	0	0
10	28041152	.	T	A	5	10	15	0	4	19	0	0
10	28041218	.	G	C	4	8	12	0	1	13	0	0
10	28043421	.	T	C	3	2	5	0	0	5	0	0
10	28043454	.	T	G	2	2	4	0	0	4	0	0
10	28043490	.	G	A	2	4	6	0	0	6	0	0
10	28046578	.	C	A	1	0	1	0	0	1	0	0
10	28056815	.	G	T	8	6	14	0	0	14	0	0
10	28057010	.	A	G	5	5	10	0	0	10	0	0
10	28057286	.	A	G	4	4	8	0	0	8	0	0
10	28057364	.	T	C	0	0	0	0	1	1	0	0
10	28063892	.	A	G	0	0	0	0	1	1	0	0
10	28066605	.	T	G	3	2	5	0	0	5	0	0
10	28111185	.	G	A	0	1	1	0	0	1	0	0
10	28111203	.	A	G	0	1	1	0	0	1	0	0
10	28161671	.	C	G	4	5	9	0	0	9	0	0
10	28161965	.	A	T	0	3	3	0	1	4	0	0
10	28162146	.	G	A	0	2	2	0	0	2	0	0
10	28165150	.	T	A	0	5	5	0	0	5	0	0
10	28165212	.	T	C	0	5	5	0	0	5	0	0
10	28168295	.	C	G	6	4	10	0	0	10	0	0
10	28172354	.	C	T	0	2	2	0	2	4	0	0
10	28308418	.	G	T	0	4	4	0	1	5	0	0
10	28308419	.	T	G	1	4	5	0	0	5	0	0
10	28308522	.	G	A	4	4	8	0	0	8	0	0
10	28308710	.	A	T	1	4	5	0	0	5	0	0
10	28308865	.	A	T	1	3	4	0	0	4	0	0
10	28311161	.	A	G	16	21	37	0	0	37	0	0
10	28315096	.	A	G	15	20	35	0	1	36	0	0
10	28315396	.	A	G	19	13	32	0	1	33	0	0
10	28315421	.	C	G	14	13	27	0	0	27	0	0
10	28319441	.	A	G	19	16	35	0	1	36	0	0
10	28320654	.	G	C	8	0	8	0	4	12	0	0
10	28321051	.	G	A	11	16	27	0	1	28	0	0
10	28323325	.	A	T	7	8	15	0	1	16	0	0
10	28328174	.	T	C	11	9	20	0	1	21	0	0
10	28328219	.	A	G	2	3	5	0	1	6	0	0
10	28328231	.	A	G	1	2	3	0	0	3	0	0
10	28332868	.	T	C	3	2	5	0	0	5	0	0
10	28334806	.	G	A	2	0	2	0	0	2	0	0
10	28339621	.	C	T	1	4	5	0	0	5	0	0
10	28349266	.	G	A	1	0	1	0	0	1	0	0
10	28350055	.	G	A	2	7	9	0	0	9	0	0
10	28350959	.	T	A	2	3	5	0	0	5	0	0
10	28351616	.	C	T	6	2	8	0	0	8	0	0
10	28355728	.	A	G	6	2	8	0	0	8	0	0
10	28371198	.	G	A	10	7	17	0	1	18	0	0
10	28371284	.	G	A	17	14	31	0	0	31	0	0
10	28371407	.	C	T	0	10	10	0	9	19	0	0
10	28376814	.	T	C	3	0	3	0	5	8	0	0
10	28376895	.	C	T	4	2	6	0	0	6	0	0
10	28483319	.	C	T	5	2	7	0	0	7	0	0
10	28483440	.	G	T	1	2	3	0	0	3	0	0
10	28483631	.	C	T	0	3	3	0	7	10	0	0
10	28483673	.	C	T	1	2	3	0	0	3	0	0
10	28690959	.	A	T	1	5	6	0	0	6	0	0
10	28691007	.	C	T	0	2	2	0	0	3	1	0
10	28691024	.	C	T	2	0	2	0	0	2	0	0
10	28695869	.	T	A	3	5	8	0	1	9	0	0
10	28696048	.	A	C	2	1	3	0	6	9	0	0
10	28696060	.	A	C	3	0	3	0	6	9	0	0
10	28723769	.	A	T	4	2	6	0	0	6	0	0
10	28723805	.	G	A	0	4	4	0	4	8	0	0
10	28724220	.	G	A	3	1	4	0	0	4	0	0
10	28730249	.	C	T	4	5	9	0	0	9	0	0
10	28730437	.	G	T	6	4	10	0	0	10	0	0
10	28730446	.	A	C	5	5	10	0	0	10	0	0
10	28730503	.	G	A	4	3	7	0	0	7	0	0
10	28730800	.	A	T	8	0	8	0	0	11	3	0
10	28730869	.	C	T	5	7	12	0	1	13	0	0
10	28730880	.	T	A	6	8	14	0	0	14	0	0
10	28730913	.	G	A	10	7	17	0	0	17	0	0
10	28731001	.	C	T	5	11	16	0	0	16	0	0
10	28731072	.	C	T	7	13	20	0	0	20	0	0
10	28731155	.	A	T	6	11	17	0	0	17	0	0
10	28731289	.	T	C	7	7	14	0	1	15	0	0
10	28731372	.	G	A	0	8	8	0	7	15	0	0
10	28732003	.	C	A	14	15	29	0	0	29	0	0
10	28732366	.	A	G	11	19	30	0	1	31	0	0
10	28732601	.	C	T	1	11	12	0	18	30	0	0
10	28733067	.	G	T	19	18	37	0	1	38	0	0
10	28733132	.	T	A	10	17	27	0	0	27	0	0
10	28737345	.	C	T	4	6	10	0	0	10	0	0
10	28743800	.	T	A	8	5	13	0	0	13	0	0
10	28745583	.	G	A	8	8	16	0	2	18	0	0
10	28748996	.	G	A	3	2	5	0	0	5	0	0
10	28835635	.	C	G	7	4	11	0	0	11	0	0
10	28835655	.	G	A	9	6	15	0	0	15	0	0
10	28835701	.	A	T	7	8	15	0	1	16	0	0
10	29166502	.	A	G	11	4	15	0	0	15	0	0
10	29185863	.	T	A	2	1	3	0	0	3	0	0
10	29187908	.	C	T	6	4	10	0	0	10	0	0
10	29201671	.	C	T	5	1	6	0	0	6	0	0
10	29205655	.	A	T	3	6	9	0	0	9	0	0
10	29224364	.	C	T	1	9	10	0	2	12	0	0
10	29224484	.	G	A	7	9	16	0	1	17	0	0
10	29224598	.	A	T	15	14	29	0	0	29	0	0
10	29224651	.	C	A	14	8	22	0	3	25	0	0
10	29225032	.	A	G	9	0	9	0	6	15	0	0
10	29265596	.	A	G	4	0	4	0	12	16	0	0
10	29265599	.	T	A	4	11	15	0	0	15	0	0
10	29266279	.	C	A	2	1	3	0	1	4	0	0
10	29266376	.	C	T	19	22	41	0	2	43	0	0
10	29270225	.	C	T	5	9	14	0	0	14	0	0
10	29271915	.	C	T	5	4	9	0	0	9	0	0
10	29572857	.	C	T	7	5	12	0	1	13	0	0
10	29578478	.	C	T	6	4	10	0	0	10	0	0
10	29578756	.	G	T	6	6	12	0	2	14	0	0
10	29661410	.	C	T	1	4	5	0	0	5	0	0
10	29661419	.	C	G	1	0	1	0	3	4	0	0
10	29678256	.	A	G	11	1	12	0	15	27	0	0
10	29678313	.	G	A	1	3	4	0	0	4	0	0
10	29736736	.	T	C	4	0	4	0	3	7	0	0
10	29736746	.	C	T	0	3	3	0	4	7	0	0
10	29742625	.	C	T	0	1	1	0	2	3	0	0
10	29742656	.	C	T	1	2	3	0	0	3	0	0
10	29742795	.	T	C	4	3	7	0	0	7	0	0
10	29751328	.	G	A	6	14	20	0	1	21	0	0
10	29751407	.	T	C	6	2	8	0	1	9	0	0
10	29761405	.	C	T	1	4	5	0	0	5	0	0
10	29761761	.	A	T	2	5	7	0	0	7	0	0
10	29761767	.	G	A	2	5	7	0	0	7	0	0
10	29766072	.	C	G	1	2	3	0	0	3	0	0
10	29766841	.	C	T	8	4	12	0	0	12	0	0
10	29768405	.	G	T	1	6	7	0	0	7	0	0
10	29770329	.	G	T	1	2	3	0	0	3	0	0
10	29778433	.	T	C	3	2	5	0	0	5	0	0
10	29782137	.	G	A	0	2	2	0	0	2	0	0
10	29782273	.	A	G	2	0	2	0	3	5	0	0
10	29788229	.	G	T	1	1	2	0	0	2	0	0
10	29815697	.	A	C	7	1	8	0	2	10	0	0
10	29815802	.	A	G	20	16	36	0	1	37	0	0
10	29816113	.	T	C	25	28	53	0	3	56	0	0
10	29816290	.	T	A	16	34	50	0	1	51	0	0
10	29816439	.	A	T	15	18	33	0	1	34	0	0
10	29816904	.	C	T	32	31	63	0	2	65	0	0
10	29817111	.	C	T	29	49	78	0	2	80	0	0
10	29817207	.	C	T	28	28	56	0	5	61	0	0
10	29817416	.	A	T	27	17	44	0	2	46	0	0
10	29820495	.	G	A	4	5	9	0	1	10	0	0
10	29823484	.	G	A	1	4	5	0	0	5	0	0
10	29824248	.	C	T	3	0	3	0	1	4	0	0
10	29824262	.	C	T	4	1	5	0	0	5	0	0
10	29831556	.	G	A	1	2	3	0	0	3	0	0
10	29851722	.	C	T	28	28	56	0	3	59	0	0
10	29852317	.	G	A	1	4	5	0	1	6	0	0
10	29852476	.	A	G	22	0	22	0	15	37	0	0
10	29852485	.	A	G	18	1	19	0	11	30	0	0
10	29963638	.	G	A	2	3	5	0	0	5	0	0
10	30570467	.	T	C	0	3	3	0	0	3	0	0
10	30576004	.	T	C	6	7	13	0	2	15	0	0
10	30576061	.	G	A	1	4	5	0	0	5	0	0
10	30618313	.	T	A	5	8	13	0	0	13	0	0
10	30618429	.	A	T	2	2	4	0	0	4	0	0
10	30623408	.	G	A	5	10	15	0	1	16	0	0
10	30624615	.	C	T	0	1	1	0	0	1	0	0
10	30691387	.	T	A	1	2	3	0	0	3	0	0
10	31020810	.	A	G	5	5	10	0	1	11	0	0
10	31021505	.	T	C	9	6	15	0	1	16	0	0
10	31021550	.	G	A	11	8	19	0	1	20	0	0
10	31021553	.	G	A	9	11	20	0	0	20	0	0
10	31021611	.	C	T	11	10	21	0	0	21	0	0
10	31021676	.	G	A	12	11	23	0	2	25	0	0
10	31023520	.	A	G	6	10	16	0	0	16	0	0
10	31032043	.	T	C	7	10	17	0	0	17	0	0
10	31034999	.	C	T	0	4	4	0	0	4	0	0
10	31035129	.	C	T	4	5	9	0	0	9	0	0
10	31035147	.	C	T	5	2	7	0	0	7	0	0
10	31040834	.	G	A	1	3	4	0	0	4	0	0
10	31066888	.	C	T	0	5	5	0	5	10	0	0
10	31624750	.	G	A	2	1	3	0	0	3	0	0
10	31628397	.	C	T	2	1	3	0	1	4	0	0
10	31628406	.	C	T	3	2	5	0	0	5	0	0
10	31628481	.	T	C	0	1	1	0	0	1	0	0
10	31632313	.	G	C	2	3	5	0	1	6	0	0
10	31632691	.	G	A	7	3	10	0	0	10	0	0
10	31632758	.	A	T	6	7	13	0	0	13	0	0
10	31632829	.	A	G	3	6	9	0	1	10	0	0
10	31632916	.	T	C	1	6	7	0	0	7	0	0
10	31632945	.	C	T	7	2	9	0	1	10	0	0
10	31633077	.	A	C	5	5	10	0	0	10	0	0
10	31633273	.	T	C	1	2	3	0	0	3	0	0
10	31633424	.	A	G	2	2	4	0	0	4	0	0
10	31633438	.	T	A	2	3	5	0	0	5	0	0
10	31633640	.	G	A	1	6	7	0	0	7	0	0
10	31725404	.	C	T	2	1	3	0	0	3	0	0
10	31725697	.	C	T	3	3	6	0	0	6	0	0
10	31725736	.	T	C	3	2	5	0	2	7	0	0
10	31726330	.	C	T	1	2	3	0	0	3	0	0
10	31738616	.	A	G	7	4	11	0	1	12	0	0
10	31739181	.	G	T	28	26	54	0	0	54	0	0
10	31739346	.	G	T	21	23	44	0	1	45	0	0
10	31751941	.	C	T	3	2	5	0	0	5	0	0
10	31757307	.	C	T	20	37	57	0	0	57	0	0
10	31772041	.	G	A	18	30	48	0	2	50	0	0
10	31782605	.	C	T	3	3	6	0	0	6	0	0
10	31800313	.	A	G	2	7	9	0	0	9	0	0
10	32037088	.	A	T	1	3	4	0	0	4	0	0
10	32037355	.	C	T	2	2	4	0	0	4	0	0
10	32037373	.	T	C	2	2	4	0	0	4	0	0
10	32037418	.	C	T	1	2	3	0	0	3	0	0
10	32037794	.	T	A	1	2	3	0	1	4	0	0
10	32038054	.	A	T	0	2	2	0	0	2	0	0
10	32038071	.	A	T	0	2	2	0	0	2	0	0
10	32058811	.	A	T	3	2	5	0	0	5	0	0
10	32062738	.	C	T	2	3	5	0	1	6	0	0
10	32062978	.	C	T	1	3	4	0	0	4	0	0
10	32063605	.	C	T	3	6	9	0	0	9	0	0
10	32063752	.	G	A	3	4	7	0	0	7	0	0
10	32064121	.	A	T	3	5	8	0	0	8	0	0
10	32064222	.	A	T	4	3	7	0	0	7	0	0
10	32071029	.	G	A	2	2	4	0	0	4	0	0
10	32122727	.	T	C	1	2	3	0	0	3	0	0
10	32122738	.	T	C	1	2	3	0	0	3	0	0
10	32122840	.	T	A	3	2	5	0	0	5	0	0
10	32122952	.	T	A	3	3	6	0	0	6	0	0
10	32265193	.	T	A	5	2	7	0	0	7	0	0
10	32265199	.	G	A	5	2	7	0	0	7	0	0
10	32265331	.	A	C	1	3	4	0	0	4	0	0
10	32383514	.	G	A	2	1	3	0	0	3	0	0
10	32561338	.	G	A	5	11	16	0	0	16	0	0
10	32561427	.	A	C	6	6	12	0	0	12	0	0
10	32561437	.	T	A	5	7	12	0	0	12	0	0
10	32561575	.	C	T	2	8	10	0	1	11	0	0
10	32561817	.	G	A	1	10	11	0	9	20	0	0
10	32561820	.	G	T	9	9	18	0	1	19	0	0
10	32562267	.	C	T	5	9	14	0	0	14	0	0
10	32577486	.	G	A	6	1	7	0	0	7	0	0
10	32577489	.	A	G	6	1	7	0	0	7	0	0
10	32577522	.	C	T	11	8	19	0	0	19	0	0
10	32577549	.	T	C	12	9	21	0	0	21	0	0
10	32577621	.	G	A	3	10	13	0	0	13	0	0
10	34572353	.	T	C	4	6	10	0	0	10	0	0
10	34580604	.	G	A	1	0	1	0	0	1	0	0
10	34580622	.	C	T	1	0	1	0	0	1	0	0
10	34588881	.	C	T	6	2	8	0	0	8	0	0
10	34611453	.	A	G	0	0	0	0	1	1	0	0
10	34651069	.	A	G	0	0	0	0	1	1	0	0
10	34661821	.	T	C	4	6	10	0	0	10	0	0
10	34661857	.	A	G	5	4	9	0	0	9	0	0
10	34662013	.	T	C	6	3	9	0	0	9	0	0
10	34662024	.	T	G	6	6	12	0	0	12	0	0
10	34662349	.	C	T	9	5	14	0	0	14	0	0
10	34662437	.	C	T	7	4	11	0	0	11	0	0
10	34662481	.	A	T	7	5	12	0	1	13	0	0
10	34664906	.	G	A	2	2	4	0	0	4	0	0
10	34673597	.	C	T	3	3	6	0	0	6	0	0
10	34676094	.	A	G	3	0	3	0	7	10	0	0
10	34676266	.	G	T	2	4	6	0	0	6	0	0
10	34677539	.	T	C	2	5	7	0	0	7	0	0
10	34677569	.	C	T	1	5	6	0	0	6	0	0
10	34677673	.	T	C	4	11	15	0	1	16	0	0
10	34699238	.	C	T	2	2	4	0	0	4	0	0
10	34701434	.	A	C	11	7	18	0	0	18	0	0
10	34703742	.	G	A	3	2	5	0	0	5	0	0
10	34703802	.	A	G	7	0	7	0	11	18	0	0
10	34707546	.	A	T	1	6	7	0	0	7	0	0
10	34709708	.	G	C	0	3	3	0	0	3	0	0
10	34709940	.	C	T	5	6	11	0	0	11	0	0
10	34724906	.	C	T	3	5	8	0	0	8	0	0
10	34729552	.	G	A	8	6	14	0	1	15	0	0
10	34729693	.	C	T	2	5	7	0	0	7	0	0
10	34733566	.	A	G	23	20	43	0	1	44	0	0
10	34733578	.	A	G	27	3	30	0	15	45	0	0
10	34733661	.	C	T	14	14	28	0	5	33	0	0
10	34733883	.	A	T	12	17	29	0	4	33	0	0
10	34734568	.	G	T	0	14	14	0	18	32	0	0
10	34734590	.	A	G	18	18	36	0	2	38	0	0
10	34734785	.	G	T	10	12	22	0	1	23	0	0
10	34737686	.	A	G	12	21	33	0	0	33	0	0
10	34738125	.	T	C	14	26	40	0	2	42	0	0
10	34741649	.	T	A	8	5	13	0	0	14	1	0
10	34743910	.	G	A	0	1	1	0	0	1	0	0
10	34754660	.	C	T	17	20	37	0	3	40	0	0
10	34756936	.	A	C	3	1	4	0	1	5	0	0
10	34813299	.	T	C	3	4	7	0	0	7	0	0
10	34867259	.	T	C	9	0	9	0	8	17	0	0
10	34867466	.	C	T	0	1	1	0	0	1	0	0
10	34908565	.	G	A	3	2	5	0	0	5	0	0
10	34913407	.	G	A	1	3	4	0	0	4	0	0
10	34951611	.	G	A	1	1	2	0	0	2	0	0
10	34958760	.	A	T	13	17	30	0	1	31	0	0
10	34961149	.	C	A	12	18	30	0	2	32	0	0
10	34976841	.	A	T	2	2	4	0	0	4	0	0
10	34976855	.	C	T	0	2	2	0	2	4	0	0
10	34984836	.	A	G	10	11	21	0	1	22	0	0
10	34984923	.	T	C	5	9	14	0	0	14	0	0
10	34984931	.	C	A	0	6	6	0	5	11	0	0
10	34989149	.	T	C	7	0	7	0	13	20	0	0
10	34998281	.	G	C	6	6	12	0	0	12	0	0
10	35002400	.	C	A	2	2	4	0	0	4	0	0
10	35006358	.	T	C	1	5	6	0	0	6	0	0
10	35008963	.	C	T	3	5	8	0	0	8	0	0
10	35011325	.	C	T	7	2	9	0	0	9	0	0
10	35011337	.	A	G	3	7	10	0	0	10	0	0
10	35012184	.	C	T	2	6	8	0	6	14	0	0
10	35025832	.	G	C	1	3	4	0	0	4	0	0
10	35029172	.	G	A	5	4	9	0	1	10	0	0
10	35032814	.	T	C	0	2	2	0	0	2	0	0
10	35033900	.	G	A	0	0	0	0	1	1	0	0
10	35046093	.	C	T	0	1	1	0	0	1	0	0
10	35059880	.	G	C	1	3	4	0	0	4	0	0
10	35103155	.	A	G	2	3	5	0	0	5	0	0
10	35220214	.	C	T	0	1	1	0	1	2	0	0
10	35220292	.	A	G	4	3	7	0	0	7	0	0
10	35236801	.	T	G	2	2	4	0	0	4	0	0
10	35236909	.	C	T	1	6	7	0	1	8	0	0
10	35241646	.	A	T	4	6	10	0	0	10	0	0
10	35245939	.	T	A	9	2	11	0	0	11	0	0
10	35245951	.	C	T	8	1	9	0	0	9	0	0
10	35247387	.	T	C	6	3	9	0	0	9	0	0
10	35247818	.	A	G	1	3	4	0	0	4	0	0
10	35247905	.	G	A	1	6	7	0	0	7	0	0
10	35247980	.	G	C	1	1	2	0	4	6	0	0
10	35248047	.	C	G	2	4	6	0	0	6	0	0
10	35248178	.	T	C	0	2	2	0	0	2	0	0
10	35248280	.	T	C	1	0	1	0	2	3	0	0
10	35248433	.	G	A	1	5	6	0	0	6	0	0
10	35265206	.	T	A	3	7	10	0	1	11	0	0
10	35265234	.	C	T	0	2	2	0	1	3	0	0
10	35266720	.	G	A	0	1	1	0	0	1	0	0
10	35281335	.	C	T	4	2	6	0	0	6	0	0
10	35281388	.	T	C	1	1	2	0	0	2	0	0
10	35298732	.	A	G	1	3	4	0	1	5	0	0
10	35300764	.	C	T	4	4	8	0	0	8	0	0
10	35302425	.	T	C	3	3	6	0	0	6	0	0
10	35304002	.	G	A	11	9	20	0	1	21	0	0
10	35307579	.	C	T	3	3	6	0	0	6	0	0
10	35312021	.	A	C	6	18	24	0	3	27	0	0
10	35312143	.	A	G	5	0	5	0	6	11	0	0
10	35314709	.	G	C	3	0	3	0	2	5	0	0
10	35314868	.	G	T	2	4	6	0	0	6	0	0
10	35316465	.	G	A	1	3	4	0	0	4	0	0
10	35538879	.	T	A	21	8	29	0	0	29	0	0
10	35539607	.	A	G	17	17	34	0	0	34	0	0
10	35539631	.	G	A	19	14	33	0	1	34	0	0
10	35540422	.	T	A	13	12	25	0	5	30	0	0
10	35540603	.	C	T	16	18	34	0	3	37	0	0
10	35540675	.	T	G	13	21	34	0	1	35	0	0
10	35540705	.	T	A	12	25	37	0	1	38	0	0
10	35540732	.	T	G	10	18	28	0	3	31	0	0
10	35540847	.	T	G	12	10	22	0	1	23	0	0
10	35541290	.	A	G	10	4	14	0	0	14	0	0
10	35541735	.	C	T	3	2	5	0	0	5	0	0
10	35541760	.	C	T	2	1	3	0	2	5	0	0
10	35554345	.	G	T	1	2	3	0	3	6	0	0
10	35579500	.	C	A	4	2	6	0	0	6	0	0
10	35579598	.	T	C	2	3	5	0	0	5	0	0
10	35579883	.	C	G	3	4	7	0	0	7	0	0
10	35584806	.	T	G	22	5	27	0	0	27	0	0
10	35584815	.	A	G	19	4	23	0	0	23	0	0
10	35584855	.	T	A	7	3	10	0	1	11	0	0
10	35585057	.	A	T	5	5	10	0	0	10	0	0
10	35585195	.	G	A	4	6	10	0	1	11	0	0
10	35585197	.	A	G	5	6	11	0	0	11	0	0
10	35585257	.	C	T	7	4	11	0	1	12	0	0
10	35585284	.	C	T	0	6	6	0	4	10	0	0
10	35592817	.	A	G	3	3	6	0	0	6	0	0
10	35592830	.	G	A	5	3	8	0	0	8	0	0
10	35595335	.	C	T	0	1	1	0	0	1	0	0
10	35595669	.	T	A	4	2	6	0	1	7	0	0
10	35602535	.	G	T	0	1	1	0	0	1	0	0
10	35602678	.	G	A	2	2	4	0	0	4	0	0
10	35602756	.	T	C	4	2	6	0	0	6	0	0
10	35609808	.	G	A	4	4	8	0	0	8	0	0
10	35611227	.	G	T	5	3	8	0	0	8	0	0
10	35611402	.	T	C	6	2	8	0	0	8	0	0
10	35611436	.	C	T	4	4	8	0	0	8	0	0
10	35611843	.	C	A	0	2	2	0	0	2	0	0
10	35654268	.	C	T	10	8	18	0	1	19	0	0
10	35654290	.	A	C	9	9	18	0	4	22	0	0
10	35654305	.	T	C	10	11	21	0	0	21	0	0
10	36443018	.	T	C	8	9	17	0	1	18	0	0
10	36443541	.	T	C	11	10	21	0	0	21	0	0
10	36443676	.	G	A	1	10	11	0	6	17	0	0
10	36443714	.	G	A	6	11	17	0	2	19	0	0
10	36443818	.	T	G	3	0	3	0	3	6	0	0
10	36446799	.	A	T	1	2	3	0	0	3	0	0
10	36451615	.	T	C	3	3	6	0	0	6	0	0
10	36451661	.	G	A	17	8	25	0	1	26	0	0
10	36454567	.	C	A	11	12	23	0	2	25	0	0
10	36454649	.	A	G	20	0	20	0	13	33	0	0
10	36454650	.	C	A	20	11	31	0	2	33	0	0
10	36454902	.	G	T	16	18	34	0	2	36	0	0
10	36455146	.	C	T	15	9	24	0	0	24	0	0
10	36455215	.	T	C	13	14	27	0	0	27	0	0
10	36455229	.	C	G	13	13	26	0	1	27	0	0
10	36455344	.	A	G	17	9	26	0	1	27	0	0
10	36455847	.	G	A	0	10	10	0	4	14	0	0
10	36476481	.	C	T	0	16	16	0	7	23	0	0
10	36476529	.	C	T	9	13	22	0	2	24	0	0
10	36476639	.	C	T	1	5	6	0	14	20	0	0
10	36476717	.	A	G	9	10	19	0	1	20	0	0
10	36476834	.	G	A	10	10	20	0	3	23	0	0
10	36476852	.	A	G	12	12	24	0	1	25	0	0
10	36476922	.	C	T	1	2	3	0	0	3	0	0
10	36481915	.	A	C	5	8	13	0	0	13	0	0
10	36482588	.	G	A	12	7	19	0	0	19	0	0
10	36487530	.	G	A	11	8	19	0	0	19	0	0
10	36489882	.	A	G	4	4	8	0	0	8	0	0
10	36489893	.	A	G	3	4	7	0	1	8	0	0
10	36492091	.	C	T	0	2	2	0	0	2	0	0
10	36494336	.	G	A	1	2	3	0	0	3	0	0
10	36494590	.	C	G	2	3	5	0	0	5	0	0
10	36495580	.	T	G	1	0	1	0	0	1	0	0
10	36496544	.	A	G	3	3	6	0	1	7	0	0
10	36496595	.	G	A	1	0	1	0	0	1	0	0
10	36498379	.	C	T	0	1	1	0	0	1	0	0
10	36498397	.	G	A	0	1	1	0	0	1	0	0
10	36500581	.	C	T	4	1	5	0	0	5	0	0
10	36500674	.	G	A	1	3	4	0	0	4	0	0
10	36506290	.	C	T	0	1	1	0	2	3	0	0
10	36506630	.	T	A	1	2	3	0	0	3	0	0
10	36519788	.	T	C	0	2	2	0	0	2	0	0
10	36520711	.	G	A	5	2	7	0	1	8	0	0
10	36520945	.	A	G	3	7	10	0	0	10	0	0
10	36528549	.	A	G	2	1	3	0	0	3	0	0
10	36558839	.	A	G	4	11	15	0	0	15	0	0
10	36558895	.	G	A	15	13	28	0	1	29	0	0
10	36570469	.	A	G	4	8	12	0	0	12	0	0
10	36572622	.	G	A	6	1	7	0	0	7	0	0
10	36572640	.	C	A	0	7	7	0	4	11	0	0
10	36572814	.	A	T	4	2	6	0	0	6	0	0
10	36575980	.	G	A	2	4	6	0	0	6	0	0
10	36575992	.	C	T	3	1	4	0	1	5	0	0
10	36584462	.	T	C	7	2	9	0	1	10	0	0
10	36613095	.	T	C	9	7	16	0	1	17	0	0
10	36613145	.	G	T	10	7	17	0	2	19	0	0
10	36613164	.	C	T	0	6	6	0	11	17	0	0
10	36613276	.	C	T	8	8	16	0	0	16	0	0
10	36615367	.	G	A	1	0	1	0	0	1	0	0
10	36615907	.	C	A	4	5	9	0	0	9	0	0
10	36618435	.	C	T	0	8	8	0	9	17	0	0
10	36618787	.	C	T	0	4	4	0	0	4	0	0
10	36625258	.	C	A	0	5	5	0	6	11	0	0
10	36625534	.	G	A	2	1	3	0	0	3	0	0
10	36625602	.	C	G	3	7	10	0	1	11	0	0
10	36625761	.	T	A	3	7	10	0	0	10	0	0
10	36626201	.	C	T	2	3	5	0	1	6	0	0
10	36627009	.	G	C	5	4	9	0	0	9	0	0
10	36627314	.	C	T	6	2	8	0	0	8	0	0
10	36627390	.	A	G	4	4	8	0	0	8	0	0
10	36627414	.	C	A	6	3	9	0	0	9	0	0
10	36627517	.	C	T	2	5	7	0	0	7	0	0
10	36627820	.	C	T	6	2	8	0	1	9	0	0
10	36628009	.	C	A	4	5	9	0	0	9	0	0
10	36628012	.	G	A	5	5	10	0	0	10	0	0
10	36628569	.	C	T	0	6	6	0	2	8	0	0
10	36628626	.	G	A	1	0	1	0	1	2	0	0
10	36670106	.	T	C	0	2	2	0	0	2	0	0
10	36673237	.	G	T	2	6	8	0	0	8	0	0
10	36688455	.	C	T	6	4	10	0	0	10	0	0
10	36691372	.	C	A	0	0	0	0	1	1	0	0
10	36695781	.	G	C	12	9	21	0	2	23	0	0
10	36695785	.	C	T	11	12	23	0	0	23	0	0
10	36704842	.	A	G	13	4	17	0	1	18	0	0
10	36708401	.	A	G	7	0	7	0	9	16	0	0
10	36708453	.	C	T	8	7	15	0	0	15	0	0
10	36710559	.	A	C	13	17	30	0	2	32	0	0
10	36710599	.	C	T	16	15	31	0	1	32	0	0
10	36710871	.	G	A	0	24	24	0	15	39	0	0
10	36710893	.	G	T	1	16	17	0	23	40	0	0
10	36711329	.	T	A	4	7	11	0	0	11	0	0
10	36711613	.	C	T	10	7	17	0	1	18	0	0
10	36774339	.	A	C	4	5	9	0	0	9	0	0
10	36774379	.	T	A	1	4	5	0	0	5	0	0
10	36778469	.	A	G	2	1	3	0	0	3	0	0
10	36784948	.	G	A	1	2	3	0	0	3	0	0
10	36784995	.	A	G	1	3	4	0	0	4	0	0
10	36796083	.	A	G	1	4	5	0	0	5	0	0
10	36796131	.	T	A	4	4	8	0	0	8	0	0
10	36800465	.	G	A	11	9	20	0	0	20	0	0
10	36800518	.	C	T	7	8	15	0	2	17	0	0
10	36800600	.	G	A	4	9	13	0	1	14	0	0
10	36800642	.	A	G	5	9	14	0	0	14	0	0
10	36807986	.	G	A	7	7	14	0	1	15	0	0
10	36808032	.	G	A	9	5	14	0	0	14	0	0
10	36808096	.	A	G	1	3	4	0	0	4	0	0
10	36811815	.	A	G	10	8	18	0	1	19	0	0
10	36812214	.	A	C	2	3	5	0	0	5	0	0
10	36814912	.	G	A	3	1	4	0	0	4	0	0
10	36817355	.	C	T	0	10	10	0	2	12	0	0
10	36817530	.	C	T	2	6	8	0	0	8	0	0
10	36817940	.	T	C	4	6	10	0	1	11	0	0
10	36817979	.	T	G	2	1	3	0	0	3	0	0
10	36819671	.	C	T	4	5	9	0	1	10	0	0
10	36820601	.	C	T	0	6	6	0	7	13	0	0
10	36820611	.	A	G	6	9	15	0	1	16	0	0
10	36820664	.	C	T	3	6	9	0	2	11	0	0
10	36820688	.	C	G	0	6	6	0	4	10	0	0
10	36820736	.	G	A	3	8	11	0	0	11	0	0
10	36820769	.	T	A	4	6	10	0	1	11	0	0
10	36820892	.	G	A	1	1	2	0	0	2	0	0
10	36825650	.	C	T	1	2	3	0	5	8	0	0
10	36825818	.	T	C	2	5	7	0	0	7	0	0
10	36825880	.	G	A	5	5	10	0	0	10	0	0
10	36828227	.	T	C	5	8	13	0	0	13	0	0
10	36828265	.	G	A	4	3	7	0	0	7	0	0
10	36828295	.	G	T	3	3	6	0	2	8	0	0
10	36828469	.	T	C	3	0	3	0	3	6	0	0
10	36828475	.	C	T	3	2	5	0	0	5	0	0
10	36835641	.	A	T	0	2	2	0	0	2	0	0
10	36835740	.	G	A	3	6	9	0	1	10	0	0
10	36838768	.	C	T	2	2	4	0	0	4	0	0
10	36841230	.	G	T	7	6	13	0	1	14	0	0
10	36843114	.	C	G	0	1	1	0	0	1	0	0
10	36848872	.	G	A	1	2	3	0	0	3	0	0
10	36848938	.	A	G	3	2	5	0	1	6	0	0
10	36850674	.	C	T	0	1	1	0	2	3	0	0
10	36850752	.	A	G	8	5	13	0	0	13	0	0
10	36876162	.	A	C	1	0	1	0	2	3	0	0
10	36878362	.	C	A	2	2	4	0	0	4	0	0
10	36878568	.	C	T	6	3	9	0	1	10	0	0
10	36878638	.	T	C	3	0	3	0	3	6	0	0
10	36950935	.	A	T	2	5	7	0	0	7	0	0
10	36951044	.	A	T	2	10	12	0	0	12	0	0
10	36951076	.	G	C	3	7	10	0	0	10	0	0
10	36951223	.	A	C	2	8	10	0	0	10	0	0
10	36951582	.	C	G	7	8	15	0	0	15	0	0
10	36951660	.	T	A	7	6	13	0	0	13	0	0
10	36963456	.	G	A	4	1	5	0	1	6	0	0
10	36967206	.	T	C	2	3	5	0	1	6	0	0
10	36969510	.	T	C	1	1	2	0	0	2	0	0
10	36969519	.	A	G	1	1	2	0	0	2	0	0
10	36974901	.	G	A	1	6	7	0	0	7	0	0
10	36976318	.	G	A	7	6	13	0	0	13	0	0
10	36987831	.	T	G	4	4	8	0	0	8	0	0
10	37007508	.	G	C	4	5	9	0	0	9	0	0
10	37011570	.	G	T	6	7	13	0	0	13	0	0
10	37016308	.	G	A	2	0	2	0	0	2	0	0
10	37016458	.	T	C	1	0	1	0	1	2	0	0
10	37022463	.	G	A	3	5	8	0	0	8	0	0
10	37024367	.	T	C	0	0	0	0	1	1	0	0
10	37028670	.	A	G	2	4	6	0	0	6	0	0
10	37070050	.	T	C	3	2	5	0	0	5	0	0
10	37070656	.	A	T	1	0	1	0	0	1	0	0
10	37107492	.	G	T	0	2	2	0	4	6	0	0
10	37126295	.	C	T	4	7	11	0	0	11	0	0
10	37126307	.	C	T	3	6	9	0	0	9	0	0
10	37137549	.	G	A	0	5	5	0	8	13	0	0
10	37145178	.	G	A	11	14	25	0	0	25	0	0
10	37152081	.	G	A	1	3	4	0	0	4	0	0
10	37152105	.	A	G	5	0	5	0	7	12	0	0
10	37155072	.	G	A	0	8	8	0	6	14	0	0
10	37163252	.	C	A	1	0	1	0	0	1	0	0
10	37167151	.	G	C	8	6	14	0	0	14	0	0
10	37227524	.	C	T	12	7	19	0	2	21	0	0
10	37234093	.	A	G	2	0	2	0	6	8	0	0
10	37236857	.	A	G	3	0	3	0	1	4	0	0
10	37239229	.	G	A	3	5	8	0	0	8	0	0
10	37252054	.	G	A	0	1	1	0	3	4	0	0
10	37253986	.	A	G	2	1	3	0	0	3	0	0
10	37304334	.	T	C	0	2	2	0	1	3	0	0
10	37304379	.	G	T	0	2	2	0	0	2	0	0
10	37304382	.	C	T	0	2	2	0	0	2	0	0
10	37334291	.	G	T	4	2	6	0	0	6	0	0
10	37337473	.	G	A	0	2	2	0	0	2	0	0
10	37361681	.	G	A	0	2	2	0	1	3	0	0
10	37373873	.	G	A	0	2	2	0	2	4	0	0
10	37378252	.	A	T	0	2	2	1	0	3	0	0
10	37394478	.	G	A	1	3	4	0	0	4	0	0
10	37394486	.	G	A	0	4	4	0	1	5	0	0
10	37394535	.	C	T	5	4	9	0	2	11	0	0
10	37764473	.	C	T	11	5	16	0	1	17	0	0
10	37779765	.	A	C	1	2	3	0	0	3	0	0
10	37779778	.	T	A	1	2	3	0	0	3	0	0
10	37783114	.	A	G	7	4	11	0	1	12	0	0
10	37783179	.	A	G	15	0	15	0	11	26	0	0
10	37783323	.	A	G	11	9	20	0	1	21	0	0
10	37783575	.	C	A	3	1	4	0	1	5	0	0
10	37783669	.	C	A	0	4	4	0	0	4	0	0
10	37992653	.	C	T	3	5	8	0	0	8	0	0
10	37992679	.	G	A	0	4	4	0	3	7	0	0
10	37992839	.	A	T	4	3	7	0	2	9	0	0
10	37994630	.	C	T	2	3	5	0	0	5	0	0
10	37997567	.	C	G	4	3	7	0	2	9	0	0
10	38000082	.	C	G	2	1	3	0	0	3	0	0
10	38000084	.	G	T	0	2	2	0	1	3	0	0
10	38003011	.	A	G	9	11	20	0	0	20	0	0
10	38005466	.	A	C	5	3	8	0	0	8	0	0
10	38149713	.	C	A	0	1	1	0	0	1	0	0
10	38149715	.	A	G	0	1	1	0	0	1	0	0
10	38170550	.	C	A	2	2	4	0	0	4	0	0
10	38170574	.	A	G	2	3	5	0	0	5	0	0
10	38170737	.	G	A	5	8	13	0	0	13	0	0
10	38171149	.	G	C	9	0	9	0	5	14	0	0
10	38171196	.	G	A	7	4	11	0	0	11	0	0
10	38171207	.	C	A	3	7	10	0	1	11	0	0
10	38171356	.	A	T	9	13	22	0	0	22	0	0
10	38171490	.	T	A	12	5	17	0	2	19	0	0
10	38173383	.	C	A	0	4	4	0	4	8	0	0
10	38177999	.	C	T	0	6	6	0	8	14	0	0
10	38180732	.	A	T	0	3	3	0	0	3	0	0
10	38199097	.	G	A	4	2	6	0	1	7	0	0
10	38199169	.	T	C	3	1	4	0	1	5	0	0
10	38205149	.	T	C	4	0	4	0	2	6	0	0
10	38211810	.	C	G	2	1	3	0	0	3	0	0
10	38231165	.	C	T	0	1	1	0	1	2	0	0
10	38235957	.	G	C	1	4	5	0	0	5	0	0
10	38243543	.	G	A	2	4	6	0	0	6	0	0
10	38257295	.	G	A	5	4	9	0	4	13	0	0
10	38257509	.	C	G	0	6	6	0	4	10	0	0
10	38257558	.	C	T	5	4	9	0	1	10	0	0
10	38257870	.	T	C	7	16	23	0	0	23	0	0
10	38258729	.	C	G	13	13	26	0	0	26	0	0
10	38259033	.	C	T	5	7	12	0	0	12	0	0
10	38259034	.	A	G	5	7	12	0	0	12	0	0
10	38259204	.	G	A	5	7	12	0	0	12	0	0
10	38259217	.	A	G	4	6	10	0	0	10	0	0
10	38259268	.	G	C	3	3	6	0	0	6	0	0
10	38259276	.	A	G	3	3	6	0	0	6	0	0
10	38259339	.	A	T	5	4	9	0	0	9	0	0
10	38259449	.	A	C	4	0	4	0	9	13	0	0
10	38259451	.	A	G	4	9	13	0	0	13	0	0
10	38259900	.	T	C	9	0	9	0	9	18	0	0
10	38260002	.	G	A	3	3	6	0	1	7	0	0
10	38260210	.	T	A	6	8	14	0	0	14	0	0
10	38260626	.	A	T	8	8	16	0	1	17	0	0
10	38261085	.	T	G	3	3	6	0	0	6	0	0
10	38261109	.	T	C	2	3	5	0	0	5	0	0
10	38261453	.	G	A	4	4	8	0	1	9	0	0
10	38261485	.	C	T	7	4	11	0	0	11	0	0
10	38261495	.	T	G	7	3	10	0	0	10	0	0
10	38261638	.	G	A	3	3	6	0	0	6	0	0
10	38261696	.	C	T	6	4	10	0	0	10	0	0
10	38432803	.	T	A	2	3	5	0	0	5	0	0
10	38665994	.	C	T	1	0	1	0	0	1	0	0
10	38666063	.	T	C	6	9	15	0	2	17	0	0
10	38686126	.	T	C	6	2	8	0	0	8	0	0
10	38695152	.	A	C	11	10	21	0	0	21	0	0
10	38695510	.	A	G	15	14	29	0	0	29	0	0
10	38695656	.	A	G	15	7	22	0	1	23	0	0
10	38695877	.	C	T	10	8	18	0	0	18	0	0
10	38695888	.	C	T	10	6	16	0	0	16	0	0
10	38696072	.	T	A	1	2	3	0	0	3	0	0
10	38712431	.	C	T	2	2	4	0	0	4	0	0
10	38723491	.	T	C	4	4	8	0	0	8	0	0
10	38723539	.	T	C	1	1	2	0	0	2	0	0
10	38726441	.	C	T	1	0	1	0	0	1	0	0
10	38775780	.	C	G	3	5	8	0	0	8	0	0
10	38885821	.	T	C	4	4	8	0	1	9	0	0
10	38891454	.	C	A	4	2	6	0	0	6	0	0
10	38922043	.	G	A	0	4	4	0	4	8	0	0
10	38924557	.	C	T	4	1	5	0	0	5	0	0
10	38924560	.	T	C	4	1	5	0	0	5	0	0
10	38934391	.	A	G	3	1	4	0	0	4	0	0
10	38940232	.	A	G	4	7	11	0	1	12	0	0
10	38943265	.	C	G	11	6	17	0	0	17	0	0
10	38950115	.	T	C	2	1	3	0	0	3	0	0
10	38950430	.	G	A	0	12	12	0	10	22	0	0
10	38950484	.	A	G	9	11	20	0	1	21	0	0
10	38950538	.	T	C	5	2	7	0	0	7	0	0
10	38954126	.	C	T	9	6	15	0	1	16	0	0
10	38954141	.	T	C	9	7	16	0	1	17	0	0
10	38954798	.	T	C	11	3	14	0	0	14	0	0
10	38954801	.	C	T	11	3	14	0	1	15	0	0
10	38957061	.	T	C	14	11	25	0	1	26	0	0
10	38957127	.	G	A	0	13	13	0	13	26	0	0
10	38957193	.	C	T	2	7	9	0	1	10	0	0
10	38957748	.	A	C	5	15	20	0	0	20	0	0
10	38957754	.	A	C	6	14	20	0	0	20	0	0
10	38969552	.	A	C	35	13	48	0	4	52	0	0
10	38969598	.	A	C	23	25	48	0	3	51	0	0
10	38969629	.	C	T	18	27	45	0	2	47	0	0
10	38969685	.	A	G	26	19	45	0	0	45	0	0
10	38969778	.	C	T	20	25	45	0	3	48	0	0
10	39011484	.	C	T	7	20	27	0	3	30	0	0
10	39086981	.	G	A	24	11	35	0	0	35	0	0
10	39087391	.	A	G	32	0	32	0	27	59	0	0
10	39087625	.	T	A	26	26	52	0	1	53	0	0
10	39087659	.	T	A	20	25	45	0	2	47	0	0
10	39091684	.	C	A	3	5	8	0	0	8	0	0
10	39091792	.	A	G	0	0	0	0	2	2	0	0
10	39098798	.	C	T	1	2	3	0	0	3	0	0
10	39102672	.	G	C	2	1	3	0	0	3	0	0
10	39102776	.	T	C	2	5	7	0	0	7	0	0
10	39110452	.	G	C	1	2	3	0	0	3	0	0
10	39115595	.	G	T	3	3	6	0	0	6	0	0
10	39115596	.	T	C	3	3	6	0	0	6	0	0
10	39120132	.	T	C	2	7	9	0	0	9	0	0
10	39130460	.	C	T	10	15	25	0	1	26	0	0
10	39140465	.	A	G	1	0	1	0	0	1	0	0
10	39140741	.	T	C	2	1	3	0	0	3	0	0
10	39152038	.	A	G	4	2	6	0	0	6	0	0
10	39153470	.	G	A	4	3	7	0	0	7	0	0
10	39153494	.	A	G	3	3	6	0	0	6	0	0
10	39153599	.	T	A	6	5	11	0	0	11	0	0
10	39175139	.	T	C	1	3	4	0	0	4	0	0
10	39177816	.	T	C	1	2	3	0	0	3	0	0
10	39179925	.	T	A	5	2	7	0	1	8	0	0
10	39179992	.	G	C	7	6	13	0	0	13	0	0
10	39182173	.	A	G	8	12	20	0	0	20	0	0
10	39182310	.	C	A	11	6	17	0	0	17	0	0
10	39182342	.	A	T	9	4	13	0	0	13	0	0
10	39182401	.	C	A	12	5	17	0	1	18	0	0
10	39182602	.	G	A	0	3	3	0	7	10	0	0
10	39182703	.	T	G	5	0	5	0	3	8	0	0
10	39199639	.	G	A	0	3	3	0	3	6	0	0
10	39205021	.	C	T	2	4	6	0	0	6	0	0
10	39205256	.	C	G	1	4	5	0	0	5	0	0
10	39206945	.	A	G	9	5	14	0	1	15	0	0
10	39207104	.	C	A	2	4	6	0	0	6	0	0
10	39207114	.	C	A	2	4	6	0	0	6	0	0
10	39207397	.	T	A	5	2	7	0	0	7	0	0
10	39216625	.	C	T	6	9	15	0	1	16	0	0
10	39219390	.	T	C	3	1	4	0	0	4	0	0
10	39219540	.	T	A	5	9	14	0	1	15	0	0
10	39222134	.	A	C	1	3	4	0	0	4	0	0
10	39222182	.	A	G	8	16	24	0	1	25	0	0
10	39225504	.	A	C	12	9	21	0	0	21	0	0
10	39225555	.	T	C	14	11	25	0	0	25	0	0
10	39231387	.	G	A	5	5	10	0	1	11	0	0
10	39249061	.	G	T	3	2	5	0	0	5	0	0
10	39266350	.	G	T	0	4	4	0	2	6	0	0
10	39266422	.	C	T	1	2	3	0	0	3	0	0
10	39266669	.	A	C	4	3	7	0	0	7	0	0
10	39266862	.	T	C	1	2	3	0	0	3	0	0
10	39274864	.	A	G	2	1	3	0	0	3	0	0
10	39277087	.	C	G	0	4	4	0	0	4	0	0
10	39284092	.	T	G	1	0	1	0	3	4	0	0
10	39284104	.	C	G	2	0	2	0	4	6	0	0
10	39285246	.	A	G	3	5	8	0	0	8	0	0
10	39285288	.	T	C	2	3	5	0	0	5	0	0
10	39287100	.	C	T	1	1	2	0	0	2	0	0
10	39293335	.	T	C	3	4	7	0	0	7	0	0
10	39293358	.	G	A	2	3	5	0	0	5	0	0
10	39293746	.	G	A	3	6	9	0	0	9	0	0
10	39293751	.	A	G	2	4	6	0	2	8	0	0
10	39294067	.	T	G	1	2	3	0	2	5	0	0
10	39307378	.	T	C	1	3	4	0	0	4	0	0
10	39476639	.	A	G	4	5	9	0	0	9	0	0
10	39904774	.	G	A	0	1	1	0	0	1	0	0
10	39904780	.	C	T	0	2	2	0	0	2	0	0
10	39904851	.	A	T	1	4	5	0	0	5	0	0
10	39904915	.	A	G	8	13	21	0	0	21	0	0
10	39904966	.	T	C	3	11	14	0	0	14	0	0
10	39905085	.	A	T	5	4	9	0	1	10	0	0
10	39905089	.	T	G	4	5	9	0	1	10	0	0
10	40089829	.	C	A	0	1	1	0	0	1	0	0
10	40089838	.	C	T	1	1	2	0	0	2	0	0
10	40097252	.	C	A	1	0	1	0	0	1	0	0
10	40109378	.	C	T	3	6	9	0	0	9	0	0
10	40109439	.	G	A	1	6	7	0	7	14	0	0
10	40110115	.	A	C	1	5	6	0	0	6	0	0
10	40110226	.	T	C	5	3	8	0	0	8	0	0
10	40110243	.	A	T	2	3	5	0	3	8	0	0
10	40110397	.	A	G	2	2	4	0	0	4	0	0
10	40110726	.	C	A	4	1	5	0	1	6	0	0
10	40110741	.	G	A	3	3	6	0	0	6	0	0
10	40110768	.	A	G	1	4	5	0	0	5	0	0
10	40111412	.	G	A	0	4	4	0	1	5	0	0
10	40111437	.	T	A	2	6	8	0	0	8	0	0
10	40111549	.	T	C	6	1	7	1	0	8	0	0
10	40111610	.	C	T	3	4	7	0	0	7	0	0
10	40111666	.	G	C	4	6	10	0	0	10	0	0
10	40111706	.	A	G	5	5	10	0	0	10	0	0
10	40111732	.	C	T	7	4	11	0	0	11	0	0
10	40111904	.	G	T	2	1	3	0	0	3	0	0
10	40111964	.	C	A	2	3	5	0	0	5	0	0
10	40112096	.	C	A	4	2	6	0	1	7	0	0
10	40112121	.	A	G	3	4	7	0	1	8	0	0
10	40112157	.	G	A	4	4	8	0	0	8	0	0
10	40112159	.	T	A	4	4	8	0	0	8	0	0
10	40112347	.	A	T	5	2	7	0	0	7	0	0
10	40112638	.	C	T	2	5	7	0	0	7	0	0
10	40112769	.	T	G	1	3	4	0	1	5	0	0
10	40112793	.	G	A	1	2	3	0	0	3	0	0
10	40113113	.	C	G	1	6	7	0	0	7	0	0
10	40113161	.	C	A	4	4	8	0	1	9	0	0
10	40113197	.	G	A	0	3	3	0	4	7	0	0
10	40113408	.	A	G	5	4	9	0	0	9	0	0
10	40113446	.	T	C	2	3	5	0	0	5	0	0
10	40113592	.	G	A	2	5	7	0	0	7	0	0
10	40113713	.	A	G	1	3	4	0	0	4	0	0
10	40204788	.	A	G	1	3	4	0	0	4	0	0
10	40204845	.	G	A	0	2	2	0	2	4	0	0
10	40236068	.	A	G	5	0	5	0	7	12	0	0
10	40262052	.	T	C	3	3	6	0	1	7	0	0
10	40266160	.	A	G	4	2	6	0	0	6	0	0
10	40274541	.	G	A	0	11	11	0	10	21	0	0
10	40275055	.	G	C	0	4	4	0	6	10	0	0
10	40275070	.	T	G	6	2	8	0	0	8	0	0
10	40275158	.	G	A	0	5	5	0	7	12	0	0
10	40290969	.	G	A	1	0	1	0	0	1	0	0
10	40296645	.	T	C	0	2	2	0	0	2	0	0
10	40296841	.	G	A	0	0	0	0	3	3	0	0
10	40303980	.	A	G	0	1	1	0	0	1	0	0
10	40307553	.	T	C	1	0	1	0	0	1	0	0
10	40307622	.	C	T	3	3	6	0	0	6	0	0
10	40314175	.	A	C	2	8	10	0	0	10	0	0
10	40314177	.	A	C	2	8	10	0	0	10	0	0
10	40314405	.	G	A	0	1	1	0	0	1	0	0
10	40314407	.	G	T	0	1	1	0	0	1	0	0
10	40316924	.	T	G	3	4	7	0	0	7	0	0
10	40316968	.	T	C	5	3	8	0	0	8	0	0
10	40317095	.	G	T	7	8	15	0	0	15	0	0
10	40317285	.	A	T	7	5	12	0	0	12	0	0
10	40317323	.	A	G	1	1	2	0	4	6	0	0
10	40822252	.	C	T	0	5	5	0	7	12	0	0
10	40826436	.	A	G	6	8	14	0	1	15	0	0
10	40826494	.	A	G	6	7	13	0	0	13	0	0
10	40826516	.	A	G	8	6	14	0	0	14	0	0
10	40826589	.	C	T	17	6	23	0	2	25	0	0
10	40826590	.	A	G	19	6	25	0	0	25	0	0
10	40859503	.	G	A	1	2	3	0	1	4	0	0
10	40859601	.	T	C	5	1	6	0	3	9	0	0
10	40859633	.	C	T	2	2	4	0	0	4	0	0
10	40859647	.	A	C	1	2	3	0	0	3	0	0
10	40859722	.	A	G	8	5	13	0	1	14	0	0
10	40859885	.	A	G	10	7	17	0	0	17	0	0
10	40859968	.	T	C	16	8	24	0	1	25	0	0
10	40861563	.	C	A	2	3	5	0	0	5	0	0
10	40861650	.	G	A	8	4	12	0	0	12	0	0
10	40866244	.	T	C	4	0	4	0	4	8	0	0
10	41089380	.	A	G	6	2	8	0	0	8	0	0
10	41099458	.	A	G	2	3	5	0	0	5	0	0
10	41112076	.	T	C	3	0	3	0	4	7	0	0
10	41115360	.	C	A	1	2	3	0	0	3	0	0
10	41126435	.	G	T	1	0	1	0	0	1	0	0
10	41136356	.	G	A	2	1	3	0	0	3	0	0
10	41136398	.	A	G	4	4	8	0	0	8	0	0
10	41156454	.	C	G	0	6	6	0	0	6	0	0
10	41156693	.	A	G	5	2	7	0	0	7	0	0
10	41156857	.	G	T	2	2	4	0	0	4	0	0
10	41181597	.	C	T	2	1	3	0	0	3	0	0
10	41190192	.	G	C	1	2	3	0	0	3	0	0
10	41192701	.	T	C	2	2	4	0	0	4	0	0
10	41192704	.	T	A	2	2	4	0	0	4	0	0
10	41279962	.	T	C	2	3	5	0	0	5	0	0
10	41279966	.	C	G	2	3	5	0	0	5	0	0
10	41362665	.	G	A	15	15	30	0	1	31	0	0
10	41362763	.	C	G	12	12	24	0	1	25	0	0
10	41362771	.	C	T	0	11	11	0	10	21	0	0
10	41362839	.	A	G	12	10	22	0	3	25	0	0
10	41362986	.	T	A	2	0	2	0	0	2	0	0
10	41379918	.	G	C	5	7	12	0	0	12	0	0
10	41397380	.	G	T	3	2	5	0	1	6	0	0
10	41397404	.	G	A	3	6	9	0	1	10	0	0
10	41397443	.	G	A	3	6	9	0	0	9	0	0
10	41399919	.	G	A	3	1	4	0	0	4	0	0
10	41399968	.	G	T	9	8	17	0	1	18	0	0
10	41409470	.	T	A	2	4	6	0	0	6	0	0
10	41409781	.	C	T	2	3	5	0	0	5	0	0
10	41419075	.	C	T	0	1	1	0	0	1	0	0
10	41605007	.	T	A	2	0	2	0	1	3	0	0
10	41605015	.	C	T	2	0	2	0	0	2	0	0
10	41605802	.	A	C	5	2	7	0	0	7	0	0
10	41605886	.	C	T	3	2	5	0	0	5	0	0
10	41606172	.	G	C	1	2	3	0	0	3	0	0
10	41606765	.	G	A	1	4	5	0	0	5	0	0
10	41606793	.	A	T	1	2	3	0	0	3	0	0
10	41607134	.	T	G	0	3	3	0	0	3	0	0
10	41607357	.	C	T	7	8	15	0	0	15	0	0
10	41607396	.	C	T	8	3	11	0	0	11	0	0
10	41607617	.	C	T	4	3	7	0	0	7	0	0
10	41607787	.	A	C	3	3	6	0	0	6	0	0
10	41607903	.	C	A	8	8	16	0	1	17	0	0
10	41607966	.	T	C	12	11	23	0	0	23	0	0
10	41608320	.	T	C	3	3	6	1	0	7	0	0
10	41608479	.	G	A	5	5	10	0	0	10	0	0
10	41608513	.	A	G	3	1	4	0	10	14	0	0
10	41608561	.	A	T	5	12	17	0	0	17	0	0
10	41608600	.	C	A	4	4	8	0	2	10	0	0
10	41608827	.	C	T	2	3	5	0	0	5	0	0
10	41735272	.	C	T	2	4	6	0	0	6	0	0
10	41735419	.	C	T	2	2	4	0	0	4	0	0
10	41735434	.	A	G	1	2	3	0	0	3	0	0
10	41765973	.	C	T	5	3	8	0	0	8	0	0
10	41766022	.	A	G	4	0	4	0	2	6	0	0
10	41801475	.	C	T	1	0	1	0	0	1	0	0
10	41816988	.	C	T	5	5	10	0	0	10	0	0
10	41816991	.	G	A	5	2	7	0	3	10	0	0
10	41817054	.	T	C	2	3	5	0	0	5	0	0
10	41817094	.	C	A	2	2	4	0	0	4	0	0
10	41830403	.	G	A	13	9	22	0	1	23	0	0
10	41830435	.	C	T	14	10	24	0	0	24	0	0
10	41832092	.	C	A	7	7	14	0	0	14	0	0
10	41834276	.	G	T	6	7	13	0	0	13	0	0
10	41834300	.	C	T	3	3	6	0	0	6	0	0
10	41835199	.	C	T	5	6	11	0	0	11	0	0
10	41835283	.	G	T	2	0	2	0	0	2	0	0
10	41841119	.	G	A	4	3	7	0	0	7	0	0
10	41841178	.	G	T	8	8	16	0	1	17	0	0
10	41841214	.	G	C	8	4	12	0	0	12	0	0
10	41846770	.	A	G	3	6	9	0	0	9	0	0
10	41865722	.	G	A	4	5	9	0	0	9	0	0
10	41891658	.	C	G	0	1	1	0	2	3	0	0
10	41902778	.	A	C	2	0	2	0	3	5	0	0
10	41914189	.	C	G	2	3	5	0	1	6	0	0
10	41921139	.	G	A	2	2	4	0	3	7	0	0
10	41921408	.	C	G	1	1	2	0	0	2	0	0
10	41926939	.	C	G	3	2	5	0	0	5	0	0
10	41933320	.	T	A	1	1	2	0	0	2	0	0
10	41959448	.	A	G	2	2	4	0	0	4	0	0
10	41983482	.	A	C	5	4	9	0	2	11	0	0
10	41983961	.	C	A	2	2	4	0	0	4	0	0
10	41984251	.	G	A	6	3	9	0	0	9	0	0
10	41995252	.	C	T	5	3	8	0	0	8	0	0
10	41995624	.	A	G	3	2	5	0	0	5	0	0
10	41995644	.	A	T	1	3	4	0	1	5	0	0
10	41995678	.	A	G	2	3	5	0	0	5	0	0
10	41995741	.	A	G	1	0	1	0	2	3	0	0
10	42002429	.	G	A	0	2	2	0	4	6	0	0
10	42002903	.	C	T	4	3	7	0	0	7	0	0
10	42010719	.	A	T	3	2	5	0	0	5	0	0
10	42010915	.	C	G	3	6	9	0	0	9	0	0
10	42011054	.	T	C	5	2	7	0	1	8	0	0
10	42011060	.	G	T	4	3	7	0	0	7	0	0
10	42017620	.	C	T	1	3	4	0	0	4	0	0
10	42017854	.	C	T	4	2	6	0	0	6	0	0
10	42019966	.	A	C	3	4	7	0	0	7	0	0
10	42020451	.	C	T	4	3	7	0	1	8	0	0
10	42020565	.	C	T	2	6	8	0	0	8	0	0
10	42020592	.	G	T	4	2	6	0	0	6	0	0
10	42021273	.	A	C	3	2	5	0	0	5	0	0
10	42021321	.	G	A	3	7	10	0	0	10	0	0
10	42021384	.	T	C	2	4	6	0	0	6	0	0
10	42021485	.	A	T	2	3	5	0	0	5	0	0
10	42021515	.	T	A	2	1	3	0	1	5	1	0
10	42021611	.	C	A	5	5	10	0	0	10	0	0
10	42030956	.	C	T	5	2	7	0	0	7	0	0
10	42036689	.	G	T	0	1	1	0	0	1	0	0
10	42039072	.	A	C	0	0	0	0	1	1	0	0
10	42044409	.	A	G	11	12	23	0	1	24	0	0
10	42044480	.	G	A	13	7	20	0	1	21	0	0
10	42044859	.	G	A	11	5	16	0	3	19	0	0
10	42045041	.	G	C	10	9	19	0	0	19	0	0
10	42045254	.	C	T	1	5	6	0	2	8	0	0
10	42045300	.	G	C	3	4	7	0	1	8	0	0
10	42045370	.	G	A	2	6	8	0	0	8	0	0
10	42045625	.	G	A	0	0	0	0	1	1	0	0
10	42090214	.	A	G	9	9	18	0	1	19	0	0
10	42090222	.	A	G	12	10	22	0	2	24	0	0
10	42090315	.	T	C	9	14	23	0	0	23	0	0
10	42093928	.	A	G	9	7	16	0	0	16	0	0
10	42101122	.	A	G	1	4	5	0	0	5	0	0
10	42104371	.	C	T	0	4	4	0	2	6	0	0
10	42105921	.	C	T	5	6	11	0	0	11	0	0
10	42107853	.	C	T	5	5	10	0	0	10	0	0
10	42107884	.	C	T	0	4	4	0	7	11	0	0
10	42108029	.	G	A	3	3	6	0	0	6	0	0
10	42108077	.	T	A	5	5	10	0	0	10	0	0
10	42108119	.	T	C	0	2	2	0	0	2	0	0
10	42111601	.	G	A	7	8	15	0	1	16	0	0
10	42111610	.	A	T	11	7	18	0	0	18	0	0
10	42111669	.	C	A	10	10	20	0	0	20	0	0
10	42111673	.	G	A	11	8	19	0	0	19	0	0
10	42111883	.	C	T	1	1	2	0	5	7	0	0
10	42111895	.	G	A	1	4	5	0	0	5	0	0
10	42112227	.	G	T	5	8	13	0	1	14	0	0
10	42114366	.	G	A	3	4	7	0	0	7	0	0
10	42119810	.	C	T	6	3	9	0	0	9	0	0
10	42119816	.	A	G	2	5	7	0	0	7	0	0
10	42123334	.	T	C	2	0	2	0	1	3	0	0
10	42123388	.	A	G	7	5	12	0	2	14	0	0
10	42131297	.	A	T	9	3	12	1	0	13	0	0
10	42134574	.	A	G	4	2	6	0	0	6	0	0
10	42135035	.	C	T	2	2	4	0	0	4	0	0
10	42136734	.	C	A	2	2	4	0	1	5	0	0
10	42136936	.	C	T	1	1	2	0	2	4	0	0
10	42136939	.	T	C	1	1	2	0	2	4	0	0
10	42137050	.	G	C	0	7	7	0	0	7	0	0
10	42138221	.	C	T	0	3	3	0	3	6	0	0
10	42140199	.	G	A	4	1	5	0	0	5	0	0
10	42196374	.	C	T	1	2	3	0	14	17	0	0
10	42196404	.	T	C	12	0	12	0	6	18	0	0
10	42196524	.	A	G	8	4	12	0	1	13	0	0
10	42199981	.	C	T	2	1	3	0	0	3	0	0
10	42237263	.	C	T	0	1	1	0	1	2	0	0
10	42378334	.	A	T	34	40	74	0	1	75	0	0
10	42501067	.	A	G	10	5	15	0	0	15	0	0
10	42501365	.	A	G	12	11	23	0	1	24	0	0
10	42505845	.	T	C	7	5	12	0	0	12	0	0
10	42507081	.	T	C	6	8	14	0	0	14	0	0
10	42507120	.	T	C	9	7	16	0	0	16	0	0
10	42507141	.	A	G	8	7	15	0	1	16	0	0
10	42519641	.	C	T	5	5	10	0	0	10	0	0
10	42522016	.	T	C	11	6	17	0	0	17	0	0
10	42526213	.	C	T	8	6	14	0	0	14	0	0
10	42531713	.	C	T	10	11	21	0	3	24	0	0
10	42539630	.	C	T	22	32	54	0	4	58	0	0
10	42539849	.	C	T	19	19	38	0	1	39	0	0
10	42539955	.	T	C	15	13	28	0	0	28	0	0
10	42540132	.	A	T	17	19	36	0	0	36	0	0
10	42540172	.	A	C	15	15	30	0	0	30	0	0
10	42540726	.	A	G	8	4	12	0	0	12	0	0
10	42542568	.	A	C	8	5	13	0	1	14	0	0
10	42542883	.	C	T	1	0	1	0	0	1	0	0
10	42548171	.	T	G	3	0	3	0	1	4	0	0
10	42548210	.	A	T	3	1	4	0	0	4	0	0
10	42548213	.	A	G	3	0	3	0	1	4	0	0
10	42549515	.	A	G	1	0	1	0	1	2	0	0
10	42550828	.	C	T	4	2	6	0	1	7	0	0
10	42555504	.	A	G	4	0	4	0	7	11	0	0
10	42555543	.	G	A	0	3	3	0	4	7	0	0
10	42555728	.	G	A	0	3	3	0	5	8	0	0
10	42555732	.	G	T	5	3	8	0	0	8	0	0
10	42631549	.	A	G	2	1	3	0	0	3	0	0
10	42650402	.	A	C	2	2	4	0	0	4	0	0
10	42656885	.	A	G	1	2	3	0	0	3	0	0
10	42694552	.	C	A	2	4	6	0	1	7	0	0
10	42700932	.	C	T	3	3	6	0	0	6	0	0
10	42701216	.	C	T	3	7	10	0	0	10	0	0
10	42701315	.	T	A	0	2	2	0	1	3	0	0
10	42704608	.	T	G	1	3	4	0	0	4	0	0
10	42704622	.	A	T	2	4	6	0	0	6	0	0
10	42704848	.	T	C	9	10	19	0	0	19	0	0
10	42704929	.	C	T	9	6	15	0	0	15	0	0
10	42709610	.	T	C	2	4	6	0	1	7	0	0
10	42709634	.	T	C	4	3	7	0	0	7	0	0
10	42715679	.	C	T	0	13	13	0	6	19	0	0
10	42715688	.	T	C	0	15	15	0	3	18	0	0
10	42716271	.	T	C	2	6	8	0	0	8	0	0
10	42716278	.	T	G	3	0	3	0	5	8	0	0
10	42738132	.	T	A	5	8	13	0	0	13	0	0
10	42739938	.	C	T	2	8	10	0	0	10	0	0
10	42740302	.	T	A	11	11	22	0	0	22	0	0
10	42741347	.	T	G	22	11	33	0	7	40	0	0
10	42741417	.	T	A	21	22	43	0	0	43	0	0
10	42741519	.	G	T	29	15	44	0	0	44	0	0
10	42741528	.	G	T	15	25	40	0	2	42	0	0
10	42741661	.	C	A	18	11	29	0	3	32	0	0
10	42741662	.	G	A	11	19	30	0	2	32	0	0
10	42741840	.	T	A	17	27	44	0	2	46	0	0
10	42741872	.	A	G	16	20	36	0	1	37	0	0
10	42741918	.	C	T	18	5	23	0	1	24	0	0
10	42741938	.	A	C	7	0	7	0	14	21	0	0
10	42742101	.	T	A	3	2	5	0	0	5	0	0
10	42742198	.	G	A	2	2	4	0	0	4	0	0
10	42742319	.	A	T	1	9	10	0	1	11	0	0
10	42742472	.	C	G	18	8	26	0	0	26	0	0
10	42742544	.	T	C	9	13	22	0	2	24	0	0
10	42742560	.	T	C	18	10	28	0	0	28	0	0
10	42742835	.	C	T	8	3	11	0	0	11	0	0
10	42742851	.	G	A	7	3	10	0	0	10	0	0
10	42743666	.	G	T	4	4	8	0	0	8	0	0
10	42744720	.	G	C	7	10	17	0	0	17	0	0
10	42745003	.	A	G	8	4	12	0	0	12	0	0
10	42745018	.	T	A	4	5	9	0	0	9	0	0
10	42745151	.	C	T	11	8	19	0	0	19	0	0
10	42748084	.	A	T	14	11	25	0	0	25	0	0
10	42748096	.	A	G	10	7	17	0	4	21	0	0
10	42748120	.	A	G	12	7	19	0	2	21	0	0
10	42775877	.	A	C	1	0	1	0	0	1	0	0
10	42775891	.	C	A	1	0	1	0	0	1	0	0
10	42873937	.	T	C	1	3	4	0	1	5	0	0
10	42876743	.	G	C	2	2	4	0	0	4	0	0
10	42901192	.	G	A	2	2	4	0	0	4	0	0
10	42901207	.	C	T	2	2	4	0	0	4	0	0
10	42902792	.	T	C	1	0	1	0	0	1	0	0
10	42930781	.	T	C	7	0	7	0	9	16	0	0
10	42930814	.	T	C	12	6	18	0	0	18	0	0
10	42930828	.	T	C	3	13	16	0	0	16	0	0
10	42930933	.	T	C	2	4	6	0	0	6	0	0
10	42931224	.	T	A	1	3	4	0	0	4	0	0
10	42931278	.	T	C	3	2	5	0	0	5	0	0
10	42931315	.	T	A	4	7	11	0	0	11	0	0
10	42992877	.	T	C	1	1	2	0	1	3	0	0
10	43044188	.	G	T	3	2	5	0	0	5	0	0
10	43044206	.	T	C	3	2	5	0	0	5	0	0
10	43047704	.	T	A	1	4	5	0	0	5	0	0
10	43057697	.	C	T	1	1	2	0	0	2	0	0
10	43117724	.	C	T	2	3	5	0	0	5	0	0
10	43127066	.	T	G	0	0	0	0	1	1	0	0
10	43151516	.	G	A	0	4	4	0	1	5	0	0
10	43157401	.	C	G	6	5	11	0	0	11	0	0
10	43157426	.	C	A	2	2	4	0	0	4	0	0
10	43225115	.	C	G	1	1	2	0	0	2	0	0
10	43225572	.	G	A	1	1	2	0	1	3	0	0
10	43231022	.	G	A	2	4	6	0	0	6	0	0
10	43231024	.	T	A	2	4	6	0	0	6	0	0
10	43231279	.	A	G	1	0	1	0	2	3	0	0
10	43231317	.	C	A	1	2	3	0	0	3	0	0
10	43231653	.	C	T	2	2	4	0	0	4	0	0
10	43231682	.	G	A	3	2	5	0	0	5	0	0
10	43231837	.	T	G	0	2	2	0	0	2	0	0
10	43231887	.	C	T	1	3	4	0	0	4	0	0
10	43231919	.	G	A	1	3	4	0	0	4	0	0
10	43232434	.	A	T	1	5	6	0	0	6	0	0
10	43232452	.	T	C	1	4	5	0	0	5	0	0
10	43232470	.	G	C	1	4	5	0	0	5	0	0
10	43248504	.	G	A	3	2	5	0	0	5	0	0
10	43248510	.	A	G	3	0	3	0	3	6	0	0
10	43270303	.	G	C	1	2	3	0	0	3	0	0
10	43270445	.	G	A	6	2	8	0	1	9	0	0
10	43355958	.	C	G	0	3	3	0	7	10	0	0
10	43372493	.	G	A	3	4	7	0	1	8	0	0
10	43375407	.	T	A	0	1	1	0	0	1	0	0
10	43499917	.	G	T	1	3	4	0	0	4	0	0
10	43545434	.	G	C	3	4	7	0	0	7	0	0
10	43545446	.	T	A	4	2	6	0	1	7	0	0
10	43545577	.	C	A	0	4	4	0	3	7	0	0
10	43548297	.	G	A	2	5	7	0	0	7	0	0
10	43548344	.	T	C	3	2	5	0	0	5	0	0
10	43548352	.	C	T	2	3	5	0	0	5	0	0
10	43548488	.	A	T	3	3	6	0	0	6	0	0
10	43548508	.	A	G	4	3	7	0	0	7	0	0
10	43549060	.	G	A	3	4	7	0	1	8	0	0
10	43549782	.	G	A	4	3	7	0	0	7	0	0
10	43549798	.	G	A	3	3	6	0	0	6	0	0
10	43549991	.	G	T	1	3	4	0	0	4	0	0
10	43558079	.	G	T	1	1	2	0	0	2	0	0
10	43995769	.	T	A	4	4	8	0	0	8	0	0
10	43999511	.	T	C	8	4	12	0	0	12	0	0
10	43999628	.	T	C	5	4	9	0	0	9	0	0
10	43999640	.	G	T	5	3	8	0	1	9	0	0
10	44002836	.	G	A	0	1	1	0	0	1	0	0
10	44047141	.	T	C	3	1	4	0	0	4	0	0
10	44057318	.	C	T	6	5	11	0	0	11	0	0
10	44131346	.	A	G	2	2	4	0	0	4	0	0
10	44146313	.	C	T	2	2	4	0	0	4	0	0
10	44180299	.	C	T	14	13	27	0	1	28	0	0
10	44189322	.	G	A	3	7	10	0	1	11	0	0
10	44303571	.	T	G	8	7	15	0	1	16	0	0
10	44303616	.	A	G	0	2	2	0	0	2	0	0
10	44314569	.	C	T	1	3	4	0	0	4	0	0
10	44314579	.	A	G	3	1	4	0	0	4	0	0
10	44320823	.	G	C	4	5	9	0	0	9	0	0
10	44337487	.	C	G	1	7	8	0	0	8	0	0
10	44337710	.	G	A	4	2	6	0	0	6	0	0
10	44340944	.	C	T	3	1	4	0	0	4	0	0
10	44345005	.	C	T	0	2	2	0	4	6	0	0
10	44348351	.	G	A	1	2	3	0	0	3	0	0
10	44353914	.	G	A	3	6	9	0	1	10	0	0
10	44354053	.	G	C	5	5	10	0	0	10	0	0
10	44354718	.	T	C	1	0	1	0	3	4	0	0
10	44363242	.	G	T	9	7	16	0	0	16	0	0
10	44364604	.	A	T	3	2	5	0	0	5	0	0
10	44364610	.	C	T	2	0	2	0	1	3	0	0
10	44371710	.	G	T	0	10	10	0	14	24	0	0
10	44375738	.	T	G	6	0	6	0	6	12	0	0
10	44375785	.	G	A	0	3	3	0	2	5	0	0
10	44377942	.	G	C	7	11	18	0	0	18	0	0
10	44377991	.	C	T	0	6	6	0	0	6	0	0
10	44378020	.	G	T	0	4	4	0	3	7	0	0
10	44409402	.	C	G	1	1	2	0	0	2	0	0
10	44410082	.	C	T	2	3	5	0	0	5	0	0
10	44410088	.	G	A	3	2	5	0	0	5	0	0
10	44410241	.	G	A	1	0	1	0	0	1	0	0
10	44437145	.	T	C	9	8	17	0	0	17	0	0
10	44465477	.	C	T	0	1	1	0	1	2	0	0
10	44466844	.	G	A	2	5	7	0	0	7	0	0
10	44503882	.	G	A	7	7	14	0	1	15	0	0
10	44513402	.	T	C	8	0	8	0	7	15	0	0
10	44513421	.	C	T	0	8	8	0	10	18	0	0
10	44515911	.	G	C	4	6	10	0	0	10	0	0
10	44515927	.	T	C	3	5	8	0	1	9	0	0
10	44516001	.	C	T	0	4	4	0	5	9	0	0
10	44516270	.	G	T	2	2	4	0	1	5	0	0
10	44516535	.	A	T	7	2	9	0	0	9	0	0
10	44516907	.	G	T	2	3	5	0	0	5	0	0
10	44516908	.	T	C	2	1	3	0	2	5	0	0
10	44517092	.	G	A	2	4	6	0	0	6	0	0
10	44581983	.	C	G	3	0	3	0	0	3	0	0
10	44640688	.	A	C	4	8	12	0	1	13	0	0
10	44640700	.	C	T	4	10	14	0	0	14	0	0
10	44640725	.	C	A	9	4	13	0	0	13	0	0
10	44640742	.	G	A	0	4	4	0	11	15	0	0
10	44640832	.	G	A	6	6	12	0	1	13	0	0
10	44640873	.	G	A	3	7	10	0	0	10	0	0
10	44640910	.	A	C	8	3	11	0	0	11	0	0
10	44641025	.	G	A	1	1	2	0	1	3	0	0
10	44641815	.	C	A	10	2	12	0	0	12	0	0
10	44648115	.	G	T	0	4	4	0	6	10	0	0
10	44648627	.	C	T	1	1	2	0	0	2	0	0
10	44650913	.	G	A	0	8	8	0	10	18	0	0
10	44652561	.	G	A	0	0	0	0	3	3	0	0
10	44656821	.	C	G	6	4	10	0	0	10	0	0
10	44656863	.	C	T	14	6	20	0	0	20	0	0
10	44656926	.	C	T	0	1	1	0	0	1	0	0
10	44659668	.	A	G	3	6	9	0	1	10	0	0
10	44663082	.	A	G	15	15	30	0	2	32	0	0
10	44665345	.	G	T	0	4	4	0	4	8	0	0
10	44665536	.	A	T	8	10	18	0	1	19	0	0
10	44665620	.	C	T	1	3	4	0	0	4	0	0
10	44667125	.	T	C	4	1	5	0	0	5	0	0
10	44669263	.	G	A	3	4	7	0	0	7	0	0
10	44669402	.	G	A	5	13	18	1	1	20	0	0
10	44669497	.	A	G	6	8	14	0	2	16	0	0
10	44669562	.	G	C	1	3	4	2	0	6	0	0
10	44670359	.	A	G	5	9	14	0	0	14	0	0
10	44670437	.	A	G	20	8	28	1	1	30	0	0
10	44671799	.	G	A	0	10	10	0	12	22	0	0
10	44671818	.	A	C	10	10	20	0	2	22	0	0
10	44672036	.	T	A	21	16	37	0	2	39	0	0
10	44672228	.	G	A	5	9	14	0	0	14	0	0
10	44692308	.	A	T	0	0	0	0	1	1	0	0
10	44692314	.	C	A	0	1	1	0	0	1	0	0
10	44693397	.	G	A	0	1	1	0	0	1	0	0
10	44693445	.	G	A	2	4	6	7	3	16	0	0
10	44693523	.	T	G	25	2	27	1	16	44	0	0
10	44693556	.	C	T	17	9	26	0	7	33	0	0
10	44693688	.	T	G	11	8	19	0	1	20	0	0
10	44693706	.	C	T	7	9	16	0	4	20	0	0
10	44693769	.	C	T	9	15	24	3	5	32	0	0
10	44693868	.	G	A	3	0	3	1	0	4	0	0
10	44694354	.	G	A	0	16	16	0	0	16	0	0
10	44738221	.	G	A	0	2	2	0	3	5	0	0
10	44738290	.	C	T	4	4	8	0	0	8	0	0
10	44745648	.	T	G	0	1	1	0	0	1	0	0
10	44745730	.	A	G	4	0	4	0	3	7	0	0
10	44745774	.	A	T	4	3	7	0	0	7	0	0
10	44899326	.	A	G	1	2	3	0	0	3	0	0
10	44899344	.	A	T	1	2	3	0	0	3	0	0
10	44900198	.	C	G	1	3	4	0	0	4	0	0
10	44900254	.	G	A	1	5	6	0	0	6	0	0
10	44900279	.	G	A	4	2	6	0	0	6	0	0
10	44900534	.	T	A	0	2	2	0	0	2	0	0
10	44900536	.	A	T	0	2	2	0	0	2	0	0
10	44900856	.	C	T	2	2	4	0	0	4	0	0
10	44900901	.	T	G	2	5	7	0	0	7	0	0
10	44905224	.	A	G	1	1	2	0	0	2	0	0
10	44914623	.	A	G	7	1	8	0	7	15	0	0
10	44914685	.	G	T	8	7	15	0	0	15	0	0
10	44914761	.	T	A	7	6	13	0	0	13	0	0
10	44941408	.	G	A	2	3	5	0	0	5	0	0
10	44979593	.	A	T	3	2	5	0	0	5	0	0
10	44979712	.	A	G	1	4	5	0	0	5	0	0
10	44979767	.	A	G	1	2	3	0	1	4	0	0
10	44980391	.	C	T	2	7	9	0	0	9	0	0
10	44980913	.	C	T	4	8	12	0	0	12	0	0
10	44989378	.	C	T	3	2	5	0	0	5	0	0
10	44989384	.	T	C	5	3	8	0	1	9	0	0
10	44990917	.	C	T	4	8	12	0	0	12	0	0
10	45046809	.	T	C	1	2	3	0	0	3	0	0
10	45047127	.	T	A	1	2	3	0	0	3	0	0
10	45047128	.	A	G	1	2	3	0	0	3	0	0
10	45053620	.	C	A	3	3	6	0	1	7	0	0
10	45055879	.	G	A	4	7	11	0	1	12	0	0
10	45055948	.	G	A	2	0	2	0	0	2	0	0
10	45059822	.	C	T	9	5	14	0	1	15	0	0
10	45064957	.	C	T	17	8	25	0	0	25	0	0
10	45099498	.	T	C	3	5	8	0	0	8	0	0
10	45099522	.	T	C	3	5	8	0	0	8	0	0
10	45101543	.	G	A	0	3	3	0	0	3	0	0
10	45103519	.	C	T	3	3	6	0	0	6	0	0
10	45105244	.	T	C	2	0	2	0	0	2	0	0
10	45148260	.	C	A	3	2	5	0	0	5	0	0
10	45160904	.	C	A	1	0	1	0	0	1	0	0
10	45179688	.	A	C	2	1	3	0	0	3	0	0
10	45180294	.	C	T	1	2	3	0	1	4	0	0
10	45187450	.	T	C	2	2	4	0	0	4	0	0
10	45190629	.	C	T	1	2	3	0	0	3	0	0
10	45203109	.	T	C	2	1	3	0	0	3	0	0
10	45203154	.	A	G	4	2	6	0	0	6	0	0
10	45203271	.	T	A	3	3	6	0	0	6	0	0
10	45203385	.	T	A	3	5	8	0	0	8	0	0
10	45203793	.	G	A	0	5	5	0	2	7	0	0
10	45203856	.	G	A	4	5	9	0	0	9	0	0
10	45203882	.	A	G	7	3	10	0	0	10	0	0
10	45204024	.	A	G	2	2	4	0	0	4	0	0
10	45204029	.	A	T	2	3	5	0	0	5	0	0
10	45205166	.	A	C	4	5	9	3	0	12	0	0
10	45205175	.	A	G	3	0	3	2	5	10	0	0
10	45205226	.	A	G	7	0	7	0	4	11	0	0
10	45205237	.	C	G	11	0	11	0	5	16	0	0
10	45205400	.	C	A	2	2	4	0	0	4	0	0
10	45205506	.	A	C	2	4	6	0	0	7	1	0
10	45205518	.	T	G	5	7	12	0	0	12	0	0
10	45205757	.	C	A	5	5	10	0	1	11	0	0
10	45205758	.	A	G	6	5	11	0	0	11	0	0
10	45206103	.	C	G	1	3	4	0	1	7	2	0
10	45206289	.	G	C	7	0	7	4	5	16	0	0
10	45206326	.	G	T	8	5	13	0	0	13	0	0
10	45206450	.	T	C	10	0	10	0	7	17	0	0
10	45206478	.	G	T	15	3	18	0	0	18	0	0
10	45208153	.	A	G	2	5	7	0	0	7	0	0
10	45208667	.	C	T	1	1	2	0	3	5	0	0
10	45208875	.	G	A	3	1	4	0	0	4	0	0
10	45208899	.	C	A	1	1	2	0	0	2	0	0
10	45213798	.	C	T	0	1	1	0	4	5	0	0
10	45215720	.	C	T	0	1	1	0	0	1	0	0
10	45222613	.	T	C	2	0	2	0	3	5	0	0
10	45229624	.	C	A	2	5	7	0	1	8	0	0
10	45248527	.	A	C	3	3	6	0	0	6	0	0
10	45248548	.	T	A	3	3	6	0	0	6	0	0
10	45248638	.	G	A	2	4	6	0	0	6	0	0
10	45313560	.	C	T	0	1	1	0	0	1	0	0
10	45313623	.	G	A	0	4	4	0	6	10	0	0
10	45313671	.	C	T	4	2	6	0	1	7	0	0
10	45322668	.	A	G	4	0	4	0	5	9	0	0
10	45325302	.	G	A	0	5	5	0	6	11	0	0
10	45334688	.	C	T	3	1	4	0	2	6	0	0
10	45336565	.	T	C	6	12	18	0	2	20	0	0
10	45340105	.	G	T	0	9	9	0	5	14	0	0
10	45340835	.	G	C	5	3	8	0	2	10	0	0
10	45340930	.	G	T	3	4	7	0	0	7	0	0
10	45341210	.	T	A	1	2	3	0	1	4	0	0
10	45341403	.	A	G	4	10	14	0	1	15	0	0
10	45341410	.	A	G	5	0	5	0	10	15	0	0
10	45341537	.	A	C	12	10	22	0	1	23	0	0
10	45341546	.	A	C	11	11	22	0	0	22	0	0
10	45341572	.	G	C	0	9	9	0	8	17	0	0
10	45341596	.	C	T	3	5	8	0	0	8	0	0
10	45341762	.	A	T	4	3	7	0	0	7	0	0
10	45349924	.	G	A	8	14	22	0	0	22	0	0
10	45351037	.	C	T	8	7	15	0	1	16	0	0
10	45352231	.	C	T	18	19	37	0	4	41	0	0
10	45375714	.	G	T	7	4	11	0	0	11	0	0
10	45375732	.	C	T	2	2	4	0	0	4	0	0
11	356174	.	C	T	7	5	12	0	0	12	0	0
11	356255	.	T	C	5	3	8	1	0	9	0	0
11	359403	.	A	G	9	1	10	0	12	22	0	0
11	359710	.	G	T	0	2	2	0	0	2	0	0
11	359740	.	T	A	0	4	4	0	0	4	0	0
11	359747	.	T	A	0	3	3	0	1	4	0	0
11	359775	.	A	C	3	3	6	0	0	6	0	0
11	359992	.	T	C	1	2	3	0	0	3	0	0
11	360104	.	A	C	1	5	6	0	0	6	0	0
11	410915	.	A	G	0	6	6	0	0	6	0	0
11	410965	.	C	T	1	3	4	0	0	4	0	0
11	411119	.	C	T	3	2	5	0	1	6	0	0
11	411207	.	A	T	6	4	10	0	0	10	0	0
11	413080	.	A	G	4	4	8	0	0	8	0	0
11	413129	.	C	T	2	3	5	0	1	6	0	0
11	413180	.	T	G	2	1	3	0	0	3	0	0
11	413184	.	A	G	2	1	3	0	0	3	0	0
11	421405	.	G	A	3	2	5	0	0	5	0	0
11	421491	.	T	G	4	4	8	0	0	8	0	0
11	421513	.	G	T	4	3	7	0	0	7	0	0
11	445266	.	C	T	1	3	4	0	0	4	0	0
11	445582	.	C	T	2	2	4	0	0	4	0	0
11	446168	.	T	C	2	2	4	0	0	4	0	0
11	446323	.	G	A	0	3	3	0	0	3	0	0
11	446351	.	A	G	0	1	1	0	2	3	0	0
11	447386	.	C	T	1	2	3	0	0	3	0	0
11	449684	.	G	A	5	5	10	0	0	10	0	0
11	449752	.	A	G	6	1	7	0	2	9	0	0
11	457707	.	C	T	0	17	17	0	11	28	0	0
11	458062	.	G	A	12	20	32	0	1	33	0	0
11	458083	.	A	G	13	20	33	0	1	34	0	0
11	460665	.	C	T	0	7	7	0	7	14	0	0
11	460752	.	G	A	0	4	4	0	0	4	0	0
11	474619	.	A	T	2	2	4	0	1	5	0	0
11	474622	.	G	T	2	2	4	0	0	4	0	0
11	474662	.	C	G	1	5	6	0	0	6	0	0
11	474676	.	A	T	1	4	5	0	0	5	0	0
11	474734	.	T	C	1	4	5	0	0	5	0	0
11	474917	.	C	A	3	7	10	0	1	11	0	0
11	475112	.	T	C	1	7	8	0	0	8	0	0
11	475214	.	C	T	0	3	3	0	2	5	0	0
11	475314	.	C	T	2	5	7	0	0	7	0	0
11	475359	.	A	G	3	3	6	0	0	6	0	0
11	475376	.	T	A	2	2	4	0	0	4	0	0
11	475449	.	A	G	1	3	4	0	0	4	0	0
11	475524	.	G	A	1	2	3	0	1	4	0	0
11	475534	.	C	T	2	3	5	0	0	5	0	0
11	475603	.	G	C	1	2	3	0	0	3	0	0
11	475787	.	C	T	1	3	4	0	0	4	0	0
11	475911	.	G	T	5	5	10	0	0	10	0	0
11	476145	.	G	T	1	4	5	0	0	5	0	0
11	480611	.	G	A	1	4	5	0	0	5	0	0
11	481943	.	A	T	3	2	5	0	1	6	0	0
11	492659	.	C	T	1	26	27	0	28	55	0	0
11	494399	.	T	C	21	30	51	0	1	52	0	0
11	494405	.	A	G	23	30	53	0	4	57	0	0
11	495003	.	T	C	0	2	2	0	0	2	0	0
11	527956	.	C	T	4	12	16	0	1	17	0	0
11	537443	.	C	T	2	1	3	0	0	3	0	0
11	539425	.	T	C	0	3	3	0	0	3	0	0
11	539470	.	G	A	0	4	4	0	0	4	0	0
11	539586	.	C	T	11	5	16	0	0	16	0	0
11	539899	.	T	C	5	2	7	0	0	7	0	0
11	570876	.	A	G	4	6	10	0	0	10	0	0
11	570881	.	T	C	5	1	6	0	5	11	0	0
11	570942	.	C	T	12	2	14	0	2	16	0	0
11	575870	.	C	T	0	6	6	0	0	6	0	0
11	575948	.	T	C	3	2	5	0	0	5	0	0
11	580812	.	A	T	2	2	4	3	0	7	0	0
11	589785	.	C	T	2	0	2	0	0	2	0	0
11	592630	.	A	G	1	2	3	0	0	3	0	0
11	675382	.	G	C	29	20	49	0	0	49	0	0
11	675477	.	G	A	13	20	33	0	1	34	0	0
11	676888	.	G	A	26	22	48	0	1	49	0	0
11	676899	.	A	T	23	24	47	0	4	51	0	0
11	677089	.	A	T	11	19	30	0	3	33	0	0
11	687501	.	G	A	8	5	13	0	1	14	0	0
11	690601	.	C	T	0	13	13	0	8	21	0	0
11	714954	.	G	A	0	2	2	0	1	3	0	0
11	717979	.	C	T	4	2	6	0	0	6	0	0
11	718423	.	G	T	12	4	16	0	1	17	0	0
11	719800	.	G	T	8	6	14	0	0	14	0	0
11	813851	.	T	C	5	0	5	0	8	13	0	0
11	813923	.	T	C	2	0	2	0	9	11	0	0
11	1529838	.	A	G	10	5	15	0	1	16	0	0
11	2217572	.	T	C	1	2	3	1	0	4	0	0
11	2254326	.	T	C	3	6	9	0	0	9	0	0
11	2255025	.	T	G	2	6	8	0	0	8	0	0
11	2255027	.	T	G	2	6	8	0	0	8	0	0
11	2681338	.	A	G	3	5	8	0	2	10	0	0
11	2682384	.	A	G	6	2	8	0	1	9	0	0
11	2682426	.	A	G	4	1	5	0	0	5	0	0
11	2682441	.	A	T	0	5	5	0	0	5	0	0
11	2687981	.	C	T	9	4	13	0	0	13	0	0
11	2690053	.	A	G	3	1	4	0	0	4	0	0
11	2705657	.	A	G	7	3	10	0	1	11	0	0
11	2759425	.	A	G	2	3	5	0	0	5	0	0
11	2759461	.	T	C	5	4	9	0	0	9	0	0
11	2759475	.	G	T	7	6	13	0	1	14	0	0
11	2759498	.	G	A	7	11	18	0	1	19	0	0
11	2759525	.	A	G	12	6	18	0	1	19	0	0
11	2759541	.	C	A	4	11	15	0	0	15	0	0
11	2759646	.	A	T	5	3	8	0	0	8	0	0
11	2828125	.	T	C	11	13	24	1	1	26	0	0
11	2828143	.	A	G	13	9	22	1	0	23	0	0
11	2828174	.	A	G	10	22	32	0	0	32	0	0
11	3170359	.	A	G	1	0	1	0	3	4	0	0
11	3211910	.	G	A	3	2	5	0	0	5	0	0
11	3211926	.	G	A	4	2	6	0	0	6	0	0
11	3217970	.	C	T	1	1	2	0	1	3	0	0
11	3222192	.	T	C	3	2	5	0	0	5	0	0
11	3227343	.	G	A	3	2	5	0	0	5	0	0
11	3230284	.	G	A	1	2	3	0	0	3	0	0
11	3237023	.	T	C	1	2	3	0	0	3	0	0
11	3238720	.	T	C	3	5	8	0	0	8	0	0
11	3243316	.	T	C	2	5	7	0	0	7	0	0
11	3246120	.	A	G	8	7	15	0	1	16	0	0
11	3249253	.	C	T	4	7	11	0	0	11	0	0
11	3249268	.	T	C	4	7	11	0	0	11	0	0
11	3249334	.	T	C	6	2	8	0	0	8	0	0
11	3249346	.	C	T	4	3	7	0	0	7	0	0
11	3249370	.	A	G	5	0	5	0	2	7	0	0
11	3312137	.	T	C	4	8	12	0	0	12	0	0
11	3323411	.	A	G	6	6	12	0	1	13	0	0
11	3323414	.	G	A	7	5	12	0	0	12	0	0
11	3327445	.	G	C	7	3	10	0	1	11	0	0
11	3337038	.	A	G	31	31	62	0	7	69	0	0
11	3337253	.	A	G	25	34	59	0	2	61	0	0
11	3337256	.	T	C	28	1	29	0	31	60	0	0
11	3337698	.	T	A	24	25	49	0	1	51	1	0
11	3337718	.	G	C	21	28	49	0	3	52	0	0
11	3338060	.	C	G	28	17	45	0	2	47	0	0
11	3338144	.	T	C	36	21	57	0	4	61	0	0
11	3338236	.	T	C	24	0	24	1	25	50	0	0
11	3338288	.	T	A	30	21	51	1	2	54	0	0
11	3338299	.	T	G	28	18	46	1	3	50	0	0
11	3338431	.	C	T	1	26	27	0	32	59	0	0
11	3338491	.	G	A	27	20	47	0	5	53	1	0
11	3338514	.	C	A	34	22	56	0	0	56	0	0
11	3338624	.	G	A	25	29	54	0	7	61	0	0
11	3338638	.	A	G	28	30	58	0	2	60	0	0
11	3338708	.	A	G	26	31	57	0	2	59	0	0
11	3338813	.	T	C	38	1	39	0	24	63	0	0
11	3338933	.	A	G	30	25	55	0	2	57	0	0
11	3339107	.	C	T	0	26	26	0	17	43	0	0
11	3339425	.	G	A	23	35	58	0	0	58	0	0
11	3340306	.	G	A	23	28	51	0	2	53	0	0
11	3341350	.	C	G	2	27	29	0	25	54	0	0
11	3345716	.	T	C	4	3	7	0	0	7	0	0
11	3345741	.	T	C	3	0	3	0	3	6	0	0
11	3346066	.	C	A	3	2	5	0	1	6	0	0
11	3346076	.	G	C	5	4	9	0	0	9	0	0
11	3346128	.	T	G	7	2	9	0	1	10	0	0
11	3346222	.	A	G	3	2	5	0	0	5	0	0
11	3346448	.	G	C	1	1	2	0	0	2	0	0
11	3346456	.	C	T	1	1	2	0	0	2	0	0
11	3346847	.	G	A	6	3	9	0	0	9	0	0
11	3348004	.	T	G	2	2	4	0	0	4	0	0
11	3367924	.	G	C	11	12	23	0	1	24	0	0
11	3369891	.	A	G	6	1	7	0	0	7	0	0
11	3373418	.	A	G	2	3	5	0	0	5	0	0
11	3379999	.	G	T	1	1	2	0	0	2	0	0
11	3380012	.	C	G	2	3	5	0	0	5	0	0
11	3380135	.	A	G	1	3	4	0	0	4	0	0
11	3381243	.	T	A	4	5	9	0	0	9	0	0
11	3381261	.	C	A	3	7	10	0	0	10	0	0
11	3381290	.	A	G	2	5	7	0	0	7	0	0
11	3395069	.	G	A	2	0	2	0	0	2	0	0
11	3395070	.	A	T	2	0	2	0	0	2	0	0
11	3395303	.	G	A	1	2	3	0	0	3	0	0
11	3395324	.	C	T	4	7	11	0	2	13	0	0
11	3395501	.	A	G	3	2	5	0	0	5	0	0
11	3395693	.	A	T	5	2	7	0	0	7	0	0
11	3395699	.	G	A	5	3	8	0	1	9	0	0
11	3401899	.	C	A	15	8	23	0	0	23	0	0
11	3422086	.	T	C	0	1	1	0	0	1	0	0
11	3425136	.	G	A	0	2	2	0	0	2	0	0
11	3425175	.	G	A	3	3	6	0	1	7	0	0
11	3494930	.	T	A	5	4	9	0	0	9	0	0
11	3499197	.	G	A	4	2	6	0	0	6	0	0
11	3499204	.	G	T	4	2	6	0	0	6	0	0
11	3510055	.	G	A	0	3	3	0	2	5	0	0
11	3510067	.	A	G	2	3	5	0	0	5	0	0
11	3514154	.	T	C	0	2	2	0	1	3	0	0
11	3520631	.	A	G	3	2	5	0	0	5	0	0
11	3523493	.	G	A	9	8	17	0	1	18	0	0
11	3523976	.	A	C	11	1	12	0	6	18	0	0
11	3524111	.	G	A	6	8	14	0	0	14	0	0
11	3524196	.	A	G	14	17	31	0	0	31	0	0
11	3524236	.	C	T	12	15	27	0	0	27	0	0
11	3524541	.	A	T	5	5	10	0	0	11	1	0
11	3524591	.	G	A	2	4	6	0	0	6	0	0
11	3524715	.	A	C	7	8	15	0	0	15	0	0
11	3526443	.	T	C	3	1	4	0	0	4	0	0
11	3526458	.	A	G	4	3	7	0	0	7	0	0
11	3526521	.	A	G	8	5	13	0	3	16	0	0
11	3526605	.	C	G	1	4	5	0	0	5	0	0
11	3528320	.	A	T	12	14	26	0	1	27	0	0
11	3530443	.	G	T	9	8	17	0	2	19	0	0
11	3530991	.	T	C	2	0	2	0	5	7	0	0
11	3532836	.	A	G	2	3	5	0	0	5	0	0
11	3551074	.	T	C	20	27	47	0	1	48	0	0
11	3551309	.	A	G	1	12	13	0	0	13	0	0
11	3551944	.	G	A	24	26	50	0	2	52	0	0
11	3551986	.	C	T	0	16	16	0	26	42	0	0
11	3563644	.	C	T	0	2	2	0	4	6	0	0
11	3563647	.	G	A	4	1	5	0	0	5	0	0
11	3593309	.	T	C	4	4	8	0	0	8	0	0
11	3593490	.	A	C	8	8	16	0	0	16	0	0
11	3593708	.	T	C	2	4	6	0	0	6	0	0
11	3593748	.	A	G	7	6	13	0	0	14	1	0
11	3594062	.	T	C	11	10	21	0	1	22	0	0
11	3594070	.	T	C	12	8	20	0	1	21	0	0
11	3594147	.	A	T	11	5	16	0	0	16	0	0
11	3594277	.	T	G	5	8	13	0	1	14	0	0
11	3594321	.	T	C	8	0	8	0	9	17	0	0
11	3594327	.	T	A	7	8	15	0	1	16	0	0
11	3594366	.	A	G	10	5	15	0	0	15	0	0
11	3594541	.	A	T	5	6	11	0	1	12	0	0
11	3594573	.	A	T	3	4	7	0	0	7	0	0
11	3594618	.	G	A	1	6	7	0	0	7	0	0
11	3594649	.	T	G	5	5	10	0	0	10	0	0
11	3595140	.	A	C	4	0	4	0	3	7	0	0
11	3595308	.	G	A	7	4	11	0	2	13	0	0
11	3595579	.	A	G	9	13	22	0	0	22	0	0
11	3602382	.	T	C	5	3	8	0	1	9	0	0
11	3603392	.	A	G	6	6	12	0	1	13	0	0
11	3606914	.	T	C	1	0	1	0	4	5	0	0
11	3609448	.	A	T	3	3	6	0	0	6	0	0
11	3848656	.	C	T	12	5	17	0	0	17	0	0
11	3858081	.	T	G	8	6	14	0	1	15	0	0
11	3858318	.	A	G	11	9	20	0	1	21	0	0
11	3860104	.	C	G	4	2	6	0	0	6	0	0
11	3860149	.	G	T	5	2	7	0	0	7	0	0
11	3860524	.	C	G	2	2	4	0	0	4	0	0
11	3893429	.	A	C	13	20	33	0	0	33	0	0
11	3893564	.	A	G	17	12	29	0	2	31	0	0
11	3893635	.	C	T	15	9	24	0	0	24	0	0
11	3893636	.	T	G	15	9	24	0	0	24	0	0
11	3893928	.	G	C	16	16	32	0	3	35	0	0
11	3893933	.	G	C	17	16	33	0	1	34	0	0
11	3894023	.	T	C	14	14	28	0	1	29	0	0
11	3898787	.	C	T	2	14	16	0	9	25	0	0
11	3899066	.	C	A	1	11	12	0	15	27	0	0
11	3901375	.	C	A	0	12	12	0	14	27	1	0
11	3901414	.	C	T	10	12	22	0	2	24	0	0
11	3901733	.	C	G	0	12	12	0	13	25	0	0
11	3904517	.	C	G	0	19	19	0	20	39	0	0
11	3904674	.	T	G	7	1	8	0	1	9	0	0
11	3910103	.	T	C	5	12	17	0	0	17	0	0
11	3910304	.	G	A	7	8	15	0	0	15	0	0
11	3910310	.	C	T	6	8	14	0	0	14	0	0
11	3917688	.	A	G	0	1	1	0	1	2	0	0
11	3922983	.	G	A	8	2	10	0	0	10	0	0
11	3925822	.	T	C	5	0	5	0	1	6	0	0
11	3925906	.	A	G	4	5	9	0	1	10	0	0
11	3925939	.	T	C	3	2	5	0	0	5	0	0
11	3927859	.	G	A	3	7	10	0	0	10	0	0
11	3928044	.	A	T	0	2	2	0	0	2	0	0
11	3928168	.	T	C	0	1	1	0	0	1	0	0
11	3934190	.	A	G	7	4	11	0	1	12	0	0
11	3934319	.	T	G	3	2	5	0	0	5	0	0
11	3936111	.	A	G	3	6	9	0	0	9	0	0
11	3936378	.	T	A	7	5	12	0	1	13	0	0
11	3941649	.	G	T	2	0	2	0	0	2	0	0
11	3941697	.	A	T	2	0	2	0	0	2	0	0
11	3951531	.	T	A	1	4	5	0	0	5	0	0
11	3954572	.	T	C	2	0	2	0	1	3	0	0
11	3962979	.	A	C	1	1	2	0	0	2	0	0
11	3963388	.	C	T	0	1	1	0	0	1	0	0
11	3963581	.	C	T	5	4	9	0	1	10	0	0
11	3963608	.	G	T	3	5	8	0	3	11	0	0
11	3963639	.	T	A	2	2	4	0	0	4	0	0
11	3964193	.	T	A	0	1	1	0	0	1	0	0
11	3965870	.	C	T	0	1	1	0	0	1	0	0
11	3965984	.	T	A	2	3	5	0	0	5	0	0
11	3967408	.	A	G	1	0	1	0	6	7	0	0
11	3967445	.	A	G	2	2	4	0	0	4	0	0
11	3968877	.	G	A	8	4	12	0	1	13	0	0
11	3968915	.	T	G	3	2	5	0	0	5	0	0
11	3968934	.	G	C	0	1	1	0	0	1	0	0
11	3970955	.	C	A	6	3	9	0	2	11	0	0
11	3971943	.	T	A	1	2	3	0	0	3	0	0
11	3972170	.	C	A	2	6	8	0	0	8	0	0
11	3972263	.	T	C	2	2	4	0	1	5	0	0
11	3972271	.	C	G	3	1	4	0	0	4	0	0
11	3972540	.	A	C	2	3	5	0	0	5	0	0
11	3972541	.	G	A	2	3	5	0	0	5	0	0
11	3989472	.	A	G	14	0	14	0	16	30	0	0
11	3993452	.	G	A	0	5	5	0	7	12	0	0
11	3995468	.	T	C	1	3	4	0	0	4	0	0
11	3995515	.	A	G	2	8	10	0	0	10	0	0
11	4006924	.	C	T	0	0	0	0	1	1	0	0
11	4006956	.	C	T	2	2	4	0	0	4	0	0
11	4010601	.	G	T	1	3	4	0	0	4	0	0
11	4010744	.	C	G	3	5	8	0	1	9	0	0
11	4010752	.	T	G	4	4	8	0	0	8	0	0
11	4010895	.	C	T	4	5	9	0	0	9	0	0
11	4011001	.	T	C	4	0	4	0	7	11	0	0
11	4014737	.	C	T	0	2	2	0	0	2	0	0
11	4018262	.	G	A	1	2	3	0	0	3	0	0
11	4018268	.	A	G	1	1	2	0	0	2	0	0
11	4053390	.	G	A	0	9	9	0	6	15	0	0
11	4113807	.	C	T	3	5	8	0	0	8	0	0
11	4131070	.	A	T	2	3	5	0	0	5	0	0
11	4131080	.	A	G	3	0	3	0	3	6	0	0
11	4131150	.	G	A	0	3	3	0	0	3	0	0
11	4131300	.	A	T	6	3	9	0	0	9	0	0
11	4131313	.	C	T	5	2	7	0	0	7	0	0
11	4131933	.	T	A	8	9	17	0	0	17	0	0
11	4132159	.	C	A	13	16	29	0	2	31	0	0
11	4132229	.	A	G	22	8	30	0	2	32	0	0
11	4132295	.	C	T	24	21	45	0	0	45	0	0
11	4132296	.	A	C	23	21	44	0	1	45	0	0
11	4132378	.	G	C	14	12	26	0	2	28	0	0
11	4132440	.	A	G	9	12	21	0	1	22	0	0
11	4209004	.	T	C	4	2	6	0	0	6	0	0
11	4219556	.	A	C	5	2	7	0	1	8	0	0
11	4954023	.	A	C	2	1	3	0	0	3	0	0
11	5397381	.	A	G	3	3	6	0	0	6	0	0
11	5469670	.	T	C	2	3	5	0	0	5	0	0
11	5469706	.	A	C	1	2	3	0	0	3	0	0
11	5474384	.	T	G	3	0	3	0	2	5	0	0
11	5476711	.	T	C	1	3	4	0	0	4	0	0
11	5476737	.	C	G	1	0	1	0	2	3	0	0
11	5476944	.	G	A	2	1	3	0	0	3	0	0
11	5477441	.	C	T	3	4	7	0	0	7	0	0
11	5477453	.	T	C	2	3	5	0	0	5	0	0
11	5479489	.	A	G	4	0	4	0	1	5	0	0
11	5479555	.	T	C	1	1	2	0	0	2	0	0
11	5484288	.	G	C	0	2	2	0	2	4	0	0
11	5484294	.	T	C	2	2	4	0	0	4	0	0
11	5489221	.	A	G	6	2	8	0	1	9	0	0
11	5489356	.	C	T	12	10	22	0	3	25	0	0
11	5489634	.	A	T	13	11	24	0	0	24	0	0
11	5489688	.	T	C	10	13	23	0	1	24	0	0
11	5489689	.	T	C	10	13	23	0	1	24	0	0
11	5489769	.	C	G	9	1	10	0	0	10	0	0
11	5489781	.	G	A	10	2	12	0	0	12	0	0
11	5489835	.	A	C	8	12	20	0	3	23	0	0
11	5489973	.	A	G	1	0	1	0	8	9	0	0
11	5489974	.	A	G	1	8	9	0	0	9	0	0
11	5506066	.	T	C	3	3	6	0	0	6	0	0
11	5506075	.	C	T	3	3	6	0	0	6	0	0
11	5506111	.	C	T	6	7	13	0	0	13	0	0
11	5509526	.	C	T	5	5	10	0	0	10	0	0
11	5512128	.	A	G	3	0	3	0	4	7	0	0
11	5512436	.	A	T	2	2	4	0	3	7	0	0
11	5512468	.	C	T	6	2	8	0	0	8	0	0
11	5512520	.	C	T	8	4	12	0	0	12	0	0
11	5512921	.	A	G	8	0	8	1	9	18	0	0
11	5512947	.	T	G	5	6	11	0	0	11	0	0
11	5513181	.	A	C	16	4	20	0	0	20	0	0
11	5513210	.	G	A	11	4	15	0	0	15	0	0
11	5513381	.	T	A	2	8	10	0	0	10	0	0
11	5514254	.	G	A	0	9	9	0	7	16	0	0
11	5514259	.	C	T	6	10	16	0	1	17	0	0
11	5514677	.	C	T	18	6	24	0	2	26	0	0
11	5515016	.	G	C	3	8	11	0	0	11	0	0
11	5577024	.	C	T	2	5	7	0	0	7	0	0
11	5582731	.	T	C	3	3	6	0	0	6	0	0
11	5619831	.	G	A	1	2	3	0	0	3	0	0
11	5648643	.	C	T	2	3	5	0	0	5	0	0
11	5654226	.	T	C	1	0	1	0	0	1	0	0
11	5658751	.	A	G	1	3	4	0	0	4	0	0
11	5659026	.	C	T	3	2	5	0	0	5	0	0
11	5669722	.	G	A	0	2	2	0	1	3	0	0
11	5669907	.	G	A	0	8	8	0	3	11	0	0
11	5674134	.	G	A	1	6	7	0	0	7	0	0
11	5674150	.	A	G	1	6	7	0	1	8	0	0
11	5674183	.	G	C	3	5	8	0	0	8	0	0
11	5674704	.	C	T	6	8	14	0	0	14	0	0
11	5674731	.	T	G	6	0	6	0	8	14	0	0
11	5674779	.	G	A	0	3	3	0	7	10	0	0
11	5674809	.	C	T	2	3	5	0	0	5	0	0
11	5674838	.	C	T	6	2	8	0	0	8	0	0
11	5817309	.	T	G	6	12	18	0	1	19	0	0
11	5817345	.	T	C	10	13	23	0	1	24	0	0
11	5817397	.	A	T	9	11	20	0	0	20	0	0
11	5821084	.	G	T	4	7	11	0	0	11	0	0
11	5821096	.	C	G	5	3	8	0	1	9	0	0
11	5825415	.	C	T	7	8	15	0	0	15	0	0
11	5825620	.	A	G	5	8	13	0	0	13	0	0
11	5844525	.	G	A	15	18	33	0	2	35	0	0
11	5844579	.	G	A	0	2	2	0	4	6	0	0
11	5847511	.	G	A	12	11	23	0	0	23	0	0
11	5888504	.	C	T	3	3	6	0	1	7	0	0
11	5923335	.	C	A	17	16	33	0	0	33	0	0
11	5923515	.	G	A	0	3	3	0	1	4	0	0
11	5934086	.	G	T	1	2	3	0	1	4	0	0
11	5934455	.	G	A	1	2	3	0	0	3	0	0
11	5945836	.	A	T	3	4	7	0	1	8	0	0
11	5945840	.	G	A	3	3	6	0	0	6	0	0
11	5945919	.	T	A	4	5	9	0	1	10	0	0
11	5946023	.	T	A	7	13	20	0	4	24	0	0
11	5946564	.	T	C	12	16	28	0	2	30	0	0
11	5946854	.	G	C	17	12	29	0	5	34	0	0
11	5947191	.	T	G	11	12	23	0	0	23	0	0
11	5965663	.	A	T	2	1	3	0	0	3	0	0
11	5966209	.	G	A	3	2	5	0	1	6	0	0
11	5966215	.	G	A	3	3	6	0	0	6	0	0
11	5966340	.	C	T	3	4	7	0	0	7	0	0
11	5971226	.	T	A	3	3	6	0	0	6	0	0
11	5971577	.	A	G	2	3	5	0	0	5	0	0
11	6010247	.	A	T	3	2	5	0	0	5	0	0
11	6034494	.	T	C	1	2	3	0	0	3	0	0
11	6037494	.	C	T	1	2	3	0	0	3	0	0
11	6051419	.	A	G	5	5	10	0	0	10	0	0
11	6051431	.	G	A	5	6	11	0	0	11	0	0
11	6051477	.	G	A	7	4	11	0	0	11	0	0
11	6051481	.	T	C	8	4	12	0	1	13	0	0
11	6051717	.	G	A	4	7	11	0	0	11	0	0
11	6051839	.	A	C	7	8	15	0	0	15	0	0
11	6052011	.	T	A	7	9	16	0	0	16	0	0
11	6052211	.	G	A	2	2	4	0	1	5	0	0
11	6065129	.	C	G	0	11	11	0	9	20	0	0
11	6065150	.	C	T	0	12	12	0	8	20	0	0
11	6071523	.	C	G	1	2	3	0	0	3	0	0
11	6072398	.	C	T	0	2	2	0	0	2	0	0
11	6072462	.	C	T	2	2	4	0	0	4	0	0
11	6072463	.	G	A	0	2	2	0	2	4	0	0
11	6073085	.	G	T	4	2	6	0	0	6	0	0
11	6073807	.	T	G	3	0	3	0	4	7	0	0
11	6443607	.	A	G	3	3	6	0	0	6	0	0
11	6456177	.	C	T	8	7	15	0	0	15	0	0
11	6456400	.	A	C	6	0	6	0	3	9	0	0
11	6456408	.	G	A	5	3	8	0	0	8	0	0
11	6456447	.	C	T	3	3	6	0	0	6	0	0
11	6456677	.	T	C	8	11	19	0	0	19	0	0
11	6456829	.	C	T	19	20	39	0	1	40	0	0
11	6457442	.	G	A	7	13	20	0	5	25	0	0
11	6457473	.	C	A	13	10	23	0	0	23	0	0
11	6457500	.	A	T	16	8	24	0	0	24	0	0
11	6457518	.	T	C	16	9	25	0	0	25	0	0
11	6457594	.	C	A	7	7	14	0	0	14	0	0
11	6457619	.	T	C	2	8	10	0	0	10	0	0
11	6850576	.	A	G	21	23	44	0	0	44	0	0
11	6860020	.	A	G	3	14	17	0	0	17	0	0
11	6860050	.	T	C	5	13	18	0	0	18	0	0
11	6865051	.	C	T	14	15	29	0	1	30	0	0
11	6868156	.	G	T	12	10	22	0	1	23	0	0
11	6869480	.	G	T	1	4	5	0	0	5	0	0
11	6869685	.	A	G	1	0	1	0	0	1	0	0
11	6870794	.	C	T	0	1	1	0	1	2	0	0
11	6874110	.	T	C	3	2	5	0	0	5	0	0
11	6877210	.	T	C	0	1	1	0	0	1	0	0
11	6877906	.	G	A	1	1	2	0	0	2	0	0
11	6877927	.	C	T	0	2	2	0	1	3	0	0
11	6877970	.	A	G	1	3	4	0	1	5	0	0
11	6880665	.	T	C	5	1	6	0	3	9	0	0
11	6880707	.	A	T	2	2	4	0	0	4	0	0
11	6889957	.	G	C	2	4	6	0	0	6	0	0
11	6890283	.	A	G	3	4	7	0	0	7	0	0
11	6890567	.	G	A	0	2	2	0	2	4	0	0
11	6895778	.	A	T	1	1	2	0	0	2	0	0
11	6921467	.	T	C	0	1	1	0	0	1	0	0
11	6921995	.	C	A	1	0	1	0	0	1	0	0
11	6925032	.	C	G	3	0	3	0	0	3	0	0
11	6925125	.	C	T	3	6	9	0	0	9	0	0
11	6925146	.	C	A	2	8	10	0	0	10	0	0
11	6934453	.	G	A	1	4	5	0	4	9	0	0
11	6934486	.	C	T	3	2	5	0	2	7	0	0
11	6934584	.	A	G	3	7	10	0	1	11	0	0
11	6941654	.	T	G	5	12	17	0	1	18	0	0
11	6941987	.	C	T	6	6	12	0	4	16	0	0
11	6942040	.	G	A	4	4	8	0	1	9	0	0
11	6942409	.	G	A	2	4	6	0	1	7	0	0
11	6942797	.	T	C	5	4	9	0	0	9	0	0
11	6943013	.	C	T	6	10	16	0	2	18	0	0
11	6943048	.	A	G	6	1	7	0	7	14	0	0
11	6943055	.	T	G	3	6	9	0	2	11	0	0
11	6943214	.	G	T	3	4	7	0	0	7	0	0
11	6943462	.	T	A	3	5	8	0	2	10	0	0
11	6943715	.	G	A	0	7	7	0	9	16	0	0
11	6944143	.	T	A	6	8	14	0	0	14	0	0
11	6978449	.	G	A	1	2	3	0	0	3	0	0
11	6980913	.	C	T	5	3	8	0	1	9	0	0
11	6980997	.	G	T	4	2	6	0	1	7	0	0
11	6981032	.	G	C	1	2	3	0	0	3	0	0
11	6983784	.	G	A	5	4	9	0	0	9	0	0
11	6983788	.	T	G	5	4	9	0	1	10	0	0
11	6985335	.	T	C	6	6	12	0	0	12	0	0
11	6987084	.	A	C	1	0	1	0	2	3	0	0
11	6987108	.	G	A	2	2	4	0	0	4	0	0
11	7041194	.	G	A	12	6	18	0	0	18	0	0
11	7041300	.	A	G	7	11	18	0	1	19	0	0
11	7041475	.	C	G	1	6	7	0	0	7	0	0
11	7041476	.	T	C	1	0	1	0	6	7	0	0
11	7041527	.	T	C	4	5	9	0	0	9	0	0
11	7041528	.	G	C	4	5	9	0	0	9	0	0
11	7041580	.	T	C	3	6	9	0	0	9	0	0
11	7041598	.	A	C	3	6	9	0	0	9	0	0
11	7041621	.	T	G	3	2	5	0	0	5	0	0
11	7041649	.	G	A	3	3	6	0	0	6	0	0
11	7041670	.	A	G	3	5	8	0	0	8	0	0
11	7041690	.	A	G	3	5	8	0	0	8	0	0
11	7041732	.	C	T	1	5	6	0	2	8	0	0
11	7041915	.	T	A	11	2	13	0	0	13	0	0
11	7041940	.	A	C	5	5	10	0	1	11	0	0
11	7042149	.	C	T	8	4	12	0	0	12	0	0
11	7042513	.	T	A	4	9	13	0	1	14	0	0
11	7042956	.	A	G	3	4	7	0	1	8	0	0
11	7043003	.	C	T	2	5	7	0	0	7	0	0
11	7043023	.	C	A	3	5	8	0	0	8	0	0
11	7043277	.	A	G	0	1	1	1	0	2	0	0
11	7043283	.	T	C	0	0	0	1	2	3	0	0
11	7043428	.	T	A	3	3	6	0	0	6	0	0
11	7078282	.	G	T	8	5	13	0	0	13	0	0
11	7101067	.	G	A	1	3	4	0	0	4	0	0
11	7101366	.	C	A	3	3	6	0	0	6	0	0
11	7102978	.	G	A	0	5	5	0	5	10	0	0
11	7103010	.	A	T	6	2	8	0	0	8	0	0
11	7103135	.	T	A	1	3	4	0	0	4	0	0
11	7103154	.	A	G	3	1	4	0	0	4	0	0
11	7149937	.	T	G	4	0	4	0	0	4	0	0
11	7150189	.	T	C	1	0	1	0	1	2	0	0
11	7150716	.	A	G	6	0	6	0	0	6	0	0
11	7151773	.	G	T	15	21	36	0	0	36	0	0
11	7151806	.	C	A	1	20	21	0	17	38	0	0
11	7151842	.	G	T	17	13	30	0	1	31	0	0
11	7151860	.	A	T	19	10	29	0	0	29	0	0
11	7151910	.	G	A	6	12	18	2	1	21	0	0
11	7152102	.	G	A	18	13	31	0	0	31	0	0
11	7152274	.	G	A	12	17	29	0	0	29	0	0
11	7152426	.	A	T	10	15	25	1	1	27	0	0
11	7152428	.	A	G	11	15	26	1	0	27	0	0
11	7152594	.	C	T	14	14	28	0	1	29	0	0
11	7152609	.	C	T	12	15	27	0	1	28	0	0
11	7152639	.	C	A	1	12	13	0	6	19	0	0
11	7156639	.	T	C	1	1	2	0	0	2	0	0
11	7175215	.	G	C	0	9	9	0	4	13	0	0
11	7178941	.	G	C	0	10	10	0	9	19	0	0
11	7179018	.	C	T	3	5	8	0	1	9	0	0
11	7179259	.	T	C	1	2	3	0	0	3	0	0
11	7179376	.	G	A	4	6	10	0	0	10	0	0
11	7179378	.	A	G	4	6	10	0	0	10	0	0
11	7192840	.	T	G	1	0	1	0	4	5	0	0
11	7194703	.	T	C	2	4	6	0	0	6	0	0
11	7198484	.	G	A	2	1	3	0	0	3	0	0
11	7198517	.	A	G	10	3	13	0	0	13	0	0
11	7198607	.	G	A	6	4	10	0	0	10	0	0
11	7198724	.	G	A	3	2	5	0	1	6	0	0
11	7201648	.	T	C	1	1	2	0	0	2	0	0
11	7202315	.	C	T	4	5	9	0	0	9	0	0
11	7202321	.	G	A	0	6	6	0	6	12	0	0
11	7211908	.	A	G	12	9	21	0	2	23	0	0
11	7212029	.	A	G	2	9	11	0	0	11	0	0
11	7212091	.	T	C	2	2	4	0	0	4	0	0
11	7212095	.	T	A	2	2	4	0	0	4	0	0
11	7277061	.	A	G	3	10	13	0	1	14	0	0
11	7277310	.	T	C	7	9	16	0	0	16	0	0
11	7277315	.	T	C	7	5	12	0	0	12	0	0
11	7279587	.	G	A	7	2	9	0	0	9	0	0
11	7279904	.	G	A	6	2	8	0	0	8	0	0
11	7279913	.	G	T	6	2	8	0	0	8	0	0
11	7282391	.	T	C	5	7	12	0	1	13	0	0
11	7282499	.	C	T	9	6	15	0	0	15	0	0
11	7283033	.	G	T	9	12	21	0	0	21	0	0
11	7283138	.	A	T	7	13	20	0	0	20	0	0
11	7283444	.	C	T	0	12	12	0	9	21	0	0
11	7283525	.	A	G	11	4	15	0	0	15	0	0
11	7283888	.	G	T	3	2	5	0	1	6	0	0
11	7283900	.	G	A	5	3	8	0	0	8	0	0
11	7283966	.	G	A	3	6	9	0	0	9	0	0
11	7284089	.	G	A	4	5	9	0	0	9	0	0
11	7284194	.	A	G	3	5	8	0	0	8	0	0
11	7284488	.	G	A	5	7	12	0	0	12	0	0
11	7284520	.	A	T	7	8	15	0	0	15	0	0
11	7284603	.	G	T	3	9	12	0	0	12	0	0
11	7284692	.	T	C	2	0	2	0	12	14	0	0
11	7284697	.	T	G	4	10	14	0	0	14	0	0
11	7285028	.	C	T	8	2	10	0	1	11	0	0
11	7285109	.	C	T	6	9	15	0	0	15	0	0
11	7285487	.	T	C	6	7	13	0	0	13	0	0
11	7285732	.	G	A	1	2	3	0	0	3	0	0
11	7285801	.	G	A	2	3	5	0	1	6	0	0
11	7286041	.	T	G	1	2	3	0	0	3	0	0
11	7287590	.	G	T	1	1	2	0	0	2	0	0
11	7295999	.	T	C	1	0	1	0	0	1	0	0
11	7298890	.	C	T	7	7	14	0	0	14	0	0
11	7298972	.	G	A	5	5	10	0	1	11	0	0
11	7299005	.	A	T	2	6	8	0	1	9	0	0
11	7299022	.	C	T	3	6	9	0	0	9	0	0
11	7299040	.	A	G	3	8	11	0	1	12	0	0
11	7305923	.	G	A	0	6	6	0	0	6	0	0
11	7340143	.	A	G	25	31	56	0	3	59	0	0
11	7341031	.	G	A	27	27	54	0	3	57	0	0
11	7388805	.	C	T	1	2	3	0	0	3	0	0
11	7528977	.	A	T	1	2	3	0	0	3	0	0
11	7628282	.	T	C	1	5	6	0	1	7	0	0
11	7628285	.	T	C	2	5	7	0	0	7	0	0
11	7640718	.	T	C	0	2	2	0	0	2	0	0
11	7652612	.	C	T	7	4	11	0	0	11	0	0
11	7652642	.	T	C	7	6	13	0	0	13	0	0
11	7652648	.	G	C	7	6	13	0	0	13	0	0
11	7670739	.	G	T	5	4	9	0	0	9	0	0
11	7673091	.	C	T	0	2	2	0	0	2	0	0
11	7686796	.	T	C	6	2	8	0	0	8	0	0
11	7692036	.	T	C	5	4	9	0	0	9	0	0
11	7696584	.	G	T	2	4	6	0	1	7	0	0
11	7734898	.	A	G	9	0	9	0	11	20	0	0
11	7735869	.	C	G	13	12	25	0	0	25	0	0
11	7735905	.	T	A	14	12	26	0	3	29	0	0
11	7735937	.	T	A	11	12	23	0	0	23	0	0
11	7736576	.	G	A	10	17	27	0	1	28	0	0
11	7736589	.	G	T	13	20	33	0	0	33	0	0
11	7981303	.	A	C	0	3	3	0	0	3	0	0
11	7981427	.	C	T	1	4	5	0	0	5	0	0
11	7981613	.	T	C	15	11	26	0	2	28	0	0
11	7981912	.	T	C	6	0	6	0	11	17	0	0
11	7981915	.	T	A	6	11	17	0	0	17	0	0
11	7981998	.	C	A	1	5	6	0	8	14	0	0
11	7982114	.	C	T	6	5	11	0	0	11	0	0
11	7982122	.	T	A	6	4	10	0	0	10	0	0
11	7982205	.	T	C	4	0	4	0	5	9	0	0
11	7982263	.	T	G	3	7	10	0	1	11	0	0
11	7982321	.	T	A	5	2	7	0	1	8	0	0
11	7982566	.	T	A	4	4	8	0	7	15	0	0
11	7982774	.	T	A	8	8	16	0	0	16	0	0
11	7982791	.	C	T	9	8	17	0	1	18	0	0
11	7982835	.	C	T	9	8	17	0	0	17	0	0
11	7982869	.	C	T	9	5	14	0	0	14	0	0
11	7983236	.	T	A	8	2	10	0	0	10	0	0
11	7983270	.	T	G	5	6	11	0	0	11	0	0
11	7983348	.	C	A	5	6	11	0	0	11	0	0
11	7983631	.	C	T	0	13	13	0	10	23	0	0
11	7983709	.	T	A	8	7	15	0	0	15	0	0
11	7983734	.	A	G	10	2	12	0	1	13	0	0
11	7983757	.	A	T	9	2	11	0	0	11	0	0
11	7984165	.	T	C	6	3	9	0	1	10	0	0
11	7984181	.	A	T	9	5	14	0	1	15	0	0
11	7984264	.	A	T	5	8	13	0	0	13	0	0
11	7984350	.	A	T	1	6	7	0	0	7	0	0
11	7984666	.	T	A	7	3	10	0	1	11	0	0
11	8003638	.	A	G	0	2	2	0	1	3	0	0
11	8012466	.	T	A	8	9	17	0	1	18	0	0
11	8012535	.	A	G	6	11	17	0	1	18	0	0
11	8097547	.	A	G	6	6	12	0	1	13	0	0
11	8115252	.	A	G	2	6	8	0	0	8	0	0
11	8115263	.	T	C	2	0	2	0	6	8	0	0
11	8153771	.	C	T	4	7	11	0	2	13	0	0
11	8156967	.	C	T	6	7	13	0	0	13	0	0
11	8156972	.	C	T	7	6	13	0	0	13	0	0
11	8157002	.	C	G	9	3	12	0	0	12	0	0
11	8304652	.	C	G	0	3	3	0	2	5	0	0
11	8305395	.	A	C	0	3	3	0	0	3	0	0
11	8565961	.	T	C	4	5	9	0	0	9	0	0
11	8662864	.	G	A	0	13	13	0	8	21	0	0
11	8672992	.	G	T	0	1	1	0	2	3	0	0
11	8673002	.	T	C	2	1	3	0	0	3	0	0
11	8673765	.	A	T	1	2	3	0	0	3	0	0
11	8681619	.	G	T	10	17	27	0	1	28	0	0
11	8681714	.	T	C	13	10	23	0	2	25	0	0
11	8681750	.	G	A	9	7	16	0	1	17	0	0
11	8682248	.	T	A	8	5	13	0	0	13	0	0
11	8682273	.	G	A	5	5	10	0	0	10	0	0
11	8682331	.	T	C	4	5	9	0	0	9	0	0
11	8697347	.	A	G	4	5	9	0	0	9	0	0
11	8697473	.	T	C	2	1	3	0	0	3	0	0
11	9564328	.	T	G	8	7	15	0	1	16	0	0
11	9564746	.	G	A	6	5	11	0	0	11	0	0
11	10389284	.	A	G	6	4	10	0	0	10	0	0
11	10402081	.	G	A	1	2	3	0	0	3	0	0
11	10467552	.	C	A	0	2	2	0	0	2	0	0
11	10467667	.	C	T	0	2	2	0	8	10	0	0
11	10468268	.	T	C	3	2	5	0	0	5	0	0
11	10468569	.	C	T	0	3	3	0	1	4	0	0
11	10468814	.	C	T	1	1	2	0	0	2	0	0
11	10483198	.	A	C	3	2	5	0	0	5	0	0
11	10524228	.	G	A	1	2	3	0	0	3	0	0
11	10579359	.	T	G	1	0	1	0	0	1	0	0
11	10602645	.	A	G	0	1	1	0	0	1	0	0
11	10602662	.	A	G	0	1	1	0	0	1	0	0
11	10669933	.	G	T	25	23	48	0	3	51	0	0
11	10670112	.	T	A	11	12	23	0	0	23	0	0
11	10670394	.	C	T	18	18	36	0	2	38	0	0
11	10670439	.	T	C	14	8	22	0	6	28	0	0
11	10671525	.	A	G	16	23	39	0	1	40	0	0
11	10671546	.	A	G	14	20	34	0	3	37	0	0
11	10671578	.	A	T	11	19	30	0	2	32	0	0
11	10671636	.	C	T	0	10	10	0	6	16	0	0
11	10671831	.	T	C	7	12	19	0	5	24	0	0
11	10671836	.	T	C	12	10	22	0	3	25	0	0
11	10672136	.	C	T	7	8	15	0	0	16	1	0
11	10672250	.	T	C	5	1	6	0	2	8	0	0
11	10672707	.	T	G	8	12	20	0	1	21	0	0
11	10672726	.	T	A	8	6	14	0	2	16	0	0
11	10672750	.	T	C	5	1	6	0	0	6	0	0
11	10713757	.	G	A	6	10	16	0	2	18	0	0
11	10713796	.	C	T	8	9	17	0	2	19	0	0
11	10720178	.	C	T	2	2	4	0	0	4	0	0
11	10720232	.	G	C	10	8	18	0	2	20	0	0
11	10720271	.	C	T	0	6	6	0	10	16	0	0
11	10720295	.	A	G	6	2	8	0	1	9	0	0
11	10725775	.	G	A	5	10	15	0	0	15	0	0
11	10725880	.	G	A	0	2	2	0	0	2	0	0
11	10835571	.	T	C	3	0	3	0	5	8	0	0
11	10842537	.	T	C	10	1	11	0	14	25	0	0
11	10842714	.	A	C	1	0	1	0	1	2	0	0
11	10909461	.	G	A	0	0	0	0	2	2	0	0
11	10958321	.	A	G	7	1	8	0	8	16	0	0
11	10959499	.	T	A	3	8	11	0	1	12	0	0
11	11517480	.	G	C	0	2	2	0	0	2	0	0
11	11597221	.	T	C	3	3	6	0	0	6	0	0
11	11597240	.	T	C	4	5	9	0	0	9	0	0
11	11597374	.	A	G	9	4	13	0	0	13	0	0
11	11597401	.	C	A	7	5	12	0	0	12	0	0
11	11597523	.	A	G	8	8	16	0	2	18	0	0
11	11597798	.	A	T	5	17	22	0	0	22	0	0
11	11597985	.	A	T	2	11	13	0	0	13	0	0
11	11598334	.	G	C	10	9	19	0	1	20	0	0
11	11598692	.	C	A	4	4	8	0	0	8	0	0
11	11605172	.	T	C	4	1	5	0	4	9	0	0
11	11605744	.	C	T	0	0	0	0	1	1	0	0
11	11607492	.	G	A	1	5	6	0	0	6	0	0
11	11607498	.	C	G	2	5	7	0	0	7	0	0
11	11607579	.	A	C	7	0	7	0	8	15	0	0
11	11607594	.	G	A	8	9	17	0	1	18	0	0
11	11607705	.	C	T	6	14	20	0	1	21	0	0
11	11625229	.	T	A	5	3	8	0	0	8	0	0
11	11777535	.	A	T	1	3	4	0	1	5	0	0
11	11777540	.	G	A	2	3	5	0	0	5	0	0
11	11780816	.	A	T	2	7	9	0	0	9	0	0
11	11866469	.	C	T	2	2	4	0	1	5	0	0
11	11867264	.	T	C	1	0	1	0	3	4	0	0
11	11871128	.	A	G	2	0	2	0	0	2	0	0
11	11875610	.	T	C	3	3	6	1	0	7	0	0
11	11875922	.	G	A	4	2	6	0	0	6	0	0
11	11942072	.	A	G	1	2	3	0	0	3	0	0
11	11951584	.	A	T	1	3	4	0	0	4	0	0
11	11979461	.	G	A	2	2	4	0	0	4	0	0
11	11983710	.	T	C	4	0	4	0	8	12	0	0
11	11983713	.	A	C	4	9	13	0	0	13	0	0
11	11983748	.	A	C	5	1	6	0	7	13	0	0
11	11983789	.	G	T	5	5	10	0	0	10	0	0
11	11983937	.	T	C	4	8	12	0	2	14	0	0
11	11984227	.	G	A	1	2	3	0	1	4	0	0
11	11984408	.	A	C	16	9	25	0	0	25	0	0
11	11984409	.	G	C	15	8	23	0	2	25	0	0
11	11984522	.	A	G	3	7	10	0	0	10	0	0
11	11984548	.	C	T	4	6	10	0	0	10	0	0
11	11984666	.	A	G	6	3	9	0	0	9	0	0
11	12004277	.	A	G	3	6	9	0	1	10	0	0
11	12004304	.	G	T	2	6	8	0	0	8	0	0
11	12004652	.	A	G	5	8	13	0	2	15	0	0
11	12011325	.	G	A	3	2	5	0	0	5	0	0
11	12016638	.	A	G	7	3	10	0	0	10	0	0
11	12050039	.	T	C	2	5	7	0	0	7	0	0
11	12050265	.	A	G	6	8	14	0	0	14	0	0
11	12050291	.	G	A	4	8	12	0	0	12	0	0
11	12051505	.	G	T	10	12	22	0	0	22	0	0
11	12118079	.	C	T	6	9	15	0	3	18	0	0
11	12118097	.	T	A	4	9	13	0	0	13	0	0
11	12136025	.	A	C	5	0	5	0	3	8	0	0
11	12141467	.	T	C	5	2	7	0	0	7	0	0
11	12141482	.	A	G	4	1	5	0	1	6	0	0
11	12145328	.	G	A	4	4	8	0	0	8	0	0
11	12158243	.	G	A	5	7	12	0	1	13	0	0
11	12727225	.	A	G	11	8	19	0	1	20	0	0
11	12727446	.	C	T	20	26	46	0	1	48	1	0
11	12727504	.	A	G	18	32	50	0	4	54	0	0
11	12727708	.	C	A	12	20	32	0	0	32	0	0
11	12727829	.	T	A	7	5	12	0	0	13	1	0
11	12727990	.	T	A	15	5	20	0	2	22	0	0
11	12727999	.	C	T	13	5	18	0	0	18	0	0
11	12732431	.	A	C	1	2	3	0	1	4	0	0
11	12732505	.	A	T	5	5	10	0	0	10	0	0
11	12732521	.	T	C	6	0	6	0	5	11	0	0
11	12732556	.	G	C	6	6	12	0	0	12	0	0
11	12732638	.	G	A	3	2	5	0	0	5	0	0
11	12733004	.	C	T	3	4	7	0	0	7	0	0
11	12733443	.	T	A	2	2	4	0	1	5	0	0
11	12733815	.	C	T	3	3	6	0	0	6	0	0
11	12733824	.	T	C	3	0	3	0	4	7	0	0
11	12733965	.	C	T	5	2	7	0	0	7	0	0
11	12734072	.	G	A	5	2	7	0	0	7	0	0
11	12734223	.	G	A	1	0	1	0	0	1	0	0
11	12743172	.	T	C	1	1	2	0	1	3	0	0
11	12744646	.	G	A	1	2	3	0	0	3	0	0
11	12744740	.	T	C	6	5	11	0	1	12	0	0
11	12751500	.	G	A	6	4	10	0	0	10	0	0
11	12751831	.	T	C	2	3	5	0	0	5	0	0
11	12759409	.	G	A	3	9	12	0	0	12	0	0
11	12759728	.	G	T	2	1	3	0	0	3	0	0
11	12759737	.	C	T	3	2	5	0	0	5	0	0
11	12767982	.	T	C	3	7	10	0	0	10	0	0
11	12768214	.	G	A	0	11	11	0	15	26	0	0
11	12768299	.	C	T	6	12	18	0	2	20	0	0
11	12782503	.	G	A	5	10	15	0	0	15	0	0
11	12782524	.	A	C	7	8	15	0	0	15	0	0
11	12782802	.	G	A	4	2	6	0	0	6	0	0
11	12782897	.	T	A	2	3	5	0	1	6	0	0
11	12782908	.	T	G	3	5	8	0	0	8	0	0
11	12783139	.	T	A	4	4	8	0	0	8	0	0
11	12784430	.	A	T	1	3	4	0	0	4	0	0
11	12792707	.	C	T	2	0	2	0	0	2	0	0
11	12796790	.	G	T	1	1	2	0	0	2	0	0
11	12800927	.	A	C	1	0	1	0	0	1	0	0
11	12814794	.	C	G	1	0	1	0	2	3	0	0
11	12835833	.	C	A	2	0	2	0	0	2	0	0
11	12839357	.	T	C	0	2	2	0	0	2	0	0
11	12839413	.	T	C	0	3	3	0	0	3	0	0
11	12845101	.	T	A	1	3	4	0	0	4	0	0
11	12845150	.	T	C	5	2	7	0	0	7	0	0
11	12848345	.	A	G	1	2	3	0	0	3	0	0
11	12858777	.	C	T	4	2	6	0	0	6	0	0
11	12858798	.	G	A	0	2	2	0	3	5	0	0
11	12864070	.	C	T	8	4	12	0	2	14	0	0
11	12987786	.	G	A	2	2	4	0	0	4	0	0
11	12987981	.	G	T	2	2	4	0	0	4	0	0
11	12988038	.	G	A	4	4	8	0	0	8	0	0
11	13041402	.	T	G	1	0	1	0	1	2	0	0
11	13055748	.	T	C	3	3	6	0	1	7	0	0
11	13062201	.	C	G	10	3	13	0	0	13	0	0
11	13067750	.	A	T	3	3	6	0	2	8	0	0
11	13071855	.	C	T	11	4	15	0	0	15	0	0
11	13079183	.	C	A	2	4	6	0	1	7	0	0
11	13082107	.	C	T	0	1	1	0	0	1	0	0
11	13085294	.	G	A	2	2	4	0	0	4	0	0
11	13088062	.	G	T	1	2	3	0	7	10	0	0
11	13094247	.	A	G	5	6	11	0	2	13	0	0
11	13094581	.	C	T	3	27	30	0	22	52	0	0
11	13094884	.	G	A	26	24	50	0	1	51	0	0
11	13094913	.	A	G	22	18	40	0	1	41	0	0
11	13094938	.	G	T	25	13	38	0	0	38	0	0
11	13101333	.	C	T	1	1	2	0	0	2	0	0
11	13101378	.	A	G	3	2	5	0	0	5	0	0
11	13104057	.	C	A	0	2	2	0	3	5	0	0
11	13185920	.	C	T	2	3	5	0	0	5	0	0
11	13185958	.	C	T	1	1	2	0	0	2	0	0
11	13185970	.	C	T	1	1	2	0	0	2	0	0
11	13188413	.	C	T	4	3	7	0	0	7	0	0
11	13208839	.	C	G	17	45	62	0	0	62	0	0
11	13209037	.	T	G	15	38	53	0	0	53	0	0
11	13209085	.	G	C	23	43	66	0	3	69	0	0
11	13210604	.	G	A	24	31	55	0	3	58	0	0
11	13210667	.	C	T	28	24	52	0	0	52	0	0
11	13210906	.	C	T	30	34	64	0	3	67	0	0
11	13212186	.	A	T	18	23	41	0	3	44	0	0
11	13212234	.	T	C	45	28	73	0	1	74	0	0
11	13212333	.	T	C	16	10	26	0	3	29	0	0
11	13212357	.	T	C	5	0	5	0	2	7	0	0
11	13212567	.	T	C	30	27	57	0	4	61	0	0
11	13212908	.	T	A	33	19	52	0	0	52	0	0
11	13280565	.	T	C	15	0	15	0	13	28	0	0
11	13280580	.	A	G	16	14	30	1	2	33	0	0
11	13281238	.	A	G	6	3	9	0	0	9	0	0
11	13281398	.	G	C	6	7	13	0	1	14	0	0
11	13281653	.	C	T	19	10	29	0	2	32	1	0
11	13281734	.	G	A	8	23	31	0	0	31	0	0
11	13281864	.	C	T	3	3	6	0	0	6	0	0
11	13282130	.	T	C	8	9	17	0	1	18	0	0
11	13282660	.	C	T	8	10	18	0	0	18	0	0
11	13282881	.	T	C	6	4	10	0	0	10	0	0
11	13282883	.	A	G	6	4	10	0	0	10	0	0
11	13283156	.	T	A	9	13	22	0	1	23	0	0
11	13283181	.	C	T	9	17	26	0	0	26	0	0
11	13283220	.	C	G	0	10	10	0	9	19	0	0
11	13283243	.	T	C	11	0	11	0	7	18	0	0
11	13283335	.	A	G	12	12	24	0	1	25	0	0
11	13283398	.	G	C	13	6	19	0	1	20	0	0
11	13292012	.	C	T	5	2	7	0	0	7	0	0
11	13292027	.	A	T	7	4	11	0	0	11	0	0
11	13297711	.	T	C	0	2	2	0	0	2	0	0
11	13304426	.	G	A	1	1	2	0	1	3	0	0
11	13305874	.	T	C	1	1	2	0	0	2	0	0
11	13305949	.	G	A	1	6	7	0	0	7	0	0
11	13341110	.	A	G	2	3	5	0	0	5	0	0
11	13341112	.	T	A	1	2	3	0	2	5	0	0
11	13341189	.	G	A	0	2	2	0	1	3	0	0
11	13341342	.	G	A	2	3	5	0	2	7	0	0
11	13341346	.	A	C	3	2	5	0	2	7	0	0
11	13424543	.	G	A	1	0	1	0	0	1	0	0
11	13445981	.	T	C	3	3	6	0	0	6	0	0
11	13446023	.	C	T	3	3	6	0	0	6	0	0
11	13480257	.	A	T	2	1	3	0	0	3	0	0
11	13494666	.	T	A	0	3	3	0	0	3	0	0
11	13503351	.	A	G	5	4	9	0	0	9	0	0
11	13504343	.	A	C	4	2	6	0	1	7	0	0
11	13504403	.	C	T	4	3	7	0	0	7	0	0
11	13504473	.	A	T	4	4	8	0	0	8	0	0
11	13505186	.	C	A	10	7	17	0	0	17	0	0
11	13529975	.	G	T	3	0	3	0	0	3	0	0
11	13530399	.	A	C	0	1	1	0	0	1	0	0
11	13530498	.	G	A	6	6	12	0	0	12	0	0
11	13531730	.	C	T	10	6	16	0	0	16	0	0
11	13531954	.	C	T	4	0	4	0	0	4	0	0
11	13532567	.	T	C	4	5	9	0	0	9	0	0
11	13532922	.	C	T	9	4	13	0	0	13	0	0
11	13533072	.	A	G	5	7	12	0	1	13	0	0
11	13533214	.	A	G	8	0	8	0	1	9	0	0
11	13533388	.	T	A	6	10	16	0	2	18	0	0
11	14015532	.	G	A	0	1	1	0	0	1	0	0
11	14062138	.	T	C	1	4	5	0	0	5	0	0
11	14062357	.	C	T	2	3	5	0	0	5	0	0
11	14062662	.	A	G	1	2	3	0	0	3	0	0
11	14062667	.	A	G	1	2	3	0	0	3	0	0
11	14062908	.	A	G	4	3	7	0	0	7	0	0
11	14073049	.	T	A	4	6	10	0	0	10	0	0
11	14073444	.	C	T	12	7	19	0	0	19	0	0
11	14073857	.	C	A	6	5	11	0	0	11	0	0
11	14073858	.	A	T	6	5	11	0	0	11	0	0
11	14074174	.	T	C	5	7	12	0	1	13	0	0
11	14074397	.	A	G	5	3	8	0	0	8	0	0
11	14074843	.	A	C	5	4	9	0	1	10	0	0
11	14101770	.	T	C	2	2	4	0	0	4	0	0
11	14102018	.	C	T	1	3	4	0	0	4	0	0
11	14112316	.	G	A	0	3	3	0	2	5	0	0
11	14112328	.	A	G	2	3	5	0	0	5	0	0
11	14132176	.	C	G	3	0	3	0	5	8	0	0
11	14137563	.	C	T	1	2	3	0	0	3	0	0
11	14137901	.	C	A	4	3	7	0	0	7	0	0
11	14137988	.	C	T	1	2	3	0	0	3	0	0
11	14148179	.	A	G	5	13	18	0	0	18	0	0
11	14148341	.	T	A	8	7	15	0	2	17	0	0
11	14149964	.	T	C	2	3	5	0	0	5	0	0
11	14159425	.	C	T	9	10	19	0	0	19	0	0
11	14159513	.	A	G	10	17	27	0	0	27	0	0
11	14159555	.	A	G	14	15	29	0	0	29	0	0
11	14159622	.	T	C	14	14	28	0	2	30	0	0
11	14159979	.	T	C	13	13	26	0	2	28	0	0
11	14160131	.	A	G	13	20	33	0	0	33	0	0
11	14160941	.	C	A	7	9	16	0	0	16	0	0
11	14161073	.	A	G	12	9	21	0	0	21	0	0
11	14161077	.	C	A	11	7	18	0	2	20	0	0
11	14161291	.	A	T	10	14	24	0	2	26	0	0
11	14161304	.	A	G	8	16	24	0	0	24	0	0
11	14199913	.	G	C	0	5	5	0	13	18	0	0
11	14249012	.	A	G	2	3	5	0	0	5	0	0
11	14267236	.	A	G	4	0	4	0	10	14	0	0
11	14318637	.	A	G	5	2	7	0	0	7	0	0
11	14318647	.	C	G	4	2	6	0	1	7	0	0
11	14326929	.	T	A	0	1	1	0	0	1	0	0
11	14333489	.	T	C	1	0	1	0	0	1	0	0
11	14338397	.	C	G	3	10	13	0	0	13	0	0
11	14338460	.	G	A	3	10	13	0	0	13	0	0
11	14340971	.	T	A	2	2	4	0	0	4	0	0
11	14341498	.	T	A	2	5	7	0	0	7	0	0
11	14341510	.	A	C	2	5	7	0	0	7	0	0
11	14341610	.	C	A	1	3	4	0	0	4	0	0
11	14343612	.	T	G	8	5	13	0	0	13	0	0
11	14344976	.	G	T	3	2	5	0	0	5	0	0
11	14344989	.	G	A	0	2	2	0	3	5	0	0
11	14345062	.	T	A	5	5	10	0	0	10	0	0
11	14345064	.	C	T	5	5	10	0	0	10	0	0
11	14345156	.	C	A	3	5	8	0	0	8	0	0
11	14345215	.	A	G	2	2	4	0	0	4	0	0
11	14345221	.	T	G	2	2	4	0	0	4	0	0
11	14345562	.	T	G	6	6	12	0	1	13	0	0
11	14345638	.	C	T	2	7	9	0	2	11	0	0
11	14345753	.	A	G	9	9	18	0	0	18	0	0
11	14345830	.	T	C	2	6	8	0	0	8	0	0
11	14345884	.	T	G	2	5	7	0	0	7	0	0
11	14345910	.	A	T	0	5	5	0	0	5	0	0
11	14345922	.	T	G	0	6	6	0	0	6	0	0
11	14431519	.	G	C	4	3	7	0	0	7	0	0
11	14431661	.	G	A	1	4	5	0	0	5	0	0
11	14432169	.	C	A	1	5	6	0	1	7	0	0
11	14639030	.	T	C	5	5	10	0	2	12	0	0
11	14640002	.	G	T	0	2	2	0	3	5	0	0
11	14640155	.	A	G	3	3	6	0	0	6	0	0
11	14676340	.	T	C	3	12	15	0	1	16	0	0
11	14676365	.	G	T	2	13	15	0	1	16	0	0
11	14676500	.	G	T	3	3	6	0	1	7	0	0
11	14676604	.	A	T	7	5	12	0	0	12	0	0
11	14749156	.	G	A	4	4	8	0	0	8	0	0
11	14751068	.	T	C	3	7	10	0	0	10	0	0
11	14955922	.	T	A	3	3	6	0	0	6	0	0
11	14957155	.	A	T	15	7	22	1	2	25	0	0
11	15250544	.	T	C	7	4	11	0	1	12	0	0
11	15281992	.	G	A	2	5	7	0	0	7	0	0
11	15586740	.	C	A	2	1	3	0	0	3	0	0
11	15586757	.	T	C	2	1	3	0	0	3	0	0
11	15833846	.	T	C	9	4	13	0	0	13	0	0
11	15834265	.	T	C	4	4	8	0	0	8	0	0
11	15910604	.	G	C	2	3	5	0	0	5	0	0
11	15915274	.	G	T	6	6	12	0	0	12	0	0
11	15972599	.	T	C	1	5	6	0	0	6	0	0
11	15972646	.	C	A	5	3	8	0	1	9	0	0
11	15975556	.	C	T	2	0	2	0	0	2	0	0
11	16005711	.	C	T	4	9	13	0	1	14	0	0
11	16005862	.	G	A	1	4	5	0	1	6	0	0
11	16005883	.	G	T	1	5	6	0	0	6	0	0
11	16006016	.	C	T	1	4	5	0	0	5	0	0
11	16006030	.	C	T	1	4	5	0	0	5	0	0
11	16006149	.	C	T	1	4	5	0	1	6	0	0
11	16006154	.	T	A	1	5	6	0	0	6	0	0
11	16010502	.	A	G	2	0	2	0	5	7	0	0
11	16010656	.	T	C	7	5	12	0	0	12	0	0
11	16010788	.	C	A	6	4	10	0	1	11	0	0
11	16010799	.	G	C	8	4	12	0	0	12	0	0
11	16010842	.	C	T	2	6	8	0	1	9	0	0
11	16010849	.	A	G	2	0	2	0	6	8	0	0
11	16010978	.	G	A	4	5	9	0	0	9	0	0
11	16010986	.	A	T	4	5	9	0	0	9	0	0
11	16011185	.	C	A	1	3	4	0	1	5	0	0
11	16011622	.	T	C	9	8	17	0	1	18	0	0
11	16011632	.	T	G	9	0	9	0	8	17	0	0
11	16011705	.	T	C	8	7	15	0	7	22	0	0
11	16011745	.	C	G	11	10	21	0	0	21	0	0
11	16011770	.	T	C	14	12	26	0	1	27	0	0
11	16011807	.	T	C	19	11	30	0	1	31	0	0
11	16011895	.	A	C	17	6	23	0	0	23	0	0
11	16012021	.	G	A	7	5	12	0	0	12	0	0
11	16012117	.	G	T	0	13	13	0	3	16	0	0
11	16012140	.	G	A	0	13	13	0	5	18	0	0
11	16012152	.	A	G	6	0	6	0	14	20	0	0
11	16012191	.	C	T	8	20	28	0	1	29	0	0
11	16012201	.	C	T	9	18	27	0	1	28	0	0
11	16012251	.	T	A	10	7	17	0	0	17	0	0
11	16012256	.	C	T	8	7	15	0	2	17	0	0
11	16012316	.	T	G	8	5	13	0	0	13	0	0
11	16012364	.	G	T	0	10	10	0	3	13	0	0
11	16012414	.	T	C	3	9	12	0	0	12	0	0
11	16012508	.	A	C	2	4	6	0	0	6	0	0
11	16012512	.	C	T	2	4	6	0	0	6	0	0
11	16012654	.	A	G	6	0	6	0	3	9	0	0
11	16012785	.	T	G	9	12	21	0	0	21	0	0
11	16012786	.	A	G	9	11	20	0	1	21	0	0
11	16012829	.	G	T	14	10	24	0	0	24	0	0
11	16012882	.	G	A	11	7	18	0	2	20	0	0
11	16013018	.	T	C	6	10	16	0	1	17	0	0
11	16013036	.	T	A	2	5	7	0	1	8	0	0
11	16063297	.	T	G	1	2	3	0	0	3	0	0
11	16083502	.	C	T	0	3	3	0	0	3	0	0
11	16099700	.	G	A	0	1	1	0	0	1	0	0
11	16104175	.	T	C	5	8	13	0	0	13	0	0
11	16115692	.	C	T	4	6	10	0	0	10	0	0
11	16143781	.	T	C	18	23	41	0	0	41	0	0
11	16143829	.	T	C	17	19	36	0	0	36	0	0
11	16153290	.	C	T	10	8	18	0	0	18	0	0
11	16158555	.	G	A	9	11	20	0	1	21	0	0
11	16159056	.	A	G	6	5	11	0	0	11	0	0
11	16159316	.	C	T	1	7	8	0	1	9	0	0
11	16159875	.	T	C	2	5	7	0	0	7	0	0
11	16159903	.	C	T	4	10	14	0	0	14	0	0
11	16160137	.	A	G	3	0	3	0	6	9	0	0
11	16165293	.	T	C	5	6	11	0	0	11	0	0
11	16165298	.	G	A	0	7	7	0	5	12	0	0
11	16165605	.	T	A	10	6	16	0	1	18	1	0
11	16165665	.	A	G	17	11	28	0	0	28	0	0
11	16165710	.	T	A	14	9	23	0	0	23	0	0
11	16166137	.	C	G	1	2	3	0	0	3	0	0
11	16169412	.	G	T	0	1	1	0	0	1	0	0
11	16180033	.	G	A	28	26	54	0	1	55	0	0
11	16184739	.	A	G	10	8	18	0	0	18	0	0
11	16184865	.	A	T	9	12	21	0	0	21	0	0
11	16237915	.	C	G	2	2	4	0	1	5	0	0
11	16585724	.	C	A	1	2	3	0	0	3	0	0
11	16586082	.	A	G	0	0	0	0	3	3	0	0
11	16586083	.	A	G	0	3	3	0	0	3	0	0
11	16586747	.	A	G	1	2	3	0	0	3	0	0
11	16587486	.	G	T	6	2	8	0	0	8	0	0
11	16587715	.	A	G	4	7	11	0	1	12	0	0
11	16738655	.	C	T	1	3	4	0	0	4	0	0
11	16739039	.	C	T	0	5	5	0	5	10	0	0
11	17511788	.	T	C	3	8	11	0	0	11	0	0
11	17511902	.	C	A	5	6	11	0	0	11	0	0
11	17511964	.	C	G	9	0	9	0	13	22	0	0
11	17512139	.	T	C	7	12	19	0	0	19	0	0
11	17512289	.	T	C	7	7	14	0	2	16	0	0
11	17513174	.	A	G	1	2	3	0	0	3	0	0
11	17513328	.	A	G	2	0	2	0	5	7	0	0
11	17513371	.	G	T	1	3	4	0	0	4	0	0
11	17513405	.	C	T	3	3	6	0	0	6	0	0
11	17513424	.	T	A	3	3	6	0	0	6	0	0
11	17513440	.	A	G	2	3	5	0	0	5	0	0
11	17513526	.	G	A	0	4	4	0	4	8	0	0
11	17513554	.	T	A	5	2	7	0	0	7	0	0
11	17597424	.	G	A	2	4	6	0	0	6	0	0
11	17713672	.	T	C	4	2	6	0	0	6	0	0
11	17734902	.	G	C	0	2	2	0	0	2	0	0
11	17734911	.	C	T	0	2	2	0	0	2	0	0
11	17757767	.	T	C	8	6	14	0	0	14	0	0
11	17757859	.	T	C	2	7	9	0	0	9	0	0
11	17763137	.	A	G	8	8	16	0	0	16	0	0
11	17763160	.	T	C	6	8	14	0	2	16	0	0
11	17763173	.	C	A	5	8	13	0	0	13	0	0
11	17763393	.	C	T	6	9	15	0	0	15	0	0
11	17765170	.	C	T	2	3	5	0	0	5	0	0
11	17765618	.	T	C	1	0	1	0	1	2	0	0
11	17769238	.	C	T	2	3	5	0	0	5	0	0
11	17769801	.	A	T	5	5	10	0	0	10	0	0
11	17770594	.	C	T	4	8	12	0	0	12	0	0
11	17770627	.	T	C	5	14	19	0	0	19	0	0
11	17771185	.	T	C	3	3	6	0	0	6	0	0
11	17771248	.	T	C	1	2	3	0	0	3	0	0
11	17774893	.	G	A	1	0	1	0	0	1	0	0
11	17774917	.	T	C	3	2	5	0	0	5	0	0
11	17774970	.	G	T	2	2	4	0	0	4	0	0
11	17778492	.	T	A	2	4	6	0	0	7	1	0
11	17778528	.	T	C	2	0	2	0	6	8	0	0
11	17778597	.	A	G	4	6	10	0	1	11	0	0
11	17778618	.	T	G	6	5	11	0	1	12	0	0
11	17778690	.	G	T	5	9	14	0	0	14	0	0
11	17778819	.	G	A	3	3	6	0	0	6	0	0
11	17778846	.	G	A	3	3	6	0	0	6	0	0
11	17779159	.	A	G	5	5	10	0	0	10	0	0
11	17779197	.	A	T	9	4	13	0	0	13	0	0
11	17779254	.	T	C	6	0	6	0	3	9	0	0
11	17779279	.	C	A	5	6	11	0	0	11	0	0
11	17779599	.	A	T	7	3	10	0	1	11	0	0
11	17779630	.	G	A	3	2	5	0	0	5	0	0
11	17779656	.	C	T	0	1	1	0	1	2	0	0
11	17782529	.	A	C	4	0	4	0	4	8	0	0
11	17782683	.	G	A	3	5	8	0	0	8	0	0
11	17782845	.	C	T	8	5	13	0	1	14	0	0
11	17782849	.	A	G	10	3	13	0	0	13	0	0
11	17785402	.	T	G	20	6	26	0	1	27	0	0
11	17785412	.	C	A	25	6	31	0	0	31	0	0
11	17785591	.	A	G	13	7	20	0	0	20	0	0
11	17789069	.	G	T	4	8	12	0	0	12	0	0
11	17789210	.	T	C	1	1	2	0	0	2	0	0
11	17792991	.	C	T	1	5	6	0	5	11	0	0
11	17793676	.	G	A	0	2	2	0	0	2	0	0
11	17796869	.	C	T	0	0	0	0	2	2	0	0
11	17797072	.	T	C	1	0	1	0	0	1	0	0
11	17797280	.	G	A	1	2	3	0	0	3	0	0
11	17984176	.	A	T	1	2	3	0	0	3	0	0
11	17984308	.	T	C	4	4	8	0	0	8	0	0
11	17984459	.	G	T	3	2	5	0	2	7	0	0
11	17987289	.	C	A	3	0	3	0	0	3	0	0
11	18223383	.	C	T	7	6	13	0	1	14	0	0
11	18238076	.	C	T	6	11	17	0	0	17	0	0
11	18244388	.	T	C	9	7	16	0	0	16	0	0
11	18271303	.	G	A	2	1	3	0	0	3	0	0
11	18277370	.	C	T	0	4	4	0	5	9	0	0
11	18277388	.	G	A	1	1	2	0	0	2	0	0
11	18283268	.	T	C	3	5	8	0	0	8	0	0
11	18283525	.	T	C	1	0	1	0	2	3	0	0
11	18287280	.	A	G	3	3	6	0	0	6	0	0
11	18287283	.	A	T	3	3	6	0	1	7	0	0
11	18287693	.	A	G	8	5	13	0	1	14	0	0
11	18287779	.	G	A	4	7	11	0	2	13	0	0
11	18287895	.	T	G	6	7	13	0	0	13	0	0
11	18287940	.	A	T	10	8	18	0	0	18	0	0
11	18288018	.	T	C	9	5	14	0	0	14	0	0
11	18288212	.	T	C	9	4	13	0	1	14	0	0
11	18290095	.	G	A	1	1	2	0	0	2	0	0
11	18291865	.	A	G	5	2	7	0	0	7	0	0
11	18291961	.	C	T	0	4	4	0	5	9	0	0
11	18292595	.	C	T	0	4	4	0	6	10	0	0
11	18292633	.	A	G	11	5	16	0	0	16	0	0
11	18292699	.	T	A	4	3	7	0	1	8	0	0
11	18293166	.	A	G	2	5	7	0	1	8	0	0
11	18294857	.	A	G	4	5	9	0	0	9	0	0
11	18297113	.	A	G	1	1	2	0	0	2	0	0
11	18299674	.	A	G	2	0	2	0	0	2	0	0
11	18304271	.	T	A	6	2	8	0	0	8	0	0
11	18305756	.	G	A	2	0	2	0	0	2	0	0
11	18305804	.	C	G	2	0	2	0	0	2	0	0
11	18315937	.	G	A	1	2	3	0	1	4	0	0
11	18315955	.	C	T	2	3	5	0	0	5	0	0
11	18345272	.	C	A	1	4	5	0	1	6	0	0
11	18345719	.	T	G	1	2	3	0	2	5	0	0
11	18365577	.	G	A	1	2	3	0	0	3	0	0
11	18397505	.	C	T	1	2	3	0	0	3	0	0
11	18397847	.	C	T	2	2	4	0	0	4	0	0
11	18397848	.	C	T	2	2	4	0	0	4	0	0
11	18398800	.	T	C	0	2	2	0	0	2	0	0
11	18465032	.	G	A	2	2	4	0	0	4	0	0
11	18535666	.	C	T	19	8	27	0	0	27	0	0
11	18535761	.	G	C	19	11	30	0	1	31	0	0
11	18537180	.	A	G	5	5	10	0	1	11	0	0
11	18537244	.	G	A	11	8	19	0	1	20	0	0
11	18537447	.	T	C	6	4	10	0	0	10	0	0
11	18537561	.	T	A	5	6	11	0	0	11	0	0
11	18537636	.	T	A	7	1	8	0	2	10	0	0
11	18538219	.	A	T	10	9	19	0	2	21	0	0
11	18538259	.	G	T	16	7	23	0	2	25	0	0
11	18538336	.	A	C	7	1	8	0	16	24	0	0
11	18538362	.	T	C	15	1	16	0	13	29	0	0
11	18542168	.	T	C	5	1	6	0	0	6	0	0
11	18542585	.	A	G	3	5	8	0	0	8	0	0
11	18543520	.	T	A	2	6	8	0	2	10	0	0
11	18543543	.	T	A	2	9	11	0	0	11	0	0
11	18543828	.	T	C	3	6	9	0	1	10	0	0
11	18543870	.	A	G	5	8	13	0	0	13	0	0
11	18546088	.	G	T	1	1	2	0	0	2	0	0
11	18546276	.	T	A	3	2	5	0	0	5	0	0
11	18546378	.	T	A	5	3	8	0	0	8	0	0
11	18547125	.	A	G	18	14	32	0	2	34	0	0
11	18551011	.	C	A	0	1	1	0	2	3	0	0
11	18551077	.	G	A	9	3	12	0	0	12	0	0
11	18551089	.	G	A	7	5	12	0	1	13	0	0
11	18551605	.	C	T	0	7	7	0	7	14	0	0
11	18552231	.	A	T	1	0	1	0	0	1	0	0
11	18568971	.	G	A	1	0	1	0	0	1	0	0
11	18572364	.	T	C	6	1	7	0	7	14	0	0
11	18572574	.	G	A	10	6	16	0	1	17	0	0
11	18572586	.	C	T	10	6	16	0	0	16	0	0
11	18572640	.	T	G	12	8	20	0	1	21	0	0
11	18572648	.	G	A	13	9	22	0	1	23	0	0
11	18572751	.	G	A	7	12	19	0	0	19	0	0
11	18575095	.	C	A	7	7	14	0	0	14	0	0
11	18575161	.	C	G	9	8	17	0	0	17	0	0
11	18575173	.	G	T	8	8	16	0	0	16	0	0
11	18575258	.	T	G	8	4	12	0	0	12	0	0
11	18575326	.	G	T	6	7	13	0	0	13	0	0
11	18577787	.	A	G	1	1	2	0	0	2	0	0
11	18579921	.	C	T	0	4	4	0	2	6	0	0
11	18580059	.	C	T	0	7	7	0	7	14	0	0
11	18580170	.	T	C	3	0	3	0	4	7	0	0
11	18580191	.	T	A	3	4	7	0	0	7	0	0
11	18580293	.	T	C	4	0	4	0	1	5	0	0
11	18586264	.	T	C	0	0	0	0	1	1	0	0
11	18587719	.	T	G	0	1	1	0	0	1	0	0
11	18587720	.	A	G	0	1	1	0	0	1	0	0
11	18592065	.	A	G	2	8	10	0	0	10	0	0
11	18677864	.	T	C	0	1	1	0	0	1	0	0
11	18677979	.	A	G	1	1	2	0	0	2	0	0
11	18678027	.	G	A	0	3	3	0	4	7	0	0
11	18678103	.	G	A	1	3	4	0	0	4	0	0
11	18678321	.	T	C	1	3	4	0	1	5	0	0
11	18678344	.	T	G	2	5	7	0	0	7	0	0
11	18681103	.	G	A	0	3	3	0	1	4	0	0
11	18681382	.	A	G	2	0	2	0	3	5	0	0
11	18682826	.	T	C	1	0	1	0	0	1	0	0
11	18697720	.	A	G	2	4	6	0	1	7	0	0
11	18697817	.	T	G	5	7	12	0	1	13	0	0
11	18697822	.	A	G	7	1	8	0	6	14	0	0
11	18698138	.	A	G	3	0	3	0	7	10	0	0
11	18698526	.	G	A	6	7	13	0	0	13	0	0
11	18699104	.	T	C	6	11	17	0	1	18	0	0
11	18704378	.	G	C	15	0	15	0	7	22	0	0
11	18704500	.	G	A	18	16	34	0	2	36	0	0
11	18704620	.	C	T	0	28	28	0	16	44	0	0
11	18705108	.	A	G	18	28	46	0	1	47	0	0
11	18784949	.	A	T	5	9	14	0	0	14	0	0
11	18785130	.	A	G	12	16	28	0	2	30	0	0
11	18785250	.	C	T	0	20	20	0	12	32	0	0
11	18785294	.	T	G	9	22	31	0	1	32	0	0
11	18785296	.	C	T	10	22	32	0	0	32	0	0
11	18785346	.	A	T	13	10	23	0	1	24	0	0
11	18785410	.	G	A	10	12	22	0	0	22	0	0
11	18785421	.	A	G	10	14	24	0	0	24	0	0
11	18785570	.	T	A	8	3	11	0	1	12	0	0
11	18785623	.	A	T	4	2	6	0	1	7	0	0
11	18785749	.	C	G	2	2	4	0	0	4	0	0
11	18785921	.	G	A	10	9	19	0	0	19	0	0
11	18785975	.	T	C	11	15	26	0	1	27	0	0
11	18785997	.	T	A	10	14	24	0	0	24	0	0
11	18786085	.	A	T	6	9	15	0	0	15	0	0
11	18786250	.	A	C	14	20	34	0	0	34	0	0
11	18786329	.	C	A	0	7	7	0	7	14	0	0
11	18794157	.	C	A	0	1	1	0	2	3	0	0
11	18799800	.	C	T	4	3	7	0	0	7	0	0
11	18799873	.	G	A	1	2	3	0	0	3	0	0
11	18802570	.	T	C	3	3	6	0	0	6	0	0
11	18802815	.	G	C	5	3	8	0	0	8	0	0
11	18802865	.	C	G	5	2	7	0	0	7	0	0
11	18802879	.	A	G	6	3	9	0	1	10	0	0
11	18803621	.	A	G	1	1	2	0	0	2	0	0
11	18809354	.	G	A	1	2	3	0	0	3	0	0
11	18814506	.	T	G	1	2	3	0	0	3	0	0
11	18815957	.	C	T	2	1	3	0	0	3	0	0
11	18819034	.	T	A	3	2	5	0	0	5	0	0
11	19999131	.	T	C	0	4	4	0	0	4	0	0
11	20017802	.	A	G	1	3	4	0	0	4	0	0
11	20092190	.	C	T	2	2	4	0	1	5	0	0
11	20092194	.	C	T	2	3	5	0	0	5	0	0
11	21281673	.	T	C	16	8	24	0	2	26	0	0
11	21281726	.	T	C	8	3	11	0	0	11	0	0
11	22093443	.	A	T	9	3	12	0	1	13	0	0
11	23596384	.	C	A	8	3	11	0	0	11	0	0
11	23856440	.	A	G	3	6	9	0	1	10	0	0
11	23881611	.	A	T	0	2	2	0	0	2	0	0
11	24054359	.	G	T	6	2	8	0	0	8	0	0
11	24993109	.	G	A	0	3	3	0	1	4	0	0
11	25615101	.	G	A	0	3	3	0	2	5	0	0
11	25713728	.	T	C	6	4	10	0	0	10	0	0
11	25713760	.	T	C	7	3	10	0	0	10	0	0
11	25713820	.	T	C	7	11	18	0	0	18	0	0
11	25713871	.	T	C	5	6	11	0	0	11	0	0
11	25713913	.	T	C	1	5	6	0	0	6	0	0
11	26233522	.	A	T	0	6	6	0	0	6	0	0
11	26545779	.	A	G	5	3	8	0	0	8	0	0
11	27511862	.	T	A	3	2	5	0	1	6	0	0
11	28218216	.	A	G	5	2	7	0	0	7	0	0
11	29333919	.	T	A	1	4	5	0	0	5	0	0
11	29818310	.	T	C	1	3	4	0	0	4	0	0
11	29818311	.	T	C	2	2	4	0	0	4	0	0
11	29918168	.	T	C	2	5	7	0	1	8	0	0
11	30147942	.	A	G	4	2	6	0	2	8	0	0
11	30640954	.	A	G	3	2	5	0	0	5	0	0
11	30642164	.	A	G	3	4	7	0	0	7	0	0
11	30946960	.	A	G	3	2	5	0	2	7	0	0
11	31558251	.	G	A	0	4	4	0	4	8	0	0
11	31558634	.	C	A	6	13	19	0	1	20	0	0
11	31558782	.	C	T	5	9	14	0	0	14	0	0
11	31602828	.	G	T	11	11	22	0	0	22	0	0
11	31603346	.	G	A	0	6	6	0	4	10	0	0
11	31621001	.	C	G	1	2	3	0	0	3	0	0
11	31621018	.	T	C	2	2	4	0	0	4	0	0
11	31621106	.	C	A	2	2	4	0	0	4	0	0
11	31647283	.	A	C	5	5	10	0	1	11	0	0
11	31649781	.	G	A	0	3	3	0	2	5	0	0
11	31653670	.	T	G	3	0	3	0	5	8	0	0
11	31653700	.	T	C	6	6	12	0	0	12	0	0
11	31664070	.	T	C	5	6	11	0	0	11	0	0
11	31664108	.	T	C	1	1	2	0	1	3	0	0
11	31667490	.	C	A	4	0	4	0	0	4	0	0
11	31667592	.	C	T	16	12	28	0	1	29	0	0
11	31667658	.	C	T	9	12	21	0	0	21	0	0
11	31667946	.	G	A	3	8	11	0	2	13	0	0
11	31668186	.	A	G	6	1	7	0	0	8	1	0
11	31668191	.	A	T	6	1	7	0	0	8	1	0
11	31668330	.	C	A	9	11	20	0	1	21	0	0
11	31668394	.	T	G	10	5	15	0	0	15	0	0
11	31668759	.	T	C	2	3	5	0	0	5	0	0
11	31668824	.	T	A	2	3	5	0	1	6	0	0
11	31668849	.	A	T	2	5	7	0	0	7	0	0
11	31668893	.	T	C	1	4	5	0	0	5	0	0
11	31669622	.	A	G	9	6	15	0	0	15	0	0
11	31670123	.	A	T	2	3	5	0	1	6	0	0
11	31670130	.	T	A	3	4	7	0	0	7	0	0
11	31670216	.	A	T	5	5	10	0	0	10	0	0
11	31670534	.	T	C	2	4	6	0	0	6	0	0
11	31670648	.	T	C	1	3	4	0	0	4	0	0
11	31670661	.	T	G	1	2	3	0	0	3	0	0
11	31670724	.	A	G	3	0	3	0	2	5	0	0
11	31670749	.	C	A	6	4	10	0	0	10	0	0
11	31670789	.	C	T	7	4	11	0	0	11	0	0
11	31670808	.	C	A	5	3	8	0	0	8	0	0
11	31670830	.	T	C	5	3	8	0	0	8	0	0
11	31670868	.	T	C	7	3	10	0	0	10	0	0
11	31670881	.	T	A	7	2	9	0	1	10	0	0
11	31671060	.	A	G	1	0	1	0	3	4	0	0
11	31671072	.	T	C	1	3	4	0	0	4	0	0
11	31671165	.	G	C	0	1	1	0	2	3	0	0
11	31671326	.	G	T	0	3	3	0	3	6	0	0
11	31671328	.	T	G	3	3	6	0	0	6	0	0
11	32576695	.	C	T	7	10	17	0	3	20	0	0
11	32577076	.	T	A	5	7	12	0	0	12	0	0
11	32577258	.	C	T	1	15	16	0	11	27	0	0
11	32577404	.	A	G	17	13	30	0	2	32	0	0
11	32577439	.	G	A	14	15	29	0	2	31	0	0
11	32577800	.	G	A	12	13	25	0	1	26	0	0
11	32577830	.	G	A	17	16	33	0	0	33	0	0
11	32578082	.	C	T	19	12	31	0	3	34	0	0
11	32578172	.	G	A	14	10	24	0	0	24	0	0
11	32720124	.	C	T	19	10	29	0	1	30	0	0
11	32720427	.	A	T	10	10	20	0	2	22	0	0
11	32720505	.	C	T	10	8	18	0	0	18	0	0
11	32720730	.	C	G	7	7	14	0	2	16	0	0
11	32720856	.	A	G	5	7	12	0	0	12	0	0
11	32721057	.	T	A	10	7	17	0	0	17	0	0
11	32721144	.	A	G	12	7	19	0	1	20	0	0
11	32721168	.	A	G	13	7	20	0	0	20	0	0
11	32721333	.	A	G	13	7	20	0	1	21	0	0
11	32721492	.	A	C	5	0	5	0	9	14	0	0
11	32721498	.	T	G	4	8	12	0	2	14	0	0
11	32721765	.	A	G	8	6	14	0	0	14	0	0
11	32721843	.	G	A	9	7	16	0	0	16	0	0
11	32722547	.	A	G	3	4	7	0	1	8	0	0
11	32723520	.	G	A	3	3	6	0	1	7	0	0
11	32723691	.	C	T	5	10	15	0	0	15	0	0
11	33426583	.	C	T	2	2	4	0	0	4	0	0
11	33426645	.	G	T	0	2	2	0	5	7	0	0
11	33426728	.	A	G	0	0	0	0	1	1	0	0
11	33530170	.	T	C	0	1	1	0	0	1	0	0
11	33530220	.	A	G	1	2	3	0	0	3	0	0
11	33532289	.	A	G	1	3	4	0	0	4	0	0
11	33532600	.	C	T	1	2	3	0	0	3	0	0
11	33537289	.	G	T	0	2	2	0	1	3	0	0
11	33537327	.	A	G	1	3	4	0	0	4	0	0
11	33537435	.	C	T	2	4	6	0	0	6	0	0
11	33539693	.	T	C	1	4	5	0	0	5	0	0
11	33545056	.	A	T	1	4	5	0	0	5	0	0
11	33551200	.	T	C	1	0	1	0	0	1	0	0
11	33553873	.	T	C	3	10	13	0	2	15	0	0
11	33554087	.	G	A	6	8	14	0	0	14	0	0
11	33554116	.	G	A	8	10	18	0	0	18	0	0
11	33554535	.	T	C	8	5	13	0	0	13	0	0
11	33598972	.	A	G	3	2	5	0	0	5	0	0
11	33599038	.	T	C	4	9	13	0	0	13	0	0
11	33599148	.	T	C	14	9	23	0	1	24	0	0
11	33599187	.	T	C	13	0	13	0	9	22	0	0
11	33599223	.	A	G	12	10	22	0	0	22	0	0
11	33599240	.	A	T	10	9	19	0	1	20	0	0
11	33599464	.	C	T	0	7	7	0	11	18	0	0
11	33599900	.	C	T	0	3	3	0	5	8	0	0
11	33600174	.	G	A	11	8	19	0	2	21	0	0
11	33600215	.	A	G	11	13	24	0	0	24	0	0
11	33600551	.	C	A	1	1	2	0	0	2	0	0
11	33600572	.	T	A	2	3	5	0	1	6	0	0
11	33600646	.	T	C	6	0	6	0	9	15	0	0
11	33600742	.	A	T	9	4	13	0	2	15	0	0
11	33600862	.	G	A	2	3	5	0	0	5	0	0
11	33676993	.	G	T	1	2	3	0	0	3	0	0
11	33739986	.	G	A	0	2	2	0	2	4	0	0
11	33751546	.	A	G	1	3	4	0	0	4	0	0
11	33751572	.	A	G	1	4	5	0	0	5	0	0
11	33772552	.	C	T	5	3	8	0	0	8	0	0
11	33827023	.	G	A	3	2	5	0	0	5	0	0
11	33829443	.	A	G	0	3	3	0	0	3	0	0
11	33829515	.	A	G	1	4	5	0	1	6	0	0
11	33832679	.	C	T	6	9	15	0	1	16	0	0
11	33834700	.	A	G	2	3	5	0	0	5	0	0
11	33835385	.	C	A	1	5	6	0	0	6	0	0
11	33835542	.	T	C	7	8	15	0	1	16	0	0
11	33841788	.	C	T	7	11	18	0	0	18	0	0
11	33841984	.	C	T	7	12	19	0	1	20	0	0
11	33842542	.	C	T	1	8	9	0	0	9	0	0
11	33846519	.	T	C	5	5	10	0	1	11	0	0
11	33846657	.	G	A	3	2	5	0	0	5	0	0
11	33846729	.	T	C	4	0	4	0	6	10	0	0
11	33847080	.	T	G	4	5	9	0	0	9	0	0
11	33847123	.	C	T	4	6	10	0	0	10	0	0
11	33847293	.	G	A	5	5	10	0	0	10	0	0
11	33855666	.	G	A	2	3	5	0	0	5	0	0
11	33855703	.	C	T	2	2	4	0	0	4	0	0
11	33857576	.	A	C	1	1	2	0	0	2	0	0
11	33857580	.	G	A	1	1	2	0	0	2	0	0
11	33857833	.	T	C	6	7	13	0	0	13	0	0
11	33870464	.	A	T	3	3	6	0	0	6	0	0
11	33871043	.	T	G	3	2	5	0	0	5	0	0
11	33871099	.	G	A	1	3	4	0	0	4	0	0
11	33871343	.	G	T	3	3	6	0	1	7	0	0
11	33871358	.	G	T	4	3	7	0	0	7	0	0
11	33871378	.	G	T	6	6	12	0	0	12	0	0
11	33871466	.	A	G	5	9	14	0	0	14	0	0
11	33871575	.	A	G	17	13	30	0	1	31	0	0
11	33871897	.	C	T	20	6	26	0	0	26	0	0
11	33872029	.	C	T	0	4	4	0	11	15	0	0
11	33872038	.	G	C	5	0	5	0	7	12	0	0
11	33872289	.	T	C	12	0	12	0	6	18	0	0
11	33872564	.	G	T	17	5	22	0	1	23	0	0
11	33872759	.	A	G	2	4	6	1	0	7	0	0
11	33872763	.	A	C	2	4	6	1	0	7	0	0
11	33872829	.	C	T	1	5	6	0	3	9	0	0
11	33873133	.	G	A	2	5	7	0	0	7	0	0
11	33873408	.	T	C	1	2	3	0	0	3	0	0
11	33873539	.	C	T	0	8	8	0	7	15	0	0
11	33873578	.	A	C	6	6	12	0	1	13	0	0
11	33880086	.	A	G	5	1	6	0	0	6	0	0
11	33880089	.	C	T	0	0	0	0	5	5	0	0
11	33888884	.	G	A	7	7	14	0	0	14	0	0
11	33900231	.	G	C	1	2	3	0	0	3	0	0
11	33900436	.	G	C	2	2	4	0	0	4	0	0
11	33912573	.	T	C	2	4	6	0	1	7	0	0
11	33912597	.	C	A	4	3	7	0	2	9	0	0
11	33912645	.	T	G	3	2	5	0	0	5	0	0
11	33996589	.	A	G	1	2	3	0	0	3	0	0
11	33996600	.	C	T	0	2	2	0	1	3	0	0
11	34146105	.	T	C	1	1	2	0	0	2	0	0
11	34158307	.	T	A	2	1	3	0	0	3	0	0
11	34220129	.	C	T	2	4	6	0	0	6	0	0
11	34220436	.	T	C	0	0	0	0	1	1	0	0
11	34231302	.	G	A	3	2	5	0	0	5	0	0
11	34232662	.	A	G	2	4	6	0	0	6	0	0
11	34232681	.	A	G	1	3	4	0	0	4	0	0
11	34235427	.	C	A	14	10	24	0	0	24	0	0
11	34235498	.	C	G	5	11	16	0	0	16	0	0
11	34235528	.	T	C	5	6	11	0	1	12	0	0
11	34235825	.	A	T	12	11	23	0	0	23	0	0
11	34235858	.	A	C	11	12	23	0	0	23	0	0
11	34235918	.	A	G	6	0	6	0	15	22	1	0
11	34236092	.	G	T	12	12	24	0	0	24	0	0
11	34236686	.	T	C	2	2	4	0	0	4	0	0
11	34236848	.	G	A	5	3	8	0	1	9	0	0
11	34237150	.	C	T	5	7	12	0	0	12	0	0
11	34237217	.	A	G	7	6	13	0	0	13	0	0
11	34779244	.	T	A	3	2	5	0	0	5	0	0
11	34780009	.	T	C	7	3	10	0	2	12	0	0
11	34824331	.	G	A	9	6	15	0	0	15	0	0
11	34856424	.	A	G	4	3	7	0	0	7	0	0
11	34859637	.	C	T	0	2	2	0	0	2	0	0
11	34899393	.	A	G	1	1	2	0	2	4	0	0
11	34900464	.	C	T	7	7	14	0	0	14	0	0
11	34900516	.	A	G	1	0	1	0	0	1	0	0
11	34900521	.	C	T	1	0	1	0	0	1	0	0
11	34907287	.	G	C	5	7	12	0	0	12	0	0
11	34907537	.	A	G	5	0	5	0	4	9	0	0
11	34907649	.	T	G	2	1	3	0	0	3	0	0
11	34907682	.	A	G	0	4	4	0	0	4	0	0
11	34907726	.	T	A	5	7	12	0	0	12	0	0
11	34907794	.	T	C	4	1	5	0	0	5	0	0
11	34907876	.	T	A	5	8	13	0	1	14	0	0
11	34908044	.	A	T	0	2	2	0	0	2	0	0
11	34908060	.	A	C	2	1	3	0	1	4	0	0
11	34908165	.	C	T	8	7	15	0	0	15	0	0
11	34908187	.	G	C	7	8	15	0	0	15	0	0
11	34908201	.	C	T	8	10	18	0	0	18	0	0
11	34908431	.	G	A	4	8	12	0	1	13	0	0
11	34908448	.	T	A	11	7	18	0	1	19	0	0
11	34908516	.	C	A	5	6	11	0	1	13	1	0
11	34908545	.	A	T	1	3	4	0	0	4	0	0
11	34908597	.	T	C	3	2	5	0	0	5	0	0
11	34909268	.	T	A	8	6	14	0	2	16	0	0
11	34909288	.	G	T	0	7	7	0	6	13	0	0
11	34909353	.	C	A	8	1	9	0	1	10	0	0
11	34909489	.	A	G	4	6	10	0	0	10	0	0
11	34909513	.	G	T	2	4	6	0	0	6	0	0
11	34909618	.	A	G	1	6	7	0	0	7	0	0
11	34909868	.	C	T	9	4	13	0	1	14	0	0
11	34909916	.	C	T	4	12	16	0	0	16	0	0
11	34909997	.	G	T	4	8	12	0	0	12	0	0
11	34910349	.	C	T	7	6	13	0	0	13	0	0
11	34910468	.	T	C	6	12	18	0	1	19	0	0
11	34910487	.	T	C	7	10	17	0	0	17	0	0
11	34910503	.	C	T	5	9	14	0	1	15	0	0
11	34910644	.	C	T	1	5	6	0	0	6	0	0
11	34910654	.	C	T	2	5	7	0	0	7	0	0
11	34910867	.	T	A	10	1	11	0	0	11	0	0
11	34910897	.	A	G	4	9	13	1	0	14	0	0
11	34911229	.	G	A	13	9	22	0	0	22	0	0
11	34911445	.	A	G	15	11	26	0	1	27	0	0
11	34911451	.	T	A	14	8	22	0	4	26	0	0
11	34912481	.	G	A	12	12	24	0	1	25	0	0
11	34912616	.	G	A	17	16	33	0	0	33	0	0
11	34912850	.	G	A	16	8	24	1	1	26	0	0
11	34913101	.	C	A	16	7	23	0	0	23	0	0
11	34913307	.	T	A	14	7	21	0	2	23	0	0
11	34913370	.	T	A	14	23	37	0	0	37	0	0
11	34913454	.	G	A	9	6	15	0	0	15	0	0
11	34914190	.	G	A	16	16	32	0	2	34	0	0
11	35019847	.	C	T	3	1	4	0	0	4	0	0
11	35034669	.	G	A	7	12	19	0	1	20	0	0
11	35038124	.	G	C	1	11	12	0	14	26	0	0
11	35056344	.	A	G	0	3	3	0	0	3	0	0
11	35440173	.	T	A	1	4	5	0	0	5	0	0
11	35575689	.	T	C	1	2	3	0	0	3	0	0
11	35759755	.	T	A	4	3	7	0	0	7	0	0
11	35777569	.	C	A	4	3	7	0	0	7	0	0
11	36046521	.	T	A	2	3	5	0	1	6	0	0
11	36046523	.	A	C	2	4	6	0	0	6	0	0
11	36158379	.	A	C	6	7	13	0	1	14	0	0
11	36158839	.	G	T	4	2	6	0	0	6	0	0
11	36180612	.	C	T	3	9	12	0	1	13	0	0
11	36180666	.	C	T	6	3	9	0	1	10	0	0
11	36180774	.	A	G	3	5	8	0	1	9	0	0
11	36180775	.	T	C	3	6	9	0	0	9	0	0
11	36180831	.	G	T	0	5	5	0	2	7	0	0
11	36180876	.	C	A	5	7	12	0	0	12	0	0
11	36205992	.	C	T	7	7	14	0	0	14	0	0
11	36206090	.	C	T	3	6	9	0	0	9	0	0
11	36208199	.	G	A	7	11	18	0	2	20	0	0
11	36208328	.	G	A	0	13	13	0	3	16	0	0
11	36214517	.	C	T	21	13	34	0	2	36	0	0
11	36214815	.	G	A	0	20	20	0	12	32	0	0
11	36214859	.	C	T	8	15	23	0	0	23	0	0
11	36214955	.	A	T	10	16	26	0	1	27	0	0
11	36215346	.	G	A	11	14	25	0	1	26	0	0
11	36215399	.	A	G	9	17	26	0	1	27	0	0
11	36218548	.	G	C	3	3	6	0	0	6	0	0
11	36224833	.	C	T	0	3	3	0	0	3	0	0
11	36230101	.	G	A	4	3	7	0	0	7	0	0
11	36236419	.	C	T	1	2	3	0	0	3	0	0
11	36236950	.	G	A	0	4	4	0	4	8	0	0
11	36237094	.	C	T	1	2	3	0	1	4	0	0
11	36237421	.	T	C	1	6	7	0	0	7	0	0
11	36237601	.	A	C	1	2	3	0	0	3	0	0
11	36254334	.	C	T	1	2	3	0	0	3	0	0
11	36254653	.	C	A	0	4	4	0	6	10	0	0
11	36269682	.	G	A	6	3	9	0	1	10	0	0
11	36269768	.	A	G	2	3	5	0	0	5	0	0
11	36269788	.	A	G	1	3	4	0	0	4	0	0
11	36281939	.	T	G	6	8	14	0	0	14	0	0
11	36281943	.	G	A	6	6	12	0	0	12	0	0
11	36282417	.	G	T	10	13	23	0	0	23	0	0
11	36282450	.	G	T	8	10	18	0	2	20	0	0
11	36282494	.	G	T	8	3	11	0	0	11	0	0
11	36282501	.	C	T	9	3	12	0	1	13	0	0
11	36282612	.	G	A	4	4	8	0	0	8	0	0
11	36282621	.	T	C	3	0	3	0	3	6	0	0
11	36282701	.	T	G	4	3	7	0	0	7	0	0
11	36282710	.	G	T	3	3	6	0	0	6	0	0
11	36282961	.	G	A	4	5	9	0	1	10	0	0
11	36283728	.	A	G	2	0	2	0	0	2	0	0
11	36340738	.	C	T	3	2	5	0	0	5	0	0
11	36340961	.	A	G	2	7	9	0	0	9	0	0
11	36340991	.	T	C	2	4	6	0	0	6	0	0
11	36343167	.	G	C	16	22	38	0	0	38	0	0
11	36343339	.	A	T	2	3	5	0	0	5	0	0
11	36355376	.	T	C	1	3	4	0	0	4	0	0
11	36369242	.	C	G	1	3	4	0	0	4	0	0
11	36372937	.	A	G	2	3	5	0	0	5	0	0
11	36372961	.	G	A	1	3	4	0	0	4	0	0
11	36373059	.	C	T	1	1	2	0	3	5	0	0
11	36373430	.	G	A	2	3	5	0	0	5	0	0
11	36373459	.	A	T	1	2	3	0	0	3	0	0
11	36373738	.	T	C	2	2	4	0	0	4	0	0
11	36373746	.	T	C	2	1	3	0	0	3	0	0
11	36374944	.	T	G	5	6	11	0	0	11	0	0
11	36374958	.	T	C	6	8	14	0	0	14	0	0
11	36374993	.	G	T	5	7	12	0	0	12	0	0
11	36375028	.	A	G	3	0	3	0	7	10	0	0
11	36375120	.	T	G	2	2	4	4	1	9	0	0
11	36375367	.	T	C	3	5	8	0	0	8	0	0
11	36375671	.	C	T	10	8	18	0	1	19	0	0
11	36375708	.	A	G	8	12	20	0	0	20	0	0
11	36375774	.	A	T	10	6	16	0	0	16	0	0
11	36393111	.	A	G	3	0	3	0	6	9	0	0
11	36393150	.	T	A	5	2	7	0	0	7	0	0
11	36395728	.	T	C	0	1	1	0	0	1	0	0
11	36398192	.	G	A	0	4	4	0	1	5	0	0
11	36398318	.	A	G	0	2	2	0	1	3	0	0
11	36398531	.	A	G	3	0	3	0	7	10	0	0
11	36398558	.	T	A	1	7	8	0	1	9	0	0
11	36422342	.	C	G	4	2	6	0	0	6	0	0
11	36422351	.	G	A	4	2	6	0	0	6	0	0
11	36429500	.	T	C	3	2	5	0	1	6	0	0
11	36452372	.	G	A	3	2	5	0	0	5	0	0
11	36452453	.	C	A	5	2	7	0	0	7	0	0
11	36452688	.	A	G	11	8	19	0	0	19	0	0
11	36456011	.	C	T	0	3	3	0	0	3	0	0
11	36456056	.	T	C	4	2	6	0	0	6	0	0
11	36456058	.	T	G	4	2	6	0	0	6	0	0
11	36456101	.	T	A	5	4	9	0	0	9	0	0
11	36456125	.	A	C	4	0	4	0	3	7	0	0
11	36460829	.	G	A	5	3	8	0	1	9	0	0
11	36463965	.	T	C	2	3	5	0	0	5	0	0
11	36467942	.	G	A	1	2	3	0	0	3	0	0
11	36467948	.	C	T	2	2	4	0	0	4	0	0
11	36468047	.	G	A	1	2	3	0	0	3	0	0
11	36470493	.	C	T	0	0	0	0	1	1	0	0
11	36470651	.	G	A	2	0	2	0	0	2	0	0
11	36470678	.	G	A	2	1	3	0	0	3	0	0
11	36471901	.	C	T	1	3	4	0	0	4	0	0
11	36477626	.	G	A	9	9	18	0	0	18	0	0
11	36477777	.	C	T	3	2	5	0	2	7	0	0
11	36477803	.	C	T	7	3	10	0	0	10	0	0
11	36482269	.	A	G	5	11	16	0	0	16	0	0
11	36482311	.	C	T	10	3	13	0	0	13	0	0
11	36484836	.	G	A	11	4	15	0	0	15	0	0
11	36485042	.	A	G	7	0	7	0	7	14	0	0
11	36489169	.	G	C	5	3	8	0	0	8	0	0
11	36489205	.	T	C	5	15	20	0	0	20	0	0
11	36489428	.	A	T	6	6	12	0	0	12	0	0
11	36489584	.	T	G	6	2	8	0	0	8	0	0
11	36489706	.	T	C	4	5	9	0	0	9	0	0
11	36625577	.	C	T	1	2	3	0	0	3	0	0
11	36689254	.	C	T	0	4	4	0	5	9	0	0
11	36742774	.	G	A	0	1	1	0	0	1	0	0
11	36795564	.	G	T	11	5	16	0	0	16	0	0
11	36797149	.	C	T	0	0	0	0	2	2	0	0
11	36801796	.	G	A	5	0	5	0	1	6	0	0
11	36806296	.	A	G	1	5	6	0	0	6	0	0
11	36816163	.	T	C	7	4	11	0	0	11	0	0
11	36816171	.	T	C	2	6	8	0	0	8	0	0
11	36818820	.	A	T	3	3	6	0	1	7	0	0
11	36819529	.	C	T	3	3	6	0	1	7	0	0
11	36819904	.	G	A	3	1	4	0	0	4	0	0
11	36847101	.	T	C	3	8	11	0	2	14	1	0
11	36885948	.	G	A	1	2	3	0	0	3	0	0
11	36989853	.	T	A	1	6	7	0	1	8	0	0
11	37001740	.	C	T	2	3	5	0	0	5	0	0
11	37004565	.	G	A	2	2	4	0	0	4	0	0
11	37015968	.	T	C	0	1	1	0	0	1	0	0
11	37020807	.	G	T	4	4	8	0	0	8	0	0
11	37031950	.	C	T	6	2	8	0	1	9	0	0
11	37032391	.	A	G	2	3	5	0	1	6	0	0
11	37032423	.	T	G	1	2	3	0	0	3	0	0
11	37032610	.	A	T	6	4	10	0	0	10	0	0
11	37032626	.	T	C	4	5	9	0	0	9	0	0
11	37032880	.	G	T	5	6	11	0	0	11	0	0
11	37033356	.	G	T	4	3	7	0	1	8	0	0
11	37033474	.	A	G	1	3	4	0	0	4	0	0
11	37033516	.	G	A	2	3	5	0	1	6	0	0
11	37033552	.	A	G	2	0	2	0	8	10	0	0
11	37033603	.	T	A	2	7	9	0	1	10	0	0
11	37033676	.	C	T	6	9	15	0	0	15	0	0
11	37033846	.	G	C	7	1	8	0	0	8	0	0
11	37033855	.	T	A	7	2	9	0	0	9	0	0
11	37033900	.	A	T	3	3	6	0	0	6	0	0
11	37035176	.	A	T	3	3	6	0	0	6	0	0
11	37035240	.	T	A	4	3	7	0	2	9	0	0
11	37035454	.	A	G	10	0	10	0	10	20	0	0
11	37049545	.	G	A	1	4	5	0	0	5	0	0
11	37070236	.	C	T	2	2	4	0	0	4	0	0
11	37080971	.	G	T	6	4	10	0	0	10	0	0
11	37088827	.	C	T	1	8	9	0	0	9	0	0
11	37109252	.	G	A	1	0	1	0	0	1	0	0
11	37109432	.	C	T	2	0	2	0	0	2	0	0
11	37137676	.	G	T	4	3	7	0	0	7	0	0
11	37137762	.	A	T	1	2	3	0	0	3	0	0
11	37144864	.	C	T	6	5	11	0	0	11	0	0
11	37152812	.	G	C	2	2	4	0	0	4	0	0
11	37155215	.	A	G	6	0	6	0	7	13	0	0
11	37155247	.	A	T	9	6	15	0	1	16	0	0
11	37155394	.	A	G	3	9	12	0	4	16	0	0
11	37155400	.	T	A	11	5	16	0	0	16	0	0
11	37159289	.	T	A	7	11	18	0	2	20	0	0
11	37159902	.	G	A	2	2	4	0	0	4	0	0
11	37159961	.	A	T	4	7	11	0	0	11	0	0
11	37159994	.	T	A	7	0	7	0	0	7	0	0
11	37160052	.	T	A	9	7	16	0	0	16	0	0
11	37162183	.	A	G	4	3	7	0	0	7	0	0
11	37162563	.	C	A	9	7	16	0	1	17	0	0
11	37162564	.	A	T	9	7	16	0	1	17	0	0
11	37162657	.	C	A	4	1	5	0	1	6	0	0
11	37163874	.	A	G	7	9	16	0	0	16	0	0
11	37163997	.	T	A	9	4	13	0	1	14	0	0
11	37167699	.	A	T	7	4	11	0	0	11	0	0
11	37167834	.	T	C	0	4	4	0	0	4	0	0
11	37167991	.	T	C	4	5	9	0	0	9	0	0
11	37168039	.	A	T	8	5	13	0	1	14	0	0
11	37168147	.	T	C	3	3	6	0	0	6	0	0
11	37168162	.	T	A	2	2	4	0	0	4	0	0
11	37169144	.	G	A	9	7	16	0	1	17	0	0
11	37169238	.	G	A	4	4	8	0	0	8	0	0
11	37170158	.	A	T	4	2	6	0	0	6	0	0
11	37170162	.	G	C	2	4	6	0	0	6	0	0
11	37297678	.	C	T	10	6	16	0	0	16	0	0
11	37297681	.	A	G	9	6	15	0	1	17	1	0
11	37297811	.	A	T	16	15	31	0	1	32	0	0
11	37297951	.	T	C	18	14	32	0	2	34	0	0
11	37298028	.	T	A	16	8	24	0	1	25	0	0
11	37298569	.	A	G	22	10	32	0	2	34	0	0
11	37298718	.	G	A	15	8	23	0	0	23	0	0
11	37298755	.	G	A	8	10	18	0	1	19	0	0
11	37299378	.	A	T	12	7	19	0	1	20	0	0
11	37315716	.	G	C	0	2	2	0	0	2	0	0
11	37337360	.	C	T	1	3	4	0	0	4	0	0
11	37411070	.	G	A	3	4	7	0	1	8	0	0
11	37431953	.	C	T	24	26	50	0	0	50	0	0
11	37434255	.	T	G	7	9	16	0	1	17	0	0
11	37434259	.	T	G	7	10	17	0	1	18	0	0
11	37434533	.	A	G	27	11	38	0	1	40	1	0
11	37442671	.	G	A	11	22	33	0	0	33	0	0
11	37442752	.	C	G	15	14	29	0	0	30	1	0
11	37442772	.	G	T	11	18	29	0	0	29	0	0
11	37445219	.	A	G	22	13	35	0	2	37	0	0
11	37445502	.	T	C	13	0	13	0	20	33	0	0
11	37445774	.	G	A	18	8	26	0	0	26	0	0
11	37445825	.	G	A	11	14	25	0	3	28	0	0
11	37446107	.	G	A	7	7	14	0	0	14	0	0
11	37446173	.	T	A	7	7	14	0	3	17	0	0
11	37446736	.	C	G	10	17	27	0	2	29	0	0
11	37447754	.	C	T	0	16	16	0	4	20	0	0
11	37450619	.	A	C	5	7	12	0	0	12	0	0
11	37450777	.	T	C	4	7	11	0	0	11	0	0
11	37451040	.	C	T	0	4	4	0	4	8	0	0
11	37452021	.	G	A	8	12	20	0	0	20	0	0
11	37548381	.	C	T	2	5	7	0	0	7	0	0
11	37613515	.	G	A	7	9	16	0	0	16	0	0
11	37613577	.	G	A	13	18	31	0	3	34	0	0
11	37613641	.	A	G	19	17	36	0	1	37	0	0
11	37616775	.	T	C	22	10	32	0	2	34	0	0
11	37616823	.	A	G	10	6	16	0	0	16	0	0
11	37868358	.	C	T	1	3	4	0	0	4	0	0
11	38033520	.	A	G	6	7	13	0	0	13	0	0
11	38048836	.	G	A	1	6	7	0	0	7	0	0
11	38051016	.	G	A	2	2	4	0	0	4	0	0
11	38055477	.	G	A	1	1	2	0	0	2	0	0
11	38055627	.	C	T	0	4	4	0	3	7	0	0
11	38083026	.	T	C	5	3	8	0	0	8	0	0
11	38480362	.	G	A	1	2	3	0	0	3	0	0
11	38480833	.	G	A	0	2	2	0	0	2	0	0
11	38505380	.	G	A	7	3	10	0	0	10	0	0
11	38505489	.	G	A	9	3	12	0	0	12	0	0
11	38506401	.	A	T	6	3	9	0	0	9	0	0
11	38506404	.	A	T	3	6	9	0	0	9	0	0
11	38506442	.	A	T	6	4	10	0	0	10	0	0
11	38506463	.	T	C	4	5	9	0	0	9	0	0
11	38506543	.	A	G	3	2	5	0	0	5	0	0
11	38506571	.	A	C	3	2	5	0	0	5	0	0
11	38506790	.	A	T	3	2	5	0	0	5	0	0
11	38506794	.	T	C	4	3	7	0	0	7	0	0
11	38506923	.	A	G	1	3	4	0	0	4	0	0
11	38506931	.	G	A	1	2	3	0	0	3	0	0
11	38507042	.	C	T	0	2	2	0	3	5	0	0
11	38507219	.	A	T	1	2	3	0	0	3	0	0
11	38507227	.	C	T	1	2	3	0	0	3	0	0
11	38507918	.	A	G	2	2	4	0	0	4	0	0
11	38508717	.	T	C	5	0	5	0	3	8	0	0
11	38508728	.	C	T	4	4	8	0	0	8	0	0
11	38509167	.	G	A	6	4	10	0	0	10	0	0
11	38509205	.	G	A	3	3	6	0	0	6	0	0
11	38509550	.	T	C	3	5	8	0	0	8	0	0
11	38509553	.	A	C	3	0	3	0	5	8	0	0
11	38509736	.	C	T	4	2	6	0	0	6	0	0
11	38509922	.	G	A	1	4	5	0	0	5	0	0
11	38510025	.	A	G	5	4	9	0	0	9	0	0
11	38510057	.	C	T	0	5	5	0	2	7	0	0
11	38510402	.	G	A	1	2	3	0	0	3	0	0
11	38540288	.	C	A	8	4	12	0	1	13	0	0
11	38540824	.	C	T	18	19	37	0	1	38	0	0
11	38541355	.	A	G	20	17	37	0	2	39	0	0
11	38542088	.	A	T	18	7	25	0	1	26	0	0
11	38542142	.	G	A	18	15	33	0	2	35	0	0
11	38542655	.	T	C	18	1	19	0	14	33	0	0
11	38545790	.	G	C	1	0	1	0	3	4	0	0
11	38545874	.	C	G	0	19	19	0	24	43	0	0
11	38807879	.	G	A	2	3	5	0	0	5	0	0
11	38808113	.	C	T	10	6	16	0	0	16	0	0
11	38846046	.	C	T	4	10	14	0	1	15	0	0
11	38846301	.	T	G	8	1	9	0	8	17	0	0
11	38846316	.	T	A	10	7	17	0	0	17	0	0
11	38850244	.	G	A	1	3	4	0	7	11	0	0
11	38853397	.	A	T	4	10	14	0	0	14	0	0
11	38853511	.	A	G	2	3	5	0	1	6	0	0
11	38868012	.	G	T	7	3	10	0	0	10	0	0
11	38874937	.	G	A	24	7	31	0	1	32	0	0
11	38875221	.	A	G	13	17	30	0	0	30	0	0
11	38875283	.	A	T	10	22	32	0	2	34	0	0
11	38875352	.	G	A	7	18	25	0	1	26	0	0
11	38875397	.	T	G	12	3	15	0	0	15	0	0
11	38875484	.	A	C	16	8	24	0	1	25	0	0
11	38875498	.	C	A	9	15	24	0	0	24	0	0
11	38875660	.	T	C	15	11	26	0	1	27	0	0
11	38875867	.	T	C	3	5	8	0	1	9	0	0
11	38875897	.	T	C	2	5	7	0	0	7	0	0
11	38875912	.	A	G	2	4	6	0	0	6	0	0
11	39014553	.	G	A	16	18	34	0	1	35	0	0
11	39044451	.	T	A	10	14	24	0	0	24	0	0
11	39076138	.	C	T	0	3	3	0	5	8	0	0
11	39076198	.	G	T	4	1	5	0	1	6	0	0
11	39076200	.	A	T	4	2	6	0	0	6	0	0
11	39107156	.	C	T	5	4	9	0	0	9	0	0
11	39109555	.	C	T	1	4	5	0	0	5	0	0
11	39110046	.	C	T	2	2	4	0	0	4	0	0
11	39112035	.	A	G	8	7	15	0	1	16	0	0
11	39112068	.	C	T	7	8	15	0	0	15	0	0
11	39113887	.	G	A	1	3	4	0	0	4	0	0
11	39113899	.	T	C	1	2	3	0	0	3	0	0
11	39113986	.	C	T	0	4	4	0	2	6	0	0
11	39114037	.	G	A	2	2	4	0	0	4	0	0
11	39114678	.	T	C	1	2	3	0	0	3	0	0
11	39114682	.	C	T	1	1	2	0	1	3	0	0
11	39114764	.	T	C	0	0	0	0	2	2	0	0
11	39114811	.	A	C	0	3	3	0	0	3	0	0
11	39115034	.	G	A	0	2	2	0	1	3	0	0
11	39118624	.	T	C	1	0	1	0	1	2	0	0
11	39135393	.	C	T	2	1	3	0	0	3	0	0
11	39141527	.	A	G	29	21	50	0	1	51	0	0
11	39141732	.	T	G	10	12	22	0	0	22	0	0
11	39141924	.	G	T	10	9	19	0	1	20	0	0
11	39147065	.	T	C	14	17	31	0	1	32	0	0
11	39147085	.	C	T	9	15	24	0	2	26	0	0
11	39147387	.	T	C	18	20	38	0	4	42	0	0
11	39147445	.	G	C	15	9	24	0	3	27	0	0
11	39147857	.	G	C	7	19	26	0	2	30	2	0
11	39147905	.	C	A	14	12	26	0	3	29	0	0
11	39147906	.	A	T	14	15	29	0	0	29	0	0
11	39147989	.	T	C	22	15	37	0	6	43	0	0
11	39148015	.	C	T	13	16	29	0	6	35	0	0
11	39168201	.	T	A	0	3	3	0	0	3	0	0
11	39168202	.	C	G	0	3	3	0	0	3	0	0
11	39168309	.	T	C	4	2	6	0	0	6	0	0
11	39168313	.	G	C	4	2	6	0	0	6	0	0
11	39926731	.	A	T	1	5	6	0	0	6	0	0
11	39926732	.	T	A	1	4	5	0	1	6	0	0
11	40647123	.	A	C	1	6	7	0	0	7	0	0
11	40653819	.	G	A	4	1	5	0	0	5	0	0
11	40657839	.	G	A	12	7	19	0	3	22	0	0
11	40657905	.	G	A	8	9	17	0	4	21	0	0
11	40658022	.	C	T	15	9	24	0	2	26	0	0
11	40658232	.	C	T	7	10	17	0	1	18	0	0
11	40658322	.	T	G	5	4	9	0	0	9	0	0
11	40658352	.	G	A	0	10	10	0	5	15	0	0
11	40661378	.	T	C	5	0	5	0	0	5	0	0
11	40665494	.	C	T	2	0	2	0	0	2	0	0
11	40665602	.	G	T	1	8	9	0	18	27	0	0
11	40673658	.	T	G	5	6	11	0	0	11	0	0
11	40673797	.	C	T	6	16	22	0	0	22	0	0
11	40677967	.	T	C	39	14	53	0	2	55	0	0
11	40678445	.	A	C	29	0	29	0	24	53	0	0
11	40714196	.	C	T	0	1	1	0	1	2	0	0
11	40714207	.	G	A	1	1	2	0	0	2	0	0
11	40716291	.	C	T	1	0	1	0	0	1	0	0
11	40831754	.	A	G	2	0	2	0	0	2	0	0
11	40843028	.	A	G	1	6	7	0	1	8	0	0
11	40843055	.	G	T	0	3	3	0	6	9	0	0
11	40843064	.	C	A	7	2	9	0	1	10	0	0
11	40843439	.	A	G	10	1	11	0	9	20	0	0
11	40843502	.	C	T	6	8	14	0	1	15	0	0
11	40843835	.	G	A	0	5	5	0	3	9	1	0
11	40844085	.	T	G	1	5	6	0	0	6	0	0
11	40844094	.	C	T	2	4	6	0	0	6	0	0
11	40845006	.	C	T	9	10	19	0	2	21	0	0
11	40845071	.	C	T	5	5	10	0	1	11	0	0
11	40845080	.	G	A	1	2	3	0	5	8	0	0
11	41066190	.	T	G	0	0	0	0	1	1	0	0
11	41066765	.	T	G	12	17	29	0	2	31	0	0
11	41066871	.	C	T	9	13	22	0	0	22	0	0
11	41066888	.	C	T	6	14	20	0	0	20	0	0
11	41066950	.	A	G	10	17	27	0	0	27	0	0
11	41067275	.	G	A	9	9	18	0	0	18	0	0
11	41067430	.	A	T	6	6	12	0	0	12	0	0
11	41067442	.	C	T	4	7	11	0	1	12	0	0
11	41067488	.	A	C	1	11	12	0	2	14	0	0
11	41067502	.	G	A	2	12	14	0	1	15	0	0
11	41067613	.	A	G	1	8	9	0	1	10	0	0
11	41078522	.	C	A	7	3	10	0	0	10	0	0
11	41078578	.	A	T	8	4	12	0	0	12	0	0
11	41078762	.	A	T	4	4	8	0	0	8	0	0
11	41082558	.	G	C	3	4	7	0	0	7	0	0
11	41084325	.	T	G	2	0	2	0	0	2	0	0
11	41089631	.	G	T	4	6	10	0	0	10	0	0
11	41089641	.	T	C	2	6	8	0	0	8	0	0
11	41101666	.	A	G	7	6	13	0	1	14	0	0
11	41101760	.	A	T	4	3	7	0	1	8	0	0
11	41101800	.	T	A	3	8	11	0	1	12	0	0
11	41101866	.	C	T	4	2	6	0	0	6	0	0
11	41101910	.	G	A	6	3	9	0	0	9	0	0
11	41101918	.	C	T	7	3	10	0	0	10	0	0
11	41101948	.	A	G	5	0	5	0	5	10	0	0
11	41102013	.	A	G	5	0	5	0	7	12	0	0
11	41102026	.	T	C	4	4	8	0	0	8	0	0
11	41102205	.	A	G	5	1	6	0	0	6	0	0
11	41104549	.	A	G	4	6	10	0	1	11	0	0
11	41105030	.	G	A	0	4	4	0	4	8	0	0
11	41105144	.	T	G	3	0	3	0	5	8	0	0
11	41105188	.	T	C	5	1	6	0	0	6	0	0
11	41105210	.	G	A	1	3	4	0	2	6	0	0
11	41111301	.	A	G	9	8	17	0	0	17	0	0
11	41111334	.	T	C	9	8	17	0	2	19	0	0
11	41111370	.	C	T	6	10	16	0	0	16	0	0
11	41111422	.	A	G	5	5	10	0	1	11	0	0
11	41111431	.	A	C	4	4	8	0	1	9	0	0
11	41111561	.	T	A	4	5	9	0	0	9	0	0
11	41111603	.	T	A	2	4	6	0	0	6	0	0
11	41111735	.	G	A	7	4	11	0	0	11	0	0
11	41114055	.	C	T	1	6	7	0	2	9	0	0
11	41114186	.	A	C	6	2	8	0	0	8	0	0
11	41122665	.	T	C	1	0	1	0	3	4	0	0
11	41125040	.	A	G	4	3	7	0	0	7	0	0
11	41132195	.	A	G	4	1	5	0	0	5	0	0
11	41216254	.	C	G	0	5	5	0	1	6	0	0
11	41216455	.	T	C	1	1	2	0	8	10	0	0
11	41216505	.	G	C	3	14	17	0	0	17	0	0
11	41216586	.	C	T	6	6	12	0	0	12	0	0
11	41222940	.	A	G	18	17	35	0	0	35	0	0
11	41284762	.	C	T	1	4	5	0	0	5	0	0
11	41306035	.	G	A	0	3	3	0	4	7	0	0
11	41363814	.	T	C	7	7	14	0	0	14	0	0
11	41459981	.	G	C	0	2	2	0	3	5	0	0
11	41461369	.	T	C	7	4	11	0	0	11	0	0
11	41461417	.	C	G	7	16	23	0	0	23	0	0
11	41463534	.	C	G	0	1	1	0	0	1	0	0
11	41468791	.	C	T	6	7	13	0	0	13	0	0
11	41474041	.	T	A	8	9	17	0	0	17	0	0
11	41474042	.	G	T	7	9	16	0	1	17	0	0
11	41474862	.	T	A	1	2	3	0	0	3	0	0
11	41666612	.	A	C	1	2	3	0	0	3	0	0
11	41672337	.	T	C	2	2	4	0	0	4	0	0
11	41699744	.	A	C	4	15	19	0	2	21	0	0
11	41838999	.	G	T	3	7	10	0	0	10	0	0
11	41840490	.	A	G	3	0	3	0	0	3	0	0
11	41840493	.	T	C	1	3	4	0	0	4	0	0
11	41840601	.	A	T	2	2	4	0	2	6	0	0
11	41842313	.	C	T	1	5	6	0	0	6	0	0
11	41844192	.	C	A	0	1	1	0	0	1	0	0
11	41845852	.	A	T	3	1	4	0	0	4	0	0
11	41846123	.	A	C	3	0	3	0	4	7	0	0
11	41846151	.	C	A	2	5	7	0	0	7	0	0
11	41846429	.	C	A	6	8	14	0	0	14	0	0
11	41846430	.	C	A	0	8	8	0	6	14	0	0
11	42174532	.	G	A	1	3	4	0	0	4	0	0
11	42174533	.	G	A	2	2	4	0	0	4	0	0
11	42175030	.	T	C	2	0	2	0	2	4	0	0
11	42175049	.	G	A	1	2	3	0	0	3	0	0
11	42305824	.	C	T	3	6	9	0	0	9	0	0
11	42306057	.	C	T	6	4	10	0	0	10	0	0
11	42306627	.	C	T	0	3	3	0	7	10	0	0
11	42306928	.	A	T	21	9	30	0	0	30	0	0
11	42307147	.	T	A	8	17	25	0	0	25	0	0
11	42307344	.	T	G	7	11	18	0	1	19	0	0
11	42307400	.	A	T	11	15	26	0	0	26	0	0
11	42307816	.	C	T	0	7	7	0	12	19	0	0
11	42315366	.	G	C	8	12	20	0	0	20	0	0
11	42319340	.	C	T	3	5	8	0	0	8	0	0
11	42325520	.	G	A	1	0	1	0	0	1	0	0
11	42327184	.	G	T	0	1	1	0	0	1	0	0
11	42329113	.	C	T	3	8	11	0	0	11	0	0
11	42338894	.	T	C	0	0	0	0	1	1	0	0
11	42350787	.	G	A	3	7	10	0	0	10	0	0
11	42350793	.	G	A	3	7	10	0	1	11	0	0
11	42353054	.	G	A	7	10	17	0	1	18	0	0
11	42355806	.	C	T	5	2	7	0	1	8	0	0
11	42417691	.	G	A	5	6	11	0	2	13	0	0
11	42422760	.	G	A	0	3	3	0	4	7	0	0
11	42457249	.	G	A	0	2	2	0	4	6	0	0
11	42457261	.	T	C	5	3	8	0	0	8	0	0
11	42457325	.	T	C	5	4	9	0	0	9	0	0
11	42457358	.	G	A	3	4	7	0	1	8	0	0
11	42458475	.	A	T	1	2	3	0	0	3	0	0
11	42500674	.	G	A	0	2	2	0	1	3	0	0
11	42500691	.	G	A	2	1	3	0	1	4	0	0
11	42500950	.	A	G	0	3	3	0	0	3	0	0
11	42501285	.	T	C	2	2	4	0	0	4	0	0
11	42502203	.	T	C	3	2	5	0	0	5	0	0
11	42502212	.	A	G	2	2	4	0	0	4	0	0
11	42521982	.	C	G	4	3	7	0	0	7	0	0
11	42521999	.	G	A	2	6	8	0	0	8	0	0
11	42525300	.	C	T	2	2	4	0	0	4	0	0
11	42532660	.	T	G	4	7	11	0	0	11	0	0
11	42532681	.	C	T	5	3	8	0	1	9	0	0
11	42532714	.	G	A	2	2	4	0	0	4	0	0
11	42532886	.	T	A	2	3	5	0	0	5	0	0
11	42532938	.	G	A	5	5	10	0	0	10	0	0
11	42533125	.	C	T	10	4	14	0	0	14	0	0
11	42533180	.	C	G	0	6	6	0	7	13	0	0
11	42533237	.	G	A	6	3	9	0	0	9	0	0
11	42533318	.	G	A	4	5	9	0	0	9	0	0
11	42533321	.	T	G	4	5	9	0	0	9	0	0
11	42539476	.	G	A	10	5	15	0	0	15	0	0
11	42557693	.	A	G	9	8	17	0	1	18	0	0
11	42561212	.	C	A	2	3	5	0	1	6	0	0
11	42600856	.	A	T	3	4	7	0	1	8	0	0
11	42608627	.	A	G	1	0	1	0	0	1	0	0
11	42610466	.	C	T	6	3	9	0	0	9	0	0
11	42618675	.	A	G	7	0	7	0	7	14	0	0
11	42621491	.	G	A	0	7	7	0	4	11	0	0
11	42626276	.	C	T	4	5	9	0	0	9	0	0
11	42715934	.	T	C	1	3	4	0	0	4	0	0
11	42720791	.	G	A	2	2	4	0	0	4	0	0
11	42730834	.	C	G	11	4	15	0	2	17	0	0
11	42730901	.	C	T	21	11	32	0	0	32	0	0
11	42731172	.	G	T	5	4	9	0	0	9	0	0
11	42732314	.	C	T	1	1	2	0	0	2	0	0
11	42732336	.	C	A	2	5	7	0	0	7	0	0
11	42732358	.	T	C	9	6	15	0	1	16	0	0
11	42766053	.	A	G	2	3	5	0	0	5	0	0
11	42801547	.	C	T	2	0	2	0	0	2	0	0
11	42809031	.	C	G	7	6	13	0	1	14	0	0
11	42809162	.	G	A	0	4	4	0	9	13	0	0
11	42809233	.	A	G	6	4	10	0	0	10	0	0
11	42809288	.	T	C	3	9	12	0	0	12	0	0
11	42809300	.	T	C	3	8	11	0	1	12	0	0
11	42809558	.	A	G	2	9	11	0	0	11	0	0
11	42809578	.	A	T	5	4	9	0	1	10	0	0
11	42809657	.	G	T	0	2	2	0	2	4	0	0
11	42816151	.	C	T	7	3	10	0	0	10	0	0
11	42816189	.	G	A	8	2	10	0	0	10	0	0
11	42816208	.	A	T	10	2	12	0	0	12	0	0
11	42816257	.	T	C	11	0	11	0	0	11	0	0
11	42816262	.	C	G	7	0	7	0	4	11	0	0
11	42816446	.	A	G	3	2	5	1	3	9	0	0
11	42816496	.	A	G	4	6	10	0	1	11	0	0
11	42816859	.	C	T	1	3	4	0	1	5	0	0
11	42817067	.	A	G	3	4	7	0	0	7	0	0
11	42817113	.	A	T	5	5	10	0	0	10	0	0
11	42817534	.	G	A	4	7	11	0	0	11	0	0
11	42817552	.	A	G	4	7	11	0	0	11	0	0
11	42912098	.	T	C	1	4	5	0	0	5	0	0
11	42912126	.	A	G	1	3	4	0	0	4	0	0
11	42912594	.	A	T	2	2	4	0	0	4	0	0
11	42912620	.	T	C	1	2	3	0	0	3	0	0
11	42912870	.	G	C	2	2	4	0	0	4	0	0
11	42913020	.	A	G	2	2	4	0	0	4	0	0
11	42913021	.	C	T	0	2	2	0	2	4	0	0
11	42915080	.	T	A	2	2	4	0	1	5	0	0
11	42915579	.	T	C	2	2	4	0	0	4	0	0
11	42917543	.	G	A	1	3	4	0	0	4	0	0
11	42933813	.	A	G	0	4	4	0	0	4	0	0
11	42940748	.	C	T	0	2	2	0	0	2	0	0
11	42942852	.	T	C	1	2	3	0	0	3	0	0
11	42942930	.	G	A	4	3	7	0	0	7	0	0
11	42947471	.	A	G	0	1	1	0	1	2	0	0
11	42947480	.	G	A	2	1	3	0	1	4	0	0
11	42949086	.	T	C	1	1	2	0	6	8	0	0
11	42949819	.	G	A	3	4	7	0	0	7	0	0
11	42949828	.	T	G	4	4	8	0	0	8	0	0
11	42954479	.	G	A	1	1	2	0	0	2	0	0
11	42958993	.	A	G	1	1	2	0	0	2	0	0
11	42971336	.	A	G	1	1	2	0	0	2	0	0
11	42971408	.	A	C	1	0	1	0	2	3	0	0
11	42974959	.	G	T	1	2	3	0	0	3	0	0
11	42974962	.	G	A	1	2	3	0	0	3	0	0
11	42976503	.	T	C	2	1	3	0	0	3	0	0
11	43045604	.	G	A	6	4	10	0	0	10	0	0
11	43102460	.	C	A	0	3	3	0	0	3	0	0
11	43104424	.	G	C	2	0	2	0	2	4	0	0
11	43115689	.	C	T	1	2	3	0	0	3	0	0
11	43137659	.	C	T	23	30	53	0	1	54	0	0
11	43151260	.	C	T	30	18	48	0	1	49	0	0
11	43159295	.	T	C	18	1	19	0	32	51	0	0
11	43167677	.	A	T	4	11	15	0	1	16	0	0
11	43170699	.	A	G	22	17	39	0	1	40	0	0
11	43170792	.	A	T	24	19	43	0	3	46	0	0
11	43170992	.	G	T	29	15	44	0	1	45	0	0
11	43171263	.	G	A	16	13	29	0	1	30	0	0
11	43171314	.	A	G	10	22	32	0	1	33	0	0
11	43178811	.	T	A	8	6	14	0	0	14	0	0
11	43178823	.	G	A	11	6	17	0	1	18	0	0
11	43178958	.	C	T	18	11	29	0	0	29	0	0
11	43178991	.	G	A	16	14	30	0	0	30	0	0
11	43179006	.	G	C	13	19	32	0	2	34	0	0
11	43179248	.	T	G	12	8	20	0	1	22	1	0
11	43187495	.	T	C	18	14	32	0	0	32	0	0
11	43189115	.	G	A	7	3	10	0	1	11	0	0
11	43189118	.	G	A	6	2	8	0	0	8	0	0
11	43189275	.	T	G	5	8	13	0	0	13	0	0
11	43200347	.	C	T	3	2	5	0	1	6	0	0
11	43200419	.	T	A	15	13	28	0	2	30	0	0
11	43378219	.	C	A	0	1	1	0	0	1	0	0
11	43378356	.	C	T	1	0	1	0	0	1	0	0
11	43381243	.	A	G	1	1	2	0	0	2	0	0
11	43387562	.	C	T	2	9	11	0	0	11	0	0
11	43387576	.	T	C	6	2	8	0	0	8	0	0
11	43387641	.	G	A	1	3	4	0	2	6	0	0
11	43401675	.	T	A	0	3	3	0	0	3	0	0
11	43411231	.	C	T	4	8	12	0	0	12	0	0
11	43470473	.	T	A	4	7	11	0	1	12	0	0
11	43470619	.	C	T	3	3	6	0	1	7	0	0
11	43470740	.	C	T	1	4	5	0	6	11	0	0
11	43470803	.	G	C	3	2	5	0	1	6	0	0
11	43711700	.	C	A	1	2	3	0	0	3	0	0
11	44019868	.	A	G	3	4	7	0	0	7	0	0
11	44021999	.	T	G	2	5	7	0	0	7	0	0
11	44023934	.	C	T	7	3	10	0	0	10	0	0
11	44024006	.	C	T	0	2	2	0	1	3	0	0
11	44144928	.	G	A	22	27	49	0	1	50	0	0
11	44144958	.	T	G	18	33	51	0	3	54	0	0
11	44148453	.	A	G	22	22	44	0	1	45	0	0
11	44152579	.	C	T	20	16	36	0	4	40	0	0
11	44152693	.	T	G	30	16	46	0	2	48	0	0
11	44152795	.	T	C	30	21	51	0	1	52	0	0
11	44153038	.	G	A	6	6	12	0	0	12	0	0
11	44155422	.	G	A	5	2	7	0	0	7	0	0
11	44155479	.	T	C	5	0	5	0	3	8	0	0
11	44155485	.	T	C	6	0	6	0	2	8	0	0
11	44155706	.	C	T	0	10	10	0	17	27	0	0
11	44157752	.	G	A	9	12	21	0	1	22	0	0
11	44159320	.	G	C	4	2	6	0	0	6	0	0
11	44163064	.	G	T	6	4	10	0	0	10	0	0
11	44181176	.	A	T	1	4	5	0	0	5	0	0
11	44181298	.	C	A	0	2	2	0	2	4	0	0
11	44181328	.	T	C	2	0	2	0	3	5	0	0
11	44183247	.	T	G	1	3	4	0	0	4	0	0
11	44185659	.	G	C	1	2	3	0	0	3	0	0
11	44188019	.	T	C	0	2	2	0	0	2	0	0
11	44226545	.	G	T	0	3	3	0	5	8	0	0
11	44244895	.	T	C	2	1	3	0	0	3	0	0
11	44304360	.	G	A	4	14	18	0	11	29	0	0
11	44329208	.	G	A	4	0	4	0	0	4	0	0
11	44334915	.	C	T	14	20	34	0	7	41	0	0
11	44337158	.	A	G	1	2	3	0	0	3	0	0
11	44356791	.	A	G	1	10	11	0	0	11	0	0
11	44442425	.	C	T	4	3	7	0	0	7	0	0
11	44445095	.	T	A	5	7	12	0	0	12	0	0
11	44445778	.	C	T	7	12	19	0	2	21	0	0
11	44445828	.	T	C	4	8	12	0	0	12	0	0
11	44452668	.	G	A	11	9	20	0	1	21	0	0
11	44452732	.	T	C	11	12	23	0	0	23	0	0
11	44452790	.	T	C	3	0	3	0	14	17	0	0
11	44452797	.	C	T	0	10	10	0	4	14	0	0
11	44452886	.	A	G	5	7	12	0	0	12	0	0
11	44455901	.	C	T	8	10	18	0	0	18	0	0
11	44457239	.	G	A	12	13	25	0	1	26	0	0
11	44457254	.	A	G	10	7	17	0	0	17	0	0
11	44461386	.	G	C	5	12	17	0	0	17	0	0
11	44461458	.	G	A	14	12	26	0	0	26	0	0
11	44468838	.	G	A	5	2	7	0	1	8	0	0
11	44468842	.	T	C	3	2	5	0	1	6	0	0
11	44481079	.	A	C	1	0	1	0	5	6	0	0
11	44502660	.	C	T	3	4	7	0	0	7	0	0
11	44508073	.	G	A	0	1	1	0	1	2	0	0
11	44520036	.	C	T	4	5	9	0	0	9	0	0
11	44522002	.	C	G	10	6	16	0	0	16	0	0
11	44522119	.	C	T	2	3	5	0	0	5	0	0
11	44522158	.	G	T	1	4	5	0	0	5	0	0
11	44522218	.	A	T	1	2	3	0	0	3	0	0
11	44522995	.	A	G	3	3	6	0	0	6	0	0
11	44523229	.	C	T	2	3	5	0	0	5	0	0
11	44523348	.	A	G	3	2	5	0	0	5	0	0
11	44523385	.	C	A	6	5	11	0	0	11	0	0
11	44523420	.	C	A	9	5	14	0	0	14	0	0
11	44524391	.	G	A	7	5	12	0	1	13	0	0
11	44524423	.	T	G	6	7	13	0	0	13	0	0
11	44524448	.	G	A	1	9	10	0	4	14	0	0
11	44524583	.	T	C	7	4	11	0	1	12	0	0
11	44524631	.	T	C	6	3	9	0	0	9	0	0
11	44524673	.	T	C	3	4	7	0	0	7	0	0
11	44527087	.	G	T	11	8	19	0	0	19	0	0
11	44527115	.	T	A	15	11	26	0	0	26	0	0
11	44527134	.	G	C	18	15	33	0	0	33	0	0
11	44527183	.	T	C	14	1	15	0	16	31	0	0
11	44527367	.	G	A	18	21	39	0	0	39	0	0
11	44527744	.	G	A	13	13	26	0	0	26	0	0
11	44527773	.	G	C	14	0	14	0	10	24	0	0
11	44527820	.	G	A	18	6	24	0	2	26	0	0
11	44528307	.	C	T	17	7	24	0	1	25	0	0
11	44528311	.	C	T	0	7	7	0	18	25	0	0
11	44528351	.	A	C	14	8	22	0	0	22	0	0
11	44528405	.	G	A	6	16	22	0	1	23	0	0
11	44528481	.	A	G	15	15	30	0	1	31	0	0
11	44528539	.	A	G	8	17	25	0	0	25	0	0
11	44528877	.	A	T	11	18	29	0	0	29	0	0
11	44528927	.	G	T	11	7	18	2	1	21	0	0
11	44529149	.	G	A	5	6	11	0	0	11	0	0
11	44529193	.	T	C	4	13	17	0	0	17	0	0
11	44529195	.	T	A	12	4	16	0	1	17	0	0
11	44529719	.	G	A	15	20	35	0	2	37	0	0
11	44530262	.	T	C	3	1	4	0	4	8	0	0
11	44533253	.	T	C	1	0	1	0	0	1	0	0
11	44542958	.	T	A	7	11	18	0	1	19	0	0
11	44606861	.	C	T	6	10	16	0	0	16	0	0
11	44606883	.	G	C	3	7	10	0	0	10	0	0
11	44607291	.	T	A	13	11	24	0	0	24	0	0
11	44607303	.	A	T	12	11	23	0	0	23	0	0
11	44612357	.	A	G	1	0	1	0	0	1	0	0
11	44617110	.	T	G	2	4	6	0	0	6	0	0
11	44622514	.	A	T	2	3	5	0	0	5	0	0
11	44622516	.	G	A	2	3	5	0	0	5	0	0
11	44622565	.	G	A	6	4	10	0	0	10	0	0
11	44622594	.	C	T	1	3	4	0	0	4	0	0
11	44624714	.	C	T	3	2	5	0	0	5	0	0
11	44624723	.	A	C	3	3	6	0	0	6	0	0
11	44634802	.	A	C	5	10	15	0	1	16	0	0
11	44634828	.	C	A	7	8	15	0	2	17	0	0
11	44634965	.	G	A	1	3	4	0	0	4	0	0
11	44637569	.	T	A	5	6	11	0	0	11	0	0
11	44637704	.	C	T	1	12	13	0	18	31	0	0
11	44637714	.	T	C	19	1	20	0	16	36	0	0
11	44637802	.	G	A	13	19	32	0	1	33	0	0
11	44637950	.	A	G	18	21	39	0	2	41	0	0
11	44637953	.	G	T	21	18	39	0	2	41	0	0
11	44638006	.	G	A	4	3	7	0	0	7	0	0
11	44643882	.	C	T	5	5	10	0	0	10	0	0
11	44723130	.	C	G	11	12	23	0	0	23	0	0
11	44723353	.	G	A	1	18	19	0	25	44	0	0
11	44723500	.	C	T	15	25	40	0	1	41	0	0
11	44723746	.	A	G	20	20	40	0	2	42	0	0
11	44725376	.	C	T	21	20	41	0	2	43	0	0
11	44726119	.	C	T	13	19	32	0	3	35	0	0
11	44805464	.	G	C	0	5	5	0	9	14	0	0
11	44805701	.	G	A	1	0	1	0	0	1	0	0
11	44834268	.	G	A	0	0	0	0	2	2	0	0
11	44836755	.	A	G	3	0	3	0	2	5	0	0
11	44843706	.	A	G	3	0	3	0	3	6	0	0
11	44848783	.	A	G	5	0	5	0	4	9	0	0
11	44848876	.	A	T	0	2	2	1	0	3	0	0
11	44852756	.	A	T	8	3	11	0	0	11	0	0
11	44852988	.	T	A	4	3	7	0	0	7	0	0
11	44853044	.	A	G	4	6	10	0	0	10	0	0
11	44853073	.	A	T	3	3	6	0	2	8	0	0
11	44853115	.	A	T	3	2	5	0	0	5	0	0
11	44853156	.	T	A	1	1	2	0	0	2	0	0
11	44853172	.	C	A	0	1	1	0	0	1	0	0
11	44853282	.	T	C	3	4	7	0	0	7	0	0
11	44853325	.	T	C	5	4	9	0	0	9	0	0
11	44854692	.	A	C	1	5	6	0	0	6	0	0
11	44854735	.	A	G	1	0	1	0	3	4	0	0
11	44854847	.	A	G	4	11	15	0	0	15	0	0
11	44854850	.	T	C	4	11	15	0	0	15	0	0
11	44854996	.	T	C	10	9	19	0	1	20	0	0
11	44855027	.	G	A	0	12	12	0	12	24	0	0
11	44880288	.	A	G	15	10	25	0	3	28	0	0
11	44880291	.	T	A	15	13	28	0	0	28	0	0
11	44880332	.	G	A	13	11	24	0	0	24	0	0
11	44880345	.	C	G	9	11	20	0	0	20	0	0
11	44887200	.	G	A	14	17	31	0	0	31	0	0
11	44887224	.	T	C	11	0	11	0	13	24	0	0
11	44887612	.	G	T	24	9	33	0	0	33	0	0
11	44891507	.	G	A	1	3	4	0	0	4	0	0
11	44892859	.	T	A	0	2	2	0	0	2	0	0
11	44892883	.	G	A	2	8	10	0	1	12	1	0
11	44892943	.	G	A	16	9	25	0	0	25	0	0
11	44892979	.	T	A	4	4	8	0	0	8	0	0
11	44897584	.	C	T	11	17	28	0	0	28	0	0
11	44897647	.	A	C	15	9	24	0	0	24	0	0
11	44901315	.	C	T	4	11	15	0	7	22	0	0
11	44901373	.	C	A	27	39	66	0	2	68	0	0
11	44910758	.	T	G	3	1	4	0	0	4	0	0
11	44912485	.	C	A	0	4	4	0	3	7	0	0
11	44913176	.	C	A	0	5	5	0	8	13	0	0
11	44914943	.	G	C	16	15	31	0	2	33	0	0
11	44927159	.	C	A	4	6	10	0	0	10	0	0
11	44927833	.	G	T	6	6	12	0	0	12	0	0
11	44939425	.	G	A	2	2	4	0	0	4	0	0
11	44954090	.	G	A	11	8	19	0	3	22	0	0
11	44960620	.	G	A	3	2	5	0	0	5	0	0
11	45097183	.	G	C	1	4	5	0	0	5	0	0
11	45097195	.	T	C	1	4	5	0	0	5	0	0
11	45120566	.	C	T	6	3	9	0	0	9	0	0
11	45120700	.	G	A	0	1	1	0	0	1	0	0
11	45122701	.	C	T	2	4	6	0	1	7	0	0
11	45125870	.	G	T	0	2	2	0	1	3	0	0
11	45126658	.	C	T	0	7	7	0	16	23	0	0
11	45126730	.	C	A	8	2	10	0	1	11	0	0
11	45126772	.	G	A	3	8	11	0	0	11	0	0
11	45127266	.	A	G	5	9	14	0	0	14	0	0
11	45127329	.	G	A	12	6	18	0	0	18	0	0
11	45127352	.	C	G	3	12	15	0	0	15	0	0
11	45129347	.	C	A	5	5	10	0	0	10	0	0
11	45130676	.	A	G	3	9	12	0	1	13	0	0
11	45130874	.	C	A	0	2	2	0	3	5	0	0
11	45130909	.	G	A	5	2	7	0	1	8	0	0
11	45138768	.	C	A	0	11	11	0	7	18	0	0
11	45139797	.	A	C	2	0	2	0	4	6	0	0
11	45140001	.	A	T	2	8	10	0	0	10	0	0
11	45141271	.	G	A	8	1	9	0	0	9	0	0
11	45143417	.	G	T	4	1	5	0	0	5	0	0
11	45161336	.	C	T	5	2	7	0	0	7	0	0
11	45161381	.	A	T	6	5	11	0	0	11	0	0
11	45161844	.	C	T	6	4	10	0	0	10	0	0
11	45161878	.	T	C	0	6	6	0	0	6	0	0
11	45162241	.	A	T	12	10	22	0	0	22	0	0
11	45227084	.	G	T	0	2	2	0	2	4	0	0
11	45227128	.	T	C	0	1	1	0	1	2	0	0
11	45233971	.	G	A	0	2	2	0	3	5	0	0
11	45235063	.	A	G	2	0	2	0	0	2	0	0
11	45243089	.	A	C	1	2	3	0	0	3	0	0
11	45243092	.	A	C	0	1	1	0	1	2	0	0
11	45262178	.	C	T	8	11	19	0	0	19	0	0
11	45262186	.	G	A	1	8	9	0	11	20	0	0
11	45262342	.	C	T	7	12	19	0	0	19	0	0
11	45265859	.	G	C	4	3	7	0	0	7	0	0
11	45265898	.	C	T	4	9	13	0	0	13	0	0
11	45290839	.	A	G	0	0	0	0	4	4	0	0
11	45290869	.	C	T	8	3	11	0	0	11	0	0
11	45290884	.	C	A	8	4	12	0	0	12	0	0
11	45290989	.	A	C	1	2	3	0	0	3	0	0
11	45291944	.	G	A	2	3	5	0	0	5	0	0
11	45294495	.	C	T	16	5	21	0	1	22	0	0
11	45294553	.	C	A	8	7	15	0	2	17	0	0
11	45326756	.	A	G	3	4	7	0	0	7	0	0
11	45327983	.	G	A	0	5	5	0	4	9	0	0
11	45328001	.	C	T	3	9	12	0	0	12	0	0
11	45328046	.	C	T	6	7	13	0	0	13	0	0
11	45328145	.	G	A	3	3	6	0	0	6	0	0
11	45328166	.	C	T	3	3	6	0	0	6	0	0
11	45328238	.	C	G	3	2	5	0	0	5	0	0
11	45342757	.	A	G	3	7	10	0	0	10	0	0
11	45342823	.	G	A	5	3	8	0	1	9	0	0
11	45342891	.	C	T	5	6	11	0	1	12	0	0
11	45343045	.	C	G	4	3	7	0	0	7	0	0
11	45343176	.	G	C	2	2	4	0	0	4	0	0
11	45343231	.	T	A	4	3	7	0	1	8	0	0
11	45343389	.	G	A	6	4	10	0	1	11	0	0
11	45343492	.	G	A	0	4	4	0	2	6	0	0
11	45344080	.	C	T	2	1	3	0	0	3	0	0
11	45348490	.	G	A	0	2	2	0	1	3	0	0
11	45351639	.	G	A	2	2	4	0	0	4	0	0
11	45355011	.	C	T	0	10	10	0	6	16	0	0
11	45355022	.	C	G	5	9	14	0	1	15	0	0
11	45355394	.	C	T	0	6	6	0	16	22	0	0
11	45355436	.	C	G	15	12	27	0	1	28	0	0
11	45355606	.	G	C	8	8	16	0	0	16	0	0
11	45356114	.	G	A	8	9	17	0	4	21	0	0
11	45356296	.	C	T	0	2	2	0	7	9	0	0
11	45356666	.	A	G	3	1	4	0	0	4	0	0
11	45359173	.	G	A	7	1	8	0	0	8	0	0
11	45359923	.	A	G	7	6	13	0	0	13	0	0
11	45359980	.	G	A	1	6	7	0	0	7	0	0
11	45362324	.	T	C	1	0	1	0	0	1	0	0
11	45366720	.	C	T	5	3	8	0	0	8	0	0
11	45366754	.	T	C	5	1	6	0	2	8	0	0
11	45370529	.	G	A	0	3	3	0	0	3	0	0
11	45371438	.	A	C	2	0	2	0	1	3	0	0
11	45371444	.	G	A	2	1	3	0	0	3	0	0
11	45371474	.	C	A	0	1	1	0	0	1	0	0
11	45371831	.	A	G	1	1	2	0	0	2	0	0
11	45371868	.	A	G	3	2	5	0	1	6	0	0
11	45372123	.	C	T	0	4	4	0	2	6	0	0
11	45385555	.	C	T	0	2	2	0	0	2	0	0
11	45389961	.	A	T	3	5	8	0	0	8	0	0
11	45389981	.	G	A	5	5	10	0	0	10	0	0
11	45390057	.	G	A	5	11	16	0	0	16	0	0
11	45391400	.	C	T	9	7	16	0	1	17	0	0
11	45391430	.	G	T	10	7	17	0	1	18	0	0
11	45391725	.	A	G	11	5	16	0	1	17	0	0
11	45391727	.	T	C	12	5	17	0	0	17	0	0
11	45391788	.	C	T	8	5	13	0	0	13	0	0
11	45393395	.	C	T	17	12	29	0	1	30	0	0
11	45393468	.	G	T	23	22	45	0	0	45	0	0
11	45393520	.	A	C	2	2	4	0	15	19	0	0
11	45393522	.	A	C	2	2	4	0	15	19	0	0
11	45397372	.	C	T	18	13	31	0	1	32	0	0
11	45399389	.	A	G	10	7	17	0	0	17	0	0
11	45399491	.	C	T	22	21	43	0	7	50	0	0
11	45399589	.	A	G	22	21	43	0	1	45	1	0
11	45402861	.	G	A	7	19	26	0	0	26	0	0
11	45403209	.	A	T	14	12	26	0	0	26	0	0
11	45403712	.	G	A	19	14	33	0	1	34	0	0
11	45403782	.	T	C	19	1	20	0	12	32	0	0
11	45403866	.	G	A	12	11	23	0	2	25	0	0
11	45403914	.	C	T	0	3	3	0	1	4	0	0
11	45410613	.	A	G	9	2	11	0	0	11	0	0
11	45412505	.	C	T	0	9	9	0	6	15	0	0
11	45428466	.	A	T	1	2	3	0	0	3	0	0
11	45430139	.	C	T	3	3	6	0	0	6	0	0
11	45439842	.	G	A	0	4	4	0	1	5	0	0
11	45439858	.	C	A	3	1	4	0	1	5	0	0
11	45439899	.	G	A	2	2	4	0	0	4	0	0
11	45448277	.	G	A	0	4	4	0	1	5	0	0
11	45448289	.	C	T	1	4	5	0	0	5	0	0
11	45452786	.	G	A	0	3	3	0	1	4	0	0
11	45454748	.	C	A	3	2	5	0	0	5	0	0
11	45460337	.	G	A	8	3	11	0	0	11	0	0
11	45461318	.	G	A	0	8	8	0	19	27	0	0
11	45463352	.	T	C	4	1	5	0	0	5	0	0
11	45463490	.	G	T	0	12	12	0	15	27	0	0
11	45464817	.	T	G	6	9	15	0	1	16	0	0
11	45464880	.	C	T	15	12	27	0	0	27	0	0
11	45465080	.	T	A	8	15	23	0	1	24	0	0
11	45468821	.	A	C	2	2	4	0	0	4	0	0
11	45468899	.	C	T	0	2	2	0	2	4	0	0
11	45468906	.	T	A	1	2	3	0	0	3	0	0
11	45468951	.	C	T	2	2	4	0	0	4	0	0
11	45469969	.	C	T	7	7	14	0	0	14	0	0
11	45470010	.	G	A	5	7	12	0	4	16	0	0
11	45470243	.	C	T	0	15	15	0	8	23	0	0
11	45470279	.	C	A	0	13	13	0	10	23	0	0
12	457769	.	C	T	0	2	2	0	0	2	0	0
12	465732	.	G	A	0	10	10	0	17	27	0	0
12	466174	.	T	A	7	6	13	0	0	13	0	0
12	466221	.	G	C	7	11	18	0	0	18	0	0
12	497201	.	C	T	17	12	29	0	0	29	0	0
12	499855	.	C	T	5	6	11	0	0	11	0	0
12	499865	.	C	T	5	5	10	0	1	11	0	0
12	502221	.	C	T	8	3	11	0	0	11	0	0
12	503308	.	G	A	15	15	30	0	2	32	0	0
12	516845	.	C	T	3	1	4	0	0	4	0	0
12	518107	.	T	C	1	3	4	0	0	4	0	0
12	527402	.	A	C	18	17	35	0	1	36	0	0
12	527693	.	T	G	13	15	28	0	0	28	0	0
12	527712	.	T	C	13	14	27	0	2	29	0	0
12	532019	.	C	G	1	2	3	0	0	3	0	0
12	533762	.	G	C	0	2	2	0	1	3	0	0
12	534078	.	G	A	1	2	3	0	1	4	0	0
12	534090	.	T	G	1	3	4	0	0	4	0	0
12	534252	.	A	T	1	5	6	0	0	6	0	0
12	534258	.	C	G	1	5	6	0	0	6	0	0
12	534297	.	A	G	4	3	7	0	0	7	0	0
12	534479	.	C	T	1	2	3	0	0	3	0	0
12	534642	.	C	T	2	3	5	0	0	5	0	0
12	540021	.	G	C	1	2	3	0	0	3	0	0
12	549605	.	T	C	7	0	7	0	4	11	0	0
12	550387	.	G	T	12	14	26	1	0	27	0	0
12	550513	.	T	A	11	7	18	0	1	20	1	0
12	550516	.	C	T	0	6	6	0	13	19	0	0
12	550973	.	T	C	14	14	28	0	0	28	0	0
12	550985	.	T	C	12	0	12	0	12	24	0	0
12	551098	.	A	G	17	14	31	0	0	31	0	0
12	551192	.	A	G	6	10	16	0	0	16	0	0
12	551372	.	C	T	9	15	24	0	1	25	0	0
12	551398	.	C	T	9	9	18	0	3	21	0	0
12	551549	.	T	C	4	0	4	0	4	8	0	0
12	551892	.	T	C	14	0	14	0	12	26	0	0
12	551927	.	A	G	13	12	25	0	0	25	0	0
12	554210	.	T	C	10	0	10	0	10	20	0	0
12	558142	.	A	C	9	9	18	0	0	18	0	0
12	561131	.	G	T	1	3	4	0	0	4	0	0
12	561350	.	G	T	2	3	5	0	1	6	0	0
12	562200	.	C	T	3	4	7	0	0	7	0	0
12	562203	.	C	T	0	4	4	0	3	7	0	0
12	564552	.	C	T	0	2	2	0	2	4	0	0
12	564553	.	G	A	2	2	4	0	0	4	0	0
12	564650	.	G	T	4	7	11	0	0	11	0	0
12	565571	.	C	G	5	3	8	0	0	8	0	0
12	566983	.	A	G	4	2	6	0	0	6	0	0
12	567012	.	T	C	2	0	2	0	1	3	0	0
12	568872	.	G	A	1	3	4	0	0	4	0	0
12	571873	.	T	C	2	3	5	0	0	5	0	0
12	573390	.	G	A	3	1	4	0	0	4	0	0
12	573414	.	C	T	3	2	5	0	0	5	0	0
12	577838	.	A	C	6	2	8	0	1	9	0	0
12	602162	.	C	T	1	1	2	0	1	3	0	0
12	602294	.	A	C	1	2	3	0	0	3	0	0
12	611260	.	C	T	0	2	2	0	1	3	0	0
12	611278	.	T	C	1	0	1	0	2	3	0	0
12	630495	.	G	A	3	3	6	0	0	6	0	0
12	630634	.	A	C	3	0	3	0	3	6	0	0
12	632298	.	C	T	1	0	1	0	0	1	0	0
12	634292	.	C	T	0	4	4	0	4	8	0	0
12	645760	.	T	C	4	4	8	0	1	9	0	0
12	755141	.	A	G	0	2	2	0	0	2	0	0
12	760750	.	C	T	0	1	1	0	0	1	0	0
12	847787	.	T	C	11	10	21	0	0	21	0	0
12	847932	.	G	T	14	12	26	0	2	28	0	0
12	848846	.	T	C	22	0	22	0	19	41	0	0
12	850303	.	T	C	4	4	8	0	1	9	0	0
12	906722	.	A	G	4	4	8	0	0	8	0	0
12	910704	.	T	C	0	0	0	0	1	1	0	0
12	911042	.	C	T	0	2	2	0	4	6	0	0
12	911162	.	G	C	6	11	17	0	0	17	0	0
12	911180	.	A	C	5	8	13	0	0	13	0	0
12	912274	.	G	C	1	7	8	0	0	8	0	0
12	931371	.	G	A	3	4	7	0	0	7	0	0
12	931410	.	C	A	0	4	4	0	3	7	0	0
12	931437	.	A	G	1	0	1	0	0	1	0	0
12	932092	.	G	T	5	7	12	0	0	12	0	0
12	964877	.	T	C	17	1	18	0	16	34	0	0
12	964888	.	T	G	17	15	32	0	0	32	0	0
12	972975	.	C	T	0	9	9	0	8	17	0	0
12	976154	.	C	G	0	2	2	0	5	7	0	0
12	979718	.	G	A	1	5	6	0	0	6	0	0
12	982979	.	T	A	6	11	17	0	0	17	0	0
12	983074	.	C	T	12	3	15	0	1	16	0	0
12	983176	.	T	A	7	10	17	0	0	17	0	0
12	983222	.	G	A	8	7	15	0	2	17	0	0
12	983340	.	C	T	15	10	25	0	1	26	0	0
12	986792	.	T	G	5	6	11	0	0	11	0	0
12	986834	.	A	G	2	3	5	0	0	5	0	0
12	989974	.	G	C	3	4	7	0	0	7	0	0
12	992698	.	A	G	2	2	4	0	0	4	0	0
12	992785	.	G	A	4	2	6	0	0	6	0	0
12	992819	.	C	T	3	2	5	0	0	5	0	0
12	993237	.	C	G	2	6	8	0	0	8	0	0
12	997320	.	G	A	1	2	3	0	0	3	0	0
12	997834	.	T	C	6	7	13	0	0	13	0	0
12	997849	.	T	C	5	4	9	0	1	10	0	0
12	997909	.	A	G	1	1	2	0	0	2	0	0
12	997917	.	G	A	0	1	1	0	0	1	0	0
12	999517	.	T	C	6	0	6	0	4	10	0	0
12	999579	.	C	G	1	1	2	0	0	2	0	0
12	1014553	.	C	T	0	14	14	0	2	16	0	0
12	1014668	.	A	G	4	6	10	0	2	12	0	0
12	1015197	.	C	T	0	10	10	0	5	15	0	0
12	1015845	.	G	A	6	12	18	0	0	18	0	0
12	1019123	.	C	T	0	6	6	0	4	10	0	0
12	1019243	.	G	T	2	4	6	0	0	6	0	0
12	1019311	.	C	G	2	2	4	0	1	5	0	0
12	1019503	.	G	A	1	2	3	0	0	3	0	0
12	1021152	.	G	A	5	2	7	0	0	7	0	0
12	1030048	.	A	G	2	4	6	0	0	6	0	0
12	1387913	.	A	G	1	3	4	0	1	5	0	0
12	1947751	.	T	C	6	3	9	0	1	10	0	0
12	1950141	.	C	A	1	1	2	0	0	2	0	0
12	2485624	.	G	C	1	0	1	0	0	1	0	0
12	2488237	.	C	T	2	4	6	0	0	6	0	0
12	2488770	.	C	T	3	2	5	0	0	5	0	0
12	2488938	.	G	A	0	1	1	0	0	1	0	0
12	2492299	.	A	G	1	3	4	0	0	4	0	0
12	2492423	.	G	T	0	5	5	0	2	7	0	0
12	2505557	.	T	G	13	9	22	0	3	25	0	0
12	2505614	.	G	A	9	10	19	0	0	19	0	0
12	2505921	.	G	C	12	0	12	0	13	25	0	0
12	2506007	.	A	G	10	5	15	0	0	15	0	0
12	2506027	.	G	A	8	7	15	0	1	16	0	0
12	2507988	.	T	C	1	0	1	0	2	3	0	0
12	2509851	.	C	G	1	1	2	0	0	2	0	0
12	2514434	.	G	T	4	4	8	0	0	8	0	0
12	2516187	.	T	C	1	0	1	0	3	4	0	0
12	2639079	.	C	A	1	2	3	0	0	3	0	0
12	2669480	.	A	T	1	2	3	0	0	3	0	0
12	2669483	.	T	A	1	2	3	0	0	3	0	0
12	2741477	.	A	T	1	2	3	0	0	3	0	0
12	2741527	.	C	T	1	2	3	0	0	3	0	0
12	2741532	.	T	C	1	3	4	0	0	4	0	0
12	2743327	.	G	T	3	3	6	0	0	6	0	0
12	2743350	.	A	C	3	3	6	0	0	6	0	0
12	2744279	.	G	T	1	3	4	0	0	5	1	0
12	2744291	.	A	T	1	3	4	0	0	4	0	0
12	2829919	.	G	C	1	1	2	0	0	2	0	0
12	2833422	.	C	G	2	0	2	0	0	2	0	0
12	2833488	.	C	A	3	1	4	0	1	5	0	0
12	2834053	.	A	G	0	0	0	0	6	6	0	0
12	2840152	.	G	A	3	2	5	0	1	6	0	0
12	2843700	.	C	G	5	0	5	0	3	8	0	0
12	2846164	.	G	C	0	1	1	0	0	1	0	0
12	2848162	.	C	T	6	7	13	0	0	13	0	0
12	2849908	.	G	A	2	3	5	0	4	9	0	0
12	2849970	.	A	G	7	5	12	0	0	12	0	0
12	2850096	.	C	T	2	6	8	0	0	8	0	0
12	2850410	.	T	C	2	2	4	0	0	4	0	0
12	2850569	.	T	C	6	5	11	0	0	11	0	0
12	2850623	.	G	A	3	7	10	0	0	10	0	0
12	2850637	.	G	A	6	7	13	0	0	13	0	0
12	2850754	.	T	C	6	3	9	0	0	9	0	0
12	2850816	.	T	C	3	0	3	0	4	7	0	0
12	2850927	.	T	A	1	1	2	0	0	2	0	0
12	2850937	.	A	G	1	1	2	0	0	2	0	0
12	2851251	.	G	A	3	2	5	0	0	5	0	0
12	2856901	.	G	C	5	4	9	0	0	9	0	0
12	2869479	.	T	C	2	2	4	0	0	4	0	0
12	2870708	.	G	A	3	2	5	0	0	5	0	0
12	2870733	.	G	A	0	2	2	0	3	5	0	0
12	2893006	.	G	A	0	7	7	0	2	9	0	0
12	2895248	.	T	C	12	5	17	0	0	17	0	0
12	2895264	.	G	T	0	14	14	0	6	20	0	0
12	2895344	.	G	A	0	7	7	0	8	15	0	0
12	2895389	.	T	G	7	4	11	0	0	11	0	0
12	2993535	.	A	G	1	0	1	0	0	1	0	0
12	2993557	.	A	C	1	0	1	0	0	1	0	0
12	2995943	.	T	C	2	2	4	0	1	5	0	0
12	2995996	.	G	T	2	3	5	0	1	6	0	0
12	2996070	.	A	G	2	0	2	0	2	4	0	0
12	3003904	.	T	C	1	5	6	0	0	6	0	0
12	3006358	.	C	T	1	1	2	0	0	2	0	0
12	3010427	.	G	A	1	1	2	0	0	2	0	0
12	3019634	.	T	C	1	5	6	0	0	6	0	0
12	3019681	.	A	G	1	3	4	0	0	4	0	0
12	3022947	.	C	A	18	17	35	0	3	38	0	0
12	3033357	.	T	C	14	15	29	0	1	30	0	0
12	3033360	.	A	C	14	16	30	0	1	31	0	0
12	3038920	.	G	A	0	19	19	0	26	45	0	0
12	3038929	.	A	G	18	1	19	0	24	43	0	0
12	3039078	.	G	C	0	22	22	0	16	38	0	0
12	3039210	.	C	T	25	15	40	0	4	44	0	0
12	3039283	.	T	A	6	20	26	0	1	27	0	0
12	3039311	.	T	C	4	14	18	0	3	21	0	0
12	3039321	.	A	G	4	12	16	0	2	18	0	0
12	3039423	.	G	A	0	11	11	0	11	22	0	0
12	3039522	.	T	C	9	17	26	0	2	28	0	0
12	3039652	.	T	C	15	39	54	0	1	55	0	0
12	3039682	.	A	C	15	26	41	0	0	41	0	0
12	3039738	.	A	T	16	7	23	0	1	24	0	0
12	3039940	.	A	G	5	16	21	0	1	22	0	0
12	3040158	.	A	T	11	17	28	0	0	28	0	0
12	3040178	.	T	C	11	14	25	0	0	25	0	0
12	3040329	.	A	G	13	22	35	0	2	37	0	0
12	3040819	.	T	A	9	18	27	0	1	28	0	0
12	3041087	.	C	A	4	4	8	0	2	10	0	0
12	3041088	.	G	T	0	3	3	0	7	10	0	0
12	3041146	.	A	T	6	3	9	0	1	10	0	0
12	3041179	.	T	A	14	13	27	0	1	28	0	0
12	3041390	.	A	T	17	17	34	0	0	34	0	0
12	3041497	.	G	A	0	15	15	0	16	31	0	0
12	3041587	.	A	T	22	15	37	0	1	39	1	0
12	3041606	.	A	T	24	23	47	0	1	48	0	0
12	3041721	.	G	A	0	16	16	0	35	51	0	0
12	3041871	.	C	T	17	21	38	0	10	48	0	0
12	3041905	.	C	A	19	15	34	0	1	35	0	0
12	3050314	.	T	A	1	0	1	0	0	1	0	0
12	3059595	.	C	T	3	1	4	0	0	4	0	0
12	3059600	.	C	T	3	1	4	0	0	4	0	0
12	3059979	.	C	A	1	3	4	0	0	4	0	0
12	3060003	.	C	T	2	6	8	0	0	8	0	0
12	3060053	.	C	G	3	6	9	0	0	9	0	0
12	3060156	.	A	G	3	4	7	0	0	7	0	0
12	3060441	.	G	A	2	4	6	0	1	7	0	0
12	3077223	.	T	C	2	5	7	0	2	9	0	0
12	3077257	.	C	T	4	4	8	0	0	8	0	0
12	3077261	.	C	G	4	3	7	0	0	7	0	0
12	3092612	.	C	T	6	2	8	0	0	8	0	0
12	3092630	.	T	C	6	2	8	0	0	8	0	0
12	3271383	.	A	G	0	6	6	0	1	7	0	0
12	3271553	.	G	A	5	3	8	0	0	8	0	0
12	3271646	.	T	A	6	5	11	1	0	12	0	0
12	3272402	.	A	G	9	3	12	0	1	13	0	0
12	3272421	.	A	G	6	6	12	0	0	12	0	0
12	3453378	.	C	T	1	1	2	0	0	2	0	0
12	3574348	.	G	A	7	17	24	0	0	24	0	0
12	3574398	.	C	G	2	13	15	0	0	15	0	0
12	3574581	.	A	T	2	2	4	0	0	4	0	0
12	3574604	.	C	T	1	2	3	0	0	3	0	0
12	3714650	.	T	C	5	6	11	0	0	11	0	0
12	3714731	.	T	C	4	6	10	0	0	10	0	0
12	3714934	.	T	C	5	5	10	1	1	12	0	0
12	3714977	.	T	C	4	0	4	0	14	18	0	0
12	3715039	.	T	C	9	7	16	0	2	18	0	0
12	3715201	.	T	C	5	5	10	0	0	10	0	0
12	3715261	.	A	T	6	4	10	0	0	10	0	0
12	3715292	.	T	G	9	6	15	0	0	15	0	0
12	3715327	.	C	A	8	3	11	0	0	11	0	0
12	3715329	.	C	G	8	3	11	0	0	11	0	0
12	3715365	.	T	C	6	2	8	0	0	8	0	0
12	3715544	.	T	C	11	3	14	0	1	15	0	0
12	3715730	.	T	C	3	0	3	0	3	6	0	0
12	3719297	.	T	G	2	2	4	0	0	4	0	0
12	3719312	.	T	C	4	0	4	0	4	8	0	0
12	3721941	.	A	G	1	7	8	0	0	8	0	0
12	3723786	.	C	G	6	6	12	0	0	12	0	0
12	3723963	.	G	A	0	7	7	0	6	13	0	0
12	3731590	.	G	A	0	3	3	0	3	6	0	0
12	3731602	.	C	A	5	4	9	0	0	9	0	0
12	3740724	.	T	A	9	11	20	0	0	20	0	0
12	3740735	.	A	T	8	13	21	0	1	22	0	0
12	3740784	.	C	T	12	7	19	0	1	20	0	0
12	3740803	.	G	A	13	13	26	0	0	26	0	0
12	3747652	.	G	C	0	4	4	0	0	4	0	0
12	3749505	.	C	T	0	1	1	0	1	2	0	0
12	3753166	.	C	T	0	3	3	0	7	10	0	0
12	3756229	.	G	T	8	9	17	0	0	17	0	0
12	3756237	.	C	T	7	8	15	0	1	16	0	0
12	3756303	.	C	T	0	7	7	0	9	16	0	0
12	3767321	.	G	T	10	5	15	0	0	15	0	0
12	3789463	.	T	C	2	4	6	0	0	6	0	0
12	3789482	.	T	C	6	3	9	0	1	10	0	0
12	3789772	.	T	G	6	6	12	0	1	13	0	0
12	3791925	.	C	A	1	3	4	0	0	4	0	0
12	4057769	.	G	A	1	5	6	0	0	6	0	0
12	4960726	.	A	G	0	0	0	0	2	2	0	0
12	4960974	.	A	G	3	0	3	0	4	7	0	0
12	4960977	.	A	G	5	2	7	0	0	7	0	0
12	5452451	.	G	A	3	2	5	0	0	5	0	0
12	6451010	.	C	T	3	2	5	0	1	6	0	0
12	6451030	.	A	T	3	2	5	0	0	5	0	0
12	6451118	.	A	C	2	4	6	0	0	6	0	0
12	6451522	.	T	C	3	1	4	0	0	4	0	0
12	6451528	.	C	T	3	1	4	0	0	4	0	0
12	6465792	.	C	A	0	1	1	0	1	2	0	0
12	6465982	.	C	T	0	2	2	0	0	2	0	0
12	6543123	.	T	C	2	5	7	0	0	7	0	0
12	6543350	.	G	A	1	2	3	0	0	3	0	0
12	6543458	.	C	G	4	4	8	0	0	8	0	0
12	6547214	.	A	G	3	2	5	0	0	5	0	0
12	6587222	.	T	C	3	0	3	0	2	5	0	0
12	6711152	.	T	C	1	0	1	0	0	1	0	0
12	6756394	.	G	C	2	2	4	0	0	4	0	0
12	7193865	.	C	T	4	3	7	0	0	7	0	0
12	7193874	.	A	G	5	3	8	0	0	8	0	0
12	7194410	.	A	G	9	12	21	0	0	21	0	0
12	7194505	.	T	C	11	6	17	0	2	19	0	0
12	7194522	.	T	C	9	8	17	0	0	17	0	0
12	7194587	.	G	A	3	3	6	0	0	6	0	0
12	7194677	.	G	C	4	4	8	0	0	8	0	0
12	7194843	.	C	A	2	5	7	0	0	7	0	0
12	7195081	.	G	T	9	9	18	0	0	18	0	0
12	7195139	.	A	T	6	9	15	0	4	19	0	0
12	7195365	.	T	C	15	6	21	0	0	21	0	0
12	7195454	.	T	A	13	10	23	0	1	24	0	0
12	7195524	.	G	T	8	6	14	0	1	15	0	0
12	7195588	.	G	A	8	6	14	1	1	16	0	0
12	7195600	.	T	C	6	9	15	0	1	16	0	0
12	7195676	.	C	T	1	8	9	0	5	14	0	0
12	7195816	.	C	A	1	6	7	0	0	7	0	0
12	7196059	.	G	A	12	4	16	0	0	16	0	0
12	7196114	.	G	A	9	6	15	0	0	15	0	0
12	7196125	.	A	G	5	8	13	0	1	14	0	0
12	7196175	.	G	A	6	5	11	0	0	11	0	0
12	7196201	.	G	A	4	3	7	0	1	8	0	0
12	7196249	.	G	T	4	5	9	0	0	9	0	0
12	7196607	.	C	T	4	3	7	0	0	7	0	0
12	7197768	.	G	A	1	2	3	0	0	3	0	0
12	7198135	.	T	A	1	4	5	0	0	5	0	0
12	7198142	.	T	C	4	0	4	0	1	5	0	0
12	7198215	.	C	A	2	2	4	0	1	5	0	0
12	7198255	.	T	A	2	3	5	0	0	5	0	0
12	7198295	.	G	T	9	3	12	0	0	12	0	0
12	7198317	.	T	A	7	2	9	0	0	9	0	0
12	7198335	.	C	T	0	3	3	0	7	10	0	0
12	7198409	.	G	A	2	3	5	0	0	5	0	0
12	7198625	.	C	A	2	4	6	0	0	6	0	0
12	7198882	.	G	A	1	3	4	0	0	4	0	0
12	7234692	.	G	A	6	5	11	0	2	13	0	0
12	7235030	.	G	A	6	7	13	0	1	14	0	0
12	7263657	.	G	T	0	2	2	0	5	7	0	0
12	7263665	.	G	T	0	3	3	0	4	7	0	0
12	7269679	.	A	C	5	0	5	0	5	10	0	0
12	7280160	.	G	T	0	2	2	0	0	2	0	0
12	7454704	.	C	T	4	5	9	0	0	9	0	0
12	7491711	.	G	A	2	2	4	0	0	4	0	0
12	7491712	.	A	G	2	2	4	0	0	4	0	0
12	7512347	.	T	C	5	7	12	0	0	12	0	0
12	7512469	.	C	T	5	6	11	0	0	11	0	0
12	7512641	.	T	A	7	12	19	0	0	19	0	0
12	7512675	.	G	A	6	8	14	0	0	14	0	0
12	7512682	.	A	G	3	6	9	0	3	12	0	0
12	7512921	.	A	G	10	10	20	0	1	21	0	0
12	7512965	.	C	A	6	10	16	0	0	16	0	0
12	7513106	.	C	A	7	8	15	0	0	15	0	0
12	7513446	.	T	A	9	5	14	0	0	14	0	0
12	7513480	.	C	T	9	5	14	0	0	14	0	0
12	7513555	.	G	A	13	4	17	0	1	18	0	0
12	7513613	.	G	A	1	10	11	0	7	18	0	0
12	7589579	.	G	A	7	2	9	0	0	9	0	0
12	7589581	.	T	G	7	2	9	0	0	9	0	0
12	7589795	.	A	G	7	4	11	0	0	11	0	0
12	7589917	.	C	G	3	2	5	0	0	5	0	0
12	7589995	.	C	A	2	3	5	0	2	7	0	0
12	7595179	.	C	T	5	11	16	0	1	17	0	0
12	7595204	.	G	A	5	11	16	0	1	17	0	0
12	7595726	.	C	A	5	5	10	0	0	10	0	0
12	7610033	.	A	G	3	4	7	0	0	7	0	0
12	7610236	.	A	T	8	2	10	0	0	10	0	0
12	7610478	.	T	A	5	6	11	0	0	11	0	0
12	7610532	.	T	G	6	3	9	0	0	9	0	0
12	7610663	.	T	C	6	1	7	0	4	11	0	0
12	7610740	.	T	C	7	11	18	0	1	19	0	0
12	7610904	.	A	G	6	2	8	0	0	8	0	0
12	7610969	.	T	C	3	6	9	0	0	9	0	0
12	7611081	.	G	C	1	0	1	0	2	3	0	0
12	7611286	.	T	C	1	3	4	0	0	4	0	0
12	7611318	.	T	C	2	0	2	0	2	4	0	0
12	7611595	.	A	G	9	6	15	0	0	15	0	0
12	7611625	.	G	T	8	3	11	0	1	12	0	0
12	7612106	.	T	C	1	5	6	0	0	6	0	0
12	7612117	.	G	A	3	4	7	0	0	7	0	0
12	7612406	.	T	A	4	4	8	0	0	8	0	0
12	7612441	.	T	C	3	1	4	0	2	6	0	0
12	7612815	.	G	A	2	2	4	0	0	4	0	0
12	7612852	.	G	T	4	4	8	0	0	8	0	0
12	7620242	.	G	T	5	4	9	0	0	9	0	0
12	7628945	.	A	C	2	0	2	0	0	2	0	0
12	7629226	.	T	C	2	0	2	0	0	2	0	0
12	7633156	.	A	G	2	2	4	0	0	4	0	0
12	7710552	.	C	T	0	1	1	0	0	1	0	0
12	7757781	.	A	G	9	6	15	0	0	15	0	0
12	7792956	.	A	G	0	1	1	0	0	1	0	0
12	7801357	.	T	A	1	2	3	0	0	3	0	0
12	8004039	.	T	C	1	2	3	0	0	3	0	0
12	8019172	.	T	C	1	4	5	0	0	5	0	0
12	8019307	.	T	C	2	2	4	0	0	4	0	0
12	8019361	.	T	C	1	2	3	0	0	3	0	0
12	8019406	.	T	C	2	3	5	0	0	5	0	0
12	8227145	.	G	C	6	3	9	0	0	10	1	0
12	8307569	.	G	A	0	0	0	0	1	1	0	0
12	8307734	.	A	C	4	1	5	0	0	5	0	0
12	8656201	.	C	T	0	1	1	0	0	1	0	0
12	8822836	.	C	T	3	3	6	0	0	6	0	0
12	8822961	.	T	C	1	5	6	0	0	6	0	0
12	8863228	.	G	A	0	1	1	0	1	2	0	0
12	8863240	.	A	T	1	1	2	0	0	2	0	0
12	8866077	.	A	G	3	2	5	0	0	5	0	0
12	8877343	.	A	C	3	2	5	0	0	5	0	0
12	8877412	.	T	C	3	2	5	0	1	6	0	0
12	8881469	.	G	A	3	6	9	0	0	9	0	0
12	8881575	.	C	T	5	3	8	0	1	9	0	0
12	8882062	.	G	T	5	5	10	0	0	10	0	0
12	8956420	.	C	T	2	2	4	0	0	4	0	0
12	8968456	.	T	A	6	11	17	0	1	18	0	0
12	8968487	.	T	A	10	5	15	0	0	15	0	0
12	8968512	.	T	G	6	9	15	0	0	15	0	0
12	8968721	.	A	G	8	14	22	0	1	23	0	0
12	8968979	.	C	A	4	6	10	0	1	11	0	0
12	8969084	.	T	C	10	13	23	0	3	26	0	0
12	8969102	.	C	T	0	15	15	0	16	31	0	0
12	8969155	.	C	G	12	10	22	0	0	22	0	0
12	8969426	.	T	C	3	7	10	2	1	13	0	0
12	8969485	.	T	C	8	13	21	0	0	21	0	0
12	8969499	.	G	A	10	13	23	0	1	24	0	0
12	8987502	.	T	C	1	0	1	0	0	1	0	0
12	8997654	.	A	G	1	1	2	0	0	2	0	0
12	9010979	.	G	A	8	0	8	0	0	8	0	0
12	9010988	.	C	T	1	0	1	0	10	11	0	0
12	9039610	.	G	A	3	5	8	0	0	8	0	0
12	9049343	.	C	T	9	8	17	0	0	17	0	0
12	9084590	.	T	C	8	8	16	0	2	18	0	0
12	9102500	.	T	A	1	1	2	0	0	2	0	0
12	9184305	.	T	C	4	2	6	0	0	6	0	0
12	9187209	.	A	G	5	2	7	0	0	7	0	0
12	9188422	.	T	C	3	7	10	0	0	10	0	0
12	9188488	.	A	G	7	4	11	0	0	11	0	0
12	9200402	.	C	T	2	0	2	0	0	2	0	0
12	9206038	.	T	C	4	3	7	0	1	8	0	0
12	9206044	.	C	T	3	4	7	0	1	8	0	0
12	9206120	.	A	T	0	1	1	0	0	1	0	0
12	9208468	.	T	G	3	0	3	0	3	6	0	0
12	9210441	.	G	A	2	1	3	0	0	3	0	0
12	9210489	.	T	C	6	7	13	0	0	13	0	0
12	9210504	.	A	G	6	7	13	0	0	13	0	0
12	9210528	.	C	T	3	5	8	0	0	8	0	0
12	9217989	.	A	G	2	1	3	0	0	3	0	0
12	9218054	.	T	C	12	9	21	0	0	21	0	0
12	9218095	.	A	T	6	3	9	0	1	10	0	0
12	9218098	.	T	C	6	4	10	0	0	10	0	0
12	9218142	.	A	G	6	2	8	0	0	8	0	0
12	9218176	.	T	C	5	3	8	0	0	8	0	0
12	9218183	.	G	A	4	3	7	0	1	8	0	0
12	9452838	.	T	C	2	0	2	0	3	5	0	0
12	9452880	.	G	C	1	0	1	0	0	1	0	0
12	9463660	.	G	A	4	5	9	0	1	10	0	0
12	9463678	.	T	C	4	5	9	0	1	10	0	0
12	9463879	.	G	A	0	1	1	0	0	1	0	0
12	9463885	.	G	A	0	1	1	0	0	1	0	0
12	9468373	.	C	T	0	3	3	0	2	5	0	0
12	9468440	.	G	A	6	4	10	0	1	11	0	0
12	9617651	.	G	A	1	1	2	0	0	2	0	0
12	9623751	.	T	C	0	3	3	0	0	3	0	0
12	9626057	.	A	C	1	4	5	0	0	5	0	0
12	9630730	.	G	A	3	0	3	0	0	3	0	0
12	9630745	.	G	A	0	1	1	0	0	1	0	0
12	9633827	.	G	A	8	8	16	0	0	16	0	0
12	9636544	.	C	T	0	2	2	0	6	8	0	0
12	9636616	.	A	G	9	7	16	0	2	18	0	0
12	9640309	.	C	T	1	2	3	0	0	3	0	0
12	9642605	.	C	T	0	1	1	0	0	1	0	0
12	9654373	.	A	G	1	2	3	0	0	3	0	0
12	9658137	.	A	G	1	4	5	0	0	5	0	0
12	9658168	.	C	T	3	4	7	0	1	8	0	0
12	9660129	.	G	A	3	2	5	0	0	5	0	0
12	9660365	.	A	G	1	3	4	0	0	4	0	0
12	9660389	.	A	G	1	4	5	0	0	5	0	0
12	9663488	.	C	T	1	2	3	0	0	3	0	0
12	9671936	.	C	T	0	1	1	0	0	1	0	0
12	9671939	.	T	C	0	1	1	0	0	1	0	0
12	9674357	.	T	C	1	2	3	0	0	3	0	0
12	9703260	.	C	T	7	6	13	0	0	13	0	0
12	9703831	.	C	T	11	5	16	0	1	17	0	0
12	9703843	.	A	G	6	10	16	0	0	16	0	0
12	9704233	.	T	C	5	4	9	0	0	9	0	0
12	9704254	.	G	T	6	7	13	0	1	14	0	0
12	9704431	.	C	T	6	12	18	0	1	19	0	0
12	9704443	.	G	T	0	11	11	0	7	18	0	0
12	9744544	.	C	T	6	6	12	0	0	12	0	0
12	9749830	.	A	G	3	11	14	0	0	14	0	0
12	9755833	.	C	T	12	20	32	0	1	33	0	0
12	9755869	.	A	G	4	14	18	0	1	19	0	0
12	9761792	.	C	T	9	7	16	0	0	16	0	0
12	9769880	.	A	T	1	5	6	0	0	6	0	0
12	9773157	.	G	A	3	5	8	0	0	8	0	0
12	9773281	.	C	T	6	4	10	0	0	10	0	0
12	9773308	.	G	A	5	5	10	0	0	10	0	0
12	9773465	.	G	A	0	12	12	0	7	19	0	0
12	9782230	.	C	T	4	4	8	0	0	8	0	0
12	9782404	.	G	A	7	2	9	0	0	9	0	0
12	9782428	.	T	C	9	3	12	0	0	12	0	0
12	9782635	.	A	G	4	4	8	0	0	8	0	0
12	9782743	.	C	T	0	3	3	0	1	4	0	0
12	9783145	.	G	A	2	3	5	0	0	5	0	0
12	9783596	.	G	A	6	3	9	0	0	9	0	0
12	9817737	.	A	T	10	12	22	0	0	22	0	0
12	9817771	.	C	T	4	9	13	0	0	13	0	0
12	9817883	.	T	A	8	19	27	0	1	29	1	0
12	9824735	.	C	T	15	12	27	0	0	27	0	0
12	9824762	.	C	A	15	13	28	0	0	28	0	0
12	9824807	.	C	A	3	1	4	0	0	4	0	0
12	9829697	.	C	T	1	1	2	0	0	2	0	0
12	9830983	.	G	A	4	6	10	0	0	10	0	0
12	9830986	.	G	A	7	4	11	0	0	11	0	0
12	9883526	.	G	A	16	40	56	0	3	59	0	0
12	9883849	.	C	T	33	36	69	0	0	69	0	0
12	9883944	.	C	T	37	28	65	0	6	71	0	0
12	9955481	.	T	G	2	2	4	0	0	4	0	0
12	9981077	.	G	A	1	2	3	0	0	3	0	0
12	10117236	.	G	A	1	3	4	0	0	4	0	0
12	10117329	.	C	T	1	0	1	0	0	1	0	0
12	10124691	.	G	T	1	3	4	0	1	5	0	0
12	10124815	.	T	G	9	7	16	0	1	17	0	0
12	10124819	.	C	T	7	7	14	0	1	15	0	0
12	10124976	.	C	T	8	4	12	0	1	13	0	0
12	10125030	.	G	T	0	4	4	0	6	10	0	0
12	10125031	.	C	A	6	3	9	0	1	10	0	0
12	10125479	.	T	A	6	10	16	0	0	16	0	0
12	10160428	.	C	T	0	2	2	0	0	2	0	0
12	10167070	.	A	G	1	1	2	0	0	2	0	0
12	10169521	.	T	C	8	9	17	0	3	20	0	0
12	10169614	.	G	A	14	13	27	0	0	27	0	0
12	10169884	.	G	T	20	16	36	0	0	36	0	0
12	10175161	.	C	T	2	4	6	0	0	6	0	0
12	10199695	.	A	G	16	12	28	0	0	28	0	0
12	10199760	.	A	T	17	16	33	0	0	33	0	0
12	10199869	.	C	T	3	13	16	0	9	25	0	0
12	10200028	.	A	G	16	19	35	0	2	37	0	0
12	10209431	.	A	G	6	11	17	0	1	18	0	0
12	10209452	.	T	A	6	3	9	0	0	9	0	0
12	10217660	.	C	T	12	7	19	0	2	21	0	0
12	10217708	.	C	T	3	4	7	0	0	7	0	0
12	10220000	.	G	T	1	1	2	0	1	3	0	0
12	10243911	.	C	T	3	0	3	0	0	3	0	0
12	10243926	.	C	T	3	1	4	0	0	4	0	0
12	10243971	.	A	C	1	2	3	0	0	3	0	0
12	10304660	.	T	A	4	6	10	0	2	12	0	0
12	10304706	.	G	A	0	1	1	0	0	1	0	0
12	10313241	.	G	A	2	1	3	0	0	3	0	0
12	10342458	.	T	C	1	0	1	0	2	3	0	0
12	10344618	.	G	A	1	0	1	0	0	1	0	0
12	10347333	.	T	C	1	2	3	0	1	4	0	0
12	10354776	.	A	G	0	1	1	0	0	1	0	0
12	10360923	.	G	A	1	0	1	0	0	1	0	0
12	10368015	.	T	C	1	0	1	0	2	3	0	0
12	10368969	.	T	C	2	1	3	0	1	4	0	0
12	10368978	.	A	G	3	2	5	0	0	5	0	0
12	10369038	.	G	T	3	2	5	0	0	5	0	0
12	10369153	.	T	G	3	4	7	0	0	7	0	0
12	10369300	.	A	G	5	2	7	0	0	7	0	0
12	10369362	.	T	C	2	4	6	0	0	6	0	0
12	10369459	.	T	G	1	2	3	0	0	3	0	0
12	10369466	.	C	T	0	2	2	0	1	3	0	0
12	10369758	.	A	G	3	2	5	0	0	5	0	0
12	10369780	.	A	G	3	4	7	0	0	7	0	0
12	10370034	.	T	A	3	2	5	0	0	5	0	0
12	10370148	.	T	G	1	2	3	0	0	3	0	0
12	10370989	.	G	T	1	2	3	0	0	3	0	0
12	10374824	.	G	T	1	2	3	0	0	3	0	0
12	10382220	.	C	T	4	2	6	0	1	7	0	0
12	10382588	.	C	T	2	4	6	0	0	6	0	0
12	10384982	.	G	A	4	8	12	0	1	13	0	0
12	10387071	.	A	G	8	8	16	0	0	16	0	0
12	10391883	.	C	T	2	1	3	0	0	3	0	0
12	10398820	.	A	G	0	2	2	0	0	2	0	0
12	10399471	.	G	A	3	0	3	0	0	3	0	0
12	10399766	.	T	C	5	3	8	0	0	8	0	0
12	10412825	.	A	C	2	3	5	0	0	5	0	0
12	10421810	.	C	T	3	3	6	0	0	6	0	0
12	10424741	.	C	G	2	14	16	0	10	26	0	0
12	10425346	.	T	C	13	4	17	0	0	17	0	0
12	10425465	.	C	T	1	1	2	0	0	2	0	0
12	10425586	.	G	T	2	2	4	0	0	4	0	0
12	10425630	.	A	T	2	2	4	0	0	4	0	0
12	10429054	.	G	A	9	8	17	0	0	17	0	0
12	10429105	.	C	A	1	3	4	0	0	4	0	0
12	10430611	.	G	A	3	1	4	0	0	4	0	0
12	10439619	.	C	A	1	5	6	0	0	6	0	0
12	10439641	.	T	G	0	4	4	0	2	6	0	0
12	10439662	.	G	A	1	6	7	0	0	7	0	0
12	10439686	.	T	C	3	0	3	0	0	3	0	0
12	10443916	.	G	T	7	10	17	0	1	18	0	0
12	10443923	.	T	C	6	7	13	0	3	16	0	0
12	10444321	.	A	T	7	9	16	0	1	17	0	0
12	10465000	.	A	C	10	11	21	0	0	21	0	0
12	10465182	.	A	C	3	6	9	0	0	9	0	0
12	10471105	.	A	G	5	4	9	0	0	9	0	0
12	10471120	.	T	C	5	0	5	0	7	12	0	0
12	10471159	.	G	A	2	3	5	0	0	5	0	0
12	10471174	.	A	C	2	0	2	0	1	3	0	0
12	10475310	.	G	A	1	0	1	0	0	1	0	0
12	10478804	.	C	A	0	5	5	0	3	8	0	0
12	10478857	.	T	C	3	3	6	0	0	6	0	0
12	10482230	.	C	A	2	3	5	0	0	5	0	0
12	10482792	.	T	G	4	0	4	0	0	4	0	0
12	10492349	.	C	T	1	0	1	0	0	1	0	0
12	10492438	.	C	T	0	2	2	0	1	3	0	0
12	10493597	.	G	A	1	2	3	0	0	3	0	0
12	10495448	.	T	A	1	1	2	0	0	2	0	0
12	10495468	.	A	T	2	1	3	0	0	3	0	0
12	10495485	.	G	T	2	4	6	0	0	6	0	0
12	10495534	.	G	A	0	4	4	0	0	4	0	0
12	10503774	.	A	T	3	3	6	0	0	6	0	0
12	10505938	.	G	C	1	0	1	0	4	5	0	0
12	10646482	.	A	T	1	1	2	0	0	2	0	0
12	10651761	.	A	G	5	5	10	0	0	10	0	0
12	10668545	.	G	C	2	3	5	0	0	5	0	0
12	10671850	.	A	G	1	1	2	0	0	2	0	0
12	10671963	.	G	C	4	2	6	0	0	6	0	0
12	10679120	.	A	T	2	1	3	0	0	3	0	0
12	10679153	.	G	A	1	4	5	0	0	5	0	0
12	10679279	.	T	G	2	3	5	0	0	5	0	0
12	10679289	.	G	A	2	2	4	0	0	4	0	0
12	10682392	.	A	G	1	1	2	0	0	2	0	0
12	10688640	.	C	T	6	7	13	0	0	13	0	0
12	10688704	.	G	A	6	6	12	0	3	15	0	0
12	10688890	.	G	A	1	1	2	0	0	2	0	0
12	10705765	.	T	A	5	4	9	0	1	10	0	0
12	10705775	.	C	G	6	5	11	0	1	12	0	0
12	10729218	.	G	A	1	0	1	0	0	1	0	0
12	10733035	.	G	A	0	2	2	0	0	2	0	0
12	10733464	.	C	T	2	1	3	0	0	3	0	0
12	10733494	.	C	A	3	1	4	0	0	4	0	0
12	11389229	.	T	C	8	5	13	0	0	13	0	0
12	11389685	.	T	A	2	3	5	0	0	5	0	0
12	11390306	.	T	C	6	2	8	0	0	8	0	0
12	11390365	.	T	C	3	6	9	0	1	10	0	0
12	11762849	.	A	T	8	9	17	0	0	17	0	0
12	13189135	.	T	C	4	6	10	0	0	10	0	0
12	13189136	.	T	C	5	0	5	0	5	10	0	0
12	13474461	.	A	G	8	4	12	0	0	12	0	0
12	13811642	.	G	A	11	4	15	0	4	19	0	0
12	18529360	.	A	T	2	2	4	0	0	4	0	0
12	18895837	.	T	C	2	4	6	0	0	6	0	0
12	18913584	.	A	G	10	4	14	0	0	14	0	0
12	18913602	.	A	G	10	5	15	0	0	15	0	0
12	19062233	.	A	G	12	4	16	0	1	17	0	0
12	19064796	.	A	T	6	5	11	0	2	13	0	0
12	19144930	.	G	A	2	2	4	0	0	4	0	0
12	19318412	.	G	T	3	3	6	0	0	6	0	0
12	19430154	.	A	G	5	3	8	0	1	9	0	0
12	22450848	.	T	C	5	2	7	0	0	7	0	0
12	22450863	.	T	C	4	3	7	0	0	7	0	0
12	22529456	.	T	G	16	18	34	0	2	36	0	0
12	22529457	.	A	C	16	20	36	0	0	36	0	0
12	22529952	.	T	C	5	5	10	0	1	11	0	0
12	22531505	.	A	T	8	10	18	0	1	19	0	0
12	22532595	.	G	A	16	16	32	0	1	33	0	0
12	22533054	.	G	A	18	15	33	0	0	33	0	0
12	22533806	.	C	T	0	15	15	0	16	31	0	0
12	22533884	.	A	T	12	19	31	0	0	31	0	0
12	22533908	.	G	A	9	18	27	0	1	28	0	0
12	22534383	.	A	G	10	12	22	0	1	23	0	0
12	22534794	.	C	T	15	13	28	0	0	28	0	0
12	22535121	.	C	G	12	12	24	0	0	24	0	0
12	22535186	.	C	T	11	10	21	0	2	23	0	0
12	22535197	.	A	G	13	11	24	0	1	25	0	0
12	22535498	.	T	C	9	5	14	0	2	16	0	0
12	22535546	.	A	T	13	11	24	0	1	26	1	0
12	22535567	.	T	C	13	9	22	0	2	24	0	0
12	22535631	.	T	G	7	9	16	0	0	16	0	0
12	22535640	.	G	A	7	8	15	0	0	15	0	0
12	22536188	.	C	T	0	6	6	0	12	18	0	0
12	22536609	.	T	G	14	19	33	0	3	36	0	0
12	22536621	.	G	C	14	18	32	0	0	32	0	0
12	22537485	.	G	A	3	6	9	0	0	9	0	0
12	22560249	.	A	G	2	5	7	0	0	7	0	0
12	22562554	.	C	T	1	2	3	0	1	4	0	0
12	22562581	.	T	C	1	3	4	0	0	4	0	0
12	22563882	.	T	C	2	6	8	0	0	8	0	0
12	22563891	.	G	T	2	6	8	0	0	8	0	0
12	22565015	.	T	C	2	5	7	0	0	7	0	0
12	22565764	.	A	G	3	3	6	0	0	6	0	0
12	22568263	.	T	C	8	3	11	0	1	12	0	0
12	22569785	.	C	T	5	5	10	0	0	10	0	0
12	22570379	.	A	T	20	13	33	0	4	37	0	0
12	22570499	.	T	C	16	13	29	0	2	31	0	0
12	22570814	.	T	C	19	11	30	0	3	33	0	0
12	22571592	.	A	T	4	7	11	0	2	13	0	0
12	22571628	.	G	A	7	6	13	0	0	13	0	0
12	22572199	.	C	G	12	13	25	0	2	27	0	0
12	22572287	.	A	C	9	12	21	0	0	21	0	0
12	22572528	.	T	G	6	14	20	0	0	20	0	0
12	22572738	.	C	T	8	16	24	0	0	24	0	0
12	22572814	.	A	G	12	0	12	0	10	23	1	0
12	22573080	.	T	A	13	12	25	0	2	28	1	0
12	22573239	.	A	C	2	2	4	0	0	4	0	0
12	22628731	.	G	T	0	2	2	0	2	4	0	0
12	22628811	.	A	C	4	2	6	0	0	6	0	0
12	22628983	.	G	A	2	1	3	0	0	3	0	0
12	22640923	.	T	C	1	3	4	0	0	4	0	0
12	22643556	.	C	G	1	1	2	0	0	2	0	0
12	22644202	.	T	G	4	2	6	0	0	6	0	0
12	22644209	.	T	C	4	5	9	0	0	9	0	0
12	22644281	.	T	C	7	7	14	0	0	14	0	0
12	22644505	.	C	A	2	3	5	0	0	5	0	0
12	22644506	.	A	G	2	3	5	0	0	5	0	0
12	22644576	.	A	G	2	0	2	0	11	13	0	0
12	22644634	.	T	C	5	8	13	0	0	13	0	0
12	22644687	.	T	G	6	9	15	0	0	15	0	0
12	22644800	.	G	A	8	4	12	0	1	13	0	0
12	22644852	.	C	T	6	5	11	0	0	11	0	0
12	22645599	.	T	C	1	2	3	0	0	3	0	0
12	22645650	.	C	T	1	3	4	0	0	4	0	0
12	22645670	.	A	G	3	2	5	0	0	5	0	0
12	22648370	.	T	C	1	0	1	0	2	3	0	0
12	22648402	.	T	C	2	4	6	0	0	6	0	0
12	22648423	.	A	T	1	4	5	0	0	5	0	0
12	22652631	.	C	T	0	2	2	0	0	2	0	0
12	22670131	.	A	G	0	2	2	0	0	2	0	0
12	22670137	.	T	G	0	2	2	0	0	2	0	0
12	22680247	.	T	C	6	5	11	0	0	11	0	0
12	22680255	.	T	C	7	4	11	0	0	11	0	0
12	22680285	.	C	G	4	1	5	0	0	6	1	0
12	22774261	.	C	T	0	2	2	0	0	2	0	0
12	22774439	.	A	G	1	3	4	0	0	4	0	0
12	22780905	.	G	A	3	0	3	0	0	3	0	0
12	22814990	.	T	C	13	9	22	0	0	22	0	0
12	22814994	.	A	G	10	12	22	0	2	24	0	0
12	22815097	.	T	C	9	5	14	0	1	15	0	0
12	22815203	.	G	A	9	7	16	0	1	17	0	0
12	22815647	.	G	A	5	4	9	0	0	9	0	0
12	22815724	.	G	T	3	7	10	0	1	11	0	0
12	22815767	.	A	T	3	6	9	0	0	10	1	0
12	22905538	.	A	G	0	3	3	0	0	3	0	0
12	22915831	.	A	G	1	0	1	0	2	3	0	0
12	22915857	.	A	T	1	2	3	0	0	3	0	0
12	22916189	.	A	T	1	3	4	0	0	4	0	0
12	22927981	.	T	C	7	10	17	0	0	17	0	0
12	22932087	.	C	T	7	16	23	0	0	23	0	0
12	22932090	.	G	C	5	16	21	0	2	23	0	0
12	22932148	.	G	A	5	9	14	0	0	14	0	0
12	22932160	.	A	C	8	5	13	0	0	13	0	0
12	22932737	.	A	G	12	0	12	0	7	19	0	0
12	22932852	.	G	T	0	8	8	0	16	24	0	0
12	22932875	.	G	T	15	10	25	0	0	25	0	0
12	22962175	.	G	A	2	4	6	0	0	6	0	0
12	22962211	.	A	T	3	5	8	0	0	8	0	0
12	22962555	.	C	A	3	3	6	0	0	6	0	0
12	22962764	.	T	C	11	2	13	0	0	13	0	0
12	22962781	.	G	A	10	3	13	0	1	14	0	0
12	22963104	.	A	C	1	3	4	0	0	4	0	0
12	22963197	.	G	A	3	3	6	0	0	6	0	0
12	22963667	.	C	G	5	3	8	0	0	8	0	0
12	23008283	.	T	G	3	0	3	0	0	3	0	0
12	23178461	.	T	A	2	2	4	0	0	4	0	0
12	23389675	.	G	A	1	5	6	0	1	7	0	0
12	23400392	.	C	T	9	21	30	0	0	30	0	0
12	23400469	.	C	T	20	6	26	0	0	26	0	0
12	23403091	.	T	C	9	8	17	0	1	18	0	0
12	23403149	.	T	C	1	2	3	0	1	4	0	0
12	23406439	.	A	G	15	17	32	0	3	35	0	0
12	23411287	.	C	T	6	7	13	0	2	15	0	0
12	23415280	.	C	T	15	12	27	0	2	29	0	0
12	23415370	.	C	T	15	13	28	0	3	31	0	0
12	23415662	.	G	A	15	13	28	0	0	28	0	0
12	23415715	.	T	C	17	10	27	0	1	28	0	0
12	23415897	.	A	T	16	1	17	1	1	20	1	0
12	23424190	.	C	T	3	5	8	0	0	8	0	0
12	23427149	.	T	C	2	4	6	0	0	6	0	0
12	23429685	.	C	T	7	7	14	0	0	14	0	0
12	23429917	.	A	G	5	0	5	0	4	9	0	0
12	23430003	.	C	A	4	4	8	0	0	8	0	0
12	23430144	.	A	G	1	0	1	0	4	5	0	0
12	23665047	.	C	G	1	0	1	0	3	4	0	0
12	23665119	.	A	G	1	0	1	0	2	3	0	0
12	23665465	.	A	G	0	0	0	0	1	1	0	0
12	23674331	.	T	A	1	2	3	0	0	3	0	0
12	23674354	.	T	C	2	4	6	0	0	6	0	0
12	23784201	.	C	G	3	3	6	0	0	6	0	0
12	23787358	.	T	G	1	3	4	0	0	4	0	0
12	23787904	.	A	T	2	4	6	0	1	7	0	0
12	23787989	.	T	A	2	9	11	0	0	11	0	0
12	23788649	.	C	A	6	2	8	0	1	9	0	0
12	23788682	.	G	A	4	3	7	0	0	7	0	0
12	23789838	.	A	C	3	4	7	0	0	7	0	0
12	23790148	.	A	T	4	4	8	0	0	8	0	0
12	23793990	.	A	T	1	4	5	0	0	5	0	0
12	23794148	.	A	T	1	3	4	0	0	4	0	0
12	23871061	.	G	A	1	2	3	0	0	3	0	0
12	23871064	.	T	A	1	2	3	0	0	3	0	0
12	23875574	.	T	A	1	2	3	0	0	3	0	0
12	23875575	.	G	T	1	2	3	0	0	3	0	0
12	23889658	.	A	G	3	3	6	0	0	6	0	0
12	23904642	.	C	T	1	1	2	0	0	2	0	0
12	23913587	.	G	A	0	2	2	0	1	3	0	0
12	23917156	.	T	G	3	0	3	0	3	6	0	0
12	23917160	.	T	G	3	3	6	0	0	6	0	0
12	23917279	.	T	C	0	2	2	0	0	2	0	0
12	23923434	.	G	A	1	1	2	0	0	2	0	0
12	23932067	.	T	G	8	12	20	0	2	22	0	0
12	24018336	.	A	G	1	1	2	0	1	3	0	0
12	24022843	.	T	C	1	2	3	0	0	3	0	0
12	24038517	.	A	G	3	2	5	0	0	5	0	0
12	24038542	.	T	C	4	4	8	0	0	8	0	0
12	24041169	.	A	G	0	0	0	0	1	1	0	0
12	24041253	.	G	T	3	5	8	0	1	9	0	0
12	24041254	.	T	A	3	6	9	0	0	9	0	0
12	24041322	.	T	A	2	3	5	0	0	5	0	0
12	24043679	.	A	G	4	0	4	0	9	13	0	0
12	24051755	.	T	A	5	2	7	0	0	7	0	0
12	24052219	.	A	C	7	2	9	0	1	10	0	0
12	24052256	.	G	C	5	3	8	0	0	8	0	0
12	24052578	.	C	T	7	6	13	0	2	15	0	0
12	24052684	.	G	A	10	4	14	0	2	16	0	0
12	24056322	.	G	A	3	3	6	0	0	6	0	0
12	24056484	.	A	T	3	2	5	0	0	5	0	0
12	24056500	.	G	T	2	2	4	0	0	4	0	0
12	24056716	.	G	T	2	3	5	0	0	5	0	0
12	24056738	.	G	A	3	3	6	0	0	6	0	0
12	24056755	.	T	A	3	2	5	0	0	5	0	0
12	24057167	.	C	G	4	5	9	0	0	9	0	0
12	24057198	.	G	T	3	5	8	0	0	8	0	0
12	24057368	.	G	A	1	3	4	0	0	4	0	0
12	24060008	.	A	G	4	5	9	0	0	9	0	0
12	24061231	.	G	C	3	2	5	0	0	5	0	0
12	24070858	.	C	T	2	1	3	0	0	3	0	0
12	24072946	.	A	G	3	3	6	0	0	6	0	0
12	24342531	.	G	A	4	6	10	0	0	10	0	0
12	24345339	.	T	C	3	3	6	0	1	7	0	0
12	24447515	.	G	A	0	6	6	0	5	11	0	0
12	24465541	.	C	T	12	19	31	0	0	31	0	0
12	24465607	.	C	T	23	14	37	0	0	37	0	0
12	24465712	.	T	C	17	11	28	0	0	28	0	0
12	24465875	.	A	C	3	1	4	0	0	4	0	0
12	24484083	.	A	C	11	9	20	0	0	20	0	0
12	24484084	.	C	T	11	9	20	0	0	20	0	0
12	24562909	.	C	T	6	3	9	0	0	9	0	0
12	24607140	.	G	A	1	30	31	0	29	60	0	0
12	24607215	.	G	A	8	10	18	0	1	19	0	0
12	24636997	.	T	G	18	18	36	0	1	37	0	0
12	24797119	.	G	A	1	5	6	0	9	15	0	0
12	24797413	.	C	T	11	5	16	0	1	17	0	0
12	24797999	.	G	C	4	6	10	0	0	10	0	0
12	24798235	.	A	G	7	5	12	0	0	12	0	0
12	24798237	.	T	G	7	5	12	0	0	12	0	0
12	24811369	.	G	A	5	6	11	0	0	11	0	0
12	24811441	.	C	A	6	3	9	0	0	9	0	0
12	24811468	.	G	A	3	3	6	0	3	9	0	0
12	24811489	.	A	G	4	6	10	0	1	11	0	0
12	24811558	.	T	C	3	0	3	0	3	6	0	0
12	24841940	.	C	A	7	4	11	0	1	12	0	0
12	24842119	.	A	G	12	11	23	0	2	25	0	0
12	24842121	.	G	A	12	12	24	0	1	25	0	0
12	24842597	.	C	T	0	2	2	0	2	4	0	0
12	24843424	.	T	C	7	0	7	0	7	14	0	0
12	24843451	.	C	T	0	1	1	0	0	1	0	0
12	24847330	.	T	G	10	4	14	0	0	14	0	0
12	24848399	.	G	A	4	5	9	0	1	10	0	0
12	24848651	.	C	T	0	4	4	0	0	4	0	0
12	24848678	.	A	G	1	8	9	0	2	11	0	0
12	24848687	.	A	G	1	8	9	0	2	11	0	0
12	24848765	.	T	C	3	2	5	0	0	5	0	0
12	24851165	.	T	C	4	9	13	0	0	13	0	0
12	24851264	.	G	A	3	6	9	0	0	9	0	0
12	24851297	.	G	A	2	3	5	0	0	5	0	0
12	24857814	.	T	C	2	3	5	0	0	5	0	0
12	24904842	.	T	C	9	6	15	0	0	15	0	0
12	24906185	.	C	A	3	2	5	0	0	5	0	0
12	24906618	.	T	C	3	4	7	0	0	7	0	0
12	24910546	.	T	A	3	5	8	0	0	8	0	0
12	24913535	.	G	C	5	3	8	0	0	8	0	0
12	24913609	.	C	A	2	5	7	0	0	7	0	0
12	24918034	.	C	T	0	1	1	0	0	1	0	0
12	24920788	.	A	G	2	2	4	0	0	4	0	0
12	24922646	.	A	T	1	1	2	0	0	2	0	0
12	24957267	.	A	G	15	17	32	0	0	32	0	0
12	24957416	.	T	C	19	15	34	0	3	37	0	0
12	24957806	.	A	G	29	42	71	0	7	78	0	0
12	25043221	.	A	G	6	3	9	0	1	10	0	0
12	25043324	.	C	T	0	3	3	0	2	5	0	0
12	25044516	.	A	G	4	10	14	0	1	15	0	0
12	25044540	.	C	T	7	8	15	0	1	16	0	0
12	25044786	.	T	G	7	13	20	0	0	20	0	0
12	25045074	.	T	C	3	5	8	0	1	9	0	0
12	25045174	.	C	T	10	9	19	0	0	19	0	0
12	25045315	.	C	T	0	2	2	0	3	5	0	0
12	25065680	.	A	G	2	2	4	0	0	4	0	0
12	25094107	.	T	G	9	12	21	0	1	22	0	0
12	25094201	.	T	C	7	7	14	0	5	19	0	0
12	25094300	.	T	C	10	7	17	0	1	18	0	0
12	25094359	.	T	C	1	9	10	0	1	11	0	0
12	25094401	.	C	T	9	4	13	0	2	15	0	0
12	25094520	.	T	C	11	4	15	0	1	16	0	0
12	25094522	.	T	C	11	4	15	0	1	16	0	0
12	25094722	.	T	A	6	2	8	0	0	8	0	0
12	25209924	.	A	C	0	2	2	0	1	3	0	0
12	25230976	.	A	G	3	2	5	0	0	5	0	0
12	25254891	.	T	C	5	3	8	0	0	8	0	0
12	25271404	.	T	G	4	2	6	0	0	6	0	0
12	25271409	.	C	A	4	2	6	0	0	6	0	0
12	25271598	.	C	T	10	4	14	0	0	14	0	0
12	25284375	.	G	A	4	9	13	0	0	13	0	0
12	25284414	.	T	C	9	16	25	0	0	25	0	0
12	25284423	.	G	A	8	15	23	0	3	26	0	0
12	25377318	.	A	C	10	0	10	0	6	16	0	0
12	25377345	.	A	T	7	3	10	0	1	11	0	0
12	25377354	.	A	C	8	4	12	0	0	12	0	0
12	25377690	.	T	A	3	2	5	0	1	6	0	0
12	25377797	.	A	T	6	6	12	0	1	13	0	0
12	25377817	.	C	G	8	4	12	0	1	13	0	0
12	25378351	.	G	A	19	13	32	0	1	33	0	0
12	25378354	.	C	T	1	9	10	0	21	31	0	0
12	25378420	.	A	G	14	16	30	0	1	31	0	0
12	25378475	.	G	A	12	11	23	0	0	23	0	0
12	25378506	.	C	A	0	8	8	0	13	21	0	0
12	25378555	.	T	C	9	4	13	0	1	14	0	0
12	25378848	.	G	T	10	8	18	0	0	18	0	0
12	25378882	.	G	T	7	9	16	0	0	16	0	0
12	25467742	.	C	T	14	9	23	0	1	24	0	0
12	25467823	.	T	C	9	12	21	0	3	24	0	0
12	25467887	.	T	C	7	9	16	0	0	16	0	0
12	25468312	.	C	T	10	16	26	0	0	26	0	0
12	25472281	.	C	T	12	13	25	0	0	25	0	0
12	25472290	.	A	G	12	0	12	0	14	26	0	0
12	25483514	.	T	C	3	4	7	0	0	7	0	0
12	25483527	.	T	C	0	2	2	0	1	3	0	0
12	25484586	.	G	A	12	17	29	0	1	30	0	0
12	25484676	.	T	G	16	13	29	0	2	31	0	0
12	25485203	.	C	T	9	11	20	0	3	23	0	0
12	25485549	.	A	T	1	2	3	0	0	3	0	0
12	25486062	.	A	G	5	2	7	0	0	7	0	0
12	25486736	.	A	T	1	2	3	0	0	3	0	0
12	25600834	.	A	G	6	7	13	0	0	13	0	0
12	25602616	.	T	A	6	8	14	0	0	14	0	0
12	25602820	.	T	A	10	7	17	0	0	17	0	0
12	25602828	.	T	A	9	9	18	0	0	18	0	0
12	25703490	.	A	G	0	0	0	0	2	2	0	0
12	25713629	.	G	C	11	11	22	0	0	22	0	0
12	25714409	.	T	C	2	4	6	0	1	7	0	0
12	25714480	.	T	G	13	11	24	0	1	25	0	0
12	25754150	.	C	T	7	11	18	0	0	18	0	0
12	25754225	.	C	T	1	1	2	0	0	2	0	0
12	25768096	.	C	T	17	12	29	0	0	29	0	0
12	25768326	.	T	A	15	24	39	0	2	41	0	0
12	25768580	.	G	A	1	16	17	0	15	32	0	0
12	25768660	.	A	T	1	4	5	0	0	5	0	0
12	25768830	.	T	C	4	9	13	0	0	13	0	0
12	25769012	.	G	A	15	15	30	0	3	33	0	0
12	25769177	.	A	T	11	12	23	0	2	25	0	0
12	25769752	.	G	A	22	16	38	0	2	41	1	0
12	25769889	.	G	A	10	5	15	0	1	16	0	0
12	25775992	.	A	T	2	0	2	0	0	2	0	0
12	25820482	.	A	C	2	2	4	0	0	4	0	0
12	25828470	.	C	T	2	2	4	0	0	4	0	0
12	25828756	.	G	A	2	1	3	0	1	4	0	0
12	25828763	.	G	A	0	2	2	0	2	4	0	0
12	25829025	.	G	A	5	3	8	0	0	8	0	0
12	25829105	.	T	C	3	3	6	0	0	6	0	0
12	25829168	.	A	G	0	2	2	0	0	2	0	0
12	25845511	.	T	C	5	7	12	0	0	12	0	0
12	25845512	.	G	A	5	7	12	0	0	12	0	0
12	25846021	.	T	C	14	14	28	0	1	29	0	0
12	25856178	.	T	A	4	1	5	0	0	5	0	0
12	25861006	.	T	C	6	1	7	0	0	7	0	0
12	25866543	.	G	A	9	16	25	0	0	25	0	0
12	25872834	.	C	A	0	1	1	0	0	1	0	0
12	25872933	.	C	T	8	4	12	0	0	12	0	0
12	25872938	.	C	A	7	4	11	0	0	11	0	0
12	25873241	.	C	T	0	6	6	0	0	6	0	0
12	25873289	.	C	T	8	9	17	0	1	18	0	0
12	25881185	.	G	C	2	19	21	0	21	42	0	0
12	25881254	.	A	C	16	14	30	0	0	30	0	0
12	25881778	.	T	C	16	18	34	0	1	35	0	0
12	25950895	.	G	C	3	0	3	0	3	6	0	0
12	25951057	.	A	G	3	4	7	0	0	7	0	0
12	25951101	.	C	T	4	3	7	0	0	7	0	0
12	25951761	.	C	T	0	6	6	0	3	9	0	0
12	25951781	.	C	A	5	3	8	0	2	10	0	0
12	25952026	.	A	G	2	3	5	0	0	5	0	0
12	25952027	.	C	G	2	3	5	0	0	5	0	0
12	25953817	.	T	C	3	3	6	0	0	6	0	0
12	26105074	.	A	G	2	2	4	0	0	4	0	0
12	26203891	.	C	T	0	5	5	0	6	11	0	0
12	26203900	.	A	T	6	6	12	0	0	12	0	0
12	26226655	.	C	G	0	5	5	0	5	10	0	0
12	26227042	.	C	T	7	5	12	0	0	12	0	0
12	26241745	.	G	A	1	3	4	0	0	4	0	0
12	26249908	.	G	A	0	1	1	0	0	1	0	0
12	26318397	.	C	T	0	4	4	0	6	10	0	0
12	26318515	.	A	G	7	7	14	0	0	14	0	0
12	26318625	.	G	A	6	7	13	0	0	13	0	0
12	26318702	.	A	G	7	7	14	0	2	16	0	0
12	26411918	.	G	A	1	4	5	0	0	5	0	0
12	26412327	.	G	T	1	2	3	0	0	3	0	0
12	26412338	.	A	T	1	3	4	0	0	4	0	0
12	26412428	.	T	C	1	1	2	0	3	5	0	0
12	26412467	.	T	G	5	3	8	0	0	8	0	0
12	26412498	.	A	G	5	4	9	0	0	9	0	0
12	26412511	.	G	C	4	5	9	0	0	9	0	0
12	26412689	.	C	A	0	4	4	0	2	6	0	0
12	26412694	.	T	C	2	4	6	0	0	6	0	0
12	26476093	.	C	G	10	9	19	0	1	20	0	0
12	26476319	.	A	G	1	2	3	0	0	3	0	0
12	26476424	.	A	G	5	5	10	0	0	10	0	0
12	26486421	.	C	G	10	17	27	0	0	27	0	0
12	26486446	.	A	C	9	25	34	0	2	36	0	0
12	26486580	.	T	C	20	14	34	0	0	34	0	0
12	26486753	.	T	C	8	5	13	0	1	14	0	0
12	26486934	.	T	A	18	8	26	0	2	28	0	0
12	26487002	.	A	T	7	12	19	0	0	19	0	0
12	26487044	.	G	A	6	9	15	0	1	16	0	0
12	26487292	.	T	G	3	9	12	0	1	13	0	0
12	26489766	.	A	T	6	6	12	0	0	12	0	0
12	26493734	.	T	C	1	4	5	0	0	5	0	0
12	26493755	.	G	A	0	5	5	0	2	7	0	0
12	26493806	.	C	T	2	6	8	0	1	9	0	0
12	26493836	.	G	A	0	4	4	0	6	10	0	0
12	26493870	.	G	T	5	2	7	0	1	8	0	0
12	26513094	.	C	T	1	2	3	0	0	3	0	0
12	26524969	.	A	C	2	4	6	0	1	7	0	0
12	26545006	.	G	C	1	4	5	0	0	5	0	0
12	26546851	.	G	T	1	3	4	0	0	4	0	0
12	26546855	.	C	T	1	3	4	0	0	4	0	0
12	26547261	.	A	C	2	0	2	0	2	4	0	0
12	26547276	.	A	C	4	2	6	0	0	6	0	0
12	26547397	.	C	T	7	11	18	0	0	18	0	0
12	26586957	.	C	T	1	2	3	0	0	3	0	0
12	26594165	.	C	T	0	5	5	0	6	11	0	0
12	26594216	.	G	A	7	5	12	0	2	14	0	0
12	26597512	.	C	T	0	2	2	0	1	3	0	0
12	26608882	.	C	T	1	3	4	0	6	10	0	0
12	26611673	.	A	T	5	3	8	0	0	8	0	0
12	26612038	.	A	G	3	5	8	0	0	8	0	0
12	26612188	.	T	C	4	1	5	0	7	12	0	0
12	26612225	.	C	G	3	5	8	0	0	9	1	0
12	26612390	.	G	C	1	0	1	0	0	1	0	0
12	26617621	.	C	A	2	4	6	0	0	6	0	0
12	26617882	.	G	A	2	0	2	0	0	2	0	0
12	26620426	.	A	G	2	0	2	0	0	2	0	0
12	26620612	.	T	G	3	4	7	0	0	7	0	0
12	26638166	.	G	A	4	7	11	0	0	11	0	0
12	26638274	.	G	A	4	4	8	0	1	9	0	0
12	26638640	.	C	T	2	8	10	0	0	10	0	0
12	26693547	.	G	A	6	3	9	0	1	10	0	0
12	26704300	.	C	T	0	1	1	0	0	1	0	0
12	26708821	.	G	A	0	4	4	0	5	9	0	0
12	26724327	.	C	A	11	5	16	0	0	16	0	0
12	26724762	.	A	G	15	0	15	0	6	21	0	0
12	26724975	.	A	G	14	0	14	0	6	20	0	0
12	26724984	.	A	T	14	5	19	0	1	20	0	0
12	26725079	.	C	A	11	4	15	0	0	15	0	0
12	26725402	.	A	G	14	9	23	0	0	23	0	0
12	26750431	.	G	A	4	4	8	0	0	8	0	0
12	26750619	.	A	G	15	18	33	0	1	34	0	0
12	26750924	.	A	C	5	4	9	0	0	9	0	0
12	26751414	.	G	A	16	7	23	0	1	24	0	0
12	26751489	.	A	G	18	8	26	0	1	27	0	0
12	26752391	.	T	C	14	1	15	0	6	21	0	0
12	26752400	.	C	T	15	7	22	0	0	22	0	0
12	26752528	.	C	T	6	9	15	0	0	15	0	0
12	26752730	.	C	T	0	9	9	0	11	20	0	0
12	26752778	.	G	C	12	6	18	0	1	19	0	0
12	26752871	.	G	A	4	6	10	0	0	10	0	0
12	26752946	.	G	A	1	6	7	0	0	7	0	0
12	26758251	.	A	G	8	10	18	0	2	20	0	0
12	26758521	.	A	G	7	9	16	0	0	16	0	0
12	26758710	.	A	C	3	4	7	0	0	7	0	0
12	26758722	.	T	C	3	4	7	0	0	7	0	0
12	26758793	.	G	T	3	5	8	0	0	8	0	0
12	26761017	.	G	A	5	3	8	0	0	8	0	0
12	26764315	.	C	T	0	2	2	0	2	4	0	0
12	26764416	.	C	T	0	1	1	0	1	2	0	0
12	26774720	.	A	G	1	2	3	0	0	3	0	0
12	26961184	.	C	T	1	4	5	0	0	5	0	0
12	27023301	.	C	T	7	5	12	0	0	12	0	0
12	27023677	.	C	T	4	8	12	0	0	12	0	0
12	27025481	.	C	T	3	6	9	0	0	9	0	0
12	27026528	.	A	C	2	7	9	0	0	9	0	0
12	27029347	.	T	C	5	1	6	0	10	16	0	0
12	27029648	.	C	T	10	14	24	0	0	24	0	0
12	27030917	.	T	C	6	1	7	0	3	10	0	0
12	27036471	.	A	G	0	2	2	0	1	3	0	0
12	27036570	.	A	C	3	3	6	0	0	6	0	0
12	27037804	.	C	T	8	3	11	0	2	13	0	0
12	27037813	.	C	T	8	3	11	0	0	11	0	0
12	27050766	.	A	G	0	3	3	0	0	3	0	0
12	27059070	.	A	G	9	7	16	0	2	18	0	0
12	27059581	.	T	C	6	13	19	0	0	19	0	0
12	27059901	.	A	T	14	16	30	0	0	30	0	0
12	27059910	.	A	T	13	15	28	0	1	29	0	0
12	27060018	.	C	T	6	7	13	0	0	13	0	0
12	27060087	.	C	A	7	5	12	0	0	12	0	0
12	27060572	.	G	A	6	8	14	0	1	15	0	0
12	27065056	.	C	A	2	4	6	0	1	7	0	0
12	27065470	.	A	C	5	2	7	0	0	7	0	0
12	27065471	.	C	A	5	2	7	0	0	7	0	0
12	27065942	.	T	C	1	3	4	0	0	4	0	0
12	27068492	.	G	A	6	7	13	0	2	15	0	0
12	27068513	.	C	A	4	5	9	0	0	9	0	0
12	27073084	.	A	G	1	2	3	0	0	3	0	0
12	27073135	.	T	C	4	4	8	0	0	8	0	0
12	27078324	.	A	T	4	8	12	0	1	13	0	0
12	27086658	.	C	T	4	7	11	0	0	11	0	0
12	27086943	.	T	C	7	6	13	0	0	13	0	0
12	27086958	.	C	T	7	5	12	0	0	12	0	0
12	27087342	.	C	A	8	6	14	0	1	15	0	0
12	27087375	.	T	C	9	5	14	0	0	14	0	0
12	27087570	.	A	T	14	9	23	0	0	23	0	0
12	27087635	.	T	C	6	16	22	0	1	23	0	0
12	27087844	.	G	A	12	5	17	0	0	17	0	0
12	27088199	.	T	C	11	7	18	0	0	18	0	0
12	27088286	.	G	T	6	12	18	0	0	18	0	0
12	27088304	.	T	C	6	13	19	0	1	20	0	0
12	27088357	.	C	T	6	15	21	0	0	21	0	0
12	27088383	.	A	C	6	12	18	0	0	18	0	0
12	27088646	.	T	A	10	10	20	0	1	21	0	0
12	27088758	.	A	C	5	5	10	0	0	10	0	0
12	27088767	.	G	A	5	5	10	0	0	10	0	0
12	27088821	.	A	G	9	0	9	0	9	18	0	0
12	27088836	.	T	C	9	6	15	0	1	16	0	0
12	27089531	.	G	C	6	9	15	0	3	18	0	0
12	27089857	.	T	C	12	14	26	0	0	26	0	0
12	27090630	.	A	C	9	8	17	0	1	18	0	0
12	27090663	.	G	A	0	5	5	0	7	12	0	0
12	27090696	.	A	T	7	10	17	0	0	17	0	0
12	27090756	.	A	G	5	14	19	0	0	19	0	0
12	27090824	.	T	G	6	10	16	0	3	19	0	0
12	27090856	.	A	T	5	12	17	0	0	17	0	0
12	27090864	.	G	C	5	12	17	0	0	17	0	0
12	27090918	.	G	A	7	12	19	0	0	19	0	0
12	27091163	.	C	A	3	6	9	0	0	9	0	0
12	27091305	.	T	C	10	8	18	0	0	18	0	0
12	27110312	.	T	A	0	1	1	0	0	1	0	0
12	27110426	.	C	A	1	1	2	0	0	2	0	0
12	27110448	.	C	A	2	2	4	0	0	4	0	0
12	27114254	.	G	A	0	2	2	0	1	3	0	0
12	27114393	.	C	T	1	2	3	0	0	3	0	0
12	27127436	.	T	A	1	2	3	0	0	3	0	0
12	27128299	.	T	A	5	3	8	0	0	8	0	0
12	27128305	.	A	G	5	4	9	0	0	9	0	0
12	27130237	.	G	A	1	12	13	0	14	27	0	0
12	27131224	.	T	C	8	7	15	0	0	15	0	0
12	27141915	.	C	T	1	3	4	0	0	4	0	0
12	27207050	.	T	G	9	2	11	0	2	13	0	0
12	27207053	.	C	T	10	2	12	0	1	13	0	0
12	27207130	.	G	A	7	7	14	0	0	14	0	0
12	27207466	.	T	C	10	16	26	0	0	26	0	0
12	27218781	.	C	T	5	7	12	0	0	12	0	0
12	27219143	.	C	T	8	4	12	0	0	12	0	0
12	27219450	.	T	C	3	1	4	0	0	4	0	0
12	27219761	.	T	A	5	9	14	0	0	14	0	0
12	27219818	.	G	A	0	6	6	0	9	15	0	0
12	27221491	.	G	A	2	1	3	0	0	3	0	0
12	27221505	.	A	T	4	6	10	0	0	10	0	0
12	27224057	.	G	A	7	11	18	0	2	20	0	0
12	27224090	.	C	G	1	1	2	0	5	7	0	0
12	27224727	.	T	C	1	1	2	0	0	2	0	0
12	27229078	.	A	G	14	4	18	0	0	18	0	0
12	27229216	.	T	A	15	7	22	0	3	26	1	0
12	27229438	.	T	G	11	9	20	0	0	20	0	0
12	27232225	.	A	C	3	2	5	0	1	6	0	0
12	27241657	.	A	G	0	1	1	0	0	1	0	0
12	27242416	.	G	A	1	0	1	0	0	1	0	0
12	27243208	.	A	G	11	5	16	0	2	18	0	0
12	27243236	.	T	C	18	5	23	0	1	24	0	0
12	27303000	.	A	G	4	7	11	0	0	11	0	0
12	27303211	.	C	T	11	5	16	0	0	16	0	0
12	27303288	.	C	T	10	8	18	0	0	18	0	0
12	27303295	.	A	C	10	7	17	0	0	17	0	0
12	27303328	.	T	C	13	7	20	0	0	20	0	0
12	27303486	.	A	T	6	12	18	0	0	18	0	0
12	27303496	.	T	C	8	9	17	0	1	18	0	0
12	27303521	.	C	T	11	8	19	0	0	19	0	0
12	27304215	.	G	A	0	3	3	0	3	6	0	0
12	27304316	.	A	T	8	6	14	0	1	15	0	0
12	27304596	.	T	A	6	5	11	0	0	11	0	0
12	27304704	.	A	C	6	12	18	0	0	18	0	0
12	27305054	.	G	A	11	6	17	0	1	18	0	0
12	27305495	.	C	A	11	16	27	0	0	27	0	0
12	27305503	.	A	G	10	16	26	0	0	26	0	0
12	27558619	.	G	C	5	4	9	0	0	9	0	0
12	27558705	.	G	T	4	3	7	0	0	7	0	0
12	27559653	.	T	C	5	5	10	0	0	10	0	0
12	27566659	.	T	C	2	2	4	0	0	4	0	0
12	27568288	.	T	A	3	9	12	0	0	12	0	0
12	27570675	.	A	G	6	3	9	0	1	10	0	0
12	27570725	.	T	A	6	9	15	0	0	15	0	0
12	27570759	.	T	G	6	12	18	0	0	18	0	0
12	27570838	.	C	G	9	8	17	0	0	17	0	0
12	27570869	.	A	T	7	6	13	0	0	13	0	0
12	27570964	.	G	A	3	6	9	0	0	9	0	0
12	27571076	.	C	A	8	5	13	0	0	13	0	0
12	27571142	.	A	C	8	6	14	0	0	14	0	0
12	27571151	.	A	T	6	5	11	0	1	12	0	0
12	27571213	.	T	C	6	0	6	0	3	9	0	0
12	27571224	.	C	T	7	6	13	0	0	13	0	0
12	27571625	.	G	A	15	4	19	0	0	19	0	0
12	27573030	.	G	A	6	4	10	0	0	10	0	0
12	27573072	.	G	A	8	8	16	0	0	16	0	0
12	27575444	.	T	C	0	4	4	0	0	4	0	0
12	27580166	.	T	C	2	5	7	0	0	7	0	0
12	27584590	.	A	T	3	2	5	0	0	5	0	0
12	27584827	.	C	T	0	8	8	0	2	10	0	0
12	27586719	.	G	A	0	1	1	0	0	1	0	0
12	27591232	.	G	A	3	4	7	0	0	7	0	0
12	27593678	.	T	C	1	1	2	0	0	2	0	0
12	27593856	.	G	A	0	4	4	0	5	9	0	0
12	27593868	.	A	C	5	5	10	0	0	10	0	0
12	27593892	.	C	T	0	4	4	0	1	5	0	0
12	27593922	.	T	G	0	1	1	0	0	1	0	0
12	27595297	.	T	A	5	3	8	0	0	8	0	0
12	27602080	.	A	T	1	4	5	0	1	6	0	0
12	27615642	.	A	G	1	0	1	0	0	1	0	0
12	27622254	.	C	T	4	2	6	0	0	6	0	0
12	27622321	.	G	A	9	5	14	0	2	16	0	0
12	27622336	.	C	A	6	6	12	0	0	12	0	0
12	27627528	.	G	C	1	1	2	0	0	2	0	0
12	27665035	.	T	C	11	7	18	0	0	18	0	0
12	27665289	.	G	C	13	13	26	0	1	27	0	0
12	27665502	.	T	A	2	3	5	0	0	5	0	0
12	27665539	.	T	C	1	2	3	0	0	3	0	0
12	27889992	.	T	C	1	1	2	0	0	2	0	0
12	27902711	.	A	C	2	3	5	0	0	5	0	0
12	27902871	.	A	G	4	0	4	0	7	11	0	0
12	27906193	.	A	C	0	1	1	0	0	1	0	0
12	27925629	.	C	T	4	2	6	0	0	6	0	0
12	27926395	.	A	C	2	2	4	0	0	4	0	0
12	27943009	.	T	C	5	3	8	0	0	8	0	0
12	27999503	.	C	T	1	3	4	0	0	4	0	0
12	28003340	.	C	T	1	1	2	0	0	2	0	0
12	28003358	.	C	T	1	1	2	0	0	2	0	0
12	28033169	.	C	T	0	3	3	0	0	3	0	0
12	28049096	.	G	A	2	7	9	0	0	9	0	0
12	28120243	.	T	A	1	2	3	0	0	3	0	0
12	28120585	.	C	T	3	3	6	0	0	6	0	0
12	28120615	.	A	G	3	0	3	0	4	7	0	0
12	28177649	.	A	G	1	0	1	0	2	3	0	0
12	28180320	.	A	G	2	2	4	0	0	4	0	0
12	28350566	.	A	G	11	12	23	0	1	24	0	0
12	28351160	.	G	C	1	4	5	0	0	5	0	0
12	28355486	.	G	A	6	11	17	0	0	17	0	0
12	28359161	.	G	A	0	1	1	0	1	2	0	0
12	28367757	.	T	A	16	15	31	0	0	31	0	0
12	28369391	.	G	A	0	4	4	0	4	8	0	0
12	28369412	.	G	T	10	9	19	0	2	21	0	0
12	28369540	.	C	A	17	19	36	0	3	39	0	0
12	28369615	.	G	C	1	14	15	0	26	41	0	0
12	28369909	.	G	T	1	26	27	0	17	44	0	0
12	28369981	.	C	T	13	20	33	0	1	35	1	0
12	28370062	.	G	C	2	22	24	0	11	35	0	0
12	28370335	.	A	C	19	29	48	0	3	51	0	0
12	28370474	.	T	G	12	0	12	0	13	25	0	0
12	28377909	.	T	A	4	3	7	0	1	8	0	0
12	28377976	.	G	A	4	5	9	0	0	9	0	0
12	28378045	.	A	T	5	2	7	0	0	7	0	0
12	28378139	.	G	A	4	8	12	0	1	13	0	0
12	28378200	.	T	G	7	4	11	0	1	12	0	0
12	28378237	.	A	C	8	7	15	0	0	15	0	0
12	28378342	.	T	C	3	4	7	0	0	7	0	0
12	28378394	.	C	A	0	5	5	0	5	10	0	0
12	28378418	.	G	A	6	9	15	0	0	15	0	0
12	28378645	.	C	T	1	4	5	0	0	5	0	0
12	28378958	.	C	T	3	4	7	0	1	8	0	0
12	28379042	.	T	C	4	5	9	0	0	9	0	0
12	28379215	.	C	T	1	5	6	0	0	6	0	0
12	28379218	.	C	T	1	3	4	0	1	5	0	0
12	28379593	.	T	A	3	6	9	0	0	9	0	0
12	28379646	.	T	C	6	4	10	0	0	10	0	0
12	28379647	.	G	A	6	4	10	0	0	10	0	0
12	28379860	.	C	T	2	7	9	0	1	10	0	0
12	28380803	.	G	A	1	3	4	0	0	4	0	0
12	28449032	.	G	T	2	5	7	0	0	7	0	0
12	28457292	.	C	T	0	1	1	0	0	1	0	0
12	28476588	.	G	A	1	2	3	0	0	3	0	0
12	28511104	.	G	T	3	2	5	0	0	5	0	0
12	28559939	.	T	C	3	6	9	0	1	10	0	0
12	28560255	.	G	C	1	2	3	0	0	3	0	0
12	28560494	.	T	C	5	2	7	0	0	7	0	0
12	28560734	.	T	C	5	4	9	0	1	10	0	0
12	28560990	.	T	C	8	8	16	0	0	16	0	0
12	28561253	.	G	A	1	2	3	0	0	3	0	0
12	28561420	.	C	T	6	4	10	0	1	11	0	0
12	28561778	.	A	T	6	5	11	0	0	11	0	0
12	28561875	.	A	C	3	0	3	0	1	4	0	0
12	28566224	.	T	C	1	1	2	0	0	2	0	0
12	28568350	.	G	A	1	2	3	0	0	3	0	0
12	28570908	.	G	A	4	1	5	0	1	6	0	0
12	28668713	.	A	T	7	3	10	0	0	10	0	0
12	28676131	.	C	T	12	10	22	0	0	22	0	0
12	28676551	.	A	G	10	0	10	0	10	20	0	0
12	28676844	.	A	T	7	8	15	0	0	15	0	0
12	28677202	.	C	T	5	14	19	0	0	19	0	0
12	28677314	.	A	G	8	10	18	0	1	19	0	0
12	28677413	.	T	C	9	9	18	0	0	18	0	0
12	28677576	.	A	T	11	10	21	0	0	21	0	0
12	28797777	.	T	C	4	0	4	0	1	5	0	0
12	28799604	.	G	C	1	0	1	0	0	1	0	0
12	28800029	.	A	G	7	3	10	0	0	10	0	0
12	28801271	.	A	G	3	0	3	0	7	10	0	0
12	28806022	.	G	A	0	15	15	0	9	24	0	0
12	28806062	.	C	T	10	12	22	0	0	22	0	0
12	28806180	.	C	T	10	5	15	0	0	15	0	0
12	28806220	.	G	T	7	8	15	0	0	15	0	0
12	28806241	.	T	G	6	4	10	0	3	13	0	0
12	28806285	.	G	A	10	6	16	0	1	17	0	0
12	28806396	.	C	A	6	5	11	0	1	12	0	0
12	28806459	.	A	T	10	5	15	0	0	15	0	0
12	28806494	.	G	A	10	6	16	0	0	16	0	0
12	28806530	.	G	C	13	9	22	0	0	22	0	0
12	28806584	.	T	G	12	8	20	0	1	21	0	0
12	28806586	.	A	T	12	9	21	0	0	21	0	0
12	28827553	.	T	A	3	0	3	0	0	3	0	0
12	28828016	.	A	C	0	4	4	0	0	4	0	0
12	28828207	.	A	T	3	4	7	0	0	7	0	0
12	28828234	.	T	C	2	0	2	0	0	2	0	0
12	28830363	.	A	G	5	6	11	0	0	11	0	0
12	28844171	.	T	C	10	11	21	0	0	21	0	0
12	28847439	.	A	C	2	3	5	0	0	5	0	0
12	28856200	.	T	C	6	3	9	0	1	10	0	0
12	28856227	.	T	C	4	3	7	0	0	7	0	0
12	28863046	.	A	T	4	14	18	0	1	19	0	0
12	28863086	.	T	A	4	8	12	0	2	14	0	0
12	28863101	.	T	C	4	9	13	0	0	13	0	0
12	28863582	.	A	G	10	8	18	0	1	19	0	0
12	28863711	.	T	C	9	7	16	0	0	16	0	0
12	28863783	.	A	C	10	9	19	0	0	19	0	0
12	28863811	.	T	C	8	10	18	0	0	18	0	0
12	28864217	.	T	C	6	6	12	0	1	13	0	0
12	28864575	.	T	G	12	0	12	0	5	17	0	0
12	28864719	.	G	C	9	4	13	0	2	15	0	0
12	28864778	.	C	G	9	10	19	0	2	21	0	0
12	28864792	.	A	C	13	11	24	0	0	24	0	0
12	28864847	.	T	C	21	13	34	0	1	35	0	0
12	28865106	.	G	T	10	9	19	0	0	19	0	0
12	28865298	.	T	A	19	21	40	0	1	41	0	0
12	28865668	.	T	G	14	8	22	0	0	22	0	0
12	28865679	.	G	A	16	7	23	0	1	24	0	0
12	28865805	.	A	C	9	14	23	0	0	23	0	0
12	28870626	.	T	C	4	11	15	0	1	16	0	0
12	28870797	.	T	C	10	1	11	0	22	33	0	0
12	28870801	.	T	A	12	17	29	0	3	32	0	0
12	28870912	.	C	A	15	21	36	0	2	38	0	0
12	28871068	.	G	T	20	11	31	0	1	32	0	0
12	28871433	.	C	A	0	18	18	0	21	39	0	0
12	28878343	.	C	T	24	23	47	0	1	48	0	0
12	28899989	.	C	A	1	1	2	0	0	2	0	0
12	28900299	.	C	T	3	2	5	0	0	5	0	0
12	28900439	.	T	C	4	4	8	0	0	8	0	0
12	28900607	.	A	G	3	4	7	0	0	7	0	0
12	28901049	.	A	G	3	2	5	0	0	5	0	0
12	28912644	.	T	C	2	0	2	0	0	2	0	0
12	28916846	.	A	T	2	0	2	0	0	2	0	0
12	28918699	.	G	A	3	0	3	0	0	3	0	0
12	28924363	.	G	A	2	2	4	0	1	5	0	0
12	28927051	.	G	A	5	7	12	0	0	12	0	0
12	28930455	.	T	C	1	3	4	0	0	4	0	0
12	28932389	.	C	T	2	0	2	0	1	3	0	0
12	28932571	.	G	A	8	8	16	0	0	16	0	0
12	28932581	.	T	A	6	9	15	0	0	15	0	0
12	28948117	.	T	C	1	3	4	0	0	4	0	0
12	28949067	.	A	G	3	4	7	0	0	7	0	0
12	28949112	.	C	A	2	2	4	0	0	4	0	0
12	28951019	.	C	T	0	6	6	0	10	16	0	0
12	28952139	.	T	C	5	8	13	0	3	16	0	0
12	28956566	.	T	C	1	3	4	0	0	4	0	0
12	28956615	.	A	G	1	2	3	0	0	3	0	0
12	28958548	.	A	G	0	0	0	0	2	2	0	0
12	28959298	.	C	T	2	2	4	0	0	4	0	0
12	28960284	.	T	C	8	4	12	0	1	13	0	0
12	29054940	.	A	G	4	2	6	0	0	6	0	0
12	29054941	.	A	G	4	2	6	0	0	6	0	0
12	29063346	.	G	A	0	3	3	0	1	4	0	0
12	29084032	.	T	C	2	2	4	0	1	5	0	0
12	29102585	.	T	C	8	9	17	0	1	18	0	0
12	29103004	.	T	C	4	2	6	0	0	6	0	0
12	29103041	.	T	A	4	8	12	0	0	12	0	0
12	29173712	.	T	C	2	4	6	0	0	6	0	0
12	29207473	.	G	A	0	3	3	0	3	6	0	0
12	29207533	.	T	C	4	5	9	0	1	10	0	0
12	29207590	.	G	A	0	7	7	0	4	11	0	0
12	29207683	.	G	T	10	10	20	0	0	20	0	0
12	29208099	.	T	G	5	4	9	0	0	9	0	0
12	29209834	.	G	A	3	4	7	0	0	7	0	0
12	29209840	.	A	T	3	4	7	0	0	7	0	0
12	29210371	.	C	A	10	6	16	0	0	16	0	0
12	29210435	.	C	G	7	6	13	0	1	14	0	0
12	29210600	.	C	T	5	7	12	0	0	12	0	0
12	29210719	.	T	A	6	6	12	0	1	13	0	0
12	29210873	.	T	A	1	5	6	0	0	6	0	0
12	29210917	.	T	C	4	5	9	0	1	10	0	0
12	29211082	.	G	A	1	2	3	0	1	4	0	0
12	29211195	.	T	A	6	5	11	0	0	11	0	0
12	29211232	.	G	A	0	10	10	0	11	21	0	0
12	29211289	.	T	A	13	11	24	0	0	24	0	0
12	29211292	.	A	G	7	9	16	0	5	21	0	0
12	29223498	.	A	G	3	4	7	0	1	8	0	0
12	29223612	.	T	G	3	3	6	0	0	6	0	0
12	29223689	.	G	A	0	3	3	0	0	3	0	0
12	29223751	.	G	C	1	3	4	0	0	4	0	0
12	29223811	.	C	A	4	2	6	0	0	6	0	0
12	29223921	.	G	A	2	4	6	0	0	6	0	0
12	29224065	.	G	A	1	2	3	0	0	3	0	0
12	29224250	.	T	G	3	4	7	0	0	7	0	0
12	29224310	.	A	G	2	4	6	0	0	6	0	0
12	29226152	.	T	C	1	2	3	0	0	3	0	0
12	29226690	.	A	G	1	2	3	0	0	3	0	0
12	29227014	.	T	G	3	3	6	0	0	6	0	0
12	29227044	.	G	A	2	2	4	0	1	5	0	0
12	29227350	.	G	T	2	2	4	0	0	4	0	0
12	29229047	.	G	C	1	2	3	0	0	3	0	0
12	29251520	.	A	G	4	2	6	0	0	6	0	0
12	29262564	.	A	G	2	0	2	0	2	4	0	0
12	29266917	.	T	C	2	6	8	0	0	8	0	0
12	29269576	.	C	A	6	2	8	0	0	8	0	0
12	29269689	.	G	A	4	3	7	0	0	7	0	0
12	29269695	.	A	G	4	0	4	0	3	7	0	0
12	29269726	.	C	G	2	8	10	0	1	11	0	0
12	29269770	.	G	T	1	7	8	0	3	11	0	0
12	29269774	.	T	G	4	6	10	0	0	10	0	0
12	29350773	.	C	A	3	3	6	0	0	6	0	0
12	29351320	.	A	G	13	16	29	0	0	29	0	0
12	29351810	.	A	G	13	13	26	0	3	29	0	0
12	29358277	.	T	C	5	2	7	0	0	7	0	0
12	29358370	.	G	C	7	0	7	0	10	17	0	0
12	29358384	.	A	G	6	5	11	0	0	11	0	0
12	29358418	.	A	G	1	1	2	0	0	2	0	0
12	29624017	.	G	A	16	14	30	0	0	30	0	0
12	29624272	.	C	A	4	8	12	0	0	12	0	0
12	29624611	.	T	C	5	0	5	0	4	9	0	0
12	29801179	.	T	C	5	3	8	0	0	8	0	0
12	29811009	.	A	G	3	0	3	0	2	5	0	0
12	29843460	.	A	G	15	10	25	0	2	27	0	0
12	29844434	.	T	C	3	5	8	0	1	9	0	0
12	29873273	.	C	G	0	3	3	0	0	3	0	0
12	29921114	.	T	G	6	5	11	0	0	11	0	0
12	29947132	.	A	G	3	6	9	0	1	10	0	0
12	29947147	.	C	A	2	5	7	0	0	7	0	0
12	29957074	.	C	T	4	0	4	0	2	6	0	0
12	29957164	.	C	T	5	13	18	0	0	18	0	0
12	29965724	.	G	A	3	7	10	0	0	10	0	0
12	29965928	.	C	T	1	2	3	0	0	3	0	0
12	29966039	.	T	C	4	0	4	0	0	4	0	0
12	29966048	.	T	C	0	0	0	0	2	2	0	0
12	29968087	.	T	C	2	0	2	0	4	6	0	0
12	29973800	.	G	A	7	4	11	0	0	11	0	0
12	29976936	.	G	A	5	5	10	0	0	10	0	0
12	29976978	.	T	C	4	0	4	0	0	4	0	0
12	30031677	.	T	C	4	6	10	0	0	10	0	0
12	30031680	.	T	C	4	6	10	0	0	10	0	0
12	30036873	.	G	A	3	2	5	0	0	5	0	0
12	30153772	.	T	C	1	2	3	0	0	3	0	0
12	30156449	.	T	C	1	0	1	0	0	1	0	0
12	30192526	.	A	T	6	8	14	0	0	14	0	0
12	30200741	.	C	T	6	5	11	0	1	12	0	0
12	30207912	.	G	A	1	3	4	0	0	4	0	0
12	30216090	.	G	T	2	2	4	0	0	4	0	0
12	30216248	.	C	T	3	8	11	0	0	11	0	0
12	30216436	.	T	C	4	2	6	0	0	6	0	0
12	30216490	.	T	C	2	3	5	0	0	5	0	0
12	30216693	.	C	T	2	4	6	0	0	6	0	0
12	30216697	.	G	A	0	4	4	0	3	7	0	0
12	30217423	.	T	C	3	6	9	0	0	9	0	0
12	30217569	.	A	G	2	2	4	0	0	4	0	0
12	30217589	.	A	T	2	4	6	0	1	7	0	0
12	30217705	.	G	A	0	5	5	0	9	14	0	0
12	30217747	.	C	T	4	4	8	0	1	9	0	0
12	30217782	.	T	G	1	2	3	0	0	4	1	0
12	30217898	.	T	A	5	2	7	0	0	7	0	0
12	30217966	.	G	A	2	2	4	0	0	4	0	0
12	30218135	.	C	A	5	2	7	0	0	7	0	0
12	30218150	.	G	A	2	5	7	0	0	7	0	0
12	30218173	.	C	T	6	4	10	0	0	10	0	0
12	30219306	.	A	T	6	14	20	0	1	21	0	0
12	30219687	.	T	A	3	1	4	0	1	5	0	0
12	30219694	.	A	T	3	2	5	0	0	5	0	0
12	30219739	.	G	A	3	6	9	0	1	10	0	0
12	30219804	.	C	T	8	6	14	0	2	16	0	0
12	30299061	.	T	C	7	3	10	0	1	11	0	0
12	30299073	.	C	T	3	6	9	0	2	11	0	0
12	30302941	.	A	T	0	3	3	0	0	3	0	0
12	30304883	.	C	T	3	2	5	0	0	5	0	0
12	30307010	.	C	T	3	5	8	0	0	8	0	0
12	30307913	.	G	T	4	10	14	0	0	14	0	0
12	30372463	.	G	A	0	3	3	0	3	6	0	0
12	30372763	.	G	A	3	2	5	0	0	5	0	0
12	30382341	.	C	T	2	5	7	0	0	7	0	0
12	30383960	.	G	A	0	0	0	0	2	2	0	0
12	30385562	.	C	T	0	2	2	0	0	2	0	0
12	30391136	.	G	A	0	1	1	0	0	1	0	0
12	30418108	.	T	C	5	5	10	0	2	12	0	0
12	30418513	.	C	G	3	12	15	0	0	15	0	0
12	30418931	.	A	T	3	4	7	0	0	7	0	0
12	30419123	.	A	T	4	6	10	0	0	10	0	0
12	30419134	.	C	A	4	4	8	0	0	8	0	0
12	30419260	.	T	G	12	8	20	0	0	20	0	0
12	30419646	.	T	C	2	15	17	0	1	18	0	0
12	30419655	.	T	C	1	17	18	0	0	18	0	0
12	30419695	.	T	C	2	14	16	0	0	16	0	0
12	30419727	.	A	G	4	5	9	0	0	9	0	0
12	30419783	.	C	A	3	3	6	0	1	7	0	0
12	30442406	.	C	A	6	8	14	0	1	15	0	0
12	30442783	.	G	A	10	9	19	0	0	19	0	0
12	30443462	.	T	C	4	3	7	0	0	7	0	0
12	30459235	.	T	C	1	5	6	0	0	6	0	0
12	30459250	.	G	A	0	3	3	0	0	3	0	0
12	30460762	.	T	A	1	2	3	0	0	3	0	0
12	30460764	.	A	C	1	1	2	0	1	3	0	0
12	30461332	.	G	A	2	3	5	0	0	5	0	0
12	30461485	.	T	A	2	1	3	0	0	3	0	0
12	30467666	.	G	T	0	3	3	0	2	5	0	0
12	30504745	.	T	C	1	2	3	0	0	3	0	0
12	30706173	.	T	A	1	1	2	0	0	2	0	0
12	30706176	.	T	C	1	1	2	0	0	2	0	0
12	30743947	.	C	T	1	0	1	0	0	1	0	0
12	30788993	.	G	A	2	2	4	0	0	4	0	0
12	30793107	.	C	T	4	4	8	0	0	8	0	0
12	30796306	.	C	T	1	2	3	0	0	3	0	0
12	30796322	.	C	A	2	2	4	0	0	4	0	0
12	30796345	.	C	T	5	2	7	0	0	7	0	0
12	30796967	.	T	A	2	1	3	0	0	3	0	0
12	30798079	.	G	A	5	5	10	0	1	11	0	0
12	30798085	.	A	T	5	4	9	0	1	10	0	0
12	30800128	.	G	A	5	4	9	0	0	9	0	0
12	30803166	.	G	A	0	4	4	0	8	12	0	0
12	30803196	.	T	C	6	7	13	0	0	13	0	0
12	30803629	.	A	G	2	4	6	0	0	6	0	0
12	30805335	.	T	C	1	2	3	0	0	3	0	0
12	30805359	.	T	C	2	5	7	0	0	7	0	0
12	30805455	.	C	T	1	4	5	0	0	5	0	0
12	30806928	.	G	T	0	9	9	0	6	15	0	0
12	30807038	.	A	G	10	13	23	0	1	24	0	0
12	30807290	.	A	G	1	4	5	0	0	5	0	0
12	30807458	.	C	T	9	6	15	0	1	16	0	0
12	30807494	.	G	A	4	10	14	0	0	14	0	0
12	30807504	.	A	C	5	9	14	0	0	14	0	0
12	30808150	.	T	A	2	9	11	0	0	11	0	0
12	30808342	.	A	T	3	7	10	0	0	10	0	0
12	30808531	.	G	C	5	6	11	0	1	12	0	0
12	30808716	.	C	T	0	6	6	0	2	8	0	0
12	30808766	.	C	T	4	2	6	0	0	6	0	0
12	30808812	.	A	G	3	0	3	0	3	6	0	0
12	30808817	.	T	G	3	3	6	0	0	6	0	0
12	30979815	.	A	C	11	12	23	0	1	24	0	0
12	30980566	.	G	A	25	18	43	0	2	45	0	0
12	30981795	.	G	A	21	23	44	0	1	45	0	0
12	30986452	.	G	A	0	1	1	0	0	1	0	0
12	31012667	.	C	T	2	2	4	0	0	4	0	0
12	31102981	.	A	G	13	6	19	0	0	19	0	0
12	31435977	.	T	A	1	2	3	0	1	4	0	0
12	31438056	.	G	T	5	10	15	0	2	17	0	0
12	31438352	.	A	T	4	4	8	0	0	8	0	0
12	31520603	.	T	C	1	0	1	0	0	1	0	0
12	31531950	.	T	G	4	3	7	0	1	8	0	0
12	31532638	.	A	C	12	5	17	0	1	18	0	0
12	31532715	.	T	C	3	5	8	0	0	8	0	0
12	31533849	.	G	A	0	2	2	0	1	3	0	0
12	31629611	.	C	T	1	2	3	0	0	3	0	0
12	31630829	.	G	A	1	2	3	0	3	6	0	0
12	31631082	.	T	C	5	2	7	0	1	8	0	0
12	31631116	.	A	T	3	3	6	0	0	6	0	0
12	31631124	.	A	T	5	3	8	0	0	8	0	0
12	31631190	.	G	T	2	2	4	0	0	4	0	0
12	31664846	.	A	T	2	2	4	0	0	4	0	0
12	31665096	.	G	A	0	2	2	0	2	4	0	0
12	31665351	.	C	T	4	3	7	0	0	7	0	0
12	31704077	.	A	C	3	3	6	0	1	7	0	0
12	31704548	.	T	C	1	5	6	0	0	6	0	0
12	31708082	.	G	A	1	2	3	0	0	3	0	0
12	31708125	.	C	A	0	3	3	0	0	3	0	0
12	31709964	.	G	T	1	5	6	0	1	7	0	0
12	31720799	.	C	T	13	17	30	0	4	34	0	0
12	31721486	.	G	A	6	5	11	0	2	13	0	0
12	31722593	.	G	T	7	9	16	0	3	19	0	0
12	31722811	.	G	T	8	12	20	0	1	21	0	0
12	31722875	.	A	C	8	1	9	0	6	15	0	0
12	31724245	.	A	C	18	17	35	0	0	36	1	0
12	31724252	.	C	T	18	17	35	0	0	35	0	0
12	31729236	.	G	A	12	9	21	0	0	21	0	0
12	31729441	.	A	C	4	7	11	0	0	11	0	0
12	31729455	.	G	T	5	7	12	0	0	12	0	0
12	31740822	.	C	T	2	6	8	0	0	8	0	0
12	31753752	.	C	T	8	4	12	0	0	12	0	0
12	31753755	.	C	T	8	4	12	0	0	12	0	0
12	31764523	.	T	C	11	11	22	0	1	23	0	0
12	31764526	.	C	A	11	11	22	0	1	23	0	0
12	31765407	.	G	A	9	12	21	0	1	22	0	0
12	31765485	.	G	A	9	6	15	0	0	15	0	0
12	31765517	.	T	C	8	3	11	0	0	11	0	0
12	31765540	.	T	G	10	3	13	0	0	13	0	0
12	31783185	.	G	A	4	0	4	0	0	4	0	0
12	31787752	.	T	C	1	2	3	0	0	3	0	0
12	31787760	.	A	G	2	2	4	0	0	4	0	0
12	31789799	.	C	T	17	10	27	0	0	27	0	0
12	31794655	.	G	A	1	2	3	0	0	3	0	0
12	31911406	.	A	G	3	3	6	0	0	6	0	0
12	32039443	.	C	T	0	7	7	0	9	16	0	0
12	32039527	.	A	G	15	12	27	0	0	27	0	0
12	32039546	.	G	A	20	13	33	0	0	33	0	0
12	32039635	.	A	C	16	15	31	0	0	31	0	0
12	32039678	.	C	T	15	20	35	0	0	35	0	0
12	32039937	.	G	A	17	22	39	0	1	40	0	0
12	32039958	.	T	C	17	2	19	0	22	41	0	0
12	32040093	.	G	A	20	18	38	0	0	38	0	0
12	32045155	.	G	A	12	20	32	0	0	32	0	0
12	32045212	.	T	C	14	0	14	0	19	33	0	0
12	32066061	.	C	A	11	6	17	0	0	17	0	0
12	32068700	.	A	T	2	2	4	0	0	4	0	0
12	33336119	.	A	C	3	0	3	0	17	20	0	0
12	33831612	.	T	C	4	2	6	0	0	6	0	0
12	33967029	.	T	C	22	9	31	0	2	33	0	0
12	33991622	.	T	C	13	23	36	0	1	37	0	0
12	34821942	.	A	G	1	2	3	0	0	3	0	0
12	34953641	.	G	T	0	1	1	0	14	15	0	0
12	35008681	.	A	G	4	7	11	0	0	11	0	0
12	35012040	.	C	T	13	14	27	0	5	32	0	0
12	35012127	.	T	C	7	4	11	0	0	11	0	0
12	35014147	.	C	A	6	3	9	0	0	9	0	0
12	35014151	.	C	A	6	2	8	0	0	8	0	0
12	35018127	.	C	T	21	26	47	0	1	48	0	0
12	35018519	.	G	T	9	4	13	0	0	13	0	0
12	35046821	.	A	G	13	20	33	0	0	33	0	0
12	35046875	.	C	T	11	10	21	0	1	22	0	0
12	35046900	.	G	A	13	6	19	0	3	22	0	0
12	35046928	.	T	C	17	11	28	0	1	29	0	0
12	35046956	.	T	G	15	16	31	0	1	32	0	0
12	35046965	.	G	T	14	17	31	0	0	31	0	0
12	35047014	.	A	G	4	12	16	0	1	17	0	0
12	35051250	.	A	G	6	15	21	0	0	21	0	0
12	35099509	.	C	T	0	1	1	0	2	3	0	0
12	35099532	.	G	T	1	3	4	0	0	4	0	0
12	35099601	.	C	T	2	2	4	0	0	4	0	0
12	35099805	.	G	A	6	2	8	0	0	8	0	0
12	35103405	.	A	G	1	2	3	0	1	4	0	0
12	35103606	.	T	C	5	0	5	0	6	11	0	0
12	35103665	.	C	T	4	1	5	0	1	6	0	0
12	35103710	.	G	C	1	0	1	0	0	1	0	0
12	35105596	.	G	C	1	2	3	0	0	3	0	0
12	35146537	.	G	A	0	4	4	0	4	8	0	0
12	35149868	.	G	A	6	4	10	0	0	10	0	0
12	35158344	.	C	T	5	4	9	0	1	10	0	0
12	35167333	.	A	G	2	4	6	0	0	6	0	0
12	35178914	.	G	A	15	12	27	0	1	28	0	0
12	35189264	.	G	T	9	9	18	0	1	19	0	0
12	35189295	.	C	T	15	13	28	0	2	30	0	0
12	35189306	.	A	G	16	12	28	0	1	29	0	0
12	35189402	.	A	G	15	0	15	0	15	30	0	0
12	35189471	.	T	A	0	4	4	0	0	4	0	0
12	35191080	.	A	T	9	11	20	0	0	20	0	0
12	35191856	.	C	T	12	11	23	0	1	24	0	0
12	35203251	.	G	T	0	4	4	0	1	5	0	0
12	35270573	.	G	A	0	0	0	0	1	1	0	0
12	35317147	.	G	A	2	2	4	0	0	4	0	0
12	35317222	.	A	G	2	2	4	0	0	4	0	0
12	35317294	.	A	G	3	0	3	0	6	9	0	0
12	35317520	.	C	A	3	5	8	0	0	8	0	0
12	35317609	.	C	T	6	4	10	0	0	10	0	0
12	35317654	.	C	T	1	3	4	0	0	4	0	0
12	35325591	.	G	T	2	1	3	0	0	3	0	0
12	35325618	.	C	A	4	2	6	0	0	6	0	0
12	35325811	.	C	T	1	0	1	0	0	1	0	0
12	35328139	.	C	T	3	6	9	0	0	9	0	0
12	35330107	.	C	T	2	2	4	0	0	4	0	0
12	35332283	.	T	A	4	6	10	0	0	10	0	0
12	35334652	.	C	G	2	5	7	0	0	7	0	0
12	35339212	.	A	G	9	5	14	0	2	16	0	0
12	35339263	.	A	T	8	7	15	0	1	16	0	0
12	35339395	.	C	T	5	4	9	0	0	9	0	0
12	35346498	.	G	A	3	23	26	0	1	27	0	0
12	35346597	.	A	T	30	18	48	0	2	50	0	0
12	35346842	.	T	C	10	23	33	0	2	35	0	0
12	35346873	.	C	T	18	26	44	0	1	45	0	0
12	35347002	.	A	T	16	20	36	0	1	37	0	0
12	35347078	.	G	A	23	27	50	0	0	50	0	0
12	35347084	.	C	T	1	21	22	0	27	49	0	0
12	35347318	.	C	T	23	17	40	0	4	44	0	0
12	35347485	.	T	G	14	19	33	0	6	39	0	0
12	35347795	.	C	T	0	8	8	0	6	14	0	0
12	35347951	.	A	G	20	17	37	0	0	37	0	0
12	35350686	.	G	A	13	28	41	0	3	44	0	0
12	35351392	.	G	T	2	4	6	0	0	6	0	0
12	35381729	.	T	C	1	0	1	0	3	4	0	0
12	35386919	.	A	G	10	3	13	0	1	14	0	0
12	35543736	.	T	G	3	11	14	0	0	14	0	0
12	35543971	.	T	G	8	13	21	0	0	21	0	0
12	35544320	.	T	G	5	6	11	0	0	11	0	0
12	35544460	.	A	G	1	10	11	0	1	12	0	0
12	35544596	.	C	A	6	5	11	0	0	11	0	0
12	35544968	.	A	G	15	11	26	0	1	27	0	0
12	35556821	.	G	C	1	3	4	0	0	4	0	0
12	35559614	.	T	G	2	3	5	0	0	5	0	0
12	35568231	.	G	A	5	10	15	0	0	15	0	0
12	35568249	.	C	T	0	10	10	0	6	16	0	0
12	35568270	.	T	A	10	8	18	0	0	18	0	0
12	35568303	.	C	G	7	8	15	0	0	15	0	0
12	35568691	.	A	G	0	2	2	0	1	3	0	0
12	35568787	.	G	A	0	3	3	0	0	3	0	0
12	35568793	.	A	G	0	2	2	0	0	2	0	0
12	35593188	.	C	T	20	21	41	0	2	43	0	0
12	35593469	.	T	A	10	8	18	0	2	20	0	0
12	35593729	.	A	G	9	0	9	0	6	15	0	0
12	35594069	.	T	A	14	22	36	0	0	36	0	0
12	35594154	.	C	T	10	12	22	0	1	23	0	0
12	35594169	.	C	T	13	12	25	0	2	27	0	0
12	35594436	.	C	T	16	8	24	0	4	28	0	0
12	35594474	.	A	G	17	9	26	0	0	26	0	0
12	35594495	.	G	A	1	8	9	0	12	21	0	0
12	35594512	.	T	C	15	7	22	0	0	22	0	0
12	35594541	.	C	A	16	11	27	0	0	27	0	0
12	35594605	.	C	T	22	15	37	0	1	38	0	0
12	35594623	.	T	A	22	14	36	0	1	37	0	0
12	35674952	.	G	A	12	12	24	0	1	25	0	0
12	35689209	.	C	T	2	2	4	0	0	4	0	0
12	35689210	.	A	G	2	1	3	0	1	4	0	0
12	35704426	.	G	T	21	13	34	0	3	37	0	0
12	35704435	.	G	T	22	13	35	0	3	38	0	0
12	35704735	.	A	G	3	2	5	0	1	6	0	0
12	35704852	.	G	A	1	1	2	0	0	2	0	0
12	35704921	.	A	C	14	12	26	0	0	26	0	0
12	35704996	.	T	G	20	13	33	0	0	33	0	0
12	35705131	.	C	T	16	16	32	0	6	38	0	0
12	35705140	.	A	C	16	0	16	0	22	38	0	0
12	35705224	.	A	G	16	23	39	0	2	41	0	0
12	35705252	.	T	G	14	21	35	0	2	37	0	0
12	35705323	.	G	A	9	14	23	0	5	28	0	0
12	35705367	.	C	T	0	17	17	0	15	32	0	0
12	35705565	.	C	T	0	10	10	0	13	23	0	0
12	35705606	.	A	T	12	7	19	0	0	20	1	0
12	35705661	.	T	C	10	7	17	0	1	18	0	0
12	35705926	.	C	T	21	15	36	0	2	38	0	0
12	35706091	.	C	T	18	9	27	0	1	28	0	0
12	35706124	.	A	G	18	8	26	0	1	27	0	0
12	35706253	.	A	T	6	22	28	0	0	28	0	0
12	35706304	.	A	G	5	16	21	0	1	22	0	0
12	35706524	.	G	A	14	17	31	0	1	32	0	0
12	35706568	.	C	T	15	15	30	0	0	30	0	0
12	35706859	.	C	T	0	16	16	0	10	26	0	0
12	35706970	.	G	T	8	11	19	0	1	20	0	0
12	35707155	.	C	T	13	10	23	0	1	24	0	0
12	35707171	.	T	C	13	9	22	0	0	22	0	0
12	35707225	.	G	A	9	11	20	0	0	20	0	0
12	35707537	.	A	G	11	7	18	0	0	18	0	0
12	35707636	.	G	A	7	5	12	0	0	12	0	0
12	35707660	.	A	C	3	6	9	0	1	10	0	0
12	35707747	.	A	G	7	8	15	0	1	16	0	0
12	35707963	.	T	C	11	0	11	0	11	22	0	0
12	35707987	.	G	A	11	12	23	0	0	23	0	0
12	35708139	.	T	G	8	10	18	0	0	18	0	0
12	35708235	.	A	G	13	11	24	0	1	25	0	0
12	35708272	.	C	T	7	4	11	0	1	12	0	0
12	35708950	.	G	A	11	4	15	0	1	16	0	0
12	35709007	.	G	A	6	4	10	0	0	10	0	0
12	35709028	.	A	G	2	0	2	0	0	2	0	0
12	35710837	.	T	C	6	3	9	0	1	10	0	0
12	35715339	.	A	G	6	1	7	0	0	7	0	0
12	35716116	.	T	G	0	1	1	0	0	1	0	0
12	35740605	.	G	T	1	2	3	0	0	3	0	0
12	35837354	.	C	T	0	4	4	0	2	6	0	0
12	35837425	.	T	A	3	7	10	0	0	10	0	0
12	35837468	.	C	A	3	7	10	0	0	10	0	0
12	35837499	.	G	C	2	7	9	0	0	9	0	0
12	35837503	.	T	G	2	7	9	0	0	9	0	0
12	35837751	.	G	A	6	5	11	0	0	11	0	0
12	35837828	.	T	A	7	4	11	0	0	11	0	0
12	35837842	.	G	A	8	2	10	0	1	11	0	0
12	35838102	.	A	G	2	2	4	0	0	4	0	0
12	35838537	.	G	C	1	3	4	0	0	4	0	0
12	35838542	.	A	C	1	2	3	0	0	3	0	0
12	35838672	.	C	A	0	5	5	0	1	6	0	0
12	35838683	.	A	G	1	4	5	0	0	5	0	0
12	35839063	.	A	T	1	8	9	0	0	9	0	0
12	35839090	.	C	T	0	3	3	0	2	5	0	0
12	35839159	.	C	T	6	3	9	0	0	9	0	0
12	35839165	.	C	G	5	5	10	0	1	11	0	0
12	35839261	.	C	A	2	10	12	0	0	12	0	0
12	35839680	.	G	A	5	7	12	0	0	12	0	0
12	35839879	.	C	A	0	4	4	0	4	8	0	0
12	35839919	.	C	G	0	0	0	0	3	3	0	0
12	35839942	.	C	T	5	1	6	0	1	7	0	0
12	35840003	.	T	C	2	0	2	0	3	5	0	0
12	35840008	.	C	A	1	2	3	0	1	4	0	0
12	35840717	.	A	G	3	5	8	0	0	8	0	0
12	35840800	.	T	G	2	3	5	0	0	5	0	0
12	35841438	.	G	A	2	3	5	0	0	5	0	0
12	35841457	.	G	A	2	8	10	0	1	11	0	0
12	35841749	.	C	T	0	4	4	0	1	5	0	0
12	35847493	.	A	T	0	1	1	0	0	1	0	0
12	35847535	.	T	C	4	2	6	0	0	6	0	0
12	35847538	.	C	T	4	2	6	0	0	6	0	0
12	35853678	.	A	G	3	2	5	0	1	6	0	0
12	35853693	.	T	C	3	2	5	0	1	6	0	0
12	35853732	.	C	A	0	1	1	0	0	1	0	0
12	35875707	.	A	G	0	2	2	0	0	2	0	0
12	35883704	.	T	C	1	0	1	0	2	3	0	0
12	35963575	.	T	C	6	6	12	0	0	12	0	0
12	35976771	.	C	A	5	0	5	0	1	6	0	0
12	35980632	.	T	C	15	11	26	0	1	27	0	0
12	35980758	.	C	T	19	13	32	0	0	32	0	0
12	35980764	.	T	C	19	12	31	0	0	31	0	0
12	35980817	.	T	A	12	5	17	0	0	17	0	0
12	35981206	.	T	C	13	0	13	0	13	26	0	0
12	35981260	.	T	A	17	12	29	0	1	30	0	0
12	35981303	.	T	G	12	8	20	0	0	20	0	0
12	35981304	.	G	C	12	8	20	0	0	20	0	0
12	35981478	.	A	G	13	8	21	0	1	22	0	0
12	35981627	.	C	T	9	12	21	0	0	21	0	0
12	35981713	.	C	T	1	11	12	0	9	21	0	0
12	35981795	.	T	A	7	12	19	0	0	19	0	0
12	35981832	.	A	G	6	12	18	0	1	19	0	0
12	35988544	.	A	G	0	3	3	0	0	3	0	0
12	35988553	.	G	A	0	3	3	0	1	4	0	0
12	36105341	.	A	G	5	3	8	0	0	8	0	0
12	36105410	.	G	T	2	3	5	0	0	5	0	0
12	36158056	.	A	C	12	10	22	0	1	23	0	0
12	36158098	.	G	C	15	13	28	0	0	28	0	0
12	36158099	.	T	C	12	13	25	0	3	28	0	0
12	36158225	.	T	C	13	18	31	0	0	31	0	0
12	36158349	.	G	A	0	18	18	0	10	28	0	0
12	36158538	.	C	T	5	4	9	0	1	10	0	0
12	36159597	.	C	G	9	10	19	0	0	19	0	0
12	36413894	.	G	T	4	3	7	0	0	7	0	0
12	36413937	.	A	T	2	2	4	0	0	4	0	0
12	36416669	.	T	C	2	0	2	0	0	2	0	0
12	36416675	.	T	C	2	0	2	0	0	2	0	0
12	36416714	.	G	A	0	2	2	0	0	2	0	0
12	36416732	.	G	C	0	1	1	0	1	2	0	0
12	36420141	.	T	C	0	2	2	0	0	2	0	0
12	36422537	.	A	G	2	1	3	0	0	3	0	0
12	36424613	.	G	A	11	4	15	0	0	15	0	0
12	36424618	.	G	A	4	10	14	0	0	14	0	0
12	36452380	.	C	T	1	2	3	0	0	3	0	0
12	36452452	.	T	A	1	3	4	0	1	5	0	0
12	36468999	.	G	T	1	2	3	0	1	4	0	0
12	36670336	.	A	C	0	3	3	0	0	3	0	0
12	36670919	.	T	C	1	2	3	0	1	4	0	0
12	36739638	.	A	G	1	1	2	0	1	3	0	0
12	36739668	.	C	T	2	2	4	0	0	4	0	0
12	36739676	.	A	G	2	1	3	0	0	3	0	0
12	36891583	.	C	T	6	6	12	0	0	12	0	0
12	36895025	.	A	G	10	7	17	0	0	17	0	0
12	36895057	.	T	C	7	6	13	0	0	13	0	0
12	36895067	.	G	A	7	7	14	0	0	14	0	0
12	36952648	.	T	G	0	0	0	0	1	1	0	0
12	36952744	.	C	T	6	3	9	0	1	10	0	0
12	36960197	.	T	C	6	4	10	0	1	11	0	0
12	36960200	.	A	T	6	4	10	0	0	10	0	0
12	37003282	.	C	T	2	3	5	0	0	5	0	0
12	37003291	.	A	G	1	2	3	0	1	4	0	0
12	37003332	.	A	G	1	3	4	0	0	4	0	0
12	37005586	.	A	G	4	0	4	0	3	7	0	0
12	37275601	.	C	T	5	3	8	0	0	8	0	0
12	37275712	.	A	T	2	3	5	0	0	5	0	0
12	37275719	.	G	T	3	3	6	0	0	6	0	0
12	37275898	.	T	C	3	4	7	0	0	7	0	0
12	37275901	.	T	C	4	3	7	0	0	7	0	0
12	37288323	.	T	A	0	1	1	0	0	1	0	0
12	37407249	.	G	T	4	3	7	0	0	7	0	0
12	37407392	.	T	A	10	11	21	0	1	22	0	0
12	37407477	.	T	C	5	8	13	0	0	13	0	0
12	37407524	.	C	A	6	8	14	0	0	14	0	0
12	37407632	.	T	A	8	4	12	0	0	12	0	0
12	37407813	.	C	T	6	10	16	0	0	16	0	0
12	37408206	.	A	G	4	2	6	0	0	6	0	0
12	37408442	.	G	C	4	6	10	0	0	10	0	0
12	37409037	.	C	T	4	4	8	0	0	8	0	0
12	37409269	.	C	T	2	7	9	0	1	10	0	0
12	37409315	.	C	T	0	5	5	0	4	9	0	0
12	37409436	.	C	A	0	3	3	0	3	7	1	0
12	37409481	.	G	A	3	2	5	0	0	5	0	0
12	37409611	.	A	G	3	4	7	0	0	7	0	0
12	37409802	.	C	T	5	6	11	0	0	11	0	0
12	37409836	.	T	G	2	8	10	0	0	10	0	0
12	37410018	.	T	C	3	0	3	0	8	11	0	0
12	37410034	.	C	T	5	7	12	0	0	12	0	0
12	37410111	.	T	C	6	4	10	0	1	11	0	0
12	37410693	.	C	G	1	6	7	0	0	7	0	0
12	37410816	.	A	G	1	5	6	0	0	6	0	0
12	37410966	.	T	C	5	5	10	0	0	10	0	0
12	37411041	.	T	C	3	0	3	0	5	8	0	0
12	37463606	.	T	C	10	0	10	0	7	17	0	0
12	37490224	.	G	T	2	0	2	0	0	2	0	0
12	37497149	.	G	A	3	3	6	0	0	6	0	0
12	37503881	.	G	A	6	4	10	0	1	11	0	0
12	37515112	.	T	C	3	0	3	0	4	7	0	0
12	37530848	.	A	G	3	1	4	0	0	4	0	0
12	37530969	.	T	C	0	1	1	0	0	1	0	0
12	37538183	.	T	G	1	0	1	0	0	1	0	0
12	37552108	.	A	T	2	1	3	0	0	3	0	0
12	38556562	.	G	T	4	3	7	0	0	7	0	0
12	38561258	.	C	A	1	0	1	0	0	1	0	0
12	38563150	.	C	A	1	4	5	0	0	5	0	0
12	38563158	.	C	T	1	3	4	0	0	4	0	0
12	38563347	.	C	G	1	4	5	0	0	5	0	0
12	38655310	.	C	A	0	1	1	0	0	1	0	0
12	38676664	.	C	T	2	0	2	0	0	2	0	0
12	38677076	.	C	T	1	1	2	0	0	2	0	0
12	38680669	.	G	T	0	1	1	0	0	1	0	0
12	38687907	.	T	A	2	2	4	0	0	4	0	0
12	38706412	.	A	G	2	1	3	0	0	3	0	0
12	38787630	.	G	A	4	1	5	0	0	5	0	0
12	38799627	.	C	T	6	2	8	0	0	8	0	0
12	38799678	.	C	G	2	2	4	0	0	4	0	0
12	38799759	.	C	T	2	6	8	0	0	8	0	0
12	38799822	.	A	C	0	1	1	0	1	2	0	0
12	38802875	.	T	C	4	4	8	0	1	9	0	0
12	38803012	.	T	C	9	0	9	0	0	9	0	0
12	38803148	.	T	A	2	2	4	0	1	5	0	0
12	38803411	.	A	G	3	1	4	0	6	10	0	0
12	38803586	.	T	C	2	2	4	0	0	4	0	0
12	38803591	.	T	A	2	3	5	0	0	5	0	0
12	38803633	.	C	T	4	5	9	0	0	9	0	0
12	38803649	.	G	C	4	5	9	0	0	9	0	0
12	38803747	.	T	A	4	2	6	0	0	6	0	0
12	38804166	.	G	T	4	4	8	0	0	8	0	0
12	38804314	.	C	T	2	8	10	0	0	10	0	0
12	38836784	.	T	G	2	0	2	0	3	5	0	0
12	38843587	.	A	G	2	3	5	0	0	5	0	0
12	38849546	.	C	A	4	6	10	0	0	10	0	0
12	38850889	.	C	T	1	1	2	0	0	2	0	0
12	38854919	.	G	T	0	4	4	0	4	8	0	0
12	38855015	.	A	T	3	4	7	0	0	7	0	0
12	38855049	.	G	A	0	3	3	0	4	7	0	0
12	38855255	.	T	C	3	4	7	0	0	7	0	0
12	38855344	.	G	A	0	8	8	0	2	10	0	0
12	38855596	.	T	G	6	0	6	0	4	11	1	0
12	38855601	.	G	A	3	7	10	0	0	10	0	0
12	38855859	.	T	A	2	4	6	0	0	6	0	0
12	39744954	.	G	C	0	4	4	0	5	9	0	0
12	40348899	.	G	T	0	2	2	0	3	5	0	0
12	40348938	.	T	A	0	2	2	0	1	3	0	0
12	40348950	.	C	T	1	2	3	0	0	3	0	0
12	40497143	.	T	C	1	1	2	0	0	2	0	0
12	40518043	.	T	C	5	13	18	0	0	18	0	0
12	40518088	.	C	T	8	7	15	0	0	15	0	0
12	40518094	.	T	C	6	6	12	0	0	12	0	0
12	40905584	.	G	C	0	0	0	0	0	0	0	0
12	40945499	.	G	A	2	2	4	0	0	4	0	0
12	40945980	.	C	T	7	6	13	0	0	13	0	0
12	41000900	.	G	A	0	1	1	0	1	2	0	0
12	41000969	.	A	G	0	1	1	0	3	4	0	0
12	41000993	.	A	C	1	1	2	0	0	2	0	0
12	41028550	.	A	G	5	7	12	0	0	12	0	0
12	41028626	.	G	A	0	3	3	0	2	5	0	0
12	41037024	.	A	C	4	14	18	0	0	18	0	0
12	41071775	.	T	C	2	2	4	0	0	4	0	0
12	41071841	.	T	C	2	3	5	0	1	6	0	0
12	41113007	.	T	C	8	3	11	0	0	11	0	0
12	41113040	.	G	A	6	5	11	0	0	11	0	0
12	41113049	.	C	A	7	6	13	0	0	13	0	0
12	41113313	.	A	T	15	13	28	0	0	28	0	0
12	41113489	.	G	T	0	5	5	0	7	12	0	0
12	41437046	.	G	A	1	5	6	0	0	6	0	0
12	41449931	.	C	T	3	0	3	0	0	3	0	0
12	41455861	.	T	C	1	1	2	0	0	2	0	0
12	41458264	.	G	A	1	0	1	0	0	1	0	0
12	41461321	.	A	T	8	7	15	0	1	16	0	0
12	41535844	.	C	T	6	5	11	0	1	12	0	0
12	41535886	.	A	C	6	13	19	0	1	20	0	0
12	41535898	.	C	T	7	12	19	0	1	20	0	0
12	41535937	.	T	A	6	4	10	0	0	10	0	0
12	41539161	.	C	T	1	3	4	0	0	4	0	0
12	41549214	.	G	A	0	5	5	0	3	8	0	0
12	41549404	.	C	G	3	7	10	0	0	10	0	0
12	41549413	.	G	T	9	6	15	0	0	15	0	0
12	41549476	.	T	C	17	20	37	0	2	39	0	0
12	41581092	.	A	G	7	7	14	0	0	14	0	0
12	41581257	.	A	T	8	9	17	0	0	17	0	0
12	41593093	.	T	A	10	12	22	0	1	23	0	0
12	41606683	.	T	C	3	1	4	0	10	14	0	0
12	41606686	.	G	T	3	10	13	0	0	13	0	0
12	41612061	.	A	G	2	2	4	0	0	4	0	0
12	41632117	.	A	G	4	9	13	0	0	13	0	0
12	41633644	.	C	A	0	8	8	0	5	13	0	0
12	41636655	.	C	T	13	2	15	0	1	16	0	0
12	41636658	.	G	T	13	4	17	0	0	17	0	0
12	41643177	.	T	A	3	4	7	0	0	7	0	0
12	41643178	.	C	T	3	3	6	0	1	7	0	0
12	41643214	.	C	T	3	4	7	0	0	7	0	0
12	41643217	.	G	A	3	4	7	0	0	7	0	0
12	41647312	.	C	T	7	3	10	0	1	11	0	0
12	41653151	.	G	A	6	5	11	0	1	12	0	0
12	41656554	.	G	A	5	6	11	0	0	11	0	0
12	41661349	.	C	T	5	2	7	0	2	9	0	0
12	41684634	.	G	A	9	10	19	0	0	19	0	0
12	41698056	.	G	A	19	19	38	0	1	39	0	0
12	41702044	.	A	C	3	2	5	0	0	5	0	0
12	41723148	.	T	A	6	5	11	0	1	12	0	0
12	41723189	.	G	A	3	3	6	0	0	6	0	0
12	41723310	.	C	T	1	9	10	0	8	18	0	0
12	41723457	.	G	A	12	9	21	0	0	21	0	0
12	41723608	.	T	A	12	13	25	0	0	25	0	0
12	41723747	.	C	T	5	6	11	0	0	11	0	0
12	41731908	.	G	A	2	2	4	0	0	4	0	0
12	41732013	.	C	T	0	3	3	0	3	6	0	0
12	41735790	.	T	C	3	4	7	0	0	7	0	0
12	41739297	.	G	T	4	1	5	0	1	6	0	0
12	41759621	.	A	C	9	0	9	0	7	16	0	0
12	41759669	.	C	T	0	6	6	0	6	12	0	0
12	41991699	.	T	A	1	2	3	0	1	4	0	0
12	41991744	.	T	G	5	4	9	0	0	9	0	0
12	41991796	.	A	C	1	5	6	0	0	6	0	0
12	41991797	.	C	T	1	5	6	0	0	6	0	0
12	41992005	.	A	C	7	4	11	0	0	11	0	0
12	41992094	.	G	A	2	4	6	0	0	6	0	0
12	41992971	.	A	T	4	4	8	0	1	9	0	0
12	42007693	.	A	G	6	0	6	0	6	12	0	0
12	42153216	.	A	G	3	5	8	0	1	9	0	0
12	42182963	.	G	A	1	0	1	0	0	1	0	0
12	42186478	.	A	G	2	4	6	0	1	7	0	0
12	42195697	.	A	T	6	6	12	0	0	12	0	0
12	42196571	.	T	A	4	4	8	0	0	8	0	0
12	42196924	.	A	G	4	3	7	0	0	7	0	0
12	42196933	.	T	G	5	5	10	0	0	10	0	0
12	42197711	.	A	G	2	1	3	0	0	3	0	0
12	42197717	.	G	A	0	2	2	0	2	4	0	0
12	42197759	.	G	A	1	3	4	0	0	4	0	0
12	42366730	.	G	A	1	1	2	0	0	2	0	0
12	42366732	.	T	G	1	1	2	0	0	2	0	0
12	42369685	.	C	T	0	11	11	0	6	17	0	0
12	42369848	.	G	A	10	5	15	0	0	15	0	0
12	42369912	.	A	G	14	9	23	0	0	23	0	0
12	42384900	.	G	T	5	12	17	0	0	17	0	0
12	42384924	.	T	C	1	0	1	0	5	6	0	0
12	42396909	.	T	C	0	0	0	0	1	1	0	0
12	42400348	.	T	C	1	3	4	0	0	4	0	0
12	42405963	.	T	G	2	2	4	0	0	4	0	0
12	42406178	.	C	T	4	2	6	0	0	6	0	0
12	42406237	.	G	A	2	2	4	0	0	4	0	0
12	42407038	.	A	T	2	2	4	0	0	4	0	0
12	42576815	.	C	T	13	13	26	0	2	28	0	0
12	42577187	.	C	T	8	13	21	0	1	22	0	0
12	42578117	.	A	T	6	6	12	0	0	12	0	0
12	42578505	.	A	T	21	12	33	0	2	35	0	0
12	42578698	.	A	G	2	0	2	0	9	11	0	0
12	42578958	.	A	G	3	4	7	0	1	8	0	0
12	42578996	.	T	A	7	8	15	0	3	18	0	0
12	43376709	.	C	T	0	10	10	0	13	23	0	0
12	43376960	.	A	T	8	6	14	0	0	14	0	0
12	43377049	.	G	T	2	4	6	0	0	6	0	0
12	43377281	.	G	C	7	8	15	0	3	18	0	0
12	43377505	.	A	T	11	4	15	0	1	16	0	0
12	43384921	.	G	A	6	3	9	0	0	9	0	0
12	43391390	.	T	C	0	0	0	0	3	3	0	0
12	43395597	.	G	A	8	7	15	0	1	16	0	0
12	43395955	.	A	G	2	4	6	0	0	6	0	0
12	43426072	.	A	G	7	2	9	0	0	9	0	0
12	44368836	.	C	G	1	2	3	0	0	3	0	0
12	44394996	.	G	C	1	0	1	0	1	2	0	0
12	44611138	.	A	G	2	0	2	0	4	6	0	0
12	44611693	.	C	T	1	2	3	0	1	4	0	0
12	44611771	.	C	T	1	3	4	0	0	4	0	0
12	44611943	.	G	A	0	6	6	0	4	10	0	0
12	44611963	.	G	A	0	4	4	0	5	9	0	0
12	45339637	.	T	C	2	2	4	0	0	4	0	0
12	47044800	.	A	T	3	2	5	0	1	6	0	0
12	47241738	.	G	A	1	6	7	0	0	7	0	0
12	47282104	.	G	A	0	4	4	0	4	8	0	0
12	47283506	.	C	T	0	1	1	0	0	1	0	0
12	47283514	.	A	G	0	1	1	0	0	1	0	0
12	47283544	.	G	C	2	2	4	0	0	4	0	0
12	47291529	.	G	C	0	3	3	0	5	8	0	0
12	47291703	.	G	A	9	7	16	0	2	18	0	0
12	47295523	.	C	T	4	6	10	0	1	11	0	0
12	47295939	.	C	T	2	4	6	0	0	6	0	0
12	47302828	.	C	T	1	2	3	0	0	3	0	0
12	47302831	.	G	A	1	2	3	0	0	3	0	0
12	47331864	.	C	T	7	16	23	0	0	23	0	0
12	47332185	.	A	G	7	15	22	0	0	22	0	0
12	47332326	.	C	A	13	14	27	0	0	27	0	0
12	47332389	.	G	A	11	16	27	0	1	28	0	0
12	47332575	.	A	G	7	18	25	0	0	25	0	0
12	47332635	.	G	A	7	13	20	0	2	22	0	0
12	47332827	.	C	T	18	11	29	0	0	29	0	0
12	47335257	.	C	T	10	11	21	0	1	22	0	0
12	47335472	.	C	T	3	2	5	0	0	5	0	0
12	47344423	.	T	C	22	13	35	0	0	35	0	0
12	47347875	.	C	T	4	6	10	0	0	10	0	0
12	47448986	.	C	T	12	8	20	0	1	21	0	0
12	47449121	.	G	A	1	5	6	0	2	8	0	0
12	47449481	.	C	T	7	13	20	0	1	21	0	0
12	47449784	.	A	G	11	0	11	0	6	17	0	0
12	47449886	.	T	C	4	8	12	1	1	14	0	0
12	47449997	.	G	A	14	13	27	0	1	28	0	0
12	47461255	.	G	A	4	3	7	0	0	7	0	0
12	47469850	.	G	C	4	3	7	0	0	7	0	0
12	47480299	.	A	C	1	3	4	0	0	4	0	0
12	47480404	.	G	A	7	7	14	0	0	14	0	0
12	47480434	.	A	G	3	1	4	0	6	10	0	0
12	47480469	.	A	T	3	5	8	0	3	11	0	0
12	47480536	.	A	C	9	13	22	0	0	22	0	0
12	47480565	.	T	A	9	13	22	0	1	23	0	0
12	47480728	.	A	G	8	0	8	0	27	35	0	0
12	47480731	.	T	A	15	11	26	0	10	36	0	0
12	47481112	.	T	G	11	16	27	0	0	27	0	0
12	47481229	.	G	C	0	5	5	0	4	9	0	0
12	47481611	.	G	A	6	5	11	0	2	13	0	0
12	47505208	.	G	A	2	2	4	0	0	4	0	0
12	47510101	.	T	C	3	9	12	0	0	12	0	0
12	47523795	.	A	C	8	8	16	0	0	16	0	0
12	47540933	.	T	C	21	23	44	0	4	48	0	0
12	47540934	.	C	T	22	24	46	0	2	48	0	0
12	47540999	.	A	C	12	16	28	0	2	30	0	0
12	47544222	.	T	C	1	0	1	0	3	4	0	0
12	47544354	.	C	A	0	2	2	0	5	7	0	0
12	47544543	.	A	G	3	1	4	0	0	4	0	0
12	47593373	.	G	A	1	5	6	0	1	7	0	0
12	47862041	.	C	T	5	3	8	0	2	10	0	0
12	47862047	.	T	C	3	5	8	0	2	10	0	0
12	47918804	.	G	A	0	3	3	0	6	9	0	0
12	47919665	.	C	T	1	1	2	0	0	2	0	0
12	47922396	.	C	T	2	1	3	0	0	3	0	0
12	47967799	.	C	A	0	2	2	0	1	3	0	0
12	47967825	.	C	A	2	2	4	0	0	4	0	0
12	47967906	.	C	A	1	2	3	0	0	3	0	0
12	47968031	.	G	A	1	4	5	0	0	5	0	0
12	48094399	.	A	T	3	4	7	0	0	7	0	0
12	48118470	.	A	C	2	2	4	0	1	5	0	0
12	48118598	.	A	T	2	3	5	0	0	5	0	0
12	48119934	.	C	T	3	2	5	0	0	5	0	0
12	48119941	.	A	G	4	2	6	0	0	6	0	0
12	48122025	.	T	C	2	2	4	0	0	4	0	0
12	48122232	.	C	T	0	0	0	0	2	2	0	0
12	48133239	.	G	A	6	7	13	0	0	13	0	0
12	48137949	.	G	A	5	3	8	0	0	8	0	0
12	48143336	.	G	A	2	2	4	0	1	5	0	0
12	48143427	.	C	T	2	1	3	0	1	4	0	0
12	48146371	.	C	T	1	0	1	0	0	1	0	0
12	48146841	.	C	T	0	2	2	0	1	3	0	0
12	48146880	.	C	T	0	1	1	0	1	2	0	0
12	48157055	.	C	T	0	2	2	0	2	4	0	0
12	48157135	.	G	A	7	1	8	0	1	9	0	0
12	48161625	.	C	T	3	1	4	0	1	5	0	0
12	48162237	.	G	A	2	3	5	0	0	5	0	0
12	48162291	.	T	A	0	3	3	0	0	3	0	0
12	48168094	.	G	A	3	4	7	0	0	7	0	0
12	48211621	.	A	G	2	2	4	0	0	4	0	0
12	48216789	.	A	T	0	1	1	0	0	1	0	0
12	48220624	.	C	G	1	10	11	0	0	11	0	0
12	48231039	.	G	A	0	4	4	0	4	8	0	0
12	48231108	.	G	T	4	10	14	0	1	15	0	0
12	48240061	.	A	C	3	2	5	0	1	6	0	0
12	48307327	.	G	A	0	1	1	0	0	1	0	0
12	48327550	.	T	G	10	10	20	0	0	20	0	0
12	48340578	.	G	A	5	4	9	0	1	10	0	0
12	48341936	.	G	A	0	12	12	0	13	25	0	0
12	48346807	.	C	T	4	2	6	0	0	6	0	0
12	48349836	.	C	T	0	4	4	0	4	8	0	0
12	48367442	.	T	G	2	0	2	0	0	2	0	0
12	48390888	.	C	G	0	1	1	0	0	1	0	0
12	48419281	.	G	C	4	6	10	0	0	10	0	0
12	48419507	.	C	T	3	3	6	0	0	6	0	0
12	48419520	.	T	A	3	4	7	0	0	7	0	0
12	48419568	.	T	G	3	3	6	0	0	6	0	0
12	48419579	.	A	T	4	2	6	0	0	6	0	0
12	48419645	.	A	C	1	2	3	0	0	3	0	0
12	48419867	.	C	T	1	5	6	0	4	10	0	0
12	48420640	.	A	G	1	0	1	0	0	1	0	0
12	48436863	.	T	C	0	0	0	0	4	4	0	0
12	48440328	.	A	G	4	2	6	0	0	6	0	0
12	48440345	.	A	G	1	3	4	0	0	4	0	0
12	48453909	.	G	A	0	1	1	0	0	1	0	0
12	48457823	.	G	A	0	1	1	0	0	1	0	0
12	48465570	.	G	A	1	2	3	0	0	3	0	0
12	48469825	.	C	T	19	14	33	0	1	34	0	0
12	48476965	.	A	T	18	14	32	0	0	32	0	0
12	48476995	.	T	C	14	0	14	0	9	23	0	0
12	48480740	.	G	A	7	6	13	0	0	13	0	0
12	48511751	.	C	T	0	1	1	0	0	1	0	0
12	48522778	.	C	T	1	2	3	0	0	3	0	0
12	48525046	.	G	A	0	3	3	0	0	3	0	0
12	48529757	.	C	T	6	11	17	0	1	18	0	0
12	48532581	.	A	G	4	5	9	0	1	10	0	0
12	48549015	.	A	G	0	2	2	0	0	2	0	0
12	48606722	.	C	A	0	2	2	0	0	2	0	0
12	48611667	.	C	T	1	3	4	0	0	4	0	0
12	48611740	.	C	T	1	2	3	0	0	3	0	0
12	48623030	.	C	A	4	6	10	0	1	11	0	0
12	48625938	.	T	G	1	5	6	0	0	6	0	0
12	48680110	.	C	G	1	1	2	0	1	3	0	0
12	48680163	.	A	T	2	1	3	0	0	3	0	0
12	48681826	.	A	T	10	8	18	0	0	18	0	0
12	48681827	.	T	A	8	8	16	0	2	18	0	0
12	48682002	.	A	G	5	7	12	0	0	12	0	0
12	48682530	.	G	C	3	4	7	0	0	7	0	0
12	48790801	.	C	T	2	4	6	0	0	6	0	0
12	48790802	.	C	T	2	4	6	0	0	6	0	0
12	48792426	.	G	A	2	4	6	0	0	6	0	0
12	48796831	.	C	T	1	6	7	0	0	7	0	0
12	48799261	.	C	T	4	11	15	0	0	15	0	0
12	48800725	.	G	A	1	2	3	0	0	3	0	0
12	48803126	.	G	C	8	6	14	0	1	15	0	0
12	48810338	.	C	T	2	2	4	0	0	4	0	0
12	48810557	.	G	T	0	15	15	0	11	26	0	0
12	48810558	.	C	T	10	16	26	0	0	26	0	0
12	48810865	.	C	T	6	8	14	0	0	14	0	0
12	48811035	.	T	C	13	7	20	0	0	20	0	0
12	48826364	.	C	T	0	1	1	0	1	2	0	0
12	48826626	.	G	A	7	3	10	0	0	10	0	0
12	48828350	.	C	T	0	1	1	0	0	1	0	0
12	48828356	.	C	G	2	0	2	0	0	2	0	0
12	48828431	.	G	A	0	6	6	0	7	13	0	0
12	48828461	.	C	T	2	1	3	0	2	5	0	0
12	48828467	.	G	A	0	2	2	0	2	4	0	0
12	48829379	.	T	C	3	1	4	0	0	4	0	0
12	48829397	.	T	C	1	3	4	0	0	4	0	0
12	48832417	.	C	A	2	5	7	0	1	8	0	0
12	48833090	.	T	C	1	2	3	0	0	3	0	0
12	48833165	.	C	T	1	3	4	0	0	4	0	0
12	48836348	.	A	G	14	8	22	0	0	22	0	0
12	48836482	.	G	A	19	15	34	0	0	34	0	0
12	48851450	.	G	A	0	3	3	0	1	4	0	0
12	48851480	.	C	A	1	2	3	0	0	3	0	0
12	48852772	.	G	A	0	1	1	0	1	2	0	0
12	48852885	.	G	T	1	1	2	0	1	3	0	0
12	48862730	.	T	C	1	0	1	0	0	1	0	0
12	48864422	.	G	T	0	2	2	0	2	4	0	0
12	48864536	.	A	G	2	0	2	0	2	4	0	0
12	48864581	.	G	A	0	2	2	0	6	8	0	0
12	48866840	.	G	A	0	4	4	0	4	8	0	0
12	48867178	.	A	G	0	1	1	0	0	1	0	0
12	48909987	.	G	A	0	1	1	0	0	1	0	0
12	48959393	.	A	G	1	4	5	0	0	5	0	0
12	48959630	.	G	A	3	3	6	0	0	6	0	0
12	48975613	.	G	A	0	2	2	0	2	4	0	0
12	48979161	.	T	C	6	0	6	0	7	13	0	0
12	48979219	.	T	C	5	0	5	0	5	10	0	0
12	48979234	.	T	C	1	0	1	0	6	7	0	0
12	48979256	.	G	T	3	1	4	0	2	6	0	0
12	48979362	.	A	C	8	0	8	0	4	12	0	0
12	48979609	.	C	T	0	6	6	0	8	14	0	0
12	48979648	.	C	T	3	1	4	0	1	5	0	0
12	48982536	.	T	C	2	1	3	0	3	6	0	0
12	48982539	.	C	T	0	4	4	0	3	7	0	0
12	48984334	.	T	C	1	0	1	0	3	4	0	0
12	48988614	.	C	T	1	1	2	0	0	2	0	0
12	49004058	.	C	T	0	11	11	0	6	17	0	0
12	49004071	.	C	T	0	8	8	0	2	10	0	0
12	49005119	.	G	T	7	8	15	0	0	15	0	0
12	49005150	.	T	C	3	4	7	0	0	7	0	0
12	49008358	.	G	T	2	2	4	0	0	4	0	0
12	49034603	.	C	T	7	4	11	0	0	11	0	0
12	49035182	.	G	A	0	10	10	0	2	12	0	0
12	49035269	.	C	T	2	2	4	0	0	4	0	0
12	49037523	.	G	C	0	3	3	0	6	9	0	0
12	49037568	.	G	A	0	2	2	0	7	9	0	0
12	49114550	.	G	T	0	14	14	0	15	29	0	0
12	49125593	.	G	A	0	2	2	0	1	3	0	0
12	49125898	.	C	T	2	2	4	0	0	4	0	0
12	49125949	.	A	G	2	1	3	0	0	3	0	0
12	49148399	.	A	G	0	3	3	0	1	4	0	0
12	49158990	.	G	A	0	2	2	0	0	2	0	0
12	49160120	.	G	A	0	1	1	0	1	2	0	0
12	49166926	.	C	T	9	12	21	0	0	21	0	0
13	10935	.	C	T	7	5	12	0	1	13	0	0
13	11043	.	G	C	8	6	14	0	1	15	0	0
13	12252	.	C	G	3	2	5	0	0	5	0	0
13	40868	.	A	T	4	9	13	0	0	13	0	0
13	40965	.	T	G	6	13	19	0	0	19	0	0
13	41161	.	C	T	0	2	2	0	3	5	0	0
13	41529	.	A	G	1	3	4	0	0	4	0	0
13	42080	.	T	C	1	0	1	0	6	7	0	0
13	42123	.	C	T	4	2	6	0	0	6	0	0
13	42182	.	C	G	1	7	8	0	0	8	0	0
13	42771	.	C	T	2	4	6	0	0	6	0	0
13	42870	.	T	C	2	0	2	0	3	5	0	0
13	46625	.	T	C	11	1	12	0	11	23	0	0
13	46637	.	G	A	12	12	24	0	0	24	0	0
13	49070	.	T	G	4	9	13	0	1	14	0	0
13	111860	.	A	C	0	0	0	0	6	6	0	0
13	214111	.	C	G	7	7	14	0	0	14	0	0
13	216562	.	A	G	10	16	26	0	1	27	0	0
13	217848	.	A	C	7	7	14	0	1	15	0	0
13	220842	.	T	C	12	1	13	0	17	30	0	0
13	220874	.	T	A	14	23	37	0	1	38	0	0
13	221131	.	C	A	14	18	32	0	1	33	0	0
13	221478	.	G	C	28	13	41	0	1	42	0	0
13	226047	.	G	C	3	2	5	0	0	5	0	0
13	237954	.	T	C	2	5	7	0	0	7	0	0
13	269861	.	C	T	0	6	6	0	5	11	0	0
13	270083	.	G	A	8	14	22	0	0	22	0	0
13	270110	.	C	T	0	11	11	0	17	28	0	0
13	271736	.	G	A	1	3	4	0	0	4	0	0
13	271802	.	A	G	2	2	4	0	0	4	0	0
13	280692	.	T	C	9	5	14	0	1	15	0	0
13	281330	.	T	C	19	25	44	0	1	45	0	0
13	281405	.	T	G	22	2	24	0	21	45	0	0
13	321752	.	C	T	0	2	2	0	0	2	0	0
13	322033	.	G	A	1	0	1	0	0	1	0	0
13	325797	.	G	A	6	4	10	0	0	10	0	0
13	326210	.	G	C	5	2	7	0	0	7	0	0
13	329876	.	C	T	10	11	21	0	1	22	0	0
13	329922	.	G	A	11	5	16	0	0	16	0	0
13	343336	.	G	T	19	7	26	0	0	26	0	0
13	343363	.	T	C	20	1	21	0	5	26	0	0
13	343510	.	C	T	0	10	10	0	13	23	0	0
13	343581	.	C	G	0	3	3	0	8	11	0	0
13	343604	.	C	T	2	2	4	0	0	4	0	0
13	353503	.	C	A	3	2	5	0	1	6	0	0
13	353686	.	C	T	7	9	16	0	2	18	0	0
13	353728	.	A	C	0	0	0	0	4	4	0	0
13	356834	.	C	G	0	5	5	0	9	14	0	0
13	357664	.	G	C	6	0	6	0	5	11	0	0
13	360461	.	C	T	0	2	2	0	3	5	0	0
13	372410	.	A	G	0	2	2	0	0	2	0	0
13	372421	.	A	G	0	1	1	0	0	1	0	0
13	421350	.	G	T	0	14	14	0	17	31	0	0
13	422990	.	T	C	2	2	4	0	0	4	0	0
13	425044	.	G	C	7	9	16	0	0	16	0	0
13	425063	.	C	T	8	4	12	0	0	12	0	0
13	425087	.	C	T	4	1	5	0	1	6	0	0
13	428646	.	G	A	9	5	14	0	1	15	0	0
13	428766	.	C	T	10	13	23	0	0	23	0	0
13	428841	.	C	T	19	12	31	0	1	32	0	0
13	429087	.	C	T	15	20	35	0	0	35	0	0
13	429144	.	A	G	16	0	16	0	22	38	0	0
13	429429	.	A	G	17	0	17	0	16	33	0	0
13	429514	.	C	T	19	9	28	0	1	29	0	0
13	429846	.	C	A	18	14	32	0	2	34	0	0
13	450040	.	C	T	1	5	6	0	8	14	0	0
13	450101	.	C	T	11	8	19	0	6	25	0	0
13	452598	.	C	A	5	7	12	0	0	12	0	0
13	452615	.	G	T	9	5	14	0	1	15	0	0
13	454846	.	C	A	0	8	8	0	5	13	0	0
13	454919	.	A	G	6	5	11	0	0	11	0	0
13	455473	.	G	A	4	8	12	0	0	12	0	0
13	456637	.	G	A	4	2	6	0	0	6	0	0
13	458513	.	G	A	3	2	5	0	1	6	0	0
13	460740	.	T	C	3	0	3	0	1	4	0	0
13	460821	.	C	T	0	6	6	0	6	12	0	0
13	460845	.	C	T	4	4	8	0	1	9	0	0
13	460875	.	G	A	2	1	3	0	0	3	0	0
13	462904	.	T	G	5	6	11	0	1	12	0	0
13	465196	.	G	A	1	2	3	0	0	3	0	0
13	465329	.	T	A	2	3	5	0	0	5	0	0
13	465535	.	C	T	0	4	4	0	2	6	0	0
13	465538	.	C	A	0	3	3	0	2	5	0	0
13	465607	.	G	A	3	1	4	0	0	4	0	0
13	467509	.	G	A	3	1	4	0	0	4	0	0
13	468054	.	G	A	0	2	2	0	1	3	0	0
13	473448	.	G	A	3	3	6	0	0	6	0	0
13	473466	.	T	G	2	2	4	0	0	4	0	0
13	473593	.	A	G	2	4	6	0	0	6	0	0
13	478386	.	C	T	1	0	1	0	1	2	0	0
13	478485	.	G	A	1	3	4	0	0	4	0	0
13	479049	.	G	A	3	1	4	0	1	5	0	0
13	479061	.	G	A	4	3	7	0	0	7	0	0
13	483021	.	A	G	10	11	21	0	1	22	0	0
13	489773	.	T	C	8	4	12	0	1	13	0	0
13	490479	.	C	G	12	0	12	0	12	24	0	0
13	514385	.	C	T	17	17	34	0	0	34	0	0
13	514664	.	G	A	9	6	15	0	2	17	0	0
13	514790	.	T	A	4	3	7	0	0	7	0	0
13	517163	.	G	T	1	5	6	0	0	6	0	0
13	518113	.	T	C	2	0	2	0	2	4	0	0
13	518915	.	G	A	2	2	4	0	0	4	0	0
13	522036	.	G	T	0	1	1	0	1	2	0	0
13	527832	.	C	T	1	0	1	0	0	1	0	0
13	529348	.	T	C	2	0	2	0	4	6	0	0
13	533133	.	T	A	2	3	5	0	0	5	0	0
13	543275	.	T	C	1	1	2	0	0	2	0	0
13	545531	.	C	A	2	2	4	0	0	4	0	0
13	555325	.	C	T	13	22	35	0	0	35	0	0
13	555326	.	G	A	20	11	31	0	4	35	0	0
13	555835	.	C	T	15	3	18	1	0	19	0	0
13	555880	.	A	T	9	9	18	0	0	18	0	0
13	555889	.	T	C	9	10	19	0	0	19	0	0
13	556397	.	T	C	7	13	20	0	1	21	0	0
13	556398	.	T	C	7	13	20	0	1	21	0	0
13	556572	.	A	G	10	8	18	0	1	19	0	0
13	556601	.	A	T	8	7	15	0	1	16	0	0
13	556658	.	C	A	2	6	8	0	0	8	0	0
13	556729	.	G	T	7	10	17	0	2	20	1	0
13	561575	.	T	A	1	1	2	0	0	2	0	0
13	561587	.	A	T	3	0	3	0	2	5	0	0
13	562966	.	C	T	0	2	2	0	3	5	0	0
13	563089	.	G	A	7	8	15	0	0	15	0	0
13	563116	.	G	A	7	5	12	0	0	12	0	0
13	565622	.	C	T	0	4	4	0	7	11	0	0
13	565660	.	G	A	0	2	2	0	0	2	0	0
13	566019	.	G	A	3	3	6	0	0	6	0	0
13	566046	.	G	A	3	4	7	0	0	7	0	0
13	566569	.	G	A	9	7	16	0	0	16	0	0
13	566604	.	T	C	7	0	7	0	8	15	0	0
13	575046	.	T	C	2	0	2	0	1	3	0	0
13	592473	.	G	A	1	1	2	0	0	2	0	0
13	615213	.	C	T	0	0	0	0	1	1	0	0
13	638303	.	C	A	6	5	11	0	0	11	0	0
13	654791	.	G	A	2	3	5	0	0	5	0	0
13	654857	.	C	T	6	2	8	0	0	8	0	0
13	655932	.	G	A	0	1	1	0	2	3	0	0
13	658429	.	G	T	0	3	3	0	1	4	0	0
13	658872	.	C	T	4	5	9	0	2	11	0	0
13	660254	.	C	T	1	4	5	0	0	5	0	0
13	662635	.	C	A	1	12	13	0	0	13	0	0
13	662727	.	G	A	1	3	4	0	1	5	0	0
13	663532	.	T	A	5	9	14	0	0	14	0	0
13	663573	.	G	A	0	8	8	0	2	10	0	0
13	663719	.	C	T	6	2	8	0	0	8	0	0
13	663752	.	A	G	4	0	4	0	6	10	0	0
13	663791	.	A	T	2	5	7	0	0	7	0	0
13	663920	.	A	T	17	3	20	1	2	23	0	0
13	664012	.	G	A	2	5	7	0	0	7	0	0
13	664139	.	C	T	6	2	8	0	0	8	0	0
13	664143	.	C	T	6	2	8	0	0	8	0	0
13	664196	.	A	G	0	0	0	0	8	8	0	0
13	664307	.	G	A	3	2	5	0	0	5	0	0
13	675139	.	C	A	1	2	3	0	0	3	0	0
13	677282	.	G	A	0	0	0	0	1	1	0	0
13	677454	.	T	C	7	3	10	0	1	11	0	0
13	677838	.	T	G	5	0	5	0	4	9	0	0
13	706679	.	C	G	2	5	7	0	0	7	0	0
13	706687	.	C	A	2	4	6	0	0	6	0	0
13	709673	.	C	T	3	1	4	0	0	4	0	0
13	714117	.	C	G	2	5	7	0	0	7	0	0
13	718183	.	T	C	2	3	5	0	0	5	0	0
13	719316	.	C	T	4	4	8	0	0	8	0	0
13	719334	.	C	G	1	2	3	0	1	4	0	0
13	721290	.	C	T	5	5	10	0	0	10	0	0
13	721332	.	G	A	10	12	22	0	0	22	0	0
13	721617	.	C	T	2	5	7	0	0	7	0	0
13	724060	.	A	G	4	0	4	0	6	10	0	0
13	724194	.	A	G	4	2	6	0	0	6	0	0
13	724249	.	C	T	0	2	2	0	0	2	0	0
13	748105	.	T	C	1	3	4	0	0	4	0	0
13	748129	.	G	T	0	3	3	0	2	5	0	0
13	751302	.	C	T	3	1	4	0	0	4	0	0
13	760241	.	G	T	6	2	8	0	0	8	0	0
13	760298	.	C	T	5	3	8	0	0	8	0	0
13	760472	.	C	A	4	0	4	0	0	4	0	0
13	761063	.	T	C	1	0	1	0	0	1	0	0
13	761135	.	C	T	6	4	10	0	0	10	0	0
13	761228	.	A	T	2	0	2	0	0	2	0	0
13	763754	.	G	T	0	2	2	0	1	3	0	0
13	785074	.	T	G	6	7	13	0	2	15	0	0
13	793529	.	G	C	0	2	2	0	2	4	0	0
13	793631	.	C	T	5	1	6	0	0	6	0	0
13	802925	.	C	T	3	6	9	0	0	9	0	0
13	807998	.	G	A	0	3	3	0	3	6	0	0
13	808333	.	A	G	4	4	8	0	0	8	0	0
13	808530	.	A	C	7	11	18	0	0	18	0	0
13	808638	.	G	A	6	5	11	0	0	11	0	0
13	808648	.	G	A	5	5	10	0	0	10	0	0
13	809140	.	A	G	2	0	2	0	1	3	0	0
13	809357	.	G	C	0	4	4	0	0	4	0	0
13	809369	.	G	T	5	4	9	0	0	9	0	0
13	809615	.	G	T	4	6	10	0	1	11	0	0
13	809620	.	T	C	7	4	11	0	0	11	0	0
13	809779	.	A	G	3	8	11	0	1	12	0	0
13	809808	.	A	G	6	4	10	0	0	10	0	0
13	809992	.	C	T	4	5	9	0	1	10	0	0
13	810008	.	G	C	5	4	9	0	0	9	0	0
13	810120	.	T	G	2	2	4	0	0	4	0	0
13	810158	.	A	G	1	0	1	0	5	6	0	0
13	810621	.	C	T	1	4	5	0	0	5	0	0
13	814038	.	G	A	7	7	14	0	1	15	0	0
13	814191	.	G	C	3	7	10	0	0	10	0	0
13	814290	.	G	C	5	6	11	0	1	12	0	0
13	814459	.	G	A	6	6	12	0	0	12	0	0
13	814501	.	T	C	6	4	10	0	0	10	0	0
13	814719	.	G	A	8	4	12	0	0	12	0	0
13	817238	.	G	A	3	6	9	0	0	9	0	0
13	821506	.	A	G	3	3	6	0	0	6	0	0
13	824485	.	T	C	8	0	8	0	8	16	0	0
13	826134	.	A	G	11	15	26	0	0	26	0	0
13	849291	.	T	C	4	4	8	0	0	8	0	0
13	854419	.	G	A	2	2	4	0	0	4	0	0
13	854458	.	T	C	2	2	4	0	0	4	0	0
13	854588	.	A	C	3	1	4	0	4	8	0	0
13	854627	.	G	A	3	7	10	0	0	10	0	0
13	912171	.	A	G	12	15	27	0	3	30	0	0
13	912212	.	C	T	11	15	26	0	0	26	0	0
13	950859	.	T	C	9	10	19	0	0	19	0	0
13	957336	.	A	C	16	15	31	0	1	32	0	0
13	977619	.	A	G	14	14	28	0	0	28	0	0
13	1025011	.	G	A	0	3	3	0	0	3	0	0
13	1090246	.	T	C	1	5	6	0	0	6	0	0
13	1096496	.	G	A	1	0	1	0	2	3	0	0
13	1115091	.	C	T	17	13	30	1	2	33	0	0
13	1115106	.	C	T	13	10	23	1	0	24	0	0
13	1120353	.	C	T	7	1	8	0	0	32	24	0
13	1125197	.	C	T	4	4	8	0	0	8	0	0
13	1125199	.	C	A	4	2	6	0	2	8	0	0
13	1125292	.	T	A	13	4	17	0	1	19	1	0
13	1125331	.	G	C	14	9	23	0	1	24	0	0
13	1125410	.	T	C	3	0	3	0	0	3	0	0
13	1129255	.	G	C	5	5	10	0	1	11	0	0
13	1129261	.	T	C	4	4	8	0	1	9	0	0
13	1129902	.	T	C	14	22	36	0	1	37	0	0
13	1135581	.	G	A	0	0	0	0	1	1	0	0
13	1135584	.	A	C	0	1	1	0	0	1	0	0
13	1137974	.	T	C	4	2	6	0	0	6	0	0
13	1138282	.	T	G	1	0	1	0	0	1	0	0
13	1138357	.	C	T	4	4	8	0	0	8	0	0
13	1139908	.	A	C	1	6	7	0	0	7	0	0
13	1140590	.	T	C	2	11	13	0	2	15	0	0
13	1140591	.	G	T	0	3	3	0	11	15	1	0
13	1140659	.	C	G	4	6	10	0	1	11	0	0
13	1140941	.	C	T	6	2	8	0	1	9	0	0
13	1140987	.	G	T	3	3	6	0	0	6	0	0
13	1140992	.	C	T	1	3	4	0	1	5	0	0
13	1142775	.	G	C	9	5	14	0	0	14	0	0
13	1142839	.	C	A	0	8	8	0	12	20	0	0
13	1142841	.	T	A	8	6	14	0	6	20	0	0
13	1142918	.	G	A	22	9	31	0	3	34	0	0
13	1146062	.	A	G	2	4	6	0	0	6	0	0
13	1146101	.	C	T	11	22	33	0	0	33	0	0
13	1149953	.	T	C	3	0	3	0	0	3	0	0
13	1167932	.	A	C	6	7	13	0	1	14	0	0
13	1167984	.	A	G	6	11	17	0	1	18	0	0
13	1168540	.	G	A	5	5	10	0	1	11	0	0
13	1168567	.	A	T	5	3	8	0	0	8	0	0
13	1168905	.	T	C	5	4	9	2	0	11	0	0
13	1169280	.	A	G	1	3	4	0	1	5	0	0
13	1169539	.	T	C	1	4	5	0	0	5	0	0
13	1169695	.	G	A	4	7	11	0	2	13	0	0
13	1169735	.	C	T	3	2	5	0	0	5	0	0
13	1170418	.	T	G	5	0	5	0	3	8	0	0
13	1197086	.	T	C	1	0	1	0	0	1	0	0
13	1197218	.	G	A	1	2	3	0	0	3	0	0
13	1205879	.	C	T	1	2	3	0	0	3	0	0
13	1208354	.	C	T	2	4	6	0	1	7	0	0
13	1307133	.	A	G	1	2	3	0	0	3	0	0
13	1345893	.	C	T	0	1	1	0	0	1	0	0
13	1368987	.	T	G	1	0	1	0	4	5	0	0
13	1370728	.	G	A	0	0	0	0	1	1	0	0
13	1374455	.	T	C	6	2	8	0	0	8	0	0
13	1374773	.	T	C	4	4	8	0	1	9	0	0
13	1382002	.	C	A	1	3	4	0	0	4	0	0
13	1382019	.	C	T	3	4	7	0	0	7	0	0
13	1382148	.	G	C	0	7	7	0	3	10	0	0
13	1382298	.	A	T	1	0	1	0	1	2	0	0
13	1394582	.	G	C	2	4	6	0	0	6	0	0
13	1394941	.	G	A	6	2	8	0	2	10	0	0
13	1394978	.	A	G	9	2	11	0	0	11	0	0
13	1415315	.	C	G	0	13	13	0	3	16	0	0
13	1415511	.	A	T	9	10	19	0	0	19	0	0
13	1415598	.	A	C	4	0	4	0	17	21	0	0
13	1416074	.	C	A	9	10	19	0	0	19	0	0
13	1416098	.	G	A	9	7	16	0	0	16	0	0
13	1418932	.	G	A	4	4	8	0	0	8	0	0
13	1421302	.	T	C	5	0	5	0	8	13	0	0
13	1421341	.	T	C	1	0	1	0	2	3	0	0
13	1422111	.	G	A	4	3	7	0	1	8	0	0
13	1423520	.	G	A	3	1	4	0	1	5	0	0
13	1423568	.	G	A	0	4	4	0	0	4	0	0
13	1425462	.	T	G	1	0	1	0	0	1	0	0
13	1430246	.	T	A	1	1	2	0	0	2	0	0
13	1515796	.	C	T	1	2	3	0	0	3	0	0
13	1525565	.	C	T	1	2	3	0	0	3	0	0
13	1532751	.	C	T	4	5	9	0	0	9	0	0
13	1540688	.	C	T	0	5	5	0	1	6	0	0
13	1540707	.	C	A	0	5	5	0	0	5	0	0
13	1540956	.	G	A	0	3	3	0	3	6	0	0
13	1540974	.	C	G	6	2	8	0	0	8	0	0
13	1542592	.	A	T	6	2	8	0	0	8	0	0
13	1542630	.	T	C	2	6	8	0	0	8	0	0
13	1542763	.	G	T	0	1	1	0	0	1	0	0
13	1543833	.	A	C	6	2	8	0	0	8	0	0
13	1577695	.	T	C	2	1	3	0	0	3	0	0
13	1577716	.	A	G	3	2	5	0	0	5	0	0
13	1577746	.	A	T	4	7	11	0	0	11	0	0
13	1577755	.	A	G	5	4	9	0	2	11	0	0
13	1577896	.	G	A	5	4	9	0	1	10	0	0
13	1577904	.	C	T	6	4	10	0	0	10	0	0
13	1577997	.	T	A	8	5	13	0	0	13	0	0
13	1585203	.	C	T	1	2	3	0	0	3	0	0
13	1585679	.	G	A	4	4	8	0	0	8	0	0
13	1588052	.	A	G	6	0	6	0	9	15	0	0
13	1588073	.	T	C	5	12	17	0	1	18	0	0
13	1590235	.	G	A	0	2	2	0	5	7	0	0
13	1592342	.	G	A	5	5	10	0	0	10	0	0
13	1592362	.	G	A	4	4	8	0	1	9	0	0
13	1592401	.	A	G	2	1	3	0	0	3	0	0
13	1592710	.	A	G	4	0	4	0	1	5	0	0
13	1595642	.	G	A	0	2	2	0	6	8	0	0
13	1595749	.	T	C	2	7	9	0	0	9	0	0
13	1595898	.	A	G	8	6	14	0	1	15	0	0
13	1595938	.	A	G	4	5	9	0	1	10	0	0
13	1599692	.	A	G	10	10	20	0	2	22	0	0
13	1599825	.	G	T	0	8	8	0	7	15	0	0
13	1599977	.	A	C	0	8	8	0	0	8	0	0
13	1600001	.	G	T	3	3	6	0	0	6	0	0
13	1600264	.	T	A	10	6	16	0	2	18	0	0
13	1600582	.	G	T	0	8	8	0	10	18	0	0
13	1627605	.	G	A	4	3	7	0	0	7	0	0
13	1632106	.	G	A	10	7	17	0	0	17	0	0
13	1634479	.	A	G	17	9	26	0	0	26	0	0
13	1641762	.	C	T	7	6	13	0	0	13	0	0
13	1641827	.	A	G	5	6	11	0	0	11	0	0
13	1643933	.	C	T	3	2	5	0	1	6	0	0
13	1648470	.	G	A	6	7	13	0	1	14	0	0
13	1649725	.	C	T	12	6	18	0	0	18	0	0
13	1650683	.	A	G	6	11	17	0	1	18	0	0
13	1650938	.	G	C	3	11	14	0	0	14	0	0
13	1651706	.	A	G	4	0	4	0	4	8	0	0
13	1651727	.	C	T	0	1	1	0	0	1	0	0
13	1655426	.	T	C	6	5	11	0	0	11	0	0
13	1655767	.	T	C	1	3	4	0	0	4	0	0
13	1655905	.	G	A	10	6	16	0	0	16	0	0
13	1661740	.	A	G	3	1	4	0	0	4	0	0
13	1666388	.	A	G	6	0	6	0	9	15	0	0
13	1666412	.	A	G	3	0	3	0	6	9	0	0
13	1667865	.	T	A	10	12	22	0	2	24	0	0
13	1676895	.	G	A	0	10	10	0	10	20	0	0
13	1677009	.	G	T	1	2	3	0	2	5	0	0
13	1677859	.	G	T	6	0	6	0	0	6	0	0
13	1677913	.	C	T	17	8	25	0	0	25	0	0
13	1677958	.	A	G	9	0	9	0	6	15	0	0
13	1682856	.	T	C	7	8	15	0	0	15	0	0
13	1682910	.	C	G	7	0	7	0	10	17	0	0
13	1682928	.	C	G	6	6	12	0	0	12	0	0
13	1685150	.	G	C	8	12	20	0	1	22	1	0
13	1685192	.	A	T	12	7	19	0	1	20	0	0
13	1691983	.	T	A	2	2	4	0	0	4	0	0
13	1693284	.	G	A	0	8	8	0	13	21	0	0
13	1693312	.	C	A	17	12	29	0	0	29	0	0
13	1693386	.	C	T	7	2	9	0	0	9	0	0
13	1693392	.	C	T	6	0	6	0	1	7	0	0
13	1694395	.	C	A	15	15	30	0	0	30	0	0
13	1694417	.	C	A	10	15	25	0	1	26	0	0
13	1707294	.	T	C	1	0	1	0	0	1	0	0
13	1714981	.	T	C	0	2	2	0	0	2	0	0
13	1719777	.	G	A	0	24	24	0	18	42	0	0
13	1904124	.	C	T	1	2	3	0	0	3	0	0
13	1981596	.	G	A	4	3	7	0	1	8	0	0
13	2029314	.	T	C	1	3	4	0	0	4	0	0
13	2254461	.	T	A	2	4	6	0	0	6	0	0
13	2254607	.	A	T	6	2	8	0	0	8	0	0
13	2254638	.	T	C	1	1	2	0	0	2	0	0
13	2254668	.	A	C	1	0	1	0	0	4	3	0
13	2254751	.	T	A	2	4	6	0	1	7	0	0
13	2254753	.	G	C	3	0	3	0	4	7	0	0
13	2255417	.	A	G	2	0	2	0	0	2	0	0
13	2262128	.	C	A	2	5	7	0	0	7	0	0
13	2357775	.	G	C	2	10	12	0	0	12	0	0
13	2358026	.	A	T	5	6	11	0	0	11	0	0
13	2366936	.	G	A	6	7	13	0	1	14	0	0
13	2370529	.	G	T	0	8	8	0	4	12	0	0
13	2375550	.	G	A	0	2	2	0	2	4	0	0
13	2382376	.	A	G	3	0	3	0	2	5	0	0
13	2384958	.	A	G	2	4	6	0	0	6	0	0
13	2385782	.	G	T	0	6	6	0	8	14	0	0
13	2385812	.	G	A	4	7	11	0	1	12	0	0
13	2392342	.	G	A	2	7	9	0	0	9	0	0
13	2392434	.	G	A	4	3	7	0	2	9	0	0
13	2392459	.	A	G	6	0	6	0	7	13	0	0
13	2410987	.	C	T	1	1	2	0	0	2	0	0
13	2414234	.	C	T	0	1	1	0	0	1	0	0
13	2416172	.	T	C	5	5	10	0	0	10	0	0
13	2416221	.	G	A	6	5	11	0	0	11	0	0
13	2416401	.	A	T	3	2	5	0	0	5	0	0
13	2416710	.	C	A	4	3	7	0	1	8	0	0
13	2416711	.	G	A	0	4	4	0	4	8	0	0
13	2416764	.	A	T	6	4	10	0	1	11	0	0
13	2416807	.	A	G	4	4	8	0	0	8	0	0
13	2416904	.	A	C	1	3	4	0	2	6	0	0
13	2416987	.	A	G	0	5	5	0	0	5	0	0
13	2417060	.	G	A	4	2	6	0	1	7	0	0
13	2417331	.	A	T	2	3	5	0	0	5	0	0
13	2427244	.	T	C	6	2	8	0	0	8	0	0
13	2427251	.	T	A	0	6	6	0	0	6	0	0
13	2427522	.	A	G	4	10	14	0	0	14	0	0
13	2429080	.	C	A	24	22	46	0	1	47	0	0
13	2429300	.	A	G	4	5	9	0	0	9	0	0
13	2434335	.	G	T	9	14	23	0	0	23	0	0
13	2454381	.	C	T	0	1	1	0	0	1	0	0
13	2455523	.	G	A	0	1	1	0	0	1	0	0
13	2460689	.	G	A	0	5	5	0	3	8	0	0
13	2460704	.	A	G	3	5	8	0	0	8	0	0
13	2460991	.	G	A	0	7	7	0	2	9	0	0
13	2461033	.	C	G	2	0	2	0	4	6	0	0
13	2464113	.	T	G	0	3	3	0	0	3	0	0
13	2464167	.	G	A	0	0	0	0	1	1	0	0
13	2468007	.	G	C	0	0	0	0	2	2	0	0
13	2468013	.	C	T	2	0	2	0	0	2	0	0
13	2468052	.	G	T	1	3	4	0	0	4	0	0
13	2473421	.	G	A	5	2	7	0	1	8	0	0
13	2473487	.	T	C	2	2	4	0	0	4	0	0
13	2477812	.	C	T	1	5	6	0	0	6	0	0
13	2480678	.	T	C	1	0	1	0	0	1	0	0
13	2483134	.	A	G	2	1	3	0	1	4	0	0
13	2492930	.	G	A	0	2	2	0	1	3	0	0
13	2495872	.	C	T	5	9	14	0	2	16	0	0
13	2496334	.	C	T	5	6	11	0	0	11	0	0
13	2496496	.	T	A	0	3	3	0	0	3	0	0
13	2520778	.	G	A	3	2	5	0	0	5	0	0
13	2520834	.	C	T	12	6	18	0	2	20	0	0
13	2746350	.	A	G	9	0	9	0	9	18	0	0
13	2764899	.	C	T	0	3	3	0	0	3	0	0
13	2766946	.	A	G	1	0	1	0	1	2	0	0
13	2769810	.	T	C	1	1	2	0	0	2	0	0
13	2807099	.	A	C	7	3	10	0	0	10	0	0
13	2814352	.	G	A	8	7	15	0	0	15	0	0
13	2814421	.	T	C	1	3	4	0	0	4	0	0
13	2826254	.	A	T	11	5	16	0	3	19	0	0
13	2826324	.	A	G	14	0	14	0	22	36	0	0
13	2826397	.	T	C	10	11	21	0	1	22	0	0
13	2826473	.	T	A	22	6	28	0	1	29	0	0
13	2826684	.	T	C	17	5	22	0	0	22	0	0
13	2826690	.	C	A	16	5	21	0	0	21	0	0
13	2827560	.	A	C	9	10	19	0	1	20	0	0
13	2827578	.	C	A	8	10	18	0	2	20	0	0
13	2827670	.	C	T	11	6	17	0	1	18	0	0
13	2827700	.	G	C	13	12	25	0	0	25	0	0
13	2827832	.	G	T	17	7	24	0	1	25	0	0
13	2827844	.	T	C	14	7	21	0	1	22	0	0
13	2827998	.	G	A	11	9	20	0	0	20	0	0
13	2828040	.	C	G	10	8	18	0	0	18	0	0
13	2828062	.	C	A	12	8	20	0	0	20	0	0
13	2901620	.	G	A	2	5	7	0	0	7	0	0
13	2901630	.	C	A	2	4	6	0	2	8	0	0
13	2913822	.	C	T	13	10	23	0	1	24	0	0
13	2913844	.	T	C	6	9	15	0	1	16	0	0
13	2927676	.	C	T	1	4	5	0	5	10	0	0
13	2927778	.	G	A	3	14	17	0	2	19	0	0
13	2932666	.	G	C	1	1	2	0	0	2	0	0
13	3109186	.	C	A	3	2	5	0	0	5	0	0
13	3109224	.	T	C	3	1	4	0	1	5	0	0
13	3125577	.	A	G	0	0	0	0	1	1	0	0
13	3127930	.	G	A	6	2	8	0	1	9	0	0
13	3128038	.	T	C	6	0	6	0	5	11	0	0
13	3133582	.	T	A	1	2	3	0	0	3	0	0
13	3133588	.	G	A	1	2	3	0	0	3	0	0
13	3154846	.	T	C	2	2	4	0	1	5	0	0
13	3155005	.	C	T	3	2	5	0	0	5	0	0
13	3263932	.	T	C	2	0	2	0	7	9	0	0
13	3263990	.	G	A	2	4	6	0	0	6	0	0
13	3264012	.	G	A	1	7	8	0	1	9	0	0
13	3264063	.	G	C	3	0	3	0	10	13	0	0
13	3264323	.	C	A	6	7	13	0	0	13	0	0
13	3264406	.	C	T	3	3	6	0	0	6	0	0
13	3264467	.	C	A	2	3	5	0	2	7	0	0
13	3270110	.	C	T	0	0	0	0	2	2	0	0
13	3270123	.	A	G	1	1	2	0	0	2	0	0
13	3278079	.	A	G	2	3	5	0	0	5	0	0
13	3279588	.	C	T	0	2	2	0	6	8	0	0
13	3279591	.	G	A	5	3	8	0	0	8	0	0
13	3282127	.	T	C	1	1	2	0	1	3	0	0
13	3283761	.	A	G	2	3	5	0	0	5	0	0
13	3284780	.	C	T	0	2	2	0	2	4	0	0
13	3287096	.	C	T	0	3	3	0	1	4	0	0
13	3289513	.	T	C	3	1	4	0	0	4	0	0
13	3299514	.	C	G	1	2	3	0	0	3	0	0
13	3302783	.	G	T	1	3	4	0	0	4	0	0
13	3354930	.	C	T	2	5	7	0	0	7	0	0
13	3420158	.	G	T	4	2	6	0	0	6	0	0
13	3423584	.	A	T	0	1	1	0	0	1	0	0
13	3423585	.	T	G	0	1	1	0	0	1	0	0
13	3474211	.	G	C	0	0	0	0	1	1	0	0
13	3474261	.	A	C	1	2	3	0	0	3	0	0
13	3474304	.	C	T	2	2	4	0	0	4	0	0
13	3474310	.	C	T	0	2	2	0	2	4	0	0
13	3826346	.	G	A	0	3	3	0	1	4	0	0
13	3826354	.	A	T	1	2	3	0	1	4	0	0
13	3832618	.	A	C	4	3	7	0	0	7	0	0
13	3874427	.	A	G	2	6	8	0	1	9	0	0
13	3874618	.	T	C	6	4	10	0	0	10	0	0
13	3874815	.	T	C	4	0	4	0	3	7	0	0
13	3874831	.	T	C	4	2	6	0	0	6	0	0
13	3874903	.	C	A	0	4	4	0	4	8	0	0
13	3874909	.	G	A	3	4	7	0	0	7	0	0
13	3874983	.	A	G	2	3	5	0	0	5	0	0
13	3881204	.	T	C	0	6	6	1	0	7	0	0
13	3881208	.	G	T	0	6	6	1	0	7	0	0
13	3887163	.	A	G	0	0	0	0	1	1	0	0
13	3915333	.	A	G	0	5	5	0	1	6	0	0
13	3915383	.	C	A	6	6	12	0	1	13	0	0
13	3915476	.	A	C	12	8	20	0	0	20	0	0
13	3915644	.	A	C	24	7	31	0	0	31	0	0
13	3915981	.	C	T	0	7	7	0	15	22	0	0
13	3919353	.	T	G	15	11	26	0	1	27	0	0
13	3919632	.	A	G	18	16	34	0	0	35	1	0
13	3919672	.	T	G	9	12	21	0	0	21	0	0
13	3919686	.	G	A	9	13	22	0	0	22	0	0
13	3920727	.	A	G	0	1	1	0	0	1	0	0
13	3920759	.	C	T	0	1	1	0	0	1	0	0
13	3922791	.	T	C	1	2	3	0	0	3	0	0
13	3926166	.	C	T	3	4	7	0	0	7	0	0
13	3927916	.	T	C	1	0	1	0	1	2	0	0
13	3927931	.	T	C	4	0	4	0	0	4	0	0
13	3927975	.	T	A	8	1	9	0	0	9	0	0
13	3942055	.	G	A	0	15	15	0	7	22	0	0
13	3945643	.	C	T	10	6	16	0	0	16	0	0
13	3950007	.	G	A	12	8	20	0	0	20	0	0
13	3950044	.	A	G	13	12	25	0	1	26	0	0
13	3950307	.	A	G	7	7	14	0	1	15	0	0
13	3950577	.	C	G	8	11	19	0	3	22	0	0
13	3950669	.	T	A	4	6	10	0	2	12	0	0
13	3954695	.	G	T	6	4	10	0	0	10	0	0
13	3958895	.	C	T	5	1	6	0	0	6	0	0
13	3958913	.	A	G	3	0	3	0	0	3	0	0
13	3960979	.	A	C	3	2	5	0	0	5	0	0
13	3962812	.	T	C	8	3	11	0	0	11	0	0
13	3980349	.	C	T	0	4	4	0	6	10	0	0
13	3980947	.	T	C	14	0	14	0	8	22	0	0
13	3980962	.	G	A	12	7	19	0	0	19	0	0
13	3980993	.	C	T	0	8	8	0	8	16	0	0
13	3981579	.	G	T	6	3	9	0	1	10	0	0
13	3981832	.	T	A	1	2	3	0	0	3	0	0
13	3982429	.	A	G	3	3	6	0	0	6	0	0
13	3982679	.	A	G	2	2	4	0	0	4	0	0
13	3983561	.	G	A	2	2	4	0	0	4	0	0
13	3983811	.	C	T	1	2	3	0	1	4	0	0
13	4213477	.	C	A	3	8	11	0	2	13	0	0
13	4213594	.	G	T	8	8	16	0	1	17	0	0
13	4213598	.	C	T	8	7	15	0	1	16	0	0
13	4213861	.	T	C	8	16	24	0	1	25	0	0
13	4226678	.	C	A	17	9	26	0	0	26	0	0
13	4231368	.	G	T	0	18	18	0	24	42	0	0
13	4231396	.	C	T	20	12	32	0	2	34	0	0
13	4231438	.	T	A	13	9	22	0	1	23	0	0
13	4231643	.	T	A	10	14	24	0	0	24	0	0
13	4231652	.	A	G	4	22	26	0	0	26	0	0
13	4231701	.	A	G	26	9	35	0	1	36	0	0
13	4231787	.	A	G	8	9	17	0	0	17	0	0
13	4231819	.	G	A	13	10	23	0	2	25	0	0
13	4231954	.	T	A	14	4	18	0	2	20	0	0
13	4232014	.	T	A	6	10	16	0	2	18	0	0
13	4232016	.	G	A	1	8	9	0	9	18	0	0
13	4232054	.	A	T	17	5	22	0	0	22	0	0
13	4232112	.	A	G	13	12	25	0	0	25	0	0
13	4232171	.	C	T	9	18	27	0	1	28	0	0
13	4232737	.	A	G	13	9	22	0	1	23	0	0
13	4233030	.	C	T	0	14	14	0	14	28	0	0
13	4233033	.	G	A	15	13	28	0	0	28	0	0
13	4233361	.	G	T	9	9	18	0	0	18	0	0
13	4233365	.	G	A	8	11	19	0	0	19	0	0
13	4233625	.	T	A	6	10	16	0	1	17	0	0
13	4233779	.	G	A	13	10	23	0	1	24	0	0
13	4233889	.	G	A	9	6	15	0	0	15	0	0
13	4233911	.	G	C	8	3	11	0	2	13	0	0
13	4233970	.	A	G	14	6	20	0	0	20	0	0
13	4234139	.	A	T	5	7	12	3	0	15	0	0
13	4234337	.	G	A	12	7	19	0	0	19	0	0
13	4234349	.	G	T	6	11	17	0	0	17	0	0
13	4234402	.	A	T	6	12	18	0	3	21	0	0
13	4238449	.	T	C	6	3	9	0	0	9	0	0
13	4247007	.	G	A	1	2	3	0	0	3	0	0
13	4256617	.	A	G	2	4	6	0	0	6	0	0
13	4302690	.	A	T	2	1	3	0	0	3	0	0
13	4307782	.	C	T	10	13	23	0	0	23	0	0
13	4308714	.	C	A	10	13	23	0	1	24	0	0
13	4308948	.	C	T	6	8	14	0	1	15	0	0
13	4308983	.	G	C	8	0	8	0	15	23	0	0
13	4309166	.	T	G	8	11	19	0	0	19	0	0
13	4309866	.	T	C	4	8	12	0	0	12	0	0
13	4310247	.	G	A	10	9	19	0	0	19	0	0
13	4310349	.	T	A	10	18	28	0	4	32	0	0
13	4310367	.	C	G	0	15	15	0	17	32	0	0
13	4310511	.	C	T	1	18	19	0	20	39	0	0
13	4310565	.	G	A	15	20	35	0	1	36	0	0
13	4310610	.	C	T	18	12	30	0	4	34	0	0
13	4310976	.	T	C	9	0	9	0	6	15	0	0
13	4311114	.	A	G	11	12	23	0	1	24	0	0
13	4311912	.	C	T	5	2	7	0	1	8	0	0
13	4314226	.	T	G	3	3	6	0	0	6	0	0
13	4314227	.	C	T	3	3	6	0	0	6	0	0
13	4317721	.	T	C	3	5	8	0	0	8	0	0
13	4320781	.	G	C	2	6	8	0	1	9	0	0
13	4325443	.	C	G	4	9	13	0	0	13	0	0
13	4330240	.	G	A	1	2	3	0	0	3	0	0
13	4332807	.	G	A	1	2	3	0	0	3	0	0
13	4332851	.	T	G	3	5	8	0	4	12	0	0
13	4333087	.	T	G	3	7	10	0	0	10	0	0
13	4339139	.	A	C	5	4	9	0	0	9	0	0
13	4339638	.	T	C	8	0	8	0	9	17	0	0
13	4343183	.	C	T	0	7	7	0	7	14	0	0
13	4343437	.	C	T	0	7	7	0	6	13	0	0
13	4343468	.	T	A	6	5	11	0	3	14	0	0
13	4343490	.	G	A	7	5	12	0	0	12	0	0
13	4344100	.	C	G	3	4	7	0	0	7	0	0
13	4344378	.	A	T	5	5	10	0	0	10	0	0
13	4344800	.	T	C	2	2	4	0	0	4	0	0
13	4344872	.	G	C	5	4	9	0	0	9	0	0
13	4344938	.	T	C	3	9	12	0	0	12	0	0
13	4347474	.	T	G	5	3	8	0	0	8	0	0
13	4347531	.	T	C	2	3	5	0	0	5	0	0
13	4349830	.	G	T	2	0	2	0	0	2	0	0
13	4354596	.	T	A	0	1	1	0	0	1	0	0
13	4361847	.	A	G	4	2	6	0	0	6	0	0
13	4366480	.	A	C	2	2	4	0	0	4	0	0
13	4366538	.	A	G	2	3	5	0	1	6	0	0
13	4366805	.	T	C	2	3	5	0	0	5	0	0
13	4399667	.	G	A	11	7	18	0	0	18	0	0
13	4399702	.	G	A	13	13	26	0	1	27	0	0
13	4399786	.	T	C	9	8	17	0	2	19	0	0
13	4400065	.	A	G	0	2	2	0	0	2	0	0
13	4400392	.	A	T	7	6	13	0	1	14	0	0
13	4400421	.	C	T	11	6	17	0	0	17	0	0
13	4400488	.	T	C	2	3	5	0	0	5	0	0
13	4400609	.	T	G	0	2	2	0	0	2	0	0
13	4400698	.	A	T	4	5	9	0	0	9	0	0
13	4400704	.	T	A	3	5	8	0	0	8	0	0
13	4406090	.	T	A	17	18	35	0	1	36	0	0
13	4406271	.	A	C	24	12	36	0	2	38	0	0
13	4406280	.	T	G	26	13	39	0	3	42	0	0
13	4406338	.	A	G	14	21	35	0	3	38	0	0
13	4505134	.	T	G	1	3	4	0	0	4	0	0
13	4505143	.	T	C	2	2	4	0	0	4	0	0
13	4606072	.	T	A	0	1	1	0	0	1	0	0
13	4613672	.	T	C	0	1	1	0	0	1	0	0
13	4613690	.	G	A	0	1	1	0	0	1	0	0
13	4615169	.	T	C	0	2	2	0	0	2	0	0
13	4657403	.	C	T	1	2	3	0	0	3	0	0
13	4657671	.	A	G	9	0	9	0	0	9	0	0
13	4657721	.	G	C	9	5	14	0	0	14	0	0
13	4663375	.	G	A	1	2	3	0	0	3	0	0
13	4663402	.	C	T	4	3	7	0	0	7	0	0
13	4712874	.	G	A	5	6	11	0	0	11	0	0
13	4713152	.	G	C	5	12	17	0	0	17	0	0
13	4713254	.	G	A	2	5	7	0	0	7	0	0
13	4713748	.	T	C	3	2	5	0	0	5	0	0
13	4713761	.	T	C	3	0	3	0	3	6	0	0
13	4729051	.	C	A	1	0	1	0	0	1	0	0
13	4872079	.	G	A	12	5	17	0	0	17	0	0
13	4888273	.	G	A	1	17	18	0	14	32	0	0
13	4945774	.	T	A	6	8	14	0	0	14	0	0
13	4945804	.	C	T	4	6	10	0	0	10	0	0
13	4948345	.	G	A	3	2	5	0	0	5	0	0
13	4951747	.	T	C	14	18	32	0	1	33	0	0
13	4956151	.	C	T	3	8	11	0	0	11	0	0
13	4968727	.	G	A	12	13	25	0	0	25	0	0
13	4968819	.	T	A	10	8	18	0	1	19	0	0
13	4968905	.	T	C	10	15	25	0	3	28	0	0
13	4969003	.	A	G	10	15	25	0	4	29	0	0
13	4969380	.	A	G	2	17	19	0	2	21	0	0
13	4973775	.	C	A	3	6	9	0	0	9	0	0
13	4973979	.	A	G	3	6	9	0	0	9	0	0
13	4977950	.	C	T	0	0	0	0	2	2	0	0
13	4977962	.	A	G	2	0	2	0	0	2	0	0
13	4978770	.	G	A	8	9	17	0	0	17	0	0
13	4978773	.	G	A	7	9	16	0	1	17	0	0
13	4979471	.	T	C	7	5	12	0	2	14	0	0
13	4982336	.	T	C	2	6	8	0	0	8	0	0
13	4982348	.	T	C	2	9	11	0	0	11	0	0
13	4992360	.	A	C	3	2	5	0	0	5	0	0
13	4995574	.	T	C	23	8	31	0	1	32	0	0
13	4995788	.	C	T	20	12	32	0	0	32	0	0
13	4995902	.	A	G	5	9	14	0	1	15	0	0
13	4995916	.	T	A	1	7	8	0	0	8	0	0
13	5000560	.	A	G	9	5	14	0	0	14	0	0
13	5000606	.	G	A	4	4	8	0	0	8	0	0
13	5000615	.	T	A	2	1	3	0	2	5	0	0
13	5004996	.	C	T	26	16	42	0	0	42	0	0
13	5013671	.	A	G	6	14	20	0	2	22	0	0
13	5013813	.	T	C	2	2	4	0	0	4	0	0
13	5013999	.	A	G	10	13	23	0	0	23	0	0
13	5016700	.	G	A	23	23	46	0	1	47	0	0
13	5017657	.	A	C	4	24	28	0	2	30	0	0
13	5017680	.	G	A	10	30	40	0	1	41	0	0
13	5017699	.	G	A	11	30	41	0	3	44	0	0
13	5017866	.	T	C	0	1	1	0	0	1	0	0
13	5025842	.	G	T	1	24	25	0	16	41	0	0
13	5025938	.	A	G	8	0	8	0	13	21	0	0
13	5026062	.	A	G	4	2	6	0	0	6	0	0
13	5026131	.	C	T	24	26	50	0	4	54	0	0
13	5028224	.	T	G	12	14	26	0	0	26	0	0
13	5028471	.	T	G	27	32	59	0	1	60	0	0
13	5028499	.	A	T	21	31	52	0	3	55	0	0
13	5028538	.	T	G	18	20	38	0	9	47	0	0
13	5028711	.	C	T	27	31	58	0	1	59	0	0
13	5028751	.	T	C	35	25	60	0	0	60	0	0
13	5028802	.	T	C	24	24	48	0	2	50	0	0
13	5028912	.	C	T	20	21	41	0	1	42	0	0
13	5071499	.	T	C	3	2	5	0	0	5	0	0
13	5245016	.	A	G	1	2	3	0	0	3	0	0
13	5251237	.	G	A	4	2	6	0	0	6	0	0
13	5870703	.	C	G	2	3	5	0	0	5	0	0
13	5871084	.	C	A	6	4	10	0	0	10	0	0
13	5871145	.	C	G	4	3	7	0	0	7	0	0
13	5871196	.	T	C	3	4	7	0	0	7	0	0
13	5871211	.	A	G	2	4	6	0	0	6	0	0
13	5871538	.	A	G	3	2	5	0	1	6	0	0
13	5871834	.	C	T	0	3	3	0	1	4	0	0
13	5872126	.	G	A	2	4	6	0	1	7	0	0
13	5872300	.	G	A	3	2	5	0	0	5	0	0
13	5872354	.	T	C	4	2	6	0	1	7	0	0
13	5872355	.	T	C	3	0	3	0	4	7	0	0
13	5872596	.	G	C	7	9	16	0	0	16	0	0
13	5872704	.	A	G	2	1	3	0	0	3	0	0
13	5872717	.	A	G	2	0	2	0	0	2	0	0
13	5936742	.	A	T	4	3	7	0	0	7	0	0
13	5936945	.	T	G	4	8	12	0	1	13	0	0
13	5953766	.	G	C	1	3	4	0	1	5	0	0
13	5974373	.	C	G	1	1	2	0	0	2	0	0
13	5978865	.	T	C	1	3	4	0	0	4	0	0
13	5978871	.	A	G	1	0	1	0	3	4	0	0
13	5979677	.	C	T	2	1	3	0	0	3	0	0
13	5985772	.	A	G	1	5	6	0	0	6	0	0
13	5987702	.	T	C	13	6	19	0	1	20	0	0
13	5987712	.	A	G	10	8	18	0	3	21	0	0
13	5999159	.	G	A	1	1	2	0	0	2	0	0
13	6089577	.	C	A	2	2	4	0	0	4	0	0
13	6089587	.	C	T	0	2	2	0	0	2	0	0
13	6089744	.	A	G	2	0	2	0	3	5	0	0
13	6089983	.	A	G	2	0	2	0	1	3	0	0
13	6091985	.	T	C	2	0	2	0	0	2	0	0
13	6092064	.	G	A	2	2	4	0	1	5	0	0
13	6092065	.	A	C	2	3	5	0	0	5	0	0
13	6092108	.	C	G	1	2	3	0	0	3	0	0
13	6099153	.	G	C	0	1	1	0	0	1	0	0
13	6270984	.	C	T	1	0	1	0	0	1	0	0
13	6271347	.	A	G	0	1	1	0	0	1	0	0
13	7049278	.	C	T	3	3	6	0	0	6	0	0
13	7049357	.	G	A	0	4	4	0	3	7	0	0
13	7061413	.	G	A	3	2	5	0	0	5	0	0
13	7063463	.	G	A	8	2	10	0	1	11	0	0
13	7063644	.	C	T	6	7	13	0	1	14	0	0
13	7063757	.	C	G	9	5	14	0	0	14	0	0
13	7107142	.	T	G	0	1	1	0	0	1	0	0
13	7149716	.	C	T	2	3	5	0	0	5	0	0
13	7169891	.	C	T	2	3	5	0	0	5	0	0
13	7191815	.	C	A	1	2	3	0	0	3	0	0
13	7243610	.	C	G	0	0	0	0	2	2	0	0
13	7251052	.	G	A	3	0	3	0	0	3	0	0
13	7251061	.	G	C	5	1	6	0	0	6	0	0
13	7304711	.	T	C	1	0	1	0	0	1	0	0
13	7305802	.	G	A	0	2	2	0	2	4	0	0
13	7306144	.	T	A	4	3	7	0	0	7	0	0
13	7307382	.	A	C	3	4	7	0	0	7	0	0
13	7307512	.	T	C	3	3	6	0	0	6	0	0
13	7307701	.	T	C	5	3	8	0	0	8	0	0
13	7309073	.	C	T	3	2	5	0	0	5	0	0
13	7309140	.	T	C	3	4	7	0	0	7	0	0
13	7310288	.	A	G	6	4	10	0	0	10	0	0
13	7311101	.	G	A	2	5	7	0	0	7	0	0
13	7311133	.	C	T	4	4	8	0	0	8	0	0
13	7311263	.	G	A	0	3	3	0	4	7	0	0
13	7311327	.	A	C	1	4	5	0	0	5	0	0
13	7312372	.	G	T	7	4	11	0	1	12	0	0
13	7312931	.	A	G	4	6	10	0	0	10	0	0
13	7313418	.	G	C	7	5	12	0	0	12	0	0
13	7313443	.	A	T	3	6	9	0	1	10	0	0
13	7313898	.	C	T	6	9	15	0	0	15	0	0
13	7314080	.	G	A	9	7	16	0	1	17	0	0
13	7314222	.	A	T	12	7	19	0	0	19	0	0
13	7314451	.	A	G	6	1	7	0	6	13	0	0
13	7314509	.	C	T	4	10	14	0	0	14	0	0
13	7314567	.	C	A	7	12	19	0	1	20	0	0
13	7314568	.	T	G	8	12	20	0	0	20	0	0
13	7314823	.	C	T	11	11	22	0	1	23	0	0
13	7314856	.	G	A	10	7	17	0	2	19	0	0
13	7315015	.	C	T	17	12	29	0	0	29	0	0
13	7315098	.	T	C	16	14	30	0	1	31	0	0
13	7315234	.	A	G	21	15	36	0	1	37	0	0
13	7315424	.	G	A	0	8	8	0	18	26	0	0
13	7316558	.	G	T	2	7	9	0	0	9	0	0
13	7316603	.	A	T	2	3	5	0	0	5	0	0
13	7316746	.	A	G	2	3	5	0	14	19	0	0
13	7333342	.	G	T	2	0	2	0	0	2	0	0
13	7339931	.	G	C	0	1	1	0	4	5	0	0
13	7346864	.	A	G	20	6	26	0	1	27	0	0
13	7346965	.	A	G	14	4	18	0	0	18	0	0
13	7346966	.	A	T	14	4	18	0	0	18	0	0
13	7557062	.	T	G	2	2	4	0	1	5	0	0
13	7651854	.	G	A	0	0	0	0	1	1	0	0
13	7693225	.	T	A	2	2	4	0	0	4	0	0
13	7693615	.	A	C	0	1	1	0	0	1	0	0
13	7696509	.	C	T	3	3	6	0	0	6	0	0
13	7696575	.	C	T	1	1	2	0	0	2	0	0
13	7698480	.	C	T	3	2	5	0	0	5	0	0
13	7703468	.	T	C	1	4	5	0	0	5	0	0
13	7703470	.	A	T	1	3	4	0	1	5	0	0
13	7711335	.	G	T	3	2	5	0	0	5	0	0
13	7725965	.	C	T	12	3	15	0	0	15	0	0
13	7728958	.	C	T	4	4	8	0	0	8	0	0
13	7744319	.	A	G	2	2	4	0	0	4	0	0
13	7744443	.	G	A	0	1	1	0	0	1	0	0
13	7744624	.	T	G	10	15	25	0	0	25	0	0
13	7745372	.	G	A	0	2	2	0	5	7	0	0
13	7745378	.	G	T	0	4	4	0	2	6	0	0
13	7745463	.	C	G	2	8	10	0	1	11	0	0
13	7747513	.	C	G	4	6	10	0	0	10	0	0
13	7747760	.	T	C	3	15	18	0	0	18	0	0
13	7747831	.	T	G	14	10	24	0	0	24	0	0
13	7748021	.	G	T	9	4	13	0	0	13	0	0
13	7748164	.	A	G	9	0	9	0	9	18	0	0
13	7748218	.	T	C	5	7	12	0	0	12	0	0
13	7748424	.	T	C	2	2	4	0	0	4	0	0
13	7748497	.	T	G	3	4	7	0	0	7	0	0
13	7748533	.	T	G	5	7	12	0	2	14	0	0
13	7748882	.	A	T	12	13	25	0	0	25	0	0
13	7748995	.	T	A	5	11	16	0	0	16	0	0
13	7749000	.	G	C	5	10	15	0	1	16	0	0
13	7755764	.	A	C	1	0	1	0	2	3	0	0
13	7759403	.	T	C	12	11	23	0	0	23	0	0
13	7766936	.	C	T	0	14	14	0	21	35	0	0
13	7767013	.	C	T	4	4	8	0	0	8	0	0
13	8142558	.	A	G	3	2	5	0	0	5	0	0
13	8277628	.	C	T	0	3	3	0	1	4	0	0
13	8281669	.	C	A	1	2	3	0	0	3	0	0
13	8281717	.	C	G	2	3	5	0	0	5	0	0
13	8281876	.	G	T	2	2	4	0	0	4	0	0
13	8281882	.	T	G	1	3	4	0	0	4	0	0
13	8285256	.	T	A	2	7	9	0	1	10	0	0
13	8285430	.	G	A	2	4	6	0	0	6	0	0
13	8285559	.	G	A	3	2	5	0	0	5	0	0
13	8296499	.	G	A	1	1	2	0	0	2	0	0
13	8296502	.	G	A	1	1	2	0	0	2	0	0
13	8317953	.	G	A	1	2	3	0	0	3	0	0
13	8320575	.	G	A	1	2	3	0	0	3	0	0
13	8320631	.	T	C	5	2	7	0	0	7	0	0
13	8320785	.	G	A	1	6	7	0	0	7	0	0
13	8323740	.	A	C	3	2	5	0	0	5	0	0
13	8333500	.	C	T	0	3	3	0	0	3	0	0
13	8333864	.	G	A	1	6	7	0	0	7	0	0
13	8340044	.	G	T	1	2	3	0	0	3	0	0
13	8340182	.	G	T	0	1	1	0	0	1	0	0
13	8348161	.	G	A	1	4	5	0	0	5	0	0
13	8348241	.	A	T	1	2	3	0	0	3	0	0
13	8348298	.	G	T	1	2	3	0	0	3	0	0
13	8352149	.	G	C	1	0	1	0	1	2	0	0
13	8378391	.	G	C	5	4	9	0	0	9	0	0
13	8380129	.	C	G	2	2	4	0	0	4	0	0
13	8380477	.	T	C	1	4	5	0	0	5	0	0
13	8380870	.	T	C	3	0	3	0	3	6	0	0
13	8381706	.	G	A	1	3	4	0	0	4	0	0
13	8402086	.	T	C	1	0	1	0	1	2	0	0
13	8453536	.	G	A	2	2	4	0	0	4	0	0
13	8453690	.	C	T	2	2	4	0	1	5	0	0
13	8453720	.	A	G	1	4	5	0	1	6	0	0
13	8516496	.	T	C	0	1	1	0	0	1	0	0
13	8600706	.	G	T	3	3	6	0	2	8	0	0
13	8605132	.	T	A	2	4	6	0	0	6	0	0
13	8605145	.	T	A	3	4	7	0	0	7	0	0
13	8621601	.	A	C	3	3	6	0	1	7	0	0
13	8623387	.	T	C	3	2	5	0	0	5	0	0
13	8623483	.	A	G	3	0	3	0	9	12	0	0
13	8623521	.	G	C	3	6	9	0	0	9	0	0
13	8623659	.	A	C	4	5	9	0	0	9	0	0
13	8624264	.	G	A	3	2	5	0	0	5	0	0
13	8624658	.	T	C	5	4	9	0	0	9	0	0
13	8624659	.	G	T	5	4	9	0	0	9	0	0
13	8626252	.	C	G	1	5	6	0	0	6	0	0
13	8626699	.	C	T	7	7	14	0	0	14	0	0
13	8626786	.	G	A	0	4	4	0	9	13	0	0
13	8626957	.	C	T	3	2	5	0	0	5	0	0
13	8627056	.	T	C	5	2	7	0	0	7	0	0
13	8627178	.	T	A	4	6	10	0	0	10	0	0
13	8627179	.	A	T	4	6	10	0	0	10	0	0
13	8627222	.	C	T	3	7	10	0	0	10	0	0
13	8627302	.	C	A	7	3	10	0	0	10	0	0
13	8627445	.	A	G	4	7	11	0	0	11	0	0
13	8627521	.	G	A	0	3	3	0	5	8	0	0
13	8627532	.	G	A	6	2	8	0	0	8	0	0
13	8627586	.	G	T	3	3	6	0	0	6	0	0
13	8627626	.	G	A	0	4	4	0	9	13	0	0
13	8627677	.	G	A	11	9	20	0	0	20	0	0
13	8627921	.	A	T	1	3	4	0	0	4	0	0
13	8627947	.	C	T	2	4	6	0	0	6	0	0
13	8683744	.	G	A	1	2	3	0	0	3	0	0
13	8683804	.	C	T	3	3	6	0	0	6	0	0
13	8683879	.	A	T	1	2	3	0	0	3	0	0
13	8683914	.	T	G	1	4	5	0	0	5	0	0
13	8684402	.	G	A	4	4	8	0	0	8	0	0
13	8684403	.	A	G	4	4	8	0	0	8	0	0
13	8684499	.	C	T	1	6	7	0	0	7	0	0
13	8684608	.	G	A	3	6	9	0	0	9	0	0
13	8684705	.	A	G	12	10	22	0	2	24	0	0
13	8684886	.	G	A	11	6	17	1	0	18	0	0
13	8685051	.	C	T	0	9	9	0	5	14	0	0
13	8685228	.	G	C	6	3	9	0	0	9	0	0
13	8685272	.	C	T	7	5	12	0	0	12	0	0
13	8685278	.	C	A	5	7	12	0	0	12	0	0
13	8685496	.	A	T	3	7	10	0	0	10	0	0
13	8685622	.	T	C	9	6	15	0	0	15	0	0
13	8692306	.	C	T	4	8	12	0	0	12	0	0
13	8692368	.	C	T	0	8	8	0	7	15	0	0
13	8692395	.	A	G	8	5	13	0	0	13	0	0
13	8692827	.	T	G	5	7	12	0	0	12	0	0
13	8777682	.	C	T	9	22	31	0	1	32	0	0
13	8777724	.	T	C	22	10	32	0	1	33	0	0
13	8777845	.	T	A	12	3	15	0	0	15	0	0
13	8778490	.	G	A	24	36	60	0	0	60	0	0
13	8778548	.	G	A	15	24	39	0	1	40	0	0
13	8781159	.	G	C	2	0	2	0	2	4	0	0
13	8781577	.	A	G	17	17	34	0	1	35	0	0
13	8781786	.	C	T	19	27	46	0	4	50	0	0
13	8781789	.	A	C	20	30	50	0	2	52	0	0
13	8782036	.	T	C	2	2	4	0	0	4	0	0
13	8782424	.	A	T	4	3	7	0	0	7	0	0
13	8785294	.	C	G	10	6	16	0	2	18	0	0
13	8785327	.	T	C	9	4	13	0	0	13	0	0
13	8923849	.	G	A	2	2	4	0	0	4	0	0
13	8923852	.	C	T	2	2	4	0	0	4	0	0
13	8937412	.	A	G	1	2	3	0	0	3	0	0
13	8937472	.	T	G	3	1	4	0	0	4	0	0
13	8950795	.	C	A	1	4	5	0	1	6	0	0
13	8950831	.	G	T	0	6	6	0	1	7	0	0
13	8950846	.	A	G	1	4	5	0	0	5	0	0
13	9299796	.	A	G	2	2	4	0	0	4	0	0
13	9300204	.	G	A	7	5	12	0	0	12	0	0
13	9304107	.	G	C	6	4	10	0	1	11	0	0
13	9307202	.	C	T	0	12	12	0	5	17	0	0
13	9311011	.	G	T	15	13	28	0	1	29	0	0
13	9313806	.	C	T	1	22	23	0	15	38	0	0
13	9313858	.	A	T	41	19	60	0	1	61	0	0
13	9313975	.	T	C	43	27	70	0	1	71	0	0
13	9314024	.	C	A	43	25	68	0	1	69	0	0
13	9314104	.	C	T	1	36	37	0	19	56	0	0
13	9314238	.	G	A	31	26	57	0	7	64	0	0
13	9314580	.	A	T	37	31	68	0	2	70	0	0
13	9314620	.	C	T	31	31	62	0	2	64	0	0
13	9314630	.	C	T	0	33	33	0	31	64	0	0
13	9314657	.	C	T	35	31	66	0	4	70	0	0
13	9314680	.	G	A	40	32	72	0	2	74	0	0
13	9314710	.	G	A	40	34	74	0	5	79	0	0
13	9314800	.	T	C	28	54	82	0	0	82	0	0
13	9314935	.	G	A	44	43	87	0	1	88	0	0
13	9315045	.	C	G	43	30	73	0	5	78	0	0
13	9315321	.	G	T	46	50	96	0	2	98	0	0
13	9315424	.	G	A	28	8	36	0	1	37	0	0
13	9315686	.	C	T	2	19	21	0	33	55	1	0
13	9315730	.	A	G	6	7	13	0	3	16	0	0
13	9317945	.	C	T	43	45	88	0	0	88	0	0
13	9318003	.	C	T	4	37	41	0	43	84	0	0
13	9318116	.	T	C	48	33	81	0	1	82	0	0
13	9318125	.	C	T	48	36	84	0	5	89	0	0
13	9318263	.	C	T	54	37	91	0	4	95	0	0
13	9318446	.	T	C	51	35	86	0	6	92	0	0
13	9318491	.	G	C	31	51	82	0	4	86	0	0
13	9318521	.	A	G	56	31	87	0	3	90	0	0
13	9318682	.	T	C	17	2	19	0	54	73	0	0
13	9318699	.	A	T	32	35	67	0	7	74	0	0
13	9340093	.	C	T	0	3	3	0	7	10	0	0
13	9340199	.	T	C	8	5	13	0	0	13	0	0
13	9340527	.	C	T	14	6	20	0	0	20	0	0
13	9340671	.	G	A	11	7	18	0	0	18	0	0
13	9344878	.	A	T	4	8	12	0	0	12	0	0
13	9351194	.	T	C	2	2	4	0	0	4	0	0
13	9356123	.	G	T	18	6	24	0	0	24	0	0
13	9358457	.	T	G	12	11	23	0	0	23	0	0
13	9361825	.	T	C	1	0	1	0	0	1	0	0
13	9362035	.	T	A	0	1	1	0	0	1	0	0
13	9367537	.	A	G	6	12	18	0	0	18	0	0
13	9367600	.	G	T	7	3	10	0	0	10	0	0
13	9373593	.	A	G	1	0	1	0	2	3	0	0
13	9373703	.	G	A	0	4	4	0	2	6	0	0
13	9374140	.	G	A	2	4	6	0	0	6	0	0
13	9374827	.	C	G	2	3	5	0	0	5	0	0
13	9375081	.	C	T	4	2	6	0	0	6	0	0
13	9375929	.	G	A	3	2	5	0	0	5	0	0
13	9375954	.	A	T	2	3	5	0	0	5	0	0
13	9375978	.	G	C	2	6	8	0	0	8	0	0
13	9375990	.	A	G	1	5	6	0	0	6	0	0
13	9384590	.	A	G	0	1	1	0	0	1	0	0
13	9384772	.	T	C	1	3	4	0	0	4	0	0
13	9384839	.	A	G	3	2	5	0	0	5	0	0
13	9384877	.	T	A	1	2	3	0	0	3	0	0
13	9384935	.	A	G	3	3	6	0	0	6	0	0
13	9384997	.	C	G	4	6	10	0	1	11	0	0
13	9384998	.	G	A	0	7	7	0	4	11	0	0
13	9385561	.	G	A	1	0	1	0	0	1	0	0
13	9392020	.	G	A	2	5	7	0	0	7	0	0
13	9392047	.	G	A	3	5	8	0	0	8	0	0
13	9392068	.	A	G	1	7	8	0	1	9	0	0
13	9392260	.	G	A	0	4	4	0	2	6	0	0
13	9394684	.	A	T	3	6	9	0	0	9	0	0
13	9394716	.	A	G	5	4	9	0	0	9	0	0
13	9395458	.	G	T	2	3	5	0	0	5	0	0
13	9550887	.	A	G	1	0	1	0	2	3	0	0
13	9550911	.	A	G	1	3	4	0	0	4	0	0
13	9554410	.	T	C	2	3	5	0	0	5	0	0
13	9554761	.	T	C	3	3	6	0	0	6	0	0
13	9554825	.	T	G	2	3	5	0	1	6	0	0
13	9554828	.	T	C	2	3	5	0	1	6	0	0
13	9554956	.	T	C	3	9	12	0	0	12	0	0
13	9555516	.	A	C	3	2	5	0	0	5	0	0
13	9556322	.	A	G	2	0	2	0	4	6	0	0
13	9556426	.	C	T	3	3	6	0	1	7	0	0
13	9556535	.	T	C	2	3	5	0	0	5	0	0
13	9556885	.	A	G	1	2	3	0	0	3	0	0
13	9556950	.	C	G	4	3	7	0	0	7	0	0
13	9556956	.	A	G	4	0	4	0	3	7	0	0
13	9557285	.	T	G	2	2	4	0	0	4	0	0
13	9557825	.	A	G	1	3	4	0	0	4	0	0
13	9557997	.	G	C	1	2	3	2	0	5	0	0
13	9558312	.	T	A	2	3	5	0	0	6	1	0
13	9558321	.	T	C	3	2	5	0	1	6	0	0
13	9559476	.	T	A	3	3	6	0	0	6	0	0
13	9559527	.	A	C	9	7	16	0	1	17	0	0
13	9559542	.	A	G	8	0	8	0	11	19	0	0
13	9560897	.	T	C	3	3	6	0	1	7	0	0
13	9565065	.	G	A	0	1	1	0	8	9	0	0
13	9568821	.	C	T	2	6	8	0	0	8	0	0
13	9568857	.	G	A	0	2	2	0	2	4	0	0
13	9568861	.	T	C	2	2	4	0	0	4	0	0
13	9570532	.	A	T	2	4	6	0	1	7	0	0
13	9570598	.	A	G	9	5	14	0	2	16	0	0
13	9570967	.	A	G	2	4	6	1	0	7	0	0
13	9571949	.	T	C	12	5	17	0	0	17	0	0
13	9571972	.	G	A	11	4	15	0	1	16	0	0
13	9571996	.	T	G	11	4	15	0	0	15	0	0
13	9572036	.	G	A	5	3	8	0	2	10	0	0
13	9572134	.	G	T	4	4	8	0	0	8	0	0
13	9585680	.	T	G	1	4	5	0	0	5	0	0
13	9760154	.	G	A	2	4	6	0	0	6	0	0
13	9760513	.	A	G	1	0	1	0	4	5	0	0
13	9819251	.	T	A	5	4	9	0	0	9	0	0
13	9825852	.	G	A	2	3	5	0	0	5	0	0
13	9825882	.	G	A	0	2	2	0	1	3	0	0
13	9828726	.	C	T	3	2	5	0	0	5	0	0
13	9828780	.	G	A	4	5	9	0	3	12	0	0
13	9828933	.	G	T	5	6	11	0	0	11	0	0
13	9829007	.	A	G	7	3	10	0	0	10	0	0
13	9829013	.	C	T	7	3	10	0	1	11	0	0
13	9829232	.	T	C	1	3	4	0	0	4	0	0
13	9829252	.	T	A	2	1	3	0	0	3	0	0
13	9829274	.	C	A	3	4	7	0	0	7	0	0
13	9829361	.	G	T	7	5	12	0	1	13	0	0
13	9829855	.	C	T	5	5	10	0	0	10	0	0
13	9829944	.	A	G	2	0	2	0	2	4	0	0
13	9830066	.	A	T	5	3	8	0	1	9	0	0
13	9830089	.	T	C	3	5	8	0	0	8	0	0
13	9830591	.	A	T	4	3	7	0	0	7	0	0
13	9830597	.	C	A	3	4	7	0	0	7	0	0
13	9844440	.	G	A	7	7	14	0	0	14	0	0
13	9844527	.	A	G	1	0	1	0	1	2	0	0
13	9848385	.	G	A	5	4	9	0	0	9	0	0
13	9848577	.	A	G	26	30	56	0	0	56	0	0
13	9855508	.	G	T	14	4	18	0	0	18	0	0
13	9855874	.	G	A	4	22	26	0	0	26	0	0
13	9856319	.	A	G	7	12	19	0	0	19	0	0
13	9856427	.	A	G	9	16	25	0	1	26	0	0
13	9856493	.	A	T	20	17	37	0	1	38	0	0
13	9856658	.	A	G	18	16	34	0	1	35	0	0
13	9863888	.	G	A	4	6	10	0	0	10	0	0
13	9866911	.	A	G	5	6	11	0	0	11	0	0
13	9870586	.	G	T	1	1	2	0	0	2	0	0
13	9896848	.	C	T	1	2	3	0	0	3	0	0
13	9896850	.	C	T	1	2	3	0	0	3	0	0
13	9901357	.	T	A	1	1	2	0	0	2	0	0
13	10361514	.	A	C	2	1	3	0	3	6	0	0
13	10361660	.	G	A	1	2	3	0	0	3	0	0
13	12624860	.	C	T	10	6	16	0	0	16	0	0
13	12628901	.	C	T	4	9	13	0	0	13	0	0
13	12633376	.	T	A	6	2	8	0	0	8	0	0
13	12633387	.	C	A	3	2	5	0	0	5	0	0
13	12635858	.	T	A	3	4	7	0	0	7	0	0
13	12635862	.	C	A	3	4	7	0	0	7	0	0
13	12665411	.	T	A	4	6	10	0	1	11	0	0
13	12665663	.	T	C	3	2	5	0	0	5	0	0
13	12665678	.	T	A	2	5	7	0	0	7	0	0
13	12665704	.	T	C	1	4	5	0	1	6	0	0
13	12665745	.	T	C	2	3	5	0	1	6	0	0
13	12665761	.	T	C	3	2	5	0	0	5	0	0
13	12665990	.	C	A	5	5	10	0	0	10	0	0
13	12666017	.	T	C	4	1	5	0	6	11	0	0
13	12666038	.	G	A	5	2	7	0	0	7	0	0
13	12666182	.	C	T	9	4	13	0	1	14	0	0
13	12666183	.	G	A	4	10	14	0	0	14	0	0
13	12681222	.	C	T	2	2	4	0	0	4	0	0
13	12681318	.	C	T	4	3	7	0	0	7	0	0
13	12739444	.	G	T	7	6	13	0	0	13	0	0
13	12739894	.	T	A	7	9	16	0	1	17	0	0
13	12739939	.	C	T	4	12	16	0	0	16	0	0
13	12740092	.	G	T	0	4	4	0	8	12	0	0
13	12740113	.	A	T	2	6	8	0	1	9	0	0
13	12740129	.	C	T	4	2	6	0	3	9	0	0
13	12740236	.	A	G	3	6	9	0	5	14	0	0
13	12740971	.	T	G	15	11	26	0	0	26	0	0
13	12762350	.	G	A	2	0	2	0	0	2	0	0
13	12762486	.	T	G	5	4	9	0	0	9	0	0
13	12762978	.	C	T	2	3	5	0	0	5	0	0
13	12769323	.	T	C	0	2	2	0	0	2	0	0
13	12769359	.	A	G	5	0	5	0	3	8	0	0
13	12778091	.	C	T	3	3	6	0	0	6	0	0
13	12778142	.	T	C	4	3	7	0	0	7	0	0
13	12778647	.	C	A	4	2	6	0	0	6	0	0
13	12834047	.	G	A	1	4	5	0	0	5	0	0
13	12834071	.	G	A	0	1	1	0	1	2	0	0
13	12866033	.	G	A	1	3	4	0	0	4	0	0
13	12866276	.	G	A	1	3	4	0	0	4	0	0
13	12868435	.	G	A	0	1	1	0	3	4	0	0
13	12868492	.	A	G	1	3	4	0	0	4	0	0
13	12874147	.	C	T	1	1	2	0	0	2	0	0
13	12883529	.	G	A	0	3	3	0	2	5	0	0
13	12891860	.	A	G	4	6	10	0	1	11	0	0
13	12891881	.	A	G	6	7	13	0	0	13	0	0
13	12904744	.	G	T	7	5	12	0	1	13	0	0
13	12911384	.	G	A	0	4	4	0	1	5	0	0
13	12915909	.	T	C	2	2	4	0	0	4	0	0
13	12915927	.	A	T	2	2	4	0	0	4	0	0
13	12916079	.	A	C	2	0	2	0	0	2	0	0
13	12917364	.	G	C	2	4	6	0	0	6	0	0
13	12917382	.	C	T	4	3	7	0	0	7	0	0
13	12917424	.	G	A	4	8	12	0	0	12	0	0
13	12917427	.	T	C	4	7	11	0	0	11	0	0
13	12918227	.	G	C	1	1	2	0	0	2	0	0
13	12920837	.	T	C	9	3	12	0	0	12	0	0
13	12920924	.	C	T	1	7	8	0	0	8	0	0
13	12940084	.	C	T	2	2	4	0	0	4	0	0
13	12946108	.	G	A	1	4	5	0	0	5	0	0
13	12955335	.	C	T	5	7	12	0	1	13	0	0
13	12955377	.	C	T	7	4	11	0	0	11	0	0
13	12955413	.	C	T	0	3	3	0	0	4	1	0
13	12955549	.	C	T	3	1	4	0	0	4	0	0
13	12962979	.	G	A	0	1	1	0	1	2	0	0
13	12963052	.	C	T	13	8	21	0	1	22	0	0
13	12967432	.	G	C	12	13	25	0	0	25	0	0
13	12967438	.	C	T	10	12	22	0	0	22	0	0
13	12970797	.	C	T	2	9	11	0	2	13	0	0
13	12971856	.	G	A	6	3	9	0	1	10	0	0
13	12985114	.	C	T	14	20	34	0	0	34	0	0
13	12985193	.	T	A	6	17	23	0	1	24	0	0
13	12985253	.	G	A	0	15	15	0	15	30	0	0
13	12985291	.	G	A	10	11	21	0	0	21	0	0
13	12985376	.	G	A	0	17	17	0	14	31	0	0
13	12985539	.	T	C	15	13	28	0	0	28	0	0
13	12985540	.	A	G	15	0	15	0	13	28	0	0
13	12985822	.	T	G	13	5	18	0	0	18	0	0
13	12994738	.	A	T	13	7	20	0	3	23	0	0
13	12994743	.	G	T	11	12	23	0	1	24	0	0
13	12997845	.	C	T	4	4	8	0	0	8	0	0
13	13004739	.	G	A	0	2	2	0	0	2	0	0
13	13004748	.	G	A	0	1	1	0	0	1	0	0
13	13019277	.	C	G	3	3	6	0	0	6	0	0
13	13027068	.	A	C	1	2	3	0	0	3	0	0
13	13069251	.	C	T	1	2	3	0	1	4	0	0
13	13091046	.	C	A	1	3	4	0	0	4	0	0
13	13091079	.	T	C	2	6	8	0	0	8	0	0
13	13094191	.	A	G	0	1	1	0	0	1	0	0
13	13096526	.	T	C	6	5	11	0	0	11	0	0
13	13099615	.	A	G	1	3	4	0	0	4	0	0
13	13213863	.	G	A	5	2	7	0	0	7	0	0
13	13214412	.	G	A	11	8	19	0	0	19	0	0
13	13214571	.	T	A	3	5	8	0	0	8	0	0
13	13214648	.	C	T	2	5	7	0	0	7	0	0
13	13215010	.	A	G	5	2	7	0	0	7	0	0
13	13215640	.	T	G	1	3	4	0	0	4	0	0
13	13215643	.	G	A	1	4	5	0	0	5	0	0
13	13215984	.	T	C	5	5	10	0	0	10	0	0
13	13216071	.	A	T	7	7	14	0	0	14	0	0
13	13216515	.	T	G	1	2	3	0	0	3	0	0
13	13216593	.	C	T	3	5	8	0	0	8	0	0
13	13217045	.	C	A	5	3	8	0	0	8	0	0
13	13218594	.	C	T	2	5	7	0	0	7	0	0
13	13228465	.	G	A	2	2	4	0	0	4	0	0
13	13228489	.	T	C	2	1	3	0	2	5	0	0
13	13230279	.	G	A	0	2	2	0	0	2	0	0
13	13693781	.	A	T	2	13	15	0	0	15	0	0
13	13697957	.	G	A	0	2	2	0	1	3	0	0
13	13704011	.	T	G	1	2	3	0	0	3	0	0
13	13713106	.	C	G	2	5	7	0	0	7	0	0
13	13725119	.	A	G	6	0	6	0	4	10	0	0
13	13733417	.	G	T	13	8	21	0	1	23	1	0
13	13917976	.	C	T	6	5	11	0	1	12	0	0
13	13917991	.	C	T	5	6	11	0	0	11	0	0
13	13943788	.	T	C	2	2	4	0	0	4	0	0
13	13944064	.	A	G	2	5	7	0	0	7	0	0
13	13945276	.	T	A	4	3	7	0	0	7	0	0
13	13970036	.	G	A	0	3	3	0	0	3	0	0
13	13982700	.	A	G	1	1	2	0	0	2	0	0
13	13984582	.	G	A	2	3	5	0	0	5	0	0
13	13988460	.	A	T	2	2	4	0	1	5	0	0
13	13988647	.	G	A	1	3	4	0	0	4	0	0
13	13997097	.	C	T	3	3	6	0	0	6	0	0
13	13997101	.	C	T	2	3	5	0	1	6	0	0
13	13997299	.	C	T	4	6	10	0	1	11	0	0
13	13997383	.	T	G	4	0	4	0	10	14	0	0
13	13997446	.	G	T	0	3	3	0	3	6	0	0
13	13997545	.	G	A	4	2	6	0	1	7	0	0
13	13997829	.	G	A	3	4	7	0	0	7	0	0
13	13999037	.	A	T	1	1	2	0	0	2	0	0
13	14002936	.	A	T	3	3	6	0	0	6	0	0
13	14002979	.	G	T	5	3	8	0	0	8	0	0
13	14003099	.	A	G	3	4	7	0	0	7	0	0
13	14004141	.	C	T	7	6	13	0	1	14	0	0
13	14004209	.	C	T	5	4	9	0	0	9	0	0
13	14004246	.	T	A	3	4	7	0	1	8	0	0
13	14070774	.	A	T	1	1	2	0	0	2	0	0
13	14070931	.	T	C	4	4	8	0	0	8	0	0
13	14070961	.	C	T	3	3	6	0	0	6	0	0
13	14070982	.	A	G	1	3	4	0	0	4	0	0
13	14078691	.	G	A	0	8	8	0	5	13	0	0
13	14078752	.	T	C	2	0	2	0	0	2	0	0
13	14081204	.	A	T	4	4	8	0	0	8	0	0
13	14088909	.	G	T	1	4	5	0	0	5	0	0
13	14092489	.	C	T	0	2	2	0	0	2	0	0
13	14092573	.	G	A	4	3	7	0	0	7	0	0
13	14094405	.	C	T	0	1	1	0	0	1	0	0
13	14094441	.	G	A	6	4	10	0	0	10	0	0
13	14098156	.	T	C	3	1	4	0	0	4	0	0
13	14102253	.	C	T	3	5	8	0	0	8	0	0
13	14103916	.	C	T	6	7	13	0	0	13	0	0
13	14116632	.	C	T	1	2	3	0	0	3	0	0
13	14116869	.	T	C	5	7	12	0	0	12	0	0
13	14137061	.	C	T	1	1	2	0	0	2	0	0
13	14181846	.	A	T	5	7	12	0	0	12	0	0
13	14181912	.	A	C	6	8	14	0	1	15	0	0
13	14181952	.	T	C	11	6	17	0	0	17	0	0
13	14190780	.	C	T	0	8	8	0	13	21	0	0
13	14191033	.	T	C	10	6	16	0	0	16	0	0
13	14191045	.	G	C	8	8	16	0	0	16	0	0
13	14191724	.	G	A	13	6	19	0	1	20	0	0
13	14192110	.	T	C	9	8	17	0	0	17	0	0
13	14192131	.	G	A	9	7	16	0	0	16	0	0
13	14192178	.	A	T	7	8	15	0	0	15	0	0
13	14192376	.	A	G	9	6	15	0	2	17	0	0
13	14192511	.	A	T	8	6	14	0	0	14	0	0
13	14194640	.	C	T	6	5	11	0	0	11	0	0
13	14194660	.	G	A	6	7	13	0	0	13	0	0
13	14194836	.	C	T	0	19	19	0	6	25	0	0
13	14194968	.	T	A	5	11	16	0	1	17	0	0
13	14195100	.	A	G	6	7	13	0	0	13	0	0
13	14199220	.	A	T	11	17	28	0	1	29	0	0
13	14220900	.	G	A	5	6	11	0	0	11	0	0
13	14241819	.	C	T	7	11	18	0	0	18	0	0
13	14251160	.	G	A	7	8	15	0	1	16	0	0
13	14251280	.	C	T	0	4	4	0	3	7	0	0
13	14251313	.	C	A	1	1	2	0	0	2	0	0
13	16782972	.	A	G	3	0	3	0	0	3	0	0
13	17470079	.	C	T	6	5	11	0	1	12	0	0
13	17470112	.	A	G	5	0	5	0	9	14	0	0
13	17470430	.	T	C	8	12	20	0	1	21	0	0
13	17702657	.	C	T	3	1	4	0	1	5	0	0
13	17703164	.	A	T	2	2	4	0	0	4	0	0
13	17703453	.	T	A	8	5	13	0	0	13	0	0
13	17703454	.	C	A	8	5	13	0	0	13	0	0
13	17703548	.	C	T	7	8	15	0	0	15	0	0
13	17703557	.	G	C	0	8	8	0	7	15	0	0
13	17714510	.	G	T	27	21	48	0	2	50	0	0
13	17714881	.	C	T	26	13	39	0	3	42	0	0
13	17714942	.	A	G	19	21	40	0	4	44	0	0
13	17717608	.	G	A	3	1	4	0	1	5	0	0
13	17752932	.	A	T	7	4	11	0	0	11	0	0
13	17753144	.	A	C	4	0	4	0	6	10	0	0
13	17753668	.	A	C	16	10	26	0	0	26	0	0
13	17753732	.	A	T	11	9	20	0	0	20	0	0
13	17753821	.	A	T	8	7	15	0	2	17	0	0
13	17754071	.	T	G	2	3	5	0	0	7	2	0
13	17754275	.	G	T	2	4	6	0	0	6	0	0
13	17754313	.	T	G	3	1	4	0	0	4	0	0
13	17754329	.	C	T	3	1	4	0	0	4	0	0
13	17754466	.	C	T	0	2	2	0	0	2	0	0
13	17754897	.	C	T	0	4	4	0	2	6	0	0
13	17755221	.	C	T	2	4	6	0	0	6	0	0
13	17755579	.	A	G	3	3	6	0	1	7	0	0
13	17755743	.	G	C	7	0	7	0	7	14	0	0
13	17755758	.	C	T	0	7	7	0	8	15	0	0
13	17755830	.	C	A	4	2	6	0	0	6	0	0
13	17755898	.	G	A	2	5	7	0	1	8	0	0
13	17756043	.	G	A	6	2	8	0	0	8	0	0
13	17756112	.	G	A	4	3	7	0	0	7	0	0
13	17756131	.	A	T	5	3	8	0	0	8	0	0
13	17756235	.	G	A	8	7	15	0	0	15	0	0
13	17756322	.	G	A	5	7	12	0	0	12	0	0
13	17943071	.	C	T	2	2	4	0	0	4	0	0
13	18011158	.	G	T	1	1	2	0	0	2	0	0
13	18019786	.	C	T	0	3	3	0	3	6	0	0
13	18024418	.	C	T	5	6	11	0	0	11	0	0
13	18024419	.	A	G	5	6	11	0	0	11	0	0
13	18033053	.	A	G	1	3	4	0	0	4	0	0
13	18033073	.	T	G	4	3	7	0	0	7	0	0
13	18046210	.	G	A	1	2	3	0	0	3	0	0
13	18064536	.	C	T	0	1	1	0	2	3	0	0
13	18069031	.	A	G	0	1	1	0	0	1	0	0
13	18073433	.	A	G	4	14	18	0	0	18	0	0
13	18073524	.	G	T	9	6	15	0	1	16	0	0
13	18073582	.	G	T	3	6	9	0	0	9	0	0
13	18073706	.	G	A	8	3	11	0	0	11	0	0
13	18076710	.	T	G	3	5	8	0	0	8	0	0
13	18076788	.	G	C	9	16	25	0	0	25	0	0
13	18076818	.	G	A	12	9	21	0	0	21	0	0
13	18076996	.	C	T	17	13	30	0	1	31	0	0
13	18077056	.	G	T	12	16	28	0	0	28	0	0
13	18077116	.	G	A	6	8	14	0	1	15	0	0
13	18077191	.	C	G	10	11	21	0	0	21	0	0
13	18080348	.	G	A	11	5	16	0	1	17	0	0
13	18080411	.	G	T	4	8	12	0	2	14	0	0
13	18083391	.	C	T	0	3	3	0	4	7	0	0
13	18083415	.	G	A	3	4	7	0	0	7	0	0
13	18087946	.	G	A	5	2	7	0	0	7	0	0
13	18088276	.	T	G	5	6	11	0	0	11	0	0
13	18092084	.	A	G	2	3	5	0	0	5	0	0
13	18092108	.	T	C	1	3	4	0	1	5	0	0
13	18092279	.	A	G	1	0	1	0	0	1	0	0
13	18092417	.	A	G	3	3	6	0	1	7	0	0
13	18099947	.	T	C	6	0	6	0	2	8	0	0
13	18104890	.	C	T	4	3	7	0	0	7	0	0
13	18104929	.	A	T	4	5	9	0	1	10	0	0
13	18105175	.	G	A	6	1	7	0	0	7	0	0
13	18105382	.	A	G	0	3	3	0	0	3	0	0
13	18107562	.	C	T	0	1	1	0	0	1	0	0
13	18107622	.	A	G	0	1	1	0	0	1	0	0
13	18110003	.	T	C	0	0	0	0	2	2	0	0
13	18119488	.	T	C	4	2	6	0	0	6	0	0
13	18119489	.	C	T	3	2	5	0	0	6	1	0
13	18122193	.	C	T	1	1	2	0	0	2	0	0
13	18122263	.	C	G	0	5	5	0	8	13	0	0
13	18179391	.	G	C	9	0	9	0	5	14	0	0
13	18179521	.	A	G	2	7	9	0	0	9	0	0
13	18179535	.	G	T	3	6	9	0	0	9	0	0
13	18179757	.	T	C	12	13	25	0	5	30	0	0
13	18179859	.	C	A	12	25	37	0	0	38	1	0
13	18185457	.	A	C	2	0	2	0	5	7	0	0
13	18185463	.	C	A	1	5	6	0	1	7	0	0
13	18195926	.	G	A	2	5	7	0	0	7	0	0
13	18274914	.	A	C	1	2	3	0	0	3	0	0
13	18275033	.	C	T	1	2	3	0	0	3	0	0
13	18275036	.	G	A	0	0	0	0	2	2	0	0
13	18275073	.	C	A	2	4	6	0	0	6	0	0
13	18275074	.	C	A	2	4	6	0	0	6	0	0
13	18282806	.	A	G	1	1	2	0	0	2	0	0
13	18295212	.	C	T	2	5	7	0	0	7	0	0
13	18295423	.	G	A	0	4	4	0	2	6	0	0
13	18295680	.	T	C	3	3	6	0	0	6	0	0
13	18295760	.	A	G	2	1	3	0	4	7	0	0
13	18314113	.	T	G	3	0	3	0	1	4	0	0
13	18321156	.	T	C	3	2	5	0	0	5	0	0
13	18323464	.	A	G	13	9	22	0	0	22	0	0
13	18323595	.	G	A	0	6	6	0	16	22	0	0
13	18323653	.	A	G	17	0	17	0	11	28	0	0
13	18323787	.	T	A	13	8	21	0	2	23	0	0
13	18358890	.	G	C	14	19	33	0	0	33	0	0
13	18359112	.	G	C	14	13	27	0	1	28	0	0
13	18359304	.	A	T	3	10	13	0	1	14	0	0
13	18359374	.	C	T	10	19	29	0	1	30	0	0
13	18359507	.	A	T	8	12	20	0	0	20	0	0
13	18371186	.	A	C	2	1	3	0	0	3	0	0
13	18375465	.	C	A	7	3	10	0	0	10	0	0
13	18375512	.	T	A	2	0	2	0	0	2	0	0
13	18382132	.	A	C	1	3	4	0	0	4	0	0
13	18382192	.	T	C	4	2	6	0	0	6	0	0
13	18385512	.	C	T	2	2	4	0	0	4	0	0
13	18385797	.	T	A	4	7	11	0	0	11	0	0
13	18397138	.	C	G	4	3	7	0	0	7	0	0
13	18409776	.	T	A	1	2	3	0	2	5	0	0
13	18410799	.	G	C	0	4	4	0	1	5	0	0
13	18418337	.	C	A	7	5	12	0	1	13	0	0
13	18418528	.	G	A	3	4	7	0	0	7	0	0
13	18428103	.	A	G	7	1	8	0	0	8	0	0
13	18431278	.	T	A	3	2	5	0	1	7	1	0
13	18431301	.	C	T	7	5	12	0	0	12	0	0
13	18431430	.	C	T	4	4	8	0	2	10	0	0
13	18434354	.	T	C	6	4	10	0	0	10	0	0
13	18434427	.	C	T	3	10	13	0	0	13	0	0
13	18434519	.	C	A	5	5	10	0	0	10	0	0
13	18434520	.	G	C	0	5	5	0	5	10	0	0
13	18434818	.	C	G	13	8	21	0	0	21	0	0
13	18434902	.	C	T	8	4	12	0	0	12	0	0
13	18471608	.	A	G	2	2	4	0	0	4	0	0
13	18471615	.	G	T	2	2	4	0	0	4	0	0
13	18499346	.	A	T	1	2	3	0	0	3	0	0
13	18499773	.	A	T	5	2	7	0	0	7	0	0
13	18499807	.	A	G	5	2	7	0	1	8	0	0
13	18509592	.	G	A	1	8	9	0	13	22	0	0
13	18509925	.	T	C	9	10	19	0	1	20	0	0
13	18509940	.	C	T	9	11	20	0	0	20	0	0
13	18510319	.	C	A	12	11	23	0	2	25	0	0
13	18510324	.	A	G	12	11	23	0	2	25	0	0
13	18510540	.	G	A	1	6	7	0	8	15	0	0
13	18511023	.	C	T	13	13	26	0	1	27	0	0
13	18511140	.	A	G	10	1	11	0	15	26	0	0
13	18511637	.	A	C	7	12	19	0	1	20	0	0
13	18511763	.	T	A	6	11	17	0	0	17	0	0
13	18511996	.	A	T	12	19	31	0	0	31	0	0
13	18512030	.	A	T	15	14	29	0	0	29	0	0
13	18512082	.	C	G	9	14	23	0	1	24	0	0
13	18663103	.	G	A	3	1	4	0	0	4	0	0
13	18663947	.	G	A	7	9	16	0	0	16	0	0
13	18677428	.	T	C	10	0	10	0	2	12	0	0
13	18677437	.	T	C	7	5	12	0	0	12	0	0
13	18677467	.	G	A	8	4	12	0	0	12	0	0
13	18677726	.	T	C	3	6	9	0	0	9	0	0
13	18677749	.	C	A	4	5	9	0	0	9	0	0
13	18677761	.	C	T	4	4	8	0	0	8	0	0
13	18677925	.	A	T	4	8	12	0	1	13	0	0
13	18680027	.	G	A	8	7	15	0	1	16	0	0
13	18685598	.	A	G	8	7	15	0	0	15	0	0
13	18685673	.	G	A	2	6	8	0	1	9	0	0
13	18801820	.	T	C	4	2	6	0	0	6	0	0
13	18804097	.	G	A	3	2	5	0	0	5	0	0
13	19304688	.	A	G	15	6	21	0	0	21	0	0
13	19306817	.	C	G	13	7	20	0	0	20	0	0
13	19316930	.	G	C	9	11	20	0	0	20	0	0
13	19317016	.	T	A	1	8	9	0	0	9	0	0
13	19317018	.	C	G	1	8	9	0	0	9	0	0
13	19317051	.	T	G	2	3	5	0	0	5	0	0
13	19627150	.	A	G	5	3	8	0	0	8	0	0
13	19627266	.	A	C	3	1	4	0	0	4	0	0
13	19629266	.	C	G	9	6	15	0	1	16	0	0
13	19639198	.	A	G	1	4	5	0	0	5	0	0
13	19639205	.	G	A	1	4	5	0	0	5	0	0
13	19639238	.	T	C	2	6	8	0	0	8	0	0
13	19639256	.	T	C	2	0	2	0	4	6	0	0
13	19799192	.	A	G	2	1	3	0	0	3	0	0
13	19799467	.	G	A	11	10	21	0	0	21	0	0
13	19799522	.	C	T	15	6	21	0	3	24	0	0
13	19799535	.	T	A	14	8	22	0	1	23	0	0
13	19799623	.	T	C	14	11	25	0	2	27	0	0
13	19799646	.	C	A	0	9	9	0	15	25	1	0
13	19799705	.	A	G	14	14	28	0	1	29	0	0
13	19799799	.	C	T	0	3	3	0	4	7	0	0
13	19884813	.	C	A	1	1	2	0	1	3	0	0
13	20007815	.	G	A	1	2	3	0	0	3	0	0
13	20007841	.	C	T	1	2	3	0	0	3	0	0
13	20328046	.	G	T	2	2	4	0	0	4	0	0
13	20401263	.	C	A	0	10	10	0	6	16	0	0
13	20425396	.	C	T	1	6	7	0	8	15	0	0
13	20518620	.	C	T	1	3	4	0	4	8	0	0
13	20518711	.	C	T	11	8	19	0	1	20	0	0
13	21638916	.	G	A	5	5	10	0	2	12	0	0
13	21638955	.	C	A	6	8	14	0	0	14	0	0
13	21676256	.	A	T	1	2	3	0	0	3	0	0
13	21676271	.	G	A	2	2	4	0	0	4	0	0
13	21681224	.	A	T	0	2	2	0	0	2	0	0
13	21683057	.	A	C	7	10	17	0	0	17	0	0
13	21683077	.	T	C	5	7	12	0	0	12	0	0
13	21683488	.	A	T	20	15	35	0	2	37	0	0
13	21683511	.	T	G	16	12	28	0	1	29	0	0
13	21683546	.	C	T	16	15	31	0	0	31	0	0
13	21689438	.	A	C	6	5	11	0	0	11	0	0
13	21689439	.	C	T	6	5	11	0	0	11	0	0
13	21689839	.	C	T	0	6	6	0	0	6	0	0
13	21689854	.	C	T	6	1	7	0	0	7	0	0
13	21689982	.	G	A	4	2	6	0	0	6	0	0
13	21690035	.	T	A	1	8	9	0	0	9	0	0
13	21690055	.	A	G	1	7	8	0	0	8	0	0
13	21690096	.	C	G	3	4	7	0	1	8	0	0
13	21690229	.	A	C	2	8	10	3	0	13	0	0
13	21690374	.	G	A	14	5	19	0	1	20	0	0
13	21690530	.	C	T	0	5	5	0	7	12	0	0
13	21690724	.	A	T	5	3	8	0	0	8	0	0
13	21690877	.	A	C	2	0	2	0	2	4	0	0
13	21690907	.	G	A	4	3	7	0	0	7	0	0
13	21691324	.	G	A	3	3	6	0	1	7	0	0
13	21691794	.	G	A	3	7	10	0	0	10	0	0
13	21692328	.	C	A	4	6	10	0	1	11	0	0
13	21692338	.	C	T	5	9	14	0	0	14	0	0
13	21692705	.	C	G	0	3	3	0	2	5	0	0
13	21692859	.	C	T	7	3	10	0	0	10	0	0
13	21693187	.	A	G	7	6	13	0	0	13	0	0
13	21693208	.	A	C	5	0	5	0	8	13	0	0
13	21693285	.	A	T	8	4	12	0	0	12	0	0
13	21693342	.	C	T	5	6	11	0	0	11	0	0
13	21693361	.	C	T	8	5	13	0	0	13	0	0
13	21693410	.	G	C	7	5	12	0	1	13	0	0
13	21693514	.	A	T	8	5	13	0	0	13	0	0
13	21695438	.	G	T	4	4	8	0	0	8	0	0
13	21712507	.	G	A	12	14	26	0	0	26	0	0
13	21712526	.	G	A	8	8	16	0	0	16	0	0
13	21712755	.	G	C	3	5	8	0	0	8	0	0
13	21716581	.	T	C	2	4	6	0	0	6	0	0
13	21725526	.	T	C	4	0	4	0	0	4	0	0
13	21727796	.	T	A	1	1	2	0	0	2	0	0
13	21735278	.	C	T	2	1	3	0	0	3	0	0
13	21770891	.	T	C	8	4	12	0	1	13	0	0
13	21775469	.	C	T	11	9	20	0	0	20	0	0
13	21775697	.	C	T	4	8	12	0	0	12	0	0
13	21776039	.	C	T	4	3	7	0	0	7	0	0
13	21776046	.	G	C	2	3	5	0	1	6	0	0
13	21818627	.	C	A	2	4	6	0	1	7	0	0
13	21818652	.	C	A	3	3	6	0	0	6	0	0
13	21819997	.	G	A	1	3	4	0	0	4	0	0
13	21821393	.	A	C	1	4	5	0	0	5	0	0
13	21826168	.	C	A	0	2	2	0	0	2	0	0
13	21826203	.	G	T	1	4	5	0	0	5	0	0
13	21826470	.	G	A	0	4	4	0	3	7	0	0
13	21852008	.	G	A	0	3	3	0	1	4	0	0
13	21855811	.	C	T	1	3	4	0	0	4	0	0
13	21855868	.	C	T	4	2	6	0	0	6	0	0
13	21856741	.	G	A	4	2	6	0	0	6	0	0
13	21860027	.	T	A	1	1	2	0	0	2	0	0
13	21860111	.	G	A	3	0	3	0	0	3	0	0
13	21861775	.	A	C	1	4	5	0	0	5	0	0
13	21861777	.	G	A	1	4	5	0	0	5	0	0
13	21862288	.	T	A	6	0	6	0	0	6	0	0
13	21864182	.	T	A	3	1	4	0	0	4	0	0
13	21866357	.	A	C	7	3	10	0	0	10	0	0
13	21869927	.	C	T	4	3	7	0	1	8	0	0
13	21870467	.	G	C	0	11	11	0	7	18	0	0
13	21870575	.	A	G	13	1	14	0	15	29	0	0
13	21870608	.	A	T	12	10	22	0	0	22	0	0
13	21874107	.	C	T	3	3	6	0	0	6	0	0
13	21874149	.	G	T	0	16	16	0	9	25	0	0
13	21874649	.	C	T	6	3	9	0	1	10	0	0
13	21884298	.	C	T	16	10	26	0	0	26	0	0
13	21884328	.	G	A	14	12	26	0	2	28	0	0
13	21884407	.	T	C	8	3	11	0	0	11	0	0
13	21884408	.	C	T	8	3	11	0	0	11	0	0
13	21884979	.	T	C	8	10	18	0	0	18	0	0
13	21884980	.	C	T	8	10	18	0	0	18	0	0
13	21885143	.	C	A	10	14	24	0	1	25	0	0
13	21885198	.	T	A	11	23	34	0	1	35	0	0
13	21919855	.	A	G	1	0	1	0	2	3	0	0
13	22064678	.	G	A	4	4	8	0	0	8	0	0
13	22064775	.	G	A	2	5	7	0	0	7	0	0
13	22065406	.	G	A	1	4	5	0	0	5	0	0
13	22065631	.	A	G	1	5	6	0	0	6	0	0
13	22065661	.	G	A	3	2	5	0	0	5	0	0
13	22066024	.	C	T	1	4	5	0	0	5	0	0
13	22066066	.	C	T	1	2	3	0	0	3	0	0
13	22066078	.	T	G	1	3	4	0	0	4	0	0
13	22076892	.	C	T	1	1	2	0	0	2	0	0
13	22087098	.	C	T	1	4	5	0	0	5	0	0
13	22087508	.	C	T	7	7	14	0	0	14	0	0
13	22094800	.	T	C	8	5	13	0	0	13	0	0
13	22094871	.	T	G	4	9	13	0	0	14	1	0
13	22095589	.	G	A	2	2	4	0	0	4	0	0
13	22095594	.	T	A	2	2	4	0	0	4	0	0
13	22119935	.	T	C	3	0	3	0	0	3	0	0
13	22198502	.	G	A	4	6	10	0	2	12	0	0
13	22207003	.	C	T	2	2	4	0	0	4	0	0
13	22238125	.	C	A	7	4	11	0	2	13	0	0
13	22238209	.	T	C	13	11	24	0	3	27	0	0
13	22238233	.	G	A	14	14	28	0	1	29	0	0
13	22240672	.	T	A	4	3	7	0	0	7	0	0
13	22241103	.	T	A	12	18	30	0	1	31	0	0
13	22241123	.	G	T	0	12	12	0	14	26	0	0
13	22241374	.	A	C	30	10	40	0	1	41	0	0
13	22241482	.	G	C	12	10	22	0	2	24	0	0
13	22241648	.	T	G	22	20	42	0	1	43	0	0
13	22241730	.	G	C	26	27	53	0	1	54	0	0
13	22241731	.	A	T	26	28	54	0	0	54	0	0
13	22242197	.	G	C	19	22	41	0	0	41	0	0
13	22242299	.	C	G	25	10	35	0	1	36	0	0
13	22242394	.	C	G	17	25	42	0	1	43	0	0
13	22242837	.	T	G	22	20	42	0	1	43	0	0
13	22243211	.	A	C	13	6	19	0	1	20	0	0
13	22281119	.	C	T	2	3	5	0	0	5	0	0
13	22303944	.	T	G	1	2	3	0	0	3	0	0
13	22317347	.	A	G	0	1	1	0	1	2	0	0
13	22328575	.	C	T	1	2	3	0	0	3	0	0
13	22340444	.	C	T	1	4	5	0	1	6	0	0
13	22340456	.	G	A	1	4	5	0	1	6	0	0
13	22347443	.	C	A	0	3	3	0	0	3	0	0
13	22351817	.	G	A	3	3	6	0	1	7	0	0
13	22354938	.	G	A	1	0	1	0	0	1	0	0
13	22355025	.	C	A	4	5	9	0	0	9	0	0
13	22357236	.	T	G	5	6	11	0	0	11	0	0
13	22357850	.	A	G	9	0	9	0	8	17	0	0
13	22358021	.	A	G	3	8	11	0	0	11	0	0
13	22361332	.	G	A	9	10	19	0	1	20	0	0
13	22361677	.	G	A	3	1	4	0	0	4	0	0
13	22361679	.	A	T	3	1	4	0	0	4	0	0
13	22361718	.	A	C	2	0	2	0	0	2	0	0
13	22364908	.	T	C	8	10	18	0	1	19	0	0
13	22365016	.	C	T	7	16	23	0	1	24	0	0
13	22365404	.	C	T	7	13	20	0	0	20	0	0
13	22365461	.	A	G	7	11	18	0	0	18	0	0
13	22367600	.	C	A	4	5	9	0	1	10	0	0
13	22369262	.	C	T	5	1	6	0	0	6	0	0
13	22369295	.	T	C	7	8	15	0	0	15	0	0
13	22369349	.	C	T	7	14	21	0	1	22	0	0
13	22369399	.	A	C	6	10	16	0	0	16	0	0
13	22369445	.	C	T	1	1	2	0	0	2	0	0
13	22371981	.	G	A	0	19	19	0	18	37	0	0
13	22372015	.	C	G	24	20	44	0	0	44	0	0
13	22372075	.	T	C	18	14	32	0	1	33	0	0
13	22372105	.	G	A	1	19	20	0	14	34	0	0
13	22372126	.	C	T	10	17	27	0	1	28	0	0
13	22372205	.	A	G	16	20	36	0	2	38	0	0
13	22372932	.	G	T	5	5	10	0	0	10	0	0
13	22453793	.	T	A	3	2	5	0	0	5	0	0
13	22555909	.	G	A	1	2	3	0	0	3	0	0
13	22613451	.	C	T	0	3	3	0	0	3	0	0
13	22617941	.	G	A	3	2	5	0	0	5	0	0
13	22618353	.	A	T	4	3	7	0	0	7	0	0
13	22618393	.	T	A	3	3	6	0	0	6	0	0
13	22618577	.	T	A	2	3	5	0	0	5	0	0
13	22618580	.	A	T	3	2	5	0	0	5	0	0
13	22619067	.	G	A	3	10	13	0	3	16	0	0
13	22619157	.	C	T	9	6	15	0	0	15	0	0
13	22620302	.	C	G	5	2	7	0	1	8	0	0
13	22659195	.	C	G	17	0	17	0	21	38	0	0
13	22659196	.	A	G	17	20	37	0	1	38	0	0
13	22659231	.	G	A	1	30	31	0	23	54	0	0
13	22659291	.	A	G	26	25	51	0	2	53	0	0
13	22659363	.	G	A	4	5	9	0	2	11	0	0
13	22659375	.	A	C	1	1	2	0	0	2	0	0
13	22669319	.	T	C	12	19	31	0	0	31	0	0
13	22679306	.	G	A	1	2	3	0	0	3	0	0
13	22683416	.	A	T	1	1	2	0	0	2	0	0
13	22688510	.	G	A	0	1	1	0	0	1	0	0
13	22704711	.	G	T	4	4	8	0	0	8	0	0
13	22705000	.	C	T	1	2	3	0	0	3	0	0
13	22705009	.	G	A	1	3	4	0	0	4	0	0
13	22705172	.	G	C	1	2	3	0	0	3	0	0
13	22725613	.	C	T	0	1	1	0	0	1	0	0
13	22728891	.	A	T	0	1	1	0	0	1	0	0
13	22735063	.	T	C	7	5	12	0	0	12	0	0
13	22735139	.	A	G	8	7	15	0	0	15	0	0
13	22742791	.	G	A	5	5	10	0	0	10	0	0
13	22744359	.	A	G	9	6	15	0	0	15	0	0
13	22867888	.	G	A	0	2	2	0	4	6	0	0
13	22867910	.	A	G	4	3	7	0	1	8	0	0
13	22867953	.	G	T	5	4	9	0	0	9	0	0
13	22868017	.	G	A	1	1	2	0	0	2	0	0
13	22868447	.	G	A	0	3	3	0	3	6	0	0
13	22868456	.	T	C	3	4	7	0	0	7	0	0
13	22871900	.	C	A	2	2	4	0	0	4	0	0
13	22871989	.	A	G	5	3	8	0	0	8	0	0
13	22872862	.	A	G	1	2	3	0	0	3	0	0
13	22872915	.	A	T	1	2	3	0	0	3	0	0
13	22876576	.	T	C	5	1	6	0	9	15	0	0
13	22876623	.	G	A	5	12	17	0	0	17	0	0
13	22876678	.	A	T	7	7	14	0	0	14	0	0
13	22877076	.	C	T	6	9	15	0	1	16	0	0
13	22877130	.	G	T	14	17	31	0	1	32	0	0
13	22878754	.	G	A	3	1	4	0	0	4	0	0
13	22879149	.	A	T	4	5	9	0	1	10	0	0
13	22890835	.	A	C	12	0	12	0	8	20	0	0
13	22898042	.	A	G	5	1	6	0	0	6	0	0
13	22900733	.	G	A	6	10	16	0	0	16	0	0
13	22900742	.	A	T	3	9	12	0	0	12	0	0
13	22902882	.	A	C	3	4	7	0	1	8	0	0
13	22902987	.	G	A	11	12	23	0	1	24	0	0
13	22925780	.	G	T	1	3	4	0	0	4	0	0
13	22925800	.	A	G	1	2	3	0	0	3	0	0
13	22973314	.	A	G	24	28	52	0	1	53	0	0
13	22973348	.	A	G	22	25	47	0	1	48	0	0
13	22973531	.	T	C	16	0	16	0	31	47	0	0
13	22973895	.	A	G	16	20	36	0	4	41	1	0
13	22974033	.	A	G	16	23	39	0	3	42	0	0
13	22974108	.	C	T	9	10	19	0	1	20	0	0
13	22976067	.	C	A	14	22	36	0	0	36	0	0
13	22976070	.	G	A	14	19	33	0	2	35	0	0
13	22976383	.	T	C	11	0	11	0	10	21	0	0
13	22977283	.	G	A	14	8	22	0	4	26	0	0
13	22977319	.	A	G	22	15	37	0	1	38	0	0
13	22977343	.	A	G	15	12	27	0	4	31	0	0
13	22978059	.	T	C	8	0	8	0	7	15	0	0
13	22978062	.	G	A	8	6	14	0	1	15	0	0
13	22983106	.	A	G	7	4	11	0	1	12	0	0
13	22983109	.	A	G	7	4	11	0	1	12	0	0
13	23002697	.	G	A	4	2	6	0	0	6	0	0
13	23007677	.	A	G	6	7	13	0	0	13	0	0
13	23017590	.	C	G	3	3	6	0	0	6	0	0
13	23017637	.	G	A	2	2	4	0	0	4	0	0
13	23017914	.	C	T	0	2	2	0	1	3	0	0
13	23023312	.	A	C	3	3	6	0	0	6	0	0
13	23037831	.	C	A	4	5	9	0	0	9	0	0
13	23042321	.	A	G	0	2	2	0	0	2	0	0
13	23042387	.	C	G	7	7	14	0	0	14	0	0
13	23042676	.	A	G	9	2	11	0	0	11	0	0
13	23042745	.	G	A	7	4	11	0	0	11	0	0
13	23042929	.	G	T	1	1	2	0	0	2	0	0
13	23045229	.	G	A	6	3	9	0	0	9	0	0
13	23062294	.	C	T	0	1	1	0	0	1	0	0
13	23064735	.	T	C	1	0	1	0	0	1	0	0
13	23070787	.	C	T	3	3	6	0	0	6	0	0
13	23070895	.	T	C	15	7	22	0	0	22	0	0
13	23084177	.	C	G	14	15	29	1	1	31	0	0
13	23084841	.	G	C	13	14	27	0	0	27	0	0
13	23090190	.	A	C	14	11	25	0	0	25	0	0
13	23094356	.	T	C	4	0	4	0	3	7	0	0
13	23094895	.	G	T	10	17	27	0	1	28	0	0
13	23166970	.	G	C	0	1	1	0	1	2	0	0
13	23166988	.	T	A	1	1	2	0	0	2	0	0
13	23169172	.	G	T	1	2	3	0	0	3	0	0
13	23169247	.	C	A	1	2	3	0	0	3	0	0
13	23201307	.	T	A	3	3	6	0	0	6	0	0
13	23201456	.	A	G	4	0	4	0	2	6	0	0
13	23204849	.	A	C	7	4	11	0	0	11	0	0
13	23212821	.	A	G	1	2	3	0	0	3	0	0
13	23222899	.	A	T	5	6	11	0	0	11	0	0
13	23223122	.	A	G	2	8	10	0	0	10	0	0
13	23223154	.	T	G	3	1	4	0	1	5	0	0
13	23223196	.	T	A	2	3	5	0	0	5	0	0
13	23223422	.	G	A	8	8	16	0	0	16	0	0
13	23223428	.	C	T	8	6	14	0	0	14	0	0
13	23223469	.	T	A	10	4	14	0	1	15	0	0
13	23223486	.	C	T	11	6	17	0	0	17	0	0
13	23223567	.	C	T	4	8	12	0	0	12	0	0
13	23223572	.	C	T	4	8	12	0	0	12	0	0
13	23223675	.	C	A	3	2	5	0	0	5	0	0
13	23223875	.	C	A	3	6	9	0	0	9	0	0
13	23224087	.	G	A	7	6	13	0	0	13	0	0
13	23224113	.	A	T	7	3	10	0	0	10	0	0
13	23224360	.	A	G	7	4	11	0	0	11	0	0
13	23224363	.	T	G	6	3	9	0	2	11	0	0
13	23224427	.	C	T	12	8	20	0	0	20	0	0
13	23224470	.	G	A	8	9	17	0	0	17	0	0
13	23224605	.	G	T	9	9	18	0	0	18	0	0
13	23224727	.	C	T	8	11	19	0	0	19	0	0
13	23224735	.	A	G	8	12	20	0	0	20	0	0
13	23224821	.	T	A	9	10	19	0	0	19	0	0
13	23224860	.	T	A	12	9	21	0	1	22	0	0
13	23225541	.	T	C	16	9	25	0	0	25	0	0
13	23225776	.	T	A	11	12	23	0	1	24	0	0
13	23226114	.	G	A	0	6	6	0	18	24	0	0
13	23226213	.	A	C	5	12	17	0	0	17	0	0
13	23234675	.	C	A	1	3	4	0	0	4	0	0
13	23234680	.	C	T	1	3	4	0	0	4	0	0
13	23314904	.	T	G	8	3	11	0	0	11	0	0
13	23382393	.	G	A	0	1	1	0	0	1	0	0
13	23387252	.	T	C	2	11	13	0	1	14	0	0
13	23666040	.	A	G	1	2	3	0	0	3	0	0
13	23669773	.	C	T	14	5	19	0	0	19	0	0
13	23669870	.	T	G	9	4	13	0	0	13	0	0
13	23675183	.	C	T	6	6	12	0	0	12	0	0
13	23675510	.	T	C	4	5	9	0	0	9	0	0
13	23675892	.	G	C	1	6	7	0	7	14	0	0
13	23676856	.	G	A	0	0	0	0	3	3	0	0
13	23676913	.	C	A	7	8	15	0	2	17	0	0
13	23678001	.	G	A	0	3	3	0	6	9	0	0
13	23679546	.	G	A	0	1	1	0	1	2	0	0
13	23679888	.	G	A	7	5	12	0	0	12	0	0
13	23685075	.	G	A	1	4	5	0	0	5	0	0
13	23685301	.	G	A	2	2	4	0	0	4	0	0
13	23692515	.	C	T	8	15	23	0	1	24	0	0
13	23692572	.	C	T	7	4	11	0	1	12	0	0
13	23703048	.	G	C	7	8	15	0	1	16	0	0
13	23703053	.	T	C	7	8	15	0	1	16	0	0
13	23709532	.	C	T	4	7	11	0	0	11	0	0
13	23709562	.	T	C	11	12	23	0	1	24	0	0
13	23709592	.	A	G	18	14	32	0	2	34	0	0
13	23711937	.	G	A	12	10	22	0	1	23	0	0
13	23728490	.	T	A	5	7	12	0	0	12	0	0
13	23730801	.	G	A	11	3	14	0	0	14	0	0
13	23876610	.	A	G	3	0	3	0	2	5	0	0
13	23876784	.	C	T	3	4	7	0	0	7	0	0
13	23882629	.	T	C	2	2	4	0	1	5	0	0
13	23882686	.	C	T	6	5	11	0	1	12	0	0
13	23882946	.	A	G	2	4	6	0	1	7	0	0
13	23898045	.	T	G	6	10	16	0	1	17	0	0
13	23901334	.	C	T	9	13	22	0	1	23	0	0
13	23901349	.	T	C	8	17	25	0	0	25	0	0
13	23901502	.	A	G	6	13	19	0	1	20	0	0
13	23901555	.	A	G	11	0	11	0	8	19	0	0
13	23901570	.	T	C	12	5	17	0	1	18	0	0
13	23931192	.	T	C	2	0	2	0	11	13	0	0
13	23940708	.	T	C	5	0	5	0	3	8	0	0
13	23940754	.	C	A	8	2	10	0	0	10	0	0
13	23990189	.	C	A	1	4	5	0	0	5	0	0
13	23996192	.	G	A	4	3	7	0	0	7	0	0
13	23999129	.	G	A	1	3	4	0	0	4	0	0
13	23999264	.	G	C	1	2	3	0	0	3	0	0
13	23999274	.	T	A	1	3	4	0	0	4	0	0
13	24000394	.	G	A	3	2	5	0	0	5	0	0
13	24010630	.	C	T	1	1	2	0	0	2	0	0
13	24014332	.	A	G	1	2	3	0	0	3	0	0
13	24014341	.	G	A	2	1	3	0	0	3	0	0
13	24014578	.	T	C	1	2	3	0	0	3	0	0
13	24018880	.	C	A	1	2	3	0	0	3	0	0
13	24023036	.	G	T	6	8	14	0	1	15	0	0
13	24033958	.	G	T	0	1	1	0	1	2	0	0
13	24034092	.	T	G	1	2	3	0	0	3	0	0
13	24034158	.	A	G	0	2	2	0	0	2	0	0
13	24034206	.	A	G	3	6	9	0	0	9	0	0
13	24034215	.	G	A	3	7	10	0	0	10	0	0
13	24045342	.	C	T	1	2	3	0	0	3	0	0
13	24056221	.	C	T	8	10	18	0	0	18	0	0
13	24068790	.	C	T	1	13	14	0	9	23	0	0
13	24069624	.	C	A	10	13	23	1	0	24	0	0
13	24069902	.	A	T	7	12	19	0	0	19	0	0
13	24070242	.	C	T	0	10	10	0	13	23	0	0
13	24070730	.	C	T	2	8	10	0	1	11	0	0
13	24096437	.	G	T	3	2	5	0	0	5	0	0
13	24234815	.	C	A	4	1	5	0	0	5	0	0
13	24262792	.	C	A	2	1	3	0	1	4	0	0
13	24266814	.	A	G	1	0	1	0	0	1	0	0
13	24268443	.	C	T	1	2	3	0	0	3	0	0
13	24276201	.	T	G	1	2	3	0	0	3	0	0
13	24276241	.	C	A	1	1	2	0	1	3	0	0
13	24276354	.	A	G	1	5	6	0	0	6	0	0
13	24276366	.	C	T	3	4	7	0	0	7	0	0
13	24290132	.	A	T	4	3	7	0	0	7	0	0
13	24290140	.	A	G	5	4	9	0	2	11	0	0
13	24290169	.	T	G	12	0	12	0	9	21	0	0
13	24292374	.	A	G	1	4	5	0	0	5	0	0
13	24292398	.	G	A	6	2	8	0	0	8	0	0
13	24292675	.	A	G	9	6	15	0	0	15	0	0
13	24292727	.	G	A	16	6	22	0	0	22	0	0
13	24292796	.	T	A	11	17	28	0	0	28	0	0
13	24292800	.	A	T	11	17	28	0	1	29	0	0
13	24292947	.	A	T	7	8	15	0	1	16	0	0
13	24293381	.	A	T	18	18	36	0	0	36	0	0
13	24293465	.	C	T	9	20	29	0	11	40	0	0
13	24293516	.	G	A	16	24	40	0	5	45	0	0
13	24293518	.	C	A	19	24	43	0	2	45	0	0
13	24293615	.	G	A	12	21	33	0	9	42	0	0
13	24293698	.	C	T	27	9	36	0	1	37	0	0
13	24293793	.	A	G	16	13	29	0	1	31	1	0
13	24294046	.	A	G	8	14	22	0	0	22	0	0
13	24295907	.	A	T	1	6	7	0	0	7	0	0
13	24295921	.	C	A	1	4	5	0	0	5	0	0
13	24295999	.	T	C	4	3	7	0	0	7	0	0
13	24296071	.	G	A	4	9	13	0	0	13	0	0
13	24296094	.	A	C	4	7	11	0	1	12	0	0
13	24296141	.	G	A	3	2	5	0	1	6	0	0
13	24296250	.	A	G	1	6	7	0	1	8	0	0
13	24303840	.	G	A	1	1	2	0	0	2	0	0
13	24305975	.	T	G	7	7	14	0	0	14	0	0
13	24311510	.	G	A	2	2	4	0	0	4	0	0
13	24371933	.	A	C	1	0	1	0	3	4	0	0
13	24372197	.	C	T	7	5	12	0	0	12	0	0
13	24372392	.	A	G	2	3	5	0	0	5	0	0
13	24372477	.	A	T	4	3	7	0	0	7	0	0
13	24372506	.	G	T	4	3	7	0	1	8	0	0
13	24372533	.	T	A	4	3	7	0	0	7	0	0
13	24372685	.	T	C	4	4	8	0	0	8	0	0
13	24372943	.	C	T	2	4	6	0	1	7	0	0
13	24373081	.	A	G	5	2	7	0	0	7	0	0
13	24378764	.	A	G	3	5	8	0	1	9	0	0
13	24381350	.	A	G	2	2	4	0	0	4	0	0
13	24382137	.	G	A	0	4	4	0	8	12	0	0
13	24382152	.	T	C	7	4	11	0	0	11	0	0
13	24382539	.	T	C	3	4	7	0	0	7	0	0
13	24383589	.	T	G	1	2	3	0	0	3	0	0
13	24401860	.	A	C	1	2	3	0	0	3	0	0
13	24401864	.	C	A	1	2	3	0	0	3	0	0
13	24402560	.	T	C	5	4	9	0	0	9	0	0
13	24411029	.	A	G	16	17	33	0	1	34	0	0
13	24423602	.	C	T	0	2	2	0	0	2	0	0
13	24423652	.	G	T	1	1	2	0	0	2	0	0
13	24423930	.	T	C	2	2	4	0	0	4	0	0
13	24424051	.	G	A	2	5	7	0	0	7	0	0
13	24424260	.	A	T	1	2	3	0	0	3	0	0
13	24424511	.	A	C	2	0	2	0	3	5	0	0
13	24424899	.	T	G	1	3	4	0	1	5	0	0
13	24425005	.	C	A	2	3	5	0	0	5	0	0
13	24425019	.	G	A	3	2	5	0	0	5	0	0
13	24425112	.	T	C	2	0	2	0	2	4	0	0
13	24431365	.	T	G	4	6	10	0	0	10	0	0
13	24432096	.	C	T	14	10	24	0	1	25	0	0
13	24432162	.	G	C	8	9	17	0	0	17	0	0
13	24432350	.	C	T	1	13	14	0	12	26	0	0
13	24436011	.	C	G	5	5	10	0	2	12	0	0
13	24436054	.	G	A	13	9	22	0	0	22	0	0
13	24437225	.	G	A	5	10	15	0	0	15	0	0
13	24447235	.	T	G	7	5	12	0	0	12	0	0
13	24447364	.	G	C	5	10	15	0	0	15	0	0
13	24519911	.	G	A	3	1	4	0	0	4	0	0
13	24519921	.	G	T	0	2	2	0	3	5	0	0
13	24522025	.	A	G	1	2	3	0	0	3	0	0
13	24523425	.	A	G	2	3	5	0	0	5	0	0
13	24523469	.	G	A	0	3	3	0	7	10	0	0
13	24524305	.	T	G	3	3	6	0	0	6	0	0
13	24552508	.	C	T	2	0	2	0	0	2	0	0
13	24580372	.	G	A	2	2	4	0	1	5	0	0
13	24580411	.	G	A	15	11	26	0	0	26	0	0
13	24580705	.	C	T	12	13	25	0	0	25	0	0
13	24580756	.	G	C	0	5	5	0	2	7	0	0
13	24580869	.	T	C	3	5	8	0	0	8	0	0
13	24580941	.	T	C	3	2	5	0	0	5	0	0
13	24581274	.	G	A	7	3	10	0	0	10	0	0
13	24581316	.	C	A	9	15	24	0	1	25	0	0
13	24581334	.	G	C	10	9	19	0	2	21	0	0
13	24581358	.	T	C	3	4	7	0	1	8	0	0
13	24581748	.	A	C	15	8	23	0	0	23	0	0
13	24581798	.	T	A	10	8	18	0	0	18	0	0
13	24581840	.	T	G	17	11	28	0	0	28	0	0
13	24581854	.	C	T	18	12	30	0	2	32	0	0
13	24582047	.	A	G	7	13	20	0	4	24	0	0
13	24582110	.	C	T	6	15	21	0	0	21	0	0
13	24582122	.	T	C	5	16	21	0	0	21	0	0
13	24582211	.	C	T	6	2	8	0	1	9	0	0
13	24582213	.	G	A	3	6	9	0	0	9	0	0
13	24585753	.	G	T	0	1	1	0	0	1	0	0
13	24586121	.	A	C	2	3	5	0	0	5	0	0
13	24586123	.	C	T	2	3	5	0	0	5	0	0
13	24662438	.	T	G	2	3	5	0	1	6	0	0
13	24663222	.	G	C	1	2	3	0	4	7	0	0
13	24663407	.	T	A	5	2	7	0	0	7	0	0
13	24663414	.	C	A	2	4	6	0	0	6	0	0
13	24663456	.	A	G	1	2	3	0	0	3	0	0
13	24663607	.	T	G	4	2	6	0	0	6	0	0
13	24663625	.	C	A	2	2	4	0	1	5	0	0
13	24663899	.	C	A	2	3	5	0	0	5	0	0
13	24663901	.	A	G	3	2	5	0	0	5	0	0
13	24664144	.	T	A	3	6	9	0	0	9	0	0
13	24664167	.	T	C	4	1	5	0	0	5	0	0
13	24665759	.	T	G	0	2	2	0	0	2	0	0
13	24665869	.	C	T	1	1	2	0	0	2	0	0
13	24669108	.	T	C	2	3	5	0	1	6	0	0
13	24702033	.	C	A	0	9	9	0	9	18	0	0
13	24702114	.	T	C	9	6	15	0	0	15	0	0
13	24702415	.	T	C	6	8	14	0	2	16	0	0
13	24702478	.	T	G	9	12	21	0	0	21	0	0
13	24702602	.	T	A	7	6	13	0	1	14	0	0
13	24702652	.	A	T	7	4	11	0	0	11	0	0
13	24702724	.	C	T	8	4	12	0	1	13	0	0
13	24702883	.	A	T	11	7	18	0	0	18	0	0
13	24703354	.	C	A	4	2	6	0	0	6	0	0
13	24703362	.	C	A	2	2	4	0	0	4	0	0
13	24704032	.	A	G	3	4	7	0	0	7	0	0
13	24704102	.	C	A	12	9	21	0	0	21	0	0
13	24716363	.	T	C	10	5	15	0	0	15	0	0
13	24716375	.	A	T	10	5	15	0	0	15	0	0
13	24741212	.	G	A	2	2	4	0	0	4	0	0
13	24744704	.	A	T	0	2	2	0	0	2	0	0
13	24744742	.	A	T	1	3	4	0	0	4	0	0
13	24745047	.	T	C	1	3	4	0	0	4	0	0
13	24745049	.	G	T	1	3	4	0	0	4	0	0
13	24745169	.	A	G	1	2	3	0	0	3	0	0
13	24745188	.	A	C	1	2	3	0	0	3	0	0
13	24745209	.	T	G	1	2	3	0	0	3	0	0
13	24781536	.	G	A	11	14	25	0	0	25	0	0
13	24781580	.	T	C	15	13	28	0	1	29	0	0
13	24781605	.	T	C	13	15	28	0	1	29	0	0
13	24781640	.	G	A	10	15	25	0	0	25	0	0
13	24781713	.	A	G	7	11	18	0	1	19	0	0
13	24781885	.	G	A	12	6	18	0	1	19	0	0
13	24786900	.	T	A	18	15	33	0	0	33	0	0
13	24791020	.	A	G	1	4	5	0	0	5	0	0
13	24791077	.	G	T	2	3	5	0	0	5	0	0
13	24804104	.	C	T	5	3	8	0	0	8	0	0
13	24804224	.	G	C	9	3	12	0	0	12	0	0
13	24804765	.	C	T	6	5	11	0	0	11	0	0
13	24804804	.	A	G	6	4	10	0	0	10	0	0
13	24805068	.	A	C	1	5	6	0	0	6	0	0
13	24805148	.	A	C	5	3	8	0	1	9	0	0
13	24805257	.	T	C	1	0	1	0	1	2	0	0
13	24805687	.	G	A	0	2	2	0	0	2	0	0
13	24806423	.	T	C	2	0	2	0	3	5	0	0
13	24826071	.	C	T	1	2	3	0	0	3	0	0
13	24834446	.	C	T	5	12	17	0	0	17	0	0
13	24837627	.	A	G	11	18	29	0	0	29	0	0
13	24837876	.	T	C	4	11	15	0	0	15	0	0
13	24871866	.	A	G	14	10	24	0	0	24	0	0
13	24872667	.	A	G	12	9	21	0	0	21	0	0
13	24872733	.	G	A	11	7	18	0	0	18	0	0
13	24873141	.	C	A	0	4	4	0	12	16	0	0
13	24873186	.	A	T	5	2	7	0	1	8	0	0
13	24873480	.	A	G	6	8	14	0	2	16	0	0
13	24873579	.	C	T	9	10	19	0	0	19	0	0
13	24874897	.	G	A	10	7	17	0	0	17	0	0
13	24875948	.	A	C	2	1	3	0	0	3	0	0
13	24876425	.	G	A	7	2	9	0	0	9	0	0
13	24878633	.	A	T	0	1	1	0	0	1	0	0
13	24878687	.	T	C	0	1	1	0	1	2	0	0
13	24881635	.	T	C	5	5	10	0	0	10	0	0
13	24885195	.	G	A	1	1	2	0	0	2	0	0
13	24905897	.	G	A	5	3	8	0	0	8	0	0
13	24906196	.	A	T	4	4	8	0	1	9	0	0
13	24918814	.	T	A	9	10	19	0	0	19	0	0
13	24918820	.	T	C	9	11	20	0	2	22	0	0
13	24986203	.	G	A	3	4	7	0	1	8	0	0
13	24986238	.	G	T	7	13	20	0	0	20	0	0
13	24986272	.	T	C	7	0	7	0	16	23	0	0
13	25199240	.	T	C	2	0	2	0	10	12	0	0
13	25202580	.	C	T	1	2	3	0	0	3	0	0
13	25204704	.	T	C	3	3	6	0	0	6	0	0
13	25207064	.	G	C	1	3	4	0	0	4	0	0
13	25207068	.	C	T	1	2	3	0	0	3	0	0
13	25208276	.	A	G	2	3	5	0	0	5	0	0
13	25208484	.	T	G	5	6	11	0	0	11	0	0
13	25208605	.	A	T	1	2	3	0	0	3	0	0
13	25212429	.	T	C	1	2	3	0	0	3	0	0
13	25227166	.	C	T	0	3	3	0	2	5	0	0
13	25284237	.	T	A	1	4	5	0	0	5	0	0
13	25284251	.	G	T	1	2	3	0	0	3	0	0
13	25284281	.	G	C	2	3	5	0	0	5	0	0
13	25365034	.	G	A	3	3	6	0	0	6	0	0
13	25366380	.	T	G	3	2	5	0	0	5	0	0
13	25369449	.	C	T	2	4	6	0	0	6	0	0
13	25371436	.	A	G	10	3	13	0	0	13	0	0
13	25371475	.	C	A	9	7	16	0	0	16	0	0
13	25371918	.	A	G	2	4	6	0	0	6	0	0
13	25378924	.	T	G	15	5	20	0	0	20	0	0
13	25379263	.	A	T	17	9	26	0	2	28	0	0
13	25379304	.	A	G	8	0	8	0	14	22	0	0
13	25379352	.	A	C	6	11	17	0	3	20	0	0
13	25384281	.	T	C	10	5	15	0	0	15	0	0
13	25386904	.	C	T	2	1	3	0	1	4	0	0
13	25388389	.	G	A	7	6	13	0	0	13	0	0
13	25429048	.	T	A	7	3	10	0	0	10	0	0
13	25429145	.	G	A	8	7	15	0	1	16	0	0
13	25429158	.	G	A	9	7	16	0	0	16	0	0
13	25436360	.	A	T	14	5	19	0	0	19	0	0
13	25449688	.	A	C	1	4	5	0	0	5	0	0
13	25449867	.	C	A	1	7	8	0	0	8	0	0
13	25472336	.	G	A	22	15	37	0	0	37	0	0
13	25472735	.	G	A	6	14	20	0	3	23	0	0
13	25472859	.	G	A	20	12	32	0	1	33	0	0
13	25473084	.	T	A	29	21	50	0	2	52	0	0
13	25473325	.	G	A	4	5	9	0	0	9	0	0
13	25474019	.	G	T	18	10	28	0	1	29	0	0
13	25475904	.	A	G	5	8	13	0	0	13	0	0
13	25477304	.	A	G	4	5	9	0	0	9	0	0
13	25495556	.	C	T	3	2	5	0	0	5	0	0
13	25495781	.	G	A	7	2	9	0	2	11	0	0
13	25497320	.	A	G	3	0	3	0	3	6	0	0
13	25497575	.	T	C	5	8	13	0	2	15	0	0
13	25497581	.	C	T	5	10	15	0	0	15	0	0
13	25497700	.	G	C	7	12	19	0	1	20	0	0
13	25497769	.	T	A	10	10	20	0	1	21	0	0
13	25516204	.	T	C	0	2	2	0	0	2	0	0
13	25519063	.	G	A	0	3	3	0	5	8	0	0
13	25523629	.	T	C	8	4	12	0	0	12	0	0
13	25523677	.	G	A	0	3	3	0	7	10	0	0
13	25523680	.	T	A	4	6	10	0	0	10	0	0
13	25525989	.	G	A	7	2	9	0	0	9	0	0
13	25531776	.	T	C	5	8	13	0	1	14	0	0
13	25532352	.	C	T	10	12	22	0	0	22	0	0
13	25532574	.	C	A	16	15	31	0	1	32	0	0
13	25532857	.	A	G	9	9	18	0	0	18	0	0
13	25533233	.	G	A	15	8	23	0	1	24	0	0
13	25533258	.	T	A	13	13	26	0	0	26	0	0
13	25533452	.	A	T	3	10	13	0	0	13	0	0
13	25533657	.	C	G	7	0	7	0	11	18	0	0
13	25533767	.	G	T	13	11	24	0	1	25	0	0
13	25533846	.	G	A	16	9	25	0	0	25	0	0
13	25533897	.	C	T	8	3	11	0	0	11	0	0
13	25534172	.	T	A	7	9	16	0	0	16	0	0
13	25534368	.	A	G	16	1	17	0	23	40	0	0
13	25535405	.	G	A	0	4	4	0	0	4	0	0
13	25549516	.	A	G	4	0	4	0	7	11	0	0
13	25551722	.	A	G	0	0	0	0	1	1	0	0
13	25551781	.	C	A	4	5	9	0	0	9	0	0
13	25551865	.	T	C	8	7	15	1	1	17	0	0
13	25552219	.	T	C	1	0	1	0	0	1	0	0
13	25557325	.	T	A	7	3	10	0	0	10	0	0
13	25560411	.	C	A	0	1	1	0	0	1	0	0
13	25560458	.	A	T	1	2	3	0	1	4	0	0
13	25560471	.	G	A	0	1	1	0	3	4	0	0
13	25563221	.	C	A	4	0	4	0	0	4	0	0
13	25565379	.	T	C	9	13	22	0	2	24	0	0
13	25565985	.	G	A	3	4	7	0	0	7	0	0
13	25565988	.	A	C	3	4	7	0	0	7	0	0
13	25566205	.	A	T	4	3	7	0	0	7	0	0
13	25566222	.	C	T	4	5	9	0	0	9	0	0
13	25569940	.	A	C	6	6	12	0	0	12	0	0
13	25570044	.	C	T	0	3	3	0	1	4	0	0
13	25570104	.	C	T	8	6	14	0	0	14	0	0
13	25570164	.	A	C	6	0	6	0	4	10	0	0
13	25570341	.	T	C	4	1	5	0	7	12	0	0
13	25570410	.	A	G	6	12	18	0	0	18	0	0
13	25570477	.	G	A	10	8	18	0	1	19	0	0
13	25570532	.	A	C	6	1	7	0	5	12	0	0
13	25570709	.	T	C	9	0	9	0	5	14	0	0
13	25570715	.	C	T	9	5	14	0	0	14	0	0
13	25570821	.	T	C	4	7	11	0	0	11	0	0
13	25570854	.	A	T	8	9	17	0	0	17	0	0
13	25571113	.	A	T	5	7	12	0	0	12	0	0
13	25571274	.	C	T	7	8	15	0	1	16	0	0
13	25573146	.	T	C	0	0	0	0	2	2	0	0
13	25575396	.	C	T	2	3	5	0	0	5	0	0
13	25575411	.	A	C	4	3	7	0	0	7	0	0
13	25580764	.	C	A	5	8	13	0	0	13	0	0
13	25584983	.	T	G	2	2	4	0	0	4	0	0
13	25584993	.	A	T	2	2	4	0	0	4	0	0
13	25585757	.	G	A	2	4	6	0	0	6	0	0
13	25585785	.	T	C	1	3	4	0	0	4	0	0
13	25585876	.	G	T	2	2	4	0	0	4	0	0
13	25585879	.	G	A	2	2	4	0	0	4	0	0
13	25589241	.	G	A	4	1	5	0	0	5	0	0
13	25590736	.	A	G	0	2	2	0	0	2	0	0
13	25592311	.	C	A	0	1	1	0	0	1	0	0
13	25592347	.	T	C	0	1	1	0	0	1	0	0
13	25593832	.	T	C	1	0	1	0	0	1	0	0
13	25726201	.	C	T	5	9	14	0	0	14	0	0
13	25726308	.	A	C	2	6	8	0	0	8	0	0
13	25728606	.	A	T	5	2	7	0	0	7	0	0
13	25728882	.	T	C	4	2	6	0	0	6	0	0
13	25729076	.	C	T	3	2	5	0	1	6	0	0
13	25735324	.	C	A	0	1	1	0	0	1	0	0
13	25737993	.	G	A	0	1	1	0	0	1	0	0
13	25738083	.	G	A	1	2	3	0	0	3	0	0
13	25750830	.	G	A	3	5	8	0	1	9	0	0
13	25750868	.	A	T	2	5	7	0	0	7	0	0
13	25763104	.	T	A	1	2	3	0	0	3	0	0
13	25795635	.	T	C	4	2	6	0	0	6	0	0
13	25824718	.	C	T	14	13	27	0	2	29	0	0
13	25825016	.	G	A	12	15	27	0	0	27	0	0
13	25825445	.	A	T	6	5	11	0	0	11	0	0
13	25827421	.	G	A	4	6	10	0	0	10	0	0
13	25842020	.	T	C	3	0	3	0	8	11	0	0
13	25852674	.	T	C	3	0	3	0	4	7	0	0
13	25923392	.	A	G	13	13	26	0	3	29	0	0
13	25923450	.	A	T	12	12	24	0	1	25	0	0
13	25924388	.	C	T	11	9	20	0	1	21	0	0
13	25924523	.	C	T	9	8	17	0	1	18	0	0
13	27036660	.	T	C	9	12	21	0	0	21	0	0
13	27036676	.	T	C	9	4	13	0	0	13	0	0
13	27038163	.	G	A	3	2	5	0	0	5	0	0
13	27107520	.	C	T	8	5	13	0	0	13	0	0
13	27189877	.	A	T	2	0	2	0	0	2	0	0
13	27190435	.	C	T	1	4	5	0	0	5	0	0
13	27201552	.	G	A	1	0	1	0	0	1	0	0
13	27201624	.	A	T	2	0	2	0	0	2	0	0
13	27209852	.	T	C	3	2	5	0	0	5	0	0
13	27227407	.	C	A	5	3	8	0	0	8	0	0
13	27277165	.	T	G	2	0	2	0	2	4	0	0
13	27277351	.	A	G	0	1	1	0	2	3	0	0
13	27277579	.	C	T	2	2	4	0	0	4	0	0
13	27278032	.	T	C	1	3	4	0	1	5	0	0
13	27293810	.	C	T	3	3	6	0	0	6	0	0
13	27293821	.	G	T	3	2	5	0	0	5	0	0
13	27293903	.	A	G	3	2	5	0	0	5	0	0
13	27293966	.	T	G	2	2	4	0	0	4	0	0
13	27294187	.	G	T	0	3	3	0	0	3	0	0
13	27294212	.	G	T	0	5	5	0	0	5	0	0
13	27294656	.	G	A	1	2	3	0	1	4	0	0
13	27294663	.	C	T	1	3	4	0	0	4	0	0
13	27294838	.	C	T	4	2	6	0	0	6	0	0
13	27294840	.	T	G	4	0	4	0	2	6	0	0
13	27295459	.	T	C	2	4	6	0	0	6	0	0
13	27295488	.	C	T	2	6	8	0	0	8	0	0
13	27295607	.	C	T	6	1	7	0	0	7	0	0
13	27296291	.	T	C	7	3	10	0	0	10	0	0
13	27296396	.	G	A	5	5	10	0	0	10	0	0
13	27296415	.	T	A	2	5	7	0	0	7	0	0
13	27296433	.	A	G	3	2	5	0	0	5	0	0
13	27296576	.	C	T	3	7	10	0	0	10	0	0
13	27296616	.	T	C	3	4	7	0	1	8	0	0
13	27309128	.	T	G	13	0	13	0	6	19	0	0
13	27312888	.	G	A	5	3	8	0	0	8	0	0
13	27312938	.	C	T	5	5	10	0	0	10	0	0
13	27313044	.	A	C	1	2	3	0	0	3	0	0
13	27313066	.	G	T	1	3	4	0	0	4	0	0
13	27313310	.	T	A	13	8	21	0	1	22	0	0
13	27316778	.	G	T	2	2	4	0	1	5	0	0
13	27317026	.	C	T	14	21	35	0	1	36	0	0
13	27320771	.	C	T	3	0	3	0	0	3	0	0
13	27320996	.	G	A	1	10	11	0	16	27	0	0
13	27321211	.	C	T	32	29	61	0	4	65	0	0
13	27323976	.	G	A	2	23	25	0	17	42	0	0
13	27324341	.	A	T	26	27	53	0	2	55	0	0
13	27324346	.	T	C	28	27	55	0	2	57	0	0
13	27634324	.	T	C	16	11	27	0	1	28	0	0
13	27634789	.	A	G	18	14	32	0	0	32	0	0
13	27641472	.	T	C	2	5	7	0	0	7	0	0
13	27675462	.	T	C	9	0	9	0	5	14	0	0
13	27685329	.	C	T	0	5	5	0	7	12	0	0
13	27685363	.	G	A	2	13	15	0	0	15	0	0
13	27685446	.	C	T	8	7	15	0	0	15	0	0
13	27685552	.	G	A	15	10	25	0	1	26	0	0
13	27685583	.	C	T	0	11	11	0	17	28	0	0
13	27686252	.	G	A	8	7	15	0	1	16	0	0
13	27686405	.	G	A	15	12	27	0	1	28	0	0
13	27771607	.	T	G	6	0	6	0	3	9	0	0
13	27782402	.	A	T	2	3	5	0	0	5	0	0
13	27782585	.	G	A	6	2	8	0	0	8	0	0
13	27951758	.	T	A	14	9	23	0	0	23	0	0
13	27951827	.	G	A	0	6	6	0	5	11	0	0
13	27951883	.	A	G	6	0	6	0	8	14	0	0
13	27952156	.	C	T	9	6	15	0	1	16	0	0
13	27952414	.	A	G	18	11	29	0	0	29	0	0
13	27952441	.	G	T	17	7	24	0	0	24	0	0
13	28009108	.	C	T	14	18	32	0	2	34	0	0
13	28009159	.	G	A	7	10	17	0	2	19	0	0
13	28009178	.	A	C	6	13	19	0	0	19	0	0
13	28009246	.	A	T	17	21	38	0	0	38	0	0
13	28009567	.	G	A	14	11	25	0	0	25	0	0
13	28010183	.	G	A	19	26	45	0	3	48	0	0
13	28010214	.	C	A	5	21	26	0	26	52	0	0
13	28495945	.	C	T	3	4	7	0	0	7	0	0
13	28498793	.	G	A	0	1	1	0	1	2	0	0
13	28498812	.	G	A	2	1	3	0	0	3	0	0
13	28500674	.	T	C	1	1	2	0	0	2	0	0
13	28561116	.	T	C	2	4	6	0	0	6	0	0
13	28561184	.	T	C	3	1	4	0	0	4	0	0
13	28561190	.	A	T	3	2	5	0	0	5	0	0
13	28561244	.	G	C	3	4	7	0	0	7	0	0
13	28561304	.	T	A	8	3	11	0	0	11	0	0
13	28596166	.	T	C	4	5	9	0	0	9	0	0
13	28596429	.	C	T	4	2	6	0	0	6	0	0
13	28596659	.	C	T	2	2	4	0	0	4	0	0
13	28596739	.	A	G	1	0	1	0	7	8	0	0
13	28615556	.	C	T	8	9	17	0	0	17	0	0
13	28632432	.	A	G	2	2	4	0	0	4	0	0
13	28632492	.	G	A	0	4	4	0	0	4	0	0
13	28642816	.	A	C	4	3	7	0	0	7	0	0
13	28642825	.	C	A	3	5	8	0	0	8	0	0
13	28643087	.	C	T	4	3	7	0	0	7	0	0
13	28649848	.	A	C	8	5	13	0	0	13	0	0
13	28650239	.	A	T	12	9	21	0	0	21	0	0
13	28650416	.	G	C	9	11	20	0	0	20	0	0
13	28650683	.	A	G	12	12	24	0	0	25	1	0
13	28650945	.	T	C	15	6	21	0	3	24	0	0
13	28650954	.	T	G	6	17	23	0	0	23	0	0
13	28650984	.	A	G	11	11	22	0	0	22	0	0
13	28651214	.	C	A	0	23	23	0	12	35	0	0
13	28665065	.	C	T	2	2	4	0	0	4	0	0
13	28676134	.	G	C	8	14	22	0	0	22	0	0
13	28676241	.	A	G	11	6	17	0	1	18	0	0
13	28676358	.	G	A	8	2	10	0	0	10	0	0
13	28676472	.	C	G	11	0	11	0	5	16	0	0
13	28680634	.	T	A	6	17	23	0	0	23	0	0
13	28680847	.	T	A	8	6	14	0	0	14	0	0
13	28692778	.	C	T	0	5	5	0	0	5	0	0
13	28694384	.	C	A	5	2	7	0	0	7	0	0
13	28694390	.	C	T	5	3	8	0	0	8	0	0
13	28694664	.	T	C	5	11	16	0	2	18	0	0
13	28701246	.	G	A	0	1	1	0	4	5	0	0
13	28743835	.	C	T	8	13	21	0	1	22	0	0
13	28744061	.	C	A	3	7	10	0	0	10	0	0
13	28744495	.	G	A	1	12	13	0	14	27	0	0
13	28744775	.	C	T	7	6	13	0	0	13	0	0
13	28744831	.	C	T	4	5	9	0	1	10	0	0
13	28745801	.	T	G	5	17	22	1	0	23	0	0
13	28745934	.	C	A	4	9	13	0	0	14	1	0
13	28746033	.	G	A	5	15	20	0	1	21	0	0
13	28786565	.	T	C	1	4	5	0	0	5	0	0
13	28792362	.	C	T	1	2	3	0	0	3	0	0
13	28827315	.	T	A	0	1	1	0	0	1	0	0
13	28841987	.	C	T	13	9	22	0	1	23	0	0
13	28841990	.	G	T	14	9	23	0	0	23	0	0
13	28848209	.	C	G	1	1	2	0	0	2	0	0
13	28848220	.	G	A	2	4	6	0	0	6	0	0
13	28848473	.	C	T	1	0	1	0	1	2	0	0
13	28865700	.	T	C	15	11	26	0	6	32	0	0
13	28866413	.	A	T	21	13	34	0	2	36	0	0
13	28866518	.	C	T	23	13	36	0	1	37	0	0
13	28866590	.	A	G	22	23	45	0	1	46	0	0
13	28866615	.	C	T	24	24	48	0	2	50	0	0
13	28866722	.	T	C	17	23	40	0	2	42	0	0
13	28866810	.	G	A	18	23	41	0	1	42	0	0
13	28866857	.	G	A	0	18	18	0	19	37	0	0
13	28867159	.	G	A	0	21	21	0	26	47	0	0
13	28867367	.	C	T	22	20	42	0	0	42	0	0
13	28867382	.	A	T	19	24	43	0	3	46	0	0
13	28870917	.	T	C	30	25	55	0	3	58	0	0
13	28871055	.	T	C	3	5	8	0	1	9	0	0
13	28901714	.	T	A	31	20	51	0	0	51	0	0
13	28902058	.	C	T	16	10	26	0	0	26	0	0
13	28902169	.	C	T	20	11	31	0	1	32	0	0
13	28902170	.	C	G	20	12	32	0	0	32	0	0
13	28902215	.	T	C	20	12	32	0	0	32	0	0
13	29223894	.	G	A	1	1	2	0	0	2	0	0
13	29226250	.	T	A	1	4	5	0	0	5	0	0
13	29226764	.	C	T	0	3	3	0	0	3	0	0
13	29296096	.	G	C	3	6	9	0	0	9	0	0
13	29298856	.	G	T	0	1	1	0	3	4	0	0
13	29333853	.	C	A	9	6	15	0	0	15	0	0
13	29346927	.	G	A	0	7	7	0	3	10	0	0
13	29347156	.	G	A	0	2	2	0	5	7	0	0
13	29347674	.	G	A	5	3	8	1	0	9	0	0
13	29347745	.	A	C	13	15	28	0	1	29	0	0
13	29357115	.	T	A	0	2	2	0	0	2	0	0
13	29374514	.	C	T	4	2	6	0	0	6	0	0
13	29381047	.	A	C	8	8	16	0	0	16	0	0
13	29385786	.	A	G	0	1	1	0	0	1	0	0
13	29385894	.	G	A	3	5	8	0	1	9	0	0
13	29392238	.	C	T	4	1	5	0	0	5	0	0
13	29395207	.	C	A	3	5	8	0	1	9	0	0
13	29395236	.	C	T	2	1	3	0	0	3	0	0
13	29402613	.	T	G	9	7	16	0	1	17	0	0
13	29402669	.	C	T	3	5	8	0	0	8	0	0
13	29402681	.	A	C	2	4	6	0	0	6	0	0
13	29403957	.	C	T	15	8	23	0	2	25	0	0
13	29404003	.	G	A	9	8	17	0	1	18	0	0
13	29404145	.	T	C	11	4	15	0	2	17	0	0
13	29404218	.	T	A	8	13	21	0	1	22	0	0
13	29404399	.	A	T	16	14	30	0	2	32	0	0
13	29404400	.	C	T	13	14	27	0	5	32	0	0
13	29404997	.	C	T	2	2	4	0	0	4	0	0
13	29407802	.	T	G	12	11	23	0	0	23	0	0
13	29408226	.	T	C	6	8	14	0	0	14	0	0
13	29408499	.	G	A	5	4	9	0	1	10	0	0
13	29408530	.	C	T	1	4	5	0	2	7	0	0
13	29408650	.	A	G	3	10	13	0	1	14	0	0
13	29408989	.	G	A	3	13	16	0	0	16	0	0
13	29409239	.	G	A	6	5	11	0	0	11	0	0
13	29412299	.	G	A	1	3	4	0	0	4	0	0
13	29414441	.	G	C	0	1	1	0	0	1	0	0
13	29414546	.	A	G	2	3	5	0	0	5	0	0
13	29415202	.	G	A	2	4	6	0	0	6	0	0
13	29417091	.	G	A	6	11	17	0	1	18	0	0
13	29419508	.	G	A	2	4	6	0	0	6	0	0
13	29419583	.	G	A	2	4	6	0	1	7	0	0
13	29420849	.	A	T	2	0	2	0	0	2	0	0
13	29421211	.	G	T	1	1	2	0	0	2	0	0
13	29421296	.	C	T	8	7	15	0	0	15	0	0
13	29422499	.	C	G	0	7	7	0	2	9	0	0
13	29422808	.	G	A	6	5	11	0	1	12	0	0
13	29449256	.	G	A	6	3	9	0	0	9	0	0
13	29450479	.	T	C	1	2	3	0	0	3	0	0
13	29455199	.	C	T	5	2	7	0	0	7	0	0
13	29455573	.	A	G	3	6	9	0	0	9	0	0
13	29771323	.	T	C	3	4	7	0	0	7	0	0
13	29802607	.	C	A	10	10	20	0	0	20	0	0
13	29802633	.	A	G	4	6	10	0	0	10	0	0
13	29803253	.	C	T	3	4	7	0	0	7	0	0
13	29803801	.	G	A	1	6	7	0	0	7	0	0
13	29804178	.	T	A	4	2	6	0	0	6	0	0
13	29804362	.	T	C	3	10	13	0	0	13	0	0
13	29804800	.	G	A	3	2	5	0	0	5	0	0
13	29926221	.	G	A	1	1	2	0	0	2	0	0
13	29926242	.	C	T	1	1	2	0	0	2	0	0
13	29928675	.	A	G	6	9	15	0	0	15	0	0
13	29935371	.	A	G	6	8	14	0	1	15	0	0
13	29935678	.	T	G	2	4	6	0	0	6	0	0
13	29935682	.	T	C	2	6	8	0	0	8	0	0
13	29935983	.	C	G	3	2	5	0	0	5	0	0
13	29952902	.	C	T	1	3	4	0	0	4	0	0
13	29952914	.	G	A	2	3	5	0	1	6	0	0
13	29952972	.	C	T	5	7	12	0	1	14	1	0
13	29952973	.	A	T	7	7	14	0	0	14	0	0
13	29953265	.	T	G	6	7	13	0	1	14	0	0
13	29953267	.	C	A	7	7	14	0	0	14	0	0
13	29953383	.	G	T	10	4	14	0	0	14	0	0
13	29953522	.	T	C	10	0	10	0	7	17	0	0
13	29958513	.	T	A	7	5	12	0	3	15	0	0
13	29958551	.	G	A	8	5	13	0	1	14	0	0
13	29958725	.	A	G	0	1	1	0	0	1	0	0
13	29965856	.	G	A	5	6	11	0	0	11	0	0
13	29979966	.	T	C	8	7	15	0	0	15	0	0
13	29992598	.	C	T	0	2	2	0	3	5	0	0
13	29992625	.	G	T	3	2	5	0	0	5	0	0
13	29993072	.	C	T	0	2	2	0	1	3	0	0
13	30008596	.	A	T	26	22	48	0	3	52	1	0
13	30008631	.	T	C	17	16	33	0	5	38	0	0
13	30008737	.	T	C	18	19	37	0	0	37	0	0
13	30009128	.	G	C	6	3	9	0	0	9	0	0
13	30009818	.	A	C	25	29	54	0	1	55	0	0
13	30009968	.	T	C	14	16	30	4	0	34	0	0
13	30010059	.	C	A	31	13	44	0	0	44	0	0
13	30021321	.	T	A	12	9	21	0	1	22	0	0
13	30027133	.	T	G	13	13	26	0	2	28	0	0
13	30027372	.	G	A	7	4	11	0	1	12	0	0
13	30027378	.	G	A	7	4	11	0	1	12	0	0
13	30027523	.	T	A	16	4	20	0	0	20	0	0
13	30027659	.	C	T	5	9	14	0	0	14	0	0
13	30039013	.	C	T	2	11	13	0	1	14	0	0
13	30041662	.	G	A	5	1	6	0	0	6	0	0
13	30043395	.	T	G	6	0	6	0	3	9	0	0
13	30043579	.	A	G	3	4	7	0	0	7	0	0
13	30106137	.	C	G	12	0	12	0	6	18	0	0
13	30112396	.	C	T	11	14	25	0	0	25	0	0
13	30112414	.	T	A	5	6	11	0	1	12	0	0
13	30115125	.	A	G	8	6	14	0	0	14	0	0
13	30115217	.	C	T	5	5	10	0	1	11	0	0
13	30125106	.	G	A	0	1	1	0	0	1	0	0
13	30125107	.	T	C	0	1	1	0	0	1	0	0
13	30131722	.	G	T	20	25	45	0	3	48	0	0
13	30131804	.	G	A	21	26	47	0	0	47	0	0
13	30132190	.	T	C	33	17	50	0	0	50	0	0
13	30138763	.	T	A	2	1	3	0	0	3	0	0
13	30145000	.	A	C	1	2	3	0	1	4	0	0
13	30145217	.	A	G	7	9	16	0	0	16	0	0
13	30145514	.	T	A	2	5	7	0	0	7	0	0
13	30145616	.	T	A	7	5	12	0	0	12	0	0
13	30145660	.	T	C	3	3	6	0	0	6	0	0
13	30145662	.	C	A	2	3	5	0	1	6	0	0
13	30146199	.	C	A	3	5	8	0	0	8	0	0
13	30146447	.	T	A	1	3	4	0	1	5	0	0
13	30152310	.	A	C	4	6	10	0	0	10	0	0
13	30152502	.	G	C	13	8	21	0	0	21	0	0
13	30155934	.	C	T	2	12	14	0	2	16	0	0
13	30155973	.	T	A	1	4	5	0	0	5	0	0
13	30156176	.	T	C	3	6	9	0	1	10	0	0
13	30156347	.	A	T	1	7	8	0	0	8	0	0
13	30158975	.	A	G	11	8	19	0	0	19	0	0
13	30159823	.	C	T	0	2	2	0	0	2	0	0
13	30161553	.	T	A	12	7	19	0	1	20	0	0
13	30166340	.	C	A	17	10	27	0	1	28	0	0
13	30167097	.	C	A	1	4	5	0	0	5	0	0
13	30167430	.	T	G	10	16	26	0	1	27	0	0
13	30167432	.	A	G	10	17	27	0	0	27	0	0
13	30167711	.	G	A	18	22	40	0	1	41	0	0
13	30167716	.	T	C	18	26	44	0	1	45	0	0
13	30167807	.	G	A	1	16	17	0	22	39	0	0
13	30168662	.	T	A	20	6	26	0	1	27	0	0
13	30181124	.	T	G	2	2	4	0	0	4	0	0
13	30181125	.	T	G	2	2	4	0	0	4	0	0
13	30186853	.	G	A	2	3	5	0	0	5	0	0
13	30186857	.	A	G	1	0	1	0	4	5	0	0
13	30186997	.	C	T	1	3	4	0	0	4	0	0
13	30190019	.	A	T	4	6	10	0	1	11	0	0
13	30190031	.	C	T	4	6	10	0	0	10	0	0
13	30199107	.	T	G	4	5	9	0	0	9	0	0
13	30199148	.	G	A	10	8	18	0	0	18	0	0
13	30199190	.	T	C	10	3	13	0	0	13	0	0
13	30229090	.	A	G	29	4	33	0	36	69	0	0
13	30234351	.	A	C	2	8	10	0	0	10	0	0
13	30235107	.	G	C	3	2	5	0	0	5	0	0
13	30498325	.	A	G	1	0	1	0	8	9	0	0
13	30509281	.	A	G	0	0	0	0	1	1	0	0
13	30551479	.	T	C	4	6	10	0	0	10	0	0
13	30552253	.	A	G	1	0	1	0	4	5	0	0
13	30552504	.	T	A	5	5	10	0	0	10	0	0
13	30552605	.	C	G	0	1	1	0	0	1	0	0
13	30552915	.	T	C	1	0	1	0	0	1	0	0
13	30553002	.	C	T	5	7	12	0	1	13	0	0
13	30553404	.	T	C	4	7	11	0	1	12	0	0
13	30553682	.	C	T	14	8	22	0	2	24	0	0
13	30555751	.	G	A	5	2	7	0	0	7	0	0
13	30556278	.	C	T	7	6	13	0	0	13	0	0
13	30558555	.	C	A	1	1	2	0	1	3	0	0
13	30558896	.	T	C	1	2	3	0	0	3	0	0
13	30559044	.	A	G	4	2	6	0	0	6	0	0
13	30562079	.	T	G	8	3	11	0	0	11	0	0
13	30562673	.	T	C	1	5	6	0	1	7	0	0
13	30568158	.	T	C	9	6	15	0	0	15	0	0
13	30568176	.	A	G	8	0	8	0	5	13	0	0
13	30568316	.	T	A	7	6	13	0	1	14	0	0
13	30568875	.	A	G	10	11	21	0	2	23	0	0
13	30569650	.	A	C	6	3	9	0	0	9	0	0
13	30569687	.	A	G	4	3	7	0	0	7	0	0
13	30572333	.	A	C	2	5	7	0	1	8	0	0
13	30575206	.	G	A	2	0	2	0	0	2	0	0
13	30575325	.	A	G	0	0	0	0	1	1	0	0
13	30575452	.	C	A	5	2	7	0	0	7	0	0
13	30575637	.	T	A	8	5	13	0	0	13	0	0
13	30579552	.	A	G	3	7	10	0	0	10	0	0
13	30579565	.	A	G	3	6	9	0	0	9	0	0
13	30579792	.	T	C	8	0	8	0	4	12	0	0
13	30580409	.	A	C	1	4	5	0	0	5	0	0
13	30580465	.	T	G	2	2	4	0	0	4	0	0
13	30580493	.	T	C	1	2	3	0	0	3	0	0
13	30580935	.	T	C	10	1	11	0	12	23	0	0
13	30580966	.	T	G	8	8	16	0	0	16	0	0
13	30581329	.	C	T	1	4	5	0	6	11	0	0
13	30581334	.	A	T	7	4	11	0	0	11	0	0
13	30581686	.	A	T	2	4	6	0	0	6	0	0
13	30581755	.	C	T	2	5	7	0	0	7	0	0
13	30582347	.	T	C	1	0	1	0	4	5	0	0
13	30582461	.	T	C	0	1	1	0	7	8	0	0
13	30582468	.	A	G	1	8	9	0	0	9	0	0
13	30582729	.	G	A	3	3	6	0	0	6	0	0
13	30582781	.	G	A	6	2	8	0	0	8	0	0
13	30583036	.	C	G	3	1	4	0	0	4	0	0
13	30583056	.	A	G	3	3	6	0	0	6	0	0
13	30583099	.	C	G	0	3	3	0	4	7	0	0
13	30583306	.	T	C	1	3	4	0	0	4	0	0
13	30583336	.	A	G	1	2	3	0	0	3	0	0
13	30583514	.	T	C	1	2	3	0	0	3	0	0
13	30583664	.	T	A	3	3	6	0	0	6	0	0
13	30584007	.	G	A	2	2	4	0	0	4	0	0
13	30584052	.	A	T	3	2	5	0	0	5	0	0
13	30584332	.	G	A	7	4	11	0	0	11	0	0
13	30817617	.	G	T	5	11	16	0	0	16	0	0
13	30817633	.	G	A	5	10	15	0	0	15	0	0
13	30817786	.	A	G	1	3	4	0	0	4	0	0
13	30817790	.	A	G	1	0	1	0	2	3	0	0
13	30817872	.	A	G	7	0	7	0	9	16	0	0
13	30817951	.	C	T	13	11	24	0	1	25	0	0
13	30817983	.	T	C	16	6	22	0	0	22	0	0
13	30818107	.	C	G	13	12	25	0	0	25	0	0
13	30818246	.	C	T	12	22	34	0	1	35	0	0
13	30818319	.	A	T	10	8	18	0	1	19	0	0
13	30818674	.	G	A	0	10	10	0	2	12	0	0
13	30818849	.	A	G	12	14	26	0	0	26	0	0
13	30818876	.	C	T	11	9	20	0	0	20	0	0
13	30818986	.	T	A	10	4	14	0	1	15	0	0
13	30819133	.	G	C	19	22	41	0	0	41	0	0
13	30819334	.	T	C	16	10	26	0	2	28	0	0
13	30819444	.	A	T	6	9	15	0	1	16	0	0
13	30819445	.	T	G	6	10	16	0	0	16	0	0
13	30819645	.	T	C	1	2	3	0	0	3	0	0
13	30875163	.	T	C	1	2	3	0	0	3	0	0
13	30876555	.	C	T	4	2	6	0	0	6	0	0
13	30878903	.	A	G	1	3	4	0	0	4	0	0
13	30879062	.	G	A	2	2	4	0	0	4	0	0
13	30892629	.	C	T	2	3	5	0	0	5	0	0
13	30903921	.	T	A	4	1	5	0	0	5	0	0
13	30905716	.	T	C	4	6	10	0	1	11	0	0
13	30906016	.	A	G	4	4	8	0	0	8	0	0
13	30906190	.	A	T	1	2	3	0	0	3	0	0
13	30908977	.	T	C	3	4	7	0	0	7	0	0
13	30909200	.	C	T	2	3	5	0	0	5	0	0
13	30909624	.	T	A	1	4	5	0	0	5	0	0
13	30951287	.	C	T	1	0	1	0	0	1	0	0
13	30964041	.	G	T	0	2	2	0	2	4	0	0
13	32795615	.	G	A	3	5	8	0	0	8	0	0
13	33099501	.	C	T	0	1	1	0	0	1	0	0
13	33101816	.	C	T	0	2	2	0	0	2	0	0
13	33122120	.	G	A	4	8	12	0	0	12	0	0
13	33122276	.	T	A	8	6	14	0	0	14	0	0
13	33122429	.	C	G	3	11	14	0	0	14	0	0
13	33122524	.	C	T	7	10	17	0	0	17	0	0
13	33122554	.	A	T	8	9	17	0	0	17	0	0
13	33122586	.	G	A	14	6	20	0	0	20	0	0
13	33122594	.	G	A	15	5	20	0	0	20	0	0
13	33122626	.	A	T	17	5	22	0	0	22	0	0
13	33122642	.	G	A	14	8	22	0	0	22	0	0
13	33122756	.	A	G	9	19	28	0	1	29	0	0
13	33122773	.	G	T	10	18	28	0	1	29	0	0
13	33122795	.	C	A	10	14	24	0	2	26	0	0
13	33122941	.	C	T	17	5	22	0	0	22	0	0
13	33122949	.	G	C	20	3	23	0	0	23	0	0
13	33122986	.	A	G	8	0	8	0	15	23	0	0
13	33123031	.	T	A	4	17	21	0	0	21	0	0
13	33123154	.	C	A	13	5	18	0	1	19	0	0
13	33155657	.	A	G	3	2	5	0	0	5	0	0
13	33155680	.	C	T	3	2	5	0	0	5	0	0
13	33158301	.	A	G	2	1	3	0	0	3	0	0
13	33158304	.	C	A	0	1	1	0	2	3	0	0
13	33158352	.	T	C	2	0	2	0	0	2	0	0
13	33159446	.	C	T	0	3	3	0	0	3	0	0
13	33174865	.	T	G	6	6	12	0	2	14	0	0
13	33175097	.	A	C	2	6	8	0	0	8	0	0
13	33175190	.	A	G	5	7	12	0	1	13	0	0
13	33175202	.	T	C	5	0	5	0	5	10	0	0
13	33175314	.	A	G	2	4	6	0	0	6	0	0
13	33177425	.	G	T	2	1	3	0	0	3	0	0
13	33177637	.	A	G	3	1	4	0	0	4	0	0
13	33187199	.	G	A	1	2	3	0	0	3	0	0
13	33187760	.	G	A	3	4	7	0	0	7	0	0
13	33190245	.	A	G	1	0	1	0	0	1	0	0
13	33194242	.	C	T	3	4	7	0	0	7	0	0
13	33194245	.	A	G	3	4	7	0	0	7	0	0
13	33194490	.	A	C	1	1	2	0	2	4	0	0
13	33194527	.	G	C	1	6	7	0	0	7	0	0
13	33194854	.	A	T	5	6	11	0	0	11	0	0
13	33195489	.	C	T	0	4	4	0	1	5	0	0
13	33195529	.	T	C	3	3	6	0	0	6	0	0
13	33196036	.	A	G	1	3	4	0	0	4	0	0
13	33196395	.	T	C	1	3	4	0	0	4	0	0
13	33196426	.	A	T	1	4	5	0	0	5	0	0
13	33196656	.	A	G	4	6	10	0	0	10	0	0
13	33197897	.	C	T	0	2	2	0	0	2	0	0
13	33198070	.	G	A	1	3	4	0	0	4	0	0
13	33200187	.	C	T	1	3	4	0	0	4	0	0
13	33211445	.	A	T	7	6	13	0	0	13	0	0
13	33214492	.	T	C	1	0	1	0	0	1	0	0
13	33214664	.	C	T	0	8	8	0	2	10	0	0
13	33214706	.	C	T	7	13	20	0	1	21	0	0
13	33214709	.	T	C	7	15	22	0	0	22	0	0
13	33214804	.	G	A	10	9	19	0	0	19	0	0
13	33214985	.	C	T	8	1	9	0	0	9	0	0
13	33216341	.	G	A	9	13	22	0	0	22	0	0
13	33218037	.	T	C	9	5	14	0	1	15	0	0
13	33218214	.	C	T	4	4	8	0	1	9	0	0
13	33219988	.	C	A	0	6	6	0	4	10	0	0
13	33220164	.	A	G	3	5	8	0	0	8	0	0
13	33222342	.	C	A	0	4	4	0	4	8	0	0
13	33222396	.	G	A	3	5	8	0	0	8	0	0
13	33224678	.	G	A	6	5	11	0	0	11	0	0
13	33224706	.	T	G	4	6	10	0	1	11	0	0
13	33224716	.	G	A	5	3	8	0	0	8	0	0
13	33224742	.	G	T	7	4	11	0	0	11	0	0
13	33225049	.	A	G	6	6	12	0	0	12	0	0
13	33227271	.	G	C	5	7	12	0	2	14	0	0
13	33229502	.	T	G	8	8	16	0	1	17	0	0
13	33229739	.	T	C	11	16	27	0	1	28	0	0
13	33229753	.	C	T	11	14	25	0	1	26	0	0
13	33230024	.	A	T	17	15	32	0	2	34	0	0
13	33230163	.	G	C	16	13	29	0	1	30	0	0
13	33230177	.	G	A	12	14	26	0	1	27	0	0
13	33230518	.	T	C	6	1	7	0	10	17	0	0
13	33236111	.	T	C	5	4	9	0	0	9	0	0
13	33236482	.	G	T	0	6	6	0	0	6	0	0
13	33236902	.	C	T	5	1	6	0	0	6	0	0
13	33238954	.	A	G	11	21	32	0	0	32	0	0
13	33238960	.	G	A	13	23	36	0	0	36	0	0
13	33239237	.	T	C	8	1	9	0	8	17	0	0
13	33242878	.	C	T	5	4	9	0	0	9	0	0
13	33246227	.	T	A	6	10	16	0	0	16	0	0
13	33246249	.	T	A	9	13	22	0	1	23	0	0
13	33248255	.	T	C	11	5	16	0	0	16	0	0
13	33248308	.	C	T	5	10	15	0	0	15	0	0
13	33248443	.	T	C	8	11	19	0	0	19	0	0
13	33250992	.	T	A	9	14	23	0	0	23	0	0
13	33251058	.	C	G	1	1	2	0	3	5	0	0
13	33253722	.	G	A	1	1	2	0	0	2	0	0
13	33261198	.	A	G	14	17	31	0	0	31	0	0
13	33261620	.	T	C	20	13	33	0	1	34	0	0
13	33261637	.	G	A	18	6	24	0	2	31	5	0
13	33261889	.	C	T	14	29	43	0	2	45	0	0
13	33262909	.	G	T	9	32	41	0	1	42	0	0
13	33262944	.	C	G	10	26	36	0	0	36	0	0
13	33262956	.	C	A	8	22	30	0	0	30	0	0
13	33262997	.	A	G	5	26	31	0	1	32	0	0
13	33263138	.	C	A	3	7	10	0	1	11	0	0
13	33263385	.	G	A	4	6	10	0	0	10	0	0
13	33263568	.	G	A	16	19	35	0	1	36	0	0
13	33263670	.	T	A	15	12	27	0	1	28	0	0
13	33263685	.	T	C	19	14	33	0	0	33	0	0
13	33263774	.	G	A	12	8	20	1	0	21	0	0
13	33263860	.	A	T	22	1	23	0	0	23	0	0
13	33263940	.	T	C	10	12	22	0	3	25	0	0
13	33263985	.	C	A	14	8	22	0	1	23	0	0
13	33264001	.	G	A	16	11	27	0	1	28	0	0
13	33264483	.	T	A	18	16	34	0	0	34	0	0
13	33264519	.	C	T	0	14	14	0	15	29	0	0
13	33264550	.	T	C	13	13	26	0	1	27	0	0
13	33264635	.	A	T	13	10	23	0	0	23	0	0
13	33264772	.	A	T	13	14	27	0	2	29	0	0
13	33265128	.	T	C	18	0	18	0	17	35	0	0
13	33265210	.	T	G	20	28	48	0	0	48	0	0
13	33271252	.	G	A	0	3	3	0	1	4	0	0
13	33271332	.	C	T	5	2	7	0	0	7	0	0
13	33276011	.	G	A	1	5	6	0	0	6	0	0
13	33276192	.	C	G	4	0	4	0	3	7	0	0
13	33282138	.	G	T	0	7	7	0	4	11	0	0
13	33293608	.	C	A	4	4	8	0	0	8	0	0
13	33295894	.	T	A	1	3	4	0	0	4	0	0
13	33298859	.	G	C	2	0	2	0	0	2	0	0
13	33300425	.	T	A	2	3	5	0	0	5	0	0
13	33310619	.	C	T	2	2	4	0	0	4	0	0
13	33310635	.	C	A	2	3	5	0	0	5	0	0
13	33311074	.	G	A	3	1	4	0	0	4	0	0
13	33314863	.	T	C	1	5	6	0	0	6	0	0
13	33314946	.	T	C	4	5	9	0	1	10	0	0
13	33314974	.	T	A	3	8	11	0	0	11	0	0
13	33315099	.	T	C	3	0	3	0	6	9	0	0
13	33315112	.	C	G	1	2	3	0	0	3	0	0
13	33317022	.	T	C	3	2	5	0	0	5	0	0
13	33368531	.	C	T	2	3	5	0	1	6	0	0
13	33368549	.	T	A	2	2	4	0	0	4	0	0
13	33373901	.	C	T	0	1	1	0	0	1	0	0
13	33394476	.	A	C	20	22	42	0	1	43	0	0
13	33394887	.	G	A	14	23	37	0	1	38	0	0
13	33394976	.	T	C	11	24	35	0	1	36	0	0
13	33395174	.	C	G	14	21	35	0	0	35	0	0
13	33395256	.	T	G	9	18	27	0	1	28	0	0
13	33396026	.	A	C	2	0	2	0	6	8	0	0
13	33398365	.	C	T	15	17	32	0	2	34	0	0
13	33398445	.	C	A	0	7	7	0	8	15	0	0
13	33398498	.	G	A	9	6	15	0	0	15	0	0
13	33398668	.	C	A	4	12	16	0	1	17	0	0
13	33411068	.	C	T	3	3	6	0	1	7	0	0
13	33411082	.	G	A	3	4	7	0	1	8	0	0
13	33445279	.	G	A	0	1	1	0	0	1	0	0
13	33447168	.	T	A	1	3	4	0	0	4	0	0
13	33447175	.	A	G	1	0	1	0	3	4	0	0
13	33447260	.	C	T	3	2	5	0	1	6	0	0
13	33447281	.	A	G	4	2	6	0	1	7	0	0
13	33447389	.	T	C	3	3	6	0	0	6	0	0
13	33448057	.	T	G	2	5	7	0	0	7	0	0
13	33448063	.	T	A	1	5	6	0	1	7	0	0
13	33614712	.	C	A	3	3	6	0	0	6	0	0
13	33614751	.	T	C	2	1	3	0	0	3	0	0
13	33616880	.	T	C	2	0	2	0	0	2	0	0
13	33619849	.	A	G	2	3	5	0	0	5	0	0
13	33624713	.	C	G	5	4	9	0	0	9	0	0
13	33625095	.	T	C	5	4	9	0	0	9	0	0
13	33633271	.	T	A	5	4	9	0	0	9	0	0
13	33633303	.	A	C	2	2	4	0	0	4	0	0
13	33636073	.	G	T	6	4	10	0	3	13	0	0
13	33636434	.	T	G	2	4	6	0	1	7	0	0
13	33636548	.	T	C	4	0	4	0	3	7	0	0
13	33636814	.	G	A	2	4	6	0	1	7	0	0
13	33645569	.	C	T	4	7	11	0	0	11	0	0
13	33645754	.	T	C	4	6	10	0	0	10	0	0
13	33645838	.	A	C	5	3	8	0	0	8	0	0
13	33645839	.	A	T	5	3	8	0	0	8	0	0
13	33645922	.	C	T	3	3	6	0	0	6	0	0
13	33645931	.	C	T	3	2	5	0	1	6	0	0
13	33646059	.	A	G	4	4	8	0	0	8	0	0
13	33646063	.	C	G	4	4	8	0	0	8	0	0
13	33646285	.	G	A	4	4	8	0	1	9	0	0
13	33646401	.	G	A	3	5	8	0	1	9	0	0
13	33646403	.	G	A	3	6	9	0	0	9	0	0
13	33646458	.	T	G	3	3	6	0	0	6	0	0
13	33646514	.	A	G	1	4	5	0	0	5	0	0
13	33646545	.	A	G	2	5	7	0	0	7	0	0
13	33646615	.	G	A	4	6	10	0	2	12	0	0
13	33649184	.	T	G	4	4	8	0	0	8	0	0
13	33652588	.	A	G	0	1	1	0	0	1	0	0
13	33654890	.	G	A	2	7	9	0	0	9	0	0
13	33654902	.	T	C	1	5	6	0	1	7	0	0
13	33682048	.	C	A	16	13	29	0	0	29	0	0
13	33682474	.	T	G	5	7	12	0	0	12	0	0
13	33682482	.	A	T	8	9	17	0	0	17	0	0
13	33682682	.	G	A	32	20	52	0	1	53	0	0
13	33682731	.	G	A	18	14	32	0	0	32	0	0
13	33683609	.	T	C	2	3	5	0	0	5	0	0
13	33683696	.	A	G	21	37	58	0	4	62	0	0
13	33683701	.	G	C	23	41	64	0	1	65	0	0
13	33692046	.	T	C	0	2	2	0	0	2	0	0
13	33813428	.	A	C	13	6	19	0	1	20	0	0
13	33816161	.	C	A	14	4	18	0	0	18	0	0
13	33816335	.	T	C	3	0	3	0	3	6	0	0
13	33816509	.	A	G	1	4	5	0	0	5	0	0
13	33968506	.	T	C	3	3	6	0	0	6	0	0
13	33968509	.	C	T	3	3	6	0	0	6	0	0
13	34217398	.	C	T	5	3	8	0	0	8	0	0
13	34519607	.	T	A	4	1	5	1	0	6	0	0
13	34523224	.	G	A	4	2	6	0	0	6	0	0
13	34689727	.	C	T	6	2	8	0	0	8	0	0
13	34690105	.	T	A	0	1	1	0	0	1	0	0
13	34746179	.	A	C	1	3	4	0	0	4	0	0
13	34746487	.	A	G	2	0	2	0	2	4	0	0
13	34746713	.	C	G	2	0	2	0	8	10	0	0
13	34746735	.	A	T	3	5	8	0	0	8	0	0
13	34746752	.	A	G	3	0	3	0	5	8	0	0
13	34746941	.	A	G	2	0	2	0	2	4	0	0
13	34747254	.	C	T	2	4	6	0	0	6	0	0
13	34747260	.	G	T	2	4	6	0	0	6	0	0
13	34747291	.	G	C	2	7	9	0	0	9	0	0
13	34747734	.	A	G	3	0	3	0	2	5	0	0
13	34747916	.	A	C	3	4	7	0	1	8	0	0
13	34748062	.	A	T	3	3	6	0	0	6	0	0
13	34748086	.	G	T	3	2	5	0	0	5	0	0
13	34748479	.	A	G	3	3	6	0	1	7	0	0
13	34748527	.	G	A	5	5	10	0	0	10	0	0
13	34748570	.	C	A	7	8	15	0	0	15	0	0
13	34748642	.	T	A	1	2	3	0	0	3	0	0
13	34748891	.	A	T	1	9	10	0	0	10	0	0
13	34748892	.	G	A	0	9	9	0	1	10	0	0
13	34749079	.	G	T	2	2	4	0	0	4	0	0
13	34749366	.	T	C	1	2	3	0	0	3	0	0
13	34749536	.	A	T	5	2	7	0	0	7	0	0
13	34749693	.	C	T	7	3	10	0	0	10	0	0
13	34749751	.	C	T	3	4	7	0	1	8	0	0
13	34749786	.	A	C	8	5	13	0	2	15	0	0
13	34749819	.	C	T	9	8	17	0	1	18	0	0
13	34749833	.	A	G	11	9	20	0	0	20	0	0
13	34765383	.	G	A	2	2	4	0	1	5	0	0
13	34765480	.	G	A	7	4	11	0	0	11	0	0
13	34765569	.	T	G	2	4	6	0	0	6	0	0
13	34765778	.	G	C	3	6	9	0	0	9	0	0
13	34765780	.	T	G	3	6	9	0	0	9	0	0
13	34766238	.	G	A	4	2	6	0	0	6	0	0
13	34771824	.	T	C	0	4	4	0	0	4	0	0
13	35049461	.	A	G	4	0	4	0	0	4	0	0
13	35389195	.	A	G	2	2	4	0	0	4	0	0
13	35475021	.	G	A	2	3	5	0	0	5	0	0
13	35475213	.	A	C	0	2	2	0	0	2	0	0
13	35511074	.	A	G	4	2	6	0	1	7	0	0
13	35511339	.	A	G	4	4	8	0	0	8	0	0
13	35511612	.	C	T	5	5	10	0	0	10	0	0
13	35522132	.	A	G	1	2	3	0	0	3	0	0
13	35527647	.	G	T	3	6	9	0	0	9	0	0
13	35722421	.	A	G	1	0	1	0	0	1	0	0
13	35723494	.	G	A	0	2	2	0	4	6	0	0
13	35728714	.	A	G	0	1	1	0	0	1	0	0
13	35744250	.	A	T	0	2	2	0	0	2	0	0
13	35744314	.	T	A	0	2	2	0	0	2	0	0
13	35745657	.	T	C	13	8	21	0	0	21	0	0
13	35745686	.	T	C	16	6	22	0	0	22	0	0
13	35746775	.	T	C	6	4	10	0	0	10	0	0
13	35746838	.	T	C	7	4	11	0	1	12	0	0
13	35747420	.	T	C	7	8	15	0	0	15	0	0
13	35747510	.	G	A	10	12	22	0	0	22	0	0
13	35747564	.	A	G	13	12	25	0	1	26	0	0
13	35747690	.	A	G	14	1	15	0	17	32	0	0
13	35747918	.	T	C	17	25	42	0	1	43	0	0
13	35747954	.	T	C	18	21	39	0	2	41	0	0
13	35748096	.	C	G	16	0	16	0	10	26	0	0
13	35748109	.	C	G	16	14	30	0	0	30	0	0
13	35748144	.	A	G	17	12	29	0	1	30	0	0
13	35748238	.	T	A	16	9	25	0	0	25	0	0
13	35748319	.	T	C	15	8	23	0	0	23	0	0
13	35748412	.	A	C	10	14	24	0	1	25	0	0
13	35748541	.	G	A	3	3	6	0	0	6	0	0
13	35751047	.	T	C	4	8	12	0	0	12	0	0
13	35751162	.	T	A	13	12	25	0	1	26	0	0
13	35751211	.	T	C	10	9	19	0	1	20	0	0
13	35752964	.	T	C	1	0	1	0	0	1	0	0
13	35755976	.	C	T	3	1	4	0	0	4	0	0
13	35755985	.	T	C	3	4	7	0	0	7	0	0
13	35756029	.	G	T	5	6	11	0	0	11	0	0
13	35757260	.	G	A	5	6	11	0	0	11	0	0
13	35757338	.	T	G	6	6	12	0	1	13	0	0
13	35787722	.	G	A	0	2	2	0	2	4	0	0
13	35787735	.	T	C	2	1	3	0	0	3	0	0
13	35788128	.	G	T	4	14	18	0	1	19	0	0
13	35788497	.	T	G	8	10	18	0	2	20	0	0
13	35788503	.	T	C	8	12	20	0	1	21	0	0
13	35788562	.	C	G	2	18	20	0	8	29	1	0
13	35791419	.	C	G	10	9	19	0	2	21	0	0
13	35791455	.	A	G	8	11	19	0	1	20	0	0
13	35791539	.	G	A	5	3	8	0	0	8	0	0
13	35798915	.	A	G	5	2	7	0	0	7	0	0
13	35799146	.	G	A	1	3	4	0	0	4	0	0
13	35799194	.	C	T	2	5	7	0	0	7	0	0
13	35799200	.	G	T	2	5	7	0	0	7	0	0
13	35799230	.	A	G	1	2	3	0	0	3	0	0
13	35801413	.	C	G	6	4	10	0	0	10	0	0
13	35801419	.	A	G	7	5	12	0	0	12	0	0
13	35801452	.	A	G	4	9	13	0	0	13	0	0
13	35801473	.	A	G	8	9	17	0	0	17	0	0
13	35801501	.	T	C	5	0	5	0	6	11	0	0
13	35803109	.	T	C	1	0	1	0	2	3	0	0
13	35808197	.	G	T	1	4	5	0	0	5	0	0
13	35808949	.	T	C	4	5	9	0	0	9	0	0
13	35811400	.	A	G	2	3	5	0	0	5	0	0
13	35820971	.	G	A	3	6	9	0	0	9	0	0
13	35821781	.	G	A	1	1	2	0	0	2	0	0
13	35824278	.	A	G	1	3	4	0	0	4	0	0
13	35824599	.	A	G	2	6	8	0	0	8	0	0
13	35824905	.	G	A	1	2	3	0	0	3	0	0
13	35824932	.	G	A	1	1	2	0	1	3	0	0
13	35825145	.	A	G	4	3	7	0	0	7	0	0
13	35825166	.	G	A	5	2	7	0	0	7	0	0
13	35844912	.	A	G	3	8	11	0	0	11	0	0
13	35856492	.	C	G	2	9	11	0	0	11	0	0
13	35856785	.	C	T	4	6	10	0	1	11	0	0
13	35856826	.	T	C	6	8	14	0	0	14	0	0
13	35866381	.	A	G	2	4	6	0	1	7	0	0
13	35866465	.	G	C	6	4	10	0	0	10	0	0
13	35866561	.	G	T	6	4	10	0	0	10	0	0
13	35866675	.	T	G	5	2	7	0	0	7	0	0
13	35871825	.	C	T	7	14	21	0	0	21	0	0
13	35872125	.	A	T	5	6	11	0	0	11	0	0
13	35872418	.	G	C	4	4	8	0	0	8	0	0
13	35904738	.	C	T	0	2	2	0	2	4	0	0
13	35904775	.	C	G	2	6	8	0	0	8	0	0
13	35904964	.	G	A	1	2	3	0	0	3	0	0
13	35925668	.	T	A	3	3	6	0	0	6	0	0
13	35925671	.	G	T	3	2	5	0	0	5	0	0
13	35931116	.	G	A	0	2	2	0	2	4	0	0
13	35940059	.	A	T	1	3	4	0	0	4	0	0
13	35940074	.	A	T	1	3	4	0	0	4	0	0
13	35941320	.	G	C	0	1	1	0	1	2	0	0
13	35942217	.	G	T	0	1	1	0	0	1	0	0
13	35942220	.	T	C	0	1	1	0	0	1	0	0
13	36039711	.	C	T	5	6	11	0	0	11	0	0
13	36039807	.	T	C	10	9	19	0	0	19	0	0
13	36039828	.	T	C	12	1	13	0	7	20	0	0
13	36040061	.	G	T	13	19	32	0	7	39	0	0
13	36040127	.	A	T	26	25	51	0	2	53	0	0
13	36040429	.	C	T	17	5	22	0	0	22	0	0
13	36040473	.	A	C	7	3	10	0	0	10	0	0
13	36040635	.	C	A	4	6	10	0	0	10	0	0
13	36044370	.	C	T	3	4	7	0	0	7	0	0
13	36047444	.	G	A	1	2	3	0	0	3	0	0
13	36048658	.	A	C	2	5	7	0	0	7	0	0
13	36054289	.	A	G	12	7	19	0	0	19	0	0
13	36054432	.	A	C	9	6	15	0	0	15	0	0
13	36054962	.	T	C	15	9	24	0	1	25	0	0
13	36079184	.	T	C	3	0	3	0	3	6	0	0
13	36079205	.	G	A	3	3	6	0	0	6	0	0
13	36086466	.	T	C	2	2	4	0	0	4	0	0
13	36088851	.	A	G	1	1	2	0	0	2	0	0
13	36098884	.	G	A	2	4	6	0	0	6	0	0
13	36102785	.	T	C	5	5	10	0	1	11	0	0
13	36103082	.	A	G	1	5	6	0	0	6	0	0
13	36103461	.	C	T	8	3	11	0	0	11	0	0
13	36103760	.	G	A	2	4	6	0	0	6	0	0
13	36103985	.	C	A	0	2	2	0	1	3	0	0
13	36134325	.	G	A	2	6	8	0	0	8	0	0
13	36135416	.	A	G	3	4	7	0	1	8	0	0
13	36136585	.	A	G	3	1	4	0	0	4	0	0
13	36136669	.	C	G	0	3	3	0	3	6	0	0
13	36138360	.	G	A	5	5	10	0	0	10	0	0
13	36139749	.	T	C	0	0	0	0	1	1	0	0
13	36146596	.	G	A	13	6	19	0	2	21	0	0
13	36151234	.	G	A	0	7	7	0	12	19	0	0
13	36151462	.	G	A	11	4	15	0	1	16	0	0
13	36151635	.	T	C	9	10	19	0	0	19	0	0
13	36151858	.	G	C	10	9	19	0	2	21	0	0
13	36151868	.	A	G	11	10	21	0	1	22	0	0
13	36151894	.	G	C	10	11	21	0	0	21	0	0
13	36151929	.	C	T	10	13	23	0	0	23	0	0
13	36152030	.	C	A	16	13	29	0	0	29	0	0
13	36152069	.	A	C	16	12	28	0	0	28	0	0
13	36152102	.	T	A	17	25	42	0	0	42	0	0
13	36152108	.	T	C	19	23	42	0	2	44	0	0
13	36152202	.	T	C	15	18	33	0	3	36	0	0
13	36152269	.	T	G	11	19	30	0	1	31	0	0
13	36152364	.	T	C	21	22	43	0	0	43	0	0
13	36152402	.	C	T	25	22	47	0	1	48	0	0
13	36152415	.	A	G	21	24	45	0	0	45	0	0
13	36152440	.	T	G	20	2	22	0	16	38	0	0
13	36152700	.	T	A	17	8	25	0	0	25	0	0
13	36152733	.	A	G	11	7	18	0	0	18	0	0
13	36152758	.	C	T	12	10	22	0	0	22	0	0
13	36152778	.	A	G	9	13	22	0	0	22	0	0
13	36152795	.	A	C	7	11	18	0	0	18	0	0
13	36152838	.	A	G	2	0	2	0	11	13	0	0
13	36152874	.	C	T	3	6	9	0	0	9	0	0
13	36153063	.	T	A	2	4	6	0	0	6	0	0
13	36153098	.	G	A	3	3	6	0	0	6	0	0
13	36153112	.	G	T	2	2	4	0	1	5	0	0
13	36153183	.	A	T	6	3	9	0	0	9	0	0
13	36153313	.	T	C	8	10	18	0	1	19	0	0
13	36153382	.	C	T	9	7	16	0	2	18	0	0
13	36164668	.	G	A	2	3	5	0	0	5	0	0
13	36168740	.	G	A	1	0	1	0	1	2	0	0
13	36168770	.	C	T	3	0	3	0	1	4	0	0
13	36168788	.	C	T	0	3	3	0	5	8	0	0
13	36168846	.	T	C	4	0	4	0	3	7	0	0
13	36170636	.	A	G	5	5	10	0	1	11	0	0
13	36175915	.	A	G	3	7	10	0	0	10	0	0
13	36179661	.	G	C	3	4	7	0	0	7	0	0
13	36179697	.	C	T	2	2	4	0	3	7	0	0
13	36312103	.	C	G	7	3	10	0	1	11	0	0
13	36312193	.	G	T	8	6	14	0	1	15	0	0
13	36312361	.	C	A	4	7	11	0	0	11	0	0
13	36312447	.	A	G	4	4	8	0	0	8	0	0
13	36312469	.	T	G	7	3	10	0	0	10	0	0
13	36312497	.	C	T	0	4	4	0	9	13	0	0
13	36312682	.	G	A	7	1	8	0	0	8	0	0
13	36321256	.	C	T	2	4	6	0	0	6	0	0
13	36322099	.	C	T	0	8	8	0	13	21	0	0
13	36322133	.	A	G	14	9	23	0	1	24	0	0
13	36330642	.	G	A	5	12	17	0	0	17	0	0
13	36335033	.	G	A	2	3	5	0	0	5	0	0
13	36335057	.	A	G	1	1	2	0	0	2	0	0
13	36335206	.	A	G	0	1	1	0	0	1	0	0
13	36337349	.	T	C	4	0	4	0	0	4	0	0
13	36338262	.	A	G	2	1	3	0	1	4	0	0
13	36349674	.	G	A	0	1	1	0	0	1	0	0
13	36409233	.	A	T	4	6	10	0	0	10	0	0
13	36409246	.	C	T	4	5	9	0	0	9	0	0
13	36409522	.	T	C	6	0	6	0	3	9	0	0
13	36409691	.	A	G	6	6	12	0	0	12	0	0
13	36410339	.	T	C	3	7	10	0	1	11	0	0
13	36410671	.	T	C	6	7	13	0	0	13	0	0
13	36418648	.	G	T	1	2	3	0	0	3	0	0
13	36418735	.	A	T	0	1	1	0	0	1	0	0
13	36424414	.	G	A	3	3	6	0	0	6	0	0
13	36452721	.	T	C	2	0	2	0	10	12	0	0
13	36452977	.	A	G	7	5	12	0	1	13	0	0
13	36461642	.	T	C	1	0	1	0	2	3	0	0
13	36465595	.	C	T	1	1	2	0	0	2	0	0
13	36465604	.	A	G	0	1	1	0	0	1	0	0
13	36466321	.	C	G	1	1	2	0	0	2	0	0
13	36467504	.	G	A	2	0	2	0	0	2	0	0
13	36467558	.	G	A	2	0	2	0	0	2	0	0
13	36471262	.	A	G	2	8	10	0	0	10	0	0
13	36484865	.	A	G	1	0	1	0	0	1	0	0
13	36530629	.	A	G	30	28	58	0	2	60	0	0
13	36531957	.	A	G	3	3	6	0	0	6	0	0
13	36532607	.	G	T	31	22	53	0	3	56	0	0
13	36532752	.	G	A	38	15	53	0	0	53	0	0
13	36533174	.	C	T	22	15	37	0	1	38	0	0
13	36534273	.	T	C	7	5	12	0	0	12	0	0
13	36537510	.	T	A	12	7	19	0	0	19	0	0
13	36568658	.	A	T	1	2	3	0	0	3	0	0
13	36568867	.	A	G	14	11	25	0	0	25	0	0
13	36568897	.	G	A	14	12	26	0	0	26	0	0
13	36569020	.	A	T	12	15	27	0	1	28	0	0
13	36569330	.	G	A	5	4	9	0	2	11	0	0
13	36579281	.	G	A	19	9	28	0	3	31	0	0
13	36579356	.	G	C	22	16	38	0	1	39	0	0
13	36589020	.	G	A	8	7	15	0	0	15	0	0
13	36589365	.	C	T	0	2	2	0	0	2	0	0
13	36589556	.	A	G	5	3	8	0	0	8	0	0
13	36592521	.	A	G	21	1	22	0	26	48	0	0
13	36592619	.	G	T	16	14	30	0	3	33	0	0
13	36592732	.	T	C	19	17	36	0	0	36	0	0
13	36592952	.	A	G	18	17	35	0	2	37	0	0
13	36592969	.	T	C	21	20	41	0	1	42	0	0
13	36593052	.	G	A	27	14	41	0	0	41	0	0
13	36593121	.	C	T	13	16	29	0	1	30	0	0
13	36593278	.	T	C	21	29	50	0	1	51	0	0
13	36593478	.	C	A	9	12	21	0	0	21	0	0
13	36605649	.	G	A	3	16	19	0	18	37	0	0
13	36605682	.	T	C	20	15	35	0	1	36	0	0
13	36605811	.	T	C	17	7	24	0	0	24	0	0
13	36605851	.	G	A	2	5	7	0	15	22	0	0
13	36606023	.	T	C	1	9	10	0	3	13	0	0
13	36606073	.	C	A	8	5	13	0	1	14	0	0
13	36606422	.	C	T	16	12	28	0	0	28	0	0
13	36606576	.	A	G	9	2	11	0	1	12	0	0
13	36606632	.	A	T	6	9	15	0	2	17	0	0
13	36606657	.	C	T	9	11	20	0	0	20	0	0
13	36606724	.	C	A	12	8	20	0	0	21	1	0
13	36606725	.	A	G	12	9	21	0	0	21	0	0
13	36625784	.	T	C	3	0	3	0	0	3	0	0
13	36636464	.	A	G	13	1	14	0	21	35	0	0
13	36636491	.	C	T	7	11	18	0	1	19	0	0
13	36638783	.	C	T	11	12	23	0	1	24	0	0
13	36638906	.	C	A	7	5	12	0	0	12	0	0
13	36639424	.	A	G	8	9	17	0	0	17	0	0
13	36639598	.	C	T	7	8	15	0	0	15	0	0
13	36640032	.	A	G	10	13	23	0	1	24	0	0
13	36640063	.	G	C	10	9	19	0	0	19	0	0
13	36640555	.	T	G	8	12	20	0	6	26	0	0
13	36647442	.	A	G	6	2	8	0	0	8	0	0
13	36647553	.	C	T	1	3	4	0	0	4	0	0
13	36655240	.	C	T	7	3	10	0	0	10	0	0
13	36655258	.	T	C	4	3	7	0	0	7	0	0
13	36655884	.	T	C	1	3	4	0	1	5	0	0
13	36795576	.	G	A	6	2	8	0	0	8	0	0
13	37076502	.	T	C	6	3	9	0	0	9	0	0
13	38304824	.	A	G	7	7	14	0	0	14	0	0
13	38446709	.	A	G	8	0	8	0	2	10	0	0
13	38466196	.	G	A	2	0	2	0	1	3	0	0
13	38466247	.	C	T	11	7	18	0	0	18	0	0
13	38466343	.	T	C	3	6	9	0	1	10	0	0
13	38583699	.	C	A	22	12	34	0	0	34	0	0
13	38583714	.	A	G	22	11	33	0	1	34	0	0
13	38593559	.	A	G	25	22	47	0	0	47	0	0
13	38593574	.	A	T	29	16	45	0	0	45	0	0
13	38622184	.	C	T	1	6	7	0	11	18	0	0
13	38666128	.	G	A	7	5	12	0	0	12	0	0
13	39111051	.	G	A	1	3	4	0	0	4	0	0
13	39111169	.	A	T	2	2	4	0	0	4	0	0
13	39111894	.	G	C	0	3	3	0	1	4	0	0
13	39112434	.	C	T	4	2	6	0	0	6	0	0
13	39112550	.	A	G	1	2	3	0	0	3	0	0
13	39112612	.	G	A	0	4	4	0	1	5	0	0
13	39112664	.	T	C	1	2	3	0	1	4	0	0
13	39114388	.	C	A	2	1	3	0	0	4	1	0
13	39115534	.	A	G	1	0	1	0	3	4	0	0
13	39217377	.	C	T	6	6	12	0	1	13	0	0
13	39217506	.	C	T	9	5	14	0	1	15	0	0
13	39217657	.	C	T	7	8	15	0	1	16	0	0
13	39217887	.	T	G	7	0	7	0	3	10	0	0
13	39218060	.	T	C	7	6	13	0	1	14	0	0
13	39218097	.	A	G	5	8	13	0	1	14	0	0
13	39218133	.	C	A	5	4	9	0	0	9	0	0
13	39218292	.	C	T	5	5	10	0	1	11	0	0
13	39218602	.	A	G	4	1	5	0	7	12	0	0
13	39218706	.	T	C	5	3	8	0	0	8	0	0
13	39218843	.	G	A	0	7	7	0	7	14	0	0
13	39221960	.	T	C	3	1	4	0	0	4	0	0
13	39223774	.	A	G	2	3	5	0	0	5	0	0
13	39226666	.	T	C	6	6	12	0	0	12	0	0
13	39227275	.	G	A	1	5	6	0	8	14	0	0
13	39270178	.	A	G	0	1	1	0	1	2	0	0
13	39303161	.	A	C	0	2	2	0	0	2	0	0
13	39364580	.	G	A	1	0	1	0	0	1	0	0
13	39657068	.	A	G	7	7	14	0	1	15	0	0
13	39657140	.	C	T	0	6	6	0	4	10	0	0
13	39657156	.	T	G	4	5	9	0	0	9	0	0
13	39830807	.	G	T	1	3	4	0	0	4	0	0
13	39830811	.	A	G	0	3	3	0	0	3	0	0
13	40335087	.	T	G	6	11	17	0	0	17	0	0
13	40335135	.	T	G	9	0	9	0	9	18	0	0
13	40344258	.	C	T	5	4	9	0	0	9	0	0
13	40344303	.	G	A	1	9	10	0	9	19	0	0
13	40351869	.	G	A	7	9	16	0	1	17	0	0
13	40351914	.	G	A	0	11	11	0	8	19	0	0
13	40351953	.	C	T	9	9	18	0	0	18	0	0
13	40352345	.	C	T	10	14	24	0	0	24	0	0
13	40352349	.	C	G	10	13	23	0	1	24	0	0
13	40352415	.	T	G	8	15	23	0	0	23	0	0
13	40352476	.	A	G	7	7	14	0	0	14	0	0
13	40352556	.	A	G	10	2	12	0	0	12	0	0
13	40352559	.	A	G	8	3	11	0	1	12	0	0
13	40353512	.	G	T	11	10	21	0	2	23	0	0
13	40353736	.	A	C	7	11	18	0	0	18	0	0
13	40445253	.	C	T	5	2	7	0	2	9	0	0
13	40463310	.	C	A	5	3	8	0	0	8	0	0
13	40463732	.	C	T	0	7	7	0	8	15	0	0
13	40481324	.	A	T	0	1	1	0	0	1	0	0
13	40482568	.	T	A	0	7	7	0	0	7	0	0
13	40486656	.	G	A	3	0	3	0	0	3	0	0
13	40497631	.	G	A	0	2	2	0	0	2	0	0
13	40497928	.	C	T	5	3	8	0	0	8	0	0
13	40498129	.	C	G	0	4	4	0	2	6	0	0
13	40498267	.	A	G	5	5	10	0	2	12	0	0
13	40498294	.	G	A	4	6	10	0	1	11	0	0
13	40498759	.	G	A	4	3	7	0	0	7	0	0
13	40707586	.	T	C	0	1	1	0	0	1	0	0
13	40716262	.	T	C	1	2	3	0	0	3	0	0
13	40746548	.	G	A	1	3	4	0	0	4	0	0
13	40746930	.	C	A	0	4	4	0	4	8	0	0
13	40746971	.	G	T	4	3	7	0	0	7	0	0
13	40747151	.	T	C	5	7	12	0	0	12	0	0
13	40747256	.	T	A	4	10	14	0	0	14	0	0
13	40747274	.	T	C	5	0	5	0	7	12	0	0
13	40747337	.	T	A	4	4	8	0	1	9	0	0
13	40747397	.	C	A	4	4	8	0	0	8	0	0
13	40747398	.	C	A	1	4	5	0	3	8	0	0
13	40747467	.	C	T	0	2	2	0	5	7	0	0
13	40747607	.	G	T	2	2	4	0	0	4	0	0
13	40747839	.	T	C	3	7	10	0	2	12	0	0
13	40747841	.	T	C	5	1	6	0	6	12	0	0
13	40748074	.	A	G	3	2	5	0	0	5	0	0
13	40748246	.	A	C	7	4	11	0	2	13	0	0
13	40748248	.	C	A	9	4	13	0	0	13	0	0
13	40748310	.	T	G	5	4	9	0	0	9	0	0
13	40748356	.	G	T	5	5	10	0	1	11	0	0
13	40748408	.	C	T	3	3	6	0	0	6	0	0
13	40748431	.	G	A	3	4	7	0	0	7	0	0
13	40748582	.	G	A	2	5	7	0	0	7	0	0
13	40748620	.	C	T	4	3	7	0	0	7	0	0
13	40748621	.	T	A	4	3	7	0	0	7	0	0
13	40749268	.	A	T	1	2	3	0	0	3	0	0
13	40749577	.	G	A	4	6	10	0	0	10	0	0
13	41125475	.	C	T	4	6	10	0	0	10	0	0
13	41125652	.	C	T	3	4	7	0	0	7	0	0
13	41125766	.	A	G	5	6	11	0	0	11	0	0
13	41128286	.	G	A	1	0	1	0	0	1	0	0
13	41214782	.	A	G	0	1	1	0	0	1	0	0
13	41214863	.	G	A	3	3	6	0	0	6	0	0
13	41222971	.	A	G	4	6	10	0	0	10	0	0
13	41249277	.	T	C	0	1	1	0	0	1	0	0
13	41288990	.	A	G	3	3	6	0	0	6	0	0
13	41289189	.	T	C	1	1	2	0	0	2	0	0
13	41320070	.	G	C	4	2	6	0	0	6	0	0
13	41910428	.	G	A	6	5	11	0	0	11	0	0
13	41910955	.	T	C	15	4	19	0	0	19	0	0
13	41911090	.	G	A	21	12	33	0	2	35	0	0
13	41911092	.	C	A	12	23	35	0	0	35	0	0
13	41911265	.	G	A	9	11	20	0	0	20	0	0
13	41911276	.	T	C	7	15	22	0	1	23	0	0
13	41911597	.	G	T	17	11	28	0	2	30	0	0
13	41911932	.	A	G	6	6	12	0	0	12	0	0
13	41915604	.	A	G	17	12	29	0	0	29	0	0
13	41917003	.	C	A	6	4	10	0	1	11	0	0
13	41922046	.	T	C	2	0	2	0	0	2	0	0
13	41940198	.	G	A	0	2	2	0	3	5	0	0
13	41944269	.	T	A	2	3	5	0	0	5	0	0
13	41944446	.	T	G	1	2	3	0	0	3	0	0
13	41944815	.	C	A	0	6	6	0	4	10	0	0
13	41945455	.	C	T	4	3	7	0	1	8	0	0
13	41945464	.	C	T	0	2	2	0	3	5	0	0
13	41945632	.	C	T	0	8	8	0	4	12	0	0
13	41945737	.	A	G	3	3	6	0	0	6	0	0
13	41945762	.	T	A	5	2	7	0	0	7	0	0
13	41947874	.	C	T	5	3	8	0	0	8	0	0
13	41947882	.	C	T	0	4	4	0	5	9	0	0
13	42016063	.	G	T	3	2	5	0	0	5	0	0
13	42016391	.	T	C	0	7	7	0	0	7	0	0
13	42018012	.	C	T	4	5	9	0	1	10	0	0
13	42018048	.	A	G	3	0	3	0	3	6	0	0
13	42018175	.	A	C	4	2	6	0	0	6	0	0
13	42018304	.	A	T	5	2	7	0	0	7	0	0
13	42018338	.	G	A	0	3	3	0	2	5	0	0
13	42018394	.	T	C	1	2	3	0	0	3	0	0
13	42066135	.	T	C	1	0	1	0	8	9	0	0
13	42142194	.	C	A	6	10	16	0	1	17	0	0
13	42142296	.	T	C	3	3	6	0	3	9	0	0
13	42142854	.	G	A	7	4	11	0	3	14	0	0
13	42143118	.	G	A	0	9	9	0	7	16	0	0
13	42143285	.	A	T	7	7	14	0	1	15	0	0
13	42143294	.	T	G	9	10	19	0	0	19	0	0
13	42309890	.	C	A	1	3	4	0	0	5	1	0
13	42319544	.	G	A	2	6	8	0	0	8	0	0
13	42321191	.	C	T	2	2	4	0	0	4	0	0
13	42349499	.	C	T	6	3	9	0	0	9	0	0
13	42349683	.	C	T	8	9	17	0	0	17	0	0
13	42361795	.	A	G	13	6	19	0	0	19	0	0
13	42365043	.	A	G	1	2	3	0	0	3	0	0
13	42365121	.	T	C	6	8	14	0	0	14	0	0
13	42365139	.	T	C	9	0	9	0	7	16	0	0
13	42365374	.	C	T	6	8	14	0	1	15	0	0
13	42400391	.	T	A	3	9	12	0	0	12	0	0
13	42400473	.	C	T	11	6	17	0	0	17	0	0
13	42407519	.	C	T	6	6	12	0	1	13	0	0
13	42407526	.	A	G	6	7	13	0	1	14	0	0
13	42407618	.	A	C	4	3	7	0	0	7	0	0
13	42443517	.	T	C	3	2	5	0	0	5	0	0
13	42467430	.	T	C	4	2	6	0	0	6	0	0
13	42471886	.	A	C	2	5	7	0	0	7	0	0
13	42481169	.	T	C	6	4	10	0	0	10	0	0
13	42481256	.	A	G	7	10	17	0	0	17	0	0
13	42481267	.	G	A	6	7	13	0	1	14	0	0
13	42481306	.	T	C	7	9	16	0	1	17	0	0
13	42481512	.	A	G	12	15	27	0	2	29	0	0
13	42481538	.	A	G	12	19	31	0	1	32	0	0
13	42481575	.	T	C	13	15	28	0	1	29	0	0
13	42481599	.	A	G	7	9	16	0	1	17	0	0
13	42483050	.	A	G	2	12	14	0	0	14	0	0
13	42483082	.	A	G	2	4	6	0	0	6	0	0
13	42483089	.	T	C	1	4	5	0	0	5	0	0
13	42488440	.	C	T	3	3	6	0	1	7	0	0
13	42490778	.	T	C	1	4	5	0	0	5	0	0
13	42491406	.	G	A	4	3	7	0	0	7	0	0
13	42491448	.	C	T	0	2	2	0	2	4	0	0
13	42500370	.	A	G	2	3	5	0	0	5	0	0
13	42502659	.	T	A	5	3	8	0	0	8	0	0
13	42502713	.	T	C	2	2	4	0	0	4	0	0
13	42517188	.	G	A	2	3	5	0	1	6	0	0
13	42523723	.	A	T	1	2	3	0	0	3	0	0
13	42523951	.	A	G	2	1	3	0	0	3	0	0
13	42523969	.	G	C	2	1	3	0	0	3	0	0
13	42523987	.	T	C	2	1	3	0	1	4	0	0
13	42526316	.	C	T	0	1	1	0	5	6	0	0
13	42526376	.	C	T	3	3	6	0	0	6	0	0
13	42536843	.	T	C	2	5	7	0	0	7	0	0
13	42607276	.	C	G	0	1	1	0	0	1	0	0
13	42610961	.	A	T	3	5	8	0	0	8	0	0
13	42611019	.	T	C	2	4	6	0	0	6	0	0
13	42614968	.	G	T	0	1	1	0	0	1	0	0
13	42615004	.	A	T	1	2	3	0	0	3	0	0
13	42615073	.	T	G	2	2	4	0	0	4	0	0
13	42615094	.	G	A	1	1	2	0	1	3	0	0
13	42616301	.	A	C	1	1	2	0	0	2	0	0
13	42616527	.	C	A	0	4	4	0	1	5	0	0
13	42616563	.	T	C	0	1	1	0	0	1	0	0
13	42617552	.	C	T	1	2	3	0	0	3	0	0
13	42622006	.	C	T	4	5	9	0	0	9	0	0
13	42622013	.	C	T	5	4	9	0	0	9	0	0
13	42626622	.	C	T	0	1	1	0	2	3	0	0
13	42630536	.	C	T	0	2	2	0	1	3	0	0
13	42632966	.	A	G	5	8	13	0	0	13	0	0
13	42672885	.	T	G	3	0	3	0	0	3	0	0
13	42676262	.	T	A	1	0	1	0	0	1	0	0
13	42681759	.	G	T	8	7	15	0	1	16	0	0
13	42681856	.	T	G	12	9	21	0	0	21	0	0
13	42682033	.	T	A	12	17	29	1	0	30	0	0
13	42691482	.	G	T	1	2	3	0	0	3	0	0
13	42693030	.	G	A	5	4	9	0	0	9	0	0
13	42698930	.	A	T	1	3	4	0	0	4	0	0
13	42721011	.	G	A	5	6	11	0	1	12	0	0
13	43223679	.	G	A	13	15	28	0	1	29	0	0
13	43223722	.	T	G	8	12	20	0	1	21	0	0
13	43225093	.	C	T	6	6	12	0	0	12	0	0
13	43225201	.	T	C	11	1	12	0	17	29	0	0
13	43226423	.	T	A	15	13	28	0	2	30	0	0
13	43226429	.	C	T	0	11	11	0	16	27	0	0
13	43229872	.	A	C	15	10	25	0	1	26	0	0
13	43229923	.	G	A	16	10	26	0	1	27	0	0
13	43237237	.	T	C	6	16	22	0	0	22	0	0
13	43237255	.	A	C	4	0	4	0	12	16	0	0
13	43238513	.	C	A	11	12	23	0	1	24	0	0
13	44340254	.	C	T	2	1	3	0	0	3	0	0
13	44355466	.	C	A	2	1	3	0	0	3	0	0
13	44702469	.	T	C	9	1	10	0	13	23	0	0
13	44738328	.	G	A	11	18	29	0	1	30	0	0
13	44767765	.	T	C	2	0	2	0	0	2	0	0
13	44772073	.	A	G	4	4	8	0	1	9	0	0
13	44775714	.	G	A	8	5	13	0	1	14	0	0
13	44775895	.	C	T	0	3	3	0	3	6	0	0
13	44779071	.	A	G	9	4	13	0	1	14	0	0
13	44779083	.	A	G	9	6	15	0	0	15	0	0
13	44779107	.	C	T	3	6	9	0	0	9	0	0
13	44782267	.	T	C	1	0	1	0	0	1	0	0
13	44788325	.	G	A	8	3	11	0	0	11	0	0
13	44788358	.	G	A	5	4	9	0	0	9	0	0
13	44788361	.	T	A	5	4	9	0	0	9	0	0
13	44788815	.	C	T	22	9	31	0	0	31	0	0
13	44808582	.	A	C	11	0	11	0	6	17	0	0
13	44808632	.	A	G	17	9	26	0	1	27	0	0
13	44827661	.	C	T	2	2	4	0	1	5	0	0
13	44832508	.	A	C	0	2	2	0	0	2	0	0
13	44841248	.	T	C	7	3	10	0	0	10	0	0
13	44842810	.	G	T	5	2	7	0	0	7	0	0
13	44843760	.	T	A	3	3	6	0	0	6	0	0
13	44843773	.	G	A	2	3	5	0	1	6	0	0
13	44843806	.	C	A	4	4	8	0	0	8	0	0
13	44888511	.	A	T	3	2	5	0	0	5	0	0
13	45010064	.	A	G	6	8	14	0	1	15	0	0
13	45012835	.	A	T	9	3	12	0	1	13	0	0
13	45015355	.	A	T	11	21	32	0	0	32	0	0
13	45015443	.	T	C	19	25	44	0	1	45	0	0
13	45015503	.	T	C	11	19	30	0	0	30	0	0
13	45018600	.	A	G	30	33	63	0	16	79	0	0
13	45018732	.	G	A	17	18	35	0	3	38	0	0
13	45019001	.	A	C	18	1	19	0	8	27	0	0
13	45035991	.	A	G	11	6	17	0	0	17	0	0
13	45036033	.	A	C	11	0	11	0	12	23	0	0
13	45434952	.	T	G	5	2	7	0	1	8	0	0
13	45436554	.	A	G	3	1	4	0	0	4	0	0
13	45436561	.	G	T	1	1	2	0	0	2	0	0
13	45468567	.	A	T	8	40	48	0	2	50	0	0
13	45468827	.	G	C	5	0	5	0	16	21	0	0
13	45470601	.	A	G	30	20	50	0	5	55	0	0
13	45470815	.	A	T	30	21	51	0	1	53	1	0
13	45470926	.	G	C	14	12	26	0	4	30	0	0
13	45471048	.	A	G	3	8	11	0	1	12	0	0
13	45471052	.	A	G	3	10	13	0	0	13	0	0
13	45471086	.	T	A	8	2	10	0	0	10	0	0
13	45471243	.	G	A	28	21	49	0	0	49	0	0
13	45471367	.	A	T	21	16	37	0	1	38	0	0
13	45471475	.	C	A	17	14	31	0	0	31	0	0
13	45471669	.	C	T	22	26	48	0	5	53	0	0
13	45471888	.	C	T	1	19	20	0	13	33	0	0
13	45472124	.	T	G	12	6	18	0	1	19	0	0
13	45472215	.	G	C	4	10	14	0	0	14	0	0
13	45472653	.	G	A	8	16	24	0	2	26	0	0
13	45472924	.	G	A	45	30	75	0	1	76	0	0
13	45472954	.	G	A	42	31	73	0	3	76	0	0
13	45476285	.	C	T	10	13	23	0	1	24	0	0
13	45476360	.	A	C	12	20	32	0	0	32	0	0
13	45476711	.	C	T	9	9	18	0	2	20	0	0
13	45476731	.	A	T	3	5	8	0	0	8	0	0
13	45481475	.	G	A	17	18	35	0	2	37	0	0
13	45481792	.	A	G	3	10	13	0	1	14	0	0
13	45494912	.	G	C	13	21	34	0	5	39	0	0
13	45495227	.	C	A	13	21	34	0	1	35	0	0
13	45524500	.	T	C	11	9	20	0	1	21	0	0
13	45553072	.	G	A	7	5	12	0	0	12	0	0
13	45553168	.	G	A	1	0	1	1	0	2	0	0
13	45565508	.	C	T	0	3	3	0	0	3	0	0
13	45565637	.	G	A	10	0	10	0	1	11	0	0
13	45565646	.	G	A	0	9	9	0	1	10	0	0
13	45570300	.	A	C	4	4	8	0	0	8	0	0
13	45794475	.	C	T	4	3	7	0	0	7	0	0
13	45991772	.	T	C	24	24	48	0	1	49	0	0
13	45991801	.	C	T	17	13	30	0	1	31	0	0
13	45999530	.	G	A	0	11	11	0	21	32	0	0
13	45999723	.	C	T	17	21	38	0	1	39	0	0
13	46000060	.	G	A	0	3	3	0	7	10	0	0
13	46179340	.	C	T	31	19	50	0	1	51	0	0
13	46179387	.	C	T	25	21	46	0	3	49	0	0
13	46179392	.	G	A	28	17	45	0	2	47	0	0
13	46179806	.	T	A	26	25	51	0	5	56	0	0
13	46179814	.	A	G	23	31	54	0	3	57	0	0
13	46298734	.	G	A	11	12	23	0	1	24	0	0
13	46298973	.	T	C	2	3	5	0	1	6	0	0
13	46299677	.	G	T	6	10	16	0	0	16	0	0
13	46299812	.	C	T	0	11	11	0	9	20	0	0
13	46299827	.	A	G	7	10	17	0	0	17	0	0
13	46299873	.	T	A	3	6	9	0	0	10	1	0
13	46299875	.	T	G	3	6	9	0	1	10	0	0
13	46299934	.	G	A	9	4	13	0	0	13	0	0
13	46299989	.	A	T	3	1	4	0	0	4	0	0
13	46299997	.	T	G	2	1	3	0	0	3	0	0
13	46300224	.	T	A	6	5	11	0	0	11	0	0
13	46300247	.	A	T	6	5	11	0	0	11	0	0
13	46300259	.	T	G	7	5	12	0	0	12	0	0
13	46300421	.	C	T	5	10	15	0	0	15	0	0
13	46300450	.	C	T	6	7	13	0	1	14	0	0
13	46300694	.	T	A	7	5	12	0	0	12	0	0
13	46300737	.	G	A	8	12	20	0	1	21	0	0
13	46343432	.	T	C	3	0	3	0	3	6	0	0
13	46343471	.	G	A	7	2	9	0	0	9	0	0
13	46343525	.	G	A	3	0	3	0	0	3	0	0
13	46346306	.	G	A	2	0	2	0	0	2	0	0
13	46356661	.	G	T	1	0	1	0	1	2	0	0
13	46384311	.	A	G	0	2	2	0	0	2	0	0
13	46520924	.	T	C	4	7	11	0	0	11	0	0
13	46521542	.	C	T	0	6	6	0	5	12	1	0
13	46521633	.	G	A	13	4	17	0	0	17	0	0
13	46521664	.	C	A	15	4	19	0	0	19	0	0
13	46521762	.	T	A	8	4	12	0	0	12	0	0
13	46674815	.	A	G	2	2	4	0	0	4	0	0
13	46674878	.	G	A	0	2	2	0	0	2	0	0
13	46686936	.	T	C	4	2	6	0	0	6	0	0
13	46687008	.	C	G	9	8	17	0	0	17	0	0
13	46687037	.	G	T	7	4	11	0	1	12	0	0
13	46718871	.	A	C	4	4	8	0	2	10	0	0
13	46718930	.	T	C	0	4	4	0	0	4	0	0
13	46771366	.	A	C	2	5	7	0	0	7	0	0
13	46793193	.	G	A	0	2	2	0	2	4	0	0
13	46795515	.	G	A	0	7	7	0	5	12	0	0
13	46831698	.	C	T	0	4	4	0	4	8	0	0
13	46832084	.	A	G	0	5	5	0	1	6	0	0
13	46832104	.	A	G	0	3	3	0	0	3	0	0
13	46832449	.	A	T	6	7	13	0	0	13	0	0
13	46832471	.	A	C	4	12	16	0	1	17	0	0
13	46832724	.	C	A	0	4	4	0	8	12	0	0
13	46832981	.	A	T	1	4	5	0	0	5	0	0
13	46833050	.	C	G	7	3	10	0	1	11	0	0
13	46833064	.	C	T	6	2	8	0	0	8	0	0
13	46833197	.	A	G	2	2	4	0	0	4	0	0
13	46834504	.	G	A	3	5	8	0	1	9	0	0
13	46834550	.	G	A	6	7	13	0	0	13	0	0
13	46834815	.	C	T	2	4	6	0	1	7	0	0
13	46834860	.	T	A	2	5	7	0	0	7	0	0
13	46835304	.	C	T	3	3	6	0	0	7	1	0
13	46835344	.	C	T	4	6	10	0	0	10	0	0
13	46844205	.	G	A	2	3	5	0	0	5	0	0
13	46849865	.	A	G	1	1	2	0	0	2	0	0
13	46857629	.	A	T	1	1	2	0	0	2	0	0
13	46935014	.	T	G	3	1	4	0	0	4	0	0
13	46935089	.	C	T	2	1	3	0	0	3	0	0
13	46936916	.	G	A	2	2	4	0	0	4	0	0
13	46988299	.	C	T	11	13	24	0	0	24	0	0
13	46988390	.	T	C	12	0	12	0	13	25	0	0
13	46988457	.	C	A	0	3	3	0	0	3	0	0
13	46988561	.	A	G	4	3	7	0	1	8	0	0
13	46988588	.	A	G	9	13	22	0	0	22	0	0
13	46988638	.	T	G	5	8	13	0	0	13	0	0
13	46989607	.	C	T	0	9	9	0	7	16	0	0
13	47030624	.	T	C	1	1	2	0	0	2	0	0
13	47042439	.	G	A	0	2	2	0	1	3	0	0
13	47045212	.	G	T	1	0	1	0	0	1	0	0
13	47045234	.	C	A	1	0	1	0	0	1	0	0
13	47064961	.	G	A	0	2	2	0	1	3	0	0
13	47064964	.	C	T	1	2	3	0	0	3	0	0
13	47099834	.	A	G	3	3	6	0	0	6	0	0
13	47099900	.	A	T	2	3	5	0	0	5	0	0
13	47130927	.	A	G	2	0	2	0	1	3	0	0
13	47146860	.	C	T	1	2	3	0	0	3	0	0
13	47163748	.	A	G	1	0	1	0	2	3	0	0
13	47687088	.	G	A	2	1	3	0	0	3	0	0
13	47689220	.	C	T	3	3	6	0	0	6	0	0
13	47690269	.	A	T	2	3	5	0	0	5	0	0
13	47690300	.	A	T	4	4	8	0	0	8	0	0
13	47690383	.	C	G	3	2	5	0	0	5	0	0
13	47690434	.	A	G	4	2	6	0	0	6	0	0
13	47690766	.	T	C	4	2	6	0	0	6	0	0
13	47690779	.	G	A	0	3	3	0	5	8	0	0
13	47691386	.	T	C	1	2	3	0	0	3	0	0
13	47752241	.	T	A	2	2	4	0	0	4	0	0
13	47827308	.	C	T	0	1	1	0	0	1	0	0
13	47831531	.	T	C	1	0	1	0	0	1	0	0
13	47831552	.	G	A	1	3	4	0	0	4	0	0
13	47834276	.	C	A	2	2	4	0	0	4	0	0
13	47835638	.	G	T	1	1	2	0	0	2	0	0
13	47838024	.	G	A	3	5	8	0	0	8	0	0
13	47838052	.	G	A	0	4	4	0	1	5	0	0
13	47838650	.	G	C	2	4	6	0	0	6	0	0
13	47839071	.	C	T	4	3	7	0	0	7	0	0
13	47839119	.	A	T	3	7	10	0	0	10	0	0
13	48747881	.	T	C	2	2	4	0	0	4	0	0
13	48748637	.	A	G	1	3	4	0	0	4	0	0
13	48748722	.	A	G	2	4	6	0	0	6	0	0
13	48755035	.	A	G	8	6	14	0	0	14	0	0
13	48758680	.	C	T	1	2	3	0	0	3	0	0
13	48759038	.	T	C	1	2	3	0	0	3	0	0
13	48760947	.	T	A	0	1	1	0	0	1	0	0
13	48766270	.	C	T	6	5	11	0	0	11	0	0
13	49110406	.	C	A	1	2	3	0	0	3	0	0
13	49153904	.	T	C	6	4	10	0	0	10	0	0
13	49154048	.	G	A	6	6	12	0	0	12	0	0
13	49154631	.	T	C	12	0	12	0	12	24	0	0
13	49158734	.	G	A	5	2	7	0	0	7	0	0
13	49167185	.	T	G	3	4	7	0	0	7	0	0
13	49167195	.	C	T	3	3	6	0	0	6	0	0
13	49169071	.	A	T	0	1	1	0	0	1	0	0
13	49169121	.	G	C	1	1	2	0	0	2	0	0
13	49169455	.	C	A	0	3	3	0	3	6	0	0
13	49176144	.	C	T	2	2	4	0	2	6	0	0
13	49443721	.	C	T	12	21	33	0	0	33	0	0
13	49443868	.	T	C	25	1	26	0	19	45	0	0
13	49444090	.	C	T	18	15	33	0	2	35	0	0
13	49444177	.	C	A	0	25	25	0	23	48	0	0
13	49444224	.	G	A	17	18	35	0	1	36	0	0
13	49444446	.	C	A	16	16	32	0	0	32	0	0
13	49544833	.	C	T	13	19	32	0	1	33	0	0
13	49544873	.	T	A	19	20	39	0	1	40	0	0
13	49544973	.	G	T	15	17	32	0	0	32	0	0
13	49545039	.	A	G	2	7	9	0	0	9	0	0
13	49585341	.	T	A	20	10	30	0	0	30	0	0
13	49585344	.	A	T	19	9	28	0	2	30	0	0
13	49585384	.	T	G	7	3	10	0	0	10	0	0
13	49597297	.	C	T	1	11	12	0	6	18	0	0
13	49608888	.	T	C	6	2	8	0	0	8	0	0
13	49609056	.	T	C	6	0	6	0	6	12	0	0
13	49633362	.	G	T	3	3	6	0	0	6	0	0
13	49636115	.	G	T	0	1	1	0	0	1	0	0
13	49636240	.	C	T	2	5	7	0	0	7	0	0
13	49655691	.	C	T	1	3	4	0	0	4	0	0
13	49655695	.	C	T	1	3	4	0	0	4	0	0
13	49660026	.	A	G	1	1	2	0	0	2	0	0
13	49727448	.	A	G	1	3	4	0	0	4	0	0
13	49727463	.	T	G	2	4	6	0	0	6	0	0
13	49765806	.	C	T	3	2	5	0	0	5	0	0
13	49765815	.	G	T	0	2	2	0	3	5	0	0
13	49765896	.	T	C	5	2	7	0	0	7	0	0
13	49766022	.	T	C	3	4	7	0	0	7	0	0
13	49766268	.	G	A	0	9	9	0	2	11	0	0
13	49767539	.	A	G	9	6	15	0	0	15	0	0
13	49767570	.	G	A	6	6	12	0	1	13	0	0
13	49767736	.	T	G	7	7	14	0	0	14	0	0
13	49767806	.	T	A	3	5	8	0	0	8	0	0
13	49767807	.	G	T	3	5	8	0	0	8	0	0
13	49767953	.	T	A	3	6	9	0	0	9	0	0
13	49768095	.	A	G	6	3	9	0	0	9	0	0
13	49768207	.	C	T	4	5	9	0	3	12	0	0
13	49768401	.	C	T	10	8	18	0	1	19	0	0
13	49768402	.	A	C	9	9	18	0	1	19	0	0
13	49768592	.	A	T	3	4	7	0	0	7	0	0
13	49768646	.	A	G	4	5	9	0	0	9	0	0
13	49769060	.	C	T	8	5	13	0	1	14	0	0
13	49769141	.	G	C	7	8	15	0	0	15	0	0
13	49769274	.	G	A	0	3	3	0	1	4	0	0
13	49774893	.	G	T	2	4	6	0	0	6	0	0
13	49775018	.	T	G	2	7	9	0	0	9	0	0
13	49775048	.	C	G	2	3	5	0	0	5	0	0
13	49775075	.	T	G	4	2	6	0	0	6	0	0
13	49785412	.	C	T	4	8	12	0	1	13	0	0
13	49785417	.	T	C	5	8	13	0	1	14	0	0
13	49785455	.	C	G	2	5	7	0	1	8	0	0
13	49785456	.	A	G	2	6	8	0	0	8	0	0
13	49788102	.	A	T	1	0	1	0	0	1	0	0
13	49802010	.	C	A	0	2	2	0	0	2	0	0
13	49802025	.	T	G	1	3	4	0	0	4	0	0
13	49819019	.	A	G	4	17	21	0	1	22	0	0
13	49898458	.	G	T	6	3	9	0	0	9	0	0
13	49915580	.	A	G	1	5	6	0	0	6	0	0
13	49917748	.	T	C	0	1	1	0	0	1	0	0
13	49922870	.	G	T	2	1	3	0	0	3	0	0
13	49922970	.	C	T	0	3	3	0	0	3	0	0
13	49923570	.	G	T	1	3	4	0	0	4	0	0
13	49923678	.	C	A	1	0	1	0	0	1	0	0
13	49927333	.	T	C	1	0	1	0	3	4	0	0
13	49931689	.	C	T	1	2	3	0	0	3	0	0
13	50169004	.	C	T	11	8	19	0	0	19	0	0
13	50670846	.	A	T	4	5	9	0	0	9	0	0
13	50670911	.	G	C	7	7	14	0	0	14	0	0
13	50672297	.	T	C	9	0	9	0	7	16	0	0
13	50712066	.	G	T	1	2	3	0	2	5	0	0
13	50712093	.	T	C	2	3	5	0	0	5	0	0
13	50712125	.	A	G	2	2	4	0	0	4	0	0
13	50715024	.	G	C	2	4	6	0	0	6	0	0
13	50715205	.	A	G	4	4	8	0	0	8	0	0
13	50715615	.	T	C	1	0	1	0	0	1	0	0
13	50730724	.	C	G	1	2	3	0	0	3	0	0
13	50731324	.	C	T	1	1	2	0	0	2	0	0
13	51140665	.	A	G	16	8	24	0	1	25	0	0
13	51140782	.	A	G	5	9	14	0	1	15	0	0
13	51145614	.	T	G	14	9	23	0	0	23	0	0
13	51147152	.	G	A	5	6	11	0	1	12	0	0
13	51147164	.	A	G	2	4	6	0	0	6	0	0
13	51162561	.	A	G	4	0	4	0	0	4	0	0
13	51162579	.	T	G	6	2	8	0	0	8	0	0
13	51169874	.	C	G	2	4	6	0	0	6	0	0
13	51247213	.	G	T	2	2	4	0	0	4	0	0
14	147257	.	C	A	0	3	3	0	0	3	0	0
14	355374	.	C	A	2	2	4	0	1	5	0	0
14	547170	.	A	G	0	5	5	0	0	5	0	0
14	549047	.	G	A	0	1	1	0	0	1	0	0
14	550963	.	C	T	1	3	4	0	0	4	0	0
14	557740	.	C	T	2	2	4	0	0	4	0	0
14	557761	.	A	G	1	1	2	0	0	2	0	0
14	565193	.	T	G	0	3	3	0	1	4	0	0
14	565260	.	A	T	1	2	3	0	0	3	0	0
14	567396	.	T	C	1	0	1	0	2	3	0	0
14	606255	.	A	G	5	1	6	0	0	6	0	0
14	616648	.	G	A	2	2	4	0	0	4	0	0
14	620200	.	C	A	2	1	3	0	0	3	0	0
14	684179	.	G	A	9	20	29	0	2	31	0	0
14	699481	.	G	T	2	1	3	0	1	4	0	0
14	699496	.	A	C	1	2	3	0	0	3	0	0
14	712194	.	G	A	3	3	6	0	0	6	0	0
14	712205	.	G	C	0	3	3	0	3	6	0	0
14	715123	.	G	C	1	1	2	0	0	2	0	0
14	715126	.	T	C	1	1	2	0	0	2	0	0
14	717845	.	G	A	0	0	0	0	5	5	0	0
14	717927	.	G	A	3	1	4	0	0	4	0	0
14	718194	.	A	C	2	6	8	0	0	8	0	0
14	719447	.	A	G	1	2	3	0	0	3	0	0
14	719926	.	A	G	1	2	3	0	1	4	0	0
14	723539	.	T	C	4	8	12	0	1	13	0	0
14	723542	.	T	C	4	9	13	0	0	13	0	0
14	758581	.	T	C	1	0	1	0	3	4	0	0
14	758583	.	T	C	1	3	4	0	0	4	0	0
14	790989	.	C	T	1	2	3	0	0	3	0	0
14	791636	.	T	C	1	4	5	0	0	5	0	0
14	791696	.	T	A	3	4	7	0	0	7	0	0
14	791707	.	T	A	3	5	8	0	1	9	0	0
14	792499	.	C	G	4	0	4	0	7	11	0	0
14	792536	.	A	C	3	5	8	0	0	8	0	0
14	792686	.	G	A	4	2	6	0	0	6	0	0
14	863188	.	T	C	3	2	5	0	0	5	0	0
14	863515	.	T	C	5	0	5	0	3	8	0	0
14	863807	.	A	T	14	7	21	0	1	22	0	0
14	863868	.	G	T	13	13	26	0	0	26	0	0
14	863949	.	T	C	6	7	13	0	0	13	0	0
14	868838	.	G	A	1	5	6	0	0	6	0	0
14	868855	.	A	G	1	7	8	0	0	8	0	0
14	912754	.	C	T	3	1	4	0	0	4	0	0
14	912775	.	G	A	3	3	6	0	0	6	0	0
14	914602	.	G	C	3	1	4	0	0	4	0	0
14	937241	.	T	C	1	2	3	0	0	3	0	0
14	937298	.	G	A	3	2	5	0	0	5	0	0
14	937345	.	G	A	4	2	6	0	1	7	0	0
14	937399	.	A	T	5	5	10	0	0	10	0	0
14	937849	.	A	C	1	4	5	0	0	5	0	0
14	938601	.	C	G	1	2	3	0	0	3	0	0
14	938633	.	C	A	0	2	2	0	1	3	0	0
14	939720	.	A	G	1	3	4	0	0	4	0	0
14	939722	.	G	A	1	3	4	0	0	4	0	0
14	939805	.	C	T	0	3	3	0	0	3	0	0
14	939813	.	T	C	0	3	3	0	0	3	0	0
14	939958	.	C	T	2	2	4	0	0	4	0	0
14	940424	.	G	A	2	2	4	0	0	4	0	0
14	940674	.	G	A	2	2	4	0	0	4	0	0
14	940677	.	G	A	2	2	4	0	0	4	0	0
14	942378	.	G	A	0	2	2	0	0	2	0	0
14	989848	.	G	T	3	3	6	0	0	6	0	0
14	994437	.	T	C	3	3	6	0	0	6	0	0
14	997012	.	C	A	2	2	4	0	0	4	0	0
14	997273	.	T	A	3	2	5	0	1	6	0	0
14	997484	.	A	G	1	0	1	0	5	6	0	0
14	997651	.	A	C	1	2	3	0	0	3	0	0
14	997765	.	T	C	7	5	12	0	1	13	0	0
14	997783	.	A	G	7	4	11	0	1	12	0	0
14	997853	.	C	T	3	2	5	0	0	5	0	0
14	997931	.	G	C	4	1	5	0	1	6	0	0
14	1119141	.	C	T	5	3	8	0	0	8	0	0
14	1119225	.	C	T	8	4	12	0	3	15	0	0
14	1119423	.	A	G	10	2	12	0	5	17	0	0
14	1119432	.	T	C	9	6	15	0	3	18	0	0
14	1119993	.	T	C	9	5	14	0	0	14	0	0
14	1120017	.	T	C	6	7	13	0	1	14	0	0
14	1120072	.	C	A	5	8	13	0	0	13	0	0
14	1120154	.	T	C	12	8	20	0	1	21	0	0
14	1120178	.	C	T	9	8	17	0	1	18	0	0
14	1120196	.	T	G	8	0	8	0	7	15	0	0
14	1120236	.	C	T	5	9	14	0	0	14	0	0
14	1120452	.	G	T	0	1	1	0	6	7	0	0
14	1120598	.	T	C	10	4	14	0	0	14	0	0
14	1121029	.	A	G	7	4	11	0	2	13	0	0
14	1121068	.	C	T	5	5	10	0	1	11	0	0
14	1121297	.	T	G	5	10	15	0	0	15	0	0
14	1121303	.	G	C	6	11	17	0	0	17	0	0
14	1124555	.	T	A	9	7	16	0	1	17	0	0
14	1124602	.	C	G	5	5	10	0	0	10	0	0
14	1127693	.	G	A	8	6	14	0	0	14	0	0
14	1138611	.	C	A	2	1	3	0	0	3	0	0
14	1138626	.	G	A	0	3	3	0	2	5	0	0
14	1139509	.	C	T	4	2	6	0	0	6	0	0
14	1146630	.	G	A	2	2	4	0	0	4	0	0
14	1150594	.	A	G	2	1	3	0	0	3	0	0
14	1152544	.	C	A	1	5	6	0	0	6	0	0
14	1153665	.	T	C	1	1	2	0	0	2	0	0
14	1153830	.	T	A	6	3	9	0	0	9	0	0
14	1159869	.	A	G	7	0	7	0	13	20	0	0
14	1160333	.	C	T	12	6	18	0	3	21	0	0
14	1160427	.	T	G	13	6	19	0	0	19	0	0
14	1171023	.	T	C	9	11	20	0	0	20	0	0
14	1171052	.	T	A	11	12	23	0	1	24	0	0
14	1171081	.	T	A	10	9	19	0	1	20	0	0
14	1192448	.	G	A	9	9	18	0	0	18	0	0
14	1192681	.	C	T	3	5	8	0	0	8	0	0
14	1194090	.	C	T	0	2	2	0	4	6	0	0
14	1194133	.	G	A	9	8	17	0	0	17	0	0
14	1194154	.	C	T	0	8	8	0	7	15	0	0
14	1196568	.	C	G	1	2	3	0	0	3	0	0
14	1196658	.	T	G	4	8	12	0	0	12	0	0
14	1200460	.	T	G	3	3	6	0	0	6	0	0
14	1200545	.	G	T	13	6	19	0	0	19	0	0
14	1200676	.	C	T	0	6	6	0	3	9	0	0
14	1200842	.	A	C	3	2	5	0	0	5	0	0
14	1203713	.	A	G	18	16	34	0	2	36	0	0
14	1203770	.	G	T	8	2	10	0	1	11	0	0
14	1204197	.	A	T	0	1	1	0	0	1	0	0
14	1204299	.	G	A	12	6	18	0	1	19	0	0
14	1225227	.	C	T	0	2	2	0	0	2	0	0
14	1434683	.	T	A	3	2	5	0	0	5	0	0
14	1888624	.	T	C	0	2	2	0	39	41	0	0
14	1948360	.	G	A	0	1	1	0	1	2	0	0
14	1948853	.	T	A	1	2	3	0	0	3	0	0
14	1948855	.	A	G	1	2	3	0	0	3	0	0
14	2188750	.	G	A	1	0	1	0	0	1	0	0
14	2188759	.	A	T	1	0	1	0	0	1	0	0
14	2191005	.	T	C	1	0	1	0	2	3	0	0
14	2206317	.	T	C	1	2	3	0	0	3	0	0
14	2212826	.	C	A	0	2	2	0	2	4	0	0
14	2266081	.	A	T	3	2	5	0	0	5	0	0
14	2266082	.	G	A	2	2	4	0	1	5	0	0
14	2351565	.	A	T	3	6	9	0	0	9	0	0
14	2351566	.	G	T	3	6	9	0	0	9	0	0
14	2352280	.	T	G	6	3	9	0	0	9	0	0
14	2356447	.	G	A	3	1	4	0	0	4	0	0
14	2356450	.	G	A	2	1	3	0	1	4	0	0
14	2360116	.	T	A	3	10	13	0	1	14	0	0
14	2384096	.	T	G	5	2	7	0	0	7	0	0
14	3451164	.	C	A	2	4	6	0	0	6	0	0
14	3451169	.	T	C	2	2	4	0	0	4	0	0
14	3451275	.	C	G	2	0	2	0	4	6	0	0
14	3576057	.	T	C	5	1	6	0	0	6	0	0
14	3576058	.	A	T	2	5	7	0	0	7	0	0
14	4047853	.	T	G	0	17	17	0	0	17	0	0
14	4048848	.	C	T	1	1	2	0	0	2	0	0
14	4193501	.	T	C	5	3	8	0	0	8	0	0
14	4193818	.	G	A	1	3	4	0	0	4	0	0
14	4292214	.	A	G	1	2	3	0	0	3	0	0
14	6222682	.	G	T	0	1	1	0	0	1	0	0
14	6332869	.	A	C	6	3	9	0	0	9	0	0
14	6332872	.	T	C	5	3	8	0	1	9	0	0
14	6333022	.	T	C	3	6	9	0	2	11	0	0
14	6334072	.	T	C	11	3	14	0	2	16	0	0
14	6334738	.	A	T	6	2	8	0	0	8	0	0
14	6341993	.	C	T	4	2	6	0	1	7	0	0
14	6624558	.	A	G	18	1	19	0	8	27	0	0
14	6624621	.	A	G	5	24	29	0	2	31	0	0
14	6624625	.	A	G	24	9	33	0	0	33	0	0
14	6625002	.	A	C	2	13	15	2	2	19	0	0
14	6625521	.	G	C	21	29	50	0	1	51	0	0
14	6625794	.	A	G	0	12	12	0	0	12	0	0
14	6625805	.	A	G	4	3	7	0	0	7	0	0
14	7170558	.	T	C	1	8	9	0	0	9	0	0
14	7170559	.	T	C	1	8	9	0	0	9	0	0
14	7965330	.	G	T	4	3	7	0	0	7	0	0
14	8496257	.	A	G	2	2	4	1	0	5	0	0
14	8572550	.	T	A	1	3	4	0	0	4	0	0
14	9522159	.	A	T	0	5	5	0	0	5	0	0
14	9593209	.	T	A	3	3	6	0	0	6	0	0
14	9595250	.	T	C	2	7	9	0	1	10	0	0
14	9595314	.	T	C	18	5	23	0	2	25	0	0
14	9595330	.	T	C	12	15	27	0	0	27	0	0
14	9595427	.	C	T	0	17	17	0	0	17	0	0
14	10958045	.	A	G	3	0	3	0	0	3	0	0
14	11266531	.	A	T	2	5	7	0	0	7	0	0
14	12635951	.	T	C	0	1	1	0	0	1	0	0
14	14593063	.	G	T	5	3	8	0	0	8	0	0
14	14594950	.	A	G	3	4	7	0	0	7	0	0
14	14594973	.	A	G	2	2	4	0	2	6	0	0
14	14595023	.	A	G	0	0	0	0	7	7	0	0
14	14838402	.	A	G	1	3	4	0	0	4	0	0
14	15664548	.	T	C	3	3	6	0	0	6	0	0
14	15972303	.	G	A	2	2	4	0	0	4	0	0
14	15972419	.	A	G	3	2	5	0	0	7	2	0
14	15972435	.	C	A	5	3	8	0	0	8	0	0
14	15972596	.	T	C	2	0	2	0	3	5	0	0
14	15972660	.	C	G	4	3	7	0	0	7	0	0
14	15972666	.	G	A	4	3	7	0	0	7	0	0
14	15973819	.	A	T	5	0	5	0	0	5	0	0
14	15973844	.	G	A	2	0	2	0	0	2	0	0
14	15973919	.	A	G	3	5	8	0	2	10	0	0
14	15974065	.	C	A	5	2	7	0	0	7	0	0
14	15974069	.	A	T	5	2	7	0	0	7	0	0
14	15974448	.	A	G	3	4	7	0	0	7	0	0
14	15974580	.	A	G	1	2	3	0	0	3	0	0
14	15974613	.	G	A	2	4	6	0	0	6	0	0
14	15983622	.	T	C	2	0	2	0	3	5	0	0
14	16042530	.	C	A	3	4	7	0	0	7	0	0
14	16044274	.	A	C	9	4	13	0	0	13	0	0
14	16044638	.	G	A	0	3	3	0	2	5	0	0
14	16044706	.	A	G	2	2	4	0	0	4	0	0
14	16068929	.	C	T	7	2	9	0	0	9	0	0
14	16069354	.	C	T	7	3	10	0	0	10	0	0
14	16069404	.	G	A	2	3	5	0	0	5	0	0
14	16069405	.	A	G	2	3	5	0	0	5	0	0
14	16069449	.	T	A	4	2	6	0	0	6	0	0
14	16084339	.	C	T	3	6	9	0	0	9	0	0
14	16090764	.	T	C	8	13	21	0	0	21	0	0
14	16090800	.	T	A	11	8	19	0	0	19	0	0
14	16090828	.	A	T	10	10	20	0	0	20	0	0
14	16090897	.	C	T	8	13	21	0	0	22	1	0
14	16090939	.	A	C	6	16	22	0	0	22	0	0
14	16091563	.	C	T	10	10	20	0	1	21	0	0
14	16091586	.	T	A	9	10	19	0	0	19	0	0
14	16091709	.	T	G	3	13	16	0	2	18	0	0
14	16093926	.	G	T	0	3	3	0	1	4	0	0
14	16093983	.	G	A	19	12	31	0	0	31	0	0
14	16095683	.	A	G	15	5	20	0	0	20	0	0
14	16097204	.	T	A	2	2	4	0	0	4	0	0
14	16115278	.	G	A	14	11	25	0	0	25	0	0
14	16115353	.	A	G	1	0	1	0	0	1	0	0
14	16122866	.	T	C	16	18	34	0	0	34	0	0
14	16122962	.	G	A	18	11	29	0	1	30	0	0
14	16123055	.	G	C	1	19	20	0	28	48	0	0
14	16127308	.	C	T	2	1	3	0	0	3	0	0
14	16130167	.	C	G	0	2	2	0	0	2	0	0
14	16132423	.	T	G	3	0	3	0	0	3	0	0
14	16145112	.	T	A	1	0	1	0	0	1	0	0
14	16189945	.	G	A	0	1	1	0	0	1	0	0
14	16203904	.	A	T	7	4	11	0	0	11	0	0
14	16208059	.	T	G	1	1	2	0	0	2	0	0
14	16288166	.	A	C	6	7	13	0	0	13	0	0
14	16288236	.	T	G	1	1	2	0	0	2	0	0
14	16296383	.	A	G	2	1	3	0	4	7	0	0
14	16383531	.	T	G	3	2	5	0	0	5	0	0
14	16383918	.	A	C	3	2	5	0	0	5	0	0
14	16389655	.	C	T	3	4	7	0	0	7	0	0
14	16402489	.	T	C	3	0	3	0	2	5	0	0
14	16432788	.	C	T	5	2	7	0	0	7	0	0
14	16433098	.	A	T	18	20	38	0	0	38	0	0
14	16433473	.	C	A	0	19	19	0	19	38	0	0
14	16433496	.	A	G	15	17	32	0	0	32	0	0
14	16433623	.	T	G	6	4	10	0	3	13	0	0
14	16433943	.	C	T	0	9	9	0	16	25	0	0
14	16434131	.	G	C	20	12	32	0	2	34	0	0
14	16434179	.	T	C	25	13	38	0	2	40	0	0
14	16434474	.	T	C	12	0	12	0	11	23	0	0
14	16434791	.	A	G	20	19	39	0	0	39	0	0
14	16434981	.	T	C	26	2	28	0	25	53	0	0
14	16434990	.	T	A	25	13	38	0	13	51	0	0
14	16448208	.	A	T	13	18	31	0	1	32	0	0
14	16456712	.	C	T	3	6	9	0	0	9	0	0
14	16484069	.	C	T	5	4	9	0	0	9	0	0
14	16484429	.	C	T	4	4	8	0	2	10	0	0
14	16484633	.	G	T	3	5	8	0	0	8	0	0
14	16484713	.	A	G	5	5	10	0	0	10	0	0
14	16485222	.	C	T	1	5	6	0	3	9	0	0
14	16606655	.	C	T	0	5	5	0	5	10	0	0
14	16618118	.	G	A	7	6	13	0	1	14	0	0
14	16754120	.	C	A	4	7	11	0	1	12	0	0
14	16754192	.	A	C	3	8	11	0	0	11	0	0
14	16754243	.	G	A	2	8	10	0	0	10	0	0
14	16766053	.	C	T	7	3	10	0	0	10	0	0
14	16769067	.	A	G	13	13	26	0	0	26	0	0
14	16769109	.	T	C	19	8	27	0	2	29	0	0
14	16769189	.	C	T	14	12	26	0	0	26	0	0
14	16769246	.	C	T	19	9	28	0	0	28	0	0
14	16769515	.	G	A	13	8	21	0	1	22	0	0
14	16769550	.	A	G	2	0	2	0	2	4	0	0
14	16770260	.	C	T	11	5	16	0	2	18	0	0
14	16770338	.	T	A	5	11	16	0	0	16	0	0
14	16770646	.	C	A	13	11	24	0	0	24	0	0
14	16770847	.	C	T	15	14	29	0	0	29	0	0
14	16770989	.	A	G	9	0	9	0	10	19	0	0
14	16771265	.	A	T	11	7	18	0	0	18	0	0
14	16777673	.	T	C	4	0	4	0	4	8	0	0
14	16777677	.	A	C	4	4	8	0	0	8	0	0
14	16777743	.	T	G	1	2	3	0	0	3	0	0
14	16778080	.	C	T	0	3	3	0	5	9	1	0
14	16790506	.	T	C	0	2	2	0	0	2	0	0
14	16790722	.	A	T	1	2	3	0	0	3	0	0
14	16801669	.	C	T	0	1	1	0	0	1	0	0
14	16801708	.	G	T	1	2	3	0	0	3	0	0
14	16803865	.	A	T	1	0	1	0	0	1	0	0
14	16803880	.	A	G	1	0	1	0	0	1	0	0
14	16813863	.	G	A	10	7	17	0	0	17	0	0
14	16813981	.	C	T	5	3	8	0	0	8	0	0
14	16949354	.	A	G	4	0	4	0	6	10	0	0
14	16949357	.	C	T	5	5	10	0	0	10	0	0
14	16968227	.	T	C	4	2	6	0	1	7	0	0
14	16968260	.	C	T	3	4	7	0	0	7	0	0
14	16996870	.	G	A	1	3	4	0	4	8	0	0
14	16996916	.	G	A	8	7	15	0	0	15	0	0
14	16997008	.	G	A	2	3	5	0	0	5	0	0
14	17003570	.	G	A	0	2	2	0	2	4	0	0
14	17003771	.	C	A	1	1	2	0	0	2	0	0
14	17025080	.	A	G	4	0	4	0	3	7	0	0
14	17025109	.	A	T	10	6	16	0	0	16	0	0
14	17025151	.	T	A	11	9	20	0	0	20	0	0
14	17025200	.	G	A	6	5	11	0	1	12	0	0
14	17025215	.	T	C	5	5	10	0	0	10	0	0
14	17025574	.	A	G	5	4	9	0	1	10	0	0
14	17025579	.	A	G	5	4	9	0	1	10	0	0
14	17025751	.	T	A	5	3	8	0	1	9	0	0
14	17025752	.	T	C	6	3	9	0	0	9	0	0
14	17025807	.	T	C	5	5	10	0	0	10	0	0
14	17025819	.	C	T	6	4	10	0	0	10	0	0
14	17025849	.	A	G	12	5	17	0	0	17	0	0
14	17026100	.	T	A	7	3	10	0	0	10	0	0
14	17026488	.	G	A	8	8	16	0	0	16	0	0
14	17026572	.	T	G	5	12	17	0	2	19	0	0
14	17026724	.	T	C	7	22	29	0	0	29	0	0
14	17026881	.	G	T	6	4	10	0	0	10	0	0
14	17027207	.	G	A	6	8	14	0	0	14	0	0
14	17065601	.	A	G	5	2	7	0	0	7	0	0
14	17088973	.	C	T	2	3	5	0	0	5	0	0
14	17088978	.	C	T	2	3	5	0	0	5	0	0
14	17197240	.	A	C	0	2	2	0	0	2	0	0
14	17199990	.	A	G	20	20	40	0	1	41	0	0
14	17200351	.	A	T	4	9	13	0	1	14	0	0
14	17200407	.	C	A	6	9	15	0	0	15	0	0
14	17200653	.	A	C	9	15	24	0	1	25	0	0
14	17230387	.	C	T	0	2	2	0	1	3	0	0
14	17230601	.	A	G	4	3	7	0	0	7	0	0
14	17233598	.	C	A	13	14	27	0	4	31	0	0
14	17260416	.	A	G	8	2	10	0	0	10	0	0
14	17260420	.	C	T	0	2	2	0	8	10	0	0
14	17266010	.	C	T	0	7	7	0	11	18	0	0
14	17275648	.	G	A	3	3	6	0	0	6	0	0
14	17275708	.	C	G	3	3	6	0	0	6	0	0
14	17278972	.	C	T	4	4	8	0	2	10	0	0
14	17279005	.	T	C	1	3	4	0	0	4	0	0
14	17279197	.	G	A	0	2	2	0	0	2	0	0
14	17279212	.	C	T	3	3	6	0	1	7	0	0
14	17279305	.	T	C	1	7	8	0	1	9	0	0
14	17281761	.	A	G	4	5	9	0	0	9	0	0
14	17282061	.	C	T	5	2	7	0	2	9	0	0
14	17282095	.	C	G	8	2	10	0	1	11	0	0
14	17282100	.	C	T	0	3	3	0	8	11	0	0
14	17282139	.	C	T	3	2	5	0	0	5	0	0
14	17305587	.	G	A	5	3	8	0	1	9	0	0
14	17305604	.	G	A	8	6	14	0	0	14	0	0
14	17330048	.	G	A	0	1	1	0	0	1	0	0
14	17349306	.	C	T	2	2	4	0	1	5	0	0
14	17349307	.	C	T	3	2	5	0	0	5	0	0
14	17349409	.	C	T	10	2	12	0	1	13	0	0
14	17349420	.	G	A	9	3	12	0	0	12	0	0
14	17444002	.	G	A	2	5	7	0	0	7	0	0
14	17444047	.	A	C	3	5	8	0	0	8	0	0
14	17451023	.	A	T	0	1	1	0	0	1	0	0
14	17567851	.	C	T	5	2	7	0	0	7	0	0
14	17567968	.	T	A	5	4	9	0	0	9	0	0
14	17568099	.	A	G	5	8	13	0	0	13	0	0
14	17572743	.	T	C	2	1	3	0	0	3	0	0
14	17575548	.	A	G	1	0	1	0	0	1	0	0
14	17575607	.	G	T	4	6	10	0	1	11	0	0
14	17575868	.	G	A	2	9	11	0	0	11	0	0
14	17575918	.	A	G	1	4	5	0	0	5	0	0
14	17580685	.	G	A	25	8	33	0	1	34	0	0
14	17580922	.	C	A	34	21	55	0	0	55	0	0
14	17581084	.	A	T	28	17	45	0	1	46	0	0
14	17581214	.	A	T	22	14	36	0	0	36	0	0
14	17586693	.	G	A	1	3	4	0	0	4	0	0
14	17588131	.	G	T	12	9	21	0	0	21	0	0
14	17593429	.	T	C	5	7	12	0	0	12	0	0
14	17593444	.	G	T	5	7	12	0	0	12	0	0
14	17593490	.	A	G	3	5	8	0	0	8	0	0
14	17593554	.	A	T	4	2	6	0	0	6	0	0
14	17593720	.	C	T	10	11	21	0	3	24	0	0
14	17593767	.	A	T	5	15	20	0	0	20	0	0
14	17593783	.	T	A	10	10	20	0	0	20	0	0
14	17593823	.	A	T	9	11	20	0	1	21	0	0
14	17593992	.	T	A	5	8	13	0	1	14	0	0
14	17594137	.	G	A	2	3	5	0	0	5	0	0
14	17594527	.	A	G	6	7	13	0	0	13	0	0
14	17594734	.	A	T	1	5	6	0	0	6	0	0
14	17595460	.	T	A	3	2	5	0	3	8	0	0
14	17595539	.	T	C	3	8	11	0	0	11	0	0
14	17596002	.	T	A	4	4	8	0	0	8	0	0
14	17596070	.	G	T	1	2	3	0	1	4	0	0
14	17596597	.	G	A	6	5	11	0	0	11	0	0
14	18667852	.	T	C	17	13	30	0	2	32	0	0
14	18668731	.	A	G	2	5	7	0	0	7	0	0
14	18669481	.	C	A	14	19	33	0	0	33	0	0
14	18670446	.	C	T	10	11	21	0	0	21	0	0
14	18670582	.	T	A	8	12	20	0	0	20	0	0
14	18670665	.	A	G	12	3	15	0	1	16	0	0
14	18671011	.	A	T	5	9	14	0	0	14	0	0
14	18672491	.	C	T	10	9	19	0	0	19	0	0
14	20190945	.	A	C	0	5	5	0	2	7	0	0
14	20729908	.	A	G	1	4	5	0	0	5	0	0
14	20733160	.	A	G	2	2	4	0	1	5	0	0
14	20736675	.	G	T	10	3	13	0	0	13	0	0
14	20736867	.	C	T	6	2	8	0	0	8	0	0
14	21750970	.	C	T	2	1	3	0	0	3	0	0
14	21766410	.	C	T	0	1	1	0	0	1	0	0
14	21766428	.	A	G	0	1	1	0	0	1	0	0
14	21768418	.	G	A	2	1	3	0	0	3	0	0
14	21770666	.	C	G	2	6	8	0	0	9	1	0
14	21770708	.	A	G	3	0	3	0	5	8	0	0
14	21772267	.	T	C	9	5	14	0	0	14	0	0
14	21772385	.	T	C	3	11	14	0	0	14	0	0
14	21772412	.	C	T	7	10	17	0	0	17	0	0
14	21772459	.	T	C	9	7	16	0	0	16	0	0
14	21772466	.	T	C	8	7	15	0	0	15	0	0
14	21772553	.	C	T	7	12	19	0	0	19	0	0
14	21772594	.	A	G	3	8	11	0	3	14	0	0
14	21772663	.	G	C	5	5	10	0	0	10	0	0
14	21779102	.	C	T	8	4	12	0	1	13	0	0
14	21779241	.	G	A	12	5	17	0	1	18	0	0
14	21779300	.	T	G	9	11	20	0	0	20	0	0
14	21779518	.	C	T	5	3	8	0	2	10	0	0
14	21779582	.	T	C	4	3	7	0	0	7	0	0
14	21779617	.	T	C	4	5	9	0	0	9	0	0
14	21779633	.	T	C	3	4	7	0	0	7	0	0
14	21779668	.	T	G	1	4	5	0	0	5	0	0
14	21779678	.	C	T	2	3	5	0	0	5	0	0
14	21779977	.	G	A	6	4	10	0	0	10	0	0
14	21780155	.	C	G	7	6	13	0	0	13	0	0
14	21780206	.	A	G	11	5	16	0	1	17	0	0
14	21780274	.	A	C	4	6	10	0	1	11	0	0
14	21780321	.	T	C	5	7	12	0	0	12	0	0
14	21783361	.	T	G	5	8	13	0	2	15	0	0
14	21797819	.	T	C	0	1	1	0	0	1	0	0
14	21816373	.	C	T	17	15	32	0	2	34	0	0
14	21816388	.	T	C	18	14	32	0	0	32	0	0
14	21816467	.	G	A	7	15	22	0	0	22	0	0
14	21834912	.	C	T	2	4	6	0	1	7	0	0
14	21840858	.	A	G	0	0	0	0	5	5	0	0
14	21842735	.	A	C	14	21	35	0	4	39	0	0
14	21843297	.	G	C	9	10	19	0	0	19	0	0
14	21844187	.	T	A	12	11	23	0	1	25	1	0
14	21844486	.	C	T	6	11	17	0	0	17	0	0
14	21844668	.	A	C	10	11	21	0	0	21	0	0
14	21844679	.	T	A	10	9	19	0	0	19	0	0
14	21845129	.	T	A	12	14	26	0	0	26	0	0
14	21845363	.	A	G	18	0	18	0	11	29	0	0
14	21845822	.	A	C	18	5	23	1	1	25	0	0
14	21924299	.	A	G	4	4	8	0	0	8	0	0
14	21931388	.	G	A	0	1	1	0	0	1	0	0
14	21987518	.	C	T	1	2	3	0	0	3	0	0
14	21999213	.	A	G	0	2	2	0	0	2	0	0
14	22102371	.	A	G	8	12	20	0	1	21	0	0
14	22102381	.	A	G	11	12	23	0	0	23	0	0
14	22104906	.	T	C	3	5	8	0	0	8	0	0
14	22104948	.	G	A	1	1	2	0	0	2	0	0
14	22108215	.	C	T	9	15	24	0	1	25	0	0
14	22108368	.	A	T	2	5	7	0	0	7	0	0
14	22108373	.	G	A	2	5	7	0	0	7	0	0
14	22132473	.	T	C	29	14	43	0	1	44	0	0
14	22132536	.	A	T	3	9	12	0	0	12	0	0
14	22139153	.	G	A	1	1	2	0	0	2	0	0
14	22139358	.	G	A	18	30	48	0	0	48	0	0
14	22139398	.	T	A	31	20	51	0	1	52	0	0
14	22139668	.	G	A	1	34	35	0	19	54	0	0
14	22140150	.	G	A	2	3	5	0	0	5	0	0
14	22140158	.	T	C	2	3	5	0	0	5	0	0
14	22140417	.	T	C	6	5	11	0	1	12	0	0
14	22151875	.	G	A	12	7	19	0	0	19	0	0
14	22151879	.	C	T	1	7	8	0	14	22	0	0
14	22151913	.	C	T	14	14	28	0	0	28	0	0
14	22172138	.	C	T	18	13	31	0	0	31	0	0
14	22249344	.	G	A	9	4	13	0	1	14	0	0
14	22254184	.	T	C	9	13	22	0	1	23	0	0
14	22272120	.	A	G	22	1	23	0	19	42	0	0
14	22272340	.	G	A	24	14	38	0	1	39	0	0
14	22272351	.	G	A	21	15	36	0	0	36	0	0
14	22272749	.	A	G	16	0	16	0	20	36	0	0
14	22370189	.	T	C	1	4	5	0	0	5	0	0
14	22441210	.	A	T	2	2	4	0	0	4	0	0
14	23187210	.	C	T	3	2	5	0	0	5	0	0
14	23405034	.	G	A	6	3	9	0	0	9	0	0
14	23411712	.	G	T	0	2	2	0	0	2	0	0
14	23455989	.	G	A	7	3	10	0	0	10	0	0
14	23463681	.	G	A	0	0	0	0	2	2	0	0
14	23463708	.	A	G	4	1	5	0	0	5	0	0
14	23463717	.	A	G	4	0	4	0	1	5	0	0
14	23463760	.	C	A	1	0	1	0	0	1	0	0
14	23609772	.	C	T	2	4	6	0	0	6	0	0
14	23609814	.	C	T	1	1	2	0	0	2	0	0
14	23613274	.	G	T	7	3	10	0	0	10	0	0
14	23615471	.	C	T	7	8	15	0	0	15	0	0
14	23615480	.	G	A	8	6	14	0	1	15	0	0
14	23621903	.	C	T	3	3	6	0	0	6	0	0
14	23622190	.	C	T	5	8	13	0	0	13	0	0
14	23663911	.	G	C	5	4	9	0	0	9	0	0
14	23664063	.	T	G	3	5	8	0	0	8	0	0
14	23666002	.	C	T	6	4	10	0	0	10	0	0
14	23666227	.	G	A	0	9	9	0	10	19	0	0
14	23666326	.	C	T	12	8	20	0	3	23	0	0
14	23666491	.	G	A	0	0	0	0	1	1	0	0
14	23673373	.	G	A	0	3	3	0	1	4	0	0
14	23673499	.	A	G	4	6	10	0	1	11	0	0
14	23673514	.	G	A	2	6	8	0	2	10	0	0
14	23679369	.	T	C	4	0	4	0	2	6	0	0
14	23679375	.	T	A	4	3	7	0	0	7	0	0
14	23680031	.	C	T	2	2	4	0	0	4	0	0
14	23680344	.	T	C	5	2	7	0	0	7	0	0
14	23687872	.	G	C	3	14	17	0	0	17	0	0
14	23693720	.	G	T	4	4	8	0	0	8	0	0
14	23693914	.	T	C	2	1	3	0	0	3	0	0
14	23696893	.	A	T	1	2	3	0	0	3	0	0
14	23700121	.	T	C	13	17	30	0	2	32	0	0
14	23700142	.	G	T	14	15	29	0	3	32	0	0
14	23702323	.	G	A	0	5	5	0	4	9	0	0
14	23702703	.	G	A	1	1	2	0	1	3	0	0
14	23704771	.	G	C	0	8	8	0	9	17	0	0
14	23707976	.	A	G	6	12	18	1	2	21	0	0
14	23710471	.	T	A	1	2	3	0	0	3	0	0
14	23710474	.	G	A	1	2	3	0	0	3	0	0
14	23717277	.	A	T	25	23	48	0	1	49	0	0
14	23717289	.	A	T	25	23	48	0	2	50	0	0
14	23720196	.	A	T	7	4	11	0	1	12	0	0
14	23722030	.	C	T	5	4	9	0	0	9	0	0
14	23726393	.	C	A	31	24	55	0	3	58	0	0
14	23726413	.	G	A	29	29	58	0	1	59	0	0
14	23726547	.	C	T	15	32	47	0	6	53	0	0
14	23732056	.	C	A	1	2	3	0	0	3	0	0
14	23732117	.	T	C	1	6	7	0	0	7	0	0
14	23732134	.	C	T	1	7	8	0	0	8	0	0
14	23732167	.	C	A	3	11	14	0	1	15	0	0
14	23732368	.	C	A	0	15	15	0	7	22	0	0
14	23732396	.	A	G	6	12	18	0	2	20	0	0
14	23732444	.	G	T	7	11	18	0	0	18	0	0
14	23732497	.	C	A	11	11	22	0	0	23	1	0
14	23732508	.	C	T	10	15	25	0	2	27	0	0
14	23732547	.	T	A	4	11	15	0	0	15	0	0
14	23732745	.	C	G	3	7	10	0	0	10	0	0
14	23732824	.	T	A	2	3	5	0	0	5	0	0
14	23732916	.	C	T	2	3	5	0	0	5	0	0
14	23732924	.	A	T	2	2	4	0	1	5	0	0
14	23733097	.	A	G	5	8	13	0	1	14	0	0
14	23733220	.	G	A	5	14	19	0	2	21	0	0
14	23747360	.	T	A	19	14	33	0	1	34	0	0
14	23748654	.	A	G	16	12	28	0	1	29	0	0
14	23752335	.	C	T	8	4	12	0	0	12	0	0
14	23756410	.	G	A	6	4	10	0	0	10	0	0
14	23756637	.	A	G	8	4	12	0	0	12	0	0
14	23756680	.	A	G	6	6	12	0	0	12	0	0
14	23756716	.	T	A	2	11	13	0	0	13	0	0
14	23756752	.	T	G	7	13	20	0	0	20	0	0
14	23756809	.	G	T	11	11	22	0	0	22	0	0
14	23799271	.	G	T	6	7	13	0	0	13	0	0
14	23799293	.	T	C	5	6	11	0	1	12	0	0
14	23801145	.	C	A	0	8	8	0	8	16	0	0
14	23801159	.	C	A	0	7	7	0	7	14	0	0
14	23801249	.	G	A	2	5	7	0	0	7	0	0
14	23811956	.	T	C	4	2	6	0	0	6	0	0
14	23811978	.	C	T	4	2	6	0	0	6	0	0
14	23812581	.	C	T	2	2	4	0	0	4	0	0
14	23947586	.	A	G	1	0	1	0	2	3	0	0
14	23947690	.	A	G	1	3	4	0	0	4	0	0
14	23961006	.	C	G	1	0	1	0	2	3	0	0
14	23967772	.	G	A	1	3	4	0	0	4	0	0
14	23968720	.	G	A	2	7	9	0	1	10	0	0
14	23969152	.	G	A	5	2	7	0	1	8	0	0
14	23969154	.	T	C	5	1	6	0	2	8	0	0
14	23969796	.	T	C	2	3	5	0	0	5	0	0
14	23970822	.	A	T	2	2	4	0	0	4	0	0
14	23972351	.	C	T	5	3	8	0	0	8	0	0
14	23972572	.	G	A	7	3	10	0	2	12	0	0
14	23972587	.	C	T	6	2	8	0	0	8	0	0
14	23982623	.	A	T	3	5	8	0	2	10	0	0
14	23991507	.	C	T	4	10	14	0	0	14	0	0
14	23993952	.	A	G	15	17	32	0	0	32	0	0
14	23998961	.	C	A	14	15	29	0	2	31	0	0
14	23999021	.	C	T	11	23	34	0	1	35	0	0
14	23999112	.	A	G	15	22	37	0	1	38	0	0
14	23999315	.	A	G	12	10	22	0	0	22	0	0
14	23999459	.	A	C	7	8	15	0	0	15	0	0
14	24092556	.	A	C	2	2	4	0	0	4	0	0
14	24097686	.	A	G	10	8	18	0	0	18	0	0
14	24097734	.	G	A	11	7	18	0	0	18	0	0
14	24098191	.	T	C	2	1	3	0	5	8	0	0
14	24098648	.	G	A	12	10	22	0	0	22	0	0
14	24098694	.	G	T	20	10	30	0	1	31	0	0
14	24099059	.	A	T	10	8	18	0	2	20	0	0
14	24099240	.	C	A	9	7	16	0	1	17	0	0
14	24109706	.	T	G	10	7	17	0	0	17	0	0
14	24220467	.	A	G	20	0	20	0	17	37	0	0
14	24220959	.	A	T	12	4	16	0	1	17	0	0
14	24221053	.	G	A	12	5	17	0	0	17	0	0
14	24221194	.	T	A	9	15	24	0	1	25	0	0
14	24248398	.	C	A	6	6	12	0	1	13	0	0
14	24268332	.	A	C	5	0	5	0	7	12	0	0
14	24268403	.	G	A	1	4	5	0	0	5	0	0
14	24268676	.	A	T	4	9	13	0	1	14	0	0
14	24268781	.	G	A	14	13	27	0	0	27	0	0
14	24274575	.	C	T	0	1	1	0	0	1	0	0
14	24278144	.	C	G	28	15	43	0	0	43	0	0
14	24278162	.	C	G	28	12	40	0	2	42	0	0
14	24278234	.	A	G	24	10	34	0	0	34	0	0
14	24278831	.	T	C	16	17	33	0	2	35	0	0
14	24279011	.	A	C	9	13	22	0	1	23	0	0
14	24279305	.	A	T	6	3	9	0	0	10	1	0
14	24279326	.	A	C	6	6	12	0	0	12	0	0
14	24279383	.	T	A	11	13	24	0	0	24	0	0
14	24279429	.	T	C	12	13	25	0	0	25	0	0
14	24279459	.	C	G	16	15	31	0	0	31	0	0
14	24279551	.	A	G	21	1	22	0	15	37	0	0
14	24279682	.	T	C	12	19	31	0	0	31	0	0
14	24280452	.	T	C	12	8	20	0	2	22	0	0
14	24280517	.	A	C	11	14	25	0	0	25	0	0
14	24280904	.	T	G	5	25	30	0	2	32	0	0
14	24280975	.	A	G	14	10	24	0	1	25	0	0
14	24281118	.	T	A	16	15	31	0	0	31	0	0
14	24281149	.	A	C	9	6	15	0	0	15	0	0
14	24281292	.	T	C	0	0	0	0	0	0	0	0
14	24283609	.	G	A	11	19	30	0	1	31	0	0
14	24288525	.	T	A	0	3	3	0	0	3	0	0
14	24301750	.	G	T	10	9	19	0	2	21	0	0
14	24301779	.	T	G	10	6	16	0	1	17	0	0
14	24301946	.	C	A	8	4	12	0	0	12	0	0
14	24302052	.	T	C	4	2	6	0	0	6	0	0
14	24302236	.	A	C	6	8	14	0	0	14	0	0
14	24302310	.	A	C	2	3	5	0	0	5	0	0
14	24302322	.	A	T	3	2	5	0	0	5	0	0
14	24302363	.	T	A	4	3	7	0	0	7	0	0
14	24302428	.	T	C	3	3	6	0	0	6	0	0
14	24302439	.	G	A	4	3	7	0	0	7	0	0
14	24302560	.	G	A	7	8	15	0	0	15	0	0
14	24302766	.	T	G	5	3	8	0	1	9	0	0
14	24302770	.	G	T	0	3	3	0	6	9	0	0
14	24302825	.	T	C	6	3	9	0	1	10	0	0
14	24303104	.	G	C	5	3	8	0	0	8	0	0
14	24303205	.	T	A	2	2	4	0	0	4	0	0
14	24303217	.	G	A	2	4	6	0	0	6	0	0
14	24303465	.	G	T	0	7	7	0	9	16	0	0
14	24303504	.	C	T	9	8	17	0	0	17	0	0
14	24303523	.	G	T	8	11	19	0	1	20	0	0
14	24303660	.	T	C	8	8	16	0	0	16	0	0
14	24303665	.	C	A	7	8	15	0	0	15	0	0
14	24303767	.	C	G	5	3	8	0	0	8	0	0
14	24304271	.	T	A	7	9	16	0	0	16	0	0
14	24304276	.	G	A	8	8	16	0	0	16	0	0
14	24304480	.	A	C	6	4	10	0	0	11	1	0
14	24304518	.	T	C	8	4	12	0	0	12	0	0
14	24304591	.	T	A	11	10	21	0	0	21	0	0
14	24304823	.	A	G	6	6	12	0	0	12	0	0
14	24317226	.	G	A	21	21	42	0	1	43	0	0
14	24317266	.	A	T	22	21	43	0	4	48	1	0
14	24317272	.	G	A	21	23	44	0	6	50	0	0
14	24317316	.	C	T	23	30	53	0	1	54	0	0
14	24317508	.	T	C	30	27	57	0	1	58	0	0
14	24317576	.	A	G	16	35	51	0	5	56	0	0
14	24317751	.	C	A	1	16	17	0	20	37	0	0
14	24318041	.	A	T	18	21	39	0	2	41	0	0
14	24318087	.	A	T	18	25	43	0	1	44	0	0
14	24318479	.	A	T	21	20	41	0	1	42	0	0
14	24318685	.	G	A	12	14	26	0	1	27	0	0
14	24318723	.	T	C	16	16	32	0	0	32	0	0
14	24318726	.	T	C	14	2	16	0	15	31	0	0
14	24318868	.	T	C	28	21	49	0	1	50	0	0
14	24325537	.	T	C	8	7	15	0	0	15	0	0
14	24326937	.	G	A	3	2	5	0	0	5	0	0
14	24327917	.	G	A	8	9	17	0	0	17	0	0
14	24328142	.	T	C	9	17	26	0	0	26	0	0
14	24328303	.	T	C	0	0	0	0	3	3	0	0
14	24332141	.	G	T	1	1	2	0	0	2	0	0
14	24332817	.	A	T	4	11	15	0	0	15	0	0
14	24333761	.	A	G	4	8	12	0	2	14	0	0
14	24369557	.	G	A	2	10	12	0	1	13	0	0
14	24391361	.	A	G	11	12	23	0	1	24	0	0
14	24406609	.	C	G	1	7	8	0	6	14	0	0
14	24409293	.	C	A	0	7	7	0	3	10	0	0
14	24410373	.	G	A	1	2	3	0	1	4	0	0
14	24410384	.	T	C	3	0	3	0	7	10	0	0
14	24410450	.	A	C	13	19	32	0	0	32	0	0
14	24410556	.	T	C	18	16	34	0	0	34	0	0
14	24492051	.	G	C	4	3	7	0	1	8	0	0
14	24492154	.	C	T	5	2	7	0	1	8	0	0
14	24492225	.	G	A	2	6	8	0	1	9	0	0
14	24492226	.	C	A	0	7	7	0	2	9	0	0
14	24841094	.	T	C	2	3	5	0	0	5	0	0
14	24853036	.	A	G	0	1	1	0	0	1	0	0
14	24857159	.	T	A	1	1	2	0	1	3	0	0
14	24973441	.	A	T	0	1	1	0	0	1	0	0
14	24985474	.	T	C	4	2	6	0	0	6	0	0
14	24985478	.	C	T	5	3	8	0	0	8	0	0
14	24985582	.	C	A	5	6	11	0	0	11	0	0
14	24990428	.	G	T	2	5	7	0	1	8	0	0
14	24990720	.	G	A	4	3	7	0	0	7	0	0
14	24997249	.	G	A	0	2	2	0	4	6	0	0
14	24997535	.	C	T	5	4	9	0	0	9	0	0
14	24997954	.	C	A	7	5	12	0	0	12	0	0
14	24998076	.	A	G	7	0	7	0	9	16	0	0
14	24998093	.	T	C	7	11	18	0	0	18	0	0
14	24998121	.	C	T	9	7	16	0	0	16	0	0
14	24998203	.	C	T	9	11	20	0	0	20	0	0
14	24998359	.	C	A	5	8	13	0	0	13	0	0
14	24998765	.	A	T	11	5	16	0	0	16	0	0
14	24998930	.	C	G	9	8	17	0	0	17	0	0
14	24999573	.	A	G	5	0	5	0	18	23	0	0
14	25000109	.	A	G	1	9	10	0	0	10	0	0
14	25000492	.	A	T	5	3	8	0	0	8	0	0
14	25000621	.	A	G	8	7	15	0	1	16	0	0
14	25035579	.	T	C	0	1	1	0	0	1	0	0
14	25040313	.	G	A	1	1	2	0	0	2	0	0
14	25063607	.	G	T	1	1	2	0	0	2	0	0
14	25063617	.	A	G	1	1	2	0	0	2	0	0
14	25065972	.	T	C	1	0	1	0	3	4	0	0
14	25066722	.	T	A	1	0	1	0	0	1	0	0
14	25066754	.	A	C	1	0	1	0	0	1	0	0
14	25067463	.	G	T	3	6	9	0	0	9	0	0
14	25067905	.	C	T	11	16	27	0	2	29	0	0
14	25076629	.	A	G	4	2	6	0	1	7	0	0
14	25077642	.	G	A	12	12	24	0	0	24	0	0
14	25078505	.	A	T	10	4	14	0	0	14	0	0
14	25080687	.	C	G	22	9	31	0	1	32	0	0
14	25102078	.	G	A	0	4	4	1	0	5	0	0
14	25490872	.	T	G	0	0	0	0	1	1	0	0
14	25501086	.	T	A	1	2	3	0	0	3	0	0
14	25905868	.	A	G	5	5	10	0	0	10	0	0
14	25905869	.	A	G	4	6	10	0	0	10	0	0
14	25907335	.	A	G	2	4	6	0	0	6	0	0
14	26105053	.	C	T	1	7	8	0	0	8	0	0
14	26404641	.	T	G	0	3	3	0	0	3	0	0
14	26405284	.	C	T	1	5	6	0	0	6	0	0
14	26805963	.	C	A	0	10	10	0	0	10	0	0
14	29746419	.	T	C	0	10	10	0	0	10	0	0
14	31643781	.	A	G	6	10	16	0	0	16	0	0
14	31643824	.	A	G	7	0	7	0	4	11	0	0
14	31644646	.	A	G	2	10	12	0	0	12	0	0
14	31647217	.	A	G	5	12	17	0	1	18	0	0
14	31647335	.	G	T	2	9	11	0	0	11	0	0
14	33282483	.	T	C	0	6	6	0	7	13	0	0
14	33330524	.	C	T	1	2	3	0	1	4	0	0
14	33754492	.	T	C	0	15	15	0	1	16	0	0
14	33826997	.	T	C	6	6	12	0	0	12	0	0
14	33827283	.	T	C	3	0	3	0	2	5	0	0
14	33901591	.	T	C	7	3	10	0	0	10	0	0
14	34090422	.	A	G	4	2	6	0	0	6	0	0
14	34125983	.	T	A	2	3	5	0	0	5	0	0
14	34126061	.	T	A	4	3	7	0	0	7	0	0
14	34130170	.	C	T	1	7	8	0	0	8	0	0
14	34130357	.	T	C	2	4	6	0	0	6	0	0
14	34488338	.	C	T	5	3	8	0	0	8	0	0
14	34634748	.	G	A	1	4	5	0	0	5	0	0
14	35804833	.	A	G	2	5	7	0	2	9	0	0
14	35813114	.	A	T	12	4	16	0	0	16	0	0
14	35813121	.	T	A	2	16	18	0	2	20	0	0
14	36268424	.	T	C	0	5	5	0	0	5	0	0
14	36268426	.	T	C	0	5	5	0	0	5	0	0
14	36720985	.	A	G	5	3	8	0	0	8	0	0
14	36752556	.	C	T	0	0	0	0	5	5	0	0
14	38656962	.	T	C	4	3	7	0	1	8	0	0
14	38656976	.	A	C	5	4	9	0	0	9	0	0
14	38659002	.	G	A	1	2	3	0	0	3	0	0
14	38668543	.	G	C	0	5	5	0	0	5	0	0
14	38668546	.	T	C	0	5	5	0	0	5	0	0
14	38668782	.	C	A	0	1	1	0	0	1	0	0
14	38668815	.	C	T	1	2	3	0	0	3	0	0
14	38672521	.	G	T	4	4	8	0	0	9	1	0
14	38678070	.	C	T	1	2	3	0	0	3	0	0
14	38688730	.	G	A	4	4	8	0	0	8	0	0
14	38688829	.	G	C	7	6	13	0	2	15	0	0
14	38689174	.	G	A	3	6	9	0	0	9	0	0
14	38689332	.	A	G	4	9	13	0	0	13	0	0
14	38689409	.	A	C	2	3	5	0	0	6	1	0
14	38689428	.	G	C	3	4	7	0	0	7	0	0
14	38689648	.	A	T	3	2	5	0	0	5	0	0
14	38763334	.	A	C	8	11	19	0	4	23	0	0
14	38763381	.	G	A	14	15	29	0	1	30	0	0
14	38763394	.	G	A	13	20	33	0	1	34	0	0
14	38783272	.	T	C	5	11	16	0	1	17	0	0
14	38796156	.	C	G	0	1	1	0	0	1	0	0
14	38802662	.	G	T	2	3	5	0	1	6	0	0
14	38802884	.	C	T	2	8	10	0	2	12	0	0
14	38802904	.	A	T	2	7	9	0	0	9	0	0
14	38802960	.	G	A	2	3	5	0	0	5	0	0
14	38802967	.	T	G	2	2	4	0	0	4	0	0
14	38803085	.	G	A	0	2	2	0	0	2	0	0
14	38806916	.	G	T	2	2	4	0	0	4	0	0
14	38809356	.	G	A	1	6	7	0	0	7	0	0
14	38809512	.	C	T	1	7	8	0	0	8	0	0
14	38809528	.	T	C	6	1	7	0	0	7	0	0
14	38812126	.	T	C	2	1	3	0	0	3	0	0
14	38812131	.	G	C	0	1	1	0	2	3	0	0
14	38845762	.	T	C	10	11	21	0	0	21	0	0
14	38845912	.	A	G	32	24	56	0	2	59	1	0
14	38846587	.	A	T	41	15	56	0	1	57	0	0
14	38847235	.	A	G	18	11	29	0	3	32	0	0
14	38847497	.	A	G	2	0	2	0	5	7	0	0
14	38849729	.	C	T	21	30	51	0	1	52	0	0
14	38849946	.	A	C	29	25	54	0	0	54	0	0
14	38853821	.	C	T	1	3	4	0	1	5	0	0
14	38862589	.	A	G	5	6	11	0	0	11	0	0
14	38862598	.	A	G	6	6	12	0	0	12	0	0
14	38865589	.	C	T	0	3	3	0	1	4	0	0
14	38869753	.	G	A	1	3	4	0	0	4	0	0
14	38872410	.	C	T	2	0	2	0	0	2	0	0
14	38875289	.	C	T	1	3	4	0	0	4	0	0
14	38875488	.	T	C	1	3	4	0	0	4	0	0
14	38875512	.	A	G	0	4	4	0	1	5	0	0
14	38878552	.	T	C	10	10	20	0	1	21	0	0
14	38881266	.	G	T	7	5	12	0	3	16	1	0
14	38881281	.	T	A	8	4	12	0	2	14	0	0
14	38881363	.	G	A	0	3	3	0	2	5	0	0
14	38881711	.	G	A	1	3	4	0	0	4	0	0
14	38882982	.	T	C	1	3	4	0	0	4	0	0
14	38937085	.	T	C	3	0	3	0	8	11	0	0
14	38937099	.	T	C	4	6	10	0	0	10	0	0
14	38937305	.	C	T	2	4	6	0	0	6	0	0
14	38941498	.	A	G	7	5	12	0	0	13	1	0
14	38946708	.	A	G	5	4	9	0	0	9	0	0
14	38946732	.	G	A	3	5	8	0	0	8	0	0
14	39002555	.	C	T	4	4	8	0	0	8	0	0
14	39002562	.	C	T	2	5	7	0	0	7	0	0
14	39002698	.	C	A	5	3	8	0	1	9	0	0
14	39002739	.	G	C	10	0	10	0	5	15	0	0
14	39002752	.	A	G	7	5	12	0	0	12	0	0
14	39002820	.	A	T	8	7	15	0	0	15	0	0
14	39002883	.	A	G	12	5	17	0	0	17	0	0
14	39003039	.	T	G	0	2	2	0	0	2	0	0
14	39017596	.	G	A	1	5	6	0	1	7	0	0
14	39608615	.	A	G	0	0	0	0	2	2	0	0
14	40746034	.	A	G	3	2	5	0	0	5	0	0
14	40746451	.	A	T	2	3	5	0	0	5	0	0
14	40746452	.	A	G	2	3	5	0	0	5	0	0
14	40852670	.	A	T	3	7	10	0	0	10	0	0
14	40852732	.	T	C	7	5	12	0	0	12	0	0
14	40853268	.	C	G	1	0	1	0	0	1	0	0
14	40857654	.	T	G	2	1	3	0	0	3	0	0
14	40857711	.	G	A	3	0	3	0	0	3	0	0
14	40857881	.	T	C	5	2	7	0	0	7	0	0
14	40857977	.	C	T	5	4	9	0	0	9	0	0
14	40859179	.	A	G	11	0	11	0	9	20	0	0
14	40860291	.	T	A	4	3	7	0	0	7	0	0
14	40860354	.	C	T	12	8	20	0	3	23	0	0
14	40863062	.	A	G	16	19	35	0	0	35	0	0
14	40863161	.	T	C	10	11	21	0	2	23	0	0
14	40863176	.	A	G	9	6	15	0	0	15	0	0
14	40869331	.	C	A	8	12	20	0	1	21	0	0
14	40874026	.	G	T	6	5	11	0	0	11	0	0
14	41276516	.	T	A	6	9	15	0	0	15	0	0
14	41276608	.	G	A	5	7	12	0	0	12	0	0
14	41277391	.	A	T	6	9	15	0	0	15	0	0
14	41277424	.	C	A	6	13	19	0	0	19	0	0
14	41277556	.	A	G	22	26	48	0	3	51	0	0
14	41277624	.	A	T	29	18	47	0	2	49	0	0
14	41278238	.	T	A	14	21	35	0	0	35	0	0
14	41278255	.	A	G	19	15	34	0	0	34	0	0
14	41278658	.	T	G	9	8	17	0	0	17	0	0
14	41278754	.	C	G	4	5	9	0	0	9	0	0
14	41278945	.	T	C	0	4	4	0	1	5	0	0
14	41278946	.	T	C	0	5	5	0	0	5	0	0
14	41279133	.	C	T	15	13	28	2	2	32	0	0
14	41279214	.	C	T	18	15	33	0	1	34	0	0
14	41279277	.	G	C	23	15	38	0	3	41	0	0
14	41279479	.	T	A	6	6	12	0	1	13	0	0
14	41279527	.	C	T	0	10	10	0	6	16	0	0
14	41279542	.	C	A	2	7	9	0	12	21	0	0
14	41279624	.	G	A	21	13	34	0	2	36	0	0
14	41279974	.	T	G	20	11	31	0	0	31	0	0
14	41279977	.	G	T	19	10	29	0	0	29	0	0
14	41280013	.	G	A	14	17	31	0	1	32	0	0
14	41280149	.	G	A	26	23	49	0	0	49	0	0
14	41280228	.	A	G	26	19	45	0	3	48	0	0
14	41280517	.	G	C	5	1	6	0	0	6	0	0
14	41318507	.	C	T	2	1	3	0	0	3	0	0
14	41318808	.	T	G	1	0	1	0	3	4	0	0
14	41319073	.	C	T	1	3	4	0	0	4	0	0
14	41333519	.	A	G	2	1	3	0	0	3	0	0
14	41339309	.	T	C	4	2	6	0	0	6	0	0
14	41339820	.	G	C	6	7	13	0	0	13	0	0
14	41339972	.	G	A	0	5	5	0	1	6	0	0
14	41340081	.	A	T	1	5	6	0	0	6	0	0
14	41340172	.	A	C	7	4	11	0	1	12	0	0
14	41340231	.	G	A	2	5	7	0	2	9	0	0
14	41361985	.	C	T	0	6	6	0	6	12	0	0
14	41362007	.	G	A	3	8	11	0	0	11	0	0
14	41362060	.	C	T	18	4	22	0	0	22	0	0
14	41366823	.	G	A	16	14	30	0	1	31	0	0
14	41366889	.	C	A	0	3	3	0	0	3	0	0
14	41385823	.	G	A	5	5	10	0	0	10	0	0
14	41385895	.	C	T	0	7	7	0	8	15	0	0
14	41388120	.	G	A	9	9	18	0	0	18	0	0
14	41388142	.	G	A	1	4	5	0	0	5	0	0
14	41406558	.	G	T	1	1	2	0	0	2	0	0
14	41414483	.	C	A	1	2	3	0	0	3	0	0
14	41414756	.	C	G	1	0	1	0	4	5	0	0
14	41414857	.	C	T	3	3	6	0	0	6	0	0
14	41428500	.	C	T	7	9	16	0	0	16	0	0
14	41435662	.	C	T	3	8	11	0	0	11	0	0
14	41436773	.	T	A	5	6	11	0	0	11	0	0
14	41436943	.	C	T	4	6	10	0	0	10	0	0
14	41438005	.	G	A	5	2	7	0	0	7	0	0
14	41466483	.	T	A	3	2	5	0	1	6	0	0
14	41466522	.	G	A	7	8	15	0	0	15	0	0
14	41466922	.	T	A	14	17	31	0	0	31	0	0
14	41467152	.	T	C	20	22	42	0	1	43	0	0
14	41467155	.	C	T	24	19	43	0	0	43	0	0
14	41467356	.	C	G	19	19	38	0	2	40	0	0
14	41469575	.	T	A	3	5	8	0	0	8	0	0
14	41469662	.	C	A	3	4	7	0	0	7	0	0
14	41469925	.	T	A	9	8	17	0	0	17	0	0
14	41469935	.	C	T	8	6	14	0	2	16	0	0
14	41470032	.	C	T	0	8	8	0	7	15	0	0
14	41470037	.	A	T	5	7	12	0	3	15	0	0
14	41514842	.	C	T	4	2	6	0	0	6	0	0
14	41601375	.	A	G	1	2	3	0	0	3	0	0
14	41924526	.	T	G	4	0	4	0	2	6	0	0
14	42172389	.	A	C	3	6	9	0	0	9	0	0
14	42172457	.	T	A	4	5	9	0	4	13	0	0
14	42172459	.	G	C	0	8	8	0	5	13	0	0
14	42172527	.	G	A	0	3	3	0	0	3	0	0
14	42172732	.	G	A	0	5	5	0	4	9	0	0
14	42172745	.	C	T	4	7	11	0	0	11	0	0
14	42172951	.	G	A	0	7	7	0	4	11	0	0
14	42173803	.	C	T	3	4	7	0	0	7	0	0
14	42174247	.	G	A	0	8	8	0	7	15	0	0
14	42174401	.	C	T	5	6	11	0	0	11	0	0
14	42174645	.	A	T	7	10	17	0	1	18	0	0
14	42178503	.	C	T	12	9	21	0	1	22	0	0
14	42178728	.	G	A	12	11	23	0	1	24	0	0
14	42178974	.	G	A	13	10	23	0	0	23	0	0
14	42179574	.	G	T	1	5	6	0	0	6	0	0
14	42978975	.	A	G	13	7	20	0	0	20	0	0
14	42978980	.	A	C	10	10	20	0	1	21	0	0
14	42979030	.	T	C	9	1	10	0	10	20	0	0
14	42979087	.	A	T	5	9	14	0	0	14	0	0
14	42979090	.	T	A	5	9	14	0	0	14	0	0
14	42979655	.	A	G	19	18	37	0	2	39	0	0
14	42997943	.	G	A	7	16	23	0	0	23	0	0
14	42998353	.	G	A	5	3	8	0	1	9	0	0
14	42998879	.	G	A	6	7	13	0	2	15	0	0
14	42999314	.	C	T	10	8	18	0	1	19	0	0
14	42999524	.	C	T	8	9	17	0	0	17	0	0
14	43000785	.	A	T	6	8	14	0	0	14	0	0
14	43572499	.	A	G	0	2	2	0	0	2	0	0
14	43577346	.	C	T	0	8	8	0	10	18	0	0
14	43577704	.	G	A	9	4	13	0	3	16	0	0
14	43577916	.	G	A	1	0	1	0	0	1	0	0
14	43580985	.	G	T	4	5	9	0	0	9	0	0
14	43582551	.	C	G	1	5	6	0	1	7	0	0
14	43582567	.	G	A	2	5	7	0	0	7	0	0
14	43582602	.	C	T	1	1	2	0	0	2	0	0
14	43590849	.	C	T	1	2	3	0	1	4	0	0
14	43591152	.	G	T	1	6	7	0	1	8	0	0
14	43591188	.	G	A	2	14	16	0	1	17	0	0
14	43605462	.	C	T	4	3	7	0	0	7	0	0
14	43605498	.	T	C	7	0	7	0	5	12	0	0
14	43605510	.	G	A	5	5	10	0	0	10	0	0
14	43610206	.	T	C	0	1	1	0	0	1	0	0
14	44013794	.	C	A	7	6	13	0	1	14	0	0
14	44589624	.	C	T	8	16	24	0	0	24	0	0
14	44589834	.	A	G	14	7	21	0	1	22	0	0
14	44589972	.	T	A	7	6	13	0	0	13	0	0
14	44589978	.	G	A	7	7	14	0	0	14	0	0
14	44590297	.	G	C	7	10	17	0	0	17	0	0
14	44590301	.	A	G	7	0	7	0	11	18	0	0
14	44590644	.	C	T	8	16	24	0	0	24	0	0
14	44590838	.	T	A	6	12	18	0	0	18	0	0
14	44590935	.	G	A	0	9	9	0	14	23	0	0
14	44590992	.	A	G	7	10	17	0	0	17	0	0
14	45435739	.	T	A	6	0	6	0	1	7	0	0
14	45636070	.	G	A	3	12	15	0	17	32	0	0
14	45911045	.	T	A	1	2	3	0	0	3	0	0
14	45925763	.	A	G	0	2	2	0	1	3	0	0
14	45925764	.	A	G	1	2	3	0	0	3	0	0
14	45925992	.	A	C	2	3	5	0	0	5	0	0
14	45927130	.	T	G	3	0	3	0	2	5	0	0
14	45927624	.	T	A	2	3	5	0	1	6	0	0
14	45928154	.	C	T	3	2	5	0	0	5	0	0
14	45928155	.	T	G	3	2	5	0	0	5	0	0
14	45928333	.	T	G	1	1	2	0	1	3	0	0
14	45928370	.	C	A	1	2	3	0	0	3	0	0
14	45928383	.	A	G	2	0	2	0	2	4	0	0
14	45929100	.	A	T	3	2	5	0	2	7	0	0
14	45929137	.	T	G	3	3	6	0	0	6	0	0
14	45929140	.	T	A	3	3	6	0	0	6	0	0
14	45929280	.	C	T	3	2	5	0	0	5	0	0
14	45929409	.	C	T	5	4	9	0	0	9	0	0
14	45929837	.	T	A	4	8	12	0	0	12	0	0
14	45929974	.	T	C	1	4	5	0	0	5	0	0
14	45930135	.	T	C	4	5	9	0	0	9	0	0
14	45930196	.	A	C	2	6	8	0	0	8	0	0
14	45930399	.	C	T	5	3	8	0	0	8	0	0
14	45930508	.	A	G	2	3	5	0	0	5	0	0
14	45930515	.	G	A	2	3	5	0	0	5	0	0
14	45930669	.	A	G	9	4	13	0	0	13	0	0
14	45930794	.	G	A	2	8	10	0	0	10	0	0
14	45931194	.	G	T	6	8	14	0	0	14	0	0
14	45931504	.	C	G	8	4	12	0	0	12	0	0
14	45931637	.	C	T	7	8	15	0	1	16	0	0
14	45931899	.	C	T	7	5	12	0	1	13	0	0
14	46007306	.	A	G	6	7	13	0	0	13	0	0
14	46007321	.	G	A	5	6	11	0	0	11	0	0
14	46009611	.	G	A	8	9	17	0	1	18	0	0
14	46009683	.	A	T	4	2	6	0	0	6	0	0
14	46010711	.	C	T	1	1	2	0	0	2	0	0
14	46010909	.	T	C	4	1	5	0	0	5	0	0
14	46013121	.	A	T	1	7	8	0	0	8	0	0
14	46013402	.	C	T	17	14	31	0	0	31	0	0
14	46015888	.	C	A	1	0	1	0	0	1	0	0
14	46016107	.	A	G	5	2	7	0	0	7	0	0
14	46017969	.	G	A	14	13	27	0	2	29	0	0
14	46018029	.	C	T	14	12	26	0	0	26	0	0
14	46018548	.	A	G	11	18	29	0	0	29	0	0
14	46028329	.	G	T	3	7	10	0	0	10	0	0
14	46028330	.	T	A	3	7	10	0	0	10	0	0
14	46028376	.	G	A	1	2	3	0	1	4	0	0
14	46028548	.	G	C	0	0	0	0	1	1	0	0
14	46037489	.	T	C	2	5	7	0	1	8	0	0
14	46039904	.	C	G	2	0	2	0	5	7	0	0
14	46040318	.	T	C	3	2	5	0	0	5	0	0
14	46041701	.	T	A	0	2	2	0	1	3	0	0
14	46041800	.	C	T	5	4	9	0	0	9	0	0
14	46041861	.	A	T	4	5	9	0	0	9	0	0
14	46048644	.	C	T	0	7	7	0	7	14	0	0
14	46048704	.	C	G	0	11	11	0	6	17	0	0
14	46048875	.	T	C	13	13	26	0	6	32	0	0
14	46052172	.	T	A	7	7	14	0	0	14	0	0
14	46052244	.	G	T	4	6	10	0	0	10	0	0
14	46067317	.	A	T	1	1	2	0	0	2	0	0
14	46074433	.	C	T	6	3	9	0	0	9	0	0
14	46074473	.	T	A	6	4	10	0	0	10	0	0
14	46074489	.	A	G	6	3	9	0	0	9	0	0
14	46074626	.	C	G	1	3	4	0	0	4	0	0
14	46075640	.	A	C	6	3	9	0	0	9	0	0
14	46075749	.	A	G	6	4	10	0	1	11	0	0
14	46075937	.	T	A	5	2	7	0	0	7	0	0
14	46076293	.	G	A	4	3	7	0	0	7	0	0
14	46076858	.	T	C	3	2	5	0	0	5	0	0
14	46088921	.	A	G	2	6	8	0	0	8	0	0
14	46089176	.	C	T	2	5	7	0	0	7	0	0
14	46089234	.	C	G	4	2	6	0	0	6	0	0
14	46089239	.	T	C	4	2	6	0	0	6	0	0
14	46089433	.	T	G	7	3	10	0	1	11	0	0
14	46089667	.	T	C	2	0	2	0	3	5	0	0
14	46090508	.	T	A	2	3	5	0	1	6	0	0
14	46091627	.	T	C	3	6	9	0	1	10	0	0
14	46094922	.	C	T	10	4	14	0	1	15	0	0
14	46095043	.	A	G	19	11	30	0	2	32	0	0
14	46095058	.	A	G	21	7	28	0	0	28	0	0
14	46095108	.	A	G	28	26	54	0	1	55	0	0
14	46104150	.	C	T	6	5	11	0	2	13	0	0
14	46104222	.	C	T	0	4	4	0	4	8	0	0
14	46104935	.	G	A	4	4	8	0	0	8	0	0
14	46113296	.	T	G	18	18	36	0	2	38	0	0
14	46113309	.	C	G	0	15	15	0	15	30	0	0
14	46114929	.	G	A	2	1	3	0	0	3	0	0
14	46116576	.	A	G	9	3	12	0	1	13	0	0
14	46117279	.	G	T	6	9	15	0	0	15	0	0
14	46128948	.	A	C	1	2	3	0	0	3	0	0
14	46134040	.	A	G	2	0	2	0	1	3	0	0
14	46140707	.	C	G	2	0	2	0	0	2	0	0
14	46140812	.	C	A	1	5	6	0	0	6	0	0
14	46146715	.	G	A	8	7	15	0	3	18	0	0
14	46146730	.	G	A	7	10	17	0	1	18	0	0
14	46154358	.	C	A	7	8	15	0	0	15	0	0
14	46154713	.	A	G	7	5	12	0	0	12	0	0
14	46154899	.	A	C	5	8	13	0	1	14	0	0
14	46154966	.	T	A	7	6	13	0	0	13	0	0
14	46154969	.	T	A	8	6	14	0	0	14	0	0
14	46157752	.	A	G	2	3	5	0	0	5	0	0
14	46157760	.	C	T	2	2	4	0	0	4	0	0
14	46183354	.	A	G	3	3	6	0	0	6	0	0
14	46183683	.	A	G	4	4	8	0	1	9	0	0
14	46187317	.	A	G	2	3	5	0	0	5	0	0
14	46188019	.	A	G	1	2	3	0	0	3	0	0
14	46462391	.	A	G	4	2	6	0	0	6	0	0
14	46679274	.	T	C	2	3	5	0	0	5	0	0
14	46679356	.	T	C	6	5	11	0	0	11	0	0
14	46684142	.	T	C	1	2	3	0	0	3	0	0
14	46684369	.	T	C	2	2	4	0	0	4	0	0
14	46684372	.	T	C	2	2	4	0	0	4	0	0
14	47003023	.	T	G	9	8	17	0	0	17	0	0
14	47003330	.	A	C	15	17	32	0	0	32	0	0
14	47003696	.	G	T	15	20	35	0	0	35	0	0
14	47003908	.	C	T	0	29	29	0	13	42	0	0
14	47003958	.	T	A	23	22	45	0	2	47	0	0
14	47004090	.	T	G	16	13	29	0	0	29	0	0
14	47004187	.	C	A	11	12	23	0	0	23	0	0
14	47004365	.	G	A	19	9	28	0	0	28	0	0
14	47004734	.	G	A	16	10	26	0	0	26	0	0
14	47004959	.	T	G	13	8	21	0	0	21	0	0
14	47027767	.	G	A	10	6	16	0	0	16	0	0
14	47066764	.	G	A	11	6	17	0	0	17	0	0
14	47074234	.	A	G	8	7	15	0	0	15	0	0
14	47085624	.	A	G	9	5	14	0	0	14	0	0
14	47096209	.	T	C	4	0	4	0	7	11	0	0
14	47131242	.	T	G	1	3	4	0	0	4	0	0
14	47131260	.	G	A	2	4	6	0	0	6	0	0
14	47142032	.	C	T	0	3	3	0	0	3	0	0
14	47264962	.	T	C	1	0	1	0	5	6	0	0
14	47265031	.	A	G	2	2	4	0	0	4	0	0
14	47882878	.	T	A	1	2	3	0	3	6	0	0
14	48108252	.	T	G	0	1	1	0	4	5	0	0
14	48108396	.	A	T	2	1	3	0	6	9	0	0
14	48308651	.	C	T	1	3	4	0	0	4	0	0
14	48327265	.	G	A	1	2	3	0	0	3	0	0
14	48734802	.	T	G	1	2	3	0	0	3	0	0
14	48735325	.	T	C	0	2	2	0	1	3	0	0
14	48735327	.	G	C	1	2	3	0	0	3	0	0
14	48737884	.	T	A	3	2	5	0	0	5	0	0
14	48737886	.	T	C	3	2	5	0	0	5	0	0
14	48738994	.	C	T	2	3	5	0	0	5	0	0
14	48739018	.	A	T	1	3	4	0	0	4	0	0
14	48773479	.	A	G	3	5	8	0	0	8	0	0
14	48775983	.	A	G	5	3	8	0	0	8	0	0
14	48781160	.	C	G	1	3	4	0	0	4	0	0
14	48781534	.	A	G	1	2	3	0	0	3	0	0
14	48781694	.	C	G	1	2	3	0	0	3	0	0
14	48781832	.	C	T	2	3	5	0	0	5	0	0
14	48932470	.	T	A	14	25	39	0	4	43	0	0
14	48932712	.	G	A	9	15	24	0	0	24	0	0
14	48932880	.	A	T	22	15	37	0	0	37	0	0
14	48932970	.	T	A	16	21	37	0	3	40	0	0
14	48933224	.	A	G	21	19	40	0	5	45	0	0
14	48933273	.	C	A	27	14	41	0	0	41	0	0
14	48933361	.	T	A	33	11	44	0	2	46	0	0
14	48933513	.	T	C	11	9	20	0	0	20	0	0
14	48933575	.	A	G	14	8	22	0	0	22	0	0
14	48933772	.	G	A	0	3	3	1	2	6	0	0
14	48934025	.	G	A	28	15	43	0	1	44	0	0
14	48934052	.	G	A	23	16	39	0	0	39	0	0
14	48934253	.	G	A	16	11	27	0	1	28	0	0
14	48934276	.	G	A	17	7	24	0	0	24	0	0
14	48934299	.	C	A	12	0	12	0	0	12	0	0
14	48934406	.	T	C	22	3	25	0	5	30	0	0
14	48934407	.	C	T	0	5	5	0	25	30	0	0
14	48934547	.	A	T	28	15	43	0	0	43	0	0
14	48934577	.	G	T	27	16	43	0	1	44	0	0
14	48934630	.	C	G	28	10	38	0	2	40	0	0
14	48934639	.	T	C	30	0	30	0	6	36	0	0
14	48934701	.	T	C	17	22	39	0	5	44	0	0
14	48934719	.	T	G	21	22	43	0	3	46	0	0
14	48934829	.	T	A	23	22	45	0	4	49	0	0
14	48944721	.	T	A	1	4	5	0	0	5	0	0
14	48945321	.	G	C	2	0	2	0	1	3	0	0
14	48964697	.	T	C	12	18	30	0	1	31	0	0
14	48982416	.	C	T	1	3	4	0	1	5	0	0
14	48986944	.	C	T	0	2	2	0	0	2	0	0
14	48995443	.	G	A	1	1	2	0	1	3	0	0
14	48995473	.	C	T	2	3	5	0	0	5	0	0
14	48995551	.	C	G	3	2	5	0	1	6	0	0
14	48995894	.	C	A	2	4	6	0	0	6	0	0
14	48997311	.	A	T	3	3	6	0	0	6	0	0
14	48997367	.	G	A	6	3	9	0	1	10	0	0
14	48997620	.	G	C	1	2	3	0	0	3	0	0
14	49005427	.	G	A	0	1	1	0	3	4	0	0
14	49005446	.	C	A	2	1	3	0	0	3	0	0
14	49005469	.	A	G	2	1	3	0	0	3	0	0
14	49015393	.	C	T	1	1	2	0	0	2	0	0
14	49022071	.	A	G	5	0	5	0	8	13	0	0
14	49022145	.	A	G	3	0	3	0	8	11	0	0
14	49022191	.	G	T	2	6	8	0	3	11	0	0
14	49022238	.	G	A	2	5	7	0	2	9	0	0
14	49022290	.	G	T	0	5	5	0	2	7	0	0
14	49028477	.	T	A	0	1	1	0	0	1	0	0
14	49028593	.	T	C	1	4	5	0	1	6	0	0
14	49029025	.	C	T	1	3	4	0	0	4	0	0
14	49029026	.	A	G	1	3	4	0	0	4	0	0
14	49029159	.	C	A	4	5	9	0	0	9	0	0
14	49030054	.	A	G	5	5	10	0	0	10	0	0
14	49030205	.	T	G	0	2	2	0	0	2	0	0
14	49031569	.	A	G	5	4	9	0	0	9	0	0
14	49031848	.	A	G	2	7	9	0	0	9	0	0
14	49040574	.	G	A	9	11	20	0	0	20	0	0
14	49040773	.	G	A	5	6	11	0	1	12	0	0
14	49047525	.	T	G	21	17	38	0	1	39	0	0
14	49050397	.	T	G	8	8	16	0	2	18	0	0
14	49053391	.	G	A	5	9	14	0	0	14	0	0
14	49053402	.	C	G	7	10	17	0	0	17	0	0
14	49054446	.	T	C	6	0	6	0	9	15	0	0
14	49054449	.	G	A	6	8	14	0	0	14	0	0
14	49057246	.	G	A	6	4	10	0	0	10	0	0
14	49057273	.	C	G	4	4	8	0	0	8	0	0
14	49078766	.	A	C	0	2	2	0	1	3	0	0
14	49092514	.	G	A	1	2	3	0	0	3	0	0
14	49119017	.	G	A	4	3	7	0	0	7	0	0
14	49119048	.	G	T	14	15	29	0	1	30	0	0
14	49119062	.	G	A	19	20	39	0	3	42	0	0
14	49119192	.	T	A	18	16	34	0	3	37	0	0
14	49119218	.	C	A	9	10	19	0	0	19	0	0
14	49119321	.	A	C	27	29	56	0	0	56	0	0
14	49119484	.	T	A	21	16	37	0	1	38	0	0
14	49119656	.	G	A	19	4	23	0	8	31	0	0
14	49126924	.	G	A	18	5	23	0	0	23	0	0
14	49133139	.	A	G	11	11	22	0	0	22	0	0
14	49136065	.	G	A	2	16	18	0	9	27	0	0
14	49136245	.	G	A	1	10	11	0	7	18	0	0
14	49136483	.	C	T	17	20	37	0	0	37	0	0
14	49136551	.	T	G	4	4	8	0	5	13	0	0
14	49136838	.	A	T	6	15	21	0	0	21	0	0
14	49136909	.	C	T	5	7	12	0	1	13	0	0
14	49153665	.	C	T	3	3	6	0	0	6	0	0
14	49153681	.	T	C	2	2	4	0	0	4	0	0
14	49154087	.	A	T	2	3	5	0	0	5	0	0
14	49161148	.	T	C	2	2	4	0	0	4	0	0
14	49172185	.	A	T	2	3	5	0	0	5	0	0
14	49172331	.	C	T	1	2	3	0	0	3	0	0
14	49172886	.	G	C	2	3	5	0	0	5	0	0
14	49172961	.	G	A	0	5	5	0	2	7	0	0
14	49173550	.	A	G	2	2	4	0	0	4	0	0
14	49173619	.	C	T	1	3	4	0	0	4	0	0
14	49173778	.	C	T	0	1	1	0	0	1	0	0
14	49173791	.	A	T	0	0	0	0	1	1	0	0
14	49174995	.	G	T	4	1	5	0	1	6	0	0
14	49175256	.	T	C	1	0	1	0	0	1	0	0
14	49175303	.	T	C	1	2	3	0	0	3	0	0
14	49175591	.	C	T	1	0	1	0	0	1	0	0
14	49182980	.	T	G	1	1	2	0	0	2	0	0
14	49183198	.	C	T	1	2	3	0	0	3	0	0
14	49195504	.	C	T	1	0	1	0	0	1	0	0
14	49196784	.	C	T	2	2	4	0	0	4	0	0
14	49199004	.	A	T	2	3	5	0	0	5	0	0
14	49202111	.	C	G	6	3	9	0	0	9	0	0
14	49203905	.	T	C	2	2	4	0	0	4	0	0
14	49204136	.	G	A	0	5	5	0	4	9	0	0
14	49206876	.	G	C	1	3	4	0	3	7	0	0
14	49206879	.	C	T	2	2	4	0	1	5	0	0
14	49206948	.	G	A	1	2	3	0	0	3	0	0
14	49209983	.	C	T	6	8	14	0	0	14	0	0
14	49210055	.	T	C	3	5	8	0	0	8	0	0
14	49210075	.	C	A	4	4	8	0	0	8	0	0
14	49210231	.	A	G	2	7	9	0	0	9	0	0
14	49210569	.	G	C	1	2	3	0	0	3	0	0
14	49210779	.	C	T	3	2	5	0	0	5	0	0
14	49210867	.	G	T	8	4	12	0	0	12	0	0
14	49210955	.	A	G	4	4	8	0	0	8	0	0
14	49211045	.	T	C	3	8	11	0	0	11	0	0
14	49211172	.	A	G	5	2	7	0	0	7	0	0
14	49211539	.	A	G	4	0	4	0	4	8	0	0
14	49211543	.	A	G	6	3	9	0	0	9	0	0
14	49212308	.	A	T	2	7	9	0	0	9	0	0
14	49212350	.	C	T	5	9	14	0	0	14	0	0
14	49212395	.	T	C	6	3	9	0	0	9	0	0
14	49212415	.	A	G	3	0	3	0	2	5	0	0
14	49212586	.	A	G	3	2	5	0	0	5	0	0
14	49212612	.	T	C	5	2	7	0	1	8	0	0
14	49212838	.	C	T	2	3	5	0	0	5	0	0
14	49213140	.	T	G	5	4	9	0	0	9	0	0
14	49213178	.	C	T	3	3	6	0	0	6	0	0
14	49213250	.	C	T	2	5	7	0	1	8	0	0
14	49213711	.	A	G	1	3	4	0	0	4	0	0
14	49213732	.	A	G	1	5	6	0	0	6	0	0
14	49214347	.	T	G	4	0	4	0	3	7	0	0
14	49214392	.	G	A	2	4	6	0	1	7	0	0
14	49224844	.	G	A	2	9	11	0	7	18	0	0
14	49224886	.	C	T	7	7	14	0	2	16	0	0
14	49231804	.	A	G	5	2	7	0	0	7	0	0
14	49231813	.	C	T	5	3	8	0	0	8	0	0
14	49231903	.	C	G	2	3	5	0	0	5	0	0
14	49236476	.	A	G	4	4	8	0	0	8	0	0
14	49237917	.	A	G	4	5	9	0	1	10	0	0
14	49244425	.	A	G	17	0	17	0	16	33	0	0
14	49244728	.	A	G	10	14	24	0	0	24	0	0
14	49244740	.	A	T	16	12	28	0	1	29	0	0
14	49245035	.	C	A	6	1	7	0	1	8	0	0
14	49245190	.	C	G	5	13	18	0	1	19	0	0
14	49430817	.	A	G	5	8	13	0	0	13	0	0
14	49442723	.	T	A	5	1	6	0	0	6	0	0
14	49442729	.	A	T	1	4	5	0	0	5	0	0
14	49442850	.	A	C	3	0	3	0	0	3	0	0
14	49489002	.	A	G	1	26	27	0	3	30	0	0
14	49683812	.	T	C	0	2	2	1	0	3	0	0
14	49734011	.	C	G	2	0	2	0	0	2	0	0
14	49738358	.	C	T	1	4	5	0	0	5	0	0
14	49738424	.	C	T	1	1	2	0	0	2	0	0
14	49757069	.	G	T	3	2	5	0	0	5	0	0
14	49757802	.	G	A	3	5	8	0	0	8	0	0
14	49757811	.	A	G	3	2	5	0	0	5	0	0
14	49761799	.	G	A	4	4	8	0	1	9	0	0
14	50975541	.	A	G	2	2	4	0	1	5	0	0
14	52517870	.	A	G	5	8	13	0	0	13	0	0
14	52517886	.	A	G	7	0	7	0	7	14	0	0
14	52518002	.	A	G	7	12	19	0	1	20	0	0
14	52575054	.	T	C	3	2	5	0	0	5	0	0
15	750422	.	C	T	1	0	1	0	0	1	0	0
15	784368	.	G	C	1	2	3	0	0	3	0	0
15	894804	.	G	A	0	4	4	0	3	7	0	0
15	908257	.	T	C	3	2	5	2	0	7	0	0
15	1026224	.	T	G	1	2	3	0	0	3	0	0
15	1026323	.	A	G	1	2	3	0	0	3	0	0
15	1029484	.	C	T	0	1	1	0	0	1	0	0
15	1033435	.	A	T	6	4	10	0	2	12	0	0
15	1033479	.	T	G	5	6	11	0	1	12	0	0
15	1033564	.	G	T	2	6	8	0	0	8	0	0
15	1033853	.	A	G	4	2	6	0	0	6	0	0
15	1033955	.	C	T	0	2	2	0	4	6	0	0
15	1036614	.	C	T	1	0	1	0	0	1	0	0
15	1036677	.	C	T	0	4	4	0	2	6	0	0
15	1036825	.	T	C	5	4	9	0	0	9	0	0
15	1148129	.	A	G	1	1	2	0	0	2	0	0
15	1152067	.	T	C	1	2	3	0	0	3	0	0
15	1158649	.	A	G	0	1	1	0	0	1	0	0
15	1167171	.	C	T	9	2	11	0	0	11	0	0
15	1167183	.	C	T	8	2	10	0	0	10	0	0
15	1169624	.	A	G	2	2	4	0	0	4	0	0
15	1173016	.	A	G	1	0	1	0	4	5	0	0
15	1173067	.	C	T	3	3	6	0	1	7	0	0
15	1173542	.	C	T	3	4	7	0	1	8	0	0
15	1174823	.	A	G	1	0	1	0	0	1	0	0
15	1176447	.	G	A	0	3	3	0	5	8	0	0
15	1178927	.	C	A	9	5	14	0	0	14	0	0
15	1181477	.	G	T	3	4	7	0	1	8	0	0
15	1181480	.	C	T	2	4	6	0	3	9	0	0
15	1183930	.	G	T	4	1	5	0	0	5	0	0
15	1183984	.	C	T	0	10	10	0	9	19	0	0
15	1186181	.	A	G	8	10	18	0	0	18	0	0
15	1186202	.	C	T	0	8	8	0	7	15	0	0
15	1189664	.	C	T	21	5	26	0	0	26	0	0
15	1191750	.	A	G	5	1	6	0	0	6	0	0
15	1191792	.	G	A	2	9	11	0	9	20	0	0
15	1191822	.	A	G	8	0	8	0	12	20	0	0
15	1194619	.	G	A	0	10	10	0	9	19	0	0
15	1194633	.	A	G	10	10	20	0	0	20	0	0
15	1194670	.	G	A	13	5	18	0	0	18	0	0
15	1194754	.	T	C	4	2	6	0	0	6	0	0
15	1204917	.	T	C	1	1	2	0	0	2	0	0
15	1204941	.	T	C	3	2	5	0	0	5	0	0
15	1209060	.	G	A	0	2	2	0	1	3	0	0
15	1682212	.	T	C	1	2	3	0	0	3	0	0
15	2414584	.	G	T	6	3	9	0	0	9	0	0
15	2730198	.	T	C	8	2	10	0	0	10	0	0
15	2730358	.	T	C	6	8	14	0	0	14	0	0
15	3160253	.	A	G	3	3	6	0	0	6	0	0
15	3160261	.	A	G	2	3	5	0	2	7	0	0
15	3160869	.	A	G	2	2	4	0	1	5	0	0
15	3377050	.	C	G	3	3	6	0	1	9	2	0
15	3377106	.	C	T	4	2	6	0	1	7	0	0
15	3781727	.	A	T	1	1	2	0	1	3	0	0
15	3781808	.	T	A	1	3	4	0	0	4	0	0
15	3781900	.	T	C	2	2	4	0	0	4	0	0
15	3781917	.	C	T	2	2	4	0	0	4	0	0
15	3781951	.	A	G	3	3	6	0	0	6	0	0
15	3900198	.	C	T	1	3	4	0	0	4	0	0
15	3900485	.	G	A	1	2	3	0	0	3	0	0
15	3915699	.	G	A	0	0	0	0	1	1	0	0
15	3920812	.	T	C	1	3	4	0	0	4	0	0
15	3920836	.	T	A	1	3	4	0	0	4	0	0
15	3920896	.	C	T	2	2	4	0	0	4	0	0
15	3921214	.	T	A	3	2	5	0	0	5	0	0
15	3921218	.	C	T	2	3	5	0	0	5	0	0
15	3921308	.	A	G	3	4	7	0	0	7	0	0
15	3921515	.	C	T	3	2	5	0	0	5	0	0
15	3921643	.	C	A	1	2	3	0	0	3	0	0
15	3921647	.	C	T	1	2	3	0	0	3	0	0
15	3923082	.	T	G	2	3	5	0	0	5	0	0
15	3923094	.	T	G	2	3	5	0	0	5	0	0
15	3923135	.	A	G	2	0	2	0	3	5	0	0
15	3923193	.	A	G	2	2	4	0	0	4	0	0
15	3924349	.	C	G	4	2	6	0	0	6	0	0
15	3925206	.	G	T	0	2	2	0	4	6	0	0
15	3925403	.	T	G	0	2	2	0	0	2	0	0
15	3927857	.	G	C	3	3	6	0	0	6	0	0
15	3930076	.	C	T	2	1	3	0	0	3	0	0
15	3932503	.	C	T	0	1	1	0	0	1	0	0
15	4105009	.	A	G	6	8	14	0	0	14	0	0
15	4105164	.	C	T	0	7	7	0	3	10	0	0
15	4105262	.	A	G	11	4	15	0	0	15	0	0
15	4105328	.	A	G	5	4	9	0	0	9	0	0
15	4111649	.	T	C	1	1	2	0	0	2	0	0
15	4111821	.	A	G	0	2	2	0	0	2	0	0
15	4112233	.	C	T	0	1	1	0	0	1	0	0
15	4172458	.	C	T	3	5	8	0	0	8	0	0
15	4174147	.	T	G	2	3	5	0	0	5	0	0
15	4174174	.	C	T	1	3	4	0	0	4	0	0
15	4174191	.	G	T	1	2	3	0	0	3	0	0
15	4177160	.	C	A	8	6	14	0	1	15	0	0
15	4180093	.	C	A	0	3	3	0	1	4	0	0
15	4182667	.	T	C	0	0	0	0	3	3	0	0
15	4182718	.	A	G	2	4	6	0	0	6	0	0
15	4190893	.	T	A	1	0	1	0	0	1	0	0
15	4202300	.	T	C	1	6	7	0	0	7	0	0
15	4202321	.	C	T	6	0	6	0	0	6	0	0
15	4314014	.	C	A	2	1	3	0	0	3	0	0
15	4353311	.	G	T	18	6	24	0	1	25	0	0
15	4353333	.	T	C	14	0	14	0	8	24	2	0
15	4353965	.	G	A	27	37	64	0	6	70	0	0
15	4354082	.	G	A	27	36	63	0	4	67	0	0
15	4371833	.	T	C	9	11	20	0	0	20	0	0
15	4371863	.	C	T	3	6	9	0	1	10	0	0
15	4376110	.	C	T	0	20	20	0	15	36	1	0
15	4422222	.	A	G	3	5	8	0	0	8	0	0
15	4422293	.	G	C	2	0	2	0	2	4	0	0
15	4422383	.	A	T	2	4	6	0	1	7	0	0
15	4422394	.	G	A	2	6	8	0	0	8	0	0
15	4422514	.	G	C	2	1	3	0	1	4	0	0
15	4426474	.	C	T	3	3	6	0	0	6	0	0
15	4429003	.	C	T	0	1	1	0	1	2	0	0
15	4429004	.	G	A	1	1	2	0	0	2	0	0
15	4553776	.	C	T	0	4	4	0	0	4	0	0
15	4983598	.	G	A	1	2	3	0	0	3	0	0
15	6234255	.	G	A	4	6	10	0	0	10	0	0
15	6570393	.	A	C	0	1	1	0	0	1	0	0
15	6570402	.	C	T	0	1	1	0	0	1	0	0
15	6571269	.	A	C	2	2	4	0	0	4	0	0
15	6571305	.	G	T	2	2	4	0	0	4	0	0
15	6587059	.	C	T	0	1	1	0	0	1	0	0
15	6652600	.	T	C	9	16	25	0	1	26	0	0
15	6653094	.	T	G	1	1	2	0	0	2	0	0
15	6653209	.	G	T	0	1	1	0	1	2	0	0
15	6653282	.	C	G	0	1	1	0	0	1	0	0
15	6654524	.	T	G	2	0	2	0	0	2	0	0
15	6654587	.	C	A	7	20	27	0	1	29	1	0
15	6659159	.	G	A	6	7	13	0	1	14	0	0
15	6661390	.	G	A	12	15	27	0	0	27	0	0
15	6661449	.	T	C	14	20	34	0	2	36	0	0
15	6661499	.	G	A	1	2	3	0	0	3	0	0
15	6726146	.	C	T	4	2	6	0	0	6	0	0
15	6778483	.	A	G	2	2	4	0	0	4	0	0
15	6778515	.	T	A	1	0	1	0	0	1	0	0
15	6778813	.	A	G	1	0	1	0	0	1	0	0
15	6778825	.	A	G	2	2	4	0	0	4	0	0
15	6778856	.	C	A	5	5	10	0	0	10	0	0
15	6778877	.	A	G	6	8	14	0	0	14	0	0
15	6784093	.	T	C	5	6	11	0	0	11	0	0
15	6784118	.	C	T	2	4	6	0	0	6	0	0
15	6799903	.	G	A	4	3	7	0	0	7	0	0
15	6806712	.	G	C	14	17	31	0	3	34	0	0
15	6806836	.	G	A	11	14	25	0	1	26	0	0
15	6806912	.	T	G	7	14	21	0	1	22	0	0
15	6806931	.	T	G	5	13	18	0	4	22	0	0
15	6807014	.	A	T	1	2	3	0	0	3	0	0
15	6807041	.	A	C	3	0	3	0	1	4	0	0
15	6807406	.	C	A	3	2	5	0	1	6	0	0
15	6807500	.	C	G	7	16	23	0	0	23	0	0
15	6807514	.	G	A	9	19	28	0	0	28	0	0
15	6807563	.	A	T	15	19	34	0	0	34	0	0
15	6807874	.	C	T	8	11	19	0	1	20	0	0
15	6838126	.	G	A	5	3	8	0	0	8	0	0
15	6838154	.	T	A	1	3	4	0	0	4	0	0
15	6838554	.	T	C	1	0	1	0	6	7	0	0
15	6838580	.	G	C	2	6	8	0	0	8	0	0
15	6838771	.	T	C	2	7	9	0	0	9	0	0
15	6838786	.	T	C	3	9	12	0	0	12	0	0
15	6841506	.	G	T	1	1	2	0	2	4	0	0
15	6845567	.	A	G	5	1	6	0	0	6	0	0
15	6845636	.	T	A	1	1	2	0	0	2	0	0
15	6863048	.	C	T	1	0	1	0	0	1	0	0
15	6957221	.	C	G	2	5	7	0	0	7	0	0
15	7300827	.	T	C	5	3	8	0	0	8	0	0
15	7300900	.	T	C	3	3	6	0	0	6	0	0
15	7300901	.	T	C	3	0	3	0	3	6	0	0
15	9235460	.	T	G	22	21	43	0	5	48	0	0
15	9235461	.	T	G	28	17	45	0	3	48	0	0
15	9367923	.	T	C	2	2	4	0	0	4	0	0
15	11218865	.	T	C	2	3	5	1	0	6	0	0
15	11668471	.	C	T	2	2	4	0	0	4	0	0
15	13107454	.	T	A	3	2	5	0	0	5	0	0
15	13107498	.	C	T	6	2	8	0	0	8	0	0
15	13107561	.	T	C	6	5	11	0	1	12	0	0
15	13107562	.	G	A	7	5	12	0	0	12	0	0
15	13127035	.	A	G	1	2	3	0	0	3	0	0
15	13127248	.	T	C	5	9	14	0	1	15	0	0
15	13129937	.	A	G	10	4	14	0	1	15	0	0
15	13137876	.	T	G	1	4	5	0	0	5	0	0
15	13138074	.	A	C	6	5	11	0	0	11	0	0
15	13138452	.	G	A	1	0	1	0	0	1	0	0
15	13138453	.	T	A	1	0	1	0	0	1	0	0
15	13207497	.	C	T	6	6	12	0	0	12	0	0
15	13207561	.	T	G	6	5	11	0	0	11	0	0
15	13207597	.	C	T	2	2	4	0	6	10	0	0
15	13207828	.	T	A	6	11	17	0	0	17	0	0
15	13207858	.	G	C	8	10	18	0	0	18	0	0
15	13207870	.	A	G	9	7	16	0	0	16	0	0
15	13208218	.	T	C	5	0	5	0	3	8	0	0
15	13253708	.	T	G	1	4	5	0	0	5	0	0
15	13985123	.	C	A	2	8	10	0	0	10	0	0
15	13985578	.	T	C	6	8	14	0	1	15	0	0
15	13985644	.	C	T	6	4	10	0	0	10	0	0
15	13985827	.	C	G	3	8	11	0	0	11	0	0
15	13986009	.	T	C	4	5	9	0	0	9	0	0
15	13986233	.	G	T	5	14	19	0	1	20	0	0
15	13986279	.	A	T	6	7	13	0	0	13	0	0
15	14036060	.	G	A	1	4	5	0	0	5	0	0
15	14076096	.	T	C	2	4	6	0	0	6	0	0
15	14076223	.	A	T	3	5	8	0	0	8	0	0
15	14076329	.	T	G	9	8	17	0	0	17	0	0
15	14076376	.	C	T	6	6	12	0	0	12	0	0
15	14076382	.	A	G	6	2	8	0	0	8	0	0
15	14076710	.	T	A	3	3	6	0	0	6	0	0
15	14079784	.	G	A	0	1	1	0	0	1	0	0
15	14079974	.	G	C	0	1	1	0	0	1	0	0
15	14082347	.	G	T	2	4	6	0	0	6	0	0
15	14083023	.	T	G	2	0	2	0	0	2	0	0
15	14085276	.	T	G	5	5	10	0	0	10	0	0
15	14085800	.	T	C	3	3	6	0	1	7	0	0
15	14085847	.	G	T	2	6	8	0	0	8	0	0
15	14085914	.	G	A	4	9	13	0	0	13	0	0
15	14088146	.	G	A	13	16	29	0	0	29	0	0
15	14088252	.	G	A	7	6	13	0	1	14	0	0
15	14088270	.	C	T	5	7	12	0	1	13	0	0
15	14092805	.	G	A	3	1	4	0	0	4	0	0
15	14092819	.	C	A	1	3	4	0	0	4	0	0
15	14093020	.	G	A	7	9	16	0	0	16	0	0
15	14093032	.	A	G	5	9	14	0	0	14	0	0
15	14093110	.	T	A	9	11	20	0	0	20	0	0
15	14093197	.	C	T	3	6	9	0	2	11	0	0
15	14098221	.	G	A	3	7	10	0	0	10	0	0
15	14119603	.	A	G	1	2	3	0	4	7	0	0
15	14206071	.	C	G	2	2	4	0	0	4	0	0
15	14206087	.	T	C	2	0	2	0	2	4	0	0
15	14206111	.	C	T	0	3	3	0	4	7	0	0
15	14206430	.	T	C	1	1	2	0	0	2	0	0
15	14206438	.	G	A	1	2	3	0	0	3	0	0
15	14206480	.	A	G	4	2	6	0	0	6	0	0
15	14206505	.	T	C	4	2	6	0	0	6	0	0
15	14207613	.	G	A	0	2	2	0	0	2	0	0
15	14207788	.	G	T	0	2	2	0	0	2	0	0
15	14208322	.	G	A	3	2	5	0	0	5	0	0
15	14208328	.	A	G	3	2	5	0	0	5	0	0
15	14317040	.	G	A	4	4	8	0	0	8	0	0
15	14321321	.	C	G	1	5	6	0	0	6	0	0
15	14321572	.	G	T	1	2	3	0	0	3	0	0
15	14378902	.	T	C	0	3	3	0	0	3	0	0
15	14378937	.	C	T	4	1	5	0	0	5	0	0
15	14385123	.	A	G	1	0	1	0	1	2	0	0
15	14388588	.	C	T	0	1	1	0	0	1	0	0
15	14417492	.	T	C	1	3	4	0	0	4	0	0
15	14419690	.	C	T	6	2	8	0	0	8	0	0
15	14420177	.	C	T	4	7	11	0	1	12	0	0
15	14420333	.	A	G	2	0	2	0	8	10	0	0
15	14436553	.	C	T	3	2	5	0	1	6	0	0
15	14436554	.	T	A	4	2	6	0	0	6	0	0
15	14436811	.	C	T	0	6	6	0	3	9	0	0
15	14437204	.	A	G	7	9	16	0	0	16	0	0
15	14437239	.	T	A	5	9	14	0	2	16	0	0
15	14443666	.	A	G	0	1	1	0	0	1	0	0
15	14446538	.	C	T	0	3	3	0	3	6	0	0
15	14446565	.	A	C	4	0	4	0	3	7	0	0
15	14554568	.	A	C	7	5	12	0	1	13	0	0
15	14554634	.	G	A	16	8	24	0	4	28	0	0
15	14557015	.	G	A	2	0	2	0	2	4	0	0
15	14557047	.	T	G	3	3	6	0	0	6	0	0
15	14567836	.	A	C	0	0	0	0	1	1	0	0
15	14570991	.	A	T	1	5	6	0	0	6	0	0
15	14571193	.	T	G	3	2	5	0	0	5	0	0
15	14571194	.	C	T	3	2	5	0	0	5	0	0
15	14576659	.	C	T	1	0	1	0	0	1	0	0
15	14592987	.	C	A	3	1	4	0	0	4	0	0
15	14597312	.	C	G	2	3	5	0	0	5	0	0
15	14597342	.	G	A	4	6	10	0	1	11	0	0
15	14597518	.	A	G	8	6	14	0	0	14	0	0
15	14597653	.	C	T	2	3	5	0	0	5	0	0
15	14597670	.	T	A	3	5	8	0	0	8	0	0
15	14597870	.	A	C	6	2	8	0	0	8	0	0
15	14597887	.	G	T	6	2	8	0	0	8	0	0
15	14597991	.	T	C	4	3	7	0	1	8	0	0
15	14598192	.	G	A	2	6	8	0	0	8	0	0
15	14598321	.	G	A	0	3	3	0	5	8	0	0
15	14598327	.	G	A	4	3	7	0	1	8	0	0
15	14598403	.	G	A	3	4	7	0	1	8	0	0
15	14598669	.	G	A	6	6	12	0	0	12	0	0
15	14598672	.	A	G	6	6	12	0	0	12	0	0
15	14598708	.	C	T	6	8	14	0	0	14	0	0
15	14598807	.	T	C	12	3	15	0	1	16	0	0
15	14598823	.	G	A	0	5	5	0	13	18	0	0
15	14598930	.	G	A	0	10	10	0	8	18	0	0
15	14599152	.	T	C	3	10	13	0	0	13	0	0
15	14599167	.	G	A	0	9	9	0	5	14	0	0
15	14599203	.	A	G	2	4	6	0	2	8	0	0
15	14599486	.	G	A	4	9	13	0	0	13	0	0
15	14630941	.	T	C	4	0	4	0	8	12	0	0
15	14631242	.	A	G	5	4	9	0	1	10	0	0
15	14631258	.	C	T	6	4	10	0	0	10	0	0
15	14631289	.	T	C	4	3	7	0	0	7	0	0
15	14631314	.	G	A	6	2	8	0	0	8	0	0
15	14631531	.	T	C	2	1	3	0	3	6	0	0
15	14631535	.	T	C	2	3	5	0	0	5	0	0
15	14631665	.	A	G	4	3	7	0	2	9	0	0
15	14631930	.	T	C	3	8	11	0	0	11	0	0
15	14631969	.	A	G	11	11	22	0	0	22	0	0
15	14632135	.	C	T	0	11	11	0	11	22	0	0
15	14632160	.	A	T	14	6	20	0	0	20	0	0
15	14632189	.	T	C	7	6	13	0	0	13	0	0
15	14632197	.	G	T	8	6	14	0	0	14	0	0
15	14632244	.	A	T	9	3	12	0	0	12	0	0
15	14632293	.	T	A	6	4	10	0	0	10	0	0
15	14632510	.	G	A	6	6	12	0	0	12	0	0
15	14632543	.	C	T	5	7	12	0	1	13	0	0
15	14632561	.	T	C	6	0	6	0	6	12	0	0
15	14632834	.	G	C	5	0	5	0	6	11	0	0
15	14632842	.	G	A	5	6	11	0	0	11	0	0
15	14633041	.	T	C	5	0	5	0	5	10	0	0
15	14633077	.	T	C	3	0	3	0	9	12	0	0
15	14633404	.	C	T	0	6	6	0	7	13	0	0
15	14633659	.	C	T	7	3	10	0	1	11	0	0
15	14633815	.	A	G	1	7	8	0	0	8	0	0
15	14633875	.	C	T	0	6	6	0	7	13	0	0
15	14633905	.	T	G	7	9	16	0	0	16	0	0
15	14633982	.	A	G	8	3	11	0	0	11	0	0
15	14634166	.	T	C	6	5	11	0	1	12	0	0
15	14634199	.	A	G	10	4	14	0	0	14	0	0
15	14634394	.	T	A	1	2	3	0	0	3	0	0
15	14634501	.	A	G	2	3	5	0	0	5	0	0
15	14636343	.	G	A	8	7	15	0	0	15	0	0
15	14636447	.	G	A	4	4	8	0	0	8	0	0
15	14636475	.	G	T	2	2	4	0	0	4	0	0
15	14639435	.	G	A	3	2	5	0	1	6	0	0
15	14641815	.	G	T	2	1	3	0	0	3	0	0
15	14641823	.	T	G	1	2	3	0	0	3	0	0
15	14642809	.	T	C	2	2	4	0	1	5	0	0
15	14642816	.	A	G	3	2	5	0	0	5	0	0
15	14659947	.	G	A	2	2	4	0	0	4	0	0
15	14665761	.	T	C	3	2	5	0	0	5	0	0
15	14855219	.	C	A	5	2	7	0	0	7	0	0
15	14855291	.	A	G	1	1	2	0	0	2	0	0
15	14856739	.	A	G	1	0	1	0	0	1	0	0
15	14856803	.	A	T	4	1	5	0	0	5	0	0
15	14964146	.	T	A	1	2	3	0	0	3	0	0
15	15294373	.	C	T	1	0	1	0	0	1	0	0
15	15297800	.	T	G	2	3	5	0	1	6	0	0
15	15349693	.	C	T	19	40	59	0	4	63	0	0
15	15349780	.	C	T	27	30	57	0	1	58	0	0
15	15349860	.	T	A	16	23	39	0	6	45	0	0
15	15403689	.	G	T	1	0	1	0	0	1	0	0
15	15403979	.	G	A	2	0	2	0	0	2	0	0
15	15406925	.	T	G	4	0	4	0	0	4	0	0
15	15406934	.	C	T	4	0	4	0	0	4	0	0
15	15407505	.	T	G	1	5	6	0	0	6	0	0
15	15415839	.	T	C	11	12	23	0	2	25	0	0
15	15415903	.	C	G	5	4	9	0	0	9	0	0
15	15445690	.	G	C	7	0	7	0	6	13	0	0
15	15445883	.	C	T	1	1	2	0	1	3	0	0
15	15445899	.	T	C	3	2	5	0	1	6	0	0
15	15446104	.	T	C	13	8	21	0	0	21	0	0
15	15446484	.	C	T	0	7	7	0	15	22	0	0
15	15446590	.	G	A	17	7	24	0	0	24	0	0
15	15446609	.	C	A	12	10	22	0	0	22	0	0
15	15447005	.	T	A	7	10	17	0	1	18	0	0
15	15447037	.	C	T	0	10	10	0	12	22	0	0
15	15447109	.	G	A	3	10	13	0	0	13	0	0
15	15447118	.	T	C	3	0	3	0	10	13	0	0
15	15448975	.	A	G	0	3	3	0	0	3	0	0
15	15449395	.	G	C	8	6	14	0	1	15	0	0
15	15449735	.	G	C	3	4	7	0	0	7	0	0
15	15460342	.	A	G	1	2	3	0	0	3	0	0
15	15460392	.	C	G	1	2	3	0	0	3	0	0
15	15460519	.	C	T	0	6	6	0	3	9	0	0
15	15468939	.	T	G	1	1	2	0	0	2	0	0
15	15468944	.	A	T	1	1	2	0	0	2	0	0
15	15468983	.	G	A	2	4	6	0	1	7	0	0
15	15468987	.	A	T	2	5	7	0	0	7	0	0
15	15510436	.	G	A	0	2	2	0	0	2	0	0
15	15510448	.	C	T	0	2	2	0	0	2	0	0
15	15510478	.	A	G	3	0	3	0	1	4	0	0
15	15587093	.	C	T	8	12	20	0	0	20	0	0
15	15587117	.	C	T	10	10	20	0	0	20	0	0
15	15589504	.	C	T	9	7	16	0	1	17	0	0
15	15591868	.	T	A	12	9	21	0	0	21	0	0
15	15592318	.	G	A	17	20	37	0	2	39	0	0
15	15592332	.	C	G	18	0	18	0	20	38	0	0
15	15592504	.	C	T	21	9	30	0	0	30	0	0
15	15592537	.	A	T	11	16	27	0	1	28	0	0
15	15592629	.	T	C	8	20	28	0	1	29	0	0
15	15592641	.	C	G	11	0	11	0	18	29	0	0
15	15592784	.	C	A	19	12	31	0	0	31	0	0
15	15592879	.	C	T	8	9	17	0	2	19	0	0
15	15592991	.	G	A	13	15	28	0	1	29	0	0
15	15593128	.	G	A	16	5	21	0	1	22	0	0
15	15786270	.	C	T	5	7	12	0	0	12	0	0
15	15786463	.	A	C	2	0	2	0	0	2	0	0
15	15810922	.	G	C	1	5	6	0	6	12	0	0
15	15811281	.	G	T	1	0	1	0	0	1	0	0
15	15813810	.	C	T	9	8	17	0	1	18	0	0
15	15856342	.	T	A	1	2	3	0	0	3	0	0
15	15876974	.	T	C	9	13	22	0	0	22	0	0
15	15877019	.	T	C	7	15	22	0	0	22	0	0
15	15877600	.	G	A	10	10	20	0	0	20	0	0
15	15877616	.	G	C	9	12	21	0	0	21	0	0
15	15886202	.	C	A	8	8	16	0	1	17	0	0
15	15886346	.	A	G	2	8	10	0	1	11	0	0
15	15886491	.	A	C	2	3	5	0	0	5	0	0
15	15886502	.	A	G	1	4	5	0	0	5	0	0
15	15886564	.	A	G	4	7	11	0	1	12	0	0
15	15886697	.	T	C	7	6	13	0	0	13	0	0
15	15886701	.	C	T	0	6	6	0	7	13	0	0
15	15886806	.	T	C	1	7	8	0	0	8	0	0
15	15906718	.	G	A	3	5	8	0	0	8	0	0
15	15906766	.	C	T	8	6	14	0	1	15	0	0
15	15916216	.	G	A	7	6	13	0	0	13	0	0
15	15923577	.	G	A	6	7	13	0	0	13	0	0
15	15923616	.	G	A	7	4	11	0	0	11	0	0
15	15923628	.	C	G	0	6	6	0	8	14	0	0
15	15923697	.	T	G	7	6	13	0	2	15	0	0
15	15944045	.	C	T	0	5	5	0	10	15	0	0
15	15944102	.	G	A	5	9	14	0	2	16	0	0
15	15944129	.	G	A	4	10	14	0	0	14	0	0
15	15944287	.	G	A	6	9	15	0	0	15	0	0
15	15944435	.	G	A	12	5	17	0	0	17	0	0
15	15944465	.	A	G	6	6	12	0	0	12	0	0
15	15949872	.	T	C	5	2	7	0	6	13	0	0
15	15950223	.	A	C	7	8	15	0	0	15	0	0
15	15953681	.	C	A	2	0	2	0	0	2	0	0
15	16066453	.	A	G	21	24	45	0	1	46	0	0
15	16066459	.	C	T	24	22	46	0	0	46	0	0
15	16066508	.	C	T	1	21	22	0	27	49	0	0
15	16067051	.	G	A	27	30	57	0	0	57	0	0
15	16072281	.	A	C	21	12	33	0	2	35	0	0
15	16072690	.	T	C	17	13	30	0	1	31	0	0
15	16072822	.	T	A	16	12	28	0	0	28	0	0
15	16076221	.	A	C	4	3	7	0	0	7	0	0
15	16079597	.	G	A	0	2	2	0	0	2	0	0
15	16079709	.	T	G	11	14	25	0	0	25	0	0
15	16079733	.	G	T	12	16	28	0	0	28	0	0
15	16080258	.	G	A	21	15	36	0	0	36	0	0
15	16086528	.	G	A	4	1	5	0	0	5	0	0
15	16086600	.	G	T	26	29	55	0	1	56	0	0
15	16094383	.	G	A	21	15	36	0	1	37	0	0
15	16094672	.	C	T	1	13	14	0	20	34	0	0
15	16101332	.	G	A	2	3	5	0	0	5	0	0
15	16101357	.	G	A	4	2	6	0	1	7	0	0
15	16101492	.	C	T	2	3	5	0	0	5	0	0
15	16104912	.	G	A	0	1	1	0	0	1	0	0
15	16123356	.	C	T	2	6	8	0	0	8	0	0
15	16123358	.	A	G	6	2	8	0	0	8	0	0
15	16123735	.	G	C	6	4	10	0	1	11	0	0
15	16123873	.	G	A	2	8	10	0	0	10	0	0
15	16123921	.	T	C	5	7	12	0	1	13	0	0
15	16124008	.	T	A	10	5	15	0	2	17	0	0
15	16124125	.	G	A	7	10	17	0	0	17	0	0
15	16124210	.	C	T	0	4	4	0	4	8	0	0
15	16125799	.	T	C	3	4	7	0	1	8	0	0
15	16127139	.	C	T	3	6	9	0	0	9	0	0
15	16130244	.	G	A	8	3	11	0	1	12	0	0
15	16136073	.	A	G	4	1	5	0	0	5	0	0
15	16143969	.	A	G	1	0	1	0	0	1	0	0
15	16144013	.	G	A	3	2	5	0	0	5	0	0
15	16144053	.	T	C	1	0	1	0	3	4	0	0
15	16144086	.	G	A	2	3	5	0	0	5	0	0
15	16148277	.	C	T	3	4	7	0	1	8	0	0
15	16148355	.	A	G	2	0	2	0	0	2	0	0
15	16148367	.	G	A	1	0	1	0	0	1	0	0
15	16149660	.	C	T	2	0	2	0	0	2	0	0
15	16149709	.	G	A	5	4	9	0	0	9	0	0
15	16155774	.	C	T	5	4	9	0	0	9	0	0
15	16169626	.	G	A	1	3	4	0	0	4	0	0
15	16183479	.	C	T	13	14	27	0	0	27	0	0
15	16191913	.	G	A	3	2	5	0	0	5	0	0
15	16194155	.	A	T	12	6	18	0	1	19	0	0
15	16194208	.	G	A	9	1	10	0	0	10	0	0
15	16194222	.	G	T	7	5	12	0	0	12	0	0
15	16194254	.	G	C	13	8	21	0	0	21	0	0
15	16194369	.	G	A	8	8	16	0	0	16	0	0
15	16194741	.	T	A	10	13	23	0	1	24	0	0
15	16226577	.	A	G	0	1	1	0	0	1	0	0
15	16323480	.	A	G	2	5	7	0	0	7	0	0
15	16323568	.	T	A	10	10	20	0	2	22	0	0
15	16328623	.	C	T	12	15	27	0	2	29	0	0
15	16332592	.	C	T	2	1	3	0	1	4	0	0
15	16332643	.	T	A	3	2	5	0	0	5	0	0
15	16332844	.	C	A	15	14	29	0	0	29	0	0
15	16378885	.	C	T	0	4	4	0	1	5	0	0
15	16380097	.	A	T	2	2	4	0	1	5	0	0
15	16380377	.	A	G	4	4	8	0	0	8	0	0
15	16398241	.	T	G	0	1	1	0	0	1	0	0
15	16398265	.	T	C	5	5	10	0	0	10	0	0
15	16401668	.	A	G	1	2	3	0	0	3	0	0
15	16406279	.	T	C	2	1	3	0	0	3	0	0
15	16407354	.	A	G	10	12	22	0	0	22	0	0
15	16407575	.	G	T	9	7	16	0	1	17	0	0
15	16407723	.	G	A	14	14	28	0	1	29	0	0
15	16935759	.	G	T	13	6	19	0	0	19	0	0
15	16935806	.	C	T	5	6	11	0	0	11	0	0
15	16935867	.	C	T	6	10	16	0	1	17	0	0
15	16936271	.	C	T	4	2	6	0	1	7	0	0
15	16936495	.	A	T	5	8	13	0	0	13	0	0
15	16936716	.	C	T	11	5	16	0	1	17	0	0
15	16937375	.	T	C	6	9	15	0	1	16	0	0
15	16937396	.	T	C	8	5	13	0	1	14	0	0
15	16938166	.	A	G	4	6	10	0	0	10	0	0
15	16939266	.	C	T	3	2	5	0	0	5	0	0
15	16939271	.	C	A	3	2	5	0	0	5	0	0
15	16939588	.	G	A	6	1	7	0	0	7	0	0
15	16944167	.	T	C	3	4	7	0	1	8	0	0
15	16944173	.	T	C	4	4	8	0	2	10	0	0
15	16944350	.	T	C	0	2	2	0	0	2	0	0
15	16946533	.	A	G	0	2	2	0	0	2	0	0
15	16946592	.	A	G	1	1	2	0	0	2	0	0
15	16948484	.	T	C	0	2	2	0	0	2	0	0
15	16948565	.	T	C	2	1	3	0	3	6	0	0
15	16965453	.	G	A	4	7	11	0	0	11	0	0
15	16967929	.	C	T	0	1	1	0	0	1	0	0
15	17085012	.	T	A	14	10	24	0	0	24	0	0
15	17091003	.	C	T	8	5	13	0	1	14	0	0
15	17091030	.	G	A	6	4	10	0	0	10	0	0
15	17091418	.	G	A	0	3	3	0	9	12	0	0
15	17095457	.	C	T	16	21	37	0	1	38	0	0
15	17103492	.	G	A	2	1	3	0	0	3	0	0
15	17112155	.	C	T	2	2	4	0	0	4	0	0
15	17112170	.	G	A	1	1	2	0	0	2	0	0
15	17114640	.	A	T	2	4	6	0	0	6	0	0
15	17117724	.	T	C	4	2	6	0	0	6	0	0
15	17117949	.	A	G	1	0	1	0	0	1	0	0
15	17122535	.	A	C	8	5	13	0	0	13	0	0
15	17122673	.	C	T	7	5	12	0	0	12	0	0
15	17123012	.	T	C	5	7	12	0	0	12	0	0
15	17123040	.	G	T	8	5	13	0	0	13	0	0
15	17123063	.	A	G	5	4	9	0	1	10	0	0
15	17123290	.	A	G	7	5	12	0	0	12	0	0
15	17123937	.	T	A	9	6	15	0	1	16	0	0
15	17123968	.	C	A	13	8	21	0	1	22	0	0
15	17124011	.	A	G	18	4	22	0	0	22	0	0
15	17124012	.	C	G	18	4	22	0	0	22	0	0
15	17124084	.	A	G	11	5	16	0	3	19	0	0
15	17124124	.	C	A	11	5	16	0	0	16	0	0
15	17124283	.	A	G	8	4	12	0	1	13	0	0
15	17124296	.	A	G	8	4	12	0	1	13	0	0
15	17124437	.	A	C	2	3	5	0	0	5	0	0
15	17124439	.	T	G	2	3	5	0	0	5	0	0
15	17124484	.	T	A	4	4	8	0	0	8	0	0
15	17124580	.	A	G	6	7	13	0	0	13	0	0
15	17124586	.	C	T	3	9	12	0	0	12	0	0
15	17124654	.	T	G	7	10	17	0	0	17	0	0
15	17124768	.	G	C	3	11	14	0	1	15	0	0
15	17125033	.	A	G	4	2	6	0	0	6	0	0
15	17128418	.	T	C	7	0	7	0	12	19	0	0
15	17128468	.	G	A	1	5	6	0	1	7	0	0
15	17131785	.	C	T	4	5	9	0	1	10	0	0
15	17134701	.	C	T	0	18	18	0	14	32	0	0
15	17147012	.	A	G	5	10	15	0	0	15	0	0
15	17147400	.	G	A	11	9	20	0	0	20	0	0
15	17151085	.	T	A	2	2	4	0	1	5	0	0
15	17156953	.	G	A	1	4	5	0	0	5	0	0
15	17168668	.	G	A	0	2	2	0	0	2	0	0
15	17263267	.	G	A	1	0	1	0	0	1	0	0
15	17266509	.	T	C	2	2	4	0	0	4	0	0
15	17266564	.	G	A	0	4	4	0	2	6	0	0
15	17268268	.	A	T	1	2	3	0	0	3	0	0
15	17299682	.	T	C	3	3	6	0	0	6	0	0
15	17308206	.	C	A	4	10	14	0	1	15	0	0
15	17308378	.	T	C	3	3	6	0	1	7	0	0
15	17312080	.	T	C	7	5	12	0	1	13	0	0
15	17312299	.	G	A	8	7	15	0	0	15	0	0
15	17312386	.	G	A	0	4	4	0	4	8	0	0
15	17314889	.	C	T	4	2	6	0	0	6	0	0
15	17317008	.	T	A	15	14	29	0	0	29	0	0
15	17317044	.	C	T	12	11	23	0	0	23	0	0
15	17317089	.	T	A	1	2	3	0	0	3	0	0
15	17318566	.	T	C	16	11	27	0	1	28	0	0
15	17319345	.	C	T	11	10	21	0	2	23	0	0
15	17320851	.	T	C	28	12	40	0	2	42	0	0
15	17321164	.	A	G	3	4	7	0	0	7	0	0
15	17321302	.	A	T	3	1	4	0	0	4	0	0
15	17324793	.	C	T	9	6	15	0	0	15	0	0
15	17327501	.	C	T	29	24	53	0	1	54	0	0
15	17339078	.	C	T	31	24	55	0	4	59	0	0
15	17339719	.	T	C	23	23	46	0	2	48	0	0
15	17340104	.	A	C	9	8	17	0	1	18	0	0
15	17348035	.	T	C	0	4	4	0	0	4	0	0
15	17350319	.	G	A	0	1	1	0	0	1	0	0
15	17372580	.	C	A	13	9	22	0	1	24	1	0
15	17372934	.	C	T	7	5	12	0	3	15	0	0
15	17423913	.	A	C	10	11	21	0	1	22	0	0
15	17424011	.	T	C	8	11	19	0	0	19	0	0
15	17424185	.	T	G	4	9	13	0	0	13	0	0
15	17424397	.	G	A	9	11	20	0	0	20	0	0
15	17424472	.	A	T	7	9	16	0	0	16	0	0
15	17424493	.	T	C	6	9	15	0	0	15	0	0
15	17424515	.	A	T	5	7	12	0	0	12	0	0
15	17424581	.	A	T	5	3	8	0	0	8	0	0
15	17443968	.	G	A	4	7	11	0	0	11	0	0
15	17443969	.	T	G	4	7	11	0	0	11	0	0
15	17444203	.	T	C	8	3	11	0	1	12	0	0
15	17444227	.	A	G	6	5	11	0	0	11	0	0
15	17444262	.	G	C	9	8	17	0	0	17	0	0
15	17444284	.	A	C	10	12	22	0	0	22	0	0
15	17444385	.	A	C	4	11	15	0	1	16	0	0
15	17444428	.	C	T	4	5	9	0	0	9	0	0
15	17444533	.	A	C	6	6	12	0	1	13	0	0
15	17444569	.	C	T	6	4	10	0	0	10	0	0
15	17444632	.	T	C	3	4	7	0	0	7	0	0
15	17445606	.	G	A	7	8	15	0	2	17	0	0
15	17445618	.	T	A	7	9	16	0	1	17	0	0
15	17446854	.	C	T	5	4	9	0	0	9	0	0
15	17486317	.	A	C	5	10	15	0	0	15	0	0
15	17486388	.	G	T	6	11	17	0	1	18	0	0
15	17486576	.	C	A	7	11	18	0	1	19	0	0
15	17486715	.	C	T	9	12	21	0	1	22	0	0
15	17486725	.	G	T	8	10	18	0	1	19	0	0
15	17487293	.	A	G	6	5	11	0	0	11	0	0
15	17487386	.	C	T	6	7	13	0	0	13	0	0
15	17487544	.	A	G	6	5	11	0	0	11	0	0
15	17487717	.	T	A	14	7	21	0	0	21	0	0
15	17488214	.	T	C	2	3	5	0	0	5	0	0
15	17488513	.	C	T	6	13	19	0	0	19	0	0
15	17488672	.	A	G	10	19	29	0	0	29	0	0
15	17488698	.	A	T	15	17	32	0	0	32	0	0
15	17488834	.	A	C	10	9	19	0	2	21	0	0
15	17489033	.	C	T	9	3	12	0	1	13	0	0
15	17489049	.	A	T	10	2	12	0	1	13	0	0
15	17489165	.	G	A	0	7	7	1	9	17	0	0
15	17489191	.	A	G	2	0	2	1	9	12	0	0
15	17489203	.	G	A	0	10	10	0	1	11	0	0
15	17489360	.	A	C	14	11	25	0	0	25	0	0
15	17489440	.	G	C	11	18	29	0	2	31	0	0
15	17489505	.	G	A	14	12	26	0	2	28	0	0
15	17489573	.	G	T	5	4	9	0	0	9	0	0
15	17489575	.	C	G	5	4	9	0	0	9	0	0
15	17489621	.	T	A	3	3	6	0	0	6	0	0
15	17489632	.	G	T	2	2	4	0	0	4	0	0
15	17866447	.	C	A	5	2	7	0	0	7	0	0
15	17866976	.	T	C	13	12	25	0	0	25	0	0
15	17867929	.	A	G	11	12	23	0	3	26	0	0
15	17868250	.	G	A	12	13	25	0	1	26	0	0
15	17868448	.	T	C	11	10	21	0	0	21	0	0
15	17868601	.	T	G	7	7	14	0	0	14	0	0
15	17948534	.	C	T	7	3	10	0	0	10	0	0
15	17948616	.	C	G	6	6	12	0	0	12	0	0
15	17948786	.	C	G	5	5	10	0	1	11	0	0
15	17948852	.	G	C	4	3	7	0	0	7	0	0
15	17949100	.	C	T	2	2	4	0	1	5	0	0
15	17949142	.	C	G	2	4	6	0	2	8	0	0
15	17949163	.	C	T	5	6	11	0	2	13	0	0
15	17949252	.	A	G	2	2	4	0	1	5	0	0
15	17960032	.	C	T	2	3	5	0	1	6	0	0
15	17966459	.	G	A	3	1	4	0	0	4	0	0
15	17971248	.	C	T	3	2	5	0	0	5	0	0
15	18102357	.	T	C	6	4	10	0	0	10	0	0
15	18102777	.	C	G	8	13	21	0	0	21	0	0
15	18102898	.	T	C	11	7	18	0	4	22	0	0
15	18103009	.	T	A	6	12	18	0	1	19	0	0
15	18103248	.	T	C	7	9	16	0	0	16	0	0
15	18103363	.	G	A	4	8	12	0	0	12	0	0
15	18106754	.	A	G	1	2	3	0	1	4	0	0
15	18107049	.	A	G	6	6	12	0	0	12	0	0
15	18107081	.	G	A	3	1	4	0	0	4	0	0
15	18111448	.	C	T	0	1	1	0	0	1	0	0
15	18115551	.	T	C	7	8	15	0	0	15	0	0
15	18130119	.	G	A	6	8	14	0	0	14	0	0
15	18130190	.	A	G	13	10	23	0	2	25	0	0
15	18130202	.	A	G	14	0	14	0	14	28	0	0
15	18130305	.	T	C	8	17	25	0	0	25	0	0
15	18141117	.	G	A	10	12	22	0	1	23	0	0
15	18148889	.	G	A	12	18	30	0	0	30	0	0
15	18148892	.	A	G	12	15	27	0	3	30	0	0
15	18148928	.	A	G	2	1	3	0	4	7	0	0
15	18151095	.	G	A	0	1	1	0	0	1	0	0
15	18155273	.	C	T	7	9	16	0	1	17	0	0
15	18155297	.	T	C	11	13	24	0	1	25	0	0
15	18155322	.	G	T	9	14	23	0	3	26	0	0
15	18155342	.	T	A	12	14	26	0	0	26	0	0
15	18155392	.	G	A	12	7	19	0	1	20	0	0
15	18155394	.	C	T	13	7	20	0	0	20	0	0
15	18155588	.	C	T	13	2	15	0	0	15	0	0
15	18155638	.	G	A	16	20	36	0	0	36	0	0
15	18155730	.	A	G	21	20	41	0	2	43	0	0
15	18253900	.	G	A	4	6	10	0	0	10	0	0
15	18254148	.	G	A	8	4	12	0	0	12	0	0
15	18254777	.	C	G	0	5	5	0	10	15	0	0
15	18254821	.	T	A	7	3	10	0	0	10	0	0
15	18254985	.	C	T	15	5	20	0	0	20	0	0
15	18255292	.	A	G	12	7	19	0	0	19	0	0
15	18255653	.	T	C	4	3	7	0	1	8	0	0
15	18256138	.	A	G	5	3	8	0	1	9	0	0
15	18256541	.	T	A	3	2	5	0	0	5	0	0
15	18256847	.	C	T	0	5	5	0	3	8	0	0
15	18257167	.	T	A	1	2	3	0	0	3	0	0
15	18257180	.	A	G	1	2	3	0	0	3	0	0
15	18257692	.	A	T	5	6	11	0	1	12	0	0
15	18257743	.	T	C	7	3	10	0	0	10	0	0
15	18257754	.	A	G	6	4	10	0	0	10	0	0
15	18258947	.	A	C	2	0	2	1	3	6	0	0
15	18259036	.	T	G	1	6	7	0	0	7	0	0
15	18259143	.	G	A	4	5	9	0	0	9	0	0
15	18259269	.	A	T	2	3	5	0	0	5	0	0
15	18259687	.	C	T	0	2	2	0	3	5	0	0
15	18260065	.	T	C	2	2	4	0	0	4	0	0
15	18324886	.	G	A	1	0	1	0	0	1	0	0
15	18358126	.	C	T	1	2	3	0	0	3	0	0
15	18358435	.	G	A	4	5	9	0	0	9	0	0
15	18358999	.	A	G	3	2	5	0	0	5	0	0
15	18359008	.	T	C	2	3	5	0	1	6	0	0
15	18371336	.	A	T	0	2	2	0	0	2	0	0
15	18371418	.	T	A	3	13	16	0	2	18	0	0
15	18371509	.	C	T	8	4	12	0	0	12	0	0
15	18371522	.	A	G	7	5	12	0	1	13	0	0
15	18371789	.	T	C	15	0	15	0	8	23	0	0
15	18389548	.	T	C	2	1	3	0	1	4	0	0
15	18401240	.	G	T	6	6	12	0	0	12	0	0
15	18401270	.	A	G	3	3	6	0	0	6	0	0
15	18426315	.	G	A	8	6	14	0	0	14	0	0
15	18429123	.	T	C	11	0	11	0	5	16	0	0
15	18429526	.	T	C	2	0	2	0	1	3	0	0
15	18469599	.	A	G	3	3	6	0	1	7	0	0
15	18481100	.	G	A	1	2	3	0	0	3	0	0
15	18481130	.	G	A	1	0	1	0	0	1	0	0
15	18482944	.	G	A	1	3	4	0	0	4	0	0
15	18574608	.	C	T	3	4	7	0	0	7	0	0
15	18863936	.	C	T	1	4	5	0	0	5	0	0
15	19037534	.	A	G	11	9	20	0	0	20	0	0
15	19037618	.	A	G	16	10	26	0	0	26	0	0
15	19037626	.	G	C	14	10	24	0	2	26	0	0
15	19037787	.	G	C	4	3	7	0	1	8	0	0
15	19037895	.	T	C	4	6	10	0	0	10	0	0
15	19038143	.	G	T	3	7	10	0	1	11	0	0
15	19038218	.	G	A	2	13	15	0	1	16	0	0
15	19039025	.	A	G	7	11	18	0	0	18	0	0
15	19039667	.	T	C	6	0	6	0	3	9	0	0
15	19039830	.	C	A	0	7	7	0	6	13	0	0
15	19039874	.	A	G	4	7	11	0	0	11	0	0
15	19042070	.	C	T	5	3	8	0	1	9	0	0
15	19042213	.	A	C	5	4	9	0	0	9	0	0
15	19042347	.	C	T	0	8	8	0	4	12	0	0
15	19045649	.	A	G	1	2	3	0	0	3	0	0
15	19045871	.	C	T	1	7	8	0	0	8	0	0
15	19045886	.	T	C	2	6	8	0	0	8	0	0
15	19051093	.	A	C	2	2	4	0	1	5	0	0
15	19061952	.	T	C	1	2	3	0	0	3	0	0
15	19132077	.	A	G	20	12	32	0	2	34	0	0
15	19132178	.	G	A	12	14	26	0	2	28	0	0
15	19132203	.	A	T	16	14	30	0	0	30	0	0
15	19132659	.	G	T	1	5	6	0	1	8	1	0
15	19132667	.	T	C	1	0	1	0	7	8	0	0
15	19132724	.	G	A	1	5	6	0	0	6	0	0
15	19133310	.	C	T	12	15	27	0	0	27	0	0
15	19133374	.	G	T	18	7	25	0	0	25	0	0
15	19133437	.	A	T	18	10	28	0	1	29	0	0
15	19133647	.	C	T	11	20	31	0	1	32	0	0
15	19133750	.	A	G	12	19	31	0	1	32	0	0
15	19134109	.	T	C	9	0	9	0	10	19	0	0
15	19134710	.	G	A	4	4	8	0	0	8	0	0
15	19134905	.	C	A	12	5	17	0	1	18	0	0
15	19135009	.	T	C	5	6	11	0	0	11	0	0
15	19135304	.	T	C	9	12	21	0	0	21	0	0
15	19135351	.	G	A	8	7	15	0	1	16	0	0
15	19139757	.	C	T	0	9	9	0	8	17	0	0
15	19146896	.	T	C	2	1	3	0	0	3	0	0
15	19147330	.	G	A	1	5	6	0	0	6	0	0
15	19170879	.	C	T	0	1	1	0	1	2	0	0
15	19175049	.	T	C	2	0	2	0	4	6	0	0
15	19175055	.	T	C	1	0	1	0	4	5	0	0
15	19250469	.	G	C	4	2	6	0	0	6	0	0
15	19293919	.	G	T	13	8	21	0	0	21	0	0
15	19293920	.	G	T	13	8	21	0	0	21	0	0
15	19311505	.	G	T	0	2	2	0	2	4	0	0
15	19311631	.	C	T	7	12	19	0	1	20	0	0
15	19312545	.	G	A	3	6	9	0	0	9	0	0
15	19316370	.	T	A	1	2	3	0	0	3	0	0
15	19316500	.	G	T	5	9	14	0	0	15	1	0
15	19316573	.	T	C	10	5	15	0	1	16	0	0
15	19317065	.	G	A	0	3	3	0	3	6	0	0
15	19318513	.	T	A	5	2	7	0	1	8	0	0
15	19319051	.	G	A	2	2	4	0	0	4	0	0
15	19319128	.	A	C	1	3	4	0	0	4	0	0
15	19319227	.	C	G	6	6	12	0	0	12	0	0
15	19319250	.	T	C	7	6	13	0	2	15	0	0
15	19319272	.	G	C	7	6	13	0	0	13	0	0
15	19319376	.	C	T	7	9	16	0	0	16	0	0
15	19319429	.	G	A	2	4	6	0	0	6	0	0
15	19319613	.	A	G	4	5	9	0	0	9	0	0
15	19319691	.	A	T	2	3	5	0	0	5	0	0
15	19324762	.	T	A	5	9	14	0	0	14	0	0
15	19327602	.	C	G	2	0	2	0	0	2	0	0
15	19327665	.	G	A	0	7	7	0	10	17	0	0
15	19328334	.	G	A	8	5	13	0	0	13	0	0
15	19329908	.	G	A	12	9	21	0	0	21	0	0
15	19329962	.	T	C	2	7	9	0	1	10	0	0
15	19330408	.	C	T	6	10	16	0	0	16	0	0
15	19330607	.	T	A	4	12	16	0	0	16	0	0
15	19330745	.	T	A	2	3	5	0	0	5	0	0
15	19330748	.	C	A	2	3	5	0	0	5	0	0
15	19330897	.	A	C	6	5	11	0	2	13	0	0
15	19332719	.	C	T	3	2	5	0	0	5	0	0
15	19337247	.	A	C	3	2	5	0	1	6	0	0
15	19339789	.	T	A	4	3	7	0	0	7	0	0
15	19472290	.	G	A	7	5	12	0	0	12	0	0
15	19482640	.	G	A	9	3	12	0	0	12	0	0
15	19482661	.	G	T	0	8	8	0	3	11	0	0
15	19522052	.	C	T	5	1	6	0	0	6	0	0
15	19522085	.	T	C	1	0	1	0	0	1	0	0
15	19544143	.	T	C	1	1	2	0	1	3	0	0
15	19574919	.	C	T	3	2	5	0	0	5	0	0
15	19577072	.	C	T	6	7	13	0	0	13	0	0
15	19577242	.	G	A	1	9	10	0	0	10	0	0
15	19583841	.	C	T	15	9	24	0	1	25	0	0
15	19584132	.	G	T	1	3	4	0	0	4	0	0
15	19584187	.	T	C	7	13	20	0	0	20	0	0
15	19595508	.	C	T	3	6	9	0	2	11	0	0
15	19595509	.	T	G	7	1	8	0	3	11	0	0
15	19595782	.	G	A	6	7	13	0	0	13	0	0
15	19600214	.	C	T	9	4	13	0	0	13	0	0
15	19661619	.	A	T	6	6	12	0	0	12	0	0
15	19661664	.	T	A	13	5	18	0	1	19	0	0
15	19661756	.	T	A	12	6	18	0	0	18	0	0
15	19661820	.	G	T	16	6	22	0	0	22	0	0
15	19668105	.	C	T	0	3	3	0	2	5	0	0
15	19668276	.	C	T	0	8	8	0	4	12	0	0
15	19668375	.	G	A	11	7	18	0	0	18	0	0
15	19668585	.	A	G	5	7	12	0	0	12	0	0
15	19668638	.	T	G	0	1	1	0	0	1	0	0
15	19727706	.	T	C	1	2	3	0	0	3	0	0
15	19727710	.	G	A	1	1	2	0	1	3	0	0
15	19728127	.	A	T	7	6	13	0	2	15	0	0
15	19728307	.	C	T	13	17	30	0	3	33	0	0
15	19772261	.	C	A	1	8	9	0	11	21	1	0
15	19870165	.	C	T	2	1	3	0	0	3	0	0
15	19870174	.	G	A	2	1	3	0	0	3	0	0
15	19878064	.	T	G	1	5	6	0	0	6	0	0
15	19878640	.	T	G	2	0	2	0	2	4	0	0
15	19878805	.	T	A	1	4	5	0	0	5	0	0
15	19878869	.	G	A	8	2	10	0	0	10	0	0
15	19878877	.	C	A	8	2	10	0	0	10	0	0
15	19884717	.	T	C	4	4	8	0	0	8	0	0
15	19891082	.	A	T	5	6	11	0	0	11	0	0
15	19891939	.	T	C	8	8	16	0	1	17	0	0
15	19892083	.	G	A	0	10	10	0	9	19	0	0
15	19893465	.	A	G	17	1	18	0	11	29	0	0
15	19893952	.	T	G	5	1	6	0	0	6	0	0
15	19894898	.	T	G	1	0	1	0	8	9	0	0
15	19895304	.	T	A	3	8	11	0	2	13	0	0
15	19896052	.	A	C	10	9	19	0	0	19	0	0
15	19896072	.	C	A	9	7	16	0	0	17	1	0
15	19896589	.	C	T	5	4	9	0	0	9	0	0
15	19907082	.	G	A	2	5	7	0	0	7	0	0
15	19907083	.	A	G	2	5	7	0	0	7	0	0
15	19907146	.	C	T	3	3	6	0	0	6	0	0
15	19907161	.	G	A	2	3	5	0	1	6	0	0
15	19907233	.	T	C	3	3	6	0	0	6	0	0
15	19907241	.	A	G	3	3	6	0	0	6	0	0
15	19907543	.	G	T	1	2	3	0	0	3	0	0
15	19907908	.	C	A	1	3	4	0	0	4	0	0
15	19907914	.	C	T	1	3	4	0	0	4	0	0
15	19908777	.	A	T	3	4	7	0	0	7	0	0
15	19908864	.	C	G	2	1	3	0	2	5	0	0
15	19915674	.	C	A	2	5	7	0	0	7	0	0
15	19916014	.	C	A	8	12	20	0	0	20	0	0
15	19925978	.	G	A	5	5	10	0	0	10	0	0
15	19932674	.	G	A	0	13	13	0	12	25	0	0
15	19990237	.	T	C	1	2	3	0	0	3	0	0
15	20003130	.	G	A	1	6	7	0	1	8	0	0
15	20005301	.	A	G	7	5	12	0	1	13	0	0
15	20005665	.	C	A	2	4	6	0	0	6	0	0
15	20005863	.	T	A	6	9	15	0	0	15	0	0
15	20007033	.	T	A	2	3	5	0	0	5	0	0
15	20008357	.	C	T	4	2	6	0	0	6	0	0
15	20061367	.	G	A	11	5	16	0	0	16	0	0
15	20065029	.	T	C	5	2	7	0	0	7	0	0
15	20065074	.	G	A	9	5	14	0	0	14	0	0
15	20065125	.	A	G	3	1	4	0	1	5	0	0
15	20066656	.	A	T	9	4	13	0	1	14	0	0
15	20071596	.	G	A	6	3	9	0	0	9	0	0
15	20074138	.	G	A	6	8	14	0	4	18	0	0
15	20074261	.	T	A	7	12	19	0	3	22	0	0
15	20081245	.	T	G	3	5	8	0	1	9	0	0
15	20081275	.	T	A	4	5	9	0	1	10	0	0
15	20081731	.	G	A	7	8	15	0	1	16	0	0
15	20081903	.	G	A	4	5	9	0	0	9	0	0
15	20094707	.	G	T	1	5	6	0	2	8	0	0
15	20117982	.	G	A	1	2	3	0	0	3	0	0
15	20204850	.	T	G	4	5	9	0	0	9	0	0
15	20204873	.	C	T	5	4	9	0	0	9	0	0
15	20204960	.	A	G	3	3	6	0	0	6	0	0
15	20352531	.	A	G	2	1	3	0	0	3	0	0
15	20363063	.	T	G	1	3	4	0	0	4	0	0
15	20363339	.	C	T	1	3	4	0	0	4	0	0
15	20367662	.	C	T	6	0	6	0	0	6	0	0
15	20374712	.	G	A	0	1	1	0	4	5	0	0
15	20376393	.	A	G	2	1	3	0	0	3	0	0
15	20377873	.	A	T	2	2	4	0	0	4	0	0
15	20378479	.	T	C	12	8	20	0	1	21	0	0
15	20380144	.	C	A	1	0	1	0	0	1	0	0
15	20382472	.	C	T	1	4	5	0	0	5	0	0
15	20383967	.	G	T	5	4	9	0	1	10	0	0
15	20384310	.	A	G	8	11	19	0	4	23	0	0
15	20386212	.	A	G	7	7	14	0	1	15	0	0
15	20394788	.	G	A	0	14	14	0	12	26	0	0
15	20394877	.	G	A	16	14	30	0	6	36	0	0
15	20394915	.	G	A	0	14	14	0	19	34	1	0
15	20463842	.	A	G	3	5	8	0	0	8	0	0
15	20463909	.	A	G	2	2	4	0	0	4	0	0
15	20476016	.	C	G	3	6	9	0	0	9	0	0
15	20476058	.	A	G	8	8	16	0	0	16	0	0
15	20476075	.	A	G	9	8	17	0	1	18	0	0
15	20478820	.	G	A	4	4	8	0	0	8	0	0
15	20489854	.	C	T	0	0	0	0	1	1	0	0
15	20525524	.	C	T	1	5	6	0	0	6	0	0
15	20525533	.	C	T	1	4	5	0	0	5	0	0
15	20535475	.	C	T	1	2	3	0	0	3	0	0
15	20540641	.	T	A	1	6	7	0	1	8	0	0
15	20637832	.	C	T	3	5	8	0	0	8	0	0
15	20640100	.	T	A	0	1	1	0	0	1	0	0
15	20643476	.	G	A	0	3	3	0	1	4	0	0
15	20652744	.	A	G	0	6	6	0	0	6	0	0
15	20652746	.	G	A	6	0	6	0	0	6	0	0
15	20652787	.	G	A	7	12	19	0	2	21	0	0
15	20653005	.	T	A	14	16	30	0	1	31	0	0
15	20653048	.	A	T	4	11	15	0	2	17	0	0
15	20653074	.	T	A	3	4	7	0	0	7	0	0
15	20653258	.	T	A	37	9	46	0	5	51	0	0
15	20655888	.	A	C	1	0	1	0	0	1	0	0
15	20709058	.	G	A	11	8	19	0	1	20	0	0
15	20709184	.	T	A	9	7	16	0	2	18	0	0
15	20709292	.	A	C	11	16	27	0	2	29	0	0
15	20731260	.	G	C	16	17	33	0	2	35	0	0
15	20731345	.	A	C	1	0	1	0	2	3	0	0
15	20731512	.	A	T	3	5	8	0	0	8	0	0
15	20803603	.	G	A	1	1	2	0	0	2	0	0
15	20807043	.	C	A	1	3	4	0	0	4	0	0
15	20808580	.	A	T	1	2	3	0	0	3	0	0
15	20808587	.	T	A	1	2	3	0	0	3	0	0
15	20830937	.	A	G	1	2	3	0	0	3	0	0
15	20830965	.	G	A	2	2	4	0	0	4	0	0
15	20831091	.	T	C	5	2	7	0	0	7	0	0
15	20831105	.	C	T	4	2	6	0	0	6	0	0
15	20832687	.	A	G	1	0	1	0	1	2	0	0
15	20836008	.	A	G	3	3	6	0	0	6	0	0
15	20838274	.	A	G	2	3	5	0	0	5	0	0
15	20838297	.	T	C	3	2	5	0	1	6	0	0
15	20838312	.	A	G	3	4	7	0	0	7	0	0
15	20838334	.	C	T	0	4	4	0	3	7	0	0
15	20838381	.	A	G	2	3	5	0	0	5	0	0
15	20838387	.	A	T	1	3	4	0	0	4	0	0
15	20843441	.	C	T	5	4	9	0	0	9	0	0
15	20844074	.	A	C	2	6	8	0	0	8	0	0
15	20883238	.	C	A	3	4	7	0	1	8	0	0
15	20884503	.	T	G	6	0	6	0	6	12	0	0
15	20884551	.	T	C	2	1	3	0	0	3	0	0
15	20891154	.	T	A	6	6	12	0	2	14	0	0
15	20893300	.	C	A	2	3	5	0	0	5	0	0
15	20893320	.	C	A	9	0	9	0	2	11	0	0
15	20893592	.	C	T	6	10	16	0	1	17	0	0
15	20893644	.	A	G	9	9	18	0	1	19	0	0
15	20894094	.	A	G	15	0	15	0	10	25	0	0
15	20894129	.	C	G	11	11	22	0	1	23	0	0
15	20894464	.	T	C	17	22	39	0	0	39	0	0
15	20894604	.	C	T	5	8	13	0	1	14	0	0
15	20901009	.	C	T	16	12	28	0	2	30	0	0
15	20901053	.	T	C	12	16	28	0	1	29	0	0
15	20901133	.	A	G	11	22	33	0	1	34	0	0
15	20901261	.	G	T	16	20	36	0	0	36	0	0
15	20901358	.	A	G	10	14	24	0	0	24	0	0
15	20901366	.	T	A	16	9	25	0	0	25	0	0
15	20901540	.	C	T	0	6	6	0	12	18	0	0
15	20901562	.	G	A	6	12	18	0	0	18	0	0
15	20907603	.	A	G	4	5	9	0	0	9	0	0
15	20907648	.	A	G	1	0	1	0	0	1	0	0
15	20907651	.	C	T	0	1	1	0	0	1	0	0
15	20907958	.	C	T	4	4	8	0	1	9	0	0
15	20907970	.	C	T	0	4	4	0	5	9	0	0
15	20943064	.	T	C	3	3	6	0	0	6	0	0
15	20943072	.	G	A	2	4	6	0	0	6	0	0
15	20943248	.	G	T	4	6	10	0	0	11	1	0
15	20943651	.	T	C	7	5	12	0	1	13	0	0
15	20943760	.	T	A	3	4	7	0	1	8	0	0
15	20944004	.	T	A	4	4	8	0	0	8	0	0
15	20944005	.	G	T	4	4	8	0	0	8	0	0
15	20944217	.	C	A	2	3	5	0	0	5	0	0
15	20944562	.	G	A	4	4	8	0	0	8	0	0
15	20944577	.	C	G	3	5	8	0	0	8	0	0
15	20944856	.	G	A	12	5	17	0	1	18	0	0
15	20945060	.	C	T	4	7	11	0	1	12	0	0
15	20948694	.	C	A	0	1	1	0	0	1	0	0
15	20954495	.	A	C	2	3	5	0	0	5	0	0
15	20956305	.	A	C	1	0	1	0	3	4	0	0
15	20956348	.	A	C	2	4	6	0	0	6	0	0
15	21253462	.	C	T	5	2	7	0	0	7	0	0
15	21255145	.	T	C	1	0	1	0	0	1	0	0
15	21258288	.	C	T	3	4	7	0	0	7	0	0
15	21260930	.	A	T	1	3	4	0	0	4	0	0
15	21260966	.	T	G	1	4	5	0	0	5	0	0
15	21262064	.	A	G	4	2	6	0	0	6	0	0
15	21262268	.	C	T	10	3	13	0	0	13	0	0
15	21265978	.	G	A	2	1	3	0	0	3	0	0
15	21266018	.	A	G	1	0	1	0	1	2	0	0
15	21267514	.	A	G	0	0	0	0	4	4	0	0
15	21269869	.	A	T	1	1	2	0	0	2	0	0
15	21275486	.	T	C	5	2	7	0	1	8	0	0
15	21307477	.	C	T	3	3	6	0	0	6	0	0
15	21315677	.	T	C	3	0	3	0	0	3	0	0
15	21316996	.	A	T	1	0	1	0	0	1	0	0
15	21319739	.	T	A	3	2	5	0	0	5	0	0
15	21320097	.	T	C	7	8	15	0	0	15	0	0
15	21320329	.	A	G	7	4	11	0	0	11	0	0
15	21320475	.	A	T	8	9	17	0	0	17	0	0
15	21320558	.	T	A	6	7	13	0	1	14	0	0
15	21521926	.	T	C	0	4	4	0	0	4	0	0
15	21521927	.	A	T	0	3	3	0	1	4	0	0
15	21541201	.	C	T	4	8	12	0	0	12	0	0
15	21541620	.	C	T	0	2	2	4	0	6	0	0
15	21541695	.	T	G	5	3	8	0	0	8	0	0
15	21542210	.	G	C	1	0	1	0	4	5	0	0
15	21542542	.	T	C	3	14	17	0	0	17	0	0
15	21542559	.	C	A	3	13	16	1	0	17	0	0
15	21542884	.	C	A	1	10	11	0	3	14	0	0
15	21545866	.	C	T	3	5	8	0	1	9	0	0
15	21545921	.	C	T	0	15	15	0	7	22	0	0
15	21546399	.	A	G	1	1	2	0	0	2	0	0
15	21548403	.	C	T	3	7	10	0	0	10	0	0
15	21552410	.	T	A	0	1	1	0	0	1	0	0
15	21554326	.	C	T	0	1	1	0	0	1	0	0
15	21554332	.	A	G	0	1	1	0	0	1	0	0
15	21556193	.	A	G	2	4	6	0	0	6	0	0
15	21556274	.	G	A	4	3	7	0	0	7	0	0
15	21557122	.	A	T	3	4	7	0	0	7	0	0
15	21557403	.	G	C	2	6	8	0	0	8	0	0
15	21557418	.	C	T	0	3	3	0	2	6	1	0
15	21558334	.	A	C	3	1	4	0	0	4	0	0
15	21561817	.	A	G	1	3	4	0	0	4	0	0
15	21561823	.	G	A	1	3	4	0	0	4	0	0
15	21571033	.	G	A	4	3	7	0	0	7	0	0
15	21571261	.	G	A	2	4	6	0	0	6	0	0
15	21638389	.	G	A	1	3	4	0	0	4	0	0
15	21669462	.	G	C	5	8	13	0	0	13	0	0
15	21669470	.	T	A	4	8	12	0	0	12	0	0
15	21684546	.	T	A	10	5	15	0	0	15	0	0
15	21684558	.	C	G	9	5	14	0	0	14	0	0
15	21684701	.	T	C	3	3	6	0	1	7	0	0
15	21684704	.	T	G	4	3	7	0	0	7	0	0
15	21684933	.	A	G	5	16	21	0	1	22	0	0
15	21685195	.	T	A	17	15	32	0	2	34	0	0
15	21685217	.	C	T	0	18	18	0	18	36	0	0
15	21685357	.	G	A	20	19	39	0	1	40	0	0
15	21685418	.	C	T	18	13	31	0	0	31	0	0
15	21685484	.	A	G	17	8	25	0	4	29	0	0
15	21712570	.	G	A	1	2	3	0	0	3	0	0
15	21712577	.	A	G	1	0	1	0	2	3	0	0
15	21715339	.	C	T	4	8	12	0	0	12	0	0
15	21715381	.	G	A	4	7	11	0	0	11	0	0
15	21715508	.	A	G	6	4	10	0	0	10	0	0
15	21715943	.	T	A	1	4	5	0	0	5	0	0
15	21747981	.	T	C	7	11	18	0	0	18	0	0
15	21757433	.	C	T	16	19	35	0	3	38	0	0
15	21769619	.	T	C	6	6	12	0	0	12	0	0
15	21769640	.	G	A	12	11	23	0	2	25	0	0
15	21771835	.	A	T	19	17	36	0	3	39	0	0
15	21772073	.	T	C	26	19	45	0	0	45	0	0
15	21772112	.	T	C	30	19	49	0	1	50	0	0
15	21772174	.	T	C	22	27	49	0	2	51	0	0
15	21772208	.	T	C	16	32	48	0	0	48	0	0
15	21772689	.	C	A	16	25	41	0	3	44	0	0
15	21782020	.	G	A	22	12	34	0	2	36	0	0
15	21782028	.	G	A	20	12	32	0	3	35	0	0
15	21782057	.	T	C	18	15	33	0	2	35	0	0
15	21782154	.	C	A	1	15	16	0	8	24	0	0
15	21782171	.	G	A	9	15	24	0	2	26	0	0
15	21782238	.	A	G	6	5	11	0	1	12	0	0
15	21782385	.	G	T	4	6	10	0	2	12	0	0
15	21782946	.	C	G	6	12	18	0	0	18	0	0
15	21783681	.	G	A	2	10	12	0	1	13	0	0
15	21784042	.	G	T	14	8	22	0	4	26	0	0
15	21784226	.	T	C	16	1	17	0	10	27	0	0
15	21784352	.	T	C	2	2	4	0	0	4	0	0
15	21784525	.	C	G	0	0	0	0	3	3	0	0
15	21789819	.	G	T	2	5	7	0	1	8	0	0
15	21791872	.	G	T	14	7	21	0	0	21	0	0
15	21791878	.	C	T	1	8	9	0	12	21	0	0
15	21792220	.	C	T	1	8	9	0	6	15	0	0
15	21798394	.	T	C	7	4	11	0	0	11	0	0
15	21813430	.	G	T	4	5	9	0	0	9	0	0
15	21813451	.	G	A	3	5	8	0	0	8	0	0
15	21836607	.	A	G	2	3	5	0	0	5	0	0
15	21976864	.	C	T	0	1	1	0	0	1	0	0
15	22046900	.	A	G	2	2	4	0	1	5	0	0
15	22047131	.	C	G	3	2	5	0	0	5	0	0
15	22047389	.	T	C	8	6	14	0	0	14	0	0
15	22133987	.	A	C	8	1	9	0	11	20	0	0
15	22143027	.	G	A	3	3	6	0	0	6	0	0
15	22147174	.	C	G	4	3	7	0	0	7	0	0
15	22147186	.	G	T	4	3	7	0	0	7	0	0
15	22272412	.	A	C	2	3	5	0	1	6	0	0
15	22319721	.	C	T	7	4	11	0	0	11	0	0
15	22319797	.	C	T	6	5	11	0	1	12	0	0
15	22319830	.	G	A	7	6	13	0	1	14	0	0
15	22324529	.	A	T	1	0	1	0	0	1	0	0
15	22324538	.	T	A	1	0	1	0	0	1	0	0
15	22324760	.	A	G	15	24	39	0	0	39	0	0
15	22324948	.	T	C	14	16	30	0	0	30	0	0
15	22325007	.	C	T	15	7	22	0	1	23	0	0
15	22325278	.	A	G	11	0	11	0	12	23	0	0
15	22325617	.	G	T	13	17	30	1	1	32	0	0
15	22325687	.	A	C	5	4	9	0	1	10	0	0
15	22435473	.	G	A	6	3	9	0	1	10	0	0
15	22435565	.	T	G	5	0	5	0	7	12	0	0
15	22441703	.	C	T	10	3	13	0	1	14	0	0
15	22441744	.	A	G	3	6	9	0	0	9	0	0
15	22441852	.	A	G	4	0	4	0	8	12	0	0
15	22441855	.	C	T	7	6	13	0	0	13	0	0
15	22441900	.	T	C	9	6	15	0	0	15	0	0
15	22441972	.	G	A	10	6	16	0	0	16	0	0
15	22442713	.	A	T	9	6	15	0	0	15	0	0
15	22442875	.	G	A	0	8	8	0	10	18	0	0
15	22443048	.	T	G	5	2	7	0	0	7	0	0
15	22443136	.	C	T	7	4	11	0	1	12	0	0
15	22443282	.	C	T	10	2	12	0	1	13	0	0
15	22443289	.	A	T	11	4	15	0	0	15	0	0
15	22443460	.	G	A	1	9	10	0	6	16	0	0
15	22443462	.	A	G	6	0	6	0	9	16	1	0
15	22443520	.	A	G	11	9	20	0	1	21	0	0
15	22443615	.	G	A	15	10	25	0	0	25	0	0
15	22443630	.	G	T	0	16	16	0	13	29	0	0
15	22443798	.	A	G	11	13	24	0	2	26	0	0
15	22443858	.	A	G	14	17	31	0	1	32	0	0
15	22443934	.	G	A	0	22	22	0	20	42	0	0
15	22444062	.	A	G	14	19	33	0	2	35	0	0
15	22444239	.	G	A	1	20	21	0	10	31	0	0
15	22444266	.	A	G	8	17	25	0	0	25	0	0
15	22444310	.	T	A	7	12	19	0	1	20	0	0
15	22444331	.	G	A	11	8	19	0	0	19	0	0
15	22444483	.	T	G	7	0	7	0	7	14	0	0
15	22444486	.	A	T	7	7	14	0	0	14	0	0
15	22444524	.	T	C	8	3	11	0	0	11	0	0
15	22444636	.	C	T	6	3	9	0	0	9	0	0
15	22502831	.	C	A	1	0	1	0	0	1	0	0
15	22516432	.	C	A	5	5	10	0	1	11	0	0
15	22516625	.	G	A	2	1	3	0	0	3	0	0
15	22526258	.	C	T	0	1	1	0	0	1	0	0
15	22526463	.	G	C	0	2	2	0	2	4	0	0
15	22536756	.	C	T	2	5	7	0	1	8	0	0
15	22536795	.	G	C	0	4	4	0	1	5	0	0
15	22537008	.	T	A	3	2	5	0	1	6	0	0
15	22722694	.	C	T	0	1	1	0	0	1	0	0
15	22976939	.	T	C	2	3	5	0	0	5	0	0
15	22976943	.	T	C	2	2	4	0	0	4	0	0
15	22999133	.	T	C	0	2	2	0	0	2	0	0
15	22999151	.	C	T	2	0	2	0	0	2	0	0
15	23181511	.	C	A	6	4	10	0	0	10	0	0
15	23187879	.	T	A	2	8	10	0	0	10	0	0
15	23187902	.	T	G	3	1	4	0	6	10	0	0
15	23188188	.	T	G	3	2	5	0	2	7	0	0
15	23188190	.	C	T	3	4	7	0	0	7	0	0
15	23188245	.	T	A	7	1	8	0	0	8	0	0
15	23208223	.	G	C	3	2	5	0	0	5	0	0
15	23243797	.	T	C	1	2	3	0	0	3	0	0
15	23243860	.	G	A	0	1	1	0	1	2	0	0
15	23244134	.	A	C	2	3	5	0	0	5	0	0
15	23255643	.	T	C	6	4	10	0	0	10	0	0
15	23256320	.	C	T	1	1	2	0	0	2	0	0
15	23256449	.	T	C	11	7	18	0	0	18	0	0
15	23256546	.	C	A	10	4	14	0	1	15	0	0
15	23256547	.	C	T	10	5	15	0	0	15	0	0
15	23256674	.	C	T	1	1	2	0	0	2	0	0
15	23256779	.	G	A	1	1	2	0	1	3	0	0
15	23264471	.	G	A	1	8	9	0	4	13	0	0
15	23264547	.	G	A	0	3	3	0	7	10	0	0
15	23264945	.	T	C	4	7	11	0	1	12	0	0
15	23265217	.	C	T	4	7	11	0	1	12	0	0
15	23272060	.	C	T	3	3	6	0	0	6	0	0
15	23273262	.	G	A	6	3	9	0	0	9	0	0
15	23273456	.	C	T	4	3	7	0	0	7	0	0
15	23280990	.	G	A	6	2	8	0	0	8	0	0
15	23281017	.	C	G	2	5	7	0	0	7	0	0
15	23282608	.	C	T	1	0	1	0	0	1	0	0
15	23284990	.	A	G	3	2	5	0	1	6	0	0
15	23285213	.	T	A	3	1	4	0	0	4	0	0
15	23357402	.	G	A	0	5	5	0	2	7	0	0
15	23357763	.	C	T	3	2	5	0	0	5	0	0
15	23357870	.	G	T	0	3	3	0	3	6	0	0
15	23357909	.	C	T	3	4	7	0	0	7	0	0
15	23357957	.	G	C	5	2	7	0	0	7	0	0
15	23358257	.	C	A	4	7	11	0	0	11	0	0
15	23386976	.	C	T	0	8	8	0	8	16	0	0
15	23387010	.	A	G	4	5	9	0	1	10	0	0
15	23387334	.	G	A	2	5	7	0	0	7	0	0
15	23387567	.	G	A	4	6	10	0	0	10	0	0
15	23387577	.	G	A	5	6	11	0	0	11	0	0
15	23388471	.	G	T	4	13	17	0	1	18	0	0
15	23388609	.	C	T	5	4	9	0	0	9	0	0
15	23389139	.	C	G	6	6	12	0	0	12	0	0
15	23389689	.	A	G	6	4	10	0	0	10	0	0
15	23391196	.	G	A	0	1	1	0	0	1	0	0
15	23391411	.	A	G	0	3	3	0	0	3	0	0
15	23391741	.	A	G	1	1	2	0	0	2	0	0
15	23394773	.	G	A	2	2	4	0	0	4	0	0
15	23397588	.	A	G	0	1	1	0	0	1	0	0
15	23397614	.	C	T	0	1	1	0	0	1	0	0
15	23397987	.	C	T	0	2	2	0	0	2	0	0
15	23398053	.	G	A	0	2	2	0	0	2	0	0
15	23400770	.	G	A	5	4	9	0	0	9	0	0
15	23400954	.	G	A	3	4	7	0	1	8	0	0
15	23403071	.	G	A	2	6	8	0	0	8	0	0
15	23403097	.	A	G	3	5	8	0	0	8	0	0
15	23403191	.	T	C	3	0	3	0	6	9	0	0
15	23403668	.	T	C	2	3	5	0	0	5	0	0
15	23419931	.	T	A	1	4	5	0	0	5	0	0
15	23423674	.	C	T	3	7	10	0	0	10	0	0
15	23423724	.	G	A	5	6	11	0	0	11	0	0
15	23426717	.	T	A	3	0	3	0	0	3	0	0
15	23427075	.	G	A	2	2	4	0	0	4	0	0
15	23429593	.	G	A	6	5	11	0	0	11	0	0
15	23429915	.	G	A	1	1	2	0	0	2	0	0
15	23431734	.	C	T	0	5	5	0	9	14	0	0
15	23434037	.	G	A	2	2	4	0	0	4	0	0
15	23434242	.	C	T	1	3	4	0	0	4	0	0
15	23434251	.	G	A	2	1	3	0	0	3	0	0
15	23437095	.	C	T	3	1	4	0	1	5	0	0
15	23437162	.	T	A	7	7	14	0	0	14	0	0
15	23440676	.	T	C	1	3	4	0	0	4	0	0
15	23440721	.	G	A	2	4	6	0	0	6	0	0
15	23440751	.	A	G	2	1	3	0	0	3	0	0
15	23468569	.	A	T	4	2	6	0	1	7	0	0
15	23468570	.	T	G	5	2	7	0	0	7	0	0
15	23468965	.	A	T	2	2	4	0	0	4	0	0
15	23474815	.	C	G	8	6	14	0	0	14	0	0
15	23478680	.	G	A	1	3	4	0	0	4	0	0
15	23499707	.	A	G	0	2	2	0	0	2	0	0
15	23512078	.	A	T	1	4	5	0	0	5	0	0
15	23512422	.	T	A	5	3	8	0	1	9	0	0
15	23512882	.	T	C	5	2	7	0	0	7	0	0
15	23513009	.	G	C	3	4	7	0	0	7	0	0
15	23526282	.	G	A	0	3	3	0	1	4	0	0
15	23526525	.	A	T	2	2	4	0	0	4	0	0
15	23526578	.	C	T	1	2	3	0	1	4	0	0
15	23528146	.	C	T	1	3	4	0	0	4	0	0
15	23528160	.	A	G	1	3	4	0	0	4	0	0
15	23528183	.	G	A	1	4	5	0	0	5	0	0
15	23531933	.	G	A	4	4	8	0	0	8	0	0
15	23532146	.	A	T	2	2	4	0	1	5	0	0
15	23532332	.	C	T	2	3	5	0	0	5	0	0
15	23532336	.	A	T	3	2	5	0	0	5	0	0
15	23538136	.	T	C	0	1	1	0	0	1	0	0
15	23538153	.	C	T	0	1	1	0	0	1	0	0
15	23540536	.	T	C	2	2	4	0	0	4	0	0
15	23540705	.	G	A	1	2	3	0	0	3	0	0
15	23541136	.	A	C	4	2	6	0	0	6	0	0
15	23541529	.	A	T	3	2	5	0	0	5	0	0
15	23541533	.	A	G	3	0	3	0	2	5	0	0
15	23541943	.	T	G	2	2	4	0	0	4	0	0
15	23551218	.	G	A	0	2	2	0	5	7	0	0
15	23551272	.	C	T	4	7	11	0	0	11	0	0
15	23551295	.	T	A	5	5	10	0	0	10	0	0
15	23551336	.	A	T	1	4	5	0	1	6	0	0
15	23551704	.	G	A	0	6	6	0	2	8	0	0
15	23551769	.	T	G	2	0	2	0	8	10	0	0
15	23551775	.	C	T	2	7	9	0	0	9	0	0
15	23617364	.	G	A	0	4	4	0	3	7	0	0
15	23617612	.	G	T	3	2	5	0	0	5	0	0
15	23619093	.	G	A	0	15	15	0	11	26	0	0
15	23620453	.	T	G	0	2	2	0	0	2	0	0
15	23620511	.	G	A	4	15	19	0	1	20	0	0
15	23620541	.	C	T	8	10	18	0	1	19	0	0
15	23627514	.	G	A	10	11	21	0	0	21	0	0
15	23640374	.	T	A	8	11	19	0	3	22	0	0
15	23640678	.	A	C	3	1	4	0	25	29	0	0
15	23640807	.	C	T	17	7	24	0	0	24	0	0
15	23641057	.	C	T	9	2	11	0	1	12	0	0
15	23641102	.	T	G	5	9	14	0	0	14	0	0
15	23641107	.	G	C	8	5	13	0	1	14	0	0
15	23641426	.	G	A	3	6	9	0	3	12	0	0
15	23677373	.	A	T	3	3	6	0	1	7	0	0
15	23677376	.	G	A	0	4	4	0	3	7	0	0
15	23689275	.	G	A	2	2	4	0	0	4	0	0
15	23689643	.	G	A	0	1	1	0	0	1	0	0
15	23691972	.	G	A	1	1	2	0	0	2	0	0
15	23692207	.	G	T	0	1	1	0	0	1	0	0
15	23693929	.	C	T	1	3	4	0	0	4	0	0
15	23709660	.	G	A	5	3	8	1	0	9	0	0
15	23710339	.	T	C	6	5	11	0	0	11	0	0
15	23710465	.	C	T	6	10	16	0	0	16	0	0
15	23710490	.	G	T	4	9	13	0	1	14	0	0
15	23710515	.	G	A	5	3	8	0	1	9	0	0
15	23710539	.	T	C	4	5	9	0	0	9	0	0
15	23710811	.	A	G	4	7	11	0	0	11	0	0
15	23711890	.	C	T	0	5	5	0	7	12	0	0
15	23711953	.	G	A	6	4	10	0	0	10	0	0
15	23712082	.	A	G	11	9	20	0	0	20	0	0
15	23713116	.	C	T	0	1	1	0	0	1	0	0
15	23713158	.	A	G	3	4	7	0	0	7	0	0
15	23713174	.	G	C	5	3	8	0	1	9	0	0
15	23713679	.	T	G	1	4	5	0	1	6	0	0
15	23713923	.	C	T	5	2	7	0	0	7	0	0
15	23718403	.	C	T	5	4	9	0	0	9	0	0
15	23722824	.	A	T	5	5	10	0	0	10	0	0
15	23723607	.	T	A	2	1	3	0	0	3	0	0
15	23724153	.	G	A	0	2	2	0	1	3	0	0
15	23730816	.	C	A	1	1	2	0	0	2	0	0
15	23733485	.	C	A	5	3	8	0	0	8	0	0
15	23738914	.	C	T	11	8	19	0	0	19	0	0
15	23738915	.	G	C	0	8	8	0	11	19	0	0
15	23739032	.	C	T	2	2	4	0	1	5	0	0
15	23745659	.	G	A	3	3	6	0	0	6	0	0
15	23745952	.	C	T	4	5	9	0	0	9	0	0
15	23747870	.	A	C	0	2	2	0	0	2	0	0
15	23761567	.	C	A	1	4	5	0	1	6	0	0
15	23781320	.	G	A	1	2	3	0	0	3	0	0
15	23783669	.	C	T	4	2	6	0	0	6	0	0
15	23784896	.	C	T	1	0	1	0	0	1	0	0
15	23788266	.	G	A	5	6	11	0	1	12	0	0
15	23793206	.	C	T	1	4	5	0	0	5	0	0
15	23817403	.	T	A	6	11	17	0	1	18	0	0
15	23817517	.	G	A	6	10	16	0	1	17	0	0
15	23817901	.	C	T	0	10	10	0	12	22	0	0
15	23818110	.	G	A	5	2	7	0	0	7	0	0
15	23818313	.	T	A	4	8	12	0	0	12	0	0
15	23818405	.	T	C	6	4	10	0	1	11	0	0
15	23818460	.	T	C	5	9	14	0	1	15	0	0
15	23818472	.	T	C	6	10	16	0	0	16	0	0
15	23818542	.	T	A	3	4	7	0	1	8	0	0
15	23818788	.	G	C	1	1	2	0	3	5	0	0
15	23819248	.	T	A	7	3	10	0	1	11	0	0
15	23819253	.	C	T	4	8	12	0	0	12	0	0
15	23819423	.	G	A	12	6	18	0	1	19	0	0
15	23823508	.	C	T	6	7	13	0	1	14	0	0
15	23823638	.	G	C	6	3	9	0	0	9	0	0
15	23829245	.	C	T	2	1	3	0	0	3	0	0
15	23830658	.	G	A	2	2	4	0	0	4	0	0
15	23831007	.	C	T	4	1	5	0	0	5	0	0
15	23835988	.	T	C	1	1	2	0	0	2	0	0
15	23841498	.	G	A	4	2	6	0	1	7	0	0
15	23860840	.	G	A	1	1	2	0	0	2	0	0
15	23860849	.	G	A	0	1	1	0	1	2	0	0
15	23863843	.	G	A	2	1	3	0	0	3	0	0
15	23883096	.	G	A	0	1	1	0	0	1	0	0
15	23892260	.	G	A	0	1	1	0	0	1	0	0
15	23911793	.	C	G	3	4	7	0	0	7	0	0
15	23911881	.	A	G	1	1	2	0	0	2	0	0
15	23913867	.	G	T	1	2	3	0	0	3	0	0
15	23913904	.	A	C	1	3	4	0	0	4	0	0
15	23918333	.	G	C	3	3	6	0	0	6	0	0
15	23918365	.	C	T	2	5	7	0	0	7	0	0
15	23918424	.	A	T	2	5	7	0	1	8	0	0
15	23922714	.	G	A	15	10	25	0	0	25	0	0
15	23922994	.	G	T	17	6	23	0	0	23	0	0
15	23923261	.	T	G	6	9	15	0	0	15	0	0
15	23925372	.	G	C	5	3	8	0	1	9	0	0
15	23927992	.	G	T	13	25	38	0	3	41	0	0
15	23931187	.	A	G	3	4	7	0	0	7	0	0
15	23931454	.	A	G	5	4	9	0	0	9	0	0
15	23942804	.	T	G	9	12	21	0	0	21	0	0
15	24016739	.	T	C	1	3	4	0	0	4	0	0
15	24017280	.	G	A	0	1	1	0	0	1	0	0
15	24020116	.	C	T	3	3	6	0	0	6	0	0
15	24026897	.	G	A	0	1	1	0	0	1	0	0
15	24035939	.	C	A	0	4	4	0	1	5	0	0
15	24035940	.	A	C	1	4	5	0	0	5	0	0
15	24052264	.	C	T	1	1	2	0	0	2	0	0
15	24054101	.	C	T	1	1	2	0	0	2	0	0
15	24084737	.	T	A	2	2	4	0	2	6	0	0
15	24084773	.	C	T	7	4	11	0	0	11	0	0
15	24094697	.	T	C	3	2	5	0	0	5	0	0
15	24096474	.	G	A	5	5	10	0	1	11	0	0
15	24096657	.	C	A	4	4	8	0	0	8	0	0
15	24104648	.	C	T	1	4	5	0	1	6	0	0
15	24106821	.	C	T	5	4	9	0	1	10	0	0
15	24119372	.	A	G	8	3	11	0	0	11	0	0
15	24119391	.	C	T	5	2	7	0	1	8	0	0
15	24119571	.	T	C	11	12	23	0	0	23	0	0
15	24119720	.	G	A	0	2	2	0	4	6	0	0
15	24120588	.	C	T	7	3	10	0	1	11	0	0
15	24150220	.	T	G	1	4	5	0	0	5	0	0
15	24150293	.	C	T	1	3	4	0	0	4	0	0
15	24161122	.	T	C	2	0	2	0	1	3	0	0
15	24161161	.	C	T	0	3	3	0	5	8	0	0
15	24161209	.	C	T	0	3	3	0	0	3	0	0
15	24164807	.	A	G	1	0	1	0	0	1	0	0
15	24388860	.	C	T	6	7	13	0	0	13	0	0
15	24389369	.	A	C	6	6	12	0	1	13	0	0
15	24389483	.	G	A	0	1	1	0	1	2	0	0
15	24391755	.	G	A	0	1	1	0	3	4	0	0
15	24439290	.	G	A	0	1	1	0	0	1	0	0
15	24439382	.	T	C	5	6	11	0	1	12	0	0
15	24489776	.	G	A	0	1	1	0	0	1	0	0
15	24500648	.	G	A	4	3	7	0	0	7	0	0
15	24525815	.	A	G	0	0	0	0	4	4	0	0
15	24525890	.	T	C	10	8	18	0	0	18	0	0
15	24530477	.	G	A	0	8	8	0	12	20	0	0
15	24535495	.	C	T	5	4	9	0	0	9	0	0
15	24543991	.	C	T	2	3	5	0	0	5	0	0
15	24544305	.	T	A	6	3	9	0	1	10	0	0
15	24544325	.	G	A	7	5	12	0	0	12	0	0
15	24544653	.	A	T	12	9	21	0	1	22	0	0
15	24544657	.	A	G	13	0	13	0	9	22	0	0
15	24549609	.	T	C	5	5	10	0	0	10	0	0
15	24554786	.	C	A	3	4	7	0	0	7	0	0
15	24557185	.	C	T	4	6	10	0	0	10	0	0
15	24557432	.	A	G	7	6	13	0	0	13	0	0
15	24557540	.	G	A	5	4	9	0	1	10	0	0
15	24557810	.	A	C	8	10	18	0	1	19	0	0
15	24561055	.	T	C	3	1	4	0	0	4	0	0
15	24561414	.	G	A	3	2	5	0	0	5	0	0
15	24561501	.	C	T	15	9	24	0	0	24	0	0
15	24562188	.	A	G	5	2	7	0	0	7	0	0
15	24562763	.	A	T	1	2	3	0	0	3	0	0
15	24565265	.	T	A	2	3	5	0	0	5	0	0
15	24583933	.	C	G	5	3	8	0	0	8	0	0
15	24644734	.	T	C	1	0	1	0	0	1	0	0
15	24661292	.	G	A	0	1	1	0	0	1	0	0
15	24671352	.	T	C	2	2	4	0	0	4	0	0
15	24671394	.	T	C	0	2	2	0	0	2	0	0
15	24673385	.	T	C	1	2	3	0	0	3	0	0
15	24673723	.	T	A	9	13	22	0	0	22	0	0
15	24673997	.	A	G	4	6	10	0	0	10	0	0
15	24676983	.	T	A	1	2	3	0	0	3	0	0
15	24677001	.	C	A	1	3	4	0	0	4	0	0
15	24678088	.	G	A	0	2	2	0	0	2	0	0
15	24679744	.	T	C	0	1	1	0	0	1	0	0
15	24679944	.	T	C	1	0	1	0	0	1	0	0
15	24683236	.	A	G	5	6	11	0	2	13	0	0
15	24686282	.	C	T	7	8	15	0	0	15	0	0
15	24686450	.	G	A	0	0	0	0	1	1	0	0
15	24689592	.	G	A	0	16	16	0	13	29	0	0
15	24689701	.	G	A	0	15	15	0	14	29	0	0
15	24689948	.	T	C	7	8	15	0	0	15	0	0
15	24691290	.	A	G	6	1	7	0	3	10	0	0
15	24691847	.	A	G	2	0	2	0	4	6	0	0
15	24692351	.	A	T	4	4	8	0	0	8	0	0
15	24692359	.	G	A	6	4	10	0	0	10	0	0
15	24692716	.	T	A	3	5	8	0	0	8	0	0
15	24733569	.	G	A	3	3	6	0	1	7	0	0
15	24733689	.	G	A	7	12	19	0	1	20	0	0
15	24733791	.	T	G	11	6	17	0	0	17	0	0
15	24733896	.	G	A	5	8	13	0	0	13	0	0
15	24733932	.	T	C	4	7	11	0	0	11	0	0
15	24735111	.	G	T	11	7	18	0	0	18	0	0
15	24735163	.	C	G	6	5	11	0	0	11	0	0
15	24735219	.	C	T	5	3	8	0	1	9	0	0
15	24735341	.	C	T	11	4	15	0	0	15	0	0
15	24735472	.	T	C	3	4	7	0	0	7	0	0
15	24735677	.	G	T	16	5	21	0	1	22	0	0
15	24735935	.	T	G	1	4	5	0	0	5	0	0
15	24736244	.	A	T	4	3	7	0	0	7	0	0
15	24736362	.	G	C	0	3	3	0	0	3	0	0
15	24736413	.	A	G	8	2	10	0	0	10	0	0
15	24736446	.	C	A	3	6	9	0	0	9	0	0
15	24736525	.	A	G	4	4	8	0	0	8	0	0
15	24737745	.	A	G	9	6	15	0	1	16	0	0
15	24742930	.	G	A	1	9	10	0	20	30	0	0
15	24743843	.	G	A	9	5	14	0	0	14	0	0
15	24744691	.	G	C	10	19	29	0	0	29	0	0
15	24744724	.	A	T	11	12	23	0	0	23	0	0
15	24749895	.	G	A	1	25	26	0	22	48	0	0
15	24751322	.	C	T	12	7	19	0	0	19	0	0
15	24754524	.	G	A	17	17	34	0	0	34	0	0
15	24758722	.	C	T	1	1	2	0	1	3	0	0
15	24783925	.	A	G	2	0	2	0	2	4	0	0
15	24791614	.	C	T	3	2	5	0	0	5	0	0
15	24791630	.	G	T	0	2	2	0	5	7	0	0
15	24791806	.	G	C	1	4	5	0	2	7	0	0
15	24791911	.	G	C	0	2	2	0	0	2	0	0
15	24791950	.	A	G	2	2	4	0	0	4	0	0
15	24792183	.	G	A	7	3	10	0	0	10	0	0
15	24792604	.	T	C	2	6	8	0	0	8	0	0
15	24793432	.	A	G	3	3	6	0	0	6	0	0
15	24794104	.	C	T	6	3	9	0	0	9	0	0
15	24794441	.	T	A	3	3	6	0	0	6	0	0
15	24798529	.	G	A	1	1	2	0	0	2	0	0
15	24806288	.	G	A	3	0	3	0	0	3	0	0
15	24837105	.	G	A	0	9	9	0	7	16	0	0
15	24837402	.	C	T	7	6	13	0	0	13	0	0
15	24837474	.	A	G	2	6	8	0	1	9	0	0
15	24845205	.	G	A	24	12	36	0	0	36	0	0
15	24845460	.	C	T	1	7	8	0	5	13	0	0
15	24845500	.	G	T	11	5	16	0	0	16	0	0
15	24846070	.	G	A	4	7	11	0	1	12	0	0
15	24846186	.	T	C	6	7	13	0	0	13	0	0
15	24846311	.	T	A	11	9	20	0	1	21	0	0
15	24846594	.	T	C	9	0	9	0	8	17	0	0
15	24846735	.	A	T	0	1	1	0	0	1	0	0
15	24869405	.	T	C	8	0	8	0	9	17	0	0
15	24869684	.	G	A	6	4	10	0	0	10	0	0
15	24946809	.	C	G	1	3	4	0	0	4	0	0
15	24946864	.	A	G	3	2	5	0	0	5	0	0
15	24947006	.	A	C	1	2	3	0	0	3	0	0
15	24948965	.	T	C	3	0	3	0	2	5	0	0
15	24959877	.	G	T	2	5	7	0	0	7	0	0
15	25082562	.	C	T	1	3	4	0	0	4	0	0
15	25096386	.	G	T	5	7	12	0	2	14	0	0
15	25096677	.	T	C	5	7	12	0	0	12	0	0
15	25097179	.	T	A	3	8	11	0	0	11	0	0
15	25097582	.	C	T	6	6	12	0	0	12	0	0
15	25099117	.	T	C	1	0	1	0	7	8	0	0
15	25099120	.	A	G	3	5	8	0	0	8	0	0
15	25099206	.	C	T	3	8	11	0	0	11	0	0
15	25099258	.	G	A	2	4	6	0	0	6	0	0
15	25099269	.	C	G	5	2	7	0	0	7	0	0
15	25099305	.	C	G	0	5	5	0	2	7	0	0
15	25099334	.	T	C	7	1	8	0	1	9	0	0
15	25101042	.	C	T	6	4	10	0	0	10	0	0
15	25101260	.	T	C	6	2	8	0	0	8	0	0
15	25101267	.	A	G	6	3	9	0	0	9	0	0
15	25101302	.	G	A	2	9	11	0	1	12	0	0
15	25101538	.	G	A	10	9	19	0	0	19	0	0
15	25101619	.	A	G	9	11	20	0	0	20	0	0
15	25101740	.	C	A	6	9	15	0	2	17	0	0
15	25101990	.	A	G	13	21	34	0	1	35	0	0
15	25121504	.	T	G	1	0	1	0	0	1	0	0
15	25121522	.	A	G	1	2	3	0	0	3	0	0
15	25127854	.	A	G	7	3	10	0	0	10	0	0
15	25152258	.	A	G	0	1	1	0	0	1	0	0
15	25152294	.	A	C	1	0	1	0	0	1	0	0
15	25153250	.	C	A	1	10	11	0	0	11	0	0
15	25173015	.	C	T	0	4	4	0	3	7	0	0
15	25173157	.	A	G	2	6	8	0	1	9	0	0
15	25173188	.	A	T	5	2	7	0	1	8	0	0
15	25173494	.	A	C	7	11	18	0	0	18	0	0
15	25173759	.	T	C	8	10	18	0	0	18	0	0
15	25173898	.	G	A	0	2	2	0	1	3	0	0
15	25173920	.	G	A	0	3	3	0	0	3	0	0
15	25174048	.	C	A	0	3	3	0	5	8	0	0
15	25174634	.	G	A	5	4	9	0	1	10	0	0
15	25175476	.	C	G	1	3	4	0	0	4	0	0
15	25175621	.	A	G	2	2	4	0	2	6	0	0
15	25175811	.	A	C	4	3	7	0	0	7	0	0
15	25176075	.	C	T	4	7	11	0	1	12	0	0
15	25176191	.	G	C	1	0	1	0	5	6	0	0
15	25176527	.	C	T	1	4	5	0	10	15	0	0
15	25214384	.	A	G	10	6	16	0	2	18	0	0
15	25239148	.	T	C	1	0	1	0	0	1	0	0
15	25273187	.	C	T	12	15	27	0	0	27	0	0
15	25274918	.	T	G	14	15	29	0	1	30	0	0
15	25278986	.	A	G	14	19	33	0	0	33	0	0
15	25281387	.	G	A	5	3	8	0	0	8	0	0
15	25283846	.	A	C	6	1	7	0	7	14	0	0
15	25283963	.	A	G	5	9	14	0	0	14	0	0
15	25304653	.	T	G	2	2	4	0	13	17	0	0
15	25304678	.	C	A	17	11	28	0	0	28	0	0
15	25321973	.	G	A	7	13	20	0	0	20	0	0
15	25321982	.	A	C	12	5	17	0	1	18	0	0
15	25322410	.	C	A	0	8	8	0	4	12	0	0
15	25322607	.	T	G	19	14	33	0	1	34	0	0
15	25322783	.	G	A	12	6	18	0	1	19	0	0
15	25322853	.	C	T	6	8	14	0	2	16	0	0
15	25323064	.	G	C	8	8	16	0	0	16	0	0
15	25333922	.	C	T	0	3	3	0	1	4	0	0
15	25345523	.	C	T	2	0	2	0	0	2	0	0
15	25346772	.	G	A	1	2	3	0	0	3	0	0
15	25346775	.	G	A	1	2	3	0	0	3	0	0
15	25349844	.	C	T	6	4	10	0	0	10	0	0
15	25352011	.	C	T	1	4	5	0	0	5	0	0
15	25352062	.	C	A	6	2	8	0	0	8	0	0
15	25352113	.	G	A	6	3	9	0	0	9	0	0
15	25353263	.	C	T	0	3	3	0	1	4	0	0
15	25357191	.	A	G	4	4	8	0	1	9	0	0
15	25367229	.	G	A	3	4	7	0	0	7	0	0
15	25375950	.	C	A	5	3	8	0	1	9	0	0
15	25376029	.	T	C	2	4	6	0	0	6	0	0
15	25376190	.	T	C	3	5	8	0	0	8	0	0
15	25376212	.	T	G	5	6	11	0	0	11	0	0
15	25376332	.	A	T	4	7	11	0	1	12	0	0
15	25376506	.	G	A	2	3	5	0	0	5	0	0
15	25376673	.	G	C	2	3	5	0	1	6	0	0
15	25376674	.	C	T	0	3	3	0	3	6	0	0
15	25376842	.	A	G	4	2	6	0	0	6	0	0
15	25377137	.	C	T	1	9	10	0	4	14	0	0
15	25377155	.	C	T	0	6	6	0	7	13	0	0
15	25377218	.	C	A	7	6	13	0	0	13	0	0
15	25388120	.	C	T	1	5	6	0	0	6	0	0
15	25398216	.	G	T	1	3	4	0	0	4	0	0
15	25398276	.	T	G	2	3	5	0	0	5	0	0
15	25398406	.	A	C	4	7	11	0	0	11	0	0
15	25398665	.	C	A	2	2	4	0	0	4	0	0
15	25400018	.	A	G	1	4	5	0	0	5	0	0
15	25400120	.	T	C	4	3	7	0	1	8	0	0
15	25485155	.	A	G	5	0	5	0	5	10	0	0
15	25485278	.	A	G	0	7	7	0	0	7	0	0
15	25485802	.	A	G	4	2	6	0	0	6	0	0
15	25498515	.	G	T	0	0	0	0	2	2	0	0
15	25498645	.	G	C	0	4	4	0	6	10	0	0
15	25498718	.	C	A	4	8	12	0	1	13	0	0
15	25498946	.	C	T	3	3	6	0	0	6	0	0
15	25499171	.	A	G	2	2	4	0	0	4	0	0
15	25504064	.	A	G	2	3	5	0	0	5	0	0
15	25504397	.	A	C	6	0	6	0	2	8	0	0
15	25504399	.	T	A	5	2	7	0	1	8	0	0
15	25507942	.	A	T	3	3	6	0	0	6	0	0
15	25508852	.	T	G	0	1	1	0	0	1	0	0
15	25509414	.	C	A	0	4	4	0	3	7	0	0
15	25509498	.	G	A	2	2	4	0	0	4	0	0
15	25509500	.	C	T	0	2	2	0	2	4	0	0
15	25510372	.	G	T	2	8	10	0	0	10	0	0
15	25515702	.	G	A	1	1	2	0	0	2	0	0
15	25517116	.	C	T	2	1	3	0	0	3	0	0
15	25531955	.	G	A	1	0	1	0	0	1	0	0
15	25531957	.	A	G	1	0	1	0	0	1	0	0
15	25533361	.	T	A	4	2	6	0	0	6	0	0
15	25533363	.	T	C	3	2	5	0	1	6	0	0
15	25534293	.	T	G	2	3	5	0	2	7	0	0
15	25537641	.	C	A	0	3	3	0	0	3	0	0
15	25538178	.	A	G	6	3	9	0	0	9	0	0
15	25538381	.	T	C	6	5	11	0	0	11	0	0
15	25538793	.	G	A	0	1	1	0	8	9	0	0
15	25578127	.	T	A	2	4	6	0	0	6	0	0
15	25588805	.	A	G	10	8	18	0	1	19	0	0
15	25588836	.	A	C	18	11	29	0	1	30	0	0
15	25588840	.	T	C	18	1	19	0	13	32	0	0
15	25589119	.	G	T	6	8	14	0	0	15	1	0
15	25589197	.	T	A	20	10	30	0	2	32	0	0
15	25589280	.	G	T	17	12	29	0	1	30	0	0
15	25589321	.	A	G	14	7	21	0	1	22	0	0
15	25589438	.	C	G	12	16	28	0	1	29	0	0
15	25589582	.	G	C	16	11	27	0	1	28	0	0
15	25589624	.	C	T	12	8	20	0	1	21	0	0
15	25589640	.	T	C	13	6	19	0	1	20	0	0
15	25589708	.	A	G	9	18	27	0	0	27	0	0
15	25589812	.	A	T	7	7	14	0	2	16	0	0
15	25589838	.	A	G	10	5	15	0	0	15	0	0
15	25589979	.	T	A	5	5	10	0	0	10	0	0
15	25589983	.	C	T	5	3	8	0	0	8	0	0
15	25590022	.	A	G	7	5	12	0	0	12	0	0
15	25590129	.	A	G	10	14	24	0	3	27	0	0
15	25590155	.	T	C	14	14	28	0	0	28	0	0
15	25590235	.	A	G	4	2	6	0	2	8	0	0
15	25590240	.	A	G	5	3	8	0	1	9	0	0
15	25590297	.	A	G	6	5	11	0	0	11	0	0
15	25590394	.	T	A	9	6	15	0	0	15	0	0
15	25590474	.	G	A	7	7	14	0	1	15	0	0
15	25590585	.	G	T	3	8	11	0	0	11	0	0
15	25590820	.	A	G	10	6	16	0	0	16	0	0
15	25591541	.	A	T	15	11	26	0	0	26	0	0
15	25591553	.	A	C	12	10	22	0	1	23	0	0
15	25591807	.	C	G	8	12	20	0	0	20	0	0
15	25591820	.	A	T	6	10	16	0	0	16	0	0
15	25591846	.	A	G	5	7	12	0	0	12	0	0
15	25591938	.	C	T	5	2	7	0	0	7	0	0
15	25592223	.	A	G	2	2	4	0	0	4	0	0
15	25592606	.	T	A	4	5	9	0	0	9	0	0
15	25592853	.	C	T	0	2	2	0	4	6	0	0
15	25593057	.	T	C	6	3	9	0	0	9	0	0
15	25593067	.	A	G	7	3	10	0	0	10	0	0
15	25593139	.	C	T	0	2	2	0	5	7	0	0
15	25593187	.	T	G	2	3	5	0	0	5	0	0
15	25594091	.	A	G	4	5	9	0	0	9	0	0
15	25594214	.	A	C	5	7	12	0	0	12	0	0
15	25594345	.	C	T	0	5	5	0	2	7	0	0
15	25594511	.	G	C	2	0	2	0	5	7	0	0
15	25594810	.	A	C	2	1	3	0	0	3	0	0
15	25595049	.	G	T	3	3	6	0	0	6	0	0
15	25595187	.	T	C	4	4	8	0	1	9	0	0
15	25598873	.	T	A	1	1	2	0	0	2	0	0
15	25598963	.	G	A	10	6	16	0	1	17	0	0
15	25599071	.	C	T	0	1	1	0	0	1	0	0
15	25602846	.	G	A	0	1	1	0	0	1	0	0
15	25602915	.	A	G	5	8	13	0	0	13	0	0
15	25603017	.	G	A	2	4	6	0	0	6	0	0
15	25605041	.	A	G	10	5	15	0	0	15	0	0
15	25608056	.	A	G	0	1	1	0	0	1	0	0
15	25608288	.	A	G	1	0	1	0	0	1	0	0
15	25628766	.	T	C	3	5	8	0	0	8	0	0
15	25628860	.	G	C	3	0	3	0	0	3	0	0
15	25628863	.	A	G	3	0	3	0	0	3	0	0
15	25635424	.	C	T	6	5	11	0	0	11	0	0
15	25638600	.	G	A	2	2	4	0	1	5	0	0
15	25640533	.	T	C	1	1	2	0	1	3	0	0
15	25640540	.	A	G	1	1	2	0	2	4	0	0
15	25640891	.	C	T	3	4	7	0	0	7	0	0
15	25640892	.	T	G	3	4	7	0	0	7	0	0
15	25649944	.	G	A	2	3	5	0	0	5	0	0
15	25649959	.	G	A	1	3	4	0	1	5	0	0
15	25650100	.	T	G	1	2	3	0	1	4	0	0
15	25656103	.	C	T	8	4	12	0	0	12	0	0
15	25656175	.	A	G	8	6	14	0	0	14	0	0
15	25910573	.	A	G	1	2	3	0	1	4	0	0
15	25910696	.	G	A	3	4	7	0	0	7	0	0
15	25971207	.	C	T	1	1	2	0	0	2	0	0
15	25971213	.	C	T	1	1	2	0	0	2	0	0
15	26399801	.	T	C	3	7	10	0	0	10	0	0
15	26400117	.	C	T	0	1	1	0	0	1	0	0
15	26400297	.	G	C	8	4	12	0	0	12	0	0
15	26400300	.	A	C	7	4	11	0	2	13	0	0
15	26400766	.	A	G	8	6	14	0	1	15	0	0
15	26400819	.	A	G	5	13	18	0	2	20	0	0
15	26400836	.	G	A	5	9	14	0	1	15	0	0
15	26400876	.	G	A	8	5	13	0	2	15	0	0
15	26400900	.	C	T	7	8	15	0	1	16	0	0
15	26400924	.	A	T	6	10	16	0	0	16	0	0
15	26401101	.	A	G	8	10	18	0	0	18	0	0
15	26401194	.	T	G	4	4	8	0	0	8	0	0
15	26401200	.	C	T	3	3	6	0	1	7	0	0
15	26401259	.	A	C	5	1	6	0	0	6	0	0
15	26401547	.	T	G	3	4	7	0	0	7	0	0
15	26401623	.	A	T	8	8	16	0	0	16	0	0
15	26401779	.	A	G	8	11	19	0	1	20	0	0
15	26402167	.	G	A	10	8	18	0	2	20	0	0
15	26498455	.	A	T	5	8	13	0	0	13	0	0
15	26498615	.	C	T	4	13	17	0	0	17	0	0
15	26498621	.	C	A	4	13	17	0	2	19	0	0
15	26498716	.	A	G	17	8	25	0	0	25	0	0
15	26498749	.	A	T	16	13	29	0	4	33	0	0
15	26498820	.	T	G	6	16	22	0	0	22	0	0
15	26505495	.	C	A	5	4	9	0	0	9	0	0
15	26515021	.	C	T	0	6	6	0	3	9	0	0
15	26534203	.	G	A	2	1	3	0	0	4	1	0
15	26538874	.	A	G	2	5	7	0	0	7	0	0
15	26538885	.	G	A	3	6	9	0	0	9	0	0
15	26553093	.	A	T	5	7	12	0	0	12	0	0
15	26553095	.	T	C	4	7	11	0	1	12	0	0
15	26554162	.	A	G	1	3	4	0	0	4	0	0
15	26554686	.	G	A	5	5	10	0	0	10	0	0
15	26554939	.	T	C	4	0	4	0	7	11	0	0
15	26561407	.	C	G	1	5	6	0	1	7	0	0
15	26561468	.	C	T	4	5	9	0	2	11	0	0
15	26561502	.	T	C	3	3	6	0	0	6	0	0
15	26561526	.	C	T	1	5	6	0	2	8	0	0
15	26561610	.	A	T	2	3	5	0	0	5	0	0
15	26563456	.	C	T	0	2	2	0	5	7	0	0
15	26563537	.	T	C	2	0	2	0	4	6	0	0
15	26563751	.	A	G	1	2	3	0	0	3	0	0
15	26563775	.	A	C	1	2	3	0	0	3	0	0
15	26563799	.	A	G	1	1	2	0	0	2	0	0
15	26564209	.	G	A	4	3	7	0	0	7	0	0
15	26564267	.	G	A	2	4	6	0	0	6	0	0
15	26566114	.	G	A	3	3	6	0	0	6	0	0
15	26616179	.	T	G	3	3	6	0	0	6	0	0
15	26616225	.	C	T	2	3	5	0	1	6	0	0
15	26678917	.	C	A	0	3	3	0	7	10	0	0
15	26678932	.	T	A	5	3	8	0	1	9	0	0
15	26679070	.	T	A	1	4	5	0	0	5	0	0
15	26679908	.	C	T	0	7	7	0	6	13	0	0
15	26683504	.	A	G	0	2	2	0	0	2	0	0
15	26683758	.	G	A	6	9	15	0	1	16	0	0
15	26683764	.	G	A	9	8	17	0	0	17	0	0
15	26686828	.	A	T	2	1	3	0	0	9	6	0
15	26707518	.	G	A	2	4	6	0	0	6	0	0
15	26707569	.	G	T	0	1	1	0	0	1	0	0
15	26710306	.	G	A	6	7	13	0	1	14	0	0
15	26720581	.	C	T	0	2	2	0	5	7	0	0
15	26729480	.	G	A	2	3	5	0	0	5	0	0
15	26843956	.	A	G	0	1	1	0	0	1	0	0
15	26844074	.	T	G	6	9	15	0	1	16	0	0
15	26844077	.	A	T	7	8	15	0	2	17	0	0
15	26849102	.	T	A	2	2	4	0	0	4	0	0
15	26849637	.	A	G	2	2	4	0	0	4	0	0
15	26855004	.	G	C	1	3	4	0	0	4	0	0
15	26855019	.	A	G	2	6	8	0	0	8	0	0
15	26880427	.	G	T	0	2	2	0	0	2	0	0
15	26882942	.	T	G	1	2	3	0	0	3	0	0
15	26885449	.	C	T	0	1	1	0	0	1	0	0
15	26904430	.	A	G	6	4	10	0	0	10	0	0
15	26904838	.	A	G	3	4	7	0	0	7	0	0
15	26904989	.	C	A	9	2	11	0	0	11	0	0
15	26905002	.	C	T	5	3	8	0	0	8	0	0
15	26905088	.	A	G	1	5	6	0	0	6	0	0
15	26905118	.	T	G	1	6	7	0	0	7	0	0
15	26915384	.	T	A	11	7	18	0	1	19	0	0
15	26915531	.	A	G	12	9	21	0	1	22	0	0
15	26915568	.	G	A	10	10	20	0	0	20	0	0
15	26915633	.	C	T	2	6	8	0	0	8	0	0
15	26915651	.	T	C	2	3	5	0	0	5	0	0
15	26919255	.	T	C	0	1	1	0	0	1	0	0
15	26924056	.	T	C	6	7	13	0	0	13	0	0
15	26924080	.	C	G	1	4	5	0	3	8	0	0
15	26926474	.	G	A	3	3	6	0	0	6	0	0
15	26935032	.	A	T	10	3	13	0	0	13	0	0
15	26935696	.	G	A	2	0	2	0	0	2	0	0
15	26939031	.	C	A	7	5	12	0	0	12	0	0
15	26939224	.	G	T	4	4	8	0	0	8	0	0
15	26939233	.	A	C	5	4	9	0	0	9	0	0
15	26939279	.	G	A	0	2	2	0	5	7	0	0
15	26941892	.	G	A	0	0	0	0	2	2	0	0
15	26993973	.	C	A	3	3	6	0	0	6	0	0
15	27071063	.	A	G	1	0	1	0	4	5	0	0
15	27071096	.	C	G	1	0	1	0	0	1	0	0
15	27071099	.	A	G	1	0	1	0	0	1	0	0
15	27071735	.	G	A	1	1	2	0	0	2	0	0
15	27071792	.	T	G	8	6	14	0	0	14	0	0
15	27071849	.	G	A	3	5	8	0	1	9	0	0
15	27087813	.	C	T	3	6	9	0	0	9	0	0
15	27328142	.	T	G	6	0	6	0	7	13	0	0
15	27352608	.	G	A	4	5	9	0	0	9	0	0
15	27352927	.	T	C	2	2	4	0	0	4	0	0
15	27353481	.	G	A	6	4	10	0	1	11	0	0
15	27353950	.	T	C	7	4	11	0	0	11	0	0
15	27354412	.	T	A	12	18	30	0	0	30	0	0
15	27371021	.	T	A	2	2	4	0	0	4	0	0
15	27703845	.	A	G	11	9	20	0	4	24	0	0
15	27704220	.	C	A	0	13	13	0	11	24	0	0
15	27710392	.	A	G	5	4	9	0	0	9	0	0
15	27710396	.	C	T	4	4	8	0	0	8	0	0
15	28079177	.	C	T	0	2	2	0	3	5	0	0
15	28079249	.	A	T	2	4	6	0	0	6	0	0
15	28079317	.	T	A	4	10	14	0	0	14	0	0
15	28079438	.	T	C	1	3	4	0	2	6	0	0
15	28082567	.	A	G	2	2	4	0	0	4	0	0
15	28085382	.	T	C	4	8	12	0	1	13	0	0
15	28106804	.	A	G	8	5	13	0	0	13	0	0
15	28124642	.	C	T	0	4	4	0	0	4	0	0
15	28124913	.	T	C	0	6	6	0	0	6	0	0
15	28125186	.	A	G	2	5	7	0	1	8	0	0
15	28175982	.	T	G	1	4	5	0	0	5	0	0
15	28177990	.	C	A	0	2	2	0	0	2	0	0
15	28178011	.	A	T	1	2	3	0	0	3	0	0
15	28178147	.	C	T	3	2	5	0	0	5	0	0
15	28178188	.	C	T	2	4	6	0	0	6	0	0
15	28178197	.	C	T	2	5	7	0	0	7	0	0
15	28178256	.	A	G	2	3	5	0	0	5	0	0
15	28178263	.	C	T	1	2	3	0	0	3	0	0
15	28182716	.	C	A	1	0	1	0	0	1	0	0
15	28182837	.	A	G	1	1	2	0	0	2	0	0
15	28189029	.	T	A	7	3	10	0	0	10	0	0
15	28189046	.	T	G	7	4	11	0	0	11	0	0
15	28189589	.	T	C	3	0	3	0	7	10	0	0
15	28189591	.	T	C	3	7	10	0	0	10	0	0
15	28189945	.	T	G	0	2	2	0	2	4	0	0
15	28192706	.	A	G	10	6	16	0	0	16	0	0
15	28194669	.	T	C	1	4	5	0	3	8	0	0
15	28194708	.	A	G	5	7	12	0	1	13	0	0
15	28199431	.	A	G	6	5	11	0	1	12	0	0
15	28199437	.	A	T	5	5	10	0	0	10	0	0
15	28199574	.	T	C	2	6	8	0	0	8	0	0
15	28199707	.	G	A	4	2	6	0	1	7	0	0
15	28199860	.	T	C	3	0	3	0	5	8	0	0
15	28199861	.	T	G	3	5	8	0	0	8	0	0
15	28199905	.	T	G	1	2	3	0	1	4	0	0
15	28230658	.	A	G	0	1	1	0	0	1	0	0
15	28249301	.	G	T	5	3	8	0	1	9	0	0
15	28251094	.	T	A	1	0	1	0	0	1	0	0
15	28252597	.	T	C	15	9	24	0	1	25	0	0
15	28252599	.	A	G	16	9	25	0	0	25	0	0
15	28253171	.	C	A	0	12	12	0	7	19	0	0
15	28253522	.	C	T	8	5	13	0	0	13	0	0
15	28253773	.	C	T	10	7	17	0	0	17	0	0
15	28254184	.	T	C	1	1	2	0	0	2	0	0
15	28254202	.	G	T	2	4	6	0	0	6	0	0
15	28256036	.	A	G	1	0	1	0	0	1	0	0
15	28257277	.	A	G	1	0	1	0	0	1	0	0
15	28259321	.	T	C	1	1	2	0	0	2	0	0
15	28259773	.	C	T	0	6	6	0	4	10	0	0
15	28259971	.	G	A	2	1	3	0	0	3	0	0
15	28260007	.	C	T	1	1	2	0	0	2	0	0
15	28260031	.	A	G	0	1	1	0	0	1	0	0
15	28260234	.	A	G	1	1	2	0	0	2	0	0
15	28260381	.	A	T	4	3	7	0	1	8	0	0
15	28260522	.	T	A	0	3	3	0	0	3	0	0
15	28343667	.	C	T	3	1	4	0	0	4	0	0
15	28349816	.	C	T	2	1	3	0	0	3	0	0
15	28350079	.	C	G	6	2	8	0	1	9	0	0
15	28350095	.	C	T	6	4	10	0	0	10	0	0
15	28350999	.	T	G	9	3	12	0	1	13	0	0
15	28351020	.	A	G	10	5	15	0	0	15	0	0
15	28351089	.	C	G	8	4	12	0	1	13	0	0
15	28351132	.	G	A	8	4	12	0	0	12	0	0
15	28351591	.	G	T	1	1	2	0	2	4	0	0
15	28352138	.	T	C	15	6	21	0	0	21	0	0
15	28352168	.	C	A	15	6	21	0	0	21	0	0
15	28368884	.	G	A	2	6	8	0	0	8	0	0
15	28370974	.	T	C	1	3	4	0	0	4	0	0
15	28392769	.	G	T	6	2	8	0	0	8	0	0
15	28403365	.	C	T	2	9	11	0	0	11	0	0
15	28432697	.	C	A	12	7	19	0	1	20	0	0
15	28432739	.	C	T	7	9	16	0	1	17	0	0
15	28432741	.	A	T	8	9	17	0	0	17	0	0
15	28432871	.	T	C	5	7	12	0	0	12	0	0
15	28432993	.	C	T	0	11	11	0	16	27	0	0
15	28433073	.	A	G	9	6	15	0	0	15	0	0
15	28433102	.	C	A	9	6	15	0	0	15	0	0
15	28433126	.	G	T	7	2	9	0	1	10	0	0
15	28433161	.	T	C	5	3	8	0	2	10	0	0
15	28433282	.	G	A	3	19	22	0	1	23	0	0
15	28433414	.	T	A	6	4	10	0	0	10	0	0
15	28433947	.	A	G	8	13	21	0	3	24	0	0
15	28437178	.	G	T	3	5	8	0	0	8	0	0
15	28439441	.	G	A	1	0	1	0	0	1	0	0
15	28446791	.	A	T	8	2	10	0	0	10	0	0
15	28452844	.	A	G	0	2	2	0	0	2	0	0
15	28453081	.	C	A	0	3	3	0	5	8	0	0
15	28453102	.	C	T	2	1	3	0	0	3	0	0
15	28463609	.	C	T	0	2	2	0	3	5	0	0
15	28480293	.	A	G	2	4	6	0	1	7	0	0
15	28480345	.	A	T	3	3	6	0	0	6	0	0
15	28483333	.	A	C	1	3	4	0	0	4	0	0
15	28509840	.	G	A	6	3	9	0	1	10	0	0
15	28515428	.	C	A	3	2	5	0	2	7	0	0
15	28520856	.	A	G	3	0	3	0	2	5	0	0
15	28526386	.	A	T	4	3	7	0	0	7	0	0
15	28537810	.	T	A	5	3	8	0	0	8	0	0
15	28537852	.	T	C	8	5	13	0	0	13	0	0
15	28537872	.	G	A	1	5	6	0	4	10	0	0
15	28537906	.	A	C	5	6	11	0	0	11	0	0
15	28537965	.	T	A	4	5	9	0	0	9	0	0
15	28538012	.	G	A	0	3	3	0	7	10	0	0
15	28538097	.	A	G	5	0	5	0	4	9	0	0
15	28538173	.	G	A	4	6	10	0	0	10	0	0
15	28538199	.	T	C	2	6	8	0	2	10	0	0
15	28538239	.	G	T	5	4	9	0	0	9	0	0
15	28538405	.	T	C	5	8	13	0	0	13	0	0
15	28538602	.	A	T	4	3	7	0	0	7	0	0
15	28538605	.	G	A	0	2	2	0	4	6	0	0
15	28538667	.	A	G	3	2	5	0	0	5	0	0
15	28538761	.	A	G	7	8	15	0	1	16	0	0
15	28538765	.	C	T	8	9	17	0	1	18	0	0
15	28539112	.	C	T	5	6	11	0	0	11	0	0
15	28539160	.	T	C	2	4	6	0	0	6	0	0
15	28539232	.	C	T	6	3	9	0	1	10	0	0
15	28539381	.	A	T	2	2	4	0	0	4	0	0
15	28539383	.	A	T	2	2	4	0	0	4	0	0
15	28539523	.	T	C	7	5	12	0	0	12	0	0
15	28539556	.	G	A	7	5	12	0	1	13	0	0
15	28539649	.	T	A	5	3	8	0	1	9	0	0
15	28549003	.	G	A	5	8	13	0	0	13	0	0
15	28549347	.	G	T	4	4	8	0	0	8	0	0
15	28549348	.	T	A	4	4	8	0	0	8	0	0
15	28549392	.	A	C	5	5	10	0	0	10	0	0
15	28550088	.	A	G	4	4	8	0	0	8	0	0
15	28551281	.	G	A	2	2	4	0	0	4	0	0
15	28551285	.	G	A	2	2	4	0	0	4	0	0
15	28609097	.	G	A	1	2	3	0	0	3	0	0
15	28615665	.	A	G	2	1	3	0	0	3	0	0
15	28634719	.	G	A	19	7	26	0	0	26	0	0
15	28646687	.	G	A	1	1	2	0	0	2	0	0
15	28646696	.	T	C	2	0	2	0	1	3	0	0
15	28672508	.	T	G	0	2	2	0	1	3	0	0
15	28677558	.	T	A	1	0	1	0	0	1	0	0
15	28686433	.	A	T	19	17	36	0	2	38	0	0
15	28758907	.	G	C	0	9	9	0	15	24	0	0
15	28758988	.	C	T	15	15	30	0	0	30	0	0
15	28759171	.	T	G	22	2	24	0	15	39	0	0
15	28759246	.	G	C	0	13	13	0	19	32	0	0
15	28759558	.	C	G	13	0	13	0	8	21	0	0
15	28759639	.	G	A	6	6	12	0	0	12	0	0
15	28760090	.	T	C	20	16	36	0	3	39	0	0
15	28760675	.	A	T	13	13	26	0	1	27	0	0
15	28761031	.	T	C	8	12	20	0	0	20	0	0
15	28761173	.	T	C	17	14	31	0	1	32	0	0
15	28761284	.	T	A	14	7	21	0	1	22	0	0
15	28762440	.	C	T	20	15	35	0	1	36	0	0
15	28763124	.	T	C	14	21	35	0	2	37	0	0
15	28763134	.	T	C	12	21	33	0	0	33	0	0
15	28763677	.	C	A	16	16	32	0	3	35	0	0
15	28763770	.	T	C	17	24	41	0	2	43	0	0
15	28763927	.	G	A	0	22	22	0	16	38	0	0
15	28763986	.	G	A	0	26	26	0	17	43	0	0
15	28764206	.	G	T	0	9	9	0	26	35	0	0
15	28764252	.	A	G	18	0	18	0	29	47	0	0
15	28766069	.	A	G	2	2	4	0	0	4	0	0
15	28787191	.	T	A	1	2	3	0	0	3	0	0
15	28787195	.	T	C	1	2	3	0	0	3	0	0
15	28802136	.	A	T	3	5	8	0	0	8	0	0
15	28881717	.	G	A	5	4	9	0	0	9	0	0
15	28882675	.	T	A	9	8	17	0	0	17	0	0
15	28882687	.	A	G	7	6	13	0	0	13	0	0
15	28886882	.	A	T	2	0	2	0	1	3	0	0
15	28887280	.	G	T	1	5	6	0	0	6	0	0
15	28887667	.	A	G	4	5	9	0	0	9	0	0
15	28972971	.	A	G	2	2	4	0	1	5	0	0
15	29000989	.	C	T	12	12	24	0	1	25	0	0
15	29001556	.	C	T	13	17	30	0	0	30	0	0
15	29001583	.	T	C	8	15	23	0	1	24	0	0
15	29005346	.	T	A	7	23	30	0	1	31	0	0
15	29005363	.	A	C	5	11	16	0	1	17	0	0
15	29005564	.	T	G	9	9	18	0	1	19	0	0
15	29005600	.	A	C	12	11	23	0	2	25	0	0
15	29005862	.	T	A	19	10	29	0	1	30	0	0
15	29005869	.	A	T	18	11	29	0	2	31	0	0
15	29005935	.	C	T	19	18	37	0	0	37	0	0
15	29005984	.	C	T	17	13	30	0	1	31	0	0
15	29005996	.	C	A	16	12	28	0	0	28	0	0
15	29006097	.	C	T	23	9	32	0	0	32	0	0
15	29006142	.	G	A	0	12	12	0	28	40	0	0
15	29089143	.	T	A	22	24	46	0	1	47	0	0
15	29089279	.	C	A	26	10	36	0	1	37	0	0
15	29089317	.	A	G	22	16	38	0	1	39	0	0
15	29089392	.	A	G	15	20	35	0	0	35	0	0
15	29089524	.	T	C	19	24	43	0	0	43	0	0
15	29089788	.	G	A	23	20	43	0	0	43	0	0
15	29089827	.	G	T	2	29	31	0	13	44	0	0
15	29089870	.	C	T	16	37	53	0	1	54	0	0
15	29090181	.	A	G	19	28	47	0	5	52	0	0
15	29091565	.	G	A	24	19	43	0	0	44	1	0
15	29092592	.	G	A	2	2	4	0	0	4	0	0
15	29092871	.	C	T	4	3	7	0	0	7	0	0
15	29093073	.	C	A	2	7	9	0	0	9	0	0
15	29097468	.	T	C	0	0	0	0	1	1	0	0
15	29097640	.	A	G	8	6	14	0	0	14	0	0
15	29100574	.	T	G	3	7	10	0	0	10	0	0
15	29100623	.	G	A	2	6	8	0	0	8	0	0
15	29100934	.	C	G	0	1	1	0	0	1	0	0
15	29104050	.	G	A	3	2	5	0	0	5	0	0
15	29108812	.	T	C	4	9	13	0	2	15	0	0
15	29108872	.	A	G	0	5	5	0	0	5	0	0
15	29111902	.	A	C	2	0	2	0	2	4	0	0
15	29111969	.	C	T	2	1	3	0	0	3	0	0
15	29111970	.	T	C	2	1	3	0	0	3	0	0
15	29112164	.	C	T	2	0	2	0	0	2	0	0
15	29114289	.	C	A	2	8	10	0	0	10	0	0
15	29114337	.	C	G	0	4	4	0	6	10	0	0
15	29114361	.	A	T	8	3	11	0	0	11	0	0
15	29116177	.	T	C	2	10	12	0	0	12	0	0
15	29116264	.	A	G	10	15	25	0	2	27	0	0
15	29119813	.	A	C	4	3	7	0	1	8	0	0
15	29119829	.	A	C	3	4	7	0	0	7	0	0
15	29122072	.	T	A	9	13	22	0	1	23	0	0
15	29123085	.	G	T	2	3	5	0	0	5	0	0
15	29136127	.	A	T	2	1	3	0	0	3	0	0
15	29152041	.	G	T	4	6	10	0	0	10	0	0
15	29297752	.	G	A	4	2	6	0	0	6	0	0
15	29311995	.	G	C	0	3	3	0	1	4	0	0
15	29312303	.	C	A	2	1	3	0	0	3	0	0
15	29312748	.	T	C	4	2	6	0	0	6	0	0
15	29312763	.	C	T	4	2	6	0	0	6	0	0
15	29316909	.	A	G	4	4	8	0	0	8	0	0
15	29343748	.	A	G	1	3	4	0	1	5	0	0
15	29343786	.	T	C	1	4	5	0	0	5	0	0
15	29343826	.	G	A	2	5	7	0	0	7	0	0
15	29343863	.	A	G	3	9	12	0	0	12	0	0
15	29344206	.	G	T	1	5	6	0	0	6	0	0
15	29344848	.	G	A	3	5	8	0	0	8	0	0
15	29344979	.	A	G	2	2	4	0	0	4	0	0
15	29353911	.	C	T	3	2	5	0	0	5	0	0
15	29383494	.	T	C	5	2	7	0	1	8	0	0
15	29384262	.	T	C	3	2	5	0	0	5	0	0
15	29454352	.	G	A	3	2	5	0	0	5	0	0
15	29456387	.	A	G	6	1	7	0	0	7	0	0
15	29456410	.	C	T	3	0	3	0	0	3	0	0
15	29459013	.	A	G	7	5	12	0	0	12	0	0
15	29459046	.	G	A	10	9	19	0	1	21	1	0
15	29465874	.	T	C	6	7	13	0	1	14	0	0
15	29467216	.	T	A	13	12	25	0	1	26	0	0
15	29467254	.	A	G	14	2	16	0	15	31	0	0
15	29467339	.	A	G	0	1	1	0	0	1	0	0
15	29469851	.	G	T	7	2	9	0	0	9	0	0
15	29481884	.	A	G	20	7	27	0	0	27	0	0
15	29481921	.	G	A	0	8	8	0	20	28	0	0
15	29482286	.	G	C	9	13	22	0	0	22	0	0
15	29482439	.	A	G	11	5	16	0	0	16	0	0
15	29483095	.	T	G	4	7	11	0	0	11	0	0
15	29483236	.	T	G	5	12	17	0	1	18	0	0
15	29483326	.	G	A	0	2	2	0	2	4	0	0
15	29483434	.	G	C	11	7	18	0	0	18	0	0
15	29483608	.	A	T	7	4	11	0	1	12	0	0
15	29483815	.	C	A	21	3	24	0	2	26	0	0
15	29483851	.	G	T	17	9	26	0	1	27	0	0
15	29549217	.	A	G	1	3	4	0	1	5	0	0
15	29549677	.	T	A	8	8	16	0	0	16	0	0
15	29549804	.	C	T	0	6	6	0	6	12	0	0
15	29555569	.	G	T	1	0	1	0	0	1	0	0
15	29555703	.	T	C	3	2	5	0	0	5	0	0
15	29555706	.	A	T	3	2	5	0	0	5	0	0
15	29555793	.	A	G	2	4	6	0	0	6	0	0
15	29556667	.	T	C	4	1	5	0	0	5	0	0
15	29709155	.	C	A	2	4	6	0	0	6	0	0
15	29709825	.	T	C	2	4	6	0	0	6	0	0
15	29710065	.	A	G	4	3	7	0	0	7	0	0
15	29710305	.	T	C	7	6	13	0	0	13	0	0
15	29710737	.	G	T	0	2	2	0	0	2	0	0
15	29712127	.	C	A	5	6	11	0	0	11	0	0
15	29712210	.	G	A	0	8	8	0	9	17	0	0
15	29712221	.	C	T	7	10	17	0	0	17	0	0
15	29712405	.	G	A	12	6	18	0	2	20	0	0
15	29712794	.	C	T	1	4	5	0	0	5	0	0
15	29772299	.	T	A	5	5	10	0	0	10	0	0
15	29773434	.	T	C	1	0	1	0	3	4	0	0
15	29889577	.	G	A	1	1	2	0	1	3	0	0
15	29889680	.	T	A	6	3	9	0	0	9	0	0
15	29889959	.	C	T	0	2	2	0	3	5	0	0
15	30127451	.	T	C	0	4	4	0	0	4	0	0
15	30130286	.	G	T	1	3	4	0	0	4	0	0
15	30130530	.	A	C	2	8	10	0	0	10	0	0
15	30130664	.	G	A	0	8	8	0	7	15	0	0
15	30131482	.	G	A	7	5	12	0	0	12	0	0
15	30131585	.	C	T	2	3	5	0	1	6	0	0
15	30131803	.	G	A	3	5	8	0	1	9	0	0
15	30134489	.	G	A	5	13	18	0	0	18	0	0
15	30134779	.	G	T	2	3	5	0	0	5	0	0
15	30135016	.	T	A	5	4	9	0	0	9	0	0
15	30135206	.	G	A	0	5	5	0	3	8	0	0
15	30135572	.	A	G	4	0	4	0	5	9	0	0
15	30135920	.	A	G	1	4	5	0	1	6	0	0
15	30136512	.	T	A	1	3	4	0	0	4	0	0
15	30136962	.	A	G	9	1	10	0	11	21	0	0
15	30137561	.	C	T	12	13	25	0	1	26	0	0
15	30158096	.	G	T	1	8	9	0	5	14	0	0
15	30159050	.	A	T	10	5	15	0	3	18	0	0
15	30252414	.	T	C	4	4	8	0	0	8	0	0
15	30265017	.	C	T	3	3	6	0	0	6	0	0
15	30301196	.	G	A	0	4	4	0	3	7	0	0
15	30301239	.	G	A	0	3	3	0	3	6	0	0
15	30301320	.	T	C	11	5	16	0	1	17	0	0
15	30301447	.	G	A	8	3	11	0	0	11	0	0
15	30301474	.	G	A	4	4	8	0	0	8	0	0
15	30311016	.	C	T	3	6	9	0	0	9	0	0
15	30311062	.	G	T	0	3	3	0	4	8	1	0
15	30311616	.	T	G	2	3	5	0	0	5	0	0
15	30350666	.	A	T	1	3	4	0	0	4	0	0
15	30354603	.	A	T	2	6	8	0	0	8	0	0
15	30424673	.	C	T	0	7	7	0	8	15	0	0
15	30425704	.	T	C	1	4	5	0	0	5	0	0
15	30425705	.	C	T	1	4	5	0	0	5	0	0
15	30425936	.	G	A	2	6	8	0	0	8	0	0
15	30426119	.	C	A	8	0	8	0	2	10	0	0
15	30838503	.	A	G	12	1	13	0	0	13	0	0
15	30838777	.	G	A	18	9	27	0	0	27	0	0
15	30838867	.	C	T	8	11	19	0	1	20	0	0
15	30839168	.	A	T	7	7	14	0	0	14	0	0
15	30852433	.	G	A	6	7	13	0	1	14	0	0
15	30852598	.	T	C	6	9	15	0	0	15	0	0
15	30853039	.	G	T	4	10	14	0	0	14	0	0
15	30853096	.	T	A	5	9	14	0	0	14	0	0
15	30861987	.	C	A	0	4	4	0	3	7	0	0
15	30862251	.	A	T	7	5	12	0	0	12	0	0
15	30862449	.	A	G	5	7	12	0	1	13	0	0
15	30862452	.	G	T	4	8	12	0	1	13	0	0
15	30862517	.	G	A	3	4	7	0	0	7	0	0
15	30862712	.	G	A	8	7	15	0	0	15	0	0
15	30862785	.	C	T	8	9	17	0	0	17	0	0
15	30862814	.	A	G	7	11	18	0	1	19	0	0
15	30862848	.	T	C	13	4	17	0	1	18	0	0
15	30862997	.	T	G	5	3	8	0	0	8	0	0
15	30863117	.	T	C	6	5	11	0	2	13	0	0
15	30863123	.	A	C	5	6	11	0	1	12	0	0
15	30863535	.	G	T	17	12	29	0	1	30	0	0
15	30863569	.	G	A	17	13	30	0	1	31	0	0
15	30863799	.	T	C	6	1	7	0	4	11	0	0
15	30863834	.	G	T	4	9	13	0	0	13	0	0
15	30863850	.	T	C	4	11	15	0	0	15	0	0
15	30864072	.	T	G	4	5	9	0	0	9	0	0
15	30864308	.	C	A	9	5	14	0	0	14	0	0
15	30864354	.	T	C	6	0	6	0	7	13	0	0
15	30874327	.	A	G	11	9	20	0	0	20	0	0
15	30874387	.	G	A	3	3	6	0	0	6	0	0
15	30883761	.	T	C	2	0	2	0	2	4	0	0
15	30889297	.	T	C	1	1	2	0	0	2	0	0
15	30891570	.	A	G	1	3	4	0	0	4	0	0
15	30894379	.	G	A	5	2	7	1	0	8	0	0
15	30900478	.	A	G	1	4	5	0	0	5	0	0
15	30902892	.	C	T	0	2	2	0	4	6	0	0
15	30904802	.	G	A	0	1	1	0	1	2	0	0
15	30906972	.	G	A	1	3	4	0	0	4	0	0
15	30907811	.	A	G	4	8	12	0	0	12	0	0
15	30907818	.	G	A	0	9	9	0	4	13	0	0
15	30907884	.	C	A	13	11	24	0	0	24	0	0
15	30907888	.	A	G	14	0	14	0	11	25	0	0
15	30909175	.	C	G	26	3	29	0	15	44	0	0
15	30909308	.	G	A	0	16	16	0	18	34	0	0
15	30909572	.	C	A	11	25	36	0	0	36	0	0
15	30909639	.	A	G	9	23	32	0	1	33	0	0
15	30909663	.	G	A	5	12	17	0	3	20	0	0
15	30909771	.	T	C	8	16	24	0	0	24	0	0
15	30909798	.	A	G	9	0	9	0	14	23	0	0
15	30909824	.	A	C	11	14	25	0	1	26	0	0
15	30909884	.	C	T	13	8	21	0	0	21	0	0
15	30910042	.	C	A	22	6	28	0	6	34	0	0
15	30917436	.	C	T	1	2	3	0	0	3	0	0
15	30917715	.	A	G	8	2	10	0	1	11	0	0
15	30917737	.	C	T	7	4	11	0	0	11	0	0
15	30917750	.	A	T	7	4	11	0	0	11	0	0
15	30919478	.	C	T	9	5	14	0	0	14	0	0
15	30919595	.	T	C	11	11	22	0	0	22	0	0
15	30919676	.	G	T	11	6	17	0	2	19	0	0
15	30919784	.	A	G	11	6	17	0	0	17	0	0
15	30919854	.	T	G	5	6	11	0	1	12	0	0
15	30920135	.	A	G	2	4	6	0	0	6	0	0
15	30920242	.	A	C	5	4	9	0	0	9	0	0
15	30920698	.	C	A	9	5	14	0	2	16	0	0
15	30924316	.	T	C	2	0	2	0	1	3	0	0
15	30955263	.	G	C	1	0	1	0	4	5	0	0
15	30958409	.	T	C	1	1	2	0	0	2	0	0
15	31041227	.	G	A	1	0	1	0	0	1	0	0
15	31075556	.	G	A	0	1	1	0	0	1	0	0
15	31099833	.	T	A	1	2	3	0	0	3	0	0
15	31162074	.	T	A	7	11	18	0	2	20	0	0
15	31162122	.	A	G	13	11	24	0	0	25	1	0
15	31162186	.	G	C	14	9	23	0	0	23	0	0
15	31162795	.	G	A	14	8	22	0	0	22	0	0
15	31162836	.	A	G	14	5	19	0	0	19	0	0
15	31163089	.	G	A	5	11	16	0	0	16	0	0
15	31163148	.	T	A	10	11	21	0	2	23	0	0
15	31163335	.	A	T	10	14	24	0	0	24	0	0
15	31163621	.	T	A	15	20	35	0	0	36	1	0
15	31166755	.	C	A	3	6	9	0	0	9	0	0
15	31166788	.	A	G	0	1	1	0	0	1	0	0
15	31173414	.	G	A	7	8	15	0	0	15	0	0
15	31177053	.	A	G	1	1	2	0	0	2	0	0
15	31177054	.	T	A	1	1	2	0	0	2	0	0
15	31177214	.	T	G	13	5	18	0	0	18	0	0
15	31205723	.	A	G	1	4	5	0	0	5	0	0
15	31206401	.	A	G	3	11	14	0	0	14	0	0
15	31213017	.	T	C	1	0	1	0	4	5	0	0
15	31213046	.	T	G	1	9	10	0	0	10	0	0
15	31213171	.	A	G	3	7	10	0	0	10	0	0
15	31213208	.	C	T	3	3	6	0	1	7	0	0
15	31244039	.	G	T	1	2	3	0	0	3	0	0
15	31244298	.	C	T	0	2	2	0	7	9	0	0
15	31244339	.	A	T	7	2	9	0	0	9	0	0
15	31244412	.	C	T	0	2	2	0	8	10	0	0
15	31250527	.	A	T	1	2	3	0	0	3	0	0
15	31486873	.	C	T	1	2	3	0	0	3	0	0
15	31513561	.	G	A	30	28	58	0	2	60	0	0
15	31513842	.	A	G	29	23	52	0	2	54	0	0
15	31513848	.	T	C	22	23	45	0	4	49	0	0
15	31513893	.	C	A	0	4	4	0	3	7	0	0
15	31514325	.	A	G	16	22	38	0	3	41	0	0
15	31564440	.	G	C	4	4	8	0	0	8	0	0
15	31564864	.	G	T	6	2	8	0	0	8	0	0
15	31564946	.	T	C	1	0	1	0	0	1	0	0
15	31568159	.	C	T	0	2	2	0	1	3	0	0
15	31571496	.	A	G	1	2	3	0	0	3	0	0
15	31574035	.	T	C	2	0	2	0	2	4	0	0
15	31580960	.	C	T	0	3	3	0	0	3	0	0
15	31588010	.	C	T	2	2	4	0	0	4	0	0
15	31674120	.	G	T	2	4	6	0	0	6	0	0
15	31694928	.	G	A	0	1	1	0	2	3	0	0
15	31700738	.	C	T	4	9	13	0	1	14	0	0
15	31706200	.	G	C	0	3	3	0	0	3	0	0
15	31732502	.	A	G	11	7	18	0	0	18	0	0
15	31828002	.	A	T	1	1	2	0	0	2	0	0
15	31852098	.	C	A	2	0	2	0	0	2	0	0
15	31855867	.	T	C	2	0	2	0	0	2	0	0
15	31862250	.	T	C	4	4	8	0	0	8	0	0
15	31862320	.	C	T	0	1	1	0	0	1	0	0
15	31864426	.	G	A	1	2	3	0	0	3	0	0
15	31870694	.	G	A	3	1	4	0	0	4	0	0
15	31877363	.	C	T	3	4	7	0	0	7	0	0
15	31881825	.	G	A	3	3	6	0	0	6	0	0
15	31881873	.	G	A	0	2	2	0	3	5	0	0
15	31881954	.	T	C	7	5	12	0	0	12	0	0
15	31882044	.	A	G	8	4	12	0	1	13	0	0
15	31882269	.	G	A	5	4	9	0	0	9	0	0
15	31882272	.	A	G	4	4	8	0	1	9	0	0
15	31882342	.	C	T	1	3	4	0	0	4	0	0
15	31884219	.	A	C	1	0	1	0	0	1	0	0
15	31889005	.	T	G	2	1	3	0	2	5	0	0
15	31889086	.	A	G	1	2	3	0	0	3	0	0
15	31889332	.	C	T	1	0	1	0	0	1	0	0
15	31890902	.	T	G	2	3	5	0	1	6	0	0
15	31893536	.	A	C	5	7	12	0	0	12	0	0
15	31893599	.	C	T	2	1	3	0	0	3	0	0
15	31895248	.	A	G	6	0	6	0	4	10	0	0
15	31905040	.	G	A	17	11	28	0	0	28	0	0
15	31905097	.	A	G	9	9	18	0	0	18	0	0
15	31909454	.	A	C	12	9	21	0	0	21	0	0
15	31909819	.	G	A	0	2	2	0	5	7	0	0
15	32186862	.	C	A	1	2	3	0	0	3	0	0
15	32193892	.	G	T	0	2	2	0	2	4	0	0
15	32193922	.	A	T	1	3	4	0	0	4	0	0
15	32194342	.	C	A	1	3	4	0	0	4	0	0
15	32194945	.	C	A	2	3	5	0	0	5	0	0
15	32195395	.	T	C	5	2	7	0	0	7	0	0
15	32195432	.	G	A	1	3	4	0	0	4	0	0
15	32195718	.	G	A	3	4	7	0	0	7	0	0
15	32195729	.	A	G	5	3	8	0	0	8	0	0
15	32197453	.	A	G	1	2	3	0	0	3	0	0
15	32197458	.	T	C	1	2	3	0	0	3	0	0
15	32249188	.	G	A	17	15	32	0	0	32	0	0
15	32259056	.	G	A	11	9	20	0	0	20	0	0
15	32261461	.	G	C	0	9	9	0	6	15	0	0
15	32261464	.	T	C	11	5	16	0	0	16	0	0
15	32265889	.	T	C	12	14	26	0	1	27	0	0
15	32266557	.	A	T	7	10	17	0	0	17	0	0
15	32266921	.	G	A	0	13	13	0	12	25	0	0
15	32267078	.	A	G	7	4	11	0	0	11	0	0
15	32349975	.	A	G	9	5	14	0	0	14	0	0
15	32350000	.	A	G	8	3	11	0	0	11	0	0
15	32350051	.	A	G	8	4	12	0	0	12	0	0
15	32350116	.	G	T	14	6	20	0	0	20	0	0
15	32350668	.	A	G	4	0	4	0	3	7	0	0
15	32350762	.	A	G	5	4	9	0	0	9	0	0
15	32351183	.	A	G	3	3	6	0	0	6	0	0
15	32351432	.	A	G	10	6	16	0	2	18	0	0
15	32453369	.	C	T	0	2	2	0	0	2	0	0
15	32887739	.	A	G	12	1	13	0	6	19	0	0
15	32888117	.	A	G	10	4	14	0	2	16	0	0
15	33853701	.	C	T	3	5	8	0	0	8	0	0
15	33864266	.	G	A	4	4	8	0	0	8	0	0
15	33864585	.	G	A	9	4	13	0	1	14	0	0
15	33891825	.	G	A	18	14	32	0	1	33	0	0
15	33891826	.	G	A	16	15	31	0	2	33	0	0
15	33891869	.	G	T	19	10	29	0	2	31	0	0
15	33896117	.	G	T	16	16	32	0	0	32	0	0
15	33896177	.	T	C	25	31	56	0	2	58	0	0
15	33896213	.	T	C	23	0	23	0	30	53	0	0
15	33896303	.	T	A	24	18	42	0	1	43	0	0
15	33896306	.	A	G	20	22	42	0	0	42	0	0
15	33896832	.	T	C	23	13	36	0	0	36	0	0
15	33899556	.	C	G	13	8	21	0	1	22	0	0
15	33899808	.	T	A	13	20	33	0	3	36	0	0
15	33902388	.	C	G	2	13	15	0	8	23	0	0
15	33910546	.	G	C	3	11	14	0	0	14	0	0
15	33970841	.	A	G	21	0	21	0	14	35	0	0
15	33970854	.	C	T	22	12	34	0	1	35	0	0
15	33970907	.	C	T	6	4	10	0	0	10	0	0
15	33971097	.	G	C	20	14	34	0	1	35	0	0
15	33977716	.	A	T	23	14	37	0	0	37	0	0
15	33977760	.	A	G	9	0	9	0	19	28	0	0
15	33977942	.	A	C	9	11	20	0	0	20	0	0
15	34064481	.	C	T	2	4	6	0	0	6	0	0
15	34064516	.	G	A	1	3	4	0	0	4	0	0
15	34074106	.	G	A	0	2	2	0	3	5	0	0
15	34074132	.	A	T	3	4	7	0	0	7	0	0
15	34074141	.	T	C	4	3	7	0	0	7	0	0
15	34074558	.	C	T	5	4	9	0	0	9	0	0
15	34174532	.	T	A	13	8	21	0	1	22	0	0
15	34174568	.	T	A	8	7	15	0	0	15	0	0
15	34174635	.	T	C	3	4	7	0	0	7	0	0
15	34174744	.	A	T	5	2	7	0	1	8	0	0
15	34175101	.	T	C	19	16	35	0	2	37	0	0
15	34175359	.	G	A	7	4	11	0	0	11	0	0
15	34175426	.	T	A	4	4	8	0	0	8	0	0
15	34175917	.	C	T	6	7	13	1	0	14	0	0
15	34175929	.	C	T	7	9	16	1	0	17	0	0
15	34176203	.	A	T	10	3	13	0	0	13	0	0
15	34176214	.	C	T	5	8	13	0	0	13	0	0
15	34176379	.	A	C	6	3	9	0	1	10	0	0
15	34176841	.	A	T	5	5	10	0	0	10	0	0
15	34176993	.	G	A	7	3	10	0	0	10	0	0
15	34182135	.	G	A	1	1	2	0	0	2	0	0
15	34189452	.	G	A	8	9	17	0	0	17	0	0
15	34212903	.	G	A	1	1	2	0	0	2	0	0
15	34239191	.	C	T	1	1	2	0	0	2	0	0
15	34334858	.	G	T	5	3	8	0	0	8	0	0
15	34334949	.	T	A	1	2	3	0	0	3	0	0
15	34335130	.	T	C	2	2	4	0	0	4	0	0
15	34335147	.	G	A	2	4	6	0	0	6	0	0
15	34335272	.	C	T	2	1	3	0	0	3	0	0
15	34365162	.	C	T	0	2	2	0	0	2	0	0
15	34558428	.	G	A	4	3	7	0	0	7	0	0
15	34573424	.	A	T	1	2	3	0	0	3	0	0
15	34573437	.	G	A	1	2	3	0	0	3	0	0
15	34573597	.	A	T	4	4	8	0	0	8	0	0
15	34573664	.	G	T	1	2	3	0	0	3	0	0
15	34574116	.	G	A	5	8	13	0	1	14	0	0
15	34577749	.	G	A	1	0	1	0	0	1	0	0
15	34586304	.	A	G	2	1	3	0	0	3	0	0
15	34590772	.	A	G	3	2	5	0	1	6	0	0
15	34618456	.	T	G	7	9	16	0	0	16	0	0
15	34618669	.	A	T	12	19	31	0	1	32	0	0
15	34618906	.	C	A	9	14	23	0	1	24	0	0
15	34618948	.	T	G	16	15	31	0	2	33	0	0
15	34618958	.	G	A	15	17	32	0	3	35	0	0
15	34621868	.	G	A	4	13	17	0	3	20	0	0
15	34621875	.	G	A	17	8	25	0	0	25	0	0
15	34627792	.	T	A	2	1	3	0	0	3	0	0
15	34627874	.	T	C	5	14	19	0	0	19	0	0
15	34635321	.	C	A	5	6	11	0	1	12	0	0
15	34635336	.	A	C	5	0	5	0	6	11	0	0
15	34637582	.	C	T	0	2	2	0	4	6	0	0
15	34638847	.	C	T	1	5	6	0	15	21	0	0
15	34641276	.	G	A	5	4	9	0	0	9	0	0
15	34641300	.	G	A	7	3	10	0	0	10	0	0
15	34641384	.	G	A	2	4	6	0	0	6	0	0
15	34657370	.	C	T	0	1	1	0	0	1	0	0
15	34657919	.	T	A	4	5	9	0	0	9	0	0
15	35091591	.	A	G	2	6	8	1	0	9	0	0
15	35103122	.	T	C	1	0	1	0	3	4	0	0
15	35103145	.	T	C	1	3	4	0	1	5	0	0
15	35156554	.	T	G	0	1	1	0	3	4	0	0
15	35156573	.	A	T	0	2	2	0	0	3	1	0
15	35157052	.	T	A	2	6	8	0	0	8	0	0
15	35157054	.	G	A	2	6	8	0	0	8	0	0
15	35158661	.	T	G	4	3	7	0	0	7	0	0
15	35163492	.	T	G	3	5	8	0	0	8	0	0
15	35167298	.	A	G	1	0	1	0	0	1	0	0
15	35212147	.	C	G	0	5	5	0	3	8	0	0
15	35212177	.	G	A	3	7	10	0	0	10	0	0
15	35212318	.	A	T	5	4	9	0	0	9	0	0
15	35212386	.	T	C	2	2	4	0	1	5	0	0
15	35212418	.	G	C	3	3	6	0	0	6	0	0
15	35214784	.	T	A	7	4	11	0	0	11	0	0
15	35214859	.	A	C	10	0	10	0	8	18	0	0
15	35214901	.	G	A	9	9	18	0	1	19	0	0
15	35217424	.	G	A	1	0	1	0	0	1	0	0
15	35217475	.	T	C	8	10	18	0	0	18	0	0
15	35217487	.	C	A	1	12	13	0	10	23	0	0
15	35221304	.	A	T	5	2	7	0	0	7	0	0
15	35224269	.	G	C	5	5	10	0	0	10	0	0
15	35247678	.	A	T	14	15	29	0	7	36	0	0
15	35247687	.	A	G	14	25	39	0	1	40	0	0
15	35247729	.	A	G	9	25	34	0	0	34	0	0
15	35247762	.	T	C	11	20	31	0	0	31	0	0
15	35709983	.	G	A	0	1	1	0	2	3	0	0
15	35709988	.	C	T	1	2	3	0	0	3	0	0
15	35718398	.	A	C	3	5	8	0	0	8	0	0
15	35737680	.	T	C	4	5	9	0	0	9	0	0
15	35760943	.	C	T	4	3	7	0	0	7	0	0
15	35760970	.	G	A	4	8	12	0	0	12	0	0
15	35761024	.	T	C	3	11	14	0	2	16	0	0
15	35761027	.	A	G	3	11	14	0	1	15	0	0
15	35761126	.	G	A	1	5	6	0	6	12	0	0
15	35780647	.	T	A	1	2	3	0	0	3	0	0
15	35889443	.	G	T	3	1	4	0	0	4	0	0
15	35889474	.	G	A	1	4	5	0	0	5	0	0
15	35889516	.	A	C	2	2	4	0	0	4	0	0
15	35889517	.	C	A	0	2	2	0	2	4	0	0
15	35889865	.	A	G	2	4	6	0	1	7	0	0
15	35890046	.	G	A	6	4	10	0	0	10	0	0
15	35892879	.	T	C	2	1	3	0	0	3	0	0
15	35926361	.	C	G	1	3	4	0	0	4	0	0
15	35926754	.	A	G	2	2	4	0	0	4	0	0
15	35927066	.	T	G	2	2	4	0	0	4	0	0
15	35944379	.	G	A	0	4	4	0	1	5	0	0
15	35944474	.	A	C	1	4	5	0	0	5	0	0
15	36352677	.	G	T	1	3	4	0	0	4	0	0
15	36352705	.	A	G	1	3	4	0	0	4	0	0
15	37222589	.	T	C	0	1	1	0	0	1	0	0
15	37227033	.	T	G	31	29	60	0	4	65	1	0
15	37227059	.	A	G	29	1	30	0	34	64	0	0
15	37227509	.	A	G	27	0	27	0	29	56	0	0
15	37227714	.	A	G	21	1	22	0	25	47	0	0
15	37227770	.	G	A	26	18	44	0	5	49	0	0
15	37228164	.	A	G	17	34	51	0	0	51	0	0
15	37228236	.	C	T	16	34	50	0	3	53	0	0
15	37228266	.	T	C	15	28	43	0	5	48	0	0
15	37228301	.	T	A	15	22	37	0	0	37	0	0
15	37228338	.	T	A	19	11	30	0	0	30	0	0
15	37228620	.	G	C	29	28	57	0	2	59	0	0
15	37228626	.	G	A	32	30	62	0	0	62	0	0
15	37228665	.	C	G	28	30	58	0	0	58	0	0
15	37228809	.	T	G	42	1	43	0	12	55	0	0
15	37228843	.	T	A	32	7	39	0	6	45	0	0
15	37228845	.	T	G	33	6	39	0	6	45	0	0
15	37229871	.	A	T	29	36	65	0	2	67	0	0
15	37229991	.	C	A	26	30	56	0	4	60	0	0
15	37230038	.	G	A	30	22	52	0	0	52	0	0
15	37230100	.	G	A	26	33	59	0	1	60	0	0
15	37459044	.	T	C	4	4	8	0	0	8	0	0
15	37459049	.	T	C	2	0	2	0	4	6	0	0
15	37459156	.	T	C	6	4	10	0	1	11	0	0
15	37459178	.	T	C	5	0	5	0	5	10	0	0
15	37459194	.	T	C	4	6	10	0	0	10	0	0
15	37459342	.	T	C	4	0	4	0	2	6	0	0
15	37459979	.	T	C	4	8	12	0	0	12	0	0
15	37459988	.	T	C	6	0	6	0	7	13	0	0
15	37460322	.	T	C	2	2	4	0	0	4	0	0
15	37460347	.	T	C	1	2	3	0	0	3	0	0
15	37561838	.	A	G	2	2	4	0	0	4	0	0
15	38859746	.	C	T	4	3	7	0	0	7	0	0
15	38859753	.	A	C	3	3	6	0	2	8	0	0
15	38892060	.	T	C	5	8	13	0	1	14	0	0
15	39128662	.	C	T	5	3	8	0	0	8	0	0
15	39140121	.	C	A	14	8	22	0	0	22	0	0
15	39140568	.	G	A	0	2	2	0	1	3	0	0
15	39141465	.	T	C	4	1	5	0	0	5	0	0
15	39208133	.	C	A	12	13	25	0	0	25	0	0
15	39208150	.	C	T	11	12	23	0	0	23	0	0
15	39208201	.	C	A	13	13	26	0	2	28	0	0
15	39208211	.	C	T	13	16	29	0	0	29	0	0
15	39208258	.	C	T	13	7	20	0	1	21	0	0
15	39228174	.	A	G	11	20	31	0	0	31	0	0
15	39278501	.	G	T	10	6	16	0	1	17	0	0
15	39281923	.	A	G	9	9	18	0	2	20	0	0
15	39282007	.	G	C	6	0	6	0	11	17	0	0
15	39282070	.	A	G	2	3	5	0	0	5	0	0
15	39282091	.	G	A	0	1	1	0	0	1	0	0
15	39294391	.	C	T	11	11	22	0	0	22	0	0
15	39296706	.	A	G	7	8	15	0	2	17	0	0
15	39296730	.	G	A	7	8	15	0	1	16	0	0
15	39297051	.	G	A	12	10	22	0	0	22	0	0
15	39297081	.	A	G	4	7	11	0	1	12	0	0
15	39305598	.	G	A	4	2	6	0	0	6	0	0
15	39326986	.	C	T	3	3	6	0	1	7	0	0
15	39345641	.	G	A	4	6	10	0	0	10	0	0
15	39354726	.	G	A	8	5	13	0	0	13	0	0
15	39368871	.	T	G	1	1	2	0	0	2	0	0
15	39372699	.	G	A	0	1	1	0	0	1	0	0
15	39967275	.	G	A	14	13	27	0	0	27	0	0
15	39969923	.	T	G	18	13	31	0	3	34	0	0
15	39986125	.	C	A	4	2	6	0	0	6	0	0
15	39987655	.	C	T	2	3	5	0	0	5	0	0
15	39987691	.	T	C	2	7	9	0	1	10	0	0
15	39992053	.	C	T	5	7	12	0	0	12	0	0
15	40000966	.	C	A	4	5	9	0	0	9	0	0
15	40000981	.	A	T	5	6	11	0	1	12	0	0
15	40002242	.	C	T	2	5	7	0	0	7	0	0
15	40002319	.	C	T	13	7	20	0	3	23	0	0
15	40002325	.	C	T	14	7	21	0	0	21	0	0
15	40002534	.	A	T	8	7	15	0	1	17	1	0
15	40004820	.	G	A	2	2	4	0	0	4	0	0
15	40005279	.	C	T	2	3	5	0	0	5	0	0
15	40005297	.	A	C	4	3	7	0	0	7	0	0
15	40005318	.	T	A	3	6	9	0	0	9	0	0
15	40005466	.	C	T	7	6	13	0	0	13	0	0
15	40005545	.	T	C	10	8	18	0	2	20	0	0
15	40006090	.	A	C	8	7	15	0	0	15	0	0
15	40008449	.	C	T	12	23	35	0	1	36	0	0
15	40008498	.	C	T	23	18	41	0	2	43	0	0
15	40008544	.	C	A	22	26	48	0	1	49	0	0
15	40018239	.	G	A	2	9	11	0	21	32	0	0
15	40018290	.	C	T	7	4	11	0	0	11	0	0
15	40027138	.	C	T	15	29	44	0	1	45	0	0
15	40027279	.	T	C	40	33	73	0	2	75	0	0
15	40027484	.	T	G	19	0	19	0	36	55	0	0
15	40027540	.	A	C	20	28	48	0	2	50	0	0
15	40027717	.	A	G	22	22	44	0	3	47	0	0
15	40028280	.	A	G	41	15	56	0	0	56	0	0
15	40028457	.	T	G	40	26	66	0	1	67	0	0
15	40028568	.	G	A	31	22	53	0	4	57	0	0
15	40028574	.	A	G	22	30	52	0	7	59	0	0
15	40091068	.	C	T	5	9	14	0	1	15	0	0
15	40099844	.	T	C	10	2	12	0	0	12	0	0
15	40104028	.	T	C	8	6	14	0	0	14	0	0
15	40108886	.	T	C	11	7	18	0	0	18	0	0
15	40108898	.	C	T	8	5	13	0	1	14	0	0
15	40115610	.	A	T	2	2	4	0	0	4	0	0
15	40115676	.	C	T	4	12	16	0	0	16	0	0
15	40122221	.	A	G	5	3	8	0	0	8	0	0
15	40122625	.	G	A	7	5	12	0	0	12	0	0
15	40126698	.	A	G	15	0	15	0	9	24	0	0
15	40128979	.	C	G	19	14	33	0	1	34	0	0
15	40129543	.	G	C	17	11	28	0	2	30	0	0
15	40129594	.	T	G	11	14	25	0	1	26	0	0
15	40129604	.	A	T	9	14	23	0	1	25	1	0
15	40129810	.	A	C	6	8	14	0	1	15	0	0
15	40130181	.	G	A	0	12	12	0	7	19	0	0
15	40130208	.	G	A	5	11	16	0	0	16	0	0
15	40130538	.	A	G	2	5	7	0	0	7	0	0
15	40130539	.	A	G	5	2	7	0	0	7	0	0
15	40130759	.	A	G	5	8	13	1	1	15	0	0
15	40130866	.	A	G	18	10	28	0	0	28	0	0
15	40130867	.	A	G	17	9	26	0	2	28	0	0
15	40131001	.	G	A	0	4	4	0	2	6	0	0
15	40131060	.	A	G	4	5	9	0	2	11	0	0
15	40131112	.	C	A	12	9	21	0	0	21	0	0
15	40131139	.	T	A	16	10	26	0	0	26	0	0
15	40131157	.	A	G	12	11	23	0	4	27	0	0
15	40131216	.	G	A	16	2	18	0	0	18	0	0
15	40131232	.	C	T	15	4	19	0	0	19	0	0
15	40131276	.	C	G	9	9	18	0	2	20	0	0
15	40131297	.	C	G	15	8	23	0	0	23	0	0
15	40131316	.	C	A	18	9	27	0	2	30	1	0
15	40131363	.	G	T	0	17	17	0	21	38	0	0
15	40131498	.	A	G	15	0	15	0	24	39	0	0
15	40131500	.	A	G	16	23	39	0	0	39	0	0
15	40131547	.	T	C	8	19	27	0	2	29	0	0
15	40131560	.	T	A	6	23	29	0	0	29	0	0
15	40131586	.	C	T	6	22	28	0	1	29	0	0
15	40131619	.	T	C	9	21	30	0	3	33	0	0
15	40131624	.	T	A	11	20	31	0	0	31	0	0
15	40131769	.	T	C	9	11	20	0	2	22	0	0
15	40202354	.	T	G	25	20	45	0	2	47	0	0
15	40202393	.	C	T	10	8	18	0	0	18	0	0
15	40211507	.	T	C	4	6	10	0	0	10	0	0
15	40211591	.	A	C	29	21	50	0	3	53	0	0
15	40211618	.	A	G	27	2	29	0	18	47	0	0
15	40211741	.	C	G	28	19	47	0	1	48	0	0
15	40211954	.	G	T	12	11	23	0	0	23	0	0
15	40284697	.	A	G	2	0	2	0	2	4	0	0
15	40284718	.	T	A	3	2	5	0	0	5	0	0
15	40794183	.	A	C	2	2	4	0	0	4	0	0
15	40795639	.	C	T	1	2	3	0	0	3	0	0
15	40893860	.	T	C	1	3	4	0	0	4	0	0
15	40893864	.	G	A	1	3	4	0	0	4	0	0
15	40926702	.	C	T	4	2	6	0	0	6	0	0
15	40930419	.	G	A	1	1	2	0	0	2	0	0
15	40933339	.	T	C	5	2	7	0	0	7	0	0
15	40935869	.	T	C	1	2	3	0	0	3	0	0
15	40938072	.	C	T	1	2	3	0	0	3	0	0
15	40938119	.	G	A	5	4	9	0	0	9	0	0
15	40938305	.	C	T	4	4	8	0	1	9	0	0
15	40938498	.	T	C	1	3	4	0	1	5	0	0
15	40941322	.	G	A	5	5	10	0	0	10	0	0
15	40945651	.	A	G	1	4	5	0	1	6	0	0
15	40945690	.	T	C	7	7	14	0	0	14	0	0
15	40952226	.	A	G	0	2	2	0	0	2	0	0
15	40962160	.	T	C	2	5	7	0	0	7	0	0
15	40962186	.	C	T	2	3	5	0	0	5	0	0
15	40988228	.	C	T	9	3	12	0	1	13	0	0
15	40988565	.	A	G	8	8	16	0	0	16	0	0
15	40988659	.	C	A	5	6	11	0	1	12	0	0
15	40989053	.	T	G	1	3	4	0	1	5	0	0
15	40989320	.	C	G	3	1	4	0	6	10	0	0
15	40989327	.	A	G	3	3	6	0	1	7	0	0
15	40989614	.	C	T	2	3	5	0	0	5	0	0
15	40989801	.	A	G	5	0	5	0	3	8	0	0
15	41170289	.	A	G	9	14	23	0	0	23	0	0
15	41170445	.	G	T	9	11	20	0	1	21	0	0
15	41170710	.	G	A	12	8	20	0	1	21	0	0
15	41170992	.	G	A	6	11	17	0	0	17	0	0
15	41171081	.	T	C	10	0	10	0	9	19	0	0
15	41171135	.	A	G	9	9	18	0	0	18	0	0
15	41171335	.	A	T	3	15	18	0	1	19	0	0
15	41171448	.	A	C	13	10	23	0	0	23	0	0
15	41171471	.	G	T	14	11	25	0	0	25	0	0
15	41171516	.	C	A	0	11	11	0	17	28	0	0
15	41172103	.	G	A	6	8	14	0	0	14	0	0
15	41172303	.	G	T	5	3	8	0	1	9	0	0
15	41172325	.	G	T	3	5	8	0	0	8	0	0
15	41172427	.	T	C	4	4	8	0	1	9	0	0
15	41172731	.	G	A	2	3	5	0	0	5	0	0
15	41172745	.	C	T	2	3	5	0	0	5	0	0
15	41172893	.	A	C	9	7	16	0	0	16	0	0
15	41172904	.	G	C	10	8	18	0	0	18	0	0
15	41173093	.	A	T	5	12	17	0	0	17	0	0
15	41173109	.	C	T	2	10	12	0	0	12	0	0
15	41173142	.	G	A	4	4	8	0	0	8	0	0
15	41173326	.	C	T	14	10	24	0	1	25	0	0
15	41173620	.	G	A	6	5	11	0	0	11	0	0
15	41769068	.	T	C	1	2	3	0	0	3	0	0
15	41769487	.	T	C	3	0	3	0	2	5	0	0
15	41769498	.	T	C	2	2	4	0	0	4	0	0
15	41769808	.	T	C	11	2	13	0	0	13	0	0
15	42767880	.	G	A	0	6	6	0	4	10	0	0
15	42920208	.	G	A	3	2	5	0	0	5	0	0
15	42920218	.	G	A	0	3	3	0	2	5	0	0
15	42920317	.	A	G	1	4	5	0	0	5	0	0
15	42920332	.	G	T	4	3	7	0	0	7	0	0
15	42920365	.	C	T	3	5	8	0	0	8	0	0
15	42933283	.	C	T	1	2	3	0	0	3	0	0
15	42947514	.	C	T	0	3	3	0	1	4	0	0
15	42947664	.	C	G	5	5	10	0	0	10	0	0
15	42947700	.	C	A	3	1	4	0	2	6	0	0
15	42952872	.	G	T	5	7	12	0	0	12	0	0
15	42958701	.	C	T	4	2	6	0	0	6	0	0
15	42976197	.	C	G	4	4	8	0	0	8	0	0
15	42981069	.	C	T	5	5	10	0	0	10	0	0
15	42981137	.	C	A	3	8	11	0	0	11	0	0
15	42981223	.	A	G	3	8	11	0	1	12	0	0
15	42981281	.	A	T	7	5	12	0	1	13	0	0
15	42981321	.	G	A	5	7	12	0	0	12	0	0
15	43604150	.	G	C	1	4	5	0	0	5	0	0
15	43604224	.	G	A	4	2	6	0	0	6	0	0
15	43604325	.	G	A	2	2	4	0	2	6	0	0
15	43604903	.	C	G	3	5	8	0	1	9	0	0
15	43604928	.	A	G	3	3	6	0	1	7	0	0
15	43604988	.	G	C	2	4	6	0	2	8	0	0
15	43604996	.	A	G	3	5	8	0	0	8	0	0
15	43605309	.	G	T	2	2	4	0	0	4	0	0
15	43605544	.	G	A	7	3	10	0	0	10	0	0
15	43656519	.	G	T	1	2	3	0	0	3	0	0
15	43656619	.	C	T	3	2	5	0	0	5	0	0
15	43657018	.	T	A	0	4	4	0	1	5	0	0
15	43671093	.	G	A	1	1	2	0	0	2	0	0
15	43931161	.	C	T	0	4	4	0	0	4	0	0
15	43931233	.	G	A	0	1	1	0	0	1	0	0
15	43966993	.	C	T	0	3	3	0	0	3	0	0
15	43969860	.	A	G	0	1	1	0	0	1	0	0
15	43982146	.	T	C	2	4	6	0	0	6	0	0
15	43982517	.	T	C	2	2	4	0	0	4	0	0
15	43983393	.	C	T	0	2	2	0	1	3	0	0
15	43983402	.	G	A	1	2	3	0	0	3	0	0
15	43984470	.	T	C	1	3	4	0	0	4	0	0
15	43984495	.	C	A	1	3	4	0	0	4	0	0
15	43988716	.	C	T	1	2	3	0	0	3	0	0
15	43988767	.	G	T	2	3	5	0	0	5	0	0
15	43994684	.	A	G	1	0	1	0	0	1	0	0
15	44056987	.	G	A	1	2	3	0	0	3	0	0
15	44072776	.	T	C	2	0	2	0	2	4	0	0
15	44072782	.	G	A	2	1	3	0	0	3	0	0
15	44074653	.	A	G	1	0	1	0	0	1	0	0
15	44075125	.	C	T	1	5	6	0	6	12	0	0
15	44077766	.	A	T	11	9	20	0	0	20	0	0
15	44140324	.	T	G	2	0	2	0	5	7	0	0
15	44140360	.	G	A	5	3	8	0	0	8	0	0
15	44140458	.	G	A	0	4	4	0	4	8	0	0
15	44140546	.	T	C	2	3	5	0	0	5	0	0
15	44140583	.	C	T	3	2	5	0	1	6	0	0
15	44140780	.	A	G	2	3	5	0	0	5	0	0
15	44140991	.	T	C	5	2	7	0	0	7	0	0
15	44141311	.	A	G	1	2	3	0	0	3	0	0
15	44141644	.	A	C	3	4	7	0	0	7	0	0
15	44252374	.	T	C	0	2	2	0	0	2	0	0
15	44254986	.	A	C	0	1	1	0	0	1	0	0
15	44255001	.	G	A	2	2	4	0	0	4	0	0
15	44255130	.	A	T	4	4	8	0	1	9	0	0
15	44255212	.	A	C	9	4	13	0	0	13	0	0
15	44255438	.	A	G	2	0	2	0	3	5	0	0
15	44255467	.	C	T	5	4	9	0	0	9	0	0
15	44255473	.	T	C	5	4	9	0	0	9	0	0
15	44255503	.	A	T	5	3	8	0	1	9	0	0
15	44283812	.	A	G	0	2	2	0	0	2	0	0
15	44290546	.	C	T	2	2	4	0	0	4	0	0
15	44295044	.	G	A	1	2	3	0	0	3	0	0
15	44295262	.	A	G	0	0	0	0	1	1	0	0
15	44323349	.	T	C	1	1	2	0	0	2	0	0
15	44323436	.	G	A	0	3	3	0	1	4	0	0
15	44323442	.	G	A	0	3	3	0	0	3	0	0
15	44336923	.	A	T	2	2	4	0	1	5	0	0
15	44370890	.	C	A	4	9	13	0	0	13	0	0
15	44371058	.	T	C	18	9	27	0	0	27	0	0
15	44371076	.	C	T	15	17	32	0	0	32	0	0
15	44371129	.	C	T	9	11	20	0	1	21	0	0
15	44371289	.	C	T	4	8	12	0	1	13	0	0
15	44371484	.	T	C	8	10	18	0	0	18	0	0
15	44384728	.	C	T	4	4	8	0	0	8	0	0
15	44385117	.	T	C	11	4	15	0	1	16	0	0
15	44440314	.	G	T	3	4	7	0	0	7	0	0
15	44440352	.	G	A	7	1	8	0	0	8	0	0
15	44445243	.	C	T	5	6	11	0	0	11	0	0
15	44472745	.	A	G	1	2	3	0	0	3	0	0
15	44472757	.	A	G	1	3	4	0	0	4	0	0
15	44472844	.	G	A	0	2	2	0	1	3	0	0
15	44475152	.	G	T	0	3	3	0	1	4	0	0
15	44499653	.	T	A	16	16	32	0	2	34	0	0
15	44534976	.	G	A	4	8	12	0	0	12	0	0
15	44559576	.	C	G	8	7	15	0	3	18	0	0
15	44559636	.	T	C	9	0	9	0	9	18	0	0
15	44559646	.	T	A	9	4	13	0	0	13	0	0
15	44559749	.	A	G	4	7	11	0	1	12	0	0
15	44560414	.	T	G	13	1	14	0	1	15	0	0
15	44565727	.	T	A	2	2	4	0	0	4	0	0
15	44646664	.	G	A	7	6	13	0	0	13	0	0
15	44646676	.	T	C	6	4	10	0	0	10	0	0
15	44660651	.	C	T	2	3	5	0	1	6	0	0
15	44663021	.	G	A	2	5	7	0	0	7	0	0
15	44676968	.	G	A	0	3	3	0	0	3	0	0
15	44677292	.	G	T	1	2	3	0	0	3	0	0
15	44714650	.	A	G	2	1	3	0	0	3	0	0
15	44721553	.	G	A	2	1	3	0	1	4	0	0
15	44721559	.	G	A	2	2	4	0	0	4	0	0
15	44755886	.	C	T	0	12	12	0	5	17	0	0
15	45103853	.	C	A	0	1	1	0	0	1	0	0
15	45122487	.	T	G	1	1	2	0	0	2	0	0
15	45123267	.	T	C	1	0	1	0	2	3	0	0
15	45129375	.	C	T	0	2	2	0	0	2	0	0
15	45151186	.	A	G	1	1	2	0	0	2	0	0
15	45162049	.	T	C	1	0	1	0	0	1	0	0
15	45169200	.	T	A	1	2	3	0	1	4	0	0
15	45418610	.	G	A	19	15	34	0	1	35	0	0
15	45510169	.	T	A	12	17	29	0	2	31	0	0
15	45527282	.	C	T	1	6	7	0	0	7	0	0
15	45527776	.	A	G	2	6	8	0	0	8	0	0
15	45527830	.	C	T	0	3	3	0	2	5	0	0
15	45528385	.	C	A	0	1	1	0	2	3	0	0
15	45544630	.	T	C	3	2	5	0	1	6	0	0
15	45544687	.	C	T	5	5	10	0	0	10	0	0
15	45544759	.	C	A	1	0	1	0	1	2	0	0
15	45552439	.	G	C	1	0	1	0	0	1	0	0
15	45555001	.	G	A	0	1	1	0	2	3	0	0
15	45555208	.	A	T	4	1	5	0	1	6	0	0
15	45591739	.	G	C	6	19	25	0	0	25	0	0
15	45591753	.	C	G	5	16	21	0	3	24	0	0
15	45595456	.	A	T	1	4	5	0	1	6	0	0
15	45602730	.	T	C	12	8	20	0	3	23	0	0
15	45602878	.	G	A	1	4	5	0	0	5	0	0
15	45607352	.	G	A	0	2	2	0	0	2	0	0
15	45612497	.	G	A	0	3	3	0	7	10	0	0
15	45621750	.	C	T	1	0	1	0	0	1	0	0
15	45628074	.	G	A	5	6	11	0	1	12	0	0
15	45634793	.	G	A	17	10	27	0	1	28	0	0
15	45634864	.	T	G	13	9	22	1	1	24	0	0
15	45634865	.	C	T	13	7	20	1	3	24	0	0
15	45634995	.	T	C	3	3	6	0	0	6	0	0
15	45635375	.	A	G	6	6	12	0	2	14	0	0
15	45635848	.	C	T	12	5	17	0	0	17	0	0
15	45635952	.	T	C	11	5	16	0	0	16	0	0
15	45635999	.	G	A	11	9	20	0	1	21	0	0
15	45636504	.	G	T	5	2	7	0	0	7	0	0
15	45637224	.	A	G	8	15	23	0	1	24	0	0
15	45637406	.	C	T	1	6	7	0	1	8	0	0
15	45662317	.	G	A	0	2	2	0	5	7	0	0
15	45994139	.	G	T	4	5	9	0	0	9	0	0
15	45994177	.	C	T	6	5	11	0	0	11	0	0
15	46034372	.	T	C	1	0	1	0	0	1	0	0
15	46108618	.	G	A	1	7	8	0	6	14	0	0
15	46111047	.	T	A	3	5	8	0	0	8	0	0
15	46111152	.	A	G	6	0	6	0	8	14	0	0
15	46111254	.	A	G	7	5	12	0	0	12	0	0
15	46111410	.	A	G	10	6	16	0	0	16	0	0
15	46116133	.	G	A	5	6	11	0	0	11	0	0
15	46116136	.	T	G	5	0	5	0	6	11	0	0
15	46116352	.	A	G	9	9	18	0	1	19	0	0
15	46598423	.	C	T	3	1	4	0	0	4	0	0
15	46598594	.	T	C	4	2	6	0	0	6	0	0
15	46643768	.	T	C	5	12	17	0	1	18	0	0
15	46649525	.	A	G	9	9	18	0	0	18	0	0
15	46652124	.	A	G	7	6	13	0	0	13	0	0
15	46662011	.	G	T	17	0	17	0	2	19	0	0
15	46662143	.	C	T	5	8	13	0	0	13	0	0
15	46662353	.	T	C	6	12	18	0	0	18	0	0
15	46666181	.	T	C	8	0	8	0	9	17	0	0
15	46668250	.	T	A	1	0	1	0	1	2	0	0
15	46687234	.	T	C	0	0	0	0	2	2	0	0
15	46687290	.	A	C	3	3	6	0	0	6	0	0
15	46687341	.	T	G	0	1	1	0	0	1	0	0
15	46687586	.	A	G	1	0	1	0	0	1	0	0
15	46704595	.	T	C	2	3	5	0	0	5	0	0
15	46704623	.	G	A	2	2	4	0	0	4	0	0
15	46722651	.	G	A	2	3	5	0	1	6	0	0
15	46722692	.	A	T	2	2	4	0	1	5	0	0
15	46722863	.	G	A	4	2	6	0	0	6	0	0
15	46722881	.	A	T	2	2	4	0	1	5	0	0
15	46726371	.	T	C	0	4	4	0	0	4	0	0
15	46727382	.	G	A	1	1	2	0	0	2	0	0
15	46727571	.	G	A	0	1	1	0	0	1	0	0
15	46796111	.	T	G	2	2	4	0	0	4	0	0
15	47029331	.	G	A	2	3	5	0	0	5	0	0
15	47063594	.	C	T	0	3	3	0	0	3	0	0
15	47100599	.	C	T	0	0	0	0	3	3	0	0
15	47107256	.	A	G	4	4	8	0	0	8	0	0
15	47113654	.	T	G	0	8	8	0	2	10	0	0
15	47336295	.	G	A	12	5	17	0	0	17	0	0
15	47386982	.	T	A	13	5	18	0	0	18	0	0
15	47410231	.	C	A	4	1	5	0	0	5	0	0
15	47418607	.	G	A	0	6	6	0	5	11	0	0
15	47418627	.	G	A	4	6	10	0	1	11	0	0
15	47419090	.	G	A	0	13	13	0	18	31	0	0
15	47419096	.	C	T	16	14	30	0	1	31	0	0
15	47419240	.	C	T	9	17	26	0	0	26	0	0
15	47419394	.	C	T	5	13	18	0	1	19	0	0
15	47419395	.	A	T	5	12	17	0	2	19	0	0
15	47420838	.	T	A	16	14	30	0	2	32	0	0
15	47421203	.	T	C	15	7	22	0	0	22	0	0
15	47421329	.	A	G	8	9	17	0	0	17	0	0
15	47421669	.	C	T	15	13	28	0	1	29	0	0
15	47421675	.	G	C	13	14	27	0	0	27	0	0
15	47446367	.	G	C	0	2	2	0	2	4	0	0
15	47448053	.	T	C	3	4	7	0	0	7	0	0
15	47452875	.	G	A	1	5	6	0	0	6	0	0
15	47452895	.	C	A	3	2	5	0	0	5	0	0
15	47453836	.	C	T	0	1	1	0	0	1	0	0
15	47453857	.	C	T	1	0	1	0	0	1	0	0
15	47454144	.	G	C	1	4	5	0	0	5	0	0
15	47454161	.	G	T	1	3	4	0	0	4	0	0
15	47830783	.	C	T	1	3	4	0	0	4	0	0
15	47830837	.	G	T	0	1	1	0	0	1	0	0
15	47830973	.	C	A	7	3	10	0	0	10	0	0
15	47831096	.	C	T	10	5	15	0	0	15	0	0
15	47831195	.	G	C	6	4	10	0	0	10	0	0
15	47831249	.	C	T	4	4	8	0	0	8	0	0
15	47831265	.	T	A	2	6	8	0	0	8	0	0
15	47831495	.	C	G	12	11	23	0	0	23	0	0
15	47831511	.	C	T	0	12	12	0	11	23	0	0
15	47831565	.	C	A	9	14	23	0	1	24	0	0
15	47831983	.	G	A	1	3	4	0	0	4	0	0
15	47831992	.	A	T	1	3	4	0	0	4	0	0
15	47832424	.	T	G	0	2	2	0	0	2	0	0
15	47832681	.	G	A	3	2	5	0	0	5	0	0
15	47832930	.	C	T	3	1	4	0	2	6	0	0
15	47832931	.	C	T	0	2	2	0	4	6	0	0
15	47833083	.	G	A	6	5	11	0	0	11	0	0
15	47833392	.	G	A	7	6	13	0	0	13	0	0
15	47833395	.	C	T	0	5	5	0	7	12	0	0
15	47833436	.	C	T	0	5	5	0	7	12	0	0
15	47833493	.	C	T	0	7	7	0	2	9	0	0
15	47833814	.	C	T	3	3	6	0	0	6	0	0
15	47833875	.	A	G	4	4	8	0	0	8	0	0
15	47834327	.	C	G	5	7	12	0	0	12	0	0
15	47834559	.	G	A	2	5	7	0	1	8	0	0
15	47839080	.	G	A	2	5	7	0	0	7	0	0
15	47845908	.	A	G	0	1	1	0	0	1	0	0
15	47847180	.	T	C	5	0	5	0	5	10	0	0
15	47847373	.	G	A	3	5	8	0	0	8	0	0
15	47848495	.	C	T	16	22	38	0	4	42	0	0
15	47851205	.	T	A	30	19	49	0	2	51	0	0
15	47851340	.	C	G	25	9	34	1	2	46	9	0
15	47851342	.	C	G	35	10	45	1	0	46	0	0
15	47851455	.	T	G	25	35	60	0	1	61	0	0
15	47851486	.	G	A	22	35	57	0	2	59	0	0
15	47851522	.	C	T	2	32	34	0	27	61	0	0
15	47851751	.	A	G	30	19	49	0	0	49	0	0
15	47851828	.	G	A	22	16	38	0	1	39	0	0
15	47851978	.	C	T	4	2	6	0	2	8	0	0
15	47851979	.	A	G	4	4	8	0	0	8	0	0
15	47852049	.	G	T	13	8	21	0	0	21	0	0
15	47855085	.	A	G	12	20	32	0	1	33	0	0
15	47855169	.	G	A	13	7	20	1	0	21	0	0
15	47856418	.	T	C	7	4	11	0	0	11	0	0
15	47860443	.	C	T	0	17	17	0	20	37	0	0
16	1884215	.	C	T	1	1	2	0	1	3	0	0
16	1884218	.	C	T	2	1	3	0	0	3	0	0
16	1906682	.	C	A	3	7	10	0	0	10	0	0
16	1996533	.	A	G	2	6	8	0	0	8	0	0
16	1996569	.	A	C	0	3	3	0	0	3	0	0
16	1996577	.	C	T	0	1	1	0	0	1	0	0
16	2009844	.	T	G	5	7	12	0	0	12	0	0
16	2009949	.	A	G	5	0	5	0	0	5	0	0
16	2033947	.	A	G	1	0	1	0	3	4	0	0
16	2043021	.	C	T	10	8	18	0	0	18	0	0
16	2043122	.	G	C	1	3	4	0	9	13	0	0
16	2071535	.	G	A	0	7	7	0	7	14	0	0
16	2102037	.	T	C	3	8	11	0	2	13	0	0
16	2102101	.	A	G	0	2	2	0	0	2	0	0
16	2102683	.	C	T	2	2	4	0	0	4	0	0
16	2103052	.	C	T	15	2	17	0	0	17	0	0
16	2103058	.	G	T	13	4	17	0	0	17	0	0
16	2103088	.	G	A	0	3	3	0	11	14	0	0
16	2103167	.	C	T	8	9	17	0	0	17	0	0
16	2103209	.	C	T	7	9	16	0	2	18	0	0
16	2103241	.	T	A	5	7	12	0	0	12	0	0
16	2103268	.	A	T	4	7	11	0	0	11	0	0
16	2103307	.	T	C	4	11	15	0	1	16	0	0
16	2103714	.	A	T	2	8	10	0	1	11	0	0
16	2104114	.	T	A	3	2	5	0	1	6	0	0
16	2104181	.	T	A	4	4	8	0	0	8	0	0
16	2104312	.	A	C	8	10	18	0	0	18	0	0
16	2104400	.	T	C	11	7	18	0	1	19	0	0
16	2104597	.	T	C	25	18	43	0	4	47	0	0
16	2104604	.	A	G	27	1	28	0	20	48	0	0
16	2105035	.	A	G	1	4	5	0	0	5	0	0
16	2353020	.	C	A	3	4	7	0	1	8	0	0
16	2353023	.	T	C	2	5	7	0	1	8	0	0
16	2353191	.	C	A	3	3	6	0	0	6	0	0
16	2360324	.	C	T	1	3	4	0	0	4	0	0
16	2365716	.	G	A	3	2	5	0	0	5	0	0
16	2368422	.	T	C	1	0	1	0	2	3	0	0
16	2382011	.	G	T	1	3	4	0	0	4	0	0
16	2388237	.	A	C	3	0	3	0	0	3	0	0
16	2472263	.	G	A	10	3	13	0	0	13	0	0
16	2472284	.	T	C	5	1	6	0	2	8	0	0
16	2484064	.	C	T	0	8	8	0	4	12	0	0
16	2485904	.	G	A	1	1	2	0	0	2	0	0
16	2494323	.	T	C	2	1	3	0	3	6	0	0
16	2495649	.	G	C	2	5	7	0	0	7	0	0
16	2517184	.	G	T	6	5	11	0	0	11	0	0
16	2519056	.	T	C	3	3	6	0	0	6	0	0
16	2519071	.	T	C	1	0	1	0	0	1	0	0
16	2525891	.	A	G	0	1	1	0	0	1	0	0
16	2526035	.	C	T	1	0	1	0	1	2	0	0
16	2540235	.	G	A	10	4	14	0	0	14	0	0
16	2542782	.	G	C	1	0	1	0	0	1	0	0
16	2545290	.	C	T	2	7	9	0	0	9	0	0
16	2558252	.	G	C	5	6	11	0	0	11	0	0
16	2558549	.	G	A	1	2	3	0	1	4	0	0
16	2567316	.	A	G	14	0	14	0	5	19	0	0
16	2568847	.	G	A	0	10	10	0	13	23	0	0
16	2574963	.	C	T	1	0	1	0	1	2	0	0
16	2577717	.	T	A	0	0	0	0	1	1	0	0
16	2580255	.	T	A	11	12	23	0	1	24	0	0
16	2580950	.	A	G	0	2	2	0	0	2	0	0
16	2637597	.	A	T	2	2	4	0	1	5	0	0
16	2637673	.	T	C	2	1	3	0	2	5	0	0
16	2637703	.	C	A	4	2	6	0	0	6	0	0
16	2638472	.	A	C	1	3	4	0	0	4	0	0
16	2638507	.	G	C	2	3	5	0	0	5	0	0
16	2640406	.	G	A	0	1	1	0	0	1	0	0
16	2647134	.	T	C	1	0	1	0	2	3	0	0
16	2647737	.	A	T	0	2	2	0	0	2	0	0
16	4514346	.	T	C	13	5	18	0	0	18	0	0
16	4514353	.	T	C	8	0	8	0	9	17	0	0
16	4541832	.	G	A	5	2	7	0	0	7	0	0
16	7723232	.	A	T	1	0	1	0	0	1	0	0
16	7728408	.	C	T	3	1	4	0	0	4	0	0
16	7730647	.	C	A	3	4	7	0	0	7	0	0
16	7743398	.	C	T	0	9	9	0	2	11	0	0
16	7745053	.	C	G	2	3	5	0	1	6	0	0
16	7745455	.	A	G	2	1	3	0	1	4	0	0
16	7745464	.	T	G	2	2	4	0	0	4	0	0
16	7745513	.	A	C	1	6	7	0	0	7	0	0
16	7745741	.	G	A	1	2	3	0	1	4	0	0
16	7746087	.	T	G	2	4	6	0	0	6	0	0
16	7748124	.	C	T	5	2	7	0	0	7	0	0
16	7748501	.	T	C	5	2	7	0	1	8	0	0
16	7748526	.	A	G	4	3	7	0	0	7	0	0
16	7803192	.	C	A	3	4	7	0	0	7	0	0
16	7803200	.	C	G	2	2	4	0	2	6	0	0
16	7803492	.	C	G	0	1	1	0	2	3	0	0
16	7803549	.	C	T	1	2	3	0	9	12	0	0
16	7803560	.	A	G	9	3	12	0	0	12	0	0
16	7803627	.	T	A	5	2	7	0	0	7	0	0
16	7803765	.	C	G	7	5	12	0	2	14	0	0
16	7803782	.	C	A	0	3	3	0	9	12	0	0
16	7803905	.	G	C	4	0	4	0	5	9	0	0
16	7803923	.	T	A	3	5	8	0	0	8	0	0
16	7803971	.	T	A	1	5	6	0	2	8	0	0
16	7804114	.	T	C	4	0	4	0	3	7	0	0
16	7804321	.	G	A	7	2	9	0	0	9	0	0
16	7804569	.	C	A	5	2	7	0	0	7	0	0
16	7804914	.	C	T	4	2	6	0	1	7	0	0
16	7804990	.	A	C	2	3	5	0	0	5	0	0
16	7805410	.	T	G	2	3	5	0	0	5	0	0
16	7821241	.	C	T	8	4	12	0	0	12	0	0
16	7821244	.	G	A	8	4	12	0	0	12	0	0
16	7824113	.	G	A	1	3	4	0	0	4	0	0
16	7824124	.	T	G	0	2	2	0	0	2	0	0
16	7828792	.	G	T	1	2	3	0	0	3	0	0
16	7985896	.	T	A	6	4	10	0	0	10	0	0
16	7994808	.	T	G	4	4	8	0	0	8	0	0
16	7994890	.	C	T	0	1	1	0	0	1	0	0
16	8040833	.	C	G	8	8	16	0	0	16	0	0
16	8040843	.	T	G	7	0	7	0	10	17	0	0
16	8040927	.	A	T	8	6	14	0	0	14	0	0
16	8041010	.	A	G	3	9	12	0	2	14	0	0
16	8051558	.	T	G	10	3	13	0	4	17	0	0
16	8051941	.	T	C	8	0	8	0	15	23	0	0
16	8052329	.	T	C	8	13	21	0	0	21	0	0
16	8052469	.	G	A	4	11	15	0	0	15	0	0
16	8052652	.	A	G	11	10	21	0	1	22	0	0
16	8052673	.	G	C	12	0	12	0	17	29	0	0
16	8052747	.	A	G	4	12	16	0	0	16	0	0
16	8052831	.	T	A	6	9	15	0	2	17	0	0
16	8052866	.	C	A	0	7	7	0	7	14	0	0
16	8052909	.	T	A	2	6	8	1	0	9	0	0
16	8052982	.	T	C	6	3	9	1	0	10	0	0
16	8053202	.	C	T	10	7	17	0	1	18	0	0
16	8053206	.	T	G	10	6	16	0	1	17	0	0
16	8053716	.	A	G	14	12	26	0	2	28	0	0
16	8053717	.	T	C	14	14	28	0	0	28	0	0
16	8053893	.	A	G	13	9	22	0	0	22	0	0
16	8054389	.	C	T	0	5	5	0	7	12	0	0
16	8054434	.	T	C	7	0	7	0	3	10	0	0
16	8066237	.	A	C	7	5	12	0	1	13	0	0
16	8066318	.	A	G	10	9	19	0	0	19	0	0
16	8119672	.	G	A	5	6	11	0	2	13	0	0
16	8119922	.	G	A	8	9	17	0	0	17	0	0
16	8120090	.	G	A	9	7	16	0	0	16	0	0
16	8120237	.	T	G	7	1	8	0	13	21	0	0
16	8120244	.	T	G	6	3	9	0	14	23	0	0
16	8158715	.	G	A	1	1	2	0	0	2	0	0
16	8160322	.	C	T	1	2	3	0	0	3	0	0
16	8160484	.	T	C	3	3	6	0	1	7	0	0
16	8160589	.	T	C	3	2	5	0	0	5	0	0
16	8161330	.	C	T	3	8	11	0	1	12	0	0
16	8161735	.	G	A	3	5	8	0	0	8	0	0
16	8161759	.	C	T	5	4	9	0	0	9	0	0
16	8161774	.	G	A	0	4	4	0	4	8	0	0
16	8298642	.	T	C	2	4	6	0	0	6	0	0
16	8298915	.	T	C	2	3	5	0	0	5	0	0
16	8299151	.	G	T	7	2	9	0	0	9	0	0
16	8299476	.	A	T	2	4	6	0	0	6	0	0
16	8299694	.	G	A	5	1	6	0	1	7	0	0
16	8300218	.	T	A	1	2	3	0	0	3	0	0
16	8300289	.	A	T	1	1	2	0	2	4	0	0
16	8300409	.	T	C	1	0	1	0	3	4	0	0
16	8300905	.	T	C	3	3	6	0	0	6	0	0
16	8301002	.	T	A	3	3	6	0	0	6	0	0
16	8301018	.	T	A	3	2	5	0	1	6	0	0
16	8301045	.	T	C	2	3	5	0	0	5	0	0
16	8301175	.	A	C	1	2	3	0	0	3	0	0
16	8323452	.	C	T	1	1	2	0	0	2	0	0
16	8342695	.	C	T	0	3	3	0	2	5	0	0
16	8531249	.	C	T	0	3	3	0	1	4	0	0
16	8531293	.	A	G	2	5	7	0	0	7	0	0
16	8531643	.	G	A	10	4	14	0	0	14	0	0
16	8531682	.	C	T	12	5	17	0	0	17	0	0
16	8531744	.	T	C	3	5	8	0	0	8	0	0
16	8532168	.	C	T	2	4	6	0	0	6	0	0
16	8536034	.	T	A	2	2	4	0	0	4	0	0
16	8536133	.	T	C	1	0	1	0	5	6	0	0
16	8539523	.	C	T	5	5	10	0	0	10	0	0
16	8542854	.	A	G	1	2	3	0	0	3	0	0
16	8542888	.	T	C	1	1	2	0	0	2	0	0
16	8771091	.	A	G	5	5	10	0	1	11	0	0
16	8772812	.	A	T	9	9	18	0	1	19	0	0
16	8772821	.	A	G	8	7	15	0	1	16	0	0
16	8788446	.	A	G	11	8	19	0	1	20	0	0
16	8816122	.	G	A	2	0	2	0	0	2	0	0
16	8819113	.	T	C	2	0	2	0	0	2	0	0
16	8834732	.	A	G	1	1	2	0	0	2	0	0
16	8837830	.	G	A	3	11	14	0	0	14	0	0
16	8837836	.	C	T	0	11	11	0	3	14	0	0
16	8845726	.	C	T	15	13	28	0	1	29	0	0
16	8845738	.	T	G	12	11	23	0	1	24	0	0
16	8847272	.	T	C	3	5	8	0	0	8	0	0
16	8873907	.	A	G	4	2	6	0	0	7	1	0
16	8888205	.	G	A	2	1	3	0	0	3	0	0
16	8890929	.	G	T	4	3	7	0	2	9	0	0
16	8905929	.	C	T	8	6	14	0	0	14	0	0
16	8905971	.	C	T	6	5	11	0	0	11	0	0
16	8905997	.	C	T	4	2	6	0	0	6	0	0
16	8906085	.	G	A	3	1	4	0	0	4	0	0
16	8918597	.	C	T	0	1	1	0	0	1	0	0
16	8927360	.	C	T	0	1	1	1	0	2	0	0
16	9267427	.	T	C	0	2	2	0	0	2	0	0
16	9275806	.	C	T	6	4	10	0	0	10	0	0
16	9276038	.	T	A	7	6	13	0	0	13	0	0
16	9281297	.	T	C	5	3	8	0	0	8	0	0
16	9286987	.	A	G	2	0	2	0	1	3	0	0
16	9292698	.	T	C	1	0	1	0	0	1	0	0
16	9299775	.	A	T	3	1	4	0	0	4	0	0
16	9300116	.	A	C	3	0	3	0	1	4	0	0
16	9300314	.	G	A	5	5	10	0	1	11	0	0
16	9313294	.	T	C	1	2	3	0	0	3	0	0
16	9411083	.	G	A	3	4	7	0	0	7	0	0
16	9412350	.	C	T	4	2	6	0	0	6	0	0
16	9412354	.	C	A	4	2	6	0	0	6	0	0
16	9412401	.	C	T	7	3	10	0	0	10	0	0
16	9412615	.	T	G	4	3	7	0	0	7	0	0
16	9415063	.	C	T	1	2	3	0	0	3	0	0
16	9415124	.	T	A	1	2	3	0	0	3	0	0
16	9415793	.	C	T	4	2	6	0	0	6	0	0
16	9420215	.	G	C	2	2	4	0	0	4	0	0
16	9420260	.	A	G	2	3	5	0	0	5	0	0
16	9433808	.	T	A	1	2	3	0	0	3	0	0
16	9433855	.	A	G	1	3	4	0	0	4	0	0
16	9434086	.	A	C	6	2	8	0	1	9	0	0
16	9438075	.	A	G	1	3	4	0	0	4	0	0
16	9446996	.	T	C	1	6	7	0	0	7	0	0
16	9453451	.	C	T	0	1	1	0	1	2	0	0
16	9580775	.	A	G	1	3	4	0	1	5	0	0
16	9580841	.	C	A	2	1	3	0	0	3	0	0
16	9584145	.	A	G	3	2	5	0	0	5	0	0
16	9585373	.	G	T	0	5	5	0	1	6	0	0
16	9602643	.	T	C	1	3	4	0	0	4	0	0
16	9603382	.	T	C	3	4	7	0	0	7	0	0
16	9605619	.	T	C	7	4	11	0	0	11	0	0
16	9605806	.	A	G	3	3	6	0	1	7	0	0
16	9605850	.	A	G	5	3	8	0	0	8	0	0
16	9713878	.	A	G	1	2	3	0	0	3	0	0
16	9714080	.	G	A	7	3	10	0	1	11	0	0
16	9714133	.	A	G	3	4	7	0	0	7	0	0
16	9724878	.	A	T	9	6	15	0	0	15	0	0
16	9745471	.	C	T	2	3	5	0	0	5	0	0
16	9751678	.	T	C	4	7	11	0	0	11	0	0
16	9751693	.	A	C	6	3	9	0	1	10	0	0
16	9752273	.	T	C	0	1	1	0	0	1	0	0
16	9752318	.	G	A	1	1	2	0	0	2	0	0
16	9755612	.	C	T	1	1	2	0	0	2	0	0
16	9758128	.	C	T	2	1	3	0	0	3	0	0
16	9758164	.	C	T	1	3	4	0	0	4	0	0
16	9758485	.	G	A	2	7	9	0	0	9	0	0
16	9758844	.	A	G	3	7	10	0	0	10	0	0
16	9758944	.	G	A	0	5	5	0	4	9	0	0
16	9758958	.	T	C	5	4	9	0	0	9	0	0
16	9758985	.	A	G	3	0	3	0	4	7	0	0
16	9759090	.	T	C	0	9	9	0	1	10	0	0
16	9759376	.	C	T	3	5	8	0	0	8	0	0
16	9759464	.	C	G	7	9	16	0	0	16	0	0
16	9759554	.	G	A	0	9	9	0	6	15	0	0
16	9759703	.	C	G	6	0	6	0	4	10	0	0
16	9761004	.	A	G	3	11	14	0	0	14	0	0
16	9761141	.	G	A	1	10	11	0	6	17	0	0
16	9761336	.	T	A	4	8	12	0	0	12	0	0
16	9761525	.	G	A	7	9	16	0	0	16	0	0
16	9766774	.	T	C	7	5	12	0	0	12	0	0
16	9777589	.	A	T	16	11	27	0	0	27	0	0
16	9777629	.	A	T	15	12	27	0	1	28	0	0
16	9785860	.	G	A	27	12	39	0	6	45	0	0
16	9785868	.	T	G	29	17	46	0	0	46	0	0
16	9785990	.	G	A	12	13	25	0	1	26	0	0
16	9787392	.	T	A	10	3	13	0	0	13	0	0
16	9788504	.	A	T	11	14	25	0	1	26	0	0
16	9789007	.	A	T	6	7	13	0	0	13	0	0
16	9789317	.	T	C	7	4	11	0	0	11	0	0
16	9807324	.	C	G	2	3	5	0	0	5	0	0
16	9807463	.	A	G	3	4	7	0	1	8	0	0
16	9833482	.	A	T	5	3	8	0	0	8	0	0
16	9833559	.	A	T	5	4	9	0	1	10	0	0
16	9833577	.	G	A	5	3	8	0	5	14	1	0
16	9833791	.	T	A	17	23	40	0	5	45	0	0
16	9833936	.	A	G	12	33	45	0	5	50	0	0
16	9833974	.	G	A	18	31	49	0	2	51	0	0
16	9834258	.	G	A	20	16	36	0	2	38	0	0
16	9835070	.	A	G	23	0	23	0	5	28	0	0
16	9868953	.	C	T	22	23	45	0	2	47	0	0
16	9978220	.	A	G	16	15	31	0	0	31	0	0
16	9978252	.	A	G	25	12	37	0	1	38	0	0
16	9978350	.	A	T	21	17	38	0	2	40	0	0
16	9978438	.	G	A	9	7	16	0	0	16	0	0
16	9980299	.	A	T	13	8	21	1	2	24	0	0
16	10027167	.	G	C	1	0	1	0	1	2	0	0
16	10038806	.	A	T	0	1	1	0	0	1	0	0
16	10038938	.	T	C	2	3	5	0	0	5	0	0
16	10038956	.	A	G	1	1	2	0	0	2	0	0
16	10055730	.	C	A	3	2	5	0	0	5	0	0
16	10055745	.	C	A	3	4	7	0	0	7	0	0
16	10055865	.	G	A	3	2	5	0	1	6	0	0
16	10055952	.	A	G	5	2	7	0	0	7	0	0
16	10055956	.	G	C	5	0	5	0	2	7	0	0
16	10056127	.	T	G	0	1	1	0	0	1	0	0
16	10058852	.	T	C	5	6	11	0	0	11	0	0
16	10058854	.	G	T	5	6	11	0	0	11	0	0
16	10065578	.	G	A	2	3	5	0	1	6	0	0
16	10065869	.	C	T	4	6	10	0	0	10	0	0
16	10065881	.	G	A	3	2	5	0	1	6	0	0
16	10068116	.	C	A	3	1	4	0	0	4	0	0
16	10068168	.	C	T	3	0	3	0	0	3	0	0
16	10071730	.	G	A	2	6	8	0	0	8	0	0
16	10071777	.	C	T	8	6	14	0	2	16	0	0
16	10071812	.	C	T	7	6	13	0	1	14	0	0
16	10097449	.	G	A	1	4	5	0	0	5	0	0
16	10210162	.	A	T	0	2	2	0	0	2	0	0
16	10264672	.	G	C	1	2	3	0	0	3	0	0
16	10636173	.	A	G	5	5	10	0	0	10	0	0
16	10636534	.	A	G	8	9	17	0	3	20	0	0
16	10820667	.	T	C	31	26	57	0	1	58	0	0
16	10828887	.	T	C	6	2	8	0	1	9	0	0
16	10829019	.	T	C	8	13	21	0	0	21	0	0
16	10829139	.	A	G	7	15	22	0	0	22	0	0
16	10829221	.	C	T	1	2	3	0	0	3	0	0
16	10829235	.	G	A	3	4	7	0	0	7	0	0
16	10829256	.	T	A	9	3	12	0	0	12	0	0
16	10829276	.	T	A	8	3	11	0	1	12	0	0
16	10829872	.	G	C	7	13	20	0	1	21	0	0
16	10829968	.	T	G	12	8	20	0	4	24	0	0
16	10830431	.	G	A	10	14	24	0	0	24	0	0
16	10832217	.	C	T	2	2	4	0	0	4	0	0
16	10833987	.	G	A	17	6	23	0	0	23	0	0
16	10833993	.	C	T	0	18	18	0	7	25	0	0
16	10834715	.	A	C	2	3	5	0	0	5	0	0
16	10841177	.	A	G	5	4	9	0	0	9	0	0
16	10843402	.	A	G	2	0	2	0	4	6	0	0
16	10856130	.	A	G	8	7	15	0	0	15	0	0
16	10858377	.	A	G	3	19	22	0	0	22	0	0
16	10859434	.	C	T	22	14	36	0	2	38	0	0
16	10859435	.	T	C	22	15	37	0	1	38	0	0
16	10862159	.	T	A	5	17	22	0	2	24	0	0
16	10862162	.	T	A	5	18	23	0	0	23	0	0
16	10862279	.	A	G	13	7	20	0	1	21	0	0
16	10862280	.	G	T	11	7	18	0	3	21	0	0
16	10862331	.	C	G	14	9	23	0	0	23	0	0
16	10862773	.	T	C	18	16	34	0	2	36	0	0
16	10918789	.	A	G	2	2	4	0	0	4	0	0
16	10919100	.	G	A	1	5	6	0	2	8	0	0
16	10919235	.	T	G	1	1	2	0	1	3	0	0
16	10919482	.	C	A	0	2	2	0	6	8	0	0
16	10982359	.	T	C	1	1	2	0	0	2	0	0
16	10987970	.	A	C	2	3	5	0	0	5	0	0
16	10988696	.	G	C	0	5	5	0	2	7	0	0
16	10988778	.	A	G	2	3	5	0	1	6	0	0
16	10989815	.	C	T	1	2	3	0	0	3	0	0
16	10990344	.	A	G	3	3	6	0	0	6	0	0
16	10990490	.	G	A	1	2	3	0	0	3	0	0
16	10991162	.	T	A	1	2	3	0	2	5	0	0
16	11135511	.	C	T	3	3	6	0	1	7	0	0
16	11135904	.	G	A	2	0	2	0	0	2	0	0
16	11137369	.	G	T	2	1	3	0	0	3	0	0
16	11137612	.	C	A	2	2	4	0	0	4	0	0
16	11137837	.	G	C	1	2	3	0	1	4	0	0
16	11138021	.	C	T	6	7	13	0	0	13	0	0
16	11139076	.	T	A	2	3	5	0	0	5	0	0
16	11140001	.	A	G	1	0	1	0	6	7	0	0
16	11140322	.	A	G	5	0	5	0	5	10	0	0
16	11140344	.	A	G	9	0	9	0	2	11	0	0
16	11140364	.	A	G	4	5	9	0	0	9	0	0
16	11140542	.	G	T	0	2	2	0	6	8	0	0
16	11140569	.	A	G	3	8	11	0	0	11	0	0
16	11140586	.	A	T	5	3	8	0	1	9	0	0
16	11140894	.	A	G	5	3	8	0	1	9	0	0
16	11140896	.	G	A	4	4	8	0	1	9	0	0
16	11140933	.	A	T	3	3	6	0	0	6	0	0
16	11141200	.	C	T	1	5	6	0	0	6	0	0
16	11141325	.	A	G	2	4	6	0	0	6	0	0
16	11141338	.	C	T	1	4	5	0	0	5	0	0
16	11141430	.	G	A	3	4	7	0	1	8	0	0
16	11141451	.	C	G	5	3	8	0	0	8	0	0
16	11141466	.	A	T	3	5	8	0	0	8	0	0
16	11141836	.	G	A	8	4	12	0	0	12	0	0
16	11142018	.	G	A	0	6	6	0	5	11	0	0
16	11142032	.	A	T	5	6	11	0	0	11	0	0
16	11142064	.	G	A	5	4	9	0	1	10	0	0
16	11142111	.	A	G	3	5	8	0	0	8	0	0
16	11142428	.	A	G	5	7	12	0	1	13	0	0
16	11142451	.	A	C	5	5	10	0	0	10	0	0
16	11151884	.	G	A	3	3	6	0	1	7	0	0
16	11166805	.	C	T	5	2	7	0	0	7	0	0
16	11166806	.	C	T	2	5	7	0	0	7	0	0
16	11166851	.	G	A	4	5	9	0	1	10	0	0
16	11166857	.	A	T	2	8	10	0	0	10	0	0
16	11167260	.	C	T	4	5	9	0	1	10	0	0
16	11167512	.	A	G	5	0	5	0	3	8	0	0
16	11168817	.	A	C	3	8	11	0	1	12	0	0
16	11168831	.	T	C	4	8	12	0	0	12	0	0
16	11169325	.	C	A	3	5	8	0	0	8	0	0
16	11169381	.	C	T	7	7	14	0	0	14	0	0
16	11169843	.	T	A	12	3	15	0	2	17	0	0
16	11170202	.	C	T	7	4	11	0	0	11	0	0
16	11190369	.	G	A	0	2	2	0	0	2	0	0
16	11195922	.	G	A	4	1	5	0	0	5	0	0
16	11199220	.	C	T	6	9	15	0	2	18	1	0
16	11199460	.	G	A	2	13	15	0	18	33	0	0
16	11199533	.	C	T	21	17	38	0	0	38	0	0
16	11212260	.	C	A	16	5	21	0	0	21	0	0
16	11212332	.	A	T	11	19	30	0	1	31	0	0
16	11212398	.	A	G	18	12	30	0	0	30	0	0
16	11215022	.	G	T	15	15	30	0	0	30	0	0
16	11221071	.	A	G	16	17	33	0	0	33	0	0
16	11221153	.	A	C	11	19	30	0	0	30	0	0
16	11221398	.	G	A	14	11	25	0	0	25	0	0
16	11221406	.	A	C	13	7	20	0	2	22	0	0
16	11222031	.	T	A	10	9	19	0	2	21	0	0
16	11228292	.	T	G	3	4	7	0	0	7	0	0
16	11228424	.	G	A	3	2	5	0	0	5	0	0
16	11228751	.	G	A	1	2	3	0	0	3	0	0
16	11229180	.	G	T	1	2	3	0	0	3	0	0
16	11231327	.	G	A	1	2	3	0	0	3	0	0
16	11231621	.	T	A	1	4	5	0	0	5	0	0
16	11231644	.	C	A	0	2	2	0	0	2	0	0
16	11242495	.	T	A	16	20	36	0	0	36	0	0
16	11242542	.	C	G	19	17	36	0	1	37	0	0
16	11275795	.	C	T	14	9	23	0	0	23	0	0
16	11275980	.	A	G	3	1	4	0	3	7	0	0
16	11276019	.	A	T	0	1	1	0	0	1	0	0
16	11290844	.	C	A	12	7	19	0	0	19	0	0
16	11290903	.	T	A	6	9	15	0	0	15	0	0
16	11303384	.	T	A	1	0	1	0	0	1	0	0
16	11313379	.	C	T	2	2	4	0	0	4	0	0
16	11314144	.	A	G	1	5	6	0	1	7	0	0
16	11318700	.	A	G	2	3	5	0	0	5	0	0
16	11344457	.	T	C	4	2	6	0	0	6	0	0
16	11486258	.	G	A	0	1	1	0	1	2	0	0
16	11486360	.	G	A	0	1	1	0	1	2	0	0
16	11506075	.	C	T	4	2	6	0	0	6	0	0
16	11506128	.	G	A	0	2	2	0	2	4	0	0
16	11531069	.	T	C	4	3	7	0	0	7	0	0
16	11533897	.	C	T	2	1	3	0	1	4	0	0
16	11541776	.	T	C	3	5	8	0	0	8	0	0
16	11542083	.	C	T	7	7	14	0	0	14	0	0
16	11544636	.	A	G	7	6	13	0	0	13	0	0
16	11544645	.	A	T	5	5	10	0	0	10	0	0
16	11544672	.	T	C	3	4	7	0	0	7	0	0
16	11554859	.	C	T	4	6	10	0	0	10	0	0
16	11554874	.	A	G	4	1	5	0	8	13	0	0
16	11554907	.	T	C	9	7	16	0	0	16	0	0
16	11554916	.	A	G	7	8	15	0	2	17	0	0
16	11554970	.	A	C	13	10	23	0	2	25	0	0
16	11555034	.	A	C	23	11	34	0	0	34	0	0
16	11555160	.	C	T	17	13	30	0	3	33	0	0
16	11555542	.	T	A	14	7	21	0	2	23	0	0
16	11773932	.	T	C	4	1	5	0	11	16	0	0
16	11774237	.	T	C	14	0	14	0	17	31	0	0
16	11774291	.	G	A	11	14	25	0	3	28	0	0
16	11774398	.	T	C	8	6	14	0	0	14	0	0
16	11774456	.	G	A	2	7	9	0	0	9	0	0
16	11774790	.	A	T	13	6	19	0	0	19	0	0
16	11775084	.	G	T	8	6	14	0	0	15	1	0
16	11775361	.	T	C	12	4	16	0	1	17	0	0
16	11775485	.	G	A	7	11	18	0	0	18	0	0
16	11775614	.	G	A	17	16	33	0	2	35	0	0
16	11968056	.	A	G	3	13	16	0	1	17	0	0
16	11970128	.	A	G	5	8	13	0	2	15	0	0
16	11970161	.	G	A	9	8	17	1	5	23	0	0
16	11970239	.	C	T	6	5	11	0	0	11	0	0
16	11974720	.	G	T	10	7	17	0	1	18	0	0
16	11978045	.	G	A	13	18	31	0	0	31	0	0
16	11979494	.	G	A	1	4	5	0	0	5	0	0
16	11979590	.	T	C	11	7	18	0	0	18	0	0
16	11980484	.	C	T	0	0	0	0	3	3	0	0
16	11982269	.	G	A	14	7	21	0	0	21	0	0
16	11986208	.	G	A	5	8	13	0	1	14	0	0
16	11986257	.	G	A	17	14	31	0	1	32	0	0
16	11986258	.	C	T	0	14	14	0	18	32	0	0
16	12060252	.	G	T	0	1	1	0	0	1	0	0
16	12064906	.	A	T	5	5	10	0	1	11	0	0
16	12064946	.	C	T	4	7	11	0	0	11	0	0
16	12065025	.	G	A	8	14	22	0	1	23	0	0
16	12065392	.	G	A	13	13	26	0	2	28	0	0
16	12069729	.	C	T	0	12	12	0	9	21	0	0
16	12078042	.	T	C	1	0	1	0	0	1	0	0
16	12078916	.	A	G	4	1	5	0	0	5	0	0
16	12078976	.	C	T	1	2	3	0	0	3	0	0
16	12095065	.	C	T	2	4	6	0	1	7	0	0
16	12095076	.	C	T	2	3	5	0	1	6	0	0
16	12097325	.	G	A	6	9	15	0	0	15	0	0
16	12097354	.	G	T	8	8	16	0	1	17	0	0
16	12102412	.	A	T	10	12	22	0	0	22	0	0
16	12102432	.	T	A	15	16	31	0	0	31	0	0
16	12102492	.	A	T	18	19	37	0	0	37	0	0
16	12102671	.	T	C	25	36	61	0	1	62	0	0
16	12102708	.	A	G	32	32	64	0	1	65	0	0
16	12102709	.	G	A	32	30	62	0	3	65	0	0
16	12102947	.	C	A	6	28	34	0	1	35	0	0
16	12103331	.	T	A	27	26	53	0	0	53	0	0
16	12103421	.	T	A	24	26	50	0	1	51	0	0
16	12103540	.	G	A	33	22	55	0	0	55	0	0
16	12103749	.	C	T	11	11	22	0	1	23	0	0
16	12103873	.	C	T	3	19	22	0	34	56	0	0
16	12103881	.	G	A	34	19	53	0	2	55	0	0
16	12103982	.	G	A	30	24	54	0	4	58	0	0
16	12104290	.	T	C	3	7	10	0	0	10	0	0
16	12104454	.	T	C	1	12	13	0	0	13	0	0
16	12104455	.	G	A	1	12	13	0	0	13	0	0
16	12104827	.	G	A	27	7	34	0	1	35	0	0
16	12104851	.	A	G	31	6	37	0	2	39	0	0
16	12104905	.	A	T	32	9	41	0	0	41	0	0
16	12104925	.	C	G	29	20	49	0	1	50	0	0
16	12105265	.	T	A	29	12	41	0	2	43	0	0
16	12105443	.	A	T	5	6	11	0	0	11	0	0
16	12105689	.	C	T	1	30	31	0	14	45	0	0
16	12105720	.	T	C	12	26	38	0	1	39	0	0
16	12108622	.	A	G	26	30	56	0	1	57	0	0
16	12114975	.	G	A	10	7	17	0	1	18	0	0
16	12115290	.	G	A	4	7	11	0	0	11	0	0
16	12117537	.	G	A	8	7	15	0	1	16	0	0
16	12117645	.	G	A	6	4	10	0	1	11	0	0
16	12117648	.	G	A	7	4	11	0	0	11	0	0
16	12126861	.	T	C	12	0	12	0	15	27	0	0
16	12126930	.	C	G	0	5	5	0	2	7	0	0
16	12127040	.	A	G	6	3	9	0	0	9	0	0
16	12138964	.	G	A	23	15	38	0	1	39	0	0
16	12138991	.	T	C	17	0	17	0	16	33	0	0
16	12143710	.	C	T	6	1	7	0	0	7	0	0
16	12150856	.	C	A	0	15	15	0	3	18	0	0
16	12174891	.	C	T	3	3	6	0	0	6	0	0
16	12175047	.	T	G	2	6	8	0	0	9	1	0
16	12175281	.	G	A	8	4	12	0	0	12	0	0
16	12175594	.	A	G	5	4	9	0	0	9	0	0
16	12185382	.	A	G	1	1	2	0	0	2	0	0
16	12185555	.	G	A	1	2	3	0	0	3	0	0
16	12243571	.	C	T	8	7	15	0	0	15	0	0
16	12245691	.	G	A	7	4	11	0	0	11	0	0
16	12254457	.	C	T	26	30	56	0	5	61	0	0
16	12254469	.	T	C	35	35	70	0	0	70	0	0
16	12254592	.	T	C	27	25	52	0	5	57	0	0
16	12254674	.	C	T	22	20	42	0	1	43	0	0
16	12254776	.	A	T	22	25	47	0	2	49	0	0
16	12256585	.	C	T	8	5	13	0	2	15	0	0
16	12256614	.	G	A	15	13	28	0	1	29	0	0
16	12256629	.	A	G	15	16	31	0	3	34	0	0
16	12256681	.	C	A	1	26	27	0	22	49	0	0
16	12256801	.	C	T	20	19	39	0	3	42	0	0
16	12256816	.	G	T	22	12	34	0	2	36	0	0
16	12257154	.	T	C	13	29	42	0	1	43	0	0
16	12257216	.	A	T	21	17	38	0	3	41	0	0
16	12257506	.	G	A	16	15	31	0	1	32	0	0
16	12257904	.	C	T	15	27	42	0	4	46	0	0
16	12257921	.	T	G	17	21	38	0	2	40	0	0
16	12258044	.	C	T	11	7	18	0	0	18	0	0
16	12258128	.	A	T	7	7	14	0	0	14	0	0
16	12258264	.	G	C	8	4	12	0	1	13	0	0
16	12258268	.	C	T	9	5	14	0	0	14	0	0
16	12258302	.	A	T	8	4	12	0	0	12	0	0
16	12258593	.	T	G	5	12	17	0	1	18	0	0
16	12258733	.	A	T	4	11	15	0	0	15	0	0
16	12258999	.	G	C	12	26	38	0	2	40	0	0
16	12259023	.	T	C	14	27	41	0	0	41	0	0
16	12259084	.	T	A	8	14	22	0	3	25	0	0
16	12259087	.	A	G	10	13	23	0	1	24	0	0
16	12259298	.	G	C	20	4	24	0	2	26	0	0
16	12259302	.	A	T	23	3	26	0	1	27	0	0
16	12259589	.	G	A	15	19	34	0	1	35	0	0
16	12259678	.	T	C	20	13	33	0	0	33	0	0
16	12259737	.	A	T	24	12	36	0	3	39	0	0
16	12260002	.	T	G	20	15	35	0	2	37	0	0
16	12260134	.	A	T	18	18	36	0	0	36	0	0
16	12260291	.	G	T	17	7	24	0	2	27	1	0
16	12261211	.	A	G	2	6	8	0	1	9	0	0
16	12261625	.	A	G	12	13	25	0	0	25	0	0
16	12262453	.	T	G	3	1	4	0	1	5	0	0
16	12262762	.	T	A	0	1	1	0	0	1	0	0
16	12263223	.	A	G	23	13	36	0	0	36	0	0
16	12263358	.	C	T	0	12	12	0	25	37	0	0
16	12265917	.	C	G	3	2	5	0	0	5	0	0
16	12266073	.	G	A	11	14	25	0	0	25	0	0
16	12266113	.	T	C	5	12	17	0	1	18	0	0
16	12266130	.	C	A	0	8	8	0	5	13	0	0
16	12267853	.	T	C	8	8	16	0	1	17	0	0
16	12273653	.	A	G	10	7	17	0	0	17	0	0
16	12276030	.	G	A	22	19	41	0	2	43	0	0
16	12276033	.	A	T	22	20	42	0	1	43	0	0
16	12286264	.	C	A	4	22	26	0	1	27	0	0
16	12286460	.	A	T	1	1	2	0	0	2	0	0
16	12292467	.	G	A	0	21	21	0	15	36	0	0
16	12292599	.	T	C	1	0	1	0	0	1	0	0
16	12292622	.	G	A	3	12	15	0	1	16	0	0
16	12292648	.	T	C	3	14	17	0	2	19	0	0
16	12294274	.	T	A	6	10	16	0	1	17	0	0
16	12294275	.	G	T	7	9	16	0	1	17	0	0
16	12294316	.	C	A	7	6	13	0	0	13	0	0
16	12346425	.	G	T	1	2	3	0	0	3	0	0
16	12367100	.	A	G	0	1	1	0	0	1	0	0
16	12403433	.	C	T	0	2	2	0	1	3	0	0
16	12475624	.	G	A	1	2	3	0	0	3	0	0
16	12505303	.	G	T	34	23	57	0	1	58	0	0
16	12632593	.	G	C	3	3	6	0	0	6	0	0
16	12632664	.	T	C	1	1	2	0	0	2	0	0
16	12636911	.	A	C	5	9	14	0	3	17	0	0
16	12637140	.	T	C	3	3	6	0	0	6	0	0
16	12637314	.	A	C	3	2	5	0	0	5	0	0
16	12637433	.	A	C	3	8	11	0	0	11	0	0
16	12637434	.	A	G	3	0	3	0	8	11	0	0
16	12637543	.	C	T	2	6	8	0	0	8	0	0
16	12637624	.	G	A	6	5	11	0	1	12	0	0
16	12637779	.	C	T	10	5	15	0	0	15	0	0
16	12637798	.	A	G	11	3	14	0	0	14	0	0
16	12638349	.	A	C	0	2	2	0	0	2	0	0
16	12638612	.	C	G	3	3	6	1	0	7	0	0
16	12639156	.	T	A	5	6	11	0	0	11	0	0
16	12639161	.	C	G	5	0	5	0	6	11	0	0
16	12639377	.	T	G	10	4	14	0	1	15	0	0
16	12639503	.	T	G	3	4	7	0	0	7	0	0
16	12730707	.	A	G	1	2	3	0	0	3	0	0
16	12740779	.	C	T	2	5	7	0	1	8	0	0
16	12740926	.	C	T	2	2	4	0	0	4	0	0
16	12744048	.	G	A	0	2	2	0	1	3	0	0
16	12747312	.	A	G	10	8	18	0	2	20	0	0
16	12748058	.	A	G	1	0	1	0	9	10	0	0
16	12748517	.	A	T	11	8	19	0	1	20	0	0
16	12748646	.	G	A	0	13	13	0	15	28	0	0
16	12748857	.	G	A	1	1	2	0	0	2	0	0
16	12748908	.	G	C	0	4	4	0	12	16	0	0
16	12748944	.	A	G	17	4	21	0	1	22	0	0
16	12748989	.	T	C	2	5	7	0	1	8	0	0
16	12754690	.	C	T	3	4	7	0	2	9	0	0
16	12754858	.	G	T	1	19	20	0	16	36	0	0
16	12755011	.	G	A	11	13	24	0	0	24	0	0
16	12755260	.	G	A	0	21	21	0	18	39	0	0
16	12756094	.	A	C	9	9	18	0	0	18	0	0
16	12794075	.	C	G	3	4	7	0	0	7	0	0
16	12807038	.	G	A	1	2	3	0	0	3	0	0
16	12809604	.	T	C	1	9	10	0	0	10	0	0
16	12809645	.	G	A	0	3	3	0	0	3	0	0
16	12812496	.	T	C	2	4	6	0	0	6	0	0
16	12814102	.	A	T	3	4	7	0	1	8	0	0
16	12814300	.	T	A	2	1	3	0	2	5	0	0
16	12816160	.	A	G	4	4	8	0	0	8	0	0
16	12816745	.	A	C	11	5	16	0	0	16	0	0
16	12820952	.	C	T	7	8	15	0	7	22	0	0
16	12821091	.	C	A	17	18	35	0	2	37	0	0
16	12821300	.	G	C	0	11	11	0	18	29	0	0
16	12821370	.	A	T	11	8	19	0	2	21	0	0
16	12821371	.	G	A	11	9	20	0	1	21	0	0
16	12821449	.	G	A	13	19	32	0	1	33	0	0
16	12821459	.	A	G	14	20	34	0	1	35	0	0
16	12821497	.	T	C	10	20	30	1	2	33	0	0
16	12882543	.	A	G	18	15	33	0	1	34	0	0
16	12883484	.	G	C	8	10	18	0	1	19	0	0
16	12884513	.	G	A	4	2	6	0	0	6	0	0
16	12953670	.	C	T	11	13	24	0	0	24	0	0
16	12963405	.	A	G	11	10	21	0	2	23	0	0
16	13038004	.	T	C	4	0	4	0	3	7	0	0
16	13056405	.	G	A	0	4	4	0	0	4	0	0
16	13072076	.	G	A	0	1	1	0	0	1	0	0
16	13179335	.	G	A	9	4	13	0	0	13	0	0
16	13180193	.	G	A	3	2	5	0	0	5	0	0
16	13180389	.	T	C	1	5	6	0	0	6	0	0
16	13201085	.	A	G	0	1	1	0	0	1	0	0
16	13453348	.	G	A	2	2	4	0	0	4	0	0
16	13569205	.	A	T	0	3	3	0	1	4	0	0
16	13600680	.	A	C	11	12	23	0	0	23	0	0
16	13601013	.	A	G	6	14	20	0	1	21	0	0
16	13601026	.	T	C	7	11	18	0	1	19	0	0
16	13601228	.	A	T	5	2	7	0	1	8	0	0
16	13601235	.	C	T	1	7	8	0	0	8	0	0
16	13601964	.	T	C	8	0	8	0	12	20	0	0
16	13602164	.	T	C	5	7	12	0	0	12	0	0
16	13602454	.	T	A	10	13	23	0	1	24	0	0
16	13602488	.	T	C	10	8	18	0	0	18	0	0
16	13602922	.	A	G	8	5	13	0	0	13	0	0
16	13603007	.	T	G	9	15	24	0	4	28	0	0
16	13606896	.	A	T	1	5	6	0	0	6	0	0
16	13610651	.	A	T	4	3	7	0	0	7	0	0
16	13610966	.	A	G	11	10	21	0	0	21	0	0
16	13611035	.	G	A	6	10	16	0	0	16	0	0
16	13612999	.	T	A	4	8	12	0	1	13	0	0
16	13613104	.	T	C	5	2	7	0	0	7	0	0
16	13613148	.	C	T	3	2	5	0	0	5	0	0
16	13613208	.	A	T	3	6	9	0	0	9	0	0
16	13613210	.	C	A	3	6	9	0	0	9	0	0
16	13616698	.	A	T	5	13	18	0	0	18	0	0
16	13616862	.	G	C	7	7	14	0	0	14	0	0
16	13617152	.	C	T	10	8	18	0	0	18	0	0
16	13617291	.	G	A	7	7	14	0	0	14	0	0
16	13618172	.	C	G	4	18	22	0	1	23	0	0
16	13618374	.	A	T	13	11	24	0	1	25	0	0
16	13618662	.	T	A	10	8	18	0	0	18	0	0
16	13620832	.	T	C	6	4	10	0	0	10	0	0
16	13621056	.	G	A	5	7	12	0	1	13	0	0
16	13621998	.	G	C	4	0	4	0	3	7	0	0
16	13622600	.	G	A	1	2	3	0	0	3	0	0
16	13622643	.	A	T	1	2	3	0	0	3	0	0
16	13622769	.	T	A	1	3	4	0	0	4	0	0
16	13622770	.	G	T	1	2	3	0	1	4	0	0
16	13623642	.	T	A	5	5	10	0	0	10	0	0
16	13643504	.	C	T	0	21	21	0	17	38	0	0
16	13643974	.	C	T	0	13	13	0	14	27	0	0
16	13644781	.	T	A	6	6	12	0	1	13	0	0
16	13645495	.	C	T	7	6	13	0	0	13	0	0
16	13673143	.	T	C	1	9	10	0	0	10	0	0
16	13673734	.	A	C	4	6	10	0	0	10	0	0
16	13674176	.	T	G	8	8	16	0	0	16	0	0
16	13679037	.	A	G	1	1	2	0	0	2	0	0
16	13680357	.	T	G	1	5	6	0	0	6	0	0
16	13680487	.	T	G	5	4	9	0	0	9	0	0
16	13685800	.	G	A	2	4	6	0	0	6	0	0
16	13701482	.	C	T	4	6	10	0	0	10	0	0
16	13701599	.	A	G	2	6	8	0	0	8	0	0
16	13706207	.	G	C	6	7	13	0	0	13	0	0
16	13721408	.	C	T	8	6	14	0	0	14	0	0
16	13729810	.	C	T	7	3	10	0	0	10	0	0
16	13741610	.	G	A	1	9	10	0	0	10	0	0
16	13743390	.	G	A	9	5	14	0	0	14	0	0
16	13780375	.	G	A	6	10	16	0	0	16	0	0
16	13789765	.	G	A	4	5	9	0	0	9	0	0
16	13810372	.	G	A	2	2	4	0	0	4	0	0
16	13810627	.	T	C	1	2	3	0	0	3	0	0
16	13810817	.	T	A	1	2	3	0	1	4	0	0
16	13810830	.	T	C	1	2	3	0	0	3	0	0
16	13818640	.	T	A	4	3	7	0	0	7	0	0
16	13818644	.	G	A	4	3	7	0	0	7	0	0
16	13826195	.	C	T	4	2	6	0	0	6	0	0
16	13833484	.	T	A	3	1	4	0	0	4	0	0
16	13841360	.	T	A	2	3	5	0	1	6	0	0
16	13845350	.	G	A	13	9	22	0	0	22	0	0
16	13845368	.	G	A	1	8	9	0	11	20	0	0
16	13845571	.	T	A	4	9	13	0	1	14	0	0
16	13855121	.	C	T	11	12	23	0	0	23	0	0
16	13855142	.	T	C	15	12	27	0	0	27	0	0
16	13855179	.	A	G	21	0	21	0	15	36	0	0
16	13855482	.	T	A	9	15	24	0	1	25	0	0
16	13856554	.	T	C	2	4	6	0	0	6	0	0
16	13857818	.	T	G	1	3	4	0	0	4	0	0
16	13858356	.	C	A	17	14	31	0	1	32	0	0
16	13858436	.	C	A	17	17	34	0	1	37	2	0
16	13858570	.	C	T	11	22	33	0	0	33	0	0
16	13858673	.	T	C	16	22	38	0	1	39	0	0
16	13858866	.	T	A	8	18	26	1	0	27	0	0
16	13860459	.	G	A	0	5	5	0	4	9	0	0
16	13866763	.	G	A	1	3	4	0	1	5	0	0
16	13870827	.	C	T	3	3	6	0	0	6	0	0
16	13881078	.	T	C	1	2	3	0	0	3	0	0
16	13883968	.	C	A	12	7	19	0	0	19	0	0
16	13883980	.	A	C	12	7	19	0	0	19	0	0
16	13911867	.	C	G	1	2	3	0	0	3	0	0
16	13911930	.	G	A	3	4	7	0	0	7	0	0
16	13912349	.	A	C	1	2	3	0	0	3	0	0
16	13912366	.	T	C	2	2	4	0	0	4	0	0
16	13913962	.	A	T	1	1	2	0	0	2	0	0
16	13913971	.	A	G	1	1	2	0	0	2	0	0
16	14010210	.	G	T	1	1	2	0	0	2	0	0
16	14010241	.	C	A	0	1	1	0	0	1	0	0
16	14010693	.	G	T	2	0	2	0	0	2	0	0
16	14010794	.	C	T	1	4	5	0	0	5	0	0
16	14021817	.	G	T	6	5	11	0	0	11	0	0
16	14022252	.	G	A	1	15	16	0	9	25	0	0
16	14022520	.	G	A	11	6	17	0	0	17	0	0
16	14022767	.	T	A	3	3	6	0	0	6	0	0
16	14022830	.	T	C	0	2	2	0	0	2	0	0
16	14029329	.	A	T	7	10	17	0	0	17	0	0
16	14029424	.	A	C	9	11	20	0	0	20	0	0
16	14029437	.	T	C	7	12	19	0	0	19	0	0
16	14055048	.	G	C	6	4	10	0	0	10	0	0
16	14055284	.	A	T	7	6	13	0	2	15	0	0
16	14095097	.	C	T	0	5	5	0	9	14	0	0
16	14115928	.	G	T	7	2	9	0	0	9	0	0
16	14115931	.	G	A	7	2	9	0	0	9	0	0
16	14133851	.	G	A	8	6	14	0	0	14	0	0
16	14133907	.	C	T	7	5	12	0	0	12	0	0
16	14154226	.	C	T	11	4	15	0	0	15	0	0
16	14154240	.	T	A	4	11	15	0	1	16	0	0
16	14154708	.	G	A	7	5	12	0	1	13	0	0
16	14154798	.	C	T	0	10	10	0	5	15	0	0
16	14154870	.	A	G	12	12	24	0	0	24	0	0
16	14154944	.	C	T	4	9	13	0	2	15	0	0
16	14155038	.	G	A	3	5	8	0	0	8	0	0
16	14155169	.	C	T	5	3	8	0	0	8	0	0
16	14155563	.	T	C	7	5	12	0	0	12	0	0
16	14155684	.	G	A	5	8	13	0	0	13	0	0
16	14155686	.	C	T	5	8	13	0	0	13	0	0
16	14156157	.	T	C	4	8	12	0	0	12	0	0
16	14156556	.	T	C	4	3	7	0	0	7	0	0
16	14156646	.	G	A	5	2	7	0	0	7	0	0
16	14156695	.	C	T	0	3	3	0	3	6	0	0
16	14156865	.	A	G	5	4	9	0	0	9	0	0
16	14156881	.	G	A	3	5	8	0	0	8	0	0
16	14157055	.	C	T	4	4	8	0	0	8	0	0
16	14157112	.	C	T	4	3	7	0	0	7	0	0
16	14158417	.	G	A	1	5	6	0	1	7	0	0
16	14167383	.	A	G	2	3	5	0	0	5	0	0
16	14202111	.	A	C	2	3	5	0	0	5	0	0
16	14202116	.	C	T	4	5	9	0	0	9	0	0
16	14202197	.	T	A	4	5	9	0	1	10	0	0
16	14209142	.	A	C	3	5	8	0	0	8	0	0
16	14209195	.	G	A	3	4	7	0	0	7	0	0
16	14209348	.	T	C	11	9	20	0	0	20	0	0
16	14210949	.	A	C	2	2	4	0	0	4	0	0
16	14212079	.	G	C	0	6	6	0	7	13	0	0
16	14214643	.	A	T	0	3	3	0	0	3	0	0
16	14216708	.	T	A	2	2	4	0	0	4	0	0
16	14217111	.	A	T	2	0	2	0	0	2	0	0
16	14220363	.	C	T	2	6	8	0	0	8	0	0
16	14223225	.	C	T	2	3	5	0	1	6	0	0
16	14223963	.	G	A	0	4	4	0	11	15	0	0
16	14224041	.	T	G	3	2	5	0	0	5	0	0
16	14226034	.	T	C	3	7	10	0	0	10	0	0
16	14226042	.	T	C	3	6	9	0	1	10	0	0
16	14228668	.	A	G	2	3	5	0	0	5	0	0
16	14228677	.	C	T	3	2	5	0	0	5	0	0
16	14228743	.	C	T	1	1	2	0	0	2	0	0
16	14228902	.	C	T	5	3	8	0	0	8	0	0
16	14228979	.	A	G	3	6	9	0	0	9	0	0
16	14229031	.	T	A	4	2	6	0	1	7	0	0
16	14229167	.	G	C	3	3	6	0	0	6	0	0
16	14229169	.	T	C	3	3	6	0	0	6	0	0
16	14229501	.	A	C	3	3	6	0	0	6	0	0
16	14229539	.	C	T	4	2	6	0	1	7	0	0
16	14229585	.	G	A	0	3	3	0	6	9	0	0
16	14229614	.	A	G	6	5	11	0	0	11	0	0
16	14229720	.	A	G	1	0	1	0	4	5	0	0
16	14229946	.	T	C	7	2	9	0	0	9	0	0
16	14229947	.	A	T	7	2	9	0	0	9	0	0
16	14230111	.	C	G	3	2	5	0	0	5	0	0
16	14230141	.	A	G	5	0	5	0	4	9	0	0
16	14230167	.	A	G	4	0	4	0	8	12	0	0
16	14230570	.	C	T	3	3	6	0	0	6	0	0
16	14230693	.	G	A	6	2	8	0	0	8	0	0
16	14230719	.	A	T	4	3	7	0	0	7	0	0
16	14231038	.	A	G	12	7	19	0	1	20	0	0
16	14231063	.	G	A	0	9	9	0	12	21	0	0
16	14231079	.	G	A	0	9	9	0	10	19	0	0
16	14231135	.	G	A	0	6	6	0	6	12	0	0
16	14231138	.	C	T	6	6	12	0	0	12	0	0
16	14231718	.	A	G	12	11	23	0	1	24	0	0
16	14231719	.	G	C	11	0	11	0	13	24	0	0
16	14232005	.	G	A	15	7	22	0	1	23	0	0
16	14240609	.	G	A	1	1	2	0	0	2	0	0
16	14242811	.	A	G	2	7	9	0	0	9	0	0
16	14258294	.	C	T	1	4	5	0	0	5	0	0
16	14416726	.	T	A	5	2	7	0	0	7	0	0
16	14588209	.	G	A	10	10	20	0	1	21	0	0
16	14588225	.	A	C	9	6	15	0	0	15	0	0
16	14588301	.	A	G	3	4	7	0	0	7	0	0
16	14588430	.	A	G	3	1	4	0	0	4	0	0
16	14588450	.	G	A	3	0	3	0	0	3	0	0
16	14664767	.	T	A	1	2	3	0	1	4	0	0
16	14674788	.	T	G	6	5	11	0	0	11	0	0
16	14674801	.	G	T	5	4	9	0	0	9	0	0
16	14674924	.	A	G	1	2	3	0	1	4	0	0
16	14674930	.	A	G	1	4	5	0	0	5	0	0
16	14675373	.	A	C	10	4	14	0	1	15	0	0
16	14675697	.	A	T	12	5	17	0	0	17	0	0
16	14809414	.	G	A	0	2	2	0	1	3	0	0
16	14871134	.	C	T	0	2	2	0	0	2	0	0
16	14913560	.	G	A	2	2	4	0	0	4	0	0
16	14973890	.	G	A	0	3	3	0	4	7	0	0
16	14998333	.	G	C	1	0	1	0	0	1	0	0
16	15034797	.	G	A	1	2	3	0	11	14	0	0
16	15037775	.	G	A	2	5	7	0	1	8	0	0
16	15048253	.	T	C	9	6	15	0	0	15	0	0
16	15048534	.	T	C	15	6	21	0	0	21	0	0
16	15048564	.	T	C	14	10	24	0	1	25	0	0
16	15048926	.	A	C	2	2	4	0	0	4	0	0
16	15048930	.	G	T	2	2	4	0	0	4	0	0
16	15049760	.	A	C	2	4	6	0	0	6	0	0
16	15050135	.	C	T	2	2	4	0	0	4	0	0
16	15050367	.	C	A	11	9	20	0	0	20	0	0
16	15050372	.	C	T	8	12	20	0	1	21	0	0
16	15050478	.	T	A	7	11	18	0	0	18	0	0
16	15050623	.	C	T	4	6	10	0	1	11	0	0
16	15165262	.	G	A	2	0	2	0	0	2	0	0
16	15987984	.	A	G	1	2	3	0	1	4	0	0
16	16041698	.	A	T	2	6	8	0	0	8	0	0
16	16042240	.	G	A	3	5	8	0	0	8	0	0
16	16043191	.	T	G	4	7	11	0	1	12	0	0
16	16043218	.	A	G	5	11	16	0	0	16	0	0
16	16069884	.	A	G	6	7	13	0	1	14	0	0
16	16103927	.	C	T	6	2	8	0	0	8	0	0
16	16113853	.	G	A	4	6	10	0	0	10	0	0
16	16120849	.	C	T	2	5	7	0	0	7	0	0
16	16165179	.	T	A	28	28	56	0	2	58	0	0
16	16165418	.	C	T	33	31	64	0	1	65	0	0
16	16182195	.	T	C	4	3	7	0	2	9	0	0
16	16210469	.	T	A	2	2	4	0	1	5	0	0
16	16232790	.	C	T	1	2	3	0	4	7	0	0
16	16232902	.	A	T	11	7	18	0	0	18	0	0
16	16232911	.	A	G	9	8	17	0	1	18	0	0
16	16233124	.	T	G	4	5	9	0	0	9	0	0
16	16233250	.	T	G	8	9	17	0	1	18	0	0
16	16233538	.	A	T	4	5	9	1	2	12	0	0
16	16233715	.	T	C	1	0	1	0	4	5	0	0
16	16233907	.	A	T	4	5	9	0	0	9	0	0
16	16233937	.	G	T	7	7	14	0	0	14	0	0
16	16233952	.	C	A	0	6	6	0	6	12	0	0
16	16234297	.	C	T	3	6	9	0	0	9	0	0
16	16234309	.	C	A	0	4	4	0	6	10	0	0
16	16234516	.	A	C	9	8	17	0	0	17	0	0
16	16234633	.	T	C	3	0	3	0	3	6	0	0
16	16234642	.	C	T	4	2	6	0	2	8	0	0
16	16234747	.	T	A	3	7	10	0	2	12	0	0
16	16234948	.	C	T	0	2	2	0	6	8	0	0
16	16235056	.	G	C	6	5	11	0	1	12	0	0
16	16237745	.	G	C	3	5	8	0	0	8	0	0
16	16266593	.	C	T	0	2	2	0	0	2	0	0
16	16266774	.	A	G	4	2	6	0	0	6	0	0
16	16267189	.	A	G	2	2	4	0	0	4	0	0
16	16267267	.	G	A	2	4	6	0	0	6	0	0
16	16267355	.	T	C	2	4	6	0	1	7	0	0
16	16267631	.	G	A	2	2	4	0	0	4	0	0
16	16267823	.	T	C	3	3	6	0	0	6	0	0
16	16267895	.	G	A	0	2	2	0	2	4	0	0
16	16267903	.	A	G	2	2	4	0	0	4	0	0
16	16267956	.	A	T	3	2	5	0	0	5	0	0
16	16267967	.	G	T	3	2	5	0	0	5	0	0
16	16268037	.	A	T	1	3	4	0	0	4	0	0
16	16268284	.	C	T	1	1	2	0	0	2	0	0
16	16268334	.	G	A	2	2	4	0	0	4	0	0
16	16268956	.	G	C	1	4	5	0	1	6	0	0
16	16269089	.	A	G	1	4	5	0	0	5	0	0
16	16269593	.	G	C	2	4	6	0	0	6	0	0
16	16269690	.	G	A	0	5	5	0	4	9	0	0
16	16269724	.	G	A	4	8	12	0	0	12	0	0
16	16269926	.	G	C	2	2	4	0	0	4	0	0
16	16269964	.	T	C	4	5	9	0	0	9	0	0
16	16270163	.	C	A	3	2	5	0	0	5	0	0
16	16270424	.	T	C	1	1	2	0	0	2	0	0
16	16271695	.	A	G	5	0	5	0	0	5	0	0
16	16275288	.	T	C	0	2	2	0	0	2	0	0
16	16276678	.	G	A	2	4	6	0	0	6	0	0
16	16277689	.	A	G	4	3	7	0	0	7	0	0
16	16277728	.	G	A	6	5	11	0	0	11	0	0
16	16277810	.	G	A	5	3	8	0	1	9	0	0
16	16277954	.	G	A	4	4	8	0	1	9	0	0
16	16278013	.	A	T	5	9	14	0	0	14	0	0
16	16278043	.	T	C	5	5	10	0	1	11	0	0
16	16278172	.	G	T	0	5	5	0	5	10	0	0
16	16281740	.	A	C	7	6	13	0	0	13	0	0
16	16283706	.	A	G	1	4	5	0	4	9	0	0
16	16284159	.	G	A	0	9	9	0	8	17	0	0
16	16284192	.	C	A	4	11	15	0	1	16	0	0
16	16289121	.	C	T	3	8	11	0	1	12	0	0
16	16302166	.	T	C	8	9	17	0	0	17	0	0
16	16302244	.	A	G	1	0	1	0	10	11	0	0
16	16302247	.	A	T	1	10	11	0	0	11	0	0
16	16302371	.	A	C	4	6	10	0	0	10	0	0
16	16302426	.	T	A	7	9	16	0	1	17	0	0
16	16302477	.	G	A	0	6	6	0	11	17	0	0
16	16302835	.	T	C	10	9	19	0	0	19	0	0
16	16303025	.	C	T	7	20	27	0	0	27	0	0
16	16303065	.	A	G	10	15	25	0	1	26	0	0
16	16303086	.	T	A	12	9	21	0	1	22	0	0
16	16303163	.	G	A	0	8	8	0	7	15	0	0
16	16303196	.	A	G	8	0	8	0	6	14	0	0
16	16303293	.	T	G	8	2	10	0	0	10	0	0
16	16553899	.	C	T	7	3	10	0	0	10	0	0
16	16555484	.	A	C	9	9	18	0	0	18	0	0
16	16555611	.	A	G	5	8	13	0	0	13	0	0
16	16555628	.	A	T	3	5	8	0	1	9	0	0
16	16555975	.	T	A	7	8	15	0	0	15	0	0
16	16556223	.	C	A	10	7	17	0	0	17	0	0
16	16565998	.	C	T	3	5	8	0	0	8	0	0
16	16569578	.	C	G	3	1	4	0	0	4	0	0
16	16586137	.	G	A	2	6	8	0	1	9	0	0
16	16586232	.	C	T	7	8	15	0	3	18	0	0
16	16586290	.	G	A	11	7	18	0	0	18	0	0
16	16589462	.	G	A	2	1	3	0	0	3	0	0
16	16589552	.	G	A	2	4	6	0	0	6	0	0
16	16590439	.	C	T	0	7	7	0	10	17	0	0
16	16597863	.	A	G	1	2	3	0	1	4	0	0
16	16597939	.	A	T	1	2	3	0	0	3	0	0
16	16598146	.	T	C	3	2	5	0	0	5	0	0
16	16598179	.	G	A	4	2	6	0	0	6	0	0
16	16598430	.	C	T	1	2	3	0	4	7	0	0
16	16849326	.	C	T	2	2	4	0	0	4	0	0
16	16849374	.	G	C	2	2	4	0	0	4	0	0
16	16898762	.	G	A	1	0	1	0	0	1	0	0
16	16902097	.	G	A	1	2	3	0	0	3	0	0
16	16904752	.	C	T	0	1	1	0	0	1	0	0
16	16908229	.	C	T	1	0	1	0	0	1	0	0
16	16908238	.	G	A	1	2	3	0	0	3	0	0
16	16913096	.	C	T	2	2	4	0	0	4	0	0
16	16913102	.	G	A	2	0	2	0	1	3	0	0
16	16920424	.	C	T	2	2	4	0	0	4	0	0
16	16921088	.	C	T	9	9	18	0	0	18	0	0
16	16921134	.	G	A	4	6	10	0	1	11	0	0
16	16923519	.	A	G	0	1	1	0	0	1	0	0
16	16924638	.	T	C	11	5	16	0	1	17	0	0
16	16928396	.	T	C	2	3	5	0	1	6	0	0
16	16928424	.	A	G	5	4	9	0	0	9	0	0
16	16928437	.	C	T	4	5	9	0	1	10	0	0
16	16932986	.	C	T	3	2	5	0	0	5	0	0
16	16939462	.	C	T	1	5	6	0	0	6	0	0
16	16940700	.	A	G	5	5	10	0	0	10	0	0
16	16940824	.	A	C	10	11	21	0	0	21	0	0
16	16941019	.	T	C	5	14	19	0	0	19	0	0
16	16941162	.	T	C	3	6	9	0	1	10	0	0
16	16941270	.	G	A	0	9	9	0	3	12	0	0
16	16941343	.	G	A	8	5	13	0	0	13	0	0
16	16941527	.	A	C	3	6	9	0	0	9	0	0
16	16941533	.	G	T	3	7	10	0	0	10	0	0
16	16941741	.	C	T	6	8	14	0	0	14	0	0
16	16941776	.	A	T	5	2	7	0	0	7	0	0
16	16941979	.	C	A	6	5	11	0	0	11	0	0
16	16942001	.	G	A	0	3	3	0	6	9	0	0
16	16942097	.	C	T	1	3	4	0	0	4	0	0
16	16942293	.	T	A	6	7	13	0	0	13	0	0
16	16942906	.	C	G	6	12	18	1	1	20	0	0
16	16943024	.	C	T	14	6	20	0	0	20	0	0
16	16943111	.	A	G	5	7	12	0	1	13	0	0
16	16943348	.	C	A	16	4	20	0	0	20	0	0
16	16943720	.	G	A	7	5	12	0	0	12	0	0
16	16943930	.	G	T	14	6	20	0	0	20	0	0
16	16944259	.	A	T	9	4	13	0	0	13	0	0
16	16944260	.	C	T	9	4	13	0	0	13	0	0
16	16944348	.	G	A	8	7	15	0	1	16	0	0
16	16944941	.	G	T	8	5	13	0	2	15	0	0
16	16945128	.	T	G	4	3	7	0	1	8	0	0
16	17062727	.	C	T	2	2	4	0	0	4	0	0
16	17122132	.	C	A	0	10	10	0	9	19	0	0
16	17136980	.	T	G	1	0	1	0	0	1	0	0
16	17136998	.	C	T	1	2	3	0	0	3	0	0
16	17137031	.	A	G	5	4	9	0	0	9	0	0
16	17137034	.	T	A	5	4	9	0	0	9	0	0
16	17161580	.	T	C	7	0	7	0	4	11	0	0
16	17162524	.	C	A	3	8	11	0	0	11	0	0
16	17162558	.	G	A	7	4	11	0	0	11	0	0
16	17162788	.	A	T	2	3	5	0	0	5	0	0
16	17192957	.	G	A	1	3	4	0	0	4	0	0
16	17195343	.	A	G	2	1	3	0	0	3	0	0
16	17234845	.	C	A	2	2	4	0	0	4	0	0
16	17235001	.	G	A	5	2	7	0	1	8	0	0
16	17235018	.	A	T	5	3	8	0	0	8	0	0
16	17235251	.	G	A	1	7	8	0	1	9	0	0
16	17235486	.	A	G	4	6	10	0	0	10	0	0
16	17238757	.	A	T	1	0	1	0	1	2	0	0
16	17238793	.	G	A	1	0	1	0	1	2	0	0
16	17240892	.	A	T	0	1	1	0	1	2	0	0
16	17248545	.	C	G	0	3	3	0	0	4	1	0
16	17251755	.	G	T	0	1	1	0	0	1	0	0
16	17251770	.	T	C	0	3	3	0	0	3	0	0
16	17252909	.	G	C	10	6	16	0	0	16	0	0
16	17253023	.	G	A	0	9	9	0	8	17	0	0
16	17253056	.	T	C	12	7	19	0	0	19	0	0
16	17253085	.	C	T	5	9	14	0	0	14	0	0
16	17254696	.	A	T	3	2	5	0	0	5	0	0
16	17254761	.	T	C	5	2	7	0	0	7	0	0
16	17256113	.	C	T	7	6	13	0	0	13	0	0
16	17256165	.	G	A	3	5	8	0	1	9	0	0
16	17256376	.	A	G	1	0	1	0	0	1	0	0
16	17302526	.	T	C	3	8	11	0	0	11	0	0
16	17302821	.	A	G	2	3	5	0	0	5	0	0
16	17305481	.	T	C	2	3	5	0	0	5	0	0
16	17305579	.	G	A	5	3	8	0	0	8	0	0
16	17311420	.	A	G	1	6	7	0	0	7	0	0
16	17316462	.	T	G	4	3	7	0	1	8	0	0
16	17316856	.	A	C	2	4	6	0	0	6	0	0
16	17319183	.	T	C	2	1	3	0	1	4	0	0
16	17442933	.	G	A	0	2	2	0	4	6	0	0
16	17466824	.	A	T	2	7	9	0	0	9	0	0
16	17466839	.	T	G	0	6	6	0	1	7	0	0
16	17467287	.	T	G	7	3	10	0	0	10	0	0
16	17550202	.	T	C	1	3	4	0	0	4	0	0
16	17550212	.	A	T	2	4	6	0	1	7	0	0
16	17560294	.	G	A	0	1	1	0	0	1	0	0
16	17560763	.	T	G	1	2	3	0	0	3	0	0
16	17580032	.	C	T	7	3	10	0	0	10	0	0
16	17580036	.	C	T	3	6	9	0	1	10	0	0
16	17580294	.	T	C	3	1	4	0	0	4	0	0
16	17580300	.	G	T	1	4	5	0	0	5	0	0
16	17581021	.	A	T	8	5	13	0	0	13	0	0
16	17581687	.	G	A	2	1	3	0	0	3	0	0
16	17585730	.	T	A	5	3	8	0	0	8	0	0
16	17585924	.	C	G	1	3	4	0	0	4	0	0
16	17640184	.	C	T	9	7	16	0	1	17	0	0
16	17640550	.	A	T	9	8	17	0	0	17	0	0
16	17640693	.	G	A	8	10	18	0	1	19	0	0
16	17646269	.	T	C	4	7	11	0	0	11	0	0
16	17763933	.	T	A	6	14	20	0	0	20	0	0
16	17764238	.	G	A	5	6	11	0	2	13	0	0
16	18570439	.	C	T	10	3	13	0	0	13	0	0
16	19124404	.	T	C	0	1	1	0	0	1	0	0
16	19124452	.	A	G	0	1	1	0	0	1	0	0
16	19136123	.	A	G	1	2	3	0	0	3	0	0
16	19136322	.	C	T	3	3	6	0	0	6	0	0
16	19141362	.	T	A	0	1	1	0	0	1	0	0
16	19150952	.	T	A	5	9	14	0	0	14	0	0
16	19537925	.	C	T	4	5	9	0	0	9	0	0
16	19539219	.	G	T	1	3	4	0	0	4	0	0
16	19641572	.	A	G	1	1	2	0	1	3	0	0
16	19641619	.	G	A	1	2	3	0	0	3	0	0
16	19840792	.	C	T	18	13	31	0	0	31	0	0
16	19841443	.	G	C	3	2	5	0	0	5	0	0
16	19841501	.	T	C	5	5	10	0	0	10	0	0
16	19841502	.	A	T	5	5	10	0	0	10	0	0
16	19841591	.	A	G	5	10	15	0	1	16	0	0
16	19841720	.	A	G	3	4	7	0	0	7	0	0
16	19841786	.	A	T	6	6	12	0	0	12	0	0
16	19841890	.	G	A	2	8	10	0	0	10	0	0
16	19842493	.	G	A	5	6	11	0	0	11	0	0
16	19842530	.	A	G	3	3	6	0	2	8	0	0
16	19843053	.	G	T	16	10	26	0	0	26	0	0
16	19843056	.	G	T	10	15	25	0	1	26	0	0
16	19850683	.	G	T	13	11	24	0	2	26	0	0
16	19853074	.	G	A	0	1	1	0	2	3	0	0
16	19853098	.	C	T	8	4	12	0	4	16	0	0
16	19853230	.	A	C	5	5	10	0	1	11	0	0
16	19878856	.	G	A	8	5	13	0	1	14	0	0
16	20055989	.	T	C	1	3	4	0	0	4	0	0
16	20123828	.	G	A	0	1	1	0	0	1	0	0
16	20137371	.	C	A	1	1	2	0	0	2	0	0
16	20148369	.	C	T	1	2	3	0	0	3	0	0
16	20164230	.	A	G	6	6	12	0	1	13	0	0
16	20183444	.	G	A	1	1	2	0	0	2	0	0
16	20187253	.	G	T	2	2	4	0	0	4	0	0
16	20236694	.	G	A	3	2	5	0	0	5	0	0
16	20267340	.	T	C	8	11	19	0	0	19	0	0
16	22750263	.	A	T	10	20	30	0	1	31	0	0
16	22750366	.	G	T	23	10	33	0	0	33	0	0
16	22750566	.	G	A	19	18	37	0	0	37	0	0
16	22750579	.	A	G	19	17	36	0	0	36	0	0
16	22750610	.	A	T	19	16	35	0	1	36	0	0
16	22750693	.	G	A	18	12	30	0	3	33	0	0
16	22750718	.	A	T	21	7	28	0	1	29	0	0
16	22750781	.	A	G	7	12	19	0	1	20	0	0
16	22751093	.	C	A	8	14	22	0	0	22	0	0
16	22751101	.	C	T	6	11	17	0	1	18	0	0
16	22751129	.	T	A	5	9	14	0	0	14	0	0
16	22751141	.	T	G	1	4	5	0	1	6	0	0
16	22751167	.	T	A	2	4	6	0	0	6	0	0
16	22751181	.	C	T	3	3	6	0	0	6	0	0
16	22751212	.	A	T	3	2	5	0	0	5	0	0
16	22751221	.	G	C	2	2	4	0	0	4	0	0
16	22751376	.	A	C	3	8	11	0	0	11	0	0
16	22751426	.	T	C	8	6	14	0	0	14	0	0
16	22751645	.	A	G	6	1	7	0	0	7	0	0
16	22751926	.	C	T	5	12	17	0	0	17	0	0
16	22752009	.	T	C	6	1	7	0	9	16	0	0
16	22752182	.	G	T	20	9	29	0	3	32	0	0
16	22752274	.	G	C	12	5	17	0	0	18	1	0
16	22752279	.	T	C	12	5	17	0	1	18	0	0
16	22752328	.	G	A	6	7	13	0	2	15	0	0
16	22752345	.	C	T	6	5	11	0	1	12	0	0
16	22752399	.	G	A	5	3	8	0	0	8	0	0
16	22752531	.	T	C	9	3	12	0	1	13	0	0
16	22752572	.	A	C	2	6	8	0	1	9	0	0
16	22752625	.	G	A	7	5	12	0	0	12	0	0
16	22752738	.	T	C	2	8	10	0	0	10	0	0
16	22752739	.	T	C	4	6	10	0	0	10	0	0
16	22752779	.	A	G	11	3	14	0	1	15	0	0
16	22752804	.	T	C	12	2	14	0	1	15	0	0
16	22752868	.	C	T	5	3	8	0	0	8	0	0
16	22752889	.	G	A	6	4	10	0	1	11	0	0
16	22752954	.	T	C	6	4	10	0	0	10	0	0
16	22753017	.	G	A	3	3	6	0	0	6	0	0
16	22753116	.	C	A	0	2	2	0	3	5	0	0
16	22753185	.	C	T	11	6	17	0	3	20	0	0
16	22753380	.	T	G	19	11	30	0	0	30	0	0
16	22753452	.	G	A	12	19	31	0	1	32	0	0
16	22753744	.	G	C	15	0	15	0	17	32	0	0
16	22753784	.	T	C	9	0	9	0	12	21	0	0
16	22754238	.	A	G	6	8	14	0	0	14	0	0
16	22757742	.	G	A	0	4	4	0	0	4	0	0
16	22757795	.	T	C	5	13	18	0	2	20	0	0
16	22757887	.	T	C	4	10	14	0	1	15	0	0
16	22757946	.	T	C	7	0	7	0	4	11	0	0
16	22764803	.	C	T	2	2	4	0	0	4	0	0
16	22764857	.	A	T	11	3	14	0	0	14	0	0
16	22767603	.	C	T	0	6	6	0	3	9	0	0
16	22767684	.	A	G	3	7	10	0	0	10	0	0
16	22769586	.	G	T	5	3	8	0	0	8	0	0
16	22771212	.	T	A	2	2	4	0	0	4	0	0
16	22782306	.	A	T	12	9	21	0	0	21	0	0
16	22782308	.	A	T	12	9	21	0	0	21	0	0
16	22782422	.	C	T	0	6	6	0	12	18	0	0
16	22782443	.	A	T	12	10	22	0	0	22	0	0
16	22782458	.	T	C	11	12	23	0	0	23	0	0
16	22782682	.	T	G	9	5	14	0	0	14	0	0
16	22782784	.	T	C	6	10	16	0	0	16	0	0
16	22782904	.	G	C	8	6	14	0	0	14	0	0
16	22783338	.	C	G	0	6	6	0	5	11	0	0
16	22783978	.	A	G	8	7	15	0	0	15	0	0
16	22783995	.	T	C	6	0	6	0	7	13	0	0
16	22866015	.	T	C	6	4	10	0	0	10	0	0
16	22866017	.	C	A	6	4	10	0	0	10	0	0
16	22868973	.	T	C	2	2	4	0	0	4	0	0
16	22872011	.	A	G	4	0	4	0	3	7	0	0
16	22872317	.	A	C	12	5	17	0	2	19	0	0
16	22872602	.	G	A	6	2	8	0	1	9	0	0
16	22872657	.	A	C	4	3	7	0	1	8	0	0
16	22872693	.	T	C	1	2	3	0	0	3	0	0
16	22872694	.	C	T	1	2	3	0	0	3	0	0
16	22872927	.	T	C	6	10	16	0	1	17	0	0
16	22878965	.	T	A	7	5	12	0	0	12	0	0
16	22879104	.	T	A	3	2	5	0	0	5	0	0
16	22879128	.	G	C	3	2	5	0	0	5	0	0
16	23087803	.	G	A	1	1	2	0	1	3	0	0
16	23353727	.	G	A	4	3	7	0	0	7	0	0
16	23353859	.	G	T	4	3	7	0	0	7	0	0
16	23353901	.	G	T	2	0	2	0	0	2	0	0
16	23361554	.	C	T	1	2	3	0	2	5	0	0
16	23379313	.	G	A	3	5	8	0	0	8	0	0
16	23383399	.	T	A	1	0	1	0	0	1	0	0
16	23385909	.	A	G	1	3	4	0	2	6	0	0
16	23388400	.	A	T	6	12	18	0	0	18	0	0
16	23398489	.	T	C	5	3	8	0	1	9	0	0
16	23399307	.	T	C	3	2	5	0	1	6	0	0
16	23432505	.	T	G	1	2	3	0	0	3	0	0
16	23495775	.	A	T	8	10	18	0	1	19	0	0
16	23495820	.	C	T	11	7	18	0	1	19	0	0
16	23556448	.	T	C	16	5	21	0	1	22	0	0
16	23556748	.	A	G	6	0	6	0	11	17	0	0
16	23556758	.	C	T	7	12	19	0	0	19	0	0
16	23556822	.	A	G	8	14	22	0	2	24	0	0
16	23557013	.	G	A	5	6	11	0	0	11	0	0
16	23599103	.	A	C	3	5	8	0	0	8	0	0
16	23600307	.	C	T	2	7	9	0	2	11	0	0
16	23706953	.	A	G	2	0	2	0	1	3	0	0
16	23718419	.	G	C	18	13	31	0	0	31	0	0
16	23718687	.	A	G	7	7	14	0	1	15	0	0
16	23718700	.	A	G	9	5	14	0	0	14	0	0
16	23718999	.	T	C	5	3	8	0	0	8	0	0
16	23719011	.	A	G	4	3	7	0	0	7	0	0
16	23788830	.	A	G	34	29	63	0	7	70	0	0
16	23808918	.	A	T	2	2	4	0	0	4	0	0
16	23809311	.	A	C	4	4	8	0	0	8	0	0
16	23821654	.	T	A	5	9	14	0	2	16	0	0
16	23831697	.	A	G	1	2	3	0	0	3	0	0
16	23831836	.	A	T	3	0	3	0	0	3	0	0
16	23831892	.	C	T	7	4	11	0	0	11	0	0
16	23832045	.	T	A	7	4	11	0	0	11	0	0
16	23832072	.	C	T	5	3	8	0	0	8	0	0
16	23832302	.	T	C	7	5	12	0	2	14	0	0
16	23832304	.	A	T	7	6	13	0	1	14	0	0
16	23832520	.	A	C	9	11	20	0	0	20	0	0
16	23832561	.	T	C	13	11	24	0	1	25	0	0
16	23832589	.	G	A	12	10	22	0	0	22	0	0
16	23832646	.	A	T	5	10	15	0	0	15	0	0
16	23832695	.	A	G	2	10	12	0	1	13	0	0
16	23832787	.	T	C	3	7	10	0	0	10	0	0
16	23832940	.	G	A	7	2	9	0	0	9	0	0
16	23833070	.	A	C	6	12	18	0	0	18	0	0
16	23833274	.	T	A	5	5	10	0	0	10	0	0
16	23833284	.	T	C	4	4	8	0	0	8	0	0
16	23833309	.	A	T	2	8	10	0	0	10	0	0
16	23833347	.	T	A	7	6	13	0	0	13	0	0
16	23833377	.	G	T	7	7	14	0	0	14	0	0
16	23833420	.	G	T	4	10	14	0	0	14	0	0
16	23833442	.	G	A	4	7	11	0	1	12	0	0
16	23833528	.	A	T	9	7	16	0	0	16	0	0
16	23833723	.	A	G	13	7	20	0	0	20	0	0
16	23833916	.	G	A	9	4	13	0	1	14	0	0
16	23834001	.	A	C	13	5	18	0	0	19	1	0
16	23834513	.	T	G	11	4	15	0	0	15	0	0
16	23834540	.	T	C	11	6	17	0	1	18	0	0
16	23834554	.	A	G	8	7	15	0	6	21	0	0
16	23834859	.	A	G	8	7	15	0	0	15	0	0
16	23834885	.	A	T	5	7	12	0	0	12	0	0
16	23835310	.	T	A	2	4	6	0	1	7	0	0
16	23864624	.	C	T	6	3	9	0	1	10	0	0
16	23864668	.	A	G	7	1	8	0	2	10	0	0
16	23869305	.	T	C	2	0	2	0	0	2	0	0
16	23875340	.	G	A	0	1	1	0	1	2	0	0
16	23881041	.	G	A	2	2	4	0	0	4	0	0
16	23901394	.	C	T	4	4	8	0	1	9	0	0
16	23901420	.	G	C	4	5	9	0	0	9	0	0
16	23901805	.	G	A	2	2	4	0	0	4	0	0
16	23902088	.	C	T	3	1	4	0	4	8	0	0
16	23902113	.	A	G	7	6	13	0	1	14	0	0
16	23902179	.	C	T	3	5	8	0	1	9	0	0
16	23902235	.	T	C	3	6	9	0	0	9	0	0
16	23961572	.	C	G	7	0	7	0	9	16	0	0
16	23961878	.	C	T	11	12	23	0	0	23	0	0
16	23961950	.	C	A	14	10	24	0	2	26	0	0
16	23962007	.	G	A	16	17	33	0	1	34	0	0
16	23962010	.	T	C	17	16	33	0	1	34	0	0
16	23963241	.	C	T	22	20	42	0	1	43	0	0
16	23963246	.	C	T	20	24	44	0	2	46	0	0
16	23963421	.	G	T	14	3	17	0	0	17	0	0
16	23963431	.	G	A	10	2	12	0	0	12	0	0
16	24056406	.	T	G	4	3	7	0	0	7	0	0
16	24056497	.	C	T	1	2	3	0	0	3	0	0
16	24058712	.	G	A	0	1	1	0	0	1	0	0
16	24135445	.	T	C	4	5	9	0	0	9	0	0
16	24135465	.	T	C	3	0	3	0	5	8	0	0
16	24135547	.	T	C	6	0	6	0	5	11	0	0
16	24190496	.	A	G	2	4	6	0	0	6	0	0
16	24190607	.	T	A	3	0	3	0	1	4	0	0
16	24190624	.	G	C	2	0	2	0	0	2	0	0
16	24190746	.	G	C	1	3	4	0	0	4	0	0
16	24190817	.	T	A	1	3	4	0	0	4	0	0
16	24190879	.	A	G	2	3	5	0	0	5	0	0
16	24191468	.	T	C	17	27	44	0	1	45	0	0
16	24194217	.	A	C	16	13	29	0	1	30	0	0
16	24213444	.	T	A	5	10	15	0	3	18	0	0
16	24213446	.	T	A	6	10	16	0	2	18	0	0
16	24213538	.	G	T	26	12	38	0	8	47	1	0
16	24213657	.	G	A	17	20	37	0	0	37	0	0
16	24213666	.	T	G	14	13	27	0	3	30	0	0
16	24213793	.	T	C	15	31	46	0	1	47	0	0
16	24214023	.	A	G	22	33	55	0	4	59	0	0
16	24214106	.	T	C	22	1	23	0	30	53	0	0
16	24214468	.	T	C	26	29	55	0	2	57	0	0
16	24261548	.	T	C	24	1	25	0	17	42	0	0
16	24277750	.	C	T	19	17	36	0	0	36	0	0
16	24302164	.	G	A	5	7	12	0	0	12	0	0
16	24517791	.	A	T	3	1	4	0	0	4	0	0
16	24552081	.	C	T	3	8	11	0	1	12	0	0
16	24552155	.	A	C	3	7	10	0	0	10	0	0
16	24552176	.	C	G	4	10	14	0	0	14	0	0
16	24552215	.	C	T	4	10	14	0	0	14	0	0
16	24552459	.	A	G	0	4	4	0	1	5	0	0
16	24552826	.	G	A	2	2	4	0	1	5	0	0
16	24553022	.	A	C	5	2	7	0	0	7	0	0
16	24553038	.	A	G	4	2	6	0	0	6	0	0
16	24553464	.	G	T	5	6	11	0	0	11	0	0
16	24554475	.	A	G	3	16	19	0	1	20	0	0
16	24554509	.	C	T	3	11	14	0	3	17	0	0
16	24590804	.	G	T	20	19	39	0	1	40	0	0
16	24591074	.	G	A	16	19	35	0	0	35	0	0
16	24591794	.	G	T	9	3	12	0	0	12	0	0
16	24601285	.	A	C	6	9	15	0	0	15	0	0
16	24601306	.	C	T	7	9	16	0	0	16	0	0
16	24601380	.	T	C	4	9	13	0	1	14	0	0
16	24601558	.	C	T	4	2	6	0	0	6	0	0
16	24632121	.	G	T	6	6	12	0	0	12	0	0
16	24632148	.	T	C	14	8	22	0	1	23	0	0
16	24632306	.	C	A	5	6	11	0	0	11	0	0
16	24632329	.	T	C	3	2	5	0	0	5	0	0
16	24637342	.	G	T	5	8	13	0	0	13	0	0
16	24637369	.	A	C	1	1	2	0	1	3	0	0
16	24642327	.	T	C	13	8	21	0	1	22	0	0
16	24645448	.	C	G	11	7	18	0	0	18	0	0
16	24645620	.	T	G	18	5	23	0	0	23	0	0
16	24645769	.	T	G	8	1	9	0	7	16	0	0
16	24645796	.	G	A	9	8	17	0	0	17	0	0
16	24645820	.	A	T	9	3	12	0	1	13	0	0
16	24645978	.	A	T	3	5	8	0	1	9	0	0
16	24648097	.	G	T	0	1	1	0	1	2	0	0
16	24649229	.	C	T	0	2	2	0	1	3	0	0
16	24649271	.	G	C	4	2	6	0	0	6	0	0
16	24657097	.	T	G	1	2	3	3	0	6	0	0
16	24657100	.	G	A	1	2	3	3	0	6	0	0
16	24692635	.	T	C	25	37	62	0	2	64	0	0
16	24692685	.	A	G	8	1	9	0	18	27	0	0
16	24695056	.	T	G	0	4	4	0	0	4	0	0
16	24695160	.	G	T	12	17	29	0	2	32	1	0
16	24721757	.	C	T	1	2	3	0	0	3	0	0
16	24721860	.	T	C	1	0	1	0	0	1	0	0
16	24721982	.	G	C	5	3	8	0	1	9	0	0
16	24723430	.	A	C	4	3	7	0	0	7	0	0
16	24725170	.	G	A	1	0	1	0	0	1	0	0
16	24727766	.	G	A	2	0	2	0	0	2	0	0
16	24727826	.	A	T	2	0	2	0	0	2	0	0
16	24732921	.	C	A	6	5	11	0	0	11	0	0
16	24918604	.	T	C	1	2	3	0	0	3	0	0
16	24918619	.	C	T	1	2	3	0	0	3	0	0
16	24974005	.	A	T	0	3	3	0	0	3	0	0
16	24974094	.	C	G	2	2	4	0	0	4	0	0
16	24978403	.	C	T	2	4	6	0	0	6	0	0
16	24989158	.	C	T	2	2	4	0	0	4	0	0
16	24989297	.	A	G	1	1	2	0	0	2	0	0
16	24989331	.	T	G	1	2	3	0	0	3	0	0
16	24989526	.	C	A	1	2	3	0	0	3	0	0
16	24989559	.	T	G	2	3	5	0	0	5	0	0
16	24989616	.	C	T	2	4	6	0	0	6	0	0
16	24990818	.	T	C	4	6	10	0	1	11	0	0
16	24990850	.	C	T	4	9	13	0	1	14	0	0
16	24991940	.	T	A	3	3	6	0	0	6	0	0
16	25012051	.	A	C	7	5	12	0	0	12	0	0
16	25012143	.	T	A	2	0	2	1	0	3	0	0
16	25012935	.	T	A	1	0	1	0	1	2	0	0
16	25032037	.	C	T	1	6	7	0	0	7	0	0
16	25032733	.	G	C	2	2	4	0	0	4	0	0
16	25033173	.	G	A	4	2	6	0	0	6	0	0
16	25034241	.	G	A	9	10	19	0	0	19	0	0
16	25034682	.	A	G	3	0	3	0	12	15	0	0
16	25038412	.	A	G	9	8	17	0	0	17	0	0
16	25069123	.	C	A	2	3	5	0	0	5	0	0
16	25069698	.	G	A	2	5	7	0	1	8	0	0
16	25070693	.	A	G	6	2	8	0	1	9	0	0
16	25070990	.	A	C	7	3	10	0	0	10	0	0
16	25071019	.	G	A	7	4	11	0	0	11	0	0
16	25071231	.	T	G	11	4	15	0	0	15	0	0
16	25071329	.	T	G	9	0	9	0	11	20	0	0
16	25071443	.	A	C	6	4	10	0	3	13	0	0
16	25071518	.	C	A	5	11	16	0	2	18	0	0
16	25071533	.	A	G	5	14	19	0	0	19	0	0
16	25071782	.	G	A	0	9	9	0	7	16	0	0
16	25077819	.	C	T	7	4	11	0	0	11	0	0
16	25078397	.	G	T	7	3	10	0	1	11	0	0
16	25095659	.	C	T	4	5	9	0	1	10	0	0
16	25096098	.	A	G	4	10	14	0	0	14	0	0
16	25104543	.	C	T	7	5	12	0	1	13	0	0
16	25104941	.	T	C	8	14	22	0	0	22	0	0
16	25104970	.	T	C	4	8	12	0	0	12	0	0
16	25107378	.	A	T	4	2	6	0	0	6	0	0
16	25111665	.	C	A	2	2	4	0	0	4	0	0
16	25111755	.	T	A	8	6	14	0	0	14	0	0
16	25112625	.	C	T	4	2	6	0	1	7	0	0
16	25112760	.	C	T	4	4	8	0	0	8	0	0
16	25112769	.	C	T	4	3	7	0	0	7	0	0
16	25113091	.	A	T	4	5	9	0	1	10	0	0
16	25113741	.	G	A	0	5	5	0	9	14	0	0
16	25114362	.	C	T	7	4	11	0	0	11	0	0
16	25114450	.	G	A	0	6	6	0	5	11	0	0
16	25114451	.	C	G	5	6	11	0	0	11	0	0
16	25114508	.	C	A	6	8	14	0	0	14	0	0
16	25114522	.	A	C	7	11	18	0	0	18	0	0
16	25114546	.	A	G	7	9	16	0	1	17	0	0
16	25114848	.	A	G	10	15	25	0	1	26	0	0
16	25114881	.	T	C	4	13	17	0	0	17	0	0
16	25114944	.	T	C	7	8	15	0	0	15	0	0
16	25118733	.	A	G	4	4	8	0	0	8	0	0
16	25120679	.	C	A	1	5	6	0	0	6	0	0
16	25120696	.	G	T	5	2	7	0	0	7	0	0
16	25120851	.	T	C	2	5	7	0	0	7	0	0
16	25121209	.	G	A	0	2	2	0	1	3	0	0
16	25121363	.	T	C	2	2	4	0	0	4	0	0
16	25121541	.	G	A	4	5	9	0	0	9	0	0
16	25121654	.	A	G	7	0	7	0	5	12	0	0
16	25121694	.	T	C	6	4	10	0	0	10	0	0
16	25121812	.	T	A	5	4	9	0	2	11	0	0
16	25121851	.	G	A	5	3	8	0	0	8	0	0
16	25121878	.	G	A	7	4	11	0	0	11	0	0
16	25121958	.	C	T	5	5	10	0	1	11	0	0
16	25122086	.	G	T	6	3	9	0	0	9	0	0
16	25122193	.	C	T	11	4	15	0	0	15	0	0
16	25122240	.	C	T	6	5	11	0	0	11	0	0
16	25122503	.	C	T	5	6	11	0	0	11	0	0
16	25122528	.	C	A	4	4	8	0	1	9	0	0
16	25123129	.	A	G	1	4	5	0	2	7	0	0
16	25123130	.	A	G	3	4	7	0	0	7	0	0
16	25123536	.	C	T	3	2	5	0	0	5	0	0
16	25123938	.	A	G	3	6	9	0	0	9	0	0
16	25142116	.	T	C	2	2	4	0	0	4	0	0
16	25142412	.	G	A	0	4	4	0	1	5	0	0
16	25142562	.	C	T	2	3	5	0	0	5	0	0
16	25146020	.	T	C	1	2	3	0	0	3	0	0
16	25146107	.	A	T	3	3	6	0	0	6	0	0
16	25146125	.	G	C	2	2	4	0	0	4	0	0
16	25148515	.	C	T	2	2	4	0	0	4	0	0
16	25148559	.	C	T	2	3	5	0	0	5	0	0
16	25148565	.	G	A	1	3	4	0	1	5	0	0
16	25148606	.	G	A	4	3	7	0	0	7	0	0
16	25149076	.	G	A	5	5	10	0	0	10	0	0
16	25149123	.	G	A	6	5	11	0	0	11	0	0
16	25149147	.	C	T	3	2	5	0	0	5	0	0
16	25149164	.	C	A	4	3	7	0	0	7	0	0
16	25149191	.	G	A	3	3	6	0	0	6	0	0
16	25149254	.	G	T	1	7	8	0	0	8	0	0
16	25149466	.	G	A	5	3	8	0	1	9	0	0
16	25149474	.	C	T	5	3	8	0	1	9	0	0
16	25149563	.	T	G	2	4	6	0	0	6	0	0
16	25149654	.	T	C	4	4	8	0	0	8	0	0
16	25149705	.	C	A	2	2	4	0	0	4	0	0
16	25149779	.	G	A	5	5	10	0	0	10	0	0
16	25149867	.	A	G	3	0	3	0	3	6	0	0
16	25149878	.	T	C	3	4	7	0	0	7	0	0
16	25150329	.	A	G	4	3	7	0	0	7	0	0
16	25150468	.	A	G	3	4	7	0	0	7	0	0
16	25151012	.	T	C	4	4	8	0	0	8	0	0
16	25151059	.	G	A	0	4	4	0	7	11	0	0
16	25151079	.	A	G	8	0	8	0	4	12	0	0
16	25151456	.	G	A	3	3	6	0	0	6	0	0
16	25151553	.	T	C	1	4	5	0	0	5	0	0
16	25151757	.	G	C	0	0	0	0	1	1	0	0
16	25154081	.	A	C	1	2	3	0	0	3	0	0
16	25154160	.	G	A	0	1	1	0	3	4	0	0
16	25161420	.	G	T	0	4	4	0	7	11	0	0
16	25167828	.	T	C	5	5	10	0	0	10	0	0
16	25168765	.	C	A	9	15	24	0	0	24	0	0
16	25169336	.	G	A	9	7	16	0	0	16	0	0
16	25173793	.	C	A	2	2	4	0	0	4	0	0
16	25173993	.	T	A	3	3	6	0	0	6	0	0
16	25174081	.	A	C	3	2	5	0	0	5	0	0
16	25176753	.	C	T	1	2	3	0	0	3	0	0
16	25176840	.	G	A	0	3	3	0	1	4	0	0
16	25180415	.	C	T	4	3	7	0	1	8	0	0
16	25180737	.	C	T	1	2	3	0	0	3	0	0
16	25180775	.	G	A	1	4	5	0	0	5	0	0
16	25180846	.	T	C	3	3	6	0	0	6	0	0
16	25180942	.	A	G	2	0	2	0	4	6	0	0
16	25181113	.	T	C	3	3	6	0	1	7	0	0
16	25181256	.	G	A	1	1	2	0	1	3	0	0
16	25232084	.	T	G	2	3	5	0	0	5	0	0
16	25232085	.	G	T	2	3	5	0	0	5	0	0
16	25232262	.	G	A	4	5	9	0	0	9	0	0
16	25232288	.	C	A	0	4	4	0	6	10	0	0
16	25232433	.	C	T	0	9	9	0	4	13	0	0
16	25232707	.	C	T	6	4	10	0	0	10	0	0
16	25259477	.	T	A	2	4	6	0	0	6	0	0
16	25268017	.	C	T	4	3	7	0	0	7	0	0
16	25272148	.	G	T	0	4	4	0	6	10	0	0
16	25272149	.	A	G	5	4	9	0	1	10	0	0
16	25272613	.	T	A	1	3	4	0	0	4	0	0
16	25275957	.	C	T	12	9	21	0	0	21	0	0
16	25283378	.	A	G	11	10	21	0	0	21	0	0
16	25283402	.	G	T	4	4	8	0	0	8	0	0
16	25296510	.	A	T	3	2	5	0	1	6	0	0
16	25296806	.	G	T	0	1	1	0	0	1	0	0
16	25296856	.	C	A	0	2	2	0	0	2	0	0
16	25300614	.	C	A	2	2	4	0	0	4	0	0
16	25300628	.	T	G	2	2	4	0	0	4	0	0
16	25306492	.	C	T	1	3	4	0	0	4	0	0
16	25306493	.	T	A	1	3	4	0	0	4	0	0
16	25308986	.	G	A	2	2	4	0	0	4	0	0
16	25311654	.	G	A	0	3	3	0	0	3	0	0
16	25314708	.	G	A	1	2	3	0	0	3	0	0
16	25317000	.	G	A	5	7	12	0	0	12	0	0
16	25327181	.	C	T	5	1	6	0	1	7	0	0
16	25327202	.	G	A	4	2	6	0	1	7	0	0
16	25327730	.	C	T	4	3	7	0	1	8	0	0
16	25333270	.	A	G	10	7	17	0	0	17	0	0
16	25337248	.	C	A	4	6	10	0	1	11	0	0
16	25337286	.	C	T	14	17	31	0	0	31	0	0
16	25337319	.	G	A	14	12	26	0	0	26	0	0
16	25337665	.	T	G	3	12	15	0	1	16	0	0
16	25351283	.	A	T	2	2	4	0	0	4	0	0
16	25360557	.	T	A	4	3	7	0	0	7	0	0
16	25364479	.	T	C	9	7	16	0	0	16	0	0
16	25364589	.	T	C	9	8	17	0	0	17	0	0
16	25364742	.	T	C	4	0	4	0	5	9	0	0
16	25365156	.	C	T	1	1	2	0	0	2	0	0
16	25367503	.	G	A	1	0	1	0	0	1	0	0
16	25367788	.	A	G	0	1	1	0	0	1	0	0
16	25367902	.	C	T	0	3	3	0	2	5	0	0
16	25367917	.	C	G	2	3	5	0	0	5	0	0
16	25367938	.	G	C	4	0	4	0	7	11	0	0
16	25373823	.	C	T	3	2	5	0	0	5	0	0
16	25374135	.	G	A	2	3	5	0	0	5	0	0
16	25374139	.	T	A	2	3	5	0	0	5	0	0
16	25374247	.	G	T	1	3	4	0	0	4	0	0
16	25374417	.	C	T	0	8	8	0	4	12	0	0
16	25374441	.	C	T	0	6	6	0	6	12	0	0
16	25374648	.	G	A	9	6	15	0	0	15	0	0
16	25375095	.	A	G	4	5	9	0	0	9	0	0
16	25376307	.	A	C	4	3	7	0	0	7	0	0
16	25376528	.	C	T	3	2	5	0	0	5	0	0
16	25380786	.	T	G	3	5	8	0	0	8	0	0
16	25388899	.	G	A	2	5	7	0	0	7	0	0
16	25389061	.	C	T	0	10	10	0	4	14	0	0
16	25389094	.	G	A	8	8	16	0	0	16	0	0
16	25389106	.	C	T	6	9	15	0	0	15	0	0
16	25389424	.	G	A	1	4	5	0	0	5	0	0
16	25389425	.	C	A	1	4	5	0	0	5	0	0
16	25393342	.	G	A	1	2	3	0	0	3	0	0
16	25395154	.	G	T	4	5	9	0	1	10	0	0
16	25395702	.	G	T	3	5	8	0	0	8	0	0
16	25399585	.	A	T	1	5	6	0	0	6	0	0
16	25399588	.	A	T	1	5	6	0	0	6	0	0
16	25400055	.	G	C	0	0	0	0	1	1	0	0
16	25400061	.	A	T	1	0	1	0	0	1	0	0
16	25407426	.	A	T	2	4	6	0	0	6	0	0
16	25470975	.	A	G	5	4	9	0	0	9	0	0
16	25477557	.	G	A	7	6	13	0	2	15	0	0
16	25477788	.	C	T	7	3	10	0	1	11	0	0
16	25498402	.	T	A	2	5	7	0	0	7	0	0
16	25500293	.	T	A	4	3	7	0	0	7	0	0
16	25504122	.	C	T	0	5	5	0	5	10	0	0
16	25504180	.	C	T	1	9	10	0	12	22	0	0
16	25504315	.	C	T	10	13	23	0	1	24	0	0
16	25504337	.	G	A	8	10	18	0	0	18	0	0
16	25504398	.	A	T	9	9	18	0	1	19	0	0
16	25504425	.	G	T	15	9	24	0	0	24	0	0
16	25504466	.	C	T	0	11	11	0	16	27	0	0
16	25504585	.	C	T	10	13	23	0	0	23	0	0
16	25504642	.	G	A	15	14	29	0	1	30	0	0
16	25507392	.	C	T	0	4	4	0	1	5	0	0
16	25507485	.	G	A	10	15	25	0	2	27	0	0
16	25507536	.	G	A	3	4	7	0	1	8	0	0
16	25507574	.	A	G	1	3	4	0	0	4	0	0
16	25507696	.	T	C	4	2	6	0	0	6	0	0
16	25519635	.	A	G	8	10	18	0	1	19	0	0
16	25527520	.	C	T	2	1	3	0	0	3	0	0
16	25535283	.	T	C	4	4	8	0	0	8	0	0
16	25555775	.	G	A	14	6	20	0	1	21	0	0
16	25555806	.	A	G	2	13	15	0	2	17	0	0
16	25556650	.	T	A	8	10	18	0	0	18	0	0
16	25556697	.	A	G	7	11	18	0	1	19	0	0
16	25556710	.	C	T	7	10	17	0	0	17	0	0
16	25556766	.	C	G	0	6	6	0	4	10	0	0
16	25556780	.	A	G	4	6	10	0	0	10	0	0
16	25556802	.	C	A	2	7	9	0	0	9	0	0
16	25556930	.	A	G	10	8	18	0	0	18	0	0
16	25556966	.	T	A	10	8	18	0	0	18	0	0
16	25557352	.	C	T	0	2	2	0	1	3	0	0
16	25557806	.	C	T	4	7	11	0	1	12	0	0
16	25558704	.	T	G	9	6	15	0	1	16	0	0
16	25558829	.	C	T	5	6	11	0	2	13	0	0
16	25558845	.	G	A	5	7	12	0	0	12	0	0
16	25559165	.	A	C	3	9	12	0	1	13	0	0
16	25559296	.	T	C	4	3	7	0	0	7	0	0
16	25559632	.	G	A	2	3	5	0	0	5	0	0
16	25560135	.	T	C	2	0	2	0	3	5	0	0
16	25560415	.	A	C	1	3	4	0	1	5	0	0
16	25560863	.	C	T	4	4	8	0	0	8	0	0
16	25561630	.	C	T	5	8	13	0	0	13	0	0
16	25562480	.	G	A	8	3	11	0	0	11	0	0
16	25562549	.	G	A	8	5	13	0	0	13	0	0
16	25563176	.	T	C	5	9	14	0	0	14	0	0
16	25567951	.	T	G	4	1	5	0	0	5	0	0
16	25568130	.	G	A	10	4	14	0	0	14	0	0
16	25593883	.	G	A	5	2	7	0	1	8	0	0
16	25641050	.	G	A	8	11	19	0	2	21	0	0
16	25642673	.	C	T	11	8	19	0	2	21	0	0
16	25642713	.	T	A	14	11	25	0	0	25	0	0
16	25642818	.	T	C	14	1	15	0	0	15	0	0
16	25642848	.	C	A	7	4	11	0	2	13	0	0
16	25643038	.	G	A	8	10	18	0	0	18	0	0
16	25643041	.	G	A	4	10	14	0	4	18	0	0
16	25643113	.	G	C	10	10	20	0	1	21	0	0
16	25644378	.	A	T	4	8	12	0	1	13	0	0
16	25673249	.	T	A	5	4	9	0	0	9	0	0
16	25683018	.	T	C	5	5	10	0	0	10	0	0
16	25683152	.	A	T	10	7	17	0	0	17	0	0
16	25683387	.	C	T	0	10	10	0	9	19	0	0
16	25683440	.	G	T	11	13	24	0	3	27	0	0
16	25688709	.	C	A	2	1	3	0	0	3	0	0
16	25697956	.	C	A	1	4	5	0	0	5	0	0
16	25697971	.	A	T	2	5	7	0	0	7	0	0
16	25698045	.	G	A	5	2	7	0	0	7	0	0
16	25698073	.	A	C	2	0	2	0	3	5	0	0
16	25698449	.	A	C	6	3	9	0	0	9	0	0
16	25779283	.	A	T	5	4	9	0	0	9	0	0
16	25798557	.	T	C	1	0	1	0	0	1	0	0
16	25798561	.	C	T	1	0	1	0	0	1	0	0
16	26021245	.	A	G	10	6	16	0	3	19	0	0
16	26021930	.	T	A	2	6	8	0	0	8	0	0
16	26027081	.	G	T	15	11	26	0	4	30	0	0
16	26027158	.	A	T	19	16	35	0	9	44	0	0
16	26030380	.	T	A	12	14	26	0	1	27	0	0
16	26039945	.	C	T	0	0	0	0	2	2	0	0
16	26043044	.	T	A	4	4	8	0	0	8	0	0
16	26074459	.	G	T	3	8	11	0	0	11	0	0
16	26141599	.	T	A	9	5	14	0	0	14	0	0
16	26141682	.	T	A	5	5	10	0	1	11	0	0
16	26141748	.	T	C	2	1	3	0	4	7	0	0
16	26141785	.	C	A	0	7	7	0	7	14	0	0
16	26142223	.	A	G	6	4	10	0	1	11	0	0
16	26142646	.	A	C	3	2	5	0	0	5	0	0
16	26142652	.	A	G	3	4	7	0	0	7	0	0
16	26142703	.	A	T	5	3	8	0	0	8	0	0
16	26142900	.	T	C	4	0	4	0	6	10	0	0
16	26143332	.	T	C	4	6	10	0	0	10	0	0
16	26143561	.	C	T	5	4	9	0	0	9	0	0
16	26148741	.	C	T	6	6	12	0	0	12	0	0
16	26148962	.	C	A	0	1	1	0	0	1	0	0
16	26148963	.	C	A	0	1	1	0	0	1	0	0
16	26149005	.	A	T	0	1	1	0	0	1	0	0
16	26157099	.	G	A	1	2	3	0	0	3	0	0
16	26157393	.	C	T	0	2	2	0	2	4	0	0
16	26167664	.	C	T	3	2	5	0	0	5	0	0
16	26169448	.	A	C	3	2	5	0	0	5	0	0
16	26169515	.	T	G	1	1	2	0	0	2	0	0
16	26186178	.	C	A	2	1	3	0	0	3	0	0
16	26186187	.	G	C	2	0	2	0	1	3	0	0
16	26234640	.	C	G	2	2	4	0	0	4	0	0
16	26234761	.	A	C	3	4	7	0	0	7	0	0
16	26234772	.	T	C	5	3	8	0	0	8	0	0
16	26379247	.	T	A	3	2	5	0	0	5	0	0
16	26381416	.	C	T	1	20	21	0	22	43	0	0
16	26406028	.	A	G	1	1	2	0	0	2	0	0
16	26410802	.	C	T	1	0	1	0	0	1	0	0
16	26413746	.	T	C	0	0	0	0	2	2	0	0
16	26435457	.	G	A	1	1	2	0	0	2	0	0
16	26443781	.	G	A	5	2	7	0	0	7	0	0
16	26443835	.	C	T	1	5	6	0	0	6	0	0
16	26443958	.	A	T	3	10	13	0	1	14	0	0
16	26444378	.	C	T	0	2	2	0	0	2	0	0
16	26444431	.	T	A	4	9	13	0	1	14	0	0
16	26444443	.	A	G	5	10	15	0	0	15	0	0
16	26444480	.	C	T	9	3	12	0	0	12	0	0
16	26444505	.	C	T	5	4	9	0	0	9	0	0
16	26444541	.	G	T	5	4	9	0	2	11	0	0
16	26444634	.	G	T	5	4	9	0	0	9	0	0
16	26444644	.	A	T	4	4	8	0	0	8	0	0
16	26444748	.	G	A	3	4	7	0	0	7	0	0
16	26444776	.	G	A	5	2	7	0	0	7	0	0
16	26444830	.	G	A	0	2	2	0	5	7	0	0
16	26445484	.	T	C	3	2	5	0	0	5	0	0
16	26445593	.	G	C	1	2	3	0	0	3	0	0
16	26445614	.	G	C	2	1	3	0	0	3	0	0
16	26482992	.	G	A	2	2	4	0	1	5	0	0
16	26599551	.	T	A	3	2	5	0	1	6	0	0
16	26599555	.	A	G	3	4	7	0	0	7	0	0
16	26612488	.	T	C	0	3	3	0	0	3	0	0
16	26631418	.	A	G	2	0	2	0	1	3	0	0
16	26634530	.	T	A	5	2	7	0	0	7	0	0
16	26688229	.	T	C	2	0	2	0	1	3	0	0
16	26689957	.	G	A	3	2	5	0	0	5	0	0
16	26690047	.	A	T	3	3	6	0	0	6	0	0
16	26691148	.	A	T	3	3	6	0	0	6	0	0
16	26691151	.	A	T	3	3	6	0	0	6	0	0
16	26691185	.	G	A	4	3	7	0	0	7	0	0
16	26691475	.	G	A	5	3	8	0	2	10	0	0
16	26691646	.	T	C	2	2	4	0	0	4	0	0
16	26691665	.	C	T	1	1	2	0	0	2	0	0
16	26694549	.	G	C	0	6	6	0	3	9	0	0
16	26702648	.	A	C	7	5	12	0	0	12	0	0
16	26702780	.	G	T	1	7	8	0	8	16	0	0
16	26706551	.	G	A	5	6	11	0	0	11	0	0
16	26706623	.	T	C	1	1	2	0	0	2	0	0
16	26706820	.	C	T	2	4	6	0	0	6	0	0
16	26706840	.	T	A	4	1	5	0	1	6	0	0
16	26706875	.	C	T	1	0	1	0	1	2	0	0
16	26707430	.	T	C	4	3	7	0	0	7	0	0
16	26707436	.	C	G	4	3	7	0	0	7	0	0
16	26707494	.	A	G	0	2	2	0	1	3	0	0
16	26710777	.	G	A	0	12	12	0	9	21	0	0
16	26710798	.	C	T	10	12	22	0	3	25	0	0
16	26710900	.	C	A	15	7	22	0	1	23	0	0
16	26710954	.	A	T	10	10	20	0	3	23	0	0
16	26710969	.	C	A	14	14	28	0	1	29	0	0
16	26713964	.	G	T	11	10	21	0	0	21	0	0
16	26717318	.	C	T	6	6	12	0	0	12	0	0
16	26766476	.	A	G	6	0	6	0	2	8	0	0
16	26766477	.	G	T	6	2	8	0	0	8	0	0
16	26766845	.	T	C	4	4	8	0	0	8	0	0
16	26766878	.	A	T	6	5	11	0	1	12	0	0
16	26766926	.	G	A	11	3	14	0	0	14	0	0
16	26768803	.	A	G	3	7	10	0	3	13	0	0
16	26816799	.	A	G	2	3	5	0	0	5	0	0
16	26816962	.	C	T	10	4	14	0	0	14	0	0
16	26817046	.	T	G	5	8	13	0	1	14	0	0
16	26817754	.	C	T	0	4	4	0	8	12	0	0
16	26817823	.	A	T	2	2	4	0	0	4	0	0
16	26818153	.	G	A	1	4	5	0	1	6	0	0
16	26818303	.	G	A	1	4	5	0	0	5	0	0
16	26818318	.	G	A	2	6	8	0	0	8	0	0
16	26818658	.	C	T	4	3	7	0	0	7	0	0
16	26818703	.	A	T	0	2	2	0	0	2	0	0
16	26818715	.	T	A	0	1	1	0	0	1	0	0
16	26850845	.	T	C	8	13	21	0	1	22	0	0
16	26850885	.	C	T	7	13	20	0	2	22	0	0
16	26851025	.	C	G	2	2	4	0	0	4	0	0
16	26851036	.	T	A	2	2	4	0	0	4	0	0
16	26851071	.	C	A	3	1	4	0	0	4	0	0
16	26851110	.	A	C	1	5	6	0	0	6	0	0
16	26851236	.	C	T	0	4	4	0	7	11	0	0
16	26851445	.	T	A	0	1	1	0	0	1	0	0
16	26855674	.	A	G	12	5	17	0	0	17	0	0
16	26855729	.	C	A	13	14	27	0	0	27	0	0
16	26855786	.	G	A	13	9	22	0	1	23	0	0
16	26855909	.	A	G	6	7	13	0	0	13	0	0
16	26863545	.	C	T	7	7	14	0	0	14	0	0
16	26863604	.	A	C	3	6	9	0	1	10	0	0
16	26994618	.	A	G	6	6	12	0	1	13	0	0
16	27069527	.	C	T	0	3	3	0	0	3	0	0
16	27072464	.	C	T	5	6	11	0	1	12	0	0
16	27072488	.	G	A	0	7	7	0	10	17	0	0
16	27098305	.	T	C	8	6	14	0	0	14	0	0
16	27098719	.	G	T	7	7	14	0	0	14	0	0
16	27098806	.	G	A	6	9	15	0	0	15	0	0
16	27099069	.	A	C	3	4	7	0	0	7	0	0
16	27099323	.	G	A	0	9	9	0	12	21	0	0
16	27099506	.	C	T	4	7	11	0	0	11	0	0
16	27099508	.	G	A	7	4	11	0	0	11	0	0
16	27100360	.	G	T	5	2	7	0	1	8	0	0
16	27126615	.	G	A	11	13	24	0	2	26	0	0
16	27126647	.	C	T	0	6	6	0	5	11	0	0
16	27126695	.	G	T	11	9	20	0	0	20	0	0
16	27126849	.	C	T	12	12	24	0	0	24	0	0
16	27127046	.	A	T	16	16	32	0	0	32	0	0
16	27127281	.	T	G	8	3	11	0	2	13	0	0
16	27127497	.	T	A	14	8	22	0	1	23	0	0
16	27127576	.	T	C	11	14	25	0	2	27	0	0
16	27127643	.	T	C	15	0	15	0	14	29	0	0
16	27131005	.	C	T	0	1	1	0	5	6	0	0
16	27138207	.	C	G	2	0	2	0	0	2	0	0
16	27138391	.	C	G	3	2	5	0	0	5	0	0
16	27148864	.	G	T	1	0	1	0	0	1	0	0
16	27158741	.	A	T	7	2	9	0	0	9	0	0
16	27159124	.	G	C	3	0	3	0	1	4	0	0
16	27161089	.	G	A	4	9	13	0	0	13	0	0
16	27215975	.	A	C	1	2	3	0	0	3	0	0
16	27216297	.	C	T	5	3	8	0	0	8	0	0
16	27216353	.	G	A	2	3	5	0	0	5	0	0
16	27216419	.	C	A	4	2	6	0	0	6	0	0
16	27216701	.	C	T	4	4	8	0	1	9	0	0
16	27216845	.	C	T	0	7	7	0	3	10	0	0
16	27217103	.	G	C	1	5	6	0	0	6	0	0
16	27217112	.	T	A	5	1	6	0	0	6	0	0
16	27217340	.	G	A	2	5	7	0	0	7	0	0
16	27223056	.	G	A	1	1	2	0	0	2	0	0
16	27231337	.	T	A	18	12	30	0	0	30	0	0
16	27231410	.	G	A	22	19	41	0	3	44	0	0
16	27231469	.	T	G	19	22	41	0	0	41	0	0
16	27356127	.	G	A	2	2	4	0	1	5	0	0
16	27363079	.	G	A	0	2	2	0	0	2	0	0
16	27363205	.	G	A	0	1	1	0	1	2	0	0
16	27367695	.	T	C	7	4	11	0	0	11	0	0
16	27368175	.	G	A	3	7	10	0	0	10	0	0
16	27368315	.	G	A	0	11	11	0	9	20	0	0
16	27368516	.	C	T	5	6	11	0	1	12	0	0
16	27368688	.	A	C	4	12	16	0	1	17	0	0
16	27368705	.	C	T	11	5	16	0	1	17	0	0
16	27368823	.	T	G	7	8	15	0	1	16	0	0
16	27368863	.	C	T	4	6	10	0	0	10	0	0
16	27392786	.	C	T	1	1	2	0	0	2	0	0
16	27405152	.	A	T	1	2	3	0	1	4	0	0
16	27417659	.	T	G	13	10	23	0	1	24	0	0
16	27427064	.	A	G	9	6	15	0	1	16	0	0
16	27427760	.	G	A	2	2	4	0	0	4	0	0
16	27502394	.	A	G	1	2	3	0	0	3	0	0
16	27510736	.	C	A	0	7	7	0	5	12	0	0
16	27513944	.	G	A	3	0	3	0	0	3	0	0
16	27522744	.	T	C	0	2	2	0	0	2	0	0
16	27532506	.	C	T	0	0	0	0	3	3	0	0
16	27533500	.	C	G	1	0	1	0	0	1	0	0
16	27533600	.	A	G	2	2	4	0	0	4	0	0
16	27533654	.	G	C	2	2	4	0	0	4	0	0
16	27536757	.	C	T	0	3	3	0	5	8	0	0
16	27536796	.	C	A	0	2	2	0	1	3	0	0
16	27539330	.	A	C	3	2	5	0	0	5	0	0
16	27539501	.	G	A	1	3	4	0	0	4	0	0
16	27548076	.	A	G	2	2	4	0	0	4	0	0
16	27550215	.	G	A	0	2	2	0	0	2	0	0
16	27555362	.	C	T	4	1	5	0	0	5	0	0
16	27555395	.	G	A	3	3	6	0	4	10	0	0
16	27558680	.	A	T	2	4	6	0	0	7	1	0
16	27575354	.	T	C	1	0	1	0	0	1	0	0
16	27608441	.	C	T	2	2	4	0	0	4	0	0
16	27608962	.	T	A	2	2	4	0	0	4	0	0
16	27608974	.	C	T	1	2	3	0	0	3	0	0
16	27615051	.	G	A	1	3	4	0	1	5	0	0
16	27615102	.	C	T	7	22	29	0	0	29	0	0
16	27615184	.	A	T	6	25	31	0	2	33	0	0
16	27617046	.	C	T	1	5	6	0	0	6	0	0
16	27617130	.	C	T	2	2	4	0	0	4	0	0
16	27621645	.	A	T	6	20	26	0	0	26	0	0
16	27621897	.	A	T	7	17	24	0	3	27	0	0
16	27629038	.	C	T	0	19	19	0	17	36	0	0
16	27629343	.	A	G	12	7	19	0	0	19	0	0
16	27629365	.	G	T	22	11	33	0	1	34	0	0
16	27629483	.	G	A	20	21	41	0	2	43	0	0
16	27629713	.	T	C	21	13	34	0	3	37	0	0
16	27630207	.	C	T	22	14	36	0	1	37	0	0
16	27630552	.	G	A	12	13	25	0	1	26	0	0
16	27631061	.	G	A	18	13	31	0	1	32	0	0
16	27631695	.	T	C	11	14	25	0	1	26	0	0
16	27631768	.	G	A	8	13	21	0	1	22	0	0
16	27632814	.	G	A	9	4	13	0	0	13	0	0
16	27633089	.	A	G	11	8	19	0	0	19	0	0
16	27633180	.	C	T	0	10	10	0	15	25	0	0
16	27633407	.	C	A	12	14	26	0	1	27	0	0
16	27633408	.	A	C	13	14	27	0	0	27	0	0
16	27640979	.	G	A	2	5	7	0	0	7	0	0
16	27660144	.	T	C	3	3	6	0	1	7	0	0
16	27660321	.	G	A	7	7	14	0	0	14	0	0
16	27660346	.	C	T	3	7	10	0	0	10	0	0
16	27660409	.	T	C	4	0	4	0	3	7	0	0
16	27660658	.	A	T	3	6	9	0	0	9	0	0
16	27660781	.	G	A	6	4	10	0	0	10	0	0
16	27660934	.	C	T	0	13	13	0	0	13	0	0
16	27661074	.	A	T	7	7	14	0	0	14	0	0
16	27671214	.	C	T	0	1	1	0	0	1	0	0
16	27672033	.	A	G	1	1	2	0	0	2	0	0
16	27736393	.	C	T	6	3	9	0	0	9	0	0
16	27736518	.	T	G	1	4	5	0	0	5	0	0
16	27736537	.	C	T	1	4	5	0	0	5	0	0
16	27737023	.	C	A	1	4	5	0	0	5	0	0
16	27998807	.	G	A	1	2	3	0	0	3	0	0
16	27998813	.	A	T	2	1	3	0	0	3	0	0
16	28112706	.	A	T	3	5	8	0	0	8	0	0
16	28112772	.	G	A	4	6	10	0	2	12	0	0
16	28113033	.	C	T	0	2	2	0	8	10	0	0
16	28256800	.	G	T	1	3	4	0	0	4	0	0
16	28256806	.	G	A	3	1	4	0	0	4	0	0
16	28263597	.	C	A	2	0	2	0	0	2	0	0
16	28268273	.	C	A	2	6	8	0	1	9	0	0
16	28270157	.	C	A	1	6	7	0	2	9	0	0
16	28270258	.	T	G	1	0	1	0	4	5	0	0
16	28270709	.	C	A	3	1	4	0	1	5	0	0
16	28277068	.	G	A	0	1	1	0	0	1	0	0
16	28277385	.	G	C	1	6	7	0	0	7	0	0
16	28278345	.	T	C	0	2	2	0	1	3	0	0
16	28278360	.	T	C	0	2	2	0	1	3	0	0
16	28278387	.	C	T	0	3	3	0	0	3	0	0
16	28309479	.	A	T	1	0	1	0	0	1	0	0
16	28313822	.	G	A	2	7	9	0	0	9	0	0
16	28313823	.	G	A	2	7	9	0	0	9	0	0
16	28511709	.	C	T	1	2	3	0	0	3	0	0
16	28554359	.	G	A	1	1	2	0	0	2	0	0
16	28573333	.	C	T	5	9	14	0	1	15	0	0
16	28573514	.	T	C	4	6	10	0	1	11	0	0
16	28573574	.	G	A	1	3	4	0	2	6	0	0
16	28573665	.	C	A	4	10	14	0	0	14	0	0
16	28573795	.	G	A	0	9	9	0	6	15	0	0
16	28573928	.	C	T	7	3	10	0	0	10	0	0
16	28573957	.	T	A	2	6	8	0	0	8	0	0
16	28574063	.	C	T	8	5	13	0	1	14	0	0
16	28574403	.	C	T	5	5	10	0	1	11	0	0
16	28581874	.	A	C	2	4	6	0	0	6	0	0
16	28591305	.	A	T	12	16	28	0	1	29	0	0
16	28591312	.	G	A	2	15	17	0	14	31	0	0
16	28591363	.	G	A	16	8	24	0	0	24	0	0
16	28592648	.	A	T	3	2	5	0	0	5	0	0
16	28592667	.	G	C	3	0	3	0	4	7	0	0
16	28592697	.	C	A	9	4	13	0	0	13	0	0
16	28592719	.	T	C	3	11	14	0	0	14	0	0
16	28592758	.	A	T	4	4	8	0	0	8	0	0
16	28592939	.	G	A	3	1	4	0	0	4	0	0
16	28592946	.	G	A	1	3	4	0	0	4	0	0
16	28593242	.	A	G	5	4	9	0	0	9	0	0
16	28593280	.	C	T	3	4	7	0	1	8	0	0
16	28593327	.	A	G	4	7	11	0	0	11	0	0
16	28593403	.	G	A	4	7	11	0	0	11	0	0
16	28593493	.	C	T	4	4	8	0	0	8	0	0
16	28593502	.	G	A	2	3	5	0	1	6	0	0
16	28593679	.	T	C	3	0	3	0	3	6	0	0
16	28593705	.	C	T	5	6	11	0	0	11	0	0
16	28598780	.	T	A	28	30	58	0	0	58	0	0
16	28598790	.	A	T	26	25	51	0	2	53	0	0
16	28598846	.	G	T	2	10	12	0	15	27	0	0
16	28599150	.	C	T	18	18	36	0	1	37	0	0
16	28607658	.	T	C	3	1	4	0	0	4	0	0
16	28624648	.	G	C	0	2	2	0	3	5	0	0
16	28626257	.	G	C	0	8	8	0	7	15	0	0
16	28626282	.	G	A	6	6	12	0	0	12	0	0
16	28626790	.	C	A	4	5	9	0	1	10	0	0
16	28626843	.	G	A	7	3	10	0	1	11	0	0
16	28626844	.	G	T	7	4	11	0	0	11	0	0
16	28626997	.	C	T	6	4	10	0	0	10	0	0
16	28627127	.	C	T	3	4	7	0	0	7	0	0
16	28627198	.	T	A	4	2	6	0	0	6	0	0
16	28627383	.	T	G	9	5	14	0	0	14	0	0
16	28627385	.	T	A	9	5	14	0	0	14	0	0
16	28627520	.	G	A	4	3	7	0	0	7	0	0
16	28627522	.	G	T	3	4	7	0	0	7	0	0
16	28629285	.	C	A	5	5	10	0	0	10	0	0
16	28629299	.	C	T	0	5	5	0	6	11	0	0
16	28638364	.	C	T	0	3	3	0	1	4	0	0
16	28644445	.	T	C	1	2	3	0	0	3	0	0
16	28649438	.	A	T	1	1	2	0	0	2	0	0
16	28663320	.	T	C	1	2	3	0	0	3	0	0
16	28663339	.	G	C	1	2	3	0	0	3	0	0
16	28664537	.	T	C	3	1	4	0	0	4	0	0
16	28664543	.	G	A	3	2	5	0	0	5	0	0
16	28664585	.	G	A	3	1	4	0	0	4	0	0
16	28664598	.	C	T	0	0	0	0	3	3	0	0
16	28664818	.	A	T	2	6	8	0	0	8	0	0
16	28664833	.	C	T	2	5	7	0	1	8	0	0
16	28665605	.	A	C	0	2	2	0	0	2	0	0
16	28665610	.	A	C	0	2	2	0	0	2	0	0
16	28666016	.	C	G	1	5	6	0	0	6	0	0
16	28667184	.	T	C	1	0	1	0	1	2	0	0
16	28674282	.	G	A	3	1	4	0	0	4	0	0
16	28678378	.	A	C	1	0	1	0	4	5	0	0
16	28842438	.	C	T	21	23	44	0	1	45	0	0
16	28856026	.	G	A	24	16	40	0	2	42	0	0
16	28983644	.	G	A	2	2	4	0	0	4	0	0
16	28983689	.	G	A	2	3	5	0	0	5	0	0
16	28995628	.	A	T	2	2	4	0	0	4	0	0
16	29009092	.	G	T	5	4	9	0	0	9	0	0
16	29010125	.	C	T	3	3	6	0	0	6	0	0
16	29010826	.	A	T	1	3	4	0	1	5	0	0
16	29012933	.	G	T	0	4	4	0	5	9	0	0
16	29012961	.	C	T	4	3	7	0	2	9	0	0
16	29013039	.	C	G	6	3	9	0	0	9	0	0
16	29013126	.	C	T	7	4	11	0	0	11	0	0
16	29013134	.	C	A	7	3	10	0	1	11	0	0
16	29013188	.	C	T	2	2	4	0	0	4	0	0
16	29013327	.	C	A	3	3	6	0	0	6	0	0
16	29013377	.	C	T	3	2	5	0	0	5	0	0
16	29014091	.	A	T	3	3	6	0	0	6	0	0
16	29014109	.	T	C	6	2	8	0	0	8	0	0
16	29016659	.	C	T	2	5	7	0	0	7	0	0
16	29016904	.	T	C	5	3	8	0	0	8	0	0
16	29017221	.	T	C	4	4	8	0	0	8	0	0
16	29019039	.	G	A	5	6	11	0	1	12	0	0
16	29020482	.	G	T	5	4	9	0	0	9	0	0
16	29022955	.	C	A	9	7	16	0	0	16	0	0
16	29023266	.	A	T	1	5	6	0	0	6	0	0
16	29024181	.	A	G	3	0	3	0	0	3	0	0
16	29024341	.	T	C	5	2	7	0	1	8	0	0
16	29024405	.	C	T	4	7	11	0	0	11	0	0
16	29024409	.	C	T	4	6	10	0	0	10	0	0
16	29027102	.	A	G	0	0	0	0	2	2	0	0
16	29029444	.	G	A	2	4	6	0	0	6	0	0
16	29029476	.	A	G	2	5	7	0	0	7	0	0
16	29030148	.	T	G	2	0	2	0	3	5	0	0
16	29044453	.	G	A	4	4	8	0	0	8	0	0
16	29044488	.	T	C	4	4	8	0	0	8	0	0
16	29050827	.	C	T	1	2	3	0	0	3	0	0
16	29051095	.	A	T	1	2	3	0	0	3	0	0
16	29051102	.	G	A	1	2	3	0	0	3	0	0
16	29052030	.	C	T	4	6	10	0	0	10	0	0
16	29052096	.	G	T	1	6	7	0	3	10	0	0
16	29052120	.	A	G	3	7	10	0	0	10	0	0
16	29052137	.	A	G	2	5	7	0	0	7	0	0
16	29052156	.	A	G	1	5	6	0	0	6	0	0
16	29052245	.	G	T	2	5	7	0	0	7	0	0
16	29052279	.	C	T	1	3	4	0	0	4	0	0
16	29052293	.	A	T	1	2	3	0	0	3	0	0
16	29052653	.	A	T	3	7	10	0	0	10	0	0
16	29052752	.	C	G	3	0	3	0	6	9	0	0
16	29052914	.	G	A	4	9	13	0	0	13	0	0
16	29052991	.	C	T	6	6	12	0	0	12	0	0
16	29053045	.	T	A	5	10	15	0	0	15	0	0
16	29053549	.	G	A	4	3	7	0	1	8	0	0
16	29053798	.	C	G	2	0	2	0	18	20	0	0
16	29054122	.	G	A	4	2	6	0	1	7	0	0
16	29054129	.	T	G	4	2	6	0	1	7	0	0
16	29073621	.	T	A	5	3	8	0	0	8	0	0
16	29074254	.	G	A	15	28	43	0	0	43	0	0
16	29075137	.	C	T	3	15	18	0	0	18	0	0
16	29075195	.	A	G	5	14	19	0	2	21	0	0
16	29075222	.	T	A	12	4	16	0	1	17	0	0
16	29075305	.	G	A	12	8	20	0	1	21	0	0
16	29075343	.	G	A	16	12	28	0	0	28	0	0
16	29075347	.	C	G	13	16	29	0	0	29	0	0
16	29075674	.	C	A	13	13	26	0	2	28	0	0
16	29075870	.	G	T	13	17	30	0	0	30	0	0
16	29075959	.	C	T	14	5	19	0	1	20	0	0
16	29075962	.	C	T	7	13	20	0	0	20	0	0
16	29076270	.	G	T	20	16	36	0	8	44	0	0
16	29076407	.	C	T	0	11	11	0	28	39	0	0
16	29076471	.	G	A	15	12	27	0	3	30	0	0
16	29076575	.	C	G	0	13	13	0	18	31	0	0
16	29076633	.	G	A	12	12	24	0	0	24	0	0
16	29076669	.	A	G	2	6	8	0	0	8	0	0
16	29076678	.	T	C	2	0	2	0	2	4	0	0
16	29111066	.	T	C	8	0	8	0	17	25	0	0
16	29225676	.	C	T	2	2	4	0	0	4	0	0
16	29225873	.	C	G	8	9	17	0	3	20	0	0
16	29226129	.	A	T	4	5	9	0	0	9	0	0
16	29226151	.	C	A	3	6	9	0	1	10	0	0
16	29226538	.	G	T	3	2	5	0	0	5	0	0
16	29226588	.	A	T	1	2	3	0	0	3	0	0
16	29265958	.	A	G	12	4	16	0	0	16	0	0
16	29265992	.	A	C	11	5	16	0	0	16	0	0
16	29266014	.	G	T	8	5	13	0	0	13	0	0
16	29266042	.	G	A	10	5	15	0	1	16	0	0
16	29266115	.	G	A	6	2	8	0	0	8	0	0
16	29266162	.	T	C	9	3	12	0	0	12	0	0
16	29266332	.	G	C	5	4	9	0	0	9	0	0
16	29266371	.	T	A	2	5	7	0	0	7	0	0
16	29266775	.	A	G	1	5	6	0	0	6	0	0
16	29266778	.	C	G	1	5	6	0	0	6	0	0
16	29267794	.	T	C	4	0	4	0	2	6	0	0
16	29267889	.	T	A	1	2	3	0	0	3	0	0
16	29303976	.	C	A	2	3	5	0	0	5	0	0
16	29306111	.	C	T	6	4	10	0	1	11	0	0
16	29310150	.	T	A	7	3	10	0	1	11	0	0
16	29310206	.	A	G	12	6	18	0	0	18	0	0
16	29310213	.	C	A	12	5	17	0	0	17	0	0
16	29310455	.	C	T	21	12	33	0	1	34	0	0
16	29310530	.	C	A	27	7	34	0	2	36	0	0
16	29310541	.	A	G	24	8	32	0	2	34	0	0
16	29310760	.	C	A	19	12	31	1	0	32	0	0
16	29310893	.	G	A	14	10	24	0	0	24	0	0
16	29310917	.	G	T	15	7	22	0	0	22	0	0
16	29311381	.	G	A	19	12	31	0	1	32	0	0
16	29311493	.	A	G	22	16	38	0	0	38	0	0
16	29311720	.	T	C	4	2	6	0	0	6	0	0
16	29313828	.	T	C	16	12	28	0	1	29	0	0
16	29314147	.	C	A	4	3	7	0	0	7	0	0
16	29320647	.	A	G	8	5	13	0	0	13	0	0
16	29320674	.	T	G	11	11	22	0	0	22	0	0
16	29320870	.	T	C	12	0	12	0	9	21	0	0
16	29321013	.	G	A	11	8	19	0	0	19	0	0
16	29323307	.	T	C	14	9	23	0	0	23	0	0
16	29323394	.	T	C	5	6	11	0	2	13	0	0
16	29324994	.	G	A	2	1	3	0	0	3	0	0
16	29325232	.	A	G	2	1	3	0	0	3	0	0
16	29328509	.	G	A	5	1	6	0	0	6	0	0
16	29370972	.	A	G	1	3	4	0	0	4	0	0
16	29371084	.	T	A	4	1	5	0	1	6	0	0
16	29371164	.	A	G	2	2	4	0	0	4	0	0
16	29371187	.	T	C	2	3	5	0	0	5	0	0
16	29373845	.	G	A	1	2	3	0	0	3	0	0
16	29374075	.	A	C	3	2	5	0	0	5	0	0
16	29381076	.	A	C	2	2	4	0	0	4	0	0
16	29381123	.	G	A	0	2	2	0	2	4	0	0
16	29381125	.	A	G	1	2	3	0	1	4	0	0
16	29381204	.	G	T	4	4	8	0	0	8	0	0
16	29384090	.	T	C	1	6	7	0	0	7	0	0
16	29384099	.	T	A	1	5	6	0	0	6	0	0
16	29384139	.	G	A	3	5	8	0	0	8	0	0
16	29384771	.	T	A	0	3	3	0	0	3	0	0
16	29391458	.	A	G	1	2	3	0	0	3	0	0
16	29407754	.	C	T	5	4	9	0	0	9	0	0
16	29407791	.	C	A	6	7	13	0	0	13	0	0
16	29408024	.	A	C	26	9	35	0	0	35	0	0
16	29408926	.	A	T	18	13	31	0	1	32	0	0
16	29408948	.	T	A	12	16	28	0	2	30	0	0
16	29409134	.	A	G	4	3	7	0	1	8	0	0
16	29409646	.	T	G	23	14	37	0	0	37	0	0
16	29409876	.	T	C	27	9	36	0	0	36	0	0
16	29410425	.	A	G	22	25	47	0	5	52	0	0
16	29410520	.	A	G	22	14	36	0	0	36	0	0
16	29411209	.	G	A	18	32	50	0	1	51	0	0
16	29413193	.	C	T	0	25	25	0	21	46	0	0
16	29414004	.	A	C	9	13	22	0	0	22	0	0
16	29419266	.	T	C	1	0	1	0	0	1	0	0
16	29420803	.	T	C	6	3	9	0	1	10	0	0
16	29421026	.	C	T	6	7	13	0	0	13	0	0
16	29424985	.	T	A	14	9	23	0	1	24	0	0
16	29425278	.	G	A	4	7	11	0	0	11	0	0
16	29427615	.	T	A	7	4	11	0	0	11	0	0
16	29456052	.	A	G	1	2	3	0	0	3	0	0
16	29456966	.	G	A	3	6	9	0	0	9	0	0
16	29456996	.	A	G	4	10	14	0	0	14	0	0
16	29457158	.	A	G	5	7	12	0	3	15	0	0
16	29457473	.	T	A	8	7	15	0	0	15	0	0
16	29457819	.	C	T	0	2	2	0	3	5	0	0
16	29458226	.	C	G	6	4	10	0	0	10	0	0
16	29458388	.	T	C	5	0	5	0	10	15	0	0
16	29460996	.	C	T	1	0	1	0	0	1	0	0
16	29502164	.	G	C	2	2	4	0	0	4	0	0
16	29526822	.	C	T	1	5	6	0	0	6	0	0
16	29526886	.	C	A	0	2	2	0	2	4	0	0
16	29586680	.	A	G	7	10	17	0	0	17	0	0
16	29642184	.	T	C	2	0	2	0	0	2	0	0
16	29644223	.	C	T	9	8	17	0	0	17	0	0
16	29667197	.	G	C	1	1	2	0	0	2	0	0
16	29671259	.	G	A	1	1	2	0	0	2	0	0
16	29686355	.	G	C	5	5	10	0	0	10	0	0
16	29686370	.	G	T	5	6	11	0	0	11	0	0
16	29688362	.	A	G	1	2	3	0	0	3	0	0
16	29688363	.	A	T	1	2	3	0	0	3	0	0
16	29691160	.	A	T	3	2	5	0	0	5	0	0
16	29691190	.	A	G	2	0	2	0	2	4	0	0
16	29693871	.	A	G	2	0	2	0	3	5	0	0
16	29693999	.	A	G	2	2	4	0	0	4	0	0
16	29695795	.	A	T	1	2	3	0	1	4	0	0
16	29695989	.	G	T	2	3	5	0	0	5	0	0
16	29696212	.	G	C	1	2	3	0	0	3	0	0
16	29696487	.	T	C	5	2	7	0	0	7	0	0
16	29696505	.	C	G	4	1	5	0	1	6	0	0
16	29696626	.	T	A	4	3	7	0	0	7	0	0
16	29696627	.	C	T	4	3	7	0	0	7	0	0
16	30002867	.	G	T	4	4	8	0	0	8	0	0
16	30184648	.	C	T	0	0	0	0	1	1	0	0
16	30199947	.	A	G	0	1	1	0	0	1	0	0
16	30202882	.	G	A	1	1	2	0	0	2	0	0
16	30202951	.	T	C	3	3	6	0	0	6	0	0
16	30205225	.	T	C	1	6	7	0	0	7	0	0
16	30267228	.	A	G	15	0	15	0	16	31	0	0
16	30267841	.	T	C	4	4	8	0	1	9	0	0
16	30268242	.	T	C	9	7	16	0	1	17	0	0
16	30268290	.	G	A	11	4	15	0	0	15	0	0
16	30268475	.	A	C	7	6	13	0	0	13	0	0
16	30269159	.	A	C	4	2	6	0	0	6	0	0
16	30270332	.	G	T	0	2	2	0	3	5	0	0
16	30270381	.	T	G	4	5	9	0	1	10	0	0
16	30270601	.	C	T	15	12	27	0	0	27	0	0
16	30322796	.	C	T	0	2	2	0	0	2	0	0
16	30408725	.	A	T	1	1	2	0	1	3	0	0
16	30408917	.	A	G	23	18	41	0	0	41	0	0
16	30409055	.	A	T	27	26	53	0	2	55	0	0
16	30409313	.	A	T	16	8	24	0	1	25	0	0
16	30415027	.	C	T	21	26	47	0	1	48	0	0
16	30417511	.	A	G	3	3	6	0	0	6	0	0
16	30417977	.	A	G	2	8	10	0	0	10	0	0
16	30417986	.	A	G	2	4	6	0	0	6	0	0
16	30419504	.	A	G	11	13	24	0	0	24	0	0
16	30422582	.	C	G	13	14	27	0	0	27	0	0
16	30422807	.	T	C	9	0	9	0	17	26	0	0
16	30422891	.	G	A	11	8	19	0	1	20	0	0
16	30423297	.	A	C	3	1	4	0	0	4	0	0
16	30423313	.	C	T	2	2	4	0	0	4	0	0
16	30423339	.	T	C	1	1	2	0	0	2	0	0
16	30423348	.	T	C	0	2	2	0	0	2	0	0
16	30423511	.	T	C	0	4	4	0	1	5	0	0
16	30423521	.	T	C	1	2	3	0	0	3	0	0
16	30423680	.	G	C	8	3	11	0	0	11	0	0
16	30423953	.	G	A	9	16	25	0	1	26	0	0
16	30426496	.	T	A	4	6	10	0	0	10	0	0
16	30427042	.	A	G	2	4	6	0	0	6	0	0
16	30429159	.	A	G	10	4	14	0	0	14	0	0
16	30429384	.	G	A	0	1	1	0	0	1	0	0
16	30432287	.	A	G	0	2	2	0	0	2	0	0
16	30434127	.	A	G	1	3	4	0	0	4	0	0
16	30434156	.	C	T	1	6	7	0	0	7	0	0
16	30434215	.	T	A	5	8	13	0	0	13	0	0
16	30521704	.	A	T	6	6	12	0	0	12	0	0
16	30522108	.	T	A	4	2	6	0	0	6	0	0
16	30522109	.	T	G	4	2	6	0	0	6	0	0
16	30522176	.	G	C	6	2	8	0	0	8	0	0
16	30522317	.	G	C	3	10	13	0	0	13	0	0
16	30522334	.	C	T	4	6	10	0	0	10	0	0
16	30522369	.	T	C	3	2	5	0	1	6	0	0
16	30522724	.	T	C	1	2	3	0	0	3	0	0
16	30522809	.	C	T	1	3	4	0	0	4	0	0
16	30522852	.	G	A	3	6	9	0	0	9	0	0
16	30522923	.	C	T	0	3	3	0	4	7	0	0
16	30523253	.	C	G	2	8	10	0	0	10	0	0
16	30525458	.	A	G	6	5	11	0	0	11	0	0
16	30525499	.	A	G	5	5	10	0	0	10	0	0
16	30530401	.	C	T	1	5	6	0	0	6	0	0
16	30531304	.	C	T	2	2	4	0	0	4	0	0
16	30531358	.	T	C	5	5	10	0	0	10	0	0
16	30537612	.	G	A	0	1	1	0	0	1	0	0
16	30537749	.	C	A	0	1	1	0	0	1	0	0
16	30562862	.	G	A	1	7	8	0	1	9	0	0
16	30737594	.	A	G	9	13	22	0	0	22	0	0
16	30737638	.	C	T	9	13	22	0	1	23	0	0
16	30737770	.	A	G	11	15	26	0	0	26	0	0
16	30740719	.	T	G	4	7	11	0	1	12	0	0
16	30760879	.	A	C	1	0	1	0	0	1	0	0
16	30772417	.	C	T	0	1	1	0	1	2	0	0
16	30785451	.	T	C	2	5	7	0	0	7	0	0
16	30788182	.	A	G	5	1	6	0	0	6	0	0
16	30794822	.	T	G	3	1	4	0	1	5	0	0
16	30808411	.	T	C	5	1	6	0	0	6	0	0
16	30808429	.	C	T	0	0	0	0	2	2	0	0
16	30826525	.	A	G	5	1	6	0	0	6	0	0
16	30826614	.	A	C	7	5	12	0	0	12	0	0
16	30869597	.	C	G	0	3	3	0	1	4	0	0
16	30869623	.	A	T	4	5	9	0	1	10	0	0
16	30908825	.	A	C	4	2	6	0	0	6	0	0
16	30909201	.	A	G	1	3	4	0	0	4	0	0
16	30909346	.	C	T	3	4	7	0	0	7	0	0
16	30909367	.	A	G	5	3	8	0	0	8	0	0
16	30910338	.	T	G	4	2	6	0	0	6	0	0
16	30910347	.	A	C	2	2	4	0	1	5	0	0
16	30914543	.	C	G	0	1	1	0	0	1	0	0
16	30918883	.	C	G	0	1	1	0	0	1	0	0
16	30919193	.	C	T	0	2	2	0	2	4	0	0
16	30919222	.	C	T	4	5	9	0	0	9	0	0
16	30919291	.	T	A	1	2	3	0	0	3	0	0
16	30948945	.	T	C	1	0	1	0	2	3	0	0
16	30980453	.	C	T	1	1	2	0	0	2	0	0
16	30980501	.	G	A	2	2	4	0	0	4	0	0
16	30983131	.	C	T	0	2	2	0	0	2	0	0
16	30983137	.	T	A	1	3	4	0	0	4	0	0
16	31000399	.	C	T	1	2	3	0	0	3	0	0
16	31186236	.	C	A	3	3	6	0	0	6	0	0
16	31186631	.	A	T	12	12	24	0	1	25	0	0
16	31187097	.	C	T	0	8	8	0	7	15	0	0
16	31187322	.	A	G	9	11	20	0	2	22	0	0
16	31188481	.	G	A	10	12	22	0	2	24	0	0
16	31188654	.	G	A	1	5	6	0	0	6	0	0
16	31260703	.	T	A	3	2	5	0	0	5	0	0
16	31260705	.	G	C	3	2	5	0	0	5	0	0
16	31260754	.	G	A	7	1	8	0	1	9	0	0
16	31261213	.	C	A	0	5	5	0	5	10	0	0
16	31261344	.	C	T	3	6	9	0	0	9	0	0
16	31266548	.	G	A	1	1	2	0	0	2	0	0
16	31268860	.	G	C	1	0	1	0	1	2	0	0
16	31268893	.	C	A	3	4	7	0	0	7	0	0
16	31272424	.	C	G	6	5	11	0	0	11	0	0
16	31274289	.	T	A	4	3	7	0	0	7	0	0
16	31274491	.	G	A	3	9	12	0	0	12	0	0
16	31280355	.	G	A	4	3	7	0	0	7	0	0
16	31306646	.	A	G	0	4	4	0	0	4	0	0
16	31314157	.	G	A	1	1	2	0	0	2	0	0
16	31342344	.	C	T	2	0	2	0	0	2	0	0
16	31351268	.	A	T	7	4	11	0	0	11	0	0
16	31437115	.	A	G	6	13	19	0	1	20	0	0
16	31437955	.	A	G	28	15	43	0	2	45	0	0
16	31444428	.	G	A	3	7	10	0	1	11	0	0
16	31445516	.	T	C	7	1	8	0	0	8	0	0
16	31454274	.	T	A	4	2	6	0	0	6	0	0
16	31454495	.	G	T	5	3	8	0	0	8	0	0
16	31454548	.	A	G	2	3	5	0	1	6	0	0
16	31454928	.	T	A	2	2	4	0	0	4	0	0
16	31516536	.	T	C	2	0	2	0	0	2	0	0
16	31516778	.	A	G	5	2	7	0	0	7	0	0
16	31602170	.	A	G	2	2	4	0	0	4	0	0
16	31608012	.	A	G	3	5	8	0	0	8	0	0
16	31608967	.	G	T	0	2	2	0	0	2	0	0
16	31609241	.	C	T	0	1	1	0	2	3	0	0
16	31613619	.	A	G	2	4	6	0	0	6	0	0
16	31614272	.	C	G	2	0	2	0	0	2	0	0
16	31614918	.	G	A	2	7	9	0	2	11	0	0
16	31615114	.	G	A	2	6	8	0	0	8	0	0
16	31717646	.	G	A	3	6	9	0	0	9	0	0
16	31717856	.	G	T	4	2	6	0	1	7	0	0
16	31762960	.	C	T	11	11	22	0	0	22	0	0
16	31763316	.	T	C	14	12	26	0	1	27	0	0
16	31763318	.	C	T	14	10	24	0	2	26	0	0
16	31763668	.	C	G	5	13	18	0	0	18	0	0
16	31763743	.	T	A	13	22	35	0	1	36	0	0
16	31763751	.	A	C	13	19	32	0	1	33	0	0
16	31763785	.	G	A	20	14	34	0	1	35	0	0
16	31763786	.	C	A	21	13	34	0	0	35	1	0
16	31763880	.	A	G	18	14	32	0	0	32	0	0
16	31764987	.	C	T	2	4	6	0	0	6	0	0
16	31766937	.	T	A	2	0	2	0	0	2	0	0
16	31767116	.	T	C	9	0	9	0	14	23	0	0
16	31767152	.	A	G	11	5	16	0	0	16	0	0
16	31767163	.	G	A	7	3	10	0	1	11	0	0
16	31767191	.	T	C	1	0	1	0	0	1	0	0
16	31768343	.	C	G	7	12	19	0	2	21	0	0
16	31768394	.	T	C	8	12	20	0	0	20	0	0
16	31768436	.	T	C	10	10	20	0	1	21	0	0
16	31769317	.	G	A	8	4	12	0	1	13	0	0
16	31769395	.	A	G	9	6	15	0	0	15	0	0
16	31769428	.	G	A	1	2	3	0	0	3	0	0
16	31776125	.	C	T	1	1	2	0	0	2	0	0
16	31780108	.	C	T	0	7	7	0	5	12	0	0
16	31782938	.	C	T	0	1	1	0	0	1	0	0
16	31789327	.	C	T	1	3	4	0	0	4	0	0
16	31790262	.	C	T	1	0	1	0	0	1	0	0
16	31815638	.	C	T	12	10	22	0	1	23	0	0
16	31815878	.	G	A	6	10	16	0	0	16	0	0
16	31816005	.	C	A	14	6	20	0	0	20	0	0
16	31816205	.	C	T	10	1	11	0	0	11	0	0
16	31816336	.	C	T	0	10	10	0	8	18	0	0
16	31816596	.	C	T	15	15	30	0	1	31	0	0
16	31827642	.	T	A	17	19	36	0	1	37	0	0
16	31827703	.	C	T	15	14	29	0	4	33	0	0
16	31832606	.	A	G	14	0	14	0	24	38	0	0
16	31833494	.	G	A	2	2	4	0	0	4	0	0
16	31853932	.	T	A	1	3	4	0	1	5	0	0
16	31854325	.	C	A	3	2	5	0	0	5	0	0
16	31855271	.	T	C	4	4	8	0	0	8	0	0
16	31855327	.	G	A	5	3	8	0	1	9	0	0
16	31855351	.	G	C	3	5	8	0	2	10	0	0
16	31855575	.	C	T	12	9	21	0	1	22	0	0
16	31855576	.	C	T	11	9	20	0	2	22	0	0
16	31855814	.	T	G	9	1	10	0	6	16	0	0
16	31856239	.	A	G	7	5	12	0	0	12	0	0
16	31858548	.	A	C	4	7	11	0	7	18	0	0
16	31858554	.	A	C	5	4	9	0	9	18	0	0
16	31859227	.	T	C	18	16	34	0	1	35	0	0
16	31859310	.	A	G	19	13	32	0	2	34	0	0
16	31859341	.	C	T	13	15	28	0	2	30	0	0
16	31859371	.	T	C	11	17	28	0	0	28	0	0
16	31859416	.	T	C	8	20	28	0	3	31	0	0
16	31859425	.	C	T	3	24	27	0	2	29	0	0
16	31859686	.	G	A	5	7	12	0	0	12	0	0
16	31868443	.	G	A	11	19	30	0	0	30	0	0
16	31922892	.	A	G	4	5	9	0	0	9	0	0
16	31923083	.	G	A	31	16	47	0	1	48	0	0
16	31923435	.	A	G	34	23	57	0	4	61	0	0
16	31924485	.	T	C	28	33	61	0	0	61	0	0
16	31924501	.	A	C	29	28	57	0	5	62	0	0
16	31925727	.	G	A	2	3	5	0	0	5	0	0
16	31927369	.	C	A	4	5	9	0	0	9	0	0
16	31928878	.	T	C	2	1	3	0	0	3	0	0
16	31942663	.	C	A	2	5	7	0	1	8	0	0
16	31946983	.	A	G	1	1	2	0	0	2	0	0
16	31955226	.	C	G	3	1	4	0	1	5	0	0
16	31958957	.	G	T	0	1	1	0	1	2	0	0
16	31959098	.	G	A	0	2	2	0	4	6	0	0
16	31959110	.	T	C	3	2	5	0	0	5	0	0
16	31959179	.	T	G	3	2	5	0	1	6	0	0
16	31959225	.	G	A	2	6	8	0	0	8	0	0
16	31959231	.	A	T	1	6	7	0	1	8	0	0
16	31959277	.	A	T	1	5	6	0	0	6	0	0
16	31959476	.	G	A	2	4	6	0	0	6	0	0
16	31959496	.	A	G	2	0	2	0	4	6	0	0
16	31959612	.	G	A	2	2	4	0	1	5	0	0
16	31960037	.	G	A	0	5	5	0	6	11	0	0
16	31960064	.	G	C	6	3	9	0	0	9	0	0
16	31960145	.	C	T	9	7	16	0	1	17	0	0
16	31960152	.	C	T	7	5	12	0	2	14	0	0
16	32009736	.	A	T	6	2	8	1	0	9	0	0
16	32011649	.	C	T	6	5	11	0	1	12	0	0
16	32011673	.	A	G	4	1	5	0	0	5	0	0
16	32013272	.	G	A	3	1	4	0	0	4	0	0
16	32013861	.	G	A	3	6	9	0	0	9	0	0
16	32013891	.	G	A	3	4	7	0	0	7	0	0
16	32014627	.	T	A	3	6	9	0	0	9	0	0
16	32014633	.	A	T	3	6	9	0	0	9	0	0
16	32018590	.	C	T	1	2	3	0	0	3	0	0
16	32019695	.	G	A	1	0	1	0	0	1	0	0
16	32021999	.	C	T	1	2	3	0	0	3	0	0
16	32023124	.	T	A	2	4	6	0	0	6	0	0
16	32025648	.	T	A	8	14	22	0	0	22	0	0
16	32025978	.	G	A	4	6	10	0	2	12	0	0
16	32025987	.	T	A	5	10	15	0	1	16	0	0
16	32026063	.	G	A	0	3	3	0	13	16	0	0
16	32026105	.	T	A	6	3	9	0	0	9	0	0
16	32051854	.	A	C	6	5	11	0	0	11	0	0
16	32052004	.	T	G	3	1	4	0	0	4	0	0
16	32052283	.	T	A	2	0	2	0	0	2	0	0
16	32052307	.	T	C	5	3	8	0	0	8	0	0
16	32052328	.	T	A	4	4	8	0	1	9	0	0
16	32052404	.	G	T	1	6	7	0	8	15	0	0
16	32055726	.	T	G	12	14	26	0	0	26	0	0
16	32057809	.	T	C	7	9	16	0	1	17	0	0
16	32057853	.	G	A	0	4	4	0	5	9	0	0
16	32060021	.	G	A	0	7	7	0	12	19	0	0
16	32060121	.	G	T	4	7	11	0	2	13	0	0
16	32060130	.	C	A	4	8	12	0	2	14	0	0
16	32063433	.	C	T	3	10	13	0	1	14	0	0
16	32067316	.	A	C	0	1	1	0	0	1	0	0
16	32068332	.	G	A	8	8	16	0	1	17	0	0
16	32068452	.	C	A	5	8	13	0	1	14	0	0
16	32068503	.	T	C	4	10	14	0	1	15	0	0
16	32068824	.	G	C	7	6	13	0	0	13	0	0
16	32069310	.	T	A	13	13	26	0	4	30	0	0
16	32069653	.	A	G	11	9	20	0	3	23	0	0
16	32070489	.	A	G	9	1	10	0	9	19	0	0
16	32070570	.	C	T	14	9	23	0	0	23	0	0
16	32070981	.	G	C	10	14	24	0	4	28	0	0
16	32071965	.	G	C	7	5	12	0	0	12	0	0
16	32071997	.	C	A	11	5	16	0	0	16	0	0
16	32072334	.	A	G	15	11	26	0	1	27	0	0
16	32073301	.	A	C	17	17	34	0	2	36	0	0
16	32073507	.	A	C	15	20	35	0	0	35	0	0
16	32073555	.	A	G	17	19	36	0	2	38	0	0
16	32073760	.	G	A	18	13	31	0	7	38	0	0
16	32074041	.	G	A	18	13	31	0	1	32	0	0
16	32074257	.	A	G	23	2	25	0	14	39	0	0
16	32074293	.	T	A	19	14	33	0	1	35	1	0
16	32074294	.	A	G	20	15	35	0	0	35	0	0
16	32080069	.	G	T	1	9	10	0	8	18	0	0
16	32080099	.	G	A	3	5	8	0	0	8	0	0
16	32080306	.	T	A	6	1	7	0	0	7	0	0
16	32080508	.	T	A	8	11	19	0	0	19	0	0
16	32082397	.	T	C	6	3	9	0	0	9	0	0
16	32082589	.	G	A	1	6	7	0	0	7	0	0
16	32082597	.	G	A	1	7	8	0	0	8	0	0
16	32082642	.	G	A	5	5	10	0	0	10	0	0
16	32085631	.	A	G	1	1	2	0	0	2	0	0
16	32085778	.	A	C	2	0	2	0	0	2	0	0
16	32086136	.	C	T	8	6	14	0	0	14	0	0
16	32088580	.	T	A	0	1	1	0	0	1	0	0
16	32090349	.	C	T	9	9	18	0	0	18	0	0
16	32110659	.	A	G	14	11	25	0	1	26	0	0
16	32110766	.	T	A	4	3	7	0	0	7	0	0
16	32111246	.	G	T	12	10	22	0	0	22	0	0
16	32113155	.	G	A	10	6	16	0	2	18	0	0
16	32113218	.	G	A	4	2	6	0	0	6	0	0
16	32116790	.	A	T	1	3	4	0	0	4	0	0
16	32117345	.	T	A	7	3	10	0	6	16	0	0
16	32119895	.	G	T	8	10	18	0	0	18	0	0
16	32120138	.	G	T	6	9	15	0	0	15	0	0
16	32120141	.	T	C	4	1	5	0	10	15	0	0
16	32120173	.	G	A	8	9	17	0	1	18	0	0
16	32120204	.	G	T	9	9	18	0	2	20	0	0
16	32120279	.	A	C	5	6	11	0	0	11	0	0
16	32128259	.	T	A	1	3	4	0	0	4	0	0
16	32131692	.	T	G	1	0	1	0	1	2	0	0
16	32140977	.	C	T	3	3	6	0	1	7	0	0
16	32140999	.	A	G	4	2	6	0	0	6	0	0
16	32141036	.	G	A	2	3	5	0	0	5	0	0
16	32141058	.	A	G	3	2	5	0	0	5	0	0
16	32141075	.	G	A	3	3	6	0	0	6	0	0
16	32141544	.	A	G	10	0	10	0	9	19	0	0
16	32141565	.	A	C	9	7	16	0	0	16	0	0
16	32141604	.	A	T	3	4	7	0	1	8	0	0
16	32144337	.	T	C	8	4	12	0	0	12	0	0
16	32144377	.	T	C	6	5	11	0	1	12	0	0
16	32144854	.	G	T	0	4	4	0	3	7	0	0
16	32144989	.	T	C	4	2	6	0	0	6	0	0
16	32145160	.	T	A	7	4	11	0	1	12	0	0
16	32145391	.	G	A	1	2	3	0	0	3	0	0
16	32145547	.	T	C	3	4	7	0	0	7	0	0
16	32145636	.	A	G	5	7	12	0	1	13	0	0
16	32257179	.	T	A	1	0	1	0	0	1	0	0
16	32267128	.	G	A	9	9	18	0	1	19	0	0
16	32267203	.	G	A	0	6	6	0	6	12	0	0
16	32273192	.	G	A	0	3	3	0	3	6	0	0
16	32274935	.	G	A	1	1	2	0	0	2	0	0
16	32275601	.	T	A	6	3	9	0	0	9	0	0
16	32275628	.	A	T	4	7	11	0	1	12	0	0
16	32561581	.	T	A	2	3	5	0	0	5	0	0
16	32562038	.	A	T	7	4	11	0	0	11	0	0
16	32562817	.	A	T	2	3	5	0	0	5	0	0
16	33004366	.	A	T	4	3	7	0	0	7	0	0
16	33004387	.	C	T	7	3	10	0	4	14	0	0
16	33595080	.	C	T	6	2	8	0	0	8	0	0
16	33595707	.	G	T	1	2	3	0	0	3	0	0
16	33595712	.	G	T	3	3	6	0	0	6	0	0
16	33735481	.	G	A	5	6	11	0	0	11	0	0
16	33735503	.	C	T	3	5	8	0	0	8	0	0
16	33735814	.	G	A	0	4	4	0	1	5	0	0
16	33735817	.	T	A	1	3	4	0	0	4	0	0
16	33735849	.	A	T	1	2	3	0	0	3	0	0
16	33736023	.	A	G	5	2	7	0	0	7	0	0
16	33736196	.	A	C	2	4	6	0	0	6	0	0
16	33736595	.	C	T	2	2	4	0	0	4	0	0
16	33774197	.	T	C	1	2	3	0	0	3	0	0
16	33806174	.	C	A	1	2	3	0	0	3	0	0
16	33905018	.	C	T	1	4	5	0	1	6	0	0
16	33909384	.	G	A	0	4	4	0	2	6	0	0
16	33919623	.	G	A	2	2	4	0	0	4	0	0
16	33923421	.	G	T	1	4	5	0	1	6	0	0
16	33923448	.	G	T	5	6	11	0	0	11	0	0
16	33923514	.	G	A	9	12	21	0	0	21	0	0
16	33925356	.	G	A	0	5	5	0	3	8	0	0
16	33925565	.	T	G	3	2	5	0	1	6	0	0
16	33926074	.	C	T	1	0	1	0	0	1	0	0
16	33928015	.	G	A	1	1	2	0	0	2	0	0
16	33929641	.	C	T	1	2	3	0	0	3	0	0
16	33933213	.	C	T	4	0	4	0	0	4	0	0
16	33933496	.	G	C	6	3	9	0	1	10	0	0
16	33933498	.	C	T	4	6	10	0	0	10	0	0
16	33933732	.	G	A	0	2	2	0	3	5	0	0
16	33939824	.	T	C	2	5	7	0	0	7	0	0
16	33939859	.	C	T	4	8	12	0	0	12	0	0
16	33940098	.	G	A	4	4	8	0	0	8	0	0
16	33940122	.	G	A	3	6	9	0	0	9	0	0
16	33940140	.	T	C	0	13	13	0	0	13	0	0
16	33940364	.	A	G	3	0	3	0	6	9	0	0
16	33940379	.	T	A	4	9	13	0	0	13	0	0
16	33953652	.	T	A	2	3	5	0	0	5	0	0
16	33953968	.	C	T	5	4	9	0	0	9	0	0
16	33964788	.	G	T	1	2	3	0	0	3	0	0
16	33971993	.	G	A	0	6	6	0	7	13	0	0
16	33972008	.	G	A	9	7	16	0	1	17	0	0
16	33972037	.	A	C	8	8	16	0	3	19	0	0
16	33972067	.	A	G	4	6	10	0	1	11	0	0
16	33972193	.	G	A	0	10	10	0	3	13	0	0
16	33972242	.	G	T	6	5	11	0	0	11	0	0
16	33972249	.	C	T	4	6	10	0	0	10	0	0
16	33972454	.	C	T	13	5	18	0	0	18	0	0
16	33978019	.	A	G	2	0	2	0	4	6	0	0
16	33979746	.	A	T	3	4	7	0	0	7	0	0
16	33981439	.	C	T	6	0	6	0	0	6	0	0
16	33981873	.	A	G	9	0	9	0	10	19	0	0
16	33983784	.	T	G	10	4	14	0	0	14	0	0
16	33983904	.	C	T	4	2	6	0	0	6	0	0
16	33984178	.	C	T	5	2	7	0	1	8	0	0
16	33984190	.	C	T	5	2	7	0	1	8	0	0
16	33985050	.	G	T	1	7	8	0	14	22	0	0
16	33985362	.	C	T	10	9	19	0	2	21	0	0
16	33985612	.	G	T	12	2	14	0	0	14	0	0
16	33986452	.	T	G	16	19	35	0	2	37	0	0
16	33989606	.	G	T	0	7	7	0	2	9	0	0
16	33992678	.	A	C	2	2	4	0	0	4	0	0
16	33994640	.	G	A	0	3	3	0	4	7	0	0
16	33995754	.	G	A	0	3	3	0	4	7	0	0
16	33996739	.	C	T	4	3	7	0	0	7	0	0
16	34004562	.	G	A	0	6	6	0	6	12	0	0
16	34004595	.	T	C	10	10	20	0	0	20	0	0
16	34004862	.	C	T	3	4	7	0	0	7	0	0
16	34005290	.	C	T	7	2	9	0	0	9	0	0
16	34005415	.	C	T	6	3	9	0	0	9	0	0
16	34005500	.	C	A	6	4	10	0	0	10	0	0
16	34005509	.	G	T	8	3	11	0	0	11	0	0
16	34005577	.	A	G	5	5	10	0	0	10	0	0
16	34005669	.	C	T	4	7	11	0	0	11	0	0
16	34005686	.	C	T	7	6	13	0	1	14	0	0
16	34005812	.	T	A	15	3	18	0	0	18	0	0
16	34006020	.	G	C	1	4	5	0	0	5	0	0
16	34054141	.	A	G	3	2	5	0	0	5	0	0
16	34054171	.	A	G	5	2	7	0	1	8	0	0
16	34054345	.	A	G	5	0	5	0	6	11	0	0
16	34054464	.	C	A	2	3	5	0	0	5	0	0
16	34054515	.	A	G	1	3	4	0	1	5	0	0
16	34054519	.	C	T	1	4	5	0	0	5	0	0
16	34054712	.	T	G	3	0	3	0	4	7	0	0
16	34054778	.	G	A	5	4	9	0	0	9	0	0
16	34054786	.	T	G	6	2	8	0	0	8	0	0
16	34056204	.	T	A	1	4	5	0	0	5	0	0
16	34056324	.	T	G	1	2	3	0	1	4	0	0
16	34160860	.	T	G	5	7	12	0	0	12	0	0
16	34172628	.	A	G	0	1	1	0	0	1	0	0
16	34172916	.	G	A	4	6	10	0	0	10	0	0
16	34173000	.	T	C	4	5	9	0	1	10	0	0
16	34173331	.	G	A	2	5	7	0	0	7	0	0
16	34185709	.	A	C	3	4	7	0	1	8	0	0
16	34185906	.	A	T	6	5	11	0	1	12	0	0
16	34200704	.	C	T	3	2	5	0	0	5	0	0
16	34201023	.	A	G	8	5	13	0	0	13	0	0
16	34208582	.	T	C	13	0	13	0	15	28	0	0
16	34208696	.	A	G	17	14	31	0	0	31	0	0
16	34212477	.	A	G	12	12	24	0	0	24	0	0
16	34212516	.	A	G	10	9	19	0	1	20	0	0
16	34212565	.	G	A	7	15	22	0	0	22	0	0
16	34212567	.	G	C	7	14	21	0	1	22	0	0
16	34212630	.	T	C	16	3	19	0	20	39	0	0
16	34212676	.	G	C	14	2	16	0	10	26	0	0
16	34222439	.	T	G	14	9	23	0	1	24	0	0
16	34225173	.	T	C	1	1	2	0	0	2	0	0
16	34225392	.	A	G	7	14	21	0	2	23	0	0
16	34225472	.	G	A	12	17	29	0	1	30	0	0
16	34267938	.	C	T	0	0	0	0	3	3	0	0
16	34267991	.	G	C	3	0	3	0	0	3	0	0
16	34321568	.	A	T	3	7	10	0	1	11	0	0
16	34322253	.	C	A	6	2	8	0	1	9	0	0
16	34322346	.	G	A	11	9	20	0	3	23	0	0
16	34322372	.	C	T	0	10	10	0	11	21	0	0
16	34331489	.	A	G	4	4	8	0	1	9	0	0
16	34337976	.	A	T	8	5	13	0	0	13	0	0
16	34338475	.	A	G	7	4	11	0	0	11	0	0
16	34339168	.	A	C	6	8	14	0	0	14	0	0
16	34339432	.	A	T	14	9	23	0	0	23	0	0
16	34339693	.	C	T	4	12	16	0	0	16	0	0
16	34339857	.	T	G	7	4	11	0	0	11	0	0
16	34340179	.	A	T	6	10	16	0	0	16	0	0
16	34340311	.	T	C	5	0	5	0	6	11	0	0
16	34340397	.	A	C	9	3	12	0	1	14	1	0
16	34340520	.	G	T	5	6	11	0	4	15	0	0
16	34340538	.	C	T	5	8	13	0	0	13	0	0
16	34340965	.	C	T	4	3	7	0	0	7	0	0
16	34340967	.	A	G	4	2	6	0	1	7	0	0
16	34341012	.	C	T	4	2	6	0	0	6	0	0
16	34341021	.	C	T	3	2	5	0	0	5	0	0
16	34341080	.	T	C	1	3	4	0	0	4	0	0
16	34342182	.	T	C	5	6	11	0	1	12	0	0
16	34497550	.	T	C	10	4	14	0	1	15	0	0
16	34499400	.	A	G	4	3	7	0	0	7	0	0
16	34499701	.	G	A	1	2	3	0	0	3	0	0
16	34499892	.	A	C	1	1	2	0	0	2	0	0
16	34499940	.	A	G	3	4	7	0	0	7	0	0
16	34500033	.	A	T	0	4	4	0	0	4	0	0
16	34500542	.	G	C	9	7	16	0	1	17	0	0
16	34500582	.	G	A	3	4	7	0	0	7	0	0
16	34500589	.	G	C	0	3	3	0	2	5	0	0
16	34500899	.	G	A	13	9	22	0	2	24	0	0
16	34501348	.	C	T	6	8	14	0	1	15	0	0
16	34501380	.	C	T	8	9	17	0	0	17	0	0
16	34501496	.	G	A	0	6	6	0	10	16	0	0
16	34501670	.	C	T	4	10	14	0	1	15	0	0
16	34525621	.	C	A	27	24	51	0	2	53	0	0
16	34526092	.	C	G	33	24	57	0	6	63	0	0
16	34526093	.	A	C	23	24	47	0	16	63	0	0
16	34526795	.	A	T	24	44	68	0	1	69	0	0
16	34526926	.	A	T	23	34	57	2	7	66	0	0
16	34532040	.	C	T	8	6	14	0	0	14	0	0
16	34532205	.	G	A	1	12	13	0	12	25	0	0
16	34532782	.	C	G	5	9	14	0	0	14	0	0
16	34532843	.	T	C	8	8	16	0	1	17	0	0
16	34930635	.	A	G	2	5	7	0	1	8	0	0
16	34930719	.	C	T	0	10	10	0	2	12	0	0
16	34948262	.	C	T	7	3	10	0	0	10	0	0
16	34953166	.	C	T	3	4	7	0	2	9	0	0
16	34975908	.	A	G	1	1	2	0	0	2	0	0
16	34989800	.	C	T	0	1	1	0	0	1	0	0
16	34993814	.	T	C	2	0	2	0	5	7	0	0
16	35022679	.	G	A	12	6	18	0	0	18	0	0
16	35023920	.	C	T	2	4	6	0	1	7	0	0
16	35023934	.	T	C	2	5	7	0	0	7	0	0
16	35043863	.	C	T	5	8	13	0	0	13	0	0
16	35053907	.	C	G	5	9	14	0	0	14	0	0
16	35351867	.	G	A	0	1	1	0	1	2	0	0
16	35351986	.	T	C	1	1	2	0	1	3	0	0
16	35354005	.	A	C	2	3	5	0	0	5	0	0
16	35354017	.	A	T	2	2	4	0	0	4	0	0
16	35367140	.	C	G	2	1	3	0	0	3	0	0
16	35367144	.	C	T	1	2	3	0	0	3	0	0
16	35372069	.	C	T	6	1	7	0	0	7	0	0
16	35376598	.	G	T	11	5	16	0	1	17	0	0
16	35376825	.	C	T	5	8	13	0	1	14	0	0
16	35405500	.	C	T	1	2	3	0	0	3	0	0
16	35409483	.	C	T	0	14	14	0	24	38	0	0
16	35409783	.	G	A	2	5	7	0	0	7	0	0
16	35414455	.	A	G	10	1	11	0	1	12	0	0
16	35414470	.	T	C	4	2	6	0	0	6	0	0
16	35414991	.	C	T	6	19	25	0	0	25	0	0
16	35416113	.	A	G	2	6	8	0	0	8	0	0
16	35416158	.	C	T	1	0	1	0	0	1	0	0
16	35416786	.	A	G	8	3	11	0	1	12	0	0
16	35418744	.	T	C	1	0	1	0	4	5	0	0
16	35420600	.	T	C	6	0	6	0	2	8	0	0
16	35423585	.	C	T	0	11	11	0	5	16	0	0
16	35426998	.	T	C	5	0	5	0	11	16	0	0
16	35536574	.	C	A	13	10	23	0	1	24	0	0
16	35536576	.	G	A	0	10	10	0	14	24	0	0
16	35536848	.	G	A	8	9	17	0	0	17	0	0
16	35536900	.	A	G	5	7	12	0	0	12	0	0
16	35536960	.	T	C	10	6	16	0	0	16	0	0
16	35536990	.	C	T	7	12	19	0	0	19	0	0
16	35537153	.	G	A	7	10	17	0	1	18	0	0
16	35556303	.	C	T	1	3	4	0	0	4	0	0
16	35562804	.	A	G	2	2	4	0	0	4	0	0
16	35578923	.	T	C	1	3	4	0	0	4	0	0
16	35605879	.	T	C	0	1	1	0	0	1	0	0
16	35661979	.	A	G	3	2	5	0	0	5	0	0
16	35662132	.	A	C	4	1	5	0	1	6	0	0
16	35728994	.	G	A	0	1	1	0	0	1	0	0
16	35743803	.	G	A	4	3	7	0	0	7	0	0
16	35743849	.	A	T	5	2	7	0	1	8	0	0
16	35750714	.	T	A	7	11	18	0	3	21	0	0
16	35752670	.	C	T	13	10	23	0	0	23	0	0
16	35752785	.	T	C	16	11	27	0	1	28	0	0
16	35773005	.	A	G	2	6	8	1	1	10	0	0
16	36041247	.	G	A	1	1	2	0	0	2	0	0
16	36062265	.	T	C	4	0	4	0	5	9	0	0
16	36075293	.	T	C	5	3	8	0	0	8	0	0
16	36075312	.	T	C	3	5	8	0	0	8	0	0
16	36075471	.	G	A	4	6	10	0	1	11	0	0
16	36075478	.	T	A	6	6	12	0	0	12	0	0
16	36075677	.	C	A	5	9	14	0	0	14	0	0
16	36075999	.	A	G	7	10	17	0	1	18	0	0
16	36076082	.	G	A	7	13	20	0	0	20	0	0
16	36080364	.	C	T	9	13	22	0	2	24	0	0
16	36080376	.	A	C	4	14	18	0	1	19	0	0
16	36087550	.	A	C	2	0	2	0	5	7	0	0
16	36118070	.	T	C	8	0	8	0	4	12	0	0
16	36118166	.	T	C	7	0	7	0	4	11	0	0
16	36150674	.	A	G	4	4	8	0	1	9	0	0
16	36150707	.	C	T	10	10	20	0	0	20	0	0
16	36150949	.	C	T	17	13	30	0	0	30	0	0
16	36150964	.	C	T	16	9	25	0	0	25	0	0
16	36151000	.	C	A	5	3	8	0	0	8	0	0
16	36159928	.	T	C	10	18	28	0	0	28	0	0
16	36162013	.	C	T	9	15	24	0	0	24	0	0
16	36162201	.	A	G	7	6	13	0	0	13	0	0
16	36162363	.	A	G	5	4	9	0	0	9	0	0
16	36162584	.	G	C	0	9	9	0	9	18	0	0
16	36162650	.	T	C	9	9	18	0	0	18	0	0
16	36162727	.	A	G	18	9	27	0	1	28	0	0
16	36162754	.	A	G	17	7	24	0	2	26	0	0
16	36162938	.	G	T	7	4	11	0	0	11	0	0
16	36168094	.	G	T	5	3	8	0	0	8	0	0
16	36168416	.	T	C	8	3	11	0	0	11	0	0
16	36168510	.	A	T	3	3	6	0	0	6	0	0
16	36168994	.	C	T	5	4	9	0	0	9	0	0
16	36169007	.	T	C	4	3	7	0	0	7	0	0
16	36169057	.	T	G	1	2	3	0	1	4	0	0
16	36169096	.	T	C	1	2	3	0	1	4	0	0
16	36169150	.	T	C	6	5	11	0	0	11	0	0
16	36169568	.	G	T	3	2	5	0	0	5	0	0
16	36171552	.	A	G	2	3	5	0	0	5	0	0
16	36172961	.	A	G	2	2	4	0	0	4	0	0
16	36172982	.	C	T	3	3	6	0	0	6	0	0
16	36173406	.	A	T	1	4	5	0	0	5	0	0
16	36180591	.	A	G	2	2	4	0	0	4	0	0
16	36180753	.	A	G	1	1	2	0	0	2	0	0
16	36180810	.	T	A	4	1	5	0	1	6	0	0
16	36183047	.	A	G	0	4	4	0	0	4	0	0
16	36184666	.	T	C	1	0	1	0	2	3	0	0
16	36189865	.	G	A	1	4	5	0	0	5	0	0
16	36195921	.	C	T	1	1	2	0	0	2	0	0
16	36195942	.	C	T	1	0	1	0	0	1	0	0
16	36196411	.	T	C	1	3	4	0	0	4	0	0
16	36721560	.	A	T	3	7	10	0	1	12	1	0
16	36721589	.	T	G	4	8	12	0	0	12	0	0
16	36724010	.	C	G	1	6	7	0	9	16	0	0
16	36729322	.	A	T	1	0	1	0	1	2	0	0
16	36729352	.	G	T	3	2	5	0	0	5	0	0
16	36729373	.	A	G	2	3	5	0	0	5	0	0
16	36731307	.	A	G	5	11	16	0	0	16	0	0
16	36735751	.	T	C	0	2	2	0	0	2	0	0
16	36741148	.	T	C	2	1	3	0	0	3	0	0
16	36743328	.	G	A	4	3	7	0	0	7	0	0
16	36743351	.	G	A	5	3	8	0	1	9	0	0
16	36745973	.	C	T	0	1	1	0	1	2	0	0
16	36748214	.	T	G	1	2	3	0	0	3	0	0
16	36748366	.	T	C	6	0	6	0	5	11	0	0
16	36749242	.	T	G	1	0	1	0	2	3	0	0
16	36751410	.	C	T	2	1	3	0	0	3	0	0
16	36751413	.	C	G	2	1	3	0	0	3	0	0
16	36752254	.	A	G	3	3	6	0	0	6	0	0
16	36752278	.	T	C	2	2	4	0	0	4	0	0
16	36759756	.	A	G	4	2	6	0	0	6	0	0
16	36759908	.	A	T	6	5	11	0	0	11	0	0
16	36759937	.	A	G	3	4	7	0	0	7	0	0
16	36766180	.	T	G	16	9	25	0	1	26	0	0
16	36766467	.	G	T	9	11	20	0	4	24	0	0
16	36766497	.	T	G	4	3	7	0	16	23	0	0
16	36906805	.	C	T	6	2	8	0	0	8	0	0
16	36906885	.	A	G	1	1	2	0	0	2	0	0
16	36911214	.	C	A	5	1	6	0	0	6	0	0
16	36914935	.	T	C	2	1	3	0	1	4	0	0
16	36923298	.	C	T	7	4	11	0	0	11	0	0
16	36925462	.	G	A	0	3	3	0	1	4	0	0
16	36926775	.	C	A	3	3	6	0	1	7	0	0
16	36926779	.	A	C	2	3	5	0	1	6	0	0
16	36928169	.	A	T	1	2	3	0	0	3	0	0
16	36928179	.	A	C	1	2	3	0	0	3	0	0
16	36928429	.	A	G	4	3	7	0	0	7	0	0
16	36931728	.	T	C	17	5	22	0	1	23	0	0
16	36934340	.	C	A	0	1	1	0	6	7	0	0
16	36934398	.	G	C	6	6	12	3	3	18	0	0
16	36939973	.	T	C	0	0	0	0	3	3	0	0
16	36939982	.	A	G	2	3	5	0	0	5	0	0
16	36940045	.	C	T	10	7	17	0	1	18	0	0
16	36941706	.	T	C	3	1	4	0	0	4	0	0
16	36941790	.	T	C	5	2	7	0	0	7	0	0
16	36941961	.	T	C	1	0	1	0	1	2	0	0
16	36942068	.	C	A	0	1	1	0	1	2	0	0
16	36945182	.	T	G	5	3	8	0	0	8	0	0
16	36945288	.	G	A	6	5	11	0	0	11	0	0
16	36945564	.	T	C	3	5	8	0	0	8	0	0
16	36945566	.	T	A	3	5	8	0	0	8	0	0
16	36974719	.	T	C	1	2	3	0	0	3	0	0
16	36975141	.	G	A	2	8	10	0	1	11	0	0
16	36975146	.	C	T	0	8	8	0	2	10	0	0
16	36975318	.	T	A	1	6	7	0	0	7	0	0
16	36976721	.	A	G	6	5	11	0	0	11	0	0
16	36977387	.	A	G	2	8	10	0	1	11	0	0
16	36979518	.	G	A	12	8	20	0	1	21	0	0
16	36979521	.	A	G	11	7	18	0	2	20	0	0
16	37167545	.	T	A	1	9	10	0	0	10	0	0
16	37167784	.	C	G	2	7	9	0	0	9	0	0
16	37167876	.	T	G	3	6	9	0	0	9	0	0
16	37167968	.	G	A	2	5	7	0	0	7	0	0
16	37306905	.	G	A	6	9	15	0	0	15	0	0
16	37470964	.	T	C	2	3	5	0	0	5	0	0
16	37471169	.	A	T	1	3	4	0	0	4	0	0
16	37520679	.	T	A	3	4	7	0	0	7	0	0
16	37521130	.	A	G	1	6	7	0	1	8	0	0
16	37521301	.	G	C	0	5	5	0	2	7	0	0
16	37552348	.	A	C	5	3	8	0	0	8	0	0
16	37552966	.	G	A	8	8	16	0	0	16	0	0
16	37554821	.	C	T	8	5	13	0	1	14	0	0
16	37563643	.	T	G	1	0	1	0	0	1	0	0
16	37565676	.	C	G	1	2	3	0	0	3	0	0
16	37593444	.	G	A	3	5	8	0	0	8	0	0
16	37596645	.	C	T	4	4	8	0	0	8	0	0
16	37596669	.	G	A	4	0	4	0	0	4	0	0
16	37614071	.	A	G	5	2	7	0	0	7	0	0
16	37617219	.	A	G	12	0	12	0	10	22	0	0
16	37617304	.	A	G	16	0	16	0	18	34	0	0
16	37617738	.	T	C	20	15	35	0	0	35	0	0
16	37627218	.	T	G	11	11	22	0	4	26	0	0
16	37627762	.	G	A	1	19	20	0	12	32	0	0
16	37627997	.	T	G	22	19	41	0	1	42	0	0
16	37947769	.	T	C	8	6	14	0	0	14	0	0
16	37948242	.	C	G	4	2	6	0	0	6	0	0
16	37948256	.	G	T	3	3	6	0	0	6	0	0
16	37948355	.	C	T	8	6	14	0	0	14	0	0
16	37948389	.	G	T	8	4	12	0	1	13	0	0
16	37948624	.	G	A	8	9	17	0	0	17	0	0
16	37948625	.	G	A	8	8	16	0	1	17	0	0
16	37963955	.	T	A	1	5	6	0	1	7	0	0
16	37964100	.	C	T	3	4	7	0	0	7	0	0
16	37964222	.	T	A	5	7	12	0	1	13	0	0
16	38067881	.	G	A	3	2	5	0	0	5	0	0
16	38121528	.	G	A	0	0	0	0	2	2	0	0
16	38121981	.	C	T	5	4	9	0	0	9	0	0
16	38124907	.	T	G	1	0	1	0	0	1	0	0
16	38125293	.	G	C	2	3	5	0	0	5	0	0
16	38125299	.	G	C	2	2	4	0	0	4	0	0
16	38125662	.	A	G	1	1	2	0	0	2	0	0
16	38127708	.	T	A	2	3	5	0	0	5	0	0
16	38129689	.	T	C	3	4	7	0	0	7	0	0
16	38135699	.	T	C	4	10	14	0	1	15	0	0
16	38135816	.	T	C	3	4	7	0	0	7	0	0
16	38136117	.	C	T	6	9	15	0	0	15	0	0
16	38136278	.	C	T	5	15	20	0	1	21	0	0
16	38136317	.	G	A	16	4	20	0	1	21	0	0
16	38136346	.	C	T	5	11	16	0	2	18	0	0
16	38136491	.	G	C	2	5	7	0	0	7	0	0
16	38139760	.	C	T	0	1	1	0	0	1	0	0
16	38143118	.	C	T	0	2	2	0	0	2	0	0
16	38143121	.	A	G	0	0	0	0	2	2	0	0
16	38148116	.	T	C	1	2	3	0	0	3	0	0
16	38148155	.	G	A	0	2	2	0	3	5	0	0
16	38148478	.	T	C	1	1	2	0	0	2	0	0
16	38152095	.	G	A	0	1	1	0	1	2	0	0
16	38154203	.	G	A	1	1	2	0	0	2	0	0
16	38154236	.	A	G	1	1	2	0	0	2	0	0
16	38157102	.	T	A	4	5	9	0	0	9	0	0
16	38157153	.	T	A	1	1	2	0	0	2	0	0
16	38159759	.	T	A	1	2	3	0	0	3	0	0
16	38159817	.	C	A	5	7	12	0	1	13	0	0
16	38167493	.	G	C	2	5	7	0	0	7	0	0
16	38167511	.	C	T	5	5	10	0	1	11	0	0
16	38167904	.	A	G	9	0	9	0	9	18	0	0
16	38168009	.	A	G	15	5	20	0	0	20	0	0
16	38168095	.	G	A	1	4	5	0	3	8	0	0
16	38188955	.	G	A	0	6	6	0	6	12	0	0
16	38189099	.	T	C	3	3	6	0	0	6	0	0
16	38191645	.	C	T	3	3	6	0	1	7	0	0
16	38194017	.	T	C	4	5	9	0	0	9	0	0
16	38198170	.	G	A	1	4	5	0	1	6	0	0
16	38199647	.	G	A	5	5	10	0	0	10	0	0
16	38261183	.	G	A	2	2	4	0	0	4	0	0
16	38261193	.	C	T	2	2	4	0	0	4	0	0
16	38266221	.	A	C	1	3	4	0	0	4	0	0
16	38266242	.	T	C	1	2	3	0	0	3	0	0
16	38266273	.	G	A	2	3	5	0	0	5	0	0
16	38313341	.	A	T	1	0	1	0	1	2	0	0
16	38313405	.	A	G	1	0	1	0	1	2	0	0
16	38355299	.	G	A	1	2	3	0	0	3	0	0
16	39213314	.	G	A	6	2	8	0	1	9	0	0
16	39213792	.	T	C	1	3	4	0	0	4	0	0
16	39238437	.	A	C	2	0	2	0	5	7	0	0
16	39238539	.	A	T	2	3	5	0	0	5	0	0
16	39238547	.	A	T	2	2	4	0	0	4	0	0
16	39244286	.	T	C	26	22	48	0	1	49	0	0
16	39248745	.	T	A	8	5	13	0	1	14	0	0
16	39248765	.	G	C	3	7	10	0	1	11	0	0
16	39248811	.	C	G	3	5	8	0	0	8	0	0
16	39248813	.	T	A	3	5	8	0	0	8	0	0
16	39248976	.	G	A	6	8	14	0	1	15	0	0
16	39249056	.	G	A	4	0	4	0	1	5	0	0
16	39249350	.	A	C	4	4	8	0	0	8	0	0
16	39249475	.	C	A	5	2	7	0	0	7	0	0
16	39249506	.	G	A	4	2	6	0	0	6	0	0
16	39249527	.	A	T	4	2	6	0	0	6	0	0
16	39249907	.	G	T	2	2	4	0	0	4	0	0
16	39250574	.	G	A	2	1	3	0	0	3	0	0
16	39253200	.	G	A	3	2	5	0	0	5	0	0
16	39271329	.	A	C	5	4	9	0	0	9	0	0
16	39297336	.	C	A	1	4	5	0	0	5	0	0
16	39297344	.	A	T	1	3	4	0	0	4	0	0
16	39297378	.	C	T	1	3	4	0	0	4	0	0
16	39323626	.	T	G	1	0	1	0	1	2	0	0
16	39323716	.	C	T	2	3	5	0	1	6	0	0
16	39325084	.	A	G	1	0	1	0	3	4	0	0
16	39325121	.	G	A	3	3	6	0	0	6	0	0
16	39372372	.	T	C	5	3	8	0	0	8	0	0
16	39372735	.	G	C	0	7	7	0	8	15	0	0
16	39372780	.	C	A	6	5	11	0	0	11	0	0
16	39378744	.	A	G	2	0	2	0	2	4	0	0
16	39382047	.	C	G	11	9	20	0	0	20	0	0
16	39382084	.	C	T	8	11	19	0	0	19	0	0
16	39382098	.	G	A	4	9	13	0	0	13	0	0
16	39382467	.	C	G	4	4	8	0	0	8	0	0
16	39382482	.	G	A	3	4	7	0	0	7	0	0
16	39385755	.	T	C	19	0	19	0	11	30	0	0
16	39386184	.	T	C	15	12	27	0	0	27	0	0
16	39386239	.	T	A	16	12	28	0	2	30	0	0
16	39386915	.	C	T	9	15	24	0	0	24	0	0
16	39390139	.	T	C	17	1	18	0	25	43	0	0
16	39390175	.	G	A	14	17	31	0	1	32	0	0
16	39393370	.	A	G	6	4	10	0	0	10	0	0
16	39394630	.	A	G	10	17	27	0	2	29	0	0
16	39399140	.	A	C	8	0	8	0	2	10	0	0
16	39413514	.	C	T	4	2	6	0	0	6	0	0
16	39505554	.	G	C	7	3	10	0	0	10	0	0
16	39901274	.	G	A	3	3	6	0	0	6	0	0
16	40025019	.	A	G	1	3	4	0	0	4	0	0
16	40025025	.	T	G	1	3	4	0	0	4	0	0
16	40026573	.	A	G	0	0	0	0	2	2	0	0
16	40027147	.	G	A	0	1	1	0	1	2	0	0
16	40031649	.	A	G	1	5	6	0	0	6	0	0
16	40153135	.	A	T	1	3	4	0	0	4	0	0
16	40153194	.	A	G	2	2	4	0	0	4	0	0
16	40338377	.	A	G	2	3	5	0	0	5	0	0
16	40340664	.	A	T	1	2	3	0	0	3	0	0
16	40340844	.	C	A	1	3	4	0	0	4	0	0
16	40340847	.	A	G	1	0	1	0	4	5	0	0
16	40340967	.	A	G	3	2	5	0	0	5	0	0
16	40341055	.	C	A	2	2	4	0	0	4	0	0
16	40341255	.	C	G	2	4	6	0	0	6	0	0
16	40341264	.	C	T	2	3	5	0	0	5	0	0
16	40343465	.	G	A	3	3	6	0	1	7	0	0
16	40343747	.	T	C	1	0	1	0	0	1	0	0
16	40352092	.	A	G	1	1	2	0	2	4	0	0
16	40568162	.	A	G	0	1	1	0	1	2	0	0
16	41030137	.	A	G	8	3	11	0	2	13	0	0
16	41345704	.	T	A	2	3	5	0	0	5	0	0
16	41686085	.	T	C	5	2	7	0	0	7	0	0
16	41732358	.	A	G	7	5	12	0	0	12	0	0
16	41732366	.	A	G	7	4	11	0	1	12	0	0
16	43228942	.	C	T	1	10	11	0	0	11	0	0
16	43228945	.	T	C	1	10	11	0	0	11	0	0
16	45981430	.	G	A	7	2	9	0	0	9	0	0
16	46091247	.	T	C	2	2	4	0	0	4	0	0
16	46200655	.	G	A	0	43	43	0	9	52	0	0
16	46399586	.	T	C	3	9	12	0	0	12	0	0
16	46399587	.	T	C	6	0	6	0	6	12	0	0
16	46464219	.	G	A	13	12	25	0	0	25	0	0
16	46464279	.	G	A	15	5	20	0	0	20	0	0
16	46464423	.	A	G	1	3	4	0	1	5	0	0
16	50109666	.	G	A	4	1	5	0	0	5	0	0
16	51183892	.	A	T	7	4	11	0	0	11	0	0
16	51244464	.	T	C	6	3	9	0	0	9	0	0
16	51244487	.	T	C	4	3	7	0	1	8	0	0
16	51244500	.	T	C	2	3	5	0	0	5	0	0
16	51244604	.	T	C	1	3	4	0	0	4	0	0
16	51244609	.	T	A	0	3	3	0	1	4	0	0
16	51370110	.	T	C	1	0	1	0	2	3	0	0
16	51559317	.	T	G	2	0	2	0	2	4	0	0
16	51559527	.	C	T	7	7	14	0	0	14	0	0
16	51950940	.	G	A	0	39	39	0	2	41	0	0
16	51951690	.	T	C	4	18	22	0	0	22	0	0
16	51951691	.	T	C	11	11	22	0	0	22	0	0
16	51952745	.	C	T	4	8	12	0	2	14	0	0
16	52130690	.	G	A	0	2	2	0	1	3	0	0
16	52208238	.	C	T	1	2	3	0	0	3	0	0
16	52214476	.	C	T	1	4	5	0	0	5	0	0
16	52218769	.	C	T	6	5	11	0	1	12	0	0
16	52223760	.	C	G	0	1	1	0	1	2	0	0
16	52926256	.	T	C	3	2	5	0	0	5	0	0
16	53152935	.	C	T	0	1	1	0	0	1	0	0
16	53153187	.	A	G	1	4	5	0	1	6	0	0
16	53203455	.	C	T	0	1	1	0	1	2	0	0
16	53212009	.	G	A	3	1	4	0	0	4	0	0
16	53213713	.	C	T	3	7	10	0	0	10	0	0
16	53224629	.	C	T	12	3	15	0	0	15	0	0
16	53247109	.	T	A	3	3	6	0	0	6	0	0
16	53247178	.	C	T	4	10	14	0	0	14	0	0
16	53278406	.	A	G	4	1	5	0	5	10	0	0
16	53278513	.	A	G	13	0	13	0	8	21	0	0
16	53290842	.	G	A	0	5	5	0	3	8	0	0
16	53405719	.	C	T	1	2	3	0	0	3	0	0
16	53436277	.	C	T	2	4	6	0	1	7	0	0
16	53443714	.	C	T	1	1	2	0	0	2	0	0
16	53443724	.	G	T	0	1	1	0	1	2	0	0
16	53449751	.	C	T	1	3	4	0	0	4	0	0
16	53449943	.	T	C	2	5	7	0	0	7	0	0
16	53495455	.	G	A	0	4	4	0	7	11	0	0
16	53495521	.	C	T	5	5	10	0	0	10	0	0
16	53502390	.	C	T	4	4	8	0	0	8	0	0
16	53513549	.	C	T	7	6	13	0	0	13	0	0
16	53513618	.	C	G	4	0	4	0	4	8	0	0
16	53516147	.	T	G	13	8	21	0	1	22	0	0
16	53516232	.	G	A	12	16	28	0	1	29	0	0
16	53516303	.	T	C	7	9	16	2	1	19	0	0
16	53519091	.	T	G	3	4	7	0	1	8	0	0
16	53529665	.	T	C	5	4	9	0	0	9	0	0
16	53530047	.	G	C	0	5	5	0	5	10	0	0
16	53530490	.	A	T	5	6	11	0	0	11	0	0
16	53537205	.	C	T	1	0	1	0	0	1	0	0
16	53539389	.	G	A	3	0	3	0	0	3	0	0
16	53539399	.	T	C	0	2	2	0	0	2	0	0
16	53541879	.	A	G	5	5	10	0	1	11	0	0
16	53541963	.	T	A	7	6	13	0	1	14	0	0
16	53590609	.	C	T	2	2	4	0	0	4	0	0
16	53591872	.	G	A	7	2	9	0	1	10	0	0
16	53591908	.	C	G	4	5	9	0	0	9	0	0
16	53592375	.	C	T	5	10	15	0	8	23	0	0
16	53596872	.	C	T	1	2	3	0	0	3	0	0
16	53601486	.	A	G	2	0	2	0	13	15	0	0
16	53701171	.	A	C	4	14	18	0	0	18	0	0
16	53708312	.	C	G	42	35	77	0	3	80	0	0
16	53708537	.	G	T	4	2	6	0	0	6	0	0
16	53708564	.	T	C	6	2	8	0	0	8	0	0
16	53733920	.	C	A	0	4	4	0	2	6	0	0
16	53734303	.	A	G	1	2	3	0	0	3	0	0
16	54186911	.	C	T	0	1	1	0	0	1	0	0
16	54222382	.	C	T	4	4	8	0	0	8	0	0
16	54222433	.	T	C	4	4	8	0	3	11	0	0
16	54222448	.	G	A	3	6	9	0	1	10	0	0
16	54245580	.	T	A	6	3	9	0	0	9	0	0
16	54245609	.	C	T	4	6	10	0	0	10	0	0
16	54245777	.	G	A	1	4	5	0	0	5	0	0
16	54245781	.	T	A	1	4	5	0	0	5	0	0
16	54245812	.	T	C	1	2	3	0	0	3	0	0
16	54245832	.	A	C	1	1	2	0	1	3	0	0
16	54303499	.	G	A	3	6	9	0	0	9	0	0
16	54313643	.	T	A	1	1	2	0	0	2	0	0
16	54314226	.	G	A	0	1	1	0	1	2	0	0
16	54356904	.	C	A	3	3	6	0	0	6	0	0
16	54474858	.	A	G	2	4	6	0	0	6	0	0
16	54474942	.	G	A	7	5	12	0	0	12	0	0
16	54474943	.	C	T	7	5	12	0	0	12	0	0
16	54479732	.	G	A	5	1	6	0	0	6	0	0
16	54491760	.	G	A	2	0	2	0	0	2	0	0
16	54521110	.	T	C	4	2	6	0	0	6	0	0
16	54521124	.	T	C	1	2	3	0	0	3	0	0
16	54521432	.	T	C	3	3	6	0	0	6	0	0
16	54521453	.	A	T	3	3	6	0	0	6	0	0
16	54521468	.	A	C	2	3	5	0	0	5	0	0
16	54521558	.	A	G	1	3	4	0	0	4	0	0
16	54568542	.	G	T	2	1	3	0	0	3	0	0
16	54568755	.	C	A	11	6	17	0	0	17	0	0
16	54568813	.	G	C	4	1	5	0	0	5	0	0
16	54571033	.	C	T	0	1	1	0	0	1	0	0
16	54574237	.	T	G	12	6	18	0	0	18	0	0
16	54574282	.	C	G	14	7	21	0	0	21	0	0
16	54580891	.	G	A	6	5	11	0	1	12	0	0
16	54580930	.	G	A	11	4	15	0	0	15	0	0
16	54580999	.	T	C	1	2	3	0	0	3	0	0
16	54582681	.	G	A	5	1	6	0	0	6	0	0
16	54584176	.	C	T	1	4	5	0	0	5	0	0
16	54584670	.	C	T	0	0	0	0	1	1	0	0
16	54585298	.	T	A	3	10	13	0	2	15	0	0
16	54585799	.	C	T	12	5	17	0	0	17	0	0
16	54586574	.	C	G	6	5	11	0	0	11	0	0
16	54588989	.	G	A	7	9	16	0	0	16	0	0
16	54590186	.	G	A	0	4	4	0	4	8	0	0
16	54592503	.	T	C	14	9	23	0	0	23	0	0
16	54593401	.	A	G	6	14	20	0	0	20	0	0
16	54594103	.	T	C	24	9	33	0	6	39	0	0
16	54594270	.	A	T	9	8	17	0	0	17	0	0
16	54594334	.	G	T	9	10	19	0	2	21	0	0
16	54594511	.	A	G	9	0	9	0	10	19	0	0
16	54594602	.	C	T	8	12	20	0	1	21	0	0
16	54594605	.	T	C	8	9	17	0	3	20	0	0
16	54594664	.	A	T	4	4	8	0	0	8	0	0
16	54636225	.	C	G	0	0	0	0	1	1	0	0
16	54636692	.	G	A	2	3	5	0	1	6	0	0
16	54636792	.	A	G	1	3	4	0	0	4	0	0
16	54636973	.	T	G	2	3	5	0	0	5	0	0
16	54637009	.	A	G	2	4	6	0	0	6	0	0
16	54780612	.	G	A	9	13	22	0	1	23	0	0
16	54780864	.	G	A	2	3	5	0	9	14	0	0
16	54782373	.	T	C	6	0	6	0	0	6	0	0
16	54785429	.	A	T	10	7	17	0	2	19	0	0
16	54785460	.	T	G	21	2	23	0	2	25	0	0
16	54786967	.	C	T	7	8	15	0	2	17	0	0
16	54787564	.	T	G	6	5	11	0	0	11	0	0
16	54793964	.	C	A	7	7	14	0	2	16	0	0
16	54794100	.	G	A	10	20	30	0	4	34	0	0
16	54795141	.	A	G	2	7	9	0	0	9	0	0
16	54795732	.	A	G	4	9	13	0	1	14	0	0
16	54795735	.	G	A	5	8	13	0	1	14	0	0
16	54800128	.	A	T	13	1	14	0	1	15	0	0
16	54809840	.	G	T	2	2	4	0	0	4	0	0
16	54809855	.	C	T	1	2	3	0	2	5	0	0
16	54829650	.	C	T	23	19	42	0	3	45	0	0
16	54829656	.	A	G	28	18	46	0	0	46	0	0
16	54837250	.	T	C	12	5	17	0	0	17	0	0
16	54843723	.	C	T	35	35	70	0	1	71	0	0
16	54843798	.	A	G	15	2	17	0	19	37	1	0
16	54846250	.	G	A	1	7	8	0	6	14	0	0
16	54940615	.	A	G	5	1	6	0	0	6	0	0
16	54947827	.	T	G	1	6	7	0	0	7	0	0
16	54947978	.	G	A	4	2	6	0	0	6	0	0
16	54948227	.	A	G	4	6	10	0	0	10	0	0
16	54948369	.	T	A	2	8	10	0	0	10	0	0
16	54948467	.	C	A	5	8	13	0	0	13	0	0
16	54948483	.	T	A	5	6	11	0	0	11	0	0
16	54948511	.	C	A	0	5	5	0	3	8	0	0
16	54948538	.	A	T	2	2	4	0	0	4	0	0
16	54948990	.	A	T	5	2	7	0	1	8	0	0
16	54949140	.	G	A	13	10	23	0	2	25	0	0
16	54952935	.	G	A	5	8	13	0	1	14	0	0
16	54953031	.	C	T	0	8	8	0	11	19	0	0
16	54953067	.	G	A	4	5	9	0	0	9	0	0
16	54956620	.	C	T	2	1	3	0	0	3	0	0
16	54956777	.	T	C	3	7	10	0	0	10	0	0
16	54957387	.	A	G	0	1	1	0	0	1	0	0
16	54957388	.	C	G	0	1	1	0	0	1	0	0
16	54958913	.	G	A	1	0	1	0	0	1	0	0
16	54964128	.	G	T	0	1	1	0	0	1	0	0
16	54964224	.	C	A	1	7	8	0	3	11	0	0
16	54964281	.	G	C	1	2	3	0	1	4	0	0
16	54964287	.	G	A	2	2	4	0	0	4	0	0
16	54967883	.	C	T	1	1	2	0	0	2	0	0
16	54969116	.	G	A	0	1	1	0	0	1	0	0
16	55004622	.	T	A	4	4	8	0	0	8	0	0
16	55004716	.	T	C	16	2	18	0	25	43	0	0
16	55004723	.	C	G	16	28	44	0	2	46	0	0
16	55012643	.	G	A	2	4	6	0	1	7	0	0
16	55090786	.	C	T	2	2	4	0	0	4	0	0
16	55090796	.	C	A	2	2	4	0	0	4	0	0
16	55090845	.	C	T	4	5	9	0	0	9	0	0
16	55102314	.	T	C	5	6	11	0	0	11	0	0
16	55102320	.	C	G	5	6	11	0	0	11	0	0
16	55102422	.	C	G	14	0	14	0	6	20	0	0
16	55102781	.	C	G	4	2	6	0	0	6	0	0
16	55102826	.	T	C	3	3	6	0	0	6	0	0
16	55102884	.	T	C	2	4	6	0	0	6	0	0
16	55102923	.	A	C	0	1	1	0	2	3	0	0
16	55106474	.	C	T	0	4	4	0	10	14	0	0
16	55106524	.	T	C	3	2	5	0	0	5	0	0
16	55106640	.	T	C	13	0	13	0	7	20	0	0
16	55106724	.	A	C	24	0	24	0	15	39	0	0
16	55108801	.	C	T	5	2	7	0	0	7	0	0
16	55108828	.	C	T	5	2	7	0	0	7	0	0
16	55172448	.	G	C	0	1	1	0	1	2	0	0
16	55181164	.	G	C	3	6	9	0	0	9	0	0
16	55181337	.	A	T	4	3	7	0	1	8	0	0
16	55182133	.	A	G	4	4	8	0	0	8	0	0
16	55182146	.	T	G	2	5	7	0	0	7	0	0
16	55225845	.	C	T	0	1	1	0	0	1	0	0
17	932681	.	G	A	2	2	4	0	2	6	0	0
17	1068814	.	C	T	10	7	17	0	0	17	0	0
17	1069048	.	G	T	5	4	9	0	0	9	0	0
17	1074636	.	C	G	1	3	4	0	4	8	0	0
17	1122515	.	G	A	1	1	2	0	0	2	0	0
17	1141376	.	G	T	0	1	1	0	0	1	0	0
17	1141380	.	G	A	1	1	2	0	0	2	0	0
17	1174929	.	G	C	4	3	7	0	0	7	0	0
17	1256771	.	G	A	0	1	1	0	0	1	0	0
17	1258380	.	C	T	2	4	6	0	0	6	0	0
17	1258485	.	G	A	0	0	0	0	1	1	0	0
17	1354412	.	A	G	2	3	5	0	0	5	0	0
17	1354581	.	A	G	0	4	4	0	1	5	0	0
17	1354902	.	T	A	2	2	4	0	0	4	0	0
17	1354906	.	T	G	2	0	2	0	1	4	1	0
17	1355509	.	T	C	0	2	2	0	0	2	0	0
17	1355561	.	A	T	1	3	4	0	0	4	0	0
17	1355562	.	C	T	1	3	4	0	0	4	0	0
17	1360271	.	C	G	2	4	6	0	0	6	0	0
17	1360292	.	G	T	0	2	2	0	1	3	0	0
17	1362244	.	C	T	2	5	7	0	0	7	0	0
17	2121955	.	T	A	0	2	2	0	1	3	0	0
17	2122196	.	G	A	7	10	17	0	0	17	0	0
17	2122252	.	C	T	12	11	23	0	0	23	0	0
17	2134990	.	C	T	1	2	3	0	0	3	0	0
17	2146034	.	G	T	0	0	0	0	4	4	0	0
17	2146073	.	G	A	0	7	7	0	1	8	0	0
17	2214291	.	C	G	0	1	1	0	0	1	0	0
17	2226906	.	A	T	0	3	3	0	0	3	0	0
17	2231779	.	C	A	1	6	7	0	0	7	0	0
17	2236042	.	C	T	2	2	4	0	0	4	0	0
17	2236075	.	T	C	2	2	4	0	0	4	0	0
17	2260582	.	G	A	1	0	1	0	0	1	0	0
17	2354798	.	A	G	0	4	4	0	0	4	0	0
17	2373246	.	G	A	0	1	1	0	0	1	0	0
17	2373962	.	C	T	0	1	1	0	2	3	0	0
17	2374549	.	A	G	4	3	7	0	1	8	0	0
17	2374558	.	A	G	6	3	9	0	0	9	0	0
17	2376866	.	G	A	1	1	2	0	0	2	0	0
17	2386078	.	G	A	0	1	1	0	0	1	0	0
17	2421926	.	T	C	1	0	1	0	1	2	0	0
17	2479601	.	G	C	6	2	8	0	0	8	0	0
17	2479620	.	C	A	1	3	4	0	0	4	0	0
17	2498487	.	T	C	2	2	4	0	0	4	0	0
17	2695743	.	C	T	0	2	2	0	2	4	0	0
17	2696241	.	T	C	4	2	6	0	0	6	0	0
17	2698100	.	T	C	4	2	6	0	0	6	0	0
17	2698362	.	G	C	1	3	4	0	0	4	0	0
17	2698366	.	C	T	1	2	3	0	1	4	0	0
17	2704135	.	G	T	0	1	1	0	0	1	0	0
17	2711282	.	A	G	2	2	4	0	0	4	0	0
17	2715262	.	G	A	1	2	3	0	0	3	0	0
17	2715377	.	C	G	2	0	2	0	0	2	0	0
17	2765879	.	C	T	1	3	4	0	0	4	0	0
17	2902704	.	C	A	4	2	6	0	0	6	0	0
17	2902880	.	A	G	2	4	6	0	1	7	0	0
17	2902911	.	T	G	3	3	6	0	0	6	0	0
17	2903645	.	T	C	1	2	3	0	0	3	0	0
17	2903655	.	G	A	1	2	3	0	0	3	0	0
17	2905019	.	A	G	2	3	5	0	1	6	0	0
17	2905049	.	T	A	2	2	4	0	1	5	0	0
17	2905078	.	A	G	0	3	3	0	0	3	0	0
17	2905813	.	T	C	1	0	1	0	4	5	0	0
17	2905824	.	C	T	1	3	4	0	0	4	0	0
17	3183694	.	A	G	0	4	4	0	0	4	0	0
17	3183811	.	T	A	1	5	6	0	0	6	0	0
17	3183970	.	A	G	4	3	7	0	0	7	0	0
17	3184246	.	G	A	1	2	3	0	1	4	0	0
17	3189790	.	G	A	1	2	3	0	0	3	0	0
17	3281934	.	A	G	1	6	7	0	0	7	0	0
17	3282028	.	G	A	4	6	10	0	0	10	0	0
17	3282034	.	G	A	3	5	8	0	1	9	0	0
17	3282307	.	C	T	2	4	6	0	0	6	0	0
17	3282367	.	A	G	2	1	3	0	0	3	0	0
17	3282394	.	A	G	2	2	4	0	0	4	0	0
17	3283250	.	A	T	2	3	5	0	0	5	0	0
17	3284956	.	T	A	3	4	7	0	0	7	0	0
17	3288101	.	A	G	2	5	7	0	1	8	0	0
17	3290657	.	G	C	1	0	1	0	3	4	0	0
17	3290700	.	A	G	4	4	8	0	0	9	1	0
17	3290771	.	A	T	0	1	1	0	0	1	0	0
17	3446847	.	T	C	4	7	11	0	0	11	0	0
17	3514131	.	C	T	2	6	8	0	1	9	0	0
17	3529998	.	C	T	1	4	5	0	0	5	0	0
17	3530031	.	C	T	2	8	10	0	0	10	0	0
17	3569169	.	A	G	11	7	18	0	1	19	0	0
17	3854266	.	T	C	10	9	19	0	0	19	0	0
17	3854290	.	C	T	9	12	21	0	0	21	0	0
17	3855436	.	T	C	4	0	4	0	10	14	0	0
17	3860857	.	C	T	0	2	2	0	2	4	0	0
17	3870739	.	T	A	2	3	5	0	0	5	0	0
17	3970905	.	C	T	0	2	2	0	0	2	0	0
17	3986204	.	A	G	6	2	8	0	0	8	0	0
17	3993854	.	A	G	4	0	4	0	4	8	0	0
17	3993866	.	A	G	4	0	4	0	4	8	0	0
17	4009449	.	T	C	1	2	3	0	0	3	0	0
17	4231104	.	G	C	2	0	2	0	1	3	0	0
17	4297546	.	C	T	11	17	28	0	2	30	0	0
17	4298221	.	T	A	16	17	33	0	3	36	0	0
17	4298349	.	T	A	13	13	26	2	6	34	0	0
17	4298768	.	T	G	1	7	8	0	1	9	0	0
17	4298990	.	A	G	13	9	22	0	1	23	0	0
17	4298996	.	C	T	13	8	21	0	2	23	0	0
17	4299031	.	C	T	11	14	25	0	3	28	0	0
17	4307164	.	G	A	4	9	13	0	0	13	0	0
17	4317738	.	G	A	7	4	11	0	0	11	0	0
17	4361710	.	C	G	1	1	2	0	0	2	0	0
17	4368900	.	T	A	3	6	9	0	0	9	0	0
17	4368968	.	G	A	5	3	8	0	0	8	0	0
17	4372865	.	C	T	5	4	9	0	0	9	0	0
17	4372871	.	A	G	5	3	8	0	1	9	0	0
17	4378219	.	C	T	1	2	3	0	0	3	0	0
17	5061184	.	G	C	9	7	16	0	0	16	0	0
17	5071257	.	G	A	1	0	1	0	0	1	0	0
17	5071266	.	A	G	4	0	4	0	1	5	0	0
17	5079706	.	C	T	3	1	4	0	0	4	0	0
17	5084892	.	G	A	11	16	27	0	2	29	0	0
17	5087222	.	G	A	10	8	18	0	0	18	0	0
17	5090829	.	G	A	0	7	7	0	16	23	0	0
17	5090871	.	T	C	10	11	21	0	2	23	0	0
17	5091108	.	T	C	2	9	11	0	0	11	0	0
17	5094330	.	T	A	11	5	16	0	1	18	1	0
17	5094355	.	T	C	9	26	35	0	0	35	0	0
17	5094519	.	C	T	3	8	11	0	0	11	0	0
17	5096691	.	T	C	22	12	34	0	0	34	0	0
17	5101234	.	A	G	18	0	18	0	7	25	0	0
17	5105702	.	T	A	8	13	21	0	0	21	0	0
17	5105828	.	T	C	11	7	18	0	1	19	0	0
17	5162096	.	T	C	5	0	5	0	3	8	0	0
17	5217050	.	T	C	1	1	2	0	0	2	0	0
17	5239046	.	C	T	0	3	3	0	5	8	0	0
17	5296534	.	T	A	0	1	1	0	0	1	0	0
17	5819951	.	C	T	1	7	8	0	0	8	0	0
17	6396866	.	G	A	1	2	3	0	0	3	0	0
17	6808341	.	A	G	8	4	12	0	1	13	0	0
17	6808796	.	A	G	5	18	23	0	1	24	0	0
17	7413492	.	T	A	0	3	3	0	0	3	0	0
17	7779778	.	A	G	1	2	3	0	0	3	0	0
17	7781599	.	G	A	2	3	5	0	0	5	0	0
17	7783375	.	C	T	2	2	4	0	0	4	0	0
17	7795583	.	T	A	3	3	6	0	0	6	0	0
17	7795593	.	G	A	2	2	4	0	0	4	0	0
17	7799980	.	A	G	1	2	3	0	0	3	0	0
17	7812480	.	A	T	1	0	1	0	0	1	0	0
17	7815212	.	C	T	3	3	6	0	2	8	0	0
17	7818872	.	T	A	1	1	2	0	0	2	0	0
17	7818935	.	C	T	4	2	6	0	0	6	0	0
17	7839517	.	G	A	0	1	1	0	0	1	0	0
17	7845085	.	T	A	9	7	16	0	1	17	0	0
17	7845288	.	A	G	5	3	8	0	0	8	0	0
17	7845364	.	G	C	12	19	31	0	0	31	0	0
17	7845412	.	T	C	17	12	29	0	0	29	0	0
17	7845566	.	C	T	18	18	36	0	1	37	0	0
17	7845604	.	G	A	19	22	41	0	0	41	0	0
17	7845661	.	G	T	14	20	34	0	0	34	0	0
17	7845733	.	G	A	18	32	50	0	0	50	0	0
17	7845776	.	C	G	0	20	20	0	12	32	0	0
17	7845800	.	A	G	5	12	17	0	1	18	0	0
17	7861124	.	C	T	12	17	29	0	1	30	0	0
17	7868632	.	G	A	1	2	3	0	0	3	0	0
17	7879327	.	C	G	2	3	5	0	0	5	0	0
17	7882941	.	G	A	11	11	22	0	0	22	0	0
17	7882998	.	G	A	10	14	24	0	1	25	0	0
17	7883016	.	C	T	12	8	20	0	0	20	0	0
17	7885635	.	G	A	1	6	7	0	0	7	0	0
17	7885662	.	A	G	4	8	12	0	2	14	0	0
17	7888351	.	G	A	9	8	17	0	0	17	0	0
17	7888369	.	G	A	12	10	22	0	0	22	0	0
17	7896340	.	G	A	11	7	18	0	0	18	0	0
17	7896356	.	C	T	0	13	13	0	10	23	0	0
17	7902203	.	A	G	1	3	4	0	0	4	0	0
17	7906612	.	G	A	4	8	12	0	0	12	0	0
17	7910537	.	C	T	11	9	20	0	0	20	0	0
17	7917414	.	T	A	10	6	16	0	1	17	0	0
17	7917997	.	G	A	2	4	6	0	0	6	0	0
17	7918075	.	C	T	7	10	17	0	0	17	0	0
17	7918244	.	C	T	0	10	10	0	4	14	0	0
17	7918310	.	C	T	0	3	3	0	5	8	0	0
17	7924263	.	G	A	5	3	8	0	0	8	0	0
17	7928615	.	T	G	6	6	12	0	1	13	0	0
17	7931722	.	T	A	0	1	1	0	1	2	0	0
17	7931737	.	G	A	1	2	3	0	0	3	0	0
17	7942122	.	G	A	5	5	10	0	0	10	0	0
17	7942127	.	T	C	5	5	10	0	0	10	0	0
17	7942191	.	T	G	3	1	4	0	0	4	0	0
17	7942375	.	C	T	0	5	5	0	2	7	0	0
17	7945421	.	C	G	5	6	11	0	0	11	0	0
17	7945485	.	A	G	1	1	2	0	0	2	0	0
17	7949066	.	G	A	4	8	12	0	1	13	0	0
17	7949119	.	G	T	7	5	12	0	1	13	0	0
17	7950339	.	G	T	5	6	11	0	1	12	0	0
17	7974804	.	T	C	7	2	9	0	0	9	0	0
17	7977806	.	C	T	3	2	5	0	0	5	0	0
17	7981566	.	C	T	6	4	10	0	1	11	0	0
17	7985543	.	A	G	1	7	8	0	0	8	0	0
17	7985633	.	G	C	2	3	5	0	0	5	0	0
17	7985693	.	G	A	4	2	6	0	0	6	0	0
17	7985720	.	C	T	4	3	7	0	0	7	0	0
17	7985970	.	C	T	0	3	3	0	5	8	0	0
17	7988467	.	C	T	0	3	3	0	3	6	0	0
17	7991338	.	G	A	3	2	5	0	0	5	0	0
17	8000122	.	C	A	3	2	5	0	0	5	0	0
17	8002895	.	G	T	2	2	4	0	0	4	0	0
17	8002932	.	G	A	3	4	7	0	0	7	0	0
17	8003009	.	G	A	3	5	8	0	0	8	0	0
17	8003027	.	T	C	2	4	6	0	0	6	0	0
17	8003165	.	G	T	0	2	2	0	0	2	0	0
17	8006088	.	C	T	1	1	2	0	0	2	0	0
17	8006696	.	T	C	2	6	8	0	0	8	0	0
17	8022620	.	C	G	0	1	1	0	0	1	0	0
17	8024283	.	A	T	1	5	6	0	0	6	0	0
17	8024338	.	C	T	2	7	9	0	0	9	0	0
17	8036086	.	T	C	1	0	1	0	5	6	0	0
17	8042133	.	G	A	3	2	5	0	0	5	0	0
17	8043710	.	T	C	1	0	1	0	1	2	0	0
17	8044351	.	A	G	1	0	1	0	0	1	0	0
17	8044369	.	A	G	0	1	1	0	0	1	0	0
17	8044522	.	C	T	0	0	0	0	1	1	0	0
17	8045475	.	C	T	1	2	3	0	0	3	0	0
17	8045486	.	C	T	1	2	3	0	0	3	0	0
17	8060288	.	T	C	1	1	2	0	0	2	0	0
17	8064830	.	T	C	2	2	4	0	0	4	0	0
17	8064881	.	C	T	3	2	5	0	0	5	0	0
17	8066418	.	C	T	2	1	3	0	0	3	0	0
17	8066460	.	G	T	2	2	4	0	0	4	0	0
17	8082427	.	G	T	2	0	2	0	0	2	0	0
17	8094875	.	A	T	1	1	2	0	0	2	0	0
17	8109421	.	T	A	1	1	2	0	0	2	0	0
17	8109433	.	C	T	0	1	1	0	1	2	0	0
17	8184435	.	A	G	3	0	3	0	5	8	0	0
17	8184515	.	A	T	10	5	15	0	0	15	0	0
17	8188963	.	G	T	0	3	3	0	3	6	0	0
17	8191370	.	C	A	4	6	10	0	0	10	0	0
17	8191382	.	C	A	4	8	12	0	0	12	0	0
17	8191475	.	A	G	1	4	5	0	1	6	0	0
17	8194715	.	C	A	7	2	9	0	0	9	0	0
17	8197141	.	G	A	1	2	3	0	0	3	0	0
17	8197569	.	C	A	4	4	8	0	0	8	0	0
17	8202778	.	T	C	15	9	24	0	0	24	0	0
17	8203231	.	T	A	24	16	40	0	1	41	0	0
17	8203234	.	G	A	21	13	34	0	5	39	0	0
17	8203471	.	C	T	18	12	30	0	1	31	0	0
17	8203498	.	G	A	12	14	26	0	1	27	0	0
17	8203729	.	T	C	22	8	30	0	0	31	1	0
17	8204248	.	A	G	12	0	12	0	18	30	0	0
17	8204533	.	C	T	11	13	24	0	1	25	0	0
17	8204755	.	A	G	22	19	41	0	1	42	0	0
17	8204818	.	A	G	20	14	34	0	0	34	0	0
17	8204962	.	C	T	18	17	35	0	2	37	0	0
17	8205508	.	T	C	12	13	25	0	1	26	0	0
17	8209686	.	A	G	8	5	13	1	0	14	0	0
17	8209931	.	C	A	8	10	18	0	1	19	0	0
17	8210327	.	A	T	15	7	22	0	1	23	0	0
17	8210355	.	T	A	9	4	13	0	2	15	0	0
17	8210365	.	C	T	11	5	16	0	0	16	0	0
17	8210415	.	C	A	15	5	20	0	0	20	0	0
17	8210466	.	A	G	8	1	9	0	10	19	0	0
17	8210552	.	A	G	13	7	20	0	1	21	0	0
17	8210596	.	A	C	18	10	28	0	2	30	0	0
17	8210801	.	C	T	22	11	33	0	0	33	0	0
17	8229904	.	C	T	2	2	4	0	0	4	0	0
17	8229906	.	G	A	2	1	3	0	1	4	0	0
17	8234886	.	C	G	1	1	2	0	0	2	0	0
17	8234889	.	C	T	0	1	1	0	1	2	0	0
17	8245868	.	G	A	3	1	4	0	0	4	0	0
17	8246121	.	C	T	2	1	3	0	0	3	0	0
17	8246329	.	T	C	3	2	5	0	0	5	0	0
17	8248987	.	A	G	2	0	2	0	0	2	0	0
17	8249153	.	A	T	2	6	8	0	0	8	0	0
17	8261535	.	T	C	6	3	9	0	1	10	0	0
17	8261799	.	C	T	3	5	8	0	0	8	0	0
17	8272569	.	T	C	1	2	3	0	2	5	0	0
17	8279414	.	A	T	1	1	2	0	0	2	0	0
17	8286764	.	C	T	5	3	8	0	0	8	0	0
17	8286877	.	A	G	2	2	4	0	0	4	0	0
17	8286879	.	C	A	1	2	3	0	1	4	0	0
17	8287050	.	T	C	2	3	5	0	0	5	0	0
17	8287082	.	A	C	1	2	3	0	0	3	0	0
17	8430423	.	T	A	2	2	4	0	0	4	0	0
17	8445358	.	G	A	0	2	2	0	0	2	0	0
17	8499025	.	C	T	0	4	4	0	8	12	0	0
17	8502883	.	G	A	9	8	17	0	0	17	0	0
17	8502931	.	G	A	6	6	12	0	1	13	0	0
17	8502949	.	G	C	11	0	11	0	5	16	0	0
17	8502982	.	G	A	8	1	9	0	0	9	0	0
17	8514511	.	G	A	3	3	6	0	0	6	0	0
17	8514648	.	A	G	2	4	6	0	0	6	0	0
17	8515363	.	G	A	2	2	4	0	0	4	0	0
17	8562349	.	A	G	2	1	3	0	0	3	0	0
17	8597078	.	C	A	0	9	9	0	11	20	0	0
17	8597174	.	T	A	15	13	28	0	1	29	0	0
17	8597515	.	A	T	19	15	34	0	1	35	0	0
17	8597702	.	A	T	16	13	29	0	0	29	0	0
17	8597871	.	T	C	14	6	20	0	1	21	0	0
17	8598070	.	C	T	0	26	26	0	15	41	0	0
17	8598168	.	G	A	24	16	40	0	0	40	0	0
17	8598345	.	T	A	10	6	16	0	1	17	0	0
17	8623396	.	G	A	7	5	12	0	1	13	0	0
17	8623480	.	C	T	1	18	19	0	16	35	0	0
17	8623540	.	C	T	0	10	10	0	10	20	0	0
17	8630043	.	C	A	16	9	25	0	0	25	0	0
17	8754388	.	C	T	2	2	4	0	0	4	0	0
17	8757694	.	C	T	2	2	4	0	0	4	0	0
17	8763782	.	G	C	0	2	2	0	1	3	0	0
17	8770161	.	C	G	1	0	1	0	0	1	0	0
17	8780728	.	C	T	1	1	2	0	0	2	0	0
17	8784742	.	G	A	0	4	4	0	6	10	0	0
17	8784934	.	C	A	0	2	2	0	0	2	0	0
17	8791613	.	T	A	3	5	8	0	1	9	0	0
17	8791618	.	C	G	5	4	9	0	1	10	0	0
17	8791863	.	C	T	1	4	5	0	0	5	0	0
17	8791917	.	T	C	2	2	4	0	0	4	0	0
17	8927397	.	G	A	1	0	1	0	0	1	0	0
17	8927638	.	A	G	2	6	8	0	0	8	0	0
17	8927641	.	A	G	2	5	7	0	1	8	0	0
17	8930017	.	C	T	5	8	13	0	0	13	0	0
17	8934235	.	C	T	18	12	30	0	1	31	0	0
17	8938011	.	G	A	5	6	11	0	0	11	0	0
17	8938249	.	T	C	9	9	18	0	0	18	0	0
17	8938269	.	G	A	14	12	26	0	0	26	0	0
17	8941206	.	G	A	7	2	9	0	0	9	0	0
17	8941264	.	T	C	10	15	25	0	0	25	0	0
17	8951516	.	C	A	6	3	9	1	0	10	0	0
17	8951606	.	C	G	0	6	6	0	15	21	0	0
17	8951867	.	C	T	0	1	1	0	5	6	0	0
17	8954377	.	G	A	11	11	22	0	1	23	0	0
17	8954482	.	C	T	10	12	22	1	0	23	0	0
17	8969278	.	A	G	4	3	7	0	1	8	0	0
17	8972806	.	T	C	7	0	7	0	12	19	0	0
17	8972821	.	G	A	8	4	12	0	1	13	0	0
17	8976273	.	A	G	11	11	22	0	2	24	0	0
17	9017898	.	A	T	5	3	8	0	0	8	0	0
17	9017899	.	T	G	5	3	8	0	0	8	0	0
17	9017950	.	A	G	4	4	8	0	2	10	0	0
17	9017972	.	G	A	6	8	14	0	0	14	0	0
17	9018124	.	C	T	0	2	2	0	0	2	0	0
17	9041916	.	C	G	1	0	1	0	3	4	0	0
17	9042623	.	T	C	4	5	9	0	0	9	0	0
17	9042652	.	T	C	5	7	12	0	0	12	0	0
17	9059105	.	A	G	1	2	3	0	0	3	0	0
17	9225184	.	G	A	0	8	8	0	9	17	0	0
17	9225223	.	A	G	5	3	8	0	1	9	0	0
17	9248656	.	A	G	3	0	3	0	2	5	0	0
17	9253504	.	A	T	4	5	9	0	0	9	0	0
17	9254269	.	T	A	6	5	11	0	0	11	0	0
17	9255196	.	G	A	0	5	5	0	8	13	0	0
17	9255547	.	G	C	4	17	21	0	1	22	0	0
17	9255703	.	C	T	11	7	18	0	0	18	0	0
17	9266298	.	C	T	10	13	23	0	0	23	0	0
17	9266501	.	G	T	0	18	18	0	7	25	0	0
17	9501630	.	A	G	3	4	7	0	1	8	0	0
17	9601121	.	G	C	1	1	2	0	0	2	0	0
17	9601133	.	C	T	1	1	2	0	0	2	0	0
17	9847215	.	C	T	3	2	5	0	0	5	0	0
17	9888958	.	C	G	3	11	14	0	0	14	0	0
17	9889223	.	C	T	12	5	17	0	3	20	0	0
17	9889427	.	G	A	6	9	15	0	0	15	0	0
17	9912162	.	A	G	1	2	3	0	0	3	0	0
17	9944725	.	A	G	1	6	7	0	0	7	0	0
17	9944733	.	A	G	0	7	7	0	0	7	0	0
17	9944848	.	T	A	8	6	14	0	0	14	0	0
17	9944874	.	C	T	9	6	15	0	0	15	0	0
17	9951885	.	G	A	2	2	4	0	0	4	0	0
17	9952033	.	C	T	0	10	10	0	8	18	0	0
17	9961079	.	T	C	0	2	2	0	0	2	0	0
17	9961080	.	G	A	0	2	2	0	0	2	0	0
17	9962505	.	A	G	2	5	7	0	0	7	0	0
17	9963519	.	G	A	4	5	9	0	0	9	0	0
17	9964437	.	A	T	3	2	5	0	1	6	0	0
17	9964944	.	C	A	7	3	10	0	0	10	0	0
17	9965010	.	C	A	1	4	5	0	0	5	0	0
17	9965344	.	T	A	1	1	2	0	0	2	0	0
17	9972748	.	C	T	0	2	2	0	0	2	0	0
17	9981995	.	A	G	2	2	4	0	0	4	0	0
17	9986655	.	G	A	1	3	4	0	0	4	0	0
17	10032559	.	C	T	1	2	3	0	0	3	0	0
17	10049162	.	C	T	1	1	2	0	0	2	0	0
17	10059909	.	G	A	1	2	3	0	0	3	0	0
17	10062229	.	T	C	0	0	0	0	5	5	0	0
17	10062243	.	T	C	1	0	1	0	4	5	0	0
17	10062318	.	C	T	3	2	5	0	0	5	0	0
17	10089583	.	G	T	5	4	9	0	1	10	0	0
17	10095554	.	A	G	2	1	3	0	0	3	0	0
17	10095961	.	G	C	0	1	1	0	3	4	0	0
17	10102289	.	T	C	3	6	9	0	0	9	0	0
17	10128550	.	A	T	0	1	1	0	0	1	0	0
17	10133901	.	G	A	2	3	5	0	0	5	0	0
17	10133902	.	C	T	2	3	5	0	0	5	0	0
17	10142416	.	G	C	3	12	15	0	0	15	0	0
17	10142474	.	T	G	3	5	8	0	0	8	0	0
17	10142481	.	A	G	3	3	6	0	0	6	0	0
17	10143808	.	A	G	3	7	10	0	0	10	0	0
17	10143960	.	C	T	2	4	6	0	0	6	0	0
17	10144027	.	A	C	4	4	8	0	0	8	0	0
17	10144104	.	A	C	1	4	5	0	0	5	0	0
17	10145004	.	G	T	11	21	32	0	2	34	0	0
17	10145281	.	C	T	7	11	18	0	1	19	0	0
17	10243069	.	A	G	4	0	4	0	2	6	0	0
17	10243120	.	C	T	3	3	6	0	1	7	0	0
17	10243794	.	C	A	2	5	7	0	0	7	0	0
17	10318127	.	A	T	5	2	7	0	0	7	0	0
17	10553213	.	A	T	1	3	4	0	0	4	0	0
17	10572650	.	G	A	5	2	7	0	0	7	0	0
17	10572655	.	T	C	6	2	8	0	0	8	0	0
17	10573034	.	G	A	1	3	4	0	0	4	0	0
17	10573186	.	A	G	3	3	6	0	0	6	0	0
17	10573312	.	C	A	3	1	4	0	0	4	0	0
17	10573327	.	T	C	2	3	5	0	0	5	0	0
17	10573366	.	C	T	2	2	4	0	0	4	0	0
17	10574230	.	C	T	1	1	2	0	0	2	0	0
17	10574804	.	C	A	1	1	2	0	1	3	0	0
17	10574981	.	G	A	3	1	4	0	0	4	0	0
17	10575393	.	C	T	2	0	2	0	0	2	0	0
17	10577617	.	A	G	1	0	1	0	0	1	0	0
17	10577843	.	A	G	1	1	2	0	0	2	0	0
17	10577867	.	G	C	1	3	4	0	0	4	0	0
17	10577887	.	A	G	1	3	4	0	1	5	0	0
17	10578806	.	C	A	2	3	5	0	0	5	0	0
17	10581404	.	T	A	2	6	8	0	1	9	0	0
17	10585056	.	G	A	1	3	4	0	0	4	0	0
17	10585083	.	G	A	0	2	2	0	4	6	0	0
17	10585101	.	G	A	2	8	10	0	1	11	0	0
17	10585140	.	C	T	5	8	13	0	0	13	0	0
17	10585166	.	A	G	5	5	10	0	0	10	0	0
17	10585210	.	T	C	2	2	4	0	0	4	0	0
17	10585363	.	A	T	4	5	9	0	0	9	0	0
17	10586161	.	A	T	6	4	10	0	1	11	0	0
17	10586449	.	A	G	6	8	14	0	0	14	0	0
17	10586664	.	A	C	8	11	19	0	0	19	0	0
17	10587020	.	G	T	5	5	10	0	1	11	0	0
17	10587330	.	A	C	4	2	6	0	0	6	0	0
17	10587601	.	A	G	4	6	10	0	0	10	0	0
17	10589488	.	C	T	1	3	4	0	0	4	0	0
17	10643288	.	A	G	1	1	2	0	1	3	0	0
17	10679990	.	T	C	0	1	1	0	0	1	0	0
17	10680447	.	A	G	1	2	3	0	2	5	0	0
17	10686248	.	A	T	5	5	10	0	0	10	0	0
17	10686287	.	A	G	6	3	9	0	0	9	0	0
17	10694630	.	G	A	1	0	1	0	0	1	0	0
17	10694756	.	T	C	0	1	1	0	0	1	0	0
17	10695904	.	G	A	6	2	8	0	0	8	0	0
17	10696006	.	C	T	2	3	5	0	0	5	0	0
17	10696137	.	A	T	1	0	1	0	0	1	0	0
17	10696498	.	A	T	0	1	1	0	0	1	0	0
17	10696676	.	A	T	3	7	10	0	1	11	0	0
17	10696688	.	T	C	4	7	11	0	0	11	0	0
17	10698537	.	A	C	10	5	15	0	0	15	0	0
17	10698681	.	G	T	4	8	12	0	0	12	0	0
17	10698977	.	A	C	3	4	7	0	0	7	0	0
17	10699076	.	G	T	0	7	7	0	6	13	0	0
17	10699077	.	A	C	4	7	11	0	2	13	0	0
17	10699151	.	A	G	4	0	4	0	5	9	0	0
17	10703731	.	C	T	3	3	6	0	0	6	0	0
17	10703764	.	C	A	6	4	10	0	1	11	0	0
17	10726617	.	C	T	2	2	4	0	1	5	0	0
17	10736503	.	G	A	1	2	3	0	0	3	0	0
17	10737844	.	T	A	1	3	4	0	0	4	0	0
17	10748708	.	G	C	0	5	5	0	7	12	0	0
17	10751051	.	T	C	1	1	2	0	0	2	0	0
17	10755512	.	A	G	13	4	17	0	0	17	0	0
17	10755656	.	T	C	4	3	7	0	0	7	0	0
17	10761763	.	T	C	1	0	1	0	0	1	0	0
17	10765286	.	C	T	3	0	3	0	0	3	0	0
17	10765683	.	T	A	3	3	6	0	0	6	0	0
17	10766074	.	G	C	11	5	16	0	1	17	0	0
17	10766142	.	T	A	9	7	16	0	1	17	0	0
17	10766205	.	G	T	4	2	6	0	0	6	0	0
17	10766219	.	A	T	2	3	5	0	1	7	1	0
17	10784149	.	C	T	0	13	13	0	8	21	0	0
17	10784151	.	T	C	7	14	21	0	0	21	0	0
17	10784210	.	A	C	15	2	17	0	10	27	0	0
17	10784441	.	A	G	9	13	22	0	0	22	0	0
17	10784618	.	G	A	10	6	16	0	2	18	0	0
17	10784646	.	C	G	11	7	18	0	1	19	0	0
17	10784948	.	A	T	14	5	19	0	2	21	0	0
17	10785020	.	A	G	9	8	17	0	2	19	0	0
17	10785206	.	A	G	10	4	14	0	0	14	0	0
17	10785289	.	T	C	13	4	17	0	0	17	0	0
17	10785552	.	A	G	3	5	8	0	2	10	0	0
17	10785616	.	T	A	7	9	16	0	0	16	0	0
17	10785619	.	C	T	7	9	16	0	0	16	0	0
17	10786085	.	C	A	8	4	12	0	1	13	0	0
17	10786149	.	T	A	1	2	3	0	0	3	0	0
17	10786520	.	T	C	6	6	12	0	0	12	0	0
17	10796797	.	T	C	4	4	8	0	2	10	0	0
17	10813718	.	G	A	3	1	4	0	1	5	0	0
17	10813783	.	A	T	7	9	16	0	0	16	0	0
17	10813817	.	G	T	8	7	15	0	1	16	0	0
17	10832208	.	A	G	0	1	1	0	0	1	0	0
17	11378906	.	T	A	4	4	8	0	0	8	0	0
17	11585063	.	C	G	0	0	0	0	1	1	0	0
17	11585117	.	G	A	2	1	3	0	1	4	0	0
17	11585279	.	G	A	2	2	4	0	0	4	0	0
17	11585399	.	T	C	1	2	3	0	0	3	0	0
17	11680788	.	T	G	1	0	1	0	2	3	0	0
17	11708690	.	G	A	3	2	5	0	0	5	0	0
17	11708797	.	G	A	0	4	4	0	3	7	0	0
17	11709187	.	G	A	4	3	7	0	0	7	0	0
17	11709199	.	C	T	2	2	4	0	0	4	0	0
17	11714598	.	T	A	4	7	11	0	1	12	0	0
17	11714635	.	G	C	8	5	13	0	0	13	0	0
17	11714874	.	T	C	0	4	4	0	0	4	0	0
17	11715917	.	G	C	6	8	14	0	0	14	0	0
17	11716068	.	T	C	4	2	6	0	1	7	0	0
17	11716113	.	T	G	7	7	14	0	0	14	0	0
17	11716296	.	A	G	4	3	7	0	0	7	0	0
17	11716397	.	T	C	2	2	4	0	0	4	0	0
17	11716487	.	T	C	0	3	3	0	1	4	0	0
17	11716509	.	G	T	1	4	5	0	0	5	0	0
17	11716701	.	A	G	2	0	2	0	2	4	0	0
17	11716702	.	A	G	0	4	4	0	0	4	0	0
17	11717109	.	C	T	14	7	21	0	6	27	0	0
17	11717131	.	C	T	6	10	16	0	5	21	0	0
17	11718118	.	A	G	11	10	21	0	1	22	0	0
17	11765805	.	G	A	0	2	2	0	0	2	0	0
17	11768427	.	G	C	1	3	4	0	0	4	0	0
17	12018751	.	C	T	0	1	1	0	1	2	0	0
17	12058522	.	G	T	0	10	10	0	4	14	0	0
17	12060478	.	G	A	0	2	2	0	2	4	0	0
17	12060587	.	A	G	7	6	13	0	3	16	0	0
17	12060627	.	C	T	6	5	11	0	0	11	0	0
17	12060631	.	G	A	0	3	3	0	5	8	0	0
17	12060799	.	A	G	4	5	9	0	1	10	0	0
17	12068675	.	G	C	4	7	11	0	1	12	0	0
17	12072890	.	C	T	12	7	19	0	0	19	0	0
17	12072977	.	T	C	6	9	15	0	0	15	0	0
17	12073037	.	C	T	4	5	9	0	1	10	0	0
17	12088799	.	G	A	0	3	3	0	4	7	0	0
17	12089069	.	G	C	3	2	5	0	0	5	0	0
17	12102140	.	C	T	2	2	4	0	0	4	0	0
17	12134693	.	C	A	2	4	6	0	0	6	0	0
17	12134709	.	C	T	4	3	7	0	0	7	0	0
17	12135206	.	G	A	3	4	7	0	0	7	0	0
17	12135322	.	A	T	4	6	10	0	1	11	0	0
17	12172771	.	C	G	0	2	2	0	0	2	0	0
17	12221666	.	T	C	1	3	4	0	0	4	0	0
17	12221788	.	C	A	0	2	2	0	6	8	0	0
17	12221891	.	G	A	2	5	7	0	0	7	0	0
17	12221903	.	C	T	0	5	5	0	1	6	0	0
17	12222226	.	A	G	3	2	5	0	1	6	0	0
17	12222235	.	G	T	2	2	4	0	0	4	0	0
17	12223514	.	G	A	0	1	1	0	0	1	0	0
17	12223743	.	G	A	6	4	10	0	0	10	0	0
17	12223883	.	C	G	3	0	3	0	0	3	0	0
17	12223884	.	T	A	3	0	3	0	0	3	0	0
17	12223971	.	G	A	1	5	6	0	0	6	0	0
17	12223989	.	C	A	0	6	6	0	3	9	0	0
17	12224581	.	T	C	4	0	4	0	6	10	0	0
17	12224621	.	T	C	2	7	9	0	0	9	0	0
17	12224976	.	G	A	8	7	15	0	0	15	0	0
17	12225070	.	G	A	6	10	16	0	1	17	0	0
17	12225271	.	G	A	2	4	6	0	0	6	0	0
17	12225292	.	C	T	0	6	6	0	2	8	0	0
17	12225418	.	T	G	5	2	7	0	0	7	0	0
17	12226404	.	C	T	0	2	2	0	0	2	0	0
17	12227034	.	C	T	0	3	3	0	2	5	0	0
17	12227369	.	C	T	1	1	2	0	0	2	0	0
17	12227374	.	T	C	1	2	3	0	0	3	0	0
17	12228304	.	C	T	3	3	6	0	0	6	0	0
17	12235791	.	A	G	2	0	2	0	0	2	0	0
17	12237333	.	G	A	0	1	1	0	0	1	0	0
17	12239955	.	T	C	2	0	2	0	2	4	0	0
17	12298106	.	G	T	35	24	59	0	4	63	0	0
17	12302409	.	G	A	26	28	54	0	4	58	0	0
17	12408447	.	C	T	9	8	17	0	0	17	0	0
17	12408454	.	G	C	8	9	17	0	0	17	0	0
17	12418130	.	C	A	0	1	1	0	0	1	0	0
17	12422810	.	A	G	8	1	9	0	9	18	0	0
17	12422850	.	T	A	9	8	17	0	0	17	0	0
17	12658472	.	G	A	3	3	6	0	0	6	0	0
17	12702780	.	C	T	9	18	27	0	0	27	0	0
17	12702801	.	A	G	6	0	6	0	12	18	0	0
17	12702831	.	C	A	4	4	8	0	0	8	0	0
17	12708393	.	A	G	7	3	10	0	0	10	0	0
17	12708404	.	C	A	7	4	11	0	0	11	0	0
17	12708903	.	T	C	13	23	36	0	1	37	0	0
17	12709244	.	T	G	8	10	18	0	0	18	0	0
17	12737483	.	G	A	0	3	3	0	4	7	0	0
17	12737580	.	A	G	3	2	5	0	0	5	0	0
17	12737586	.	T	G	3	0	3	0	2	5	0	0
17	12737629	.	A	T	1	2	3	0	0	3	0	0
17	12742971	.	A	G	1	2	3	0	0	3	0	0
17	12742974	.	C	T	1	1	2	0	0	2	0	0
17	12753792	.	G	A	10	9	19	0	0	19	0	0
17	12753823	.	A	G	13	8	21	0	1	22	0	0
17	12753916	.	T	A	7	12	19	0	0	19	0	0
17	12753940	.	A	T	6	8	14	0	0	14	0	0
17	12754071	.	A	G	10	12	22	0	2	24	0	0
17	12754158	.	A	T	6	5	11	0	0	11	0	0
17	12754198	.	A	T	0	6	6	0	0	7	1	0
17	12758823	.	T	C	7	1	8	0	1	9	0	0
17	12759072	.	G	A	1	6	7	0	0	7	0	0
17	12759135	.	C	T	3	2	5	0	0	5	0	0
17	12761221	.	G	C	5	5	10	0	0	10	0	0
17	12762852	.	T	C	3	3	6	0	0	6	0	0
17	12764004	.	C	T	1	11	12	0	16	28	0	0
17	12764090	.	G	T	8	9	17	0	2	19	0	0
17	12764244	.	A	T	5	1	6	0	1	7	0	0
17	12764247	.	G	T	5	2	7	0	0	7	0	0
17	12767696	.	A	T	3	2	5	0	0	5	0	0
17	12785737	.	T	C	3	2	5	0	0	5	0	0
17	12797241	.	C	G	3	3	6	0	0	6	0	0
17	12797280	.	C	T	4	3	7	0	0	7	0	0
17	12799132	.	C	T	6	4	10	0	0	10	0	0
17	12806340	.	C	G	2	4	6	0	1	7	0	0
17	12806360	.	C	T	2	4	6	0	0	6	0	0
17	12806381	.	T	C	1	0	1	0	0	1	0	0
17	12809332	.	T	C	1	2	3	0	0	3	0	0
17	12811215	.	C	T	0	1	1	0	0	1	0	0
17	12818580	.	T	C	1	1	2	0	0	2	0	0
17	12825732	.	C	T	1	2	3	0	0	3	0	0
17	12825741	.	G	A	0	4	4	0	2	6	0	0
17	12851473	.	T	G	2	1	3	0	0	3	0	0
17	12851518	.	G	A	0	6	6	0	4	10	0	0
17	12851831	.	T	G	5	4	9	0	2	11	0	0
17	12858173	.	C	T	10	10	20	0	3	23	0	0
17	12858658	.	G	C	11	10	21	0	0	21	0	0
17	12858765	.	A	G	10	10	20	0	0	20	0	0
17	12865807	.	C	T	1	0	1	0	0	1	0	0
17	12867975	.	G	A	2	1	3	0	1	4	0	0
17	12881532	.	G	A	4	1	5	0	0	5	0	0
17	12881590	.	G	A	0	12	12	0	8	20	0	0
17	12922410	.	A	T	9	7	16	0	2	18	0	0
17	12922678	.	A	G	4	5	9	0	1	10	0	0
17	12923028	.	A	G	16	11	27	0	2	29	0	0
17	12923131	.	A	G	12	0	12	0	12	24	0	0
17	12923303	.	A	G	12	0	12	0	12	24	0	0
17	12923509	.	A	T	8	3	11	0	0	11	0	0
17	12925020	.	G	A	4	4	8	0	0	8	0	0
17	12958744	.	G	A	8	2	10	0	0	10	0	0
17	12963487	.	A	C	6	0	6	0	10	16	0	0
17	12963571	.	G	A	9	12	21	0	1	22	0	0
17	12965499	.	A	G	2	5	7	0	0	7	0	0
17	12971471	.	G	A	0	1	1	0	0	1	0	0
17	12972906	.	T	G	3	2	5	0	0	5	0	0
17	12972969	.	A	G	7	3	10	0	0	10	0	0
17	12977682	.	T	C	1	0	1	0	0	1	0	0
17	13004885	.	T	C	1	0	1	0	2	3	0	0
17	13005936	.	T	C	1	1	2	0	0	2	0	0
17	13006372	.	A	G	2	2	4	0	0	4	0	0
17	13006784	.	G	A	4	2	6	0	0	6	0	0
17	13007303	.	A	T	4	2	6	0	0	6	0	0
17	13019988	.	T	A	17	18	35	0	0	35	0	0
17	13020090	.	G	A	5	14	19	0	0	19	0	0
17	13020187	.	A	C	13	4	17	0	0	17	0	0
17	13020472	.	T	C	12	9	21	0	0	21	0	0
17	13020476	.	T	A	9	8	17	0	2	19	0	0
17	13020601	.	C	T	1	8	9	0	9	18	0	0
17	13020733	.	C	G	13	16	29	0	1	30	0	0
17	13023022	.	G	A	0	1	1	0	0	1	0	0
17	13023289	.	T	C	8	6	14	0	1	15	0	0
17	13023407	.	A	C	7	7	14	0	1	15	0	0
17	13026599	.	A	T	7	5	12	0	0	12	0	0
17	13032557	.	A	G	9	0	9	0	5	14	0	0
17	13032558	.	A	G	9	4	13	0	1	14	0	0
17	13045230	.	C	G	3	4	7	0	0	7	0	0
17	13045540	.	G	T	5	7	12	0	0	12	0	0
17	13045559	.	A	C	6	6	12	0	0	12	0	0
17	13045794	.	T	A	11	8	19	0	0	19	0	0
17	13045882	.	A	T	5	8	13	0	1	14	0	0
17	13045980	.	T	C	3	4	7	0	0	7	0	0
17	13046058	.	T	G	2	6	8	0	0	8	0	0
17	13046099	.	G	A	4	7	11	0	1	12	0	0
17	13052081	.	C	T	0	4	4	0	2	6	0	0
17	13057986	.	T	A	3	7	10	0	0	10	0	0
17	13061839	.	T	C	1	1	2	0	0	2	0	0
17	13061849	.	C	G	1	2	3	0	0	3	0	0
17	13064531	.	C	T	4	3	7	0	0	7	0	0
17	13066963	.	T	A	3	2	5	0	0	5	0	0
17	13068561	.	G	A	2	3	5	0	0	5	0	0
17	13070504	.	T	C	1	1	2	0	0	2	0	0
17	13071678	.	T	A	2	3	5	0	0	5	0	0
17	13091660	.	T	G	6	5	11	0	2	13	0	0
17	13097239	.	C	T	4	3	7	0	0	7	0	0
17	13102057	.	A	G	1	0	1	0	0	1	0	0
17	13107061	.	A	G	12	1	13	0	3	16	0	0
17	13108626	.	G	T	14	18	32	0	1	33	0	0
17	13109010	.	A	G	11	24	35	0	1	36	0	0
17	13109042	.	T	C	13	20	33	0	0	33	0	0
17	13109097	.	A	T	10	12	22	0	3	25	0	0
17	13109409	.	C	T	16	15	31	0	2	33	0	0
17	13109793	.	A	C	8	4	12	0	1	13	0	0
17	13109818	.	T	C	9	6	15	0	0	15	0	0
17	13109910	.	A	G	14	0	14	0	6	20	0	0
17	13109928	.	G	T	1	8	9	0	13	22	0	0
17	13109990	.	T	A	15	11	26	0	0	26	0	0
17	13110003	.	C	G	13	10	23	0	1	24	0	0
17	13110043	.	C	T	8	3	11	0	0	11	0	0
17	13763454	.	T	C	1	3	4	0	1	5	0	0
17	13764198	.	C	T	6	2	8	0	0	8	0	0
17	13764513	.	A	C	2	4	6	0	2	8	0	0
17	14443633	.	T	A	6	7	13	0	0	13	0	0
17	14443651	.	T	C	5	0	5	0	6	11	0	0
17	14443697	.	G	A	6	3	9	0	0	9	0	0
17	14443768	.	T	A	2	3	5	0	0	5	0	0
17	14443820	.	T	G	1	3	4	0	2	6	0	0
17	14444166	.	A	G	10	10	20	0	0	20	0	0
17	14444167	.	G	A	10	10	20	0	0	20	0	0
17	14447282	.	A	G	2	1	3	0	0	3	0	0
17	14449386	.	C	T	0	0	0	0	3	3	0	0
17	14451264	.	T	C	2	1	3	0	0	3	0	0
17	14457452	.	T	G	8	4	12	0	0	12	0	0
17	14457911	.	C	A	1	3	4	0	2	6	0	0
17	14458364	.	T	C	3	4	7	0	1	8	0	0
17	14467471	.	G	A	5	2	7	0	0	7	0	0
17	14468247	.	C	T	0	6	6	0	5	11	0	0
17	14468263	.	T	G	5	5	10	0	1	11	0	0
17	14468370	.	A	T	8	10	18	0	4	22	0	0
17	14468386	.	T	A	8	14	22	0	0	22	0	0
17	14468433	.	G	A	12	15	27	0	0	27	0	0
17	14470340	.	A	G	3	1	4	0	0	4	0	0
17	14494395	.	A	G	5	12	17	0	0	17	0	0
17	14494429	.	A	G	6	13	19	0	0	19	0	0
17	14502454	.	T	A	9	5	14	0	0	14	0	0
17	14523518	.	G	T	4	5	9	0	1	10	0	0
17	14614452	.	T	C	11	7	18	0	0	18	0	0
17	14614471	.	A	G	10	11	21	0	0	21	0	0
17	14614509	.	C	A	13	16	29	0	0	29	0	0
17	14614863	.	C	A	8	17	25	0	1	26	0	0
17	14614900	.	G	A	9	9	18	0	1	19	0	0
17	14614973	.	C	G	6	6	12	0	0	12	0	0
17	14615089	.	T	C	9	8	17	0	1	18	0	0
17	14618038	.	C	G	6	7	13	0	0	13	0	0
17	14618051	.	G	A	6	6	12	0	1	13	0	0
17	14618842	.	C	T	3	1	4	0	0	4	0	0
17	14618857	.	C	T	0	4	4	0	7	11	0	0
17	14620476	.	T	G	1	3	4	0	1	5	0	0
17	14621230	.	C	T	0	0	0	0	2	2	0	0
17	14623340	.	A	G	1	3	4	0	0	4	0	0
17	14623352	.	T	A	2	5	7	0	1	8	0	0
17	14623391	.	A	T	3	4	7	0	0	7	0	0
17	14624088	.	G	T	4	1	5	0	0	5	0	0
17	14627407	.	A	G	2	6	8	0	0	8	0	0
17	14694711	.	C	A	23	27	50	0	0	50	0	0
17	14694744	.	A	G	20	20	40	0	0	40	0	0
17	14694802	.	C	G	18	18	36	0	0	36	0	0
17	14722223	.	A	G	4	5	9	0	0	9	0	0
17	14723137	.	C	T	17	18	35	0	0	35	0	0
17	14723208	.	T	C	13	14	27	0	1	28	0	0
17	14723302	.	A	G	5	16	21	0	0	21	0	0
17	14724005	.	C	A	12	8	20	0	1	21	0	0
17	14724057	.	T	C	11	10	21	0	2	23	0	0
17	14724489	.	T	C	7	5	12	0	0	12	0	0
17	14724514	.	T	C	7	1	8	0	7	15	0	0
17	14725246	.	A	C	11	0	11	0	8	19	0	0
17	14725561	.	C	T	0	9	9	0	7	16	0	0
17	14725648	.	C	T	10	9	19	0	0	19	0	0
17	14725831	.	T	A	9	12	21	0	1	22	0	0
17	14731522	.	G	T	8	3	11	0	0	11	0	0
17	14731560	.	T	C	8	7	15	0	0	15	0	0
17	14731819	.	T	C	2	3	5	0	1	6	0	0
17	14734632	.	C	T	1	3	4	0	0	4	0	0
17	14734734	.	G	A	8	5	13	0	0	13	0	0
17	14737070	.	G	A	2	3	5	0	0	5	0	0
17	14751227	.	T	A	2	0	2	0	0	2	0	0
17	14755275	.	A	G	5	7	12	0	0	12	0	0
17	14755852	.	G	A	0	4	4	0	0	4	0	0
17	14756129	.	A	G	3	2	5	0	0	5	0	0
17	14758562	.	G	A	5	5	10	0	0	10	0	0
17	14768411	.	G	A	2	5	7	0	0	7	0	0
17	14768652	.	T	A	5	9	14	0	0	14	0	0
17	14773949	.	T	C	0	0	0	0	1	1	0	0
17	14784323	.	T	C	11	11	22	0	1	23	0	0
17	14785663	.	C	T	3	8	11	0	0	11	0	0
17	14794285	.	A	G	5	5	10	0	0	10	0	0
17	14794485	.	G	T	14	25	39	0	1	40	0	0
17	14794639	.	A	T	3	3	6	0	0	6	0	0
17	14794672	.	C	G	1	4	5	0	0	5	0	0
17	14919126	.	T	G	2	7	9	0	0	9	0	0
17	14933285	.	T	A	1	0	1	0	0	1	0	0
17	14938834	.	C	T	3	2	5	0	0	5	0	0
17	14941594	.	A	G	2	3	5	0	0	5	0	0
17	14941634	.	T	A	2	5	7	0	0	7	0	0
17	14945613	.	T	C	4	0	4	0	0	4	0	0
17	14948914	.	A	T	1	2	3	0	0	3	0	0
17	14948957	.	G	T	1	2	3	0	0	3	0	0
17	14948958	.	T	C	1	2	3	0	0	3	0	0
17	14953698	.	A	G	2	2	4	0	0	4	0	0
17	14953761	.	G	A	4	1	5	0	0	5	0	0
17	14953949	.	T	G	4	1	5	0	0	5	0	0
17	14953953	.	T	C	4	1	5	0	0	5	0	0
17	14953989	.	C	G	0	3	3	0	0	3	0	0
17	14953999	.	C	G	0	2	2	0	0	2	0	0
17	14954037	.	C	T	0	1	1	0	0	1	0	0
17	14964644	.	C	T	3	2	5	0	0	5	0	0
17	15005217	.	A	G	4	4	8	0	0	8	0	0
17	15021944	.	G	A	1	1	2	0	0	2	0	0
17	15023286	.	G	A	2	1	3	0	0	3	0	0
17	15029220	.	A	T	1	1	2	0	0	2	0	0
17	15029290	.	G	A	1	2	3	0	1	4	0	0
17	15049262	.	T	C	1	4	5	0	2	7	0	0
17	15049316	.	G	C	1	7	8	0	0	8	0	0
17	15098680	.	G	A	1	2	3	0	0	3	0	0
17	15098783	.	C	T	0	3	3	0	0	3	0	0
17	15112200	.	A	T	3	2	5	0	1	6	0	0
17	15112285	.	G	A	2	2	4	0	0	4	0	0
17	15122021	.	T	G	6	5	11	0	0	11	0	0
17	15122177	.	T	C	6	0	6	0	3	9	0	0
17	15123023	.	A	G	3	3	6	0	0	6	0	0
17	15149034	.	T	C	1	2	3	0	1	4	0	0
17	15157300	.	A	G	0	1	1	0	0	1	0	0
17	15157304	.	G	C	0	1	1	0	0	1	0	0
17	15213620	.	C	T	2	3	5	0	0	5	0	0
17	15216134	.	A	T	0	2	2	0	1	3	0	0
17	15219107	.	G	A	2	5	7	0	0	7	0	0
17	15219325	.	A	C	1	3	4	0	0	4	0	0
17	15219739	.	T	A	1	2	3	0	0	3	0	0
17	15220092	.	C	T	1	4	5	0	1	6	0	0
17	15224052	.	G	A	3	4	7	0	0	7	0	0
17	15229577	.	T	C	2	2	4	0	0	4	0	0
17	15304284	.	C	T	1	5	6	0	0	6	0	0
17	15309621	.	C	T	0	3	3	0	7	10	0	0
17	15316001	.	T	C	10	5	15	0	0	15	0	0
17	15316022	.	T	C	6	4	10	0	0	10	0	0
17	15319232	.	G	A	6	6	12	0	1	13	0	0
17	15353984	.	G	A	9	5	14	0	1	15	0	0
17	15374185	.	T	C	11	14	25	0	1	26	0	0
17	15374507	.	G	A	10	13	23	0	1	24	0	0
17	15374744	.	C	G	13	7	20	0	0	20	0	0
17	15382421	.	T	A	17	9	26	0	1	27	0	0
17	15382486	.	C	T	14	6	20	0	0	20	0	0
17	15633377	.	T	C	4	14	18	0	0	18	0	0
17	15633379	.	T	C	3	15	18	0	0	18	0	0
17	15633439	.	T	C	8	4	12	0	4	16	0	0
17	15633530	.	C	T	4	2	6	0	0	6	0	0
17	15633721	.	T	C	4	6	10	0	0	10	0	0
17	15636751	.	T	C	8	3	11	0	0	11	0	0
17	15892479	.	G	A	0	5	5	0	4	9	0	0
17	15964960	.	C	T	2	2	4	0	0	4	0	0
17	15964997	.	T	C	1	2	3	0	0	3	0	0
17	15965589	.	C	A	2	3	5	0	0	5	0	0
17	15965951	.	G	T	0	2	2	0	3	5	0	0
17	15983530	.	C	T	10	9	19	0	0	19	0	0
17	16022530	.	C	T	13	6	19	0	1	20	0	0
17	16024587	.	A	G	7	7	14	0	3	17	0	0
17	16024590	.	G	A	9	5	14	0	2	16	0	0
17	16026207	.	T	A	3	1	4	0	0	4	0	0
17	16026293	.	A	G	7	12	19	0	0	19	0	0
17	16026345	.	A	G	13	9	22	0	0	22	0	0
17	16026486	.	C	T	5	9	14	0	0	14	0	0
17	16026593	.	C	T	2	13	15	0	0	15	0	0
17	16027718	.	G	A	7	8	15	0	1	16	0	0
17	16027720	.	A	G	7	9	16	0	0	16	0	0
17	16027935	.	G	T	9	11	20	0	1	21	0	0
17	16027983	.	A	T	12	10	22	0	1	23	0	0
17	16028040	.	G	A	14	11	25	0	0	25	0	0
17	16028118	.	A	G	8	0	8	0	8	16	0	0
17	16051749	.	T	C	1	3	4	0	0	4	0	0
17	16051805	.	A	G	1	4	5	0	0	5	0	0
17	16051968	.	G	A	3	5	8	0	0	8	0	0
17	16052075	.	A	G	5	4	9	0	1	10	0	0
17	16052229	.	C	T	5	6	11	0	0	11	0	0
17	16052282	.	G	A	6	3	9	0	1	10	0	0
17	16052563	.	G	A	8	7	15	0	1	16	0	0
17	16052587	.	T	G	5	7	12	0	0	12	0	0
17	16055049	.	T	C	5	7	12	0	1	13	0	0
17	16055179	.	G	A	4	2	6	0	0	6	0	0
17	16057798	.	C	T	13	11	24	0	0	24	0	0
17	16057877	.	C	A	0	3	3	0	2	5	0	0
17	16059802	.	T	G	7	11	18	0	0	18	0	0
17	16059831	.	T	G	10	7	17	0	0	17	0	0
17	16059854	.	G	T	6	11	17	0	0	17	0	0
17	16059889	.	A	C	9	0	9	0	7	16	0	0
17	16059928	.	T	A	2	1	3	0	0	3	0	0
17	16064779	.	A	T	0	3	3	0	1	4	0	0
17	16064843	.	G	T	2	4	6	0	1	7	0	0
17	16083852	.	C	T	1	2	3	0	0	3	0	0
17	16097737	.	A	T	1	1	2	0	0	2	0	0
17	16099691	.	C	T	2	3	5	0	0	5	0	0
17	16107111	.	C	T	6	5	11	0	0	11	0	0
17	16107167	.	T	A	4	4	8	0	1	9	0	0
17	16107882	.	A	G	7	0	7	0	8	15	0	0
17	16108231	.	T	A	2	2	4	0	0	4	0	0
17	16110234	.	A	G	8	8	16	0	0	16	0	0
17	16110291	.	T	A	3	3	6	0	0	6	0	0
17	16110336	.	T	C	4	8	12	0	1	13	0	0
17	16110447	.	T	G	8	5	13	0	0	13	0	0
17	16110527	.	C	G	0	8	8	0	3	11	0	0
17	16110552	.	C	T	1	10	11	0	1	12	0	0
17	16110573	.	A	G	5	3	8	0	0	8	0	0
17	16110687	.	G	A	6	4	10	0	0	10	0	0
17	16110773	.	A	G	3	4	7	0	0	7	0	0
17	16111427	.	C	T	5	7	12	0	0	12	0	0
17	16733982	.	C	T	1	3	4	0	1	5	0	0
17	16804700	.	A	G	6	11	17	0	0	17	0	0
17	16804703	.	A	G	3	14	17	0	0	17	0	0
17	16805671	.	T	G	0	2	2	0	0	2	0	0
17	16805695	.	A	G	4	2	6	0	1	7	0	0
17	17816030	.	T	C	0	2	2	0	0	2	0	0
17	18179927	.	T	C	2	5	7	0	2	9	0	0
17	19022656	.	C	G	1	4	5	0	0	5	0	0
17	19755258	.	T	C	1	2	3	0	0	3	0	0
17	19755269	.	T	C	0	2	2	0	0	2	0	0
17	20214570	.	C	A	2	2	4	0	0	4	0	0
17	21560753	.	A	T	6	2	8	0	0	8	0	0
17	23213060	.	T	C	4	2	6	0	0	6	0	0
17	23575291	.	A	G	1	1	2	0	1	3	0	0
17	23575301	.	A	G	1	0	1	0	2	3	0	0
17	23763190	.	T	C	4	3	7	0	0	7	0	0
17	23763192	.	T	C	4	3	7	0	0	7	0	0
17	24443182	.	G	C	0	4	4	0	0	4	0	0
17	24580112	.	C	T	1	4	5	0	0	5	0	0
17	24608232	.	C	T	4	1	5	0	0	5	0	0
17	25402098	.	A	T	0	4	4	0	1	5	0	0
17	25885260	.	T	A	0	1	1	0	0	1	0	0
17	26298967	.	C	T	2	3	5	0	0	5	0	0
17	26335000	.	G	A	3	0	3	0	0	3	0	0
17	26362130	.	G	A	10	9	19	0	0	19	0	0
17	26362512	.	A	C	2	6	8	0	0	8	0	0
17	26362539	.	C	T	1	7	8	0	0	8	0	0
17	26477743	.	A	C	12	2	14	0	1	15	0	0
17	26477747	.	T	A	9	4	13	0	1	14	0	0
17	26477795	.	A	C	9	6	15	0	0	15	0	0
17	26477857	.	T	C	6	8	14	0	2	16	0	0
17	26477860	.	C	T	8	7	15	0	1	16	0	0
17	26478023	.	T	C	8	5	13	0	0	13	0	0
17	26478592	.	A	G	8	10	18	0	1	19	0	0
17	26478818	.	T	C	2	0	2	0	9	11	0	0
17	26478952	.	G	A	6	9	15	0	1	16	0	0
17	26478986	.	A	G	7	8	15	0	0	15	0	0
17	26479063	.	A	G	9	9	18	0	1	19	0	0
17	26479145	.	T	C	9	8	17	0	0	17	0	0
17	26479960	.	C	T	1	6	7	0	0	7	0	0
17	26479997	.	A	T	3	4	7	0	0	7	0	0
17	26480421	.	A	G	2	2	4	0	0	4	0	0
17	26480423	.	T	C	2	1	3	0	1	4	0	0
17	26480622	.	A	T	6	4	10	0	1	11	0	0
17	26480683	.	A	G	4	4	8	0	0	8	0	0
17	26480926	.	T	G	4	2	6	0	0	6	0	0
17	26502047	.	A	C	1	1	2	0	3	5	0	0
17	26502107	.	G	A	3	3	6	0	1	7	0	0
17	26507294	.	G	A	1	1	2	0	0	2	0	0
17	26517310	.	A	C	5	0	5	0	4	9	0	0
17	26517366	.	G	A	1	2	3	0	0	3	0	0
17	26519475	.	T	C	3	0	3	0	2	5	0	0
17	26519681	.	C	T	5	3	8	0	0	8	0	0
17	26519823	.	T	C	2	0	2	0	5	7	0	0
17	26520183	.	T	A	1	0	1	0	0	1	0	0
17	26577293	.	T	C	3	5	8	0	0	8	0	0
17	26585135	.	G	T	4	10	14	0	0	14	0	0
17	26585163	.	A	T	7	6	13	0	1	14	0	0
17	26585298	.	G	T	0	4	4	0	5	9	0	0
17	26585316	.	C	T	5	5	10	0	0	10	0	0
17	26585646	.	C	T	15	9	24	0	0	24	0	0
17	26585727	.	C	T	5	16	21	0	2	23	0	0
17	26585748	.	A	G	14	0	14	0	9	23	0	0
17	26585763	.	T	A	16	8	24	0	0	24	0	0
17	26590001	.	T	G	8	9	17	0	2	19	0	0
17	26590054	.	C	T	6	5	11	0	1	12	0	0
17	26590091	.	C	T	7	4	11	0	0	11	0	0
17	26590330	.	T	C	8	5	13	0	0	13	0	0
17	26590495	.	A	G	1	2	3	0	0	3	0	0
17	26590650	.	G	T	3	5	8	0	0	8	0	0
17	26594931	.	C	T	3	10	13	0	2	15	0	0
17	26599208	.	C	T	0	1	1	0	2	3	0	0
17	26600555	.	T	A	2	5	7	0	0	7	0	0
17	26600639	.	G	A	6	5	11	0	1	13	1	0
17	26600667	.	C	T	5	4	9	0	0	9	0	0
17	26600785	.	G	A	1	1	2	0	0	2	0	0
17	26600881	.	G	A	3	5	8	0	0	8	0	0
17	26603369	.	A	T	1	0	1	0	0	1	0	0
17	26604572	.	A	G	4	2	6	0	0	6	0	0
17	26604751	.	G	C	3	8	11	0	0	11	0	0
17	26604758	.	C	T	3	8	11	0	0	11	0	0
17	26604801	.	C	A	5	6	11	0	1	12	0	0
17	26604917	.	G	A	3	3	6	0	0	6	0	0
17	26630909	.	C	T	1	5	6	0	1	7	0	0
17	26639659	.	C	T	4	3	7	0	1	8	0	0
17	26639725	.	A	G	8	1	9	0	6	15	0	0
17	26642775	.	C	A	3	5	8	0	0	8	0	0
17	26642817	.	T	G	5	0	5	0	9	14	0	0
17	26642818	.	T	C	6	8	14	0	0	14	0	0
17	26657852	.	T	C	8	10	18	0	0	18	0	0
17	26662347	.	C	T	6	3	9	0	0	9	0	0
17	26683466	.	T	C	0	1	1	0	0	1	0	0
17	26683526	.	C	T	10	9	19	0	1	20	0	0
17	26689753	.	G	A	10	17	27	0	5	32	0	0
17	26689768	.	C	A	24	4	28	0	3	31	0	0
17	26689792	.	C	A	10	20	30	0	0	30	0	0
17	26690112	.	T	A	19	8	27	0	0	27	0	0
17	26690250	.	C	T	4	7	11	0	0	11	0	0
17	26690276	.	C	T	10	8	18	0	0	18	0	0
17	26690478	.	C	T	8	5	13	0	0	13	0	0
17	26690558	.	G	A	1	7	8	0	9	17	0	0
17	26714009	.	C	T	20	29	49	0	6	55	0	0
17	26743948	.	T	C	1	2	3	0	0	3	0	0
17	26744174	.	G	A	1	2	3	0	0	3	0	0
17	26744207	.	G	C	2	1	3	0	0	3	0	0
17	26744489	.	G	A	1	2	3	0	0	3	0	0
17	26744516	.	A	G	1	0	1	0	3	4	0	0
17	26744840	.	A	G	2	3	5	0	1	6	0	0
17	26744862	.	G	A	3	2	5	0	0	5	0	0
17	26744981	.	C	T	4	2	6	0	0	6	0	0
17	26745106	.	T	C	3	4	7	0	0	7	0	0
17	26745110	.	C	T	3	4	7	0	1	8	0	0
17	26747348	.	A	G	1	1	2	0	0	2	0	0
17	26747392	.	G	T	0	1	1	0	0	1	0	0
17	26749836	.	G	A	1	2	3	0	1	4	0	0
17	26749881	.	T	A	1	2	3	0	0	3	0	0
17	26749889	.	C	T	1	2	3	0	0	3	0	0
17	26810380	.	C	T	17	8	25	0	1	26	0	0
17	26813285	.	T	C	1	12	13	0	5	18	0	0
17	26846203	.	C	T	10	7	17	0	1	18	0	0
17	26846650	.	G	A	4	6	10	0	0	10	0	0
17	26846707	.	G	A	0	4	4	0	4	8	0	0
17	26846901	.	T	G	2	8	10	0	0	10	0	0
17	26879854	.	A	C	5	13	18	0	0	18	0	0
17	26879869	.	A	G	10	10	20	0	0	20	0	0
17	26879893	.	A	G	13	17	30	0	0	30	0	0
17	26880107	.	G	A	17	14	31	0	2	33	0	0
17	26880231	.	T	C	22	22	44	0	2	46	0	0
17	26880424	.	T	C	29	20	49	0	1	50	0	0
17	26880714	.	G	T	7	0	7	0	0	7	0	0
17	26880926	.	T	C	14	1	15	0	12	27	0	0
17	26880964	.	A	G	15	24	39	0	3	42	0	0
17	26881131	.	T	A	23	7	30	0	3	33	0	0
17	26881354	.	A	G	12	21	33	0	1	34	0	0
17	26881777	.	A	G	19	16	35	0	1	36	0	0
17	26911747	.	A	G	15	16	31	0	0	31	0	0
17	26924308	.	C	T	0	5	5	0	1	6	0	0
17	26926548	.	G	A	1	6	7	0	0	7	0	0
17	26928727	.	T	C	3	2	5	0	0	5	0	0
17	26928737	.	A	G	0	2	2	0	0	2	0	0
17	26928765	.	C	T	1	8	9	0	0	9	0	0
17	26928994	.	C	T	0	3	3	0	0	3	0	0
17	26929475	.	T	C	8	5	13	0	0	13	0	0
17	26929577	.	C	A	7	6	13	0	0	13	0	0
17	26929649	.	A	G	7	7	14	0	1	15	0	0
17	26929654	.	T	A	8	6	14	0	1	15	0	0
17	26929776	.	C	T	7	4	11	0	0	11	0	0
17	26929893	.	G	A	8	7	15	0	1	16	0	0
17	26933223	.	A	G	0	3	3	0	0	3	0	0
17	26933328	.	C	T	0	2	2	0	0	2	0	0
17	26934417	.	C	T	0	4	4	0	2	6	0	0
17	26935160	.	C	T	1	0	1	0	1	2	0	0
17	26935254	.	G	T	7	8	15	0	0	15	0	0
17	26935274	.	G	T	11	8	19	0	0	19	0	0
17	26985158	.	G	A	0	7	7	0	18	25	0	0
17	26985544	.	T	A	3	8	11	0	0	11	0	0
17	26985561	.	T	G	2	0	2	0	9	11	0	0
17	26985586	.	C	T	3	13	16	0	0	16	0	0
17	26985638	.	T	G	2	12	14	0	1	15	0	0
17	26985656	.	T	A	2	8	10	0	1	11	0	0
17	26985692	.	G	T	3	5	8	0	0	8	0	0
17	27064523	.	T	A	6	6	12	0	0	12	0	0
17	27064725	.	T	C	2	5	7	0	0	7	0	0
17	27064840	.	G	C	0	3	3	0	1	4	0	0
17	27162479	.	C	T	0	0	0	0	1	1	0	0
17	27164497	.	T	C	4	4	8	0	0	8	0	0
17	27164530	.	C	T	0	3	3	0	0	3	0	0
17	27166221	.	T	C	2	0	2	0	0	2	0	0
17	27166257	.	T	C	5	1	6	0	0	6	0	0
17	27166521	.	C	T	1	3	4	0	0	4	0	0
17	27168957	.	G	T	0	2	2	0	3	5	0	0
17	27169783	.	A	C	4	4	8	0	0	8	0	0
17	27170017	.	G	A	1	3	4	0	5	9	0	0
17	27170153	.	A	T	1	7	8	0	0	8	0	0
17	27170516	.	G	A	1	5	6	0	9	15	0	0
17	27170549	.	G	A	8	5	13	0	0	13	0	0
17	27170605	.	T	G	2	6	8	0	1	9	0	0
17	27170730	.	T	G	5	11	16	0	0	16	0	0
17	27170746	.	A	T	4	8	12	0	0	12	0	0
17	27176640	.	G	A	4	2	6	0	0	6	0	0
17	27176871	.	G	A	3	7	10	0	0	10	0	0
17	27176967	.	G	C	5	8	13	0	0	13	0	0
17	27176991	.	C	T	4	9	13	0	1	14	0	0
17	27177064	.	C	T	1	7	8	0	0	8	0	0
17	27177083	.	G	A	0	8	8	0	2	10	0	0
17	27177251	.	A	G	2	3	5	0	0	5	0	0
17	27177302	.	A	G	1	0	1	0	3	4	0	0
17	27177473	.	C	T	1	7	8	0	0	8	0	0
17	27177560	.	A	C	3	2	5	0	0	5	0	0
17	27177745	.	G	A	5	5	10	0	0	10	0	0
17	27177776	.	G	T	1	4	5	0	2	7	0	0
17	27177808	.	G	T	5	2	7	0	0	7	0	0
17	27178024	.	T	A	5	7	12	0	0	12	0	0
17	27178088	.	T	A	5	4	9	0	0	9	0	0
17	27178130	.	G	A	0	2	2	0	8	10	0	0
17	27178135	.	T	A	8	2	10	0	0	10	0	0
17	27178191	.	G	A	4	2	6	0	1	7	0	0
17	27178232	.	A	G	2	3	5	0	0	5	0	0
17	27178254	.	C	A	4	2	6	0	0	6	0	0
17	27178273	.	G	T	2	2	4	0	0	4	0	0
17	27178296	.	G	A	0	3	3	0	1	4	0	0
17	27178356	.	T	A	3	2	5	0	0	5	0	0
17	27178383	.	C	G	3	7	10	0	1	11	0	0
17	27178557	.	C	T	7	6	13	0	0	13	0	0
17	27178638	.	C	G	8	4	12	0	0	12	0	0
17	27178870	.	T	C	8	6	14	0	1	15	0	0
17	27179189	.	A	G	8	5	13	0	0	13	0	0
17	27179203	.	G	T	0	7	7	0	5	12	0	0
17	27179434	.	G	T	3	5	8	0	0	8	0	0
17	27180847	.	A	G	5	4	9	0	0	9	0	0
17	27181021	.	T	C	5	3	8	0	1	9	0	0
17	27181048	.	C	G	7	4	11	0	1	12	0	0
17	27181129	.	G	A	11	9	20	0	0	20	0	0
17	27181130	.	G	A	11	9	20	0	0	20	0	0
17	27181257	.	A	C	8	9	17	0	1	18	0	0
17	27181323	.	A	G	11	0	11	0	7	18	0	0
17	27181411	.	A	G	8	0	8	0	6	14	0	0
17	27181427	.	C	T	5	7	12	0	1	13	0	0
17	27181463	.	A	G	2	0	2	0	3	5	0	0
17	27181481	.	A	G	1	2	3	0	1	4	0	0
17	27181829	.	A	G	6	5	11	0	0	11	0	0
17	27182006	.	G	T	14	4	18	0	0	18	0	0
17	27182039	.	T	C	11	7	18	0	0	18	0	0
17	27182114	.	A	G	2	12	14	0	0	14	0	0
17	27182146	.	C	T	3	10	13	0	1	14	0	0
17	27182331	.	T	G	2	4	6	0	0	6	0	0
17	27182340	.	C	T	2	5	7	0	0	7	0	0
17	27182449	.	G	T	4	7	11	0	0	11	0	0
17	27182484	.	T	C	8	12	20	0	1	21	0	0
17	27182645	.	G	T	11	13	24	0	2	26	0	0
17	27182649	.	A	G	14	12	26	0	0	26	0	0
17	27182769	.	A	G	8	9	17	0	0	17	0	0
17	27182894	.	T	C	5	12	17	0	1	18	0	0
17	27182925	.	A	T	4	12	16	0	0	16	0	0
17	27182979	.	C	T	8	7	15	0	1	16	0	0
17	27190731	.	C	G	1	4	5	0	0	5	0	0
17	27190732	.	C	T	1	3	4	0	1	5	0	0
17	27192048	.	G	A	0	2	2	0	0	2	0	0
17	27192756	.	G	C	1	3	4	0	0	4	0	0
17	27194087	.	G	A	0	3	3	0	0	3	0	0
17	27194669	.	C	T	0	2	2	0	0	2	0	0
17	27194867	.	A	G	2	2	4	0	0	4	0	0
17	27272913	.	T	C	5	9	14	0	0	14	0	0
17	27273013	.	C	T	16	9	25	0	0	25	0	0
17	27408386	.	A	G	8	7	15	0	0	15	0	0
17	27408472	.	C	T	6	12	18	0	3	21	0	0
17	27408523	.	G	T	4	4	8	0	1	9	0	0
17	27408531	.	T	A	2	3	5	0	2	7	0	0
17	27408637	.	T	C	2	0	2	0	8	10	0	0
17	27408836	.	T	G	1	10	11	0	0	11	0	0
17	27408889	.	T	C	0	6	6	0	0	6	0	0
17	27413564	.	T	C	2	2	4	0	0	4	0	0
17	27413705	.	T	C	6	9	15	0	0	15	0	0
17	27414035	.	G	A	5	2	7	0	2	9	0	0
17	27414098	.	C	A	4	11	15	0	1	16	0	0
17	27414203	.	G	A	8	10	18	0	1	19	0	0
17	27414215	.	C	T	0	7	7	0	15	22	0	0
17	27414367	.	A	G	4	11	15	0	1	16	0	0
17	27414658	.	T	C	5	13	18	0	1	19	0	0
17	27414701	.	A	G	4	7	11	0	0	11	0	0
17	27414791	.	A	G	5	7	12	0	1	13	0	0
17	27414815	.	G	A	4	7	11	0	0	11	0	0
17	27415010	.	C	T	0	7	7	0	5	12	0	0
17	27723800	.	G	T	8	5	13	0	2	15	0	0
17	27807455	.	T	C	20	17	37	0	1	38	0	0
17	27808190	.	A	G	11	0	11	0	10	21	0	0
17	27808335	.	A	G	13	14	27	0	0	27	0	0
17	27808686	.	G	A	5	5	10	0	0	10	0	0
17	27808700	.	G	A	6	5	11	0	0	11	0	0
17	27808987	.	G	T	0	20	20	0	28	48	0	0
17	27809548	.	T	A	13	9	22	0	2	24	0	0
17	27809631	.	G	T	0	4	4	0	13	17	0	0
17	27809779	.	C	A	18	13	31	0	0	31	0	0
17	27809885	.	A	G	25	14	39	0	0	39	0	0
17	27810508	.	G	T	13	4	17	0	0	17	0	0
17	27811199	.	T	A	4	3	7	0	0	7	0	0
17	27811209	.	A	G	3	4	7	0	1	9	1	0
17	27812525	.	A	C	16	8	24	0	0	24	0	0
17	27812562	.	G	A	0	9	9	0	17	26	0	0
17	27812702	.	A	T	11	10	21	0	1	22	0	0
17	27813010	.	A	G	5	2	7	0	1	8	0	0
17	27813221	.	C	T	10	5	15	0	0	15	0	0
17	27813222	.	A	G	10	4	14	0	1	15	0	0
17	27813549	.	C	G	10	5	15	0	1	16	0	0
17	27813553	.	C	G	10	7	17	0	0	17	0	0
17	28049663	.	A	T	1	3	4	0	0	4	0	0
17	28049804	.	G	T	6	4	10	0	0	10	0	0
17	28050954	.	G	A	5	7	12	0	0	12	0	0
17	28051073	.	C	T	2	3	5	0	0	5	0	0
17	28051129	.	G	A	6	4	10	0	0	10	0	0
17	28051222	.	C	T	1	3	4	0	0	4	0	0
17	28051247	.	T	A	2	4	6	0	0	6	0	0
17	28051465	.	T	C	4	5	9	0	0	9	0	0
17	28051504	.	G	T	5	5	10	0	0	10	0	0
17	28051605	.	A	G	3	3	6	0	0	6	0	0
17	28051739	.	A	G	8	7	15	0	1	16	0	0
17	28052322	.	C	A	5	3	8	0	3	11	0	0
17	28067389	.	C	T	10	4	14	0	0	14	0	0
17	28067472	.	A	C	10	10	20	0	1	21	0	0
17	28067618	.	A	G	5	2	7	0	0	7	0	0
17	28067856	.	C	T	4	6	10	0	1	11	0	0
17	28068083	.	T	C	10	3	13	0	0	13	0	0
17	28068087	.	G	T	10	3	13	0	0	13	0	0
17	28068168	.	G	A	9	1	10	0	1	11	0	0
17	28068262	.	T	G	4	1	5	0	1	6	0	0
17	28068276	.	C	T	3	2	5	0	0	5	0	0
17	28068507	.	A	G	5	6	11	0	0	11	0	0
17	28068514	.	T	C	4	5	9	0	0	9	0	0
17	28068916	.	C	T	6	5	11	0	0	11	0	0
17	28069170	.	G	A	8	12	20	0	0	20	0	0
17	28069341	.	G	T	6	8	14	0	0	14	0	0
17	28069342	.	T	C	6	8	14	0	0	14	0	0
17	28069645	.	G	T	8	7	15	0	1	16	0	0
17	28069716	.	G	C	14	9	23	0	0	23	0	0
17	28069787	.	G	A	0	13	13	0	14	27	0	0
17	28070078	.	G	C	7	9	16	0	0	16	0	0
17	28070167	.	C	T	10	8	18	0	0	18	0	0
17	28070284	.	G	A	6	6	12	0	0	12	0	0
17	28070286	.	A	C	6	6	12	0	0	12	0	0
17	28070481	.	T	A	15	6	21	0	0	21	0	0
17	28070600	.	C	A	9	7	16	0	1	17	0	0
17	28070840	.	G	A	8	2	10	0	1	11	0	0
17	28070879	.	T	G	3	2	5	0	0	5	0	0
17	28071194	.	C	T	4	2	6	0	0	6	0	0
17	28071260	.	A	G	4	4	8	0	1	9	0	0
17	28084592	.	C	T	5	8	13	0	1	14	0	0
17	28084908	.	C	T	10	17	27	0	0	27	0	0
17	28097235	.	G	A	3	1	4	0	0	4	0	0
17	28100598	.	C	T	0	13	13	0	11	24	0	0
17	28167312	.	G	A	4	2	6	0	0	6	0	0
17	28167313	.	A	T	4	2	6	0	0	6	0	0
17	28168645	.	C	T	8	3	11	0	0	11	0	0
17	28168712	.	T	A	3	3	6	0	1	7	0	0
17	28168941	.	A	T	1	4	5	0	0	5	0	0
17	28340740	.	A	T	4	5	9	0	0	9	0	0
17	28440212	.	T	A	8	2	10	0	1	11	0	0
17	28461857	.	G	A	0	8	8	0	6	14	0	0
17	28466273	.	C	T	5	4	9	0	0	9	0	0
17	28624471	.	C	T	0	1	1	0	0	1	0	0
17	28637139	.	G	A	0	3	3	0	2	5	0	0
17	28639058	.	T	C	1	0	1	0	0	1	0	0
17	28639333	.	T	G	0	2	2	0	0	2	0	0
17	28640625	.	C	T	1	4	5	0	0	5	0	0
17	28643730	.	A	G	0	0	0	0	4	4	0	0
17	28654157	.	G	T	0	1	1	0	0	1	0	0
17	28658563	.	A	G	3	5	8	0	0	8	0	0
17	28658629	.	C	T	4	1	5	0	0	5	0	0
17	28660700	.	C	G	0	1	1	0	0	1	0	0
17	28661628	.	C	G	6	0	6	0	5	11	0	0
17	28661931	.	G	T	0	2	2	0	6	8	0	0
17	28670351	.	T	A	6	3	9	0	1	10	0	0
17	28670352	.	C	T	6	4	10	0	0	10	0	0
17	28680593	.	T	C	5	3	8	0	0	8	0	0
17	28683415	.	T	C	2	2	4	0	0	4	0	0
17	28684786	.	C	T	5	2	7	0	0	7	0	0
17	28688931	.	G	T	7	7	14	0	0	14	0	0
17	28694574	.	A	T	1	0	1	0	0	1	0	0
17	28694589	.	T	C	3	2	5	0	0	5	0	0
17	28695956	.	G	A	13	12	25	0	0	25	0	0
17	28696109	.	C	A	6	6	12	0	2	14	0	0
17	28696160	.	C	T	7	11	18	0	1	19	0	0
17	28696311	.	C	T	12	11	23	0	1	24	0	0
17	28696397	.	A	G	12	0	12	0	8	20	0	0
17	28700311	.	T	C	1	1	2	0	0	2	0	0
17	28700428	.	G	A	17	18	35	0	1	36	0	0
17	28701100	.	G	A	13	6	19	0	0	19	0	0
17	28707851	.	C	A	0	7	7	0	6	13	0	0
17	28730705	.	C	T	3	1	4	0	0	4	0	0
17	28738387	.	C	T	6	5	11	0	0	11	0	0
17	28738675	.	A	G	6	0	6	0	1	7	0	0
17	28741540	.	A	G	6	0	6	0	8	15	1	0
17	28741752	.	C	T	8	12	20	0	2	22	0	0
17	28741934	.	C	T	3	4	7	0	1	8	0	0
17	28742263	.	G	C	6	12	18	0	0	18	0	0
17	28742385	.	T	A	7	8	15	0	2	17	0	0
17	28742395	.	G	A	0	5	5	0	11	16	0	0
17	28742559	.	C	T	15	14	29	0	0	29	0	0
17	28762295	.	A	G	1	3	4	0	0	4	0	0
17	28771228	.	T	A	5	1	6	0	0	6	0	0
17	28777803	.	C	T	1	1	2	0	0	2	0	0
17	28784090	.	G	T	3	3	6	0	0	6	0	0
17	28784102	.	G	A	3	3	6	0	0	6	0	0
17	28785010	.	G	A	3	2	5	0	0	5	0	0
17	28785013	.	C	T	2	4	6	0	0	6	0	0
17	28789014	.	C	T	0	3	3	0	7	10	0	0
17	28793818	.	G	A	1	2	3	0	1	4	0	0
17	28803488	.	A	T	1	2	3	0	0	3	0	0
17	28942683	.	C	T	3	0	3	0	0	3	0	0
17	28948818	.	G	A	5	3	8	0	0	8	0	0
17	28959148	.	T	C	15	6	21	0	0	21	0	0
17	28968461	.	T	C	21	18	39	0	0	39	0	0
17	28968611	.	C	T	2	3	5	0	0	5	0	0
17	29117355	.	G	A	4	4	8	0	0	8	0	0
17	29127126	.	C	T	0	1	1	0	0	1	0	0
17	29252207	.	G	A	5	3	8	0	0	8	0	0
17	29252254	.	C	T	3	4	7	0	1	8	0	0
17	29253050	.	T	C	2	1	3	0	0	3	0	0
17	29282901	.	C	A	8	3	11	0	0	11	0	0
17	29282913	.	C	T	0	3	3	0	5	8	0	0
17	29283380	.	T	A	1	6	7	0	0	7	0	0
17	29283421	.	G	A	6	1	7	0	0	7	0	0
17	29283422	.	C	T	6	1	7	0	0	7	0	0
17	29283866	.	T	C	7	7	14	0	0	14	0	0
17	29283920	.	A	C	6	0	6	0	5	11	0	0
17	29283943	.	A	G	5	2	7	0	0	7	0	0
17	29283962	.	A	G	3	1	4	0	1	5	0	0
17	29288057	.	G	T	1	6	7	0	1	8	0	0
17	29288718	.	A	G	5	1	6	0	0	6	0	0
17	29298191	.	G	C	0	1	1	0	3	4	0	0
17	29300641	.	A	T	3	7	10	0	0	10	0	0
17	29300650	.	A	G	3	6	9	0	0	9	0	0
17	29301058	.	G	C	1	4	5	0	0	5	0	0
17	29306455	.	G	A	3	3	6	0	0	6	0	0
17	29306598	.	A	C	6	5	11	0	2	13	0	0
17	29306670	.	C	T	8	5	13	0	0	13	0	0
17	29306854	.	C	T	0	1	1	0	2	3	0	0
17	29308591	.	C	T	2	2	4	0	0	4	0	0
17	29308639	.	G	T	4	5	9	0	2	11	0	0
17	29308693	.	G	A	10	4	14	0	1	15	0	0
17	29308706	.	G	A	11	3	14	0	1	15	0	0
17	29308987	.	A	T	2	3	5	0	1	6	0	0
17	29310200	.	T	C	5	3	8	0	0	8	0	0
17	29310353	.	C	G	0	3	3	0	3	6	0	0
17	29311418	.	G	T	1	1	2	0	0	2	0	0
17	29311758	.	T	C	3	2	5	0	0	5	0	0
17	29311791	.	C	T	0	2	2	0	2	4	0	0
17	29312376	.	G	A	1	3	4	0	0	4	0	0
17	29312434	.	C	T	0	5	5	0	0	5	0	0
17	29334520	.	T	A	3	2	5	0	0	5	0	0
17	29334569	.	A	C	2	1	3	0	1	4	0	0
17	29335645	.	G	A	2	2	4	0	0	4	0	0
17	29336179	.	G	A	4	7	11	0	0	11	0	0
17	29336180	.	G	T	3	7	10	0	1	11	0	0
17	29341079	.	C	T	5	10	15	0	1	16	0	0
17	29341123	.	C	A	6	6	12	0	0	12	0	0
17	29345725	.	T	G	4	11	15	0	1	16	0	0
17	29345890	.	T	A	5	6	11	0	0	11	0	0
17	29366113	.	G	A	0	5	5	0	4	9	0	0
17	29369642	.	G	T	7	19	26	0	2	28	0	0
17	29369644	.	G	A	8	19	27	0	1	28	0	0
17	29797906	.	C	T	12	10	22	0	1	23	0	0
17	29804291	.	G	C	11	7	18	0	2	20	0	0
17	29876956	.	G	A	2	3	5	0	0	5	0	0
17	29877094	.	A	G	6	3	9	0	0	9	0	0
17	29877283	.	C	A	0	5	5	0	6	11	0	0
17	30395510	.	C	T	1	2	3	0	0	3	0	0
17	30414463	.	C	A	3	2	5	0	0	5	0	0
17	30453514	.	A	G	1	0	1	0	2	3	0	0
17	30460090	.	C	T	2	5	7	0	0	7	0	0
17	30590075	.	A	T	6	5	11	0	1	12	0	0
17	30857431	.	A	T	1	8	9	0	2	11	0	0
17	30857433	.	A	T	2	8	10	0	1	11	0	0
17	30979391	.	T	C	12	0	12	0	7	19	0	0
17	30979465	.	T	C	5	5	10	0	1	11	0	0
17	32524695	.	A	G	37	15	52	0	1	53	0	0
17	33197579	.	A	G	3	0	3	0	2	5	0	0
17	33306079	.	A	G	4	0	4	0	2	6	0	0
17	33306093	.	A	G	5	2	7	0	0	7	0	0
17	33306121	.	A	G	2	7	9	0	0	9	0	0
17	33306916	.	A	G	8	0	8	0	5	13	0	0
17	35248121	.	T	A	2	11	13	0	0	13	0	0
17	35249688	.	A	G	1	8	9	0	0	9	0	0
17	36940974	.	T	G	2	15	17	0	1	18	0	0
17	36940977	.	T	C	1	15	16	0	1	17	0	0
17	37363938	.	A	G	2	0	2	0	5	7	0	0
17	37445729	.	G	A	7	4	11	0	0	11	0	0
17	37445924	.	G	A	10	11	21	0	0	21	0	0
17	37445926	.	A	T	11	9	20	0	1	21	0	0
17	37446208	.	A	T	5	5	10	0	1	11	0	0
17	37446379	.	T	C	2	8	10	0	0	10	0	0
17	37446443	.	T	G	6	5	11	0	0	11	0	0
17	37446555	.	T	A	10	8	18	0	1	19	0	0
17	37446563	.	G	A	9	9	18	0	1	19	0	0
17	37446735	.	G	A	9	11	20	0	3	23	0	0
17	37446789	.	A	C	11	2	13	0	5	18	0	0
17	37449200	.	G	C	1	3	4	0	0	4	0	0
17	37450132	.	C	T	4	2	6	0	0	6	0	0
17	37450135	.	A	T	2	4	6	0	0	6	0	0
17	37450180	.	T	G	2	4	6	0	0	6	0	0
17	37570871	.	A	G	1	8	9	0	0	9	0	0
17	37584963	.	A	G	4	1	5	0	0	5	0	0
17	37585002	.	A	G	4	2	6	0	0	6	0	0
17	37590024	.	C	T	0	0	0	0	1	1	0	0
17	37593662	.	C	T	2	1	3	0	0	3	0	0
17	37603748	.	G	A	0	1	1	0	4	5	0	0
17	37605870	.	A	G	2	0	2	0	4	6	0	0
17	37606011	.	G	A	0	7	7	0	2	9	0	0
17	37606101	.	G	A	0	5	5	0	4	9	0	0
17	37606116	.	G	A	3	4	7	0	0	7	0	0
17	37618028	.	C	G	6	2	8	0	0	8	0	0
17	37618143	.	T	C	4	11	15	0	0	15	0	0
17	37618485	.	C	T	9	3	12	0	1	13	0	0
17	37624913	.	A	T	8	12	20	0	0	20	0	0
17	37648766	.	C	T	5	9	14	0	0	14	0	0
17	37792745	.	A	G	8	10	18	0	0	18	0	0
17	37793456	.	C	T	0	2	2	0	11	13	0	0
17	37793606	.	T	A	1	2	3	0	6	9	0	0
17	37793627	.	G	A	6	3	9	0	1	10	0	0
17	37794035	.	G	A	7	6	13	0	0	13	0	0
17	37795730	.	C	T	1	3	4	0	0	4	0	0
17	37795756	.	A	T	3	5	8	0	0	8	0	0
17	38021502	.	C	T	1	2	3	0	0	3	0	0
17	38021526	.	A	G	1	2	3	0	0	3	0	0
17	38022262	.	G	A	1	1	2	0	0	2	0	0
17	38022330	.	C	T	1	2	3	0	0	3	0	0
17	38022394	.	T	C	2	2	4	0	0	4	0	0
17	38232211	.	A	T	1	2	3	0	1	4	0	0
17	38232237	.	T	C	5	2	7	0	0	7	0	0
17	38232839	.	G	A	0	1	1	0	1	2	0	0
17	38263804	.	A	G	9	4	13	0	0	13	0	0
17	38263912	.	G	C	0	2	2	0	5	7	0	0
17	38264044	.	G	T	7	6	13	0	0	13	0	0
17	38295925	.	C	A	5	2	7	0	0	7	0	0
17	38295927	.	T	A	2	5	7	0	0	7	0	0
17	38295991	.	C	T	2	7	9	0	1	10	0	0
17	38296642	.	G	A	0	2	2	0	0	2	0	0
17	38296644	.	T	G	2	0	2	0	0	2	0	0
17	38303423	.	C	T	6	12	18	0	0	18	0	0
17	38303607	.	A	G	2	4	6	0	0	6	0	0
17	38303652	.	G	A	0	3	3	0	3	6	0	0
17	38393473	.	A	C	2	0	2	0	3	5	0	0
17	38394013	.	G	T	1	2	3	0	0	4	1	0
17	38394804	.	A	G	2	2	4	0	0	4	0	0
17	38397619	.	C	A	1	3	4	0	0	4	0	0
17	38397637	.	C	A	0	1	1	0	0	1	0	0
17	38471166	.	G	T	0	1	1	0	0	1	0	0
17	38471456	.	G	T	0	0	0	0	1	1	0	0
17	38545302	.	G	T	2	2	4	0	0	4	0	0
17	38545550	.	A	G	1	0	1	0	4	5	0	0
17	38545563	.	C	A	1	3	4	0	0	4	0	0
17	38678498	.	T	C	2	2	4	0	1	5	0	0
17	38688547	.	C	A	0	1	1	0	0	1	0	0
17	38688558	.	A	G	0	1	1	0	0	1	0	0
17	38688885	.	A	T	1	3	4	0	0	4	0	0
17	38698716	.	G	A	1	2	3	0	0	3	0	0
17	38713696	.	A	G	5	0	5	0	0	5	0	0
17	38713709	.	C	T	2	5	7	0	0	7	0	0
17	38714002	.	G	C	0	2	2	0	2	4	0	0
17	38714133	.	G	T	1	3	4	0	0	4	0	0
17	38714280	.	A	T	1	2	3	0	1	4	0	0
17	38714446	.	A	G	3	4	7	0	0	7	0	0
17	38714811	.	T	C	3	2	5	0	0	5	0	0
17	38740582	.	T	C	1	0	1	0	2	3	0	0
17	38740626	.	G	A	3	3	6	0	0	6	0	0
17	38740684	.	T	C	6	8	14	0	0	14	0	0
17	38740698	.	A	T	5	6	11	0	0	11	0	0
17	38749800	.	G	A	0	0	0	0	1	1	0	0
17	38749807	.	G	A	0	1	1	0	0	1	0	0
17	38751711	.	T	A	1	2	3	0	0	3	0	0
17	38754825	.	C	A	1	0	1	0	0	1	0	0
17	38755038	.	A	G	4	9	13	0	0	13	0	0
17	38756777	.	T	G	11	8	19	0	1	20	0	0
17	38758682	.	G	A	2	7	9	0	0	9	0	0
17	38760619	.	G	A	2	2	4	0	0	4	0	0
17	38760931	.	T	C	1	3	4	0	0	4	0	0
17	38761035	.	A	G	7	5	12	0	0	12	0	0
17	38761069	.	T	C	6	2	8	0	0	8	0	0
17	38768370	.	G	T	4	1	5	0	1	6	0	0
17	38768433	.	C	T	0	5	5	0	6	11	0	0
17	38768483	.	G	A	1	0	1	0	0	1	0	0
17	38769924	.	T	A	3	0	3	0	0	3	0	0
17	38769935	.	T	C	3	0	3	0	0	3	0	0
17	38769975	.	G	A	3	0	3	0	0	3	0	0
17	38784385	.	G	A	8	7	15	0	1	16	0	0
17	38784477	.	T	C	15	9	24	0	0	24	0	0
17	38784545	.	G	T	13	4	17	0	0	17	0	0
17	38784642	.	T	C	10	5	15	0	1	16	0	0
17	38787327	.	G	A	2	5	7	0	0	7	0	0
17	38787498	.	G	A	1	1	2	0	0	2	0	0
17	38787540	.	A	T	3	1	4	0	0	4	0	0
17	38804808	.	C	T	1	2	3	0	0	3	0	0
17	38804853	.	A	T	4	4	8	0	0	8	0	0
17	38804868	.	T	C	6	0	6	0	5	11	0	0
17	38887156	.	C	T	1	2	3	0	3	6	0	0
17	38887271	.	T	G	6	3	9	0	0	9	0	0
17	38928073	.	A	T	4	4	8	0	0	8	0	0
17	38928447	.	T	C	5	0	5	0	4	9	0	0
17	38929142	.	T	G	8	5	13	0	0	13	0	0
17	38931440	.	G	A	7	2	9	0	0	9	0	0
17	38938727	.	G	A	4	3	7	0	1	8	0	0
17	38941193	.	T	C	1	2	3	0	1	4	0	0
17	38941286	.	G	A	3	4	7	0	0	7	0	0
17	38946619	.	G	A	0	1	1	0	0	1	0	0
17	38989302	.	G	C	5	0	5	0	1	6	0	0
17	39697690	.	T	C	3	2	5	0	1	6	0	0
17	39703380	.	C	A	0	2	2	0	0	2	0	0
17	39707421	.	C	T	2	3	5	0	0	5	0	0
17	39717616	.	T	C	2	1	3	0	0	3	0	0
17	39717645	.	A	G	4	0	4	0	3	7	0	0
17	39720791	.	T	C	8	5	13	0	1	14	0	0
17	39728239	.	C	T	5	5	10	0	0	10	0	0
17	39728261	.	G	T	7	6	13	0	1	14	0	0
17	39728423	.	T	A	3	7	10	0	0	10	0	0
17	39729014	.	G	A	6	11	17	0	0	17	0	0
17	39732512	.	C	T	8	7	15	0	1	16	0	0
17	39732573	.	C	A	10	10	20	0	1	21	0	0
17	39732584	.	G	A	9	11	20	0	1	21	0	0
17	39736088	.	T	A	13	6	19	0	0	19	0	0
17	39736103	.	G	A	12	7	19	0	2	21	0	0
17	39736130	.	T	C	10	10	20	0	0	20	0	0
17	39739842	.	A	T	5	5	10	0	0	10	0	0
17	39751466	.	C	A	3	1	4	0	0	4	0	0
17	39751522	.	T	A	1	2	3	0	0	3	0	0
17	39751540	.	C	T	2	2	4	0	0	4	0	0
17	39862536	.	C	G	2	12	14	0	0	14	0	0
17	40223456	.	G	A	1	4	5	0	0	5	0	0
17	40223457	.	G	A	1	4	5	0	0	5	0	0
17	40879510	.	A	G	3	7	10	0	0	10	0	0
17	40879822	.	C	T	3	3	6	0	0	6	0	0
17	40879823	.	C	T	3	3	6	0	0	6	0	0
17	40880042	.	G	A	4	3	7	0	2	9	0	0
17	40883596	.	C	T	0	2	2	0	0	2	0	0
17	40887285	.	G	T	2	3	5	0	0	5	0	0
17	40888907	.	A	C	2	1	3	0	0	3	0	0
17	40888909	.	G	C	1	1	2	0	1	3	0	0
17	40889613	.	C	A	2	0	2	0	0	2	0	0
17	40889697	.	A	G	2	2	4	0	0	4	0	0
17	40890056	.	C	T	1	2	3	0	0	3	0	0
17	40890107	.	G	T	0	1	1	0	0	1	0	0
17	40890396	.	C	T	3	2	5	0	0	5	0	0
17	40898878	.	G	A	1	5	6	0	1	7	0	0
17	40899449	.	A	G	1	3	4	0	0	4	0	0
17	40899489	.	A	C	5	2	7	0	1	8	0	0
17	40899805	.	G	C	1	2	3	0	0	3	0	0
17	40899809	.	C	A	1	2	3	0	0	3	0	0
17	40900354	.	C	T	4	6	10	0	0	10	0	0
17	40900686	.	T	G	4	7	11	0	0	11	0	0
17	40901389	.	A	G	1	2	3	0	0	3	0	0
17	40901439	.	T	C	1	2	3	0	0	3	0	0
17	40901695	.	G	C	7	8	15	0	0	15	0	0
17	40901712	.	C	G	6	6	12	0	0	12	0	0
17	40901752	.	G	A	4	5	9	0	0	9	0	0
17	40901799	.	A	C	1	2	3	0	0	3	0	0
17	40901804	.	A	T	1	2	3	0	0	3	0	0
17	40902005	.	C	A	8	5	13	0	4	17	0	0
17	40902065	.	G	A	1	2	3	0	1	4	0	0
17	40902148	.	G	T	7	7	14	0	0	14	0	0
17	40902180	.	G	C	8	6	14	0	0	14	0	0
17	40902598	.	G	A	6	8	14	0	0	14	0	0
17	40902629	.	A	T	6	6	12	0	0	12	0	0
17	40902657	.	A	C	7	10	17	0	0	17	0	0
17	40902830	.	A	T	3	10	13	0	0	13	0	0
17	40902932	.	T	C	2	2	4	0	1	5	0	0
17	40903162	.	C	T	4	7	11	0	3	14	0	0
17	40955529	.	G	C	3	2	5	0	0	5	0	0
17	40990061	.	T	A	6	14	20	0	1	21	0	0
17	40990097	.	T	A	2	5	7	0	0	7	0	0
17	40999460	.	A	G	14	10	24	0	1	25	0	0
17	40999697	.	C	G	6	7	13	0	0	13	0	0
17	40999700	.	C	A	6	6	12	0	1	13	0	0
17	40999732	.	A	G	6	2	8	0	0	8	0	0
17	41084623	.	C	T	0	1	1	0	0	1	0	0
17	41084670	.	T	C	6	6	12	0	0	12	0	0
17	41092465	.	C	T	2	1	3	0	0	3	0	0
17	41220064	.	T	A	1	2	3	0	0	3	0	0
17	41254741	.	C	T	2	2	4	0	1	5	0	0
17	41264054	.	G	A	0	3	3	0	0	3	0	0
17	41264165	.	C	A	1	6	7	0	0	7	0	0
17	41314040	.	G	T	1	10	11	0	14	25	0	0
17	41314097	.	T	C	6	10	16	0	0	16	0	0
17	41314309	.	T	A	2	4	6	0	0	6	0	0
17	41314471	.	G	A	12	4	16	0	0	16	0	0
17	41314501	.	A	G	3	4	7	0	0	7	0	0
17	41317234	.	A	G	8	0	8	0	11	19	0	0
17	41317494	.	G	A	11	11	22	0	1	23	0	0
17	41317999	.	G	A	11	7	18	0	0	18	0	0
17	41318310	.	A	G	10	11	21	0	1	22	0	0
17	41318436	.	G	A	0	2	2	0	0	2	0	0
17	41368655	.	G	A	2	2	4	0	0	4	0	0
17	41464090	.	G	A	0	7	7	0	6	13	0	0
17	41465504	.	A	C	2	5	7	0	2	9	0	0
17	41465922	.	G	A	5	2	7	0	0	7	0	0
17	41475863	.	T	C	8	14	22	0	2	24	0	0
17	41476104	.	T	C	14	0	14	0	14	28	0	0
17	41476161	.	A	G	16	15	31	0	1	32	0	0
17	41476279	.	G	A	9	17	26	0	4	30	0	0
17	41476298	.	T	A	9	17	26	0	0	26	0	0
17	41476393	.	G	T	6	4	10	0	3	13	0	0
17	41476833	.	T	C	2	4	6	0	0	6	0	0
17	41476906	.	A	C	2	0	2	0	6	8	0	0
17	41476917	.	C	T	1	5	6	0	1	7	0	0
17	41476970	.	T	C	5	5	10	0	0	10	0	0
17	41476994	.	G	A	4	7	11	0	0	11	0	0
17	41477007	.	C	T	0	7	7	0	4	11	0	0
17	41477157	.	T	C	7	7	14	0	0	14	0	0
17	41477324	.	G	A	5	11	16	0	1	17	0	0
17	41571328	.	T	A	3	6	9	0	0	9	0	0
17	41583337	.	T	C	6	3	9	0	1	10	0	0
17	41583555	.	C	G	0	5	5	0	3	8	0	0
17	41583747	.	G	T	7	7	14	0	3	17	0	0
17	41583768	.	T	C	8	0	8	0	5	13	0	0
17	41583786	.	A	G	4	2	6	0	0	6	0	0
17	41592172	.	A	C	1	0	1	0	0	1	0	0
17	41601633	.	G	A	2	1	3	0	1	4	0	0
17	41602081	.	T	C	3	1	4	0	0	4	0	0
17	41639674	.	A	G	0	2	2	0	0	2	0	0
17	41639675	.	G	A	0	2	2	0	0	2	0	0
17	41666581	.	G	A	6	4	10	0	0	10	0	0
17	41667069	.	G	A	5	2	7	0	0	7	0	0
17	41667109	.	C	T	0	0	0	0	2	2	0	0
17	41669288	.	G	A	1	2	3	0	0	3	0	0
17	41685644	.	G	A	2	2	4	0	0	4	0	0
17	41992262	.	T	G	2	0	2	0	3	5	0	0
17	41994768	.	G	T	0	3	3	0	0	3	0	0
17	42003872	.	C	T	4	2	6	0	0	6	0	0
17	42027915	.	C	T	2	6	8	0	0	8	0	0
17	42030083	.	A	G	3	0	3	0	2	5	0	0
17	42095539	.	A	T	0	2	2	0	0	2	0	0
17	42095602	.	A	G	2	3	5	0	0	5	0	0
17	42096960	.	C	G	0	3	3	0	4	7	0	0
17	42611545	.	C	T	2	3	5	0	0	5	0	0
17	42624707	.	A	T	1	1	2	0	0	2	0	0
17	42842731	.	C	T	1	5	6	0	0	6	0	0
17	42871419	.	G	T	10	8	18	0	0	18	0	0
17	43013675	.	G	A	6	8	14	0	0	14	0	0
17	43017672	.	C	T	14	12	26	0	0	26	0	0
17	43017687	.	G	A	12	11	23	0	0	23	0	0
17	43017830	.	A	G	11	4	15	0	1	16	0	0
17	43017863	.	A	C	16	8	24	0	1	25	0	0
17	43018037	.	G	A	0	14	14	0	18	32	0	0
17	43018124	.	A	G	23	0	23	0	5	28	0	0
17	43018273	.	G	A	18	18	36	0	2	38	0	0
17	43018382	.	T	G	16	18	34	0	1	35	0	0
17	43018502	.	T	A	23	21	44	0	0	44	0	0
17	43018549	.	C	G	22	12	34	0	5	39	0	0
17	43018638	.	A	T	20	15	35	0	0	35	0	0
17	43018815	.	A	G	20	10	30	0	3	33	0	0
17	43018899	.	T	A	17	17	34	0	1	35	0	0
17	43030696	.	T	C	3	9	12	0	1	13	0	0
17	43030737	.	T	G	16	15	31	0	0	31	0	0
17	43030828	.	G	A	9	11	20	0	2	22	0	0
17	43031495	.	G	A	5	7	12	0	1	13	0	0
17	43033177	.	G	A	11	8	19	0	1	20	0	0
17	43035798	.	T	C	16	21	37	0	3	40	0	0
17	43035958	.	A	G	11	10	21	0	2	23	0	0
17	43035996	.	G	T	15	18	33	0	0	33	0	0
17	43036025	.	A	G	10	18	28	0	0	28	0	0
17	43036055	.	T	C	7	12	19	0	0	19	0	0
17	43039706	.	A	G	1	3	4	0	0	4	0	0
17	43040422	.	T	A	1	6	7	0	0	7	0	0
17	43075560	.	G	T	2	1	3	0	0	3	0	0
17	43075561	.	G	A	2	1	3	0	0	3	0	0
17	43082976	.	A	T	4	3	7	0	0	7	0	0
17	43104590	.	T	A	0	4	4	0	0	4	0	0
17	43146607	.	G	C	2	3	5	0	0	5	0	0
17	43174889	.	G	A	2	3	5	0	0	5	0	0
17	43286920	.	C	T	2	2	4	0	0	4	0	0
17	43287129	.	C	T	0	3	3	0	4	7	0	0
17	43287146	.	A	G	3	2	5	0	0	5	0	0
17	43297946	.	G	C	12	15	27	0	0	27	0	0
17	43298011	.	G	A	13	13	26	0	1	27	0	0
17	43298068	.	G	A	18	12	30	0	0	30	0	0
17	43302492	.	G	A	8	9	17	0	0	17	0	0
17	43309095	.	A	G	3	6	9	0	0	9	0	0
17	43309164	.	C	T	1	7	8	0	3	11	0	0
17	43315085	.	C	T	4	3	7	0	0	7	0	0
17	43348986	.	T	C	4	7	11	0	0	11	0	0
17	43391434	.	G	T	5	3	8	0	2	10	0	0
17	43391442	.	C	T	6	3	9	0	1	10	0	0
17	43436782	.	T	C	13	0	13	0	14	27	0	0
17	43437305	.	G	C	14	8	22	0	0	22	0	0
17	43437365	.	C	G	7	1	8	0	0	8	0	0
17	43439720	.	G	T	7	13	20	0	3	23	0	0
17	43441575	.	A	T	2	0	2	0	0	2	0	0
17	43453507	.	T	C	4	6	10	0	1	12	1	0
17	43453531	.	G	A	5	12	17	0	0	17	0	0
17	43456825	.	C	T	5	11	16	0	0	16	0	0
17	43456900	.	G	A	9	10	19	0	1	20	0	0
17	43456921	.	T	C	8	6	14	0	1	15	0	0
17	43461181	.	G	A	2	3	5	0	0	5	0	0
17	43469515	.	G	T	2	4	6	0	1	7	0	0
17	43473913	.	T	C	3	3	6	0	1	7	0	0
17	43475994	.	T	G	8	6	14	0	1	15	0	0
17	43476137	.	T	A	9	6	15	0	0	15	0	0
17	43476232	.	A	G	4	2	6	0	0	6	0	0
17	43476241	.	A	G	3	2	5	0	0	5	0	0
17	43497376	.	A	G	2	8	10	0	1	11	0	0
17	43513318	.	C	T	1	3	4	0	5	9	0	0
17	43516451	.	T	A	3	0	3	0	0	3	0	0
17	43516464	.	T	A	4	0	4	0	0	4	0	0
17	43516502	.	G	T	9	6	15	0	1	16	0	0
17	43516506	.	A	C	9	7	16	0	0	16	0	0
17	43516548	.	A	G	5	10	15	0	1	16	0	0
17	43524233	.	T	C	4	2	6	0	0	6	0	0
17	43524245	.	T	G	4	2	6	0	0	6	0	0
17	43525757	.	A	G	2	0	2	0	0	2	0	0
17	43538209	.	C	T	5	4	9	0	0	9	0	0
17	43547945	.	A	G	4	2	6	0	0	6	0	0
17	43551539	.	A	C	2	3	5	0	0	5	0	0
17	43551547	.	G	T	2	2	4	0	0	4	0	0
17	43551865	.	C	T	4	3	7	0	2	9	0	0
17	43572332	.	G	A	3	2	5	0	0	5	0	0
17	43575545	.	C	A	2	2	4	0	0	4	0	0
17	43594693	.	C	A	1	2	3	0	0	3	0	0
17	43594709	.	A	T	1	2	3	0	0	3	0	0
17	43594806	.	T	C	1	4	5	0	0	5	0	0
17	43604511	.	G	C	1	2	3	0	0	3	0	0
17	43608998	.	C	T	1	1	2	0	0	2	0	0
17	43611513	.	C	T	1	3	4	0	0	4	0	0
17	43623744	.	T	G	4	2	6	0	0	6	0	0
17	43623856	.	A	T	1	4	5	0	0	5	0	0
17	43629286	.	A	T	3	2	5	0	0	5	0	0
17	43629364	.	C	T	1	3	4	0	1	5	0	0
17	43629502	.	G	A	0	2	2	0	3	5	0	0
17	43629604	.	T	C	3	2	5	0	0	5	0	0
17	43629622	.	C	T	2	3	5	0	0	5	0	0
17	43632931	.	G	T	0	0	0	0	1	1	0	0
17	43659950	.	T	G	2	5	7	0	1	8	0	0
17	43660168	.	C	T	9	10	19	0	0	19	0	0
17	43660232	.	G	A	8	10	18	0	1	19	0	0
17	43660779	.	T	C	6	6	12	0	0	12	0	0
17	43661176	.	C	G	5	8	13	0	0	13	0	0
17	43661223	.	G	T	6	5	11	0	0	11	0	0
17	43661578	.	A	G	9	6	15	0	1	16	0	0
17	43661618	.	T	A	5	7	12	0	2	14	0	0
17	43663611	.	T	G	4	5	9	0	0	9	0	0
17	43664128	.	G	C	15	26	41	0	0	41	0	0
17	43664176	.	C	A	1	14	15	0	12	27	0	0
17	43664605	.	G	A	12	13	25	0	0	25	0	0
17	43708608	.	C	T	4	5	9	0	1	10	0	0
17	43711502	.	G	A	2	2	4	0	0	4	0	0
17	43850878	.	A	T	7	8	15	0	0	15	0	0
17	43853767	.	A	T	7	9	16	0	0	16	0	0
17	43853778	.	C	T	0	6	6	0	9	15	0	0
17	43854010	.	T	G	7	7	14	0	0	14	0	0
17	43856232	.	T	C	5	3	8	0	1	9	0	0
17	43859306	.	A	T	10	7	17	0	0	17	0	0
17	43859378	.	C	T	9	14	23	0	2	25	0	0
17	43859387	.	C	T	8	14	22	0	0	22	0	0
17	43863540	.	C	A	9	17	26	0	0	26	0	0
17	43871524	.	T	C	1	0	1	0	2	3	0	0
17	43926650	.	C	A	2	0	2	0	0	2	0	0
17	43946490	.	T	G	3	0	3	0	5	8	0	0
17	43951792	.	A	C	3	0	3	0	1	4	0	0
17	43952984	.	C	T	2	4	6	0	1	7	0	0
17	43954926	.	A	C	4	3	7	0	0	7	0	0
17	43955964	.	G	A	0	3	3	0	1	4	0	0
17	43956910	.	T	C	1	2	3	0	0	3	0	0
17	43959078	.	A	G	1	0	1	0	7	8	0	0
17	43959098	.	A	G	3	0	3	0	9	12	0	0
17	43959594	.	A	G	0	1	1	0	0	1	0	0
17	43961739	.	C	T	1	0	1	0	0	1	0	0
17	43961801	.	T	C	4	4	8	0	0	8	0	0
17	43968605	.	A	G	0	1	1	0	0	1	0	0
17	43977416	.	G	A	3	2	5	0	0	5	0	0
17	43977433	.	T	G	3	5	8	0	0	8	0	0
17	43985045	.	G	A	3	1	4	0	0	4	0	0
17	43985075	.	C	T	5	5	10	0	0	10	0	0
17	43986863	.	C	T	4	5	9	0	1	10	0	0
17	43996483	.	G	A	5	3	8	0	0	8	0	0
17	43996485	.	G	A	5	3	8	0	0	8	0	0
17	43996620	.	A	T	2	1	3	0	0	3	0	0
17	43996667	.	G	A	4	4	8	0	0	8	0	0
17	44001833	.	T	C	9	11	20	0	0	20	0	0
17	44001880	.	T	A	7	17	24	0	0	24	0	0
17	44002000	.	C	G	9	1	10	0	14	24	0	0
17	44006579	.	G	T	4	3	7	0	0	7	0	0
17	44006654	.	A	G	2	4	6	0	0	6	0	0
17	44006924	.	G	C	1	2	3	0	0	3	0	0
17	44006927	.	G	A	1	1	2	0	0	2	0	0
17	44007047	.	A	T	7	3	10	0	0	10	0	0
17	44007326	.	G	T	1	0	1	0	0	1	0	0
17	44074996	.	C	G	3	0	3	0	2	5	0	0
17	44075035	.	A	G	2	0	2	0	5	7	0	0
17	44079258	.	G	A	0	5	5	0	1	6	0	0
17	44079441	.	G	A	1	4	5	0	0	5	0	0
17	44079803	.	G	T	6	3	9	0	1	10	0	0
17	44079925	.	G	C	3	2	5	0	0	5	0	0
17	44080212	.	G	A	4	6	10	0	0	10	0	0
17	44080227	.	C	T	5	5	10	0	0	10	0	0
17	44080530	.	A	G	0	3	3	0	0	3	0	0
17	44115587	.	T	C	4	2	6	0	0	6	0	0
17	44245452	.	T	C	19	10	29	0	0	29	0	0
17	44247495	.	G	A	11	11	22	0	0	22	0	0
17	44249428	.	T	G	1	1	2	0	0	2	0	0
17	44252640	.	T	A	4	7	11	0	0	11	0	0
17	44413925	.	C	T	3	3	6	0	0	6	0	0
17	44413980	.	G	A	3	2	5	0	0	5	0	0
17	44414030	.	A	G	7	6	13	0	1	14	0	0
17	44420201	.	G	A	1	0	1	0	0	1	0	0
17	44420602	.	G	A	5	5	10	0	0	10	0	0
17	44422527	.	G	T	1	0	1	0	0	1	0	0
17	44422729	.	C	T	0	2	2	0	2	4	0	0
17	44430544	.	A	G	2	3	5	0	1	6	0	0
17	44430586	.	C	T	0	3	3	0	1	4	0	0
17	44443867	.	T	C	2	2	4	0	0	4	0	0
17	44443885	.	A	T	2	2	4	0	0	4	0	0
17	44443984	.	G	A	2	2	4	0	0	4	0	0
17	44444017	.	T	G	2	2	4	0	0	4	0	0
17	44444035	.	A	T	1	2	3	0	0	3	0	0
17	44444127	.	C	T	3	4	7	0	0	7	0	0
17	44444188	.	C	T	3	2	5	0	0	5	0	0
17	44444378	.	A	G	3	0	3	0	0	3	0	0
17	44444396	.	G	A	0	2	2	0	0	2	0	0
17	44453771	.	G	A	0	4	4	0	1	5	0	0
17	44473954	.	G	C	2	7	9	0	0	9	0	0
17	44474284	.	G	A	7	6	13	0	0	13	0	0
17	44474392	.	A	G	11	5	16	0	0	16	0	0
17	44474445	.	C	A	5	9	14	0	0	14	0	0
17	44474541	.	C	T	2	3	5	0	0	5	0	0
17	44474547	.	T	A	3	0	3	0	2	5	0	0
17	44474592	.	T	G	1	2	3	0	0	3	0	0
17	44474658	.	A	G	1	0	1	0	9	10	0	0
17	44475047	.	T	G	5	8	13	0	2	15	0	0
17	44475093	.	C	G	6	8	14	0	0	14	0	0
17	44475940	.	C	G	5	3	8	0	1	9	0	0
17	44476075	.	G	T	1	6	7	0	1	8	0	0
17	44502836	.	A	G	4	3	7	0	0	7	0	0
17	44539266	.	T	A	3	2	5	0	0	5	0	0
17	44542577	.	A	G	3	3	6	0	0	6	0	0
17	44542598	.	G	C	4	3	7	0	0	7	0	0
17	44542712	.	G	C	4	4	8	0	0	8	0	0
17	44542790	.	A	G	2	2	4	0	0	4	0	0
17	44756390	.	G	A	0	2	2	0	5	7	0	0
17	44756895	.	A	C	1	0	1	0	0	1	0	0
17	44756986	.	C	T	0	1	1	0	0	1	0	0
17	44758078	.	T	C	1	2	3	0	1	4	0	0
17	44760544	.	C	A	5	9	14	0	1	15	0	0
17	44760618	.	C	T	8	5	13	0	0	13	0	0
17	44760774	.	C	T	5	7	12	0	0	12	0	0
17	44760858	.	A	G	3	4	7	0	1	8	0	0
17	44761011	.	A	G	3	4	7	0	0	7	0	0
17	44761349	.	G	A	2	5	7	0	0	7	0	0
17	44761356	.	G	T	2	5	7	0	0	7	0	0
17	44761504	.	T	C	0	2	2	0	0	2	0	0
17	44761542	.	T	A	1	1	2	0	1	3	0	0
17	44769039	.	T	A	1	4	5	0	1	6	0	0
17	44769379	.	A	G	2	3	5	0	0	5	0	0
17	44771236	.	C	G	3	2	5	0	0	5	0	0
17	44771353	.	A	C	1	0	1	0	0	1	0	0
17	44775971	.	C	T	4	2	6	0	0	6	0	0
17	44776034	.	T	A	2	2	4	0	0	4	0	0
17	44833808	.	G	A	0	1	1	0	0	1	0	0
17	44857662	.	C	T	3	2	5	0	0	5	0	0
17	44860885	.	C	G	0	1	1	0	0	1	0	0
17	44860887	.	C	A	0	1	1	0	0	1	0	0
17	44862308	.	G	C	5	3	8	0	0	8	0	0
17	44865421	.	G	A	0	0	0	0	1	1	0	0
17	44870978	.	G	A	0	2	2	0	2	4	0	0
17	44871033	.	A	T	3	1	4	0	0	4	0	0
17	44873988	.	C	T	3	3	6	0	1	7	0	0
17	44878504	.	G	T	2	3	5	0	0	5	0	0
17	44884946	.	C	T	2	2	4	0	0	4	0	0
17	44884955	.	G	A	0	3	3	0	4	7	0	0
17	44884997	.	C	T	4	3	7	0	0	7	0	0
17	44899562	.	G	A	0	8	8	0	7	15	0	0
17	44911803	.	A	G	3	4	7	0	0	7	0	0
17	44922442	.	C	T	9	7	16	0	0	16	0	0
17	44922685	.	G	T	3	17	20	0	1	21	0	0
17	44922743	.	G	A	5	11	16	0	0	16	0	0
17	44922788	.	C	A	7	10	17	0	1	18	0	0
17	44922819	.	A	T	6	11	17	0	0	17	0	0
17	44922866	.	C	T	4	12	16	0	0	16	0	0
17	44923053	.	C	T	4	2	6	0	0	6	0	0
17	44923083	.	T	A	3	3	6	0	0	6	0	0
17	44923322	.	T	A	4	9	13	0	0	13	0	0
17	44923389	.	G	A	2	3	5	0	0	5	0	0
17	44923504	.	A	T	1	0	1	0	0	3	2	0
17	44923510	.	T	A	1	2	3	0	0	3	0	0
17	44962056	.	G	A	20	10	30	0	0	30	0	0
17	44962502	.	A	T	2	3	5	0	0	5	0	0
17	44962507	.	A	G	3	1	4	0	1	5	0	0
17	44962575	.	G	T	2	7	9	0	1	10	0	0
17	44962693	.	T	C	6	6	12	0	1	13	0	0
17	44967819	.	G	A	11	14	25	0	0	25	0	0
17	44968095	.	C	T	6	2	8	0	2	10	0	0
17	44981154	.	G	A	3	2	5	0	0	5	0	0
17	44981175	.	T	C	2	4	6	0	0	6	0	0
17	44981689	.	A	G	5	4	9	0	1	10	0	0
17	44981693	.	C	G	5	6	11	0	0	11	0	0
17	44998615	.	C	G	4	4	8	0	0	8	0	0
17	45002782	.	T	G	3	4	7	0	0	7	0	0
17	45002812	.	G	A	5	2	7	0	0	7	0	0
17	45004833	.	T	C	3	5	8	0	0	8	0	0
17	45005038	.	G	T	2	2	4	0	0	4	0	0
17	45007209	.	T	C	1	1	2	0	0	2	0	0
17	45010190	.	A	C	8	2	10	0	2	12	0	0
17	45010337	.	C	T	5	5	10	0	1	11	0	0
17	45010338	.	T	A	5	6	11	0	0	11	0	0
17	45018030	.	C	T	6	1	7	0	0	7	0	0
17	45018207	.	A	G	2	0	2	0	0	2	0	0
17	45022535	.	T	G	6	0	6	0	7	13	0	0
17	45026822	.	C	A	2	2	4	0	0	4	0	0
17	45026833	.	C	T	2	1	3	0	0	3	0	0
17	45026922	.	G	A	0	2	2	0	1	3	0	0
17	45028213	.	G	C	3	2	5	0	0	5	0	0
17	45028689	.	T	A	2	2	4	0	0	4	0	0
17	45073467	.	T	A	3	5	8	0	0	8	0	0
17	45073490	.	C	A	0	6	6	0	3	9	0	0
17	45076111	.	A	G	6	12	18	0	0	18	0	0
17	45082331	.	T	G	3	10	13	0	2	15	0	0
17	45082406	.	A	G	18	13	31	0	1	32	0	0
17	45082466	.	C	A	0	4	4	0	1	5	0	0
17	45085085	.	G	A	13	9	22	0	0	22	0	0
17	45085100	.	C	T	14	14	28	0	1	29	0	0
17	45093134	.	G	T	6	7	13	1	0	14	0	0
17	45093155	.	G	A	3	4	7	0	0	7	0	0
17	45099042	.	G	T	4	6	10	0	1	11	0	0
17	45099141	.	C	A	2	3	5	0	1	6	0	0
17	45138048	.	C	G	11	7	18	0	0	18	0	0
17	45138255	.	C	A	0	7	7	0	6	13	0	0
17	45138329	.	A	C	15	7	22	0	0	22	0	0
17	45138733	.	T	C	13	12	25	0	0	25	0	0
17	45138741	.	T	C	19	8	27	0	0	27	0	0
17	45139291	.	T	C	7	4	11	0	0	11	0	0
17	45139503	.	C	A	17	12	29	0	0	29	0	0
17	45139506	.	G	T	15	11	26	0	0	27	1	0
17	45139609	.	T	A	6	4	10	0	0	10	0	0
17	45139750	.	C	T	10	6	16	0	0	16	0	0
17	45139805	.	A	T	6	6	12	0	0	12	0	0
17	45139879	.	C	T	7	10	17	0	2	19	0	0
17	45139881	.	G	A	7	11	18	0	1	19	0	0
17	45140088	.	C	G	1	10	11	0	2	13	0	0
17	45140114	.	T	C	1	4	5	0	0	5	0	0
17	45140376	.	A	T	5	4	9	0	0	9	0	0
17	45145056	.	A	G	8	5	13	0	0	13	0	0
17	45145065	.	T	C	9	0	9	0	6	15	0	0
17	45145143	.	T	C	4	1	5	0	5	10	0	0
17	45148190	.	G	T	2	1	3	0	0	3	0	0
17	45148302	.	T	A	1	1	2	0	0	2	0	0
17	45148303	.	A	G	1	1	2	0	0	2	0	0
17	45216125	.	C	T	3	5	8	0	0	8	0	0
17	45216312	.	C	T	0	4	4	0	4	8	0	0
17	45216388	.	G	A	2	3	5	0	0	5	0	0
17	45216612	.	G	A	8	5	13	0	0	13	0	0
17	45232756	.	T	C	6	3	9	0	1	10	0	0
17	45232993	.	T	A	3	2	5	0	0	5	0	0
17	45233125	.	T	A	0	1	1	0	0	1	0	0
17	45233134	.	C	T	1	0	1	0	0	1	0	0
17	45234663	.	T	A	1	3	4	0	0	4	0	0
17	45234816	.	G	C	1	3	4	0	0	4	0	0
17	45235138	.	G	A	2	3	5	0	1	6	0	0
17	45235370	.	C	A	4	4	8	0	2	10	0	0
17	45235379	.	A	T	5	5	10	0	0	10	0	0
17	45247199	.	A	G	2	2	4	0	0	4	0	0
17	45254339	.	C	T	2	3	5	0	0	5	0	0
17	45263441	.	C	A	1	3	4	0	0	4	0	0
17	45302528	.	A	G	0	1	1	0	0	1	0	0
17	45348243	.	G	A	5	3	8	0	0	8	0	0
17	45348585	.	T	A	1	3	4	0	0	4	0	0
17	45348616	.	T	C	1	2	3	0	0	3	0	0
17	45349061	.	T	A	2	2	4	0	0	4	0	0
17	45349518	.	G	T	1	3	4	0	0	4	0	0
17	45350779	.	G	A	1	2	3	0	0	3	0	0
17	45350802	.	G	T	0	2	2	0	1	3	0	0
17	45362270	.	T	C	2	2	4	0	0	4	0	0
17	45362352	.	G	A	1	3	4	0	0	4	0	0
17	45363768	.	C	T	0	2	2	0	0	2	0	0
17	45402558	.	G	A	1	4	5	0	0	5	0	0
17	45458154	.	C	G	6	0	6	0	3	9	0	0
17	45458838	.	T	C	4	2	6	0	0	6	0	0
17	45474994	.	A	G	0	2	2	0	3	5	0	0
17	45476850	.	C	T	3	2	5	0	0	5	0	0
17	45476871	.	G	A	1	2	3	0	0	3	0	0
17	45481934	.	G	T	1	2	3	0	0	3	0	0
17	45481935	.	A	C	1	2	3	0	0	3	0	0
17	45482377	.	T	C	3	2	5	0	1	6	0	0
17	45482409	.	C	T	6	2	8	0	0	8	0	0
17	45482537	.	C	G	2	3	5	0	0	5	0	0
17	45532532	.	T	A	22	15	37	0	1	38	0	0
17	45532637	.	A	T	17	15	32	0	0	32	0	0
17	45639367	.	G	A	0	4	4	0	3	7	0	0
17	45639926	.	C	A	1	2	3	0	1	4	0	0
17	45731991	.	T	C	3	6	9	0	0	9	0	0
17	45732147	.	T	C	10	14	24	0	0	24	0	0
17	45732173	.	C	T	0	15	15	0	11	26	0	0
17	45732327	.	G	A	16	9	25	0	0	25	0	0
17	45732601	.	G	A	2	3	5	0	0	5	0	0
17	45732765	.	A	T	9	8	17	0	1	18	0	0
17	45732785	.	T	C	10	11	21	0	2	23	0	0
17	45732802	.	G	T	10	14	24	0	0	24	0	0
17	45733537	.	A	G	1	3	4	0	0	4	0	0
17	45733664	.	G	A	2	7	9	0	0	9	0	0
17	45734170	.	A	G	0	0	0	0	1	1	0	0
17	45738138	.	A	G	2	3	5	0	0	5	0	0
17	45744187	.	C	T	0	2	2	0	0	2	0	0
17	45748014	.	A	G	2	0	2	0	3	5	0	0
17	45748623	.	C	T	3	2	5	0	0	5	0	0
17	45748674	.	A	G	1	3	4	0	0	4	0	0
17	45748701	.	T	A	1	0	1	0	0	1	0	0
17	45750485	.	C	T	2	0	2	0	0	2	0	0
17	45751385	.	C	T	3	7	10	0	0	10	0	0
17	45751404	.	T	C	5	1	6	0	1	7	0	0
17	45756547	.	C	T	6	4	10	0	0	10	0	0
17	45756610	.	T	C	5	3	8	0	0	8	0	0
17	45759087	.	C	T	5	6	11	0	1	12	0	0
17	45765222	.	C	T	3	1	4	0	0	4	0	0
17	45765234	.	G	A	2	1	3	0	0	3	0	0
17	45981067	.	C	T	1	2	3	0	0	3	0	0
17	45981984	.	G	A	1	6	7	0	0	7	0	0
17	45982478	.	C	G	1	0	1	0	2	3	0	0
17	45983269	.	C	T	1	2	3	0	0	3	0	0
17	45983392	.	G	A	2	3	5	0	1	6	0	0
17	45983410	.	C	T	2	4	6	0	1	7	0	0
17	45984415	.	A	G	3	0	3	0	2	5	0	0
17	45984465	.	G	T	0	4	4	0	4	8	0	0
17	45987075	.	G	A	0	2	2	0	0	2	0	0
17	45987120	.	C	T	2	4	6	0	0	6	0	0
17	45987143	.	A	T	3	3	6	0	0	6	0	0
17	45987629	.	A	T	1	2	3	0	0	3	0	0
17	45988188	.	A	G	5	0	5	0	6	11	0	0
17	45988446	.	G	A	0	2	2	0	1	3	0	0
17	46387226	.	C	A	3	1	4	0	0	4	0	0
17	46387253	.	G	T	0	2	2	0	2	4	0	0
17	46387291	.	C	A	6	4	10	0	1	11	0	0
17	46402526	.	A	G	2	0	2	0	2	4	0	0
17	46439098	.	G	A	1	0	1	0	0	1	0	0
17	46439102	.	C	T	2	0	2	0	0	2	0	0
17	46439186	.	A	G	2	2	4	0	0	4	0	0
17	47140969	.	G	A	0	2	2	0	3	5	0	0
17	47164815	.	G	A	0	2	2	0	4	6	0	0
17	47169612	.	A	T	3	1	4	0	0	4	0	0
17	47169660	.	G	C	0	3	3	0	4	7	0	0
17	47175456	.	G	A	3	4	7	0	0	7	0	0
17	47175569	.	G	A	3	8	11	0	0	11	0	0
17	47188778	.	G	A	3	2	5	0	1	6	0	0
17	47188800	.	T	A	7	2	9	0	0	9	0	0
17	47188932	.	C	T	0	11	11	0	3	14	0	0
17	47188984	.	G	A	10	4	14	0	0	14	0	0
17	47189025	.	C	A	2	9	11	0	0	11	0	0
17	47189129	.	C	A	7	3	10	0	0	10	0	0
17	47189221	.	C	T	4	5	9	0	0	9	0	0
17	47189243	.	T	C	5	5	10	0	0	10	0	0
17	47189258	.	G	T	4	7	11	0	0	11	0	0
17	47189283	.	A	T	6	4	10	0	0	10	0	0
17	47189684	.	G	A	11	9	20	0	0	20	0	0
17	47189725	.	G	A	6	8	14	0	0	14	0	0
17	47189741	.	G	T	8	5	13	0	0	13	0	0
17	47189765	.	G	T	5	3	8	0	0	9	1	0
17	47189937	.	T	A	8	7	15	0	2	17	0	0
17	47190941	.	G	T	4	7	11	0	0	11	0	0
17	47191891	.	T	C	1	6	7	0	0	7	0	0
17	47192178	.	C	T	2	5	7	0	0	7	0	0
17	47192332	.	T	C	1	4	5	1	0	6	0	0
17	47192392	.	C	A	1	4	5	0	0	5	0	0
17	47192755	.	C	T	5	4	9	0	0	9	0	0
17	47192766	.	C	T	5	4	9	0	0	9	0	0
17	47193180	.	T	A	3	2	5	0	0	5	0	0
17	47193200	.	A	G	3	2	5	0	0	5	0	0
17	47193313	.	T	C	2	5	7	0	0	7	0	0
17	47193692	.	C	T	6	7	13	0	0	13	0	0
17	47193857	.	T	C	5	0	5	0	5	10	0	0
17	47193902	.	C	T	0	8	8	0	4	12	0	0
17	47193995	.	T	C	5	3	8	0	0	8	0	0
17	47196584	.	T	G	2	1	3	0	0	3	0	0
17	47196587	.	G	A	2	1	3	0	0	3	0	0
17	48138525	.	G	A	0	1	1	0	0	1	0	0
17	48139415	.	C	T	1	2	3	0	1	4	0	0
17	48139427	.	T	C	2	2	4	0	0	4	0	0
17	48156580	.	C	T	2	6	8	0	0	8	0	0
17	48156631	.	G	A	3	7	10	0	0	10	0	0
17	48831725	.	C	T	1	2	3	0	0	3	0	0
17	48853270	.	C	T	0	1	1	0	0	1	0	0
17	48883751	.	A	G	1	2	3	0	0	3	0	0
17	48883763	.	C	T	2	0	2	0	0	2	0	0
17	48890549	.	A	C	1	0	1	0	0	1	0	0
17	48892732	.	T	C	3	3	6	0	0	6	0	0
17	48908911	.	A	G	0	4	4	0	0	4	0	0
17	48911097	.	T	G	2	7	9	0	0	9	0	0
17	48915387	.	A	T	0	5	5	0	1	6	0	0
17	48922267	.	T	A	1	2	3	0	0	3	0	0
17	48926655	.	G	A	2	4	6	0	0	6	0	0
17	48965350	.	T	G	6	0	6	0	4	10	0	0
17	49003651	.	A	G	3	3	6	0	1	7	0	0
17	49010678	.	T	C	3	5	8	0	0	8	0	0
17	49010727	.	T	C	5	5	10	0	0	10	0	0
17	49011174	.	A	G	6	6	12	0	0	12	0	0
17	49011177	.	C	A	6	7	13	0	0	13	0	0
17	49016534	.	C	T	4	9	13	0	0	13	0	0
17	49018224	.	G	A	0	8	8	0	8	16	0	0
17	49018508	.	C	G	11	11	22	0	0	22	0	0
17	49018575	.	G	A	6	7	13	0	0	13	0	0
17	49019177	.	C	A	8	20	28	0	0	28	0	0
17	49105252	.	C	A	1	2	3	0	0	3	0	0
17	49105391	.	C	T	1	2	3	0	0	3	0	0
17	49105399	.	C	T	1	1	2	0	0	2	0	0
17	49294912	.	A	G	1	3	4	0	0	4	0	0
17	49294960	.	T	C	1	3	4	0	0	4	0	0
17	49300008	.	T	C	1	1	2	0	0	2	0	0
17	49300392	.	C	T	3	3	6	0	0	6	0	0
17	49306256	.	C	T	11	5	16	0	0	16	0	0
17	49306341	.	T	C	5	2	7	0	1	8	0	0
17	49331860	.	A	G	1	1	2	0	0	2	0	0
17	49354484	.	G	A	1	1	2	0	0	2	0	0
17	49354485	.	A	T	1	1	2	0	0	2	0	0
17	49416044	.	T	G	7	5	12	0	0	12	0	0
17	49416151	.	T	C	5	0	5	0	6	11	0	0
17	49416259	.	T	C	7	0	7	0	5	12	0	0
17	49416327	.	T	C	10	6	16	0	0	16	0	0
17	49416992	.	G	A	3	7	10	0	0	10	0	0
17	49417137	.	C	T	3	6	9	0	0	9	0	0
17	49417148	.	A	T	3	6	9	0	0	9	0	0
17	49417414	.	T	A	7	12	19	0	2	21	0	0
17	49417569	.	T	C	5	7	12	0	1	13	0	0
17	49417599	.	G	C	6	4	10	0	0	10	0	0
17	49417835	.	G	A	10	7	17	0	0	17	0	0
17	49417838	.	A	G	11	6	17	0	1	18	0	0
17	49417961	.	A	C	4	4	8	0	0	8	0	0
17	49417974	.	C	A	3	4	7	0	0	7	0	0
17	49418122	.	C	G	2	5	7	0	0	7	0	0
17	49419410	.	T	C	2	3	5	0	0	5	0	0
17	49419761	.	G	T	5	5	10	0	0	10	0	0
17	49419887	.	C	T	0	6	6	0	5	11	0	0
17	49420049	.	T	G	6	4	10	0	0	10	0	0
17	49420565	.	A	C	4	0	4	0	5	9	0	0
17	49420655	.	A	C	2	1	3	0	0	3	0	0
17	49420677	.	G	A	3	4	7	0	1	8	0	0
17	49420727	.	C	A	0	10	10	0	3	13	0	0
17	49421141	.	A	G	1	4	5	0	0	5	0	0
17	49421751	.	C	A	4	1	5	0	0	5	0	0
17	49425030	.	G	A	1	0	1	0	0	1	0	0
17	49429844	.	T	C	2	6	8	0	0	8	0	0
17	49429877	.	C	T	2	6	8	0	0	8	0	0
17	49434723	.	T	C	1	0	1	0	0	1	0	0
17	49438631	.	G	A	1	6	7	0	0	7	0	0
17	49527588	.	A	G	3	1	4	0	0	4	0	0
17	49632492	.	A	G	3	3	6	0	0	6	0	0
17	49635656	.	C	T	3	4	7	0	0	7	0	0
17	49637421	.	T	A	2	2	4	0	0	4	0	0
17	49640957	.	A	G	3	6	9	0	0	9	0	0
17	49640986	.	C	G	3	7	10	0	0	10	0	0
17	49641046	.	C	A	3	8	11	0	0	11	0	0
17	49641629	.	C	T	1	4	5	0	1	6	0	0
17	49641698	.	T	C	3	3	6	0	0	6	0	0
17	49785789	.	A	G	3	4	7	0	0	7	0	0
17	49789953	.	T	G	1	4	5	0	0	5	0	0
17	49983202	.	A	T	8	6	14	0	0	14	0	0
17	49983273	.	C	T	20	30	50	0	1	51	0	0
17	49987618	.	A	T	6	9	15	0	0	15	0	0
17	49992629	.	G	A	12	10	22	0	0	22	0	0
17	49998167	.	C	T	11	11	22	0	1	23	0	0
17	49998221	.	G	A	18	12	30	0	0	30	0	0
17	49998591	.	T	G	6	6	12	0	0	12	0	0
17	49998804	.	C	A	20	20	40	0	2	42	0	0
17	49998995	.	G	C	32	0	32	0	6	38	0	0
17	49999037	.	G	T	19	20	39	0	1	40	0	0
17	50002381	.	A	G	20	23	43	0	0	43	0	0
17	50010011	.	A	G	22	15	37	0	0	37	0	0
17	50010024	.	G	C	21	17	38	0	0	38	0	0
17	50074447	.	A	G	1	1	2	0	1	3	0	0
17	50084344	.	T	C	3	2	5	0	0	5	0	0
17	50099976	.	T	C	2	2	4	0	0	4	0	0
17	50099985	.	A	C	2	1	3	0	1	4	0	0
17	50107391	.	G	A	1	0	1	0	0	1	0	0
17	50110192	.	C	A	2	3	5	0	0	5	0	0
17	50110255	.	G	C	1	4	5	0	0	5	0	0
17	50110304	.	T	A	3	4	7	0	1	8	0	0
17	50110442	.	C	T	4	6	10	0	0	10	0	0
17	50110517	.	G	A	1	2	3	0	8	11	0	0
17	50110574	.	A	G	2	0	2	0	2	4	0	0
17	50110613	.	C	T	3	2	5	0	0	5	0	0
17	50110636	.	C	A	2	3	5	0	0	5	0	0
17	50110862	.	T	A	0	3	3	0	0	3	0	0
17	50111397	.	A	G	2	7	9	0	2	11	0	0
17	50111406	.	G	A	5	8	13	0	0	13	0	0
17	50111479	.	T	A	2	12	14	0	0	14	0	0
17	50111497	.	A	G	4	1	5	0	12	17	0	0
17	50111528	.	A	G	10	3	13	0	0	13	0	0
17	50111718	.	T	G	6	3	9	0	0	9	0	0
17	50112112	.	T	G	0	6	6	0	0	6	0	0
17	50112440	.	T	C	0	2	2	0	0	2	0	0
17	50112455	.	G	A	0	1	1	0	0	1	0	0
17	50113141	.	G	A	4	7	11	0	0	11	0	0
17	50113336	.	C	T	4	5	9	0	1	10	0	0
17	50141766	.	T	A	7	3	10	0	0	10	0	0
17	50171937	.	T	C	1	6	7	0	0	7	0	0
17	50176061	.	G	A	1	1	2	0	0	2	0	0
17	50176139	.	T	C	4	2	6	0	3	9	0	0
17	50176519	.	C	A	3	3	6	0	0	6	0	0
17	50178553	.	G	C	2	2	4	0	1	5	0	0
17	50180672	.	C	T	3	2	5	0	0	5	0	0
17	50185659	.	C	A	8	14	22	0	0	22	0	0
17	50185665	.	T	A	15	10	25	0	0	25	0	0
17	50185831	.	C	A	10	11	21	0	2	23	0	0
17	50185930	.	T	C	10	11	21	0	0	21	0	0
17	50186011	.	G	A	0	5	5	0	11	16	0	0
17	50186041	.	T	A	8	3	11	0	0	11	0	0
17	50186097	.	G	A	4	6	10	0	0	10	0	0
17	50229337	.	A	G	14	7	21	0	0	21	0	0
17	50229409	.	T	C	10	5	15	0	0	15	0	0
17	50233858	.	C	A	1	9	10	0	10	20	0	0
17	50233869	.	G	T	10	13	23	0	0	23	0	0
17	50245400	.	G	A	6	3	9	0	0	9	0	0
17	50245673	.	T	C	25	10	35	0	1	36	0	0
17	50245715	.	C	G	11	29	40	0	0	40	0	0
17	50247886	.	T	C	0	0	0	0	2	2	0	0
17	50284899	.	T	A	9	14	23	0	1	24	0	0
17	50284935	.	A	T	15	12	27	0	2	29	0	0
17	50285009	.	A	T	6	5	11	0	0	11	0	0
17	50285221	.	A	T	4	9	13	0	0	13	0	0
17	50472868	.	C	T	0	2	2	0	0	2	0	0
17	50840514	.	A	G	1	7	8	0	1	9	0	0
17	51206396	.	G	A	10	12	22	0	2	24	0	0
17	51206825	.	T	C	13	0	13	0	13	26	0	0
17	51206951	.	T	A	7	12	19	0	1	20	0	0
17	51207200	.	G	C	12	7	19	0	0	19	0	0
17	51209442	.	G	A	4	5	9	0	0	9	0	0
17	51213963	.	C	T	1	2	3	0	0	3	0	0
17	51214185	.	C	T	3	5	8	0	0	8	0	0
17	51214302	.	C	T	2	5	7	0	0	7	0	0
17	51218418	.	G	A	6	2	8	0	0	8	0	0
17	51224484	.	G	A	0	6	6	0	9	15	0	0
17	51226592	.	G	A	4	3	7	0	0	7	0	0
17	51226879	.	C	T	2	4	6	0	1	7	0	0
17	51228936	.	G	A	6	8	14	0	0	14	0	0
17	51229009	.	G	T	2	3	5	0	0	5	0	0
17	51229135	.	T	A	1	2	3	0	0	3	0	0
17	51229206	.	C	T	2	3	5	0	0	5	0	0
17	51229397	.	C	A	4	2	6	0	0	6	0	0
17	51229413	.	T	C	4	3	7	0	1	8	0	0
17	51229451	.	A	G	4	2	6	0	0	6	0	0
17	51231538	.	T	C	5	8	13	0	0	13	0	0
17	51231649	.	T	C	6	2	8	0	0	8	0	0
17	51231980	.	T	C	4	4	8	0	0	8	0	0
17	51232437	.	T	C	3	2	5	0	0	5	0	0
17	51232759	.	C	T	0	13	13	0	17	30	0	0
17	51234540	.	A	C	2	0	2	0	2	4	0	0
17	51241185	.	G	A	1	3	4	0	0	4	0	0
17	51241203	.	C	T	2	1	3	0	2	5	0	0
17	51256927	.	C	T	0	5	5	0	3	8	0	0
17	51256933	.	C	G	2	6	8	0	1	9	0	0
17	51257013	.	A	G	4	3	7	0	0	7	0	0
17	51260362	.	G	C	2	5	7	0	0	7	0	0
17	51303112	.	C	T	6	5	11	0	0	11	0	0
17	51303130	.	G	A	0	8	8	0	10	18	0	0
17	51303241	.	G	A	4	5	9	0	0	9	0	0
17	51305422	.	A	T	11	14	25	0	0	25	0	0
17	51305458	.	G	C	8	9	17	0	0	17	0	0
17	51307706	.	G	A	5	14	19	0	1	20	0	0
17	51307871	.	A	G	8	1	9	0	8	17	0	0
17	51682501	.	T	A	2	2	4	0	0	4	0	0
17	51711040	.	A	G	7	4	11	0	0	11	0	0
17	51711184	.	C	A	6	5	11	0	0	11	0	0
17	51711194	.	C	A	5	6	11	0	0	11	0	0
17	51711268	.	G	A	0	0	0	0	1	1	0	0
17	51715641	.	G	A	0	1	1	0	0	1	0	0
17	51720176	.	C	T	4	4	8	0	1	9	0	0
17	51720177	.	A	T	3	3	6	0	3	9	0	0
17	51720710	.	A	G	3	0	3	0	3	6	0	0
17	51749545	.	G	T	0	8	8	0	6	14	0	0
17	51752790	.	A	G	5	4	9	0	1	10	0	0
17	51753138	.	T	G	0	3	3	0	0	3	0	0
17	51757010	.	G	A	6	5	11	0	1	12	0	0
17	51757380	.	T	G	4	5	9	0	0	9	0	0
17	51757387	.	A	T	2	4	6	0	2	8	0	0
17	51776369	.	C	T	4	2	6	0	0	6	0	0
17	51776388	.	G	C	3	2	5	0	0	5	0	0
17	51776636	.	T	G	1	2	3	0	0	3	0	0
17	51780543	.	G	A	1	1	2	0	0	2	0	0
17	51789032	.	G	A	4	6	10	0	0	10	0	0
17	51789038	.	T	C	3	6	9	0	0	9	0	0
17	51789069	.	T	C	2	5	7	0	1	8	0	0
17	51789079	.	T	G	2	0	2	0	6	8	0	0
17	51789137	.	A	T	2	3	5	0	0	5	0	0
17	51789731	.	A	G	2	2	4	0	0	4	0	0
17	51789746	.	C	T	2	3	5	0	0	5	0	0
17	51796837	.	A	G	2	3	5	0	0	5	0	0
17	51796843	.	A	T	2	3	5	0	0	5	0	0
17	51797004	.	G	A	2	6	8	0	0	8	0	0
17	51797015	.	T	C	2	1	3	0	6	9	0	0
17	51797145	.	A	G	3	3	6	0	0	6	0	0
17	51797223	.	G	A	3	2	5	0	0	5	0	0
17	51797333	.	A	G	2	3	5	0	0	5	0	0
17	51797782	.	C	T	9	5	14	0	2	16	0	0
17	51797788	.	T	A	9	6	15	0	2	17	0	0
17	51797863	.	G	A	8	10	18	0	1	19	0	0
17	51805764	.	T	G	2	0	2	0	0	2	0	0
17	51807494	.	G	A	0	1	1	0	0	1	0	0
17	51807539	.	T	A	3	4	7	0	0	7	0	0
17	51807545	.	G	A	4	5	9	0	0	9	0	0
17	51822481	.	G	A	2	4	6	0	0	6	0	0
17	51823012	.	G	C	2	0	2	0	7	9	0	0
17	51823042	.	A	G	4	6	10	0	0	10	0	0
17	51823073	.	A	C	6	4	10	0	0	10	0	0
17	51823152	.	A	G	4	4	8	0	0	8	0	0
17	51823483	.	C	T	9	7	16	0	0	16	0	0
17	51823568	.	G	A	12	4	16	0	1	17	0	0
17	51823617	.	G	T	12	3	15	0	0	15	0	0
17	51823841	.	C	A	1	7	8	0	2	10	0	0
17	51823857	.	T	C	5	3	8	0	1	9	0	0
17	51823995	.	A	T	1	5	6	0	0	6	0	0
17	51824046	.	C	T	9	5	14	0	0	14	0	0
17	51824061	.	G	A	8	5	13	0	0	13	0	0
17	51824081	.	A	C	4	9	13	0	1	14	0	0
17	51824306	.	T	C	1	4	5	3	0	8	0	0
17	51824790	.	T	C	3	5	8	0	2	10	0	0
17	51824981	.	T	C	4	2	6	0	1	7	0	0
17	51825059	.	A	T	4	4	8	0	0	8	0	0
17	51825086	.	A	G	3	7	10	0	1	11	0	0
17	51825094	.	G	A	4	6	10	0	1	11	0	0
17	51825138	.	C	T	0	8	8	0	4	12	0	0
17	51825161	.	T	C	4	5	9	0	1	10	0	0
17	51825205	.	T	G	5	6	11	0	0	11	0	0
17	51825225	.	T	C	4	6	10	0	1	11	0	0
17	51825421	.	T	G	2	3	5	0	1	6	0	0
17	51825576	.	A	C	7	1	8	0	5	13	0	0
17	51825969	.	A	T	7	6	13	0	2	15	0	0
17	51826025	.	G	T	4	5	9	0	1	10	0	0
17	51826035	.	C	T	4	5	9	0	2	11	0	0
17	51826062	.	G	T	5	6	11	0	0	11	0	0
17	51826088	.	A	G	6	8	14	0	2	16	0	0
17	51826149	.	A	C	5	0	5	0	11	16	0	0
17	51826172	.	T	C	3	0	3	0	11	14	0	0
17	51832999	.	G	A	2	5	7	0	0	7	0	0
17	52036863	.	G	A	3	2	5	0	0	5	0	0
17	52059149	.	T	C	0	1	1	0	4	5	0	0
17	52063114	.	G	T	2	4	6	0	1	7	0	0
17	52359040	.	G	T	0	2	2	0	1	3	0	0
17	52385779	.	C	T	1	4	5	0	0	5	0	0
17	52386018	.	A	G	4	0	4	0	4	8	0	0
17	52574077	.	G	A	0	5	5	0	0	5	0	0
17	52840328	.	A	C	14	16	30	0	1	31	0	0
17	52856614	.	T	C	9	14	23	0	4	27	0	0
17	52919954	.	C	T	22	29	51	0	0	51	0	0
17	52920291	.	A	T	18	21	39	0	3	42	0	0
17	52920588	.	A	G	16	0	16	0	10	26	0	0
17	52940864	.	C	T	0	2	2	0	3	5	0	0
17	53364109	.	T	C	1	4	5	0	0	5	0	0
17	53364111	.	T	C	1	4	5	0	0	5	0	0
18	1689	.	A	C	17	10	27	0	0	27	0	0
18	1983	.	T	C	4	1	5	0	1	6	0	0
18	9214	.	G	A	2	0	2	0	0	2	0	0
18	11295	.	A	G	6	7	13	0	2	15	0	0
18	17639	.	G	A	5	1	6	0	1	7	0	0
18	17786	.	G	A	4	2	6	0	1	7	0	0
18	17795	.	G	A	6	6	12	0	0	12	0	0
18	18606	.	T	A	4	2	6	0	0	6	0	0
18	22746	.	A	G	10	5	15	0	0	15	0	0
18	22891	.	G	A	3	0	3	0	0	3	0	0
18	54502	.	C	T	1	3	4	0	1	5	0	0
18	54600	.	C	T	2	4	6	0	0	6	0	0
18	58631	.	C	T	0	0	0	0	1	1	0	0
18	73714	.	C	G	15	4	19	0	0	19	0	0
18	73740	.	A	C	18	0	18	0	7	25	0	0
18	73839	.	A	G	7	1	8	0	0	8	0	0
18	74095	.	T	C	4	3	7	0	1	8	0	0
18	74112	.	T	C	1	4	5	0	0	5	0	0
18	74994	.	A	G	6	4	10	0	0	10	0	0
18	82705	.	C	T	7	11	18	1	0	19	0	0
18	97789	.	C	T	4	1	5	0	0	5	0	0
18	98622	.	G	A	3	4	7	0	1	8	0	0
18	100944	.	G	A	0	14	14	0	13	27	0	0
18	102350	.	T	G	9	1	10	0	16	26	0	0
18	102353	.	A	G	10	15	25	0	1	26	0	0
18	103101	.	G	C	0	1	1	0	1	2	0	0
18	104405	.	G	A	0	3	3	0	2	5	0	0
18	106814	.	T	C	6	15	21	0	0	21	0	0
18	107015	.	T	C	11	12	23	0	2	25	0	0
18	107135	.	A	T	7	17	24	0	1	25	0	0
18	107345	.	A	G	13	0	13	0	26	39	0	0
18	114089	.	A	C	9	8	17	0	0	17	0	0
18	114502	.	T	C	1	0	1	0	7	8	0	0
18	114713	.	A	T	8	3	11	0	0	11	0	0
18	117788	.	G	A	5	6	11	0	1	12	0	0
18	118729	.	G	A	9	6	15	0	0	15	0	0
18	118912	.	G	A	4	5	9	0	0	9	0	0
18	127438	.	G	A	6	7	13	0	0	13	0	0
18	127444	.	A	G	6	6	12	0	0	12	0	0
18	127678	.	A	G	1	3	4	0	0	4	0	0
18	131065	.	T	C	1	0	1	0	4	5	0	0
18	131092	.	C	T	0	6	6	0	2	8	0	0
18	137781	.	A	G	1	1	2	0	0	2	0	0
18	139365	.	A	G	1	2	3	0	0	3	0	0
18	144447	.	G	A	5	4	9	0	0	9	0	0
18	146940	.	C	A	3	2	5	0	0	5	0	0
18	173660	.	C	T	10	7	17	0	2	19	0	0
18	173694	.	C	T	11	6	17	0	0	17	0	0
18	173903	.	C	A	7	15	22	0	0	22	0	0
18	184917	.	T	C	3	4	7	0	1	8	0	0
18	193689	.	A	C	7	13	20	0	1	21	0	0
18	193982	.	C	T	17	5	22	0	0	22	0	0
18	194006	.	A	G	15	0	15	0	8	23	0	0
18	194078	.	C	T	15	19	34	0	0	34	0	0
18	194162	.	G	C	1	23	24	0	18	42	0	0
18	194318	.	A	G	6	9	15	0	3	18	0	0
18	194460	.	C	G	4	8	12	0	0	12	0	0
18	194464	.	C	T	4	8	12	0	0	12	0	0
18	194799	.	T	C	5	4	9	0	0	9	0	0
18	204828	.	G	A	16	14	30	0	0	30	0	0
18	204866	.	T	A	15	18	33	0	4	37	0	0
18	204980	.	C	T	26	11	37	0	1	38	0	0
18	204982	.	G	A	25	11	36	0	2	38	0	0
18	205095	.	C	T	0	20	20	0	19	39	0	0
18	205105	.	A	G	17	17	34	0	2	36	0	0
18	205152	.	G	A	22	8	30	0	1	31	0	0
18	205179	.	G	A	21	15	36	0	1	37	0	0
18	207172	.	T	C	3	1	4	0	0	4	0	0
18	207184	.	G	A	4	2	6	0	1	7	0	0
18	207314	.	T	A	0	1	1	0	0	1	0	0
18	209114	.	G	A	16	10	26	0	1	27	0	0
18	209118	.	A	G	14	12	26	0	1	27	0	0
18	209321	.	T	G	2	1	3	0	0	3	0	0
18	209382	.	A	G	4	3	7	0	0	7	0	0
18	210385	.	T	A	26	9	35	0	2	37	0	0
18	210899	.	T	A	2	4	6	0	0	6	0	0
18	211101	.	G	A	5	6	11	0	0	11	0	0
18	211186	.	T	A	21	14	35	0	0	35	0	0
18	211304	.	T	C	16	0	16	0	8	24	0	0
18	211346	.	C	T	0	12	12	0	11	23	0	0
18	211380	.	G	A	13	21	34	0	1	35	0	0
18	211399	.	T	C	13	21	34	0	1	35	0	0
18	211438	.	T	A	9	12	21	0	1	22	0	0
18	211469	.	C	A	7	7	14	0	0	14	0	0
18	211483	.	A	T	10	9	19	0	0	19	0	0
18	211605	.	A	G	10	15	25	0	0	25	0	0
18	211610	.	T	C	10	0	10	0	16	26	0	0
18	211812	.	T	A	7	6	13	0	0	13	0	0
18	212305	.	A	G	27	4	31	0	0	31	0	0
18	214688	.	A	G	7	4	11	0	0	11	0	0
18	214717	.	T	C	9	4	13	0	1	14	0	0
18	216775	.	G	A	1	4	5	0	0	5	0	0
18	216779	.	G	A	2	6	8	0	0	8	0	0
18	220144	.	G	A	9	9	18	0	2	20	0	0
18	222448	.	T	C	2	0	2	0	1	3	0	0
18	298740	.	C	T	1	3	4	0	0	4	0	0
18	302902	.	C	T	10	9	19	0	0	19	0	0
18	303136	.	G	T	0	1	1	0	3	4	0	0
18	316039	.	C	T	17	10	27	0	1	28	0	0
18	318601	.	G	A	1	1	2	0	0	2	0	0
18	318821	.	T	C	11	14	25	0	0	25	0	0
18	318824	.	C	T	11	13	24	0	1	25	0	0
18	321802	.	T	C	8	7	15	0	3	18	0	0
18	321820	.	C	T	8	9	17	0	1	18	0	0
18	321934	.	C	T	4	5	9	0	1	10	0	0
18	323840	.	G	A	0	4	4	0	7	11	0	0
18	324190	.	T	C	4	5	9	0	2	11	0	0
18	324243	.	G	A	4	7	11	0	1	12	0	0
18	324317	.	G	A	6	5	11	0	0	11	0	0
18	324325	.	A	G	7	4	11	0	1	12	0	0
18	324380	.	T	G	10	4	14	0	0	14	0	0
18	324409	.	C	T	8	11	19	0	0	19	0	0
18	324465	.	T	C	14	8	22	0	0	22	0	0
18	324692	.	A	T	9	11	20	0	0	20	0	0
18	324834	.	T	G	16	1	17	0	10	27	0	0
18	324835	.	G	T	16	11	27	0	0	27	0	0
18	325044	.	A	G	12	14	26	0	2	28	0	0
18	325189	.	C	T	17	17	34	0	1	35	0	0
18	325290	.	G	A	0	13	13	0	23	36	0	0
18	325407	.	T	G	8	16	24	0	0	24	0	0
18	328733	.	A	G	8	4	12	0	0	12	0	0
18	328795	.	G	C	12	12	24	0	1	25	0	0
18	330474	.	A	G	4	10	14	0	0	14	0	0
18	333765	.	T	C	11	5	16	0	2	18	0	0
18	334018	.	C	T	2	11	13	0	1	14	0	0
18	334049	.	A	T	3	12	15	0	1	16	0	0
18	334152	.	T	C	4	5	9	0	0	9	0	0
18	334163	.	T	C	4	4	8	0	0	8	0	0
18	334239	.	T	C	3	2	5	0	1	6	0	0
18	334248	.	T	C	2	3	5	0	1	6	0	0
18	334431	.	T	G	5	2	7	0	1	8	0	0
18	334560	.	T	C	1	4	5	0	0	5	0	0
18	334634	.	G	A	2	6	8	0	0	8	0	0
18	334872	.	C	T	0	3	3	0	6	9	0	0
18	336212	.	A	C	1	2	3	0	2	5	0	0
18	336607	.	T	G	11	8	19	0	1	20	0	0
18	344332	.	G	A	4	4	8	0	2	10	0	0
18	344388	.	T	G	4	5	9	0	0	9	0	0
18	344437	.	C	A	0	2	2	0	2	4	0	0
18	358240	.	C	G	0	1	1	0	3	4	0	0
18	370129	.	C	T	0	3	3	0	1	4	0	0
18	422944	.	C	T	1	0	1	0	0	1	0	0
18	422953	.	C	T	0	1	1	0	0	1	0	0
18	422992	.	G	A	0	0	0	0	1	1	0	0
18	789974	.	T	A	9	11	20	0	1	21	0	0
18	790247	.	T	C	9	10	19	0	0	19	0	0
18	790301	.	T	A	10	7	17	0	2	19	0	0
18	790451	.	T	G	14	2	16	0	11	27	0	0
18	790962	.	T	G	10	5	15	0	6	21	0	0
18	791069	.	A	G	6	0	6	0	9	15	0	0
18	791076	.	G	C	6	8	14	0	0	14	0	0
18	791137	.	T	A	3	4	7	0	0	7	0	0
18	791171	.	G	C	2	10	12	0	0	12	0	0
18	791246	.	G	A	10	10	20	0	0	20	0	0
18	791348	.	T	A	6	5	11	0	2	13	0	0
18	791350	.	T	A	6	7	13	0	0	13	0	0
18	791449	.	T	G	3	4	7	0	1	8	0	0
18	791582	.	G	A	0	5	5	0	5	10	0	0
18	809012	.	G	T	20	12	32	0	3	35	0	0
18	824921	.	G	A	0	1	1	0	0	1	0	0
18	824994	.	G	A	1	2	3	0	0	3	0	0
18	824998	.	C	T	1	2	3	0	0	3	0	0
18	825078	.	A	T	1	5	6	0	0	6	0	0
18	826116	.	G	A	6	3	9	0	0	9	0	0
18	826190	.	A	T	3	9	12	0	1	13	0	0
18	826574	.	C	T	0	6	6	0	1	7	0	0
18	826745	.	G	A	3	5	8	0	0	8	0	0
18	826749	.	T	A	2	5	7	0	0	7	0	0
18	2171623	.	C	T	0	1	1	0	0	1	0	0
18	2180636	.	C	T	2	4	6	0	0	6	0	0
18	2189335	.	C	T	1	2	3	0	0	3	0	0
18	2197638	.	A	C	3	5	8	0	1	9	0	0
18	2214873	.	A	G	3	2	5	0	0	5	0	0
18	2225862	.	A	C	5	4	9	0	0	9	0	0
18	2377216	.	T	C	3	5	8	0	0	8	0	0
18	2377241	.	A	C	5	3	8	0	0	8	0	0
18	2377338	.	T	A	6	7	13	0	1	14	0	0
18	2377413	.	C	T	13	7	20	0	0	20	0	0
18	2377486	.	A	T	2	3	5	0	0	5	0	0
18	2377516	.	A	G	3	3	6	1	0	7	0	0
18	2377566	.	A	G	4	7	11	1	0	12	0	0
18	2377582	.	G	T	4	9	13	0	1	14	0	0
18	2377645	.	T	C	4	0	4	0	13	17	0	0
18	2377700	.	C	T	0	10	10	0	5	15	0	0
18	2377714	.	A	G	6	13	19	0	1	20	0	0
18	2377768	.	G	A	8	15	23	0	1	24	0	0
18	2377775	.	C	T	7	13	20	0	2	22	0	0
18	2378462	.	A	T	3	2	5	0	0	5	0	0
18	2378510	.	C	A	1	4	5	0	0	5	0	0
18	2378542	.	G	C	4	3	7	0	0	7	0	0
18	2378568	.	T	A	4	3	7	0	0	7	0	0
18	2378713	.	T	G	8	11	19	0	0	20	1	0
18	2683985	.	T	C	2	6	8	0	2	10	0	0
18	2684306	.	T	C	7	0	7	0	4	11	0	0
18	2684324	.	T	C	8	6	14	0	0	14	0	0
18	5170063	.	A	G	24	15	39	0	3	42	0	0
18	5170069	.	A	G	12	1	13	0	31	45	1	0
18	5234937	.	C	A	0	13	13	0	14	27	0	0
18	5234990	.	T	G	10	8	18	0	1	19	0	0
18	5242329	.	G	A	9	6	15	0	1	16	0	0
18	5243234	.	A	G	5	5	10	0	0	10	0	0
18	5243255	.	T	C	6	5	11	0	0	11	0	0
18	5244632	.	G	A	2	2	4	0	1	5	0	0
18	5244986	.	G	A	5	2	7	0	0	7	0	0
18	5245467	.	G	A	4	3	7	0	0	7	0	0
18	5245806	.	T	C	11	14	25	0	1	26	0	0
18	5245818	.	C	T	0	12	12	0	13	25	0	0
18	5308441	.	T	G	3	4	7	0	2	9	0	0
18	5316537	.	A	G	5	8	13	0	0	13	0	0
18	5316575	.	C	T	4	3	7	0	0	7	0	0
18	5316708	.	C	G	4	2	6	0	1	7	0	0
18	5318809	.	G	T	5	2	7	0	0	7	0	0
18	5318833	.	G	A	2	4	6	0	0	6	0	0
18	5375143	.	A	G	5	4	9	0	1	10	0	0
18	5378093	.	C	A	0	1	1	0	0	1	0	0
18	5454381	.	G	A	7	4	11	0	0	11	0	0
18	5455161	.	C	T	5	4	9	0	0	9	0	0
18	5455347	.	G	T	0	2	2	0	2	4	0	0
18	5456883	.	C	T	2	7	9	0	0	9	0	0
18	5456940	.	G	A	1	3	4	0	0	4	0	0
18	5491697	.	G	A	6	8	14	0	0	14	0	0
18	5494980	.	A	G	1	8	9	0	1	10	0	0
18	5495903	.	T	C	7	23	30	0	4	34	0	0
18	5506578	.	C	T	2	3	5	0	1	6	0	0
18	5509426	.	G	C	3	2	5	0	0	5	0	0
18	5514321	.	T	G	2	3	5	0	0	5	0	0
18	5514544	.	T	A	11	8	19	0	1	20	0	0
18	5514678	.	G	A	0	4	4	0	13	17	0	0
18	5516320	.	C	T	2	2	4	0	0	4	0	0
18	5517046	.	A	G	6	2	8	0	3	11	0	0
18	5518108	.	C	T	6	3	9	0	0	9	0	0
18	5518128	.	T	C	1	1	2	0	0	2	0	0
18	5518749	.	T	C	7	4	11	0	0	11	0	0
18	5518809	.	T	G	8	4	12	0	1	13	0	0
18	5519052	.	C	T	5	2	7	0	2	9	0	0
18	5519119	.	A	G	5	3	8	0	0	8	0	0
18	5519269	.	T	C	8	6	14	0	0	14	0	0
18	5519534	.	T	A	3	3	6	0	1	7	0	0
18	5519622	.	G	A	0	5	5	0	5	10	0	0
18	5519776	.	T	A	4	4	8	0	1	9	0	0
18	5533186	.	A	C	7	0	7	0	9	16	0	0
18	5534295	.	T	C	2	0	2	0	4	6	0	0
18	5535127	.	C	T	1	0	1	0	0	1	0	0
18	5535203	.	C	T	0	3	3	0	4	7	0	0
18	5535243	.	G	A	0	2	2	0	0	2	0	0
18	5537129	.	G	C	2	1	3	0	2	5	0	0
18	5537138	.	C	T	3	2	5	0	0	5	0	0
18	5537255	.	T	C	2	7	9	0	1	10	0	0
18	5537530	.	A	G	4	3	7	0	0	7	0	0
18	5539488	.	T	C	2	0	2	0	2	4	0	0
18	5539517	.	T	C	1	0	1	0	4	5	0	0
18	5619919	.	G	A	0	5	5	0	4	9	0	0
18	5619922	.	G	A	4	4	8	0	1	9	0	0
18	5624614	.	A	G	5	2	7	0	0	7	0	0
18	5624654	.	T	A	9	8	17	0	0	17	0	0
18	5626583	.	G	A	2	2	4	0	0	4	0	0
18	5626661	.	A	C	0	2	2	0	1	3	0	0
18	5692205	.	A	G	9	13	22	0	0	22	0	0
18	5692222	.	A	T	7	10	17	0	0	17	0	0
18	6868454	.	A	G	18	5	23	0	0	23	0	0
18	7015600	.	T	C	3	3	6	0	0	6	0	0
18	7553113	.	C	A	2	2	4	0	0	4	0	0
18	7571381	.	C	T	2	4	6	0	0	6	0	0
18	7571412	.	A	G	3	3	6	0	1	7	0	0
18	7571548	.	T	C	2	5	7	0	0	7	0	0
18	7571628	.	C	T	2	10	12	0	1	13	0	0
18	11507028	.	T	G	2	4	6	0	0	6	0	0
18	11507253	.	T	G	6	4	10	0	0	10	0	0
18	11507263	.	G	A	4	6	10	0	0	10	0	0
18	11515830	.	C	T	4	4	8	0	0	8	0	0
18	11557169	.	C	T	1	2	3	0	0	3	0	0
18	11557178	.	T	C	1	2	3	0	0	3	0	0
18	12036434	.	G	A	2	2	4	0	0	4	0	0
18	12058480	.	T	A	4	8	12	0	1	13	0	0
18	12105432	.	T	C	4	3	7	0	0	7	0	0
18	12105548	.	G	A	0	3	3	0	4	7	0	0
18	12111431	.	A	C	1	1	2	0	0	2	0	0
18	12111772	.	A	C	5	2	7	0	0	7	0	0
18	12111784	.	G	T	4	2	6	0	1	7	0	0
18	12112105	.	T	C	6	8	14	0	0	14	0	0
18	12112219	.	C	T	8	7	15	0	0	15	0	0
18	12112246	.	A	G	10	0	10	0	9	19	0	0
18	12112726	.	C	T	1	1	2	0	1	3	0	0
18	12112750	.	G	A	0	1	1	0	0	1	0	0
18	12113515	.	C	A	10	4	14	0	1	15	0	0
18	12113516	.	C	T	10	5	15	0	0	15	0	0
18	12148050	.	T	G	1	0	1	0	0	1	0	0
18	12171277	.	C	T	2	0	2	0	0	2	0	0
18	12171313	.	A	G	2	0	2	0	0	2	0	0
18	12196939	.	G	A	0	0	0	0	2	2	0	0
18	12207046	.	A	G	3	4	7	0	0	7	0	0
18	12207070	.	C	A	6	6	12	0	0	12	0	0
18	12214299	.	A	G	2	1	3	0	0	3	0	0
18	12228217	.	C	A	4	4	8	0	1	9	0	0
18	12228758	.	C	T	7	2	9	0	0	9	0	0
18	12228834	.	G	C	1	5	6	0	0	6	0	0
18	12229120	.	A	T	8	9	17	0	0	17	0	0
18	12229223	.	A	C	4	8	12	0	0	12	0	0
18	12229245	.	C	T	5	4	9	0	1	10	0	0
18	12229405	.	G	A	7	9	16	0	0	16	0	0
18	12236351	.	C	T	3	4	7	0	0	7	0	0
18	12238082	.	G	A	3	1	4	0	0	4	0	0
18	12240740	.	G	C	1	0	1	0	0	1	0	0
18	12242967	.	C	T	0	1	1	0	0	1	0	0
18	12248104	.	T	C	1	0	1	0	0	1	0	0
18	12249400	.	G	A	0	1	1	0	0	1	0	0
18	12251352	.	G	A	1	2	3	0	0	3	0	0
18	12254398	.	A	G	3	4	7	0	0	7	0	0
18	12254409	.	G	A	2	4	6	0	0	6	0	0
18	12254905	.	G	A	3	2	5	0	0	5	0	0
18	12255012	.	T	C	0	2	2	0	0	2	0	0
18	12256647	.	A	G	1	2	3	0	0	3	0	0
18	12264032	.	A	G	1	3	4	0	0	4	0	0
18	12264097	.	G	A	0	1	1	0	0	1	0	0
18	12265717	.	T	A	1	3	4	0	0	4	0	0
18	12265725	.	G	T	1	3	4	0	0	4	0	0
18	12276859	.	C	T	6	4	10	0	1	11	0	0
18	12277052	.	A	G	6	5	11	0	0	11	0	0
18	12277206	.	G	C	6	13	19	0	1	20	0	0
18	12277490	.	G	A	22	13	35	0	1	36	0	0
18	12280269	.	C	T	16	5	21	0	0	21	0	0
18	12292017	.	G	A	19	11	30	0	2	32	0	0
18	12327321	.	C	A	0	2	2	0	3	5	0	0
18	12364876	.	G	A	3	6	9	0	0	9	0	0
18	12366097	.	G	T	0	3	3	0	0	3	0	0
18	12370573	.	T	G	3	2	5	0	0	5	0	0
18	12374168	.	A	G	4	2	6	0	0	6	0	0
18	12406385	.	G	A	2	2	4	0	0	4	0	0
18	12409705	.	A	T	1	0	1	0	0	1	0	0
18	12416307	.	G	A	0	1	1	0	0	1	0	0
18	12416835	.	C	A	2	3	5	0	0	5	0	0
18	12416908	.	G	A	1	2	3	0	0	3	0	0
18	12465290	.	G	A	18	6	24	0	1	25	0	0
18	12465316	.	C	T	12	5	17	0	4	21	0	0
18	12467834	.	G	C	5	0	5	0	7	12	0	0
18	12470013	.	G	T	11	3	14	0	0	14	0	0
18	12470136	.	G	A	6	8	14	0	0	14	0	0
18	12470148	.	A	G	5	6	11	0	1	12	0	0
18	12470211	.	C	T	0	8	8	0	2	10	0	0
18	12471210	.	T	C	4	0	4	0	1	5	0	0
18	12471225	.	G	A	2	4	6	0	0	6	0	0
18	12612160	.	A	G	6	2	8	0	0	8	0	0
18	12653846	.	G	C	1	4	5	0	0	5	0	0
18	12659197	.	C	T	0	9	9	0	0	9	0	0
18	12659226	.	C	T	0	2	2	0	1	3	0	0
18	12776727	.	C	T	6	6	12	0	0	12	0	0
18	12779357	.	T	A	5	9	14	0	0	14	0	0
18	12828500	.	C	T	0	1	1	0	0	1	0	0
18	12833894	.	A	G	7	5	12	0	0	12	0	0
18	12839847	.	G	A	1	2	3	0	0	3	0	0
18	12845022	.	T	A	0	1	1	0	0	1	0	0
18	12845039	.	C	T	0	1	1	0	0	1	0	0
18	12850474	.	C	A	2	2	4	0	0	4	0	0
18	12871545	.	G	T	4	5	9	0	0	9	0	0
18	12871605	.	C	T	0	4	4	0	3	7	0	0
18	12871650	.	G	A	7	5	12	0	0	12	0	0
18	12907570	.	T	C	3	1	4	0	0	4	0	0
18	12949899	.	A	G	6	3	9	0	0	9	0	0
18	12949932	.	C	T	0	3	3	0	6	9	0	0
18	13063534	.	G	A	10	11	21	0	1	22	0	0
18	13102659	.	C	A	6	2	8	0	0	8	0	0
18	13124620	.	T	C	2	6	8	0	1	9	0	0
18	13124633	.	T	C	2	8	10	0	0	10	0	0
18	13124664	.	T	C	5	3	8	0	0	8	0	0
18	13125829	.	G	A	2	5	7	0	1	8	0	0
18	13125836	.	G	T	5	2	7	0	0	7	0	0
18	13133040	.	C	T	3	1	4	0	0	4	0	0
18	13196113	.	A	G	1	4	5	0	0	5	0	0
18	13196306	.	C	T	2	1	3	0	0	3	0	0
18	13215966	.	G	A	21	18	39	0	2	41	0	0
18	13216051	.	C	T	14	14	28	0	1	29	0	0
18	13216566	.	T	A	6	9	15	0	0	15	0	0
18	13236577	.	G	A	3	2	5	0	0	5	0	0
18	13238078	.	G	A	1	3	4	0	0	4	0	0
18	13240208	.	T	A	1	0	1	0	0	1	0	0
18	13245795	.	G	A	8	14	22	0	0	22	0	0
18	13245803	.	A	G	6	17	23	0	1	24	0	0
18	13246013	.	A	C	6	2	8	0	0	8	0	0
18	13324391	.	G	A	10	13	23	0	1	24	0	0
18	13324416	.	T	C	15	11	26	0	1	27	0	0
18	13324473	.	G	A	13	18	31	0	0	31	0	0
18	13324494	.	T	C	15	0	15	0	14	29	0	0
18	13324747	.	A	G	22	21	43	0	0	43	0	0
18	13325224	.	A	G	16	14	30	0	1	31	0	0
18	13325225	.	C	T	16	15	31	0	0	31	0	0
18	13325451	.	G	T	22	10	32	0	1	33	0	0
18	13325492	.	C	T	8	22	30	0	1	31	0	0
18	13325679	.	C	T	0	9	9	0	8	17	0	0
18	13325912	.	G	A	14	10	24	0	0	24	0	0
18	13326124	.	A	C	12	0	12	0	5	17	0	0
18	13326178	.	G	T	8	11	19	0	1	20	0	0
18	13326400	.	C	T	0	10	10	0	4	14	0	0
18	13326593	.	G	C	18	8	26	0	4	30	0	0
18	13336278	.	G	A	2	0	2	0	0	2	0	0
18	13345001	.	C	G	1	11	12	0	0	12	0	0
18	13345088	.	G	A	8	14	22	0	1	23	0	0
18	13345166	.	A	C	17	1	18	0	7	25	0	0
18	13356438	.	A	G	11	8	19	0	0	19	0	0
18	13837843	.	T	C	4	7	11	0	0	11	0	0
18	13888370	.	A	T	16	11	27	0	2	29	0	0
18	13888406	.	G	A	10	7	17	0	2	19	0	0
18	14041036	.	C	T	19	15	34	0	1	35	0	0
18	14075262	.	A	G	5	10	15	0	1	16	0	0
18	14114915	.	G	A	5	3	8	0	0	8	0	0
18	14114930	.	C	T	10	8	18	0	1	19	0	0
18	14115011	.	A	G	21	18	39	0	1	40	0	0
18	14115083	.	G	C	10	12	22	0	1	23	0	0
18	14132006	.	G	A	0	4	4	0	4	8	0	0
18	14132077	.	A	T	20	25	45	0	2	47	0	0
18	14132360	.	G	A	0	21	21	0	14	35	0	0
18	14132836	.	A	G	13	17	30	0	1	31	0	0
18	14132892	.	T	C	19	16	35	0	2	37	0	0
18	14233809	.	C	A	5	3	8	0	0	8	0	0
18	14334468	.	A	T	22	6	28	0	1	30	1	0
18	14337320	.	T	A	8	14	22	0	0	22	0	0
18	14529932	.	T	C	2	5	7	0	0	7	0	0
18	14529971	.	A	T	1	6	7	0	0	7	0	0
18	14620505	.	T	C	0	2	2	0	0	2	0	0
18	14633131	.	T	C	4	6	10	0	1	11	0	0
18	14637888	.	T	C	1	6	7	0	0	7	0	0
18	14642018	.	T	C	3	3	6	0	0	6	0	0
18	14642970	.	A	C	4	1	5	0	0	5	0	0
18	14648859	.	C	A	1	1	2	0	0	2	0	0
18	14649227	.	G	A	0	10	10	0	2	12	0	0
18	14649408	.	A	T	4	7	11	0	0	11	0	0
18	14652676	.	A	G	4	0	4	0	4	8	0	0
18	14660205	.	C	G	3	2	5	0	0	5	0	0
18	14672230	.	G	A	3	3	6	0	0	6	0	0
18	14672353	.	A	G	2	2	4	0	0	4	0	0
18	14672542	.	A	T	1	3	4	0	0	4	0	0
18	14690967	.	G	A	2	2	4	0	0	4	0	0
18	14691037	.	T	C	2	3	5	0	0	5	0	0
18	14691133	.	T	C	3	4	7	0	1	8	0	0
18	14691269	.	A	T	4	2	6	0	0	6	0	0
18	14691634	.	G	C	1	2	3	0	1	4	0	0
18	14698371	.	C	T	8	8	16	0	0	16	0	0
18	14698538	.	A	G	3	7	10	0	0	10	0	0
18	14698860	.	A	C	8	11	19	0	0	19	0	0
18	14698928	.	G	T	8	5	13	0	2	15	0	0
18	14699012	.	T	A	0	1	1	0	0	1	0	0
18	14700684	.	A	G	9	0	9	0	5	14	0	0
18	14700731	.	A	T	13	10	23	0	0	23	0	0
18	14702153	.	G	A	8	9	17	0	0	17	0	0
18	14702427	.	G	A	9	10	19	0	1	20	0	0
18	14702439	.	T	C	12	15	27	0	0	27	0	0
18	14702511	.	G	T	0	5	5	0	6	11	0	0
18	14705287	.	T	C	7	18	25	0	1	26	0	0
18	14705308	.	A	G	3	16	19	0	0	19	0	0
18	14705371	.	T	C	9	12	21	0	0	21	0	0
18	14705518	.	G	A	0	10	10	0	5	15	0	0
18	14705578	.	G	T	3	8	11	0	0	11	0	0
18	14731967	.	T	C	12	0	12	0	9	21	0	0
18	14732128	.	G	A	6	6	12	0	0	12	0	0
18	14732809	.	T	C	7	8	15	0	1	16	0	0
18	14732840	.	T	G	6	10	16	0	0	16	0	0
18	14732859	.	C	T	0	10	10	0	4	14	0	0
18	14732885	.	T	C	2	11	13	0	0	13	0	0
18	14732903	.	T	A	2	11	13	0	0	13	0	0
18	14732923	.	G	A	4	8	12	0	1	13	0	0
18	14732996	.	T	C	5	12	17	0	0	17	0	0
18	14733019	.	C	A	6	10	16	0	1	17	0	0
18	14733114	.	A	T	5	6	11	0	0	11	0	0
18	14733362	.	G	A	3	4	7	0	0	7	0	0
18	14733402	.	C	T	3	7	10	0	1	11	0	0
18	14733561	.	A	T	4	6	10	0	0	10	0	0
18	14733638	.	A	G	5	8	13	0	0	13	0	0
18	14733839	.	A	G	4	5	9	0	0	9	0	0
18	14734651	.	C	T	4	5	9	0	1	10	0	0
18	14772522	.	G	A	6	6	12	0	0	12	0	0
18	14772747	.	C	T	0	2	2	0	10	12	0	0
18	14772957	.	A	T	4	3	7	0	3	10	0	0
18	14773020	.	T	A	5	3	8	0	0	8	0	0
18	14773050	.	C	T	5	4	9	0	1	10	0	0
18	14773068	.	G	T	6	5	11	0	1	12	0	0
18	14773140	.	C	T	7	6	13	0	1	14	0	0
18	14774568	.	T	C	2	0	2	0	5	7	0	0
18	14774646	.	C	G	4	10	14	0	0	14	0	0
18	14779135	.	T	C	4	0	4	0	4	8	0	0
18	14779213	.	C	T	0	1	1	0	0	1	0	0
18	14780608	.	G	T	1	1	2	0	0	2	0	0
18	14780644	.	A	G	1	1	2	0	0	2	0	0
18	14780650	.	G	C	1	1	2	0	0	2	0	0
18	14780840	.	A	G	3	2	5	0	0	5	0	0
18	14825239	.	G	A	1	0	1	0	0	1	0	0
18	14836706	.	C	T	5	3	8	0	0	8	0	0
18	14836818	.	G	C	7	0	7	0	4	11	0	0
18	14863675	.	A	G	5	3	8	0	1	9	0	0
18	14863680	.	T	A	6	6	12	0	0	12	0	0
18	14863799	.	A	C	5	1	6	0	7	13	0	0
18	14866508	.	C	T	2	2	4	0	0	4	0	0
18	14867044	.	T	C	1	0	1	0	2	3	0	0
18	14878645	.	C	T	1	3	4	0	0	4	0	0
18	14886018	.	G	A	4	6	10	0	0	10	0	0
18	14891848	.	A	T	1	3	4	0	0	4	0	0
18	14893825	.	T	C	0	2	2	0	0	2	0	0
18	14910365	.	C	T	2	2	4	0	1	5	0	0
18	14928703	.	C	T	0	6	6	0	10	16	0	0
18	14937106	.	G	A	3	4	7	0	0	7	0	0
18	14956177	.	G	A	2	2	4	0	0	4	0	0
18	14969855	.	G	A	2	2	4	0	0	4	0	0
18	14984213	.	G	T	0	1	1	0	1	2	0	0
18	14989163	.	G	A	2	3	5	0	0	5	0	0
18	15010681	.	C	T	1	0	1	0	1	2	0	0
18	15010738	.	G	A	0	1	1	0	0	1	0	0
18	15100812	.	T	A	2	2	4	0	2	6	0	0
18	15106546	.	G	A	0	2	2	0	3	5	0	0
18	15121465	.	G	A	0	4	4	0	2	6	0	0
18	15121484	.	G	A	3	1	4	0	0	4	0	0
18	15121642	.	A	G	0	2	2	0	0	2	0	0
18	16128510	.	G	T	3	2	5	0	0	5	0	0
18	17535741	.	A	T	0	17	17	0	1	18	0	0
18	17535748	.	A	T	6	8	14	0	3	17	0	0
18	18472117	.	G	T	2	2	4	0	0	4	0	0
18	18975917	.	A	G	0	8	8	0	0	8	0	0
18	20226131	.	G	T	3	9	12	0	0	12	0	0
18	20249005	.	G	T	0	10	10	0	11	21	0	0
18	20252129	.	C	T	1	1	2	0	0	2	0	0
18	20254384	.	C	T	4	6	10	0	0	10	0	0
18	20254398	.	G	A	0	5	5	0	6	11	0	0
18	20256275	.	C	T	8	10	18	0	0	18	0	0
18	20256379	.	A	G	4	2	6	0	1	7	0	0
18	20256491	.	T	A	5	8	13	0	1	14	0	0
18	20256492	.	A	T	7	6	13	0	1	14	0	0
18	20256539	.	G	A	7	8	15	0	0	15	0	0
18	20257005	.	G	A	0	18	18	0	4	22	0	0
18	20257159	.	C	G	9	8	17	0	1	18	0	0
18	20257200	.	A	T	15	7	22	0	0	22	0	0
18	20460291	.	A	G	0	2	2	0	0	2	0	0
18	20469150	.	G	A	2	2	4	0	0	4	0	0
18	20473464	.	T	C	1	0	1	0	0	1	0	0
18	20475854	.	C	T	2	10	12	0	1	13	0	0
18	20482471	.	C	G	3	2	5	0	0	5	0	0
18	20488843	.	A	G	5	3	8	0	0	8	0	0
18	20488849	.	G	A	0	3	3	0	4	7	0	0
18	20488879	.	G	A	3	2	5	0	0	5	0	0
18	20489011	.	T	C	2	2	4	0	0	4	0	0
18	20489348	.	G	A	1	2	3	0	0	3	0	0
18	20490544	.	T	A	2	5	7	0	0	7	0	0
18	20490834	.	T	C	5	3	8	0	0	8	0	0
18	20516618	.	C	A	1	1	2	0	2	4	0	0
18	20516628	.	T	C	2	2	4	0	0	4	0	0
18	20516863	.	A	C	1	8	9	0	0	9	0	0
18	20516869	.	T	G	1	8	9	0	0	9	0	0
18	20517000	.	G	A	6	3	9	0	0	9	0	0
18	20518951	.	T	G	4	2	6	0	0	6	0	0
18	20521344	.	A	G	2	2	4	0	0	4	0	0
18	20521515	.	C	G	2	5	7	0	0	7	0	0
18	20521680	.	G	A	3	3	6	0	0	6	0	0
18	20521713	.	G	A	4	2	6	0	0	6	0	0
18	20532685	.	T	C	4	3	7	0	0	7	0	0
18	20541735	.	A	G	8	4	12	0	0	12	0	0
18	20542113	.	T	A	9	6	15	0	0	15	0	0
18	20542419	.	T	C	5	7	12	0	2	14	0	0
18	20542428	.	A	G	4	7	11	0	1	12	0	0
18	20542526	.	G	A	16	8	24	0	0	24	0	0
18	20542581	.	A	G	10	4	14	0	0	14	0	0
18	20542899	.	T	A	11	11	22	0	0	22	0	0
18	20542929	.	T	C	13	14	27	0	0	27	0	0
18	20542988	.	T	G	8	11	19	0	0	19	0	0
18	20543466	.	T	A	10	11	21	0	4	25	0	0
18	20544883	.	G	A	3	3	6	0	1	7	0	0
18	20553607	.	T	C	2	6	8	0	0	8	0	0
18	20554066	.	C	T	0	3	3	0	3	6	0	0
18	20559518	.	C	T	5	7	12	0	1	13	0	0
18	20559571	.	G	A	8	8	16	0	1	17	0	0
18	20572016	.	G	A	2	0	2	0	1	3	0	0
18	20582109	.	G	A	4	13	17	0	0	17	0	0
18	20582222	.	G	A	1	3	4	0	2	6	0	0
18	20582303	.	C	T	0	8	8	0	3	11	0	0
18	20582314	.	C	G	2	7	9	0	0	9	0	0
18	20582356	.	C	T	3	6	9	0	0	9	0	0
18	20582361	.	T	C	3	5	8	0	0	8	0	0
18	20582413	.	T	A	2	3	5	0	1	6	0	0
18	20582694	.	G	A	2	3	5	0	0	5	0	0
18	20582956	.	C	T	0	6	6	0	0	6	0	0
18	20582957	.	T	C	0	6	6	0	0	6	0	0
18	20583127	.	C	T	5	2	7	0	0	7	0	0
18	20583414	.	T	C	6	2	8	0	0	8	0	0
18	20585558	.	T	C	9	2	11	0	0	11	0	0
18	20585561	.	T	C	7	4	11	0	0	11	0	0
18	20585828	.	T	C	3	0	3	0	2	5	0	0
18	20585883	.	G	A	0	4	4	0	0	4	0	0
18	20594104	.	G	A	2	5	7	0	0	7	0	0
18	20726232	.	T	C	22	2	24	0	14	38	0	0
18	20726304	.	T	C	26	0	26	0	20	46	0	0
18	20729281	.	C	T	0	4	4	0	4	8	0	0
18	20730583	.	G	A	7	10	17	0	0	17	0	0
18	20735371	.	C	T	15	10	25	0	0	25	0	0
18	20735413	.	C	T	0	13	13	0	11	24	0	0
18	20738244	.	T	A	2	4	6	0	1	7	0	0
18	20738262	.	A	G	5	4	9	0	2	11	0	0
18	20738298	.	G	A	10	10	20	0	1	21	0	0
18	20738383	.	G	A	1	4	5	0	0	5	0	0
18	20739268	.	G	T	0	1	1	0	0	1	0	0
18	20742025	.	G	A	6	2	8	0	1	9	0	0
18	20742029	.	C	G	2	6	8	0	0	8	0	0
18	20744164	.	T	C	3	4	7	0	0	7	0	0
18	20752848	.	G	A	9	7	16	0	0	16	0	0
18	20752879	.	C	T	0	6	6	0	5	11	0	0
18	20755763	.	G	A	1	0	1	0	0	1	0	0
18	20755787	.	G	T	3	3	6	0	0	6	0	0
18	20755971	.	G	T	4	6	10	0	2	12	0	0
18	20757663	.	G	A	1	2	3	0	0	3	0	0
18	20757934	.	C	T	14	11	25	0	0	25	0	0
18	20757977	.	A	C	9	0	9	0	9	18	0	0
18	20757979	.	G	A	10	7	17	0	1	18	0	0
18	20760425	.	C	T	8	8	16	0	0	16	0	0
18	20768254	.	T	C	5	0	5	0	5	10	0	0
18	20768407	.	C	T	17	7	24	0	6	30	0	0
18	20768686	.	C	T	9	10	19	0	0	19	0	0
18	20768977	.	C	T	7	6	13	0	0	13	0	0
18	20821793	.	G	A	2	2	4	0	0	4	0	0
18	20859991	.	G	T	1	1	2	0	1	3	0	0
18	20860321	.	C	T	2	4	6	0	0	6	0	0
18	20860423	.	T	C	3	0	3	0	4	7	0	0
18	20861350	.	G	A	4	2	6	0	0	6	0	0
18	20861767	.	G	A	1	2	3	0	0	3	0	0
18	20882195	.	T	A	1	4	5	0	0	5	0	0
18	20894485	.	G	A	3	3	6	0	0	6	0	0
18	20909747	.	T	C	1	0	1	0	2	3	0	0
18	20917292	.	A	G	0	1	1	0	0	1	0	0
18	20917352	.	T	C	0	3	3	0	0	3	0	0
18	21075807	.	C	A	1	2	3	0	1	4	0	0
18	21102013	.	G	A	5	7	12	0	0	12	0	0
18	21102797	.	G	T	6	6	12	0	0	12	0	0
18	21103043	.	G	A	3	3	6	0	0	6	0	0
18	21105927	.	A	G	3	2	5	0	1	6	0	0
18	21113258	.	G	A	0	4	4	0	10	14	0	0
18	21113273	.	T	C	9	3	12	0	0	12	0	0
18	21115175	.	C	T	1	1	2	0	0	2	0	0
18	21117589	.	C	A	4	3	7	0	0	7	0	0
18	21117801	.	C	T	11	6	17	0	0	17	0	0
18	21119562	.	G	A	9	6	15	0	0	15	0	0
18	21119579	.	A	T	8	6	14	0	1	15	0	0
18	21119654	.	G	A	10	6	16	0	0	16	0	0
18	21119751	.	C	T	7	15	22	0	1	23	0	0
18	21119845	.	C	A	7	6	13	0	1	14	0	0
18	21123001	.	A	G	8	0	8	0	8	16	0	0
18	21144751	.	G	A	0	5	5	0	2	7	0	0
18	21144823	.	C	A	6	4	10	0	0	10	0	0
18	21144852	.	A	G	10	6	16	0	0	16	0	0
18	21144965	.	G	C	0	4	4	0	6	10	0	0
18	21144985	.	C	T	5	4	9	0	0	9	0	0
18	21178865	.	T	G	3	2	5	0	0	5	0	0
18	21179135	.	T	C	3	5	8	0	0	8	0	0
18	21179158	.	G	C	5	5	10	0	0	10	0	0
18	21179181	.	A	T	9	3	12	0	1	13	0	0
18	21179228	.	G	C	4	9	13	0	0	13	0	0
18	21179325	.	T	C	13	0	13	0	6	19	0	0
18	21179369	.	T	C	16	9	25	0	1	26	0	0
18	21179484	.	G	A	5	9	14	0	0	14	0	0
18	21179566	.	T	C	11	12	23	0	1	24	0	0
18	21179709	.	A	C	3	4	7	0	1	8	0	0
18	21182879	.	A	G	2	2	4	0	0	4	0	0
18	21199515	.	T	C	2	7	9	0	1	10	0	0
18	21201953	.	G	A	1	0	1	0	0	1	0	0
18	21214976	.	T	C	1	3	4	0	0	4	0	0
18	21218734	.	G	A	14	10	24	0	1	25	0	0
18	21257623	.	A	G	21	11	32	0	3	35	0	0
18	21257657	.	T	C	12	19	31	0	2	33	0	0
18	21257757	.	G	A	12	10	22	0	0	23	1	0
18	21257816	.	G	T	16	7	23	0	1	24	0	0
18	21257867	.	G	A	9	19	28	0	0	28	0	0
18	21257951	.	T	A	15	10	25	0	1	26	0	0
18	21263120	.	G	A	1	2	3	0	1	4	0	0
18	21263268	.	C	T	0	3	3	0	1	4	0	0
18	21266815	.	A	G	1	2	3	0	1	4	0	0
18	21266885	.	G	A	4	5	9	0	0	9	0	0
18	21409113	.	A	T	1	2	3	0	0	3	0	0
18	22376947	.	A	C	6	0	6	0	16	22	0	0
18	23869134	.	C	T	20	16	36	0	1	37	0	0
18	23870092	.	G	A	21	16	37	0	0	37	0	0
18	23870837	.	C	T	17	10	27	0	0	27	0	0
18	23875111	.	A	C	7	8	15	0	1	16	0	0
18	24922124	.	C	A	3	4	7	0	0	7	0	0
18	24926768	.	A	G	13	0	13	0	12	25	0	0
18	24926925	.	T	C	5	2	7	0	1	8	0	0
18	24928941	.	A	G	8	17	25	0	0	25	0	0
18	24929079	.	T	G	5	11	16	0	1	17	0	0
18	24929406	.	A	G	6	0	6	0	6	12	0	0
18	24929413	.	G	A	6	7	13	0	0	13	0	0
18	24929460	.	G	A	0	7	7	0	11	18	0	0
18	24929633	.	C	T	12	7	19	0	1	20	0	0
18	24929720	.	C	T	12	12	24	0	0	24	0	0
18	24930189	.	G	A	9	9	18	0	3	21	0	0
18	24930758	.	T	C	19	20	39	0	1	40	0	0
18	24931044	.	T	A	15	16	31	0	0	31	0	0
18	24931326	.	G	A	11	8	19	0	0	19	0	0
18	24931634	.	A	G	20	25	45	0	0	45	0	0
18	24931660	.	G	T	14	16	30	0	0	30	0	0
18	24931699	.	T	C	10	15	25	0	3	28	0	0
18	24933638	.	C	A	7	7	14	0	0	15	1	0
18	24933769	.	C	A	9	16	25	0	0	25	0	0
18	24933799	.	A	G	14	14	28	0	0	28	0	0
18	24933990	.	A	C	7	5	12	0	0	12	0	0
18	24934456	.	G	A	12	13	25	0	1	26	0	0
18	24934692	.	C	A	6	5	11	0	1	12	0	0
18	24934719	.	G	C	8	9	17	0	0	17	0	0
18	24934950	.	G	A	7	6	13	0	0	13	0	0
18	24946637	.	T	C	2	2	4	0	0	4	0	0
18	24947618	.	G	A	0	3	3	0	2	5	0	0
18	24947678	.	A	G	3	4	7	0	1	8	0	0
18	24952182	.	G	A	2	3	5	0	0	5	0	0
18	24952245	.	T	G	5	7	12	0	0	12	0	0
18	24966110	.	G	A	3	3	6	0	0	6	0	0
18	24968639	.	C	T	0	2	2	0	0	2	0	0
18	24984682	.	T	A	3	2	5	0	0	5	0	0
18	24988707	.	T	A	1	2	3	0	0	3	0	0
18	25009233	.	C	T	1	3	4	0	0	4	0	0
18	25009352	.	G	A	12	10	22	0	0	22	0	0
18	25009407	.	T	C	11	14	25	0	0	25	0	0
18	25028181	.	C	A	0	2	2	0	4	6	0	0
18	25046163	.	G	A	3	2	5	0	0	5	0	0
18	25092318	.	G	A	1	1	2	0	0	2	0	0
18	25568888	.	T	C	1	3	4	0	0	4	0	0
18	25602074	.	A	C	1	0	1	0	1	2	0	0
18	25653727	.	T	A	1	2	3	0	0	3	0	0
18	25745182	.	G	A	0	1	1	0	1	2	0	0
18	25752722	.	G	A	5	3	8	0	0	8	0	0
18	25754690	.	T	G	0	3	3	0	0	3	0	0
18	25754704	.	A	C	1	3	4	0	0	4	0	0
18	25783812	.	T	C	6	3	9	0	0	9	0	0
18	25783992	.	C	T	3	3	6	0	0	6	0	0
18	25784146	.	C	A	0	3	3	0	1	4	0	0
18	25792097	.	A	G	3	3	6	0	0	6	0	0
18	26089004	.	G	C	2	3	5	0	0	5	0	0
18	26089028	.	C	G	3	4	7	0	1	8	0	0
18	26089135	.	G	C	2	2	4	0	0	4	0	0
18	26089136	.	G	A	2	2	4	0	0	4	0	0
18	26094421	.	C	T	2	5	7	0	0	7	0	0
18	26094491	.	A	C	3	4	7	0	0	7	0	0
18	26099274	.	A	T	16	24	40	0	0	40	0	0
18	26125983	.	A	G	2	3	5	0	0	5	0	0
18	26126046	.	C	T	4	5	9	0	0	9	0	0
18	26362401	.	A	G	2	8	10	0	0	10	0	0
18	26389326	.	G	A	9	18	27	0	2	29	0	0
18	26389401	.	C	T	6	3	9	0	0	9	0	0
18	26401743	.	C	T	16	27	43	0	2	45	0	0
18	26401938	.	A	C	3	11	14	0	1	15	0	0
18	26405271	.	G	A	10	23	33	0	0	33	0	0
18	26410176	.	T	C	2	8	10	0	1	11	0	0
18	26412001	.	A	G	0	4	4	0	0	4	0	0
18	26425485	.	A	G	1	2	3	0	0	3	0	0
18	26460594	.	G	A	4	6	10	0	0	10	0	0
18	26460723	.	G	T	7	2	9	0	0	9	0	0
18	26460773	.	A	T	2	3	5	0	1	6	0	0
18	26474249	.	A	G	2	2	4	0	0	4	0	0
18	26476133	.	C	T	1	1	2	0	0	2	0	0
18	26480138	.	T	A	0	1	1	0	0	1	0	0
18	26689775	.	G	C	0	2	2	0	0	2	0	0
18	26790510	.	A	T	4	12	16	0	1	17	0	0
18	26793948	.	G	A	0	1	1	0	0	1	0	0
18	26797112	.	G	A	3	2	5	0	0	5	0	0
18	26800148	.	A	C	5	5	10	0	0	10	0	0
18	26800198	.	T	C	3	6	9	0	0	9	0	0
18	26800280	.	G	A	6	7	13	0	0	13	0	0
18	26800418	.	T	C	10	9	19	0	1	20	0	0
18	26804218	.	G	A	1	3	4	0	0	4	0	0
18	26807229	.	T	A	1	2	3	0	0	3	0	0
18	26807304	.	C	T	2	1	3	0	0	3	0	0
18	26809791	.	G	T	1	4	5	0	0	5	0	0
18	26810162	.	C	A	1	2	3	0	0	3	0	0
18	26810434	.	G	C	4	5	9	0	0	9	0	0
18	26863681	.	T	C	3	0	3	0	3	6	0	0
18	26874553	.	G	A	2	0	2	0	0	2	0	0
18	26891630	.	C	T	1	2	3	0	0	3	0	0
18	26891744	.	A	G	2	3	5	0	0	5	0	0
18	26891752	.	A	G	2	3	5	0	0	5	0	0
18	26891823	.	G	C	1	1	2	0	0	2	0	0
18	26896160	.	G	C	0	7	7	0	6	13	0	0
18	26899453	.	T	C	6	9	15	0	0	15	0	0
18	26909470	.	G	A	1	18	19	0	23	42	0	0
18	26913949	.	C	T	31	19	50	0	4	54	0	0
18	26919865	.	T	C	8	10	18	0	0	18	0	0
18	26968389	.	T	A	5	2	7	0	0	7	0	0
18	26968822	.	T	C	2	0	2	0	3	5	0	0
18	26971513	.	G	A	4	1	5	0	0	5	0	0
18	27054937	.	G	A	1	2	3	0	0	3	0	0
18	27063996	.	C	A	1	3	4	0	0	4	0	0
18	27066063	.	C	T	1	2	3	0	0	3	0	0
18	27066080	.	T	A	0	2	2	0	0	2	0	0
18	27072144	.	A	C	4	3	7	0	0	7	0	0
18	27072226	.	C	A	7	2	9	0	0	9	0	0
18	27072690	.	C	T	3	3	6	0	1	7	0	0
18	27072697	.	G	A	3	4	7	0	0	7	0	0
18	27080991	.	C	T	5	2	7	0	0	7	0	0
18	27081050	.	C	T	3	3	6	0	0	6	0	0
18	27081056	.	T	C	3	2	5	0	0	5	0	0
18	27085217	.	A	T	1	3	4	0	0	4	0	0
18	27252386	.	C	T	1	2	3	0	0	3	0	0
18	27252401	.	G	A	0	3	3	0	1	4	0	0
18	27254790	.	T	A	1	4	5	0	0	5	0	0
18	27285337	.	C	T	1	0	1	0	0	1	0	0
18	27285741	.	C	T	0	4	4	0	1	5	0	0
18	27285764	.	C	T	1	3	4	0	0	4	0	0
18	27309512	.	T	C	3	6	9	0	0	9	0	0
18	27309517	.	A	G	3	6	9	0	1	10	0	0
18	27309555	.	G	A	7	6	13	0	0	13	0	0
18	27309873	.	C	T	21	12	33	0	1	34	0	0
18	27335583	.	T	C	9	11	20	0	1	21	0	0
18	27335740	.	T	A	11	6	17	0	0	18	1	0
18	27335828	.	A	G	7	9	16	0	0	16	0	0
18	27335935	.	T	A	4	2	6	0	0	6	0	0
18	27340993	.	C	T	4	3	7	0	0	7	0	0
18	27341170	.	C	T	4	7	11	0	0	11	0	0
18	27341313	.	G	A	1	2	3	0	0	3	0	0
18	27358499	.	G	A	1	5	6	0	1	7	0	0
18	27358744	.	G	C	2	5	7	0	0	7	0	0
18	27358787	.	T	C	1	6	7	0	0	7	0	0
18	27439981	.	T	A	3	0	3	0	0	3	0	0
18	27624354	.	C	T	2	4	6	0	1	7	0	0
18	27624477	.	C	A	1	3	4	0	0	4	0	0
18	27625814	.	A	C	3	4	7	0	0	7	0	0
18	27625903	.	T	G	3	3	6	0	0	6	0	0
18	27626271	.	C	T	3	4	7	0	0	7	0	0
18	27626350	.	T	C	1	2	3	0	0	3	0	0
18	27732389	.	T	C	15	11	26	0	1	27	0	0
18	27802795	.	C	T	4	7	11	0	0	11	0	0
18	27812400	.	T	G	13	0	13	0	19	32	0	0
18	27812429	.	T	C	14	18	32	0	2	34	0	0
18	27812618	.	T	A	9	15	24	0	0	24	0	0
18	27849969	.	T	C	1	0	1	0	4	5	0	0
18	27896989	.	C	T	0	1	1	0	0	1	0	0
18	27927010	.	C	G	1	2	3	0	0	3	0	0
18	27970182	.	A	T	2	6	8	0	0	8	0	0
18	27981137	.	A	C	0	3	3	0	0	3	0	0
18	27982320	.	A	G	0	3	3	0	0	3	0	0
18	27984021	.	A	G	6	0	6	0	7	13	0	0
18	27984026	.	C	T	6	6	12	0	0	12	0	0
18	27984080	.	C	T	5	3	8	0	0	8	0	0
18	27988481	.	G	C	4	4	8	0	1	9	0	0
18	27988509	.	T	C	1	4	5	0	0	5	0	0
18	27993392	.	T	G	8	7	15	0	0	15	0	0
18	27993625	.	C	A	7	3	10	0	1	11	0	0
18	28106790	.	A	G	3	0	3	0	3	6	0	0
18	28123612	.	T	C	4	2	6	0	0	6	0	0
18	28564674	.	T	A	3	3	6	0	0	6	0	0
18	28564737	.	T	C	5	4	9	0	0	9	0	0
18	28564856	.	G	T	2	3	5	0	0	5	0	0
18	28564858	.	G	A	0	3	3	0	2	5	0	0
18	28564923	.	G	A	0	4	4	0	1	5	0	0
18	28564947	.	A	G	2	4	6	0	0	6	0	0
18	28565025	.	C	T	0	0	0	0	1	1	0	0
18	28606134	.	C	A	3	1	4	0	0	4	0	0
18	28606191	.	A	G	1	0	1	0	1	2	0	0
18	28867342	.	T	C	1	4	5	0	0	5	0	0
18	28876524	.	C	G	11	12	23	0	1	24	0	0
18	28876569	.	A	G	8	1	9	0	14	23	0	0
18	28879736	.	G	T	0	8	8	0	10	19	1	0
18	28879758	.	C	G	9	9	18	0	0	18	0	0
18	28879847	.	G	T	6	9	15	0	1	16	0	0
18	29008407	.	C	T	6	19	25	0	1	26	0	0
18	29058989	.	C	T	4	9	13	0	1	14	0	0
18	29059194	.	A	G	5	10	15	0	0	15	0	0
18	29402888	.	G	T	2	3	5	0	0	5	0	0
18	29403241	.	G	T	2	3	5	0	1	6	0	0
18	29403433	.	G	T	0	3	3	0	1	4	0	0
18	29886272	.	G	A	2	2	4	0	0	4	0	0
18	29886275	.	C	T	2	2	4	0	0	4	0	0
18	29887283	.	C	G	1	2	3	0	0	3	0	0
18	29887372	.	T	C	1	2	3	0	0	3	0	0
18	29888576	.	A	G	2	4	6	0	0	6	0	0
18	29888586	.	C	T	2	4	6	0	0	6	0	0
18	29889227	.	C	T	0	2	2	0	1	3	0	0
18	29889267	.	C	T	2	2	4	0	0	4	0	0
18	29898173	.	A	C	4	3	7	0	0	7	0	0
18	29898187	.	T	A	5	3	8	0	0	8	0	0
18	29898341	.	A	G	3	4	7	0	0	7	0	0
18	29904176	.	T	A	1	2	3	0	0	3	0	0
18	29950442	.	A	G	0	1	1	0	0	1	0	0
18	29953082	.	G	A	0	1	1	0	2	3	0	0
18	29953867	.	G	A	2	4	6	0	4	10	0	0
18	29954824	.	C	A	11	6	17	0	0	17	0	0
18	29954918	.	C	T	8	7	15	0	1	16	0	0
18	29954929	.	T	C	9	8	17	0	0	17	0	0
18	29958874	.	G	A	2	2	4	0	0	4	0	0
18	29959241	.	T	C	2	2	4	0	0	4	0	0
18	29959517	.	A	G	2	5	7	0	0	7	0	0
18	29961466	.	G	C	2	2	4	0	0	4	0	0
18	29969920	.	A	T	4	4	8	0	0	8	0	0
18	29970458	.	C	G	12	14	26	0	1	27	0	0
18	29970559	.	T	G	8	14	22	0	0	22	0	0
18	29977423	.	C	T	5	4	9	0	1	10	0	0
18	29977753	.	C	T	8	4	12	0	1	13	0	0
18	29977784	.	T	A	10	5	15	0	0	15	0	0
18	29977789	.	C	T	8	4	12	1	0	13	0	0
18	29978794	.	A	T	7	6	13	0	0	13	0	0
18	29978848	.	A	G	9	2	11	0	1	12	0	0
18	29980462	.	A	G	4	6	10	0	0	10	0	0
18	29980474	.	A	G	3	5	8	0	0	8	0	0
18	29980560	.	A	G	3	2	5	0	0	5	0	0
18	29980584	.	C	T	1	1	2	0	0	2	0	0
18	30014561	.	G	A	4	2	6	0	0	6	0	0
18	30021380	.	A	C	3	0	3	0	2	5	0	0
18	30370469	.	T	C	3	2	5	0	0	5	0	0
18	30441825	.	G	A	1	3	4	0	11	15	0	0
18	30463346	.	C	T	4	3	7	0	0	7	0	0
18	30466712	.	A	T	11	11	22	0	3	25	0	0
18	30467010	.	A	G	10	0	10	0	6	16	0	0
18	30470471	.	A	G	2	2	4	0	0	4	0	0
18	30470929	.	T	C	10	12	22	0	2	24	0	0
18	30470930	.	G	A	10	12	22	0	2	24	0	0
18	30473566	.	C	G	2	0	2	0	6	8	0	0
18	30473905	.	A	G	5	0	5	0	9	14	0	0
18	30476837	.	G	A	13	12	25	0	0	25	0	0
18	30477289	.	G	T	7	9	16	0	2	18	0	0
18	30477469	.	C	T	8	9	17	0	3	20	0	0
18	30477495	.	T	G	5	12	17	0	0	17	0	0
18	30477616	.	A	G	8	7	15	0	2	17	0	0
18	30477625	.	C	T	10	6	16	0	0	16	0	0
18	30477889	.	C	T	20	9	29	0	0	29	0	0
18	30478113	.	A	G	12	0	12	0	6	18	0	0
18	30478156	.	C	T	24	13	37	0	0	37	0	0
18	30500912	.	G	T	5	3	8	0	1	9	0	0
18	30501194	.	T	C	2	7	9	0	0	9	0	0
18	30501298	.	C	A	7	10	17	0	0	17	0	0
18	30501393	.	G	A	13	5	18	0	0	18	0	0
18	30501639	.	A	G	12	8	20	0	0	20	0	0
18	30501701	.	T	C	10	12	22	0	1	23	0	0
18	30503562	.	T	C	4	0	4	0	2	6	0	0
18	30504366	.	C	T	4	12	16	0	0	16	0	0
18	30511260	.	C	A	3	4	7	0	0	7	0	0
18	30564142	.	T	A	5	3	8	0	0	8	0	0
18	30564199	.	A	G	3	0	3	0	2	5	0	0
18	30564240	.	A	T	3	6	9	0	0	9	0	0
18	30564301	.	C	A	4	5	9	0	1	10	0	0
18	30564334	.	T	G	10	2	12	0	0	12	0	0
18	30564342	.	G	T	10	4	14	0	0	14	0	0
18	30564385	.	T	G	7	5	12	0	0	12	0	0
18	30564598	.	A	G	2	2	4	0	1	5	0	0
18	30949449	.	C	T	2	4	6	0	0	6	0	0
18	31033267	.	C	T	1	3	4	0	6	10	0	0
18	31036721	.	A	T	6	2	8	0	0	8	0	0
18	31036722	.	C	A	6	2	8	0	0	8	0	0
18	31041640	.	G	A	3	5	8	0	1	9	0	0
18	31057204	.	T	A	1	2	3	0	0	3	0	0
18	31057911	.	C	T	1	2	3	0	0	3	0	0
18	31058647	.	G	A	0	5	5	0	6	11	0	0
18	31064706	.	A	G	4	0	4	0	9	13	0	0
18	31064734	.	G	A	4	8	12	0	0	12	0	0
18	31068392	.	A	C	4	3	7	0	1	8	0	0
18	31105257	.	G	A	21	13	34	0	1	35	0	0
18	31151851	.	G	A	1	0	1	0	0	1	0	0
18	31152920	.	A	G	2	5	7	0	0	7	0	0
18	31152946	.	C	A	2	7	9	0	0	9	0	0
18	31201750	.	T	C	0	0	0	0	1	1	0	0
18	31206392	.	C	A	3	6	9	0	0	9	0	0
18	31281034	.	G	C	0	6	6	0	11	17	0	0
18	31281161	.	T	A	14	9	23	0	1	24	0	0
18	31281186	.	T	C	15	9	24	0	1	25	0	0
18	31281254	.	G	A	6	3	9	0	0	9	0	0
18	31775711	.	G	A	0	3	3	0	3	6	0	0
18	33982078	.	G	T	1	3	4	0	0	4	0	0
18	33982331	.	G	T	3	3	6	0	0	6	0	0
18	33982340	.	G	A	3	2	5	0	0	5	0	0
18	33982423	.	A	C	10	4	14	0	0	14	0	0
18	33982591	.	T	C	10	13	23	0	0	23	0	0
18	33982811	.	C	T	1	12	13	0	7	20	0	0
18	33983154	.	G	A	13	12	25	0	2	27	0	0
18	33983165	.	T	C	12	16	28	0	0	28	0	0
18	33983300	.	A	C	10	0	10	0	9	19	0	0
18	33983564	.	T	A	7	7	14	0	0	14	0	0
18	33983641	.	T	C	8	8	16	0	0	16	0	0
18	33983771	.	A	C	8	5	13	0	0	13	0	0
18	33984153	.	A	G	6	6	12	0	0	12	0	0
18	33984191	.	C	A	7	8	15	0	1	16	0	0
18	33984215	.	G	T	5	5	10	0	3	13	0	0
18	33984235	.	T	A	9	6	15	0	0	15	0	0
18	33984596	.	G	A	7	5	12	0	1	13	0	0
18	33985249	.	T	C	13	6	19	0	0	19	0	0
18	33985414	.	T	C	10	0	10	0	13	23	0	0
18	33985953	.	C	T	10	13	23	0	1	24	0	0
18	33986027	.	A	G	10	5	15	0	0	15	0	0
18	33986199	.	C	T	12	15	27	0	3	30	0	0
18	33986391	.	C	T	5	5	10	0	0	10	0	0
18	33986395	.	A	G	5	5	10	0	0	10	0	0
18	33986470	.	T	C	7	6	13	0	0	13	0	0
18	33988590	.	C	T	0	1	1	0	1	2	0	0
18	33988743	.	A	C	6	0	6	0	9	15	0	0
18	33999714	.	C	G	0	1	1	0	0	1	0	0
18	33999923	.	G	A	3	2	5	0	0	5	0	0
18	34043325	.	G	A	4	2	6	0	0	6	0	0
18	34050813	.	A	G	1	0	1	0	0	1	0	0
18	34146406	.	A	C	3	2	5	0	0	5	0	0
18	34146890	.	C	T	1	3	4	0	0	4	0	0
18	34156693	.	A	T	4	3	7	0	2	9	0	0
18	34163629	.	C	T	0	4	4	0	2	6	0	0
18	34163631	.	G	T	1	4	5	0	1	6	0	0
18	34163687	.	A	G	1	0	1	0	0	1	0	0
18	34195231	.	A	G	4	4	8	0	0	8	0	0
18	34195318	.	C	A	2	2	4	0	0	4	0	0
18	34195336	.	A	T	1	0	1	0	0	1	0	0
18	34196270	.	G	C	1	1	2	0	0	2	0	0
18	34207700	.	G	A	8	6	14	0	0	14	0	0
18	34213414	.	T	C	3	2	5	0	0	5	0	0
18	34213426	.	T	C	3	1	4	0	0	4	0	0
18	34213530	.	G	A	0	2	2	0	4	7	1	0
18	34213995	.	A	T	9	4	13	0	0	13	0	0
18	34214054	.	C	T	3	5	8	0	1	9	0	0
18	34214141	.	T	G	5	3	8	0	1	9	0	0
18	34214280	.	A	T	7	4	11	0	0	11	0	0
18	34214288	.	G	T	9	5	14	0	0	14	0	0
18	34214478	.	A	G	10	0	10	0	9	19	0	0
18	34214754	.	C	G	8	17	25	0	2	27	0	0
18	34214894	.	T	C	16	6	22	0	0	22	0	0
18	34362633	.	A	T	2	3	5	0	0	5	0	0
18	34534807	.	G	T	6	8	14	0	0	14	0	0
18	34535184	.	A	G	5	3	8	0	0	8	0	0
18	34535235	.	C	T	5	8	13	0	0	13	0	0
18	34535302	.	A	C	6	6	12	0	0	12	0	0
18	34535423	.	A	G	2	4	6	0	4	10	0	0
18	34535518	.	T	C	4	2	6	0	0	6	0	0
18	34535695	.	A	T	2	2	4	0	0	4	0	0
18	34535769	.	T	C	2	4	6	0	0	6	0	0
18	34542620	.	C	A	15	12	27	0	1	28	0	0
18	34601008	.	C	A	9	4	13	0	0	14	1	0
18	34601323	.	T	G	9	5	14	0	0	14	0	0
18	34601468	.	G	T	2	11	13	0	0	13	0	0
18	34601471	.	A	T	2	11	13	0	0	13	0	0
18	34641352	.	A	C	11	12	23	0	3	26	0	0
18	34641439	.	T	C	10	13	23	0	0	23	0	0
18	34641442	.	T	C	10	12	22	0	1	23	0	0
18	34641622	.	C	G	15	9	24	0	0	24	0	0
18	34641633	.	T	C	15	9	24	0	0	24	0	0
18	35143069	.	A	T	0	1	1	0	0	1	0	0
18	35143242	.	G	T	2	3	5	0	0	5	0	0
18	35147372	.	G	A	6	3	9	0	0	9	0	0
18	35147379	.	T	G	5	2	7	0	0	7	0	0
18	35173904	.	G	A	2	2	4	0	0	4	0	0
18	35173932	.	A	T	1	2	3	0	0	3	0	0
18	35179690	.	G	A	0	3	3	0	0	3	0	0
18	35182349	.	A	C	2	1	3	0	0	3	0	0
18	35195963	.	C	A	3	2	5	0	0	5	0	0
18	35238163	.	A	T	1	1	2	0	0	2	0	0
18	35238632	.	G	T	0	1	1	0	0	1	0	0
18	35251104	.	C	T	1	0	1	0	0	1	0	0
18	35251139	.	C	G	3	0	3	0	1	4	0	0
18	35251249	.	T	C	3	2	5	0	0	5	0	0
18	35251258	.	G	A	0	2	2	0	2	4	0	0
18	35405389	.	T	C	4	0	4	0	3	7	0	0
18	35406987	.	G	A	4	7	11	0	1	12	0	0
18	35407271	.	C	T	1	1	2	0	0	2	0	0
18	35501357	.	G	A	5	9	14	0	1	15	0	0
18	35503705	.	A	G	1	10	11	0	2	13	0	0
18	35506377	.	C	G	0	12	12	0	10	22	0	0
18	35506393	.	C	T	10	13	23	0	2	25	0	0
18	35508097	.	G	A	4	8	12	0	2	14	0	0
18	35510011	.	G	A	2	2	4	0	1	5	0	0
18	35510812	.	G	A	0	1	1	0	0	1	0	0
18	35520248	.	G	A	1	0	1	0	0	1	0	0
18	35529482	.	T	G	1	1	2	0	0	2	0	0
18	35548101	.	T	C	1	0	1	0	2	3	0	0
18	35561331	.	C	T	0	1	1	0	0	1	0	0
18	35561463	.	G	A	2	3	5	0	0	5	0	0
18	35562303	.	C	T	1	4	5	0	0	5	0	0
18	35578016	.	G	T	2	1	3	0	0	3	0	0
18	35582682	.	C	T	3	2	5	0	0	5	0	0
18	35582718	.	C	T	6	3	9	0	0	9	0	0
18	35582721	.	C	T	3	6	9	0	0	9	0	0
18	35625935	.	A	G	1	2	3	0	0	3	0	0
18	35625968	.	T	C	1	3	4	0	0	4	0	0
18	35794289	.	T	C	3	3	6	0	0	6	0	0
18	35794322	.	T	C	1	2	3	0	1	4	0	0
18	35807960	.	G	A	13	4	17	0	0	17	0	0
18	35808137	.	C	T	7	5	12	0	0	12	0	0
18	35808206	.	C	A	9	4	13	0	0	13	0	0
18	35814745	.	T	G	3	1	4	0	0	4	0	0
18	35827185	.	C	T	7	5	12	0	0	12	0	0
18	35827399	.	T	A	2	2	4	0	0	4	0	0
18	35827621	.	T	A	4	2	6	0	0	6	0	0
18	35832858	.	G	T	3	5	8	0	0	8	0	0
18	35832896	.	G	A	8	9	17	0	0	17	0	0
18	35832911	.	G	A	6	10	16	0	0	16	0	0
18	35838817	.	A	G	2	2	4	0	0	4	0	0
18	35839224	.	T	C	1	1	2	0	1	3	0	0
18	35839257	.	T	C	2	0	2	0	3	5	0	0
18	35839412	.	G	C	4	6	10	0	0	10	0	0
18	35839461	.	T	C	4	5	9	0	0	9	0	0
18	35839512	.	A	G	9	6	15	0	0	15	0	0
18	35839543	.	A	T	13	6	19	0	0	19	0	0
18	35839658	.	T	C	9	7	16	0	0	16	0	0
18	35839832	.	G	A	3	2	5	0	1	6	0	0
18	35842419	.	T	C	3	3	6	0	0	6	0	0
18	35842440	.	C	T	0	6	6	0	9	15	0	0
18	35842461	.	A	T	11	13	24	0	0	24	0	0
18	35842476	.	C	T	12	10	22	0	1	23	0	0
18	35871710	.	G	A	1	2	3	0	0	3	0	0
18	35891896	.	C	T	2	2	4	0	0	4	0	0
18	35891899	.	C	T	2	2	4	0	0	4	0	0
18	35898617	.	C	T	3	2	5	0	0	5	0	0
18	36037258	.	T	C	3	2	5	0	0	5	0	0
18	36066450	.	G	C	6	6	12	0	0	12	0	0
18	36070870	.	T	C	0	1	1	0	0	1	0	0
18	36071223	.	G	A	0	4	4	0	1	5	0	0
18	36071262	.	C	T	4	1	5	0	0	5	0	0
18	36075306	.	C	T	6	15	21	0	0	21	0	0
18	36080616	.	G	T	12	12	24	0	0	24	0	0
18	36081483	.	G	T	7	16	23	0	0	23	0	0
18	36081513	.	C	T	14	8	22	0	2	24	0	0
18	36081728	.	C	T	4	1	5	0	1	6	0	0
18	36081773	.	G	A	4	2	6	0	0	6	0	0
18	36081792	.	T	C	2	4	6	0	0	6	0	0
18	36106031	.	T	C	14	13	27	0	1	28	0	0
18	36128954	.	C	T	0	1	1	0	0	1	0	0
18	36129177	.	G	A	3	11	14	0	0	14	0	0
18	36142578	.	C	T	0	1	1	0	3	4	0	0
18	36142649	.	C	T	5	2	7	0	0	7	0	0
18	36142652	.	A	C	5	2	7	0	0	7	0	0
18	36591488	.	G	T	2	2	4	0	0	4	0	0
18	36591745	.	C	T	2	0	2	0	0	2	0	0
18	36593874	.	C	T	3	6	9	0	0	9	0	0
18	36598075	.	G	A	0	3	3	0	4	7	0	0
18	36598076	.	T	A	4	3	7	0	0	7	0	0
18	36598273	.	T	A	5	4	9	0	0	9	0	0
18	36598332	.	A	G	5	5	10	0	0	10	0	0
18	36598441	.	C	T	5	7	12	0	0	12	0	0
18	36598476	.	G	A	3	2	5	0	2	7	0	0
18	36614822	.	T	G	0	0	0	0	1	1	0	0
18	36615056	.	G	A	0	1	1	0	0	1	0	0
18	36620186	.	C	T	4	7	11	0	0	11	0	0
18	36623275	.	C	T	9	5	14	0	0	14	0	0
18	36630615	.	T	C	6	5	11	0	1	12	0	0
18	36630740	.	T	A	8	8	16	0	0	16	0	0
18	36630867	.	C	T	7	9	16	0	0	16	0	0
18	36645330	.	A	T	3	2	5	0	0	5	0	0
18	36647855	.	C	T	1	6	7	0	0	7	0	0
18	36806939	.	T	G	1	2	3	0	1	4	0	0
18	36858200	.	T	C	1	3	4	0	0	4	0	0
18	36869052	.	A	G	0	2	2	0	1	3	0	0
18	36869242	.	C	A	11	7	18	0	0	18	0	0
18	36869427	.	T	A	1	4	5	0	0	5	0	0
18	36869774	.	A	G	13	3	16	0	1	17	0	0
18	36869798	.	A	G	16	2	18	0	0	18	0	0
18	36870068	.	G	A	9	10	19	0	1	20	0	0
18	36870278	.	G	A	9	7	16	0	1	17	0	0
18	36949014	.	G	A	2	2	4	0	1	5	0	0
18	36951632	.	G	T	2	5	7	0	0	7	0	0
18	36951990	.	G	A	4	8	12	0	1	13	0	0
18	36954230	.	C	T	2	4	6	0	1	7	0	0
18	36959767	.	T	C	1	2	3	0	0	3	0	0
18	37007161	.	G	A	2	2	4	0	0	4	0	0
18	37007190	.	G	T	1	1	2	0	1	3	0	0
18	37121202	.	G	T	2	4	6	0	0	6	0	0
18	37133566	.	G	A	0	3	3	0	0	3	0	0
18	37137278	.	T	G	3	2	5	0	1	6	0	0
18	37153325	.	A	G	3	3	6	0	0	6	0	0
18	37153557	.	T	G	4	0	4	0	2	6	0	0
18	37155872	.	T	A	5	2	7	0	1	8	0	0
18	39523000	.	G	T	1	2	3	0	1	4	0	0
18	40669758	.	T	C	2	4	6	0	0	6	0	0
18	40762874	.	T	A	3	2	5	0	0	5	0	0
18	41364890	.	T	C	2	2	4	0	0	4	0	0
18	41805831	.	C	T	1	1	2	0	0	2	0	0
18	43900299	.	G	A	0	7	7	0	0	7	0	0
18	44321949	.	T	C	1	3	4	0	0	4	0	0
18	44365197	.	G	A	0	37	37	0	0	37	0	0
18	44366129	.	T	C	6	10	16	0	0	16	0	0
18	44366155	.	T	C	5	0	5	0	16	21	0	0
18	44597048	.	G	A	1	2	3	0	0	3	0	0
18	44615861	.	A	T	0	7	7	0	2	9	0	0
18	44905671	.	T	C	1	2	3	0	0	3	0	0
18	45114550	.	C	T	1	3	4	0	0	4	0	0
18	45231238	.	C	T	3	2	5	0	0	5	0	0
18	45235903	.	G	T	0	2	2	0	1	3	0	0
18	45235924	.	T	C	1	0	1	0	0	1	0	0
18	45257475	.	C	T	5	7	12	0	0	12	0	0
18	45260131	.	T	C	8	8	16	0	0	16	0	0
18	45260228	.	T	C	2	3	5	0	0	5	0	0
18	45260316	.	A	C	5	4	9	0	0	9	0	0
18	45261177	.	C	T	6	5	11	0	0	11	0	0
18	45261203	.	T	C	4	3	7	0	0	7	0	0
18	45261284	.	A	C	7	3	10	0	2	12	0	0
18	45261299	.	T	A	8	2	10	0	0	10	0	0
18	45261319	.	A	T	8	5	13	0	0	13	0	0
18	45261355	.	C	T	7	7	14	0	0	14	0	0
18	45261369	.	G	T	7	5	12	0	1	13	0	0
18	45261412	.	A	G	1	0	1	0	7	8	0	0
18	45261845	.	T	A	3	2	5	0	0	5	0	0
18	45261968	.	C	T	5	4	9	0	0	9	0	0
18	45262000	.	G	A	3	5	8	0	0	8	0	0
18	45262327	.	A	G	4	2	6	0	1	7	0	0
18	45262397	.	C	T	5	6	11	0	0	11	0	0
18	45262440	.	C	A	6	7	13	0	0	13	0	0
18	45262469	.	C	A	5	5	10	0	0	10	0	0
18	45550831	.	G	C	0	12	12	0	9	21	0	0
18	45550839	.	A	C	8	12	20	0	2	22	0	0
18	45561677	.	G	T	1	2	3	0	0	3	0	0
18	45563800	.	A	C	4	7	11	0	1	12	0	0
18	45574140	.	A	G	17	11	28	0	2	30	0	0
18	45574232	.	A	G	7	13	20	0	3	23	0	0
18	45575079	.	G	A	1	9	10	0	19	29	0	0
18	45578543	.	A	G	4	5	9	0	0	9	0	0
18	45581704	.	C	A	9	6	15	0	0	15	0	0
18	45584036	.	C	T	8	12	20	0	0	20	0	0
18	45586597	.	G	A	2	1	3	0	6	9	0	0
18	45591836	.	A	T	9	15	24	0	2	26	0	0
18	45591929	.	G	A	9	6	15	0	1	16	0	0
18	45592002	.	A	C	8	4	12	0	0	12	0	0
18	45592031	.	G	A	9	7	16	0	0	16	0	0
18	45649916	.	A	G	6	0	6	0	6	12	0	0
18	45651032	.	C	T	5	5	10	0	0	10	0	0
18	45651731	.	T	A	3	6	9	0	1	10	0	0
18	45656089	.	T	C	3	3	6	0	2	8	0	0
18	45677240	.	A	G	3	3	6	0	1	7	0	0
18	45677259	.	T	C	2	3	5	0	0	5	0	0
18	45682029	.	G	A	0	2	2	0	1	3	0	0
18	45684977	.	T	C	2	2	4	0	1	5	0	0
18	45685907	.	A	G	2	0	2	0	3	5	0	0
18	45686225	.	A	T	5	2	7	0	0	7	0	0
18	45686267	.	G	A	3	2	5	0	1	6	0	0
18	45686452	.	A	G	3	5	8	0	0	8	0	0
18	45686483	.	A	C	3	4	7	0	0	7	0	0
18	45686664	.	T	C	6	8	14	0	1	15	0	0
18	45686840	.	T	C	3	4	7	0	0	7	0	0
18	45687156	.	T	G	5	0	5	0	4	9	0	0
18	45687258	.	G	C	1	5	6	0	0	6	0	0
18	45689081	.	C	T	0	1	1	0	0	1	0	0
18	45689115	.	G	C	2	3	5	0	0	5	0	0
18	45694762	.	G	A	5	1	6	0	1	7	0	0
18	45697582	.	C	T	4	3	7	0	0	7	0	0
18	45697833	.	A	T	2	4	6	0	0	6	0	0
18	45698344	.	C	A	4	2	6	0	0	6	0	0
18	45734521	.	G	C	10	7	17	0	1	18	0	0
18	45740194	.	T	C	4	10	14	0	0	14	0	0
18	45743518	.	G	A	2	9	11	0	1	12	0	0
18	45743522	.	G	A	2	10	12	0	0	12	0	0
18	45743555	.	C	A	2	10	12	0	0	12	0	0
18	45745504	.	A	T	4	2	6	0	0	6	0	0
18	45759309	.	G	T	3	5	8	0	0	8	0	0
18	45786801	.	T	C	17	13	30	0	2	32	0	0
18	45807942	.	G	C	0	14	14	0	7	21	0	0
18	45818602	.	C	T	16	12	28	0	1	29	0	0
18	45820510	.	G	A	0	0	0	0	3	3	0	0
18	45820588	.	A	G	16	8	24	0	0	24	0	0
18	45821780	.	T	C	10	6	16	0	0	16	0	0
18	45824315	.	C	T	8	20	28	0	0	28	0	0
18	45824467	.	G	A	0	7	7	0	15	22	0	0
18	45840402	.	A	G	8	0	8	0	7	15	0	0
18	45842491	.	T	C	6	7	13	0	0	13	0	0
18	45842679	.	G	A	1	10	11	0	6	17	0	0
18	45844458	.	C	T	15	17	32	0	0	32	0	0
18	45844473	.	A	T	13	19	32	0	1	33	0	0
18	45849253	.	T	C	5	3	8	0	0	8	0	0
18	45849283	.	C	T	15	6	21	0	1	22	0	0
18	45851540	.	G	A	0	6	6	0	6	12	0	0
18	45875986	.	T	C	1	2	3	0	0	3	0	0
18	45885709	.	A	G	2	3	5	0	0	5	0	0
18	45885711	.	T	A	2	3	5	0	0	5	0	0
18	45886318	.	G	T	1	2	3	0	0	3	0	0
18	45886634	.	C	T	1	1	2	0	0	2	0	0
18	45887046	.	T	C	4	2	6	0	0	6	0	0
18	45932359	.	C	T	3	1	4	0	0	4	0	0
18	45932401	.	C	A	2	1	3	0	0	3	0	0
18	45934691	.	G	T	1	3	4	0	0	4	0	0
18	45936773	.	G	A	1	1	2	0	0	2	0	0
18	45944522	.	G	A	1	5	6	0	0	6	0	0
18	45947936	.	A	G	1	0	1	0	2	3	0	0
18	45947946	.	C	T	2	3	5	0	0	5	0	0
18	45948071	.	C	A	2	3	5	0	0	5	0	0
18	45948295	.	T	C	1	2	3	0	0	3	0	0
18	45955140	.	T	A	16	7	23	0	2	25	0	0
18	45955142	.	T	C	16	7	23	0	2	25	0	0
18	45962620	.	T	C	20	15	35	0	2	37	0	0
18	45967083	.	A	G	18	18	36	0	1	37	0	0
18	45967107	.	C	T	21	19	40	0	0	40	0	0
18	45969252	.	C	A	4	4	8	0	1	9	0	0
18	45979887	.	C	T	4	8	12	0	0	12	0	0
18	45983268	.	A	C	44	12	56	0	3	59	0	0
18	46003902	.	A	T	1	1	2	0	0	2	0	0
18	46010180	.	A	G	7	8	15	0	0	15	0	0
18	46010243	.	C	T	3	3	6	0	0	6	0	0
18	46012619	.	A	C	2	5	7	0	0	7	0	0
18	46012631	.	C	T	1	4	5	0	0	5	0	0
18	46020069	.	C	T	3	2	5	0	0	5	0	0
18	46059029	.	A	G	3	2	5	0	0	5	0	0
18	46059095	.	A	G	11	8	19	0	1	20	0	0
18	46061242	.	G	A	8	5	13	0	0	13	0	0
18	46063648	.	C	T	6	9	15	0	0	15	0	0
18	46107344	.	A	G	3	3	6	0	0	6	0	0
18	46116974	.	C	T	3	4	7	0	0	7	0	0
18	46117139	.	T	C	4	2	6	0	0	6	0	0
18	46117272	.	T	C	5	2	7	0	0	7	0	0
18	46117466	.	T	G	1	2	3	0	0	3	0	0
18	46118881	.	C	A	1	4	5	0	0	5	0	0
18	46118929	.	A	G	3	5	8	0	0	8	0	0
18	46118953	.	T	C	2	0	2	0	3	5	0	0
18	46194102	.	C	G	3	3	6	0	0	6	0	0
18	46194243	.	T	C	7	4	11	0	1	12	0	0
18	46194360	.	T	G	7	4	11	0	0	11	0	0
18	46196280	.	C	T	0	0	0	0	1	1	0	0
18	46198152	.	G	C	12	6	18	0	0	18	0	0
18	46198253	.	G	T	9	10	19	0	0	19	0	0
18	46202801	.	T	C	9	11	20	0	0	20	0	0
18	46203195	.	T	C	10	0	10	0	16	26	0	0
18	46203199	.	C	T	11	12	23	0	2	25	0	0
18	46203291	.	G	A	9	11	20	0	1	21	0	0
18	46203457	.	G	T	15	4	19	0	2	21	0	0
18	46203562	.	T	C	4	13	17	0	2	19	0	0
18	46203563	.	C	T	0	13	13	0	6	19	0	0
18	46211270	.	A	T	3	3	6	0	0	6	0	0
18	46211271	.	C	T	0	3	3	0	3	6	0	0
18	46212074	.	A	T	2	2	4	0	0	4	0	0
18	46212555	.	C	T	0	2	2	0	1	3	0	0
18	46212572	.	G	A	1	4	5	0	0	5	0	0
18	46270486	.	A	G	1	1	2	0	0	2	0	0
18	46362772	.	G	T	10	8	18	0	7	25	0	0
18	46367691	.	G	C	0	1	1	0	1	2	0	0
18	46368771	.	C	T	0	5	5	0	3	8	0	0
18	46368924	.	C	A	1	4	5	0	0	5	0	0
18	46369173	.	T	C	3	5	8	0	0	8	0	0
18	46391945	.	T	C	2	1	3	0	0	3	0	0
18	46393508	.	G	A	0	3	3	0	1	4	0	0
18	46395965	.	G	C	21	23	44	0	3	47	0	0
18	46400979	.	A	G	1	1	2	0	0	2	0	0
18	46401137	.	T	C	5	5	10	0	2	12	0	0
18	46414299	.	C	T	0	5	5	0	7	12	0	0
18	46417624	.	T	C	15	10	25	0	2	27	0	0
18	46417681	.	G	T	10	12	22	0	0	22	0	0
18	46417775	.	T	C	16	1	17	0	10	27	0	0
18	46417807	.	A	G	16	9	25	0	0	25	0	0
18	46418281	.	T	C	11	0	11	0	9	20	0	0
18	46418458	.	C	T	0	6	6	0	13	19	0	0
18	46418776	.	C	T	0	7	7	0	7	14	0	0
18	46453240	.	C	T	0	5	5	0	2	7	0	0
18	46634497	.	A	G	0	3	3	0	0	3	0	0
18	46634544	.	T	C	4	7	11	0	0	11	0	0
18	46635257	.	G	A	3	6	9	0	0	9	0	0
18	46635390	.	G	C	4	4	8	0	0	8	0	0
18	46635876	.	G	A	3	6	9	0	1	10	0	0
18	46653253	.	T	G	2	7	9	0	0	9	0	0
18	46653284	.	A	G	4	9	13	0	0	13	0	0
18	46684230	.	A	T	4	4	8	0	1	9	0	0
18	46684258	.	G	T	10	7	17	0	0	17	0	0
18	46699773	.	G	A	28	16	44	0	2	46	0	0
18	46702492	.	G	A	22	23	45	0	0	45	0	0
18	46714896	.	A	G	15	13	28	0	3	31	0	0
18	46729044	.	A	G	7	9	16	0	0	16	0	0
18	46729321	.	A	G	13	7	20	0	0	20	0	0
18	46732406	.	C	G	3	4	7	0	1	8	0	0
18	46732417	.	T	A	2	2	4	0	0	4	0	0
18	46735972	.	T	C	0	2	2	0	0	2	0	0
18	46738862	.	C	A	0	13	13	0	18	31	0	0
18	46738955	.	A	C	21	17	38	0	1	39	0	0
18	46738990	.	A	T	20	18	38	0	1	39	0	0
18	47301204	.	T	C	4	6	10	0	0	10	0	0
18	47305433	.	A	G	2	2	4	0	0	4	0	0
18	47306782	.	A	G	3	2	5	0	1	6	0	0
18	47566919	.	A	T	3	1	4	0	0	4	0	0
18	48640143	.	G	C	0	7	7	0	3	10	0	0
18	48640155	.	G	C	0	7	7	0	3	10	0	0
18	48640284	.	C	G	4	0	4	0	7	11	0	0
18	48640317	.	G	T	0	2	2	0	5	7	0	0
18	48640348	.	A	G	4	0	4	0	3	7	0	0
18	48640417	.	G	C	4	7	11	0	0	11	0	0
18	48640420	.	A	G	4	6	10	0	0	10	0	0
18	48641451	.	T	A	1	2	3	0	0	3	0	0
18	48642821	.	C	T	3	4	7	0	0	7	0	0
18	48643055	.	A	G	1	4	5	0	1	6	0	0
18	48643438	.	A	G	2	0	2	0	2	4	0	0
18	48643458	.	A	G	2	2	4	0	0	4	0	0
18	48643490	.	A	G	1	1	2	0	1	3	0	0
18	48745366	.	C	A	1	2	3	0	0	3	0	0
18	48794005	.	G	A	4	5	9	0	0	9	0	0
18	48803191	.	C	T	4	2	6	0	1	7	0	0
18	48807200	.	C	G	2	0	2	0	2	4	0	0
18	48807499	.	A	G	2	3	5	0	0	5	0	0
18	48807521	.	T	C	1	4	5	0	0	5	0	0
18	48808099	.	A	G	3	6	9	0	0	9	0	0
18	48808372	.	G	A	3	4	7	0	0	7	0	0
18	48808396	.	A	G	4	4	8	0	0	8	0	0
18	48808552	.	T	C	3	4	7	0	0	7	0	0
18	48808659	.	G	A	0	3	3	0	4	7	0	0
18	48808708	.	T	A	4	4	8	0	0	8	0	0
18	48809226	.	G	A	2	4	6	0	0	6	0	0
18	48864856	.	T	C	6	3	9	0	0	9	0	0
18	48864944	.	C	T	7	8	15	0	0	15	0	0
18	48898641	.	C	T	1	0	1	0	0	1	0	0
18	48928230	.	C	T	12	16	28	0	0	28	0	0
18	48928240	.	A	G	13	1	14	0	17	31	0	0
18	48928342	.	A	G	12	3	15	0	15	30	0	0
18	48928387	.	T	A	11	20	31	0	1	33	1	0
18	48934524	.	T	C	6	6	12	0	0	12	0	0
18	48934593	.	T	C	2	4	6	0	0	6	0	0
18	48934805	.	A	G	8	17	25	0	2	27	0	0
18	48934833	.	T	C	8	18	26	0	1	27	0	0
18	48935170	.	G	A	14	16	30	0	1	31	0	0
18	48935279	.	T	G	19	13	32	0	2	34	0	0
18	48935282	.	T	G	20	15	35	0	1	36	0	0
18	48935709	.	A	G	14	16	30	0	0	30	0	0
18	48935907	.	T	C	7	8	15	0	2	17	0	0
18	48957783	.	G	A	0	3	3	0	4	7	0	0
18	48964912	.	G	C	2	2	4	0	0	4	0	0
18	48964915	.	G	A	0	2	2	0	2	4	0	0
18	48966177	.	C	T	1	1	2	0	0	2	0	0
18	48967500	.	T	C	5	2	7	0	0	7	0	0
18	48968436	.	C	G	4	0	4	0	4	8	0	0
18	48971165	.	T	C	4	4	8	0	1	9	0	0
18	48971192	.	A	G	2	2	4	0	0	4	0	0
18	48972490	.	A	T	9	9	18	0	2	20	0	0
18	49154000	.	G	A	0	2	2	0	7	9	0	0
18	49154328	.	G	A	3	10	13	0	0	13	0	0
18	49154458	.	G	T	7	7	14	0	0	14	0	0
18	49154483	.	G	T	0	9	9	0	11	20	0	0
18	49154525	.	C	T	14	8	22	0	1	23	0	0
18	49154527	.	T	C	14	8	22	0	1	23	0	0
18	49155045	.	A	G	4	0	4	0	9	13	0	0
18	49155211	.	C	A	10	5	15	0	1	16	0	0
18	49155303	.	G	A	1	8	9	0	0	9	0	0
18	49155941	.	C	T	7	8	15	0	0	15	0	0
18	49155956	.	T	C	9	13	22	0	0	22	0	0
18	49155976	.	A	T	4	11	15	0	0	15	0	0
18	49156009	.	G	C	8	7	15	0	0	15	0	0
18	49156077	.	A	G	5	0	5	0	5	10	0	0
18	49214171	.	A	G	1	2	3	0	0	3	0	0
18	49225590	.	A	G	2	0	2	0	4	6	0	0
18	49241958	.	A	G	1	3	4	0	0	4	0	0
18	49242211	.	G	T	0	2	2	0	1	3	0	0
18	49244819	.	C	A	4	4	8	0	0	8	0	0
18	49244821	.	C	A	4	4	8	0	0	8	0	0
18	49245256	.	G	C	3	2	5	0	1	7	1	0
18	49247010	.	A	G	2	2	4	0	0	4	0	0
18	49247020	.	T	C	1	1	2	0	1	3	0	0
18	49248524	.	G	T	4	5	9	0	0	9	0	0
18	49261687	.	T	C	5	1	6	0	0	6	0	0
18	49265001	.	G	T	11	7	18	0	0	18	0	0
18	49265002	.	G	T	10	7	17	0	1	18	0	0
18	49266523	.	A	G	1	3	4	0	0	4	0	0
18	49266589	.	A	G	6	7	13	0	0	13	0	0
18	49266635	.	A	G	3	4	7	0	0	7	0	0
18	49266715	.	C	T	3	3	6	0	1	7	0	0
18	49266746	.	A	G	2	4	6	0	0	6	0	0
18	49266998	.	A	G	6	6	12	0	0	12	0	0
18	49267489	.	A	G	1	2	3	0	0	3	0	0
18	49267629	.	A	G	6	0	6	0	9	15	0	0
18	49267645	.	T	A	6	8	14	0	0	14	0	0
18	49267665	.	A	T	5	7	12	0	1	13	0	0
18	49267682	.	T	A	4	3	7	0	0	8	1	0
18	49267701	.	A	T	3	3	6	0	0	6	0	0
18	49267832	.	A	G	2	2	4	0	0	4	0	0
18	49274616	.	C	T	3	2	5	0	1	6	0	0
18	49274639	.	T	G	2	4	6	0	0	6	0	0
18	49274729	.	C	T	0	2	2	0	1	3	0	0
18	49274745	.	C	A	0	2	2	0	1	3	0	0
18	49310668	.	A	G	2	4	6	0	0	6	0	0
18	49310944	.	T	A	2	3	5	0	0	5	0	0
18	49311466	.	T	A	2	1	3	0	0	3	0	0
18	49412259	.	T	C	4	2	6	0	0	6	0	0
18	49412367	.	G	T	3	4	7	0	0	7	0	0
18	49412394	.	A	G	2	4	6	0	0	6	0	0
18	49412514	.	T	C	5	4	9	0	0	9	0	0
18	49412709	.	G	A	0	5	5	0	4	9	0	0
18	49428280	.	G	A	3	4	7	0	0	7	0	0
18	49428793	.	T	C	5	4	9	0	0	9	0	0
18	49446190	.	G	T	2	5	7	0	0	7	0	0
18	49446254	.	T	G	3	4	7	0	1	8	0	0
18	49446293	.	C	G	4	8	12	0	1	13	0	0
18	49446312	.	G	A	4	7	11	0	3	14	0	0
18	49446398	.	G	A	5	3	8	0	0	8	0	0
18	49446456	.	A	G	5	0	5	0	2	7	0	0
18	49446490	.	A	G	4	4	8	0	0	8	0	0
18	49446491	.	A	G	3	5	8	0	0	8	0	0
18	49446796	.	C	A	4	2	6	0	0	6	0	0
18	49446803	.	T	A	4	2	6	0	0	6	0	0
18	49447008	.	C	A	9	4	13	0	0	13	0	0
18	49447041	.	G	A	0	6	6	0	6	12	0	0
18	49969631	.	A	C	3	4	7	0	2	9	0	0
18	50037820	.	C	T	5	3	8	0	0	8	0	0
18	50038651	.	A	G	3	0	3	0	3	6	0	0
18	50038720	.	T	G	2	7	9	0	0	9	0	0
18	50038721	.	G	T	2	6	8	0	1	9	0	0
18	50039045	.	C	G	4	0	4	0	4	8	0	0
18	50039295	.	C	A	3	3	6	0	0	6	0	0
18	50039536	.	G	A	0	3	3	0	3	6	0	0
18	50039852	.	G	T	4	11	15	0	0	15	0	0
18	50039939	.	C	T	8	3	11	0	0	11	0	0
18	50047733	.	A	G	0	2	2	0	0	2	0	0
18	50093398	.	C	A	2	2	4	0	0	4	0	0
18	50276173	.	C	T	14	8	22	0	0	22	0	0
18	50276435	.	G	A	6	18	24	0	2	26	0	0
18	50276476	.	C	G	2	4	6	0	1	7	0	0
18	50279112	.	A	T	11	13	24	0	4	28	0	0
18	50353650	.	C	T	27	15	42	0	0	42	0	0
18	50356440	.	G	A	20	18	38	0	5	43	0	0
18	50356518	.	C	A	23	18	41	0	10	52	1	0
18	50356532	.	G	A	26	25	51	0	0	51	0	0
18	50356632	.	T	C	15	18	33	0	1	34	0	0
18	50495604	.	C	T	1	4	5	0	0	5	0	0
18	50523854	.	T	G	0	1	1	0	0	1	0	0
18	50523952	.	T	G	3	2	5	0	0	5	0	0
18	50524008	.	C	T	2	2	4	0	0	4	0	0
18	50529552	.	T	A	1	1	2	0	0	2	0	0
18	50532421	.	C	T	11	5	16	0	1	17	0	0
18	50536843	.	C	T	1	4	5	0	4	9	0	0
18	50537647	.	A	G	4	1	5	0	1	6	0	0
18	50537884	.	G	A	6	10	16	0	0	16	0	0
18	50538019	.	A	C	9	6	15	0	3	18	0	0
18	50538020	.	G	A	11	7	18	0	0	18	0	0
18	50538235	.	T	C	9	5	14	0	0	14	0	0
18	50538268	.	A	G	5	10	15	0	0	15	0	0
18	50538289	.	T	C	7	10	17	0	0	17	0	0
18	50538340	.	T	C	3	14	17	0	0	17	0	0
18	50538442	.	T	C	6	5	11	0	1	12	0	0
18	50538617	.	C	G	2	4	6	0	0	6	0	0
18	50538760	.	G	A	3	6	9	0	0	9	0	0
18	50538790	.	A	T	4	3	7	0	1	8	0	0
18	50538875	.	G	C	3	2	5	0	0	5	0	0
18	50538969	.	T	G	1	8	9	0	0	9	0	0
18	50539041	.	G	T	3	5	8	0	0	8	0	0
18	50539271	.	G	A	2	5	7	0	0	7	0	0
18	50539341	.	G	C	2	5	7	0	0	7	0	0
18	50579546	.	G	A	4	5	9	0	1	10	0	0
18	50579551	.	C	T	4	7	11	0	0	11	0	0
18	50601049	.	T	C	2	0	2	0	4	6	0	0
18	50601149	.	G	A	3	7	10	0	0	10	0	0
18	50601426	.	C	G	8	4	12	0	2	14	0	0
18	50601436	.	C	A	8	4	12	0	1	13	0	0
18	50601630	.	C	A	14	14	28	0	3	31	0	0
18	50601636	.	A	G	19	12	31	0	2	33	0	0
18	50606024	.	T	C	7	0	7	0	8	15	0	0
18	50614145	.	T	A	10	9	19	0	1	20	0	0
18	50689577	.	T	C	0	4	4	0	0	4	0	0
18	50689583	.	G	A	4	0	4	0	0	4	0	0
18	50689914	.	T	C	0	2	2	0	0	2	0	0
18	50709147	.	C	A	1	1	2	0	15	17	0	0
18	50766625	.	G	A	5	2	7	0	0	7	0	0
19	372211	.	A	G	5	5	10	0	0	10	0	0
19	372766	.	A	G	10	2	12	0	2	14	0	0
19	372768	.	A	G	10	0	10	0	4	14	0	0
19	861077	.	T	A	1	2	3	0	0	3	0	0
19	981432	.	C	T	0	7	7	0	6	13	0	0
19	981483	.	A	G	1	1	2	0	0	2	0	0
19	985629	.	T	C	5	0	5	0	0	5	0	0
19	985638	.	G	C	4	0	4	0	0	4	0	0
19	987655	.	T	A	4	5	9	0	0	9	0	0
19	1008043	.	T	C	2	4	6	0	0	6	0	0
19	1008049	.	A	G	2	0	2	0	4	6	0	0
19	1010362	.	T	C	3	5	8	0	1	9	0	0
19	1010434	.	G	C	0	9	9	0	8	17	0	0
19	1010529	.	C	A	3	5	8	0	1	9	0	0
19	1010592	.	C	T	3	5	8	0	0	8	0	0
19	1010901	.	C	T	2	2	4	0	0	4	0	0
19	1010904	.	T	A	2	2	4	0	0	4	0	0
19	1011091	.	C	T	5	3	8	0	1	9	0	0
19	1011530	.	A	G	5	2	7	0	0	7	0	0
19	1011697	.	A	C	4	3	7	0	0	7	0	0
19	1012048	.	G	A	0	9	9	0	6	15	0	0
19	1012085	.	A	C	5	2	7	0	1	9	1	0
19	1019153	.	T	C	15	1	16	0	13	29	0	0
19	1021490	.	C	T	1	4	5	0	0	5	0	0
19	1097579	.	A	G	3	1	4	0	4	8	0	0
19	1097613	.	T	C	1	1	2	0	0	2	0	0
19	1097616	.	T	C	1	1	2	0	0	2	0	0
19	1108290	.	C	T	13	8	21	0	3	24	0	0
19	1110528	.	G	A	5	5	10	0	1	11	0	0
19	1111871	.	T	C	6	8	14	0	0	14	0	0
19	1111882	.	G	T	4	8	12	0	1	13	0	0
19	1111982	.	T	G	3	2	5	0	0	5	0	0
19	1111983	.	G	A	3	2	5	0	0	5	0	0
19	1112032	.	C	A	1	3	4	0	0	4	0	0
19	1112121	.	T	C	4	2	6	0	0	6	0	0
19	1112467	.	G	T	1	3	4	0	0	4	0	0
19	1185244	.	T	C	4	5	9	0	0	9	0	0
19	1185343	.	G	A	0	11	11	0	10	21	0	0
19	1185485	.	A	G	14	12	26	0	0	26	0	0
19	1331064	.	G	T	4	3	7	0	0	7	0	0
19	1331105	.	T	A	4	4	8	0	0	8	0	0
19	1331146	.	C	A	9	8	17	0	0	17	0	0
19	1331394	.	T	G	9	9	18	0	0	18	0	0
19	1358114	.	A	G	2	1	3	0	0	3	0	0
19	1359700	.	T	G	2	3	5	0	0	5	0	0
19	1359703	.	G	A	1	4	5	0	0	5	0	0
19	1361932	.	C	T	4	5	9	0	0	9	0	0
19	1362021	.	T	G	3	1	4	0	0	4	0	0
19	1370542	.	T	G	7	0	7	0	15	22	0	0
19	1370714	.	A	G	8	5	13	0	0	13	0	0
19	1370725	.	A	C	8	5	13	0	0	13	0	0
19	1384408	.	A	T	2	4	6	0	0	6	0	0
19	1392134	.	G	A	1	11	12	0	18	30	0	0
19	1392482	.	T	C	2	3	5	0	1	6	0	0
19	1392544	.	T	A	7	5	12	0	0	12	0	0
19	1392565	.	A	G	8	8	16	0	1	17	0	0
19	1392586	.	T	A	8	10	18	0	0	18	0	0
19	1393073	.	T	A	11	18	29	0	0	29	0	0
19	1393085	.	C	A	10	17	27	0	0	27	0	0
19	1393176	.	C	T	9	6	15	0	1	16	0	0
19	1393199	.	A	G	7	8	15	0	1	16	0	0
19	1393212	.	A	G	5	0	5	0	8	13	0	0
19	1406549	.	A	C	6	5	11	0	1	12	0	0
19	1406593	.	T	G	5	5	10	0	1	11	0	0
19	1406649	.	T	C	4	2	6	0	0	6	0	0
19	1406795	.	A	C	4	7	11	0	0	11	0	0
19	1407181	.	T	A	3	3	6	0	0	6	0	0
19	1407396	.	A	G	7	3	10	0	0	10	0	0
19	1407731	.	G	A	6	5	11	0	0	12	1	0
19	1410896	.	A	G	2	4	6	0	0	6	0	0
19	1411193	.	G	A	3	3	6	0	0	6	0	0
19	1411374	.	G	C	3	2	5	0	0	5	0	0
19	1561359	.	T	C	2	3	5	0	0	5	0	0
19	1562020	.	G	A	0	3	3	0	2	5	0	0
19	1562086	.	G	A	2	4	6	0	0	6	0	0
19	1562570	.	C	T	3	4	7	0	0	7	0	0
19	1618967	.	G	A	2	3	5	0	0	5	0	0
19	1669830	.	G	A	2	1	3	0	1	4	0	0
19	1685215	.	G	A	3	2	5	0	0	5	0	0
19	1685690	.	A	G	2	1	3	0	3	6	0	0
19	1685755	.	A	G	1	3	4	0	0	4	0	0
19	1707015	.	A	T	1	1	2	0	0	2	0	0
19	1735376	.	G	A	3	4	7	0	0	7	0	0
19	1735882	.	G	A	0	2	2	0	0	2	0	0
19	1737359	.	A	G	2	3	5	0	0	5	0	0
19	1790838	.	A	G	5	3	8	0	0	8	0	0
19	1801819	.	G	A	0	1	1	0	0	1	0	0
19	1807390	.	C	T	2	2	4	0	0	4	0	0
19	1807393	.	G	C	2	1	3	0	0	3	0	0
19	1848057	.	G	A	5	2	7	0	0	7	0	0
19	1848062	.	A	T	3	2	5	0	2	7	0	0
19	1848239	.	G	A	10	3	13	0	1	14	0	0
19	1848298	.	A	G	8	3	11	0	1	12	0	0
19	1848301	.	G	A	1	4	5	0	7	12	0	0
19	1848334	.	T	C	4	3	7	0	0	7	0	0
19	1852303	.	T	C	15	6	21	0	3	24	0	0
19	1853802	.	A	G	3	2	5	0	0	5	0	0
19	1853826	.	T	C	3	4	7	0	0	7	0	0
19	1856335	.	G	A	1	3	4	0	0	4	0	0
19	1856458	.	T	G	4	9	13	0	1	14	0	0
19	1856556	.	C	G	15	11	26	0	0	26	0	0
19	1856641	.	T	A	12	4	16	0	0	16	0	0
19	1856716	.	A	C	2	6	8	0	0	8	0	0
19	1858785	.	G	A	1	2	3	0	0	3	0	0
19	1868152	.	G	C	4	0	4	0	4	8	0	0
19	1868327	.	A	G	0	4	4	0	0	4	0	0
19	1868460	.	C	T	0	3	3	0	6	9	0	0
19	1870977	.	T	C	2	0	2	0	4	6	0	0
19	1872897	.	G	A	10	14	24	0	0	24	0	0
19	1877255	.	A	G	15	1	16	0	21	37	0	0
19	1877288	.	T	C	20	15	35	0	1	36	0	0
19	1877536	.	G	C	18	12	30	0	0	30	0	0
19	1877544	.	G	T	15	14	29	0	0	29	0	0
19	1878618	.	G	A	7	8	15	0	2	17	0	0
19	1878630	.	C	G	7	7	14	0	0	14	0	0
19	1879923	.	G	C	4	4	8	0	0	8	0	0
19	1879951	.	C	T	2	0	2	0	0	2	0	0
19	1880602	.	T	C	0	5	5	0	0	5	0	0
19	1880836	.	G	A	0	2	2	0	3	5	0	0
19	1880886	.	T	C	9	6	15	0	0	15	0	0
19	1880916	.	T	C	6	3	9	0	0	9	0	0
19	1953569	.	A	G	17	20	37	0	1	39	1	0
19	1953583	.	G	T	19	21	40	0	2	42	0	0
19	1960987	.	T	G	16	18	34	0	0	34	0	0
19	1960997	.	T	C	14	20	34	0	1	35	0	0
19	1964016	.	G	A	0	3	3	0	1	4	0	0
19	1966136	.	C	T	0	1	1	0	0	1	0	0
19	1966150	.	G	A	0	1	1	0	0	1	0	0
19	1969817	.	A	G	0	0	0	0	1	1	0	0
19	1990839	.	G	C	1	2	3	0	0	3	0	0
19	1992908	.	G	C	1	2	3	0	0	3	0	0
19	1993007	.	C	T	6	3	9	0	2	11	0	0
19	1995133	.	A	T	3	2	5	0	0	5	0	0
19	1995229	.	G	A	0	2	2	0	5	7	0	0
19	1995367	.	A	G	3	0	3	0	6	9	0	0
19	1995404	.	G	A	4	3	7	0	0	7	0	0
19	1995590	.	T	G	4	4	8	0	0	8	0	0
19	1995594	.	A	G	4	3	7	0	0	7	0	0
19	1995733	.	C	T	1	2	3	0	0	3	0	0
19	1995839	.	T	A	4	2	6	0	0	6	0	0
19	1995915	.	A	G	2	0	2	0	4	6	0	0
19	1995925	.	C	A	1	3	4	0	1	5	0	0
19	1995982	.	G	C	2	2	4	0	0	4	0	0
19	1996494	.	G	T	0	2	2	0	5	7	0	0
19	1996504	.	T	C	4	2	6	0	0	6	0	0
19	1996550	.	G	A	2	3	5	0	0	5	0	0
19	1996639	.	T	G	2	2	4	0	1	5	0	0
19	1996776	.	G	A	1	8	9	0	0	9	0	0
19	1996831	.	A	C	1	2	3	0	1	4	0	0
19	1996995	.	C	T	1	2	3	0	0	3	0	0
19	1997010	.	G	A	1	2	3	0	0	3	0	0
19	1997159	.	T	C	2	3	5	0	0	5	0	0
19	1997165	.	C	T	3	2	5	0	0	5	0	0
19	1997638	.	T	A	3	3	6	0	0	6	0	0
19	1997767	.	C	G	7	4	11	0	0	11	0	0
19	1997781	.	A	T	8	3	11	0	0	11	0	0
19	1997868	.	T	A	6	3	9	0	0	9	0	0
19	1998260	.	G	A	1	2	3	0	0	3	0	0
19	2000142	.	C	G	8	5	13	0	1	14	0	0
19	2001557	.	T	C	3	1	4	0	1	5	0	0
19	2001618	.	A	C	6	2	8	0	0	8	0	0
19	2002992	.	A	G	0	0	0	0	1	1	0	0
19	2003150	.	T	C	4	2	6	0	1	7	0	0
19	2003158	.	C	T	4	4	8	0	0	8	0	0
19	2003634	.	T	C	4	4	8	0	0	8	0	0
19	2003767	.	C	T	6	10	16	0	1	17	0	0
19	2003803	.	C	G	11	0	11	0	7	18	0	0
19	2003902	.	A	T	8	9	17	0	0	17	0	0
19	2003962	.	G	T	0	12	12	0	10	22	0	0
19	2004046	.	G	C	7	9	16	0	1	17	0	0
19	2019147	.	C	T	0	0	0	0	1	1	0	0
19	2019430	.	G	A	1	0	1	0	0	1	0	0
19	2019480	.	C	T	0	1	1	0	1	2	0	0
19	2064629	.	G	A	5	3	8	0	0	8	0	0
19	2064762	.	G	C	5	3	8	0	0	8	0	0
19	2071597	.	T	C	0	1	1	0	0	1	0	0
19	2071672	.	A	G	1	0	1	0	0	1	0	0
19	2079996	.	A	G	1	1	2	0	0	2	0	0
19	2083254	.	C	T	1	2	3	0	0	3	0	0
19	2084982	.	G	A	2	4	6	0	0	6	0	0
19	2089667	.	C	A	2	1	3	0	0	3	0	0
19	2279284	.	C	T	1	6	7	0	0	7	0	0
19	2290753	.	T	C	1	0	1	0	1	2	0	0
19	2292831	.	T	C	1	1	2	0	0	2	0	0
19	2294971	.	G	C	3	5	8	0	0	8	0	0
19	2296760	.	A	T	8	6	14	0	0	14	0	0
19	2301010	.	T	C	1	7	8	0	0	8	0	0
19	2307248	.	C	A	3	5	8	0	0	8	0	0
19	2307268	.	C	T	1	3	4	0	0	4	0	0
19	2315511	.	C	T	0	5	5	0	4	9	0	0
19	2315666	.	A	G	8	4	12	0	1	13	0	0
19	2315752	.	A	T	6	5	11	0	0	11	0	0
19	2315936	.	C	T	2	2	4	0	1	5	0	0
19	2316510	.	T	C	8	7	15	0	0	15	0	0
19	2316729	.	G	C	3	3	6	0	0	6	0	0
19	2316765	.	T	C	4	3	7	0	1	8	0	0
19	2316894	.	T	C	5	3	8	0	0	8	0	0
19	2396421	.	T	C	2	0	2	0	2	4	0	0
19	2396492	.	C	A	5	2	7	0	0	7	0	0
19	2396647	.	C	T	2	3	5	0	0	5	0	0
19	2396926	.	G	A	1	2	3	0	0	3	0	0
19	2397268	.	A	T	1	2	3	0	0	3	0	0
19	2397559	.	T	C	4	2	6	0	0	6	0	0
19	2400403	.	G	A	4	0	4	0	1	5	0	0
19	2403906	.	T	C	2	1	3	0	3	6	0	0
19	2546871	.	T	A	3	4	7	0	0	7	0	0
19	2550676	.	G	A	7	2	9	0	3	12	0	0
19	2550839	.	C	T	3	4	7	0	0	7	0	0
19	2551178	.	A	G	6	6	12	0	0	12	0	0
19	2551214	.	C	T	3	8	11	0	0	11	0	0
19	2551518	.	G	A	1	2	3	0	5	8	0	0
19	2551727	.	C	T	7	9	16	0	0	16	0	0
19	2560950	.	A	G	4	4	8	0	0	8	0	0
19	2561048	.	A	C	4	9	13	0	2	15	0	0
19	2561739	.	G	A	0	5	5	0	9	14	0	0
19	2571439	.	C	T	2	0	2	0	0	2	0	0
19	2602934	.	G	A	2	8	10	0	0	10	0	0
19	2645115	.	C	T	2	4	6	0	0	6	0	0
19	2651272	.	A	G	0	4	4	0	0	4	0	0
19	2651344	.	G	A	0	1	1	0	2	3	0	0
19	2654388	.	A	T	5	5	10	0	0	10	0	0
19	2654424	.	C	T	5	11	16	0	0	16	0	0
19	2663609	.	A	G	7	10	17	0	0	17	0	0
19	2664125	.	G	A	3	7	10	0	2	12	0	0
19	2664394	.	C	T	9	12	21	0	1	22	0	0
19	2664613	.	T	C	7	6	13	0	2	15	0	0
19	2685839	.	T	C	5	3	8	0	2	10	0	0
19	2695314	.	G	A	10	7	17	0	0	17	0	0
19	2695351	.	A	G	5	0	5	0	4	9	0	0
19	2695358	.	G	A	3	3	6	0	0	6	0	0
19	2731100	.	C	T	1	1	2	0	0	2	0	0
19	2732833	.	C	T	6	4	10	0	0	10	0	0
19	2732836	.	G	A	6	4	10	0	0	10	0	0
19	2744169	.	C	G	3	2	5	0	0	5	0	0
19	2746008	.	G	A	0	6	6	0	8	14	0	0
19	2746134	.	C	T	5	0	5	0	0	5	0	0
19	2750162	.	G	A	0	2	2	0	1	3	0	0
19	2871511	.	A	G	5	12	17	0	1	18	0	0
19	2871553	.	C	T	5	3	8	0	0	8	0	0
19	2871559	.	G	A	2	3	5	0	0	5	0	0
19	2874618	.	T	C	1	0	1	0	0	1	0	0
19	2877298	.	A	C	2	4	6	0	0	6	0	0
19	2886952	.	G	A	5	3	8	0	0	8	0	0
19	2887046	.	G	C	0	2	2	0	2	4	0	0
19	2930597	.	A	G	7	7	14	0	0	14	0	0
19	2934321	.	A	G	0	2	2	0	0	2	0	0
19	2965923	.	A	G	1	1	2	0	0	2	0	0
19	2967894	.	A	G	2	3	5	0	0	5	0	0
19	3002047	.	G	A	0	2	2	0	3	5	0	0
19	3052828	.	A	G	1	2	3	0	0	3	0	0
19	3052836	.	A	T	1	2	3	0	0	3	0	0
19	3052904	.	A	T	1	2	3	0	0	3	0	0
19	3056629	.	C	T	6	4	10	0	0	10	0	0
19	3080572	.	G	A	3	4	7	0	0	7	0	0
19	3080647	.	G	A	5	1	6	0	1	7	0	0
19	3080657	.	T	G	8	4	12	0	0	12	0	0
19	3080712	.	T	A	7	6	13	0	1	14	0	0
19	3080863	.	A	T	5	3	8	0	0	8	0	0
19	3080907	.	A	T	4	2	6	0	0	6	0	0
19	3081008	.	A	G	3	0	3	0	5	8	0	0
19	3081020	.	A	G	8	4	12	0	0	12	0	0
19	3081106	.	C	G	3	1	4	0	1	5	0	0
19	3081122	.	A	T	3	2	5	0	0	5	0	0
19	3081154	.	G	C	1	2	3	0	0	3	0	0
19	3081206	.	G	T	2	3	5	0	0	5	0	0
19	3081628	.	T	C	3	2	5	0	0	5	0	0
19	3081704	.	A	T	1	4	5	0	0	5	0	0
19	3081927	.	G	A	9	3	12	0	0	12	0	0
19	3081933	.	G	A	0	5	5	0	9	14	0	0
19	3082053	.	T	C	12	4	16	0	0	16	0	0
19	3082102	.	C	T	10	5	15	0	1	16	0	0
19	3087025	.	A	G	5	7	12	0	0	12	0	0
19	3137727	.	C	T	0	32	32	0	15	47	0	0
19	3137761	.	C	A	16	29	45	0	0	47	2	0
19	3137803	.	A	T	31	17	48	0	3	51	0	0
19	3137888	.	T	C	24	1	25	0	26	51	0	0
19	3138166	.	G	T	20	3	23	0	1	24	0	0
19	3138325	.	A	C	28	21	49	0	2	51	0	0
19	3138355	.	T	G	28	15	43	0	2	45	0	0
19	3138638	.	T	C	13	1	14	0	18	32	0	0
19	3142260	.	T	C	0	0	0	0	1	1	0	0
19	3142286	.	C	G	0	1	1	0	0	1	0	0
19	3144567	.	A	G	0	1	1	0	0	1	0	0
19	3149236	.	T	C	10	9	19	0	1	20	0	0
19	3149296	.	A	C	9	21	30	0	1	31	0	0
19	3149320	.	T	G	9	23	32	0	0	32	0	0
19	3149368	.	A	T	7	27	34	0	1	35	0	0
19	3149515	.	T	C	5	4	9	0	0	9	0	0
19	3149516	.	T	C	5	0	5	0	4	9	0	0
19	3149692	.	A	G	10	13	23	0	1	24	0	0
19	3215468	.	A	G	1	1	2	0	0	2	0	0
19	3229424	.	A	G	2	1	3	0	0	3	0	0
19	3231206	.	T	C	1	1	2	0	0	2	0	0
19	3238395	.	T	A	17	27	44	0	2	46	0	0
19	3238425	.	T	C	19	24	43	0	2	45	0	0
19	3238721	.	T	A	34	28	62	0	0	62	0	0
19	3240409	.	G	C	30	23	53	0	2	55	0	0
19	3376893	.	G	C	1	0	1	0	2	3	0	0
19	3379035	.	G	T	1	1	2	0	0	2	0	0
19	3386258	.	T	A	7	12	19	0	0	19	0	0
19	3386358	.	A	G	6	8	14	0	0	14	0	0
19	3386485	.	C	A	3	11	14	0	1	15	0	0
19	3386873	.	C	T	8	14	22	0	2	24	0	0
19	3387040	.	C	A	0	12	12	0	9	21	0	0
19	3387068	.	A	C	11	11	22	0	3	25	0	0
19	3387097	.	C	G	14	13	27	0	2	29	0	0
19	3387506	.	G	A	16	14	30	0	3	33	0	0
19	3387713	.	G	A	19	19	38	0	1	39	0	0
19	3388376	.	T	C	15	15	30	0	2	32	0	0
19	3388467	.	T	C	15	17	32	0	0	32	0	0
19	3388617	.	G	A	15	13	28	0	2	30	0	0
19	3390203	.	G	A	10	16	26	0	0	26	0	0
19	3390283	.	G	T	7	3	10	0	0	10	0	0
19	3390506	.	C	G	3	1	4	0	0	4	0	0
19	3391479	.	G	A	6	4	10	0	1	11	0	0
19	3391530	.	G	T	8	5	13	0	1	14	0	0
19	3391608	.	T	A	13	5	18	0	0	18	0	0
19	3391669	.	A	G	12	3	15	0	1	16	0	0
19	3391805	.	T	G	5	12	17	0	1	18	0	0
19	3392127	.	G	A	5	9	14	0	1	15	0	0
19	3392178	.	C	T	8	4	12	0	0	12	0	0
19	3392415	.	G	T	9	10	19	0	0	19	0	0
19	3392481	.	A	G	5	5	10	0	1	12	1	0
19	3393128	.	A	T	5	8	13	0	0	13	0	0
19	3393343	.	G	C	8	4	12	0	0	12	0	0
19	3393437	.	T	A	7	9	16	0	0	16	0	0
19	3393924	.	G	A	7	6	13	0	1	14	0	0
19	3395277	.	C	G	0	5	5	0	4	9	0	0
19	3395435	.	C	T	0	5	5	0	0	5	0	0
19	3395457	.	T	A	2	3	5	0	1	6	0	0
19	3395523	.	G	A	1	2	3	0	1	4	0	0
19	3395763	.	T	A	1	9	10	0	1	11	0	0
19	3395889	.	A	G	6	3	9	0	0	10	1	0
19	3396103	.	A	G	2	4	6	0	0	6	0	0
19	3539839	.	C	A	1	0	1	0	0	1	0	0
19	3539840	.	C	T	0	0	0	0	1	1	0	0
19	3573912	.	A	T	1	7	8	0	0	8	0	0
19	3573971	.	A	G	2	3	5	0	3	8	0	0
19	3577907	.	C	A	3	4	7	0	0	7	0	0
19	3577953	.	A	C	3	4	7	0	1	8	0	0
19	3577994	.	A	G	2	3	5	0	0	5	0	0
19	3577997	.	A	G	2	3	5	0	0	5	0	0
19	3578233	.	C	T	1	2	3	0	0	3	0	0
19	3578234	.	C	T	1	2	3	0	0	3	0	0
19	3653989	.	C	T	3	6	9	0	0	9	0	0
19	3681077	.	T	C	4	4	8	0	0	8	0	0
19	3681134	.	C	T	2	5	7	0	2	9	0	0
19	3698060	.	A	G	1	0	1	0	0	1	0	0
19	3698249	.	C	G	0	1	1	0	0	1	0	0
19	3702941	.	G	A	0	5	5	0	5	10	0	0
19	3703149	.	A	G	6	6	12	0	1	13	0	0
19	3703178	.	C	T	4	8	12	0	0	12	0	0
19	3706875	.	C	T	1	2	3	0	0	3	0	0
19	3706902	.	C	G	4	0	4	0	3	7	0	0
19	3707235	.	A	G	11	12	23	0	0	23	0	0
19	3707328	.	A	G	0	0	0	0	4	4	0	0
19	3707334	.	G	A	3	2	5	0	0	5	0	0
19	3707562	.	T	A	1	3	4	0	0	4	0	0
19	3707576	.	C	T	1	4	5	0	0	5	0	0
19	3707625	.	G	A	0	5	5	0	5	10	0	0
19	3718110	.	A	T	14	4	18	0	0	18	0	0
19	3718222	.	G	A	12	17	29	0	1	30	0	0
19	3718251	.	C	A	9	20	29	0	1	30	0	0
19	3718330	.	G	A	16	18	34	0	2	36	0	0
19	3718415	.	G	T	19	18	37	0	2	39	0	0
19	3718675	.	C	A	25	18	43	0	1	44	0	0
19	3865928	.	C	T	0	9	9	0	7	16	0	0
19	3866029	.	C	T	8	8	16	0	1	17	0	0
19	3866031	.	G	A	6	10	16	0	1	17	0	0
19	3866075	.	T	C	13	4	17	0	2	19	0	0
19	3866102	.	A	G	12	6	18	0	3	21	0	0
19	3866289	.	C	G	5	7	12	0	2	14	0	0
19	3866424	.	A	T	13	18	31	0	2	33	0	0
19	3866727	.	C	T	0	15	15	0	19	34	0	0
19	3868535	.	T	C	8	3	11	0	2	13	0	0
19	3868541	.	C	T	1	5	6	0	9	15	0	0
19	3872419	.	C	T	0	5	5	0	0	5	0	0
19	3872833	.	C	T	12	10	22	0	2	24	0	0
19	3873019	.	C	T	5	7	12	0	1	13	0	0
19	3873055	.	C	T	0	4	4	0	0	4	0	0
19	3873847	.	A	C	5	5	10	0	2	12	0	0
19	3873955	.	G	A	5	10	15	0	1	16	0	0
19	3874195	.	A	G	10	7	17	0	0	17	0	0
19	3874277	.	C	A	5	6	11	0	0	11	0	0
19	3874339	.	G	A	7	4	11	0	0	11	0	0
19	3874381	.	G	A	8	6	14	0	1	15	0	0
19	3876296	.	C	T	6	2	8	0	0	8	0	0
19	3878548	.	C	T	8	11	19	0	0	19	0	0
19	3878565	.	G	C	6	4	10	0	1	11	0	0
19	3937971	.	T	C	21	27	48	0	3	51	0	0
19	3939887	.	C	T	16	7	23	0	0	23	0	0
19	3939902	.	G	T	22	11	33	0	0	33	0	0
19	3940022	.	C	T	1	16	17	0	18	35	0	0
19	3945750	.	G	T	9	7	16	0	1	17	0	0
19	4010146	.	A	G	5	9	14	0	1	15	0	0
19	4024467	.	T	C	2	3	5	0	0	5	0	0
19	4092834	.	G	A	0	1	1	0	0	1	0	0
19	4127217	.	G	A	3	3	6	0	0	6	0	0
19	4134782	.	A	G	1	1	2	0	0	2	0	0
19	4137043	.	G	A	1	2	3	0	0	3	0	0
19	4137044	.	A	G	1	2	3	0	0	3	0	0
19	4142717	.	T	C	2	4	6	0	0	6	0	0
19	4142777	.	G	A	1	3	4	0	0	4	0	0
19	4143053	.	A	T	1	2	3	0	0	3	0	0
19	4194072	.	T	C	1	1	2	0	0	2	0	0
19	4279835	.	A	C	3	7	10	0	0	10	0	0
19	4291716	.	C	T	1	0	1	0	0	1	0	0
19	4341539	.	T	C	7	8	15	0	0	15	0	0
19	4443334	.	T	C	3	2	5	0	1	6	0	0
19	4443403	.	T	C	8	5	13	0	0	13	0	0
19	4445154	.	T	C	4	4	8	0	0	8	0	0
19	4445222	.	A	T	1	2	3	0	0	3	0	0
19	4445269	.	T	C	4	3	7	0	1	8	0	0
19	4446293	.	A	G	5	3	8	0	0	8	0	0
19	4447322	.	G	T	4	1	5	0	0	5	0	0
19	4447347	.	G	A	1	3	4	0	0	4	0	0
19	4447403	.	A	T	2	6	8	0	0	8	0	0
19	4447502	.	T	A	9	7	16	0	0	16	0	0
19	4447683	.	T	G	2	0	2	0	4	6	0	0
19	4464173	.	C	T	1	2	3	0	0	3	0	0
19	4464232	.	G	A	1	5	6	0	0	6	0	0
19	4464338	.	G	A	2	3	5	0	0	5	0	0
19	4530146	.	A	G	0	0	0	0	1	1	0	0
19	4530264	.	T	C	5	3	8	0	0	8	0	0
19	4530872	.	G	T	1	7	8	0	4	12	0	0
19	4828379	.	T	G	5	3	8	0	0	8	0	0
19	4828395	.	T	C	4	2	6	0	0	6	0	0
19	4828428	.	A	T	3	2	5	0	0	5	0	0
19	4828463	.	A	G	4	2	6	0	0	6	0	0
19	4828464	.	A	T	4	2	6	0	0	6	0	0
19	4856825	.	C	A	1	4	5	0	2	7	0	0
19	4856852	.	A	T	4	3	7	0	0	7	0	0
19	4857547	.	G	A	10	3	13	0	0	13	0	0
19	4866919	.	T	C	12	8	20	0	0	20	0	0
19	4866936	.	C	T	11	7	18	0	2	20	0	0
19	4867128	.	C	T	14	8	22	0	1	23	0	0
19	4867168	.	G	C	10	12	22	0	0	22	0	0
19	4875478	.	G	A	1	4	5	0	0	5	0	0
19	4875529	.	C	T	8	10	18	0	0	18	0	0
19	4875583	.	A	G	7	5	12	0	0	12	0	0
19	4875595	.	A	G	3	4	7	0	2	9	0	0
19	4877141	.	T	C	8	4	12	0	0	12	0	0
19	4878742	.	G	T	7	7	14	0	1	15	0	0
19	4888471	.	T	G	4	5	9	0	0	9	0	0
19	4888744	.	A	G	9	9	18	0	1	19	0	0
19	4888756	.	G	A	0	7	7	0	12	19	0	0
19	4892154	.	G	A	4	4	8	0	0	8	0	0
19	4892590	.	C	T	3	1	4	0	1	5	0	0
19	4892628	.	A	G	5	5	10	0	0	10	0	0
19	4892643	.	T	C	6	8	14	0	0	14	0	0
19	4892787	.	C	T	2	3	5	0	0	5	0	0
19	4892940	.	G	A	0	7	7	0	3	10	0	0
19	4892946	.	A	T	3	6	9	0	2	11	0	0
19	4893033	.	A	G	2	0	2	0	4	6	0	0
19	4903998	.	A	G	11	9	20	0	2	22	0	0
19	4904042	.	A	T	8	4	12	0	5	17	0	0
19	4904127	.	C	T	8	3	11	0	0	11	0	0
19	4904407	.	T	C	1	2	3	0	0	3	0	0
19	4904429	.	G	A	4	3	7	0	0	7	0	0
19	4904766	.	T	C	6	3	9	0	1	10	0	0
19	4904972	.	T	C	7	2	9	0	1	10	0	0
19	4904991	.	T	C	9	4	13	0	1	14	0	0
19	4905088	.	G	T	17	7	24	0	0	24	0	0
19	4905175	.	G	A	1	4	5	0	1	6	0	0
19	4905229	.	T	C	7	4	11	0	2	13	0	0
19	4905239	.	C	T	7	5	12	0	1	13	0	0
19	4913087	.	A	G	3	7	10	0	1	11	0	0
19	4960956	.	G	A	2	3	5	0	0	5	0	0
19	4961656	.	A	G	3	2	5	0	0	5	0	0
19	4962019	.	C	T	4	2	6	0	0	6	0	0
19	4970776	.	C	T	0	2	2	0	0	2	0	0
19	4978660	.	G	T	1	2	3	0	0	3	0	0
19	4978704	.	C	G	1	2	3	0	0	3	0	0
19	4984668	.	T	G	6	5	11	0	0	11	0	0
19	4984739	.	G	A	4	4	8	0	0	8	0	0
19	4985064	.	T	A	8	6	14	0	0	14	0	0
19	4985808	.	A	T	4	2	6	0	0	6	0	0
19	5003359	.	T	G	3	2	5	0	0	5	0	0
19	5007465	.	G	A	4	2	6	0	0	6	0	0
19	5007549	.	G	A	14	11	25	0	0	25	0	0
19	5009251	.	A	C	5	3	8	0	0	8	0	0
19	5009489	.	G	A	6	2	8	0	0	8	0	0
19	5016071	.	T	C	4	4	8	0	0	8	0	0
19	5016257	.	G	C	7	0	7	0	2	9	0	0
19	5016302	.	T	G	14	11	25	0	1	26	0	0
19	5018340	.	A	G	3	2	5	0	0	5	0	0
19	5019697	.	G	C	5	7	12	0	0	12	0	0
19	5019712	.	A	T	3	4	7	0	0	7	0	0
19	5019736	.	A	G	0	1	1	0	0	1	0	0
19	5020451	.	G	A	3	1	4	0	1	5	0	0
19	5024541	.	C	T	0	1	1	0	0	1	0	0
19	5025813	.	T	C	3	0	3	0	3	6	0	0
19	5028136	.	G	A	4	3	7	0	0	7	0	0
19	5028605	.	A	G	2	4	6	0	0	6	0	0
19	5028719	.	C	T	0	1	1	0	2	3	0	0
19	5030032	.	T	C	6	2	8	0	1	9	0	0
19	5031461	.	G	A	3	0	3	0	0	3	0	0
19	5031617	.	T	C	1	1	2	0	0	2	0	0
19	5032178	.	T	C	3	4	7	0	0	7	0	0
19	5032199	.	A	C	2	3	5	0	0	5	0	0
19	5034965	.	G	A	7	4	11	0	1	12	0	0
19	5039148	.	A	G	2	2	4	0	1	5	0	0
19	5039491	.	A	T	5	7	12	0	0	12	0	0
19	5039530	.	T	C	3	0	3	0	1	4	0	0
19	5042062	.	T	C	4	0	4	0	10	14	0	0
19	5042074	.	G	A	4	9	13	0	0	13	0	0
19	5045606	.	C	T	0	6	6	0	4	10	0	0
19	5045639	.	A	G	0	3	3	0	0	3	0	0
19	5048954	.	T	A	1	2	3	0	0	3	0	0
19	5054876	.	C	T	1	0	1	0	0	1	0	0
19	5058763	.	G	A	1	3	4	0	0	4	0	0
19	5077114	.	C	T	0	2	2	0	0	2	0	0
19	5077167	.	A	G	12	6	18	0	0	18	0	0
19	5077173	.	C	T	6	11	17	0	1	18	0	0
19	5080112	.	A	C	2	1	3	0	0	3	0	0
19	5082095	.	A	G	28	18	46	0	7	53	0	0
19	5082161	.	C	T	12	16	28	0	2	30	0	0
19	5090035	.	C	G	21	25	46	0	1	47	0	0
19	5090264	.	G	A	23	18	41	0	0	41	0	0
19	5090409	.	G	A	10	25	35	0	0	35	0	0
19	5090483	.	A	T	34	25	59	0	1	60	0	0
19	5091503	.	C	T	29	26	55	0	3	58	0	0
19	5091587	.	G	C	25	26	51	0	3	54	0	0
19	5094405	.	C	A	1	6	7	0	13	20	0	0
19	5094417	.	A	T	7	15	22	0	1	23	0	0
19	5094504	.	A	G	16	10	26	0	0	26	0	0
19	5094564	.	T	A	18	10	28	0	0	28	0	0
19	5100191	.	G	A	12	15	27	0	1	28	0	0
19	5100240	.	G	A	6	6	12	0	0	12	0	0
19	5100249	.	C	T	4	3	7	0	0	7	0	0
19	5100458	.	G	A	3	4	7	0	0	7	0	0
19	5100665	.	C	T	8	9	17	0	0	17	0	0
19	5103228	.	T	C	2	0	2	0	3	5	0	0
19	5144107	.	C	T	5	5	10	0	0	10	0	0
19	5144395	.	T	C	6	3	9	0	0	9	0	0
19	5144962	.	G	A	3	3	6	0	0	6	0	0
19	5146708	.	C	T	9	14	23	0	0	23	0	0
19	5149133	.	T	C	16	15	31	0	3	34	0	0
19	5158657	.	G	A	38	33	71	0	3	74	0	0
19	5159120	.	C	T	41	24	65	0	5	70	0	0
19	5159399	.	T	A	36	22	58	0	4	62	0	0
19	5159425	.	C	T	30	29	59	0	0	59	0	0
19	5159534	.	G	A	24	27	51	0	3	54	0	0
19	5160048	.	C	G	30	26	56	0	2	58	0	0
19	5160121	.	T	C	32	0	32	0	23	55	0	0
19	5160201	.	A	G	26	23	49	0	2	51	0	0
19	5161750	.	A	G	24	15	39	0	0	39	0	0
19	5161782	.	C	T	27	15	42	0	0	42	0	0
19	5162105	.	G	A	28	23	51	0	0	51	0	0
19	5162300	.	T	G	22	33	55	0	2	57	0	0
19	5162521	.	G	A	22	15	37	0	1	38	0	0
19	5162679	.	A	G	22	21	43	0	1	44	0	0
19	5162685	.	T	A	20	22	42	0	4	46	0	0
19	5162960	.	A	T	20	9	29	0	1	30	0	0
19	5163127	.	A	T	19	24	43	0	1	44	0	0
19	5163409	.	G	A	20	27	47	0	2	49	0	0
19	5163434	.	A	G	27	20	47	0	1	48	0	0
19	5163635	.	C	T	20	17	37	0	1	44	6	0
19	5300036	.	G	A	2	3	5	0	0	5	0	0
19	5302286	.	A	G	1	0	1	0	0	1	0	0
19	5305025	.	C	T	2	1	3	0	0	3	0	0
19	5305612	.	C	T	3	4	7	0	0	7	0	0
19	5316069	.	G	A	1	2	3	0	0	3	0	0
19	5316279	.	T	A	2	2	4	0	0	4	0	0
19	5318355	.	G	A	0	2	2	0	7	9	0	0
19	5318356	.	T	A	6	2	8	0	1	9	0	0
19	5318806	.	A	C	9	8	17	0	0	17	0	0
19	5318979	.	G	A	15	10	25	0	3	28	0	0
19	5319096	.	C	G	5	15	20	0	1	21	0	0
19	5320139	.	G	A	1	9	10	0	2	12	0	0
19	5378640	.	G	A	3	2	5	0	0	5	0	0
19	5380014	.	G	T	1	0	1	0	0	1	0	0
19	5418116	.	T	A	24	16	40	0	0	40	0	0
19	5421086	.	T	A	24	34	58	0	1	59	0	0
19	5421277	.	T	G	21	3	24	0	31	55	0	0
19	5480485	.	T	C	3	5	8	0	0	8	0	0
19	5552433	.	G	A	0	3	3	0	1	4	0	0
19	5563708	.	G	A	3	1	4	0	0	4	0	0
19	5569767	.	C	G	6	3	9	0	1	10	0	0
19	5569864	.	A	C	6	4	10	0	0	10	0	0
19	5582319	.	G	T	1	4	5	0	0	5	0	0
19	5582376	.	A	G	10	7	17	0	0	17	0	0
19	5582418	.	T	C	5	3	8	0	0	8	0	0
19	5610860	.	T	A	5	8	13	0	1	14	0	0
19	5611772	.	G	A	17	20	37	0	4	42	1	0
19	5611856	.	A	T	17	18	35	0	3	38	0	0
19	5615570	.	C	A	2	1	3	0	0	3	0	0
19	5615678	.	T	C	0	3	3	0	7	10	0	0
19	5615681	.	T	C	0	1	1	0	6	7	0	0
19	5619685	.	G	A	0	5	5	0	8	13	0	0
19	5619735	.	G	A	29	14	43	0	0	43	0	0
19	5619926	.	G	A	0	14	14	0	4	18	0	0
19	5620011	.	G	A	0	6	6	0	10	16	0	0
19	5620370	.	T	C	12	16	28	0	0	28	0	0
19	5620380	.	G	A	16	12	28	0	0	28	0	0
19	5620419	.	G	A	11	18	29	0	1	30	0	0
19	5620498	.	T	A	14	14	28	0	0	28	0	0
19	5620631	.	C	T	17	9	26	0	0	26	0	0
19	5620772	.	G	A	11	9	20	0	2	22	0	0
19	5620810	.	T	C	19	12	31	0	0	31	0	0
19	5621096	.	T	C	10	11	21	0	0	21	0	0
19	5621124	.	G	T	14	13	27	0	0	27	0	0
19	5621131	.	A	G	14	0	14	0	12	26	0	0
19	5621269	.	C	T	1	3	4	0	0	4	0	0
19	5779271	.	A	G	10	9	19	0	0	19	0	0
19	5779829	.	G	T	8	9	17	0	0	17	0	0
19	5779835	.	C	T	6	8	14	0	1	15	0	0
19	5779897	.	T	C	9	10	19	0	0	19	0	0
19	5780032	.	C	G	0	3	3	0	1	4	0	0
19	5780293	.	A	T	5	7	12	0	0	12	0	0
19	5780312	.	A	T	4	9	13	0	0	13	0	0
19	5780585	.	G	T	6	4	10	0	1	11	0	0
19	5780688	.	A	C	5	3	8	0	0	8	0	0
19	5780989	.	G	A	11	5	16	0	0	16	0	0
19	5781259	.	A	T	4	5	9	0	0	9	0	0
19	5781316	.	G	T	3	6	9	0	1	10	0	0
19	5781367	.	T	C	4	7	11	0	0	11	0	0
19	5793484	.	C	G	0	4	4	0	0	4	0	0
19	5793532	.	T	C	1	5	6	0	0	6	0	0
19	5801151	.	G	A	2	6	8	0	0	8	0	0
19	5805833	.	G	A	5	3	8	0	1	9	0	0
19	5805839	.	G	A	7	3	10	0	0	10	0	0
19	6060281	.	T	A	15	9	24	0	0	24	0	0
19	6060309	.	A	T	15	6	21	0	2	23	0	0
19	6060415	.	C	A	0	5	5	0	8	13	0	0
19	6076813	.	C	A	3	4	7	0	1	8	0	0
19	6083524	.	G	A	8	7	15	0	0	15	0	0
19	6085957	.	A	T	9	7	16	0	3	19	0	0
19	6086441	.	C	G	16	12	28	0	0	28	0	0
19	6086577	.	C	T	1	11	12	0	16	28	0	0
19	6087130	.	T	A	3	5	8	0	0	8	0	0
19	6087146	.	C	T	0	6	6	0	4	10	0	0
19	6087186	.	A	T	6	12	18	0	1	19	0	0
19	6087619	.	T	C	7	0	7	0	7	14	0	0
19	6087656	.	C	T	2	3	5	0	0	5	0	0
19	6087894	.	G	A	5	10	15	0	2	17	0	0
19	6087948	.	A	T	11	3	14	0	1	15	0	0
19	6088000	.	C	T	0	13	13	0	9	22	0	0
19	6088166	.	T	C	7	11	18	0	1	19	0	0
19	6088259	.	A	C	8	9	17	0	1	18	0	0
19	6088368	.	A	G	12	12	24	0	2	26	0	0
19	6090702	.	T	C	5	4	9	0	0	9	0	0
19	6090732	.	T	A	1	2	3	0	0	3	0	0
19	6094162	.	A	C	4	6	10	0	0	10	0	0
19	6097473	.	C	A	3	6	9	0	0	9	0	0
19	6100295	.	A	G	11	11	22	0	0	22	0	0
19	6102594	.	A	T	5	3	8	0	0	8	0	0
19	6102732	.	T	C	2	1	3	0	0	3	0	0
19	6105528	.	A	T	3	5	8	0	0	8	0	0
19	6111085	.	G	A	5	8	13	0	3	16	0	0
19	6111214	.	A	G	11	9	20	0	2	22	0	0
19	6111223	.	A	G	10	9	19	0	1	20	0	0
19	6111268	.	G	A	13	15	28	0	2	30	0	0
19	6111544	.	A	G	8	6	14	0	0	14	0	0
19	6111724	.	T	C	7	3	10	0	1	11	0	0
19	6116477	.	A	G	5	3	8	0	0	8	0	0
19	6116638	.	A	G	2	3	5	0	0	5	0	0
19	6122614	.	A	G	2	7	9	0	0	9	0	0
19	6125329	.	G	T	10	6	16	0	1	17	0	0
19	6125350	.	A	G	7	5	12	0	1	13	0	0
19	6125425	.	A	T	2	8	10	0	0	10	0	0
19	6125656	.	G	C	6	9	15	0	1	16	0	0
19	6125926	.	G	A	9	14	23	0	0	23	0	0
19	6125941	.	C	T	7	13	20	0	0	20	0	0
19	6126001	.	G	A	4	12	16	0	0	16	0	0
19	6126046	.	A	T	3	6	9	0	8	17	0	0
19	6126277	.	G	A	7	7	14	0	0	14	0	0
19	6126403	.	C	G	2	2	4	0	0	4	0	0
19	6126544	.	A	G	3	3	6	0	0	6	0	0
19	6126625	.	G	A	7	5	12	0	0	12	0	0
19	6126645	.	T	C	5	4	9	0	1	10	0	0
19	6127108	.	C	A	1	8	9	0	0	9	0	0
19	6127669	.	C	A	5	2	7	0	0	7	0	0
19	6127696	.	T	C	3	3	6	0	0	6	0	0
19	6127764	.	A	G	5	4	9	0	0	9	0	0
19	6127768	.	A	G	5	4	9	0	0	9	0	0
19	6127847	.	G	T	2	3	5	0	0	5	0	0
19	6128416	.	G	A	2	5	7	0	0	7	0	0
19	6142187	.	C	A	0	2	2	0	7	9	0	0
19	6142669	.	T	A	14	5	19	0	2	21	0	0
19	6142714	.	A	T	11	11	22	0	0	22	0	0
19	6142802	.	G	T	5	4	9	0	0	9	0	0
19	6142803	.	A	G	5	4	9	0	0	9	0	0
19	6143608	.	C	T	0	3	3	0	6	9	0	0
19	6143825	.	C	T	4	4	8	0	0	8	0	0
19	6144722	.	C	T	3	3	6	0	0	6	0	0
19	6144822	.	C	G	4	4	8	0	0	8	0	0
19	6145736	.	G	A	2	8	10	0	0	10	0	0
19	6145964	.	A	G	3	2	5	0	0	5	0	0
19	6214598	.	G	A	4	2	6	0	0	6	0	0
19	6217133	.	T	A	3	2	5	0	0	5	0	0
19	6217667	.	A	G	5	3	8	0	0	8	0	0
19	6233690	.	C	A	0	1	1	0	0	1	0	0
19	6235483	.	G	A	1	4	5	0	0	5	0	0
19	6328442	.	T	C	36	10	46	0	42	88	0	0
19	6328514	.	A	C	36	36	72	0	6	78	0	0
19	6328533	.	A	G	39	42	81	0	4	85	0	0
19	6328830	.	T	G	31	39	70	0	5	75	0	0
19	6328859	.	G	A	30	26	56	0	4	63	3	0
19	6328889	.	C	T	4	27	31	0	39	70	0	0
19	6328906	.	G	A	37	28	65	0	5	70	0	0
19	6328963	.	T	C	28	34	62	0	2	64	0	0
19	6329062	.	A	T	35	25	60	0	5	65	0	0
19	6329381	.	A	T	34	17	51	0	2	53	0	0
19	6329382	.	T	G	35	16	51	0	2	53	0	0
19	6329533	.	C	T	4	22	26	0	37	63	0	0
19	6329813	.	G	A	39	29	68	0	1	69	0	0
19	6330194	.	A	C	41	3	44	0	25	69	0	0
19	6330239	.	C	A	0	7	7	0	16	23	0	0
19	6332767	.	A	C	15	4	19	0	9	28	0	0
19	6332902	.	C	A	0	7	7	0	11	18	0	0
19	6332947	.	C	T	2	13	15	0	16	31	0	0
19	6332973	.	G	A	5	7	12	0	0	12	0	0
19	6338207	.	A	G	5	6	11	0	2	13	0	0
19	6338261	.	A	G	13	25	38	0	3	41	0	0
19	6342278	.	G	T	24	15	39	0	2	41	0	0
19	6344522	.	G	C	31	3	34	0	29	63	0	0
19	6346506	.	C	G	28	28	56	0	1	57	0	0
19	6346587	.	C	T	0	25	25	0	23	48	0	0
19	6347662	.	C	T	17	18	35	0	1	36	0	0
19	6352379	.	A	G	13	11	24	0	3	27	0	0
19	6352448	.	G	A	18	22	40	0	2	42	0	0
19	6352511	.	G	A	26	22	48	0	1	49	0	0
19	6358232	.	A	G	2	9	11	0	1	12	0	0
19	6606673	.	T	A	5	6	11	0	0	11	0	0
19	6606725	.	T	C	3	7	10	0	2	12	0	0
19	6606764	.	A	T	1	4	5	0	0	5	0	0
19	6612432	.	T	C	1	1	2	0	0	2	0	0
19	6618293	.	A	G	1	0	1	0	0	1	0	0
19	6872539	.	T	C	3	5	8	0	0	8	0	0
19	6872595	.	C	T	2	3	5	0	0	5	0	0
19	6892963	.	C	T	0	2	2	0	0	2	0	0
19	6900002	.	G	T	1	2	3	0	0	3	0	0
19	6901116	.	A	T	2	3	5	0	0	5	0	0
19	6901174	.	G	T	0	5	5	0	4	9	0	0
19	6908566	.	A	G	0	3	3	0	0	3	0	0
19	6908574	.	T	A	0	2	2	0	0	3	1	0
19	6908650	.	T	C	2	2	4	0	0	4	0	0
19	6908651	.	T	C	2	1	3	0	1	4	0	0
19	6910409	.	A	G	4	4	8	0	0	8	0	0
19	6914280	.	A	T	4	2	6	0	0	6	0	0
19	6914319	.	T	A	5	3	8	0	0	8	0	0
19	6914370	.	A	C	4	2	6	0	1	7	0	0
19	6914589	.	T	C	4	2	6	2	0	8	0	0
19	6915030	.	T	C	3	5	8	0	0	8	0	0
19	6915114	.	C	T	2	4	6	0	0	6	0	0
19	6915175	.	A	C	6	3	9	0	0	9	0	0
19	6915177	.	A	G	6	3	9	0	0	9	0	0
19	6915234	.	G	A	2	5	7	0	0	7	0	0
19	6916158	.	C	A	2	2	4	0	0	4	0	0
19	6922387	.	A	G	0	2	2	0	0	2	0	0
19	6923014	.	A	G	2	2	4	0	0	4	0	0
19	6923033	.	A	C	2	2	4	0	0	4	0	0
19	6923617	.	A	G	2	2	4	0	0	4	0	0
19	6932362	.	A	C	1	1	2	0	0	2	0	0
19	6933374	.	G	C	3	3	6	0	0	6	0	0
19	6933469	.	G	A	1	3	4	0	0	4	0	0
19	6933697	.	G	T	0	2	2	0	0	2	0	0
19	6933716	.	T	A	0	3	3	0	0	3	0	0
19	6934005	.	C	T	2	2	4	0	0	4	0	0
19	6934166	.	C	T	1	2	3	0	1	4	0	0
19	6938364	.	A	T	10	7	17	0	2	19	0	0
19	6938377	.	A	T	8	8	16	0	2	18	0	0
19	6940213	.	C	T	0	2	2	0	0	2	0	0
19	6949256	.	G	A	1	23	24	0	20	44	0	0
19	6949316	.	C	A	11	11	22	0	1	23	0	0
19	6952600	.	T	C	17	19	36	0	0	36	0	0
19	6955061	.	C	T	21	12	33	0	0	33	0	0
19	6955130	.	C	T	15	11	26	0	0	26	0	0
19	6955131	.	C	T	14	11	25	0	1	26	0	0
19	6955198	.	C	A	12	13	25	0	2	27	0	0
19	6955411	.	C	T	10	11	21	0	1	22	0	0
19	6955475	.	T	C	7	10	17	0	2	19	0	0
19	6955609	.	C	G	12	6	18	0	0	18	0	0
19	6955620	.	G	A	0	4	4	0	12	16	0	0
19	6955920	.	G	A	12	10	22	0	1	23	0	0
19	6956135	.	A	G	21	10	31	0	1	32	0	0
19	6956553	.	A	C	0	7	7	0	0	7	0	0
19	6956555	.	A	T	0	7	7	0	0	7	0	0
19	6956665	.	C	A	14	11	25	0	1	26	0	0
19	6956728	.	T	A	19	11	30	0	0	30	0	0
19	6956829	.	T	A	8	11	19	0	1	20	0	0
19	6956835	.	C	G	9	11	20	0	0	20	0	0
19	6956881	.	T	C	7	9	16	0	0	16	0	0
19	6956892	.	T	A	9	5	14	0	0	14	0	0
19	6957127	.	A	T	27	12	39	0	1	41	1	0
19	6957131	.	C	A	23	12	35	0	5	40	0	0
19	6960653	.	C	A	6	7	13	0	0	13	0	0
19	6961095	.	G	A	1	4	5	0	1	6	0	0
19	6961211	.	T	C	1	2	3	1	0	4	0	0
19	6961421	.	T	A	7	5	12	0	0	12	0	0
19	6961610	.	G	A	5	7	12	0	0	12	0	0
19	6961674	.	A	G	5	3	8	0	0	8	0	0
19	6963020	.	C	T	5	2	7	0	0	7	0	0
19	6963863	.	C	A	2	4	6	0	0	6	0	0
19	6963874	.	A	G	1	1	2	0	1	3	0	0
19	6964364	.	C	T	6	4	10	0	1	11	0	0
19	6964381	.	T	C	6	5	11	0	0	11	0	0
19	6964417	.	A	G	5	7	12	0	0	12	0	0
19	6964636	.	C	T	1	2	3	0	0	3	0	0
19	6964641	.	T	C	2	0	2	0	2	4	0	0
19	6964679	.	C	A	1	1	2	0	1	3	0	0
19	6964684	.	C	T	0	2	2	0	1	3	0	0
19	6965420	.	A	T	2	3	5	0	0	5	0	0
19	6965717	.	A	G	2	2	4	0	0	4	0	0
19	6966003	.	C	A	5	4	9	0	0	9	0	0
19	6966022	.	A	G	5	2	7	0	0	7	0	0
19	6966208	.	G	A	6	5	11	0	0	11	0	0
19	6966271	.	T	G	6	4	10	0	1	11	0	0
19	6966781	.	A	T	4	4	8	0	1	9	0	0
19	6975261	.	A	C	4	0	4	0	6	10	0	0
19	6977067	.	T	C	1	1	2	0	0	2	0	0
19	6980493	.	C	T	2	2	4	0	0	4	0	0
19	6982477	.	C	G	1	2	3	0	0	3	0	0
19	6988778	.	T	C	5	1	6	0	0	6	0	0
19	6994666	.	G	A	0	3	3	0	1	4	0	0
19	6995760	.	C	G	1	0	1	0	4	5	0	0
19	6996885	.	A	G	1	2	3	0	0	3	0	0
19	6998402	.	A	G	0	0	0	0	1	1	0	0
19	6998429	.	T	G	0	0	0	0	1	1	0	0
19	7003167	.	C	T	3	2	5	0	0	5	0	0
19	7003228	.	C	A	2	2	4	0	0	4	0	0
19	7005030	.	C	T	2	3	5	0	0	5	0	0
19	7005032	.	G	C	2	3	5	0	0	5	0	0
19	7005462	.	G	A	0	2	2	0	4	6	0	0
19	7005594	.	C	T	1	4	5	0	0	5	0	0
19	7005630	.	C	T	1	4	5	0	0	5	0	0
19	7005881	.	C	T	2	3	5	0	0	5	0	0
19	7006215	.	C	T	2	2	4	0	0	4	0	0
19	7006709	.	G	T	0	7	7	0	3	10	0	0
19	7006826	.	C	A	2	2	4	0	1	5	0	0
19	7006837	.	A	C	3	2	5	0	1	6	0	0
19	7006928	.	C	T	4	3	7	0	0	7	0	0
19	7014778	.	T	A	2	3	5	0	1	6	0	0
19	7014815	.	C	T	2	4	6	0	0	6	0	0
19	7014863	.	T	G	2	7	9	0	0	9	0	0
19	7014909	.	C	A	3	7	10	0	0	10	0	0
19	7014912	.	G	A	3	7	10	0	0	10	0	0
19	7014948	.	T	C	2	0	2	0	2	4	0	0
19	7015034	.	T	A	1	2	3	0	0	3	0	0
19	7020179	.	G	A	5	6	11	0	0	11	0	0
19	7020775	.	T	C	3	5	8	0	1	9	0	0
19	7022107	.	G	A	2	2	4	0	0	4	0	0
19	7022128	.	G	A	2	2	4	0	0	4	0	0
19	7024591	.	T	G	4	5	9	0	0	9	0	0
19	7024593	.	C	T	4	3	7	0	2	9	0	0
19	7024627	.	T	C	1	6	7	0	0	7	0	0
19	7029769	.	A	G	2	2	4	0	0	4	0	0
19	7029770	.	C	G	2	2	4	0	0	4	0	0
19	7029806	.	C	G	2	3	5	0	0	5	0	0
19	7029811	.	G	A	3	3	6	0	0	6	0	0
19	7039308	.	G	A	0	1	1	0	1	2	0	0
19	7039335	.	T	C	0	0	0	0	1	1	0	0
19	7039344	.	G	A	0	1	1	0	0	1	0	0
19	7040158	.	A	G	1	3	4	0	0	4	0	0
19	7069019	.	A	G	0	4	4	0	0	4	0	0
19	7100564	.	A	T	9	4	13	0	0	13	0	0
19	7106409	.	A	G	3	1	4	0	0	4	0	0
19	7106433	.	G	A	2	1	3	0	0	3	0	0
19	7120680	.	C	T	1	2	3	0	0	3	0	0
19	7120696	.	G	A	1	2	3	0	0	3	0	0
19	7126422	.	T	A	1	2	3	0	0	3	0	0
19	7131154	.	G	C	0	2	2	0	4	6	0	0
19	7152971	.	G	T	0	8	8	0	8	16	0	0
19	7152974	.	G	A	8	7	15	0	0	15	0	0
19	7154729	.	A	G	13	19	32	0	1	33	0	0
19	7154770	.	A	C	12	20	32	0	0	32	0	0
19	7155001	.	A	T	5	16	21	0	0	21	0	0
19	7155034	.	A	G	11	18	29	0	1	30	0	0
19	7155065	.	T	C	14	15	29	0	0	29	0	0
19	7158469	.	C	T	3	7	10	0	0	10	0	0
19	7158546	.	A	G	2	0	2	0	5	7	0	0
19	7159062	.	G	A	0	2	2	0	5	7	0	0
19	7159107	.	T	C	12	7	19	0	0	19	0	0
19	7161452	.	G	A	2	2	4	0	0	4	0	0
19	7161527	.	A	G	3	2	5	0	1	6	0	0
19	7161539	.	G	T	3	2	5	0	1	6	0	0
19	7163872	.	C	T	7	8	15	0	0	15	0	0
19	7163908	.	A	G	10	9	19	0	1	20	0	0
19	7164022	.	G	A	7	4	11	0	1	12	0	0
19	7166211	.	C	T	2	5	7	0	0	7	0	0
19	7166454	.	C	A	1	1	2	0	0	2	0	0
19	7169204	.	A	C	8	6	14	0	1	15	0	0
19	7169228	.	C	T	13	11	24	0	1	25	0	0
19	7169304	.	G	A	9	5	14	0	3	17	0	0
19	7169587	.	A	G	1	7	8	0	0	8	0	0
19	7169588	.	G	A	1	6	7	0	1	8	0	0
19	7169809	.	C	T	8	5	13	0	0	13	0	0
19	7169880	.	T	C	8	4	12	0	2	14	0	0
19	7169886	.	G	A	10	3	13	0	2	15	0	0
19	7169929	.	G	A	5	8	13	0	1	14	0	0
19	7170014	.	A	C	5	5	10	0	0	10	0	0
19	7170015	.	T	C	5	5	10	0	0	10	0	0
19	7170128	.	A	G	4	2	6	0	0	6	0	0
19	7170191	.	A	C	4	6	10	0	1	11	0	0
19	7170228	.	A	T	3	3	6	0	0	6	0	0
19	7170242	.	G	T	4	2	6	0	0	6	0	0
19	7174417	.	C	A	4	4	8	0	0	8	0	0
19	7174456	.	T	C	4	2	6	0	0	6	0	0
19	7174669	.	T	C	7	1	8	0	0	8	0	0
19	7176913	.	G	A	0	0	0	0	2	2	0	0
19	7176915	.	C	A	2	0	2	0	0	2	0	0
19	7249800	.	A	G	7	13	20	0	0	20	0	0
19	7249811	.	T	C	9	10	19	0	1	20	0	0
19	7250372	.	T	C	3	3	6	0	0	6	0	0
19	7258085	.	A	G	7	5	12	0	0	12	0	0
19	7258118	.	C	T	4	3	7	0	1	8	0	0
19	7265377	.	T	C	1	0	1	0	0	1	0	0
19	7270102	.	G	A	9	6	15	0	0	15	0	0
19	7270156	.	C	A	0	7	7	0	8	15	0	0
19	7272224	.	C	A	2	0	2	0	0	2	0	0
19	7272935	.	G	A	4	5	9	0	1	10	0	0
19	7276106	.	G	A	11	10	21	0	1	22	0	0
19	7276149	.	A	G	21	21	42	0	0	42	0	0
19	7276194	.	T	A	22	27	49	0	4	53	0	0
19	7276559	.	G	A	26	36	62	0	2	64	0	0
19	7276610	.	G	A	25	24	49	0	6	55	0	0
19	7279235	.	A	G	10	12	22	0	2	24	0	0
19	7279721	.	A	G	3	5	8	0	0	8	0	0
19	7282541	.	C	T	7	9	16	0	1	17	0	0
19	7282554	.	G	A	13	13	26	0	0	26	0	0
19	7283427	.	C	A	25	13	38	0	1	39	0	0
19	7283499	.	A	G	19	17	36	0	0	36	0	0
19	7284840	.	C	T	1	17	18	0	14	32	0	0
19	7286301	.	A	G	7	8	15	0	0	15	0	0
19	7286355	.	A	G	27	26	53	0	1	54	0	0
19	7286421	.	T	A	12	11	23	0	0	23	0	0
19	7286742	.	A	G	11	10	21	0	0	21	0	0
19	7287600	.	T	C	22	22	44	0	2	46	0	0
19	7287603	.	G	A	23	21	44	0	0	44	0	0
19	7288195	.	A	G	7	9	16	0	0	16	0	0
19	7290175	.	A	G	3	1	4	0	0	4	0	0
19	7290214	.	A	G	17	15	32	0	3	35	0	0
19	7291642	.	A	T	2	4	6	0	0	6	0	0
19	7291705	.	G	A	1	3	4	0	0	4	0	0
19	7291708	.	T	C	1	2	3	0	0	3	0	0
19	7292621	.	G	A	3	1	4	0	0	4	0	0
19	7292636	.	A	T	1	1	2	0	0	2	0	0
19	7293138	.	A	G	1	3	4	0	1	5	0	0
19	7295279	.	G	A	7	10	17	0	0	17	0	0
19	7295572	.	G	C	5	5	10	0	3	13	0	0
19	7309154	.	G	A	14	10	24	0	1	25	0	0
19	7309391	.	C	A	21	16	37	0	2	39	0	0
19	7309522	.	G	C	14	17	31	0	2	33	0	0
19	7309556	.	T	A	14	9	23	0	0	23	0	0
19	7309557	.	T	A	12	9	21	0	2	23	0	0
19	7309754	.	T	G	6	4	10	0	1	11	0	0
19	7309929	.	A	T	14	13	27	0	3	30	0	0
19	7309968	.	G	T	11	18	29	0	1	30	0	0
19	7310117	.	T	C	15	0	15	0	18	33	0	0
19	7310131	.	C	T	15	13	28	0	3	31	0	0
19	7310154	.	A	T	14	10	24	0	2	26	0	0
19	7311678	.	T	G	6	2	8	0	0	8	0	0
19	7313933	.	C	G	9	7	16	0	1	17	0	0
19	7327462	.	A	G	7	6	13	0	0	13	0	0
19	7327519	.	C	T	3	11	14	0	0	14	0	0
19	7327564	.	G	T	1	3	4	0	0	4	0	0
19	7327570	.	T	C	1	1	2	0	0	2	0	0
19	7338033	.	C	T	0	14	14	0	11	25	0	0
19	7338125	.	C	T	9	12	21	0	1	22	0	0
19	7338150	.	G	A	4	9	13	0	0	13	0	0
19	7338218	.	A	T	6	6	12	0	0	12	0	0
19	7338309	.	C	T	0	11	11	0	4	15	0	0
19	7338402	.	C	T	0	8	8	0	8	16	0	0
19	7338425	.	T	C	5	6	11	0	0	11	0	0
19	7338444	.	T	C	5	0	5	0	7	12	0	0
19	7338969	.	C	T	12	7	19	0	0	19	0	0
19	7338978	.	T	C	12	0	12	0	8	20	0	0
19	7339008	.	T	G	8	11	19	0	0	20	1	0
19	7341300	.	G	A	9	9	18	0	2	20	0	0
19	7341385	.	A	G	0	3	3	0	0	3	0	0
19	7358131	.	A	G	2	6	8	0	0	8	0	0
19	7379601	.	C	T	2	3	5	0	0	5	0	0
19	7379637	.	T	C	1	0	1	0	3	4	0	0
19	7408360	.	T	G	6	7	13	0	1	14	0	0
19	7411975	.	T	C	6	3	9	0	0	9	0	0
19	7412062	.	T	C	2	2	4	0	0	4	0	0
19	7412320	.	C	T	6	12	18	0	0	18	0	0
19	7412358	.	A	T	3	8	11	0	1	12	0	0
19	7424794	.	G	A	2	0	2	0	0	2	0	0
19	7426637	.	C	T	10	5	15	0	0	15	0	0
19	7426814	.	C	T	3	6	9	0	0	9	0	0
19	7426832	.	G	A	3	7	10	0	1	11	0	0
19	7426967	.	T	C	9	9	18	0	0	18	0	0
19	7427099	.	C	A	3	1	4	0	0	4	0	0
19	7430160	.	T	C	7	9	16	0	1	17	0	0
19	7430607	.	G	A	0	10	10	0	13	23	0	0
19	7430652	.	C	T	9	8	17	0	0	17	0	0
19	7430700	.	A	G	4	1	5	0	6	11	0	0
19	7430715	.	C	A	3	4	7	0	0	7	0	0
19	7432806	.	A	C	3	6	9	0	0	9	0	0
19	7433068	.	T	A	4	6	10	0	0	10	0	0
19	7433149	.	A	T	2	2	4	0	0	4	0	0
19	7433454	.	G	A	3	3	6	0	0	6	0	0
19	7433598	.	C	T	1	2	3	0	0	3	0	0
19	7433601	.	T	C	1	2	3	0	0	3	0	0
19	7433637	.	C	A	1	4	5	0	0	5	0	0
19	7433896	.	T	C	3	1	4	0	0	4	0	0
19	7433927	.	T	C	3	2	5	0	0	5	0	0
19	7434139	.	T	C	5	2	7	0	1	8	0	0
19	7434161	.	G	T	2	4	6	0	1	7	0	0
19	7434731	.	G	C	3	1	4	0	1	5	0	0
19	7434753	.	A	G	2	3	5	0	0	5	0	0
19	7434813	.	G	A	2	6	8	0	0	8	0	0
19	7434866	.	C	T	2	2	4	0	0	4	0	0
19	7434881	.	C	T	0	1	1	0	2	3	0	0
19	7435605	.	T	C	2	3	5	0	0	5	0	0
19	7437053	.	A	G	2	1	3	0	0	3	0	0
19	7441832	.	T	A	2	1	3	0	0	3	0	0
19	7445676	.	G	A	3	5	8	0	2	10	0	0
19	7445897	.	C	T	28	24	52	0	2	54	0	0
19	7446050	.	T	C	22	30	52	0	2	54	0	0
19	7446137	.	G	T	25	25	50	0	0	50	0	0
19	7446286	.	G	T	37	27	64	0	0	64	0	0
19	7446495	.	G	T	26	41	67	0	4	71	0	0
19	7446621	.	C	A	35	29	64	0	5	69	0	0
19	7446702	.	T	C	2	3	5	0	1	6	0	0
19	7450572	.	G	A	18	24	42	0	0	42	0	0
19	7450658	.	T	C	15	17	32	0	1	33	0	0
19	7450750	.	A	G	6	5	11	0	0	11	0	0
19	7450783	.	C	T	0	4	4	0	8	12	0	0
19	7456364	.	T	C	5	5	10	0	0	10	0	0
19	7456371	.	A	C	5	5	10	0	0	10	0	0
19	7456722	.	C	G	2	10	12	0	0	13	1	0
19	7456793	.	A	G	6	7	13	0	0	13	0	0
19	7456816	.	C	G	5	5	10	0	1	11	0	0
19	7468556	.	G	T	1	4	5	0	0	5	0	0
19	7468580	.	C	T	4	5	9	0	0	9	0	0
19	7474242	.	T	C	2	7	9	0	0	9	0	0
19	7474245	.	T	G	2	1	3	0	6	9	0	0
19	7478159	.	A	G	14	8	22	0	0	22	0	0
19	7478356	.	G	A	3	8	11	0	0	11	0	0
19	7482931	.	C	T	4	7	11	0	0	11	0	0
19	7482993	.	G	A	0	4	4	0	0	4	0	0
19	7483059	.	A	T	1	4	5	0	0	5	0	0
19	7483469	.	T	G	2	5	7	0	0	7	0	0
19	7483667	.	G	A	4	3	7	0	0	7	0	0
19	7484313	.	T	A	3	3	6	0	0	6	0	0
19	7484668	.	A	T	1	3	4	1	0	5	0	0
19	7484990	.	G	T	5	2	7	0	0	7	0	0
19	7485298	.	A	C	3	3	6	0	0	6	0	0
19	7485339	.	A	C	1	2	3	0	0	3	0	0
19	7485343	.	T	A	1	2	3	0	0	3	0	0
19	7485503	.	G	A	3	3	6	0	0	6	0	0
19	7485528	.	T	C	1	0	1	0	3	4	0	0
19	7486022	.	T	C	2	4	6	0	0	6	0	0
19	7486698	.	G	C	2	2	4	0	1	5	0	0
19	7486791	.	T	C	3	4	7	0	0	7	0	0
19	7487163	.	A	G	4	2	6	0	0	6	0	0
19	7487321	.	C	T	2	2	4	0	1	5	0	0
19	7487592	.	T	A	3	3	6	0	0	6	0	0
19	7490212	.	C	T	2	2	4	0	0	4	0	0
19	7490227	.	A	G	1	2	3	0	1	4	0	0
19	7490873	.	T	A	1	1	2	0	0	2	0	0
19	7495867	.	A	T	4	6	10	0	1	11	0	0
19	7498046	.	T	C	11	12	23	0	0	23	0	0
19	7498079	.	A	G	10	14	24	0	4	28	0	0
19	7498103	.	A	G	11	10	21	0	0	21	0	0
19	7505591	.	A	G	9	5	14	0	0	14	0	0
19	7505907	.	A	G	5	0	5	0	6	11	0	0
19	7506036	.	A	G	4	0	4	0	10	14	0	0
19	7506097	.	T	C	1	2	3	0	0	3	0	0
19	7507833	.	A	T	10	8	18	0	1	19	0	0
19	7510223	.	T	C	9	12	21	0	0	21	0	0
19	7510348	.	T	C	8	6	14	0	0	14	0	0
19	7510501	.	G	A	0	10	10	0	7	17	0	0
19	7510567	.	C	T	5	6	11	0	0	11	0	0
19	7512406	.	C	G	13	8	21	0	0	21	0	0
19	7513085	.	C	T	9	6	15	0	2	17	0	0
19	7513291	.	A	C	8	12	20	0	0	20	0	0
19	7513406	.	A	T	9	7	16	0	0	16	0	0
19	7513631	.	A	G	4	7	11	0	1	12	0	0
19	7513651	.	A	G	4	7	11	0	0	11	0	0
19	7513779	.	T	C	6	3	9	0	2	11	0	0
19	7513872	.	A	G	5	6	11	0	0	11	0	0
19	7514025	.	T	C	10	7	17	0	0	17	0	0
19	7514512	.	T	C	6	5	11	0	1	12	0	0
19	7515336	.	A	T	9	5	14	0	1	15	0	0
19	7515356	.	G	A	11	10	21	0	1	22	0	0
19	7515423	.	A	G	5	4	9	0	0	9	0	0
19	7515787	.	A	T	5	6	11	0	0	11	0	0
19	7515829	.	C	T	6	10	16	0	1	17	0	0
19	7515845	.	A	T	5	13	18	0	2	20	0	0
19	7516035	.	A	G	9	12	21	0	0	21	0	0
19	7516063	.	A	C	8	14	22	0	0	22	0	0
19	7516169	.	C	A	14	8	22	0	1	23	0	0
19	7516183	.	T	G	12	8	20	0	0	20	0	0
19	7525148	.	C	T	0	2	2	0	4	6	0	0
19	7525337	.	C	A	7	4	11	0	0	11	0	0
19	7534401	.	A	G	0	2	2	0	0	2	0	0
19	7540717	.	G	A	0	3	3	0	0	3	0	0
19	7552736	.	C	A	3	2	5	0	0	5	0	0
19	7552737	.	G	T	0	2	2	0	3	5	0	0
19	7552887	.	A	G	1	5	6	0	0	6	0	0
19	7553368	.	T	C	1	1	2	0	0	2	0	0
19	7557538	.	T	C	13	19	32	0	3	35	0	0
19	7557735	.	T	C	12	20	32	0	2	34	0	0
19	7557793	.	G	C	15	21	36	0	1	37	0	0
19	7563894	.	A	T	1	0	1	0	0	1	0	0
19	7564073	.	A	G	7	4	11	0	0	11	0	0
19	7564176	.	C	T	8	9	17	0	1	18	0	0
19	7565462	.	T	A	16	17	33	0	1	34	0	0
19	7565463	.	T	C	15	18	33	0	1	34	0	0
19	7566488	.	A	T	6	4	10	0	0	10	0	0
19	7566493	.	A	T	10	4	14	0	1	15	0	0
19	7566770	.	A	G	11	10	21	0	2	23	0	0
19	7567011	.	T	C	17	21	38	0	1	39	0	0
19	7567021	.	T	A	18	20	38	0	1	39	0	0
19	7567196	.	A	C	2	4	6	0	0	6	0	0
19	7570229	.	C	T	0	1	1	0	0	1	0	0
19	7590695	.	A	T	1	2	3	0	0	3	0	0
19	7608939	.	G	A	0	3	3	0	4	7	0	0
19	7608980	.	C	T	2	3	5	0	0	5	0	0
19	7608997	.	G	A	1	4	5	0	0	5	0	0
19	7630359	.	T	A	1	2	3	0	0	3	0	0
19	7630785	.	C	T	1	2	3	0	0	3	0	0
19	7631386	.	C	T	10	11	21	0	1	22	0	0
19	7631700	.	G	A	1	13	14	0	13	27	0	0
19	7631860	.	T	C	14	11	25	0	0	25	0	0
19	7631968	.	T	C	4	10	14	0	0	14	0	0
19	7632056	.	C	T	8	5	13	0	0	13	0	0
19	7632470	.	C	T	9	8	17	0	1	18	0	0
19	7632526	.	T	C	7	5	12	0	1	13	0	0
19	7632837	.	C	T	9	5	14	0	1	15	0	0
19	7670253	.	C	T	0	0	0	0	1	1	0	0
19	7673215	.	A	G	0	1	1	0	0	1	0	0
19	7761855	.	C	T	1	1	2	0	0	2	0	0
19	7765259	.	G	A	2	3	5	0	1	6	0	0
19	7775789	.	G	A	0	2	2	0	1	3	0	0
19	7782743	.	G	T	0	7	7	0	6	13	0	0
19	7784681	.	T	A	2	5	7	0	1	8	0	0
19	7784684	.	T	A	1	6	7	0	1	8	0	0
19	7785138	.	C	T	5	2	7	0	0	7	0	0
19	7794830	.	G	C	1	12	13	0	12	25	0	0
19	7794872	.	A	G	16	0	16	0	18	34	0	0
19	7794893	.	A	T	12	13	25	0	7	32	0	0
19	7796888	.	G	A	12	13	25	0	1	26	0	0
19	7796951	.	T	C	8	3	11	0	1	12	0	0
19	7797534	.	C	T	14	11	25	0	0	25	0	0
19	7799098	.	C	T	5	2	7	0	0	7	0	0
19	7799113	.	C	T	5	6	11	0	0	11	0	0
19	7799137	.	T	C	10	9	19	0	0	19	0	0
19	7802622	.	G	A	5	11	16	0	1	17	0	0
19	7802700	.	G	A	4	4	8	0	0	8	0	0
19	7802704	.	T	C	4	4	8	0	0	8	0	0
19	7803459	.	C	T	5	2	7	0	1	8	0	0
19	7803730	.	G	A	1	7	8	0	0	8	0	0
19	7803745	.	T	A	1	3	4	0	0	4	0	0
19	7804785	.	A	C	0	4	4	0	0	4	0	0
19	7804841	.	G	A	5	18	23	0	1	24	0	0
19	7804843	.	G	A	7	16	23	0	1	24	0	0
19	7804892	.	C	T	12	12	24	0	0	24	0	0
19	7819991	.	G	A	8	5	13	0	0	13	0	0
19	7820018	.	C	G	2	11	13	0	0	13	0	0
19	7820665	.	T	A	6	16	22	0	0	22	0	0
19	7820767	.	C	T	0	9	9	0	7	16	0	0
19	7820980	.	C	T	3	9	12	0	0	12	0	0
19	7820992	.	C	A	0	4	4	0	9	13	0	0
19	7821055	.	C	T	10	9	19	0	2	21	0	0
19	7823330	.	C	T	3	1	4	0	2	6	0	0
19	7825025	.	T	G	4	3	7	0	0	7	0	0
19	7825163	.	C	T	4	7	11	0	0	11	0	0
19	7827031	.	T	G	2	2	4	0	0	4	0	0
19	7828576	.	G	A	8	3	11	0	0	11	0	0
19	7828672	.	C	G	2	5	7	0	0	7	0	0
19	7829080	.	G	A	5	2	7	0	0	7	0	0
19	7829094	.	T	G	4	2	6	0	2	8	0	0
19	7829174	.	C	G	4	4	8	0	3	11	0	0
19	7829175	.	C	T	5	5	10	0	1	11	0	0
19	7830625	.	C	T	2	2	4	0	0	4	0	0
19	7835708	.	C	T	0	1	1	0	1	2	0	0
19	7967063	.	C	T	4	2	6	0	0	6	0	0
19	7967067	.	T	C	5	2	7	0	0	7	0	0
19	8315478	.	C	T	4	2	6	0	1	7	0	0
19	8336054	.	A	G	6	1	7	0	9	16	0	0
19	8336208	.	C	T	9	10	19	0	0	19	0	0
19	8336335	.	C	A	4	7	11	0	0	11	0	0
19	8336640	.	G	C	9	8	17	0	0	17	0	0
19	8336730	.	G	T	0	2	2	0	2	4	0	0
19	8338487	.	G	A	2	3	5	0	1	6	0	0
19	8338559	.	A	G	3	3	6	0	0	6	0	0
19	8339302	.	A	G	16	10	26	0	2	28	0	0
19	8482053	.	T	A	3	1	4	0	0	4	0	0
19	8496701	.	C	T	5	3	8	0	0	8	0	0
19	8496737	.	T	A	7	2	9	0	1	10	0	0
19	8496758	.	T	C	4	3	7	0	0	7	0	0
19	8500688	.	T	C	7	7	14	0	0	14	0	0
19	8500928	.	A	T	3	7	10	0	0	10	0	0
19	8500960	.	A	T	4	5	9	0	0	9	0	0
19	8501019	.	G	A	0	4	4	0	5	9	0	0
19	8501499	.	T	C	8	7	15	0	2	17	0	0
19	8501540	.	C	A	9	11	20	0	0	20	0	0
19	8501873	.	G	A	10	12	22	0	0	22	0	0
19	8501901	.	A	T	10	10	20	0	0	20	0	0
19	8534334	.	G	A	7	8	15	0	0	15	0	0
19	8534426	.	G	A	22	9	31	0	1	32	0	0
19	8534428	.	A	G	22	9	31	0	1	32	0	0
19	8534859	.	A	C	10	14	24	0	0	24	0	0
19	8534878	.	A	G	6	13	19	0	0	19	0	0
19	8534996	.	A	G	2	0	2	0	0	2	0	0
19	8535005	.	T	G	1	0	1	0	0	1	0	0
19	8582763	.	T	C	6	4	10	0	0	10	0	0
19	8582809	.	A	G	6	7	13	0	0	13	0	0
19	8583131	.	G	A	2	6	8	0	1	9	0	0
19	8583170	.	G	T	3	6	9	0	0	9	0	0
19	8587075	.	T	C	2	0	2	0	3	5	0	0
19	8589693	.	C	T	7	4	11	0	0	11	0	0
19	8589714	.	C	T	4	4	8	0	0	8	0	0
19	8592419	.	A	G	2	5	7	0	0	7	0	0
19	8592906	.	C	T	1	3	4	0	0	4	0	0
19	8598667	.	A	G	3	2	5	0	0	5	0	0
19	8604154	.	A	G	0	1	1	0	0	1	0	0
19	8612981	.	G	C	0	8	8	0	11	19	0	0
19	8613146	.	A	G	2	2	4	0	2	6	0	0
19	8628830	.	G	T	0	3	3	0	5	8	0	0
19	8641403	.	A	G	4	1	5	0	6	11	0	0
19	8647747	.	T	A	4	13	17	0	1	18	0	0
19	8689918	.	A	G	2	1	3	0	0	3	0	0
19	8699707	.	T	C	2	2	4	0	2	6	0	0
19	8724452	.	C	T	0	1	1	0	1	2	0	0
19	8775362	.	A	T	6	11	17	0	0	17	0	0
19	8795436	.	A	G	1	6	7	0	1	8	0	0
19	8795490	.	C	T	1	2	3	0	0	3	0	0
19	8798044	.	A	G	4	1	5	0	0	5	0	0
19	8812584	.	T	C	3	2	5	0	0	5	0	0
19	8812707	.	T	C	3	4	7	0	0	7	0	0
19	8817074	.	G	T	2	3	5	1	1	7	0	0
19	8817480	.	A	G	12	13	25	0	5	30	0	0
19	8822347	.	A	G	2	0	2	0	0	2	0	0
19	8824364	.	A	G	6	7	13	0	3	16	0	0
19	8831895	.	T	C	6	0	6	0	5	11	0	0
19	8834529	.	A	G	7	4	11	0	1	12	0	0
19	8834583	.	T	C	16	22	38	0	1	39	0	0
19	8894229	.	T	C	2	6	8	0	0	8	0	0
19	8894905	.	G	T	2	3	5	0	0	5	0	0
19	8895074	.	G	A	16	13	29	0	3	32	0	0
19	8895163	.	T	C	9	7	16	0	1	17	0	0
19	8895546	.	C	T	5	2	7	0	0	7	0	0
19	8895630	.	C	T	4	7	11	0	0	11	0	0
19	8898125	.	G	A	4	2	6	0	1	7	0	0
19	8929488	.	C	T	1	16	17	0	6	23	0	0
19	8929549	.	T	C	11	0	11	0	7	18	0	0
19	8929669	.	A	G	3	8	11	0	0	11	0	0
19	8929678	.	A	G	2	8	10	0	1	11	0	0
19	8929708	.	A	T	3	7	10	0	0	10	0	0
19	8929743	.	T	A	6	7	13	0	0	13	0	0
19	8929839	.	G	A	11	8	19	0	0	19	0	0
19	8929860	.	T	C	11	7	18	0	0	18	0	0
19	8930187	.	A	G	6	9	15	0	1	16	0	0
19	8932643	.	T	C	9	0	9	0	7	16	0	0
19	8937377	.	T	C	4	7	11	0	0	11	0	0
19	8937485	.	A	G	8	3	11	0	0	11	0	0
19	8939917	.	C	T	10	6	16	0	0	16	0	0
19	8958797	.	C	T	8	8	16	0	0	16	0	0
19	8962840	.	A	C	2	0	2	0	9	11	0	0
19	8979038	.	T	C	2	2	4	0	0	4	0	0
19	8979060	.	G	T	1	3	4	0	0	4	0	0
19	8979171	.	G	C	0	2	2	0	1	3	0	0
19	8979221	.	T	G	2	5	7	0	0	7	0	0
19	8979519	.	T	C	4	4	8	0	0	8	0	0
19	8979539	.	T	G	4	0	4	0	5	9	0	0
19	8979575	.	A	T	2	5	7	0	0	7	0	0
19	8979581	.	G	A	0	2	2	0	2	4	0	0
19	8985221	.	G	A	7	4	11	0	0	11	0	0
19	8985408	.	C	T	6	6	12	0	0	12	0	0
19	8985564	.	G	A	0	8	8	0	12	20	0	0
19	8989992	.	G	A	0	8	8	0	9	17	0	0
19	8997627	.	T	C	5	7	12	0	0	12	0	0
19	8997629	.	G	A	5	7	12	0	0	12	0	0
19	8997903	.	C	T	1	4	5	0	0	5	0	0
19	9000718	.	G	A	0	18	18	0	20	38	0	0
19	9000838	.	C	T	26	10	36	0	1	37	0	0
19	9000868	.	C	G	18	0	18	0	15	34	1	0
19	9001058	.	C	T	8	13	21	0	4	25	0	0
19	9001151	.	C	T	9	22	31	0	1	32	0	0
19	9001180	.	A	G	11	18	29	0	1	30	0	0
19	9001315	.	C	T	15	12	27	0	1	28	0	0
19	9043096	.	T	C	5	7	12	0	0	12	0	0
19	9043318	.	G	A	5	2	7	1	0	8	0	0
19	9043657	.	T	A	8	4	12	0	0	12	0	0
19	9044331	.	C	T	4	4	8	0	1	9	0	0
19	9044727	.	G	A	4	7	11	0	0	11	0	0
19	9044799	.	T	A	8	6	14	0	0	14	0	0
19	9045097	.	G	T	0	2	2	0	5	7	0	0
19	9045124	.	A	C	5	4	9	0	0	9	0	0
19	9045443	.	C	G	7	8	15	0	0	15	0	0
19	9046119	.	G	C	5	6	11	0	0	11	0	0
19	9046230	.	T	G	7	6	13	0	1	14	0	0
19	9046383	.	T	A	6	5	11	0	4	15	0	0
19	9046542	.	A	C	2	13	15	0	3	18	0	0
19	9046551	.	T	C	3	11	14	0	2	16	0	0
19	9047004	.	G	A	0	9	9	0	5	14	0	0
19	9047283	.	A	G	7	4	11	0	0	11	0	0
19	9047806	.	T	A	9	7	16	0	3	19	0	0
19	9048345	.	C	T	3	5	8	0	1	9	0	0
19	9048538	.	A	C	5	8	13	0	1	14	0	0
19	9048614	.	C	T	4	5	9	0	0	9	0	0
19	9050305	.	G	A	12	11	23	0	2	25	0	0
19	9050319	.	C	T	13	11	24	0	1	25	0	0
19	9050609	.	C	G	11	8	19	0	0	19	0	0
19	9050631	.	T	C	10	6	16	0	0	16	0	0
19	9050823	.	A	G	8	6	14	0	0	14	0	0
19	9054458	.	T	C	0	1	1	0	0	1	0	0
19	9055793	.	C	T	11	11	22	0	0	22	0	0
19	9058454	.	T	C	4	1	5	0	1	6	0	0
19	9077465	.	C	T	10	4	14	0	1	15	0	0
19	9078840	.	A	T	2	3	5	0	0	5	0	0
19	9079084	.	T	C	10	10	20	0	1	21	0	0
19	9081228	.	T	C	24	7	31	0	0	31	0	0
19	9081272	.	C	T	13	6	19	0	2	21	0	0
19	9084604	.	G	A	14	18	32	0	0	32	0	0
19	9084688	.	T	C	8	16	24	0	1	25	0	0
19	9084797	.	A	G	19	12	31	0	0	31	0	0
19	9084859	.	G	T	19	15	34	0	3	37	0	0
19	9084880	.	T	C	20	15	35	0	3	38	0	0
19	9085359	.	A	T	8	4	12	0	0	12	0	0
19	9085423	.	G	A	15	5	20	0	7	27	0	0
19	9085730	.	A	G	7	0	7	0	2	11	2	0
19	9085757	.	A	C	8	14	22	0	3	25	0	0
19	9085835	.	A	G	12	8	20	0	0	20	0	0
19	9086084	.	T	A	16	25	41	0	1	42	0	0
19	9086429	.	G	T	9	8	17	0	1	18	0	0
19	9106738	.	A	T	0	3	3	0	0	3	0	0
19	9111676	.	T	A	5	2	7	0	0	7	0	0
19	9111712	.	T	A	6	3	9	0	0	9	0	0
19	9116528	.	T	C	0	2	2	0	0	2	0	0
19	9116534	.	A	G	0	0	0	0	3	3	0	0
19	9116656	.	G	A	0	2	2	0	2	4	0	0
19	9117114	.	G	A	0	2	2	0	4	6	0	0
19	9117167	.	T	G	5	5	10	0	0	10	0	0
19	9117210	.	T	C	3	4	7	0	1	8	0	0
19	9117216	.	C	A	3	4	7	0	0	7	0	0
19	9117402	.	G	A	1	3	4	0	0	4	0	0
19	9117731	.	G	T	4	6	10	0	0	10	0	0
19	9117769	.	A	G	3	6	9	0	0	9	0	0
19	9117777	.	T	A	2	5	7	0	0	7	0	0
19	9118044	.	G	A	0	3	3	0	5	8	0	0
19	9130205	.	T	A	5	5	10	0	0	10	0	0
19	9134017	.	G	A	1	2	3	0	6	9	0	0
19	9134125	.	G	A	0	6	6	0	4	10	0	0
19	9134140	.	T	C	5	7	12	0	0	12	0	0
19	9135053	.	C	T	1	8	9	0	0	9	0	0
19	9135065	.	A	G	3	0	3	0	10	13	0	0
19	9138695	.	A	G	6	0	6	0	6	12	0	0
19	9140507	.	A	G	1	1	2	0	0	2	0	0
19	9140618	.	C	T	2	4	6	0	0	6	0	0
19	9140750	.	T	C	8	6	14	0	1	15	0	0
19	9140950	.	T	C	1	2	3	0	0	3	0	0
19	9144175	.	G	A	1	4	5	0	6	11	0	0
19	9144228	.	T	G	3	5	8	0	1	9	0	0
19	9144234	.	C	T	3	3	6	0	2	8	0	0
19	9150074	.	T	C	12	6	18	0	1	19	0	0
19	9152720	.	C	A	2	5	7	0	0	7	0	0
19	9152841	.	A	T	10	19	29	0	0	29	0	0
19	9155603	.	A	G	18	0	18	0	9	27	0	0
19	9158481	.	A	T	8	8	16	0	3	19	0	0
19	9161595	.	G	A	9	1	10	0	1	11	0	0
19	9161830	.	C	T	12	11	23	0	1	24	0	0
19	9166374	.	G	A	0	2	2	0	0	2	0	0
19	9168513	.	C	T	11	26	37	0	2	39	0	0
19	9168608	.	C	A	14	12	26	0	0	26	0	0
19	9168622	.	C	T	8	18	26	0	2	28	0	0
19	9168699	.	T	C	22	11	33	0	1	34	0	0
19	9168947	.	G	T	1	13	14	0	17	31	0	0
19	9169099	.	G	A	18	15	33	0	0	33	0	0
19	9169222	.	A	G	1	2	3	0	0	3	0	0
19	9220813	.	C	T	9	12	21	0	1	22	0	0
19	9220828	.	C	T	10	12	22	0	5	27	0	0
19	9220939	.	T	C	7	9	16	0	1	17	0	0
19	9223369	.	T	C	31	15	46	0	3	49	0	0
19	9225567	.	C	T	5	5	10	0	0	10	0	0
19	9225585	.	G	A	5	5	10	0	0	10	0	0
19	9228196	.	T	G	24	15	39	0	2	41	0	0
19	9228326	.	A	T	16	14	30	0	2	32	0	0
19	9228462	.	G	A	1	7	8	0	7	15	0	0
19	9240536	.	C	T	1	5	6	0	0	6	0	0
19	9240576	.	T	C	2	5	7	0	0	7	0	0
19	9241568	.	G	A	4	3	7	0	0	7	0	0
19	9245681	.	A	T	1	0	1	0	0	1	0	0
19	9247724	.	C	T	0	2	2	0	0	2	0	0
19	9251160	.	C	G	2	0	2	0	1	3	0	0
19	9262982	.	A	T	2	2	4	0	0	4	0	0
19	9263201	.	T	A	4	2	6	0	0	6	0	0
19	9265048	.	T	C	5	7	12	0	0	12	0	0
19	9265745	.	G	T	1	4	5	0	0	5	0	0
19	9266027	.	A	G	2	4	6	0	1	7	0	0
19	9266063	.	A	G	4	5	9	0	0	9	0	0
19	9266076	.	A	G	3	4	7	0	2	9	0	0
19	9266162	.	G	A	2	3	5	0	1	6	0	0
19	9266326	.	C	T	8	5	13	0	0	13	0	0
19	9266749	.	T	C	3	3	6	0	0	6	0	0
19	9266963	.	C	T	3	3	6	0	0	6	0	0
19	9268619	.	C	A	4	1	5	0	0	5	0	0
19	9270836	.	T	C	2	2	4	0	0	4	0	0
19	9273768	.	T	A	8	3	11	0	0	11	0	0
19	9273997	.	A	G	4	0	4	0	6	10	0	0
19	9274070	.	G	A	0	7	7	0	4	11	0	0
19	9274095	.	G	T	5	8	13	0	0	13	0	0
19	9274248	.	T	A	6	7	13	0	0	13	0	0
19	9274428	.	T	A	4	9	13	0	0	13	0	0
19	9274844	.	A	C	2	7	9	0	0	9	0	0
19	9274891	.	G	T	5	9	14	0	0	14	0	0
19	9458166	.	A	G	24	0	24	0	14	38	0	0
19	9458181	.	A	C	21	15	36	0	0	36	0	0
19	9458304	.	G	A	11	15	26	1	2	29	0	0
19	9458328	.	T	C	10	20	30	0	0	30	0	0
19	9458421	.	G	A	17	16	33	0	7	40	0	0
19	9458463	.	C	T	20	22	42	0	2	44	0	0
19	9459325	.	T	A	24	16	40	0	1	41	0	0
19	9459330	.	C	T	22	7	29	0	2	31	0	0
19	9459378	.	A	G	18	1	19	0	26	45	0	0
19	9459597	.	G	A	0	18	18	0	20	38	0	0
19	9459673	.	G	A	0	17	17	0	13	30	0	0
19	9459820	.	T	C	15	16	31	0	0	31	0	0
19	9460128	.	A	C	18	8	26	0	2	30	2	0
19	9460196	.	A	G	16	18	34	0	1	35	0	0
19	9460499	.	A	G	19	22	41	0	0	41	0	0
19	9460531	.	G	T	23	29	52	0	1	53	0	0
19	9461072	.	A	G	29	16	45	0	2	47	0	0
19	9461141	.	T	G	17	21	38	0	0	38	0	0
19	9461376	.	A	G	16	24	40	0	1	41	0	0
19	9461841	.	A	G	26	16	42	0	1	43	0	0
19	9471066	.	G	A	28	22	50	0	4	54	0	0
19	9472368	.	T	A	1	2	3	0	0	3	0	0
19	9472405	.	A	G	2	2	4	0	0	4	0	0
19	9472865	.	G	A	30	19	49	0	0	49	0	0
19	9481781	.	T	G	2	3	5	0	0	5	0	0
19	9482071	.	A	G	0	3	3	0	2	5	0	0
19	9482261	.	A	G	7	10	17	0	0	17	0	0
19	9485543	.	A	G	3	4	7	0	0	7	0	0
19	9502456	.	A	C	7	5	12	0	1	13	0	0
19	9502640	.	T	C	15	7	22	0	1	23	0	0
19	9502656	.	A	G	13	11	24	0	1	25	0	0
19	9502968	.	C	T	10	9	19	0	0	19	0	0
19	9503303	.	A	G	8	4	12	0	0	12	0	0
19	9503356	.	T	G	9	8	17	0	1	18	0	0
19	9513443	.	T	C	8	16	24	0	2	26	0	0
19	9513572	.	A	C	7	11	18	0	1	19	0	0
19	9513863	.	A	C	11	16	27	0	0	27	0	0
19	9513869	.	A	C	12	14	26	0	1	27	0	0
19	9516869	.	A	G	4	9	13	0	0	13	0	0
19	9519284	.	G	A	3	1	4	0	0	4	0	0
19	9533299	.	C	G	2	7	9	0	1	10	0	0
19	9585421	.	C	T	8	4	12	0	0	12	0	0
19	9585436	.	G	A	5	3	8	0	1	9	0	0
19	9598053	.	C	T	7	9	16	0	1	17	0	0
19	9598080	.	A	G	8	9	17	0	0	17	0	0
19	9598119	.	C	A	5	3	8	0	0	8	0	0
19	9603062	.	C	T	7	6	13	0	7	20	0	0
19	9603160	.	G	A	2	8	10	0	4	14	0	0
19	9603233	.	G	T	1	13	14	0	10	24	0	0
19	9603425	.	C	T	10	9	19	0	0	19	0	0
19	9603432	.	T	A	9	10	19	0	2	21	0	0
19	9603752	.	C	T	3	3	6	0	1	7	0	0
19	9603975	.	G	T	2	2	4	0	0	4	0	0
19	9604114	.	A	G	0	3	3	0	0	3	0	0
19	9685506	.	A	G	17	13	30	0	1	31	0	0
19	9685695	.	A	G	21	23	44	0	1	45	0	0
19	9686123	.	G	T	7	9	16	0	1	17	0	0
19	9686128	.	A	G	9	10	19	0	0	19	0	0
19	9686160	.	T	C	10	8	18	0	0	18	0	0
19	9686163	.	C	A	10	8	18	0	0	18	0	0
19	9686421	.	G	T	11	15	26	0	2	28	0	0
19	9686515	.	T	A	14	6	20	0	1	21	0	0
19	9686519	.	G	A	13	6	19	0	2	21	0	0
19	9686615	.	T	C	6	19	25	0	1	26	0	0
19	9686627	.	T	C	6	21	27	0	1	28	0	0
19	9686678	.	T	A	12	13	25	0	0	25	0	0
19	9686806	.	T	C	3	2	5	0	0	5	0	0
19	9686807	.	C	T	3	2	5	0	0	5	0	0
19	9686902	.	T	A	4	2	6	0	0	6	0	0
19	9686905	.	T	C	4	0	4	0	2	6	0	0
19	9687001	.	T	G	6	7	13	0	0	13	0	0
19	9687146	.	T	C	22	10	32	0	0	32	0	0
19	9687206	.	T	A	15	12	27	0	3	30	0	0
19	9687306	.	G	A	15	22	37	0	0	37	0	0
19	9691780	.	A	G	9	12	21	0	3	24	0	0
19	9700886	.	T	C	6	0	6	0	5	11	0	0
19	9711421	.	T	C	4	8	12	0	2	14	0	0
19	9711444	.	G	A	4	5	9	0	1	10	0	0
19	9712337	.	G	A	4	4	8	0	0	8	0	0
19	9712357	.	T	A	6	9	15	0	0	15	0	0
19	9712444	.	G	A	7	9	16	0	0	16	0	0
19	9712514	.	C	T	5	3	8	0	0	8	0	0
19	9813608	.	G	A	18	17	35	0	3	38	0	0
19	9814291	.	C	T	1	22	23	0	28	51	0	0
19	9814336	.	T	C	22	22	44	0	0	44	0	0
19	9814423	.	A	G	18	11	29	0	4	33	0	0
19	9814444	.	G	A	18	17	35	0	3	38	0	0
19	9814504	.	G	A	27	22	49	0	0	49	0	0
19	9814516	.	A	G	24	19	43	0	3	46	0	0
19	9814549	.	T	C	25	19	44	0	5	49	0	0
19	9814611	.	A	G	8	10	18	0	0	18	0	0
19	9814621	.	C	T	0	10	10	0	4	14	0	0
19	9822566	.	G	C	21	19	40	0	1	41	0	0
19	9841077	.	T	A	7	6	13	0	0	13	0	0
19	9841203	.	A	T	8	10	18	0	0	18	0	0
19	9841450	.	C	G	13	11	24	0	3	27	0	0
19	9841728	.	T	C	9	12	21	0	0	21	0	0
19	9841825	.	C	T	9	4	13	0	0	13	0	0
19	9841902	.	A	T	11	9	20	0	0	20	0	0
19	9842306	.	A	G	26	11	37	0	1	38	0	0
19	9859170	.	A	G	2	2	4	0	0	4	0	0
19	9866930	.	C	G	5	6	11	0	0	11	0	0
19	9866933	.	C	T	6	5	11	0	0	11	0	0
19	9911419	.	G	A	8	3	11	0	0	11	0	0
19	9911566	.	T	A	6	4	10	0	0	10	0	0
19	9911587	.	T	G	5	6	11	0	0	11	0	0
19	9911855	.	G	A	5	3	8	0	0	8	0	0
19	9911863	.	A	T	4	3	7	0	0	7	0	0
19	9911904	.	A	T	4	3	7	0	0	7	0	0
19	9912063	.	C	T	3	4	7	0	2	9	0	0
19	9912113	.	A	C	4	9	13	0	0	13	0	0
19	9912117	.	C	T	4	7	11	0	1	12	0	0
19	9912169	.	G	A	4	1	5	0	0	5	0	0
19	9912425	.	A	G	2	2	4	0	0	4	0	0
19	9912487	.	A	T	4	10	14	0	0	14	0	0
19	9912561	.	A	C	0	3	3	1	0	4	0	0
19	9912663	.	G	C	5	0	5	0	3	8	0	0
19	9912665	.	G	T	5	2	7	0	1	8	0	0
19	9912756	.	C	A	0	6	6	0	0	6	0	0
19	9912946	.	A	T	2	3	5	0	1	6	0	0
19	9912993	.	C	A	2	3	5	0	1	6	0	0
19	9912998	.	T	C	3	2	5	0	0	5	0	0
19	9914291	.	T	G	4	3	7	0	0	7	0	0
19	9914357	.	G	A	5	3	8	0	0	8	0	0
19	9914845	.	G	A	7	5	12	0	1	13	0	0
19	9916197	.	C	T	4	3	7	0	1	8	0	0
19	9916597	.	C	T	4	4	8	0	0	8	0	0
19	9916630	.	G	T	5	4	9	0	0	9	0	0
19	9916786	.	A	G	5	5	10	0	0	10	0	0
19	9916840	.	G	A	4	5	9	0	0	9	0	0
19	9917518	.	C	T	1	5	6	0	0	6	0	0
19	9919114	.	G	T	1	2	3	0	0	3	0	0
19	9919150	.	C	A	3	3	6	0	0	6	0	0
19	10177290	.	G	A	14	12	26	0	3	29	0	0
19	10177382	.	C	A	14	13	27	0	0	27	0	0
19	10177397	.	T	G	15	15	30	0	0	30	0	0
19	10178339	.	T	A	7	15	22	0	2	24	0	0
19	10180561	.	C	T	0	9	9	0	8	17	0	0
19	10195375	.	C	G	1	3	4	0	0	4	0	0
19	10195376	.	A	C	1	0	1	0	3	4	0	0
19	10195756	.	T	G	9	7	16	0	0	16	0	0
19	10196049	.	T	A	4	11	15	0	0	15	0	0
19	10196070	.	T	A	10	0	10	0	1	14	3	0
19	10196113	.	T	C	6	7	13	0	2	15	0	0
19	10202682	.	T	C	14	0	14	0	9	23	0	0
19	10202756	.	T	A	5	9	14	0	1	15	0	0
19	10203024	.	C	A	0	8	8	0	6	14	0	0
19	10203420	.	T	C	14	9	23	0	0	23	0	0
19	10203936	.	T	G	10	9	19	0	0	19	0	0
19	10204023	.	G	A	3	9	12	0	0	12	0	0
19	10204407	.	G	C	8	9	17	0	0	17	0	0
19	10204476	.	C	T	6	4	10	0	1	11	0	0
19	10205505	.	G	A	5	10	15	0	4	19	0	0
19	10205946	.	C	T	7	5	12	0	1	13	0	0
19	10205949	.	G	A	6	7	13	0	0	13	0	0
19	10217742	.	A	G	0	5	5	0	0	5	0	0
19	10217844	.	T	A	6	3	9	0	1	10	0	0
19	10219001	.	C	T	14	10	24	0	0	24	0	0
19	10219542	.	G	A	8	17	25	0	2	27	0	0
19	10219547	.	T	C	8	17	25	0	2	27	0	0
19	10219749	.	C	T	6	12	18	0	0	18	0	0
19	10220064	.	A	T	20	16	36	0	1	37	0	0
19	10220283	.	T	G	16	13	29	0	1	30	0	0
19	10220421	.	A	G	14	18	32	0	0	32	0	0
19	10220448	.	C	G	1	16	17	0	14	32	1	0
19	10220651	.	T	C	19	4	23	0	22	45	0	0
19	10220790	.	C	T	5	8	13	0	0	13	0	0
19	10235373	.	T	C	14	12	26	0	0	26	0	0
19	10235899	.	G	C	18	11	29	0	0	29	0	0
19	10236249	.	C	T	12	9	21	0	1	22	0	0
19	10236490	.	C	A	9	16	25	0	2	27	0	0
19	10236569	.	T	C	5	9	14	0	0	14	0	0
19	10236853	.	A	G	7	4	11	0	0	11	0	0
19	10237198	.	G	C	6	7	13	0	0	13	0	0
19	10237241	.	G	A	5	10	15	0	0	15	0	0
19	10237365	.	C	A	0	10	10	0	13	23	0	0
19	10237394	.	A	G	13	13	26	0	0	26	0	0
19	10237446	.	A	T	14	24	38	0	0	38	0	0
19	10237815	.	A	T	3	6	9	0	0	9	0	0
19	10237950	.	T	C	6	0	6	0	12	18	0	0
19	10238011	.	G	C	12	0	12	0	7	19	0	0
19	10238045	.	C	G	11	7	18	0	0	18	0	0
19	10238301	.	G	C	8	0	8	0	3	11	0	0
19	10238303	.	T	C	7	3	10	0	1	11	0	0
19	10252999	.	A	G	1	3	4	0	0	4	0	0
19	10253087	.	T	G	5	4	9	0	0	9	0	0
19	10253140	.	A	T	3	3	6	0	0	6	0	0
19	10253316	.	T	C	7	3	10	0	1	11	0	0
19	10253347	.	T	C	8	4	12	0	0	12	0	0
19	10253545	.	G	A	2	4	6	0	0	6	0	0
19	10253812	.	T	A	3	3	6	0	0	6	0	0
19	10253977	.	T	C	2	0	2	0	3	5	0	0
19	10254650	.	C	T	5	3	8	0	0	8	0	0
19	10254690	.	A	C	4	5	9	0	0	9	0	0
19	10255387	.	T	A	3	2	5	0	0	5	0	0
19	10255552	.	T	G	0	2	2	0	1	3	0	0
19	10255554	.	G	A	1	2	3	0	0	3	0	0
19	10255702	.	A	C	3	2	5	0	0	5	0	0
19	10866300	.	G	A	2	1	3	0	0	3	0	0
19	10866310	.	G	A	0	2	2	0	0	2	0	0
19	10870677	.	A	G	0	0	0	0	6	6	0	0
19	11271224	.	C	T	2	3	5	0	0	5	0	0
19	11275304	.	T	A	0	1	1	0	0	1	0	0
19	11314625	.	C	T	3	2	5	0	0	5	0	0
19	11314807	.	C	T	0	5	5	0	0	5	0	0
19	11314858	.	A	T	1	5	6	0	0	6	0	0
19	11314945	.	A	G	3	3	6	0	0	6	0	0
19	11331967	.	G	T	9	15	24	0	0	24	0	0
19	11332050	.	G	T	11	14	25	0	1	26	0	0
19	11332071	.	T	C	15	9	24	0	0	24	0	0
19	11332574	.	T	A	13	9	22	0	1	23	0	0
19	11332576	.	C	T	14	9	23	0	0	23	0	0
19	11332670	.	T	C	10	0	10	0	8	18	0	0
19	11347910	.	C	T	0	0	0	0	3	3	0	0
19	11356692	.	G	A	6	9	15	0	1	16	0	0
19	11429841	.	C	T	0	1	1	0	0	1	0	0
19	11508991	.	G	C	9	6	15	0	0	15	0	0
19	11509029	.	T	C	3	0	3	0	8	11	0	0
19	11545803	.	T	G	3	6	9	0	0	9	0	0
19	11546105	.	G	A	11	4	15	0	2	17	0	0
19	11546181	.	G	A	6	2	8	0	1	9	0	0
19	11790720	.	C	T	0	2	2	0	0	2	0	0
19	11790915	.	G	A	1	1	2	0	0	2	0	0
19	11792756	.	A	T	0	2	2	0	0	2	0	0
19	11814900	.	A	G	3	3	6	0	0	6	0	0
19	11815024	.	T	C	2	2	4	0	0	4	0	0
19	11815030	.	T	A	2	2	4	0	0	4	0	0
19	11815306	.	C	T	3	6	9	0	0	9	0	0
19	11815325	.	C	T	2	6	8	0	0	8	0	0
19	11815448	.	T	A	6	3	9	0	0	9	0	0
19	11815576	.	T	A	4	4	8	0	0	8	0	0
19	11815762	.	T	C	2	0	2	0	4	6	0	0
19	11838654	.	C	T	0	1	1	0	0	1	0	0
19	11846538	.	G	A	0	0	0	0	1	1	0	0
19	11846550	.	G	C	1	1	2	0	1	3	0	0
19	11846607	.	G	T	2	2	4	0	2	6	0	0
19	11892419	.	A	T	3	4	7	0	0	7	0	0
19	11892422	.	A	G	3	5	8	0	0	8	0	0
19	11892636	.	T	A	5	10	15	0	0	15	0	0
19	11892814	.	G	A	2	3	5	0	2	7	0	0
19	11893087	.	A	G	3	6	9	0	0	9	0	0
19	11893309	.	G	T	0	5	5	0	2	7	0	0
19	11893313	.	G	A	2	5	7	0	0	7	0	0
19	11893445	.	A	G	7	5	12	0	0	12	0	0
19	11893624	.	T	C	3	2	5	0	0	5	0	0
19	11893650	.	T	A	1	4	5	0	0	5	0	0
19	11893785	.	G	T	0	3	3	0	0	3	0	0
19	11894055	.	T	A	6	2	8	0	0	8	0	0
19	11897841	.	G	T	2	4	6	0	1	7	0	0
19	11899324	.	A	G	14	10	24	0	0	24	0	0
19	11899384	.	T	C	3	4	7	0	0	7	0	0
19	11906178	.	G	A	2	0	2	0	0	2	0	0
19	11906238	.	T	G	6	2	8	0	1	9	0	0
19	11908436	.	A	G	0	1	1	0	1	2	0	0
19	11908567	.	G	A	2	1	3	0	0	3	0	0
19	11910538	.	T	C	4	0	4	0	4	8	0	0
19	11910595	.	A	C	1	0	1	0	0	1	0	0
19	11912635	.	T	A	2	3	5	0	0	5	0	0
19	11912838	.	T	G	0	2	2	0	0	2	0	0
19	11915066	.	T	G	2	0	2	0	0	2	0	0
19	11915320	.	G	A	2	5	7	0	0	7	0	0
19	11921047	.	C	T	2	7	9	0	0	9	0	0
19	11921816	.	G	A	1	3	4	0	0	4	0	0
19	11921817	.	T	A	1	3	4	0	0	4	0	0
19	11927986	.	G	A	1	2	3	0	0	3	0	0
19	11941657	.	C	T	1	1	2	0	0	2	0	0
19	11955512	.	A	G	4	2	6	0	0	6	0	0
19	11955713	.	A	G	6	8	14	0	0	14	0	0
19	11960343	.	C	T	6	4	10	0	0	11	1	0
19	11964016	.	A	G	5	6	11	0	0	11	0	0
19	11964313	.	A	G	2	3	5	0	0	5	0	0
19	11968998	.	G	A	1	1	2	0	1	3	0	0
19	11969337	.	G	A	1	2	3	0	0	3	0	0
19	11975110	.	A	G	0	1	1	0	1	2	0	0
19	11985848	.	C	T	5	8	13	0	1	14	0	0
19	11985858	.	T	C	6	8	14	0	1	15	0	0
19	11996249	.	T	A	3	1	4	0	0	4	0	0
19	11996360	.	A	C	2	1	3	0	4	7	0	0
19	12017902	.	G	A	0	3	3	0	8	11	0	0
19	12018036	.	C	G	3	6	9	0	0	9	0	0
19	12018084	.	C	T	3	2	5	0	0	5	0	0
19	12018367	.	G	T	0	5	5	0	5	10	0	0
19	12030982	.	C	A	3	0	3	0	0	3	0	0
19	12030992	.	G	A	2	0	2	0	0	2	0	0
19	12031202	.	C	T	0	4	4	0	8	12	0	0
19	12031466	.	T	A	4	7	11	0	0	11	0	0
19	12031515	.	T	G	4	4	8	0	1	9	0	0
19	12031920	.	G	A	4	4	8	0	1	9	0	0
19	12031925	.	G	T	4	6	10	0	0	10	0	0
19	12032622	.	C	T	5	3	8	0	0	8	0	0
19	12032649	.	G	A	5	2	7	0	1	8	0	0
19	12033428	.	T	C	6	3	9	0	0	9	0	0
19	12033494	.	T	C	4	0	4	0	5	9	0	0
19	12046899	.	C	A	0	1	1	0	0	1	0	0
19	12122035	.	A	G	19	22	41	0	0	41	0	0
19	12122039	.	G	A	17	21	38	0	3	41	0	0
19	12122124	.	C	A	36	18	54	0	4	58	0	0
19	12122489	.	G	T	10	13	23	0	1	24	0	0
19	12130089	.	G	A	12	10	22	0	0	22	0	0
19	12134950	.	C	G	1	4	5	0	0	5	0	0
19	12134960	.	T	G	1	3	4	0	0	4	0	0
19	12145548	.	A	T	28	15	43	1	2	46	0	0
19	12171712	.	C	T	15	9	24	0	0	24	0	0
19	12193604	.	A	G	9	5	14	0	0	14	0	0
19	12193617	.	T	A	8	5	13	0	1	14	0	0
19	12211809	.	T	C	5	7	12	0	0	12	0	0
19	12938366	.	T	C	1	2	3	0	0	3	0	0
19	13151155	.	A	G	5	0	5	0	10	15	0	0
19	13413547	.	A	G	2	3	5	0	0	5	0	0
19	13413615	.	A	G	2	8	10	0	0	10	0	0
19	13413617	.	A	G	1	9	10	0	0	10	0	0
19	14419398	.	T	C	0	1	1	0	0	1	0	0
19	14454402	.	A	T	6	2	8	0	0	8	0	0
19	17276028	.	A	G	11	6	17	0	0	17	0	0
19	17515753	.	T	A	7	3	10	0	1	11	0	0
19	17517136	.	T	C	12	4	16	0	0	16	0	0
19	17688595	.	C	A	4	2	6	0	0	6	0	0
19	20721761	.	A	C	3	9	12	1	2	15	0	0
19	20753194	.	G	T	1	5	6	0	1	7	0	0
19	20792049	.	T	A	0	3	3	0	0	3	0	0
19	20792054	.	C	T	4	2	6	0	0	6	0	0
19	24129616	.	A	T	0	7	7	0	0	7	0	0
19	24267287	.	G	A	5	2	7	0	0	7	0	0
19	25653005	.	A	G	0	31	31	0	3	34	0	0
19	27286084	.	A	C	2	3	5	0	1	6	0	0
19	27469130	.	A	G	0	11	11	0	0	11	0	0
19	29842568	.	T	C	3	1	4	0	0	4	0	0
19	30391968	.	G	T	0	1	1	0	1	2	0	0
19	30393967	.	T	C	1	1	2	0	0	2	0	0
19	30396777	.	C	T	9	2	11	0	2	13	0	0
19	30398392	.	T	C	11	16	27	0	0	27	0	0
19	30398395	.	T	C	11	16	27	0	1	28	0	0
19	30398487	.	G	A	2	5	7	0	0	7	0	0
19	30398632	.	T	C	5	7	12	0	0	12	0	0
19	30398700	.	A	C	1	1	2	0	1	3	0	0
19	30398763	.	T	G	2	5	7	0	0	7	0	0
19	30398909	.	T	C	5	3	8	0	0	8	0	0
19	30398978	.	G	A	0	3	3	0	4	7	0	0
19	30399047	.	A	T	6	6	12	0	0	13	1	0
19	30410192	.	G	A	2	3	5	0	2	7	0	0
19	30410406	.	A	G	16	9	25	0	2	27	0	0
19	30414279	.	G	A	10	3	13	0	1	14	0	0
19	30416496	.	G	T	5	1	6	0	1	7	0	0
19	30416523	.	A	T	3	0	3	0	0	3	0	0
19	30417081	.	A	T	1	4	5	0	1	6	0	0
19	30425622	.	T	C	2	4	6	0	0	6	0	0
19	30428688	.	A	C	4	17	21	0	0	21	0	0
19	30428726	.	A	G	3	2	5	0	8	13	0	0
19	30429063	.	G	A	2	3	5	0	0	5	0	0
19	30434939	.	C	T	0	1	1	0	0	1	0	0
19	30438496	.	G	A	1	1	2	0	0	2	0	0
19	30438518	.	A	G	1	1	2	0	0	2	0	0
19	30439733	.	C	T	4	6	10	0	3	13	0	0
19	30439754	.	C	T	4	10	14	0	0	14	0	0
19	30455697	.	A	G	9	5	14	0	1	15	0	0
19	30457627	.	G	A	4	5	9	0	1	10	0	0
19	30457648	.	C	T	5	7	12	0	0	12	0	0
19	30457811	.	C	A	5	7	12	0	0	12	0	0
19	30458039	.	C	A	8	4	12	0	0	12	0	0
19	30458103	.	G	A	0	11	11	0	13	24	0	0
19	30458121	.	C	T	10	11	21	0	1	22	0	0
19	30460936	.	T	A	1	0	1	0	0	1	0	0
19	30460953	.	C	T	1	0	1	0	0	1	0	0
19	30463210	.	G	C	1	5	6	0	1	7	0	0
19	30481692	.	T	C	6	0	6	0	6	12	0	0
19	30481799	.	T	A	6	17	23	0	0	23	0	0
19	30485029	.	G	A	1	1	2	0	0	2	0	0
19	30485085	.	T	C	13	8	21	0	1	22	0	0
19	30485247	.	T	G	1	1	2	0	0	2	0	0
19	30485253	.	A	G	2	1	3	0	0	3	0	0
19	30495908	.	C	T	4	6	10	0	3	13	0	0
19	30495985	.	T	C	3	0	3	0	7	10	0	0
19	30499969	.	T	A	5	7	12	0	1	13	0	0
19	30506619	.	C	T	3	5	8	0	1	9	0	0
19	30506709	.	G	A	4	3	7	0	0	7	0	0
19	30510264	.	T	C	4	1	5	0	0	5	0	0
19	30518480	.	T	A	12	11	23	0	0	23	0	0
19	30518646	.	A	C	23	21	44	0	0	44	0	0
19	30518906	.	A	G	20	15	35	0	0	35	0	0
19	30518973	.	C	T	18	13	31	0	1	32	0	0
19	30519319	.	A	G	4	8	12	0	0	12	0	0
19	30519324	.	C	T	4	9	13	0	1	14	0	0
19	30519459	.	T	A	4	3	7	0	0	7	0	0
19	30519510	.	T	C	2	2	4	0	0	4	0	0
19	30519802	.	C	T	10	13	23	0	0	23	0	0
19	30519803	.	T	G	10	12	22	0	1	23	0	0
19	30519858	.	A	G	11	14	25	0	0	25	0	0
19	30520061	.	T	G	11	16	27	0	0	27	0	0
19	30520214	.	C	T	19	14	33	0	0	33	0	0
19	30520337	.	A	G	15	15	30	0	1	31	0	0
19	30520419	.	G	A	16	24	40	0	0	40	0	0
19	30520431	.	C	G	12	21	33	0	0	33	0	0
19	30520567	.	T	A	9	9	18	0	1	19	0	0
19	30520569	.	T	A	10	9	19	0	0	19	0	0
19	30521281	.	T	A	3	2	5	0	0	5	0	0
19	30521443	.	C	A	1	3	4	0	0	4	0	0
19	30522182	.	T	C	7	13	20	0	2	22	0	0
19	30564815	.	A	G	1	0	1	0	1	2	0	0
19	30669930	.	A	G	15	8	23	0	1	24	0	0
19	30672935	.	T	C	16	16	32	0	0	32	0	0
19	30673004	.	T	A	10	6	16	0	2	18	0	0
19	30676543	.	G	A	0	1	1	0	0	1	0	0
19	30676699	.	C	T	11	13	24	0	0	24	0	0
19	30681938	.	G	A	0	15	15	0	26	41	0	0
19	30682680	.	G	A	22	30	52	0	1	53	0	0
19	30682781	.	C	A	19	24	43	0	0	43	0	0
19	30682947	.	A	G	23	18	41	0	2	43	0	0
19	30683129	.	A	C	19	25	44	0	0	44	0	0
19	30683395	.	A	T	24	16	40	0	1	41	0	0
19	30723251	.	A	T	3	2	5	0	0	5	0	0
19	30723308	.	T	C	1	0	1	0	5	6	0	0
19	30723482	.	C	T	1	2	3	0	0	3	0	0
19	30723554	.	C	G	5	3	8	0	0	8	0	0
19	30723675	.	A	T	1	2	3	0	0	3	0	0
19	30755362	.	C	A	3	1	4	0	0	4	0	0
19	30763040	.	G	T	2	1	3	0	0	3	0	0
19	30805617	.	C	T	4	5	9	0	0	9	0	0
19	30805698	.	C	G	8	6	14	0	0	14	0	0
19	30805886	.	A	C	4	7	11	0	1	12	0	0
19	30807557	.	A	G	10	7	17	0	2	19	0	0
19	30810911	.	A	T	5	3	8	0	0	8	0	0
19	30810916	.	T	G	4	4	8	0	0	8	0	0
19	30810958	.	T	C	3	6	9	0	0	9	0	0
19	30810970	.	G	A	3	8	11	0	0	11	0	0
19	30811103	.	A	G	5	4	9	0	0	9	0	0
19	30867948	.	G	A	3	6	9	0	1	10	0	0
19	30867955	.	A	T	3	5	8	0	0	8	0	0
19	30868030	.	C	T	1	2	3	0	0	3	0	0
19	30868063	.	C	G	0	1	1	0	0	1	0	0
19	30876669	.	G	A	1	1	2	0	0	2	0	0
19	30878424	.	G	A	1	0	1	0	0	1	0	0
19	30878655	.	G	T	1	0	1	0	0	1	0	0
19	30878688	.	C	T	1	0	1	0	0	1	0	0
19	30880083	.	C	G	3	4	7	0	0	7	0	0
19	30882576	.	G	T	7	5	12	0	0	12	0	0
19	30882688	.	T	C	6	7	13	0	0	13	0	0
19	30882743	.	G	A	6	1	7	0	1	8	0	0
19	30882973	.	A	T	12	11	23	0	0	23	0	0
19	30883224	.	C	T	7	7	14	0	1	15	0	0
19	30883298	.	G	A	6	8	14	0	1	15	0	0
19	30883302	.	G	A	6	8	14	0	1	15	0	0
19	30883476	.	A	T	6	7	13	0	0	13	0	0
19	30883549	.	T	C	2	9	11	0	0	11	0	0
19	30886970	.	T	C	3	7	10	0	1	11	0	0
19	30894883	.	G	A	11	9	20	0	0	20	0	0
19	30894980	.	A	G	8	5	13	0	1	14	0	0
19	30895163	.	G	A	2	5	7	0	0	7	0	0
19	30897545	.	T	A	2	3	5	0	1	6	0	0
19	30897585	.	A	C	2	6	8	0	0	8	0	0
19	30898050	.	C	T	1	3	4	0	0	4	0	0
19	30899256	.	T	C	2	3	5	0	0	5	0	0
19	30899280	.	T	G	2	6	8	0	0	8	0	0
19	30899536	.	C	A	1	5	6	0	0	6	0	0
19	30900150	.	C	T	0	2	2	0	3	5	0	0
19	30902042	.	C	T	2	3	5	0	0	5	0	0
19	30999947	.	T	C	8	2	10	0	7	17	0	0
19	31000077	.	C	T	0	8	8	0	8	16	0	0
19	31000207	.	T	C	7	17	24	0	2	26	0	0
19	31001318	.	T	G	4	4	8	0	0	8	0	0
19	31001417	.	A	G	2	2	4	0	0	4	0	0
19	31003330	.	A	T	9	8	17	0	2	19	0	0
19	31005005	.	A	C	7	6	13	0	1	14	0	0
19	31005053	.	C	T	1	1	2	0	0	2	0	0
19	31010033	.	A	C	8	4	12	0	1	13	0	0
19	31010061	.	T	A	2	1	3	0	0	3	0	0
19	31012900	.	G	A	3	10	13	0	0	13	0	0
19	31016410	.	A	T	6	9	15	0	0	15	0	0
19	31016458	.	C	A	10	9	19	0	0	19	0	0
19	31340089	.	G	A	7	3	10	0	1	11	0	0
19	31340777	.	A	G	4	7	11	0	2	13	0	0
19	31340882	.	C	G	0	7	7	0	9	16	0	0
19	31341000	.	C	T	5	11	16	0	0	16	0	0
19	31341829	.	C	T	4	2	6	0	0	6	0	0
19	31347668	.	T	C	1	2	3	0	0	3	0	0
19	31392375	.	C	T	13	11	24	0	0	24	0	0
19	31392700	.	G	A	19	18	37	0	0	37	0	0
19	31392803	.	C	T	0	3	3	0	5	8	0	0
19	31394550	.	A	G	7	10	17	0	1	18	0	0
19	31398961	.	A	G	6	6	12	0	0	12	0	0
19	31398979	.	A	G	7	10	17	0	0	17	0	0
19	31402418	.	T	C	1	1	2	0	0	2	0	0
19	31416787	.	G	A	7	5	12	0	0	12	0	0
19	31424215	.	C	G	5	0	5	0	3	8	0	0
19	31431021	.	T	C	6	6	12	0	1	13	0	0
19	31437956	.	A	G	6	8	14	0	4	18	0	0
19	31437974	.	G	A	4	6	10	0	2	12	0	0
19	31438009	.	G	T	3	4	7	0	0	7	0	0
19	31438016	.	T	C	2	0	2	0	3	5	0	0
19	31449834	.	T	G	5	1	6	0	1	7	0	0
19	31455562	.	T	C	0	1	1	0	0	1	0	0
19	31461620	.	C	G	2	3	5	0	1	6	0	0
19	31517478	.	T	C	4	1	5	0	0	5	0	0
19	31569338	.	A	G	1	0	1	0	0	1	0	0
19	31571563	.	T	C	3	3	6	0	0	6	0	0
19	31571572	.	G	A	3	3	6	0	0	6	0	0
19	31574099	.	A	T	2	1	3	0	1	4	0	0
19	31574150	.	G	T	2	4	6	0	0	6	0	0
19	31575616	.	G	A	1	1	2	0	0	2	0	0
19	31575705	.	A	G	3	1	4	0	0	4	0	0
19	31576024	.	T	A	5	4	9	0	0	9	0	0
19	31576954	.	A	G	8	10	18	0	2	20	0	0
19	31579783	.	T	A	20	11	31	0	0	31	0	0
19	31579860	.	G	T	21	21	42	0	0	42	0	0
19	31580071	.	C	A	0	15	15	0	12	27	0	0
19	31580103	.	A	T	17	18	35	0	2	37	0	0
19	31580160	.	T	A	21	16	37	0	1	38	0	0
19	31580186	.	T	G	12	14	26	0	3	29	0	0
19	31580328	.	A	C	21	3	24	0	26	50	0	0
19	31582349	.	C	T	0	1	1	0	0	1	0	0
19	31583137	.	A	G	7	5	12	0	1	13	0	0
19	31583179	.	C	T	11	7	18	0	4	22	0	0
19	31583289	.	C	T	12	8	20	0	1	21	0	0
19	31583305	.	A	G	7	7	14	0	0	14	0	0
19	31584018	.	T	G	12	23	35	0	1	36	0	0
19	31590194	.	A	G	3	0	3	0	0	3	0	0
19	31593550	.	A	G	2	7	9	0	1	10	0	0
19	31593594	.	C	A	2	8	10	0	1	11	0	0
19	31593595	.	C	A	2	8	10	0	1	11	0	0
19	31593706	.	G	C	6	6	12	0	0	12	0	0
19	31593762	.	G	A	7	4	11	0	2	13	0	0
19	31593957	.	C	T	10	3	13	0	0	13	0	0
19	31596948	.	C	G	0	1	1	0	0	1	0	0
19	31598108	.	G	T	3	1	4	0	0	4	0	0
19	31598113	.	G	A	1	2	3	0	0	3	0	0
19	31613176	.	G	A	3	4	7	0	1	8	0	0
19	31619299	.	G	A	3	2	5	0	0	5	0	0
19	31619311	.	A	G	3	2	5	0	1	6	0	0
19	31743583	.	T	A	6	2	8	0	0	8	0	0
19	31771335	.	T	A	28	21	49	0	1	50	0	0
19	31789533	.	C	G	3	3	6	0	6	12	0	0
19	31789666	.	C	T	15	19	34	0	9	43	0	0
19	31790042	.	C	A	28	11	39	0	4	43	0	0
19	31790079	.	A	G	33	17	50	0	1	51	0	0
19	31790097	.	C	T	33	18	51	0	2	53	0	0
19	31790115	.	C	A	17	27	44	0	0	44	0	0
19	31790283	.	G	C	39	21	60	0	1	61	0	0
19	31790385	.	A	G	20	25	45	0	6	51	0	0
19	31797691	.	T	C	0	3	3	0	0	3	0	0
19	31797778	.	G	A	11	6	17	0	0	17	0	0
19	31797834	.	G	T	8	5	13	0	0	13	0	0
19	31798162	.	T	C	0	6	6	0	0	6	0	0
19	31798203	.	C	G	0	5	5	0	1	6	0	0
19	31798420	.	T	A	1	2	3	0	0	3	0	0
19	31798456	.	G	T	2	2	4	0	0	4	0	0
19	31798479	.	C	T	3	3	6	0	1	7	0	0
19	31798660	.	G	A	6	3	9	0	1	10	0	0
19	31798809	.	A	C	1	1	2	0	0	2	0	0
19	31798885	.	T	C	0	0	0	0	2	2	0	0
19	31798966	.	A	C	1	0	1	0	3	4	0	0
19	31799664	.	G	C	2	0	2	0	3	5	0	0
19	31800090	.	G	A	2	7	9	0	0	9	0	0
19	31800112	.	A	G	1	9	10	0	1	11	0	0
19	31800271	.	A	G	1	4	5	0	0	5	0	0
19	31800283	.	T	C	1	3	4	0	0	4	0	0
19	31878529	.	A	T	3	0	3	0	0	3	0	0
19	31882114	.	G	A	2	5	7	0	0	7	0	0
19	31891350	.	A	G	4	5	9	0	0	9	0	0
19	31938817	.	T	C	3	4	7	0	2	9	0	0
19	32042056	.	C	T	2	3	5	0	0	5	0	0
19	32049055	.	A	G	11	7	18	0	2	20	0	0
19	32049443	.	T	C	10	11	21	0	1	22	0	0
19	32049485	.	A	T	6	12	18	0	0	18	0	0
19	32049775	.	G	A	7	7	14	0	0	14	0	0
19	32049850	.	A	G	17	7	24	0	2	26	0	0
19	32049891	.	A	G	9	9	18	0	0	18	0	0
19	32050174	.	T	G	7	13	20	0	1	21	0	0
19	32050535	.	A	T	16	15	31	0	0	31	0	0
19	32050536	.	T	A	16	15	31	0	0	31	0	0
19	32050593	.	A	T	0	11	11	0	0	11	0	0
19	32050679	.	C	A	11	7	18	0	1	19	0	0
19	32050702	.	G	A	5	8	13	0	1	14	0	0
19	32050822	.	C	T	0	3	3	0	4	7	0	0
19	32050944	.	A	T	14	16	30	0	0	30	0	0
19	32051218	.	C	A	10	5	15	0	1	16	0	0
19	32051226	.	G	A	7	10	17	0	0	17	0	0
19	32051541	.	T	G	3	8	11	0	0	11	0	0
19	32051566	.	G	C	4	0	4	0	0	4	0	0
19	32064557	.	T	G	8	15	23	0	0	23	0	0
19	32064872	.	C	T	0	3	3	0	4	7	0	0
19	32895702	.	G	A	18	8	26	1	2	29	0	0
19	34957672	.	C	T	2	2	4	0	0	4	0	0
19	34960099	.	A	G	5	4	9	0	0	9	0	0
19	34960143	.	A	G	8	10	18	0	1	19	0	0
19	34960147	.	G	A	8	11	19	0	0	19	0	0
19	34960190	.	C	G	1	17	18	0	15	33	0	0
19	34960198	.	T	C	16	16	32	0	0	32	0	0
19	34960315	.	T	A	5	7	12	0	2	14	0	0
19	34960694	.	T	A	2	7	9	0	5	14	0	0
19	34960816	.	C	A	4	2	6	0	0	6	0	0
19	34961152	.	C	T	7	13	20	0	2	22	0	0
19	34961269	.	A	G	0	2	2	0	0	2	0	0
19	34966834	.	C	T	1	2	3	0	0	3	0	0
19	35002450	.	G	A	5	5	10	0	0	10	0	0
19	35002527	.	G	A	0	1	1	0	1	2	0	0
19	35002714	.	A	C	0	3	3	0	0	3	0	0
19	35002723	.	T	C	0	3	3	0	0	3	0	0
19	35004117	.	A	C	10	3	13	0	0	13	0	0
19	35004135	.	C	T	10	2	12	0	0	12	0	0
19	35004868	.	C	A	0	3	3	0	0	3	0	0
19	35004869	.	C	A	0	3	3	0	0	3	0	0
19	35004920	.	G	A	2	3	5	0	1	6	0	0
19	35004941	.	T	C	3	8	11	0	0	11	0	0
19	35005136	.	A	C	6	3	9	0	0	9	0	0
19	35005137	.	A	T	6	3	9	0	0	9	0	0
19	35005318	.	G	A	3	11	14	0	8	22	0	0
19	35007021	.	G	A	0	3	3	0	1	4	0	0
19	35007220	.	G	A	4	1	5	0	0	5	0	0
19	35007235	.	G	A	4	1	5	0	0	5	0	0
19	35013806	.	C	T	22	25	47	0	1	48	0	0
19	35016477	.	C	T	1	0	1	0	0	1	0	0
19	35016553	.	T	G	14	14	28	0	0	28	0	0
19	35016646	.	A	T	24	15	39	0	3	42	0	0
19	35016696	.	T	G	13	9	22	0	1	24	1	0
19	35016835	.	C	T	13	11	24	0	0	24	0	0
19	35016962	.	T	A	4	5	9	0	2	11	0	0
19	35019490	.	T	A	1	3	4	0	0	4	0	0
19	35040003	.	G	T	3	3	6	0	1	7	0	0
19	35041158	.	T	A	15	29	44	0	3	47	0	0
19	35041308	.	A	G	27	23	50	0	2	52	0	0
19	35041458	.	T	C	9	0	9	0	8	17	0	0
19	35052411	.	G	T	12	10	22	0	0	22	0	0
19	35052435	.	T	C	12	0	12	0	10	22	0	0
19	35055889	.	A	G	7	14	21	0	0	21	0	0
19	35057860	.	G	T	0	1	1	0	0	1	0	0
19	35057869	.	C	T	3	1	4	0	0	4	0	0
19	35058232	.	T	C	2	7	9	0	0	9	0	0
19	35060217	.	A	C	16	14	30	0	0	30	0	0
19	35065906	.	A	T	6	5	11	0	0	11	0	0
19	35067367	.	G	A	12	15	27	0	0	27	0	0
19	35069299	.	G	T	2	0	2	0	0	2	0	0
19	35069755	.	C	A	5	4	9	0	0	9	0	0
19	35069934	.	T	G	2	2	4	0	0	4	0	0
19	35070015	.	C	T	7	2	9	0	0	9	0	0
19	35072613	.	A	C	14	9	23	0	3	26	0	0
19	35072712	.	G	C	4	1	5	0	4	9	0	0
19	35075637	.	C	T	2	6	8	0	14	22	0	0
19	35076301	.	C	T	0	11	11	0	6	17	0	0
19	35076773	.	G	A	13	15	28	0	0	28	0	0
19	35078584	.	T	C	14	0	14	0	18	32	0	0
19	35078632	.	T	C	4	1	5	0	3	8	0	0
19	35079259	.	C	T	9	11	20	0	1	21	0	0
19	35079515	.	A	T	3	1	4	0	0	4	0	0
19	35082163	.	T	A	1	2	3	0	0	3	0	0
19	35083010	.	G	A	2	4	6	0	0	6	0	0
19	35083019	.	C	T	2	0	2	0	0	2	0	0
19	35083182	.	C	T	1	0	1	0	0	1	0	0
19	35116228	.	A	G	8	12	20	0	0	20	0	0
19	35116297	.	T	C	6	7	13	0	0	13	0	0
19	35116405	.	A	G	13	7	20	0	1	21	0	0
19	35116438	.	G	A	14	4	18	0	2	20	0	0
19	35118813	.	G	C	7	9	16	0	0	16	0	0
19	35118842	.	T	C	5	9	14	0	2	16	0	0
19	35118860	.	G	T	4	9	13	0	1	14	0	0
19	35118911	.	C	A	7	8	15	0	0	15	0	0
19	35118983	.	A	T	8	10	18	0	0	18	0	0
19	35119039	.	T	C	8	5	13	0	1	14	0	0
19	35119052	.	A	G	7	5	12	0	3	15	0	0
19	35119082	.	T	C	5	1	6	0	7	13	0	0
19	35119169	.	G	A	7	9	16	0	0	16	0	0
19	35119205	.	G	A	7	5	12	0	0	12	0	0
19	35119436	.	C	T	6	14	20	0	1	21	0	0
19	35121381	.	T	C	5	4	9	0	1	10	0	0
19	35121459	.	T	C	10	8	18	0	0	18	0	0
19	35123452	.	A	T	1	3	4	0	0	4	0	0
19	35128238	.	T	C	6	2	8	0	0	8	0	0
19	35131332	.	G	A	0	1	1	0	0	1	0	0
19	35134092	.	G	T	2	3	5	0	1	6	0	0
19	35134181	.	G	A	1	4	5	0	0	5	0	0
19	35135406	.	C	A	0	5	5	0	4	9	0	0
19	35135466	.	G	A	1	2	3	0	0	3	0	0
19	35135600	.	A	G	5	1	6	0	0	6	0	0
19	35135626	.	T	G	6	3	9	0	0	9	0	0
19	35135711	.	A	G	3	4	7	0	0	7	0	0
19	35135870	.	C	T	2	0	2	0	0	2	0	0
19	35135883	.	A	G	2	2	4	0	0	4	0	0
19	35135927	.	T	G	7	4	11	0	0	11	0	0
19	35135961	.	A	G	5	7	12	0	1	13	0	0
19	35137910	.	A	G	3	3	6	0	0	6	0	0
19	35138260	.	A	G	2	2	4	0	0	4	0	0
19	35140771	.	A	T	1	3	4	0	0	4	0	0
19	35140812	.	C	T	1	3	4	0	0	4	0	0
19	35155676	.	C	T	4	1	5	0	0	5	0	0
19	35157621	.	C	T	6	0	6	0	0	6	0	0
19	35159665	.	G	T	3	1	4	0	0	4	0	0
19	35159668	.	G	A	3	2	5	0	0	5	0	0
19	35159721	.	A	G	7	6	13	0	0	13	0	0
19	35167278	.	A	T	4	6	10	0	0	10	0	0
19	35167368	.	C	G	2	2	4	0	0	4	0	0
19	35170195	.	A	T	7	2	9	0	0	9	0	0
19	35175205	.	A	G	5	2	7	0	0	7	0	0
19	35184402	.	A	G	1	3	4	0	0	4	0	0
19	35191348	.	A	G	2	4	6	0	0	6	0	0
19	35339968	.	G	A	4	2	6	0	1	7	0	0
19	35359341	.	C	T	17	27	44	0	1	45	0	0
19	35379917	.	A	G	2	6	8	0	1	9	0	0
19	35379923	.	G	A	2	7	9	0	0	9	0	0
19	35379998	.	A	G	4	5	9	0	1	10	0	0
19	35380031	.	G	A	7	6	13	0	0	13	0	0
19	35380070	.	G	A	5	5	10	0	0	10	0	0
19	35380168	.	T	C	6	1	7	0	2	9	0	0
19	35381625	.	T	A	0	1	1	0	0	1	0	0
19	35381956	.	A	G	1	4	5	0	0	5	0	0
19	35383571	.	G	A	0	4	4	0	0	4	0	0
19	35383586	.	C	T	0	3	3	0	0	3	0	0
19	35386288	.	T	G	0	3	3	0	0	3	0	0
19	35390668	.	T	C	3	1	4	0	0	4	0	0
19	35419202	.	A	G	3	2	5	0	1	6	0	0
19	35419215	.	T	A	4	4	8	0	1	9	0	0
19	35419292	.	T	A	2	2	4	0	0	4	0	0
19	35419300	.	A	T	2	2	4	0	0	4	0	0
19	35422354	.	T	C	4	2	6	0	0	6	0	0
19	35428735	.	G	A	5	4	9	0	0	9	0	0
19	35435011	.	G	A	2	2	4	0	0	4	0	0
19	35446532	.	A	G	0	1	1	0	0	1	0	0
19	35459414	.	A	G	14	9	23	0	2	25	0	0
19	35459737	.	G	A	15	26	41	0	0	41	0	0
19	35459801	.	A	T	19	22	41	0	0	41	0	0
19	35473080	.	C	A	0	4	4	0	5	9	0	0
19	35723040	.	G	T	16	11	27	0	2	29	0	0
19	35723087	.	G	T	16	17	33	0	0	33	0	0
19	35723113	.	G	T	12	25	37	0	1	38	0	0
19	35723189	.	G	T	0	0	0	0	3	3	0	0
19	35723214	.	T	C	3	0	3	0	8	11	0	0
19	35723237	.	C	A	9	12	21	0	0	21	0	0
19	35723268	.	A	T	9	16	25	0	1	26	0	0
19	35723289	.	C	A	10	13	23	0	1	24	0	0
19	35723422	.	C	T	7	12	19	0	0	19	0	0
19	35723552	.	C	T	0	8	8	0	5	13	0	0
19	35733351	.	T	C	6	14	20	0	0	20	0	0
19	35849232	.	A	G	1	0	1	0	0	1	0	0
19	36114931	.	A	T	1	2	3	0	0	3	0	0
19	36115044	.	G	A	7	5	12	0	1	13	0	0
19	36115084	.	C	T	5	11	16	0	0	16	0	0
19	36115100	.	C	T	0	12	12	0	4	16	0	0
19	36115170	.	G	C	4	6	10	0	1	11	0	0
19	36115210	.	G	A	5	8	13	0	0	13	0	0
19	36120265	.	C	T	0	5	5	0	5	10	0	0
19	36167703	.	C	T	0	5	5	0	8	13	0	0
19	36169872	.	A	G	2	2	4	0	1	5	0	0
19	36171682	.	T	C	1	0	1	0	6	7	0	0
19	36171778	.	G	A	3	3	6	0	0	6	0	0
19	36212370	.	G	A	1	1	2	0	1	3	0	0
19	36227281	.	G	A	2	4	6	0	1	7	0	0
19	36227407	.	A	G	2	0	2	0	0	2	0	0
19	36277799	.	G	A	3	0	3	0	0	3	0	0
19	36290669	.	C	T	0	2	2	0	3	5	0	0
19	36290702	.	G	A	4	3	7	0	0	7	0	0
19	36374340	.	A	G	2	3	5	0	0	5	0	0
19	36374365	.	G	A	3	4	7	0	0	7	0	0
19	37127483	.	A	T	8	4	12	0	0	12	0	0
19	37133533	.	C	A	7	6	13	0	2	15	0	0
19	37133719	.	G	T	4	3	7	0	0	7	0	0
19	37133872	.	T	C	3	4	7	0	1	8	0	0
19	37138743	.	C	T	8	14	22	0	0	22	0	0
19	37139266	.	T	C	8	4	12	0	1	13	0	0
19	37459656	.	A	G	1	1	2	0	0	2	0	0
19	37481658	.	C	T	4	4	8	0	0	8	0	0
19	37488593	.	C	T	0	2	2	0	0	2	0	0
19	37492351	.	G	A	3	3	6	0	0	6	0	0
19	37501738	.	T	C	11	0	11	0	9	20	0	0
19	37501802	.	C	T	15	15	30	0	1	31	0	0
19	37501935	.	A	G	19	18	37	0	2	39	0	0
19	37501959	.	C	T	22	23	45	0	0	45	0	0
19	37502235	.	G	A	8	8	16	0	0	16	0	0
19	37504201	.	G	A	1	1	2	0	0	2	0	0
19	37505790	.	G	A	0	3	3	0	0	3	0	0
19	37505808	.	G	A	4	1	5	0	0	5	0	0
19	37505880	.	C	G	5	4	9	0	0	9	0	0
19	37506405	.	G	A	1	5	6	0	0	6	0	0
19	37506414	.	T	C	1	5	6	0	0	6	0	0
19	37508533	.	G	A	4	6	10	0	0	10	0	0
19	37701637	.	A	G	1	2	3	0	0	3	0	0
19	37799569	.	T	C	1	1	2	0	0	2	0	0
19	37804440	.	T	C	2	3	5	0	0	5	0	0
19	37804673	.	T	C	3	1	4	0	0	4	0	0
19	37815718	.	C	A	5	6	11	0	0	11	0	0
19	37815733	.	A	G	6	4	10	0	0	10	0	0
19	37815763	.	G	A	3	4	7	0	0	7	0	0
19	37829463	.	A	C	2	0	2	0	0	2	0	0
19	37835433	.	A	C	3	3	6	0	0	6	0	0
19	37835502	.	A	G	1	1	2	0	0	2	0	0
19	37835508	.	T	C	1	1	2	0	0	2	0	0
19	37926003	.	C	T	22	15	37	0	0	37	0	0
19	37926066	.	C	A	19	17	36	0	2	38	0	0
19	37926261	.	C	T	12	19	31	0	1	32	0	0
19	37926267	.	C	A	12	19	31	0	1	32	0	0
19	37926447	.	C	T	10	15	25	0	3	28	0	0
19	37926493	.	C	T	10	11	21	0	0	21	0	0
19	37926637	.	A	G	3	0	3	0	8	11	0	0
19	37926816	.	T	G	21	11	32	0	0	32	0	0
19	38171067	.	G	A	0	3	3	0	0	3	0	0
19	38175219	.	C	T	4	5	9	0	1	10	0	0
19	38175630	.	A	T	1	2	3	0	0	3	0	0
19	38205299	.	T	C	1	3	4	0	0	4	0	0
19	38205350	.	T	C	1	3	4	0	0	4	0	0
19	38216302	.	A	C	3	10	13	0	0	13	0	0
19	38216310	.	C	G	3	1	4	0	9	13	0	0
19	38240844	.	C	T	3	1	4	0	0	4	0	0
19	38327186	.	T	C	1	2	3	0	0	3	0	0
19	38327305	.	G	A	2	3	5	0	0	5	0	0
19	38389833	.	G	A	1	5	6	0	1	7	0	0
19	38473901	.	G	T	3	3	6	0	0	6	0	0
19	38477272	.	G	T	1	2	3	0	0	3	0	0
19	38776962	.	A	G	4	8	12	0	2	14	0	0
19	38777235	.	T	C	2	3	5	0	0	5	0	0
19	40026627	.	A	G	19	15	34	0	2	36	0	0
19	40026661	.	T	C	19	24	43	0	0	43	0	0
19	40027652	.	C	A	19	13	32	0	2	34	0	0
19	40031164	.	G	A	19	15	34	0	0	34	0	0
19	40039603	.	G	A	12	10	22	0	0	22	0	0
19	40039606	.	T	A	11	8	19	0	2	21	0	0
19	40039651	.	A	T	7	7	14	0	1	15	0	0
19	40052809	.	G	T	3	5	8	0	1	9	0	0
19	40052884	.	G	A	7	5	12	0	1	13	0	0
19	40055365	.	A	T	1	4	5	0	0	5	0	0
19	40071619	.	A	G	1	0	1	0	4	5	0	0
19	40099361	.	C	T	4	3	7	0	0	7	0	0
19	40110897	.	G	A	1	10	11	0	0	11	0	0
19	40113526	.	G	A	0	3	3	0	4	7	0	0
19	40113549	.	T	G	2	2	4	0	0	4	0	0
19	40113618	.	T	C	5	6	11	0	0	11	0	0
19	40126647	.	A	G	1	0	1	0	4	5	0	0
19	40129258	.	A	C	4	5	9	0	0	9	0	0
19	40129443	.	A	G	2	2	4	0	0	4	0	0
19	40145888	.	G	A	5	8	13	0	1	14	0	0
19	40146214	.	C	T	0	1	1	0	0	1	0	0
19	40146215	.	G	A	1	0	1	0	0	1	0	0
19	40147782	.	T	C	16	4	20	0	0	20	0	0
19	40147821	.	G	A	0	15	15	0	4	19	0	0
19	40151351	.	C	T	4	1	5	0	0	5	0	0
19	40151970	.	G	A	3	4	7	0	0	7	0	0
19	40151983	.	C	T	2	3	5	0	0	5	0	0
19	40153024	.	A	T	3	2	5	0	0	5	0	0
19	40154957	.	C	T	10	8	18	0	0	18	0	0
19	40155144	.	C	A	4	5	9	0	0	9	0	0
19	40155327	.	C	T	4	9	13	0	1	14	0	0
19	40156805	.	G	A	0	6	6	0	1	7	0	0
19	40157041	.	T	A	6	2	8	0	0	8	0	0
19	40162945	.	C	A	14	13	27	0	1	28	0	0
19	40163077	.	C	T	8	3	11	0	0	11	0	0
19	40163184	.	C	T	4	1	5	0	0	5	0	0
19	40163223	.	G	A	7	11	18	0	0	18	0	0
19	40177726	.	G	C	1	3	4	0	0	4	0	0
19	40177762	.	T	C	2	0	2	0	0	2	0	0
19	40179916	.	G	C	0	8	8	0	6	14	0	0
19	40180011	.	C	T	9	11	20	0	2	22	0	0
19	40180058	.	G	A	5	8	13	0	2	15	0	0
19	40185995	.	T	G	2	2	4	0	0	4	0	0
19	40326527	.	G	A	0	3	3	0	4	7	0	0
19	40326882	.	C	T	4	5	9	0	1	10	0	0
19	40340319	.	A	G	5	3	8	0	0	8	0	0
19	40343087	.	C	T	4	1	5	0	0	5	0	0
19	40347600	.	T	G	1	0	1	0	1	2	0	0
19	40347702	.	T	A	16	21	37	0	1	38	0	0
19	40347760	.	T	A	13	9	22	0	3	25	0	0
19	40347785	.	A	T	13	6	19	0	1	20	0	0
19	40540276	.	A	T	0	1	1	0	0	1	0	0
19	40540324	.	C	T	1	0	1	0	0	1	0	0
19	40551964	.	C	T	3	4	7	0	0	7	0	0
19	40551982	.	T	G	5	0	5	0	5	10	0	0
19	40558221	.	C	T	4	0	4	0	0	4	0	0
19	40558281	.	A	G	5	3	8	0	0	8	0	0
19	40641356	.	C	G	1	0	1	0	2	3	0	0
19	40641379	.	A	G	2	3	5	0	0	5	0	0
19	40641439	.	C	T	4	4	8	0	0	8	0	0
19	40685424	.	C	T	3	9	12	0	1	13	0	0
19	40685447	.	A	G	7	1	8	0	4	12	0	0
19	40685875	.	G	A	5	6	11	0	0	11	0	0
19	40685923	.	T	C	9	3	12	0	0	12	0	0
19	40685935	.	A	G	5	2	7	0	2	9	0	0
19	40686662	.	T	A	5	6	11	0	0	11	0	0
19	40717649	.	C	A	4	10	14	0	1	15	0	0
19	40770455	.	G	A	1	2	3	0	0	3	0	0
19	40770527	.	G	A	4	0	4	0	0	4	0	0
19	40773573	.	G	A	1	5	6	0	0	6	0	0
19	40776907	.	G	A	3	0	3	0	0	3	0	0
19	40889832	.	T	C	1	0	1	0	1	2	0	0
19	40892312	.	T	C	4	6	10	0	0	10	0	0
19	40895763	.	G	A	5	6	11	0	2	13	0	0
19	40895826	.	T	C	2	3	5	0	1	6	0	0
19	40898334	.	A	C	6	17	23	0	0	23	0	0
19	40898352	.	T	G	4	1	5	0	13	18	0	0
19	40898500	.	G	A	5	5	10	0	0	10	0	0
19	40900205	.	T	C	9	0	9	0	7	16	0	0
19	40900334	.	C	T	2	2	4	0	0	4	0	0
19	40906097	.	A	C	13	14	27	0	0	27	0	0
19	40906118	.	T	A	9	12	21	0	0	21	0	0
19	41021048	.	T	C	3	2	5	0	0	5	0	0
19	41033811	.	G	A	1	17	18	0	16	34	0	0
19	41038855	.	C	T	8	29	37	0	2	39	0	0
19	41160925	.	A	G	3	3	6	0	1	7	0	0
19	42629789	.	G	A	1	4	5	0	0	5	0	0
19	42843640	.	A	G	8	0	8	0	3	11	0	0
19	42843845	.	A	G	7	6	13	0	0	13	0	0
19	42843859	.	A	G	9	5	14	0	1	15	0	0
19	42843894	.	A	G	11	8	19	0	0	19	0	0
19	42844126	.	A	G	8	5	13	0	0	13	0	0
19	43706808	.	G	C	0	12	12	0	0	12	0	0
19	43900995	.	A	G	5	4	9	0	0	9	0	0
19	45859824	.	C	T	15	5	20	0	0	20	0	0
19	45868237	.	A	C	4	2	6	0	1	7	0	0
19	45883536	.	C	T	4	3	7	0	0	7	0	0
19	45883563	.	G	A	11	7	18	0	0	18	0	0
19	45896193	.	C	T	16	9	25	0	1	26	0	0
19	45962080	.	T	G	0	2	2	0	0	2	0	0
19	45962214	.	G	A	3	5	8	0	1	9	0	0
19	45967297	.	C	G	7	0	7	0	7	14	0	0
19	45967406	.	G	A	8	10	18	0	1	19	0	0
19	45967516	.	A	G	2	1	3	0	8	11	0	0
19	45970867	.	G	C	2	2	4	0	0	4	0	0
19	45977846	.	A	T	4	5	9	0	0	9	0	0
19	45977932	.	C	T	1	2	3	0	0	3	0	0
19	45979521	.	C	T	0	2	2	0	0	2	0	0
19	45980323	.	C	T	4	10	14	0	1	15	0	0
19	45980428	.	A	C	6	2	8	0	0	8	0	0
19	45980545	.	C	T	0	2	2	0	0	2	0	0
19	45985934	.	C	A	1	2	3	0	1	4	0	0
19	45994263	.	T	C	1	2	3	0	0	3	0	0
19	45999081	.	G	A	1	0	1	0	0	1	0	0
19	45999146	.	G	A	3	2	5	0	0	5	0	0
19	46001218	.	G	A	2	4	6	0	0	6	0	0
19	46006267	.	G	A	5	4	9	0	1	10	0	0
19	46010406	.	C	G	1	1	2	0	0	2	0	0
19	46014993	.	A	T	1	3	4	0	0	4	0	0
19	46015027	.	C	T	0	2	2	0	1	3	0	0
19	46015372	.	C	T	1	2	3	0	0	3	0	0
19	46019644	.	A	T	0	3	3	0	0	4	1	0
19	46019645	.	A	T	0	4	4	0	0	4	0	0
19	46020177	.	A	C	9	0	9	0	8	17	0	0
19	46020276	.	C	T	0	11	11	0	9	20	0	0
19	46020462	.	G	A	9	18	27	0	1	28	0	0
19	46020544	.	G	C	3	1	4	0	4	8	0	0
19	46028151	.	T	A	12	7	19	0	1	20	0	0
19	46032793	.	T	G	6	2	8	0	1	9	0	0
19	46033012	.	C	T	2	2	4	0	1	5	0	0
19	46038800	.	G	A	4	5	9	0	0	9	0	0
19	46043943	.	G	T	1	5	6	0	0	6	0	0
19	46047223	.	T	A	3	3	6	0	0	6	0	0
19	46049311	.	C	T	5	3	8	0	0	8	0	0
19	46050672	.	C	T	1	1	2	0	4	6	0	0
19	47976325	.	C	T	26	26	52	0	0	52	0	0
19	47976449	.	A	T	10	3	13	0	0	13	0	0
19	47982897	.	A	G	19	21	40	0	0	40	0	0
19	47983014	.	C	G	8	7	15	0	2	17	0	0
19	47983859	.	G	A	0	3	3	0	0	3	0	0
19	47984483	.	C	T	6	4	10	0	0	10	0	0
19	47986324	.	C	T	0	24	24	0	17	41	0	0
19	47989417	.	T	C	1	0	1	0	0	1	0	0
19	48013142	.	G	A	6	4	10	0	0	10	0	0
19	48013172	.	A	G	11	6	17	0	0	17	0	0
19	48014266	.	A	G	6	7	13	0	0	13	0	0
19	48018336	.	T	C	4	0	4	0	7	11	0	0
19	48022989	.	T	G	9	16	25	0	1	26	0	0
19	48023309	.	A	G	28	3	31	0	22	53	0	0
19	48031094	.	T	C	7	7	14	0	0	14	0	0
19	48032167	.	G	A	1	7	8	0	6	14	0	0
19	48033631	.	A	G	4	10	14	0	0	14	0	0
19	48036809	.	T	G	15	1	16	0	19	35	0	0
19	48049279	.	T	G	19	10	29	0	2	31	0	0
19	48050029	.	G	A	0	9	9	0	4	13	0	0
19	48053315	.	A	C	19	16	35	0	1	36	0	0
19	48064885	.	C	T	1	3	4	0	1	5	0	0
19	48067046	.	C	T	5	4	9	0	0	9	0	0
19	48069366	.	T	C	5	3	8	0	0	8	0	0
19	48102652	.	C	T	4	2	6	0	0	6	0	0
19	48114344	.	T	A	3	3	6	0	1	7	0	0
19	48119203	.	T	C	15	7	22	1	2	25	0	0
19	48120238	.	A	G	11	2	13	0	15	28	0	0
19	48251407	.	T	C	1	2	3	0	0	3	0	0
19	48251410	.	T	C	1	0	1	0	2	3	0	0
19	48252173	.	T	C	1	2	3	0	1	4	0	0
19	48284234	.	A	T	1	2	3	0	0	3	0	0
19	48364848	.	C	T	0	10	10	0	2	12	0	0
19	48364870	.	T	C	8	16	24	0	1	25	0	0
2	19225	.	T	C	5	9	14	0	0	14	0	0
2	19568	.	G	A	12	12	24	0	0	24	0	0
2	21074	.	A	G	14	14	28	0	1	29	0	0
2	21479	.	C	T	0	26	26	0	30	56	0	0
2	68899	.	A	G	2	4	6	0	0	6	0	0
2	100981	.	T	C	1	0	1	0	2	3	0	0
2	108000	.	C	T	4	4	8	0	0	8	0	0
2	108586	.	G	A	0	1	1	0	1	2	0	0
2	109030	.	G	A	13	14	27	0	0	27	0	0
2	109075	.	T	C	7	7	14	0	0	14	0	0
2	112223	.	T	C	0	2	2	0	0	2	0	0
2	113654	.	A	G	1	2	3	0	0	3	0	0
2	136409	.	T	G	3	6	9	0	1	10	0	0
2	136479	.	A	G	4	8	12	0	0	12	0	0
2	137169	.	T	C	0	1	1	0	0	1	0	0
2	138603	.	G	A	0	1	1	0	0	1	0	0
2	146199	.	T	C	3	4	7	0	0	7	0	0
2	1213071	.	C	T	0	1	1	0	0	1	0	0
2	1213640	.	C	T	1	2	3	0	0	3	0	0
2	1215156	.	G	A	0	1	1	0	0	1	0	0
2	1220802	.	T	C	1	1	2	0	0	2	0	0
2	1453259	.	G	A	3	1	4	0	0	4	0	0
2	1463612	.	A	C	3	0	3	0	2	5	0	0
2	1466478	.	T	C	2	0	2	0	7	9	0	0
2	1466829	.	G	A	0	6	6	0	0	6	0	0
2	1509457	.	A	G	0	1	1	0	0	1	0	0
2	1527682	.	C	G	5	4	9	0	1	10	0	0
2	1527828	.	T	C	8	0	8	0	7	15	0	0
2	1529602	.	G	C	3	0	3	0	6	9	0	0
2	1540611	.	A	C	1	0	1	0	1	2	0	0
2	1543191	.	A	G	5	4	9	0	0	9	0	0
2	1548430	.	T	A	3	7	10	0	0	10	0	0
2	1548470	.	A	C	4	0	4	0	7	11	0	0
2	1569132	.	T	C	2	5	7	0	0	7	0	0
2	1595187	.	C	T	8	9	17	0	0	17	0	0
2	1595275	.	T	C	8	21	29	0	3	32	0	0
2	1595330	.	A	G	12	3	15	0	1	16	0	0
2	1595334	.	G	A	12	2	14	0	2	16	0	0
2	1595470	.	T	C	10	7	17	0	0	17	0	0
2	1595582	.	C	T	0	7	7	0	9	16	0	0
2	1595601	.	A	G	10	10	20	0	1	21	0	0
2	1595696	.	A	G	4	4	8	0	0	8	0	0
2	1595897	.	T	C	6	5	11	0	1	12	0	0
2	1595914	.	T	C	5	5	10	0	1	11	0	0
2	1595945	.	G	C	10	8	18	0	0	18	0	0
2	1596159	.	C	T	1	3	4	0	3	7	0	0
2	1596196	.	T	A	8	4	12	0	1	13	0	0
2	1596282	.	G	T	7	5	12	0	0	12	0	0
2	1596325	.	C	A	1	8	9	0	13	22	0	0
2	1596327	.	C	T	1	8	9	0	13	22	0	0
2	1596424	.	T	A	8	8	16	0	0	16	0	0
2	1596671	.	C	T	2	3	5	0	0	5	0	0
2	1596690	.	T	C	3	2	5	0	0	5	0	0
2	1596830	.	C	T	0	3	3	0	6	9	0	0
2	1596908	.	A	T	8	6	14	0	0	14	0	0
2	1597048	.	C	T	5	3	8	0	0	8	0	0
2	1597054	.	A	G	5	3	8	0	0	8	0	0
2	1597084	.	G	A	5	5	10	0	0	10	0	0
2	1597096	.	G	A	3	5	8	0	1	9	0	0
2	1597396	.	A	C	4	4	8	0	0	8	0	0
2	1597413	.	T	C	7	5	12	0	0	12	0	0
2	1597534	.	T	C	7	0	7	0	6	13	0	0
2	1597588	.	A	G	8	4	12	0	1	13	0	0
2	1597617	.	T	C	4	10	14	0	1	15	0	0
2	1597634	.	T	A	7	9	16	0	0	16	0	0
2	1597658	.	C	T	0	8	8	0	5	13	0	0
2	1598115	.	C	A	7	4	11	0	0	11	0	0
2	1598124	.	G	A	6	5	11	0	1	12	0	0
2	1598533	.	A	C	13	0	13	0	5	18	0	0
2	1714740	.	T	G	2	2	4	0	0	4	0	0
2	1750377	.	T	C	1	5	6	0	0	6	0	0
2	1759608	.	G	T	0	2	2	0	1	3	0	0
2	1771164	.	C	T	2	6	8	0	0	8	0	0
2	1771233	.	A	T	6	4	10	0	0	10	0	0
2	1771464	.	T	C	1	2	3	0	0	3	0	0
2	1846555	.	G	A	0	4	4	0	2	6	0	0
2	1846624	.	A	G	3	4	7	0	1	8	0	0
2	1941054	.	G	A	1	4	5	0	0	5	0	0
2	1942812	.	C	T	5	6	11	0	0	11	0	0
2	1943037	.	A	G	4	0	4	0	8	12	0	0
2	2005807	.	T	C	3	3	6	0	0	6	0	0
2	2005836	.	T	A	2	2	4	0	3	7	0	0
2	2005844	.	C	A	3	4	7	0	0	7	0	0
2	2005892	.	T	C	1	2	3	0	0	3	0	0
2	2010765	.	T	C	24	1	25	0	30	55	0	0
2	2010945	.	G	C	22	30	52	0	1	53	0	0
2	2011287	.	T	A	16	29	45	0	0	45	0	0
2	2013834	.	C	T	3	6	9	0	15	24	0	0
2	2017450	.	T	C	7	11	18	0	0	18	0	0
2	2024876	.	A	G	2	6	8	0	1	9	0	0
2	2025044	.	A	G	7	5	12	0	0	12	0	0
2	2025080	.	T	C	8	3	11	0	0	11	0	0
2	2025175	.	C	A	7	5	12	0	0	12	0	0
2	2025219	.	G	T	5	7	12	0	1	13	0	0
2	2025617	.	A	G	8	8	16	0	0	16	0	0
2	2026068	.	G	A	7	10	17	0	0	17	0	0
2	2026218	.	G	A	3	4	7	0	0	7	0	0
2	2026397	.	T	C	8	8	16	0	3	19	0	0
2	2026475	.	G	T	10	7	17	0	0	17	0	0
2	2039601	.	A	G	0	1	1	0	0	1	0	0
2	2045718	.	G	A	2	0	2	0	0	2	0	0
2	2047189	.	G	A	0	3	3	0	2	5	0	0
2	2047234	.	G	A	3	8	11	0	1	12	0	0
2	2095574	.	G	C	5	4	9	0	1	10	0	0
2	2159181	.	A	G	1	3	4	0	0	4	0	0
2	2161269	.	C	T	3	2	5	0	0	5	0	0
2	2168642	.	T	A	4	2	6	0	0	6	0	0
2	2169353	.	T	C	1	3	4	0	0	4	0	0
2	2172878	.	G	A	0	12	12	0	14	26	0	0
2	2172879	.	T	A	12	13	25	0	1	26	0	0
2	2173317	.	A	T	20	23	43	0	1	44	0	0
2	2248991	.	C	A	3	0	3	0	1	4	0	0
2	2248993	.	C	T	0	4	4	0	0	4	0	0
2	2251501	.	C	T	8	5	13	0	0	13	0	0
2	2256216	.	T	C	1	4	5	0	0	5	0	0
2	2256372	.	C	G	6	4	10	0	0	10	0	0
2	2256375	.	C	T	4	6	10	0	0	10	0	0
2	2256424	.	T	C	2	4	6	0	1	7	0	0
2	2630212	.	A	G	19	9	28	0	0	28	0	0
2	2633731	.	G	A	2	2	4	0	0	4	0	0
2	2638528	.	C	T	0	1	1	0	4	5	0	0
2	2785378	.	C	T	7	5	12	0	0	12	0	0
2	2786198	.	T	A	3	3	6	0	0	6	0	0
2	2791168	.	C	T	0	7	7	0	11	18	0	0
2	2795564	.	C	T	2	6	8	0	0	8	0	0
2	2805882	.	T	C	2	0	2	0	1	3	0	0
2	2818664	.	G	A	0	2	2	0	1	3	0	0
2	2849616	.	C	T	0	1	1	0	0	1	0	0
2	2851740	.	C	A	1	3	4	0	0	4	0	0
2	2851746	.	G	T	0	3	3	0	1	4	0	0
2	2854959	.	C	G	0	2	2	0	0	2	0	0
2	2857400	.	T	C	2	0	2	0	0	2	0	0
2	2859642	.	C	T	0	1	1	0	0	1	0	0
2	2867344	.	A	G	0	1	1	0	0	1	0	0
2	2869590	.	A	G	1	3	4	0	0	4	0	0
2	2871722	.	T	C	1	2	3	0	0	3	0	0
2	2872180	.	G	T	0	2	2	0	1	3	0	0
2	2872550	.	G	A	5	10	15	0	0	15	0	0
2	2872565	.	A	G	7	12	19	0	0	19	0	0
2	2873531	.	A	G	7	0	7	0	9	16	0	0
2	2873546	.	G	A	7	8	15	0	0	15	0	0
2	2873579	.	T	A	5	3	8	0	0	8	0	0
2	2883302	.	C	T	1	1	2	0	0	2	0	0
2	2892531	.	A	G	4	7	11	0	0	11	0	0
2	2894098	.	A	T	6	11	17	0	0	17	0	0
2	2900553	.	A	T	2	3	5	0	0	5	0	0
2	2905776	.	G	A	2	7	9	0	0	9	0	0
2	2905996	.	T	C	8	8	16	0	0	16	0	0
2	2908617	.	A	G	12	0	12	0	6	18	0	0
2	2911892	.	A	T	2	0	2	0	0	2	0	0
2	2913151	.	C	T	8	3	11	0	0	11	0	0
2	2913161	.	G	A	9	4	13	0	0	13	0	0
2	2916697	.	T	C	1	3	4	0	0	4	0	0
2	2917105	.	T	C	12	9	21	0	1	22	0	0
2	2967361	.	A	C	3	3	6	0	0	6	0	0
2	2967440	.	T	G	1	2	3	0	0	3	0	0
2	2967453	.	C	T	1	2	3	0	0	3	0	0
2	2975272	.	G	A	2	2	4	0	0	4	0	0
2	2977237	.	C	A	0	2	2	0	0	2	0	0
2	2987062	.	G	A	5	3	8	0	0	8	0	0
2	2988214	.	C	T	1	2	3	0	0	3	0	0
2	3014242	.	G	C	4	2	6	0	0	6	0	0
2	3014326	.	G	A	0	1	1	0	0	1	0	0
2	3015951	.	T	C	1	2	3	0	1	4	0	0
2	3015975	.	T	C	1	0	1	0	0	1	0	0
2	3020186	.	G	T	3	5	8	0	0	8	0	0
2	3022253	.	G	A	0	0	0	0	2	2	0	0
2	3026997	.	T	C	6	2	8	0	0	8	0	0
2	3027065	.	T	A	14	4	18	0	0	18	0	0
2	3027066	.	A	T	14	4	18	0	0	18	0	0
2	3027200	.	T	A	13	15	28	0	1	29	0	0
2	3027286	.	G	A	15	8	23	0	0	23	0	0
2	3027504	.	C	T	16	7	23	0	0	23	0	0
2	3027704	.	C	G	11	14	25	0	1	26	0	0
2	3027765	.	G	T	12	12	24	0	1	25	0	0
2	3027804	.	C	T	0	10	10	0	8	18	0	0
2	3027859	.	T	C	9	2	11	0	13	24	0	0
2	3027862	.	A	G	9	15	24	0	1	25	0	0
2	3027928	.	T	C	6	12	18	0	1	19	0	0
2	3028117	.	A	G	13	9	22	0	0	22	0	0
2	3028156	.	G	T	12	7	19	0	0	19	0	0
2	3028203	.	T	C	15	9	24	0	0	25	1	0
2	3028233	.	C	T	11	12	23	0	1	24	0	0
2	3028270	.	A	T	10	12	22	0	2	24	0	0
2	3028312	.	T	G	9	8	17	0	0	17	0	0
2	3028463	.	G	A	5	5	10	0	0	10	0	0
2	3028558	.	T	C	4	8	12	0	1	13	0	0
2	3028605	.	G	A	10	6	16	0	0	16	0	0
2	3028715	.	C	T	2	5	7	0	0	7	0	0
2	3028893	.	A	G	5	3	8	0	0	8	0	0
2	3028908	.	A	T	5	3	8	0	0	8	0	0
2	3029048	.	T	C	6	0	6	0	6	12	0	0
2	3029383	.	T	A	14	7	21	0	0	21	0	0
2	3029437	.	T	C	17	0	17	0	9	26	0	0
2	3032707	.	G	A	5	8	13	0	3	16	0	0
2	3032944	.	C	T	0	6	6	0	3	9	0	0
2	3034701	.	T	C	1	1	2	0	0	2	0	0
2	3034704	.	T	A	1	1	2	0	0	2	0	0
2	3034819	.	G	A	5	6	11	0	0	11	0	0
2	3034907	.	G	A	0	1	1	0	0	1	0	0
2	3045272	.	C	G	3	3	6	0	0	6	0	0
2	3056627	.	A	G	1	0	1	0	0	1	0	0
2	3056663	.	A	C	1	0	1	0	0	1	0	0
2	3061083	.	G	A	1	2	3	0	1	4	0	0
2	3062181	.	T	G	5	4	9	0	0	9	0	0
2	3062356	.	T	G	1	1	2	0	0	2	0	0
2	3062381	.	T	G	1	2	3	0	0	3	0	0
2	3064922	.	A	G	4	13	17	0	0	17	0	0
2	3065248	.	C	T	8	5	13	0	0	13	0	0
2	3065428	.	C	T	7	5	12	0	1	13	0	0
2	3065451	.	C	T	8	6	14	0	0	14	0	0
2	3065474	.	C	G	6	7	13	0	0	13	0	0
2	3065507	.	C	T	7	7	14	0	0	14	0	0
2	3065563	.	G	A	6	4	10	0	0	10	0	0
2	3065581	.	A	T	7	6	13	0	0	13	0	0
2	3065633	.	A	T	5	3	8	0	0	8	0	0
2	3066074	.	T	A	2	4	6	0	0	6	0	0
2	3066075	.	C	T	2	4	6	0	0	6	0	0
2	3066304	.	G	A	2	2	4	0	0	4	0	0
2	3066336	.	T	A	2	2	4	0	1	5	0	0
2	3066391	.	A	T	2	2	4	0	0	4	0	0
2	3067118	.	C	A	3	3	6	0	0	6	0	0
2	3067132	.	T	C	3	0	3	0	4	7	0	0
2	4045400	.	T	C	13	5	18	0	1	19	0	0
2	4045656	.	T	C	7	9	16	0	1	17	0	0
2	4045661	.	A	G	0	13	13	0	1	14	0	0
2	4729279	.	A	T	0	3	3	0	0	3	0	0
2	4729329	.	G	A	3	4	7	0	0	7	0	0
2	4729340	.	G	A	6	4	10	0	0	10	0	0
2	4729682	.	A	T	1	3	4	0	0	4	0	0
2	4729798	.	A	T	1	4	5	0	0	5	0	0
2	4729857	.	G	T	4	2	6	0	1	7	0	0
2	4735995	.	G	A	3	2	5	0	0	5	0	0
2	4736978	.	G	A	6	5	11	0	0	11	0	0
2	4737217	.	G	T	4	2	6	0	0	6	0	0
2	4737350	.	G	T	1	5	6	0	0	6	0	0
2	4737524	.	T	A	2	5	7	0	0	7	0	0
2	4737607	.	G	A	4	2	6	0	1	7	0	0
2	4753966	.	C	A	1	2	3	0	1	4	0	0
2	4754041	.	T	G	1	2	3	0	0	3	0	0
2	4758510	.	T	C	2	0	2	0	0	2	0	0
2	4765408	.	G	A	1	2	3	0	0	3	0	0
2	4900650	.	T	C	27	7	34	0	2	36	0	0
2	4900688	.	A	C	12	13	25	0	2	27	0	0
2	4900798	.	T	C	7	25	32	0	0	32	0	0
2	4902439	.	T	C	12	3	15	0	3	18	0	0
2	4902586	.	T	C	2	0	2	0	14	16	0	0
2	4902590	.	T	C	7	9	16	0	0	16	0	0
2	4902647	.	G	A	0	2	2	0	3	5	0	0
2	4902648	.	G	A	1	2	3	0	2	5	0	0
2	4907857	.	C	T	1	1	2	0	0	2	0	0
2	4916736	.	A	G	1	2	3	0	1	4	0	0
2	4930730	.	T	C	7	6	13	0	0	13	0	0
2	4948832	.	A	G	6	7	13	0	0	13	0	0
2	4948850	.	G	A	5	5	10	0	0	10	0	0
2	4950607	.	C	T	7	4	11	0	0	11	0	0
2	4984371	.	A	T	1	3	4	0	0	4	0	0
2	4995045	.	C	G	8	6	14	0	0	14	0	0
2	4995084	.	C	T	0	5	5	0	6	11	0	0
2	5014631	.	A	C	6	6	12	0	0	12	0	0
2	5043749	.	T	A	0	3	3	0	0	3	0	0
2	5407137	.	A	G	4	8	12	0	0	12	0	0
2	5407152	.	A	G	6	3	9	0	0	9	0	0
2	5579958	.	A	G	10	0	10	0	4	14	0	0
2	5734952	.	T	C	4	5	9	0	0	9	0	0
2	5883127	.	A	G	19	6	25	0	1	26	0	0
2	6033874	.	G	A	0	1	1	0	0	1	0	0
2	7056470	.	G	T	5	3	8	0	0	8	0	0
2	7154025	.	T	C	4	4	8	0	0	8	0	0
2	7154599	.	T	C	1	0	1	0	2	3	0	0
2	7154619	.	T	C	2	2	4	0	0	4	0	0
2	7240378	.	G	A	1	4	5	0	1	6	0	0
2	7422927	.	C	T	1	2	3	0	3	6	0	0
2	7767314	.	C	T	2	3	5	0	0	5	0	0
2	9716336	.	G	A	0	1	1	0	0	1	0	0
2	9747645	.	G	A	1	2	3	0	0	3	0	0
2	10607387	.	T	C	2	3	5	0	0	5	0	0
2	10685754	.	A	G	6	0	6	0	4	10	0	0
2	13018408	.	T	C	1	8	9	0	0	9	0	0
2	13186823	.	T	A	12	4	16	0	0	16	0	0
2	14455498	.	A	G	2	0	2	0	0	2	0	0
2	14998764	.	A	G	1	5	6	0	0	6	0	0
2	15942638	.	A	G	8	3	11	0	0	11	0	0
2	16387964	.	G	A	0	2	2	0	0	2	0	0
2	16548514	.	T	C	22	8	30	0	0	30	0	0
2	17105693	.	T	C	1	0	1	0	0	1	0	0
2	17266812	.	G	C	1	0	1	0	3	4	0	0
2	17267217	.	C	T	0	2	2	0	2	4	0	0
2	17267621	.	G	A	4	1	5	0	0	5	0	0
2	17267626	.	G	A	4	2	6	0	0	6	0	0
2	17317821	.	G	A	0	1	1	0	0	1	0	0
2	17318017	.	G	A	0	2	2	0	0	2	0	0
2	17450642	.	C	T	4	4	8	0	1	9	0	0
2	17450726	.	A	T	1	8	9	0	0	9	0	0
2	17450841	.	A	T	2	2	4	0	0	4	0	0
2	17450859	.	C	A	0	3	3	0	2	5	0	0
2	17451003	.	G	A	3	2	5	0	0	5	0	0
2	17451198	.	G	A	5	6	11	0	1	12	0	0
2	17451327	.	A	G	11	8	19	0	1	20	0	0
2	17451375	.	G	A	9	6	15	0	0	15	0	0
2	17468947	.	C	T	1	2	3	0	0	3	0	0
2	17488438	.	G	T	0	1	1	0	0	1	0	0
2	17578710	.	A	G	10	24	34	0	3	37	0	0
2	17579033	.	G	A	16	10	26	0	1	27	0	0
2	17579109	.	A	C	20	0	20	0	10	31	1	0
2	17579110	.	A	G	21	9	30	0	0	31	1	0
2	17579324	.	T	C	29	8	37	0	1	38	0	0
2	17579888	.	A	C	23	0	23	0	16	39	0	0
2	17579926	.	G	C	32	0	32	0	12	44	0	0
2	17596503	.	A	G	0	1	1	0	0	1	0	0
2	17604640	.	G	C	3	4	7	0	0	7	0	0
2	17617513	.	T	C	3	1	4	0	1	5	0	0
2	17644591	.	G	A	20	12	32	0	1	33	0	0
2	17644609	.	T	C	14	1	15	0	16	31	0	0
2	17646976	.	G	A	1	2	3	0	1	4	0	0
2	17651370	.	A	G	2	2	4	0	0	4	0	0
2	17651466	.	A	G	10	19	29	0	0	29	0	0
2	17651529	.	C	T	0	18	18	0	7	25	0	0
2	17651565	.	C	T	2	17	19	0	1	20	0	0
2	17651574	.	C	T	2	17	19	0	0	19	0	0
2	17702137	.	T	C	6	0	6	0	5	11	0	0
2	17702518	.	G	A	6	3	9	0	0	9	0	0
2	17704701	.	G	A	4	2	6	0	0	6	0	0
2	17717026	.	A	G	2	3	5	0	1	6	0	0
2	17728132	.	G	A	0	1	1	0	0	1	0	0
2	17792300	.	T	C	0	0	0	0	2	2	0	0
2	19101393	.	A	T	2	7	9	0	0	9	0	0
2	19222708	.	T	C	2	2	4	0	0	4	0	0
2	20285762	.	G	A	1	0	1	0	0	1	0	0
2	20323703	.	C	A	2	3	5	0	0	5	0	0
2	20332135	.	A	G	6	6	12	0	0	12	0	0
2	20367846	.	A	C	13	11	24	0	3	27	0	0
2	20367927	.	G	T	8	15	23	0	0	23	0	0
2	20368569	.	A	C	13	17	30	0	1	31	0	0
2	20368630	.	G	A	0	12	12	0	11	23	0	0
2	20368761	.	T	C	17	17	34	0	1	35	0	0
2	20368812	.	G	A	18	14	32	0	3	35	0	0
2	20368965	.	C	T	23	22	45	0	0	45	0	0
2	20369516	.	A	G	19	16	35	0	1	36	0	0
2	20369836	.	A	T	15	22	37	0	2	39	0	0
2	20369925	.	T	A	13	12	25	0	2	27	0	0
2	20369947	.	A	C	11	9	20	0	4	24	0	0
2	20370012	.	C	T	12	15	27	0	0	27	0	0
2	20370090	.	G	C	19	15	34	1	1	36	0	0
2	20370143	.	C	T	18	19	37	0	0	37	0	0
2	20370792	.	T	C	20	20	40	0	0	40	0	0
2	20370893	.	C	T	16	17	33	0	0	33	0	0
2	20370998	.	A	G	19	14	33	0	0	33	0	0
2	20371060	.	T	A	10	4	14	0	0	14	0	0
2	20371210	.	G	C	3	5	8	0	0	8	0	0
2	20437721	.	G	A	10	8	18	0	0	18	0	0
2	20437878	.	G	A	12	5	17	0	0	17	0	0
2	20438054	.	G	A	15	15	30	0	3	33	0	0
2	20438061	.	A	T	15	12	27	0	3	30	0	0
2	20438589	.	C	T	8	6	14	0	0	14	0	0
2	20439070	.	A	G	12	0	12	0	11	23	0	0
2	20439223	.	G	T	9	20	29	0	1	30	0	0
2	20439303	.	C	T	7	16	23	0	0	23	0	0
2	20440244	.	G	A	0	2	2	0	0	2	0	0
2	20473191	.	T	G	1	4	5	0	0	5	0	0
2	20475819	.	A	G	1	6	7	0	0	7	0	0
2	20477158	.	C	T	2	2	4	0	0	4	0	0
2	20478880	.	A	T	4	2	6	0	0	6	0	0
2	20487211	.	C	T	2	4	6	0	0	6	0	0
2	20501627	.	C	A	3	1	4	0	0	4	0	0
2	20501646	.	C	T	3	2	5	0	0	5	0	0
2	20503698	.	C	A	6	9	15	0	0	15	0	0
2	20503734	.	T	G	8	0	8	0	11	19	0	0
2	20503770	.	C	T	6	3	9	0	0	9	0	0
2	20505994	.	C	T	1	5	6	0	0	6	0	0
2	20505995	.	C	T	4	1	5	0	1	6	0	0
2	20514915	.	A	G	2	0	2	0	0	2	0	0
2	20515013	.	G	A	8	11	19	0	0	19	0	0
2	20515056	.	G	A	3	3	6	0	0	6	0	0
2	20515060	.	T	G	3	2	5	0	0	5	0	0
2	20515307	.	C	T	2	5	7	0	0	7	0	0
2	20515377	.	C	T	1	1	2	0	0	2	0	0
2	20516291	.	G	A	4	1	5	0	0	5	0	0
2	20523002	.	C	T	3	3	6	0	0	6	0	0
2	20523004	.	C	T	3	3	6	0	0	6	0	0
2	20523351	.	T	A	11	10	21	0	1	22	0	0
2	20523364	.	A	G	13	13	26	0	0	26	0	0
2	20526411	.	T	C	22	11	33	0	1	34	0	0
2	20526592	.	A	G	7	0	7	0	9	16	0	0
2	20526599	.	T	A	9	11	20	0	0	20	0	0
2	20565967	.	T	C	0	0	0	0	1	1	0	0
2	20614879	.	T	C	1	3	4	0	0	4	0	0
2	20614955	.	T	A	1	3	4	0	0	4	0	0
2	20663819	.	C	T	2	1	3	0	0	3	0	0
2	20666367	.	G	C	0	1	1	0	0	1	0	0
2	20811080	.	C	T	3	3	6	0	1	7	0	0
2	20811739	.	A	G	1	2	3	0	0	3	0	0
2	20814291	.	T	G	7	3	10	0	0	10	0	0
2	20814419	.	T	C	1	1	2	0	0	2	0	0
2	20814488	.	C	T	8	9	17	0	0	17	0	0
2	20814688	.	G	C	4	0	4	0	3	7	0	0
2	20814754	.	G	T	1	1	2	0	0	2	0	0
2	20817736	.	G	A	1	3	4	0	0	4	0	0
2	20820587	.	C	T	2	3	5	0	0	5	0	0
2	20822794	.	A	G	3	1	4	0	1	5	0	0
2	20826495	.	T	C	1	2	3	0	0	3	0	0
2	20828000	.	G	A	3	3	6	0	0	6	0	0
2	20828235	.	C	T	1	1	2	0	1	3	0	0
2	20830387	.	A	G	3	4	7	0	0	7	0	0
2	20830993	.	C	G	2	6	8	0	0	8	0	0
2	20836438	.	A	C	3	3	6	0	0	6	0	0
2	20836780	.	G	A	3	3	6	0	0	6	0	0
2	20837017	.	G	A	1	2	3	0	1	4	0	0
2	20840539	.	C	A	4	6	10	0	0	10	0	0
2	20840596	.	C	T	1	2	3	0	0	3	0	0
2	20840837	.	T	C	2	0	2	0	1	3	0	0
2	20843816	.	A	G	3	3	6	0	0	6	0	0
2	20846698	.	C	T	0	1	1	0	0	1	0	0
2	20848862	.	T	C	2	2	4	0	0	4	0	0
2	20849095	.	T	C	4	1	5	0	0	5	0	0
2	20864246	.	C	T	1	0	1	0	0	1	0	0
2	20868556	.	G	T	2	3	5	0	0	5	0	0
2	20871012	.	G	A	0	0	0	0	1	1	0	0
2	20871630	.	T	A	0	1	1	0	0	1	0	0
2	20873717	.	A	G	0	0	0	0	1	1	0	0
2	20874515	.	T	C	0	1	1	0	0	1	0	0
2	20875064	.	C	T	5	4	9	0	0	9	0	0
2	20875112	.	G	A	0	8	8	0	10	18	0	0
2	20875166	.	C	T	4	3	7	0	1	8	0	0
2	20875860	.	A	G	2	7	9	0	1	10	0	0
2	20875922	.	T	A	1	1	2	0	0	2	0	0
2	20920946	.	C	T	1	1	2	0	0	2	0	0
2	20967782	.	C	G	5	6	11	0	0	11	0	0
2	20967788	.	G	A	5	4	9	0	1	10	0	0
2	20971382	.	C	T	3	2	5	0	0	5	0	0
2	20971423	.	T	C	2	3	5	0	0	5	0	0
2	20972877	.	A	G	2	7	9	0	2	11	0	0
2	20973419	.	G	A	3	4	7	0	0	7	0	0
2	20973794	.	A	T	6	6	12	0	1	13	0	0
2	20973864	.	G	A	0	6	6	0	3	9	0	0
2	20974085	.	G	A	6	3	9	0	0	9	0	0
2	20974837	.	T	G	3	0	3	0	6	9	0	0
2	20975010	.	T	C	3	3	6	0	0	6	0	0
2	20975255	.	G	C	6	6	12	0	0	12	0	0
2	20975283	.	C	T	7	11	18	0	0	18	0	0
2	20975460	.	T	C	5	6	11	0	0	11	0	0
2	20980356	.	T	C	4	6	10	0	0	10	0	0
2	21060085	.	G	T	1	2	3	0	0	3	0	0
2	21071401	.	T	A	2	2	4	0	0	4	0	0
2	21073286	.	T	A	3	0	3	0	0	3	0	0
2	21073350	.	A	C	2	2	4	0	0	4	0	0
2	21076203	.	C	T	7	6	13	0	4	17	0	0
2	21076342	.	T	C	5	2	7	0	0	7	0	0
2	21076499	.	T	G	1	4	5	0	0	5	0	0
2	21076932	.	A	T	2	2	4	0	0	4	0	0
2	21077268	.	G	T	14	7	21	1	0	22	0	0
2	21077299	.	C	T	19	10	29	0	1	30	0	0
2	21082585	.	C	G	2	9	11	0	0	11	0	0
2	21082596	.	C	A	1	4	5	0	1	6	0	0
2	21156350	.	G	A	7	3	10	0	1	11	0	0
2	21177237	.	G	A	2	2	4	0	0	4	0	0
2	21182482	.	G	T	2	8	10	0	0	10	0	0
2	21298986	.	G	C	0	5	5	0	1	6	0	0
2	21299023	.	G	C	2	2	4	0	0	4	0	0
2	21299069	.	G	C	1	2	3	0	0	3	0	0
2	21309811	.	C	T	2	2	4	0	0	4	0	0
2	21312257	.	T	C	2	6	8	0	1	9	0	0
2	21312507	.	C	T	2	2	4	0	0	4	0	0
2	21316009	.	G	A	2	2	4	0	0	4	0	0
2	21338146	.	C	A	3	3	6	0	0	6	0	0
2	21338276	.	T	C	1	2	3	0	0	3	0	0
2	21340915	.	G	A	2	1	3	0	0	3	0	0
2	21343359	.	G	A	4	2	6	0	0	6	0	0
2	21349413	.	C	T	0	1	1	0	0	1	0	0
2	21351972	.	A	G	1	2	3	0	0	3	0	0
2	21356392	.	C	T	6	3	9	0	0	9	0	0
2	21356584	.	T	G	4	4	8	0	1	9	0	0
2	21367952	.	A	G	2	2	4	0	0	4	0	0
2	21367977	.	C	T	4	4	8	0	0	8	0	0
2	21368006	.	T	C	2	5	7	0	0	7	0	0
2	21371159	.	G	A	0	5	5	0	0	5	0	0
2	21376407	.	C	T	3	2	5	0	0	5	0	0
2	21381230	.	C	T	8	5	13	0	0	13	0	0
2	21455240	.	C	T	3	1	4	0	0	4	0	0
2	21456950	.	G	A	1	2	3	0	0	3	0	0
2	21459091	.	G	T	8	4	12	0	0	12	0	0
2	21459100	.	G	A	9	4	13	0	0	13	0	0
2	21459196	.	C	T	12	9	21	0	2	23	0	0
2	21459701	.	C	A	2	5	7	0	0	7	0	0
2	21462185	.	A	G	4	4	8	0	0	8	0	0
2	21462191	.	A	G	3	3	6	0	0	6	0	0
2	21466555	.	T	C	15	10	25	0	0	25	0	0
2	21466567	.	A	T	17	10	27	0	1	28	0	0
2	21468807	.	G	A	17	14	31	0	1	32	0	0
2	21468825	.	G	A	17	14	31	0	3	34	0	0
2	21469405	.	T	C	11	12	23	0	2	25	0	0
2	21469490	.	T	C	15	8	23	0	0	23	0	0
2	21469644	.	A	G	9	9	18	0	1	19	0	0
2	21469830	.	T	A	2	5	7	0	0	7	0	0
2	21487190	.	G	A	6	2	8	0	0	8	0	0
2	21502301	.	G	T	2	3	5	0	0	5	0	0
2	21502540	.	G	C	7	4	11	0	0	11	0	0
2	21605644	.	A	T	3	8	11	0	1	12	0	0
2	21605724	.	T	C	4	3	7	0	0	7	0	0
2	21605857	.	T	C	1	2	3	0	1	4	0	0
2	21605937	.	G	T	2	4	6	0	1	7	0	0
2	21607456	.	G	C	1	6	7	0	1	8	0	0
2	21608427	.	C	G	4	2	6	0	1	7	0	0
2	21608582	.	G	A	14	9	23	0	0	23	0	0
2	21608587	.	C	T	15	9	24	0	0	24	0	0
2	21608710	.	T	A	5	13	18	0	0	18	0	0
2	21608781	.	T	G	6	7	13	0	0	13	0	0
2	21609104	.	A	T	7	6	13	0	1	14	0	0
2	21609443	.	C	A	3	6	9	0	0	9	0	0
2	21609446	.	C	T	3	7	10	0	0	10	0	0
2	21609830	.	T	G	1	2	3	0	0	3	0	0
2	21610233	.	G	A	3	1	4	0	0	4	0	0
2	21613008	.	T	C	1	2	3	0	0	3	0	0
2	21620412	.	A	G	7	4	11	0	1	12	0	0
2	21620469	.	T	C	8	0	8	0	10	18	0	0
2	21620691	.	G	A	4	7	11	0	0	11	0	0
2	21620856	.	C	T	6	6	12	0	2	14	0	0
2	21621151	.	G	A	6	7	13	0	0	13	0	0
2	21621507	.	T	C	8	6	14	0	1	15	0	0
2	21621528	.	A	G	8	4	12	0	0	12	0	0
2	21621606	.	C	T	4	4	8	0	0	8	0	0
2	21621762	.	T	C	5	5	10	0	0	10	0	0
2	21634223	.	A	T	1	2	3	0	0	3	0	0
2	21715476	.	G	A	0	2	2	0	3	5	0	0
2	21765814	.	G	A	3	1	4	0	1	5	0	0
2	21766212	.	A	G	6	5	11	0	1	12	0	0
2	21766237	.	G	A	10	5	15	0	0	15	0	0
2	21766277	.	G	A	7	11	18	0	1	19	0	0
2	21766478	.	T	A	11	9	20	0	1	21	0	0
2	21766554	.	G	A	5	4	9	0	0	9	0	0
2	21766785	.	G	A	6	10	16	0	1	17	0	0
2	21767207	.	C	T	4	9	13	0	1	14	0	0
2	21767244	.	A	T	4	7	11	0	0	11	0	0
2	21767286	.	T	C	8	3	11	0	0	11	0	0
2	21768168	.	G	A	9	3	12	0	0	12	0	0
2	21768821	.	T	A	5	8	13	0	1	14	0	0
2	21771191	.	G	T	5	4	9	0	1	10	0	0
2	21772082	.	G	A	5	3	8	0	0	8	0	0
2	21772099	.	G	A	5	6	11	0	0	11	0	0
2	21774400	.	G	A	2	0	2	0	0	2	0	0
2	21777101	.	C	A	3	3	6	0	0	6	0	0
2	21777102	.	A	G	3	3	6	0	0	6	0	0
2	21780896	.	C	T	1	0	1	0	0	1	0	0
2	21806152	.	C	T	0	5	5	0	5	10	0	0
2	21806185	.	T	C	4	0	4	0	5	9	0	0
2	21806462	.	G	T	1	2	3	0	1	4	0	0
2	21807295	.	C	T	3	3	6	0	0	6	0	0
2	21807396	.	G	A	1	5	6	0	1	7	0	0
2	21822288	.	C	A	19	31	50	0	3	53	0	0
2	21822304	.	A	G	32	12	44	0	4	48	0	0
2	21822816	.	T	A	13	20	33	0	1	34	0	0
2	21827276	.	A	G	24	11	35	0	0	35	0	0
2	21855248	.	C	G	7	9	16	0	0	16	0	0
2	21855253	.	G	A	1	7	8	0	9	18	1	0
2	21861735	.	T	G	2	0	2	0	1	3	0	0
2	21862511	.	C	T	1	2	3	0	0	3	0	0
2	21865620	.	G	C	9	9	18	0	1	19	0	0
2	21877711	.	C	G	6	5	11	0	0	11	0	0
2	21877878	.	G	A	4	5	9	0	0	9	0	0
2	21878036	.	G	C	6	16	22	0	2	24	0	0
2	21878053	.	T	C	18	7	25	0	0	25	0	0
2	21878197	.	T	C	12	16	28	0	1	29	0	0
2	21878415	.	C	T	10	11	21	0	0	21	0	0
2	21878462	.	T	C	11	7	18	0	0	18	0	0
2	21983064	.	T	G	4	0	4	0	6	10	0	0
2	22058071	.	A	G	3	0	3	0	3	6	0	0
2	22058098	.	C	T	8	6	14	0	0	14	0	0
2	22058200	.	C	T	18	4	22	0	4	26	0	0
2	22058254	.	G	A	9	6	15	0	1	16	0	0
2	22058281	.	C	T	3	4	7	0	1	8	0	0
2	22073176	.	C	T	17	6	23	0	2	25	0	0
2	22101657	.	C	T	17	19	36	0	0	36	0	0
2	22101699	.	A	C	6	9	15	0	1	16	0	0
2	22104292	.	C	T	14	19	33	0	0	33	0	0
2	22104415	.	C	A	17	12	29	0	4	33	0	0
2	22104506	.	T	C	9	13	22	0	0	22	0	0
2	22104999	.	A	G	20	17	37	0	0	37	0	0
2	22208560	.	G	A	6	3	9	0	2	11	0	0
2	22208638	.	A	G	10	3	13	0	0	13	0	0
2	22209045	.	C	A	11	15	26	0	0	26	0	0
2	22209722	.	C	T	9	13	22	0	1	23	0	0
2	22210412	.	G	A	9	10	19	0	0	19	0	0
2	22286813	.	T	A	5	5	10	0	0	10	0	0
2	22353568	.	T	C	21	13	34	0	1	35	0	0
2	22353661	.	T	A	14	13	27	0	2	29	0	0
2	22362290	.	G	A	22	14	36	0	2	38	0	0
2	22362302	.	G	A	21	16	37	0	0	37	0	0
2	22363365	.	T	C	2	2	4	0	0	4	0	0
2	22363418	.	T	A	3	3	6	0	0	6	0	0
2	22364079	.	T	C	1	5	6	0	0	6	0	0
2	22364095	.	A	C	1	4	5	0	0	5	0	0
2	22390361	.	G	A	3	1	4	0	0	4	0	0
2	22480321	.	G	T	8	4	12	0	2	14	0	0
2	22480759	.	G	A	16	18	34	0	2	36	0	0
2	22483222	.	G	A	3	7	10	0	3	13	0	0
2	22483351	.	A	G	4	8	12	0	1	13	0	0
2	22483381	.	A	G	5	5	10	0	1	11	0	0
2	22483423	.	C	T	10	3	13	0	0	13	0	0
2	22483444	.	A	G	7	3	10	0	0	10	0	0
2	22513202	.	A	G	1	1	2	0	0	2	0	0
2	22516758	.	A	G	1	0	1	0	0	1	0	0
2	22521337	.	G	A	5	3	8	0	1	9	0	0
2	22521582	.	A	T	1	2	3	0	0	3	0	0
2	22522073	.	A	G	4	2	6	0	0	6	0	0
2	22522211	.	G	T	6	3	9	0	0	9	0	0
2	22522405	.	G	A	2	3	5	0	0	5	0	0
2	22522448	.	A	G	3	4	7	0	0	7	0	0
2	22522719	.	A	G	1	3	4	0	0	4	0	0
2	22522778	.	T	A	1	4	5	0	0	5	0	0
2	22523573	.	G	A	1	3	4	0	0	4	0	0
2	22599787	.	C	T	4	4	8	0	1	9	0	0
2	22602653	.	A	G	3	3	6	0	0	6	0	0
2	22602808	.	C	T	5	9	14	0	2	16	0	0
2	22602826	.	C	T	10	6	16	0	0	16	0	0
2	22607462	.	G	A	0	1	1	0	2	3	0	0
2	22608314	.	G	T	7	4	11	0	0	11	0	0
2	22614357	.	T	A	2	3	5	0	1	6	0	0
2	22614448	.	T	A	4	5	9	0	0	9	0	0
2	22614529	.	C	T	6	10	16	0	0	16	0	0
2	22614959	.	A	T	11	9	20	0	1	21	0	0
2	22617836	.	A	G	5	5	10	0	3	13	0	0
2	22617848	.	A	G	7	7	14	0	1	15	0	0
2	22617932	.	G	A	14	20	34	0	2	36	0	0
2	22626878	.	T	A	14	5	19	0	1	20	0	0
2	22627149	.	G	A	11	7	18	0	1	19	0	0
2	22629684	.	C	T	0	11	11	0	7	18	0	0
2	22633869	.	G	A	5	2	7	0	0	7	0	0
2	22634070	.	A	G	6	3	9	0	1	10	0	0
2	22653693	.	T	A	9	8	17	0	0	17	0	0
2	22656651	.	G	A	5	3	8	0	0	8	0	0
2	22656708	.	T	C	4	1	5	0	0	5	0	0
2	22656723	.	C	T	0	1	1	0	0	1	0	0
2	22656870	.	A	G	7	6	13	0	0	13	0	0
2	22659072	.	G	A	7	1	8	0	0	8	0	0
2	22702423	.	T	C	0	7	7	0	1	8	0	0
2	22707536	.	A	C	8	7	15	0	0	15	0	0
2	22710985	.	T	C	0	1	1	0	0	1	0	0
2	22711898	.	T	G	0	1	1	0	0	1	0	0
2	22714603	.	A	G	10	15	25	0	0	25	0	0
2	22714618	.	G	A	8	10	18	0	4	22	0	0
2	22716770	.	T	C	11	11	22	0	0	22	0	0
2	22718895	.	T	A	17	13	30	0	1	31	0	0
2	22719145	.	A	G	19	0	19	0	21	40	0	0
2	22724661	.	T	C	7	7	14	0	0	14	0	0
2	22731426	.	C	T	4	10	14	0	0	14	0	0
2	22731456	.	G	A	3	4	7	0	0	7	0	0
2	22733494	.	A	T	7	4	11	0	0	11	0	0
2	22733813	.	A	G	11	11	22	0	0	22	0	0
2	22735037	.	T	A	2	2	4	0	0	5	1	0
2	22735205	.	A	T	16	14	30	0	0	30	0	0
2	22735232	.	C	T	11	5	16	0	1	17	0	0
2	22742179	.	C	T	6	8	14	0	1	15	0	0
2	22745690	.	C	T	8	10	18	0	0	18	0	0
2	22747304	.	C	T	8	7	15	0	0	15	0	0
2	22750164	.	C	T	0	1	1	0	0	1	0	0
2	22750621	.	C	T	4	3	7	0	0	7	0	0
2	22750622	.	A	G	4	2	6	0	1	7	0	0
2	22756528	.	C	T	12	17	29	0	1	30	0	0
2	22795615	.	A	G	20	20	40	0	0	40	0	0
2	22801748	.	T	C	27	29	56	0	1	57	0	0
2	22801899	.	A	T	20	16	36	0	2	38	0	0
2	22802030	.	G	A	0	20	20	0	17	37	0	0
2	22802117	.	A	T	19	17	36	0	5	41	0	0
2	22802402	.	T	C	23	21	44	0	2	46	0	0
2	22802504	.	G	A	14	16	30	0	0	30	0	0
2	22802524	.	T	A	16	15	31	0	0	31	0	0
2	22803110	.	T	A	28	22	50	0	1	51	0	0
2	22803128	.	G	T	24	24	48	0	1	49	0	0
2	22803190	.	C	T	21	20	41	0	3	44	0	0
2	22857653	.	G	A	1	2	3	0	0	3	0	0
2	22857691	.	T	C	1	2	3	0	0	3	0	0
2	22860541	.	C	T	2	3	5	0	0	5	0	0
2	22933381	.	C	T	3	2	5	0	0	5	0	0
2	22933539	.	G	A	2	2	4	0	0	4	0	0
2	22933554	.	G	A	1	2	3	0	1	4	0	0
2	22935753	.	A	G	0	1	1	0	0	1	0	0
2	22944154	.	C	T	1	1	2	0	0	2	0	0
2	22944464	.	G	A	1	2	3	0	0	3	0	0
2	22970413	.	G	A	7	3	10	0	1	11	0	0
2	22970683	.	C	G	3	2	5	0	1	6	0	0
2	22970707	.	G	A	3	3	6	0	0	6	0	0
2	22971012	.	T	A	11	7	18	0	1	19	0	0
2	22979805	.	G	A	2	6	8	0	0	8	0	0
2	22980020	.	G	C	9	0	9	0	4	13	0	0
2	22994327	.	G	A	2	4	6	0	0	6	0	0
2	22996520	.	A	T	0	3	3	0	0	3	0	0
2	23001533	.	G	A	8	17	25	0	1	26	0	0
2	23001638	.	G	T	19	7	26	0	1	27	0	0
2	23020948	.	C	T	2	2	4	0	0	4	0	0
2	23023465	.	G	A	5	4	9	0	0	9	0	0
2	23023466	.	C	G	4	5	9	0	0	9	0	0
2	23023801	.	C	T	3	2	5	0	0	5	0	0
2	23023890	.	G	T	4	6	10	0	0	10	0	0
2	23024069	.	C	A	2	4	6	0	0	6	0	0
2	23024697	.	T	A	3	4	7	0	1	8	0	0
2	23024704	.	A	C	4	3	7	0	0	7	0	0
2	23024735	.	G	T	2	2	4	0	0	4	0	0
2	23066671	.	C	T	2	3	5	0	0	5	0	0
2	23078082	.	A	G	5	9	14	0	1	15	0	0
2	23081413	.	C	A	2	2	4	0	0	4	0	0
2	23082912	.	C	T	1	2	3	0	0	3	0	0
2	23085185	.	C	T	4	4	8	0	0	8	0	0
2	23090867	.	C	T	1	3	4	0	0	4	0	0
2	23094876	.	C	T	1	4	5	0	0	5	0	0
2	23094912	.	C	T	1	3	4	0	0	4	0	0
2	23098416	.	G	A	1	3	4	0	0	4	0	0
2	23098563	.	G	A	2	2	4	0	0	4	0	0
2	23098565	.	A	G	2	2	4	0	0	4	0	0
2	23098614	.	A	C	1	3	4	0	0	4	0	0
2	23099038	.	T	A	1	2	3	0	0	3	0	0
2	23099090	.	G	T	4	2	6	0	0	6	0	0
2	23099141	.	G	A	1	3	4	0	0	4	0	0
2	23099307	.	T	C	0	4	4	0	0	4	0	0
2	23099369	.	G	C	2	2	4	0	1	5	0	0
2	23223037	.	C	T	8	6	14	0	0	14	0	0
2	23226584	.	C	T	3	7	10	0	0	10	0	0
2	23232884	.	T	C	6	7	13	0	0	13	0	0
2	23238502	.	C	T	1	1	2	0	0	2	0	0
2	23263294	.	T	A	3	4	7	0	0	7	0	0
2	23292123	.	A	T	1	2	3	0	0	3	0	0
2	23292262	.	G	A	6	7	13	0	0	13	0	0
2	23292429	.	A	T	4	7	11	0	2	13	0	0
2	23292516	.	G	A	1	4	5	0	14	19	0	0
2	23292549	.	C	A	8	5	13	0	0	13	0	0
2	23292690	.	T	A	8	10	18	0	1	19	0	0
2	23292776	.	G	A	3	4	7	0	0	7	0	0
2	23293123	.	G	C	10	3	13	0	1	14	0	0
2	23293230	.	A	T	10	6	16	1	0	17	0	0
2	23361020	.	T	G	14	11	25	0	2	27	0	0
2	23361605	.	C	T	17	10	27	0	0	27	0	0
2	23361784	.	A	T	3	6	9	0	1	10	0	0
2	23379532	.	G	A	6	9	15	0	0	15	0	0
2	23379588	.	C	T	10	5	15	0	2	17	0	0
2	23379757	.	T	A	1	5	6	0	0	6	0	0
2	23379861	.	G	A	6	3	9	0	0	9	0	0
2	23380621	.	C	A	4	2	6	0	0	6	0	0
2	23381056	.	A	G	1	0	1	0	0	1	0	0
2	23387139	.	C	T	1	3	4	0	0	4	0	0
2	23390670	.	T	C	1	0	1	0	3	4	0	0
2	23613432	.	C	T	0	1	1	0	0	1	0	0
2	23701743	.	T	A	3	3	6	0	0	6	0	0
2	23707161	.	G	T	2	0	2	0	0	2	0	0
2	23707444	.	T	A	0	1	1	0	0	1	0	0
2	23714743	.	A	T	1	2	3	0	0	3	0	0
2	23716575	.	T	C	2	3	5	0	0	5	0	0
2	23716617	.	C	T	2	3	5	0	0	5	0	0
2	23722518	.	A	G	2	0	2	0	4	6	0	0
2	23722609	.	T	A	0	1	1	0	1	2	0	0
2	23722610	.	T	A	1	1	2	0	0	2	0	0
2	23722849	.	T	C	6	3	9	0	0	9	0	0
2	23723256	.	C	T	3	5	8	0	0	8	0	0
2	23723521	.	A	T	2	4	6	0	0	6	0	0
2	23723571	.	G	A	2	2	4	0	1	5	0	0
2	23723638	.	A	T	3	4	7	0	0	7	0	0
2	23724469	.	G	A	0	4	4	0	7	11	0	0
2	23724535	.	T	G	4	5	9	0	0	9	0	0
2	23725075	.	G	A	7	3	10	0	1	11	0	0
2	23725159	.	T	C	2	13	15	0	0	15	0	0
2	23725239	.	C	T	3	6	9	0	0	9	0	0
2	23725608	.	A	T	7	3	10	0	0	10	0	0
2	23726043	.	A	G	9	5	14	0	0	14	0	0
2	23726206	.	T	A	5	8	13	0	0	13	0	0
2	23726312	.	G	A	14	8	22	0	1	23	0	0
2	23803100	.	C	T	1	2	3	0	0	3	0	0
2	23803419	.	G	C	3	3	6	0	0	6	0	0
2	23811573	.	T	C	1	0	1	0	0	1	0	0
2	23813951	.	C	T	1	2	3	0	0	3	0	0
2	23816293	.	A	C	5	4	9	0	1	10	0	0
2	23818207	.	C	A	2	3	5	0	0	5	0	0
2	23818209	.	A	T	2	3	5	0	0	5	0	0
2	23818271	.	G	A	0	6	6	0	0	6	0	0
2	23818765	.	A	G	5	2	7	0	0	7	0	0
2	23818835	.	T	C	1	3	4	0	0	4	0	0
2	23819237	.	T	G	1	2	3	1	0	4	0	0
2	23819241	.	G	C	0	1	1	1	1	3	0	0
2	23819471	.	T	G	2	0	2	0	3	5	0	0
2	23819862	.	A	C	2	2	4	0	0	4	0	0
2	23819946	.	T	G	1	0	1	0	2	3	0	0
2	23823684	.	A	T	1	7	8	0	2	10	0	0
2	23823719	.	A	G	1	6	7	0	1	8	0	0
2	23937227	.	G	A	6	4	10	0	0	10	0	0
2	23937231	.	C	G	6	3	9	0	0	9	0	0
2	23937549	.	T	G	2	4	6	0	0	6	0	0
2	23943510	.	G	A	1	0	1	0	0	1	0	0
2	23946416	.	G	T	2	1	3	0	0	3	0	0
2	23969593	.	C	T	0	1	1	0	0	1	0	0
2	24188637	.	G	A	5	7	12	0	0	12	0	0
2	24199338	.	C	A	19	19	38	0	2	40	0	0
2	24202528	.	T	C	5	6	11	0	0	11	0	0
2	24218922	.	A	T	19	23	42	0	1	43	0	0
2	24218927	.	G	A	0	20	20	0	26	46	0	0
2	24222069	.	A	C	7	13	20	0	2	22	0	0
2	24223991	.	A	G	13	29	42	0	7	49	0	0
2	24248498	.	C	T	21	28	49	0	2	51	0	0
2	24249037	.	T	A	27	18	45	0	3	48	0	0
2	24249083	.	T	A	12	12	24	0	0	24	0	0
2	24249397	.	G	T	1	22	23	0	20	43	0	0
2	24249943	.	T	A	17	6	23	1	0	24	0	0
2	24249947	.	T	A	17	5	22	1	0	23	0	0
2	24250059	.	T	G	12	3	15	0	0	15	0	0
2	24250062	.	G	T	12	4	16	0	0	16	0	0
2	24250097	.	T	C	9	11	20	0	1	21	0	0
2	24250112	.	T	A	17	7	24	0	0	24	0	0
2	24250147	.	G	A	1	15	16	0	6	22	0	0
2	24250209	.	A	C	4	3	7	0	0	7	0	0
2	24250212	.	G	C	3	4	7	0	0	7	0	0
2	24250303	.	C	T	23	11	34	0	0	34	0	0
2	24250419	.	C	T	7	6	13	0	0	18	5	0
2	24250482	.	C	T	19	16	35	0	4	39	0	0
2	24250577	.	A	T	32	18	50	0	1	51	0	0
2	24250637	.	A	G	16	25	41	0	1	42	0	0
2	24250879	.	T	G	22	25	47	0	2	49	0	0
2	24250972	.	C	A	24	24	48	0	0	48	0	0
2	24251294	.	G	A	0	31	31	0	23	54	0	0
2	24251430	.	A	G	29	27	56	0	3	59	0	0
2	24251690	.	G	A	25	26	51	0	2	53	0	0
2	24251800	.	G	A	28	33	61	0	3	64	0	0
2	24251909	.	A	T	38	28	66	0	2	68	0	0
2	24252078	.	A	T	44	20	64	0	3	67	0	0
2	24252088	.	C	T	46	19	65	0	0	65	0	0
2	24252192	.	T	A	21	29	50	0	1	51	0	0
2	24252196	.	G	T	1	28	29	0	20	49	0	0
2	24310739	.	G	T	4	5	9	0	0	9	0	0
2	24310850	.	G	C	12	15	27	0	1	29	1	0
2	24310897	.	G	A	16	21	37	0	0	37	0	0
2	24311045	.	T	C	16	1	17	0	12	29	0	0
2	24311218	.	T	A	9	10	19	0	0	19	0	0
2	24311296	.	G	C	10	13	23	0	1	24	0	0
2	24311703	.	A	G	5	8	13	0	3	16	0	0
2	24311879	.	A	G	3	7	10	0	0	10	0	0
2	24313884	.	T	C	6	6	12	0	0	12	0	0
2	24313896	.	G	A	6	4	10	0	0	10	0	0
2	24314221	.	T	C	3	4	7	0	0	7	0	0
2	24316503	.	C	T	0	4	4	0	3	7	0	0
2	24317537	.	G	A	9	12	21	0	0	21	0	0
2	24319740	.	A	G	14	16	30	0	1	31	0	0
2	24319945	.	T	G	3	4	7	0	0	7	0	0
2	24320173	.	C	T	11	10	21	0	0	21	0	0
2	24321853	.	T	C	8	4	12	0	5	18	1	0
2	24322189	.	G	C	11	21	32	0	0	32	0	0
2	24326455	.	A	G	3	7	10	0	0	10	0	0
2	24326509	.	G	A	2	4	6	0	0	6	0	0
2	24331392	.	T	A	6	7	13	0	1	14	0	0
2	24335246	.	G	A	4	4	8	0	0	8	0	0
2	24382093	.	A	G	4	6	10	0	2	12	0	0
2	24385210	.	C	T	2	4	6	0	1	7	0	0
2	24385271	.	T	G	4	5	9	0	0	9	0	0
2	24385603	.	G	A	1	5	6	0	7	13	0	0
2	24385633	.	C	T	7	5	12	0	0	12	0	0
2	24385685	.	T	C	6	5	11	0	0	11	0	0
2	24385724	.	G	A	2	3	5	0	0	6	1	0
2	24385837	.	A	G	2	0	2	0	5	7	0	0
2	24385872	.	T	A	5	2	7	0	0	7	0	0
2	24385875	.	T	A	4	2	6	0	1	7	0	0
2	24410544	.	T	C	7	1	8	0	5	13	0	0
2	24410851	.	C	T	14	16	30	0	1	31	0	0
2	24410882	.	G	A	13	20	33	0	0	33	0	0
2	24411114	.	G	C	14	13	27	0	1	28	0	0
2	24411625	.	T	C	11	10	21	0	1	22	0	0
2	24411812	.	A	T	12	8	20	0	3	23	0	0
2	24411840	.	T	C	13	6	19	0	1	20	0	0
2	24412856	.	A	G	9	3	12	0	0	12	0	0
2	24412908	.	C	A	7	3	10	0	0	10	0	0
2	24412947	.	A	T	4	6	10	0	0	10	0	0
2	24413155	.	C	T	11	11	22	0	1	23	0	0
2	24414032	.	G	C	10	6	16	0	0	16	0	0
2	24414062	.	G	A	9	12	21	0	0	21	0	0
2	24421813	.	T	C	1	0	1	0	1	2	0	0
2	24421816	.	G	A	1	1	2	0	0	2	0	0
2	24432634	.	G	T	7	10	17	0	1	18	0	0
2	24432661	.	C	T	12	9	21	0	0	21	0	0
2	24444650	.	C	T	5	4	9	0	0	9	0	0
2	24536874	.	C	T	1	2	3	0	1	4	0	0
2	24536918	.	A	C	1	2	3	0	0	3	0	0
2	24541478	.	G	A	0	2	2	0	2	4	0	0
2	24549532	.	G	A	1	3	4	0	0	4	0	0
2	24549586	.	A	T	4	5	9	0	1	10	0	0
2	24558512	.	A	T	6	1	7	0	0	7	0	0
2	24558545	.	A	G	1	1	2	0	0	2	0	0
2	24558790	.	C	G	2	3	5	0	1	6	0	0
2	24559652	.	T	A	3	2	5	0	0	5	0	0
2	24560323	.	T	A	1	2	3	0	0	3	0	0
2	24560359	.	G	A	3	6	9	0	0	9	0	0
2	24560455	.	T	C	1	6	7	0	1	8	0	0
2	24560881	.	C	T	5	2	7	0	0	7	0	0
2	24565123	.	A	G	2	5	7	0	0	7	0	0
2	24578284	.	C	T	0	1	1	0	1	2	0	0
2	24578308	.	C	T	0	1	1	0	0	1	0	0
2	24594632	.	A	T	2	1	3	0	1	4	0	0
2	24650758	.	C	T	5	2	7	0	0	7	0	0
2	24650815	.	T	C	4	4	8	0	0	8	0	0
2	24650878	.	A	T	1	0	1	0	0	1	0	0
2	24664583	.	G	A	1	0	1	0	0	1	0	0
2	24666629	.	C	T	0	3	3	0	0	3	0	0
2	24666656	.	T	G	1	2	3	0	0	3	0	0
2	24677139	.	A	G	4	3	7	0	0	7	0	0
2	24683093	.	A	G	12	6	18	0	10	28	0	0
2	24683311	.	G	A	12	19	31	0	1	32	0	0
2	24701102	.	A	G	3	7	10	0	0	10	0	0
2	24737749	.	C	T	3	4	7	0	1	8	0	0
2	24737776	.	C	T	3	4	7	0	0	7	0	0
2	24740439	.	C	T	4	4	8	0	1	9	0	0
2	24740468	.	T	A	2	3	5	0	1	6	0	0
2	24743787	.	G	A	0	3	3	0	1	4	0	0
2	24743855	.	G	A	2	4	6	0	0	6	0	0
2	24748308	.	G	T	0	3	3	0	2	5	0	0
2	24748810	.	A	G	2	3	5	0	0	5	0	0
2	24748828	.	A	G	2	3	5	0	1	6	0	0
2	24749403	.	G	A	2	3	5	0	1	6	0	0
2	24749438	.	A	G	9	3	12	0	0	12	0	0
2	24749467	.	G	A	5	8	13	0	1	14	0	0
2	24749582	.	T	C	8	9	17	0	0	17	0	0
2	24750869	.	C	T	2	2	4	0	0	4	0	0
2	24750918	.	A	T	2	3	5	0	0	5	0	0
2	24751401	.	G	A	2	7	9	0	0	9	0	0
2	24751526	.	G	A	1	3	4	0	0	4	0	0
2	24751948	.	C	T	5	8	13	0	0	13	0	0
2	24751991	.	A	G	5	7	12	0	0	12	0	0
2	24752048	.	C	T	3	7	10	0	0	10	0	0
2	24752181	.	T	A	7	6	13	0	0	13	0	0
2	24752193	.	C	T	6	8	14	0	0	14	0	0
2	24752247	.	A	G	8	3	11	0	0	11	0	0
2	24752293	.	C	T	5	11	16	0	1	17	0	0
2	24752385	.	C	T	5	14	19	0	0	19	0	0
2	24753062	.	T	C	7	3	10	0	1	11	0	0
2	24753917	.	C	T	6	3	9	0	0	9	0	0
2	24754465	.	A	G	4	5	9	0	0	9	0	0
2	24754783	.	C	T	18	15	33	0	1	34	0	0
2	24754796	.	A	C	17	19	36	0	2	38	0	0
2	24755018	.	T	C	17	6	23	0	0	23	0	0
2	24766941	.	G	A	6	3	9	0	0	9	0	0
2	24767291	.	C	T	3	1	4	0	0	4	0	0
2	24770649	.	G	T	5	2	7	0	0	7	0	0
2	24770755	.	G	C	1	3	4	0	0	4	0	0
2	24773726	.	G	A	0	1	1	0	1	2	0	0
2	24774344	.	C	T	0	1	1	0	0	1	0	0
2	24863918	.	T	G	2	2	4	0	0	4	0	0
2	24864536	.	A	T	3	5	8	0	0	8	0	0
2	24864570	.	A	T	2	4	6	0	0	6	0	0
2	24865187	.	C	A	4	2	6	0	0	6	0	0
2	24865360	.	T	C	7	8	15	0	2	17	0	0
2	24866568	.	C	T	5	3	8	0	0	8	0	0
2	24876864	.	T	A	5	10	15	0	0	15	0	0
2	24877010	.	A	G	10	18	28	0	4	32	0	0
2	24877227	.	C	T	11	7	18	0	0	18	0	0
2	24877534	.	G	A	8	0	8	0	0	8	0	0
2	24877879	.	T	C	2	7	9	0	0	9	0	0
2	24877900	.	T	A	5	7	12	0	1	13	0	0
2	24878211	.	C	T	12	10	22	0	1	23	0	0
2	24878332	.	A	G	5	9	14	0	0	14	0	0
2	24943482	.	G	T	7	6	13	0	0	13	0	0
2	24943660	.	T	C	3	4	7	0	0	7	0	0
2	24943689	.	C	T	4	11	15	0	0	15	0	0
2	24943717	.	C	T	16	4	20	0	0	20	0	0
2	24943891	.	A	T	10	11	21	0	1	22	0	0
2	24943916	.	T	C	10	10	20	0	0	20	0	0
2	24943971	.	A	T	7	6	13	0	3	16	0	0
2	24944415	.	C	T	10	11	21	0	0	21	0	0
2	24944644	.	A	G	5	5	10	0	0	10	0	0
2	24957158	.	A	T	1	1	2	0	0	2	0	0
2	24958705	.	A	G	1	0	1	0	0	1	0	0
2	24958712	.	T	G	1	0	1	0	0	1	0	0
2	24964335	.	A	G	4	4	8	0	0	8	0	0
2	24964416	.	C	A	3	2	5	0	0	5	0	0
2	24964424	.	C	T	3	2	5	0	0	5	0	0
2	24970042	.	C	T	0	3	3	0	3	6	0	0
2	24970127	.	T	A	5	3	8	0	1	9	0	0
2	24991149	.	G	A	8	15	23	0	1	24	0	0
2	24991153	.	T	C	10	15	25	0	1	26	0	0
2	24991476	.	G	A	19	11	30	0	0	30	0	0
2	24991639	.	G	A	17	8	25	0	0	25	0	0
2	24991825	.	G	A	16	14	30	0	0	30	0	0
2	24992185	.	T	C	13	9	22	0	0	22	0	0
2	24992242	.	C	T	0	8	8	0	18	26	0	0
2	24992368	.	T	C	13	14	27	0	0	27	0	0
2	24992464	.	C	T	13	12	25	0	2	27	0	0
2	24992536	.	C	G	10	12	22	0	1	23	0	0
2	24996241	.	C	T	1	4	5	0	2	7	0	0
2	24996402	.	G	C	11	8	19	0	1	20	0	0
2	25074873	.	C	T	0	1	1	0	0	1	0	0
2	25081243	.	T	C	0	1	1	0	0	1	0	0
2	25102571	.	C	T	7	4	11	0	1	12	0	0
2	25105482	.	G	A	2	2	4	0	0	4	0	0
2	25105681	.	G	T	4	5	9	0	0	9	0	0
2	25105683	.	C	T	4	5	9	0	0	9	0	0
2	25106020	.	T	C	8	6	14	0	0	14	0	0
2	25106310	.	A	T	3	3	6	0	0	6	0	0
2	25106380	.	A	G	3	7	10	0	1	11	0	0
2	25106402	.	C	A	6	8	14	0	1	15	0	0
2	25106795	.	G	A	9	3	12	0	0	12	0	0
2	25106952	.	C	T	4	2	6	0	0	6	0	0
2	25107673	.	T	G	8	3	11	0	0	11	0	0
2	25107717	.	C	G	11	7	18	0	0	18	0	0
2	25107891	.	G	T	5	11	16	0	1	17	0	0
2	25107942	.	C	A	10	6	16	0	0	16	0	0
2	25108104	.	A	G	5	4	9	0	1	10	0	0
2	25108377	.	T	A	8	13	21	0	0	21	0	0
2	25108597	.	T	A	1	2	3	0	0	3	0	0
2	25108633	.	C	T	0	5	5	0	0	5	0	0
2	25113448	.	A	G	0	0	0	0	1	1	0	0
2	25124683	.	A	C	3	2	5	0	0	5	0	0
2	25124845	.	C	T	0	2	2	0	1	3	0	0
2	25124875	.	G	A	0	2	2	0	1	3	0	0
2	25125073	.	G	A	4	3	7	0	0	7	0	0
2	25125175	.	G	A	0	4	4	0	2	6	0	0
2	25125318	.	C	T	4	2	6	0	0	6	0	0
2	25126591	.	A	G	2	4	6	0	0	6	0	0
2	25127042	.	G	T	5	3	8	0	0	8	0	0
2	25127132	.	C	A	6	9	15	0	0	15	0	0
2	25127219	.	T	C	3	4	7	0	0	7	0	0
2	25127261	.	G	T	0	5	5	0	3	8	0	0
2	25128328	.	G	A	1	2	3	0	0	3	0	0
2	25128581	.	T	C	8	3	11	0	0	11	0	0
2	25128595	.	A	T	7	3	10	0	0	10	0	0
2	25128668	.	C	T	2	4	6	0	0	6	0	0
2	25247457	.	A	G	3	0	3	0	3	6	0	0
2	25247755	.	T	A	1	2	3	0	1	4	0	0
2	25247769	.	A	C	2	1	3	0	0	3	0	0
2	25281138	.	G	A	1	1	2	0	0	2	0	0
2	25289919	.	G	T	3	3	6	0	0	6	0	0
2	25289933	.	G	A	0	3	3	0	4	7	0	0
2	25509230	.	G	A	2	0	2	0	0	2	0	0
2	25540691	.	T	A	1	5	6	0	0	6	0	0
2	25631627	.	G	T	4	2	6	0	0	6	0	0
2	25658376	.	G	T	4	4	8	0	0	8	0	0
2	25759446	.	C	A	2	1	3	0	0	3	0	0
2	25772113	.	G	A	8	2	10	0	1	11	0	0
2	25781601	.	G	A	0	1	1	0	0	1	0	0
2	25781640	.	C	T	2	4	6	0	0	6	0	0
2	25787292	.	C	T	0	4	4	0	0	4	0	0
2	25794226	.	A	G	5	1	6	0	0	6	0	0
2	25794241	.	C	A	7	1	8	0	0	8	0	0
2	25797439	.	C	T	7	2	9	0	1	10	0	0
2	25797472	.	C	T	5	4	9	0	0	9	0	0
2	25798611	.	A	G	1	0	1	0	0	1	0	0
2	25798647	.	A	G	4	4	8	0	1	9	0	0
2	25809736	.	C	T	2	0	2	0	0	2	0	0
2	25814694	.	C	T	5	7	12	0	0	12	0	0
2	25815329	.	G	C	6	6	12	0	1	13	0	0
2	25815452	.	G	A	5	12	17	0	1	18	0	0
2	25815737	.	G	T	3	4	7	0	1	8	0	0
2	25816321	.	C	T	5	6	11	0	1	12	0	0
2	25816382	.	C	T	2	3	5	0	0	5	0	0
2	25816383	.	T	C	3	2	5	0	0	5	0	0
2	25843922	.	G	A	2	15	17	0	9	26	0	0
2	25844840	.	C	T	15	13	28	0	0	28	0	0
2	25844986	.	T	A	5	11	16	0	1	17	0	0
2	25947585	.	T	C	3	4	7	0	0	7	0	0
2	25947651	.	C	T	3	5	8	0	1	9	0	0
2	25947678	.	T	C	2	5	7	0	0	7	0	0
2	25947699	.	T	C	2	6	8	0	1	9	0	0
2	25952800	.	C	T	3	1	4	0	0	4	0	0
2	25952845	.	C	T	6	4	10	0	1	11	0	0
2	25952983	.	C	T	6	6	12	0	1	13	0	0
2	25984970	.	C	T	8	9	17	0	0	17	0	0
2	25985159	.	G	A	0	8	8	0	8	16	0	0
2	25985234	.	G	A	6	6	12	0	0	12	0	0
2	25985405	.	C	T	4	7	11	0	1	12	0	0
2	25985409	.	C	T	6	5	11	0	1	12	0	0
2	25988269	.	A	G	16	10	26	0	1	28	1	0
2	25988378	.	C	A	6	15	21	0	0	21	0	0
2	25988414	.	G	A	0	6	6	0	9	15	0	0
2	25988475	.	C	T	4	8	12	0	0	12	0	0
2	25988551	.	A	T	16	4	20	0	0	20	0	0
2	25988846	.	A	G	14	0	14	0	11	25	0	0
2	25989059	.	G	A	0	9	9	0	4	13	0	0
2	25989610	.	C	T	9	13	22	0	0	22	0	0
2	25989827	.	C	T	2	11	13	0	0	14	1	0
2	25989884	.	T	A	3	7	10	0	0	10	0	0
2	25989905	.	C	A	4	6	10	0	0	10	0	0
2	25989994	.	A	G	15	15	30	0	0	30	0	0
2	25990323	.	G	A	11	10	21	0	2	23	0	0
2	25990337	.	A	G	16	10	26	0	0	26	0	0
2	25990522	.	A	C	5	5	10	0	1	11	0	0
2	25990563	.	A	G	3	8	11	0	1	12	0	0
2	25990702	.	G	A	20	11	31	0	1	32	0	0
2	25990777	.	T	G	4	2	6	0	2	8	0	0
2	25997881	.	C	G	1	4	5	0	0	5	0	0
2	26155992	.	C	T	1	2	3	0	0	3	0	0
2	26179183	.	G	A	4	4	8	0	0	8	0	0
2	26179223	.	C	T	1	5	6	0	0	6	0	0
2	26196805	.	C	T	0	0	0	0	1	1	0	0
2	26197159	.	G	C	3	4	7	0	0	7	0	0
2	26207944	.	T	C	11	4	15	0	2	17	0	0
2	26208369	.	A	G	8	3	11	0	1	12	0	0
2	26208416	.	G	A	8	6	14	0	1	15	0	0
2	26208425	.	G	A	8	6	14	0	1	15	0	0
2	26208480	.	A	C	4	7	11	0	1	12	0	0
2	26208520	.	A	G	9	7	16	0	1	17	0	0
2	26208589	.	A	G	9	6	15	0	0	15	0	0
2	26208621	.	T	C	9	7	16	0	0	16	0	0
2	26208668	.	T	G	14	0	14	0	12	26	0	0
2	26208815	.	G	T	15	4	19	0	0	19	0	0
2	26208832	.	C	G	11	0	11	0	10	21	0	0
2	26208904	.	T	C	9	12	21	0	0	21	0	0
2	26208987	.	G	A	1	13	14	0	13	27	0	0
2	26209030	.	G	A	11	11	22	0	0	22	0	0
2	26209058	.	C	T	5	8	13	0	1	14	0	0
2	26209266	.	A	C	4	2	6	0	1	7	0	0
2	26240771	.	A	T	14	27	41	0	1	42	0	0
2	26240930	.	A	T	11	11	22	0	1	23	0	0
2	26282688	.	C	T	27	20	47	0	1	48	0	0
2	26283723	.	A	G	4	7	11	0	2	13	0	0
2	26298558	.	A	C	1	3	4	0	0	4	0	0
2	26299673	.	A	T	1	3	4	0	0	4	0	0
2	26300085	.	A	G	3	2	5	0	0	5	0	0
2	26300091	.	G	A	0	2	2	0	2	4	0	0
2	26300341	.	A	G	1	3	4	0	0	4	0	0
2	26303684	.	T	A	3	4	7	0	0	7	0	0
2	26303719	.	T	A	2	1	3	0	2	5	0	0
2	26303831	.	C	T	8	5	13	0	0	13	0	0
2	26303845	.	A	C	4	8	12	0	1	13	0	0
2	26303905	.	C	A	3	7	10	0	0	10	0	0
2	26304008	.	C	A	6	10	16	0	0	16	0	0
2	26304066	.	T	C	9	5	14	0	2	16	0	0
2	26443146	.	G	T	16	15	31	0	1	32	0	0
2	26443517	.	T	C	3	5	8	0	0	8	0	0
2	26443859	.	A	G	5	10	15	0	0	15	0	0
2	26463199	.	C	A	3	3	6	0	0	6	0	0
2	26463309	.	C	T	4	5	9	0	0	9	0	0
2	26463534	.	C	A	2	5	7	0	0	7	0	0
2	26463598	.	T	C	5	1	6	0	3	9	0	0
2	26467131	.	T	G	9	5	14	0	0	14	0	0
2	26467150	.	G	A	4	3	7	0	0	7	0	0
2	26468683	.	A	G	3	2	5	0	0	5	0	0
2	26470087	.	A	G	0	3	3	0	0	3	0	0
2	26470208	.	G	A	14	25	39	0	1	40	0	0
2	26470237	.	G	T	10	17	27	0	1	28	0	0
2	26470267	.	G	A	12	9	21	0	1	22	0	0
2	26470537	.	C	T	9	9	18	0	0	18	0	0
2	26470636	.	C	T	1	22	23	0	17	40	0	0
2	26470666	.	A	G	23	18	41	0	0	41	0	0
2	26473106	.	T	C	7	4	11	0	0	11	0	0
2	26473361	.	C	T	11	6	17	0	0	17	0	0
2	26475272	.	G	A	5	8	13	0	0	13	0	0
2	26476109	.	G	A	1	2	3	0	0	3	0	0
2	26481029	.	C	T	3	4	7	0	0	7	0	0
2	26481430	.	G	A	0	1	1	0	0	1	0	0
2	26483946	.	G	T	2	2	4	0	0	4	0	0
2	26491457	.	G	C	3	2	5	0	0	5	0	0
2	26491667	.	G	A	1	2	3	0	0	3	0	0
2	26491676	.	A	T	2	1	3	0	0	3	0	0
2	26494366	.	C	T	1	0	1	0	0	1	0	0
2	26494507	.	G	A	1	2	3	0	0	3	0	0
2	26500899	.	G	A	31	35	66	0	5	71	0	0
2	26577378	.	A	G	9	7	16	0	0	16	0	0
2	26581675	.	G	C	4	3	7	0	0	7	0	0
2	26583609	.	G	A	0	2	2	0	0	2	0	0
2	26583666	.	A	G	4	2	6	0	0	6	0	0
2	26588026	.	T	C	2	2	4	0	0	4	0	0
2	26592493	.	A	T	1	2	3	0	0	3	0	0
2	26592523	.	C	T	2	2	4	0	0	4	0	0
2	26598950	.	A	C	1	3	4	0	0	4	0	0
2	26599614	.	A	G	1	2	3	0	0	3	0	0
2	26605049	.	T	A	3	5	8	0	1	9	0	0
2	26605052	.	A	G	2	5	7	0	2	9	0	0
2	26610677	.	T	C	1	0	1	0	0	1	0	0
2	26612624	.	G	C	11	8	19	0	0	19	0	0
2	26612676	.	A	T	19	14	33	0	1	34	0	0
2	26613106	.	G	A	22	21	43	0	1	44	0	0
2	26619786	.	C	T	11	7	18	0	2	20	0	0
2	26620441	.	C	T	9	5	14	0	0	14	0	0
2	26623587	.	C	T	18	13	31	0	2	33	0	0
2	26623832	.	T	C	9	12	21	0	3	24	0	0
2	26627301	.	C	A	9	9	18	0	3	22	1	0
2	26627332	.	T	A	6	5	11	0	0	11	0	0
2	26630855	.	A	G	10	12	22	0	0	22	0	0
2	26656349	.	G	A	0	11	11	0	7	18	0	0
2	26662047	.	G	C	3	1	4	0	0	4	0	0
2	26665081	.	A	G	10	6	16	0	2	18	0	0
2	26665155	.	A	T	8	6	14	0	2	16	0	0
2	26665233	.	G	A	6	2	8	0	0	8	0	0
2	26665375	.	A	G	4	3	7	0	0	7	0	0
2	26665631	.	A	T	4	4	8	0	1	9	0	0
2	26672488	.	A	G	9	6	15	0	2	17	0	0
2	26676807	.	T	A	5	5	10	0	0	10	0	0
2	26677017	.	C	A	4	5	9	0	0	9	0	0
2	26677109	.	T	A	7	4	11	0	0	11	0	0
2	26677125	.	C	G	5	10	15	0	0	15	0	0
2	26677172	.	G	A	8	6	14	0	0	14	0	0
2	26677283	.	C	G	6	7	13	0	1	14	0	0
2	26677346	.	T	G	5	5	10	1	0	11	0	0
2	26677512	.	A	T	8	2	10	0	2	12	0	0
2	26677513	.	G	A	9	3	12	0	0	12	0	0
2	26680229	.	G	T	2	2	4	0	0	4	0	0
2	26680231	.	G	A	2	2	4	0	0	4	0	0
2	26680370	.	C	T	4	2	6	0	0	6	0	0
2	26680759	.	T	A	6	4	10	0	1	11	0	0
2	26680762	.	C	T	6	4	10	0	2	12	0	0
2	26680801	.	A	T	4	4	8	0	0	8	0	0
2	26680919	.	G	A	0	2	2	0	6	8	0	0
2	26681064	.	A	T	4	6	10	0	0	10	0	0
2	26681219	.	T	A	3	7	10	0	1	11	0	0
2	26682031	.	G	T	1	6	7	0	10	17	0	0
2	26684689	.	A	G	3	3	6	0	0	6	0	0
2	26686752	.	T	C	4	0	4	0	0	4	0	0
2	26697929	.	A	G	0	2	2	0	1	3	0	0
2	26714144	.	A	G	1	1	2	0	0	2	0	0
2	26714171	.	G	A	1	1	2	0	0	2	0	0
2	27000575	.	G	T	3	7	10	0	0	10	0	0
2	27045168	.	G	T	1	3	4	0	0	4	0	0
2	27048999	.	C	A	0	2	2	0	0	2	0	0
2	27049123	.	C	A	1	0	1	0	2	3	0	0
2	27064687	.	T	C	0	6	6	0	0	6	0	0
2	27075980	.	G	A	0	4	4	0	11	15	0	0
2	27075992	.	A	T	6	9	15	0	1	16	0	0
2	27094393	.	C	T	5	8	13	0	1	14	0	0
2	27319197	.	T	C	1	1	2	0	0	2	0	0
2	27330731	.	T	G	2	4	6	0	0	6	0	0
2	27341572	.	C	A	1	1	2	0	0	2	0	0
2	27378439	.	A	G	3	0	3	0	5	8	0	0
2	27378524	.	T	A	0	7	7	0	0	7	0	0
2	27380366	.	C	A	0	6	6	0	5	11	0	0
2	27382232	.	C	G	3	3	6	0	1	7	0	0
2	27382516	.	A	G	1	2	3	0	0	3	0	0
2	27384708	.	C	T	1	2	3	0	0	3	0	0
2	27384765	.	G	C	2	1	3	0	1	4	0	0
2	27385701	.	C	A	2	3	5	0	0	5	0	0
2	27385862	.	A	G	1	3	4	0	0	4	0	0
2	27385863	.	T	C	1	3	4	0	0	4	0	0
2	27387046	.	C	G	0	1	1	0	0	1	0	0
2	27527570	.	T	C	2	5	7	0	0	7	0	0
2	27532523	.	A	G	4	1	5	0	0	5	0	0
2	27538271	.	G	A	0	2	2	0	2	4	0	0
2	27538619	.	G	A	3	3	6	0	1	7	0	0
2	27540458	.	C	T	10	9	19	0	1	20	0	0
2	27541512	.	A	G	5	6	11	0	0	11	0	0
2	27541740	.	C	T	5	8	13	0	0	13	0	0
2	27541743	.	A	G	5	9	14	0	0	14	0	0
2	27541778	.	G	T	8	3	11	0	3	14	0	0
2	27542058	.	A	G	9	1	10	0	6	16	0	0
2	27542721	.	C	T	8	10	18	0	1	19	0	0
2	27542856	.	G	A	0	10	10	0	7	17	0	0
2	27543103	.	A	T	11	6	17	0	1	18	0	0
2	27543212	.	T	A	11	10	21	0	1	22	0	0
2	27543478	.	G	A	0	0	0	0	8	8	0	0
2	27543499	.	C	A	6	1	7	0	0	7	0	0
2	27635935	.	C	T	3	3	6	0	2	8	0	0
2	27641130	.	G	A	1	3	4	0	1	5	0	0
2	27641159	.	T	C	2	0	2	0	2	4	0	0
2	27642776	.	C	G	4	3	7	0	0	7	0	0
2	27658522	.	G	A	2	1	3	0	0	3	0	0
2	27658566	.	A	G	8	3	11	0	0	11	0	0
2	27658579	.	C	T	2	8	10	0	1	11	0	0
2	27658639	.	G	A	1	4	5	0	3	8	0	0
2	27658973	.	T	G	5	3	8	0	0	8	0	0
2	27659018	.	T	C	9	6	15	0	0	15	0	0
2	27662374	.	C	T	6	7	13	0	0	13	0	0
2	27662496	.	G	A	2	5	7	0	1	8	0	0
2	27663785	.	C	A	6	4	10	0	0	10	0	0
2	27664202	.	T	C	4	3	7	0	0	7	0	0
2	27664215	.	A	C	4	4	8	0	0	8	0	0
2	27670836	.	C	T	0	7	7	0	9	16	0	0
2	27670884	.	T	G	7	9	16	0	0	16	0	0
2	27671172	.	C	T	7	14	21	0	3	24	0	0
2	27671290	.	G	T	13	9	22	0	0	22	0	0
2	27671334	.	T	C	11	10	21	0	2	23	0	0
2	27671485	.	A	T	10	3	13	0	0	13	0	0
2	27671486	.	G	A	10	3	13	0	0	13	0	0
2	27671623	.	A	T	11	5	16	0	0	16	0	0
2	27671650	.	C	A	0	5	5	0	5	10	0	0
2	27671681	.	G	T	5	8	13	0	0	13	0	0
2	27671704	.	C	T	7	7	14	0	0	14	0	0
2	27671724	.	G	A	11	5	16	0	0	16	0	0
2	27672215	.	G	T	7	7	14	0	2	16	0	0
2	27672426	.	T	C	12	4	16	0	0	16	0	0
2	27672440	.	C	T	0	5	5	0	9	14	0	0
2	27672535	.	C	T	2	5	7	0	0	7	0	0
2	27672636	.	C	T	4	5	9	0	1	10	0	0
2	27673041	.	A	G	4	10	14	0	1	15	0	0
2	27673080	.	G	A	5	8	13	0	0	13	0	0
2	27673148	.	G	A	10	9	19	0	0	19	0	0
2	27673173	.	A	G	10	9	19	0	0	19	0	0
2	27774370	.	G	A	4	10	14	0	2	16	0	0
2	27812578	.	G	A	2	1	3	0	0	3	0	0
2	27843845	.	G	A	1	6	7	0	0	7	0	0
2	27843937	.	A	G	2	2	4	0	0	4	0	0
2	27845694	.	G	A	3	4	7	0	0	7	0	0
2	27846071	.	G	A	11	4	15	0	2	17	0	0
2	27853876	.	A	T	2	2	4	0	1	5	0	0
2	27933143	.	C	T	1	3	4	0	0	4	0	0
2	27933215	.	C	A	3	4	7	0	1	8	0	0
2	27933260	.	C	A	4	4	8	0	3	11	0	0
2	27963660	.	G	A	4	4	8	0	0	8	0	0
2	27963686	.	C	T	0	5	5	0	3	8	0	0
2	27966636	.	C	T	1	2	3	0	0	3	0	0
2	27969966	.	G	A	3	3	6	0	0	6	0	0
2	27969985	.	A	G	3	3	6	0	0	6	0	0
2	27975443	.	G	T	3	2	5	0	1	6	0	0
2	28049696	.	C	T	8	9	17	0	0	17	0	0
2	28049996	.	A	G	7	5	12	0	0	12	0	0
2	28050058	.	C	A	5	3	8	0	0	8	0	0
2	28050243	.	T	C	8	0	8	0	7	15	0	0
2	28050565	.	T	A	4	8	12	0	1	13	0	0
2	28050600	.	G	C	3	0	3	0	6	9	0	0
2	28050921	.	G	T	8	2	10	0	1	11	0	0
2	28050933	.	G	A	3	5	8	0	2	10	0	0
2	28051041	.	T	A	4	11	15	0	2	17	0	0
2	28051092	.	C	T	0	13	13	0	10	23	0	0
2	28051104	.	G	A	7	11	18	0	1	19	0	0
2	28057518	.	G	A	5	3	8	0	0	8	0	0
2	28077152	.	C	A	0	2	2	0	2	4	0	0
2	28910813	.	C	G	3	2	5	0	0	5	0	0
2	28929177	.	G	A	0	2	2	0	1	3	0	0
2	28930100	.	T	C	7	8	15	0	1	16	0	0
2	28933846	.	T	G	4	4	8	0	0	8	0	0
2	28934011	.	C	T	10	8	18	0	0	18	0	0
2	28934152	.	T	C	9	3	12	0	0	12	0	0
2	29012723	.	C	T	1	2	3	0	0	3	0	0
2	29105857	.	T	A	2	1	3	0	0	3	0	0
2	29289068	.	G	T	0	1	1	0	0	1	0	0
2	29317718	.	G	A	6	6	12	0	0	12	0	0
2	29352279	.	G	A	0	10	10	0	11	21	0	0
2	29352411	.	A	C	8	4	12	0	0	12	0	0
2	29352481	.	G	C	8	3	11	0	0	11	0	0
2	29352579	.	T	C	4	8	12	0	0	12	0	0
2	29352673	.	C	T	7	3	10	0	0	10	0	0
2	29477653	.	T	C	14	16	30	0	2	32	0	0
2	29477733	.	A	T	24	11	35	0	0	35	0	0
2	29482390	.	G	A	9	5	14	0	0	14	0	0
2	29482417	.	A	G	12	5	17	0	0	17	0	0
2	29485046	.	G	A	5	13	18	0	0	18	0	0
2	29485068	.	G	T	13	6	19	0	0	19	0	0
2	29491445	.	C	T	1	2	3	0	0	3	0	0
2	29915582	.	C	G	5	4	9	0	0	9	0	0
2	30116316	.	A	T	6	2	8	0	0	9	1	0
2	30459984	.	T	A	5	0	5	0	0	5	0	0
2	30459985	.	A	C	5	0	5	0	0	5	0	0
2	30568944	.	A	T	9	8	17	0	0	17	0	0
2	30568959	.	C	T	7	5	12	0	0	12	0	0
2	30574092	.	C	T	0	7	7	0	6	13	0	0
2	30586847	.	G	C	2	4	6	0	0	6	0	0
2	30611283	.	G	T	6	9	15	0	3	18	0	0
2	30613764	.	G	A	5	6	11	0	0	11	0	0
2	30614153	.	C	A	11	7	18	0	1	19	0	0
2	30614370	.	T	G	4	4	8	0	0	8	0	0
2	30618155	.	C	T	5	5	10	0	3	13	0	0
2	30618205	.	T	C	7	1	8	0	5	13	0	0
2	30668467	.	C	G	1	1	2	0	0	2	0	0
2	30693635	.	G	A	2	4	6	0	0	6	0	0
2	30741192	.	C	T	5	8	13	0	0	13	0	0
2	30743041	.	T	C	8	3	11	0	0	11	0	0
2	30743864	.	A	G	8	9	17	0	1	18	0	0
2	30743907	.	T	C	15	12	27	0	0	27	0	0
2	30743951	.	C	A	4	5	9	0	0	9	0	0
2	30752796	.	G	A	1	3	4	0	0	4	0	0
2	30752928	.	G	A	3	3	6	0	0	6	0	0
2	30753072	.	A	T	18	6	24	0	0	24	0	0
2	30753273	.	G	A	8	9	17	0	1	18	0	0
2	30753888	.	A	G	9	9	18	0	0	18	0	0
2	30753899	.	C	T	8	9	17	0	0	17	0	0
2	30753928	.	G	A	4	6	10	0	1	11	0	0
2	30754030	.	A	T	6	6	12	0	0	12	0	0
2	30754113	.	T	C	8	12	20	0	0	20	0	0
2	30754196	.	G	A	10	13	23	0	0	23	0	0
2	30754300	.	C	T	9	18	27	0	2	29	0	0
2	30754306	.	G	A	18	10	28	0	0	28	0	0
2	30754346	.	A	G	9	16	25	0	3	28	0	0
2	30754432	.	G	T	10	18	28	0	0	28	0	0
2	30754733	.	A	G	8	9	17	0	0	17	0	0
2	30754741	.	A	G	8	10	18	0	0	18	0	0
2	30754777	.	A	T	9	7	16	0	0	16	0	0
2	30754793	.	A	T	9	4	13	0	1	14	0	0
2	30755195	.	G	A	1	4	5	0	0	5	0	0
2	30755359	.	A	T	3	14	17	1	0	18	0	0
2	30755522	.	G	T	5	4	9	0	0	9	0	0
2	31650963	.	T	G	0	5	5	0	0	5	0	0
2	31687583	.	A	G	1	1	2	1	2	5	0	0
2	31687593	.	A	G	2	1	3	1	1	5	0	0
2	31703443	.	C	T	0	5	5	0	1	6	0	0
2	31827396	.	G	A	2	11	13	0	0	13	0	0
2	31891344	.	T	A	4	23	27	0	0	29	2	0
2	32352875	.	G	A	5	2	7	0	0	7	0	0
2	32392166	.	A	G	2	3	5	0	0	5	0	0
2	32392724	.	A	G	4	4	8	0	0	8	0	0
2	32393259	.	A	G	2	2	4	0	0	4	0	0
2	32393281	.	T	A	1	3	4	0	0	5	1	0
2	32393321	.	A	G	1	2	3	0	0	3	0	0
2	32393460	.	C	T	0	4	4	0	2	6	0	0
2	32393516	.	T	C	9	0	9	0	3	12	0	0
2	32393579	.	T	C	5	2	7	0	0	7	0	0
2	32393616	.	A	G	2	1	3	0	1	4	0	0
2	32393617	.	T	G	2	2	4	0	0	4	0	0
2	32393731	.	G	A	1	5	6	0	0	6	0	0
2	32393918	.	A	T	1	2	3	0	0	3	0	0
2	32393930	.	T	C	1	3	4	0	0	4	0	0
2	32393985	.	A	G	1	2	3	0	0	3	0	0
2	32396773	.	A	G	1	0	1	0	0	1	0	0
2	32396845	.	C	T	0	2	2	0	2	4	0	0
2	32407242	.	C	T	0	2	2	0	1	3	0	0
2	32414132	.	G	A	2	0	2	0	1	3	0	0
2	32415840	.	A	T	1	2	3	0	0	3	0	0
2	32424387	.	C	T	0	1	1	0	0	1	0	0
2	32475941	.	A	T	4	4	8	0	0	8	0	0
2	32477432	.	T	C	13	7	20	0	1	21	0	0
2	32483020	.	C	G	4	5	9	0	1	10	0	0
2	32485832	.	A	G	6	17	23	0	0	23	0	0
2	32485895	.	C	T	1	13	14	0	7	21	0	0
2	32485962	.	G	A	4	16	20	0	0	20	0	0
2	32494486	.	G	A	14	9	23	0	1	24	0	0
2	32494705	.	C	T	0	1	1	0	1	2	0	0
2	32494720	.	G	A	1	1	2	0	0	2	0	0
2	32498078	.	C	T	1	0	1	0	0	1	0	0
2	32498117	.	A	G	0	1	1	0	0	1	0	0
2	32501188	.	G	A	3	2	5	0	1	6	0	0
2	32505664	.	G	A	6	5	11	0	0	11	0	0
2	32507094	.	C	T	1	3	4	0	0	4	0	0
2	32507218	.	G	A	1	3	4	0	0	4	0	0
2	32509238	.	T	G	5	13	18	0	0	18	0	0
2	32509247	.	G	A	14	4	18	0	0	18	0	0
2	32509309	.	G	T	1	6	7	0	0	7	0	0
2	32509573	.	G	A	6	11	17	0	0	17	0	0
2	32509636	.	C	T	2	4	6	0	0	6	0	0
2	32515861	.	C	T	0	7	7	0	6	13	0	0
2	32516110	.	T	C	9	4	13	0	5	18	0	0
2	32516359	.	A	T	6	9	15	0	0	15	0	0
2	32516469	.	T	C	11	0	11	0	13	24	0	0
2	32519690	.	G	A	5	8	13	0	0	13	0	0
2	32531232	.	C	T	1	0	1	0	0	1	0	0
2	32543014	.	T	A	1	1	2	0	0	2	0	0
2	32558621	.	G	A	1	3	4	0	1	5	0	0
2	32561752	.	A	G	5	3	8	0	1	9	0	0
2	32561754	.	G	A	5	4	9	0	0	9	0	0
2	32562059	.	G	A	7	9	16	0	1	17	0	0
2	32569639	.	G	A	9	9	18	0	0	18	0	0
2	32569717	.	A	G	9	6	15	0	0	15	0	0
2	32569745	.	A	G	9	10	19	0	1	20	0	0
2	32569930	.	G	A	2	11	13	0	1	14	0	0
2	32577939	.	G	A	3	3	6	0	0	6	0	0
2	32578124	.	A	T	9	8	17	0	1	18	0	0
2	32578230	.	C	T	10	12	22	0	0	22	0	0
2	32578330	.	A	G	3	7	10	0	0	10	0	0
2	32578580	.	C	A	8	9	17	0	1	18	0	0
2	32578677	.	C	A	7	8	15	0	0	15	0	0
2	32583144	.	A	G	9	6	15	0	0	15	0	0
2	32583162	.	T	A	8	7	15	0	2	17	0	0
2	32583209	.	C	T	7	7	14	0	0	14	0	0
2	32583345	.	C	T	5	5	10	0	0	10	0	0
2	32583411	.	C	A	0	7	7	0	9	16	0	0
2	32583453	.	T	A	7	9	16	0	0	16	0	0
2	32583459	.	A	G	6	8	14	0	0	14	0	0
2	32583629	.	A	C	6	1	7	0	6	13	0	0
2	32583681	.	T	A	2	1	3	0	0	3	0	0
2	32583687	.	G	A	2	1	3	0	0	3	0	0
2	32584548	.	C	T	0	2	2	0	0	2	0	0
2	32590552	.	C	T	1	0	1	0	0	1	0	0
2	32591488	.	C	A	3	3	6	0	0	6	0	0
2	32591697	.	G	T	3	5	8	0	1	9	0	0
2	32594670	.	A	T	4	5	9	0	1	10	0	0
2	32594699	.	T	A	5	6	11	0	0	11	0	0
2	32594763	.	G	A	2	4	6	0	1	7	0	0
2	32665798	.	G	A	1	1	2	0	0	2	0	0
2	32667941	.	C	A	0	6	6	0	4	10	0	0
2	32676228	.	T	A	4	9	13	0	1	14	0	0
2	32676482	.	A	C	5	4	9	0	0	9	0	0
2	32680338	.	C	T	7	4	11	0	0	11	0	0
2	32680356	.	C	T	9	5	14	0	1	15	0	0
2	32682216	.	C	T	3	1	4	0	0	4	0	0
2	32686412	.	C	T	1	0	1	0	1	2	0	0
2	32686594	.	C	T	2	3	5	0	0	5	0	0
2	32749875	.	T	C	2	0	2	0	1	3	0	0
2	32749989	.	C	T	5	2	7	0	0	7	0	0
2	32750028	.	C	T	1	2	3	0	0	3	0	0
2	32750675	.	C	A	1	2	3	0	0	3	0	0
2	32751636	.	T	C	0	1	1	0	0	1	0	0
2	32752447	.	G	A	1	4	5	0	0	5	0	0
2	32756074	.	C	T	2	4	6	0	0	6	0	0
2	32756630	.	C	T	4	2	6	0	0	6	0	0
2	32814503	.	G	A	2	2	4	0	0	4	0	0
2	32814677	.	G	C	3	3	6	0	0	6	0	0
2	32814695	.	T	C	6	4	10	0	0	10	0	0
2	32817615	.	T	A	3	6	9	0	0	9	0	0
2	32817627	.	G	A	5	6	11	0	0	11	0	0
2	32817921	.	G	A	3	5	8	0	0	8	0	0
2	32820764	.	G	A	4	5	9	0	0	9	0	0
2	32821622	.	T	G	1	0	1	0	0	1	0	0
2	32824727	.	G	A	8	5	13	0	0	13	0	0
2	32824805	.	G	A	3	9	12	0	1	13	0	0
2	32824896	.	C	T	2	5	7	0	0	7	0	0
2	32825018	.	C	G	0	4	4	0	5	9	0	0
2	32825033	.	G	A	4	7	11	0	1	12	0	0
2	32825294	.	G	A	3	5	8	0	0	8	0	0
2	32825382	.	C	T	10	5	15	0	0	15	0	0
2	32825480	.	T	G	4	5	9	0	0	9	0	0
2	32827004	.	C	T	3	3	6	0	0	6	0	0
2	32827005	.	C	T	3	3	6	0	0	6	0	0
2	32828651	.	A	G	1	1	2	0	0	2	0	0
2	32828683	.	A	G	2	3	5	0	0	5	0	0
2	32828704	.	C	T	3	1	4	0	0	4	0	0
2	32828839	.	C	A	3	3	6	0	1	7	0	0
2	32829016	.	T	C	3	4	7	0	0	7	0	0
2	32831664	.	C	A	4	2	6	0	0	6	0	0
2	32833563	.	T	G	3	5	8	0	0	8	0	0
2	32833590	.	C	T	0	4	4	0	1	5	0	0
2	32846004	.	G	A	3	3	6	0	0	6	0	0
2	32849667	.	A	G	5	3	8	0	0	8	0	0
2	32850138	.	C	T	9	8	17	0	0	17	0	0
2	32850305	.	T	C	7	7	14	0	0	14	0	0
2	32850401	.	T	C	10	4	14	0	1	15	0	0
2	32850477	.	T	A	1	9	10	0	1	11	0	0
2	32850510	.	A	T	3	2	5	0	0	5	0	0
2	33209645	.	T	G	1	0	1	0	0	1	0	0
2	33216346	.	C	T	17	6	23	0	0	23	0	0
2	33216518	.	G	A	3	19	22	0	9	31	0	0
2	33216563	.	C	G	15	23	38	0	0	38	0	0
2	33415269	.	T	G	2	2	4	0	0	4	0	0
2	33415981	.	A	G	0	2	2	0	0	2	0	0
2	33416242	.	G	T	2	3	5	0	0	5	0	0
2	33416755	.	A	G	1	0	1	0	2	3	0	0
2	33416771	.	T	A	1	2	3	0	0	3	0	0
2	33417504	.	G	T	1	4	5	0	0	5	0	0
2	33417533	.	C	G	1	5	6	0	0	6	0	0
2	33417591	.	C	T	3	2	5	0	0	5	0	0
2	33417604	.	G	A	4	3	7	0	0	7	0	0
2	33417661	.	A	T	3	6	9	0	0	9	0	0
2	33417700	.	C	T	2	5	7	0	0	7	0	0
2	33418081	.	T	A	2	2	4	0	0	4	0	0
2	33418476	.	G	A	5	5	10	0	0	10	0	0
2	33418486	.	T	C	4	5	9	0	0	9	0	0
2	33418534	.	C	A	5	4	9	0	0	9	0	0
2	33418586	.	C	A	6	5	11	0	0	11	0	0
2	33418604	.	A	T	5	6	11	0	0	11	0	0
2	33419463	.	G	C	3	6	9	0	0	9	0	0
2	33419506	.	A	G	4	4	8	0	0	8	0	0
2	33419541	.	G	A	5	2	7	0	0	7	0	0
2	33419542	.	A	G	5	2	7	0	0	7	0	0
2	33419602	.	A	G	1	7	8	0	0	8	0	0
2	33419650	.	A	G	3	2	5	0	0	5	0	0
2	33419704	.	A	G	6	0	6	0	5	11	0	0
2	33419730	.	A	G	5	3	8	0	0	8	0	0
2	33420218	.	T	A	14	6	20	0	0	20	0	0
2	33420309	.	T	A	3	2	5	0	1	6	0	0
2	33420318	.	A	G	4	0	4	0	3	7	0	0
2	33420384	.	G	A	0	4	4	0	5	9	0	0
2	33420438	.	C	A	4	4	8	0	0	8	0	0
2	33420539	.	T	A	2	4	6	0	0	6	0	0
2	33420545	.	G	A	2	4	6	0	0	6	0	0
2	33420638	.	T	G	1	3	4	0	0	4	0	0
2	33420679	.	T	G	2	5	7	0	0	7	0	0
2	33420684	.	A	C	2	4	6	0	1	7	0	0
2	33420806	.	C	T	13	7	20	0	0	20	0	0
2	33420925	.	C	A	10	7	17	0	0	18	1	0
2	33421078	.	G	T	2	7	9	0	0	9	0	0
2	33421200	.	C	T	6	7	13	0	1	14	0	0
2	33421222	.	A	C	8	8	16	0	0	16	0	0
2	33421275	.	C	G	3	11	14	0	0	14	0	0
2	33421276	.	T	C	3	11	14	0	0	14	0	0
2	33421331	.	C	A	3	12	15	0	0	15	0	0
2	33421382	.	A	T	6	5	11	0	0	11	0	0
2	33421404	.	T	A	10	5	15	0	0	15	0	0
2	33421441	.	T	G	10	0	10	0	10	20	0	0
2	33421547	.	A	G	11	6	17	0	0	17	0	0
2	33421549	.	A	C	11	6	17	0	0	17	0	0
2	33421720	.	A	G	10	13	23	0	0	23	0	0
2	33421774	.	A	G	11	11	22	0	0	22	0	0
2	33421860	.	T	G	9	10	19	0	1	20	0	0
2	33421872	.	A	T	10	9	19	0	0	19	0	0
2	33421985	.	T	A	9	2	11	0	1	12	0	0
2	33422125	.	C	T	2	6	8	0	0	8	0	0
2	33422169	.	T	C	5	5	10	0	0	10	0	0
2	33422211	.	G	A	4	8	12	0	0	12	0	0
2	33422286	.	T	G	11	7	18	0	0	18	0	0
2	33422289	.	C	T	8	7	15	0	2	17	0	0
2	33422327	.	G	A	12	18	30	0	1	31	0	0
2	33422509	.	T	A	14	4	18	0	4	22	0	0
2	33477073	.	C	T	3	0	3	0	0	3	0	0
2	33477139	.	G	A	2	7	9	0	0	9	0	0
2	33477160	.	T	C	3	8	11	0	0	11	0	0
2	33477175	.	A	G	4	8	12	0	0	12	0	0
2	33522070	.	C	T	3	0	3	0	1	4	0	0
2	33522130	.	A	T	6	3	9	0	1	10	0	0
2	33645058	.	A	G	6	3	9	0	0	9	0	0
2	33645157	.	A	G	3	4	7	0	0	7	0	0
2	33645335	.	G	A	4	3	7	0	0	7	0	0
2	33645344	.	C	A	2	3	5	0	1	6	0	0
2	33676209	.	A	G	2	3	5	0	0	5	0	0
2	33676218	.	G	A	1	2	3	0	1	4	0	0
2	33681337	.	A	T	31	8	39	0	2	41	0	0
2	33687090	.	G	A	19	23	42	0	0	42	0	0
2	33687110	.	C	A	19	22	41	0	3	44	0	0
2	33969861	.	C	A	1	3	4	0	0	4	0	0
2	34009014	.	G	A	1	1	2	0	1	3	0	0
2	34022992	.	T	A	2	4	6	0	0	6	0	0
2	34024832	.	A	G	2	2	4	0	0	4	0	0
2	34025167	.	G	A	8	6	14	0	0	14	0	0
2	34029353	.	G	A	1	3	4	0	0	4	0	0
2	34071980	.	T	G	3	2	5	0	0	5	0	0
2	34112170	.	C	G	4	0	4	0	2	6	0	0
2	34119467	.	A	C	3	2	5	0	0	5	0	0
2	34119783	.	G	A	0	5	5	0	1	6	0	0
2	34122859	.	A	G	7	9	16	0	1	17	0	0
2	34122985	.	C	T	1	2	3	0	0	3	0	0
2	34126040	.	T	C	4	3	7	0	0	7	0	0
2	34126514	.	G	T	2	1	3	0	0	3	0	0
2	34141494	.	A	G	1	0	1	0	0	1	0	0
2	34173018	.	T	A	2	3	5	0	0	5	0	0
2	34173253	.	C	T	4	4	8	0	0	8	0	0
2	34173335	.	A	C	6	2	8	0	1	9	0	0
2	34173336	.	G	A	6	3	9	0	0	9	0	0
2	34381013	.	T	G	12	12	24	0	0	24	0	0
2	34381032	.	T	C	9	5	14	0	2	16	0	0
2	34381066	.	C	T	9	7	16	0	1	17	0	0
2	34555410	.	A	G	7	3	10	0	1	11	0	0
2	34573032	.	A	T	8	12	20	0	0	20	0	0
2	34573064	.	C	T	6	8	14	0	0	14	0	0
2	34698215	.	C	A	10	8	18	0	1	19	0	0
2	34714557	.	A	G	3	0	3	0	2	5	0	0
2	34725878	.	A	G	7	8	15	0	0	15	0	0
2	34793415	.	C	T	0	1	1	0	0	1	0	0
2	34924412	.	A	G	9	23	32	0	2	34	0	0
2	34962193	.	A	T	2	1	3	0	0	3	0	0
2	34962223	.	A	G	8	0	8	0	12	20	0	0
2	34970135	.	T	C	6	9	15	0	0	15	0	0
2	34970329	.	A	G	23	13	36	0	1	37	0	0
2	34981747	.	G	A	27	18	45	0	3	48	0	0
2	34981986	.	G	A	19	29	48	0	2	50	0	0
2	34982205	.	T	G	18	17	35	0	1	36	0	0
2	34982322	.	A	T	4	5	9	0	0	10	1	0
2	34986320	.	A	G	1	3	4	0	0	4	0	0
2	34986337	.	C	A	0	3	3	0	1	4	0	0
2	34986702	.	C	T	2	4	6	0	0	6	0	0
2	35011823	.	A	T	0	3	3	0	0	3	0	0
2	35012056	.	C	G	0	2	2	0	1	3	0	0
2	35012103	.	T	C	1	0	1	0	0	1	0	0
2	35024724	.	A	G	1	1	2	0	0	2	0	0
2	35116674	.	T	C	3	4	7	0	0	7	0	0
2	35117066	.	A	C	3	2	5	0	0	5	0	0
2	35118607	.	C	T	2	3	5	0	1	6	0	0
2	35126353	.	A	C	2	2	4	0	0	4	0	0
2	35128951	.	A	G	3	0	3	0	4	7	0	0
2	35395875	.	G	T	1	4	5	0	0	5	0	0
2	35406960	.	G	A	0	1	1	0	0	1	0	0
2	35407144	.	C	T	3	1	4	0	1	5	0	0
2	35419271	.	T	G	1	0	1	0	2	3	0	0
2	35419307	.	G	A	3	4	7	0	0	7	0	0
2	35419385	.	T	C	1	1	2	0	0	2	0	0
2	35421399	.	A	T	2	4	6	0	0	6	0	0
2	35424633	.	C	T	2	3	5	0	0	5	0	0
2	35434910	.	C	T	3	4	7	0	1	8	0	0
2	35437417	.	C	T	1	3	4	0	0	4	0	0
2	35437513	.	C	A	2	4	6	0	0	6	0	0
2	35454442	.	C	T	2	2	4	0	0	4	0	0
2	35473847	.	G	A	0	11	11	0	7	18	0	0
2	35473975	.	G	T	8	3	11	0	0	11	0	0
2	35474049	.	G	A	0	11	11	0	12	23	0	0
2	35474112	.	T	C	4	2	6	0	0	6	0	0
2	35593364	.	T	G	7	3	10	0	1	11	0	0
2	35594003	.	G	A	9	9	18	0	0	18	0	0
2	35595514	.	C	A	17	21	38	0	3	41	0	0
2	35595551	.	A	T	14	13	27	0	1	28	0	0
2	35598219	.	A	T	8	7	15	0	0	15	0	0
2	35598257	.	C	G	6	4	10	0	0	10	0	0
2	35601212	.	T	G	8	2	10	0	0	10	0	0
2	35605841	.	G	A	1	2	3	0	0	3	0	0
2	35607206	.	C	T	11	12	23	0	0	23	0	0
2	35608445	.	T	A	12	5	17	0	1	18	0	0
2	35610890	.	T	G	2	12	14	0	1	15	0	0
2	35611051	.	T	A	2	8	10	0	2	12	0	0
2	35611172	.	C	T	10	17	27	0	1	28	0	0
2	35731033	.	C	G	1	3	4	0	2	6	0	0
2	35731054	.	A	T	4	4	8	0	1	9	0	0
2	36708172	.	G	A	0	0	0	0	1	1	0	0
2	36718401	.	T	A	2	2	4	0	0	4	0	0
2	36722846	.	T	C	3	2	5	0	0	5	0	0
2	36724384	.	A	C	17	16	33	0	0	33	0	0
2	36727360	.	A	T	3	4	7	0	0	7	0	0
2	36816003	.	A	G	6	10	16	0	1	17	0	0
2	36816120	.	T	G	4	6	10	0	0	10	0	0
2	36816312	.	T	C	0	3	3	0	0	3	0	0
2	36816495	.	T	G	6	7	13	0	0	13	0	0
2	36816501	.	T	G	5	6	11	0	1	12	0	0
2	36816828	.	T	C	2	4	6	0	0	6	0	0
2	36817317	.	T	C	3	7	10	0	1	11	0	0
2	36817362	.	G	A	4	8	12	0	0	12	0	0
2	36819320	.	C	T	3	3	6	0	0	7	1	0
2	36819587	.	A	G	3	4	7	0	0	7	0	0
2	36819596	.	A	T	3	4	7	0	0	7	0	0
2	36828901	.	C	G	0	1	1	0	2	3	0	0
2	36831368	.	C	T	1	2	3	0	0	3	0	0
2	36833378	.	C	A	4	4	8	0	0	8	0	0
2	36834497	.	C	A	2	1	3	0	0	3	0	0
2	36834542	.	C	T	2	1	3	0	0	3	0	0
2	36838094	.	C	T	1	2	3	0	0	3	0	0
2	36838274	.	G	A	2	3	5	0	0	5	0	0
2	36838322	.	T	C	1	9	10	0	0	10	0	0
2	36838355	.	A	G	0	0	0	0	2	2	0	0
2	36840594	.	C	T	1	1	2	0	0	2	0	0
2	36840789	.	C	T	3	4	7	0	0	7	0	0
2	36841523	.	A	G	3	3	6	0	0	6	0	0
2	36852056	.	C	G	13	16	29	0	2	31	0	0
2	36853630	.	C	T	3	0	3	0	0	3	0	0
2	36853936	.	T	C	8	9	17	0	0	17	0	0
2	36853955	.	A	C	6	10	16	0	0	16	0	0
2	36854173	.	T	C	13	9	22	0	1	23	0	0
2	36854184	.	C	A	11	7	18	0	0	18	0	0
2	36862726	.	T	C	7	4	11	0	0	11	0	0
2	36889867	.	A	T	4	3	7	0	1	8	0	0
2	36892504	.	C	T	4	11	15	0	0	15	0	0
2	36892518	.	A	G	5	9	14	0	1	15	0	0
2	36892857	.	A	G	3	4	7	0	0	7	0	0
2	36921495	.	A	T	4	6	10	0	0	10	0	0
2	36921579	.	G	C	11	0	11	0	13	24	0	0
2	36921588	.	A	G	12	12	24	0	0	24	0	0
2	36922595	.	G	A	0	1	1	0	0	1	0	0
2	36922604	.	A	T	2	2	4	0	0	4	0	0
2	36922883	.	C	T	10	7	17	0	0	17	0	0
2	36922988	.	A	T	6	7	13	0	0	13	0	0
2	36923167	.	T	C	12	0	12	0	8	20	0	0
2	36924020	.	G	T	4	4	8	0	0	8	0	0
2	36924051	.	T	C	7	1	8	0	4	12	0	0
2	36925218	.	T	C	6	7	13	0	0	13	0	0
2	36925931	.	A	G	1	0	1	0	0	1	0	0
2	36926239	.	T	G	2	0	2	0	0	2	0	0
2	36932226	.	A	C	2	0	2	0	2	4	0	0
2	36933269	.	C	A	0	1	1	0	0	1	0	0
2	36933356	.	A	T	0	1	1	0	0	1	0	0
2	36939965	.	T	A	4	5	9	0	0	9	0	0
2	36941365	.	A	G	4	2	6	0	0	6	0	0
2	36990050	.	A	T	17	19	36	0	0	36	0	0
2	36990185	.	A	C	21	21	42	0	2	44	0	0
2	36990283	.	A	T	20	20	40	0	1	41	0	0
2	36990294	.	A	T	21	17	38	0	1	39	0	0
2	36990363	.	A	G	17	31	48	0	1	49	0	0
2	36990458	.	A	G	24	27	51	0	0	51	0	0
2	36992795	.	T	C	4	0	4	0	4	8	0	0
2	37043708	.	A	C	4	0	4	0	5	9	0	0
2	37059835	.	T	G	4	5	9	0	0	9	0	0
2	37089448	.	A	G	1	2	3	0	0	3	0	0
2	37094361	.	A	G	1	4	5	0	0	5	0	0
2	37123507	.	T	C	14	8	22	0	1	23	0	0
2	37123901	.	T	C	14	8	22	0	1	23	0	0
2	37124181	.	A	C	24	20	44	0	0	44	0	0
2	37124509	.	A	G	11	6	17	0	2	19	0	0
2	37124546	.	G	A	4	4	8	0	5	13	0	0
2	37124821	.	C	A	7	9	16	0	0	16	0	0
2	37124961	.	C	G	15	15	30	0	0	30	0	0
2	37128450	.	C	T	13	14	27	0	0	27	0	0
2	37141002	.	G	A	0	2	2	0	2	4	0	0
2	37145793	.	T	A	8	25	33	0	0	33	0	0
2	37145820	.	G	C	10	24	34	0	1	35	0	0
2	37146474	.	C	T	15	17	32	0	2	34	0	0
2	37146512	.	A	G	12	0	12	0	7	19	0	0
2	37189834	.	T	C	2	2	4	0	0	4	0	0
2	37191964	.	A	G	0	2	2	0	0	2	0	0
2	37193743	.	G	A	0	2	2	0	0	2	0	0
2	37195406	.	C	A	2	3	5	0	0	5	0	0
2	37195472	.	A	C	4	8	12	0	1	13	0	0
2	37201513	.	G	A	0	3	3	0	0	3	0	0
2	37205437	.	T	G	5	1	6	1	5	12	0	0
2	37257571	.	A	G	6	4	10	0	0	10	0	0
2	37258084	.	C	A	5	2	7	0	0	7	0	0
2	37261326	.	A	T	10	8	18	0	1	19	0	0
2	37263874	.	C	A	26	17	43	0	0	43	0	0
2	37264364	.	A	T	9	5	14	0	0	14	0	0
2	37264423	.	G	T	5	8	13	0	0	13	0	0
2	37264693	.	T	C	13	15	28	0	4	32	0	0
2	37264856	.	T	A	13	18	31	0	1	32	0	0
2	37264889	.	T	G	5	19	24	0	0	24	0	0
2	37264915	.	T	A	11	13	24	0	1	25	0	0
2	37264928	.	A	T	12	12	24	0	1	25	0	0
2	37265021	.	C	T	11	8	19	0	0	19	0	0
2	37265125	.	T	A	11	8	19	0	2	21	0	0
2	37265302	.	G	A	10	12	22	0	5	27	0	0
2	37265409	.	T	A	19	18	37	0	2	39	0	0
2	37267831	.	T	A	2	4	6	0	0	6	0	0
2	37272392	.	A	G	2	2	4	0	0	4	0	0
2	37274504	.	A	G	7	2	9	0	1	10	0	0
2	37280268	.	T	C	1	0	1	0	0	1	0	0
2	37280399	.	A	G	2	0	2	0	0	2	0	0
2	37280457	.	C	T	0	6	6	0	3	9	0	0
2	37307422	.	T	A	10	10	20	0	0	20	0	0
2	37307557	.	T	C	0	3	3	0	0	3	0	0
2	37322252	.	G	A	6	3	9	0	1	10	0	0
2	37352084	.	G	A	2	3	5	0	0	5	0	0
2	37365855	.	C	T	0	14	14	0	22	36	0	0
2	37366234	.	A	G	7	8	15	0	0	15	0	0
2	37366496	.	A	T	18	11	29	0	0	29	0	0
2	37366526	.	T	C	12	15	27	0	3	30	0	0
2	37366810	.	G	C	10	8	18	0	0	18	0	0
2	37366815	.	G	A	10	7	17	0	0	17	0	0
2	37375027	.	G	A	0	3	3	0	0	3	0	0
2	37379482	.	A	G	2	2	4	0	0	5	1	0
2	37383444	.	A	G	10	7	17	0	1	18	0	0
2	37391319	.	T	C	2	0	2	0	1	3	0	0
2	37424290	.	G	A	1	3	4	0	0	4	0	0
2	37424499	.	G	C	1	5	6	0	0	6	0	0
2	37428557	.	C	T	2	1	3	0	0	3	0	0
2	37428741	.	G	A	2	2	4	0	0	4	0	0
2	37428804	.	A	G	10	6	16	0	0	16	0	0
2	37433540	.	C	T	3	2	5	0	0	5	0	0
2	37436778	.	T	A	11	6	17	0	1	18	0	0
2	37455811	.	A	G	2	4	6	0	1	7	0	0
2	37457985	.	T	G	0	1	1	0	0	1	0	0
2	37469926	.	G	A	19	13	32	0	1	33	0	0
2	37469962	.	A	G	16	20	36	0	1	37	0	0
2	37470001	.	A	G	20	15	35	0	1	36	0	0
2	37471495	.	C	G	5	6	11	0	0	11	0	0
2	37496982	.	A	G	2	2	4	0	0	4	0	0
2	37497789	.	G	C	0	2	2	0	0	2	0	0
2	37502213	.	G	A	4	17	21	0	1	22	0	0
2	37502412	.	T	G	3	14	17	0	0	17	0	0
2	37502834	.	G	A	4	8	12	0	1	13	0	0
2	37505414	.	T	C	1	0	1	0	1	2	0	0
2	37508935	.	A	G	2	2	4	0	0	4	0	0
2	37545462	.	A	G	10	9	19	0	0	19	0	0
2	37545473	.	C	G	8	8	16	0	2	18	0	0
2	37545628	.	G	A	8	6	14	0	1	15	0	0
2	37546225	.	T	C	9	1	10	0	12	22	0	0
2	37547874	.	T	C	4	6	10	0	0	10	0	0
2	37554817	.	G	A	5	3	8	0	0	8	0	0
2	37555512	.	A	G	0	1	1	0	0	1	0	0
2	37559306	.	C	T	4	3	7	0	0	7	0	0
2	37559318	.	G	A	3	2	5	0	0	5	0	0
2	37564141	.	G	A	6	1	7	0	0	7	0	0
2	37564375	.	T	A	8	3	11	0	0	11	0	0
2	37566708	.	C	T	4	4	8	0	0	8	0	0
2	37567609	.	A	T	1	3	4	0	0	4	0	0
2	37632100	.	C	T	1	5	6	0	0	6	0	0
2	37632469	.	A	G	2	3	5	0	0	5	0	0
2	37656317	.	A	C	4	4	8	0	0	8	0	0
2	37656372	.	A	G	4	8	12	0	0	12	0	0
2	37664128	.	G	A	0	2	2	0	0	2	0	0
2	37823104	.	C	T	5	13	18	0	0	18	0	0
2	37823663	.	A	G	2	0	2	0	5	7	0	0
2	37824133	.	G	A	5	2	7	0	0	7	0	0
2	37826888	.	T	C	1	2	3	0	0	3	0	0
2	37826908	.	A	G	1	2	3	0	0	3	0	0
2	37826933	.	T	C	3	3	6	0	0	6	0	0
2	37827660	.	C	T	2	3	5	0	1	6	0	0
2	37827977	.	C	T	0	7	7	0	11	18	0	0
2	37830066	.	G	T	3	1	4	0	0	4	0	0
2	37830908	.	G	T	2	2	4	0	0	4	0	0
2	37830922	.	C	T	2	2	4	0	0	4	0	0
2	37831076	.	T	C	0	1	1	0	0	1	0	0
2	37833702	.	A	G	2	2	4	0	0	4	0	0
2	37833708	.	A	T	2	1	3	0	1	4	0	0
2	37833739	.	A	C	2	2	4	0	0	4	0	0
2	37834433	.	T	C	0	1	1	0	0	1	0	0
2	37834703	.	C	T	4	3	7	0	0	7	0	0
2	37840741	.	G	T	1	0	1	0	0	1	0	0
2	37840887	.	G	A	1	1	2	0	0	2	0	0
2	37841270	.	T	C	2	1	3	0	0	3	0	0
2	37841295	.	A	C	2	2	4	0	0	4	0	0
2	37841333	.	T	C	4	3	7	0	1	8	0	0
2	37846286	.	A	G	1	1	2	0	0	2	0	0
2	37846513	.	C	T	1	1	2	0	0	2	0	0
2	37846705	.	C	T	2	4	6	0	0	6	0	0
2	37867148	.	C	T	4	9	13	0	1	14	0	0
2	37867165	.	C	T	0	7	7	0	6	13	0	0
2	37927208	.	G	A	0	1	1	0	1	2	0	0
2	37987009	.	C	T	0	1	1	0	1	2	0	0
2	37990315	.	A	G	4	4	8	0	0	8	0	0
2	38000133	.	G	T	10	9	19	0	0	19	0	0
2	38000185	.	G	A	25	24	49	0	2	51	0	0
2	38008491	.	G	A	4	8	12	0	0	12	0	0
2	38008916	.	C	T	10	5	15	0	0	15	0	0
2	38018076	.	G	A	3	6	9	0	0	9	0	0
2	38027068	.	G	T	3	11	14	0	0	14	0	0
2	38032270	.	G	A	6	7	13	0	1	14	0	0
2	38033937	.	G	A	13	13	26	0	1	27	0	0
2	38033979	.	C	T	8	9	17	0	3	20	0	0
2	38055638	.	G	C	0	4	4	0	0	4	0	0
2	38055662	.	C	G	2	0	2	0	4	6	0	0
2	38056837	.	T	A	0	2	2	0	0	2	0	0
2	38056840	.	A	G	0	0	0	0	2	2	0	0
2	38064638	.	T	C	3	2	5	0	0	5	0	0
2	38064903	.	T	C	4	4	8	0	0	8	0	0
2	38065056	.	G	A	0	9	9	0	5	14	0	0
2	38065095	.	C	T	7	9	16	0	0	16	0	0
2	38065101	.	G	A	0	7	7	0	7	14	0	0
2	38065579	.	C	T	2	3	5	0	0	5	0	0
2	38068593	.	A	G	2	3	5	0	0	5	0	0
2	38068677	.	T	A	5	7	12	0	1	13	0	0
2	38072328	.	T	C	9	7	16	0	3	19	0	0
2	38072460	.	C	T	5	6	11	0	2	13	0	0
2	38072463	.	G	A	6	5	11	0	3	14	0	0
2	38072547	.	C	T	0	6	6	0	12	18	0	0
2	38072670	.	G	T	6	11	17	0	0	17	0	0
2	38072703	.	G	A	10	16	26	0	0	26	0	0
2	38073092	.	A	G	1	0	1	0	0	1	0	0
2	38076425	.	C	T	5	4	9	0	2	11	0	0
2	38076754	.	G	A	3	5	8	0	0	8	0	0
2	38076884	.	A	T	8	3	11	0	0	11	0	0
2	38078188	.	C	T	3	4	7	0	1	8	0	0
2	38078227	.	G	A	3	3	6	0	0	6	0	0
2	38087879	.	T	A	5	5	10	0	0	10	0	0
2	38088096	.	A	T	6	10	16	0	0	16	0	0
2	38088329	.	C	G	4	7	11	0	0	11	0	0
2	38088454	.	A	G	8	10	18	0	1	19	0	0
2	38088475	.	A	G	6	9	15	0	3	18	0	0
2	38088535	.	C	T	9	9	18	0	0	18	0	0
2	38092067	.	G	T	15	5	20	0	0	20	0	0
2	38098442	.	G	A	6	2	8	0	1	9	0	0
2	38098810	.	G	A	6	9	15	0	0	15	0	0
2	38098871	.	C	T	0	4	4	0	5	9	0	0
2	38101590	.	G	A	4	6	10	0	1	11	0	0
2	38101616	.	T	G	2	1	3	0	0	3	0	0
2	38102335	.	A	T	3	6	9	0	1	10	0	0
2	38106744	.	A	G	0	1	1	0	0	1	0	0
2	38109319	.	C	T	0	2	2	0	2	4	0	0
2	38112907	.	T	A	2	3	5	0	1	6	0	0
2	38112917	.	T	C	4	2	6	0	0	6	0	0
2	38112952	.	T	A	3	4	7	0	0	7	0	0
2	38115004	.	T	C	4	4	8	0	1	9	0	0
2	38121433	.	T	C	0	8	8	0	0	8	0	0
2	38121536	.	C	T	16	32	48	0	1	49	0	0
2	38121558	.	C	T	19	34	53	0	1	54	0	0
2	38123931	.	G	T	32	20	52	0	1	53	0	0
2	38124030	.	A	G	19	28	47	0	3	50	0	0
2	38125620	.	A	G	1	3	4	0	0	4	0	0
2	38151134	.	C	T	1	6	7	0	0	7	0	0
2	38151849	.	T	A	6	7	13	0	2	15	0	0
2	38152523	.	C	T	7	5	12	0	0	12	0	0
2	38152717	.	C	T	10	7	17	0	1	18	0	0
2	38153069	.	T	A	4	2	6	0	1	7	0	0
2	38153884	.	C	T	7	8	15	0	0	15	0	0
2	38153929	.	G	A	8	9	17	0	0	17	0	0
2	38154098	.	T	C	5	5	10	0	1	11	0	0
2	38154107	.	G	A	6	4	10	0	0	10	0	0
2	38154177	.	C	A	5	4	9	0	0	9	0	0
2	38154307	.	A	G	9	8	17	0	2	19	0	0
2	38154879	.	A	T	12	10	22	0	1	23	0	0
2	38155339	.	G	C	8	4	12	0	0	12	0	0
2	38155340	.	T	C	4	8	12	0	0	12	0	0
2	38155479	.	G	A	0	10	10	0	5	15	0	0
2	38155511	.	G	A	3	7	10	0	1	11	0	0
2	38155651	.	G	T	2	7	9	0	0	9	0	0
2	38155802	.	C	T	4	8	12	0	0	12	0	0
2	38156165	.	C	T	8	6	14	0	0	14	0	0
2	38174752	.	C	A	0	1	1	0	1	2	0	0
2	38174753	.	A	C	0	2	2	0	0	2	0	0
2	38175455	.	C	A	3	2	5	0	0	5	0	0
2	38181561	.	G	T	0	3	3	0	4	7	0	0
2	38182016	.	C	T	6	3	9	0	1	10	0	0
2	38182867	.	T	A	2	2	4	0	0	4	0	0
2	38198118	.	G	T	23	21	44	0	2	46	0	0
2	38198626	.	C	T	18	23	41	0	1	42	0	0
2	38198627	.	T	G	17	23	40	0	2	42	0	0
2	38199761	.	C	T	2	5	7	1	0	8	0	0
2	38199764	.	G	T	2	4	6	1	0	7	0	0
2	38200181	.	A	G	18	19	37	0	0	37	0	0
2	38200830	.	G	A	3	4	7	0	0	7	0	0
2	38201073	.	T	C	16	0	16	0	12	28	0	0
2	38201864	.	C	A	12	10	22	0	1	23	0	0
2	38202356	.	C	T	10	9	19	0	0	19	0	0
2	38202890	.	C	A	0	1	1	0	0	1	0	0
2	38204025	.	C	A	1	2	3	0	4	7	0	0
2	38204810	.	T	C	1	3	4	0	0	4	0	0
2	38205968	.	A	C	2	0	2	0	5	7	0	0
2	38205997	.	C	T	0	4	4	0	2	6	0	0
2	38213642	.	G	T	9	12	21	0	3	24	0	0
2	38214094	.	C	T	1	22	23	0	21	44	0	0
2	38214102	.	C	T	19	24	43	0	2	45	0	0
2	38214164	.	C	T	27	20	47	0	0	47	0	0
2	38214720	.	C	T	25	17	42	0	4	46	0	0
2	38214974	.	T	G	6	5	11	0	0	11	0	0
2	38215391	.	G	A	21	17	38	0	1	39	0	0
2	38215860	.	C	T	0	18	18	0	22	40	0	0
2	38216481	.	C	T	12	17	29	0	3	32	0	0
2	38216502	.	C	T	14	14	28	0	4	32	0	0
2	38216580	.	T	C	12	13	25	0	0	25	0	0
2	38227332	.	C	A	7	10	17	0	0	17	0	0
2	38261830	.	T	C	1	3	4	0	1	5	0	0
2	38265504	.	G	A	2	2	4	0	0	4	0	0
2	38266439	.	C	T	4	4	8	0	0	8	0	0
2	38269105	.	G	A	2	0	2	0	0	2	0	0
2	38269114	.	T	G	0	2	2	0	0	2	0	0
2	38269355	.	G	A	12	9	21	0	1	22	0	0
2	38269435	.	T	C	1	3	4	0	0	4	0	0
2	38269446	.	A	T	1	2	3	0	1	4	0	0
2	38289260	.	G	A	15	16	31	0	1	32	0	0
2	38289393	.	C	T	13	10	23	0	0	23	0	0
2	38289494	.	T	A	9	7	16	0	1	17	0	0
2	38289496	.	A	G	9	1	10	0	7	17	0	0
2	38289633	.	G	A	1	6	7	0	1	8	0	0
2	38373380	.	T	C	20	17	37	0	1	38	0	0
2	38378888	.	T	A	4	2	6	0	0	6	0	0
2	38391846	.	T	C	8	15	23	0	1	24	0	0
2	38391847	.	T	C	9	15	24	0	0	24	0	0
2	38391945	.	C	T	24	19	43	0	2	45	0	0
2	38556203	.	C	A	3	3	6	0	1	7	0	0
2	38687004	.	T	C	0	2	2	0	0	2	0	0
2	38689219	.	C	T	3	1	4	0	0	4	0	0
2	38695337	.	C	T	3	5	8	0	1	9	0	0
2	38699469	.	C	T	4	9	13	0	0	13	0	0
2	38699526	.	G	A	4	5	9	0	0	9	0	0
2	38708714	.	A	T	9	12	21	0	0	21	0	0
2	38708744	.	C	T	11	12	23	0	1	24	0	0
2	38708780	.	T	A	12	12	24	0	0	24	0	0
2	38796192	.	C	T	0	1	1	0	0	1	0	0
2	38804272	.	T	C	2	1	3	0	0	3	0	0
2	38847349	.	C	T	0	2	2	0	0	2	0	0
2	38880942	.	C	T	5	10	15	0	1	16	0	0
2	38880999	.	G	A	9	5	14	0	0	14	0	0
2	38887527	.	A	G	8	3	11	0	1	12	0	0
2	38887772	.	C	A	6	7	13	0	0	13	0	0
2	38887932	.	G	C	4	4	8	0	0	8	0	0
2	38888057	.	T	C	6	2	8	0	1	9	0	0
2	38888157	.	T	A	3	6	9	0	1	10	0	0
2	38888170	.	T	C	8	4	12	0	0	12	0	0
2	38888235	.	A	G	6	8	14	0	0	14	0	0
2	38888272	.	T	C	10	6	16	0	0	16	0	0
2	38888517	.	A	C	6	7	13	0	1	14	0	0
2	38888710	.	G	A	0	5	5	0	1	6	0	0
2	38888789	.	C	T	3	3	6	0	2	8	0	0
2	38888820	.	A	C	3	5	8	0	0	8	0	0
2	38888895	.	T	C	1	7	8	0	0	8	0	0
2	38889034	.	A	G	1	2	3	0	0	3	0	0
2	38889067	.	A	T	3	0	3	0	1	4	0	0
2	38889369	.	A	G	7	0	7	0	7	14	0	0
2	38889389	.	G	T	9	7	16	0	0	16	0	0
2	38889487	.	A	G	10	0	10	0	10	20	0	0
2	38889523	.	G	C	2	7	9	0	11	20	0	0
2	38890481	.	T	C	6	6	12	0	2	14	0	0
2	38890495	.	C	A	4	7	11	0	0	11	0	0
2	38926665	.	C	G	3	5	8	0	0	8	0	0
2	38926780	.	A	C	2	8	10	0	1	11	0	0
2	38926787	.	T	C	3	4	7	0	0	7	0	0
2	38977157	.	G	A	4	3	7	0	0	7	0	0
2	38977159	.	T	C	4	3	7	0	0	7	0	0
2	38977266	.	C	A	3	4	7	0	0	7	0	0
2	38977269	.	A	G	3	4	7	0	0	7	0	0
2	38997627	.	G	T	19	14	33	0	1	34	0	0
2	38997631	.	A	G	20	14	34	0	1	35	0	0
2	38998100	.	G	T	21	17	38	0	0	38	0	0
2	39001713	.	G	A	0	3	3	0	0	3	0	0
2	39001975	.	A	G	3	5	8	0	1	9	0	0
2	39001993	.	G	T	8	8	16	0	0	16	0	0
2	39002038	.	G	A	21	9	30	0	0	30	0	0
2	39002164	.	C	T	0	0	0	0	1	1	0	0
2	39002546	.	G	C	11	9	20	0	0	20	0	0
2	39002692	.	T	C	3	1	4	0	0	4	0	0
2	39005438	.	C	T	1	3	4	0	0	4	0	0
2	39011421	.	T	A	1	1	2	0	0	2	0	0
2	39013488	.	T	C	0	0	0	0	2	2	0	0
2	39013572	.	A	T	4	3	7	0	0	7	0	0
2	39015083	.	G	A	6	5	11	0	0	11	0	0
2	39015094	.	A	G	3	4	7	0	0	7	0	0
2	39028379	.	T	G	2	3	5	0	1	6	0	0
2	39028570	.	G	T	3	4	7	0	1	8	0	0
2	39028695	.	A	G	8	3	11	0	0	11	0	0
2	39028774	.	G	T	8	5	13	0	0	13	0	0
2	39028811	.	G	T	6	2	8	0	0	8	0	0
2	39036516	.	G	T	4	11	15	0	0	15	0	0
2	39036615	.	C	A	3	3	6	0	0	6	0	0
2	39068306	.	T	A	3	1	4	0	0	4	0	0
2	39068335	.	C	T	2	4	6	0	0	6	0	0
2	39068365	.	C	T	6	5	11	0	0	11	0	0
2	39068409	.	C	A	6	5	11	0	0	11	0	0
2	39386628	.	G	A	1	1	2	0	0	2	0	0
2	39386670	.	A	G	1	0	1	0	3	4	0	0
2	39394003	.	G	A	0	3	3	0	2	5	0	0
2	39498061	.	A	G	5	4	9	0	0	9	0	0
2	39506808	.	T	G	4	0	4	0	1	5	0	0
2	39532346	.	C	A	3	3	6	0	0	6	0	0
2	39549297	.	A	C	10	3	13	1	0	14	0	0
2	39549505	.	G	A	0	3	3	0	5	8	0	0
2	39549510	.	C	A	5	2	7	0	0	7	0	0
2	39549600	.	G	A	1	2	3	0	0	3	0	0
2	39549780	.	C	T	2	6	8	0	0	8	0	0
2	39549898	.	A	G	4	6	10	0	0	10	0	0
2	39550380	.	A	C	3	4	7	1	0	8	0	0
2	39550494	.	C	T	3	6	9	0	0	9	0	0
2	39550627	.	G	A	5	3	8	0	0	8	0	0
2	39550677	.	T	C	4	3	7	0	0	7	0	0
2	39550755	.	C	T	5	5	10	0	0	10	0	0
2	39550761	.	A	C	5	4	9	0	0	9	0	0
2	39550854	.	G	A	0	9	9	0	7	16	0	0
2	39550901	.	C	T	2	6	8	0	0	8	0	0
2	39551023	.	T	C	4	3	7	0	0	7	0	0
2	39551185	.	T	C	3	11	14	0	0	14	0	0
2	39551213	.	G	A	0	6	6	0	6	12	0	0
2	39551238	.	C	T	6	4	10	0	0	10	0	0
2	39551469	.	A	G	3	3	6	0	0	6	0	0
2	39551581	.	C	G	2	3	5	0	0	5	0	0
2	39551869	.	T	G	2	2	4	0	0	4	0	0
2	39552101	.	C	T	2	3	5	0	1	6	0	0
2	39553213	.	A	G	7	3	10	0	1	11	0	0
2	39553279	.	G	A	6	8	14	0	1	15	0	0
2	39553283	.	A	T	8	6	14	0	1	15	0	0
2	39553351	.	G	A	5	4	9	0	3	12	0	0
2	39554098	.	A	C	5	3	8	0	1	9	0	0
2	39554514	.	A	C	7	9	16	0	0	16	0	0
2	39555273	.	A	G	8	7	15	0	2	17	0	0
2	39584287	.	A	T	2	5	7	0	0	7	0	0
2	39584370	.	T	C	2	0	2	0	2	4	0	0
2	39585130	.	G	A	1	2	3	0	0	3	0	0
2	39649553	.	G	A	5	3	8	0	0	8	0	0
2	39649589	.	C	T	7	3	10	0	0	10	0	0
2	39649592	.	C	T	3	6	9	0	0	9	0	0
2	39649655	.	G	C	3	1	4	0	6	10	0	0
2	39649673	.	C	T	6	3	9	0	1	10	0	0
2	39649799	.	C	T	9	5	14	0	1	15	0	0
2	39650108	.	T	C	7	4	11	0	0	11	0	0
2	39650191	.	T	C	3	5	8	0	3	11	0	0
2	39731567	.	C	T	20	11	31	0	2	33	0	0
2	39732139	.	C	A	14	11	25	0	1	26	0	0
2	39732157	.	G	A	9	10	19	0	2	21	0	0
2	39732710	.	T	C	9	4	13	0	0	13	0	0
2	39732743	.	T	C	2	0	2	0	7	9	0	0
2	39732767	.	A	G	3	4	7	0	0	7	0	0
2	39732818	.	C	T	0	5	5	0	5	10	0	0
2	39732833	.	G	A	4	7	11	0	1	12	0	0
2	39732955	.	A	G	7	10	17	0	0	17	0	0
2	39732967	.	T	G	8	11	19	0	1	20	0	0
2	39733130	.	T	A	17	10	27	0	2	29	0	0
2	39733437	.	T	A	5	2	7	0	1	8	0	0
2	39733531	.	C	T	11	14	25	0	0	25	0	0
2	39733903	.	T	A	9	4	13	0	1	14	0	0
2	39734298	.	A	G	11	11	22	0	0	22	0	0
2	39734396	.	G	A	10	19	29	0	1	30	0	0
2	39734410	.	A	T	9	17	26	0	0	26	0	0
2	39734444	.	A	G	13	23	36	0	0	36	0	0
2	39734494	.	T	A	20	21	41	0	1	42	0	0
2	39735568	.	T	C	2	0	2	0	3	5	0	0
2	39753775	.	C	A	0	3	3	0	2	5	0	0
2	39758810	.	A	C	5	1	6	0	2	8	0	0
2	39759009	.	G	A	5	7	12	0	0	12	0	0
2	39759044	.	A	G	2	2	4	0	0	4	0	0
2	40067983	.	A	G	4	6	10	0	2	12	0	0
2	40068188	.	C	T	23	24	47	0	2	49	0	0
2	40068238	.	G	A	15	26	41	0	1	42	0	0
2	40068279	.	G	A	14	21	35	0	2	37	0	0
2	40068281	.	T	G	12	22	34	0	3	37	0	0
2	40068372	.	G	A	17	15	32	0	3	35	0	0
2	40068386	.	G	A	19	19	38	0	1	39	0	0
2	40069392	.	G	A	16	15	31	0	1	32	0	0
2	40070040	.	A	G	8	8	16	0	0	16	0	0
2	40074474	.	G	A	3	6	9	0	0	9	0	0
2	40088719	.	G	A	4	3	7	0	0	7	0	0
2	40088785	.	G	A	3	0	3	0	0	3	0	0
2	40090490	.	C	T	11	12	23	0	1	24	0	0
2	40094202	.	A	T	10	7	17	0	0	17	0	0
2	40094217	.	G	C	10	10	20	0	0	20	0	0
2	40100281	.	G	A	2	1	3	0	0	3	0	0
2	40131941	.	G	C	5	5	10	0	0	10	0	0
2	40132034	.	C	T	5	7	12	0	1	13	0	0
2	40135884	.	G	A	5	4	9	0	0	9	0	0
2	40342644	.	T	C	3	5	8	0	1	9	0	0
2	40342776	.	T	C	5	5	10	0	0	10	0	0
2	40343124	.	G	A	1	3	4	0	0	4	0	0
2	40407135	.	A	G	7	2	9	0	0	9	0	0
2	40412057	.	C	A	10	3	13	0	1	14	0	0
2	40500542	.	T	C	3	5	8	0	0	8	0	0
2	40500596	.	T	C	0	2	2	0	0	2	0	0
2	40507030	.	T	C	3	6	9	0	1	10	0	0
2	40507060	.	A	G	10	5	15	0	0	15	0	0
2	40513998	.	C	T	4	6	10	0	1	11	0	0
2	40830967	.	T	C	5	3	8	0	0	8	0	0
2	40831047	.	A	G	9	5	14	0	0	14	0	0
2	40831103	.	T	C	4	0	4	0	5	9	0	0
2	40831119	.	C	A	3	4	7	0	0	7	0	0
2	40831176	.	A	T	4	3	7	0	0	7	0	0
2	40831197	.	C	T	0	3	3	0	4	7	0	0
2	40831220	.	C	T	4	4	8	0	0	8	0	0
2	40831568	.	G	A	4	4	8	0	0	8	0	0
2	40831728	.	T	C	3	6	9	0	1	10	0	0
2	40831797	.	C	T	7	3	10	0	0	10	0	0
2	40831822	.	T	A	4	6	10	0	1	11	0	0
2	40832412	.	T	A	3	2	5	0	0	5	0	0
2	40832416	.	A	G	3	2	5	0	1	6	0	0
2	40832457	.	A	T	2	5	7	0	0	7	0	0
2	40832537	.	T	A	2	4	6	0	0	6	0	0
2	40832596	.	C	T	3	2	5	0	0	5	0	0
2	40833032	.	C	T	0	3	3	0	3	6	0	0
2	40833063	.	A	G	5	3	8	0	1	9	0	0
2	40833068	.	A	G	5	3	8	0	0	8	0	0
2	40834944	.	A	G	2	3	5	0	0	5	0	0
2	40902411	.	A	G	5	3	8	0	0	8	0	0
2	41524321	.	A	G	5	5	10	0	0	10	0	0
2	41532745	.	A	G	1	1	2	0	0	2	0	0
2	41532746	.	A	G	1	1	2	0	0	2	0	0
2	41537384	.	T	G	8	0	8	0	5	13	0	0
2	41539251	.	G	A	0	2	2	0	2	4	0	0
2	41542080	.	T	G	14	14	28	0	0	28	0	0
2	41542451	.	T	C	10	6	16	0	0	16	0	0
2	41542601	.	G	A	14	13	27	0	2	29	0	0
2	41542637	.	A	G	10	0	10	0	11	21	0	0
2	41549678	.	G	A	3	1	4	0	0	4	0	0
2	41552916	.	A	G	1	1	2	0	0	2	0	0
2	41558407	.	T	C	3	2	5	0	0	5	0	0
2	41563610	.	T	C	6	6	12	0	0	12	0	0
2	41563612	.	A	C	6	6	12	0	0	12	0	0
2	41563686	.	T	G	7	8	15	0	1	17	1	0
2	41563689	.	G	A	8	8	16	0	0	16	0	0
2	41566463	.	T	C	7	9	16	0	2	18	0	0
2	41566770	.	T	G	7	10	17	0	0	17	0	0
2	41566852	.	C	T	3	4	7	0	0	7	0	0
2	41569177	.	T	C	5	15	20	0	1	21	0	0
2	41578181	.	A	T	9	22	31	0	2	33	0	0
2	41578281	.	C	T	8	13	21	0	5	27	1	0
2	41578656	.	C	A	9	6	15	0	1	16	0	0
2	41578716	.	T	A	8	2	10	0	0	10	0	0
2	41578921	.	C	T	4	6	10	0	1	11	0	0
2	41579222	.	T	C	5	5	10	0	0	10	0	0
2	41579265	.	A	C	4	0	4	0	2	6	0	0
2	41579539	.	C	G	1	3	4	0	3	7	0	0
2	41579572	.	C	G	6	3	9	0	0	9	0	0
2	41579701	.	G	C	7	6	13	0	0	13	0	0
2	41579804	.	T	C	15	12	27	0	2	29	0	0
2	41579952	.	C	A	6	11	17	0	0	17	0	0
2	41579984	.	A	G	7	11	18	0	0	18	0	0
2	41580004	.	C	A	6	10	16	0	1	17	0	0
2	41580028	.	T	C	5	6	11	0	0	11	0	0
2	41580125	.	C	T	9	5	14	0	1	15	0	0
2	41580263	.	T	A	10	11	21	0	0	21	0	0
2	41580473	.	C	T	0	7	7	0	13	20	0	0
2	41580522	.	G	A	5	4	9	0	1	10	0	0
2	41580546	.	A	G	7	6	13	0	1	14	0	0
2	41580715	.	C	T	0	13	13	0	10	23	0	0
2	41580832	.	G	T	7	9	16	0	1	17	0	0
2	41580897	.	T	C	2	7	9	0	0	9	0	0
2	41580946	.	A	C	11	9	20	0	0	20	0	0
2	41580966	.	T	C	11	7	18	0	1	19	0	0
2	41581815	.	T	A	12	12	24	0	2	26	0	0
2	41581998	.	G	T	9	15	24	0	1	25	0	0
2	41582136	.	G	A	10	7	17	0	0	17	0	0
2	41582383	.	A	C	8	6	14	0	0	14	0	0
2	41582801	.	T	C	4	6	10	0	1	11	0	0
2	41582805	.	C	T	4	6	10	0	1	11	0	0
2	41582923	.	C	T	5	5	10	0	0	10	0	0
2	41583007	.	A	G	7	9	16	0	1	17	0	0
2	41583043	.	A	G	11	8	19	0	1	20	0	0
2	41583171	.	C	T	0	8	8	0	3	11	0	0
2	41585878	.	A	G	0	1	1	0	0	1	0	0
2	41599247	.	G	A	0	1	1	0	0	1	0	0
2	41620101	.	A	T	1	0	1	0	1	2	0	0
2	42021468	.	T	C	1	2	3	0	0	3	0	0
2	42039046	.	G	A	2	4	6	0	0	6	0	0
2	42039297	.	C	G	0	8	8	0	4	12	0	0
2	42049030	.	G	C	4	3	7	0	1	8	0	0
2	42049795	.	T	A	4	5	9	0	0	9	0	0
2	42049797	.	T	G	4	5	9	0	0	9	0	0
2	42051071	.	G	A	0	1	1	0	0	1	0	0
2	42063897	.	C	T	0	1	1	0	1	2	0	0
2	42068217	.	T	G	0	1	1	0	0	1	0	0
2	42071276	.	A	T	2	3	5	0	0	5	0	0
2	42073030	.	T	C	4	2	6	0	0	6	0	0
2	42073261	.	G	A	1	3	4	0	0	4	0	0
2	42073519	.	T	G	3	2	5	0	0	5	0	0
2	42073543	.	A	G	1	0	1	0	2	3	0	0
2	42074419	.	A	G	1	0	1	0	2	3	0	0
2	42074485	.	C	T	5	4	9	0	0	9	0	0
2	42074515	.	G	A	6	4	10	0	0	10	0	0
2	42074671	.	C	G	4	5	9	0	0	9	0	0
2	42075103	.	T	G	2	0	2	0	4	6	0	0
2	42075106	.	G	T	0	4	4	0	2	6	0	0
2	42075160	.	C	T	2	2	4	0	0	4	0	0
2	42081425	.	T	C	6	3	9	0	0	9	0	0
2	42143931	.	A	G	3	0	3	0	2	5	0	0
2	42143975	.	G	A	0	2	2	0	1	3	0	0
2	42144004	.	T	C	0	1	1	0	1	2	0	0
2	42146976	.	G	A	0	1	1	0	0	1	0	0
2	42149748	.	A	C	1	2	3	0	0	3	0	0
2	42156579	.	A	G	13	15	28	0	1	29	0	0
2	42156637	.	G	A	14	18	32	0	2	34	0	0
2	42158839	.	C	T	9	6	15	0	0	15	0	0
2	42159159	.	G	T	1	4	5	0	0	5	0	0
2	42161309	.	A	G	22	20	42	0	0	42	0	0
2	42161351	.	C	T	21	17	38	0	0	38	0	0
2	42168496	.	G	A	11	22	33	0	1	34	0	0
2	42168505	.	A	T	9	20	29	0	1	30	0	0
2	42176962	.	T	C	3	13	16	0	1	17	0	0
2	42177056	.	C	T	8	12	20	0	0	20	0	0
2	42177075	.	G	A	8	11	19	0	1	20	0	0
2	42179607	.	C	A	0	0	0	0	1	1	0	0
2	42179675	.	A	G	5	0	5	0	3	8	0	0
2	42182051	.	T	A	2	6	8	0	0	8	0	0
2	42182089	.	A	G	2	6	8	0	0	8	0	0
2	42184056	.	T	G	2	1	3	0	0	3	0	0
2	42200453	.	C	A	3	4	7	0	0	7	0	0
2	42200520	.	G	T	3	8	11	0	0	11	0	0
2	42202043	.	T	C	4	6	10	0	0	10	0	0
2	42206954	.	A	G	1	4	5	0	0	5	0	0
2	42210431	.	G	T	2	6	8	0	0	8	0	0
2	42210486	.	C	T	1	6	7	0	0	7	0	0
2	42220876	.	C	T	0	2	2	0	0	2	0	0
2	42220887	.	C	T	0	1	1	0	0	1	0	0
2	42221346	.	T	G	3	3	6	0	0	6	0	0
2	42224171	.	G	T	0	2	2	0	4	6	0	0
2	42224255	.	G	A	5	5	10	0	0	10	0	0
2	42224315	.	C	T	3	4	7	0	1	8	0	0
2	42224455	.	C	T	2	8	10	0	0	10	0	0
2	42224535	.	T	G	3	9	12	0	0	12	0	0
2	42224544	.	C	A	3	9	12	0	0	12	0	0
2	42224628	.	C	A	1	6	7	0	0	7	0	0
2	42224629	.	A	G	1	6	7	0	0	7	0	0
2	42355076	.	T	A	3	2	5	0	0	5	0	0
2	42355086	.	A	G	1	1	2	0	0	2	0	0
2	42355132	.	C	T	2	2	4	0	0	4	0	0
2	42360123	.	C	T	3	2	5	0	0	5	0	0
2	42360162	.	C	T	0	2	2	0	4	6	0	0
2	42361415	.	T	C	2	7	9	0	0	9	0	0
2	42361517	.	C	A	5	9	14	0	0	14	0	0
2	42361616	.	T	A	4	13	17	0	0	17	0	0
2	42361790	.	C	T	7	4	11	0	0	11	0	0
2	42373646	.	G	T	17	18	35	0	0	35	0	0
2	42374218	.	G	A	13	9	22	0	1	23	0	0
2	42374455	.	T	A	20	19	39	0	0	40	1	0
2	42382574	.	G	A	4	3	7	0	1	8	0	0
2	42382609	.	G	T	6	2	8	0	1	9	0	0
2	42382670	.	G	A	8	5	13	0	2	15	0	0
2	42382687	.	C	G	8	3	11	0	0	11	0	0
2	42382744	.	T	C	7	10	17	0	0	17	0	0
2	42382905	.	T	A	15	14	29	0	0	29	0	0
2	42383032	.	A	G	10	9	19	0	1	20	0	0
2	42383064	.	C	T	0	11	11	0	10	21	0	0
2	42383071	.	T	C	10	8	18	0	1	19	0	0
2	42383209	.	A	G	11	8	19	0	0	19	0	0
2	42383227	.	T	G	12	8	20	0	1	21	0	0
2	42383263	.	A	G	20	14	34	0	0	34	0	0
2	42383327	.	G	A	16	13	29	0	2	31	0	0
2	42383757	.	A	C	21	15	36	0	2	38	0	0
2	42383768	.	A	G	26	13	39	0	0	39	0	0
2	42383947	.	C	A	18	8	26	0	3	29	0	0
2	42384313	.	A	G	11	11	22	0	5	27	0	0
2	42384338	.	C	A	14	11	25	0	0	25	0	0
2	42384365	.	T	G	9	11	20	0	2	22	0	0
2	42384382	.	C	T	8	13	21	0	1	22	0	0
2	42384587	.	C	A	11	9	20	0	2	22	0	0
2	42384588	.	A	G	10	11	21	0	1	22	0	0
2	42384637	.	G	A	17	7	24	0	1	25	0	0
2	42384699	.	A	C	18	13	31	0	1	32	0	0
2	42384961	.	T	G	10	8	18	0	1	19	0	0
2	42385022	.	T	C	11	9	20	0	1	21	0	0
2	42385023	.	T	C	11	10	21	0	0	21	0	0
2	42385447	.	C	G	0	6	6	0	9	15	0	0
2	42385498	.	T	C	10	0	10	0	8	18	0	0
2	42388272	.	G	A	0	2	2	0	2	4	0	0
2	42388341	.	A	G	8	4	12	0	1	13	0	0
2	42391328	.	C	T	2	5	7	0	0	7	0	0
2	42393550	.	C	T	0	2	2	0	4	6	0	0
2	42396218	.	A	G	3	2	5	0	1	6	0	0
2	42401362	.	G	C	24	22	46	0	0	46	0	0
2	42415745	.	G	A	17	19	36	0	2	38	0	0
2	42415798	.	G	A	12	16	28	0	1	29	0	0
2	42420100	.	T	A	4	4	8	0	0	8	0	0
2	42420166	.	A	C	1	0	1	0	3	4	0	0
2	42420175	.	C	T	0	3	3	0	0	3	0	0
2	42420430	.	T	A	6	5	11	0	1	12	0	0
2	42420542	.	G	A	6	4	10	0	0	10	0	0
2	42420933	.	C	T	1	2	3	0	1	4	0	0
2	42421884	.	T	C	3	2	5	0	0	5	0	0
2	42421888	.	T	A	2	2	4	0	1	5	0	0
2	42422067	.	T	C	1	2	3	0	0	3	0	0
2	42424988	.	C	T	0	1	1	0	0	1	0	0
2	42425049	.	T	C	2	3	5	0	0	5	0	0
2	42425052	.	T	G	1	2	3	0	1	4	0	0
2	42425255	.	T	C	2	0	2	0	1	3	0	0
2	42431924	.	A	C	0	1	1	0	0	1	0	0
2	42432200	.	T	A	2	4	6	0	0	6	0	0
2	42433689	.	A	T	0	2	2	0	0	2	0	0
2	42501860	.	G	A	7	7	14	0	0	14	0	0
2	42504589	.	G	C	0	1	1	0	0	1	0	0
2	42508957	.	G	A	11	4	15	0	0	15	0	0
2	42508987	.	C	A	13	4	17	0	1	18	0	0
2	42510637	.	G	A	3	5	8	0	0	8	0	0
2	42510664	.	G	A	4	6	10	0	0	10	0	0
2	42511435	.	C	T	2	2	4	0	0	4	0	0
2	42511464	.	T	G	1	2	3	0	0	3	0	0
2	42511681	.	T	C	1	1	2	0	1	3	0	0
2	42517602	.	G	A	1	6	7	0	0	7	0	0
2	42519767	.	G	A	0	4	4	0	2	6	0	0
2	42519897	.	T	C	3	1	4	0	0	4	0	0
2	42526893	.	A	G	6	3	9	0	1	10	0	0
2	42526931	.	G	A	3	1	4	0	0	4	0	0
2	42530463	.	G	A	1	1	2	0	0	2	0	0
2	42542024	.	T	C	4	6	10	0	0	10	0	0
2	42550602	.	C	T	3	1	4	0	3	7	0	0
2	42552653	.	G	A	0	2	2	0	0	2	0	0
2	42592887	.	G	A	3	2	5	0	0	5	0	0
2	42597981	.	G	A	0	4	4	0	2	6	0	0
2	42599962	.	C	G	3	3	6	0	0	6	0	0
2	42600044	.	T	C	3	2	5	0	1	6	0	0
2	42609479	.	A	G	5	3	8	0	1	9	0	0
2	42609689	.	T	G	5	2	7	0	0	7	0	0
2	42624732	.	A	G	2	3	5	0	0	5	0	0
2	42746504	.	G	C	26	41	67	0	2	69	0	0
2	42746530	.	G	T	7	44	51	0	26	77	0	0
2	42746604	.	C	T	30	35	65	0	2	67	0	0
2	42746833	.	C	T	43	27	70	0	2	72	0	0
2	42747069	.	G	T	31	35	66	0	0	66	0	0
2	42747389	.	T	C	26	15	41	0	12	53	0	0
2	42748186	.	A	T	20	22	42	1	11	54	0	0
2	42748211	.	A	G	30	37	67	0	4	71	0	0
2	42748257	.	G	C	32	28	60	1	0	61	0	0
2	42776527	.	A	G	8	10	18	0	5	23	0	0
2	42776569	.	A	G	12	11	23	0	3	26	0	0
2	42776683	.	A	G	6	7	13	0	0	13	0	0
2	42780597	.	T	A	2	2	4	0	0	4	0	0
2	42780657	.	T	C	1	3	4	0	0	4	0	0
2	42814888	.	A	G	4	4	8	0	1	9	0	0
2	42814928	.	A	G	9	9	18	0	1	19	0	0
2	42817384	.	G	T	10	8	18	0	0	18	0	0
2	42817462	.	A	T	9	3	12	0	0	12	0	0
2	42864455	.	A	G	2	2	4	0	0	4	0	0
2	42872714	.	C	A	0	2	2	0	0	2	0	0
2	42925153	.	G	A	1	2	3	0	0	3	0	0
2	42926064	.	A	C	1	3	4	0	0	4	0	0
2	42930540	.	A	C	1	3	4	0	0	4	0	0
2	43004419	.	T	C	1	0	1	0	1	2	0	0
2	43005260	.	T	A	1	1	2	0	0	2	0	0
2	43027530	.	A	G	3	1	4	0	0	4	0	0
2	43082195	.	G	A	0	0	0	0	1	1	0	0
2	43082608	.	G	A	2	0	2	0	0	2	0	0
2	43111833	.	A	T	1	0	1	0	0	1	0	0
2	43113478	.	T	C	1	0	1	0	0	1	0	0
2	43159217	.	T	G	8	12	20	0	1	21	0	0
2	43159293	.	G	A	12	4	16	1	0	17	0	0
2	43159302	.	A	C	14	4	18	1	0	19	0	0
2	43159500	.	G	A	7	5	12	0	1	13	0	0
2	43159613	.	A	G	5	6	11	0	1	12	0	0
2	43159781	.	A	G	13	5	18	0	2	20	0	0
2	43159868	.	T	C	1	2	3	0	0	3	0	0
2	43163958	.	T	C	7	0	7	0	5	12	0	0
2	43168096	.	T	C	1	1	2	0	0	2	0	0
2	43168123	.	A	G	5	3	8	0	0	8	0	0
2	43255020	.	T	C	1	1	2	0	0	2	0	0
2	43255059	.	A	G	0	0	0	0	1	1	0	0
2	43279591	.	A	G	1	2	3	0	0	3	0	0
2	43329280	.	T	C	1	3	4	0	0	4	0	0
2	43329425	.	A	G	1	0	1	0	0	1	0	0
2	43493466	.	G	C	0	2	2	0	4	6	0	0
2	43505035	.	C	T	2	1	3	0	0	3	0	0
2	43507219	.	G	A	0	3	3	0	2	5	0	0
2	43507275	.	A	G	0	2	2	0	0	2	0	0
2	43513660	.	G	A	2	2	4	0	1	5	0	0
2	43516460	.	T	C	2	4	6	0	0	6	0	0
2	43583558	.	G	A	1	0	1	0	0	1	0	0
2	43586793	.	A	C	7	16	23	0	0	23	0	0
2	43587478	.	A	T	10	7	17	0	0	17	0	0
2	43589691	.	C	G	1	1	2	0	0	2	0	0
2	43589856	.	T	C	15	13	28	0	0	28	0	0
2	43590136	.	A	T	4	1	5	0	0	5	0	0
2	43593210	.	C	T	0	10	10	0	18	28	0	0
2	43593651	.	T	C	0	4	4	0	0	4	0	0
2	43593696	.	T	G	1	11	12	0	1	13	0	0
2	43714362	.	A	G	0	1	1	0	0	1	0	0
2	43723092	.	C	T	3	0	3	0	0	3	0	0
2	43739287	.	T	C	8	8	16	0	2	18	0	0
2	43739401	.	G	C	8	8	16	0	1	17	0	0
2	43787827	.	A	G	0	2	2	0	0	2	0	0
2	43795117	.	G	A	2	4	6	0	0	6	0	0
2	43796290	.	A	C	3	2	5	0	0	5	0	0
2	43796756	.	G	A	0	4	4	0	7	11	0	0
2	43807356	.	G	A	1	5	6	0	0	6	0	0
2	43807536	.	A	G	7	12	19	0	2	21	0	0
2	43807566	.	T	G	6	10	16	0	0	16	0	0
2	43813088	.	A	G	4	6	10	0	0	10	0	0
2	43813193	.	G	A	5	3	8	0	0	8	0	0
2	43816952	.	G	T	5	6	11	0	0	11	0	0
2	43817247	.	C	T	1	3	4	0	1	5	0	0
2	43817303	.	C	T	4	4	8	0	0	8	0	0
2	43817593	.	C	T	5	8	13	0	1	14	0	0
2	43817760	.	A	C	6	7	13	0	1	14	0	0
2	43817826	.	C	T	0	5	5	0	6	11	0	0
2	43817875	.	T	G	5	6	11	0	0	11	0	0
2	43826043	.	A	C	5	0	5	0	5	10	0	0
2	43962071	.	C	G	9	7	16	0	1	17	0	0
2	43962108	.	C	A	1	8	9	0	6	15	0	0
2	43962242	.	T	A	6	6	12	0	2	14	0	0
2	43962279	.	C	T	8	8	16	0	1	17	0	0
2	43962328	.	T	A	5	11	16	0	0	16	0	0
2	43962483	.	T	A	6	7	13	0	0	13	0	0
2	43962600	.	C	T	4	5	9	0	0	9	0	0
2	43962864	.	C	T	0	8	8	0	8	16	0	0
2	43962983	.	T	C	8	16	24	0	0	24	0	0
2	43963097	.	G	C	7	12	19	0	1	20	0	0
2	43963136	.	C	T	0	12	12	0	7	19	0	0
2	43963163	.	C	T	0	9	9	0	8	17	0	0
2	43963202	.	T	C	11	0	11	0	9	20	0	0
2	43963454	.	A	T	9	12	21	0	2	23	0	0
2	43963493	.	A	G	9	11	20	0	0	20	0	0
2	43976333	.	C	A	6	4	10	0	0	10	0	0
2	43976339	.	T	C	4	0	4	0	3	7	0	0
2	43983668	.	T	A	1	2	3	0	0	3	0	0
2	43987317	.	G	A	2	2	4	0	0	4	0	0
2	44082542	.	G	A	4	4	8	0	1	9	0	0
2	44183301	.	G	A	4	3	7	0	0	7	0	0
2	44192871	.	T	C	16	20	36	0	1	37	0	0
2	44192893	.	T	C	21	17	38	0	1	39	0	0
2	44193029	.	T	A	3	0	3	0	0	3	0	0
2	44193742	.	C	T	0	11	11	0	13	24	0	0
2	44193769	.	T	G	5	4	9	0	0	9	0	0
2	44199761	.	G	C	2	0	2	0	2	4	0	0
2	44199776	.	T	G	2	2	4	0	0	4	0	0
2	44259855	.	G	A	28	46	74	0	3	77	0	0
2	44260002	.	C	T	39	47	86	0	4	90	0	0
2	44260088	.	A	G	29	33	62	0	7	69	0	0
2	44260100	.	A	T	31	36	67	0	1	68	0	0
2	44260358	.	G	A	33	40	73	0	12	85	0	0
2	44260836	.	T	C	41	3	44	0	25	69	0	0
2	44261028	.	A	G	27	39	66	0	3	69	0	0
2	44263025	.	G	A	12	7	19	0	0	19	0	0
2	44263063	.	T	C	6	7	13	0	0	13	0	0
2	44263068	.	C	T	6	7	13	0	1	14	0	0
2	44276731	.	A	G	32	26	58	0	4	62	0	0
2	44304374	.	A	G	0	1	1	0	0	1	0	0
2	44304386	.	T	C	2	3	5	0	0	5	0	0
2	44304485	.	G	C	2	0	2	0	8	10	0	0
2	44304515	.	T	C	0	1	1	0	0	1	0	0
2	44312641	.	G	A	0	1	1	0	1	2	0	0
2	44327877	.	C	T	0	2	2	0	0	2	0	0
2	44328056	.	A	G	0	2	2	0	0	2	0	0
2	44331020	.	T	C	2	2	4	0	0	4	0	0
2	44333396	.	G	A	0	2	2	0	0	2	0	0
2	44338569	.	T	C	2	2	4	0	0	4	0	0
2	44338973	.	G	T	1	0	1	0	0	1	0	0
2	44339189	.	C	A	1	1	2	0	0	2	0	0
2	44340566	.	G	A	2	3	5	0	0	5	0	0
2	44340568	.	A	T	2	3	5	0	0	5	0	0
2	44340602	.	T	C	1	2	3	0	0	3	0	0
2	44340788	.	C	T	1	1	2	0	0	2	0	0
2	44383457	.	A	G	11	6	17	0	1	18	0	0
2	44398551	.	A	C	10	13	23	0	2	25	0	0
2	44398611	.	A	T	3	2	5	0	1	6	0	0
2	44406091	.	C	T	2	2	4	0	0	4	0	0
2	44484882	.	T	C	4	4	8	0	0	8	0	0
2	44508273	.	A	G	1	2	3	0	0	3	0	0
2	44509873	.	T	C	10	5	15	0	0	15	0	0
2	44510073	.	T	C	11	15	26	0	0	26	0	0
2	44510263	.	T	A	4	4	8	0	0	8	0	0
2	44510273	.	T	G	4	4	8	0	0	8	0	0
2	44510506	.	A	G	4	0	4	0	4	8	0	0
2	44510569	.	T	C	5	4	9	0	0	9	0	0
2	44510596	.	A	G	3	4	7	0	0	7	0	0
2	44550903	.	G	A	0	8	8	0	2	10	0	0
2	44550950	.	C	T	3	3	6	0	1	7	0	0
2	44554362	.	A	T	1	2	3	0	1	4	0	0
2	44556982	.	G	A	1	10	11	0	4	15	0	0
2	44556983	.	G	A	5	10	15	0	0	15	0	0
2	44557141	.	C	T	6	5	11	0	1	12	0	0
2	44604202	.	T	C	3	3	6	0	0	6	0	0
2	44604220	.	T	C	2	3	5	0	0	5	0	0
2	44621086	.	A	C	2	2	4	0	0	4	0	0
2	44633487	.	A	G	0	0	0	0	1	1	0	0
2	44643678	.	G	T	1	1	2	0	0	2	0	0
2	44643696	.	T	G	1	1	2	0	0	2	0	0
2	44666553	.	A	T	1	0	1	0	0	1	0	0
2	44666558	.	G	C	2	2	4	0	0	4	0	0
2	44666838	.	G	A	0	2	2	0	0	2	0	0
2	44669595	.	G	T	1	3	4	0	1	5	0	0
2	44678904	.	C	G	3	2	5	0	0	5	0	0
2	44678913	.	A	G	2	2	4	0	1	5	0	0
2	44682684	.	C	T	0	1	1	0	0	1	0	0
2	44687090	.	C	A	5	3	8	0	0	8	0	0
2	44687106	.	T	C	4	2	6	0	0	6	0	0
2	44692527	.	T	C	3	1	4	0	0	4	0	0
2	44692529	.	C	T	3	1	4	0	0	4	0	0
2	44692638	.	C	G	3	4	7	0	0	7	0	0
2	44692641	.	A	G	2	0	2	0	5	7	0	0
2	44692691	.	C	T	5	5	10	0	0	10	0	0
2	44692696	.	T	C	5	4	9	0	0	9	0	0
2	44692746	.	C	T	2	1	3	0	0	3	0	0
2	44693093	.	A	G	1	2	3	0	1	4	0	0
2	44697590	.	T	C	20	8	28	0	1	29	0	0
2	44720175	.	A	G	16	16	32	0	2	34	0	0
2	44720201	.	G	A	18	10	28	0	1	29	0	0
2	44720423	.	G	A	17	11	28	0	2	30	0	0
2	44752545	.	A	G	2	4	6	0	1	7	0	0
2	44757781	.	G	A	0	1	1	0	0	1	0	0
2	44757790	.	C	T	0	1	1	0	0	1	0	0
2	44757826	.	A	G	0	1	1	0	0	1	0	0
2	44757967	.	G	A	0	1	1	0	0	1	0	0
2	44759674	.	A	G	2	0	2	0	0	2	0	0
2	44759953	.	A	G	1	3	4	0	0	4	0	0
2	44759956	.	G	A	1	3	4	0	0	4	0	0
2	44762311	.	A	G	6	4	10	0	0	10	0	0
2	44922789	.	G	T	1	2	3	0	0	3	0	0
2	44923858	.	T	C	2	1	3	0	0	3	0	0
2	44923878	.	T	C	3	2	5	0	0	5	0	0
2	44924616	.	T	G	2	0	2	0	5	7	0	0
2	44924647	.	T	C	3	2	5	0	0	5	0	0
2	44924662	.	G	A	1	2	3	0	2	5	0	0
2	44943621	.	C	A	10	4	14	0	1	15	0	0
2	44944789	.	A	T	29	30	59	0	0	59	0	0
2	44961712	.	G	A	1	2	3	0	0	3	0	0
2	44961734	.	G	T	1	3	4	0	0	4	0	0
2	44961792	.	G	T	2	2	4	0	0	4	0	0
2	44962973	.	A	T	1	2	3	0	0	3	0	0
2	44963053	.	G	A	2	2	4	0	0	4	0	0
2	44963670	.	G	T	2	3	5	0	0	5	0	0
2	44964427	.	C	A	3	2	5	0	0	5	0	0
2	44964514	.	C	T	5	2	7	0	0	7	0	0
2	44964516	.	T	A	5	2	7	0	0	7	0	0
2	44964688	.	C	G	0	3	3	0	2	5	0	0
2	44964773	.	T	C	1	2	3	0	0	3	0	0
2	44965921	.	C	A	1	2	3	0	3	6	0	0
2	44975918	.	T	C	1	4	5	0	0	5	0	0
2	44977719	.	C	G	2	0	2	0	0	2	0	0
2	44980270	.	T	C	0	0	0	0	1	1	0	0
2	44980422	.	T	C	4	3	7	0	0	7	0	0
2	44980562	.	A	G	2	1	3	0	0	3	0	0
2	44981043	.	C	T	8	6	14	0	0	14	0	0
2	45116988	.	C	G	1	12	13	0	10	23	0	0
2	45117063	.	A	G	14	7	21	0	2	23	0	0
2	45117076	.	T	C	12	7	19	0	0	19	0	0
2	45117280	.	C	A	14	4	18	0	0	18	0	0
2	45117354	.	G	C	12	13	25	0	0	25	0	0
2	45117440	.	T	A	12	9	21	0	0	21	0	0
2	45117712	.	T	A	1	2	3	0	0	3	0	0
2	45129977	.	G	A	5	4	9	0	0	9	0	0
2	45132677	.	A	G	0	2	2	0	0	2	0	0
2	45139669	.	A	G	2	2	4	0	0	4	0	0
2	45139729	.	T	G	1	4	5	0	0	5	0	0
2	45139894	.	C	T	6	11	17	0	0	17	0	0
2	45142971	.	G	A	6	12	18	0	3	21	0	0
2	45143036	.	T	G	7	12	19	0	1	20	0	0
2	45144030	.	G	A	5	6	11	0	0	11	0	0
2	45144163	.	G	A	1	3	4	0	0	4	0	0
2	45145817	.	A	T	2	3	5	0	1	6	0	0
2	45145969	.	G	C	5	5	10	0	0	10	0	0
2	45145973	.	C	T	5	5	10	0	0	10	0	0
2	45149649	.	G	A	3	3	6	0	1	7	0	0
2	45149730	.	T	G	4	6	10	0	0	10	0	0
2	45149751	.	C	T	3	6	9	0	0	9	0	0
2	45149798	.	T	C	1	0	1	0	1	2	0	0
2	45152302	.	T	C	2	4	6	0	0	6	0	0
2	45152323	.	C	A	4	6	10	0	0	10	0	0
2	45152461	.	A	G	0	1	1	0	0	1	0	0
2	45153108	.	T	C	0	0	0	0	1	1	0	0
2	45326177	.	G	A	0	1	1	0	2	3	0	0
2	45326207	.	A	G	4	2	6	0	0	6	0	0
2	45326240	.	T	C	2	2	4	0	0	4	0	0
2	45326255	.	T	G	2	0	2	0	1	3	0	0
2	45349423	.	C	T	3	0	3	0	0	3	0	0
2	45354994	.	T	C	4	8	12	0	0	12	0	0
2	45355036	.	A	G	5	7	12	0	0	12	0	0
2	45355138	.	C	T	3	7	10	0	0	10	0	0
2	45355171	.	C	A	1	5	6	0	0	6	0	0
2	45358712	.	C	A	2	8	10	0	0	10	0	0
2	45358796	.	A	T	3	8	11	0	0	12	1	0
2	45358974	.	G	A	5	8	13	0	0	13	0	0
2	45359045	.	T	G	7	0	7	0	13	20	0	0
2	45359159	.	C	A	9	10	19	0	0	19	0	0
2	45359394	.	A	G	10	9	19	0	1	20	0	0
2	45359400	.	A	G	11	8	19	0	0	19	0	0
2	45359492	.	T	G	5	9	14	0	1	15	0	0
2	45359504	.	T	G	6	7	13	0	0	13	0	0
2	45362087	.	G	A	9	12	21	0	0	21	0	0
2	45362117	.	G	A	5	9	14	0	1	15	0	0
2	45362129	.	A	T	4	6	10	0	0	10	0	0
2	45376148	.	T	C	9	6	15	0	1	16	0	0
2	45382521	.	T	A	3	7	10	0	0	10	0	0
2	45384870	.	G	A	6	5	11	0	0	11	0	0
2	45406944	.	A	G	2	0	2	0	6	8	0	0
2	45410956	.	A	C	2	1	3	0	0	3	0	0
2	45412340	.	T	C	3	7	10	0	0	10	0	0
2	45417195	.	T	C	1	0	1	0	0	1	0	0
2	45419436	.	T	C	11	9	20	0	0	20	0	0
2	45419583	.	T	G	7	7	14	0	0	14	0	0
2	45491595	.	A	C	3	2	5	0	1	6	0	0
2	45491596	.	C	T	3	3	6	0	0	6	0	0
2	45491633	.	T	G	5	6	11	0	0	11	0	0
2	45491663	.	C	T	2	3	5	0	0	5	0	0
2	45492371	.	G	A	3	2	5	0	0	5	0	0
2	45493712	.	G	T	0	2	2	0	0	2	0	0
2	45496283	.	T	C	2	0	2	0	0	2	0	0
2	45655555	.	G	C	2	6	8	0	0	8	0	0
2	45656177	.	A	T	14	20	34	0	0	34	0	0
2	45656198	.	C	T	17	21	38	0	1	39	0	0
2	45656234	.	T	C	19	19	38	0	2	40	0	0
2	45656260	.	C	T	0	16	16	0	15	31	0	0
2	45656447	.	G	A	13	11	24	0	1	25	0	0
2	45659952	.	G	A	1	2	3	0	0	3	0	0
2	45661511	.	C	A	0	3	3	0	2	5	0	0
2	45663532	.	C	T	5	2	7	0	0	7	0	0
2	45663794	.	G	C	4	8	12	0	0	12	0	0
2	45665592	.	A	G	0	2	2	0	0	2	0	0
2	45666033	.	A	G	4	2	6	0	0	6	0	0
2	45666055	.	C	T	4	2	6	0	0	6	0	0
2	45689109	.	G	A	1	2	3	0	0	3	0	0
2	45689442	.	A	G	2	1	3	0	0	3	0	0
2	46032894	.	T	C	4	2	6	0	0	6	0	0
2	46117197	.	T	C	2	1	3	0	0	3	0	0
2	46140293	.	G	C	5	9	14	0	0	14	0	0
2	46140470	.	T	C	1	5	6	0	1	7	0	0
2	46140479	.	T	C	0	5	5	0	0	5	0	0
2	46140512	.	G	A	0	2	2	0	0	2	0	0
2	46175367	.	G	T	0	0	0	0	1	1	0	0
2	46175484	.	C	T	3	2	5	0	0	5	0	0
2	46176783	.	A	G	3	4	7	0	0	7	0	0
2	46176822	.	T	C	1	3	4	0	0	4	0	0
2	46181029	.	T	C	5	5	10	0	0	10	0	0
2	46183855	.	T	C	8	6	14	0	2	16	0	0
2	46183897	.	G	A	10	8	18	0	1	19	0	0
2	46183985	.	A	T	8	6	14	0	0	14	0	0
2	46184024	.	T	A	6	9	15	0	0	15	0	0
2	46184057	.	C	A	5	9	14	0	1	15	0	0
2	46184193	.	C	T	4	12	16	0	0	16	0	0
2	46184248	.	G	C	5	3	8	0	1	9	0	0
2	46184555	.	A	G	9	10	19	0	1	20	0	0
2	46471365	.	A	T	3	3	6	0	0	6	0	0
2	46471392	.	C	T	2	2	4	0	0	4	0	0
2	46471440	.	A	G	2	0	2	0	5	7	0	0
2	46471515	.	G	A	1	4	5	0	0	5	0	0
2	46669688	.	A	G	0	1	1	0	0	1	0	0
2	46694469	.	G	C	0	0	0	0	1	1	0	0
2	46697528	.	A	C	2	3	5	0	0	5	0	0
2	46715639	.	G	A	0	2	2	0	5	7	0	0
2	46715681	.	G	A	4	4	8	0	1	9	0	0
2	47472068	.	T	A	2	11	13	0	0	13	0	0
2	47493456	.	C	G	3	0	3	0	5	8	0	0
2	47495077	.	T	C	2	3	5	0	0	5	0	0
2	47500251	.	C	T	3	5	8	0	3	11	0	0
2	47506185	.	C	T	2	0	2	0	0	2	0	0
2	47506187	.	G	A	2	0	2	0	0	2	0	0
2	47511341	.	T	C	4	2	6	0	0	6	0	0
2	47512820	.	G	A	7	17	24	0	2	26	0	0
2	47513002	.	G	T	12	9	21	0	2	23	0	0
2	47513391	.	G	A	0	4	4	0	4	8	0	0
2	47513712	.	C	A	11	16	27	0	0	27	0	0
2	47513871	.	C	A	15	20	35	0	0	35	0	0
2	47514001	.	A	G	5	19	24	0	0	24	0	0
2	47514504	.	C	A	1	3	4	0	0	4	0	0
2	47514582	.	T	G	5	11	16	0	0	16	0	0
2	47514613	.	T	A	6	9	15	0	1	16	0	0
2	47514619	.	A	T	6	11	17	0	0	17	0	0
2	47514697	.	A	G	11	12	23	0	0	23	0	0
2	47514878	.	T	G	13	15	28	0	1	29	0	0
2	47515019	.	T	C	9	16	25	0	1	26	0	0
2	47515073	.	T	C	9	14	23	0	0	23	0	0
2	47515111	.	G	A	6	16	22	0	0	22	0	0
2	47515223	.	T	A	11	10	21	0	1	22	0	0
2	47582559	.	C	G	1	3	4	0	0	4	0	0
2	47582891	.	A	G	27	17	44	0	0	44	0	0
2	47583029	.	C	A	28	27	55	0	4	59	0	0
2	47583377	.	G	A	2	32	34	0	30	64	0	0
2	47583701	.	C	T	25	21	46	0	2	48	0	0
2	47583788	.	T	A	35	31	66	0	2	68	0	0
2	47584064	.	G	A	2	31	33	0	35	68	0	0
2	47584092	.	G	A	29	39	68	0	4	72	0	0
2	47584547	.	T	A	29	23	52	0	1	53	0	0
2	47584612	.	G	A	26	15	41	0	0	41	0	0
2	47584799	.	A	T	32	25	57	0	2	59	0	0
2	47587387	.	C	A	4	4	8	0	2	10	0	0
2	47587652	.	C	T	9	9	18	0	0	18	0	0
2	47587703	.	A	G	5	10	15	0	1	16	0	0
2	47620714	.	C	T	1	0	1	0	0	1	0	0
2	47633835	.	T	A	2	3	5	0	0	5	0	0
2	47633841	.	C	T	2	3	5	0	0	5	0	0
2	47644488	.	T	G	19	13	32	0	1	33	0	0
2	47648076	.	A	G	13	15	28	0	0	28	0	0
2	47648091	.	T	G	10	9	19	0	0	19	0	0
2	47651598	.	A	G	2	6	8	0	0	8	0	0
2	47652403	.	A	G	5	3	8	0	1	9	0	0
2	47652406	.	A	G	4	3	7	0	3	10	0	0
2	47658641	.	T	G	4	4	8	0	2	10	0	0
2	47658653	.	G	A	8	6	14	0	0	14	0	0
2	47658752	.	A	G	3	5	8	0	1	9	0	0
2	47661273	.	A	C	5	0	5	0	5	10	0	0
2	47662955	.	A	G	10	7	17	0	0	17	0	0
2	47754158	.	T	A	4	3	7	0	0	7	0	0
2	47754160	.	C	A	4	3	7	0	0	7	0	0
2	47754496	.	G	T	0	5	5	0	8	13	0	0
2	47754503	.	A	C	5	4	9	0	0	10	1	0
2	47805071	.	G	C	0	4	4	0	5	9	0	0
2	47827274	.	A	G	1	1	2	0	0	2	0	0
2	47829112	.	T	C	5	4	9	0	0	9	0	0
2	47829126	.	C	T	3	6	9	0	0	9	0	0
2	47916384	.	T	A	3	3	6	0	0	6	0	0
2	47916389	.	T	C	2	0	2	0	5	7	0	0
2	47916467	.	A	T	5	3	8	0	0	8	0	0
2	47916599	.	G	A	2	2	4	0	1	5	0	0
2	47916719	.	G	A	1	4	5	0	0	5	0	0
2	47918584	.	C	T	2	3	5	0	0	5	0	0
2	47918632	.	T	G	2	1	3	0	0	3	0	0
2	47918643	.	C	G	1	1	2	0	0	2	0	0
2	47955411	.	T	C	4	2	6	0	0	6	0	0
2	47955412	.	A	G	4	2	6	0	0	6	0	0
2	47957332	.	G	A	1	2	3	0	0	3	0	0
2	48092781	.	C	G	1	3	4	0	0	4	0	0
2	48092793	.	C	A	1	3	4	0	0	4	0	0
2	48098019	.	T	A	3	3	6	0	1	7	0	0
2	48099951	.	A	C	0	2	2	0	1	3	0	0
2	48099990	.	G	A	0	3	3	0	1	4	0	0
2	48108314	.	C	A	2	3	5	0	0	5	0	0
2	48111190	.	G	A	1	0	1	0	0	1	0	0
2	48112887	.	A	T	0	1	1	0	0	1	0	0
2	48114388	.	G	A	2	4	6	0	0	6	0	0
2	48114391	.	T	G	2	0	2	0	4	6	0	0
2	48115732	.	T	A	5	3	8	0	0	8	0	0
2	48115990	.	C	T	4	0	4	0	0	4	0	0
2	48118470	.	T	C	1	4	5	0	1	6	0	0
2	48118485	.	G	A	0	4	4	0	2	6	0	0
2	48119134	.	G	A	2	6	8	0	2	10	0	0
2	48119209	.	G	A	2	4	6	0	0	6	0	0
2	48119631	.	A	C	12	2	14	0	0	14	0	0
2	48119696	.	A	T	6	9	15	0	2	17	0	0
2	48119704	.	A	T	7	8	15	0	2	17	0	0
2	48119744	.	A	G	6	10	16	0	2	18	0	0
2	48119793	.	A	C	8	16	24	0	1	25	0	0
2	48119821	.	T	A	9	13	22	0	0	22	0	0
2	48120190	.	A	T	18	4	22	0	1	23	0	0
2	48120273	.	T	C	14	4	18	0	0	18	0	0
2	48120274	.	T	A	15	4	19	0	0	19	0	0
2	48120392	.	C	G	12	3	15	0	0	15	0	0
2	48120401	.	A	G	12	3	15	0	0	15	0	0
2	48120430	.	C	T	8	5	13	0	1	14	0	0
2	48120462	.	T	A	10	8	18	0	0	18	0	0
2	48120516	.	T	C	18	15	33	0	1	34	0	0
2	48120689	.	G	A	12	8	20	0	2	22	0	0
2	48120694	.	C	G	12	9	21	0	1	22	0	0
2	48120743	.	T	C	6	10	16	0	1	17	0	0
2	48120744	.	G	A	6	11	17	0	0	17	0	0
2	48120805	.	T	A	7	3	10	0	0	10	0	0
2	48120825	.	A	C	5	3	8	0	1	9	0	0
2	48120864	.	C	A	3	3	6	0	0	6	0	0
2	48121039	.	T	C	4	2	6	0	1	7	0	0
2	48121078	.	T	C	3	2	5	0	0	5	0	0
2	48121157	.	C	A	0	2	2	0	1	3	0	0
2	48121164	.	A	T	2	1	3	0	0	3	0	0
2	48121312	.	G	A	18	5	23	0	0	23	0	0
2	48121351	.	G	C	19	7	26	0	0	26	0	0
2	48121352	.	T	C	19	7	26	0	0	26	0	0
2	48121428	.	T	A	11	7	18	0	0	18	0	0
2	48121713	.	G	T	7	6	13	0	1	14	0	0
2	48121743	.	A	G	8	9	17	0	0	17	0	0
2	48127614	.	G	A	3	1	4	0	0	4	0	0
2	48127810	.	A	G	1	0	1	0	0	1	0	0
2	48130185	.	G	A	5	1	6	0	0	6	0	0
2	48130200	.	G	A	7	2	9	0	0	9	0	0
2	48130224	.	A	G	9	3	12	0	0	12	0	0
2	48130281	.	A	G	2	2	4	0	0	4	0	0
2	48137605	.	A	G	2	1	3	0	0	3	0	0
2	48145216	.	A	G	4	2	6	0	0	6	0	0
2	48145219	.	T	A	3	2	5	0	1	6	0	0
2	48165061	.	G	T	0	2	2	0	0	2	0	0
2	48203544	.	A	G	9	7	16	0	1	17	0	0
2	48203554	.	C	T	11	5	16	0	2	18	0	0
2	48203622	.	G	A	11	9	20	0	4	24	0	0
2	48203920	.	C	A	0	7	7	0	4	11	0	0
2	48207319	.	C	T	0	7	7	0	11	18	0	0
2	48212114	.	C	A	1	2	3	0	0	3	0	0
2	48232643	.	T	A	11	6	17	0	0	17	0	0
2	48234695	.	C	T	0	1	1	0	2	3	0	0
2	48284721	.	G	A	24	18	42	0	0	42	0	0
2	48285153	.	C	G	16	16	32	0	0	32	0	0
2	48285241	.	T	G	9	10	19	0	1	20	0	0
2	48285265	.	A	C	7	9	16	0	1	17	0	0
2	48290805	.	A	T	24	32	56	0	1	57	0	0
2	48290820	.	C	T	24	33	57	0	0	57	0	0
2	48304467	.	G	A	15	10	25	0	0	25	0	0
2	48309874	.	T	A	8	9	17	0	0	17	0	0
2	48309876	.	A	T	7	9	16	0	1	17	0	0
2	48309970	.	C	A	16	12	28	0	1	29	0	0
2	48310207	.	C	T	1	6	7	0	8	15	0	0
2	48310258	.	A	T	7	8	15	0	0	15	0	0
2	48310266	.	T	C	5	0	5	0	7	12	0	0
2	48310330	.	C	G	4	5	9	0	0	9	0	0
2	48310342	.	A	G	6	5	11	0	0	11	0	0
2	48310374	.	G	A	5	2	7	0	0	7	0	0
2	48313598	.	A	G	5	5	10	0	1	11	0	0
2	48317363	.	G	T	13	11	24	0	1	25	0	0
2	48317418	.	C	G	12	11	23	0	1	24	0	0
2	48317444	.	G	T	8	10	18	0	0	18	0	0
2	48323317	.	C	T	7	5	12	0	1	13	0	0
2	48323341	.	T	C	6	6	12	0	1	13	0	0
2	48323470	.	A	T	15	18	33	0	0	33	0	0
2	48323562	.	A	T	10	13	23	0	9	32	0	0
2	48323572	.	A	G	12	16	28	0	4	32	0	0
2	48323695	.	A	G	12	19	31	0	0	31	0	0
2	48323863	.	A	G	14	16	30	0	0	30	0	0
2	48326354	.	G	A	4	2	6	0	1	7	0	0
2	48326408	.	C	T	0	9	9	0	13	22	0	0
2	48332566	.	A	G	8	1	9	0	0	9	0	0
2	48335187	.	G	A	1	4	5	0	0	5	0	0
2	48343259	.	T	G	1	1	2	0	0	2	0	0
2	48343367	.	G	A	4	3	7	0	2	9	0	0
2	48344066	.	C	G	5	3	8	0	0	8	0	0
2	48344072	.	T	C	5	0	5	0	3	8	0	0
2	48345379	.	A	G	2	2	4	0	0	4	0	0
2	48356642	.	C	T	3	7	10	0	1	11	0	0
2	48356689	.	T	C	3	4	7	0	1	8	0	0
2	48512050	.	T	A	1	3	4	0	0	4	0	0
2	48546121	.	T	A	1	0	1	0	0	1	0	0
2	48552301	.	A	G	1	5	6	0	0	6	0	0
2	48753714	.	C	T	4	3	7	0	0	7	0	0
2	48956187	.	C	A	0	2	2	0	1	3	0	0
2	49007765	.	A	G	12	7	19	0	0	19	0	0
2	49007781	.	A	T	9	7	16	0	1	17	0	0
2	49008073	.	T	A	2	4	6	0	0	6	0	0
2	49008339	.	A	T	8	3	11	0	0	11	0	0
2	49008382	.	T	G	4	8	12	0	0	12	0	0
2	49017754	.	C	T	1	6	7	0	0	7	0	0
2	49039289	.	A	T	0	3	3	0	1	4	0	0
2	49063457	.	A	G	1	3	4	0	0	4	0	0
2	49609086	.	T	C	9	6	15	0	0	15	0	0
2	49609202	.	T	C	5	0	5	0	6	11	0	0
2	50892529	.	A	G	7	1	8	0	15	23	0	0
2	50892537	.	A	G	5	14	19	0	1	20	0	0
2	50892671	.	A	G	10	5	15	0	2	17	0	0
2	52063128	.	T	C	0	2	2	0	0	2	0	0
2	53065392	.	G	A	6	5	11	0	1	12	0	0
2	53065421	.	A	G	5	3	8	0	0	8	0	0
2	53085962	.	C	T	0	1	1	0	1	2	0	0
2	53091285	.	C	T	2	0	2	0	0	2	0	0
2	53201805	.	C	T	2	2	4	0	0	4	0	0
2	53414142	.	C	T	4	3	7	0	0	7	0	0
2	53665098	.	A	G	3	0	3	0	0	3	0	0
2	53673285	.	G	A	0	1	1	0	3	4	0	0
2	53673342	.	G	A	9	13	22	0	0	22	0	0
2	53673354	.	T	G	9	12	21	0	2	23	0	0
2	53673393	.	C	A	10	13	23	0	2	25	0	0
2	53675227	.	C	T	12	3	15	0	0	15	0	0
2	53675682	.	A	T	7	3	10	0	0	10	0	0
2	53720058	.	G	C	0	5	5	0	7	12	0	0
2	53720098	.	A	G	12	0	12	0	11	23	0	0
2	53720122	.	C	G	6	7	13	0	0	13	0	0
2	53721966	.	G	C	3	1	4	0	0	4	0	0
2	53724856	.	G	A	3	3	6	0	0	6	0	0
2	53750668	.	T	C	12	5	17	0	1	18	0	0
2	53750707	.	C	T	7	4	11	0	1	12	0	0
2	53750719	.	C	T	5	4	9	0	0	9	0	0
2	53893969	.	C	T	1	4	5	0	1	6	0	0
2	54017861	.	G	T	5	6	11	0	1	12	0	0
2	54017885	.	C	A	0	6	6	0	6	12	0	0
2	54018350	.	C	T	1	7	8	0	5	13	0	0
2	54018407	.	G	A	12	5	17	0	0	17	0	0
2	54018413	.	T	A	10	4	14	0	1	15	0	0
2	54018461	.	G	A	4	5	9	0	1	10	0	0
2	54039142	.	A	G	6	3	9	0	1	10	0	0
2	54039159	.	C	T	0	5	5	0	7	12	0	0
2	54049402	.	T	C	6	3	9	0	0	9	0	0
2	54049453	.	C	A	0	4	4	0	2	6	0	0
2	54051923	.	G	A	0	1	1	0	0	1	0	0
2	54054112	.	C	T	1	0	1	0	0	1	0	0
2	54054184	.	T	A	6	3	9	0	0	10	1	0
2	54832219	.	A	G	6	3	9	0	0	9	0	0
2	54832224	.	A	G	2	8	10	0	0	10	0	0
2	54832298	.	A	G	5	2	7	0	0	7	0	0
2	54832599	.	A	G	2	3	5	0	1	6	0	0
2	55491471	.	C	T	4	32	36	0	4	40	0	0
2	55967882	.	C	T	1	2	3	0	0	3	0	0
2	55968617	.	T	A	0	2	2	0	0	2	0	0
2	55968730	.	C	T	1	2	3	0	0	3	0	0
2	56061520	.	C	T	0	4	4	0	0	4	0	0
2	56125945	.	T	C	0	0	0	0	0	1	1	0
2	56159430	.	G	A	0	4	4	0	0	4	0	0
2	56508695	.	T	C	12	17	29	0	3	32	0	0
2	56510628	.	T	C	3	6	9	0	0	9	0	0
2	57240283	.	G	T	5	4	9	0	0	9	0	0
2	57240340	.	A	T	7	3	10	0	0	10	0	0
2	57240345	.	C	T	7	4	11	0	0	11	0	0
2	57240570	.	A	T	8	4	12	0	0	12	0	0
2	57240668	.	G	T	2	4	6	0	0	6	0	0
2	57240708	.	C	T	2	7	9	0	0	9	0	0
2	57240736	.	G	A	3	9	12	0	0	12	0	0
2	57247385	.	C	G	1	0	1	0	0	1	0	0
2	57268868	.	G	A	14	24	38	0	4	42	0	0
2	57268898	.	T	A	24	20	44	0	0	44	0	0
2	57268947	.	C	A	27	23	50	0	1	51	0	0
2	57269123	.	C	A	14	15	29	0	0	29	0	0
2	57284550	.	A	T	4	2	6	0	0	6	0	0
2	57325904	.	A	G	1	3	4	0	0	4	0	0
2	57417092	.	A	C	2	3	5	0	0	5	0	0
2	57420477	.	G	A	0	1	1	0	0	1	0	0
2	57609378	.	C	T	0	6	6	0	3	9	0	0
2	57609714	.	T	C	2	6	8	0	0	8	0	0
2	57616908	.	T	G	1	0	1	0	0	1	0	0
2	57620076	.	C	T	1	3	4	0	2	6	0	0
2	57624474	.	G	A	1	2	3	0	0	3	0	0
2	57830385	.	T	C	16	1	17	0	16	33	0	0
2	57834927	.	T	C	10	8	18	0	1	19	0	0
2	57834930	.	T	C	11	7	18	0	0	18	0	0
2	57848889	.	G	C	9	13	22	0	1	23	0	0
2	57848936	.	G	C	9	7	16	0	0	16	0	0
2	57856706	.	C	T	1	0	1	0	0	1	0	0
2	57867471	.	C	T	4	5	9	0	0	9	0	0
2	57867473	.	C	T	4	4	8	0	1	9	0	0
2	57867579	.	G	T	8	3	11	0	0	11	0	0
2	57867642	.	A	T	5	4	9	0	1	10	0	0
2	57868151	.	C	T	3	2	5	0	0	5	0	0
2	57868433	.	T	C	11	5	16	0	0	16	0	0
2	57868580	.	A	G	16	12	28	0	2	30	0	0
2	57869966	.	A	T	3	1	4	0	0	4	0	0
2	57870003	.	A	G	6	4	10	0	0	10	0	0
2	57870049	.	G	A	8	3	11	0	1	12	0	0
2	57870051	.	A	G	7	0	7	0	5	12	0	0
2	57870155	.	C	T	12	8	20	0	0	20	0	0
2	57870180	.	T	C	10	10	20	0	1	21	0	0
2	57870323	.	G	T	2	4	6	0	0	6	0	0
2	57870343	.	A	G	3	2	5	0	2	7	0	0
2	57870383	.	G	A	3	4	7	0	0	8	1	0
2	57870622	.	G	C	2	2	4	0	0	4	0	0
2	57870659	.	A	T	6	5	11	0	0	11	0	0
2	57870713	.	C	G	10	12	22	0	0	22	0	0
2	57870794	.	G	T	16	11	27	0	0	27	0	0
2	57870795	.	T	A	16	11	27	0	0	27	0	0
2	57870830	.	A	G	16	10	26	0	1	27	0	0
2	57870868	.	G	A	1	9	10	0	15	25	0	0
2	57870887	.	A	G	15	0	15	0	8	23	0	0
2	57870934	.	T	C	9	9	18	0	1	19	0	0
2	57870984	.	A	T	12	5	17	0	1	18	0	0
2	57873851	.	T	A	3	2	5	0	0	5	0	0
2	57873854	.	A	T	3	2	5	0	0	5	0	0
2	57879582	.	T	C	10	18	28	0	2	30	0	0
2	57879615	.	T	C	7	0	7	0	5	12	0	0
2	57879618	.	T	C	7	4	11	0	0	11	0	0
2	57883433	.	C	T	7	17	24	0	1	25	0	0
2	57883452	.	C	T	10	25	35	0	2	37	0	0
2	57883509	.	C	T	0	27	27	0	12	39	0	0
2	57891444	.	G	A	9	18	27	0	0	27	0	0
2	57891463	.	T	C	4	10	14	0	0	14	0	0
2	57892808	.	A	G	2	2	4	0	0	4	0	0
2	57893340	.	A	T	4	2	6	0	0	6	0	0
2	57893494	.	G	A	3	7	10	0	0	10	0	0
2	57893547	.	A	G	2	3	5	0	1	6	0	0
2	57893684	.	G	A	3	4	7	0	0	7	0	0
2	57893748	.	A	G	2	2	4	3	0	7	0	0
2	57893826	.	A	G	4	3	7	0	0	7	0	0
2	57893889	.	A	T	1	2	3	0	0	3	0	0
2	57894012	.	T	C	3	2	5	0	6	11	0	0
2	57894127	.	T	G	3	4	7	0	0	7	0	0
2	57897143	.	T	C	2	3	5	0	1	6	0	0
2	57898875	.	G	A	1	0	1	0	0	1	0	0
2	57899003	.	G	A	4	2	6	0	0	6	0	0
2	57900156	.	A	G	1	3	4	0	0	4	0	0
2	57913904	.	A	G	1	4	5	0	1	6	0	0
2	57913913	.	G	A	2	5	7	0	0	7	0	0
2	57918008	.	G	A	0	2	2	0	0	2	0	0
2	57940770	.	G	A	2	2	4	0	0	4	0	0
2	58009111	.	T	C	3	3	6	0	0	6	0	0
2	58009112	.	G	C	3	3	6	0	0	6	0	0
2	58009416	.	A	G	1	4	5	0	0	5	0	0
2	58012271	.	T	C	6	10	16	0	2	18	0	0
2	58012293	.	T	C	7	4	11	0	2	13	0	0
2	58012568	.	T	C	5	2	7	0	0	7	0	0
2	58013054	.	G	A	4	2	6	0	1	7	0	0
2	58013336	.	T	C	9	4	13	0	0	13	0	0
2	58013903	.	A	G	4	0	4	0	8	12	0	0
2	58014110	.	G	T	8	7	15	0	0	15	0	0
2	58014156	.	A	T	10	9	19	0	0	19	0	0
2	58014364	.	G	A	9	4	13	0	0	13	0	0
2	58014502	.	G	A	1	3	4	0	1	5	0	0
2	58077783	.	T	G	1	6	7	0	0	7	0	0
2	58077795	.	C	A	2	8	10	0	0	10	0	0
2	58077869	.	T	C	4	11	15	0	0	15	0	0
2	58078071	.	G	C	7	4	11	0	0	11	0	0
2	58081768	.	G	A	2	3	5	0	0	5	0	0
2	58122023	.	A	T	2	4	6	0	0	6	0	0
2	58126268	.	C	T	3	1	4	0	0	4	0	0
2	58129968	.	C	G	2	0	2	0	0	2	0	0
2	58129992	.	A	G	2	0	2	0	0	2	0	0
2	58132558	.	A	C	4	2	6	0	0	6	0	0
2	58137902	.	A	C	3	6	9	0	1	10	0	0
2	58187013	.	C	G	5	6	11	0	0	11	0	0
2	58187038	.	G	A	7	4	11	0	1	12	0	0
2	58187052	.	T	A	7	4	11	0	2	13	0	0
2	58187187	.	T	C	8	0	8	0	7	15	0	0
2	58187621	.	G	T	10	8	18	0	1	19	0	0
2	58187624	.	C	T	0	8	8	0	11	19	0	0
2	58228022	.	G	C	2	0	2	0	0	2	0	0
2	58347944	.	C	T	0	2	2	0	0	2	0	0
2	58347965	.	G	C	0	2	2	0	0	2	0	0
2	58349088	.	A	G	1	2	3	0	0	3	0	0
2	58349253	.	G	A	2	4	6	0	0	6	0	0
2	58411998	.	T	C	3	6	9	0	1	10	0	0
2	58514819	.	T	C	0	6	6	0	0	6	0	0
2	58516445	.	C	A	3	8	11	0	0	11	0	0
2	58541894	.	C	T	11	8	19	0	1	20	0	0
2	58541939	.	G	A	16	10	26	0	0	26	0	0
2	58541981	.	C	G	11	12	23	0	0	23	0	0
2	58546821	.	G	T	7	13	20	0	1	21	0	0
2	58546893	.	G	A	12	12	24	0	0	24	0	0
2	58570715	.	C	G	0	1	1	0	0	1	0	0
2	58581582	.	G	C	4	2	6	0	0	6	0	0
2	58632210	.	T	C	5	0	5	0	14	19	0	0
2	58739511	.	C	T	8	8	16	0	1	17	0	0
2	58739574	.	C	T	2	0	2	0	0	2	0	0
2	58739714	.	G	A	6	8	14	0	1	15	0	0
2	58785866	.	T	C	3	4	7	0	1	8	0	0
2	58786094	.	G	A	3	7	10	0	1	11	0	0
2	58788301	.	A	G	7	2	9	0	0	9	0	0
2	58789112	.	G	A	7	3	10	0	0	10	0	0
2	58789495	.	C	T	0	0	0	0	1	1	0	0
2	58793396	.	C	T	0	13	13	0	16	29	0	0
2	58793438	.	A	G	13	15	28	0	0	28	0	0
2	58793652	.	A	G	10	10	20	0	1	21	0	0
2	58795599	.	C	T	1	0	1	0	1	2	0	0
2	58841219	.	T	C	5	6	11	0	1	12	0	0
2	58845239	.	C	T	2	0	2	0	1	3	0	0
2	58845396	.	T	C	6	8	14	0	1	15	0	0
2	58848646	.	T	G	30	2	32	0	30	62	0	0
2	58868193	.	G	A	9	9	18	0	0	18	0	0
2	58868439	.	T	C	7	0	7	0	16	23	0	0
2	58868577	.	G	C	9	0	9	0	7	16	0	0
2	58868679	.	G	A	7	8	15	0	1	16	0	0
2	58868841	.	G	A	7	7	14	0	0	14	0	0
2	58869037	.	C	G	0	1	1	0	0	1	0	0
2	58869142	.	G	A	11	11	22	0	0	22	0	0
2	58869319	.	G	T	8	8	16	0	2	18	0	0
2	58879122	.	C	G	14	0	14	0	13	27	0	0
2	58887659	.	T	C	3	3	6	0	0	6	0	0
2	58887668	.	T	C	2	4	6	0	0	6	0	0
2	58887726	.	A	G	10	3	13	0	0	13	0	0
2	58887752	.	G	A	5	7	12	0	0	12	0	0
2	58887766	.	C	G	5	5	10	0	0	10	0	0
2	58887817	.	C	T	0	7	7	0	3	10	0	0
2	58892142	.	T	C	5	0	5	0	9	14	0	0
2	58892160	.	C	T	6	1	7	0	1	8	0	0
2	58898910	.	A	G	6	3	9	0	0	9	0	0
2	58914807	.	A	T	1	5	6	0	0	6	0	0
2	58914896	.	A	G	3	1	4	0	0	4	0	0
2	58996000	.	A	T	4	6	10	0	0	10	0	0
2	59004046	.	C	T	1	0	1	0	0	1	0	0
2	59032670	.	T	C	7	11	18	0	1	19	0	0
2	59045797	.	G	A	0	0	0	0	1	1	0	0
2	59050160	.	C	T	2	1	3	0	0	3	0	0
2	59056203	.	C	T	6	23	29	0	0	29	0	0
2	59056212	.	G	A	4	17	21	0	3	24	0	0
2	59057670	.	C	T	10	6	16	0	2	18	0	0
2	59063227	.	T	C	5	5	10	0	0	10	0	0
2	59144385	.	T	G	6	3	9	0	0	9	0	0
2	59144436	.	T	A	10	3	13	0	0	13	0	0
20	22552	.	A	C	4	2	6	0	0	6	0	0
20	22632	.	G	C	1	3	4	0	0	4	0	0
20	66886	.	C	A	4	1	5	0	0	5	0	0
20	66919	.	C	T	3	4	7	0	0	7	0	0
20	67321	.	C	T	6	6	12	0	0	12	0	0
20	67388	.	C	A	5	4	9	0	0	9	0	0
20	67755	.	C	T	8	5	13	0	0	13	0	0
20	67867	.	T	G	3	5	8	0	0	8	0	0
20	75079	.	C	A	10	7	17	0	0	17	0	0
20	75121	.	C	T	10	10	20	0	0	20	0	0
20	75148	.	T	C	11	7	18	0	0	18	0	0
20	75266	.	G	A	0	2	2	0	5	7	0	0
20	75330	.	T	A	6	5	11	0	0	11	0	0
20	75374	.	A	G	7	3	10	0	1	11	0	0
20	75376	.	G	T	0	3	3	0	8	11	0	0
20	75889	.	C	T	9	6	15	0	1	16	0	0
20	76193	.	G	A	0	6	6	0	7	13	0	0
20	76209	.	A	G	4	6	10	0	1	11	0	0
20	76285	.	C	T	11	6	17	0	1	18	0	0
20	87449	.	A	T	1	2	3	0	0	3	0	0
20	87505	.	A	G	1	2	3	0	0	3	0	0
20	89176	.	A	G	8	8	16	0	0	16	0	0
20	89188	.	G	T	0	5	5	0	9	14	0	0
20	89567	.	G	A	10	14	24	0	0	24	0	0
20	89607	.	G	T	0	4	4	0	9	13	0	0
20	89625	.	T	A	7	7	14	0	1	15	0	0
20	90003	.	A	T	12	15	27	0	0	27	0	0
20	90167	.	C	T	9	16	25	0	0	25	0	0
20	90242	.	T	C	7	15	22	0	1	23	0	0
20	90246	.	T	C	9	15	24	0	0	24	0	0
20	114147	.	G	A	0	2	2	0	0	2	0	0
20	114708	.	A	G	26	21	47	0	1	48	0	0
20	114776	.	A	G	15	15	30	0	2	32	0	0
20	116164	.	A	T	22	15	37	0	1	38	0	0
20	122702	.	C	T	0	6	6	0	4	10	0	0
20	124691	.	C	T	0	2	2	0	0	2	0	0
20	147537	.	T	A	1	3	4	0	0	4	0	0
20	151348	.	T	A	0	2	2	0	0	2	0	0
20	151548	.	C	T	0	11	11	0	9	20	0	0
20	151846	.	C	T	17	13	30	0	1	31	0	0
20	152496	.	G	C	0	2	2	0	0	2	0	0
20	167791	.	T	A	2	3	5	0	0	5	0	0
20	186752	.	G	A	17	14	31	0	1	32	0	0
20	188449	.	A	G	15	10	25	0	0	25	0	0
20	188638	.	T	C	12	13	25	0	0	25	0	0
20	188687	.	C	G	4	4	8	0	1	9	0	0
20	196767	.	G	A	5	7	12	0	0	12	0	0
20	196773	.	T	A	5	6	11	0	0	11	0	0
20	196838	.	G	A	10	6	16	0	0	16	0	0
20	197274	.	T	C	5	6	11	0	1	12	0	0
20	197560	.	C	G	7	9	16	0	1	17	0	0
20	197842	.	T	C	10	11	21	0	2	23	0	0
20	198040	.	G	T	9	9	18	0	0	18	0	0
20	198049	.	C	T	9	11	20	0	0	20	0	0
20	198112	.	G	T	11	11	22	0	0	22	0	0
20	198127	.	A	T	10	8	18	0	0	18	0	0
20	198352	.	G	A	10	11	21	0	0	21	0	0
20	199168	.	C	T	0	9	9	0	4	13	0	0
20	199504	.	C	T	5	9	14	0	2	16	0	0
20	199956	.	G	A	5	3	8	0	1	9	0	0
20	199962	.	T	C	3	4	7	0	1	8	0	0
20	200302	.	C	T	3	2	5	0	1	6	0	0
20	200544	.	C	T	0	2	2	0	6	8	0	0
20	200851	.	G	A	5	4	9	0	0	9	0	0
20	201524	.	G	C	7	9	16	0	3	19	0	0
20	201718	.	G	A	1	7	8	0	0	8	0	0
20	201889	.	T	C	3	0	3	0	7	10	0	0
20	202012	.	A	G	8	6	14	0	1	15	0	0
20	202340	.	T	A	6	8	14	0	0	14	0	0
20	202480	.	T	C	6	3	9	0	1	10	0	0
20	202982	.	T	C	3	2	5	0	0	5	0	0
20	203122	.	G	A	4	5	9	0	0	9	0	0
20	204292	.	A	C	3	1	4	0	3	7	0	0
20	247639	.	G	A	1	1	2	0	0	2	0	0
20	247648	.	G	C	1	1	2	0	0	2	0	0
20	251162	.	A	G	2	0	2	0	4	6	0	0
20	254130	.	G	A	1	5	6	0	1	7	0	0
20	254601	.	C	T	2	3	5	0	0	5	0	0
20	255431	.	C	T	1	1	2	0	0	2	0	0
20	255433	.	C	G	1	1	2	0	0	2	0	0
20	255859	.	G	A	0	6	6	0	1	7	0	0
20	258687	.	G	A	1	3	4	0	0	4	0	0
20	259534	.	C	T	0	1	1	0	0	1	0	0
20	259602	.	T	C	6	6	12	0	0	12	0	0
20	259625	.	T	C	4	6	10	0	0	10	0	0
20	259763	.	C	T	8	5	13	0	1	14	0	0
20	259766	.	C	A	8	6	14	0	0	14	0	0
20	259847	.	C	T	3	6	9	0	0	9	0	0
20	329072	.	A	C	5	6	11	0	1	12	0	0
20	329113	.	G	A	1	2	3	0	0	3	0	0
20	369583	.	A	G	5	0	5	0	4	9	0	0
20	379577	.	A	C	1	5	6	0	0	6	0	0
20	379595	.	C	T	0	3	3	0	0	3	0	0
20	384585	.	G	T	0	1	1	0	1	2	0	0
20	384606	.	C	T	2	2	4	0	0	4	0	0
20	395704	.	C	T	7	9	16	0	1	17	0	0
20	396013	.	A	G	2	3	5	0	0	5	0	0
20	405867	.	G	A	4	5	9	0	0	9	0	0
20	405925	.	A	C	8	5	13	0	0	13	0	0
20	405928	.	A	G	5	0	5	0	8	13	0	0
20	406264	.	T	A	2	2	4	0	0	4	0	0
20	406278	.	T	A	1	2	3	0	0	3	0	0
20	409377	.	C	A	5	7	12	0	0	12	0	0
20	409524	.	C	T	4	8	12	0	1	13	0	0
20	410832	.	A	T	4	10	14	0	0	14	0	0
20	410981	.	A	T	6	13	19	0	0	19	0	0
20	411063	.	T	A	1	8	9	0	1	10	0	0
20	426390	.	T	C	1	1	2	0	0	2	0	0
20	426434	.	T	A	5	2	7	0	0	7	0	0
20	429984	.	G	A	2	1	3	0	1	4	0	0
20	430080	.	A	G	3	6	9	0	0	9	0	0
20	430539	.	C	T	0	1	1	0	0	1	0	0
20	431851	.	C	T	4	3	7	0	0	7	0	0
20	431886	.	C	T	0	1	1	0	2	3	0	0
20	432898	.	T	A	2	3	5	0	0	5	0	0
20	436661	.	T	C	0	3	3	0	0	3	0	0
20	438554	.	G	A	5	2	7	0	1	8	0	0
20	438613	.	G	A	2	2	4	0	0	4	0	0
20	474341	.	C	A	3	8	11	0	0	11	0	0
20	483866	.	C	T	1	0	1	0	0	1	0	0
20	522541	.	G	A	11	6	17	0	1	18	0	0
20	522778	.	C	T	1	2	3	0	0	3	0	0
20	522811	.	T	A	2	1	3	0	0	3	0	0
20	528561	.	C	T	10	5	15	0	1	16	0	0
20	530335	.	C	T	7	5	12	0	0	12	0	0
20	530405	.	G	A	0	6	6	0	10	16	0	0
20	530408	.	C	T	9	7	16	0	0	16	0	0
20	530443	.	C	T	12	6	18	0	0	18	0	0
20	530445	.	T	G	12	6	18	0	0	18	0	0
20	530534	.	C	G	5	4	9	0	0	9	0	0
20	530536	.	C	T	3	5	8	0	1	9	0	0
20	530624	.	G	T	3	10	13	0	0	13	0	0
20	555095	.	A	G	1	2	3	0	0	3	0	0
20	555785	.	C	A	1	2	3	0	0	3	0	0
20	555791	.	T	A	1	2	3	0	0	3	0	0
20	592190	.	G	A	1	4	5	0	0	5	0	0
20	592243	.	A	G	0	2	2	0	0	2	0	0
20	593685	.	G	A	0	3	3	0	2	5	0	0
20	593880	.	C	T	3	2	5	0	0	5	0	0
20	603599	.	T	C	0	1	1	0	0	1	0	0
20	603647	.	T	C	1	2	3	0	0	3	0	0
20	605171	.	A	T	1	0	1	0	0	1	0	0
20	605264	.	C	T	3	7	10	0	0	10	0	0
20	605291	.	C	T	1	6	7	0	0	7	0	0
20	605471	.	G	A	4	6	10	0	0	10	0	0
20	700683	.	C	T	1	2	3	0	0	3	0	0
20	700686	.	A	T	1	2	3	0	0	3	0	0
20	700899	.	C	A	15	6	21	0	1	22	0	0
20	700995	.	C	T	5	1	6	0	1	7	0	0
20	707767	.	C	T	2	1	3	0	0	3	0	0
20	742087	.	A	C	0	4	4	0	0	4	0	0
20	742126	.	T	C	0	1	1	0	0	1	0	0
20	752624	.	G	A	0	3	3	0	3	6	0	0
20	755725	.	G	A	0	1	1	0	0	1	0	0
20	757522	.	G	A	2	2	4	0	0	4	0	0
20	757525	.	C	A	1	2	3	0	1	4	0	0
20	761004	.	C	T	5	0	5	0	0	5	0	0
20	761006	.	G	C	0	5	5	0	0	5	0	0
20	764346	.	A	G	5	0	5	0	0	5	0	0
20	764355	.	G	A	1	5	6	0	0	6	0	0
20	764388	.	A	G	2	13	15	0	2	17	0	0
20	764436	.	T	C	2	7	9	0	0	9	0	0
20	764807	.	G	A	8	15	23	0	0	23	0	0
20	771986	.	C	G	7	1	8	0	0	8	0	0
20	772577	.	C	A	0	1	1	0	0	1	0	0
20	772700	.	C	T	0	2	2	0	0	2	0	0
20	775412	.	G	A	0	5	5	0	7	12	0	0
20	775487	.	C	T	13	12	25	0	0	25	0	0
20	775538	.	G	A	0	11	11	0	15	26	0	0
20	775562	.	C	T	10	10	20	0	0	20	0	0
20	775583	.	T	A	5	8	13	0	1	14	0	0
20	776171	.	C	T	16	25	41	0	2	43	0	0
20	776261	.	A	T	10	25	35	0	5	40	0	0
20	776630	.	G	T	15	7	22	0	1	23	0	0
20	776826	.	G	A	4	7	11	0	0	11	0	0
20	826672	.	C	T	1	2	3	0	0	3	0	0
20	826762	.	C	T	1	2	3	0	0	3	0	0
20	844590	.	G	A	1	1	2	0	0	2	0	0
20	844592	.	C	G	1	1	2	0	0	2	0	0
20	845654	.	T	C	2	3	5	0	0	5	0	0
20	845679	.	G	A	0	1	1	0	2	3	0	0
20	845708	.	T	C	1	0	1	0	0	1	0	0
20	847735	.	T	G	2	5	7	0	1	8	0	0
20	847758	.	T	A	4	4	8	0	1	9	0	0
20	847779	.	G	A	3	5	8	0	1	9	0	0
20	847820	.	G	A	0	6	6	0	5	11	0	0
20	847854	.	G	A	4	3	7	0	2	9	0	0
20	847887	.	T	A	4	5	9	0	0	9	0	0
20	847989	.	T	G	1	1	2	0	2	4	0	0
20	848017	.	T	C	1	2	3	0	0	3	0	0
20	851699	.	G	A	4	5	9	0	0	9	0	0
20	851746	.	G	A	5	6	11	0	0	11	0	0
20	851843	.	T	C	6	5	11	0	1	12	0	0
20	851876	.	C	T	10	10	20	0	0	20	0	0
20	852184	.	A	G	4	3	7	0	0	7	0	0
20	856170	.	G	A	7	4	11	0	0	11	0	0
20	856185	.	G	A	8	6	14	0	2	16	0	0
20	875008	.	C	G	7	5	12	0	0	12	0	0
20	875042	.	G	A	4	3	7	0	0	7	0	0
20	880430	.	G	A	10	4	14	0	0	14	0	0
20	880447	.	A	G	10	4	14	0	0	14	0	0
20	883163	.	C	T	0	2	2	0	3	5	0	0
20	884404	.	A	T	4	0	4	0	0	4	0	0
20	888058	.	T	C	1	1	2	0	0	2	0	0
20	892055	.	C	T	6	4	10	0	0	10	0	0
20	902647	.	A	G	6	5	11	0	0	11	0	0
20	902671	.	G	A	3	10	13	0	0	13	0	0
20	902712	.	A	T	6	10	16	0	0	16	0	0
20	908195	.	A	G	6	6	12	0	1	13	0	0
20	908294	.	A	G	5	5	10	0	2	12	0	0
20	908641	.	C	T	0	6	6	0	7	13	0	0
20	908717	.	G	A	5	7	12	0	0	12	0	0
20	944314	.	A	C	4	3	7	0	0	7	0	0
20	946681	.	G	A	1	3	4	0	0	4	0	0
20	1079035	.	G	A	1	2	3	0	0	3	0	0
20	1081952	.	G	T	5	3	8	0	0	8	0	0
20	1081960	.	G	A	4	5	9	0	0	9	0	0
20	1119955	.	A	G	1	8	9	0	0	9	0	0
20	1119975	.	C	G	3	5	8	0	1	9	0	0
20	1125057	.	A	G	7	7	14	0	0	14	0	0
20	1125135	.	G	A	1	6	7	0	12	19	0	0
20	1177879	.	A	T	9	9	18	0	0	18	0	0
20	1178040	.	T	A	3	4	7	0	0	7	0	0
20	1178041	.	T	C	3	4	7	0	0	7	0	0
20	1178725	.	A	G	1	2	3	0	0	3	0	0
20	1179196	.	T	C	3	6	9	0	0	9	0	0
20	1179404	.	T	G	2	2	4	0	0	4	0	0
20	1179485	.	T	C	4	7	11	0	0	11	0	0
20	1179577	.	C	T	0	4	4	0	3	7	0	0
20	1179715	.	A	C	10	0	10	0	9	19	0	0
20	1185942	.	G	A	0	2	2	0	1	3	0	0
20	1198485	.	C	T	5	6	11	0	1	12	0	0
20	1198558	.	A	T	4	11	15	0	1	16	0	0
20	1198819	.	T	A	5	8	13	7	0	20	0	0
20	1201917	.	A	T	4	4	8	0	0	8	0	0
20	1202099	.	T	C	2	3	5	0	0	5	0	0
20	1202107	.	C	T	3	3	6	0	0	6	0	0
20	1202134	.	A	T	5	2	7	0	0	7	0	0
20	1204020	.	T	G	5	9	14	0	0	14	0	0
20	1208852	.	C	T	0	3	3	0	1	4	0	0
20	1240552	.	A	T	1	4	5	0	0	5	0	0
20	1240684	.	G	A	5	2	7	0	0	7	0	0
20	1241478	.	A	T	3	5	8	0	0	8	0	0
20	1241596	.	T	G	4	3	7	0	0	7	0	0
20	1244021	.	T	A	2	3	5	0	0	5	0	0
20	1244101	.	T	C	1	2	3	0	0	3	0	0
20	1246641	.	C	A	1	1	2	0	0	2	0	0
20	1246870	.	C	T	0	2	2	0	0	2	0	0
20	1257193	.	G	A	6	4	10	0	0	10	0	0
20	1258054	.	G	A	1	3	4	0	0	4	0	0
20	1265240	.	A	G	2	2	4	0	0	4	0	0
20	1278796	.	G	A	7	15	22	0	0	22	0	0
20	1279033	.	G	A	14	5	19	0	1	20	0	0
20	1281278	.	G	T	3	4	7	0	0	7	0	0
20	1294012	.	T	G	8	6	14	0	0	14	0	0
20	1294062	.	C	G	11	10	21	0	1	22	0	0
20	1294569	.	T	C	6	1	7	0	3	10	0	0
20	1294735	.	T	C	5	3	8	1	0	9	0	0
20	1294863	.	T	G	11	6	17	0	1	18	0	0
20	1294903	.	C	G	10	6	16	0	0	16	0	0
20	1294970	.	A	G	13	14	27	0	1	28	0	0
20	1295302	.	T	C	2	5	7	0	0	7	0	0
20	1295840	.	G	A	12	15	27	0	0	27	0	0
20	1296022	.	G	C	15	6	21	0	1	24	2	0
20	1296114	.	G	A	10	18	28	0	1	29	0	0
20	1296139	.	A	G	12	16	28	0	1	29	0	0
20	1316764	.	A	G	5	5	10	0	0	10	0	0
20	1316860	.	G	C	0	4	4	0	4	8	0	0
20	1324404	.	G	A	2	2	4	0	0	4	0	0
20	1324976	.	C	A	0	2	2	0	0	2	0	0
20	1327545	.	A	T	8	7	15	0	0	15	0	0
20	1336992	.	A	C	2	0	2	0	0	2	0	0
20	1338988	.	T	G	2	0	2	0	9	11	0	0
20	1339066	.	G	A	0	4	4	0	5	9	0	0
20	1339084	.	G	A	3	5	8	0	0	8	0	0
20	1339657	.	T	C	5	5	10	0	0	10	0	0
20	1339798	.	G	A	5	4	9	0	0	9	0	0
20	1339843	.	C	T	2	5	7	0	2	9	0	0
20	1339924	.	G	A	2	3	5	0	0	5	0	0
20	1340015	.	G	A	0	5	5	0	7	12	0	0
20	1341782	.	G	A	1	3	4	0	0	4	0	0
20	1346873	.	T	C	0	1	1	0	0	1	0	0
20	1349264	.	A	T	2	2	4	0	0	4	0	0
20	1349947	.	G	A	0	6	6	0	3	9	0	0
20	1441815	.	A	C	14	12	26	0	1	32	5	0
20	1441825	.	T	C	14	14	28	0	2	30	0	0
20	1442358	.	G	T	7	11	18	0	0	18	0	0
20	1442468	.	G	A	5	8	13	0	1	14	0	0
20	1442515	.	A	T	9	8	17	0	0	17	0	0
20	1442522	.	C	A	10	5	15	0	0	15	0	0
20	1442582	.	G	T	6	8	14	0	0	14	0	0
20	1442624	.	C	T	12	6	18	0	2	20	0	0
20	1454065	.	T	C	6	9	15	1	1	17	0	0
20	1455104	.	G	A	2	4	6	0	2	8	0	0
20	1460979	.	C	A	3	10	13	0	1	14	0	0
20	1476772	.	C	T	4	8	12	0	0	12	0	0
20	1487612	.	T	C	2	0	2	0	0	2	0	0
20	1513605	.	A	G	10	8	18	0	1	19	0	0
20	1513617	.	G	A	6	7	13	0	0	13	0	0
20	1518414	.	G	A	3	6	9	0	0	9	0	0
20	1519699	.	A	G	3	9	12	0	1	13	0	0
20	2646893	.	A	G	5	2	7	0	0	7	0	0
20	2716149	.	C	A	9	6	15	0	1	16	0	0
20	2972260	.	A	G	0	0	0	0	24	24	0	0
20	2975748	.	A	G	9	2	11	0	1	12	0	0
20	2976077	.	A	G	8	1	9	0	0	9	0	0
20	2976094	.	A	G	6	1	7	0	0	7	0	0
20	2976257	.	A	G	16	6	22	0	1	23	0	0
20	2976263	.	A	G	18	5	23	0	0	23	0	0
20	2976909	.	C	A	18	8	26	1	0	27	0	0
20	2977100	.	A	G	13	0	13	0	14	27	0	0
20	2977112	.	A	G	17	12	29	0	1	30	0	0
20	2977257	.	C	T	17	18	35	0	1	36	0	0
20	2977417	.	C	A	21	0	21	0	1	22	0	0
20	2977418	.	C	A	21	0	21	0	1	22	0	0
20	2983175	.	T	C	0	3	3	0	0	3	0	0
20	3020423	.	G	A	1	6	7	0	0	7	0	0
20	3086745	.	A	C	2	2	4	0	1	5	0	0
20	3828563	.	T	C	1	1	2	0	2	4	0	0
20	3916456	.	T	A	10	7	17	0	0	17	0	0
20	3916464	.	C	T	11	8	19	0	0	19	0	0
20	3916621	.	T	G	5	10	15	0	1	16	0	0
20	3920746	.	T	G	12	8	20	0	1	21	0	0
20	3920873	.	T	A	8	4	12	0	3	15	0	0
20	3920875	.	G	A	7	6	13	0	2	15	0	0
20	3921127	.	A	T	9	9	18	0	1	19	0	0
20	3921184	.	G	A	4	8	12	0	0	12	0	0
20	3921202	.	T	C	2	3	5	0	0	5	0	0
20	3923735	.	C	G	8	6	14	0	1	15	0	0
20	3923983	.	G	A	0	3	3	0	10	13	0	0
20	3924098	.	A	T	16	6	22	0	1	23	0	0
20	3924349	.	G	A	7	6	13	0	1	14	0	0
20	3924430	.	G	A	0	7	7	0	9	16	0	0
20	3924528	.	C	A	4	8	12	0	0	12	0	0
20	3924824	.	A	C	1	2	3	0	0	3	0	0
20	3924884	.	G	T	1	4	5	0	0	5	0	0
20	3924943	.	T	G	9	0	9	0	5	14	0	0
20	3925146	.	A	T	6	5	11	0	0	11	0	0
20	3925537	.	T	C	6	1	7	0	1	8	0	0
20	3925544	.	T	A	3	8	11	0	1	12	0	0
20	3925842	.	C	A	9	5	14	0	1	15	0	0
20	3925889	.	C	T	3	8	11	0	0	11	0	0
20	3925907	.	T	A	5	1	6	0	0	6	0	0
20	3925934	.	C	T	1	3	4	0	0	4	0	0
20	3925942	.	A	G	3	4	7	0	0	7	0	0
20	3926020	.	C	T	4	3	7	0	0	7	0	0
20	3926337	.	C	T	2	2	4	2	1	7	0	0
20	3926721	.	T	C	7	3	10	0	0	10	0	0
20	3926736	.	T	A	8	4	12	0	0	12	0	0
20	3926907	.	T	G	13	16	29	0	1	30	0	0
20	3926928	.	T	A	16	18	34	0	0	34	0	0
20	3926951	.	A	G	19	16	35	0	2	37	0	0
20	3927267	.	C	A	21	15	36	0	1	38	1	0
20	3927326	.	A	G	9	12	21	0	2	23	0	0
20	3927446	.	C	G	8	12	20	0	0	20	0	0
20	3947006	.	T	G	2	1	3	0	0	3	0	0
20	3947058	.	C	A	4	3	7	0	0	7	0	0
20	3947100	.	C	T	1	3	4	0	0	4	0	0
20	3947116	.	A	G	0	1	1	0	1	2	0	0
20	3953593	.	T	C	8	8	16	0	0	16	0	0
20	3954846	.	A	T	4	2	6	0	0	6	0	0
20	3954870	.	C	T	0	4	4	0	4	8	0	0
20	3971246	.	G	C	1	1	2	0	0	2	0	0
20	4000366	.	C	T	2	3	5	0	0	5	0	0
20	4009491	.	C	T	1	2	3	0	0	3	0	0
20	4010211	.	G	T	6	3	9	0	1	10	0	0
20	4010217	.	C	T	3	7	10	0	1	11	0	0
20	4010256	.	T	C	7	4	11	0	1	12	0	0
20	4010462	.	C	T	7	8	15	0	0	15	0	0
20	4010573	.	A	G	2	3	5	0	1	6	0	0
20	4030825	.	G	A	5	2	7	0	0	7	0	0
20	4035507	.	A	C	2	0	2	0	0	2	0	0
20	4035837	.	G	A	8	5	13	0	0	13	0	0
20	4035858	.	G	C	9	3	12	0	0	12	0	0
20	4036272	.	G	T	1	2	3	0	0	3	0	0
20	4036462	.	A	G	1	2	3	0	0	3	0	0
20	4036587	.	T	C	3	3	6	0	0	6	0	0
20	4036720	.	T	C	3	5	8	0	0	8	0	0
20	4036795	.	T	C	1	2	3	0	1	4	0	0
20	4036889	.	A	T	2	4	6	0	0	6	0	0
20	4037016	.	T	C	7	3	10	0	0	10	0	0
20	4037057	.	G	A	3	4	7	0	0	7	0	0
20	4037409	.	T	A	2	3	5	0	0	5	0	0
20	4037461	.	G	T	4	2	6	0	0	6	0	0
20	4037708	.	C	T	0	4	4	0	5	9	0	0
20	4037942	.	C	T	4	3	7	0	0	7	0	0
20	4043508	.	C	G	2	8	10	0	1	11	0	0
20	4051818	.	C	T	8	10	18	0	0	18	0	0
20	4052295	.	A	G	2	0	2	0	3	5	0	0
20	4052313	.	T	C	2	2	4	0	0	4	0	0
20	4052854	.	G	C	4	5	9	0	0	9	0	0
20	4053012	.	G	A	0	6	6	0	6	12	0	0
20	4153436	.	A	G	3	2	5	0	0	5	0	0
20	4157066	.	A	C	2	2	4	0	0	4	0	0
20	4174220	.	G	A	1	2	3	0	0	3	0	0
20	4175807	.	T	A	1	4	5	0	0	5	0	0
20	4176863	.	G	A	0	1	1	0	0	1	0	0
20	4177035	.	G	A	0	1	1	0	0	1	0	0
20	4393455	.	C	T	1	3	4	0	0	4	0	0
20	5065746	.	G	A	4	4	8	0	0	8	0	0
20	5065776	.	T	A	3	4	7	0	0	7	0	0
20	5066007	.	T	C	2	5	7	0	0	7	0	0
20	5067424	.	A	T	6	0	6	0	0	6	0	0
20	5069500	.	T	C	4	2	6	0	0	6	0	0
20	5094207	.	G	A	0	2	2	0	1	3	0	0
20	5094283	.	A	T	2	6	8	0	0	8	0	0
20	5158552	.	A	T	0	2	2	0	0	2	0	0
20	5158670	.	T	C	0	2	2	0	0	2	0	0
20	5158691	.	C	T	0	1	1	0	3	4	0	0
20	5158705	.	A	G	4	1	5	0	0	5	0	0
20	5159001	.	A	C	2	5	7	0	0	7	0	0
20	5163286	.	C	T	1	0	1	0	0	1	0	0
20	5228120	.	A	G	0	2	2	0	0	2	0	0
20	5228516	.	G	A	4	7	11	0	0	11	0	0
20	5237369	.	A	T	2	4	6	0	0	6	0	0
20	5237385	.	G	A	2	2	4	0	0	4	0	0
20	5330859	.	C	G	7	8	15	0	0	15	0	0
20	5330875	.	A	G	8	6	14	0	1	15	0	0
20	5330990	.	T	A	6	2	8	0	0	8	0	0
20	5331095	.	A	G	6	8	14	0	0	14	0	0
20	5331112	.	G	C	5	7	12	0	1	13	0	0
20	5331186	.	T	C	4	0	4	0	4	8	0	0
20	5332145	.	C	G	5	2	7	0	0	7	0	0
20	5332551	.	G	A	0	3	3	0	1	4	0	0
20	5332682	.	A	T	2	3	5	0	0	5	0	0
20	5332728	.	G	A	2	1	3	0	0	3	0	0
20	5332742	.	A	C	4	2	6	0	0	6	0	0
20	5332901	.	T	C	3	0	3	0	4	7	0	0
20	5333317	.	A	G	0	3	3	0	0	3	0	0
20	5333405	.	T	G	4	4	8	0	1	9	0	0
20	5337006	.	G	A	3	1	4	0	0	4	0	0
20	5348081	.	G	A	4	3	7	0	0	7	0	0
20	5354306	.	T	A	1	0	1	0	0	1	0	0
20	5356870	.	G	T	0	2	2	0	0	2	0	0
20	5358482	.	A	G	0	1	1	0	0	1	0	0
20	5369097	.	A	G	2	2	4	0	0	4	0	0
20	5369099	.	T	C	2	2	4	0	0	4	0	0
20	5390784	.	A	T	2	4	6	0	0	6	0	0
20	5391138	.	G	T	6	5	11	0	3	14	0	0
20	5394584	.	G	A	6	3	9	0	0	9	0	0
20	5563813	.	C	T	1	2	3	0	0	3	0	0
20	5563947	.	A	C	2	4	6	0	0	6	0	0
20	5564002	.	T	C	1	3	4	0	0	4	0	0
20	5564233	.	T	C	2	3	5	0	0	5	0	0
20	5564292	.	A	G	2	0	2	0	8	10	0	0
20	5679786	.	T	C	1	4	5	0	0	5	0	0
20	5696935	.	C	T	4	2	6	0	1	7	0	0
20	5696971	.	C	A	7	3	10	0	0	10	0	0
20	5700002	.	C	T	1	2	3	0	0	3	0	0
20	5742118	.	C	T	2	5	7	0	0	7	0	0
20	5742169	.	T	C	1	2	3	0	0	3	0	0
20	5744339	.	T	C	1	1	2	0	0	2	0	0
20	5921278	.	T	C	9	9	18	0	2	20	0	0
20	6100614	.	A	T	2	1	3	0	0	3	0	0
20	6100689	.	T	C	0	1	1	0	0	1	0	0
20	6102938	.	C	T	2	0	2	0	0	2	0	0
20	6103258	.	T	C	1	0	1	0	2	3	0	0
20	6121569	.	T	C	1	2	3	0	0	3	0	0
20	6122336	.	G	T	1	4	5	0	0	5	0	0
20	6122357	.	C	T	0	2	2	0	1	3	0	0
20	6164060	.	A	T	9	8	17	0	0	17	0	0
20	6164432	.	T	A	6	3	9	0	2	11	0	0
20	6164484	.	T	G	12	12	24	0	0	24	0	0
20	6164569	.	A	T	7	10	17	0	1	18	0	0
20	6164608	.	C	A	15	9	24	0	1	25	0	0
20	6164923	.	C	T	7	9	16	0	1	17	0	0
20	6165289	.	A	C	13	0	13	0	13	26	0	0
20	6165412	.	T	A	7	4	11	0	1	12	0	0
20	6165675	.	T	C	10	12	22	0	1	23	0	0
20	6165684	.	G	A	14	13	27	0	0	27	0	0
20	6165825	.	A	C	15	12	27	0	0	27	0	0
20	6165864	.	A	G	16	8	24	0	0	24	0	0
20	6166522	.	A	T	3	6	9	1	0	10	0	0
20	6166595	.	T	A	8	10	18	0	1	19	0	0
20	6166757	.	C	A	6	7	13	0	0	13	0	0
20	6178530	.	C	T	11	5	16	0	1	17	0	0
20	6341343	.	C	T	1	1	2	0	0	2	0	0
20	6341346	.	C	T	0	1	1	0	1	2	0	0
20	6347143	.	G	A	2	0	2	0	0	2	0	0
20	6347246	.	C	T	6	3	9	0	0	9	0	0
20	6380081	.	T	C	0	1	1	0	0	1	0	0
20	6380084	.	T	C	0	0	0	0	1	1	0	0
20	6380203	.	C	T	0	1	1	0	1	2	0	0
20	6380210	.	G	A	0	1	1	0	1	2	0	0
20	6410812	.	C	T	0	1	1	0	0	1	0	0
20	6425001	.	G	A	0	1	1	0	0	1	0	0
20	6425067	.	A	G	2	6	8	0	0	8	0	0
20	6425187	.	C	T	0	1	1	0	1	2	0	0
20	6437623	.	G	A	1	0	1	0	0	1	0	0
20	6437641	.	T	C	1	0	1	0	0	1	0	0
20	6437749	.	C	A	0	1	1	0	1	2	0	0
20	8060349	.	A	G	1	0	1	0	2	3	0	0
20	8122772	.	A	T	5	4	9	0	1	10	0	0
20	8122938	.	T	A	4	4	8	0	0	8	0	0
20	8123047	.	G	A	2	3	5	0	0	5	0	0
20	8138389	.	C	G	4	1	5	0	0	5	0	0
20	8147222	.	C	T	0	1	1	0	0	1	0	0
20	8154178	.	G	A	5	4	9	0	0	9	0	0
20	8154562	.	A	G	3	5	8	0	0	8	0	0
20	8245716	.	G	A	1	1	2	0	0	2	0	0
20	9109195	.	T	C	1	0	1	0	0	1	0	0
20	9190823	.	T	G	6	0	6	1	15	22	0	0
20	9190826	.	A	C	6	0	6	1	15	22	0	0
20	9420974	.	A	T	12	11	23	2	0	26	1	0
20	9420976	.	C	T	12	12	24	2	0	26	0	0
20	14003544	.	T	A	0	2	2	0	1	3	0	0
20	15876778	.	A	G	12	15	27	0	0	27	0	0
20	15876812	.	G	A	12	14	26	0	0	26	0	0
20	15876824	.	C	A	0	11	11	0	7	18	0	0
20	15911808	.	A	G	2	1	3	0	0	3	0	0
20	15911880	.	C	T	11	10	21	0	0	21	0	0
20	15912102	.	T	C	6	13	19	0	4	23	0	0
20	15912167	.	A	G	11	9	20	0	0	20	0	0
20	15912192	.	C	T	0	6	6	0	11	17	0	0
20	15912906	.	T	C	1	2	3	0	0	3	0	0
20	15922331	.	T	C	6	0	6	0	9	15	0	0
20	15922364	.	C	G	18	8	26	0	2	28	0	0
20	15933168	.	G	C	5	4	9	0	0	9	0	0
20	15933223	.	C	A	5	10	15	0	1	16	0	0
20	15933229	.	T	C	6	10	16	0	0	16	0	0
20	15933258	.	C	T	10	9	19	0	3	22	0	0
20	15933289	.	G	A	10	5	15	0	3	18	0	0
20	15933374	.	C	T	10	5	15	0	1	16	0	0
20	15933424	.	T	C	11	9	20	0	0	20	0	0
20	15933566	.	G	A	4	8	12	0	2	14	0	0
20	15933659	.	C	T	4	6	10	0	0	10	0	0
20	15934026	.	G	A	7	13	20	0	0	20	0	0
20	15934456	.	G	T	7	12	19	0	2	21	0	0
20	15934474	.	A	C	7	0	7	0	12	19	0	0
20	15934592	.	T	C	6	3	9	0	2	11	0	0
20	15935650	.	A	C	3	3	6	0	0	6	0	0
20	15936989	.	G	T	7	5	12	0	0	13	1	0
20	15937165	.	A	T	1	3	4	0	0	4	0	0
20	15937178	.	C	T	0	2	2	0	2	4	0	0
20	15937278	.	C	G	1	5	6	0	0	6	0	0
20	15937351	.	G	A	1	2	3	0	0	3	0	0
20	15937445	.	G	T	2	3	5	0	0	5	0	0
20	15937567	.	G	T	1	3	4	0	0	4	0	0
20	15937735	.	A	T	3	4	7	0	0	7	0	0
20	15937763	.	A	G	3	5	8	0	1	9	0	0
20	15937839	.	T	G	3	7	10	0	0	10	0	0
20	15937849	.	G	A	3	5	8	0	0	8	0	0
20	15937883	.	G	A	4	2	6	0	0	6	0	0
20	15937926	.	C	A	3	3	6	0	0	6	0	0
20	15937962	.	A	G	4	2	6	0	0	6	0	0
20	15937971	.	T	C	4	0	4	0	2	6	0	0
20	15947267	.	G	C	1	0	1	0	2	3	0	0
20	15970150	.	A	G	1	4	5	0	0	5	0	0
20	15970177	.	C	T	2	4	6	0	0	6	0	0
20	15970249	.	T	C	2	0	2	0	1	3	0	0
20	15973728	.	T	C	2	0	2	0	1	3	0	0
20	16006264	.	C	T	0	2	2	0	0	2	0	0
20	16020682	.	A	G	1	3	4	0	0	4	0	0
20	16156347	.	A	G	2	2	4	0	0	4	0	0
20	16156367	.	A	G	2	2	4	0	0	4	0	0
20	16163282	.	C	T	6	4	10	0	0	10	0	0
20	16163333	.	T	C	8	1	9	0	14	23	0	0
20	16163384	.	A	G	12	19	31	0	0	31	0	0
20	16171203	.	A	T	5	2	7	0	0	7	0	0
20	16173957	.	T	C	3	3	6	0	0	6	0	0
20	16173984	.	T	G	2	0	2	0	3	5	0	0
20	16177754	.	A	G	1	0	1	0	4	5	0	0
20	16180064	.	C	A	7	6	13	0	0	13	0	0
20	16180070	.	G	C	1	6	7	0	5	12	0	0
20	16180127	.	T	C	4	4	8	0	0	8	0	0
20	16182806	.	C	T	1	1	2	0	0	2	0	0
20	16182839	.	G	A	0	4	4	0	3	7	0	0
20	16193776	.	A	G	1	2	3	0	1	4	0	0
20	16193899	.	C	T	3	1	4	0	1	5	0	0
20	16201015	.	C	A	9	5	14	0	2	16	0	0
20	16201111	.	G	A	1	4	5	0	4	9	0	0
20	16201200	.	C	T	7	12	19	0	2	21	0	0
20	16201394	.	G	A	8	12	20	0	0	20	0	0
20	16201709	.	A	G	4	10	14	0	0	14	0	0
20	16201759	.	T	C	6	8	14	0	0	14	0	0
20	16427895	.	T	C	1	2	3	0	0	3	0	0
20	16437895	.	A	G	4	9	13	0	0	13	0	0
20	16437958	.	A	G	6	5	11	0	0	11	0	0
20	16438097	.	G	A	13	11	24	0	0	24	0	0
20	16438119	.	T	A	10	12	22	0	1	23	0	0
20	16438252	.	G	A	8	8	16	0	2	18	0	0
20	16438557	.	A	C	12	8	20	0	1	21	0	0
20	16438837	.	T	C	7	0	7	0	5	12	0	0
20	16438854	.	T	C	5	5	10	0	1	11	0	0
20	16441658	.	C	T	3	5	8	0	0	8	0	0
20	16446685	.	A	G	3	1	4	0	0	4	0	0
20	16447831	.	A	G	0	2	2	0	0	2	0	0
20	16448913	.	G	T	10	4	14	0	1	15	0	0
20	16477963	.	A	G	3	2	5	0	0	5	0	0
20	16477973	.	A	G	2	4	6	0	1	7	0	0
20	16478011	.	A	G	4	4	8	0	0	8	0	0
20	16478577	.	G	A	6	2	8	0	1	9	0	0
20	16478612	.	T	C	4	0	4	0	0	4	0	0
20	16498566	.	T	C	1	5	6	0	0	6	0	0
20	16498767	.	A	G	5	7	12	0	0	12	0	0
20	16498932	.	C	A	2	2	4	0	0	4	0	0
20	16639964	.	G	A	0	12	12	0	7	19	0	0
20	16640011	.	G	A	5	3	8	0	0	8	0	0
20	16644943	.	A	G	4	1	5	0	7	12	0	0
20	16645004	.	T	C	4	3	7	0	1	8	0	0
20	16652964	.	G	A	0	0	0	0	1	1	0	0
20	16660327	.	G	C	11	11	22	0	2	24	0	0
20	16660462	.	A	T	13	10	23	0	0	23	0	0
20	16660567	.	G	A	8	10	18	0	0	18	0	0
20	16660652	.	G	A	9	17	26	0	0	26	0	0
20	16660707	.	G	A	0	13	13	0	12	25	0	0
20	16734343	.	C	T	12	16	28	0	2	30	0	0
20	16737512	.	C	T	11	12	23	0	1	24	0	0
20	16740834	.	G	A	12	11	23	0	0	23	0	0
20	16771318	.	C	T	13	12	25	0	2	27	0	0
20	16774970	.	T	A	29	29	58	0	2	61	1	0
20	16775173	.	C	T	25	19	44	0	3	47	0	0
20	16832788	.	G	T	8	7	15	0	0	15	0	0
20	16834572	.	C	T	0	7	7	0	6	13	0	0
20	16834778	.	T	C	6	6	12	0	0	12	0	0
20	16849100	.	C	A	0	2	2	0	3	5	0	0
20	16884078	.	C	T	1	4	5	0	0	5	0	0
20	16903806	.	T	A	1	1	2	0	0	2	0	0
20	16903878	.	T	A	2	1	3	0	0	3	0	0
20	16906564	.	C	T	12	8	20	0	0	20	0	0
20	17740215	.	G	A	9	12	21	0	0	21	0	0
20	17798906	.	T	C	12	15	27	0	5	32	0	0
20	17799127	.	C	A	17	14	31	0	2	33	0	0
20	17800493	.	T	C	2	8	10	0	2	12	0	0
20	17800843	.	A	C	5	4	9	0	1	10	0	0
20	17800867	.	T	C	2	0	2	0	0	2	0	0
20	17802895	.	G	A	15	14	29	0	0	29	0	0
20	17802964	.	A	G	14	1	15	0	10	25	0	0
20	17803572	.	T	C	9	10	19	0	2	21	0	0
20	17809141	.	T	C	21	21	42	0	3	45	0	0
20	17813702	.	C	T	3	5	8	0	0	8	0	0
20	17817433	.	T	G	29	17	46	0	3	49	0	0
20	17817886	.	T	A	13	18	31	0	0	31	0	0
20	17817926	.	G	T	15	15	30	0	0	30	0	0
20	17818129	.	G	C	8	17	25	0	0	25	0	0
20	17818159	.	A	T	5	6	11	0	1	12	0	0
20	17818177	.	A	C	7	7	14	0	0	14	0	0
20	17819008	.	T	C	22	10	32	0	1	33	0	0
20	18249646	.	T	C	9	8	17	0	0	17	0	0
20	18255673	.	G	T	3	7	10	0	1	11	0	0
20	18255748	.	A	G	10	5	15	0	2	17	0	0
20	18255755	.	A	G	12	7	19	0	0	19	0	0
20	18255929	.	A	G	11	0	11	0	10	21	0	0
20	18255931	.	A	T	11	8	19	0	2	21	0	0
20	18256068	.	C	T	1	3	4	0	1	5	0	0
20	18256170	.	G	A	5	5	10	0	0	10	0	0
20	18312860	.	C	T	12	12	24	0	0	24	0	0
20	18354627	.	C	T	5	6	11	0	1	12	0	0
20	18373014	.	T	G	2	3	5	0	0	5	0	0
20	18376800	.	C	T	1	2	3	0	0	3	0	0
20	18392845	.	C	T	14	16	30	0	1	31	0	0
20	18393128	.	G	A	7	9	16	0	1	17	0	0
20	18393132	.	A	C	6	9	15	0	0	15	0	0
20	18393249	.	T	C	13	7	20	0	1	21	0	0
20	18393359	.	A	T	13	9	22	0	0	22	0	0
20	18393376	.	C	T	15	7	22	0	0	22	0	0
20	18396134	.	A	G	3	2	5	0	0	5	0	0
20	18413987	.	T	C	3	0	3	0	13	16	0	0
20	18417768	.	G	A	7	10	17	0	0	17	0	0
20	18417777	.	T	C	6	10	16	0	1	17	0	0
20	18431770	.	T	C	0	0	0	0	1	1	0	0
20	18432732	.	C	T	3	4	7	0	2	9	0	0
20	18443489	.	T	C	3	2	5	0	0	5	0	0
20	18443543	.	C	G	0	1	1	0	3	4	0	0
20	18443554	.	C	T	0	1	1	0	1	2	0	0
20	18456785	.	C	T	1	3	4	0	0	4	0	0
20	18456791	.	T	C	1	3	4	0	0	4	0	0
20	18459961	.	G	A	4	4	8	0	0	8	0	0
20	18459976	.	C	T	5	5	10	0	0	10	0	0
20	18465958	.	G	T	1	2	3	0	0	3	0	0
20	18535350	.	G	A	3	3	6	0	0	6	0	0
20	18551728	.	T	A	15	9	24	0	2	26	0	0
20	18591704	.	G	A	11	22	33	0	1	34	0	0
20	18591716	.	A	C	8	21	29	0	0	29	0	0
20	18591743	.	A	T	2	11	13	0	0	13	0	0
20	18594958	.	C	A	24	24	48	0	0	48	0	0
20	18669605	.	T	G	0	1	1	0	0	1	0	0
20	18672033	.	G	A	2	8	10	0	0	10	0	0
20	18672064	.	C	T	4	14	18	0	0	18	0	0
20	18672094	.	T	C	6	14	20	0	1	21	0	0
20	18672162	.	G	A	5	12	17	0	0	17	0	0
20	18672610	.	C	G	3	2	5	0	0	5	0	0
20	18672733	.	A	T	10	13	23	0	1	24	0	0
20	18672970	.	G	A	5	12	17	0	1	18	0	0
20	18673132	.	C	T	6	12	18	0	2	20	0	0
20	18683158	.	T	C	7	8	15	0	1	16	0	0
20	18683177	.	A	G	5	0	5	0	3	8	0	0
20	18684760	.	G	A	11	10	21	0	0	21	0	0
20	18684769	.	G	A	12	11	23	0	0	23	0	0
20	18685235	.	C	G	8	11	19	0	1	20	0	0
20	18685256	.	G	A	5	7	12	0	0	12	0	0
20	18685279	.	G	C	0	6	6	0	4	10	0	0
20	18708770	.	T	C	16	16	32	0	1	33	0	0
20	18713016	.	C	T	22	21	43	0	0	43	0	0
20	18713067	.	T	C	13	15	28	0	5	33	0	0
20	18721383	.	A	T	4	3	7	0	0	7	0	0
20	18721788	.	C	T	15	6	21	0	0	21	0	0
20	18721910	.	G	A	13	12	25	0	0	25	0	0
20	18722565	.	A	T	18	14	32	0	3	35	0	0
20	18722652	.	T	A	9	5	14	0	0	14	0	0
20	18722860	.	A	T	11	4	15	0	1	16	0	0
20	18722943	.	G	A	7	3	10	0	0	10	0	0
20	18723105	.	C	T	17	10	27	0	2	29	0	0
20	18723277	.	T	C	11	11	22	0	0	22	0	0
20	18723383	.	A	T	13	10	23	0	0	23	0	0
20	18723401	.	T	C	5	0	5	0	15	20	0	0
20	18723459	.	T	C	5	10	15	0	0	15	0	0
20	18723511	.	T	C	5	5	10	0	0	10	0	0
20	18727506	.	T	C	11	3	14	0	0	14	0	0
20	18730498	.	G	A	10	10	20	0	1	21	0	0
20	18730840	.	T	C	14	6	20	0	1	21	0	0
20	18731068	.	C	T	13	12	25	0	1	26	0	0
20	18747062	.	C	A	0	2	2	0	0	2	0	0
20	18747199	.	C	A	2	2	4	0	0	4	0	0
20	18747210	.	G	A	2	2	4	0	0	4	0	0
20	18756047	.	A	T	4	2	6	0	0	6	0	0
20	18756069	.	A	G	5	3	8	0	0	8	0	0
20	18756680	.	T	C	2	2	4	0	0	4	0	0
20	18801644	.	G	A	2	5	7	0	0	7	0	0
20	18801670	.	G	A	2	2	4	0	0	4	0	0
20	18802438	.	A	G	3	6	9	0	0	9	0	0
20	18802603	.	C	T	1	2	3	0	0	3	0	0
20	18802651	.	G	A	2	3	5	0	1	6	0	0
20	18915249	.	C	T	5	6	11	0	1	12	0	0
20	18947388	.	A	G	11	10	21	0	1	22	0	0
20	18958106	.	C	G	3	14	17	0	0	17	0	0
20	18958420	.	T	C	11	9	20	0	0	20	0	0
20	18958433	.	G	A	1	9	10	0	12	22	0	0
20	18958477	.	G	A	0	5	5	0	7	12	0	0
20	18961838	.	C	T	4	5	9	0	0	9	0	0
20	18968826	.	C	T	11	10	21	0	0	21	0	0
20	19058500	.	A	G	2	7	9	0	0	9	0	0
20	19431561	.	A	G	2	0	2	0	2	4	0	0
20	20275095	.	A	T	0	4	4	0	0	4	0	0
20	20277324	.	T	C	6	2	8	0	0	8	0	0
20	20602232	.	T	C	9	3	12	0	0	12	0	0
20	20605071	.	T	C	1	6	7	0	0	7	0	0
20	21638431	.	C	A	2	3	5	0	0	5	0	0
20	21638575	.	T	C	2	7	9	0	0	9	0	0
20	21638903	.	T	C	2	2	4	0	0	4	0	0
20	21656284	.	T	C	1	0	1	0	2	3	0	0
20	21815659	.	G	T	6	11	17	0	1	18	0	0
20	21815986	.	C	T	0	7	7	0	17	24	0	0
20	21816061	.	C	G	9	11	20	0	2	22	0	0
20	21819062	.	T	C	17	18	35	0	2	37	0	0
20	21839504	.	G	A	10	3	13	0	1	14	0	0
20	21841312	.	G	A	2	0	2	0	0	2	0	0
20	21841316	.	G	T	2	0	2	0	0	2	0	0
20	21855195	.	T	C	4	3	7	0	1	8	0	0
20	21862963	.	C	T	2	17	19	0	17	36	0	0
20	21862975	.	C	T	1	7	8	0	23	31	0	0
20	21872945	.	A	G	2	0	2	0	1	3	0	0
20	21872990	.	G	A	2	5	7	0	0	7	0	0
20	21875111	.	G	A	2	3	5	0	0	5	0	0
20	21875162	.	G	A	7	7	14	0	0	14	0	0
20	21875165	.	T	G	7	7	14	0	0	14	0	0
20	21875411	.	C	A	3	2	5	0	0	5	0	0
20	21910005	.	C	T	0	8	8	0	14	22	0	0
20	22045260	.	A	C	1	5	6	0	0	6	0	0
20	22061949	.	C	T	1	2	3	0	0	3	0	0
20	22166512	.	A	G	5	4	9	0	0	9	0	0
20	22174303	.	T	A	2	2	4	0	0	4	0	0
20	22175326	.	G	A	6	2	8	0	0	8	0	0
20	22175625	.	T	C	7	3	10	0	0	10	0	0
20	22175815	.	T	C	8	5	13	0	0	13	0	0
20	22175830	.	G	A	8	3	11	0	2	13	0	0
20	22179962	.	T	A	3	9	12	0	0	12	0	0
20	22186632	.	G	A	5	9	14	0	0	14	0	0
20	22186738	.	G	A	8	11	19	0	0	19	0	0
20	22186765	.	C	G	7	11	18	0	2	20	0	0
20	22186886	.	A	G	8	4	12	0	0	12	0	0
20	22186914	.	A	G	10	8	18	0	0	18	0	0
20	22186971	.	C	T	11	10	21	0	0	21	0	0
20	22186973	.	C	T	11	10	21	0	0	21	0	0
20	22187233	.	T	C	12	14	26	0	1	27	0	0
20	22191361	.	A	T	15	12	27	0	1	28	0	0
20	22191376	.	A	G	12	12	24	0	2	26	0	0
20	22191493	.	T	C	12	0	12	0	4	16	0	0
20	22193013	.	C	A	0	7	7	0	10	17	0	0
20	22194385	.	A	T	6	5	11	0	0	11	0	0
20	22194395	.	G	A	6	3	9	0	0	9	0	0
20	22196960	.	T	G	2	3	5	0	0	5	0	0
20	22198957	.	C	A	3	2	5	0	0	5	0	0
20	22336000	.	G	A	1	2	3	0	0	3	0	0
20	22369090	.	A	G	1	2	3	0	0	3	0	0
20	22435609	.	T	A	5	2	7	0	0	7	0	0
20	22435672	.	T	C	4	2	6	0	0	6	0	0
20	22435789	.	G	A	1	6	7	0	1	8	0	0
20	22435893	.	T	A	6	3	9	0	0	9	0	0
20	22435901	.	C	T	5	4	9	0	0	9	0	0
20	22436403	.	T	G	1	2	3	0	0	3	0	0
20	22436613	.	G	A	1	4	5	0	0	5	0	0
20	22436815	.	G	A	1	2	3	0	0	3	0	0
20	22442741	.	T	C	1	0	1	0	0	1	0	0
20	22483771	.	T	C	2	3	5	0	0	5	0	0
20	22484279	.	A	G	6	4	10	0	0	10	0	0
20	22709610	.	C	A	15	11	26	0	2	28	0	0
20	22709685	.	T	A	20	9	29	0	0	29	0	0
20	22722200	.	C	A	16	12	28	0	2	30	0	0
20	22722255	.	G	C	12	10	22	0	0	22	0	0
20	22730689	.	C	G	7	4	11	0	0	11	0	0
20	22734031	.	G	A	0	8	8	0	13	21	0	0
20	22734052	.	G	A	0	13	13	0	14	27	0	0
20	22736673	.	C	T	21	20	41	0	0	41	0	0
20	22738204	.	C	A	5	11	16	0	0	16	0	0
20	22739946	.	C	A	24	19	43	0	2	45	0	0
20	22740056	.	C	T	14	15	29	0	2	31	0	0
20	22740140	.	C	T	15	18	33	0	0	33	0	0
20	22740230	.	A	G	19	21	40	0	1	41	0	0
20	22740533	.	A	T	20	7	27	0	0	27	0	0
20	22740567	.	A	G	11	0	11	0	22	33	0	0
20	22800759	.	G	A	1	0	1	0	0	1	0	0
20	22843640	.	A	G	3	3	6	0	0	6	0	0
20	22907915	.	C	T	1	1	2	0	0	2	0	0
20	23021287	.	G	T	3	7	10	0	0	10	0	0
20	23021292	.	A	T	3	7	10	0	0	10	0	0
20	23023364	.	G	A	10	9	19	0	0	19	0	0
20	23023471	.	C	T	11	14	25	0	0	25	0	0
20	23023482	.	A	G	12	9	21	0	0	21	0	0
20	23023623	.	G	A	5	6	11	0	0	11	0	0
20	23023641	.	A	G	5	5	10	0	0	10	0	0
20	23023670	.	T	C	7	1	8	0	8	16	0	0
20	23023835	.	A	G	10	9	19	0	0	19	0	0
20	23024096	.	G	A	2	7	9	0	1	10	0	0
20	23026133	.	C	T	0	4	4	0	6	10	0	0
20	23161620	.	G	T	2	2	4	0	0	4	0	0
20	23175425	.	A	G	15	16	31	0	0	31	0	0
20	23175479	.	C	A	10	19	29	0	2	31	0	0
20	23175495	.	C	A	13	17	30	0	0	30	0	0
20	23178078	.	T	C	14	18	32	0	0	32	0	0
20	23179753	.	A	G	3	0	3	0	8	11	0	0
20	23204754	.	C	A	13	8	21	0	1	22	0	0
20	23205102	.	T	C	8	15	23	0	0	23	0	0
20	23205868	.	T	C	17	11	28	0	3	31	0	0
20	23205879	.	G	A	23	12	35	0	2	37	0	0
20	23245852	.	C	T	7	4	11	0	0	11	0	0
20	23246105	.	G	A	2	4	6	0	0	6	0	0
20	23248635	.	T	C	12	13	25	0	1	26	0	0
20	23250530	.	C	A	9	4	13	0	0	13	0	0
20	23253455	.	G	A	1	3	4	0	0	4	0	0
20	23332689	.	G	A	0	1	1	0	0	1	0	0
20	23360738	.	G	A	1	1	2	0	0	2	0	0
20	23363538	.	C	T	1	2	3	0	0	3	0	0
20	23368411	.	T	C	0	1	1	0	0	1	0	0
20	23368510	.	A	G	5	0	5	0	4	9	0	0
20	23372087	.	C	T	0	1	1	0	0	1	0	0
20	23374412	.	C	T	2	2	4	0	1	5	0	0
20	23376342	.	C	T	3	10	13	0	0	13	0	0
20	23376659	.	C	T	1	1	2	0	0	2	0	0
20	23385556	.	G	A	2	0	2	0	0	2	0	0
20	23385922	.	T	C	6	3	9	0	0	9	0	0
20	23386096	.	G	A	8	6	14	0	0	14	0	0
20	23386198	.	A	T	6	8	14	0	1	15	0	0
20	23387775	.	C	T	3	5	8	0	0	8	0	0
20	23387832	.	T	C	2	2	4	0	0	4	0	0
20	23395369	.	A	C	1	1	2	0	6	8	0	0
20	23402554	.	A	G	7	4	11	0	0	11	0	0
20	23406545	.	T	A	10	8	18	0	1	19	0	0
20	23408734	.	T	C	1	8	9	0	0	9	0	0
20	23418228	.	G	A	7	7	14	0	2	16	0	0
20	23418291	.	C	G	10	13	23	0	0	23	0	0
20	23420784	.	A	T	14	14	28	0	7	35	0	0
20	23421695	.	T	C	18	17	35	0	2	37	0	0
20	23422061	.	T	C	13	17	30	0	5	35	0	0
20	23422205	.	A	T	7	5	12	0	0	12	0	0
20	23431702	.	C	T	0	2	2	0	2	4	0	0
20	23446698	.	G	A	6	4	10	0	1	11	0	0
20	23446854	.	C	T	4	4	8	0	0	8	0	0
20	23447086	.	T	C	8	2	10	0	7	17	0	0
20	23447540	.	C	T	6	6	12	0	1	13	0	0
20	23447564	.	C	G	7	11	18	0	1	19	0	0
20	23453642	.	C	T	3	5	8	0	0	8	0	0
20	23453671	.	C	T	2	0	2	0	0	2	0	0
20	23467400	.	C	A	0	3	3	0	1	4	0	0
20	23471742	.	G	A	1	2	3	0	1	4	0	0
20	23471859	.	C	A	7	4	11	0	0	11	0	0
20	23472036	.	C	T	4	4	8	0	0	8	0	0
20	23472039	.	C	T	5	4	9	0	0	9	0	0
20	23472186	.	T	C	3	4	7	0	0	7	0	0
20	23472239	.	C	T	1	8	9	0	5	14	0	0
20	23472259	.	G	T	7	8	15	0	0	15	0	0
20	23475605	.	T	C	2	2	4	0	0	4	0	0
20	23477436	.	C	T	4	2	6	0	0	6	0	0
20	23478231	.	C	T	3	2	5	0	0	5	0	0
20	23478469	.	C	G	0	2	2	0	1	3	0	0
20	23621625	.	C	G	4	2	6	0	0	6	0	0
20	23647669	.	C	T	2	2	4	0	0	4	0	0
20	23648235	.	T	A	3	2	5	0	2	7	0	0
20	23651156	.	C	A	3	4	7	0	0	7	0	0
20	23651254	.	G	A	0	2	2	0	2	4	0	0
20	23651294	.	C	T	3	3	6	0	0	6	0	0
20	23651350	.	C	T	3	6	9	0	1	10	0	0
20	23651503	.	T	C	3	0	3	0	4	7	0	0
20	23655749	.	A	T	2	2	4	0	0	4	0	0
20	23655767	.	C	T	1	1	2	0	0	2	0	0
20	23656454	.	A	G	6	3	9	0	0	9	0	0
20	23658812	.	G	C	1	2	3	0	0	3	0	0
20	23658868	.	G	A	2	2	4	0	0	4	0	0
20	23665041	.	G	A	0	4	4	0	3	7	0	0
20	23665086	.	C	T	2	3	5	0	0	5	0	0
20	23665185	.	A	T	3	2	5	0	0	5	0	0
20	23665793	.	G	T	0	8	8	0	7	15	0	0
20	23665863	.	G	A	0	5	5	0	7	12	0	0
20	23666055	.	T	A	1	4	5	0	0	5	0	0
20	23666137	.	G	T	0	2	2	0	0	2	0	0
20	23685062	.	G	A	1	3	4	0	0	4	0	0
20	23685106	.	A	T	2	3	5	0	1	6	0	0
20	23685259	.	G	T	1	1	2	0	0	2	0	0
20	23685270	.	T	A	1	2	3	0	0	3	0	0
20	23685529	.	T	A	2	1	3	0	1	4	0	0
20	23689996	.	G	A	5	4	9	0	0	9	0	0
20	23690051	.	A	T	4	3	7	0	0	7	0	0
20	23690077	.	C	A	2	2	4	0	1	5	0	0
20	23691015	.	G	A	0	1	1	0	0	1	0	0
20	23691911	.	T	C	2	3	5	0	0	5	0	0
20	23691917	.	C	T	1	2	3	0	0	3	0	0
20	23692094	.	T	C	5	8	13	0	1	14	0	0
20	23694005	.	C	T	0	1	1	0	0	1	0	0
20	23694259	.	T	C	2	1	3	0	0	3	0	0
20	23694299	.	G	T	0	5	5	0	8	13	0	0
20	23705719	.	G	A	3	2	5	0	0	5	0	0
20	23713122	.	G	A	0	5	5	0	4	9	0	0
20	23713197	.	A	G	6	0	6	0	3	9	0	0
20	23713266	.	G	A	0	2	2	0	1	3	0	0
20	23713824	.	A	G	4	4	8	0	0	8	0	0
20	23713858	.	T	G	5	0	5	0	4	9	0	0
20	23713883	.	A	G	4	0	4	0	5	9	0	0
20	23746672	.	G	A	0	1	1	0	1	2	0	0
20	23746831	.	G	A	0	3	3	0	4	7	0	0
20	23746885	.	G	A	0	6	6	0	2	8	0	0
20	23746966	.	C	G	1	0	1	0	2	3	0	0
20	23747167	.	A	G	0	2	2	0	0	2	0	0
20	23796406	.	T	C	3	5	8	0	0	8	0	0
20	23796565	.	C	T	1	1	2	0	1	3	0	0
20	23801069	.	G	T	0	3	3	0	3	6	0	0
20	23828102	.	G	T	2	5	7	0	0	7	0	0
20	23829161	.	A	G	0	0	0	0	1	1	0	0
20	23829170	.	C	T	1	0	1	0	0	1	0	0
20	23829413	.	A	G	9	0	9	0	4	13	0	0
20	23832884	.	G	C	4	3	7	0	0	7	0	0
20	23833193	.	G	T	1	0	1	0	0	1	0	0
20	23835228	.	C	T	4	5	9	0	0	9	0	0
20	23835472	.	C	T	11	4	15	0	0	15	0	0
20	23835549	.	C	A	6	3	9	0	0	9	0	0
20	23835591	.	G	T	8	4	12	0	0	12	0	0
20	23836009	.	G	T	1	4	5	0	0	5	0	0
20	23836037	.	G	A	0	4	4	0	3	7	0	0
20	23836106	.	A	T	5	3	8	0	0	8	0	0
20	23836161	.	C	T	5	4	9	0	0	9	0	0
20	23836343	.	G	C	3	2	5	0	0	5	0	0
20	23836344	.	T	C	2	2	4	0	1	5	0	0
20	23836422	.	A	T	2	3	5	0	0	5	0	0
20	23836608	.	C	T	2	2	4	0	1	5	0	0
20	23836685	.	A	T	5	4	9	0	1	10	0	0
20	23836688	.	C	A	5	5	10	0	0	10	0	0
20	23836756	.	G	A	1	3	4	0	4	8	0	0
20	23836880	.	C	T	10	5	15	0	0	15	0	0
20	23836915	.	A	G	2	0	2	0	4	6	0	0
20	23855673	.	C	T	3	4	7	0	0	7	0	0
20	23855675	.	T	A	3	4	7	0	0	7	0	0
20	23856274	.	T	A	7	3	10	0	0	10	0	0
20	23856345	.	A	T	15	11	26	0	0	26	0	0
20	23857214	.	G	C	16	13	29	0	2	31	0	0
20	23857407	.	C	A	5	2	7	0	0	7	0	0
20	23857559	.	G	A	4	14	18	0	0	18	0	0
20	23857592	.	C	T	1	1	2	0	0	2	0	0
20	23859383	.	G	C	3	5	8	0	0	8	0	0
20	23859386	.	A	G	3	5	8	0	0	8	0	0
20	23859425	.	G	A	0	13	13	0	11	24	0	0
20	23859458	.	A	G	17	12	29	0	1	30	0	0
20	23859486	.	G	A	1	4	5	0	10	15	0	0
20	23877623	.	G	A	1	6	7	0	0	7	0	0
20	23879673	.	C	T	1	1	2	0	0	2	0	0
20	23879879	.	G	T	0	1	1	0	0	1	0	0
20	23879903	.	C	A	0	1	1	0	0	1	0	0
20	23881731	.	C	G	1	2	3	0	0	3	0	0
20	23882437	.	C	T	3	4	7	0	1	8	0	0
20	23883008	.	T	C	4	3	7	0	0	7	0	0
20	23883351	.	T	A	8	5	13	0	1	14	0	0
20	23883599	.	T	C	2	3	5	0	0	5	0	0
20	23885402	.	T	A	0	1	1	0	0	1	0	0
20	23885485	.	T	A	7	3	10	0	1	11	0	0
20	23885505	.	C	T	0	7	7	0	1	8	0	0
20	23885925	.	G	A	1	0	1	0	0	1	0	0
20	23886277	.	A	G	4	4	8	0	0	8	0	0
20	23886358	.	A	G	2	3	5	0	0	5	0	0
20	23888878	.	C	G	1	3	4	0	0	4	0	0
20	23890478	.	C	T	1	5	6	0	0	6	0	0
20	23890489	.	C	T	1	5	6	0	0	6	0	0
20	23892006	.	G	A	1	3	4	0	0	4	0	0
20	23892027	.	C	T	0	3	3	0	1	4	0	0
20	23892059	.	G	A	3	1	4	0	0	4	0	0
20	23897573	.	C	G	2	2	4	0	0	4	0	0
20	23897600	.	T	C	2	1	3	0	0	3	0	0
20	23898417	.	G	C	1	1	2	0	0	2	0	0
20	23898718	.	C	A	1	2	3	0	0	3	0	0
20	23950624	.	A	G	1	2	3	0	1	4	0	0
20	23953822	.	A	G	2	2	4	0	1	5	0	0
20	23954847	.	G	A	0	2	2	0	1	3	0	0
20	23955237	.	C	G	5	2	7	0	0	7	0	0
20	23955326	.	G	T	0	5	5	0	2	7	0	0
20	23972997	.	C	T	0	5	5	0	4	9	0	0
20	23973358	.	T	C	1	2	3	0	0	3	0	0
20	23973433	.	T	C	1	6	7	0	1	8	0	0
20	23974755	.	G	A	3	2	5	0	0	5	0	0
20	23974834	.	T	C	1	4	5	0	0	5	0	0
20	23974953	.	T	G	6	5	11	0	0	11	0	0
20	23975055	.	T	C	1	0	1	0	2	3	0	0
20	23996985	.	C	A	1	3	4	0	0	4	0	0
20	24122740	.	G	C	2	6	8	0	1	9	0	0
20	24151599	.	C	T	0	9	9	0	6	15	0	0
20	24152098	.	G	A	0	3	3	0	2	5	0	0
20	24152821	.	G	A	6	17	23	0	1	24	0	0
20	24152822	.	G	A	17	7	24	0	0	24	0	0
20	24175892	.	A	G	4	1	5	0	0	5	0	0
20	24182789	.	T	C	1	1	2	0	4	6	0	0
20	24182819	.	T	C	2	0	2	0	5	7	0	0
20	24182980	.	C	T	3	2	5	0	0	5	0	0
20	24183288	.	G	A	4	8	12	0	0	12	0	0
20	24818673	.	G	A	9	12	21	0	1	22	0	0
20	24819091	.	A	G	7	10	17	0	0	17	0	0
20	24819152	.	C	G	4	5	9	0	2	11	0	0
20	24819582	.	C	T	0	8	8	0	12	20	0	0
20	24819646	.	C	T	7	4	11	0	0	11	0	0
20	24819698	.	G	A	4	7	11	0	0	11	0	0
20	24819858	.	T	C	3	2	5	0	1	6	0	0
20	24819929	.	T	C	8	7	15	0	2	17	0	0
20	24820032	.	T	C	3	9	12	0	0	12	0	0
20	24820885	.	C	T	0	8	8	0	11	19	0	0
20	24820963	.	T	A	9	2	11	0	1	12	0	0
20	24821048	.	C	A	8	12	20	0	0	20	0	0
20	24821072	.	A	G	9	8	17	0	1	18	0	0
20	24835754	.	C	T	0	3	3	0	2	5	0	0
20	24852707	.	C	T	0	2	2	0	2	4	0	0
20	24915538	.	G	A	5	3	8	0	1	9	0	0
20	24915591	.	T	C	6	0	6	0	5	11	0	0
20	24915712	.	G	A	3	4	7	0	2	9	0	0
20	24959732	.	A	G	2	4	6	0	1	7	0	0
20	25243971	.	T	A	1	0	1	0	0	1	0	0
20	25265832	.	A	G	0	1	1	0	0	1	0	0
20	25269734	.	T	C	1	0	1	0	0	1	0	0
20	25269762	.	C	A	1	0	1	0	0	1	0	0
20	25270069	.	T	C	1	2	3	0	0	3	0	0
20	25271444	.	C	A	3	2	5	0	0	5	0	0
20	25342164	.	C	T	1	0	1	0	0	1	0	0
20	25342397	.	C	T	3	2	5	0	0	5	0	0
20	25342721	.	C	T	3	2	5	0	1	6	0	0
20	25368871	.	C	T	7	5	12	0	0	12	0	0
20	25371869	.	A	G	3	4	7	0	0	7	0	0
20	25372677	.	A	G	3	0	3	0	1	4	0	0
20	25378556	.	C	T	0	1	1	0	1	2	0	0
20	25378583	.	T	G	0	2	2	0	0	2	0	0
20	25378610	.	C	T	0	4	4	0	0	4	0	0
20	25384473	.	A	T	0	1	1	0	0	1	0	0
20	25384494	.	G	A	0	1	1	0	0	1	0	0
20	25387850	.	T	A	2	4	6	0	0	6	0	0
20	25387865	.	A	G	7	3	10	0	0	10	0	0
20	25440724	.	G	T	5	6	11	0	1	12	0	0
20	25441033	.	G	T	10	11	21	0	0	21	0	0
20	25444929	.	A	G	6	3	9	0	0	9	0	0
20	25499412	.	A	C	1	0	1	0	0	1	0	0
20	25500859	.	A	G	2	0	2	0	6	8	0	0
20	25500922	.	C	T	4	1	5	0	0	5	0	0
20	25508260	.	G	T	0	1	1	0	1	2	0	0
20	25509772	.	C	T	5	9	14	0	0	14	0	0
20	25509842	.	C	A	13	6	19	0	0	19	0	0
20	25509851	.	A	T	12	7	19	0	0	19	0	0
20	25509934	.	T	C	5	8	13	0	2	15	0	0
20	25510234	.	A	T	2	5	7	0	0	7	0	0
20	25510256	.	T	A	6	2	8	0	0	8	0	0
20	25510270	.	G	T	7	2	9	0	0	9	0	0
20	25510481	.	A	G	2	5	7	0	0	7	0	0
20	25510586	.	A	G	3	12	15	0	0	15	0	0
20	25510630	.	G	A	3	10	13	0	2	15	0	0
20	25510739	.	C	A	5	5	10	0	0	10	0	0
20	25510769	.	T	C	3	7	10	0	0	10	0	0
20	25510897	.	G	C	6	2	8	0	0	8	0	0
20	25511312	.	T	A	4	10	14	0	0	14	0	0
20	25511609	.	T	C	7	14	21	0	1	22	0	0
20	25511785	.	T	C	5	2	7	0	0	7	0	0
20	25511940	.	G	A	0	3	3	0	7	10	0	0
20	25511957	.	A	T	3	6	9	0	1	10	0	0
20	25516185	.	C	T	1	2	3	0	0	3	0	0
20	25537558	.	T	C	1	3	4	0	0	4	0	0
20	25548780	.	C	T	0	3	3	0	5	8	0	0
20	25549039	.	T	G	1	0	1	0	0	1	0	0
20	25549127	.	A	G	2	1	3	0	0	3	0	0
20	25552377	.	C	T	2	2	4	0	0	4	0	0
20	25552386	.	G	A	0	2	2	0	0	2	0	0
20	25552412	.	A	C	1	2	3	0	1	4	0	0
20	25618601	.	T	A	5	6	11	0	0	11	0	0
20	25623770	.	A	T	1	0	1	0	1	2	0	0
20	25623778	.	A	T	2	1	3	0	0	3	0	0
20	25625969	.	A	G	2	1	3	0	0	3	0	0
20	25626180	.	T	C	2	2	4	0	0	4	0	0
20	25626615	.	G	T	1	3	4	0	1	5	0	0
20	25629072	.	A	G	1	3	4	0	0	4	0	0
20	25629730	.	G	A	0	2	2	0	0	2	0	0
20	25633197	.	A	C	0	1	1	0	0	1	0	0
20	25661199	.	A	G	16	10	26	0	1	27	0	0
20	25661509	.	G	A	20	17	37	0	1	38	0	0
20	25663590	.	T	G	4	2	6	0	0	6	0	0
20	25665101	.	G	T	12	16	28	0	0	28	0	0
20	25665115	.	G	T	16	14	30	0	2	32	0	0
20	25665144	.	G	T	17	14	31	0	1	32	0	0
20	25665195	.	G	A	17	13	30	0	0	30	0	0
20	25665325	.	T	G	4	14	18	0	1	19	0	0
20	25665506	.	C	T	8	6	14	0	0	14	0	0
20	25665515	.	C	T	8	5	13	0	0	13	0	0
20	25665627	.	T	C	7	11	18	0	0	18	0	0
20	25665822	.	G	A	10	12	22	0	0	22	0	0
20	25665927	.	T	C	8	8	16	0	0	16	0	0
20	25666142	.	C	T	14	11	25	0	2	27	0	0
20	25666277	.	G	T	7	5	12	0	2	14	0	0
20	25666812	.	T	A	16	13	29	0	1	30	0	0
20	25666947	.	C	T	7	9	16	0	0	16	0	0
20	25669567	.	T	G	9	6	15	0	0	15	0	0
20	25669888	.	C	A	1	1	2	0	1	3	0	0
20	25740649	.	G	A	0	2	2	0	1	3	0	0
20	25853228	.	T	C	2	4	6	0	0	6	0	0
20	25853767	.	A	G	18	17	35	0	3	38	0	0
20	25855561	.	G	A	1	1	2	0	0	2	0	0
20	25859494	.	C	T	14	12	26	0	2	28	0	0
20	25906391	.	T	C	2	1	3	0	0	3	0	0
20	25909276	.	T	C	2	1	3	0	0	3	0	0
20	25909330	.	C	T	9	7	16	0	0	16	0	0
20	25909462	.	T	C	8	7	15	0	1	16	0	0
20	25909699	.	C	T	4	16	20	0	0	20	0	0
20	25909765	.	A	C	7	15	22	0	0	22	0	0
20	25910133	.	G	A	6	6	12	0	0	12	0	0
20	25910298	.	A	T	3	7	10	0	0	10	0	0
20	25910366	.	A	T	1	4	5	0	0	5	0	0
20	25910368	.	A	T	1	4	5	0	0	5	0	0
20	25910522	.	G	T	1	3	4	0	0	4	0	0
20	25919371	.	T	C	3	1	4	0	0	4	0	0
20	25923747	.	T	C	8	9	17	0	0	17	0	0
20	25923960	.	T	C	14	14	28	0	1	29	0	0
20	25926048	.	A	G	10	17	27	0	3	30	0	0
20	25926474	.	G	A	4	5	9	0	0	9	0	0
20	25926540	.	T	A	4	6	10	0	0	10	0	0
20	25926623	.	A	G	1	7	8	0	0	8	0	0
20	25927259	.	C	G	10	1	11	0	13	24	0	0
20	25927283	.	T	G	15	11	26	0	0	26	0	0
20	25927310	.	A	G	17	7	24	0	0	24	0	0
20	25928098	.	C	T	9	13	22	0	0	22	0	0
20	25929576	.	A	T	6	8	14	0	0	14	0	0
20	25929913	.	T	A	27	12	39	0	1	40	0	0
20	25930671	.	T	C	7	6	13	0	0	13	0	0
20	25939014	.	G	C	1	2	3	0	0	3	0	0
20	25953538	.	T	C	0	1	1	0	0	1	0	0
20	26002683	.	T	C	8	4	12	0	1	13	0	0
20	26002780	.	T	A	3	6	9	0	0	9	0	0
20	26002900	.	C	G	12	4	16	0	1	17	0	0
20	26002970	.	A	G	4	0	4	0	7	11	0	0
20	26004160	.	T	A	10	6	16	0	0	17	1	0
20	26004251	.	A	G	3	12	15	0	1	16	0	0
20	26024196	.	G	A	13	21	34	0	2	36	0	0
20	26024432	.	C	T	11	12	23	0	1	24	0	0
20	26024434	.	A	G	11	12	23	0	1	24	0	0
20	26024565	.	G	A	0	17	17	0	18	35	0	0
20	26027434	.	G	T	9	6	15	0	0	15	0	0
20	26027630	.	C	T	3	5	8	0	0	8	0	0
20	26030641	.	G	T	1	5	6	0	0	6	0	0
20	26037691	.	G	T	4	1	5	0	0	5	0	0
20	26047462	.	G	A	3	11	14	0	0	14	0	0
20	26048815	.	C	T	7	4	11	0	1	12	0	0
20	26049961	.	G	A	3	3	6	0	0	6	0	0
20	26050226	.	T	C	2	0	2	0	5	7	0	0
20	26054485	.	T	C	5	5	10	0	0	10	0	0
20	26054503	.	A	G	5	6	11	0	0	11	0	0
20	26055709	.	A	C	2	1	3	0	0	3	0	0
20	26268443	.	T	C	1	1	2	0	0	2	0	0
20	26269925	.	A	G	1	2	3	0	0	3	0	0
20	26270488	.	T	C	0	1	1	0	0	1	0	0
20	26270730	.	A	G	3	3	6	0	0	6	0	0
20	26271357	.	G	T	0	0	0	0	3	3	0	0
20	26279817	.	A	C	3	2	5	0	0	5	0	0
20	26279961	.	A	C	4	9	13	0	0	13	0	0
20	26283471	.	C	A	4	3	7	0	2	9	0	0
20	26285416	.	A	G	0	0	0	0	2	2	0	0
20	26285606	.	G	A	2	0	2	0	0	2	0	0
20	26290451	.	G	A	5	4	9	0	0	9	0	0
20	26290667	.	A	T	6	5	11	0	1	12	0	0
20	26290738	.	A	T	5	3	8	0	1	9	0	0
20	26290739	.	T	C	6	2	8	0	1	9	0	0
20	26290778	.	A	G	4	3	7	0	2	9	0	0
20	26290947	.	A	G	3	2	5	0	1	6	0	0
20	26290962	.	C	T	3	3	6	0	0	6	0	0
20	26291016	.	G	C	8	3	11	0	0	11	0	0
20	26291331	.	T	C	6	2	8	0	0	8	0	0
20	26298380	.	G	A	3	8	11	0	0	11	0	0
20	26300495	.	A	G	3	2	5	0	0	5	0	0
20	26300840	.	G	T	2	3	5	0	1	6	0	0
20	26301092	.	C	T	5	6	11	0	0	11	0	0
20	26304918	.	G	A	0	1	1	0	0	1	0	0
20	26304921	.	G	A	0	2	2	0	0	2	0	0
20	26305019	.	A	T	8	3	11	0	0	11	0	0
20	26310596	.	T	A	2	2	4	0	1	5	0	0
20	26310637	.	C	T	1	1	2	0	0	2	0	0
20	26320288	.	T	C	3	3	6	0	0	6	0	0
20	26321073	.	G	A	4	5	9	0	1	10	0	0
20	26323356	.	T	C	3	2	5	0	0	5	0	0
20	26325671	.	A	G	8	10	18	0	1	19	0	0
20	26326345	.	T	C	14	16	30	0	1	31	0	0
20	26327719	.	C	T	13	6	19	0	0	19	0	0
20	26328051	.	C	T	4	6	10	0	0	10	0	0
20	26329035	.	G	A	1	4	5	0	0	5	0	0
20	26331595	.	A	G	5	3	8	0	1	9	0	0
20	26334446	.	C	T	5	10	15	0	1	16	0	0
20	26337036	.	C	T	7	10	17	0	0	17	0	0
20	26337733	.	C	T	21	17	38	0	0	38	0	0
20	26342889	.	C	T	5	6	11	0	0	11	0	0
20	26344835	.	A	G	6	4	10	0	0	10	0	0
20	26345856	.	T	A	8	14	22	0	1	23	0	0
20	26346710	.	C	T	17	23	40	0	3	43	0	0
20	26348838	.	G	A	0	8	8	0	5	13	0	0
20	26351914	.	T	G	15	0	15	0	10	25	0	0
20	26353751	.	T	C	8	7	15	0	3	18	0	0
20	26353770	.	A	G	13	12	25	0	2	27	0	0
20	26353793	.	T	C	17	18	35	0	0	35	0	0
20	26358574	.	T	C	19	25	44	0	1	45	0	0
20	26360192	.	C	T	4	8	12	0	1	13	0	0
20	26387181	.	G	A	6	4	10	0	0	10	0	0
20	26387288	.	T	A	9	10	19	0	0	19	0	0
20	26387413	.	A	T	4	2	6	0	0	6	0	0
20	26387881	.	T	G	5	7	12	0	0	12	0	0
20	26390906	.	C	T	2	2	4	0	0	4	0	0
20	26390912	.	G	A	2	3	5	0	0	5	0	0
20	26402615	.	T	C	2	4	6	0	0	6	0	0
20	26404281	.	A	G	1	0	1	0	4	5	0	0
20	26404361	.	C	G	3	5	8	0	0	8	0	0
20	26404443	.	G	A	0	4	4	0	2	6	0	0
20	26404696	.	G	A	0	5	5	0	3	8	0	0
20	26404860	.	T	A	5	4	9	0	1	10	0	0
20	26405356	.	A	T	2	2	4	0	0	4	0	0
20	26405382	.	C	T	3	2	5	0	0	5	0	0
20	26405406	.	T	G	3	0	3	0	7	10	0	0
20	26405808	.	T	A	4	5	9	0	0	9	0	0
20	26405857	.	G	A	0	4	4	0	5	9	0	0
20	26406160	.	G	A	0	7	7	0	4	11	0	0
20	26406252	.	T	C	1	4	5	0	0	5	0	0
20	26406352	.	T	C	3	3	6	0	0	6	0	0
20	26406369	.	G	A	3	2	5	0	0	5	0	0
20	26406640	.	G	T	0	4	4	0	5	9	0	0
20	26409194	.	T	A	4	4	8	1	0	9	0	0
20	26409261	.	C	A	0	8	8	0	8	16	0	0
20	26409295	.	C	A	13	4	17	0	0	17	0	0
20	26409310	.	A	T	13	6	19	0	0	19	0	0
20	26409403	.	A	T	5	5	10	0	0	10	0	0
20	26409471	.	C	T	0	10	10	0	6	16	0	0
20	26409599	.	C	T	18	20	38	0	1	39	0	0
20	26409922	.	T	C	9	25	34	0	1	35	0	0
20	26409931	.	C	T	12	22	34	0	2	36	0	0
20	26410224	.	G	T	10	8	18	0	1	19	0	0
20	26410275	.	G	A	5	10	15	0	0	15	0	0
20	26410341	.	A	G	16	17	33	0	0	33	0	0
20	26410344	.	A	C	15	19	34	0	0	35	1	0
20	26412372	.	T	A	12	11	23	0	0	23	0	0
20	26412479	.	C	T	8	8	16	0	0	16	0	0
20	26412501	.	G	A	9	8	17	0	0	17	0	0
20	26412579	.	C	A	9	10	19	0	1	20	0	0
20	26412830	.	G	T	13	19	32	0	0	32	0	0
20	26412831	.	G	T	13	19	32	0	0	32	0	0
20	26412876	.	G	A	14	13	27	0	0	27	0	0
20	26412968	.	T	A	14	17	31	0	1	32	0	0
20	26413057	.	G	A	15	11	26	0	1	27	0	0
20	26413181	.	T	C	6	9	15	0	1	16	0	0
20	26413269	.	C	A	7	9	16	0	1	17	0	0
20	26413280	.	A	C	8	0	8	0	10	18	0	0
20	26413311	.	C	T	8	12	20	0	1	21	0	0
20	26413470	.	G	T	4	16	20	0	0	20	0	0
20	26413584	.	G	A	4	3	7	0	0	7	0	0
20	26413923	.	C	T	7	6	13	0	0	13	0	0
20	26413998	.	A	T	8	9	17	0	0	17	0	0
20	26414724	.	C	T	0	2	2	0	4	6	0	0
20	26414747	.	C	T	3	2	5	0	0	5	0	0
20	26414832	.	C	T	3	6	9	0	2	11	0	0
20	26414844	.	G	A	4	4	8	0	1	9	0	0
20	26414919	.	A	G	6	7	13	0	0	13	0	0
20	26415021	.	G	T	6	3	9	0	0	9	0	0
20	26415853	.	G	A	6	2	8	0	0	8	0	0
20	26416114	.	A	G	2	3	5	0	0	5	0	0
20	26416265	.	C	T	1	6	7	0	0	7	0	0
20	26416266	.	T	A	1	6	7	0	0	7	0	0
20	26416353	.	T	G	5	9	14	0	3	17	0	0
20	26416469	.	C	G	6	5	11	0	0	11	0	0
20	26416514	.	T	C	6	4	10	0	0	10	0	0
20	26467216	.	C	T	10	3	13	0	0	13	0	0
20	26587834	.	A	G	0	9	9	0	1	10	0	0
20	26594516	.	G	T	2	3	5	0	0	5	0	0
20	26599709	.	C	T	3	0	3	0	0	3	0	0
20	26599748	.	G	C	1	0	1	0	0	1	0	0
20	26601222	.	G	A	4	2	6	0	1	7	0	0
20	26610433	.	G	A	5	8	13	0	1	14	0	0
20	26613462	.	A	G	2	3	5	0	0	5	0	0
20	26616241	.	G	C	4	0	4	0	3	7	0	0
20	26807385	.	G	A	1	6	7	0	0	7	0	0
20	26809059	.	A	G	3	2	5	0	0	5	0	0
20	26822389	.	A	G	8	4	12	0	2	14	0	0
20	26822449	.	A	G	4	9	13	0	0	13	0	0
20	26886291	.	C	T	1	0	1	0	0	1	0	0
20	26886607	.	A	G	1	0	1	0	4	5	0	0
20	26913236	.	G	T	3	5	8	0	0	8	0	0
20	26919426	.	G	A	1	2	3	0	0	3	0	0
20	26920711	.	C	T	0	2	2	0	1	3	0	0
20	26920767	.	G	A	2	2	4	0	0	4	0	0
20	26920879	.	C	G	2	3	5	0	0	5	0	0
20	26921043	.	A	G	2	2	4	0	0	4	0	0
20	26921070	.	T	C	6	2	8	0	0	8	0	0
20	26939926	.	C	T	7	9	16	0	0	16	0	0
20	26944106	.	G	A	12	16	28	0	2	30	0	0
20	26944311	.	G	A	16	18	34	0	6	40	0	0
20	26944576	.	C	T	13	12	25	0	0	25	0	0
20	26944762	.	C	T	13	16	29	0	1	30	0	0
20	26944971	.	G	A	7	4	11	0	1	12	0	0
20	26945394	.	C	T	13	8	21	0	0	21	0	0
20	26945735	.	C	T	6	12	18	0	0	18	0	0
20	26945913	.	T	C	9	17	26	0	0	26	0	0
20	26948033	.	A	T	4	5	9	0	0	9	0	0
20	26948161	.	A	G	5	5	10	0	0	10	0	0
20	26958737	.	C	T	6	6	12	0	2	14	0	0
20	26959139	.	G	C	5	3	8	0	1	9	0	0
20	26959605	.	T	C	5	3	8	0	0	8	0	0
20	26959624	.	C	T	5	2	7	0	0	7	0	0
20	26959829	.	C	T	3	5	8	0	0	8	0	0
20	26959900	.	G	A	0	2	2	0	6	8	0	0
20	26959902	.	G	C	6	2	8	0	0	8	0	0
20	26960540	.	A	G	2	0	2	0	5	7	0	0
20	26960619	.	A	G	9	8	17	0	0	17	0	0
20	26960673	.	A	G	5	6	11	0	0	11	0	0
20	26960802	.	T	C	8	6	14	0	0	14	0	0
20	26960877	.	G	A	0	4	4	0	9	13	0	0
20	26961079	.	G	A	0	2	2	0	5	7	0	0
20	26961149	.	A	G	4	4	8	0	0	8	0	0
20	26961156	.	A	G	3	4	7	0	0	7	0	0
20	26961469	.	A	G	6	6	12	0	1	13	0	0
20	26961533	.	A	G	0	5	5	0	0	5	0	0
20	26961643	.	C	T	1	2	3	0	0	3	0	0
20	26961726	.	C	T	5	2	7	0	0	7	0	0
20	26961758	.	A	T	5	3	8	0	0	8	0	0
20	26961799	.	C	T	4	2	6	0	1	7	0	0
20	26961832	.	T	G	7	1	8	0	0	8	0	0
20	26961907	.	A	G	8	10	18	0	0	18	0	0
20	26962077	.	G	A	0	8	8	0	10	18	0	0
20	26962095	.	T	C	10	7	17	0	1	18	0	0
20	26962385	.	T	A	7	3	10	0	0	10	0	0
20	26962455	.	G	A	0	6	6	0	5	11	0	0
20	26972810	.	C	T	0	3	3	0	0	3	0	0
20	26973754	.	T	A	1	6	7	0	0	7	0	0
20	26973890	.	T	C	1	5	6	0	0	6	0	0
20	26987599	.	G	A	0	2	2	0	1	3	0	0
20	26989248	.	T	G	2	6	8	0	0	8	0	0
20	26989258	.	T	G	2	5	7	0	0	7	0	0
20	26992102	.	G	A	1	5	6	0	0	6	0	0
20	26993506	.	C	T	1	1	2	0	0	2	0	0
20	26999506	.	T	A	4	5	9	0	0	9	0	0
20	27001816	.	A	C	11	13	24	0	0	24	0	0
20	27001864	.	T	A	12	11	23	0	0	23	0	0
20	27001867	.	C	T	11	12	23	0	0	23	0	0
20	27001903	.	C	T	10	12	22	0	1	23	0	0
20	27001915	.	T	C	10	10	20	0	1	21	0	0
20	27020221	.	G	A	4	12	16	0	1	17	0	0
20	27020294	.	T	A	22	23	45	0	1	46	0	0
20	27020346	.	A	C	12	10	22	0	1	23	0	0
20	27020442	.	G	T	6	2	8	0	0	8	0	0
20	27020446	.	G	A	6	2	8	0	0	8	0	0
20	27033700	.	C	T	1	3	4	0	0	4	0	0
20	27033847	.	A	T	24	25	49	0	3	52	0	0
20	27033914	.	A	G	16	25	41	0	3	44	0	0
20	27039364	.	G	T	0	35	35	0	22	57	0	0
20	27039400	.	G	A	21	36	57	0	1	58	0	0
20	27039498	.	C	T	31	26	57	0	2	59	0	0
20	27039550	.	A	T	28	22	50	0	1	51	0	0
20	27039577	.	C	T	21	19	40	0	2	42	0	0
20	27045649	.	T	G	20	1	21	0	32	53	0	0
20	27045703	.	A	G	12	14	26	0	0	26	0	0
20	27045719	.	T	C	8	12	20	0	2	22	0	0
20	27089494	.	G	T	1	3	4	0	0	4	0	0
20	27090340	.	A	G	4	3	7	0	0	7	0	0
20	27090401	.	C	T	4	5	9	0	0	9	0	0
20	27090525	.	T	G	1	5	6	0	0	6	0	0
20	27090551	.	A	T	1	4	5	0	0	5	0	0
20	27091064	.	G	A	7	3	10	0	0	10	0	0
20	27091143	.	G	A	11	3	14	0	0	14	0	0
20	27092182	.	C	T	10	19	29	0	0	29	0	0
20	27092245	.	A	G	16	16	32	0	0	32	0	0
20	27093198	.	A	T	4	6	10	0	0	10	0	0
20	27093286	.	C	T	6	6	12	0	0	12	0	0
20	27094615	.	A	G	2	2	4	0	0	4	0	0
20	27094624	.	C	T	3	3	6	0	0	6	0	0
20	27094693	.	T	C	3	3	6	0	0	6	0	0
20	27096092	.	A	T	1	4	5	0	0	5	0	0
20	27096469	.	G	T	0	0	0	0	2	2	0	0
20	27100005	.	T	C	7	7	14	0	0	14	0	0
20	27102325	.	C	T	5	8	13	0	2	15	0	0
20	27107173	.	A	C	3	10	13	0	0	13	0	0
20	27107241	.	C	A	6	2	8	0	0	8	0	0
20	27107572	.	C	G	1	3	4	0	0	4	0	0
20	27116869	.	G	T	3	3	6	0	0	6	0	0
20	27122383	.	C	T	0	1	1	0	0	1	0	0
20	27264482	.	G	A	2	2	4	0	0	4	0	0
20	27280808	.	G	A	7	4	11	0	0	11	0	0
20	27280840	.	G	A	0	8	8	0	3	11	0	0
20	27281203	.	A	G	2	4	6	0	0	6	0	0
20	27281678	.	A	C	2	7	9	1	0	10	0	0
20	27281780	.	T	G	4	5	9	0	0	9	0	0
20	27282340	.	A	C	1	6	7	0	1	8	0	0
20	27282437	.	A	G	7	6	13	0	0	13	0	0
20	27282438	.	G	A	7	6	13	0	0	13	0	0
20	27282561	.	T	C	3	7	10	0	0	10	0	0
20	27282592	.	A	G	5	7	12	0	0	12	0	0
20	27282598	.	T	A	4	6	10	0	1	11	0	0
20	27331149	.	G	A	8	6	14	0	0	14	0	0
20	27352584	.	T	C	4	8	12	0	0	12	0	0
20	27352591	.	A	G	4	1	5	0	7	12	0	0
20	27353040	.	T	C	1	0	1	0	0	1	0	0
20	27353982	.	A	G	2	4	6	0	0	6	0	0
20	27358777	.	C	A	5	4	9	0	0	9	0	0
20	27366122	.	G	A	2	1	3	0	0	3	0	0
20	27366597	.	T	G	9	5	14	0	1	15	0	0
20	27368882	.	A	C	2	0	2	0	0	2	0	0
20	27370340	.	G	A	3	14	17	0	0	17	0	0
20	27371629	.	T	C	9	26	35	0	3	38	0	0
20	27371642	.	A	C	10	27	37	0	1	38	0	0
20	27371693	.	T	A	3	14	17	0	2	19	0	0
20	27371735	.	A	G	2	19	21	0	2	23	0	0
20	27371821	.	C	A	19	16	35	0	0	35	0	0
20	27374961	.	C	T	19	19	38	0	1	39	0	0
20	27375008	.	C	T	2	19	21	0	19	40	0	0
20	27378174	.	C	T	26	27	53	0	0	53	0	0
20	27378252	.	A	T	17	27	44	0	1	45	0	0
20	27378321	.	G	T	20	38	58	0	1	59	0	0
20	27381508	.	G	A	5	3	8	0	0	8	0	0
20	27381529	.	T	G	10	9	19	0	0	20	1	0
20	27396384	.	T	A	5	16	21	0	1	22	0	0
20	27396385	.	A	T	3	17	20	0	2	22	0	0
20	27396478	.	A	T	9	11	20	0	1	21	0	0
20	27396489	.	C	T	8	9	17	0	0	17	0	0
20	27491214	.	C	A	0	2	2	0	0	2	0	0
20	27542146	.	G	A	0	2	2	0	3	5	0	0
20	27542951	.	A	G	2	3	5	0	0	5	0	0
20	27549491	.	G	A	2	3	5	0	0	5	0	0
20	27549524	.	G	A	1	5	6	0	0	6	0	0
20	27550856	.	T	G	1	0	1	0	3	4	0	0
20	27551113	.	A	T	2	5	7	0	0	7	0	0
20	27551329	.	A	G	2	5	7	0	0	7	0	0
20	27692330	.	G	T	1	3	4	0	0	4	0	0
20	27692581	.	T	C	1	2	3	0	0	3	0	0
20	27692588	.	A	T	1	2	3	0	0	3	0	0
20	27692632	.	G	T	1	2	3	0	0	3	0	0
20	27692634	.	A	G	1	2	3	0	0	3	0	0
20	27693172	.	G	T	0	3	3	0	2	5	0	0
20	27693194	.	G	A	0	2	2	0	0	2	0	0
20	27708016	.	G	A	1	6	7	0	2	9	0	0
20	27708181	.	C	T	3	7	10	0	0	10	0	0
20	27708306	.	A	G	2	8	10	0	0	10	0	0
20	27708943	.	G	A	1	3	4	0	0	4	0	0
20	27712847	.	T	C	0	1	1	0	0	1	0	0
20	27716086	.	G	A	0	2	2	0	2	4	0	0
20	27716093	.	C	T	2	3	5	0	0	5	0	0
20	27716190	.	T	C	2	2	4	0	0	4	0	0
20	27717055	.	T	A	1	5	6	0	0	6	0	0
20	27717493	.	A	G	2	6	8	0	0	8	0	0
20	27717945	.	C	T	1	4	5	0	0	5	0	0
20	27718292	.	T	C	2	2	4	0	0	4	0	0
20	27718304	.	T	C	2	1	3	0	0	3	0	0
20	27718549	.	T	A	3	5	8	0	0	8	0	0
20	27718578	.	A	T	2	4	6	0	0	6	0	0
20	27718824	.	C	G	0	2	2	0	0	2	0	0
20	27719009	.	A	G	2	6	8	0	0	8	0	0
20	27719578	.	T	C	2	2	4	0	0	4	0	0
20	27719859	.	T	C	4	3	7	0	0	7	0	0
20	27732832	.	A	G	6	6	12	0	0	12	0	0
20	27733034	.	G	A	5	10	15	0	0	15	0	0
20	27733611	.	T	C	8	7	15	0	0	15	0	0
20	27733631	.	G	C	6	0	6	0	7	13	0	0
20	27733650	.	C	A	0	9	9	0	5	14	0	0
20	28294732	.	G	T	1	2	3	0	0	3	0	0
20	28322943	.	C	T	2	2	4	0	0	4	0	0
20	28326229	.	G	A	0	2	2	0	0	2	0	0
20	28326283	.	A	T	2	2	4	0	0	4	0	0
20	28326508	.	T	C	0	1	1	0	0	1	0	0
20	28326565	.	T	C	0	1	1	0	0	1	0	0
20	28337640	.	A	G	1	1	2	0	0	2	0	0
20	28354549	.	T	A	5	6	11	0	0	11	0	0
20	28354588	.	A	G	6	8	14	0	0	14	0	0
20	28354951	.	A	G	7	4	11	0	1	12	0	0
20	28356989	.	T	C	7	6	13	0	0	13	0	0
20	28356998	.	G	A	6	7	13	0	0	13	0	0
20	28357028	.	A	G	11	4	15	0	0	15	0	0
20	28357184	.	A	G	4	7	11	0	1	12	0	0
20	28357190	.	C	T	5	8	13	0	0	13	0	0
20	28357463	.	A	G	5	11	16	0	0	16	0	0
20	28357538	.	G	A	9	5	14	0	0	14	0	0
20	28357570	.	A	G	6	3	9	0	0	9	0	0
20	28357610	.	A	G	4	8	12	0	0	12	0	0
20	28357688	.	T	C	6	5	11	0	0	11	0	0
20	28357718	.	T	C	6	5	11	0	0	11	0	0
20	28357733	.	G	A	6	3	9	0	0	9	0	0
20	28357769	.	A	G	7	7	14	0	0	14	0	0
20	28357823	.	T	A	9	5	14	0	0	14	0	0
20	28357883	.	C	T	4	3	7	0	0	7	0	0
20	28358060	.	C	G	3	2	5	0	1	6	0	0
20	28358333	.	T	C	2	2	4	0	0	4	0	0
20	28361044	.	C	T	1	1	2	0	0	2	0	0
20	28399987	.	C	A	0	2	2	0	1	3	0	0
20	28400380	.	A	T	3	1	4	0	1	5	0	0
20	28400455	.	A	C	4	5	9	0	0	9	0	0
20	28400481	.	A	G	6	4	10	0	1	11	0	0
20	28400619	.	G	A	10	17	27	0	1	28	0	0
20	28401147	.	A	G	10	8	18	0	2	20	0	0
20	28401298	.	C	G	8	2	10	0	1	11	0	0
20	28401309	.	C	T	9	3	12	0	0	12	0	0
20	28402253	.	G	A	1	0	1	0	0	1	0	0
20	28402426	.	G	A	7	3	10	0	0	10	0	0
20	28402456	.	A	G	11	4	15	0	0	15	0	0
20	28402470	.	G	A	10	4	14	0	0	14	0	0
20	28404191	.	A	G	6	3	9	0	0	9	0	0
20	28404247	.	T	C	8	0	8	0	9	17	0	0
20	28404270	.	T	G	6	14	20	0	3	23	0	0
20	28404342	.	G	A	3	7	10	0	1	11	0	0
20	28411688	.	T	C	0	1	1	0	0	1	0	0
20	28414423	.	T	C	3	4	7	0	0	7	0	0
20	28418587	.	C	T	6	5	11	0	0	11	0	0
20	28418939	.	T	C	3	9	12	0	0	12	0	0
20	28419015	.	A	T	5	4	9	0	2	11	0	0
20	28419133	.	A	T	1	2	3	0	0	3	0	0
20	28420111	.	C	T	1	2	3	0	0	3	0	0
20	28420496	.	C	T	4	4	8	0	0	8	0	0
20	28422842	.	C	A	1	2	3	0	0	3	0	0
20	28422920	.	A	G	3	2	5	0	0	5	0	0
20	28422927	.	T	C	3	0	3	0	2	5	0	0
20	28423035	.	G	T	7	3	10	0	0	10	0	0
20	28423062	.	G	A	6	1	7	0	0	7	0	0
20	28423072	.	A	T	6	2	8	0	0	8	0	0
20	28456574	.	T	C	5	5	10	0	1	11	0	0
20	28469982	.	A	G	5	7	12	0	0	12	0	0
20	28487287	.	T	C	1	2	3	0	0	3	0	0
20	28501425	.	G	A	0	4	4	0	2	6	0	0
20	28514841	.	A	G	4	3	7	0	0	7	0	0
20	28514878	.	T	C	5	6	11	0	1	12	0	0
20	28514955	.	C	T	4	4	8	0	0	8	0	0
20	28541754	.	A	G	2	3	5	0	0	5	0	0
20	28641940	.	A	T	11	3	14	0	0	14	0	0
20	28641997	.	T	A	3	3	6	0	0	6	0	0
20	28642007	.	G	A	2	2	4	0	0	4	0	0
20	28650323	.	T	C	16	9	25	0	0	25	0	0
20	28650328	.	A	C	15	10	25	0	2	27	0	0
20	28650945	.	A	T	13	11	24	0	2	26	0	0
20	28650946	.	T	G	14	12	26	0	0	26	0	0
20	28651194	.	C	T	20	19	39	0	1	40	0	0
20	28651239	.	A	G	20	19	39	0	1	40	0	0
20	28651454	.	G	A	20	17	37	0	3	40	0	0
20	28651709	.	T	C	10	0	10	0	5	15	0	0
20	28651958	.	T	G	9	7	16	0	1	17	0	0
20	28652449	.	G	C	15	18	33	0	0	33	0	0
20	28654339	.	G	A	1	2	3	0	0	3	0	0
20	28658666	.	A	C	8	4	12	0	1	13	0	0
20	28658693	.	T	C	4	0	4	0	3	7	0	0
20	28659924	.	A	G	2	3	5	0	0	5	0	0
20	28659969	.	G	T	9	5	14	0	0	14	0	0
20	28660050	.	G	A	5	4	9	0	1	10	0	0
20	28660729	.	T	C	10	0	10	0	8	18	0	0
20	28660795	.	G	A	11	4	15	0	1	16	0	0
20	28660828	.	G	T	11	4	15	0	0	15	0	0
20	28660837	.	T	C	12	5	17	0	0	17	0	0
20	28675587	.	C	A	0	8	8	0	0	8	0	0
20	28677911	.	G	T	5	4	9	0	3	12	0	0
20	28682989	.	T	C	1	4	5	0	1	6	0	0
20	28693295	.	C	T	3	3	6	0	0	6	0	0
20	28698284	.	T	C	8	0	8	0	3	11	0	0
20	28783046	.	T	C	14	6	20	0	1	21	0	0
20	28783327	.	T	C	4	3	7	0	2	9	0	0
20	28783502	.	C	G	4	5	9	0	0	9	0	0
20	28783607	.	T	C	3	0	3	0	12	15	0	0
20	28783627	.	T	C	4	8	12	0	1	13	0	0
20	28783688	.	C	A	10	11	21	0	1	22	0	0
20	28783781	.	A	C	8	1	9	0	12	21	0	0
20	28784045	.	G	T	10	7	17	0	1	18	0	0
20	28800961	.	A	G	13	9	22	0	2	24	0	0
20	28804089	.	G	A	6	6	12	0	0	12	0	0
20	28817492	.	A	G	1	0	1	0	0	1	0	0
20	28822696	.	T	A	6	2	8	0	0	8	0	0
20	28822735	.	T	C	1	1	2	0	0	2	0	0
20	28823116	.	T	C	2	1	3	0	0	3	0	0
20	28825375	.	C	T	7	10	17	0	0	17	0	0
20	28827208	.	A	G	1	0	1	0	0	1	0	0
20	28827350	.	T	C	3	5	8	0	0	8	0	0
20	28827388	.	C	A	7	8	15	0	1	16	0	0
20	28827416	.	C	T	8	9	17	0	0	17	0	0
20	28827433	.	A	C	9	9	18	0	0	18	0	0
20	28827633	.	T	C	1	3	4	0	0	4	0	0
20	28833245	.	C	T	15	12	27	0	1	28	0	0
20	28833312	.	C	A	16	21	37	0	2	39	0	0
20	28833793	.	A	G	20	20	40	0	1	41	0	0
20	28833878	.	T	C	19	2	21	0	24	45	0	0
20	28834008	.	C	T	22	18	40	0	1	41	0	0
20	28834536	.	C	A	4	5	9	0	1	10	0	0
20	28834571	.	G	A	4	4	8	0	0	8	0	0
20	28834597	.	T	C	4	0	4	0	3	7	0	0
20	28835046	.	A	T	1	4	5	0	0	5	0	0
20	28835101	.	T	G	3	2	5	0	1	6	0	0
20	28870806	.	C	G	22	27	49	0	1	50	0	0
20	28871830	.	G	A	32	28	60	0	7	67	0	0
20	28875824	.	T	C	15	0	15	0	17	32	0	0
20	28876885	.	G	A	5	21	26	0	1	27	0	0
20	28876899	.	A	G	4	18	22	0	0	22	0	0
20	28876942	.	T	A	17	7	24	0	0	24	0	0
20	28876971	.	A	C	14	0	14	0	10	24	0	0
20	28876996	.	T	A	10	10	20	0	2	22	0	0
20	28877028	.	C	T	7	18	25	0	1	26	0	0
20	28877085	.	T	A	8	18	26	0	2	28	0	0
20	28877136	.	A	T	10	14	24	0	0	24	0	0
20	28877696	.	T	C	14	1	15	0	19	34	0	0
20	28878097	.	T	G	6	17	23	0	0	23	0	0
20	28878229	.	T	A	5	5	10	0	0	10	0	0
20	28884768	.	T	A	1	1	2	0	0	2	0	0
20	28886159	.	A	T	3	11	14	0	0	14	0	0
20	28886311	.	T	C	13	12	25	0	0	25	0	0
20	28886530	.	C	T	11	7	18	0	2	20	0	0
20	28886608	.	C	A	3	3	6	0	0	6	0	0
20	28886618	.	C	A	4	1	5	0	0	5	0	0
20	28886735	.	T	C	9	7	16	0	0	16	0	0
20	28887091	.	C	A	1	2	3	0	0	3	0	0
20	28887092	.	T	A	1	2	3	0	0	3	0	0
20	28887498	.	T	A	10	11	21	0	0	21	0	0
20	28887590	.	G	C	11	14	25	0	0	25	0	0
20	28888012	.	C	A	5	3	8	0	1	9	0	0
20	28888041	.	A	T	5	3	8	0	1	9	0	0
20	28888198	.	G	C	10	0	10	0	6	16	0	0
20	28888331	.	T	A	8	8	16	0	2	18	0	0
20	28888514	.	C	G	2	3	5	0	0	5	0	0
20	28888629	.	T	G	5	6	11	0	0	11	0	0
20	28888856	.	A	G	4	7	11	0	0	11	0	0
20	28889248	.	G	T	7	7	14	0	0	14	0	0
20	28889306	.	A	G	7	5	12	0	0	12	0	0
20	28897255	.	G	A	2	1	3	0	0	3	0	0
20	28897595	.	A	G	5	5	10	0	0	10	0	0
20	28935493	.	G	A	6	3	9	0	0	9	0	0
20	28935620	.	T	A	7	3	10	0	1	11	0	0
20	28935902	.	A	G	3	0	3	0	0	3	0	0
20	28938417	.	C	G	1	2	3	1	0	4	0	0
20	28938491	.	C	T	5	2	7	0	0	7	0	0
20	28973834	.	T	C	8	8	16	0	0	16	0	0
20	29216103	.	G	T	5	2	7	0	0	7	0	0
20	29268260	.	A	G	4	3	7	0	0	7	0	0
20	29471843	.	A	T	1	2	3	0	0	3	0	0
20	30865461	.	G	A	2	2	4	0	0	4	0	0
20	30877774	.	C	T	2	2	4	0	0	4	0	0
20	30879211	.	C	T	5	2	7	0	0	7	0	0
20	30879494	.	G	A	4	5	9	0	0	9	0	0
20	30879843	.	A	C	5	5	10	0	1	11	0	0
20	30879987	.	A	G	1	3	4	0	0	4	0	0
20	30889754	.	T	G	2	3	5	0	0	5	0	0
20	30889792	.	T	A	3	6	9	0	0	9	0	0
20	30894333	.	T	C	3	0	3	0	5	8	0	0
20	30894496	.	G	T	4	4	8	0	0	8	0	0
20	30894510	.	T	A	5	3	8	0	0	8	0	0
20	30894630	.	A	T	1	4	5	0	0	5	0	0
20	30894743	.	T	C	3	3	6	0	0	6	0	0
20	30894830	.	T	C	7	3	10	0	0	10	0	0
20	30894834	.	T	C	5	2	7	0	1	8	0	0
20	30895007	.	A	G	1	9	10	0	0	10	0	0
20	30895013	.	A	G	1	8	9	0	0	9	0	0
20	30895070	.	A	G	3	11	14	0	0	14	0	0
20	30895091	.	G	A	4	10	14	0	0	14	0	0
20	30897944	.	G	A	5	4	9	0	1	10	0	0
20	30897948	.	G	T	5	5	10	0	0	10	0	0
20	30899353	.	A	G	5	5	10	0	0	10	0	0
20	30900837	.	A	C	1	0	1	0	3	4	0	0
20	30900880	.	A	C	3	0	3	0	7	10	0	0
20	30900928	.	C	G	0	7	7	0	6	13	0	0
20	30900969	.	T	G	2	5	7	0	1	8	0	0
20	30922687	.	G	A	7	8	15	0	1	16	0	0
20	30922688	.	A	T	7	9	16	0	0	16	0	0
20	30922808	.	T	A	7	7	14	0	3	17	0	0
20	30922836	.	C	A	14	4	18	0	0	19	1	0
20	30923101	.	T	C	6	8	14	0	0	14	0	0
20	30925253	.	T	C	1	0	1	0	2	3	0	0
20	30926205	.	T	C	5	4	9	0	1	10	0	0
20	30928174	.	T	C	1	1	2	0	0	2	0	0
20	30931021	.	A	T	1	0	1	0	0	1	0	0
20	30931108	.	G	A	7	10	17	0	0	17	0	0
20	30931671	.	G	A	14	5	19	0	1	20	0	0
20	30932277	.	T	C	18	1	19	0	17	36	0	0
20	30936755	.	T	C	1	0	1	0	1	2	0	0
20	30939177	.	T	C	8	16	24	0	2	26	0	0
20	30940566	.	C	G	7	6	13	0	0	13	0	0
20	30947353	.	T	C	33	16	49	0	2	51	0	0
20	30947433	.	T	C	10	11	21	0	0	21	0	0
20	31076504	.	T	A	6	5	11	0	0	11	0	0
20	31147609	.	G	A	5	6	11	0	0	11	0	0
20	31170202	.	G	A	8	6	14	0	1	15	0	0
20	31171010	.	G	A	0	5	5	0	0	5	0	0
20	31172725	.	A	C	3	1	4	0	0	4	0	0
20	31178425	.	G	T	5	11	16	0	1	18	1	0
20	31181050	.	A	G	7	6	13	0	0	13	0	0
20	31182194	.	G	A	3	0	3	0	0	3	0	0
20	31185594	.	C	A	4	6	10	0	0	10	0	0
20	31186253	.	T	C	4	2	6	0	0	6	0	0
20	31187975	.	G	A	17	19	36	0	0	36	0	0
20	31192304	.	A	C	4	0	4	0	0	4	0	0
20	31192720	.	C	T	3	9	12	0	0	12	0	0
20	31193762	.	G	A	0	3	3	0	3	6	0	0
20	31193826	.	C	T	13	5	18	0	0	18	0	0
20	31197217	.	G	T	7	8	15	0	1	16	0	0
20	31197307	.	G	A	0	4	4	0	4	8	0	0
20	31197465	.	T	C	10	7	17	0	0	17	0	0
20	31199655	.	G	A	1	1	2	0	0	2	0	0
20	31202316	.	C	T	4	2	6	0	0	6	0	0
20	31204173	.	T	C	5	8	13	0	0	13	0	0
20	31204191	.	A	C	9	7	16	0	1	17	0	0
20	31206649	.	A	G	0	4	4	0	0	4	0	0
20	31211701	.	T	A	10	8	18	0	0	18	0	0
20	31211710	.	A	G	10	10	20	0	0	20	0	0
20	31211846	.	G	A	0	3	3	0	7	10	0	0
20	31212156	.	G	A	1	10	11	0	10	21	0	0
20	31212390	.	G	C	6	3	9	0	1	10	0	0
20	31217572	.	C	G	7	3	10	0	0	10	0	0
20	31217612	.	T	C	2	2	4	0	1	5	0	0
20	31222978	.	T	G	11	0	11	0	8	19	0	0
20	31223282	.	C	T	3	2	5	0	0	5	0	0
20	31223336	.	C	T	6	6	12	0	0	12	0	0
20	31225875	.	C	T	3	4	7	0	0	7	0	0
20	31233199	.	C	T	0	1	1	0	2	3	0	0
20	31233214	.	T	A	2	2	4	0	0	4	0	0
20	31233329	.	C	T	0	5	5	0	5	10	0	0
20	31233463	.	T	G	2	5	7	0	0	7	0	0
20	31233566	.	T	G	2	8	10	0	0	10	0	0
20	31233623	.	T	C	1	4	5	0	0	5	0	0
20	31233679	.	A	G	4	3	7	0	1	8	0	0
20	31233837	.	G	C	4	6	10	0	0	10	0	0
20	31252532	.	G	A	2	1	3	0	0	3	0	0
20	31309826	.	C	G	0	2	2	0	1	3	0	0
20	31429917	.	T	G	3	3	6	0	0	6	0	0
20	31430115	.	A	T	7	9	16	0	0	16	0	0
20	31431345	.	C	T	4	3	7	0	0	7	0	0
20	31431457	.	T	A	5	9	14	0	1	15	0	0
20	31431501	.	G	T	4	5	9	0	0	9	0	0
20	31431561	.	A	G	5	3	8	0	0	8	0	0
20	31436387	.	T	C	13	0	13	0	9	22	0	0
20	31436483	.	C	T	10	14	24	0	0	24	0	0
20	31436504	.	T	C	9	0	9	0	10	19	0	0
20	31436984	.	C	T	2	0	2	0	0	2	0	0
20	31442308	.	C	T	0	2	2	0	1	3	0	0
20	31447356	.	A	G	0	2	2	0	0	2	0	0
20	31447455	.	C	T	2	3	5	0	0	5	0	0
20	31743161	.	C	T	4	3	7	0	0	7	0	0
20	31743684	.	T	C	2	3	5	0	0	5	0	0
20	31746212	.	T	A	2	2	4	0	0	4	0	0
20	31747695	.	G	C	12	14	26	0	0	26	0	0
20	31747860	.	C	T	0	9	9	0	10	19	0	0
20	31748183	.	C	T	8	10	18	0	1	19	0	0
20	31748448	.	A	G	6	10	16	0	1	17	0	0
20	31748518	.	C	T	11	17	28	0	0	28	0	0
20	31748803	.	A	G	3	13	16	0	1	17	0	0
20	31748845	.	A	T	4	12	16	0	0	16	0	0
20	31749118	.	A	G	14	13	27	0	1	28	0	0
20	31769469	.	A	G	5	7	12	0	0	12	0	0
20	31769523	.	T	A	2	4	6	0	0	6	0	0
20	31771899	.	G	A	0	1	1	0	0	1	0	0
20	31777192	.	C	T	0	5	5	0	8	13	0	0
20	31786688	.	T	A	3	4	7	0	0	7	0	0
20	32053122	.	G	A	10	14	24	0	1	25	0	0
20	32061596	.	G	A	5	10	15	0	1	16	0	0
20	32061611	.	C	A	0	11	11	0	4	15	0	0
20	32071494	.	A	G	2	7	9	0	0	9	0	0
20	32098046	.	A	G	12	11	23	0	1	24	0	0
20	32110172	.	T	C	2	0	2	0	2	4	0	0
20	32110331	.	G	A	21	12	33	0	0	33	0	0
20	32110370	.	T	C	12	0	12	0	19	31	0	0
20	32110790	.	T	C	4	16	20	0	0	20	0	0
20	32110898	.	A	T	19	10	29	0	1	30	0	0
20	32118658	.	A	G	10	0	10	0	11	21	0	0
20	32136584	.	T	A	10	11	21	0	0	21	0	0
20	32136588	.	G	T	9	11	20	0	1	21	0	0
20	32136847	.	C	G	6	9	15	0	0	15	0	0
20	32136921	.	G	A	10	5	15	0	0	15	0	0
20	32136953	.	C	T	5	10	15	0	1	16	0	0
20	32137529	.	A	T	5	10	15	0	1	16	0	0
20	32137752	.	G	T	11	9	20	0	2	22	0	0
20	32138171	.	T	C	11	14	25	0	0	25	0	0
20	32138478	.	A	G	11	16	27	0	3	30	0	0
20	32138692	.	G	A	14	10	24	0	2	26	0	0
20	32138723	.	A	G	13	0	13	0	8	21	0	0
20	32138754	.	T	C	14	11	25	0	1	26	0	0
20	32138828	.	C	T	14	18	32	0	1	33	0	0
20	32138965	.	A	T	3	3	6	0	0	6	0	0
20	32138977	.	G	A	0	3	3	0	3	6	0	0
20	32141959	.	T	A	1	1	2	0	0	2	0	0
20	32224485	.	C	A	8	11	19	0	0	19	0	0
20	32224532	.	T	C	6	8	14	0	0	14	0	0
20	32228863	.	G	A	22	16	38	0	1	39	0	0
20	32228936	.	A	C	13	15	28	0	1	29	0	0
20	32229004	.	G	A	23	17	40	0	1	41	0	0
20	32229053	.	C	T	22	12	34	0	3	37	0	0
20	32229095	.	T	C	16	15	31	0	2	33	0	0
20	32230168	.	T	C	16	15	31	0	0	31	0	0
20	32230376	.	T	C	13	10	23	0	1	24	0	0
20	32230574	.	T	A	13	14	27	0	3	30	0	0
20	32230592	.	T	A	14	19	33	0	2	36	1	0
20	32230620	.	C	T	12	23	35	0	3	38	0	0
20	32230680	.	A	G	8	16	24	0	0	24	0	0
20	32230720	.	C	G	9	9	18	0	0	18	0	0
20	32230776	.	G	A	11	14	25	0	1	27	1	0
20	32230781	.	G	C	13	18	31	0	0	31	0	0
20	32230836	.	T	C	7	9	16	0	2	18	0	0
20	32286800	.	C	T	1	5	6	0	6	12	0	0
20	32286877	.	A	C	15	18	33	0	1	34	0	0
20	32286923	.	A	T	13	15	28	0	1	29	0	0
20	32286960	.	A	C	9	14	23	0	1	24	0	0
20	32287181	.	C	T	0	6	6	0	7	13	0	0
20	32287317	.	C	T	6	5	11	0	0	11	0	0
20	32287943	.	A	C	5	7	12	0	0	12	0	0
20	32288318	.	T	A	8	4	12	0	0	12	0	0
20	32288372	.	T	C	14	0	14	0	8	22	0	0
20	32290149	.	T	A	9	12	21	0	0	21	0	0
20	32290222	.	G	A	13	9	22	0	0	22	0	0
20	32290435	.	A	G	14	15	29	0	1	30	0	0
20	32330924	.	T	G	6	12	18	0	0	18	0	0
20	32332298	.	T	C	7	1	8	0	5	13	0	0
20	32337734	.	A	C	1	3	4	0	0	4	0	0
20	32337918	.	A	C	3	1	4	0	0	4	0	0
20	32337927	.	G	A	1	1	2	0	0	2	0	0
20	32339847	.	A	G	4	2	6	0	0	6	0	0
20	32339860	.	T	G	5	2	7	0	0	7	0	0
20	32348548	.	T	C	1	1	2	0	0	2	0	0
20	32348568	.	C	T	3	2	5	0	0	5	0	0
20	32351817	.	A	T	0	1	1	0	0	1	0	0
20	32403599	.	A	G	2	5	7	0	1	8	0	0
20	32403611	.	C	T	3	3	6	0	2	8	0	0
20	32432315	.	G	T	11	7	18	0	1	19	0	0
20	32432657	.	A	G	11	1	12	0	8	20	0	0
20	32437987	.	C	T	1	4	5	0	0	5	0	0
20	32437993	.	G	T	1	5	6	0	0	6	0	0
20	32478509	.	T	C	1	2	3	0	0	3	0	0
20	32484600	.	C	T	7	4	11	0	0	11	0	0
20	32490004	.	G	T	4	3	7	0	0	7	0	0
20	32490047	.	A	T	4	6	10	0	0	10	0	0
20	32498345	.	A	G	5	3	8	0	0	8	0	0
20	32498635	.	C	A	3	6	9	0	0	9	0	0
20	32498639	.	C	A	2	6	8	0	1	9	0	0
20	32498771	.	C	G	7	4	11	0	0	11	0	0
20	32499166	.	G	A	0	14	14	0	4	18	0	0
20	32499199	.	T	C	3	7	10	0	1	11	0	0
20	32501840	.	T	G	8	9	17	0	0	17	0	0
20	32513235	.	G	A	6	6	12	0	1	13	0	0
20	32513256	.	G	A	5	4	9	0	1	10	0	0
20	32520171	.	C	T	8	6	14	0	0	14	0	0
20	32520172	.	A	G	4	6	10	0	4	14	0	0
20	32520330	.	T	C	8	9	17	0	0	17	0	0
20	32520351	.	A	G	12	0	12	0	10	22	0	0
20	32520365	.	A	G	17	0	17	0	12	29	0	0
20	32520615	.	T	A	5	11	16	0	0	16	0	0
20	32520673	.	A	G	3	13	16	0	0	16	0	0
20	32520815	.	A	G	6	0	6	0	8	14	0	0
20	32520852	.	A	G	6	4	10	0	0	10	0	0
20	32521057	.	C	T	5	6	11	0	2	13	0	0
20	32521203	.	C	T	7	8	15	0	1	16	0	0
20	32521377	.	C	T	6	9	15	0	0	15	0	0
20	32521686	.	A	C	10	16	26	0	2	28	0	0
20	32521719	.	A	C	9	16	25	0	1	27	1	0
20	32521742	.	G	A	11	19	30	0	0	30	0	0
20	32567835	.	G	T	1	0	1	0	0	1	0	0
20	32569300	.	C	T	3	3	6	0	0	6	0	0
20	32571913	.	T	C	2	0	2	0	0	2	0	0
20	32576667	.	T	C	1	6	7	0	0	7	0	0
20	32756790	.	G	A	0	6	6	0	8	14	0	0
20	32757807	.	C	G	6	0	6	0	12	18	0	0
20	32758490	.	A	G	9	10	19	0	1	20	0	0
20	32758558	.	T	C	11	9	20	0	2	22	0	0
20	32838484	.	T	C	1	0	1	0	2	3	0	0
20	32838551	.	A	G	2	6	8	0	0	8	0	0
20	32939176	.	T	C	2	3	5	0	0	5	0	0
20	33007836	.	T	C	0	0	0	0	1	1	0	0
20	33020372	.	C	G	1	1	2	0	0	2	0	0
20	33127588	.	C	T	1	1	2	0	0	2	0	0
20	33180295	.	G	A	7	4	11	0	0	11	0	0
20	33180547	.	C	T	5	4	9	0	0	9	0	0
20	33189326	.	T	G	7	0	7	0	5	12	0	0
20	33189631	.	G	A	8	3	11	0	0	11	0	0
20	33297701	.	C	T	0	1	1	0	0	1	0	0
20	33297746	.	C	A	0	3	3	0	0	3	0	0
20	33297776	.	A	C	7	6	13	0	0	13	0	0
20	33298651	.	G	A	8	6	14	0	0	14	0	0
20	33468040	.	T	G	10	25	35	0	1	36	0	0
20	33471085	.	G	A	1	5	6	0	0	6	0	0
20	33471127	.	A	T	6	8	14	0	1	15	0	0
20	33471166	.	C	T	0	12	12	0	12	24	0	0
20	33471199	.	T	C	7	0	7	0	9	16	0	0
20	33484083	.	G	A	4	8	12	0	0	12	0	0
20	33484387	.	T	C	5	7	12	0	1	13	0	0
20	33484438	.	G	C	3	0	3	0	8	11	0	0
20	33486846	.	G	A	5	4	9	0	0	9	0	0
20	33486989	.	T	C	5	0	5	0	3	8	0	0
20	33487238	.	C	T	3	4	7	0	0	7	0	0
20	33487370	.	T	A	1	6	7	0	0	7	0	0
20	33487374	.	G	T	0	5	5	0	1	6	0	0
20	33487603	.	C	T	1	7	8	0	0	8	0	0
20	33494064	.	A	G	15	13	28	0	1	29	0	0
20	33494436	.	C	T	22	17	39	0	0	39	0	0
20	33534313	.	A	G	1	2	3	0	0	3	0	0
20	33656178	.	C	T	0	2	2	0	0	2	0	0
20	33737482	.	T	C	0	2	2	0	0	2	0	0
20	33745452	.	C	T	2	2	4	0	0	4	0	0
20	33748921	.	T	A	1	6	7	0	0	7	0	0
20	33759014	.	C	T	0	1	1	0	0	1	0	0
20	33771521	.	G	A	0	2	2	0	0	2	0	0
20	33771605	.	A	G	4	3	7	0	0	7	0	0
20	33789729	.	T	C	6	0	6	0	7	13	0	0
20	33789927	.	C	T	0	4	4	0	9	13	0	0
20	33789965	.	G	T	12	9	21	0	1	22	0	0
20	33809464	.	C	A	2	2	4	0	1	5	0	0
20	33809783	.	C	A	8	10	18	0	0	18	0	0
20	33809846	.	G	C	12	18	30	0	0	30	0	0
20	33809927	.	T	A	10	14	24	0	0	24	0	0
20	33810302	.	C	T	2	1	3	0	1	4	0	0
20	33810303	.	C	A	2	2	4	0	0	4	0	0
20	33810343	.	A	G	3	2	5	0	3	8	0	0
20	33810344	.	G	A	2	6	8	0	0	8	0	0
20	33810403	.	C	A	9	2	11	0	0	11	0	0
20	33810845	.	C	T	7	6	13	0	0	13	0	0
20	33811150	.	T	G	1	2	3	0	0	3	0	0
20	33811230	.	T	A	1	5	6	0	0	6	0	0
20	33811257	.	T	G	1	5	6	0	0	6	0	0
20	33811400	.	A	T	4	3	7	0	1	8	0	0
20	33811435	.	G	A	5	4	9	0	0	9	0	0
20	33811436	.	C	A	4	4	8	0	1	9	0	0
20	33856416	.	A	T	5	7	12	0	0	12	0	0
20	33856421	.	T	C	5	6	11	0	0	11	0	0
20	33859788	.	A	T	4	1	5	0	0	5	0	0
20	33859869	.	C	T	0	11	11	0	17	28	0	0
20	33862741	.	G	A	2	0	2	0	0	2	0	0
20	33863932	.	T	C	0	0	0	0	1	1	0	0
20	33864772	.	A	G	3	8	11	0	0	11	0	0
20	34001034	.	G	A	1	2	3	0	0	3	0	0
20	34008141	.	G	A	0	3	3	0	0	3	0	0
20	34009363	.	G	A	0	1	1	0	0	1	0	0
20	34009947	.	A	G	6	8	14	0	2	16	0	0
20	34009952	.	C	A	7	9	16	0	0	16	0	0
20	34010028	.	A	G	2	8	10	0	0	10	0	0
20	34012916	.	A	T	3	5	8	0	1	9	0	0
20	34015845	.	C	T	6	10	16	0	3	19	0	0
20	34023551	.	T	C	1	0	1	0	0	1	0	0
20	34028271	.	C	T	1	2	3	0	0	3	0	0
20	34039408	.	A	C	6	5	11	0	0	11	0	0
20	34042070	.	A	G	4	1	5	0	1	6	0	0
20	34042209	.	A	G	2	4	6	0	0	6	0	0
20	34044813	.	G	A	6	6	12	0	0	12	0	0
20	34044845	.	A	T	2	1	3	0	0	3	0	0
20	34049141	.	G	A	2	2	4	0	0	4	0	0
20	34051417	.	G	A	2	3	5	0	0	5	0	0
20	34054401	.	C	T	2	4	6	0	0	6	0	0
20	34056227	.	C	T	7	4	11	0	0	11	0	0
20	34056656	.	A	G	7	7	14	0	2	16	0	0
20	34059175	.	A	T	2	0	2	0	0	2	0	0
20	34059259	.	C	T	5	4	9	0	0	9	0	0
20	34059433	.	C	T	0	1	1	0	0	1	0	0
20	34061117	.	C	T	1	0	1	0	0	1	0	0
20	34061286	.	A	G	1	3	4	0	0	4	0	0
20	34061577	.	A	T	2	3	5	0	0	5	0	0
20	34061784	.	C	T	2	4	6	0	0	6	0	0
20	34061788	.	G	T	2	1	3	0	3	6	0	0
20	34061986	.	G	A	1	2	3	0	0	3	0	0
20	34064061	.	C	T	1	5	6	0	0	6	0	0
20	34065796	.	A	G	2	0	2	0	0	2	0	0
20	34066128	.	G	A	1	1	2	0	0	2	0	0
20	34154118	.	T	C	2	3	5	0	1	6	0	0
20	34155025	.	C	T	10	12	22	0	2	24	0	0
20	34155134	.	G	A	11	4	15	0	0	15	0	0
20	34155339	.	C	A	18	10	28	0	2	30	0	0
20	34155428	.	A	G	14	11	25	0	0	25	0	0
20	34596736	.	C	T	5	2	7	0	0	7	0	0
20	34643277	.	G	T	4	2	6	0	0	6	0	0
20	34643392	.	G	T	4	2	6	0	0	6	0	0
20	34737944	.	G	C	1	2	3	0	0	3	0	0
20	34738198	.	G	A	24	13	37	0	1	38	0	0
20	34738314	.	G	A	10	18	28	0	1	29	0	0
20	34738397	.	G	T	8	10	18	0	0	18	0	0
20	34738473	.	T	G	14	8	22	0	0	22	0	0
20	34738756	.	A	G	15	19	34	0	1	35	0	0
20	34742840	.	G	A	1	4	5	0	0	5	0	0
20	34745872	.	A	G	7	3	10	0	0	10	0	0
20	34746019	.	G	A	10	12	22	0	0	22	0	0
20	34747208	.	T	C	4	6	10	0	0	10	0	0
20	34749747	.	G	A	8	10	18	0	0	18	0	0
20	34777607	.	C	T	1	2	3	0	1	4	0	0
20	34794668	.	T	C	4	3	7	0	0	7	0	0
20	34794939	.	C	T	24	35	59	0	3	62	0	0
20	34795111	.	C	A	27	39	66	0	5	71	0	0
20	34795126	.	A	G	30	37	67	0	3	70	0	0
20	34795296	.	T	C	30	34	64	0	2	66	0	0
20	34795379	.	T	C	38	25	63	0	0	63	0	0
20	34795473	.	C	T	3	22	25	0	38	63	0	0
20	34795689	.	C	T	39	26	65	0	2	67	0	0
20	34797252	.	G	T	34	30	64	0	2	66	0	0
20	34797598	.	A	T	29	30	59	0	3	62	0	0
20	34955791	.	C	T	21	25	46	0	5	51	0	0
20	34956159	.	A	T	22	9	31	0	0	31	0	0
20	34956164	.	T	A	20	9	29	0	2	31	0	0
20	34967476	.	T	C	5	0	5	0	9	14	0	0
20	34969773	.	A	T	11	2	13	0	0	13	0	0
20	34975831	.	G	A	1	2	3	0	0	3	0	0
20	34980452	.	T	C	11	7	18	0	0	18	0	0
20	34982018	.	C	T	4	2	6	0	0	6	0	0
20	34982323	.	T	A	3	7	10	0	1	11	0	0
20	34985368	.	C	A	1	11	12	0	7	19	0	0
20	34985384	.	C	T	1	12	13	0	6	19	0	0
20	34985424	.	T	G	6	10	16	0	0	16	0	0
20	34985462	.	A	G	9	10	19	0	0	19	0	0
20	34985480	.	A	T	9	5	14	0	0	14	0	0
20	34985499	.	A	C	6	3	9	0	0	9	0	0
20	34991739	.	T	A	4	3	7	0	0	7	0	0
20	34993974	.	G	A	2	2	4	0	0	4	0	0
20	34994019	.	G	T	2	4	6	0	1	7	0	0
20	35001423	.	G	A	6	3	9	0	0	9	0	0
20	35007466	.	A	G	1	0	1	0	0	1	0	0
20	35011946	.	C	T	3	2	5	0	0	5	0	0
20	35013931	.	G	C	1	3	4	0	0	4	0	0
20	35018537	.	G	A	4	3	7	0	0	7	0	0
20	35018847	.	C	A	1	2	3	0	0	3	0	0
20	35019290	.	A	C	1	0	1	0	2	3	0	0
20	35019578	.	T	C	1	2	3	0	0	3	0	0
20	35019662	.	G	A	1	2	3	0	0	3	0	0
20	35019845	.	T	C	2	2	4	0	0	4	0	0
20	35020427	.	T	G	1	2	3	0	0	3	0	0
20	35021337	.	A	G	1	1	2	0	0	2	0	0
20	35059085	.	G	A	0	14	14	0	9	23	0	0
20	35064469	.	T	C	15	13	28	0	0	28	0	0
20	35064808	.	C	T	2	3	5	0	0	5	0	0
20	35065345	.	G	A	0	0	0	0	3	3	0	0
20	35065573	.	A	C	5	10	15	0	7	22	0	0
20	35066821	.	G	A	0	12	12	0	11	23	0	0
20	35066935	.	G	A	1	28	29	0	20	49	0	0
20	35068064	.	A	G	9	0	9	0	15	24	0	0
20	35068790	.	A	T	9	6	15	0	1	16	0	0
20	35069063	.	A	C	9	7	16	0	2	18	0	0
20	35069756	.	A	G	7	18	25	0	2	27	0	0
20	35069963	.	A	C	13	15	28	0	1	29	0	0
20	35070176	.	C	T	13	13	26	0	1	27	0	0
20	35070217	.	T	G	11	22	33	0	2	35	0	0
20	35086291	.	C	T	3	3	6	0	0	6	0	0
20	35131977	.	G	A	1	1	2	0	0	2	0	0
20	35142856	.	A	G	1	0	1	0	0	1	0	0
20	35159500	.	C	A	3	4	7	0	2	9	0	0
20	35183406	.	A	G	1	0	1	0	1	2	0	0
20	35184413	.	T	C	1	0	1	0	0	1	0	0
20	35184419	.	T	C	1	0	1	0	0	1	0	0
20	35186620	.	C	T	1	0	1	0	0	1	0	0
20	35186629	.	G	C	0	0	0	0	0	1	1	0
20	35188776	.	G	A	2	2	4	0	1	5	0	0
20	35195535	.	A	G	0	4	4	0	1	5	0	0
20	35198810	.	A	C	1	0	1	0	0	1	0	0
20	35204702	.	A	C	3	8	11	0	0	11	0	0
20	35204729	.	T	C	3	5	8	0	2	10	0	0
20	35204773	.	C	T	7	4	11	0	0	11	0	0
20	35204814	.	A	G	4	0	4	0	4	8	0	0
20	35204848	.	T	G	3	3	6	0	0	6	0	0
20	35204944	.	G	A	8	8	16	0	0	16	0	0
20	35205061	.	C	T	8	11	19	0	0	19	0	0
20	35205182	.	T	C	7	8	15	0	0	15	0	0
20	35205361	.	T	A	3	2	5	0	0	5	0	0
20	35205600	.	A	T	14	10	24	0	0	24	0	0
20	35205680	.	A	G	8	7	15	0	0	15	0	0
20	35206101	.	A	T	9	4	13	0	1	14	0	0
20	35208046	.	A	G	4	4	8	0	1	9	0	0
20	35209012	.	G	A	2	3	5	0	0	5	0	0
20	35209080	.	T	A	1	4	5	0	0	5	0	0
20	35209405	.	C	T	15	9	24	0	2	26	0	0
20	35209481	.	G	A	13	11	24	0	0	24	0	0
20	35210175	.	C	A	12	7	19	0	2	21	0	0
20	35210212	.	G	T	9	4	13	0	3	16	0	0
20	35210229	.	A	C	8	4	12	0	1	13	0	0
20	35210282	.	T	C	1	0	1	0	6	7	0	0
20	35210306	.	T	C	4	2	6	0	0	6	0	0
20	35210320	.	T	C	5	2	7	0	1	8	0	0
20	35210462	.	A	T	2	2	4	0	0	4	0	0
20	35210538	.	C	G	4	4	8	0	2	10	0	0
20	35210575	.	C	T	4	1	5	0	1	6	0	0
20	35210649	.	A	G	3	2	5	0	0	5	0	0
20	35210853	.	A	T	2	8	10	0	2	12	0	0
20	35210909	.	T	C	10	3	13	0	0	13	0	0
20	35211015	.	T	A	1	3	4	0	0	4	0	0
20	35211153	.	A	G	0	2	2	0	0	2	0	0
20	35211225	.	A	G	3	3	6	0	2	8	0	0
20	35211399	.	G	A	7	4	11	0	0	11	0	0
20	35211515	.	C	T	0	5	5	0	1	6	0	0
20	35211760	.	G	A	8	5	13	0	1	14	0	0
20	35212168	.	A	G	2	2	4	0	0	4	0	0
20	35212366	.	T	C	2	4	6	0	0	6	0	0
20	35215671	.	C	T	2	2	4	0	0	4	0	0
20	35215680	.	T	G	2	4	6	0	0	6	0	0
20	35226167	.	C	A	1	2	3	0	0	3	0	0
20	35226665	.	T	C	1	2	3	0	1	4	0	0
20	35226813	.	A	G	5	2	7	0	0	7	0	0
20	35227211	.	G	A	5	4	9	0	0	9	0	0
20	35227256	.	C	G	3	3	6	0	0	6	0	0
20	35295208	.	C	T	1	0	1	0	1	2	0	0
20	35296980	.	T	C	3	6	9	1	0	10	0	0
20	35297417	.	T	G	13	8	21	0	0	21	0	0
20	35297693	.	G	A	7	10	17	0	1	18	0	0
20	35297699	.	A	G	6	13	19	0	0	19	0	0
20	35297870	.	T	C	3	4	7	0	1	8	0	0
20	35392100	.	C	T	6	5	11	0	1	12	0	0
20	35427409	.	G	C	19	25	44	0	1	45	0	0
20	35427536	.	G	C	1	3	4	0	1	5	0	0
20	35427676	.	T	G	24	0	24	0	31	55	0	0
20	35427745	.	A	G	23	1	24	0	38	62	0	0
20	35427907	.	C	G	21	23	44	0	0	45	1	0
20	35427946	.	A	G	19	1	20	0	24	44	0	0
20	35428035	.	A	G	27	18	45	0	6	51	0	0
20	35428436	.	G	A	31	30	61	0	1	62	0	0
20	35428633	.	T	C	29	28	57	0	5	62	0	0
20	35428802	.	A	G	21	42	63	0	2	65	0	0
20	35429017	.	T	A	34	13	47	0	0	47	0	0
20	35429054	.	A	G	28	3	31	0	32	63	0	0
20	35429610	.	A	T	31	27	58	0	2	61	1	0
20	35433311	.	A	G	22	2	24	0	22	46	0	0
20	35497048	.	A	G	1	0	1	0	0	1	0	0
20	35798370	.	G	A	19	15	34	0	1	35	0	0
20	35798697	.	A	T	7	4	11	0	1	13	1	0
20	35799135	.	G	A	11	11	22	0	0	22	0	0
20	35799175	.	T	C	5	5	10	0	1	11	0	0
20	35799192	.	T	A	4	2	6	0	1	7	0	0
20	35799238	.	G	A	7	2	9	0	0	9	0	0
20	35799291	.	G	C	7	3	10	0	0	10	0	0
20	35799534	.	T	C	9	13	22	0	0	22	0	0
20	35799612	.	A	T	8	6	14	0	0	14	0	0
20	35799673	.	T	A	10	12	22	0	0	22	0	0
20	35799729	.	T	A	11	9	20	0	1	21	0	0
20	35799751	.	G	A	10	6	16	0	1	17	0	0
20	35799889	.	A	T	8	8	16	0	0	16	0	0
20	35799913	.	T	G	7	3	10	0	0	10	0	0
20	35800098	.	G	A	14	11	25	0	1	26	0	0
20	35800338	.	T	G	7	3	10	0	0	10	0	0
20	35800349	.	C	T	7	3	10	0	1	11	0	0
20	35800520	.	G	A	7	4	11	0	2	13	0	0
20	35800557	.	G	A	3	3	6	0	2	8	0	0
20	35800564	.	T	C	4	4	8	0	0	8	0	0
20	35800749	.	G	A	12	6	18	0	0	18	0	0
20	35816533	.	A	G	3	9	12	0	0	12	0	0
20	35816534	.	A	G	3	8	11	0	1	12	0	0
20	35831719	.	C	T	4	4	8	0	0	8	0	0
20	35841393	.	C	T	2	5	7	0	0	7	0	0
20	35941146	.	G	A	0	1	1	0	1	2	0	0
20	35979899	.	G	T	5	4	9	0	0	10	1	0
20	35979910	.	T	G	4	6	10	0	0	10	0	0
20	35979983	.	G	C	2	3	5	0	0	5	0	0
20	35980009	.	A	G	3	1	4	0	0	4	0	0
20	35980021	.	C	T	2	0	2	0	0	2	0	0
20	36067796	.	C	T	0	3	3	0	3	6	0	0
20	36069388	.	G	A	2	2	4	0	1	5	0	0
20	36069734	.	C	T	1	2	3	0	0	3	0	0
20	36100657	.	A	C	1	0	1	0	2	3	0	0
20	36234084	.	C	A	4	4	8	0	2	10	0	0
20	36290217	.	C	T	6	5	11	0	3	14	0	0
20	36297356	.	G	A	0	11	11	0	14	25	0	0
20	36297418	.	C	A	12	15	27	0	0	27	0	0
20	36297871	.	A	T	3	12	15	0	1	16	0	0
20	36403820	.	T	A	1	3	4	0	0	4	0	0
20	36416877	.	A	C	2	4	6	0	1	7	0	0
20	36420218	.	A	C	9	18	27	0	0	27	0	0
20	36420713	.	C	T	0	8	8	0	19	27	0	0
20	36420753	.	T	A	16	9	25	0	2	27	0	0
20	36420804	.	G	T	13	13	26	0	0	26	0	0
20	36421219	.	G	A	7	11	18	0	2	20	0	0
20	36421238	.	C	T	9	16	25	0	1	26	0	0
20	36421530	.	A	C	8	0	8	0	8	16	0	0
20	36421757	.	C	T	0	10	10	0	5	15	0	0
20	36422098	.	C	A	14	11	25	0	1	26	0	0
20	36422146	.	G	C	11	7	18	0	0	18	0	0
20	36422291	.	G	T	3	9	12	0	0	12	0	0
20	36434308	.	A	G	6	7	13	0	0	13	0	0
20	36439858	.	A	C	3	6	9	0	3	12	0	0
20	36440113	.	C	T	0	1	1	0	21	22	0	0
20	36440170	.	C	T	0	13	13	0	13	26	0	0
20	36449286	.	G	A	0	2	2	0	0	2	0	0
20	36449385	.	C	T	9	7	16	0	0	16	0	0
20	36449442	.	A	C	9	6	15	0	1	16	0	0
20	36449601	.	C	T	3	7	10	0	1	11	0	0
20	36559761	.	T	G	3	4	7	0	0	7	0	0
20	36626195	.	A	G	14	0	14	0	15	29	0	0
20	36626218	.	C	T	10	15	25	0	0	25	0	0
20	36626248	.	G	A	12	13	25	0	2	27	0	0
20	36626335	.	C	T	12	5	17	0	2	19	0	0
20	36626354	.	C	A	8	6	14	0	2	16	0	0
20	36626465	.	C	T	6	2	8	0	0	8	0	0
20	36629281	.	A	G	4	3	7	0	0	7	0	0
20	36637604	.	T	A	1	6	7	0	0	7	0	0
20	36637657	.	A	C	3	6	9	0	1	10	0	0
20	36637829	.	T	C	5	2	7	0	1	8	0	0
20	36637999	.	G	A	5	7	12	0	0	12	0	0
20	36638033	.	G	T	5	12	17	0	0	17	0	0
20	36638138	.	C	G	2	3	5	0	0	5	0	0
20	36638169	.	T	C	1	7	8	0	1	9	0	0
20	36646951	.	C	T	1	2	3	0	0	3	0	0
20	36656380	.	A	C	2	0	2	0	0	2	0	0
20	36675294	.	G	C	7	0	7	0	10	17	0	0
20	36675456	.	G	A	6	8	14	0	1	15	0	0
20	36675468	.	C	T	9	7	16	0	1	17	0	0
20	36677457	.	C	T	7	5	12	0	0	12	0	0
20	36677574	.	G	A	3	2	5	0	0	5	0	0
20	36773807	.	A	G	7	7	14	0	0	14	0	0
20	36773918	.	A	G	11	0	11	0	7	18	0	0
20	36783480	.	C	T	6	4	10	0	0	10	0	0
20	36785477	.	G	A	5	7	12	0	0	12	0	0
20	36788775	.	C	T	1	0	1	0	0	1	0	0
20	36791885	.	C	T	6	6	12	0	0	12	0	0
20	36792123	.	T	C	0	5	5	0	0	5	0	0
20	36816471	.	G	A	5	7	12	0	0	12	0	0
20	36816522	.	G	A	6	5	11	0	0	11	0	0
20	36817095	.	T	A	3	2	5	0	1	6	0	0
20	36817101	.	A	G	2	4	6	0	1	7	0	0
20	36817184	.	G	A	0	4	4	0	3	7	0	0
20	36817368	.	G	C	3	3	6	0	0	6	0	0
20	36821214	.	A	G	1	4	5	0	0	5	0	0
20	36828833	.	T	C	5	5	10	0	0	10	0	0
20	36828948	.	A	C	4	5	9	0	0	9	0	0
20	36829040	.	T	C	7	6	13	0	2	15	0	0
20	36829208	.	T	C	4	9	13	0	0	13	0	0
20	36829517	.	T	G	11	0	11	0	8	19	0	0
20	36838717	.	C	T	10	5	15	0	1	16	0	0
20	36838805	.	C	T	5	7	12	0	1	13	0	0
20	36838871	.	C	T	5	15	20	0	0	20	0	0
20	36838896	.	A	G	5	14	19	0	0	19	0	0
20	36915481	.	G	A	7	15	22	0	2	24	0	0
20	36915529	.	G	A	11	12	23	0	2	25	0	0
20	36916004	.	G	A	9	10	19	0	1	20	0	0
20	36916050	.	A	G	10	8	18	0	1	19	0	0
20	36917631	.	C	T	7	7	14	0	0	14	0	0
20	37913866	.	A	G	4	8	12	0	0	12	0	0
20	37914025	.	A	G	15	0	15	0	7	22	0	0
20	38765296	.	T	G	4	6	10	0	0	10	0	0
20	38820176	.	A	G	0	2	2	0	0	2	0	0
20	39257354	.	A	C	1	3	4	0	0	4	0	0
20	39806385	.	T	C	2	3	5	0	0	5	0	0
20	41237086	.	T	A	1	3	4	0	0	4	0	0
20	41237909	.	A	G	3	2	5	0	0	5	0	0
20	41998507	.	T	C	20	6	26	0	1	27	0	0
20	41998516	.	T	C	20	7	27	0	0	27	0	0
20	42047386	.	C	T	1	1	2	0	0	2	0	0
20	42100882	.	G	A	1	3	4	0	0	4	0	0
20	42203254	.	C	T	4	7	11	0	0	11	0	0
20	42203407	.	G	T	7	6	13	0	2	15	0	0
20	42203461	.	T	C	7	13	20	0	2	22	0	0
20	42221216	.	C	A	0	4	4	0	1	5	0	0
20	42221438	.	C	A	5	4	9	0	0	9	0	0
20	42221439	.	A	T	5	4	9	0	0	9	0	0
20	42221555	.	C	T	17	13	30	0	0	30	0	0
20	42221731	.	T	G	4	7	11	0	0	11	0	0
20	42221964	.	A	C	3	2	5	0	0	5	0	0
20	42222546	.	A	T	10	7	17	0	0	17	0	0
20	42222549	.	A	T	10	8	18	0	0	18	0	0
20	42222770	.	T	C	7	6	13	0	0	13	0	0
20	42233955	.	G	C	3	0	3	0	0	3	0	0
20	42241224	.	T	G	7	7	14	0	0	14	0	0
20	42247018	.	G	C	4	3	7	0	0	7	0	0
20	42247099	.	T	A	2	5	7	0	0	7	0	0
20	42247108	.	C	G	3	5	8	0	0	8	0	0
20	42247180	.	T	C	3	5	8	0	0	8	0	0
20	42247231	.	G	A	1	3	4	0	0	4	0	0
20	42275441	.	G	A	1	7	8	0	2	10	0	0
20	42280782	.	C	T	10	5	15	0	0	15	0	0
20	42281000	.	G	A	0	4	4	0	8	12	0	0
20	42281068	.	C	T	4	4	8	0	0	8	0	0
20	42281408	.	G	A	0	11	11	0	4	15	0	0
20	42296674	.	C	T	5	2	7	0	0	7	0	0
20	42296893	.	C	G	1	3	4	0	0	4	0	0
20	42296908	.	C	T	3	3	6	0	0	6	0	0
20	42296982	.	A	C	2	2	4	0	0	4	0	0
20	42297907	.	A	G	3	2	5	0	0	5	0	0
20	42299681	.	A	G	1	2	3	0	0	3	0	0
20	42299687	.	C	A	1	2	3	0	0	3	0	0
20	42300015	.	T	A	2	3	5	0	1	6	0	0
20	42304274	.	T	C	1	0	1	0	0	1	0	0
20	42592245	.	G	A	1	2	3	0	0	3	0	0
20	42604480	.	G	A	3	2	5	0	0	5	0	0
20	42627357	.	G	T	1	2	3	0	0	3	0	0
20	42627360	.	T	C	1	2	3	0	0	3	0	0
20	42629329	.	C	T	1	2	3	0	0	3	0	0
20	42629473	.	G	A	2	1	3	0	0	3	0	0
20	42629476	.	C	G	1	0	1	0	1	2	0	0
20	42631258	.	T	A	1	0	1	0	0	1	0	0
20	42650481	.	G	T	0	2	2	0	2	4	0	0
20	42653409	.	C	T	1	4	5	0	0	5	0	0
20	42653523	.	C	T	2	3	5	0	0	5	0	0
20	42660034	.	A	G	3	6	9	0	0	9	0	0
20	42660273	.	C	G	2	0	2	0	4	6	0	0
20	42660491	.	G	T	2	8	10	0	1	11	0	0
20	42687744	.	T	C	1	3	4	0	0	4	0	0
20	42688156	.	C	A	1	5	6	0	0	6	0	0
20	42688225	.	A	C	1	3	4	0	0	4	0	0
20	42748829	.	C	T	1	3	4	0	0	4	0	0
20	42918862	.	C	T	0	1	1	0	0	1	0	0
20	42929574	.	C	T	1	3	4	0	0	4	0	0
20	42932464	.	C	T	2	1	3	0	0	3	0	0
20	42939350	.	T	C	3	5	8	0	0	8	0	0
20	42939407	.	G	A	3	0	3	0	0	3	0	0
20	42941107	.	T	C	2	5	7	0	0	7	0	0
20	42941176	.	G	T	2	4	6	0	0	6	0	0
20	42943084	.	G	A	1	1	2	0	0	2	0	0
20	42953084	.	T	C	2	1	3	0	0	3	0	0
20	42953096	.	G	A	1	4	5	0	0	5	0	0
20	42953129	.	C	T	5	2	7	0	0	7	0	0
20	42968811	.	C	T	0	5	5	0	6	11	0	0
20	42968857	.	T	A	4	5	9	0	0	9	0	0
20	43016669	.	G	C	1	2	3	0	0	3	0	0
20	43016739	.	C	T	4	2	6	0	0	6	0	0
20	43016828	.	G	A	4	3	7	0	0	7	0	0
20	43017007	.	T	C	2	3	5	0	0	5	0	0
20	43017200	.	G	A	3	3	6	0	0	6	0	0
20	43017246	.	C	G	1	1	2	0	0	2	0	0
20	43035137	.	C	T	0	1	1	0	0	1	0	0
20	43036852	.	G	A	2	1	3	0	0	3	0	0
20	43041025	.	T	C	1	1	2	0	0	2	0	0
20	43120256	.	T	G	15	4	19	0	0	19	0	0
20	43120658	.	T	G	10	12	22	0	0	22	0	0
20	43120718	.	C	T	1	7	8	0	5	13	0	0
20	43120753	.	A	T	5	7	12	0	1	14	1	0
20	43120787	.	G	C	0	0	0	0	18	18	0	0
20	43120814	.	T	A	4	12	16	0	1	17	0	0
20	43120842	.	A	G	5	3	8	0	0	8	0	0
20	43121545	.	A	G	11	5	16	0	0	16	0	0
20	43121650	.	T	C	1	9	10	0	0	10	0	0
20	43122921	.	G	T	1	14	15	0	1	18	2	0
20	43122925	.	T	G	2	18	20	0	0	20	0	0
20	43123314	.	C	T	3	3	6	0	0	6	0	0
20	43133228	.	G	C	2	4	6	0	0	6	0	0
20	43133426	.	A	G	8	3	11	0	0	11	0	0
20	43158910	.	C	T	1	3	4	0	0	4	0	0
20	43161797	.	A	G	0	0	0	0	1	1	0	0
20	43184362	.	G	A	1	4	5	0	0	5	0	0
20	43194695	.	T	G	0	2	2	0	0	2	0	0
20	43252360	.	G	A	1	3	4	0	0	4	0	0
20	43252447	.	T	C	0	0	0	0	1	1	0	0
20	43345866	.	T	C	1	2	3	0	1	4	0	0
20	43648391	.	G	A	5	2	7	0	0	7	0	0
20	43648538	.	C	T	3	3	6	0	0	6	0	0
20	43652934	.	T	C	3	2	5	0	0	5	0	0
20	43652967	.	T	C	5	3	8	0	0	8	0	0
20	43655958	.	A	G	3	2	5	0	0	5	0	0
20	43655967	.	C	G	3	2	5	0	0	5	0	0
20	43670280	.	G	C	6	2	8	0	0	8	0	0
20	43671935	.	G	A	1	1	2	0	0	2	0	0
20	43673634	.	G	A	0	6	6	0	5	11	0	0
20	43675840	.	G	A	0	2	2	0	4	6	0	0
20	43680616	.	C	A	3	6	9	0	0	9	0	0
20	43680700	.	G	A	6	6	12	0	0	12	0	0
20	43680752	.	C	T	1	3	4	0	0	4	0	0
20	43683238	.	A	G	3	0	3	0	2	5	0	0
20	43686738	.	G	A	0	1	1	0	0	1	0	0
20	43689138	.	T	A	8	4	12	0	0	12	0	0
20	43689254	.	C	A	5	7	12	0	0	12	0	0
20	43689360	.	C	T	8	10	18	0	0	18	0	0
20	43689418	.	G	A	0	6	6	0	11	17	0	0
20	43694144	.	G	T	1	1	2	0	0	2	0	0
20	43711968	.	A	G	1	1	2	0	0	2	0	0
20	43714699	.	T	G	1	0	1	0	4	5	0	0
20	43746738	.	A	G	6	4	10	0	0	10	0	0
20	43746749	.	C	T	0	4	4	0	7	11	0	0
20	43746780	.	C	T	3	7	10	0	0	10	0	0
20	43746890	.	T	C	10	0	10	0	13	23	0	0
20	43750362	.	A	G	6	18	24	0	0	24	0	0
20	43750680	.	A	G	6	24	30	0	0	30	0	0
20	43776373	.	T	C	26	14	40	0	1	41	0	0
20	43776456	.	T	A	36	17	53	0	1	54	0	0
20	43776841	.	G	A	26	34	60	0	2	62	0	0
20	43776842	.	A	G	35	26	61	0	1	62	0	0
20	43786415	.	T	C	18	21	39	0	2	41	0	0
20	43793065	.	T	C	4	2	6	0	0	6	0	0
20	43793193	.	G	A	16	14	30	0	0	30	0	0
20	43793329	.	C	T	7	5	12	0	2	14	0	0
20	43793683	.	G	A	8	5	13	0	0	13	0	0
20	43793702	.	C	T	11	9	20	0	0	20	0	0
20	43793867	.	A	C	9	9	18	0	0	18	0	0
20	43793901	.	A	G	12	8	20	0	1	21	0	0
20	43793960	.	A	T	14	15	29	0	2	31	0	0
20	43794004	.	G	A	15	14	29	0	0	29	0	0
20	43794053	.	A	T	16	18	34	0	1	35	0	0
20	43794312	.	C	T	0	6	6	0	2	8	0	0
20	43794488	.	A	G	8	2	10	0	0	10	0	0
20	43812584	.	G	A	7	3	10	0	1	11	0	0
20	43825607	.	A	G	3	3	6	0	0	6	0	0
20	43831482	.	T	C	8	9	17	0	0	17	0	0
20	43895806	.	G	A	6	9	15	0	1	16	0	0
20	43895827	.	T	A	5	7	12	0	1	13	0	0
20	43917422	.	A	T	1	4	5	0	0	5	0	0
20	43917450	.	A	G	2	7	9	0	0	9	0	0
20	43917468	.	A	G	4	5	9	0	0	9	0	0
20	43917553	.	C	T	4	3	7	0	0	7	0	0
20	43917559	.	A	G	3	3	6	0	0	6	0	0
20	43917616	.	A	C	8	8	16	0	0	16	0	0
20	43917617	.	C	A	8	8	16	0	0	16	0	0
20	43968214	.	C	T	1	3	4	0	0	4	0	0
20	44344521	.	A	T	1	2	3	0	0	3	0	0
20	44346910	.	G	A	0	2	2	0	2	4	0	0
20	44346913	.	T	C	2	2	4	0	0	4	0	0
20	44372973	.	C	A	6	8	14	0	0	14	0	0
20	44372977	.	C	T	6	8	14	0	0	14	0	0
20	44386452	.	C	T	1	15	16	0	13	29	0	0
20	44386561	.	G	A	0	1	1	0	0	1	0	0
20	44451286	.	C	A	0	3	3	0	12	15	0	0
20	44464875	.	G	T	9	20	29	0	1	30	0	0
20	44465778	.	G	T	8	10	18	0	2	20	0	0
20	44509653	.	C	T	0	1	1	0	0	1	0	0
20	44517604	.	C	T	2	1	3	0	0	3	0	0
20	44519142	.	G	A	1	2	3	0	0	3	0	0
20	44567107	.	T	C	7	7	14	0	0	14	0	0
20	44569943	.	C	A	4	1	5	0	0	5	0	0
20	44574845	.	G	A	9	3	12	0	0	12	0	0
20	44574852	.	G	T	12	3	15	0	1	16	0	0
20	44623940	.	G	A	0	1	1	0	2	3	0	0
20	44680332	.	G	T	0	1	1	0	1	2	0	0
20	44761074	.	A	G	2	1	3	0	0	3	0	0
20	44761518	.	T	C	1	2	3	0	0	3	0	0
20	44799458	.	T	A	8	4	12	0	0	12	0	0
20	45040929	.	T	C	3	0	3	0	7	11	1	0
20	45057888	.	C	T	1	2	3	0	0	3	0	0
20	45406735	.	C	A	3	3	6	0	0	8	2	0
20	45406783	.	C	T	8	5	13	0	0	13	0	0
20	45406870	.	G	A	7	13	20	0	0	20	0	0
20	45408129	.	T	A	7	7	14	0	0	14	0	0
20	45408130	.	C	T	0	6	6	0	8	14	0	0
20	45408345	.	G	A	2	6	8	0	1	9	0	0
20	45408436	.	G	A	3	2	5	0	4	9	0	0
20	45643947	.	G	C	7	6	13	0	0	13	0	0
20	45644095	.	C	T	5	6	11	0	1	12	0	0
20	45644096	.	T	G	5	7	12	0	0	12	0	0
20	45644152	.	G	C	7	1	8	0	0	8	0	0
20	45644163	.	G	T	9	2	11	0	0	11	0	0
20	45644275	.	G	A	3	6	9	0	0	9	0	0
20	45645560	.	A	G	2	4	6	0	0	6	0	0
20	45645574	.	A	G	4	6	10	0	0	10	0	0
20	45649379	.	C	T	0	2	2	0	2	4	0	0
20	45653434	.	A	G	8	8	16	0	0	16	0	0
20	45656899	.	A	G	3	2	5	0	0	5	0	0
20	45669311	.	C	T	16	19	35	0	0	35	0	0
20	45685823	.	T	A	3	3	6	0	0	6	0	0
20	45689866	.	G	A	0	4	4	0	0	4	0	0
20	45689951	.	A	G	3	4	7	0	0	7	0	0
20	45692585	.	G	A	13	7	20	0	0	20	0	0
20	45692624	.	C	T	11	4	15	0	0	15	0	0
20	45741592	.	C	A	5	3	8	0	0	8	0	0
20	45745423	.	C	T	8	10	18	0	2	20	0	0
20	45745523	.	C	T	9	11	20	0	1	21	0	0
20	45745930	.	A	G	9	0	9	0	9	18	0	0
20	45746150	.	G	A	11	13	24	0	1	25	0	0
20	45746402	.	G	A	19	9	28	0	3	31	0	0
20	45746432	.	C	T	19	11	30	0	0	30	0	0
20	45746486	.	T	C	19	9	28	0	1	29	0	0
20	45746674	.	C	A	12	15	27	0	1	28	0	0
20	45746678	.	C	T	13	15	28	0	1	29	0	0
20	45746936	.	C	G	12	15	27	0	1	28	0	0
20	45747032	.	G	C	0	20	20	0	12	32	0	0
20	45747125	.	G	A	0	3	3	0	1	4	0	0
20	45751304	.	T	C	1	0	1	0	0	1	0	0
20	45751364	.	T	A	11	11	22	0	1	23	0	0
20	45751466	.	G	A	3	20	23	0	0	23	0	0
20	45751526	.	T	G	18	12	30	0	0	30	0	0
20	45751563	.	T	C	17	18	35	0	0	35	0	0
20	45751668	.	G	A	3	5	8	0	0	8	0	0
20	45759508	.	G	A	0	2	2	0	0	2	0	0
20	45764770	.	C	A	0	5	5	0	3	8	0	0
20	45766438	.	C	G	3	1	4	0	0	4	0	0
20	45772021	.	A	G	1	1	2	0	1	3	0	0
20	46352444	.	G	C	3	3	6	0	0	6	0	0
20	46352460	.	A	T	5	4	9	0	0	9	0	0
20	46352632	.	A	C	1	0	1	0	3	4	0	0
20	46353253	.	G	A	5	2	7	0	0	7	0	0
20	46353259	.	G	A	5	2	7	0	0	7	0	0
20	46357302	.	G	A	2	3	5	0	0	5	0	0
20	46357333	.	C	A	0	3	3	0	5	8	0	0
20	46359889	.	T	C	3	0	3	0	5	8	0	0
20	46359964	.	T	C	1	2	3	0	1	4	0	0
20	46430090	.	A	G	0	0	0	0	1	1	0	0
20	46430099	.	C	T	0	1	1	0	0	1	0	0
20	46441724	.	C	A	5	2	7	0	0	8	1	0
20	46442459	.	A	G	6	16	22	0	1	23	0	0
20	46451592	.	G	A	0	4	4	0	0	4	0	0
20	46457175	.	A	T	13	13	26	0	1	27	0	0
20	46457334	.	T	C	18	0	18	0	13	31	0	0
20	46457376	.	A	G	2	6	8	0	0	8	0	0
20	46463327	.	T	C	1	0	1	0	4	5	0	0
20	46466934	.	G	T	1	10	11	0	0	11	0	0
20	46467054	.	T	C	5	4	9	0	0	9	0	0
20	46467174	.	A	C	10	10	20	0	0	20	0	0
20	46492279	.	T	C	2	4	6	0	1	7	0	0
20	46498023	.	C	A	5	3	8	0	0	8	0	0
20	46502423	.	T	A	2	2	4	0	0	4	0	0
20	46506079	.	G	A	0	0	0	0	1	1	0	0
20	46508767	.	C	T	3	8	11	0	0	11	0	0
20	46515680	.	C	T	3	7	10	0	0	10	0	0
20	46517173	.	A	T	2	1	3	0	0	3	0	0
20	46517429	.	C	T	0	1	1	0	0	1	0	0
20	46519076	.	A	G	2	1	3	0	0	3	0	0
20	46519082	.	G	A	1	1	2	0	2	4	0	0
20	46523196	.	G	A	10	5	15	0	1	16	0	0
20	46525639	.	T	A	7	6	13	0	0	13	0	0
20	46528643	.	T	C	5	7	12	0	1	13	0	0
20	46528709	.	A	G	8	3	11	0	1	12	0	0
20	46529398	.	G	A	5	3	8	0	0	8	0	0
20	46529479	.	T	C	5	5	10	0	0	10	0	0
20	46533930	.	G	A	3	5	8	0	0	8	0	0
20	46534087	.	T	A	7	5	12	0	2	14	0	0
20	46536707	.	T	A	6	4	10	0	0	10	0	0
20	46536906	.	T	G	15	20	35	0	0	35	0	0
20	46536936	.	G	T	14	18	32	0	3	35	0	0
20	46536981	.	C	T	15	26	41	0	1	42	0	0
20	46537143	.	A	T	26	19	45	1	0	46	0	0
20	46537231	.	C	G	16	21	37	0	0	37	0	0
20	46537563	.	A	G	28	18	46	0	1	47	0	0
20	46537636	.	G	A	13	14	27	0	0	27	0	0
20	46541802	.	G	A	4	3	7	0	0	7	0	0
20	46553020	.	T	G	28	28	56	0	1	57	0	0
20	46553274	.	G	C	30	24	54	0	2	56	0	0
20	46564009	.	G	A	1	4	5	0	0	5	0	0
20	46564108	.	C	T	3	2	5	0	0	5	0	0
20	46564120	.	G	C	0	2	2	0	2	4	0	0
20	46564267	.	C	T	4	6	10	0	0	10	0	0
20	46594507	.	C	T	4	2	6	0	0	6	0	0
20	46699344	.	T	C	5	4	9	0	0	9	0	0
20	46713607	.	C	T	1	3	4	0	0	4	0	0
20	46721084	.	G	A	4	6	10	0	2	12	0	0
20	46724740	.	C	T	13	11	24	0	1	25	0	0
20	46730654	.	T	C	2	6	8	0	0	8	0	0
20	46730663	.	G	A	2	6	8	0	1	9	0	0
20	46730734	.	C	T	11	15	26	0	0	26	0	0
20	46731010	.	T	A	5	6	11	0	2	13	0	0
20	46732062	.	G	T	5	6	11	0	0	11	0	0
20	46732848	.	T	A	10	12	22	0	0	22	0	0
20	46732887	.	C	T	11	11	22	0	2	24	0	0
20	46733764	.	A	G	5	7	12	0	0	12	0	0
20	46733809	.	G	A	10	6	16	0	0	16	0	0
20	46742633	.	A	C	2	2	4	0	0	4	0	0
20	46746711	.	G	A	0	4	4	0	10	14	0	0
20	46758728	.	C	T	1	2	3	0	0	3	0	0
20	46758733	.	C	T	2	1	3	0	0	3	0	0
20	46758782	.	G	A	0	2	2	0	1	3	0	0
20	46831124	.	T	C	8	7	15	0	1	16	0	0
20	46835350	.	C	T	0	0	0	0	3	3	0	0
20	46835363	.	G	T	3	2	5	0	0	5	0	0
20	46835432	.	G	A	3	4	7	0	0	7	0	0
20	46858896	.	G	A	7	4	11	0	1	12	0	0
20	46859259	.	A	G	2	5	7	0	0	7	0	0
20	46859328	.	G	A	7	7	14	0	1	15	0	0
20	46859418	.	A	G	3	5	8	0	1	9	0	0
20	46886820	.	G	A	1	3	4	0	0	4	0	0
20	46904168	.	A	C	1	0	1	0	0	1	0	0
20	46904187	.	T	C	1	0	1	0	0	1	0	0
20	46915458	.	G	A	0	2	2	0	1	3	0	0
20	46915467	.	C	T	1	2	3	0	0	3	0	0
20	46918894	.	A	T	1	2	3	0	0	3	0	0
20	46935914	.	C	G	0	2	2	0	0	2	0	0
20	46935926	.	C	T	0	2	2	0	0	2	0	0
20	46937502	.	T	C	0	1	1	0	0	1	0	0
20	46941181	.	G	T	0	2	2	0	1	3	0	0
20	46945945	.	G	T	0	1	1	0	0	1	0	0
20	46957559	.	G	T	16	24	40	0	0	40	0	0
20	46957575	.	C	G	15	19	34	0	1	35	0	0
20	46957600	.	T	A	14	13	27	0	0	27	0	0
20	46957650	.	A	T	14	16	30	0	3	33	0	0
20	46957803	.	T	A	14	16	30	0	1	31	0	0
20	46958136	.	C	T	9	10	19	0	1	20	0	0
20	46958478	.	T	C	16	0	16	0	15	31	0	0
20	46958705	.	G	T	15	10	25	0	0	26	1	0
20	46958766	.	T	A	13	10	23	0	0	23	0	0
20	46959135	.	T	C	15	12	27	0	1	28	0	0
20	46959147	.	A	T	18	11	29	0	1	30	0	0
20	46959465	.	C	A	6	9	15	0	1	16	0	0
20	46959477	.	A	T	8	8	16	0	0	16	0	0
20	46959504	.	T	C	4	8	12	0	0	12	0	0
20	46959525	.	T	C	6	0	6	0	5	11	0	0
20	46959543	.	A	T	6	6	12	0	1	13	0	0
20	46967563	.	T	G	1	5	6	0	0	6	0	0
20	46974942	.	C	T	0	1	1	0	0	1	0	0
20	46980230	.	A	G	5	3	8	0	0	8	0	0
20	46988005	.	T	G	4	4	8	0	0	8	0	0
20	46988087	.	C	T	1	0	1	0	0	1	0	0
20	46994504	.	G	A	2	1	3	0	0	3	0	0
20	46994543	.	A	G	2	1	3	0	0	3	0	0
20	47051979	.	C	T	2	3	5	0	0	5	0	0
20	47290273	.	T	C	2	0	2	0	2	4	0	0
20	47290466	.	A	T	4	4	8	0	1	9	0	0
20	47291133	.	C	T	0	4	4	0	3	7	0	0
20	47291137	.	G	A	3	3	6	0	0	6	0	0
20	47297780	.	T	C	3	0	3	0	0	3	0	0
20	47305152	.	G	A	1	3	4	0	0	4	0	0
20	47383913	.	A	G	9	11	20	0	0	20	0	0
20	47386932	.	T	G	2	3	5	0	0	5	0	0
20	47386965	.	T	C	7	7	14	0	0	14	0	0
20	47387067	.	T	C	5	5	10	0	0	10	0	0
20	47388431	.	G	A	1	4	5	0	0	5	0	0
20	47421471	.	C	A	10	9	19	0	0	19	0	0
20	47421554	.	A	G	6	6	12	0	0	12	0	0
20	47421891	.	A	G	4	5	9	0	0	9	0	0
20	47435018	.	T	A	23	22	45	0	3	48	0	0
20	47435065	.	G	T	0	17	17	0	20	37	0	0
20	47435186	.	C	A	18	9	27	0	0	27	0	0
20	47471391	.	A	G	17	1	18	0	8	26	0	0
20	47689570	.	A	G	5	5	10	0	0	10	0	0
20	47689621	.	A	T	5	11	16	0	0	16	0	0
20	47689647	.	A	C	6	1	7	0	7	14	0	0
20	47689671	.	T	C	10	9	19	0	0	19	0	0
20	47689801	.	C	T	10	11	21	0	0	21	0	0
20	47700055	.	C	T	6	1	7	0	0	7	0	0
20	47704959	.	C	T	0	1	1	0	1	2	0	0
20	47718334	.	T	C	10	0	10	0	7	17	0	0
20	47718458	.	T	C	9	9	18	0	0	18	0	0
20	47726010	.	G	A	0	3	3	0	0	3	0	0
20	47726049	.	C	G	2	6	8	0	0	8	0	0
20	47931995	.	A	G	0	2	2	0	0	2	0	0
20	47932268	.	G	T	15	14	29	0	0	29	0	0
20	47932424	.	T	C	11	14	25	0	2	27	0	0
20	47932867	.	T	C	6	7	13	0	1	14	0	0
20	47938981	.	C	T	0	1	1	0	1	2	0	0
20	47942600	.	G	A	9	5	14	0	0	14	0	0
20	47942651	.	A	G	5	2	7	0	0	7	0	0
20	47944132	.	C	T	0	4	4	0	5	9	0	0
20	47944151	.	G	A	7	4	11	0	1	12	0	0
20	47944277	.	C	T	0	3	3	0	5	8	0	0
20	47948116	.	A	G	2	3	5	0	0	5	0	0
20	47960793	.	A	G	3	4	7	0	1	8	0	0
20	47961065	.	C	T	0	1	1	0	0	1	0	0
20	47973272	.	T	C	2	0	2	0	0	2	0	0
20	47984494	.	C	T	5	2	7	0	0	7	0	0
20	47984650	.	T	G	2	2	4	0	0	4	0	0
20	47995295	.	T	C	2	0	2	0	4	6	0	0
20	47995479	.	G	A	0	1	1	0	0	1	0	0
20	48037036	.	T	C	5	3	8	0	0	8	0	0
20	48037147	.	T	C	2	2	4	0	1	5	0	0
20	48037765	.	A	G	0	2	2	0	0	2	0	0
20	48038086	.	T	A	2	3	5	0	1	6	0	0
20	48043220	.	G	A	2	0	2	0	0	2	0	0
20	48043401	.	G	A	3	6	9	0	0	9	0	0
20	48043428	.	G	A	3	6	9	0	0	9	0	0
20	48043470	.	A	G	1	1	2	0	0	2	0	0
20	48046899	.	A	G	1	1	2	0	0	2	0	0
20	48061288	.	G	A	4	3	7	0	0	7	0	0
20	48143921	.	T	A	1	3	4	0	0	4	0	0
20	48296314	.	T	C	11	0	11	0	10	21	0	0
20	48296315	.	A	G	12	9	21	0	0	21	0	0
20	48298716	.	C	T	2	4	6	0	0	6	0	0
20	48312445	.	A	G	4	0	4	0	0	4	0	0
20	48341712	.	T	C	6	0	6	0	5	11	0	0
20	48342821	.	G	A	2	1	3	0	0	3	0	0
20	48344049	.	T	C	3	0	3	0	1	4	0	0
20	48353119	.	C	T	0	5	5	0	5	10	0	0
20	49725935	.	A	G	2	2	4	0	1	5	0	0
20	49726589	.	A	G	4	2	6	0	0	6	0	0
20	49726690	.	A	G	2	2	4	0	0	4	0	0
20	49787832	.	A	G	4	0	4	0	5	9	0	0
20	49788219	.	G	A	0	6	6	0	0	6	0	0
20	49788228	.	C	G	0	6	6	0	0	6	0	0
20	49816883	.	T	C	2	2	4	0	0	4	0	0
20	49895249	.	T	A	2	4	6	0	0	6	0	0
20	49902337	.	A	G	0	1	1	0	0	1	0	0
20	49905163	.	C	T	1	3	4	0	0	4	0	0
20	49916653	.	T	C	3	2	5	0	0	5	0	0
20	49928292	.	C	A	2	4	6	0	0	6	0	0
20	49928295	.	A	G	2	1	3	0	3	6	0	0
20	49928358	.	A	T	4	2	6	0	0	6	0	0
20	49940895	.	G	A	6	4	10	0	0	10	0	0
20	49940969	.	G	T	7	3	10	0	0	10	0	0
20	49959810	.	T	A	3	2	5	0	0	5	0	0
20	49960011	.	A	G	4	2	6	0	0	6	0	0
20	49960314	.	A	G	5	2	7	0	1	8	0	0
20	49960328	.	A	G	4	3	7	0	0	7	0	0
20	49960791	.	A	G	4	4	8	0	0	8	0	0
20	49961995	.	G	C	4	3	7	0	0	7	0	0
20	49961998	.	C	T	4	2	6	0	0	6	0	0
20	50015754	.	C	T	4	5	9	0	1	10	0	0
20	50022331	.	T	C	2	4	6	0	0	6	0	0
20	50022333	.	G	C	2	4	6	0	0	6	0	0
20	50041707	.	A	G	0	3	3	0	0	3	0	0
20	50049036	.	G	C	37	2	39	0	23	62	0	0
20	50049078	.	C	A	18	8	26	0	1	27	0	0
20	50057348	.	C	T	1	2	3	0	0	3	0	0
20	50074077	.	C	T	0	4	4	0	0	4	0	0
20	50074173	.	C	T	5	8	13	0	1	14	0	0
20	50074212	.	C	T	5	6	11	0	0	11	0	0
20	50076480	.	G	A	0	3	3	0	4	7	0	0
20	50079019	.	C	G	6	3	9	0	1	10	0	0
20	50079067	.	T	C	6	5	11	0	0	11	0	0
20	50079070	.	A	G	6	3	9	0	1	10	0	0
20	50079154	.	T	C	0	2	2	0	0	2	0	0
20	50082425	.	A	G	2	7	9	0	0	9	0	0
20	50082861	.	T	C	1	6	7	0	0	7	0	0
20	50191655	.	C	A	1	1	2	0	0	2	0	0
20	50238657	.	A	G	6	4	10	0	0	10	0	0
20	50238672	.	A	G	5	4	9	0	1	10	0	0
20	50238717	.	G	A	3	3	6	0	1	7	0	0
20	50926695	.	G	A	0	5	5	0	8	13	0	0
20	50926713	.	A	G	7	0	7	0	11	18	0	0
20	50989199	.	A	G	7	1	8	0	8	16	0	0
20	50996515	.	G	T	0	3	3	0	9	12	0	0
20	50998672	.	T	A	19	18	37	0	1	38	0	0
20	50998746	.	A	G	14	13	27	0	1	28	0	0
20	50998858	.	C	T	18	28	46	0	0	46	0	0
20	51069662	.	G	A	11	5	16	0	1	17	0	0
20	51069996	.	T	C	7	7	14	0	0	14	0	0
20	51070017	.	A	G	6	5	11	0	0	11	0	0
20	51073334	.	T	A	0	2	2	0	0	2	0	0
20	51073358	.	C	G	1	5	6	0	0	6	0	0
20	51073670	.	A	T	6	3	9	0	1	10	0	0
20	51073730	.	G	A	13	10	23	0	0	23	0	0
20	51073791	.	C	T	8	10	18	0	2	20	0	0
20	51073799	.	T	A	8	8	16	0	1	17	0	0
20	51074517	.	G	A	0	3	3	0	3	6	0	0
20	51074535	.	C	T	3	2	5	0	0	5	0	0
20	51075589	.	T	A	1	2	3	0	0	3	0	0
20	51075614	.	G	T	2	2	4	0	0	4	0	0
20	51088683	.	G	A	20	14	34	0	1	35	0	0
20	51088920	.	C	T	18	31	49	0	1	50	0	0
20	51088967	.	C	A	25	26	51	0	1	52	0	0
20	51089236	.	T	C	11	0	11	0	20	31	0	0
20	51089243	.	T	C	12	20	32	0	0	32	0	0
20	51089328	.	C	T	1	20	21	0	32	53	0	0
20	51089487	.	A	C	21	25	46	0	2	48	0	0
20	51089495	.	C	G	20	24	44	0	1	45	0	0
20	51089559	.	G	A	19	21	40	0	1	41	0	0
20	51100562	.	A	G	22	19	41	0	0	41	0	0
20	51112184	.	C	T	5	4	9	0	0	9	0	0
20	51117661	.	A	C	11	6	17	0	0	17	0	0
20	51117706	.	C	G	4	1	5	0	5	10	0	0
20	51118227	.	A	G	4	0	4	0	8	12	0	0
20	51118281	.	C	A	22	30	52	0	3	55	0	0
20	51122939	.	C	T	13	10	23	0	1	24	0	0
20	51123109	.	G	C	13	8	21	0	0	21	0	0
20	51123151	.	A	T	19	9	28	0	0	28	0	0
20	51123229	.	C	T	5	2	7	0	0	7	0	0
20	51132284	.	A	G	18	13	31	0	3	34	0	0
20	51141284	.	C	T	0	12	12	0	8	20	0	0
20	51141347	.	A	G	5	10	15	0	0	15	0	0
20	51145837	.	A	G	4	2	6	0	0	6	0	0
20	51145888	.	T	C	4	0	4	0	8	12	0	0
20	51146153	.	G	A	9	10	19	0	1	20	0	0
20	51150029	.	G	T	7	8	15	0	0	15	0	0
20	51151647	.	G	A	0	1	1	0	0	1	0	0
20	51157010	.	T	G	1	4	5	0	0	5	0	0
20	51157109	.	C	T	15	14	29	0	1	30	0	0
20	51157204	.	G	A	5	6	11	0	0	11	0	0
20	51168502	.	T	C	4	5	9	0	0	9	0	0
20	51168559	.	A	T	1	1	2	0	0	2	0	0
20	51199791	.	T	C	10	10	20	0	0	20	0	0
20	51207672	.	C	T	35	37	72	0	3	75	0	0
20	51211455	.	G	A	11	42	53	0	35	88	0	0
20	51211459	.	A	G	43	10	53	0	32	85	0	0
20	51237673	.	A	G	1	2	3	0	0	3	0	0
20	51238171	.	T	C	2	4	6	0	0	6	0	0
20	51239329	.	A	G	4	2	6	0	0	6	0	0
20	51276342	.	G	A	0	2	2	0	0	2	0	0
20	51276459	.	G	A	1	6	7	0	1	8	0	0
20	51312886	.	C	T	3	4	7	0	0	7	0	0
20	51312894	.	T	C	2	4	6	0	0	6	0	0
20	51332530	.	C	T	9	3	12	0	0	12	0	0
20	51334413	.	A	G	0	2	2	0	0	2	0	0
20	51334434	.	G	A	0	2	2	0	1	3	0	0
20	51363773	.	A	G	5	3	8	0	0	8	0	0
20	51370329	.	C	T	3	14	17	0	0	17	0	0
20	51374752	.	A	G	0	0	0	0	1	1	0	0
20	51377075	.	C	T	2	1	3	0	0	3	0	0
20	51377158	.	G	A	8	15	23	0	1	24	0	0
20	51377261	.	G	A	5	10	15	0	0	15	0	0
20	51383472	.	G	A	2	2	4	0	0	4	0	0
20	51383706	.	C	T	0	4	4	0	8	12	0	0
20	51384072	.	C	T	0	0	0	0	2	2	0	0
20	51386444	.	G	T	2	3	5	0	0	5	0	0
20	51386487	.	G	A	2	6	8	0	0	8	0	0
20	51390456	.	A	G	0	2	2	0	0	2	0	0
20	51475236	.	A	G	1	1	2	0	2	4	0	0
20	51475569	.	T	C	0	2	2	0	2	4	0	0
20	51489438	.	T	C	3	0	3	0	2	5	0	0
20	51489450	.	T	G	2	3	5	0	0	5	0	0
20	51489705	.	A	G	2	4	6	0	0	6	0	0
20	51489976	.	A	G	1	2	3	0	0	3	0	0
20	51542166	.	G	T	1	2	3	0	0	3	0	0
20	51547458	.	A	T	0	2	2	0	0	2	0	0
20	51647872	.	A	T	5	3	8	0	0	8	0	0
20	51648019	.	A	T	6	3	9	0	0	9	0	0
20	51649521	.	A	C	2	2	4	0	0	4	0	0
20	51649533	.	A	G	2	2	4	0	0	4	0	0
20	51649767	.	C	T	3	2	5	0	0	5	0	0
20	51702896	.	T	C	2	0	2	0	3	5	0	0
20	51703043	.	A	G	1	2	3	0	1	4	0	0
20	51703146	.	A	T	4	8	12	0	0	12	0	0
20	51703153	.	C	T	5	9	14	0	0	14	0	0
20	51704001	.	C	T	0	2	2	0	0	2	0	0
20	51713103	.	G	A	5	3	8	0	0	8	0	0
20	51721640	.	G	A	2	6	8	0	0	8	0	0
20	51723187	.	G	T	5	4	9	0	0	9	0	0
20	51723227	.	A	G	0	2	2	0	0	2	0	0
20	51730662	.	T	G	2	5	7	0	0	7	0	0
20	51745943	.	G	A	1	3	4	0	1	5	0	0
20	51753384	.	A	T	6	11	17	0	0	17	0	0
20	51753512	.	G	T	13	7	20	0	0	20	0	0
20	51758608	.	A	C	7	2	9	0	0	10	1	0
20	51758611	.	A	C	8	3	11	0	1	12	0	0
20	51758975	.	A	G	12	7	19	0	1	20	0	0
20	51759562	.	G	A	6	10	16	0	0	16	0	0
20	51763248	.	G	T	14	13	27	0	0	27	0	0
20	51789582	.	T	C	1	0	1	0	0	1	0	0
20	51798112	.	T	C	1	1	2	0	1	3	0	0
20	51802061	.	A	T	3	2	5	0	0	5	0	0
20	51802242	.	G	A	1	2	3	0	0	3	0	0
20	51803856	.	G	T	3	4	7	0	0	7	0	0
20	51807449	.	C	T	0	1	1	0	3	4	0	0
20	51810872	.	T	A	3	0	3	0	0	3	0	0
20	51817532	.	A	G	1	1	2	0	0	2	0	0
20	51819257	.	C	A	2	3	5	0	0	5	0	0
20	51819309	.	C	G	0	0	0	0	1	1	0	0
20	51821275	.	T	C	4	2	6	0	0	6	0	0
20	51821286	.	G	T	5	2	7	0	0	7	0	0
20	51822180	.	C	T	1	4	5	0	0	5	0	0
20	51822233	.	C	T	2	2	4	0	0	4	0	0
20	51822468	.	G	A	3	4	7	0	0	7	0	0
20	51822670	.	A	T	3	3	6	0	1	7	0	0
20	51822738	.	A	G	1	3	4	0	0	4	0	0
20	51823898	.	A	T	2	2	4	0	0	4	0	0
20	51831582	.	A	C	3	0	3	0	2	5	0	0
20	51874061	.	G	A	1	4	5	0	1	6	0	0
20	52333052	.	A	G	4	2	6	0	1	7	0	0
20	52333070	.	A	G	3	5	8	0	1	9	0	0
20	52333177	.	T	C	6	0	6	0	6	12	0	0
20	52333202	.	T	C	6	5	11	0	1	12	0	0
20	52333344	.	A	G	5	3	8	0	0	8	0	0
20	52333385	.	G	A	4	6	10	0	0	10	0	0
20	52333388	.	A	G	3	6	9	0	0	9	0	0
20	52404398	.	T	C	2	5	7	0	1	8	0	0
20	52404935	.	T	A	2	3	5	0	0	5	0	0
20	52415876	.	T	C	3	4	7	0	0	7	0	0
20	52416020	.	C	A	2	5	7	0	0	7	0	0
20	52416125	.	C	T	0	1	1	0	0	1	0	0
20	52420126	.	G	T	0	3	3	0	1	4	0	0
20	52458788	.	C	G	2	4	6	0	0	6	0	0
20	52458800	.	G	C	2	4	6	0	0	6	0	0
20	52458831	.	A	T	4	7	11	0	0	11	0	0
20	52458987	.	G	T	0	1	1	0	2	3	0	0
20	52482128	.	T	C	0	1	1	0	0	1	0	0
20	52482448	.	G	A	0	1	1	0	0	1	0	0
20	52482484	.	T	C	0	1	1	0	0	1	0	0
20	52486247	.	G	A	3	2	5	0	0	5	0	0
20	52540868	.	A	T	2	2	4	0	0	4	0	0
20	52540873	.	T	A	2	2	4	0	0	4	0	0
20	52540928	.	C	T	4	4	8	0	0	8	0	0
20	52540946	.	T	A	1	6	7	0	1	8	0	0
20	52540992	.	G	A	6	3	9	0	0	9	0	0
20	52541014	.	C	A	5	2	7	0	1	8	0	0
20	52543783	.	C	A	1	2	3	0	0	3	0	0
20	52543852	.	A	G	1	3	4	0	0	4	0	0
20	52544394	.	G	T	0	7	7	0	5	12	0	0
20	52544491	.	A	C	4	10	14	0	1	15	0	0
20	52544559	.	T	C	2	7	9	0	1	10	0	0
20	52544612	.	G	T	2	3	5	0	0	5	0	0
20	52546252	.	C	T	0	2	2	0	0	2	0	0
20	52554022	.	G	T	13	10	23	0	1	24	0	0
20	52554065	.	A	C	22	18	40	0	0	40	0	0
20	52554547	.	A	C	21	16	37	0	2	39	0	0
20	52554685	.	A	G	3	1	4	0	1	5	0	0
20	52561670	.	A	G	19	15	34	0	0	34	0	0
20	52563215	.	C	A	1	1	2	0	0	2	0	0
20	52568373	.	C	G	2	1	3	0	0	3	0	0
20	52574813	.	G	A	0	12	12	0	21	33	0	0
20	52575377	.	T	C	15	14	29	0	0	29	0	0
20	52724917	.	C	T	2	2	4	0	0	4	0	0
20	52907631	.	A	T	5	6	11	0	0	11	0	0
20	52920903	.	G	A	3	1	4	0	0	4	0	0
20	53069778	.	C	T	0	11	11	0	10	21	0	0
20	53069784	.	G	A	9	16	25	0	1	26	0	0
20	53074579	.	G	A	3	2	5	0	1	6	0	0
20	53171938	.	C	G	0	6	6	0	4	10	0	0
20	53181085	.	C	T	2	3	5	0	0	5	0	0
20	53183510	.	C	T	1	2	3	0	0	3	0	0
20	53224585	.	A	G	4	0	4	0	0	4	0	0
20	53224594	.	C	T	2	4	6	0	0	6	0	0
20	53230903	.	G	T	0	5	5	0	3	8	0	0
20	53262237	.	G	T	0	7	7	0	5	12	0	0
20	53262283	.	C	T	7	7	14	0	0	14	0	0
20	53302300	.	G	A	5	6	11	0	0	11	0	0
20	53302568	.	T	G	1	3	4	0	16	20	0	0
20	53318814	.	G	T	7	8	15	0	0	15	0	0
20	53365862	.	C	T	5	3	8	0	0	8	0	0
20	53365921	.	C	T	0	7	7	0	6	13	0	0
20	53377661	.	A	G	0	0	0	0	5	5	0	0
20	53377691	.	G	A	0	4	4	0	1	5	0	0
20	53384643	.	A	G	3	1	4	0	0	4	0	0
20	53391922	.	G	T	7	1	8	0	0	8	0	0
20	53393594	.	T	C	2	3	5	0	0	5	0	0
20	53393669	.	C	A	6	6	12	0	0	12	0	0
20	53398790	.	C	T	7	11	18	0	3	21	0	0
20	53401910	.	C	T	3	2	5	0	1	6	0	0
20	53408394	.	A	C	1	3	4	0	0	4	0	0
20	53422244	.	G	T	1	1	2	0	1	3	0	0
20	53505985	.	C	T	1	0	1	0	0	1	0	0
20	53506936	.	G	A	0	2	2	0	0	2	0	0
20	53639980	.	C	T	2	11	13	0	1	14	0	0
20	53641462	.	T	C	1	8	9	0	0	9	0	0
20	53803637	.	C	T	9	17	26	0	0	26	0	0
20	53803783	.	T	A	11	10	21	0	4	25	0	0
20	53804342	.	A	G	5	10	15	0	0	15	0	0
20	53804470	.	G	A	4	4	8	0	1	12	3	0
20	53804480	.	A	G	9	2	11	0	0	11	0	0
20	53898770	.	C	T	0	17	17	0	19	36	0	0
20	53898930	.	G	A	11	3	14	0	2	16	0	0
20	53898968	.	A	T	15	13	28	0	1	29	0	0
20	53899023	.	G	C	13	22	35	0	1	36	0	0
20	53899035	.	G	A	12	21	33	0	3	36	0	0
20	53899063	.	G	A	19	12	31	0	0	31	0	0
20	53899104	.	A	C	16	1	17	0	15	32	0	0
20	53901098	.	T	A	4	10	14	0	0	14	0	0
20	53901136	.	G	C	1	7	8	0	1	9	0	0
20	53912208	.	C	T	0	6	6	0	4	10	0	0
20	53928363	.	T	C	3	0	3	0	1	4	0	0
20	53930457	.	G	A	0	3	3	0	0	3	0	0
20	53930466	.	C	T	0	2	2	0	1	3	0	0
20	53968126	.	A	G	26	27	53	0	0	53	0	0
20	53968273	.	A	G	2	2	4	3	0	7	0	0
20	53970281	.	C	T	13	17	30	0	2	32	0	0
20	53974508	.	T	C	5	8	13	0	0	13	0	0
20	53974565	.	G	A	7	10	17	0	0	17	0	0
20	53974580	.	G	A	5	7	12	0	2	14	0	0
20	53981487	.	C	T	8	6	14	0	0	14	0	0
20	53981577	.	T	G	4	9	13	0	0	13	0	0
20	54048486	.	G	A	1	1	2	0	1	3	0	0
20	54050531	.	A	G	1	0	1	0	2	3	0	0
20	54050949	.	C	T	0	2	2	0	0	4	2	0
20	54050957	.	C	G	3	0	3	0	0	3	0	0
20	54051044	.	C	T	3	1	4	0	0	4	0	0
20	54067345	.	A	G	7	6	13	0	0	13	0	0
20	54067639	.	G	A	11	13	24	0	1	25	0	0
20	54067894	.	G	A	5	7	12	0	1	13	0	0
20	54067908	.	G	A	5	4	9	0	1	10	0	0
20	54175011	.	A	G	2	3	5	0	0	5	0	0
20	54175056	.	G	T	2	2	4	0	1	5	0	0
20	54175527	.	A	G	0	0	0	0	1	1	0	0
20	54196791	.	T	C	11	0	11	0	13	24	0	0
20	54197263	.	G	C	14	17	31	0	2	33	0	0
20	54197287	.	A	T	18	18	36	0	1	37	0	0
20	54197383	.	G	A	12	22	34	0	0	34	0	0
20	54197473	.	A	G	15	11	26	0	1	27	0	0
20	54205704	.	C	T	7	14	21	0	0	21	0	0
20	54215115	.	A	G	6	13	19	0	1	20	0	0
20	54219286	.	T	C	2	0	2	0	3	5	0	0
20	54232738	.	A	G	14	21	35	0	1	36	0	0
20	54232772	.	G	C	8	0	8	0	10	18	0	0
20	54233207	.	T	C	1	0	1	0	2	3	0	0
20	54236421	.	A	C	0	1	1	0	0	1	0	0
20	54236423	.	G	A	0	1	1	0	0	1	0	0
20	54249577	.	G	C	8	8	16	0	0	16	0	0
20	54251406	.	T	C	3	8	11	0	0	11	0	0
20	54274516	.	T	C	12	9	21	0	2	23	0	0
20	54274521	.	A	T	13	10	23	0	0	23	0	0
20	54278129	.	T	A	3	2	5	0	1	6	0	0
20	54278190	.	C	T	3	3	6	0	1	7	0	0
20	54283025	.	G	T	0	2	2	0	4	6	0	0
20	54283659	.	A	G	1	0	1	0	1	2	0	0
20	54283695	.	A	G	1	1	2	0	0	2	0	0
20	54286145	.	A	G	12	6	18	0	0	18	0	0
20	54286797	.	G	T	5	5	10	0	0	10	0	0
20	54334389	.	C	G	8	0	8	0	6	14	0	0
20	54334417	.	G	T	1	10	11	0	12	23	0	0
20	54334478	.	C	T	10	15	25	0	0	25	0	0
20	54339998	.	C	T	8	4	12	0	0	12	0	0
20	54340018	.	G	C	9	2	11	0	1	12	0	0
20	54340260	.	G	C	6	10	16	0	1	17	0	0
20	54340285	.	C	T	8	10	18	0	0	18	0	0
20	54340359	.	G	A	0	6	6	0	6	12	0	0
20	54340700	.	T	C	5	2	7	0	0	7	0	0
20	54340750	.	A	C	2	2	4	0	0	4	0	0
20	54340990	.	G	A	0	3	3	0	6	9	0	0
20	54341019	.	A	G	3	4	7	0	0	7	0	0
20	54341203	.	T	A	6	3	9	0	0	9	0	0
20	54341210	.	A	G	3	4	7	0	0	7	0	0
20	54341252	.	A	G	5	2	7	0	0	7	0	0
20	54342388	.	A	G	2	1	3	0	1	4	0	0
20	54342674	.	T	C	3	9	12	0	2	14	0	0
20	54343639	.	C	A	8	0	8	0	1	9	0	0
20	54343695	.	A	T	5	7	12	0	0	12	0	0
20	54343720	.	A	T	10	7	17	0	1	18	0	0
20	54343866	.	G	A	10	5	15	0	3	18	0	0
20	54343928	.	A	G	5	7	12	0	1	13	0	0
20	54344125	.	C	A	4	4	8	0	0	8	0	0
20	54344373	.	T	G	6	7	13	0	0	13	0	0
20	54344386	.	T	A	4	6	10	0	1	11	0	0
20	54344533	.	G	A	7	8	15	0	1	16	0	0
20	54344711	.	A	G	10	0	10	0	9	19	0	0
20	54344795	.	G	A	8	6	14	0	2	16	0	0
20	54344815	.	G	T	5	9	14	0	0	14	0	0
20	54344872	.	G	T	2	2	4	0	0	4	0	0
20	54344900	.	T	G	2	4	6	0	0	6	0	0
20	54345895	.	C	T	13	15	28	0	0	28	0	0
20	54346124	.	A	T	11	8	19	0	1	20	0	0
20	54350102	.	C	T	4	3	7	0	0	7	0	0
20	54355807	.	A	G	12	0	12	0	8	20	0	0
20	54357955	.	C	T	8	7	15	0	0	15	0	0
20	54358601	.	A	G	3	0	3	0	10	13	0	0
20	54360077	.	T	G	6	0	6	0	12	18	0	0
20	54360143	.	G	A	3	2	5	0	0	5	0	0
20	54360148	.	G	T	0	2	2	0	3	5	0	0
20	54360939	.	G	A	1	4	5	0	0	5	0	0
20	54360940	.	A	G	0	3	3	0	2	5	0	0
20	54397846	.	A	G	6	0	6	0	7	13	0	0
20	54398005	.	G	A	2	8	10	0	12	22	0	0
20	54398242	.	C	T	9	10	19	0	0	19	0	0
20	54398449	.	G	A	0	12	12	0	9	21	0	0
20	54402121	.	C	T	11	8	19	0	0	19	0	0
20	54402157	.	G	T	2	12	14	0	8	22	0	0
20	54402211	.	G	A	0	19	19	0	10	29	0	0
20	54402346	.	G	A	13	9	22	0	1	23	0	0
20	54402400	.	C	G	6	0	6	0	11	17	0	0
20	54402553	.	C	T	3	4	7	0	0	7	0	0
20	54406954	.	G	A	16	13	29	0	0	29	0	0
20	54407196	.	G	A	1	16	17	0	17	34	0	0
20	54422636	.	G	A	17	18	35	0	1	36	0	0
20	54422780	.	C	G	9	19	28	0	0	28	0	0
20	54422830	.	T	C	16	0	16	0	5	21	0	0
20	54422868	.	T	G	13	6	19	0	0	19	0	0
20	54422884	.	G	A	9	6	15	0	0	15	0	0
20	54422909	.	C	T	8	16	24	0	0	24	0	0
20	54422929	.	G	A	7	16	23	0	0	23	0	0
20	54423005	.	T	C	16	8	24	0	0	24	0	0
20	54423217	.	C	T	2	9	11	0	12	23	0	0
20	54434895	.	G	A	10	27	37	0	2	39	0	0
20	54434918	.	C	T	12	25	37	0	0	38	1	0
20	54446877	.	G	A	9	10	19	0	1	20	0	0
20	54462151	.	G	C	8	5	13	0	0	13	0	0
20	54522571	.	T	C	1	1	2	0	0	2	0	0
20	54522615	.	G	C	2	2	4	0	0	4	0	0
20	54525439	.	T	C	3	6	9	0	0	9	0	0
20	54563425	.	A	G	14	11	25	0	1	26	0	0
20	54563722	.	C	A	0	5	5	0	3	8	0	0
20	54563995	.	G	A	7	5	12	0	1	13	0	0
20	54563998	.	G	C	8	5	13	0	0	13	0	0
20	54666245	.	G	C	0	1	1	0	0	1	0	0
20	54670966	.	A	G	4	3	7	0	0	7	0	0
20	54670984	.	T	A	4	3	7	0	0	7	0	0
20	54671032	.	A	C	5	4	9	0	0	9	0	0
20	54671864	.	T	G	2	4	6	0	0	6	0	0
20	54671894	.	A	C	1	4	5	0	1	6	0	0
20	54672839	.	A	G	3	0	3	0	10	13	0	0
20	54672869	.	T	C	2	11	13	0	0	13	0	0
20	54672891	.	T	C	1	11	12	0	0	12	0	0
20	54672974	.	G	A	0	6	6	0	7	13	0	0
20	54673175	.	T	C	4	4	8	0	0	8	0	0
20	54673198	.	T	A	3	7	10	0	0	10	0	0
20	54675294	.	T	C	7	4	11	0	0	11	0	0
20	54675308	.	C	G	7	0	7	0	7	14	0	0
20	54675356	.	C	T	11	9	20	0	0	20	0	0
20	54675391	.	T	C	10	8	18	0	1	19	0	0
20	54676529	.	A	G	6	0	6	0	5	11	0	0
20	54676532	.	T	G	5	5	10	0	2	12	0	0
20	54676583	.	C	T	3	3	6	0	0	6	0	0
20	54681734	.	G	A	7	6	13	0	2	15	0	0
20	54681797	.	T	A	4	9	13	0	1	14	0	0
20	54681944	.	A	T	8	1	9	0	0	9	0	0
20	54698791	.	C	T	2	9	11	0	2	13	0	0
20	54699133	.	C	T	11	6	17	0	1	18	0	0
20	54708193	.	T	C	14	9	23	0	1	24	0	0
20	54708277	.	G	A	0	9	9	0	8	17	0	0
20	54711535	.	G	C	3	7	10	0	1	11	0	0
20	54738249	.	C	G	1	3	4	0	0	4	0	0
20	54740904	.	G	A	13	13	26	0	1	27	0	0
20	54740907	.	A	G	12	0	12	0	17	29	0	0
20	54740955	.	C	T	6	8	14	0	2	16	0	0
20	54740976	.	G	T	2	8	10	0	6	16	0	0
20	54742277	.	C	T	4	2	6	0	0	6	0	0
20	54742641	.	C	G	5	7	12	0	0	12	0	0
20	54742912	.	A	C	7	10	17	0	0	17	0	0
20	54743917	.	G	A	18	9	27	0	4	31	0	0
20	54743937	.	C	T	12	7	19	0	4	23	0	0
20	54744230	.	C	T	10	13	23	0	0	23	0	0
20	54744314	.	A	G	17	0	17	0	17	34	0	0
20	54744363	.	A	G	15	0	15	0	16	31	0	0
20	54744419	.	A	G	13	12	25	0	0	25	0	0
20	54744451	.	A	G	17	6	23	0	0	23	0	0
21	238575	.	T	C	8	5	13	0	0	13	0	0
21	734868	.	A	G	19	1	20	0	5	25	0	0
21	734962	.	A	G	10	0	10	0	20	30	0	0
21	735066	.	A	G	28	0	28	0	11	39	0	0
21	735222	.	A	G	36	2	38	1	25	64	0	0
21	1576168	.	T	C	12	11	23	0	2	25	0	0
21	1594104	.	C	T	0	3	3	0	0	3	0	0
21	1594167	.	T	A	2	4	6	0	4	10	0	0
21	1594228	.	T	G	1	1	2	0	0	2	0	0
21	1599017	.	T	C	3	2	5	0	0	5	0	0
21	1599075	.	C	A	3	5	8	0	3	11	0	0
21	1604351	.	G	A	1	4	5	0	6	11	0	0
21	1610473	.	C	G	2	0	2	0	0	2	0	0
21	1610673	.	A	G	2	3	5	0	0	5	0	0
21	1780912	.	A	C	5	1	6	0	0	6	0	0
21	1780964	.	T	C	3	0	3	0	4	7	0	0
21	1781007	.	A	G	3	2	5	0	0	5	0	0
21	1788234	.	A	G	1	6	7	0	0	7	0	0
21	2171521	.	T	C	2	2	4	0	0	4	0	0
21	2180408	.	C	T	0	3	3	0	3	6	0	0
21	2202458	.	C	T	0	2	2	0	2	4	0	0
21	2202461	.	A	G	2	2	4	0	0	4	0	0
21	2202836	.	G	A	0	2	2	0	0	2	0	0
21	2202956	.	G	A	2	2	4	0	0	4	0	0
21	2203021	.	G	T	2	2	4	0	0	4	0	0
21	2203121	.	G	C	1	3	4	0	0	4	0	0
21	2203220	.	C	T	0	4	4	0	3	7	0	0
21	2213109	.	C	A	6	2	8	0	0	8	0	0
21	2213119	.	G	T	7	2	9	0	0	9	0	0
21	2213276	.	G	A	5	2	7	0	0	7	0	0
21	2213309	.	G	C	5	2	7	0	0	7	0	0
21	2213539	.	T	G	3	2	5	0	0	5	0	0
21	2213772	.	C	T	0	4	4	0	4	8	0	0
21	2220295	.	A	T	4	5	9	0	0	9	0	0
21	2220326	.	G	C	1	5	6	0	0	6	0	0
21	2220388	.	T	C	4	3	7	0	0	7	0	0
21	2220988	.	C	T	2	2	4	0	1	5	0	0
21	2236037	.	C	T	1	2	3	0	1	4	0	0
21	2236079	.	G	A	4	4	8	0	0	8	0	0
21	2236114	.	T	C	3	2	5	0	1	6	0	0
21	2237552	.	G	T	3	2	5	0	0	5	0	0
21	2237578	.	A	G	0	1	1	0	0	1	0	0
21	2247119	.	T	A	1	2	3	0	0	3	0	0
21	2248169	.	A	G	0	2	2	0	1	3	0	0
21	2281135	.	C	T	5	6	11	0	0	11	0	0
21	2281270	.	A	G	3	3	6	0	0	6	0	0
21	2281482	.	T	C	1	0	1	0	3	4	0	0
21	2621083	.	T	C	1	4	5	0	0	5	0	0
21	2738221	.	C	T	4	10	14	0	1	15	0	0
21	2949336	.	G	A	2	2	4	0	1	5	0	0
21	2949352	.	C	A	0	3	3	0	2	5	0	0
21	2949384	.	A	C	2	2	4	0	0	4	0	0
21	2949421	.	T	A	2	2	4	0	0	4	0	0
21	2949861	.	A	G	3	2	5	0	0	5	0	0
21	2949945	.	G	A	3	3	6	0	1	7	0	0
21	2950257	.	G	A	3	3	6	0	0	6	0	0
21	2950460	.	T	G	2	2	4	0	0	4	0	0
21	2957806	.	A	G	2	4	6	0	0	6	0	0
21	2957874	.	T	C	1	1	2	0	2	4	0	0
21	2958131	.	C	G	1	2	3	0	0	3	0	0
21	2958154	.	C	T	1	2	3	0	0	3	0	0
21	3422565	.	T	G	7	8	15	0	1	16	0	0
21	3452462	.	A	G	11	5	16	0	0	16	0	0
21	3485351	.	T	C	3	0	3	0	2	5	0	0
21	3536050	.	A	G	2	0	2	0	0	2	0	0
21	3536056	.	T	A	2	0	2	0	0	2	0	0
21	3536113	.	A	C	1	1	2	0	0	2	0	0
21	3536116	.	G	A	1	1	2	0	0	2	0	0
21	3539275	.	C	T	4	4	8	0	3	11	0	0
21	3567722	.	A	G	3	5	8	0	0	8	0	0
21	3597391	.	C	T	0	1	1	0	1	2	0	0
21	3606571	.	C	T	0	1	1	0	2	3	0	0
21	3613551	.	G	A	1	6	7	0	1	8	0	0
21	3715950	.	A	G	7	13	20	0	2	22	0	0
21	3715986	.	T	A	5	13	18	0	0	18	0	0
21	3715989	.	A	G	5	12	17	0	0	17	0	0
21	3716058	.	T	A	8	9	17	0	0	17	0	0
21	3716266	.	T	A	3	2	5	0	0	5	0	0
21	3716732	.	G	T	9	18	27	0	0	27	0	0
21	3716845	.	G	A	9	7	16	0	2	18	0	0
21	3716846	.	A	T	6	7	13	0	5	18	0	0
21	3716930	.	G	A	11	21	32	0	7	39	0	0
21	3717055	.	G	A	18	19	37	0	3	40	0	0
21	3717505	.	T	C	2	0	2	0	5	7	0	0
21	3719779	.	G	A	7	5	12	0	0	12	0	0
21	3725881	.	A	C	8	0	8	0	5	13	0	0
21	3738181	.	C	T	0	4	4	0	8	12	0	0
21	3775605	.	G	T	3	2	5	0	0	5	0	0
21	3778633	.	T	C	4	7	11	0	0	11	0	0
21	3786377	.	C	T	4	5	9	0	0	9	0	0
21	3789922	.	T	A	13	6	19	0	0	19	0	0
21	3789930	.	C	T	11	9	20	0	3	23	0	0
21	3789998	.	A	G	16	19	35	0	2	37	0	0
21	3793211	.	G	A	4	2	6	0	0	6	0	0
21	3793309	.	T	C	0	2	2	0	0	2	0	0
21	3793413	.	C	T	20	21	41	0	1	42	0	0
21	3796376	.	G	T	23	15	38	0	1	39	0	0
21	3796398	.	G	T	16	7	23	0	0	23	0	0
21	3797577	.	A	T	1	3	4	0	0	4	0	0
21	3822666	.	T	C	4	0	4	0	7	11	0	0
21	3822827	.	T	G	6	7	13	0	0	13	0	0
21	3822841	.	A	T	6	6	12	0	1	13	0	0
21	3822896	.	T	C	3	0	3	0	6	9	0	0
21	3825019	.	T	A	4	4	8	0	0	8	0	0
21	3859098	.	C	T	1	2	3	0	0	3	0	0
21	3881003	.	G	A	3	3	6	0	0	6	0	0
21	3881105	.	C	T	6	3	9	0	0	9	0	0
21	3917912	.	C	A	8	4	12	0	0	12	0	0
21	3918006	.	A	G	10	5	15	0	1	16	0	0
21	3918186	.	G	A	8	7	15	0	0	15	0	0
21	3954932	.	A	T	1	2	3	0	0	3	0	0
21	3958256	.	T	C	0	1	1	0	0	1	0	0
21	3958262	.	A	C	0	1	1	0	0	1	0	0
21	3961084	.	A	C	3	0	3	0	0	3	0	0
21	3972766	.	G	A	8	3	11	0	1	12	0	0
21	4166110	.	C	G	0	1	1	0	0	1	0	0
21	4185028	.	C	A	2	6	8	0	0	8	0	0
21	4188200	.	G	A	3	5	8	0	0	8	0	0
21	4191043	.	T	A	0	2	2	0	0	2	0	0
21	4201072	.	C	G	2	2	4	0	0	4	0	0
21	4209004	.	C	A	0	2	2	0	0	2	0	0
21	4209027	.	T	C	0	2	2	0	0	2	0	0
21	4219400	.	T	A	5	2	7	0	0	7	0	0
21	4219450	.	C	T	6	4	10	0	1	11	0	0
21	4227433	.	T	G	1	6	7	0	0	7	0	0
21	4227788	.	G	A	10	10	20	0	0	20	0	0
21	4228026	.	G	A	10	6	16	0	1	17	0	0
21	4240010	.	A	G	2	0	2	0	0	2	0	0
21	4240016	.	A	G	3	1	4	0	0	4	0	0
21	4240121	.	T	C	3	2	5	0	0	5	0	0
21	4244348	.	T	A	7	10	17	0	2	19	0	0
21	4244377	.	C	G	5	13	18	0	2	20	0	0
21	4247684	.	A	G	8	6	14	0	0	14	0	0
21	4250360	.	T	C	10	4	14	0	2	16	0	0
21	4250401	.	C	T	11	6	17	0	1	18	0	0
21	4250583	.	C	A	7	4	11	0	0	11	0	0
21	4250596	.	C	T	0	6	6	0	4	10	0	0
21	4250634	.	G	A	2	3	5	0	0	5	0	0
21	4250642	.	T	A	1	3	4	0	0	4	0	0
21	4287853	.	G	A	0	2	2	0	1	3	0	0
21	4287934	.	A	G	1	2	3	0	0	3	0	0
21	4293557	.	C	A	2	5	7	0	0	7	0	0
21	4293620	.	C	T	4	2	6	0	0	6	0	0
21	4300254	.	T	C	2	6	8	0	0	8	0	0
21	4300257	.	T	C	2	5	7	0	0	7	0	0
21	4300413	.	A	G	2	3	5	0	0	5	0	0
21	4304725	.	G	A	0	2	2	0	3	5	0	0
21	4304822	.	G	A	3	2	5	1	2	8	0	0
21	4304912	.	A	T	3	2	5	0	0	5	0	0
21	4304913	.	C	T	3	2	5	0	0	5	0	0
21	4511940	.	A	G	1	1	2	0	0	2	0	0
21	4511964	.	A	C	2	2	4	0	0	4	0	0
21	4518181	.	A	T	1	1	2	0	1	3	0	0
21	4534865	.	T	A	1	4	5	0	0	5	0	0
21	4535546	.	T	C	1	0	1	0	3	4	0	0
21	4556490	.	C	T	1	0	1	0	0	1	0	0
21	4571398	.	T	C	0	0	0	0	1	1	0	0
21	4575674	.	T	C	0	1	1	0	0	1	0	0
21	4576310	.	G	C	2	2	4	0	0	4	0	0
21	4576319	.	G	C	1	2	3	0	1	4	0	0
21	4578137	.	G	A	0	1	1	0	1	2	0	0
21	4578428	.	C	A	3	6	9	0	0	9	0	0
21	4578520	.	T	C	2	3	5	0	0	5	0	0
21	4585012	.	A	C	0	3	3	0	0	3	0	0
21	4585189	.	C	A	1	1	2	0	0	2	0	0
21	4591407	.	C	G	2	8	10	0	0	10	0	0
21	4591410	.	A	T	2	8	10	0	0	10	0	0
21	4591443	.	A	G	3	3	6	0	1	7	0	0
21	4592959	.	T	C	0	3	3	0	0	3	0	0
21	4592984	.	A	G	0	3	3	0	0	3	0	0
21	4593008	.	A	T	0	2	2	0	0	2	0	0
21	4596883	.	G	T	7	8	15	0	3	18	0	0
21	4596970	.	A	G	2	8	10	0	0	10	0	0
21	4603372	.	C	T	4	5	9	0	0	9	0	0
21	4656793	.	A	T	1	2	3	0	0	3	0	0
21	4657681	.	A	C	0	2	2	0	0	2	0	0
21	4660756	.	C	T	0	1	1	0	2	3	0	0
21	4679623	.	T	C	1	3	4	0	1	5	0	0
21	4679703	.	C	G	0	4	4	0	0	4	0	0
21	4712215	.	A	G	1	6	7	0	0	7	0	0
21	4712743	.	A	G	2	2	4	0	0	4	0	0
21	4712756	.	T	C	2	0	2	0	2	4	0	0
21	4713252	.	T	C	14	0	14	0	14	28	0	0
21	4718518	.	G	A	7	11	18	0	0	18	0	0
21	4720325	.	C	T	3	7	10	0	0	10	0	0
21	4723670	.	G	A	8	9	17	0	1	18	0	0
21	4724351	.	C	T	0	4	4	0	2	6	0	0
21	4724428	.	A	G	6	8	14	0	0	14	0	0
21	4724564	.	G	A	3	8	11	0	0	11	0	0
21	4724810	.	T	C	11	4	15	0	0	15	0	0
21	4729876	.	G	A	1	3	4	0	2	6	0	0
21	4742721	.	A	G	8	3	11	0	0	11	0	0
21	4742793	.	G	A	2	1	3	0	0	3	0	0
21	4748802	.	G	C	5	8	13	0	0	13	0	0
21	4748841	.	A	G	3	8	11	0	0	11	0	0
21	5002844	.	T	C	1	0	1	0	2	3	0	0
21	5004171	.	T	C	3	2	5	0	0	5	0	0
21	5034442	.	T	C	2	0	2	0	3	5	0	0
21	5034630	.	A	T	4	6	10	0	0	10	0	0
21	5066371	.	A	G	4	2	6	0	0	6	0	0
21	5066417	.	T	C	4	0	4	0	5	9	0	0
21	5066425	.	T	C	3	0	3	0	5	8	0	0
21	5159695	.	T	C	1	0	1	0	0	1	0	0
21	5160428	.	G	A	2	1	3	0	0	3	0	0
21	5169217	.	T	A	16	16	32	0	2	34	0	0
21	5171036	.	C	T	20	38	58	0	3	61	0	0
21	5173402	.	T	G	14	3	17	0	11	28	0	0
21	5173447	.	C	T	28	31	59	0	1	60	0	0
21	5173638	.	T	C	12	19	31	2	2	35	0	0
21	5199875	.	G	A	8	11	19	0	0	19	0	0
21	5200683	.	C	T	21	24	45	0	0	45	0	0
21	5209585	.	A	G	15	0	15	0	10	25	0	0
21	5209666	.	C	T	13	13	26	0	1	27	0	0
21	5237137	.	G	A	3	5	8	0	0	8	0	0
21	5240259	.	C	T	18	6	24	0	1	25	0	0
21	5797960	.	T	C	42	13	55	0	2	57	0	0
21	5972631	.	T	A	0	4	4	0	0	4	0	0
21	11493661	.	A	G	33	22	55	0	2	57	0	0
21	11494536	.	A	G	13	3	16	0	35	51	0	0
21	11501975	.	A	G	19	23	42	0	2	44	0	0
21	11502056	.	A	G	39	17	56	0	2	58	0	0
21	11502143	.	A	G	13	44	57	0	2	59	0	0
21	13612494	.	T	C	5	0	5	0	5	10	0	0
21	13612803	.	T	C	2	2	4	0	0	4	0	0
21	13613001	.	T	C	5	2	7	0	0	7	0	0
21	13613652	.	T	C	2	3	5	0	0	5	0	0
21	17568543	.	A	G	10	22	32	0	2	34	0	0
21	18266851	.	A	T	0	2	2	0	0	2	0	0
21	18266852	.	A	T	0	3	3	0	0	3	0	0
21	18372988	.	A	C	5	0	5	0	16	21	0	0
21	18372997	.	T	G	10	0	10	0	12	22	0	0
21	19607481	.	T	C	4	2	6	0	0	6	0	0
21	20113659	.	A	G	0	6	6	0	0	6	0	0
21	20634252	.	A	G	3	0	3	0	3	6	0	0
21	20634263	.	A	G	3	3	6	0	1	7	0	0
21	21297979	.	A	G	4	2	6	0	0	6	0	0
21	21343262	.	A	G	5	0	5	0	3	8	0	0
21	21343266	.	A	G	2	5	7	0	2	9	0	0
21	21347167	.	A	T	9	3	12	0	0	12	0	0
21	22447329	.	A	C	4	3	7	0	0	7	0	0
21	22447370	.	T	C	4	6	10	0	0	10	0	0
21	22447373	.	G	C	4	6	10	0	0	10	0	0
21	22447991	.	T	C	1	3	4	0	0	4	0	0
21	22448151	.	T	G	2	4	6	0	0	6	0	0
21	22448380	.	C	G	2	4	6	0	0	6	0	0
21	22448445	.	A	T	0	4	4	0	0	4	0	0
21	22448574	.	A	G	3	2	5	0	0	5	0	0
21	22448597	.	T	A	1	4	5	0	1	6	0	0
21	22448961	.	C	T	1	5	6	0	0	6	0	0
21	22454381	.	T	C	4	2	6	0	0	6	0	0
21	22454396	.	A	G	3	2	5	0	0	5	0	0
21	22466319	.	T	C	0	3	3	0	0	3	0	0
21	22476263	.	A	G	0	2	2	0	0	2	0	0
21	22479343	.	C	T	3	3	6	0	0	6	0	0
21	22479346	.	C	T	3	3	6	0	0	6	0	0
21	22479385	.	T	C	1	3	4	0	0	4	0	0
21	22552520	.	A	T	1	0	1	0	0	1	0	0
21	22589726	.	T	A	2	3	5	0	0	5	0	0
21	22630324	.	C	T	6	6	12	0	0	12	0	0
21	22633734	.	A	G	7	11	18	0	0	18	0	0
21	22697107	.	C	T	5	2	7	0	0	7	0	0
21	22697161	.	T	C	3	4	7	0	0	7	0	0
21	22698790	.	T	C	1	0	1	0	0	1	0	0
21	22698809	.	C	T	0	1	1	0	0	1	0	0
21	22699471	.	T	C	6	6	12	0	0	12	0	0
21	22699491	.	T	C	7	7	14	0	0	14	0	0
21	22699512	.	T	C	7	7	14	0	0	14	0	0
21	22699556	.	A	G	4	3	7	0	1	8	0	0
21	22699563	.	C	T	5	3	8	0	0	8	0	0
21	22699595	.	C	A	4	3	7	0	2	9	0	0
21	22699608	.	T	C	3	4	7	0	1	8	0	0
21	22699853	.	G	T	0	5	5	0	2	7	0	0
21	22699916	.	G	A	4	3	7	0	0	7	0	0
21	22699956	.	T	G	2	3	5	0	1	6	0	0
21	22699986	.	T	A	3	4	7	0	1	8	0	0
21	22700015	.	A	G	4	0	4	0	6	10	0	0
21	22702551	.	A	C	5	10	15	0	1	16	0	0
21	22702804	.	C	T	6	7	13	0	0	13	0	0
21	22705087	.	C	T	6	8	14	0	0	14	0	0
21	22705203	.	C	T	1	6	7	0	0	7	0	0
21	22706822	.	A	C	1	1	2	0	0	2	0	0
21	22708876	.	C	A	0	4	4	0	3	7	0	0
21	22709197	.	T	A	2	7	9	0	0	9	0	0
21	22709218	.	C	T	5	2	7	0	1	8	0	0
21	22772230	.	T	C	3	0	3	0	0	3	0	0
21	22777182	.	T	C	2	0	2	0	0	2	0	0
21	22791122	.	T	C	1	3	4	0	0	4	0	0
21	22791174	.	A	C	5	4	9	0	0	9	0	0
21	22791178	.	C	T	3	3	6	0	2	8	0	0
21	22795009	.	T	C	10	6	16	0	0	16	0	0
21	22795107	.	G	A	0	5	5	0	13	18	0	0
21	22795593	.	C	G	3	8	11	0	0	11	0	0
21	22846973	.	C	T	8	14	22	0	0	22	0	0
21	22846986	.	T	C	8	15	23	0	1	24	0	0
21	22847022	.	A	T	10	12	22	0	0	22	0	0
21	22847136	.	C	T	3	18	21	0	1	22	0	0
21	22847163	.	A	G	7	16	23	0	0	23	0	0
21	22847174	.	G	C	8	15	23	0	0	23	0	0
21	22847207	.	A	G	15	8	23	0	0	23	0	0
21	22847284	.	A	G	16	0	16	0	14	30	0	0
21	22847750	.	C	T	18	12	30	0	6	36	0	0
21	22847969	.	C	T	17	19	36	0	2	38	0	0
21	22847984	.	A	T	17	20	37	0	1	38	0	0
21	22848011	.	G	A	21	19	40	0	0	40	0	0
21	22848047	.	C	T	24	15	39	0	0	39	0	0
21	22848173	.	C	T	7	19	26	0	2	28	0	0
21	22848403	.	T	C	4	4	8	0	0	8	0	0
21	22848424	.	C	T	5	7	12	0	0	12	0	0
21	22850949	.	G	A	23	11	34	0	0	34	0	0
21	22875980	.	C	T	0	1	1	0	0	1	0	0
21	22876955	.	A	G	1	1	2	0	2	4	0	0
21	22876976	.	T	A	1	2	3	0	0	3	0	0
21	22878844	.	A	C	5	7	12	0	0	12	0	0
21	22878856	.	G	A	6	10	16	0	0	16	0	0
21	22879338	.	C	A	11	8	19	0	0	19	0	0
21	22879458	.	A	G	9	0	9	0	8	17	0	0
21	22879559	.	A	C	10	6	16	0	2	18	0	0
21	22879733	.	G	C	1	11	12	0	4	16	0	0
21	22879824	.	A	C	7	8	15	0	2	17	0	0
21	22879909	.	C	A	3	7	10	0	2	12	0	0
21	22880016	.	A	T	4	6	10	0	0	10	0	0
21	22880079	.	C	T	9	6	15	0	0	15	0	0
21	22881408	.	A	G	10	10	20	0	0	20	0	0
21	22881477	.	G	C	7	5	12	0	0	12	0	0
21	22882138	.	T	C	5	11	16	0	0	16	0	0
21	22882354	.	G	T	5	8	13	0	0	13	0	0
21	22882386	.	T	G	6	0	6	0	7	13	0	0
21	22882587	.	A	C	12	10	22	0	0	22	0	0
21	22882866	.	T	C	7	8	15	0	0	15	0	0
21	22883182	.	C	T	13	4	17	0	0	17	0	0
21	22883363	.	T	C	2	5	7	0	1	8	0	0
21	22884361	.	T	C	8	13	21	0	0	21	0	0
21	22884412	.	C	T	14	13	27	0	1	28	0	0
21	22884556	.	G	A	0	4	4	0	7	11	0	0
21	22884661	.	T	C	11	10	21	0	0	21	0	0
21	22884769	.	C	T	11	15	26	0	0	26	0	0
21	22885083	.	G	T	5	0	5	0	1	6	0	0
21	22890454	.	C	T	1	1	2	0	0	2	0	0
21	22890457	.	T	C	1	0	1	0	1	2	0	0
21	22891607	.	T	G	1	1	2	0	0	2	0	0
21	22891872	.	C	A	2	4	6	0	0	6	0	0
21	22892045	.	G	C	2	0	2	0	4	6	0	0
21	22901119	.	G	A	1	4	5	0	1	6	0	0
21	22922568	.	A	G	3	2	5	0	1	6	0	0
21	22922588	.	C	A	3	2	5	0	0	5	0	0
21	22973628	.	G	A	0	1	1	0	0	1	0	0
21	22998100	.	A	G	2	2	4	0	0	4	0	0
21	23019589	.	T	G	3	5	8	0	0	8	0	0
21	23019679	.	C	A	22	13	35	0	1	36	0	0
21	23019836	.	T	G	13	18	31	0	1	32	0	0
21	23020095	.	A	C	19	13	32	0	1	33	0	0
21	23020126	.	A	G	18	12	30	0	2	32	0	0
21	23020440	.	A	T	16	13	29	0	1	30	0	0
21	23020523	.	T	C	19	1	20	0	18	38	0	0
21	23020558	.	C	T	1	19	20	0	18	38	0	0
21	23021145	.	C	A	7	8	15	0	1	16	0	0
21	23025233	.	G	A	1	0	1	0	0	1	0	0
21	23026978	.	C	T	0	4	4	0	3	7	0	0
21	23027017	.	C	T	7	13	20	0	0	20	0	0
21	23027023	.	A	T	15	7	22	0	2	24	0	0
21	23036534	.	G	A	4	5	9	0	1	10	0	0
21	23040529	.	C	T	0	4	4	0	2	6	0	0
21	23040577	.	A	G	11	6	17	0	0	17	0	0
21	23041283	.	G	A	3	10	13	0	0	13	0	0
21	23041602	.	T	A	1	4	5	0	0	5	0	0
21	23042616	.	C	T	0	2	2	0	1	3	0	0
21	23043466	.	A	G	1	0	1	0	0	1	0	0
21	23043777	.	G	A	0	4	4	0	0	4	0	0
21	23043974	.	G	C	3	3	6	0	0	6	0	0
21	23043978	.	A	G	3	3	6	0	0	6	0	0
21	23046406	.	A	T	0	1	1	0	0	1	0	0
21	23160558	.	T	G	4	3	7	0	1	8	0	0
21	23160851	.	A	T	13	10	23	0	1	24	0	0
21	23161651	.	C	A	7	7	14	0	0	14	0	0
21	23162023	.	C	T	9	9	18	0	0	18	0	0
21	23162127	.	A	T	14	8	22	0	0	22	0	0
21	23162395	.	T	G	4	4	8	0	2	10	0	0
21	23162618	.	C	A	7	4	11	0	0	11	0	0
21	23163534	.	T	C	7	1	8	0	6	14	0	0
21	23163564	.	T	A	8	9	17	0	0	17	0	0
21	23163884	.	A	G	7	3	10	0	0	10	0	0
21	23163885	.	A	G	7	3	10	0	0	10	0	0
21	23163938	.	G	T	12	10	22	0	2	24	0	0
21	23163990	.	A	T	14	8	22	0	0	22	0	0
21	23164090	.	C	T	1	3	4	0	0	4	0	0
21	23175440	.	C	T	3	2	5	0	1	6	0	0
21	23304314	.	G	A	2	4	6	0	1	7	0	0
21	23307764	.	T	A	1	2	3	0	0	3	0	0
21	23338168	.	A	G	7	6	13	0	1	14	0	0
21	23338241	.	G	A	6	8	14	0	1	15	0	0
21	23350240	.	A	G	2	6	8	0	0	8	0	0
21	23352629	.	A	G	1	1	2	0	0	2	0	0
21	23352707	.	A	G	10	9	19	0	0	19	0	0
21	23352749	.	G	A	9	7	16	0	1	17	0	0
21	23367200	.	C	T	11	11	22	0	7	29	0	0
21	23367218	.	T	G	16	23	39	0	3	42	0	0
21	23469825	.	T	C	3	0	3	0	0	3	0	0
21	23473213	.	G	A	7	12	19	0	1	20	0	0
21	23475195	.	G	A	6	3	9	0	3	12	0	0
21	23746912	.	G	T	2	4	6	0	1	7	0	0
21	24287537	.	C	T	2	3	5	0	0	5	0	0
21	24411429	.	C	G	12	12	24	0	1	25	0	0
21	24531725	.	A	T	8	9	17	0	0	17	0	0
21	24545622	.	A	G	7	8	15	0	0	15	0	0
21	24548355	.	A	G	3	3	6	0	0	6	0	0
21	24548563	.	G	A	2	1	3	0	0	3	0	0
21	24548695	.	C	T	0	3	3	0	3	6	0	0
21	24548716	.	C	T	2	2	4	0	1	5	0	0
21	24548838	.	A	C	3	0	3	0	0	3	0	0
21	24554450	.	C	T	1	1	2	0	0	2	0	0
21	24704475	.	C	T	0	2	2	0	1	3	0	0
21	24704508	.	T	C	2	2	4	0	0	4	0	0
21	24729736	.	C	T	0	2	2	0	1	3	0	0
21	25037431	.	G	T	0	4	4	0	3	7	0	0
21	25037521	.	G	A	0	2	2	0	4	6	0	0
21	25037557	.	C	A	3	2	5	0	0	5	0	0
21	25037572	.	T	C	2	1	3	0	1	4	0	0
21	25043681	.	C	T	6	6	12	0	0	12	0	0
21	25043872	.	A	T	1	3	4	0	0	4	0	0
21	25044196	.	C	T	1	3	4	0	0	4	0	0
21	25044433	.	T	A	3	2	5	0	0	5	0	0
21	25044434	.	C	A	3	1	4	0	1	5	0	0
21	25044523	.	G	A	0	4	4	0	3	7	0	0
21	25044532	.	C	A	3	4	7	0	0	7	0	0
21	25044848	.	C	G	7	3	10	0	0	10	0	0
21	25044876	.	A	T	3	7	10	0	0	10	0	0
21	25044885	.	G	C	2	6	8	0	0	8	0	0
21	25044968	.	G	A	0	5	5	0	6	11	0	0
21	25045517	.	C	T	3	2	5	0	0	5	0	0
21	25045521	.	T	C	3	1	4	0	0	4	0	0
21	25045634	.	A	T	3	6	9	0	1	10	0	0
21	25046179	.	A	G	8	1	9	0	4	13	0	0
21	25046210	.	G	C	7	3	10	0	0	10	0	0
21	25046840	.	C	T	5	2	7	0	2	9	0	0
21	25055553	.	T	C	2	2	4	0	0	4	0	0
21	25057140	.	G	A	0	2	2	0	0	2	0	0
21	25057217	.	G	T	6	4	10	0	1	11	0	0
21	25057475	.	G	A	2	2	4	0	0	4	0	0
21	25057544	.	G	A	1	0	1	0	0	1	0	0
21	25057547	.	A	G	0	1	1	0	0	1	0	0
21	25082995	.	G	A	0	1	1	0	0	1	0	0
21	25083046	.	C	T	2	2	4	0	1	5	0	0
21	25103457	.	G	A	2	7	9	0	0	9	0	0
21	25103676	.	T	A	1	10	11	0	0	11	0	0
21	25117588	.	A	G	13	8	21	0	2	23	0	0
21	25117626	.	A	G	10	0	10	0	9	19	0	0
21	25117777	.	T	G	12	14	26	0	0	26	0	0
21	25117959	.	G	A	14	15	29	0	2	31	0	0
21	25117974	.	A	C	12	16	28	0	2	30	0	0
21	25118065	.	G	A	10	8	18	0	1	19	0	0
21	25118108	.	T	C	8	9	17	0	0	17	0	0
21	25118560	.	G	A	0	8	8	0	5	13	0	0
21	25118617	.	A	T	1	2	3	0	1	4	0	0
21	25125110	.	C	T	3	2	5	0	0	5	0	0
21	25135777	.	A	G	4	0	4	0	4	8	0	0
21	25135789	.	C	T	5	3	8	0	1	9	0	0
21	25135922	.	T	G	7	4	11	0	0	11	0	0
21	25140596	.	A	G	4	3	7	0	0	7	0	0
21	25142536	.	T	A	5	7	12	0	1	13	0	0
21	25142635	.	A	G	3	1	4	0	0	4	0	0
21	25156379	.	C	T	4	6	10	0	0	10	0	0
21	25156486	.	C	A	2	2	4	0	0	4	0	0
21	25156487	.	C	A	2	2	4	0	0	4	0	0
21	25181029	.	C	T	1	0	1	0	0	1	0	0
21	25181089	.	G	T	6	2	8	0	0	8	0	0
21	25182091	.	C	A	18	10	28	0	0	28	0	0
21	25182207	.	A	T	11	9	20	0	0	20	0	0
21	25209223	.	G	A	0	2	2	0	1	3	0	0
21	25213423	.	G	A	0	1	1	0	0	1	0	0
21	25231265	.	T	A	2	1	3	0	0	3	0	0
21	25231269	.	T	G	1	0	1	0	1	2	0	0
21	25250497	.	C	T	0	4	4	0	2	6	0	0
21	25250836	.	G	A	2	5	7	0	0	7	0	0
21	25250986	.	G	A	7	3	10	0	1	11	0	0
21	25251013	.	G	A	5	3	8	0	0	8	0	0
21	25251034	.	G	T	5	3	8	0	0	8	0	0
21	25254915	.	G	C	3	3	6	0	0	6	0	0
21	25256907	.	C	T	3	7	10	0	0	10	0	0
21	25259454	.	A	G	6	2	8	0	0	8	0	0
21	25380817	.	T	A	4	3	7	0	0	7	0	0
21	25380894	.	G	T	2	2	4	0	0	4	0	0
21	25384076	.	T	C	5	1	6	0	0	6	0	0
21	25386752	.	T	C	1	5	6	0	0	6	0	0
21	25391290	.	C	A	12	5	17	0	1	18	0	0
21	25399339	.	T	G	5	2	7	0	0	7	0	0
21	25399909	.	T	G	20	16	36	0	0	36	0	0
21	25407216	.	C	G	16	8	24	0	0	24	0	0
21	25425773	.	C	A	12	10	22	0	1	23	0	0
21	25425798	.	T	C	10	8	18	0	0	18	0	0
21	25425826	.	G	T	7	6	13	0	2	15	0	0
21	25425848	.	C	A	0	11	11	0	4	15	0	0
21	25425873	.	A	T	4	12	16	0	0	16	0	0
21	25440049	.	G	A	9	23	32	0	1	33	0	0
21	25449464	.	G	A	0	1	1	0	0	1	0	0
21	25450846	.	G	A	7	3	10	0	0	10	0	0
21	25451002	.	A	G	0	1	1	0	0	1	0	0
21	25452558	.	G	A	5	6	11	0	0	11	0	0
21	25458902	.	T	A	6	11	17	0	0	17	0	0
21	25460713	.	G	A	3	4	7	0	0	7	0	0
21	25460734	.	G	A	5	11	16	0	1	17	0	0
21	25463338	.	A	G	1	0	1	0	0	1	0	0
21	25476597	.	G	A	2	1	3	0	0	3	0	0
21	25492981	.	C	T	1	1	2	0	0	2	0	0
21	25522674	.	C	T	0	9	9	0	15	24	0	0
21	25536182	.	G	A	0	1	1	0	0	1	0	0
21	25538219	.	A	C	4	2	6	0	1	7	0	0
21	25538237	.	G	A	0	2	2	0	4	6	0	0
21	25540822	.	C	A	4	3	7	0	0	7	0	0
21	25540846	.	A	C	3	3	6	0	0	6	0	0
21	25540900	.	G	A	3	4	7	0	0	7	0	0
21	25541473	.	C	T	5	5	10	0	0	10	0	0
21	25542356	.	C	A	8	3	11	0	1	12	0	0
21	25542679	.	G	A	5	2	7	0	0	7	0	0
21	25542966	.	G	T	3	4	7	0	1	8	0	0
21	25561388	.	C	A	2	2	4	0	0	4	0	0
21	25561775	.	T	C	12	2	14	0	11	25	0	0
21	25565268	.	C	T	16	13	29	0	1	30	0	0
21	25570042	.	A	G	15	17	32	0	1	33	0	0
21	25570275	.	G	C	13	9	22	0	3	25	0	0
21	25570416	.	C	G	1	12	13	0	12	25	0	0
21	25571377	.	A	G	6	1	7	0	0	7	0	0
21	25571392	.	G	A	7	2	9	0	0	9	0	0
21	25571436	.	T	A	5	6	11	0	0	11	0	0
21	25571446	.	G	A	5	6	11	0	0	11	0	0
21	25571488	.	T	A	6	4	10	0	0	10	0	0
21	25571919	.	T	C	2	0	2	0	0	2	0	0
21	25572145	.	C	T	2	1	3	0	0	3	0	0
21	25572785	.	G	T	5	2	7	0	0	7	0	0
21	25572930	.	C	T	0	5	5	0	7	12	0	0
21	25589819	.	A	T	7	2	9	0	0	9	0	0
21	25606796	.	C	T	1	0	1	0	1	2	0	0
21	25606971	.	A	G	3	2	5	0	0	5	0	0
21	25609470	.	A	T	3	2	5	0	0	5	0	0
21	25611659	.	A	G	3	1	4	0	0	4	0	0
21	25611861	.	G	A	6	2	8	0	0	8	0	0
21	25611931	.	T	C	14	7	21	0	0	21	0	0
21	25620446	.	T	C	2	5	7	0	0	7	0	0
21	25645217	.	A	C	5	8	13	0	1	14	0	0
21	25645555	.	T	G	20	20	40	0	0	40	0	0
21	25645655	.	G	C	21	11	32	0	0	32	0	0
21	25663198	.	A	G	2	2	4	0	1	5	0	0
21	25663199	.	G	C	2	1	3	0	2	5	0	0
21	25663378	.	T	A	0	2	2	0	1	3	0	0
21	25671377	.	T	C	2	2	4	0	0	4	0	0
21	25685385	.	G	T	1	2	3	0	0	3	0	0
21	25694895	.	G	A	2	3	5	0	0	5	0	0
21	25694896	.	G	A	2	3	5	0	0	5	0	0
21	25694974	.	A	G	1	2	3	0	0	3	0	0
21	25713908	.	T	C	0	2	2	0	0	2	0	0
21	25722719	.	C	T	4	8	12	0	1	13	0	0
21	25796628	.	G	T	2	2	4	0	0	4	0	0
21	25811263	.	C	T	2	1	3	0	0	3	0	0
21	25816780	.	G	A	3	3	6	0	0	6	0	0
21	25817224	.	A	G	4	5	9	0	1	10	0	0
21	25817230	.	A	G	5	4	9	0	0	9	0	0
21	25817847	.	A	G	2	3	5	0	0	5	0	0
21	25818293	.	C	A	2	3	5	0	0	5	0	0
21	25818322	.	A	T	1	3	4	0	0	4	0	0
21	25968253	.	C	T	2	6	8	0	0	8	0	0
21	26021662	.	T	A	1	3	4	0	0	4	0	0
21	26021822	.	T	C	1	1	2	0	3	5	0	0
21	26021834	.	A	C	1	4	5	0	0	5	0	0
21	26021867	.	A	T	4	2	6	0	0	6	0	0
21	26022391	.	T	C	1	0	1	0	2	3	0	0
21	26022992	.	C	T	1	3	4	0	0	4	0	0
21	26023146	.	G	A	4	8	12	0	1	13	0	0
21	26023147	.	T	A	4	8	12	0	1	13	0	0
21	26023209	.	G	A	6	8	14	0	2	16	0	0
21	26023231	.	G	A	8	7	15	0	1	16	0	0
21	26026171	.	A	G	6	4	10	0	0	10	0	0
21	26029021	.	T	C	5	6	11	0	0	11	0	0
21	26030687	.	T	C	3	5	8	0	0	8	0	0
21	26033800	.	C	T	11	5	16	0	0	16	0	0
21	26041741	.	C	T	0	1	1	0	0	1	0	0
21	26043333	.	A	G	1	0	1	0	0	1	0	0
21	26050097	.	C	T	2	2	4	0	1	5	0	0
21	26050115	.	C	T	4	3	7	0	0	7	0	0
21	26050415	.	T	G	4	3	7	0	0	7	0	0
21	26053710	.	T	G	1	0	1	0	1	2	0	0
21	26053929	.	C	A	7	16	23	0	1	24	0	0
21	26054453	.	A	G	4	0	4	0	2	6	0	0
21	26057490	.	T	A	5	11	16	0	1	17	0	0
21	26057707	.	C	T	7	10	17	0	7	24	0	0
21	26057864	.	T	A	8	5	13	0	0	13	0	0
21	26058121	.	C	T	8	17	25	0	0	25	0	0
21	26058275	.	G	T	11	8	19	0	2	21	0	0
21	26058378	.	C	T	8	8	16	0	1	17	0	0
21	26058386	.	C	A	8	6	14	0	3	17	0	0
21	26071110	.	A	C	1	2	3	0	0	3	0	0
21	26080402	.	A	G	6	2	8	0	0	8	0	0
21	26080633	.	G	C	9	10	19	0	0	19	0	0
21	26161272	.	G	A	0	2	2	0	0	2	0	0
21	26389462	.	C	T	6	2	8	0	2	10	0	0
21	26390614	.	G	A	13	7	20	0	0	20	0	0
21	26390620	.	A	G	10	7	17	0	0	17	0	0
21	26391964	.	T	A	9	4	13	0	1	14	0	0
21	26401602	.	C	A	4	4	8	0	0	8	0	0
21	26408340	.	A	C	9	0	9	0	15	24	0	0
21	26415195	.	C	T	9	10	19	0	0	19	0	0
21	26417389	.	A	T	1	2	3	0	0	3	0	0
21	26417854	.	A	T	6	5	11	0	1	12	0	0
21	26426274	.	C	A	0	3	3	0	4	7	0	0
21	26438785	.	C	T	2	3	5	0	0	5	0	0
21	26438854	.	T	C	0	2	2	0	0	2	0	0
21	26441889	.	A	G	2	4	6	0	0	6	0	0
21	26441904	.	C	T	4	3	7	0	1	8	0	0
21	26522682	.	G	A	5	13	18	0	0	18	0	0
21	26523233	.	C	T	2	3	5	0	0	5	0	0
21	26525311	.	C	T	4	1	5	0	0	5	0	0
21	26527782	.	G	A	0	12	12	0	10	22	0	0
21	26527808	.	A	G	7	16	23	0	1	24	0	0
21	26530332	.	G	A	0	3	3	0	1	4	0	0
21	26530663	.	T	A	1	5	6	0	1	7	0	0
21	26530737	.	G	C	11	13	24	0	0	24	0	0
21	26531014	.	G	A	12	7	19	0	0	19	0	0
21	26545469	.	C	T	0	1	1	0	0	1	0	0
21	26545622	.	T	A	2	2	4	0	0	4	0	0
21	26607004	.	T	G	6	3	9	0	1	10	0	0
21	26634042	.	C	T	6	6	12	0	3	15	0	0
21	26657476	.	C	T	7	9	16	0	1	17	0	0
21	26657484	.	C	A	5	5	10	0	0	10	0	0
21	26660055	.	G	A	2	11	13	0	20	34	1	0
21	26662745	.	G	A	10	19	29	0	1	30	0	0
21	26664824	.	G	A	8	5	13	0	1	14	0	0
21	26665046	.	G	T	1	7	8	0	1	9	0	0
21	26665092	.	C	T	0	4	4	0	5	9	0	0
21	26665141	.	A	G	6	9	15	0	0	15	0	0
21	26669386	.	C	G	3	4	7	0	0	7	0	0
21	26669394	.	C	T	4	3	7	0	0	7	0	0
21	26669421	.	T	C	5	6	11	0	0	11	0	0
21	26669480	.	C	A	8	8	16	0	1	17	0	0
21	26669495	.	G	A	8	4	12	0	0	12	0	0
21	26670145	.	T	C	11	0	11	0	5	16	0	0
21	26670306	.	T	A	2	6	8	0	0	8	0	0
21	26670860	.	C	A	2	5	7	0	0	7	0	0
21	26672014	.	G	A	4	0	4	0	0	4	0	0
21	26672160	.	C	T	2	4	6	0	1	7	0	0
21	26672184	.	C	T	1	7	8	0	2	10	0	0
21	26672217	.	G	C	5	5	10	0	0	10	0	0
21	26672270	.	T	C	7	6	13	0	0	13	0	0
21	26672293	.	A	G	4	5	9	0	0	9	0	0
21	26672373	.	T	C	5	3	8	0	0	8	0	0
21	26672434	.	C	T	3	1	4	0	2	6	0	0
21	26672611	.	G	A	6	2	8	0	0	8	0	0
21	26675363	.	T	C	1	0	1	0	7	8	0	0
21	26678649	.	C	T	7	9	16	0	0	16	0	0
21	26678650	.	C	T	7	9	16	0	0	16	0	0
21	26678838	.	C	A	3	3	6	0	0	6	0	0
21	26678965	.	C	T	0	5	5	0	10	15	0	0
21	26679023	.	T	C	10	9	19	0	1	20	0	0
21	26689875	.	T	A	8	3	11	0	0	11	0	0
21	26689934	.	A	T	3	11	14	0	0	14	0	0
21	26690151	.	T	A	5	3	8	0	1	9	0	0
21	26691889	.	T	C	2	3	5	0	0	5	0	0
21	26691898	.	A	T	2	4	6	0	0	6	0	0
21	26697686	.	G	C	33	16	49	0	4	53	0	0
21	26706581	.	C	A	28	35	63	0	1	64	0	0
21	26706583	.	G	A	28	35	63	0	1	64	0	0
21	26706646	.	C	G	24	21	45	0	3	48	0	0
21	26706662	.	T	A	30	20	50	0	2	52	0	0
21	26706846	.	T	A	21	27	48	0	0	48	0	0
21	26710071	.	A	G	20	19	39	0	0	39	0	0
21	26710194	.	T	A	23	19	42	0	2	44	0	0
21	26710239	.	G	A	21	18	39	0	0	39	0	0
21	26710496	.	C	A	34	18	52	0	3	55	0	0
21	26710514	.	A	G	31	23	54	0	2	56	0	0
21	26714361	.	C	T	0	5	5	0	2	7	0	0
21	26714373	.	C	A	0	2	2	0	0	2	0	0
21	26721385	.	C	A	0	7	7	0	0	7	0	0
21	26721400	.	G	A	0	9	9	0	1	10	0	0
21	26722269	.	C	T	4	13	17	0	2	19	0	0
21	26722347	.	G	A	9	14	23	0	1	24	0	0
21	26722431	.	T	C	3	3	6	0	0	6	0	0
21	26722625	.	C	T	10	13	23	0	0	23	0	0
21	26722688	.	T	A	4	5	9	0	2	11	0	0
21	26724649	.	A	G	17	9	26	0	1	27	0	0
21	26724833	.	A	G	21	16	37	0	2	39	0	0
21	26725247	.	C	T	16	15	31	0	3	34	0	0
21	26731344	.	G	A	29	31	60	0	0	60	0	0
21	26731364	.	T	A	30	30	60	0	0	60	0	0
21	26731765	.	C	T	30	35	65	1	4	70	0	0
21	26731925	.	C	A	22	28	50	0	3	53	0	0
21	26733455	.	G	T	2	9	11	0	0	11	0	0
21	26733489	.	G	A	6	2	8	0	0	8	0	0
21	26733517	.	A	G	2	3	5	0	0	5	0	0
21	26733639	.	A	G	1	1	2	0	0	2	0	0
21	26748198	.	A	G	0	3	3	0	0	3	0	0
21	26753714	.	G	A	2	1	3	0	0	3	0	0
21	26760073	.	G	A	0	5	5	0	5	10	0	0
21	26909169	.	C	T	8	12	20	0	2	22	0	0
21	26909177	.	C	T	7	10	17	0	4	21	0	0
21	26909228	.	A	G	13	11	24	0	0	24	0	0
21	26909425	.	C	G	10	11	21	0	0	21	0	0
21	26909560	.	A	C	9	1	10	0	11	21	0	0
21	26914870	.	T	G	6	11	17	0	0	17	0	0
21	26914915	.	T	G	5	12	17	0	0	17	0	0
21	26915086	.	G	A	6	9	15	0	2	17	0	0
21	26915203	.	A	G	3	8	11	0	1	12	0	0
21	26915355	.	G	A	10	10	20	0	0	20	0	0
21	26916142	.	A	G	4	5	9	0	1	10	0	0
21	26916238	.	C	T	0	4	4	0	2	6	0	0
21	26918601	.	C	T	9	4	13	0	1	14	0	0
21	26918684	.	G	A	1	4	5	0	1	6	0	0
21	26918703	.	A	G	3	4	7	0	0	7	0	0
21	26918726	.	G	A	4	5	9	0	0	9	0	0
21	26918762	.	C	A	6	5	11	0	0	11	0	0
21	26918767	.	G	A	8	4	12	0	0	12	0	0
21	26918892	.	A	G	2	2	4	0	0	4	0	0
21	26927201	.	C	A	2	1	3	0	0	3	0	0
21	26927255	.	T	C	1	8	9	0	0	9	0	0
21	26934419	.	G	A	11	7	18	0	0	18	0	0
21	26934888	.	C	T	4	4	8	0	0	8	0	0
21	26954405	.	G	A	6	7	13	0	0	13	0	0
21	26954430	.	T	C	6	8	14	0	0	14	0	0
21	26961015	.	A	T	1	1	2	0	1	3	0	0
21	26961084	.	A	G	6	15	21	0	2	23	0	0
21	26965918	.	A	T	17	12	29	0	2	31	0	0
21	26966025	.	T	C	8	8	16	0	0	16	0	0
21	26966047	.	A	T	8	7	15	0	0	15	0	0
21	26966079	.	A	G	7	1	8	0	3	11	0	0
21	26966088	.	A	T	7	2	9	0	0	9	0	0
21	26966287	.	G	A	0	8	8	0	17	25	0	0
21	26966315	.	G	A	7	7	14	0	0	14	0	0
21	26966681	.	A	G	10	0	10	0	17	27	0	0
21	26967230	.	C	T	6	16	22	0	1	23	0	0
21	26967265	.	T	A	7	10	17	0	1	18	0	0
21	26967551	.	A	T	9	24	33	0	1	34	0	0
21	26967906	.	T	G	23	13	36	0	2	39	1	0
21	26968042	.	G	A	20	11	31	0	2	33	0	0
21	26968344	.	G	A	14	13	27	0	2	29	0	0
21	26968499	.	T	G	8	16	24	0	0	24	0	0
21	26995869	.	G	A	2	6	8	0	0	8	0	0
21	26996849	.	C	A	1	25	26	0	24	50	0	0
21	26996893	.	T	C	20	0	20	0	30	50	0	0
21	27010406	.	T	A	8	20	28	0	1	29	0	0
21	27047839	.	A	T	13	12	25	0	0	25	0	0
21	27047955	.	G	A	15	16	31	0	1	32	0	0
21	27048320	.	C	A	7	9	16	0	1	17	0	0
21	27048423	.	G	T	10	13	23	0	1	24	0	0
21	27048534	.	G	A	10	9	19	0	3	22	0	0
21	27053061	.	G	A	2	6	8	0	1	9	0	0
21	27061097	.	C	T	1	0	1	0	0	1	0	0
21	27119735	.	T	A	2	14	16	0	0	16	0	0
21	27121852	.	G	A	6	4	10	0	0	10	0	0
21	27122362	.	G	A	10	9	19	0	0	19	0	0
21	27122596	.	A	G	6	3	9	0	0	9	0	0
21	27122620	.	C	T	3	4	7	0	0	7	0	0
21	27122908	.	C	G	0	5	5	0	5	10	0	0
21	27122980	.	C	T	0	5	5	0	5	11	1	0
21	27123024	.	T	C	5	0	5	0	9	14	0	0
21	27123089	.	G	A	5	7	12	0	1	13	0	0
21	27185479	.	T	G	3	1	4	0	0	4	0	0
21	27189802	.	G	A	1	15	16	0	8	24	0	0
21	27190038	.	G	C	3	3	6	0	0	6	0	0
21	27198405	.	C	T	6	12	18	0	4	22	0	0
21	27199893	.	G	A	10	10	20	0	0	20	0	0
21	27204648	.	C	T	6	15	21	0	1	22	0	0
21	27204669	.	T	C	12	0	12	0	8	20	0	0
21	27204713	.	T	A	13	13	26	0	0	27	1	0
21	27204747	.	C	T	21	13	34	0	3	37	0	0
21	27204942	.	G	A	10	10	20	0	2	22	0	0
21	27204957	.	G	A	12	11	23	0	0	23	0	0
21	27205050	.	G	A	10	13	23	0	1	24	0	0
21	27213209	.	A	T	9	8	17	0	0	17	0	0
21	27213287	.	T	A	7	8	15	0	0	15	0	0
21	27221206	.	G	A	0	0	0	0	1	1	0	0
21	27283720	.	G	A	5	5	10	0	0	10	0	0
21	27283782	.	G	A	4	2	6	0	0	6	0	0
21	27302868	.	A	G	11	0	11	0	14	25	0	0
21	27302943	.	C	A	13	14	27	0	3	30	0	0
21	27305739	.	T	G	7	5	12	0	0	12	0	0
21	27305972	.	A	G	4	0	4	0	3	7	0	0
21	27306203	.	C	T	4	3	7	0	1	8	0	0
21	27308671	.	C	T	22	16	38	0	2	40	0	0
21	27311230	.	C	T	9	12	21	0	2	23	0	0
21	27311450	.	C	T	8	7	15	0	2	17	0	0
21	27312950	.	C	T	7	10	17	0	2	19	0	0
21	27312962	.	G	A	10	4	14	0	0	14	0	0
21	27318274	.	G	T	7	5	12	0	1	13	0	0
21	27341444	.	C	T	3	1	4	0	0	4	0	0
21	27341453	.	G	A	0	2	2	0	2	4	0	0
21	27343611	.	C	T	2	4	6	0	0	6	0	0
21	27343637	.	T	C	2	3	5	0	0	5	0	0
21	27343814	.	G	A	0	1	1	0	3	4	0	0
21	27344125	.	T	C	0	2	2	0	0	2	0	0
21	27346260	.	T	C	4	1	5	0	2	7	0	0
21	27347994	.	C	T	1	0	1	0	0	1	0	0
21	27348033	.	A	C	3	0	3	0	0	3	0	0
21	27351316	.	T	C	5	4	9	0	1	10	0	0
21	27354112	.	A	G	14	7	21	0	1	22	0	0
21	27354142	.	C	A	9	9	18	0	1	19	0	0
21	27354147	.	T	C	10	5	15	0	2	17	0	0
21	27354434	.	C	A	9	8	17	0	1	18	0	0
21	27354505	.	T	C	4	8	12	0	0	12	0	0
21	27354602	.	G	T	4	4	8	0	0	8	0	0
21	27354621	.	T	G	2	4	6	0	0	6	0	0
21	27357019	.	T	C	4	2	6	0	1	7	0	0
21	27359016	.	G	C	1	0	1	0	2	3	0	0
21	27359811	.	C	T	1	2	3	0	0	3	0	0
21	27375247	.	C	T	4	10	14	0	2	16	0	0
21	27377354	.	C	A	10	23	33	0	2	35	0	0
21	27377815	.	G	A	0	4	4	0	0	4	0	0
21	27378011	.	A	C	8	7	15	0	0	15	0	0
21	27378269	.	T	A	6	11	17	0	0	17	0	0
21	27378388	.	T	G	4	8	12	0	0	12	0	0
21	27378607	.	T	A	7	5	12	0	1	13	0	0
21	27378663	.	G	A	0	7	7	0	2	9	0	0
21	27407856	.	C	T	0	2	2	0	0	2	0	0
21	27488954	.	A	G	0	3	3	0	0	3	0	0
21	27514139	.	T	G	4	0	4	0	3	7	0	0
21	27523049	.	G	A	0	2	2	0	0	2	0	0
21	27523079	.	T	C	2	0	2	0	0	2	0	0
21	27526405	.	C	T	0	1	1	0	0	1	0	0
21	27530414	.	C	A	0	1	1	0	0	1	0	0
21	27536026	.	G	A	0	5	5	0	2	7	0	0
21	27549702	.	G	T	6	5	11	0	1	12	0	0
21	27552349	.	A	G	2	0	2	0	8	10	0	0
21	27552667	.	A	G	8	0	8	0	10	18	0	0
21	27552699	.	C	G	6	6	12	0	0	12	0	0
21	27554837	.	T	C	13	4	17	0	0	17	0	0
21	27554858	.	C	T	10	14	24	0	0	24	0	0
21	27554904	.	A	G	12	14	26	0	1	27	0	0
21	27554939	.	G	C	11	14	25	0	0	25	0	0
21	27554986	.	C	T	5	5	10	0	2	12	0	0
21	27555051	.	G	T	1	5	6	0	0	6	0	0
21	27581311	.	G	A	2	2	4	0	0	4	0	0
21	27587211	.	T	C	1	0	1	0	2	3	0	0
21	27602975	.	C	T	0	3	3	0	0	3	0	0
21	27606765	.	G	A	1	1	2	0	0	2	0	0
21	27636438	.	C	T	16	18	34	0	1	35	0	0
21	27636664	.	C	T	0	11	11	2	17	31	1	0
21	27636733	.	C	A	10	22	32	0	0	32	0	0
21	27636739	.	G	A	13	21	34	0	0	34	0	0
21	27636867	.	C	T	12	17	29	0	0	29	0	0
21	27637534	.	C	T	22	17	39	0	1	40	0	0
21	27637912	.	G	A	25	19	44	0	1	45	0	0
21	27637951	.	A	G	29	18	47	0	0	47	0	0
21	27637993	.	G	A	27	15	42	0	2	44	0	0
21	27638260	.	A	G	13	5	18	0	1	19	0	0
21	27657331	.	T	A	4	8	12	0	0	12	0	0
21	27657475	.	A	G	12	17	29	0	0	30	1	0
21	27880547	.	G	A	1	6	7	0	0	7	0	0
21	27880607	.	C	T	0	9	9	0	1	10	0	0
21	27881043	.	G	C	10	0	10	0	7	17	0	0
21	27881449	.	A	G	4	6	10	0	2	12	0	0
21	27881474	.	C	T	4	8	12	0	2	14	0	0
21	27881577	.	A	G	6	4	10	0	1	11	0	0
21	27881609	.	C	T	0	5	5	0	8	13	0	0
21	27881729	.	C	T	1	10	11	0	9	20	0	0
21	28051224	.	G	T	2	5	7	0	0	7	0	0
21	28051332	.	C	T	4	5	9	0	1	10	0	0
21	28076575	.	A	G	2	4	6	0	1	7	0	0
21	28076668	.	G	A	3	9	12	0	1	13	0	0
21	28076770	.	T	C	3	3	6	0	0	6	0	0
21	28076821	.	A	G	2	2	4	0	0	4	0	0
21	28078711	.	G	T	4	4	8	0	0	8	0	0
21	28078826	.	A	G	2	7	9	0	0	9	0	0
21	28082587	.	T	G	1	1	2	0	0	2	0	0
21	28089641	.	G	T	3	7	10	0	0	10	0	0
21	28235371	.	A	G	2	3	5	0	0	5	0	0
21	28235740	.	G	T	1	1	2	0	1	3	0	0
21	28496276	.	T	C	27	18	45	0	3	48	0	0
21	28496332	.	C	T	38	27	65	0	1	66	0	0
21	28500561	.	C	T	30	29	59	0	4	63	0	0
21	28510226	.	C	T	2	2	4	0	0	4	0	0
21	28510258	.	A	G	8	11	19	0	0	19	0	0
21	28512800	.	G	T	11	7	18	0	1	19	0	0
21	28555436	.	C	T	0	2	2	0	5	7	0	0
21	28561707	.	T	C	2	3	5	0	0	5	0	0
21	28564947	.	T	C	1	0	1	0	0	1	0	0
21	28567343	.	G	A	0	4	4	0	0	4	0	0
21	28724148	.	C	T	14	13	27	0	1	28	0	0
21	28749802	.	C	T	1	2	3	0	0	3	0	0
21	28863810	.	A	G	11	5	16	0	0	16	0	0
21	28863884	.	G	A	4	2	6	0	0	6	0	0
21	28864246	.	G	A	15	9	24	0	1	25	0	0
21	28864475	.	C	T	0	9	9	0	6	15	0	0
21	28901022	.	C	A	0	12	12	0	15	27	0	0
21	28901037	.	G	A	13	6	19	0	0	19	0	0
21	28901078	.	T	C	3	2	5	0	0	5	0	0
21	28920111	.	C	T	3	10	13	0	13	26	0	0
21	29039214	.	C	A	10	13	23	0	0	23	0	0
21	29059819	.	G	A	1	0	1	0	2	3	0	0
21	29064692	.	T	C	5	2	7	0	0	7	0	0
21	29074438	.	C	G	23	17	40	0	2	42	0	0
21	29074439	.	T	C	24	14	38	0	4	42	0	0
21	29074492	.	A	T	18	19	37	0	3	40	0	0
21	29075234	.	T	G	12	4	16	0	1	17	0	0
21	29075235	.	T	G	15	1	16	0	1	17	0	0
21	29075332	.	G	T	20	13	33	0	2	36	1	0
21	29090879	.	C	T	1	6	7	0	14	21	0	0
21	29090935	.	C	T	0	4	4	0	6	10	0	0
21	29090984	.	T	G	26	7	33	0	0	33	0	0
21	29091053	.	T	C	26	12	38	0	0	38	0	0
21	29091054	.	G	A	25	11	36	0	2	38	0	0
21	29091362	.	C	G	0	3	3	0	0	3	0	0
21	29092420	.	A	G	1	2	3	0	1	4	0	0
21	29094676	.	T	C	6	0	6	0	8	14	0	0
21	29096390	.	A	T	1	0	1	0	1	2	0	0
21	29096709	.	T	G	24	26	50	0	3	53	0	0
21	29100081	.	G	A	2	2	4	0	0	4	0	0
21	29228027	.	A	G	1	2	3	0	1	4	0	0
21	29228144	.	A	C	1	1	2	0	0	2	0	0
21	29247636	.	C	T	5	7	12	0	1	13	0	0
21	29247813	.	A	G	2	5	7	0	0	7	0	0
21	30010042	.	T	C	4	3	7	0	0	7	0	0
21	30010146	.	C	T	4	8	12	0	1	13	0	0
21	30010299	.	C	A	7	7	14	0	0	14	0	0
21	30010332	.	G	A	0	7	7	0	8	15	0	0
21	30010462	.	C	T	1	3	4	0	0	4	0	0
21	30014318	.	C	T	5	5	10	0	0	10	0	0
21	30019225	.	C	T	5	4	9	0	0	9	0	0
21	30019385	.	C	G	2	5	7	0	0	7	0	0
21	30019586	.	T	A	1	4	5	0	0	5	0	0
21	30019992	.	T	C	1	0	1	0	2	3	0	0
21	30020062	.	T	A	5	6	11	0	0	11	0	0
21	30020097	.	A	G	2	6	8	0	0	8	0	0
21	30020123	.	T	G	7	3	10	0	0	10	0	0
21	30025205	.	T	C	7	0	7	0	5	12	0	0
21	30025514	.	G	A	8	4	12	0	0	12	0	0
21	30026162	.	C	T	1	4	5	0	13	18	0	0
21	30031126	.	G	A	5	4	9	0	0	9	0	0
21	30031316	.	G	A	2	7	9	0	3	12	0	0
21	30031987	.	G	A	9	8	17	0	0	17	0	0
21	30032045	.	C	T	10	11	21	0	0	21	0	0
21	30057194	.	G	T	2	2	4	0	0	4	0	0
21	30058052	.	G	A	2	2	4	0	0	4	0	0
21	30116508	.	G	A	8	7	15	0	2	17	0	0
21	30169705	.	T	C	4	0	4	0	4	8	0	0
21	30181216	.	G	A	4	4	8	0	1	9	0	0
21	30181662	.	T	A	4	0	4	0	0	4	0	0
21	30195389	.	C	T	1	2	3	0	0	3	0	0
21	30201092	.	G	A	7	5	12	0	0	12	0	0
21	30201235	.	C	T	4	1	5	0	0	5	0	0
21	30206393	.	A	T	3	3	6	0	1	7	0	0
21	30208255	.	G	A	0	10	10	0	9	19	0	0
21	30232112	.	T	G	12	12	24	0	1	26	1	0
21	30232187	.	C	T	15	19	34	0	1	35	0	0
21	30232212	.	C	T	15	15	30	0	0	30	0	0
21	30232304	.	C	T	2	1	3	0	0	3	0	0
21	30236791	.	C	A	1	5	6	0	0	6	0	0
21	30239975	.	A	C	16	12	28	0	0	28	0	0
21	30240378	.	C	A	13	16	29	0	1	30	0	0
21	30240400	.	T	G	16	13	29	0	2	31	0	0
21	30244739	.	G	T	9	15	24	0	3	27	0	0
21	30246684	.	A	G	4	6	10	0	0	10	0	0
21	30253692	.	A	G	10	11	21	0	1	22	0	0
21	30253884	.	A	G	7	9	16	0	0	16	0	0
21	30253942	.	A	C	9	7	16	0	0	16	0	0
21	30253954	.	A	C	10	8	18	0	1	19	0	0
21	30253982	.	T	A	10	9	19	0	2	21	0	0
21	30260653	.	C	A	2	8	10	0	0	10	0	0
21	30260961	.	C	T	1	9	10	0	3	13	0	0
21	30270015	.	C	G	0	2	2	0	11	13	0	0
21	30270024	.	A	T	3	0	3	0	7	10	0	0
21	30273366	.	C	A	3	9	12	0	0	12	0	0
21	30299416	.	T	C	3	2	5	0	1	6	0	0
21	30299561	.	T	C	11	13	24	0	0	24	0	0
21	30299679	.	A	T	3	5	8	0	0	8	0	0
21	30299735	.	C	T	4	2	6	0	0	6	0	0
21	30692794	.	A	G	4	4	8	0	0	8	0	0
21	30692817	.	A	G	4	0	4	0	3	7	0	0
21	30692835	.	A	G	3	2	5	0	0	5	0	0
21	30693311	.	A	G	8	12	20	0	0	20	0	0
21	30693312	.	A	G	7	10	17	0	3	20	0	0
21	30693906	.	A	G	16	6	22	0	1	23	0	0
21	31010037	.	C	T	1	2	3	0	2	5	0	0
21	32281076	.	G	A	2	8	10	0	1	11	0	0
21	32281122	.	G	A	6	10	16	0	2	18	0	0
21	32281155	.	G	A	6	14	20	0	1	21	0	0
21	32281680	.	C	T	2	3	5	0	0	5	0	0
21	32283519	.	G	A	1	1	2	0	0	2	0	0
21	32284398	.	A	G	2	4	6	0	0	6	0	0
21	32285135	.	T	C	1	0	1	0	3	4	0	0
21	32343230	.	C	A	4	3	7	0	0	7	0	0
21	32343248	.	C	A	3	4	7	0	2	9	0	0
21	32343316	.	T	A	7	9	16	0	1	17	0	0
21	32343453	.	C	T	4	6	10	0	1	11	0	0
21	32343577	.	T	C	6	5	11	0	0	11	0	0
21	32343649	.	C	A	6	5	11	0	3	14	0	0
21	32343721	.	T	G	6	0	6	0	6	12	0	0
21	32344021	.	C	A	5	6	11	0	0	11	0	0
21	32345162	.	T	C	4	2	6	0	0	6	0	0
21	32345318	.	G	A	0	3	3	0	5	8	0	0
21	32345607	.	C	T	9	5	14	0	0	14	0	0
21	32345724	.	A	G	4	4	8	0	0	8	0	0
21	32346273	.	G	A	17	11	28	0	0	28	0	0
21	32346603	.	G	C	12	18	30	0	1	31	0	0
21	32346630	.	T	C	8	23	31	0	0	31	0	0
21	32346674	.	T	A	7	16	23	0	1	24	0	0
21	32346689	.	A	G	7	13	20	0	1	21	0	0
21	32346799	.	G	A	9	14	23	0	0	23	0	0
21	32346800	.	T	A	8	14	22	0	1	23	0	0
21	32346899	.	A	G	17	9	26	0	1	27	0	0
21	32346901	.	A	G	18	9	27	0	0	27	0	0
21	32347134	.	T	A	17	17	34	0	1	35	0	0
21	32347569	.	G	T	12	16	28	0	0	28	0	0
21	32347855	.	T	C	8	6	14	0	1	15	0	0
21	32347966	.	A	C	10	0	10	0	6	16	0	0
21	32348230	.	A	T	11	5	16	0	1	17	0	0
21	32348512	.	G	T	6	8	14	0	1	15	0	0
21	32348542	.	A	T	9	9	18	0	0	18	0	0
21	32348570	.	C	T	10	13	23	0	0	23	0	0
21	32348600	.	C	T	10	16	26	0	0	26	0	0
21	32348664	.	G	A	7	12	19	0	1	20	0	0
21	32353049	.	G	A	5	5	10	0	0	10	0	0
21	32354980	.	A	G	6	13	19	0	1	20	0	0
21	32374460	.	A	T	4	9	13	0	0	13	0	0
21	32457785	.	T	C	12	13	25	0	0	25	0	0
21	32457923	.	C	A	16	14	30	0	0	30	0	0
21	32457931	.	T	G	17	10	27	0	1	29	1	0
21	32457983	.	G	A	13	13	26	0	2	28	0	0
21	32458261	.	A	G	20	25	45	0	1	46	0	0
21	32458315	.	T	A	16	23	39	0	0	39	0	0
21	32460912	.	A	G	14	10	24	0	1	25	0	0
21	32466140	.	G	C	4	6	10	0	0	10	0	0
21	32467660	.	A	G	13	14	27	0	3	30	0	0
21	32467724	.	T	C	19	15	34	0	3	37	0	0
21	32476760	.	A	G	33	19	52	0	1	53	0	0
21	32477584	.	T	C	21	27	48	0	4	52	0	0
21	32477967	.	C	T	29	20	49	0	4	53	0	0
21	32477987	.	A	T	29	9	38	0	13	51	0	0
21	32478227	.	G	T	21	10	31	0	0	31	0	0
21	32482797	.	C	T	6	15	21	0	1	22	0	0
21	32482854	.	T	C	18	3	21	0	27	48	0	0
21	32486997	.	A	T	1	2	3	0	1	4	0	0
21	32552207	.	G	A	1	3	4	0	0	4	0	0
21	32581420	.	C	A	1	0	1	0	0	1	0	0
21	32758254	.	G	A	9	5	14	0	1	15	0	0
21	32758351	.	C	T	11	6	17	0	0	17	0	0
21	32758584	.	G	A	12	19	31	0	0	31	0	0
21	32759421	.	C	T	17	4	21	0	0	21	0	0
21	32766389	.	G	A	13	6	19	0	1	20	0	0
21	32772450	.	G	A	0	4	4	0	0	4	0	0
21	32821138	.	T	C	6	2	8	0	0	8	0	0
21	33058940	.	G	C	5	8	13	0	1	14	0	0
21	33066214	.	T	G	3	0	3	0	1	4	0	0
21	33069896	.	A	G	4	1	5	0	0	5	0	0
21	33211266	.	A	G	6	2	8	0	0	8	0	0
21	33211296	.	T	C	2	3	5	0	0	5	0	0
21	33211506	.	T	A	7	16	23	0	0	23	0	0
21	33211568	.	C	T	14	5	19	0	2	21	0	0
21	33211664	.	T	G	2	5	7	0	1	8	0	0
21	33211720	.	A	T	7	7	14	0	1	15	0	0
21	33211809	.	A	T	19	13	32	0	0	32	0	0
21	33213315	.	C	T	6	7	13	0	1	14	0	0
21	33213384	.	G	A	4	5	9	0	0	9	0	0
21	33218312	.	T	C	6	5	11	0	0	11	0	0
21	33218405	.	G	A	4	8	12	0	0	12	0	0
21	33249606	.	T	A	3	4	7	0	0	7	0	0
21	33249638	.	A	C	2	2	4	0	0	4	0	0
21	33447251	.	A	G	14	7	21	0	1	22	0	0
21	33463486	.	A	G	3	3	6	0	0	6	0	0
21	34001982	.	C	T	12	10	22	0	0	22	0	0
21	34002041	.	C	A	8	10	18	0	1	19	0	0
21	34002333	.	T	C	4	8	12	0	1	13	0	0
21	34002455	.	G	A	2	7	9	0	1	10	0	0
21	34002507	.	A	G	7	9	16	0	0	16	0	0
21	34026657	.	T	C	1	1	2	0	0	2	0	0
21	34031232	.	G	A	7	4	11	0	1	12	0	0
21	34057611	.	T	G	1	9	10	0	0	10	0	0
21	34074618	.	A	G	5	7	12	0	1	13	0	0
21	34074684	.	G	A	4	7	11	0	2	13	0	0
21	34074712	.	T	C	5	8	13	0	0	13	0	0
21	34088192	.	C	T	1	3	4	0	0	4	0	0
21	34098048	.	C	T	0	1	1	0	0	1	0	0
21	34103275	.	G	A	0	6	6	0	5	11	0	0
21	34114410	.	G	A	2	1	3	0	1	4	0	0
21	34128660	.	A	G	8	6	14	0	0	14	0	0
21	34129007	.	C	G	3	0	3	0	3	6	0	0
21	34129073	.	G	C	15	20	35	0	2	37	0	0
21	34129195	.	G	T	9	23	32	0	0	32	0	0
21	34129279	.	A	G	13	21	34	0	1	35	0	0
21	34129629	.	A	G	5	3	8	0	0	8	0	0
21	34195712	.	G	A	2	2	4	0	0	4	0	0
21	34195790	.	T	C	3	5	8	0	1	9	0	0
21	34210970	.	G	A	8	3	11	0	0	11	0	0
21	34211206	.	T	C	10	9	19	0	0	19	0	0
21	34211344	.	G	A	12	9	21	0	1	22	0	0
21	34211418	.	G	A	1	3	4	0	5	9	0	0
21	34211427	.	A	C	5	3	8	0	0	8	0	0
21	34364595	.	G	A	6	5	11	0	1	12	0	0
21	34364774	.	G	A	4	3	7	0	0	7	0	0
21	34364962	.	G	T	10	7	17	0	0	17	0	0
21	34391104	.	C	T	4	11	15	0	3	18	0	0
21	34391155	.	T	C	2	3	5	0	2	7	0	0
21	34392786	.	C	T	1	3	4	0	2	6	0	0
21	34392828	.	G	T	4	7	11	0	3	14	0	0
21	34424116	.	A	G	5	10	15	0	0	15	0	0
21	34430533	.	A	G	7	6	13	0	0	13	0	0
21	34430544	.	A	G	8	6	14	0	1	15	0	0
21	34714359	.	G	A	0	4	4	0	3	7	0	0
21	34714403	.	C	A	2	9	11	0	1	12	0	0
21	34724797	.	G	A	6	4	10	0	1	11	0	0
21	34724956	.	C	T	4	5	9	0	0	9	0	0
21	34741120	.	T	C	1	0	1	0	0	1	0	0
21	34770460	.	G	A	2	1	3	0	0	3	0	0
21	34770483	.	G	A	3	1	4	0	0	4	0	0
21	34770510	.	C	T	2	1	3	0	0	3	0	0
21	34792896	.	G	A	1	6	7	0	1	8	0	0
21	34793224	.	C	T	14	12	26	0	0	26	0	0
21	34793405	.	C	T	9	15	24	0	2	26	0	0
21	34793660	.	T	A	6	4	10	0	0	10	0	0
21	34793694	.	T	C	2	3	5	0	0	5	0	0
21	34793753	.	A	C	6	2	8	0	0	8	0	0
21	34793786	.	C	G	2	6	8	0	0	8	0	0
21	34815276	.	T	A	2	2	4	0	0	4	0	0
21	34834292	.	C	G	2	2	4	0	0	4	0	0
21	34834295	.	A	G	2	0	2	0	2	4	0	0
21	34834430	.	G	C	0	1	1	0	6	7	0	0
21	34834472	.	A	T	2	2	4	0	0	4	0	0
21	34834874	.	A	T	2	2	4	0	0	4	0	0
21	34849534	.	A	G	8	5	13	0	1	14	0	0
21	34981031	.	G	A	5	4	9	0	0	9	0	0
21	34987505	.	C	T	1	10	11	0	1	12	0	0
21	34987612	.	G	A	1	7	8	0	8	16	0	0
21	34987662	.	G	T	3	4	7	0	0	7	0	0
21	35009472	.	C	T	3	0	3	0	0	3	0	0
21	35009509	.	A	G	3	1	4	0	0	4	0	0
21	35009676	.	T	A	0	1	1	0	0	1	0	0
21	35009706	.	C	T	0	2	2	0	0	2	0	0
21	35010135	.	A	T	0	2	2	0	0	2	0	0
21	35033847	.	G	A	1	4	5	0	1	6	0	0
21	35033853	.	G	A	2	4	6	0	0	6	0	0
21	35035560	.	G	A	0	3	3	0	0	3	0	0
21	35040310	.	C	T	5	7	12	0	0	13	1	0
21	35048278	.	T	A	4	4	8	0	0	8	0	0
21	35048320	.	A	G	1	0	1	0	3	4	0	0
21	35054466	.	A	G	2	4	6	0	1	7	0	0
21	35054879	.	G	A	2	2	4	0	0	4	0	0
21	35054892	.	G	A	2	2	4	0	0	4	0	0
21	35055032	.	C	A	2	2	4	0	0	4	0	0
21	35279874	.	C	T	7	8	15	0	0	15	0	0
21	35280099	.	A	G	8	9	17	0	0	17	0	0
21	35280209	.	G	A	0	4	4	0	8	12	0	0
21	35280233	.	T	C	8	5	13	0	0	13	0	0
21	35280285	.	G	A	6	3	9	0	0	9	0	0
21	35280388	.	T	A	6	3	9	0	2	11	0	0
21	35280389	.	A	T	5	5	10	0	1	11	0	0
21	35280482	.	G	T	6	4	10	0	0	10	0	0
21	35280938	.	C	T	5	10	15	0	0	15	0	0
21	35281246	.	A	C	12	10	22	0	1	23	0	0
21	35305823	.	G	A	3	2	5	0	0	5	0	0
21	35327489	.	C	A	1	0	1	0	0	1	0	0
21	35328083	.	A	G	1	0	1	0	0	1	0	0
21	35328108	.	T	G	2	1	3	0	0	3	0	0
21	35335079	.	A	G	1	0	1	0	1	2	0	0
21	35359489	.	A	G	2	0	2	0	6	8	0	0
21	35653043	.	T	C	4	3	7	0	0	7	0	0
21	35653077	.	A	C	3	4	7	0	0	7	0	0
21	35653321	.	G	A	2	1	3	0	0	3	0	0
21	35677566	.	C	A	0	1	1	0	4	5	0	0
21	36386928	.	G	A	11	4	15	0	0	15	0	0
21	36387018	.	A	G	15	6	21	0	0	21	0	0
21	36387051	.	T	C	9	1	10	0	0	10	0	0
21	36417065	.	C	A	1	0	1	0	0	1	0	0
21	36419256	.	G	A	0	0	0	0	1	1	0	0
21	36435575	.	G	C	4	2	6	0	0	6	0	0
21	36442260	.	T	A	5	6	11	0	0	11	0	0
21	36442633	.	G	A	9	10	19	0	1	20	0	0
21	36446952	.	A	G	3	5	8	0	2	10	0	0
21	36449385	.	T	G	7	6	13	0	0	13	0	0
21	36449427	.	G	A	4	5	9	0	0	9	0	0
21	36449686	.	T	C	10	8	18	0	1	19	0	0
21	36449716	.	G	A	5	9	14	0	2	16	0	0
21	36468431	.	G	A	5	3	8	0	0	8	0	0
21	36474466	.	G	A	3	0	3	0	0	3	0	0
21	36501319	.	C	T	4	2	6	0	0	6	0	0
21	36512296	.	G	A	5	2	7	0	0	7	0	0
21	36525559	.	C	A	0	1	1	0	1	2	0	0
21	36570995	.	A	G	3	2	5	0	0	5	0	0
21	36571694	.	T	A	1	3	4	0	0	4	0	0
21	36592164	.	G	A	4	4	8	0	0	8	0	0
21	36592212	.	T	C	3	2	5	0	0	5	0	0
21	36598047	.	T	C	1	1	2	0	0	2	0	0
21	36598143	.	G	A	0	7	7	0	4	11	0	0
21	36598471	.	T	C	8	4	12	0	0	12	0	0
21	36598474	.	C	A	5	8	13	0	0	13	0	0
21	36598529	.	G	T	8	8	16	0	0	16	0	0
21	36598583	.	T	C	7	5	12	0	0	12	0	0
21	36598596	.	A	G	5	4	9	0	0	9	0	0
21	36598853	.	G	A	0	5	5	0	11	16	0	0
21	36598915	.	C	T	2	2	4	1	0	5	0	0
21	36599020	.	A	T	6	13	19	0	0	19	0	0
21	36599077	.	T	C	10	5	15	0	0	15	0	0
21	36599320	.	C	T	4	2	6	0	1	7	0	0
21	36599358	.	A	C	7	4	11	0	0	11	0	0
21	36599847	.	G	A	3	4	7	0	0	7	0	0
21	36599895	.	G	A	0	3	3	0	0	3	0	0
21	36600049	.	G	A	1	5	6	0	0	6	0	0
21	36600174	.	C	A	2	4	6	0	0	6	0	0
21	36612586	.	T	A	2	7	9	0	0	9	0	0
21	36612633	.	T	C	4	7	11	0	0	11	0	0
21	37637792	.	G	A	9	12	21	0	0	21	0	0
21	37637794	.	A	T	9	11	20	0	1	21	0	0
21	37640005	.	G	A	4	7	11	0	1	12	0	0
21	37686849	.	C	T	2	3	5	1	0	6	0	0
21	37686850	.	A	G	2	3	5	1	0	6	0	0
21	37687523	.	G	A	7	8	15	0	0	15	0	0
21	37687590	.	C	T	5	2	7	0	0	7	0	0
21	37687602	.	T	G	4	2	6	0	2	8	0	0
21	37687729	.	C	T	8	4	12	0	1	13	0	0
21	37689192	.	T	G	4	6	10	0	1	11	0	0
21	37689590	.	C	A	5	2	7	0	0	7	0	0
21	37689997	.	T	C	5	0	5	0	4	9	0	0
21	37690002	.	T	C	2	7	9	0	0	9	0	0
21	37690468	.	T	C	4	6	10	0	0	10	0	0
21	37703499	.	G	A	3	4	7	0	0	7	0	0
21	37703502	.	C	T	3	4	7	0	0	7	0	0
21	37733199	.	G	A	4	4	8	0	1	9	0	0
21	37788147	.	G	A	1	0	1	0	0	1	0	0
21	37822681	.	G	A	2	3	5	0	0	5	0	0
21	38013631	.	T	C	2	5	7	0	0	7	0	0
21	38586171	.	G	A	10	3	13	0	2	15	0	0
21	38587378	.	T	C	10	9	19	0	2	21	0	0
21	39569373	.	T	G	7	4	11	0	23	34	0	0
21	39973622	.	G	C	2	2	4	0	1	5	0	0
21	40045441	.	T	C	5	6	11	0	0	11	0	0
21	40045569	.	G	T	8	9	17	0	1	18	0	0
21	40045665	.	G	A	13	14	27	0	1	28	0	0
21	40045701	.	G	A	15	14	29	0	1	30	0	0
21	40045754	.	G	A	2	3	5	0	1	6	0	0
21	40048981	.	C	A	0	2	2	0	1	3	0	0
21	40049524	.	A	G	4	1	5	0	2	7	0	0
21	40049556	.	T	G	7	9	16	0	1	17	0	0
21	40049606	.	T	G	4	8	12	0	1	13	0	0
21	40054456	.	T	C	1	1	2	0	0	2	0	0
21	40119571	.	C	T	2	2	4	0	0	4	0	0
21	40355063	.	A	C	5	7	12	0	0	12	0	0
21	40355102	.	G	A	6	3	9	0	1	10	0	0
21	40355350	.	T	C	0	8	8	0	0	8	0	0
21	40355539	.	G	T	9	7	16	0	1	17	0	0
21	40355710	.	A	T	8	3	11	0	0	11	0	0
21	40355764	.	C	T	7	7	14	0	0	14	0	0
21	40355968	.	T	A	4	7	11	0	1	12	0	0
21	40364758	.	C	A	8	6	14	0	0	14	0	0
21	40365356	.	G	T	5	4	9	0	0	9	0	0
21	40368568	.	A	G	2	1	3	0	0	3	0	0
21	40368991	.	C	T	1	2	3	0	0	3	0	0
21	40369108	.	C	T	0	8	8	0	6	14	0	0
21	40373048	.	G	T	2	3	5	0	3	8	0	0
21	40373049	.	G	T	2	6	8	0	0	8	0	0
21	40373086	.	A	T	7	4	11	0	1	12	0	0
21	40373137	.	C	T	0	7	7	0	6	13	0	0
21	40377655	.	T	C	4	2	6	0	0	6	0	0
21	40377702	.	A	G	2	2	4	0	0	4	0	0
21	40377712	.	C	G	2	2	4	0	0	4	0	0
21	40381967	.	C	T	2	4	6	0	0	6	0	0
21	40382215	.	G	A	1	0	1	0	0	1	0	0
21	40382278	.	C	T	0	3	3	0	2	5	0	0
21	40384140	.	A	G	2	4	6	0	0	6	0	0
21	40386061	.	C	T	1	0	1	0	0	1	0	0
21	40387881	.	A	C	3	2	5	0	0	5	0	0
21	40389761	.	G	T	1	2	3	0	0	3	0	0
21	40391710	.	T	G	0	1	1	0	0	1	0	0
21	40402864	.	C	T	1	7	8	0	6	14	0	0
21	40403423	.	A	G	10	7	17	0	3	20	0	0
21	40403465	.	G	A	8	9	17	0	1	18	0	0
21	40403581	.	G	C	4	5	9	0	0	9	0	0
21	40406796	.	C	A	8	3	11	0	0	11	0	0
21	40411034	.	G	A	6	4	10	0	0	10	0	0
21	40464991	.	T	C	1	2	3	0	0	3	0	0
21	40466893	.	C	T	1	6	7	0	0	7	0	0
21	40467039	.	C	T	2	5	7	0	0	7	0	0
21	40467126	.	G	A	0	3	3	0	10	13	0	0
21	40475127	.	C	G	4	0	4	0	3	7	0	0
21	40475427	.	C	T	4	5	9	0	0	9	0	0
21	40475563	.	C	G	11	6	17	0	1	18	0	0
21	40475579	.	G	T	7	9	16	0	0	16	0	0
21	40528986	.	C	T	16	15	31	0	2	33	0	0
21	40531316	.	C	T	15	14	29	0	1	30	0	0
21	40531615	.	G	A	10	17	27	0	1	28	0	0
21	40531971	.	A	T	4	8	12	0	0	12	0	0
21	40531993	.	G	A	3	9	12	0	0	12	0	0
21	40532147	.	A	G	3	11	14	0	2	16	0	0
21	40532204	.	A	G	3	5	8	0	2	10	0	0
21	40532584	.	T	G	9	7	16	0	0	16	0	0
21	40532848	.	G	A	9	9	18	0	0	18	0	0
21	40532891	.	A	G	8	8	16	0	1	17	0	0
21	40532931	.	G	C	9	7	16	0	1	17	0	0
21	40533039	.	T	C	9	4	13	0	1	14	0	0
21	40533165	.	A	G	6	12	18	0	2	20	0	0
21	40537149	.	C	T	9	7	16	0	3	19	0	0
21	40537152	.	G	A	10	9	19	0	0	19	0	0
21	40537188	.	A	G	15	12	27	0	0	27	0	0
21	40546922	.	T	C	6	11	17	0	0	17	0	0
21	40547729	.	G	A	3	5	8	0	0	8	0	0
21	40553356	.	G	T	1	1	2	0	0	2	0	0
21	40553365	.	C	T	1	0	1	0	0	1	0	0
21	40553547	.	C	T	0	10	10	0	3	13	0	0
21	40553667	.	C	G	0	0	0	0	1	1	0	0
21	40562600	.	G	A	1	1	2	0	1	3	0	0
21	40579746	.	C	A	3	4	7	0	0	7	0	0
21	40598941	.	A	G	0	1	1	0	0	1	0	0
21	40619072	.	G	A	4	2	6	0	0	6	0	0
21	40671742	.	G	A	1	2	3	0	0	3	0	0
21	40675060	.	T	C	0	3	3	0	0	3	0	0
21	40685948	.	A	G	10	0	10	0	8	18	0	0
21	40685964	.	A	C	10	6	16	0	0	16	0	0
21	40686109	.	G	A	7	12	19	0	0	19	0	0
21	40700116	.	A	G	1	1	2	0	0	2	0	0
21	40709140	.	A	T	2	3	5	0	0	5	0	0
21	40714691	.	C	T	13	6	19	0	0	19	0	0
21	40715730	.	T	C	6	4	10	0	1	12	1	0
21	40715808	.	A	G	2	2	4	0	0	4	0	0
21	40731482	.	A	G	0	1	1	0	0	1	0	0
21	40936544	.	G	A	1	1	2	0	0	2	0	0
21	40944590	.	A	C	1	2	3	0	0	3	0	0
21	40944832	.	C	T	4	3	7	0	0	7	0	0
21	40945090	.	T	C	4	2	6	0	0	6	0	0
21	40959280	.	A	T	2	2	4	0	0	4	0	0
21	40959490	.	T	C	1	5	6	0	0	6	0	0
21	40959517	.	C	A	1	2	3	0	0	3	0	0
21	41028902	.	A	G	5	4	9	0	0	9	0	0
21	41029378	.	A	G	6	3	9	0	1	10	0	0
21	41039914	.	T	G	3	1	4	0	0	4	0	0
21	41046647	.	T	A	1	2	3	0	0	3	0	0
21	41046745	.	T	A	3	1	4	0	0	4	0	0
21	41046746	.	G	C	3	1	4	0	0	4	0	0
21	41049005	.	G	A	0	1	1	0	0	1	0	0
21	41049488	.	A	G	1	1	2	0	0	2	0	0
21	41060822	.	C	A	0	0	0	0	1	1	0	0
21	41256821	.	C	T	1	7	8	0	9	17	0	0
21	41257136	.	A	G	26	19	45	0	1	46	0	0
21	41257157	.	C	G	24	18	42	0	0	42	0	0
21	41257228	.	T	G	29	26	55	0	0	55	0	0
21	41257256	.	T	C	27	22	49	0	1	50	0	0
21	41257357	.	G	A	27	32	59	0	1	60	0	0
21	41257374	.	C	T	29	33	62	0	1	63	0	0
21	41257599	.	T	A	23	28	51	0	1	53	1	0
21	41293435	.	G	A	8	13	21	0	2	23	0	0
21	41305128	.	G	T	3	1	4	0	1	5	0	0
21	41305269	.	C	T	2	0	2	0	0	2	0	0
21	41305271	.	C	T	0	1	1	0	1	2	0	0
21	41311605	.	A	G	16	12	28	0	0	28	0	0
21	41311922	.	G	A	10	14	24	0	0	24	0	0
21	41312058	.	A	T	11	9	20	0	1	21	0	0
21	41537124	.	T	C	0	2	2	0	0	2	0	0
21	41598942	.	G	C	12	6	18	0	0	19	1	0
21	41598961	.	T	C	7	2	9	0	7	16	0	0
21	41599060	.	T	C	0	6	6	0	0	6	0	0
21	41599096	.	A	C	16	0	16	0	0	16	0	0
21	41600295	.	T	C	4	0	4	0	3	7	0	0
21	41600360	.	T	C	1	3	4	0	1	5	0	0
21	41600361	.	T	C	3	2	5	0	0	5	0	0
21	41600660	.	T	C	6	4	10	0	1	11	0	0
21	41601151	.	T	C	3	3	6	0	0	6	0	0
21	41743527	.	T	C	3	1	4	0	0	4	0	0
21	41840914	.	C	T	5	2	7	0	0	7	0	0
21	42046969	.	G	A	0	5	5	8	1	14	0	0
21	42777772	.	T	C	4	3	7	0	0	7	0	0
21	42778169	.	T	C	1	2	3	0	0	3	0	0
21	42778937	.	G	A	3	2	5	0	2	7	0	0
21	42948344	.	A	C	2	2	4	0	0	4	0	0
21	42954434	.	A	G	2	5	7	0	0	7	0	0
21	43032261	.	T	G	4	2	6	0	4	10	0	0
21	43354390	.	A	G	1	0	1	0	3	4	0	0
21	43363939	.	A	G	1	0	1	0	0	1	0	0
21	43363957	.	G	C	2	1	3	0	0	3	0	0
21	43366064	.	C	T	0	1	1	0	0	1	0	0
21	43420719	.	T	C	6	2	8	0	0	8	0	0
21	43461398	.	T	C	5	1	6	0	0	6	0	0
21	43476276	.	T	C	7	3	10	0	1	11	0	0
21	43477894	.	T	C	20	8	28	0	0	29	1	0
21	43505699	.	G	A	2	5	7	0	0	7	0	0
21	43505943	.	T	C	3	4	7	0	0	7	0	0
21	43506620	.	A	G	2	5	7	0	1	8	0	0
21	43506675	.	G	C	6	3	9	0	1	10	0	0
21	43506980	.	G	A	4	2	6	0	0	6	0	0
21	43507055	.	A	G	3	3	6	0	0	6	0	0
21	43507058	.	C	T	2	3	5	0	1	6	0	0
21	43507114	.	T	G	3	3	6	0	0	6	0	0
21	43507873	.	A	G	4	2	6	0	0	6	0	0
21	43515778	.	A	T	2	3	5	0	1	6	0	0
21	43524271	.	G	A	9	8	17	0	0	17	0	0
21	43524778	.	T	C	12	10	22	0	1	23	0	0
21	43525429	.	T	C	1	5	6	0	2	8	0	0
21	43525522	.	A	G	5	5	10	0	0	10	0	0
21	43525618	.	T	G	5	13	18	0	1	19	0	0
21	43525861	.	G	A	6	5	11	0	0	11	0	0
21	43525909	.	C	T	0	4	4	0	2	6	0	0
21	43525978	.	G	A	4	3	7	0	0	7	0	0
21	43526371	.	G	A	6	5	11	0	0	11	0	0
21	43526434	.	G	C	1	6	7	0	0	7	0	0
21	43526740	.	C	T	4	4	8	0	0	8	0	0
21	43536532	.	A	G	8	6	14	0	1	15	0	0
21	43536592	.	G	A	5	6	11	0	0	11	0	0
21	43537073	.	C	T	0	2	2	0	1	3	0	0
21	43537082	.	G	A	2	4	6	0	0	6	0	0
21	43539461	.	G	C	7	0	7	0	11	18	0	0
21	43540090	.	G	T	5	11	16	0	0	16	0	0
21	43540358	.	T	C	3	0	3	0	5	8	0	0
21	43540412	.	G	C	3	0	3	0	6	9	0	0
21	43562012	.	C	T	2	2	4	0	0	4	0	0
21	43562237	.	G	T	1	2	3	0	0	3	0	0
21	43562588	.	G	T	0	2	2	0	1	3	0	0
21	43562601	.	G	A	0	2	2	0	1	3	0	0
21	43581478	.	A	G	15	12	27	0	1	28	0	0
21	43581505	.	T	C	15	0	15	0	10	25	0	0
21	43581606	.	A	G	17	12	29	0	2	31	0	0
21	43584745	.	G	A	19	11	30	0	2	32	0	0
21	43584822	.	A	G	10	20	30	0	4	34	0	0
21	43586774	.	C	T	0	9	9	0	20	29	0	0
21	43588112	.	T	C	5	8	13	0	0	13	0	0
21	43588136	.	G	C	2	0	2	0	1	3	0	0
21	43595318	.	G	A	11	12	23	0	1	24	0	0
21	43595384	.	C	T	5	3	8	0	0	8	0	0
21	43606392	.	T	A	4	0	4	0	0	4	0	0
21	43688783	.	G	A	5	2	7	0	0	7	0	0
21	43688806	.	C	T	5	4	9	0	0	9	0	0
21	43695692	.	G	A	5	2	7	0	0	7	0	0
21	43695787	.	A	G	2	0	2	0	2	4	0	0
21	43704161	.	T	C	0	2	2	0	0	2	0	0
21	43705848	.	G	A	0	2	2	0	7	9	0	0
21	43705866	.	G	A	5	2	7	0	0	7	0	0
21	43705893	.	C	T	2	1	3	0	1	4	0	0
21	43709743	.	T	C	0	1	1	0	0	1	0	0
21	43710834	.	A	C	3	3	6	0	0	6	0	0
21	43710842	.	A	G	3	0	3	0	2	5	0	0
21	43739016	.	G	A	6	4	10	0	0	10	0	0
21	43755096	.	A	G	1	2	3	0	0	3	0	0
21	43755105	.	A	G	1	2	3	0	0	3	0	0
21	43785445	.	G	A	1	1	2	0	0	2	0	0
21	43886134	.	T	G	1	0	1	0	0	1	0	0
21	43897365	.	C	T	17	27	44	0	4	48	0	0
21	43900196	.	T	C	25	18	43	0	0	43	0	0
21	43920541	.	A	G	2	4	6	0	0	6	0	0
21	43926773	.	C	A	1	0	1	0	0	1	0	0
21	43952949	.	G	T	8	10	18	0	0	18	0	0
21	44005548	.	G	A	5	6	11	0	0	11	0	0
21	44005583	.	G	A	11	17	28	0	0	28	0	0
21	44005587	.	A	C	12	18	30	0	1	31	0	0
21	44005637	.	T	G	10	11	21	0	0	21	0	0
21	44022008	.	T	A	21	24	45	0	1	46	0	0
21	44022014	.	A	G	20	23	43	0	3	46	0	0
21	44025907	.	A	G	21	24	45	0	0	45	0	0
21	44028691	.	G	A	14	20	34	0	0	34	0	0
21	44028755	.	C	A	11	18	29	0	3	33	1	0
21	44031139	.	T	C	5	1	6	0	1	7	0	0
21	44031145	.	T	A	5	2	7	0	0	7	0	0
21	44036872	.	A	T	6	6	12	0	1	13	0	0
21	44036912	.	A	C	6	12	18	0	0	18	0	0
21	44036984	.	T	A	8	9	17	0	0	17	0	0
21	44037011	.	T	A	7	7	14	0	2	16	0	0
21	44037040	.	G	A	0	3	3	0	6	9	0	0
21	44037046	.	A	G	6	0	6	0	3	9	0	0
21	44300766	.	A	G	1	2	3	0	0	3	0	0
21	44553806	.	A	G	1	2	3	0	0	3	0	0
21	44558693	.	C	T	2	1	3	0	1	4	0	0
21	44558697	.	T	C	2	1	3	0	0	3	0	0
21	44558898	.	T	C	13	3	16	0	13	29	0	0
21	44559095	.	C	T	18	18	36	0	1	37	0	0
21	44561900	.	A	G	1	2	3	0	0	3	0	0
21	44563129	.	T	A	10	6	16	0	0	16	0	0
21	44581845	.	A	T	3	2	5	0	0	5	0	0
21	44581947	.	C	T	1	2	3	0	0	3	0	0
21	44581948	.	C	A	1	2	3	0	0	3	0	0
21	44687941	.	A	G	14	1	15	0	14	29	0	0
21	44687949	.	T	C	15	10	25	0	1	26	0	0
21	44688711	.	G	A	7	13	20	0	1	21	0	0
21	44689277	.	A	T	10	11	21	0	2	23	0	0
21	44689476	.	C	T	11	8	19	0	0	19	0	0
21	44689503	.	A	T	13	9	22	0	1	23	0	0
21	44689528	.	A	G	17	0	17	0	6	23	0	0
21	44689655	.	C	T	12	5	17	0	0	17	0	0
21	44690520	.	A	G	11	0	11	0	7	18	0	0
21	44777617	.	G	T	0	1	1	0	1	2	0	0
21	44777713	.	T	C	2	3	5	0	0	5	0	0
21	44781745	.	A	G	4	6	10	0	4	14	0	0
21	44784156	.	A	G	7	0	7	0	8	15	0	0
21	44784223	.	A	G	8	0	8	0	17	25	0	0
21	44784493	.	G	T	7	6	13	0	1	14	0	0
21	44784589	.	T	C	8	4	12	0	0	12	0	0
21	44784663	.	C	T	3	6	9	0	0	9	0	0
21	44868607	.	G	A	1	1	2	0	0	2	0	0
21	44933461	.	G	T	0	3	3	0	3	6	0	0
21	45043548	.	G	A	2	3	5	0	1	6	0	0
21	45043590	.	T	C	5	0	5	0	4	9	0	0
21	45043611	.	A	G	5	2	7	0	0	7	0	0
21	45052584	.	G	A	7	5	12	0	0	12	0	0
21	45058331	.	T	G	5	6	11	0	1	12	0	0
21	45059466	.	T	A	2	6	8	0	0	8	0	0
21	45061877	.	G	T	3	3	6	0	0	6	0	0
21	45061889	.	G	A	3	3	6	0	0	6	0	0
21	45068223	.	T	C	5	2	7	0	0	7	0	0
21	45068478	.	A	G	2	2	4	0	0	4	0	0
21	45107329	.	G	A	0	2	2	0	0	2	0	0
21	45114489	.	G	T	0	1	1	0	4	5	0	0
21	45114657	.	A	G	5	0	5	0	4	9	0	0
21	45117537	.	C	T	6	2	8	0	0	8	0	0
21	45182311	.	A	T	6	9	15	0	2	17	0	0
21	45182345	.	A	G	4	7	11	0	1	12	0	0
21	45182566	.	C	T	5	7	12	0	1	13	0	0
21	45182687	.	T	C	7	3	10	0	0	10	0	0
21	45185829	.	A	G	2	1	3	0	1	4	0	0
21	45187123	.	C	T	10	10	20	0	0	20	0	0
21	45187248	.	A	G	5	1	6	0	0	6	0	0
21	45187258	.	G	A	2	0	2	0	0	2	0	0
21	45190704	.	A	G	23	25	48	0	2	50	0	0
21	45190709	.	T	A	24	24	48	0	2	50	0	0
21	45190754	.	C	T	1	21	22	0	33	55	0	0
21	45190766	.	T	A	31	23	54	0	1	56	1	0
21	45190861	.	A	T	32	26	58	0	0	58	0	0
21	45190884	.	G	A	29	22	51	0	2	53	0	0
21	45190975	.	C	T	21	30	51	0	1	52	0	0
21	45190984	.	T	C	21	30	51	0	2	53	0	0
21	45191163	.	A	T	31	39	70	0	2	73	1	0
21	45193260	.	A	G	20	16	36	0	0	36	0	0
21	45198712	.	C	T	2	10	12	0	19	31	0	0
21	45341958	.	A	T	22	32	54	0	1	55	0	0
21	45342043	.	G	T	31	30	61	0	1	62	0	0
21	45349469	.	G	A	4	5	9	0	0	9	0	0
21	45356811	.	T	G	8	7	15	0	0	15	0	0
21	45366268	.	C	T	7	7	14	0	1	15	0	0
21	45374439	.	C	T	4	10	14	0	0	14	0	0
21	45374475	.	A	G	13	4	17	0	0	17	0	0
21	45374478	.	A	G	13	3	16	0	1	17	0	0
21	45374583	.	A	T	1	3	4	0	0	4	0	0
21	45374725	.	G	A	6	5	11	0	0	11	0	0
21	45374749	.	C	G	7	5	12	0	1	13	0	0
21	45375144	.	G	A	3	3	6	0	0	6	0	0
21	45377546	.	G	A	11	9	20	0	2	22	0	0
21	45377685	.	G	A	14	6	20	0	4	24	0	0
21	45382032	.	G	A	23	18	41	0	1	42	0	0
21	45386175	.	C	T	6	4	10	0	0	10	0	0
21	45393642	.	T	C	0	1	1	0	0	1	0	0
21	45398081	.	G	C	2	6	8	0	0	8	0	0
21	45398178	.	T	C	1	2	3	0	0	3	0	0
21	45410019	.	G	A	0	7	7	0	2	9	0	0
21	45410589	.	G	A	2	2	4	0	0	4	0	0
21	45410601	.	G	A	2	3	5	0	0	5	0	0
21	45510529	.	G	A	1	2	3	0	0	3	0	0
21	45535881	.	A	G	0	2	2	0	0	2	0	0
21	45542246	.	A	G	1	0	1	0	1	2	0	0
21	45544108	.	C	T	7	4	11	0	0	11	0	0
21	45544384	.	A	G	4	1	5	0	8	13	0	0
21	45544615	.	T	A	2	7	9	0	0	9	0	0
21	45544616	.	G	A	2	7	9	0	0	9	0	0
21	45544709	.	A	G	4	3	7	0	0	7	0	0
21	45547147	.	C	T	5	5	10	0	1	11	0	0
21	45549075	.	A	G	3	2	5	0	0	5	0	0
21	45550004	.	C	A	2	2	4	0	1	5	0	0
21	45550066	.	G	A	0	9	9	0	5	14	0	0
21	45550122	.	A	G	4	0	4	0	9	13	0	0
21	45550244	.	C	G	2	7	9	0	0	9	0	0
21	45550354	.	C	T	3	3	6	0	0	6	0	0
21	45550450	.	C	T	2	2	4	0	0	4	0	0
21	45550454	.	G	C	2	3	5	0	0	5	0	0
21	45550527	.	C	G	4	2	6	0	0	6	0	0
21	45550734	.	T	C	5	3	8	0	0	8	0	0
21	45550736	.	C	T	5	3	8	0	0	8	0	0
21	45550928	.	A	T	3	5	8	0	0	8	0	0
21	45551011	.	T	A	2	6	8	0	0	8	0	0
21	45551014	.	T	C	2	5	7	0	0	7	0	0
21	45551095	.	A	C	6	7	13	0	1	14	0	0
21	45551096	.	G	A	7	7	14	0	0	14	0	0
21	45551386	.	G	C	1	3	4	0	0	4	0	0
21	45551391	.	A	G	1	5	6	0	0	6	0	0
21	45551421	.	T	C	2	4	6	0	0	6	0	0
21	45551606	.	T	A	4	4	8	0	0	8	0	0
21	45551620	.	C	T	3	3	6	0	0	6	0	0
21	45551653	.	A	G	4	3	7	0	0	7	0	0
21	45551785	.	G	A	2	5	7	0	1	8	0	0
21	45551845	.	C	T	8	8	16	0	0	16	0	0
21	45551972	.	G	A	0	7	7	0	8	15	0	0
21	45552187	.	T	C	4	7	11	0	0	11	0	0
21	45552282	.	T	C	7	7	14	0	2	16	0	0
21	45552286	.	C	T	7	9	16	0	0	16	0	0
21	45552676	.	G	A	12	6	18	0	1	19	0	0
21	45552924	.	C	T	4	7	11	0	0	11	0	0
21	45582048	.	T	C	13	16	29	0	5	34	0	0
21	45582907	.	A	G	11	4	15	0	0	15	0	0
21	45582931	.	G	A	6	2	8	0	0	8	0	0
21	45584817	.	C	T	4	1	5	0	1	6	0	0
21	45586600	.	A	G	2	4	6	0	1	7	0	0
21	45591105	.	A	G	9	8	17	0	0	17	0	0
21	45597559	.	A	T	3	0	3	0	0	3	0	0
21	45598671	.	G	A	6	2	8	0	0	8	0	0
21	45599059	.	G	A	0	1	1	0	0	1	0	0
21	45599335	.	C	G	3	3	6	0	0	6	0	0
21	45599379	.	G	A	5	4	9	0	0	9	0	0
21	45599413	.	G	A	2	1	3	0	0	3	0	0
21	45628374	.	G	A	0	4	4	0	2	6	0	0
21	45628486	.	C	A	3	1	4	0	0	4	0	0
21	45632866	.	T	C	4	4	8	0	1	9	0	0
21	45673667	.	T	A	18	13	31	0	2	33	0	0
21	45673826	.	G	A	13	14	27	0	2	29	0	0
21	45674321	.	T	C	9	23	32	0	5	37	0	0
21	45688148	.	G	A	6	5	11	0	2	13	0	0
21	45692948	.	A	G	4	2	6	0	0	6	0	0
21	45693023	.	A	G	2	0	2	0	2	4	0	0
21	45694166	.	C	T	5	3	8	0	0	8	0	0
21	45696135	.	C	T	4	3	7	0	0	7	0	0
21	45696164	.	G	A	0	3	3	0	5	8	0	0
21	45704975	.	C	T	2	2	4	0	0	4	0	0
21	45704999	.	C	T	1	1	2	0	0	2	0	0
21	45705267	.	T	C	5	8	13	0	0	13	0	0
21	45705276	.	T	C	6	10	16	0	0	16	0	0
21	45705375	.	A	G	3	2	5	0	0	5	0	0
21	45705948	.	T	C	2	0	2	0	0	2	0	0
21	45707154	.	T	C	1	0	1	0	1	2	0	0
21	45707734	.	T	C	1	0	1	0	1	2	0	0
21	45714390	.	T	C	8	12	20	0	0	20	0	0
21	45715241	.	T	C	25	15	40	0	0	40	0	0
21	45715271	.	G	A	11	6	17	0	24	41	0	0
21	45715558	.	G	C	12	3	15	0	1	16	0	0
21	45719205	.	T	G	9	0	9	0	16	25	0	0
21	45721245	.	T	C	9	10	19	0	0	19	0	0
21	45721246	.	C	G	7	0	7	0	12	19	0	0
21	45721760	.	G	A	4	9	13	0	0	13	0	0
21	45723174	.	G	C	2	0	2	0	0	2	0	0
21	45726391	.	C	T	0	2	2	0	0	2	0	0
21	45726600	.	C	T	4	4	8	0	0	8	0	0
21	45728723	.	T	G	8	11	19	0	0	19	0	0
21	45728774	.	T	C	6	6	12	0	1	13	0	0
21	45729365	.	C	G	6	5	11	0	1	12	0	0
21	45730150	.	G	C	20	21	41	0	0	41	0	0
21	45732018	.	C	G	8	8	16	0	0	16	0	0
21	45733905	.	C	T	15	14	29	0	0	29	0	0
21	45734044	.	T	C	0	2	2	0	0	2	0	0
21	45735918	.	G	A	0	6	6	0	3	9	0	0
21	45736157	.	T	G	13	0	13	0	13	26	0	0
21	45736179	.	T	C	13	11	24	0	1	25	0	0
21	45736244	.	T	C	19	15	34	0	2	36	0	0
21	45736463	.	T	A	15	11	26	0	0	26	0	0
21	45737829	.	C	A	15	7	22	0	2	24	0	0
21	45737960	.	T	G	6	9	15	0	0	15	0	0
21	45738043	.	T	C	6	6	12	0	1	13	0	0
21	45738046	.	T	C	7	6	13	0	0	13	0	0
21	45738125	.	C	T	4	11	15	0	1	16	0	0
21	45738525	.	G	A	1	9	10	0	22	32	0	0
21	45738592	.	T	C	10	9	19	0	0	19	0	0
21	45738775	.	A	G	16	5	21	0	1	22	0	0
21	45738852	.	G	A	13	14	27	0	2	29	0	0
21	45738856	.	C	T	14	15	29	0	1	30	0	0
21	45738945	.	A	G	8	0	8	0	17	25	0	0
21	45739074	.	A	C	11	11	22	0	0	22	0	0
21	45739087	.	A	C	12	10	22	0	0	22	0	0
21	45739125	.	A	G	14	8	22	0	1	23	0	0
21	45739139	.	C	T	12	6	18	0	0	18	0	0
21	45739169	.	T	A	11	6	17	0	0	17	0	0
21	45739235	.	T	C	9	8	17	0	4	21	0	0
21	45739418	.	C	G	16	3	19	0	0	19	0	0
21	45739519	.	C	G	16	6	22	0	0	22	0	0
21	45739613	.	A	T	15	11	26	0	1	27	0	0
21	45739642	.	G	A	0	13	13	0	17	30	0	0
21	45739724	.	A	T	26	12	38	0	0	38	0	0
21	45758525	.	T	A	1	4	5	0	0	5	0	0
21	45760767	.	G	A	0	1	1	0	1	2	0	0
21	45761690	.	A	T	1	1	2	0	0	2	0	0
21	45765889	.	C	T	4	1	5	0	1	6	0	0
21	45767470	.	C	A	3	3	6	0	1	7	0	0
21	45767676	.	A	T	3	3	6	0	0	6	0	0
21	45767716	.	C	A	1	2	3	0	2	5	0	0
21	45767848	.	T	A	4	4	8	0	0	8	0	0
21	45767884	.	T	C	3	5	8	0	0	8	0	0
21	45767920	.	G	A	0	3	3	0	2	5	0	0
21	45767965	.	A	T	4	3	7	0	0	7	0	0
21	45768031	.	G	A	0	8	8	0	5	13	0	0
21	45768043	.	T	C	6	8	14	0	1	15	0	0
21	45768114	.	G	C	4	3	7	0	0	7	0	0
21	45768220	.	A	G	2	4	6	0	0	6	0	0
21	45768260	.	T	A	4	7	11	0	0	11	0	0
21	45768317	.	A	C	4	6	10	0	0	10	0	0
21	45768462	.	A	G	6	8	14	0	0	14	0	0
21	45768597	.	G	C	4	3	7	0	0	7	0	0
21	45768892	.	A	T	3	3	6	0	0	6	0	0
21	45769130	.	C	G	10	11	21	0	0	21	0	0
21	45769199	.	C	A	11	12	23	0	0	23	0	0
21	45769379	.	T	G	1	2	3	0	0	3	0	0
21	45769394	.	G	T	0	2	2	0	1	3	0	0
21	45838304	.	C	T	19	18	37	0	2	39	0	0
21	45839258	.	A	G	11	14	25	0	1	26	0	0
21	45840307	.	C	A	0	8	8	0	6	14	0	0
21	45840317	.	G	T	5	8	13	0	1	14	0	0
21	45850905	.	G	A	0	7	7	0	8	15	0	0
21	45851180	.	T	C	3	6	9	0	1	10	0	0
21	45851493	.	A	T	12	4	16	0	3	19	0	0
21	45851496	.	A	C	13	5	18	0	1	19	0	0
21	45851563	.	A	C	18	14	32	0	2	34	0	0
21	45856614	.	G	A	3	3	6	0	0	6	0	0
21	45857425	.	G	A	0	1	1	0	1	2	0	0
21	45857954	.	T	G	7	15	22	0	0	22	0	0
21	45859589	.	C	T	4	7	11	0	0	11	0	0
21	45860602	.	A	G	0	1	1	0	0	1	0	0
21	45863053	.	G	A	8	9	17	0	1	18	0	0
21	45865174	.	C	T	13	11	24	0	1	25	0	0
21	45866065	.	G	A	8	7	15	0	1	16	0	0
21	45866066	.	G	A	8	8	16	0	0	16	0	0
21	45875861	.	C	T	0	4	4	0	3	7	0	0
21	45875870	.	A	T	3	4	7	0	1	8	0	0
21	45876230	.	T	C	5	9	14	0	0	14	0	0
21	45876253	.	A	T	5	8	13	0	1	14	0	0
21	45876638	.	A	G	12	0	12	0	6	38	20	0
21	45876642	.	C	A	0	19	19	0	18	37	0	0
21	45884210	.	A	G	2	3	5	0	0	5	0	0
21	45905088	.	T	C	14	6	20	0	0	20	0	0
21	45905257	.	C	G	5	9	14	0	2	16	0	0
21	45914107	.	C	A	0	1	1	0	0	1	0	0
21	45914182	.	A	G	3	3	6	0	0	6	0	0
21	45916436	.	C	T	2	3	5	0	1	6	0	0
21	45919139	.	G	T	3	2	5	0	0	5	0	0
21	45919290	.	C	T	4	2	6	0	0	6	0	0
22	6910	.	A	G	0	1	1	0	0	1	0	0
22	11433	.	T	C	3	6	9	0	0	9	0	0
22	13985	.	C	T	13	8	21	0	1	22	0	0
22	13988	.	C	T	13	10	23	0	2	25	0	0
22	14278	.	C	T	21	12	33	0	2	35	0	0
22	15785	.	T	C	34	24	58	0	4	62	0	0
22	15819	.	T	C	37	26	63	0	3	66	0	0
22	15855	.	A	G	32	1	33	0	30	63	0	0
22	15860	.	C	G	36	26	62	0	1	63	0	0
22	15950	.	A	G	15	1	16	0	21	37	0	0
22	16047	.	G	A	12	19	31	0	0	31	0	0
22	16297	.	C	G	4	5	9	0	0	9	0	0
22	16538	.	A	G	5	0	5	0	4	9	0	0
22	23325	.	C	T	5	3	8	0	0	8	0	0
22	23380	.	C	A	3	4	7	0	0	7	0	0
22	23417	.	C	T	2	4	6	0	0	6	0	0
22	23706	.	A	T	6	6	12	0	0	12	0	0
22	23842	.	A	C	5	3	8	0	0	8	0	0
22	23916	.	A	T	4	6	10	0	1	11	0	0
22	24117	.	C	T	5	6	11	0	1	12	0	0
22	24143	.	A	G	3	5	8	0	0	8	0	0
22	44474	.	T	C	2	2	4	0	0	4	0	0
22	44508	.	A	C	3	4	7	0	0	7	0	0
22	44529	.	G	A	3	3	6	0	0	6	0	0
22	44826	.	A	T	4	8	12	0	0	12	0	0
22	46012	.	T	A	3	2	5	0	1	6	0	0
22	46968	.	G	A	4	2	6	0	0	6	0	0
22	46997	.	T	C	3	4	7	0	2	9	0	0
22	47177	.	G	A	7	5	12	0	0	12	0	0
22	88379	.	A	G	1	2	3	0	0	3	0	0
22	90083	.	A	C	8	7	15	0	1	16	0	0
22	90084	.	C	A	0	8	8	0	8	16	0	0
22	90134	.	C	G	9	7	16	1	1	18	0	0
22	94323	.	C	A	6	7	13	0	0	13	0	0
22	94699	.	A	G	8	0	8	0	9	17	0	0
22	94817	.	A	C	3	3	6	0	0	6	0	0
22	96200	.	C	T	3	4	7	0	0	7	0	0
22	96852	.	T	C	3	2	5	0	0	5	0	0
22	96959	.	T	C	12	10	22	0	2	24	0	0
22	97280	.	T	G	2	0	2	0	7	9	0	0
22	97325	.	T	G	5	0	5	0	4	9	0	0
22	97346	.	G	T	0	2	2	0	4	6	0	0
22	97438	.	C	A	2	3	5	0	0	5	0	0
22	97565	.	A	G	3	8	11	0	3	14	0	0
22	98523	.	A	G	1	4	5	0	0	5	0	0
22	101661	.	C	T	2	1	3	0	0	3	0	0
22	105466	.	C	A	9	7	16	0	2	18	0	0
22	105548	.	T	G	5	0	5	0	4	9	0	0
22	105584	.	G	A	0	2	2	0	2	4	0	0
22	106007	.	T	C	0	4	4	0	0	4	0	0
22	107916	.	G	A	0	4	4	0	1	5	0	0
22	108003	.	G	A	2	6	8	0	0	8	0	0
22	108186	.	A	G	1	0	1	0	0	1	0	0
22	110280	.	A	G	3	4	7	0	0	7	0	0
22	133647	.	T	C	4	0	4	0	3	7	0	0
22	134008	.	C	T	0	12	12	0	13	25	0	0
22	134272	.	T	C	20	18	38	0	0	38	0	0
22	134353	.	T	C	9	11	20	0	1	21	0	0
22	134563	.	T	C	13	0	13	0	12	25	0	0
22	134848	.	C	A	11	10	21	0	0	21	0	0
22	134950	.	G	A	11	11	22	0	0	22	0	0
22	135045	.	C	T	11	7	18	0	0	18	0	0
22	135214	.	C	A	0	7	7	0	14	21	0	0
22	135678	.	T	C	5	2	7	0	1	8	0	0
22	135684	.	A	G	4	5	9	0	0	9	0	0
22	136183	.	T	A	5	10	15	0	1	16	0	0
22	136552	.	C	A	0	5	5	0	2	7	0	0
22	136704	.	C	A	2	3	5	0	0	5	0	0
22	136858	.	C	A	0	4	4	0	3	7	0	0
22	137259	.	T	C	3	7	10	0	1	11	0	0
22	137434	.	T	C	3	0	3	0	6	9	0	0
22	137662	.	C	T	0	3	3	0	7	10	0	0
22	137786	.	G	A	5	5	10	0	1	11	0	0
22	138193	.	A	T	5	2	7	0	0	7	0	0
22	138198	.	T	A	3	1	4	0	1	5	0	0
22	138339	.	C	A	0	5	5	0	5	10	0	0
22	138457	.	C	T	1	2	3	0	0	3	0	0
22	138505	.	G	A	2	3	5	0	0	5	0	0
22	138517	.	G	A	1	3	4	0	0	4	0	0
22	138684	.	A	G	5	7	12	0	0	12	0	0
22	138791	.	C	T	5	2	7	0	0	7	0	0
22	139069	.	G	A	5	2	7	0	0	7	0	0
22	139088	.	G	C	5	3	8	0	0	8	0	0
22	139139	.	C	T	3	5	8	0	0	8	0	0
22	139264	.	G	A	2	2	4	0	0	4	0	0
22	139396	.	T	A	3	5	8	0	0	8	0	0
22	139474	.	G	A	6	6	12	0	1	13	0	0
22	139538	.	G	A	5	2	7	0	1	8	0	0
22	139562	.	G	A	4	2	6	0	2	9	1	0
22	139702	.	C	T	6	6	12	0	1	13	0	0
22	139900	.	A	G	3	7	10	0	1	11	0	0
22	140080	.	G	A	2	3	5	0	0	5	0	0
22	140161	.	T	G	5	6	11	0	1	12	0	0
22	144801	.	T	C	0	2	2	0	0	2	0	0
22	144855	.	G	T	2	1	3	0	0	3	0	0
22	144869	.	T	G	2	1	3	0	0	3	0	0
22	147499	.	A	C	2	1	3	0	0	3	0	0
22	147505	.	A	G	1	1	2	0	0	2	0	0
22	158468	.	A	T	2	2	4	0	1	5	0	0
22	158472	.	T	A	1	3	4	0	0	4	0	0
22	188043	.	C	T	2	2	4	0	0	4	0	0
22	192443	.	G	A	16	16	32	0	2	34	0	0
22	192754	.	A	G	11	12	23	0	0	23	0	0
22	192953	.	A	G	15	7	22	0	2	24	0	0
22	193193	.	A	C	2	0	2	0	6	8	0	0
22	336378	.	A	G	3	0	3	0	4	7	0	0
22	336982	.	C	T	23	18	41	0	0	41	0	0
22	337063	.	A	G	22	15	37	0	3	40	0	0
22	337121	.	A	C	2	2	4	0	22	26	0	0
22	337127	.	A	C	2	0	2	0	26	28	0	0
22	337457	.	T	C	15	16	31	0	3	34	0	0
22	337540	.	A	T	16	20	36	0	0	36	0	0
22	337632	.	T	C	16	22	38	0	0	38	0	0
22	337705	.	C	T	29	11	40	0	2	42	0	0
22	337752	.	A	T	11	11	22	0	0	22	0	0
22	337918	.	G	T	7	6	13	0	1	14	0	0
22	337970	.	C	G	12	8	20	0	1	21	0	0
22	342167	.	A	G	1	2	3	0	0	3	0	0
22	344977	.	T	G	1	5	6	0	1	7	0	0
22	345794	.	C	G	11	7	18	0	0	18	0	0
22	349378	.	G	A	20	21	41	0	3	44	0	0
22	354076	.	G	C	13	6	19	0	2	21	0	0
22	354269	.	T	C	14	7	21	0	1	22	0	0
22	354272	.	C	T	14	8	22	0	0	22	0	0
22	354466	.	C	T	11	14	25	0	4	29	0	0
22	354509	.	T	G	7	16	23	0	0	23	0	0
22	360302	.	A	G	8	3	11	0	1	12	0	0
22	367517	.	A	G	27	7	34	0	2	36	0	0
22	371121	.	T	G	11	12	23	0	0	23	0	0
22	371141	.	G	C	15	9	24	0	2	26	0	0
22	371689	.	C	T	15	15	30	0	5	35	0	0
22	371926	.	C	T	1	7	8	0	18	26	0	0
22	371933	.	T	C	18	0	18	0	7	25	0	0
22	404666	.	T	C	2	5	7	0	0	7	0	0
22	405177	.	T	C	6	4	10	0	0	10	0	0
22	415091	.	T	C	1	2	3	0	0	3	0	0
22	415258	.	G	A	4	3	7	0	0	7	0	0
22	415789	.	A	T	1	3	4	0	0	4	0	0
22	415828	.	T	C	2	2	4	0	0	4	0	0
22	415832	.	T	G	2	0	2	0	2	4	0	0
22	426122	.	A	G	2	3	5	0	0	5	0	0
22	426243	.	C	T	4	3	7	0	0	7	0	0
22	431242	.	C	T	1	2	3	0	1	4	0	0
22	443622	.	T	C	5	2	7	0	0	7	0	0
22	445769	.	G	A	1	2	3	0	0	3	0	0
22	446686	.	G	C	0	1	1	0	2	3	0	0
22	446716	.	G	T	0	4	4	0	2	6	0	0
22	446809	.	T	C	1	3	4	0	0	4	0	0
22	447384	.	T	C	1	1	2	0	0	2	0	0
22	448604	.	C	T	1	2	3	0	0	3	0	0
22	448643	.	G	A	0	2	2	0	3	5	0	0
22	448644	.	C	A	3	2	5	0	0	5	0	0
22	451371	.	T	C	2	0	2	0	0	2	0	0
22	451533	.	G	A	0	0	0	0	1	1	0	0
22	452694	.	T	G	8	5	13	0	1	14	0	0
22	452748	.	A	G	9	0	9	0	5	14	0	0
22	452776	.	A	G	6	1	7	0	4	11	0	0
22	452784	.	A	G	5	6	11	0	1	12	0	0
22	453137	.	G	A	3	2	5	0	0	5	0	0
22	453170	.	C	A	2	2	4	0	0	4	0	0
22	461258	.	T	C	0	2	2	0	0	2	0	0
22	461502	.	G	A	0	4	4	0	3	7	0	0
22	465609	.	A	G	3	0	3	0	5	8	0	0
22	468088	.	T	C	2	5	7	0	6	13	0	0
22	473607	.	A	G	18	28	46	0	0	46	0	0
22	474787	.	C	A	0	6	6	0	5	11	0	0
22	479703	.	C	T	0	9	9	0	8	17	0	0
22	479754	.	C	T	10	13	23	0	1	24	0	0
22	481670	.	A	G	3	3	6	0	1	7	0	0
22	483593	.	G	T	9	17	26	0	0	26	0	0
22	483841	.	C	T	1	2	3	0	0	3	0	0
22	485328	.	A	C	9	0	9	0	8	17	0	0
22	485352	.	G	A	17	7	24	0	1	25	0	0
22	486713	.	C	T	13	12	25	0	1	26	0	0
22	489566	.	T	C	10	14	24	0	0	24	0	0
22	489694	.	G	T	10	9	19	0	0	19	0	0
22	534484	.	A	G	2	2	4	0	0	4	0	0
22	534492	.	C	T	2	1	3	0	0	3	0	0
22	535020	.	T	A	4	2	6	0	0	6	0	0
22	535110	.	G	A	5	4	9	0	0	9	0	0
22	535154	.	C	T	3	2	5	0	0	5	0	0
22	551166	.	C	T	0	8	8	0	12	20	0	0
22	551262	.	A	G	6	2	8	0	0	8	0	0
22	552169	.	T	C	4	0	4	0	4	8	0	0
22	554411	.	T	C	10	0	10	0	12	22	0	0
22	555234	.	C	T	6	14	20	0	0	20	0	0
22	557733	.	G	A	17	11	28	0	0	28	0	0
22	557770	.	C	T	0	12	12	0	14	26	0	0
22	557886	.	G	A	16	8	24	0	2	26	0	0
22	563826	.	G	A	0	2	2	0	1	3	0	0
22	564097	.	G	A	1	2	3	0	0	3	0	0
22	569840	.	C	G	2	2	4	0	0	4	0	0
22	581775	.	T	C	1	2	3	0	0	3	0	0
22	582412	.	C	T	1	2	3	0	0	3	0	0
22	582438	.	C	A	2	4	6	0	0	6	0	0
22	582525	.	A	C	1	9	10	0	0	10	0	0
22	583118	.	A	G	3	2	5	0	0	5	0	0
22	583141	.	A	G	3	0	3	0	4	7	0	0
22	583178	.	A	G	5	0	5	0	3	8	0	0
22	583223	.	A	G	5	0	5	0	2	7	0	0
22	583295	.	T	C	4	2	6	0	0	6	0	0
22	583343	.	A	G	9	3	12	0	0	12	0	0
22	583421	.	C	T	1	2	3	0	0	3	0	0
22	583538	.	A	C	5	3	8	0	0	8	0	0
22	591851	.	A	T	7	11	18	0	1	19	0	0
22	591937	.	A	G	16	18	34	0	0	34	0	0
22	591942	.	G	T	16	17	33	0	1	34	0	0
22	592029	.	A	G	11	13	24	0	0	24	0	0
22	592069	.	G	A	12	19	31	0	2	33	0	0
22	592107	.	T	A	11	13	24	0	1	25	0	0
22	593071	.	A	G	8	2	10	0	0	10	0	0
22	593708	.	C	T	6	4	10	0	0	10	0	0
22	593819	.	C	A	18	14	32	0	3	35	0	0
22	593828	.	G	A	20	15	35	0	0	35	0	0
22	593903	.	T	C	9	0	9	0	21	30	0	0
22	599951	.	A	T	13	17	30	0	4	34	0	0
22	613352	.	G	A	23	12	35	0	3	38	0	0
22	613355	.	C	G	24	15	39	0	0	39	0	0
22	613433	.	C	T	3	21	24	0	21	45	0	0
22	613572	.	T	A	37	8	45	0	2	47	0	0
22	613591	.	C	A	1	10	11	0	24	35	0	0
22	616076	.	T	G	9	4	13	0	0	13	0	0
22	617692	.	G	A	3	2	5	0	0	5	0	0
22	618149	.	G	A	16	11	27	0	2	29	0	0
22	635832	.	C	G	3	3	6	0	0	6	0	0
22	637508	.	C	A	2	2	4	0	0	4	0	0
22	637517	.	G	C	2	1	3	0	0	3	0	0
22	710974	.	A	G	25	27	52	0	3	55	0	0
22	711071	.	A	G	26	20	46	0	1	47	0	0
22	711158	.	T	G	27	17	44	0	3	47	0	0
22	711285	.	G	T	10	11	21	0	4	25	0	0
22	711357	.	C	A	8	7	15	0	0	15	0	0
22	711370	.	A	C	7	5	12	0	1	13	0	0
22	711437	.	C	T	5	3	8	0	0	8	0	0
22	711725	.	A	T	18	22	40	0	0	40	0	0
22	711787	.	A	T	24	19	43	0	0	43	0	0
22	712146	.	T	A	5	12	17	0	2	19	0	0
22	712160	.	A	G	8	14	22	0	2	24	0	0
22	712222	.	G	A	19	8	27	0	8	35	0	0
22	712484	.	G	A	14	17	31	0	3	35	1	0
22	712578	.	A	G	22	17	39	0	3	42	0	0
22	724890	.	A	C	10	4	14	0	0	14	0	0
22	725010	.	C	T	4	4	8	0	1	9	0	0
22	725013	.	C	T	4	4	8	0	0	8	0	0
22	728144	.	T	A	2	6	8	0	0	8	0	0
22	728171	.	G	A	0	5	5	0	4	9	0	0
22	728235	.	A	G	2	0	2	0	1	3	0	0
22	728244	.	T	C	1	0	1	0	1	2	0	0
22	732142	.	G	A	0	2	2	0	2	4	0	0
22	732149	.	G	T	0	2	2	0	4	6	0	0
22	732398	.	T	G	4	6	10	0	1	11	0	0
22	741559	.	T	C	0	2	2	0	0	2	0	0
22	744646	.	T	C	4	1	5	0	0	5	0	0
22	745425	.	A	C	3	3	6	0	0	6	0	0
22	774949	.	G	C	7	11	18	0	0	18	0	0
22	774989	.	T	C	9	1	10	0	18	28	0	0
22	775044	.	T	C	11	1	12	0	10	22	0	0
22	775085	.	G	A	8	6	14	0	0	14	0	0
22	776875	.	T	G	7	7	14	0	1	16	1	0
22	777072	.	G	A	1	0	1	0	0	1	0	0
22	779246	.	C	T	0	7	7	0	12	19	0	0
22	779255	.	G	A	10	9	19	0	0	19	0	0
22	779330	.	T	A	0	2	2	0	0	2	0	0
22	786611	.	T	C	12	7	19	0	0	19	0	0
22	796937	.	C	T	16	3	19	0	0	19	0	0
22	796994	.	G	T	0	6	6	0	2	9	1	0
22	797000	.	G	A	0	2	2	0	4	6	0	0
22	797196	.	G	T	0	12	12	0	17	29	0	0
22	797255	.	T	C	4	8	12	0	0	12	0	0
22	804409	.	C	T	17	18	35	0	1	36	0	0
22	806155	.	C	T	4	6	10	0	1	11	0	0
22	807503	.	G	A	3	3	6	0	0	6	0	0
22	808015	.	T	A	7	8	15	0	0	15	0	0
22	808032	.	T	C	9	9	18	0	0	18	0	0
22	808077	.	A	G	7	2	9	0	11	20	0	0
22	808134	.	G	A	3	6	9	0	0	9	0	0
22	808228	.	A	G	7	3	10	0	1	11	0	0
22	808340	.	A	T	23	14	37	0	0	37	0	0
22	808655	.	G	C	8	12	20	0	1	21	0	0
22	819756	.	G	A	1	4	5	0	1	6	0	0
22	819787	.	G	A	3	3	6	0	0	6	0	0
22	820087	.	G	T	7	11	18	0	1	19	0	0
22	820459	.	G	T	6	3	9	0	0	9	0	0
22	822923	.	C	G	3	1	4	0	0	4	0	0
22	825130	.	G	A	7	9	16	0	2	18	0	0
22	825178	.	C	G	0	2	2	0	4	6	0	0
22	827309	.	G	A	8	6	14	0	1	15	0	0
22	828235	.	C	G	6	3	9	0	1	10	0	0
22	831185	.	C	T	2	7	9	0	0	9	0	0
22	831482	.	C	T	1	6	7	0	8	15	0	0
22	831533	.	G	A	6	7	13	0	0	13	0	0
22	831575	.	C	T	3	4	7	0	0	7	0	0
22	833990	.	T	C	6	5	11	0	1	12	0	0
22	857032	.	G	A	2	2	4	0	0	4	0	0
22	857249	.	C	T	0	1	1	0	1	2	0	0
22	857271	.	T	C	1	3	4	0	0	4	0	0
22	857511	.	C	G	13	4	17	0	0	17	0	0
22	857630	.	A	G	11	8	19	0	0	19	0	0
22	857733	.	T	G	6	4	10	0	3	13	0	0
22	859511	.	T	C	5	0	5	0	4	9	0	0
22	860224	.	G	A	7	5	12	0	1	13	0	0
22	860236	.	G	A	6	4	10	0	0	10	0	0
22	861160	.	A	G	8	5	13	0	0	13	0	0
22	866064	.	C	T	2	1	3	0	1	4	0	0
22	868114	.	T	C	4	6	10	0	0	10	0	0
22	868175	.	A	G	7	8	15	0	0	15	0	0
22	868195	.	C	A	6	6	12	0	0	12	0	0
22	868312	.	A	G	4	5	9	0	1	10	0	0
22	868353	.	T	A	5	6	11	0	1	12	0	0
22	868563	.	A	T	7	10	17	0	0	17	0	0
22	868594	.	T	A	3	10	13	0	1	14	0	0
22	869584	.	C	T	5	4	9	0	0	9	0	0
22	869739	.	G	A	1	8	9	0	0	9	0	0
22	869793	.	C	A	3	10	13	0	0	13	0	0
22	869798	.	G	T	3	10	13	0	0	13	0	0
22	869989	.	A	G	0	2	2	0	0	2	0	0
22	873058	.	G	C	1	5	6	0	0	6	0	0
22	876988	.	G	A	0	2	2	0	0	2	0	0
22	982735	.	T	C	2	3	5	0	0	5	0	0
22	994433	.	G	A	3	4	7	0	0	7	0	0
22	994512	.	T	A	0	2	2	0	0	2	0	0
22	1069191	.	G	A	1	1	2	0	1	3	0	0
22	1266976	.	A	T	1	1	2	0	0	2	0	0
22	1267013	.	C	T	6	3	9	0	0	9	0	0
22	1267045	.	A	G	5	4	9	0	1	10	0	0
22	1267081	.	G	A	3	5	8	0	0	8	0	0
22	1267213	.	G	C	0	9	9	0	4	13	0	0
22	1276710	.	A	T	1	9	10	0	0	10	0	0
22	1277741	.	T	C	1	3	4	0	0	4	0	0
22	1277766	.	A	G	2	1	3	0	1	4	0	0
22	1281832	.	C	A	2	5	7	0	1	8	0	0
22	1281951	.	G	A	3	6	9	0	0	9	0	0
22	1281978	.	T	C	3	4	7	0	2	9	0	0
22	1281993	.	A	G	4	4	8	0	0	8	0	0
22	1282176	.	T	A	5	8	13	0	0	13	0	0
22	1282296	.	G	T	9	9	18	0	0	18	0	0
22	1289380	.	C	T	0	3	3	0	1	4	0	0
22	1289402	.	T	G	1	3	4	0	1	5	0	0
22	1289430	.	G	A	2	2	4	0	0	4	0	0
22	1289769	.	A	G	2	1	3	0	1	4	0	0
22	1291702	.	T	G	2	4	6	0	0	6	0	0
22	1291704	.	C	T	2	4	6	0	0	6	0	0
22	1292316	.	G	A	0	0	0	0	2	2	0	0
22	1294642	.	C	T	3	2	5	0	0	5	0	0
22	1317398	.	G	C	0	0	0	0	2	2	0	0
22	1322749	.	T	G	1	0	1	0	2	3	0	0
22	1322755	.	C	T	1	2	3	0	0	3	0	0
22	1323514	.	G	A	2	4	6	0	0	6	0	0
22	1323628	.	G	A	2	3	5	0	0	5	0	0
22	1326647	.	A	C	2	5	7	0	0	7	0	0
22	1327074	.	A	G	4	2	6	0	1	7	0	0
22	1327209	.	C	T	5	2	7	0	0	7	0	0
22	1327452	.	G	A	2	2	4	0	0	4	0	0
22	1327475	.	A	C	2	3	5	0	0	5	0	0
22	1327979	.	G	A	0	7	7	0	2	9	0	0
22	1328001	.	C	T	2	3	5	0	0	5	0	0
22	1328402	.	T	C	12	9	21	0	0	21	0	0
22	1328660	.	A	T	10	8	18	0	0	18	0	0
22	1328708	.	G	A	17	6	23	0	0	23	0	0
22	1328748	.	A	G	15	0	15	0	7	22	0	0
22	1328890	.	A	G	6	1	7	0	2	9	0	0
22	1328967	.	G	A	4	2	6	0	0	6	0	0
22	1328968	.	C	A	4	2	6	0	0	6	0	0
22	1332905	.	A	G	2	3	5	0	0	5	0	0
22	1332906	.	A	G	1	3	4	0	1	5	0	0
22	1353802	.	T	A	2	6	8	0	0	8	0	0
22	1353818	.	A	G	2	3	5	0	0	5	0	0
22	1353857	.	T	C	1	0	1	0	0	1	0	0
22	1353860	.	A	T	1	0	1	0	0	1	0	0
22	1373320	.	G	T	2	3	5	0	0	5	0	0
22	1373633	.	T	C	5	2	7	0	0	7	0	0
22	1374716	.	C	A	2	4	6	0	0	6	0	0
22	1374838	.	A	C	2	1	3	0	0	3	0	0
22	1374848	.	C	T	1	1	2	0	0	2	0	0
22	1375030	.	T	C	1	1	2	0	0	2	0	0
22	1375032	.	T	C	1	1	2	0	0	2	0	0
22	1375083	.	T	C	1	5	6	0	1	7	0	0
22	1392930	.	A	C	1	0	1	0	0	1	0	0
22	1393924	.	C	T	2	3	5	0	0	5	0	0
22	1407074	.	A	G	6	4	10	0	1	11	0	0
22	1407152	.	T	C	4	5	9	0	0	9	0	0
22	1421447	.	A	G	2	2	4	0	0	4	0	0
22	1421448	.	C	A	2	2	4	0	0	4	0	0
22	1421557	.	C	T	0	2	2	0	0	2	0	0
22	1422820	.	G	A	2	2	4	0	0	4	0	0
22	1423108	.	A	G	3	5	8	0	0	8	0	0
22	1423588	.	A	G	2	4	6	0	1	7	0	0
22	1423975	.	A	T	2	3	5	0	0	5	0	0
22	1424002	.	A	G	2	2	4	0	0	4	0	0
22	1424065	.	C	A	2	2	4	0	1	5	0	0
22	1424456	.	T	A	1	2	3	0	0	3	0	0
22	1431789	.	G	A	5	0	5	0	1	6	0	0
22	1431798	.	A	G	6	0	6	0	0	6	0	0
22	1431829	.	G	A	0	2	2	0	6	8	0	0
22	1431882	.	A	G	1	5	6	0	0	6	0	0
22	1432101	.	T	C	3	2	5	0	0	5	0	0
22	1440977	.	A	G	5	0	5	0	3	8	0	0
22	1440989	.	A	C	2	4	6	0	2	8	0	0
22	1441154	.	A	G	1	2	3	0	1	4	0	0
22	1441200	.	C	G	3	0	3	0	4	7	0	0
22	1441337	.	C	T	3	4	7	0	0	7	0	0
22	1441470	.	T	C	2	1	3	0	0	3	0	0
22	1441475	.	A	T	2	1	3	0	0	3	0	0
22	1727204	.	C	A	2	4	6	1	1	8	0	0
22	1727238	.	A	G	1	3	4	1	0	5	0	0
22	1757132	.	A	G	1	0	1	0	2	3	0	0
22	1757150	.	T	C	1	4	5	0	0	5	0	0
22	1757415	.	T	A	2	2	4	0	0	4	0	0
22	1794099	.	A	G	2	5	7	0	0	7	0	0
22	1809319	.	C	G	1	2	3	0	0	3	0	0
22	1817629	.	C	A	3	2	5	0	0	5	0	0
22	1838348	.	A	G	1	3	4	0	0	4	0	0
22	1838352	.	A	G	0	0	0	0	5	5	0	0
22	1849302	.	C	G	2	2	4	0	0	4	0	0
22	1860922	.	G	A	0	4	4	0	0	4	0	0
22	1861431	.	T	C	2	2	4	0	0	4	0	0
22	1900144	.	T	C	2	3	5	0	0	5	0	0
22	1900146	.	A	G	2	0	2	0	3	5	0	0
22	1900563	.	T	G	1	0	1	0	4	5	0	0
22	1900888	.	G	A	1	2	3	0	0	3	0	0
22	1901428	.	C	A	1	2	3	0	0	3	0	0
22	1901456	.	C	G	1	2	3	0	0	3	0	0
22	1924416	.	G	A	1	2	3	1	0	4	0	0
22	1924952	.	C	T	3	2	5	0	0	5	0	0
22	1925055	.	G	C	2	3	5	0	0	5	0	0
22	1925132	.	T	C	2	3	5	0	0	5	0	0
22	1925182	.	A	G	2	3	5	0	1	6	0	0
22	1944952	.	T	C	3	2	5	0	0	5	0	0
22	1945243	.	G	A	4	2	6	0	0	6	0	0
22	1945258	.	C	T	3	2	5	0	0	5	0	0
22	1948689	.	A	G	3	2	5	0	0	5	0	0
22	1948847	.	A	C	1	4	5	0	0	5	0	0
22	1948915	.	G	A	3	2	5	0	0	5	0	0
22	2033362	.	G	A	1	2	3	0	0	3	0	0
22	2033389	.	C	A	1	3	4	0	0	4	0	0
22	2033430	.	A	G	2	0	2	0	7	9	0	0
22	2033674	.	C	T	7	7	14	0	0	14	0	0
22	2033740	.	C	T	3	4	7	0	3	10	0	0
22	2033767	.	G	A	5	5	10	0	0	10	0	0
22	2033908	.	C	T	7	3	10	1	1	12	0	0
22	2034016	.	A	G	6	0	6	0	4	10	0	0
22	2106400	.	T	G	0	3	3	0	0	3	0	0
22	2106420	.	T	C	0	5	5	0	0	5	0	0
22	2106630	.	C	T	0	2	2	0	0	2	0	0
22	2106657	.	G	C	1	3	4	0	0	4	0	0
22	2125829	.	G	A	6	3	9	0	0	9	0	0
22	2147047	.	C	G	1	1	2	0	1	3	0	0
22	2163243	.	A	T	1	3	4	0	1	5	0	0
22	2172239	.	A	G	2	2	4	0	0	4	0	0
22	2172240	.	G	A	2	2	4	0	0	4	0	0
22	2172283	.	G	T	3	3	6	0	0	6	0	0
22	2172294	.	A	G	2	2	4	0	0	4	0	0
22	2172437	.	C	G	0	2	2	1	0	3	0	0
22	2172495	.	C	G	0	0	0	0	2	2	0	0
22	2178333	.	A	C	3	2	5	0	0	5	0	0
22	2233980	.	C	T	3	3	6	0	1	7	0	0
22	2233985	.	T	C	3	5	8	0	0	8	0	0
22	2234325	.	T	A	2	5	7	0	0	7	0	0
22	2234637	.	A	G	2	5	7	0	0	7	0	0
22	2234642	.	T	C	3	4	7	0	0	7	0	0
22	2234862	.	G	A	1	4	5	0	0	5	0	0
22	2242507	.	G	A	0	3	3	0	1	4	0	0
22	2242763	.	C	T	3	4	7	0	0	7	0	0
22	2347889	.	A	G	2	4	6	0	0	6	0	0
22	2347923	.	A	C	1	3	4	0	0	4	0	0
22	2347958	.	T	C	2	4	6	0	0	6	0	0
22	2348129	.	A	G	0	3	3	0	0	3	0	0
22	2348132	.	G	A	0	2	2	0	1	3	0	0
22	2352130	.	G	A	0	0	0	0	2	2	0	0
22	2365114	.	C	T	1	3	4	0	0	4	0	0
22	2368037	.	C	T	2	2	4	0	1	5	0	0
22	2368161	.	C	G	2	6	8	0	1	9	0	0
22	2373908	.	C	T	1	2	3	0	0	3	0	0
22	2373909	.	A	G	1	2	3	0	0	3	0	0
22	2374088	.	T	C	4	4	8	0	0	8	0	0
22	2389009	.	A	T	4	8	12	0	0	12	0	0
22	2389041	.	T	C	9	6	15	0	0	15	0	0
22	2389225	.	G	T	2	3	5	0	0	5	0	0
22	2403919	.	T	A	1	2	3	0	0	3	0	0
22	2417311	.	G	T	0	3	3	0	2	5	0	0
22	2417389	.	T	C	3	4	7	0	0	7	0	0
22	2420325	.	A	G	6	2	8	0	0	8	0	0
22	2420493	.	C	G	4	2	6	0	0	7	1	0
22	2420623	.	C	G	2	5	7	0	0	7	0	0
22	2420744	.	C	A	2	3	5	0	0	5	0	0
22	2420881	.	T	C	2	7	9	0	1	10	0	0
22	2421028	.	A	T	4	6	10	0	0	10	0	0
22	2443865	.	T	C	2	4	6	0	0	6	0	0
22	2444186	.	G	T	5	2	7	0	0	7	0	0
22	2444234	.	G	A	2	5	7	0	0	7	0	0
22	2444303	.	G	A	3	8	11	0	0	11	0	0
22	2473557	.	G	T	0	2	2	0	1	3	0	0
22	2497777	.	T	C	2	4	6	0	0	6	0	0
22	2498169	.	T	C	4	5	9	0	0	9	0	0
22	2498196	.	G	A	0	2	2	0	2	4	0	0
22	2498212	.	C	T	3	2	5	0	0	5	0	0
22	2498279	.	G	A	0	4	4	0	2	6	0	0
22	2529408	.	G	A	2	2	4	0	0	4	0	0
22	2529946	.	C	G	1	1	2	0	1	3	0	0
22	2535173	.	A	T	4	2	6	0	0	6	0	0
22	2535180	.	T	C	4	2	6	0	0	6	0	0
22	2538363	.	T	C	1	3	4	0	0	4	0	0
22	2538546	.	T	C	2	5	7	0	0	7	0	0
22	2552748	.	C	G	3	3	6	0	0	6	0	0
22	2552814	.	G	A	0	5	5	0	1	6	0	0
22	2554749	.	A	T	4	8	12	0	1	13	0	0
22	2554793	.	C	A	2	7	9	0	1	10	0	0
22	2554800	.	G	A	1	8	9	0	0	9	0	0
22	2557735	.	C	T	2	2	4	0	0	4	0	0
22	2557783	.	G	A	5	3	8	0	1	9	0	0
22	2558279	.	A	T	1	9	10	0	0	10	0	0
22	2558344	.	G	A	3	8	11	0	1	12	0	0
22	2558386	.	C	T	3	5	8	1	0	9	0	0
22	2558416	.	A	T	3	5	8	3	0	11	0	0
22	2558491	.	T	C	2	3	5	0	1	6	0	0
22	2558493	.	C	T	3	3	6	0	0	6	0	0
22	2580443	.	G	A	0	1	1	0	1	2	0	0
22	2580444	.	T	C	1	1	2	0	0	2	0	0
22	2602338	.	G	A	0	2	2	0	2	4	0	0
22	2623083	.	G	A	2	5	7	0	0	7	0	0
22	2623632	.	T	G	3	0	3	0	3	6	0	0
22	2626968	.	G	A	0	1	1	0	1	2	0	0
22	2627317	.	A	G	0	0	0	2	3	5	0	0
22	2627483	.	A	G	2	0	2	0	5	7	0	0
22	2627736	.	A	T	2	8	10	0	0	10	0	0
22	2627773	.	A	T	1	6	7	0	0	7	0	0
22	2627804	.	C	T	3	3	6	0	0	6	0	0
22	2627813	.	T	G	2	2	4	0	0	4	0	0
22	2627853	.	C	A	2	4	6	0	0	6	0	0
22	2627864	.	A	C	4	4	8	0	0	8	0	0
22	2627988	.	T	A	1	3	4	0	0	4	0	0
22	2627998	.	G	A	1	2	3	0	0	3	0	0
22	2638000	.	G	T	3	2	5	0	0	5	0	0
22	2638033	.	C	G	2	2	4	0	0	4	0	0
22	2645137	.	A	T	0	2	2	0	1	3	0	0
22	2645410	.	G	A	1	4	5	0	0	5	0	0
22	2645741	.	C	T	2	3	5	0	0	5	0	0
22	2647807	.	C	A	1	2	3	0	0	3	0	0
22	2647819	.	T	A	1	4	5	0	0	5	0	0
22	2653023	.	T	C	6	3	9	0	0	9	0	0
22	2657856	.	G	A	1	2	3	0	0	3	0	0
22	2659103	.	A	T	2	3	5	0	0	5	0	0
22	2659111	.	G	C	2	4	6	0	0	6	0	0
22	2659152	.	A	T	2	3	5	0	0	5	0	0
22	2659153	.	C	A	2	3	5	0	0	5	0	0
22	2664297	.	C	T	2	2	4	0	0	4	0	0
22	2667992	.	T	A	1	1	2	0	0	2	0	0
22	2667993	.	T	C	1	1	2	0	0	2	0	0
22	2668031	.	G	A	1	4	5	0	0	5	0	0
22	2668043	.	C	T	2	3	5	0	0	5	0	0
22	2668131	.	G	A	0	2	2	0	3	5	0	0
22	2668262	.	A	G	1	3	4	0	0	4	0	0
22	2668352	.	C	T	2	2	4	0	0	4	0	0
22	2668467	.	G	C	0	3	3	0	3	6	0	0
22	2668486	.	G	A	2	4	6	0	1	7	0	0
22	2668533	.	G	A	0	4	4	0	0	4	0	0
22	2676234	.	G	C	1	4	5	0	0	5	0	0
22	2676393	.	A	G	1	0	1	0	4	5	0	0
22	2676415	.	A	C	1	4	5	0	0	5	0	0
22	2690523	.	A	C	4	3	7	0	0	7	0	0
22	3232370	.	T	A	3	5	8	0	0	8	0	0
22	3232433	.	C	T	2	2	4	0	0	4	0	0
22	3232506	.	C	T	1	2	3	0	1	4	0	0
22	3233094	.	A	G	2	4	6	0	0	6	0	0
22	3233194	.	T	C	4	2	6	0	0	6	0	0
22	3233652	.	A	C	3	2	5	0	3	8	0	0
22	3263172	.	G	A	5	5	10	0	1	11	0	0
22	3263195	.	G	A	5	6	11	0	0	11	0	0
22	3263318	.	A	G	7	13	20	0	2	22	0	0
22	3263760	.	G	A	6	4	10	0	0	10	0	0
22	3263776	.	T	G	3	6	9	0	1	10	0	0
22	3263917	.	C	T	10	11	21	0	0	21	0	0
22	3265889	.	C	A	8	3	11	0	1	12	0	0
22	3273835	.	T	C	9	4	13	0	0	13	0	0
22	3387859	.	G	A	3	6	9	0	0	9	0	0
22	3387865	.	T	C	3	6	9	0	0	9	0	0
22	3389500	.	T	G	16	10	26	0	2	28	0	0
22	3402151	.	A	G	2	5	7	0	0	7	0	0
22	3446337	.	G	A	5	7	12	0	0	12	0	0
22	4390344	.	C	T	6	3	9	0	0	9	0	0
22	4397709	.	A	G	2	1	3	0	1	4	0	0
22	4397772	.	G	A	6	2	8	0	1	9	0	0
22	4397947	.	A	G	8	9	17	0	0	17	0	0
22	4397966	.	C	G	8	9	17	0	0	17	0	0
22	4407768	.	T	C	3	7	10	0	1	11	0	0
22	4444165	.	C	T	2	4	6	0	0	6	0	0
22	4444620	.	T	C	2	4	6	0	0	6	0	0
22	4444736	.	C	G	2	3	5	0	0	5	0	0
22	4444740	.	T	C	2	3	5	0	0	5	0	0
22	4445071	.	A	G	1	0	1	0	2	3	0	0
22	4445393	.	T	C	3	1	4	0	0	4	0	0
22	4445401	.	A	G	2	0	2	0	3	5	0	0
22	4450231	.	T	G	3	0	3	0	1	4	0	0
22	4450395	.	C	T	1	1	2	0	0	2	0	0
22	4450449	.	T	A	1	1	2	0	0	2	0	0
22	4453459	.	G	T	0	5	5	0	5	10	0	0
22	4453504	.	C	T	0	1	1	0	0	1	0	0
22	4457622	.	G	C	8	6	14	0	0	14	0	0
22	4459772	.	T	C	2	4	6	0	0	6	0	0
22	4460297	.	A	G	8	4	12	0	1	13	0	0
22	4462713	.	C	G	1	0	1	0	0	1	0	0
22	4462889	.	A	G	6	11	17	0	1	18	0	0
22	4462890	.	C	A	7	8	15	0	3	18	0	0
22	4463041	.	A	G	5	5	10	0	1	11	0	0
22	4463160	.	C	T	7	2	9	0	0	9	0	0
22	4463192	.	G	A	1	2	3	0	1	4	0	0
22	4711814	.	A	T	2	0	2	0	0	2	0	0
22	4711929	.	C	T	6	6	12	0	0	12	0	0
22	4719525	.	G	A	0	3	3	0	7	10	0	0
22	4719526	.	T	G	3	7	10	0	0	10	0	0
22	4726694	.	A	G	8	5	13	0	0	13	0	0
22	4726733	.	T	G	0	1	1	0	0	1	0	0
22	4728712	.	A	G	2	0	2	0	0	2	0	0
22	4728730	.	C	T	3	3	6	0	0	6	0	0
22	4730881	.	G	A	7	8	15	0	0	15	0	0
22	4730882	.	A	T	7	8	15	0	0	15	0	0
22	4732627	.	C	A	14	21	35	0	0	35	0	0
22	4745227	.	C	T	6	7	13	0	0	13	0	0
22	4745421	.	A	G	11	14	25	0	1	26	0	0
22	4745642	.	G	A	15	8	23	0	0	23	0	0
22	4745677	.	C	G	11	6	17	0	0	17	0	0
22	4745682	.	A	T	10	5	15	0	1	16	0	0
22	4745779	.	C	T	1	15	16	0	17	33	0	0
22	4746120	.	A	T	10	20	30	0	1	31	0	0
22	4746401	.	A	G	4	3	7	0	1	8	0	0
22	4746577	.	C	A	1	10	11	0	1	12	0	0
22	4746721	.	C	T	7	11	18	0	0	18	0	0
22	4746750	.	C	T	10	10	20	0	0	20	0	0
22	4747278	.	A	C	3	5	8	0	0	8	0	0
22	4747287	.	C	T	5	3	8	0	0	8	0	0
22	4747524	.	T	C	1	2	3	0	0	3	0	0
22	4747684	.	C	T	4	6	10	0	0	10	0	0
22	4747832	.	C	T	5	7	12	0	0	12	0	0
22	4747862	.	C	T	6	8	14	0	0	14	0	0
22	4747921	.	G	T	5	8	13	0	0	13	0	0
22	4752478	.	C	T	7	8	15	0	2	17	0	0
22	4754306	.	C	T	2	5	7	0	0	7	0	0
22	4755338	.	A	G	7	6	13	0	1	14	0	0
22	4755656	.	C	T	0	3	3	0	6	9	0	0
22	4755681	.	G	A	5	4	9	0	1	10	0	0
22	4758015	.	C	T	2	1	3	0	0	3	0	0
22	4762663	.	C	T	0	10	10	0	14	24	0	0
22	4762664	.	A	G	11	13	24	0	0	24	0	0
22	4762773	.	T	C	18	22	40	0	0	40	0	0
22	4763125	.	G	A	7	5	12	0	0	12	0	0
22	4763474	.	C	A	0	9	9	0	6	15	0	0
22	4766818	.	C	T	3	4	7	0	1	8	0	0
22	4767075	.	A	C	14	1	15	0	2	17	0	0
22	4767534	.	C	T	8	7	15	0	0	15	0	0
22	4767738	.	C	G	3	2	5	0	0	5	0	0
22	4767754	.	C	T	4	6	10	0	0	10	0	0
22	4769024	.	C	G	10	11	21	0	1	22	0	0
22	4948157	.	G	A	0	1	1	0	0	1	0	0
22	4952568	.	T	C	2	3	5	0	0	5	0	0
22	4952823	.	C	A	1	3	4	0	0	4	0	0
22	4955415	.	C	A	1	2	3	0	0	3	0	0
22	4955761	.	G	A	1	1	2	0	0	2	0	0
22	4962414	.	A	G	1	2	3	0	0	3	0	0
22	4962550	.	A	C	4	0	4	0	7	11	0	0
22	4962559	.	G	A	4	10	14	0	0	14	0	0
22	4962590	.	A	G	3	10	13	0	1	14	0	0
22	4962610	.	A	T	6	15	21	0	0	21	0	0
22	4962635	.	A	G	7	12	19	0	0	19	0	0
22	4962878	.	G	A	11	12	23	0	0	23	0	0
22	4967354	.	G	T	1	2	3	0	1	4	0	0
22	4968955	.	A	G	2	4	6	0	0	6	0	0
22	4969021	.	A	G	8	19	27	0	0	27	0	0
22	4970773	.	T	C	3	0	3	0	4	7	0	0
22	4970797	.	G	C	6	3	9	0	2	11	0	0
22	4972848	.	T	G	9	9	18	0	2	20	0	0
22	4975236	.	T	A	9	18	27	0	4	31	0	0
22	4977106	.	G	A	9	7	16	0	0	16	0	0
22	4979470	.	C	T	6	12	18	0	1	19	0	0
22	4987889	.	T	C	3	0	3	0	9	12	0	0
22	4989754	.	G	T	1	2	3	0	0	3	0	0
22	5056607	.	A	G	7	6	13	0	1	14	0	0
22	5056760	.	T	G	6	17	23	0	0	23	0	0
22	5056978	.	A	T	5	6	11	0	0	11	0	0
22	5057034	.	G	T	6	6	12	0	0	12	0	0
22	5057188	.	G	A	6	3	9	0	1	10	0	0
22	5057191	.	T	C	7	0	7	0	3	10	0	0
22	5057254	.	T	A	3	6	9	0	0	9	0	0
22	5057421	.	C	A	0	6	6	0	5	11	0	0
22	5057489	.	T	A	5	4	9	0	0	9	0	0
22	5057504	.	T	A	5	4	9	0	1	10	0	0
22	5057562	.	G	T	5	7	12	0	0	12	0	0
22	5120172	.	C	T	4	8	12	0	0	12	0	0
22	5140840	.	C	T	0	2	2	0	2	4	0	0
22	5144566	.	G	C	7	6	13	0	0	13	0	0
22	5144750	.	T	A	6	5	11	0	1	12	0	0
22	5144882	.	T	G	4	5	9	0	0	9	0	0
22	5144981	.	T	C	6	4	10	0	1	11	0	0
22	5145109	.	C	A	6	4	10	0	0	10	0	0
22	5145330	.	C	T	5	4	9	0	0	9	0	0
22	5145396	.	T	C	1	2	3	0	1	4	0	0
22	5153853	.	C	T	1	2	3	0	0	3	0	0
22	5153957	.	T	G	2	2	4	0	0	4	0	0
22	5154556	.	T	A	1	2	3	0	0	3	0	0
22	5154630	.	T	C	1	0	1	0	2	3	0	0
22	5154649	.	A	T	1	2	3	0	0	3	0	0
22	5176299	.	C	A	3	3	6	0	0	6	0	0
22	5176514	.	C	G	5	6	11	0	0	11	0	0
22	5209139	.	A	G	1	1	2	0	0	3	1	0
22	5227738	.	C	T	11	9	20	0	0	20	0	0
22	5227869	.	C	T	6	13	19	0	0	19	0	0
22	5227870	.	C	G	6	11	17	0	2	19	0	0
22	5228124	.	G	T	0	5	5	0	9	14	0	0
22	5228158	.	C	T	6	5	11	0	0	11	0	0
22	5228201	.	T	G	4	7	11	0	0	11	0	0
22	5228711	.	T	C	3	3	6	0	0	6	0	0
22	5228744	.	G	A	0	4	4	0	12	16	0	0
22	5229048	.	G	A	5	3	8	0	0	8	0	0
22	5229151	.	A	G	12	4	16	0	0	16	0	0
22	5229315	.	A	C	0	3	3	0	0	3	0	0
22	5229320	.	G	A	0	3	3	0	0	3	0	0
22	5230047	.	T	G	1	2	3	0	0	3	0	0
22	5230339	.	A	G	11	4	15	0	1	16	0	0
22	5230455	.	A	C	2	2	4	0	0	4	0	0
22	5230684	.	A	G	2	2	4	0	0	4	0	0
22	5230751	.	G	C	5	6	11	0	0	11	0	0
22	5230794	.	T	A	4	6	10	0	0	10	0	0
22	5230839	.	A	G	5	9	14	0	0	14	0	0
22	5231145	.	T	C	5	4	9	0	0	9	0	0
22	5231263	.	A	G	10	10	20	0	1	21	0	0
22	5231354	.	C	T	9	6	15	0	0	15	0	0
22	5231696	.	A	G	12	9	21	0	2	23	0	0
22	5232088	.	T	G	11	9	20	0	0	21	1	0
22	5233560	.	C	T	4	2	6	0	0	6	0	0
22	5233620	.	G	A	3	2	5	0	0	5	0	0
22	5233657	.	C	T	0	3	3	0	4	7	0	0
22	5233920	.	T	C	9	8	17	1	0	18	0	0
22	5234042	.	T	A	10	7	17	0	2	19	0	0
22	5235322	.	G	A	1	1	2	0	0	2	0	0
22	5244560	.	T	C	3	1	4	0	0	4	0	0
22	5247823	.	G	T	4	1	5	0	0	5	0	0
22	5247846	.	G	A	1	1	2	0	0	2	0	0
22	5251783	.	C	T	2	4	6	0	0	6	0	0
22	5403361	.	A	T	1	2	3	0	0	3	0	0
22	5421469	.	A	G	1	0	1	0	0	1	0	0
22	5423296	.	G	T	0	2	2	0	1	3	0	0
22	5423305	.	A	G	1	0	1	0	2	3	0	0
22	5424031	.	T	C	3	1	4	0	0	4	0	0
22	5436580	.	G	A	1	1	2	0	0	2	0	0
22	5575088	.	C	T	15	13	28	0	1	29	0	0
22	5577139	.	T	C	7	6	13	0	0	13	0	0
22	5577196	.	A	G	6	0	6	0	5	11	0	0
22	5577211	.	T	C	4	1	5	0	0	5	0	0
22	5578880	.	T	C	12	12	24	0	2	26	0	0
22	5584541	.	A	G	2	1	3	0	1	4	0	0
22	5586896	.	T	C	12	10	22	0	1	23	0	0
22	5586902	.	C	T	11	12	23	0	0	23	0	0
22	5587039	.	C	T	9	18	27	0	0	27	0	0
22	5587075	.	C	A	6	13	19	0	0	19	0	0
22	5587077	.	C	T	6	13	19	0	0	19	0	0
22	5587124	.	G	A	9	24	33	0	0	33	0	0
22	5587204	.	A	G	17	4	21	0	21	42	0	0
22	5587285	.	A	C	7	7	14	0	2	16	0	0
22	5587826	.	T	C	22	25	47	0	4	51	0	0
22	5587930	.	T	C	13	26	39	0	3	42	0	0
22	5634158	.	A	T	2	1	3	0	0	3	0	0
22	5634763	.	T	G	1	0	1	0	0	1	0	0
22	5637164	.	G	A	1	0	1	0	0	1	0	0
22	5637329	.	A	G	1	2	3	0	0	3	0	0
22	5637353	.	A	C	0	0	0	0	2	2	0	0
22	5639691	.	G	T	0	2	2	0	1	3	0	0
22	5639715	.	T	C	1	0	1	0	2	3	0	0
22	5643503	.	G	A	0	1	1	0	0	1	0	0
22	5649818	.	A	G	1	2	3	0	0	3	0	0
22	5649836	.	A	G	1	2	3	0	0	3	0	0
22	5657155	.	G	A	4	8	12	0	1	13	0	0
22	5657191	.	C	T	0	6	6	0	8	14	0	0
22	5657278	.	A	T	2	6	8	0	0	8	0	0
22	5657456	.	T	C	1	0	1	0	5	6	0	0
22	5657704	.	T	C	5	8	13	0	2	15	0	0
22	5657731	.	T	C	8	0	8	0	5	13	0	0
22	5657800	.	T	A	11	4	15	0	1	16	0	0
22	5661524	.	C	T	1	4	5	0	5	10	0	0
22	5661530	.	G	T	5	6	11	0	1	12	0	0
22	5663260	.	T	A	5	5	10	0	0	10	0	0
22	5663275	.	G	A	6	5	11	0	1	12	0	0
22	5667596	.	T	G	18	3	21	0	0	21	0	0
22	5667629	.	T	C	13	0	13	0	0	13	0	0
22	5752305	.	T	C	6	0	6	0	0	6	0	0
22	5752315	.	G	A	6	0	6	0	0	6	0	0
22	5758228	.	T	A	4	2	6	0	1	7	0	0
22	5758240	.	T	A	2	2	4	0	0	4	0	0
22	7556642	.	T	C	1	1	2	0	0	2	0	0
22	7676489	.	A	C	1	2	3	0	0	3	0	0
22	7676984	.	G	T	2	5	7	0	0	7	0	0
22	7682820	.	T	A	1	0	1	0	0	1	0	0
22	7682825	.	T	G	1	0	1	0	0	1	0	0
22	7683668	.	A	T	4	2	6	0	1	7	0	0
22	7683921	.	T	C	0	2	2	0	0	2	0	0
22	7693674	.	C	T	1	5	6	0	0	6	0	0
22	7693741	.	C	A	1	5	6	2	0	8	0	0
22	7972256	.	G	A	0	3	3	0	1	4	0	0
22	7972848	.	A	G	8	6	14	0	1	15	0	0
22	7972851	.	T	C	9	8	17	0	0	17	0	0
22	7974133	.	C	T	11	2	13	0	1	14	0	0
22	7974164	.	C	A	5	8	13	1	0	14	0	0
22	7974302	.	C	G	2	0	2	0	0	2	0	0
22	9057022	.	A	G	2	2	4	0	0	4	0	0
22	9057025	.	A	G	2	2	4	0	0	4	0	0
22	9195567	.	C	T	0	6	6	2	0	8	0	0
22	9241835	.	G	A	1	2	3	0	0	3	0	0
22	9241850	.	G	A	1	3	4	0	0	4	0	0
22	9431003	.	C	A	0	2	2	0	0	2	0	0
22	9512885	.	T	G	7	3	10	0	1	11	0	0
22	9591254	.	T	C	1	2	3	0	0	3	0	0
22	9591295	.	C	T	2	4	6	0	0	6	0	0
22	9872878	.	A	C	1	1	2	0	0	2	0	0
22	9898190	.	A	C	2	2	4	0	0	4	0	0
22	9899279	.	A	G	2	6	8	0	0	8	0	0
22	9899303	.	T	C	1	2	3	0	0	3	0	0
22	10049478	.	T	C	2	2	4	0	0	4	0	0
22	10197180	.	T	A	16	7	23	0	1	24	0	0
22	10553526	.	G	A	0	5	5	0	0	5	0	0
22	10553532	.	C	T	1	5	6	0	0	6	0	0
22	10557870	.	T	G	0	1	1	0	0	1	0	0
22	10658090	.	G	A	0	8	8	0	0	8	0	0
22	10734941	.	C	T	4	2	6	0	0	6	0	0
22	10930738	.	T	C	1	1	2	0	0	2	0	0
22	11156578	.	A	G	0	3	3	0	2	5	0	0
22	12090543	.	A	T	4	2	6	0	1	7	0	0
22	12163370	.	T	A	2	0	2	0	0	2	0	0
22	12171293	.	G	A	3	4	7	0	1	8	0	0
22	12174573	.	T	G	9	12	21	0	3	24	0	0
22	12174740	.	A	G	10	6	16	0	0	16	0	0
22	12175021	.	T	G	13	1	14	0	15	29	0	0
22	12175181	.	T	C	9	3	12	0	2	14	0	0
22	12175556	.	A	G	3	1	4	0	7	11	0	0
22	12175583	.	A	T	3	12	15	0	1	16	0	0
22	12176043	.	G	T	11	11	22	0	0	22	0	0
22	12218882	.	C	A	2	3	5	0	0	5	0	0
22	12218884	.	G	A	2	2	4	0	1	5	0	0
22	12247703	.	T	G	1	4	5	0	0	6	1	0
22	12247715	.	T	C	1	0	1	0	4	5	0	0
22	12259405	.	C	T	1	3	4	0	0	4	0	0
22	13514736	.	A	G	0	6	6	0	0	6	0	0
22	13846395	.	T	A	8	18	26	0	1	27	0	0
22	13846606	.	G	A	17	18	35	0	3	38	0	0
22	13846788	.	C	A	12	15	27	0	1	28	0	0
22	13847783	.	A	G	44	26	70	0	2	72	0	0
22	13847797	.	C	G	44	24	68	0	4	72	0	0
22	13847940	.	G	A	28	27	55	0	1	56	0	0
22	13848006	.	A	C	28	2	30	0	30	60	0	0
22	13848031	.	G	A	28	29	57	0	1	58	0	0
22	13848085	.	G	A	29	23	52	0	0	52	0	0
22	13848106	.	A	G	25	18	43	0	3	46	0	0
22	13850865	.	A	G	23	13	36	0	1	37	0	0
22	13919476	.	G	A	4	2	6	0	0	6	0	0
22	13920370	.	T	C	1	2	3	0	0	3	0	0
22	13939993	.	G	C	1	2	3	0	0	3	0	0
22	13940036	.	T	C	2	6	8	0	1	9	0	0
22	13942934	.	T	C	1	3	4	0	0	4	0	0
22	13942941	.	G	A	0	3	3	0	2	5	0	0
22	13977910	.	T	G	5	5	10	0	0	10	0	0
22	13978228	.	T	C	9	3	12	0	0	12	0	0
22	13978465	.	A	G	8	1	9	0	6	15	0	0
22	13978480	.	T	C	10	4	14	0	0	14	0	0
22	13978849	.	C	T	7	11	18	0	1	19	0	0
22	13979314	.	A	C	2	4	6	0	0	6	0	0
22	13979348	.	C	A	2	3	5	0	1	6	0	0
22	14068658	.	G	A	0	1	1	0	0	1	0	0
22	14073118	.	A	G	1	0	1	0	0	1	0	0
22	14075171	.	C	A	0	1	1	0	0	1	0	0
22	14076954	.	G	A	3	1	4	0	0	4	0	0
22	14077017	.	A	G	1	3	4	0	0	4	0	0
22	14077029	.	T	C	0	1	1	0	0	1	0	0
22	14083218	.	A	G	1	0	1	0	2	3	0	0
22	14083532	.	T	C	0	4	4	0	0	4	0	0
22	14083929	.	A	T	6	4	10	0	0	10	0	0
22	14124381	.	C	T	13	16	29	0	3	32	0	0
22	14124465	.	G	A	11	10	21	0	0	21	0	0
22	14124655	.	C	T	11	17	28	0	0	28	0	0
22	14125440	.	T	A	5	1	6	0	3	9	0	0
22	14125448	.	A	T	5	5	10	0	1	11	0	0
22	14366267	.	C	T	1	1	2	0	0	2	0	0
22	14398606	.	G	T	3	4	7	0	0	7	0	0
22	14402524	.	A	G	2	2	4	0	0	4	0	0
22	14408112	.	C	A	1	1	2	0	0	2	0	0
22	14408161	.	T	G	3	2	5	0	0	5	0	0
22	14422533	.	A	T	1	2	3	0	0	3	0	0
22	14427749	.	G	A	1	0	1	0	0	1	0	0
22	14475796	.	G	A	1	1	2	0	0	2	0	0
22	14475884	.	A	G	2	2	4	0	0	4	0	0
22	14650641	.	T	C	1	0	1	0	2	3	0	0
22	14845774	.	T	C	5	3	8	0	0	8	0	0
22	15009648	.	T	C	0	2	2	0	0	2	0	0
22	15251895	.	A	T	1	3	4	0	0	4	0	0
22	15251931	.	T	C	1	4	5	0	0	5	0	0
22	15280577	.	A	G	2	2	4	0	0	4	0	0
22	15344144	.	T	A	2	0	2	0	0	2	0	0
22	15345546	.	T	C	2	5	7	0	0	7	0	0
22	15345580	.	G	A	2	2	4	0	0	4	0	0
22	15345592	.	T	C	2	1	3	0	0	3	0	0
22	15350053	.	T	C	2	4	6	0	0	6	0	0
22	15350240	.	G	A	1	1	2	0	0	2	0	0
22	15351505	.	A	G	4	6	10	0	0	10	0	0
22	15352257	.	T	C	5	0	5	0	1	6	0	0
22	15384612	.	G	T	7	9	16	0	0	16	0	0
22	15384695	.	T	C	6	0	6	0	7	13	0	0
22	15384696	.	C	G	6	7	13	0	0	13	0	0
22	15384759	.	A	T	3	8	11	0	0	11	0	0
22	15385026	.	G	C	5	0	5	0	4	9	0	0
22	15429753	.	T	C	1	2	3	0	0	3	0	0
22	15437173	.	C	A	8	6	14	0	0	14	0	0
22	15448607	.	T	A	1	2	3	0	0	3	0	0
22	15448637	.	T	C	0	1	1	0	0	1	0	0
22	15448649	.	T	A	0	1	1	0	0	1	0	0
22	15540196	.	A	G	1	5	6	0	0	6	0	0
22	15540211	.	C	G	2	5	7	0	0	7	0	0
22	15541028	.	C	G	3	3	6	0	0	6	0	0
22	15541046	.	G	A	3	5	8	0	0	8	0	0
22	15541277	.	C	T	2	7	9	0	0	9	0	0
22	15541311	.	A	G	5	2	7	0	0	7	0	0
22	15543412	.	C	T	0	1	1	0	0	1	0	0
22	15544595	.	C	A	2	5	7	0	0	7	0	0
22	15544834	.	C	T	3	5	8	0	0	8	0	0
22	15548150	.	C	T	15	5	20	0	0	20	0	0
22	15552046	.	G	T	1	3	4	0	1	5	0	0
22	15585848	.	C	T	3	2	5	0	0	5	0	0
22	15585860	.	T	C	3	2	5	0	1	6	0	0
22	15585893	.	A	G	4	2	6	0	0	6	0	0
22	15628647	.	A	G	0	1	1	0	0	1	0	0
22	15628710	.	G	A	0	1	1	0	0	1	0	0
22	15629367	.	A	T	2	2	4	0	0	4	0	0
22	15696007	.	A	G	11	28	39	0	1	40	0	0
22	15696026	.	A	G	20	28	48	0	1	49	0	0
22	15696191	.	T	G	5	6	11	0	0	11	0	0
22	15697354	.	G	A	8	17	25	0	2	27	0	0
22	15700157	.	C	T	0	14	14	0	13	27	0	0
22	15701545	.	A	T	12	16	28	0	2	30	0	0
22	15701561	.	G	A	17	15	32	0	1	33	0	0
22	15701636	.	A	G	14	17	31	0	2	33	0	0
22	15704622	.	C	T	19	19	38	0	0	38	0	0
22	15719547	.	C	A	5	0	5	0	0	6	1	0
22	15719625	.	T	A	21	15	36	0	1	37	0	0
22	15719672	.	G	T	8	5	13	0	0	13	0	0
22	15719682	.	G	A	6	2	8	0	0	8	0	0
22	15719821	.	A	C	4	2	6	0	0	6	0	0
22	15720250	.	T	G	19	13	32	0	1	33	0	0
22	15720583	.	C	T	7	3	10	0	0	10	0	0
22	15720608	.	T	C	14	12	26	0	1	27	0	0
22	15720676	.	T	A	8	0	8	0	0	8	0	0
22	15720677	.	C	A	7	0	7	0	1	8	0	0
22	15720925	.	T	A	23	22	45	0	3	48	0	0
22	15721408	.	G	A	2	21	23	0	12	35	0	0
22	15721443	.	C	T	11	15	26	0	1	27	0	0
22	15721466	.	G	A	9	5	14	0	1	19	4	0
22	15721534	.	C	T	15	4	19	0	2	21	0	0
22	15721696	.	A	T	6	6	12	0	0	12	0	0
22	15721730	.	C	A	9	5	14	0	0	14	0	0
22	15899283	.	G	A	0	2	2	0	2	4	0	0
22	15900812	.	T	C	7	4	11	0	0	11	0	0
22	15912316	.	T	C	11	9	20	0	1	21	0	0
22	15912346	.	C	T	0	8	8	0	7	15	0	0
22	15915582	.	A	G	2	2	4	0	0	4	0	0
22	15915611	.	G	A	1	5	6	0	0	6	0	0
22	15915919	.	G	T	3	2	5	0	0	5	0	0
22	15917855	.	G	A	2	5	7	0	0	7	0	0
22	15932440	.	T	C	4	3	7	0	0	7	0	0
22	16335500	.	C	T	1	2	3	0	0	3	0	0
22	16345485	.	A	G	3	2	5	0	0	5	0	0
22	16348504	.	A	T	2	2	4	0	0	4	0	0
22	16348506	.	C	T	2	2	4	0	0	4	0	0
22	16350682	.	G	A	12	12	24	0	3	27	0	0
22	16350792	.	T	A	17	20	37	0	4	41	0	0
22	16350811	.	T	G	16	15	31	0	6	37	0	0
22	16350862	.	C	T	15	6	21	0	0	21	0	0
22	16350877	.	T	A	17	6	23	0	0	23	0	0
22	16351141	.	G	A	12	10	22	0	1	23	0	0
22	16351199	.	C	G	17	13	30	0	1	31	0	0
22	16351345	.	A	T	5	2	7	0	1	8	0	0
22	16351353	.	G	A	4	3	7	0	1	8	0	0
22	16351439	.	C	T	1	3	4	0	1	5	0	0
22	16351820	.	G	T	1	2	3	0	0	3	0	0
22	16352215	.	A	G	9	5	14	0	0	14	0	0
22	16352249	.	T	C	12	5	17	0	0	17	0	0
22	16352668	.	T	C	16	0	16	0	12	28	0	0
22	16352768	.	A	G	17	12	29	0	0	29	0	0
22	16357818	.	A	G	2	1	3	0	0	3	0	0
22	16357831	.	A	G	5	3	8	0	0	8	0	0
22	16357867	.	G	A	7	7	14	0	1	15	0	0
22	16357909	.	C	T	1	5	6	0	0	6	0	0
22	16367007	.	T	C	8	0	8	0	10	18	0	0
22	16367055	.	A	G	7	8	15	0	1	16	0	0
22	16377364	.	A	G	6	4	10	0	0	10	0	0
22	16412091	.	A	G	0	2	2	0	0	2	0	0
22	16418990	.	G	A	1	3	4	0	1	5	0	0
22	16419007	.	A	T	1	4	5	0	0	5	0	0
22	16423042	.	G	A	1	4	5	0	2	7	0	0
22	16424576	.	T	C	4	3	7	0	0	7	0	0
22	16427969	.	A	G	2	0	2	0	6	8	0	0
22	16428005	.	C	A	5	8	13	0	0	13	0	0
22	16430623	.	G	A	11	6	17	0	1	18	0	0
22	16430782	.	T	A	10	11	21	0	0	21	0	0
22	16430913	.	T	C	4	2	6	0	0	6	0	0
22	16433009	.	G	A	7	3	10	0	0	10	0	0
22	16433054	.	T	A	15	8	23	0	1	24	0	0
22	16433078	.	G	A	16	9	25	0	1	26	0	0
22	16433096	.	A	G	13	16	29	0	0	29	0	0
22	16433665	.	C	T	3	3	6	0	0	6	0	0
22	16433681	.	G	A	1	4	5	0	1	6	0	0
22	16433895	.	T	C	10	2	12	0	0	12	0	0
22	16433912	.	T	A	12	4	16	0	0	16	0	0
22	16433940	.	C	T	14	4	18	0	1	19	0	0
22	16434056	.	G	A	18	16	34	0	0	34	0	0
22	16440072	.	G	A	4	4	8	0	0	8	0	0
22	16440086	.	T	C	3	0	3	0	1	4	0	0
22	16484489	.	G	C	12	1	13	0	18	31	0	0
22	16484712	.	C	T	5	1	6	0	1	7	0	0
22	16484877	.	A	T	4	10	14	0	1	15	0	0
22	16484938	.	A	G	7	18	25	0	1	26	0	0
22	16484944	.	T	C	7	17	24	0	2	26	0	0
22	16485238	.	A	C	13	12	25	0	1	26	0	0
22	16485379	.	A	T	7	11	18	0	1	19	0	0
22	16485538	.	T	C	9	0	9	0	4	13	0	0
22	16485563	.	A	T	4	1	5	0	0	5	0	0
22	16485688	.	G	A	3	3	6	0	1	7	0	0
22	16485768	.	G	A	5	2	7	0	0	7	0	0
22	16485790	.	C	T	4	3	7	0	1	8	0	0
22	16485920	.	G	A	15	4	19	0	0	19	0	0
22	16485962	.	C	G	13	7	20	0	2	22	0	0
22	16486008	.	A	C	9	2	11	0	0	11	0	0
22	16486102	.	G	A	9	10	19	0	0	19	0	0
22	16486112	.	T	C	9	8	17	0	1	18	0	0
22	16491711	.	C	A	5	7	12	0	0	12	0	0
22	16491942	.	G	A	14	14	28	0	1	29	0	0
22	16498232	.	T	C	18	13	31	0	2	33	0	0
22	16498333	.	A	C	24	12	36	0	5	41	0	0
22	16498661	.	A	G	15	0	15	0	16	31	0	0
22	16537701	.	C	T	1	2	3	0	0	3	0	0
22	16537854	.	C	T	7	6	13	0	0	13	0	0
22	16537878	.	C	A	7	11	18	0	1	19	0	0
22	16544243	.	C	T	6	8	14	0	2	16	0	0
22	16544384	.	G	A	8	10	18	0	0	18	0	0
22	16544400	.	T	G	8	9	17	0	0	17	0	0
22	16544599	.	A	G	12	0	12	0	16	28	0	0
22	16544674	.	T	G	13	13	26	0	0	26	0	0
22	16544780	.	A	T	16	6	22	0	1	23	0	0
22	16544800	.	G	A	12	9	21	0	1	22	0	0
22	16569403	.	T	C	6	2	8	0	0	8	0	0
22	16594852	.	G	A	1	1	2	0	0	2	0	0
22	16594870	.	T	A	1	3	4	0	0	4	0	0
22	16594981	.	C	A	4	3	7	0	0	7	0	0
22	16597623	.	G	A	1	2	3	0	0	3	0	0
22	16601400	.	C	T	5	3	8	0	1	9	0	0
22	16601422	.	C	T	2	3	5	0	0	5	0	0
22	16606938	.	G	A	0	2	2	0	0	2	0	0
22	16775197	.	G	A	0	7	7	0	13	20	0	0
22	16775284	.	T	G	10	9	19	0	1	20	0	0
22	16775306	.	C	T	9	13	22	0	1	23	0	0
22	16862842	.	A	G	2	8	10	0	1	11	0	0
22	16893867	.	C	T	0	2	2	0	0	2	0	0
22	16991847	.	C	T	0	1	1	0	5	6	0	0
22	16997788	.	T	A	5	3	8	0	0	8	0	0
22	17197367	.	A	T	2	1	3	0	0	3	0	0
22	17200890	.	G	A	16	19	35	0	1	36	0	0
22	17200985	.	A	C	10	16	26	0	1	27	0	0
22	17201015	.	C	G	11	19	30	0	3	33	0	0
22	17201102	.	C	G	14	8	22	0	1	23	0	0
22	17201135	.	G	A	10	11	21	0	2	23	0	0
22	17201172	.	C	T	3	7	10	0	0	10	0	0
22	17201617	.	T	G	2	2	4	0	0	4	0	0
22	17208680	.	T	C	4	2	6	0	0	6	0	0
22	17208695	.	A	G	5	3	8	0	1	9	0	0
22	17208770	.	T	C	15	7	22	0	0	22	0	0
22	17208913	.	A	C	9	8	17	0	0	17	0	0
22	17208973	.	G	A	19	10	29	0	1	30	0	0
22	17208983	.	T	C	20	9	29	0	2	31	0	0
22	17209036	.	A	T	16	5	21	0	1	22	0	0
22	17209384	.	A	C	20	15	35	0	0	35	0	0
22	17209413	.	T	A	19	11	30	0	0	30	0	0
22	17209484	.	T	A	13	16	29	0	0	29	0	0
22	17209492	.	T	A	14	14	28	0	3	31	0	0
22	17209523	.	A	T	12	8	20	0	1	21	0	0
22	17209737	.	T	C	14	13	27	0	0	27	0	0
22	17209762	.	T	C	11	14	25	0	1	26	0	0
22	17209986	.	A	T	9	18	27	0	2	29	0	0
22	17209993	.	A	T	10	18	28	0	0	28	0	0
22	17210053	.	C	G	13	5	18	0	0	18	0	0
22	17210157	.	T	A	19	14	33	0	0	33	0	0
22	17210196	.	C	G	15	0	15	0	14	29	0	0
22	17210217	.	C	A	18	8	26	0	1	27	0	0
22	17210820	.	A	C	26	12	38	0	3	41	0	0
22	17210825	.	G	A	0	10	10	0	27	37	0	0
22	17211295	.	T	C	8	4	12	0	0	12	0	0
22	17211343	.	C	T	9	15	24	0	0	24	0	0
22	17211361	.	A	G	11	18	29	0	0	29	0	0
22	17211431	.	C	T	16	9	25	0	1	26	0	0
22	17211438	.	T	C	16	9	25	0	1	26	0	0
22	17211875	.	G	C	19	19	38	0	0	38	0	0
22	17211990	.	A	G	14	14	28	0	2	30	0	0
22	17212235	.	T	A	12	7	19	0	1	20	0	0
22	17212236	.	T	C	12	8	20	0	0	20	0	0
22	17219045	.	G	A	0	1	1	0	1	2	0	0
22	17226483	.	T	C	1	0	1	0	0	1	0	0
22	17227931	.	C	A	1	1	2	0	0	2	0	0
22	17235449	.	A	C	1	1	2	0	0	2	0	0
22	17250475	.	T	A	5	1	6	0	0	6	0	0
22	17315288	.	G	A	0	1	1	0	1	2	0	0
22	17315296	.	C	G	0	1	1	0	0	1	0	0
22	17318172	.	C	T	3	1	4	0	0	4	0	0
22	17318401	.	T	C	2	4	6	0	0	6	0	0
22	17318404	.	T	C	0	5	5	0	0	6	1	0
22	17318635	.	G	T	0	3	3	0	0	3	0	0
22	17322532	.	C	T	0	3	3	0	0	3	0	0
22	17331325	.	A	G	4	1	5	0	1	6	0	0
22	17343530	.	A	G	1	1	2	0	0	2	0	0
22	17359735	.	A	G	13	0	13	0	9	22	0	0
22	17359816	.	G	C	0	8	8	0	4	12	0	0
22	17360107	.	C	A	11	3	14	0	0	14	0	0
22	17360428	.	G	A	0	5	5	0	3	8	0	0
22	17446858	.	T	C	2	3	5	0	0	5	0	0
22	17448778	.	G	A	4	2	6	0	0	6	0	0
22	17448781	.	C	T	4	2	6	0	0	6	0	0
22	17450115	.	G	A	0	12	12	0	20	32	0	0
22	17452798	.	C	T	22	16	38	0	0	38	0	0
22	17453000	.	G	T	9	3	12	0	0	12	0	0
22	17453286	.	T	G	23	19	42	0	3	45	0	0
22	17453336	.	A	G	17	0	17	0	20	37	0	0
22	17453419	.	G	A	15	9	24	0	1	25	0	0
22	17453478	.	T	A	23	16	39	0	1	40	0	0
22	17453552	.	T	C	11	11	22	0	2	24	0	0
22	17453569	.	C	G	15	5	20	0	1	21	0	0
22	17453680	.	C	T	8	14	22	0	0	22	0	0
22	17453688	.	A	G	8	12	20	0	1	21	0	0
22	17453742	.	A	G	7	10	17	0	0	17	0	0
22	17453836	.	A	G	9	12	21	0	1	22	0	0
22	17453883	.	A	T	6	20	26	0	0	26	0	0
22	17453884	.	T	C	6	20	26	0	0	26	0	0
22	17454015	.	T	C	9	17	26	0	1	27	0	0
22	17454038	.	G	T	9	11	20	0	0	20	0	0
22	17454120	.	C	T	3	7	10	0	0	10	0	0
22	17454178	.	A	G	7	0	7	0	9	16	0	0
22	17454179	.	T	G	7	9	16	0	0	16	0	0
22	17454320	.	T	C	15	10	25	0	1	26	0	0
22	17454382	.	C	T	13	7	20	0	0	20	0	0
22	17454424	.	C	T	3	2	5	0	1	6	0	0
22	17501623	.	G	C	6	2	8	0	0	8	0	0
22	17505820	.	A	C	27	18	45	0	8	53	0	0
22	17506021	.	C	A	7	0	7	0	11	18	0	0
22	17506536	.	A	T	16	16	32	0	1	33	0	0
22	17506537	.	T	G	17	16	33	0	0	33	0	0
22	17509449	.	A	T	4	3	7	0	0	7	0	0
22	17509494	.	T	A	9	8	17	0	0	17	0	0
22	17509533	.	T	A	4	5	9	0	0	9	0	0
22	17517881	.	G	A	2	2	4	0	0	4	0	0
22	17520792	.	A	G	3	0	3	0	5	8	0	0
22	17531044	.	G	A	0	4	4	0	7	11	0	0
22	17531188	.	A	G	13	14	27	0	0	27	0	0
22	17533907	.	C	T	4	9	13	0	0	13	0	0
22	17539297	.	C	T	31	17	48	0	1	49	0	0
22	17539633	.	G	A	7	10	17	0	0	17	0	0
22	17541593	.	G	A	17	14	31	0	0	31	0	0
22	17542016	.	C	T	15	14	29	0	0	29	0	0
22	17542057	.	C	T	11	15	26	0	0	26	0	0
22	17542117	.	T	C	7	13	20	0	0	20	0	0
22	17542136	.	G	A	6	14	20	0	1	21	0	0
22	17542199	.	A	T	9	5	14	0	0	14	0	0
22	17542293	.	C	T	7	13	20	0	1	21	0	0
22	17542594	.	G	T	4	5	9	0	0	9	0	0
22	17542702	.	G	A	2	4	6	0	0	6	0	0
22	17542944	.	T	C	5	1	6	0	0	6	0	0
22	17543079	.	C	G	2	5	7	0	0	7	0	0
22	17543408	.	A	G	4	1	5	0	0	5	0	0
22	17543421	.	G	A	3	1	4	0	0	4	0	0
22	17543552	.	G	A	3	10	13	0	0	13	0	0
22	17543634	.	A	C	6	10	16	0	0	16	0	0
22	17543668	.	A	T	8	6	14	0	0	14	0	0
22	17543748	.	A	C	2	1	3	0	4	7	0	0
22	17543903	.	A	G	8	9	17	0	0	17	0	0
22	17550643	.	T	C	6	0	6	0	7	13	0	0
22	17550664	.	G	A	8	12	20	0	0	20	0	0
22	17550684	.	C	T	0	8	8	0	8	16	0	0
22	17550724	.	T	G	2	3	5	0	0	5	0	0
22	17552526	.	A	G	4	7	11	0	1	12	0	0
22	17554785	.	G	A	6	16	22	0	0	22	0	0
22	17560376	.	A	C	2	0	2	0	0	2	0	0
22	17564009	.	T	C	7	10	17	0	2	19	0	0
22	17565735	.	C	T	7	8	15	0	2	17	0	0
22	17565837	.	A	G	1	0	1	0	0	1	0	0
22	17571533	.	C	A	1	4	5	0	0	5	0	0
22	17590019	.	G	A	0	3	3	0	0	3	0	0
22	17590037	.	C	T	0	3	3	0	0	3	0	0
22	17591712	.	G	A	11	17	28	0	1	29	0	0
22	17596874	.	G	A	1	3	4	0	0	4	0	0
22	17596903	.	C	G	7	19	26	0	0	26	0	0
22	17596943	.	A	T	11	28	39	0	0	39	0	0
22	17606908	.	A	C	12	8	20	0	0	20	0	0
22	17607226	.	G	A	6	9	15	0	1	16	0	0
22	17819385	.	C	T	2	2	4	0	0	4	0	0
22	17822821	.	A	G	4	5	9	0	0	9	0	0
22	17822833	.	T	C	5	6	11	0	0	11	0	0
22	17828741	.	C	T	10	7	17	0	0	17	0	0
22	17829069	.	A	C	5	3	8	0	0	8	0	0
22	17829168	.	A	G	12	7	19	0	4	23	0	0
22	17830360	.	A	G	24	13	37	0	1	38	0	0
22	17830632	.	A	G	14	6	20	0	0	20	0	0
22	17830640	.	A	G	11	8	19	0	0	19	0	0
22	17865043	.	A	G	6	9	15	0	0	15	0	0
22	17865106	.	G	A	6	9	15	0	0	15	0	0
22	17867570	.	C	T	4	12	16	0	1	17	0	0
22	17881737	.	A	G	0	1	1	0	0	1	0	0
22	17881743	.	T	C	0	1	1	0	0	1	0	0
22	17991690	.	G	A	3	11	14	0	0	14	0	0
22	17998481	.	G	A	4	6	10	0	0	10	0	0
22	17999041	.	C	T	0	1	1	0	0	1	0	0
22	17999050	.	T	C	0	0	0	0	1	1	0	0
22	18004724	.	C	T	0	4	4	0	0	4	0	0
22	18022162	.	G	A	2	2	4	0	0	4	0	0
22	18022282	.	A	G	1	3	4	0	0	4	0	0
22	18156459	.	G	A	0	1	1	0	0	1	0	0
22	18160090	.	T	G	1	4	5	0	0	5	0	0
22	18168776	.	A	T	1	0	1	0	0	1	0	0
22	18211058	.	G	A	2	0	2	0	0	2	0	0
22	18231282	.	C	T	3	5	8	0	0	8	0	0
22	18231366	.	T	C	6	3	9	0	0	9	0	0
22	18231370	.	A	G	5	5	10	0	0	10	0	0
22	18231673	.	T	A	4	2	6	0	0	6	0	0
22	18232503	.	G	C	1	3	4	0	1	5	0	0
22	18232527	.	C	T	1	5	6	0	0	6	0	0
22	18232612	.	C	T	3	3	6	0	0	6	0	0
22	18232640	.	G	A	3	4	7	0	0	7	0	0
22	18232711	.	A	G	2	6	8	0	0	8	0	0
22	18232754	.	T	C	2	5	7	0	1	8	0	0
22	18232868	.	G	T	5	4	9	0	0	9	0	0
22	18232935	.	T	G	1	8	9	0	0	9	0	0
22	18233053	.	C	A	5	5	10	0	0	10	0	0
22	18233367	.	T	A	5	5	10	0	0	10	0	0
22	18233747	.	T	C	5	6	11	0	0	11	0	0
22	18234340	.	A	C	1	0	1	0	0	1	0	0
22	18247883	.	T	C	2	5	7	0	0	7	0	0
22	18376359	.	C	A	5	2	7	0	2	9	0	0
22	18376434	.	G	A	8	3	11	0	0	11	0	0
22	18376467	.	A	C	4	2	6	0	2	8	0	0
22	18459182	.	C	T	10	6	16	0	0	16	0	0
22	18461964	.	C	T	5	5	10	0	0	10	0	0
22	18462018	.	A	G	10	6	16	0	0	16	0	0
22	18462239	.	C	T	16	8	24	0	0	24	0	0
22	18464455	.	T	C	3	4	7	0	0	7	0	0
22	18488823	.	T	C	2	6	8	0	0	8	0	0
22	18488952	.	C	A	3	6	9	0	0	9	0	0
22	18489191	.	A	G	1	2	3	0	1	4	0	0
22	18542090	.	C	T	27	13	40	0	2	42	0	0
22	18542393	.	C	T	11	18	29	0	0	29	0	0
22	18542508	.	A	G	27	9	36	0	1	37	0	0
22	18542720	.	A	T	12	17	29	0	0	29	0	0
22	18543819	.	C	G	30	22	52	0	1	53	0	0
22	18543847	.	T	G	32	25	57	0	0	57	0	0
22	18544465	.	C	T	0	5	5	0	8	13	0	0
22	18544992	.	T	C	11	5	16	0	1	17	0	0
22	18725485	.	T	A	3	4	7	0	0	7	0	0
22	18726040	.	A	T	17	13	30	0	1	31	0	0
22	18726470	.	A	T	22	21	43	0	2	45	0	0
22	18726505	.	T	A	24	17	41	0	1	42	0	0
22	18726668	.	C	A	14	16	30	0	0	30	0	0
22	18727787	.	C	A	0	7	7	0	10	17	0	0
22	18727890	.	G	A	9	10	19	0	2	21	0	0
22	18736155	.	T	C	15	0	15	0	18	33	0	0
22	18736182	.	C	T	13	14	27	0	3	30	0	0
22	18736859	.	A	G	12	20	32	0	1	33	0	0
22	18746486	.	A	G	5	8	13	0	0	13	0	0
22	18778872	.	C	T	21	26	47	0	0	47	0	0
22	18778895	.	A	C	19	26	45	0	2	47	0	0
22	18799110	.	T	G	2	0	2	0	0	2	0	0
22	18799190	.	C	T	4	3	7	0	2	9	0	0
22	18971667	.	T	C	3	4	7	1	0	8	0	0
22	18971697	.	T	C	5	7	12	0	0	12	0	0
22	18971725	.	T	C	4	5	9	0	0	9	0	0
22	18971736	.	T	C	3	3	6	0	0	6	0	0
22	19004947	.	A	G	3	2	5	0	0	5	0	0
22	19004950	.	A	T	3	2	5	0	0	5	0	0
22	19006676	.	A	G	4	4	8	0	0	8	0	0
22	19006763	.	T	C	7	7	14	0	1	15	0	0
22	19006994	.	T	C	15	15	30	0	0	30	0	0
22	19007574	.	A	G	10	6	16	0	3	19	0	0
22	19007677	.	C	A	5	8	13	0	2	15	0	0
22	19007764	.	A	G	4	6	10	0	1	11	0	0
22	19024732	.	T	G	1	0	1	0	0	1	0	0
22	19067550	.	C	T	3	1	4	0	0	4	0	0
22	19547501	.	A	T	4	11	15	0	0	15	0	0
22	19547573	.	C	G	1	9	10	0	9	19	0	0
22	19547575	.	A	C	9	0	9	0	10	19	0	0
22	19547796	.	C	T	14	23	37	0	1	38	0	0
22	19552745	.	C	T	10	12	22	0	1	23	0	0
22	19642960	.	T	A	3	5	8	0	0	8	0	0
22	19643017	.	A	G	4	0	4	0	5	9	0	0
22	19643020	.	G	A	0	5	5	0	5	10	0	0
22	19645155	.	G	A	2	5	7	0	1	8	0	0
22	19645170	.	G	A	2	6	8	0	2	10	0	0
22	19645233	.	T	C	6	8	14	0	1	15	0	0
22	19645464	.	A	G	5	0	5	0	5	10	0	0
22	19645673	.	C	G	4	1	5	0	5	10	0	0
22	19645802	.	G	A	3	5	8	0	0	8	0	0
22	19665618	.	C	T	5	2	7	0	0	7	0	0
22	19671776	.	A	G	13	10	23	0	0	23	0	0
22	20105123	.	C	G	4	2	6	0	0	6	0	0
22	20105353	.	G	A	4	2	6	0	0	6	0	0
22	20105686	.	T	C	2	2	4	0	0	4	0	0
22	20140913	.	G	A	0	2	2	0	3	5	0	0
22	20141632	.	T	C	3	2	5	0	0	5	0	0
22	20141635	.	C	A	3	2	5	0	0	5	0	0
22	20142160	.	T	C	3	2	5	0	1	6	0	0
22	20142178	.	A	T	1	1	2	0	1	3	0	0
22	20142753	.	T	A	2	2	4	0	0	4	0	0
22	20143002	.	G	T	2	3	5	0	0	5	0	0
22	20143138	.	A	G	2	2	4	0	1	5	0	0
22	20143143	.	G	T	2	4	6	0	0	6	0	0
22	20159200	.	A	C	13	7	20	0	2	22	0	0
22	20159576	.	A	T	12	21	33	0	1	34	0	0
22	20159771	.	C	A	16	18	34	0	3	37	0	0
22	20164449	.	T	C	1	2	3	0	0	3	0	0
22	20169411	.	A	C	0	1	1	0	0	1	0	0
22	20169429	.	G	A	0	1	1	0	0	1	0	0
22	20172105	.	A	G	2	0	2	0	0	2	0	0
22	20172642	.	A	G	6	4	10	0	1	11	0	0
22	20175295	.	G	A	8	10	18	0	1	19	0	0
22	20177970	.	G	A	0	6	6	0	6	12	0	0
22	20177981	.	G	A	5	8	13	0	0	13	0	0
22	20178045	.	C	T	5	5	10	0	1	11	0	0
22	20178065	.	T	C	5	6	11	0	0	11	0	0
22	20202641	.	G	A	7	3	10	0	0	10	0	0
22	20211289	.	G	T	0	3	3	0	0	3	0	0
22	20212794	.	G	T	0	3	3	0	5	8	0	0
22	20214649	.	G	A	0	5	5	0	4	9	0	0
22	20215089	.	T	A	5	6	11	0	0	11	0	0
22	20215351	.	C	T	3	0	3	0	0	3	0	0
22	20220161	.	A	G	2	1	3	0	8	11	0	0
22	20220197	.	C	T	6	14	20	0	1	21	0	0
22	20222950	.	G	C	0	2	2	0	0	2	0	0
22	20230044	.	T	C	1	0	1	0	0	1	0	0
22	20240483	.	T	C	16	14	30	0	0	30	0	0
22	20240835	.	A	G	13	11	24	0	0	24	0	0
22	20292544	.	A	T	3	3	6	0	0	6	0	0
22	20292595	.	A	T	6	14	20	0	0	20	0	0
22	20292789	.	T	C	19	22	41	0	1	42	0	0
22	20293440	.	G	A	15	12	27	0	2	29	0	0
22	20296615	.	A	T	17	19	36	0	1	37	0	0
22	20296669	.	T	C	12	10	22	0	2	24	0	0
22	20299280	.	A	G	7	8	15	0	0	15	0	0
22	20299283	.	G	A	7	9	16	0	0	16	0	0
22	20299349	.	T	C	16	27	43	0	2	45	0	0
22	20303406	.	A	G	17	11	28	1	0	29	0	0
22	20303412	.	G	T	18	11	29	1	3	33	0	0
22	20303487	.	A	G	1	4	5	0	0	5	0	0
22	20305443	.	G	T	23	10	33	0	3	36	0	0
22	20313722	.	C	A	10	14	24	0	7	31	0	0
22	20313791	.	A	G	16	12	28	0	1	29	0	0
22	20313887	.	C	G	17	13	30	0	0	30	0	0
22	20313926	.	C	A	0	13	13	0	9	22	0	0
22	20315851	.	T	C	12	1	13	0	6	19	0	0
22	20315883	.	C	T	14	9	23	0	2	25	0	0
22	20315896	.	G	A	14	11	25	0	1	26	0	0
22	20316020	.	G	A	2	1	3	0	0	3	0	0
22	20318937	.	C	T	0	5	5	0	11	16	0	0
22	20319149	.	A	G	8	2	10	0	0	10	0	0
22	20388853	.	G	A	9	11	20	0	0	20	0	0
22	20389198	.	C	A	12	13	25	0	0	25	0	0
22	20389286	.	A	G	3	7	10	0	1	11	0	0
22	20389392	.	A	G	4	10	14	0	1	15	0	0
22	20389538	.	A	T	8	16	24	0	0	24	0	0
22	20389545	.	G	A	8	14	22	0	0	22	0	0
22	20389580	.	T	G	9	13	22	0	3	25	0	0
22	20389620	.	T	A	13	6	19	0	0	19	0	0
22	20390002	.	C	A	9	6	15	0	1	16	0	0
22	20390041	.	C	T	10	10	20	0	0	20	0	0
22	20402889	.	T	C	4	3	7	0	0	7	0	0
22	20407002	.	C	T	0	4	4	0	3	7	0	0
22	20408865	.	T	C	8	1	9	0	10	19	0	0
22	20409099	.	C	T	0	4	4	0	1	5	0	0
22	20473596	.	G	A	0	2	2	0	1	3	0	0
22	20475073	.	G	A	1	2	3	0	0	3	0	0
22	20475994	.	T	C	3	2	5	0	0	5	0	0
22	20478274	.	T	C	3	2	5	0	0	5	0	0
22	20574066	.	T	C	10	9	19	0	0	19	0	0
22	20574402	.	A	G	7	7	14	0	0	14	0	0
22	20574585	.	A	G	12	7	19	0	1	20	0	0
22	20783269	.	T	A	4	2	6	0	0	6	0	0
22	20791016	.	T	C	3	2	5	0	0	5	0	0
22	20792042	.	G	A	3	4	7	0	0	7	0	0
22	20792054	.	T	C	3	4	7	0	0	7	0	0
22	20797280	.	G	A	0	2	2	0	0	2	0	0
22	20797511	.	A	G	2	4	6	0	0	6	0	0
22	20797556	.	G	A	2	4	6	0	0	6	0	0
22	20801844	.	C	T	1	3	4	0	0	4	0	0
22	20806394	.	G	A	2	3	5	0	0	5	0	0
22	20848297	.	G	A	3	3	6	0	0	6	0	0
22	20848326	.	C	T	3	3	6	0	0	6	0	0
22	20848488	.	G	A	5	7	12	0	0	12	0	0
22	20848501	.	A	G	6	7	13	0	0	13	0	0
22	20849615	.	T	C	0	0	0	0	4	4	0	0
22	20877036	.	T	C	3	0	3	0	2	5	0	0
22	20926412	.	C	T	4	6	10	0	0	10	0	0
22	20926466	.	G	A	9	4	13	0	1	14	0	0
22	20926511	.	G	A	11	6	17	0	3	20	0	0
22	20940039	.	C	T	0	2	2	0	4	6	0	0
22	20940048	.	G	A	6	3	9	0	0	9	0	0
22	20944679	.	A	G	10	8	18	0	0	18	0	0
22	20951387	.	T	C	8	0	8	0	5	13	0	0
22	20951514	.	C	T	0	10	10	0	9	19	0	0
22	20951788	.	G	A	13	17	30	0	0	30	0	0
22	20951861	.	C	T	13	10	23	0	0	23	0	0
22	20951866	.	G	T	10	11	21	0	0	21	0	0
22	20952257	.	A	G	17	16	33	0	0	33	0	0
22	20952292	.	A	T	17	16	33	0	0	33	0	0
22	20953053	.	T	A	6	8	14	0	0	14	0	0
22	20953127	.	A	T	8	5	13	0	0	13	0	0
22	20953141	.	C	A	7	5	12	0	0	12	0	0
22	20953418	.	G	A	7	10	17	0	2	19	0	0
22	20953555	.	C	A	17	5	22	0	0	22	0	0
22	20954386	.	C	T	8	3	11	0	0	11	0	0
22	20954391	.	C	T	8	3	11	0	0	11	0	0
22	20954557	.	T	A	6	13	19	0	1	20	0	0
22	20954717	.	A	T	12	11	23	0	2	25	0	0
22	20954810	.	C	T	0	21	21	0	12	33	0	0
22	20954953	.	C	T	10	25	35	0	0	35	0	0
22	20955427	.	C	T	0	4	4	0	7	11	0	0
22	20955469	.	C	T	0	7	7	0	6	13	0	0
22	21032184	.	A	G	1	0	1	0	0	1	0	0
22	21128200	.	A	G	12	10	22	0	0	22	0	0
22	21129075	.	G	A	29	30	59	0	2	62	1	0
22	21129101	.	G	A	25	34	59	0	3	62	0	0
22	21129407	.	A	G	28	36	64	0	3	67	0	0
22	21129558	.	T	G	25	37	62	0	0	63	1	0
22	21129575	.	T	C	25	37	62	0	1	63	0	0
22	21676215	.	A	G	0	3	3	0	0	3	0	0
22	21676233	.	G	A	1	7	8	0	0	8	0	0
22	21676296	.	G	A	2	9	11	0	0	11	0	0
22	21755248	.	T	C	1	5	6	0	0	6	0	0
22	22129568	.	T	A	4	4	8	0	0	8	0	0
22	22129586	.	T	C	5	5	10	0	0	10	0	0
22	22129754	.	A	G	2	8	10	0	1	11	0	0
22	22130085	.	C	T	4	2	6	0	0	6	0	0
22	22130255	.	G	A	0	8	8	0	0	8	0	0
22	22141175	.	C	T	1	2	3	0	2	5	0	0
22	22164013	.	A	G	2	3	5	0	0	5	0	0
22	22179714	.	A	G	8	2	10	0	0	10	0	0
22	22188715	.	T	C	13	9	22	0	4	26	0	0
22	22188717	.	C	T	17	9	26	0	0	26	0	0
22	22196339	.	G	A	6	5	11	0	2	13	0	0
22	22199227	.	G	A	6	9	15	0	0	15	0	0
22	22204002	.	C	T	9	4	13	0	0	13	0	0
22	22204098	.	C	T	4	7	11	0	0	11	0	0
22	22204395	.	G	A	6	7	13	0	1	14	0	0
22	22204440	.	G	A	1	1	2	0	0	2	0	0
22	22214640	.	G	A	7	9	16	0	1	17	0	0
22	22215458	.	G	T	4	5	9	0	0	9	0	0
22	22234750	.	G	A	8	11	19	0	1	20	0	0
22	22241769	.	A	G	5	2	7	0	0	7	0	0
22	22241772	.	A	T	4	3	7	0	0	8	1	0
22	22245400	.	T	C	3	4	7	0	0	7	0	0
22	22245435	.	C	T	4	11	15	0	0	15	0	0
22	22245617	.	A	G	3	5	8	0	0	8	0	0
22	22245812	.	C	T	6	8	14	0	1	15	0	0
22	22251493	.	A	C	3	0	3	0	3	6	0	0
22	22260456	.	G	A	1	2	3	0	0	3	0	0
22	22266519	.	T	C	6	5	11	0	0	11	0	0
22	22267524	.	G	C	0	2	2	0	1	3	0	0
22	22273465	.	G	A	4	5	9	0	1	10	0	0
22	22273871	.	A	C	5	13	18	0	1	19	0	0
22	22274000	.	A	T	4	6	10	0	0	10	0	0
22	22274137	.	C	T	4	4	8	0	0	8	0	0
22	22274157	.	G	T	4	4	8	0	0	8	0	0
22	22276418	.	C	T	1	2	3	0	0	3	0	0
22	22297936	.	C	T	1	2	3	0	0	3	0	0
22	22303024	.	A	G	2	0	2	0	1	3	0	0
22	22303230	.	A	G	1	2	3	0	0	3	0	0
22	22303305	.	T	C	0	1	1	0	0	1	0	0
22	22311283	.	T	C	3	4	7	0	0	7	0	0
22	22311316	.	C	T	3	1	4	0	0	4	0	0
22	22312313	.	A	G	0	1	1	0	0	3	2	0
22	22313104	.	A	T	1	2	3	0	1	4	0	0
22	22313376	.	T	C	6	3	9	0	0	9	0	0
22	22313651	.	C	A	5	0	5	0	0	5	0	0
22	22313652	.	G	T	0	0	0	0	5	5	0	0
22	22313686	.	G	A	0	5	5	0	2	7	0	0
22	22313710	.	C	A	4	4	8	0	1	9	0	0
22	22313794	.	G	A	8	3	11	0	3	14	0	0
22	22313927	.	G	C	3	4	7	0	0	7	0	0
22	22313959	.	C	T	3	2	5	0	0	5	0	0
22	22314427	.	G	T	8	9	17	0	0	17	0	0
22	22314430	.	A	C	7	9	16	0	1	17	0	0
22	22314721	.	A	G	14	11	25	0	0	25	0	0
22	22315048	.	T	C	3	4	7	0	1	8	0	0
22	22345136	.	C	T	0	16	16	0	5	21	0	0
22	22345179	.	A	C	11	8	19	0	0	19	0	0
22	22345197	.	C	T	13	8	21	0	0	21	0	0
22	22345255	.	G	A	11	15	26	0	0	26	0	0
22	22345367	.	C	T	1	7	8	0	14	22	0	0
22	22345403	.	G	A	9	13	22	0	0	22	0	0
22	22345418	.	G	A	13	17	30	0	0	30	0	0
22	22348234	.	A	G	4	3	7	0	0	7	0	0
22	22350963	.	C	T	2	3	5	0	1	6	0	0
22	22351103	.	A	T	2	1	3	0	0	3	0	0
22	22352249	.	C	T	9	6	15	0	0	15	0	0
22	22352312	.	T	C	12	9	21	0	0	21	0	0
22	22353128	.	G	A	12	15	27	0	0	27	0	0
22	22353222	.	G	A	8	6	14	0	1	15	0	0
22	22353416	.	A	G	8	9	17	0	0	17	0	0
22	22353470	.	G	A	4	12	16	0	1	17	0	0
22	22353803	.	C	T	0	5	5	0	6	11	0	0
22	22353822	.	G	A	7	5	12	0	0	12	0	0
22	22353887	.	G	A	7	10	17	0	1	18	0	0
22	22353902	.	G	A	7	8	15	0	0	15	0	0
22	22354145	.	G	A	4	4	8	0	0	8	0	0
22	22354698	.	C	T	0	3	3	0	1	4	0	0
22	22354867	.	C	T	0	1	1	0	0	1	0	0
22	22376081	.	G	C	2	0	2	0	1	3	0	0
22	22376174	.	C	T	0	3	3	0	5	8	0	0
22	22397336	.	G	A	6	7	13	0	0	13	0	0
22	22397402	.	A	C	8	0	8	0	5	13	0	0
22	22418342	.	C	T	2	2	4	0	0	4	0	0
22	22418446	.	A	G	4	0	4	0	5	9	0	0
22	22422264	.	C	T	2	0	2	0	1	3	0	0
22	22422270	.	G	T	2	1	3	0	0	3	0	0
22	22424085	.	A	T	1	5	6	0	1	7	0	0
22	22424106	.	G	A	0	3	3	0	3	6	0	0
22	22427415	.	T	C	6	12	18	0	0	18	0	0
22	22427612	.	C	T	7	3	10	0	0	10	0	0
22	22428125	.	T	C	1	5	6	0	0	6	0	0
22	22428190	.	T	G	1	2	3	0	0	3	0	0
22	22428194	.	T	G	1	2	3	0	0	3	0	0
22	22634971	.	G	T	1	2	3	0	0	3	0	0
22	22636260	.	A	G	1	2	3	0	0	3	0	0
22	22636434	.	T	C	2	0	2	0	2	4	0	0
22	22978041	.	A	G	2	2	4	0	1	5	0	0
22	22982792	.	G	A	0	2	2	0	0	2	0	0
22	22995776	.	G	A	0	1	1	0	0	1	0	0
22	24360169	.	C	T	4	2	6	0	0	6	0	0
22	24361095	.	A	G	10	9	19	0	0	19	0	0
22	25942829	.	A	C	7	6	13	0	0	13	0	0
22	26180265	.	T	C	1	12	13	0	1	14	0	0
22	26180280	.	A	G	1	11	12	0	0	12	0	0
22	26180300	.	C	T	1	11	12	0	1	13	0	0
22	26858153	.	T	C	2	0	2	0	5	7	0	0
22	29585244	.	G	A	4	2	6	0	0	6	0	0
22	29585247	.	G	C	4	2	6	0	0	6	0	0
22	29612096	.	A	G	2	2	4	0	0	4	0	0
22	29615056	.	A	G	3	3	6	0	0	6	0	0
22	29617050	.	G	A	1	1	2	0	0	2	0	0
22	29620258	.	G	T	6	2	8	0	0	8	0	0
22	29620306	.	A	G	4	6	10	0	0	10	0	0
22	29620488	.	T	G	4	7	11	0	0	11	0	0
22	29640098	.	T	C	1	4	5	0	0	5	0	0
22	29651938	.	C	T	12	25	37	0	1	38	0	0
22	29652161	.	T	A	4	17	21	0	0	21	0	0
22	29652201	.	A	G	8	0	8	0	13	21	0	0
22	29657463	.	G	A	1	2	3	0	0	3	0	0
22	29659031	.	T	A	5	4	9	0	0	9	0	0
22	29659637	.	G	A	13	10	23	0	2	25	0	0
22	29666501	.	G	A	15	19	34	0	1	35	0	0
22	29666505	.	C	T	0	17	17	0	20	37	0	0
22	29666746	.	G	A	8	5	13	0	0	13	0	0
22	29668796	.	C	T	2	3	5	0	0	5	0	0
22	29668799	.	C	T	2	3	5	0	0	5	0	0
22	29670324	.	G	A	8	6	14	0	0	14	0	0
22	29671553	.	A	G	3	3	6	0	0	6	0	0
22	29689458	.	T	C	5	2	7	0	0	7	0	0
22	29858936	.	T	C	6	16	22	0	0	22	0	0
22	30359955	.	G	T	12	3	15	0	0	15	0	0
22	31383515	.	A	G	0	1	1	0	0	1	0	0
22	31387676	.	T	C	2	1	3	0	0	3	0	0
22	31389400	.	A	C	2	2	4	0	0	4	0	0
22	31404427	.	T	A	3	5	8	0	0	8	0	0
22	31406548	.	G	A	1	4	5	0	2	7	0	0
22	31407859	.	C	G	3	0	3	0	2	5	0	0
22	31466141	.	G	A	4	5	9	0	0	9	0	0
22	31513575	.	C	T	0	2	2	0	0	2	0	0
22	31517163	.	A	G	2	4	6	0	0	6	0	0
22	33190241	.	C	T	10	5	15	0	0	15	0	0
22	33190835	.	C	T	10	19	29	0	0	29	0	0
22	33190874	.	T	G	10	1	11	0	16	27	0	0
22	33190994	.	C	T	10	11	21	0	0	21	0	0
22	33191033	.	C	A	18	15	33	0	0	33	0	0
22	33191039	.	C	T	15	16	31	0	0	31	0	0
22	33191097	.	A	G	12	15	27	0	1	28	0	0
22	33191312	.	C	G	13	1	14	0	9	23	0	0
22	33191426	.	G	T	0	5	5	0	5	10	0	0
22	33191831	.	C	A	11	9	20	0	0	20	0	0
22	33191852	.	G	T	0	5	5	0	8	13	0	0
22	33192392	.	T	G	7	0	7	0	19	26	0	0
22	33192496	.	G	A	10	11	21	0	0	21	0	0
22	33193261	.	C	T	9	4	13	0	0	13	0	0
22	33193821	.	G	T	6	5	11	0	0	11	0	0
22	33194419	.	T	A	8	6	14	0	1	15	0	0
22	33194475	.	C	T	5	7	12	0	0	12	0	0
22	33194507	.	G	A	0	9	9	0	7	16	0	0
22	33194627	.	A	T	2	8	10	0	0	10	0	0
22	33364271	.	A	T	1	1	2	0	0	2	0	0
22	33364536	.	C	T	6	5	11	0	0	11	0	0
22	33364558	.	G	A	0	7	7	0	3	10	0	0
22	33371364	.	G	A	0	0	0	0	2	2	0	0
22	33378098	.	G	A	0	8	8	0	3	11	0	0
22	33378253	.	C	T	4	2	6	0	0	6	0	0
22	33378256	.	A	T	4	2	6	0	0	6	0	0
22	33378432	.	A	T	2	4	6	0	1	7	0	0
22	33378445	.	G	T	4	5	9	0	0	9	0	0
22	33378479	.	G	A	0	4	4	0	7	11	0	0
22	33535881	.	C	T	0	3	3	0	3	6	0	0
22	33535884	.	C	T	0	3	3	0	2	5	0	0
22	33591895	.	C	T	0	2	2	0	5	7	0	0
22	33592530	.	G	T	11	8	19	0	1	20	0	0
22	33592708	.	T	C	8	0	8	0	15	23	0	0
22	33639382	.	C	T	0	0	0	0	2	2	0	0
22	33639388	.	G	A	2	5	7	0	0	7	0	0
22	33639418	.	G	A	12	6	18	0	0	18	0	0
22	33791076	.	G	T	0	1	1	1	0	2	0	0
22	33915644	.	A	T	4	3	7	0	1	8	0	0
22	33915896	.	T	G	5	7	12	0	1	13	0	0
22	34391029	.	G	T	0	2	2	0	0	2	0	0
22	34431166	.	T	C	7	5	12	0	0	12	0	0
22	34431702	.	C	T	6	3	9	0	0	9	0	0
22	34701901	.	G	C	12	24	36	0	2	38	0	0
22	34706938	.	T	C	19	15	34	0	0	34	0	0
22	34707041	.	A	G	33	2	35	0	13	48	0	0
22	34707062	.	T	G	32	6	38	0	0	38	0	0
22	34707084	.	C	T	25	15	40	0	2	42	0	0
22	34707119	.	G	T	22	20	42	0	1	43	0	0
22	34707272	.	T	A	17	10	27	0	6	33	0	0
22	34707295	.	C	T	12	7	19	0	2	21	0	0
22	34817506	.	G	C	0	2	2	0	0	2	0	0
22	34843569	.	C	T	1	4	5	0	0	5	0	0
22	34843892	.	C	T	0	2	2	0	3	5	0	0
22	34843910	.	T	C	3	2	5	0	0	5	0	0
22	34843964	.	C	A	0	0	0	0	1	1	0	0
22	34847690	.	A	G	4	4	8	0	0	8	0	0
22	34849108	.	G	A	5	2	7	0	0	7	0	0
22	34851302	.	T	C	1	0	1	0	2	3	0	0
22	34854810	.	A	C	2	2	4	0	0	4	0	0
22	35013549	.	A	T	3	2	5	0	0	5	0	0
22	35013675	.	C	T	0	5	5	0	4	9	0	0
22	35013679	.	C	T	4	5	9	0	0	9	0	0
22	35013855	.	A	T	2	3	5	0	0	5	0	0
22	35013856	.	T	G	2	3	5	0	0	5	0	0
22	35014014	.	G	A	4	3	7	0	0	7	0	0
22	35015828	.	C	T	3	4	7	0	0	7	0	0
22	35016177	.	G	A	7	6	13	0	0	13	0	0
22	35016185	.	A	G	7	6	13	0	0	13	0	0
22	35041537	.	T	C	0	1	1	0	0	1	0	0
22	35049063	.	A	G	0	2	2	0	0	2	0	0
22	35301978	.	T	C	1	2	3	0	0	3	0	0
22	35473126	.	G	A	6	2	8	0	0	8	0	0
22	35520389	.	C	T	1	3	4	0	0	4	0	0
22	35520412	.	G	A	0	3	3	0	1	4	0	0
22	35531002	.	C	T	1	4	5	0	0	5	0	0
22	35531122	.	G	A	2	2	4	0	0	4	0	0
22	35531196	.	G	A	3	2	5	0	0	5	0	0
22	35945668	.	G	A	0	7	7	0	1	8	0	0
22	37542836	.	C	A	2	7	9	0	0	9	0	0
22	37543070	.	A	T	10	8	18	0	0	18	0	0
22	37543656	.	A	G	3	2	5	0	0	5	0	0
22	37550984	.	A	G	4	15	19	0	1	20	0	0
22	37551029	.	A	G	2	6	8	0	0	8	0	0
22	37551369	.	G	T	3	9	12	0	1	13	0	0
22	37551481	.	G	C	5	0	5	0	2	7	0	0
22	37552783	.	A	C	9	3	12	0	9	21	0	0
22	37557308	.	A	C	3	0	3	0	1	4	0	0
22	37557531	.	G	A	8	10	18	0	0	18	0	0
22	37559603	.	G	A	2	2	4	0	0	4	0	0
22	37561642	.	C	G	3	2	5	0	0	5	0	0
22	37588622	.	T	C	10	0	10	0	7	17	0	0
22	37588667	.	A	C	9	12	21	0	1	22	0	0
22	37588715	.	T	C	15	5	20	0	0	20	0	0
22	37589420	.	T	C	5	5	10	0	0	10	0	0
22	37589430	.	T	C	6	4	10	0	0	10	0	0
22	37589634	.	C	T	9	13	22	0	0	22	0	0
22	37589779	.	T	G	10	7	17	0	0	17	0	0
22	37589782	.	T	G	10	7	17	0	0	17	0	0
22	37589818	.	C	T	0	4	4	0	8	12	0	0
22	37589848	.	T	G	7	6	13	0	1	14	0	0
22	37590230	.	A	G	6	5	11	0	0	11	0	0
22	37590260	.	A	G	10	7	17	0	1	18	0	0
22	37590470	.	A	T	6	7	13	0	0	13	0	0
22	37590486	.	C	T	6	8	14	0	0	14	0	0
22	37590611	.	T	G	3	4	7	0	1	8	0	0
22	37590710	.	T	G	4	7	11	0	0	11	0	0
22	37590711	.	C	T	4	7	11	0	0	11	0	0
22	37590925	.	T	C	6	2	8	0	0	8	0	0
22	37591023	.	A	C	2	5	7	0	0	7	0	0
22	37591073	.	G	A	3	9	12	0	0	12	0	0
22	37591074	.	T	G	3	9	12	0	0	12	0	0
22	37591457	.	T	C	9	4	13	0	0	13	0	0
22	37596823	.	A	G	2	4	6	0	0	6	0	0
22	37599007	.	C	A	2	0	2	0	0	2	0	0
22	37599076	.	A	G	1	3	4	0	1	5	0	0
22	37602479	.	A	C	1	4	5	0	1	6	0	0
22	37608435	.	T	C	1	0	1	0	4	5	0	0
22	37610043	.	C	T	0	3	3	0	1	4	0	0
22	37611589	.	A	G	2	2	4	0	0	4	0	0
22	37639239	.	C	T	6	6	12	0	1	13	0	0
22	37644009	.	C	A	14	12	26	0	1	27	0	0
22	37644021	.	C	G	11	11	22	0	1	23	0	0
22	37646124	.	C	T	4	4	8	0	0	8	0	0
22	37650110	.	T	G	4	0	4	0	4	8	0	0
22	37650246	.	C	T	3	3	6	0	0	6	0	0
22	37652191	.	C	T	4	7	11	0	0	11	0	0
22	37652850	.	C	T	11	14	25	0	0	25	0	0
22	37691852	.	C	T	3	5	8	0	0	8	0	0
22	37697408	.	C	T	9	5	14	0	1	15	0	0
22	37699569	.	T	C	0	0	0	0	1	1	0	0
22	37708199	.	T	A	17	18	35	0	0	35	0	0
22	37710223	.	A	G	7	5	12	0	0	12	0	0
22	37710241	.	A	G	7	5	12	0	0	12	0	0
22	37712558	.	A	G	9	11	20	0	0	20	0	0
22	37737696	.	A	G	2	0	2	0	0	2	0	0
22	37738195	.	C	T	2	0	2	0	0	2	0	0
22	37746900	.	G	C	0	2	2	0	0	2	0	0
22	37746901	.	G	A	0	2	2	0	0	2	0	0
22	37746944	.	A	G	2	4	6	0	0	6	0	0
22	37751709	.	A	G	1	1	2	0	0	2	0	0
22	37805329	.	C	T	21	16	37	0	1	38	0	0
22	37834045	.	G	T	9	7	16	0	0	16	0	0
22	37834164	.	G	C	4	11	15	0	0	15	0	0
22	37881090	.	A	G	2	5	7	0	0	7	0	0
22	37951928	.	C	A	1	4	5	0	0	5	0	0
22	38005108	.	C	A	0	2	2	0	1	3	0	0
22	38005162	.	C	G	0	1	1	0	0	1	0	0
22	38022099	.	T	G	1	0	1	0	0	1	0	0
22	38028903	.	A	G	1	1	2	0	0	2	0	0
22	38030803	.	C	T	0	2	2	0	0	2	0	0
22	38034577	.	A	T	2	2	4	0	0	4	0	0
22	38040070	.	T	G	1	1	2	0	0	2	0	0
22	38041959	.	C	T	1	2	3	0	0	3	0	0
22	38044902	.	G	C	0	13	13	0	7	21	1	0
22	38045009	.	T	A	9	9	18	0	1	19	0	0
22	38045213	.	G	T	1	2	3	0	0	3	0	0
22	38174040	.	C	T	4	3	7	0	0	7	0	0
22	38183600	.	A	G	1	3	4	0	0	4	0	0
22	38183669	.	C	T	1	7	8	0	0	8	0	0
22	38186385	.	C	A	0	1	1	0	0	1	0	0
22	38186409	.	A	G	1	4	5	0	0	5	0	0
22	38191715	.	A	G	6	8	14	0	1	15	0	0
22	38191778	.	T	G	9	10	19	0	1	20	0	0
22	38192440	.	A	G	5	9	14	0	0	14	0	0
22	38194415	.	A	G	3	5	8	0	0	8	0	0
22	38194419	.	G	C	2	3	5	0	0	5	0	0
22	38199709	.	A	C	14	9	23	0	1	24	0	0
22	38199716	.	C	T	15	7	22	0	1	24	1	0
22	38199864	.	C	A	11	8	19	0	0	19	0	0
22	38205072	.	A	G	10	6	16	0	0	16	0	0
22	38205099	.	C	T	0	4	4	0	9	13	0	0
22	38209190	.	C	T	3	2	5	0	1	6	0	0
22	38209295	.	A	G	0	1	1	0	0	1	0	0
22	38216676	.	A	G	2	2	4	0	0	4	0	0
22	38216690	.	G	T	1	2	3	0	0	3	0	0
22	38217308	.	G	C	1	0	1	0	0	1	0	0
22	38224077	.	G	T	2	5	7	0	0	7	0	0
22	38224197	.	A	T	9	3	12	0	0	12	0	0
22	38276083	.	T	A	5	6	11	0	0	11	0	0
22	38280834	.	T	G	1	0	1	0	3	4	0	0
22	38283993	.	A	G	1	3	4	0	0	4	0	0
22	38284020	.	A	C	2	4	6	0	0	6	0	0
22	38284047	.	G	A	2	2	4	0	0	4	0	0
22	38286866	.	T	C	0	3	3	0	0	3	0	0
22	38286875	.	G	A	0	3	3	0	0	3	0	0
22	38293836	.	G	A	0	6	6	0	10	16	0	0
22	38293866	.	A	T	8	8	16	0	2	18	0	0
22	38294005	.	A	G	3	0	3	0	5	8	0	0
22	38294010	.	T	C	4	4	8	0	0	8	0	0
22	38337414	.	T	C	4	4	8	1	2	11	0	0
22	38337417	.	A	C	5	0	5	1	3	9	0	0
22	38343178	.	G	A	3	2	5	0	0	5	0	0
22	38396186	.	C	G	2	4	6	0	0	6	0	0
22	38400375	.	G	C	3	2	5	0	1	6	0	0
22	38468163	.	A	G	4	7	11	0	0	11	0	0
22	38468562	.	C	T	0	18	18	0	15	33	0	0
22	38469848	.	C	A	0	14	14	0	23	37	0	0
22	38469856	.	G	A	22	14	36	0	1	37	0	0
22	38469884	.	G	A	13	16	29	0	1	30	0	0
22	38469926	.	G	A	6	1	7	0	1	8	0	0
22	38471854	.	T	A	19	17	36	0	1	37	0	0
22	38474186	.	G	A	4	3	7	0	0	7	0	0
22	38475506	.	C	A	1	4	5	0	0	5	0	0
22	38475593	.	A	G	25	17	42	0	1	43	0	0
22	38492116	.	G	A	16	14	30	0	0	30	0	0
22	38499700	.	C	T	7	9	16	0	0	16	0	0
22	38499727	.	C	T	0	1	1	0	3	4	0	0
22	38501788	.	A	G	8	8	16	0	1	17	0	0
22	38501815	.	G	C	12	10	22	0	2	24	0	0
22	38508006	.	C	A	9	11	20	0	1	21	0	0
22	38508018	.	C	A	11	11	22	0	0	22	0	0
22	38508100	.	C	T	2	4	6	0	1	7	0	0
22	38508102	.	C	T	2	5	7	0	0	7	0	0
22	38516814	.	A	T	8	7	15	0	0	15	0	0
22	38516816	.	C	T	8	6	14	0	1	15	0	0
22	38516893	.	C	T	3	11	14	0	1	15	0	0
22	38516899	.	G	A	7	4	11	0	0	11	0	0
22	38520336	.	A	C	11	1	12	0	8	20	0	0
22	38520360	.	A	C	11	10	21	0	1	22	0	0
22	38521095	.	T	C	11	9	20	0	1	21	0	0
22	38521154	.	G	C	7	9	16	0	0	16	0	0
22	38521454	.	C	A	2	8	10	0	1	11	0	0
22	38521596	.	C	G	3	6	9	0	0	9	0	0
22	38521630	.	A	G	17	10	27	0	0	27	0	0
22	38521743	.	C	T	4	4	8	0	0	8	0	0
22	38521949	.	T	A	7	13	20	0	0	20	0	0
22	38522431	.	T	A	6	6	12	0	0	12	0	0
22	38522436	.	T	C	7	0	7	0	5	12	0	0
22	38522468	.	C	T	4	5	9	0	2	11	0	0
22	38522622	.	G	C	12	16	28	0	0	28	0	0
22	38522711	.	G	A	15	8	23	0	0	23	0	0
22	38523376	.	A	C	2	0	2	0	5	7	0	0
22	38523658	.	A	T	13	7	20	0	0	20	0	0
22	38523917	.	C	A	0	12	12	0	7	19	0	0
22	38524033	.	T	C	4	12	16	0	0	16	0	0
22	38524107	.	C	T	1	5	6	0	0	6	0	0
22	38524536	.	T	G	4	9	13	0	0	13	0	0
22	38524539	.	C	T	0	9	9	0	4	13	0	0
22	38524616	.	A	T	3	6	9	0	1	10	0	0
22	38524621	.	G	C	6	3	9	0	2	11	0	0
22	38524701	.	T	G	3	4	7	0	1	8	0	0
22	38524740	.	A	C	2	5	7	0	0	7	0	0
22	38524771	.	G	A	3	5	8	0	0	8	0	0
22	38525082	.	G	A	6	0	6	0	0	6	0	0
22	38525146	.	A	G	6	2	8	0	0	8	0	0
22	38525155	.	A	T	6	1	7	0	1	8	0	0
22	38525326	.	T	G	2	6	8	0	1	9	0	0
22	38525789	.	A	C	7	3	10	0	0	10	0	0
22	38525996	.	G	T	3	5	8	0	0	8	0	0
22	38530277	.	T	C	3	4	7	0	0	7	0	0
22	38545882	.	A	C	4	0	4	0	3	7	0	0
22	38545921	.	C	T	0	5	5	0	4	9	0	0
22	38549152	.	G	A	0	2	2	0	0	2	0	0
22	38549990	.	A	G	4	1	5	0	0	5	0	0
22	38559907	.	A	G	1	0	1	0	0	1	0	0
22	38566147	.	T	C	0	1	1	0	0	1	0	0
22	38567348	.	C	T	0	4	4	0	2	6	0	0
22	38567431	.	G	A	1	0	1	0	0	1	0	0
22	38615295	.	T	C	8	0	8	0	3	11	0	0
22	38796464	.	G	T	1	3	4	0	1	5	0	0
22	38796652	.	A	T	4	2	6	0	2	8	0	0
22	38796689	.	G	A	4	2	6	0	0	6	0	0
22	38796813	.	A	T	0	2	2	2	0	4	0	0
22	38800038	.	T	A	4	6	10	0	0	10	0	0
22	38800183	.	T	C	1	0	1	0	2	3	0	0
22	38911514	.	C	T	4	2	6	0	0	6	0	0
22	38911607	.	T	G	1	2	3	0	0	3	0	0
22	38912426	.	C	T	1	4	5	0	0	5	0	0
22	38912445	.	A	G	2	3	5	0	0	5	0	0
22	38915088	.	C	T	4	3	7	0	0	7	0	0
22	38918963	.	G	A	0	3	3	0	3	6	0	0
22	38918965	.	T	A	3	3	6	0	0	6	0	0
22	38919010	.	A	C	1	4	5	0	0	5	0	0
22	38925404	.	A	G	0	0	0	0	1	1	0	0
22	38928275	.	T	A	5	4	9	0	0	9	0	0
22	38928367	.	G	C	0	5	5	0	5	10	0	0
22	38928475	.	C	T	3	2	5	0	0	5	0	0
22	38928677	.	C	G	1	3	4	0	0	4	0	0
22	38930738	.	A	T	1	2	3	0	0	3	0	0
22	38932288	.	G	A	10	11	21	0	0	21	0	0
22	38932327	.	G	A	12	10	22	0	2	24	0	0
22	38934663	.	C	T	1	2	3	0	1	4	0	0
22	38935074	.	A	G	3	2	5	0	0	5	0	0
22	38935083	.	C	T	4	4	8	0	0	8	0	0
22	38937336	.	A	G	4	0	4	0	4	8	0	0
22	38943059	.	T	C	3	3	6	0	0	6	0	0
22	38943113	.	T	C	1	4	5	0	0	5	0	0
22	38943688	.	A	G	0	1	1	0	0	1	0	0
22	38945312	.	C	T	1	1	2	0	0	2	0	0
22	38947013	.	G	A	14	8	22	0	0	22	0	0
22	38947040	.	G	A	11	6	17	0	0	17	0	0
22	38951084	.	T	C	8	8	16	0	1	17	0	0
22	38951186	.	G	T	2	3	5	0	0	5	0	0
22	39015190	.	T	C	2	2	4	0	0	4	0	0
22	39015203	.	A	T	2	3	5	0	0	5	0	0
22	39017130	.	G	A	1	4	5	0	1	6	0	0
22	39023330	.	A	G	2	0	2	0	2	4	0	0
22	39023444	.	A	G	3	0	3	0	5	8	0	0
22	39023646	.	A	G	4	0	4	0	6	10	0	0
22	39023680	.	C	A	6	5	11	0	1	12	0	0
22	39023804	.	T	G	6	0	6	0	5	11	0	0
22	39023863	.	G	C	0	7	7	0	6	13	0	0
22	39023877	.	T	A	4	7	11	0	1	12	0	0
22	39024002	.	T	A	0	2	2	0	0	2	0	0
22	39024005	.	C	A	0	2	2	0	0	2	0	0
22	39026706	.	T	C	3	2	5	0	0	5	0	0
22	39028350	.	G	A	0	6	6	0	5	11	0	0
22	39033036	.	C	G	6	3	9	0	0	9	0	0
22	39033053	.	C	T	7	6	13	0	0	13	0	0
22	39033644	.	T	C	5	3	8	0	0	8	0	0
22	39033838	.	T	G	1	3	4	0	0	4	0	0
22	39054436	.	G	T	2	3	5	0	0	5	0	0
22	39054683	.	T	C	4	4	8	0	0	8	0	0
22	39079231	.	T	C	10	7	17	0	2	19	0	0
22	39079335	.	G	A	0	12	12	0	8	20	0	0
22	39079428	.	C	G	2	6	8	1	1	10	0	0
22	39079528	.	T	A	4	9	13	0	1	14	0	0
22	39079950	.	C	A	8	11	19	0	1	20	0	0
22	39079997	.	A	G	11	9	20	0	4	24	0	0
22	39080290	.	C	T	10	6	16	0	1	17	0	0
22	39080300	.	A	T	10	7	17	0	0	17	0	0
22	39080402	.	A	C	8	13	21	0	0	21	0	0
22	39080547	.	A	C	9	9	18	0	1	19	0	0
22	39080679	.	C	G	7	10	17	0	0	17	0	0
22	39080701	.	C	A	7	12	19	0	0	19	0	0
22	39080774	.	C	G	10	4	14	0	0	14	0	0
22	39081126	.	A	T	9	4	13	0	1	14	0	0
22	39081169	.	A	G	6	0	6	0	5	11	0	0
22	39081177	.	C	T	5	5	10	0	1	11	0	0
22	39081259	.	T	A	10	6	16	0	0	16	0	0
22	39084943	.	G	A	9	6	15	0	2	17	0	0
22	39087327	.	C	T	1	2	3	0	1	4	0	0
22	39090558	.	A	G	1	0	1	0	1	2	0	0
22	39093984	.	T	C	3	3	6	0	0	6	0	0
22	39096090	.	C	A	5	4	9	0	0	9	0	0
22	39100979	.	G	A	0	3	3	0	1	4	0	0
22	39100984	.	C	T	1	3	4	0	0	4	0	0
22	39103941	.	T	C	7	4	11	0	0	11	0	0
22	39104849	.	G	A	2	2	4	0	0	4	0	0
22	39105022	.	T	C	2	0	2	0	0	2	0	0
23	16928	.	G	A	3	2	5	0	0	5	0	0
23	16943	.	C	G	0	2	2	0	3	5	0	0
23	314850	.	T	C	1	6	7	0	0	7	0	0
23	320667	.	C	T	0	2	2	0	0	2	0	0
23	320690	.	G	A	1	7	8	0	0	8	0	0
23	327817	.	T	C	0	0	0	0	3	3	0	0
23	458254	.	T	C	7	7	14	0	1	15	0	0
23	460773	.	T	C	2	1	3	0	0	3	0	0
23	527384	.	T	C	3	4	7	0	0	7	0	0
23	585657	.	A	G	7	0	7	0	5	12	0	0
23	585848	.	A	G	5	0	5	0	9	14	0	0
23	587161	.	A	G	4	10	14	0	0	14	0	0
23	862489	.	T	C	2	2	4	0	0	4	0	0
23	863395	.	T	C	2	2	4	0	0	4	0	0
23	863574	.	T	C	4	2	6	0	1	7	0	0
23	864367	.	T	C	4	3	7	0	0	7	0	0
23	864470	.	T	C	1	2	3	0	0	3	0	0
23	1723720	.	A	G	4	0	4	0	4	8	0	0
23	1723748	.	G	A	1	1	2	0	0	2	0	0
23	1723992	.	C	T	4	3	7	0	0	7	0	0
23	1725456	.	T	C	7	6	13	0	0	13	0	0
23	1725664	.	G	A	3	2	5	0	0	5	0	0
23	1725785	.	G	C	3	6	9	0	0	9	0	0
23	1725803	.	G	C	4	6	10	0	0	10	0	0
23	1725959	.	C	T	10	5	15	0	0	15	0	0
23	1725974	.	T	A	10	5	15	0	0	15	0	0
23	1726080	.	T	C	11	9	20	0	0	20	0	0
23	1726106	.	G	T	13	5	18	0	1	19	0	0
23	1726467	.	T	A	5	4	9	0	0	9	0	0
23	2053414	.	A	G	2	2	4	0	0	4	0	0
23	2053418	.	C	A	2	3	5	0	0	5	0	0
23	2054010	.	C	T	5	10	15	0	0	15	0	0
23	2054316	.	C	G	5	6	11	0	0	11	0	0
23	2054505	.	G	A	3	8	11	0	0	11	0	0
23	2054584	.	G	C	4	4	8	0	0	8	0	0
23	2054613	.	A	G	5	5	10	0	0	10	0	0
23	2054622	.	T	C	5	0	5	0	4	9	0	0
23	2054838	.	C	T	0	4	4	0	8	12	0	0
23	2054886	.	A	G	4	4	8	0	0	8	0	0
23	2054952	.	T	G	5	3	8	0	0	8	0	0
23	2055162	.	G	A	4	4	8	0	0	8	0	0
23	2055219	.	T	C	1	2	3	0	0	3	0	0
23	2055240	.	T	A	1	0	1	0	0	1	0	0
23	2081004	.	T	G	2	2	4	0	0	4	0	0
23	2099158	.	A	G	7	5	12	0	0	12	0	0
23	2099214	.	A	G	6	4	10	0	0	10	0	0
23	2136417	.	T	C	2	9	11	0	1	12	0	0
23	2155134	.	T	C	0	2	2	0	0	2	0	0
23	2158054	.	T	C	1	1	2	0	0	2	0	0
23	2160242	.	T	C	3	1	4	0	2	6	0	0
23	2212977	.	A	C	1	3	4	0	0	4	0	0
23	2212993	.	A	G	2	3	5	0	0	5	0	0
23	2242494	.	T	C	2	3	5	0	0	5	0	0
23	2246536	.	G	A	1	2	3	0	0	3	0	0
23	2246855	.	C	G	0	0	0	0	2	2	0	0
23	2249537	.	A	G	0	0	0	0	1	1	0	0
23	2249589	.	G	A	0	3	3	0	1	4	0	0
23	2249633	.	T	C	1	2	3	0	0	3	0	0
23	2252812	.	G	A	1	1	2	0	1	3	0	0
23	2256142	.	G	C	2	2	4	0	0	4	0	0
23	2256348	.	C	T	2	2	4	0	0	4	0	0
23	2256349	.	A	T	2	2	4	0	0	4	0	0
23	2435776	.	G	A	2	0	2	0	0	2	0	0
23	2438388	.	G	A	10	13	23	0	3	26	0	0
23	2438463	.	G	T	1	7	8	0	14	22	0	0
23	2438641	.	A	T	11	14	25	0	0	25	0	0
23	2440698	.	G	A	4	3	7	0	0	7	0	0
23	2443160	.	C	T	19	20	39	0	0	39	0	0
23	2443613	.	C	T	12	27	39	0	0	39	0	0
23	2443772	.	T	C	6	2	8	0	1	9	0	0
23	2443782	.	T	C	6	2	8	0	1	9	0	0
23	2547556	.	A	C	4	5	9	0	0	9	0	0
23	2564339	.	T	A	11	8	19	0	1	20	0	0
23	2564420	.	T	C	14	15	29	0	0	29	0	0
23	2679634	.	G	A	0	1	1	0	6	7	0	0
23	2689807	.	T	C	3	10	13	0	0	13	0	0
23	2690659	.	C	T	4	5	9	0	0	9	0	0
23	2703173	.	C	T	1	2	3	0	0	3	0	0
23	2703243	.	T	A	0	4	4	0	0	4	0	0
23	2716519	.	C	A	3	3	6	0	0	6	0	0
23	2717852	.	A	C	9	16	25	0	3	28	0	0
23	2717867	.	T	G	11	18	29	0	1	30	0	0
23	2718009	.	C	G	10	14	24	0	0	24	0	0
23	2721539	.	A	G	9	16	25	0	0	25	0	0
23	2725095	.	A	C	3	6	9	0	2	11	0	0
23	2757841	.	C	T	0	1	1	0	0	1	0	0
23	2757876	.	T	A	0	1	1	0	0	1	0	0
23	2762855	.	G	A	1	1	2	0	0	2	0	0
23	2767194	.	G	A	0	6	6	0	3	9	0	0
23	2767227	.	C	T	3	8	11	0	0	11	0	0
23	2774812	.	G	A	1	1	2	0	0	2	0	0
23	2777534	.	G	A	3	3	6	0	0	6	0	0
23	2778827	.	A	G	2	2	4	0	0	4	0	0
23	2837155	.	T	C	4	6	10	0	0	10	0	0
23	2837188	.	C	T	3	7	10	0	0	10	0	0
23	2837218	.	T	C	0	3	3	0	0	3	0	0
23	2839156	.	G	T	0	5	5	0	7	12	0	0
23	2842292	.	G	T	0	1	1	0	2	3	0	0
23	2842407	.	C	A	2	4	6	0	0	6	0	0
23	2842409	.	G	A	2	4	6	0	0	6	0	0
23	2849307	.	G	A	0	2	2	0	4	6	0	0
23	2860937	.	T	G	0	0	0	0	3	3	0	0
23	2861990	.	C	T	4	9	13	0	2	15	0	0
23	2864186	.	A	T	2	0	2	0	0	2	0	0
23	2870732	.	T	A	4	10	14	0	2	16	0	0
23	2871264	.	C	T	5	7	12	0	0	12	0	0
23	2871699	.	G	A	11	8	19	0	1	20	0	0
23	2871908	.	A	G	10	4	14	0	0	14	0	0
23	2871994	.	T	C	12	7	19	0	0	19	0	0
23	2872206	.	T	C	7	16	23	0	1	24	0	0
23	2872338	.	T	G	18	0	18	0	6	24	0	0
23	2872517	.	G	T	17	21	38	0	3	41	0	0
23	2873327	.	A	T	5	5	10	0	0	10	0	0
23	2877144	.	C	T	0	13	13	0	5	18	0	0
23	2877519	.	T	C	3	0	3	0	3	6	0	0
23	2877792	.	C	A	0	2	2	0	4	6	0	0
23	2877930	.	T	C	8	3	11	0	0	11	0	0
23	2878041	.	C	A	0	4	4	0	4	8	0	0
23	2878689	.	C	T	1	5	6	0	1	7	0	0
23	2879235	.	A	G	5	2	7	0	1	8	0	0
23	2879618	.	A	G	4	3	7	0	0	7	0	0
23	2900767	.	A	G	4	3	7	0	0	7	0	0
23	2906312	.	A	G	6	4	10	0	0	10	0	0
23	2914612	.	A	G	1	0	1	0	0	1	0	0
23	2917463	.	T	C	1	1	2	0	0	2	0	0
23	2919264	.	A	G	1	0	1	0	1	2	0	0
23	2919276	.	T	C	1	1	2	0	0	2	0	0
23	2920448	.	C	T	0	1	1	0	0	1	0	0
23	2920588	.	G	T	0	1	1	0	2	3	0	0
23	2920603	.	T	C	1	2	3	0	0	3	0	0
23	2920753	.	G	A	1	3	4	0	0	4	0	0
23	2925086	.	T	C	2	4	6	0	0	6	0	0
23	2925137	.	C	T	8	5	13	0	0	13	0	0
23	2925238	.	A	T	1	0	1	0	0	1	0	0
23	2925357	.	T	C	1	0	1	0	0	1	0	0
23	2927117	.	A	G	3	3	6	0	0	6	0	0
23	2927144	.	A	G	3	3	6	0	0	6	0	0
23	2927175	.	C	T	2	1	3	0	0	3	0	0
23	2929180	.	A	G	5	0	5	0	0	5	0	0
23	2931288	.	T	A	3	6	9	0	1	10	0	0
23	2931321	.	G	A	5	6	11	0	0	11	0	0
23	2931329	.	C	A	4	7	11	0	0	11	0	0
23	2931358	.	C	T	6	6	12	0	0	12	0	0
23	2931409	.	C	T	6	7	13	0	0	13	0	0
23	2931461	.	A	G	5	0	5	0	5	10	0	0
23	2931732	.	C	A	7	5	12	0	0	12	0	0
23	2931836	.	C	A	4	3	7	0	1	8	0	0
23	2931970	.	T	A	6	7	13	0	0	13	0	0
23	2932241	.	A	T	5	7	12	0	1	13	0	0
23	3406094	.	C	A	6	3	9	0	0	9	0	0
23	3406708	.	T	C	7	11	18	0	0	18	0	0
23	3406729	.	A	G	10	10	20	0	0	20	0	0
23	3406811	.	T	C	14	15	29	0	0	29	0	0
23	3406950	.	T	G	6	9	15	0	0	15	0	0
23	3407285	.	T	A	4	17	21	0	1	22	0	0
23	3407305	.	C	A	5	16	21	0	0	21	0	0
23	3503614	.	C	A	4	2	6	0	0	6	0	0
23	3503622	.	A	G	4	2	6	0	0	6	0	0
23	3511204	.	C	A	5	2	7	0	0	7	0	0
23	3511291	.	T	C	2	2	4	0	0	4	0	0
23	3517582	.	T	A	7	4	11	0	0	11	0	0
23	3517621	.	T	G	8	5	13	0	0	13	0	0
23	3517734	.	T	G	8	1	9	0	9	18	0	0
23	3517800	.	C	T	3	4	7	0	0	7	0	0
23	3519953	.	A	G	5	0	5	0	9	14	0	0
23	3520120	.	C	T	6	11	17	0	1	18	0	0
23	3653478	.	G	T	13	22	35	0	1	36	0	0
23	3653846	.	T	C	23	8	31	0	0	31	0	0
23	3653859	.	G	A	22	9	31	0	0	31	0	0
23	3653953	.	T	A	6	11	17	0	2	19	0	0
23	3654034	.	A	G	10	6	16	0	1	17	0	0
23	3654134	.	A	G	3	3	6	0	0	6	0	0
23	3654356	.	C	T	7	11	18	0	1	19	0	0
23	3654490	.	A	C	12	16	28	0	1	29	0	0
23	3654747	.	C	T	0	17	17	0	14	31	0	0
23	3654774	.	G	A	15	14	29	0	1	30	0	0
23	3654989	.	A	G	19	22	41	0	0	41	0	0
23	3655082	.	C	T	2	12	14	0	15	30	1	0
23	3655139	.	T	A	20	20	40	0	0	41	1	0
23	3655207	.	T	G	13	24	37	0	1	38	0	0
23	3655220	.	A	G	15	23	38	0	2	40	0	0
23	3657557	.	T	C	20	18	38	0	2	40	0	0
23	3657602	.	T	C	25	3	28	0	25	53	0	0
23	3660060	.	C	A	1	11	12	0	19	31	0	0
23	3660674	.	A	G	11	12	23	0	3	26	0	0
23	3660713	.	G	A	3	2	5	0	0	5	0	0
23	3662210	.	G	A	23	21	44	0	2	46	0	0
23	3662246	.	C	T	0	12	12	0	21	33	0	0
23	3664306	.	A	G	9	7	16	0	2	18	0	0
23	3667257	.	T	C	11	17	28	0	0	28	0	0
23	3711178	.	T	C	1	2	3	0	0	3	0	0
23	3711308	.	C	A	6	3	9	0	1	10	0	0
23	3711949	.	T	G	2	5	7	0	0	7	0	0
23	3712002	.	G	A	2	4	6	0	0	6	0	0
23	3712062	.	C	T	7	4	11	3	0	14	0	0
23	3712484	.	T	C	1	3	4	0	1	5	0	0
23	3713045	.	T	G	4	2	6	0	0	6	0	0
23	3713321	.	A	G	3	7	10	0	0	10	0	0
23	3713363	.	A	G	4	10	14	0	0	14	0	0
23	3713388	.	C	T	5	10	15	0	0	15	0	0
23	3713400	.	A	C	5	8	13	0	0	13	0	0
23	3713452	.	T	C	9	7	16	0	0	16	0	0
23	3713453	.	G	A	9	6	15	0	1	16	0	0
23	3713491	.	G	A	10	7	17	0	0	17	0	0
23	3713622	.	A	G	12	9	21	0	0	21	0	0
23	3713643	.	G	A	7	9	16	0	2	18	0	0
23	3713692	.	T	A	7	5	12	0	1	13	0	0
23	3713928	.	A	G	6	3	9	0	0	9	0	0
23	3713968	.	C	T	1	0	1	0	0	1	0	0
23	3721131	.	T	C	8	10	18	0	0	18	0	0
23	3740379	.	T	A	10	7	17	0	0	17	0	0
23	3744654	.	A	C	1	3	4	0	0	4	0	0
23	3751965	.	A	G	13	23	36	0	1	37	0	0
23	3751990	.	A	G	14	23	37	0	2	39	0	0
23	3752305	.	C	G	18	16	34	0	0	34	0	0
23	3752394	.	C	T	0	15	15	0	18	33	0	0
23	3752992	.	T	A	20	10	30	0	3	33	0	0
23	3951804	.	T	C	5	5	10	0	0	10	0	0
23	3951942	.	G	C	3	9	12	0	0	15	3	0
23	3951948	.	G	T	3	8	11	0	1	13	1	0
23	3962692	.	A	G	1	4	5	0	2	7	0	0
23	3982480	.	G	A	3	0	3	0	1	4	0	0
23	3982936	.	G	C	1	0	1	0	2	3	0	0
23	4017626	.	G	A	4	3	7	0	0	7	0	0
23	4019600	.	T	C	3	7	10	0	1	11	0	0
23	4086817	.	T	G	5	2	7	0	1	8	0	0
23	4086829	.	C	G	5	3	8	0	0	8	0	0
23	4087064	.	C	A	2	2	4	0	0	4	0	0
23	4087588	.	G	A	1	2	3	0	0	3	0	0
23	4087819	.	A	G	4	2	6	0	0	6	0	0
23	4088361	.	A	G	1	2	3	0	0	3	0	0
23	4216472	.	C	T	4	2	6	0	0	6	0	0
23	4221918	.	C	T	3	2	5	0	0	5	0	0
23	4222119	.	A	G	3	7	10	0	0	10	0	0
23	4222149	.	G	A	4	3	7	0	1	8	0	0
23	4222437	.	C	G	2	3	5	0	0	5	0	0
23	4222503	.	C	T	2	2	4	0	1	5	0	0
23	4222509	.	G	A	2	3	5	0	0	5	0	0
23	4254105	.	G	T	2	27	29	0	32	61	0	0
23	4254192	.	A	C	11	13	24	0	0	24	0	0
23	4255566	.	C	G	21	0	21	0	26	47	0	0
23	4259194	.	A	G	16	18	34	0	1	35	0	0
23	4259369	.	T	G	19	26	45	0	1	46	0	0
23	4259626	.	G	A	19	16	35	0	1	36	0	0
23	4259635	.	G	C	2	14	16	0	18	34	0	0
23	4259674	.	G	T	12	6	18	0	0	18	0	0
23	4260629	.	G	A	2	1	3	0	0	3	0	0
23	4269780	.	C	G	2	6	8	0	0	8	0	0
23	4270928	.	T	C	2	1	3	0	1	4	0	0
23	4271333	.	A	G	25	19	44	0	3	47	0	0
23	4271730	.	G	C	15	13	28	0	3	31	0	0
23	4277683	.	A	G	1	3	4	0	0	4	0	0
23	4280719	.	C	T	3	2	5	0	0	5	0	0
23	4280877	.	A	C	2	2	4	0	1	5	0	0
23	4289066	.	C	G	9	1	10	0	1	11	0	0
23	4292251	.	C	T	0	3	3	0	0	3	0	0
23	4307737	.	C	T	3	2	5	0	0	5	0	0
23	4307740	.	T	C	3	2	5	0	0	5	0	0
23	4312033	.	T	G	5	8	13	0	0	13	0	0
23	4314691	.	G	A	4	7	11	0	0	11	0	0
23	4344317	.	G	C	2	2	4	0	0	4	0	0
23	4344332	.	T	A	2	3	5	0	0	5	0	0
23	4353456	.	C	T	1	3	4	0	0	4	0	0
23	4353495	.	G	A	0	3	3	0	2	5	0	0
23	4353498	.	A	C	2	2	4	0	0	4	0	0
23	4355923	.	C	T	1	1	2	0	0	2	0	0
23	4356773	.	A	T	1	2	3	0	0	3	0	0
23	4356779	.	T	A	1	3	4	0	0	4	0	0
23	4356932	.	C	T	1	4	5	0	0	5	0	0
23	4357124	.	T	C	2	3	5	0	0	5	0	0
23	4362847	.	C	G	2	3	5	0	0	5	0	0
23	4362874	.	T	C	1	3	4	0	0	4	0	0
23	4363971	.	A	G	0	2	2	0	0	2	0	0
23	4364914	.	C	T	3	6	9	0	0	9	0	0
23	4367071	.	G	A	3	3	6	0	0	6	0	0
23	4392201	.	T	C	1	3	4	0	0	4	0	0
23	4392211	.	T	C	1	2	3	0	1	4	0	0
23	4508439	.	A	G	0	1	1	0	0	1	0	0
23	4540349	.	G	A	0	1	1	0	0	1	0	0
23	4542695	.	A	T	1	3	4	0	0	4	0	0
23	4545451	.	A	G	1	0	1	0	0	1	0	0
23	4549501	.	T	C	2	2	4	0	0	4	0	0
23	4549514	.	C	T	2	2	4	0	0	4	0	0
23	4554745	.	A	G	1	0	1	0	0	1	0	0
23	4554764	.	C	T	1	0	1	0	0	1	0	0
23	4677464	.	T	G	3	0	3	0	11	14	0	0
23	4677468	.	T	G	4	0	4	0	10	14	0	0
23	5010006	.	C	T	2	5	7	0	1	8	0	0
23	5010722	.	C	T	5	7	12	0	0	12	0	0
23	5011064	.	T	A	1	7	8	0	0	8	0	0
23	5011968	.	A	G	1	3	4	0	0	4	0	0
23	5012826	.	C	T	2	0	2	0	0	2	0	0
23	5012832	.	T	C	2	0	2	0	0	2	0	0
23	5565897	.	A	G	4	2	6	0	0	6	0	0
23	5583113	.	C	T	1	3	4	0	2	6	0	0
23	5583185	.	A	G	0	0	0	0	1	1	0	0
23	5585483	.	T	C	5	4	9	0	0	9	0	0
23	5585528	.	G	T	0	1	1	0	0	1	0	0
23	5587625	.	T	C	2	5	7	0	0	7	0	0
23	5587626	.	C	A	2	5	7	0	0	7	0	0
23	5756600	.	G	A	3	5	8	0	0	8	0	0
23	5756781	.	G	T	6	3	9	0	1	10	0	0
23	5756847	.	C	T	4	5	9	0	0	9	0	0
23	5757010	.	G	A	1	3	4	0	0	4	0	0
23	5757193	.	G	T	2	0	2	0	0	2	0	0
23	5757202	.	C	T	0	0	0	0	1	1	0	0
23	5758610	.	G	A	3	7	10	0	0	10	0	0
23	5769031	.	C	T	0	2	2	0	0	2	0	0
23	5919188	.	C	T	3	2	5	0	0	5	0	0
23	5919293	.	C	T	1	2	3	0	0	3	0	0
23	6011931	.	G	A	5	3	8	0	0	8	0	0
23	6011958	.	A	G	4	4	8	0	0	8	0	0
23	6027379	.	G	A	1	1	2	0	0	2	0	0
23	6027415	.	T	G	4	3	7	0	0	7	0	0
23	6027439	.	G	A	3	4	7	0	0	7	0	0
23	6027578	.	C	T	4	2	6	0	0	6	0	0
23	6027781	.	T	C	1	4	5	0	1	6	0	0
23	6028015	.	C	T	3	2	5	0	0	5	0	0
23	6028029	.	C	T	3	4	7	0	0	7	0	0
23	6028051	.	G	A	4	4	8	0	0	8	0	0
23	6028093	.	G	A	0	1	1	0	0	1	0	0
23	6035912	.	C	G	4	0	4	0	1	5	0	0
23	6046850	.	T	C	0	1	1	0	0	1	0	0
23	6046867	.	T	C	1	0	1	0	0	1	0	0
23	6053512	.	G	A	3	1	4	0	1	5	0	0
23	6056016	.	T	C	1	1	2	0	0	2	0	0
23	6058704	.	C	T	3	1	4	0	0	4	0	0
23	6059847	.	G	A	0	1	1	0	4	5	0	0
23	6062654	.	C	T	3	1	4	0	1	5	0	0
23	6064579	.	T	C	6	3	9	0	0	9	0	0
23	6272793	.	C	T	5	4	9	0	0	9	0	0
23	6301287	.	T	A	4	4	8	0	0	8	0	0
23	6301332	.	T	C	7	13	20	0	0	20	0	0
23	6301413	.	A	G	2	1	3	0	2	5	0	0
23	6301416	.	T	C	2	1	3	0	2	5	0	0
23	6304243	.	A	G	12	0	12	0	9	21	0	0
23	6304249	.	T	C	9	8	17	0	1	18	0	0
23	6421776	.	T	C	3	3	6	0	0	6	0	0
23	6421954	.	G	A	1	2	3	0	0	3	0	0
23	6719757	.	G	C	3	2	5	0	0	5	0	0
23	6951157	.	C	T	0	2	2	0	0	2	0	0
23	6951505	.	T	C	1	2	3	0	1	4	0	0
23	6952261	.	T	C	1	0	1	0	1	2	0	0
23	6955860	.	G	A	5	4	9	0	1	10	0	0
23	6958166	.	A	G	0	1	1	0	0	1	0	0
23	6958211	.	A	T	0	2	2	0	0	2	0	0
23	6958250	.	G	C	1	3	4	0	0	4	0	0
23	6958256	.	A	G	1	2	3	0	0	3	0	0
23	6966857	.	C	T	0	2	2	0	1	3	0	0
23	6985279	.	G	A	1	2	3	0	0	3	0	0
23	7000372	.	C	A	9	3	12	0	1	13	0	0
23	7003744	.	C	T	5	2	7	0	0	7	0	0
23	7007480	.	C	T	4	5	9	0	0	9	0	0
23	7027534	.	C	T	0	7	7	0	4	11	0	0
23	7029600	.	G	A	4	1	5	0	0	5	0	0
23	7029741	.	G	A	1	6	7	0	0	7	0	0
23	7029777	.	A	T	2	1	3	0	0	3	0	0
23	7029916	.	A	T	3	8	11	0	0	11	0	0
23	7029964	.	A	C	1	0	1	0	6	7	0	0
23	7032435	.	C	A	4	4	8	0	0	8	0	0
23	7040274	.	T	G	1	0	1	0	8	9	0	0
23	7040708	.	T	A	0	5	5	0	0	5	0	0
23	7067257	.	T	C	3	2	5	0	1	6	0	0
23	7068334	.	A	T	1	3	4	0	0	4	0	0
23	7068349	.	G	A	2	2	4	0	0	4	0	0
23	7556970	.	C	G	0	4	4	0	0	4	0	0
23	7556979	.	G	C	1	5	6	0	0	6	0	0
23	7557383	.	G	A	0	4	4	0	4	8	0	0
23	7572445	.	A	G	6	0	6	0	5	11	0	0
23	7578710	.	T	C	12	8	20	0	0	20	0	0
23	7708839	.	G	A	2	3	5	0	0	5	0	0
23	7708882	.	T	A	1	3	4	0	0	4	0	0
23	7715651	.	C	T	2	3	5	0	0	5	0	0
23	7715747	.	A	G	5	2	7	0	0	7	0	0
23	7715801	.	G	A	0	2	2	0	2	4	0	0
23	7715945	.	G	C	0	4	4	0	3	7	0	0
23	7716281	.	T	C	5	6	11	0	0	11	0	0
23	7718380	.	G	A	1	2	3	0	0	3	0	0
23	7718999	.	C	T	0	3	3	0	0	3	0	0
23	7721342	.	A	G	2	1	3	0	0	3	0	0
23	7732578	.	T	C	3	5	8	0	1	9	0	0
23	7732760	.	C	G	1	4	5	0	0	5	0	0
23	7733088	.	C	G	7	3	10	0	1	11	0	0
23	7733603	.	T	C	5	8	13	0	0	13	0	0
23	7733614	.	G	T	3	9	12	0	0	12	0	0
23	7733732	.	T	C	4	3	7	0	0	7	0	0
23	7733826	.	T	A	2	2	4	0	0	4	0	0
23	7733836	.	T	C	2	2	4	0	0	4	0	0
23	7734920	.	C	T	3	2	5	0	2	7	0	0
23	7735497	.	T	C	1	3	4	0	0	4	0	0
23	7735649	.	C	T	8	8	16	0	0	16	0	0
23	7735809	.	A	T	5	4	9	0	0	9	0	0
23	7736089	.	T	G	2	0	2	0	2	4	0	0
23	7743670	.	T	C	2	8	10	0	0	10	0	0
23	7743691	.	T	C	1	8	9	0	1	10	0	0
23	7746618	.	T	C	0	0	0	0	3	3	0	0
23	7746797	.	T	G	3	3	6	0	0	6	0	0
23	7750693	.	A	C	3	6	9	0	0	9	0	0
23	7755088	.	T	C	1	0	1	0	0	1	0	0
23	7755112	.	A	C	2	1	3	0	0	3	0	0
23	7755189	.	T	G	5	4	9	0	1	10	0	0
23	7755215	.	T	C	2	2	4	0	0	4	0	0
23	7762045	.	A	G	5	9	14	0	0	14	0	0
23	7765955	.	G	A	1	1	2	0	0	2	0	0
23	7765961	.	C	T	0	0	0	0	1	1	0	0
23	7768416	.	T	C	5	0	5	0	6	11	0	0
23	7771305	.	T	C	1	1	2	0	0	2	0	0
23	7778670	.	G	A	9	18	27	0	0	27	0	0
23	7778715	.	A	G	8	12	20	0	0	20	0	0
23	7789553	.	T	A	4	2	6	0	1	7	0	0
23	7789556	.	T	A	7	1	8	0	0	8	0	0
23	7789635	.	G	A	7	12	19	0	0	19	0	0
23	7789802	.	C	T	8	3	11	0	1	12	0	0
23	7789930	.	C	T	0	13	13	0	10	23	0	0
23	7823544	.	T	G	2	2	4	0	0	4	0	0
23	8285094	.	G	T	7	3	10	0	0	10	0	0
23	8285236	.	G	T	10	21	31	0	0	31	0	0
23	8285297	.	C	T	1	19	20	0	18	38	0	0
23	8285365	.	G	A	15	14	29	0	0	29	0	0
23	8285468	.	T	C	3	5	8	0	4	12	0	0
23	8285585	.	A	T	12	9	21	0	1	22	0	0
23	8285640	.	C	T	8	7	15	0	1	16	0	0
23	8286192	.	T	C	8	1	9	0	9	18	0	0
23	8286237	.	G	A	10	5	15	0	1	16	0	0
23	8286342	.	C	T	0	15	15	0	6	21	0	0
23	8286384	.	G	T	7	9	16	0	1	17	0	0
23	8286483	.	G	A	5	2	7	0	1	8	0	0
23	8373535	.	T	G	11	4	15	0	0	15	0	0
23	8373641	.	A	G	7	8	15	0	0	15	0	0
23	8687821	.	G	A	2	2	4	0	0	4	0	0
23	8719074	.	T	C	11	3	14	0	1	15	0	0
23	8719491	.	G	C	1	1	2	0	1	3	0	0
23	8721202	.	G	A	0	1	1	0	0	1	0	0
23	8724467	.	G	A	8	11	19	0	1	20	0	0
23	8799808	.	A	G	3	3	6	0	0	6	0	0
23	8993280	.	G	A	5	6	11	0	0	11	0	0
23	9013456	.	C	G	2	0	2	0	6	8	0	0
23	9013597	.	T	C	7	9	16	0	0	16	0	0
23	9013843	.	G	A	10	7	17	0	1	18	0	0
23	9013876	.	T	A	5	10	15	0	0	15	0	0
23	9014122	.	G	A	0	10	10	0	8	18	0	0
23	9014259	.	G	A	7	10	17	0	0	17	0	0
23	9058105	.	A	T	3	3	6	0	0	6	0	0
23	9058108	.	C	A	4	4	8	0	0	8	0	0
23	9058157	.	A	T	3	3	6	0	2	8	0	0
23	9058160	.	C	A	5	2	7	0	0	7	0	0
23	9069900	.	A	G	1	0	1	0	0	1	0	0
23	9131416	.	A	G	0	0	0	0	2	2	0	0
23	9132147	.	A	G	2	5	7	0	0	7	0	0
23	9132150	.	T	C	2	4	6	0	0	6	0	0
23	9268466	.	T	C	4	4	8	0	0	8	0	0
23	9272674	.	C	T	1	2	3	0	0	3	0	0
23	9272984	.	T	C	6	9	15	0	0	15	0	0
23	9794959	.	T	A	12	20	32	0	1	33	0	0
23	9795057	.	A	G	16	16	32	0	2	34	0	0
23	9795097	.	C	T	1	13	14	0	18	32	0	0
23	9795663	.	A	C	7	12	19	0	0	19	0	0
23	9795908	.	C	T	17	13	30	0	1	31	0	0
23	9800761	.	T	G	6	6	12	0	1	13	0	0
23	9800872	.	T	C	0	2	2	0	0	2	0	0
23	9800993	.	G	T	4	9	13	0	0	13	0	0
23	9801964	.	T	A	1	2	3	0	0	3	0	0
23	9809863	.	A	G	14	17	31	0	1	32	0	0
23	9809977	.	C	T	0	5	5	0	14	19	0	0
23	9810491	.	C	G	9	2	11	0	0	11	0	0
23	10450488	.	A	G	1	2	3	0	0	3	0	0
23	10638386	.	A	G	3	3	6	0	0	6	0	0
23	10638702	.	C	A	0	2	2	0	1	3	0	0
23	10638774	.	A	T	5	3	8	0	0	8	0	0
23	10638775	.	T	A	5	3	8	0	0	8	0	0
23	10639037	.	A	G	7	4	11	0	0	11	0	0
23	10642720	.	T	C	6	1	7	0	0	7	0	0
23	10669371	.	A	G	0	2	2	0	0	2	0	0
23	10724336	.	A	G	10	11	21	0	1	22	0	0
23	10724695	.	A	C	5	0	5	0	9	14	0	0
23	10725012	.	T	C	8	7	15	0	0	15	0	0
23	10725013	.	G	A	8	7	15	0	0	15	0	0
23	10725491	.	T	G	5	11	16	0	0	16	0	0
23	10725753	.	A	C	12	13	25	0	1	26	0	0
23	10745058	.	G	T	7	5	12	0	2	14	0	0
23	10745139	.	T	G	6	4	10	0	2	12	0	0
23	10762922	.	G	A	9	5	14	0	0	14	0	0
23	10763070	.	G	A	5	12	17	0	0	17	0	0
23	10763182	.	G	C	9	5	14	0	0	14	0	0
23	10763301	.	T	C	5	7	12	0	0	12	0	0
23	10763303	.	T	C	5	7	12	0	0	12	0	0
23	10771991	.	C	A	2	17	19	0	12	31	0	0
23	10805275	.	A	G	3	2	5	0	0	5	0	0
23	10805322	.	A	G	1	2	3	0	1	4	0	0
23	10817292	.	T	G	1	3	4	0	0	4	0	0
23	10825541	.	T	A	6	9	15	0	0	15	0	0
23	10825569	.	A	G	5	2	7	0	10	17	0	0
23	10825591	.	C	T	3	10	13	0	5	18	0	0
23	10825996	.	G	A	5	5	10	0	0	10	0	0
23	10826120	.	C	T	10	3	13	0	0	13	0	0
23	10826194	.	C	A	5	5	10	0	4	14	0	0
23	10826618	.	T	C	16	6	22	0	1	23	0	0
23	10826856	.	A	T	2	4	6	0	1	7	0	0
23	10828929	.	T	C	4	2	6	0	0	6	0	0
23	10829138	.	A	G	4	3	7	0	1	8	0	0
23	10829164	.	A	G	2	3	5	0	1	6	0	0
23	10829415	.	G	T	3	3	6	0	0	6	0	0
23	10829547	.	C	T	1	1	2	0	1	3	0	0
23	10914243	.	A	G	1	2	3	0	0	3	0	0
23	11763161	.	C	T	2	3	5	0	0	5	0	0
23	11763163	.	A	G	2	0	2	0	3	5	0	0
23	11764269	.	C	T	1	0	1	0	0	1	0	0
23	11851459	.	C	A	3	1	4	0	2	6	0	0
23	11851467	.	C	T	3	2	5	0	1	6	0	0
23	11851545	.	T	C	6	6	12	0	0	12	0	0
23	11861321	.	T	C	0	1	1	0	0	1	0	0
23	11861367	.	C	T	2	3	5	0	1	6	0	0
23	11861378	.	G	C	3	4	7	0	0	7	0	0
23	11864948	.	T	C	22	15	37	0	2	39	0	0
23	11865055	.	T	A	12	6	18	0	3	21	0	0
23	11865274	.	A	C	3	3	6	0	1	7	0	0
23	11865510	.	T	C	8	12	20	0	1	21	0	0
23	11865545	.	A	G	16	13	29	0	0	29	0	0
23	11866086	.	G	A	22	12	34	0	4	38	0	0
23	11866259	.	T	C	20	23	43	0	1	44	0	0
23	11870063	.	T	C	2	0	2	0	3	5	0	0
23	11871807	.	G	A	16	16	32	0	1	33	0	0
23	11872533	.	A	G	2	0	2	0	0	2	0	0
23	11878173	.	A	G	7	4	11	0	2	13	0	0
23	11920705	.	G	A	4	2	6	0	0	6	0	0
23	12014796	.	C	T	6	7	13	0	0	13	0	0
23	12014872	.	T	C	11	1	12	0	15	27	0	0
23	12147630	.	T	C	1	1	2	0	0	2	0	0
23	12150658	.	G	A	3	2	5	0	0	5	0	0
23	12155166	.	G	A	4	8	12	0	0	12	0	0
23	12155298	.	G	A	11	4	15	0	1	16	0	0
23	12155319	.	G	A	12	5	17	0	0	17	0	0
23	12155364	.	A	G	10	7	17	0	0	17	0	0
23	12155391	.	G	A	9	7	16	0	2	18	0	0
23	12155638	.	A	C	1	0	1	0	0	1	0	0
23	12158399	.	G	A	3	3	6	0	0	6	0	0
23	12161851	.	T	A	1	5	6	0	0	6	0	0
23	12232873	.	G	A	5	2	7	0	0	7	0	0
23	12233117	.	G	A	4	15	19	0	1	20	0	0
23	12278655	.	A	C	1	2	3	0	0	3	0	0
23	12487331	.	C	T	5	3	8	0	0	8	0	0
23	12612350	.	A	G	1	2	3	0	0	3	0	0
23	12612427	.	A	G	2	0	2	0	2	4	0	0
23	13313801	.	G	A	1	2	3	0	0	3	0	0
23	13502684	.	T	G	0	3	3	0	0	3	0	0
23	13516339	.	T	G	2	0	2	0	3	5	0	0
23	13516414	.	C	T	1	3	4	0	0	4	0	0
23	13558711	.	C	T	4	1	5	0	0	5	0	0
23	13566948	.	T	C	1	0	1	0	0	1	0	0
23	13567257	.	G	T	0	1	1	0	0	1	0	0
23	13589383	.	A	G	2	0	2	0	0	2	0	0
23	13598094	.	C	T	2	3	5	0	0	5	0	0
23	13598632	.	T	C	8	7	15	0	0	15	0	0
23	13598679	.	C	T	5	3	8	0	2	10	0	0
23	13598766	.	A	C	6	7	13	0	0	13	0	0
23	13599079	.	G	A	0	3	3	0	3	6	0	0
23	13722254	.	G	A	1	2	3	0	0	3	0	0
23	13722335	.	T	G	4	0	4	0	7	11	0	0
23	13722416	.	C	A	3	5	8	0	1	9	0	0
23	13806444	.	T	C	5	18	23	0	0	23	0	0
23	13832412	.	T	C	3	2	5	0	0	5	0	0
23	13833376	.	T	A	3	2	5	0	0	5	0	0
23	13839846	.	A	G	4	7	11	0	1	12	0	0
23	13840362	.	C	T	0	9	9	0	14	23	0	0
23	13845114	.	A	C	6	6	12	0	0	12	0	0
23	13845149	.	T	G	9	8	17	0	1	18	0	0
23	13845201	.	A	G	10	10	20	0	0	20	0	0
23	13845247	.	G	T	6	5	11	0	0	11	0	0
23	13845411	.	G	T	7	11	18	0	0	18	0	0
23	13845447	.	T	C	11	11	22	0	2	24	0	0
23	13845544	.	C	T	8	6	14	0	1	15	0	0
23	13845558	.	C	T	0	7	7	0	8	15	0	0
23	13845764	.	A	G	5	2	7	0	2	9	0	0
23	13846207	.	A	T	7	5	12	0	0	12	0	0
23	13846482	.	G	T	2	4	6	0	0	6	0	0
23	13846540	.	C	A	3	3	6	0	0	6	0	0
23	13846664	.	T	C	1	7	8	0	0	8	0	0
23	13846765	.	T	C	2	0	2	0	3	5	0	0
23	13846783	.	T	C	2	4	6	0	0	6	0	0
23	13846917	.	T	G	4	2	6	2	0	8	0	0
23	13847220	.	T	C	4	5	9	0	0	9	0	0
23	13848537	.	G	A	2	0	2	0	0	2	0	0
23	13850343	.	A	G	9	4	13	0	0	13	0	0
23	13851386	.	A	C	5	3	8	0	0	8	0	0
23	13851392	.	A	G	4	3	7	0	1	8	0	0
23	13872465	.	A	G	2	0	2	0	0	2	0	0
23	13941275	.	C	T	6	11	17	0	0	17	0	0
23	13944394	.	A	G	0	1	1	0	0	1	0	0
23	13948990	.	A	G	5	11	16	0	0	16	0	0
23	13948993	.	G	A	5	11	16	0	0	16	0	0
23	13949074	.	T	C	7	9	16	0	0	16	0	0
23	13949089	.	T	C	7	6	13	0	0	13	0	0
23	13949110	.	C	T	0	6	6	0	9	15	0	0
23	13963821	.	A	T	1	1	2	0	0	2	0	0
23	13986276	.	G	A	3	1	4	0	0	4	0	0
23	14056595	.	A	G	4	6	10	0	0	10	0	0
23	14056679	.	G	A	2	2	4	0	0	4	0	0
23	14058967	.	A	G	3	1	4	0	0	4	0	0
23	14059036	.	A	G	4	3	7	0	0	7	0	0
23	14059063	.	G	A	2	1	3	0	0	3	0	0
23	14159182	.	A	G	1	1	2	0	0	2	0	0
23	14193640	.	T	C	3	5	8	0	0	8	0	0
23	14193649	.	G	T	2	5	7	0	2	9	0	0
23	14193777	.	C	T	4	11	15	0	0	15	0	0
23	14193851	.	A	G	12	12	24	0	0	24	0	0
23	14194101	.	T	A	5	14	19	0	0	19	0	0
23	14194125	.	A	G	7	12	19	0	1	20	0	0
23	14198137	.	G	A	5	4	9	0	0	9	0	0
23	14201512	.	T	C	9	6	15	0	1	16	0	0
23	14201521	.	T	C	9	5	14	0	1	15	0	0
23	14203829	.	T	G	7	12	19	0	1	20	0	0
23	14208718	.	A	G	3	4	7	0	0	7	0	0
23	14208817	.	A	T	5	3	8	0	0	8	0	0
23	14209024	.	T	G	5	2	7	0	1	8	0	0
23	14211707	.	C	T	3	7	10	0	1	11	0	0
23	14217769	.	G	A	1	4	5	0	4	9	0	0
23	14217799	.	G	A	4	2	6	0	0	6	0	0
23	14218018	.	A	G	2	3	5	0	0	5	0	0
23	14218065	.	C	T	2	1	3	0	0	3	0	0
23	14230410	.	A	T	2	3	5	0	0	5	0	0
23	14230459	.	G	T	3	2	5	0	0	5	0	0
23	14265152	.	A	G	5	4	9	0	0	9	0	0
23	14265182	.	C	T	11	3	14	0	0	14	0	0
23	14320390	.	T	C	3	4	7	0	0	7	0	0
23	14432386	.	C	A	2	3	5	0	0	5	0	0
23	14432447	.	T	C	4	1	5	0	2	7	0	0
23	14743092	.	A	G	0	1	1	0	1	2	0	0
23	14743099	.	G	A	0	3	3	0	0	3	0	0
23	14743154	.	G	A	1	3	4	0	0	4	0	0
23	14743562	.	T	C	2	0	2	0	0	2	0	0
23	14757409	.	T	C	2	2	4	0	0	4	0	0
23	14772079	.	G	A	3	3	6	0	0	6	0	0
23	14777039	.	A	C	2	5	7	0	0	7	0	0
23	14784198	.	T	A	1	2	3	0	0	3	0	0
23	14786347	.	T	C	3	5	8	0	0	8	0	0
23	14786429	.	A	T	2	5	7	0	0	7	0	0
23	14787336	.	A	G	2	0	2	0	2	4	0	0
23	14787372	.	T	C	4	9	13	0	0	13	0	0
23	14787378	.	A	G	4	0	4	0	9	13	0	0
23	14787409	.	G	A	0	5	5	0	3	8	0	0
23	14787426	.	G	A	2	4	6	0	0	6	0	0
23	14790659	.	T	C	1	0	1	0	0	1	0	0
23	14790795	.	A	G	2	1	3	0	0	3	0	0
23	14790827	.	G	A	4	2	6	0	0	6	0	0
23	14790881	.	A	T	1	0	1	0	0	1	0	0
23	14799653	.	T	C	3	7	10	0	0	10	0	0
23	14803617	.	T	C	1	1	2	0	0	2	0	0
23	14803624	.	C	T	1	1	2	0	0	2	0	0
23	14808537	.	G	T	4	6	10	0	0	10	0	0
23	14809613	.	C	A	3	1	4	0	0	4	0	0
23	14832585	.	T	G	4	11	15	0	2	17	0	0
23	14832733	.	G	A	11	30	41	0	2	43	0	0
23	14832740	.	A	C	16	31	47	0	0	47	0	0
23	14832866	.	C	T	26	26	52	0	3	55	0	0
23	14832941	.	C	A	0	28	28	0	19	47	0	0
23	14833142	.	A	T	23	25	48	0	1	50	1	0
23	14833143	.	A	T	23	26	49	0	1	50	0	0
23	14833389	.	A	C	20	18	38	0	1	39	0	0
23	14990819	.	G	T	7	12	19	0	2	21	0	0
23	14990893	.	C	T	0	2	2	0	0	2	0	0
23	14993074	.	T	A	14	4	18	0	1	19	0	0
23	14993302	.	A	C	8	11	19	0	1	20	0	0
23	14993393	.	C	A	7	6	13	0	0	13	0	0
23	14993421	.	G	A	7	3	10	0	0	10	0	0
23	14993438	.	A	G	8	4	12	0	0	12	0	0
23	14993493	.	A	T	8	7	15	0	0	15	0	0
23	14993525	.	A	T	9	6	15	0	0	15	0	0
23	14997341	.	A	G	10	10	20	0	1	21	0	0
23	14999053	.	C	T	13	9	22	0	0	22	0	0
23	14999095	.	C	T	0	8	8	0	19	27	0	0
23	15003551	.	T	C	5	0	5	0	6	11	0	0
23	15022206	.	T	C	5	0	5	0	13	18	0	0
23	15022511	.	C	T	2	2	4	0	0	4	0	0
23	15022526	.	C	T	2	2	4	0	0	4	0	0
23	15036698	.	G	A	4	5	9	0	0	9	0	0
23	15046644	.	T	C	2	0	2	0	2	4	0	0
23	15046819	.	G	A	2	3	5	0	0	5	0	0
23	15047157	.	C	T	3	2	5	0	0	5	0	0
23	15047446	.	T	C	1	0	1	0	2	3	0	0
23	15047468	.	A	G	2	2	4	0	0	4	0	0
23	15047674	.	A	G	1	4	5	0	0	5	0	0
23	15047745	.	C	T	0	2	2	0	2	4	0	0
23	15048070	.	A	G	2	2	4	0	0	4	0	0
23	15050912	.	T	C	1	1	2	0	0	2	0	0
23	15053319	.	T	C	0	0	0	0	1	1	0	0
23	15053433	.	A	G	1	4	5	0	0	5	0	0
23	15087187	.	G	C	1	2	3	0	0	3	0	0
23	15087550	.	T	C	2	2	4	0	0	4	0	0
23	15087562	.	T	C	2	2	4	0	0	4	0	0
23	15204028	.	C	T	20	10	30	0	1	31	0	0
23	15204038	.	T	G	19	7	26	0	2	28	0	0
23	15204222	.	C	T	0	7	7	0	18	25	0	0
23	15204321	.	T	A	11	11	22	0	2	24	0	0
23	15204324	.	T	A	13	10	23	0	1	24	0	0
23	15204417	.	A	G	9	14	23	0	0	23	0	0
23	15204926	.	C	A	11	6	17	0	0	17	0	0
23	15204936	.	G	T	5	12	17	0	0	17	0	0
23	15205100	.	T	G	18	10	28	0	4	32	0	0
23	15205428	.	A	T	18	18	36	0	0	36	0	0
23	15205487	.	C	G	14	16	30	0	1	31	0	0
23	15211253	.	G	C	12	20	32	0	2	34	0	0
23	15215709	.	G	A	12	18	30	0	1	31	0	0
23	15216664	.	G	T	4	6	10	0	1	11	0	0
23	15222509	.	G	A	5	7	12	0	1	13	0	0
23	15222521	.	C	T	6	13	19	0	0	19	0	0
23	15259821	.	G	A	6	7	13	0	1	14	0	0
23	15284602	.	G	T	6	1	7	0	0	7	0	0
23	15284668	.	A	G	6	6	12	0	1	13	0	0
23	15284671	.	G	A	7	6	13	0	0	13	0	0
23	15851064	.	A	G	17	10	27	0	2	29	0	0
23	15851506	.	C	G	14	11	25	0	1	26	0	0
23	15854004	.	T	C	21	12	33	0	1	34	0	0
23	15854102	.	A	C	9	8	17	0	0	17	0	0
23	15861092	.	C	T	1	13	14	0	12	26	0	0
23	15861536	.	T	C	2	3	5	0	0	5	0	0
23	15872605	.	T	A	1	2	3	0	0	3	0	0
23	15900255	.	C	T	8	6	14	0	0	14	0	0
23	15900330	.	G	A	16	15	31	0	2	33	0	0
23	15900387	.	G	A	14	10	24	0	2	26	0	0
23	15916232	.	A	T	11	7	18	0	0	18	0	0
23	16640852	.	A	G	10	0	10	0	10	20	0	0
23	16660094	.	G	T	2	1	3	0	0	3	0	0
23	16699712	.	T	A	0	2	2	0	0	2	0	0
23	16748903	.	A	T	7	8	15	0	1	16	0	0
23	16748915	.	T	A	7	7	14	0	0	14	0	0
23	16753735	.	T	C	1	2	3	0	0	3	0	0
23	16757414	.	T	G	1	0	1	0	3	4	0	0
23	16761407	.	A	G	1	0	1	0	0	1	0	0
23	16762022	.	A	T	1	8	9	0	0	9	0	0
23	16769220	.	C	A	3	5	8	0	0	8	0	0
23	16769255	.	T	C	2	6	8	0	0	8	0	0
23	16769385	.	T	A	5	5	10	0	0	10	0	0
23	16769949	.	T	C	3	5	8	0	0	8	0	0
23	16769991	.	T	G	2	0	2	0	11	13	0	0
23	16770008	.	G	A	0	8	8	0	1	9	0	0
23	16770091	.	A	G	3	0	3	3	6	12	0	0
23	16770340	.	G	C	1	2	3	1	0	4	0	0
23	16810343	.	A	G	0	2	2	0	0	2	0	0
23	16821940	.	T	C	1	6	7	0	1	8	0	0
23	16822095	.	T	G	6	0	6	0	3	9	0	0
23	16831106	.	A	T	1	2	3	0	0	3	0	0
23	16831507	.	A	T	1	1	2	0	0	2	0	0
23	16831822	.	G	A	0	4	4	0	2	6	0	0
23	16831928	.	G	A	1	1	2	0	1	3	0	0
23	16831976	.	G	T	1	0	1	0	0	1	0	0
23	16849383	.	A	G	2	3	5	0	0	5	0	0
23	16881359	.	T	C	1	3	4	0	0	4	0	0
23	16910963	.	A	T	2	2	4	0	0	4	0	0
23	16957050	.	C	T	0	1	1	0	1	2	0	0
23	16961626	.	T	C	2	2	4	0	0	4	0	0
23	16966670	.	A	G	1	1	2	0	0	2	0	0
23	16979959	.	A	G	1	2	3	0	0	3	0	0
23	17012024	.	T	C	2	0	2	0	2	4	0	0
23	17012033	.	T	C	1	0	1	0	2	3	0	0
23	17113842	.	A	G	3	0	3	0	0	3	0	0
23	17113923	.	T	C	5	5	10	0	0	10	0	0
23	17113938	.	A	G	3	3	6	0	0	6	0	0
23	17221056	.	G	A	2	1	3	0	0	3	0	0
23	17339044	.	C	T	3	5	8	0	0	8	0	0
23	17340346	.	G	A	0	5	5	0	3	8	0	0
23	17342788	.	T	C	0	2	2	0	0	2	0	0
23	17355498	.	G	T	3	4	7	0	0	7	0	0
23	17812711	.	C	T	22	19	41	0	0	41	0	0
23	17812720	.	T	A	17	22	39	0	1	40	0	0
23	17812755	.	G	T	18	21	39	0	2	41	0	0
23	17813057	.	G	A	22	7	29	0	0	29	0	0
23	17813161	.	T	A	6	13	19	0	3	22	0	0
23	17813717	.	G	A	25	19	44	0	0	44	0	0
23	17813911	.	A	G	5	3	8	0	1	9	0	0
23	17813924	.	A	G	7	2	9	0	1	10	0	0
23	17813952	.	G	T	7	9	16	0	0	16	0	0
23	17814056	.	G	A	21	18	39	0	0	39	0	0
23	17814223	.	C	T	17	14	31	0	12	43	0	0
23	17814281	.	G	T	17	19	36	0	4	40	0	0
23	17814299	.	A	C	21	18	39	0	1	40	0	0
23	17814408	.	A	C	18	10	28	0	0	28	0	0
23	17849044	.	T	A	1	4	5	0	0	5	0	0
23	17849275	.	T	G	13	6	19	0	1	20	0	0
23	17849296	.	C	G	1	9	10	0	13	23	0	0
23	17849627	.	C	T	13	9	22	0	1	23	0	0
23	17851768	.	C	T	0	9	9	0	4	13	0	0
23	17853145	.	T	G	0	3	3	0	0	3	0	0
23	17853396	.	A	T	3	2	5	0	0	5	0	0
23	17855427	.	C	A	7	5	12	0	0	12	0	0
23	17857831	.	G	A	2	7	9	0	0	9	0	0
23	17865973	.	T	C	0	0	0	0	1	1	0	0
23	17870234	.	C	T	0	2	2	0	1	3	0	0
23	17870758	.	G	T	0	2	2	0	2	4	0	0
23	17873750	.	C	A	26	25	51	0	1	53	1	0
23	17879066	.	C	A	4	3	7	0	1	8	0	0
23	17879107	.	C	T	4	5	9	0	1	10	0	0
23	17879152	.	A	T	2	6	8	0	0	8	0	0
23	17879153	.	A	C	6	2	8	0	0	8	0	0
23	17880800	.	C	T	2	4	6	0	0	6	0	0
23	17881252	.	T	C	9	4	13	0	1	14	0	0
23	17899284	.	A	C	0	1	1	0	0	1	0	0
23	17901655	.	A	G	0	0	0	0	1	1	0	0
23	17901724	.	A	G	1	0	1	0	2	3	0	0
23	17903519	.	G	A	0	2	2	0	1	3	0	0
23	17903574	.	C	T	4	8	12	0	0	12	0	0
23	17907323	.	A	C	3	3	6	0	0	6	0	0
23	17994101	.	T	A	3	2	5	0	0	5	0	0
23	17994274	.	C	G	6	4	10	0	1	11	0	0
23	17994615	.	T	C	4	3	7	0	0	7	0	0
23	17995469	.	G	T	5	4	9	0	0	9	0	0
23	17996051	.	A	T	1	4	5	0	0	5	0	0
23	17997033	.	A	G	1	2	3	0	1	4	0	0
23	17997043	.	T	C	1	0	1	0	3	4	0	0
23	18004297	.	A	G	2	3	5	0	0	5	0	0
23	18014744	.	C	T	0	2	2	0	0	2	0	0
23	18032772	.	G	A	3	3	6	0	0	6	0	0
23	18032912	.	A	C	6	5	11	0	0	11	0	0
23	18032924	.	T	A	5	4	9	0	0	9	0	0
23	18118653	.	A	T	2	3	5	0	0	5	0	0
23	18118922	.	G	A	22	22	44	0	1	45	0	0
23	18119166	.	C	T	19	14	33	0	2	35	0	0
23	18119192	.	T	C	14	0	14	0	18	32	0	0
23	18119399	.	A	G	15	15	30	0	0	30	0	0
23	18286781	.	G	A	4	6	10	0	1	11	0	0
23	18286782	.	C	T	4	7	11	0	0	11	0	0
23	18375847	.	G	A	2	0	2	0	0	2	0	0
23	18375853	.	T	C	1	0	1	0	4	5	0	0
23	18387709	.	T	A	21	21	42	0	2	44	0	0
23	18388004	.	G	A	11	14	25	0	0	25	0	0
23	18388166	.	T	A	9	10	19	0	2	21	0	0
23	18388476	.	G	A	8	8	16	0	0	17	1	0
23	18388555	.	A	G	10	12	22	0	1	23	0	0
23	18388620	.	A	C	5	9	14	0	0	14	0	0
23	18388685	.	G	A	5	10	15	0	2	17	0	0
23	18388764	.	G	A	11	11	22	0	0	22	0	0
23	18388858	.	T	G	6	6	12	0	0	12	0	0
23	18388954	.	G	A	10	7	17	0	0	17	0	0
23	18389594	.	G	T	21	9	30	0	0	30	0	0
23	18390402	.	G	A	8	15	23	0	2	25	0	0
23	18390635	.	G	A	10	10	20	0	1	21	0	0
23	18390758	.	T	C	9	1	10	0	8	18	0	0
23	18390780	.	C	T	10	9	19	0	1	20	0	0
23	18394401	.	T	G	10	8	18	0	4	22	0	0
23	18405812	.	C	T	2	7	9	0	0	9	0	0
23	18406479	.	G	A	4	4	8	0	0	8	0	0
23	18406573	.	C	A	3	6	9	0	1	10	0	0
23	18409242	.	C	T	7	6	13	0	0	13	0	0
23	18415329	.	G	C	5	8	13	0	2	15	0	0
23	18415427	.	T	A	2	5	7	0	0	7	0	0
23	18537386	.	C	T	3	2	5	0	0	5	0	0
23	18537414	.	A	G	1	5	6	0	0	6	0	0
23	18543166	.	C	T	0	1	1	0	0	1	0	0
23	18561051	.	T	C	11	5	16	0	0	16	0	0
23	18561289	.	T	A	18	19	37	0	0	37	0	0
23	18561434	.	C	T	0	15	15	0	13	28	0	0
23	18562358	.	T	G	2	7	9	0	0	10	1	0
23	18562427	.	C	T	6	4	10	0	0	10	0	0
23	18562484	.	G	A	3	5	8	0	0	8	0	0
23	18562522	.	A	C	0	2	2	0	0	2	0	0
23	18562623	.	C	T	9	7	16	0	0	16	0	0
23	18562911	.	C	A	1	12	13	0	12	25	0	0
23	18563951	.	G	T	8	11	19	0	0	19	0	0
23	18563952	.	T	C	8	0	8	0	11	19	0	0
23	18568144	.	G	A	1	5	6	0	1	7	0	0
23	18568206	.	G	A	6	7	13	0	1	14	0	0
23	18568520	.	G	A	1	2	3	0	0	3	0	0
23	18569380	.	T	A	8	10	18	0	1	19	0	0
23	18569399	.	C	A	0	6	6	0	10	16	0	0
23	18569543	.	T	C	12	13	25	0	0	25	0	0
23	18569625	.	A	G	23	21	44	0	0	44	0	0
23	18572547	.	T	A	5	7	12	0	2	14	0	0
23	18572605	.	T	A	7	8	15	0	0	15	0	0
23	18572618	.	G	A	8	5	13	0	0	13	0	0
23	18574353	.	G	A	11	11	22	0	1	23	0	0
23	18574720	.	T	C	17	15	32	0	1	33	0	0
23	18574800	.	C	T	0	17	17	0	12	29	0	0
23	18580933	.	C	A	2	1	3	0	1	4	0	0
23	18580939	.	C	A	0	4	4	0	1	5	0	0
23	18581065	.	A	G	1	3	4	0	0	4	0	0
23	18581835	.	G	A	3	6	9	0	0	9	0	0
23	18581933	.	T	G	8	8	16	0	1	17	0	0
23	18584225	.	G	A	11	11	22	0	0	22	0	0
23	18588969	.	C	T	11	9	20	0	1	21	0	0
23	18597667	.	G	A	13	10	23	0	1	24	0	0
23	18616517	.	A	T	9	5	14	0	1	15	0	0
23	18616880	.	T	A	9	12	21	0	0	21	0	0
23	18616980	.	C	G	9	4	13	0	1	14	0	0
23	18617300	.	G	A	11	13	24	0	0	24	0	0
23	18619766	.	C	T	1	0	1	0	0	1	0	0
23	18622541	.	T	G	7	8	15	0	1	16	0	0
23	18628460	.	T	G	1	0	1	0	0	1	0	0
23	18628746	.	C	T	10	5	15	0	0	15	0	0
23	18651918	.	C	A	4	3	7	0	0	7	0	0
23	18652067	.	T	C	3	4	7	0	0	7	0	0
23	18668440	.	T	C	6	6	12	0	0	12	0	0
23	18703170	.	C	T	5	2	7	0	0	7	0	0
23	18703204	.	T	A	0	1	1	0	0	1	0	0
23	18759802	.	C	A	7	7	14	0	0	14	0	0
23	18759827	.	T	C	6	7	13	0	0	13	0	0
23	18759944	.	C	T	0	2	2	0	0	2	0	0
23	18759973	.	T	G	4	5	9	0	0	9	0	0
23	18760004	.	G	C	7	0	7	0	10	17	0	0
23	18760049	.	T	A	11	9	20	0	0	20	0	0
23	18760223	.	T	A	2	3	5	0	1	6	0	0
23	18760519	.	T	A	2	1	3	0	0	3	0	0
23	18764770	.	A	C	2	1	3	0	0	3	0	0
23	18769161	.	T	C	2	0	2	0	1	3	0	0
23	18774122	.	T	C	4	4	8	0	0	8	0	0
23	18777816	.	C	T	0	1	1	0	0	1	0	0
23	18795055	.	T	C	5	3	8	0	1	9	0	0
23	18795620	.	A	G	15	26	41	0	0	41	0	0
23	18795721	.	C	T	4	7	11	0	0	11	0	0
23	18801275	.	G	A	6	5	11	0	0	11	0	0
23	18869550	.	C	A	0	2	2	0	3	5	0	0
23	18870235	.	A	T	2	4	6	0	1	7	0	0
23	18870716	.	G	T	8	3	11	0	0	11	0	0
23	18944489	.	A	G	12	7	19	0	0	19	0	0
23	18944543	.	G	A	0	8	8	0	9	17	0	0
23	18947344	.	C	A	15	23	38	0	1	39	0	0
23	18947385	.	G	C	18	17	35	0	1	36	0	0
23	18950968	.	T	C	13	19	32	0	0	32	0	0
23	18950970	.	T	A	14	16	30	0	2	32	0	0
23	18951010	.	G	A	10	13	23	0	1	24	0	0
23	18954023	.	A	G	5	5	10	0	1	11	0	0
23	18954100	.	A	G	4	2	6	0	0	6	0	0
23	18954151	.	G	A	6	8	14	0	0	14	0	0
23	18954759	.	T	G	15	15	30	0	1	31	0	0
23	18979342	.	C	T	12	15	27	0	0	27	0	0
23	18979561	.	G	A	15	12	27	0	2	29	0	0
23	18979756	.	T	C	11	6	17	0	1	18	0	0
23	18981525	.	G	A	1	2	3	0	0	3	0	0
23	18982375	.	G	A	10	5	15	0	0	15	0	0
23	18986338	.	G	A	10	3	13	0	0	13	0	0
23	18986344	.	G	A	3	10	13	0	1	14	0	0
23	18990914	.	C	T	0	5	5	0	7	12	0	0
23	18993525	.	T	C	6	5	11	0	1	12	0	0
23	18993827	.	C	T	0	2	2	0	7	9	0	0
23	18996030	.	C	T	4	2	6	0	0	6	0	0
23	19003263	.	A	G	2	4	6	0	0	6	0	0
23	19005426	.	G	T	2	1	3	0	0	3	0	0
23	19007389	.	G	T	4	3	7	0	0	7	0	0
23	19008149	.	C	T	1	3	4	0	0	4	0	0
23	19012845	.	C	G	3	4	7	0	0	7	0	0
23	19017421	.	C	A	2	1	3	0	0	3	0	0
23	19017466	.	G	T	1	2	3	0	0	3	0	0
23	19022254	.	A	G	3	2	5	0	0	5	0	0
23	19022534	.	G	A	2	4	6	0	0	6	0	0
23	19027408	.	G	A	3	2	5	0	0	5	0	0
23	19027510	.	A	C	3	0	3	0	2	5	0	0
23	19032787	.	C	T	1	1	2	0	0	2	0	0
23	19035542	.	A	G	0	2	2	0	1	3	0	0
23	19036052	.	C	G	5	7	12	0	0	12	0	0
23	19051645	.	C	T	5	7	12	0	1	13	0	0
23	19051737	.	C	T	2	4	6	0	0	6	0	0
23	19051739	.	G	A	2	3	5	0	1	6	0	0
23	19051831	.	C	T	4	2	6	0	1	7	0	0
23	19051897	.	G	A	0	2	2	0	1	3	0	0
23	19106781	.	G	A	2	0	2	0	1	3	0	0
23	19118372	.	G	T	5	5	10	0	0	10	0	0
23	19198348	.	A	T	8	11	19	0	0	19	0	0
23	19198588	.	A	T	2	3	5	0	0	5	0	0
23	19200168	.	G	A	11	12	23	0	0	23	0	0
23	19201103	.	C	A	7	14	21	0	0	21	0	0
23	19201148	.	G	T	3	5	8	0	1	9	0	0
23	19202958	.	A	G	0	1	1	0	0	1	0	0
23	19204126	.	C	T	2	2	4	0	0	4	0	0
23	19204130	.	T	C	2	2	4	0	0	4	0	0
23	19204738	.	C	T	8	4	12	0	0	12	0	0
23	19206388	.	G	T	1	3	4	0	0	4	0	0
23	19221073	.	G	T	1	4	5	0	0	5	0	0
23	19221744	.	G	T	1	3	4	0	0	4	0	0
23	19222257	.	G	A	0	2	2	0	1	3	0	0
23	19250418	.	G	A	3	1	4	0	1	5	0	0
23	19474823	.	G	T	10	10	20	0	0	20	0	0
23	19483010	.	C	T	1	1	2	0	3	5	0	0
23	19483497	.	A	C	2	0	2	0	1	3	0	0
23	19575044	.	G	A	0	10	10	0	10	20	0	0
23	19575134	.	C	T	12	13	25	0	0	25	0	0
23	19577464	.	G	A	1	15	16	0	19	35	0	0
23	19582481	.	T	C	7	17	24	0	1	25	0	0
23	19582559	.	G	T	6	13	19	0	1	20	0	0
23	19582668	.	T	C	17	10	27	0	0	27	0	0
23	19582678	.	C	T	13	15	28	0	2	30	0	0
23	19583208	.	G	A	1	11	12	0	9	21	0	0
23	19583252	.	C	T	11	13	24	0	0	24	0	0
23	19603630	.	T	C	8	13	21	0	1	22	0	0
23	19603753	.	T	C	31	18	49	0	1	50	0	0
23	19603803	.	T	C	17	23	40	0	1	41	0	0
23	19603880	.	A	T	16	18	34	0	5	39	0	0
23	19603994	.	G	A	23	20	43	0	1	44	0	0
23	19604263	.	A	G	15	0	15	0	18	33	0	0
23	19604351	.	G	T	7	10	17	0	0	17	0	0
23	19670139	.	G	C	8	5	13	0	0	13	0	0
23	19670185	.	A	T	3	6	9	0	0	9	0	0
23	19672720	.	T	C	8	5	13	0	0	13	0	0
23	19673170	.	C	T	15	8	23	0	0	23	0	0
23	19673376	.	C	T	7	7	14	0	0	14	0	0
23	19712898	.	G	A	18	28	46	0	1	48	1	0
23	19713291	.	A	G	13	19	32	0	1	33	0	0
23	19713324	.	A	G	31	26	57	0	6	63	0	0
23	19759280	.	G	C	0	5	5	0	2	7	0	0
23	19788562	.	A	T	1	2	3	0	1	4	0	0
23	19790452	.	G	A	0	4	4	0	4	8	0	0
23	19791217	.	G	A	2	1	3	0	0	3	0	0
23	19798174	.	A	G	0	1	1	0	0	1	0	0
23	19798493	.	T	C	0	1	1	0	0	1	0	0
23	19798700	.	T	A	1	2	3	0	0	3	0	0
23	19804543	.	C	A	1	1	2	0	0	2	0	0
23	19804878	.	T	C	0	1	1	0	0	1	0	0
23	19805577	.	A	T	3	2	5	0	1	6	0	0
23	19808022	.	C	T	4	4	8	0	0	8	0	0
23	19808078	.	T	C	9	9	18	0	1	19	0	0
23	19808691	.	G	A	0	14	14	0	15	29	0	0
23	19808895	.	A	G	2	1	3	0	4	7	0	0
23	19815467	.	G	A	3	2	5	0	0	5	0	0
23	19821136	.	A	G	2	0	2	0	16	18	0	0
23	19821150	.	C	T	5	19	24	0	0	24	0	0
23	19821277	.	A	C	10	7	17	0	0	17	0	0
23	19821408	.	C	T	5	9	14	0	0	14	0	0
23	19821447	.	G	C	4	4	8	0	0	8	0	0
23	19821470	.	G	A	1	1	2	0	2	4	0	0
23	19821489	.	A	T	3	1	4	0	0	4	0	0
23	19821549	.	C	A	4	3	7	0	0	7	0	0
23	19822100	.	G	T	6	3	9	0	0	9	0	0
23	19835308	.	T	C	36	13	49	0	0	49	0	0
23	19836260	.	C	T	23	25	48	0	0	48	0	0
23	19837080	.	T	C	21	29	50	0	1	51	0	0
23	19837503	.	G	A	22	20	42	0	0	42	0	0
23	19837939	.	A	G	8	6	14	0	2	16	0	0
23	19837974	.	G	A	6	6	12	0	0	12	0	0
23	19838100	.	C	A	15	28	43	0	1	44	0	0
23	19838295	.	T	G	3	2	5	0	0	5	0	0
23	19838312	.	A	T	2	3	5	0	0	5	0	0
23	19838387	.	A	T	8	11	19	0	0	19	0	0
23	19838388	.	T	A	7	10	17	0	2	19	0	0
23	19838458	.	A	T	7	12	19	0	0	19	0	0
23	19838459	.	A	C	7	12	19	0	0	19	0	0
23	19869132	.	G	A	14	13	27	0	3	30	0	0
23	19871615	.	A	G	28	19	47	0	2	49	0	0
23	19879576	.	C	T	0	4	4	0	9	13	0	0
23	19883318	.	T	C	1	2	3	0	0	4	1	0
23	19893409	.	A	T	9	9	18	0	0	18	0	0
23	19933542	.	A	G	11	9	20	0	0	20	0	0
23	19933578	.	G	A	10	14	24	0	0	24	0	0
23	19933742	.	G	A	14	12	26	0	1	27	0	0
23	19933850	.	A	G	10	9	19	0	0	19	0	0
23	19933896	.	A	G	13	12	25	0	2	27	0	0
23	19933952	.	A	G	9	14	23	0	0	23	0	0
23	19952743	.	C	T	0	12	12	0	16	28	0	0
23	19952869	.	T	A	17	13	30	0	0	30	0	0
23	19969109	.	A	T	5	3	8	0	0	8	0	0
23	19969420	.	A	T	3	2	5	0	0	5	0	0
23	19969431	.	T	C	2	2	4	0	0	4	0	0
23	19969710	.	G	A	6	2	8	0	0	8	0	0
23	19974092	.	G	A	1	6	7	0	0	7	0	0
23	19981048	.	C	A	3	2	5	0	0	5	0	0
23	19981510	.	G	T	5	7	12	0	0	12	0	0
23	19981554	.	T	C	4	7	11	0	0	11	0	0
23	19981608	.	A	T	6	6	12	0	0	12	0	0
23	19985054	.	A	G	4	2	6	0	0	6	0	0
23	19985201	.	A	G	1	4	5	0	0	5	0	0
23	19985210	.	G	T	1	4	5	0	0	5	0	0
23	19985307	.	G	T	2	4	6	0	1	7	0	0
23	19985403	.	T	C	9	4	13	0	0	13	0	0
23	20000716	.	A	G	2	5	7	0	7	14	0	0
23	20002339	.	G	C	7	3	10	0	0	10	0	0
23	20002373	.	T	A	3	5	8	0	0	8	0	0
23	20002524	.	A	G	4	7	11	0	0	11	0	0
23	20010481	.	A	C	2	0	2	0	3	5	0	0
23	20014285	.	A	T	4	3	7	0	0	7	0	0
23	20113599	.	T	C	17	10	27	0	0	27	0	0
23	20113848	.	G	T	16	19	35	0	0	35	0	0
23	20114327	.	C	A	5	6	11	0	2	13	0	0
23	20117625	.	C	G	0	11	11	0	14	25	0	0
23	20117830	.	A	G	1	2	3	0	0	3	0	0
23	20117938	.	A	C	6	0	6	0	16	22	0	0
23	20118597	.	T	G	3	1	4	0	0	4	0	0
23	20118730	.	T	A	7	6	13	0	0	13	0	0
23	20120646	.	T	C	11	3	14	0	6	20	0	0
23	20121265	.	T	A	0	0	0	0	2	2	0	0
23	20121270	.	G	T	1	2	3	0	0	3	0	0
23	20121326	.	G	A	12	11	23	0	0	23	0	0
23	20122190	.	A	G	8	3	11	0	0	11	0	0
23	20123375	.	G	A	7	5	12	0	1	13	0	0
23	20123386	.	G	T	7	5	12	0	1	13	0	0
23	20123575	.	C	A	5	12	17	0	0	17	0	0
23	20123576	.	C	T	5	12	17	0	0	17	0	0
23	20123629	.	A	G	2	9	11	0	2	13	0	0
23	20129840	.	T	C	3	3	6	0	0	6	0	0
23	20139248	.	T	C	0	3	3	0	0	3	0	0
23	20139320	.	T	C	1	2	3	0	0	3	0	0
23	20141925	.	C	T	3	2	5	0	0	5	0	0
23	20142968	.	C	A	0	2	2	0	1	3	0	0
23	20143177	.	G	A	1	2	3	0	0	3	0	0
23	20145420	.	T	A	10	12	22	0	0	22	0	0
23	20145823	.	T	C	4	8	12	0	0	12	0	0
23	20146080	.	A	G	7	9	16	0	0	16	0	0
23	20152477	.	T	C	5	3	8	0	0	8	0	0
23	20152640	.	G	A	4	7	11	0	0	11	0	0
23	20154486	.	A	G	2	8	10	0	0	10	0	0
23	20157790	.	G	A	6	4	10	0	0	10	0	0
23	20157923	.	G	C	3	0	3	0	6	9	0	0
23	20157930	.	T	C	3	0	3	0	6	9	0	0
23	20159225	.	C	T	0	1	1	0	2	3	0	0
23	20159234	.	G	T	1	1	2	0	0	2	0	0
23	20162522	.	C	T	0	2	2	0	1	3	0	0
23	20167966	.	G	A	7	3	10	0	1	11	0	0
23	20168111	.	T	A	7	5	12	0	0	12	0	0
23	20168127	.	C	T	1	5	6	0	4	10	0	0
23	20168404	.	C	G	8	3	11	0	0	11	0	0
23	20168568	.	T	C	1	3	4	0	0	4	0	0
23	20168573	.	A	G	1	3	4	0	0	4	0	0
23	20169105	.	C	G	0	1	1	0	1	2	0	0
23	20170945	.	T	A	4	2	6	0	0	6	0	0
23	20189590	.	T	G	2	2	4	0	0	4	0	0
23	20264937	.	T	C	0	1	1	0	0	1	0	0
23	20267328	.	A	G	0	2	2	0	0	2	0	0
23	20902390	.	T	A	7	6	13	0	0	13	0	0
23	20931095	.	C	A	10	8	18	0	2	20	0	0
23	20931119	.	C	T	10	5	15	0	0	15	0	0
23	20936226	.	G	A	0	7	7	0	5	12	0	0
23	20936395	.	T	A	9	4	13	0	0	13	0	0
23	20936467	.	T	C	2	2	4	0	0	4	0	0
23	21089840	.	C	A	1	2	3	0	0	3	0	0
23	21106219	.	A	T	0	1	1	0	0	1	0	0
23	21108312	.	T	C	0	2	2	0	0	2	0	0
23	21111170	.	A	G	5	0	5	0	6	11	0	0
23	21113750	.	T	C	0	4	4	0	0	4	0	0
23	21113770	.	C	T	0	4	4	0	0	4	0	0
23	21114732	.	A	C	3	5	8	0	0	8	0	0
23	21264226	.	A	G	2	1	3	0	0	3	0	0
23	21265351	.	T	C	2	2	4	0	0	4	0	0
23	21265446	.	C	T	3	3	6	0	0	6	0	0
23	21266896	.	C	T	3	0	3	0	0	3	0	0
23	21267105	.	G	C	0	2	2	0	1	3	0	0
23	21268808	.	T	C	5	2	7	0	0	7	0	0
23	21269494	.	A	G	10	7	17	0	0	17	0	0
23	21269792	.	T	G	2	10	12	0	0	12	0	0
23	21272845	.	G	T	0	1	1	0	2	3	0	0
23	21276362	.	T	C	1	6	7	0	0	7	0	0
23	21305907	.	C	T	1	0	1	0	0	1	0	0
23	21306051	.	A	T	3	2	5	0	0	5	0	0
23	21306061	.	G	T	0	2	2	0	3	5	0	0
23	21313858	.	G	T	3	0	3	0	1	4	0	0
23	21314021	.	T	C	0	1	1	0	0	1	0	0
23	21314094	.	C	T	0	5	5	0	0	5	0	0
23	21315209	.	A	T	1	0	1	0	0	1	0	0
23	21316361	.	C	T	2	0	2	0	0	2	0	0
23	21320115	.	A	C	0	1	1	0	0	1	0	0
23	21328482	.	C	T	3	6	9	0	0	9	0	0
23	21329165	.	C	A	4	1	5	0	0	5	0	0
23	21330786	.	T	C	0	4	4	0	0	4	0	0
23	21330864	.	T	C	8	3	11	0	0	11	0	0
23	21331048	.	C	T	0	1	1	0	0	1	0	0
23	21331603	.	T	A	0	1	1	0	0	1	0	0
23	21338789	.	A	G	5	2	7	0	0	7	0	0
23	21338834	.	C	T	5	6	11	0	0	11	0	0
23	21338846	.	G	A	4	5	9	0	0	9	0	0
23	21339130	.	G	C	0	3	3	0	0	3	0	0
23	21339136	.	C	T	0	3	3	0	0	3	0	0
23	21341304	.	G	A	5	3	8	0	0	8	0	0
23	21349972	.	T	C	2	3	5	0	0	5	0	0
23	21350008	.	T	C	2	3	5	0	0	5	0	0
23	21352523	.	G	A	1	4	5	0	0	5	0	0
23	21353604	.	C	A	3	4	7	0	1	8	0	0
23	21353625	.	G	A	2	2	4	0	0	4	0	0
23	21353643	.	A	T	1	0	1	0	0	1	0	0
23	21353837	.	C	T	4	5	9	0	1	10	0	0
23	21356056	.	C	T	4	7	11	0	0	11	0	0
23	21361347	.	T	C	5	2	7	0	0	7	0	0
23	21361570	.	G	A	4	1	5	0	0	5	0	0
23	21362178	.	G	A	0	6	6	0	3	9	0	0
23	21362217	.	G	T	3	5	8	0	1	9	0	0
23	21362735	.	G	A	5	2	7	0	1	8	0	0
23	21363039	.	C	A	4	4	8	0	0	8	0	0
23	21364431	.	G	A	3	6	9	0	0	9	0	0
23	21364449	.	G	A	0	12	12	0	3	15	0	0
23	21364632	.	T	C	1	1	2	0	0	2	0	0
23	21364725	.	C	T	1	0	1	0	1	2	0	0
23	21366588	.	C	T	1	3	4	0	0	4	0	0
23	21366743	.	A	C	1	4	5	0	3	8	0	0
23	21366764	.	C	T	1	1	2	0	0	2	0	0
23	21367861	.	A	G	3	4	7	0	1	8	0	0
23	21367994	.	A	T	2	1	3	0	0	3	0	0
23	21368078	.	C	T	11	7	18	0	3	21	0	0
23	21368090	.	G	A	12	9	21	0	0	21	0	0
23	21368156	.	A	G	7	10	17	0	0	17	0	0
23	21368183	.	G	A	3	5	8	0	1	9	0	0
23	21369126	.	G	C	1	3	4	0	4	8	0	0
23	21369678	.	T	C	11	15	26	0	2	28	0	0
23	21369703	.	C	A	8	14	22	0	1	23	0	0
23	21369750	.	C	T	1	3	4	0	0	4	0	0
23	21376413	.	T	A	13	15	28	0	2	30	0	0
23	21376570	.	C	T	13	15	28	0	0	28	0	0
23	21376617	.	A	G	9	0	9	0	12	21	0	0
23	21376678	.	G	T	13	5	18	0	0	18	0	0
23	21376689	.	C	T	16	5	21	0	0	21	0	0
23	21376787	.	C	G	7	6	13	0	1	14	0	0
23	21405248	.	T	G	1	1	2	0	0	2	0	0
23	21405254	.	T	A	1	1	2	0	0	2	0	0
23	21408459	.	G	A	2	2	4	0	0	4	0	0
23	21452700	.	C	T	2	3	5	0	1	6	0	0
23	21452750	.	A	G	2	4	6	0	0	6	0	0
23	21452814	.	G	T	2	2	4	0	0	4	0	0
23	21453061	.	T	G	4	2	6	0	0	6	0	0
23	21455709	.	C	T	3	2	5	0	2	7	0	0
23	21470390	.	C	G	0	3	3	0	0	3	0	0
23	21483656	.	C	T	6	4	10	0	1	11	0	0
23	21483803	.	G	A	5	4	9	0	0	9	0	0
23	21484652	.	G	C	2	0	2	0	0	2	0	0
23	21488208	.	A	G	3	3	6	0	1	7	0	0
23	21488221	.	A	T	3	3	6	0	0	6	0	0
23	21488438	.	C	A	1	3	4	0	0	4	0	0
23	21488630	.	A	C	6	8	14	0	0	14	0	0
23	21488872	.	G	A	8	9	17	0	0	17	0	0
23	21489121	.	C	T	4	7	11	0	0	11	0	0
23	21489233	.	T	C	4	7	11	0	0	11	0	0
23	21489567	.	T	C	4	7	11	0	0	11	0	0
23	21490211	.	G	A	0	3	3	0	4	7	0	0
23	21492284	.	A	G	5	7	12	0	0	12	0	0
23	21492314	.	A	T	3	3	6	0	0	6	0	0
23	21492756	.	A	T	0	2	2	0	0	2	0	0
23	21492777	.	C	T	2	1	3	0	0	3	0	0
23	21497808	.	C	T	4	3	7	0	0	7	0	0
23	21498165	.	T	C	5	4	9	0	0	9	0	0
23	21498291	.	T	C	1	2	3	0	0	3	0	0
23	21498326	.	C	T	1	3	4	0	0	4	0	0
23	21498383	.	A	T	2	2	4	0	0	4	0	0
23	21498449	.	T	C	5	3	8	0	0	8	0	0
23	21498478	.	T	C	6	3	9	0	0	9	0	0
23	21533380	.	A	T	2	2	4	0	0	4	0	0
23	21575986	.	C	T	2	5	7	0	0	7	0	0
23	21618055	.	C	T	2	2	4	0	0	4	0	0
23	21626211	.	C	T	4	4	8	0	0	8	0	0
23	21630363	.	T	G	7	6	13	0	0	13	0	0
23	21630393	.	G	A	5	4	9	0	0	9	0	0
23	21630676	.	G	A	7	6	13	0	1	14	0	0
23	21630973	.	C	T	10	8	18	0	1	19	0	0
23	21638300	.	C	T	3	5	8	0	0	8	0	0
23	21647187	.	C	T	2	4	6	0	0	6	0	0
23	21647196	.	G	A	0	2	2	0	4	6	0	0
23	21661227	.	C	T	6	5	11	0	0	11	0	0
23	21661483	.	G	A	0	3	3	0	6	9	0	0
23	21674163	.	G	T	1	2	3	0	0	3	0	0
23	21674167	.	G	T	1	2	3	0	0	3	0	0
23	21721568	.	T	C	1	0	1	0	2	3	0	0
23	21721667	.	C	T	3	2	5	0	0	5	0	0
23	21721868	.	G	A	2	4	6	0	0	6	0	0
23	21734738	.	A	G	4	3	7	0	0	7	0	0
23	21735034	.	G	A	2	1	3	0	1	4	0	0
23	21735090	.	C	T	2	4	6	0	1	7	0	0
23	21744521	.	T	A	2	3	5	0	0	5	0	0
23	21744522	.	C	T	2	3	5	0	0	5	0	0
23	21744789	.	A	G	2	4	6	0	1	7	0	0
23	21744819	.	G	A	2	2	4	0	1	5	0	0
23	21744988	.	A	G	2	2	4	0	0	4	0	0
23	21748436	.	G	A	1	2	3	0	0	3	0	0
23	21796849	.	T	C	3	2	5	0	0	5	0	0
23	21803494	.	T	G	2	2	4	0	0	4	0	0
23	21803685	.	G	A	3	3	6	0	0	6	0	0
23	21803801	.	T	C	2	3	5	0	0	5	0	0
23	21805605	.	A	G	0	2	2	0	0	2	0	0
23	21805621	.	C	A	1	2	3	0	0	3	0	0
23	21805710	.	C	T	2	2	4	0	0	4	0	0
23	21805899	.	A	T	1	2	3	0	0	3	0	0
23	21806130	.	C	T	2	5	7	0	0	7	0	0
23	21806273	.	C	A	2	4	6	0	1	7	0	0
23	21806281	.	G	A	3	4	7	0	0	7	0	0
23	21807113	.	T	C	4	3	7	0	0	7	0	0
23	21810048	.	A	G	5	2	7	0	0	7	0	0
23	21812702	.	A	C	1	3	4	0	0	4	0	0
23	21978616	.	T	A	2	2	4	0	1	5	0	0
23	22030235	.	T	C	5	3	8	0	1	9	0	0
23	22033653	.	C	T	1	0	1	0	0	1	0	0
23	22033661	.	G	A	1	3	4	0	0	4	0	0
23	22034461	.	C	T	3	3	6	0	0	6	0	0
23	22034473	.	G	A	0	2	2	0	3	5	0	0
23	22051041	.	G	A	1	1	2	0	0	2	0	0
23	22051380	.	C	T	1	2	3	0	1	4	0	0
23	22054542	.	C	A	2	0	2	0	0	2	0	0
23	22064493	.	A	G	5	3	8	0	0	8	0	0
23	22067865	.	G	T	2	3	5	0	0	5	0	0
23	22072641	.	T	G	1	3	4	0	0	4	0	0
23	22097092	.	G	A	1	4	5	0	1	6	0	0
23	22208920	.	A	G	1	3	4	0	1	5	0	0
23	22209186	.	C	T	3	6	9	0	0	9	0	0
23	22209196	.	C	T	4	2	6	0	1	7	0	0
23	22384741	.	C	T	0	2	2	0	0	2	0	0
23	22394219	.	G	A	5	3	8	0	0	8	0	0
23	22424506	.	T	A	2	0	2	0	0	2	0	0
23	22424524	.	C	T	1	2	3	0	0	3	0	0
23	22424574	.	G	A	0	6	6	0	6	12	0	0
23	22424764	.	C	T	5	4	9	0	1	10	0	0
23	22425126	.	G	C	3	7	10	0	0	10	0	0
23	22496525	.	C	A	4	6	10	0	0	10	0	0
23	22496589	.	A	G	5	11	16	0	0	16	0	0
23	22496785	.	A	G	2	6	8	0	0	8	0	0
23	22497049	.	A	T	6	6	12	0	1	13	0	0
23	22497550	.	A	G	3	3	6	0	0	6	0	0
23	22508141	.	A	T	1	2	3	0	0	3	0	0
23	22591304	.	C	A	1	2	3	0	0	3	0	0
23	22635284	.	G	A	8	7	15	0	2	17	0	0
23	22635490	.	C	G	0	9	9	0	0	9	0	0
23	22635720	.	T	A	5	2	7	0	0	7	0	0
23	22635732	.	C	A	0	2	2	0	3	5	0	0
23	22667247	.	C	T	21	32	53	0	4	57	0	0
23	22674704	.	C	T	3	4	7	0	0	7	0	0
23	22677394	.	A	C	6	12	18	0	0	18	0	0
23	22677496	.	C	T	38	39	77	0	4	81	0	0
23	22677638	.	C	T	33	25	58	0	4	62	0	0
23	22895465	.	G	A	1	2	3	0	0	3	0	0
23	22920431	.	A	C	1	2	3	0	15	18	0	0
23	22920438	.	A	C	5	1	6	0	7	13	0	0
23	22922775	.	A	C	10	9	19	0	4	23	0	0
23	22922795	.	G	T	6	7	13	0	1	14	0	0
23	22923021	.	A	C	22	8	30	0	1	31	0	0
23	22923033	.	C	T	23	8	31	0	1	32	0	0
23	22923198	.	C	T	8	11	19	1	1	21	0	0
23	22923339	.	C	T	15	20	35	0	1	36	0	0
23	22923537	.	C	T	14	10	24	0	1	25	0	0
23	22923603	.	T	C	11	11	22	0	0	22	0	0
23	22925490	.	C	A	1	3	4	0	0	4	0	0
23	23096495	.	A	G	1	0	1	0	0	1	0	0
23	23118653	.	A	T	3	3	6	0	0	6	0	0
23	23118815	.	C	T	2	2	4	0	0	4	0	0
23	23122381	.	C	T	7	7	14	0	0	14	0	0
23	23123146	.	G	T	6	4	10	0	1	11	0	0
23	23126589	.	A	C	4	4	8	0	0	8	0	0
23	23154388	.	T	A	1	1	2	0	0	2	0	0
23	23170963	.	T	G	2	3	5	0	1	6	0	0
23	23171172	.	C	T	1	3	4	0	0	4	0	0
23	23190151	.	T	A	5	9	14	0	0	14	0	0
23	23192478	.	G	A	7	8	15	0	1	16	0	0
23	23192514	.	A	T	3	2	5	0	0	5	0	0
23	23194228	.	C	T	10	10	20	0	0	20	0	0
23	23205469	.	A	G	12	0	12	0	15	27	0	0
23	23205511	.	T	C	7	5	12	0	0	12	0	0
23	23210288	.	A	G	10	9	19	0	1	20	0	0
23	23210303	.	A	G	12	13	25	0	2	27	0	0
23	23210339	.	C	T	11	12	23	0	0	23	0	0
23	23212257	.	C	T	2	5	7	0	0	7	0	0
23	23212567	.	C	T	12	12	24	0	0	24	0	0
23	23213219	.	T	C	18	9	27	0	0	27	0	0
23	23213417	.	C	T	24	5	29	1	1	31	0	0
23	23213437	.	G	A	0	20	20	0	9	29	0	0
23	23213582	.	C	A	15	13	28	0	1	29	0	0
23	23213613	.	T	A	13	17	30	0	0	30	0	0
23	23213657	.	G	A	16	14	30	0	4	34	0	0
23	23213757	.	G	A	24	19	43	0	0	43	0	0
23	23213800	.	G	A	0	12	12	0	8	20	0	0
23	23213917	.	T	A	13	12	25	0	0	25	0	0
23	23213939	.	T	A	16	14	30	0	0	30	0	0
23	23214070	.	C	T	10	5	15	0	0	15	0	0
23	23214417	.	C	T	10	4	14	0	1	15	0	0
23	23399987	.	T	C	8	6	14	0	0	14	0	0
23	23400332	.	G	C	4	3	7	0	0	7	0	0
23	23658600	.	A	G	3	5	8	0	2	10	0	0
23	23741687	.	G	A	0	2	2	0	6	8	0	0
23	23754415	.	C	T	3	7	10	0	0	10	0	0
23	23816509	.	A	C	2	3	5	0	0	5	0	0
23	23860113	.	T	A	0	4	4	0	1	5	0	0
23	23860117	.	G	A	0	5	5	0	0	5	0	0
23	23877088	.	A	G	4	0	4	0	5	9	0	0
23	23888136	.	G	A	0	6	6	0	4	10	0	0
23	23891551	.	G	A	0	2	2	0	3	5	0	0
23	23903278	.	G	A	1	11	12	0	11	23	0	0
23	23903432	.	C	T	4	5	9	0	0	9	0	0
23	23912720	.	G	T	11	14	25	0	2	27	0	0
23	23912723	.	C	A	12	15	27	0	1	28	0	0
23	23912900	.	C	G	17	6	23	0	1	24	0	0
23	23913065	.	G	T	10	2	12	0	1	13	0	0
23	23913066	.	G	T	11	2	13	0	0	13	0	0
23	23913240	.	G	T	17	18	35	0	1	36	0	0
23	23913818	.	A	T	15	15	30	0	0	30	0	0
23	23913858	.	A	C	15	20	35	0	3	38	0	0
23	23914017	.	G	A	1	12	13	0	16	29	0	0
23	23914176	.	A	T	14	16	30	0	3	33	0	0
23	23973724	.	T	A	2	5	7	0	0	7	0	0
23	23987646	.	A	G	1	1	2	0	1	3	0	0
23	23987652	.	G	A	0	1	1	0	0	1	0	0
23	23994537	.	T	C	2	0	2	0	1	3	0	0
23	23994595	.	C	T	10	7	17	0	1	18	0	0
23	23995111	.	G	T	5	2	7	0	0	7	0	0
23	23995382	.	G	T	3	3	6	0	0	6	0	0
23	24112906	.	A	G	2	0	2	0	2	4	0	0
23	24113184	.	C	T	1	2	3	0	0	3	0	0
23	24144860	.	A	G	3	4	7	0	0	7	0	0
23	24144872	.	T	C	3	3	6	0	0	6	0	0
23	24148183	.	T	C	2	4	6	0	0	6	0	0
23	24170870	.	G	A	8	8	16	0	1	17	0	0
23	24188087	.	C	T	0	0	0	0	3	3	0	0
23	24195469	.	C	T	13	7	20	0	0	20	0	0
23	24195611	.	T	C	6	0	6	0	3	9	0	0
23	24202602	.	C	T	2	5	7	0	0	7	0	0
23	24202658	.	G	A	4	2	6	0	1	7	0	0
23	24202760	.	C	T	3	7	10	0	0	10	0	0
23	24202858	.	C	T	6	4	10	0	0	10	0	0
23	24208176	.	G	A	6	4	10	0	0	10	0	0
23	24214381	.	G	A	5	6	11	0	0	11	0	0
23	24214414	.	C	T	5	6	11	0	0	11	0	0
23	24216192	.	G	A	3	4	7	0	0	7	0	0
23	24216339	.	A	C	2	0	2	0	2	4	0	0
23	24226487	.	C	T	2	1	3	0	0	3	0	0
23	24227315	.	T	C	2	3	5	0	1	6	0	0
23	24227352	.	A	T	11	4	15	0	1	16	0	0
23	24227380	.	A	G	10	6	16	0	2	18	0	0
23	24227458	.	T	C	3	15	18	0	2	20	0	0
23	24227673	.	C	A	16	15	31	0	2	33	0	0
23	24228767	.	G	A	13	8	21	0	1	22	0	0
23	24229110	.	G	A	12	6	18	0	1	19	0	0
23	24231222	.	A	G	3	6	9	0	1	10	0	0
23	24233458	.	A	G	5	4	9	0	0	9	0	0
23	24233831	.	A	G	2	5	7	0	0	7	0	0
23	24238551	.	G	A	2	4	6	0	0	6	0	0
23	24238676	.	A	T	1	4	5	0	0	5	0	0
23	24240979	.	G	T	9	5	14	0	1	15	0	0
23	24243168	.	G	A	1	2	3	0	0	3	0	0
23	24244694	.	C	T	0	1	1	0	2	3	0	0
23	24247719	.	A	T	2	2	4	0	0	4	0	0
23	24251628	.	C	A	0	1	1	0	0	1	0	0
23	24251829	.	T	A	3	6	9	0	0	9	0	0
23	24300958	.	T	A	2	2	4	0	1	5	0	0
23	24301288	.	G	A	4	2	6	0	0	6	0	0
23	24301297	.	C	T	1	4	5	0	0	5	0	0
23	24304648	.	T	C	2	2	4	0	0	4	0	0
23	24439480	.	G	T	10	8	18	0	1	19	0	0
23	24439780	.	G	A	12	7	19	0	1	20	0	0
23	24440397	.	C	T	9	6	15	0	2	17	0	0
23	24442787	.	T	G	2	0	2	0	1	3	0	0
23	24443161	.	G	T	4	9	13	0	1	14	0	0
23	24443576	.	A	G	10	10	20	0	3	23	0	0
23	24443609	.	C	T	0	14	14	0	9	23	0	0
23	24444291	.	A	G	12	14	26	0	0	26	0	0
23	24444344	.	C	G	7	14	21	0	0	21	0	0
23	24444543	.	C	T	0	11	11	0	7	18	0	0
23	24444803	.	T	G	8	3	11	0	1	12	0	0
23	24444861	.	G	A	9	6	15	0	1	16	0	0
23	24445112	.	G	T	14	8	22	0	0	22	0	0
23	24445338	.	A	G	13	13	26	0	1	27	0	0
23	24445584	.	A	G	9	8	17	0	1	18	0	0
23	24445876	.	A	G	9	8	17	0	1	18	0	0
23	24445906	.	G	C	7	9	16	0	1	17	0	0
23	24446411	.	C	T	11	9	20	0	1	21	0	0
23	24447113	.	C	T	7	8	15	0	0	15	0	0
23	24447297	.	C	T	2	3	5	0	2	7	0	0
23	24447794	.	G	A	6	9	15	0	0	15	0	0
23	24448071	.	T	A	5	4	9	0	0	9	0	0
23	24448146	.	T	C	3	5	8	0	0	8	0	0
23	24448273	.	G	C	10	5	15	0	0	15	0	0
23	24448621	.	G	C	9	4	13	0	0	13	0	0
23	24448630	.	G	T	7	3	10	0	1	11	0	0
23	24449429	.	G	A	1	3	4	0	1	5	0	0
23	24450353	.	C	T	3	2	5	0	2	7	0	0
23	24451083	.	A	G	3	4	7	0	0	7	0	0
23	24451283	.	A	G	3	6	9	0	0	9	0	0
23	24451512	.	T	C	5	6	11	0	1	12	0	0
23	24451791	.	T	C	1	0	1	0	0	1	0	0
23	24475749	.	G	T	1	3	4	0	1	5	0	0
23	24504389	.	A	G	3	0	3	0	2	5	0	0
23	24528161	.	C	T	1	2	3	0	0	3	0	0
23	24600513	.	C	T	2	5	7	0	0	7	0	0
23	24600947	.	T	C	4	8	12	0	0	12	0	0
23	24604042	.	C	T	5	12	17	0	1	18	0	0
23	24604323	.	C	T	0	1	1	0	0	1	0	0
23	24604461	.	A	G	4	0	4	0	2	6	0	0
23	24605243	.	T	A	0	3	3	0	0	3	0	0
23	24608805	.	G	A	2	2	4	0	1	5	0	0
23	24608847	.	G	A	0	6	6	0	11	17	0	0
23	24611786	.	G	A	0	7	7	0	4	11	0	0
23	24654287	.	G	T	3	3	6	0	2	8	0	0
23	24654528	.	G	T	2	2	4	0	0	4	0	0
23	24655227	.	T	C	5	6	11	0	0	11	0	0
23	24655478	.	C	T	1	2	3	0	0	3	0	0
23	24655761	.	T	G	6	0	6	0	4	10	0	0
23	24655833	.	A	G	4	4	8	0	0	8	0	0
23	24659777	.	C	T	1	3	4	0	0	4	0	0
23	24661851	.	C	T	5	4	9	0	0	9	0	0
23	24669381	.	C	T	0	7	7	0	9	16	0	0
23	24669633	.	T	C	17	1	18	0	7	25	0	0
23	24672365	.	C	T	4	2	6	0	0	6	0	0
23	24676192	.	G	C	8	0	8	0	0	8	0	0
23	24694242	.	C	A	17	16	33	0	1	34	0	0
23	24694756	.	C	T	1	2	3	0	0	3	0	0
23	24694763	.	T	A	3	4	7	0	0	7	0	0
23	24697036	.	G	A	19	14	33	0	0	33	0	0
23	24699281	.	T	A	17	26	43	0	2	45	0	0
23	24749514	.	A	G	3	0	3	0	1	4	0	0
23	24749528	.	A	T	3	3	6	0	0	6	0	0
23	24749673	.	C	T	2	2	4	0	0	4	0	0
23	24803130	.	C	T	12	13	25	0	1	26	0	0
23	24803221	.	T	C	8	0	8	0	2	10	0	0
23	24819831	.	C	G	8	9	17	0	0	17	0	0
23	24823899	.	T	C	5	6	11	0	0	11	0	0
23	24926470	.	G	A	7	6	13	0	1	14	0	0
23	24932493	.	G	T	5	2	7	0	0	7	0	0
23	24932979	.	G	A	6	4	10	0	2	12	0	0
23	24933121	.	C	T	4	9	13	0	2	15	0	0
23	24934567	.	T	C	12	10	22	0	1	23	0	0
23	24934597	.	C	G	12	10	22	0	1	23	0	0
23	24956985	.	A	T	2	2	4	0	0	4	0	0
23	24957061	.	T	G	7	3	10	0	0	10	0	0
23	24957161	.	G	C	3	6	9	0	0	9	0	0
23	24957184	.	A	G	7	0	7	0	5	12	0	0
23	24959374	.	G	C	4	5	9	0	0	9	0	0
23	24959406	.	T	C	1	6	7	0	0	7	0	0
23	24960393	.	T	A	1	2	3	0	0	3	0	0
23	24960701	.	C	T	4	1	5	0	0	5	0	0
23	24960702	.	C	T	4	1	5	0	0	5	0	0
23	24962560	.	G	A	0	1	1	0	0	1	0	0
23	24965393	.	C	T	3	5	8	0	0	8	0	0
23	24965396	.	G	A	3	5	8	0	0	8	0	0
23	24965432	.	G	T	5	11	16	0	0	16	0	0
23	24965767	.	C	G	3	4	7	0	0	7	0	0
23	24968676	.	C	A	9	4	13	0	0	13	0	0
23	24970331	.	A	G	0	0	0	0	4	4	0	0
23	24970372	.	G	A	5	6	11	0	0	11	0	0
23	24970451	.	T	C	2	3	5	0	1	6	0	0
23	24970710	.	G	A	2	2	4	0	0	4	0	0
23	24973871	.	T	C	5	3	8	0	1	9	0	0
23	24973928	.	A	G	5	3	8	0	0	8	0	0
23	24973931	.	A	G	5	0	5	0	3	8	0	0
23	24977048	.	G	T	5	2	7	0	0	7	0	0
23	24977060	.	C	T	3	2	5	0	0	5	0	0
23	24980349	.	T	A	1	0	1	0	0	1	0	0
23	24980448	.	A	G	2	0	2	0	0	2	0	0
23	24983469	.	C	G	2	2	4	0	0	4	0	0
23	24983479	.	G	C	2	3	5	0	0	5	0	0
23	24983536	.	A	G	1	0	1	0	4	5	0	0
23	25517732	.	A	T	2	3	5	0	0	5	0	0
23	25525287	.	T	G	3	2	5	0	0	5	0	0
23	25525335	.	A	G	1	4	5	0	0	5	0	0
23	25533607	.	T	C	2	2	4	0	0	4	0	0
23	25533609	.	A	G	2	2	4	0	0	4	0	0
23	25533685	.	C	T	0	3	3	0	3	6	0	0
23	25537722	.	G	A	3	3	6	0	0	6	0	0
23	25539868	.	A	G	1	1	2	0	0	2	0	0
23	25550840	.	G	A	1	2	3	0	0	3	0	0
23	25550894	.	A	G	1	2	3	0	0	3	0	0
23	25557150	.	T	C	0	0	0	0	2	2	0	0
23	25564701	.	T	C	3	2	5	0	0	5	0	0
23	25756641	.	A	G	3	4	7	0	1	8	0	0
23	25757012	.	G	A	0	2	2	0	0	2	0	0
23	25757378	.	G	A	0	2	2	0	2	4	0	0
23	25767757	.	G	A	0	3	3	0	3	6	0	0
23	25768384	.	C	T	3	2	5	0	0	5	0	0
23	25770414	.	G	A	1	2	3	0	0	3	0	0
23	25772369	.	A	G	1	0	1	0	0	1	0	0
23	25772799	.	G	A	3	1	4	0	0	4	0	0
23	25773460	.	G	A	3	7	10	0	0	10	0	0
23	25776824	.	C	T	3	1	4	0	0	4	0	0
23	25777286	.	A	G	2	4	6	0	0	6	0	0
23	25796410	.	T	A	3	6	9	0	0	9	0	0
23	25796484	.	G	C	2	0	2	0	4	6	0	0
23	25796563	.	C	A	3	3	6	0	0	6	0	0
23	25796670	.	T	G	3	4	7	0	0	7	0	0
23	25796691	.	T	C	2	0	2	0	4	6	0	0
23	25797011	.	T	A	5	9	14	0	0	14	0	0
23	25797143	.	G	C	5	4	9	0	0	9	0	0
23	25797216	.	G	A	3	9	12	0	1	13	0	0
23	25869424	.	A	G	12	0	12	0	5	17	0	0
23	25869571	.	G	A	10	5	15	0	0	15	0	0
23	25869596	.	C	A	5	4	9	0	1	10	0	0
23	25869658	.	C	T	9	3	12	0	0	12	0	0
23	25869706	.	A	G	7	7	14	0	0	14	0	0
23	25871764	.	C	A	8	5	13	0	0	13	0	0
23	25872703	.	G	A	0	0	0	0	2	2	0	0
23	25873444	.	C	A	6	5	11	0	0	11	0	0
23	25873670	.	A	G	1	1	2	0	1	3	0	0
23	25873876	.	A	T	4	2	6	0	0	6	0	0
23	25873882	.	G	C	4	2	6	0	0	6	0	0
23	25873966	.	T	A	1	2	3	0	0	3	0	0
23	25873976	.	T	A	7	3	10	0	0	10	0	0
23	25874249	.	A	G	12	0	12	0	10	22	0	0
23	25874261	.	T	A	11	12	23	0	2	25	0	0
23	25874334	.	C	G	3	4	7	0	0	7	0	0
23	25874355	.	A	T	3	4	7	0	2	9	0	0
23	25874459	.	A	T	7	11	18	0	0	18	0	0
23	25874498	.	G	A	8	10	18	0	0	18	0	0
23	25879786	.	A	G	5	9	14	0	0	14	0	0
23	25879930	.	A	C	3	2	5	0	1	6	0	0
23	25930689	.	C	T	5	4	9	0	1	10	0	0
23	25942399	.	T	G	14	0	14	0	9	23	0	0
23	25942559	.	T	A	5	4	9	0	1	10	0	0
23	25942708	.	G	A	0	3	3	0	3	6	0	0
23	25946732	.	A	G	2	2	4	0	1	5	0	0
23	25946766	.	C	T	2	2	4	0	1	5	0	0
23	25946882	.	T	C	4	0	4	0	3	7	0	0
23	25946981	.	C	T	1	2	3	0	0	3	0	0
23	25946985	.	C	G	1	2	3	0	0	3	0	0
23	25947258	.	A	C	3	2	5	0	0	5	0	0
23	25947599	.	T	C	3	0	3	0	2	5	0	0
23	25948000	.	G	A	2	4	6	0	0	6	0	0
23	25958173	.	T	C	1	0	1	0	2	3	0	0
23	26063179	.	A	T	2	2	4	0	0	4	0	0
23	26063372	.	G	A	14	5	19	0	0	19	0	0
23	26063560	.	A	T	21	24	45	0	2	47	0	0
23	26063614	.	A	C	28	25	53	0	2	55	0	0
23	26063734	.	G	A	21	21	42	0	1	43	0	0
23	26063843	.	G	A	28	26	54	0	1	55	0	0
23	26063985	.	A	T	24	28	52	0	0	52	0	0
23	26064050	.	T	A	27	25	52	0	0	52	0	0
23	26064122	.	T	A	7	9	16	0	0	17	1	0
23	26064124	.	T	A	10	6	16	0	1	17	0	0
23	26064266	.	T	A	9	8	17	0	1	18	0	0
23	26064923	.	T	C	27	5	32	0	31	63	0	0
23	26064948	.	T	G	24	32	56	0	4	60	0	0
23	26064989	.	A	G	35	23	58	0	1	59	0	0
23	26065079	.	T	C	30	29	59	0	1	60	0	0
23	26074123	.	G	A	9	14	23	0	1	24	0	0
23	26074252	.	T	A	1	1	2	0	1	3	0	0
23	26083822	.	A	C	1	1	2	0	0	2	0	0
23	26085897	.	A	C	3	1	4	0	0	4	0	0
23	26088791	.	G	C	5	8	13	0	0	13	0	0
23	26088845	.	A	G	5	5	10	0	0	10	0	0
23	26093095	.	C	T	5	4	9	0	0	9	0	0
23	26093597	.	A	G	7	5	12	0	1	13	0	0
23	26093868	.	T	C	3	2	5	0	0	5	0	0
23	26093933	.	A	T	4	4	8	0	0	8	0	0
23	26094063	.	A	G	2	3	5	0	0	5	0	0
23	26094533	.	A	G	5	5	10	0	0	10	0	0
23	26094589	.	G	C	8	11	19	0	0	19	0	0
23	26094617	.	T	C	13	19	32	0	0	32	0	0
23	26094626	.	T	C	13	0	13	0	21	34	0	0
23	26094694	.	A	C	4	12	16	0	0	16	0	0
23	26094877	.	A	G	9	9	18	0	1	19	0	0
23	26094932	.	G	A	7	7	14	0	1	15	0	0
23	26094938	.	C	A	9	7	16	0	0	16	0	0
23	26095081	.	G	A	11	12	23	0	3	26	0	0
23	26095096	.	C	T	15	12	27	0	2	29	0	0
23	26095153	.	G	A	17	8	25	0	0	25	0	0
23	26095285	.	T	A	9	10	19	0	2	21	0	0
23	26095400	.	C	T	10	10	20	0	0	20	0	0
23	26095416	.	T	G	7	11	18	0	0	18	0	0
23	26110735	.	G	A	16	8	24	0	1	25	0	0
23	26120198	.	C	A	1	3	4	0	7	11	0	0
23	26126478	.	G	A	0	4	4	9	0	13	0	0
23	26187735	.	C	T	1	3	4	0	0	4	0	0
23	26225907	.	A	T	7	5	12	0	0	12	0	0
23	26226066	.	G	T	3	0	3	0	0	3	0	0
23	26227697	.	C	T	0	6	6	0	6	12	0	0
23	26232509	.	C	A	3	7	10	0	0	10	0	0
23	26240860	.	G	A	6	4	10	0	1	11	0	0
23	26249884	.	G	A	2	1	3	0	0	3	0	0
23	26251940	.	G	A	0	4	4	0	0	4	0	0
23	26251946	.	A	G	0	5	5	0	1	6	0	0
23	26258065	.	C	T	0	5	5	0	3	8	0	0
23	26273212	.	C	T	0	1	1	0	5	6	0	0
23	26273215	.	G	A	1	4	5	0	0	5	0	0
23	26299011	.	T	C	1	0	1	0	0	1	0	0
23	26311056	.	T	C	2	3	5	0	0	5	0	0
23	26330387	.	C	T	2	0	2	0	0	2	0	0
23	26501502	.	T	A	3	2	5	0	0	5	0	0
23	26503884	.	T	C	26	1	27	0	23	50	0	0
23	26504151	.	A	C	21	2	23	0	24	47	0	0
23	26504202	.	A	T	36	14	50	0	3	53	0	0
23	26504254	.	G	A	30	20	50	0	0	50	0	0
23	26504264	.	C	T	30	21	51	0	0	51	0	0
23	26507741	.	G	A	24	29	53	0	0	53	0	0
23	26509764	.	G	A	20	20	40	0	1	41	0	0
23	26517183	.	G	A	16	25	41	0	0	41	0	0
23	26522647	.	A	G	13	14	27	0	2	29	0	0
23	26522892	.	G	A	17	13	30	0	1	31	0	0
23	26523020	.	A	G	4	2	6	0	0	6	0	0
23	26560135	.	C	A	1	1	2	0	0	2	0	0
23	26763798	.	A	T	9	6	15	0	0	15	0	0
23	26763994	.	C	A	11	5	16	0	1	17	0	0
23	26764230	.	G	T	5	4	9	0	0	9	0	0
23	26764351	.	A	C	7	7	14	0	0	14	0	0
23	26770174	.	A	G	3	2	5	0	0	5	0	0
23	26774334	.	G	A	0	1	1	0	0	1	0	0
23	26774412	.	T	C	2	0	2	0	4	6	0	0
23	26777492	.	G	A	2	3	5	0	0	5	0	0
23	26777537	.	G	A	1	1	2	0	0	2	0	0
23	26780394	.	G	A	3	2	5	0	1	6	0	0
23	26780400	.	T	C	2	0	2	0	4	6	0	0
23	26797108	.	T	A	1	2	3	0	0	3	0	0
23	26797166	.	G	A	2	1	3	0	1	4	0	0
23	26813850	.	C	T	2	3	5	0	0	5	0	0
23	26821702	.	G	A	1	3	4	0	0	4	0	0
23	26828760	.	G	A	1	3	4	0	0	4	0	0
23	26946805	.	A	G	1	3	4	0	0	4	0	0
23	26951926	.	G	A	0	1	1	0	0	1	0	0
23	26955383	.	C	T	3	2	5	0	0	5	0	0
23	26955401	.	A	G	2	2	4	0	0	4	0	0
23	26958483	.	A	G	3	2	5	0	0	5	0	0
23	26979223	.	C	A	13	11	24	0	2	26	0	0
23	27003630	.	T	A	4	12	16	0	1	17	0	0
23	27003720	.	G	A	24	26	50	0	0	50	0	0
23	27003801	.	T	C	18	26	44	0	1	45	0	0
23	27004310	.	C	T	19	15	34	0	1	35	0	0
23	27004339	.	C	T	11	25	36	0	1	37	0	0
23	27004347	.	G	A	10	25	35	0	1	36	0	0
23	27004383	.	C	T	8	20	28	0	2	30	0	0
23	27004397	.	T	C	7	14	21	0	1	22	0	0
23	27004665	.	T	C	15	13	28	0	0	28	0	0
23	27005195	.	G	A	15	21	36	0	2	38	0	0
23	27005514	.	A	G	13	0	13	0	10	23	0	0
23	27041461	.	A	T	3	2	5	0	0	6	1	0
23	27041503	.	C	G	4	3	7	0	1	8	0	0
23	27042132	.	A	G	4	6	10	0	0	10	0	0
23	27042533	.	C	T	0	2	2	0	0	2	0	0
23	27044526	.	A	G	2	3	5	0	0	5	0	0
23	27044638	.	T	A	2	6	8	0	0	8	0	0
23	27052123	.	C	A	14	9	23	0	0	23	0	0
23	27052125	.	C	T	13	9	22	0	1	23	0	0
23	27054361	.	C	T	8	7	15	0	0	15	0	0
23	27059120	.	G	A	1	18	19	0	16	35	0	0
23	27059376	.	T	A	22	13	35	0	0	35	0	0
23	27059422	.	C	T	20	13	33	0	1	34	0	0
23	27059459	.	A	G	24	0	24	0	13	37	0	0
23	27059526	.	G	A	0	21	21	0	13	34	0	0
23	27136385	.	T	G	3	3	6	0	0	6	0	0
23	27251789	.	G	C	21	9	30	0	0	30	0	0
23	27251859	.	G	A	24	19	43	0	1	44	0	0
23	27251872	.	C	T	0	18	18	0	21	39	0	0
23	27252425	.	G	A	17	23	40	0	2	42	0	0
23	27252587	.	A	G	14	11	25	0	1	26	0	0
23	27252833	.	A	G	12	21	33	0	1	34	0	0
23	27254226	.	T	C	2	4	6	0	0	6	0	0
23	27254586	.	C	T	2	14	16	0	17	33	0	0
23	27274110	.	G	A	3	2	5	0	0	5	0	0
23	27274266	.	G	A	1	1	2	0	0	2	0	0
23	27279281	.	A	G	7	7	14	0	0	14	0	0
23	27279320	.	A	G	8	9	17	0	0	17	0	0
23	27279476	.	G	A	16	9	25	0	1	26	0	0
23	27279533	.	C	T	7	14	21	0	0	21	0	0
23	27294611	.	G	A	10	15	25	0	0	25	0	0
23	27296964	.	G	C	7	0	7	0	9	16	0	0
23	27305186	.	C	T	6	8	14	0	1	15	0	0
23	27305195	.	G	A	5	10	15	0	0	15	0	0
23	27336193	.	G	A	3	8	11	0	0	11	0	0
23	27358990	.	A	T	7	8	15	0	0	15	0	0
23	27359203	.	A	G	10	11	21	0	0	21	0	0
23	27359526	.	T	C	11	4	15	0	0	15	0	0
23	27359618	.	C	A	0	7	7	0	0	7	0	0
23	27359755	.	C	T	1	11	12	0	7	19	0	0
23	27359825	.	C	A	10	6	16	0	0	16	0	0
23	27359867	.	A	C	5	6	11	0	0	11	0	0
23	27360007	.	G	A	4	7	11	0	0	11	0	0
23	27361210	.	A	T	4	0	4	0	2	6	0	0
23	27361216	.	G	A	4	3	7	0	1	8	0	0
23	27364018	.	C	T	5	5	10	0	2	12	0	0
23	27366669	.	C	T	3	2	5	0	0	5	0	0
23	27373181	.	C	T	0	2	2	0	2	4	0	0
23	27373186	.	G	T	2	2	4	0	0	4	0	0
23	27380215	.	C	T	0	0	0	0	1	1	0	0
23	27380430	.	A	C	2	0	2	0	1	3	0	0
23	27383362	.	G	A	1	2	3	0	0	3	0	0
23	27383518	.	A	G	3	2	5	0	0	5	0	0
23	27383533	.	G	C	2	3	5	0	0	5	0	0
23	27384946	.	T	C	2	0	2	0	3	5	0	0
23	27386246	.	G	A	1	0	1	0	0	1	0	0
23	27497811	.	T	A	1	2	3	0	0	3	0	0
23	27497960	.	A	T	10	11	21	0	0	21	0	0
23	27498027	.	A	T	7	5	12	0	0	12	0	0
23	27498040	.	C	G	7	6	13	0	0	13	0	0
23	27498195	.	A	T	9	17	26	0	1	27	0	0
23	27498441	.	A	T	5	5	10	0	3	13	0	0
23	27498798	.	C	T	0	13	13	0	14	27	0	0
23	27499096	.	G	A	8	14	22	0	1	23	0	0
23	27499195	.	A	T	8	14	22	0	2	24	0	0
23	27499246	.	G	A	12	13	25	0	2	27	0	0
23	27499306	.	C	T	14	14	28	0	0	28	0	0
23	27501872	.	A	G	9	12	21	0	1	22	0	0
23	27513952	.	A	G	5	3	8	0	0	8	0	0
23	27515931	.	G	A	2	6	8	0	1	9	0	0
23	27518434	.	G	A	3	9	12	0	2	14	0	0
23	27521608	.	A	T	1	1	2	0	0	2	0	0
23	27521863	.	A	G	4	3	7	0	1	8	0	0
23	27547467	.	C	T	0	3	3	0	1	4	0	0
23	27547568	.	G	A	5	5	10	0	0	10	0	0
23	27547650	.	A	T	1	4	5	0	1	6	0	0
23	27547850	.	C	T	0	4	4	0	4	8	0	0
23	27583700	.	C	T	1	3	4	0	0	4	0	0
23	27583703	.	T	A	0	3	3	0	0	3	0	0
23	27591834	.	C	T	4	5	9	0	0	9	0	0
23	27591859	.	C	T	7	5	12	0	2	14	0	0
23	27591939	.	A	G	3	5	8	0	0	8	0	0
23	27592411	.	A	C	2	7	9	0	0	9	0	0
23	27592615	.	T	C	5	3	8	0	0	8	0	0
23	27592796	.	T	C	6	0	6	0	9	15	0	0
23	27593230	.	C	T	5	9	14	0	1	15	0	0
23	27597141	.	C	A	0	1	1	0	1	2	0	0
23	27597808	.	G	A	6	6	12	0	0	12	0	0
23	27597980	.	G	A	4	0	4	0	0	4	0	0
23	27597981	.	C	A	4	0	4	0	0	4	0	0
23	27599110	.	A	C	1	2	3	0	0	3	0	0
23	27599365	.	G	A	6	2	8	0	0	8	0	0
23	27601803	.	C	T	3	5	8	0	0	8	0	0
23	27603302	.	G	A	1	3	4	0	1	5	0	0
23	27622036	.	T	A	18	19	37	0	1	38	0	0
23	27622212	.	C	A	13	10	23	0	1	24	0	0
23	27622258	.	T	C	21	11	32	0	0	32	0	0
23	27622324	.	T	C	6	10	16	0	0	16	0	0
23	27622386	.	T	G	7	9	16	0	0	16	0	0
23	27629923	.	A	T	2	3	5	0	0	5	0	0
23	27643894	.	T	C	1	0	1	0	4	5	0	0
23	27643941	.	T	C	3	0	3	0	2	5	0	0
23	27657816	.	C	T	1	2	3	0	0	3	0	0
23	27657924	.	A	C	1	2	3	0	0	3	0	0
23	27677263	.	G	A	33	18	51	0	2	53	0	0
23	27677278	.	G	A	14	18	32	0	7	39	0	0
23	27683248	.	C	A	0	4	4	0	2	6	0	0
23	27683371	.	C	T	0	5	5	0	2	7	0	0
23	27683497	.	C	T	4	5	9	0	0	9	0	0
23	27683629	.	C	T	0	6	6	0	4	10	0	0
23	27683710	.	G	A	3	3	6	0	0	6	0	0
23	27684618	.	T	C	5	0	5	0	3	8	0	0
23	27727417	.	C	G	3	2	5	0	0	5	0	0
23	27778706	.	T	G	2	0	2	0	3	5	0	0
23	27784466	.	G	A	3	3	6	0	0	6	0	0
23	27785026	.	A	C	5	3	8	0	0	9	1	0
23	27785460	.	A	T	4	3	7	0	0	7	0	0
23	27787598	.	T	C	1	0	1	0	0	1	0	0
23	27788133	.	G	A	1	1	2	0	1	3	0	0
23	27788665	.	C	T	8	11	19	0	1	20	0	0
23	27788768	.	G	A	10	7	17	0	0	17	0	0
23	27789577	.	T	C	5	3	8	0	1	9	0	0
23	27793510	.	T	C	5	4	9	0	0	9	0	0
23	27800681	.	G	T	7	4	11	0	0	11	0	0
23	27800954	.	A	C	7	14	21	0	1	22	0	0
23	27800977	.	C	T	13	8	21	0	0	21	0	0
23	27801268	.	C	A	19	8	27	0	0	27	0	0
23	27801629	.	C	T	5	2	7	0	1	8	0	0
23	27801849	.	G	A	3	5	8	0	0	8	0	0
23	27801880	.	G	T	7	5	12	0	0	12	0	0
23	27805414	.	A	G	4	7	11	0	0	11	0	0
23	27807294	.	A	G	10	11	21	0	0	21	0	0
23	27807523	.	A	G	0	1	1	0	0	1	0	0
23	27807664	.	G	A	7	8	15	0	1	16	0	0
23	27836235	.	C	T	0	4	4	0	5	9	0	0
23	27836245	.	G	A	5	3	8	0	0	8	0	0
23	27839682	.	A	G	1	3	4	0	0	4	0	0
23	27912116	.	C	A	5	4	9	0	1	10	0	0
23	27912136	.	T	C	4	5	9	0	0	9	0	0
23	27966981	.	G	A	4	2	6	0	0	6	0	0
23	27967014	.	T	G	4	3	7	0	0	7	0	0
23	28005087	.	C	T	7	3	10	0	0	10	0	0
23	28005338	.	A	G	10	4	14	0	0	14	0	0
23	28023784	.	T	C	4	4	8	0	1	9	0	0
23	28025586	.	G	A	5	8	13	0	0	13	0	0
23	28025664	.	A	G	2	2	4	0	0	4	0	0
23	28089478	.	C	T	0	0	0	0	1	1	0	0
23	28125796	.	C	T	3	4	7	0	0	7	0	0
23	28125841	.	C	T	2	7	9	0	0	9	0	0
23	28128445	.	T	C	2	1	3	0	0	3	0	0
23	28130983	.	G	A	0	6	6	0	0	6	0	0
23	28130999	.	A	G	2	7	9	0	0	9	0	0
23	28131047	.	T	C	4	8	12	0	0	12	0	0
23	28131083	.	A	G	3	5	8	0	0	8	0	0
23	28131248	.	C	T	3	4	7	0	0	7	0	0
23	28131251	.	C	T	3	3	6	0	0	6	0	0
23	28131285	.	C	T	4	5	9	0	0	9	0	0
23	28131320	.	G	A	7	5	12	0	0	12	0	0
23	28136167	.	G	T	6	4	10	0	0	10	0	0
23	28136390	.	A	C	5	3	8	0	0	8	0	0
23	28136395	.	G	A	0	3	3	0	6	9	0	0
23	28136471	.	T	G	3	4	7	0	0	7	0	0
23	28136498	.	A	G	3	4	7	0	0	7	0	0
23	28136615	.	C	G	2	2	4	0	0	4	0	0
23	28139515	.	C	T	7	5	12	0	0	12	0	0
23	28139564	.	A	G	10	6	16	0	0	16	0	0
23	28139633	.	T	C	6	6	12	0	2	14	0	0
23	28139812	.	A	G	1	0	1	0	0	1	0	0
23	28141324	.	G	C	8	4	12	0	0	12	0	0
23	28186060	.	T	A	6	6	12	0	0	12	0	0
23	28186688	.	T	G	2	2	4	0	0	4	0	0
23	28186995	.	T	C	6	1	7	0	9	16	0	0
23	28190648	.	A	G	4	6	10	0	1	11	0	0
23	28200967	.	A	G	8	15	23	0	0	23	0	0
23	28231248	.	G	A	3	3	6	0	0	6	0	0
23	28294259	.	T	A	1	1	2	0	0	2	0	0
23	28294709	.	A	G	2	2	4	0	0	4	0	0
23	28374570	.	G	A	16	21	37	0	0	37	0	0
23	28374711	.	C	A	16	21	37	0	0	37	0	0
23	28374756	.	A	G	8	13	21	0	1	22	0	0
23	28377424	.	T	C	3	6	9	0	0	9	0	0
23	28382953	.	C	T	8	10	18	0	2	20	0	0
23	28388013	.	C	A	12	21	33	0	2	35	0	0
23	28388318	.	C	T	18	15	33	0	2	35	0	0
23	28388325	.	T	C	19	16	35	0	0	35	0	0
23	28388474	.	G	T	1	3	4	0	3	7	0	0
23	28486050	.	C	A	1	2	3	0	0	3	0	0
23	28487088	.	C	A	0	11	11	0	2	13	0	0
23	28500660	.	G	A	3	1	4	0	0	4	0	0
23	28504245	.	T	A	0	1	1	0	0	1	0	0
23	28515768	.	C	T	1	3	4	0	0	4	0	0
23	28522491	.	A	G	4	1	5	0	4	9	0	0
23	28532518	.	G	A	1	3	4	0	0	4	0	0
23	28537575	.	G	A	0	3	3	0	2	5	0	0
23	28538590	.	T	A	1	0	1	0	0	1	0	0
23	28539108	.	T	C	1	1	2	0	0	2	0	0
23	28539279	.	G	A	0	1	1	0	5	6	0	0
23	28539626	.	G	A	3	4	7	0	0	7	0	0
23	28541593	.	T	C	6	5	11	0	0	11	0	0
23	28541633	.	A	G	8	4	12	0	2	14	0	0
23	28541638	.	C	T	10	5	15	0	0	15	0	0
23	28541683	.	G	T	8	7	15	0	0	15	0	0
23	28546798	.	T	C	8	8	16	0	0	16	0	0
23	28551764	.	A	G	7	1	8	0	5	13	0	0
23	28561248	.	T	C	0	0	0	0	1	1	0	0
23	28561502	.	C	A	14	16	30	0	0	30	0	0
23	28561836	.	C	T	6	3	9	0	0	9	0	0
23	28564191	.	C	A	18	13	31	0	2	33	0	0
23	28663266	.	G	A	1	4	5	0	0	5	0	0
23	28667294	.	T	C	5	3	8	0	1	9	0	0
23	28672063	.	G	A	0	1	1	0	1	2	0	0
23	28674046	.	C	T	2	1	3	0	0	3	0	0
23	28674252	.	G	A	0	1	1	0	0	1	0	0
23	28674634	.	T	A	1	0	1	0	0	1	0	0
23	28674890	.	A	C	7	7	14	0	0	14	0	0
23	28679693	.	A	G	5	3	8	0	0	8	0	0
23	28679696	.	C	T	5	3	8	0	0	8	0	0
23	28679753	.	C	T	6	6	12	0	2	14	0	0
23	28680239	.	A	G	1	4	5	0	0	5	0	0
23	28681558	.	G	C	16	28	44	0	1	45	0	0
23	28681559	.	C	A	17	28	45	0	0	45	0	0
23	28681723	.	T	A	19	26	45	0	1	46	0	0
23	28687561	.	C	T	2	2	4	0	0	4	0	0
23	28687637	.	G	T	6	6	12	0	0	12	0	0
23	28687766	.	C	T	4	3	7	0	0	7	0	0
23	28693280	.	T	A	3	5	8	0	1	9	0	0
23	28693308	.	T	A	5	4	9	0	0	9	0	0
23	28698340	.	T	C	10	4	14	0	0	14	0	0
23	28704611	.	G	A	8	10	18	0	0	18	0	0
23	28704683	.	G	A	1	0	1	0	0	1	0	0
23	28705908	.	C	T	6	9	15	0	0	15	0	0
23	28707195	.	T	A	8	3	11	0	0	11	0	0
23	28710429	.	T	C	10	10	20	0	0	20	0	0
23	28712193	.	T	G	0	5	5	0	0	5	0	0
23	28722887	.	G	A	2	1	3	0	0	3	0	0
23	28722917	.	C	T	3	3	6	0	0	6	0	0
23	28723338	.	C	A	2	1	3	0	0	3	0	0
23	28724964	.	A	G	3	3	6	0	0	6	0	0
23	28725174	.	G	A	0	1	1	0	4	5	0	0
23	28725644	.	G	A	3	4	7	0	0	7	0	0
23	28725743	.	A	G	3	5	8	0	1	9	0	0
23	28725991	.	T	C	2	3	5	0	0	5	0	0
23	28725994	.	G	A	2	3	5	0	0	5	0	0
23	28726278	.	A	G	1	3	4	0	0	4	0	0
23	28726302	.	T	G	1	3	4	0	0	4	0	0
23	28726521	.	A	G	2	6	8	0	0	8	0	0
23	28726634	.	A	C	5	6	11	0	0	11	0	0
23	28726985	.	A	T	3	3	6	0	0	6	0	0
23	28731489	.	A	C	20	37	57	0	1	58	0	0
23	28731499	.	C	T	18	35	53	0	2	55	0	0
23	28731834	.	C	T	21	36	57	0	5	62	0	0
23	28731914	.	T	C	27	36	63	0	3	66	0	0
23	28803167	.	A	G	2	2	4	0	0	4	0	0
23	28803209	.	T	C	2	2	4	0	1	5	0	0
23	28803213	.	C	T	3	2	5	0	0	5	0	0
23	28806171	.	A	G	0	1	1	0	0	1	0	0
23	28806278	.	A	G	5	6	11	0	0	11	0	0
23	28856977	.	A	G	0	1	1	0	0	1	0	0
23	28882508	.	T	C	0	1	1	0	0	1	0	0
23	28922024	.	A	G	4	6	10	0	0	10	0	0
23	28922165	.	C	A	4	3	7	0	0	7	0	0
23	28922300	.	G	A	0	3	3	0	3	6	0	0
23	28923531	.	G	A	3	4	7	0	0	7	0	0
23	28923540	.	A	G	3	3	6	0	0	6	0	0
23	28923571	.	T	A	2	4	6	0	0	6	0	0
23	28923717	.	T	A	2	3	5	0	1	6	0	0
23	28923760	.	T	A	2	6	8	0	0	8	0	0
23	28923962	.	A	G	8	9	17	0	0	17	0	0
23	28924117	.	G	C	7	4	11	0	0	11	0	0
23	28924399	.	C	G	6	2	8	0	1	9	0	0
23	28924806	.	A	G	4	5	9	0	0	9	0	0
23	28925275	.	T	C	5	3	8	0	2	10	0	0
23	28925441	.	G	A	2	5	7	0	1	8	0	0
23	28925451	.	A	T	3	6	9	0	0	9	0	0
23	28925620	.	A	G	1	2	3	0	0	3	0	0
23	28969769	.	T	G	2	2	4	0	0	4	0	0
23	28979087	.	T	C	0	3	3	0	0	3	0	0
23	28979387	.	G	A	2	5	7	0	0	7	0	0
23	29003403	.	A	T	1	2	3	0	0	3	0	0
23	29003421	.	T	C	1	2	3	0	0	3	0	0
23	29358241	.	G	A	0	18	18	0	25	43	0	0
23	29358253	.	C	T	23	20	43	0	0	43	0	0
23	29359664	.	T	A	9	9	18	0	0	18	0	0
23	29360407	.	G	T	0	6	6	0	12	18	0	0
23	29360687	.	G	T	4	4	8	0	0	8	0	0
23	29360707	.	G	T	4	2	6	0	0	6	0	0
23	29360757	.	T	G	3	2	5	0	0	5	0	0
23	29361357	.	C	A	8	15	23	0	3	26	0	0
23	29361365	.	A	C	8	17	25	0	3	28	0	0
23	29361557	.	A	T	4	3	7	0	1	8	0	0
23	29361576	.	G	A	2	0	2	0	2	4	0	0
23	29381612	.	C	A	12	6	18	0	0	18	0	0
23	29386735	.	C	T	0	2	2	0	0	2	0	0
23	29393787	.	A	G	3	5	8	0	0	8	0	0
23	29393817	.	T	C	2	3	5	0	0	5	0	0
23	29394039	.	T	C	1	0	1	0	0	1	0	0
23	29396452	.	C	T	1	22	23	0	28	51	0	0
23	29397116	.	C	G	25	11	36	0	0	36	0	0
23	29397230	.	T	A	28	23	51	0	2	53	0	0
23	29397501	.	C	T	16	22	38	0	1	39	0	0
23	29397506	.	T	G	18	23	41	0	1	42	0	0
23	29397563	.	C	T	1	14	15	0	23	38	0	0
23	29397665	.	T	G	13	18	31	0	2	33	0	0
23	29397816	.	G	A	22	12	34	0	5	39	0	0
23	29397907	.	T	C	30	19	49	0	0	49	0	0
23	29398065	.	T	C	18	27	45	0	2	47	0	0
23	29398544	.	C	A	1	22	23	0	12	35	0	0
23	29398548	.	A	G	13	20	33	0	3	36	0	0
23	29399085	.	T	C	7	0	7	0	3	10	0	0
23	29403306	.	T	G	12	5	17	0	0	17	0	0
23	29403437	.	G	A	6	8	14	0	2	16	0	0
23	29403491	.	C	A	8	12	20	0	1	21	0	0
23	29403515	.	A	C	1	2	3	0	0	3	0	0
23	29405829	.	A	G	20	25	45	0	1	46	0	0
23	29408773	.	A	G	25	15	40	0	4	45	1	0
23	29412411	.	A	G	14	13	27	0	0	27	0	0
23	29415484	.	A	G	14	8	22	0	0	22	0	0
23	29421959	.	C	G	17	18	35	0	0	35	0	0
23	29431995	.	T	C	19	20	39	0	1	40	0	0
23	29432040	.	A	G	14	18	32	0	2	34	0	0
23	29432055	.	G	A	14	21	35	0	1	37	1	0
23	29432867	.	T	G	5	3	8	0	1	9	0	0
23	29433715	.	C	A	11	12	23	0	0	23	0	0
23	29435044	.	T	C	3	3	6	0	0	6	0	0
23	29457909	.	G	A	3	2	5	0	0	5	0	0
23	29457942	.	T	C	9	0	9	0	6	15	0	0
23	29463158	.	A	G	0	1	1	0	0	1	0	0
23	29468959	.	A	G	14	10	24	0	2	26	0	0
23	29468980	.	G	A	16	10	26	0	2	28	0	0
23	29469261	.	A	G	2	1	3	0	1	4	0	0
23	29502227	.	C	T	0	10	10	0	6	16	0	0
23	29502302	.	C	T	0	2	2	0	9	12	1	0
23	29502311	.	C	T	8	1	9	0	0	9	0	0
23	29505482	.	C	T	0	6	6	0	10	16	0	0
23	29507723	.	A	T	16	19	35	0	0	35	0	0
23	29507825	.	T	C	7	2	9	0	11	20	0	0
23	29507859	.	T	G	5	13	18	0	0	18	0	0
23	29507883	.	G	A	8	14	22	0	1	23	0	0
23	29508151	.	C	T	6	3	9	0	0	9	0	0
23	29508247	.	G	C	2	0	2	0	7	9	0	0
23	29516726	.	T	C	12	5	17	0	1	18	0	0
23	29519565	.	G	A	3	3	6	0	0	6	0	0
23	29519769	.	G	C	8	6	14	0	0	14	0	0
23	29520070	.	A	C	1	4	5	0	0	5	0	0
23	29523602	.	G	A	3	10	13	0	0	13	0	0
23	29541251	.	C	T	0	4	4	0	0	4	0	0
23	29565835	.	T	C	0	2	2	0	0	2	0	0
23	29570627	.	C	G	8	6	14	0	1	15	0	0
23	29574311	.	C	G	2	2	4	0	0	4	0	0
23	29582634	.	C	A	37	28	65	0	2	67	0	0
23	29582673	.	A	G	40	20	60	0	6	66	0	0
23	29583417	.	T	A	25	35	60	0	0	60	0	0
23	29583708	.	G	A	37	16	53	0	4	57	0	0
23	29583814	.	T	A	39	37	76	0	1	77	0	0
23	29583882	.	A	G	32	43	75	0	0	75	0	0
23	29583960	.	G	A	25	28	53	0	11	64	0	0
23	29586380	.	G	A	18	14	32	0	1	33	0	0
23	29589392	.	A	G	17	25	42	0	3	45	0	0
23	29592588	.	T	C	17	1	18	0	20	38	0	0
23	29592708	.	G	A	19	36	55	0	0	55	0	0
23	29592741	.	C	T	17	29	46	0	0	46	0	0
23	29592927	.	T	C	17	1	18	0	20	38	0	0
23	29594441	.	A	G	11	11	22	0	1	23	0	0
23	29601269	.	C	T	14	8	22	0	0	22	0	0
23	29603174	.	T	C	5	3	8	0	1	9	0	0
23	29607011	.	A	G	24	17	41	0	1	42	0	0
23	29607029	.	A	G	23	17	40	0	1	41	0	0
23	29608769	.	A	G	6	7	13	0	0	13	0	0
23	29617571	.	A	C	16	1	17	0	12	29	0	0
23	29667473	.	A	C	3	3	6	0	0	6	0	0
23	29667480	.	G	A	5	5	10	0	1	11	0	0
23	29667614	.	C	G	19	17	36	0	3	39	0	0
23	29667812	.	T	C	1	0	1	0	2	3	0	0
23	29711788	.	G	A	11	12	23	0	0	23	0	0
23	29711911	.	C	T	17	13	30	0	0	30	0	0
23	29711998	.	G	A	12	13	25	0	0	25	0	0
23	29712140	.	G	A	7	4	11	0	0	11	0	0
23	29712465	.	G	A	16	7	23	0	0	23	0	0
23	29712493	.	C	T	0	5	5	0	14	19	0	0
23	29712922	.	C	A	9	9	18	0	0	18	0	0
23	29756865	.	A	T	6	8	14	0	2	16	0	0
23	29757038	.	G	A	9	5	14	0	0	14	0	0
23	29757099	.	A	T	7	5	12	0	1	13	0	0
23	29757980	.	T	C	9	0	9	0	7	16	0	0
23	29758030	.	C	T	0	12	12	0	7	19	0	0
23	29758088	.	A	G	8	9	17	0	3	20	0	0
23	29764120	.	T	C	1	5	6	0	0	6	0	0
23	29812595	.	G	C	7	8	15	0	0	15	0	0
23	29812663	.	A	T	9	10	19	0	0	19	0	0
23	29827748	.	G	A	6	5	11	0	0	11	0	0
23	29829115	.	A	G	1	1	2	0	0	2	0	0
23	29829160	.	A	T	4	3	7	0	0	7	0	0
23	29829186	.	A	C	3	2	5	0	0	5	0	0
23	29840171	.	T	C	1	0	1	0	0	1	0	0
23	29840178	.	A	G	2	0	2	0	1	3	0	0
23	29840274	.	C	A	7	9	16	0	1	17	0	0
23	29841374	.	T	C	2	5	7	0	0	7	0	0
23	29841965	.	T	C	1	3	4	0	0	4	0	0
23	29842151	.	T	C	0	2	2	0	0	2	0	0
23	29842966	.	C	T	4	2	6	0	0	6	0	0
23	29842967	.	T	G	4	2	6	0	0	6	0	0
23	29844239	.	C	T	0	2	2	0	2	4	0	0
23	29849025	.	A	G	1	3	4	0	0	4	0	0
23	29854359	.	G	A	1	1	2	0	0	2	0	0
23	29854362	.	C	T	0	1	1	0	1	2	0	0
23	29854443	.	G	A	6	8	14	0	0	14	0	0
23	29854491	.	C	T	3	5	8	0	0	8	0	0
23	29857920	.	A	T	2	1	3	0	0	3	0	0
23	29857967	.	T	A	5	7	12	0	0	12	0	0
23	29861645	.	A	T	6	5	11	0	0	11	0	0
23	29861973	.	A	G	13	15	28	0	1	29	0	0
23	29861976	.	T	C	14	0	14	0	14	28	0	0
23	29867576	.	G	A	4	2	6	0	1	7	0	0
23	29872254	.	A	G	7	6	13	0	0	13	0	0
23	29886897	.	G	C	14	15	29	0	0	29	0	0
23	29886937	.	T	A	13	20	33	0	3	36	0	0
23	29938154	.	C	T	0	1	1	0	1	2	0	0
23	29966518	.	A	T	2	2	4	0	0	4	0	0
23	29979467	.	T	C	0	1	1	0	0	1	0	0
23	29992023	.	G	C	1	9	10	0	2	12	0	0
23	30009382	.	C	T	2	3	5	0	0	5	0	0
23	30010029	.	A	T	1	1	2	0	0	2	0	0
23	30014345	.	T	C	0	1	1	0	0	1	0	0
23	30061605	.	A	C	17	7	24	0	0	24	0	0
23	30061606	.	A	C	19	5	24	0	0	24	0	0
23	30061763	.	C	T	0	16	16	0	19	35	0	0
23	30061804	.	A	C	10	11	21	0	2	23	0	0
23	30061960	.	T	C	9	3	12	0	23	35	0	0
23	30062364	.	T	A	14	16	30	0	0	30	0	0
23	30062792	.	C	T	10	9	19	0	2	21	0	0
23	30062888	.	C	T	1	11	12	0	6	18	0	0
23	30063216	.	T	C	5	0	5	0	11	16	0	0
23	30063217	.	T	G	5	11	16	0	0	16	0	0
23	30063527	.	G	A	8	7	15	0	0	15	0	0
23	30063578	.	A	G	8	9	17	0	0	17	0	0
23	30063643	.	C	T	3	11	14	0	1	15	0	0
23	30063722	.	G	A	12	5	17	0	0	17	0	0
23	30064289	.	T	C	5	5	10	0	4	14	0	0
23	30064579	.	A	G	6	16	22	0	0	22	0	0
23	30064743	.	C	A	10	7	17	0	1	18	0	0
23	30064804	.	A	G	9	5	14	0	1	15	0	0
23	30064853	.	A	G	9	11	20	0	0	20	0	0
23	30065641	.	T	G	9	3	12	0	0	12	0	0
23	30071637	.	G	A	0	1	1	0	0	1	0	0
23	30075201	.	G	A	9	9	18	0	0	18	0	0
23	30075367	.	A	T	1	1	2	0	0	2	0	0
23	30077023	.	T	C	7	0	7	0	7	14	0	0
23	30085812	.	A	T	2	1	3	0	0	3	0	0
23	30124048	.	A	C	3	0	3	0	5	8	0	0
23	30124303	.	C	T	0	12	12	0	8	20	0	0
23	30124430	.	C	G	5	6	11	0	0	11	0	0
23	30124651	.	A	G	8	8	16	0	0	16	0	0
23	30124818	.	C	T	9	5	14	0	0	14	0	0
23	30124960	.	G	A	3	9	12	0	0	12	0	0
23	30124998	.	T	C	4	6	10	0	2	12	0	0
23	30125004	.	G	A	7	5	12	0	0	12	0	0
23	30125206	.	A	G	7	8	15	0	0	15	0	0
23	30125599	.	G	A	5	5	10	0	0	10	0	0
23	30125698	.	A	G	2	4	6	0	0	6	0	0
23	30128781	.	A	T	7	0	7	0	0	7	0	0
23	30128788	.	G	A	4	0	4	0	2	6	0	0
23	30715328	.	T	C	3	4	7	0	0	7	0	0
23	30715397	.	G	A	0	0	0	0	1	1	0	0
23	30716096	.	C	T	9	3	12	0	1	13	0	0
23	30718514	.	T	A	3	6	9	0	0	9	0	0
23	30718554	.	A	G	3	0	3	0	6	9	0	0
23	30724230	.	C	A	3	6	9	0	0	9	0	0
23	30724698	.	T	A	2	4	6	0	0	6	0	0
23	30730194	.	C	T	2	3	5	0	0	5	0	0
23	30730351	.	C	T	2	4	6	0	1	7	0	0
23	30730374	.	C	T	2	5	7	0	1	8	0	0
23	30750183	.	G	A	0	13	13	0	9	22	0	0
23	30750402	.	C	A	10	7	17	0	3	20	0	0
23	30752095	.	C	A	9	4	13	0	0	13	0	0
23	30752233	.	T	G	4	5	9	0	0	9	0	0
23	30752352	.	A	T	10	4	14	0	1	15	0	0
23	30761144	.	G	A	5	4	9	0	0	9	0	0
23	30764212	.	T	C	10	12	22	0	0	22	0	0
23	30770193	.	A	G	5	6	11	0	0	11	0	0
23	30772902	.	C	T	1	4	5	0	0	5	0	0
23	30775273	.	T	C	5	1	6	0	0	6	0	0
23	30778499	.	G	A	8	8	16	0	0	16	0	0
23	30878451	.	G	A	0	2	2	0	1	3	0	0
23	30890018	.	G	T	2	2	4	0	0	4	0	0
23	30890839	.	C	T	3	2	5	0	1	6	0	0
23	30898132	.	C	T	4	3	7	0	0	7	0	0
23	30898150	.	T	C	4	3	7	0	0	7	0	0
23	30898297	.	T	C	2	5	7	0	0	7	0	0
23	30898355	.	A	C	4	5	9	0	0	9	0	0
23	30898387	.	C	T	4	2	6	0	0	6	0	0
23	30898467	.	G	C	0	5	5	0	2	7	0	0
23	30898503	.	A	T	0	2	2	0	1	3	0	0
23	30919151	.	C	T	1	3	4	0	0	4	0	0
23	30940412	.	A	T	1	1	2	0	0	2	0	0
23	31245593	.	A	T	2	5	7	0	0	7	0	0
23	31248779	.	T	C	2	2	4	0	0	4	0	0
23	31276396	.	T	A	5	4	9	0	0	9	0	0
23	31276453	.	G	A	11	4	15	0	0	15	0	0
23	31276509	.	C	T	5	5	10	0	1	11	0	0
23	31276657	.	T	C	10	3	13	0	0	13	0	0
23	31278183	.	G	T	5	2	7	0	0	7	0	0
23	31278237	.	C	T	0	6	6	0	4	10	0	0
23	31278322	.	A	G	3	7	10	0	2	12	0	0
23	31278375	.	A	G	5	11	16	0	1	17	0	0
23	31278417	.	G	T	3	5	8	0	0	8	0	0
23	31278450	.	T	A	2	2	4	0	3	7	0	0
23	31278732	.	C	T	0	5	5	0	1	6	0	0
23	31279122	.	G	T	5	1	6	0	0	6	0	0
23	31281768	.	T	G	0	1	1	0	0	1	0	0
23	31307138	.	C	A	1	0	1	0	0	1	0	0
23	31358342	.	A	T	15	27	42	0	0	42	0	0
23	31358344	.	A	T	15	26	41	0	1	42	0	0
23	31358489	.	T	G	24	25	49	0	0	50	1	0
23	31358631	.	G	A	30	30	60	0	0	60	0	0
23	31381335	.	A	G	2	2	4	0	0	4	0	0
23	31381389	.	T	C	1	2	3	0	0	3	0	0
23	31381392	.	C	T	1	2	3	0	0	3	0	0
23	31405519	.	C	T	6	5	11	0	0	11	0	0
23	31405570	.	A	C	10	10	20	0	0	20	0	0
23	31419064	.	C	T	2	1	3	0	1	4	0	0
23	31419172	.	A	T	7	4	11	0	0	11	0	0
23	31422369	.	A	T	3	3	6	0	0	6	0	0
23	31422429	.	C	T	6	6	12	0	1	13	0	0
23	31422540	.	A	C	2	4	6	0	1	8	1	0
23	31422543	.	A	C	4	2	6	0	1	7	0	0
23	31422600	.	C	T	4	3	7	0	0	7	0	0
23	31422768	.	A	G	2	5	7	0	0	7	0	0
23	31423145	.	G	A	2	5	7	0	7	14	0	0
23	31423392	.	C	A	16	9	25	0	3	28	0	0
23	31423427	.	A	G	20	0	20	0	9	29	0	0
23	31423432	.	C	A	18	9	27	0	0	27	0	0
23	31432102	.	A	G	4	0	4	0	15	19	0	0
23	31596584	.	T	G	5	0	5	0	4	9	0	0
23	31597571	.	T	C	10	7	17	0	0	17	0	0
23	31604900	.	C	T	3	3	6	0	1	7	0	0
23	31604912	.	G	T	2	2	4	0	0	4	0	0
23	31608368	.	C	A	1	2	3	0	0	3	0	0
23	31641153	.	C	A	15	22	37	0	0	37	0	0
23	31641197	.	A	G	22	21	43	0	0	43	0	0
23	31641270	.	G	A	20	21	41	0	2	43	0	0
23	31643818	.	A	G	9	12	21	0	1	22	0	0
23	31644368	.	A	G	8	9	17	0	1	18	0	0
23	31644419	.	A	G	8	2	10	0	0	10	0	0
23	31644602	.	T	G	8	14	22	0	0	22	0	0
23	31684244	.	A	G	0	2	2	0	4	6	0	0
23	31684352	.	G	A	15	19	34	0	0	34	0	0
23	31752717	.	A	G	1	3	4	0	0	4	0	0
23	31768596	.	T	C	10	4	14	0	0	14	0	0
23	31771282	.	T	C	1	2	3	0	0	3	0	0
23	31774194	.	G	A	7	1	8	0	0	8	0	0
23	31778174	.	A	G	1	1	2	0	0	2	0	0
23	31778183	.	C	T	1	1	2	0	0	2	0	0
23	31782969	.	T	C	0	1	1	0	1	2	0	0
23	31785175	.	G	A	5	9	14	0	1	15	0	0
23	31785183	.	T	G	5	9	14	0	1	15	0	0
23	31787127	.	C	G	0	1	1	0	0	1	0	0
23	31804162	.	A	G	2	2	4	0	0	4	0	0
23	31915069	.	T	C	1	2	3	0	0	3	0	0
23	31933739	.	T	G	4	3	7	0	2	9	0	0
23	31940681	.	C	A	6	3	9	0	0	9	0	0
23	31940775	.	T	A	4	2	6	0	0	6	0	0
23	31940776	.	A	G	4	2	6	0	0	6	0	0
23	31953501	.	A	G	3	3	6	0	0	6	0	0
23	31953518	.	C	T	0	3	3	0	1	4	0	0
23	31953537	.	A	C	1	3	4	0	0	4	0	0
23	31962648	.	A	T	2	2	4	0	0	4	0	0
23	31962650	.	T	C	2	1	3	0	1	4	0	0
23	31962971	.	T	C	3	3	6	0	2	8	0	0
23	31963226	.	C	T	8	8	16	0	2	18	0	0
23	31963360	.	A	G	3	3	6	0	0	6	0	0
23	31964680	.	C	T	2	5	7	0	0	7	0	0
23	31982041	.	T	C	1	1	2	0	1	3	0	0
23	31982042	.	C	T	2	1	3	0	0	3	0	0
23	31984871	.	C	T	2	3	5	0	0	5	0	0
23	31986705	.	T	G	1	0	1	0	1	2	0	0
23	31992375	.	T	C	2	2	4	0	0	4	0	0
23	31992522	.	T	C	3	4	7	0	0	7	0	0
23	31992537	.	C	T	4	5	9	0	0	9	0	0
23	31992690	.	C	T	2	2	4	0	0	4	0	0
23	31995113	.	G	A	2	1	3	0	0	3	0	0
23	31997582	.	G	A	1	4	5	0	0	5	0	0
23	31997953	.	C	T	1	1	2	0	0	2	0	0
23	31998162	.	T	C	2	2	4	0	0	4	0	0
23	32000336	.	G	C	0	2	2	0	0	2	0	0
23	32003354	.	T	A	5	3	8	0	1	9	0	0
23	32003808	.	T	C	2	5	7	0	1	8	0	0
23	32003820	.	G	T	3	4	7	0	0	7	0	0
23	32007376	.	T	G	8	3	11	0	0	11	0	0
23	32007445	.	T	A	7	7	14	0	1	15	0	0
23	32007520	.	T	C	5	7	12	0	0	12	0	0
23	32007526	.	C	G	5	8	13	0	0	13	0	0
23	32026927	.	T	C	1	3	4	0	1	5	0	0
23	32026978	.	C	T	2	6	8	0	2	10	0	0
23	32026996	.	G	T	0	1	1	0	2	5	2	0
23	32033330	.	A	G	1	2	3	0	0	3	0	0
23	32081708	.	C	T	8	9	17	0	0	17	0	0
23	32081717	.	T	C	8	10	18	0	0	18	0	0
23	32085908	.	G	T	2	2	4	0	1	5	0	0
23	32096873	.	C	T	0	2	2	0	1	3	0	0
23	32129326	.	C	A	7	3	10	0	0	10	0	0
23	32129476	.	G	T	3	4	7	0	0	7	0	0
23	32129514	.	G	T	1	4	5	0	0	5	0	0
23	32151099	.	G	A	1	2	3	0	0	3	0	0
23	32151669	.	A	C	13	20	33	0	1	34	0	0
23	32152022	.	C	T	22	20	42	0	0	42	0	0
23	32154021	.	G	T	4	9	13	0	0	13	0	0
23	32155325	.	A	G	5	4	9	0	0	9	0	0
23	32155719	.	C	T	13	9	22	0	0	22	0	0
23	32155720	.	C	T	0	9	9	0	13	22	0	0
23	32155864	.	A	C	8	0	8	0	12	20	0	0
23	32155975	.	C	T	6	4	10	0	1	11	0	0
23	32157787	.	G	T	2	3	5	0	0	5	0	0
23	32200004	.	A	G	1	3	4	0	0	4	0	0
23	32200071	.	A	G	1	3	4	0	0	4	0	0
23	32200076	.	T	G	1	3	4	0	0	4	0	0
23	32200482	.	T	C	1	3	4	0	0	4	0	0
23	32200517	.	C	A	4	2	6	0	1	7	0	0
23	32200583	.	C	T	0	3	3	0	4	7	0	0
23	32200979	.	A	G	10	3	13	0	0	13	0	0
23	32201087	.	G	T	3	5	8	0	0	8	0	0
23	32239532	.	G	A	5	4	9	0	0	9	0	0
23	32239533	.	G	A	5	4	9	0	0	9	0	0
23	32239688	.	C	A	13	2	15	0	1	16	0	0
23	32239708	.	G	A	14	7	21	0	0	21	0	0
23	32239824	.	G	A	11	5	16	0	0	16	0	0
23	32240258	.	C	T	6	4	10	0	0	10	0	0
23	32242086	.	C	A	2	2	4	0	1	5	0	0
23	32242251	.	T	C	8	6	14	0	0	14	0	0
23	32248595	.	C	G	0	2	2	0	0	2	0	0
23	32250286	.	C	T	1	0	1	0	0	1	0	0
23	32251473	.	T	G	0	1	1	0	0	1	0	0
23	32252805	.	A	G	0	3	3	0	0	3	0	0
23	32309187	.	T	C	14	12	26	0	0	26	0	0
23	32309193	.	G	A	13	12	25	0	1	26	0	0
23	32309323	.	G	A	11	11	22	0	1	23	0	0
23	32309533	.	A	G	10	9	19	0	0	19	0	0
23	32309659	.	C	A	0	7	7	0	7	14	0	0
23	32309709	.	G	A	5	6	11	0	1	12	0	0
23	32309787	.	A	C	11	9	20	0	1	21	0	0
23	32309943	.	A	G	6	4	10	0	0	10	0	0
23	32310148	.	G	T	0	3	3	0	1	4	0	0
23	32310151	.	G	A	1	2	3	0	1	4	0	0
23	32310209	.	C	T	6	2	8	0	0	8	0	0
23	32310254	.	T	A	6	3	9	0	1	10	0	0
23	32310864	.	G	A	4	4	8	0	1	9	0	0
23	32311418	.	T	C	10	8	18	0	0	18	0	0
23	32311555	.	G	C	15	15	30	0	2	32	0	0
23	32311612	.	G	A	16	10	26	0	0	26	0	0
23	32318047	.	A	G	13	21	34	0	0	34	0	0
23	32326532	.	A	G	6	4	10	0	0	10	0	0
23	32362317	.	A	G	5	5	10	0	0	10	0	0
23	32589398	.	C	T	4	2	6	0	0	6	0	0
23	32592518	.	A	G	1	1	2	0	0	2	0	0
23	32592593	.	C	T	0	5	5	0	3	8	0	0
23	32592608	.	A	C	3	3	6	0	0	6	0	0
23	32599214	.	G	T	5	5	10	0	0	10	0	0
23	32621780	.	C	T	0	1	1	0	1	2	0	0
23	32621792	.	G	A	1	1	2	0	0	2	0	0
23	32636209	.	T	C	1	3	4	0	0	4	0	0
23	32636251	.	G	A	2	3	5	0	0	5	0	0
23	32668999	.	A	G	4	1	5	0	0	5	0	0
23	32892403	.	G	T	3	2	5	0	0	5	0	0
23	33357953	.	T	A	3	8	11	0	0	11	0	0
23	33361256	.	C	T	1	3	4	0	6	10	0	0
23	33361310	.	C	T	5	8	13	0	1	14	0	0
23	33633592	.	T	C	3	2	5	0	0	5	0	0
23	33633620	.	G	A	3	4	7	0	2	9	0	0
23	33636203	.	C	T	0	1	1	0	0	1	0	0
23	33657205	.	A	G	15	16	31	0	1	32	0	0
23	33657451	.	A	G	4	10	14	0	1	15	0	0
23	33658013	.	T	G	7	8	15	0	0	15	0	0
23	33658031	.	A	C	6	11	17	0	0	17	0	0
23	33658052	.	G	A	10	4	14	0	1	15	0	0
23	33663285	.	C	T	3	1	4	0	0	4	0	0
23	33664546	.	C	T	3	5	8	0	1	9	0	0
23	33678530	.	G	A	7	7	14	0	0	14	0	0
23	34384939	.	C	T	0	3	3	0	0	3	0	0
23	34427379	.	T	C	4	4	8	0	0	8	0	0
23	34559897	.	C	T	2	3	5	0	0	5	0	0
23	34559971	.	C	T	2	2	4	0	1	5	0	0
23	34641484	.	C	T	3	5	8	0	0	8	0	0
23	34641505	.	G	A	0	5	5	0	3	8	0	0
23	34678957	.	G	T	2	5	7	0	0	7	0	0
23	34679008	.	A	G	2	9	11	0	1	12	0	0
23	34696631	.	C	T	4	6	10	0	0	10	0	0
23	34726384	.	A	G	5	0	5	0	3	8	0	0
23	34726387	.	A	G	5	4	9	0	0	9	0	0
23	34726438	.	T	C	6	2	8	0	2	10	0	0
23	34726444	.	G	T	5	4	9	0	1	10	0	0
23	34732871	.	A	G	4	0	4	0	3	7	0	0
23	34748833	.	G	A	0	10	10	0	5	15	0	0
23	34753803	.	A	G	9	8	17	0	2	19	0	0
23	35027386	.	T	G	3	3	6	0	0	6	0	0
23	35027480	.	T	G	4	3	7	0	1	8	0	0
23	35027518	.	T	A	5	5	10	0	1	11	0	0
23	35027541	.	A	G	5	6	11	0	0	11	0	0
23	35027736	.	C	G	5	9	14	0	0	14	0	0
23	35039803	.	C	T	2	3	5	0	0	5	0	0
23	35064271	.	T	G	1	3	4	0	0	4	0	0
23	35187726	.	C	T	4	2	6	0	0	6	0	0
23	35187739	.	G	T	5	2	7	0	0	7	0	0
23	35192619	.	A	G	1	2	3	0	0	3	0	0
23	35256186	.	G	A	6	6	12	0	0	12	0	0
23	35362951	.	C	T	6	5	11	0	0	11	0	0
23	35362973	.	G	T	5	2	7	0	1	8	0	0
23	35363024	.	A	T	5	9	14	0	0	14	0	0
23	35363067	.	A	T	5	4	9	0	4	13	0	0
23	35363106	.	G	A	8	12	20	0	1	21	0	0
23	35363111	.	C	G	9	14	23	0	1	24	0	0
23	35363226	.	T	C	13	0	13	0	13	26	0	0
23	35363341	.	A	G	16	6	22	0	1	23	0	0
23	35369733	.	G	A	1	3	4	0	0	4	0	0
23	35376893	.	A	G	2	0	2	0	0	2	0	0
23	35383037	.	C	T	2	2	4	0	0	4	0	0
23	35386349	.	A	G	4	3	7	0	0	7	0	0
23	35386394	.	C	T	0	3	3	0	4	7	0	0
23	35386415	.	G	A	4	3	7	0	0	7	0	0
23	35389118	.	C	T	1	1	2	0	0	2	0	0
23	35393459	.	A	G	2	1	3	0	1	4	0	0
23	35393473	.	G	T	2	1	3	0	0	3	0	0
23	35396735	.	C	A	5	2	7	0	0	7	0	0
23	35396791	.	C	A	5	4	9	0	0	9	0	0
23	35469135	.	T	C	5	3	8	0	1	9	0	0
23	35469136	.	G	A	5	4	9	0	0	9	0	0
23	35469479	.	A	G	5	10	15	0	2	17	0	0
23	35469668	.	G	T	9	9	18	0	1	19	0	0
23	35473640	.	A	G	2	0	2	0	0	2	0	0
23	35479987	.	G	A	2	0	2	0	0	2	0	0
23	35537390	.	C	T	5	8	13	0	0	13	0	0
23	35537599	.	G	A	9	6	15	0	0	15	0	0
23	35537617	.	G	A	7	5	12	0	0	12	0	0
23	35537693	.	A	C	5	3	8	0	0	8	0	0
23	35642195	.	C	T	8	4	12	0	0	12	0	0
23	35642327	.	T	G	6	10	16	0	1	17	0	0
23	35661380	.	C	T	0	4	4	0	1	5	0	0
23	35661530	.	T	C	8	5	13	0	0	13	0	0
23	35661549	.	A	C	8	4	12	0	0	12	0	0
23	35661572	.	A	C	4	4	8	0	0	8	0	0
23	35661692	.	C	A	4	3	7	0	0	7	0	0
23	35661723	.	A	C	1	1	2	0	0	2	0	0
23	35663421	.	T	G	8	4	12	0	0	12	0	0
23	35664298	.	A	G	1	7	8	0	0	8	0	0
23	35709839	.	T	C	29	12	41	0	2	43	0	0
23	35710620	.	A	C	24	20	44	0	1	45	0	0
23	35714883	.	T	C	1	1	2	0	0	2	0	0
23	35746290	.	A	G	1	2	3	0	0	3	0	0
23	35771483	.	T	C	7	12	19	0	0	19	0	0
23	35771486	.	T	C	7	10	17	0	0	17	0	0
23	35782311	.	T	C	7	5	12	0	0	12	0	0
23	35787331	.	T	G	1	3	4	0	0	4	0	0
23	35787449	.	A	G	1	5	6	0	0	6	0	0
23	35787573	.	A	G	4	4	8	0	0	8	0	0
23	35787841	.	G	T	3	4	7	0	1	8	0	0
23	35788256	.	G	A	3	7	10	0	0	10	0	0
23	35788328	.	G	A	11	5	16	0	0	16	0	0
23	35788505	.	C	T	4	1	5	0	3	8	0	0
23	35788513	.	G	A	4	4	8	0	0	8	0	0
23	35789716	.	G	T	2	2	4	0	0	4	0	0
23	35789720	.	T	G	2	2	4	0	0	4	0	0
23	35800378	.	T	C	0	0	0	0	5	5	0	0
23	35800550	.	C	T	0	5	5	0	9	14	0	0
23	35800591	.	C	T	12	5	17	0	0	17	0	0
23	35821401	.	C	T	1	3	4	0	0	4	0	0
23	35821403	.	C	T	0	3	3	0	1	4	0	0
23	35821442	.	T	A	3	6	9	0	0	9	0	0
23	35918697	.	A	T	7	4	11	0	0	11	0	0
23	35918795	.	G	A	1	10	11	0	1	12	0	0
23	35960683	.	G	A	2	5	7	0	0	7	0	0
23	35963076	.	G	T	0	0	0	0	2	2	0	0
23	35963176	.	T	G	6	8	14	0	2	16	0	0
23	35963316	.	C	T	7	6	13	0	1	14	0	0
23	35963322	.	T	G	7	6	13	0	1	14	0	0
23	35963718	.	C	A	2	3	5	0	0	5	0	0
23	35982441	.	A	G	12	8	20	0	0	20	0	0
23	35982533	.	G	A	5	10	15	0	0	15	0	0
23	35982637	.	G	A	2	8	10	0	0	10	0	0
23	35982726	.	C	G	9	8	17	0	0	17	0	0
23	35982755	.	T	C	8	8	16	0	1	17	0	0
23	35983029	.	A	G	10	10	20	0	1	21	0	0
23	35993540	.	T	A	6	2	8	0	1	9	0	0
23	36000704	.	T	C	4	0	4	0	2	6	0	0
23	36103602	.	T	A	2	2	4	0	0	4	0	0
23	36132338	.	C	A	7	5	12	0	0	12	0	0
23	36190623	.	A	T	3	2	5	0	0	5	0	0
23	36297367	.	C	T	0	5	5	0	6	11	0	0
23	36297471	.	C	T	3	7	10	0	0	10	0	0
23	36297916	.	C	T	7	5	12	0	1	13	0	0
23	36298320	.	T	A	9	20	29	0	0	29	0	0
23	36298327	.	A	T	19	10	29	0	1	30	0	0
23	36298375	.	T	C	12	19	31	0	1	32	0	0
23	36298719	.	G	A	12	16	28	0	3	31	0	0
23	36301544	.	G	A	15	9	24	0	0	24	0	0
23	36301679	.	A	G	21	13	34	0	2	36	0	0
23	36303266	.	G	C	3	3	6	0	0	6	0	0
23	36306566	.	G	T	0	1	1	0	0	1	0	0
23	36307656	.	A	T	18	25	43	0	6	49	0	0
23	36307779	.	C	T	4	1	5	0	0	5	0	0
23	36307906	.	C	G	0	1	1	0	1	2	0	0
23	36343467	.	T	C	8	4	12	0	0	12	0	0
23	36353698	.	A	G	15	14	29	0	2	31	0	0
23	36353869	.	C	G	17	6	23	0	1	24	0	0
23	36353876	.	G	T	0	13	13	0	8	21	0	0
23	36353979	.	G	T	1	9	10	0	18	28	0	0
23	36401591	.	T	C	1	2	3	0	0	3	0	0
23	36401624	.	T	A	3	1	4	0	0	4	0	0
23	36401632	.	C	T	2	2	4	0	1	5	0	0
23	36401686	.	G	T	1	3	4	0	0	4	0	0
23	36401844	.	A	G	4	2	6	0	0	6	0	0
23	36401926	.	T	C	2	6	8	0	0	8	0	0
23	36401930	.	A	G	2	4	6	0	0	6	0	0
23	36401986	.	G	C	1	3	4	0	0	4	0	0
23	36402184	.	A	G	6	3	9	0	2	11	0	0
23	36404898	.	C	G	0	1	1	0	0	1	0	0
23	36404967	.	A	G	3	0	3	0	1	4	0	0
23	36405429	.	A	G	3	0	3	0	0	3	0	0
23	36443511	.	A	T	3	8	11	0	1	12	0	0
23	36443865	.	C	A	3	3	6	0	0	6	0	0
23	36444201	.	G	C	11	0	11	0	8	19	0	0
23	36445967	.	C	G	3	5	8	0	0	8	0	0
23	36446023	.	G	A	10	7	17	0	0	17	0	0
23	36446132	.	A	G	3	5	8	0	1	9	0	0
23	36446190	.	A	T	9	4	13	0	0	13	0	0
23	36446258	.	T	C	5	0	5	0	3	8	0	0
23	36446271	.	C	T	2	4	6	0	0	6	0	0
23	36477749	.	A	G	1	0	1	0	1	2	0	0
23	36484210	.	C	G	1	0	1	0	0	1	0	0
23	36487257	.	C	T	1	5	6	0	0	6	0	0
23	36487280	.	A	G	1	4	5	0	1	6	0	0
23	36487298	.	C	A	2	2	4	0	1	5	0	0
23	36487865	.	C	T	10	5	15	0	0	15	0	0
23	36488378	.	G	C	1	3	4	0	0	4	0	0
23	36488478	.	T	C	1	2	3	0	0	3	0	0
23	36491169	.	C	G	0	4	4	0	3	7	0	0
23	36497530	.	A	T	3	3	6	0	0	6	0	0
23	36538298	.	G	A	1	3	4	0	0	4	0	0
23	36538306	.	A	G	0	4	4	0	0	4	0	0
23	36604488	.	G	A	0	2	2	0	0	2	0	0
23	36616998	.	C	T	4	3	7	0	0	7	0	0
23	36627793	.	C	T	16	15	31	0	0	31	0	0
23	36627859	.	G	C	2	1	3	0	0	3	0	0
23	36638542	.	G	A	13	8	21	0	1	22	0	0
23	36644423	.	T	G	19	22	41	0	1	42	0	0
23	36644907	.	C	T	20	15	35	0	0	35	0	0
23	36661216	.	T	C	1	2	3	0	0	3	0	0
23	36662097	.	A	G	1	4	5	0	0	5	0	0
23	36662098	.	C	G	0	4	4	0	1	5	0	0
23	36662174	.	T	G	2	2	4	0	0	4	0	0
23	36662175	.	T	G	2	2	4	0	0	4	0	0
23	36662400	.	A	G	0	2	2	0	1	3	0	0
23	36662449	.	A	C	1	5	6	0	1	7	0	0
23	36662651	.	G	C	3	3	6	0	1	7	0	0
23	36662685	.	C	A	1	2	3	0	0	3	0	0
23	36662714	.	G	A	1	2	3	0	0	3	0	0
23	36662772	.	A	T	3	3	6	0	0	6	0	0
23	36663346	.	G	A	2	2	4	0	0	4	0	0
23	36663506	.	C	A	0	3	3	0	2	5	0	0
23	36663512	.	C	T	0	2	2	0	2	4	0	0
23	36666666	.	A	G	2	4	6	0	0	6	0	0
23	36666669	.	A	G	1	4	5	0	0	5	0	0
23	36667131	.	T	C	4	0	4	0	4	8	0	0
23	36679751	.	C	T	11	16	27	0	1	28	0	0
23	36679829	.	G	C	17	0	17	0	25	42	0	0
23	36679874	.	T	C	7	0	7	0	17	24	0	0
23	36681545	.	C	T	0	1	1	0	2	3	0	0
23	36681557	.	A	G	1	2	3	0	1	4	0	0
23	36681927	.	T	C	1	0	1	0	0	1	0	0
23	36683801	.	G	A	5	2	7	0	1	8	0	0
23	36688236	.	T	C	11	0	11	0	9	20	0	0
23	36689677	.	C	T	4	5	9	0	0	9	0	0
23	36690595	.	G	A	3	12	15	0	0	15	0	0
23	36690641	.	T	A	13	6	19	0	1	20	0	0
23	36700836	.	T	G	1	4	5	0	0	5	0	0
23	36700891	.	G	A	13	8	21	0	1	22	0	0
23	36700896	.	T	A	14	8	22	0	0	22	0	0
23	36730854	.	A	T	3	1	4	0	0	4	0	0
23	36738776	.	C	T	0	3	3	0	0	3	0	0
23	36749380	.	G	A	0	14	14	0	24	38	0	0
23	36750005	.	C	G	9	16	25	0	1	26	0	0
23	36750440	.	A	T	2	1	3	0	0	3	0	0
23	36753191	.	A	G	1	0	1	0	4	5	0	0
23	36772018	.	G	A	1	16	17	0	9	26	0	0
23	36798184	.	C	T	7	15	22	0	0	22	0	0
23	36798220	.	G	A	13	12	25	0	0	25	0	0
23	36798612	.	G	A	0	14	14	0	10	24	0	0
23	36816573	.	A	G	3	4	7	0	0	7	0	0
23	36816698	.	G	T	7	4	11	0	0	11	0	0
23	36816840	.	C	T	1	0	1	0	0	1	0	0
23	36846006	.	C	T	0	2	2	0	1	3	0	0
23	36856128	.	G	A	0	1	1	0	0	1	0	0
23	36907624	.	G	A	4	6	10	0	0	10	0	0
23	36907690	.	A	G	2	4	6	0	0	6	0	0
23	36910155	.	G	A	0	1	1	0	0	1	0	0
23	36914223	.	A	G	3	1	4	0	0	4	0	0
23	36920063	.	C	T	0	5	5	0	1	6	0	0
23	37065182	.	G	A	1	1	2	0	0	2	0	0
23	37075407	.	C	T	1	3	4	0	1	5	0	0
23	37077689	.	A	C	3	1	4	0	0	4	0	0
23	37085367	.	T	C	2	0	2	0	2	4	0	0
23	37085421	.	C	T	3	2	5	0	0	5	0	0
23	37086288	.	A	C	11	5	16	0	0	16	0	0
23	37086317	.	G	T	1	5	6	0	2	8	0	0
23	37086368	.	G	A	6	5	11	0	0	11	0	0
23	37089042	.	G	A	5	3	8	0	0	8	0	0
23	37089102	.	G	A	3	7	10	0	0	10	0	0
23	37089162	.	C	T	10	9	19	0	0	19	0	0
23	37089192	.	C	T	7	11	18	0	2	20	0	0
23	37089333	.	C	T	9	3	12	0	1	13	0	0
23	37089568	.	C	T	11	2	13	0	0	13	0	0
23	37089609	.	T	G	7	7	14	0	0	14	0	0
23	37089852	.	A	T	5	5	10	0	0	10	0	0
23	37090003	.	T	C	3	7	10	0	0	10	0	0
23	37277157	.	A	G	7	10	17	0	1	18	0	0
23	37277289	.	G	A	1	2	3	0	0	3	0	0
23	37280658	.	C	T	4	5	9	0	0	9	0	0
23	37287919	.	T	A	3	2	5	0	0	5	0	0
23	37288467	.	A	G	4	4	8	0	0	8	0	0
23	37324009	.	A	G	16	0	16	0	11	27	0	0
23	37324638	.	A	C	20	15	35	0	0	35	0	0
23	37324848	.	G	A	13	7	20	0	2	22	0	0
23	37324868	.	G	C	17	5	22	0	0	22	0	0
23	37324990	.	A	G	15	12	27	0	4	31	0	0
23	37325026	.	C	T	19	16	35	0	1	36	0	0
23	37325138	.	T	G	16	0	16	0	16	32	0	0
23	37325570	.	A	C	21	13	34	0	1	35	0	0
23	37325817	.	T	G	8	8	16	0	1	17	0	0
23	37458748	.	G	A	10	12	22	0	0	22	0	0
23	37458791	.	A	T	3	2	5	0	0	5	0	0
23	37464452	.	A	G	9	12	21	0	1	22	0	0
23	37464621	.	A	G	10	3	13	0	0	13	0	0
23	37464661	.	T	A	10	0	10	0	0	11	1	0
23	37464760	.	G	C	1	7	8	0	15	23	0	0
23	37464804	.	C	A	11	5	16	0	0	16	0	0
23	37465007	.	T	C	12	8	20	0	0	20	0	0
23	37465257	.	A	G	4	0	4	0	4	8	0	0
23	37465276	.	A	T	5	2	7	0	0	7	0	0
23	37465332	.	A	T	15	5	20	0	0	20	0	0
23	37465414	.	G	A	8	11	19	0	1	20	0	0
23	37465479	.	G	C	12	14	26	0	1	27	0	0
23	37465505	.	A	G	9	7	16	0	4	20	0	0
23	37465527	.	A	G	11	9	20	0	1	21	0	0
23	37465584	.	T	C	5	4	9	0	0	9	0	0
23	37465813	.	A	G	4	2	6	0	0	6	0	0
23	37465820	.	A	C	4	2	6	0	0	6	0	0
23	37467073	.	A	G	6	3	9	0	0	9	0	0
23	37467109	.	A	G	12	0	12	0	7	19	0	0
23	37467115	.	A	G	13	0	13	0	6	19	0	0
23	37468225	.	T	C	0	2	2	0	0	2	0	0
23	37468393	.	A	G	3	8	11	0	0	11	0	0
23	37476475	.	T	C	1	0	1	0	0	1	0	0
23	37476675	.	G	A	1	3	4	0	5	9	0	0
23	37478227	.	G	T	1	1	2	0	1	3	0	0
23	37478506	.	C	G	4	7	11	0	0	11	0	0
23	37479798	.	G	A	12	2	14	0	0	14	0	0
23	37479799	.	A	T	10	2	12	0	2	14	0	0
23	37479992	.	G	T	25	6	31	0	3	34	0	0
23	37497367	.	A	T	4	2	6	0	0	6	0	0
23	37503288	.	A	G	0	1	1	0	0	1	0	0
23	37504803	.	A	G	2	1	3	0	0	3	0	0
23	37504900	.	A	G	3	4	7	0	0	7	0	0
23	37505129	.	G	A	1	4	5	0	0	5	0	0
23	37823651	.	T	A	6	3	9	0	0	9	0	0
23	37823704	.	A	G	7	3	10	0	1	11	0	0
23	37823710	.	T	C	8	3	11	0	1	12	0	0
23	37823782	.	T	C	2	7	9	0	0	9	0	0
23	37823795	.	T	C	4	9	13	0	0	13	0	0
23	37828884	.	A	G	6	5	11	0	1	12	0	0
23	37955662	.	G	C	0	4	4	0	4	8	0	0
23	37970998	.	C	T	0	2	2	0	0	2	0	0
23	38151520	.	C	T	11	16	27	0	0	27	0	0
23	38252466	.	C	T	1	2	3	0	0	3	0	0
23	38379786	.	C	T	0	15	15	0	12	27	0	0
23	38380005	.	C	T	11	19	30	0	0	30	0	0
23	38380047	.	G	A	12	13	25	0	0	25	0	0
23	38381217	.	C	T	0	11	11	0	8	19	0	0
23	38381281	.	T	C	5	10	15	0	0	15	0	0
23	38381316	.	T	C	4	0	4	0	11	15	0	0
23	38381490	.	G	A	6	3	9	0	0	9	0	0
23	38807624	.	C	T	6	3	9	0	0	9	0	0
23	38810913	.	A	G	0	1	1	0	0	1	0	0
23	38810927	.	T	C	0	1	1	0	0	1	0	0
23	38816824	.	T	C	3	5	8	0	0	8	0	0
23	38816827	.	T	C	3	5	8	0	0	8	0	0
23	38817049	.	A	G	3	3	6	0	0	6	0	0
23	38817745	.	G	A	3	5	8	0	0	8	0	0
23	38818001	.	G	A	1	4	5	0	0	5	0	0
23	38818004	.	G	A	1	4	5	0	0	5	0	0
23	38818234	.	A	G	1	0	1	0	4	5	0	0
23	38818249	.	G	T	5	2	7	0	0	7	0	0
23	39002515	.	G	A	0	4	4	0	3	7	0	0
23	39006575	.	C	T	1	1	2	0	0	2	0	0
23	39015280	.	C	T	0	1	1	0	0	1	0	0
23	39028513	.	C	T	3	2	5	0	0	5	0	0
23	39321992	.	T	C	2	2	4	0	0	4	0	0
23	39322043	.	T	C	3	2	5	0	0	5	0	0
23	39413341	.	A	C	4	4	8	0	0	8	0	0
23	39425547	.	G	A	1	0	1	0	0	1	0	0
23	39433818	.	C	T	2	1	3	0	0	3	0	0
23	39440432	.	A	C	1	1	2	0	0	2	0	0
23	39448012	.	A	G	2	0	2	0	2	4	0	0
23	39449770	.	C	G	4	0	4	0	0	4	0	0
23	39450022	.	A	G	5	5	10	0	0	10	0	0
23	39516525	.	T	C	2	4	6	0	0	6	0	0
23	39516528	.	T	C	2	3	5	0	0	5	0	0
23	39516572	.	C	A	2	3	5	0	1	6	0	0
23	39587272	.	T	C	3	2	5	0	0	5	0	0
23	39587284	.	G	C	3	4	7	0	0	7	0	0
23	39587323	.	A	G	4	0	4	0	3	7	0	0
23	39587347	.	G	T	2	0	2	0	0	2	0	0
23	39591674	.	C	T	4	4	8	0	1	9	0	0
23	39593793	.	T	C	3	0	3	0	0	3	0	0
23	39594141	.	C	T	2	1	3	0	0	3	0	0
23	39594211	.	A	G	4	2	6	0	4	10	0	0
23	39594854	.	T	G	1	2	3	0	1	4	0	0
23	39594857	.	C	A	2	2	4	0	0	4	0	0
23	39594950	.	T	A	2	2	4	0	0	4	0	0
23	39594962	.	C	T	1	3	4	0	0	4	0	0
23	39595044	.	C	T	1	2	3	0	0	3	0	0
23	39595159	.	G	A	0	3	3	0	4	7	0	0
23	39595248	.	T	G	4	3	7	0	0	7	0	0
23	39595297	.	G	T	5	5	10	0	0	10	0	0
23	39595974	.	C	T	4	8	12	0	0	12	0	0
23	39596028	.	C	T	2	7	9	0	1	10	0	0
23	39596545	.	A	C	5	4	9	0	0	9	0	0
23	39596776	.	T	C	8	6	14	0	0	14	0	0
23	39596919	.	G	A	0	3	3	0	5	8	0	0
23	39597119	.	G	T	4	7	11	0	1	12	0	0
23	39597309	.	G	A	0	4	4	0	8	12	0	0
23	39597566	.	T	C	7	1	8	0	0	8	0	0
23	39607439	.	A	G	2	4	6	0	1	7	0	0
23	39607494	.	G	T	1	2	3	0	0	3	0	0
23	39611787	.	G	T	1	2	3	0	3	6	0	0
23	39615660	.	C	T	0	3	3	0	0	3	0	0
23	39615689	.	G	C	4	1	5	0	0	5	0	0
23	39615706	.	C	A	4	2	6	0	0	6	0	0
23	39623042	.	G	A	0	6	6	0	6	12	0	0
23	39626230	.	G	C	4	7	11	0	0	12	1	0
23	39626311	.	C	T	11	10	21	0	0	21	0	0
23	39626395	.	C	T	6	9	15	0	0	15	0	0
23	39626525	.	G	A	6	4	10	0	2	12	0	0
23	39632901	.	A	G	4	5	9	0	0	9	0	0
23	39633114	.	C	T	0	3	3	0	5	8	0	0
23	39633150	.	C	T	1	2	3	0	0	3	0	0
23	39635959	.	C	T	1	0	1	0	2	3	0	0
23	39636079	.	G	T	7	5	12	0	0	12	0	0
23	39636181	.	C	T	1	3	4	0	0	4	0	0
23	39638480	.	A	G	5	5	10	0	0	10	0	0
23	39641840	.	G	A	1	3	4	0	0	4	0	0
23	39642002	.	C	T	0	2	2	0	2	4	0	0
23	39649499	.	C	A	4	6	10	0	0	10	0	0
23	39649569	.	C	T	2	3	5	0	1	6	0	0
23	39649607	.	C	T	2	4	6	0	0	6	0	0
23	39649671	.	A	G	3	3	6	0	0	6	0	0
23	39744501	.	A	G	7	7	14	0	0	14	0	0
23	39744788	.	T	A	8	0	8	0	0	8	0	0
23	39744943	.	A	T	19	7	26	0	0	26	0	0
23	39756666	.	A	G	6	3	9	0	2	11	0	0
23	39756775	.	T	G	7	5	12	0	1	13	0	0
23	39756864	.	T	C	11	5	16	1	0	17	0	0
23	39756917	.	C	A	5	4	9	0	1	10	0	0
23	39756958	.	A	G	5	8	13	0	0	13	0	0
23	39757017	.	A	G	4	12	16	0	0	16	0	0
23	39757031	.	T	C	8	0	8	0	5	13	0	0
23	39758527	.	C	A	2	2	4	0	0	4	0	0
23	39759044	.	C	T	1	2	3	0	0	3	0	0
23	39759290	.	A	C	1	2	3	0	1	4	0	0
23	39759344	.	A	C	5	1	6	0	3	9	0	0
23	39759355	.	T	C	4	1	5	0	4	9	0	0
23	39759400	.	T	C	5	0	5	0	5	10	0	0
23	39764906	.	C	T	0	7	7	0	1	8	0	0
23	39765105	.	G	A	2	1	3	0	0	3	0	0
23	39767894	.	A	G	18	11	29	0	1	30	0	0
23	39768001	.	T	G	3	3	6	0	2	8	0	0
23	39771935	.	C	T	2	6	8	0	1	9	0	0
23	39771972	.	A	T	5	7	12	0	1	13	0	0
23	39772002	.	C	T	7	9	16	0	0	16	0	0
23	39772035	.	G	A	3	4	7	0	2	9	0	0
23	39808332	.	G	A	11	4	15	0	1	16	0	0
23	39808337	.	G	C	10	5	15	0	0	15	0	0
23	39808439	.	A	G	18	12	30	0	4	34	0	0
23	39808644	.	A	C	14	6	20	0	0	20	0	0
23	39808705	.	A	G	12	6	18	0	1	19	0	0
23	39809251	.	C	A	13	3	16	2	3	21	0	0
23	39809254	.	A	G	13	2	15	2	3	20	0	0
23	39809381	.	A	T	4	6	10	6	2	18	0	0
23	39809437	.	A	G	6	14	20	0	2	22	0	0
23	39809454	.	T	G	7	11	18	0	1	19	0	0
23	39809876	.	C	T	1	11	12	1	12	25	0	0
23	39811187	.	C	T	0	7	7	0	2	9	0	0
23	39811191	.	C	A	2	8	10	0	0	10	0	0
23	39811242	.	T	C	8	12	20	0	1	21	0	0
23	39811324	.	A	G	10	10	20	0	0	20	0	0
23	39811401	.	T	C	6	5	11	0	0	11	0	0
23	39811548	.	A	G	5	2	7	0	0	7	0	0
23	39811587	.	G	A	3	2	5	0	0	5	0	0
23	39811612	.	T	C	3	5	8	0	0	8	0	0
23	39811647	.	C	G	4	10	14	0	0	14	0	0
23	39811741	.	G	A	12	7	19	0	0	19	0	0
23	39811956	.	T	A	10	3	13	0	1	14	0	0
23	39812003	.	A	G	9	6	15	0	0	15	0	0
23	39812131	.	T	C	8	13	21	0	0	21	0	0
23	39812142	.	C	G	9	14	23	0	1	24	0	0
23	39812482	.	G	A	1	8	9	0	0	9	0	0
23	39812535	.	T	C	5	9	14	0	1	15	0	0
23	39812608	.	C	T	0	13	13	0	7	20	0	0
23	39812633	.	A	T	8	10	18	0	1	19	0	0
23	39812643	.	C	T	0	13	13	0	7	20	0	0
23	39901454	.	T	C	4	3	7	0	0	7	0	0
23	39924005	.	G	C	6	3	9	0	0	9	0	0
23	39926437	.	T	C	1	3	4	0	0	4	0	0
23	39929955	.	G	A	3	4	7	0	0	7	0	0
23	39936352	.	A	G	1	0	1	0	2	3	0	0
23	39940362	.	A	G	1	3	4	0	1	5	0	0
23	39940371	.	T	C	2	4	6	0	0	6	0	0
23	39940421	.	G	T	1	4	5	0	0	5	0	0
23	39940575	.	G	C	3	4	7	0	0	7	0	0
23	39940577	.	G	A	3	3	6	0	1	7	0	0
23	39988019	.	G	A	1	2	3	0	0	3	0	0
23	39989525	.	A	G	2	0	2	0	2	4	0	0
23	40007485	.	G	A	1	2	3	0	0	3	0	0
23	40019258	.	G	T	2	2	4	0	0	4	0	0
23	40237159	.	G	A	1	3	4	0	0	4	0	0
23	40283022	.	C	T	1	3	4	0	0	4	0	0
23	40283618	.	A	G	2	3	5	0	0	5	0	0
23	40283640	.	C	T	1	2	3	0	0	3	0	0
23	40285775	.	T	A	4	3	7	0	0	7	0	0
23	40438000	.	T	A	4	2	6	0	1	7	0	0
23	40452660	.	A	T	11	7	18	0	0	18	0	0
23	40452667	.	T	C	11	7	18	0	1	19	0	0
23	40452735	.	G	T	13	8	21	0	0	21	0	0
23	40452739	.	G	C	0	8	8	0	12	20	0	0
23	40452793	.	A	G	5	4	9	0	0	9	0	0
23	40460860	.	G	C	2	2	4	0	0	4	0	0
23	40462004	.	A	G	6	6	12	0	0	12	0	0
23	40462538	.	G	A	5	6	11	0	0	11	0	0
23	40466320	.	C	T	3	4	7	0	0	7	0	0
23	40466623	.	C	G	7	7	14	0	1	15	0	0
23	40466714	.	T	A	8	9	17	0	0	17	0	0
23	40471963	.	G	A	0	11	11	0	7	18	0	0
23	40472068	.	A	G	5	0	5	0	11	16	0	0
23	40480255	.	C	A	9	8	17	0	0	17	0	0
23	40480263	.	C	T	7	8	15	0	0	15	0	0
23	40526361	.	T	C	6	5	11	0	0	11	0	0
23	40526713	.	T	C	1	1	2	0	0	2	0	0
23	40526745	.	G	T	3	3	6	0	2	8	0	0
23	40526760	.	G	A	7	6	13	0	0	13	0	0
23	40526883	.	T	G	2	6	8	0	1	9	0	0
23	40527174	.	A	T	1	0	1	0	0	1	0	0
23	40527205	.	C	T	2	0	2	0	0	2	0	0
23	40527359	.	T	C	8	0	8	0	4	12	0	0
23	40527425	.	C	T	0	4	4	0	6	10	0	0
23	40527427	.	A	C	6	0	6	0	4	10	0	0
23	40527583	.	G	A	5	4	9	0	1	10	0	0
23	40527632	.	G	A	6	3	9	0	1	10	0	0
23	40527653	.	T	G	2	4	6	0	1	7	0	0
23	40527993	.	A	C	4	2	6	0	0	6	0	0
23	40528019	.	C	T	5	4	9	0	0	9	0	0
23	40528172	.	T	C	1	0	1	0	2	3	0	0
23	40528182	.	T	C	0	0	0	0	3	3	0	0
23	40528209	.	C	T	2	2	4	0	0	4	0	0
23	40528226	.	G	C	2	3	5	0	0	5	0	0
23	40528669	.	C	T	0	10	10	0	7	17	0	0
23	40528727	.	G	A	12	11	23	0	0	23	0	0
23	40528886	.	T	A	6	13	19	0	2	21	0	0
23	40528998	.	G	A	9	14	23	0	1	24	0	0
23	40529137	.	T	C	12	8	20	0	0	20	0	0
23	40529288	.	T	C	7	5	12	0	1	13	0	0
23	40529318	.	A	G	6	9	15	0	1	16	0	0
23	40529693	.	T	C	8	6	14	0	0	14	0	0
23	40529708	.	T	C	5	5	10	0	0	10	0	0
23	40529747	.	G	A	2	1	3	0	0	3	0	0
23	40605193	.	A	T	1	6	7	0	1	8	0	0
23	40605223	.	T	A	2	4	6	0	0	6	0	0
23	40605234	.	A	G	3	3	6	0	0	6	0	0
23	40605356	.	C	T	1	4	5	0	0	5	0	0
23	40655395	.	T	G	2	3	5	0	0	5	0	0
23	40655425	.	A	G	2	2	4	0	0	4	0	0
23	40720200	.	T	C	6	4	10	0	0	10	0	0
23	40720216	.	G	A	1	6	7	0	4	11	0	0
23	40731757	.	A	G	0	1	1	0	0	1	0	0
23	40738508	.	A	G	1	4	5	0	0	5	0	0
23	40741673	.	A	G	3	3	6	0	0	6	0	0
23	40742067	.	G	A	0	8	8	0	4	12	0	0
23	40742145	.	A	G	6	0	6	0	4	10	0	0
23	40742236	.	G	C	4	7	11	0	0	11	0	0
23	40755895	.	C	G	1	2	3	0	0	3	0	0
23	40755903	.	C	T	1	1	2	0	0	2	0	0
23	40761073	.	T	A	2	4	6	0	0	6	0	0
23	40766436	.	A	G	7	4	11	0	0	11	0	0
23	40766470	.	C	T	3	3	6	0	0	6	0	0
23	40937532	.	T	C	1	1	2	0	1	3	0	0
23	40937583	.	G	T	1	1	2	0	0	2	0	0
23	40972121	.	G	A	0	3	3	0	0	3	0	0
23	40972205	.	A	T	4	5	9	0	0	9	0	0
23	40986765	.	G	A	1	1	2	0	0	2	0	0
23	41021774	.	G	A	1	2	3	0	0	3	0	0
23	41198104	.	G	C	1	1	2	0	0	2	0	0
23	41225955	.	G	A	0	3	3	0	3	6	0	0
23	41226179	.	A	G	0	0	0	0	4	4	0	0
23	41227092	.	T	C	3	1	4	0	1	5	0	0
23	41228876	.	G	A	0	1	1	0	3	4	0	0
23	41228903	.	T	G	1	2	3	0	1	4	0	0
23	41313116	.	G	C	7	7	14	0	0	14	0	0
23	41320957	.	G	A	4	2	6	0	0	6	0	0
23	41381026	.	A	C	1	1	2	0	0	2	0	0
23	41739874	.	C	A	2	4	6	0	0	7	1	0
23	41739952	.	G	A	3	2	5	0	0	5	0	0
23	41754587	.	A	G	3	3	6	0	0	6	0	0
23	41799849	.	C	A	3	0	3	0	0	3	0	0
23	41801492	.	C	T	12	15	27	0	2	29	0	0
23	41801555	.	G	A	10	10	20	0	1	21	0	0
23	41801940	.	G	T	11	14	25	0	4	29	0	0
23	41802130	.	T	G	8	15	23	0	1	24	0	0
23	41802932	.	C	T	1	1	2	0	0	2	0	0
23	41802944	.	G	T	1	2	3	0	0	3	0	0
23	41803017	.	G	A	2	4	6	0	1	7	0	0
23	41803124	.	G	T	5	7	12	0	1	13	0	0
23	41803160	.	C	T	5	6	11	0	0	11	0	0
23	41803217	.	T	C	1	0	1	0	7	8	0	0
23	41803447	.	G	A	3	4	7	0	0	7	0	0
23	41803473	.	A	G	3	3	6	0	0	6	0	0
23	41803643	.	G	C	2	2	4	0	0	4	0	0
23	41803672	.	C	T	2	3	5	0	0	5	0	0
23	41803740	.	A	G	3	10	13	0	0	13	0	0
23	41804039	.	A	G	1	1	2	0	0	2	0	0
23	41804070	.	C	T	0	2	2	0	1	3	0	0
23	41804202	.	T	A	4	2	6	0	0	6	0	0
23	41804518	.	A	C	4	3	7	0	0	7	0	0
23	41804776	.	G	C	3	9	12	0	0	12	0	0
23	41804779	.	A	T	2	9	11	0	0	11	0	0
23	41804934	.	A	C	2	0	2	0	4	6	0	0
23	41805158	.	C	T	2	8	10	0	1	11	0	0
23	41805348	.	G	A	4	15	19	0	0	19	0	0
23	41808038	.	G	A	1	1	2	0	0	2	0	0
23	41821117	.	G	C	1	2	3	0	1	4	0	0
23	41831305	.	T	A	14	8	22	0	1	23	0	0
23	41831306	.	C	T	15	6	21	0	2	23	0	0
23	41839373	.	G	A	0	2	2	0	0	2	0	0
23	41853782	.	T	C	10	8	18	0	0	18	0	0
23	41853876	.	T	C	6	10	16	0	0	16	0	0
23	41853892	.	A	T	6	6	12	0	1	13	0	0
23	41853989	.	T	C	13	4	17	0	0	17	0	0
23	41853994	.	G	T	12	3	15	0	1	16	0	0
23	41854025	.	C	A	12	4	16	0	1	17	0	0
23	41854030	.	C	A	11	4	15	0	0	15	0	0
23	41854068	.	G	T	12	7	19	0	0	19	0	0
23	41949703	.	G	A	2	3	5	0	0	5	0	0
23	41949748	.	T	G	1	4	5	0	1	6	0	0
23	41949751	.	A	G	1	4	5	0	1	6	0	0
23	42000700	.	C	T	0	2	2	0	2	4	0	0
23	42275411	.	A	T	1	1	2	0	0	2	0	0
23	42283476	.	A	G	4	5	9	0	0	9	0	0
23	42328175	.	A	G	0	0	0	0	2	2	0	0
23	42328184	.	T	C	0	2	2	0	0	2	0	0
23	42329684	.	C	G	4	2	6	0	0	6	0	0
23	42451447	.	T	C	3	2	5	0	0	5	0	0
23	42627857	.	G	A	1	2	3	0	0	3	0	0
23	42627981	.	T	C	3	2	5	0	0	5	0	0
23	42628083	.	A	G	1	4	5	0	0	5	0	0
23	42640631	.	C	T	5	3	8	0	0	8	0	0
23	42641652	.	A	G	0	3	3	0	1	4	0	0
23	42641879	.	T	C	10	4	14	0	0	14	0	0
23	42642361	.	G	A	12	5	17	0	3	20	0	0
23	42642543	.	A	C	0	1	1	3	2	6	0	0
23	42642593	.	T	G	6	3	9	0	1	10	0	0
23	42642623	.	C	A	6	1	7	0	2	9	0	0
23	42642780	.	G	T	4	3	7	0	0	7	0	0
23	42766124	.	C	A	2	4	6	0	0	6	0	0
23	42766378	.	A	G	2	2	4	0	0	4	0	0
23	42766419	.	C	T	1	2	3	0	0	3	0	0
23	42766607	.	G	A	3	4	7	0	0	7	0	0
23	42766609	.	A	T	3	4	7	0	0	7	0	0
23	42767453	.	C	T	0	3	3	0	9	12	0	0
23	43508171	.	T	C	4	2	6	0	0	6	0	0
23	43513159	.	T	G	1	0	1	0	2	3	0	0
23	43517448	.	G	A	0	3	3	0	0	3	0	0
23	43519409	.	G	A	2	3	5	0	0	5	0	0
23	43519414	.	G	A	1	4	5	0	0	5	0	0
23	43535874	.	G	A	2	2	4	0	0	4	0	0
23	43539296	.	G	T	1	1	2	0	0	2	0	0
23	43561464	.	C	T	0	0	0	0	1	1	0	0
23	43652261	.	A	G	3	5	8	0	0	8	0	0
23	43688291	.	T	C	3	2	5	0	0	5	0	0
23	43688737	.	G	A	2	3	5	0	0	5	0	0
23	43688810	.	T	C	3	2	5	0	1	6	0	0
23	43689202	.	T	C	3	3	6	0	0	6	0	0
23	43689621	.	C	G	3	0	3	0	2	5	0	0
23	43689675	.	T	C	1	1	2	0	1	3	0	0
23	43690394	.	A	G	3	2	5	0	0	5	0	0
23	43690506	.	C	A	2	7	9	0	0	9	0	0
23	43690629	.	C	G	3	0	3	0	3	6	0	0
23	43690762	.	C	A	2	3	5	0	0	5	0	0
23	43691336	.	T	G	1	2	3	0	0	3	0	0
23	43691528	.	C	T	1	2	3	0	0	3	0	0
23	43691750	.	T	C	1	2	3	0	1	4	0	0
23	43691770	.	T	C	1	3	4	0	0	4	0	0
23	43691915	.	A	G	1	0	1	0	3	4	0	0
23	43696095	.	G	A	26	9	35	0	1	36	0	0
23	43696211	.	G	T	23	16	39	0	1	40	0	0
23	43696355	.	G	A	19	11	30	0	0	30	0	0
23	43699846	.	A	G	4	16	20	0	0	20	0	0
23	43700064	.	T	C	9	0	9	0	10	19	0	0
23	43700114	.	G	A	6	6	12	0	1	13	0	0
23	43700121	.	G	A	6	6	12	0	1	13	0	0
23	43705961	.	G	T	10	8	18	0	0	18	0	0
23	43706003	.	A	G	18	19	37	0	0	37	0	0
23	43706102	.	T	G	12	10	22	0	0	22	0	0
23	43713602	.	A	G	1	3	4	0	0	4	0	0
23	43713692	.	T	A	3	4	7	0	0	7	0	0
23	43718169	.	T	A	7	5	12	0	1	13	0	0
23	43718185	.	T	A	6	5	11	0	2	13	0	0
23	43718225	.	G	A	0	3	3	0	2	5	0	0
23	43718257	.	G	T	0	2	2	0	0	2	0	0
23	43723615	.	G	A	0	1	1	0	0	1	0	0
23	43723633	.	C	T	1	4	5	0	0	5	0	0
23	43723765	.	C	T	5	3	8	0	0	8	0	0
23	43770158	.	T	A	1	1	2	0	1	3	0	0
23	43770210	.	C	T	7	6	13	0	2	15	0	0
23	43770240	.	A	C	8	13	21	0	1	22	0	0
23	43770279	.	A	T	5	9	14	0	0	14	0	0
23	43770319	.	T	G	4	0	4	0	5	9	0	0
23	43770360	.	A	T	8	4	12	0	0	12	0	0
23	43770414	.	T	C	7	5	12	0	0	12	0	0
23	43770433	.	T	C	10	8	18	0	0	18	0	0
23	43770467	.	T	C	7	11	18	0	4	22	0	0
23	43770583	.	C	A	10	8	18	0	0	18	0	0
23	43770634	.	G	C	9	8	17	0	1	18	0	0
23	43770832	.	T	C	5	4	9	0	0	9	0	0
23	43780214	.	C	T	3	1	4	0	1	5	0	0
23	43781781	.	C	T	5	3	8	0	0	8	0	0
23	43784985	.	C	T	9	13	22	0	1	23	0	0
23	43799463	.	T	C	3	4	7	0	0	7	0	0
23	43799798	.	A	C	4	3	7	0	1	8	0	0
23	43799835	.	A	G	1	0	1	0	3	4	0	0
23	43800270	.	T	A	1	3	4	0	0	4	0	0
23	43800280	.	A	T	1	2	3	0	0	3	0	0
23	43800509	.	G	C	0	2	2	0	1	3	0	0
23	43800594	.	C	T	2	2	4	0	1	5	0	0
23	43800684	.	G	A	1	2	3	0	3	6	0	0
23	43800701	.	T	C	4	3	7	0	0	7	0	0
23	43800723	.	G	A	0	5	5	0	4	9	0	0
23	43800747	.	A	C	3	3	6	0	0	6	0	0
23	43800968	.	T	G	1	2	3	0	0	3	0	0
23	43800983	.	G	A	2	2	4	0	0	4	0	0
23	43801090	.	A	C	3	5	8	0	0	8	0	0
23	43801284	.	C	G	2	3	5	0	0	5	0	0
23	43830137	.	T	A	4	3	7	0	0	7	0	0
23	43876103	.	C	A	3	5	8	0	0	8	0	0
23	43876109	.	T	A	3	4	7	0	0	8	1	0
23	43876158	.	A	C	0	1	1	0	0	1	0	0
23	43876163	.	T	G	0	0	0	0	1	1	0	0
23	43889641	.	T	C	0	2	2	0	0	2	0	0
23	43898075	.	C	T	0	3	3	0	0	3	0	0
23	43898097	.	A	C	1	3	4	0	0	4	0	0
23	43928824	.	A	G	2	4	6	0	0	6	0	0
23	44521330	.	A	G	9	3	12	0	0	12	0	0
23	45287374	.	T	C	1	1	2	0	0	2	0	0
23	45295434	.	G	A	0	3	3	0	1	4	0	0
23	45423138	.	A	C	8	3	11	0	0	11	0	0
23	45423167	.	T	C	6	3	9	0	1	10	0	0
23	45423268	.	A	G	2	3	5	0	1	6	0	0
23	45423324	.	G	T	2	4	6	0	0	6	0	0
23	45423397	.	T	C	4	0	4	0	2	6	0	0
23	45424143	.	C	G	1	4	5	0	0	5	0	0
23	45425030	.	A	C	2	0	2	0	0	2	0	0
23	45425186	.	G	A	2	2	4	0	0	4	0	0
23	45425225	.	A	G	1	3	4	0	0	4	0	0
23	45515555	.	C	G	4	1	5	0	0	5	0	0
23	45515570	.	C	G	1	0	1	0	2	3	0	0
23	45516336	.	C	T	7	5	12	0	1	13	0	0
23	45521246	.	G	C	7	7	14	0	0	14	0	0
23	45521285	.	G	C	9	1	10	0	1	11	0	0
23	45521293	.	C	A	7	2	9	0	0	9	0	0
23	45521385	.	T	G	2	5	7	0	0	7	0	0
23	45521492	.	G	A	9	5	14	0	0	14	0	0
23	45521742	.	T	G	3	2	5	0	0	5	0	0
23	45521775	.	C	T	3	3	6	0	0	6	0	0
23	45521811	.	A	G	6	5	11	0	0	11	0	0
23	45521816	.	T	A	6	5	11	0	0	11	0	0
23	45521853	.	G	A	6	7	13	0	0	13	0	0
23	45521857	.	G	A	6	5	11	0	0	11	0	0
23	45521942	.	A	G	10	8	18	0	1	19	0	0
23	45522046	.	G	A	3	9	12	0	1	13	0	0
23	45522166	.	T	G	12	11	23	0	0	23	0	0
23	45522170	.	T	G	13	11	24	0	0	24	0	0
23	45522238	.	A	G	9	12	21	0	0	21	0	0
23	45522434	.	G	A	7	8	15	0	1	16	0	0
23	45523295	.	C	T	9	3	12	0	0	12	0	0
23	45523409	.	T	C	12	11	23	0	0	23	0	0
23	45523562	.	A	G	5	0	5	0	9	14	0	0
23	45523619	.	C	T	5	8	13	0	1	14	0	0
23	45523669	.	A	T	5	7	12	0	1	13	0	0
23	45547600	.	A	C	10	6	16	0	1	17	0	0
23	45547807	.	A	G	4	0	4	0	13	17	0	0
23	45547902	.	C	T	7	11	18	0	1	19	0	0
23	45548034	.	G	C	10	7	17	0	0	17	0	0
23	45548140	.	G	A	4	4	8	0	1	9	0	0
23	45548355	.	A	G	6	7	13	0	0	13	0	0
23	45548641	.	A	C	2	5	7	0	0	7	0	0
23	45548703	.	C	T	3	2	5	0	0	5	0	0
23	45548704	.	T	A	3	2	5	0	0	5	0	0
23	45579547	.	A	G	14	29	43	0	1	44	0	0
23	45579629	.	A	C	21	32	53	0	3	56	0	0
23	45580052	.	C	T	23	21	44	0	1	45	0	0
23	45580442	.	C	T	29	36	65	0	4	69	0	0
23	45580508	.	C	T	25	40	65	0	7	72	0	0
23	45580562	.	C	T	35	28	63	0	1	64	0	0
23	45581181	.	C	T	24	28	52	0	0	52	0	0
23	45586655	.	C	G	2	4	6	0	0	6	0	0
23	45586744	.	C	A	1	3	4	0	0	4	0	0
23	45586828	.	A	T	4	2	6	0	1	7	0	0
23	45586833	.	G	A	4	3	7	0	0	7	0	0
23	45586979	.	G	A	2	3	5	0	0	5	0	0
23	45587609	.	T	C	6	2	8	0	0	8	0	0
23	45587702	.	C	T	3	3	6	0	0	6	0	0
23	45587732	.	T	C	2	3	5	0	1	6	0	0
23	45587875	.	T	C	4	3	7	0	0	7	0	0
23	45587883	.	C	A	4	3	7	0	1	8	0	0
23	45588412	.	G	A	0	7	7	0	5	12	0	0
23	45591606	.	A	G	2	0	2	0	3	5	0	0
23	45591639	.	A	G	5	4	9	0	0	9	0	0
23	45595151	.	C	T	5	4	9	0	0	9	0	0
23	45595178	.	C	T	8	8	16	0	0	16	0	0
23	45596217	.	C	T	0	1	1	0	0	1	0	0
23	45596262	.	A	G	0	0	0	0	1	1	0	0
23	45600575	.	A	G	1	0	1	0	0	1	0	0
23	45600773	.	G	C	0	6	6	0	4	10	0	0
23	45622106	.	G	A	2	6	8	0	1	9	0	0
24	20671	.	T	C	1	3	4	0	0	4	0	0
24	20740	.	C	G	2	0	2	0	5	8	1	0
24	24470	.	T	C	1	7	8	0	0	8	0	0
24	24473	.	C	T	1	7	8	0	0	8	0	0
24	26103	.	C	T	0	3	3	0	0	3	0	0
24	44306	.	C	T	7	1	8	0	0	8	0	0
24	86768	.	T	C	1	3	4	0	0	4	0	0
24	91430	.	A	G	0	0	0	0	4	4	0	0
24	166969	.	T	G	2	8	10	0	0	10	0	0
24	167149	.	A	T	7	13	20	0	0	20	0	0
24	167177	.	A	G	3	6	9	0	0	9	0	0
24	174353	.	A	G	4	0	4	0	12	16	0	0
24	178693	.	G	A	10	9	19	0	0	19	0	0
24	184800	.	A	G	16	0	16	0	9	25	0	0
24	184818	.	C	T	12	6	18	0	2	20	0	0
24	187371	.	T	A	11	16	27	0	1	28	0	0
24	187414	.	T	A	7	9	16	0	0	16	0	0
24	187621	.	T	C	9	13	22	0	2	24	0	0
24	187643	.	A	G	14	10	24	0	2	26	0	0
24	187686	.	T	A	7	12	19	0	0	19	0	0
24	187811	.	A	T	7	4	11	0	1	12	0	0
24	187971	.	A	G	4	2	6	0	0	6	0	0
24	188155	.	C	G	7	6	13	0	0	13	0	0
24	188191	.	T	A	9	2	11	0	1	12	0	0
24	188363	.	G	A	16	11	27	0	0	27	0	0
24	188382	.	G	A	2	11	13	0	14	27	0	0
24	188423	.	T	C	11	14	25	0	2	27	0	0
24	188425	.	A	T	12	14	26	0	1	27	0	0
24	188464	.	T	C	11	21	32	0	1	33	0	0
24	196679	.	G	A	8	4	12	0	1	13	0	0
24	197062	.	C	T	1	0	1	0	0	1	0	0
24	788327	.	A	G	0	7	7	0	0	7	0	0
24	788384	.	A	G	2	5	7	0	0	7	0	0
24	788419	.	A	G	6	0	6	0	3	9	0	0
24	945478	.	C	T	2	2	4	0	0	4	0	0
24	945526	.	C	T	4	5	9	0	3	12	0	0
24	945537	.	G	A	3	5	8	0	5	13	0	0
24	945706	.	T	C	10	14	24	0	0	24	0	0
24	945841	.	T	G	5	3	8	0	0	8	0	0
24	947503	.	G	C	5	7	12	0	0	12	0	0
24	947518	.	C	T	1	8	9	0	5	14	0	0
24	947611	.	C	T	6	5	11	0	6	17	0	0
24	947680	.	T	C	6	3	9	0	9	18	0	0
24	947957	.	C	A	5	10	15	0	4	19	0	0
24	947984	.	G	C	10	9	19	0	0	19	0	0
24	948351	.	T	A	6	7	13	0	2	15	0	0
24	948438	.	T	C	4	7	11	0	5	16	0	0
24	948466	.	C	G	2	11	13	0	6	19	0	0
24	948503	.	C	T	5	9	14	0	8	22	0	0
24	948565	.	T	C	11	1	12	0	8	20	0	0
24	948609	.	G	T	4	7	11	0	5	16	0	0
24	948729	.	G	A	4	7	11	0	3	14	0	0
24	948806	.	G	A	3	8	11	0	0	11	0	0
24	948999	.	G	A	3	3	6	0	0	6	0	0
24	962659	.	G	C	1	2	3	0	0	3	0	0
24	985094	.	A	T	8	3	11	0	0	11	0	0
24	985284	.	G	C	8	3	11	0	1	12	0	0
24	985438	.	A	C	12	6	18	0	0	18	0	0
24	985748	.	G	A	11	3	14	0	0	14	0	0
24	988373	.	A	C	4	0	4	0	4	8	0	0
24	992228	.	T	G	2	0	2	0	1	3	0	0
24	1000040	.	A	G	0	2	2	0	0	2	0	0
24	1002664	.	T	C	6	7	13	0	0	13	0	0
24	1002757	.	T	C	1	0	1	0	0	1	0	0
24	1003596	.	G	A	12	7	19	0	1	20	0	0
24	1009078	.	A	G	5	5	10	0	0	10	0	0
24	1009381	.	C	A	0	4	4	0	3	7	0	0
24	1010190	.	T	C	4	1	5	0	4	9	0	0
24	1010205	.	A	T	5	5	10	0	1	11	0	0
24	1010347	.	G	T	1	3	4	0	0	4	0	0
24	1013142	.	G	A	3	2	5	0	0	5	0	0
24	1015292	.	T	C	14	0	14	0	13	27	0	0
24	1018672	.	T	C	8	0	8	0	15	23	0	0
24	1022962	.	G	A	4	1	5	0	0	5	0	0
24	1022986	.	C	A	0	6	6	0	6	12	0	0
24	1110595	.	G	C	11	3	14	0	0	14	0	0
24	1110601	.	G	A	12	4	16	0	0	16	0	0
24	1111024	.	C	G	3	3	6	0	0	6	0	0
24	1111055	.	C	A	5	4	9	0	0	9	0	0
24	1111102	.	G	T	4	4	8	0	1	9	0	0
24	1111146	.	T	C	5	3	8	0	0	8	0	0
24	1111164	.	T	C	6	2	8	0	0	8	0	0
24	1162622	.	T	A	9	13	22	0	1	23	0	0
24	1163184	.	A	G	15	18	33	0	0	33	0	0
24	1167263	.	G	A	4	0	4	0	0	4	0	0
24	1167338	.	C	T	0	11	11	0	11	22	0	0
24	1167413	.	A	G	19	11	30	0	4	34	0	0
24	1167506	.	G	A	3	4	7	0	1	8	0	0
24	1169336	.	T	C	0	0	0	0	1	1	0	0
24	1185225	.	G	T	9	14	23	0	0	23	0	0
24	1185374	.	G	C	6	9	15	0	1	16	0	0
24	1195775	.	C	T	4	0	4	0	0	4	0	0
24	1203573	.	A	G	3	0	3	0	0	3	0	0
24	1229571	.	A	G	1	0	1	0	0	1	0	0
24	1229646	.	G	C	5	0	5	0	12	17	0	0
24	1229683	.	G	C	3	4	7	0	0	7	0	0
24	1236358	.	A	G	8	18	26	0	0	27	1	0
24	1301258	.	C	T	2	2	4	0	0	4	0	0
24	1303660	.	G	T	7	5	12	0	0	12	0	0
24	1627499	.	A	C	0	0	0	0	2	2	0	0
24	2284197	.	G	C	8	19	27	0	0	27	0	0
24	2284279	.	C	T	0	16	16	0	17	33	0	0
24	2284458	.	G	A	10	13	23	0	1	24	0	0
24	2287254	.	C	G	0	1	1	0	1	2	0	0
24	2289991	.	C	T	0	2	2	0	1	3	0	0
24	2290232	.	T	C	5	0	5	0	5	10	0	0
24	2293360	.	G	A	4	1	5	0	0	5	0	0
24	2298000	.	A	G	2	4	6	0	0	6	0	0
24	2303778	.	G	A	3	2	5	0	1	6	0	0
24	2307342	.	C	T	2	4	6	0	1	7	0	0
24	2308075	.	A	G	2	2	4	0	0	4	0	0
24	2322219	.	C	T	1	3	4	0	0	4	0	0
24	2322228	.	C	T	1	3	4	0	0	4	0	0
24	2322261	.	G	A	1	2	3	0	1	4	0	0
24	2324350	.	G	C	1	1	2	0	0	2	0	0
24	2327295	.	T	C	1	2	3	0	0	3	0	0
24	2327866	.	C	G	2	3	5	0	0	5	0	0
24	2327935	.	T	C	1	1	2	0	0	2	0	0
24	2330491	.	T	C	1	2	3	0	0	3	0	0
24	2331198	.	G	A	1	2	3	0	0	3	0	0
24	2331330	.	A	G	1	0	1	0	4	5	0	0
24	2331387	.	G	A	0	3	3	0	2	5	0	0
24	2340379	.	C	T	1	3	4	0	0	4	0	0
24	2347002	.	A	G	3	2	5	0	0	5	0	0
24	2352176	.	C	T	0	2	2	0	2	4	0	0
24	2352314	.	G	A	1	2	3	0	0	3	0	0
24	2524848	.	C	A	25	24	49	0	1	50	0	0
24	2524868	.	C	T	22	23	45	0	2	47	0	0
24	2524903	.	A	T	22	16	38	0	3	41	0	0
24	2558323	.	G	A	1	2	3	0	0	3	0	0
24	2642517	.	G	A	1	2	3	0	0	3	0	0
24	2684081	.	T	G	1	2	3	0	0	3	0	0
24	2684208	.	A	G	2	2	4	0	0	4	0	0
24	2684314	.	C	T	1	2	3	0	1	4	0	0
24	2684417	.	C	T	0	3	3	0	1	4	0	0
24	2684455	.	A	G	1	4	5	0	0	5	0	0
24	2684481	.	G	A	3	3	6	0	0	6	0	0
24	2762780	.	C	A	7	2	9	0	0	9	0	0
24	2762782	.	G	A	0	3	3	0	6	9	0	0
24	2821435	.	G	A	7	7	14	0	0	14	0	0
24	2836405	.	T	C	5	3	8	0	0	8	0	0
24	2836451	.	C	A	2	4	6	0	1	7	0	0
24	2836452	.	A	G	2	5	7	0	0	7	0	0
24	2836673	.	A	T	1	5	6	0	0	6	0	0
24	2836708	.	T	G	3	4	7	0	0	7	0	0
24	2836709	.	G	T	3	4	7	0	0	7	0	0
24	2842910	.	A	G	6	3	9	0	1	10	0	0
24	2891081	.	T	C	1	0	1	0	7	8	0	0
24	2891101	.	T	C	1	5	6	0	0	6	0	0
24	2891146	.	G	A	5	5	10	0	0	10	0	0
24	2891187	.	T	G	3	3	6	0	0	6	0	0
24	2891188	.	A	T	3	3	6	0	0	6	0	0
24	2892507	.	G	A	1	3	4	0	0	4	0	0
24	2892587	.	C	A	4	2	6	0	0	6	0	0
24	2892688	.	G	T	11	8	19	0	1	20	0	0
24	2892951	.	T	C	2	7	9	0	2	11	0	0
24	2893003	.	A	T	5	2	7	0	0	7	0	0
24	2893056	.	T	G	5	4	9	0	1	10	0	0
24	2893175	.	C	G	4	3	7	0	0	7	0	0
24	2893342	.	T	C	3	5	8	0	1	9	0	0
24	2894044	.	C	T	4	4	8	0	0	8	0	0
24	2894076	.	G	A	3	5	8	0	0	8	0	0
24	2917174	.	A	T	0	0	0	0	1	1	0	0
24	2961142	.	C	G	7	11	18	0	0	18	0	0
24	2963066	.	C	G	5	3	8	0	2	10	0	0
24	2964809	.	C	T	9	9	18	0	1	19	0	0
24	2966557	.	C	T	3	8	11	0	0	11	0	0
24	2971595	.	T	C	21	18	39	0	1	40	0	0
24	2971684	.	A	G	8	11	19	0	0	19	0	0
24	2971747	.	G	T	9	11	20	0	1	21	0	0
24	2971890	.	A	G	5	6	11	0	3	14	0	0
24	3059710	.	C	T	5	4	9	0	0	9	0	0
24	3061408	.	A	G	4	0	4	0	4	8	0	0
24	3272773	.	G	A	1	0	1	0	0	1	0	0
24	3325645	.	C	G	4	3	7	0	0	7	0	0
24	3325933	.	T	C	3	3	6	0	0	6	0	0
24	3325941	.	C	G	1	3	4	0	2	6	0	0
24	3326053	.	G	T	1	1	2	0	0	2	0	0
24	3326069	.	T	A	1	1	2	0	0	2	0	0
24	3326212	.	A	G	1	2	3	0	0	3	0	0
24	3328397	.	C	G	8	8	16	0	1	17	0	0
24	3328473	.	A	T	5	8	13	0	0	13	0	0
24	3328532	.	T	C	3	6	9	0	2	11	0	0
24	3333940	.	G	A	0	1	1	0	0	1	0	0
24	3335963	.	G	A	0	5	5	0	13	18	0	0
24	3336199	.	C	T	6	18	24	0	0	24	0	0
24	3336236	.	G	A	0	8	8	0	14	22	0	0
24	3348012	.	G	T	7	3	10	0	1	11	0	0
24	3348503	.	C	T	0	12	12	0	14	26	0	0
24	3348530	.	C	T	10	11	21	0	1	22	0	0
24	3350081	.	T	C	7	0	7	0	12	19	0	0
24	3350408	.	T	G	3	8	11	0	1	12	0	0
24	3350426	.	T	C	4	7	11	0	1	12	0	0
24	3350639	.	A	G	12	7	19	0	2	21	0	0
24	3350732	.	A	G	0	1	1	0	0	1	0	0
24	3374783	.	G	A	8	8	16	0	1	17	0	0
24	3470108	.	T	C	14	5	19	0	0	19	0	0
24	3470177	.	T	C	11	2	13	0	0	13	0	0
24	3470188	.	T	C	9	3	12	0	0	12	0	0
24	3470405	.	T	C	4	4	8	0	1	9	0	0
24	3470594	.	T	C	5	2	7	0	1	8	0	0
24	3470608	.	T	C	5	4	9	0	0	9	0	0
24	3471342	.	T	C	8	3	11	0	0	11	0	0
24	3623721	.	G	A	2	2	4	0	0	4	0	0
24	3623984	.	C	T	1	5	6	0	0	6	0	0
24	3624089	.	G	A	2	4	6	0	0	6	0	0
24	3624320	.	C	T	1	2	3	0	1	4	0	0
24	3624332	.	C	T	0	3	3	0	2	5	0	0
24	3783180	.	G	A	1	2	3	0	0	3	0	0
24	3972295	.	C	T	17	14	31	0	1	32	0	0
24	3990337	.	G	A	0	2	2	0	2	4	0	0
24	4000242	.	C	T	4	2	6	0	1	7	0	0
24	4000308	.	T	C	12	11	23	0	1	24	0	0
24	4000323	.	C	T	7	8	15	0	1	16	0	0
24	4002905	.	C	G	31	18	49	0	2	51	0	0
24	4002966	.	A	G	16	29	45	0	2	47	0	0
24	4002997	.	C	T	19	27	46	0	2	48	0	0
24	4003172	.	C	T	12	24	36	0	1	37	0	0
24	4003533	.	C	T	27	28	55	0	5	60	0	0
24	4003559	.	G	A	18	34	52	0	1	53	0	0
24	4003598	.	C	T	7	34	41	0	9	50	0	0
24	4003693	.	A	C	34	22	56	0	2	58	0	0
24	4003782	.	C	A	27	19	46	0	0	46	0	0
24	4003800	.	T	C	25	21	46	0	0	46	0	0
24	4003842	.	G	A	23	12	35	0	1	36	0	0
24	4003947	.	G	A	2	21	23	0	18	41	0	0
24	4003978	.	G	A	13	20	33	0	2	35	0	0
24	4004041	.	C	A	4	13	17	0	0	17	0	0
24	4004046	.	G	C	2	12	14	0	2	16	0	0
24	4142777	.	C	T	0	6	6	0	7	13	0	0
24	4142856	.	C	T	5	6	11	0	0	11	0	0
24	4142898	.	T	C	7	9	16	0	2	18	0	0
24	4143517	.	T	A	7	6	13	0	0	13	0	0
24	4373109	.	C	T	4	2	6	0	0	6	0	0
24	4412717	.	C	T	3	3	6	0	1	7	0	0
24	4417793	.	G	A	5	6	11	0	1	12	0	0
24	4421183	.	C	T	3	1	4	0	0	4	0	0
24	4448608	.	T	C	6	6	12	0	0	12	0	0
24	4449787	.	G	A	5	5	10	0	0	10	0	0
24	4450139	.	A	C	1	2	3	0	0	3	0	0
24	4450161	.	C	T	6	3	9	0	0	9	0	0
24	4970956	.	T	C	18	27	45	0	2	47	0	0
24	4971126	.	G	T	29	25	54	0	3	57	0	0
24	4972735	.	G	A	23	29	52	0	4	56	0	0
24	4981740	.	G	A	14	12	26	0	1	27	0	0
24	5210628	.	G	A	10	4	14	0	0	14	0	0
24	5213008	.	G	T	5	1	6	0	0	6	0	0
24	5213029	.	C	T	6	4	10	0	0	10	0	0
24	5214786	.	A	C	3	4	7	0	0	7	0	0
24	5313685	.	T	A	0	2	2	0	0	2	0	0
24	5996942	.	A	T	5	3	8	0	0	8	0	0
24	5996996	.	G	A	5	5	10	0	2	12	0	0
24	6002538	.	C	G	19	0	19	0	7	26	0	0
24	6002628	.	T	C	1	1	2	0	0	2	0	0
24	6008674	.	G	A	2	3	5	0	0	5	0	0
24	6010598	.	G	A	0	4	4	0	6	10	0	0
24	6010690	.	G	A	2	6	8	0	0	8	0	0
24	6010700	.	A	T	3	7	10	0	0	10	0	0
24	6010770	.	C	T	7	7	14	0	0	14	0	0
24	6010801	.	G	A	5	11	16	0	1	17	0	0
24	6010830	.	A	T	4	7	11	0	0	11	0	0
24	6011063	.	G	T	2	4	6	0	0	6	0	0
24	6011154	.	A	T	5	3	8	0	1	9	0	0
24	6011271	.	T	G	2	3	5	0	0	5	0	0
24	6011769	.	T	C	2	4	6	0	0	6	0	0
24	6011774	.	T	C	1	4	5	0	0	5	0	0
24	6012374	.	T	C	4	18	22	0	0	22	0	0
24	6012381	.	T	C	3	16	19	0	2	21	0	0
24	6012499	.	T	A	13	9	22	0	0	22	0	0
24	6012535	.	T	A	12	7	19	0	0	19	0	0
24	6012540	.	A	T	10	7	17	0	0	18	1	0
24	6012662	.	G	A	3	8	11	0	0	11	0	0
24	6016749	.	A	C	0	3	3	0	0	3	0	0
24	6018727	.	C	T	1	0	1	0	0	1	0	0
24	6018908	.	C	T	2	2	4	0	0	4	0	0
24	6021001	.	G	A	4	5	9	0	1	10	0	0
24	6021022	.	G	C	3	0	3	0	5	8	0	0
24	6021277	.	T	C	1	0	1	0	2	3	0	0
24	6024355	.	C	T	4	6	10	0	2	12	0	0
24	6024366	.	T	C	4	11	15	0	1	16	0	0
24	6024401	.	A	T	4	7	11	0	0	11	0	0
24	6024411	.	C	A	0	6	6	0	4	10	0	0
24	6117676	.	A	G	1	0	1	0	3	4	0	0
24	6118018	.	T	G	0	2	2	0	0	2	0	0
24	6134324	.	T	G	23	29	52	0	4	56	0	0
24	6134456	.	C	T	4	39	43	0	25	68	0	0
24	6134881	.	C	T	16	14	30	0	3	33	0	0
24	6134888	.	C	G	1	17	18	0	19	37	0	0
24	6134946	.	A	T	25	7	32	0	1	33	0	0
24	6135002	.	A	G	16	31	47	0	1	48	0	0
24	6135100	.	A	T	21	29	50	0	0	50	0	0
24	6135118	.	A	G	21	30	51	0	1	52	0	0
24	6135375	.	A	C	23	24	47	0	2	49	0	0
24	6135701	.	G	A	20	26	46	0	1	47	0	0
24	6136089	.	T	G	5	6	11	0	1	12	0	0
24	6136243	.	T	G	6	3	9	0	1	10	0	0
24	6136414	.	A	T	2	5	7	0	0	7	0	0
24	6136415	.	A	T	2	5	7	0	0	7	0	0
24	6136714	.	T	A	24	16	40	0	0	40	0	0
24	6137061	.	C	T	0	16	16	0	8	24	0	0
24	6137622	.	C	T	0	12	12	0	22	34	0	0
24	6153202	.	C	T	0	4	4	0	7	11	0	0
24	6153515	.	A	G	4	4	8	0	0	8	0	0
24	6155751	.	T	C	11	1	12	0	6	18	0	0
24	6157154	.	G	A	23	21	44	0	2	47	1	0
24	6157832	.	A	G	11	5	16	0	1	17	0	0
24	6158835	.	C	A	19	16	35	0	0	35	0	0
24	6158868	.	C	T	16	13	29	0	1	30	0	0
24	6177161	.	T	C	2	0	2	0	1	3	0	0
24	6177169	.	T	C	1	1	2	0	0	2	0	0
24	6339629	.	G	A	3	2	5	0	0	5	0	0
24	6339714	.	G	T	1	3	4	0	0	4	0	0
24	6344909	.	G	A	5	9	14	0	0	14	0	0
24	6361637	.	T	A	2	4	6	0	0	6	0	0
24	6361639	.	G	A	1	4	5	0	1	6	0	0
24	6361917	.	T	A	2	2	4	0	0	4	0	0
24	6362116	.	T	C	15	5	20	0	2	22	0	0
24	6362123	.	A	C	6	16	22	0	0	22	0	0
24	6362609	.	A	T	17	18	35	0	4	39	0	0
24	6362688	.	T	C	9	17	26	0	3	29	0	0
24	6362730	.	T	C	7	14	21	0	1	22	0	0
24	6362791	.	C	A	7	7	14	0	0	14	0	0
24	6362801	.	G	A	8	6	14	0	0	14	0	0
24	6363502	.	G	A	16	7	23	0	1	24	0	0
24	6373660	.	A	G	1	1	2	0	1	3	0	0
24	6395401	.	G	A	3	5	8	0	0	8	0	0
24	6395494	.	G	A	1	7	8	0	0	8	0	0
24	6395655	.	G	A	10	8	18	0	2	20	0	0
24	6395734	.	T	C	2	4	6	0	0	6	0	0
24	6395838	.	G	T	3	3	6	0	0	6	0	0
24	6395877	.	G	A	3	2	5	0	0	5	0	0
24	6396137	.	C	G	12	6	18	0	0	18	0	0
24	6396198	.	T	A	5	9	14	0	2	16	0	0
24	6396558	.	T	C	6	2	8	0	0	8	0	0
24	6396720	.	A	G	4	7	11	0	0	11	0	0
24	6402552	.	T	C	1	2	3	0	0	3	0	0
24	6444204	.	C	T	0	3	3	0	3	6	0	0
24	6500812	.	C	T	2	3	5	0	0	5	0	0
24	6500973	.	G	A	6	3	9	0	0	9	0	0
24	6501024	.	T	C	2	3	5	0	0	5	0	0
24	6501044	.	C	T	1	2	3	0	0	3	0	0
24	6513857	.	A	T	5	11	16	0	0	16	0	0
24	6513996	.	G	A	6	7	13	0	1	14	0	0
24	6514012	.	C	T	4	6	10	0	1	11	0	0
24	6514117	.	T	C	7	5	12	0	1	13	0	0
24	6514263	.	T	G	8	5	13	0	0	13	0	0
24	6514882	.	A	T	7	6	13	0	0	13	0	0
24	6515019	.	C	T	0	11	11	0	13	24	0	0
24	6515245	.	G	A	6	10	16	0	0	16	0	0
24	6515327	.	G	A	7	6	13	0	3	16	0	0
24	6515364	.	A	T	8	15	23	0	1	24	0	0
24	6515499	.	A	G	10	9	19	0	0	19	0	0
24	6515519	.	T	C	8	1	9	0	12	21	0	0
24	6538504	.	C	T	0	7	7	0	6	14	1	0
24	6543068	.	A	G	0	2	2	0	0	2	0	0
24	6543443	.	G	A	6	9	15	0	0	15	0	0
24	6546364	.	A	C	6	12	18	0	1	19	0	0
24	6546594	.	A	T	5	5	10	0	1	11	0	0
24	6546749	.	C	T	0	7	7	0	6	13	0	0
24	6546841	.	G	A	9	5	14	0	0	14	0	0
24	6546863	.	T	C	9	1	10	0	8	18	0	0
24	6546909	.	T	C	6	1	7	0	6	14	1	0
24	6546999	.	T	C	1	3	4	0	0	4	0	0
24	6547020	.	T	C	2	4	6	0	0	6	0	0
24	6547278	.	A	G	1	6	7	0	0	7	0	0
24	6547727	.	G	A	9	8	17	0	0	17	0	0
24	6547812	.	C	T	8	8	16	0	0	16	0	0
24	6547890	.	C	G	9	5	14	0	0	14	0	0
24	6547956	.	A	G	7	3	10	0	2	12	0	0
24	6547958	.	A	T	8	4	12	0	0	12	0	0
24	6548027	.	C	T	0	7	7	0	4	11	0	0
24	6548064	.	T	C	4	1	5	0	7	12	0	0
24	7826475	.	C	G	0	4	4	0	0	4	0	0
24	8143351	.	G	A	1	4	5	0	0	5	0	0
24	8862829	.	T	C	1	2	3	0	0	3	0	0
24	8862861	.	T	C	3	0	3	0	3	6	0	0
24	8862978	.	T	C	4	2	6	0	0	6	0	0
24	10303168	.	C	T	6	8	14	0	0	14	0	0
24	10303178	.	G	T	0	9	9	0	8	17	0	0
24	10303221	.	A	G	3	0	3	0	5	8	0	0
24	10303240	.	T	A	5	6	11	0	1	12	0	0
24	10309243	.	A	G	5	5	10	0	0	10	0	0
24	10309289	.	C	T	4	2	6	0	0	6	0	0
24	10309382	.	T	C	2	2	4	0	0	4	0	0
24	10309532	.	T	A	4	3	7	0	0	7	0	0
24	10323534	.	G	A	0	5	5	0	1	6	0	0
24	10335692	.	G	A	0	1	1	0	0	1	0	0
24	10349671	.	C	T	0	2	2	0	0	2	0	0
24	10349783	.	G	T	1	4	5	0	0	5	0	0
24	10349818	.	G	A	2	6	8	0	0	8	0	0
24	10349865	.	T	G	2	5	7	0	2	9	0	0
24	10350089	.	T	A	2	5	7	0	0	7	0	0
24	10350135	.	A	T	1	7	8	0	0	8	0	0
24	10350239	.	T	A	8	3	11	0	1	12	0	0
24	10356563	.	G	A	3	2	5	0	0	5	0	0
24	10356592	.	T	C	2	4	6	0	0	6	0	0
24	10356617	.	G	A	2	3	5	0	0	5	0	0
24	10369024	.	G	A	4	2	6	0	0	6	0	0
24	10376984	.	G	A	2	0	2	0	0	2	0	0
24	10376990	.	T	C	1	0	1	0	0	1	0	0
24	10394027	.	A	G	5	2	7	0	0	7	0	0
24	10394224	.	G	A	3	6	9	0	0	9	0	0
24	10405797	.	A	G	2	0	2	0	3	5	0	0
24	10413560	.	C	T	5	3	8	0	1	9	0	0
24	10414039	.	T	C	2	1	3	0	0	3	0	0
24	10414385	.	T	C	0	7	7	0	1	8	0	0
24	10414439	.	G	T	0	5	5	0	2	7	0	0
24	10415193	.	A	G	11	14	25	0	1	26	0	0
24	10415370	.	G	C	11	10	21	0	0	22	1	0
24	10415790	.	C	T	1	2	3	0	1	4	0	0
24	10464195	.	A	G	0	3	3	0	0	3	0	0
24	10464354	.	T	G	1	2	3	0	1	4	0	0
24	10793390	.	T	G	4	2	6	0	0	6	0	0
24	10797306	.	T	C	4	0	4	0	0	4	0	0
24	10810390	.	C	T	0	5	5	0	1	6	0	0
24	10824235	.	C	T	6	9	15	0	1	16	0	0
24	10828512	.	A	G	2	1	3	0	0	3	0	0
24	10897254	.	G	A	2	1	3	0	0	3	0	0
24	10897340	.	C	A	2	3	5	0	0	5	0	0
24	10897344	.	C	A	2	2	4	0	0	4	0	0
24	10901467	.	A	C	5	4	9	0	0	9	0	0
24	10901696	.	C	G	23	23	46	1	0	47	0	0
24	10901759	.	G	T	14	22	36	0	1	37	0	0
24	10901946	.	C	T	10	7	17	0	0	17	0	0
24	10902065	.	T	G	4	12	16	0	1	17	0	0
24	10902268	.	G	A	7	9	16	0	0	16	0	0
24	10902568	.	T	C	17	1	18	0	24	42	0	0
24	10902688	.	G	A	11	19	30	0	1	31	0	0
24	10907000	.	T	C	3	4	7	0	0	7	0	0
24	10907473	.	C	T	15	11	26	0	4	30	0	0
24	10907587	.	G	T	3	5	8	0	0	8	0	0
24	10917040	.	C	T	2	3	5	0	0	5	0	0
24	10917046	.	C	T	0	3	3	0	2	5	0	0
24	10917238	.	C	T	1	1	2	0	0	2	0	0
24	10919519	.	A	G	7	5	12	0	1	13	0	0
24	10919563	.	G	T	6	2	8	0	0	8	0	0
24	10924880	.	C	T	5	13	18	0	1	19	0	0
24	10924912	.	C	T	4	10	14	0	2	16	0	0
24	10924930	.	T	A	5	8	13	0	0	13	0	0
24	10925951	.	G	A	2	1	3	0	0	3	0	0
24	10928291	.	G	A	1	0	1	0	0	1	0	0
24	10944579	.	T	A	5	1	6	0	0	6	0	0
24	10961510	.	T	C	3	0	3	0	0	3	0	0
24	10971127	.	C	T	0	1	1	0	0	1	0	0
24	10971160	.	G	A	1	1	2	0	0	2	0	0
24	11049819	.	C	G	12	8	20	0	0	20	0	0
24	11049825	.	C	T	12	9	21	0	0	21	0	0
24	11060403	.	C	A	0	2	2	0	2	4	0	0
24	11084035	.	G	A	1	3	4	0	0	4	0	0
24	11084074	.	A	C	1	3	4	0	0	4	0	0
24	11084085	.	T	G	1	2	3	0	0	3	0	0
24	11086465	.	T	A	4	2	6	0	0	6	0	0
24	11086679	.	T	A	2	4	6	0	0	6	0	0
24	11086752	.	A	G	1	0	1	0	0	1	0	0
24	11086887	.	C	A	4	3	7	0	0	7	0	0
24	11087015	.	G	A	2	5	7	0	0	7	0	0
24	11112173	.	C	A	8	8	16	0	0	17	1	0
24	11112174	.	C	G	9	8	17	0	0	17	0	0
24	11112290	.	G	A	6	7	13	0	0	13	0	0
24	11112474	.	A	G	6	3	9	0	0	9	0	0
24	11112710	.	A	C	8	0	8	0	14	22	0	0
24	11112839	.	G	A	7	9	16	0	0	16	0	0
24	11113027	.	T	C	8	8	16	0	0	16	0	0
24	11113243	.	G	A	3	6	9	1	0	10	0	0
24	11113330	.	C	T	0	7	7	0	1	8	0	0
24	11113383	.	C	A	7	8	15	0	0	15	0	0
24	11113392	.	G	T	7	6	13	0	2	15	0	0
24	11113507	.	T	C	1	5	6	0	0	6	0	0
24	11113668	.	C	A	1	2	3	0	0	3	0	0
24	11113900	.	A	T	7	11	18	0	2	20	0	0
24	11113912	.	A	T	6	13	19	0	0	19	0	0
24	11113966	.	T	C	5	9	14	0	2	16	0	0
24	11113972	.	C	G	6	10	16	0	1	17	0	0
24	11114184	.	G	T	7	8	15	0	0	15	0	0
24	11114346	.	A	T	2	3	5	0	0	5	0	0
24	11114385	.	T	C	2	2	4	0	0	4	0	0
24	11114549	.	G	A	4	9	13	0	0	13	0	0
24	11114560	.	T	C	5	0	5	0	11	16	0	0
24	11114584	.	T	C	4	13	17	0	1	18	0	0
24	11114670	.	C	T	0	3	3	0	3	6	0	0
24	11114688	.	T	G	6	2	8	0	0	8	0	0
24	11114709	.	T	A	6	5	11	0	0	11	0	0
24	11114996	.	G	T	4	5	9	0	0	9	0	0
24	11115048	.	T	A	5	5	10	0	0	10	0	0
24	11115078	.	A	G	3	3	6	0	0	6	0	0
24	11115269	.	C	A	5	8	13	0	0	13	0	0
24	11115338	.	A	T	2	4	6	0	1	7	0	0
24	11115339	.	C	T	0	4	4	0	3	7	0	0
24	11115373	.	C	T	1	5	6	0	1	7	0	0
24	11115451	.	C	A	3	5	8	0	0	8	0	0
24	11115894	.	A	G	6	4	10	0	0	10	0	0
24	11115920	.	T	C	8	4	12	0	0	12	0	0
24	11116025	.	G	C	4	0	4	0	7	11	0	0
24	11116032	.	C	T	4	5	9	0	0	9	0	0
24	11141027	.	G	A	1	6	7	0	0	7	0	0
24	11141065	.	C	T	4	11	15	0	0	15	0	0
24	11141253	.	A	C	5	5	10	0	0	10	0	0
24	11145148	.	C	T	1	6	7	0	0	7	0	0
24	11145190	.	C	T	5	6	11	0	0	11	0	0
24	11145193	.	G	A	5	6	11	0	0	11	0	0
24	11145232	.	G	A	9	3	12	0	0	12	0	0
24	11145250	.	G	A	3	8	11	0	1	12	0	0
24	11145445	.	G	A	8	6	14	0	0	14	0	0
24	11145499	.	T	G	6	5	11	0	0	11	0	0
24	11145592	.	C	T	0	2	2	0	5	7	0	0
24	11345943	.	C	T	2	2	4	0	0	4	0	0
24	11390139	.	A	T	0	2	2	0	1	3	0	0
24	11390254	.	C	T	1	2	3	0	0	3	0	0
24	11473788	.	T	A	2	4	6	0	0	6	0	0
24	11473845	.	T	G	4	2	6	0	0	6	0	0
24	11473968	.	T	C	5	0	5	0	8	13	0	0
24	11474103	.	C	G	6	15	21	0	0	21	0	0
24	11474110	.	G	A	5	12	17	0	0	17	0	0
24	11474257	.	G	A	7	4	11	0	0	11	0	0
24	11474730	.	A	G	6	6	12	0	0	12	0	0
24	11490060	.	C	T	5	8	13	0	0	13	0	0
24	11490238	.	A	T	0	3	3	0	0	3	0	0
24	11490280	.	A	T	1	4	5	0	3	8	0	0
24	11496640	.	T	A	4	2	6	0	0	6	0	0
24	11496890	.	G	A	1	8	9	0	0	9	0	0
24	11496922	.	G	A	5	7	12	0	1	13	0	0
24	11496937	.	A	G	5	7	12	0	0	12	0	0
24	11497201	.	T	A	5	11	16	0	0	16	0	0
24	11497243	.	A	G	4	9	13	0	0	13	0	0
24	11497351	.	C	T	4	5	9	0	0	9	0	0
24	11528804	.	A	G	2	3	5	0	0	5	0	0
24	11529876	.	A	T	0	0	0	0	2	2	0	0
24	11530003	.	T	C	6	4	10	0	1	11	0	0
24	11530044	.	T	C	4	0	4	0	6	10	0	0
24	11531088	.	T	A	0	2	2	0	1	3	0	0
24	11531180	.	T	C	3	3	6	0	0	6	0	0
24	11531184	.	G	A	3	3	6	0	0	6	0	0
24	11531261	.	G	A	1	2	3	0	0	3	0	0
24	11531270	.	G	T	1	2	3	0	0	3	0	0
24	11690594	.	G	A	3	2	5	0	0	5	0	0
24	11888694	.	G	A	5	7	12	0	2	14	0	0
24	11888788	.	G	A	15	8	23	0	2	25	0	0
24	11889107	.	T	C	4	3	7	0	0	7	0	0
24	11889617	.	T	C	3	2	5	0	1	6	0	0
24	11893314	.	G	A	8	9	17	0	0	17	0	0
24	11894968	.	C	T	0	8	8	0	2	10	0	0
24	11895910	.	C	A	1	1	2	0	0	2	0	0
24	11900151	.	A	G	4	3	7	0	1	8	0	0
24	11900166	.	G	A	2	6	8	0	0	8	0	0
24	11900230	.	A	C	2	6	8	0	1	9	0	0
24	11900292	.	C	T	2	3	5	0	0	5	0	0
24	11905817	.	A	G	2	2	4	0	0	4	0	0
24	11905834	.	G	A	1	3	4	0	0	4	0	0
24	11905881	.	A	G	1	3	4	0	0	4	0	0
24	11908852	.	T	C	1	4	5	0	1	6	0	0
24	11909441	.	T	G	0	3	3	0	0	3	0	0
24	11918846	.	G	A	3	3	6	0	0	6	0	0
24	12743648	.	T	A	4	3	7	0	0	7	0	0
24	12744274	.	A	G	1	3	4	0	0	4	0	0
24	12744894	.	G	T	5	3	8	0	0	8	0	0
24	12747941	.	A	G	3	2	5	0	0	5	0	0
24	12748448	.	T	A	2	6	8	0	0	8	0	0
24	12748468	.	A	G	2	7	9	0	0	9	0	0
24	12768339	.	G	A	1	2	3	0	0	3	0	0
24	12963161	.	T	A	6	6	12	0	0	12	0	0
24	12967163	.	G	A	3	5	8	0	0	8	0	0
24	12975210	.	A	G	8	11	19	0	2	21	0	0
24	12977735	.	A	T	6	4	10	0	1	11	0	0
24	12977738	.	G	A	6	5	11	0	0	11	0	0
24	12978892	.	A	G	4	4	8	0	1	9	0	0
24	12981349	.	A	T	4	5	9	0	0	9	0	0
24	12981384	.	C	T	0	5	5	0	6	11	0	0
24	12988694	.	A	T	1	2	3	0	0	3	0	0
24	12988745	.	T	G	1	2	3	0	0	3	0	0
24	13009351	.	T	A	1	1	2	0	0	2	0	0
24	13013596	.	T	C	1	5	6	0	0	6	0	0
24	13101128	.	A	G	23	18	41	0	2	43	0	0
24	13101185	.	A	G	28	1	29	0	35	64	0	0
24	13138165	.	T	C	3	4	7	0	0	7	0	0
24	13229408	.	G	A	7	6	13	0	1	14	0	0
24	13239040	.	C	T	8	16	24	0	21	45	0	0
24	13239123	.	T	A	19	14	33	0	4	43	6	0
24	13239248	.	A	G	9	20	29	0	9	38	0	0
24	13239712	.	G	T	5	35	40	0	26	66	0	0
24	13239934	.	G	T	26	23	49	0	0	49	0	0
24	13251963	.	T	C	11	6	17	0	0	17	0	0
24	13252065	.	G	A	9	7	16	0	1	17	0	0
24	13252122	.	A	C	2	0	2	0	6	8	0	0
24	13262409	.	G	C	1	0	1	0	2	3	0	0
24	13271566	.	T	C	2	5	7	0	0	7	0	0
24	13271628	.	A	G	3	4	7	0	0	7	0	0
24	13271637	.	C	T	0	5	5	0	1	6	0	0
24	13321083	.	T	C	1	0	1	0	0	1	0	0
24	13337070	.	C	G	1	0	1	0	3	4	0	0
24	13337071	.	T	C	1	3	4	0	0	4	0	0
24	13361973	.	C	T	2	4	6	0	0	6	0	0
24	13361974	.	C	T	2	4	6	0	0	6	0	0
24	13966516	.	G	A	1	2	3	0	0	3	0	0
24	14214930	.	A	C	5	3	8	0	0	8	0	0
24	14233716	.	C	A	1	3	4	0	2	6	0	0
24	14233833	.	G	A	0	1	1	0	3	4	0	0
24	14233840	.	T	G	2	2	4	0	1	5	0	0
24	14234518	.	T	A	7	6	13	0	0	13	0	0
24	14234567	.	A	T	4	4	8	0	0	8	0	0
24	14234594	.	A	C	1	4	5	0	0	5	0	0
24	14338708	.	T	G	2	0	2	0	2	4	0	0
24	14355885	.	T	C	2	3	5	0	1	6	0	0
24	14384979	.	C	T	5	5	10	0	0	10	0	0
24	14385751	.	G	A	0	9	9	0	8	17	0	0
24	14385765	.	G	T	10	5	15	0	2	17	0	0
24	14385882	.	T	G	6	0	6	0	6	12	0	0
24	14414325	.	G	A	0	4	4	0	2	6	0	0
24	14415844	.	C	T	2	4	6	0	0	6	0	0
24	14420990	.	T	G	2	0	2	0	3	5	0	0
24	14432194	.	T	C	0	1	1	0	0	1	0	0
24	14443578	.	A	G	4	6	10	0	0	10	0	0
24	14443592	.	C	G	6	3	9	0	0	9	0	0
24	14443953	.	A	G	8	0	8	0	6	14	0	0
24	14550242	.	T	G	2	5	7	0	0	7	0	0
24	14550305	.	T	A	3	0	3	0	1	4	0	0
24	14550479	.	G	A	6	10	16	0	0	16	0	0
24	14550487	.	A	T	8	12	20	0	0	20	0	0
24	14550554	.	G	A	7	16	23	0	2	25	0	0
24	14550596	.	T	C	2	5	7	0	1	8	0	0
24	14559778	.	A	T	36	28	64	0	0	64	0	0
24	14559828	.	T	A	33	39	72	0	2	74	0	0
24	14560155	.	G	A	29	24	53	0	0	53	0	0
24	14577512	.	G	C	5	3	8	0	0	8	0	0
24	14597264	.	G	A	4	3	7	0	1	8	0	0
24	14597311	.	C	T	2	8	10	0	0	10	0	0
24	14597313	.	G	A	2	7	9	0	1	10	0	0
24	14600137	.	G	A	1	6	7	0	0	7	0	0
24	14600191	.	C	T	0	3	3	0	0	3	0	0
24	14636271	.	A	G	2	4	6	0	0	6	0	0
24	14636649	.	G	A	2	3	5	0	0	5	0	0
24	14706484	.	G	A	1	2	3	0	0	3	0	0
24	14711696	.	A	G	5	3	8	0	0	8	0	0
24	14713789	.	G	A	0	1	1	0	2	3	0	0
24	14713796	.	T	C	2	3	5	0	0	5	0	0
24	14713865	.	A	G	15	16	31	0	0	31	0	0
24	14718163	.	T	C	19	8	27	0	0	27	0	0
24	14718476	.	A	G	4	0	4	0	1	5	0	0
24	14725323	.	T	C	14	28	42	0	4	46	0	0
24	14725400	.	G	A	0	27	27	0	13	40	0	0
24	14725410	.	C	T	14	28	42	0	1	43	0	0
24	14725480	.	G	A	8	14	22	0	1	23	0	0
24	14725505	.	G	A	0	16	16	0	9	25	0	0
24	14725551	.	G	A	4	14	18	0	0	18	0	0
24	14725634	.	C	T	2	6	8	0	0	8	0	0
24	14725642	.	T	C	1	5	6	0	0	6	0	0
24	15124785	.	A	T	7	10	17	0	1	18	0	0
24	15124818	.	C	T	9	12	21	0	1	22	0	0
24	15124847	.	C	T	0	14	14	0	11	25	0	0
24	15124880	.	T	C	8	0	8	0	10	18	0	0
24	15124937	.	T	G	1	0	1	0	0	1	0	0
24	15127376	.	G	T	2	1	3	0	1	4	0	0
24	15127581	.	G	T	7	6	13	0	1	14	0	0
24	15277338	.	G	C	6	3	9	0	0	9	0	0
24	15277347	.	T	C	6	3	9	0	0	9	0	0
24	15277512	.	C	T	3	5	8	0	0	8	0	0
24	15278697	.	G	A	1	2	3	0	0	3	0	0
24	15645280	.	A	C	3	6	9	0	0	9	0	0
24	15645617	.	G	T	6	6	12	0	5	17	0	0
24	15645669	.	G	T	8	1	9	0	2	11	0	0
24	15648504	.	T	C	7	5	12	0	0	12	0	0
24	15898196	.	T	G	2	5	7	0	0	7	0	0
24	16111914	.	T	C	1	2	3	0	1	4	0	0
24	16121362	.	G	A	0	8	8	0	8	16	0	0
24	16121462	.	G	A	5	6	11	0	1	12	0	0
24	16149704	.	G	C	1	4	5	0	0	5	0	0
24	16162422	.	A	T	9	4	13	0	0	13	0	0
24	16393606	.	C	T	4	3	7	0	0	7	0	0
24	16572141	.	C	T	7	3	10	0	0	10	0	0
24	16596414	.	A	G	9	0	9	0	9	18	0	0
24	16612792	.	G	T	9	4	13	0	0	13	0	0
24	16612819	.	G	A	0	6	6	0	11	17	0	0
24	16615706	.	A	G	1	1	2	0	1	3	0	0
24	16630964	.	T	C	4	6	10	0	0	10	0	0
24	16646712	.	C	G	13	16	29	0	0	29	0	0
24	16646781	.	C	G	4	0	4	0	5	9	0	0
24	16685001	.	G	A	1	3	4	0	0	4	0	0
24	16693526	.	T	C	8	9	17	0	0	17	0	0
24	16696713	.	G	C	15	13	28	0	1	29	0	0
24	16696741	.	T	C	9	5	14	0	0	14	0	0
24	16705878	.	C	T	14	16	30	0	0	30	0	0
24	16705890	.	A	C	17	15	32	0	0	32	0	0
24	16706108	.	A	G	20	15	35	0	2	37	0	0
24	16706349	.	T	C	20	16	36	0	0	36	0	0
24	16706709	.	A	C	2	2	4	0	0	4	0	0
24	16854827	.	C	T	4	2	6	0	0	6	0	0
24	16854830	.	T	C	4	2	6	0	0	6	0	0
24	16855488	.	A	T	2	2	4	0	0	4	0	0
24	16855489	.	G	A	2	2	4	0	0	4	0	0
24	16889456	.	G	A	2	3	5	0	0	5	0	0
24	16900009	.	G	A	2	2	4	0	0	4	0	0
24	16900023	.	G	A	0	2	2	0	0	2	0	0
24	16900046	.	A	G	0	5	5	0	0	5	0	0
24	16900101	.	A	G	3	4	7	0	0	7	0	0
24	16905265	.	A	C	14	8	22	0	0	22	0	0
24	16905292	.	C	T	18	13	31	0	0	31	0	0
24	16908771	.	A	C	1	8	9	0	1	10	0	0
24	16908848	.	C	T	17	17	34	0	0	34	0	0
24	16909052	.	T	C	9	4	13	0	0	13	0	0
24	16911600	.	A	C	7	10	17	0	2	19	0	0
24	16911898	.	C	T	6	13	19	0	1	20	0	0
24	16911940	.	G	C	14	21	35	0	2	37	0	0
24	16911949	.	T	A	14	19	33	0	1	34	0	0
24	16912086	.	G	A	0	4	4	0	1	5	0	0
24	16912188	.	G	A	3	17	20	0	30	50	0	0
24	16912710	.	G	A	22	17	39	0	1	40	0	0
24	16913077	.	G	A	1	3	4	0	0	4	0	0
24	16914728	.	A	C	1	0	1	0	2	3	0	0
24	16964500	.	C	T	7	3	10	0	1	11	0	0
24	16964750	.	T	C	4	3	7	0	0	7	0	0
24	16965503	.	G	A	6	4	10	0	0	10	0	0
24	16965648	.	C	G	8	5	13	0	0	13	0	0
24	16965729	.	A	C	4	8	12	0	0	12	0	0
24	16965765	.	T	C	6	5	11	0	1	12	0	0
24	16965770	.	T	C	6	5	11	0	0	11	0	0
24	16965900	.	A	C	4	0	4	0	7	11	0	0
24	16966389	.	A	G	2	3	5	0	0	5	0	0
24	16966617	.	G	A	7	3	10	0	0	10	0	0
24	16966662	.	G	A	6	3	9	0	0	9	0	0
24	16969220	.	T	C	3	4	7	0	0	7	0	0
24	16979675	.	G	T	3	2	5	0	0	6	1	0
24	16979678	.	A	T	4	2	6	0	0	6	0	0
24	16985547	.	C	T	3	1	4	0	0	4	0	0
24	16992440	.	A	G	13	21	34	0	2	36	0	0
24	16992506	.	A	C	2	2	4	0	1	5	0	0
24	16992605	.	G	A	0	4	4	0	5	9	0	0
24	16992915	.	C	T	14	14	28	0	2	30	0	0
24	16998976	.	A	T	20	9	29	0	0	29	0	0
24	16999057	.	T	G	17	24	41	0	0	41	0	0
24	17002611	.	C	T	6	8	14	0	0	14	0	0
24	17002666	.	A	T	24	22	46	0	3	49	0	0
24	17005683	.	T	G	2	0	2	0	1	3	0	0
24	17010923	.	G	T	3	3	6	0	0	6	0	0
24	17010932	.	G	T	4	3	7	0	0	7	0	0
24	17010995	.	C	A	2	4	6	0	0	6	0	0
24	17011082	.	C	A	4	2	6	0	0	6	0	0
24	17020761	.	T	A	2	3	5	0	0	5	0	0
24	17020764	.	A	T	2	3	5	0	0	5	0	0
24	17021848	.	G	A	30	31	61	0	1	62	0	0
24	17021894	.	T	C	30	3	33	0	25	58	0	0
24	17021942	.	A	C	29	14	43	0	3	46	0	0
24	17022164	.	G	A	3	3	6	0	1	7	0	0
24	17023063	.	G	A	25	14	39	0	1	41	1	0
24	17023427	.	A	G	4	5	9	0	0	9	0	0
24	17023439	.	C	A	5	5	10	0	0	10	0	0
24	17027464	.	G	A	21	14	35	0	1	36	0	0
24	17027484	.	C	A	25	21	46	0	1	47	0	0
24	17028690	.	T	A	11	15	26	0	1	27	0	0
24	17028990	.	C	T	1	1	2	0	0	2	0	0
24	17041159	.	G	C	5	12	17	0	0	17	0	0
24	17041208	.	T	G	5	9	14	0	0	14	0	0
24	17041267	.	T	A	11	11	22	0	1	23	0	0
24	17041354	.	A	G	4	13	17	0	1	18	0	0
24	17042014	.	A	G	2	7	9	0	0	9	0	0
24	17042022	.	A	G	2	7	9	0	0	9	0	0
24	17042698	.	A	T	10	6	16	0	0	16	0	0
24	17042763	.	C	T	18	8	26	0	0	27	1	0
24	17049723	.	C	T	2	1	3	0	0	3	0	0
24	17049730	.	G	T	0	1	1	0	0	1	0	0
24	17119170	.	C	T	1	0	1	0	0	1	0	0
24	17124306	.	T	A	1	6	7	0	0	7	0	0
24	17124476	.	G	A	0	10	10	0	9	19	0	0
24	17124567	.	T	C	9	18	27	0	2	29	0	0
24	17124591	.	T	A	14	12	26	0	0	26	0	0
24	17125503	.	G	A	16	6	22	0	1	23	0	0
24	17126341	.	C	T	16	15	31	0	1	32	0	0
24	17126391	.	T	C	5	10	15	0	2	17	0	0
24	17126738	.	T	A	23	19	42	0	0	42	0	0
24	17137778	.	T	C	2	1	3	0	1	4	0	0
24	17177262	.	G	A	0	3	3	0	7	10	0	0
24	17181103	.	A	G	3	0	3	0	3	6	0	0
24	17181443	.	A	G	6	0	6	0	6	12	0	0
24	17189815	.	T	A	2	2	4	0	0	4	0	0
24	17209371	.	T	C	1	4	5	1	1	7	0	0
24	17211821	.	C	A	4	2	6	0	0	6	0	0
24	17214493	.	A	T	11	10	21	0	1	22	0	0
24	17214629	.	T	C	18	5	23	0	3	26	0	0
24	17214756	.	C	T	11	5	16	0	0	16	0	0
24	17215186	.	T	C	4	3	7	0	0	7	0	0
24	17215855	.	C	T	1	4	5	0	1	6	0	0
24	17215894	.	A	G	1	5	6	0	0	6	0	0
24	17257693	.	C	A	12	7	19	0	0	19	0	0
24	17257866	.	T	C	0	2	2	0	0	2	0	0
24	17260568	.	C	A	3	4	7	0	0	7	0	0
24	17266564	.	G	T	5	4	9	0	0	9	0	0
24	17334815	.	T	C	8	7	15	0	1	16	0	0
24	17345708	.	T	C	3	5	8	0	0	8	0	0
24	17349859	.	G	A	1	0	1	0	0	1	0	0
24	17351704	.	C	T	1	0	1	0	0	1	0	0
24	17352009	.	C	T	0	2	2	0	0	2	0	0
24	17352335	.	C	A	2	3	5	0	1	6	0	0
24	17364287	.	T	C	1	2	3	0	1	4	0	0
24	17364985	.	G	A	12	10	22	0	2	24	0	0
24	17366374	.	G	A	4	3	7	0	0	7	0	0
24	17367882	.	G	A	7	9	16	0	2	18	0	0
24	17374611	.	T	C	8	2	10	0	0	10	0	0
24	17378478	.	C	A	3	1	4	0	0	4	0	0
24	17378493	.	T	G	2	0	2	0	0	2	0	0
24	17381017	.	G	A	7	4	11	0	0	11	0	0
24	17389385	.	A	T	8	3	11	0	0	11	0	0
24	17389415	.	G	A	5	4	9	0	0	9	0	0
24	17389460	.	A	G	0	1	1	0	0	1	0	0
24	17389462	.	A	G	0	1	1	0	0	1	0	0
24	17400069	.	T	A	0	1	1	0	0	1	0	0
24	17404219	.	G	A	10	6	16	0	0	16	0	0
24	17409892	.	T	G	3	6	9	0	0	9	0	0
24	17410153	.	A	T	5	4	9	0	1	10	0	0
24	17417855	.	G	C	8	7	15	0	0	15	0	0
24	17418292	.	T	A	8	7	15	0	0	15	0	0
24	17418306	.	C	T	7	7	14	0	0	14	0	0
24	17418460	.	T	C	6	8	14	0	0	14	0	0
24	17418659	.	A	T	0	5	5	0	1	6	0	0
24	17418668	.	T	C	2	5	7	0	0	7	0	0
24	17418837	.	A	G	1	4	5	0	0	5	0	0
24	17420761	.	G	T	8	6	14	0	0	14	0	0
24	17420876	.	C	T	5	3	8	0	0	8	0	0
24	17420893	.	G	T	6	3	9	0	0	9	0	0
24	17420989	.	T	C	11	0	11	0	9	20	0	0
24	17421270	.	C	T	0	10	10	0	14	24	0	0
24	17421338	.	A	T	17	13	30	0	0	30	0	0
24	17421396	.	C	A	17	13	30	0	1	31	0	0
24	17421655	.	G	A	12	12	24	0	2	26	0	0
24	17505248	.	C	T	5	5	10	0	0	10	0	0
24	17505358	.	C	T	0	4	4	0	3	7	0	0
24	17521598	.	G	A	5	6	11	0	0	11	0	0
24	17611267	.	A	G	1	2	3	0	0	3	0	0
24	17611316	.	G	C	4	2	6	0	1	7	0	0
24	17733647	.	T	G	0	2	2	0	0	2	0	0
24	17733735	.	T	G	1	2	3	0	0	3	0	0
24	17754509	.	T	C	6	0	6	0	6	12	0	0
24	17754557	.	G	A	3	2	5	0	0	5	0	0
24	17817767	.	A	G	0	4	4	0	0	4	0	0
24	17835698	.	G	A	0	1	1	0	0	1	0	0
24	17835788	.	G	A	3	3	6	0	0	6	0	0
24	18376840	.	G	A	1	3	4	0	3	7	0	0
24	18444095	.	A	C	6	7	13	0	0	13	0	0
24	18444265	.	A	T	19	30	49	0	1	50	0	0
24	18444267	.	T	C	30	5	35	0	15	50	0	0
24	18444334	.	G	T	11	14	25	0	1	26	0	0
24	18444373	.	C	T	3	5	8	0	0	8	0	0
24	18444429	.	A	C	1	2	3	0	1	4	0	0
24	18444434	.	T	C	1	1	2	0	1	3	0	0
24	18444476	.	A	G	2	2	4	0	0	4	0	0
24	18444499	.	A	G	1	2	3	0	0	3	0	0
24	18446527	.	T	A	10	15	25	0	1	26	0	0
24	18448339	.	A	G	0	6	6	0	0	6	0	0
24	18448348	.	G	A	1	4	5	0	0	5	0	0
24	18461007	.	C	T	0	3	3	0	1	4	0	0
24	18465403	.	C	T	0	2	2	0	0	2	0	0
24	18486030	.	A	G	5	4	9	0	0	9	0	0
24	18486053	.	A	G	6	3	9	0	0	9	0	0
24	18486936	.	G	A	1	2	3	0	0	3	0	0
24	18487315	.	G	C	3	1	4	0	0	4	0	0
24	18487385	.	C	T	0	2	2	0	0	2	0	0
24	18549388	.	A	G	3	3	6	0	0	6	0	0
24	18557481	.	A	G	5	3	8	0	1	9	0	0
24	18563714	.	A	G	1	2	3	0	0	3	0	0
24	18563826	.	C	A	0	1	1	0	0	1	0	0
24	18565564	.	A	G	0	3	3	0	1	4	0	0
24	18565591	.	C	T	1	3	4	0	2	6	0	0
24	18598654	.	C	T	1	1	2	0	0	2	0	0
24	18693646	.	T	G	2	2	4	0	0	4	0	0
24	18693665	.	C	A	2	2	4	0	0	4	0	0
24	18714339	.	C	T	2	3	5	0	0	5	0	0
24	18731918	.	G	A	0	8	8	0	4	12	0	0
24	18731951	.	T	C	3	10	13	0	1	14	0	0
24	18732190	.	T	G	1	2	3	0	0	3	0	0
24	18732216	.	A	T	1	4	5	0	0	5	0	0
24	18737876	.	C	T	7	5	12	0	0	12	0	0
24	18749985	.	A	G	6	13	19	0	0	19	0	0
24	18751785	.	G	A	10	9	19	0	0	19	0	0
24	18754752	.	G	A	2	3	5	0	1	6	0	0
24	18769556	.	G	A	5	2	7	0	0	7	0	0
24	18769625	.	C	G	5	6	11	0	0	11	0	0
24	18776192	.	T	A	2	3	5	0	0	5	0	0
24	18776298	.	A	G	1	2	3	0	0	3	0	0
24	18777699	.	T	G	2	0	2	0	0	2	0	0
24	18780044	.	G	A	1	1	2	0	0	2	0	0
24	18782982	.	G	T	1	2	3	0	0	3	0	0
24	18783713	.	T	G	0	2	2	0	0	2	0	0
24	18784241	.	C	T	1	2	3	0	0	3	0	0
24	18784259	.	C	T	0	3	3	0	1	4	0	0
24	18784288	.	G	A	3	1	4	0	0	4	0	0
24	18794371	.	G	A	2	3	5	0	0	5	0	0
24	18794455	.	T	C	0	4	4	0	4	8	0	0
24	18814782	.	G	T	3	6	9	0	0	9	0	0
24	19078352	.	A	G	1	2	3	0	1	4	0	0
24	19129518	.	C	T	1	3	4	0	0	4	0	0
24	19129530	.	G	A	3	1	4	0	0	4	0	0
24	19249658	.	C	T	1	2	3	0	0	3	0	0
24	19260900	.	C	T	3	2	5	0	0	5	0	0
24	19342704	.	C	G	2	0	2	0	0	2	0	0
24	19342705	.	A	T	2	0	2	0	0	2	0	0
24	19402505	.	G	T	2	4	6	0	0	6	0	0
24	19402645	.	C	T	1	4	5	0	1	6	0	0
24	19593256	.	T	C	0	2	2	0	0	2	0	0
24	19661679	.	C	T	1	3	4	0	0	4	0	0
24	19692615	.	G	A	0	1	1	0	1	2	0	0
24	19707742	.	G	A	4	13	17	0	0	17	0	0
24	19708366	.	C	T	7	7	14	0	3	17	0	0
24	19708448	.	G	T	11	15	26	0	0	26	0	0
24	19708927	.	G	A	7	9	16	0	0	16	0	0
24	19709272	.	C	A	6	12	18	0	1	19	0	0
24	19719132	.	C	A	0	14	14	0	10	24	0	0
24	20064368	.	T	C	2	0	2	0	4	6	0	0
24	20064653	.	C	T	2	3	5	0	1	6	0	0
24	20064892	.	G	A	3	5	8	0	1	9	0	0
24	20064924	.	A	G	2	2	4	0	0	4	0	0
24	20065115	.	C	T	0	4	4	0	3	7	0	0
24	20065156	.	C	A	0	3	3	0	6	9	0	0
24	20065236	.	T	C	1	6	7	0	0	7	0	0
24	20065733	.	T	C	0	5	5	0	0	5	0	0
24	20066110	.	T	C	1	0	1	0	5	6	0	0
24	20066122	.	A	G	2	2	4	0	1	5	0	0
24	20082944	.	G	A	2	1	3	0	0	3	0	0
24	20095469	.	G	A	0	1	1	0	1	2	0	0
24	20196172	.	A	G	6	8	14	0	0	14	0	0
24	20197755	.	C	A	1	2	3	0	2	5	0	0
24	20202041	.	C	T	2	3	5	0	0	5	0	0
24	20207173	.	T	G	0	2	2	0	0	2	0	0
24	20214463	.	G	T	2	4	6	0	0	6	0	0
24	20216163	.	A	T	2	2	4	0	0	4	0	0
24	20227798	.	T	C	2	1	3	0	0	3	0	0
24	20328430	.	C	T	3	1	4	0	0	4	0	0
24	20328821	.	C	A	4	8	12	0	2	14	0	0
24	20328999	.	T	A	1	3	4	0	0	4	0	0
24	20329493	.	G	A	5	7	12	0	0	12	0	0
24	20329589	.	G	C	0	3	3	0	0	3	0	0
24	20332145	.	A	G	1	4	5	0	0	5	0	0
24	20332187	.	A	T	1	3	4	0	0	4	0	0
24	20334326	.	T	G	2	0	2	0	2	4	0	0
24	20336686	.	T	C	3	2	5	0	0	5	0	0
24	20336694	.	A	G	3	2	5	0	0	5	0	0
24	20336784	.	G	A	2	1	3	0	0	3	0	0
24	20340026	.	A	C	0	1	1	0	0	1	0	0
24	20418000	.	A	G	1	2	3	0	0	3	0	0
24	20418011	.	T	C	1	2	3	0	0	3	0	0
24	20470921	.	C	T	2	3	5	0	0	5	0	0
24	20501159	.	G	A	6	3	9	0	1	10	0	0
24	20531624	.	C	A	5	2	7	0	0	7	0	0
24	20536110	.	G	C	5	5	10	0	0	10	0	0
24	20536188	.	C	A	6	9	15	0	0	15	0	0
24	20536235	.	G	A	0	7	7	0	7	14	0	0
24	20539454	.	G	A	5	3	8	0	0	8	0	0
24	20542907	.	G	A	1	2	3	0	0	3	0	0
24	20542909	.	C	T	1	2	3	0	0	3	0	0
24	20542972	.	T	C	4	5	9	0	0	9	0	0
24	20552393	.	A	T	8	4	12	0	0	12	0	0
24	20554732	.	A	G	17	13	30	0	0	30	0	0
24	20554812	.	T	A	9	6	15	0	0	15	0	0
24	20589592	.	C	T	0	3	3	0	3	6	0	0
24	20589791	.	G	A	12	7	19	0	1	20	0	0
24	20643765	.	T	C	3	4	7	0	1	8	0	0
24	20643780	.	T	A	4	3	7	0	0	7	0	0
24	20644063	.	A	C	7	3	10	0	2	12	0	0
24	20644123	.	A	C	9	7	16	0	0	16	0	0
24	20644685	.	C	T	0	2	2	0	1	3	0	0
24	20645101	.	T	C	11	16	27	0	1	28	0	0
24	20645273	.	T	C	14	13	27	0	1	28	0	0
24	20645662	.	T	C	14	1	15	0	14	29	0	0
24	20646270	.	T	A	15	10	25	0	1	26	0	0
24	20648942	.	C	T	3	2	5	0	0	5	0	0
24	20648945	.	T	C	1	3	4	0	1	5	0	0
24	20649039	.	T	G	5	12	17	0	1	18	0	0
24	20658386	.	C	A	0	2	2	0	0	2	0	0
24	20897560	.	T	C	1	2	3	0	0	3	0	0
24	20897561	.	G	T	1	2	3	0	0	3	0	0
24	20897801	.	T	A	3	3	6	0	1	7	0	0
24	20913403	.	C	T	0	5	5	0	1	6	0	0
24	20913408	.	T	A	1	5	6	0	0	6	0	0
24	20916841	.	C	A	3	5	8	0	3	11	0	0
24	20921431	.	C	T	5	16	21	0	0	21	0	0
24	20921670	.	G	A	3	3	6	0	0	6	0	0
24	20924996	.	C	T	2	1	3	0	0	3	0	0
24	20931626	.	G	A	5	1	6	0	1	7	0	0
24	20934528	.	G	A	5	12	17	0	1	18	0	0
24	20934616	.	T	C	0	3	3	0	1	4	0	0
24	20934619	.	A	T	1	3	4	0	0	4	0	0
24	20941540	.	G	A	7	4	11	0	0	11	0	0
24	20941605	.	A	G	5	5	10	0	0	10	0	0
24	20946263	.	G	A	3	2	5	0	1	6	0	0
24	20948122	.	C	T	12	10	22	0	1	23	0	0
24	20949494	.	A	G	15	8	23	0	0	23	0	0
24	20952215	.	T	A	1	4	5	0	0	5	0	0
24	20952306	.	C	T	1	1	2	0	1	3	0	0
24	20953415	.	C	T	6	10	16	0	2	18	0	0
24	20954151	.	C	A	5	1	6	0	0	6	0	0
24	20954154	.	T	C	4	1	5	0	0	5	0	0
24	20968424	.	A	C	1	2	3	0	1	4	0	0
24	20968498	.	A	T	2	4	6	0	0	6	0	0
24	20968514	.	A	T	3	6	9	0	0	9	0	0
24	20980039	.	A	G	1	0	1	0	3	4	0	0
24	20987732	.	C	T	6	7	13	0	0	13	0	0
24	20987798	.	T	C	6	1	7	0	0	7	0	0
24	21005546	.	C	T	1	2	3	0	0	3	0	0
24	21006053	.	A	G	6	8	14	0	1	15	0	0
24	21006082	.	G	A	5	11	16	0	1	17	0	0
24	21089886	.	A	G	1	3	4	0	0	4	0	0
24	21119798	.	C	A	1	2	3	0	0	3	0	0
24	21119806	.	A	G	1	2	3	0	0	3	0	0
24	21154203	.	C	T	10	12	22	0	0	22	0	0
24	21154419	.	T	G	13	15	28	0	1	29	0	0
24	21154496	.	C	A	2	11	13	0	26	39	0	0
24	21154586	.	T	C	17	34	51	0	0	51	0	0
24	21157712	.	G	A	18	27	45	0	1	47	1	0
24	21167720	.	G	A	4	7	11	0	0	11	0	0
24	21168638	.	G	T	10	12	22	0	0	22	0	0
24	21182642	.	G	A	11	11	22	0	0	22	0	0
24	21182783	.	C	T	0	9	9	0	2	11	0	0
24	21182834	.	G	A	0	13	13	0	10	23	0	0
24	21182911	.	G	A	1	5	6	0	9	15	0	0
24	21183474	.	G	A	9	8	17	0	0	17	0	0
24	21196211	.	C	A	5	2	7	0	0	7	0	0
24	21197152	.	T	C	1	3	4	0	0	4	0	0
24	21197823	.	A	G	2	2	4	0	0	4	0	0
24	21198025	.	T	C	4	3	7	0	0	7	0	0
24	21198160	.	T	A	3	3	6	0	0	6	0	0
24	21198192	.	A	G	1	3	4	0	0	4	0	0
24	21198611	.	A	G	1	0	1	0	2	3	0	0
24	21200739	.	C	T	3	6	9	0	0	9	0	0
24	21201380	.	T	C	8	12	20	0	1	21	0	0
24	21201860	.	G	A	0	5	5	0	7	12	0	0
24	21202067	.	G	T	5	5	10	0	0	10	0	0
24	21202203	.	A	G	6	2	8	0	0	8	0	0
24	21202225	.	C	T	3	2	5	0	0	5	0	0
24	21202256	.	G	T	1	1	2	0	0	2	0	0
24	21206352	.	G	T	3	4	7	0	1	8	0	0
24	21206401	.	T	C	4	4	8	0	0	8	0	0
24	21210608	.	T	G	1	2	3	0	1	4	0	0
24	21214898	.	G	A	5	4	9	0	0	9	0	0
24	21220660	.	C	T	0	3	3	0	2	5	0	0
24	21222664	.	T	C	2	0	2	0	4	6	0	0
24	21222697	.	C	T	0	2	2	0	1	3	0	0
24	21371481	.	T	C	15	14	29	0	0	29	0	0
24	21371520	.	G	C	16	15	31	0	0	31	0	0
24	21371547	.	T	C	18	18	36	0	2	38	0	0
24	21371599	.	C	T	24	20	44	0	2	46	0	0
24	21371801	.	T	G	24	19	43	0	1	44	0	0
24	21371919	.	G	A	24	14	38	0	1	39	0	0
24	21372417	.	A	G	18	15	33	0	1	34	0	0
24	21372435	.	G	A	13	11	24	0	0	24	0	0
24	21403620	.	C	T	1	0	1	0	0	1	0	0
24	21411463	.	G	A	3	5	8	0	1	9	0	0
24	21411514	.	G	A	6	6	12	0	0	12	0	0
24	21411876	.	T	A	11	13	24	0	0	24	0	0
24	21417872	.	C	T	2	5	7	0	1	8	0	0
24	21438161	.	G	A	6	11	17	0	1	18	0	0
24	21447610	.	T	G	7	7	14	0	0	14	0	0
24	21447668	.	C	T	0	3	3	0	2	5	0	0
24	21450130	.	C	T	5	5	10	0	0	10	0	0
24	21450383	.	G	A	9	9	18	0	0	18	0	0
24	21470881	.	A	T	4	4	8	0	0	8	0	0
24	21470933	.	C	A	3	2	5	0	0	5	0	0
24	21470934	.	C	A	3	2	5	0	0	5	0	0
24	21498770	.	G	A	2	2	4	0	0	4	0	0
24	21502007	.	A	G	3	4	7	0	0	7	0	0
24	21502069	.	G	A	8	7	15	0	1	16	0	0
24	21502133	.	T	C	5	0	5	0	7	12	0	0
24	21502305	.	A	G	9	8	17	0	0	17	0	0
24	21502817	.	C	A	2	5	7	0	0	7	0	0
24	21502842	.	T	A	7	5	12	0	0	12	0	0
24	21502880	.	G	T	9	7	16	0	1	17	0	0
24	21502973	.	G	A	9	3	12	0	1	13	0	0
24	21502999	.	G	A	7	5	12	0	3	15	0	0
24	21503043	.	G	T	7	8	15	0	2	17	0	0
24	21503438	.	G	A	2	4	6	0	0	6	0	0
24	21503682	.	C	T	2	4	6	0	1	7	0	0
24	21503694	.	C	G	3	4	7	0	1	8	0	0
24	21503748	.	T	C	5	2	7	0	0	7	0	0
24	21503793	.	G	A	3	3	6	0	0	6	0	0
24	21504725	.	C	T	0	6	6	0	5	11	0	0
24	21504785	.	A	G	2	12	14	0	1	15	0	0
24	21504860	.	G	T	6	5	11	0	0	11	0	0
24	21505043	.	C	A	3	4	7	0	0	7	0	0
24	21505255	.	T	G	0	3	3	0	0	3	0	0
24	21505271	.	C	T	0	3	3	0	4	7	0	0
24	21505446	.	A	T	6	4	10	0	0	10	0	0
24	21505505	.	C	T	0	4	4	0	2	6	0	0
24	21505623	.	G	A	2	2	4	0	2	6	0	0
24	21505931	.	G	T	9	7	16	0	2	18	0	0
24	21506033	.	C	T	2	1	3	0	1	4	0	0
24	21514386	.	T	A	5	5	10	0	1	11	0	0
24	21514437	.	T	C	3	5	8	0	1	9	0	0
24	21538568	.	A	C	9	11	20	0	0	20	0	0
24	21538628	.	C	T	7	3	10	0	1	11	0	0
24	21539131	.	T	G	3	4	7	0	0	7	0	0
24	21561074	.	C	T	2	7	9	0	0	9	0	0
24	21575273	.	T	A	1	2	3	0	1	4	0	0
24	21575311	.	G	C	6	14	20	0	1	21	0	0
24	21577239	.	G	A	0	1	1	0	0	1	0	0
24	21577394	.	C	A	18	10	28	0	0	28	0	0
24	21577573	.	T	G	9	10	19	0	1	20	0	0
24	21577638	.	A	G	3	9	12	0	1	13	0	0
24	21577898	.	C	A	5	4	9	0	0	9	0	0
24	21584189	.	G	A	5	5	10	0	0	10	0	0
24	21584673	.	T	G	7	2	9	0	0	9	0	0
24	21584731	.	G	A	3	2	5	0	0	5	0	0
24	21584756	.	A	C	3	1	4	0	1	5	0	0
24	21585042	.	A	C	2	5	7	0	0	7	0	0
24	21585043	.	A	C	2	5	7	0	0	7	0	0
24	21585366	.	C	A	0	2	2	0	5	7	0	0
24	21585396	.	C	T	0	4	4	0	1	5	0	0
24	21586190	.	C	G	3	5	8	0	0	8	0	0
24	21586454	.	C	G	5	6	11	0	0	11	0	0
24	21600984	.	C	A	17	19	36	0	1	37	0	0
24	21606035	.	G	A	8	13	21	0	1	22	0	0
24	21606325	.	C	T	1	4	5	0	0	5	0	0
24	21610064	.	G	A	3	0	3	0	0	3	0	0
24	21625149	.	C	T	29	31	60	0	8	68	0	0
24	21646375	.	G	A	9	5	14	0	1	15	0	0
24	21646802	.	A	C	20	18	38	0	1	39	0	0
24	21646805	.	C	G	1	17	18	0	19	37	0	0
24	21657567	.	C	G	12	12	24	0	0	24	0	0
24	21657639	.	G	A	14	10	24	0	0	24	0	0
24	21657642	.	G	A	15	11	26	0	0	26	0	0
24	21659593	.	T	C	13	0	13	0	13	26	0	0
24	21659792	.	C	T	0	6	6	0	14	20	0	0
24	21659819	.	G	A	16	10	26	0	0	26	0	0
24	21659864	.	A	T	6	7	13	0	0	13	0	0
24	21671114	.	G	A	11	3	14	0	0	14	0	0
24	21671381	.	A	G	5	10	15	0	2	17	0	0
24	21671506	.	G	A	10	9	19	0	0	19	0	0
24	21680646	.	G	T	1	2	3	0	0	3	0	0
24	21680747	.	C	G	5	6	11	0	0	11	0	0
24	21680970	.	A	C	9	5	14	0	0	14	0	0
24	21681162	.	C	T	7	3	10	0	0	10	0	0
24	21735379	.	G	A	3	5	8	0	0	8	0	0
24	21735466	.	A	G	3	2	5	0	0	5	0	0
24	21744200	.	C	T	6	4	10	0	1	11	0	0
24	21744266	.	A	G	1	1	2	0	0	2	0	0
24	21747316	.	T	G	6	5	11	0	1	12	0	0
24	21747325	.	T	C	6	4	10	0	2	12	0	0
24	21747368	.	T	C	6	6	12	0	0	12	0	0
24	21747376	.	C	T	5	6	11	0	0	11	0	0
24	21747705	.	T	C	5	1	6	0	1	7	0	0
24	21747714	.	C	T	0	6	6	0	1	7	0	0
24	21748249	.	T	C	13	7	20	0	1	21	0	0
24	21748279	.	C	T	12	10	22	0	0	22	0	0
24	21748374	.	T	C	7	3	10	0	0	10	0	0
24	21781238	.	C	A	4	3	7	0	0	7	0	0
24	21781451	.	T	G	8	3	11	0	0	11	0	0
24	21781452	.	T	A	7	3	10	0	1	11	0	0
24	21927377	.	T	C	1	3	4	0	0	4	0	0
24	21927503	.	A	G	5	5	10	0	0	10	0	0
24	21927638	.	G	A	5	6	11	0	2	13	0	0
24	21960044	.	C	A	2	4	6	0	0	6	0	0
24	21960293	.	C	T	3	12	15	0	1	16	0	0
24	21960299	.	G	A	3	12	15	0	1	16	0	0
24	21960538	.	A	G	4	3	7	0	0	7	0	0
24	21960930	.	C	T	3	8	11	0	0	11	0	0
24	21968103	.	A	G	0	1	1	0	1	2	0	0
24	21969526	.	G	A	1	2	3	0	0	3	0	0
24	21978470	.	A	G	8	9	17	0	0	17	0	0
24	21978524	.	C	T	8	8	16	0	1	17	0	0
24	21978531	.	A	G	8	7	15	0	1	16	0	0
24	21978647	.	C	G	11	10	21	0	3	24	0	0
24	21978733	.	C	T	26	11	37	0	0	37	0	0
24	21978790	.	T	C	7	17	24	0	0	24	0	0
24	21978805	.	T	C	20	1	21	0	0	21	0	0
24	21986794	.	A	G	15	3	18	0	0	18	0	0
24	21986802	.	C	T	11	2	13	0	2	15	0	0
24	22022535	.	A	G	1	0	1	0	0	1	0	0
24	22022570	.	T	C	1	2	3	0	0	3	0	0
24	22022629	.	G	C	1	2	3	0	0	3	0	0
24	22070477	.	A	G	4	7	11	0	1	12	0	0
24	22070530	.	G	T	2	3	5	0	0	5	0	0
24	22070877	.	G	A	0	5	5	0	1	6	0	0
24	22070878	.	A	G	1	5	6	0	0	6	0	0
24	22071115	.	G	A	4	3	7	0	0	7	0	0
24	22071146	.	G	C	2	4	6	0	0	6	0	0
24	22071183	.	C	T	0	2	2	0	1	3	0	0
24	22071185	.	C	A	0	3	3	0	0	3	0	0
24	22071644	.	G	T	18	14	32	0	6	38	0	0
24	22122828	.	A	C	8	0	8	0	1	9	0	0
24	22122922	.	C	T	0	8	8	0	11	19	0	0
24	22122929	.	G	A	8	11	19	0	1	20	0	0
24	22123024	.	G	A	4	7	11	0	1	12	0	0
24	22123115	.	C	T	1	7	8	0	12	20	0	0
24	22123176	.	T	A	8	13	21	0	2	23	0	0
24	22123434	.	G	C	4	3	7	0	0	7	0	0
24	22123446	.	A	G	4	6	10	0	0	10	0	0
24	22123640	.	A	G	10	13	23	0	0	23	0	0
24	22124020	.	G	A	10	9	19	0	0	19	0	0
24	22174462	.	C	T	2	2	4	0	0	4	0	0
24	22174486	.	G	A	3	7	10	0	1	11	0	0
24	22219741	.	C	T	5	3	8	0	0	8	0	0
24	22219792	.	G	A	10	8	18	0	0	18	0	0
24	22219810	.	C	T	1	10	11	0	4	15	0	0
24	22254056	.	G	T	2	6	8	0	0	8	0	0
24	22275400	.	C	T	2	7	9	0	0	9	0	0
24	22275403	.	A	T	2	6	8	0	1	9	0	0
24	22291190	.	C	T	0	4	4	0	5	9	0	0
24	22291193	.	T	C	5	0	5	0	4	9	0	0
24	22395255	.	T	C	9	8	17	0	0	17	0	0
24	22412434	.	C	T	1	5	6	0	9	15	0	0
24	22442301	.	T	C	4	0	4	0	2	6	0	0
24	22442340	.	G	A	1	3	4	0	0	4	0	0
24	22731340	.	T	A	0	2	2	0	0	2	0	0
24	22740552	.	T	C	2	2	4	0	0	4	0	0
24	22740589	.	T	C	7	7	14	0	1	15	0	0
24	22740897	.	A	T	6	16	22	0	0	22	0	0
24	22740949	.	A	G	7	18	25	0	3	28	0	0
24	22740996	.	C	T	6	11	17	0	4	21	0	0
24	22741051	.	G	A	10	7	17	0	1	18	0	0
24	22741088	.	C	T	6	10	16	0	1	17	0	0
24	22741403	.	T	A	8	9	17	0	1	18	0	0
24	22741453	.	C	T	8	11	19	0	1	20	0	0
24	22744502	.	A	G	4	5	9	0	1	10	0	0
24	22746843	.	T	G	4	7	11	0	0	11	0	0
24	22748633	.	C	T	5	7	12	0	1	13	0	0
24	22769225	.	A	T	9	15	24	0	1	25	0	0
24	22769447	.	G	A	7	6	13	0	0	13	0	0
24	22769484	.	C	T	4	4	8	0	0	8	0	0
24	22769593	.	C	A	2	2	4	0	0	4	0	0
24	22769595	.	T	A	2	2	4	0	0	4	0	0
24	23213206	.	C	G	1	2	3	0	1	4	0	0
24	23213886	.	G	A	0	2	2	0	7	9	0	0
24	23243116	.	T	C	13	1	14	0	8	22	0	0
24	23243257	.	A	G	3	3	6	0	0	6	0	0
24	23243872	.	A	T	8	8	16	0	1	17	0	0
24	23243946	.	C	A	8	5	13	0	0	13	0	0
24	23244161	.	T	A	7	12	19	0	1	20	0	0
24	23300755	.	A	G	0	4	4	0	0	4	0	0
24	23302371	.	A	G	5	4	9	0	0	9	0	0
24	23302441	.	A	G	4	5	9	0	1	10	0	0
24	23303003	.	G	A	1	2	3	0	0	3	0	0
24	24015086	.	G	T	5	4	9	0	0	9	0	0
24	24017837	.	C	T	6	4	10	0	1	11	0	0
24	24027914	.	T	A	4	9	13	0	0	13	0	0
24	24027990	.	A	T	9	9	18	0	1	19	0	0
24	24028059	.	T	A	13	11	24	0	0	24	0	0
24	24733667	.	C	A	10	4	14	0	0	14	0	0
24	25694871	.	G	T	1	2	3	0	0	3	0	0
24	25764281	.	A	G	0	1	1	0	1	2	0	0
24	25794560	.	T	C	3	2	5	0	0	5	0	0
24	26887490	.	C	A	5	4	9	0	0	9	0	0
24	26888938	.	A	C	1	1	2	0	0	2	0	0
24	26936744	.	C	T	2	0	2	0	0	2	0	0
24	26941996	.	A	G	7	13	20	0	0	20	0	0
24	26942242	.	C	G	5	12	17	0	0	17	0	0
24	26942614	.	C	T	1	10	11	0	8	19	0	0
24	26948744	.	A	T	1	0	1	0	0	1	0	0
24	26948933	.	A	T	2	4	6	0	1	7	0	0
24	26949229	.	T	C	10	8	18	0	0	18	0	0
24	26949426	.	A	C	9	3	12	0	0	12	0	0
24	26949555	.	T	G	4	5	9	0	1	10	0	0
24	26961917	.	A	G	1	0	1	0	0	1	0	0
24	26962277	.	C	T	3	3	6	0	1	7	0	0
24	26970323	.	A	T	1	0	1	0	0	1	0	0
24	26970726	.	C	T	2	0	2	0	0	2	0	0
24	26970936	.	T	C	1	0	1	0	2	3	0	0
24	26980360	.	A	G	0	1	1	0	0	1	0	0
24	26980376	.	A	G	0	1	1	0	0	1	0	0
24	26980770	.	A	C	0	2	2	0	0	2	0	0
24	26997881	.	T	G	4	5	9	0	0	9	0	0
24	26998086	.	T	A	3	3	6	0	0	6	0	0
24	27013469	.	A	T	2	8	10	0	0	10	0	0
24	27130971	.	A	T	3	3	6	0	0	6	0	0
24	27151634	.	T	C	1	1	2	0	0	2	0	0
24	27168700	.	G	T	2	0	2	0	0	2	0	0
24	27169734	.	T	C	0	2	2	0	0	2	0	0
24	27181048	.	T	A	5	7	12	0	0	12	0	0
24	27181135	.	A	G	1	0	1	0	3	4	0	0
24	27185859	.	T	A	4	4	8	0	0	8	0	0
24	27222610	.	A	C	8	17	25	0	0	25	0	0
24	27222713	.	A	G	9	2	11	0	6	17	0	0
24	27222937	.	G	A	0	5	5	0	12	17	0	0
24	27224484	.	A	T	9	17	26	0	1	27	0	0
24	27224842	.	G	A	14	11	25	0	0	25	0	0
24	27224990	.	G	A	11	18	29	0	0	29	0	0
24	27225238	.	C	T	0	9	9	0	14	23	0	0
24	27225342	.	G	A	11	10	21	0	1	22	0	0
24	27225675	.	T	A	13	10	23	0	0	23	0	0
24	27225693	.	A	G	13	12	25	0	2	27	0	0
24	27225842	.	A	G	10	10	20	0	1	21	0	0
24	27225859	.	C	G	9	10	19	0	0	19	0	0
24	27225960	.	G	A	16	12	28	0	0	28	0	0
24	27226044	.	A	G	8	4	12	0	1	13	0	0
24	27226368	.	C	T	7	7	14	0	0	14	0	0
24	27238527	.	G	A	3	0	3	0	0	3	0	0
24	27268027	.	C	T	3	4	7	0	0	7	0	0
24	27346819	.	G	A	1	2	3	0	0	3	0	0
24	27346837	.	C	T	2	3	5	0	0	5	0	0
24	27399940	.	G	A	5	7	12	0	1	13	0	0
24	27399969	.	T	C	5	8	13	0	0	13	0	0
24	27607841	.	C	G	4	2	6	0	0	6	0	0
24	27700425	.	G	A	3	3	6	0	0	6	0	0
24	27714869	.	T	A	3	2	5	0	0	5	0	0
24	27714879	.	T	C	3	3	6	0	0	6	0	0
24	27715088	.	C	A	5	3	8	0	0	8	0	0
24	27784342	.	A	G	5	9	14	0	0	14	0	0
24	27784348	.	C	T	5	8	13	0	1	14	0	0
24	28231635	.	T	A	2	2	4	0	0	4	0	0
24	28231637	.	A	G	1	2	3	0	1	4	0	0
24	28240609	.	T	C	3	0	3	0	0	3	0	0
24	28242709	.	T	C	8	0	8	0	2	10	0	0
24	28252605	.	C	T	5	3	8	0	1	9	0	0
24	28252677	.	T	A	5	7	12	0	0	12	0	0
24	28253782	.	A	T	18	23	41	0	0	41	0	0
24	28259128	.	C	T	5	2	7	0	0	7	0	0
24	28263850	.	G	A	0	2	2	0	0	2	0	0
24	28263856	.	G	C	2	0	2	0	0	2	0	0
24	28263964	.	G	A	3	4	7	0	0	7	0	0
24	28293347	.	C	T	0	3	3	0	1	4	0	0
24	28306471	.	C	T	5	3	8	0	0	8	0	0
24	28312326	.	T	A	5	3	8	0	0	8	0	0
24	28312359	.	G	A	10	3	13	0	0	13	0	0
24	28312431	.	G	A	6	5	11	0	0	11	0	0
24	28312460	.	A	T	4	1	5	0	1	6	0	0
24	28381351	.	C	A	4	3	7	0	0	7	0	0
24	28392367	.	A	G	1	0	1	0	2	3	0	0
24	28394446	.	G	T	2	8	10	0	1	11	0	0
24	28397232	.	G	T	0	7	7	0	3	10	0	0
24	28426363	.	T	G	25	17	42	1	0	43	0	0
24	28426705	.	T	A	19	18	37	0	2	39	0	0
24	28426717	.	C	T	0	16	16	0	21	37	0	0
24	28432162	.	A	G	9	8	17	0	0	17	0	0
24	28432297	.	A	C	24	18	42	0	0	42	0	0
24	28432372	.	G	A	21	11	32	0	1	33	0	0
24	28437405	.	G	A	16	17	33	0	0	33	0	0
24	28437681	.	C	T	10	8	18	0	1	19	0	0
24	28556150	.	C	T	1	2	3	0	0	3	0	0
24	28649152	.	G	A	0	1	1	0	0	1	0	0
24	28686911	.	C	T	0	3	3	0	5	8	0	0
24	28687245	.	A	C	7	1	8	0	5	13	0	0
24	28687253	.	G	A	7	6	13	0	1	14	0	0
24	28687576	.	A	G	11	8	19	0	0	19	0	0
24	28687783	.	G	T	16	13	29	0	2	31	0	0
24	28688104	.	G	A	5	6	11	0	1	12	0	0
24	28691389	.	C	T	1	7	8	0	0	8	0	0
24	28691457	.	C	T	0	7	7	0	8	15	0	0
24	28710825	.	A	G	3	0	3	0	0	3	0	0
24	28710915	.	G	T	13	11	24	0	2	26	0	0
24	28710953	.	G	A	11	14	25	0	0	25	0	0
24	28711027	.	T	A	5	6	11	0	0	11	0	0
24	28949511	.	G	A	4	6	10	0	0	10	0	0
24	28953040	.	C	A	4	7	11	0	1	12	0	0
24	28963133	.	C	T	9	5	14	0	1	15	0	0
24	28963445	.	C	T	0	1	1	0	0	1	0	0
24	28964254	.	T	C	1	2	3	0	0	3	0	0
24	28964747	.	T	A	2	2	4	0	0	4	0	0
24	28965578	.	G	A	1	3	4	0	0	4	0	0
24	28965903	.	A	G	1	2	3	0	0	3	0	0
24	28966810	.	T	C	1	5	6	0	0	6	0	0
24	28966812	.	T	G	1	5	6	0	0	6	0	0
24	28966873	.	C	A	8	4	12	0	0	12	0	0
24	28966892	.	T	C	5	5	10	0	0	10	0	0
24	29352296	.	T	A	3	5	8	0	1	9	0	0
24	29352703	.	T	C	2	7	9	0	1	10	0	0
24	29353048	.	C	T	2	5	7	0	0	7	0	0
24	29353508	.	T	C	1	2	3	0	0	3	0	0
24	29382153	.	T	A	6	5	11	0	2	13	0	0
24	29382235	.	T	C	9	10	19	0	0	19	0	0
24	29449847	.	C	T	5	3	8	0	1	9	0	0
24	29450183	.	C	T	3	11	14	0	0	14	0	0
24	29525071	.	C	T	13	16	29	0	1	30	0	0
24	29525262	.	T	C	11	7	18	0	1	19	0	0
24	29961745	.	T	C	1	2	3	0	0	3	0	0
24	29961883	.	G	A	1	4	5	0	0	5	0	0
24	29961904	.	C	G	2	3	5	0	0	5	0	0
24	29961958	.	G	A	3	3	6	0	0	6	0	0
24	29962084	.	A	G	2	2	4	0	0	4	0	0
24	29997145	.	A	T	7	1	8	0	0	8	0	0
24	30053987	.	C	T	0	4	4	0	7	11	0	0
24	30054257	.	A	G	2	4	6	0	0	6	0	0
24	30054404	.	G	A	3	6	9	0	0	9	0	0
24	30054812	.	G	C	6	8	14	0	1	15	0	0
24	30054835	.	A	T	12	7	19	0	2	21	0	0
24	30054857	.	A	G	7	4	11	0	0	11	0	0
24	30054898	.	G	A	9	6	15	0	0	15	0	0
24	30054947	.	C	T	9	6	15	0	2	17	0	0
24	30054980	.	T	G	7	7	14	0	2	16	0	0
24	30055046	.	G	A	2	4	6	0	0	6	0	0
24	30056786	.	C	T	3	1	4	0	0	4	0	0
24	30067126	.	C	T	5	7	12	0	1	13	0	0
24	30082868	.	A	G	2	6	8	0	0	8	0	0
24	30082884	.	A	G	1	6	7	0	0	7	0	0
24	30082929	.	A	G	0	2	2	0	0	2	0	0
24	30160662	.	T	C	2	1	3	0	0	3	0	0
24	30182391	.	G	A	0	3	3	0	2	5	0	0
24	30194386	.	G	A	0	0	0	0	1	1	0	0
24	30198967	.	C	G	3	2	5	0	0	5	0	0
24	30198977	.	T	C	2	2	4	0	0	4	0	0
24	30268050	.	T	C	1	2	3	0	0	3	0	0
24	30835992	.	G	T	9	3	12	1	2	15	0	0
24	30837682	.	G	C	6	8	14	0	0	14	0	0
24	30852329	.	C	T	0	3	3	0	3	6	0	0
24	30855603	.	C	T	0	3	3	0	2	5	0	0
24	31082078	.	A	G	5	10	15	0	1	16	0	0
24	31082432	.	G	T	9	4	13	0	0	13	0	0
24	31082774	.	C	A	5	4	9	0	0	9	0	0
24	31092530	.	T	G	1	1	2	0	0	2	0	0
24	31098655	.	C	A	13	11	24	0	1	25	0	0
24	31098720	.	A	G	13	12	25	0	0	25	0	0
24	31098820	.	A	G	10	10	20	0	0	20	0	0
24	31098874	.	G	T	9	9	18	0	0	18	0	0
24	31123315	.	G	A	11	3	14	0	0	14	0	0
24	31140110	.	G	A	3	2	5	0	0	5	0	0
24	31140251	.	A	G	2	4	6	0	0	6	0	0
24	31140269	.	C	T	6	4	10	0	0	10	0	0
24	31170558	.	T	A	14	12	26	0	0	26	0	0
24	31170751	.	A	T	3	4	7	0	0	7	0	0
24	31171057	.	T	A	9	6	15	0	0	15	0	0
24	31171285	.	G	A	9	11	20	0	0	20	0	0
24	31171417	.	G	A	6	15	21	0	1	22	0	0
24	31171468	.	A	T	9	11	20	0	1	21	0	0
24	31176087	.	A	G	2	4	6	0	1	7	0	0
24	31194653	.	T	C	0	3	3	0	0	3	0	0
24	31194710	.	A	G	0	3	3	0	0	3	0	0
24	31201348	.	T	C	1	3	4	0	0	4	0	0
24	31277432	.	A	T	1	4	5	0	0	5	0	0
24	31310849	.	T	A	7	6	13	0	0	13	0	0
24	31310981	.	T	G	5	3	8	0	0	8	0	0
24	31311087	.	G	A	14	10	24	0	1	25	0	0
24	31311110	.	T	A	12	10	22	0	2	24	0	0
24	31311137	.	A	G	8	11	19	0	1	20	0	0
24	31315500	.	A	G	3	5	8	0	1	9	0	0
24	31319363	.	A	C	1	1	2	0	0	2	0	0
24	31319544	.	T	C	0	1	1	0	0	1	0	0
24	31319606	.	A	G	1	2	3	0	0	3	0	0
24	31320006	.	A	G	0	3	3	0	0	3	0	0
24	31322920	.	A	G	1	2	3	0	0	3	0	0
24	31334313	.	A	G	11	14	25	0	1	26	0	0
24	31340610	.	C	G	20	1	21	0	20	41	0	0
24	31340673	.	T	C	8	11	19	0	1	20	0	0
24	31340922	.	A	G	13	0	13	0	17	30	0	0
24	31364654	.	A	G	2	0	2	0	4	6	0	0
24	31367491	.	A	G	1	2	3	0	0	3	0	0
24	31367533	.	T	C	4	7	11	0	0	11	0	0
24	31367880	.	A	G	4	1	5	0	2	7	0	0
24	31374532	.	A	G	2	0	2	0	3	5	0	0
24	31379390	.	A	G	6	4	10	0	0	10	0	0
24	31379402	.	G	C	6	4	10	0	0	10	0	0
24	31397840	.	G	A	3	6	9	0	0	9	0	0
24	31398002	.	A	G	1	3	4	0	0	4	0	0
24	31404580	.	C	G	4	11	15	0	0	15	0	0
24	31832970	.	C	T	3	4	7	0	0	7	0	0
24	31838972	.	T	C	5	6	11	0	0	11	0	0
24	31842739	.	C	T	3	5	8	0	0	8	0	0
24	31854349	.	A	G	1	3	4	0	0	4	0	0
24	31942597	.	A	C	6	0	6	0	5	11	0	0
24	32152877	.	T	G	2	5	7	0	0	7	0	0
24	32152898	.	C	T	2	5	7	0	0	7	0	0
24	32152914	.	A	T	2	5	7	0	0	7	0	0
24	32152944	.	C	T	1	2	3	0	0	3	0	0
24	32163890	.	C	T	3	5	8	0	0	8	0	0
24	32163954	.	T	C	3	0	3	0	5	8	0	0
24	32164027	.	C	T	6	4	10	0	0	10	0	0
24	32173246	.	G	A	1	0	1	0	0	1	0	0
24	32173251	.	A	G	1	0	1	0	0	1	0	0
24	32173646	.	A	G	1	1	2	0	0	2	0	0
24	32176222	.	T	C	9	12	21	0	0	21	0	0
24	32176499	.	T	C	24	13	37	0	0	37	0	0
24	32176716	.	G	C	20	23	43	0	1	44	0	0
24	32180747	.	C	T	1	14	15	0	0	15	0	0
24	32184363	.	C	T	17	20	37	0	3	41	1	0
24	32184379	.	C	A	17	20	37	0	5	42	0	0
24	32187534	.	G	A	27	32	59	0	1	60	0	0
24	32192518	.	G	A	2	19	21	0	25	46	0	0
24	32192529	.	T	C	20	24	44	0	1	45	0	0
24	32192558	.	G	A	14	27	41	0	2	43	0	0
24	32406971	.	C	T	2	3	5	0	0	5	0	0
24	32473594	.	C	G	9	6	15	0	1	16	0	0
24	32473597	.	G	A	0	7	7	0	7	14	0	0
24	32517984	.	G	A	10	11	21	0	0	21	0	0
24	32519471	.	G	A	4	5	9	0	0	9	0	0
24	32522462	.	T	A	19	14	33	0	0	33	0	0
24	32522526	.	A	G	27	29	56	0	1	57	0	0
24	32530539	.	A	G	4	7	11	0	0	11	0	0
24	32531517	.	T	C	0	1	1	0	0	1	0	0
24	32531527	.	G	A	0	1	1	0	0	1	0	0
24	32534789	.	C	T	2	3	5	0	0	5	0	0
24	32536788	.	A	G	2	0	2	0	5	7	0	0
24	32547755	.	T	C	5	3	8	0	0	8	0	0
24	32547920	.	A	G	2	0	2	0	3	5	0	0
24	32547926	.	A	C	5	2	7	0	0	7	0	0
24	32548038	.	A	C	2	5	7	0	0	7	0	0
24	33767819	.	T	C	0	5	5	0	0	5	0	0
24	33768259	.	A	T	2	0	2	0	1	3	0	0
24	33824503	.	G	A	0	5	5	0	1	6	0	0
24	33836689	.	A	G	7	3	10	0	0	10	0	0
24	33837790	.	A	G	7	6	13	0	3	16	0	0
24	33837914	.	A	G	3	4	7	0	0	7	0	0
24	33837916	.	A	G	3	4	7	0	0	7	0	0
24	33838097	.	A	G	4	3	7	0	0	7	0	0
24	33838105	.	A	G	5	2	7	0	0	7	0	0
24	33838374	.	A	G	5	5	10	0	0	10	0	0
24	33838535	.	A	G	4	4	8	0	0	8	0	0
24	33838606	.	A	G	5	3	8	0	1	9	0	0
24	34549405	.	A	G	4	3	7	0	0	7	0	0
24	34607240	.	C	T	6	10	16	0	0	16	0	0
24	34607282	.	C	G	9	12	21	0	0	21	0	0
24	34607366	.	C	A	2	6	8	0	0	8	0	0
24	34608653	.	C	T	8	8	16	0	0	16	0	0
24	34608844	.	C	T	10	8	18	0	0	18	0	0
24	34610215	.	G	T	0	10	10	0	10	20	0	0
24	34610293	.	A	G	5	10	15	0	0	15	0	0
24	34610391	.	T	C	12	4	16	0	1	17	0	0
24	34610515	.	G	A	12	5	17	0	1	18	0	0
24	34610655	.	G	A	1	3	4	0	8	12	0	0
24	34610874	.	A	G	14	10	24	0	2	26	0	0
24	34610920	.	A	T	11	10	21	0	1	23	1	0
24	34611151	.	T	C	16	15	31	0	0	31	0	0
24	34611211	.	G	A	8	21	29	0	1	30	0	0
24	34611236	.	G	A	0	20	20	0	9	29	0	0
24	34611407	.	G	C	13	16	29	0	1	30	0	0
24	34611445	.	A	G	11	12	23	0	0	24	1	0
24	34611681	.	C	T	16	8	24	0	0	24	0	0
24	34611779	.	T	A	5	3	8	0	0	8	0	0
24	34611798	.	C	T	3	3	6	0	0	6	0	0
24	34611885	.	T	A	8	6	14	0	0	14	0	0
24	34611915	.	A	G	6	0	6	0	5	11	0	0
24	34612123	.	A	G	14	13	27	0	0	27	0	0
24	34612160	.	A	G	19	10	29	0	0	29	0	0
24	34612187	.	C	A	16	11	27	0	0	27	0	0
24	34612327	.	A	T	16	14	30	0	0	30	0	0
24	37170198	.	G	A	0	5	5	0	4	9	0	0
24	37195514	.	T	A	12	7	19	0	2	21	0	0
24	37203849	.	A	G	4	2	6	0	1	7	0	0
24	37206315	.	G	A	3	2	5	0	0	5	0	0
24	37214116	.	T	A	4	5	9	0	1	10	0	0
24	37214122	.	C	T	4	5	9	0	1	10	0	0
24	37221248	.	C	T	1	3	4	0	0	4	0	0
24	37221302	.	C	T	5	2	7	0	0	7	0	0
24	37221323	.	C	T	0	1	1	0	4	5	0	0
24	37257922	.	T	G	20	4	24	0	1	30	5	0
24	37261221	.	A	G	2	3	5	0	0	5	0	0
24	37276218	.	C	T	2	2	4	0	1	5	0	0
24	37277000	.	A	G	1	4	5	0	0	5	0	0
24	37277257	.	T	G	1	3	4	0	0	4	0	0
24	37302011	.	T	A	6	7	13	0	0	13	0	0
24	37302539	.	G	A	14	18	32	0	0	32	0	0
24	37302747	.	G	A	13	17	30	0	4	34	0	0
24	37302764	.	G	T	16	18	34	0	0	34	0	0
24	37310338	.	A	C	10	8	18	0	1	19	0	0
24	37312146	.	T	C	9	8	17	0	0	17	0	0
24	37312173	.	A	G	7	7	14	0	0	14	0	0
24	37319839	.	G	A	4	5	9	0	0	9	0	0
24	37319851	.	G	A	4	5	9	0	0	9	0	0
24	37329390	.	A	G	2	2	4	0	0	4	0	0
24	37329476	.	T	A	6	6	12	0	1	13	0	0
24	37329578	.	T	A	4	1	5	0	0	5	0	0
24	37336975	.	A	G	5	2	7	0	0	7	0	0
24	37337763	.	C	T	4	5	9	0	0	9	0	0
24	37338980	.	T	C	2	1	3	0	1	4	0	0
24	37344146	.	A	T	9	10	19	0	0	19	0	0
24	37344164	.	G	A	9	11	20	0	0	20	0	0
24	37347758	.	A	C	1	7	8	0	0	8	0	0
24	37347937	.	A	C	3	7	10	0	2	12	0	0
24	37347946	.	T	C	4	9	13	0	0	13	0	0
24	37370207	.	T	G	12	0	12	0	9	21	0	0
24	37375160	.	C	T	12	9	21	0	3	24	0	0
24	37375165	.	T	C	10	10	20	0	2	22	0	0
24	37469699	.	G	A	2	5	7	0	0	7	0	0
24	37474110	.	A	G	6	13	19	0	0	19	0	0
24	37476633	.	A	C	2	3	5	0	0	5	0	0
24	37476735	.	A	C	7	6	13	0	0	13	0	0
24	37476759	.	T	C	6	4	10	0	1	11	0	0
24	37476955	.	A	G	3	6	9	0	0	9	0	0
24	37477036	.	C	T	2	1	3	0	1	4	0	0
24	37482699	.	T	A	2	6	8	0	0	8	0	0
24	37531360	.	G	A	0	1	1	0	1	2	0	0
24	37539572	.	T	C	1	0	1	0	0	1	0	0
24	37542624	.	C	T	0	1	1	0	0	1	0	0
24	37544677	.	C	T	3	2	5	0	0	5	0	0
24	37544680	.	T	C	3	2	5	0	0	5	0	0
24	37544901	.	C	T	2	3	5	0	0	5	0	0
24	37547639	.	T	C	1	1	2	0	1	3	0	0
24	37553522	.	T	C	0	1	1	0	0	1	0	0
24	37553534	.	A	C	0	1	1	0	0	1	0	0
24	37555605	.	C	T	3	0	3	0	0	3	0	0
24	37567342	.	C	T	13	15	28	0	2	30	0	0
24	37567734	.	C	T	4	26	30	0	22	52	0	0
24	37567953	.	A	G	26	23	49	0	4	53	0	0
24	37568186	.	A	C	25	23	48	0	1	49	0	0
24	37568349	.	T	G	9	7	16	0	0	16	0	0
24	37604311	.	G	T	3	1	4	0	1	5	0	0
24	37604362	.	C	T	2	4	6	0	1	7	0	0
24	37623208	.	C	T	5	4	9	0	0	9	0	0
24	37631701	.	G	A	3	2	5	0	1	6	0	0
24	37631702	.	A	C	3	2	5	0	1	6	0	0
24	37631842	.	G	A	2	3	5	0	1	6	0	0
24	37636887	.	G	A	0	1	1	0	0	1	0	0
24	37649846	.	G	A	0	3	3	0	3	6	0	0
24	37653377	.	A	G	4	0	4	0	4	8	0	0
24	37653447	.	C	T	0	1	1	0	0	1	0	0
24	37657923	.	C	T	3	3	6	0	0	6	0	0
24	37660472	.	C	T	2	2	4	0	0	4	0	0
24	37661919	.	T	C	2	5	7	0	0	7	0	0
24	37661949	.	C	T	2	3	5	0	0	5	0	0
24	37681556	.	G	T	4	5	9	0	1	10	0	0
24	37685942	.	C	T	0	4	4	0	6	10	0	0
24	37686147	.	G	A	0	1	1	0	0	1	0	0
24	37687864	.	G	A	0	2	2	0	0	2	0	0
24	37688804	.	C	T	0	2	2	0	0	2	0	0
24	37688810	.	A	C	0	1	1	0	0	1	0	0
24	37689919	.	T	C	29	23	52	0	2	54	0	0
24	37692529	.	G	A	16	10	26	0	0	26	0	0
24	37696427	.	G	A	5	10	15	0	0	15	0	0
24	37700263	.	A	G	1	0	1	0	0	1	0	0
24	37705648	.	C	A	1	1	2	0	0	2	0	0
24	37705667	.	A	G	2	1	3	0	0	3	0	0
24	37705685	.	C	G	4	0	4	0	3	7	0	0
24	37708017	.	T	C	1	0	1	0	0	1	0	0
24	37708288	.	A	C	1	3	4	0	0	4	0	0
24	37722245	.	T	C	2	3	5	0	0	5	0	0
24	37722247	.	T	G	3	2	5	0	0	5	0	0
24	37724550	.	G	A	4	2	6	0	0	6	0	0
24	37724881	.	T	C	2	2	4	0	0	4	0	0
24	37725117	.	T	C	1	5	6	0	0	6	0	0
24	37725179	.	T	A	3	2	5	0	1	6	0	0
24	37725286	.	G	T	0	3	3	0	3	6	0	0
24	37725423	.	G	C	2	5	7	0	1	8	0	0
24	37725877	.	A	G	2	6	8	0	0	8	0	0
24	37725885	.	G	T	2	5	7	0	0	7	0	0
24	37726004	.	G	A	1	4	5	0	1	6	0	0
24	37726022	.	A	G	1	0	1	0	7	8	0	0
24	37726329	.	C	T	4	3	7	0	0	7	0	0
24	37726367	.	C	T	3	2	5	0	0	5	0	0
24	37726377	.	A	G	1	3	4	0	0	4	0	0
24	37726562	.	C	A	3	6	9	0	0	9	0	0
24	37726598	.	A	G	6	3	9	0	0	9	0	0
24	37726649	.	G	A	1	2	3	0	2	5	0	0
24	37726867	.	C	G	4	6	10	0	0	10	0	0
24	37726997	.	G	A	1	3	4	0	0	4	0	0
24	37727272	.	C	A	6	2	8	0	0	8	0	0
24	37746094	.	G	A	0	1	1	0	0	1	0	0
24	37781446	.	C	T	6	4	10	0	0	10	0	0
24	37786365	.	C	T	8	8	16	0	0	16	0	0
24	37788853	.	G	A	2	3	5	0	0	5	0	0
24	37793276	.	C	A	2	3	5	0	0	5	0	0
24	37793282	.	C	T	2	4	6	0	0	6	0	0
24	37793315	.	C	T	5	7	12	0	0	12	0	0
24	37793725	.	C	T	5	2	7	0	0	7	0	0
24	37793762	.	A	G	2	0	2	0	2	4	0	0
24	37793769	.	C	T	0	4	4	0	0	4	0	0
24	37800148	.	G	A	1	2	3	0	0	3	0	0
24	37802311	.	T	A	2	5	7	0	0	7	0	0
24	37813474	.	G	T	2	2	4	0	0	4	0	0
24	37815037	.	G	A	2	1	3	0	0	3	0	0
24	37818511	.	G	A	4	5	9	0	0	9	0	0
24	37893466	.	G	A	1	2	3	0	0	3	0	0
24	37895022	.	C	T	1	0	1	0	0	1	0	0
24	37896875	.	C	T	0	3	3	0	0	3	0	0
24	37901114	.	A	G	5	3	8	0	0	8	0	0
24	37901178	.	C	T	6	4	10	0	0	10	0	0
24	37919696	.	G	A	0	1	1	0	1	2	0	0
24	37919753	.	T	G	1	2	3	0	0	3	0	0
24	37920358	.	G	A	3	2	5	0	0	5	0	0
24	37921721	.	A	G	1	0	1	0	2	3	0	0
24	37941862	.	C	T	0	11	11	0	3	14	0	0
24	37941922	.	A	C	11	7	18	0	1	19	0	0
24	37941958	.	A	G	9	8	17	0	2	19	0	0
24	37942032	.	C	T	11	10	21	0	1	22	0	0
24	37942183	.	A	T	5	5	10	0	0	10	0	0
24	37942323	.	C	T	0	4	4	0	10	14	0	0
24	37942359	.	G	A	8	4	12	0	0	12	0	0
24	37942406	.	T	C	3	3	6	0	1	7	0	0
24	37942559	.	C	T	4	2	6	0	0	6	0	0
24	37942866	.	C	A	1	2	3	0	0	3	0	0
24	37943005	.	T	A	2	1	3	0	0	3	0	0
24	37943012	.	A	G	3	1	4	0	0	4	0	0
24	37943052	.	A	G	0	2	2	0	0	2	0	0
24	37943342	.	T	A	3	2	5	0	0	5	0	0
24	37943767	.	C	T	0	4	4	0	2	6	0	0
24	37943803	.	A	G	5	2	7	0	1	8	0	0
24	37955866	.	G	A	1	2	3	0	1	4	0	0
24	37955870	.	A	T	1	2	3	0	0	3	0	0
24	38073271	.	G	A	23	25	48	0	1	49	0	0
24	38073319	.	G	A	35	28	63	0	3	66	0	0
24	38073502	.	G	C	26	24	50	0	4	54	0	0
24	38073511	.	G	A	32	22	54	0	1	55	0	0
24	38073655	.	A	G	21	16	37	0	1	38	0	0
24	38073688	.	G	A	25	15	40	0	4	44	0	0
24	38073712	.	C	T	17	25	42	0	3	45	0	0
24	38073793	.	G	A	18	16	34	0	1	35	0	0
24	38166248	.	T	C	1	0	1	0	0	1	0	0
24	38180213	.	G	A	0	1	1	0	3	4	0	0
24	38180221	.	C	A	2	3	5	0	0	5	0	0
24	38187862	.	T	C	3	5	8	0	0	8	0	0
24	38187937	.	T	C	1	4	5	0	0	5	0	0
24	38188084	.	T	C	4	3	7	0	0	7	0	0
24	38188149	.	G	A	0	2	2	0	3	5	0	0
24	38188222	.	A	G	6	2	8	0	0	8	0	0
24	38188229	.	A	G	2	3	5	0	1	6	0	0
24	38188333	.	A	G	6	0	6	0	3	9	0	0
24	38188361	.	G	A	5	4	9	0	2	11	0	0
24	38188388	.	C	A	3	2	5	0	1	6	0	0
24	38189475	.	G	C	2	2	4	0	0	4	0	0
24	38189988	.	T	C	2	3	5	0	0	5	0	0
24	38190160	.	T	A	3	2	5	1	0	6	0	0
24	38190768	.	G	A	2	3	5	0	0	5	0	0
24	38190789	.	C	T	4	5	9	0	0	9	0	0
24	38190933	.	G	A	0	2	2	0	2	4	0	0
24	38190985	.	G	T	1	2	3	0	1	4	0	0
24	38191841	.	C	T	5	7	12	0	0	12	0	0
24	38191900	.	A	G	2	3	5	0	0	5	0	0
24	38369559	.	T	A	19	16	35	0	2	37	0	0
24	38369819	.	A	G	21	20	41	0	1	42	0	0
24	38369873	.	G	A	18	26	44	0	1	45	0	0
24	38370188	.	A	G	17	12	29	0	0	29	0	0
24	38370325	.	A	G	14	16	30	0	0	30	0	0
24	38370404	.	T	A	13	15	28	0	0	28	0	0
24	38370518	.	C	T	15	16	31	0	3	34	0	0
24	38370796	.	T	G	5	6	11	0	0	11	0	0
24	38370998	.	A	G	10	21	31	0	1	32	0	0
24	38371178	.	A	G	13	9	22	0	1	23	0	0
24	38374684	.	G	A	9	7	16	0	0	16	0	0
24	38384245	.	A	T	10	9	19	0	0	19	0	0
24	38618802	.	G	A	1	2	3	0	0	3	0	0
24	38619830	.	T	C	0	2	2	0	0	2	0	0
24	38816010	.	G	T	7	4	11	0	0	12	1	0
24	38816184	.	T	G	5	2	7	0	0	7	0	0
24	38816340	.	T	G	6	11	17	0	0	17	0	0
24	39051042	.	T	C	10	5	15	0	0	15	0	0
24	39051114	.	A	G	7	0	7	0	4	11	0	0
24	39051692	.	G	C	6	5	11	0	3	14	0	0
24	39051981	.	G	A	1	5	6	0	5	11	0	0
24	39052117	.	T	C	6	3	9	0	1	10	0	0
24	39052125	.	A	G	7	5	12	0	1	13	0	0
24	39052200	.	C	T	6	4	10	0	0	10	0	0
24	39052302	.	G	A	13	5	18	0	0	18	0	0
24	39052386	.	A	G	4	1	5	0	0	5	0	0
24	39064643	.	T	C	1	2	3	0	0	3	0	0
24	39064719	.	T	C	3	4	7	0	0	7	0	0
24	39075534	.	T	C	7	4	11	0	0	11	0	0
24	39136940	.	A	C	1	0	1	0	0	1	0	0
24	39137015	.	C	T	8	3	11	0	0	11	0	0
24	39137165	.	A	G	5	8	13	0	0	13	0	0
24	39147852	.	A	G	8	10	18	0	1	19	0	0
24	39147871	.	A	G	4	0	4	0	11	15	0	0
24	39150853	.	C	G	6	0	6	0	7	13	0	0
24	39150946	.	T	C	6	5	11	0	0	11	0	0
24	39150975	.	G	T	4	5	9	0	1	10	0	0
24	39151004	.	A	T	8	11	19	0	1	20	0	0
24	39151225	.	G	T	2	0	2	0	0	2	0	0
24	39151235	.	G	A	4	1	5	0	0	5	0	0
24	39151301	.	A	C	8	4	12	0	0	12	0	0
24	39151343	.	G	A	8	9	17	0	0	17	0	0
24	39151467	.	T	C	6	7	13	0	1	14	0	0
24	39151637	.	G	C	14	5	19	0	0	19	0	0
24	39151725	.	C	T	13	10	23	0	1	24	0	0
24	39151727	.	T	C	13	10	23	0	1	24	0	0
24	39151796	.	A	G	3	4	7	0	1	8	0	0
24	39152001	.	A	G	12	6	18	0	1	19	0	0
24	39152077	.	C	G	2	8	10	0	0	10	0	0
24	39152603	.	A	T	7	4	11	0	2	13	0	0
24	39152612	.	C	A	8	4	12	0	1	13	0	0
24	39152651	.	G	A	8	3	11	0	0	11	0	0
24	39152658	.	C	T	7	2	9	0	1	10	0	0
24	39152794	.	A	G	4	2	6	0	0	6	0	0
24	39152798	.	A	G	4	2	6	0	0	6	0	0
24	39152917	.	G	A	5	4	9	0	0	9	0	0
24	39153817	.	G	A	10	4	14	0	0	14	0	0
24	39153857	.	G	T	8	6	14	0	1	15	0	0
24	39153890	.	A	G	9	5	14	0	0	14	0	0
24	39153911	.	G	T	8	2	10	0	1	11	0	0
24	39153952	.	A	G	5	0	5	0	6	11	0	0
24	39153995	.	A	G	12	9	21	0	0	21	0	0
24	39154001	.	C	T	12	9	21	0	1	22	0	0
24	39154044	.	G	A	17	11	28	0	0	28	0	0
24	39154315	.	C	T	16	18	34	0	0	34	0	0
24	39154551	.	C	A	10	13	23	0	1	24	0	0
24	39154620	.	C	T	12	9	21	0	0	21	0	0
24	39154865	.	C	A	7	3	10	0	1	11	0	0
24	39172141	.	T	C	26	33	59	0	2	61	0	0
24	39172222	.	A	G	14	18	32	0	1	33	0	0
24	39174437	.	T	C	3	5	8	0	0	8	0	0
24	39174570	.	C	T	37	32	69	0	4	73	0	0
24	39175002	.	A	C	18	17	35	0	7	42	0	0
24	39175044	.	A	G	13	35	48	0	0	48	0	0
24	39175047	.	T	C	13	34	47	0	1	48	0	0
24	39175083	.	C	G	23	24	47	0	0	47	0	0
24	39175109	.	T	A	31	15	46	1	3	50	0	0
24	39175143	.	C	T	30	24	54	1	3	58	0	0
24	39175207	.	A	G	23	2	25	0	42	67	0	0
24	39178484	.	C	G	3	3	6	0	1	7	0	0
24	39178516	.	T	G	4	6	10	0	0	10	0	0
24	39178591	.	C	A	0	4	4	0	9	13	0	0
24	39178627	.	C	A	0	1	1	0	4	5	0	0
24	39182404	.	G	A	4	4	8	0	1	9	0	0
24	39184715	.	T	C	1	2	3	0	0	3	0	0
24	39215387	.	A	G	4	2	6	0	0	6	0	0
24	39215423	.	A	G	2	1	3	0	5	8	0	0
24	39216253	.	T	A	0	1	1	0	0	1	0	0
24	39268891	.	A	G	8	10	18	0	1	19	0	0
24	39274786	.	C	A	8	7	15	0	1	16	0	0
24	39274821	.	A	G	3	4	7	0	0	7	0	0
24	39277575	.	C	G	9	6	15	0	0	15	0	0
24	39277581	.	T	A	8	7	15	0	2	17	0	0
24	39309684	.	A	G	8	0	8	0	12	20	0	0
24	39309698	.	T	G	9	0	9	0	10	20	1	0
24	39310061	.	A	G	9	12	21	0	2	23	0	0
24	39310129	.	G	A	14	6	20	0	1	21	0	0
24	39310163	.	G	T	6	13	19	0	0	19	0	0
24	39322945	.	G	T	0	6	6	0	12	18	0	0
24	39323791	.	C	T	8	9	17	0	0	17	0	0
24	39333916	.	C	T	7	3	10	0	0	10	0	0
24	39333972	.	A	C	23	17	40	0	1	41	0	0
24	39334054	.	A	G	19	20	39	0	0	39	0	0
24	39334187	.	G	A	1	12	13	0	19	32	0	0
24	39334388	.	A	G	15	29	44	0	2	46	0	0
24	39334400	.	G	A	1	18	19	0	29	48	0	0
24	39510668	.	T	A	1	3	4	0	0	4	0	0
24	39510694	.	G	T	1	3	4	0	0	4	0	0
24	39510891	.	T	C	5	5	10	0	0	10	0	0
24	39510981	.	A	G	4	7	11	0	0	11	0	0
24	39511016	.	T	C	9	6	15	0	0	15	0	0
24	39511034	.	G	A	12	4	16	0	0	16	0	0
24	39511157	.	G	A	4	8	12	0	1	13	0	0
24	39514296	.	C	G	6	5	11	0	1	12	0	0
24	39518841	.	T	C	5	5	10	0	0	10	0	0
24	39530034	.	G	A	0	6	6	0	7	13	0	0
24	39533836	.	C	T	5	3	8	0	0	8	0	0
24	39533987	.	T	A	10	8	18	0	1	19	0	0
24	39534283	.	A	G	1	0	1	0	5	6	0	0
24	39534301	.	A	G	1	5	6	0	0	6	0	0
24	39534532	.	A	G	2	1	3	0	7	10	0	0
24	39544398	.	G	A	1	2	3	0	0	3	0	0
24	39549379	.	C	T	3	3	6	0	0	6	0	0
24	39556276	.	G	T	0	3	3	0	4	7	0	0
24	39556324	.	G	A	0	1	1	0	0	1	0	0
24	39559205	.	T	C	2	1	3	0	0	3	0	0
24	39559356	.	C	T	3	0	3	0	0	3	0	0
24	39559386	.	G	A	0	1	1	0	0	1	0	0
24	39576071	.	A	T	1	8	9	0	0	9	0	0
24	39576247	.	C	T	1	4	5	0	0	5	0	0
24	39576414	.	C	T	3	3	6	0	1	7	0	0
24	39579569	.	G	A	3	3	6	0	0	6	0	0
24	39579730	.	A	G	3	4	7	0	0	7	0	0
24	39579989	.	G	A	0	7	7	0	6	13	0	0
24	39586778	.	A	T	1	8	9	0	0	9	0	0
24	39587369	.	C	G	1	1	2	0	0	2	0	0
24	39593009	.	T	C	0	1	1	0	0	1	0	0
24	39593038	.	G	A	0	2	2	0	1	3	0	0
24	39595866	.	A	C	2	1	3	0	0	3	0	0
24	39606237	.	G	A	26	20	46	0	2	48	0	0
24	39610535	.	G	T	13	17	30	0	0	30	0	0
24	39614901	.	G	A	3	2	5	0	0	5	0	0
24	39614915	.	A	G	2	3	5	0	0	5	0	0
24	39616170	.	C	A	4	4	8	0	1	9	0	0
24	39625539	.	T	C	0	2	2	0	0	2	0	0
24	39632991	.	G	T	1	4	5	0	0	5	0	0
24	39633018	.	C	T	1	5	6	0	0	6	0	0
24	39638642	.	G	A	24	19	43	0	0	43	0	0
24	39642072	.	A	T	5	9	14	0	0	14	0	0
24	39642220	.	A	G	7	5	12	0	0	12	0	0
24	39642229	.	A	G	5	6	11	0	0	11	0	0
24	39642336	.	C	A	7	7	14	0	0	14	0	0
24	39642361	.	G	T	8	11	19	0	1	20	0	0
24	39644259	.	T	C	8	6	14	0	1	15	0	0
24	39646762	.	C	T	8	11	19	0	0	19	0	0
24	39647021	.	C	T	4	4	8	0	0	8	0	0
24	39647042	.	G	C	10	10	20	0	1	21	0	0
24	39648806	.	C	T	13	8	21	0	0	21	0	0
24	39651567	.	T	G	19	20	39	0	1	40	0	0
24	39651612	.	A	T	11	10	21	0	2	23	0	0
24	39653626	.	G	A	16	12	28	7	2	37	0	0
24	39660219	.	C	T	3	2	5	0	0	5	0	0
24	39661890	.	T	A	0	2	2	0	0	2	0	0
24	39661905	.	C	T	2	4	6	0	0	6	0	0
24	39662074	.	T	C	5	4	9	0	1	10	0	0
24	39663197	.	A	G	3	6	9	0	0	9	0	0
24	39667348	.	T	C	12	3	15	0	0	15	0	0
24	39742273	.	G	A	2	6	8	0	1	9	0	0
24	39742336	.	G	A	3	2	5	0	1	6	0	0
24	39742396	.	G	A	3	8	11	0	0	11	0	0
24	39742786	.	T	A	6	6	12	0	0	12	0	0
24	39742869	.	G	T	5	2	7	0	0	7	0	0
24	39771659	.	G	T	4	4	8	0	0	8	0	0
24	39771864	.	T	C	1	2	3	0	0	3	0	0
24	39771976	.	G	A	4	4	8	0	0	8	0	0
24	39771983	.	A	G	6	5	11	0	0	11	0	0
24	39778970	.	C	T	6	2	8	0	0	8	0	0
24	39778982	.	C	G	5	3	8	0	0	8	0	0
24	39779020	.	C	T	2	3	5	0	0	5	0	0
24	39779637	.	A	G	0	2	2	0	0	2	0	0
24	40001569	.	T	C	3	2	5	0	0	5	0	0
24	40001698	.	C	T	6	4	10	0	1	11	0	0
24	40001802	.	C	T	0	2	2	0	3	5	0	0
24	40004797	.	G	C	1	0	1	0	5	6	0	0
24	40004806	.	G	A	1	4	5	0	0	5	0	0
24	40004839	.	A	G	0	3	3	0	0	3	0	0
24	40006413	.	G	A	2	2	4	0	0	4	0	0
24	40006419	.	C	T	0	2	2	0	2	4	0	0
24	40156272	.	C	A	1	3	4	0	0	4	0	0
24	40156345	.	T	G	1	0	1	0	1	2	0	0
24	40156350	.	A	G	1	0	1	0	0	1	0	0
24	40167076	.	C	T	0	3	3	0	0	3	0	0
24	40171381	.	C	A	5	2	7	0	1	8	0	0
24	40495406	.	G	A	1	2	3	0	0	3	0	0
24	40495415	.	C	T	1	2	3	0	0	3	0	0
24	40495532	.	T	C	1	2	3	0	0	3	0	0
24	41473618	.	G	A	2	0	2	0	0	2	0	0
24	41473627	.	G	A	2	0	2	0	1	3	0	0
25	13978	.	C	T	7	9	16	0	0	16	0	0
25	14101	.	C	T	7	10	17	0	0	17	0	0
25	15467	.	C	T	2	3	5	0	0	5	0	0
25	15524	.	C	T	11	10	21	0	2	23	0	0
25	15542	.	T	C	11	8	19	0	1	20	0	0
25	15764	.	A	G	10	0	10	0	6	16	0	0
25	127683	.	T	G	2	0	2	0	2	4	0	0
25	127734	.	A	G	4	6	10	0	1	11	0	0
25	127786	.	A	G	4	0	4	0	13	17	0	0
25	136857	.	C	T	19	12	31	0	1	32	0	0
25	136986	.	C	T	14	11	25	0	3	28	0	0
25	146198	.	C	T	25	13	38	0	0	39	1	0
25	146237	.	G	A	20	14	34	0	1	35	0	0
25	146282	.	C	T	11	5	16	0	1	17	0	0
25	146778	.	C	T	8	7	15	0	0	15	0	0
25	146918	.	G	A	15	17	32	0	1	33	0	0
25	154392	.	T	C	6	4	10	0	0	10	0	0
25	156608	.	C	T	1	4	5	0	0	5	0	0
25	157023	.	A	G	3	0	3	0	6	9	0	0
25	157151	.	T	C	2	2	4	0	0	4	0	0
25	157389	.	T	C	2	2	4	0	1	5	0	0
25	157404	.	C	A	2	3	5	0	0	5	0	0
25	157996	.	C	A	3	5	8	0	0	8	0	0
25	158770	.	C	T	3	8	11	0	0	11	0	0
25	158958	.	C	T	14	5	19	0	1	20	0	0
25	159543	.	T	C	14	8	22	0	0	22	0	0
25	160490	.	C	T	9	8	17	0	2	19	0	0
25	187121	.	G	A	0	2	2	0	2	4	0	0
25	187241	.	T	G	6	5	11	0	0	11	0	0
25	236835	.	G	A	3	2	5	0	0	5	0	0
25	241694	.	C	T	6	5	11	0	0	11	0	0
25	241695	.	A	G	6	4	10	0	1	11	0	0
25	269108	.	C	G	1	0	1	0	0	1	0	0
25	269134	.	A	C	1	0	1	0	1	2	0	0
25	315157	.	C	T	1	2	3	0	0	3	0	0
25	315364	.	A	G	1	2	3	0	0	3	0	0
25	315373	.	G	T	1	2	3	0	0	3	0	0
25	315584	.	C	T	1	3	4	0	0	4	0	0
25	317065	.	A	G	0	3	3	0	0	3	0	0
25	317066	.	A	T	0	3	3	0	0	3	0	0
25	388320	.	C	A	2	0	2	0	0	2	0	0
25	398433	.	T	C	2	0	2	0	0	2	0	0
25	399735	.	C	T	5	2	7	0	0	7	0	0
25	401810	.	T	C	8	6	14	0	0	14	0	0
25	402053	.	C	T	2	5	7	0	1	8	0	0
25	402152	.	T	C	3	6	9	0	1	10	0	0
25	402224	.	A	T	4	3	7	0	1	8	0	0
25	402348	.	G	A	0	2	2	0	4	6	0	0
25	402359	.	T	G	3	0	3	0	2	5	0	0
25	403935	.	T	G	3	6	9	0	1	10	0	0
25	450354	.	C	T	9	7	16	0	1	17	0	0
25	469932	.	G	T	34	26	60	0	0	60	0	0
25	469983	.	C	T	9	7	16	0	0	16	0	0
25	472843	.	A	T	3	1	4	0	0	4	0	0
25	474766	.	G	C	15	12	27	0	1	28	0	0
25	474938	.	T	A	17	18	35	0	1	36	0	0
25	474981	.	A	C	23	24	47	0	2	49	0	0
25	474983	.	A	C	24	22	46	0	3	49	0	0
25	485418	.	T	A	2	4	6	0	0	6	0	0
25	485437	.	C	T	6	5	11	0	0	11	0	0
25	485653	.	A	G	17	19	36	0	0	36	0	0
25	485772	.	C	A	15	10	25	0	1	26	0	0
25	485802	.	T	C	19	11	30	0	0	30	0	0
25	485863	.	A	T	13	10	23	0	0	23	0	0
25	486276	.	A	T	8	9	17	0	0	17	0	0
25	486284	.	G	A	5	11	16	0	3	19	0	0
25	486363	.	T	G	9	12	21	0	0	21	0	0
25	487045	.	C	T	13	19	32	0	2	34	0	0
25	487360	.	C	T	0	10	10	0	5	15	0	0
25	488701	.	G	C	6	0	6	0	11	17	0	0
25	488817	.	G	T	14	13	27	0	2	29	0	0
25	489557	.	C	G	0	4	4	0	0	4	0	0
25	489904	.	G	T	5	7	12	0	0	12	0	0
25	494685	.	A	G	7	6	13	0	1	14	0	0
25	495366	.	G	A	1	3	4	0	0	4	0	0
25	498814	.	T	C	10	5	15	0	0	15	0	0
25	502593	.	C	G	0	5	5	0	2	7	0	0
25	502608	.	G	A	2	3	5	0	0	5	0	0
25	505214	.	C	T	5	6	11	0	1	12	0	0
25	509625	.	G	A	4	9	13	0	0	13	0	0
25	509899	.	C	T	5	6	11	0	0	11	0	0
25	510468	.	C	T	0	4	4	0	6	11	1	0
25	510645	.	G	A	5	4	9	0	1	10	0	0
25	513362	.	C	T	2	1	3	0	0	3	0	0
25	525220	.	T	C	1	2	3	0	0	3	0	0
25	527694	.	A	G	4	5	9	0	0	9	0	0
25	527721	.	G	A	6	8	14	0	0	14	0	0
25	535003	.	A	T	1	0	1	0	0	1	0	0
25	538788	.	G	A	1	1	2	0	0	2	0	0
25	552548	.	G	A	3	10	13	0	0	13	0	0
25	552677	.	T	G	2	6	8	0	0	8	0	0
25	552743	.	A	C	3	0	3	0	5	8	0	0
25	552761	.	C	T	0	1	1	0	5	6	0	0
25	552779	.	G	A	3	2	5	0	0	5	0	0
25	552872	.	G	A	6	5	11	0	0	11	0	0
25	582432	.	G	T	10	7	17	0	1	18	0	0
25	582437	.	T	C	10	7	17	0	1	18	0	0
25	582484	.	C	A	1	1	2	0	1	3	0	0
25	615178	.	G	A	11	15	26	0	0	26	0	0
25	617774	.	C	T	0	1	1	0	0	1	0	0
25	617859	.	T	C	3	3	6	0	0	6	0	0
25	626817	.	C	T	4	7	11	0	1	12	0	0
25	640440	.	G	A	0	3	3	0	5	8	0	0
25	663178	.	C	T	1	4	5	0	0	5	0	0
25	663214	.	C	T	20	12	32	0	0	32	0	0
25	663284	.	G	A	0	4	4	0	2	6	0	0
25	713131	.	G	C	2	3	5	0	0	5	0	0
25	745909	.	G	C	1	2	3	0	0	3	0	0
25	763197	.	C	T	7	10	17	0	0	17	0	0
25	763774	.	T	C	5	0	5	0	0	5	0	0
25	764745	.	G	A	13	14	27	0	1	28	0	0
25	769484	.	A	G	4	4	8	0	0	8	0	0
25	771140	.	T	G	1	0	1	0	0	1	0	0
25	824750	.	C	T	0	7	7	0	4	11	0	0
25	824774	.	C	T	5	6	11	0	0	11	0	0
25	825323	.	A	G	9	4	13	0	0	13	0	0
25	825335	.	C	G	11	4	15	0	0	15	0	0
25	825656	.	G	A	6	3	9	0	0	9	0	0
25	825695	.	T	C	3	3	6	0	0	6	0	0
25	825704	.	A	C	4	0	4	0	0	4	0	0
25	825746	.	T	C	3	0	3	0	3	6	0	0
25	825902	.	G	T	4	6	10	0	0	10	0	0
25	825968	.	A	C	3	7	10	0	0	10	0	0
25	826405	.	C	A	4	5	9	0	0	9	0	0
25	827036	.	G	A	1	3	4	0	0	4	0	0
25	827408	.	T	C	3	0	3	0	4	7	0	0
25	827459	.	C	A	3	0	3	0	0	3	0	0
25	1049686	.	G	C	6	3	9	0	0	9	0	0
25	1049967	.	G	A	3	3	6	0	0	6	0	0
25	1060999	.	A	G	2	5	7	0	0	7	0	0
25	1091760	.	A	G	9	5	14	0	0	14	0	0
25	1091806	.	G	A	0	2	2	0	0	2	0	0
25	1092442	.	C	A	0	6	6	0	4	10	0	0
25	1093526	.	A	G	5	2	7	0	0	7	0	0
25	1094460	.	T	G	1	5	6	0	0	6	0	0
25	1101431	.	A	G	4	2	6	0	0	6	0	0
25	1101659	.	A	G	4	6	10	0	0	10	0	0
25	1101704	.	C	G	2	4	6	0	0	6	0	0
25	1101707	.	G	A	2	4	6	0	0	6	0	0
25	1102626	.	G	T	0	2	2	0	1	3	0	0
25	1103369	.	G	T	3	4	7	0	1	8	0	0
25	1103486	.	C	T	1	3	4	0	0	4	0	0
25	1103980	.	G	A	4	4	8	0	0	8	0	0
25	1106247	.	C	G	7	7	14	0	0	14	0	0
25	1107992	.	G	A	2	4	6	0	0	6	0	0
25	1108210	.	G	A	1	1	2	0	0	2	0	0
25	1112046	.	G	A	0	2	2	0	0	2	0	0
25	1117241	.	G	A	0	1	1	0	0	1	0	0
25	1124405	.	C	T	0	2	2	0	1	3	0	0
25	1124488	.	C	G	3	3	6	0	0	6	0	0
25	1132496	.	C	G	11	5	16	0	1	17	0	0
25	1132611	.	A	T	10	4	14	0	1	15	0	0
25	1133793	.	G	A	0	5	5	0	13	18	0	0
25	1133797	.	T	G	5	14	19	0	0	19	0	0
25	1220400	.	G	T	1	2	3	0	0	3	0	0
25	1304556	.	G	A	3	3	6	0	1	7	0	0
25	1305338	.	T	G	7	7	14	0	1	15	0	0
25	1335681	.	G	A	1	6	7	0	0	7	0	0
25	1338263	.	C	T	3	4	7	0	0	7	0	0
25	1338272	.	G	T	2	1	3	0	2	5	0	0
25	1338689	.	T	C	2	4	6	0	0	6	0	0
25	1338860	.	T	A	3	4	7	0	1	8	0	0
25	1339403	.	C	T	7	10	17	0	0	17	0	0
25	1339601	.	G	T	0	2	2	0	1	3	0	0
25	1339760	.	C	T	6	4	10	0	1	11	0	0
25	1340215	.	G	A	5	2	7	0	0	7	0	0
25	1558320	.	G	A	0	2	2	0	2	4	0	0
25	1592111	.	G	A	13	17	30	0	1	31	0	0
25	1603727	.	G	A	0	5	5	0	2	7	0	0
25	1603772	.	C	A	2	3	5	0	0	5	0	0
25	1603787	.	G	T	2	1	3	0	0	3	0	0
25	1604543	.	T	G	6	0	6	0	5	11	0	0
25	1608836	.	C	G	3	3	6	0	0	6	0	0
25	1608857	.	C	G	3	8	11	0	0	11	0	0
25	1624547	.	C	A	11	10	21	0	0	21	0	0
25	1624777	.	G	A	14	12	26	0	0	26	0	0
25	1635419	.	G	A	5	8	13	0	0	13	0	0
25	1635714	.	C	G	13	7	20	0	0	20	0	0
25	1635783	.	G	A	13	12	25	0	0	25	0	0
25	1635786	.	C	T	0	9	9	0	15	24	0	0
25	1635879	.	G	A	15	7	22	0	0	22	0	0
25	1639932	.	G	T	4	4	8	0	1	9	0	0
25	1642319	.	C	A	5	16	21	0	1	22	0	0
25	1644857	.	C	T	2	1	3	0	0	3	0	0
25	1652138	.	C	T	0	6	6	0	6	12	0	0
25	1652294	.	G	A	5	8	13	0	1	14	0	0
25	1652450	.	A	G	4	6	10	0	0	10	0	0
25	1652513	.	G	A	7	10	17	0	1	18	0	0
25	1652543	.	C	T	0	6	6	0	6	12	0	0
25	1652591	.	A	G	8	7	15	0	1	16	0	0
25	1652766	.	C	A	2	0	2	0	0	2	0	0
25	1652793	.	C	T	0	3	3	0	2	5	0	0
25	1652916	.	G	A	3	2	5	0	0	5	0	0
25	1654432	.	G	T	5	8	13	0	0	13	0	0
25	1655408	.	G	A	1	2	3	0	0	3	0	0
25	1655502	.	G	A	3	8	11	0	0	11	0	0
25	1655535	.	G	C	1	3	4	0	0	4	0	0
25	1655537	.	G	A	1	3	4	0	0	4	0	0
25	1660233	.	G	A	2	2	4	0	0	4	0	0
25	1660255	.	G	T	2	4	6	0	0	6	0	0
25	1662047	.	G	A	0	1	1	0	0	1	0	0
25	1670422	.	G	T	2	0	2	0	0	2	0	0
25	1670785	.	T	C	2	2	4	0	0	4	0	0
25	1670850	.	C	T	4	2	6	0	0	6	0	0
25	1670878	.	T	C	1	3	4	0	0	4	0	0
25	1672306	.	A	G	1	2	3	0	0	3	0	0
25	1672911	.	C	T	3	1	4	0	1	5	0	0
25	1672920	.	G	T	1	3	4	0	1	5	0	0
25	1681344	.	A	C	3	3	6	0	0	6	0	0
25	2264091	.	C	A	4	4	8	0	0	8	0	0
25	2264112	.	T	C	4	9	13	0	0	13	0	0
25	2264875	.	C	A	1	3	4	0	0	4	0	0
25	2264953	.	A	G	1	4	5	0	0	5	0	0
25	2273945	.	C	T	0	1	1	0	0	1	0	0
25	2276828	.	T	A	3	3	6	0	0	6	0	0
25	2276869	.	C	T	2	2	4	0	0	4	0	0
25	2282566	.	A	G	9	1	10	0	10	20	0	0
25	2282846	.	A	C	10	13	23	0	2	25	0	0
25	2286066	.	C	T	8	7	15	0	1	16	0	0
25	2286120	.	G	A	10	8	18	0	2	20	0	0
25	2286376	.	T	C	2	3	5	0	1	6	0	0
25	2286502	.	T	C	7	9	16	0	0	16	0	0
25	2286600	.	A	T	8	17	25	0	2	27	0	0
25	2286762	.	A	C	9	9	18	0	1	19	0	0
25	2286798	.	A	C	18	8	26	0	3	29	0	0
25	2286837	.	C	T	17	11	28	0	1	29	0	0
25	2286841	.	C	A	16	12	28	0	0	29	1	0
25	2707178	.	T	C	0	2	2	0	0	2	0	0
25	3245895	.	A	G	9	6	15	0	0	15	0	0
25	3246593	.	A	G	7	5	12	0	1	13	0	0
25	3451196	.	T	A	5	8	13	0	2	15	0	0
25	3451250	.	A	C	13	8	21	0	0	21	0	0
25	3451760	.	A	C	5	7	12	0	0	12	0	0
25	3451779	.	A	G	5	2	7	0	0	7	0	0
25	3453651	.	G	A	0	1	1	0	0	1	0	0
25	3454644	.	G	A	11	9	20	0	0	20	0	0
25	3454719	.	G	A	7	9	16	0	0	16	0	0
25	3457756	.	G	A	4	7	11	0	0	11	0	0
25	3461097	.	C	G	0	0	0	0	1	1	0	0
25	3465854	.	G	A	3	1	4	0	1	5	0	0
25	3465905	.	C	G	0	4	4	0	12	16	0	0
25	3465911	.	A	G	4	11	15	0	0	15	0	0
25	3469502	.	G	A	6	5	11	0	0	11	0	0
25	3478467	.	G	T	1	0	1	0	0	1	0	0
25	3478617	.	C	T	2	2	4	0	0	4	0	0
25	3481088	.	G	T	8	5	13	0	0	13	0	0
25	3483727	.	G	A	3	2	5	0	1	6	0	0
25	3513274	.	G	A	2	1	3	0	0	3	0	0
25	3529701	.	G	A	0	4	4	0	4	8	0	0
25	3529758	.	C	T	5	4	9	0	0	9	0	0
25	3529806	.	A	G	4	4	8	0	2	10	0	0
25	3536269	.	G	A	6	3	9	0	0	9	0	0
25	3536279	.	G	T	6	3	9	0	0	9	0	0
25	3536470	.	G	T	2	2	4	0	0	4	0	0
25	3536512	.	A	T	3	4	7	0	0	7	0	0
25	3539530	.	C	T	0	2	2	0	2	4	0	0
25	3541928	.	C	T	1	2	3	0	0	3	0	0
25	3546464	.	G	A	4	0	4	0	0	4	0	0
25	3546602	.	C	A	4	1	5	0	1	6	0	0
25	3557470	.	G	A	0	3	3	0	5	8	0	0
25	3573350	.	G	A	2	6	8	0	0	8	0	0
25	3573447	.	T	C	1	0	1	0	4	5	0	0
25	3573624	.	G	C	4	7	11	0	0	12	1	0
25	3573635	.	A	T	4	9	13	0	1	14	0	0
25	3573796	.	C	A	0	13	13	0	6	20	1	0
25	3573815	.	G	A	6	11	17	0	0	17	0	0
25	3579429	.	A	C	5	11	16	0	0	16	0	0
25	3579459	.	C	A	5	12	17	0	0	17	0	0
25	3582443	.	A	G	3	10	13	0	0	13	0	0
25	3583975	.	C	T	3	3	6	0	1	7	0	0
25	3583983	.	G	T	3	4	7	0	0	7	0	0
25	3584053	.	G	A	2	14	16	0	0	16	0	0
25	3584156	.	T	C	4	0	4	0	4	8	0	0
25	3584803	.	C	T	0	5	5	0	2	7	0	0
25	3595118	.	G	A	2	2	4	0	0	4	0	0
25	3595120	.	C	T	0	2	2	0	2	4	0	0
25	3596319	.	C	T	2	3	5	0	0	5	0	0
25	3596361	.	T	G	1	6	7	0	0	7	0	0
25	3606940	.	G	A	1	3	4	0	0	4	0	0
25	3606970	.	C	T	3	4	7	0	0	7	0	0
25	3623403	.	T	C	0	1	1	0	0	1	0	0
25	3623573	.	T	G	0	1	1	0	0	1	0	0
25	3623872	.	G	C	1	3	4	0	0	4	0	0
25	3641160	.	G	A	3	5	8	0	0	8	0	0
25	3664880	.	C	A	2	2	4	0	0	4	0	0
25	3667035	.	C	T	2	2	4	0	0	4	0	0
25	3677703	.	G	A	1	0	1	0	1	2	0	0
25	3682253	.	C	T	17	24	41	0	1	42	0	0
25	3682610	.	G	A	0	12	12	0	15	27	0	0
25	3682789	.	G	A	25	22	47	0	0	47	0	0
25	3682795	.	A	C	24	26	50	0	1	51	0	0
25	3683247	.	G	A	23	23	46	0	2	48	0	0
25	3683297	.	C	T	21	31	52	0	5	57	0	0
25	3683386	.	C	T	29	28	57	0	2	59	0	0
25	3683527	.	G	A	3	17	20	0	18	38	0	0
25	3683796	.	A	T	12	5	17	0	0	17	0	0
25	3683887	.	C	T	20	12	32	0	2	34	0	0
25	3684141	.	C	A	29	31	60	0	0	60	0	0
25	3684148	.	A	G	30	27	57	0	0	57	0	0
25	3684195	.	G	A	1	9	10	1	14	25	0	0
25	3684409	.	G	T	3	10	13	2	38	53	0	0
25	3684741	.	A	G	17	26	43	0	2	45	0	0
25	3708287	.	G	A	2	2	4	0	0	4	0	0
25	3708429	.	G	T	3	2	5	0	1	7	1	0
25	3713652	.	T	C	6	0	6	0	14	20	0	0
25	3713724	.	T	C	1	0	1	0	0	1	0	0
25	3719768	.	T	C	2	8	10	0	3	13	0	0
25	3719888	.	G	T	7	8	15	0	1	16	0	0
25	3721726	.	G	C	2	0	2	0	4	6	0	0
25	3724275	.	T	C	2	0	2	0	1	3	0	0
25	3725000	.	G	A	3	2	5	0	1	6	0	0
25	3750509	.	T	A	3	5	8	0	0	8	0	0
25	3750545	.	A	T	6	9	15	0	1	16	0	0
25	3750559	.	T	C	9	12	21	0	2	23	0	0
25	3750655	.	C	T	10	11	21	0	0	22	1	0
25	3754606	.	G	A	2	7	9	0	1	10	0	0
25	3755271	.	G	A	17	9	26	0	0	26	0	0
25	3755303	.	A	G	9	7	16	0	0	16	0	0
25	3757584	.	G	A	2	7	9	0	1	10	0	0
25	3757606	.	G	A	7	11	18	0	0	18	0	0
25	3757670	.	C	T	6	6	12	0	0	12	0	0
25	3758022	.	T	C	1	3	4	0	0	4	0	0
25	3772126	.	G	A	0	0	0	0	1	1	0	0
25	3774637	.	A	C	2	0	2	0	0	2	0	0
25	3774681	.	G	A	3	4	7	0	0	7	0	0
25	3774705	.	A	T	2	4	6	0	0	6	0	0
25	3777625	.	T	G	1	1	2	0	0	2	0	0
25	3777774	.	A	G	0	0	0	0	1	1	0	0
25	3777795	.	G	C	0	1	1	0	0	1	0	0
25	3779091	.	T	C	2	1	3	0	0	3	0	0
25	3782576	.	T	C	1	3	4	0	0	4	0	0
25	3784679	.	C	T	0	3	3	0	0	3	0	0
25	3788564	.	T	C	5	0	5	0	0	5	0	0
25	3789004	.	G	A	0	7	7	0	9	16	0	0
25	3790279	.	G	A	0	11	11	0	11	22	0	0
25	3792945	.	A	G	7	1	8	0	0	8	0	0
25	3793096	.	T	C	9	5	14	0	1	15	0	0
25	3793141	.	T	A	5	3	8	0	1	9	0	0
25	3794786	.	A	G	2	0	2	0	3	5	0	0
25	3794975	.	A	G	0	0	0	0	3	3	0	0
25	3801505	.	T	G	3	2	5	0	1	6	0	0
25	3801612	.	T	C	3	0	3	0	3	6	0	0
25	3801726	.	A	G	17	9	26	0	2	28	0	0
25	3801737	.	T	C	18	15	33	0	0	33	0	0
25	3804410	.	A	G	8	4	12	0	1	13	0	0
25	3807526	.	C	T	0	5	5	0	4	9	0	0
25	3808572	.	T	A	9	11	20	0	3	23	0	0
25	3810105	.	T	A	1	4	5	0	0	5	0	0
25	3810107	.	T	A	1	4	5	0	0	5	0	0
25	3887287	.	C	T	0	2	2	0	4	6	0	0
25	3891940	.	A	T	16	16	32	0	1	33	0	0
25	3897988	.	G	A	15	5	20	0	0	20	0	0
25	3898013	.	A	G	8	5	13	0	4	17	0	0
25	3898332	.	A	G	12	9	21	0	0	21	0	0
25	3898449	.	T	C	6	0	6	0	9	15	0	0
25	3898483	.	C	T	7	11	18	0	1	19	0	0
25	3898566	.	G	T	11	12	23	0	0	23	0	0
25	3898572	.	C	A	0	10	10	0	12	22	0	0
25	3898608	.	G	A	6	2	8	0	1	9	0	0
25	3899039	.	A	C	5	13	18	0	1	19	0	0
25	3899169	.	C	T	16	14	30	0	2	32	0	0
25	3906840	.	A	C	6	0	6	0	12	18	0	0
25	3907063	.	A	G	1	1	2	0	0	2	0	0
25	3910957	.	A	G	1	0	1	0	0	1	0	0
25	3913568	.	G	A	4	4	8	0	0	8	0	0
25	3915284	.	C	A	0	2	2	0	1	3	0	0
25	4112013	.	C	T	1	0	1	0	1	2	0	0
25	4113930	.	T	C	2	1	3	0	0	3	0	0
25	4117899	.	C	T	1	4	5	0	1	6	0	0
25	4126771	.	G	A	4	2	6	0	0	6	0	0
25	4129075	.	G	T	3	3	6	0	0	6	0	0
25	4129093	.	T	A	4	4	8	0	0	8	0	0
25	4129165	.	C	A	8	2	10	0	0	10	0	0
25	4133498	.	T	C	19	16	35	0	1	36	0	0
25	4133647	.	C	A	22	15	37	0	1	38	0	0
25	4133648	.	T	C	22	0	22	0	16	38	0	0
25	4133708	.	T	G	30	10	40	0	0	40	0	0
25	4133720	.	C	A	24	10	34	0	2	36	0	0
25	4136001	.	C	A	9	5	14	0	1	15	0	0
25	4136292	.	A	G	6	10	16	0	0	16	0	0
25	4141629	.	G	A	3	3	6	0	0	6	0	0
25	4143837	.	T	C	4	0	4	0	7	11	0	0
25	4313658	.	C	T	0	3	3	0	0	3	0	0
25	4460165	.	T	C	5	3	8	0	0	8	0	0
25	4460441	.	G	A	18	6	24	0	0	24	0	0
25	4465382	.	T	C	13	0	13	0	6	19	0	0
25	4475705	.	A	G	1	2	3	0	0	3	0	0
25	4479613	.	G	C	7	3	10	0	0	10	0	0
25	4581599	.	T	C	1	4	5	0	0	5	0	0
25	4677100	.	A	C	3	1	4	0	0	4	0	0
25	4689362	.	A	G	3	4	7	0	0	7	0	0
25	4689990	.	T	G	0	2	2	0	1	3	0	0
25	4708201	.	T	G	2	5	7	0	0	7	0	0
25	4717246	.	C	T	0	3	3	0	2	5	0	0
25	4733021	.	A	G	3	4	7	0	0	7	0	0
25	4837937	.	G	C	6	11	17	0	0	17	0	0
25	4838118	.	A	G	2	1	3	0	0	3	0	0
25	4841406	.	T	C	2	4	6	0	0	6	0	0
25	4843398	.	A	G	12	5	17	0	0	17	0	0
25	4848808	.	C	T	5	1	6	0	0	6	0	0
25	4849326	.	A	G	6	0	6	0	11	17	0	0
25	4849422	.	T	A	16	11	27	0	0	27	0	0
25	4849453	.	C	T	4	4	8	0	0	8	0	0
25	4850969	.	C	G	6	0	6	0	9	15	0	0
25	4850989	.	G	A	12	13	25	0	0	25	0	0
25	4855790	.	A	G	2	1	3	0	0	3	0	0
25	4867832	.	C	T	2	2	4	0	0	4	0	0
25	4867859	.	T	A	1	1	2	0	0	2	0	0
25	4873878	.	C	A	1	2	3	0	0	3	0	0
25	4873904	.	G	A	1	1	2	0	0	2	0	0
25	4874057	.	C	A	1	2	3	0	0	3	0	0
25	4876366	.	A	G	0	0	0	0	4	4	0	0
25	4877685	.	A	G	0	2	2	0	0	2	0	0
25	4877781	.	C	A	3	5	8	0	0	8	0	0
25	4879937	.	T	A	5	3	8	0	0	8	0	0
25	4879964	.	C	T	6	5	11	0	0	11	0	0
25	4879973	.	A	C	6	5	11	0	0	11	0	0
25	4880030	.	G	A	6	3	9	0	0	9	0	0
25	4880138	.	A	C	1	3	4	0	1	5	0	0
25	4880144	.	A	G	3	0	3	0	3	6	0	0
25	4880363	.	C	T	7	2	9	0	0	9	0	0
25	4880372	.	T	A	6	2	8	0	0	8	0	0
25	4883338	.	A	G	3	0	3	0	4	7	0	0
25	4891272	.	G	A	35	25	60	0	4	64	0	0
25	4891286	.	A	T	32	27	59	0	6	65	0	0
25	4891350	.	C	T	21	39	60	0	2	62	0	0
25	4891538	.	A	G	17	33	50	0	2	52	0	0
25	4891597	.	G	A	19	38	57	0	0	57	0	0
25	4891762	.	C	G	22	25	47	0	1	48	0	0
25	4891867	.	T	C	12	1	13	0	13	26	0	0
25	4891882	.	C	T	12	9	21	0	1	22	0	0
25	4892172	.	G	T	29	25	54	0	0	54	0	0
25	4892203	.	T	A	19	34	53	0	1	54	0	0
25	4892291	.	T	C	16	37	53	0	0	53	0	0
25	4892537	.	A	G	27	32	59	0	0	59	0	0
25	4892830	.	C	T	19	29	48	0	1	49	0	0
25	4892982	.	T	C	2	18	20	0	0	20	0	0
25	4892985	.	T	C	2	17	19	0	0	19	0	0
25	4893024	.	A	C	2	12	14	0	0	14	0	0
25	4893049	.	T	C	2	8	10	0	1	11	0	0
25	4893059	.	G	A	3	6	9	0	0	9	0	0
25	4893176	.	C	T	0	12	12	0	5	17	0	0
25	4893193	.	A	C	7	15	22	0	0	22	0	0
25	4893214	.	T	G	9	23	32	0	1	33	0	0
25	4893238	.	A	G	7	25	32	0	2	34	0	0
25	4893304	.	G	T	7	46	53	0	0	54	1	0
25	4893398	.	T	C	16	38	54	0	3	57	0	0
25	4893435	.	C	T	19	35	54	0	4	58	0	0
25	4896182	.	A	G	13	28	41	0	0	41	0	0
25	4896281	.	A	C	7	0	7	0	4	11	0	0
25	4896290	.	A	G	4	3	7	0	0	7	0	0
25	4897187	.	T	A	7	9	16	0	0	16	0	0
25	4899071	.	G	A	10	25	35	0	0	35	0	0
25	4902538	.	A	T	10	13	23	0	0	23	0	0
25	4902586	.	T	C	14	0	14	0	23	37	0	0
25	4904387	.	A	G	1	1	2	0	0	2	0	0
25	5015230	.	C	T	1	0	1	0	0	1	0	0
25	5018352	.	C	T	1	3	4	0	0	4	0	0
25	5025212	.	T	A	2	2	4	0	0	4	0	0
25	5189445	.	T	C	1	0	1	0	3	4	0	0
25	5605252	.	A	G	5	0	5	0	3	8	0	0
25	5605309	.	T	C	1	2	3	0	0	3	0	0
25	5605314	.	T	A	0	2	2	0	0	2	0	0
25	5636188	.	C	T	2	2	4	0	0	4	0	0
25	5644985	.	C	G	5	3	8	0	0	8	0	0
25	5652409	.	G	A	1	6	7	0	0	7	0	0
25	5654679	.	G	T	0	2	2	0	2	5	1	0
25	5654724	.	A	C	1	2	3	0	0	3	0	0
25	5666904	.	C	T	1	3	4	0	0	4	0	0
25	5666925	.	A	G	1	2	3	0	1	4	0	0
25	5702160	.	G	T	4	8	12	0	1	13	0	0
25	5709328	.	T	G	3	3	6	0	0	7	1	0
25	5710949	.	C	G	10	9	19	0	0	19	0	0
25	5713704	.	G	C	1	2	3	0	7	10	0	0
25	5722072	.	A	G	1	2	3	0	0	3	0	0
25	5724887	.	C	T	0	11	11	0	5	16	0	0
25	5730936	.	A	T	4	4	8	0	0	8	0	0
25	5733681	.	G	A	4	2	6	0	0	6	0	0
25	5733684	.	G	A	5	2	7	0	0	7	0	0
25	5734392	.	C	T	0	1	1	0	4	5	0	0
25	5736673	.	C	T	0	0	0	0	2	2	0	0
25	5770764	.	C	T	2	0	2	0	0	2	0	0
25	5774925	.	C	T	0	1	1	0	0	1	0	0
25	5774984	.	C	G	0	3	3	0	0	3	0	0
25	5774990	.	T	A	0	3	3	0	0	3	0	0
25	5775124	.	C	T	3	3	6	0	0	6	0	0
25	5775139	.	T	A	4	2	6	0	1	7	0	0
25	5775423	.	G	A	1	2	3	0	3	6	0	0
25	5775497	.	T	C	1	9	10	0	1	11	0	0
25	5775498	.	C	T	1	9	10	0	1	11	0	0
25	5775536	.	T	A	4	11	15	0	0	15	0	0
25	5775552	.	C	T	4	6	10	0	1	11	0	0
25	5775605	.	G	C	2	3	5	0	0	5	0	0
25	5775638	.	G	C	1	5	6	0	1	7	0	0
25	5775697	.	G	A	5	4	9	0	0	9	0	0
25	5776138	.	G	A	0	7	7	0	7	14	0	0
25	5776920	.	T	A	3	7	10	0	1	11	0	0
25	5776966	.	G	C	1	5	6	0	1	7	0	0
25	5777032	.	T	A	6	2	8	0	1	9	0	0
25	5777674	.	G	A	4	4	8	0	1	9	0	0
25	5778797	.	C	T	0	1	1	0	0	1	0	0
25	5778842	.	C	G	1	4	5	0	0	5	0	0
25	5778851	.	T	C	1	4	5	0	0	5	0	0
25	5779557	.	G	A	3	5	8	0	0	8	0	0
25	5780633	.	T	C	1	3	4	0	0	4	0	0
25	5783309	.	T	C	2	0	2	0	0	2	0	0
25	5783523	.	C	T	7	11	18	0	0	18	0	0
25	5783598	.	T	A	6	7	13	0	0	13	0	0
25	5786668	.	T	C	5	5	10	0	0	10	0	0
25	5787684	.	C	T	11	15	26	0	1	27	0	0
25	5787966	.	C	A	9	6	15	0	2	17	0	0
25	5788310	.	T	C	9	3	12	0	0	12	0	0
25	5788321	.	C	T	11	3	14	0	0	14	0	0
25	5788384	.	C	T	11	6	17	0	0	17	0	0
25	5788432	.	A	G	8	9	17	0	0	17	0	0
25	5788519	.	G	T	12	7	19	0	0	19	0	0
25	5788670	.	C	T	0	16	16	0	12	28	0	0
25	5788783	.	G	C	12	10	22	0	1	24	1	0
25	5788838	.	A	G	11	10	21	0	0	21	0	0
25	5788842	.	C	T	0	10	10	0	10	20	0	0
25	5788968	.	C	T	0	3	3	0	8	11	0	0
25	5789625	.	T	A	5	3	8	0	0	8	0	0
25	5789626	.	T	C	5	0	5	0	3	8	0	0
25	5789660	.	A	T	6	1	7	0	0	7	0	0
25	5789721	.	G	A	6	6	12	0	1	13	0	0
25	5789734	.	G	C	5	5	10	0	0	10	0	0
25	5789937	.	A	C	8	6	14	0	0	14	0	0
25	5790050	.	T	G	9	7	16	0	0	16	0	0
25	5790341	.	C	G	6	10	16	0	1	17	0	0
25	5790414	.	A	T	5	6	11	0	1	12	0	0
25	5790500	.	T	C	3	3	6	0	0	6	0	0
25	5790742	.	G	A	5	7	12	0	0	12	0	0
25	5796606	.	A	G	9	6	15	0	0	15	0	0
25	5796675	.	A	C	1	0	1	0	1	2	0	0
25	5803529	.	A	G	12	8	20	0	0	20	0	0
25	5805328	.	G	A	3	7	10	0	2	12	0	0
25	5805346	.	G	T	6	9	15	0	0	15	0	0
25	5805382	.	G	A	3	5	8	0	0	8	0	0
25	5815822	.	G	A	5	3	8	0	0	8	0	0
25	5835564	.	T	C	5	2	7	0	0	7	0	0
25	5936080	.	C	T	8	6	14	0	0	14	0	0
25	5936556	.	A	T	7	12	19	0	0	19	0	0
25	5936725	.	T	A	8	16	24	0	0	24	0	0
25	5936764	.	C	A	6	15	21	0	1	22	0	0
25	5936886	.	C	T	0	7	7	0	4	11	0	0
25	5937012	.	C	T	6	6	12	0	0	12	0	0
25	5937424	.	T	G	7	7	14	0	2	16	0	0
25	5937516	.	C	T	0	14	14	0	15	29	0	0
25	5937686	.	G	C	20	0	20	0	18	38	0	0
25	5938065	.	A	T	9	6	15	0	1	16	0	0
25	5938694	.	G	A	3	6	9	0	0	9	0	0
25	5938858	.	A	C	4	7	11	0	0	11	0	0
25	5938881	.	G	T	6	4	10	0	1	11	0	0
25	5938895	.	C	T	5	5	10	0	0	10	0	0
25	5939484	.	C	T	8	8	16	0	1	17	0	0
25	5939569	.	T	C	5	4	9	0	1	10	0	0
25	5940272	.	T	C	4	5	9	0	1	10	0	0
25	5962763	.	C	T	0	5	5	0	7	12	0	0
25	5963435	.	T	A	1	3	4	0	0	4	0	0
25	5986994	.	A	G	32	1	33	0	18	51	0	0
25	5990107	.	A	C	15	14	29	0	0	29	0	0
25	6010948	.	C	A	3	3	6	0	0	6	0	0
25	6016708	.	G	A	4	4	8	0	1	9	0	0
25	6016752	.	T	C	6	0	6	0	5	11	0	0
25	6016829	.	C	T	8	8	16	0	1	17	0	0
25	6017382	.	A	T	9	12	21	0	0	21	0	0
25	6017623	.	C	T	0	0	0	0	1	1	0	0
25	6025278	.	C	A	3	1	4	0	1	5	0	0
25	6025326	.	G	T	8	8	16	0	1	17	0	0
25	6026106	.	G	A	8	5	13	0	0	13	0	0
25	6028947	.	G	A	3	3	6	0	0	6	0	0
25	6042829	.	A	T	2	6	8	0	0	8	0	0
25	6042871	.	G	A	5	7	12	0	0	12	0	0
25	6049177	.	G	A	6	6	12	0	2	15	1	0
25	6059533	.	C	T	0	2	2	0	0	2	0	0
25	6065026	.	A	T	4	2	6	0	0	6	0	0
25	6065064	.	G	A	3	3	6	0	0	6	0	0
25	6065094	.	G	A	2	2	4	0	0	4	0	0
25	6069635	.	T	G	2	3	5	0	0	5	0	0
25	6069639	.	A	T	2	3	5	0	0	5	0	0
25	6074342	.	T	C	1	0	1	0	3	4	0	0
25	6152324	.	G	A	5	3	8	0	0	8	0	0
25	6186861	.	A	G	5	2	7	0	0	7	0	0
25	6186933	.	A	G	6	5	11	0	0	11	0	0
25	6202870	.	T	A	3	12	15	0	1	16	0	0
25	6203292	.	A	G	7	8	15	0	5	20	0	0
25	6203505	.	G	T	6	2	8	0	0	8	0	0
25	6205703	.	C	T	14	9	23	0	2	25	0	0
25	6206331	.	G	T	4	2	6	0	0	6	0	0
25	6216349	.	A	C	9	11	20	0	0	20	0	0
25	6222555	.	G	A	6	8	14	0	0	14	0	0
25	6222600	.	C	A	1	15	16	0	22	38	0	0
25	6228616	.	G	A	6	12	18	0	0	18	0	0
25	6228651	.	A	G	6	15	21	0	0	21	0	0
25	6230616	.	G	A	10	5	15	0	2	17	0	0
25	6230721	.	T	C	5	5	10	0	0	10	0	0
25	6230736	.	T	G	2	2	4	0	0	4	0	0
25	6230935	.	T	C	4	4	8	0	0	8	0	0
25	6233485	.	C	T	10	13	23	0	1	24	0	0
25	6237656	.	G	A	3	4	7	0	0	7	0	0
25	6237674	.	T	C	1	0	1	0	4	5	0	0
25	6237993	.	A	G	1	0	1	0	0	1	0	0
25	6240154	.	G	A	1	0	1	0	0	1	0	0
25	6245099	.	A	G	1	0	1	0	0	1	0	0
25	6246357	.	A	T	1	0	1	0	0	1	0	0
25	6249408	.	C	T	2	4	6	0	0	6	0	0
25	6249409	.	C	T	0	4	4	0	2	6	0	0
25	6274993	.	T	C	3	2	5	0	1	6	0	0
25	6288353	.	G	C	9	9	18	0	0	18	0	0
25	6292481	.	C	T	0	5	5	0	6	11	0	0
25	6307064	.	T	C	6	8	14	0	2	16	0	0
25	6312955	.	A	C	21	20	41	0	2	44	1	0
25	6313069	.	G	A	2	12	14	0	6	20	0	0
25	6313075	.	T	C	6	8	14	0	0	14	0	0
25	6337111	.	G	A	0	19	19	0	10	29	0	0
25	6337136	.	C	T	13	29	42	0	2	44	0	0
25	6337253	.	A	T	21	19	40	0	0	40	0	0
25	6337271	.	C	A	22	22	44	0	0	44	0	0
25	6351282	.	A	G	11	8	19	0	0	19	0	0
25	6351283	.	C	G	11	8	19	0	0	19	0	0
25	6357227	.	C	T	3	8	11	0	0	11	0	0
25	6357245	.	C	T	0	5	5	0	3	8	0	0
25	6357451	.	T	C	3	2	5	0	0	5	0	0
25	6357503	.	G	A	2	0	2	0	0	2	0	0
25	6359728	.	G	C	5	5	10	0	0	10	0	0
25	6360049	.	T	A	6	4	10	0	0	10	0	0
25	6360225	.	T	C	5	5	10	0	2	12	0	0
25	6365322	.	T	C	5	9	14	0	0	14	0	0
25	6365361	.	C	A	4	6	10	0	0	10	0	0
25	6365394	.	G	T	3	0	3	0	0	3	0	0
25	6365415	.	T	C	1	0	1	0	0	1	0	0
25	6370171	.	C	T	0	1	1	0	2	3	0	0
25	6370184	.	T	C	2	1	3	0	0	3	0	0
25	6377724	.	T	C	7	0	7	0	3	10	0	0
25	6383376	.	T	C	0	0	0	0	5	5	0	0
25	6403986	.	A	T	3	3	6	0	0	6	0	0
25	6404146	.	T	A	3	2	5	0	0	5	0	0
25	6404630	.	T	G	3	4	7	0	0	7	0	0
25	6407526	.	T	C	0	0	0	0	2	2	0	0
25	6407562	.	T	C	3	0	3	0	2	5	0	0
25	6411731	.	T	A	2	3	5	0	0	5	0	0
25	6411935	.	A	G	2	1	3	0	0	3	0	0
25	6431914	.	C	A	1	7	8	0	2	10	0	0
25	6436199	.	G	C	11	11	22	0	0	22	0	0
25	6437716	.	A	G	3	0	3	0	0	3	0	0
25	6437735	.	A	G	3	1	4	0	0	4	0	0
25	6437945	.	C	T	2	1	3	0	0	3	0	0
25	7229255	.	T	A	7	4	11	0	0	11	0	0
25	7229462	.	A	C	4	2	6	0	0	6	0	0
25	7230239	.	T	C	11	8	19	0	0	19	0	0
25	7324580	.	C	T	1	1	2	0	0	2	0	0
25	7334900	.	A	G	7	1	8	0	2	10	0	0
25	7334915	.	T	C	5	11	16	0	1	17	0	0
25	7334957	.	G	A	1	13	14	0	12	26	0	0
25	7334987	.	G	C	6	5	11	0	1	12	0	0
25	7398659	.	C	A	3	3	6	0	0	6	0	0
25	7399195	.	A	G	2	3	5	0	0	5	0	0
25	7399297	.	G	A	0	2	2	0	1	3	0	0
25	7399507	.	T	C	1	4	5	0	0	5	0	0
25	7400530	.	C	T	3	2	5	0	0	5	0	0
25	7401509	.	C	G	2	3	5	0	0	5	0	0
25	7401580	.	A	G	2	2	4	0	0	4	0	0
25	7401601	.	C	G	3	4	7	0	0	7	0	0
25	7410399	.	A	G	2	2	4	0	0	4	0	0
25	7410645	.	G	A	4	6	10	0	0	10	0	0
25	7412640	.	T	G	7	6	13	0	0	13	0	0
25	7412750	.	G	A	1	4	5	0	0	5	0	0
25	7412985	.	C	T	4	7	11	0	1	12	0	0
25	7413144	.	C	T	3	4	7	0	0	7	0	0
25	7413351	.	C	T	2	2	4	0	1	5	0	0
25	7413501	.	C	T	3	3	6	0	0	6	0	0
25	7413898	.	T	C	1	2	3	0	0	3	0	0
25	7428932	.	A	C	4	9	13	0	1	14	0	0
25	7428944	.	T	C	3	8	11	0	2	13	0	0
25	7428971	.	A	T	5	4	9	0	0	9	0	0
25	7429028	.	C	A	1	0	1	0	0	1	0	0
25	7431430	.	A	G	1	0	1	0	2	3	0	0
25	7451133	.	C	A	7	3	10	0	0	10	0	0
25	7454599	.	T	C	4	0	4	0	2	6	0	0
25	7456535	.	C	A	0	1	1	0	1	2	0	0
25	7456843	.	G	A	0	2	2	0	1	3	0	0
25	7456860	.	G	A	0	1	1	0	2	3	0	0
25	7480949	.	G	C	11	13	24	0	2	26	0	0
25	7481063	.	C	A	17	25	42	0	0	42	0	0
25	7481123	.	G	A	0	17	17	0	19	36	0	0
25	7481159	.	C	T	25	18	43	0	1	44	0	0
25	7485040	.	A	G	8	0	8	0	10	18	0	0
25	7485073	.	G	A	1	6	7	0	0	7	0	0
25	7485527	.	C	T	13	23	36	0	4	40	0	0
25	7485588	.	A	G	4	4	8	0	0	8	0	0
25	7487809	.	T	C	30	22	52	0	2	54	0	0
25	7488310	.	T	A	0	15	15	0	0	15	0	0
25	7488749	.	T	G	13	22	35	0	2	37	0	0
25	7488753	.	C	T	12	23	35	0	1	36	0	0
25	7488812	.	G	A	32	22	54	0	0	54	0	0
25	7488813	.	G	T	32	22	54	0	0	54	0	0
25	7489034	.	G	A	1	20	21	0	26	47	0	0
25	7489082	.	A	G	17	23	40	0	0	40	0	0
25	7489085	.	G	C	17	23	40	0	0	40	0	0
25	7492888	.	C	T	11	6	17	0	1	18	0	0
25	7494184	.	C	T	2	0	2	0	0	2	0	0
25	7494207	.	T	C	4	4	8	0	0	8	0	0
25	7494258	.	G	C	4	10	14	0	3	18	1	0
25	7494306	.	T	C	6	5	11	0	1	12	0	0
25	7496021	.	C	T	2	5	7	0	1	8	0	0
25	7496039	.	C	T	7	6	13	0	0	13	0	0
25	7496099	.	G	A	0	2	2	0	0	2	0	0
25	7500342	.	A	G	1	0	1	0	0	1	0	0
25	7502022	.	G	C	17	7	24	0	0	24	0	0
25	7502201	.	G	A	2	3	5	0	0	5	0	0
25	7502204	.	T	G	2	3	5	0	0	5	0	0
25	7502241	.	G	A	0	1	1	0	0	1	0	0
25	7502271	.	T	G	4	0	4	0	8	12	0	0
25	7520131	.	G	A	1	0	1	0	1	2	0	0
25	7520753	.	G	T	2	2	4	0	0	4	0	0
25	7520785	.	A	T	2	3	5	0	0	5	0	0
25	7520796	.	A	T	2	3	5	0	0	5	0	0
25	7533161	.	A	G	0	2	2	0	0	2	0	0
25	7533220	.	T	C	4	4	8	0	1	9	0	0
25	7533437	.	C	T	3	4	7	0	0	7	0	0
25	7533476	.	C	T	3	9	12	0	0	12	0	0
25	7533559	.	G	C	2	4	6	0	1	7	0	0
25	7551182	.	C	T	5	6	11	0	0	11	0	0
25	7553064	.	G	T	1	2	3	0	0	3	0	0
25	7556313	.	A	G	2	1	3	0	0	3	0	0
25	7556410	.	T	C	10	9	19	0	0	19	0	0
25	7556427	.	C	T	8	6	14	0	2	16	0	0
25	7556454	.	C	T	5	6	11	0	1	12	0	0
25	7562301	.	T	A	12	6	18	0	1	19	0	0
25	7562418	.	G	A	0	3	3	0	4	7	0	0
25	7562921	.	C	T	13	6	19	0	0	19	0	0
25	7562925	.	A	T	14	6	20	0	0	20	0	0
25	7562975	.	A	G	13	10	23	0	0	23	0	0
25	7572200	.	C	T	1	1	2	0	0	2	0	0
25	7576192	.	C	G	1	0	1	0	0	1	0	0
25	7578131	.	C	T	2	3	5	0	0	5	0	0
25	7580798	.	T	C	2	2	4	0	0	4	0	0
25	7580840	.	G	A	2	3	5	0	0	5	0	0
25	7580945	.	C	T	1	3	4	0	0	4	0	0
25	7583147	.	T	C	4	3	7	0	0	7	0	0
25	7586915	.	A	G	1	1	2	0	0	2	0	0
25	7587748	.	A	T	0	1	1	0	0	1	0	0
25	7589915	.	A	G	8	0	8	0	9	17	0	0
25	7589951	.	C	T	5	7	12	0	0	12	0	0
25	7590679	.	C	T	0	1	1	0	0	1	0	0
25	7590702	.	C	T	0	1	1	0	0	1	0	0
25	7667923	.	G	A	5	3	8	0	0	8	0	0
25	7667943	.	T	C	5	5	10	0	0	10	0	0
25	7668161	.	A	G	3	0	3	0	0	3	0	0
25	7668166	.	C	T	0	2	2	0	0	2	0	0
25	7672067	.	C	T	6	7	13	0	0	13	0	0
25	7672382	.	G	A	1	7	8	0	9	17	0	0
25	7672385	.	C	T	7	5	12	0	4	16	0	0
25	7673040	.	T	C	11	9	20	0	1	21	0	0
25	7673052	.	C	T	8	6	14	0	0	14	0	0
25	7673139	.	T	A	10	17	27	0	0	27	0	0
25	7673140	.	C	T	10	16	26	0	1	27	0	0
25	7673897	.	T	G	2	1	3	0	0	3	0	0
25	7673930	.	G	A	10	2	12	0	0	12	0	0
25	7673951	.	C	T	7	11	18	0	0	18	0	0
25	7674098	.	G	A	1	2	3	0	0	3	0	0
25	7678180	.	A	T	13	12	25	0	0	25	0	0
25	7693323	.	C	A	1	3	4	0	0	4	0	0
25	7693339	.	A	C	2	4	6	0	0	6	0	0
25	7693511	.	T	C	4	3	7	0	0	7	0	0
25	7693546	.	G	A	2	6	8	0	0	8	0	0
25	7693808	.	C	T	1	2	3	0	0	3	0	0
25	7693818	.	T	C	1	2	3	0	0	3	0	0
25	7693889	.	C	T	2	4	6	0	0	6	0	0
25	7694577	.	A	T	2	3	5	0	0	5	0	0
25	7694855	.	T	G	2	4	6	1	0	7	0	0
25	7695625	.	C	T	4	5	9	0	0	9	0	0
25	7695982	.	T	C	1	3	4	0	0	4	0	0
25	7696399	.	G	A	5	2	7	0	0	7	0	0
25	7697457	.	G	A	1	2	3	0	0	3	0	0
25	7697487	.	G	A	1	2	3	0	0	3	0	0
25	7697977	.	G	A	1	2	3	0	0	3	0	0
25	7697986	.	A	G	1	1	2	0	0	2	0	0
25	7698022	.	T	C	1	1	2	0	0	2	0	0
25	7698031	.	T	C	1	0	1	0	1	2	0	0
25	7704991	.	G	C	1	3	4	0	1	5	0	0
25	7709335	.	C	T	1	2	3	0	3	6	0	0
25	7719778	.	A	G	2	2	4	0	1	5	0	0
25	7784705	.	G	A	3	3	6	0	0	6	0	0
25	7784711	.	G	T	3	5	8	0	0	8	0	0
25	7784981	.	G	T	12	3	15	0	1	16	0	0
25	7890361	.	T	C	4	2	6	0	0	6	0	0
25	7890540	.	T	C	3	3	6	0	0	6	0	0
25	7891836	.	T	C	1	4	5	0	0	5	0	0
25	7892297	.	T	C	1	6	7	0	0	7	0	0
25	8030173	.	T	C	1	0	1	0	7	8	0	0
25	8047441	.	A	G	0	2	2	0	0	2	0	0
25	8478634	.	G	A	0	7	7	0	0	7	0	0
25	8478814	.	T	C	5	3	8	0	1	9	0	0
25	8478869	.	T	C	4	1	5	0	3	8	0	0
25	8482837	.	C	T	3	3	6	0	0	6	0	0
25	8486622	.	C	T	0	9	9	0	4	13	0	0
25	8486631	.	A	C	3	0	3	0	11	14	0	0
25	8486705	.	A	G	1	1	2	0	0	2	0	0
25	8486884	.	T	A	3	8	11	0	0	11	0	0
25	8495246	.	A	G	0	4	4	0	0	4	0	0
25	8506973	.	G	A	1	2	3	0	0	3	0	0
25	8506991	.	C	T	0	2	2	0	1	3	0	0
25	8511772	.	A	G	1	2	3	0	0	3	0	0
25	8581671	.	T	A	3	2	5	0	0	5	0	0
25	8590436	.	T	C	1	1	2	0	0	2	0	0
25	8624174	.	A	T	1	2	3	0	0	3	0	0
25	8624258	.	A	G	0	4	4	0	0	4	0	0
25	8627940	.	G	A	5	4	9	0	0	9	0	0
25	8627943	.	T	C	4	5	9	0	0	9	0	0
25	8630910	.	A	G	6	0	6	0	0	6	0	0
25	8631015	.	A	T	2	2	4	0	0	4	0	0
25	8631017	.	C	T	0	2	2	0	2	4	0	0
25	8639640	.	C	T	0	2	2	0	0	2	0	0
25	8642262	.	C	T	4	4	8	0	1	9	0	0
25	8658002	.	A	T	1	3	4	0	0	4	0	0
25	8660568	.	T	A	1	0	1	0	0	1	0	0
25	8660651	.	G	A	3	5	8	0	0	8	0	0
25	8665888	.	T	G	2	4	6	0	2	8	0	0
25	8665979	.	A	C	0	3	3	0	0	3	0	0
25	8675615	.	C	T	4	2	6	0	0	6	0	0
25	8700514	.	G	A	4	5	9	0	0	9	0	0
25	8700603	.	G	A	0	0	0	0	2	2	0	0
25	8700630	.	C	T	1	0	1	0	0	1	0	0
25	8707860	.	A	G	2	0	2	0	1	3	0	0
25	8722680	.	T	G	0	0	0	0	1	1	0	0
25	8736254	.	C	T	6	1	7	0	0	7	0	0
25	8739881	.	A	T	2	7	9	0	0	9	0	0
25	8740236	.	G	T	1	3	4	0	2	6	0	0
25	8740545	.	G	A	0	0	0	0	11	11	0	0
25	8740550	.	G	C	11	0	11	0	1	12	0	0
25	8740998	.	A	T	2	2	4	0	0	4	0	0
25	8741303	.	C	T	11	5	16	0	0	16	0	0
25	8741469	.	T	A	6	5	11	0	0	11	0	0
25	8741471	.	C	T	6	5	11	0	0	11	0	0
25	8741549	.	A	G	3	0	3	0	3	6	0	0
25	8741624	.	C	T	4	2	6	0	0	6	0	0
25	8741758	.	C	T	5	7	12	0	2	14	0	0
25	8741759	.	G	T	0	8	8	0	6	14	0	0
25	8741877	.	G	C	5	12	17	0	1	18	0	0
25	8741968	.	G	C	8	11	19	0	1	20	0	0
25	8742126	.	T	C	15	10	25	0	0	25	0	0
25	8742148	.	T	A	11	12	23	0	0	23	0	0
25	8756099	.	T	C	7	2	9	0	0	9	0	0
25	8756573	.	C	A	2	10	12	0	0	12	0	0
25	8757038	.	A	C	3	0	3	0	4	7	0	0
25	8767925	.	A	G	8	18	26	0	1	27	0	0
25	8773257	.	A	G	2	4	6	0	0	6	0	0
25	8773867	.	T	G	0	8	8	0	0	8	0	0
25	8773897	.	C	T	1	7	8	0	0	8	0	0
25	8791174	.	A	G	9	14	23	0	0	23	0	0
25	8834967	.	T	G	0	1	1	0	0	1	0	0
25	8834968	.	G	C	0	0	0	0	1	1	0	0
25	8852072	.	A	T	3	2	5	0	0	5	0	0
25	8908297	.	C	T	0	3	3	0	6	9	0	0
25	8916632	.	G	A	6	4	10	0	0	10	0	0
25	8916635	.	C	G	4	6	10	0	0	10	0	0
25	8916859	.	A	G	6	5	11	0	0	11	0	0
25	8921682	.	C	T	1	2	3	0	0	3	0	0
25	8921867	.	C	T	2	5	7	0	0	7	0	0
25	8922223	.	T	C	2	4	6	0	1	7	0	0
25	8925748	.	T	C	2	9	11	0	0	11	0	0
25	8925928	.	T	C	6	2	8	0	0	8	0	0
25	8926097	.	T	A	1	3	4	0	0	4	0	0
25	8926171	.	G	T	1	2	3	0	0	3	0	0
25	8940231	.	G	A	0	0	0	0	1	1	0	0
25	8940242	.	T	C	1	1	2	0	0	2	0	0
25	8940269	.	G	T	1	2	3	0	0	3	0	0
25	8940281	.	T	C	1	2	3	0	0	3	0	0
25	8946648	.	C	T	0	1	1	0	0	1	0	0
25	8946942	.	T	C	7	6	13	0	0	13	0	0
25	8948700	.	G	A	0	6	6	0	3	9	0	0
25	8948978	.	C	A	4	5	9	0	0	9	0	0
25	8949062	.	A	T	5	6	11	0	1	12	0	0
25	8949124	.	C	T	3	5	8	0	1	9	0	0
25	9028216	.	G	A	1	3	4	0	0	4	0	0
25	9028223	.	C	T	2	2	4	0	0	4	0	0
25	9678666	.	G	A	6	4	10	0	0	10	0	0
25	9679242	.	G	A	14	13	27	0	0	27	0	0
25	9679389	.	G	A	10	3	13	0	1	14	0	0
25	9679413	.	C	T	0	2	2	0	9	11	0	0
25	9679539	.	T	C	5	7	12	0	0	12	0	0
25	9680022	.	T	C	6	8	14	0	0	14	0	0
25	9680196	.	T	A	5	2	7	0	0	7	0	0
25	9680448	.	A	G	9	4	13	0	1	14	0	0
25	9805253	.	G	C	5	5	10	0	0	10	0	0
25	9805257	.	G	C	5	5	10	0	0	10	0	0
25	11796531	.	T	C	10	0	10	0	9	19	0	0
25	11796579	.	T	A	15	14	29	0	0	29	0	0
25	11796728	.	A	T	15	5	20	0	3	23	0	0
25	11796860	.	T	C	10	9	19	0	2	21	0	0
25	11796973	.	T	C	7	0	7	0	5	12	0	0
25	11796987	.	A	G	8	4	12	0	0	12	0	0
25	11797515	.	A	G	6	14	20	0	0	20	0	0
25	11797550	.	G	T	2	15	17	0	0	17	0	0
25	11797789	.	A	T	3	5	8	0	0	8	0	0
25	11797912	.	T	A	1	2	3	0	0	3	0	0
25	11797979	.	A	G	3	3	6	0	0	6	0	0
25	11797990	.	A	G	2	3	5	0	0	5	0	0
25	11798043	.	G	A	2	5	7	0	0	7	0	0
25	11798215	.	A	C	4	8	12	0	0	12	0	0
25	11798227	.	T	A	3	6	9	0	1	10	0	0
25	11798333	.	A	T	3	2	5	0	0	5	0	0
25	11798381	.	T	A	6	10	16	0	0	16	0	0
25	11798509	.	A	T	4	4	8	0	0	8	0	0
25	11798511	.	C	A	0	4	4	0	4	8	0	0
25	11798659	.	A	T	0	2	2	0	0	2	0	0
25	11799527	.	A	T	6	6	12	0	0	12	0	0
25	11799577	.	G	A	6	5	11	0	0	11	0	0
25	11799625	.	A	T	5	4	9	0	0	9	0	0
25	11799750	.	A	T	7	2	9	0	0	9	0	0
25	11799945	.	T	C	5	2	7	0	1	8	0	0
25	11799954	.	G	T	4	3	7	0	0	7	0	0
25	11800140	.	A	G	4	2	6	0	0	6	0	0
25	11800522	.	G	A	9	6	15	0	1	16	0	0
25	11800652	.	C	T	1	5	6	0	2	8	0	0
25	11800883	.	C	T	9	5	14	0	0	14	0	0
25	11801111	.	C	A	4	3	7	0	0	7	0	0
25	11801513	.	A	C	1	7	8	0	1	9	0	0
25	11801642	.	C	G	1	6	7	0	0	7	0	0
25	11801838	.	A	C	5	0	5	0	5	10	0	0
25	11801841	.	G	T	5	3	8	0	2	10	0	0
25	11802044	.	A	G	4	5	9	0	0	9	0	0
25	11802066	.	C	G	3	6	9	0	0	9	0	0
25	11802115	.	C	A	1	3	4	0	0	4	0	0
25	11802192	.	T	A	2	8	10	0	1	11	0	0
25	11802306	.	C	A	0	8	8	0	10	18	0	0
25	11802485	.	C	T	0	7	7	0	5	12	0	0
25	11803455	.	G	T	7	6	13	0	0	13	0	0
25	11803467	.	A	T	5	6	11	0	0	11	0	0
25	11803996	.	A	C	1	2	3	0	0	3	0	0
25	11804330	.	C	G	0	2	2	0	2	4	0	0
25	11804490	.	T	G	4	5	9	0	0	9	0	0
25	11804688	.	T	G	5	3	8	0	1	9	0	0
25	11804969	.	T	A	1	3	4	0	0	4	0	0
25	11805270	.	C	G	1	3	4	0	1	5	0	0
25	11805417	.	C	T	2	2	4	0	0	4	0	0
25	11805841	.	A	G	2	2	4	0	1	5	0	0
25	11806408	.	C	A	1	1	2	0	0	2	0	0
25	11833526	.	G	A	5	3	8	0	1	9	0	0
25	11844148	.	C	T	1	1	2	0	0	2	0	0
25	12008336	.	A	G	1	2	3	0	0	3	0	0
25	12203626	.	G	A	1	4	5	0	0	5	0	0
25	12640549	.	C	T	7	3	10	0	0	10	0	0
25	12656712	.	C	G	8	8	16	0	0	16	0	0
25	12657193	.	C	T	8	4	12	0	1	13	0	0
25	12688845	.	C	T	5	4	9	0	0	9	0	0
25	12689250	.	G	A	11	5	16	0	0	16	0	0
25	12689537	.	T	C	8	9	17	0	2	19	0	0
25	12689546	.	A	G	9	0	9	0	9	18	0	0
25	12689649	.	C	T	6	3	9	0	0	9	0	0
25	12695051	.	T	C	4	5	9	0	3	12	0	0
25	12695205	.	C	G	9	1	10	0	17	27	0	0
25	12695449	.	A	T	5	12	17	0	0	17	0	0
25	12695658	.	C	T	11	11	22	0	0	22	0	0
25	12707565	.	T	C	2	0	2	0	2	4	0	0
25	12707631	.	A	G	5	3	8	0	0	8	0	0
25	12717574	.	C	T	11	6	17	0	0	17	0	0
25	12723890	.	G	A	1	1	2	0	0	2	0	0
25	12725258	.	C	T	1	1	2	0	0	2	0	0
25	12729898	.	C	A	0	2	2	0	2	4	0	0
25	12729928	.	A	G	2	2	4	0	0	4	0	0
25	12798284	.	A	C	5	4	9	0	0	9	0	0
25	12798386	.	A	G	2	4	6	0	0	6	0	0
25	12804003	.	A	G	3	4	7	0	0	7	0	0
25	12804006	.	A	G	3	4	7	0	0	7	0	0
25	12804051	.	T	C	1	2	3	0	0	3	0	0
25	12804428	.	A	G	5	2	7	0	0	7	0	0
25	12804458	.	T	C	7	5	12	0	0	12	0	0
25	12809004	.	A	G	6	2	8	0	0	8	0	0
25	12809277	.	G	A	4	2	6	0	0	6	0	0
25	12816683	.	G	A	0	1	1	0	1	2	0	0
25	12816913	.	G	A	8	4	12	0	0	12	0	0
25	12818948	.	T	G	4	6	10	0	0	10	0	0
25	12823185	.	G	A	1	2	3	0	0	3	0	0
25	12853407	.	A	T	26	25	51	0	0	51	0	0
25	12853519	.	A	G	16	20	36	0	1	37	0	0
25	12853602	.	T	C	9	39	48	0	1	49	0	0
25	12853611	.	T	A	11	39	50	0	3	53	0	0
25	12853691	.	C	T	20	28	48	0	0	48	0	0
25	12853762	.	T	C	18	0	18	0	25	43	0	0
25	12853850	.	A	C	9	16	25	0	3	28	0	0
25	12853971	.	T	A	33	19	52	0	0	52	0	0
25	12854016	.	G	A	23	27	50	0	3	53	0	0
25	12854021	.	T	A	24	23	47	0	1	48	0	0
25	12854099	.	C	A	18	31	49	0	0	49	0	0
25	12854201	.	C	T	34	13	47	1	4	52	0	0
25	12854230	.	T	G	22	20	42	0	2	44	0	0
25	12854266	.	A	T	23	14	37	0	4	41	0	0
25	12854279	.	T	G	20	26	46	0	0	46	0	0
25	12854393	.	T	C	12	18	30	0	3	33	0	0
25	12856663	.	G	A	3	9	12	0	1	13	0	0
25	12901551	.	G	A	3	9	12	0	0	12	0	0
25	12906814	.	G	A	20	14	34	0	2	36	0	0
25	13069954	.	C	T	3	7	10	0	1	11	0	0
25	13069960	.	T	G	3	8	11	0	0	11	0	0
25	13104333	.	C	A	0	3	3	0	4	7	0	0
25	13104393	.	T	C	3	3	6	0	0	6	0	0
25	13332406	.	A	T	34	19	53	0	7	60	0	0
25	13332531	.	C	T	25	30	55	0	2	57	0	0
25	13332693	.	G	A	33	35	68	0	1	69	0	0
25	13333191	.	G	T	41	33	74	0	1	75	0	0
25	13333463	.	G	A	32	38	70	0	11	81	0	0
25	13333508	.	A	T	42	23	65	0	5	70	0	0
25	13333665	.	C	T	26	33	59	1	3	63	0	0
25	13333839	.	A	T	30	19	49	0	1	50	0	0
25	13333986	.	T	A	25	38	63	0	0	64	1	0
25	13334229	.	A	G	20	24	44	0	1	45	0	0
25	13334236	.	T	C	22	23	45	0	0	45	0	0
25	13334269	.	G	A	19	25	44	0	1	45	0	0
25	13334275	.	A	T	19	23	42	0	2	44	0	0
25	13334304	.	T	C	17	0	17	0	14	31	0	0
25	13334487	.	A	T	29	17	46	0	3	50	1	0
25	13334729	.	C	T	51	24	75	0	0	75	0	0
25	13334977	.	A	T	34	36	70	0	1	71	0	0
25	13335012	.	A	G	38	28	66	0	0	66	0	0
25	13335021	.	G	T	24	35	59	0	4	63	0	0
25	13335185	.	A	G	31	25	56	0	2	58	0	0
25	13335225	.	T	C	29	28	57	0	4	61	0	0
25	13335378	.	T	C	20	16	36	0	1	37	0	0
25	13335432	.	T	A	14	17	31	0	0	31	0	0
25	13335441	.	G	A	14	16	30	0	3	33	0	0
25	13335469	.	T	G	20	12	32	0	1	33	0	0
25	13335505	.	C	A	13	13	26	0	0	26	0	0
25	13335558	.	G	T	27	22	49	0	2	51	0	0
25	13335562	.	G	A	25	25	50	0	2	52	0	0
25	13335762	.	C	T	7	8	15	1	2	18	0	0
25	13335765	.	C	T	1	10	11	1	8	20	0	0
25	13336277	.	G	A	11	25	36	0	2	38	0	0
25	13336323	.	T	G	26	32	58	0	2	60	0	0
25	13336343	.	T	C	31	30	61	0	1	62	0	0
25	13336493	.	A	G	26	29	55	0	0	55	0	0
25	13336545	.	T	C	24	23	47	0	3	50	0	0
25	13336598	.	C	G	26	35	61	0	1	62	0	0
25	13336672	.	G	A	1	8	9	0	1	10	0	0
25	13336685	.	G	A	0	2	2	0	3	5	0	0
25	13336815	.	T	A	25	36	61	0	4	65	0	0
25	13336846	.	T	C	39	21	60	0	2	62	0	0
25	13336861	.	A	G	36	19	55	0	0	55	0	0
25	13336967	.	T	A	24	24	48	0	5	53	0	0
25	13337272	.	G	A	20	47	67	0	3	70	0	0
25	13337338	.	G	A	17	29	46	0	2	48	0	0
25	13352304	.	T	A	0	1	1	0	0	1	0	0
25	13363206	.	C	T	1	9	10	0	10	20	0	0
25	13363248	.	G	T	17	19	36	0	5	41	0	0
25	13363258	.	G	A	17	20	37	0	0	37	0	0
25	13469844	.	A	G	13	1	14	0	8	22	0	0
25	13470123	.	T	C	14	11	25	0	0	25	0	0
25	13470424	.	C	T	9	17	26	0	1	27	0	0
25	13471079	.	A	C	17	11	28	0	1	29	0	0
25	13474192	.	G	A	4	2	6	0	0	6	0	0
25	13474362	.	C	G	6	10	16	0	0	16	0	0
25	13478185	.	G	T	1	2	3	0	3	6	0	0
25	13478217	.	T	G	5	4	9	0	1	10	0	0
25	13484787	.	A	G	1	5	6	0	0	6	0	0
25	13484791	.	T	C	0	3	3	0	1	4	0	0
25	13485370	.	A	T	2	3	5	0	0	5	0	0
25	13498342	.	G	A	0	3	3	0	4	7	0	0
25	13509942	.	T	A	7	3	10	0	0	11	1	0
25	13525848	.	A	T	9	17	26	0	0	26	0	0
25	13525864	.	G	A	13	18	31	0	0	31	0	0
25	13526171	.	A	C	1	13	14	0	0	14	0	0
25	13528732	.	G	A	5	3	8	0	0	8	0	0
25	13528787	.	G	T	6	3	9	0	0	9	0	0
25	13528796	.	C	T	5	3	8	0	1	9	0	0
25	13529294	.	A	G	2	4	6	0	0	6	0	0
25	13531933	.	G	A	1	3	4	0	0	4	0	0
25	13536613	.	T	C	1	3	4	0	0	4	0	0
25	13559168	.	T	G	4	5	9	0	2	11	0	0
25	13559194	.	G	A	7	10	17	0	0	17	0	0
25	13559548	.	T	A	11	6	17	0	3	20	0	0
25	13559633	.	T	C	12	0	12	0	10	22	0	0
25	13559950	.	G	A	14	17	31	0	1	32	0	0
25	13559953	.	A	T	17	10	27	0	4	31	0	0
25	13560080	.	C	T	9	13	22	0	1	23	0	0
25	13560342	.	T	C	22	12	34	0	0	34	0	0
25	13560518	.	G	A	16	14	30	0	0	30	0	0
25	13560638	.	C	A	1	7	8	0	0	8	0	0
25	13561133	.	T	C	11	7	18	0	0	18	0	0
25	13561149	.	T	C	7	8	15	0	0	15	0	0
25	13561775	.	C	A	0	12	12	0	9	21	0	0
25	13561851	.	A	C	4	9	13	0	0	13	0	0
25	13562066	.	G	A	2	8	10	0	0	10	0	0
25	13614475	.	G	C	9	0	9	0	7	16	0	0
25	13643476	.	G	A	4	7	11	0	0	11	0	0
25	13645911	.	C	T	8	4	12	0	0	12	0	0
25	13646153	.	G	A	2	2	4	0	0	4	0	0
25	13658450	.	G	A	4	8	12	0	0	12	0	0
25	13658468	.	C	T	1	5	6	0	5	11	0	0
25	13658681	.	G	A	9	6	15	0	0	15	0	0
25	13658940	.	G	A	13	5	18	0	1	19	0	0
25	13663828	.	A	T	1	2	3	0	0	3	0	0
25	13672398	.	T	G	1	3	4	0	0	4	0	0
25	13673455	.	C	T	7	3	10	0	0	10	0	0
25	13673680	.	T	C	5	1	6	0	4	10	0	0
25	13673839	.	G	A	3	3	6	0	0	6	0	0
25	13673884	.	C	T	0	3	3	0	2	5	0	0
25	13674073	.	C	T	1	3	4	0	1	5	0	0
25	13674202	.	A	G	5	7	12	0	0	12	0	0
25	13674327	.	A	G	6	2	8	0	0	8	0	0
25	13676438	.	C	T	0	6	6	0	5	11	0	0
25	13677352	.	G	A	0	4	4	0	4	8	0	0
25	13677396	.	A	G	3	5	8	0	1	9	0	0
25	13677519	.	C	T	1	2	3	0	0	3	0	0
25	13677533	.	G	A	2	1	3	0	0	3	0	0
25	13677726	.	G	C	5	2	7	0	0	7	0	0
25	13680319	.	G	A	0	3	3	0	4	7	0	0
25	13689440	.	G	A	4	4	8	0	0	8	0	0
25	13689486	.	T	C	0	0	0	0	9	9	0	0
25	13689612	.	A	G	3	5	8	0	0	8	0	0
25	13689617	.	C	A	3	4	7	0	0	7	0	0
25	13689945	.	G	A	2	5	7	0	0	7	0	0
25	13695768	.	A	G	2	0	2	0	0	2	0	0
25	13744587	.	T	C	2	3	5	0	0	5	0	0
25	13745665	.	A	G	31	25	56	0	0	56	0	0
25	13745776	.	A	G	7	11	18	0	1	19	0	0
25	13750695	.	G	A	0	2	2	0	0	2	0	0
25	13750734	.	T	A	10	8	18	0	1	19	0	0
25	13762759	.	G	C	10	13	23	0	0	23	0	0
25	13762889	.	T	C	4	3	7	0	0	7	0	0
25	13763241	.	C	T	0	4	4	0	5	9	0	0
25	13763641	.	C	T	1	1	2	0	0	2	0	0
25	13766021	.	G	T	2	3	5	0	0	5	0	0
25	13766062	.	G	A	2	5	7	0	0	7	0	0
25	13767612	.	G	A	6	10	16	0	0	16	0	0
25	13768396	.	G	A	2	1	3	0	1	4	0	0
25	13768547	.	A	G	4	3	7	0	0	7	0	0
25	13773970	.	G	A	7	8	15	0	0	15	0	0
25	13774036	.	C	T	3	0	3	0	0	3	0	0
25	13774400	.	G	A	2	4	6	0	0	6	0	0
25	13774421	.	C	A	0	2	2	0	4	6	0	0
25	13775158	.	A	G	0	1	1	0	0	1	0	0
25	13776838	.	C	T	5	5	10	0	2	12	0	0
25	13777997	.	T	A	4	4	8	0	0	8	0	0
25	13778018	.	A	G	5	7	12	0	0	12	0	0
25	13780322	.	C	G	3	7	10	0	1	11	0	0
25	13782146	.	T	C	6	8	14	0	1	15	0	0
25	13790004	.	T	A	2	1	3	0	0	3	0	0
25	13799158	.	A	C	3	3	6	0	0	6	0	0
25	13799172	.	G	A	4	2	6	0	0	6	0	0
25	13799226	.	C	T	3	2	5	0	0	5	0	0
25	13799359	.	A	C	3	4	7	0	0	7	0	0
25	13799434	.	T	C	9	20	29	0	3	32	0	0
25	13799458	.	T	C	12	20	32	0	1	33	0	0
25	13799537	.	G	C	10	11	21	0	1	22	0	0
25	13799689	.	C	T	11	23	34	0	2	36	0	0
25	13799830	.	A	G	15	21	36	0	2	38	0	0
25	13801768	.	C	A	6	3	9	0	0	9	0	0
25	13801895	.	G	C	12	15	27	0	0	27	0	0
25	13801933	.	C	T	13	7	20	0	1	21	0	0
25	13802100	.	C	T	16	16	32	0	1	33	0	0
25	13802451	.	A	G	11	9	20	0	0	20	0	0
25	13802673	.	C	T	2	8	10	0	11	21	0	0
25	13802688	.	C	A	17	11	28	0	0	28	0	0
25	13802710	.	C	T	13	9	22	0	2	24	0	0
25	13802876	.	G	A	10	22	32	0	1	33	0	0
25	13802901	.	G	A	11	21	32	0	1	33	0	0
25	13802918	.	A	G	12	18	30	0	0	30	0	0
25	13802940	.	A	T	12	15	27	0	2	29	0	0
25	13803710	.	A	G	15	13	28	0	2	30	0	0
25	13803712	.	T	G	14	13	27	0	2	30	1	0
25	13803895	.	A	G	10	14	24	0	1	25	0	0
25	13804000	.	A	C	12	0	12	0	10	22	0	0
25	13804056	.	C	T	17	10	27	0	1	28	0	0
25	13804093	.	A	G	19	15	34	0	1	35	0	0
25	13804169	.	G	T	15	14	29	0	0	29	0	0
25	13804216	.	C	T	11	15	26	0	1	27	0	0
25	13808756	.	A	G	12	2	14	0	1	15	0	0
25	13813824	.	G	T	3	1	4	0	1	5	0	0
25	13813827	.	A	G	3	2	5	0	0	5	0	0
25	13815325	.	G	A	9	7	16	0	0	16	0	0
25	13816724	.	G	A	17	5	22	0	0	22	0	0
25	13816840	.	C	T	0	9	9	0	9	18	0	0
25	13817135	.	C	G	10	8	18	0	0	18	0	0
25	13817168	.	T	A	9	12	21	0	1	22	0	0
25	13817243	.	C	T	0	2	2	0	0	2	0	0
25	13821187	.	C	T	1	1	2	0	0	2	0	0
25	13846926	.	A	C	3	1	4	0	0	4	0	0
25	13846934	.	A	G	2	2	4	0	0	4	0	0
25	13846984	.	A	G	2	4	6	0	0	6	0	0
25	13846990	.	A	G	2	3	5	0	0	5	0	0
25	13847301	.	C	T	1	14	15	0	9	24	0	0
25	13847533	.	A	G	10	7	17	0	0	17	0	0
25	13850757	.	A	C	3	4	7	0	0	7	0	0
25	13854838	.	G	A	11	7	18	0	0	18	0	0
25	13855707	.	T	A	7	6	13	0	1	14	0	0
25	13862188	.	G	A	10	7	17	0	2	19	0	0
25	13862233	.	T	G	4	3	7	0	0	7	0	0
25	13869025	.	T	C	3	2	5	0	0	5	0	0
25	13871100	.	A	G	5	10	15	0	0	15	0	0
25	13871112	.	G	A	4	3	7	0	0	7	0	0
25	14017737	.	A	C	1	6	7	0	0	7	0	0
25	14017834	.	G	A	0	7	7	0	6	13	0	0
25	14018006	.	A	G	7	5	12	0	1	13	0	0
25	14018043	.	T	C	3	2	5	0	0	5	0	0
25	14019501	.	G	T	11	6	17	0	0	17	0	0
25	14019879	.	A	T	10	13	23	0	2	25	0	0
25	14019921	.	G	A	2	7	9	0	10	19	0	0
25	14020279	.	G	A	9	10	19	0	1	20	0	0
25	14020923	.	C	A	2	2	4	0	0	4	0	0
25	14020924	.	A	C	2	2	4	0	0	4	0	0
25	14020973	.	C	T	3	2	5	0	2	7	0	0
25	14021000	.	A	C	4	2	6	0	0	6	0	0
25	14033268	.	T	C	13	16	29	0	1	30	0	0
25	14033657	.	T	C	9	8	17	0	1	18	0	0
25	14033711	.	T	A	6	9	15	0	0	15	0	0
25	14033719	.	T	C	8	1	9	0	10	19	0	0
25	14033867	.	A	G	3	5	8	0	0	8	0	0
25	14033914	.	G	A	7	4	11	0	0	11	0	0
25	14034240	.	G	C	17	12	29	0	3	32	0	0
25	14034354	.	T	G	6	13	19	0	1	20	0	0
25	14034620	.	A	G	10	10	20	0	2	22	0	0
25	14034637	.	G	A	6	9	15	0	5	20	0	0
25	14034805	.	C	G	0	7	7	0	8	15	0	0
25	14034824	.	C	T	7	6	13	0	1	14	0	0
25	14034929	.	G	A	8	5	13	0	0	13	0	0
25	14035505	.	T	C	4	5	9	0	0	9	0	0
25	14035684	.	A	C	1	3	4	0	0	4	0	0
25	14035833	.	A	C	1	3	4	0	0	4	0	0
25	14035834	.	A	T	1	3	4	0	0	4	0	0
25	14036172	.	C	A	9	6	15	0	0	15	0	0
25	14036187	.	A	T	9	8	17	0	0	17	0	0
25	14036535	.	G	T	7	7	14	0	0	14	0	0
25	14086393	.	A	T	2	1	3	0	1	4	0	0
25	14309785	.	G	A	2	0	2	0	0	2	0	0
25	14351449	.	C	T	1	3	4	0	0	4	0	0
25	14351995	.	A	T	2	1	3	0	0	3	0	0
25	14361812	.	C	T	14	9	23	0	0	23	0	0
25	14361815	.	T	C	14	9	23	0	1	24	0	0
25	14362292	.	T	A	11	11	22	0	2	24	0	0
25	14362340	.	C	T	10	8	18	0	2	20	0	0
25	14362355	.	A	G	8	7	15	0	1	16	0	0
25	14362943	.	A	C	11	0	11	0	16	27	0	0
25	14365618	.	C	T	21	18	39	0	2	41	0	0
25	14369587	.	G	T	4	7	11	0	0	11	0	0
25	14369883	.	T	C	6	4	10	0	9	19	0	0
25	14381564	.	A	G	15	9	24	0	1	25	0	0
25	14381583	.	A	G	15	7	22	0	0	22	0	0
25	14387391	.	G	A	3	5	8	0	0	8	0	0
25	14388955	.	A	T	12	9	21	0	1	22	0	0
25	14392871	.	T	C	1	3	4	0	0	4	0	0
25	14393438	.	T	C	12	0	12	0	14	26	0	0
25	14401150	.	C	T	3	1	4	0	0	4	0	0
25	14401219	.	C	A	6	4	10	0	0	10	0	0
25	14401432	.	G	A	0	2	2	0	2	4	0	0
25	14403297	.	C	T	3	9	12	0	2	14	0	0
25	14403961	.	C	T	0	1	1	0	0	1	0	0
25	14406494	.	G	A	13	12	25	0	0	25	0	0
25	14406530	.	T	A	7	13	20	0	1	21	0	0
25	14406608	.	A	C	6	4	10	0	1	11	0	0
25	14409099	.	A	T	2	3	5	0	0	5	0	0
25	14409123	.	C	T	5	3	8	0	0	8	0	0
25	14409140	.	C	T	0	5	5	0	5	10	0	0
25	14412941	.	G	A	1	1	2	0	1	3	0	0
25	14507856	.	G	T	2	2	4	0	0	4	0	0
25	14510047	.	C	A	2	2	4	0	0	4	0	0
25	14511584	.	T	A	0	6	6	0	0	6	0	0
25	14511904	.	T	C	1	2	3	0	0	3	0	0
25	14511951	.	C	A	1	2	3	0	1	4	0	0
25	14511958	.	A	G	1	2	3	0	0	3	0	0
25	14694942	.	C	T	2	4	6	0	0	6	0	0
25	14695092	.	C	T	8	4	12	0	0	12	0	0
25	14700609	.	T	C	0	2	2	0	0	2	0	0
25	14702794	.	G	C	10	6	16	0	0	16	0	0
25	14702821	.	C	T	6	12	18	1	0	19	0	0
25	14733824	.	C	T	2	1	3	0	0	3	0	0
25	14738132	.	C	T	2	3	5	0	0	5	0	0
25	14738499	.	T	G	2	3	5	0	0	5	0	0
25	14738716	.	T	C	6	5	11	0	0	11	0	0
25	14738868	.	T	C	4	4	8	0	0	8	0	0
25	14883648	.	C	T	2	2	4	0	0	4	0	0
25	15029575	.	C	T	6	6	12	0	1	13	0	0
25	15034012	.	C	T	0	0	0	0	3	3	0	0
25	15038561	.	C	T	6	9	15	0	2	17	0	0
25	15045221	.	T	A	4	4	8	0	0	8	0	0
25	15049560	.	G	A	1	3	4	0	0	4	0	0
25	15273487	.	G	A	0	2	2	0	2	4	0	0
25	15275408	.	A	G	3	1	4	0	0	4	0	0
25	15275987	.	G	C	1	3	4	0	0	4	0	0
25	15278014	.	G	A	0	5	5	0	4	9	0	0
25	15281889	.	C	T	10	7	17	0	0	17	0	0
25	15281891	.	A	G	10	7	17	0	0	17	0	0
25	15284440	.	T	C	6	6	12	0	0	12	0	0
25	15284611	.	T	C	5	7	12	0	1	13	0	0
25	15284734	.	G	T	17	14	31	0	0	31	0	0
25	15284799	.	C	T	14	6	20	0	1	21	0	0
25	15284862	.	T	C	14	21	35	0	0	35	0	0
25	15284979	.	T	A	14	21	35	0	0	35	0	0
25	15285092	.	T	C	13	9	22	0	1	23	0	0
25	15285105	.	C	A	14	10	24	0	0	24	0	0
25	15285202	.	A	C	7	15	22	0	1	23	0	0
25	15285213	.	G	C	16	10	26	0	0	26	0	0
25	15285255	.	C	A	10	12	22	0	1	23	0	0
25	15285256	.	T	A	11	11	22	0	1	23	0	0
25	15285374	.	A	G	8	11	19	0	1	20	0	0
25	15285384	.	G	A	10	11	21	0	1	22	0	0
25	15285470	.	C	T	6	7	13	0	0	13	0	0
25	15285471	.	C	A	6	7	13	0	0	13	0	0
25	15287216	.	G	A	2	3	5	0	0	5	0	0
25	15343016	.	C	A	3	4	7	0	1	8	0	0
25	15345474	.	C	A	4	2	6	0	1	7	0	0
25	15347852	.	G	A	0	2	2	0	2	4	0	0
25	15348533	.	G	A	0	3	3	0	2	5	0	0
25	15350012	.	A	G	3	4	7	0	0	7	0	0
25	15350058	.	A	G	2	3	5	0	1	6	0	0
25	15351088	.	A	G	5	4	9	0	1	10	0	0
25	15354222	.	T	C	9	6	15	0	1	16	0	0
25	15354333	.	G	T	9	12	21	0	0	21	0	0
25	15354360	.	C	T	9	13	22	0	2	24	0	0
25	15404898	.	G	A	18	16	34	0	0	34	0	0
25	15408816	.	G	A	0	13	13	0	16	29	0	0
25	15408820	.	G	A	0	13	13	0	16	29	0	0
25	15408883	.	G	A	15	23	38	0	1	39	0	0
25	15408918	.	C	T	18	25	43	0	2	45	0	0
25	15408939	.	C	T	21	23	44	0	1	45	0	0
25	15408987	.	G	T	1	17	18	0	16	34	0	0
25	15432769	.	G	A	10	5	15	0	0	15	0	0
25	15434479	.	T	A	8	9	17	0	1	18	0	0
25	15434579	.	C	T	8	5	13	0	0	13	0	0
25	15438789	.	C	A	2	1	3	0	0	3	0	0
25	15472103	.	C	T	20	20	40	0	1	41	0	0
25	15472286	.	C	A	20	29	49	0	0	49	0	0
25	15477186	.	G	A	0	12	12	0	7	19	0	0
25	15478092	.	A	G	4	10	14	0	1	15	0	0
25	15478474	.	T	C	2	3	5	0	0	5	0	0
25	15480676	.	G	A	1	19	20	0	7	27	0	0
25	15480712	.	T	C	30	19	49	0	1	50	0	0
25	15481040	.	C	T	12	8	20	0	2	22	0	0
25	15481481	.	T	G	14	11	25	0	0	25	0	0
25	15482014	.	A	T	8	10	18	0	0	18	0	0
25	15482138	.	A	G	10	0	10	0	16	26	0	0
25	15647886	.	C	T	3	3	6	0	0	6	0	0
25	15648042	.	G	A	6	6	12	0	0	12	0	0
25	15648092	.	A	G	9	9	18	0	0	18	0	0
25	15648237	.	T	A	8	7	15	0	1	16	0	0
25	15648243	.	C	A	5	8	13	0	0	14	1	0
25	15648330	.	C	A	6	11	17	0	1	18	0	0
25	15648342	.	G	C	7	8	15	0	0	15	0	0
25	15649992	.	G	A	2	6	8	0	0	8	0	0
25	16692783	.	G	A	5	2	7	0	0	7	0	0
25	17892352	.	A	T	5	1	6	0	1	7	0	0
25	18495989	.	T	C	4	2	6	0	0	6	0	0
25	18908651	.	A	G	7	4	11	0	0	11	0	0
25	18931039	.	G	T	0	1	1	0	1	2	0	0
25	18977092	.	A	G	2	4	6	0	0	6	0	0
25	18977347	.	A	G	4	7	11	0	1	12	0	0
25	18977360	.	A	G	10	2	12	0	0	12	0	0
25	19132008	.	T	C	0	0	0	0	2	2	0	0
25	19133092	.	G	C	0	2	2	0	0	2	0	0
25	19133167	.	G	A	4	3	7	0	0	7	0	0
25	19133191	.	A	G	4	2	6	0	0	6	0	0
25	19134470	.	C	T	0	3	3	0	0	3	0	0
25	19149330	.	C	T	1	2	3	0	0	3	0	0
25	19164147	.	G	A	0	4	4	0	0	4	0	0
25	19178206	.	T	C	2	3	5	0	0	5	0	0
25	19179081	.	C	A	4	7	11	0	0	11	0	0
25	19179150	.	G	A	0	1	1	0	0	1	0	0
25	19180159	.	C	T	2	4	6	0	0	6	0	0
25	19180222	.	G	T	0	0	0	0	1	1	0	0
25	19205783	.	G	C	10	3	13	0	0	13	0	0
25	19214347	.	T	C	0	0	0	0	1	1	0	0
25	19214352	.	A	T	0	1	1	0	0	1	0	0
25	19272728	.	C	T	1	1	2	0	0	2	0	0
25	19312623	.	C	T	1	1	2	0	0	2	0	0
25	19357346	.	A	C	32	24	56	0	3	60	1	0
25	19357359	.	T	G	33	25	58	0	2	60	0	0
25	19357782	.	G	C	21	18	39	0	0	39	0	0
25	19357800	.	T	C	20	19	39	0	1	40	0	0
25	19357934	.	G	A	28	17	45	0	1	46	0	0
25	19358924	.	T	A	11	19	30	0	0	30	0	0
25	19359191	.	T	C	9	8	17	0	3	20	0	0
25	19359205	.	G	A	8	9	17	0	1	18	0	0
25	19359314	.	G	A	22	16	38	0	2	40	0	0
25	19359402	.	A	G	14	22	36	0	1	37	0	0
25	19359640	.	C	T	1	21	22	0	19	41	0	0
25	19359734	.	A	G	21	25	46	0	1	47	0	0
25	19363994	.	G	C	19	0	19	0	10	29	0	0
25	19367753	.	A	T	12	16	28	0	1	30	1	0
25	19372175	.	C	T	11	9	20	0	4	24	0	0
25	19373330	.	G	A	7	8	15	0	0	15	0	0
25	19373597	.	C	T	2	6	8	0	1	9	0	0
25	19374332	.	A	G	2	3	5	0	0	5	0	0
25	19374649	.	G	T	2	0	2	0	0	2	0	0
25	19374697	.	C	T	2	0	2	0	0	2	0	0
25	19442955	.	G	A	2	2	4	0	0	4	0	0
25	19443356	.	C	T	30	24	54	0	4	58	0	0
25	19486270	.	C	T	0	16	16	0	7	23	0	0
25	19486287	.	G	T	13	14	27	0	1	28	0	0
25	19503073	.	T	A	0	1	1	0	0	1	0	0
25	19512981	.	G	A	3	1	4	0	0	4	0	0
25	19520520	.	C	T	2	1	3	0	0	3	0	0
25	19531854	.	G	A	2	0	2	0	0	2	0	0
25	19535338	.	C	T	0	2	2	0	1	3	0	0
25	19535374	.	G	A	3	4	7	0	0	7	0	0
25	19535727	.	G	T	2	2	4	0	0	4	0	0
25	19535746	.	C	T	2	2	4	0	0	4	0	0
25	19535782	.	G	T	3	2	5	0	0	5	0	0
25	19552841	.	G	C	0	1	1	0	2	3	0	0
25	19560285	.	G	A	2	2	4	0	0	4	0	0
25	19562558	.	G	A	2	2	4	0	0	4	0	0
25	19562756	.	C	T	2	1	3	0	0	3	0	0
25	19570692	.	A	G	2	2	4	0	0	4	0	0
25	19570725	.	T	A	1	3	4	0	0	4	0	0
25	19570873	.	A	G	1	5	6	0	0	6	0	0
25	19570995	.	T	G	4	1	5	0	0	5	0	0
25	19571018	.	A	G	1	1	2	0	0	2	0	0
25	19574054	.	T	C	2	4	6	0	0	6	0	0
25	19585916	.	C	A	4	3	7	0	1	8	0	0
25	19586249	.	A	T	7	1	8	0	0	8	0	0
25	19591549	.	C	T	3	2	5	0	1	6	0	0
25	19591844	.	T	C	4	6	10	0	0	10	0	0
25	19594008	.	T	C	10	5	15	0	0	15	0	0
25	19594011	.	A	C	10	5	15	0	0	15	0	0
25	19599841	.	T	C	1	2	3	0	0	3	0	0
25	19610021	.	C	T	0	2	2	0	0	2	0	0
25	19610645	.	G	A	3	4	7	0	0	7	0	0
25	19610708	.	G	T	1	2	3	0	0	3	0	0
25	19666713	.	C	T	1	1	2	0	0	2	0	0
25	19667602	.	G	C	0	2	2	0	5	7	0	0
25	19667653	.	T	C	3	3	6	0	0	6	0	0
25	19667669	.	C	T	2	3	5	0	0	5	0	0
25	19667960	.	A	G	0	2	2	0	1	3	0	0
25	19670365	.	A	G	3	2	5	0	0	5	0	0
25	19670378	.	C	T	2	2	4	0	0	4	0	0
25	19676240	.	C	T	0	4	4	0	0	4	0	0
25	19676241	.	G	A	0	4	4	0	0	4	0	0
25	19676276	.	C	A	5	2	7	0	0	7	0	0
25	19676426	.	C	A	4	3	7	0	0	7	0	0
25	19678631	.	T	A	1	2	3	0	0	3	0	0
25	20669202	.	T	G	0	3	3	0	1	4	0	0
25	20716591	.	T	C	0	1	1	0	0	1	0	0
25	20716627	.	G	A	5	9	14	0	0	14	0	0
25	20721482	.	A	C	3	5	8	0	0	9	1	0
25	20721502	.	C	T	2	5	7	0	1	8	0	0
25	20724822	.	G	A	0	1	1	0	1	2	0	0
25	20724879	.	G	A	11	9	20	0	0	20	0	0
25	20726609	.	C	T	1	1	2	0	0	2	0	0
25	20726626	.	G	A	0	1	1	0	1	2	0	0
25	20729919	.	G	A	1	3	4	0	0	4	0	0
25	20730031	.	G	A	2	4	6	0	0	6	0	0
25	20730660	.	T	A	6	1	7	0	1	8	0	0
25	20730663	.	A	G	8	1	9	0	0	9	0	0
25	20760221	.	G	A	3	6	9	0	0	9	0	0
25	20772953	.	C	T	1	2	3	0	0	3	0	0
25	20997813	.	C	T	0	4	4	0	1	5	0	0
25	20997950	.	T	C	1	0	1	0	6	7	0	0
25	20998037	.	A	G	4	6	10	0	0	10	0	0
25	20998134	.	A	G	6	3	9	0	0	9	0	0
25	20998245	.	T	C	11	7	18	0	1	19	0	0
25	20998250	.	G	T	11	6	17	0	0	17	0	0
25	20998945	.	G	A	1	2	3	0	0	3	0	0
25	20999104	.	G	A	2	2	4	0	0	4	0	0
25	20999140	.	T	A	2	4	6	0	1	7	0	0
25	20999203	.	A	G	5	8	13	0	0	13	0	0
25	21002097	.	C	G	2	2	4	0	0	4	0	0
25	21011816	.	A	T	1	2	3	0	0	3	0	0
25	21030882	.	A	T	1	2	3	0	0	3	0	0
25	21064154	.	C	T	2	4	6	0	1	7	0	0
25	21064337	.	A	T	1	4	5	0	0	5	0	0
25	21064361	.	C	G	1	3	4	0	0	4	0	0
25	21064519	.	T	A	5	5	10	0	1	11	0	0
25	21065071	.	G	A	4	7	11	0	1	12	0	0
25	21065237	.	T	C	2	7	9	0	0	9	0	0
25	21065345	.	A	G	3	8	11	0	0	11	0	0
25	21065447	.	A	G	4	3	7	0	0	7	0	0
25	21066092	.	G	A	3	2	5	0	1	6	0	0
25	21075410	.	G	T	5	5	10	0	1	11	0	0
25	21075710	.	C	T	0	3	3	0	4	7	0	0
25	21077571	.	A	C	0	0	0	0	3	3	0	0
25	21091634	.	C	A	0	3	3	0	7	10	0	0
25	21110624	.	T	C	3	3	6	0	0	6	0	0
25	21115672	.	T	C	12	14	26	0	1	27	0	0
25	21115761	.	A	G	10	11	21	0	0	21	0	0
25	21115784	.	C	A	8	14	22	0	0	22	0	0
25	21117001	.	A	T	0	4	4	0	0	4	0	0
25	21119687	.	G	A	11	13	24	0	0	24	0	0
25	21119843	.	T	A	2	1	3	0	0	3	0	0
25	21121788	.	A	G	7	15	22	0	0	22	0	0
25	21121964	.	C	T	3	2	5	0	0	5	0	0
25	21122011	.	A	G	11	11	22	0	0	22	0	0
25	21122194	.	T	C	9	11	20	0	2	22	0	0
25	21122266	.	T	A	8	13	21	0	2	23	0	0
25	21122490	.	C	T	4	2	6	0	0	6	0	0
25	21122535	.	A	T	1	2	3	0	0	3	0	0
25	21122540	.	C	A	1	1	2	0	0	2	0	0
25	21124889	.	A	T	10	19	29	0	0	29	0	0
25	21125108	.	A	G	10	5	15	0	0	15	0	0
25	21125289	.	C	G	12	14	26	0	0	26	0	0
25	21125391	.	T	C	12	13	25	0	1	26	0	0
25	21125583	.	C	T	0	2	2	0	3	5	0	0
25	21125676	.	T	A	6	4	10	0	0	10	0	0
25	21129836	.	A	T	0	1	1	0	0	1	0	0
25	21153642	.	A	G	5	5	10	0	0	10	0	0
25	21153664	.	T	A	7	5	12	0	0	12	0	0
25	21153735	.	T	C	2	5	7	0	0	7	0	0
25	21153759	.	T	A	6	4	10	0	0	10	0	0
25	21154418	.	G	T	3	0	3	0	3	6	0	0
25	21177396	.	A	G	10	0	10	0	7	17	0	0
25	21180649	.	G	T	2	3	5	0	0	5	0	0
25	21180658	.	C	T	3	2	5	0	1	6	0	0
25	21194387	.	C	T	3	3	6	0	1	7	0	0
25	21194552	.	C	T	8	14	22	0	0	22	0	0
25	21194663	.	A	T	16	13	29	0	0	29	0	0
25	21194672	.	T	C	14	10	24	0	0	24	0	0
25	21202349	.	C	T	2	2	4	0	0	4	0	0
25	21208597	.	G	A	4	0	4	0	0	4	0	0
25	21213122	.	G	T	4	6	10	0	1	11	0	0
25	21222077	.	T	C	11	11	22	0	0	22	0	0
25	21222128	.	G	A	2	0	2	0	0	2	0	0
25	21229668	.	G	C	8	8	16	0	1	17	0	0
25	21229677	.	G	A	5	6	11	0	1	12	0	0
25	21239861	.	A	G	7	10	17	0	0	17	0	0
25	21239870	.	G	A	5	5	10	0	0	10	0	0
25	21240198	.	G	A	0	2	2	0	3	5	0	0
25	21240258	.	G	A	0	0	0	0	2	2	0	0
25	21253106	.	C	T	14	15	29	0	0	29	0	0
25	21277832	.	T	C	5	0	5	0	2	7	0	0
25	21277839	.	T	C	2	4	6	0	0	6	0	0
25	21277892	.	C	A	0	6	6	1	6	13	0	0
25	21278235	.	G	A	5	3	8	0	0	8	0	0
25	21278244	.	A	G	5	3	8	0	0	8	0	0
25	21280449	.	T	C	1	0	1	0	2	3	0	0
25	21280506	.	T	G	5	5	10	0	0	10	0	0
25	21298540	.	C	T	0	2	2	0	0	2	0	0
25	21341712	.	T	A	5	6	11	0	0	11	0	0
25	21343250	.	A	C	10	8	18	0	1	19	0	0
25	21343340	.	G	C	18	10	28	0	0	28	0	0
25	21343358	.	C	T	12	15	27	0	0	27	0	0
25	21343476	.	G	A	12	9	21	0	0	21	0	0
25	21343843	.	C	T	16	12	28	0	3	31	0	0
25	21344201	.	T	G	8	16	24	0	2	26	0	0
25	21344417	.	A	G	4	4	8	0	0	8	0	0
25	21518033	.	G	T	1	7	8	0	0	8	0	0
25	21519943	.	C	T	0	2	2	0	2	4	0	0
25	21521229	.	T	A	2	2	4	0	0	4	0	0
25	21521236	.	C	G	2	2	4	0	0	4	0	0
25	21521360	.	C	T	0	2	2	0	2	4	0	0
25	21521365	.	T	G	2	2	4	0	0	4	0	0
25	21521428	.	A	G	2	2	4	0	0	4	0	0
25	21521442	.	T	C	3	0	3	0	2	5	0	0
25	21521504	.	T	A	3	2	5	0	0	5	0	0
25	21521666	.	A	G	1	4	5	0	0	5	0	0
25	21521764	.	G	A	3	2	5	0	0	5	0	0
25	21521993	.	T	A	1	3	4	0	0	4	0	0
25	21522481	.	A	T	1	2	3	0	0	3	0	0
25	21522503	.	T	A	0	3	3	0	0	3	0	0
25	21522690	.	A	T	2	3	5	0	0	5	0	0
25	21523345	.	A	T	2	3	5	0	0	5	0	0
25	21528828	.	A	G	4	3	7	0	0	7	0	0
25	21535738	.	G	A	1	3	4	0	0	4	0	0
25	21541179	.	G	A	1	4	5	0	0	5	0	0
25	21561823	.	C	T	2	0	2	0	0	2	0	0
25	21609733	.	A	T	1	0	1	0	0	1	0	0
25	21738460	.	G	A	1	0	1	0	0	1	0	0
25	21739116	.	T	C	3	1	4	0	1	5	0	0
25	21741480	.	G	A	0	0	0	0	1	1	0	0
25	21743630	.	G	A	4	2	6	0	0	6	0	0
25	21782389	.	G	A	8	10	18	0	1	19	0	0
25	21832972	.	C	T	3	6	9	0	1	10	0	0
25	21833163	.	A	G	16	17	33	0	0	33	0	0
25	21833307	.	C	T	29	29	58	0	2	60	0	0
25	21833308	.	G	T	1	30	31	0	29	60	0	0
25	21834976	.	G	A	0	5	5	0	4	9	0	0
25	21835093	.	T	C	23	23	46	0	1	47	0	0
25	21835126	.	A	T	14	11	25	0	0	25	0	0
25	21838627	.	A	T	4	5	9	0	0	9	0	0
25	21838951	.	G	A	3	8	11	0	0	11	0	0
25	21838963	.	A	G	2	8	10	0	1	11	0	0
25	21838993	.	T	C	3	6	9	0	1	10	0	0
25	21841487	.	G	A	6	5	11	0	0	11	0	0
25	21847233	.	C	T	47	31	78	0	1	80	1	0
25	21860819	.	T	C	2	0	2	0	1	3	0	0
25	21860999	.	C	A	14	6	20	0	0	20	0	0
25	21861041	.	G	A	7	12	19	0	0	19	0	0
25	21863477	.	C	T	4	6	10	0	0	10	0	0
25	21863540	.	C	T	1	5	6	0	0	6	0	0
25	21863600	.	G	T	3	2	5	0	4	9	0	0
25	21865988	.	C	T	0	8	8	0	4	12	0	0
25	21866386	.	G	A	3	2	5	0	0	5	0	0
25	21866404	.	C	T	0	2	2	0	3	5	0	0
25	21877548	.	C	T	0	0	0	0	1	1	0	0
25	21893897	.	G	C	2	5	7	0	0	7	0	0
25	21893958	.	T	G	5	2	7	0	0	7	0	0
25	23555815	.	C	T	0	7	7	0	9	16	0	0
25	23555852	.	T	C	11	0	11	0	13	24	0	0
25	23555998	.	A	T	3	10	13	0	2	15	0	0
25	23556047	.	G	A	4	14	18	0	0	18	0	0
25	23556240	.	A	T	2	9	11	0	0	11	0	0
25	23556254	.	C	T	3	11	14	0	1	15	0	0
25	23556378	.	C	G	6	4	10	0	1	11	0	0
25	23562487	.	C	T	0	1	1	0	9	10	0	0
25	23570933	.	G	A	1	3	4	0	1	5	0	0
25	24583152	.	C	A	2	3	5	0	4	9	0	0
25	24583223	.	C	T	1	0	1	0	0	1	0	0
25	24583450	.	C	T	1	3	4	0	0	4	0	0
25	24593493	.	G	A	0	0	0	0	1	1	0	0
25	24594153	.	T	C	5	3	8	0	0	8	0	0
25	24594163	.	C	T	4	3	7	0	0	7	0	0
25	24594276	.	T	C	5	3	8	0	2	10	0	0
25	24594339	.	C	T	7	2	9	0	0	9	0	0
25	24594394	.	T	C	5	1	6	0	0	6	0	0
25	24594399	.	T	C	5	2	7	0	0	7	0	0
25	24594633	.	A	G	8	0	8	0	5	13	0	0
25	24598826	.	C	A	2	5	7	0	0	7	0	0
25	24598869	.	T	C	3	5	8	0	0	8	0	0
25	24605595	.	G	T	1	4	5	0	0	5	0	0
25	24605598	.	A	C	1	3	4	0	1	5	0	0
25	24607933	.	A	G	4	0	4	0	3	7	0	0
25	24609463	.	T	A	4	1	5	0	0	5	0	0
25	24609656	.	G	A	2	3	5	0	1	6	0	0
25	24610543	.	A	T	6	3	9	0	0	9	0	0
25	24610544	.	A	G	6	3	9	0	0	9	0	0
25	24708767	.	C	T	2	3	5	0	0	5	0	0
25	24723129	.	G	A	3	4	7	0	1	8	0	0
25	24736314	.	T	G	2	5	7	0	1	8	0	0
25	24736669	.	A	C	3	6	9	0	0	9	0	0
25	24736828	.	A	T	5	2	7	0	0	7	0	0
25	24736921	.	G	A	1	4	5	0	0	5	0	0
25	24737940	.	A	C	4	3	7	0	0	7	0	0
25	24737961	.	C	T	3	3	6	0	0	6	0	0
25	24738084	.	T	C	13	0	13	0	11	24	0	0
25	24738155	.	T	A	3	7	10	0	0	10	0	0
25	24738810	.	C	A	2	2	4	0	0	4	0	0
25	24738826	.	G	A	2	4	6	0	0	6	0	0
25	24738892	.	G	A	9	5	14	0	0	14	0	0
25	24739029	.	A	G	6	7	13	0	0	13	0	0
25	24752103	.	T	C	4	3	7	0	0	7	0	0
25	24752175	.	G	A	5	10	15	0	1	16	0	0
25	24752181	.	A	G	5	11	16	0	0	16	0	0
25	24752211	.	C	T	0	6	6	0	3	9	0	0
25	24763746	.	A	G	3	1	4	0	0	4	0	0
25	24763755	.	G	T	4	2	6	0	0	6	0	0
25	24763914	.	C	T	3	7	10	0	0	10	0	0
25	24770089	.	G	A	1	0	1	0	0	1	0	0
25	24792647	.	C	A	2	2	4	0	0	4	0	0
25	24826237	.	G	T	1	3	4	0	0	4	0	0
25	24826240	.	T	C	1	0	1	0	4	5	0	0
25	24826290	.	A	G	1	2	3	0	0	3	0	0
25	25058180	.	C	T	3	4	7	0	0	7	0	0
25	25058334	.	A	C	5	0	5	0	6	11	0	0
25	25123444	.	G	T	3	5	8	0	0	8	0	0
25	25123445	.	T	C	3	5	8	0	0	8	0	0
25	25124779	.	A	T	7	10	17	0	3	20	0	0
25	25127673	.	G	A	0	9	9	0	5	14	0	0
25	25130749	.	G	C	21	10	31	0	1	32	0	0
25	25130782	.	G	A	20	15	35	0	2	37	0	0
25	25130908	.	C	T	23	21	44	0	0	44	0	0
25	25130968	.	C	T	26	22	48	0	0	48	0	0
25	25131165	.	G	A	1	7	8	0	0	8	0	0
25	25131298	.	A	T	7	23	30	0	3	33	0	0
25	25131427	.	G	A	22	15	37	0	1	38	0	0
25	25132985	.	C	T	11	7	18	0	0	18	0	0
25	25133030	.	G	A	13	6	19	0	1	20	0	0
25	25133104	.	G	A	14	11	25	0	1	26	0	0
25	25133123	.	T	G	11	15	26	0	1	27	0	0
25	25133171	.	A	G	9	16	25	0	0	25	0	0
25	25133353	.	G	A	6	14	20	0	0	20	0	0
25	25133365	.	T	A	9	16	25	0	2	27	0	0
25	25133509	.	A	G	6	3	9	0	0	9	0	0
25	25133721	.	G	A	13	11	24	0	0	24	0	0
25	25142127	.	G	A	9	4	13	0	2	18	3	0
25	25142171	.	T	C	8	5	13	0	0	13	0	0
25	25142202	.	T	A	9	3	12	0	1	13	0	0
25	25396237	.	T	C	5	20	25	0	0	25	0	0
25	25396295	.	T	C	0	5	5	0	0	5	0	0
25	25446832	.	C	G	0	3	3	0	1	4	0	0
25	25488291	.	G	A	2	2	4	0	0	4	0	0
25	25488445	.	A	T	3	2	5	0	0	5	0	0
25	25488460	.	T	A	4	2	6	0	0	6	0	0
25	25488555	.	G	C	3	2	5	0	0	5	0	0
25	25488588	.	A	C	2	2	4	0	0	4	0	0
25	25488772	.	T	G	3	4	7	0	0	7	0	0
25	25509245	.	A	G	1	0	1	0	0	1	0	0
25	25509254	.	C	T	1	0	1	0	0	1	0	0
25	25536394	.	C	A	5	1	6	0	0	6	0	0
25	25536661	.	A	T	4	2	6	0	0	6	0	0
25	25538354	.	T	A	6	7	13	0	0	13	0	0
25	25538624	.	C	A	2	3	5	0	0	5	0	0
25	25538786	.	T	G	2	0	2	0	7	9	0	0
25	25539199	.	G	T	4	2	6	0	1	7	0	0
25	25539270	.	C	A	4	6	10	0	0	10	0	0
25	25539434	.	G	A	0	4	4	0	3	7	0	0
25	25539539	.	C	A	5	7	12	0	0	12	0	0
25	25539723	.	C	A	11	9	20	0	0	20	0	0
25	25540058	.	T	A	2	2	4	0	0	4	0	0
25	25540060	.	G	A	2	2	4	0	0	4	0	0
25	25540181	.	A	T	3	6	9	0	0	9	0	0
25	25540245	.	A	G	5	2	7	0	0	7	0	0
25	25540312	.	C	A	8	4	12	0	0	12	0	0
25	25540935	.	A	G	5	0	5	0	9	14	0	0
25	25540954	.	G	A	8	4	12	0	0	12	0	0
25	25542708	.	C	T	3	2	5	0	0	5	0	0
25	25544468	.	C	T	7	6	13	0	0	13	0	0
25	25545007	.	G	A	4	4	8	0	0	8	0	0
25	25545654	.	T	C	1	1	2	0	0	2	0	0
25	25546053	.	G	A	4	4	8	0	0	8	0	0
25	25547137	.	C	A	3	2	5	0	0	5	0	0
25	25548220	.	G	C	2	2	4	0	0	4	0	0
25	25565303	.	T	C	2	4	6	0	1	7	0	0
25	25565351	.	C	T	3	2	5	0	0	5	0	0
25	25566006	.	A	G	0	3	3	0	0	3	0	0
25	25566063	.	A	T	1	2	3	0	1	4	0	0
25	25566069	.	C	A	1	3	4	0	0	4	0	0
25	25566288	.	G	C	5	2	7	0	0	7	0	0
25	25594104	.	A	G	2	3	5	0	0	5	0	0
25	25594240	.	G	A	1	2	3	0	1	4	0	0
25	25594348	.	C	T	0	2	2	0	2	4	0	0
25	25595684	.	A	C	1	0	1	0	0	1	0	0
25	25806264	.	C	T	14	6	20	0	1	21	0	0
25	25823529	.	T	C	5	6	11	0	1	12	0	0
25	26739161	.	G	T	6	5	11	0	0	11	0	0
25	26739184	.	T	C	4	6	10	0	0	10	0	0
25	26739579	.	C	T	1	0	1	0	0	1	0	0
25	26743379	.	G	C	0	3	3	0	0	3	0	0
25	26747970	.	G	A	1	0	1	0	0	1	0	0
25	26811965	.	T	G	1	0	1	0	0	1	0	0
25	26813023	.	A	C	1	4	5	0	0	5	0	0
25	26813323	.	G	T	0	2	2	0	0	2	0	0
25	26821795	.	T	C	1	1	2	0	0	2	0	0
25	26821844	.	A	T	1	5	6	0	0	6	0	0
25	26822823	.	C	T	0	3	3	0	0	3	0	0
25	26823244	.	C	T	2	2	4	0	0	4	0	0
25	26827274	.	T	C	3	1	4	0	0	4	0	0
25	26827435	.	T	C	2	3	5	0	0	5	0	0
25	26827440	.	A	G	2	3	5	0	0	5	0	0
25	26829261	.	C	T	1	3	4	0	0	4	0	0
25	26829266	.	G	T	0	3	3	0	1	4	0	0
25	26829918	.	A	G	2	0	2	0	0	2	0	0
25	26832023	.	A	G	2	4	6	0	0	6	0	0
25	26840452	.	G	T	7	10	17	0	1	18	0	0
25	26854734	.	T	C	0	2	2	0	0	2	0	0
25	26854875	.	G	T	1	1	2	0	0	2	0	0
25	26867671	.	A	T	1	3	4	0	0	4	0	0
25	26877783	.	A	T	7	14	21	0	0	21	0	0
25	26877865	.	A	T	10	5	15	0	0	15	0	0
25	26877966	.	A	G	3	1	4	0	0	4	0	0
25	26879592	.	T	C	10	5	15	0	0	15	0	0
25	26884286	.	G	A	9	15	24	0	0	24	0	0
25	26884407	.	C	T	4	4	8	0	0	8	0	0
25	26888170	.	A	G	2	4	6	0	2	8	0	0
25	26909013	.	C	T	2	5	7	0	2	9	0	0
25	26909197	.	G	A	6	6	12	0	0	12	0	0
25	26909269	.	A	G	4	9	13	0	1	14	0	0
25	26909392	.	A	T	12	10	22	0	1	23	0	0
25	26909618	.	A	C	7	8	15	0	0	15	0	0
25	26911428	.	A	C	5	2	7	0	0	7	0	0
25	26911554	.	T	A	6	7	13	0	2	15	0	0
25	26911605	.	C	A	7	4	11	0	1	12	0	0
25	26911768	.	A	G	5	5	10	0	0	10	0	0
25	26911792	.	G	A	3	4	7	0	0	7	0	0
25	26912037	.	C	T	5	7	12	0	1	13	0	0
25	26912062	.	C	T	2	2	4	0	0	4	0	0
25	26923055	.	C	T	4	6	10	0	0	10	0	0
25	26923177	.	G	A	4	3	7	0	1	8	0	0
25	26923426	.	T	C	1	2	3	0	0	3	0	0
25	26923438	.	T	C	2	3	5	0	0	5	0	0
25	26923579	.	T	C	2	5	7	0	1	8	0	0
25	27089335	.	G	A	2	3	5	0	0	5	0	0
25	27089349	.	G	A	1	3	4	0	0	4	0	0
25	27092669	.	C	G	5	5	10	0	1	11	0	0
25	27173849	.	G	A	6	9	15	0	0	15	0	0
25	27173979	.	G	A	9	6	15	0	0	15	0	0
25	27174065	.	C	T	2	3	5	0	0	5	0	0
25	27174323	.	C	T	8	7	15	0	0	15	0	0
25	27174500	.	G	A	8	10	18	0	0	18	0	0
25	27477746	.	A	G	2	2	4	0	0	4	0	0
25	27488803	.	T	A	0	1	1	0	0	1	0	0
25	27493723	.	A	T	2	4	6	0	1	7	0	0
25	27493728	.	T	C	2	3	5	0	2	7	0	0
25	27494044	.	T	C	1	2	3	0	0	3	0	0
25	27494536	.	G	A	1	2	3	0	0	3	0	0
25	27499304	.	T	A	2	3	5	0	0	5	0	0
25	27543087	.	T	C	2	3	5	0	0	5	0	0
25	27715164	.	T	G	6	7	13	0	1	14	0	0
25	27715423	.	A	T	4	2	6	0	0	6	0	0
25	27715468	.	G	A	3	7	10	0	0	10	0	0
25	27715499	.	T	A	7	4	11	0	0	11	0	0
25	27715535	.	C	G	3	3	6	0	0	6	0	0
25	27716160	.	C	T	0	3	3	0	5	8	0	0
25	27716204	.	C	A	11	4	15	0	1	16	0	0
25	27716265	.	T	C	14	7	21	0	0	21	0	0
25	27716270	.	A	T	13	7	20	0	1	21	0	0
25	27716374	.	G	A	0	1	1	0	0	1	0	0
25	27763514	.	A	T	2	1	3	0	0	3	0	0
25	27788094	.	T	C	7	5	12	0	0	12	0	0
25	27788109	.	C	T	10	6	16	0	1	17	0	0
25	27795086	.	G	A	7	4	11	0	0	11	0	0
25	27801783	.	A	T	11	9	20	0	12	32	0	0
25	27801873	.	T	G	3	0	3	0	18	21	0	0
25	27801876	.	A	C	4	1	5	0	13	18	0	0
25	27802005	.	C	T	13	8	21	0	0	21	0	0
25	27802122	.	C	A	6	11	17	0	1	18	0	0
25	27802149	.	G	A	3	7	10	0	0	10	0	0
25	27806800	.	C	T	6	5	11	0	0	11	0	0
25	27811761	.	C	T	15	18	33	0	4	37	0	0
25	27995812	.	G	A	2	5	7	0	0	7	0	0
25	28120150	.	C	T	0	2	2	0	0	2	0	0
25	28122051	.	C	T	5	3	8	0	0	8	0	0
25	28222152	.	T	C	0	2	2	0	1	3	0	0
25	28229540	.	C	T	0	2	2	0	0	2	0	0
25	28240151	.	T	C	4	6	10	0	0	10	0	0
25	28244242	.	A	T	3	2	5	0	0	5	0	0
25	28269652	.	T	C	4	0	4	1	3	8	0	0
25	28269735	.	T	C	3	5	8	0	0	8	0	0
25	28287661	.	G	A	0	2	2	0	0	2	0	0
25	28317616	.	C	T	1	2	3	0	0	3	0	0
25	28317697	.	C	T	2	2	4	0	0	4	0	0
25	28320664	.	G	C	2	1	3	0	0	3	0	0
25	28322663	.	T	C	2	1	3	0	0	3	0	0
25	28322671	.	T	A	2	3	5	0	0	5	0	0
25	28322704	.	G	A	2	3	5	0	0	5	0	0
25	28323054	.	A	C	0	4	4	0	0	4	0	0
25	28332778	.	A	G	2	3	5	0	1	6	0	0
25	28334272	.	C	T	2	4	6	0	1	7	0	0
25	28335178	.	C	G	2	3	5	0	0	5	0	0
25	28335569	.	C	T	2	2	4	0	0	4	0	0
25	28335576	.	T	C	4	2	6	0	0	6	0	0
25	28335632	.	C	A	6	2	8	0	3	11	0	0
25	28335744	.	G	A	0	4	4	0	5	9	0	0
25	28369239	.	G	A	0	1	1	0	0	1	0	0
25	28376926	.	A	G	2	0	2	0	1	3	0	0
25	28379830	.	A	T	0	1	1	0	1	2	0	0
25	28383467	.	G	A	3	2	5	0	0	5	0	0
25	28383715	.	T	G	2	5	7	0	0	7	0	0
25	28384672	.	C	T	0	2	2	0	1	3	0	0
25	28384702	.	A	G	1	3	4	0	0	4	0	0
25	28399698	.	C	T	0	1	1	0	0	1	0	0
25	28589719	.	C	A	6	2	8	0	0	8	0	0
25	28640526	.	G	A	7	3	10	0	1	11	0	0
25	28640599	.	G	A	8	7	15	0	0	15	0	0
25	28640662	.	G	A	16	10	26	0	2	28	0	0
25	28640724	.	T	G	24	16	40	0	3	43	0	0
25	28640890	.	T	G	18	18	36	0	1	37	0	0
25	28641005	.	A	C	10	8	18	0	0	18	0	0
25	28641207	.	A	T	6	5	11	0	3	14	0	0
25	28641215	.	A	T	12	3	15	0	0	15	0	0
25	28641261	.	T	A	12	11	23	0	1	24	0	0
25	28641321	.	T	G	18	14	32	0	0	32	0	0
25	28648067	.	T	C	1	0	1	0	0	1	0	0
25	28648078	.	A	G	3	2	5	0	0	5	0	0
25	28648166	.	G	A	14	12	26	0	1	27	0	0
25	28650812	.	G	A	12	10	22	0	0	22	0	0
25	28652511	.	G	A	16	18	34	0	1	35	0	0
25	28655056	.	G	A	1	0	1	0	0	1	0	0
25	28656024	.	G	C	1	6	7	0	0	7	0	0
25	28656078	.	G	T	1	4	5	0	0	5	0	0
25	28661185	.	C	T	2	2	4	0	0	4	0	0
25	28661227	.	T	C	8	6	14	0	1	15	0	0
25	28661279	.	T	C	12	11	23	0	0	23	0	0
25	28661626	.	G	A	4	5	9	0	0	9	0	0
25	28665386	.	T	A	5	4	9	0	1	10	0	0
25	28665464	.	A	C	4	7	11	0	0	11	0	0
25	28668046	.	G	T	1	1	2	0	0	2	0	0
25	28668614	.	T	C	10	5	15	0	1	16	0	0
25	28668627	.	G	A	14	9	23	0	0	23	0	0
25	28668746	.	G	T	6	4	10	0	0	10	0	0
25	28714616	.	A	G	2	3	5	0	0	5	0	0
25	28714796	.	C	G	5	2	7	0	1	8	0	0
25	28714804	.	G	A	5	2	7	0	0	7	0	0
25	28715421	.	T	C	5	5	10	0	0	10	0	0
25	28715605	.	C	G	0	3	3	0	2	5	0	0
25	28715631	.	T	A	0	2	2	0	1	3	0	0
25	28716206	.	G	A	5	3	8	0	1	9	0	0
25	28719957	.	T	G	0	1	1	0	0	1	0	0
25	28726537	.	C	A	0	5	5	0	2	7	0	0
25	28726788	.	G	T	5	2	7	0	0	7	0	0
25	28726797	.	C	T	0	1	1	0	6	7	0	0
25	28736679	.	C	T	0	4	4	0	0	4	0	0
25	28737007	.	A	T	2	1	3	0	0	3	0	0
25	28739882	.	A	G	0	4	4	0	0	4	0	0
25	28739891	.	A	G	0	1	1	0	0	1	0	0
25	28745128	.	A	G	0	2	2	0	0	2	0	0
25	28745260	.	G	A	2	2	4	0	0	4	0	0
25	28745266	.	C	T	2	2	4	0	0	4	0	0
25	28752579	.	C	T	0	4	4	0	1	5	0	0
25	28768464	.	C	T	1	2	3	0	0	3	0	0
25	28825652	.	G	C	2	1	3	0	0	3	0	0
25	28826630	.	A	G	3	0	3	0	3	6	0	0
25	28827752	.	A	G	2	0	2	0	1	3	0	0
25	28846383	.	G	T	1	10	11	0	16	27	0	0
25	28893652	.	A	G	3	0	3	0	2	5	0	0
25	28893665	.	T	A	5	5	10	0	0	10	0	0
25	28893713	.	C	A	12	7	19	0	0	19	0	0
25	28893956	.	C	T	7	6	13	0	0	13	0	0
25	28903105	.	A	C	7	11	18	0	1	19	0	0
25	28903253	.	A	G	3	0	3	0	3	6	0	0
25	28907830	.	A	T	1	4	5	0	0	5	0	0
25	28907971	.	T	C	3	0	3	0	3	6	0	0
25	28907997	.	A	G	3	3	6	0	0	6	0	0
25	29000604	.	A	G	1	2	3	0	0	3	0	0
25	29076852	.	T	A	3	1	4	0	0	4	0	0
25	29080112	.	G	A	5	6	11	0	0	11	0	0
25	29084154	.	G	A	1	2	3	0	0	3	0	0
25	29087845	.	T	C	1	0	1	0	4	5	0	0
25	29087859	.	T	C	1	0	1	0	2	3	0	0
25	29103743	.	A	T	1	2	3	0	0	3	0	0
25	29109251	.	G	A	1	0	1	0	0	1	0	0
25	29212008	.	G	A	3	2	5	0	0	5	0	0
25	29212167	.	G	T	2	3	5	0	1	6	0	0
25	29212302	.	C	T	0	4	4	0	4	8	0	0
25	29212476	.	T	C	2	2	4	0	0	4	0	0
25	29212780	.	A	T	4	2	6	0	0	6	0	0
25	29212781	.	C	G	0	2	2	0	4	6	0	0
25	29212851	.	G	T	6	3	9	0	1	10	0	0
25	29212986	.	A	G	3	3	6	0	0	6	0	0
25	29213001	.	G	C	4	3	7	0	0	7	0	0
25	29213804	.	A	G	4	2	6	0	0	6	0	0
25	29231956	.	C	T	0	1	1	0	0	1	0	0
25	29319097	.	A	G	25	24	49	0	0	49	0	0
25	29319239	.	A	T	12	21	33	0	2	35	0	0
25	29319706	.	T	C	35	4	39	0	32	71	0	0
25	29319712	.	A	G	33	34	67	0	1	68	0	0
25	29319831	.	A	G	26	14	40	0	4	44	0	0
25	29319849	.	G	A	18	11	29	0	0	29	0	0
25	29329949	.	A	G	23	18	41	0	5	46	0	0
25	29428094	.	A	G	12	14	26	0	1	27	0	0
25	29428300	.	C	A	13	12	25	0	2	27	0	0
25	29428638	.	A	G	11	14	25	0	0	25	0	0
25	29428806	.	T	A	14	10	24	0	1	25	0	0
25	29428963	.	G	A	15	22	37	0	0	37	0	0
25	29429187	.	A	G	8	12	20	0	1	21	0	0
25	29429420	.	G	A	18	16	34	0	1	35	0	0
25	29429569	.	T	C	12	0	12	0	13	25	0	0
25	29429589	.	G	T	11	9	20	0	2	22	0	0
25	29429732	.	A	T	4	5	9	0	1	10	0	0
25	29429984	.	T	C	10	0	10	0	12	22	0	0
25	29444782	.	A	G	5	2	7	0	0	7	0	0
25	29662642	.	T	C	2	7	9	0	0	9	0	0
25	29662739	.	C	T	11	5	16	0	1	17	0	0
25	29663116	.	T	G	4	5	9	0	0	9	0	0
25	29664955	.	T	C	5	2	7	0	0	7	0	0
25	29665705	.	G	A	0	7	7	0	9	16	0	0
25	29666170	.	T	G	9	0	9	0	6	15	0	0
25	29666299	.	A	G	16	8	24	0	0	24	0	0
25	29666607	.	G	T	3	2	5	0	0	5	0	0
25	29666640	.	T	A	4	3	7	0	0	7	0	0
25	29666797	.	T	A	3	6	9	0	0	9	0	0
25	29688802	.	G	A	1	3	4	0	1	5	0	0
25	29688824	.	C	T	1	3	4	0	0	4	0	0
25	29688844	.	T	C	1	2	3	0	0	3	0	0
25	29694272	.	T	A	1	5	6	0	0	6	0	0
25	29694545	.	A	G	3	8	11	0	0	11	0	0
25	29695316	.	G	A	0	3	3	0	2	5	0	0
25	29696881	.	A	G	1	4	5	0	1	6	0	0
25	29696896	.	A	G	0	0	0	0	1	1	0	0
25	29697015	.	G	A	3	0	3	0	0	3	0	0
25	29697064	.	C	T	6	7	13	0	0	13	0	0
25	29697625	.	A	G	1	0	1	0	2	3	0	0
25	29698784	.	C	T	2	5	7	0	2	9	0	0
25	29698922	.	A	T	4	3	7	0	0	7	0	0
25	29699018	.	G	A	2	1	3	0	0	3	0	0
25	29699227	.	T	C	1	1	2	0	1	3	0	0
25	29699236	.	A	T	1	2	3	0	0	3	0	0
25	29711597	.	A	T	6	3	9	0	1	10	0	0
25	29711754	.	C	A	4	4	8	0	2	10	0	0
25	32216389	.	A	G	3	1	4	0	9	13	0	0
25	32739551	.	C	T	2	2	4	0	1	5	0	0
25	32886471	.	C	T	2	2	4	0	0	4	0	0
25	33050967	.	T	C	1	0	1	0	0	1	0	0
25	33065530	.	A	G	2	0	2	0	1	3	0	0
25	33065551	.	C	T	3	2	5	0	0	5	0	0
25	33065593	.	T	C	2	1	3	0	0	3	0	0
25	33065605	.	C	T	1	1	2	0	0	2	0	0
25	33067793	.	C	T	0	1	1	0	0	1	0	0
25	33081889	.	A	G	1	3	4	0	0	4	0	0
25	33091554	.	A	G	1	0	1	0	0	1	0	0
25	33093485	.	T	C	1	4	5	0	0	5	0	0
25	33104491	.	T	C	3	7	10	0	0	10	0	0
25	33104494	.	T	C	3	7	10	0	0	10	0	0
25	33121219	.	T	C	3	1	4	0	0	4	0	0
25	33121740	.	C	T	2	5	7	0	0	7	0	0
25	33121782	.	A	G	1	1	2	0	6	8	0	0
25	33145031	.	C	T	2	0	2	0	1	3	0	0
25	33192787	.	A	C	1	0	1	0	2	3	0	0
25	33194649	.	A	G	2	1	3	0	0	3	0	0
25	33194667	.	A	C	0	1	1	0	0	1	0	0
25	33225248	.	A	G	4	15	19	0	0	19	0	0
25	33225287	.	G	A	8	19	27	0	0	27	0	0
25	33238303	.	G	A	0	2	2	0	1	3	0	0
25	33238370	.	C	T	4	2	6	0	0	6	0	0
25	33238373	.	T	A	4	1	5	0	0	5	0	0
25	33239533	.	G	A	0	2	2	0	3	5	0	0
25	33239557	.	T	G	4	2	6	0	0	6	0	0
25	33239682	.	C	T	3	3	6	0	0	6	0	0
25	33242605	.	A	T	2	3	5	0	1	6	0	0
25	33242606	.	T	G	3	2	5	0	1	6	0	0
25	33249905	.	T	G	16	13	29	0	2	31	0	0
25	33250017	.	C	A	5	10	15	0	1	16	0	0
25	33250053	.	A	G	14	11	25	0	0	25	0	0
25	33258739	.	G	A	0	5	5	0	4	9	0	0
25	33258745	.	T	G	5	0	5	0	5	10	0	0
25	33258811	.	A	G	2	0	2	0	2	4	0	0
25	33258817	.	C	T	1	2	3	0	0	3	0	0
25	33259568	.	A	G	3	0	3	0	5	8	0	0
25	33262180	.	A	G	5	8	13	0	0	13	0	0
25	33265759	.	A	G	1	1	2	0	0	2	0	0
25	33265814	.	C	T	8	4	12	0	0	12	0	0
25	33265898	.	C	T	7	4	11	0	2	13	0	0
25	33266029	.	G	A	4	10	14	0	0	14	0	0
25	33266128	.	A	G	5	0	5	0	5	10	0	0
25	33962809	.	G	A	0	8	8	0	11	19	0	0
25	33963168	.	C	A	14	6	20	0	0	20	0	0
25	33963427	.	A	T	6	6	12	0	1	13	0	0
25	33964506	.	A	C	2	3	5	0	0	5	0	0
25	33964791	.	A	G	9	4	13	0	0	13	0	0
25	33964962	.	A	G	8	9	17	0	0	17	0	0
25	33964968	.	A	G	4	8	12	0	3	15	0	0
25	33965016	.	C	A	1	5	6	0	0	6	0	0
25	33965238	.	A	G	2	3	5	0	0	5	0	0
25	33965251	.	G	A	0	3	3	0	2	5	0	0
25	33965518	.	G	T	4	2	6	0	0	6	0	0
25	33965541	.	C	T	10	3	13	0	0	13	0	0
25	33965695	.	C	T	5	4	9	0	0	9	0	0
25	33965786	.	T	C	3	1	4	0	0	4	0	0
25	33965974	.	A	C	8	9	17	0	1	18	0	0
25	33966100	.	G	A	6	5	11	0	0	11	0	0
25	33966251	.	T	G	10	7	17	0	1	18	0	0
25	33966585	.	C	G	11	0	11	0	8	19	0	0
25	33966731	.	T	C	8	9	17	0	0	17	0	0
25	33966854	.	C	T	7	13	20	0	0	20	0	0
25	33966969	.	T	A	5	5	10	0	0	10	0	0
25	33967133	.	T	A	8	8	16	0	2	18	0	0
25	33967361	.	A	G	13	7	20	0	0	20	0	0
25	33967495	.	T	C	7	10	17	0	0	17	0	0
25	33967695	.	T	C	8	5	13	0	0	13	0	0
25	33967791	.	C	T	9	6	15	0	1	16	0	0
25	33968091	.	C	T	6	10	16	0	0	16	0	0
25	33968470	.	T	A	3	7	10	0	0	10	0	0
25	33968691	.	A	G	6	11	17	0	0	17	0	0
25	33968842	.	G	C	15	10	25	0	1	26	0	0
25	33968857	.	C	T	14	12	26	0	3	29	0	0
25	33968881	.	T	A	12	12	24	0	0	24	0	0
25	33983031	.	G	A	3	4	7	0	0	7	0	0
25	33983286	.	C	T	7	4	11	0	0	11	0	0
25	33983303	.	T	C	7	5	12	0	0	12	0	0
25	33987881	.	A	G	0	2	2	0	0	2	0	0
25	33988893	.	G	A	1	1	2	0	0	2	0	0
25	33988899	.	T	C	1	2	3	0	0	3	0	0
25	33988928	.	A	T	1	5	6	0	0	6	0	0
25	34002853	.	T	C	5	8	13	0	0	13	0	0
25	34017089	.	A	G	1	3	4	0	0	4	0	0
25	34018537	.	C	T	4	5	9	0	0	9	0	0
25	34022288	.	T	C	5	5	10	0	0	10	0	0
25	34022309	.	T	C	4	5	9	0	0	9	0	0
25	34027086	.	A	T	12	11	23	0	1	24	0	0
25	34027215	.	C	A	11	5	16	0	0	16	0	0
25	34027263	.	G	T	6	6	12	0	0	12	0	0
25	34154496	.	A	T	4	13	17	0	1	18	0	0
25	34154540	.	T	G	7	13	20	0	1	21	0	0
25	34154678	.	G	A	14	16	30	0	2	32	0	0
25	34246669	.	G	T	0	7	7	0	2	9	0	0
25	34246687	.	A	T	2	7	9	0	0	9	0	0
25	34246947	.	C	T	1	3	4	0	0	4	0	0
25	34247047	.	T	G	1	0	1	0	3	4	0	0
25	34257427	.	T	C	2	3	5	0	0	5	0	0
25	34257433	.	G	A	3	3	6	0	0	6	0	0
25	34267634	.	T	A	2	2	4	0	0	4	0	0
25	34267764	.	C	A	1	2	3	0	0	3	0	0
25	34267800	.	C	G	0	2	2	0	0	2	0	0
25	34267806	.	G	T	1	3	4	0	0	4	0	0
25	34421753	.	C	T	2	4	6	0	0	6	0	0
25	34456976	.	A	G	5	3	8	0	0	8	0	0
25	34457251	.	G	C	8	4	12	0	1	13	0	0
25	34457558	.	T	C	4	4	8	0	0	8	0	0
25	34457564	.	G	A	4	4	8	0	0	8	0	0
25	34457663	.	C	T	6	2	8	0	0	8	0	0
25	34457841	.	A	T	3	9	12	0	1	13	0	0
25	34458131	.	A	C	3	1	4	0	1	5	0	0
25	34458206	.	C	T	9	3	12	0	0	12	0	0
25	34487733	.	T	C	3	0	3	0	3	6	0	0
25	34487775	.	G	A	5	5	10	0	0	10	0	0
25	34487895	.	C	G	0	10	10	0	4	14	0	0
25	34488111	.	A	G	4	5	9	0	0	9	0	0
25	34488373	.	T	A	6	3	9	0	1	10	0	0
25	34488650	.	T	C	4	3	7	0	0	7	0	0
25	34489315	.	G	T	3	6	9	0	0	9	0	0
25	34511600	.	A	G	7	4	11	0	0	11	0	0
25	34511604	.	T	C	6	4	10	0	0	10	0	0
25	34511741	.	T	C	3	7	10	0	1	11	0	0
25	34511852	.	C	A	1	14	15	0	2	17	0	0
25	34511927	.	T	C	4	8	12	0	0	12	0	0
25	34511963	.	C	A	5	7	12	0	0	12	0	0
25	34643918	.	G	A	4	6	10	0	0	10	0	0
25	34647825	.	A	G	1	2	3	0	3	6	0	0
25	34649896	.	T	C	2	4	6	0	0	6	0	0
25	34649907	.	A	C	2	4	6	0	0	6	0	0
25	34662400	.	C	A	8	3	11	0	0	11	0	0
25	34662430	.	A	G	11	4	15	0	0	15	0	0
25	34670411	.	C	A	1	1	2	0	0	2	0	0
25	34697157	.	G	A	4	3	7	0	0	7	0	0
25	34703720	.	A	G	3	2	5	0	0	5	0	0
25	34704377	.	G	A	0	5	5	0	0	5	0	0
25	34706860	.	T	C	0	1	1	0	0	1	0	0
25	34706944	.	G	A	2	4	6	0	0	6	0	0
25	34707777	.	G	A	1	3	4	0	0	4	0	0
25	34709562	.	T	G	1	0	1	0	0	1	0	0
25	34714287	.	T	C	1	0	1	0	2	3	0	0
25	34718587	.	T	C	1	0	1	0	2	3	0	0
25	34728053	.	C	A	1	3	4	0	0	4	0	0
25	34728068	.	A	G	1	3	4	0	0	4	0	0
25	34728253	.	C	T	0	7	7	0	10	17	0	0
25	34728762	.	T	G	11	9	20	0	0	20	0	0
25	34728921	.	G	C	13	8	21	0	0	21	0	0
25	34728924	.	T	C	11	0	11	0	10	21	0	0
25	34752389	.	T	C	1	3	4	0	0	4	0	0
25	34762403	.	A	G	3	0	3	0	7	10	0	0
25	34763022	.	T	A	9	16	25	0	0	25	0	0
25	34763065	.	A	G	7	15	22	0	1	23	0	0
25	34763121	.	T	A	1	5	6	0	1	7	0	0
25	34763473	.	G	A	4	2	6	0	1	7	0	0
25	34765654	.	A	C	4	10	14	0	1	15	0	0
25	34765717	.	A	G	10	0	10	0	15	25	0	0
25	34765732	.	G	T	9	11	20	0	0	20	0	0
25	34794357	.	T	C	1	2	3	0	0	3	0	0
25	34797387	.	G	A	1	2	3	0	1	4	0	0
25	34798189	.	C	T	5	6	11	0	0	11	0	0
25	34798237	.	T	C	4	12	16	0	0	16	0	0
25	34798246	.	A	G	2	9	11	0	1	12	0	0
25	34799413	.	T	C	4	3	7	0	1	8	0	0
25	34799446	.	T	C	5	5	10	0	0	10	0	0
25	34801664	.	T	C	11	10	21	0	1	22	0	0
25	34801945	.	A	G	5	0	5	0	4	9	0	0
25	34801977	.	C	T	7	8	15	0	0	15	0	0
25	34802054	.	T	C	0	7	7	0	0	7	0	0
25	34802119	.	G	A	3	8	11	0	2	13	0	0
25	34802164	.	A	C	7	4	11	0	1	14	2	0
25	34802235	.	C	T	7	5	12	0	0	12	0	0
25	34802236	.	G	A	0	5	5	0	7	12	0	0
25	34802308	.	G	A	0	5	5	0	5	10	0	0
25	34802310	.	G	T	4	5	9	0	1	10	0	0
25	34802426	.	C	T	6	11	17	0	0	17	0	0
25	34802897	.	C	T	4	9	13	0	1	14	0	0
25	34802995	.	A	C	10	8	18	0	0	18	0	0
25	34803010	.	C	A	11	11	22	0	0	22	0	0
25	34803128	.	C	T	15	19	34	0	1	35	0	0
25	34803153	.	A	G	19	12	31	0	3	34	0	0
25	34803254	.	T	C	21	14	35	0	3	38	0	0
25	34803496	.	T	A	14	12	26	0	0	26	0	0
25	34803524	.	C	T	17	15	32	0	0	32	0	0
25	34803744	.	G	A	14	22	36	0	1	37	0	0
25	34803871	.	T	C	8	6	14	0	1	15	0	0
25	34803908	.	G	A	0	5	5	0	9	14	0	0
25	34803954	.	T	C	6	4	10	0	1	11	0	0
25	34835772	.	A	G	19	34	53	0	2	55	0	0
25	34841329	.	C	T	0	17	17	0	29	46	0	0
25	34844995	.	C	T	1	31	32	0	13	45	0	0
25	34845042	.	T	C	12	0	12	0	19	31	0	0
25	34845611	.	G	T	3	3	6	0	0	6	0	0
25	34845780	.	C	T	4	2	6	0	0	6	0	0
25	34845865	.	A	G	0	1	1	0	0	1	0	0
25	34851815	.	A	G	1	0	1	0	1	2	0	0
25	34854577	.	G	A	0	1	1	0	0	1	0	0
25	34859413	.	C	T	4	5	9	0	0	9	0	0
25	34859416	.	C	T	3	5	8	0	2	10	0	0
25	34889190	.	A	T	0	6	6	0	1	8	1	0
25	34889487	.	A	G	8	4	12	0	4	16	0	0
25	34889563	.	C	T	1	1	2	0	0	2	0	0
25	34908713	.	G	A	0	1	1	0	0	1	0	0
25	34972856	.	T	A	1	2	3	0	0	3	0	0
25	34973029	.	G	A	2	2	4	0	0	4	0	0
25	34973070	.	C	T	3	3	6	0	1	7	0	0
25	34973090	.	C	A	1	8	9	0	0	9	0	0
25	34976145	.	T	C	0	3	3	0	1	4	0	0
25	35002394	.	G	A	27	32	59	0	1	60	0	0
25	35005362	.	G	A	8	12	20	0	0	20	0	0
25	35006830	.	G	A	0	14	14	0	24	38	0	0
25	35006989	.	C	T	21	12	33	0	2	35	0	0
25	35007857	.	C	T	6	6	12	0	0	12	0	0
25	35007864	.	G	A	6	8	14	0	1	15	0	0
25	35045190	.	A	G	1	2	3	0	0	3	0	0
25	35098007	.	G	A	1	2	3	0	0	3	0	0
25	35101485	.	C	T	1	1	2	0	0	2	0	0
25	35270407	.	A	G	3	5	8	0	0	8	0	0
25	35295334	.	C	T	1	2	3	0	0	3	0	0
25	35462533	.	T	C	6	2	8	0	0	8	0	0
25	35467246	.	A	C	1	5	6	0	0	6	0	0
25	35467298	.	G	A	0	5	5	0	0	5	0	0
25	35713260	.	G	A	8	2	10	0	0	10	0	0
25	35713263	.	G	C	8	2	10	0	0	10	0	0
25	35720552	.	G	A	18	3	21	0	0	21	0	0
25	35720558	.	T	C	16	4	20	0	1	21	0	0
25	35765181	.	A	G	7	14	21	0	1	22	0	0
25	35765206	.	A	G	16	5	21	0	0	21	0	0
25	36040526	.	A	G	0	1	1	0	0	1	0	0
25	36065954	.	T	C	1	4	5	0	0	5	0	0
25	37335959	.	A	G	5	2	7	0	0	7	0	0
25	37335961	.	A	G	2	3	5	0	2	7	0	0
25	37336710	.	A	G	5	2	7	0	0	7	0	0
3	40948	.	G	A	4	3	7	0	0	7	0	0
3	41014	.	T	C	4	2	6	0	0	6	0	0
3	197013	.	T	C	1	2	3	0	0	3	0	0
3	197661	.	T	C	2	2	4	0	0	4	0	0
3	197667	.	A	G	2	2	4	0	0	4	0	0
3	198078	.	G	A	2	2	4	0	0	4	0	0
3	198222	.	C	T	0	2	2	0	2	4	0	0
3	205614	.	A	G	0	1	1	0	0	1	0	0
3	214039	.	A	T	2	2	4	0	1	5	0	0
3	214061	.	G	T	2	3	5	0	0	5	0	0
3	214149	.	C	T	1	3	4	0	0	4	0	0
3	214163	.	T	G	1	2	3	0	0	3	0	0
3	248989	.	C	T	2	4	6	0	0	6	0	0
3	1096863	.	A	G	3	0	3	0	3	6	0	0
3	1101705	.	T	C	1	0	1	0	0	1	0	0
3	1101709	.	C	A	0	0	0	0	1	1	0	0
3	1101781	.	A	G	1	3	4	0	2	6	0	0
3	1101847	.	A	G	1	3	4	0	1	5	0	0
3	1101910	.	G	A	6	9	15	0	0	15	0	0
3	1101925	.	C	T	9	9	18	0	0	18	0	0
3	1102252	.	G	A	0	3	3	0	2	5	0	0
3	1105108	.	G	A	0	19	19	0	7	26	0	0
3	1105133	.	T	C	11	16	27	0	1	28	0	0
3	1105175	.	T	C	13	8	21	0	0	21	0	0
3	1105241	.	T	G	5	0	5	0	6	11	0	0
3	1105286	.	T	A	2	7	9	0	1	10	0	0
3	1105290	.	G	A	0	6	6	0	4	10	0	0
3	1105331	.	T	G	4	1	5	0	4	9	0	0
3	1105385	.	A	C	6	3	9	0	0	9	0	0
3	1105427	.	G	A	0	3	3	0	3	6	0	0
3	1105436	.	T	A	1	3	4	0	1	5	0	0
3	1105566	.	C	T	6	7	13	0	0	13	0	0
3	1105760	.	G	A	8	8	16	0	1	17	0	0
3	1105983	.	G	A	3	5	8	0	0	8	0	0
3	1105991	.	C	T	3	4	7	0	0	7	0	0
3	1106083	.	A	G	5	6	11	0	0	11	0	0
3	1106160	.	A	C	4	10	14	0	1	15	0	0
3	1106261	.	T	C	2	6	8	0	1	9	0	0
3	1107222	.	T	G	8	0	8	0	3	11	0	0
3	1107231	.	A	C	7	3	10	0	0	10	0	0
3	1113879	.	A	G	5	1	6	0	0	6	0	0
3	1116936	.	G	A	0	9	9	0	13	22	0	0
3	1117574	.	G	A	9	10	19	0	1	20	0	0
3	1118431	.	C	T	12	5	17	0	1	18	0	0
3	1122908	.	A	G	14	9	23	0	0	23	0	0
3	1123280	.	T	C	4	4	8	0	0	8	0	0
3	1123335	.	G	A	0	9	9	0	10	19	0	0
3	1123598	.	C	T	6	12	18	0	1	19	0	0
3	1123848	.	G	A	0	4	4	0	8	12	0	0
3	1123860	.	A	T	8	3	11	0	0	11	0	0
3	1126605	.	A	G	9	0	9	0	7	16	0	0
3	1126632	.	A	G	2	0	2	0	0	2	0	0
3	1129313	.	C	T	18	22	40	0	1	41	0	0
3	1129325	.	C	T	17	23	40	0	0	40	0	0
3	1129364	.	G	A	10	17	27	0	5	32	0	0
3	1129768	.	T	A	12	20	32	0	0	32	0	0
3	1129840	.	G	A	0	22	22	0	30	52	0	0
3	1130299	.	C	A	9	4	13	0	0	13	0	0
3	1130716	.	A	T	17	10	27	0	0	27	0	0
3	1133176	.	G	A	5	3	8	0	1	9	0	0
3	1133305	.	T	C	5	1	6	0	14	20	0	0
3	1133480	.	T	A	5	6	11	0	0	11	0	0
3	1133573	.	A	G	4	9	13	0	0	13	0	0
3	1133669	.	C	T	4	7	11	0	0	11	0	0
3	1133695	.	G	C	5	5	10	1	0	11	0	0
3	1133780	.	T	C	7	7	14	0	0	14	0	0
3	1133805	.	T	C	5	6	11	0	1	12	0	0
3	1133815	.	T	A	3	9	12	0	1	13	0	0
3	1133861	.	G	C	0	7	7	0	1	8	0	0
3	1133894	.	G	C	1	4	5	0	0	5	0	0
3	1134009	.	C	G	2	3	5	1	0	6	0	0
3	1134012	.	C	T	2	2	4	1	0	5	0	0
3	1135550	.	T	C	10	0	10	0	14	24	0	0
3	1135598	.	C	T	6	11	17	0	2	19	0	0
3	1141878	.	A	G	1	7	8	0	0	8	0	0
3	1141894	.	T	C	2	0	2	0	11	13	0	0
3	1142074	.	T	C	2	0	2	0	6	8	0	0
3	1142089	.	T	C	4	3	7	0	0	7	0	0
3	1150419	.	G	A	0	3	3	0	2	5	0	0
3	1150462	.	G	T	5	6	11	0	1	12	0	0
3	1150463	.	G	T	6	6	12	0	0	12	0	0
3	1155099	.	C	T	0	1	1	0	0	1	0	0
3	1155326	.	A	G	1	0	1	0	7	8	0	0
3	1167097	.	C	G	4	0	4	0	6	10	0	0
3	1167116	.	T	C	3	5	8	0	0	8	0	0
3	1175788	.	A	G	7	4	11	0	0	11	0	0
3	1175822	.	T	G	5	0	5	0	5	10	0	0
3	1178562	.	G	A	0	13	13	0	3	16	0	0
3	1178605	.	A	G	0	0	0	0	2	2	0	0
3	1179097	.	T	C	9	8	17	0	1	18	0	0
3	1179372	.	C	G	1	2	3	0	0	3	0	0
3	1179375	.	C	T	1	2	3	0	0	3	0	0
3	1179609	.	G	C	1	0	1	0	0	1	0	0
3	1187069	.	C	T	2	8	10	0	11	21	0	0
3	1187075	.	A	G	13	12	25	0	1	26	0	0
3	1187174	.	A	G	4	5	9	0	0	9	0	0
3	1187177	.	T	C	4	0	4	0	3	7	0	0
3	1191482	.	C	T	13	6	19	0	1	20	0	0
3	1191573	.	A	C	10	10	20	0	3	23	0	0
3	1191685	.	A	G	18	5	23	0	1	24	0	0
3	1191965	.	T	C	15	0	15	1	16	32	0	0
3	1191972	.	G	A	15	16	31	0	1	32	0	0
3	1192582	.	G	A	13	7	20	0	2	22	0	0
3	1192768	.	G	C	13	8	21	0	0	21	0	0
3	1192772	.	A	G	12	7	19	0	2	21	0	0
3	1195669	.	A	G	0	5	5	0	0	5	0	0
3	1196926	.	C	T	0	10	10	0	8	18	0	0
3	1196938	.	A	G	5	6	11	0	0	11	0	0
3	1197157	.	A	G	9	8	17	0	1	18	0	0
3	1197161	.	T	C	10	0	10	0	7	17	0	0
3	1200012	.	C	A	1	17	18	0	10	28	0	0
3	1200019	.	G	C	9	18	27	0	2	29	0	0
3	1209085	.	C	G	2	0	2	0	3	5	0	0
3	1211342	.	T	C	4	6	10	0	0	10	0	0
3	1211489	.	T	C	8	10	18	0	1	19	0	0
3	1211586	.	T	C	11	3	14	0	0	14	0	0
3	1211753	.	G	A	6	6	12	0	0	12	0	0
3	1211804	.	A	G	0	1	1	0	0	1	0	0
3	1212141	.	T	A	3	2	5	0	0	5	0	0
3	1215082	.	C	T	3	4	7	0	0	7	0	0
3	1215233	.	A	G	6	1	7	0	11	18	0	0
3	1218176	.	T	C	13	9	22	0	0	22	0	0
3	1220373	.	C	T	4	5	9	0	0	9	0	0
3	1220420	.	C	T	0	2	2	0	0	2	0	0
3	1220423	.	C	A	0	1	1	0	1	2	0	0
3	1220612	.	T	C	8	4	12	0	1	13	0	0
3	1220621	.	A	G	6	0	6	0	6	12	0	0
3	1223892	.	G	A	1	26	27	0	26	53	0	0
3	1226959	.	T	C	12	16	28	0	0	28	0	0
3	1227040	.	G	C	1	12	13	0	13	26	0	0
3	1227230	.	T	C	6	4	10	0	1	11	0	0
3	1230094	.	A	G	6	11	17	0	3	20	0	0
3	1260566	.	T	C	12	9	21	0	0	21	0	0
3	1260572	.	C	T	0	7	7	0	12	19	0	0
3	1261214	.	A	G	5	4	9	0	1	10	0	0
3	1262641	.	A	G	12	12	24	0	2	26	0	0
3	1263068	.	C	T	12	11	23	0	3	26	0	0
3	1263376	.	T	C	11	0	11	0	11	22	0	0
3	1263420	.	G	A	13	12	25	0	1	26	0	0
3	1263584	.	G	T	12	12	24	0	1	25	0	0
3	1263606	.	G	T	14	10	24	0	0	24	0	0
3	1263690	.	T	A	8	6	14	0	0	14	0	0
3	1264045	.	C	G	3	4	7	0	0	7	0	0
3	1264312	.	A	G	13	7	20	0	1	21	0	0
3	1264342	.	T	C	10	8	18	0	1	19	0	0
3	1264361	.	G	A	12	9	21	0	0	21	0	0
3	1264448	.	C	G	9	8	17	0	2	19	0	0
3	1264749	.	G	A	10	7	17	0	0	17	0	0
3	1264822	.	C	T	6	7	13	0	2	15	0	0
3	1264853	.	A	G	7	4	11	0	0	11	0	0
3	1265019	.	T	A	10	7	17	0	0	17	0	0
3	1265064	.	G	A	7	6	13	0	1	14	0	0
3	1265084	.	A	G	5	5	10	0	0	10	0	0
3	1265140	.	G	T	9	6	15	0	0	15	0	0
3	1265965	.	C	T	1	4	5	0	2	7	0	0
3	1266110	.	T	C	8	6	14	0	0	14	0	0
3	1266229	.	G	A	5	8	13	0	0	13	0	0
3	1266344	.	T	C	10	9	19	0	2	21	0	0
3	1266871	.	C	T	6	10	16	0	0	16	0	0
3	1267132	.	T	A	3	6	9	0	0	9	0	0
3	1267162	.	C	T	2	6	8	0	0	8	0	0
3	1267201	.	C	T	5	6	11	0	0	11	0	0
3	1267369	.	T	A	3	4	7	0	0	7	0	0
3	1267678	.	T	C	2	4	6	0	0	6	0	0
3	1267684	.	T	A	1	4	5	0	1	6	0	0
3	1267993	.	A	T	9	6	15	0	1	16	0	0
3	1268874	.	T	G	11	6	17	0	0	17	0	0
3	1268906	.	G	A	7	7	14	0	0	14	0	0
3	1269079	.	G	A	2	3	5	0	0	5	0	0
3	1269090	.	A	C	2	0	2	0	3	5	0	0
3	1269250	.	T	A	2	3	5	0	0	5	0	0
3	1269303	.	C	G	2	2	4	0	0	4	0	0
3	1269307	.	T	A	2	2	4	0	0	4	0	0
3	1269418	.	A	C	4	4	8	0	0	8	0	0
3	1269476	.	T	C	2	3	5	0	0	5	0	0
3	1269563	.	A	G	4	4	8	0	0	8	0	0
3	1283113	.	C	G	3	0	3	0	0	3	0	0
3	1304528	.	C	T	4	9	13	0	0	13	0	0
3	1304633	.	G	A	5	6	11	0	0	11	0	0
3	1304772	.	C	T	4	17	21	0	0	21	0	0
3	1323815	.	T	C	7	5	12	0	0	12	0	0
3	1323879	.	T	A	5	7	12	0	1	13	0	0
3	1323895	.	C	A	7	7	14	0	1	15	0	0
3	1324045	.	C	A	7	11	18	0	0	18	0	0
3	1324064	.	C	A	12	4	16	0	0	16	0	0
3	1324233	.	G	A	8	3	11	0	0	11	0	0
3	1324281	.	G	T	3	1	4	0	1	5	0	0
3	1324300	.	T	C	5	4	9	0	0	9	0	0
3	1324509	.	C	A	8	4	12	0	1	13	0	0
3	1337593	.	A	G	3	10	13	0	0	13	0	0
3	1337674	.	T	C	6	1	7	1	8	16	0	0
3	1386456	.	G	A	7	8	15	0	0	15	0	0
3	1388867	.	A	G	11	20	31	1	10	42	0	0
3	1395837	.	A	G	14	17	31	0	2	33	0	0
3	1395861	.	C	T	1	12	13	0	19	32	0	0
3	1395918	.	C	T	0	4	4	0	9	13	0	0
3	1415312	.	A	T	0	1	1	0	0	1	0	0
3	1492276	.	C	T	1	0	1	0	0	1	0	0
3	1494431	.	T	C	0	4	4	0	0	4	0	0
3	1494466	.	T	A	2	3	5	0	1	6	0	0
3	1494570	.	A	T	5	2	7	0	0	7	0	0
3	1494588	.	G	A	5	3	8	0	0	8	0	0
3	1494612	.	G	A	3	3	6	0	1	7	0	0
3	1494643	.	G	T	0	4	4	0	6	10	0	0
3	1497102	.	T	C	5	5	10	0	0	10	0	0
3	1499548	.	G	A	15	12	27	0	0	27	0	0
3	1499581	.	T	C	17	8	25	0	2	27	0	0
3	1499677	.	A	G	18	14	32	0	2	34	0	0
3	1499908	.	T	G	14	0	14	0	8	22	0	0
3	1499909	.	A	G	15	6	21	0	1	22	0	0
3	1500004	.	A	T	9	10	19	0	1	20	0	0
3	1500232	.	T	A	6	13	19	0	0	19	0	0
3	1500648	.	G	A	15	9	24	0	0	24	0	0
3	1501016	.	T	C	4	2	6	0	1	7	0	0
3	1501131	.	C	T	5	9	14	0	0	14	0	0
3	1511215	.	G	T	3	2	5	0	0	5	0	0
3	1511271	.	G	A	2	9	11	0	0	11	0	0
3	1515168	.	G	A	0	1	1	0	0	1	0	0
3	3327558	.	C	G	0	6	6	1	0	7	0	0
3	3358066	.	C	G	3	2	5	0	0	5	0	0
3	3361127	.	T	G	1	2	3	0	0	3	0	0
3	3361187	.	A	C	4	0	4	0	2	6	0	0
3	3361781	.	C	T	1	3	4	0	0	4	0	0
3	3362031	.	C	T	4	2	6	0	1	7	0	0
3	3362248	.	T	A	2	4	6	0	0	6	0	0
3	3362682	.	C	G	1	2	3	0	0	3	0	0
3	3610185	.	C	A	7	9	16	0	0	16	0	0
3	3610202	.	A	T	8	7	15	0	1	16	0	0
3	3610255	.	C	T	5	3	8	0	0	8	0	0
3	3628238	.	G	A	0	10	10	0	7	17	0	0
3	3628248	.	A	C	4	8	12	0	2	14	0	0
3	3630587	.	T	C	0	3	3	0	1	4	0	0
3	3631389	.	T	G	6	14	20	0	0	20	0	0
3	3634393	.	G	C	12	10	22	0	0	22	0	0
3	3634696	.	G	T	3	3	6	0	0	6	0	0
3	3810947	.	A	G	0	1	1	0	1	2	0	0
3	3813847	.	T	C	2	1	3	0	0	3	0	0
3	4465928	.	G	A	1	2	3	0	0	3	0	0
3	4502158	.	C	A	2	1	3	0	0	4	1	0
3	4502161	.	T	C	2	1	3	0	0	3	0	0
3	4504739	.	A	G	3	0	3	0	0	3	0	0
3	4504808	.	A	G	3	6	9	0	0	9	0	0
3	4506897	.	A	G	2	10	12	0	0	12	0	0
3	4508042	.	A	C	12	7	19	0	2	21	0	0
3	4508093	.	C	A	9	7	16	0	0	16	0	0
3	4508120	.	C	T	7	3	10	0	0	10	0	0
3	4511052	.	T	C	4	5	9	0	0	9	0	0
3	4511163	.	A	G	2	0	2	0	1	3	0	0
3	4514030	.	G	A	0	2	2	0	0	2	0	0
3	4522767	.	A	G	4	0	4	0	6	10	0	0
3	4530061	.	G	A	1	2	3	0	1	4	0	0
3	4530118	.	T	A	4	7	11	0	0	11	0	0
3	4537660	.	C	T	1	1	2	0	0	2	0	0
3	4644400	.	A	G	2	4	6	0	0	6	0	0
3	4644469	.	A	C	1	3	4	0	0	4	0	0
3	4997917	.	A	T	1	0	1	0	0	1	0	0
3	5010664	.	A	T	2	1	3	0	1	4	0	0
3	5012736	.	T	C	2	0	2	0	1	3	0	0
3	5012832	.	C	G	1	6	7	0	3	10	0	0
3	5019687	.	T	C	1	1	2	0	0	2	0	0
3	5019701	.	C	A	2	1	3	0	1	4	0	0
3	5019801	.	A	G	5	5	10	0	0	10	0	0
3	5019839	.	A	T	7	2	9	0	0	9	0	0
3	5021516	.	T	C	20	12	32	0	3	35	0	0
3	5027635	.	A	G	3	2	5	0	1	6	0	0
3	5029924	.	A	C	14	15	29	0	1	30	0	0
3	5029982	.	A	T	10	14	24	0	0	24	0	0
3	5035201	.	A	C	1	2	3	0	0	3	0	0
3	5040591	.	A	G	1	3	4	0	2	6	0	0
3	5040757	.	A	G	4	3	7	0	0	7	0	0
3	5040777	.	G	A	4	5	9	0	0	9	0	0
3	5040798	.	A	C	4	5	9	0	1	10	0	0
3	5053060	.	C	T	1	18	19	0	16	35	0	0
3	5053084	.	C	T	0	17	17	0	18	35	0	0
3	5053108	.	A	C	11	15	26	0	0	26	0	0
3	5053246	.	G	A	16	10	26	0	1	27	0	0
3	5053260	.	C	T	18	5	23	0	1	24	0	0
3	5053409	.	C	T	0	13	13	1	15	29	0	0
3	5053465	.	T	C	17	0	17	0	6	23	0	0
3	5053586	.	C	T	2	13	15	0	20	35	0	0
3	5053934	.	G	A	16	27	43	0	0	43	0	0
3	5054018	.	A	G	10	10	20	0	1	21	0	0
3	5056247	.	G	A	15	20	35	0	1	36	0	0
3	5056390	.	A	T	3	1	4	0	0	4	0	0
3	5062927	.	G	A	15	19	34	0	2	36	0	0
3	5062980	.	C	A	14	22	36	0	2	38	0	0
3	5063011	.	T	C	9	0	9	0	21	30	0	0
3	5063176	.	G	A	4	4	8	0	0	8	0	0
3	5130791	.	C	A	13	6	19	0	0	19	0	0
3	5130851	.	T	C	1	4	5	0	0	5	0	0
3	5134113	.	G	A	4	3	7	0	1	8	0	0
3	5134122	.	G	A	4	4	8	0	1	9	0	0
3	5134669	.	T	C	9	9	18	0	0	18	0	0
3	5136617	.	G	A	1	4	5	0	0	5	0	0
3	5140851	.	A	G	1	2	3	0	0	3	0	0
3	5141035	.	C	T	7	5	12	0	1	13	0	0
3	5141152	.	C	T	6	5	11	0	0	11	0	0
3	5143119	.	C	T	5	2	7	0	0	7	0	0
3	5143522	.	C	T	3	3	6	0	0	6	0	0
3	5145139	.	C	A	1	2	3	0	2	5	0	0
3	5145988	.	G	A	1	0	1	0	0	1	0	0
3	5145991	.	T	C	1	0	1	0	0	1	0	0
3	5147544	.	G	A	2	4	6	0	1	7	0	0
3	5150391	.	G	A	1	2	3	0	0	3	0	0
3	5152715	.	T	C	2	2	4	0	0	4	0	0
3	5163352	.	C	T	0	1	1	0	0	1	0	0
3	5163418	.	C	G	4	4	8	0	0	8	0	0
3	5163442	.	G	T	4	4	8	0	0	8	0	0
3	5163826	.	C	T	0	3	3	0	4	7	0	0
3	5163889	.	G	A	2	1	3	0	0	3	0	0
3	5171303	.	G	T	0	2	2	0	0	2	0	0
3	5228084	.	A	G	4	3	7	0	0	7	0	0
3	5267221	.	G	A	6	3	9	0	1	10	0	0
3	5267251	.	C	T	8	8	16	0	0	16	0	0
3	5270274	.	C	T	0	14	14	0	20	34	0	0
3	5623807	.	C	T	0	4	4	0	11	15	0	0
3	5624487	.	C	T	1	2	3	0	4	7	0	0
3	5624604	.	C	A	6	3	9	0	0	9	0	0
3	5627917	.	G	A	9	10	19	0	2	21	0	0
3	5633089	.	G	A	14	16	30	0	0	30	0	0
3	5648055	.	C	T	2	3	5	0	0	5	0	0
3	5652588	.	C	T	1	2	3	0	0	3	0	0
3	5719007	.	G	T	3	2	5	0	0	5	0	0
3	5779044	.	T	A	6	9	15	0	0	15	0	0
3	5779093	.	G	T	8	9	17	0	1	18	0	0
3	5782501	.	A	G	0	2	2	0	0	2	0	0
3	5782715	.	A	G	3	2	5	0	0	5	0	0
3	5812802	.	C	T	0	1	1	0	2	3	0	0
3	5814475	.	C	T	2	4	6	0	0	6	0	0
3	5814478	.	C	T	2	4	6	0	0	6	0	0
3	5823477	.	G	A	4	2	6	0	1	7	0	0
3	5823483	.	C	A	0	2	2	0	5	7	0	0
3	5824826	.	T	C	1	0	1	0	0	1	0	0
3	5824870	.	C	T	1	6	7	0	0	7	0	0
3	5829415	.	A	G	6	4	10	0	0	10	0	0
3	5882351	.	G	A	1	2	3	0	0	3	0	0
3	5882912	.	A	T	1	2	3	0	0	3	0	0
3	5886917	.	C	T	0	23	23	0	30	53	0	0
3	5887223	.	T	C	20	15	35	0	0	35	0	0
3	5887463	.	T	G	15	20	35	0	2	37	0	0
3	5887661	.	A	T	17	13	30	0	2	32	0	0
3	5887673	.	G	C	23	0	23	0	16	39	0	0
3	5887715	.	T	C	18	13	31	0	0	31	0	0
3	5887841	.	T	A	12	19	31	0	6	37	0	0
3	5887931	.	A	T	16	15	31	0	8	39	0	0
3	5888245	.	C	T	17	15	32	0	0	32	0	0
3	5888664	.	G	A	13	13	26	0	0	26	0	0
3	5888868	.	G	A	11	14	25	0	0	25	0	0
3	5889077	.	G	T	12	15	27	0	0	27	0	0
3	5889302	.	T	C	12	10	22	0	1	23	0	0
3	5889642	.	A	T	6	7	13	0	0	13	0	0
3	5889983	.	A	G	4	3	7	0	1	8	0	0
3	5890274	.	T	A	18	7	25	0	0	25	0	0
3	5890287	.	A	G	20	6	26	0	3	29	0	0
3	5890698	.	C	T	0	10	10	0	18	28	0	0
3	5908262	.	C	T	7	10	17	0	1	18	0	0
3	5908302	.	T	C	2	0	2	0	12	14	0	0
3	5908452	.	T	C	10	0	10	0	16	26	0	0
3	5908569	.	C	A	0	10	10	0	10	20	0	0
3	5964113	.	G	A	3	2	5	0	0	5	0	0
3	5994984	.	C	T	5	5	10	0	1	11	0	0
3	5995038	.	A	G	1	2	3	0	1	4	0	0
3	6015843	.	A	G	0	3	3	0	2	5	0	0
3	6018562	.	A	G	1	6	7	0	1	8	0	0
3	6018622	.	G	A	1	4	5	0	0	5	0	0
3	6380368	.	T	C	16	14	30	0	2	32	0	0
3	6417172	.	G	A	18	16	34	0	1	35	0	0
3	6444075	.	C	A	3	5	8	0	0	8	0	0
3	6457308	.	T	G	0	0	0	1	0	1	0	0
3	6460039	.	G	T	2	1	3	0	1	4	0	0
3	6477596	.	G	C	1	2	3	0	1	4	0	0
3	6491117	.	C	A	0	2	2	1	1	4	0	0
3	6491540	.	C	T	4	5	9	0	1	10	0	0
3	6491542	.	G	T	4	6	10	0	0	10	0	0
3	6491663	.	A	G	0	4	4	0	1	5	0	0
3	6491670	.	C	T	1	3	4	0	1	5	0	0
3	6491820	.	A	T	4	4	8	0	0	8	0	0
3	6491833	.	A	G	5	4	9	0	0	9	0	0
3	6491881	.	G	T	6	6	12	0	0	12	0	0
3	6491906	.	T	C	3	8	11	0	1	12	0	0
3	6495017	.	G	A	0	1	1	0	0	1	0	0
3	6498049	.	C	G	0	12	12	0	5	17	0	0
3	6499636	.	A	G	3	0	3	0	1	4	0	0
3	6504814	.	T	A	2	1	3	0	0	3	0	0
3	6505007	.	G	T	1	0	1	0	0	1	0	0
3	6505010	.	T	C	1	0	1	0	0	1	0	0
3	6515014	.	C	G	1	1	2	0	0	2	0	0
3	6515029	.	A	G	0	1	1	0	0	1	0	0
3	6659702	.	G	A	0	4	4	0	7	11	0	0
3	6659843	.	C	T	2	2	4	0	0	4	0	0
3	6663606	.	G	A	3	4	7	0	0	7	0	0
3	6664358	.	T	G	2	3	5	0	0	5	0	0
3	6664498	.	A	G	2	4	6	0	0	6	0	0
3	6664603	.	A	G	1	6	7	0	0	7	0	0
3	6664609	.	T	C	5	3	8	0	1	9	0	0
3	6664643	.	A	G	4	2	6	0	0	6	0	0
3	6664943	.	A	G	2	3	5	0	0	5	0	0
3	6665701	.	A	G	3	4	7	0	0	7	0	0
3	6665738	.	A	T	2	9	11	0	0	11	0	0
3	6665808	.	A	G	2	3	5	0	0	5	0	0
3	6665951	.	C	A	7	5	12	0	1	13	0	0
3	6665985	.	A	T	4	7	11	0	1	12	0	0
3	6666027	.	C	T	5	8	13	0	0	13	0	0
3	6666080	.	A	G	8	9	17	0	1	18	0	0
3	6666092	.	T	C	8	10	18	0	0	18	0	0
3	6666194	.	G	C	5	17	22	0	2	24	0	0
3	6666283	.	A	T	4	15	19	0	1	20	0	0
3	6666342	.	A	G	15	3	18	0	0	18	0	0
3	6666362	.	G	A	7	9	16	0	0	16	0	0
3	6666474	.	T	C	0	5	5	0	0	5	0	0
3	6666689	.	T	C	1	7	8	0	0	8	0	0
3	6666730	.	C	T	2	2	4	0	0	4	0	0
3	6667209	.	C	T	6	19	25	0	1	26	0	0
3	6667383	.	T	C	2	2	4	4	0	8	0	0
3	6669439	.	C	G	1	0	1	0	3	4	0	0
3	6669474	.	T	C	1	2	3	0	0	3	0	0
3	6721286	.	G	C	4	4	8	0	1	9	0	0
3	6721421	.	T	G	4	7	11	0	2	13	0	0
3	6721430	.	T	C	8	2	10	0	0	10	0	0
3	6721456	.	A	T	3	4	7	0	1	8	0	0
3	6721851	.	C	T	3	8	11	0	0	11	0	0
3	6721971	.	A	T	3	6	9	0	1	10	0	0
3	6722715	.	A	C	13	3	16	0	0	16	0	0
3	6722725	.	C	G	16	3	19	0	0	19	0	0
3	6722981	.	G	A	11	7	18	0	0	18	0	0
3	6722986	.	A	T	9	4	13	0	3	16	0	0
3	6723078	.	A	C	6	8	14	0	0	14	0	0
3	6725332	.	T	G	7	3	10	0	0	10	0	0
3	6725432	.	T	A	4	3	7	0	0	7	0	0
3	6725468	.	C	T	2	2	4	0	0	4	0	0
3	6725523	.	C	T	1	3	4	1	0	5	0	0
3	6725554	.	T	C	1	4	5	0	0	5	0	0
3	6725607	.	A	G	2	2	4	2	0	6	0	0
3	6726020	.	C	T	1	2	3	0	0	3	0	0
3	6726284	.	A	T	1	8	9	0	1	10	0	0
3	6726317	.	A	G	6	2	8	0	1	9	0	0
3	6726359	.	G	A	6	12	18	0	0	18	0	0
3	6726455	.	A	T	10	9	19	0	1	20	0	0
3	6727154	.	C	T	0	7	7	0	5	12	0	0
3	6732696	.	G	A	0	1	1	0	0	1	0	0
3	6732697	.	C	T	0	1	1	0	0	1	0	0
3	6737099	.	G	T	1	0	1	0	0	1	0	0
3	6744653	.	A	G	2	1	3	0	0	3	0	0
3	6749311	.	T	C	1	2	3	0	0	3	0	0
3	6895908	.	C	A	1	4	5	0	0	5	0	0
3	7007279	.	C	T	0	2	2	0	0	2	0	0
3	7007294	.	T	C	0	2	2	0	0	2	0	0
3	7008117	.	C	T	1	2	3	0	1	4	0	0
3	7008220	.	G	T	0	2	2	0	0	2	0	0
3	7008234	.	G	A	0	3	3	0	0	3	0	0
3	7008640	.	T	A	2	2	4	0	0	4	0	0
3	7008750	.	C	T	3	2	5	0	1	6	0	0
3	7008772	.	T	C	3	2	5	0	0	5	0	0
3	7081625	.	C	T	0	4	4	1	0	5	0	0
3	7081667	.	T	C	1	1	2	0	2	4	0	0
3	7081696	.	G	C	1	2	3	0	2	5	0	0
3	7081838	.	T	A	2	2	4	0	0	4	0	0
3	7099344	.	A	G	3	4	7	0	2	9	0	0
3	7099380	.	C	T	4	4	8	0	0	8	0	0
3	7099452	.	T	C	1	0	1	0	6	7	0	0
3	7099460	.	T	G	1	7	8	0	0	8	0	0
3	7113025	.	C	T	0	5	5	0	6	11	0	0
3	7113330	.	T	C	3	9	12	0	0	12	0	0
3	7113660	.	A	G	4	3	7	0	0	7	0	0
3	7113669	.	C	T	5	5	10	0	0	10	0	0
3	7113720	.	G	A	4	7	11	0	1	12	0	0
3	7113742	.	G	A	5	3	8	3	1	12	0	0
3	7113934	.	A	G	9	3	12	0	0	12	0	0
3	7124140	.	G	A	0	1	1	0	0	1	0	0
3	7124157	.	C	G	1	2	3	0	0	3	0	0
3	7124206	.	A	C	1	8	9	0	1	10	0	0
3	7124300	.	G	A	0	3	3	0	0	3	0	0
3	7124437	.	A	G	1	2	3	0	0	3	0	0
3	7133388	.	G	A	1	3	4	0	0	4	0	0
3	7133435	.	T	G	1	6	7	0	0	7	0	0
3	7134022	.	G	C	2	2	4	0	0	4	0	0
3	7141527	.	G	T	4	6	10	0	0	10	0	0
3	7141651	.	T	C	8	4	12	0	0	12	0	0
3	7141717	.	A	G	3	5	8	0	1	9	0	0
3	7141924	.	G	A	3	3	6	0	1	7	0	0
3	7141981	.	C	T	1	3	4	0	1	5	0	0
3	7142143	.	G	A	3	5	8	0	0	8	0	0
3	7142350	.	A	G	0	3	3	2	1	6	0	0
3	7155039	.	T	C	1	7	8	0	0	8	0	0
3	7155403	.	A	G	6	8	14	0	0	14	0	0
3	7155428	.	G	A	9	7	16	0	0	16	0	0
3	7155462	.	C	T	1	7	8	0	6	14	0	0
3	7155771	.	G	A	3	2	5	0	5	10	0	0
3	7155846	.	T	C	6	8	14	0	0	14	0	0
3	7155960	.	T	G	3	6	9	6	1	16	0	0
3	7277008	.	A	T	3	4	7	0	0	7	0	0
3	7277172	.	G	A	3	2	5	0	0	5	0	0
3	7296139	.	T	A	0	2	2	0	0	2	0	0
3	7435861	.	T	C	1	3	4	0	0	4	0	0
3	7570230	.	G	A	4	3	7	0	0	7	0	0
3	7570241	.	C	T	4	2	6	0	0	6	0	0
3	7638510	.	A	G	2	7	9	0	0	9	0	0
3	7819686	.	A	G	1	5	6	0	0	6	0	0
3	7819698	.	A	G	5	3	8	0	0	8	0	0
3	7819722	.	A	G	5	3	8	0	1	9	0	0
3	8399700	.	G	A	6	4	10	0	1	11	0	0
3	8399799	.	C	T	0	1	1	0	0	1	0	0
3	9593338	.	G	T	0	1	1	0	0	1	0	0
3	10163405	.	T	C	4	2	6	0	0	6	0	0
3	10421097	.	A	G	3	2	5	0	0	5	0	0
3	11564499	.	G	A	0	1	1	0	0	1	0	0
3	11564523	.	T	C	4	4	8	0	0	8	0	0
3	11564592	.	C	T	0	1	1	0	0	1	0	0
3	11575354	.	G	A	0	6	6	0	4	10	0	0
3	11575471	.	T	C	6	11	17	0	1	18	0	0
3	11575591	.	C	A	2	4	6	0	0	6	0	0
3	11576231	.	A	G	3	3	6	0	0	6	0	0
3	11576249	.	G	A	2	2	4	0	0	4	0	0
3	11585488	.	T	A	24	10	34	0	1	35	0	0
3	11585492	.	G	A	24	7	31	0	1	32	0	0
3	11585815	.	A	G	5	5	10	0	1	11	0	0
3	11585852	.	T	A	11	9	20	0	0	20	0	0
3	11585937	.	G	A	7	15	22	0	2	24	0	0
3	11586028	.	T	A	7	1	8	0	0	8	0	0
3	11586030	.	C	A	7	1	8	0	0	8	0	0
3	11586217	.	G	A	10	3	13	0	3	16	0	0
3	11586227	.	C	A	9	3	12	0	0	12	0	0
3	11586331	.	C	T	1	10	11	0	15	26	0	0
3	11586346	.	C	T	19	13	32	0	0	32	0	0
3	11586382	.	G	A	23	13	36	0	1	37	0	0
3	11586635	.	A	G	21	8	29	0	1	30	0	0
3	11586679	.	C	T	15	8	23	0	2	25	0	0
3	11586695	.	C	T	0	6	6	0	13	19	0	0
3	11590280	.	A	G	5	7	12	0	1	13	0	0
3	11614970	.	T	C	7	0	7	0	1	8	0	0
3	11615007	.	A	T	17	8	25	0	3	29	1	0
3	11615041	.	T	C	19	1	20	0	20	40	0	0
3	11615109	.	G	A	19	20	39	0	1	40	0	0
3	11615133	.	A	G	20	17	37	0	3	40	0	0
3	11615224	.	A	G	15	25	40	0	0	40	0	0
3	11624298	.	A	G	17	7	24	0	1	25	0	0
3	11781003	.	A	C	10	13	23	2	0	26	1	0
3	11781079	.	T	C	8	5	13	0	5	18	0	0
3	11781113	.	G	A	13	12	25	0	4	29	0	0
3	11784743	.	G	A	11	21	32	0	7	39	0	0
3	11797076	.	C	T	1	3	4	0	2	6	0	0
3	11922695	.	G	T	3	4	7	0	0	7	0	0
3	11934018	.	G	A	9	12	21	0	0	21	0	0
3	11934021	.	T	C	9	10	19	0	0	19	0	0
3	11934072	.	C	T	2	4	6	0	0	6	0	0
3	11937063	.	G	A	5	8	13	0	1	14	0	0
3	11937093	.	T	C	2	2	4	0	0	4	0	0
3	11937295	.	C	T	6	4	10	0	1	11	0	0
3	11941226	.	A	C	0	1	1	0	0	1	0	0
3	11947012	.	A	G	17	0	17	0	6	23	0	0
3	11947291	.	A	G	15	4	19	0	1	20	0	0
3	11947323	.	C	G	9	7	16	0	1	17	0	0
3	11947401	.	A	T	7	9	16	0	0	16	0	0
3	11947462	.	G	A	7	2	9	0	0	9	0	0
3	11958700	.	A	T	2	3	5	0	0	5	0	0
3	11991143	.	T	C	0	2	2	0	0	2	0	0
3	12322215	.	T	C	2	3	5	0	0	5	0	0
3	12335842	.	T	A	2	2	4	0	1	5	0	0
3	12345351	.	T	C	7	7	14	0	0	14	0	0
3	12345373	.	G	T	9	11	20	0	1	21	0	0
3	12349672	.	A	G	6	9	15	0	1	16	0	0
3	12376677	.	G	A	1	1	2	0	0	2	0	0
3	12376803	.	C	T	0	2	2	0	1	3	0	0
3	12602469	.	T	C	4	4	8	0	0	8	0	0
3	12630622	.	C	G	4	0	4	0	5	9	0	0
3	12647220	.	G	T	7	7	14	0	0	14	0	0
3	12647229	.	A	G	8	10	18	0	1	19	0	0
3	12647256	.	C	T	8	8	16	0	2	18	0	0
3	12647316	.	T	C	1	1	2	0	0	2	0	0
3	12652186	.	T	C	2	4	6	0	0	6	0	0
3	12652243	.	T	C	10	7	17	0	0	17	0	0
3	12658066	.	G	C	6	5	11	0	1	12	0	0
3	12658518	.	T	C	4	3	7	0	0	7	0	0
3	12658536	.	T	C	5	4	9	0	0	9	0	0
3	12658591	.	G	A	5	5	10	0	1	11	0	0
3	12660690	.	C	G	8	5	13	0	0	13	0	0
3	12672020	.	C	T	7	8	15	0	1	16	0	0
3	12672068	.	C	T	10	8	18	0	0	18	0	0
3	12672195	.	C	A	3	0	3	0	0	3	0	0
3	12678383	.	G	A	7	3	10	0	2	12	0	0
3	12678482	.	A	G	2	1	3	0	0	3	0	0
3	12678993	.	T	C	3	1	4	0	0	4	0	0
3	12679090	.	C	T	4	4	8	0	0	8	0	0
3	12681141	.	C	T	17	12	29	0	1	30	0	0
3	12681359	.	G	A	9	11	20	0	1	21	0	0
3	12689490	.	T	C	6	4	10	0	1	11	0	0
3	12689511	.	A	G	9	0	9	0	5	14	0	0
3	12689613	.	T	A	1	2	3	0	1	4	0	0
3	12691823	.	C	A	9	5	14	0	0	14	0	0
3	12692858	.	G	T	7	6	13	0	1	14	0	0
3	12692859	.	T	G	7	7	14	0	0	14	0	0
3	12698831	.	A	T	12	9	21	0	0	21	0	0
3	12698890	.	T	C	16	7	23	0	1	24	0	0
3	12698897	.	A	G	15	10	25	0	0	25	0	0
3	12698976	.	C	A	7	12	19	0	0	19	0	0
3	12699026	.	T	A	6	9	15	0	1	16	0	0
3	12699044	.	T	C	9	9	18	0	1	19	0	0
3	12699073	.	T	A	10	12	22	0	0	22	0	0
3	12699260	.	A	G	11	8	19	0	0	19	0	0
3	12699274	.	C	T	11	9	20	0	0	20	0	0
3	12699311	.	A	T	11	9	20	0	0	20	0	0
3	12699525	.	C	T	13	11	24	0	0	24	0	0
3	12699645	.	G	C	11	6	17	0	0	17	0	0
3	12699662	.	C	T	8	7	15	0	0	15	0	0
3	12831862	.	A	C	0	3	3	0	1	4	0	0
3	13332911	.	G	A	1	2	3	0	0	3	0	0
3	13860363	.	G	A	4	5	9	0	0	9	0	0
3	14451012	.	A	G	5	10	15	0	0	15	0	0
3	14451026	.	A	G	13	4	17	0	0	17	0	0
3	14496729	.	T	C	20	1	21	0	19	40	0	0
3	14496823	.	T	C	23	13	36	0	1	37	0	0
3	14507609	.	A	G	4	2	6	0	0	6	0	0
3	14580598	.	A	C	1	4	5	0	1	6	0	0
3	14598409	.	C	T	2	2	4	0	0	4	0	0
3	14605750	.	T	C	2	4	6	0	0	6	0	0
3	14692201	.	T	C	18	22	40	0	1	41	0	0
3	14692204	.	T	C	18	0	18	0	23	41	0	0
3	14694835	.	G	A	12	20	32	0	0	32	0	0
3	14859756	.	C	T	7	5	12	0	0	12	0	0
3	15020506	.	C	T	10	7	17	0	0	17	0	0
3	15020548	.	T	A	9	5	14	0	0	14	0	0
3	15020572	.	C	T	2	3	5	0	0	5	0	0
3	15041021	.	C	T	17	17	34	0	4	38	0	0
3	15041084	.	T	C	6	4	10	0	2	12	0	0
3	15057191	.	A	T	12	15	27	0	3	30	0	0
3	15057321	.	T	C	14	12	26	0	2	28	0	0
3	15057538	.	C	T	11	13	24	0	0	24	0	0
3	15057696	.	T	C	14	9	23	0	0	23	0	0
3	15057697	.	G	T	14	9	23	0	0	23	0	0
3	15057928	.	G	A	11	10	21	0	1	22	0	0
3	15058003	.	C	G	14	4	18	0	0	18	0	0
3	15058106	.	C	T	11	13	24	0	0	24	0	0
3	15058123	.	A	G	11	13	24	0	1	25	0	0
3	15058161	.	T	C	9	12	21	0	0	21	0	0
3	15058259	.	G	T	13	15	28	0	0	28	0	0
3	15058278	.	A	T	10	12	22	0	1	23	0	0
3	15085669	.	A	G	9	11	20	0	0	20	0	0
3	15085673	.	G	A	11	8	19	0	0	19	0	0
3	15085784	.	G	C	5	10	15	0	1	16	0	0
3	15091201	.	A	G	4	4	8	0	1	9	0	0
3	15095987	.	A	G	9	11	20	0	0	20	0	0
3	15098913	.	C	G	1	0	1	0	0	1	0	0
3	15109081	.	C	T	1	0	1	0	1	2	0	0
3	15110967	.	T	C	2	4	6	0	0	6	0	0
3	15114793	.	G	A	2	5	7	0	0	7	0	0
3	15114935	.	C	T	1	3	4	0	1	5	0	0
3	15115120	.	C	T	0	2	2	0	4	6	0	0
3	15115138	.	G	A	2	3	5	0	0	5	0	0
3	15130981	.	T	G	2	2	4	0	0	4	0	0
3	15130993	.	C	T	3	3	6	0	0	6	0	0
3	15131217	.	T	C	2	5	7	0	0	7	0	0
3	15131295	.	C	A	0	2	2	0	6	8	0	0
3	15134326	.	G	A	1	2	3	0	0	3	0	0
3	15134327	.	G	A	1	2	3	0	0	3	0	0
3	15134493	.	T	C	5	4	9	0	0	9	0	0
3	15134537	.	T	A	1	2	3	0	0	3	0	0
3	15137023	.	C	T	2	1	3	0	0	3	0	0
3	15137045	.	A	G	7	3	10	0	1	11	0	0
3	15193773	.	T	A	8	3	11	0	0	11	0	0
3	15198701	.	A	G	7	6	13	0	1	14	0	0
3	15203329	.	C	A	15	17	32	0	3	35	0	0
3	15203371	.	A	C	12	14	26	0	5	31	0	0
3	15203388	.	T	G	13	15	28	0	0	28	0	0
3	15203935	.	C	T	3	9	12	0	1	13	0	0
3	15203977	.	G	A	0	1	1	0	0	1	0	0
3	15207876	.	T	A	9	3	12	0	0	12	0	0
3	15214098	.	G	T	1	3	4	0	0	4	0	0
3	15214252	.	A	C	9	11	20	0	0	20	0	0
3	15214300	.	T	A	6	6	12	0	1	13	0	0
3	15214462	.	C	A	8	6	14	0	1	15	0	0
3	15214475	.	T	A	7	6	13	0	0	13	0	0
3	15214683	.	C	T	4	7	11	0	1	12	0	0
3	15215101	.	T	A	3	3	6	0	0	6	0	0
3	15215599	.	G	A	9	3	12	0	0	12	0	0
3	15215625	.	G	A	2	8	10	0	0	10	0	0
3	15223921	.	G	A	3	6	9	0	0	9	0	0
3	15232447	.	A	G	19	31	50	0	2	52	0	0
3	15232481	.	G	A	30	13	43	0	1	44	0	0
3	15232498	.	G	A	18	25	43	0	2	45	0	0
3	15242201	.	C	T	0	4	4	0	5	9	0	0
3	15245973	.	C	T	23	28	51	0	0	51	0	0
3	15246060	.	T	C	12	9	21	0	0	21	0	0
3	15246871	.	C	T	1	3	4	0	1	5	0	0
3	15247060	.	T	C	2	0	2	0	0	2	0	0
3	15255286	.	C	T	6	4	10	0	1	11	0	0
3	15255334	.	C	T	0	12	12	1	15	28	0	0
3	15258440	.	T	A	18	13	31	0	0	31	0	0
3	15258676	.	G	A	7	17	24	0	0	24	0	0
3	15259118	.	G	A	4	6	10	0	0	10	0	0
3	15272263	.	A	G	0	2	2	0	1	3	0	0
3	15273982	.	G	C	1	1	2	0	1	3	0	0
3	15274280	.	G	A	0	9	9	0	8	17	0	0
3	15274320	.	G	A	14	6	20	0	1	21	0	0
3	15274649	.	G	A	0	2	2	0	5	7	0	0
3	15274691	.	T	C	14	8	22	0	0	22	0	0
3	15278931	.	A	G	1	0	1	0	5	6	0	0
3	15279045	.	C	G	16	11	27	0	1	28	0	0
3	15282328	.	C	T	3	6	9	0	0	9	0	0
3	15284041	.	C	T	4	6	10	0	4	14	0	0
3	15284047	.	C	T	6	8	14	0	0	14	0	0
3	15284513	.	C	A	4	11	15	0	8	23	0	0
3	15284604	.	G	A	0	9	9	0	5	14	0	0
3	15332476	.	C	A	14	17	31	0	0	31	0	0
3	15332601	.	G	T	15	12	27	0	3	30	0	0
3	15332641	.	C	T	22	11	33	1	1	35	0	0
3	15332881	.	G	A	6	19	25	0	0	25	0	0
3	15332902	.	C	A	1	14	15	0	12	28	1	0
3	15332923	.	G	A	14	17	31	0	2	33	0	0
3	15333065	.	G	A	16	22	38	0	2	40	0	0
3	15360723	.	C	T	2	5	7	0	0	7	0	0
3	15361086	.	G	T	11	12	23	0	0	23	0	0
3	15361222	.	T	C	6	11	17	0	0	17	0	0
3	15361359	.	T	A	5	3	8	0	0	8	0	0
3	15362277	.	C	T	8	6	14	0	0	14	0	0
3	15362403	.	A	C	17	6	23	0	0	23	0	0
3	15392401	.	G	A	5	9	14	0	3	17	0	0
3	15392452	.	A	G	8	1	9	0	0	9	0	0
3	15392460	.	A	G	3	3	6	0	3	9	0	0
3	15400517	.	G	A	1	1	2	0	0	2	0	0
3	15406059	.	C	A	1	4	5	0	1	6	0	0
3	15416645	.	G	A	0	4	4	0	7	11	0	0
3	15419098	.	C	T	9	11	20	0	0	20	0	0
3	15458554	.	G	A	3	8	11	0	2	13	0	0
3	15476843	.	G	A	4	9	13	0	0	13	0	0
3	15476891	.	G	T	3	5	8	0	0	8	0	0
3	15477765	.	C	T	1	1	2	0	0	2	0	0
3	15477827	.	T	C	2	3	5	0	0	5	0	0
3	15480437	.	G	T	5	2	7	0	0	7	0	0
3	15480464	.	A	G	6	3	9	0	0	9	0	0
3	15486290	.	G	A	0	1	1	0	0	1	0	0
3	15489796	.	A	C	1	0	1	0	2	3	0	0
3	15489799	.	G	A	1	2	3	0	0	3	0	0
3	15490026	.	A	C	4	5	9	0	0	9	0	0
3	15490681	.	T	G	0	9	9	0	0	9	0	0
3	15491473	.	G	A	1	2	3	0	0	3	0	0
3	15491503	.	A	C	4	0	4	0	3	7	0	0
3	15496463	.	G	T	3	7	10	0	0	10	0	0
3	15505359	.	T	C	26	11	37	0	0	37	0	0
3	15505658	.	G	A	13	7	20	0	1	21	0	0
3	15505700	.	A	G	6	3	9	0	0	9	0	0
3	15505703	.	C	G	6	2	8	0	0	8	0	0
3	15505856	.	A	T	11	8	19	0	0	19	0	0
3	15505864	.	G	A	0	8	8	0	12	20	0	0
3	15505910	.	C	T	12	12	24	0	0	24	0	0
3	15505911	.	G	A	0	12	12	0	12	24	0	0
3	15505979	.	G	A	5	6	11	0	0	11	0	0
3	15551723	.	G	A	0	2	2	0	0	2	0	0
3	15608000	.	C	A	14	13	27	0	2	29	0	0
3	15622576	.	G	A	1	2	3	0	0	3	0	0
3	15622701	.	C	G	3	2	5	0	0	5	0	0
3	15622804	.	A	C	1	0	1	0	7	8	0	0
3	15627447	.	A	G	3	5	8	0	0	8	0	0
3	15627493	.	C	T	0	5	5	0	4	9	0	0
3	15627539	.	G	A	3	5	8	0	0	8	0	0
3	15627767	.	G	A	7	9	16	0	0	16	0	0
3	15628056	.	G	A	4	0	4	0	1	5	0	0
3	15628292	.	C	T	1	4	5	0	0	5	0	0
3	15628455	.	G	A	1	4	5	1	0	6	0	0
3	15628458	.	A	C	1	0	1	0	4	5	0	0
3	15628779	.	C	T	2	5	7	0	0	7	0	0
3	15629894	.	T	C	3	2	5	0	0	5	0	0
3	15630257	.	A	T	2	4	6	0	0	6	0	0
3	15635288	.	T	A	6	5	11	0	0	11	0	0
3	15638264	.	C	T	1	8	9	0	3	12	0	0
3	15647699	.	C	T	3	3	6	0	0	6	0	0
3	15647784	.	G	A	0	2	2	0	0	2	0	0
3	15661675	.	G	A	5	5	10	0	0	10	0	0
3	15661705	.	G	A	5	5	10	0	0	10	0	0
3	15661726	.	C	T	5	4	9	0	0	9	0	0
3	15670812	.	T	C	2	2	4	0	0	4	0	0
3	15671055	.	G	A	6	8	14	0	2	16	0	0
3	15671631	.	T	C	4	3	7	0	0	7	0	0
3	15671635	.	T	A	4	3	7	0	0	7	0	0
3	15671703	.	G	A	2	0	2	0	0	2	0	0
3	15671704	.	A	G	2	0	2	0	0	2	0	0
3	15678918	.	G	A	3	5	8	0	1	9	0	0
3	15822021	.	A	G	3	2	5	0	0	5	0	0
3	15988337	.	A	G	16	17	33	0	0	33	0	0
3	16018350	.	G	T	5	2	7	0	0	7	0	0
3	16018352	.	G	A	5	2	7	0	0	7	0	0
3	16449859	.	A	T	1	1	2	0	0	2	0	0
3	16455693	.	G	A	0	1	1	0	0	1	0	0
3	16455740	.	C	A	0	3	3	0	0	3	0	0
3	16456222	.	T	A	2	2	4	0	0	4	0	0
3	16456255	.	C	T	5	2	7	0	0	7	0	0
3	16457532	.	G	A	2	2	4	0	0	4	0	0
3	16473242	.	C	T	1	3	4	0	1	5	0	0
3	16637830	.	C	T	1	0	1	1	0	2	0	0
3	16643170	.	A	G	2	1	3	0	0	3	0	0
3	16644899	.	G	T	1	3	4	0	4	8	0	0
3	16648459	.	G	T	3	3	6	0	0	6	0	0
3	16652265	.	C	T	5	5	10	0	0	10	0	0
3	16678830	.	C	T	3	6	9	0	1	10	0	0
3	16679171	.	T	G	6	6	12	0	3	15	0	0
3	16679172	.	G	T	7	7	14	0	1	15	0	0
3	16679238	.	C	T	3	7	10	0	0	10	0	0
3	16679331	.	T	C	5	9	14	0	0	14	0	0
3	16679387	.	G	A	1	3	4	0	0	4	0	0
3	16693877	.	G	C	1	0	1	0	0	1	0	0
3	16694188	.	G	C	2	0	2	0	2	4	0	0
3	16701965	.	A	G	1	1	2	0	0	2	0	0
3	16729101	.	G	A	2	4	6	0	0	6	0	0
3	16731938	.	A	G	2	0	2	0	2	4	0	0
3	16733790	.	C	T	7	6	13	0	0	13	0	0
3	16735423	.	C	T	4	7	11	0	0	11	0	0
3	16735507	.	C	T	0	2	2	0	0	2	0	0
3	16738857	.	T	A	2	1	3	0	0	3	0	0
3	16741179	.	A	C	6	11	17	0	0	17	0	0
3	16746153	.	A	C	13	16	29	0	1	30	0	0
3	16746947	.	A	T	7	13	20	0	0	20	0	0
3	16841970	.	T	A	1	0	1	0	0	1	0	0
3	16841984	.	C	A	0	2	2	0	0	2	0	0
3	16842168	.	A	G	2	3	5	0	0	5	0	0
3	16842343	.	G	A	2	2	4	0	0	4	0	0
3	16869168	.	T	A	2	3	5	0	0	5	0	0
3	16871413	.	C	G	4	0	4	0	3	7	0	0
3	16871503	.	G	A	4	2	6	0	0	6	0	0
3	16871504	.	G	T	4	2	6	0	0	6	0	0
3	16872038	.	T	A	2	3	5	0	0	5	0	0
3	16872179	.	G	T	1	4	5	0	0	5	0	0
3	16872453	.	A	T	5	2	7	0	0	7	0	0
3	16872493	.	T	C	2	6	8	0	0	8	0	0
3	16872508	.	G	T	4	3	7	0	0	7	0	0
3	16972991	.	T	C	6	3	9	0	0	9	0	0
3	17070259	.	A	G	1	0	1	0	0	1	0	0
3	17093097	.	T	C	4	4	8	0	0	8	0	0
3	17107058	.	G	C	1	5	6	0	1	7	0	0
3	17107067	.	A	T	0	5	5	0	1	6	0	0
3	17457475	.	T	C	1	2	3	0	1	4	0	0
3	17458045	.	C	T	2	2	4	0	0	4	0	0
3	17458960	.	C	T	3	0	3	0	0	3	0	0
3	17481886	.	T	C	2	4	6	0	1	7	0	0
3	17481955	.	G	A	1	5	6	0	3	9	0	0
3	17482012	.	G	A	1	0	1	0	0	1	0	0
3	17488995	.	A	G	1	0	1	0	0	1	0	0
3	17489004	.	A	T	1	0	1	0	0	1	0	0
3	17591140	.	G	A	0	3	3	0	1	4	0	0
3	17600849	.	A	G	1	1	2	0	3	5	0	0
3	17600994	.	T	C	1	5	6	0	0	6	0	0
3	17601636	.	C	A	1	3	4	0	0	4	0	0
3	17602344	.	T	A	2	3	5	1	0	6	0	0
3	17867869	.	T	C	6	3	9	0	0	9	0	0
3	17867870	.	T	C	3	6	9	0	0	9	0	0
3	18686781	.	T	C	5	0	5	0	27	32	0	0
3	18801071	.	G	A	1	2	3	0	0	3	0	0
3	18839017	.	C	T	6	4	10	0	1	11	0	0
3	18921482	.	A	G	0	2	2	0	1	3	0	0
3	19717541	.	G	T	0	26	26	0	2	29	1	0
3	20108790	.	T	C	8	15	23	0	1	24	0	0
3	21287872	.	G	C	0	1	1	0	0	1	0	0
3	22152952	.	C	T	2	4	6	0	1	7	0	0
3	22153116	.	C	T	3	11	14	0	0	14	0	0
3	22153762	.	C	G	2	5	7	0	0	7	0	0
3	22153849	.	A	G	2	6	8	1	0	9	0	0
3	22153944	.	T	G	2	0	2	0	3	5	0	0
3	22153983	.	A	G	0	4	4	0	0	4	0	0
3	22154008	.	A	G	6	0	6	0	4	10	0	0
3	22154051	.	A	G	4	5	9	0	5	14	0	0
3	22154368	.	A	G	2	3	5	0	1	6	0	0
3	22154431	.	A	G	3	12	15	0	1	16	0	0
3	22154745	.	C	T	6	10	16	0	1	17	0	0
3	22158243	.	T	A	22	23	45	0	1	46	0	0
3	22158364	.	T	C	10	13	23	0	1	24	0	0
3	22158414	.	G	A	22	25	47	0	1	48	0	0
3	22158416	.	G	C	25	23	48	0	0	48	0	0
3	22158489	.	G	A	36	18	54	0	3	57	0	0
3	22158904	.	A	T	10	14	24	0	1	25	0	0
3	22159081	.	T	C	36	16	52	0	2	54	0	0
3	22159520	.	T	G	3	15	18	0	0	18	0	0
3	22159525	.	A	T	2	11	13	0	1	14	0	0
3	22159569	.	A	G	13	6	19	0	0	19	0	0
3	22159697	.	A	G	11	29	40	1	1	42	0	0
3	22159797	.	G	A	7	10	17	0	1	18	0	0
3	22159943	.	C	T	3	4	7	0	0	7	0	0
3	22160007	.	G	A	16	15	31	0	1	32	0	0
3	22160131	.	C	G	3	3	6	0	1	7	0	0
3	22160436	.	A	C	21	14	35	0	0	35	0	0
3	22160706	.	T	A	11	7	18	0	2	20	0	0
3	22160767	.	G	T	8	10	18	0	2	22	2	0
3	22160779	.	C	T	13	14	27	0	0	27	0	0
3	22160888	.	A	T	11	10	21	0	0	21	0	0
3	22160947	.	C	A	11	1	12	0	0	15	3	0
3	22161153	.	A	G	15	19	34	0	1	35	0	0
3	22161317	.	C	T	0	17	17	0	8	25	0	0
3	22161366	.	G	A	8	14	22	0	1	23	0	0
3	22161389	.	T	A	7	13	20	0	2	22	0	0
3	22161588	.	C	T	11	5	16	0	0	16	0	0
3	22168615	.	C	T	2	3	5	0	1	6	0	0
3	22172837	.	G	A	20	17	37	0	1	38	0	0
3	22179835	.	A	C	4	6	10	0	0	10	0	0
3	22179857	.	T	A	2	8	10	0	0	10	0	0
3	22179899	.	A	C	3	5	8	0	0	8	0	0
3	22180013	.	G	A	1	3	4	0	0	4	0	0
3	22180139	.	T	G	2	3	5	0	0	5	0	0
3	22180315	.	T	C	5	3	8	0	0	8	0	0
3	22180411	.	C	T	0	3	3	0	1	4	0	0
3	22180666	.	T	C	3	2	5	0	1	6	0	0
3	22191042	.	T	C	20	17	37	0	1	38	0	0
3	22191044	.	C	A	19	17	36	0	2	38	0	0
3	22213993	.	T	A	1	2	3	0	0	3	0	0
3	22216212	.	T	C	1	0	1	0	1	2	0	0
3	22216265	.	G	A	3	4	7	0	1	8	0	0
3	22216296	.	A	T	3	5	8	0	0	8	0	0
3	22216358	.	G	A	4	17	21	0	0	21	0	0
3	22216413	.	C	G	4	8	12	0	0	12	0	0
3	22432213	.	G	T	4	19	23	0	1	24	0	0
3	22534277	.	C	T	1	2	3	0	0	3	0	0
3	22534900	.	C	A	2	2	4	0	0	4	0	0
3	22547182	.	A	G	12	4	16	0	1	17	0	0
3	22547227	.	C	T	2	4	6	0	0	6	0	0
3	22548052	.	G	A	10	0	10	0	0	10	0	0
3	22548094	.	A	G	11	11	22	0	0	22	0	0
3	22548095	.	G	T	10	10	20	0	2	22	0	0
3	22548177	.	G	T	2	1	3	0	0	3	0	0
3	22548388	.	G	A	7	6	13	0	0	13	0	0
3	22548666	.	C	G	15	9	24	0	0	24	0	0
3	22548677	.	C	T	17	8	25	0	1	26	0	0
3	22548903	.	A	C	9	10	19	0	1	20	0	0
3	22548928	.	T	A	10	10	20	0	0	20	0	0
3	22578532	.	T	C	2	0	2	0	0	2	0	0
3	22578705	.	A	T	1	1	2	0	0	2	0	0
3	22578717	.	G	C	1	0	1	0	0	1	0	0
3	22636680	.	A	T	2	0	2	0	0	2	0	0
3	22760872	.	C	A	3	0	3	0	1	4	0	0
3	22783133	.	G	A	0	1	1	0	1	2	0	0
3	22783277	.	A	G	7	6	13	0	0	13	0	0
3	22783298	.	G	A	8	8	16	0	0	16	0	0
3	22784434	.	A	G	0	0	0	0	2	2	0	0
3	22788163	.	T	C	5	5	10	0	0	10	0	0
3	22788430	.	G	T	0	5	5	0	7	12	0	0
3	22788457	.	T	C	6	4	10	0	0	10	0	0
3	22789725	.	G	T	6	3	9	0	0	9	0	0
3	22790117	.	A	G	4	7	11	0	0	11	0	0
3	22790318	.	A	G	3	9	12	0	0	12	0	0
3	22792033	.	T	C	7	2	9	0	1	10	0	0
3	22794477	.	A	G	4	2	6	0	0	6	0	0
3	22811835	.	G	A	0	8	8	0	13	21	0	0
3	22812753	.	A	G	12	0	12	0	11	23	0	0
3	22812759	.	C	A	13	5	18	0	5	23	0	0
3	22813052	.	G	A	1	8	9	0	16	25	0	0
3	22813515	.	T	A	5	8	13	0	0	13	0	0
3	22813563	.	G	T	7	8	15	0	1	17	1	0
3	22813569	.	T	G	8	8	16	0	0	16	0	0
3	22813628	.	C	A	12	10	22	0	0	22	0	0
3	22813629	.	T	A	12	9	21	0	1	22	0	0
3	22813778	.	C	T	4	6	10	0	0	10	0	0
3	22813998	.	T	G	2	5	7	0	0	7	0	0
3	22814109	.	G	A	10	4	14	0	1	15	0	0
3	22814147	.	G	A	0	12	12	0	7	19	0	0
3	22814209	.	T	C	9	23	32	0	0	32	0	0
3	22814230	.	A	G	9	2	11	0	13	24	0	0
3	22814453	.	A	G	7	13	20	0	0	20	0	0
3	22814478	.	A	G	8	6	14	0	2	16	0	0
3	22814546	.	G	A	9	12	21	0	1	22	0	0
3	22815296	.	C	A	0	3	3	0	0	3	0	0
3	22815994	.	C	T	1	10	11	0	11	22	0	0
3	22816030	.	A	G	9	8	17	0	0	17	0	0
3	22816502	.	G	T	1	3	4	0	1	5	0	0
3	22816586	.	G	A	8	4	12	0	0	12	0	0
3	22816616	.	T	A	9	3	12	0	0	12	0	0
3	22816652	.	A	G	9	4	13	0	0	13	0	0
3	22816676	.	T	C	9	5	14	0	0	14	0	0
3	22816783	.	A	C	9	0	9	0	7	16	0	0
3	22816793	.	T	C	12	5	17	0	0	17	0	0
3	22816989	.	C	T	9	6	15	0	1	16	0	0
3	22817004	.	G	T	9	4	13	0	1	14	0	0
3	22817300	.	T	C	12	0	12	0	9	21	0	0
3	22829682	.	G	T	4	1	5	0	0	5	0	0
3	22935364	.	G	A	8	2	10	0	1	11	0	0
3	22947802	.	A	G	1	0	1	0	4	5	0	0
3	22947820	.	T	C	1	2	3	0	0	3	0	0
3	22953826	.	G	A	0	5	5	0	6	11	0	0
3	22953926	.	T	C	3	3	6	0	0	6	0	0
3	22967007	.	A	G	1	2	3	0	1	4	0	0
3	22993279	.	A	C	7	3	10	0	0	10	0	0
3	22993542	.	G	A	6	3	9	0	0	9	0	0
3	22993614	.	C	T	3	5	8	0	0	8	0	0
3	22993997	.	C	A	4	4	8	0	0	8	0	0
3	22994019	.	A	C	6	7	13	0	0	13	0	0
3	22994078	.	G	T	0	7	7	0	9	16	0	0
3	22994318	.	A	G	5	0	5	0	3	8	0	0
3	22994344	.	G	T	0	4	4	0	6	10	0	0
3	23019762	.	A	C	2	3	5	0	0	5	0	0
3	23020490	.	C	T	1	3	4	0	0	4	0	0
3	23092841	.	C	A	2	0	2	0	0	2	0	0
3	23095945	.	A	G	4	4	8	0	0	8	0	0
3	24443008	.	G	A	0	1	1	0	0	1	0	0
3	24517534	.	C	T	3	2	5	0	0	5	0	0
3	26057839	.	G	A	1	17	18	0	2	20	0	0
3	26057842	.	G	T	0	19	19	0	1	20	0	0
3	26157690	.	T	C	2	0	2	0	7	9	0	0
3	26351448	.	A	G	8	28	36	0	0	36	0	0
3	27695326	.	A	G	2	0	2	0	3	5	0	0
3	27695410	.	A	G	7	3	10	0	1	11	0	0
3	27695434	.	A	G	1	0	1	0	8	9	0	0
3	27695450	.	A	G	3	0	3	0	6	9	0	0
3	27767185	.	A	G	12	4	16	0	0	16	0	0
3	27833009	.	T	C	23	8	31	0	0	31	0	0
3	27834305	.	T	C	24	10	34	0	1	35	0	0
3	27834412	.	T	C	14	20	34	0	1	35	0	0
3	27834552	.	T	C	12	8	20	0	3	23	0	0
3	27834563	.	T	C	17	7	24	0	2	26	0	0
3	27836036	.	T	C	7	10	17	0	1	18	0	0
3	28581572	.	C	T	3	4	7	0	0	7	0	0
3	28594831	.	T	C	7	2	9	0	0	9	0	0
3	28621351	.	C	T	3	0	3	0	0	3	0	0
3	28626340	.	A	C	7	7	14	0	1	15	0	0
3	28627044	.	T	A	8	8	16	0	1	17	0	0
3	28634485	.	T	A	6	6	12	0	0	12	0	0
3	28634549	.	A	G	11	10	21	0	0	21	0	0
3	28634883	.	C	A	15	7	22	0	4	26	0	0
3	28634884	.	A	C	14	9	23	0	3	26	0	0
3	28635106	.	G	A	14	13	27	0	1	28	0	0
3	28640608	.	C	T	0	14	14	0	5	19	0	0
3	28640734	.	G	A	10	6	16	0	1	17	0	0
3	28650721	.	T	C	6	0	6	0	0	6	0	0
3	28665218	.	T	C	9	6	15	0	0	15	0	0
3	28665239	.	G	A	8	9	17	0	0	17	0	0
3	28719103	.	G	A	6	4	10	0	0	10	0	0
3	28719506	.	C	G	11	9	20	0	0	20	0	0
3	28719592	.	T	G	10	7	17	0	0	17	0	0
3	28719636	.	T	A	7	8	15	0	2	17	0	0
3	28719649	.	C	T	7	8	15	0	0	15	0	0
3	28719730	.	G	T	4	7	11	0	1	12	0	0
3	28719852	.	T	C	8	13	21	0	1	22	0	0
3	28719878	.	G	A	5	15	20	0	1	21	0	0
3	28719905	.	C	A	0	15	15	0	4	19	0	0
3	28719971	.	C	A	0	4	4	0	4	8	0	0
3	28720010	.	G	A	4	3	7	0	0	7	0	0
3	28750223	.	G	T	5	8	13	0	0	13	0	0
3	28750376	.	A	C	6	4	10	0	0	11	1	0
3	28750377	.	G	C	6	5	11	0	0	11	0	0
3	29950919	.	T	C	18	6	24	0	0	24	0	0
3	29950927	.	T	C	14	11	25	0	1	26	0	0
3	30801282	.	G	A	6	4	10	0	0	10	0	0
3	30801297	.	G	T	5	3	8	0	0	8	0	0
3	30801370	.	T	C	3	0	3	0	4	7	0	0
3	30860896	.	A	T	1	1	2	0	0	2	0	0
3	30861043	.	G	A	3	2	5	0	0	5	0	0
3	30868853	.	T	G	9	7	16	0	0	16	0	0
3	30868855	.	T	C	9	7	16	0	0	16	0	0
3	30869205	.	A	G	5	10	15	0	1	16	0	0
3	30869206	.	C	T	6	8	14	0	2	16	0	0
3	30869662	.	C	T	4	6	10	0	1	11	0	0
3	30869728	.	C	T	0	6	6	0	5	11	0	0
3	30869938	.	A	G	1	4	5	0	0	5	0	0
3	30870409	.	G	A	2	4	6	0	1	7	0	0
3	30870508	.	G	A	4	3	7	0	1	8	0	0
3	30870838	.	T	A	4	5	9	0	0	9	0	0
3	30870974	.	A	C	10	5	15	0	0	15	0	0
3	30871021	.	G	T	6	3	9	0	0	9	0	0
3	30871478	.	A	T	4	2	6	0	0	6	0	0
3	30871873	.	C	G	0	2	2	0	2	4	0	0
3	30872004	.	C	T	2	3	5	0	0	5	0	0
3	30872034	.	T	C	3	2	5	0	0	5	0	0
3	30872264	.	T	G	5	2	7	0	0	7	0	0
3	30872608	.	C	T	0	3	3	0	4	7	0	0
3	30872655	.	T	C	6	3	9	0	0	9	0	0
3	30873029	.	G	A	2	7	9	0	1	10	0	0
3	30873048	.	G	A	2	6	8	0	0	8	0	0
3	30873102	.	T	C	1	1	2	0	1	3	0	0
3	30873165	.	C	T	4	4	8	0	0	8	0	0
3	30873185	.	A	T	3	4	7	0	1	8	0	0
3	30873408	.	T	C	3	2	5	0	0	5	0	0
3	30877163	.	C	T	5	3	8	0	0	8	0	0
3	30890630	.	T	A	13	5	18	0	0	18	0	0
3	30890869	.	G	A	15	23	38	0	2	40	0	0
3	30891201	.	A	G	23	16	39	0	5	44	0	0
3	30894281	.	A	G	11	9	20	0	2	22	0	0
3	30926689	.	A	G	0	2	2	0	0	2	0	0
3	30962456	.	C	G	1	3	4	0	0	4	0	0
3	31043876	.	A	C	1	0	1	0	3	4	0	0
3	31044493	.	A	C	2	3	5	0	0	5	0	0
3	31044579	.	A	G	7	3	10	0	0	10	0	0
3	31044649	.	T	C	1	3	4	0	0	4	0	0
3	31044782	.	A	C	5	0	5	0	3	8	0	0
3	31044986	.	G	T	1	4	5	0	0	5	0	0
3	31045098	.	G	A	1	4	5	0	0	5	0	0
3	31045335	.	C	G	2	4	6	0	0	6	0	0
3	31050554	.	T	C	2	3	5	0	0	5	0	0
3	31057471	.	T	C	1	0	1	0	3	4	0	0
3	31060219	.	A	G	3	0	3	0	5	8	0	0
3	31063625	.	A	T	8	3	11	0	0	11	0	0
3	31066143	.	C	G	3	6	9	0	0	9	0	0
3	31066259	.	A	G	0	2	2	0	0	2	0	0
3	31069634	.	T	C	15	8	23	0	1	24	0	0
3	31070892	.	A	G	6	3	9	0	0	9	0	0
3	31084598	.	C	T	0	2	2	0	0	2	0	0
3	31087613	.	A	T	2	2	4	0	0	4	0	0
3	31087644	.	A	C	2	2	4	0	0	4	0	0
3	31090353	.	C	G	2	3	5	0	0	5	0	0
3	31090424	.	T	C	2	6	8	0	0	8	0	0
3	31102353	.	G	C	1	2	3	0	0	3	0	0
3	31102774	.	A	G	3	2	5	0	0	5	0	0
3	31102778	.	T	A	2	2	4	0	0	4	0	0
3	31103852	.	G	A	2	3	5	0	0	5	0	0
3	31103861	.	C	T	2	3	5	0	0	5	0	0
3	31104046	.	T	C	1	2	3	0	1	4	0	0
3	31104065	.	T	C	3	2	5	0	0	5	0	0
3	31104104	.	G	C	2	2	4	0	0	4	0	0
3	31104127	.	A	T	3	3	6	0	0	6	0	0
3	31104969	.	G	A	5	6	11	0	1	12	0	0
3	31105259	.	A	C	30	25	55	0	0	56	1	0
3	31120249	.	C	T	6	5	11	0	0	11	0	0
3	31122581	.	T	G	11	13	24	0	1	25	0	0
3	31135832	.	T	C	6	1	7	0	5	12	0	0
3	31135898	.	T	C	2	0	2	0	2	4	0	0
3	31137957	.	G	A	3	2	5	0	0	5	0	0
3	31138225	.	A	G	2	4	6	0	0	6	0	0
3	31138247	.	C	T	7	5	12	0	0	12	0	0
3	31140267	.	C	T	3	7	10	0	0	10	0	0
3	31144674	.	A	G	1	0	1	0	0	1	0	0
3	31150018	.	C	T	1	1	2	0	0	2	0	0
3	31150996	.	G	A	3	3	6	0	0	6	0	0
3	31151008	.	T	A	3	4	7	0	1	8	0	0
3	31152156	.	A	C	1	2	3	0	0	3	0	0
3	31152443	.	G	A	1	0	1	0	0	1	0	0
3	31155340	.	C	T	0	1	1	0	3	4	0	0
3	31184034	.	C	T	1	0	1	0	0	1	0	0
3	31187564	.	C	G	9	4	13	0	0	13	0	0
3	31187608	.	C	T	5	3	8	0	0	8	0	0
3	31187719	.	G	A	3	6	9	0	0	9	0	0
3	31187721	.	A	C	3	5	8	0	1	9	0	0
3	31201643	.	T	G	2	6	8	0	0	8	0	0
3	31217714	.	G	T	3	2	5	0	0	5	0	0
3	31217723	.	G	A	3	2	5	0	0	5	0	0
3	31218153	.	C	T	0	1	1	0	2	3	0	0
3	31218230	.	G	A	1	1	2	0	0	2	0	0
3	31396212	.	A	G	3	0	3	0	5	8	0	0
3	31396679	.	A	G	8	5	13	0	1	14	0	0
3	31396760	.	A	C	5	7	12	0	0	12	0	0
3	31396781	.	C	G	5	0	5	0	5	10	0	0
3	31396826	.	T	C	3	1	4	0	0	4	0	0
3	31430327	.	T	C	2	1	3	0	1	4	0	0
3	31603766	.	G	A	0	4	4	0	3	7	0	0
3	31603787	.	G	A	3	2	5	0	0	5	0	0
3	31603925	.	A	G	5	2	7	0	0	7	0	0
3	31603976	.	G	A	2	4	6	0	0	6	0	0
3	31604030	.	T	C	0	3	3	0	0	3	0	0
3	31604053	.	G	A	0	3	3	0	0	3	0	0
3	31604411	.	T	A	1	1	2	0	1	3	0	0
3	31604834	.	A	T	7	3	10	0	1	11	0	0
3	31605033	.	A	G	6	3	9	0	0	9	0	0
3	31605039	.	C	T	5	4	9	0	1	10	0	0
3	31623521	.	A	G	2	0	2	0	2	4	0	0
3	31706607	.	C	A	12	11	23	0	0	23	0	0
3	31706966	.	T	C	8	12	20	0	1	21	0	0
3	31709010	.	C	T	11	19	30	0	1	31	0	0
3	31709079	.	G	A	10	7	17	0	1	18	0	0
3	31711526	.	T	C	7	8	15	0	1	16	0	0
3	31712328	.	G	T	4	4	8	0	0	8	0	0
3	31717595	.	C	T	17	13	30	0	1	31	0	0
3	31722101	.	A	T	11	20	31	0	0	31	0	0
3	31722342	.	A	G	3	6	9	0	0	9	0	0
3	31725824	.	C	T	17	19	36	0	0	36	0	0
3	31726395	.	G	A	1	8	9	0	5	14	0	0
3	31726541	.	A	T	5	11	16	0	3	19	0	0
3	31726829	.	C	T	8	13	21	0	0	21	0	0
3	31729087	.	T	G	1	2	3	0	0	3	0	0
3	31729177	.	G	C	3	3	6	0	0	6	0	0
3	31729328	.	A	G	1	3	4	0	0	4	0	0
3	31729531	.	C	T	1	2	3	0	1	4	0	0
3	31734188	.	C	T	0	4	4	0	5	9	0	0
3	31792600	.	T	A	2	4	6	0	0	6	0	0
3	31792601	.	G	A	4	2	6	0	0	6	0	0
3	31792683	.	G	T	19	5	24	0	0	24	0	0
3	31792856	.	G	A	23	14	37	0	1	38	0	0
3	31793080	.	C	T	19	10	29	0	1	30	0	0
3	31793515	.	T	G	16	18	34	0	1	35	0	0
3	31793518	.	G	A	20	15	35	0	0	35	0	0
3	31793557	.	A	G	17	14	31	0	0	31	0	0
3	31793715	.	G	C	20	15	35	0	1	36	0	0
3	31793739	.	C	T	11	13	24	0	0	24	0	0
3	31797508	.	C	G	25	18	43	0	1	44	0	0
3	31797749	.	A	G	7	5	12	0	0	12	0	0
3	31804244	.	A	G	8	14	22	0	0	22	0	0
3	31815925	.	A	T	1	2	3	0	0	3	0	0
3	31815952	.	T	C	1	1	2	0	0	2	0	0
3	31816638	.	T	A	1	2	3	0	0	3	0	0
3	31816797	.	A	T	1	2	3	0	0	3	0	0
3	31874969	.	G	T	2	8	10	0	0	10	0	0
3	31879626	.	G	A	4	8	12	0	0	12	0	0
3	31879725	.	T	A	5	4	9	0	0	9	0	0
3	31879726	.	C	A	5	4	9	0	0	9	0	0
3	31879880	.	G	T	14	12	26	0	0	26	0	0
3	31879911	.	T	C	14	11	25	0	1	26	0	0
3	31880184	.	C	G	0	4	4	0	7	11	0	0
3	31880641	.	C	T	0	10	10	0	12	22	0	0
3	31881082	.	G	T	8	5	13	0	0	13	0	0
3	31884001	.	A	G	1	2	3	0	0	3	0	0
3	31884321	.	C	T	1	0	1	0	5	6	0	0
3	31884477	.	C	T	10	6	16	0	1	17	0	0
3	31890010	.	T	C	0	1	1	0	0	1	0	0
3	31897070	.	A	G	5	4	9	0	1	10	0	0
3	31914167	.	T	A	3	3	6	0	0	6	0	0
3	31916624	.	T	G	4	0	4	0	10	14	0	0
3	31916701	.	A	T	4	12	16	0	1	17	0	0
3	31916724	.	A	G	7	7	14	0	1	15	0	0
3	31916787	.	G	T	13	11	24	0	0	24	0	0
3	31916863	.	T	C	13	11	24	0	0	24	0	0
3	31917075	.	T	G	7	0	7	0	6	13	0	0
3	31917279	.	G	T	6	4	10	0	0	10	0	0
3	31939272	.	A	G	1	0	1	0	0	1	0	0
3	31939473	.	G	T	0	13	13	0	15	28	0	0
3	31939566	.	C	A	16	13	29	0	0	30	1	0
3	31941152	.	C	T	3	9	12	0	1	13	0	0
3	31944357	.	A	T	12	4	16	0	1	17	0	0
3	31951034	.	A	C	1	2	3	0	1	4	0	0
3	31961992	.	G	A	0	7	7	0	16	23	0	0
3	32021628	.	G	A	9	7	16	0	1	17	0	0
3	32049689	.	C	A	11	4	15	0	0	15	0	0
3	32049740	.	C	T	8	11	19	0	3	22	0	0
3	32087455	.	T	G	3	1	4	0	0	4	0	0
3	32098130	.	G	A	0	3	3	0	6	9	0	0
3	32098194	.	C	T	6	2	8	0	0	8	0	0
3	32098379	.	A	G	2	3	5	0	0	5	0	0
3	32099841	.	A	G	28	1	29	0	25	54	0	0
3	32100183	.	G	T	6	3	9	0	0	9	0	0
3	32100206	.	T	C	6	3	9	0	0	9	0	0
3	32100755	.	T	C	19	9	28	0	1	29	0	0
3	32105746	.	C	A	7	5	12	0	0	12	0	0
3	32118802	.	C	T	2	2	4	0	0	4	0	0
3	32119573	.	T	C	1	2	3	0	0	3	0	0
3	32120096	.	A	C	1	2	3	0	0	3	0	0
3	32120187	.	A	T	6	3	9	0	0	9	0	0
3	32139671	.	G	A	5	6	11	0	1	12	0	0
3	32139701	.	C	G	5	5	10	0	2	12	0	0
3	32160490	.	G	A	4	1	5	0	0	5	0	0
3	32169545	.	G	A	1	1	2	0	0	2	0	0
3	32172636	.	A	T	4	5	9	0	0	10	1	0
3	32175758	.	C	T	0	1	1	0	2	3	0	0
3	32176806	.	C	T	0	3	3	0	2	5	0	0
3	32176824	.	C	T	2	2	4	0	0	4	0	0
3	32176926	.	G	C	1	0	1	0	1	2	0	0
3	32294745	.	G	A	12	18	30	0	0	30	0	0
3	32294869	.	C	G	0	13	13	0	20	33	0	0
3	32295151	.	C	T	12	16	28	0	0	28	0	0
3	32295294	.	G	A	18	10	28	0	0	28	0	0
3	32295519	.	A	C	14	7	21	0	0	21	0	0
3	32296122	.	C	T	7	12	19	0	0	19	0	0
3	32296202	.	G	A	13	10	23	0	0	23	0	0
3	32296253	.	T	A	4	12	16	0	2	18	0	0
3	32296283	.	G	A	6	8	14	0	1	15	0	0
3	32296306	.	G	A	9	6	15	0	0	15	0	0
3	32296379	.	A	G	16	11	27	0	1	28	0	0
3	32296559	.	G	A	14	11	25	0	0	25	0	0
3	32296560	.	C	T	0	13	13	0	12	25	0	0
3	32296673	.	A	G	13	16	29	0	1	30	0	0
3	32296873	.	G	A	14	11	25	0	2	27	0	0
3	32303045	.	G	A	12	9	21	0	0	21	0	0
3	32303589	.	G	C	2	0	2	0	3	5	0	0
3	32303590	.	T	G	2	3	5	0	0	5	0	0
3	32303698	.	A	G	1	1	2	0	0	2	0	0
3	32325218	.	A	G	3	6	9	0	3	12	0	0
3	32329167	.	A	T	8	16	24	0	1	25	0	0
3	32357596	.	C	T	14	22	36	0	6	42	0	0
3	32357799	.	A	C	27	31	58	0	1	59	0	0
3	32360978	.	G	A	4	9	13	0	0	13	0	0
3	32361669	.	G	A	17	16	33	0	2	35	0	0
3	32361865	.	A	G	4	9	13	0	1	14	0	0
3	32366131	.	T	C	9	10	19	0	0	19	0	0
3	32366279	.	T	C	7	6	13	0	0	13	0	0
3	32366332	.	G	A	10	11	21	0	1	22	0	0
3	32366403	.	C	T	14	11	25	0	0	25	0	0
3	32400967	.	C	T	33	19	52	0	1	53	0	0
3	32401159	.	C	A	26	27	53	0	1	54	0	0
3	32401252	.	C	T	21	18	39	0	3	42	0	0
3	32403959	.	T	G	8	0	8	0	11	19	0	0
3	32405571	.	C	T	3	5	8	0	0	8	0	0
3	32405865	.	G	C	16	14	30	0	3	33	0	0
3	32405910	.	C	T	28	13	41	0	0	41	0	0
3	32406447	.	T	C	35	24	59	0	1	60	0	0
3	32406547	.	T	C	29	25	54	0	1	55	0	0
3	32406618	.	G	A	30	28	58	0	1	59	0	0
3	32406631	.	C	G	25	29	54	0	2	56	0	0
3	32410792	.	A	G	2	2	4	0	0	4	0	0
3	32414109	.	T	C	0	2	2	0	1	3	0	0
3	32414273	.	A	T	1	0	1	0	0	1	0	0
3	32414873	.	T	C	4	4	8	0	0	8	0	0
3	32414882	.	G	C	4	5	9	0	0	9	0	0
3	32415781	.	A	C	2	2	4	0	0	4	0	0
3	32433953	.	T	C	4	2	6	0	0	6	0	0
3	32434974	.	G	A	0	14	14	0	8	22	0	0
3	32435034	.	G	T	0	10	10	0	10	20	0	0
3	32435757	.	G	A	0	10	10	0	10	20	0	0
3	32435874	.	G	A	0	6	6	0	7	13	0	0
3	32436024	.	C	A	5	7	12	0	0	12	0	0
3	32436109	.	T	A	6	9	15	0	0	15	0	0
3	32436156	.	T	C	4	7	11	0	0	11	0	0
3	32436426	.	C	T	13	9	22	0	1	23	0	0
3	32436736	.	G	C	10	7	17	0	0	17	0	0
3	32436774	.	G	A	6	7	13	0	0	13	0	0
3	32438425	.	A	C	14	6	20	0	0	20	0	0
3	32440805	.	A	G	5	4	9	0	0	9	0	0
3	32441156	.	T	G	17	0	17	0	17	34	0	0
3	32441297	.	C	A	12	10	22	0	0	22	0	0
3	32441385	.	G	C	19	13	32	0	4	36	0	0
3	32441532	.	G	A	3	12	15	0	2	17	0	0
3	32441779	.	C	T	25	13	38	0	3	41	0	0
3	32447386	.	G	A	9	6	15	0	0	15	0	0
3	32447505	.	G	T	15	14	29	0	1	30	0	0
3	32447674	.	C	G	14	15	29	0	0	29	0	0
3	32447800	.	T	C	6	4	10	0	0	10	0	0
3	32450399	.	T	C	10	6	16	0	2	18	0	0
3	32453727	.	G	A	6	6	12	0	0	12	0	0
3	32457325	.	G	A	0	4	4	0	7	11	0	0
3	32457620	.	T	C	13	13	26	0	0	26	0	0
3	32457686	.	T	C	13	19	32	0	1	33	0	0
3	32458627	.	C	T	8	8	16	0	0	16	0	0
3	32477891	.	T	C	5	2	7	0	1	8	0	0
3	32477950	.	T	A	1	2	3	0	0	3	0	0
3	32479471	.	T	C	1	0	1	0	0	1	0	0
3	32482222	.	A	T	9	9	18	0	0	18	0	0
3	32482231	.	A	G	10	0	10	0	10	20	0	0
3	32482495	.	G	T	0	6	6	0	11	18	1	0
3	32482834	.	A	G	12	5	17	0	0	17	0	0
3	32483557	.	T	G	12	15	27	0	1	28	0	0
3	32483956	.	T	C	9	7	16	0	0	16	0	0
3	32484034	.	A	G	11	0	11	0	14	25	0	0
3	32484039	.	A	G	12	0	12	0	14	26	0	0
3	32484204	.	T	C	16	9	25	0	0	25	0	0
3	32484472	.	T	C	7	6	13	0	1	14	0	0
3	32484676	.	T	G	16	16	32	0	0	32	0	0
3	32484892	.	A	G	5	9	14	0	2	16	0	0
3	32485306	.	A	G	22	19	41	0	1	42	0	0
3	32485324	.	C	T	21	20	41	0	1	42	0	0
3	32485366	.	A	G	22	13	35	0	0	35	0	0
3	32485519	.	A	C	10	13	23	0	5	28	0	0
3	32485967	.	C	A	30	11	41	0	1	42	0	0
3	32486049	.	A	T	18	17	35	0	0	35	0	0
3	32486069	.	C	G	19	0	19	0	15	34	0	0
3	32489613	.	C	T	19	20	39	0	1	40	0	0
3	32490098	.	C	T	11	12	23	0	2	25	0	0
3	32490251	.	G	T	10	11	21	0	0	21	0	0
3	32490264	.	G	A	9	7	16	0	0	16	0	0
3	32490487	.	G	T	13	7	20	0	3	23	0	0
3	32534263	.	A	G	2	4	6	0	0	6	0	0
3	32534353	.	C	T	4	7	11	0	0	11	0	0
3	32534365	.	T	A	1	6	7	0	0	7	0	0
3	32587304	.	C	T	4	3	7	0	0	7	0	0
3	32591894	.	T	C	1	0	1	0	2	3	0	0
3	32641716	.	T	G	3	2	5	0	0	5	0	0
3	32643512	.	G	A	12	10	22	0	1	23	0	0
3	32647124	.	T	C	14	11	25	0	0	25	0	0
3	32647194	.	C	T	5	6	11	0	2	13	0	0
3	32647252	.	G	A	8	12	20	0	3	23	0	0
3	32647308	.	G	C	7	13	20	0	0	20	0	0
3	32647414	.	A	G	1	2	3	0	0	3	0	0
3	32647558	.	A	G	7	0	7	0	6	13	0	0
3	32649846	.	C	T	10	16	26	0	0	26	0	0
3	32649960	.	G	A	10	7	17	0	0	17	0	0
3	32650004	.	A	G	6	7	13	0	2	15	0	0
3	32650199	.	C	A	6	2	8	0	1	9	0	0
3	32662034	.	A	C	4	2	6	0	0	6	0	0
3	32663255	.	T	C	3	4	7	0	0	7	0	0
3	32663485	.	T	C	9	5	14	0	1	15	0	0
3	32663638	.	A	G	2	2	4	0	1	5	0	0
3	32663764	.	T	G	4	4	8	0	0	8	0	0
3	32667118	.	A	C	6	2	8	0	0	8	0	0
3	32668806	.	A	G	10	5	15	0	0	15	0	0
3	32668818	.	A	G	8	4	12	0	0	12	0	0
3	32675236	.	G	A	7	10	17	0	0	17	0	0
3	32679267	.	T	A	7	8	15	0	0	15	0	0
3	32679289	.	T	A	10	14	24	0	0	24	0	0
3	32679332	.	C	T	10	16	26	0	2	28	0	0
3	32679528	.	C	A	9	10	19	0	0	19	0	0
3	32685708	.	A	G	3	0	3	0	4	7	0	0
3	32686230	.	A	G	4	0	4	0	3	7	0	0
3	32686245	.	T	C	2	1	3	0	0	3	0	0
3	32686305	.	T	C	0	2	2	0	0	2	0	0
3	32686307	.	G	A	0	2	2	0	0	2	0	0
3	32686342	.	A	G	1	2	3	0	1	4	0	0
3	32686353	.	T	G	1	1	2	0	1	3	0	0
3	32698458	.	T	C	4	2	6	0	0	6	0	0
3	32698500	.	A	G	11	13	24	0	0	24	0	0
3	32700697	.	A	G	7	9	16	0	0	16	0	0
3	32700758	.	A	G	11	19	30	0	4	34	0	0
3	32700988	.	C	T	20	14	34	0	1	35	0	0
3	32701031	.	T	G	13	0	13	0	7	20	0	0
3	32702596	.	T	A	13	7	20	0	1	21	0	0
3	32707219	.	G	A	6	4	10	0	2	12	0	0
3	32707267	.	T	C	6	9	15	0	0	15	0	0
3	32707272	.	C	A	4	8	12	0	0	12	0	0
3	32707621	.	C	G	10	15	25	0	1	26	0	0
3	32707813	.	C	G	14	11	25	0	0	25	0	0
3	32708077	.	T	C	16	6	22	0	0	22	0	0
3	32710705	.	A	G	9	3	12	0	1	13	0	0
3	32710812	.	G	A	0	3	3	0	2	5	0	0
3	32710999	.	C	A	6	4	10	0	0	10	0	0
3	32711147	.	T	A	2	2	4	0	0	4	0	0
3	32715571	.	G	A	1	3	4	0	0	4	0	0
3	32717529	.	C	T	1	0	1	0	0	1	0	0
3	32718451	.	T	G	0	1	1	0	0	1	0	0
3	32718605	.	A	G	4	5	9	0	0	9	0	0
3	32718851	.	T	C	2	2	4	0	0	4	0	0
3	32718945	.	C	G	6	3	9	0	0	9	0	0
3	32719715	.	T	C	6	10	16	0	1	17	0	0
3	32720342	.	T	C	2	6	8	0	0	8	0	0
3	32722973	.	C	T	9	5	14	0	0	14	0	0
3	32723033	.	A	G	3	0	3	0	9	12	0	0
3	32723119	.	A	G	2	0	2	0	2	4	0	0
3	32723497	.	A	G	4	0	4	0	11	15	0	0
3	32723698	.	C	T	4	4	8	0	2	10	0	0
3	32724010	.	G	A	0	5	5	0	3	8	0	0
3	32724100	.	G	A	0	1	1	0	0	1	0	0
3	32726271	.	A	G	6	2	8	0	0	8	0	0
3	32726357	.	A	G	0	1	1	0	0	1	0	0
3	32729150	.	T	C	7	10	17	0	0	18	1	0
3	32729232	.	T	C	4	6	10	0	3	13	0	0
3	32729591	.	C	T	8	5	13	0	2	15	0	0
3	32729663	.	C	T	4	6	10	0	2	12	0	0
3	32729759	.	C	A	6	4	10	0	0	10	0	0
3	32729827	.	A	T	2	5	7	0	2	9	0	0
3	32729845	.	G	A	2	8	10	0	1	11	0	0
3	32730011	.	A	G	6	0	6	0	5	11	0	0
3	32730071	.	T	A	5	4	9	0	2	11	0	0
3	32730131	.	A	G	5	2	7	0	1	8	0	0
3	32731255	.	A	G	5	0	5	0	9	14	0	0
3	32731418	.	C	T	4	5	9	0	3	12	0	0
3	32731750	.	A	G	1	0	1	0	4	5	0	0
3	32731804	.	T	C	8	10	18	0	0	18	0	0
3	32731840	.	T	C	7	4	11	0	0	11	0	0
3	32731855	.	T	C	3	3	6	0	0	6	0	0
3	32734926	.	G	A	0	2	2	0	5	7	0	0
3	32737727	.	C	T	3	4	7	0	0	7	0	0
3	32741137	.	G	A	0	12	12	0	5	17	0	0
3	32741385	.	G	A	0	5	5	0	10	15	0	0
3	32741809	.	A	G	10	0	10	0	9	19	0	0
3	32777481	.	A	C	14	12	26	0	0	26	0	0
3	32777733	.	G	T	4	12	16	0	1	17	0	0
3	32789654	.	G	T	6	2	8	0	9	17	0	0
3	32789985	.	T	C	1	0	1	0	1	2	0	0
3	32794931	.	C	A	3	9	12	0	0	12	0	0
3	32795068	.	C	T	9	9	18	0	2	20	0	0
3	32795425	.	G	A	5	8	13	0	0	13	0	0
3	32795461	.	A	T	7	7	14	0	0	14	0	0
3	32795614	.	C	T	2	3	5	0	1	6	0	0
3	32807667	.	G	A	3	4	7	0	1	8	0	0
3	32808023	.	T	A	12	10	22	0	1	23	0	0
3	32808185	.	T	C	11	12	23	0	0	23	0	0
3	32808214	.	G	A	17	12	29	0	1	30	0	0
3	32808338	.	A	C	21	16	37	0	7	44	0	0
3	32808554	.	T	G	13	14	27	0	1	28	0	0
3	32808771	.	G	A	4	12	16	0	1	17	0	0
3	32808772	.	G	C	4	13	17	0	0	17	0	0
3	32808979	.	T	G	9	11	20	0	3	23	0	0
3	32809154	.	A	T	4	8	12	0	0	12	0	0
3	32809368	.	G	A	8	18	26	0	1	27	0	0
3	32809410	.	G	A	10	7	17	0	0	17	0	0
3	32809432	.	T	A	9	7	16	0	0	16	0	0
3	32809548	.	T	C	7	16	23	0	0	23	0	0
3	32809561	.	G	A	8	16	24	0	2	26	0	0
3	32809836	.	A	G	4	0	4	0	16	20	0	0
3	32809927	.	T	C	9	14	23	0	0	23	0	0
3	32810011	.	T	A	9	6	15	0	0	15	0	0
3	32810580	.	C	T	16	12	28	0	0	28	0	0
3	32810715	.	A	G	11	19	30	0	1	31	0	0
3	32811094	.	A	T	2	6	8	0	3	11	0	0
3	32824733	.	C	T	2	2	4	0	0	4	0	0
3	32825846	.	G	A	1	5	6	0	1	7	0	0
3	32827751	.	C	T	0	2	2	0	1	3	0	0
3	32837643	.	G	A	16	8	24	0	6	30	0	0
3	32837904	.	A	G	19	1	20	0	21	41	0	0
3	32838033	.	G	A	0	6	6	0	10	16	0	0
3	32838039	.	A	G	8	6	14	0	1	15	0	0
3	32842163	.	C	T	11	5	16	0	2	18	0	0
3	32842235	.	G	T	10	6	16	0	0	16	0	0
3	32842318	.	C	T	11	6	17	0	0	17	0	0
3	32847607	.	C	T	3	5	8	0	0	8	0	0
3	32847771	.	G	A	0	2	2	0	4	6	0	0
3	32847839	.	C	A	4	3	7	0	0	7	0	0
3	32847887	.	C	G	3	4	7	0	0	7	0	0
3	32848175	.	T	G	3	7	10	0	1	11	0	0
3	32848418	.	C	T	12	7	19	0	0	19	0	0
3	32848714	.	A	G	3	4	7	0	0	7	0	0
3	32849079	.	C	T	9	10	19	0	0	19	0	0
3	32849679	.	T	A	9	14	23	0	0	23	0	0
3	32850029	.	A	T	5	5	10	0	0	10	0	0
3	32854276	.	T	C	6	6	12	0	0	12	0	0
3	32854533	.	T	C	6	7	13	0	1	14	0	0
3	32854743	.	C	G	9	0	9	0	5	14	0	0
3	32854744	.	A	G	8	4	12	0	2	14	0	0
3	32855066	.	G	A	5	5	10	0	0	10	0	0
3	32855500	.	T	C	1	2	3	0	0	3	0	0
3	32863016	.	A	G	2	4	6	0	0	6	0	0
3	32863128	.	C	A	0	1	1	0	0	1	0	0
3	32864848	.	A	G	1	1	2	0	0	2	0	0
3	32864854	.	T	A	1	1	2	0	0	2	0	0
3	32865309	.	A	C	0	1	1	0	0	1	0	0
3	32868114	.	G	T	2	2	4	0	0	4	0	0
3	32868590	.	C	T	2	6	8	0	0	8	0	0
3	32868593	.	A	G	2	3	5	0	3	8	0	0
3	32869770	.	C	T	5	5	10	0	0	10	0	0
3	32869773	.	G	A	5	5	10	0	0	10	0	0
3	32870222	.	A	C	2	2	4	0	0	4	0	0
3	32870488	.	C	G	1	3	4	0	0	4	0	0
3	32870564	.	G	C	1	2	3	0	0	3	0	0
3	32870756	.	A	G	2	0	2	0	4	6	0	0
3	32870766	.	G	A	1	3	4	0	1	5	0	0
3	32870881	.	T	A	3	2	5	0	0	5	0	0
3	32871350	.	T	C	1	1	2	0	1	3	0	0
3	32873507	.	A	T	1	1	2	0	0	2	0	0
3	32873573	.	T	G	2	3	5	0	0	5	0	0
3	32873596	.	A	G	1	2	3	0	0	3	0	0
3	32889849	.	T	C	2	1	3	0	12	15	0	0
3	32890002	.	G	T	19	11	30	0	2	33	1	0
3	32890058	.	A	G	14	15	29	0	4	33	0	0
3	32892061	.	G	A	4	4	8	0	1	9	0	0
3	32892422	.	A	G	3	8	11	0	0	11	0	0
3	32900428	.	A	G	3	3	6	0	0	6	0	0
3	32924386	.	G	A	6	9	15	0	1	16	0	0
3	32924643	.	G	A	6	9	15	0	1	16	0	0
3	32924836	.	T	A	18	15	33	0	1	34	0	0
3	32924989	.	G	A	2	0	2	0	0	2	0	0
3	32925066	.	G	A	2	8	10	0	0	10	0	0
3	32925248	.	C	T	11	3	14	0	0	14	0	0
3	32925264	.	G	T	12	4	16	0	1	17	0	0
3	32925400	.	C	T	7	9	16	0	0	16	0	0
3	32926016	.	C	T	0	4	4	0	5	9	0	0
3	32926025	.	G	A	6	6	12	0	0	12	0	0
3	32926058	.	A	G	6	10	16	0	0	16	0	0
3	32926148	.	G	A	2	2	4	0	0	4	0	0
3	32926184	.	A	T	2	2	4	0	0	4	0	0
3	32933774	.	A	C	4	7	11	0	0	11	0	0
3	32933849	.	A	T	6	6	12	0	0	12	0	0
3	32935936	.	A	G	6	0	6	0	8	14	0	0
3	32937628	.	A	G	16	15	31	0	0	31	0	0
3	32941242	.	G	A	7	7	14	0	1	15	0	0
3	32941661	.	A	G	6	6	12	0	0	12	0	0
3	32944203	.	C	A	9	8	17	0	0	17	0	0
3	32944569	.	C	T	2	4	6	0	0	6	0	0
3	32944668	.	C	A	13	15	28	0	2	30	0	0
3	32944854	.	C	T	16	22	38	0	1	39	0	0
3	32947971	.	T	C	4	2	6	0	1	7	0	0
3	32950959	.	G	A	9	9	18	0	0	18	0	0
3	32950977	.	G	A	0	9	9	0	14	23	0	0
3	32951001	.	G	T	0	8	8	0	13	21	0	0
3	32951394	.	G	A	22	18	40	0	1	41	0	0
3	32951564	.	A	C	4	14	18	0	0	18	0	0
3	32951637	.	G	A	8	7	15	0	0	15	0	0
3	32951778	.	C	T	11	15	26	0	2	28	0	0
3	32951891	.	T	C	14	12	26	0	0	26	0	0
3	33065643	.	T	A	3	3	6	0	0	6	0	0
3	33065950	.	T	C	2	3	5	0	0	5	0	0
3	33065985	.	A	G	2	6	8	0	0	8	0	0
3	33066155	.	C	T	0	5	5	0	8	13	0	0
3	33066292	.	C	T	7	3	10	0	0	10	0	0
3	33066629	.	C	T	0	3	3	0	4	7	0	0
3	33066804	.	T	C	6	0	6	0	7	13	0	0
3	33066809	.	C	G	6	6	12	0	1	13	0	0
3	33066969	.	T	C	10	0	10	0	5	15	0	0
3	33066976	.	T	C	6	5	11	0	1	12	0	0
3	33067337	.	A	G	2	2	4	0	1	5	0	0
3	33067340	.	A	G	2	3	5	0	0	5	0	0
3	33067376	.	G	A	3	4	7	0	0	7	0	0
3	33067438	.	G	A	1	2	3	0	0	3	0	0
3	33069274	.	A	C	3	6	9	0	1	10	0	0
3	33069596	.	G	A	7	5	12	0	1	13	0	0
3	33075167	.	C	T	1	1	2	0	0	2	0	0
3	33341072	.	T	A	3	5	8	0	2	10	0	0
3	33344470	.	T	A	5	10	15	0	0	15	0	0
3	33344636	.	A	T	2	3	5	0	0	5	0	0
3	33368134	.	T	C	3	4	7	0	5	12	0	0
3	33372555	.	G	C	0	3	3	0	5	8	0	0
3	33373540	.	A	C	6	7	13	0	0	13	0	0
3	33375645	.	C	A	3	5	8	0	0	8	0	0
3	33379072	.	C	T	7	7	14	0	1	15	0	0
3	33424010	.	C	T	0	9	9	0	10	19	0	0
3	33424420	.	G	A	18	25	43	0	6	49	0	0
3	33426513	.	G	A	10	4	14	0	0	14	0	0
3	33432893	.	T	C	1	2	3	0	0	3	0	0
3	33433319	.	T	C	2	0	2	0	5	7	0	0
3	33433621	.	G	A	4	6	10	0	0	10	0	0
3	33437399	.	T	C	3	2	5	0	0	5	0	0
3	33440693	.	C	T	3	7	10	0	0	10	0	0
3	33445039	.	A	T	5	4	9	0	1	10	0	0
3	33445090	.	G	C	0	8	8	0	9	17	0	0
3	33449405	.	C	T	4	3	7	0	0	7	0	0
3	33449554	.	G	A	0	4	4	0	7	11	0	0
3	33452168	.	C	T	11	27	38	0	0	38	0	0
3	33455809	.	G	A	0	9	9	0	4	13	0	0
3	33458803	.	C	T	15	15	30	0	2	32	0	0
3	33458911	.	A	T	16	9	25	0	1	26	0	0
3	33459394	.	T	A	6	8	14	0	1	15	0	0
3	33459489	.	C	T	3	2	5	0	0	5	0	0
3	33459517	.	C	T	4	4	8	0	0	8	0	0
3	33459532	.	G	A	4	5	9	0	0	9	0	0
3	33461366	.	C	T	0	13	13	0	14	27	0	0
3	33461646	.	C	T	0	8	8	0	9	17	0	0
3	33461796	.	A	T	16	7	23	0	0	23	0	0
3	33469614	.	T	A	1	5	6	0	1	7	0	0
3	33473131	.	C	T	0	4	4	0	10	14	0	0
3	33476589	.	T	C	8	7	15	0	2	17	0	0
3	33478690	.	G	A	7	3	10	0	1	11	0	0
3	33494089	.	A	T	10	13	23	0	0	24	1	0
3	33494091	.	G	C	9	13	22	0	2	24	0	0
3	33571002	.	C	T	4	2	6	0	0	6	0	0
3	33571264	.	T	C	4	1	5	0	2	7	0	0
3	33571294	.	C	T	2	3	5	0	2	7	0	0
3	33571840	.	G	C	3	0	3	0	4	7	0	0
3	33572206	.	G	C	4	0	4	0	6	10	0	0
3	33572298	.	G	A	3	5	8	0	0	8	0	0
3	33572335	.	C	T	3	5	8	0	0	8	0	0
3	33572404	.	C	T	0	3	3	0	3	6	0	0
3	33572512	.	C	A	2	2	4	0	1	5	0	0
3	33572553	.	T	G	2	5	7	0	0	7	0	0
3	33572668	.	A	G	4	2	6	0	0	6	0	0
3	33573178	.	G	A	3	4	7	0	0	7	0	0
3	33747563	.	A	G	0	1	1	0	2	3	0	0
3	33761597	.	C	T	13	10	23	0	0	23	0	0
3	33761705	.	G	A	1	18	19	0	20	39	0	0
3	33761834	.	G	A	16	21	37	0	2	39	0	0
3	33761835	.	A	T	15	22	37	0	2	39	0	0
3	33762068	.	A	G	10	11	21	0	3	24	0	0
3	33762278	.	A	G	14	14	28	0	0	28	0	0
3	33762310	.	C	A	13	14	27	0	2	29	0	0
3	33762408	.	T	A	11	19	30	0	0	30	0	0
3	33762480	.	C	T	16	5	21	0	0	21	0	0
3	33773294	.	A	G	13	19	32	0	2	34	0	0
3	33777317	.	T	G	9	10	19	0	0	19	0	0
3	33777425	.	A	G	15	15	30	0	0	30	0	0
3	33777807	.	A	G	1	2	3	0	0	3	0	0
3	33820291	.	T	C	2	6	8	0	0	8	0	0
3	33820309	.	T	C	3	2	5	0	0	5	0	0
3	33820568	.	C	T	1	1	2	0	0	2	0	0
3	33820580	.	A	G	1	0	1	0	0	1	0	0
3	33834678	.	T	C	0	1	1	0	0	1	0	0
3	33844761	.	T	C	0	0	0	0	1	1	0	0
3	33847191	.	T	C	2	4	6	0	0	6	0	0
3	33854879	.	T	C	1	8	9	0	0	9	0	0
3	33854927	.	G	A	3	6	9	0	0	9	0	0
3	33854972	.	A	G	2	0	2	0	1	3	0	0
3	33918611	.	A	G	5	4	9	0	0	9	0	0
3	33918675	.	T	G	3	11	14	0	0	14	0	0
3	33918775	.	A	G	10	8	18	0	0	18	0	0
3	33921663	.	A	C	8	11	19	0	1	20	0	0
3	33922198	.	C	T	0	2	2	0	0	2	0	0
3	33922233	.	T	A	0	2	2	0	0	2	0	0
3	33922269	.	A	G	3	2	5	0	0	5	0	0
3	33922359	.	G	A	4	7	11	0	0	11	0	0
3	33922413	.	T	A	5	7	12	0	0	12	0	0
3	33922415	.	G	A	4	7	11	0	1	12	0	0
3	33922471	.	T	C	3	6	9	0	0	9	0	0
3	33932170	.	C	T	0	2	2	0	4	6	0	0
3	33932430	.	T	A	1	0	1	0	0	1	0	0
3	33932628	.	G	A	1	5	6	0	0	6	0	0
3	33934848	.	T	C	4	3	7	0	0	7	0	0
3	33934849	.	G	C	3	4	7	0	0	7	0	0
3	33936783	.	G	C	4	4	8	0	0	8	0	0
3	34129941	.	C	T	0	14	14	0	14	28	0	0
3	34135868	.	C	T	2	3	5	0	0	5	0	0
3	34144353	.	A	T	5	0	5	0	0	5	0	0
3	34144807	.	C	G	4	5	9	0	0	9	0	0
3	34144808	.	G	A	0	5	5	0	4	9	0	0
3	34145131	.	T	G	3	5	8	0	0	8	0	0
3	34146338	.	C	T	5	5	10	0	0	10	0	0
3	34146882	.	G	T	6	13	19	0	1	20	0	0
3	34166288	.	C	A	5	3	8	0	0	8	0	0
3	34170913	.	G	A	13	16	29	0	0	29	0	0
3	34171862	.	C	G	3	0	3	0	12	15	0	0
3	34171867	.	C	G	3	1	4	0	12	16	0	0
3	34180332	.	A	G	8	5	13	0	0	13	0	0
3	34180386	.	G	A	9	9	18	0	0	18	0	0
3	34182164	.	C	T	8	6	14	0	0	14	0	0
3	34182376	.	A	C	5	7	12	0	0	12	0	0
3	34182386	.	G	A	0	5	5	0	5	10	0	0
3	34220359	.	A	T	1	4	5	0	0	5	0	0
3	34244901	.	G	C	3	11	14	0	0	14	0	0
3	34258965	.	G	A	11	14	25	0	1	26	0	0
3	34259013	.	C	G	12	10	22	0	6	28	0	0
3	34259060	.	C	T	21	13	34	0	0	34	0	0
3	34259868	.	A	T	3	3	6	0	6	15	3	0
3	34260325	.	T	C	2	10	12	0	1	13	0	0
3	34260808	.	T	C	8	9	17	0	0	17	0	0
3	34261204	.	T	C	5	4	9	0	1	10	0	0
3	34261354	.	A	G	11	15	26	0	0	26	0	0
3	34261795	.	G	A	10	7	17	0	0	17	0	0
3	34262290	.	C	T	11	12	23	0	1	24	0	0
3	34262421	.	C	A	9	10	19	0	0	19	0	0
3	34262639	.	G	A	16	9	25	0	1	26	0	0
3	34262823	.	A	T	13	7	20	0	2	22	0	0
3	34263007	.	C	T	0	10	10	0	7	18	1	0
3	34264140	.	A	T	5	0	5	0	1	6	0	0
3	34264634	.	T	A	10	6	16	0	2	18	0	0
3	34264657	.	A	T	7	6	13	0	1	14	0	0
3	34270546	.	A	G	5	10	15	0	0	15	0	0
3	34337389	.	A	G	2	3	5	0	0	5	0	0
3	34337734	.	A	T	2	2	4	0	0	4	0	0
3	34455908	.	C	T	0	3	3	0	1	4	0	0
3	34456405	.	A	G	1	2	3	0	1	4	0	0
3	34456538	.	A	G	2	2	4	0	1	5	0	0
3	34461700	.	A	G	0	1	1	0	0	1	0	0
3	34477190	.	G	A	2	1	3	0	0	3	0	0
3	34588493	.	A	G	1	3	4	0	0	4	0	0
3	34588788	.	G	A	3	8	11	0	0	11	0	0
3	34589396	.	A	C	1	4	5	0	0	5	0	0
3	34599655	.	T	G	4	4	8	0	0	8	0	0
3	34697514	.	T	C	6	0	6	0	7	13	0	0
3	34703722	.	T	G	4	7	11	0	0	11	0	0
3	34703731	.	G	C	4	6	10	0	1	11	0	0
3	34767112	.	G	T	29	23	52	0	3	55	0	0
3	34767662	.	T	G	26	31	57	0	0	57	0	0
3	34767669	.	G	A	27	25	52	0	2	54	0	0
3	34772941	.	T	G	16	20	36	0	1	37	0	0
3	34775942	.	G	A	22	13	35	0	1	36	0	0
3	34776115	.	T	G	5	0	5	0	0	5	0	0
3	34776133	.	G	C	4	3	7	0	2	9	0	0
3	34776151	.	C	A	4	3	7	0	2	9	0	0
3	34781074	.	A	G	17	39	56	0	2	58	0	0
3	34781095	.	C	T	17	33	50	0	4	54	0	0
3	34781448	.	T	C	7	11	18	0	1	19	0	0
3	34781586	.	T	C	1	0	1	0	2	3	0	0
3	34783970	.	G	A	5	8	13	0	2	15	0	0
3	34783982	.	A	G	12	9	21	0	1	22	0	0
3	34801034	.	T	C	10	8	18	0	1	19	0	0
3	34804427	.	A	G	15	12	27	0	3	30	0	0
3	34814839	.	A	G	2	4	6	0	0	6	0	0
3	34822049	.	C	T	18	14	32	0	2	34	0	0
3	34822169	.	C	T	16	16	32	0	0	32	0	0
3	34822214	.	T	C	10	12	22	0	1	23	0	0
3	34919853	.	A	G	3	0	3	0	4	7	0	0
3	34919892	.	C	T	9	10	19	0	1	20	0	0
3	34977497	.	A	G	4	1	5	0	3	8	0	0
3	34977508	.	A	G	2	0	2	0	0	2	0	0
3	34981394	.	T	C	2	3	5	0	1	6	0	0
3	34994140	.	C	T	34	29	63	0	1	64	0	0
3	34994750	.	A	G	10	14	24	0	0	24	0	0
3	35170112	.	T	C	9	6	15	0	0	15	0	0
3	35225160	.	A	G	17	0	17	0	11	28	0	0
3	35225202	.	C	T	20	14	34	0	1	35	0	0
3	35248387	.	T	C	20	9	29	0	3	32	0	0
3	35248470	.	T	C	12	14	26	0	0	26	0	0
3	35248492	.	T	A	13	10	23	0	3	26	0	0
3	35249369	.	T	C	15	15	30	0	0	30	0	0
3	35249535	.	T	C	9	16	25	0	1	26	0	0
3	35250145	.	A	T	15	16	31	0	0	31	0	0
3	35250188	.	A	G	8	10	18	0	1	19	0	0
3	35264406	.	T	G	24	11	35	0	3	38	0	0
3	35264460	.	C	T	16	22	38	0	1	39	0	0
3	35264744	.	T	A	13	18	31	0	2	33	0	0
3	35264951	.	G	A	14	7	21	0	1	22	0	0
3	35265350	.	T	C	15	12	27	0	1	28	0	0
3	35265419	.	T	G	14	9	23	0	0	24	1	0
3	35265654	.	G	A	0	27	27	0	19	46	0	0
3	35298531	.	G	T	8	5	13	0	0	13	0	0
3	35298725	.	T	A	4	6	10	0	0	10	0	0
3	35374514	.	C	T	1	2	3	0	0	3	0	0
3	35374719	.	C	T	9	11	20	0	1	21	0	0
3	35375112	.	G	A	6	10	16	0	0	16	0	0
3	35375162	.	T	A	14	9	23	0	4	27	0	0
3	35375279	.	A	T	6	6	12	0	1	13	0	0
3	35375306	.	T	C	8	7	15	0	0	15	0	0
3	35375448	.	T	G	12	0	12	0	13	25	0	0
3	35375638	.	T	A	13	10	23	0	0	23	0	0
3	35406475	.	G	A	3	4	7	0	0	7	0	0
3	35406648	.	G	T	0	3	3	0	2	5	0	0
3	35418047	.	A	G	5	6	11	0	1	12	0	0
3	35419683	.	A	T	11	10	21	0	3	24	0	0
3	35420588	.	A	G	5	3	8	0	2	10	0	0
3	35420604	.	C	T	5	2	7	0	2	9	0	0
3	35420733	.	A	T	6	4	10	0	0	10	0	0
3	35513674	.	A	G	1	0	1	0	0	1	0	0
3	35514849	.	C	A	5	4	9	0	4	13	0	0
3	35515053	.	G	T	3	4	7	0	1	8	0	0
3	35515074	.	C	T	4	7	11	0	0	11	0	0
3	35515103	.	G	A	4	8	12	0	0	12	0	0
3	35515179	.	T	C	5	5	10	0	1	11	0	0
3	35515206	.	G	A	4	3	7	0	0	7	0	0
3	35515304	.	T	G	5	8	13	0	1	14	0	0
3	35515866	.	A	T	10	6	16	0	0	16	0	0
3	35517999	.	A	C	5	9	14	0	0	14	0	0
3	35518036	.	C	G	10	6	16	0	0	16	0	0
3	35518464	.	A	C	1	1	2	0	0	2	0	0
3	35518962	.	C	A	1	1	2	0	0	2	0	0
3	35523824	.	C	G	9	6	15	0	0	15	0	0
3	35527024	.	T	C	2	3	5	0	0	5	0	0
3	35529040	.	T	C	9	16	25	0	0	25	0	0
3	35531018	.	T	C	4	8	12	0	3	15	0	0
3	35531028	.	T	C	8	9	17	0	1	18	0	0
3	35531328	.	G	A	0	7	7	0	8	15	0	0
3	35531329	.	A	T	8	7	15	0	0	15	0	0
3	35531671	.	A	T	11	6	17	0	0	17	0	0
3	35531791	.	A	G	10	0	10	0	16	26	0	0
3	35531866	.	T	A	15	15	30	0	0	30	0	0
3	35531985	.	G	A	15	17	32	0	1	33	0	0
3	35532074	.	A	T	17	14	31	0	2	33	0	0
3	35532452	.	A	T	14	17	31	0	1	32	0	0
3	35532634	.	A	G	14	0	14	0	15	29	0	0
3	35532665	.	C	T	15	11	26	0	1	27	0	0
3	35532736	.	A	C	6	9	15	0	0	16	1	0
3	35535588	.	A	G	1	3	4	0	0	4	0	0
3	35535589	.	C	T	0	3	3	0	1	4	0	0
3	35535652	.	T	A	0	1	1	0	0	1	0	0
3	35536115	.	C	G	13	15	28	0	2	30	0	0
3	35536269	.	G	A	1	0	1	0	1	2	0	0
3	35541273	.	A	G	21	35	56	0	3	59	0	0
3	35548780	.	T	C	3	3	6	0	0	6	0	0
3	35548822	.	C	A	4	3	7	0	0	7	0	0
3	35548903	.	G	A	3	3	6	0	0	6	0	0
3	35549002	.	G	A	2	2	4	0	0	4	0	0
3	35549018	.	C	T	4	2	6	0	0	6	0	0
3	35551047	.	A	T	16	12	28	0	3	31	0	0
3	35551190	.	C	T	0	6	6	0	18	24	0	0
3	35589548	.	C	T	15	22	37	0	1	38	0	0
3	35589881	.	T	C	11	20	31	0	5	36	0	0
3	35589908	.	A	G	22	20	42	0	0	42	0	0
3	35589918	.	G	A	18	24	42	0	1	43	0	0
3	35590270	.	T	C	29	1	30	0	25	55	0	0
3	35602007	.	A	C	22	0	22	0	20	42	0	0
3	35602047	.	A	G	23	24	47	0	2	49	0	0
3	35602153	.	A	G	17	12	29	0	0	29	0	0
3	35602154	.	T	A	17	12	29	0	0	29	0	0
3	35617940	.	A	C	2	1	3	0	0	3	0	0
3	35617943	.	A	C	2	1	3	0	0	3	0	0
3	35621473	.	G	A	0	0	0	0	1	1	0	0
3	35621515	.	T	G	6	0	6	0	4	10	0	0
3	35623614	.	A	G	0	1	1	0	0	1	0	0
3	35634953	.	A	G	2	6	8	0	0	8	0	0
3	35635039	.	C	T	6	9	15	0	0	15	0	0
3	35635135	.	A	G	3	0	3	0	3	6	0	0
3	35635282	.	T	C	10	2	12	0	0	12	0	0
3	35635283	.	T	C	10	2	12	0	0	12	0	0
3	35636095	.	A	G	6	3	9	0	1	10	0	0
3	35636172	.	A	G	8	2	10	0	0	10	0	0
3	35638119	.	A	C	12	12	24	0	1	25	0	0
3	35638201	.	A	G	15	16	31	0	0	31	0	0
3	35638240	.	C	T	10	10	20	0	1	21	0	0
3	35638450	.	T	A	3	4	7	0	0	7	0	0
3	35638513	.	G	A	9	8	17	0	2	19	0	0
3	35638908	.	C	T	1	18	19	0	21	40	0	0
3	35638986	.	C	A	14	15	29	0	2	31	0	0
3	35639020	.	A	G	13	16	29	0	2	31	0	0
3	35639021	.	G	A	14	17	31	0	0	31	0	0
3	35639194	.	T	C	9	12	21	0	1	22	0	0
3	35639621	.	A	C	13	10	23	0	0	23	0	0
3	35639817	.	T	A	5	5	10	0	2	12	0	0
3	35639862	.	G	T	9	8	17	0	0	17	0	0
3	35639884	.	T	C	6	0	6	0	8	14	0	0
3	35639958	.	T	C	5	3	8	0	0	8	0	0
3	35640042	.	A	G	6	11	17	1	1	19	0	0
3	35640122	.	G	T	7	7	14	1	1	16	0	0
3	35640625	.	C	T	13	7	20	0	1	21	0	0
3	35640784	.	T	C	8	13	21	0	0	21	0	0
3	35640828	.	A	G	10	3	13	0	0	13	0	0
3	35641173	.	C	T	7	2	9	0	0	9	0	0
3	35641371	.	C	T	0	12	12	0	15	27	0	0
3	35641382	.	G	A	15	13	28	0	1	29	0	0
3	35641595	.	A	T	12	14	26	0	2	28	0	0
3	35641663	.	T	C	14	7	21	0	2	23	0	0
3	35641785	.	C	T	0	7	7	0	7	14	0	0
3	35642012	.	A	T	9	12	21	0	0	21	0	0
3	35642072	.	A	G	9	14	23	0	0	23	0	0
3	35642242	.	T	C	6	0	6	0	6	12	0	0
3	35642462	.	T	C	5	1	6	0	9	15	0	0
3	35643320	.	G	A	5	7	12	0	0	12	0	0
3	35643357	.	G	A	1	4	5	0	2	7	0	0
3	35643540	.	G	A	6	10	16	0	0	16	0	0
3	35643546	.	A	T	5	8	13	0	0	13	0	0
3	35645380	.	T	C	8	1	9	0	15	24	0	0
3	35645411	.	G	A	7	6	13	0	0	13	0	0
3	35645661	.	T	G	11	14	25	0	4	29	0	0
3	35646025	.	G	T	8	9	17	0	1	18	0	0
3	35646160	.	G	T	7	7	14	0	0	14	0	0
3	35646611	.	T	G	8	4	12	0	0	12	0	0
3	35647181	.	A	G	5	14	19	0	2	21	0	0
3	35647321	.	G	A	10	5	15	0	2	17	0	0
3	35647882	.	G	A	0	3	3	0	0	3	0	0
3	35647975	.	A	G	3	5	8	0	0	8	0	0
3	35652750	.	G	A	2	2	4	0	0	4	0	0
3	35652765	.	G	A	4	1	5	0	1	6	0	0
3	35800319	.	G	A	2	2	4	0	0	4	0	0
3	35800614	.	C	G	2	2	4	0	1	5	0	0
3	35800738	.	T	C	9	6	15	0	0	15	0	0
3	35800758	.	T	G	7	0	7	0	5	12	0	0
3	35800995	.	A	G	2	3	5	0	0	5	0	0
3	35831029	.	T	C	0	3	3	0	0	3	0	0
3	35831095	.	G	T	4	4	8	0	0	8	0	0
3	35831167	.	T	C	2	0	2	0	2	4	0	0
3	35837532	.	C	T	3	1	4	0	0	4	0	0
3	35845735	.	A	G	0	0	0	0	1	1	0	0
3	35845774	.	T	C	0	2	2	0	0	2	0	0
3	35845805	.	A	G	1	2	3	0	0	3	0	0
3	35846120	.	C	G	5	7	12	0	1	13	0	0
3	35846343	.	C	G	5	1	6	0	0	6	0	0
3	35846410	.	A	T	3	5	8	0	0	8	0	0
3	35846440	.	G	A	3	6	9	0	1	10	0	0
3	35846823	.	A	G	4	5	9	0	0	9	0	0
3	35850364	.	A	G	2	6	8	0	0	8	0	0
3	35850380	.	C	T	2	3	5	0	0	5	0	0
3	35864419	.	G	A	2	1	3	0	0	3	0	0
3	36023342	.	T	G	14	21	35	0	1	37	1	0
3	36023455	.	A	G	13	12	25	0	2	27	0	0
3	36023465	.	A	G	16	16	32	0	0	32	0	0
3	36026294	.	C	G	1	13	14	0	5	19	0	0
3	36032241	.	G	A	3	0	3	0	1	4	0	0
3	36038631	.	G	A	21	8	29	0	0	29	0	0
3	36040863	.	A	G	5	3	8	0	0	8	0	0
3	36041017	.	A	C	15	9	24	0	0	24	0	0
3	36125256	.	C	G	1	5	6	0	7	13	0	0
3	36127108	.	G	A	2	4	6	0	0	6	0	0
3	36127402	.	A	G	3	0	3	0	2	5	0	0
3	36129027	.	A	T	2	2	4	0	0	4	0	0
3	36129646	.	T	G	0	1	1	0	0	1	0	0
3	36132099	.	C	T	4	0	4	0	0	4	0	0
3	36132740	.	T	C	7	8	15	0	0	15	0	0
3	36135084	.	A	G	2	6	8	0	2	10	0	0
3	36136184	.	T	A	1	1	2	0	2	4	0	0
3	36136186	.	A	T	1	3	4	0	0	4	0	0
3	36136609	.	T	C	4	7	11	0	0	11	0	0
3	36146491	.	C	A	1	1	2	0	0	2	0	0
3	36146497	.	G	C	1	1	2	0	0	2	0	0
3	36167286	.	T	C	6	4	10	0	0	10	0	0
3	36173633	.	T	C	15	7	22	0	1	23	0	0
3	36174175	.	C	A	11	18	29	0	2	31	0	0
3	36174248	.	C	G	8	13	21	0	0	21	0	0
3	36174276	.	T	C	9	1	10	0	11	21	0	0
3	36184806	.	A	G	4	3	7	0	1	8	0	0
3	36188400	.	A	G	3	2	5	0	0	5	0	0
3	36210030	.	G	A	9	7	16	0	0	16	0	0
3	36210074	.	C	T	8	7	15	0	0	15	0	0
3	36210307	.	T	A	3	3	6	0	0	6	0	0
3	36224109	.	C	T	2	2	4	0	0	4	0	0
3	36226431	.	A	G	1	0	1	0	0	1	0	0
3	36228235	.	A	G	1	0	1	0	2	3	0	0
3	36229823	.	G	A	2	4	6	0	0	6	0	0
3	36232331	.	C	T	9	3	12	0	0	12	0	0
3	36232368	.	A	C	4	2	6	0	0	6	0	0
3	36241839	.	T	C	5	1	6	0	1	7	0	0
3	36241938	.	T	C	4	0	4	0	4	8	0	0
3	36242239	.	C	T	0	0	0	0	2	2	0	0
3	36249172	.	C	T	3	4	7	0	0	7	0	0
3	36249419	.	G	A	22	5	27	0	0	27	0	0
3	36249476	.	T	A	20	15	35	0	1	36	0	0
3	36249516	.	T	A	18	10	28	0	2	30	0	0
3	36249518	.	A	C	18	12	30	0	0	30	0	0
3	36253186	.	G	A	0	1	1	0	0	1	0	0
3	36255436	.	A	G	3	3	6	0	1	7	0	0
3	36259855	.	T	C	22	18	40	0	0	40	0	0
3	36262799	.	A	C	12	1	13	0	16	29	0	0
3	36263099	.	T	C	15	1	16	0	15	31	0	0
3	36263151	.	A	G	11	17	28	0	1	29	0	0
3	36263163	.	C	T	14	16	30	0	0	30	0	0
3	36263464	.	C	A	11	17	28	0	1	29	0	0
3	36263557	.	A	G	13	20	33	0	1	34	0	0
3	36263563	.	T	A	13	20	33	0	0	33	0	0
3	36263596	.	T	C	8	0	8	0	15	23	0	0
3	36263666	.	T	C	5	0	5	0	7	12	0	0
3	36263824	.	T	C	18	21	39	0	3	42	0	0
3	36263895	.	A	T	15	19	34	0	1	35	0	0
3	36264028	.	T	C	14	0	14	0	16	30	0	0
3	36264204	.	T	G	14	13	27	0	0	27	0	0
3	36264217	.	A	C	11	15	26	0	0	26	0	0
3	36264248	.	T	C	14	10	24	0	0	24	0	0
3	36264822	.	C	A	1	4	5	0	0	5	0	0
3	36265895	.	C	T	0	1	1	0	5	6	0	0
3	36266137	.	T	A	1	0	1	0	1	2	0	0
3	36266173	.	A	G	8	7	15	0	0	15	0	0
3	36268616	.	A	G	12	15	27	0	0	27	0	0
3	36285177	.	C	A	3	2	5	0	0	5	0	0
3	36291213	.	A	G	3	1	4	0	2	6	0	0
3	36292481	.	G	C	0	2	2	0	7	9	0	0
3	36292657	.	T	C	3	4	7	0	0	7	0	0
3	36293950	.	C	T	6	4	10	0	0	10	0	0
3	36293964	.	C	T	6	6	12	0	0	12	0	0
3	36305854	.	A	G	14	20	34	0	2	36	0	0
3	36305860	.	A	G	16	0	16	0	21	37	0	0
3	36305971	.	T	A	12	15	27	0	0	27	0	0
3	36319778	.	T	A	1	1	2	0	0	2	0	0
3	36323064	.	C	T	3	2	5	0	0	5	0	0
3	36323523	.	T	C	1	2	3	0	0	3	0	0
3	36323598	.	A	C	1	1	2	0	0	2	0	0
3	36323604	.	C	T	1	1	2	0	0	2	0	0
3	36325569	.	T	A	2	4	6	0	0	6	0	0
3	36325599	.	G	C	1	2	3	0	1	4	0	0
3	36325648	.	A	T	5	5	10	0	0	10	0	0
3	36325802	.	A	G	5	1	6	0	5	11	0	0
3	36326139	.	T	G	2	3	5	0	1	6	0	0
3	36326482	.	T	A	1	2	3	0	0	3	0	0
3	36326490	.	A	T	1	2	3	0	0	3	0	0
3	36326681	.	T	C	2	3	5	0	1	6	0	0
3	36326685	.	T	A	3	3	6	0	0	6	0	0
3	36326839	.	T	A	2	2	4	0	0	4	0	0
3	36327060	.	G	A	0	2	2	0	4	6	0	0
3	36327061	.	A	C	3	3	6	0	0	6	0	0
3	36327129	.	G	A	4	3	7	0	1	8	0	0
3	36327872	.	G	A	5	4	9	0	0	9	0	0
3	36327906	.	G	T	3	3	6	0	0	6	0	0
3	36327909	.	G	T	0	2	2	0	4	6	0	0
3	36327961	.	A	G	7	1	8	0	0	8	0	0
3	36327970	.	G	A	6	2	8	0	0	8	0	0
3	36328029	.	T	G	6	3	9	0	0	9	0	0
3	36328339	.	G	A	2	4	6	0	0	6	0	0
3	36328390	.	A	T	1	2	3	0	0	3	0	0
3	36328414	.	T	A	1	2	3	0	1	4	0	0
3	36349176	.	T	C	2	2	4	0	1	5	0	0
3	36407283	.	C	A	2	1	3	0	0	3	0	0
3	36407604	.	A	G	2	5	7	0	0	7	0	0
3	36408402	.	G	T	1	2	3	0	0	3	0	0
3	36409656	.	C	T	3	2	5	0	0	5	0	0
3	36409721	.	G	A	2	3	5	0	0	5	0	0
3	36409877	.	C	T	4	5	9	0	0	9	0	0
3	36409969	.	T	C	1	3	4	0	0	4	0	0
3	36410038	.	T	A	1	2	3	0	0	3	0	0
3	36410157	.	A	G	2	3	5	0	0	5	0	0
3	36410172	.	A	G	2	2	4	0	0	4	0	0
3	36414501	.	A	G	2	2	4	0	1	5	0	0
3	36415987	.	A	G	1	1	2	0	0	2	0	0
3	36415999	.	A	C	1	1	2	0	0	2	0	0
3	36416026	.	C	A	1	2	3	0	0	3	0	0
3	36419413	.	A	C	3	4	7	0	0	7	0	0
3	36419512	.	C	T	2	1	3	0	1	4	0	0
3	36428612	.	T	A	21	21	42	0	1	43	0	0
3	36428620	.	T	A	22	21	43	0	0	43	0	0
3	36431380	.	T	C	8	11	19	0	1	20	0	0
3	36441465	.	G	A	5	4	9	0	0	9	0	0
3	36441484	.	T	C	4	8	12	0	1	13	0	0
3	36442021	.	T	C	4	3	7	0	0	7	0	0
3	36442029	.	A	G	3	3	6	0	0	6	0	0
3	36442551	.	C	T	1	17	18	0	5	23	0	0
3	36442661	.	T	G	11	11	22	0	0	22	0	0
3	36442726	.	A	G	13	10	23	0	1	24	0	0
3	36443189	.	G	A	1	1	2	0	0	2	0	0
3	36446613	.	A	G	5	4	9	0	0	9	0	0
3	36859720	.	C	T	19	9	28	0	0	28	0	0
3	36859755	.	A	T	15	9	24	0	2	26	0	0
3	36859767	.	A	G	15	1	16	0	12	28	0	0
3	36859821	.	G	T	9	9	18	0	2	20	0	0
3	36862242	.	T	G	7	5	12	0	0	12	0	0
3	36868428	.	T	C	1	2	3	0	0	3	0	0
3	36871254	.	A	T	12	11	23	0	2	25	0	0
3	36871260	.	G	A	0	10	10	0	15	25	0	0
3	36871310	.	A	G	16	1	17	0	10	27	0	0
3	36871316	.	A	G	12	0	12	0	11	23	0	0
3	36877656	.	A	G	18	11	29	0	1	30	0	0
3	36880046	.	C	T	8	3	11	0	0	11	0	0
3	36883659	.	A	G	17	0	17	0	17	34	0	0
3	36888169	.	T	C	1	5	6	0	0	6	0	0
3	36888395	.	G	A	2	3	5	0	2	7	0	0
3	36889376	.	G	A	0	0	0	0	6	6	0	0
3	36889821	.	A	G	1	0	1	0	1	2	0	0
3	36892130	.	C	T	14	15	29	0	0	29	0	0
3	36892294	.	T	C	10	4	14	0	0	14	0	0
3	36892298	.	G	C	7	4	11	0	1	12	0	0
3	36892514	.	G	C	2	5	7	0	0	7	0	0
3	36909852	.	T	G	1	1	2	0	0	2	0	0
3	36910132	.	T	G	3	3	6	0	2	8	0	0
3	36917320	.	A	T	4	6	10	0	1	11	0	0
3	36917365	.	A	G	5	7	12	0	0	12	0	0
3	36918852	.	G	A	1	2	3	0	0	3	0	0
3	36918966	.	A	G	1	0	1	0	0	1	0	0
3	36923226	.	G	A	4	1	5	0	0	5	0	0
3	36923412	.	A	G	3	3	6	0	0	6	0	0
3	36923933	.	C	T	4	5	9	0	1	10	0	0
3	36926417	.	A	G	0	1	1	0	0	1	0	0
3	36926456	.	C	T	0	3	3	0	3	6	0	0
3	36926886	.	G	A	6	2	8	0	0	8	0	0
3	36929565	.	A	G	2	1	3	0	0	3	0	0
3	37051914	.	A	G	2	2	4	0	0	4	0	0
3	37053099	.	A	G	0	3	3	0	0	3	0	0
3	37107093	.	C	T	2	4	6	0	1	7	0	0
3	37107100	.	G	T	8	4	12	0	0	12	0	0
3	37237750	.	T	C	5	3	8	0	1	9	0	0
3	37558513	.	T	A	3	2	5	0	0	5	0	0
3	37558571	.	C	A	3	2	5	0	0	5	0	0
3	37559334	.	A	T	21	29	50	0	0	50	0	0
3	37559905	.	A	C	11	22	33	0	1	34	0	0
3	37564769	.	G	A	17	18	35	0	3	38	0	0
3	37649598	.	G	C	3	3	6	0	1	7	0	0
3	37660307	.	G	A	8	5	13	0	0	13	0	0
3	37664117	.	A	T	8	11	19	0	0	19	0	0
3	37664635	.	A	G	14	7	21	0	0	21	0	0
3	37665855	.	G	A	20	27	47	0	0	47	0	0
3	37666774	.	C	T	0	14	14	0	15	29	0	0
3	37667562	.	C	T	0	20	20	0	16	36	0	0
3	37667608	.	G	C	10	20	30	0	2	32	0	0
3	37667646	.	C	T	7	16	23	0	2	25	0	0
3	37667952	.	C	T	0	16	16	0	13	29	0	0
3	37668319	.	A	G	7	10	17	0	0	17	0	0
3	37668370	.	T	C	3	2	5	0	0	5	0	0
3	37668578	.	T	A	10	7	17	0	1	18	0	0
3	37668667	.	C	A	9	5	14	0	0	14	0	0
3	37670156	.	G	T	4	4	8	0	1	9	0	0
3	37673750	.	T	A	9	10	19	0	0	19	0	0
3	37725453	.	A	G	5	0	5	0	4	9	0	0
3	37726111	.	C	T	3	3	6	0	0	6	0	0
3	37727784	.	T	C	4	4	8	0	0	8	0	0
3	37727926	.	C	G	2	4	6	0	1	7	0	0
3	37730412	.	T	C	1	2	3	0	0	3	0	0
3	37737680	.	C	A	9	6	15	0	1	16	0	0
3	37737735	.	T	G	2	0	2	0	4	6	0	0
3	37737736	.	C	T	2	4	6	0	0	6	0	0
3	37737852	.	A	G	1	1	2	0	0	2	0	0
3	37738024	.	A	G	4	10	14	0	1	15	0	0
3	37738050	.	C	G	2	10	12	0	0	12	0	0
3	37738089	.	G	A	3	8	11	0	0	11	0	0
3	37742245	.	C	T	5	6	11	0	1	12	0	0
3	37742247	.	A	G	5	5	10	0	2	12	0	0
3	37742284	.	T	G	5	3	8	0	1	9	0	0
3	37742338	.	C	G	3	3	6	0	0	6	0	0
3	37742363	.	C	T	2	4	6	0	0	6	0	0
3	37776713	.	T	C	3	4	7	0	0	7	0	0
3	37777309	.	A	T	2	5	7	0	2	9	0	0
3	37777417	.	G	C	2	4	6	0	0	6	0	0
3	37777590	.	C	T	6	6	12	0	2	14	0	0
3	37777811	.	C	T	0	8	8	0	8	16	0	0
3	37788401	.	T	C	2	1	3	1	0	4	0	0
3	37789216	.	G	T	8	3	11	0	0	11	0	0
3	37827364	.	G	A	0	1	1	0	0	1	0	0
3	37827420	.	G	A	1	1	2	0	0	2	0	0
3	37827822	.	C	T	4	6	10	0	0	10	0	0
3	37827948	.	C	T	4	5	9	0	1	10	0	0
3	38505629	.	A	G	3	6	9	0	1	10	0	0
3	38614426	.	A	G	5	0	5	0	3	8	0	0
3	38614562	.	C	T	2	2	4	0	0	4	0	0
3	38624737	.	A	G	4	0	4	0	2	6	0	0
3	38624823	.	G	A	10	8	18	0	1	19	0	0
3	38625098	.	A	C	18	11	29	0	0	29	0	0
3	38625497	.	G	T	16	4	20	0	1	21	0	0
3	38625559	.	T	C	11	3	14	0	1	15	0	0
3	38625605	.	G	A	9	9	18	0	1	19	0	0
3	38625751	.	A	C	13	5	18	0	1	19	0	0
3	38625901	.	T	G	12	8	20	0	0	20	0	0
3	38649991	.	A	T	6	11	17	0	0	17	0	0
3	38650341	.	T	C	11	4	15	0	0	15	0	0
3	38650348	.	T	C	0	16	16	0	0	16	0	0
3	38650440	.	T	C	3	7	10	0	1	11	0	0
3	38650462	.	T	C	5	8	13	0	1	14	0	0
3	38763153	.	T	A	3	12	15	0	1	16	0	0
3	38763174	.	G	A	4	9	13	0	8	21	0	0
3	38763391	.	A	G	4	7	11	0	1	12	0	0
3	38763449	.	C	T	6	6	12	0	0	12	0	0
3	38763700	.	G	A	3	3	6	0	0	6	0	0
3	38764738	.	A	C	3	0	3	0	5	8	0	0
3	38765811	.	A	T	2	4	6	0	1	7	0	0
3	38766395	.	G	A	1	1	2	0	1	3	0	0
3	38766507	.	G	A	3	4	7	0	0	7	0	0
3	38766813	.	A	G	2	2	4	0	0	4	0	0
3	38767750	.	T	C	0	1	1	0	0	1	0	0
3	38793631	.	C	T	3	5	8	0	0	8	0	0
3	38793674	.	A	G	3	2	5	0	0	5	0	0
3	38794066	.	C	T	2	2	4	0	0	4	0	0
3	38794422	.	G	C	4	2	6	0	0	6	0	0
3	38858514	.	T	G	2	0	2	0	2	4	0	0
3	38858649	.	A	G	4	2	6	0	0	6	0	0
3	38858673	.	C	A	3	4	7	0	2	9	0	0
3	38858722	.	G	A	3	3	6	0	0	6	0	0
3	38858908	.	G	A	0	2	2	0	1	3	0	0
3	38858949	.	G	C	3	6	9	0	0	9	0	0
3	38859066	.	G	A	1	6	7	0	0	7	0	0
3	39181560	.	A	C	3	2	5	0	0	5	0	0
3	39181635	.	C	T	2	5	7	0	0	7	0	0
3	39181745	.	T	A	1	2	3	0	0	3	0	0
3	39181758	.	C	A	1	2	3	0	0	3	0	0
3	39181793	.	A	G	2	3	5	0	0	5	0	0
3	39181823	.	A	G	3	7	10	0	0	10	0	0
3	39181849	.	A	G	7	8	15	0	1	16	0	0
3	39184156	.	A	G	7	8	15	0	0	15	0	0
3	39184180	.	C	T	6	10	16	0	0	16	0	0
3	39184710	.	A	G	3	5	8	0	0	8	0	0
3	39186729	.	T	C	4	3	7	2	0	9	0	0
3	39238579	.	C	A	4	4	8	0	0	8	0	0
3	39238580	.	C	A	4	4	8	0	0	8	0	0
3	39239380	.	A	G	3	6	9	0	0	9	0	0
3	39241350	.	G	T	5	1	6	0	0	6	0	0
3	39248863	.	A	G	6	9	15	0	1	16	0	0
3	39251020	.	G	T	0	2	2	0	0	2	0	0
3	39259624	.	T	C	11	0	11	0	6	17	0	0
3	39260767	.	A	T	1	2	3	0	0	3	0	0
3	39260818	.	A	G	1	2	3	0	0	3	0	0
3	39261182	.	C	A	0	2	2	0	3	5	0	0
3	39261230	.	C	T	4	5	9	0	0	9	0	0
3	39261270	.	C	T	0	4	4	0	3	7	0	0
3	39261709	.	T	C	1	0	1	0	2	3	0	0
3	39261718	.	C	T	1	3	4	0	0	4	0	0
3	39261765	.	C	T	4	2	6	0	0	6	0	0
3	39261843	.	T	G	2	3	5	0	0	5	0	0
3	39261865	.	C	A	2	4	6	0	0	6	0	0
3	39262338	.	C	G	9	3	12	0	0	12	0	0
3	39262694	.	A	G	1	3	4	0	0	4	0	0
3	39262695	.	T	A	1	3	4	0	0	4	0	0
3	39262801	.	C	A	0	2	2	0	1	3	0	0
3	39263444	.	T	G	1	5	6	0	0	6	0	0
3	39313310	.	A	G	5	10	15	0	1	16	0	0
3	39313625	.	T	C	14	6	20	0	0	20	0	0
3	39314028	.	C	T	10	11	21	0	2	23	0	0
3	39314101	.	T	C	7	8	15	0	1	16	0	0
3	39314146	.	C	G	13	13	26	0	0	26	0	0
3	39314260	.	A	G	9	6	15	0	0	15	0	0
3	39314502	.	G	C	13	8	21	0	1	22	0	0
3	39314631	.	C	T	0	14	14	0	7	21	0	0
3	39314677	.	C	T	6	8	14	0	0	14	0	0
3	39314857	.	G	T	5	2	7	0	0	7	0	0
3	39314893	.	C	A	6	2	8	0	0	8	0	0
3	39314899	.	C	T	6	2	8	0	0	8	0	0
3	39314931	.	C	G	5	2	7	0	0	7	0	0
3	39315154	.	C	A	6	4	10	0	0	10	0	0
3	39315169	.	C	G	7	5	12	0	0	12	0	0
3	39315191	.	C	G	2	7	9	0	1	10	0	0
3	39315229	.	A	T	2	2	4	0	0	4	0	0
3	39315292	.	A	G	7	3	10	0	0	10	0	0
3	39315728	.	C	T	10	4	14	0	0	14	0	0
3	39315737	.	T	C	9	2	11	0	0	11	0	0
3	39315816	.	A	G	1	3	4	0	0	4	0	0
3	39315874	.	C	A	6	10	16	0	2	18	0	0
3	39315876	.	C	T	6	9	15	0	3	18	0	0
3	39315937	.	A	C	9	0	9	0	6	15	0	0
3	39316037	.	T	C	9	7	16	0	1	17	0	0
3	39316062	.	G	A	10	8	18	0	0	18	0	0
3	39316167	.	A	G	9	10	19	0	0	19	0	0
3	39316570	.	G	A	9	6	15	0	1	16	0	0
3	39316846	.	T	C	10	12	22	0	2	24	0	0
3	39316906	.	C	A	16	15	31	0	2	33	0	0
3	39316912	.	G	A	14	16	30	0	1	31	0	0
3	39316996	.	A	G	16	17	33	0	1	34	0	0
3	39317215	.	C	G	4	11	15	0	2	17	0	0
3	39317279	.	C	T	8	6	14	0	0	14	0	0
3	39317310	.	T	C	6	8	14	0	3	17	0	0
3	39317370	.	C	T	5	8	13	0	0	13	0	0
3	39322109	.	G	A	2	1	3	0	1	4	0	0
3	39328095	.	G	C	9	4	13	0	1	14	0	0
3	39330407	.	T	C	8	0	8	0	5	13	0	0
3	39348533	.	G	A	8	9	17	0	2	19	0	0
3	39348914	.	G	A	9	7	16	0	1	17	0	0
3	39454708	.	C	G	3	2	5	0	0	5	0	0
3	39560664	.	T	C	1	2	3	0	0	3	0	0
3	39568368	.	T	G	8	4	12	0	0	12	0	0
3	39568856	.	A	G	13	24	37	0	0	37	0	0
3	39574883	.	C	A	16	21	37	0	1	38	0	0
3	39574961	.	G	A	32	29	61	0	3	64	0	0
3	39576621	.	T	G	23	6	29	0	31	60	0	0
3	39576663	.	A	G	31	44	75	0	2	77	0	0
3	39576866	.	T	C	30	20	50	0	2	52	0	0
3	39579562	.	T	C	2	2	4	0	0	4	0	0
3	39579616	.	C	A	3	3	6	0	0	6	0	0
3	39579660	.	G	T	1	1	2	0	0	2	0	0
3	39580908	.	T	C	1	1	2	0	0	2	0	0
3	39586473	.	A	T	4	2	6	0	0	6	0	0
3	39592640	.	T	G	1	2	3	0	0	3	0	0
3	39592797	.	C	T	4	5	9	0	0	9	0	0
3	39592800	.	G	C	0	5	5	0	4	9	0	0
3	39606220	.	C	T	8	9	17	0	3	20	0	0
3	39612261	.	T	A	16	10	26	0	1	27	0	0
3	39612430	.	T	C	6	11	17	0	3	20	0	0
3	39612579	.	G	C	8	10	18	0	0	18	0	0
3	39612715	.	A	T	9	8	17	0	0	17	0	0
3	39613024	.	T	C	14	13	27	0	0	27	0	0
3	39631505	.	T	C	3	4	7	0	0	7	0	0
3	39686776	.	T	A	7	2	9	0	1	10	0	0
3	39686807	.	A	T	4	2	6	0	0	6	0	0
3	39687418	.	C	T	3	2	5	0	2	7	0	0
3	39688892	.	T	C	6	4	10	0	0	10	0	0
3	39688906	.	C	T	5	3	8	0	1	9	0	0
3	39689216	.	T	C	7	2	9	0	1	10	0	0
3	39689234	.	G	T	6	5	11	0	1	12	0	0
3	39689277	.	A	G	4	5	9	0	1	10	0	0
3	39691978	.	C	G	1	5	6	0	0	6	0	0
3	39692008	.	G	T	3	7	10	0	0	10	0	0
3	39692165	.	A	T	4	9	13	0	0	13	0	0
3	39692196	.	C	T	0	10	10	0	5	15	0	0
3	39692206	.	C	T	6	5	11	0	0	11	0	0
3	39692235	.	C	A	7	7	14	0	1	15	0	0
3	39692265	.	G	A	6	9	15	0	1	16	0	0
3	39692307	.	A	G	9	9	18	0	0	18	0	0
3	39878822	.	T	C	4	3	7	0	0	7	0	0
3	39919127	.	G	A	0	5	5	0	0	5	0	0
3	39923512	.	G	A	0	1	1	0	5	6	0	0
3	39925087	.	T	C	1	1	2	0	0	2	0	0
3	39940210	.	T	C	4	0	4	0	0	4	0	0
3	39945696	.	A	G	0	3	3	0	0	3	0	0
3	39949389	.	G	A	4	3	7	0	0	7	0	0
3	39949650	.	G	A	0	1	1	0	2	3	0	0
3	39950276	.	A	C	9	7	16	0	2	18	0	0
3	39950340	.	C	T	11	8	19	0	0	19	0	0
3	39950414	.	T	C	15	11	26	0	2	28	0	0
3	39950954	.	T	C	11	6	17	0	0	17	0	0
3	39951124	.	C	T	5	8	13	0	1	14	0	0
3	39951216	.	T	C	6	5	11	0	1	12	0	0
3	39951703	.	A	T	6	7	13	0	0	13	0	0
3	39952025	.	T	C	6	9	15	0	2	17	0	0
3	39952272	.	A	G	7	6	13	0	0	13	0	0
3	39952273	.	A	T	7	6	13	0	0	13	0	0
3	39958680	.	C	T	3	7	10	0	0	11	1	0
3	39958729	.	T	A	7	11	18	0	0	18	0	0
3	39959679	.	A	C	6	6	12	0	1	13	0	0
3	39960535	.	G	C	0	1	1	0	3	4	0	0
3	39962981	.	T	C	6	13	19	0	0	19	0	0
3	39963053	.	T	C	10	9	19	0	0	19	0	0
3	39963089	.	A	G	5	6	11	0	1	12	0	0
3	39963128	.	G	A	0	0	0	0	1	1	0	0
3	39970568	.	C	A	11	3	14	0	0	14	0	0
3	39970641	.	T	G	12	6	18	0	0	18	0	0
3	39971470	.	T	C	9	4	13	0	1	14	0	0
3	39971499	.	T	C	11	5	16	0	0	16	0	0
3	39971592	.	T	C	4	5	9	0	1	10	0	0
3	39971894	.	T	C	8	10	18	0	0	18	0	0
3	39971930	.	T	C	11	3	14	0	0	14	0	0
3	39972127	.	T	C	7	3	10	0	0	10	0	0
3	39975467	.	T	C	9	1	10	0	9	19	0	0
3	39982019	.	C	T	5	5	10	0	4	14	0	0
3	39982198	.	A	T	1	1	2	0	0	2	0	0
3	39982423	.	T	C	0	0	0	0	2	2	0	0
3	39984551	.	C	T	0	1	1	0	4	5	0	0
3	39984776	.	G	T	3	3	6	0	0	6	0	0
3	39987992	.	T	C	2	0	2	0	4	6	0	0
3	40003947	.	T	G	3	2	5	0	0	5	0	0
3	40015234	.	G	A	2	2	4	0	0	4	0	0
3	40054647	.	C	T	0	3	3	0	1	4	0	0
3	40154387	.	C	T	7	2	9	0	3	12	0	0
3	40158383	.	C	G	5	8	13	0	0	13	0	0
3	40160676	.	G	A	1	0	1	0	1	2	0	0
3	40161564	.	T	C	3	0	3	0	2	5	0	0
3	40162535	.	T	C	2	0	2	0	1	3	0	0
3	40164156	.	C	T	5	7	12	0	0	12	0	0
3	40164233	.	T	C	7	12	19	0	1	20	0	0
3	40164238	.	G	T	8	11	19	0	2	21	0	0
3	40165637	.	T	C	5	10	15	0	0	15	0	0
3	40165733	.	T	C	10	5	15	0	2	17	0	0
3	40168006	.	A	C	2	1	3	0	0	3	0	0
3	40168007	.	G	A	2	1	3	0	0	3	0	0
3	40168192	.	T	G	6	7	13	0	0	13	0	0
3	40168424	.	T	G	1	2	3	0	0	3	0	0
3	40172218	.	C	T	9	18	27	0	0	27	0	0
3	40178148	.	C	T	25	25	50	0	0	50	0	0
3	40178154	.	C	T	26	25	51	0	1	52	0	0
3	40178343	.	G	A	15	17	32	0	0	32	0	0
3	40178833	.	G	A	0	7	7	0	11	18	0	0
3	40178956	.	G	T	15	13	28	0	0	28	0	0
3	40179025	.	G	C	26	10	36	0	1	37	0	0
3	40179331	.	A	T	23	12	35	0	2	37	0	0
3	40179457	.	A	T	16	8	24	0	1	25	0	0
3	40179476	.	T	C	15	11	26	0	0	26	0	0
3	40179528	.	G	T	15	20	35	0	0	35	0	0
3	40179533	.	T	A	15	21	36	0	0	37	1	0
3	40179604	.	T	A	26	19	45	0	1	46	0	0
3	40179608	.	A	G	26	21	47	0	2	49	0	0
3	40179642	.	C	T	27	15	42	0	8	50	0	0
3	40179669	.	G	A	30	17	47	0	4	51	0	0
3	40179849	.	C	T	19	26	45	0	3	49	1	0
3	40179870	.	C	A	15	32	47	0	3	50	0	0
3	40180023	.	A	G	15	0	15	0	28	43	0	0
3	40180091	.	A	G	21	20	41	0	1	42	0	0
3	40180092	.	A	G	20	20	40	0	2	42	0	0
3	40180197	.	A	T	10	5	15	0	2	17	0	0
3	40186041	.	C	T	8	4	12	0	0	12	0	0
3	40188830	.	A	G	2	5	7	0	0	7	0	0
3	40189828	.	A	C	5	0	5	0	1	6	0	0
3	40190805	.	A	G	6	6	12	0	0	12	0	0
3	40190926	.	C	T	0	3	3	0	4	7	0	0
3	40191012	.	C	T	0	5	5	0	2	7	0	0
3	40191061	.	A	T	4	3	7	0	0	7	0	0
3	40191116	.	C	T	2	6	8	0	1	9	0	0
3	40193589	.	G	T	4	2	6	0	0	6	0	0
3	40193819	.	C	T	5	3	8	0	0	8	0	0
3	40202440	.	C	A	1	2	3	0	0	3	0	0
3	40206184	.	G	A	10	5	15	0	0	15	0	0
3	40206430	.	G	T	14	5	19	0	0	19	0	0
3	40206440	.	T	C	13	5	18	0	0	18	0	0
3	40206597	.	A	T	12	9	21	0	0	21	0	0
3	40206736	.	T	G	10	12	22	0	0	22	0	0
3	40206766	.	C	T	1	10	11	0	9	20	0	0
3	40207030	.	A	G	12	8	20	0	3	23	0	0
3	40207407	.	A	C	5	3	8	0	0	8	0	0
3	40207449	.	C	A	3	4	7	0	1	8	0	0
3	40212040	.	G	T	3	7	10	0	0	10	0	0
3	40214005	.	C	T	8	3	11	0	0	11	0	0
3	40216281	.	G	A	2	0	2	0	0	2	0	0
3	40218727	.	G	A	0	1	1	0	0	1	0	0
3	40219194	.	C	T	0	0	0	0	1	1	0	0
3	40220951	.	G	A	5	3	8	0	0	8	0	0
3	40220984	.	A	G	8	3	11	0	0	11	0	0
3	40221059	.	G	A	1	1	2	0	0	2	0	0
3	40235463	.	G	C	1	0	1	0	2	3	0	0
3	40235483	.	T	A	1	3	4	0	0	4	0	0
3	40241337	.	A	T	1	0	1	0	0	1	0	0
3	40255500	.	G	T	0	2	2	0	2	4	0	0
3	40255951	.	C	T	1	5	6	0	0	6	0	0
3	40256373	.	G	A	2	7	9	0	0	9	0	0
3	40256418	.	C	T	3	9	12	0	0	12	0	0
3	40256688	.	T	C	6	5	11	0	0	11	0	0
3	40256734	.	G	A	4	4	8	0	0	8	0	0
3	40256735	.	C	A	4	2	6	0	2	8	0	0
3	40256864	.	C	T	3	3	6	0	0	6	0	0
3	40257397	.	C	G	2	5	7	0	0	7	0	0
3	40261168	.	G	A	1	3	4	0	0	4	0	0
3	40268089	.	C	T	0	1	1	0	0	1	0	0
3	40280034	.	T	C	1	0	1	0	0	1	0	0
3	40284375	.	T	C	13	0	13	0	7	20	0	0
3	40284447	.	T	A	8	6	14	0	0	14	0	0
3	40284837	.	A	T	6	5	11	0	0	11	0	0
3	40284860	.	G	T	13	11	24	0	0	24	0	0
3	40287149	.	C	T	10	12	22	0	1	23	0	0
3	40287227	.	C	T	2	2	4	0	0	4	0	0
3	40287538	.	C	T	0	3	3	0	1	4	0	0
3	40287808	.	A	G	3	5	8	0	0	8	0	0
3	40290123	.	T	C	12	8	20	0	0	20	0	0
3	40294179	.	G	A	3	0	3	0	0	3	0	0
3	40294969	.	A	G	5	0	5	1	7	13	0	0
3	40299905	.	A	T	2	5	7	0	1	8	0	0
3	40318555	.	C	G	1	0	1	0	1	2	0	0
3	40318556	.	C	G	1	1	2	0	0	2	0	0
3	40318613	.	A	G	4	5	9	0	0	9	0	0
3	40318733	.	T	A	2	2	4	0	0	4	0	0
3	40329684	.	G	A	0	1	1	0	1	2	0	0
3	40333577	.	A	G	4	0	4	0	2	6	0	0
3	40333592	.	C	T	5	3	8	0	0	8	0	0
3	40333700	.	A	G	2	0	2	0	3	5	0	0
3	40333793	.	T	C	2	1	3	0	1	4	0	0
3	40346035	.	C	T	6	13	19	0	1	20	0	0
3	40348839	.	T	C	11	17	28	0	0	28	0	0
3	40349123	.	C	T	6	4	10	0	0	10	0	0
3	40349354	.	T	G	7	5	12	0	0	12	0	0
3	40349417	.	A	C	6	9	15	0	0	15	0	0
3	40349618	.	G	C	1	3	4	0	0	4	0	0
3	40349631	.	T	A	1	3	4	0	0	4	0	0
3	40404508	.	T	A	2	2	4	0	0	4	0	0
3	40430922	.	G	A	0	3	3	0	10	13	0	0
3	40443143	.	A	T	5	7	12	0	0	12	0	0
3	40444020	.	C	T	1	2	3	0	0	3	0	0
3	40444342	.	G	A	5	5	10	0	0	10	0	0
3	40444470	.	G	A	2	14	16	0	0	16	0	0
3	40448130	.	A	G	9	0	9	0	8	17	0	0
3	40448220	.	T	C	0	1	1	0	0	1	0	0
3	40467464	.	C	T	1	0	1	0	0	1	0	0
3	40467486	.	G	A	0	3	3	0	3	6	0	0
3	40467687	.	G	A	6	5	11	0	0	11	0	0
3	40467756	.	C	T	14	6	20	0	1	21	0	0
3	40468374	.	C	T	3	1	4	0	0	4	0	0
3	40479736	.	A	T	2	6	8	0	0	8	0	0
3	40480877	.	G	A	0	2	2	0	1	3	0	0
3	40480986	.	G	T	11	10	21	0	1	22	0	0
3	40484376	.	A	T	7	6	13	0	0	14	1	0
3	40484454	.	C	A	12	12	24	0	0	24	0	0
3	40485360	.	C	A	13	12	25	0	2	27	0	0
3	40485499	.	G	A	22	11	33	0	0	33	0	0
3	40485582	.	C	T	12	11	23	0	0	23	0	0
3	40486256	.	C	T	17	24	41	0	0	41	0	0
3	40486294	.	C	T	16	23	39	0	0	39	0	0
3	40487095	.	G	T	9	7	16	0	0	16	0	0
3	40487197	.	T	A	6	8	14	0	0	14	0	0
3	40487628	.	T	C	17	16	33	0	1	34	0	0
3	40487957	.	G	A	16	13	29	0	0	29	0	0
3	40488212	.	C	T	15	16	31	0	0	31	0	0
3	40488266	.	T	C	14	4	18	0	7	25	0	0
3	40488630	.	T	C	1	3	4	0	0	4	0	0
3	40488640	.	T	C	1	2	3	0	0	3	0	0
3	40527028	.	G	A	22	18	40	0	1	41	0	0
3	40527575	.	G	A	12	8	20	0	4	24	0	0
3	40527853	.	T	C	1	3	4	0	0	4	0	0
3	40528241	.	A	T	19	16	35	0	2	37	0	0
3	40576600	.	C	T	26	15	41	0	3	44	0	0
3	40576780	.	C	T	21	16	37	0	0	37	0	0
3	40577032	.	C	T	19	8	27	0	1	28	0	0
3	40581432	.	C	T	10	12	22	0	1	23	0	0
3	40587884	.	G	A	1	21	22	0	30	52	0	0
3	40587901	.	G	A	1	21	22	0	29	51	0	0
3	40588109	.	A	T	21	24	45	0	1	46	0	0
3	40588363	.	C	T	21	22	43	0	1	44	0	0
3	40588410	.	C	A	20	28	48	0	1	49	0	0
3	40588746	.	C	G	19	13	32	0	2	34	0	0
3	40589117	.	T	A	26	22	48	0	0	48	0	0
3	40589214	.	C	A	17	32	49	0	1	50	0	0
3	40589348	.	A	G	15	20	35	0	1	36	0	0
3	40589356	.	A	G	16	19	35	0	1	36	0	0
3	40615948	.	G	A	10	6	16	0	0	16	0	0
3	40647450	.	C	A	3	3	6	0	0	6	0	0
3	40649928	.	A	T	1	3	4	0	1	5	0	0
3	40656449	.	T	G	3	3	6	0	0	6	0	0
3	40656600	.	T	C	2	4	6	0	0	6	0	0
3	40690901	.	G	A	2	3	5	0	0	5	0	0
3	40691643	.	A	T	6	3	9	0	0	9	0	0
3	40691969	.	C	T	9	11	20	0	0	20	0	0
3	40692064	.	A	T	5	6	11	0	0	11	0	0
3	40692099	.	A	G	7	5	12	0	0	12	0	0
3	40698424	.	C	A	4	6	10	0	0	10	0	0
3	40698481	.	A	G	6	4	10	0	0	10	0	0
3	40712935	.	G	A	1	0	1	0	0	1	0	0
3	40716045	.	G	A	0	3	3	0	0	3	0	0
3	40804286	.	T	G	23	4	27	0	1	29	1	0
3	40804382	.	G	A	1	10	11	0	10	21	0	0
3	40814704	.	C	A	2	1	3	0	0	3	0	0
3	40817022	.	G	A	1	2	3	0	0	3	0	0
3	40817213	.	G	A	2	1	3	0	0	3	0	0
3	40817338	.	C	T	2	3	5	0	0	5	0	0
3	40817712	.	G	A	4	9	13	0	0	13	0	0
3	40821871	.	A	T	14	10	24	0	0	24	0	0
3	40833733	.	C	T	1	1	2	0	0	2	0	0
3	40833775	.	C	T	0	4	4	0	5	9	0	0
3	40876757	.	G	A	5	1	6	0	1	7	0	0
3	40876770	.	G	C	0	3	3	0	2	5	0	0
3	40880130	.	C	A	1	2	3	0	0	3	0	0
3	40902163	.	C	T	0	9	9	0	3	12	0	0
3	40902171	.	C	T	10	3	13	0	0	13	0	0
3	40913590	.	G	A	3	4	7	0	1	8	0	0
3	40913730	.	G	A	3	2	5	0	0	5	0	0
3	40927653	.	C	T	11	5	16	0	0	16	0	0
3	40927656	.	C	T	0	10	10	0	5	15	0	0
3	40932798	.	G	A	3	4	7	0	0	7	0	0
3	40969547	.	C	T	0	1	1	0	3	4	0	0
3	40973247	.	C	A	0	1	1	0	4	5	0	0
3	40973554	.	T	C	1	0	1	0	0	1	0	0
3	40979597	.	G	C	2	9	11	0	0	11	0	0
3	40979746	.	T	A	5	9	14	0	0	14	0	0
3	40980024	.	G	A	8	3	11	0	0	11	0	0
3	40980166	.	T	A	6	7	13	0	0	13	0	0
3	40980167	.	T	A	7	6	13	0	0	13	0	0
3	40980245	.	G	T	10	6	16	0	1	17	0	0
3	40983062	.	A	G	7	2	9	0	0	9	0	0
3	40995278	.	G	A	5	2	7	0	0	7	0	0
3	41030891	.	C	T	0	3	3	0	4	7	0	0
3	41030921	.	T	C	2	6	8	0	0	8	0	0
3	41030939	.	T	C	1	4	5	0	0	6	1	0
3	41037779	.	A	T	2	3	5	0	0	5	0	0
3	41069430	.	G	A	0	1	1	0	0	1	0	0
3	41086775	.	G	A	2	4	6	0	0	6	0	0
3	41089046	.	C	T	0	2	2	0	0	2	0	0
3	41092137	.	A	T	2	2	4	0	0	4	0	0
3	41136272	.	A	G	1	2	3	0	0	3	0	0
3	41150941	.	G	A	3	4	7	0	0	7	0	0
3	41282708	.	C	T	0	2	2	0	2	4	0	0
3	41511204	.	T	A	1	3	4	0	0	4	0	0
3	41704286	.	C	G	1	2	3	0	0	3	0	0
3	41704295	.	A	C	1	2	3	0	0	3	0	0
3	41704514	.	T	C	1	3	4	0	0	4	0	0
3	41704909	.	C	T	2	2	4	0	0	4	0	0
3	41705468	.	A	T	3	5	8	0	0	8	0	0
3	41705476	.	C	T	4	5	9	0	0	9	0	0
3	41705560	.	A	G	2	4	6	0	0	6	0	0
3	41705597	.	C	T	4	2	6	0	0	6	0	0
3	41715646	.	G	A	0	8	8	0	7	15	0	0
3	41716889	.	C	A	6	7	13	0	0	13	0	0
3	41719049	.	G	A	4	1	5	0	2	7	0	0
3	41719219	.	A	G	7	0	7	0	6	13	0	0
3	41721916	.	G	A	1	2	3	0	0	3	0	0
3	41723069	.	G	A	16	9	25	0	0	25	0	0
3	41723437	.	G	A	8	11	19	0	0	19	0	0
3	41724298	.	C	T	8	11	19	0	0	19	0	0
3	41724806	.	G	A	18	19	37	0	1	38	0	0
3	41731929	.	C	A	2	3	5	0	0	5	0	0
3	41731980	.	G	A	4	4	8	0	0	8	0	0
3	41732145	.	T	C	1	5	6	0	0	6	0	0
3	41732486	.	T	A	3	4	7	0	0	7	0	0
3	41732782	.	C	A	4	2	6	0	0	6	0	0
3	41917608	.	G	T	4	6	10	0	0	10	0	0
3	41917747	.	T	C	7	5	12	0	0	12	0	0
3	41917830	.	T	C	3	7	10	0	0	10	0	0
3	41922587	.	C	T	4	1	5	0	0	5	0	0
3	41922766	.	A	G	4	0	4	0	1	5	0	0
3	41922799	.	C	T	6	6	12	0	0	12	0	0
3	41923195	.	T	C	4	4	8	0	0	8	0	0
3	41923288	.	C	T	0	1	1	0	0	1	0	0
3	41925154	.	C	T	6	5	11	0	0	11	0	0
3	41925823	.	C	T	4	5	9	0	0	9	0	0
3	41925889	.	T	C	1	5	6	0	0	6	0	0
3	41926020	.	T	A	5	2	7	0	0	7	0	0
3	41926557	.	G	A	3	7	10	0	0	10	0	0
3	41926695	.	T	C	7	4	11	0	0	11	0	0
3	41955526	.	C	T	3	3	6	0	0	6	0	0
3	41955613	.	G	T	15	19	34	0	0	34	0	0
3	41955911	.	C	G	11	13	24	0	1	25	0	0
3	41956040	.	G	T	11	14	25	0	0	25	0	0
3	41956299	.	T	C	8	8	16	0	1	17	0	0
3	41956353	.	T	A	7	9	16	0	1	17	0	0
3	41956467	.	T	A	6	3	9	0	0	9	0	0
3	41956504	.	C	T	2	5	7	0	0	7	0	0
3	41956792	.	A	T	3	9	12	0	2	14	0	0
3	41956818	.	T	C	3	9	12	0	0	12	0	0
3	41956837	.	T	G	2	6	8	0	0	8	0	0
3	41956855	.	C	T	5	6	11	0	0	11	0	0
3	41956921	.	T	A	5	5	10	0	0	10	0	0
3	41956978	.	G	A	6	7	13	0	1	14	0	0
3	41957580	.	G	T	5	5	10	0	0	10	0	0
3	41958291	.	T	G	4	5	9	0	0	9	0	0
3	41958690	.	C	T	1	2	3	0	0	3	0	0
3	41958705	.	T	A	1	2	3	0	0	3	0	0
3	41959370	.	G	T	3	15	18	0	1	19	0	0
3	41959658	.	G	T	4	9	13	0	0	13	0	0
3	41959772	.	A	G	5	9	14	0	0	14	0	0
3	41959906	.	T	A	3	3	6	0	0	6	0	0
3	41959943	.	T	C	3	5	8	0	0	8	0	0
3	41959958	.	A	G	2	4	6	0	0	6	0	0
3	41960069	.	G	T	2	3	5	0	0	5	0	0
3	41960249	.	C	T	1	2	3	0	0	3	0	0
3	41960254	.	A	C	1	2	3	0	0	3	0	0
3	41960346	.	A	G	1	2	3	0	0	3	0	0
3	41961314	.	G	A	2	2	4	0	0	4	0	0
3	41961341	.	T	G	5	1	6	0	0	6	0	0
3	41961469	.	A	G	2	4	6	0	0	6	0	0
3	41961558	.	A	T	3	10	13	0	0	13	0	0
3	41961587	.	T	G	1	6	7	0	0	7	0	0
3	41961651	.	G	A	4	6	10	0	0	10	0	0
3	41961688	.	T	C	6	0	6	0	6	12	0	0
3	41961993	.	C	G	0	5	5	0	3	8	0	0
3	41962098	.	T	C	4	7	11	0	1	12	0	0
3	41962463	.	G	A	1	4	5	0	0	5	0	0
3	41985866	.	G	A	1	2	3	0	0	3	0	0
3	41985953	.	C	T	1	5	6	0	0	6	0	0
3	41985959	.	G	A	1	5	6	0	0	6	0	0
3	42016675	.	A	T	0	1	1	0	0	1	0	0
3	42016682	.	C	G	0	1	1	0	0	1	0	0
3	42121428	.	A	G	1	3	4	0	0	4	0	0
3	42121500	.	G	A	2	4	6	0	1	7	0	0
3	42122108	.	A	G	1	0	1	0	0	1	0	0
3	42126594	.	A	T	1	3	4	0	0	4	0	0
3	42126621	.	A	G	1	2	3	0	0	3	0	0
3	42126639	.	T	C	1	3	4	0	0	4	0	0
3	42918924	.	C	A	12	9	21	0	0	21	0	0
3	42919474	.	C	T	13	15	28	0	0	28	0	0
3	42919510	.	C	T	8	7	15	0	1	16	0	0
3	42919664	.	C	T	2	2	4	0	1	5	0	0
3	42919846	.	T	G	5	9	14	0	0	14	0	0
3	42919849	.	C	T	5	7	12	0	0	12	0	0
3	42919881	.	C	T	4	5	9	0	0	9	0	0
3	42919895	.	A	G	3	3	6	0	0	6	0	0
3	43000474	.	A	G	0	1	1	0	2	3	0	0
3	43003017	.	G	T	2	3	5	0	0	5	0	0
3	43009405	.	G	A	0	1	1	0	1	2	0	0
3	43014396	.	T	C	1	1	2	0	0	2	0	0
3	43017912	.	T	C	1	2	3	0	0	3	0	0
3	43018005	.	C	T	2	2	4	0	0	4	0	0
3	43038222	.	G	A	2	3	5	0	0	5	0	0
3	43039306	.	A	G	2	3	5	0	0	5	0	0
3	43040677	.	G	A	0	3	3	0	3	6	0	0
3	43052230	.	T	C	5	3	8	0	0	8	0	0
3	43059153	.	A	G	0	6	6	0	1	7	0	0
3	43060866	.	T	C	2	3	5	0	0	5	0	0
3	43376543	.	A	G	0	3	3	0	0	3	0	0
3	43380283	.	C	T	3	5	8	0	0	8	0	0
3	43392755	.	T	A	1	9	10	0	0	10	0	0
3	43392795	.	C	A	2	6	8	0	0	8	0	0
3	43467654	.	T	C	4	3	7	0	0	7	0	0
3	43474920	.	A	T	4	7	11	0	0	11	0	0
3	43475184	.	C	T	3	2	5	0	0	5	0	0
3	43475265	.	G	A	4	6	10	0	0	10	0	0
3	43475325	.	A	G	8	6	14	0	1	15	0	0
3	43475376	.	T	C	6	5	11	0	0	11	0	0
3	43475397	.	C	T	3	5	8	0	1	9	0	0
3	43475592	.	A	C	4	10	14	0	0	14	0	0
3	43475617	.	G	T	0	9	9	0	5	14	0	0
3	43475654	.	C	T	5	6	11	0	0	11	0	0
3	43475742	.	G	T	7	6	13	0	0	13	0	0
3	43475772	.	A	G	5	5	10	0	0	10	0	0
3	43476088	.	G	T	4	5	9	0	0	9	0	0
3	43476097	.	C	A	5	4	9	0	0	9	0	0
3	43476394	.	T	C	3	1	4	0	1	5	0	0
3	43476402	.	C	T	2	2	4	0	0	4	0	0
3	43476435	.	G	T	4	5	9	0	0	9	0	0
3	43476514	.	A	C	5	7	12	0	0	12	0	0
3	43476698	.	A	G	6	5	11	0	0	11	0	0
3	43476880	.	C	T	5	6	11	0	1	12	0	0
3	43476887	.	T	G	3	7	10	0	1	11	0	0
3	43477705	.	T	A	2	2	4	0	0	4	0	0
3	43477975	.	T	G	2	2	4	0	0	4	0	0
3	43478137	.	T	C	10	8	18	0	1	19	0	0
3	43478238	.	C	T	8	7	15	0	0	15	0	0
3	43478310	.	T	G	7	3	10	0	0	10	0	0
3	43478321	.	A	G	7	0	7	0	5	12	0	0
3	43478433	.	A	T	11	3	14	0	0	14	0	0
3	43478586	.	C	T	3	2	5	0	0	5	0	0
3	43579820	.	C	T	0	11	11	0	13	24	0	0
3	43580055	.	A	G	15	9	24	0	0	24	0	0
3	43580195	.	A	T	6	5	11	0	0	11	0	0
3	43580583	.	T	C	9	10	19	0	0	19	0	0
3	43581272	.	A	C	14	6	20	0	0	20	0	0
3	43584423	.	T	C	7	0	7	0	11	18	0	0
3	43584453	.	T	C	5	9	14	0	0	14	0	0
3	43594256	.	A	G	1	3	4	0	1	5	0	0
3	43594358	.	C	T	4	13	17	0	1	18	0	0
3	43594376	.	C	T	1	10	11	0	6	17	0	0
3	43594577	.	G	A	11	11	22	0	0	22	0	0
3	43594655	.	C	T	0	6	6	0	13	19	0	0
3	43594658	.	G	A	12	7	19	0	1	20	0	0
3	43594735	.	T	C	3	7	10	0	0	10	0	0
3	43600999	.	C	T	0	3	3	0	6	9	0	0
3	43645900	.	G	C	12	5	17	0	0	17	0	0
3	43646161	.	A	G	8	4	12	0	0	12	0	0
3	43646362	.	C	T	0	6	6	0	2	8	0	0
3	43711455	.	A	T	0	1	1	0	2	3	0	0
3	43774440	.	C	A	3	2	5	0	1	6	0	0
3	43776859	.	T	C	0	2	2	0	1	3	0	0
3	43785646	.	A	T	0	1	1	0	0	1	0	0
3	43791284	.	T	C	6	5	11	0	0	11	0	0
3	43791317	.	G	A	5	5	10	0	1	11	0	0
3	43793147	.	T	C	2	3	5	0	0	5	0	0
3	43793273	.	G	A	2	4	6	0	0	6	0	0
3	43797073	.	C	T	1	0	1	0	0	1	0	0
3	43801338	.	C	T	0	2	2	0	0	2	0	0
3	43807512	.	T	C	4	6	10	0	1	11	0	0
3	43807921	.	C	A	10	6	16	0	3	19	0	0
3	43807945	.	T	A	10	5	15	0	1	17	1	0
3	43814607	.	C	T	8	10	18	0	1	19	0	0
3	43821273	.	G	T	11	5	16	0	0	16	0	0
3	43821328	.	A	G	10	8	18	0	0	18	0	0
3	43825892	.	T	A	4	4	8	0	0	8	0	0
3	43825901	.	T	C	3	3	6	0	1	7	0	0
3	43828870	.	T	C	1	4	5	0	0	5	0	0
3	43828902	.	G	A	3	4	7	0	0	7	0	0
3	43828906	.	T	C	3	4	7	0	0	7	0	0
3	43829154	.	G	C	2	5	7	0	0	7	0	0
3	43829179	.	G	C	2	5	7	0	0	7	0	0
3	43829712	.	G	A	3	5	8	0	1	9	0	0
3	43942053	.	A	C	1	4	5	0	0	5	0	0
3	43944611	.	A	G	1	2	3	0	0	3	0	0
3	43953883	.	T	C	7	0	7	0	6	13	0	0
3	43985334	.	T	C	1	2	3	0	0	3	0	0
3	43985690	.	C	T	2	2	4	0	0	4	0	0
3	43985691	.	C	T	2	2	4	0	0	4	0	0
3	43985795	.	T	A	2	4	6	0	0	6	0	0
3	43985815	.	G	T	0	3	3	0	3	6	0	0
3	43986252	.	T	A	2	3	5	0	0	5	0	0
3	43986937	.	G	A	0	2	2	0	2	4	0	0
3	43986982	.	G	A	2	5	7	0	0	7	0	0
3	44077508	.	C	T	5	2	7	0	0	7	0	0
3	44077543	.	G	T	1	4	5	0	0	5	0	0
3	44082239	.	T	G	0	1	1	0	0	1	0	0
3	44089225	.	T	G	0	1	1	0	0	1	0	0
3	44089529	.	A	G	0	1	1	0	0	1	0	0
3	44093661	.	T	C	1	0	1	0	2	3	0	0
3	44093896	.	T	G	1	2	3	0	0	3	0	0
3	44093911	.	A	G	1	2	3	0	0	3	0	0
3	44094172	.	C	T	0	4	4	0	2	6	0	0
3	44541766	.	C	T	0	2	2	0	4	6	0	0
3	45714678	.	C	T	4	3	7	0	0	7	0	0
3	45715511	.	T	A	1	3	4	0	0	4	0	0
3	45715655	.	A	G	7	4	11	0	0	11	0	0
3	45715716	.	C	T	4	4	8	0	0	8	0	0
3	45715776	.	T	C	3	7	10	0	0	10	0	0
3	45716082	.	T	C	2	2	4	0	0	4	0	0
3	45716098	.	C	T	3	2	5	0	0	5	0	0
3	45716562	.	A	G	0	3	3	1	0	4	0	0
3	45716766	.	A	G	2	0	2	0	7	9	0	0
3	45717180	.	C	T	11	11	22	0	1	23	0	0
3	45776520	.	T	C	20	2	22	0	25	47	0	0
3	45776721	.	T	C	12	12	24	0	0	24	0	0
3	45814631	.	A	T	3	6	9	0	0	9	0	0
3	45815997	.	G	A	0	5	5	0	1	6	0	0
3	45816004	.	C	T	1	4	5	0	0	5	0	0
3	45816549	.	A	G	10	7	17	0	0	17	0	0
3	45816618	.	T	C	7	8	15	0	0	15	0	0
3	45817321	.	C	T	6	3	9	0	0	9	0	0
3	45817571	.	G	T	0	7	7	0	0	7	0	0
3	45817572	.	T	G	3	4	7	0	0	7	0	0
3	46043483	.	G	A	3	4	7	0	0	7	0	0
3	46043528	.	T	A	1	3	4	0	0	4	0	0
3	46043918	.	T	A	3	3	6	0	0	6	0	0
3	46044097	.	C	T	0	2	2	0	1	3	0	0
3	46044190	.	G	T	1	2	3	0	0	3	0	0
3	46114398	.	A	G	1	2	3	0	0	3	0	0
3	46114458	.	C	T	0	3	3	0	2	5	0	0
3	46114491	.	C	A	1	4	5	0	0	5	0	0
3	46795118	.	G	T	4	3	7	0	1	8	0	0
3	46923352	.	A	G	1	2	3	0	0	3	0	0
3	47000852	.	A	G	0	1	1	0	0	1	0	0
3	50077034	.	C	A	3	2	5	0	0	5	0	0
3	50419686	.	A	T	0	3	3	0	1	4	0	0
3	53075779	.	C	T	1	2	3	0	0	3	0	0
3	53075784	.	C	T	5	3	8	0	0	8	0	0
3	54567797	.	A	G	4	2	6	0	0	6	0	0
3	54834625	.	A	G	0	4	4	0	1	5	0	0
3	54835252	.	T	C	1	1	2	0	0	2	0	0
3	55099174	.	A	G	0	1	1	0	0	1	0	0
3	55100228	.	T	C	11	0	11	0	1	12	0	0
3	55100522	.	A	G	16	7	23	0	0	23	0	0
3	55104214	.	T	C	0	0	0	0	12	12	0	0
3	55104215	.	A	G	0	12	12	0	0	12	0	0
3	57126930	.	A	T	1	1	2	0	0	2	0	0
3	57131468	.	A	G	1	2	3	0	1	4	0	0
3	57131477	.	C	G	1	2	3	0	1	4	0	0
3	57133220	.	G	T	0	2	2	0	2	4	0	0
3	57133447	.	A	G	1	3	4	0	0	4	0	0
3	57150015	.	G	A	0	2	2	0	4	6	0	0
3	57173711	.	T	C	2	6	8	0	0	8	0	0
3	57423485	.	A	C	4	3	7	0	0	7	0	0
3	57423489	.	C	T	4	3	7	0	0	7	0	0
3	57423533	.	A	G	1	2	3	0	0	3	0	0
3	57423909	.	T	C	2	2	4	0	0	4	0	0
3	57423929	.	T	C	5	2	7	0	0	7	0	0
3	57423952	.	T	G	5	3	8	0	1	9	0	0
3	57424244	.	C	T	1	5	6	0	0	6	0	0
3	57424327	.	T	C	2	3	5	0	0	5	0	0
3	57424743	.	A	G	5	4	9	0	0	9	0	0
3	57462285	.	G	A	8	4	12	0	0	12	0	0
3	57462301	.	A	C	6	8	14	0	1	15	0	0
3	57462490	.	G	T	13	12	25	0	3	28	0	0
3	57462548	.	C	T	0	10	10	0	16	26	0	0
3	57462584	.	C	T	7	11	18	0	0	18	0	0
3	57462598	.	A	G	7	11	18	0	1	19	0	0
3	57462643	.	A	C	10	3	13	0	0	13	0	0
3	57462751	.	G	C	5	4	9	0	0	9	0	0
3	57462962	.	T	C	1	6	7	0	5	12	0	0
3	57462990	.	T	C	6	4	10	0	0	10	0	0
3	57463446	.	A	T	11	8	19	0	0	19	0	0
3	57463470	.	C	T	10	12	22	0	1	23	0	0
3	57463698	.	C	T	0	13	13	0	7	21	1	0
3	57463817	.	C	G	7	10	17	0	0	17	0	0
3	57463933	.	G	A	15	6	21	0	4	25	0	0
3	57464426	.	T	C	11	8	19	0	1	20	0	0
3	57464441	.	G	C	11	7	18	0	0	18	0	0
3	57464484	.	G	A	10	8	18	0	0	18	0	0
3	57464735	.	T	A	8	7	15	0	0	15	0	0
3	57464746	.	C	T	0	8	8	0	5	13	0	0
3	57464793	.	T	A	3	9	12	0	0	12	0	0
3	57464884	.	T	A	6	3	9	0	0	9	0	0
3	57464986	.	A	C	5	5	10	0	0	10	0	0
3	57465090	.	G	C	5	13	18	0	1	19	0	0
3	57465176	.	G	C	9	9	18	0	0	18	0	0
3	57465308	.	T	C	5	0	5	0	12	17	0	0
3	57465544	.	A	T	2	5	7	0	1	8	0	0
3	57465550	.	A	G	3	5	8	0	0	8	0	0
3	57465827	.	G	C	6	7	13	0	0	13	0	0
3	57465965	.	G	T	1	1	2	0	0	2	0	0
3	57492140	.	C	T	1	3	4	0	0	4	0	0
3	57494405	.	G	A	1	1	2	0	0	2	0	0
3	57583954	.	C	T	9	4	13	0	0	13	0	0
3	57584599	.	A	T	10	15	25	0	0	25	0	0
3	57584606	.	A	G	8	14	22	0	0	22	0	0
3	57584656	.	A	C	4	7	11	0	0	11	0	0
3	57584783	.	T	C	8	0	8	0	6	14	0	0
3	57585015	.	C	T	0	3	3	0	13	16	0	0
3	57585033	.	C	T	2	10	12	0	4	16	0	0
3	57585150	.	C	T	0	7	7	0	3	10	0	0
3	57593524	.	C	T	6	4	10	0	1	11	0	0
3	57593977	.	G	A	6	9	15	0	0	15	0	0
3	57593978	.	G	A	5	7	12	0	3	15	0	0
3	57594016	.	G	A	11	6	17	0	0	17	0	0
3	57599177	.	C	T	3	2	5	0	0	5	0	0
3	57603720	.	C	T	3	4	7	0	0	7	0	0
3	57603737	.	C	T	0	3	3	0	0	3	0	0
3	57608900	.	A	T	1	0	1	0	0	1	0	0
3	57614363	.	G	A	1	2	3	0	0	3	0	0
3	57630700	.	C	T	0	1	1	0	1	2	0	0
3	57634139	.	G	T	2	2	4	0	0	4	0	0
3	57634380	.	A	G	2	3	5	0	0	5	0	0
3	57634480	.	G	A	1	2	3	0	0	3	0	0
3	57646269	.	A	G	4	7	11	0	1	12	0	0
3	57646307	.	T	A	5	2	7	0	1	8	0	0
3	57646437	.	C	T	0	6	6	0	8	14	0	0
3	57649281	.	G	T	1	0	1	0	0	1	0	0
3	57654123	.	A	G	0	1	1	0	0	1	0	0
3	57666435	.	C	A	3	4	7	0	0	7	0	0
3	57742154	.	G	A	4	3	7	0	0	7	0	0
3	57742220	.	G	A	6	13	19	0	1	20	0	0
3	57742262	.	C	G	9	15	24	0	1	25	0	0
3	57742532	.	T	G	4	7	11	0	0	11	0	0
3	57742636	.	A	G	4	2	6	0	0	6	0	0
3	57744225	.	A	G	1	1	2	0	0	2	0	0
3	57747866	.	T	C	3	0	3	0	5	8	0	0
3	57747889	.	C	A	4	4	8	0	0	8	0	0
3	57748026	.	G	A	6	3	9	0	0	9	0	0
3	57748246	.	C	T	4	3	7	0	0	7	0	0
3	57748342	.	T	A	5	8	13	0	0	13	0	0
3	57748437	.	A	G	6	3	9	0	0	9	0	0
3	57748449	.	G	A	4	4	8	0	1	9	0	0
3	57748494	.	T	C	6	4	10	0	0	10	0	0
3	57748581	.	C	G	0	8	8	0	6	14	0	0
3	57751835	.	G	A	2	6	8	0	0	8	0	0
3	57754460	.	C	T	4	13	17	0	1	18	0	0
3	57767106	.	A	C	4	4	8	0	0	8	0	0
3	57768419	.	T	A	1	2	3	0	0	3	0	0
3	57998332	.	T	C	0	1	1	0	0	1	0	0
3	58001423	.	T	C	1	1	2	0	0	2	0	0
3	58001814	.	G	A	0	2	2	0	4	6	0	0
3	58004532	.	C	T	3	2	5	0	0	5	0	0
3	58137414	.	T	C	3	3	6	0	0	6	0	0
3	58140344	.	G	A	2	2	4	0	0	4	0	0
3	58147315	.	C	G	1	1	2	0	0	2	0	0
3	58147467	.	T	C	2	1	3	0	0	3	0	0
3	58147479	.	C	A	4	1	5	0	0	5	0	0
3	58148028	.	C	A	8	5	13	0	0	13	0	0
3	58148031	.	G	T	8	5	13	0	0	13	0	0
3	58148643	.	G	A	1	1	2	0	0	2	0	0
3	58149114	.	C	A	3	5	8	0	0	8	0	0
3	58149192	.	T	C	2	3	5	0	0	5	0	0
3	58149204	.	G	A	2	0	2	0	0	2	0	0
3	58153632	.	C	T	0	1	1	0	0	1	0	0
3	58153889	.	T	A	5	8	13	0	1	14	0	0
3	58153994	.	A	G	2	0	2	0	7	9	0	0
3	58154073	.	G	A	1	4	5	0	9	14	0	0
3	58158709	.	T	C	6	5	11	0	0	11	0	0
3	58158712	.	T	C	6	4	10	0	0	10	0	0
3	58171761	.	C	T	2	3	5	0	0	5	0	0
3	58174380	.	C	T	0	2	2	0	0	2	0	0
3	58175761	.	G	C	9	2	11	0	0	11	0	0
3	58178032	.	G	A	1	21	22	0	11	34	1	0
3	58180664	.	G	A	9	4	13	0	3	16	0	0
3	58197600	.	A	G	0	0	0	2	0	2	0	0
3	58211317	.	T	C	0	2	2	1	0	3	0	0
3	58220627	.	G	C	0	2	2	0	1	3	0	0
3	58220628	.	G	C	0	3	3	0	0	3	0	0
3	58221912	.	C	A	1	3	4	0	0	4	0	0
3	58221914	.	A	G	1	3	4	0	0	4	0	0
3	58581212	.	C	G	1	5	6	0	0	6	0	0
3	58608380	.	G	A	0	1	1	1	0	2	0	0
3	58611208	.	G	A	1	8	9	0	0	9	0	0
3	58615428	.	T	G	2	3	5	0	0	5	0	0
3	58615543	.	G	C	5	4	9	0	1	10	0	0
3	58710350	.	T	C	3	13	16	0	0	16	0	0
3	58710351	.	T	A	13	2	15	0	1	16	0	0
3	60074274	.	C	G	2	2	4	0	0	4	0	0
3	60219080	.	T	C	3	4	7	0	0	7	0	0
3	60219093	.	T	C	2	5	7	0	0	7	0	0
3	60222551	.	T	C	1	2	3	0	0	3	0	0
3	60222583	.	G	C	2	3	5	0	0	5	0	0
3	60222625	.	A	G	1	4	5	0	0	5	0	0
3	60223583	.	A	G	0	3	3	0	0	3	0	0
3	60294089	.	C	G	0	2	2	0	0	2	0	0
3	60526504	.	T	A	0	6	6	0	0	6	0	0
3	60596660	.	C	T	5	2	7	0	0	7	0	0
3	61156566	.	G	A	2	1	3	0	0	3	0	0
3	61221250	.	A	T	5	5	10	0	0	10	0	0
3	61221329	.	G	A	4	2	6	0	0	6	0	0
3	61244015	.	C	T	6	3	9	0	0	9	0	0
3	61272235	.	C	T	1	0	1	0	0	1	0	0
3	61277028	.	C	G	3	3	6	0	1	7	0	0
3	61278677	.	A	G	3	3	6	0	0	6	0	0
3	61278692	.	C	T	3	4	7	0	0	7	0	0
3	61278992	.	C	T	6	8	14	0	0	14	0	0
3	61279308	.	T	G	3	3	6	0	0	6	0	0
3	61279427	.	A	C	9	6	15	0	1	16	0	0
3	61279585	.	G	A	0	3	3	0	9	12	0	0
3	61279643	.	T	C	9	13	22	0	1	23	0	0
3	61280055	.	G	A	3	8	11	0	0	11	0	0
3	61280117	.	T	C	8	3	11	0	0	11	0	0
3	61280343	.	G	C	13	5	18	0	0	18	0	0
3	61280350	.	C	G	13	6	19	0	0	19	0	0
3	61280381	.	T	A	6	16	22	0	1	24	1	0
3	61280579	.	T	G	6	0	6	0	10	16	0	0
3	61281051	.	A	G	6	8	14	0	0	14	0	0
3	61281681	.	G	A	0	2	2	0	2	4	0	0
3	61285705	.	C	A	3	7	10	0	0	10	0	0
3	61285706	.	A	T	0	7	7	0	3	10	0	0
3	61285787	.	C	T	9	8	17	0	0	17	0	0
3	61286009	.	A	C	2	2	4	0	0	4	0	0
3	61286081	.	C	A	2	4	6	0	0	6	0	0
3	61286325	.	C	G	10	0	10	0	6	16	0	0
3	61286468	.	C	T	8	3	11	0	0	11	0	0
3	61286528	.	A	T	0	8	8	0	0	8	0	0
3	61286576	.	C	T	4	7	11	0	0	11	0	0
3	61286687	.	T	A	4	8	12	0	0	12	0	0
3	61286889	.	T	C	7	12	19	0	1	20	0	0
3	61287282	.	T	G	5	0	5	0	9	14	0	0
3	61287491	.	T	A	16	7	23	0	0	23	0	0
3	61287590	.	G	T	12	15	27	0	0	27	0	0
3	61287627	.	C	G	11	7	18	0	0	18	0	0
3	61287893	.	T	G	7	0	7	0	11	18	0	0
3	61288028	.	T	C	12	12	24	0	2	26	0	0
3	61288105	.	C	A	18	11	29	0	1	30	0	0
3	61288238	.	A	C	12	13	25	0	1	26	0	0
3	61288469	.	T	G	12	0	12	0	25	37	0	0
3	61288613	.	T	C	6	2	8	0	0	8	0	0
3	61292963	.	C	A	4	2	6	0	1	7	0	0
3	61293028	.	A	G	2	4	6	0	0	6	0	0
3	61293531	.	T	G	4	1	5	0	0	5	0	0
3	61297154	.	C	T	0	0	0	0	1	1	0	0
3	61326373	.	G	A	1	0	1	0	0	1	0	0
3	61326379	.	C	T	1	0	1	0	0	1	0	0
3	61327534	.	G	T	0	1	1	0	0	1	0	0
3	61328472	.	G	C	0	1	1	0	0	1	0	0
3	61342368	.	T	C	2	11	13	0	0	13	0	0
3	61342387	.	G	A	3	7	10	0	0	10	0	0
3	61342408	.	G	A	6	3	9	0	1	10	0	0
3	61342423	.	G	C	2	7	9	0	0	9	0	0
3	61342747	.	C	T	0	5	5	0	7	12	0	0
3	61342770	.	G	A	4	8	12	0	2	14	0	0
3	61342891	.	A	G	2	3	5	0	0	5	0	0
3	61342942	.	T	C	1	5	6	1	1	8	0	0
3	61343076	.	C	T	1	5	6	0	0	6	0	0
3	61343224	.	C	T	2	2	4	0	1	5	0	0
3	61343339	.	A	T	1	3	4	0	0	4	0	0
3	61343390	.	A	C	3	0	3	0	3	6	0	0
3	61343589	.	T	C	3	5	8	0	0	8	0	0
3	61345503	.	T	C	6	0	6	0	2	8	0	0
3	61349184	.	C	A	1	2	3	0	0	3	0	0
3	61349477	.	C	T	0	3	3	0	2	5	0	0
3	61349602	.	G	A	9	6	15	0	1	16	0	0
3	61349654	.	C	T	2	3	5	0	0	5	0	0
3	61349887	.	A	T	8	5	13	0	0	13	0	0
3	61349931	.	G	T	8	5	13	0	1	14	0	0
3	61350156	.	A	G	1	3	4	0	0	4	0	0
3	61350238	.	A	G	2	2	4	0	0	4	0	0
3	61350259	.	T	A	3	3	6	0	0	6	0	0
3	61350303	.	T	G	3	2	5	0	0	5	0	0
3	61350466	.	T	A	2	3	5	0	0	5	0	0
3	61350487	.	T	C	3	4	7	0	0	7	0	0
3	61350529	.	T	A	3	5	8	0	0	8	0	0
3	61350600	.	T	C	1	3	4	0	0	4	0	0
3	61350648	.	G	A	3	5	8	0	0	8	0	0
3	61350673	.	T	G	4	5	9	0	1	10	0	0
3	61350700	.	C	T	5	4	9	0	0	9	0	0
3	61350787	.	A	T	3	4	7	0	0	7	0	0
3	61350788	.	T	G	3	4	7	0	0	7	0	0
3	61351007	.	A	G	1	3	4	0	1	5	0	0
3	61351640	.	G	T	1	5	6	0	0	6	0	0
3	61351733	.	C	T	3	3	6	0	0	6	0	0
3	61352058	.	C	T	0	1	1	0	0	1	0	0
3	61354108	.	C	A	2	2	4	0	0	4	0	0
3	61359266	.	G	T	2	4	6	0	0	6	0	0
3	61359629	.	A	G	0	5	5	0	0	5	0	0
3	61359713	.	C	A	0	5	5	0	4	9	0	0
3	61360125	.	T	C	0	3	3	0	2	5	0	0
3	61360127	.	C	T	4	1	5	0	0	5	0	0
3	61361249	.	A	C	0	0	0	0	1	1	0	0
3	61365135	.	G	A	1	4	5	0	0	5	0	0
3	61366070	.	T	G	2	4	6	0	0	6	0	0
3	61372328	.	G	A	0	1	1	0	1	2	0	0
3	61372627	.	T	A	1	1	2	0	1	3	0	0
3	61383062	.	A	T	1	0	1	0	1	2	0	0
3	61383072	.	C	T	0	2	2	0	2	4	0	0
3	61383835	.	C	T	1	4	5	0	0	5	0	0
3	61383841	.	G	T	1	4	5	0	1	6	0	0
3	61385007	.	A	C	0	0	0	0	1	1	0	0
3	61385043	.	A	G	1	0	1	0	0	1	0	0
3	61387263	.	C	A	0	1	1	0	0	1	0	0
3	61391953	.	C	A	6	13	19	0	0	19	0	0
3	61392048	.	A	G	3	0	3	0	5	8	0	0
3	61395181	.	C	T	0	2	2	0	0	2	0	0
3	61395211	.	G	A	0	2	2	0	1	3	0	0
3	61396891	.	C	A	9	3	12	0	0	12	0	0
3	61396911	.	C	T	8	2	10	0	0	10	0	0
3	61397037	.	T	A	9	7	16	0	1	17	0	0
3	61397093	.	C	T	8	9	17	0	0	17	0	0
3	61397141	.	G	T	7	8	15	0	0	15	0	0
3	61397231	.	C	A	4	6	10	0	2	12	0	0
3	61397248	.	A	G	8	0	8	0	7	15	0	0
3	61398505	.	C	G	3	3	6	0	0	6	0	0
3	61398610	.	T	A	10	7	17	0	1	18	0	0
3	61398612	.	C	T	10	6	16	0	2	18	0	0
3	61398728	.	A	G	11	9	20	0	1	21	0	0
3	61398835	.	G	A	6	6	12	0	1	13	0	0
3	61398839	.	T	C	6	6	12	0	0	12	0	0
3	61401583	.	A	C	1	2	3	0	0	3	0	0
3	61542854	.	G	T	3	4	7	0	0	7	0	0
3	61542889	.	C	A	2	3	5	0	2	7	0	0
3	61542973	.	T	C	3	3	6	0	0	6	0	0
3	61543300	.	G	A	1	1	2	0	0	2	0	0
3	61543429	.	A	G	0	4	4	1	0	5	0	0
3	61543440	.	A	G	0	0	0	1	4	5	0	0
3	61543466	.	C	A	0	2	2	1	1	4	0	0
3	61566559	.	G	A	3	3	6	0	0	6	0	0
3	61566595	.	T	C	2	0	2	0	1	3	0	0
3	61585516	.	G	A	2	3	5	0	0	5	0	0
3	62035030	.	G	A	0	7	7	0	4	11	0	0
3	62035861	.	C	T	5	2	7	0	0	7	0	0
3	62035952	.	A	G	1	0	1	0	2	3	0	0
3	62036320	.	A	G	6	3	9	0	0	9	0	0
3	62036323	.	A	G	5	3	8	0	1	9	0	0
3	62036426	.	G	A	0	3	3	0	0	3	0	0
3	62036570	.	G	A	4	6	10	0	1	11	0	0
3	62037343	.	G	C	3	4	7	0	0	7	0	0
3	62037430	.	A	G	7	0	7	0	4	11	0	0
3	62037716	.	G	A	4	2	6	0	0	6	0	0
3	62038354	.	G	A	0	3	3	0	4	7	0	0
3	62038526	.	T	C	13	7	20	0	0	20	0	0
3	62038739	.	G	C	12	8	20	0	0	20	0	0
3	62038993	.	G	A	0	10	10	0	9	19	0	0
3	62039278	.	A	G	5	1	6	0	10	16	0	0
3	62039657	.	G	A	0	5	5	0	11	16	0	0
3	62039689	.	C	A	8	6	14	0	1	15	0	0
3	62039718	.	G	A	6	6	12	0	1	13	0	0
3	62039813	.	T	A	10	6	16	0	1	17	0	0
3	62040555	.	G	A	7	4	11	0	0	11	0	0
3	62051107	.	C	T	14	3	17	0	2	19	0	0
3	62051125	.	C	T	11	4	15	0	0	15	0	0
3	62051395	.	A	G	1	6	7	0	0	7	0	0
3	62051660	.	T	A	11	4	15	0	0	15	0	0
3	62051731	.	G	A	3	3	6	0	0	6	0	0
3	62051738	.	C	T	0	5	5	0	0	5	0	0
3	62068866	.	A	G	5	6	11	0	0	11	0	0
3	62068871	.	A	G	5	6	11	0	0	11	0	0
3	62068902	.	C	T	0	1	1	0	2	3	0	0
3	62069739	.	G	T	2	6	8	0	0	8	0	0
3	62069815	.	G	A	9	6	15	0	0	15	0	0
3	62069821	.	G	A	8	5	13	0	1	14	0	0
3	62070762	.	T	C	0	1	1	0	0	1	0	0
3	62070890	.	G	A	2	4	6	0	1	7	0	0
3	62073967	.	T	A	1	0	1	0	0	1	0	0
3	62074030	.	T	C	3	8	11	0	1	12	0	0
3	62080117	.	G	C	8	10	18	0	1	19	0	0
3	62080172	.	G	A	4	11	15	0	2	17	0	0
3	62080183	.	G	A	10	4	14	0	1	15	0	0
3	62091632	.	T	A	2	12	14	0	1	15	0	0
3	62091660	.	T	A	4	13	17	0	0	17	0	0
3	62091880	.	C	T	9	12	21	0	0	21	0	0
3	62091975	.	C	A	10	14	24	0	1	26	1	0
3	62091995	.	G	T	11	16	27	0	0	27	0	0
3	62092025	.	C	T	0	16	16	0	13	29	0	0
3	62092262	.	T	A	9	11	20	0	1	21	0	0
3	62092279	.	A	T	9	8	17	0	0	17	0	0
3	62092666	.	G	A	10	7	17	0	1	18	0	0
3	62092715	.	A	C	8	17	25	0	0	25	0	0
3	62092749	.	G	C	5	18	23	0	0	23	0	0
3	62092801	.	C	T	10	5	15	0	0	15	0	0
3	62092902	.	A	T	3	4	7	0	0	7	0	0
3	62093241	.	T	A	5	12	17	0	1	18	0	0
3	62093567	.	A	C	4	3	7	0	0	7	0	0
3	62094327	.	C	T	7	3	10	0	0	10	0	0
3	62094645	.	A	G	2	9	11	0	1	12	0	0
3	62094849	.	A	G	6	5	11	0	0	11	0	0
3	62095051	.	G	A	1	6	7	0	0	7	0	0
3	62095432	.	A	G	8	6	14	0	1	15	0	0
3	62095572	.	T	A	7	5	12	0	0	12	0	0
3	62095573	.	G	T	6	5	11	0	1	12	0	0
3	62095827	.	G	C	4	4	8	0	0	8	0	0
3	62095887	.	T	C	2	0	2	0	9	11	0	0
3	62095940	.	G	C	3	5	8	0	1	9	0	0
3	62095980	.	A	C	5	6	11	0	0	11	0	0
3	62096021	.	G	A	5	2	7	0	0	7	0	0
3	62097170	.	T	C	1	3	4	0	0	4	0	0
3	62097300	.	A	T	6	2	8	0	1	9	0	0
3	62097490	.	A	T	6	7	13	0	4	17	0	0
3	62114615	.	C	T	0	1	1	0	2	3	0	0
3	62114663	.	C	T	1	2	3	0	0	3	0	0
3	62117187	.	C	T	3	4	7	0	1	8	0	0
3	62149774	.	C	T	1	0	1	0	1	2	0	0
3	62167857	.	A	G	0	0	0	0	2	2	0	0
3	62173443	.	A	T	4	3	7	0	0	7	0	0
3	62173546	.	C	T	6	4	10	0	0	10	0	0
3	62173593	.	T	C	3	5	8	0	1	9	0	0
3	62173628	.	T	C	5	2	7	0	0	7	0	0
3	62176426	.	T	C	3	0	3	0	3	6	0	0
3	62180788	.	G	A	4	3	7	0	0	7	0	0
3	62196977	.	C	T	0	1	1	0	0	1	0	0
3	62203509	.	G	A	4	1	5	0	1	6	0	0
3	62203653	.	T	A	5	4	9	0	0	9	0	0
3	62208925	.	G	A	0	0	0	0	3	3	0	0
3	62209024	.	A	G	3	5	8	0	0	8	0	0
3	62209033	.	A	G	3	5	8	0	0	8	0	0
3	62209183	.	A	G	4	0	4	0	6	10	0	0
3	62209216	.	A	G	5	6	11	0	1	12	0	0
3	62238660	.	A	G	1	2	3	0	0	3	0	0
3	62238692	.	G	A	4	3	7	0	0	7	0	0
3	62238721	.	C	T	7	4	11	0	1	12	0	0
3	62240421	.	A	T	1	3	4	0	0	4	0	0
3	62248015	.	A	G	2	0	2	0	0	2	0	0
3	62275415	.	T	A	2	3	5	0	0	5	0	0
3	62275598	.	G	A	1	5	6	0	0	6	0	0
3	62275743	.	T	C	4	5	9	0	0	9	0	0
3	62275855	.	G	C	2	3	5	0	0	5	0	0
3	62276009	.	A	T	2	2	4	0	0	4	0	0
3	62276101	.	G	A	1	2	3	0	2	5	0	0
3	62276104	.	A	G	2	2	4	0	0	4	0	0
3	62323165	.	T	C	5	2	7	0	0	8	1	0
3	62323564	.	C	T	0	2	2	0	1	3	0	0
3	62323579	.	A	G	3	0	3	0	1	4	0	0
3	62323648	.	G	A	7	4	11	0	0	11	0	0
3	62323771	.	C	T	2	2	4	0	0	4	0	0
3	62323789	.	C	T	1	2	3	0	0	3	0	0
3	62324030	.	C	T	1	3	4	0	0	4	0	0
3	62324063	.	A	T	5	3	8	0	0	8	0	0
3	62324426	.	A	G	3	2	5	0	0	5	0	0
3	62328846	.	G	C	1	1	2	0	0	2	0	0
3	62328938	.	A	C	1	3	4	1	0	5	0	0
3	62328970	.	A	G	0	6	6	1	0	7	0	0
3	62329097	.	G	C	5	4	9	0	1	10	0	0
3	62329285	.	T	A	4	3	7	0	0	7	0	0
3	62329545	.	G	T	2	8	10	0	0	10	0	0
3	62345471	.	A	T	2	7	9	0	0	9	0	0
3	62345588	.	T	A	2	5	7	0	0	7	0	0
3	62353679	.	G	T	4	2	6	0	1	7	0	0
3	62353952	.	G	A	0	0	0	0	1	1	0	0
3	62359440	.	G	T	0	5	5	0	0	5	0	0
3	62360484	.	C	T	11	5	16	0	1	17	0	0
3	62360686	.	G	A	5	2	7	0	0	7	0	0
3	62360736	.	C	A	2	3	5	0	0	5	0	0
3	62369864	.	G	A	11	14	25	0	0	26	1	0
3	62370068	.	A	G	12	13	25	0	0	25	0	0
3	62370381	.	A	G	14	8	22	0	0	22	0	0
3	62370476	.	G	A	7	7	14	0	0	14	0	0
3	62379739	.	C	T	10	8	18	0	0	18	0	0
3	62379797	.	A	T	3	0	3	0	0	3	0	0
3	62382863	.	A	G	36	28	64	0	1	65	0	0
3	62383314	.	T	G	42	8	50	0	3	53	0	0
3	62383315	.	G	T	42	10	52	0	1	53	0	0
3	62383438	.	G	A	24	36	60	0	0	60	0	0
3	62383439	.	A	G	23	36	59	0	1	60	0	0
3	62383565	.	T	A	25	28	53	0	0	53	0	0
3	62383589	.	A	C	20	22	42	0	2	44	0	0
3	62383610	.	G	C	18	0	18	0	18	36	0	0
3	62383706	.	C	T	20	21	41	0	1	42	0	0
3	62383992	.	C	G	11	11	22	0	0	22	0	0
3	62384055	.	G	A	10	7	17	0	0	17	0	0
3	62384112	.	T	A	2	4	6	0	0	6	0	0
3	62384208	.	C	T	1	47	48	0	10	58	0	0
3	62384219	.	G	A	42	7	49	0	7	56	0	0
3	62384423	.	C	G	32	30	62	0	0	62	0	0
3	62384428	.	T	A	27	32	59	0	2	61	0	0
3	62384565	.	C	G	23	30	53	0	4	57	0	0
3	62386420	.	T	C	28	1	29	0	27	56	0	0
3	62386955	.	G	T	5	3	8	0	0	8	0	0
3	62387141	.	C	T	0	8	8	0	16	24	0	0
3	62387144	.	C	T	8	15	23	0	1	24	0	0
3	62389677	.	A	C	1	3	4	0	0	4	0	0
3	62389681	.	A	C	3	1	4	0	0	4	0	0
3	62390349	.	A	G	3	4	7	0	1	8	0	0
3	62393297	.	T	C	20	10	30	0	4	34	0	0
3	62393321	.	G	A	24	13	37	0	0	37	0	0
3	62393337	.	C	T	29	8	37	0	2	39	0	0
3	62398151	.	C	T	0	2	2	0	1	3	0	0
3	62398359	.	C	T	1	3	4	0	0	4	0	0
3	62399218	.	C	T	0	1	1	0	0	1	0	0
3	62433017	.	G	A	0	5	5	0	5	10	0	0
3	62433064	.	C	T	8	4	12	0	0	12	0	0
3	62433138	.	T	G	0	2	2	0	0	2	0	0
3	62521137	.	G	A	3	6	9	0	0	9	0	0
3	62521142	.	T	C	4	0	4	0	5	9	0	0
3	62521263	.	T	A	12	10	22	0	1	23	0	0
3	62521956	.	G	A	11	11	22	0	1	23	0	0
3	62522063	.	A	T	17	9	26	0	0	26	0	0
3	62522065	.	G	T	16	9	25	0	1	26	0	0
3	62522143	.	T	A	0	4	4	0	0	4	0	0
3	62522148	.	G	A	5	0	5	0	0	5	0	0
3	62522238	.	A	G	5	9	14	0	0	14	0	0
3	62522325	.	T	G	4	2	6	0	0	6	0	0
3	62522742	.	C	A	4	4	8	0	2	10	0	0
3	62522750	.	G	C	4	5	9	0	1	10	0	0
3	62522804	.	C	T	1	9	10	0	9	19	0	0
3	62522808	.	C	T	0	10	10	0	8	18	0	0
3	62522899	.	C	G	12	15	27	0	1	28	0	0
3	62523031	.	A	G	0	11	11	0	0	11	0	0
3	62523032	.	A	T	11	0	11	0	0	11	0	0
3	62523325	.	G	T	10	14	24	0	3	27	0	0
3	62523550	.	C	T	2	9	11	0	1	12	0	0
3	62527379	.	G	T	4	5	9	1	3	13	0	0
3	62527397	.	G	T	8	3	11	0	2	13	0	0
3	62527533	.	C	A	1	2	3	0	0	5	2	0
4	316946	.	A	T	9	21	30	0	1	31	0	0
4	317091	.	A	G	8	23	31	0	1	32	0	0
4	317217	.	T	A	14	15	29	0	0	29	0	0
4	317275	.	G	T	9	8	17	0	1	18	0	0
4	317938	.	G	A	3	2	5	0	0	5	0	0
4	325073	.	C	T	1	2	3	0	0	3	0	0
4	325126	.	G	A	5	9	14	0	0	14	0	0
4	325136	.	G	A	6	11	17	0	0	17	0	0
4	325161	.	A	C	7	0	7	0	13	20	0	0
4	332491	.	G	T	1	2	3	0	2	5	0	0
4	344662	.	G	A	1	3	4	0	0	4	0	0
4	348201	.	G	A	0	3	3	0	2	5	0	0
4	348216	.	C	T	3	4	7	0	0	7	0	0
4	348297	.	T	C	6	5	11	0	2	13	0	0
4	349490	.	A	C	2	5	7	0	0	7	0	0
4	349514	.	T	C	2	4	6	0	0	6	0	0
4	349886	.	T	C	0	0	0	0	1	1	0	0
4	350652	.	C	T	6	3	9	0	1	10	0	0
4	350832	.	G	A	4	4	8	0	0	8	0	0
4	351055	.	G	A	2	4	6	0	1	7	0	0
4	351840	.	G	C	5	3	8	0	1	9	0	0
4	351845	.	A	C	4	3	7	0	2	9	0	0
4	352031	.	C	G	2	3	5	0	1	6	0	0
4	352284	.	A	G	7	0	7	0	9	16	0	0
4	352289	.	T	C	9	7	16	0	0	16	0	0
4	352504	.	T	C	9	4	13	0	0	13	0	0
4	353064	.	C	G	7	4	11	0	0	11	0	0
4	353238	.	T	G	4	0	4	0	11	15	0	0
4	353247	.	T	C	4	11	15	0	0	15	0	0
4	353379	.	A	T	7	7	14	0	2	16	0	0
4	353481	.	A	G	3	0	3	0	5	8	0	0
4	353638	.	C	T	2	2	4	0	0	4	0	0
4	353778	.	T	A	3	6	9	0	0	9	0	0
4	357887	.	T	G	6	7	13	0	0	13	0	0
4	357954	.	G	A	9	6	15	0	0	15	0	0
4	358080	.	T	C	0	1	1	0	0	1	0	0
4	362282	.	C	T	3	3	6	0	0	6	0	0
4	367532	.	T	G	1	0	1	0	0	1	0	0
4	385092	.	C	T	21	12	33	0	0	33	0	0
4	385625	.	A	T	2	7	9	0	0	9	0	0
4	385668	.	G	A	5	9	14	0	1	15	0	0
4	385710	.	T	C	10	7	17	0	0	17	0	0
4	386014	.	A	C	11	6	17	0	3	20	0	0
4	386037	.	T	G	11	10	21	0	0	21	0	0
4	386085	.	G	A	13	11	24	0	0	24	0	0
4	386124	.	C	A	2	5	7	0	6	13	0	0
4	386537	.	T	A	12	17	29	0	3	32	0	0
4	386538	.	T	A	18	14	32	0	2	35	1	0
4	386839	.	A	G	20	0	20	0	7	27	0	0
4	386961	.	G	A	13	10	23	0	2	25	0	0
4	386998	.	G	T	11	5	16	1	5	22	0	0
4	394020	.	T	C	22	17	39	0	1	40	0	0
4	397913	.	A	G	5	6	11	0	1	12	0	0
4	659276	.	C	T	7	8	15	0	0	15	0	0
4	659345	.	T	C	0	1	1	0	0	1	0	0
4	660571	.	G	A	4	4	8	0	1	9	0	0
4	660649	.	T	A	11	10	21	0	2	23	0	0
4	660655	.	G	A	0	10	10	0	12	22	0	0
4	660715	.	T	C	13	7	20	0	0	20	0	0
4	667358	.	T	C	5	7	12	0	0	12	0	0
4	667382	.	A	G	8	0	8	0	9	17	0	0
4	674838	.	T	C	4	8	12	0	1	13	0	0
4	675080	.	T	C	3	2	5	0	1	6	0	0
4	676885	.	A	G	7	4	11	0	0	11	0	0
4	676942	.	A	G	1	1	2	0	0	2	0	0
4	678853	.	C	T	1	5	6	0	0	6	0	0
4	679441	.	C	G	1	9	10	0	8	18	0	0
4	680314	.	G	T	5	8	13	0	1	14	0	0
4	680320	.	C	T	5	10	15	0	1	16	0	0
4	680359	.	C	T	3	6	9	0	0	9	0	0
4	680395	.	T	C	2	0	2	0	0	2	0	0
4	680404	.	G	A	1	0	1	0	0	1	0	0
4	681595	.	G	A	11	2	13	0	0	13	0	0
4	686987	.	G	A	0	1	1	0	5	6	0	0
4	686999	.	C	G	8	3	11	0	0	11	0	0
4	687083	.	A	G	1	1	2	0	3	5	0	0
4	694680	.	A	C	8	4	12	0	1	13	0	0
4	694718	.	G	A	4	3	7	0	0	7	0	0
4	694741	.	T	G	0	1	1	0	0	1	0	0
4	694757	.	A	T	0	1	1	0	0	1	0	0
4	695367	.	C	T	0	1	1	0	0	1	0	0
4	700281	.	A	C	10	12	22	0	3	25	0	0
4	700284	.	G	T	0	9	9	0	17	26	0	0
4	700563	.	G	T	6	3	9	0	0	9	0	0
4	700569	.	G	A	0	3	3	0	5	8	0	0
4	700598	.	A	T	2	3	5	0	0	5	0	0
4	700634	.	A	C	0	2	2	0	0	2	0	0
4	700665	.	G	T	0	2	2	0	0	2	0	0
4	702061	.	C	G	2	4	6	0	0	6	0	0
4	702130	.	G	A	1	1	2	0	0	2	0	0
4	702138	.	C	A	1	0	1	0	0	1	0	0
4	736442	.	A	G	5	4	9	0	0	9	0	0
4	737636	.	A	T	6	4	10	0	0	10	0	0
4	737811	.	A	G	6	4	10	0	0	10	0	0
4	737883	.	T	A	4	4	8	0	0	8	0	0
4	737927	.	T	G	1	1	2	0	1	3	0	0
4	740435	.	A	T	0	4	4	0	0	4	0	0
4	740921	.	T	C	5	2	7	0	0	7	0	0
4	749803	.	G	A	16	13	29	0	0	29	0	0
4	749989	.	G	T	9	7	16	0	1	17	0	0
4	750016	.	T	C	2	0	2	0	2	4	0	0
4	750526	.	C	G	3	1	4	0	0	4	0	0
4	750531	.	C	T	2	3	5	0	1	6	0	0
4	750661	.	C	T	0	2	2	0	4	6	0	0
4	751275	.	A	G	4	5	9	0	0	9	0	0
4	751546	.	G	A	8	18	26	0	1	27	0	0
4	751553	.	C	T	6	19	25	0	2	27	0	0
4	751640	.	T	G	11	11	22	0	0	22	0	0
4	753723	.	T	C	2	0	2	0	4	6	0	0
4	755539	.	C	T	5	5	10	0	0	10	0	0
4	757405	.	C	T	2	1	3	0	0	3	0	0
4	760555	.	G	T	0	1	1	0	0	1	0	0
4	765112	.	A	G	8	9	17	0	1	18	0	0
4	766575	.	G	A	3	5	8	0	0	8	0	0
4	766588	.	G	A	5	6	11	0	0	11	0	0
4	766613	.	A	C	6	9	15	0	0	15	0	0
4	769533	.	A	T	1	2	3	0	0	3	0	0
4	772363	.	C	T	9	4	13	0	0	13	0	0
4	776550	.	G	T	3	0	3	0	0	3	0	0
4	777976	.	A	G	2	3	5	0	2	7	0	0
4	778111	.	G	A	1	5	6	0	0	6	0	0
4	779310	.	G	A	1	4	5	0	0	5	0	0
4	779363	.	T	C	8	1	9	0	13	22	0	0
4	779429	.	A	G	13	7	20	0	0	20	0	0
4	779442	.	G	A	13	6	19	0	0	19	0	0
4	779523	.	T	C	2	4	6	0	0	6	0	0
4	783816	.	G	T	25	18	43	0	2	45	0	0
4	783835	.	A	G	23	15	38	0	1	39	0	0
4	784002	.	T	A	17	18	35	0	0	35	0	0
4	784177	.	T	C	16	26	42	0	1	43	0	0
4	784325	.	A	T	8	8	16	0	1	17	0	0
4	784373	.	T	A	3	5	8	0	0	9	1	0
4	784435	.	G	T	5	4	9	0	0	9	0	0
4	784472	.	T	C	4	2	6	0	0	6	0	0
4	784473	.	A	C	4	2	6	0	0	6	0	0
4	784733	.	T	A	4	2	6	0	1	7	0	0
4	784854	.	C	A	10	4	14	0	0	14	0	0
4	784990	.	T	A	11	11	22	0	2	24	0	0
4	785132	.	G	A	31	12	43	0	0	43	0	0
4	788970	.	G	C	8	0	8	0	14	22	0	0
4	789589	.	A	G	9	11	20	0	0	20	0	0
4	798743	.	G	C	3	2	5	0	0	5	0	0
4	798804	.	G	A	13	12	25	0	2	27	0	0
4	798850	.	A	C	12	11	23	0	0	23	0	0
4	798861	.	G	T	12	11	23	0	0	23	0	0
4	799006	.	G	T	19	16	35	0	1	36	0	0
4	799090	.	T	C	10	10	20	0	1	21	0	0
4	799127	.	T	G	14	11	25	0	1	26	0	0
4	799245	.	G	A	14	13	27	0	0	27	0	0
4	799385	.	C	G	4	3	7	0	0	7	0	0
4	799475	.	A	G	8	14	22	0	0	22	0	0
4	799513	.	G	A	12	14	26	0	3	29	0	0
4	799620	.	C	T	23	14	37	0	0	37	0	0
4	799643	.	T	A	20	15	35	0	1	36	0	0
4	799933	.	C	T	18	21	39	0	2	41	0	0
4	800027	.	C	T	12	17	29	0	2	32	1	0
4	800094	.	A	G	8	19	27	0	1	28	0	0
4	800113	.	A	G	11	17	28	0	1	29	0	0
4	800363	.	C	T	3	14	17	0	26	43	0	0
4	800520	.	T	C	12	6	18	0	0	18	0	0
4	802909	.	T	A	13	8	21	0	0	21	0	0
4	803862	.	T	C	5	0	5	0	6	11	0	0
4	806319	.	G	A	8	4	12	0	0	12	0	0
4	806322	.	T	C	8	4	12	0	0	12	0	0
4	807895	.	C	G	6	3	9	0	2	11	0	0
4	807898	.	A	G	5	5	10	0	3	13	0	0
4	808031	.	C	T	2	6	8	0	0	8	0	0
4	809456	.	A	G	12	15	27	0	1	28	0	0
4	809512	.	T	C	17	1	18	0	16	34	0	0
4	809549	.	A	G	4	8	12	0	1	13	0	0
4	813157	.	G	A	8	3	11	0	0	11	0	0
4	813226	.	A	G	11	11	22	0	1	23	0	0
4	823755	.	C	A	0	2	2	0	1	3	0	0
4	824178	.	C	G	0	2	2	0	2	4	0	0
4	844545	.	C	A	7	4	11	0	0	11	0	0
4	844547	.	T	C	7	4	11	0	0	11	0	0
4	844819	.	G	A	2	2	4	0	0	4	0	0
4	862009	.	A	G	4	2	6	0	0	6	0	0
4	864712	.	C	T	3	3	6	0	0	6	0	0
4	864739	.	G	C	1	3	4	0	0	4	0	0
4	867601	.	G	C	1	0	1	0	0	1	0	0
4	867692	.	A	C	0	2	2	0	0	2	0	0
4	873763	.	C	G	6	4	10	0	0	10	0	0
4	874241	.	G	T	3	1	4	0	1	5	0	0
4	875350	.	A	G	0	1	1	0	1	2	0	0
4	880033	.	A	G	1	4	5	0	0	5	0	0
4	880201	.	A	C	2	2	4	0	0	4	0	0
4	880365	.	G	A	2	2	4	0	0	4	0	0
4	880934	.	A	C	3	0	3	0	2	5	0	0
4	881497	.	A	C	0	4	4	0	0	4	0	0
4	881758	.	G	T	1	2	3	0	0	3	0	0
4	881886	.	G	A	3	4	7	0	0	7	0	0
4	881888	.	A	G	3	4	7	0	0	7	0	0
4	881980	.	T	A	5	2	7	0	0	7	0	0
4	882099	.	G	A	2	2	4	0	0	4	0	0
4	882207	.	G	T	3	4	7	0	0	7	0	0
4	882231	.	A	G	2	2	4	0	0	4	0	0
4	882294	.	A	T	0	0	0	4	0	4	0	0
4	883485	.	G	A	3	3	6	0	1	7	0	0
4	905612	.	G	A	1	2	3	0	2	5	0	0
4	958978	.	A	T	5	2	7	0	1	8	0	0
4	959015	.	T	C	6	5	11	0	0	11	0	0
4	961542	.	G	A	0	2	2	0	0	2	0	0
4	963452	.	A	G	2	0	2	0	0	2	0	0
4	965124	.	C	G	0	1	1	0	5	6	0	0
4	967974	.	C	T	4	4	8	0	0	8	0	0
4	968001	.	G	A	0	4	4	0	5	9	0	0
4	968121	.	T	C	1	0	1	0	0	1	0	0
4	971842	.	G	C	0	1	1	0	0	1	0	0
4	974482	.	C	T	8	6	14	0	0	14	0	0
4	975735	.	G	C	0	2	2	0	1	3	0	0
4	975758	.	C	T	6	4	10	0	0	10	0	0
4	975792	.	G	C	0	7	7	0	8	15	0	0
4	982892	.	G	A	1	3	4	0	0	4	0	0
4	982893	.	T	C	3	1	4	0	0	4	0	0
4	982938	.	C	G	2	3	5	0	0	5	0	0
4	982958	.	A	G	2	3	5	0	0	5	0	0
4	983092	.	G	T	2	2	4	0	0	4	0	0
4	983093	.	C	A	2	2	4	0	0	4	0	0
4	986133	.	A	G	5	2	7	0	0	7	0	0
4	986210	.	T	C	1	4	5	0	1	6	0	0
4	986350	.	C	A	0	6	6	0	9	15	0	0
4	1054775	.	G	A	10	21	31	0	0	31	0	0
4	1054866	.	G	T	26	5	31	0	6	37	0	0
4	1054868	.	G	A	27	5	32	0	5	37	0	0
4	1055081	.	C	T	22	11	33	0	1	34	0	0
4	1055095	.	T	A	18	10	28	0	1	29	0	0
4	1055200	.	A	G	7	3	10	0	4	14	0	0
4	1055724	.	C	T	21	21	42	0	3	45	0	0
4	1055770	.	A	G	28	15	43	0	2	45	0	0
4	1146384	.	T	C	4	2	6	1	0	7	0	0
4	1146466	.	G	C	1	2	3	0	0	3	0	0
4	1283605	.	A	G	3	0	3	0	2	5	0	0
4	1283626	.	T	C	4	2	6	0	0	6	0	0
4	1283707	.	C	T	2	3	5	0	0	5	0	0
4	1301582	.	G	A	8	13	21	0	0	21	0	0
4	1301785	.	G	T	1	7	8	0	2	10	0	0
4	1301848	.	G	A	1	7	8	0	0	8	0	0
4	1301866	.	A	T	2	10	12	0	0	12	0	0
4	1301921	.	T	C	2	1	3	0	13	16	0	0
4	1301954	.	C	T	4	6	10	0	1	11	0	0
4	1302059	.	T	C	12	0	12	0	8	20	0	0
4	1302155	.	A	G	8	9	17	0	0	17	0	0
4	1302198	.	G	A	8	3	11	0	4	15	0	0
4	1302219	.	G	T	5	4	9	0	5	14	0	0
4	1302385	.	G	A	2	15	17	0	0	17	0	0
4	1302401	.	G	A	5	17	22	0	0	22	0	0
4	1302437	.	A	G	10	15	25	0	0	25	0	0
4	1302485	.	T	C	13	0	13	0	10	23	0	0
4	1302488	.	T	C	13	0	13	0	11	24	0	0
4	1302584	.	A	G	3	8	11	0	0	11	0	0
4	1302609	.	A	G	3	7	10	0	0	10	0	0
4	1302624	.	A	G	3	8	11	0	3	14	0	0
4	1302702	.	C	A	8	13	21	0	0	21	0	0
4	1302785	.	C	T	0	14	14	0	9	23	0	0
4	1303044	.	C	T	5	6	11	0	0	11	0	0
4	1303097	.	A	G	5	10	15	0	0	15	0	0
4	1303196	.	G	A	2	3	5	0	0	5	0	0
4	1303206	.	T	C	2	0	2	0	1	3	0	0
4	1303235	.	G	C	1	1	2	0	2	4	0	0
4	1389106	.	C	T	5	12	17	0	2	19	0	0
4	1389157	.	T	A	0	1	1	0	0	1	0	0
4	1393032	.	T	A	8	6	14	0	0	14	0	0
4	1393062	.	A	G	5	3	8	0	0	8	0	0
4	1469788	.	T	C	2	4	6	0	0	6	0	0
4	1469839	.	A	T	2	2	4	0	0	4	0	0
4	1469913	.	T	G	1	2	3	0	0	3	0	0
4	1470000	.	C	T	11	3	14	0	0	14	0	0
4	1470380	.	C	A	16	10	26	0	0	26	0	0
4	1470689	.	T	C	2	0	2	0	5	7	0	0
4	1470707	.	T	G	5	2	7	0	2	9	0	0
4	1477538	.	A	G	6	6	12	0	1	13	0	0
4	1479855	.	C	A	2	3	5	0	0	5	0	0
4	1497159	.	G	A	4	4	8	0	0	8	0	0
4	1497211	.	A	G	5	2	7	0	1	8	0	0
4	1547304	.	G	C	1	2	3	0	0	3	0	0
4	1547354	.	G	A	0	3	3	0	2	5	0	0
4	1564041	.	T	C	4	2	6	0	0	6	0	0
4	1565315	.	G	T	4	2	6	0	0	6	0	0
4	1565336	.	C	T	4	3	7	0	0	7	0	0
4	1565356	.	A	G	4	3	7	0	1	8	0	0
4	1565673	.	T	C	3	6	9	0	0	9	0	0
4	1565789	.	A	G	1	2	3	0	0	3	0	0
4	1565832	.	G	A	4	2	6	0	0	6	0	0
4	1566427	.	C	A	9	8	17	0	0	17	0	0
4	1566501	.	T	C	5	3	8	0	1	9	0	0
4	1566502	.	T	G	4	0	4	0	5	9	0	0
4	1733713	.	T	C	3	3	6	0	0	6	0	0
4	1733717	.	T	C	3	2	5	0	0	5	0	0
4	1834169	.	C	G	2	1	3	0	0	3	0	0
4	1834190	.	G	A	0	2	2	0	0	2	0	0
4	1835801	.	C	T	1	2	3	0	1	4	0	0
4	1835950	.	G	T	2	1	3	0	0	3	0	0
4	1835982	.	T	C	1	1	2	0	0	2	0	0
4	1837647	.	A	T	3	2	5	0	1	6	0	0
4	1839142	.	T	C	5	5	10	0	0	10	0	0
4	1988669	.	G	A	4	2	6	0	0	6	0	0
4	1988856	.	T	C	4	0	4	0	10	14	0	0
4	1989101	.	T	C	2	0	2	0	3	5	0	0
4	1997528	.	C	T	0	7	7	0	4	11	0	0
4	1997549	.	G	A	4	7	11	0	1	12	0	0
4	2044213	.	A	G	13	7	20	0	0	20	0	0
4	2044432	.	G	T	18	11	29	0	1	30	0	0
4	2044517	.	A	G	15	10	25	0	0	25	0	0
4	2044944	.	T	A	0	2	2	0	1	3	0	0
4	2051372	.	T	C	2	5	7	0	0	7	0	0
4	2051447	.	A	G	3	5	8	0	0	8	0	0
4	2055067	.	C	A	5	7	12	0	5	17	0	0
4	2055103	.	G	T	5	4	9	0	1	10	0	0
4	2055118	.	T	A	2	4	6	0	1	7	0	0
4	2055265	.	G	A	16	15	31	0	1	32	0	0
4	2055318	.	G	A	8	10	18	0	0	18	0	0
4	2056028	.	G	A	18	13	31	0	1	32	0	0
4	2059765	.	C	A	13	6	19	0	0	19	0	0
4	2059801	.	T	A	11	13	24	0	0	24	0	0
4	2059831	.	C	G	12	12	24	0	0	24	0	0
4	2059846	.	A	T	10	12	22	0	1	23	0	0
4	2060125	.	T	C	1	4	5	0	0	5	0	0
4	2060134	.	C	T	1	1	2	0	0	2	0	0
4	2061214	.	G	A	3	4	7	0	0	7	0	0
4	2062085	.	A	G	5	3	8	0	0	8	0	0
4	2062133	.	G	A	8	4	12	0	2	14	0	0
4	2062237	.	T	A	9	5	14	0	0	14	0	0
4	2151743	.	G	A	6	6	12	0	0	12	0	0
4	2160995	.	G	A	3	3	6	0	0	6	0	0
4	2162664	.	T	G	5	6	11	0	0	11	0	0
4	2162726	.	C	G	0	11	11	0	10	21	0	0
4	2162798	.	G	A	7	15	22	0	1	23	0	0
4	2162804	.	A	G	7	16	23	0	2	25	0	0
4	2163383	.	T	C	3	0	3	0	7	10	0	0
4	2163521	.	A	G	3	2	5	0	1	6	0	0
4	2260515	.	T	C	2	0	2	0	1	3	0	0
4	2261176	.	A	G	1	0	1	0	1	2	0	0
4	2349386	.	G	A	4	4	8	0	1	9	0	0
4	2349391	.	C	T	4	4	8	0	1	9	0	0
4	2349527	.	A	G	6	5	11	0	2	13	0	0
4	2349542	.	A	T	8	5	13	0	0	13	0	0
4	2349576	.	A	C	4	4	8	0	1	9	0	0
4	2349656	.	T	C	1	4	5	0	0	5	0	0
4	2349798	.	G	A	13	10	23	0	0	23	0	0
4	2349805	.	G	T	11	9	20	0	1	21	0	0
4	2368016	.	A	G	9	6	15	0	0	15	0	0
4	2396616	.	C	T	1	3	4	0	0	4	0	0
4	2404782	.	T	G	3	0	3	0	0	3	0	0
4	2404785	.	G	A	3	0	3	0	0	3	0	0
4	2404872	.	A	G	1	2	3	0	0	3	0	0
4	2506611	.	C	T	4	1	5	0	0	5	0	0
4	2508427	.	A	C	8	12	20	0	0	20	0	0
4	2511830	.	C	T	18	11	29	1	2	32	0	0
4	2511921	.	T	C	9	13	22	0	1	23	0	0
4	2511991	.	A	T	13	10	23	0	1	24	0	0
4	2514580	.	G	A	5	2	7	0	0	7	0	0
4	2514596	.	C	A	5	3	8	0	0	8	0	0
4	2516385	.	G	A	2	5	7	0	0	7	0	0
4	2550932	.	T	C	1	1	2	0	0	2	0	0
4	2550934	.	C	T	0	1	1	0	1	2	0	0
4	2556364	.	A	C	0	0	0	0	2	2	0	0
4	2556508	.	C	T	5	3	8	0	1	9	0	0
4	2559498	.	A	G	1	0	1	0	0	1	0	0
4	2563181	.	G	A	4	3	7	0	1	8	0	0
4	2571695	.	T	A	0	2	2	0	0	2	0	0
4	2571701	.	A	G	0	2	2	0	0	2	0	0
4	2573559	.	G	T	1	0	1	0	0	1	0	0
4	2620973	.	C	A	9	12	21	0	1	22	0	0
4	2621086	.	G	A	6	11	17	0	0	17	0	0
4	2621186	.	G	A	8	11	19	0	1	20	0	0
4	2621761	.	T	C	13	5	18	0	1	19	0	0
4	2622344	.	G	C	13	12	25	0	0	25	0	0
4	2622496	.	T	C	15	12	27	0	0	27	0	0
4	2622529	.	C	A	9	10	19	0	1	20	0	0
4	2623129	.	G	A	0	2	2	0	3	5	0	0
4	2642254	.	T	A	1	2	3	0	0	3	0	0
4	2655466	.	A	G	0	3	3	0	0	3	0	0
4	2666037	.	T	C	2	0	2	0	2	4	0	0
4	2666064	.	T	C	1	3	4	0	0	4	0	0
4	2666133	.	T	A	0	2	2	0	0	2	0	0
4	2675148	.	C	T	8	3	11	0	2	13	0	0
4	2675235	.	C	T	8	14	22	0	6	28	0	0
4	2688740	.	T	C	6	2	8	0	0	8	0	0
4	2688785	.	T	G	1	2	3	0	0	3	0	0
4	2695357	.	G	A	3	0	3	0	0	3	0	0
4	2701352	.	G	A	3	3	6	0	0	6	0	0
4	2701370	.	T	C	3	3	6	0	0	6	0	0
4	2752987	.	C	T	3	3	6	0	0	6	0	0
4	2753455	.	C	T	0	3	3	0	2	5	0	0
4	2765529	.	C	G	1	2	3	0	0	3	0	0
4	2773997	.	G	A	1	0	1	0	0	1	0	0
4	2866721	.	C	A	2	0	2	0	0	2	0	0
4	2867168	.	G	A	1	3	4	0	0	4	0	0
4	2867795	.	C	T	1	3	4	0	0	4	0	0
4	3351481	.	A	G	2	2	4	0	0	4	0	0
4	3475007	.	A	G	4	2	6	0	0	6	0	0
4	4090438	.	C	T	0	1	1	0	0	1	0	0
4	4098479	.	T	A	4	2	6	0	1	7	0	0
4	4104264	.	A	G	3	0	3	0	7	10	0	0
4	4106478	.	A	C	7	0	7	0	11	18	0	0
4	4106546	.	T	G	2	6	8	0	1	9	0	0
4	4111070	.	A	G	5	5	10	0	1	11	0	0
4	4111180	.	C	T	4	3	7	0	0	7	0	0
4	4111229	.	A	T	6	7	13	0	0	13	0	0
4	4111252	.	A	T	2	2	4	0	7	11	0	0
4	4111396	.	T	C	6	12	18	0	0	18	0	0
4	4111673	.	G	A	1	5	6	0	0	6	0	0
4	4117174	.	A	C	2	4	6	0	0	6	0	0
4	4117480	.	T	C	1	5	6	0	0	6	0	0
4	4117730	.	T	C	1	0	1	0	3	4	0	0
4	4118119	.	C	A	0	2	2	0	1	3	0	0
4	4118397	.	C	T	0	1	1	0	0	1	0	0
4	4119344	.	G	A	1	3	4	0	1	5	0	0
4	4119368	.	G	A	1	5	6	0	0	6	0	0
4	4120825	.	C	T	1	1	2	0	0	2	0	0
4	4120854	.	C	T	2	2	4	0	1	5	0	0
4	4120872	.	A	G	2	4	6	0	0	6	0	0
4	4122577	.	G	A	2	3	5	0	0	5	0	0
4	4122586	.	G	A	2	4	6	0	0	6	0	0
4	4122769	.	T	A	2	2	4	0	0	4	0	0
4	4129088	.	G	T	0	1	1	0	0	1	0	0
4	4232886	.	C	G	4	0	4	0	6	10	0	0
4	4232994	.	T	C	2	2	4	0	0	4	0	0
4	4235162	.	A	G	25	14	39	0	4	43	0	0
4	4238175	.	C	T	0	6	6	0	6	12	0	0
4	4240177	.	T	C	5	7	12	0	0	12	0	0
4	4243084	.	G	A	6	9	15	0	1	16	0	0
4	4249690	.	G	A	0	2	2	0	0	2	0	0
4	4258884	.	A	G	1	3	4	0	0	4	0	0
4	4258927	.	T	C	10	16	26	0	0	26	0	0
4	4258951	.	C	T	13	25	38	0	0	38	0	0
4	4273225	.	G	A	0	2	2	0	1	3	0	0
4	4290728	.	C	G	2	0	2	0	6	8	0	0
4	4327793	.	C	T	3	5	8	0	0	8	0	0
4	4329022	.	G	A	0	1	1	0	2	3	0	0
4	4331151	.	C	T	1	2	3	0	0	3	0	0
4	4348785	.	C	T	1	6	7	0	0	7	0	0
4	4355714	.	C	T	6	4	10	0	1	11	0	0
4	4355791	.	G	T	0	6	6	0	8	14	0	0
4	4356320	.	C	T	0	8	8	0	0	8	0	0
4	4356766	.	A	T	1	3	4	0	0	4	0	0
4	4357073	.	A	G	7	8	15	0	1	16	0	0
4	4357173	.	C	T	4	5	9	0	0	9	0	0
4	4357175	.	G	A	4	5	9	0	0	9	0	0
4	4358201	.	G	A	0	2	2	0	0	2	0	0
4	4358239	.	G	C	1	3	4	0	0	4	0	0
4	4358240	.	T	A	1	3	4	0	0	4	0	0
4	4358471	.	C	T	3	4	7	0	1	8	0	0
4	4358558	.	A	G	10	3	13	0	0	13	0	0
4	4358580	.	A	G	6	6	12	0	0	12	0	0
4	4358610	.	C	A	9	7	16	0	0	16	0	0
4	4484788	.	A	G	12	9	21	0	0	21	0	0
4	4484914	.	T	A	18	13	31	0	1	32	0	0
4	4485186	.	A	T	18	22	40	1	1	42	0	0
4	4485247	.	A	T	18	17	35	0	1	36	0	0
4	4485534	.	C	A	14	12	26	0	1	27	0	0
4	4485650	.	A	T	7	13	20	0	1	21	0	0
4	4485736	.	T	G	12	10	22	0	0	22	0	0
4	4485793	.	C	G	8	17	25	0	0	25	0	0
4	4488137	.	A	G	6	5	11	0	0	11	0	0
4	4488207	.	G	A	9	8	17	0	1	18	0	0
4	4491740	.	T	C	4	0	4	0	8	12	0	0
4	4491782	.	T	C	3	0	3	0	6	9	0	0
4	4492003	.	C	T	3	2	5	0	3	8	0	0
4	4492336	.	A	G	2	3	5	0	1	6	0	0
4	4492369	.	C	A	0	7	7	0	5	12	0	0
4	4492444	.	A	G	3	2	5	0	0	5	0	0
4	4492456	.	T	C	3	0	3	0	1	4	0	0
4	4494733	.	C	A	0	3	3	0	0	3	0	0
4	4510097	.	A	G	7	0	7	0	7	14	0	0
4	4514215	.	A	G	8	0	8	0	13	21	0	0
4	4516310	.	G	C	0	14	14	0	12	26	0	0
4	4516313	.	A	G	11	0	11	0	15	26	0	0
4	4516346	.	C	T	13	9	22	0	1	23	0	0
4	4519688	.	G	A	11	7	18	0	2	20	0	0
4	4519697	.	T	C	11	5	16	0	0	16	0	0
4	4523403	.	C	G	12	14	26	0	0	26	0	0
4	4523579	.	T	C	16	34	50	0	2	52	0	0
4	4523885	.	A	C	14	15	29	0	0	29	0	0
4	4524215	.	T	A	3	5	8	0	0	8	0	0
4	4526936	.	T	C	1	1	2	0	1	3	0	0
4	4527045	.	A	G	1	2	3	0	0	3	0	0
4	4527554	.	A	T	1	3	4	0	0	4	0	0
4	4635691	.	C	G	15	15	30	0	2	32	0	0
4	4638701	.	G	C	2	0	2	0	1	3	0	0
4	4640605	.	G	A	12	16	28	0	0	28	0	0
4	4640614	.	G	A	12	15	27	0	0	27	0	0
4	4647977	.	A	G	7	9	16	0	0	16	0	0
4	4653380	.	A	C	2	0	2	0	3	5	0	0
4	4657961	.	G	A	4	3	7	0	1	8	0	0
4	4706687	.	G	T	1	0	1	0	0	1	0	0
4	4706819	.	C	T	0	12	12	0	12	24	0	0
4	4706825	.	C	G	11	13	24	0	1	25	0	0
4	4712951	.	G	A	3	5	8	0	0	8	0	0
4	4713042	.	T	G	4	6	10	0	0	10	0	0
4	4713967	.	T	G	6	2	8	0	1	9	0	0
4	4713982	.	C	G	4	3	7	0	1	8	0	0
4	4714338	.	A	T	3	3	6	0	0	6	0	0
4	4714358	.	C	T	0	2	2	0	1	3	0	0
4	4714743	.	A	T	2	3	5	0	0	5	0	0
4	4714763	.	A	C	1	2	3	0	0	3	0	0
4	4721297	.	T	C	0	0	0	0	3	3	0	0
4	4753372	.	T	A	0	1	1	0	0	1	0	0
4	4754474	.	A	G	2	8	10	0	0	10	0	0
4	4758291	.	C	A	4	2	6	0	0	6	0	0
4	4760581	.	C	T	3	1	4	0	0	4	0	0
4	4762804	.	T	A	1	2	3	0	0	3	0	0
4	4782880	.	C	G	0	2	2	0	0	2	0	0
4	4782962	.	A	C	7	3	10	0	0	10	0	0
4	4783020	.	C	T	0	2	2	0	7	9	0	0
4	4783059	.	A	T	9	6	15	0	0	15	0	0
4	4783067	.	C	T	9	5	14	0	2	16	0	0
4	4784802	.	G	A	7	6	13	0	0	13	0	0
4	4786350	.	A	G	2	5	7	0	0	7	0	0
4	4786383	.	G	A	5	5	10	0	1	11	0	0
4	4786443	.	A	C	7	0	7	0	5	12	0	0
4	4831630	.	T	G	8	7	15	0	1	16	0	0
4	4831660	.	G	A	12	5	17	0	1	18	0	0
4	4831722	.	A	C	13	4	17	0	0	17	0	0
4	4831759	.	C	A	14	4	18	0	1	19	0	0
4	4831763	.	A	T	15	4	19	0	0	19	0	0
4	4831885	.	A	C	7	6	13	0	0	13	0	0
4	4831898	.	T	C	5	10	15	0	0	15	0	0
4	4831968	.	A	C	8	9	17	0	1	18	0	0
4	4832241	.	A	G	6	10	16	0	1	17	0	0
4	4834125	.	G	A	0	2	2	0	0	2	0	0
4	4834497	.	A	G	16	6	22	0	0	22	0	0
4	4902137	.	A	C	4	4	8	0	1	9	0	0
4	4902425	.	G	C	7	13	20	0	0	20	0	0
4	4911071	.	C	T	2	4	6	0	0	6	0	0
4	4911247	.	A	G	2	2	4	0	0	4	0	0
4	4913422	.	C	T	7	7	14	0	1	15	0	0
4	4914832	.	A	G	7	6	13	0	0	13	0	0
4	4921733	.	T	C	7	15	22	0	1	23	0	0
4	4921773	.	G	A	0	7	7	0	3	10	0	0
4	4923290	.	A	T	8	11	19	0	2	21	0	0
4	4923323	.	C	T	5	3	8	0	0	8	0	0
4	4923755	.	T	G	4	10	14	0	0	14	0	0
4	4925611	.	C	T	3	2	5	0	0	5	0	0
4	4926037	.	G	T	2	4	6	0	0	6	0	0
4	4938978	.	C	T	9	3	12	0	2	14	0	0
4	4971354	.	C	A	4	5	9	0	1	10	0	0
4	4971836	.	T	C	2	1	3	0	1	4	0	0
4	4971847	.	T	A	4	2	6	0	0	6	0	0
4	4971911	.	G	T	3	11	14	0	0	15	1	0
4	4972056	.	C	T	7	8	15	0	1	16	0	0
4	4972533	.	G	A	13	11	24	0	0	24	0	0
4	4972555	.	G	C	9	7	16	0	4	20	0	0
4	4972664	.	G	T	5	4	9	0	0	9	0	0
4	4972762	.	A	T	1	5	6	0	0	6	0	0
4	4973053	.	G	A	8	4	12	0	0	12	0	0
4	4975329	.	C	G	3	0	3	0	0	3	0	0
4	4980443	.	G	A	1	1	2	0	0	2	0	0
4	4980458	.	C	T	0	1	1	0	1	2	0	0
4	4992114	.	A	C	2	3	5	0	0	5	0	0
4	5006535	.	T	C	2	0	2	0	0	2	0	0
4	5006562	.	G	T	2	0	2	0	0	2	0	0
4	5025964	.	G	C	13	7	20	0	0	20	0	0
4	5026355	.	T	C	2	3	5	0	0	5	0	0
4	5042689	.	T	A	1	0	1	0	0	1	0	0
4	5042755	.	C	T	11	7	18	0	1	19	0	0
4	5048903	.	C	T	7	4	11	0	0	11	0	0
4	5094237	.	C	T	6	3	9	0	1	10	0	0
4	5097421	.	C	T	0	1	1	0	2	3	0	0
4	5098152	.	G	A	1	5	6	0	0	6	0	0
4	5098507	.	A	G	0	3	3	0	0	3	0	0
4	5102316	.	A	C	7	0	7	0	4	11	0	0
4	5104859	.	G	A	1	5	6	0	0	6	0	0
4	5107389	.	G	A	1	2	3	0	0	3	0	0
4	5158749	.	C	T	3	4	7	0	0	7	0	0
4	5161241	.	G	T	4	4	8	0	0	8	0	0
4	5161256	.	A	C	5	4	9	0	0	9	0	0
4	5181042	.	C	T	2	2	4	0	0	4	0	0
4	5200306	.	T	C	1	2	3	0	0	3	0	0
4	5240203	.	A	C	24	2	26	0	20	46	0	0
4	5240265	.	C	T	20	20	40	1	2	43	0	0
4	5240393	.	C	T	20	21	41	1	4	46	0	0
4	5240472	.	T	A	29	26	55	0	2	57	0	0
4	5240505	.	A	G	27	27	54	0	0	54	0	0
4	5242055	.	T	G	6	9	15	0	0	15	0	0
4	5242300	.	C	G	4	6	10	0	0	10	0	0
4	5243657	.	C	A	0	4	4	0	1	5	0	0
4	5244568	.	C	A	0	3	3	0	0	3	0	0
4	5247107	.	G	A	24	17	41	0	0	41	0	0
4	5247127	.	G	C	26	21	47	0	1	48	0	0
4	5247145	.	C	T	1	20	21	0	29	51	1	0
4	5255128	.	C	A	16	11	27	1	1	29	0	0
4	5255148	.	C	T	16	14	30	0	2	32	0	0
4	5255180	.	T	C	9	10	19	0	0	19	0	0
4	5256482	.	A	G	8	14	22	0	0	22	0	0
4	5256659	.	A	G	8	1	9	0	11	20	0	0
4	5256674	.	G	T	14	8	22	0	0	22	0	0
4	5256737	.	A	G	3	5	8	0	0	8	0	0
4	5256788	.	G	A	6	2	8	0	0	8	0	0
4	5269608	.	G	A	11	5	16	0	1	17	0	0
4	5269660	.	C	G	15	17	32	0	1	33	0	0
4	5291755	.	T	C	8	6	14	0	1	15	0	0
4	5291794	.	T	C	4	0	4	0	0	4	0	0
4	5302127	.	C	T	1	23	24	0	20	44	0	0
4	5302195	.	A	G	24	14	38	0	0	38	0	0
4	5302327	.	G	A	20	13	33	0	1	34	0	0
4	5302689	.	G	A	15	6	21	0	0	21	0	0
4	5318995	.	G	A	6	9	15	0	0	15	0	0
4	5324871	.	G	T	10	8	18	0	0	18	0	0
4	5325105	.	C	T	9	16	25	0	0	25	0	0
4	5329849	.	G	A	2	1	3	0	0	3	0	0
4	5329850	.	G	A	1	2	3	0	0	3	0	0
4	5330192	.	C	A	0	1	1	0	0	1	0	0
4	5330341	.	C	T	0	0	0	0	1	1	0	0
4	5331720	.	G	A	3	6	9	0	1	10	0	0
4	5334029	.	G	C	1	3	4	0	0	4	0	0
4	5334061	.	G	A	1	2	3	0	1	4	0	0
4	5338909	.	T	A	5	6	11	0	0	13	2	0
4	5338950	.	G	T	5	4	9	0	3	12	0	0
4	5339053	.	T	A	9	18	27	0	0	27	0	0
4	5363744	.	A	C	4	3	7	0	0	7	0	0
4	5363836	.	G	A	3	4	7	0	0	7	0	0
4	5365191	.	C	T	0	3	3	0	0	3	0	0
4	5365199	.	A	G	0	5	5	0	0	5	0	0
4	5365235	.	C	T	2	0	2	0	0	2	0	0
4	5365243	.	C	T	2	0	2	0	0	2	0	0
4	5365878	.	T	C	1	3	4	0	0	4	0	0
4	5365881	.	T	C	1	0	1	0	3	4	0	0
4	5366247	.	G	A	2	3	5	0	0	5	0	0
4	5366462	.	C	G	1	4	5	0	0	5	0	0
4	5366663	.	C	T	5	2	7	0	0	7	0	0
4	5366700	.	G	T	1	4	5	0	0	5	0	0
4	5366765	.	G	A	3	2	5	0	0	5	0	0
4	5366789	.	G	A	2	2	4	0	0	4	0	0
4	5367032	.	G	A	6	2	8	0	1	9	0	0
4	5370090	.	C	T	3	1	4	0	0	4	0	0
4	5398370	.	A	G	1	0	1	0	2	3	0	0
4	5521510	.	C	T	16	15	31	0	0	31	0	0
4	5521996	.	G	T	20	7	27	0	0	27	0	0
4	5522154	.	G	T	9	13	22	0	1	23	0	0
4	5522161	.	C	T	14	8	22	0	0	22	0	0
4	5522298	.	C	A	2	3	5	0	0	5	0	0
4	5595171	.	C	T	6	6	12	0	0	12	0	0
4	5597604	.	C	A	5	2	7	0	0	7	0	0
4	5597772	.	T	C	3	4	7	0	0	7	0	0
4	5643321	.	G	A	1	0	1	0	0	1	0	0
4	5644808	.	G	A	6	7	13	0	0	13	0	0
4	5644974	.	G	A	6	12	18	0	0	18	0	0
4	5645097	.	C	T	6	2	8	0	1	9	0	0
4	5665612	.	T	C	6	0	6	0	3	9	0	0
4	5672765	.	G	A	0	1	1	0	0	1	0	0
4	5691208	.	C	A	0	0	0	0	1	1	0	0
4	5742551	.	G	A	11	7	18	0	2	20	0	0
4	5742831	.	A	C	13	19	32	0	0	32	0	0
4	5742846	.	C	T	15	12	27	0	1	28	0	0
4	5742936	.	G	A	0	15	15	0	11	26	0	0
4	5742962	.	A	T	11	11	22	0	0	22	0	0
4	5743027	.	A	G	6	8	14	0	0	14	0	0
4	5750854	.	G	A	3	9	12	0	0	12	0	0
4	5750884	.	T	A	7	3	10	0	1	11	0	0
4	5750924	.	A	G	6	5	11	0	0	11	0	0
4	5751381	.	A	C	11	7	18	0	1	19	0	0
4	5751382	.	C	T	0	7	7	0	12	19	0	0
4	5751551	.	G	A	9	5	14	0	3	17	0	0
4	5755018	.	C	T	1	9	10	0	7	17	0	0
4	5755027	.	C	T	0	8	8	0	8	16	0	0
4	5757253	.	C	T	2	6	8	0	1	9	0	0
4	5759617	.	T	G	8	4	12	0	0	12	0	0
4	5763975	.	G	A	11	15	26	0	1	27	0	0
4	5764128	.	T	A	9	20	29	0	0	29	0	0
4	5764926	.	C	T	2	10	12	0	0	12	0	0
4	5765181	.	C	T	1	3	4	0	1	5	0	0
4	5765985	.	C	A	4	8	12	0	0	12	0	0
4	5766063	.	G	A	6	3	9	0	0	9	0	0
4	5766156	.	C	T	0	12	12	0	1	13	0	0
4	5766200	.	T	A	3	8	11	0	0	11	0	0
4	5766315	.	G	A	7	11	18	0	0	18	0	0
4	5785957	.	G	T	1	2	3	0	0	3	0	0
4	5786961	.	T	C	2	0	2	0	0	2	0	0
4	5790426	.	G	A	2	2	4	0	0	4	0	0
4	5790438	.	C	A	2	2	4	0	0	4	0	0
4	5801063	.	C	T	1	2	3	0	0	3	0	0
4	5806111	.	G	A	1	1	2	0	0	2	0	0
4	5806252	.	T	A	6	2	8	0	0	8	0	0
4	5806274	.	T	A	2	5	7	0	0	8	1	0
4	5806810	.	T	A	2	3	5	0	1	6	0	0
4	5832470	.	A	T	3	0	3	0	0	3	0	0
4	5835612	.	C	T	6	3	9	0	1	10	0	0
4	5835635	.	G	A	3	4	7	0	1	8	0	0
4	5835688	.	T	G	0	1	1	0	0	1	0	0
4	5838505	.	G	A	8	6	14	0	0	14	0	0
4	5849003	.	C	A	5	5	10	0	0	10	0	0
4	5849180	.	A	G	10	0	10	0	8	18	0	0
4	5849225	.	G	A	7	9	16	0	1	17	0	0
4	5850169	.	T	C	4	2	6	0	0	6	0	0
4	5850281	.	T	C	11	9	20	0	0	20	0	0
4	5850297	.	A	G	6	10	16	0	4	20	0	0
4	5850604	.	C	G	1	3	4	0	0	4	0	0
4	5851097	.	C	G	2	3	5	0	0	5	0	0
4	5896187	.	C	T	1	2	3	0	1	4	0	0
4	5905707	.	T	C	1	1	2	0	0	2	0	0
4	5907100	.	C	T	3	1	4	0	1	5	0	0
4	5907145	.	C	T	7	4	11	0	0	11	0	0
4	5907465	.	G	T	0	1	1	0	1	2	0	0
4	5910137	.	A	G	3	2	5	0	0	5	0	0
4	5910302	.	C	T	1	4	5	0	2	7	0	0
4	5910492	.	A	G	6	6	12	0	6	18	0	0
4	5910516	.	A	G	9	9	18	0	1	19	0	0
4	5910644	.	G	A	24	21	45	0	1	46	0	0
4	5912445	.	C	T	1	0	1	0	0	1	0	0
4	5912475	.	G	A	7	6	13	0	0	13	0	0
4	5912707	.	A	G	3	1	4	0	0	4	0	0
4	6341358	.	A	G	1	2	3	0	0	3	0	0
4	6432112	.	G	A	0	1	1	0	0	1	0	0
4	6449366	.	G	A	3	3	6	0	0	6	0	0
4	6455849	.	G	A	6	5	11	0	0	11	0	0
4	6507418	.	C	T	1	2	3	0	0	3	0	0
4	6508320	.	G	A	0	5	5	0	1	6	0	0
4	6508382	.	G	C	2	4	6	0	0	6	0	0
4	6639440	.	A	G	13	13	26	0	0	26	0	0
4	6639665	.	G	A	14	13	27	0	0	27	0	0
4	6639786	.	C	T	10	15	25	0	1	26	0	0
4	6640145	.	G	C	8	11	19	0	1	20	0	0
4	6640156	.	T	C	6	12	18	0	1	19	0	0
4	6645994	.	C	T	11	15	26	0	1	27	0	0
4	6646283	.	A	C	7	9	16	0	2	18	0	0
4	6646851	.	G	A	7	11	18	0	0	18	0	0
4	6737609	.	T	G	1	2	3	0	0	3	0	0
4	6749054	.	T	C	6	3	9	0	0	9	0	0
4	6749060	.	C	G	6	3	9	0	0	9	0	0
4	6799942	.	A	G	27	17	44	0	4	48	0	0
4	6800153	.	T	C	14	16	30	0	1	31	0	0
4	6800162	.	C	T	13	16	29	0	1	30	0	0
4	6800393	.	G	A	5	2	7	0	0	7	0	0
4	6802173	.	T	G	8	15	23	0	0	23	0	0
4	6802506	.	A	C	17	12	29	0	0	29	0	0
4	6802518	.	C	G	0	15	15	0	19	34	0	0
4	6909858	.	G	A	2	1	3	0	0	3	0	0
4	6925881	.	C	A	0	1	1	0	0	1	0	0
4	6940374	.	C	T	1	1	2	0	0	2	0	0
4	6946608	.	C	T	1	3	4	0	0	4	0	0
4	6946831	.	G	A	0	1	1	0	0	1	0	0
4	6960365	.	G	A	0	2	2	0	1	3	0	0
4	6960377	.	C	T	1	3	4	0	0	4	0	0
4	6990096	.	C	T	10	11	21	0	0	21	0	0
4	6990392	.	G	T	2	3	5	0	0	5	0	0
4	6990421	.	T	C	2	4	6	0	1	7	0	0
4	6990621	.	G	A	0	7	7	0	7	14	0	0
4	6990632	.	A	G	6	6	12	0	0	12	0	0
4	6990682	.	G	A	4	6	10	0	0	10	0	0
4	6990882	.	C	T	8	7	15	0	0	15	0	0
4	6990886	.	C	A	7	7	14	0	1	15	0	0
4	6991220	.	T	A	4	4	8	0	0	8	0	0
4	6991272	.	G	A	2	4	6	0	0	6	0	0
4	6991764	.	G	T	4	5	9	0	1	10	0	0
4	6992264	.	G	T	12	15	27	0	1	28	0	0
4	6992744	.	C	T	4	8	12	0	0	12	0	0
4	6992918	.	G	C	12	10	22	0	1	23	0	0
4	7211013	.	G	A	17	17	34	0	2	36	0	0
4	7211097	.	C	T	14	12	26	0	1	27	0	0
4	7211264	.	A	G	17	18	35	0	1	36	0	0
4	7211364	.	C	T	1	17	18	0	11	29	0	0
4	7212228	.	G	A	12	14	26	0	0	26	0	0
4	7212236	.	G	A	9	13	22	0	1	23	0	0
4	7212342	.	G	A	4	7	11	0	0	11	0	0
4	7212461	.	G	A	14	10	24	0	0	24	0	0
4	7212606	.	A	G	12	15	27	0	1	28	0	0
4	7212624	.	G	A	10	14	24	0	0	24	0	0
4	7222118	.	G	T	4	3	7	0	0	7	0	0
4	7415423	.	C	T	2	0	2	0	0	2	0	0
4	7465914	.	T	C	1	0	1	0	0	1	0	0
4	7471682	.	A	T	0	2	2	0	0	2	0	0
4	7476736	.	C	T	2	2	4	0	0	4	0	0
4	7546046	.	T	A	1	0	1	0	0	1	0	0
4	7652726	.	G	A	2	6	8	0	0	8	0	0
4	7659924	.	G	A	1	2	3	0	0	3	0	0
4	7664811	.	G	A	0	2	2	0	1	3	0	0
4	7665110	.	T	A	0	2	2	0	0	2	0	0
4	7668510	.	A	G	0	2	2	0	0	2	0	0
4	7668516	.	G	A	0	2	2	0	0	2	0	0
4	7698971	.	G	A	0	2	2	0	0	2	0	0
4	7713041	.	A	G	0	0	0	0	3	3	0	0
4	7713070	.	T	C	0	4	4	0	0	4	0	0
4	7713176	.	C	T	4	3	7	0	0	7	0	0
4	7718868	.	C	T	9	8	17	0	1	18	0	0
4	7726665	.	G	A	1	1	2	0	0	2	0	0
4	7726752	.	T	C	3	3	6	0	0	6	0	0
4	7729807	.	G	A	3	1	4	0	0	4	0	0
4	7737468	.	G	T	7	3	10	0	0	10	0	0
4	7743092	.	C	T	0	4	4	0	11	15	0	0
4	7870444	.	A	T	2	4	6	0	0	6	0	0
4	7870599	.	T	C	2	3	5	0	0	5	0	0
4	7870624	.	T	C	2	4	6	0	0	6	0	0
4	7870660	.	T	A	1	3	4	0	0	4	0	0
4	7870669	.	A	G	1	3	4	0	0	4	0	0
4	7870913	.	T	G	11	3	14	0	0	14	0	0
4	7870952	.	C	T	0	3	3	0	8	11	0	0
4	7870983	.	C	T	6	10	16	0	0	16	0	0
4	7871084	.	A	C	1	1	2	0	0	2	0	0
4	7872229	.	A	G	1	0	1	0	0	1	0	0
4	7872637	.	G	A	0	1	1	0	0	1	0	0
4	7875901	.	T	G	0	1	1	0	0	1	0	0
4	7875917	.	A	T	1	3	4	0	0	4	0	0
4	7879522	.	A	G	0	0	0	0	4	4	0	0
4	7881534	.	C	G	7	1	8	0	5	13	0	0
4	7883462	.	A	C	4	6	10	0	0	10	0	0
4	7883466	.	G	A	3	6	9	0	1	10	0	0
4	7888181	.	A	C	4	4	8	0	0	8	0	0
4	7959162	.	T	C	3	3	6	0	0	6	0	0
4	8027183	.	A	T	0	2	2	0	0	2	0	0
4	8609609	.	T	A	4	1	5	0	3	8	0	0
4	8609648	.	G	A	6	8	14	0	0	14	0	0
4	8609799	.	T	C	14	11	25	0	1	26	0	0
4	8662255	.	C	T	2	2	4	0	0	4	0	0
4	8680965	.	C	T	12	8	20	0	0	20	0	0
4	8681039	.	C	T	1	2	3	0	0	3	0	0
4	8697245	.	C	T	4	2	6	0	1	7	0	0
4	8697269	.	A	G	4	5	9	0	1	10	0	0
4	8702687	.	G	A	7	4	11	0	0	11	0	0
4	8702765	.	C	T	2	5	7	0	0	7	0	0
4	8704655	.	C	T	9	7	16	0	0	16	0	0
4	8706385	.	G	A	3	5	8	0	1	9	0	0
4	8706412	.	G	T	6	5	11	0	0	11	0	0
4	8706716	.	A	G	9	9	18	0	0	18	0	0
4	8706855	.	A	T	1	5	6	0	0	6	0	0
4	8707182	.	T	C	5	9	14	0	0	14	0	0
4	8707381	.	A	G	1	2	3	0	0	3	0	0
4	8761205	.	C	T	0	2	2	0	2	4	0	0
4	8797201	.	T	A	29	21	50	0	1	51	0	0
4	8797234	.	T	A	31	16	47	0	4	51	0	0
4	8797315	.	T	C	26	24	50	0	0	50	0	0
4	8803071	.	C	T	3	2	5	0	1	6	0	0
4	8805792	.	T	C	8	9	17	0	1	18	0	0
4	8808775	.	C	T	8	8	16	0	0	16	0	0
4	8808823	.	C	T	24	20	44	0	3	47	0	0
4	8808974	.	C	T	20	31	51	0	2	53	0	0
4	8809268	.	T	G	34	9	43	0	3	46	0	0
4	8809431	.	T	G	2	19	21	0	1	22	0	0
4	8809506	.	A	T	13	16	29	0	0	29	0	0
4	8809544	.	C	G	22	0	22	0	19	41	0	0
4	8809690	.	G	T	0	12	12	0	0	12	0	0
4	8809695	.	C	T	0	21	21	0	1	22	0	0
4	8809772	.	T	A	1	5	6	1	2	9	0	0
4	8809879	.	T	G	4	3	7	0	1	8	0	0
4	8809985	.	G	T	10	3	13	0	1	14	0	0
4	8810175	.	A	C	15	5	20	0	0	20	0	0
4	8810200	.	G	T	12	10	22	0	0	22	0	0
4	8810367	.	A	C	28	19	47	0	0	47	0	0
4	8810474	.	A	T	13	29	42	0	0	42	0	0
4	8810597	.	A	T	17	23	40	0	3	43	0	0
4	8810607	.	C	T	17	23	40	0	0	40	0	0
4	8850984	.	A	G	3	3	6	0	0	6	0	0
4	8850998	.	G	A	4	3	7	0	0	7	0	0
4	8851503	.	T	A	9	9	18	0	1	19	0	0
4	8851547	.	A	G	13	14	27	0	1	28	0	0
4	8851740	.	G	A	9	10	19	0	0	19	0	0
4	8851864	.	G	A	4	9	13	0	1	14	0	0
4	8851999	.	C	T	10	6	16	0	2	18	0	0
4	8852085	.	G	T	10	6	16	0	0	16	0	0
4	8854403	.	G	T	9	12	21	0	1	22	0	0
4	8882297	.	G	T	2	1	3	0	0	3	0	0
4	8898917	.	C	T	0	15	15	0	18	33	0	0
4	8898939	.	G	A	12	15	27	0	0	28	1	0
4	8903051	.	T	A	0	2	2	0	0	2	0	0
4	9012215	.	T	G	1	0	1	0	2	3	0	0
4	9012218	.	T	C	1	2	3	0	0	3	0	0
4	9012258	.	A	T	3	3	6	0	1	7	0	0
4	9017996	.	C	T	1	2	3	0	0	3	0	0
4	9021369	.	T	C	10	5	15	0	2	17	0	0
4	9024665	.	T	G	10	11	21	0	1	22	0	0
4	9024671	.	A	G	11	10	21	0	0	21	0	0
4	9024720	.	A	C	5	9	14	0	0	14	0	0
4	9024784	.	A	G	14	9	23	0	1	24	0	0
4	9024807	.	A	G	17	10	27	0	1	28	0	0
4	9028868	.	T	C	1	3	4	0	0	4	0	0
4	9038894	.	T	A	0	2	2	0	0	2	0	0
4	9039030	.	G	A	0	0	0	0	1	1	0	0
4	9040604	.	A	G	1	2	3	0	0	3	0	0
4	9043856	.	A	G	1	0	1	0	0	1	0	0
4	9045012	.	T	C	2	1	3	0	0	3	0	0
4	9045979	.	C	T	0	3	3	0	0	3	0	0
4	9048957	.	G	T	1	5	6	0	0	6	0	0
4	9052184	.	A	G	6	4	10	0	0	10	0	0
4	9052192	.	T	A	6	4	10	0	0	10	0	0
4	9052228	.	C	G	0	7	7	0	2	9	0	0
4	9070929	.	T	G	1	0	1	0	0	1	0	0
4	9085337	.	A	G	4	0	4	0	5	9	0	0
4	9094270	.	G	T	4	3	7	0	0	7	0	0
4	9094347	.	G	A	4	3	7	0	0	7	0	0
4	9094666	.	T	G	5	4	9	0	0	9	0	0
4	9094668	.	T	A	5	4	9	0	0	9	0	0
4	9104173	.	G	C	2	5	7	0	1	8	0	0
4	9104510	.	T	C	8	0	8	0	5	13	0	0
4	9105199	.	T	C	4	0	4	0	7	11	0	0
4	9128095	.	T	C	2	0	2	0	1	3	0	0
4	9173425	.	A	G	5	3	8	0	0	8	0	0
4	9180680	.	G	A	11	13	24	0	0	24	0	0
4	9180746	.	T	C	7	10	17	0	0	17	0	0
4	9183115	.	T	A	3	1	4	0	1	5	0	0
4	9183406	.	T	G	1	3	4	0	0	4	0	0
4	9184684	.	A	T	3	3	6	0	0	6	0	0
4	9189969	.	C	T	0	1	1	0	1	2	0	0
4	9192549	.	G	A	6	2	8	0	0	8	0	0
4	9194875	.	C	T	0	2	2	0	1	3	0	0
4	9196113	.	C	T	1	2	3	0	0	3	0	0
4	9196128	.	C	G	0	2	2	0	1	3	0	0
4	9208383	.	A	G	2	3	5	0	1	6	0	0
4	9209366	.	C	T	0	2	2	0	1	3	0	0
4	9210389	.	T	G	1	2	3	0	0	3	0	0
4	9280030	.	C	T	1	2	3	0	2	5	0	0
4	9308332	.	C	T	1	2	3	0	0	3	0	0
4	9308344	.	G	A	0	1	1	0	0	1	0	0
4	9317959	.	T	C	1	3	4	0	0	4	0	0
4	9329819	.	T	A	3	3	6	0	0	6	0	0
4	9329912	.	C	A	2	2	4	0	0	4	0	0
4	9331330	.	G	A	0	10	10	0	7	17	0	0
4	9331495	.	T	G	5	0	5	0	3	8	0	0
4	9333565	.	G	A	0	12	12	0	8	20	0	0
4	9333619	.	G	C	0	1	1	0	6	7	0	0
4	9333620	.	A	C	0	0	0	0	7	7	0	0
4	9333739	.	A	C	8	15	23	0	2	25	0	0
4	9334180	.	G	C	2	5	7	0	7	14	0	0
4	9334196	.	A	G	6	6	12	0	1	13	0	0
4	9334735	.	A	G	10	0	10	0	4	14	0	0
4	9339140	.	G	A	3	3	6	0	0	6	0	0
4	9339202	.	G	A	3	6	9	0	0	9	0	0
4	9339274	.	C	T	4	5	9	0	0	9	0	0
4	9339316	.	C	T	0	5	5	0	4	9	0	0
4	9339637	.	C	T	0	6	6	0	5	11	0	0
4	9339964	.	T	C	3	0	3	0	3	6	0	0
4	9350496	.	G	T	3	4	7	0	0	7	0	0
4	9364317	.	C	T	3	2	5	0	0	5	0	0
4	9367091	.	T	C	0	1	1	0	0	1	0	0
4	9385390	.	A	G	12	0	12	0	9	21	0	0
4	9386108	.	C	T	5	5	10	0	0	10	0	0
4	9429583	.	A	T	2	0	2	0	0	2	0	0
4	9429769	.	G	A	2	2	4	0	0	4	0	0
4	9446126	.	C	G	0	2	2	0	0	2	0	0
4	9447758	.	C	T	3	5	8	0	0	8	0	0
4	9448634	.	G	A	5	4	9	0	0	9	0	0
4	9448643	.	G	T	5	3	8	0	0	8	0	0
4	9460213	.	A	G	7	0	7	0	5	12	0	0
4	9460603	.	A	C	2	2	4	0	0	4	0	0
4	9461548	.	A	G	1	1	2	0	2	4	0	0
4	9461739	.	G	C	1	2	3	0	0	3	0	0
4	9461822	.	C	A	4	5	9	0	0	9	0	0
4	9461839	.	C	A	6	3	9	0	1	10	0	0
4	9462039	.	T	G	5	3	8	0	0	8	0	0
4	9462897	.	A	G	4	0	4	0	4	8	0	0
4	9463634	.	T	G	2	2	4	0	0	4	0	0
4	9463840	.	C	G	4	2	6	0	1	7	0	0
4	9463855	.	T	A	4	4	8	0	0	8	0	0
4	9464057	.	T	A	3	2	5	0	0	5	0	0
4	9464143	.	T	G	5	4	9	0	0	9	0	0
4	9464224	.	T	C	3	3	6	0	0	6	0	0
4	9465637	.	A	G	3	4	7	0	0	7	0	0
4	9465832	.	G	T	6	10	16	0	0	16	0	0
4	9465899	.	C	A	9	8	17	0	0	17	0	0
4	9465900	.	C	A	8	8	16	0	1	17	0	0
4	9466075	.	G	T	4	4	8	0	0	8	0	0
4	9466192	.	C	A	4	3	7	0	0	7	0	0
4	9490315	.	T	A	0	1	1	0	0	1	0	0
4	9496926	.	C	T	2	5	7	0	1	8	0	0
4	9496934	.	G	A	3	4	7	0	0	7	0	0
4	9496969	.	A	T	4	4	8	0	1	9	0	0
4	9496976	.	C	G	4	3	7	0	0	7	0	0
4	9498803	.	C	A	4	2	6	0	0	6	0	0
4	9498886	.	G	C	1	5	6	0	1	7	0	0
4	9498896	.	T	C	1	3	4	0	0	4	0	0
4	9499404	.	G	A	3	2	5	0	1	6	0	0
4	9499448	.	C	A	2	1	3	0	0	3	0	0
4	9500311	.	A	T	2	4	6	0	0	6	0	0
4	9500312	.	G	T	2	2	4	0	2	6	0	0
4	9500370	.	G	A	0	2	2	0	0	2	0	0
4	9502243	.	G	T	13	10	23	0	1	24	0	0
4	9502312	.	T	A	3	7	10	0	0	10	0	0
4	9502347	.	C	G	9	0	9	0	4	13	0	0
4	9502388	.	T	C	6	7	13	0	1	14	0	0
4	9502422	.	G	A	12	6	18	0	2	20	0	0
4	9502440	.	A	G	12	0	12	0	11	23	0	0
4	9502608	.	T	G	6	0	6	0	6	12	0	0
4	9537015	.	A	G	8	7	15	0	0	15	0	0
4	9537025	.	C	T	7	5	12	0	0	12	0	0
4	9539303	.	G	A	5	5	10	0	0	10	0	0
4	9565450	.	C	T	0	7	7	0	2	9	0	0
4	9573368	.	G	A	0	1	1	0	0	1	0	0
4	9579297	.	C	G	1	4	5	0	0	5	0	0
4	9592782	.	A	T	3	1	4	0	0	4	0	0
4	9596614	.	A	G	6	8	14	0	1	15	0	0
4	9597837	.	G	A	0	0	0	0	1	1	0	0
4	9597862	.	G	A	0	1	1	0	0	1	0	0
4	9598642	.	C	T	5	6	11	0	1	12	0	0
4	9598690	.	C	T	4	1	5	0	0	5	0	0
4	9599566	.	G	A	0	1	1	0	1	2	0	0
4	9601174	.	T	C	4	7	11	0	0	11	0	0
4	9601256	.	A	C	1	3	4	0	0	4	0	0
4	9601329	.	C	T	6	4	10	0	4	14	0	0
4	9601401	.	A	T	6	12	18	0	1	19	0	0
4	9601628	.	G	T	1	5	6	0	1	7	0	0
4	9603488	.	T	C	4	2	6	0	0	6	0	0
4	9603505	.	T	C	5	2	7	0	0	7	0	0
4	9603559	.	G	A	1	3	4	1	0	5	0	0
4	9603620	.	A	T	1	0	1	0	1	2	0	0
4	9603791	.	G	A	9	7	16	0	0	16	0	0
4	9603803	.	G	A	9	4	13	0	2	15	0	0
4	9604134	.	G	A	4	7	11	0	0	11	0	0
4	9604294	.	C	T	1	9	10	0	7	17	0	0
4	9604336	.	T	C	6	2	8	0	8	16	0	0
4	9604384	.	A	G	5	4	9	0	0	9	0	0
4	9605221	.	C	T	0	2	2	0	2	4	0	0
4	9605397	.	A	G	0	4	4	0	0	4	0	0
4	9607259	.	A	G	1	1	2	0	1	3	0	0
4	9616190	.	A	G	0	3	3	0	1	4	0	0
4	9618432	.	A	G	0	1	1	0	0	1	0	0
4	9618867	.	A	C	6	3	9	0	0	9	0	0
4	9632179	.	A	G	1	1	2	0	1	3	0	0
4	9632188	.	C	A	2	1	3	0	0	3	0	0
4	9653570	.	A	G	5	8	13	0	0	13	0	0
4	9653574	.	C	A	0	7	7	0	4	11	0	0
4	9653626	.	G	A	1	3	4	0	0	4	0	0
4	9653925	.	T	G	4	6	10	0	0	10	0	0
4	9654020	.	T	A	7	13	20	0	1	21	0	0
4	9654071	.	T	C	5	13	18	0	0	18	0	0
4	9654103	.	A	G	7	10	17	0	0	17	0	0
4	9654114	.	C	T	0	10	10	0	5	15	0	0
4	9654149	.	C	G	3	2	5	0	0	5	0	0
4	9655534	.	T	C	2	0	2	0	2	4	0	0
4	9655807	.	G	A	9	9	18	0	1	19	0	0
4	9659858	.	G	A	1	3	4	0	0	4	0	0
4	9661625	.	T	A	1	0	1	0	0	1	0	0
4	9664900	.	G	A	0	1	1	0	0	1	0	0
4	9669846	.	A	T	7	5	12	0	0	12	0	0
4	9669869	.	C	T	4	4	8	0	0	8	0	0
4	9674206	.	G	A	4	5	9	0	0	9	0	0
4	9675420	.	G	A	0	6	6	0	1	7	0	0
4	9677280	.	G	C	5	2	7	0	0	7	0	0
4	9686153	.	A	G	5	0	5	0	6	11	0	0
4	9688093	.	T	C	6	8	14	0	0	14	0	0
4	9688570	.	C	T	6	8	14	0	0	14	0	0
4	9688636	.	G	A	12	18	30	0	0	30	0	0
4	9689825	.	G	A	1	20	21	0	16	37	0	0
4	9697346	.	A	G	3	2	5	0	0	5	0	0
4	9697599	.	C	A	8	5	13	0	0	13	0	0
4	9697763	.	A	C	1	9	10	0	1	11	0	0
4	9697813	.	C	T	1	5	6	0	0	6	0	0
4	9698023	.	C	T	1	0	1	0	1	2	0	0
4	9724635	.	T	A	8	20	28	0	0	28	0	0
4	9724644	.	C	T	8	18	26	0	0	26	0	0
4	9724718	.	C	A	9	10	19	0	2	21	0	0
4	9724898	.	A	G	11	15	26	0	1	27	0	0
4	9736186	.	A	G	5	4	9	0	0	9	0	0
4	9736211	.	C	T	7	4	11	0	0	11	0	0
4	9737157	.	G	T	10	10	20	0	0	20	0	0
4	9737314	.	A	C	16	0	16	0	14	30	0	0
4	9739228	.	C	A	7	4	11	0	0	11	0	0
4	9740769	.	G	A	9	6	15	0	0	15	0	0
4	9743708	.	G	C	6	4	10	0	1	11	0	0
4	9743762	.	T	G	10	11	21	0	0	22	1	0
4	9743774	.	C	T	8	8	16	0	1	17	0	0
4	9744561	.	A	T	3	2	5	0	1	6	0	0
4	9746515	.	A	G	0	1	1	0	0	1	0	0
4	9746547	.	C	T	3	4	7	0	0	7	0	0
4	9746559	.	C	A	3	5	8	0	0	8	0	0
4	9746604	.	G	A	2	7	9	0	1	10	0	0
4	9747647	.	C	T	5	5	10	0	0	10	0	0
4	9750109	.	G	T	3	2	5	0	0	5	0	0
4	9750154	.	T	G	2	4	6	0	0	7	1	0
4	9751050	.	A	G	5	2	7	0	0	7	0	0
4	9751310	.	T	G	6	3	9	0	0	9	0	0
4	9753200	.	A	G	4	5	9	0	0	9	0	0
4	9755341	.	G	A	6	10	16	0	0	16	0	0
4	9755350	.	G	A	6	9	15	0	0	15	0	0
4	9756488	.	G	T	4	5	9	0	0	9	0	0
4	9758862	.	C	A	0	8	8	0	6	14	0	0
4	9764703	.	G	A	7	4	11	0	0	11	0	0
4	9784331	.	T	A	7	6	13	0	0	13	0	0
4	9784444	.	C	T	5	4	9	0	1	10	0	0
4	9784669	.	G	A	4	7	11	0	1	12	0	0
4	9784678	.	C	T	0	6	6	0	7	13	0	0
4	9784740	.	A	G	9	1	10	0	0	10	0	0
4	9784747	.	T	A	8	3	11	0	0	11	0	0
4	9785412	.	T	C	4	3	7	0	0	7	0	0
4	9785444	.	G	A	3	8	11	0	0	11	0	0
4	9785477	.	G	A	3	6	9	0	0	9	0	0
4	9785900	.	T	A	4	3	7	0	0	7	0	0
4	9786203	.	A	G	6	11	17	0	0	17	0	0
4	9786338	.	T	A	7	13	20	0	0	20	0	0
4	9786466	.	C	G	0	6	6	0	6	12	0	0
4	9786514	.	C	T	2	4	6	0	0	6	0	0
4	9786574	.	T	A	1	1	2	0	0	2	0	0
4	9786617	.	C	A	6	4	10	0	0	10	0	0
4	9786670	.	C	A	6	2	8	0	0	8	0	0
4	9786705	.	A	C	5	3	8	0	0	8	0	0
4	9786855	.	T	C	3	5	8	0	0	8	0	0
4	9786925	.	T	C	2	0	2	0	5	7	0	0
4	9787090	.	T	C	9	3	12	0	0	12	0	0
4	9787130	.	A	G	9	4	13	0	0	13	0	0
4	9787250	.	A	G	3	3	6	0	1	7	0	0
4	9787415	.	G	A	6	10	16	0	1	17	0	0
4	9787516	.	C	T	5	4	9	0	0	9	0	0
4	9787600	.	G	T	13	9	22	0	0	22	0	0
4	9787761	.	A	G	8	10	18	0	0	18	0	0
4	9789478	.	A	G	4	5	9	0	0	9	0	0
4	9790492	.	A	C	4	0	4	0	9	13	0	0
4	9791466	.	A	T	6	2	8	0	1	9	0	0
4	9791493	.	T	C	4	0	4	0	2	6	0	0
4	9792102	.	T	G	4	1	5	0	0	5	0	0
4	9792229	.	G	T	9	5	14	0	0	14	0	0
4	9792726	.	T	G	1	2	3	0	0	3	0	0
4	9792798	.	A	G	5	2	7	0	0	7	0	0
4	9794644	.	C	A	0	7	7	0	6	13	0	0
4	9795288	.	C	T	5	4	9	0	0	9	0	0
4	9795309	.	C	T	5	5	10	0	2	12	0	0
4	9795417	.	T	A	0	1	1	0	2	3	0	0
4	9797312	.	C	T	0	3	3	0	6	9	0	0
4	9798229	.	T	C	1	0	1	0	1	2	0	0
4	9798825	.	C	A	0	5	5	0	7	12	0	0
4	9801626	.	G	A	5	2	7	0	0	7	0	0
4	9801730	.	A	T	6	7	13	0	1	14	0	0
4	9801747	.	G	A	6	7	13	0	0	13	0	0
4	9801935	.	A	G	6	3	9	0	1	10	0	0
4	9802472	.	A	T	4	4	8	0	0	8	0	0
4	9802487	.	C	T	0	5	5	0	3	8	0	0
4	9809733	.	T	G	2	5	7	0	0	7	0	0
4	9813902	.	C	A	2	2	4	0	0	4	0	0
4	9814044	.	C	G	4	4	8	0	1	9	0	0
4	9814880	.	T	G	2	2	4	0	0	4	0	0
4	9817327	.	C	T	1	1	2	0	1	3	0	0
4	9819858	.	A	T	1	4	5	0	0	5	0	0
4	9819944	.	T	C	4	4	8	0	0	8	0	0
4	9822506	.	T	C	1	0	1	0	2	3	0	0
4	9827514	.	C	T	0	1	1	0	0	1	0	0
4	9836583	.	T	A	8	8	16	0	2	18	0	0
4	9837992	.	A	G	3	7	10	0	0	10	0	0
4	9838875	.	T	C	5	11	16	0	1	17	0	0
4	9838932	.	C	T	6	9	15	0	0	15	0	0
4	9838974	.	T	C	6	9	15	0	0	15	0	0
4	9840136	.	T	C	1	2	3	0	0	3	0	0
4	9840242	.	T	C	3	1	4	0	0	4	0	0
4	9840338	.	T	C	7	5	12	0	1	13	0	0
4	9841657	.	G	A	18	13	31	0	0	31	0	0
4	9854313	.	T	C	5	5	10	0	1	11	0	0
4	9854458	.	T	C	1	0	1	0	2	3	0	0
4	9854467	.	C	T	1	2	3	0	0	3	0	0
4	9855482	.	G	A	3	3	6	0	0	6	0	0
4	9858023	.	A	G	1	1	2	0	1	3	0	0
4	9858050	.	C	T	3	3	6	0	0	6	0	0
4	9860188	.	T	G	0	1	1	0	0	1	0	0
4	9865503	.	T	C	1	2	3	0	0	3	0	0
4	9866737	.	G	A	0	1	1	0	0	1	0	0
4	9866911	.	C	T	0	2	2	0	1	3	0	0
4	9867387	.	A	G	1	3	4	0	0	4	0	0
4	9955338	.	A	G	2	0	2	0	4	6	0	0
4	9955350	.	C	T	2	3	5	0	1	6	0	0
4	9957319	.	T	C	3	5	8	0	1	9	0	0
4	9957331	.	C	T	3	6	9	0	0	9	0	0
4	9957367	.	T	C	3	2	5	0	0	5	0	0
4	9962466	.	C	T	2	2	4	0	0	4	0	0
4	9964153	.	T	C	10	3	13	0	0	13	0	0
4	9964161	.	C	G	10	3	13	0	0	13	0	0
4	9964813	.	C	T	3	1	4	0	0	4	0	0
4	9966229	.	C	T	3	2	5	0	0	5	0	0
4	9969261	.	C	T	5	1	6	0	0	6	0	0
4	9969447	.	T	C	4	3	7	0	1	8	0	0
4	9974720	.	C	T	3	1	4	0	1	5	0	0
4	9979792	.	T	C	3	9	12	0	0	12	0	0
4	9980400	.	G	A	1	6	7	0	5	12	0	0
4	9981763	.	C	T	0	1	1	0	0	1	0	0
4	9981838	.	G	A	4	10	14	0	0	14	0	0
4	9982775	.	G	T	0	1	1	0	0	1	0	0
4	9982872	.	A	T	9	4	13	0	0	13	0	0
4	9982883	.	A	G	8	2	10	0	0	10	0	0
4	9983251	.	G	A	2	3	5	0	1	6	0	0
4	9983269	.	C	G	5	5	10	0	1	11	0	0
4	9983347	.	G	T	6	8	14	0	0	14	0	0
4	9983940	.	C	T	9	3	12	0	0	12	0	0
4	9983943	.	T	C	9	3	12	0	0	12	0	0
4	9985320	.	G	C	0	2	2	0	0	3	1	0
4	9986279	.	G	A	11	8	19	0	0	19	0	0
4	9988867	.	C	T	5	0	5	0	0	5	0	0
4	9990796	.	G	A	3	6	9	0	0	9	0	0
4	9993789	.	C	T	5	13	18	0	0	18	0	0
4	9996182	.	T	C	3	5	8	0	0	8	0	0
4	9998553	.	G	A	0	16	16	0	12	28	0	0
4	9998566	.	A	C	11	14	25	0	1	26	0	0
4	9998677	.	A	G	9	8	17	0	0	17	0	0
4	9998986	.	A	T	6	16	22	0	0	22	0	0
4	9998988	.	T	C	6	16	22	0	0	22	0	0
4	9999240	.	C	T	14	15	29	0	2	31	0	0
4	9999367	.	A	G	13	20	33	0	2	35	0	0
4	9999909	.	A	T	7	3	10	0	3	13	0	0
4	10006223	.	A	G	1	1	2	0	0	2	0	0
4	10008902	.	T	C	1	3	4	0	0	4	0	0
4	10008905	.	G	A	1	2	3	0	0	3	0	0
4	10017468	.	A	G	14	20	34	0	1	35	0	0
4	10038009	.	T	C	0	1	1	0	0	1	0	0
4	10040249	.	G	A	0	21	21	0	22	43	0	0
4	10040285	.	A	G	30	3	33	0	17	50	0	0
4	10040297	.	C	T	29	13	42	0	3	45	0	0
4	10124153	.	A	C	1	2	3	0	0	3	0	0
4	10127591	.	C	A	3	2	5	0	0	5	0	0
4	10128875	.	T	C	1	0	1	0	0	1	0	0
4	10130199	.	G	A	0	3	3	0	0	3	0	0
4	10366043	.	G	A	0	4	4	0	2	6	0	0
4	10366045	.	C	T	2	4	6	0	0	6	0	0
4	10366710	.	G	A	7	5	12	0	1	13	0	0
4	10367028	.	A	G	4	6	10	0	0	10	0	0
4	10367349	.	G	A	7	2	9	0	0	9	0	0
4	10367358	.	A	G	6	0	6	0	4	10	0	0
4	10367412	.	A	C	4	5	9	0	0	9	0	0
4	10367562	.	C	T	3	5	8	0	1	9	0	0
4	10367610	.	C	T	3	4	7	0	0	7	0	0
4	10367619	.	C	T	2	4	6	0	0	6	0	0
4	10553528	.	G	A	6	4	10	0	0	10	0	0
4	10558370	.	C	T	4	5	9	0	0	9	0	0
4	10558510	.	T	C	3	2	5	0	0	5	0	0
4	10559042	.	A	T	3	4	7	0	0	7	0	0
4	10559213	.	C	G	5	5	10	0	0	10	0	0
4	10559558	.	A	G	2	0	2	0	4	6	0	0
4	10559621	.	C	A	4	5	9	0	1	10	0	0
4	10560246	.	G	A	8	8	16	0	0	16	0	0
4	10560253	.	A	T	8	7	15	0	1	16	0	0
4	10560284	.	C	T	10	11	21	0	0	21	0	0
4	10560404	.	A	T	13	11	24	0	0	24	0	0
4	10560607	.	A	G	4	3	7	0	0	7	0	0
4	10560916	.	C	T	7	4	11	0	2	13	0	0
4	10561598	.	T	C	9	14	23	0	0	23	0	0
4	10561603	.	G	A	9	12	21	0	0	21	0	0
4	10605409	.	T	C	4	4	8	0	1	9	0	0
4	10605457	.	C	T	3	1	4	0	0	4	0	0
4	10608878	.	G	T	11	8	19	0	0	19	0	0
4	10611014	.	T	A	19	8	27	0	1	28	0	0
4	10615123	.	A	T	13	7	20	0	0	20	0	0
4	10615127	.	G	T	13	9	22	0	0	22	0	0
4	10615175	.	A	G	12	0	12	0	13	25	0	0
4	10697134	.	T	C	1	2	3	0	0	3	0	0
4	10706818	.	T	A	2	3	5	0	0	5	0	0
4	10706835	.	A	C	1	3	4	0	0	4	0	0
4	10709634	.	G	C	2	3	5	0	0	5	0	0
4	10757096	.	A	G	0	1	1	0	0	1	0	0
4	10825618	.	G	A	1	1	2	0	0	2	0	0
4	10835494	.	C	G	2	2	4	0	0	4	0	0
4	10888842	.	G	C	1	4	5	0	3	8	0	0
4	10888890	.	T	A	4	2	6	0	1	7	0	0
4	10888935	.	C	A	4	2	6	0	1	7	0	0
4	10890516	.	G	T	2	2	4	0	1	5	0	0
4	10890822	.	G	A	5	5	10	0	0	10	0	0
4	10896570	.	G	A	8	4	12	0	1	13	0	0
4	10896582	.	G	T	6	3	9	0	2	11	0	0
4	10904784	.	C	T	1	1	2	0	0	2	0	0
4	10905246	.	C	T	6	6	12	0	0	12	0	0
4	10906254	.	C	T	9	9	18	0	1	19	0	0
4	10907054	.	G	A	1	4	5	0	0	5	0	0
4	10907056	.	G	T	1	4	5	0	0	5	0	0
4	10908001	.	C	T	10	17	27	0	0	27	0	0
4	10908294	.	C	T	11	7	18	0	1	19	0	0
4	10908726	.	T	C	8	7	15	0	1	16	0	0
4	10974650	.	C	T	5	9	14	0	0	14	0	0
4	10974722	.	G	A	3	3	6	0	0	6	0	0
4	10974747	.	A	T	4	3	7	0	0	7	0	0
4	10975629	.	A	G	1	1	2	0	0	2	0	0
4	10975632	.	G	A	1	0	1	0	0	1	0	0
4	10976944	.	G	A	3	1	4	0	0	4	0	0
4	10982291	.	C	T	2	0	2	0	0	2	0	0
4	10982339	.	T	G	2	5	7	0	0	7	0	0
4	10982390	.	C	A	0	1	1	0	0	1	0	0
4	10988147	.	A	G	1	3	4	0	0	4	0	0
4	10988546	.	G	C	2	4	6	0	1	7	0	0
4	10988581	.	C	T	0	1	1	0	1	2	0	0
4	10994967	.	A	G	2	2	4	0	0	4	0	0
4	10995138	.	G	A	2	2	4	0	0	4	0	0
4	11024616	.	C	T	0	3	3	0	3	6	0	0
4	11050883	.	T	G	2	1	3	0	0	3	0	0
4	11050893	.	G	A	2	2	4	0	0	4	0	0
4	11053851	.	G	A	0	5	5	0	8	13	0	0
4	11054484	.	A	C	9	6	15	0	0	15	0	0
4	11054509	.	G	C	6	6	12	0	0	12	0	0
4	11186762	.	G	A	0	2	2	0	3	5	0	0
4	11186777	.	C	T	2	5	7	0	0	7	0	0
4	11197863	.	G	A	0	2	2	0	1	3	0	0
4	11197873	.	G	T	1	2	3	0	0	3	0	0
4	11311632	.	T	A	1	2	3	0	0	3	0	0
4	11358626	.	C	T	4	3	7	0	0	7	0	0
4	11366360	.	T	C	6	6	12	0	1	13	0	0
4	11366481	.	G	A	11	7	18	0	3	21	0	0
4	11367668	.	T	A	6	8	14	0	0	14	0	0
4	11367952	.	T	C	7	6	13	0	1	14	0	0
4	11368056	.	A	T	8	12	20	0	2	22	0	0
4	11368076	.	G	T	15	13	28	0	0	28	0	0
4	11368171	.	G	A	1	18	19	0	21	40	0	0
4	11385001	.	T	C	1	5	6	0	0	6	0	0
4	11387131	.	G	T	3	2	5	0	2	7	0	0
4	11387698	.	A	T	3	1	4	0	0	4	0	0
4	11389372	.	G	C	0	5	5	0	4	9	0	0
4	11411640	.	A	C	1	0	1	0	9	10	0	0
4	11414424	.	A	T	3	2	5	0	0	5	0	0
4	11415471	.	G	A	4	6	10	0	0	10	0	0
4	11415483	.	G	A	4	6	10	0	0	10	0	0
4	11415852	.	A	T	0	2	2	0	0	2	0	0
4	11415853	.	G	A	0	2	2	0	0	2	0	0
4	11416701	.	C	T	10	4	14	0	4	18	0	0
4	11416758	.	T	A	12	8	20	0	0	20	0	0
4	11416854	.	G	A	9	11	20	0	0	20	0	0
4	11417753	.	G	T	6	2	8	0	0	8	0	0
4	11417829	.	C	A	5	5	10	0	0	10	0	0
4	11418969	.	C	T	7	7	14	0	0	14	0	0
4	11419062	.	G	A	8	3	11	0	1	12	0	0
4	11419163	.	C	G	3	3	6	0	0	6	0	0
4	11419510	.	C	T	10	7	17	0	0	17	0	0
4	11419656	.	C	T	6	5	11	0	1	12	0	0
4	11419836	.	A	T	12	6	18	0	2	20	0	0
4	11419869	.	T	C	9	6	15	0	1	16	0	0
4	11420005	.	A	T	13	14	27	0	0	27	0	0
4	11421575	.	C	T	11	9	20	0	2	22	0	0
4	11422121	.	C	T	11	10	21	0	0	21	0	0
4	11425839	.	G	T	5	2	7	0	0	7	0	0
4	11439544	.	C	A	3	5	8	0	1	9	0	0
4	11446078	.	A	G	25	15	40	0	0	40	0	0
4	11446365	.	A	T	20	13	33	0	2	35	0	0
4	11446878	.	A	G	14	3	17	0	1	18	0	0
4	11447135	.	T	C	20	18	38	0	0	38	0	0
4	11447144	.	G	A	18	16	34	0	1	35	0	0
4	11447226	.	T	G	11	3	14	0	12	27	1	0
4	11447251	.	T	C	15	12	27	0	1	28	0	0
4	11447719	.	T	G	17	19	36	0	1	37	0	0
4	11448296	.	A	T	9	21	30	0	1	31	0	0
4	11448403	.	G	A	0	23	23	0	21	44	0	0
4	11458318	.	T	G	10	5	15	0	0	15	0	0
4	11461914	.	A	G	0	6	6	0	0	6	0	0
4	11464390	.	A	G	4	7	11	0	0	11	0	0
4	11470854	.	A	G	5	2	7	0	0	7	0	0
4	11471203	.	T	C	10	9	19	0	1	20	0	0
4	11472674	.	T	C	11	10	21	0	1	22	0	0
4	11476472	.	G	A	0	33	33	0	23	56	0	0
4	11476487	.	C	T	20	38	58	0	0	58	0	0
4	11476740	.	C	T	21	28	49	0	0	49	0	0
4	11476868	.	C	G	21	32	53	0	2	55	0	0
4	11476945	.	C	T	32	25	57	0	2	59	0	0
4	11477047	.	T	A	26	30	56	0	3	59	0	0
4	11477377	.	C	T	38	12	50	0	2	52	0	0
4	11477381	.	T	C	41	11	52	0	1	53	0	0
4	11480649	.	T	C	3	2	5	0	2	7	0	0
4	11480824	.	C	A	3	8	11	0	1	12	0	0
4	11480866	.	C	T	3	0	3	0	0	3	0	0
4	11482235	.	G	A	0	6	6	0	2	8	0	0
4	11482259	.	G	A	6	8	14	0	1	15	0	0
4	11482358	.	T	G	0	2	2	0	0	2	0	0
4	11482668	.	T	A	6	14	20	0	1	21	0	0
4	11482830	.	C	T	3	5	8	0	0	8	0	0
4	11484854	.	A	G	2	3	5	0	0	5	0	0
4	11489736	.	C	T	2	1	3	0	0	3	0	0
4	11489758	.	G	A	0	1	1	0	6	7	0	0
4	11574829	.	A	G	1	2	3	0	0	3	0	0
4	11704180	.	C	T	1	2	3	0	0	3	0	0
4	11704195	.	A	G	1	2	3	0	0	3	0	0
4	11712653	.	C	T	2	5	7	0	0	7	0	0
4	11712704	.	G	T	0	3	3	0	3	6	0	0
4	11712794	.	T	C	2	1	3	0	0	3	0	0
4	11713065	.	C	T	3	4	7	0	0	7	0	0
4	11721659	.	T	C	0	3	3	0	0	3	0	0
4	11721731	.	C	T	2	3	5	0	0	5	0	0
4	11726366	.	T	A	1	3	4	0	0	4	0	0
4	11728959	.	G	A	0	3	3	0	3	6	0	0
4	11729719	.	G	A	8	5	13	0	1	14	0	0
4	11730159	.	G	C	2	11	13	0	0	13	0	0
4	11730515	.	C	A	8	4	12	0	0	12	0	0
4	11732213	.	G	A	2	2	4	0	0	4	0	0
4	11732222	.	G	A	3	2	5	0	0	5	0	0
4	11732456	.	G	A	5	2	7	0	0	7	0	0
4	11732589	.	T	C	4	8	12	0	1	13	0	0
4	11732590	.	T	C	4	9	13	0	0	13	0	0
4	11732956	.	A	G	5	6	11	0	0	11	0	0
4	11732975	.	G	A	5	3	8	0	0	8	0	0
4	11733061	.	A	C	2	4	6	0	0	6	0	0
4	11733114	.	A	C	3	0	3	0	2	5	0	0
4	11733201	.	T	A	2	2	4	0	0	4	0	0
4	11733222	.	C	T	2	2	4	0	0	4	0	0
4	11733281	.	G	T	3	2	5	0	0	5	0	0
4	11733286	.	C	T	3	2	5	0	0	5	0	0
4	11733357	.	C	A	5	2	7	0	0	7	0	0
4	11733573	.	G	A	6	5	11	0	0	11	0	0
4	11733726	.	A	C	6	6	12	0	0	12	0	0
4	11733778	.	C	A	1	6	7	0	6	13	0	0
4	11733830	.	G	A	3	5	8	0	0	8	0	0
4	11733909	.	A	T	7	2	9	0	0	9	0	0
4	11734001	.	A	T	4	2	6	0	0	6	0	0
4	11734071	.	T	C	4	3	7	0	0	7	0	0
4	11734072	.	A	C	3	3	6	0	1	7	0	0
4	11734150	.	A	G	4	3	7	0	0	7	0	0
4	11734196	.	A	T	4	3	7	0	0	7	0	0
4	11734490	.	T	C	6	4	10	0	0	10	0	0
4	11734696	.	C	G	2	2	4	0	0	4	0	0
4	11765658	.	T	C	2	2	4	0	0	4	0	0
4	11765871	.	C	T	6	2	8	0	0	8	0	0
4	11804825	.	C	G	6	6	12	0	0	12	0	0
4	11804940	.	G	A	4	10	14	0	1	15	0	0
4	11805423	.	T	C	9	6	15	0	0	15	0	0
4	11806934	.	G	A	5	4	9	0	1	10	0	0
4	11806965	.	G	C	4	4	8	0	0	8	0	0
4	11814022	.	A	G	13	8	21	0	1	22	0	0
4	11814055	.	C	T	1	18	19	0	16	35	0	0
4	11814074	.	T	A	21	22	43	0	0	43	0	0
4	11814429	.	A	T	9	6	15	0	0	15	0	0
4	11814456	.	A	G	5	10	15	0	0	15	0	0
4	11814471	.	G	A	10	5	15	0	0	15	0	0
4	11814494	.	C	T	2	7	9	0	0	9	0	0
4	11814565	.	A	T	4	4	8	0	0	8	0	0
4	11814684	.	C	T	6	6	12	0	0	12	0	0
4	11814723	.	A	C	9	10	19	0	0	19	0	0
4	11815137	.	G	T	15	17	32	0	0	32	0	0
4	11815143	.	C	G	15	16	31	0	0	31	0	0
4	11815324	.	A	C	14	13	27	0	0	27	0	0
4	11815801	.	T	A	11	7	18	0	0	18	0	0
4	11816535	.	T	C	5	0	5	0	4	9	0	0
4	11818347	.	G	A	1	1	2	0	0	2	0	0
4	11818353	.	A	G	3	1	4	0	0	4	0	0
4	11827171	.	C	T	4	3	7	0	0	7	0	0
4	11841949	.	T	A	3	6	9	0	0	9	0	0
4	12006542	.	G	A	4	6	10	0	0	10	0	0
4	12006761	.	C	T	0	6	6	0	8	14	0	0
4	12007149	.	T	A	2	6	8	0	0	8	0	0
4	12013470	.	T	G	12	8	20	0	0	20	0	0
4	12013513	.	A	T	9	11	20	0	2	22	0	0
4	12020936	.	C	T	4	3	7	0	1	8	0	0
4	12021120	.	C	T	3	6	9	0	0	9	0	0
4	12021703	.	C	T	2	4	6	0	0	6	0	0
4	12021748	.	G	T	0	15	15	0	9	24	0	0
4	12022108	.	A	G	16	0	16	0	15	31	0	0
4	12022444	.	T	C	10	17	27	0	0	27	0	0
4	12023445	.	A	C	8	12	20	0	0	20	0	0
4	12025771	.	G	A	3	13	16	0	1	17	0	0
4	12026098	.	G	A	5	5	10	0	0	10	0	0
4	12026286	.	A	T	11	16	27	0	1	28	0	0
4	12026305	.	T	C	14	15	29	0	0	29	0	0
4	12026369	.	G	T	5	13	18	0	0	18	0	0
4	12026429	.	C	A	7	12	19	0	0	19	0	0
4	12026488	.	T	C	1	2	3	0	0	3	0	0
4	12078423	.	T	C	4	0	4	0	2	6	0	0
4	12080673	.	C	T	6	5	11	0	0	11	0	0
4	12080911	.	T	G	7	9	16	0	0	16	0	0
4	12087262	.	G	C	1	0	1	0	2	3	0	0
4	12091037	.	T	C	11	1	12	0	11	23	0	0
4	12103535	.	G	A	4	2	6	0	0	6	0	0
4	12103619	.	T	C	2	0	2	0	3	5	0	0
4	12103840	.	G	T	4	3	7	0	0	7	0	0
4	12103846	.	A	T	3	2	5	0	1	6	0	0
4	12103911	.	A	T	1	6	7	0	0	7	0	0
4	12103964	.	T	A	9	4	13	0	0	13	0	0
4	12106000	.	G	C	5	0	5	0	9	14	0	0
4	12111399	.	G	A	9	3	12	0	0	12	0	0
4	12113128	.	C	T	5	5	10	0	0	10	0	0
4	12230029	.	C	T	5	15	20	0	1	21	0	0
4	12230509	.	C	A	8	10	18	0	0	18	0	0
4	12230510	.	T	C	8	10	18	0	0	18	0	0
4	12230608	.	T	C	6	4	10	0	1	11	0	0
4	12230665	.	C	T	7	5	12	0	0	12	0	0
4	12230698	.	C	T	6	5	11	0	0	11	0	0
4	12230713	.	T	C	5	4	9	0	1	10	0	0
4	12230833	.	G	T	5	1	6	0	0	6	0	0
4	12230851	.	T	C	5	2	7	0	0	7	0	0
4	12230890	.	T	A	1	5	6	0	0	6	0	0
4	12231008	.	G	A	1	12	13	0	6	19	0	0
4	12231131	.	A	C	5	5	10	0	1	11	0	0
4	12231328	.	A	T	10	7	17	0	0	17	0	0
4	12231751	.	A	C	8	8	16	0	0	16	0	0
4	12231789	.	C	A	4	6	10	0	0	10	0	0
4	12232164	.	C	G	11	6	17	0	0	17	0	0
4	12232253	.	G	T	10	7	17	0	1	18	0	0
4	12232254	.	C	T	10	8	18	0	0	18	0	0
4	12232323	.	A	T	16	5	21	0	0	21	0	0
4	12232328	.	A	T	16	5	21	0	0	21	0	0
4	12232480	.	G	T	6	2	8	0	0	8	0	0
4	12232509	.	C	T	6	4	10	0	0	10	0	0
4	12232614	.	A	C	5	8	13	0	1	14	0	0
4	12232644	.	A	T	6	10	16	0	3	19	0	0
4	12232737	.	G	A	4	4	8	0	0	8	0	0
4	12232746	.	T	C	5	3	8	0	1	9	0	0
4	12232958	.	T	C	4	4	8	0	0	8	0	0
4	12232985	.	G	T	6	7	13	0	0	13	0	0
4	12233004	.	A	G	6	0	6	0	10	16	0	0
4	12233125	.	T	A	10	11	21	0	0	21	0	0
4	12233220	.	C	T	5	6	11	0	0	11	0	0
4	12233252	.	A	T	4	8	12	0	0	12	0	0
4	12233363	.	G	T	2	2	4	0	0	4	0	0
4	12233402	.	G	T	3	2	5	0	0	5	0	0
4	12233431	.	C	A	5	3	8	0	0	8	0	0
4	12233450	.	C	A	8	4	12	0	0	12	0	0
4	12233595	.	C	T	3	4	7	2	0	9	0	0
4	12233728	.	G	T	8	4	12	0	1	13	0	0
4	12233908	.	A	C	8	7	15	1	0	16	0	0
4	12234267	.	G	C	5	2	7	0	0	7	0	0
4	12234269	.	T	A	5	2	7	0	0	7	0	0
4	12234398	.	T	G	5	6	11	1	0	12	0	0
4	12234458	.	C	T	3	8	11	0	0	11	0	0
4	12234599	.	A	G	3	5	8	0	0	8	0	0
4	12234670	.	A	G	8	0	8	0	5	13	0	0
4	12234755	.	C	A	7	7	14	0	2	16	0	0
4	12234792	.	A	G	12	8	20	0	0	20	0	0
4	12234828	.	C	T	9	9	18	0	1	19	0	0
4	12234955	.	C	T	11	10	21	0	1	22	0	0
4	12235677	.	T	C	9	5	14	0	0	14	0	0
4	12235722	.	A	G	3	7	10	0	2	12	0	0
4	12235770	.	T	C	7	6	13	0	1	14	0	0
4	12235987	.	T	G	6	4	10	0	0	10	0	0
4	12236171	.	G	A	9	12	21	0	0	21	0	0
4	12236178	.	T	G	8	11	19	0	0	19	0	0
4	12236429	.	T	A	5	8	13	0	1	14	0	0
4	12236584	.	C	T	3	5	8	0	0	8	0	0
4	12236592	.	T	A	2	0	2	0	0	5	3	0
4	12236641	.	A	G	6	5	11	0	0	11	0	0
4	12236667	.	C	A	6	5	11	0	2	13	0	0
4	12237337	.	T	C	1	2	3	0	0	3	0	0
4	12237340	.	G	A	1	2	3	0	0	3	0	0
4	12237490	.	C	A	10	11	21	0	1	22	0	0
4	12237689	.	C	A	13	5	18	0	0	18	0	0
4	12237849	.	C	T	13	18	31	0	0	31	0	0
4	12238161	.	C	T	10	14	24	0	7	31	0	0
4	12238418	.	C	T	22	17	39	0	0	39	0	0
4	12238711	.	G	A	9	12	21	0	0	21	0	0
4	12238904	.	G	A	2	3	5	0	1	6	0	0
4	12238956	.	G	A	26	8	34	0	4	38	0	0
4	12243881	.	T	G	6	10	16	0	2	18	0	0
4	12244071	.	T	C	7	10	17	0	0	17	0	0
4	12244099	.	T	C	11	13	24	0	0	24	0	0
4	12244153	.	T	A	16	7	23	0	0	23	0	0
4	12244258	.	T	C	9	7	16	0	0	16	0	0
4	12244322	.	C	T	11	7	18	0	0	18	0	0
4	12244607	.	C	T	0	6	6	0	4	10	0	0
4	12245058	.	G	A	9	4	13	0	0	13	0	0
4	12245584	.	A	G	9	13	22	0	0	22	0	0
4	12265268	.	T	A	3	6	9	0	1	10	0	0
4	12265337	.	T	C	2	0	2	0	1	3	0	0
4	12270202	.	A	T	1	0	1	0	0	1	0	0
4	12312634	.	T	C	1	2	3	0	0	3	0	0
4	12312865	.	T	C	1	3	4	0	1	5	0	0
4	12312899	.	G	A	2	4	6	0	0	6	0	0
4	12312969	.	T	G	2	0	2	0	3	5	0	0
4	12317636	.	T	G	4	2	6	0	1	7	0	0
4	12317674	.	A	T	2	3	5	0	1	6	0	0
4	12317764	.	G	A	0	3	3	0	3	6	0	0
4	12381781	.	G	A	2	2	4	0	1	5	0	0
4	12381930	.	G	A	11	6	17	0	1	18	0	0
4	12382076	.	A	G	19	12	31	0	2	33	0	0
4	12382234	.	C	T	7	5	12	0	2	14	0	0
4	12382673	.	A	T	8	14	22	0	0	22	0	0
4	12382871	.	G	A	22	10	32	0	0	32	0	0
4	12382889	.	T	G	13	11	24	0	6	30	0	0
4	12382943	.	T	G	13	17	30	0	1	31	0	0
4	12383030	.	C	T	20	13	33	0	0	33	0	0
4	12383081	.	C	T	10	2	12	0	0	12	0	0
4	12384831	.	A	G	16	8	24	0	0	24	0	0
4	12384840	.	G	A	13	6	19	0	0	19	0	0
4	12384873	.	C	G	0	2	2	0	5	7	0	0
4	12388419	.	T	C	13	11	24	0	2	26	0	0
4	12679190	.	C	T	1	2	3	0	0	3	0	0
4	13575296	.	C	T	3	2	5	0	0	5	0	0
4	13575814	.	A	T	9	3	12	0	0	12	0	0
4	13755907	.	A	G	14	7	21	0	1	22	0	0
4	14992426	.	T	C	6	6	12	0	1	13	0	0
4	14992499	.	T	C	11	5	16	0	1	17	0	0
4	16077663	.	G	A	4	4	8	0	7	15	0	0
4	16078531	.	G	A	10	9	19	0	14	33	0	0
4	16315830	.	A	G	0	2	2	0	0	2	0	0
4	16319377	.	C	T	2	6	8	0	0	8	0	0
4	16319839	.	T	A	6	2	8	0	0	8	0	0
4	16320221	.	G	A	0	2	2	0	2	4	0	0
4	16368805	.	T	C	14	0	14	0	17	31	0	0
4	16368977	.	G	A	10	13	23	0	1	24	0	0
4	16369033	.	T	A	13	9	22	0	1	23	0	0
4	16369335	.	T	C	3	0	3	0	15	18	0	0
4	16369375	.	G	C	7	11	18	0	1	19	0	0
4	16369384	.	T	C	7	11	18	0	1	19	0	0
4	16369440	.	C	T	6	9	15	0	1	16	0	0
4	16369486	.	T	C	5	4	9	0	1	10	0	0
4	16380491	.	G	C	1	1	2	0	3	5	0	0
4	16382917	.	A	G	4	6	10	0	0	10	0	0
4	16536356	.	G	A	3	6	9	0	1	10	0	0
4	16536946	.	C	A	17	16	33	0	2	35	0	0
4	16537045	.	T	C	23	17	40	0	2	42	0	0
4	16537099	.	A	T	23	27	50	0	2	52	0	0
4	16537575	.	T	G	25	23	48	0	1	49	0	0
4	16537770	.	G	A	21	24	45	0	1	46	0	0
4	16538055	.	T	A	14	14	28	0	0	28	0	0
4	16539253	.	A	G	19	20	39	0	1	40	0	0
4	16615212	.	A	C	3	0	3	0	2	5	0	0
4	16616024	.	G	A	1	3	4	0	0	4	0	0
4	16632415	.	G	A	3	7	10	0	0	10	0	0
4	16632650	.	A	T	7	6	13	0	0	13	0	0
4	16632762	.	A	T	4	11	15	0	0	15	0	0
4	16633208	.	C	T	8	6	14	0	0	14	0	0
4	16633451	.	T	C	7	3	10	0	0	10	0	0
4	16634916	.	A	G	3	8	11	0	0	11	0	0
4	16634929	.	A	T	4	8	12	0	0	12	0	0
4	16635162	.	G	A	3	8	11	0	0	11	0	0
4	16635208	.	G	A	2	7	9	0	1	10	0	0
4	16635460	.	T	A	3	4	7	0	0	7	0	0
4	16635710	.	T	C	7	4	11	0	0	11	0	0
4	16638015	.	T	C	2	3	5	0	0	5	0	0
4	16638021	.	T	G	1	3	4	0	2	6	0	0
4	16641677	.	T	C	4	5	9	0	1	10	0	0
4	16650057	.	G	A	6	4	10	0	0	10	0	0
4	16650102	.	T	C	1	5	6	0	1	7	0	0
4	16650142	.	A	T	2	6	8	0	0	8	0	0
4	16650433	.	A	C	8	19	27	0	1	28	0	0
4	16650482	.	T	C	13	10	23	0	0	23	0	0
4	16650611	.	T	G	14	16	30	0	0	30	0	0
4	16650618	.	A	G	13	15	28	0	1	29	0	0
4	16650855	.	A	G	10	3	13	0	0	13	0	0
4	16651046	.	G	C	9	7	16	0	0	16	0	0
4	16651121	.	A	G	5	5	10	0	2	12	0	0
4	16651414	.	G	A	6	8	14	0	0	14	0	0
4	16652890	.	A	G	0	2	2	0	1	3	0	0
4	16654337	.	G	C	7	8	15	0	1	16	0	0
4	16654349	.	C	T	0	7	7	0	13	20	0	0
4	16659679	.	G	A	1	3	4	0	1	5	0	0
4	16666267	.	C	T	2	2	4	0	0	4	0	0
4	16671133	.	T	C	9	6	15	0	0	15	0	0
4	16671232	.	C	T	0	4	4	0	1	5	0	0
4	16672481	.	G	T	5	6	11	0	0	11	0	0
4	16672771	.	C	T	8	11	19	0	0	19	0	0
4	16677348	.	T	C	1	6	7	0	0	7	0	0
4	16677354	.	C	G	1	6	7	0	0	7	0	0
4	16680671	.	T	G	6	7	13	0	0	14	1	0
4	16680674	.	T	G	7	8	15	0	0	15	0	0
4	16706865	.	T	C	12	3	15	0	0	16	1	0
4	16713056	.	T	C	1	2	3	0	0	3	0	0
4	16733585	.	G	A	0	4	4	0	0	4	0	0
4	16733984	.	C	T	4	9	13	0	1	14	0	0
4	16736812	.	C	G	3	0	3	0	4	7	0	0
4	16736833	.	A	G	1	0	1	0	0	1	0	0
4	16739122	.	G	A	0	5	5	0	6	11	0	0
4	16741979	.	T	G	10	6	16	0	1	17	0	0
4	16742246	.	A	T	5	2	7	0	0	7	0	0
4	16742444	.	G	C	8	10	18	0	0	18	0	0
4	16784712	.	A	T	4	2	6	0	0	6	0	0
4	16784840	.	G	T	10	9	19	0	2	21	0	0
4	16784876	.	C	T	0	1	1	0	1	2	0	0
4	16785393	.	A	G	17	24	41	0	0	41	0	0
4	16785664	.	A	T	16	16	32	0	0	32	0	0
4	16785960	.	G	A	0	2	2	0	0	2	0	0
4	16785961	.	G	T	0	2	2	0	0	2	0	0
4	16786002	.	C	A	1	5	6	0	1	7	0	0
4	16786018	.	A	T	1	8	9	0	0	9	0	0
4	16786077	.	G	A	0	8	8	0	0	8	0	0
4	16786208	.	C	T	3	13	16	0	0	16	0	0
4	16788485	.	C	T	0	2	2	0	0	2	0	0
4	16788500	.	G	A	0	4	4	0	1	5	0	0
4	16791616	.	G	A	2	3	5	0	0	5	0	0
4	16791673	.	C	A	7	4	11	0	0	11	0	0
4	16791780	.	A	G	9	0	9	0	5	14	0	0
4	16791781	.	G	C	8	5	13	0	1	14	0	0
4	16791883	.	T	A	6	5	11	0	1	12	0	0
4	16791934	.	C	T	4	3	7	0	1	8	0	0
4	16797045	.	A	G	1	0	1	0	0	1	0	0
4	16829355	.	T	C	43	28	71	0	1	72	0	0
4	16829387	.	T	G	39	25	64	0	3	67	0	0
4	16829651	.	G	A	31	29	60	0	8	68	0	0
4	16831399	.	A	T	12	17	29	0	1	30	0	0
4	16832124	.	C	A	2	11	13	0	17	30	0	0
4	16832894	.	G	A	4	10	14	0	0	14	0	0
4	16858074	.	A	T	4	4	8	0	0	8	0	0
4	16858075	.	A	G	4	3	7	0	1	8	0	0
4	16858155	.	G	A	2	3	5	0	0	5	0	0
4	16858289	.	G	C	3	0	3	0	5	8	0	0
4	16858414	.	A	T	1	4	5	0	1	6	0	0
4	16858442	.	C	G	0	2	2	0	2	4	0	0
4	16877387	.	C	T	0	16	16	0	17	33	0	0
4	16879505	.	T	C	8	0	8	0	13	21	0	0
4	16881865	.	T	G	1	2	3	0	1	4	0	0
4	16885898	.	A	T	13	12	25	0	0	25	0	0
4	16889709	.	C	T	3	11	14	0	0	14	0	0
4	16889745	.	G	A	2	5	7	0	0	7	0	0
4	16893050	.	A	G	0	5	5	0	0	5	0	0
4	16893062	.	T	C	3	7	10	0	0	10	0	0
4	16898904	.	A	T	11	9	20	0	0	20	0	0
4	16899273	.	T	C	8	5	13	0	0	13	0	0
4	16904521	.	C	G	24	14	38	0	0	38	0	0
4	16904527	.	A	G	24	0	24	0	15	39	0	0
4	16905090	.	T	C	12	11	23	0	0	23	0	0
4	16905119	.	T	C	7	16	23	0	1	24	0	0
4	16905184	.	T	C	17	12	29	0	1	30	0	0
4	16905224	.	A	G	13	8	21	0	1	22	0	0
4	16905318	.	G	A	15	6	21	0	1	22	0	0
4	16905486	.	A	T	6	2	8	0	0	8	0	0
4	16905511	.	C	T	3	7	10	0	0	10	0	0
4	16905684	.	T	G	10	9	19	0	0	19	0	0
4	16905708	.	T	A	9	8	17	0	0	17	0	0
4	16905723	.	C	A	7	11	18	0	1	19	0	0
4	16905853	.	T	A	9	11	20	0	0	20	0	0
4	16906173	.	C	A	13	18	31	0	0	31	0	0
4	16906198	.	C	A	10	22	32	0	0	32	0	0
4	16906244	.	A	T	13	23	36	0	0	36	0	0
4	16906562	.	G	A	19	14	33	0	2	35	0	0
4	16982269	.	G	A	7	10	17	0	0	17	0	0
4	16982682	.	C	A	14	9	23	0	0	23	0	0
4	16983131	.	A	G	2	6	8	0	0	8	0	0
4	16983434	.	T	C	18	0	18	0	14	32	0	0
4	16984252	.	C	G	8	7	15	0	2	17	0	0
4	16984542	.	A	G	8	9	17	0	0	17	0	0
4	16985045	.	C	T	6	6	12	0	0	12	0	0
4	16988139	.	A	G	15	5	20	0	1	21	0	0
4	17008995	.	A	G	4	2	6	0	0	6	0	0
4	17248712	.	T	C	1	3	4	0	0	4	0	0
4	17253737	.	A	G	3	3	6	0	0	6	0	0
4	17253758	.	C	T	3	4	7	0	0	7	0	0
4	17253813	.	A	C	10	3	13	0	0	13	0	0
4	17253818	.	A	G	10	3	13	0	0	13	0	0
4	17253925	.	T	A	4	14	18	0	0	18	0	0
4	17253927	.	T	A	4	14	18	0	0	18	0	0
4	17254046	.	A	G	13	14	27	0	1	28	0	0
4	17256855	.	C	T	1	1	2	0	0	2	0	0
4	17257386	.	G	A	3	4	7	0	2	9	0	0
4	17257458	.	C	T	3	5	8	0	0	8	0	0
4	17260535	.	G	A	1	0	1	0	0	1	0	0
4	17287446	.	T	G	5	5	10	0	0	10	0	0
4	17288964	.	T	C	12	12	24	0	0	24	0	0
4	17291024	.	A	G	16	16	32	0	0	32	0	0
4	17292575	.	C	A	2	2	4	0	1	5	0	0
4	17292770	.	G	A	9	0	9	0	3	12	0	0
4	17292789	.	A	C	12	7	19	0	1	20	0	0
4	17292837	.	A	G	19	23	42	0	1	43	0	0
4	17294947	.	T	C	1	2	3	0	0	3	0	0
4	17296974	.	A	G	6	9	15	0	1	16	0	0
4	17297086	.	C	A	20	12	32	0	0	32	0	0
4	17297338	.	T	G	6	7	13	0	0	13	0	0
4	17336624	.	C	T	8	5	13	0	0	13	0	0
4	17336693	.	G	A	7	5	12	0	0	12	0	0
4	17338664	.	T	C	1	4	5	0	0	5	0	0
4	17353770	.	G	C	1	2	3	0	0	3	0	0
4	17353776	.	A	C	1	2	3	0	0	3	0	0
4	17354747	.	G	C	2	4	6	0	0	6	0	0
4	17369451	.	T	C	1	4	5	0	0	5	0	0
4	17380828	.	C	A	6	2	8	0	0	8	0	0
4	17382878	.	G	A	1	2	3	0	0	3	0	0
4	17384624	.	A	T	1	3	4	0	0	4	0	0
4	17417668	.	T	G	6	1	7	0	5	12	0	0
4	17417692	.	C	T	3	4	7	0	0	7	0	0
4	17418109	.	G	A	2	6	8	0	1	9	0	0
4	17524604	.	T	A	0	1	1	0	0	1	0	0
4	17530763	.	C	T	1	2	3	0	0	3	0	0
4	17536140	.	T	G	4	3	7	0	0	7	0	0
4	17537639	.	A	G	12	5	17	0	3	20	0	0
4	17537939	.	G	T	0	4	4	0	6	10	0	0
4	17539157	.	G	A	4	3	7	0	0	7	0	0
4	17539261	.	T	G	1	2	3	0	1	4	0	0
4	17541730	.	G	A	1	1	2	0	0	2	0	0
4	17572583	.	C	T	9	10	19	0	3	22	0	0
4	17572589	.	C	A	8	10	18	0	1	19	0	0
4	17572898	.	T	C	10	12	22	1	0	23	0	0
4	17572901	.	A	C	10	13	23	1	0	24	0	0
4	17573071	.	A	T	10	8	18	0	0	18	0	0
4	17573081	.	G	C	11	6	17	0	2	19	0	0
4	17573464	.	A	G	3	12	15	0	1	16	0	0
4	17573465	.	A	G	3	12	15	0	1	16	0	0
4	17573594	.	T	A	8	7	15	0	0	15	0	0
4	17573616	.	A	G	8	4	12	0	0	12	0	0
4	17573697	.	G	A	5	5	10	0	1	11	0	0
4	17573706	.	A	G	7	6	13	0	0	13	0	0
4	17573802	.	T	C	13	12	25	0	1	26	0	0
4	17573841	.	A	G	14	13	27	0	2	29	0	0
4	17573865	.	T	A	11	19	30	0	3	33	0	0
4	17573959	.	T	A	9	7	16	0	1	17	0	0
4	17573982	.	A	T	5	9	14	0	2	16	0	0
4	17574093	.	A	G	18	9	27	0	0	27	0	0
4	17574175	.	G	C	9	8	17	0	0	17	0	0
4	17574390	.	C	T	12	8	20	0	0	20	0	0
4	17574608	.	A	C	15	8	23	0	0	23	0	0
4	17574706	.	T	C	4	9	13	0	0	13	0	0
4	17577307	.	C	A	1	1	2	0	0	2	0	0
4	17580468	.	A	T	0	4	4	0	0	4	0	0
4	17596433	.	T	C	13	0	13	0	12	25	0	0
4	17596490	.	T	C	5	3	8	0	1	9	0	0
4	17629138	.	C	T	0	10	10	0	8	18	0	0
4	17629266	.	C	A	10	5	15	0	0	15	0	0
4	17636416	.	C	T	2	2	4	0	0	4	0	0
4	17642813	.	G	T	1	2	3	0	0	3	0	0
4	17643252	.	A	G	0	1	1	0	0	1	0	0
4	17643448	.	T	C	1	0	1	0	0	1	0	0
4	17644600	.	T	C	5	5	10	0	1	11	0	0
4	17644913	.	A	G	3	2	5	0	0	5	0	0
4	17645408	.	T	C	3	1	4	0	0	4	0	0
4	17645890	.	A	C	3	0	3	0	0	3	0	0
4	17645962	.	C	T	2	4	6	0	0	6	0	0
4	17657549	.	A	G	5	1	6	0	6	12	0	0
4	17660723	.	C	T	6	4	10	0	0	10	0	0
4	17660732	.	A	G	6	4	10	0	0	10	0	0
4	17660859	.	G	A	5	2	7	0	0	7	0	0
4	17660871	.	A	G	4	3	7	0	1	8	0	0
4	17661102	.	T	G	5	3	8	0	0	8	0	0
4	17661349	.	C	T	4	3	7	0	0	7	0	0
4	17661354	.	T	G	4	3	7	0	0	7	0	0
4	17684535	.	A	T	0	2	2	0	0	2	0	0
4	17686494	.	T	C	1	3	4	0	0	4	0	0
4	17686515	.	G	C	3	4	7	0	0	7	0	0
4	17688726	.	G	A	1	1	2	0	0	2	0	0
4	17688795	.	T	C	4	5	9	0	0	9	0	0
4	17688849	.	T	C	8	7	15	0	0	15	0	0
4	17688874	.	T	C	8	6	14	0	0	14	0	0
4	17688897	.	C	T	8	4	12	0	1	13	0	0
4	17689377	.	A	G	2	3	5	0	0	5	0	0
4	17689395	.	C	T	2	3	5	0	0	5	0	0
4	17689464	.	C	A	1	3	4	0	0	4	0	0
4	17689476	.	A	G	1	0	1	0	2	3	0	0
4	17689551	.	G	A	1	4	5	0	0	5	0	0
4	17689561	.	T	C	1	4	5	0	0	5	0	0
4	17693223	.	C	T	2	3	5	0	1	6	0	0
4	17693232	.	C	T	2	3	5	0	2	7	0	0
4	17693286	.	T	C	3	3	6	0	1	7	0	0
4	17693400	.	A	G	3	0	3	0	0	3	0	0
4	17696254	.	G	A	0	0	0	0	1	1	0	0
4	17696341	.	A	G	4	0	4	0	4	8	0	0
4	17704067	.	G	A	1	1	2	0	0	2	0	0
4	17704123	.	T	C	4	4	8	0	1	9	0	0
4	17704345	.	C	T	2	3	5	0	0	5	0	0
4	17704393	.	A	T	6	4	10	0	0	10	0	0
4	17704560	.	A	G	2	4	6	0	0	6	0	0
4	17704885	.	T	C	2	4	6	0	0	6	0	0
4	17704915	.	A	T	2	5	7	0	0	7	0	0
4	17704928	.	T	A	2	1	3	0	0	3	0	0
4	17707739	.	A	G	3	2	5	0	1	6	0	0
4	17708230	.	T	C	6	10	16	0	0	16	0	0
4	17708346	.	G	A	3	3	6	0	0	6	0	0
4	17712719	.	A	G	0	1	1	0	0	1	0	0
4	17734967	.	A	G	1	2	3	0	0	3	0	0
4	17821696	.	A	G	2	2	4	0	0	4	0	0
4	17822279	.	G	A	1	1	2	0	0	2	0	0
4	17849010	.	C	T	1	0	1	0	0	1	0	0
4	17849578	.	T	C	0	2	2	0	0	2	0	0
4	17851366	.	T	C	2	2	4	0	0	4	0	0
4	17853738	.	T	C	1	2	3	0	0	3	0	0
4	17873530	.	T	G	4	4	8	0	0	8	0	0
4	17873711	.	A	T	2	2	4	0	0	4	0	0
4	17873743	.	C	T	3	2	5	0	0	5	0	0
4	17873787	.	G	A	1	3	4	0	5	9	0	0
4	17873808	.	G	C	5	4	9	0	0	9	0	0
4	17886974	.	G	A	18	14	32	0	2	34	0	0
4	17887059	.	T	C	11	3	14	0	0	14	0	0
4	17887388	.	A	T	11	15	26	0	0	26	0	0
4	17902098	.	A	G	19	12	31	0	3	34	0	0
4	17904325	.	A	C	13	0	13	0	9	22	0	0
4	17915070	.	G	A	3	6	9	0	1	10	0	0
4	17949261	.	C	T	9	17	26	0	3	29	0	0
4	17999156	.	G	A	3	3	6	0	0	6	0	0
4	17999310	.	C	A	6	9	15	0	0	15	0	0
4	17999412	.	G	T	2	3	5	0	0	5	0	0
4	18067311	.	C	T	2	5	7	0	0	7	0	0
4	18067324	.	G	T	2	2	4	0	0	4	0	0
4	18098108	.	C	T	0	2	2	0	0	2	0	0
4	18119557	.	G	C	3	2	5	0	0	5	0	0
4	18208068	.	A	G	10	6	16	0	0	16	0	0
4	18208347	.	C	G	6	4	10	0	1	11	0	0
4	18208557	.	C	A	1	3	4	0	0	4	0	0
4	18208569	.	T	C	1	3	4	0	0	4	0	0
4	18208939	.	C	T	3	3	6	0	1	7	0	0
4	18209107	.	G	C	5	3	8	1	0	9	0	0
4	18209181	.	A	T	2	3	5	0	2	7	0	0
4	18209305	.	T	A	9	3	12	0	2	14	0	0
4	18213267	.	C	T	7	4	11	0	0	11	0	0
4	18216182	.	A	G	2	2	4	0	0	4	0	0
4	18216251	.	T	C	9	3	12	0	0	12	0	0
4	18216332	.	A	G	13	4	17	0	0	17	0	0
4	18235106	.	T	C	4	5	9	0	0	9	0	0
4	18235397	.	A	T	5	2	7	0	0	7	0	0
4	18237355	.	A	G	2	2	4	0	0	4	0	0
4	18240356	.	A	G	5	3	8	0	0	8	0	0
4	18240451	.	G	A	4	5	9	0	0	9	0	0
4	18240536	.	G	T	5	3	8	0	0	8	0	0
4	18240546	.	C	T	0	2	2	0	6	8	0	0
4	18240640	.	C	G	3	3	6	0	0	6	0	0
4	18240658	.	T	C	1	3	4	0	0	4	0	0
4	18240690	.	A	T	1	3	4	0	0	4	0	0
4	18240811	.	G	A	2	4	6	0	0	6	0	0
4	18240822	.	G	A	1	3	4	0	0	4	0	0
4	18241255	.	C	G	4	3	7	0	2	9	0	0
4	18242936	.	G	T	6	3	9	0	0	9	0	0
4	18244632	.	T	A	1	1	2	0	0	2	0	0
4	18244669	.	G	A	0	2	2	0	1	3	0	0
4	18244670	.	G	C	1	0	1	0	2	3	0	0
4	18249120	.	G	C	3	2	5	0	1	6	0	0
4	18249414	.	T	C	1	3	4	0	1	5	0	0
4	18249423	.	G	T	0	3	3	0	2	5	0	0
4	18251171	.	T	G	1	3	4	0	0	4	0	0
4	18283222	.	A	G	1	0	1	0	0	1	0	0
4	18287049	.	G	C	1	0	1	0	0	1	0	0
4	18287739	.	T	G	0	1	1	0	0	1	0	0
4	18287744	.	A	G	0	1	1	0	0	1	0	0
4	18301293	.	C	A	0	5	5	0	2	7	0	0
4	18301353	.	T	C	0	2	2	0	0	2	0	0
4	18416371	.	C	G	5	4	9	0	0	9	0	0
4	18454352	.	A	G	7	7	14	0	0	14	0	0
4	18454363	.	T	A	6	6	12	0	1	13	0	0
4	18454400	.	C	T	0	3	3	0	7	10	0	0
4	18454423	.	G	A	5	2	7	0	0	7	0	0
4	18502437	.	A	G	2	1	3	0	0	3	0	0
4	18502494	.	C	T	4	2	6	0	2	8	0	0
4	18503393	.	G	C	1	2	3	0	0	3	0	0
4	18509231	.	A	G	1	1	2	0	0	2	0	0
4	18510478	.	C	T	0	1	1	0	0	1	0	0
4	18510675	.	C	T	0	1	1	0	1	2	0	0
4	18592863	.	A	C	2	6	8	0	0	8	0	0
4	18593839	.	G	A	16	4	20	0	0	20	0	0
4	18594019	.	G	T	8	5	13	0	2	15	0	0
4	18594045	.	T	C	9	4	13	0	0	13	0	0
4	18594125	.	T	A	11	5	16	0	0	16	0	0
4	18594871	.	T	C	4	2	6	0	0	6	0	0
4	18594920	.	G	A	10	4	14	0	0	14	0	0
4	18597683	.	C	G	3	3	6	0	1	7	0	0
4	18597841	.	C	G	16	16	32	0	0	32	0	0
4	18606501	.	G	T	3	7	10	0	0	10	0	0
4	18606512	.	C	T	3	8	11	0	1	12	0	0
4	18609613	.	T	G	6	3	9	0	0	9	0	0
4	18609759	.	C	G	2	4	6	0	0	6	0	0
4	18609769	.	A	G	2	3	5	0	0	5	0	0
4	18609812	.	A	C	2	3	5	0	0	5	0	0
4	18609855	.	G	C	3	3	6	0	0	6	0	0
4	18614208	.	C	T	3	4	7	0	0	7	0	0
4	18614232	.	A	G	3	4	7	0	0	7	0	0
4	18614367	.	A	G	4	2	6	0	1	7	0	0
4	18623708	.	A	G	4	2	6	0	0	6	0	0
4	18709714	.	T	C	1	1	2	0	2	4	0	0
4	18713577	.	A	C	1	2	3	0	1	4	0	0
4	18713937	.	T	C	2	3	5	0	0	5	0	0
4	18720871	.	C	T	9	3	12	0	0	12	0	0
4	18720942	.	C	T	4	9	13	0	0	13	0	0
4	18720947	.	G	T	5	10	15	0	0	15	0	0
4	18734609	.	T	C	2	0	2	0	0	2	0	0
4	18734613	.	G	A	2	0	2	0	0	2	0	0
4	18737966	.	T	G	2	1	3	0	0	3	0	0
4	18738057	.	A	G	1	3	4	0	0	4	0	0
4	18738072	.	T	C	1	1	2	0	0	2	0	0
4	18741886	.	T	C	3	3	6	0	0	6	0	0
4	18837160	.	T	G	2	0	2	0	4	6	0	0
4	18837166	.	T	G	1	1	2	0	4	6	0	0
4	18837898	.	A	T	5	13	18	0	1	19	0	0
4	18850630	.	A	G	1	2	3	0	0	3	0	0
4	18851035	.	T	C	2	3	5	0	0	5	0	0
4	18853153	.	C	T	2	4	6	0	0	6	0	0
4	18853972	.	C	G	11	9	20	0	0	20	0	0
4	18854250	.	A	C	14	0	14	0	21	35	0	0
4	18854433	.	A	G	8	4	12	0	0	12	0	0
4	18939328	.	A	G	0	1	1	0	0	1	0	0
4	18963897	.	G	A	1	10	11	0	8	19	0	0
4	18963908	.	C	A	8	8	16	0	0	16	0	0
4	18963960	.	G	C	6	5	11	0	0	11	0	0
4	18976182	.	A	G	2	5	7	0	0	7	0	0
4	18976574	.	C	T	1	1	2	0	0	2	0	0
4	18979820	.	T	A	4	5	9	0	0	9	0	0
4	18985807	.	T	A	13	18	31	0	1	32	0	0
4	18985846	.	A	G	16	17	33	0	2	35	0	0
4	18985995	.	G	A	9	10	19	0	1	20	0	0
4	18986107	.	C	T	8	3	11	0	0	11	0	0
4	18986293	.	T	G	10	2	12	0	1	13	0	0
4	18986413	.	G	A	5	9	14	0	0	14	0	0
4	18986497	.	C	T	0	12	12	0	12	24	0	0
4	18986771	.	A	T	7	5	12	0	0	12	0	0
4	18986805	.	G	T	7	9	16	0	0	16	0	0
4	18986893	.	C	G	2	6	8	0	2	10	0	0
4	18986897	.	T	A	4	6	10	0	1	11	0	0
4	18987202	.	C	A	5	3	8	0	0	8	0	0
4	18987216	.	T	C	1	6	7	0	1	8	0	0
4	18987250	.	G	A	7	8	15	0	0	15	0	0
4	18987275	.	A	G	6	6	12	0	0	12	0	0
4	18987391	.	G	A	6	4	10	0	1	12	1	0
4	18987523	.	T	C	10	4	14	0	1	15	0	0
4	18987835	.	G	C	16	0	16	0	12	28	0	0
4	18988068	.	T	C	4	0	4	0	8	12	0	0
4	18988084	.	G	A	5	9	14	0	0	14	0	0
4	18988150	.	T	G	8	10	18	0	1	19	0	0
4	18988222	.	A	G	7	8	15	0	1	16	0	0
4	18988270	.	T	A	7	4	11	0	0	11	0	0
4	18988426	.	G	C	4	5	9	0	0	9	0	0
4	18988912	.	G	A	5	6	11	0	0	11	0	0
4	18989185	.	T	C	4	0	4	0	12	16	0	0
4	18999680	.	C	T	0	5	5	0	6	11	0	0
4	19007158	.	C	T	0	3	3	0	2	5	0	0
4	19007377	.	T	A	7	5	12	0	0	12	0	0
4	19007486	.	A	C	6	10	16	0	0	16	0	0
4	19007601	.	A	T	7	11	18	0	1	19	0	0
4	19007811	.	T	C	8	5	13	0	2	15	0	0
4	19007823	.	A	G	7	7	14	0	1	15	0	0
4	19008090	.	C	T	0	4	4	0	4	8	0	0
4	19397641	.	A	T	17	5	22	0	4	26	0	0
4	19414905	.	G	A	2	3	5	0	0	5	0	0
4	19493773	.	G	T	8	6	14	0	0	14	0	0
4	19493808	.	G	A	9	8	17	0	0	17	0	0
4	19535841	.	T	G	8	18	26	0	4	30	0	0
4	19536422	.	T	C	10	18	28	0	1	29	0	0
4	19536917	.	C	T	16	18	34	0	2	36	0	0
4	19537703	.	A	G	14	27	41	0	2	43	0	0
4	19537937	.	A	G	29	0	29	0	27	56	0	0
4	19539017	.	C	T	6	8	14	0	0	14	0	0
4	19567605	.	A	G	12	6	18	0	0	18	0	0
4	19611694	.	G	A	2	7	9	0	0	9	0	0
4	19611739	.	T	G	2	8	10	0	1	11	0	0
4	19630280	.	A	G	1	2	3	0	0	3	0	0
4	19651917	.	G	A	1	1	2	0	0	2	0	0
4	19690484	.	C	A	0	1	1	0	0	1	0	0
4	19777959	.	T	G	0	2	2	0	1	3	0	0
4	19777962	.	A	G	0	2	2	0	1	3	0	0
4	19947781	.	G	T	3	2	5	0	0	5	0	0
4	19948131	.	G	A	5	3	8	0	0	8	0	0
4	19948312	.	A	G	4	5	9	0	1	10	0	0
4	19948313	.	A	G	3	7	10	0	0	10	0	0
4	19948602	.	C	A	1	2	3	0	0	3	0	0
4	19948746	.	T	C	1	3	4	0	0	4	0	0
4	19949148	.	T	C	4	3	7	0	2	9	0	0
4	19949178	.	A	T	5	3	8	0	0	8	0	0
4	19949651	.	C	T	0	3	3	0	3	6	0	0
4	19949730	.	T	C	4	6	10	0	0	10	0	0
4	19949956	.	T	C	7	0	7	0	3	10	0	0
4	19950212	.	A	C	2	3	5	0	0	5	0	0
4	19954907	.	G	C	3	0	3	0	3	6	0	0
4	19955375	.	G	A	1	0	1	0	0	1	0	0
4	19962685	.	G	A	1	2	3	0	0	3	0	0
4	19962707	.	C	T	1	2	3	0	0	3	0	0
4	19962725	.	T	C	1	0	1	0	2	3	0	0
4	20049543	.	C	T	33	23	56	0	0	56	0	0
4	20051021	.	A	G	21	30	51	0	2	53	0	0
4	20051092	.	C	T	0	15	15	0	21	36	0	0
4	20053199	.	T	C	14	10	24	0	0	24	0	0
4	20053211	.	A	G	11	10	21	0	0	21	0	0
4	20053901	.	C	T	17	9	26	0	2	28	0	0
4	20054036	.	C	T	19	13	32	0	1	33	0	0
4	20054135	.	A	G	10	8	18	0	0	18	0	0
4	20054190	.	T	G	3	4	7	0	0	7	0	0
4	20054243	.	A	G	4	4	8	0	0	8	0	0
4	20054516	.	C	T	4	4	8	0	0	8	0	0
4	20060589	.	A	G	1	1	2	0	2	4	0	0
4	20066194	.	T	G	2	3	5	0	1	6	0	0
4	20066208	.	G	A	3	2	5	0	3	8	0	0
4	20066263	.	T	C	4	3	7	0	0	7	0	0
4	20068149	.	T	G	2	7	9	0	0	9	0	0
4	20068185	.	A	G	3	6	9	0	2	11	0	0
4	20068266	.	A	G	3	2	5	0	1	6	0	0
4	20068446	.	G	A	9	8	17	0	0	17	0	0
4	20068470	.	C	G	7	5	12	0	0	13	1	0
4	20068717	.	G	A	2	5	7	0	1	8	0	0
4	20068890	.	G	A	7	4	11	0	3	14	0	0
4	20068903	.	T	C	4	5	9	0	1	10	0	0
4	20069091	.	T	C	9	5	14	0	0	14	0	0
4	20069343	.	C	A	6	10	16	0	0	16	0	0
4	20071344	.	A	T	3	2	5	0	2	7	0	0
4	20071401	.	G	T	5	6	11	0	0	11	0	0
4	20071905	.	A	G	4	2	6	0	0	6	0	0
4	20072035	.	T	C	6	2	8	0	0	8	0	0
4	20072084	.	G	C	1	3	4	0	0	4	0	0
4	20072094	.	C	T	1	2	3	0	1	4	0	0
4	20072394	.	C	G	8	11	19	0	0	19	0	0
4	20072429	.	T	G	7	12	19	0	0	19	0	0
4	20073790	.	T	C	1	2	3	0	0	3	0	0
4	20073799	.	A	G	1	2	3	0	0	3	0	0
4	20080778	.	T	A	0	1	1	0	0	1	0	0
4	20081451	.	A	G	1	6	7	0	0	7	0	0
4	20085183	.	A	G	3	3	6	0	1	7	0	0
4	20089075	.	C	A	2	2	4	0	0	4	0	0
4	20091055	.	G	C	0	4	4	0	6	10	0	0
4	20098793	.	C	G	5	3	8	0	0	8	0	0
4	20099022	.	G	A	1	3	4	0	0	4	0	0
4	20099261	.	C	T	5	2	7	0	0	7	0	0
4	20099516	.	G	A	0	3	3	0	4	7	0	0
4	20099564	.	C	T	2	2	4	0	0	4	0	0
4	20101105	.	G	T	7	9	16	0	0	16	0	0
4	20102901	.	C	A	3	2	5	0	0	5	0	0
4	20103813	.	T	A	0	1	1	0	0	1	0	0
4	20103864	.	G	A	0	1	1	0	0	1	0	0
4	20103873	.	T	C	0	1	1	0	0	1	0	0
4	20105455	.	T	A	2	2	4	0	0	4	0	0
4	20125767	.	A	G	3	2	5	0	0	5	0	0
4	20129813	.	C	T	1	2	3	0	0	3	0	0
4	20129822	.	C	T	1	3	4	0	0	4	0	0
4	20130015	.	G	T	2	1	3	0	0	3	0	0
4	20130216	.	T	C	1	2	3	0	0	3	0	0
4	20133945	.	G	C	0	1	1	0	0	1	0	0
4	20135088	.	A	C	3	0	3	0	2	5	0	0
4	20150138	.	G	T	3	3	6	0	0	6	0	0
4	20226677	.	A	G	1	1	2	0	0	2	0	0
4	20226826	.	T	C	1	1	2	0	0	2	0	0
4	20226916	.	A	C	2	2	4	0	0	4	0	0
4	20229626	.	C	T	1	7	8	0	0	8	0	0
4	20229920	.	C	A	0	11	11	0	11	22	0	0
4	20230213	.	G	A	2	8	10	0	0	10	0	0
4	20235766	.	G	A	8	8	16	0	1	17	0	0
4	20265275	.	A	T	0	2	2	0	0	2	0	0
4	20265309	.	C	T	5	4	9	0	0	9	0	0
4	20303545	.	T	C	2	2	4	0	0	4	0	0
4	20303604	.	T	C	1	1	2	0	0	2	0	0
4	20305777	.	T	G	6	2	8	0	0	8	0	0
4	20305985	.	A	C	3	5	8	0	0	8	0	0
4	20305991	.	G	C	3	4	7	0	0	7	0	0
4	20306278	.	T	C	0	2	2	0	0	2	0	0
4	20306333	.	G	A	0	1	1	0	0	1	0	0
4	20376139	.	G	A	0	1	1	0	0	1	0	0
4	20447754	.	A	G	2	4	6	0	1	7	0	0
4	20453583	.	A	C	4	5	9	0	1	10	0	0
4	20453824	.	A	G	1	1	2	0	0	2	0	0
4	20464937	.	C	T	2	1	3	0	0	3	0	0
4	20465711	.	T	C	1	4	5	0	0	5	0	0
4	20465899	.	C	T	5	1	6	0	0	6	0	0
4	20467610	.	T	C	1	2	3	0	0	3	0	0
4	20470061	.	G	A	4	7	11	0	0	11	0	0
4	20470205	.	C	T	13	6	19	0	0	19	0	0
4	20470316	.	C	T	7	2	9	0	0	9	0	0
4	20473032	.	G	A	12	7	19	0	1	20	0	0
4	20473127	.	G	A	0	9	9	0	9	18	0	0
4	20473142	.	C	T	8	9	17	0	0	17	0	0
4	20473175	.	C	T	11	13	24	0	0	24	0	0
4	20474728	.	A	T	3	4	7	0	3	10	0	0
4	20474969	.	A	G	4	2	6	0	11	17	0	0
4	20480734	.	G	A	2	4	6	0	0	6	0	0
4	20482150	.	T	C	4	3	7	0	0	7	0	0
4	20482425	.	A	G	13	5	18	0	0	18	0	0
4	20482506	.	C	T	7	9	16	0	0	16	0	0
4	20482615	.	G	T	5	2	7	0	1	9	1	0
4	20482726	.	A	G	9	5	14	0	0	14	0	0
4	20483785	.	G	A	2	2	4	0	0	4	0	0
4	20483846	.	T	G	3	3	6	0	1	7	0	0
4	20483881	.	C	T	2	5	7	0	0	7	0	0
4	20483901	.	G	A	2	6	8	0	1	9	0	0
4	20483918	.	A	G	4	5	9	0	0	9	0	0
4	20486087	.	T	A	1	3	4	0	0	4	0	0
4	20496653	.	A	G	2	2	4	0	0	4	0	0
4	20496655	.	C	T	2	2	4	0	0	4	0	0
4	20499421	.	G	C	2	5	7	0	0	7	0	0
4	20499440	.	A	G	3	6	9	0	0	9	0	0
4	20499493	.	T	G	2	5	7	0	0	7	0	0
4	20499516	.	G	T	2	6	8	0	0	8	0	0
4	20499557	.	G	A	3	4	7	0	0	7	0	0
4	20507121	.	T	A	4	12	16	0	3	19	0	0
4	20507155	.	A	C	8	15	23	0	1	24	0	0
4	20507546	.	T	A	2	5	7	0	0	7	0	0
4	20508691	.	G	A	0	1	1	0	0	1	0	0
4	20508913	.	A	G	10	10	20	0	1	21	0	0
4	20508928	.	A	G	11	9	20	0	1	21	0	0
4	20508992	.	C	T	13	14	27	0	0	27	0	0
4	20930170	.	C	T	1	2	3	0	0	3	0	0
4	20949623	.	G	C	2	2	4	0	0	4	0	0
4	20950073	.	C	T	1	4	5	0	0	5	0	0
4	20950816	.	T	C	2	2	4	0	0	4	0	0
4	20950990	.	A	C	2	2	4	0	0	4	0	0
4	20951080	.	C	T	2	2	4	0	0	4	0	0
4	20951390	.	C	T	5	5	10	0	2	12	0	0
4	20952934	.	A	G	2	0	2	0	5	7	0	0
4	20953265	.	C	A	3	4	7	0	0	7	0	0
4	20955052	.	T	C	3	2	5	0	0	5	0	0
4	20959176	.	T	C	0	1	1	0	0	1	0	0
4	20965483	.	T	C	1	1	2	0	0	2	0	0
4	20971490	.	C	T	1	3	4	0	0	4	0	0
4	20974250	.	C	T	5	3	8	0	1	9	0	0
4	20974343	.	C	A	4	1	5	0	0	5	0	0
4	20976062	.	A	T	0	2	2	0	0	2	0	0
4	20976085	.	G	A	0	0	0	0	1	1	0	0
4	20976371	.	C	T	1	0	1	0	0	1	0	0
4	20979435	.	C	A	5	4	9	0	1	10	0	0
4	20980875	.	G	T	0	1	1	0	0	1	0	0
4	20980971	.	A	G	2	2	4	0	0	4	0	0
4	20981198	.	G	A	0	10	10	0	5	15	0	0
4	20981273	.	A	C	2	1	3	0	0	3	0	0
4	21290798	.	G	A	10	22	32	0	2	34	0	0
4	21295949	.	T	C	18	12	30	0	5	35	0	0
4	21297417	.	A	C	10	20	30	0	4	34	0	0
4	21312642	.	T	C	27	19	46	0	6	52	0	0
4	21312981	.	C	T	20	30	50	0	7	57	0	0
4	21313120	.	A	G	27	1	28	0	29	57	0	0
4	21313136	.	T	C	31	21	52	0	5	57	0	0
4	21313779	.	T	G	32	16	48	0	3	52	1	0
4	21313805	.	G	A	0	26	26	0	36	62	0	0
4	21314120	.	T	C	19	21	40	0	0	40	0	0
4	21314204	.	G	T	21	12	33	0	2	35	0	0
4	21314338	.	G	T	23	32	55	0	1	56	0	0
4	21314583	.	T	C	24	26	50	0	0	50	0	0
4	21323174	.	T	A	4	5	9	0	0	9	0	0
4	21323215	.	T	C	2	0	2	0	5	7	0	0
4	21323216	.	T	G	4	3	7	0	0	7	0	0
4	21323339	.	T	C	4	3	7	0	0	7	0	0
4	21323363	.	G	C	2	6	8	0	0	8	0	0
4	21323454	.	A	G	4	4	8	0	0	8	0	0
4	21323467	.	G	C	3	3	6	0	0	6	0	0
4	21489550	.	A	G	5	2	7	0	3	10	0	0
4	21489629	.	G	T	12	9	21	0	0	21	0	0
4	21490320	.	T	C	14	10	24	0	1	25	0	0
4	21490344	.	A	G	18	7	25	0	1	26	0	0
4	21499521	.	G	A	5	4	9	0	1	10	0	0
4	21507026	.	G	A	5	2	7	0	0	7	0	0
4	21508353	.	C	T	7	6	13	0	0	13	0	0
4	21512191	.	C	T	6	8	14	0	0	14	0	0
4	21517970	.	A	G	2	3	5	0	0	5	0	0
4	21523541	.	A	T	5	7	12	0	2	14	0	0
4	21523789	.	T	G	3	7	10	0	1	11	0	0
4	21525430	.	G	T	2	0	2	0	0	2	0	0
4	21526300	.	A	G	1	1	2	0	0	2	0	0
4	21649505	.	G	A	8	19	27	0	4	31	0	0
4	21651486	.	G	A	16	18	34	0	2	36	0	0
4	21752284	.	G	A	13	5	18	0	0	18	0	0
4	21752291	.	C	T	15	8	23	0	0	23	0	0
4	21752688	.	G	C	12	0	12	0	10	22	0	0
4	21752736	.	T	C	12	9	21	0	0	21	0	0
4	21752941	.	T	A	5	9	14	0	2	16	0	0
4	21752969	.	C	T	8	10	18	0	1	19	0	0
4	21752984	.	C	A	7	12	19	0	0	19	0	0
4	21753139	.	C	T	10	11	21	0	0	21	0	0
4	21753185	.	T	C	14	16	30	0	1	31	0	0
4	21753316	.	T	C	14	11	25	0	3	28	0	0
4	21753344	.	G	A	13	12	25	0	2	27	0	0
4	21761688	.	A	T	7	13	20	0	0	20	0	0
4	22756239	.	T	C	12	12	24	0	0	24	0	0
4	25703048	.	G	A	1	1	2	0	0	2	0	0
4	26304907	.	T	A	11	4	15	0	2	17	0	0
4	26304910	.	T	A	11	2	13	0	4	17	0	0
4	26762518	.	G	T	4	2	6	0	0	6	0	0
4	26762524	.	G	T	7	3	10	0	1	11	0	0
4	27112663	.	T	A	2	3	5	0	0	5	0	0
4	28062972	.	T	C	4	1	5	0	4	9	0	0
4	28847555	.	A	C	0	1	1	0	0	1	0	0
4	28851996	.	G	A	0	6	6	0	0	6	0	0
4	30354216	.	A	T	2	2	4	0	0	4	0	0
4	31303132	.	C	T	1	2	3	1	0	4	0	0
4	55587518	.	T	C	1	0	1	0	1	2	0	0
4	70846240	.	G	A	0	1	1	0	0	1	0	0
4	70851202	.	T	C	2	0	2	0	7	9	0	0
4	70855931	.	T	C	4	0	4	0	4	8	0	0
4	70855939	.	C	T	0	3	3	0	6	9	0	0
4	70860034	.	A	C	1	0	1	0	0	1	0	0
4	70860166	.	A	G	3	6	9	0	1	10	0	0
4	70864441	.	C	G	0	1	1	0	0	1	0	0
4	70864466	.	G	A	0	4	4	0	0	4	0	0
4	72064369	.	G	A	6	2	8	0	0	8	0	0
4	73064345	.	A	G	1	0	1	0	1	2	0	0
4	73064492	.	A	G	2	3	5	0	0	5	0	0
4	73336664	.	T	C	5	3	8	0	1	9	0	0
4	73336700	.	T	C	1	7	8	0	0	8	0	0
4	73336711	.	T	C	2	0	2	0	4	6	0	0
4	73758354	.	T	C	2	0	2	0	2	4	0	0
4	73758392	.	T	C	2	0	2	0	1	3	0	0
4	73758411	.	T	C	1	0	1	0	4	5	0	0
4	73898661	.	A	G	1	3	4	0	0	4	0	0
4	73899184	.	A	G	2	0	2	0	3	5	0	0
4	73899191	.	A	G	1	4	5	0	0	5	0	0
4	74204776	.	C	T	0	4	4	0	0	4	0	0
4	74556185	.	A	G	2	0	2	0	3	5	0	0
4	74556212	.	A	G	5	2	7	0	0	7	0	0
4	74875802	.	A	G	0	2	2	0	0	2	0	0
4	74891617	.	A	T	1	3	4	0	0	4	0	0
4	74891619	.	C	G	1	3	4	0	0	4	0	0
4	74929459	.	A	T	1	1	2	0	0	2	0	0
4	74943202	.	A	T	3	12	15	0	1	16	0	0
4	74952477	.	G	A	9	13	22	0	4	26	0	0
4	74952525	.	A	G	14	1	15	0	18	33	0	0
4	74952660	.	G	T	1	9	10	0	13	23	0	0
4	74960826	.	C	T	10	17	27	0	1	28	0	0
4	74961011	.	C	T	7	6	13	0	4	17	0	0
4	74961075	.	G	A	10	10	20	0	1	21	0	0
4	74961520	.	T	A	5	6	11	0	0	11	0	0
4	74975016	.	C	T	1	1	2	0	0	2	0	0
4	75138707	.	G	A	3	7	10	0	1	11	0	0
4	75138750	.	A	G	1	8	9	0	0	9	0	0
4	75138987	.	C	T	6	8	14	0	1	15	0	0
4	75139002	.	A	T	5	3	8	0	0	8	0	0
4	75139194	.	C	T	12	8	20	0	0	20	0	0
4	75139264	.	T	C	12	9	21	0	2	23	0	0
4	75142269	.	G	A	8	5	13	0	0	13	0	0
4	75149056	.	C	T	12	11	23	0	1	25	1	0
4	75149071	.	T	A	10	13	23	0	1	24	0	0
4	75149125	.	C	A	0	5	5	0	2	7	0	0
4	75149149	.	C	T	0	2	2	0	0	2	0	0
4	75150806	.	T	G	11	4	15	0	1	16	0	0
4	75153925	.	C	T	1	1	2	0	0	2	0	0
4	75153930	.	G	A	1	0	1	0	0	1	0	0
4	75157424	.	C	T	3	3	6	0	0	6	0	0
4	75157445	.	G	T	3	2	5	0	0	5	0	0
4	75251782	.	A	C	3	4	7	0	0	7	0	0
4	75270438	.	G	C	6	5	11	0	1	12	0	0
4	75293460	.	T	C	1	2	3	0	0	3	0	0
4	75392271	.	C	T	0	2	2	0	0	2	0	0
4	75416605	.	C	T	4	3	7	0	0	7	0	0
4	75416760	.	G	A	0	2	2	0	2	4	0	0
4	75417250	.	T	G	5	1	6	0	0	6	0	0
4	75417258	.	T	A	5	2	7	0	0	7	0	0
4	75417441	.	C	T	2	5	7	0	1	8	0	0
4	75417608	.	C	A	2	4	6	0	1	7	0	0
4	75417916	.	C	A	3	5	8	0	0	8	0	0
4	75417925	.	G	A	4	2	6	0	0	6	0	0
4	75419127	.	A	T	7	3	10	0	0	10	0	0
4	75419163	.	C	A	5	3	8	0	0	8	0	0
4	75419342	.	A	T	5	2	7	0	0	7	0	0
4	75419353	.	C	T	4	3	7	0	0	7	0	0
4	75419528	.	G	C	0	2	2	0	1	3	0	0
4	75419551	.	G	C	1	3	4	0	0	4	0	0
4	75419653	.	G	A	10	7	17	0	1	18	0	0
4	75419819	.	C	G	2	6	8	0	0	8	0	0
4	75419822	.	A	C	2	7	9	0	0	9	0	0
4	75419916	.	G	T	10	5	15	0	0	15	0	0
4	75419928	.	T	G	9	0	9	0	5	14	0	0
4	75419961	.	A	C	14	6	20	0	0	20	0	0
4	75419970	.	G	A	0	5	5	0	15	20	0	0
4	75420086	.	C	T	12	3	15	0	1	16	0	0
4	75420107	.	A	G	10	3	13	0	1	14	0	0
4	75420270	.	A	G	4	4	8	0	0	8	0	0
4	75420318	.	T	A	7	4	11	0	0	11	0	0
4	75420873	.	A	C	1	5	6	0	0	6	0	0
4	75420931	.	A	T	2	3	5	0	0	5	0	0
4	75420934	.	A	G	2	2	4	0	1	5	0	0
4	76305380	.	A	G	2	2	4	0	0	4	0	0
4	76320752	.	G	A	5	1	6	0	0	6	0	0
4	76320798	.	C	G	1	2	3	0	0	3	0	0
4	76322771	.	T	C	6	4	10	0	2	12	0	0
4	76336468	.	T	A	4	2	6	0	0	6	0	0
4	76336471	.	A	C	1	3	4	0	1	5	0	0
4	76344109	.	C	A	5	4	9	0	0	9	0	0
4	76344120	.	C	A	5	4	9	0	0	9	0	0
4	76345689	.	C	T	5	3	8	0	0	8	0	0
4	76345923	.	A	G	1	0	1	0	4	5	0	0
4	76346188	.	T	A	4	6	10	0	0	10	0	0
4	76346554	.	A	G	2	1	3	0	2	5	0	0
4	76353485	.	C	G	0	2	2	0	0	2	0	0
4	76359636	.	C	T	0	3	3	0	0	3	0	0
4	76360086	.	A	G	2	5	7	0	0	7	0	0
4	76360446	.	T	C	3	3	6	0	0	6	0	0
4	76361041	.	G	A	1	4	5	0	1	6	0	0
4	76361300	.	G	T	1	2	3	0	0	3	0	0
4	76361303	.	T	G	1	2	3	0	0	3	0	0
4	76361624	.	T	A	3	4	7	0	0	7	0	0
4	76361627	.	G	A	0	3	3	0	4	7	0	0
4	76363096	.	G	A	1	5	6	0	0	6	0	0
4	76363541	.	A	G	0	3	3	1	0	4	0	0
4	76363553	.	T	C	0	3	3	0	0	3	0	0
4	76378409	.	C	T	2	4	6	0	0	6	0	0
4	76408988	.	G	A	1	7	8	0	0	8	0	0
4	76409300	.	A	G	5	2	7	0	0	7	0	0
4	76409375	.	A	T	6	2	8	0	0	8	0	0
4	76409385	.	C	G	5	3	8	0	1	9	0	0
4	76410551	.	A	G	2	5	7	0	0	7	0	0
4	76411005	.	A	G	1	3	4	0	0	4	0	0
4	76411757	.	A	T	1	6	7	0	0	7	0	0
4	76411759	.	A	T	1	6	7	0	0	7	0	0
4	76411990	.	A	G	4	0	4	0	6	10	0	0
4	76412061	.	A	G	6	3	9	0	0	9	0	0
4	76412697	.	A	G	2	2	4	0	0	4	0	0
4	76416857	.	G	T	1	1	2	0	0	2	0	0
4	76420800	.	A	G	0	1	1	0	0	1	0	0
4	76420809	.	A	G	1	1	2	0	0	2	0	0
4	76420841	.	G	T	1	2	3	0	0	3	0	0
4	76420875	.	C	T	3	2	5	0	0	5	0	0
4	76420883	.	G	A	2	2	4	0	1	5	0	0
4	76420930	.	T	A	1	5	6	0	0	6	0	0
4	76421739	.	T	C	3	3	6	0	0	6	0	0
4	76421886	.	C	T	3	5	8	0	0	8	0	0
4	76422231	.	G	A	0	4	4	0	7	11	0	0
4	76423537	.	C	T	3	2	5	0	0	5	0	0
4	76429102	.	A	G	0	1	1	0	0	1	0	0
4	76429202	.	A	C	1	5	6	0	0	6	0	0
4	76429223	.	G	T	4	1	5	0	0	5	0	0
4	76429237	.	G	T	4	1	5	0	0	5	0	0
4	76429545	.	C	A	2	2	4	0	1	5	0	0
4	76429584	.	A	G	1	3	4	0	0	4	0	0
4	76429969	.	G	A	1	6	7	0	0	7	0	0
4	76430256	.	G	A	4	2	6	0	0	6	0	0
4	76430257	.	A	G	4	2	6	0	0	6	0	0
4	76430388	.	C	G	1	2	3	0	0	3	0	0
4	76430404	.	A	G	1	2	3	0	0	3	0	0
4	76436823	.	T	G	1	2	3	0	0	3	0	0
4	76439149	.	C	T	1	3	4	0	0	4	0	0
4	76439339	.	C	A	2	2	4	0	0	4	0	0
4	76439374	.	C	T	1	2	3	0	0	3	0	0
4	76439534	.	A	G	1	0	1	0	2	3	0	0
4	76462729	.	G	A	2	2	4	0	0	4	0	0
4	76463517	.	G	A	2	3	5	0	0	5	0	0
4	76464282	.	C	A	1	2	3	0	0	3	0	0
4	76464286	.	C	T	2	1	3	0	0	3	0	0
4	76466770	.	G	C	0	1	1	0	0	1	0	0
4	76473500	.	T	C	1	2	3	0	0	3	0	0
4	76473696	.	T	A	2	2	4	0	0	4	0	0
4	76474493	.	C	T	4	2	6	0	1	7	0	0
4	76474498	.	C	T	4	3	7	0	0	7	0	0
4	76474584	.	A	T	1	2	3	0	0	3	0	0
4	76480573	.	T	C	1	2	3	0	1	4	0	0
4	76481087	.	C	A	0	1	1	0	3	4	0	0
4	76481103	.	T	C	3	2	5	0	0	5	0	0
4	76481168	.	C	G	4	3	7	0	0	7	0	0
4	76481177	.	T	C	4	0	4	0	3	7	0	0
4	76481262	.	A	G	6	2	8	0	0	8	0	0
4	76481403	.	T	A	7	6	13	0	1	14	0	0
4	76481409	.	T	G	7	5	12	0	0	12	0	0
4	76481511	.	A	G	7	5	12	0	0	12	0	0
4	76481572	.	G	A	2	7	9	0	0	9	0	0
4	76481576	.	C	A	2	6	8	0	1	9	0	0
4	76482245	.	C	T	1	3	4	0	0	4	0	0
4	76482696	.	T	A	2	3	5	0	0	5	0	0
4	76484531	.	T	C	1	1	2	0	0	2	0	0
4	76484688	.	C	T	0	1	1	0	0	1	0	0
4	76488244	.	A	T	1	0	1	0	0	1	0	0
4	76488269	.	G	T	1	0	1	0	0	1	0	0
4	76488514	.	T	A	5	3	8	0	0	8	0	0
4	76488521	.	G	A	4	1	5	0	2	7	0	0
4	76488624	.	A	G	2	2	4	0	0	4	0	0
4	76488742	.	G	C	2	4	6	0	0	6	0	0
4	76581336	.	G	A	0	3	3	0	6	9	0	0
4	76581351	.	A	G	6	0	6	0	3	9	0	0
4	76582649	.	C	T	4	1	5	0	0	5	0	0
4	76582655	.	T	C	4	1	5	0	0	5	0	0
4	76582696	.	G	A	0	1	1	0	2	3	0	0
4	76587462	.	T	C	6	6	12	0	0	12	0	0
4	76587474	.	C	T	5	6	11	0	0	11	0	0
4	76588133	.	A	C	5	7	12	0	6	18	0	0
4	76588134	.	C	G	10	0	10	0	8	18	0	0
4	76588177	.	T	C	10	5	15	0	2	17	0	0
4	76749312	.	A	G	3	2	5	0	0	5	0	0
4	76839217	.	A	G	3	0	3	0	1	4	0	0
4	76839227	.	G	A	0	2	2	0	3	5	0	0
4	76839306	.	C	T	3	4	7	0	0	7	0	0
4	76839534	.	G	C	3	1	4	0	0	4	0	0
4	76867394	.	A	T	14	4	18	0	1	19	0	0
4	76867829	.	C	G	11	4	15	0	0	15	0	0
4	76961053	.	G	T	3	1	4	0	0	4	0	0
4	77050459	.	T	C	0	3	3	0	0	3	0	0
4	77050777	.	A	G	2	0	2	0	3	5	0	0
4	77051047	.	C	T	1	2	3	0	0	3	0	0
4	77051086	.	C	T	3	2	5	0	0	5	0	0
4	77051273	.	A	G	1	2	3	0	0	3	0	0
4	77052192	.	T	G	2	0	2	0	1	3	0	0
4	77052213	.	C	T	1	0	1	0	0	1	0	0
4	77052677	.	A	G	3	1	4	0	3	7	0	0
4	77053602	.	C	T	1	1	2	0	1	3	0	0
4	77057152	.	C	A	1	2	3	0	0	3	0	0
4	77057243	.	G	C	2	2	4	0	0	4	0	0
4	77057635	.	C	T	2	4	6	0	0	6	0	0
4	77057671	.	G	A	3	4	7	0	0	7	0	0
4	77057695	.	C	G	4	0	4	0	2	6	0	0
4	77058024	.	G	A	2	7	9	0	0	9	0	0
4	77058097	.	T	C	1	3	4	0	0	4	0	0
4	77058108	.	A	G	1	3	4	0	0	4	0	0
4	77058503	.	G	C	4	5	9	0	0	9	0	0
4	77058543	.	G	A	0	3	3	0	1	4	0	0
4	77058723	.	A	G	3	4	7	0	0	7	0	0
4	77058754	.	T	C	4	2	6	0	0	6	0	0
4	77058875	.	T	A	1	3	4	0	1	5	0	0
4	77059969	.	C	T	2	3	5	0	1	6	0	0
4	77060002	.	A	G	3	3	6	0	1	7	0	0
4	77064908	.	C	G	2	3	5	0	0	5	0	0
4	77065152	.	G	A	2	2	4	1	0	5	0	0
4	77065304	.	A	T	2	2	4	0	0	4	0	0
4	77065342	.	A	T	2	2	4	0	0	4	0	0
4	77065472	.	G	A	0	4	4	0	3	7	0	0
4	77100775	.	G	T	0	2	2	0	2	4	0	0
4	77100890	.	C	T	1	3	4	0	0	4	0	0
4	77100937	.	C	G	2	2	4	0	0	4	0	0
4	77147285	.	T	C	1	2	3	0	0	3	0	0
4	77147706	.	G	C	1	3	4	0	0	4	0	0
4	77148225	.	G	T	2	2	4	0	0	4	0	0
4	77148248	.	T	C	1	1	2	0	0	2	0	0
4	77148561	.	A	G	1	0	1	0	3	4	0	0
4	77149888	.	C	T	4	3	7	0	0	7	0	0
4	77149963	.	C	T	3	2	5	0	0	5	0	0
4	77158574	.	G	C	2	2	4	0	1	5	0	0
4	77158575	.	A	G	3	0	3	0	2	5	0	0
4	77207726	.	G	A	1	2	3	0	0	3	0	0
4	77207728	.	T	A	1	2	3	0	0	3	0	0
4	77207768	.	G	C	4	5	9	0	0	9	0	0
4	77207903	.	C	T	0	2	2	0	1	3	0	0
4	77209054	.	A	G	6	8	14	0	3	17	0	0
4	77211866	.	G	A	2	2	4	0	0	4	0	0
4	77211872	.	G	A	2	3	5	0	0	5	0	0
4	77212126	.	G	T	8	7	15	0	1	16	0	0
4	77214843	.	C	A	0	5	5	0	0	5	0	0
4	77214846	.	G	A	0	5	5	0	0	5	0	0
4	77216563	.	C	A	9	12	21	0	0	21	0	0
4	77219843	.	G	A	2	4	6	0	0	6	0	0
4	77221718	.	A	G	1	2	3	0	0	3	0	0
4	77221775	.	G	A	1	2	3	0	0	3	0	0
4	77222573	.	T	C	4	3	7	0	0	7	0	0
4	77222714	.	C	A	1	3	4	0	1	5	0	0
4	77222939	.	C	G	0	3	3	0	3	6	0	0
4	77229916	.	T	C	1	2	3	0	0	3	0	0
4	77230839	.	T	A	2	2	4	0	0	4	0	0
4	77250931	.	T	C	5	2	7	0	1	8	0	0
4	77349372	.	A	G	1	3	4	0	0	4	0	0
4	77349374	.	G	A	1	3	4	0	0	4	0	0
4	77349501	.	G	A	2	5	7	0	1	8	0	0
4	77357903	.	T	A	0	2	2	0	0	2	0	0
4	77389776	.	A	C	5	2	7	0	0	7	0	0
4	77389832	.	G	C	5	4	9	0	0	9	0	0
4	77389877	.	C	T	5	9	14	0	0	14	0	0
4	77389929	.	G	C	15	4	19	0	0	19	0	0
4	77389932	.	C	A	15	3	18	0	1	19	0	0
4	77390006	.	G	A	15	9	24	0	1	25	0	0
4	77390083	.	A	T	6	11	17	0	1	18	0	0
4	77390164	.	G	T	7	7	14	0	0	14	0	0
4	77390174	.	C	T	6	7	13	0	1	14	0	0
4	77390254	.	T	G	4	5	9	0	1	10	0	0
4	77390288	.	A	C	6	7	13	0	0	13	0	0
4	77390314	.	A	G	8	9	17	0	0	17	0	0
4	77390347	.	G	C	12	12	24	0	0	24	0	0
4	77390400	.	G	A	10	4	14	0	1	15	0	0
4	77400439	.	G	T	2	2	4	0	0	4	0	0
4	77402102	.	C	T	0	3	3	0	3	6	0	0
4	77402123	.	A	G	0	1	1	0	0	1	0	0
4	77402753	.	A	G	1	3	4	0	0	4	0	0
4	77928565	.	T	C	4	6	10	0	0	10	0	0
4	77931408	.	G	A	0	2	2	0	0	2	0	0
4	77932143	.	C	T	5	7	12	0	1	13	0	0
4	77932186	.	T	C	11	15	26	0	2	28	0	0
4	77932198	.	A	G	13	10	23	0	2	25	0	0
4	77932221	.	A	G	7	11	18	0	4	22	0	0
4	77932408	.	G	C	9	7	16	0	0	16	0	0
4	77932414	.	T	C	9	6	15	0	0	15	0	0
4	77945088	.	A	G	2	2	4	0	0	4	0	0
4	77945109	.	G	A	1	2	3	0	0	3	0	0
4	77948591	.	G	A	4	2	6	0	0	6	0	0
4	77953610	.	A	G	1	0	1	0	4	5	0	0
4	77953718	.	T	C	1	3	4	0	0	4	0	0
4	77953777	.	G	A	1	2	3	0	0	3	0	0
4	77953786	.	C	T	1	2	3	0	0	3	0	0
4	77963819	.	C	T	3	2	5	0	0	5	0	0
4	77964574	.	C	A	6	3	9	0	0	9	0	0
4	77964609	.	G	A	0	2	2	0	6	8	0	0
4	77967545	.	C	T	0	4	4	0	0	4	0	0
4	77971836	.	G	C	1	3	4	0	0	4	0	0
4	77971981	.	C	G	1	3	4	0	0	4	0	0
4	77971988	.	C	T	1	3	4	0	0	4	0	0
4	77973929	.	G	A	0	2	2	0	1	3	0	0
4	77975714	.	A	G	2	4	6	0	0	6	0	0
4	77975822	.	G	C	1	3	4	0	0	4	0	0
4	77975870	.	C	G	2	2	4	0	0	4	0	0
4	77976600	.	A	G	1	2	3	0	0	3	0	0
4	77993148	.	T	A	2	4	6	0	0	6	0	0
4	77993210	.	G	A	2	3	5	0	0	5	0	0
4	77993813	.	T	C	5	3	8	0	0	8	0	0
4	77993916	.	G	A	8	10	18	0	3	21	0	0
4	77995476	.	T	C	5	3	8	0	2	10	0	0
4	77995990	.	C	G	3	4	7	0	0	7	0	0
4	77996032	.	C	A	1	1	2	0	0	2	0	0
4	77996171	.	C	T	1	1	2	0	0	2	0	0
4	77996751	.	T	G	5	0	5	0	2	7	0	0
4	77996780	.	C	A	5	2	7	0	0	7	0	0
4	78022570	.	A	G	3	2	5	0	0	5	0	0
4	78024247	.	A	G	15	10	25	0	1	26	0	0
4	78024558	.	C	T	0	8	8	0	8	16	0	0
4	78025040	.	C	T	8	9	17	0	1	18	0	0
4	78025052	.	T	G	8	8	16	0	0	16	0	0
4	78025223	.	C	T	0	12	12	0	14	26	0	0
5	32110	.	C	T	4	3	7	0	1	8	0	0
5	32121	.	A	T	3	3	6	0	0	6	0	0
5	43375	.	G	T	4	3	7	0	0	7	0	0
5	318077	.	G	A	1	0	1	0	0	1	0	0
5	318125	.	C	T	1	0	1	0	0	1	0	0
5	320383	.	T	C	3	0	3	0	1	4	0	0
5	340614	.	A	G	4	0	4	0	0	4	0	0
5	340667	.	T	C	7	6	13	0	2	15	0	0
5	341288	.	T	C	13	7	20	0	0	20	0	0
5	341331	.	C	T	13	6	19	0	1	20	0	0
5	341740	.	A	C	16	7	23	0	3	26	0	0
5	341828	.	T	A	0	6	6	0	2	8	0	0
5	342082	.	A	G	14	0	14	0	9	23	0	0
5	342180	.	A	G	6	4	10	0	0	10	0	0
5	393858	.	G	A	5	8	13	0	0	13	0	0
5	393979	.	T	C	5	4	9	0	0	9	0	0
5	394181	.	G	A	10	20	30	0	0	30	0	0
5	394184	.	T	C	10	22	32	0	0	32	0	0
5	394238	.	A	G	8	17	25	0	0	25	0	0
5	394239	.	T	G	8	16	24	0	1	25	0	0
5	394360	.	C	G	8	8	16	0	0	16	0	0
5	394417	.	G	A	0	10	10	0	13	23	0	0
5	394484	.	A	G	2	1	3	0	13	16	0	0
5	395404	.	T	A	7	6	13	0	0	13	0	0
5	395405	.	T	C	7	6	13	0	0	13	0	0
5	416808	.	T	C	6	0	6	0	7	13	0	0
5	440032	.	A	G	4	0	4	0	8	12	0	0
5	440033	.	A	C	5	7	12	0	0	12	0	0
5	440106	.	T	C	4	2	6	0	0	6	0	0
5	457736	.	C	G	5	5	10	0	0	10	0	0
5	491982	.	T	C	2	1	3	0	0	3	0	0
5	894613	.	C	T	0	1	1	0	0	1	0	0
5	895581	.	T	C	1	0	1	0	0	1	0	0
5	896908	.	C	A	9	8	17	0	0	17	0	0
5	899952	.	C	T	2	5	7	0	0	7	0	0
5	905263	.	C	A	10	3	13	0	0	13	0	0
5	917336	.	C	T	3	3	6	0	0	6	0	0
5	1055103	.	C	T	0	1	1	0	0	1	0	0
5	1059697	.	T	C	1	1	2	0	0	2	0	0
5	1068116	.	T	A	10	5	15	0	1	16	0	0
5	1073609	.	G	A	1	2	3	0	0	3	0	0
5	1079480	.	C	T	16	13	29	0	0	29	0	0
5	1079558	.	G	T	4	2	6	0	0	6	0	0
5	1083203	.	G	C	4	4	8	0	1	9	0	0
5	1083237	.	T	A	2	2	4	0	0	4	0	0
5	1083242	.	T	C	1	2	3	0	0	3	0	0
5	1083679	.	G	A	0	4	4	0	5	9	0	0
5	1083894	.	T	G	8	0	8	0	5	13	0	0
5	1152013	.	G	C	2	2	4	0	1	5	0	0
5	1155594	.	G	A	1	3	4	0	0	4	0	0
5	1187950	.	G	A	0	1	1	0	0	1	0	0
5	1205869	.	C	G	1	2	3	0	0	3	0	0
5	1207835	.	C	T	4	4	8	0	0	8	0	0
5	1216494	.	A	G	2	6	8	0	2	10	0	0
5	1216536	.	C	T	0	7	7	0	6	13	0	0
5	1216575	.	G	A	4	2	6	0	0	6	0	0
5	1218781	.	G	A	3	4	7	0	0	7	0	0
5	1219263	.	C	T	21	13	34	0	0	34	0	0
5	1219318	.	C	A	17	7	24	0	0	24	0	0
5	1219342	.	G	T	15	7	22	0	1	23	0	0
5	1219381	.	G	A	9	4	13	0	0	13	0	0
5	1223368	.	A	T	14	12	26	0	0	26	0	0
5	1223369	.	C	T	14	12	26	0	0	26	0	0
5	1223460	.	G	A	13	6	19	0	3	22	0	0
5	1240517	.	T	C	2	3	5	0	0	5	0	0
5	1240589	.	C	T	0	1	1	0	1	2	0	0
5	1244945	.	A	G	1	2	3	0	0	3	0	0
5	1244952	.	C	T	0	2	2	0	1	3	0	0
5	1245017	.	T	C	1	1	2	0	0	2	0	0
5	1270554	.	T	C	2	0	2	0	1	3	0	0
5	1271483	.	C	G	0	1	1	0	0	1	0	0
5	1311041	.	G	A	4	7	11	0	1	12	0	0
5	1317871	.	T	C	3	9	12	0	0	12	0	0
5	1317883	.	G	A	1	7	8	0	0	8	0	0
5	1406989	.	T	C	25	14	39	1	1	41	0	0
5	1406991	.	T	C	25	14	39	1	1	41	0	0
5	1420729	.	A	G	14	6	20	0	1	21	0	0
5	1420926	.	C	A	6	3	9	0	0	9	0	0
5	1420949	.	A	C	4	2	6	0	1	7	0	0
5	1421052	.	T	A	3	2	5	0	0	5	0	0
5	1421116	.	A	T	1	2	3	1	0	4	0	0
5	1438628	.	G	A	4	2	6	0	0	6	0	0
5	1445964	.	G	A	7	3	10	0	1	11	0	0
5	1451568	.	G	A	4	1	5	0	1	6	0	0
5	1451666	.	T	C	1	0	1	0	0	1	0	0
5	1461953	.	C	T	0	2	2	0	0	2	0	0
5	1519571	.	G	C	2	5	7	0	0	7	0	0
5	1519574	.	T	A	2	4	6	0	1	7	0	0
5	1624525	.	G	A	11	6	17	0	6	23	0	0
5	1653920	.	C	T	18	16	34	0	0	34	0	0
5	1653989	.	T	C	7	6	13	0	1	14	0	0
5	1688200	.	T	C	5	4	9	0	0	9	0	0
5	1707066	.	T	A	1	1	2	0	0	2	0	0
5	1729730	.	A	T	1	3	4	0	0	4	0	0
5	1869497	.	T	C	6	0	6	0	10	16	0	0
5	1869601	.	T	A	4	7	11	0	0	12	1	0
5	1950783	.	G	A	39	39	78	0	4	82	0	0
5	1952857	.	T	C	9	7	16	0	0	16	0	0
5	1952872	.	A	G	14	12	26	0	4	30	0	0
5	1952940	.	A	G	40	35	75	0	3	78	0	0
5	1953019	.	C	A	11	9	20	0	1	21	0	0
5	1955757	.	G	A	29	22	51	0	3	54	0	0
5	1957996	.	G	A	18	25	43	0	2	45	0	0
5	1958120	.	T	A	12	6	18	0	1	19	0	0
5	1962010	.	G	A	10	5	15	0	0	15	0	0
5	1990040	.	A	C	3	5	8	0	1	9	0	0
5	1991408	.	G	C	1	2	3	0	0	3	0	0
5	1991410	.	G	C	1	2	3	0	0	3	0	0
5	1991532	.	T	G	2	2	4	0	0	4	0	0
5	1997957	.	A	G	22	16	38	0	0	38	0	0
5	1997958	.	G	A	22	16	38	0	0	38	0	0
5	1998019	.	A	C	29	1	30	0	21	51	0	0
5	1999199	.	G	A	24	26	50	0	1	51	0	0
5	2047372	.	G	T	0	3	3	0	7	10	0	0
5	2067504	.	C	T	3	2	5	0	0	5	0	0
5	2067597	.	T	G	2	1	3	1	0	4	0	0
5	2067621	.	G	A	2	4	6	0	0	6	0	0
5	2067781	.	G	A	7	7	14	0	0	14	0	0
5	2067832	.	C	T	7	3	10	0	1	11	0	0
5	2067842	.	T	A	5	6	11	0	0	11	0	0
5	2068318	.	G	T	6	2	8	0	0	9	1	0
5	2069327	.	T	G	7	2	9	0	1	10	0	0
5	2069684	.	C	G	5	7	12	0	0	12	0	0
5	2074369	.	C	T	7	4	11	0	0	11	0	0
5	2086067	.	G	C	1	1	2	0	0	2	0	0
5	2086120	.	G	A	3	4	7	0	0	7	0	0
5	2095161	.	A	C	2	0	2	0	2	4	0	0
5	2099320	.	G	C	0	2	2	0	1	3	0	0
5	2099323	.	T	G	3	0	3	0	0	3	0	0
5	2241978	.	T	A	4	3	7	0	0	7	0	0
5	2242324	.	A	C	1	0	1	1	3	5	0	0
5	2242499	.	C	T	5	4	9	0	1	10	0	0
5	2242549	.	G	A	4	3	7	0	0	7	0	0
5	2242550	.	G	T	4	3	7	0	0	7	0	0
5	2242762	.	C	G	1	4	5	0	0	5	0	0
5	2242815	.	A	T	3	4	7	0	0	7	0	0
5	2243032	.	A	C	8	4	12	0	0	12	0	0
5	2243038	.	C	T	8	4	12	0	0	12	0	0
5	2251629	.	C	T	1	1	2	0	0	2	0	0
5	2251669	.	A	G	2	4	6	0	0	6	0	0
5	2251670	.	T	A	2	4	6	0	0	6	0	0
5	2251704	.	T	C	2	0	2	0	5	7	0	0
5	2410373	.	T	C	30	0	30	0	19	49	0	0
5	2410610	.	G	A	5	6	11	0	0	11	0	0
5	2413134	.	G	A	12	15	27	0	1	28	0	0
5	2413303	.	A	G	1	0	1	0	0	1	0	0
5	2413327	.	G	A	0	1	1	0	0	1	0	0
5	2419100	.	G	A	11	7	18	0	1	19	0	0
5	2426103	.	C	T	4	2	6	0	0	6	0	0
5	2434335	.	C	A	5	4	9	0	0	9	0	0
5	2434362	.	G	A	4	5	9	0	0	9	0	0
5	2434504	.	C	T	1	2	3	0	1	4	0	0
5	2434507	.	T	A	2	1	3	0	1	4	0	0
5	2435940	.	G	A	6	4	10	0	0	10	0	0
5	2451222	.	G	A	12	11	23	0	1	24	0	0
5	2451276	.	C	T	0	8	8	0	7	15	0	0
5	2451294	.	A	C	6	0	6	0	3	9	0	0
5	2454780	.	C	G	11	12	23	0	0	23	0	0
5	2454791	.	C	T	11	12	23	0	0	23	0	0
5	2457599	.	C	T	0	2	2	0	1	3	0	0
5	2460563	.	C	G	10	8	18	0	1	19	0	0
5	2461886	.	G	A	3	3	6	0	1	7	0	0
5	2463679	.	T	C	0	0	0	0	4	4	0	0
5	2467870	.	G	A	4	8	12	0	1	13	0	0
5	2495522	.	T	C	1	1	2	0	0	2	0	0
5	2509488	.	A	T	10	11	21	0	3	24	0	0
5	2509521	.	G	A	5	7	12	0	0	12	0	0
5	2521496	.	G	A	6	7	13	0	1	14	0	0
5	2571368	.	C	T	0	1	1	0	14	15	0	0
5	2571381	.	T	G	1	0	1	0	18	19	0	0
5	2658348	.	G	A	9	5	14	0	0	14	0	0
5	2681119	.	G	C	0	2	2	0	0	2	0	0
5	2689347	.	G	A	3	11	14	0	1	15	0	0
5	2689361	.	C	G	3	8	11	0	1	12	0	0
5	2693718	.	G	A	4	1	5	0	0	5	0	0
5	2693768	.	G	A	0	3	3	0	1	4	0	0
5	2696450	.	A	C	0	4	4	0	0	4	0	0
5	2696477	.	A	G	2	3	5	0	0	5	0	0
5	2709533	.	A	G	4	5	9	0	0	9	0	0
5	2709561	.	T	C	2	2	4	0	1	5	0	0
5	2713967	.	A	G	18	18	36	0	4	40	0	0
5	2714042	.	C	T	23	24	47	0	1	48	0	0
5	2714135	.	C	T	23	23	46	0	1	47	0	0
5	2714237	.	G	A	23	24	47	0	2	49	0	0
5	2714495	.	G	A	30	17	47	0	2	50	1	0
5	2714507	.	A	G	33	17	50	0	1	51	0	0
5	2714531	.	T	C	18	0	18	0	17	35	0	0
5	2716930	.	G	A	7	15	22	0	1	23	0	0
5	2716963	.	G	A	10	14	24	0	0	24	0	0
5	2717014	.	G	A	13	15	28	0	1	29	0	0
5	2717022	.	G	A	11	14	25	0	0	25	0	0
5	2717260	.	T	C	1	3	4	0	0	4	0	0
5	2717350	.	G	C	8	1	9	0	9	19	1	0
5	2717611	.	C	T	4	11	15	0	0	15	0	0
5	2717623	.	A	G	2	8	10	0	1	11	0	0
5	2717960	.	A	G	5	1	6	0	0	6	0	0
5	2718696	.	A	G	6	11	17	0	0	17	0	0
5	2718834	.	G	A	2	3	5	0	0	5	0	0
5	2720119	.	A	G	6	1	7	0	0	7	0	0
5	2721588	.	C	T	2	0	2	0	0	2	0	0
5	2742784	.	A	G	10	6	16	0	0	16	0	0
5	2744938	.	C	T	11	3	14	0	0	14	0	0
5	2744962	.	C	G	12	6	18	0	0	18	0	0
5	2744998	.	C	T	8	7	15	0	0	15	0	0
5	2750087	.	G	A	8	10	18	0	1	19	0	0
5	2750127	.	G	A	9	9	18	0	1	19	0	0
5	2750244	.	G	A	7	8	15	0	1	16	0	0
5	2750256	.	G	A	8	7	15	0	0	15	0	0
5	2751319	.	G	A	5	7	12	0	0	12	0	0
5	2751511	.	G	A	8	6	14	0	3	17	0	0
5	3118842	.	A	G	12	23	35	0	0	35	0	0
5	3127488	.	T	A	1	3	4	0	0	4	0	0
5	3185164	.	C	G	0	2	2	0	3	5	0	0
5	3258510	.	A	G	0	1	1	0	0	1	0	0
5	3545205	.	A	T	27	0	27	0	2	29	0	0
5	3568401	.	G	A	0	8	8	0	0	8	0	0
5	3568530	.	C	T	7	3	10	0	0	10	0	0
5	3573992	.	C	T	0	2	2	0	2	4	0	0
5	3611613	.	T	C	7	1	8	1	9	18	0	0
5	3611654	.	C	T	13	6	19	0	0	19	0	0
5	3611655	.	T	G	13	6	19	0	0	19	0	0
5	3612011	.	A	T	4	7	11	0	0	11	0	0
5	3612025	.	C	A	4	4	8	0	1	9	0	0
5	3618043	.	A	G	8	9	17	0	0	17	0	0
5	3618064	.	G	A	13	10	23	0	1	24	0	0
5	3626294	.	G	A	1	2	3	0	0	3	0	0
5	3626870	.	G	T	6	3	9	0	0	9	0	0
5	3626911	.	T	G	1	3	4	0	0	4	0	0
5	3891532	.	G	C	7	2	9	0	1	10	0	0
5	3891603	.	C	T	6	3	9	0	0	9	0	0
5	3891666	.	G	C	1	2	3	0	0	3	0	0
5	3892688	.	G	T	1	7	8	0	0	8	0	0
5	3906272	.	C	T	5	3	8	0	0	8	0	0
5	3906293	.	C	T	2	2	4	0	0	4	0	0
5	3914638	.	T	G	13	16	29	0	0	29	0	0
5	3914668	.	C	T	14	13	27	0	0	27	0	0
5	3914701	.	G	A	11	7	18	0	0	18	0	0
5	3925732	.	A	C	4	0	4	0	1	5	0	0
5	3925769	.	T	C	12	14	26	0	2	28	0	0
5	3927524	.	G	A	15	14	29	0	1	30	0	0
5	3928112	.	T	C	0	1	1	0	0	1	0	0
5	4009715	.	T	C	3	4	7	0	0	7	0	0
5	4009736	.	C	A	4	3	7	0	0	7	0	0
5	4024746	.	A	G	4	0	4	0	6	10	0	0
5	4040153	.	G	A	10	9	19	0	0	19	0	0
5	4041064	.	C	T	0	4	4	0	0	4	0	0
5	4041181	.	T	C	3	2	5	0	1	6	0	0
5	4041671	.	C	A	3	5	8	0	0	8	0	0
5	4048760	.	A	G	5	12	17	0	0	17	0	0
5	4048820	.	C	T	0	4	4	0	1	5	0	0
5	4051551	.	C	T	4	4	8	0	0	8	0	0
5	4051594	.	A	G	12	0	12	0	13	25	0	0
5	4052191	.	G	A	5	6	11	0	1	12	0	0
5	4052225	.	A	G	4	4	8	0	0	8	0	0
5	4137043	.	A	G	0	2	2	0	1	3	0	0
5	4260672	.	G	A	10	9	19	0	1	20	0	0
5	4263154	.	G	C	2	4	6	0	0	6	0	0
5	4263241	.	G	T	19	13	32	0	1	33	0	0
5	4263297	.	G	T	6	9	15	0	0	15	0	0
5	4263322	.	C	T	4	2	6	0	0	6	0	0
5	4265417	.	T	C	2	10	12	0	0	12	0	0
5	4265452	.	G	A	4	11	15	0	0	15	0	0
5	4269325	.	G	T	7	3	10	0	1	11	0	0
5	4273216	.	G	A	11	7	18	0	1	19	0	0
5	4275481	.	C	T	0	3	3	0	1	4	0	0
5	4278433	.	G	A	10	7	17	0	0	17	0	0
5	4281626	.	A	G	5	1	6	0	0	6	0	0
5	4281634	.	A	G	6	3	9	0	0	9	0	0
5	4293975	.	T	C	1	1	2	0	0	2	0	0
5	4293978	.	C	A	1	1	2	0	0	2	0	0
5	4298902	.	G	C	16	5	21	0	1	22	0	0
5	4299588	.	A	G	2	0	2	0	0	2	0	0
5	4308861	.	G	A	1	4	5	0	0	5	0	0
5	4374146	.	G	T	1	3	4	0	0	5	1	0
5	4374155	.	C	G	1	2	3	0	1	4	0	0
5	4387137	.	T	G	1	0	1	0	0	1	0	0
5	4397741	.	A	G	2	3	5	0	1	6	0	0
5	4414178	.	C	T	1	9	10	0	1	11	0	0
5	4448249	.	G	A	0	3	3	0	2	5	0	0
5	4469658	.	G	A	0	3	3	0	2	5	0	0
5	4469754	.	G	A	0	2	2	0	3	5	0	0
5	4482647	.	A	G	3	5	8	0	0	8	0	0
5	4482992	.	G	A	7	1	8	0	1	9	0	0
5	4493427	.	C	G	1	10	11	0	11	22	0	0
5	4493502	.	T	G	2	4	6	0	0	6	0	0
5	4523677	.	T	C	8	0	8	0	6	14	0	0
5	4528225	.	G	A	1	3	4	0	0	4	0	0
5	4532499	.	A	G	4	3	7	0	0	7	0	0
5	4545106	.	G	A	0	3	3	0	0	3	0	0
5	4545115	.	A	G	0	4	4	0	1	5	0	0
5	4547680	.	C	T	0	2	2	0	0	2	0	0
5	4729334	.	G	A	1	1	2	0	0	2	0	0
5	5033234	.	G	C	2	0	2	0	2	4	0	0
5	5171750	.	G	A	3	3	6	0	1	7	0	0
5	5171770	.	G	A	5	4	9	0	0	9	0	0
5	5171978	.	G	A	1	2	3	0	0	3	0	0
5	5185955	.	G	C	7	4	11	0	0	11	0	0
5	5313879	.	T	C	2	0	2	0	0	2	0	0
5	5394341	.	A	C	3	0	3	0	4	7	0	0
5	5394467	.	T	C	2	3	5	0	0	5	0	0
5	5399019	.	C	T	3	2	5	0	1	6	0	0
5	5399025	.	T	A	3	3	6	0	0	6	0	0
5	5406568	.	C	T	3	5	8	0	0	8	0	0
5	5498155	.	C	T	2	2	4	0	0	4	0	0
5	5498206	.	G	A	1	1	2	0	0	2	0	0
5	5619609	.	G	C	3	2	5	0	0	5	0	0
5	5619670	.	G	T	3	3	6	0	0	6	0	0
5	5619677	.	C	G	0	1	1	0	2	3	0	0
5	5619722	.	A	G	0	0	0	0	1	1	0	0
5	5628973	.	G	A	0	2	2	0	0	2	0	0
5	5628979	.	C	T	0	2	2	0	0	2	0	0
5	5629053	.	A	G	2	2	4	0	0	4	0	0
5	5632371	.	T	C	4	0	4	0	1	5	0	0
5	5632397	.	G	A	1	3	4	0	1	5	0	0
5	5649223	.	A	G	0	1	1	0	1	2	0	0
5	5689538	.	G	T	1	4	5	0	0	5	0	0
5	5689542	.	C	T	1	5	6	0	0	6	0	0
5	5691906	.	C	T	0	2	2	0	0	2	0	0
5	5696023	.	G	A	0	3	3	0	3	6	0	0
5	5696044	.	T	C	2	3	5	0	0	5	0	0
5	5778624	.	G	A	5	4	9	0	1	10	0	0
5	5780248	.	A	T	1	2	3	0	0	3	0	0
5	5796908	.	A	T	0	1	1	0	0	1	0	0
5	5797960	.	C	G	0	0	0	1	0	1	0	0
5	6726273	.	T	A	2	5	7	0	0	7	0	0
5	6858380	.	C	A	5	9	14	0	0	14	0	0
5	6858540	.	T	A	10	8	18	0	1	19	0	0
5	6858779	.	G	T	0	3	3	0	15	18	0	0
5	6863577	.	C	T	6	4	10	0	0	10	0	0
5	6863647	.	C	T	12	9	21	0	1	22	0	0
5	6863768	.	G	C	6	15	21	0	0	22	1	0
5	6863793	.	G	A	3	20	23	0	0	23	0	0
5	6863834	.	A	G	4	1	5	0	18	23	0	0
5	6863855	.	G	A	7	12	19	0	1	20	0	0
5	6863912	.	A	C	7	4	11	0	1	12	0	0
5	6864010	.	C	T	3	4	7	0	0	7	0	0
5	8006474	.	A	G	1	3	4	0	1	5	0	0
5	8006503	.	A	G	1	9	10	0	0	10	0	0
5	8237162	.	A	G	0	5	5	0	0	5	0	0
5	8537820	.	T	C	3	3	6	0	0	6	0	0
5	9443250	.	T	C	1	3	4	0	0	4	0	0
5	9443251	.	T	C	1	3	4	0	0	4	0	0
5	9824444	.	G	C	2	3	5	0	0	5	0	0
5	9824694	.	G	A	4	1	5	0	2	7	0	0
5	10046718	.	G	A	0	2	2	0	2	4	0	0
5	10046839	.	G	A	0	2	2	0	1	3	0	0
5	10051017	.	G	A	0	1	1	0	1	2	0	0
5	10053778	.	C	A	3	2	5	0	0	5	0	0
5	10084310	.	C	T	5	3	8	0	0	8	0	0
5	10766286	.	G	A	9	4	13	0	0	13	0	0
5	10766505	.	A	G	12	13	25	0	0	25	0	0
5	10766529	.	G	A	10	10	20	0	2	22	0	0
5	10766879	.	A	G	17	12	29	0	0	29	0	0
5	10767113	.	C	T	11	9	20	0	0	20	0	0
5	10767259	.	A	G	21	17	38	0	0	38	0	0
5	10767456	.	G	A	6	6	12	0	0	12	0	0
5	10767588	.	C	T	2	4	6	0	0	6	0	0
5	10768089	.	G	A	11	11	22	0	1	23	0	0
5	10768182	.	G	A	7	15	22	0	0	22	0	0
5	10768215	.	T	C	9	0	9	0	4	13	0	0
5	10946038	.	G	A	6	9	15	0	0	15	0	0
5	10946085	.	G	T	3	7	10	0	0	10	0	0
5	11244625	.	T	C	2	3	5	0	0	5	0	0
5	11244675	.	A	G	2	2	4	0	0	4	0	0
5	11250049	.	C	T	1	0	1	0	0	1	0	0
5	11270844	.	C	A	1	0	1	0	0	1	0	0
5	11507602	.	A	G	1	7	8	0	0	8	0	0
5	11727757	.	T	C	1	5	6	0	0	6	0	0
5	11812278	.	C	T	9	1	10	0	0	10	0	0
5	11816599	.	G	A	0	6	6	0	0	6	0	0
5	11824059	.	G	A	0	3	3	0	2	5	0	0
5	11824188	.	T	C	2	2	4	0	0	4	0	0
5	11826347	.	T	C	3	3	6	0	1	7	0	0
5	11836437	.	T	C	8	6	14	0	0	14	0	0
5	11863412	.	C	T	0	3	3	0	1	4	0	0
5	11864774	.	T	G	5	8	13	0	0	13	0	0
5	11900230	.	T	C	3	1	4	0	2	6	0	0
5	11905086	.	A	T	3	1	4	0	0	4	0	0
5	11905725	.	C	T	4	4	8	0	0	8	0	0
5	11905890	.	A	G	7	9	16	0	0	16	0	0
5	11905903	.	T	G	7	5	12	0	0	12	0	0
5	11917125	.	C	T	11	4	15	0	0	15	0	0
5	11917405	.	G	A	10	5	15	0	0	15	0	0
5	11917436	.	G	A	2	12	14	0	0	14	0	0
5	11917485	.	G	A	13	5	18	0	0	18	0	0
5	11917596	.	C	A	2	15	17	0	8	25	0	0
5	11933155	.	A	G	9	8	17	0	0	17	0	0
5	11935444	.	G	A	0	4	4	0	0	4	0	0
5	11937486	.	G	A	3	1	4	0	0	4	0	0
5	11941903	.	T	C	1	0	1	0	4	5	0	0
5	11943662	.	A	C	4	6	10	0	0	10	0	0
5	11943868	.	G	A	9	15	24	0	2	26	0	0
5	11943934	.	C	A	6	4	10	0	1	11	0	0
5	11943948	.	T	A	5	7	12	0	0	12	0	0
5	11943989	.	G	A	6	8	14	0	0	14	0	0
5	11944060	.	T	G	5	5	10	0	1	11	0	0
5	11949244	.	G	T	6	9	15	0	1	16	0	0
5	11959776	.	G	T	0	12	12	0	13	25	0	0
5	11959777	.	C	T	12	12	24	0	1	25	0	0
5	11959818	.	C	T	13	15	28	0	0	28	0	0
5	11959966	.	C	G	12	5	17	0	1	18	0	0
5	11959988	.	G	A	0	14	14	0	6	20	0	0
5	11982950	.	C	A	5	5	10	0	0	10	0	0
5	11983017	.	T	C	3	6	9	0	1	10	0	0
5	11983085	.	C	T	0	2	2	0	2	4	0	0
5	11983548	.	C	G	5	9	14	0	0	14	0	0
5	11984086	.	T	C	6	7	13	0	0	13	0	0
5	11984133	.	C	T	3	6	9	0	0	9	0	0
5	11984808	.	C	T	3	2	5	0	0	5	0	0
5	11985546	.	A	T	5	5	10	0	0	10	0	0
5	11985842	.	T	A	2	4	6	0	0	6	0	0
5	11985843	.	G	T	2	4	6	0	0	6	0	0
5	11986635	.	A	C	2	0	2	0	2	4	0	0
5	12100335	.	G	A	4	7	11	0	0	11	0	0
5	12113257	.	T	C	0	0	0	0	1	1	0	0
5	12146026	.	A	G	3	3	6	0	0	6	0	0
5	12219580	.	A	G	1	3	4	0	0	4	0	0
5	12284075	.	C	T	16	9	25	0	2	27	0	0
5	12285172	.	T	C	8	1	9	0	5	14	0	0
5	12288511	.	T	C	4	5	9	0	0	9	0	0
5	12288541	.	A	G	1	4	5	0	0	5	0	0
5	12322321	.	G	A	0	2	2	0	0	2	0	0
5	12357554	.	C	T	4	4	8	0	0	8	0	0
5	12454563	.	T	C	5	0	5	0	15	20	0	0
5	12503554	.	G	A	3	7	10	0	0	10	0	0
5	12516815	.	T	G	1	4	5	0	0	5	0	0
5	12524938	.	A	G	5	7	12	1	0	13	0	0
5	12533197	.	C	T	2	0	2	0	2	4	0	0
5	12549258	.	C	T	9	6	15	0	0	15	0	0
5	12549326	.	C	T	8	10	18	0	1	19	0	0
5	12549642	.	C	A	2	2	4	0	0	4	0	0
5	12549776	.	G	T	1	3	4	0	0	4	0	0
5	12549807	.	A	G	3	4	7	0	0	7	0	0
5	12549981	.	G	T	6	5	11	0	0	11	0	0
5	12553935	.	C	T	0	0	0	0	5	5	0	0
5	12554119	.	A	G	2	3	5	0	0	5	0	0
5	12558090	.	C	T	2	3	5	0	0	5	0	0
5	12615809	.	C	T	1	2	3	0	0	3	0	0
5	12625831	.	A	T	0	2	2	0	0	2	0	0
5	12652240	.	A	T	0	2	2	0	0	2	0	0
5	12664278	.	G	A	6	3	9	0	0	9	0	0
5	12664330	.	T	C	1	6	7	0	0	7	0	0
5	12701122	.	A	G	5	2	7	0	0	7	0	0
5	12701139	.	C	T	2	5	7	0	0	7	0	0
5	12724121	.	C	T	8	8	16	0	2	18	0	0
5	12724224	.	G	A	11	9	20	0	0	20	0	0
5	12724249	.	A	C	8	7	15	0	1	16	0	0
5	12724307	.	A	G	2	6	8	0	0	8	0	0
5	12724412	.	A	G	1	0	1	0	0	1	0	0
5	12724450	.	C	T	0	4	4	0	4	8	0	0
5	12724505	.	C	A	7	11	18	0	0	18	0	0
5	12724518	.	G	C	7	0	7	0	13	20	0	0
5	12724567	.	A	G	12	9	21	0	1	22	0	0
5	12724694	.	C	T	0	9	9	0	16	25	0	0
5	12725930	.	G	A	1	3	4	0	0	4	0	0
5	12726842	.	A	G	1	4	5	0	0	5	0	0
5	12729397	.	C	T	3	2	5	0	1	6	0	0
5	12732247	.	C	T	6	1	7	0	0	7	0	0
5	12734883	.	G	T	0	8	8	0	0	8	0	0
5	12734910	.	T	C	0	8	8	0	1	9	0	0
5	12743011	.	C	A	1	5	6	0	0	6	0	0
5	12743088	.	T	A	2	4	6	0	0	6	0	0
5	12743159	.	A	T	4	2	6	0	0	6	0	0
5	12797446	.	T	C	1	2	3	0	0	3	0	0
5	12797455	.	T	C	1	1	2	0	0	2	0	0
5	12811268	.	G	T	1	0	1	0	0	1	0	0
5	12837013	.	T	A	0	2	2	0	0	2	0	0
5	12837064	.	G	A	3	6	9	0	0	9	0	0
5	12859258	.	T	C	11	10	21	0	2	23	0	0
5	12865111	.	A	G	6	11	17	0	0	17	0	0
5	12903862	.	G	C	2	5	7	0	0	7	0	0
5	12905285	.	C	A	2	2	4	0	0	4	0	0
5	12905621	.	T	G	2	2	4	0	0	4	0	0
5	12905717	.	C	A	4	2	6	0	0	6	0	0
5	12905911	.	A	C	1	3	4	0	0	4	0	0
5	12905968	.	T	G	2	4	6	0	0	6	0	0
5	12906014	.	C	T	1	6	7	0	0	7	0	0
5	12906273	.	C	T	2	5	7	0	1	8	0	0
5	12908828	.	C	A	4	7	11	0	0	11	0	0
5	12926507	.	C	A	0	1	1	0	0	1	0	0
5	12935223	.	A	G	3	3	6	0	0	6	0	0
5	12956918	.	T	C	2	1	3	0	0	3	0	0
5	12956960	.	C	T	1	2	3	0	0	3	0	0
5	12975532	.	C	T	2	1	3	0	1	4	0	0
5	13037199	.	C	T	0	3	3	0	7	10	0	0
5	13037203	.	C	T	0	8	8	0	3	11	0	0
5	13037723	.	A	G	4	5	9	0	0	9	0	0
5	13037939	.	T	G	7	6	13	0	1	14	0	0
5	13037967	.	G	A	7	7	14	0	0	14	0	0
5	13037998	.	A	G	8	8	16	0	0	16	0	0
5	13105020	.	C	T	15	26	41	0	3	44	0	0
5	13105070	.	C	A	4	23	27	0	14	41	0	0
5	13112979	.	G	A	1	1	2	0	0	2	0	0
5	13167048	.	A	T	13	9	22	0	1	23	0	0
5	13213161	.	A	G	0	2	2	0	0	2	0	0
5	13213169	.	T	C	2	2	4	0	0	4	0	0
5	13214055	.	C	T	0	4	4	0	0	4	0	0
5	13214637	.	C	G	6	6	12	0	1	13	0	0
5	13214802	.	C	G	4	3	7	0	1	8	0	0
5	13223062	.	G	A	1	1	2	0	0	2	0	0
5	13227057	.	C	T	0	1	1	0	1	2	0	0
5	13229024	.	C	A	1	1	2	0	0	2	0	0
5	13239172	.	A	G	0	1	1	0	0	1	0	0
5	13239412	.	A	G	1	0	1	0	0	1	0	0
5	13251737	.	C	A	0	1	1	0	3	4	0	0
5	13308654	.	T	A	0	2	2	0	0	2	0	0
5	13308959	.	G	A	1	3	4	0	0	4	0	0
5	13308985	.	T	C	0	4	4	0	0	4	0	0
5	13308997	.	G	T	2	4	6	0	0	6	0	0
5	13309174	.	T	C	12	1	13	0	13	26	0	0
5	13309215	.	C	T	12	10	22	0	0	22	0	0
5	13309273	.	C	T	13	16	29	0	0	29	0	0
5	13309309	.	G	A	10	15	25	0	1	26	0	0
5	13309402	.	A	G	8	18	26	0	2	28	0	0
5	13309435	.	A	T	9	20	29	0	0	29	0	0
5	13309522	.	G	A	6	13	19	0	1	20	0	0
5	13312671	.	A	T	2	2	4	0	0	4	0	0
5	13312746	.	G	A	16	8	24	0	0	24	0	0
5	13315490	.	G	C	6	10	16	0	1	17	0	0
5	13315526	.	T	C	9	14	23	0	0	23	0	0
5	13315603	.	A	C	11	14	25	0	1	26	0	0
5	13326851	.	C	T	1	2	3	0	0	3	0	0
5	13326911	.	G	A	0	0	0	0	1	1	0	0
5	13329785	.	G	C	1	4	5	0	0	5	0	0
5	13332930	.	A	G	1	2	3	0	0	3	0	0
5	13335291	.	C	T	2	0	2	0	1	3	0	0
5	13335333	.	G	A	0	5	5	0	0	5	0	0
5	13335423	.	C	T	5	4	9	0	0	9	0	0
5	13337803	.	C	T	11	12	23	0	0	23	0	0
5	13337883	.	T	A	17	15	32	0	2	34	0	0
5	13338441	.	C	T	0	15	15	0	11	26	0	0
5	13338762	.	A	T	8	7	15	0	1	16	0	0
5	13339038	.	G	C	17	21	38	0	9	47	0	0
5	13394714	.	A	G	2	2	4	0	1	5	0	0
5	13410020	.	G	T	0	1	1	0	0	1	0	0
5	13410768	.	A	G	0	2	2	0	1	3	0	0
5	13413091	.	T	A	1	0	1	0	0	1	0	0
5	13418089	.	T	A	1	0	1	0	1	2	0	0
5	13418096	.	T	C	1	1	2	0	0	2	0	0
5	13445433	.	C	T	5	2	7	0	0	7	0	0
5	13461377	.	T	C	1	2	3	0	0	3	0	0
5	13465095	.	T	C	3	1	4	0	1	5	0	0
5	13468108	.	G	T	1	2	3	0	5	8	0	0
5	13468440	.	T	A	2	3	5	0	0	5	0	0
5	13468574	.	G	A	2	4	6	0	0	6	0	0
5	13468655	.	G	A	5	2	7	0	1	8	0	0
5	13468656	.	A	T	5	2	7	0	1	8	0	0
5	13469105	.	T	A	2	3	5	0	0	5	0	0
5	13469137	.	C	A	2	4	6	0	0	6	0	0
5	13472279	.	C	T	3	5	8	0	1	9	0	0
5	13472295	.	G	T	7	3	10	0	1	11	0	0
5	13473334	.	G	A	0	6	6	0	2	8	0	0
5	13501288	.	C	A	1	2	3	0	0	3	0	0
5	13539403	.	A	G	1	0	1	0	6	7	0	0
5	13539493	.	A	G	2	0	2	0	6	8	0	0
5	13540689	.	C	T	11	4	15	0	1	16	0	0
5	13540738	.	C	T	1	5	6	0	1	7	0	0
5	13540846	.	T	A	6	3	9	0	0	9	0	0
5	13556425	.	G	A	0	1	1	0	1	2	0	0
5	13557614	.	T	C	1	1	2	0	0	2	0	0
5	13643325	.	G	A	13	11	24	0	1	25	0	0
5	13643411	.	C	T	0	22	22	0	14	36	0	0
5	13643824	.	G	A	12	9	21	0	0	21	0	0
5	13644126	.	A	T	19	21	40	0	1	41	0	0
5	13644185	.	T	G	13	15	28	0	1	29	0	0
5	13644189	.	T	G	12	13	25	0	1	26	0	0
5	13644227	.	A	G	14	10	24	0	0	24	0	0
5	13644256	.	A	T	12	5	17	0	0	17	0	0
5	13644581	.	T	G	13	12	25	0	4	29	0	0
5	13644602	.	T	A	20	13	33	0	0	33	0	0
5	13644781	.	C	T	6	12	18	0	0	19	1	0
5	13644797	.	A	G	10	7	17	0	0	17	0	0
5	13645047	.	C	G	14	19	33	0	1	34	0	0
5	13645746	.	A	G	19	14	33	0	0	33	0	0
5	13645885	.	T	C	11	11	22	0	1	23	0	0
5	13649518	.	C	T	7	5	12	0	2	14	0	0
5	13652410	.	T	C	8	21	29	0	0	29	0	0
5	13671624	.	G	T	7	4	11	0	0	11	0	0
5	13671631	.	A	C	3	6	9	0	1	10	0	0
5	13671899	.	C	G	7	16	23	0	2	25	0	0
5	13672004	.	C	T	0	20	20	0	21	41	0	0
5	13672211	.	C	T	14	25	39	0	2	41	0	0
5	13672232	.	C	T	23	12	35	0	1	36	0	0
5	13673016	.	C	G	0	6	6	0	3	9	0	0
5	13684132	.	A	G	14	12	26	0	2	28	0	0
5	13684502	.	C	A	2	24	26	0	18	44	0	0
5	13766276	.	A	G	8	5	13	0	0	13	0	0
5	13767883	.	A	T	1	7	8	0	1	9	0	0
5	13772666	.	T	C	3	3	6	0	0	6	0	0
5	13778659	.	G	T	26	15	41	0	4	45	0	0
5	13778663	.	C	T	27	17	44	0	1	45	0	0
5	13782325	.	T	C	18	11	29	0	1	30	0	0
5	13782786	.	C	A	5	4	9	0	3	12	0	0
5	13783992	.	T	G	1	3	4	0	0	4	0	0
5	13783995	.	G	A	1	4	5	0	0	5	0	0
5	13784243	.	T	A	12	8	20	0	0	20	0	0
5	13784486	.	G	T	10	3	13	0	0	14	1	0
5	13784559	.	T	A	2	2	4	0	0	4	0	0
5	13784914	.	G	T	3	4	7	0	0	7	0	0
5	13784916	.	C	T	3	4	7	0	0	7	0	0
5	13784951	.	A	T	2	1	3	0	0	3	0	0
5	13785013	.	T	G	1	1	2	0	0	2	0	0
5	13785289	.	T	C	9	0	9	2	4	15	0	0
5	13785304	.	A	G	8	4	12	2	0	14	0	0
5	13785441	.	A	G	4	3	7	0	0	7	0	0
5	13785485	.	T	C	3	0	3	0	2	5	0	0
5	13785490	.	G	A	2	2	4	0	1	5	0	0
5	13785522	.	T	C	2	2	4	0	4	8	0	0
5	13785677	.	T	C	10	0	10	0	6	16	0	0
5	13785735	.	C	T	8	10	18	0	0	18	0	0
5	13791984	.	G	A	4	3	7	0	1	8	0	0
5	13793333	.	T	C	4	0	4	0	0	4	0	0
5	13799613	.	G	A	9	11	20	0	0	20	0	0
5	13799635	.	C	T	10	7	17	0	2	19	0	0
5	13799704	.	G	A	7	12	19	0	2	21	0	0
5	13800062	.	C	T	1	3	4	0	0	4	0	0
5	13800170	.	C	A	2	4	6	0	0	6	0	0
5	13803918	.	C	A	0	3	3	0	3	6	0	0
5	13803960	.	C	T	4	5	9	0	1	10	0	0
5	13820304	.	C	T	4	5	9	0	0	9	0	0
5	13820457	.	G	A	2	1	3	0	0	3	0	0
5	13835462	.	T	G	3	4	7	0	0	7	0	0
5	13992582	.	T	C	2	2	4	0	0	4	0	0
5	14004030	.	A	T	0	2	2	0	0	2	0	0
5	14306793	.	G	T	14	14	28	0	0	28	0	0
5	14307459	.	G	A	5	6	11	0	0	11	0	0
5	14307720	.	C	T	13	7	20	0	1	21	0	0
5	14308710	.	A	G	8	16	24	0	2	26	0	0
5	14308773	.	G	A	7	8	15	0	2	17	0	0
5	14308792	.	C	A	9	10	19	0	0	19	0	0
5	14309073	.	T	C	1	2	3	0	1	4	0	0
5	14309219	.	A	G	5	4	9	0	0	9	0	0
5	14309334	.	C	T	0	5	5	0	7	12	0	0
5	14309661	.	C	T	1	3	4	0	0	4	0	0
5	14310874	.	T	A	16	13	29	0	0	29	0	0
5	14312030	.	C	T	0	5	5	0	14	19	0	0
5	14312091	.	G	A	7	6	13	0	1	14	0	0
5	14321243	.	G	A	3	6	9	0	2	11	0	0
5	14321336	.	G	A	8	7	15	0	1	16	0	0
5	14321393	.	C	T	5	6	11	0	0	11	0	0
5	14321438	.	A	G	9	8	17	0	0	17	0	0
5	14321488	.	G	A	5	5	10	0	0	10	0	0
5	14322022	.	C	T	10	9	19	0	0	19	0	0
5	14322037	.	C	T	12	8	20	0	1	21	0	0
5	14322212	.	C	T	9	6	15	0	0	15	0	0
5	14322269	.	T	C	4	4	8	0	0	8	0	0
5	14322433	.	A	T	12	6	18	0	1	19	0	0
5	14322647	.	C	T	3	8	11	0	0	11	0	0
5	14322898	.	T	G	7	9	16	0	0	16	0	0
5	14323082	.	A	T	6	10	16	0	0	16	0	0
5	14323934	.	T	C	4	5	9	0	1	10	0	0
5	14372993	.	G	A	1	2	3	0	0	3	0	0
5	14375330	.	T	A	4	4	8	0	0	8	0	0
5	14375529	.	A	G	12	9	21	0	1	22	0	0
5	14375598	.	A	G	13	9	22	0	2	24	0	0
5	14375623	.	A	G	15	11	26	0	3	29	0	0
5	14375881	.	T	C	14	8	22	0	0	22	0	0
5	14376155	.	A	G	10	4	14	0	0	14	0	0
5	14380632	.	C	T	11	7	18	0	1	19	0	0
5	14382534	.	C	G	3	4	7	0	0	7	0	0
5	14383193	.	G	A	6	5	11	0	0	11	0	0
5	14386045	.	T	A	3	2	5	0	1	6	0	0
5	14386277	.	A	G	7	7	14	0	2	16	0	0
5	14387338	.	G	A	12	9	21	0	0	21	0	0
5	14394466	.	A	G	20	18	38	0	0	38	0	0
5	14394515	.	G	A	15	20	35	0	1	36	0	0
5	14394872	.	T	A	14	5	19	0	2	21	0	0
5	14395430	.	G	A	12	10	22	0	1	23	0	0
5	14395664	.	G	A	13	16	29	0	0	29	0	0
5	14395697	.	G	A	21	10	31	0	0	31	0	0
5	14396030	.	C	T	6	6	12	0	0	12	0	0
5	14396438	.	C	G	0	16	16	0	13	29	0	0
5	14396609	.	T	C	5	8	13	0	1	14	0	0
5	14396783	.	C	T	13	11	24	0	0	24	0	0
5	14396876	.	C	T	8	7	15	0	1	16	0	0
5	14396893	.	G	T	11	7	18	0	0	18	0	0
5	14397231	.	T	A	6	7	13	0	0	13	0	0
5	14397232	.	G	T	6	5	11	0	2	13	0	0
5	14398364	.	C	T	4	6	10	0	0	10	0	0
5	14398876	.	A	T	1	1	2	0	0	2	0	0
5	14399766	.	G	C	0	1	1	0	0	1	0	0
5	14402108	.	C	T	4	6	10	0	0	10	0	0
5	14402848	.	C	T	1	0	1	0	0	1	0	0
5	14407552	.	A	G	2	0	2	0	0	2	0	0
5	14413810	.	A	G	3	3	6	0	0	6	0	0
5	14442388	.	C	T	0	2	2	0	3	5	0	0
5	14529221	.	C	T	0	15	15	0	12	27	0	0
5	14529450	.	C	T	14	9	23	0	2	25	0	0
5	14530091	.	T	G	12	13	25	0	1	26	0	0
5	14530346	.	C	T	4	6	10	0	0	10	0	0
5	14530457	.	G	A	6	5	11	0	0	11	0	0
5	14530511	.	T	C	7	11	18	0	0	18	0	0
5	14530571	.	A	G	10	9	19	0	0	19	0	0
5	14530595	.	C	T	7	3	10	0	0	10	0	0
5	14533937	.	C	T	0	1	1	0	1	2	0	0
5	14534025	.	G	A	1	4	5	0	1	6	0	0
5	14543331	.	G	A	2	3	5	0	0	5	0	0
5	14545814	.	C	T	0	2	2	0	2	4	0	0
5	14564831	.	G	A	7	6	13	0	0	13	0	0
5	14584305	.	G	A	1	4	5	0	0	5	0	0
5	14647979	.	T	C	7	5	12	0	1	13	0	0
5	14648272	.	G	A	3	3	6	0	0	6	0	0
5	15394285	.	G	T	6	7	13	0	0	13	0	0
5	15394354	.	G	A	9	6	15	0	0	15	0	0
5	15394357	.	A	G	9	4	13	0	0	13	0	0
5	15394396	.	C	T	0	1	1	0	2	3	0	0
5	15416836	.	T	A	3	3	6	0	0	6	0	0
5	15810523	.	A	G	3	2	5	0	0	5	0	0
5	16124919	.	C	T	1	1	2	0	0	2	0	0
5	16126203	.	C	T	1	3	4	0	0	4	0	0
5	16126440	.	T	C	2	2	4	0	0	4	0	0
5	16126762	.	C	A	1	2	3	0	0	3	0	0
5	16128798	.	C	T	7	5	12	0	0	12	0	0
5	16128841	.	G	A	0	2	2	0	0	2	0	0
5	16134766	.	C	T	0	1	1	0	1	2	0	0
5	16138840	.	G	C	0	1	1	0	0	1	0	0
5	16139401	.	G	A	2	2	4	0	1	5	0	0
5	16139451	.	A	G	9	3	12	0	1	13	0	0
5	16139556	.	T	C	2	0	2	0	4	6	0	0
5	16718993	.	G	C	7	6	13	0	2	15	0	0
5	16720830	.	G	A	11	9	20	0	0	20	0	0
5	16800437	.	A	G	11	9	20	0	0	20	0	0
5	16800710	.	T	C	17	1	18	0	17	35	0	0
5	16800955	.	C	T	0	10	10	0	11	21	0	0
5	16815222	.	C	G	5	6	11	0	1	12	0	0
5	16818828	.	G	A	5	7	12	0	0	12	0	0
5	16818858	.	T	G	10	9	19	0	0	19	0	0
5	16833631	.	A	G	8	4	12	0	0	12	0	0
5	16916446	.	T	C	4	5	9	0	1	10	0	0
5	16916476	.	G	A	7	9	16	0	0	16	0	0
5	16916575	.	T	C	0	1	1	0	0	1	0	0
5	16928099	.	T	C	11	0	11	0	6	17	0	0
5	16956501	.	G	A	4	1	5	0	1	6	0	0
5	16956615	.	C	T	4	4	8	0	0	8	0	0
5	16982624	.	G	A	10	8	18	0	2	20	0	0
5	16983206	.	C	T	2	5	7	0	0	7	0	0
5	17727417	.	C	A	14	8	22	0	3	25	0	0
5	17727421	.	A	C	12	10	22	0	2	24	0	0
5	17731592	.	C	A	3	5	8	0	2	10	0	0
5	17738720	.	G	A	0	1	1	0	2	3	0	0
5	17751119	.	G	A	5	2	7	0	1	8	0	0
5	17751681	.	G	A	0	17	17	0	5	22	0	0
5	17751894	.	A	T	8	21	29	0	1	30	0	0
5	17751939	.	A	G	15	16	31	0	0	31	0	0
5	17752545	.	A	G	20	13	33	0	0	33	0	0
5	17752778	.	A	T	3	3	6	0	0	6	0	0
5	17753214	.	G	A	4	10	14	0	4	18	0	0
5	17753216	.	G	A	4	11	15	0	3	18	0	0
5	17753529	.	A	T	14	11	25	0	0	25	0	0
5	17813007	.	G	A	0	1	1	0	2	3	0	0
5	17813008	.	G	T	2	1	3	0	0	3	0	0
5	17813051	.	T	G	1	1	2	0	0	2	0	0
5	17813181	.	C	T	1	5	6	0	0	6	0	0
5	17849037	.	T	C	0	2	2	0	0	2	0	0
5	17881995	.	A	T	3	4	7	0	0	7	0	0
5	17882282	.	T	A	4	5	9	0	0	9	0	0
5	17882291	.	C	T	4	4	8	0	2	10	0	0
5	17885194	.	T	C	6	0	6	0	7	13	0	0
5	17885287	.	A	C	3	7	10	0	0	10	0	0
5	17885902	.	G	A	2	4	6	0	0	6	0	0
5	17885995	.	A	G	2	2	4	0	0	4	0	0
5	17886028	.	T	G	3	2	5	0	0	5	0	0
5	17886039	.	G	T	3	2	5	0	0	5	0	0
5	17891709	.	G	A	0	3	3	0	0	3	0	0
5	18072673	.	C	T	3	2	5	0	0	5	0	0
5	18935716	.	A	G	4	2	6	0	0	6	0	0
5	19008335	.	A	G	18	10	28	1	6	35	0	0
5	19932246	.	C	T	0	0	0	0	1	1	0	0
5	20416618	.	A	T	6	4	10	0	0	10	0	0
5	20416958	.	T	C	6	3	9	0	0	9	0	0
5	20416976	.	C	T	4	2	6	0	0	6	0	0
5	20417099	.	T	C	9	3	12	1	1	14	0	0
5	20417180	.	G	A	0	6	6	0	3	9	0	0
5	20417274	.	G	A	0	7	7	0	3	10	0	0
5	20417399	.	G	C	3	1	4	0	1	5	0	0
5	20417405	.	C	G	3	2	5	0	1	6	0	0
5	20417515	.	T	C	3	3	6	0	0	6	0	0
5	20417631	.	T	G	8	0	8	0	4	12	0	0
5	20418958	.	A	T	5	2	7	0	1	8	0	0
5	20419008	.	A	T	13	6	19	0	0	19	0	0
5	20419087	.	A	G	12	6	18	0	1	19	0	0
5	20419373	.	G	C	13	4	17	0	0	17	0	0
5	20419563	.	A	C	4	6	10	0	0	10	0	0
5	20419613	.	G	A	6	5	11	0	0	11	0	0
5	20443949	.	A	G	4	7	11	0	1	12	0	0
5	20444017	.	G	T	11	16	27	0	3	30	0	0
5	20444216	.	G	C	22	23	45	0	0	45	0	0
5	20445065	.	G	A	15	15	30	0	1	31	0	0
5	20445985	.	A	T	13	16	29	0	3	32	0	0
5	20446021	.	T	A	12	14	26	0	0	26	0	0
5	20457390	.	C	T	0	1	1	0	0	1	0	0
5	20467641	.	A	G	0	1	1	0	0	1	0	0
5	20471875	.	G	C	14	9	23	0	0	23	0	0
5	20473812	.	A	G	5	1	6	0	15	21	0	0
5	20473818	.	G	A	0	11	11	0	8	19	0	0
5	20474076	.	A	G	7	14	21	0	0	21	0	0
5	20475730	.	A	G	1	4	5	0	0	5	0	0
5	20477419	.	T	C	9	13	22	0	1	23	0	0
5	20479921	.	C	A	4	9	13	0	1	14	0	0
5	20479990	.	A	G	2	9	11	0	2	13	0	0
5	20480036	.	A	T	3	6	9	0	0	9	0	0
5	20480369	.	T	C	7	4	11	0	0	11	0	0
5	20480401	.	G	A	3	4	7	0	0	7	0	0
5	20480758	.	T	A	6	15	21	0	0	21	0	0
5	20481132	.	G	A	6	3	9	0	0	9	0	0
5	20485754	.	G	A	1	6	7	0	0	7	0	0
5	20485769	.	T	C	2	3	5	0	2	7	0	0
5	20485965	.	C	T	4	3	7	0	0	7	0	0
5	20486442	.	T	A	1	6	7	0	0	7	0	0
5	20486444	.	A	T	1	6	7	0	0	7	0	0
5	20486485	.	G	A	3	6	9	0	0	9	0	0
5	20486727	.	G	T	3	5	8	0	0	8	0	0
5	20486746	.	A	G	3	5	8	0	0	8	0	0
5	20487175	.	A	G	4	5	9	0	1	10	0	0
5	20487328	.	G	A	6	3	9	0	0	9	0	0
5	20487379	.	G	A	6	3	9	0	1	10	0	0
5	20487433	.	C	T	3	2	5	0	0	5	0	0
5	20487490	.	A	G	0	3	3	0	0	3	0	0
5	20590725	.	C	T	1	4	5	0	0	5	0	0
5	20590730	.	T	C	1	4	5	0	0	5	0	0
5	20627556	.	G	T	3	4	7	0	0	7	0	0
5	20627569	.	A	G	2	4	6	0	0	6	0	0
5	20627917	.	T	G	1	2	3	0	1	4	0	0
5	20628036	.	G	A	4	5	9	0	0	9	0	0
5	20638976	.	A	T	1	2	3	0	0	3	0	0
5	20639246	.	G	T	1	2	3	0	0	3	0	0
5	20639285	.	C	G	0	2	2	0	1	3	0	0
5	20647434	.	A	G	1	2	3	0	0	3	0	0
5	20678070	.	T	C	4	4	8	0	0	8	0	0
5	20678159	.	T	C	2	0	2	0	4	6	0	0
5	20787995	.	C	T	6	2	8	0	0	8	0	0
5	20933321	.	C	A	0	39	39	0	1	40	0	0
5	20933332	.	T	C	0	3	3	0	41	44	0	0
5	21295883	.	G	A	7	13	20	0	1	21	0	0
5	21296027	.	T	C	14	0	14	0	6	20	0	0
5	21296298	.	C	G	4	11	15	0	0	15	0	0
5	21296363	.	T	C	5	0	5	0	12	17	0	0
5	21296527	.	A	G	16	13	29	0	0	29	0	0
5	21296693	.	G	T	17	20	37	0	0	37	0	0
5	21296720	.	T	A	12	14	26	0	1	27	0	0
5	21296822	.	T	C	15	11	26	0	1	27	0	0
5	21297014	.	A	G	6	16	22	0	0	22	0	0
5	21297188	.	A	T	5	15	20	0	1	21	0	0
5	21297320	.	G	A	0	1	1	0	0	1	0	0
5	21301127	.	A	G	6	9	15	0	0	15	0	0
5	21301232	.	C	A	0	6	6	0	3	9	0	0
5	21301322	.	T	C	6	8	14	0	0	14	0	0
5	21301424	.	T	C	13	0	13	0	10	23	0	0
5	21301445	.	A	G	17	7	24	0	0	24	0	0
5	21302012	.	A	G	8	5	13	0	1	14	0	0
5	21309754	.	T	C	9	0	9	0	8	17	0	0
5	21309886	.	G	A	5	2	7	0	1	8	0	0
5	21331520	.	C	T	2	5	7	0	0	7	0	0
5	21334671	.	C	T	4	7	11	0	1	12	0	0
5	21340998	.	A	G	5	4	9	0	0	10	1	0
5	21341060	.	A	T	6	2	8	0	0	8	0	0
5	21359091	.	C	T	0	4	4	0	2	6	0	0
5	21384089	.	C	T	0	5	5	0	3	8	0	0
5	21422329	.	A	G	2	6	8	0	0	8	0	0
5	21460310	.	G	A	0	1	1	0	0	1	0	0
5	21471337	.	C	T	0	4	4	0	0	4	0	0
5	22012452	.	T	C	8	3	11	0	0	11	0	0
5	22012459	.	T	C	5	7	12	0	0	12	0	0
5	22012895	.	T	C	6	7	13	0	0	13	0	0
5	22013511	.	A	T	4	3	7	0	0	7	0	0
5	22013581	.	G	A	8	3	11	0	0	11	0	0
5	22013658	.	G	A	10	5	15	0	1	16	0	0
5	22013712	.	A	G	8	9	17	0	0	17	0	0
5	22013913	.	C	T	3	2	5	0	0	5	0	0
5	22013985	.	T	C	1	0	1	0	2	3	0	0
5	22014062	.	C	T	1	3	4	0	0	4	0	0
5	22014129	.	T	G	3	4	7	0	0	7	0	0
5	22014560	.	C	G	2	3	5	0	0	5	0	0
5	22014589	.	G	A	3	3	6	0	0	6	0	0
5	22015475	.	A	T	2	3	5	0	1	6	0	0
5	22015496	.	G	A	1	5	6	0	0	6	0	0
5	22015568	.	A	C	2	3	5	0	0	5	0	0
5	22015583	.	G	A	1	3	4	0	2	6	0	0
5	22015749	.	G	C	3	3	6	0	0	6	0	0
5	22015759	.	G	C	3	4	7	0	0	7	0	0
5	22015952	.	T	C	1	3	4	0	0	4	0	0
5	22015991	.	G	A	0	4	4	0	0	4	0	0
5	22016003	.	A	G	0	5	5	0	0	5	0	0
5	22016668	.	G	A	2	3	5	0	0	5	0	0
5	22016831	.	T	C	3	3	6	0	1	7	0	0
5	22017104	.	T	C	5	0	5	0	5	10	0	0
5	22017149	.	A	G	2	4	6	0	0	6	0	0
5	22021447	.	A	T	1	4	5	0	1	6	0	0
5	22024040	.	A	C	3	2	5	0	0	5	0	0
5	22025729	.	C	A	0	1	1	0	0	1	0	0
5	22025876	.	T	C	2	0	2	0	2	4	0	0
5	22025891	.	C	T	1	1	2	0	0	2	0	0
5	22028901	.	G	C	0	2	2	0	0	2	0	0
5	22032743	.	C	T	0	2	2	0	0	2	0	0
5	22036356	.	A	G	1	0	1	0	0	1	0	0
5	22073989	.	A	T	18	14	32	0	4	36	0	0
5	22074040	.	C	T	11	21	32	0	1	34	1	0
5	22074118	.	A	T	13	11	24	0	0	24	0	0
5	22074132	.	T	C	9	12	21	0	2	23	0	0
5	22074376	.	C	T	1	14	15	0	22	37	0	0
5	22074407	.	C	T	16	14	30	0	0	30	0	0
5	22082786	.	T	C	12	15	27	0	2	29	0	0
5	22098739	.	C	T	8	4	12	0	1	13	0	0
5	22098790	.	G	A	0	6	6	0	3	9	0	0
5	22106043	.	C	G	8	0	8	0	5	13	0	0
5	22106168	.	T	G	8	0	8	0	9	17	0	0
5	22106174	.	T	C	8	10	18	0	0	18	0	0
5	22106264	.	T	C	5	9	14	0	1	15	0	0
5	22106306	.	C	T	3	5	8	0	0	8	0	0
5	22115256	.	G	A	5	4	9	0	1	10	0	0
5	22115277	.	A	G	5	4	9	0	0	9	0	0
5	22115319	.	C	T	2	4	6	0	0	6	0	0
5	22115579	.	A	G	4	7	11	0	0	11	0	0
5	22115786	.	C	T	1	5	6	0	0	6	0	0
5	22115821	.	A	C	3	3	6	0	0	6	0	0
5	22115915	.	G	T	5	5	10	0	0	10	0	0
5	22121467	.	G	A	5	8	13	0	1	14	0	0
5	22123288	.	G	T	6	0	6	0	0	6	0	0
5	22127703	.	T	A	2	3	5	0	0	5	0	0
5	22161350	.	T	C	3	3	6	0	0	6	0	0
5	22161359	.	T	C	3	2	5	0	0	5	0	0
5	22163437	.	C	T	4	1	5	0	0	5	0	0
5	22172454	.	A	C	4	4	8	0	1	9	0	0
5	22172613	.	T	A	5	7	12	0	0	13	1	0
5	22172809	.	A	T	5	3	8	0	0	8	0	0
5	22172810	.	G	A	5	3	8	0	0	8	0	0
5	22173409	.	G	A	9	9	18	0	0	18	0	0
5	22173691	.	T	A	8	9	17	0	1	18	0	0
5	22173875	.	T	G	15	1	16	0	8	24	0	0
5	22173999	.	C	T	5	5	10	0	4	14	0	0
5	22465140	.	A	G	6	6	12	0	1	13	0	0
5	22465152	.	A	C	5	4	9	0	1	10	0	0
5	22465206	.	A	G	9	5	14	0	1	15	0	0
5	22473572	.	T	C	14	7	21	0	0	21	0	0
5	22473746	.	C	T	12	10	22	0	2	24	0	0
5	22474043	.	A	T	9	10	19	0	0	19	0	0
5	22474151	.	G	A	12	9	21	0	0	21	0	0
5	22474349	.	A	G	15	20	35	0	0	35	0	0
5	22476208	.	G	A	1	2	3	0	0	3	0	0
5	22479469	.	C	T	14	7	21	0	0	21	0	0
5	22479571	.	T	C	7	0	7	0	4	11	0	0
5	22481954	.	A	G	6	3	9	0	0	9	0	0
5	22482071	.	T	C	5	3	8	0	0	8	0	0
5	22482875	.	A	G	5	4	9	0	0	9	0	0
5	22484165	.	G	C	12	4	16	0	1	17	0	0
5	22485748	.	T	C	1	1	2	0	0	2	0	0
5	22489258	.	A	G	5	2	7	0	0	7	0	0
5	22489369	.	A	G	13	15	28	0	1	29	0	0
5	22489390	.	G	A	12	15	27	0	0	27	0	0
5	22489501	.	G	A	3	3	6	0	1	7	0	0
5	22501577	.	G	A	8	7	15	0	1	16	0	0
5	22544064	.	C	T	1	2	3	0	0	3	0	0
5	22550983	.	G	A	12	10	22	0	0	22	0	0
5	22550990	.	A	G	14	11	25	0	0	25	0	0
5	22557201	.	T	C	1	0	1	0	0	1	0	0
5	22557626	.	T	G	0	1	1	0	0	1	0	0
5	22560446	.	G	A	0	7	7	0	0	7	0	0
5	22562118	.	A	G	9	3	12	0	0	12	0	0
5	22562154	.	T	C	7	0	7	0	3	10	0	0
5	22562177	.	T	A	3	3	6	0	1	7	0	0
5	22564726	.	A	T	3	3	6	0	1	7	0	0
5	22564829	.	G	A	4	5	9	0	0	9	0	0
5	22564843	.	G	A	5	5	10	0	0	10	0	0
5	22564997	.	G	T	2	0	2	0	0	2	0	0
5	22569353	.	G	T	1	2	3	0	0	3	0	0
5	22571595	.	C	A	5	1	6	0	0	6	0	0
5	22573616	.	T	C	6	0	6	0	9	15	0	0
5	22593801	.	A	G	10	8	18	0	0	18	0	0
5	22593877	.	G	A	13	15	28	0	2	30	0	0
5	22593882	.	T	A	11	16	27	0	2	29	0	0
5	22593930	.	A	G	13	23	36	0	1	37	0	0
5	22596067	.	T	C	9	14	23	0	3	26	0	0
5	22598531	.	C	G	2	1	3	0	0	3	0	0
5	22598746	.	G	A	8	14	22	0	1	23	0	0
5	22600498	.	A	C	9	0	9	0	10	20	1	0
5	22600552	.	A	G	8	14	22	0	1	23	0	0
5	22600579	.	A	G	7	9	16	0	0	16	0	0
5	22605931	.	A	T	8	2	10	0	0	10	0	0
5	22606052	.	A	G	8	3	11	0	0	11	0	0
5	22606101	.	A	T	8	5	13	0	0	13	0	0
5	22606323	.	A	C	9	3	12	0	1	13	0	0
5	22683531	.	C	T	13	16	29	0	1	30	0	0
5	22683556	.	G	A	12	15	27	0	1	28	0	0
5	22683732	.	G	T	15	16	31	0	4	35	0	0
5	22683836	.	G	A	16	12	28	0	2	30	0	0
5	22822569	.	C	T	2	1	3	0	0	3	0	0
5	22830639	.	A	T	3	4	7	0	0	7	0	0
5	22851915	.	T	A	5	6	11	0	1	12	0	0
5	22852200	.	C	T	10	4	14	0	0	14	0	0
5	22852263	.	G	A	4	3	7	0	2	9	0	0
5	22856713	.	C	T	0	1	1	0	2	3	0	0
5	22856939	.	T	G	14	12	26	0	0	26	0	0
5	22857069	.	T	G	8	10	18	0	0	18	0	0
5	22857109	.	G	A	3	11	14	0	2	16	0	0
5	22858028	.	A	G	2	1	3	0	0	3	0	0
5	22860557	.	C	T	2	5	7	0	0	7	0	0
5	22860577	.	C	T	0	5	5	0	2	7	0	0
5	22860626	.	T	C	2	0	2	0	0	2	0	0
5	22860897	.	A	G	1	2	3	0	1	4	0	0
5	22872067	.	A	C	11	15	26	0	0	26	0	0
5	22872627	.	A	T	18	12	30	0	2	32	0	0
5	22873075	.	C	T	6	0	6	0	5	11	0	0
5	22876443	.	T	A	0	1	1	0	0	1	0	0
5	22876475	.	G	T	3	6	9	0	0	9	0	0
5	22876587	.	G	A	15	14	29	0	1	30	0	0
5	22876890	.	A	G	12	15	27	0	0	27	0	0
5	22879260	.	T	C	1	1	2	0	0	2	0	0
5	22888231	.	G	A	13	18	31	0	0	31	0	0
5	22888369	.	G	A	3	2	5	0	0	5	0	0
5	22916732	.	A	G	2	1	3	0	0	3	0	0
5	22916789	.	G	A	3	6	9	0	0	9	0	0
5	22971151	.	T	C	6	0	6	0	0	6	0	0
5	22971270	.	G	A	0	1	1	0	3	4	0	0
5	22971463	.	T	C	10	6	16	0	1	17	0	0
5	22972573	.	A	G	27	23	50	0	2	52	0	0
5	22972597	.	A	C	23	24	47	0	4	52	1	0
5	22980250	.	G	A	0	1	1	0	0	1	0	0
5	22989109	.	A	G	3	0	3	0	6	9	0	0
5	22989148	.	T	C	1	3	4	0	0	4	0	0
5	23014929	.	C	T	2	0	2	0	0	2	0	0
5	23019939	.	G	A	1	3	4	0	2	6	0	0
5	23020075	.	G	C	9	5	14	0	0	14	0	0
5	23020084	.	C	T	7	7	14	0	0	14	0	0
5	23026604	.	G	A	10	6	16	0	1	17	0	0
5	23027597	.	G	C	14	11	25	0	1	27	1	0
5	23027642	.	A	C	10	15	25	0	0	25	0	0
5	23027770	.	T	C	13	16	29	0	2	31	0	0
5	23027937	.	C	T	17	17	34	0	0	34	0	0
5	23028131	.	C	A	5	4	9	0	1	10	0	0
5	23045605	.	G	T	1	1	2	0	0	2	0	0
5	23056697	.	A	G	6	6	12	0	0	12	0	0
5	23076015	.	C	T	1	1	2	0	0	2	0	0
5	23079094	.	A	G	2	1	3	0	1	4	0	0
5	23107566	.	A	C	2	3	5	0	0	5	0	0
5	23107571	.	G	A	2	3	5	0	0	5	0	0
5	23107927	.	C	T	5	8	13	0	0	13	0	0
5	23108019	.	G	A	7	11	18	0	1	19	0	0
5	23108042	.	T	A	8	8	16	0	1	17	0	0
5	23108128	.	G	A	18	17	35	0	1	36	0	0
5	23110281	.	A	G	13	8	21	0	5	26	0	0
5	23110311	.	C	T	4	5	9	0	1	10	0	0
5	23118253	.	A	T	5	9	14	0	1	15	0	0
5	23125545	.	G	A	2	1	3	0	0	3	0	0
5	23125555	.	C	T	2	4	6	0	1	7	0	0
5	23126065	.	C	T	7	12	19	0	0	19	0	0
5	23126431	.	C	T	8	9	17	0	0	17	0	0
5	23126464	.	T	G	7	0	7	0	12	19	0	0
5	23126500	.	G	A	4	11	15	0	0	15	0	0
5	23126677	.	C	G	13	8	21	0	0	21	0	0
5	23126856	.	C	G	9	7	16	0	1	17	0	0
5	23127025	.	C	T	6	12	18	0	2	20	0	0
5	23127376	.	T	C	15	16	31	0	1	32	0	0
5	23127418	.	C	T	16	16	32	0	1	33	0	0
5	23127451	.	A	G	22	12	34	0	0	34	0	0
5	23127946	.	T	G	15	18	33	0	1	34	0	0
5	23127979	.	A	G	16	19	35	0	1	36	0	0
5	23128135	.	T	C	14	17	31	0	0	31	0	0
5	23128651	.	A	C	8	17	25	0	1	26	0	0
5	23128696	.	T	A	7	9	16	0	0	16	0	0
5	23128714	.	C	A	7	8	15	0	1	16	0	0
5	23128957	.	T	C	2	7	9	0	1	10	0	0
5	23129161	.	C	T	19	8	27	0	3	30	0	0
5	23129902	.	G	T	11	10	21	0	0	21	0	0
5	23130629	.	T	C	16	24	40	0	1	41	0	0
5	23130970	.	C	T	10	16	26	0	1	27	0	0
5	23131106	.	G	C	13	18	31	0	0	31	0	0
5	23131147	.	T	C	14	13	27	0	1	28	0	0
5	23132256	.	G	T	1	2	3	0	0	3	0	0
5	23136635	.	G	A	14	6	20	0	0	20	0	0
5	23140527	.	T	G	2	8	10	0	0	10	0	0
5	23140548	.	A	G	0	0	0	0	2	2	0	0
5	23143454	.	G	T	10	12	22	0	1	23	0	0
5	23143725	.	A	G	9	0	9	0	15	24	0	0
5	23143755	.	C	T	14	17	31	0	0	31	0	0
5	23146414	.	T	C	3	5	8	0	0	8	0	0
5	23146537	.	G	A	0	21	21	0	10	31	0	0
5	23146576	.	T	A	14	18	32	0	1	33	0	0
5	23146790	.	G	T	19	16	35	0	0	35	0	0
5	23146897	.	T	G	2	9	11	0	2	13	0	0
5	23147118	.	C	A	6	8	14	0	0	14	0	0
5	23147127	.	T	C	7	8	15	0	0	15	0	0
5	23147185	.	T	A	9	12	21	0	0	21	0	0
5	23147479	.	C	G	16	10	26	0	0	26	0	0
5	23177291	.	G	A	1	2	3	0	0	3	0	0
5	23177304	.	G	A	1	2	3	0	1	4	0	0
5	23223647	.	T	A	0	3	3	0	0	3	0	0
5	23230692	.	C	T	3	4	7	0	0	7	0	0
5	23230877	.	A	G	2	0	2	0	3	5	0	0
5	23231042	.	A	G	6	4	10	0	0	10	0	0
5	23231125	.	C	A	2	3	5	0	0	5	0	0
5	23268370	.	A	C	32	32	64	0	4	68	0	0
5	23268371	.	C	A	35	32	67	0	1	68	0	0
5	23268542	.	T	G	36	33	69	0	23	92	0	0
5	23268785	.	C	G	41	71	112	0	3	115	0	0
5	23272981	.	T	G	4	4	8	0	1	9	0	0
5	23273487	.	G	A	20	25	45	0	0	45	0	0
5	23275945	.	G	A	1	1	2	0	0	2	0	0
5	23276037	.	G	A	33	22	55	0	1	56	0	0
5	23277139	.	G	A	26	44	70	0	8	78	0	0
5	23277816	.	C	A	23	18	41	0	0	41	0	0
5	23284014	.	T	C	15	6	21	0	1	22	0	0
5	23284867	.	A	G	10	8	18	0	0	18	0	0
5	23285133	.	T	C	12	7	19	0	1	20	0	0
5	23285206	.	G	A	17	16	33	0	0	33	0	0
5	23285546	.	A	G	25	17	42	0	2	44	0	0
5	23285554	.	A	G	23	20	43	0	1	44	0	0
5	23285611	.	G	A	18	25	43	0	3	46	0	0
5	23286004	.	A	G	23	22	45	0	1	46	0	0
5	23286280	.	A	G	19	23	42	0	0	42	0	0
5	23286361	.	A	G	19	17	36	0	1	37	0	0
5	23286376	.	G	A	20	18	38	0	0	38	0	0
5	23288545	.	A	G	16	9	25	0	1	26	0	0
5	23288560	.	C	T	15	11	26	0	0	26	0	0
5	23288653	.	G	A	9	8	17	0	0	17	0	0
5	23288710	.	T	C	6	1	7	0	11	18	0	0
5	23288725	.	C	T	4	10	14	0	0	14	0	0
5	23316807	.	C	T	3	0	3	0	0	3	0	0
5	23353648	.	A	G	23	21	44	0	0	44	0	0
5	23357357	.	T	A	1	3	4	0	1	5	0	0
5	23386277	.	C	T	4	16	20	0	0	20	0	0
5	23389025	.	C	T	0	10	10	0	13	23	0	0
5	23389190	.	A	G	12	11	23	0	0	23	0	0
5	23389268	.	G	A	8	6	14	0	0	14	0	0
5	23397221	.	T	C	5	0	5	0	0	5	0	0
5	23417421	.	G	C	8	12	20	0	1	21	0	0
5	23428594	.	C	T	0	8	8	0	5	13	0	0
5	23575682	.	T	C	3	3	6	0	0	6	0	0
5	23575683	.	T	C	1	5	6	0	0	6	0	0
5	24002991	.	C	T	10	3	13	0	0	13	0	0
5	24129047	.	A	T	6	8	14	0	1	15	0	0
5	24129122	.	C	T	0	5	5	0	0	5	0	0
5	24130706	.	T	C	4	12	16	0	0	16	0	0
5	24130715	.	C	T	3	11	14	0	2	16	0	0
5	24130809	.	C	T	11	9	20	0	0	20	0	0
5	24131320	.	A	C	9	9	18	0	2	20	0	0
5	24131611	.	A	G	7	11	18	0	0	18	0	0
5	24132457	.	G	A	6	5	11	0	0	11	0	0
5	24132615	.	T	C	7	7	14	0	0	14	0	0
5	24133732	.	G	A	0	10	10	0	9	19	0	0
5	24134952	.	A	T	1	1	2	0	0	2	0	0
5	24134997	.	A	T	6	7	13	0	1	14	0	0
5	24135361	.	G	T	0	10	10	0	17	27	0	0
5	24138964	.	G	A	2	5	7	0	1	8	0	0
5	24147508	.	C	G	6	6	12	0	0	12	0	0
5	24147529	.	A	G	8	7	15	0	0	15	0	0
5	24148419	.	T	G	4	4	8	0	1	9	0	0
5	24148431	.	C	T	4	4	8	0	2	10	0	0
5	24153202	.	C	T	0	2	2	0	0	2	0	0
5	24153253	.	G	C	3	10	13	0	0	13	0	0
5	24153289	.	T	C	5	0	5	0	10	15	0	0
5	24153331	.	T	C	8	0	8	0	7	15	0	0
5	24153403	.	C	T	2	8	10	0	1	11	0	0
5	24153441	.	T	C	5	9	14	0	0	14	0	0
5	24153887	.	C	T	0	2	2	0	0	2	0	0
5	24156193	.	G	A	0	0	0	0	1	1	0	0
5	24157083	.	C	T	3	5	8	0	1	9	0	0
5	24162191	.	T	G	2	8	10	0	0	10	0	0
5	24162679	.	T	C	2	3	5	0	0	5	0	0
5	24163000	.	T	A	1	3	4	0	0	4	0	0
5	24163098	.	A	G	4	3	7	0	0	7	0	0
5	24181685	.	A	C	1	2	3	0	0	3	0	0
5	24184011	.	G	A	4	2	6	0	0	6	0	0
5	24184273	.	T	G	1	3	4	0	0	4	0	0
5	24184285	.	A	T	1	4	5	0	0	5	0	0
5	24184520	.	A	G	3	2	5	0	0	5	0	0
5	24184523	.	C	T	3	2	5	0	0	5	0	0
5	24184613	.	C	T	4	3	7	0	1	8	0	0
5	24184920	.	T	C	2	3	5	0	0	5	0	0
5	24184988	.	A	T	3	2	5	0	0	5	0	0
5	24185470	.	C	A	2	3	5	0	1	6	0	0
5	24185593	.	G	T	0	4	4	0	3	7	0	0
5	24185629	.	G	A	3	3	6	0	0	6	0	0
5	24185648	.	A	T	2	3	5	0	1	6	0	0
5	24199739	.	T	C	10	10	20	1	2	23	0	0
5	24199757	.	T	A	9	13	22	1	1	24	0	0
5	24199987	.	C	A	7	7	14	0	2	16	0	0
5	24200017	.	C	A	6	11	17	0	1	18	0	0
5	24200259	.	T	C	5	10	15	0	0	15	0	0
5	24200592	.	G	A	11	8	19	0	0	19	0	0
5	24200611	.	G	A	13	8	21	0	1	22	0	0
5	24201232	.	G	T	2	9	11	0	0	11	0	0
5	24208781	.	G	C	27	29	56	0	2	58	0	0
5	24208900	.	G	C	18	1	19	0	31	51	1	0
5	24209088	.	C	T	16	23	39	0	0	39	0	0
5	24209293	.	A	T	26	26	52	0	1	53	0	0
5	24209460	.	A	G	26	29	55	1	2	58	0	0
5	24213273	.	T	G	26	16	42	0	0	42	0	0
5	24213291	.	T	C	19	0	19	0	10	29	0	0
5	24223890	.	G	T	3	3	6	0	0	6	0	0
5	24227532	.	A	G	7	7	14	0	1	15	0	0
5	24227658	.	C	T	7	3	10	0	0	10	0	0
5	24227700	.	T	C	4	4	8	0	1	9	0	0
5	24230996	.	C	T	0	1	1	0	0	1	0	0
5	24231082	.	T	C	3	5	8	0	0	8	0	0
5	24240491	.	C	T	3	3	6	0	0	6	0	0
5	24240586	.	A	T	5	1	6	0	2	8	0	0
5	24240866	.	C	T	2	6	8	0	0	8	0	0
5	24240932	.	T	C	7	6	13	0	0	13	0	0
5	24240968	.	T	A	10	4	14	0	1	15	0	0
5	24244891	.	G	T	3	6	9	0	0	9	0	0
5	24244952	.	G	T	2	6	8	0	0	8	0	0
5	24245085	.	T	A	1	2	3	0	0	3	0	0
5	24252744	.	A	G	4	7	11	0	1	12	0	0
5	24256387	.	G	A	14	10	24	0	1	25	0	0
5	24259642	.	A	G	26	1	27	0	22	49	0	0
5	24259980	.	T	G	4	4	8	0	2	10	0	0
5	24288003	.	T	C	1	2	3	0	0	3	0	0
5	24288089	.	G	A	0	2	2	0	3	5	0	0
5	24330025	.	A	G	1	2	3	0	0	3	0	0
5	24330492	.	A	G	8	3	11	0	1	12	0	0
5	24330527	.	T	C	6	0	6	0	7	13	0	0
5	24330840	.	G	T	15	6	21	0	1	22	0	0
5	24330932	.	C	A	11	9	20	0	0	20	0	0
5	24331724	.	G	C	6	7	13	0	0	13	0	0
5	24331840	.	T	A	6	11	17	0	1	18	0	0
5	24332216	.	T	G	2	3	5	0	0	5	0	0
5	24333135	.	C	T	2	11	13	0	0	13	0	0
5	24333612	.	C	G	2	3	5	0	0	5	0	0
5	24511111	.	C	T	0	14	14	0	12	26	0	0
5	24511748	.	G	A	2	7	9	0	0	9	0	0
5	24513193	.	G	A	9	5	14	0	0	14	0	0
5	24516819	.	A	G	5	2	7	0	1	8	0	0
5	24521812	.	G	A	9	8	17	0	1	18	0	0
5	24522206	.	A	T	12	11	23	0	2	25	0	0
5	24530663	.	A	T	10	13	23	0	0	23	0	0
5	24530853	.	C	T	6	9	15	0	3	18	0	0
5	24531370	.	C	T	6	7	13	0	6	19	0	0
5	24531538	.	T	G	8	13	21	0	1	22	0	0
5	24531854	.	A	T	0	3	3	0	0	3	0	0
5	24532661	.	T	C	1	0	1	0	2	3	0	0
5	24535171	.	C	A	3	1	4	0	0	4	0	0
5	24535421	.	G	T	1	4	5	0	0	5	0	0
5	24542259	.	G	A	2	6	8	0	1	9	0	0
5	24542389	.	G	A	2	2	4	0	0	4	0	0
5	24542490	.	G	A	1	3	4	0	0	4	0	0
5	24544099	.	A	T	2	2	4	0	0	4	0	0
5	24563811	.	G	A	0	4	4	0	1	5	0	0
5	24566917	.	A	G	4	3	7	0	0	7	0	0
5	24567297	.	C	T	5	4	9	0	0	9	0	0
5	24567351	.	G	A	0	5	5	0	6	11	0	0
5	24567460	.	C	A	1	3	4	0	0	4	0	0
5	24578500	.	C	A	1	2	3	0	0	3	0	0
5	24584547	.	C	T	0	1	1	0	0	1	0	0
5	24596078	.	G	C	3	0	3	0	4	7	0	0
5	24596080	.	C	T	0	4	4	0	3	7	0	0
5	24712264	.	G	A	2	6	8	0	0	8	0	0
5	24756844	.	G	A	2	17	19	0	2	21	0	0
5	24756845	.	A	G	9	11	20	0	1	21	0	0
5	24756967	.	A	T	18	17	35	0	0	35	0	0
5	24757494	.	A	C	2	2	4	0	0	4	0	0
5	24757497	.	C	A	2	2	4	0	0	4	0	0
5	24757561	.	A	T	2	3	5	0	1	6	0	0
5	24757656	.	A	G	5	11	16	0	0	16	0	0
5	24757748	.	T	A	8	3	11	0	1	13	1	0
5	24757916	.	G	A	13	9	22	0	0	22	0	0
5	24757952	.	A	T	9	9	18	0	0	18	0	0
5	24757976	.	G	A	6	8	14	0	0	14	0	0
5	24758013	.	C	T	0	3	3	0	2	5	0	0
5	24768725	.	A	G	2	2	4	0	0	4	0	0
5	24772801	.	C	T	1	2	3	0	1	4	0	0
5	24778244	.	A	G	4	8	12	0	1	13	0	0
5	24790326	.	C	A	2	6	8	0	0	8	0	0
5	24790335	.	C	T	1	6	7	0	1	8	0	0
5	24796678	.	G	A	5	2	7	0	0	7	0	0
5	24800407	.	T	C	2	5	7	0	0	7	0	0
5	24803418	.	A	G	0	1	1	0	0	1	0	0
5	24816788	.	A	T	3	2	5	0	0	5	0	0
5	24816854	.	T	A	2	4	6	0	0	6	0	0
5	24817014	.	C	G	10	13	23	0	0	23	0	0
5	24817142	.	A	T	5	8	13	0	1	14	0	0
5	24817445	.	A	G	4	5	9	0	0	9	0	0
5	24817450	.	T	C	3	3	6	0	2	8	0	0
5	24817674	.	T	C	2	7	9	0	1	10	0	0
5	24817800	.	A	G	0	5	5	0	1	6	0	0
5	24817806	.	T	C	1	0	1	0	5	6	0	0
5	24818461	.	T	C	5	2	7	0	0	7	0	0
5	24818564	.	T	C	5	7	12	0	0	12	0	0
5	24818969	.	T	C	1	0	1	0	3	4	0	0
5	24818990	.	T	C	3	3	6	0	0	6	0	0
5	24820603	.	G	T	2	5	7	0	0	7	0	0
5	24826299	.	G	A	9	5	14	0	0	14	0	0
5	24826464	.	C	T	0	0	0	0	5	5	0	0
5	24875585	.	G	T	0	8	8	0	0	8	0	0
5	24878111	.	A	G	0	0	0	10	0	10	0	0
5	24886066	.	T	C	3	2	5	0	0	5	0	0
5	24887472	.	T	G	5	7	12	0	1	13	0	0
5	24887541	.	G	T	15	9	24	0	3	27	0	0
5	24887707	.	C	T	6	3	9	0	2	11	0	0
5	24887828	.	A	G	4	9	13	0	1	14	0	0
5	24887830	.	T	A	5	9	14	0	0	14	0	0
5	24909161	.	C	T	1	0	1	0	2	3	0	0
5	25046430	.	C	A	3	4	7	0	0	7	0	0
5	25046440	.	C	T	3	3	6	0	0	6	0	0
5	25047223	.	T	C	1	2	3	0	0	3	0	0
5	25047527	.	G	A	3	1	4	0	0	4	0	0
5	25055473	.	C	T	2	3	5	0	0	5	0	0
5	25068442	.	T	C	1	0	1	0	0	1	0	0
5	25074812	.	C	T	18	9	27	0	1	28	0	0
5	25074917	.	C	T	12	10	22	0	0	22	0	0
5	25077792	.	G	A	1	5	6	0	1	7	0	0
5	25084459	.	A	T	1	2	3	0	1	4	0	0
5	25084499	.	C	T	2	4	6	0	0	6	0	0
5	25085351	.	G	A	1	2	3	0	0	3	0	0
5	25089174	.	A	G	9	12	21	0	1	22	0	0
5	25089212	.	C	T	0	12	12	0	7	19	0	0
5	25094191	.	G	A	8	4	12	0	2	14	0	0
5	25094203	.	G	T	11	6	17	0	1	18	0	0
5	25100142	.	C	T	8	5	13	0	3	16	0	0
5	25100473	.	C	T	0	5	5	0	8	13	0	0
5	25100494	.	G	A	7	9	16	0	0	16	0	0
5	25101971	.	G	A	8	12	20	0	1	21	0	0
5	25102013	.	A	G	16	13	29	0	0	29	0	0
5	25102025	.	C	A	14	10	24	0	1	25	0	0
5	25104670	.	G	A	11	9	20	0	0	20	0	0
5	25104733	.	C	A	2	3	5	0	0	5	0	0
5	25107035	.	T	C	7	0	7	0	4	11	0	0
5	25115171	.	T	A	3	2	5	0	0	5	0	0
5	25115210	.	C	T	0	2	2	0	3	5	0	0
5	25118134	.	C	G	3	1	4	0	0	4	0	0
5	25119495	.	T	C	0	0	0	0	1	1	0	0
5	25122848	.	T	C	3	4	7	0	0	7	0	0
5	25122851	.	A	G	2	4	6	0	1	7	0	0
5	25129252	.	A	G	0	1	1	0	0	1	0	0
5	25129312	.	C	T	1	6	7	0	2	9	0	0
5	25129378	.	T	C	2	0	2	0	5	7	0	0
5	25129690	.	C	T	1	0	1	0	0	1	0	0
5	25141763	.	C	T	2	1	3	0	0	3	0	0
5	25141784	.	A	G	1	0	1	0	0	1	0	0
5	25143264	.	G	A	1	2	3	0	0	3	0	0
5	25143277	.	A	C	3	2	5	0	0	5	0	0
5	25156822	.	C	T	1	1	2	0	0	2	0	0
5	25163928	.	G	A	2	4	6	0	0	6	0	0
5	25236262	.	C	T	1	2	3	0	0	3	0	0
5	25311388	.	T	A	4	6	10	0	0	10	0	0
5	25311468	.	T	C	6	3	9	0	0	9	0	0
5	25311636	.	G	A	0	6	6	0	7	13	0	0
5	25314181	.	C	G	4	13	17	0	0	17	0	0
5	25314213	.	G	A	7	5	12	0	0	12	0	0
5	25369772	.	A	G	1	1	2	0	0	2	0	0
5	25372384	.	C	T	0	3	3	0	2	5	0	0
5	25372429	.	C	T	0	1	1	0	3	4	0	0
5	25376277	.	G	T	6	4	10	0	1	11	0	0
5	25376283	.	G	T	6	5	11	0	1	12	0	0
5	25536912	.	A	T	1	2	3	0	0	3	0	0
5	25571629	.	G	A	2	6	8	0	1	9	0	0
5	25572029	.	G	A	4	6	10	0	0	10	0	0
5	25576284	.	A	T	0	3	3	0	0	3	0	0
5	25578601	.	T	G	0	4	4	0	0	4	0	0
5	25607045	.	A	C	3	0	3	0	3	6	0	0
5	25607175	.	T	G	5	4	9	0	0	9	0	0
5	25610212	.	A	T	1	1	2	0	0	2	0	0
5	25610245	.	T	C	1	1	2	0	0	2	0	0
5	25613240	.	T	C	0	1	1	0	0	1	0	0
5	25613887	.	A	G	0	1	1	0	0	1	0	0
5	25613899	.	G	A	0	1	1	0	0	1	0	0
5	25613922	.	T	C	0	0	0	0	1	1	0	0
5	25619266	.	C	T	0	2	2	0	1	3	0	0
5	25683970	.	C	A	3	2	5	0	0	5	0	0
5	25693229	.	C	T	4	5	9	0	0	9	0	0
5	25693550	.	C	A	7	12	19	0	1	20	0	0
5	25693551	.	G	A	12	7	19	0	1	20	0	0
5	25693790	.	T	C	12	15	27	0	1	28	0	0
5	25726642	.	G	T	6	2	8	0	1	9	0	0
5	25726838	.	T	G	1	7	8	0	0	8	0	0
5	25726882	.	T	C	5	0	5	0	5	10	0	0
5	25727267	.	T	C	4	6	10	0	0	10	0	0
5	25728393	.	C	A	7	2	9	0	0	9	0	0
5	25728424	.	T	C	2	3	5	0	0	5	0	0
5	25728428	.	C	T	3	2	5	0	0	5	0	0
5	25729900	.	C	T	0	2	2	0	3	5	0	0
5	25733877	.	T	C	8	9	17	0	0	17	0	0
5	25750414	.	C	T	4	3	7	0	0	7	0	0
5	25753013	.	A	G	1	0	1	0	4	5	0	0
5	25753265	.	C	A	5	8	13	0	1	14	0	0
5	25753410	.	G	A	1	2	3	0	4	7	0	0
5	25753990	.	G	A	8	6	14	0	1	15	0	0
5	25754054	.	T	C	9	6	15	0	0	15	0	0
5	25754092	.	T	C	9	7	16	0	0	16	0	0
5	25754231	.	T	A	2	2	4	0	0	4	0	0
5	25754277	.	A	G	1	2	3	0	0	3	0	0
5	25754396	.	T	C	2	4	6	0	0	6	0	0
5	25754913	.	T	C	0	12	12	0	0	12	0	0
5	25755051	.	G	A	1	2	3	0	0	3	0	0
5	25955323	.	G	C	0	2	2	0	4	6	0	0
5	25962593	.	C	T	3	2	5	0	0	5	0	0
5	26026525	.	C	T	2	1	3	0	0	3	0	0
5	26036099	.	T	C	2	3	5	0	0	5	0	0
5	26036192	.	A	T	3	4	7	0	0	7	0	0
5	26050872	.	C	T	2	0	2	0	0	2	0	0
5	26060141	.	C	T	4	3	7	0	0	7	0	0
5	26061919	.	G	A	5	3	8	0	2	10	0	0
5	26062582	.	A	G	9	7	16	0	0	16	0	0
5	26062888	.	A	G	9	3	12	0	0	12	0	0
5	26075722	.	A	C	5	6	11	0	2	13	0	0
5	26075740	.	C	A	5	8	13	0	0	13	0	0
5	26077444	.	T	A	2	4	6	0	0	6	0	0
5	26077498	.	A	T	8	6	14	0	0	14	0	0
5	26077504	.	G	T	0	5	5	0	8	13	0	0
5	26077666	.	C	T	2	5	7	0	1	8	0	0
5	26077692	.	A	G	3	5	8	0	0	8	0	0
5	26077751	.	T	C	5	7	12	0	0	12	0	0
5	26077762	.	A	T	7	5	12	0	0	12	0	0
5	26077791	.	A	C	10	3	13	0	2	15	0	0
5	26077892	.	T	A	2	3	5	0	1	6	0	0
5	26077909	.	G	T	2	2	4	0	0	4	0	0
5	26082485	.	G	T	13	15	28	0	0	28	0	0
5	26082537	.	T	A	11	21	32	0	1	33	0	0
5	26092042	.	G	A	3	8	11	0	1	12	0	0
5	26093962	.	A	T	13	14	27	0	3	30	0	0
5	26100912	.	A	T	1	2	3	0	0	3	0	0
5	26101020	.	C	T	0	2	2	0	3	5	0	0
5	26101332	.	T	C	6	10	16	0	0	16	0	0
5	26101353	.	C	T	9	8	17	0	1	18	0	0
5	26102115	.	A	G	9	10	19	0	0	19	0	0
5	26102160	.	T	A	7	6	13	0	0	13	0	0
5	26102254	.	G	A	11	4	15	0	1	16	0	0
5	26102258	.	G	C	3	10	13	0	1	14	0	0
5	26102365	.	A	G	4	3	7	0	2	9	0	0
5	26102370	.	C	G	3	5	8	0	0	8	0	0
5	26102692	.	G	C	7	5	12	0	0	12	0	0
5	26102931	.	C	T	6	5	11	0	1	12	0	0
5	26102973	.	A	G	4	6	10	0	0	10	0	0
5	26102986	.	G	A	5	3	8	0	0	8	0	0
5	26103162	.	A	G	5	3	8	0	1	9	0	0
5	26103388	.	A	G	5	2	7	0	0	7	0	0
5	26103521	.	A	C	3	2	5	0	0	5	0	0
5	26109318	.	C	T	6	2	8	0	1	9	0	0
5	26109349	.	A	G	6	4	10	0	0	10	0	0
5	26135751	.	A	G	1	0	1	0	2	3	0	0
5	26145456	.	C	T	3	2	5	0	0	5	0	0
5	26145498	.	A	C	4	0	4	0	0	4	0	0
5	26158745	.	C	G	5	0	5	0	3	8	0	0
5	26158753	.	G	C	3	5	8	0	1	9	0	0
5	26159543	.	G	A	1	1	2	0	1	3	0	0
5	26162632	.	G	A	5	2	7	0	0	7	0	0
5	26165257	.	C	A	1	0	1	0	0	1	0	0
5	26167933	.	G	A	0	1	1	0	0	1	0	0
5	26168758	.	A	T	1	1	2	0	0	2	0	0
5	26168782	.	G	A	3	3	6	0	0	6	0	0
5	26175074	.	C	T	0	2	2	0	0	2	0	0
5	26189514	.	C	A	0	4	4	0	1	5	0	0
5	26192860	.	C	G	0	1	1	0	3	4	0	0
5	26194287	.	C	T	1	2	3	0	0	3	0	0
5	26199422	.	T	A	0	2	2	0	0	2	0	0
5	26199550	.	G	A	0	2	2	0	2	4	0	0
5	26200679	.	T	G	3	4	7	0	0	7	0	0
5	26202863	.	T	A	6	5	11	0	1	12	0	0
5	26202898	.	T	C	2	3	5	0	1	6	0	0
5	26202914	.	T	A	2	4	6	0	0	6	0	0
5	26224496	.	G	A	0	1	1	0	0	1	0	0
5	26232765	.	G	C	9	6	15	0	0	15	0	0
5	26232790	.	A	T	9	8	17	0	0	17	0	0
5	26232915	.	C	A	7	4	11	0	1	12	0	0
5	26232936	.	C	A	7	4	11	0	0	11	0	0
5	26232952	.	T	A	6	4	10	0	0	10	0	0
5	26234645	.	G	A	1	2	3	0	0	3	0	0
5	26234758	.	G	A	1	3	4	0	0	4	0	0
5	26234797	.	C	T	1	0	1	0	0	1	0	0
5	26235098	.	T	C	0	1	1	0	0	1	0	0
5	26235156	.	A	G	1	6	7	0	0	7	0	0
5	26235183	.	C	T	0	5	5	0	0	5	0	0
5	26236243	.	C	T	0	1	1	0	0	1	0	0
5	26238927	.	A	G	2	2	4	0	1	5	0	0
5	26238934	.	T	C	2	2	4	0	1	5	0	0
5	26263562	.	T	A	21	17	38	0	0	38	0	0
5	26274540	.	C	T	0	5	5	0	4	9	0	0
5	26274582	.	C	T	4	5	9	0	0	9	0	0
5	26281262	.	G	T	9	6	15	0	0	15	0	0
5	26281331	.	T	C	2	0	2	0	2	4	0	0
5	26285471	.	G	A	3	0	3	0	0	3	0	0
5	26285474	.	A	G	3	0	3	0	0	3	0	0
5	26330230	.	T	A	10	14	24	0	0	24	0	0
5	26334568	.	G	A	6	2	8	0	0	8	0	0
5	26355982	.	C	T	12	6	18	0	0	18	0	0
5	26356000	.	G	C	15	5	20	0	0	20	0	0
5	26356051	.	C	T	0	4	4	0	6	10	0	0
5	26387686	.	G	A	11	9	20	0	1	21	0	0
5	26493095	.	A	G	3	2	5	0	1	6	0	0
5	26493185	.	G	A	8	5	13	0	0	13	0	0
5	26697420	.	A	G	2	1	3	0	0	3	0	0
5	26721787	.	C	T	1	2	3	0	0	3	0	0
5	26721966	.	T	G	4	2	6	0	0	6	0	0
5	26722268	.	T	G	5	6	11	0	0	11	0	0
5	26722361	.	T	C	3	2	5	0	0	5	0	0
5	26750165	.	A	T	4	2	6	0	0	6	0	0
5	26750291	.	C	A	2	2	4	0	0	4	0	0
5	26756338	.	C	T	3	3	6	0	1	7	0	0
5	26783788	.	G	A	1	2	3	0	0	3	0	0
5	26783802	.	T	G	0	1	1	0	2	3	0	0
5	26787426	.	A	G	6	3	9	0	1	10	0	0
5	26787666	.	A	G	2	5	7	0	1	8	0	0
5	26787668	.	A	G	2	5	7	0	1	8	0	0
5	26789576	.	T	C	4	3	7	0	1	8	0	0
5	26790133	.	C	T	0	1	1	0	0	1	0	0
5	26790339	.	T	C	4	2	6	0	0	6	0	0
5	26790342	.	C	A	4	2	6	0	0	6	0	0
5	26793573	.	G	C	2	4	6	0	1	7	0	0
5	26793625	.	T	A	5	1	6	0	1	7	0	0
5	26795605	.	A	C	5	6	11	0	0	11	0	0
5	26798713	.	C	T	1	1	2	0	0	2	0	0
5	26799142	.	C	T	2	4	6	0	0	6	0	0
5	26802968	.	G	A	6	4	10	0	0	10	0	0
5	26805115	.	G	A	2	1	3	0	0	3	0	0
5	26805168	.	G	A	6	5	11	0	0	11	0	0
5	26805636	.	T	C	0	1	1	0	0	1	0	0
5	26805746	.	G	T	4	2	6	0	0	6	0	0
5	26805748	.	C	A	4	2	6	0	0	6	0	0
5	26806240	.	C	T	4	2	6	0	1	7	0	0
5	26806262	.	G	A	0	1	1	0	0	1	0	0
5	26809221	.	C	T	2	5	7	0	0	7	0	0
5	26814159	.	G	A	0	1	1	0	2	3	0	0
5	26814171	.	C	T	1	2	3	0	0	3	0	0
5	26816779	.	G	A	0	7	7	0	17	24	0	0
5	26823191	.	G	A	4	9	13	0	0	13	0	0
5	26823636	.	C	G	6	13	19	0	0	19	0	0
5	26848020	.	C	T	0	1	1	0	0	1	0	0
5	26850037	.	A	C	1	1	2	0	0	2	0	0
5	26856272	.	C	T	1	1	2	0	0	2	0	0
5	26858053	.	G	A	0	0	0	0	1	1	0	0
5	26859409	.	C	A	3	2	5	0	0	5	0	0
5	26859778	.	G	A	1	3	4	0	0	4	0	0
5	26862098	.	C	T	0	1	1	0	0	1	0	0
5	26866118	.	T	A	2	5	7	0	0	7	0	0
5	26866123	.	T	C	2	5	7	0	0	7	0	0
5	26866284	.	A	G	4	3	7	0	0	7	0	0
5	26866724	.	A	C	1	2	3	0	0	3	0	0
5	26867065	.	T	A	2	4	6	0	0	6	0	0
5	26867066	.	A	T	2	4	6	0	0	6	0	0
5	26867151	.	G	A	5	4	9	0	0	9	0	0
5	26867482	.	G	T	5	6	11	0	0	11	0	0
5	26867516	.	C	A	4	6	10	0	0	10	0	0
5	26868024	.	A	C	1	3	4	0	0	4	0	0
5	26868133	.	A	G	2	3	5	0	0	5	0	0
5	26868223	.	T	C	0	2	2	0	0	2	0	0
5	26868351	.	C	A	3	2	5	0	0	5	0	0
5	26869044	.	G	C	7	9	16	0	1	17	0	0
5	26884809	.	C	T	6	2	8	0	2	10	0	0
5	26884825	.	A	G	7	3	10	0	0	10	0	0
5	26885838	.	T	A	3	5	8	0	0	8	0	0
5	26887993	.	T	C	2	3	5	0	0	5	0	0
5	26921041	.	C	T	6	7	13	0	0	13	0	0
5	27137691	.	G	T	1	3	4	0	0	4	0	0
5	27137703	.	G	A	0	2	2	0	3	5	0	0
5	27137736	.	A	G	3	3	6	0	0	6	0	0
5	27330313	.	C	T	2	0	2	0	0	2	0	0
5	27345083	.	C	T	3	3	6	0	0	6	0	0
5	27345134	.	C	T	3	3	6	0	0	6	0	0
5	27354960	.	A	G	2	2	4	0	0	4	0	0
5	27355029	.	G	T	0	5	5	0	4	9	0	0
5	27375774	.	C	A	4	5	9	0	0	9	0	0
5	27381557	.	G	A	1	2	3	0	0	3	0	0
5	27385471	.	A	G	5	0	5	0	5	10	0	0
5	27392278	.	G	A	6	2	8	0	1	9	0	0
5	27866921	.	G	A	18	8	26	0	1	27	0	0
5	27867129	.	G	A	27	17	44	0	6	50	0	0
5	27924458	.	C	A	4	6	10	0	0	10	0	0
5	27924827	.	A	G	17	20	37	0	0	37	0	0
5	28999854	.	A	G	3	4	7	0	0	7	0	0
5	29088591	.	T	A	1	3	4	0	0	4	0	0
5	29491363	.	A	G	5	2	7	0	1	8	0	0
5	29491467	.	A	T	1	3	4	0	1	5	0	0
5	29495881	.	A	G	1	0	1	0	0	1	0	0
5	29498314	.	G	T	0	0	0	0	1	1	0	0
5	29498332	.	G	A	2	2	4	0	0	4	0	0
5	29508851	.	T	C	3	2	5	0	0	5	0	0
5	29510306	.	C	T	2	1	3	0	0	3	0	0
5	29549047	.	C	T	1	2	3	0	0	3	0	0
5	29549064	.	G	A	2	3	5	0	0	5	0	0
5	29549263	.	A	G	5	2	7	0	0	7	0	0
5	29549279	.	A	G	6	4	10	0	1	11	0	0
5	29551150	.	A	G	1	4	5	0	1	6	0	0
5	29551337	.	C	A	1	0	1	0	0	1	0	0
5	29552891	.	T	C	3	2	5	0	0	5	0	0
5	29556157	.	C	T	2	1	3	0	0	3	0	0
5	29572465	.	T	C	1	3	4	0	0	4	0	0
5	29598008	.	A	G	8	9	17	0	0	17	0	0
5	29598312	.	C	T	0	34	34	0	19	53	0	0
5	29598386	.	A	G	21	17	38	0	2	40	0	0
5	29598425	.	G	A	17	18	35	0	2	37	0	0
5	29598513	.	G	A	26	14	40	0	1	41	0	0
5	29599023	.	A	G	22	21	43	0	1	44	0	0
5	29599236	.	T	C	13	20	33	0	2	35	0	0
5	29599315	.	T	C	23	0	23	0	19	42	0	0
5	29599429	.	A	G	21	22	43	0	2	45	0	0
5	29599754	.	A	T	26	26	52	0	2	54	0	0
5	29599784	.	C	T	25	27	52	0	1	53	0	0
5	29599878	.	A	C	23	23	46	0	2	49	1	0
5	29611084	.	G	A	19	25	44	0	1	45	0	0
5	29614090	.	G	A	5	7	12	0	1	13	0	0
5	29619464	.	G	T	6	18	24	0	0	24	0	0
5	29619500	.	A	G	4	10	14	0	0	14	0	0
5	29622609	.	A	T	1	3	4	0	0	4	0	0
5	29628856	.	A	T	4	1	5	0	1	6	0	0
5	29639357	.	C	T	0	8	8	0	12	20	0	0
5	29639384	.	A	G	16	11	27	0	2	29	0	0
5	29639451	.	T	A	7	7	14	0	2	16	0	0
5	29643158	.	C	T	18	15	33	0	1	34	0	0
5	29658561	.	T	C	1	2	3	0	0	3	0	0
5	29660282	.	C	G	6	0	6	0	6	12	0	0
5	29660509	.	A	T	3	0	3	0	1	4	0	0
5	29661032	.	C	A	3	2	5	0	0	5	0	0
5	29661116	.	T	C	3	2	5	0	0	5	0	0
5	29661119	.	T	C	3	2	5	0	0	5	0	0
5	29661461	.	T	C	3	1	4	0	0	4	0	0
5	29663745	.	T	C	4	7	11	0	0	11	0	0
5	29664763	.	G	A	5	3	8	0	0	8	0	0
5	29666599	.	T	C	5	3	8	0	1	9	0	0
5	29666947	.	G	C	2	6	8	0	0	8	0	0
5	29667260	.	T	C	5	6	11	0	0	11	0	0
5	29667305	.	G	A	4	4	8	0	0	8	0	0
5	29667470	.	A	C	4	3	7	0	1	8	0	0
5	29668519	.	G	A	10	7	17	0	0	17	0	0
5	29668551	.	G	A	9	5	14	0	2	16	0	0
5	29668570	.	G	A	5	5	10	0	0	10	0	0
5	29668676	.	T	C	15	5	20	0	0	20	0	0
5	29668691	.	G	A	14	5	19	0	1	20	0	0
5	29668754	.	C	T	12	5	17	0	2	19	0	0
5	29668867	.	G	A	13	5	18	0	0	18	0	0
5	29684863	.	G	A	0	1	1	0	1	2	0	0
5	29711623	.	A	G	1	0	1	0	2	3	0	0
5	29715284	.	C	T	1	1	2	0	0	2	0	0
5	29720873	.	A	T	1	1	2	0	0	2	0	0
5	29746404	.	T	A	3	4	7	0	1	8	0	0
5	29746419	.	T	C	6	4	10	0	0	10	0	0
5	29746642	.	A	G	2	7	9	0	0	9	0	0
5	29746706	.	A	T	1	6	7	0	0	7	0	0
5	29747027	.	C	T	11	13	24	0	1	26	1	0
5	29747121	.	G	T	14	23	37	0	5	42	0	0
5	29749734	.	T	C	16	14	30	0	1	31	0	0
5	29749827	.	C	G	8	13	21	0	0	21	0	0
5	29750074	.	G	A	9	13	22	0	2	24	0	0
5	29750189	.	T	C	5	9	14	0	0	14	0	0
5	29750285	.	G	A	8	8	16	0	0	16	0	0
5	29784196	.	T	A	2	11	13	0	1	14	0	0
5	29784200	.	G	C	2	14	16	0	0	16	0	0
5	29789706	.	T	C	14	9	23	0	0	23	0	0
5	29790175	.	T	A	17	14	31	0	0	31	0	0
5	29790301	.	G	C	7	10	17	0	1	18	0	0
5	29790390	.	A	C	2	5	7	0	0	7	0	0
5	29817549	.	A	C	2	4	6	0	0	6	0	0
5	29884098	.	T	G	5	5	10	0	1	11	0	0
5	29884125	.	T	C	4	5	9	0	1	10	0	0
5	29886728	.	A	T	1	2	3	0	0	3	0	0
5	29891094	.	A	T	1	1	2	0	0	2	0	0
5	29894003	.	T	C	3	2	5	0	0	5	0	0
5	30053291	.	C	T	0	3	3	0	5	8	0	0
5	30053533	.	G	C	5	2	7	0	0	7	0	0
5	30054062	.	T	C	5	7	12	0	0	12	0	0
5	30054122	.	T	A	9	8	17	0	3	20	0	0
5	30054201	.	T	C	4	0	4	0	7	11	0	0
5	30054203	.	G	T	4	6	10	0	1	11	0	0
5	30054255	.	G	T	4	6	10	0	1	11	0	0
5	30054375	.	C	T	0	2	2	0	1	3	0	0
5	30054566	.	G	A	1	2	3	0	0	3	0	0
5	30055086	.	G	T	2	2	4	0	0	4	0	0
5	30055267	.	A	T	2	3	5	0	0	5	0	0
5	30055294	.	C	T	0	1	1	0	2	3	0	0
5	30055327	.	A	G	2	2	4	0	0	4	0	0
5	30055344	.	C	A	1	4	5	0	0	5	0	0
5	30055382	.	T	C	1	3	4	0	0	4	0	0
5	30055542	.	C	T	0	6	6	0	1	7	0	0
5	30055549	.	A	T	1	6	7	0	1	8	0	0
5	30055648	.	G	A	1	2	3	0	0	3	0	0
5	30056162	.	G	T	2	3	5	0	0	5	0	0
5	30056723	.	A	C	1	3	4	0	0	4	0	0
5	30056993	.	G	C	3	7	10	0	0	10	0	0
5	30057443	.	C	T	0	1	1	0	0	1	0	0
5	30058358	.	C	T	0	2	2	0	2	4	0	0
5	30058412	.	G	A	1	0	1	0	0	1	0	0
5	30060772	.	C	T	0	0	0	0	1	1	0	0
5	30062635	.	G	T	0	2	2	0	0	2	0	0
5	30068381	.	G	C	3	0	3	0	0	3	0	0
5	30068396	.	T	A	6	1	7	0	0	7	0	0
5	30070497	.	C	T	2	1	3	0	0	3	0	0
5	30074289	.	C	T	0	2	2	0	0	2	0	0
5	30081359	.	G	A	10	12	22	0	0	22	0	0
5	30081495	.	G	A	13	8	21	1	2	24	0	0
5	30081737	.	C	T	2	2	4	0	0	4	0	0
5	30087667	.	C	A	2	2	4	0	0	4	0	0
5	30088074	.	C	T	0	3	3	0	1	4	0	0
5	30090364	.	C	A	7	7	14	0	0	14	0	0
5	30145601	.	C	T	2	2	4	0	0	4	0	0
5	30145850	.	A	G	2	3	5	0	0	5	0	0
5	30179479	.	C	G	4	2	6	0	0	6	0	0
5	30179816	.	A	C	1	0	1	0	2	3	0	0
5	30198388	.	C	T	0	2	2	0	0	2	0	0
5	30198389	.	C	T	0	2	2	0	0	2	0	0
5	30200574	.	T	C	0	2	2	0	0	2	0	0
5	30203411	.	C	A	0	1	1	0	0	1	0	0
5	30410073	.	T	C	1	2	3	0	0	3	0	0
5	30415236	.	A	G	26	18	44	0	1	45	0	0
5	30440415	.	T	C	0	1	1	0	3	4	0	0
5	30440486	.	G	T	5	5	10	0	3	13	0	0
5	30456179	.	T	A	4	5	9	0	1	10	0	0
5	30459036	.	C	T	0	5	5	0	2	7	0	0
5	30466678	.	C	G	5	2	7	0	0	7	0	0
5	30466705	.	T	G	2	4	6	0	1	7	0	0
5	30466773	.	A	T	3	3	6	0	0	6	0	0
5	30466951	.	C	G	1	5	6	0	0	6	0	0
5	30467026	.	A	G	1	3	4	0	0	4	0	0
5	30467107	.	A	G	4	8	12	0	0	12	0	0
5	30467352	.	T	C	3	5	8	0	0	8	0	0
5	30486794	.	T	G	2	1	3	0	0	3	0	0
5	30502862	.	A	G	9	5	14	0	0	14	0	0
5	30503022	.	A	G	3	5	8	0	0	8	0	0
5	30503194	.	C	A	7	4	11	0	0	11	0	0
5	30507329	.	T	G	2	0	2	0	0	2	0	0
5	30507745	.	A	T	0	2	2	0	0	2	0	0
5	30510396	.	A	G	7	9	16	0	1	17	0	0
5	30511154	.	G	T	12	4	16	0	0	16	0	0
5	30513069	.	G	A	7	4	11	0	0	11	0	0
5	30513102	.	C	T	0	5	5	0	4	9	0	0
5	30516553	.	G	A	3	6	9	0	1	10	0	0
5	30534910	.	G	A	6	12	18	0	1	19	0	0
5	30537647	.	A	G	9	11	20	0	1	21	0	0
5	30538043	.	T	C	13	0	13	0	18	31	0	0
5	30538110	.	G	T	2	7	9	0	0	9	0	0
5	30542683	.	A	G	8	14	22	0	1	23	0	0
5	30542695	.	C	T	9	16	25	0	1	26	0	0
5	30544147	.	T	C	5	6	11	0	0	11	0	0
5	30544364	.	G	A	14	13	27	0	1	28	0	0
5	30549756	.	G	A	6	4	10	0	1	11	0	0
5	30554108	.	C	A	3	4	7	0	0	7	0	0
5	30554110	.	T	G	3	4	7	0	0	7	0	0
5	30554190	.	T	C	0	3	3	0	0	3	0	0
5	30554191	.	G	T	0	3	3	0	0	3	0	0
5	30583872	.	G	C	8	1	9	0	5	14	0	0
5	30583995	.	G	A	16	7	23	0	1	24	0	0
5	30586171	.	A	T	10	8	18	0	1	19	0	0
5	30588905	.	C	T	6	3	9	0	0	9	0	0
5	30589722	.	T	C	2	4	6	0	0	6	0	0
5	30589728	.	C	T	2	5	7	0	0	7	0	0
5	30591570	.	C	T	5	2	7	1	0	8	0	0
5	30597105	.	T	C	2	2	4	0	0	4	0	0
5	30605226	.	G	A	5	3	8	0	0	8	0	0
5	30605280	.	G	A	0	5	5	0	0	5	0	0
5	30624264	.	C	A	4	5	9	0	0	9	0	0
5	30624345	.	G	C	12	5	17	0	0	17	0	0
5	30624432	.	C	A	4	4	8	0	0	8	0	0
5	30624638	.	A	G	1	2	3	0	0	3	0	0
5	30635431	.	T	A	7	3	10	0	0	10	0	0
5	30635497	.	C	T	1	6	7	0	0	7	0	0
5	30661242	.	G	A	8	4	12	0	0	12	0	0
5	30661296	.	T	C	4	0	4	0	0	4	0	0
5	30661443	.	C	A	1	1	2	0	0	2	0	0
5	30661533	.	C	T	2	1	3	0	0	3	0	0
5	30663282	.	G	A	0	4	4	0	8	12	0	0
5	30665690	.	G	A	0	1	1	0	1	2	0	0
5	30665720	.	C	T	3	5	8	0	0	8	0	0
5	30665738	.	A	G	3	5	8	0	0	8	0	0
5	30665804	.	A	C	2	1	3	0	0	3	0	0
5	30670212	.	A	G	8	7	15	0	1	16	0	0
5	30670251	.	G	C	15	8	23	0	1	24	0	0
5	30672016	.	A	T	2	1	3	0	0	3	0	0
5	30672019	.	T	C	1	1	2	0	0	2	0	0
5	30672366	.	T	C	12	9	21	0	1	22	0	0
5	30672446	.	C	T	11	10	21	0	1	22	0	0
5	30699337	.	A	T	22	27	49	0	0	49	0	0
5	30702796	.	G	A	3	3	6	0	0	6	0	0
5	30702903	.	A	T	13	13	26	0	1	27	0	0
5	30704029	.	C	T	3	3	6	0	0	6	0	0
5	30704188	.	G	A	9	7	16	0	2	18	0	0
5	30704229	.	C	T	6	2	8	0	3	11	0	0
5	30760821	.	C	T	1	2	3	0	0	3	0	0
5	30764160	.	T	G	1	1	2	0	1	3	0	0
5	30764214	.	T	C	3	8	11	0	0	11	0	0
5	30764629	.	T	G	4	7	11	0	0	11	0	0
5	30764820	.	A	G	2	1	3	0	0	3	0	0
5	30805072	.	T	A	1	4	5	0	0	5	0	0
5	30805623	.	A	G	15	5	20	0	0	20	0	0
5	30805781	.	A	G	1	5	6	0	0	6	0	0
5	30806237	.	C	T	5	6	11	0	0	11	0	0
5	30806391	.	C	G	7	5	12	0	0	12	0	0
5	30806553	.	T	C	5	4	9	0	0	9	0	0
5	30806962	.	G	A	7	5	12	0	1	13	0	0
5	30806966	.	T	G	6	5	11	0	0	11	0	0
5	30828381	.	T	G	2	2	4	0	1	5	0	0
5	30828486	.	A	G	4	4	8	0	0	8	0	0
5	30828680	.	G	A	1	1	2	0	0	2	0	0
5	30842345	.	G	A	4	8	12	0	0	12	0	0
5	30891023	.	C	T	3	2	5	1	0	6	0	0
5	30891443	.	A	G	2	2	4	0	0	4	0	0
5	30924101	.	T	C	13	8	21	0	0	21	0	0
5	30924247	.	T	A	9	12	21	0	0	21	0	0
5	30993821	.	T	C	4	3	7	0	2	9	0	0
5	30993828	.	C	T	0	8	8	0	1	9	0	0
5	30994105	.	T	A	9	13	22	0	0	22	0	0
5	30994256	.	C	T	7	2	9	0	2	11	0	0
5	30994359	.	G	T	5	2	7	0	8	15	0	0
5	30994610	.	T	C	6	6	12	0	0	12	0	0
5	30994818	.	C	T	3	4	7	0	0	7	0	0
5	30994843	.	G	T	2	2	4	0	0	4	0	0
5	31007548	.	T	A	0	2	2	0	1	3	0	0
5	31015348	.	T	C	3	6	9	0	1	10	0	0
5	31015399	.	G	A	4	2	6	0	0	6	0	0
5	31015566	.	T	C	0	1	1	0	0	1	0	0
5	31016680	.	T	A	2	2	4	0	0	4	0	0
5	31016741	.	C	T	3	3	6	0	0	6	0	0
5	31016833	.	T	C	3	1	4	0	0	4	0	0
5	31017021	.	C	T	1	0	1	0	0	1	0	0
5	31021146	.	G	A	2	7	9	0	1	10	0	0
5	31025009	.	G	T	0	5	5	0	8	13	0	0
5	31029089	.	G	A	2	2	4	0	0	4	0	0
5	31029471	.	G	A	1	9	10	0	5	15	0	0
5	31029520	.	G	A	1	3	4	0	9	13	0	0
5	31029766	.	C	T	6	8	14	0	2	16	0	0
5	31029886	.	A	C	7	7	14	0	3	17	0	0
5	31029898	.	A	G	7	9	16	0	0	16	0	0
5	31030037	.	T	A	8	3	11	0	0	11	0	0
5	31034559	.	G	A	7	1	8	0	4	12	0	0
5	31038882	.	A	G	1	2	3	0	0	3	0	0
5	31061637	.	C	A	1	1	2	0	0	2	0	0
5	31067918	.	G	T	0	1	1	0	0	1	0	0
5	31071802	.	C	A	4	4	8	0	1	9	0	0
5	31071820	.	C	A	4	4	8	0	0	8	0	0
5	31073479	.	C	T	2	1	3	0	0	3	0	0
5	31073991	.	T	A	1	2	3	0	0	3	0	0
5	31074007	.	T	C	3	3	6	0	0	6	0	0
5	31082425	.	T	C	7	5	12	0	1	13	0	0
5	31084531	.	G	A	0	4	4	0	2	6	0	0
5	31084778	.	A	G	3	7	10	0	0	10	0	0
5	31087232	.	G	A	1	2	3	0	1	4	0	0
5	31092294	.	T	C	2	4	6	0	0	6	0	0
5	31092321	.	C	T	2	3	5	0	0	5	0	0
5	31108569	.	T	A	2	3	5	0	2	7	0	0
5	31108622	.	C	T	4	3	7	0	0	7	0	0
5	31108800	.	A	G	3	1	4	0	3	7	0	0
5	31108804	.	T	C	3	3	6	0	0	6	0	0
5	31108922	.	A	G	3	2	5	0	0	5	0	0
5	31230971	.	T	A	6	8	14	0	0	14	0	0
5	31264263	.	C	T	17	10	27	0	0	27	0	0
5	31266620	.	G	A	13	18	31	0	2	33	0	0
5	31266676	.	T	C	13	21	34	0	0	34	0	0
5	31266716	.	T	G	16	16	32	0	0	32	0	0
5	31267009	.	C	G	10	16	26	0	2	28	0	0
5	31267164	.	A	G	11	15	26	1	2	29	0	0
5	31267233	.	A	C	11	16	27	0	0	27	0	0
5	31267254	.	A	G	13	14	27	0	0	27	0	0
5	31267313	.	T	A	11	15	26	0	0	26	0	0
5	31267336	.	G	A	10	17	27	0	3	30	0	0
5	31267450	.	T	G	22	0	22	0	21	44	1	0
5	31267655	.	C	T	26	16	42	0	1	43	0	0
5	31267975	.	T	C	20	17	37	0	0	37	0	0
5	31268104	.	A	T	17	27	44	0	1	45	0	0
5	31268417	.	A	G	25	23	48	0	3	51	0	0
5	31268489	.	T	C	14	13	27	0	1	28	0	0
5	31268601	.	G	A	19	18	37	0	1	38	0	0
5	31269004	.	C	T	18	19	37	0	4	41	0	0
5	31284068	.	C	A	3	3	6	0	0	6	0	0
5	31350923	.	C	T	2	5	7	0	0	7	0	0
5	31351004	.	A	G	6	3	9	0	0	9	0	0
5	31401792	.	T	A	0	0	0	0	1	1	0	0
5	31419826	.	G	A	3	3	6	0	0	6	0	0
5	31431901	.	C	T	4	3	7	0	0	7	0	0
5	31432338	.	A	G	1	3	4	0	0	4	0	0
5	31432498	.	A	T	3	3	6	0	0	6	0	0
5	31480674	.	C	T	4	7	11	0	0	11	0	0
5	31480756	.	A	C	8	2	10	0	3	13	0	0
5	31480757	.	A	C	8	2	10	0	3	13	0	0
5	31480891	.	A	T	1	5	6	0	0	6	0	0
5	31546306	.	T	A	8	4	12	0	0	12	0	0
5	31562670	.	G	A	0	2	2	0	1	3	0	0
5	31579415	.	C	A	4	2	6	0	0	6	0	0
5	31579508	.	T	C	11	8	19	0	1	20	0	0
5	31644517	.	T	A	6	9	15	0	0	15	0	0
5	31644614	.	T	G	11	17	28	0	1	29	0	0
5	31644709	.	C	T	0	6	6	0	14	20	0	0
5	31644867	.	A	G	10	18	28	0	4	32	0	0
5	31649757	.	G	A	15	20	35	0	0	35	0	0
5	31658294	.	C	T	4	5	9	0	0	9	0	0
5	31658303	.	T	C	1	2	3	0	0	3	0	0
5	31699112	.	T	C	4	0	4	0	7	11	0	0
5	31703395	.	A	G	2	7	9	0	0	9	0	0
5	31703432	.	T	C	0	0	0	0	2	2	0	0
5	31709943	.	G	A	2	1	3	0	0	3	0	0
5	31711869	.	C	G	2	6	8	0	0	8	0	0
5	31712231	.	A	G	1	5	6	0	0	6	0	0
5	31712245	.	C	A	1	5	6	0	0	6	0	0
5	31712295	.	A	G	1	3	4	0	0	4	0	0
5	31714394	.	G	A	4	3	7	0	0	7	0	0
5	31714550	.	C	T	12	9	21	0	0	21	0	0
5	31714742	.	A	C	21	13	34	0	0	34	0	0
5	31714914	.	T	C	8	10	18	0	0	18	0	0
5	31723845	.	G	A	14	11	25	0	0	25	0	0
5	31723870	.	A	G	10	9	19	0	0	19	0	0
5	31723960	.	T	A	7	4	11	0	0	11	0	0
5	31724003	.	G	A	3	4	7	0	0	7	0	0
5	31724004	.	A	T	3	4	7	0	0	7	0	0
5	31724052	.	T	G	8	3	11	0	2	13	0	0
5	31724279	.	A	T	1	3	4	0	0	4	0	0
5	31724330	.	G	T	2	3	5	0	0	5	0	0
5	31724347	.	A	G	4	3	7	0	0	7	0	0
5	31724395	.	T	C	4	0	4	0	3	7	0	0
5	31730513	.	T	C	1	1	2	0	0	2	0	0
5	31730525	.	T	G	2	2	4	0	1	5	0	0
5	32796788	.	T	C	2	2	4	0	0	4	0	0
5	33019181	.	G	A	9	8	17	0	0	17	0	0
5	33019571	.	C	G	14	10	24	0	0	24	0	0
5	33019598	.	G	A	14	6	20	0	0	20	0	0
5	33019826	.	T	C	7	10	17	0	0	17	0	0
5	33021257	.	A	T	2	4	6	0	0	6	0	0
5	33200071	.	G	A	8	6	14	0	0	14	0	0
5	33200279	.	T	C	1	0	1	0	1	2	0	0
5	33208429	.	A	G	10	12	22	0	1	23	0	0
5	33215307	.	G	A	4	3	7	0	0	7	0	0
5	33238950	.	C	A	3	4	7	0	0	7	0	0
5	33239444	.	G	T	3	6	9	0	0	9	0	0
5	33239486	.	A	G	3	5	8	0	0	8	0	0
5	33239551	.	A	T	2	4	6	0	2	8	0	0
5	33239625	.	T	C	6	4	10	0	1	11	0	0
5	33239965	.	G	C	3	7	10	0	0	10	0	0
5	33239996	.	T	C	4	4	8	0	1	9	0	0
5	33240295	.	G	A	12	6	18	0	1	19	0	0
5	33240425	.	A	T	4	6	10	0	1	11	0	0
5	33240469	.	T	C	9	10	19	0	0	19	0	0
5	33240600	.	G	A	4	4	8	0	0	8	0	0
5	33240930	.	A	T	5	8	13	0	0	13	0	0
5	33245668	.	C	A	0	5	5	0	6	11	0	0
5	33245860	.	C	T	0	7	7	0	1	8	0	0
5	33247152	.	C	T	1	4	5	0	0	5	0	0
5	33248925	.	G	A	5	6	11	0	1	12	0	0
5	33251276	.	A	T	6	2	8	0	0	8	0	0
5	33266608	.	G	C	1	0	1	0	2	3	0	0
5	33266770	.	A	T	1	1	2	0	0	2	0	0
5	33266785	.	T	G	1	3	4	0	0	4	0	0
5	33266832	.	T	A	1	2	3	0	0	3	0	0
5	33266919	.	C	G	4	2	6	0	0	6	0	0
5	33266924	.	A	C	4	2	6	0	0	6	0	0
5	33267041	.	A	T	5	5	10	0	2	12	0	0
5	33268218	.	T	C	1	0	1	0	0	1	0	0
5	33269701	.	A	G	1	0	1	0	0	1	0	0
5	33274623	.	G	T	2	0	2	0	0	2	0	0
5	33274630	.	T	C	2	0	2	0	0	2	0	0
5	33277701	.	A	G	0	2	2	0	0	2	0	0
5	33277928	.	C	T	0	3	3	0	6	9	0	0
5	33280658	.	C	T	1	3	4	0	0	4	0	0
5	33281047	.	A	C	3	3	6	0	0	6	0	0
5	33281196	.	T	C	3	4	7	0	0	7	0	0
5	33282484	.	A	C	2	5	7	0	0	7	0	0
5	33285096	.	C	T	0	6	6	0	6	12	0	0
5	33289072	.	T	G	1	2	3	0	1	4	0	0
5	33289170	.	A	T	7	4	11	0	0	11	0	0
5	33290815	.	A	G	6	0	6	0	9	15	0	0
5	33295805	.	A	G	2	3	5	0	0	5	0	0
5	33295806	.	A	G	2	3	5	0	0	5	0	0
5	33296924	.	G	T	9	7	16	0	0	16	0	0
5	33302826	.	C	A	2	1	3	0	1	4	0	0
5	33307621	.	C	G	16	10	26	0	0	26	0	0
5	33307805	.	C	G	5	2	7	0	0	7	0	0
5	33307812	.	C	A	4	0	4	0	0	4	0	0
5	33310458	.	G	T	0	1	1	0	0	1	0	0
5	33310947	.	T	G	7	5	12	0	0	12	0	0
5	33314422	.	G	C	0	1	1	0	1	2	0	0
5	33315247	.	A	T	4	5	9	0	0	9	0	0
5	33318597	.	G	A	0	2	2	0	3	5	0	0
5	33328791	.	C	A	9	5	14	0	0	14	0	0
5	33328939	.	A	G	10	5	15	0	2	17	0	0
5	33329210	.	G	A	0	7	7	0	7	14	0	0
5	33329345	.	G	A	0	11	11	0	16	27	0	0
5	33329418	.	G	A	9	15	24	0	1	25	0	0
5	33329600	.	T	C	10	10	20	0	0	20	0	0
5	33329740	.	G	T	13	13	26	0	0	26	0	0
5	33329774	.	A	G	9	12	21	0	0	21	0	0
5	33329786	.	A	G	8	11	19	0	0	19	0	0
5	33330146	.	G	C	13	9	22	0	0	22	0	0
5	33336805	.	C	A	0	1	1	0	0	1	0	0
5	33336920	.	A	G	1	3	4	0	0	4	0	0
5	33337041	.	T	A	5	2	7	0	0	7	0	0
5	33337050	.	G	A	4	5	9	0	0	9	0	0
5	33337470	.	C	G	4	3	7	0	0	7	0	0
5	33337593	.	A	T	3	8	11	0	0	11	0	0
5	33337610	.	A	G	4	9	13	0	1	14	0	0
5	33337776	.	A	C	3	2	5	0	0	5	0	0
5	33338332	.	G	T	2	2	4	0	0	4	0	0
5	33347302	.	G	A	2	1	3	0	0	3	0	0
5	33360761	.	C	G	3	10	13	0	0	13	0	0
5	33360835	.	T	G	7	4	11	0	0	11	0	0
5	33360884	.	T	C	0	1	1	0	0	1	0	0
5	33382095	.	G	A	0	1	1	0	0	1	0	0
5	33385512	.	T	A	2	1	3	0	3	6	0	0
5	33387624	.	A	G	3	2	5	0	0	5	0	0
5	33537918	.	T	A	2	3	5	0	0	5	0	0
5	33538011	.	G	T	2	3	5	0	0	5	0	0
5	33538197	.	C	T	0	3	3	0	1	4	0	0
5	33554892	.	T	C	3	2	5	0	0	5	0	0
5	33636449	.	C	T	2	3	5	0	0	5	0	0
5	33679862	.	T	G	1	3	4	0	0	4	0	0
5	33680184	.	T	G	7	13	20	0	0	20	0	0
5	33694109	.	T	C	7	7	14	0	0	14	0	0
5	33698666	.	G	A	3	6	9	0	2	11	0	0
5	34066594	.	C	T	3	4	7	0	0	7	0	0
5	34066837	.	G	A	2	2	4	0	0	4	0	0
5	34098880	.	G	T	1	2	3	0	0	3	0	0
5	34142962	.	A	G	3	4	7	0	0	7	0	0
5	34185186	.	C	G	1	5	6	0	0	6	0	0
5	34185195	.	C	T	1	5	6	0	0	6	0	0
5	34542344	.	C	T	6	7	13	0	0	13	0	0
5	34542389	.	G	C	3	6	9	0	1	10	0	0
5	34568883	.	T	C	17	18	35	0	0	35	0	0
5	34573792	.	T	C	2	6	8	0	0	8	0	0
5	34573807	.	T	C	6	13	19	0	0	19	0	0
5	34574165	.	G	A	11	9	20	0	1	21	0	0
5	34574191	.	T	G	11	6	17	0	1	18	0	0
5	34574224	.	G	A	14	8	22	0	0	22	0	0
5	34574238	.	C	A	10	11	21	0	0	21	0	0
5	34574267	.	G	A	12	12	24	0	1	25	0	0
5	34574546	.	A	G	14	1	15	0	15	30	0	0
5	34574915	.	C	T	12	12	24	0	0	24	0	0
5	34574919	.	A	G	13	13	26	0	0	26	0	0
5	34575079	.	T	A	17	1	18	0	4	22	0	0
5	34588977	.	A	G	2	0	2	0	3	5	0	0
5	34589009	.	G	T	4	3	7	0	0	7	0	0
5	34589225	.	G	T	0	1	1	0	0	1	0	0
5	34593289	.	A	C	2	2	4	0	0	4	0	0
5	34593568	.	A	G	3	3	6	0	0	6	0	0
5	34603792	.	T	G	6	7	13	0	0	13	0	0
5	34603811	.	T	C	7	8	15	0	0	15	0	0
5	34606570	.	C	T	1	0	1	0	0	1	0	0
5	34609005	.	A	G	0	3	3	0	0	3	0	0
5	34609116	.	G	C	5	0	5	0	7	12	0	0
5	34609321	.	A	G	1	3	4	0	1	5	0	0
5	34609324	.	G	A	1	4	5	0	0	5	0	0
5	34609357	.	G	A	1	5	6	0	0	6	0	0
5	34614057	.	A	G	1	0	1	0	0	1	0	0
5	34624816	.	G	C	1	3	4	0	0	4	0	0
5	34625129	.	T	C	1	2	3	0	0	3	0	0
5	34625485	.	T	G	2	0	2	0	2	4	0	0
5	34633673	.	C	T	2	3	5	0	0	5	0	0
5	34634253	.	T	G	3	3	6	0	0	6	0	0
5	34635098	.	T	A	6	11	17	0	1	18	0	0
5	34635133	.	A	T	7	8	15	0	2	17	0	0
5	34635194	.	A	G	10	3	13	0	0	13	0	0
5	34635434	.	C	A	3	3	6	0	0	6	0	0
5	34635451	.	A	C	2	4	6	0	0	6	0	0
5	34635673	.	G	A	3	5	8	0	0	8	0	0
5	34635701	.	T	C	3	3	6	0	0	6	0	0
5	34635795	.	A	T	6	1	7	0	0	7	0	0
5	34636252	.	G	A	5	4	9	0	1	10	0	0
5	34636413	.	G	A	5	6	11	0	0	11	0	0
5	34636457	.	A	T	3	4	7	0	0	7	0	0
5	34636638	.	T	C	3	3	6	0	0	6	0	0
5	34636731	.	A	T	4	7	11	0	0	12	1	0
5	34636986	.	T	G	1	3	4	0	0	4	0	0
5	34637067	.	T	C	9	7	16	0	0	16	0	0
5	34637399	.	A	C	3	8	11	0	1	12	0	0
5	34637466	.	T	C	4	8	12	0	0	12	0	0
5	34637539	.	A	G	9	5	14	0	0	14	0	0
5	34637667	.	T	G	5	6	11	0	1	12	0	0
5	34637681	.	A	G	7	11	18	0	0	18	0	0
5	34637706	.	T	G	7	9	16	0	0	16	0	0
5	34637843	.	A	G	11	13	24	0	0	24	0	0
5	34637849	.	G	C	9	13	22	0	1	23	0	0
5	34637997	.	A	C	15	17	32	0	0	32	0	0
5	34830008	.	T	C	2	3	5	0	0	5	0	0
5	34830046	.	A	T	5	2	7	0	0	7	0	0
5	34830080	.	T	A	2	1	3	0	0	3	0	0
5	34830084	.	G	T	2	1	3	0	0	3	0	0
5	34981636	.	A	T	0	1	1	0	0	1	0	0
5	34982414	.	G	A	7	12	19	0	0	19	0	0
5	34982866	.	C	G	7	1	8	0	11	19	0	0
5	34987043	.	A	T	20	16	36	0	0	36	0	0
5	34987812	.	G	A	10	6	16	0	2	18	0	0
5	34991271	.	C	T	30	33	63	0	6	69	0	0
5	35123955	.	C	T	7	5	12	0	0	12	0	0
5	35124398	.	C	T	11	10	21	0	0	21	0	0
5	35124435	.	T	C	9	0	9	0	8	17	0	0
5	35124939	.	G	A	3	5	8	0	0	8	0	0
5	35125414	.	C	T	0	9	9	0	5	14	0	0
5	35125423	.	C	T	6	9	15	0	0	15	0	0
5	35125882	.	G	A	5	9	14	0	1	15	0	0
5	35125883	.	A	T	4	10	14	0	1	15	0	0
5	35127255	.	G	C	2	5	7	0	0	7	0	0
5	35129892	.	T	C	2	0	2	0	0	2	0	0
5	35133188	.	A	T	0	1	1	0	0	1	0	0
5	35137621	.	C	T	0	3	3	0	2	5	0	0
5	35202771	.	G	T	3	2	5	0	1	6	0	0
5	35202815	.	T	A	9	7	16	0	1	17	0	0
5	35202876	.	A	T	8	6	14	0	0	14	0	0
5	35202958	.	G	A	13	3	16	0	0	16	0	0
5	35202959	.	A	T	13	3	16	0	0	16	0	0
5	35203092	.	G	A	5	7	12	0	0	12	0	0
5	35203629	.	C	T	1	10	11	0	11	22	0	0
5	35204077	.	T	G	6	6	12	0	1	13	0	0
5	35204390	.	G	A	3	10	13	0	1	14	0	0
5	35204681	.	A	C	3	8	11	0	0	11	0	0
5	35204689	.	A	C	3	0	3	0	8	11	0	0
5	35204857	.	T	C	6	0	6	0	3	9	0	0
5	35204934	.	A	T	9	3	12	0	1	13	0	0
5	35204945	.	T	C	11	4	15	0	0	15	0	0
5	35205005	.	G	A	10	7	17	0	0	17	0	0
5	35205123	.	C	G	1	1	2	0	0	2	0	0
5	35207914	.	T	G	6	5	11	0	0	11	0	0
5	35218361	.	G	A	0	2	2	0	0	2	0	0
5	35220402	.	T	A	4	2	6	0	0	6	0	0
5	35222413	.	T	G	1	3	4	0	0	4	0	0
5	35229964	.	G	A	3	4	7	0	0	7	0	0
5	35230015	.	G	A	1	2	3	0	0	3	0	0
5	35245159	.	A	G	0	1	1	0	0	1	0	0
5	35253608	.	T	C	2	0	2	0	4	6	0	0
5	35258669	.	T	C	5	0	5	0	3	8	0	0
5	35258880	.	C	T	0	1	1	0	0	1	0	0
5	35259846	.	G	C	2	1	3	0	0	3	0	0
5	35262439	.	C	A	2	0	2	0	0	2	0	0
5	35264468	.	G	C	2	3	5	0	0	5	0	0
5	35271001	.	C	T	24	11	35	0	1	36	0	0
5	35271465	.	T	C	30	19	49	0	1	50	0	0
5	35271613	.	G	A	14	24	38	0	2	40	0	0
5	35271706	.	C	T	18	16	34	0	2	36	0	0
5	35271791	.	T	A	13	10	23	0	1	24	0	0
5	35271824	.	C	A	7	5	12	0	0	12	0	0
5	35271889	.	T	A	10	13	23	0	1	24	0	0
5	35272562	.	A	C	10	17	27	0	2	29	0	0
5	35272774	.	T	G	11	19	30	0	1	31	0	0
5	35272835	.	G	A	23	24	47	0	0	47	0	0
5	35272909	.	A	G	19	20	39	0	0	39	0	0
5	35273099	.	G	C	19	21	40	0	2	42	0	0
5	35273164	.	T	C	19	13	32	0	2	34	0	0
5	35273632	.	T	C	6	14	20	0	1	21	0	0
5	35273793	.	A	T	15	13	28	0	1	29	0	0
5	35273825	.	C	A	16	10	26	0	1	27	0	0
5	35273838	.	A	C	13	18	31	0	0	31	0	0
5	35274029	.	C	A	20	18	38	0	1	39	0	0
5	35275070	.	G	A	14	14	28	0	1	29	0	0
5	35275103	.	C	T	16	14	30	0	1	31	0	0
5	35276154	.	A	G	15	13	28	0	2	30	0	0
5	35276911	.	C	T	1	8	9	0	15	24	0	0
5	35277256	.	T	A	15	4	19	0	0	19	0	0
5	35277319	.	T	C	8	15	23	0	1	24	0	0
5	35277459	.	T	C	10	9	19	0	1	20	0	0
5	35278597	.	C	T	9	6	15	0	0	15	0	0
5	35278863	.	C	T	7	5	12	0	1	13	0	0
5	35278933	.	T	C	3	0	3	0	9	12	0	0
5	35278977	.	T	G	4	9	13	0	0	13	0	0
5	35279275	.	T	G	7	15	22	0	2	24	0	0
5	35279341	.	G	A	8	12	20	0	0	20	0	0
5	35279387	.	T	G	8	9	17	0	1	18	0	0
5	35279647	.	G	T	10	6	16	0	0	16	0	0
5	35280157	.	T	C	4	0	4	0	10	14	0	0
5	35280226	.	C	T	5	6	11	0	0	11	0	0
5	35301563	.	A	G	2	1	3	0	0	3	0	0
5	35422550	.	G	C	4	0	4	0	4	8	0	0
5	35422692	.	C	T	9	12	21	0	0	21	0	0
5	35431641	.	A	G	6	5	11	0	0	11	0	0
5	35431703	.	T	G	0	1	1	0	0	1	0	0
5	35454416	.	C	T	1	19	20	0	8	28	0	0
5	35454464	.	C	T	7	2	9	0	1	10	0	0
5	35487132	.	C	T	8	4	12	0	0	12	0	0
5	35487658	.	G	C	2	5	7	0	0	7	0	0
5	35561985	.	C	A	0	2	2	0	1	3	0	0
5	35562617	.	T	C	1	2	3	0	0	3	0	0
5	35678570	.	G	A	0	3	3	0	4	7	0	0
5	35682967	.	C	A	1	6	7	0	0	7	0	0
5	35682999	.	C	A	1	3	4	0	0	4	0	0
5	35683021	.	A	G	1	3	4	0	0	4	0	0
5	35683950	.	T	A	1	5	6	0	0	6	0	0
5	35683965	.	C	T	0	3	3	0	1	4	0	0
5	35683991	.	A	G	1	1	2	0	0	2	0	0
5	35684014	.	C	T	1	0	1	0	0	1	0	0
5	35749458	.	A	G	3	0	3	0	0	3	0	0
5	35749470	.	A	G	0	2	2	0	0	2	0	0
5	35749826	.	A	G	2	1	3	0	0	3	0	0
5	35751883	.	G	T	5	0	5	0	1	6	0	0
5	35751970	.	C	T	7	6	13	0	1	14	0	0
5	35751977	.	A	G	6	7	13	0	1	14	0	0
5	35754354	.	A	G	12	8	20	0	2	22	0	0
5	35754481	.	T	G	10	12	22	0	1	23	0	0
5	35877578	.	C	A	1	3	4	0	0	4	0	0
5	35955514	.	T	C	13	15	28	0	1	29	0	0
5	35955534	.	G	T	18	12	30	0	0	30	0	0
5	35955663	.	T	A	1	0	1	0	0	1	0	0
5	35967234	.	C	T	10	5	15	0	0	15	0	0
5	35967270	.	T	A	11	6	17	0	0	17	0	0
5	36274750	.	C	A	3	3	6	0	0	6	0	0
5	36296066	.	G	A	4	5	9	0	0	9	0	0
5	36296114	.	T	C	3	2	5	0	0	5	0	0
5	36416597	.	C	G	15	19	34	0	1	35	0	0
5	36421991	.	G	A	0	7	7	0	8	15	0	0
5	36537182	.	G	A	1	7	8	0	5	13	0	0
5	36551493	.	A	G	1	3	4	0	0	4	0	0
5	36551614	.	C	A	8	7	15	0	0	15	0	0
5	36551824	.	C	T	1	13	14	0	12	26	0	0
5	36558059	.	G	A	7	4	11	0	0	11	0	0
5	36558286	.	G	A	5	10	15	0	0	15	0	0
5	36558369	.	G	A	9	11	20	0	1	21	0	0
5	36558441	.	C	T	7	8	15	0	0	15	0	0
5	36563257	.	T	C	0	5	5	0	0	5	0	0
5	36567750	.	C	A	0	6	6	0	5	11	0	0
5	36568071	.	A	T	2	4	6	0	0	6	0	0
5	36570280	.	G	A	3	1	4	0	0	4	0	0
5	36577828	.	T	C	3	2	5	0	0	5	0	0
5	36583575	.	C	T	0	1	1	0	4	5	0	0
5	36583644	.	G	A	9	4	13	0	0	13	0	0
5	36584779	.	G	T	3	1	4	0	0	4	0	0
5	36584985	.	C	T	2	1	3	0	0	3	0	0
5	36585662	.	G	A	3	2	5	0	0	5	0	0
5	36585933	.	C	T	3	5	8	0	0	8	0	0
5	36586190	.	G	A	2	1	3	0	1	4	0	0
5	36586844	.	A	C	3	3	6	0	0	6	0	0
5	36588938	.	A	G	1	1	2	0	0	2	0	0
5	36596278	.	G	A	3	3	6	0	0	6	0	0
5	36596294	.	G	A	2	2	4	0	0	4	0	0
5	36596517	.	C	A	1	7	8	0	10	18	0	0
5	36624638	.	A	T	9	14	23	0	0	23	0	0
5	36625809	.	A	T	20	18	38	0	1	39	0	0
5	36626632	.	A	T	16	13	29	0	1	30	0	0
5	36650153	.	C	A	2	10	12	0	1	13	0	0
5	36650176	.	A	T	3	5	8	0	0	8	0	0
5	36650289	.	T	G	5	3	8	0	0	8	0	0
5	36653522	.	G	A	3	7	10	0	0	10	0	0
5	36653876	.	T	G	1	0	1	0	2	3	0	0
5	36654147	.	G	A	0	9	9	0	8	17	0	0
5	36654334	.	A	T	3	2	5	0	0	5	0	0
5	36665351	.	C	T	5	6	11	0	0	11	0	0
5	36668321	.	C	T	5	4	9	0	1	10	0	0
5	36673347	.	C	T	2	4	6	0	0	6	0	0
5	36673470	.	C	A	1	8	9	0	2	11	0	0
5	36674796	.	G	C	4	3	7	0	0	7	0	0
5	36674831	.	C	T	3	4	7	0	0	7	0	0
5	36730732	.	C	T	4	4	8	0	0	8	0	0
5	36732199	.	G	C	5	3	8	0	0	8	0	0
5	36732217	.	A	G	5	3	8	0	0	8	0	0
5	36739134	.	T	C	17	20	37	0	0	37	0	0
5	36739310	.	T	A	15	14	29	0	1	30	0	0
5	36739316	.	T	C	14	13	27	0	0	27	0	0
5	36739352	.	T	A	13	14	27	0	2	29	0	0
5	36739361	.	T	C	10	12	22	0	3	25	0	0
5	36802452	.	A	G	5	0	5	0	2	7	0	0
5	36805119	.	A	G	1	3	4	0	0	4	0	0
5	36851191	.	C	T	2	3	5	0	1	6	0	0
5	36852564	.	A	G	0	0	0	0	2	2	0	0
5	36852808	.	T	A	3	1	4	0	0	4	0	0
5	36853849	.	C	G	2	8	10	0	0	10	0	0
5	36854450	.	T	C	14	6	20	0	2	22	0	0
5	36854485	.	G	A	1	4	5	0	14	19	0	0
5	36854494	.	G	T	15	2	17	0	0	17	0	0
5	36895627	.	G	A	0	0	0	0	1	1	0	0
5	36898476	.	C	T	8	3	11	0	0	11	0	0
5	36898668	.	A	G	6	0	6	0	8	14	0	0
5	36901003	.	T	G	5	7	12	0	0	12	0	0
5	36902610	.	A	G	7	0	7	0	8	15	0	0
5	36902628	.	T	C	7	8	15	0	0	15	0	0
5	36903131	.	C	T	0	2	2	0	0	2	0	0
5	36907111	.	G	A	7	2	9	0	0	9	0	0
5	36907117	.	C	T	6	2	8	0	0	8	0	0
5	36908004	.	G	T	17	22	39	0	1	40	0	0
5	36908034	.	T	C	21	21	42	0	0	42	0	0
5	36916257	.	C	A	1	3	4	0	1	5	0	0
5	36916615	.	C	T	1	4	5	0	0	5	0	0
5	36945327	.	T	G	10	6	16	0	0	16	0	0
5	36945378	.	T	A	19	16	35	0	0	35	0	0
5	36945518	.	T	G	21	20	41	0	5	46	0	0
5	36945608	.	G	A	28	35	63	0	5	68	0	0
5	36945680	.	T	C	33	41	74	0	2	76	0	0
5	36945927	.	A	C	32	35	67	0	1	68	0	0
5	36945937	.	C	T	30	32	62	0	1	63	0	0
5	36946133	.	A	G	33	31	64	0	3	67	0	0
5	36946244	.	A	G	28	39	67	0	7	74	0	0
5	36996638	.	A	G	13	0	13	0	19	32	0	0
5	36997133	.	A	G	18	12	30	0	0	30	0	0
5	37032095	.	A	G	11	13	24	0	3	27	0	0
5	37032225	.	C	G	11	11	22	0	0	22	0	0
5	37032280	.	C	G	9	13	22	0	0	22	0	0
5	37032339	.	A	G	7	0	7	0	8	15	0	0
5	37032446	.	T	C	9	15	24	0	0	24	0	0
5	37032500	.	A	G	7	9	16	0	1	17	0	0
5	37032717	.	A	C	8	15	23	0	1	24	0	0
5	37032782	.	G	A	14	15	29	0	0	29	0	0
5	37032959	.	A	G	1	7	8	0	0	8	0	0
5	37033688	.	C	T	0	2	2	0	0	2	0	0
5	37036562	.	A	T	11	10	21	0	1	22	0	0
5	37037232	.	A	G	10	13	23	0	0	23	0	0
5	37037256	.	G	T	9	13	22	0	1	23	0	0
5	37037284	.	C	T	9	9	18	0	2	20	0	0
5	37037325	.	G	A	7	5	12	0	0	12	0	0
5	37037392	.	G	T	4	3	7	0	1	8	0	0
5	37037436	.	G	T	0	6	6	0	5	11	0	0
5	37037489	.	A	C	5	10	15	0	0	16	1	0
5	37037669	.	T	G	10	16	26	0	1	27	0	0
5	37037742	.	A	T	13	20	33	0	2	35	0	0
5	37037987	.	A	C	12	12	24	0	3	27	0	0
5	37038017	.	T	C	7	7	14	0	1	15	0	0
5	37065508	.	T	C	19	22	41	0	1	42	0	0
5	37065537	.	T	C	20	13	33	0	1	34	0	0
5	37065729	.	C	T	27	4	31	0	0	32	1	0
5	37092021	.	C	T	1	5	6	0	0	6	0	0
5	37092067	.	T	C	0	3	3	0	0	3	0	0
5	37093389	.	T	A	2	2	4	0	0	4	0	0
5	37094944	.	T	A	5	11	16	0	0	16	0	0
5	37095008	.	A	C	6	8	14	0	0	14	0	0
5	37095066	.	A	C	6	5	11	0	0	11	0	0
5	37102064	.	T	C	1	0	1	0	2	3	0	0
5	37277302	.	A	G	1	4	5	0	0	5	0	0
5	37277355	.	A	G	1	6	7	0	0	7	0	0
5	37277377	.	T	A	1	3	4	0	0	4	0	0
5	37277534	.	A	G	3	5	8	0	0	8	0	0
5	37280125	.	A	G	2	1	3	0	1	4	0	0
5	37286325	.	A	G	1	0	1	0	3	4	0	0
5	37286590	.	G	A	1	7	8	0	0	8	0	0
5	37286811	.	T	A	1	2	3	0	0	3	0	0
5	37293815	.	T	C	5	6	11	0	0	11	0	0
5	37295469	.	C	T	3	2	5	0	0	5	0	0
5	37296298	.	C	T	5	3	8	0	0	9	1	0
5	37299125	.	G	A	5	4	9	0	0	9	0	0
5	37301236	.	G	A	1	3	4	0	0	4	0	0
5	37301249	.	C	T	2	5	7	0	0	7	0	0
5	37301282	.	C	T	5	4	9	0	3	12	0	0
5	37301505	.	A	G	1	1	2	0	0	2	0	0
5	37301783	.	A	G	2	3	5	0	0	5	0	0
5	37304028	.	T	C	5	6	11	0	1	12	0	0
5	37304070	.	G	T	1	0	1	0	0	1	0	0
5	37307921	.	C	G	1	2	3	0	0	3	0	0
5	37309734	.	A	G	10	2	12	0	0	12	0	0
5	37309881	.	C	T	6	7	13	0	0	13	0	0
5	37312520	.	T	A	10	10	20	0	2	22	0	0
5	37312556	.	A	T	15	18	33	0	1	34	0	0
5	37312577	.	A	G	9	1	10	0	23	33	0	0
5	37312681	.	C	A	13	11	24	0	0	24	0	0
5	37316716	.	G	C	13	0	13	0	8	21	0	0
5	37316743	.	A	G	6	3	9	0	0	9	0	0
5	37316954	.	A	G	6	15	21	0	1	22	0	0
5	37320254	.	A	G	13	13	26	0	0	26	0	0
5	37321251	.	C	G	0	4	4	0	2	6	0	0
5	37321519	.	C	T	1	7	8	0	0	8	0	0
5	37323690	.	C	T	2	2	4	0	0	4	0	0
5	37380533	.	T	C	5	2	7	0	0	7	0	0
5	37380701	.	T	G	5	7	12	0	0	12	0	0
5	37406445	.	G	A	0	6	6	0	8	14	0	0
5	37422993	.	C	T	1	0	1	0	0	1	0	0
5	37423298	.	G	A	0	7	7	0	8	15	0	0
5	37439388	.	C	T	8	9	17	0	0	17	0	0
5	37439418	.	C	T	11	8	19	0	0	19	0	0
5	37439505	.	T	C	7	6	13	0	1	14	0	0
5	37439517	.	A	C	7	6	13	0	0	13	0	0
5	37439891	.	T	C	17	10	27	0	2	29	0	0
5	37494590	.	T	A	1	0	1	0	0	1	0	0
5	37494596	.	T	C	1	1	2	0	0	2	0	0
5	37494630	.	A	T	1	2	3	0	0	3	0	0
5	37494639	.	C	T	3	2	5	0	0	5	0	0
5	37494738	.	A	T	1	2	3	0	0	3	0	0
5	37495132	.	T	C	2	4	6	0	1	7	0	0
5	37504340	.	T	A	3	2	5	0	1	6	0	0
5	37504422	.	T	C	2	7	9	0	0	9	0	0
5	37504439	.	T	A	1	3	4	0	0	4	0	0
5	37504470	.	C	A	1	2	3	0	0	3	0	0
5	37504531	.	T	C	1	7	8	0	0	8	0	0
5	37504913	.	C	T	4	6	10	0	0	10	0	0
5	37504927	.	G	T	3	5	8	0	2	10	0	0
5	37504966	.	G	A	2	5	7	0	0	7	0	0
5	37507823	.	T	C	2	0	2	0	0	2	0	0
5	37507901	.	C	T	2	12	14	0	1	15	0	0
5	37509102	.	T	C	2	4	6	0	0	6	0	0
5	37509156	.	G	A	3	3	6	0	0	6	0	0
5	37509285	.	T	C	8	4	12	0	0	12	0	0
5	37509296	.	G	C	7	5	12	0	1	13	0	0
5	37509428	.	T	G	4	5	9	0	0	9	0	0
5	37509703	.	C	T	10	10	20	0	0	20	0	0
5	37509766	.	G	A	1	9	10	0	5	15	0	0
5	37509857	.	A	G	7	13	20	0	3	23	0	0
5	37509916	.	A	G	5	5	10	0	0	10	0	0
5	37510292	.	C	T	2	3	5	0	2	7	0	0
5	37510293	.	T	C	4	3	7	0	0	7	0	0
5	37510496	.	G	T	11	11	22	0	0	22	0	0
5	37510565	.	A	T	7	6	13	0	0	13	0	0
5	37578979	.	G	A	0	4	4	0	3	7	0	0
5	37584160	.	A	G	8	5	13	0	1	14	0	0
5	37584180	.	T	A	9	4	13	0	1	14	0	0
5	37584220	.	T	A	5	3	8	0	1	9	0	0
5	37585024	.	T	A	4	2	6	0	0	6	0	0
5	37680403	.	G	A	0	1	1	0	1	2	0	0
5	37680600	.	C	T	2	0	2	0	0	2	0	0
5	37684289	.	G	A	9	9	18	0	2	20	0	0
5	37686590	.	C	T	2	4	6	0	0	6	0	0
5	37688077	.	C	T	0	3	3	0	0	3	0	0
5	37688371	.	C	T	4	16	20	0	0	20	0	0
5	37688560	.	C	G	2	3	5	0	0	5	0	0
5	37688878	.	A	C	10	12	22	0	0	22	0	0
5	37691459	.	T	C	6	16	22	0	0	22	0	0
5	37691516	.	C	T	7	13	20	0	0	20	0	0
5	37692198	.	C	T	7	4	11	0	0	11	0	0
5	37694568	.	A	C	11	7	18	0	0	18	0	0
5	37695528	.	A	G	1	2	3	0	1	4	0	0
5	37696582	.	G	A	3	13	16	0	1	17	0	0
5	37697134	.	C	T	10	12	22	0	1	23	0	0
5	37699115	.	A	G	6	8	14	0	3	17	0	0
5	37699373	.	C	T	12	10	22	0	1	23	0	0
5	37700687	.	C	A	2	3	5	0	0	5	0	0
5	37700905	.	C	T	16	15	31	0	1	32	0	0
5	37701281	.	C	T	8	11	19	0	0	19	0	0
5	37703176	.	G	A	0	4	4	0	7	11	0	0
5	37703180	.	G	A	3	7	10	0	1	11	0	0
5	37707190	.	G	A	9	11	20	0	0	20	0	0
5	37747276	.	C	T	0	2	2	0	0	2	0	0
5	37749854	.	G	C	3	0	3	0	0	3	0	0
5	37757505	.	C	T	2	3	5	0	0	5	0	0
5	37757677	.	C	T	4	5	9	0	0	9	0	0
5	37807834	.	A	G	1	3	4	0	0	4	0	0
5	37812090	.	C	T	2	3	5	0	0	5	0	0
5	37912292	.	T	A	12	15	27	0	0	27	0	0
5	37912859	.	A	C	10	8	18	0	0	18	0	0
5	37918855	.	G	A	6	6	12	0	2	14	0	0
5	37918882	.	C	T	0	8	8	0	10	18	0	0
5	37918932	.	A	T	6	9	15	0	1	16	0	0
5	37918993	.	T	C	10	3	13	0	1	14	0	0
5	37918994	.	C	T	10	4	14	0	0	14	0	0
5	37919253	.	A	T	4	2	6	0	0	6	0	0
5	37934058	.	G	A	7	3	10	0	1	11	0	0
5	37935468	.	A	C	5	3	8	0	0	8	0	0
5	37963259	.	C	T	9	9	18	0	1	19	0	0
5	37968912	.	T	G	4	2	6	0	0	6	0	0
5	37970764	.	C	T	14	7	21	0	1	22	0	0
5	37970773	.	A	T	10	6	16	0	5	21	0	0
5	37970818	.	T	G	9	1	10	0	6	16	0	0
5	37982040	.	A	G	3	2	5	0	0	5	0	0
5	37987114	.	A	T	6	8	14	0	0	14	0	0
5	37987301	.	T	C	6	1	7	0	1	8	0	0
5	37987325	.	C	T	0	4	4	0	6	10	0	0
5	37987369	.	G	A	0	3	3	0	0	3	0	0
5	37989128	.	G	C	6	0	6	0	10	16	0	0
5	37989135	.	A	G	5	8	13	0	2	15	0	0
5	37989204	.	A	G	10	6	16	0	1	17	0	0
5	37989325	.	G	A	10	10	20	0	0	20	0	0
5	37989379	.	G	T	5	4	9	0	1	10	0	0
5	37989443	.	A	C	5	4	9	0	1	10	0	0
5	37989447	.	A	G	5	4	9	0	0	9	0	0
5	37991350	.	T	A	1	3	4	0	0	4	0	0
5	37991535	.	T	G	0	1	1	0	1	2	0	0
5	37991566	.	C	A	0	1	1	0	1	2	0	0
5	37991756	.	C	T	2	2	4	0	0	4	0	0
5	37991757	.	C	T	2	2	4	0	0	4	0	0
5	37993446	.	G	T	6	4	10	0	1	11	0	0
5	37994266	.	G	C	2	1	3	0	0	3	0	0
5	37997251	.	T	A	3	2	5	0	0	5	0	0
5	38302158	.	C	A	2	35	37	0	1	38	0	0
5	38302159	.	A	C	9	29	38	0	0	38	0	0
5	38390640	.	T	C	1	4	5	0	0	5	0	0
5	39386667	.	A	G	1	4	5	0	0	5	0	0
5	39386685	.	A	G	1	4	5	0	0	5	0	0
5	39386709	.	T	A	4	3	7	0	0	7	0	0
5	39386721	.	A	T	4	2	6	0	1	7	0	0
5	39386752	.	T	A	4	3	7	0	0	7	0	0
5	39386791	.	C	A	1	2	3	0	0	3	0	0
5	39504190	.	C	A	10	6	16	0	0	16	0	0
5	39504307	.	C	A	2	1	3	0	1	4	0	0
5	39508009	.	C	T	18	16	34	0	1	35	0	0
5	39508059	.	T	A	16	17	33	0	1	34	0	0
5	39673363	.	C	T	2	2	4	0	0	4	0	0
5	39684052	.	A	G	1	2	3	0	0	3	0	0
5	39707424	.	G	A	0	1	1	0	0	1	0	0
5	39707825	.	G	A	5	5	10	0	0	10	0	0
5	39708565	.	A	T	12	7	19	0	2	21	0	0
5	39708576	.	G	T	14	6	20	0	1	21	0	0
5	39708658	.	T	C	11	15	26	0	1	27	0	0
5	39708686	.	G	A	7	9	16	0	0	16	0	0
5	39708711	.	G	A	4	3	7	0	0	7	0	0
5	39715249	.	G	A	5	2	7	0	0	7	0	0
5	39730575	.	C	T	1	1	2	0	0	2	0	0
5	40040058	.	T	C	2	0	2	0	2	4	0	0
5	40040065	.	G	T	3	2	5	0	1	6	0	0
5	40040152	.	A	G	12	6	18	0	1	19	0	0
5	40054407	.	C	G	4	1	5	0	1	6	0	0
5	40059610	.	A	G	21	11	32	0	0	32	0	0
5	40059811	.	A	C	18	0	18	0	19	37	0	0
5	40059860	.	T	C	9	10	19	0	1	20	0	0
5	40062094	.	G	A	2	5	7	0	0	7	0	0
5	40062121	.	G	T	3	5	8	0	0	8	0	0
5	40062276	.	T	C	7	0	7	0	2	9	0	0
5	40062351	.	A	G	10	9	19	0	1	20	0	0
5	40062396	.	C	A	4	5	9	0	1	10	0	0
5	40069356	.	C	T	1	6	7	0	0	7	0	0
5	40069741	.	C	T	9	11	20	0	0	20	0	0
5	40077300	.	G	A	3	2	5	0	0	5	0	0
5	40078717	.	C	A	0	1	1	0	0	1	0	0
5	40095602	.	C	T	0	2	2	0	2	4	0	0
5	40097502	.	A	G	7	5	12	0	1	13	0	0
5	40097505	.	A	G	7	4	11	0	2	13	0	0
5	40097831	.	A	G	6	6	12	0	0	12	0	0
5	40111613	.	G	T	0	1	1	0	0	1	0	0
5	40203540	.	G	A	9	6	15	0	1	16	0	0
5	40206117	.	G	A	4	2	6	0	0	6	0	0
5	40206358	.	A	C	3	6	9	0	0	9	0	0
5	40273080	.	T	A	5	8	13	0	0	13	0	0
5	40273444	.	A	C	4	2	6	0	0	6	0	0
5	40273606	.	C	T	0	7	7	0	4	11	0	0
5	40273727	.	T	A	5	3	8	0	0	8	0	0
5	40291229	.	A	G	4	3	7	0	0	7	0	0
5	40291889	.	G	A	3	2	5	0	0	5	0	0
5	40291988	.	T	C	1	2	3	0	1	4	0	0
5	40292111	.	C	T	0	5	5	0	1	6	0	0
5	40501035	.	G	A	16	14	30	0	0	30	0	0
5	40505074	.	C	A	2	2	4	0	0	4	0	0
5	40505124	.	C	T	1	2	3	0	2	5	0	0
5	40506427	.	C	G	2	2	4	0	0	4	0	0
5	40728852	.	A	G	2	5	7	0	0	7	0	0
5	40728914	.	G	A	4	2	6	0	1	7	0	0
5	40729147	.	T	C	4	4	8	0	0	8	0	0
5	40729408	.	G	A	9	12	21	0	0	21	0	0
5	40729618	.	A	G	9	7	16	0	0	16	0	0
5	40732293	.	A	G	5	3	8	0	0	8	0	0
5	40865171	.	T	C	6	3	9	0	0	9	0	0
5	41125140	.	G	A	2	2	4	0	0	4	0	0
5	41880186	.	G	C	3	0	3	0	17	20	0	0
5	42053874	.	T	C	3	2	5	0	0	5	0	0
5	42067090	.	A	G	0	3	3	0	1	4	0	0
5	43073005	.	A	T	7	7	14	0	0	14	0	0
5	43073019	.	T	C	9	7	16	0	0	16	0	0
5	43073116	.	T	C	3	7	10	0	0	10	0	0
5	43082997	.	A	G	12	0	12	0	16	28	0	0
5	43083084	.	A	C	9	5	14	0	2	16	0	0
5	43428514	.	A	G	1	2	3	0	0	3	0	0
5	43479236	.	C	T	1	2	3	0	0	3	0	0
5	43479805	.	A	G	1	1	2	0	0	2	0	0
5	43479880	.	A	C	3	3	6	0	0	6	0	0
5	43602335	.	G	A	0	2	2	0	3	5	0	0
5	43602353	.	G	T	2	2	4	0	0	4	0	0
5	43602425	.	C	T	0	1	1	0	0	1	0	0
5	43602431	.	T	C	1	2	3	0	0	3	0	0
5	43604076	.	G	A	0	0	0	0	1	1	0	0
5	43604079	.	T	C	1	0	1	0	0	1	0	0
5	43606651	.	C	T	1	2	3	0	0	3	0	0
5	43617277	.	C	G	5	11	16	0	0	16	0	0
5	43617295	.	C	G	5	11	16	0	1	17	0	0
5	43617692	.	T	C	7	0	7	0	22	29	0	0
5	43626060	.	C	T	0	0	0	0	2	2	0	0
5	43629881	.	G	C	1	0	1	0	2	3	0	0
5	43629884	.	T	C	1	0	1	0	1	2	0	0
5	43638710	.	C	T	0	0	0	0	1	1	0	0
5	43682888	.	C	A	1	2	3	0	0	3	0	0
5	43682889	.	T	G	1	2	3	0	0	3	0	0
5	43862663	.	T	A	5	2	7	0	0	7	0	0
5	44795297	.	A	G	6	0	6	0	19	25	0	0
5	45748172	.	T	A	4	3	7	0	0	7	0	0
5	48986398	.	T	C	14	22	36	1	2	39	0	0
5	51522426	.	A	T	2	0	2	0	0	2	0	0
5	51575586	.	C	T	0	1	1	0	0	1	0	0
5	51578289	.	A	T	4	4	8	0	0	8	0	0
5	51579025	.	G	A	0	4	4	0	4	8	0	0
5	51616474	.	A	T	2	2	4	0	0	4	0	0
5	51617022	.	T	C	11	13	24	0	0	24	0	0
5	51775052	.	A	G	7	4	11	0	1	12	0	0
5	51775291	.	A	T	12	11	23	0	4	27	0	0
5	51775391	.	A	G	15	18	33	0	0	33	0	0
5	51775501	.	T	G	19	14	33	0	0	33	0	0
5	51775715	.	G	A	15	14	29	0	1	30	0	0
5	51775805	.	A	G	20	12	32	0	0	32	0	0
5	51775837	.	G	C	21	6	27	0	3	30	0	0
5	51775997	.	A	T	14	16	30	0	1	31	0	0
5	51776171	.	T	C	6	7	13	0	0	13	0	0
5	51776183	.	C	A	4	4	8	0	0	8	0	0
5	51789264	.	T	G	4	7	11	0	0	11	0	0
5	51789286	.	A	T	4	7	11	0	0	11	0	0
5	51789580	.	C	G	0	5	5	0	2	7	0	0
5	51793031	.	C	T	0	9	9	0	13	22	0	0
5	51843021	.	G	T	2	1	3	0	0	3	0	0
5	51847495	.	A	G	6	2	8	0	0	8	0	0
5	51893952	.	A	G	4	8	12	0	0	12	0	0
5	51947551	.	T	C	18	14	32	0	0	32	0	0
5	51947621	.	T	A	6	9	15	0	0	15	0	0
5	51947759	.	G	T	13	8	21	0	0	21	0	0
5	51947852	.	A	T	4	9	13	0	0	13	0	0
5	51947927	.	T	C	7	0	7	0	5	12	0	0
5	51948076	.	G	A	7	4	11	0	0	11	0	0
5	51948189	.	T	G	10	5	15	0	0	15	0	0
5	51948222	.	G	C	9	9	18	0	1	19	0	0
5	51948289	.	G	A	12	13	25	0	1	26	0	0
5	51948389	.	A	T	7	10	17	0	0	17	0	0
5	51948436	.	G	T	5	5	10	0	1	11	0	0
5	51948858	.	T	A	10	4	14	0	0	14	0	0
5	51948946	.	T	C	10	0	10	0	20	30	0	0
5	51949071	.	T	A	10	7	17	0	2	19	0	0
5	51949896	.	G	A	4	2	6	0	0	6	0	0
5	51949926	.	T	C	2	3	5	0	0	5	0	0
5	51950054	.	T	C	9	0	9	0	9	18	0	0
5	51958596	.	G	A	1	1	2	0	0	2	0	0
5	51985355	.	G	A	6	7	13	0	0	13	0	0
5	51985456	.	G	A	1	2	3	0	0	3	0	0
5	52005851	.	G	T	1	0	1	0	0	1	0	0
5	52005893	.	C	T	2	2	4	0	0	4	0	0
5	52007921	.	C	T	0	5	5	0	4	9	0	0
5	52007930	.	C	T	4	5	9	0	0	9	0	0
5	52068452	.	G	A	0	3	3	0	0	3	0	0
5	52121940	.	T	G	2	6	8	0	0	8	0	0
5	52121945	.	C	T	5	2	7	0	0	7	0	0
5	52122021	.	C	T	4	4	8	0	1	9	0	0
5	52122052	.	G	A	2	6	8	0	0	8	0	0
5	52122682	.	C	T	1	3	4	0	0	4	0	0
5	52122841	.	T	G	5	3	8	0	0	8	0	0
5	52123862	.	C	T	5	3	8	0	0	8	0	0
5	52123903	.	A	G	2	3	5	0	0	5	0	0
5	52124144	.	C	A	5	5	10	0	0	10	0	0
5	52124259	.	G	A	6	3	9	0	0	9	0	0
5	52132490	.	C	T	3	1	4	0	0	4	0	0
5	52132672	.	G	A	6	9	15	0	0	15	0	0
5	52132966	.	A	G	2	7	9	0	1	10	0	0
5	52190948	.	G	T	5	1	6	0	1	7	0	0
5	52190969	.	A	G	5	2	7	0	0	7	0	0
5	52191263	.	T	C	9	6	15	0	0	15	0	0
5	52191270	.	C	T	7	12	19	0	0	19	0	0
5	52191329	.	T	G	9	5	14	0	0	14	0	0
5	52191525	.	A	T	5	3	8	0	1	9	0	0
5	52191617	.	C	T	3	3	6	0	0	6	0	0
5	52191715	.	A	C	10	3	13	0	0	13	0	0
5	52191722	.	T	C	4	0	4	0	9	13	0	0
5	52191758	.	C	T	7	5	12	0	0	12	0	0
5	52191987	.	A	G	4	3	7	0	0	7	0	0
5	52192030	.	C	T	0	2	2	0	1	3	0	0
5	52192361	.	T	C	5	8	13	0	0	13	0	0
5	52192364	.	A	G	5	8	13	0	0	13	0	0
5	52192508	.	G	T	5	2	7	0	0	7	0	0
5	52192572	.	T	C	6	5	11	0	0	11	0	0
5	52193154	.	G	A	3	10	13	0	1	14	0	0
5	52193240	.	A	T	3	3	6	0	1	7	0	0
5	52193249	.	T	G	3	3	6	0	0	6	0	0
5	52193283	.	T	C	2	0	2	0	2	4	0	0
5	52193507	.	A	T	8	7	15	0	2	17	0	0
5	52193508	.	T	G	9	8	17	0	0	17	0	0
5	52201265	.	C	T	1	2	3	0	0	3	0	0
5	52212199	.	G	T	1	4	5	0	0	5	0	0
5	52215356	.	A	C	2	2	4	0	0	4	0	0
5	52227269	.	T	A	3	2	5	0	1	6	0	0
5	52227393	.	T	C	1	1	2	0	0	2	0	0
5	52227404	.	T	C	1	0	1	0	2	3	0	0
5	52227660	.	T	A	3	1	4	0	0	4	0	0
5	52234729	.	G	A	3	3	6	0	0	6	0	0
5	52235362	.	C	T	0	2	2	0	3	5	0	0
5	52235385	.	C	T	2	2	4	0	0	4	0	0
5	52236775	.	G	T	1	0	1	0	0	1	0	0
5	52236802	.	A	G	1	0	1	0	0	1	0	0
5	52237001	.	T	G	0	1	1	0	1	2	0	0
5	52257463	.	T	C	13	5	18	0	1	19	0	0
5	52257530	.	A	G	13	8	21	0	0	21	0	0
5	52257905	.	A	G	10	6	16	0	3	19	0	0
5	52258036	.	G	A	6	9	15	0	2	17	0	0
5	52258068	.	C	T	0	9	9	0	7	16	0	0
5	52258152	.	C	A	18	7	25	0	2	27	0	0
5	52258653	.	C	G	10	4	14	0	0	14	0	0
5	52258772	.	A	T	9	9	18	0	0	18	0	0
5	52258801	.	T	A	7	6	13	0	0	13	0	0
5	52258995	.	C	G	9	2	11	0	2	13	0	0
5	52259289	.	A	G	3	6	9	0	1	10	0	0
5	52259503	.	G	T	11	7	18	0	0	18	0	0
5	52259887	.	G	A	8	8	16	0	0	16	0	0
5	52860209	.	A	T	1	2	3	0	0	3	0	0
5	53908855	.	A	T	7	0	7	0	4	11	0	0
5	54458477	.	C	T	8	9	17	0	1	18	0	0
5	54459337	.	T	C	2	13	15	0	0	15	0	0
5	54459740	.	T	C	3	4	7	0	0	7	0	0
5	54459746	.	T	C	4	3	7	0	0	7	0	0
5	55895673	.	T	C	0	0	0	0	1	1	0	0
5	56268496	.	T	C	1	2	3	0	0	3	0	0
5	56280394	.	G	A	1	1	2	1	1	4	0	0
5	56280651	.	G	C	1	3	4	0	0	4	0	0
5	56289841	.	C	T	1	5	6	0	0	6	0	0
5	56289925	.	G	A	0	1	1	0	1	2	0	0
5	56290079	.	C	T	2	4	6	0	0	6	0	0
5	56308647	.	A	T	0	2	2	0	0	2	0	0
5	56308657	.	G	A	3	2	5	0	0	5	0	0
5	56309246	.	A	C	4	4	8	0	0	8	0	0
5	56309445	.	C	T	20	15	35	0	0	35	0	0
5	56309506	.	G	A	10	9	19	0	1	20	0	0
5	56309677	.	C	A	7	11	18	0	0	18	0	0
5	56313246	.	C	T	15	10	25	0	3	28	0	0
5	56317470	.	C	T	1	2	3	0	0	3	0	0
5	56317473	.	T	G	1	2	3	0	0	3	0	0
5	56343032	.	C	T	0	3	3	0	3	6	0	0
5	56343053	.	G	A	4	5	9	0	0	9	0	0
5	56343095	.	C	T	2	2	4	0	0	4	0	0
5	56345036	.	G	C	2	4	6	0	0	6	0	0
5	56345157	.	C	T	13	7	20	0	1	21	0	0
5	56355129	.	C	T	5	5	10	0	0	10	0	0
5	56362376	.	C	T	1	1	2	0	0	2	0	0
5	56375262	.	G	T	6	1	7	0	0	7	0	0
5	56376648	.	A	G	2	4	6	0	0	6	0	0
5	56381655	.	G	A	1	2	3	0	0	3	0	0
5	56412062	.	G	A	1	1	2	0	0	2	0	0
5	56915422	.	G	A	8	2	10	0	0	10	0	0
5	56918884	.	G	T	3	2	5	0	0	5	0	0
5	56921906	.	G	A	6	5	11	0	1	12	0	0
5	56924356	.	C	T	2	4	6	0	0	6	0	0
5	56924686	.	C	T	2	3	5	0	1	6	0	0
5	56935240	.	A	G	2	0	2	0	0	2	0	0
5	56935245	.	C	T	1	0	1	0	0	1	0	0
5	56937131	.	C	A	0	1	1	0	0	1	0	0
5	56942904	.	C	T	1	5	6	0	0	6	0	0
5	56943528	.	T	A	0	3	3	0	0	3	0	0
5	56951034	.	G	A	7	8	15	0	0	15	0	0
5	56951229	.	C	T	9	14	23	0	2	25	0	0
5	56951769	.	A	G	6	7	13	0	0	13	0	0
5	56951841	.	T	A	3	3	6	0	0	7	1	0
5	56952141	.	T	C	18	0	18	0	18	36	0	0
5	56952316	.	A	G	6	6	12	0	0	12	0	0
5	56955460	.	C	T	12	12	24	0	1	25	0	0
5	56955508	.	T	G	4	5	9	0	0	9	0	0
5	56956359	.	G	A	13	7	20	0	0	20	0	0
5	56958516	.	C	T	0	2	2	0	3	5	0	0
5	56964475	.	G	A	6	7	13	0	0	13	0	0
5	57021652	.	C	T	1	2	3	0	0	3	0	0
5	57021655	.	T	C	1	1	2	0	0	2	0	0
5	57217380	.	G	C	2	5	7	0	0	7	0	0
5	57217391	.	C	G	2	2	4	0	0	4	0	0
5	57219496	.	G	A	6	3	9	0	0	9	0	0
5	57219736	.	T	C	1	5	6	0	0	6	0	0
5	57219789	.	C	T	3	3	6	0	0	6	0	0
5	57219938	.	G	C	1	5	6	0	5	11	0	0
5	57219941	.	G	A	7	3	10	0	2	12	0	0
5	57220033	.	T	C	6	3	9	0	0	9	0	0
5	57220108	.	G	A	0	8	8	0	8	16	0	0
5	57220190	.	A	G	8	1	9	0	13	22	0	0
5	57220324	.	T	C	1	2	3	0	1	4	0	0
5	57225343	.	C	T	1	4	5	0	1	6	0	0
5	57225496	.	C	G	2	0	2	0	1	3	0	0
5	57231089	.	C	T	7	5	12	0	0	12	0	0
5	57325118	.	C	A	26	37	63	0	2	66	1	0
5	57325123	.	G	T	25	38	63	0	3	66	0	0
5	57325204	.	T	G	29	4	33	0	30	63	0	0
5	57325210	.	G	A	31	34	65	0	1	66	0	0
5	57325381	.	A	T	23	32	55	0	1	56	0	0
5	57325537	.	C	T	5	7	12	0	0	12	0	0
5	57347653	.	A	G	1	0	1	0	0	1	0	0
5	57351036	.	A	G	3	0	3	0	3	6	0	0
5	57351404	.	C	A	1	4	5	0	0	5	0	0
5	57353616	.	T	A	3	4	7	0	0	7	0	0
5	57354166	.	T	C	6	10	16	0	0	16	0	0
5	57354452	.	C	T	3	5	8	0	0	8	0	0
5	57354552	.	C	T	5	5	10	0	0	10	0	0
5	57354596	.	C	T	4	6	10	0	1	11	0	0
5	57354786	.	G	T	6	10	16	0	2	18	0	0
5	57359699	.	G	T	2	6	8	0	0	8	0	0
5	57422146	.	A	T	4	7	11	0	0	11	0	0
5	57444345	.	A	G	2	4	6	0	0	6	0	0
5	57447301	.	C	T	3	2	5	0	0	5	0	0
5	57450440	.	C	A	3	5	8	0	0	8	0	0
5	57451036	.	A	T	5	7	12	0	0	12	0	0
5	57453635	.	T	C	2	3	5	0	0	5	0	0
5	57489777	.	T	C	17	1	18	0	8	26	0	0
5	57489821	.	G	A	13	15	28	0	0	28	0	0
5	57490344	.	C	A	1	15	16	0	7	23	0	0
5	57490371	.	C	T	2	8	10	0	9	19	0	0
5	57499990	.	T	C	4	0	4	0	1	5	0	0
5	57505050	.	C	T	5	4	9	0	1	10	0	0
5	57526813	.	C	T	0	5	5	0	2	7	0	0
5	57718488	.	A	C	18	10	28	0	0	28	0	0
5	57718651	.	A	T	11	7	18	0	0	19	1	0
5	57718716	.	T	C	8	12	20	0	0	20	0	0
5	57718739	.	T	C	4	8	12	0	0	12	0	0
5	57726655	.	G	C	7	2	9	0	0	9	0	0
5	57737535	.	C	G	3	4	7	0	0	7	0	0
5	57737589	.	T	C	4	5	9	0	0	9	0	0
5	57737919	.	T	A	4	4	8	0	0	8	0	0
5	57744722	.	C	A	4	2	6	0	0	6	0	0
5	57744731	.	T	C	4	1	5	0	0	5	0	0
5	57753791	.	G	T	7	5	12	0	0	12	0	0
5	57755422	.	T	C	2	2	4	0	0	4	0	0
5	57759107	.	C	T	4	3	7	0	0	7	0	0
5	57759159	.	G	A	0	9	9	0	12	21	0	0
5	57762423	.	A	T	10	8	18	0	1	19	0	0
5	57762608	.	A	G	14	1	15	0	19	34	0	0
5	57762986	.	C	G	13	17	30	0	1	31	0	0
5	57781459	.	T	A	2	3	5	0	0	5	0	0
5	57797086	.	C	T	21	16	37	0	0	37	0	0
5	57814468	.	C	T	4	3	7	0	1	8	0	0
5	57814523	.	A	G	5	5	10	0	1	11	0	0
5	57814630	.	T	C	5	0	5	0	16	21	0	0
5	57819001	.	A	G	5	1	6	0	0	6	0	0
5	57819091	.	A	T	1	1	2	0	0	2	0	0
5	57820716	.	C	T	2	7	9	0	0	9	0	0
5	57842319	.	G	T	1	3	4	0	0	4	0	0
5	57879040	.	T	A	3	1	4	0	0	4	0	0
5	58075815	.	T	G	2	9	11	0	3	14	0	0
5	58081110	.	C	T	1	0	1	0	0	1	0	0
5	58086215	.	G	C	4	0	4	0	3	7	0	0
5	58382267	.	G	A	34	19	53	0	2	55	0	0
5	58382415	.	C	T	21	19	40	0	2	42	0	0
5	58382474	.	T	A	22	15	37	0	2	39	0	0
5	58382596	.	G	A	1	7	8	0	2	10	0	0
5	58851232	.	G	A	14	6	20	0	0	20	0	0
5	58852925	.	T	G	3	4	7	0	0	7	0	0
5	58852972	.	G	A	1	4	5	0	0	5	0	0
5	58853688	.	A	G	11	7	18	0	0	18	0	0
5	58868948	.	A	C	5	6	11	0	0	11	0	0
5	58871633	.	T	G	7	5	12	0	0	12	0	0
5	58875035	.	C	T	1	5	6	0	3	9	0	0
5	58878899	.	G	T	3	5	8	0	2	10	0	0
5	58939388	.	C	A	0	0	0	0	1	1	0	0
5	58993133	.	G	T	1	3	4	0	0	4	0	0
5	58997286	.	T	A	1	2	3	0	0	3	0	0
5	59008759	.	T	A	4	3	7	0	0	7	0	0
5	59008762	.	G	C	4	2	6	0	2	8	0	0
5	59008892	.	C	T	4	5	9	0	0	9	0	0
5	59041862	.	T	C	1	0	1	0	0	1	0	0
5	59046296	.	T	C	3	6	9	0	0	9	0	0
5	59050241	.	A	G	5	7	12	0	0	12	0	0
5	59050307	.	G	A	1	2	3	0	0	3	0	0
5	59063090	.	C	A	2	1	3	0	0	3	0	0
5	59063102	.	C	T	2	1	3	0	0	3	0	0
5	59079618	.	A	T	6	7	13	0	0	13	0	0
5	59079732	.	A	C	11	10	21	0	0	21	0	0
5	59079806	.	C	A	8	16	24	0	0	24	0	0
5	59080055	.	G	T	4	2	6	0	0	6	0	0
5	59080163	.	C	T	4	6	10	0	1	11	0	0
5	59080392	.	C	A	3	5	8	0	0	8	0	0
5	59080452	.	G	T	0	10	10	0	2	13	1	0
5	59082405	.	T	G	5	3	8	0	1	9	0	0
5	59082409	.	G	T	5	4	9	0	0	9	0	0
5	59082758	.	G	T	10	7	17	0	2	19	0	0
5	59082761	.	C	T	11	8	19	0	0	19	0	0
5	59095793	.	C	T	2	5	7	0	2	9	0	0
5	59095862	.	G	A	1	1	2	0	0	2	0	0
5	59100577	.	G	A	1	0	1	0	0	1	0	0
5	59101602	.	A	G	0	1	1	0	1	2	0	0
5	59101605	.	G	A	1	1	2	0	0	2	0	0
5	59103052	.	A	G	1	1	2	0	0	2	0	0
5	59103118	.	A	T	1	2	3	0	0	3	0	0
5	59147690	.	C	T	5	7	12	0	0	12	0	0
5	59147711	.	T	C	6	6	12	0	1	13	0	0
5	59198649	.	C	G	5	5	10	0	0	10	0	0
5	59198658	.	A	G	5	5	10	0	1	11	0	0
5	59198979	.	G	A	1	2	3	0	1	4	0	0
5	59198982	.	A	G	1	3	4	0	0	4	0	0
5	59199018	.	G	A	0	2	2	0	4	6	0	0
5	59199028	.	C	T	4	2	6	0	0	6	0	0
5	59199332	.	A	C	1	2	3	0	0	3	0	0
5	59200153	.	T	G	6	2	8	0	0	8	0	0
5	59200369	.	T	C	1	3	4	0	1	5	0	0
5	59200383	.	A	G	1	4	5	0	0	5	0	0
5	59200412	.	G	T	1	3	4	0	0	4	0	0
5	59200523	.	C	G	2	4	6	0	0	6	0	0
5	59200569	.	A	G	2	2	4	0	0	4	0	0
5	59201211	.	A	T	5	3	8	0	0	8	0	0
5	59201308	.	G	A	0	5	5	0	3	8	0	0
5	59201609	.	A	T	4	2	6	0	0	6	0	0
5	59201624	.	C	T	3	3	6	0	0	6	0	0
5	59201825	.	G	A	3	6	9	0	0	9	0	0
5	59201883	.	T	G	8	5	13	0	0	14	1	0
5	59201914	.	G	A	6	6	12	0	0	12	0	0
5	59201918	.	G	C	6	5	11	0	1	12	0	0
5	59248031	.	T	C	12	5	17	0	0	17	0	0
5	59278508	.	T	G	3	3	6	0	0	6	0	0
5	59278520	.	T	G	1	2	3	0	0	3	0	0
5	59297918	.	C	G	2	2	4	0	1	5	0	0
5	59328475	.	C	T	3	1	4	0	0	4	0	0
5	59341675	.	C	A	1	2	3	0	0	3	0	0
5	59361402	.	A	G	2	2	4	0	0	4	0	0
5	59367819	.	C	G	4	2	6	0	1	7	0	0
5	59386332	.	A	G	7	6	13	0	0	13	0	0
5	59386456	.	T	C	5	6	11	0	0	11	0	0
5	59386964	.	G	T	4	2	6	0	0	6	0	0
5	59386997	.	T	G	2	3	5	0	1	6	0	0
5	59387007	.	G	A	2	3	5	0	1	6	0	0
5	59387577	.	C	A	12	7	19	0	1	20	0	0
5	59388343	.	T	C	1	6	7	0	0	7	0	0
5	59388586	.	T	A	9	5	14	0	0	14	0	0
5	59388604	.	T	C	11	7	18	0	0	18	0	0
5	59388739	.	A	G	0	3	3	0	0	3	0	0
5	59388922	.	G	C	0	5	5	0	10	15	0	0
5	59388932	.	C	T	12	6	18	0	0	18	0	0
5	59389002	.	G	A	14	8	22	0	0	22	0	0
5	59389079	.	A	G	6	0	6	0	10	16	0	0
5	59389693	.	A	T	6	6	12	0	0	12	0	0
5	59397551	.	A	G	1	0	1	0	2	3	0	0
5	59397600	.	G	A	2	4	6	0	0	6	0	0
5	59398522	.	A	G	6	2	8	0	0	8	0	0
5	59398655	.	A	G	1	0	1	0	2	3	0	0
5	59419988	.	T	C	6	1	7	0	1	8	0	0
5	59420096	.	T	C	1	2	3	0	0	3	0	0
5	59420138	.	G	A	0	2	2	0	3	5	0	0
5	59420291	.	A	G	3	0	3	0	4	7	0	0
5	59420321	.	A	C	2	4	6	0	0	6	0	0
5	59420366	.	T	C	3	6	9	0	0	9	0	0
5	59420375	.	C	T	3	7	10	0	0	10	0	0
5	59420414	.	G	T	0	5	5	0	5	10	0	0
5	59449692	.	G	A	0	0	0	0	1	1	0	0
5	59449764	.	G	A	6	6	12	0	0	12	0	0
5	59449818	.	C	T	4	5	9	0	0	9	0	0
5	59450034	.	C	T	2	1	3	0	1	4	0	0
5	59462424	.	G	T	1	2	3	0	0	3	0	0
5	59462457	.	G	A	3	2	5	0	0	5	0	0
5	59462501	.	G	A	0	4	4	0	6	10	0	0
5	59462534	.	A	G	7	7	14	0	1	15	0	0
5	59462595	.	C	T	6	5	11	0	0	11	0	0
5	59462679	.	C	T	3	6	9	0	0	9	0	0
5	59462727	.	C	T	2	8	10	0	0	10	0	0
5	59462790	.	C	T	10	6	16	0	0	16	0	0
5	59463327	.	A	C	5	3	8	0	0	8	0	0
5	59466882	.	G	A	0	2	2	0	4	6	0	0
5	59466930	.	A	G	4	2	6	0	0	6	0	0
5	59473728	.	T	C	2	2	4	0	0	4	0	0
5	59473885	.	A	C	5	1	6	0	0	6	0	0
5	59479541	.	C	A	1	0	1	0	0	1	0	0
5	59479546	.	A	C	1	0	1	0	0	1	0	0
5	59510265	.	A	C	2	2	4	0	0	4	0	0
5	59515497	.	A	T	7	6	13	0	0	13	0	0
5	59515509	.	A	G	4	6	10	0	2	12	0	0
5	59515573	.	T	C	3	3	6	0	0	6	0	0
5	59544222	.	C	G	3	3	6	0	0	6	0	0
5	59544249	.	T	C	4	4	8	0	0	8	0	0
5	59544291	.	T	C	6	4	10	0	0	10	0	0
5	59544642	.	A	C	0	3	3	0	0	3	0	0
5	59548976	.	C	G	5	2	7	0	1	8	0	0
5	59549354	.	T	C	4	5	9	0	0	9	0	0
5	59549480	.	G	A	5	2	7	0	1	8	0	0
5	59550051	.	A	G	2	2	4	0	0	4	0	0
5	59550064	.	T	C	2	1	3	0	0	3	0	0
5	59550088	.	A	G	4	2	6	0	0	6	0	0
5	59550365	.	G	A	4	7	11	0	0	11	0	0
5	59550636	.	A	T	2	8	10	0	0	10	0	0
5	59559905	.	T	C	3	11	14	0	0	14	0	0
5	59559950	.	T	C	6	11	17	0	0	17	0	0
5	59560171	.	A	G	5	4	9	0	0	9	0	0
5	59560176	.	A	G	5	3	8	0	0	8	0	0
5	59575772	.	C	T	2	3	5	0	0	5	0	0
5	59584548	.	G	A	2	0	2	0	0	2	0	0
5	59593231	.	C	T	8	9	17	0	0	17	0	0
5	59593441	.	G	A	8	7	15	0	0	15	0	0
5	59593447	.	G	C	0	7	7	0	9	16	0	0
5	59593502	.	C	T	2	8	10	0	0	10	0	0
5	59593520	.	C	T	5	6	11	0	0	11	0	0
5	59593699	.	T	C	3	5	8	0	1	9	0	0
5	59593773	.	G	C	9	6	15	0	0	15	0	0
5	59593795	.	T	A	5	4	9	0	0	9	0	0
5	59593834	.	C	A	5	2	7	0	0	7	0	0
5	59594551	.	A	G	17	1	18	0	3	21	0	0
5	59594729	.	A	G	2	10	12	0	0	12	0	0
5	59594763	.	T	G	4	8	12	0	2	14	0	0
5	59594878	.	C	T	6	4	10	0	0	10	0	0
5	59594893	.	C	T	5	3	8	0	1	9	0	0
5	59594943	.	A	C	8	6	14	0	0	14	0	0
5	59595241	.	T	C	8	6	14	0	0	14	0	0
5	59595252	.	C	T	10	6	16	0	1	17	0	0
5	59595502	.	T	C	2	7	9	0	0	9	0	0
5	60520653	.	C	A	3	2	5	0	0	5	0	0
5	60520995	.	C	T	4	2	6	0	0	6	0	0
5	60521010	.	C	T	2	3	5	0	0	5	0	0
5	60605673	.	T	C	2	3	5	0	0	5	0	0
5	60684296	.	A	G	2	0	2	0	4	6	0	0
5	60684728	.	C	T	0	8	8	0	1	9	0	0
5	60684731	.	C	T	1	8	9	0	0	9	0	0
5	60685202	.	A	T	7	8	15	0	1	16	0	0
5	60685676	.	C	T	3	5	8	0	0	8	0	0
5	60686409	.	G	A	6	7	13	0	0	13	0	0
5	60686452	.	C	T	5	7	12	0	0	12	0	0
5	60686473	.	C	T	5	8	13	0	0	13	0	0
5	60686541	.	A	G	6	10	16	0	0	16	0	0
5	60686603	.	C	T	3	4	7	0	0	7	0	0
5	60686636	.	C	T	4	2	6	0	0	6	0	0
5	60686784	.	G	T	3	5	8	0	0	8	0	0
5	60686918	.	A	T	7	9	16	0	1	17	0	0
5	60687313	.	A	T	3	7	10	0	0	10	0	0
5	60687344	.	A	T	6	11	17	0	0	17	0	0
5	60687362	.	A	G	7	12	19	0	1	20	0	0
5	60847925	.	G	A	3	2	5	0	0	5	0	0
5	60851962	.	A	T	0	1	1	0	0	1	0	0
5	60852050	.	T	G	0	0	0	0	1	1	0	0
5	60861610	.	C	T	0	1	1	0	0	1	0	0
5	60868009	.	A	G	0	0	0	0	3	3	0	0
5	60868958	.	T	C	0	2	2	0	0	2	0	0
5	60868987	.	G	A	0	2	2	0	0	2	0	0
5	60871969	.	C	T	3	2	5	0	0	5	0	0
5	60872349	.	T	G	1	0	1	0	2	3	0	0
5	60872639	.	G	A	1	2	3	0	4	7	0	0
5	60893432	.	C	T	0	1	1	0	0	1	0	0
5	60894723	.	T	G	4	2	6	0	0	6	0	0
5	60894729	.	C	T	3	2	5	0	0	5	0	0
5	60894807	.	A	G	4	0	4	0	7	11	0	0
5	60894846	.	A	G	2	0	2	0	9	11	0	0
5	60902623	.	G	A	0	2	2	0	5	7	0	0
5	60906002	.	C	T	2	4	6	0	0	6	0	0
5	61316248	.	T	C	8	4	12	0	1	13	0	0
5	61325345	.	A	T	1	5	6	0	0	6	0	0
5	61329508	.	G	C	11	8	19	0	1	20	0	0
5	61329604	.	C	T	7	11	18	0	0	18	0	0
5	61329650	.	A	G	6	8	14	0	4	18	0	0
5	61352474	.	A	T	2	2	4	0	0	4	0	0
5	61352582	.	T	C	1	0	1	0	0	1	0	0
5	61353710	.	G	C	0	0	0	0	3	3	0	0
5	61353728	.	G	A	0	1	1	0	0	1	0	0
5	61354097	.	A	C	4	5	9	0	0	9	0	0
5	61354112	.	G	T	4	5	9	0	1	10	0	0
5	61354264	.	A	G	4	4	8	0	0	8	0	0
5	61380091	.	A	G	7	0	7	0	5	12	0	0
5	61389725	.	T	C	9	6	15	0	1	16	0	0
5	61392719	.	C	T	16	9	25	0	1	26	0	0
5	61401915	.	C	T	9	6	15	0	0	15	0	0
5	61402366	.	G	C	11	4	15	0	3	18	0	0
5	61402440	.	T	C	15	6	21	0	2	23	0	0
5	61402455	.	A	T	12	10	22	0	2	24	0	0
5	61402584	.	A	G	18	0	18	0	15	33	0	0
5	61402607	.	C	T	17	17	34	0	0	34	0	0
5	61402761	.	T	A	20	13	33	0	1	34	0	0
5	61402999	.	T	A	16	10	26	0	1	27	0	0
5	61403005	.	A	T	16	9	25	0	0	25	0	0
5	61405203	.	C	T	1	4	5	0	1	6	0	0
5	61405245	.	C	A	1	6	7	0	0	7	0	0
5	61405954	.	A	G	10	6	16	0	0	16	0	0
5	61414618	.	A	T	6	3	9	0	1	10	0	0
5	61414619	.	C	T	7	3	10	0	0	10	0	0
5	61425723	.	C	T	1	0	1	0	0	1	0	0
5	61425795	.	G	C	3	4	7	0	0	7	0	0
5	61425800	.	A	G	2	4	6	0	0	6	0	0
5	61428878	.	A	G	1	1	2	0	0	2	0	0
5	61428915	.	C	G	5	2	7	0	1	8	0	0
5	61428984	.	C	T	3	9	12	0	0	12	0	0
5	61429058	.	G	T	8	4	12	0	0	12	0	0
5	61429149	.	C	T	0	1	1	0	0	1	0	0
5	61431752	.	A	G	4	5	9	0	0	9	0	0
5	61431765	.	C	T	4	5	9	0	0	9	0	0
5	61432808	.	A	C	1	2	3	0	0	3	0	0
5	61432996	.	T	C	2	2	4	0	1	5	0	0
5	61433044	.	C	T	0	4	4	0	1	5	0	0
5	61433181	.	T	G	2	4	6	0	0	6	0	0
5	61433196	.	A	T	3	4	7	0	0	7	0	0
5	61433293	.	G	A	2	9	11	0	1	12	0	0
5	61433369	.	A	T	4	5	9	0	1	10	0	0
5	61435041	.	G	A	3	4	7	0	1	8	0	0
5	61435047	.	A	G	4	4	8	0	0	8	0	0
5	61464900	.	G	T	13	6	19	0	1	20	0	0
5	61467646	.	T	A	1	3	4	0	0	4	0	0
5	61467748	.	G	T	2	0	2	0	0	2	0	0
5	61467754	.	T	A	2	0	2	0	0	2	0	0
5	61472543	.	C	G	2	3	5	0	0	5	0	0
5	61508451	.	A	G	15	11	26	0	0	26	0	0
5	61508648	.	G	T	18	10	28	0	2	30	0	0
5	61548819	.	T	G	17	0	17	0	10	27	0	0
5	61552554	.	T	C	13	16	29	0	0	29	0	0
5	61552591	.	A	T	13	15	28	0	0	28	0	0
5	61552623	.	G	A	1	11	12	0	13	25	0	0
5	61552724	.	G	T	8	10	18	0	1	19	0	0
5	61552787	.	T	A	6	6	12	0	0	12	0	0
5	61552831	.	C	T	10	8	18	0	0	18	0	0
5	61552939	.	C	T	14	14	28	0	0	28	0	0
5	61553022	.	G	A	14	13	27	0	0	27	0	0
5	61553252	.	G	T	9	8	17	0	0	17	0	0
5	61553409	.	A	T	18	5	23	0	0	23	0	0
5	61553452	.	C	T	17	6	23	0	0	23	0	0
5	61553699	.	G	T	8	13	21	0	0	21	0	0
5	61553702	.	A	T	7	13	20	0	0	20	0	0
5	61553852	.	A	T	15	10	25	0	0	25	0	0
5	61566651	.	C	T	1	0	1	0	0	1	0	0
5	61566659	.	C	G	1	0	1	0	0	1	0	0
5	61570931	.	C	T	1	4	5	0	0	5	0	0
5	61571183	.	C	T	2	2	4	0	0	4	0	0
5	61571203	.	C	T	3	4	7	0	0	7	0	0
5	61584008	.	A	T	1	4	5	0	1	6	0	0
5	61584010	.	A	T	1	3	4	0	2	6	0	0
5	61588913	.	A	G	4	3	7	0	0	7	0	0
5	61660310	.	C	T	6	3	9	0	0	9	0	0
5	61660526	.	C	T	5	7	12	0	0	12	0	0
5	61706220	.	T	C	5	6	11	0	0	11	0	0
5	61712754	.	C	T	13	9	22	0	0	22	0	0
5	61723180	.	T	C	24	29	53	0	1	54	0	0
5	61723289	.	A	G	29	34	63	0	0	63	0	0
5	61723315	.	G	C	28	28	56	0	2	58	0	0
5	61723366	.	A	G	27	26	53	0	1	54	0	0
5	61723481	.	G	T	2	26	28	0	21	49	0	0
5	61723538	.	A	G	16	3	19	0	32	51	0	0
5	61723584	.	A	T	11	19	30	0	1	31	0	0
5	61723674	.	G	A	17	19	36	0	1	37	0	0
5	61723981	.	G	A	9	14	23	0	1	24	0	0
5	61724016	.	A	T	8	6	14	0	0	14	0	0
5	61790220	.	G	A	4	2	6	0	0	6	0	0
5	61790460	.	G	T	5	2	7	0	0	7	0	0
5	61791376	.	G	A	4	4	8	0	0	8	0	0
5	61793756	.	T	C	2	1	3	0	0	3	0	0
5	61793886	.	T	A	9	3	12	0	0	12	0	0
5	61794625	.	G	A	0	0	0	1	0	1	0	0
5	61799766	.	G	A	17	16	33	0	1	34	0	0
5	61801070	.	G	A	13	14	27	0	2	29	0	0
5	61804538	.	C	T	9	6	15	0	0	15	0	0
5	61806498	.	T	C	7	2	9	0	1	10	0	0
5	61817051	.	A	T	11	23	34	0	1	35	0	0
5	61866749	.	G	A	0	8	8	0	8	16	0	0
5	61868691	.	C	T	2	4	6	0	0	6	0	0
5	61870677	.	G	T	2	2	4	0	1	5	0	0
5	61871360	.	T	C	2	1	3	0	0	3	0	0
5	61874068	.	G	A	1	0	1	0	0	1	0	0
5	61881353	.	A	G	4	0	4	0	0	4	0	0
5	61884460	.	C	T	8	7	15	0	0	15	0	0
5	61884478	.	C	T	10	12	22	0	0	22	0	0
5	61884514	.	C	T	10	11	21	0	0	21	0	0
5	61886601	.	C	T	9	6	15	0	1	16	0	0
5	61886622	.	G	A	5	10	15	0	2	17	0	0
5	61889421	.	A	G	16	1	17	0	10	27	0	0
5	61889572	.	C	G	6	2	8	0	0	8	0	0
5	61890223	.	G	A	0	11	11	0	7	18	0	0
5	61890336	.	A	T	5	5	10	0	1	11	0	0
5	61921824	.	C	T	0	2	2	0	1	3	0	0
5	61923289	.	A	T	4	2	6	0	1	7	0	0
5	61923322	.	A	G	5	3	8	0	1	9	0	0
5	61930715	.	A	T	8	2	10	0	2	12	0	0
5	61931392	.	A	G	19	18	37	0	2	39	0	0
5	61931409	.	C	T	18	16	34	0	3	37	0	0
5	61931795	.	T	C	5	1	6	0	0	7	1	0
5	61932045	.	T	C	20	1	21	0	14	35	0	0
5	61932096	.	T	C	10	11	21	0	1	22	0	0
5	61932177	.	G	A	1	2	3	1	0	4	0	0
5	61932319	.	C	T	13	9	22	0	0	22	0	0
5	61932332	.	C	T	9	12	21	0	2	23	0	0
5	61932361	.	A	T	10	6	16	0	1	17	0	0
5	61932383	.	G	A	7	11	18	0	2	20	0	0
5	61932568	.	T	C	11	16	27	0	4	31	0	0
5	61932604	.	C	T	18	13	31	0	0	31	0	0
5	61932706	.	C	G	12	11	23	0	0	23	0	0
5	61932707	.	T	G	11	11	22	0	1	23	0	0
5	61932754	.	G	C	20	13	33	0	1	34	0	0
5	61934579	.	C	T	1	3	4	0	0	4	0	0
5	61941770	.	G	A	0	2	2	0	1	3	0	0
5	61947326	.	C	T	1	1	2	0	0	2	0	0
5	61947395	.	C	T	1	4	5	0	0	5	0	0
5	61947586	.	G	C	5	3	8	0	0	8	0	0
5	61947734	.	C	T	1	3	4	0	0	4	0	0
5	61947848	.	G	C	3	4	7	0	0	7	0	0
5	61947914	.	A	T	2	4	6	0	0	6	0	0
5	61948214	.	C	T	5	3	8	0	0	8	0	0
5	61948809	.	G	A	0	6	6	0	5	11	0	0
5	61949549	.	T	G	3	6	9	0	1	10	0	0
5	61949624	.	C	T	8	8	16	0	0	16	0	0
5	61949757	.	C	G	4	3	7	0	0	7	0	0
5	61950345	.	T	G	3	3	6	0	0	6	0	0
5	61950573	.	A	G	5	2	7	0	0	7	0	0
5	61950834	.	A	T	1	6	7	0	0	7	0	0
5	61951032	.	T	C	8	6	14	0	0	14	0	0
5	61998644	.	C	T	3	14	17	0	0	17	0	0
5	62004552	.	C	T	2	1	3	0	0	3	0	0
5	62004561	.	A	G	2	3	5	0	0	5	0	0
5	62004999	.	A	G	9	13	22	0	2	24	0	0
5	62005005	.	G	T	9	11	20	0	2	22	0	0
5	62005054	.	C	T	4	5	9	0	0	9	0	0
5	62018920	.	G	A	0	2	2	0	7	9	0	0
5	62025541	.	C	T	3	5	8	0	1	9	0	0
5	62025736	.	G	A	0	3	3	0	11	14	0	0
5	62025829	.	C	A	3	4	7	0	1	8	0	0
5	62025924	.	T	C	7	4	11	0	0	11	0	0
5	62029820	.	C	T	3	0	3	0	1	4	0	0
5	62038700	.	C	A	5	3	8	0	0	8	0	0
5	62042450	.	A	G	3	3	6	0	0	6	0	0
5	62052860	.	T	G	4	5	9	0	0	9	0	0
5	62053043	.	G	A	1	1	2	0	0	2	0	0
5	62288882	.	T	C	7	4	11	0	0	11	0	0
5	62288960	.	C	T	11	7	18	0	0	18	0	0
5	62289032	.	A	T	4	7	11	0	1	12	0	0
5	62289241	.	C	A	2	3	5	0	4	9	0	0
5	62289478	.	A	G	2	3	5	0	0	5	0	0
5	62289822	.	A	G	4	0	4	0	7	11	0	0
5	62290338	.	A	C	1	6	7	3	0	10	0	0
5	62290341	.	T	C	1	6	7	3	0	10	0	0
5	62290539	.	A	G	3	0	3	0	2	5	0	0
5	62290568	.	A	T	2	4	6	0	0	6	0	0
5	62290605	.	T	C	5	7	12	0	0	12	0	0
5	62290869	.	A	T	3	4	7	0	0	7	0	0
5	62290904	.	T	C	7	8	15	0	0	15	0	0
5	62290931	.	T	C	7	7	14	0	0	14	0	0
5	62311639	.	C	A	6	2	8	0	2	10	0	0
5	62321310	.	C	T	2	2	4	0	1	5	0	0
5	62328572	.	G	A	2	3	5	0	0	5	0	0
5	62328605	.	G	T	0	3	3	0	2	5	0	0
5	62328824	.	G	T	2	2	4	0	0	4	0	0
5	62329216	.	G	A	0	2	2	0	1	3	0	0
5	62329437	.	G	A	2	3	5	0	0	5	0	0
5	62329773	.	G	T	2	3	5	0	0	5	0	0
5	62329876	.	C	G	2	2	4	0	0	4	0	0
5	62329944	.	A	G	1	1	2	0	1	3	0	0
5	62330124	.	C	T	2	3	5	0	0	5	0	0
5	62330389	.	A	G	3	3	6	0	0	6	0	0
5	62330438	.	G	A	0	4	4	0	3	7	0	0
5	62330661	.	G	A	0	2	2	0	3	5	0	0
5	62330737	.	C	G	1	3	4	0	0	4	0	0
5	62331120	.	T	C	3	5	8	0	0	8	0	0
5	62331123	.	A	T	3	5	8	0	0	8	0	0
5	62331193	.	G	T	0	2	2	0	3	5	0	0
5	62331255	.	T	C	2	4	6	0	0	6	0	0
5	62331427	.	A	T	4	2	6	0	0	6	0	0
5	62331478	.	C	A	3	4	7	0	1	8	0	0
5	62331516	.	A	T	3	6	9	0	1	10	0	0
5	62331519	.	A	G	3	6	9	0	1	10	0	0
5	62331675	.	G	A	2	4	6	0	0	6	0	0
5	62331802	.	C	A	3	1	4	0	0	4	0	0
5	62331835	.	G	A	3	3	6	0	0	6	0	0
5	62331932	.	T	G	6	2	8	0	0	8	0	0
5	62332231	.	A	C	2	6	8	0	0	8	0	0
5	62332491	.	G	A	2	6	8	0	0	8	0	0
5	62332508	.	G	A	2	4	6	0	0	6	0	0
5	62332531	.	T	A	8	1	9	0	0	9	0	0
5	62332735	.	C	T	2	2	4	0	0	4	0	0
5	62332756	.	A	T	2	2	4	0	0	4	0	0
5	62333163	.	A	G	2	0	2	0	3	5	0	0
5	62333198	.	C	A	0	4	4	0	0	4	0	0
5	62333534	.	A	C	1	4	5	0	1	6	0	0
5	62333740	.	T	G	2	5	7	0	0	7	0	0
5	62333926	.	T	A	2	4	6	0	0	6	0	0
5	62334062	.	A	G	2	3	5	0	0	5	0	0
5	62334064	.	C	T	2	3	5	0	0	5	0	0
5	62334121	.	G	C	4	4	8	0	0	8	0	0
5	62334164	.	G	A	5	5	10	0	0	10	0	0
5	62334610	.	C	T	6	2	8	0	0	8	0	0
5	62334788	.	A	G	1	5	6	0	0	6	0	0
5	62334843	.	G	T	1	6	7	0	0	7	0	0
5	62334980	.	G	A	6	2	8	0	2	10	0	0
5	62335079	.	A	G	7	0	7	0	5	12	0	0
5	62335089	.	A	G	7	0	7	0	7	14	0	0
5	62335167	.	T	C	4	3	7	0	0	7	0	0
5	62335297	.	C	A	3	2	5	0	0	5	0	0
5	62335337	.	A	T	4	2	6	0	0	6	0	0
5	62335641	.	T	A	2	4	6	0	0	6	0	0
5	62335655	.	G	T	5	3	8	0	0	8	0	0
5	62521757	.	C	A	8	5	13	0	0	13	0	0
5	62526241	.	T	C	5	3	8	0	0	8	0	0
5	62526295	.	C	T	3	9	12	0	0	12	0	0
5	62533737	.	C	T	0	1	1	0	0	1	0	0
5	62633231	.	A	G	6	0	6	0	7	13	0	0
5	62637753	.	A	C	9	9	18	0	1	19	0	0
5	62639596	.	G	A	15	18	33	0	2	35	0	0
5	62642976	.	T	G	12	1	13	0	9	22	0	0
5	62642989	.	A	G	12	5	17	0	0	17	0	0
5	62806675	.	A	G	10	7	17	0	1	18	0	0
5	62806701	.	A	G	9	5	14	0	0	14	0	0
5	62806902	.	T	C	7	0	7	0	4	11	0	0
5	62806918	.	G	C	4	6	10	0	0	10	0	0
5	62806951	.	A	G	5	3	8	0	1	9	0	0
5	62807294	.	G	A	5	3	8	0	0	8	0	0
5	62807357	.	G	A	4	4	8	0	0	8	0	0
5	62821214	.	A	T	3	6	9	0	0	9	0	0
5	62856559	.	C	T	4	2	6	0	0	6	0	0
5	62868303	.	T	C	5	3	8	0	1	9	0	0
5	62868328	.	G	A	3	2	5	0	0	5	0	0
5	62883587	.	C	T	7	4	11	0	0	11	0	0
5	62885777	.	A	G	9	4	13	0	1	14	0	0
5	62885835	.	C	T	8	2	10	0	1	11	0	0
5	62885838	.	G	A	8	3	11	0	0	11	0	0
5	62889966	.	C	G	6	6	12	0	0	12	0	0
5	62890047	.	C	T	0	4	4	0	4	8	0	0
5	62890397	.	T	A	6	5	11	0	0	11	0	0
5	62890482	.	C	T	3	3	6	0	0	6	0	0
5	62890541	.	C	T	0	2	2	0	5	7	0	0
5	62890593	.	C	T	0	4	4	0	7	11	0	0
5	62890650	.	C	T	3	7	10	0	0	10	0	0
5	62890740	.	C	T	9	3	12	0	0	12	0	0
5	62890951	.	G	A	2	0	2	1	0	3	0	0
5	62924403	.	C	A	1	3	4	0	0	4	0	0
5	62924404	.	T	C	1	0	1	0	3	4	0	0
5	62940788	.	A	G	5	4	9	0	0	9	0	0
5	63198158	.	T	A	1	2	3	0	0	3	0	0
5	63200877	.	A	G	1	2	3	0	0	3	0	0
5	63200895	.	A	G	2	2	4	0	0	4	0	0
5	63248320	.	G	T	3	2	5	0	1	6	0	0
5	63248486	.	G	A	3	3	6	0	0	6	0	0
5	63248665	.	A	C	5	3	8	0	0	8	0	0
5	63248668	.	T	C	3	3	6	0	1	7	0	0
5	63268917	.	G	A	2	2	4	0	0	4	0	0
5	63276533	.	A	G	1	2	3	0	0	3	0	0
5	63285995	.	T	G	1	1	2	0	0	2	0	0
5	63305610	.	T	C	4	5	9	0	1	10	0	0
5	63322180	.	A	C	0	4	4	1	0	5	0	0
5	63359812	.	G	A	1	2	3	0	1	4	0	0
5	63360284	.	C	T	3	2	5	0	0	5	0	0
5	63360290	.	A	G	5	1	6	0	0	6	0	0
5	63360344	.	T	C	3	6	9	0	0	9	0	0
5	63363058	.	C	T	1	2	3	0	0	3	0	0
5	63378588	.	G	A	0	1	1	0	0	1	0	0
5	63378650	.	C	T	1	2	3	0	0	3	0	0
5	63382081	.	G	A	1	1	2	0	0	2	0	0
5	63386534	.	C	G	1	0	1	0	0	1	0	0
5	63387007	.	T	C	1	3	4	0	0	4	0	0
5	63395030	.	T	C	2	9	11	0	0	11	0	0
5	63395057	.	A	T	2	9	11	0	0	11	0	0
5	63398847	.	T	C	7	9	16	0	1	17	0	0
5	63399066	.	G	C	28	12	40	0	0	40	0	0
5	63399202	.	C	T	19	25	44	0	3	47	0	0
5	63399479	.	C	T	28	28	56	0	0	56	0	0
5	63399683	.	T	A	16	14	30	0	0	31	1	0
5	63400629	.	C	A	4	4	8	0	0	8	0	0
5	63400685	.	G	A	3	3	6	0	0	6	0	0
5	63412535	.	G	C	1	3	4	0	0	4	0	0
5	63412576	.	T	C	2	2	4	0	0	4	0	0
5	63418067	.	T	C	0	1	1	0	0	1	0	0
5	63434314	.	T	C	1	0	1	0	2	3	0	0
5	63510908	.	G	T	5	4	9	0	1	10	0	0
5	63511045	.	A	G	5	4	9	0	1	10	0	0
5	63511110	.	T	C	3	0	3	0	7	10	0	0
5	63511170	.	A	G	3	4	7	0	0	7	0	0
5	63511172	.	T	G	3	3	6	0	1	7	0	0
5	63511525	.	A	G	9	6	15	0	0	15	0	0
5	63511537	.	A	G	7	7	14	0	1	15	0	0
5	63629299	.	A	T	4	9	13	0	0	13	0	0
5	63644850	.	G	A	3	6	9	0	0	9	0	0
5	63648376	.	T	C	3	0	3	0	2	5	0	0
5	63648811	.	A	G	3	2	5	0	0	5	0	0
5	63657590	.	G	C	1	1	2	0	0	2	0	0
5	63658512	.	G	A	0	5	5	0	0	5	0	0
5	63659582	.	T	A	1	0	1	0	0	1	0	0
5	63680655	.	A	G	9	1	10	0	9	19	0	0
5	63680661	.	C	G	8	8	16	0	0	16	0	0
5	63680709	.	T	G	4	3	7	0	0	7	0	0
5	63680718	.	A	G	2	0	2	0	3	5	0	0
5	63681123	.	A	G	4	2	6	0	0	6	0	0
5	63695760	.	C	T	5	6	11	0	0	11	0	0
5	63698549	.	T	C	0	7	7	0	0	7	0	0
5	63699468	.	T	C	2	1	3	0	0	3	0	0
5	63720639	.	A	G	9	11	20	0	1	21	0	0
5	63723807	.	G	A	0	8	8	0	5	13	0	0
5	63730115	.	G	A	2	12	14	0	15	29	0	0
5	63739912	.	A	G	11	27	38	0	0	38	0	0
5	63740093	.	C	T	10	14	24	0	0	24	0	0
5	63740097	.	T	A	8	12	20	0	1	21	0	0
5	63740149	.	T	C	10	8	18	0	1	19	0	0
5	63740167	.	A	G	9	8	17	0	3	20	0	0
5	63740815	.	A	C	22	20	42	0	1	43	0	0
5	63740874	.	A	C	16	21	37	0	1	38	0	0
5	63740895	.	A	C	14	22	36	0	1	37	0	0
5	63740910	.	A	G	12	23	35	0	0	35	0	0
5	63741023	.	T	A	11	9	20	0	0	20	0	0
5	63741077	.	A	T	7	8	15	0	0	15	0	0
5	63848566	.	G	A	0	5	5	0	10	15	0	0
5	63848593	.	T	C	6	5	11	0	0	11	0	0
5	63848662	.	C	G	5	9	14	0	0	14	0	0
5	63857154	.	A	C	1	2	3	0	0	3	0	0
5	63858978	.	C	T	2	3	5	0	0	5	0	0
5	63860701	.	G	A	0	2	2	0	4	6	0	0
5	63860831	.	A	G	6	0	6	0	3	9	0	0
5	63861164	.	A	T	3	4	7	0	0	7	0	0
5	63861167	.	G	T	3	3	6	0	0	6	0	0
5	63861331	.	A	G	4	2	6	0	0	6	0	0
5	63862198	.	T	A	3	2	5	0	0	5	0	0
5	63862204	.	T	C	2	2	4	0	1	5	0	0
5	63862298	.	G	C	1	2	3	0	0	3	0	0
5	63862323	.	G	A	2	2	4	0	0	4	0	0
5	63862938	.	A	G	1	3	4	0	0	4	0	0
5	63862942	.	A	G	0	3	3	0	1	4	0	0
5	63863629	.	A	G	2	0	2	0	2	4	0	0
5	63863671	.	G	A	4	3	7	0	0	7	0	0
5	63863676	.	G	A	5	3	8	0	0	8	0	0
5	63863998	.	G	A	0	4	4	0	2	6	0	0
5	64177760	.	T	A	5	5	10	0	0	10	0	0
5	64177762	.	T	A	5	5	10	0	0	10	0	0
5	64181114	.	T	A	1	1	2	0	0	2	0	0
5	64182403	.	G	A	3	1	4	0	0	4	0	0
5	64184521	.	C	T	0	1	1	0	0	1	0	0
5	64184626	.	G	A	3	7	10	0	0	10	0	0
5	64204517	.	C	T	7	8	15	0	1	16	0	0
5	64204524	.	T	C	8	8	16	0	0	16	0	0
5	64205046	.	C	T	5	4	9	0	1	10	0	0
5	64205388	.	C	T	9	12	21	0	0	21	0	0
5	64205784	.	T	C	10	4	14	0	1	15	0	0
5	64205879	.	T	A	4	2	6	0	2	8	0	0
5	64205881	.	G	A	4	4	8	0	0	8	0	0
5	64205937	.	T	C	7	3	10	0	0	10	0	0
5	64206182	.	G	A	4	12	16	0	0	16	0	0
5	64206266	.	C	T	0	6	6	0	2	8	0	0
5	64206402	.	G	A	10	8	18	0	0	18	0	0
5	64206411	.	A	G	9	10	19	0	1	20	0	0
5	64206453	.	G	A	6	3	9	0	0	9	0	0
5	64206455	.	C	T	3	4	7	0	2	9	0	0
5	64206591	.	A	G	10	8	18	0	1	19	0	0
5	64206688	.	C	T	6	11	17	0	1	18	0	0
5	64207386	.	T	C	6	0	6	0	9	15	0	0
5	64207415	.	C	T	0	9	9	0	10	19	0	0
5	64207570	.	T	G	7	3	10	0	1	11	0	0
5	64207779	.	A	G	3	1	4	0	0	4	0	0
5	64210227	.	C	T	0	3	3	0	5	8	0	0
5	64210350	.	G	A	7	6	13	0	0	13	0	0
5	64212865	.	G	A	4	3	7	0	2	9	0	0
5	64212868	.	T	A	5	4	9	0	0	9	0	0
5	64277624	.	G	A	1	2	3	0	0	3	0	0
5	64291675	.	G	T	2	2	4	0	0	4	0	0
5	64299242	.	C	T	1	2	3	0	0	3	0	0
5	64299257	.	T	C	2	2	4	0	0	4	0	0
5	64369001	.	A	C	6	5	11	0	1	12	0	0
5	64369089	.	C	T	2	3	5	0	0	5	0	0
5	64376756	.	C	A	4	5	9	0	0	9	0	0
5	64377399	.	C	T	2	9	11	0	1	12	0	0
5	64377618	.	T	C	2	2	4	0	0	4	0	0
5	64377957	.	G	A	1	3	4	0	0	4	0	0
5	64378175	.	C	T	7	3	10	0	0	10	0	0
5	64378293	.	G	A	0	6	6	0	3	9	0	0
5	64378369	.	T	C	3	5	8	0	0	8	0	0
5	64378404	.	T	C	7	2	9	0	0	9	0	0
5	64378413	.	G	C	2	7	9	0	0	9	0	0
5	64397667	.	C	A	22	11	33	0	1	34	0	0
5	64398506	.	C	T	22	25	47	0	2	49	0	0
5	64398554	.	G	A	9	16	25	0	2	27	0	0
5	64398688	.	C	T	12	4	16	0	1	17	0	0
5	64408107	.	C	A	3	2	5	0	0	5	0	0
5	64408134	.	A	G	5	4	9	0	1	10	0	0
5	64408157	.	A	T	6	4	10	0	0	10	0	0
5	64408682	.	C	T	1	5	6	0	0	6	0	0
5	64412096	.	C	T	0	9	9	0	13	22	0	0
5	64412907	.	G	A	6	5	11	0	0	11	0	0
5	64413095	.	A	C	14	16	30	0	0	30	0	0
5	64413319	.	G	A	5	4	9	0	0	9	0	0
5	64413383	.	G	T	7	4	11	0	1	12	0	0
5	64413458	.	A	G	5	4	9	0	0	9	0	0
5	64413834	.	G	T	6	6	12	0	0	13	1	0
5	64413842	.	C	T	11	4	15	0	0	15	0	0
5	64413943	.	C	T	11	10	21	0	2	23	0	0
5	64439116	.	G	A	5	9	14	0	0	14	0	0
5	64439218	.	T	C	6	9	15	0	3	18	0	0
5	64439272	.	T	C	16	0	16	0	9	25	0	0
5	64444517	.	G	A	2	4	6	0	0	6	0	0
5	64448456	.	T	A	5	9	14	0	1	15	0	0
5	64454394	.	A	G	5	4	9	0	0	9	0	0
5	64732170	.	T	A	18	20	38	0	3	42	1	0
5	64732240	.	T	C	17	31	48	0	2	50	0	0
5	64740004	.	G	A	12	11	23	0	0	23	0	0
5	64848834	.	T	C	1	0	1	0	0	1	0	0
5	65062558	.	G	A	0	8	8	0	2	10	0	0
5	65067533	.	T	C	2	2	4	0	0	4	0	0
5	65624163	.	G	A	0	1	1	0	0	1	0	0
5	66250917	.	C	T	4	4	8	0	0	8	0	0
5	66252054	.	G	A	0	0	0	0	2	2	0	0
5	66266997	.	A	G	2	3	5	0	1	6	0	0
5	66268964	.	A	G	0	0	0	0	1	1	0	0
5	66271189	.	G	A	2	1	3	0	0	3	0	0
5	66271214	.	C	T	2	1	3	0	1	4	0	0
5	66676766	.	C	G	6	2	8	0	0	8	0	0
5	66676768	.	G	A	6	2	8	0	0	8	0	0
5	66699135	.	G	T	10	10	20	0	0	20	0	0
5	66699138	.	C	G	10	10	20	0	0	20	0	0
5	66699564	.	G	T	6	7	13	0	0	13	0	0
5	66700388	.	C	T	4	2	6	0	0	6	0	0
5	66700602	.	T	A	1	2	3	0	0	3	0	0
5	66700608	.	T	C	1	2	3	0	0	3	0	0
5	66700734	.	C	A	0	4	4	0	6	10	0	0
5	66700833	.	T	C	4	1	5	0	4	9	0	0
5	66700974	.	T	A	4	3	7	0	0	7	0	0
5	66701266	.	T	C	2	3	5	0	0	5	0	0
5	66701493	.	T	C	5	4	9	0	0	9	0	0
5	66702411	.	G	A	2	2	4	0	0	4	0	0
5	66733482	.	C	G	2	2	4	0	0	4	0	0
5	66733572	.	C	T	0	4	4	0	3	7	0	0
5	66733682	.	T	C	11	7	18	0	2	20	0	0
5	66733694	.	T	C	12	1	13	0	8	21	0	0
5	66733891	.	G	C	7	5	12	0	1	13	0	0
5	66736211	.	T	C	0	2	2	0	0	2	0	0
5	66736280	.	A	G	4	5	9	0	1	10	0	0
5	66740183	.	A	T	8	6	14	0	2	16	0	0
5	66740239	.	T	G	9	4	13	0	0	13	0	0
5	66740273	.	A	T	5	2	7	0	1	8	0	0
5	66807482	.	C	T	12	14	26	0	0	26	0	0
5	66807543	.	C	T	0	22	22	0	17	39	0	0
5	66807771	.	T	G	8	13	21	0	0	21	0	0
5	66807788	.	C	T	1	14	15	0	8	23	0	0
5	66807830	.	G	A	11	10	21	0	1	22	0	0
5	66807831	.	A	G	10	10	20	0	2	22	0	0
5	66807881	.	A	G	16	9	25	0	1	26	0	0
5	66807916	.	T	C	16	17	33	0	0	33	0	0
5	66813647	.	T	C	8	0	8	0	4	13	1	0
5	66813674	.	G	A	10	7	17	0	0	17	0	0
5	66813722	.	A	G	1	2	3	0	0	3	0	0
5	66814504	.	T	C	7	7	14	0	0	14	0	0
5	66814522	.	A	G	8	8	16	0	2	18	0	0
5	66818699	.	C	T	12	17	29	0	1	30	0	0
5	66819515	.	T	C	14	14	28	0	0	28	0	0
5	66820859	.	A	T	7	10	17	0	0	17	0	0
5	67079724	.	C	A	1	0	1	0	0	1	0	0
5	67884508	.	G	A	7	3	10	0	1	11	0	0
5	68766688	.	T	C	3	0	3	0	8	11	0	0
5	68766704	.	C	T	10	3	13	0	1	14	0	0
5	68767050	.	C	T	0	14	14	1	8	23	0	0
5	68767439	.	G	T	3	5	8	0	1	9	0	0
5	68767642	.	A	C	5	4	9	0	1	10	0	0
5	68767802	.	G	A	2	3	5	0	0	5	0	0
5	68778455	.	T	A	5	6	11	0	0	11	0	0
5	68778524	.	C	A	0	2	2	0	7	9	0	0
5	68778746	.	C	G	0	7	7	0	9	16	0	0
5	68778957	.	G	T	8	3	11	0	0	11	0	0
5	68779049	.	A	G	6	7	13	0	0	13	0	0
5	68779214	.	A	G	6	5	11	0	0	11	0	0
5	68779472	.	G	T	5	6	11	0	0	11	0	0
5	68779595	.	G	T	5	6	11	0	0	11	0	0
5	68782207	.	G	A	2	3	5	0	0	5	0	0
5	68782210	.	C	T	2	3	5	0	0	5	0	0
5	68782433	.	T	G	3	3	6	0	0	6	0	0
5	68782584	.	C	T	2	3	5	0	2	7	0	0
5	68831382	.	C	T	2	2	4	0	0	4	0	0
5	68840928	.	T	C	0	2	2	0	0	2	0	0
5	68846542	.	G	T	1	0	1	0	0	1	0	0
5	68848116	.	G	A	4	6	10	0	0	10	0	0
5	68850856	.	C	T	0	0	0	0	1	1	0	0
5	68850967	.	C	G	0	7	7	0	5	12	0	0
5	68863784	.	C	T	0	7	7	0	4	11	0	0
5	68863806	.	T	C	4	0	4	0	8	12	0	0
5	68892515	.	A	C	0	1	1	0	0	1	0	0
5	68892550	.	C	T	8	1	9	0	0	9	0	0
5	68892872	.	T	C	3	8	11	0	0	11	0	0
5	68892917	.	T	C	1	6	7	0	0	7	0	0
5	68899505	.	C	T	2	2	4	0	0	4	0	0
5	68900820	.	C	G	6	7	13	0	0	13	0	0
5	68900825	.	G	A	6	6	12	0	1	13	0	0
5	68927410	.	T	A	0	4	4	0	0	4	0	0
5	68927539	.	G	A	2	4	6	0	0	6	0	0
5	68927557	.	G	A	3	6	9	0	1	10	0	0
5	68927591	.	G	A	7	2	9	0	0	9	0	0
5	68980985	.	G	T	0	2	2	0	1	3	0	0
5	68982205	.	G	T	3	2	5	0	0	5	0	0
5	68982340	.	G	A	9	2	11	0	1	12	0	0
5	68993809	.	G	C	0	0	0	0	1	1	0	0
5	68998572	.	A	T	1	1	2	0	0	2	0	0
5	69002293	.	C	T	4	8	12	0	0	12	0	0
5	69008453	.	A	C	5	0	5	0	5	10	0	0
5	69014276	.	T	C	0	2	2	0	0	2	0	0
5	69016025	.	C	T	3	1	4	0	0	4	0	0
5	69018997	.	G	A	1	1	2	0	0	2	0	0
5	69140658	.	T	C	1	1	2	0	0	2	0	0
5	69140680	.	T	A	1	2	3	0	0	3	0	0
5	69141307	.	G	A	12	3	15	0	1	16	0	0
5	69141440	.	G	T	6	12	18	0	0	18	0	0
5	69144428	.	C	T	0	1	1	0	2	3	0	0
5	69234725	.	C	T	0	1	1	0	1	2	0	0
5	69235583	.	G	A	1	3	4	0	1	5	0	0
5	69235589	.	A	C	2	3	5	0	0	5	0	0
5	69259068	.	C	T	1	2	3	0	0	3	0	0
5	69259347	.	G	A	4	4	8	0	0	8	0	0
5	69259384	.	G	A	5	3	8	0	0	8	0	0
5	69271104	.	G	T	2	2	4	0	1	5	0	0
5	69271220	.	G	T	2	7	9	0	0	9	0	0
5	69271304	.	A	C	6	2	8	0	0	8	0	0
5	69278192	.	A	G	16	0	16	0	30	46	0	0
5	69287061	.	C	T	11	6	17	0	0	17	0	0
5	69287180	.	A	T	13	18	31	0	1	32	0	0
5	69287264	.	C	G	13	12	25	0	1	26	0	0
5	69287498	.	C	T	2	5	7	0	0	7	0	0
5	69290128	.	A	G	5	3	8	0	0	8	0	0
5	69290980	.	C	T	1	2	3	0	0	3	0	0
5	69291071	.	A	T	5	3	8	0	0	8	0	0
5	69291109	.	T	C	2	5	7	0	0	7	0	0
5	69293183	.	C	T	0	3	3	0	2	5	0	0
5	69427984	.	A	G	12	20	32	0	0	32	0	0
5	69428056	.	A	T	6	4	10	0	1	11	0	0
5	69428148	.	T	C	3	2	5	0	1	6	0	0
5	69429187	.	C	T	2	2	4	0	0	4	0	0
5	69429205	.	G	T	1	2	3	0	0	3	0	0
5	69429544	.	G	A	16	16	32	0	3	35	0	0
5	69431287	.	G	C	11	11	22	0	0	22	0	0
5	69431486	.	A	G	0	1	1	0	0	1	0	0
5	69462882	.	G	A	1	1	2	0	0	2	0	0
5	69462894	.	C	T	0	0	0	0	1	1	0	0
5	69463077	.	G	A	2	5	7	0	1	8	0	0
5	69464731	.	G	A	4	0	4	0	1	5	0	0
5	69464773	.	G	A	6	1	7	0	0	7	0	0
5	69464811	.	C	T	0	5	5	0	4	9	0	0
5	69466375	.	G	T	1	3	4	0	0	4	0	0
5	69469336	.	G	A	0	2	2	0	0	2	0	0
5	69479393	.	T	G	1	2	3	0	0	3	0	0
5	69482885	.	C	T	0	1	1	0	1	2	0	0
5	69486379	.	A	T	2	2	4	0	0	4	0	0
5	69486618	.	T	C	9	8	17	0	2	19	0	0
5	69486698	.	G	A	9	10	19	0	0	19	0	0
5	69486749	.	A	T	8	13	21	0	1	22	0	0
5	69486756	.	G	A	8	11	19	0	2	21	0	0
5	69486844	.	G	T	3	1	4	0	0	4	0	0
5	69491754	.	G	A	3	5	8	0	1	9	0	0
5	69491766	.	T	C	4	1	5	0	7	12	0	0
5	69492126	.	G	C	5	0	5	0	6	11	0	0
5	69505988	.	A	G	0	3	3	0	1	4	0	0
5	69505993	.	T	G	1	3	4	0	0	4	0	0
5	69557764	.	A	G	4	1	5	0	0	5	0	0
5	69557776	.	G	T	3	2	5	0	1	6	0	0
5	69574972	.	G	T	12	11	23	0	1	24	0	0
5	69579118	.	T	C	7	0	7	0	11	18	0	0
5	69579378	.	G	A	1	0	1	0	0	1	0	0
5	69581937	.	G	A	1	4	5	0	0	5	0	0
5	69581943	.	C	T	0	2	2	0	5	7	0	0
5	69595361	.	G	A	2	9	11	0	0	11	0	0
5	69595412	.	G	A	12	2	14	0	0	14	0	0
5	69595416	.	A	C	11	2	13	0	0	13	0	0
5	69599798	.	G	T	0	2	2	0	0	2	0	0
5	69607398	.	T	C	0	4	4	0	0	4	0	0
5	69607411	.	A	C	0	0	0	0	0	3	3	0
5	69616625	.	A	T	2	0	2	0	0	2	0	0
5	69673180	.	C	A	0	4	4	0	0	4	0	0
5	69673214	.	A	C	0	4	4	0	0	4	0	0
5	69686414	.	T	C	1	3	4	0	0	4	0	0
5	69686458	.	T	A	2	6	8	0	0	8	0	0
5	69783716	.	A	G	2	7	9	0	1	10	0	0
5	69907555	.	T	C	3	10	13	0	1	14	0	0
5	69927317	.	C	T	5	2	7	0	2	9	0	0
5	70183091	.	T	C	14	13	27	1	2	30	0	0
5	71748357	.	T	C	3	4	7	0	0	7	0	0
5	71765768	.	C	T	10	6	16	0	1	17	0	0
5	71934514	.	C	G	7	3	10	0	2	12	0	0
5	71934762	.	T	C	2	2	4	0	1	5	0	0
5	71934867	.	C	T	2	4	6	0	0	6	0	0
5	71943627	.	C	T	0	1	1	0	0	1	0	0
5	71944137	.	G	A	0	3	3	0	2	5	0	0
5	71944140	.	G	A	2	3	5	0	0	5	0	0
5	71946050	.	G	A	1	0	1	0	0	1	0	0
5	71946074	.	T	C	0	1	1	0	0	1	0	0
5	71946405	.	G	A	3	2	5	0	0	5	0	0
5	71946540	.	A	G	5	4	9	0	0	9	0	0
5	71983564	.	G	C	1	2	3	0	0	3	0	0
5	71995042	.	C	A	0	2	2	0	1	3	0	0
5	72002655	.	A	C	3	2	5	0	0	5	0	0
5	72002712	.	G	A	3	2	5	0	1	6	0	0
5	72002730	.	C	G	0	0	0	0	4	4	0	0
5	72002790	.	G	T	6	2	8	0	0	8	0	0
5	72002796	.	G	A	6	2	8	0	0	8	0	0
5	72023857	.	C	T	23	10	33	0	9	42	0	0
5	72024336	.	C	T	0	5	5	0	1	6	0	0
5	72027464	.	C	T	0	2	2	0	1	3	0	0
5	72028042	.	G	C	4	1	5	0	7	12	0	0
5	72031809	.	G	A	17	17	34	0	1	35	0	0
5	72031846	.	A	G	10	12	22	0	0	22	0	0
5	72033527	.	C	T	0	7	7	0	8	15	0	0
5	72034108	.	C	T	0	4	4	0	9	13	0	0
5	72034177	.	A	G	3	2	5	0	0	5	0	0
5	72038586	.	C	T	9	16	25	0	1	26	0	0
5	72038727	.	G	A	8	13	21	0	1	22	0	0
5	72038909	.	C	T	0	17	17	0	8	25	0	0
5	72039105	.	G	A	7	13	20	0	1	21	0	0
5	72043751	.	A	G	13	5	18	0	0	18	0	0
5	72043778	.	G	A	13	9	22	0	3	25	0	0
5	72043791	.	G	T	15	11	26	0	4	31	1	0
5	72044324	.	G	A	3	7	10	0	0	10	0	0
5	72045010	.	C	T	0	3	3	0	1	4	0	0
5	72046888	.	C	T	12	6	18	0	0	18	0	0
5	72047047	.	C	G	1	15	16	0	4	20	0	0
5	72047127	.	T	A	4	4	8	0	1	9	0	0
5	72047136	.	T	C	2	0	2	0	2	4	0	0
5	72049688	.	C	A	0	3	3	0	2	5	0	0
5	72050192	.	A	G	12	15	27	0	3	30	0	0
5	72050257	.	C	T	2	16	18	0	10	28	0	0
5	72050314	.	T	C	11	0	11	0	16	27	0	0
5	72058489	.	T	C	2	3	5	0	0	5	0	0
5	72066904	.	C	T	5	11	16	0	0	16	0	0
5	72066993	.	G	A	2	6	8	0	0	8	0	0
5	72067803	.	A	G	0	2	2	0	0	2	0	0
5	72068820	.	C	T	0	4	4	0	2	6	0	0
5	72068908	.	C	A	1	2	3	0	0	3	0	0
5	72069295	.	C	A	3	2	5	0	0	5	0	0
5	72072329	.	C	A	1	2	3	0	0	3	0	0
5	72075193	.	T	C	0	0	0	0	1	1	0	0
5	72075405	.	A	G	2	3	5	0	0	5	0	0
5	72092483	.	C	T	38	18	56	0	2	58	0	0
5	72092958	.	G	A	0	16	16	0	7	23	0	0
5	72095464	.	G	A	3	3	6	0	0	6	0	0
5	72130139	.	C	A	6	4	10	0	0	10	0	0
5	72130656	.	A	G	6	3	9	0	0	9	0	0
5	72131482	.	C	T	0	6	6	0	2	8	0	0
5	72131531	.	C	T	3	6	9	0	0	9	0	0
5	72131558	.	A	T	8	4	12	0	0	12	0	0
5	72131618	.	C	T	1	3	4	0	0	4	0	0
5	72139978	.	G	A	1	3	4	0	0	4	0	0
5	72142077	.	T	C	2	4	6	0	0	6	0	0
5	72157900	.	A	G	2	3	5	0	0	5	0	0
5	72166708	.	A	G	2	1	3	0	0	3	0	0
5	72167239	.	C	T	2	2	4	0	0	4	0	0
5	72167277	.	G	A	2	5	7	0	1	8	0	0
5	72167289	.	A	G	2	5	7	0	1	8	0	0
5	72167379	.	C	T	3	3	6	0	1	7	0	0
5	72168267	.	A	G	5	2	7	0	1	8	0	0
5	72168297	.	T	G	3	0	3	0	6	9	0	0
5	72168552	.	C	T	4	5	9	0	0	9	0	0
5	72172350	.	T	A	24	23	47	0	1	48	0	0
5	72172446	.	G	T	18	16	34	0	0	34	0	0
5	72172456	.	G	T	20	16	36	0	1	37	0	0
5	72172600	.	T	C	16	8	24	0	1	25	0	0
5	72172752	.	G	A	13	30	43	0	2	45	0	0
5	72173169	.	C	A	6	11	17	0	1	18	0	0
5	72173476	.	T	C	15	12	27	0	2	29	0	0
5	72173483	.	T	G	14	13	27	0	1	28	0	0
5	72173894	.	G	A	15	13	28	0	0	28	0	0
5	72173943	.	C	T	11	11	22	0	2	24	0	0
5	72196949	.	G	A	2	2	4	0	2	6	0	0
5	72201999	.	C	T	1	1	2	0	0	2	0	0
5	72202402	.	G	A	0	2	2	0	2	4	0	0
5	72202467	.	G	A	1	4	5	0	2	7	0	0
5	72205483	.	A	C	5	7	12	0	0	12	0	0
5	72205583	.	T	G	10	0	10	0	6	16	0	0
5	72205701	.	G	A	3	2	5	0	0	5	0	0
5	72206009	.	T	C	9	5	14	0	0	14	0	0
5	72206090	.	T	C	2	7	9	0	1	10	0	0
5	72206155	.	G	T	5	7	12	0	0	12	0	0
5	72206235	.	T	G	2	1	3	0	3	6	0	0
5	72316948	.	A	G	2	2	4	0	0	4	0	0
5	72317534	.	T	C	1	2	3	0	0	3	0	0
5	72317589	.	T	G	4	3	7	0	0	7	0	0
5	72317622	.	C	T	2	4	6	0	0	6	0	0
5	72317643	.	A	G	1	4	5	0	0	5	0	0
5	72318027	.	T	C	4	1	5	0	0	5	0	0
5	72318067	.	C	G	2	1	3	0	1	4	0	0
5	72318075	.	A	G	0	3	3	0	0	3	0	0
5	72318307	.	G	A	3	2	5	0	0	5	0	0
5	72376119	.	C	G	15	29	44	0	0	44	0	0
5	72376227	.	A	G	18	18	36	0	1	37	0	0
5	72376959	.	A	G	9	18	27	0	1	28	0	0
5	72382995	.	C	T	2	3	5	0	0	5	0	0
5	72383263	.	C	T	14	13	27	0	0	27	0	0
5	72384395	.	C	T	23	6	29	0	0	29	0	0
5	72384396	.	A	G	23	5	28	0	1	29	0	0
5	72384524	.	A	G	4	8	12	0	1	13	0	0
5	72384642	.	T	C	5	14	19	0	1	20	0	0
5	72384807	.	T	C	9	0	9	0	14	23	0	0
5	72384978	.	G	A	13	9	22	0	4	26	0	0
5	72385001	.	C	T	21	8	29	0	1	30	0	0
5	72385034	.	A	G	21	10	31	0	2	33	0	0
5	72385075	.	C	T	11	13	24	0	0	24	0	0
5	72386870	.	T	C	13	14	27	0	1	28	0	0
5	72389156	.	C	A	1	7	8	0	7	15	0	0
5	72390189	.	G	A	14	12	26	0	1	27	0	0
5	72412200	.	G	T	1	2	3	0	0	3	0	0
6	28313	.	G	A	6	3	9	0	0	9	0	0
6	29439	.	T	C	16	10	26	0	0	26	0	0
6	33139	.	A	G	1	4	5	0	0	5	0	0
6	35464	.	G	C	3	4	7	0	0	7	0	0
6	37050	.	C	T	4	3	7	0	0	7	0	0
6	37919	.	C	T	4	3	7	0	0	7	0	0
6	38264	.	C	G	8	8	16	0	0	16	0	0
6	41065	.	A	T	6	10	16	0	2	18	0	0
6	41164	.	A	G	3	1	4	0	6	10	0	0
6	42301	.	A	T	11	9	20	0	1	21	0	0
6	58559	.	G	A	0	4	4	0	12	16	0	0
6	59048	.	C	T	6	5	11	0	2	13	0	0
6	59171	.	G	A	8	3	11	0	0	11	0	0
6	59459	.	T	C	5	4	9	0	0	9	0	0
6	59465	.	G	A	5	4	9	0	0	9	0	0
6	59732	.	T	C	2	0	2	0	0	2	0	0
6	92359	.	T	G	7	8	15	0	0	15	0	0
6	92383	.	A	G	6	8	14	0	0	14	0	0
6	93840	.	T	C	15	15	30	0	0	30	0	0
6	93966	.	A	G	4	4	8	0	0	8	0	0
6	102633	.	T	C	3	2	5	0	0	5	0	0
6	121239	.	C	T	3	6	9	0	0	9	0	0
6	132157	.	G	C	5	4	9	0	0	9	0	0
6	132867	.	C	T	5	9	14	0	1	15	0	0
6	132868	.	A	G	5	9	14	0	1	15	0	0
6	134267	.	C	G	2	9	11	0	0	11	0	0
6	134270	.	C	T	0	8	8	0	2	10	0	0
6	136816	.	G	A	2	6	8	0	0	8	0	0
6	136988	.	A	T	5	5	10	0	0	10	0	0
6	152306	.	A	G	4	0	4	0	7	11	0	0
6	152680	.	T	A	8	6	14	0	0	14	0	0
6	169944	.	G	A	1	2	3	0	0	3	0	0
6	169959	.	A	C	0	3	3	0	0	3	0	0
6	184361	.	C	T	6	6	12	0	0	12	0	0
6	184382	.	A	G	3	0	3	0	2	5	0	0
6	202561	.	T	C	10	6	16	0	2	18	0	0
6	203950	.	A	T	4	10	14	0	0	14	0	0
6	204004	.	C	T	4	10	14	0	0	14	0	0
6	204014	.	A	C	4	10	14	0	0	14	0	0
6	204106	.	G	A	0	2	2	0	7	9	0	0
6	204354	.	T	C	7	7	14	0	0	14	0	0
6	204385	.	C	T	4	2	6	0	2	8	0	0
6	204952	.	T	C	7	13	20	0	0	20	0	0
6	205090	.	T	C	6	4	10	0	0	10	0	0
6	205102	.	G	A	7	5	12	0	0	12	0	0
6	205159	.	T	C	5	5	10	0	0	10	0	0
6	205258	.	G	A	0	12	12	0	9	21	0	0
6	265188	.	G	T	18	11	29	0	1	30	0	0
6	265191	.	A	T	17	11	28	0	1	29	0	0
6	265837	.	G	A	7	7	14	0	0	14	0	0
6	267412	.	C	T	15	4	19	0	0	19	0	0
6	267417	.	C	G	15	4	19	0	0	19	0	0
6	267451	.	G	A	0	5	5	0	13	18	0	0
6	267501	.	G	C	5	6	11	0	0	11	0	0
6	267516	.	G	A	8	5	13	0	1	14	0	0
6	267568	.	A	G	11	5	16	0	1	17	0	0
6	267645	.	C	T	7	7	14	0	1	15	0	0
6	267669	.	C	T	7	7	14	0	1	15	0	0
6	267817	.	G	A	8	5	13	0	0	13	0	0
6	267884	.	T	C	5	7	12	0	1	13	0	0
6	267886	.	T	C	5	7	12	0	1	13	0	0
6	271793	.	C	A	16	17	33	0	6	39	0	0
6	272041	.	C	T	19	25	44	0	1	45	0	0
6	272056	.	A	G	20	20	40	0	1	41	0	0
6	272298	.	G	A	1	21	22	0	24	46	0	0
6	272503	.	T	C	11	6	17	0	0	17	0	0
6	322371	.	C	T	6	7	13	0	0	13	0	0
6	331909	.	T	A	4	9	13	0	1	14	0	0
6	331912	.	C	T	5	10	15	0	0	15	0	0
6	340480	.	A	C	19	8	27	0	1	28	0	0
6	340488	.	T	C	13	9	22	0	2	24	0	0
6	340670	.	A	G	11	23	34	0	2	36	0	0
6	340800	.	T	G	15	6	21	0	1	23	1	0
6	340839	.	A	G	11	4	15	0	0	15	0	0
6	340931	.	G	A	6	8	14	0	1	15	0	0
6	341882	.	G	A	13	17	30	0	3	33	0	0
6	341933	.	G	A	19	19	38	0	1	39	0	0
6	341953	.	C	T	17	24	41	0	1	42	0	0
6	342017	.	T	A	10	15	25	0	1	26	0	0
6	342123	.	C	T	7	11	18	0	0	18	0	0
6	374956	.	T	A	6	11	17	0	0	17	0	0
6	374988	.	G	T	7	9	16	0	0	16	0	0
6	375007	.	A	C	6	10	16	0	0	16	0	0
6	375051	.	T	C	2	1	3	0	1	4	0	0
6	543216	.	G	A	0	3	3	0	0	3	0	0
6	543429	.	C	T	2	2	4	0	1	5	0	0
6	543474	.	A	G	2	0	2	0	2	4	0	0
6	840792	.	C	G	8	14	22	0	1	23	0	0
6	841511	.	T	C	8	8	16	0	2	18	0	0
6	841557	.	A	G	8	7	15	0	2	17	0	0
6	841851	.	T	C	13	18	31	0	0	31	0	0
6	841941	.	G	A	5	12	17	0	2	19	0	0
6	842009	.	G	A	10	15	25	0	1	26	0	0
6	842010	.	C	T	0	15	15	0	11	26	0	0
6	842149	.	A	T	9	6	15	0	2	18	1	0
6	842241	.	T	C	10	4	14	0	0	14	0	0
6	842309	.	T	A	9	3	12	0	0	12	0	0
6	842343	.	C	T	3	7	10	0	0	10	0	0
6	842369	.	A	G	4	1	5	0	1	6	0	0
6	842391	.	T	C	3	3	6	0	0	6	0	0
6	842461	.	C	T	4	4	8	0	0	8	0	0
6	842739	.	C	T	0	9	9	0	7	16	0	0
6	842791	.	C	A	11	8	19	0	2	21	0	0
6	842816	.	A	C	10	11	21	0	1	22	0	0
6	843745	.	C	A	7	8	15	0	0	15	0	0
6	843836	.	G	A	4	3	7	1	1	9	0	0
6	844146	.	G	T	3	8	11	0	0	11	0	0
6	844164	.	C	T	6	5	11	0	2	13	0	0
6	844209	.	G	A	4	6	10	0	1	11	0	0
6	844282	.	T	C	4	4	8	0	0	8	0	0
6	844337	.	A	G	3	5	8	0	2	10	0	0
6	844388	.	A	G	15	5	20	0	1	21	0	0
6	858026	.	C	T	0	8	8	0	10	18	0	0
6	858128	.	C	T	0	9	9	0	12	21	0	0
6	858713	.	A	G	15	10	25	0	1	26	0	0
6	859364	.	C	T	8	5	13	0	0	13	0	0
6	859907	.	A	G	2	2	4	0	0	4	0	0
6	859910	.	C	T	2	2	4	0	0	4	0	0
6	866742	.	G	T	1	2	3	0	0	3	0	0
6	869374	.	T	C	1	1	2	0	0	2	0	0
6	1421205	.	T	C	2	0	2	0	4	6	0	0
6	1431028	.	G	A	0	1	1	0	0	1	0	0
6	1431901	.	T	G	1	3	4	0	0	4	0	0
6	1431940	.	T	C	1	4	5	0	0	5	0	0
6	1431988	.	A	C	1	4	5	0	0	5	0	0
6	1511685	.	A	G	5	8	13	0	0	13	0	0
6	1535603	.	G	T	5	5	10	0	0	10	0	0
6	1538150	.	G	A	1	0	1	0	0	1	0	0
6	1539074	.	G	A	1	0	1	0	0	1	0	0
6	1541393	.	A	G	2	3	5	0	0	5	0	0
6	1544724	.	G	A	1	0	1	0	0	1	0	0
6	1549727	.	G	A	3	0	3	0	0	3	0	0
6	1554922	.	A	T	1	4	5	0	0	5	0	0
6	1557177	.	G	C	2	5	7	0	0	7	0	0
6	1561807	.	C	G	0	2	2	0	1	3	0	0
6	1562026	.	A	C	3	3	6	0	0	6	0	0
6	1797352	.	A	C	2	8	10	0	0	10	0	0
6	1797560	.	A	T	1	4	5	0	0	5	0	0
6	1797567	.	G	T	1	4	5	0	0	5	0	0
6	1799112	.	A	T	1	3	4	0	1	5	0	0
6	1838527	.	C	T	4	10	14	0	1	15	0	0
6	1843300	.	G	C	5	0	5	0	3	8	0	0
6	1843315	.	C	T	0	2	2	0	5	7	0	0
6	1843423	.	C	G	0	6	6	0	5	11	0	0
6	1843468	.	G	A	3	4	7	0	0	7	0	0
6	1872047	.	G	A	1	3	4	0	0	4	0	0
6	1874191	.	A	G	4	5	9	0	0	9	0	0
6	1874251	.	A	C	2	0	2	0	7	9	0	0
6	1874305	.	A	G	6	6	12	0	0	12	0	0
6	1874539	.	T	C	6	4	10	0	0	10	0	0
6	1874554	.	C	T	0	4	4	0	4	8	0	0
6	1874606	.	T	G	8	9	17	0	0	17	0	0
6	1874656	.	C	A	2	2	4	0	0	4	0	0
6	2068764	.	A	G	0	2	2	0	0	2	0	0
6	2068774	.	G	A	0	1	1	0	1	2	0	0
6	2089145	.	C	T	3	3	6	0	0	6	0	0
6	2089197	.	A	C	3	5	8	0	0	8	0	0
6	2089239	.	A	G	4	0	4	0	4	8	0	0
6	2120821	.	A	C	1	4	5	0	0	5	0	0
6	2121446	.	C	T	1	2	3	0	0	3	0	0
6	2126043	.	G	A	5	2	7	0	0	7	0	0
6	2126486	.	T	A	3	8	11	0	0	11	0	0
6	2126512	.	C	T	9	3	12	0	0	12	0	0
6	2165703	.	T	G	4	3	7	0	0	7	0	0
6	2165735	.	A	T	2	2	4	0	0	4	0	0
6	2165955	.	A	G	1	2	3	0	0	3	0	0
6	2165982	.	A	T	3	2	5	0	0	5	0	0
6	2166074	.	G	A	2	5	7	0	0	7	0	0
6	2166085	.	T	G	2	6	8	0	0	8	0	0
6	2166157	.	G	A	4	7	11	0	0	11	0	0
6	2166240	.	T	C	4	0	4	0	6	10	0	0
6	2166287	.	A	T	3	2	5	0	0	5	0	0
6	2166531	.	A	T	2	4	6	0	0	6	0	0
6	2166703	.	C	A	2	2	4	0	1	5	0	0
6	2170215	.	A	C	0	2	2	0	0	2	0	0
6	2190325	.	T	A	4	0	4	0	0	4	0	0
6	2190337	.	C	T	2	5	7	0	0	7	0	0
6	2190857	.	C	T	2	2	4	0	0	4	0	0
6	2194178	.	A	G	0	4	4	0	0	4	0	0
6	2198105	.	G	C	8	6	14	0	0	14	0	0
6	2206682	.	C	T	1	4	5	0	0	5	0	0
6	2206884	.	G	A	7	6	13	0	0	13	0	0
6	2208261	.	A	T	1	4	5	0	0	5	0	0
6	2208479	.	T	G	5	7	12	0	0	12	0	0
6	2208522	.	T	C	5	6	11	0	0	11	0	0
6	2208562	.	C	T	7	5	12	0	1	13	0	0
6	2208609	.	C	T	2	5	7	0	0	7	0	0
6	2208655	.	A	G	2	5	7	0	1	8	0	0
6	2210120	.	A	G	3	2	5	0	0	5	0	0
6	2215208	.	T	A	6	4	10	0	0	10	0	0
6	2217689	.	C	T	0	1	1	0	1	2	0	0
6	2271637	.	A	C	8	6	14	0	0	14	0	0
6	2372043	.	A	T	3	3	6	0	0	6	0	0
6	2384828	.	C	T	5	3	8	0	0	8	0	0
6	2391475	.	G	A	0	1	1	0	1	2	0	0
6	2453730	.	T	C	0	4	4	0	0	4	0	0
6	2453751	.	A	C	4	8	12	0	0	12	0	0
6	2505585	.	C	G	1	3	4	0	0	4	0	0
6	2520157	.	C	T	2	1	3	0	0	3	0	0
6	2558381	.	T	A	1	3	4	0	0	4	0	0
6	2560494	.	G	A	0	2	2	0	0	2	0	0
6	2586037	.	A	G	1	0	1	0	2	3	0	0
6	2620078	.	C	G	3	7	10	0	0	10	0	0
6	2621719	.	T	A	0	2	2	0	0	2	0	0
6	2623378	.	G	C	1	1	2	0	0	2	0	0
6	2624527	.	G	C	1	3	4	0	0	4	0	0
6	3005115	.	C	A	7	4	11	0	0	11	0	0
6	3005179	.	G	T	1	2	3	0	0	3	0	0
6	3040443	.	C	T	1	0	1	0	0	1	0	0
6	3040572	.	G	A	1	0	1	0	0	1	0	0
6	3142968	.	T	C	2	4	6	0	0	6	0	0
6	3143019	.	C	T	3	7	10	0	0	10	0	0
6	3143292	.	T	A	8	7	15	0	0	15	0	0
6	3145256	.	C	A	1	1	2	0	0	2	0	0
6	3197028	.	C	T	9	10	19	0	2	21	0	0
6	3205538	.	T	C	4	7	11	0	0	11	0	0
6	3223245	.	C	T	3	4	7	0	0	7	0	0
6	3223341	.	C	G	1	0	1	0	0	1	0	0
6	3268327	.	T	C	3	4	7	0	1	8	0	0
6	3270011	.	G	A	1	7	8	0	1	9	0	0
6	3273341	.	T	A	9	10	19	0	2	21	0	0
6	3273379	.	A	G	9	8	17	0	3	20	0	0
6	3273826	.	A	T	13	16	29	0	0	29	0	0
6	3273965	.	C	T	18	9	27	0	0	27	0	0
6	3273986	.	T	C	15	13	28	0	0	28	0	0
6	3274114	.	G	C	1	20	21	0	14	35	0	0
6	3274289	.	C	T	9	12	21	0	1	22	0	0
6	3280986	.	A	T	1	2	3	0	0	3	0	0
6	3282817	.	G	A	0	1	1	0	1	2	0	0
6	3284988	.	A	C	2	1	3	0	0	3	0	0
6	3289514	.	C	T	1	1	2	0	0	2	0	0
6	3289735	.	C	T	1	4	5	0	0	5	0	0
6	3293428	.	T	A	1	4	5	0	1	6	0	0
6	3293441	.	C	G	2	2	4	0	0	4	0	0
6	3295998	.	C	A	6	4	10	0	0	10	0	0
6	3302599	.	C	T	1	2	3	0	0	3	0	0
6	3302734	.	T	C	0	1	1	0	0	1	0	0
6	3309358	.	C	T	3	2	5	0	0	5	0	0
6	3312750	.	A	T	1	0	1	0	0	1	0	0
6	3318673	.	T	C	1	3	4	0	0	4	0	0
6	3319047	.	A	G	1	2	3	0	0	3	0	0
6	3334437	.	G	A	3	5	8	0	0	8	0	0
6	3395649	.	C	T	2	2	4	0	0	4	0	0
6	3404956	.	G	A	0	7	7	0	1	8	0	0
6	3405060	.	G	A	0	4	4	0	3	7	0	0
6	3405143	.	T	C	11	6	17	0	0	17	0	0
6	3405244	.	A	G	4	6	10	0	0	10	0	0
6	3405245	.	C	A	4	6	10	0	0	10	0	0
6	3499159	.	T	A	0	2	2	0	1	3	0	0
6	3502595	.	C	T	1	2	3	0	0	3	0	0
6	3506783	.	T	C	2	3	5	0	0	5	0	0
6	3509041	.	T	G	1	3	4	0	0	4	0	0
6	3514481	.	A	C	25	23	48	0	1	50	1	0
6	3564143	.	C	T	1	2	3	0	0	3	0	0
6	3698558	.	C	T	0	2	2	0	0	2	0	0
6	3707095	.	A	G	6	6	12	0	0	12	0	0
6	3707116	.	G	A	7	7	14	0	2	16	0	0
6	3707371	.	G	A	0	8	8	0	9	17	0	0
6	3707372	.	A	G	7	9	16	0	1	17	0	0
6	3707407	.	T	C	7	11	18	0	0	18	0	0
6	3708061	.	A	G	5	10	15	0	1	16	0	0
6	3708149	.	T	C	9	7	16	0	1	17	0	0
6	3711200	.	T	A	5	12	17	0	0	17	0	0
6	3711221	.	A	G	7	11	18	0	0	18	0	0
6	3711282	.	T	G	12	0	12	0	13	25	0	0
6	3711338	.	A	G	9	11	20	0	0	20	0	0
6	3711386	.	T	C	5	9	14	0	1	15	0	0
6	3711419	.	A	G	2	6	8	0	0	8	0	0
6	3711448	.	C	A	3	2	5	0	0	5	0	0
6	3711616	.	G	A	3	4	7	0	0	7	0	0
6	3711665	.	A	T	5	2	7	0	1	8	0	0
6	3711971	.	G	A	8	3	11	0	0	11	0	0
6	3712045	.	T	A	3	2	5	0	1	6	0	0
6	3712069	.	A	T	5	4	9	0	0	9	0	0
6	3712136	.	G	A	1	8	9	0	2	11	0	0
6	3712198	.	G	T	5	7	12	0	0	12	0	0
6	3712199	.	A	C	5	7	12	0	0	12	0	0
6	3712238	.	A	T	6	5	11	0	0	11	0	0
6	3712264	.	A	C	5	5	10	0	0	10	0	0
6	3712335	.	T	G	10	0	10	0	4	14	0	0
6	3712389	.	C	T	4	4	8	0	0	8	0	0
6	3712713	.	C	G	7	7	14	0	1	15	0	0
6	3717110	.	A	T	1	1	2	0	1	3	0	0
6	3717843	.	C	T	1	0	1	0	0	1	0	0
6	3724870	.	A	C	12	6	18	0	2	20	0	0
6	3725767	.	C	A	9	13	22	0	1	23	0	0
6	3727891	.	C	T	11	9	20	0	1	21	0	0
6	3728295	.	A	T	5	8	13	0	1	14	0	0
6	3728559	.	G	C	7	5	12	0	0	12	0	0
6	3812378	.	C	T	1	5	6	0	0	6	0	0
6	3827894	.	C	A	16	19	35	0	1	36	0	0
6	3834630	.	G	C	24	26	50	0	2	52	0	0
6	3853120	.	T	G	18	0	18	0	12	30	0	0
6	3853165	.	T	C	19	13	32	0	3	35	0	0
6	3862018	.	A	G	12	14	26	0	0	26	0	0
6	3867542	.	A	T	4	1	5	0	0	5	0	0
6	3869454	.	G	A	0	6	6	0	7	13	0	0
6	3869891	.	C	T	12	9	21	0	1	22	0	0
6	3871982	.	T	A	4	6	10	0	1	11	0	0
6	3874504	.	G	A	1	15	16	0	29	45	0	0
6	3874533	.	C	T	25	21	46	0	0	46	0	0
6	3874686	.	A	G	9	12	21	0	2	23	0	0
6	3878513	.	T	A	4	2	6	0	0	6	0	0
6	3878593	.	A	G	7	6	13	0	0	13	0	0
6	3878831	.	G	C	4	3	7	0	1	8	0	0
6	3878983	.	A	T	6	8	14	0	2	16	0	0
6	3879158	.	A	G	7	8	15	0	0	15	0	0
6	3879247	.	C	A	0	7	7	0	10	17	0	0
6	3879314	.	C	G	1	9	10	0	9	19	0	0
6	3879335	.	C	T	6	9	15	0	1	16	0	0
6	3879367	.	G	A	1	4	5	0	0	5	0	0
6	3881078	.	G	A	0	2	2	0	0	2	0	0
6	3885451	.	C	T	10	12	22	0	1	23	0	0
6	3895442	.	A	T	2	2	4	0	0	4	0	0
6	3895460	.	C	T	0	7	7	0	3	10	0	0
6	3901120	.	C	T	0	0	0	0	3	3	0	0
6	3907796	.	A	T	6	6	12	0	0	12	0	0
6	3944518	.	G	T	1	1	2	0	0	2	0	0
6	3945773	.	C	A	2	2	4	0	0	4	0	0
6	3945792	.	C	A	2	2	4	0	0	4	0	0
6	3950267	.	C	T	1	1	2	0	0	2	0	0
6	3950270	.	C	T	1	1	2	0	0	2	0	0
6	3950309	.	C	T	2	3	5	0	0	5	0	0
6	3953280	.	T	C	2	3	5	0	0	5	0	0
6	3953302	.	A	C	3	3	6	0	0	6	0	0
6	3961387	.	G	A	5	3	8	0	0	8	0	0
6	3962132	.	G	A	19	14	33	0	2	35	0	0
6	3962192	.	A	T	8	8	16	0	1	17	0	0
6	3964619	.	G	A	0	1	1	0	0	1	0	0
6	3965389	.	G	T	4	2	6	0	0	6	0	0
6	3965461	.	A	G	12	10	22	0	1	23	0	0
6	3973572	.	G	A	1	1	2	0	0	2	0	0
6	3973638	.	T	G	1	2	3	0	0	3	0	0
6	3974047	.	G	A	9	5	14	0	0	14	0	0
6	3985083	.	G	A	7	9	16	0	2	18	0	0
6	3985137	.	G	A	7	13	20	0	0	20	0	0
6	3987131	.	A	G	2	5	7	0	0	7	0	0
6	3987145	.	T	C	4	0	4	0	0	4	0	0
6	3989704	.	C	A	0	3	3	0	0	3	0	0
6	4003864	.	A	G	3	3	6	0	0	6	0	0
6	4144415	.	C	T	2	6	8	0	0	8	0	0
6	4144448	.	C	T	1	2	3	0	0	3	0	0
6	4185678	.	G	A	15	22	37	0	3	40	0	0
6	4191449	.	C	T	2	8	10	0	0	10	0	0
6	4191554	.	A	T	5	7	12	0	1	13	0	0
6	4192025	.	G	A	8	3	11	0	0	11	0	0
6	4192031	.	A	G	3	6	9	0	0	9	0	0
6	4192171	.	G	A	2	0	2	0	0	2	0	0
6	4204072	.	G	T	4	2	6	0	1	7	0	0
6	4204117	.	G	T	5	1	6	0	0	6	0	0
6	4219856	.	G	A	2	14	16	0	0	16	0	0
6	4229789	.	T	C	6	4	10	0	1	11	0	0
6	4229790	.	T	C	6	4	10	0	1	11	0	0
6	4229830	.	C	T	6	3	9	0	0	9	0	0
6	4241945	.	C	T	3	2	5	0	0	5	0	0
6	4241954	.	A	G	3	2	5	0	0	5	0	0
6	4246466	.	T	C	5	2	7	0	1	8	0	0
6	4246496	.	G	A	1	8	9	0	8	17	0	0
6	4246638	.	A	C	0	4	4	0	0	4	0	0
6	4247928	.	C	T	3	7	10	0	0	10	0	0
6	4247942	.	T	C	5	3	8	0	0	8	0	0
6	4248195	.	G	C	2	4	6	0	0	6	0	0
6	4248231	.	A	G	4	0	4	0	4	8	0	0
6	4248307	.	G	A	0	2	2	0	2	4	0	0
6	4248399	.	A	T	2	1	3	0	0	3	0	0
6	4248412	.	T	A	2	2	4	0	0	4	0	0
6	4249420	.	C	T	0	3	3	0	0	3	0	0
6	4249437	.	A	G	2	3	5	0	0	5	0	0
6	4249684	.	A	G	1	4	5	0	0	5	0	0
6	4305224	.	A	G	1	2	3	0	0	3	0	0
6	4305234	.	C	T	1	2	3	0	0	3	0	0
6	4314415	.	A	T	1	2	3	0	0	3	0	0
6	4314446	.	C	T	0	1	1	0	0	1	0	0
6	4319805	.	C	A	0	1	1	0	0	1	0	0
6	4322404	.	G	A	0	1	1	0	2	3	0	0
6	4329801	.	C	T	2	1	3	0	0	3	0	0
6	4332730	.	G	A	0	3	3	0	1	4	0	0
6	4341944	.	G	A	2	0	2	0	0	2	0	0
6	4347541	.	T	C	2	1	3	0	0	3	0	0
6	4352140	.	G	T	1	1	2	0	0	2	0	0
6	4359773	.	G	A	2	2	4	0	0	4	0	0
6	4359857	.	C	G	1	1	2	0	0	2	0	0
6	4360110	.	C	T	3	3	6	0	0	6	0	0
6	4365163	.	C	T	4	8	12	0	0	12	0	0
6	4365295	.	G	C	9	7	16	0	1	17	0	0
6	4376831	.	T	C	6	3	9	0	1	10	0	0
6	4376849	.	G	A	0	6	6	0	2	8	0	0
6	4376894	.	G	A	1	1	2	0	0	2	0	0
6	4379760	.	G	A	0	2	2	0	2	4	0	0
6	4392639	.	C	T	8	9	17	0	0	17	0	0
6	4397173	.	G	A	7	9	16	0	0	16	0	0
6	4397181	.	C	A	9	10	19	0	0	19	0	0
6	4397262	.	C	T	3	1	4	0	0	4	0	0
6	4398906	.	C	T	4	3	7	0	0	7	0	0
6	4398939	.	A	C	1	1	2	0	0	2	0	0
6	4400803	.	T	A	3	4	7	0	0	7	0	0
6	4400999	.	C	T	2	2	4	0	0	4	0	0
6	4401087	.	T	A	3	6	9	0	0	9	0	0
6	4401088	.	A	T	4	5	9	0	0	9	0	0
6	4416859	.	G	A	4	3	7	0	0	7	0	0
6	4417007	.	G	A	2	3	5	0	0	5	0	0
6	4531158	.	T	C	1	1	2	0	0	2	0	0
6	4540110	.	A	G	0	0	0	0	4	4	0	0
6	4540115	.	C	A	1	5	6	0	0	6	0	0
6	4540422	.	A	G	2	1	3	0	0	3	0	0
6	4541178	.	T	C	7	7	14	0	0	14	0	0
6	4542260	.	G	A	0	3	3	0	1	4	0	0
6	4542492	.	A	G	3	0	3	0	8	11	0	0
6	4542573	.	A	C	3	6	9	0	0	9	0	0
6	4873119	.	G	A	4	3	7	0	0	7	0	0
6	4874434	.	T	C	6	4	10	0	0	10	0	0
6	4874563	.	C	T	3	3	6	0	0	6	0	0
6	4874821	.	G	C	5	3	8	0	0	8	0	0
6	4875031	.	G	A	0	6	6	0	3	9	0	0
6	4875292	.	C	T	6	3	9	0	0	9	0	0
6	4876522	.	G	C	0	10	10	0	5	15	0	0
6	4876738	.	G	A	12	11	23	0	2	25	0	0
6	4876946	.	C	A	5	7	12	0	0	12	0	0
6	4877023	.	C	T	5	3	8	0	0	8	0	0
6	6231040	.	A	T	0	2	2	0	0	2	0	0
6	6231186	.	C	A	3	1	4	0	0	4	0	0
6	6231244	.	T	C	4	4	8	0	0	8	0	0
6	6231321	.	C	A	3	4	7	0	0	7	0	0
6	6231337	.	A	C	3	4	7	0	0	7	0	0
6	6232301	.	A	C	26	19	45	0	2	47	0	0
6	6232315	.	T	C	25	1	26	0	20	46	0	0
6	6258045	.	G	C	9	0	9	0	8	17	0	0
6	6258130	.	C	T	10	9	19	0	1	20	0	0
6	6258239	.	C	T	0	4	4	0	8	12	0	0
6	6258240	.	A	G	4	8	12	0	0	12	0	0
6	6270882	.	G	C	0	1	1	0	0	1	0	0
6	6271855	.	T	C	1	2	3	0	0	3	0	0
6	6273345	.	C	T	35	39	74	0	1	75	0	0
6	6273396	.	C	T	29	34	63	0	2	65	0	0
6	6275667	.	C	T	2	6	8	0	1	9	0	0
6	6275668	.	A	G	2	6	8	0	1	9	0	0
6	6284114	.	A	G	2	2	4	0	0	4	0	0
6	6308361	.	A	T	0	4	4	0	0	4	0	0
6	6317092	.	T	G	3	2	5	0	0	5	0	0
6	6317189	.	C	T	0	4	4	0	0	4	0	0
6	6317246	.	G	A	0	2	2	0	0	2	0	0
6	6317488	.	G	A	1	2	3	0	0	3	0	0
6	6317501	.	C	A	1	2	3	0	0	3	0	0
6	6318553	.	A	G	1	4	5	0	0	5	0	0
6	6330877	.	C	T	1	2	3	0	0	3	0	0
6	6395035	.	T	G	2	5	7	0	0	7	0	0
6	6395096	.	C	T	0	6	6	0	5	11	0	0
6	6395099	.	C	T	6	5	11	0	0	11	0	0
6	6395211	.	T	A	3	7	10	0	0	10	0	0
6	6395222	.	T	A	3	8	11	0	0	11	0	0
6	6395367	.	C	T	0	7	7	0	2	9	0	0
6	6395405	.	C	T	1	5	6	0	0	6	0	0
6	6423827	.	C	T	0	4	4	0	4	8	0	0
6	6459235	.	T	C	4	9	13	0	0	13	0	0
6	6459315	.	G	A	3	3	6	0	0	6	0	0
6	6466502	.	C	T	0	1	1	0	0	1	0	0
6	6467931	.	C	T	0	2	2	0	3	5	0	0
6	6471174	.	C	G	1	2	3	0	0	3	0	0
6	6471391	.	G	A	2	2	4	0	0	4	0	0
6	6471486	.	G	A	2	3	5	0	0	5	0	0
6	6471726	.	T	C	3	2	5	0	0	5	0	0
6	6471843	.	T	G	8	3	11	0	1	12	0	0
6	6471875	.	C	G	7	4	11	0	0	11	0	0
6	6475515	.	C	T	0	4	4	0	2	6	0	0
6	6475576	.	G	T	1	5	6	0	1	7	0	0
6	6477785	.	G	A	4	4	8	0	0	8	0	0
6	6480583	.	A	G	0	1	1	0	0	1	0	0
6	6491152	.	T	C	1	4	5	0	0	5	0	0
6	6498842	.	C	T	4	2	6	0	0	6	0	0
6	6539842	.	T	G	2	0	2	0	2	4	0	0
6	6539848	.	T	A	1	2	3	0	0	3	0	0
6	6541039	.	C	T	4	3	7	0	0	7	0	0
6	6541360	.	T	C	1	3	4	0	0	4	0	0
6	6541369	.	A	G	2	0	2	0	4	6	0	0
6	6665965	.	G	A	6	3	9	0	0	9	0	0
6	6666079	.	C	T	2	3	5	0	0	5	0	0
6	6666194	.	A	G	1	2	3	0	0	3	0	0
6	6669743	.	G	A	2	2	4	0	0	4	0	0
6	6671545	.	G	C	6	4	10	0	1	11	0	0
6	6671607	.	C	G	3	6	9	0	0	9	0	0
6	6671769	.	T	A	4	3	7	0	1	8	0	0
6	6673527	.	C	A	4	4	8	0	0	8	0	0
6	6737391	.	C	T	12	8	20	0	0	20	0	0
6	6737401	.	G	T	11	6	17	0	0	17	0	0
6	6737982	.	T	A	17	18	35	0	0	35	0	0
6	6737998	.	C	T	0	17	17	0	18	35	0	0
6	6769345	.	T	A	6	8	14	0	1	15	0	0
6	6769716	.	C	T	6	10	16	0	1	17	0	0
6	6769719	.	T	C	6	11	17	0	1	18	0	0
6	6769782	.	A	G	5	2	7	0	0	7	0	0
6	6775689	.	G	T	9	6	15	0	4	19	0	0
6	6784095	.	G	A	2	3	5	0	0	5	0	0
6	6784239	.	G	C	6	3	9	0	1	10	0	0
6	6785788	.	G	A	1	2	3	0	0	3	0	0
6	6788714	.	A	G	2	0	2	0	1	3	0	0
6	6793164	.	C	T	11	7	18	0	0	18	0	0
6	6793224	.	G	A	0	4	4	0	3	7	0	0
6	6795664	.	T	C	7	5	12	0	0	12	0	0
6	6797583	.	A	G	5	8	13	0	1	14	0	0
6	6797598	.	T	C	12	7	19	0	0	19	0	0
6	6797694	.	T	A	8	8	16	0	0	16	0	0
6	6800031	.	G	T	5	5	10	0	0	10	0	0
6	6800091	.	A	G	4	4	8	0	0	8	0	0
6	6800107	.	T	A	3	2	5	0	1	6	0	0
6	6803726	.	T	A	6	4	10	0	0	10	0	0
6	6805275	.	G	A	4	6	10	0	0	10	0	0
6	6805572	.	G	T	17	11	28	0	3	31	0	0
6	6808431	.	C	G	4	2	6	0	0	6	0	0
6	6900767	.	T	C	2	3	5	0	1	6	0	0
6	6905848	.	G	A	0	2	2	0	1	3	0	0
6	6908699	.	A	G	1	4	5	0	0	5	0	0
6	6908955	.	A	G	1	1	2	0	0	2	0	0
6	6909792	.	G	A	3	3	6	0	0	6	0	0
6	6919866	.	G	T	0	8	8	0	9	17	0	0
6	6920673	.	A	T	2	5	7	1	2	10	0	0
6	6920753	.	A	T	0	3	3	1	0	4	0	0
6	6921577	.	C	T	3	6	9	0	1	10	0	0
6	6921581	.	T	C	2	6	8	0	0	8	0	0
6	6921802	.	G	A	18	19	37	1	0	38	0	0
6	6921889	.	T	A	14	9	23	0	0	23	0	0
6	6922072	.	G	T	10	9	19	0	1	20	0	0
6	6922187	.	T	C	5	11	16	0	0	16	0	0
6	6973009	.	A	T	8	8	16	0	1	17	0	0
6	6973383	.	G	T	3	7	10	0	3	13	0	0
6	6990063	.	G	A	0	7	7	5	0	12	0	0
6	7089952	.	C	G	3	3	6	0	0	6	0	0
6	7105400	.	C	T	2	2	4	0	0	4	0	0
6	7107034	.	A	G	4	1	5	0	0	5	0	0
6	7110148	.	C	T	10	13	23	0	1	24	0	0
6	7110434	.	C	T	9	18	27	0	0	27	0	0
6	7110435	.	T	G	9	17	26	0	1	27	0	0
6	7110551	.	C	T	17	15	32	0	1	33	0	0
6	7113001	.	T	G	2	6	8	0	2	10	0	0
6	7114482	.	C	T	5	6	11	0	0	11	0	0
6	7115967	.	T	C	2	2	4	0	0	4	0	0
6	7133402	.	C	T	3	2	5	0	0	5	0	0
6	7157570	.	G	A	3	4	7	0	0	7	0	0
6	7157615	.	C	T	4	5	9	0	0	9	0	0
6	7251362	.	A	T	2	2	4	0	0	4	0	0
6	7251426	.	A	G	5	4	9	0	1	10	0	0
6	7251564	.	G	A	2	2	4	0	1	5	0	0
6	7251627	.	A	G	2	9	11	0	0	11	0	0
6	7251694	.	G	A	1	2	3	0	0	3	0	0
6	7265179	.	G	A	0	1	1	0	0	1	0	0
6	7270355	.	T	C	6	4	10	0	0	10	0	0
6	7276139	.	T	C	4	2	6	0	1	7	0	0
6	7276178	.	T	A	6	4	10	0	0	10	0	0
6	7276212	.	C	T	6	5	11	0	0	11	0	0
6	7276263	.	G	A	0	9	9	0	4	13	0	0
6	7414459	.	G	A	1	3	4	0	0	4	0	0
6	7425208	.	T	C	1	5	6	0	0	6	0	0
6	7435565	.	C	T	2	2	4	0	2	6	0	0
6	7438474	.	C	T	4	4	8	0	0	8	0	0
6	7444930	.	T	C	8	12	20	0	0	20	0	0
6	7451563	.	T	G	11	11	22	0	0	22	0	0
6	7452519	.	T	C	13	13	26	0	1	27	0	0
6	7453379	.	T	G	14	1	15	0	16	31	0	0
6	7453567	.	G	T	8	4	12	1	1	14	0	0
6	7453649	.	C	G	9	9	18	0	0	18	0	0
6	7453660	.	C	T	6	9	15	0	1	16	0	0
6	7529559	.	A	G	2	0	2	0	2	4	0	0
6	7530295	.	T	C	2	2	4	0	0	4	0	0
6	7530494	.	T	A	2	3	5	0	0	5	0	0
6	7530577	.	A	G	2	4	6	0	0	6	0	0
6	7531396	.	T	C	1	3	4	0	0	4	0	0
6	7542491	.	G	T	0	3	3	0	5	8	0	0
6	7545794	.	C	T	13	8	21	0	0	21	0	0
6	7545824	.	T	C	15	9	24	0	0	24	0	0
6	7547451	.	C	T	2	5	7	0	0	7	0	0
6	7549967	.	G	A	6	5	11	0	0	11	0	0
6	7550210	.	A	C	11	5	16	0	0	16	0	0
6	7550405	.	C	T	8	13	21	0	1	22	0	0
6	7551087	.	C	A	4	3	7	0	1	8	0	0
6	7555618	.	C	T	2	1	3	0	0	3	0	0
6	7555634	.	G	T	4	3	7	0	0	7	0	0
6	7555871	.	G	A	5	5	10	0	0	10	0	0
6	7591018	.	G	A	2	4	6	0	0	6	0	0
6	7624322	.	C	T	3	3	6	0	0	6	0	0
6	7626457	.	C	T	2	2	4	0	0	4	0	0
6	7633452	.	G	C	0	7	7	0	5	12	0	0
6	7636811	.	A	T	4	7	11	0	1	12	0	0
6	7637195	.	C	T	4	6	10	0	0	10	0	0
6	7638717	.	G	A	6	8	14	0	0	14	0	0
6	7645319	.	T	C	2	1	3	0	0	3	0	0
6	7646039	.	A	G	1	4	5	0	1	6	0	0
6	7646102	.	G	A	12	17	29	0	0	29	0	0
6	7646111	.	G	C	14	14	28	0	0	28	0	0
6	7648224	.	A	G	7	0	7	0	4	11	0	0
6	7652458	.	C	T	12	15	27	0	1	28	0	0
6	7652470	.	A	C	10	14	24	0	0	24	0	0
6	7652896	.	G	A	0	21	21	0	18	39	0	0
6	7652959	.	C	T	9	16	25	0	1	26	0	0
6	7652989	.	C	T	3	4	7	0	0	7	0	0
6	7656920	.	A	G	13	0	13	0	13	26	0	0
6	7656932	.	A	G	17	19	36	0	1	37	0	0
6	7657077	.	A	C	28	8	36	0	0	36	0	0
6	7657177	.	C	T	12	15	27	0	1	28	0	0
6	7657793	.	A	C	19	14	33	0	0	33	0	0
6	7657886	.	T	A	16	11	27	0	0	27	0	0
6	7657887	.	G	T	16	11	27	0	0	27	0	0
6	7657972	.	T	G	12	4	16	0	4	20	0	0
6	7658076	.	G	A	9	13	22	0	0	22	0	0
6	7659915	.	G	A	2	8	10	0	0	10	0	0
6	7660119	.	A	G	9	9	18	0	0	18	0	0
6	7660369	.	T	C	1	2	3	0	0	3	0	0
6	7660458	.	A	C	1	1	2	0	3	5	0	0
6	7660594	.	C	T	6	3	9	0	0	9	0	0
6	7660659	.	C	A	0	2	2	0	3	5	0	0
6	7660707	.	C	T	0	4	4	0	1	5	0	0
6	7679455	.	G	A	2	2	4	0	0	4	0	0
6	7688655	.	T	C	0	0	0	0	2	2	0	0
6	7697573	.	G	A	2	2	4	0	0	4	0	0
6	7699948	.	C	T	1	0	1	0	0	1	0	0
6	7702770	.	G	T	2	3	5	0	0	5	0	0
6	7705984	.	G	A	2	3	5	0	0	5	0	0
6	7711629	.	G	A	1	2	3	0	0	3	0	0
6	7713350	.	A	T	5	6	11	1	0	12	0	0
6	7713433	.	G	A	10	28	38	0	6	44	0	0
6	7721530	.	T	A	3	6	9	0	0	9	0	0
6	7721860	.	G	A	4	5	9	0	0	9	0	0
6	7721906	.	G	A	10	13	23	0	0	23	0	0
6	7721958	.	C	A	12	14	26	1	0	27	0	0
6	7722143	.	G	T	12	5	17	0	0	17	0	0
6	7722159	.	A	T	10	6	16	0	3	19	0	0
6	7722195	.	G	T	7	4	11	0	0	11	0	0
6	7722205	.	G	A	8	8	16	0	1	17	0	0
6	7722333	.	G	A	6	7	13	0	1	14	0	0
6	7722387	.	T	C	9	4	13	0	0	14	1	0
6	7722402	.	T	C	5	10	15	0	0	15	0	0
6	7722467	.	T	A	2	4	6	1	0	7	0	0
6	7722577	.	C	T	0	10	10	0	13	23	0	0
6	7722921	.	A	T	1	2	3	0	0	3	0	0
6	7723008	.	G	T	7	4	11	0	0	11	0	0
6	7723155	.	A	C	5	9	14	0	1	15	0	0
6	7723232	.	A	T	4	4	8	0	1	9	0	0
6	7723850	.	C	T	0	3	3	0	7	10	0	0
6	7723961	.	G	A	4	12	16	0	0	16	0	0
6	7726824	.	G	A	8	9	17	0	0	17	0	0
6	7734250	.	A	C	0	2	2	0	0	2	0	0
6	7734271	.	C	A	0	1	1	0	0	1	0	0
6	7795698	.	C	T	19	10	29	0	3	32	0	0
6	7842013	.	C	T	1	10	11	0	5	16	0	0
6	7842034	.	C	A	7	10	17	0	1	18	0	0
6	8176101	.	A	G	4	7	11	0	0	11	0	0
6	8176575	.	C	T	11	5	16	0	0	16	0	0
6	8177030	.	T	C	7	8	15	0	0	15	0	0
6	8177399	.	T	C	8	11	19	0	1	20	0	0
6	8177600	.	T	C	12	6	18	0	0	18	0	0
6	8177678	.	C	T	10	7	17	0	1	18	0	0
6	8178002	.	T	C	7	11	18	0	1	19	0	0
6	8178053	.	G	A	1	7	8	0	9	17	0	0
6	8178113	.	T	C	8	8	16	0	1	17	0	0
6	8178351	.	G	A	8	6	14	0	1	15	0	0
6	8179022	.	G	T	0	10	10	0	16	26	0	0
6	8179205	.	A	T	12	9	21	0	0	21	0	0
6	8179373	.	G	A	10	12	22	0	1	24	1	0
6	8179683	.	A	T	1	3	4	0	0	4	0	0
6	8211075	.	C	T	4	5	9	0	0	9	0	0
6	8211106	.	T	C	6	3	9	0	0	9	0	0
6	8214118	.	T	C	0	4	4	0	1	5	0	0
6	8224881	.	A	G	0	2	2	0	0	2	0	0
6	8241961	.	T	C	1	2	3	0	0	3	0	0
6	8265282	.	G	A	6	6	12	0	0	12	0	0
6	8267111	.	C	T	12	8	20	0	2	22	0	0
6	8267266	.	A	G	12	17	29	0	1	30	0	0
6	8267284	.	G	A	7	18	25	0	1	26	0	0
6	8267307	.	G	C	6	14	20	0	1	22	1	0
6	8267352	.	A	T	12	13	25	0	1	26	0	0
6	8267519	.	G	A	13	20	33	0	2	35	0	0
6	8267563	.	G	T	17	24	41	0	0	41	0	0
6	8267635	.	T	C	15	26	41	0	1	42	0	0
6	8267795	.	T	A	10	7	17	0	1	18	0	0
6	8267880	.	G	A	13	7	20	0	0	20	0	0
6	8268529	.	A	G	11	7	18	0	3	21	0	0
6	8273066	.	G	A	0	1	1	0	0	1	0	0
6	8283360	.	A	G	0	2	2	0	0	2	0	0
6	8283393	.	T	C	1	0	1	0	3	4	0	0
6	8291577	.	T	G	3	0	3	0	0	3	0	0
6	8315076	.	A	G	7	6	13	0	0	13	0	0
6	8315078	.	A	G	7	6	13	0	0	13	0	0
6	8318001	.	T	C	4	10	14	0	0	14	0	0
6	8318037	.	G	A	0	15	15	0	10	25	0	0
6	8328181	.	G	T	12	16	28	0	0	29	1	0
6	8365753	.	T	C	2	2	4	0	0	4	0	0
6	8366006	.	A	T	3	5	8	0	2	10	0	0
6	8366167	.	C	T	11	10	21	0	3	24	0	0
6	8370489	.	T	C	7	8	15	0	1	16	0	0
6	8374716	.	G	A	2	4	6	0	0	6	0	0
6	8375089	.	C	T	15	8	23	0	0	23	0	0
6	8380433	.	G	C	9	3	12	0	0	12	0	0
6	8391629	.	C	T	0	8	8	0	6	14	0	0
6	8392005	.	G	A	5	1	6	0	1	7	0	0
6	8455483	.	T	C	4	0	4	0	2	6	0	0
6	8460435	.	G	T	4	2	6	0	0	6	0	0
6	8460493	.	G	T	2	4	6	0	1	7	0	0
6	8500557	.	G	T	1	2	3	0	0	3	0	0
6	9130510	.	A	G	4	5	9	0	0	9	0	0
6	9130521	.	A	G	3	7	10	0	2	12	0	0
6	9130575	.	A	G	4	10	14	0	0	14	0	0
6	9859999	.	T	G	0	2	2	1	0	3	0	0
6	10000929	.	G	C	2	0	2	0	2	4	0	0
6	10000936	.	A	C	1	2	3	0	0	3	0	0
6	10008329	.	G	A	0	9	9	0	17	26	0	0
6	10008398	.	A	G	13	12	25	0	3	28	0	0
6	10008407	.	C	T	10	13	23	0	0	23	0	0
6	10009850	.	C	T	17	15	32	0	1	33	0	0
6	10009903	.	A	T	19	18	37	0	2	39	0	0
6	10015551	.	T	C	2	6	8	0	2	10	0	0
6	10015602	.	T	C	20	24	44	0	2	46	0	0
6	10015794	.	A	T	27	31	58	2	8	68	0	0
6	10015902	.	A	T	39	20	59	0	1	60	0	0
6	10015952	.	C	A	33	31	64	0	0	64	0	0
6	10015992	.	A	C	37	30	67	0	2	69	0	0
6	10015993	.	G	A	35	29	64	0	5	69	0	0
6	10016114	.	C	T	21	32	53	0	1	54	0	0
6	10016116	.	C	A	19	31	50	0	4	54	0	0
6	10016174	.	T	G	24	20	44	0	5	49	0	0
6	10016363	.	T	G	35	19	54	0	1	59	4	0
6	10020055	.	G	A	23	25	48	0	3	51	0	0
6	10026677	.	C	T	12	10	22	0	2	24	0	0
6	10026818	.	G	A	13	6	19	0	1	20	0	0
6	10029332	.	G	A	2	1	3	0	0	3	0	0
6	10032925	.	T	G	2	2	4	0	0	5	1	0
6	10032932	.	C	T	2	3	5	0	0	5	0	0
6	10033015	.	G	A	1	5	6	0	0	6	0	0
6	10045449	.	G	T	8	7	15	0	0	15	0	0
6	10047204	.	T	C	12	10	22	0	0	22	0	0
6	10047805	.	G	A	2	10	12	0	0	12	0	0
6	10047814	.	T	C	2	2	4	0	1	5	0	0
6	10050050	.	G	A	15	12	27	0	0	27	0	0
6	10056466	.	G	T	25	16	41	0	1	43	1	0
6	10085495	.	A	G	0	1	1	0	0	1	0	0
6	10087986	.	A	C	1	4	5	0	0	5	0	0
6	10087995	.	G	A	2	2	4	0	1	5	0	0
6	10248476	.	T	A	15	11	26	0	3	29	0	0
6	10248530	.	A	G	11	7	18	0	2	20	0	0
6	10248546	.	T	C	9	0	9	0	10	19	0	0
6	10248596	.	T	C	10	12	22	0	5	27	0	0
6	10248980	.	A	G	9	9	18	0	0	18	0	0
6	10249451	.	A	G	6	8	14	0	0	14	0	0
6	10251188	.	C	A	9	8	17	0	3	20	0	0
6	10257886	.	A	G	2	2	4	0	0	4	0	0
6	10264656	.	T	C	3	0	3	0	3	6	0	0
6	10283118	.	T	A	2	2	4	0	0	4	0	0
6	10283462	.	A	G	3	7	10	0	0	10	0	0
6	10291687	.	A	G	3	2	5	0	0	5	0	0
6	10305813	.	T	G	4	5	9	0	1	10	0	0
6	10305821	.	A	G	3	6	9	0	1	10	0	0
6	10305922	.	G	A	2	4	6	0	0	6	0	0
6	10354469	.	T	C	1	0	1	0	0	1	0	0
6	10512858	.	C	T	3	1	4	0	0	4	0	0
6	10512903	.	C	G	5	6	11	0	0	11	0	0
6	10513182	.	C	G	5	9	14	0	0	14	0	0
6	10522332	.	C	T	2	3	5	0	0	5	0	0
6	10540300	.	A	T	4	4	8	0	0	8	0	0
6	10547409	.	C	T	2	2	4	0	1	5	0	0
6	10547502	.	T	G	1	0	1	0	5	6	0	0
6	10547556	.	T	C	1	3	4	0	1	5	0	0
6	10564408	.	C	T	1	1	2	0	0	2	0	0
6	10564426	.	T	C	1	1	2	0	0	2	0	0
6	10567861	.	C	T	3	2	5	0	0	5	0	0
6	10570843	.	C	T	0	2	2	0	0	2	0	0
6	10576573	.	A	G	7	0	7	0	4	11	0	0
6	10701627	.	C	T	4	4	8	0	0	8	0	0
6	10701642	.	C	A	0	4	4	0	4	8	0	0
6	10701864	.	T	C	4	0	4	0	7	11	0	0
6	10702203	.	T	C	6	0	6	0	5	11	0	0
6	10702244	.	T	C	4	0	4	0	4	8	0	0
6	10702269	.	T	A	2	4	6	0	0	6	0	0
6	10713784	.	G	A	0	0	0	0	1	1	0	0
6	10713810	.	G	T	1	2	3	0	0	3	0	0
6	10721767	.	C	T	13	1	14	0	1	15	0	0
6	10721971	.	T	G	2	11	13	1	1	15	0	0
6	10722541	.	G	A	2	2	4	0	0	4	0	0
6	10724275	.	G	A	2	9	11	0	0	11	0	0
6	10724336	.	C	T	1	6	7	0	12	19	0	0
6	10724591	.	G	T	9	6	15	0	1	16	0	0
6	10724645	.	A	T	7	8	15	0	2	17	0	0
6	10724665	.	G	A	12	4	16	0	1	17	0	0
6	10724765	.	G	A	8	4	12	0	0	12	0	0
6	10725365	.	T	C	4	0	4	0	3	7	0	0
6	10725506	.	T	C	8	4	12	0	0	12	0	0
6	10727621	.	C	T	1	3	4	0	0	4	0	0
6	10736615	.	T	C	4	6	10	0	0	10	0	0
6	10736798	.	T	A	1	2	3	0	0	3	0	0
6	10737000	.	C	A	0	3	3	0	1	4	0	0
6	10741432	.	G	T	2	4	6	0	0	6	0	0
6	10741483	.	T	C	1	2	3	0	1	4	0	0
6	10741853	.	T	G	2	2	4	0	0	4	0	0
6	10741916	.	G	C	4	12	16	0	0	16	0	0
6	10742120	.	T	C	14	11	25	0	1	26	0	0
6	10742121	.	G	A	14	12	26	0	0	26	0	0
6	10742306	.	A	G	12	22	34	0	2	36	0	0
6	10742318	.	G	A	20	8	28	0	1	29	0	0
6	10742497	.	T	C	8	0	8	0	6	14	0	0
6	10758866	.	A	T	4	2	6	0	0	6	0	0
6	10758890	.	A	C	3	0	3	0	3	6	0	0
6	10759200	.	A	G	2	1	3	0	0	3	0	0
6	10763899	.	A	T	1	7	8	0	0	8	0	0
6	10763977	.	A	G	4	3	7	0	1	8	0	0
6	10764001	.	A	G	2	5	7	0	0	7	0	0
6	10776227	.	A	T	1	1	2	0	0	2	0	0
6	10780694	.	A	G	3	3	6	0	0	6	0	0
6	10782416	.	T	G	2	3	5	0	1	6	0	0
6	10788102	.	T	A	0	2	2	0	0	2	0	0
6	10788480	.	T	A	1	2	3	0	0	3	0	0
6	10788489	.	C	G	1	0	1	0	1	2	0	0
6	10831093	.	G	A	19	33	52	0	5	57	0	0
6	10833078	.	T	C	20	0	20	0	24	44	0	0
6	10834821	.	G	C	3	7	10	0	1	11	0	0
6	10835676	.	G	A	3	4	7	0	0	7	0	0
6	10835700	.	T	A	3	5	8	0	1	9	0	0
6	10835721	.	A	G	1	7	8	0	0	8	0	0
6	10835788	.	G	A	10	4	14	0	0	14	0	0
6	10838690	.	C	T	0	4	4	0	5	9	0	0
6	10838716	.	A	C	5	6	11	0	0	11	0	0
6	10838741	.	G	A	5	6	11	0	0	11	0	0
6	10838753	.	T	C	3	6	9	0	0	9	0	0
6	10839332	.	A	G	5	4	9	0	0	9	0	0
6	10839370	.	A	C	0	2	2	0	0	2	0	0
6	10839885	.	C	A	0	15	15	0	13	28	0	0
6	10846001	.	G	A	0	1	1	0	0	1	0	0
6	10859011	.	G	A	7	5	12	0	0	12	0	0
6	10877269	.	A	G	2	1	3	0	0	3	0	0
6	10879525	.	T	C	5	5	10	0	1	11	0	0
6	10879633	.	T	C	15	18	33	0	0	33	0	0
6	10879679	.	G	A	13	18	31	0	2	33	0	0
6	10879816	.	A	T	9	11	20	0	2	22	0	0
6	10879833	.	A	G	8	1	9	0	16	25	0	0
6	10910684	.	G	A	5	5	10	0	0	10	0	0
6	10910784	.	C	A	21	14	35	0	0	35	0	0
6	10911066	.	T	C	22	27	49	0	5	54	0	0
6	10911198	.	A	G	12	24	36	0	0	36	0	0
6	10912341	.	G	A	19	19	38	0	1	39	0	0
6	10982984	.	G	T	3	2	5	0	0	5	0	0
6	10983066	.	T	C	2	2	4	0	0	4	0	0
6	10983433	.	A	C	1	4	5	0	0	5	0	0
6	11071222	.	A	G	20	31	51	0	5	56	0	0
6	11101781	.	T	C	4	6	10	0	0	10	0	0
6	11101790	.	C	T	0	7	7	0	2	9	0	0
6	11101852	.	G	A	4	8	12	0	1	13	0	0
6	11106924	.	C	G	1	3	4	0	0	4	0	0
6	11107167	.	G	C	5	1	6	0	10	16	0	0
6	11107233	.	C	A	4	8	12	0	0	12	0	0
6	11107326	.	T	C	1	0	1	0	4	5	0	0
6	11122579	.	A	G	0	1	1	0	0	1	0	0
6	11122682	.	T	C	1	0	1	0	0	1	0	0
6	11129033	.	G	A	5	2	7	0	0	7	0	0
6	11129357	.	T	C	5	3	8	0	0	8	0	0
6	11141282	.	T	C	0	3	3	0	0	3	0	0
6	11250309	.	A	C	3	2	5	0	0	5	0	0
6	11250427	.	A	T	3	5	8	0	0	8	0	0
6	11250462	.	C	T	2	6	8	0	1	9	0	0
6	11250973	.	T	C	6	4	10	0	0	10	0	0
6	11253881	.	T	C	2	2	4	0	0	4	0	0
6	11253890	.	C	T	2	3	5	0	0	5	0	0
6	11254142	.	T	G	12	1	13	0	11	24	0	0
6	11254358	.	A	G	4	0	4	0	11	15	0	0
6	11254526	.	C	T	8	6	14	0	0	14	0	0
6	11257827	.	G	A	0	16	16	0	10	26	0	0
6	11257866	.	G	C	0	15	15	0	8	23	0	0
6	11257917	.	T	A	12	16	28	0	1	29	0	0
6	11259970	.	C	A	19	8	27	0	2	29	0	0
6	11265612	.	G	T	0	13	13	0	12	25	0	0
6	11265681	.	T	A	20	8	28	0	1	29	0	0
6	11265717	.	T	C	19	11	30	0	1	31	0	0
6	11266104	.	A	G	6	22	28	0	3	31	0	0
6	11266111	.	A	G	13	0	13	0	20	33	0	0
6	11266255	.	C	T	12	19	31	0	0	31	0	0
6	11266490	.	A	T	5	7	12	0	0	12	0	0
6	11266496	.	T	C	5	5	10	0	0	10	0	0
6	11276912	.	A	G	0	1	1	0	0	1	0	0
6	11279804	.	T	C	0	6	6	0	0	6	0	0
6	11279815	.	T	C	0	6	6	0	0	6	0	0
6	11285310	.	C	T	0	3	3	0	0	3	0	0
6	11285362	.	T	C	5	0	5	0	4	9	0	0
6	11285374	.	C	T	5	2	7	0	0	7	0	0
6	11285453	.	T	C	6	6	12	0	1	13	0	0
6	11285716	.	G	A	4	4	8	0	0	8	0	0
6	11285772	.	C	T	5	5	10	0	1	11	0	0
6	11287918	.	C	G	2	3	5	0	0	5	0	0
6	11288179	.	T	A	4	1	5	0	0	5	0	0
6	11288265	.	T	G	1	3	4	0	0	4	0	0
6	11288460	.	G	T	2	1	3	0	0	3	0	0
6	11288558	.	T	C	1	0	1	0	2	3	0	0
6	11295484	.	G	A	2	3	5	0	0	5	0	0
6	11299909	.	C	T	1	6	7	0	1	8	0	0
6	11309571	.	C	T	0	3	3	0	0	3	0	0
6	11309604	.	G	A	0	3	3	0	0	3	0	0
6	11334517	.	T	A	1	2	3	0	0	3	0	0
6	11344220	.	A	T	0	2	2	0	0	2	0	0
6	11344221	.	C	T	0	2	2	0	0	2	0	0
6	11370800	.	A	C	1	2	3	0	0	3	0	0
6	11397818	.	G	C	0	2	2	0	2	4	0	0
6	11403359	.	C	A	0	2	2	0	0	2	0	0
6	11407918	.	G	A	0	1	1	0	0	1	0	0
6	11407944	.	A	G	0	1	1	0	0	1	0	0
6	11407954	.	A	G	0	1	1	0	0	1	0	0
6	11410523	.	C	T	3	2	5	0	1	6	0	0
6	11414715	.	C	T	7	2	9	0	0	9	0	0
6	11414748	.	G	A	2	6	8	0	0	8	0	0
6	11414777	.	A	T	2	6	8	0	0	8	0	0
6	11414822	.	T	G	2	0	2	0	4	6	0	0
6	11415220	.	A	C	24	13	37	0	0	38	1	0
6	11415460	.	G	A	1	8	9	0	4	13	0	0
6	11504470	.	G	A	2	1	3	0	0	3	0	0
6	11512622	.	C	T	2	1	3	0	0	3	0	0
6	11540362	.	T	C	1	0	1	0	0	1	0	0
6	11765506	.	A	G	19	24	43	0	2	45	0	0
6	11766190	.	T	A	16	14	30	0	0	30	0	0
6	11766267	.	G	A	19	15	34	0	2	36	0	0
6	11766276	.	A	G	18	17	35	0	2	37	0	0
6	11766765	.	T	C	3	6	9	0	0	9	0	0
6	12199470	.	T	A	1	2	3	0	0	3	0	0
6	12504230	.	T	C	3	6	9	0	0	9	0	0
6	12504362	.	C	T	4	5	9	0	1	10	0	0
6	12504392	.	G	C	7	3	10	0	1	11	0	0
6	12529163	.	C	T	1	2	3	0	0	3	0	0
6	12529247	.	C	T	1	2	3	0	1	4	0	0
6	12550437	.	G	A	5	1	6	0	0	6	0	0
6	12550764	.	G	A	9	7	16	0	3	19	0	0
6	12550934	.	C	T	12	8	20	0	1	21	0	0
6	12627321	.	T	A	0	3	3	0	0	3	0	0
6	12668613	.	A	G	0	2	2	0	0	2	0	0
6	12671681	.	A	G	1	1	2	0	0	2	0	0
6	12684618	.	A	T	0	2	2	0	0	2	0	0
6	12684627	.	T	C	1	2	3	0	0	3	0	0
6	12797677	.	C	T	3	3	6	0	0	6	0	0
6	12797755	.	G	A	10	8	18	0	0	18	0	0
6	12797815	.	A	G	13	7	20	0	0	20	0	0
6	12798083	.	G	T	8	6	14	0	0	14	0	0
6	12798124	.	T	C	5	3	8	0	0	8	0	0
6	12798320	.	C	G	5	3	8	0	0	8	0	0
6	12798326	.	T	G	6	2	8	0	1	9	0	0
6	12803257	.	C	A	10	6	16	0	0	16	0	0
6	12803598	.	T	C	3	8	11	0	1	12	0	0
6	12803664	.	G	A	6	6	12	0	2	14	0	0
6	12803790	.	A	G	7	9	16	0	0	16	0	0
6	12803919	.	C	G	4	5	9	0	0	9	0	0
6	12804024	.	A	T	6	5	11	0	1	12	0	0
6	12804132	.	G	A	4	9	13	0	1	14	0	0
6	12810249	.	C	G	0	8	8	0	4	12	0	0
6	13231948	.	T	C	5	2	7	0	0	7	0	0
6	13510307	.	A	G	0	1	1	0	0	1	0	0
6	13514013	.	T	A	2	2	4	0	0	4	0	0
6	13668901	.	G	A	0	0	0	0	1	1	0	0
6	13709142	.	G	A	1	3	4	0	0	4	0	0
6	13709416	.	A	G	2	2	4	0	0	4	0	0
6	13734266	.	G	A	4	4	8	0	0	8	0	0
6	13734439	.	C	T	7	3	10	0	0	10	0	0
6	13734449	.	C	T	3	5	8	0	1	9	0	0
6	13734474	.	C	T	3	2	5	0	1	6	0	0
6	13743317	.	G	A	18	31	49	0	1	50	0	0
6	13743753	.	T	C	27	25	52	0	1	53	0	0
6	13743923	.	C	T	25	29	54	0	1	55	0	0
6	13744099	.	C	T	30	23	53	0	1	54	0	0
6	13806522	.	C	T	11	9	20	0	0	20	0	0
6	13862171	.	C	T	6	8	14	0	0	14	0	0
6	13862576	.	A	C	11	12	23	0	0	23	0	0
6	13866551	.	G	A	13	14	27	0	2	29	0	0
6	13868823	.	A	G	25	12	37	0	2	39	0	0
6	13868850	.	A	T	16	8	24	0	4	30	2	0
6	13869540	.	C	A	18	6	24	0	0	24	0	0
6	13869608	.	C	T	17	11	28	0	2	30	0	0
6	13871812	.	C	G	0	2	2	0	2	4	0	0
6	13871906	.	G	T	1	2	3	0	0	3	0	0
6	13897624	.	C	G	0	0	0	0	1	1	0	0
6	13900918	.	C	G	4	0	4	0	2	6	0	0
6	13901312	.	C	T	1	1	2	0	0	2	0	0
6	13901496	.	C	T	0	1	1	0	0	1	0	0
6	13901604	.	T	C	0	1	1	0	0	1	0	0
6	13903413	.	T	C	1	0	1	0	0	1	0	0
6	13907856	.	T	A	3	0	3	0	0	3	0	0
6	13908633	.	G	A	0	8	8	0	13	21	0	0
6	13914821	.	T	C	2	4	6	0	0	6	0	0
6	13914824	.	G	A	2	4	6	0	0	6	0	0
6	13920275	.	T	G	2	3	5	0	0	5	0	0
6	13920543	.	C	T	3	2	5	0	0	5	0	0
6	13941729	.	C	A	14	20	34	0	3	37	0	0
6	13967038	.	A	T	7	6	13	0	0	13	0	0
6	13967328	.	G	A	4	3	7	0	0	7	0	0
6	13967512	.	C	A	17	16	33	0	2	35	0	0
6	13977080	.	T	A	5	2	7	0	1	8	0	0
6	13977567	.	G	T	11	17	28	0	0	28	0	0
6	13977588	.	C	T	10	22	32	0	3	35	0	0
6	13977648	.	G	A	9	7	16	0	1	17	0	0
6	13987287	.	G	C	15	5	20	0	0	20	0	0
6	13987299	.	A	T	17	10	27	0	0	27	0	0
6	13987346	.	C	T	10	13	23	0	2	25	0	0
6	13987560	.	T	C	21	9	30	0	2	32	0	0
6	13987631	.	G	A	23	18	41	0	2	43	0	0
6	13987663	.	T	A	22	19	41	0	1	42	0	0
6	13987710	.	G	A	15	11	26	0	0	26	0	0
6	13987713	.	T	G	15	9	24	0	0	24	0	0
6	13993783	.	A	T	6	2	8	0	0	8	0	0
6	14032693	.	T	C	17	9	26	0	2	28	0	0
6	14032698	.	T	A	17	8	25	0	0	25	0	0
6	14032739	.	G	A	13	11	24	0	1	25	0	0
6	14033030	.	G	T	6	9	15	0	1	16	0	0
6	14033167	.	G	A	22	13	35	0	0	35	0	0
6	14033556	.	T	A	5	3	8	0	0	8	0	0
6	14033836	.	G	C	5	3	8	0	0	8	0	0
6	14034887	.	G	C	9	7	16	0	0	16	0	0
6	14034907	.	C	T	0	6	6	0	15	21	0	0
6	14034949	.	G	A	7	11	18	0	1	19	0	0
6	14038306	.	C	T	0	1	1	0	0	1	0	0
6	14038506	.	T	A	2	0	2	0	0	2	0	0
6	14086810	.	T	C	20	22	42	0	3	45	0	0
6	14086901	.	G	T	20	21	41	0	1	42	0	0
6	14086942	.	G	C	19	26	45	0	3	48	0	0
6	14087182	.	C	A	22	22	44	0	3	47	0	0
6	14087220	.	T	A	24	22	46	0	1	47	0	0
6	14087569	.	T	G	21	19	40	0	1	41	0	0
6	14087641	.	A	C	20	24	44	0	1	45	0	0
6	14087883	.	T	C	11	10	21	0	0	21	0	0
6	14088095	.	C	T	23	24	47	0	2	49	0	0
6	14092942	.	T	A	14	9	23	0	4	27	0	0
6	14096684	.	C	T	0	1	1	0	1	2	0	0
6	14098760	.	C	T	0	14	14	0	15	29	0	0
6	14105071	.	G	T	2	2	4	0	0	4	0	0
6	14173159	.	C	A	4	3	7	0	1	9	1	0
6	14173599	.	A	G	4	3	7	0	0	7	0	0
6	14173641	.	G	A	7	6	13	0	2	15	0	0
6	14191637	.	A	G	1	2	3	0	1	4	0	0
6	14191709	.	T	C	1	0	1	0	6	7	0	0
6	14209151	.	C	T	8	5	13	0	1	14	0	0
6	14209674	.	A	G	4	7	11	0	0	11	0	0
6	14212352	.	G	A	2	3	5	0	1	6	0	0
6	14212370	.	G	A	4	4	8	0	0	8	0	0
6	14212430	.	T	G	6	6	12	0	0	12	0	0
6	14240226	.	C	T	4	0	4	0	0	4	0	0
6	14950538	.	T	A	2	4	6	0	0	6	0	0
6	14950567	.	T	C	5	5	10	0	0	10	0	0
6	14950759	.	T	C	7	14	21	0	0	21	0	0
6	14951854	.	C	T	16	16	32	0	2	34	0	0
6	14952579	.	T	C	14	8	22	0	0	22	0	0
6	14981102	.	G	T	0	2	2	0	2	4	0	0
6	14988559	.	G	T	5	2	7	0	0	7	0	0
6	15023688	.	G	A	5	7	12	0	0	13	1	0
6	15023713	.	A	G	2	3	5	0	0	5	0	0
6	15037025	.	A	G	2	4	6	0	0	6	0	0
6	15037258	.	A	G	1	0	1	0	0	1	0	0
6	15051753	.	G	A	2	3	5	0	0	5	0	0
6	15051782	.	T	C	3	3	6	0	0	6	0	0
6	15051834	.	A	G	1	0	1	0	0	1	0	0
6	15059249	.	A	G	1	2	3	0	0	3	0	0
6	15059283	.	T	C	1	3	4	0	0	4	0	0
6	15062015	.	A	G	1	3	4	0	0	4	0	0
6	15127591	.	G	A	0	5	5	0	1	6	0	0
6	15130921	.	G	A	0	1	1	0	0	1	0	0
6	15130982	.	G	A	0	4	4	0	5	9	0	0
6	15235960	.	A	C	4	2	6	0	0	6	0	0
6	15236344	.	G	A	2	2	4	0	0	4	0	0
6	15242287	.	A	T	1	1	2	0	0	2	0	0
6	15242641	.	C	T	5	5	10	0	0	10	0	0
6	15243129	.	T	C	2	2	4	0	0	4	0	0
6	15243137	.	A	C	2	4	6	0	0	6	0	0
6	15434544	.	T	A	9	14	23	0	0	23	0	0
6	15446974	.	A	G	3	1	4	0	0	4	0	0
6	15447086	.	C	T	3	4	7	0	0	7	0	0
6	15447165	.	A	G	1	0	1	0	2	3	0	0
6	15447305	.	G	A	3	3	6	0	1	7	0	0
6	15455804	.	C	A	0	3	3	0	2	5	0	0
6	15470505	.	A	G	1	3	4	0	0	4	0	0
6	15491460	.	C	A	5	2	7	0	1	8	0	0
6	15527107	.	A	G	4	2	6	0	0	6	0	0
6	15527356	.	T	C	6	6	12	0	0	12	0	0
6	15527385	.	G	A	8	6	14	0	0	14	0	0
6	15531697	.	G	A	3	2	5	0	0	5	0	0
6	15541015	.	G	A	2	4	6	0	0	6	0	0
6	15541077	.	T	C	0	1	1	0	0	1	0	0
6	15543451	.	C	T	11	4	15	0	0	15	0	0
6	15548966	.	A	G	4	6	10	0	0	10	0	0
6	15604133	.	C	T	4	5	9	0	0	9	0	0
6	15752298	.	A	C	5	1	6	0	4	10	0	0
6	15752348	.	A	G	4	9	13	0	0	13	0	0
6	15752489	.	C	T	4	6	10	0	0	10	0	0
6	15752681	.	A	C	5	4	9	0	0	9	0	0
6	15753256	.	A	G	1	3	4	0	0	4	0	0
6	15753508	.	A	C	3	2	5	0	0	5	0	0
6	15889726	.	C	T	6	2	8	0	0	8	0	0
6	16031714	.	C	T	4	3	7	0	1	8	0	0
6	16033239	.	A	G	3	2	5	0	0	5	0	0
6	16043950	.	C	T	0	15	15	0	7	22	0	0
6	16043980	.	A	G	8	18	26	0	0	26	0	0
6	16044019	.	T	C	12	0	12	0	17	29	0	0
6	16044597	.	C	T	16	6	22	0	0	22	0	0
6	16044664	.	T	C	9	12	21	0	0	21	0	0
6	16045413	.	T	C	7	10	17	0	0	17	0	0
6	16045463	.	G	C	11	0	11	0	11	22	0	0
6	16045511	.	G	A	9	4	13	0	0	13	0	0
6	16045650	.	G	A	4	12	16	0	0	16	0	0
6	16045712	.	C	T	5	8	13	0	0	13	0	0
6	16045768	.	C	G	8	3	11	0	0	11	0	0
6	16045884	.	A	G	8	10	18	1	0	19	0	0
6	16045912	.	T	C	4	0	4	1	17	22	0	0
6	16045946	.	A	C	8	9	17	1	1	19	0	0
6	16045947	.	A	T	7	8	15	1	3	19	0	0
6	16046025	.	T	A	5	11	16	0	1	17	0	0
6	16046049	.	G	T	14	6	20	0	0	21	1	0
6	16046110	.	T	C	6	10	16	0	0	16	0	0
6	16046115	.	T	C	7	8	15	0	1	16	0	0
6	16046272	.	G	T	6	8	14	0	0	14	0	0
6	16046365	.	G	A	5	2	7	0	0	7	0	0
6	16046664	.	A	G	5	6	11	0	0	12	1	0
6	16046676	.	G	A	6	6	12	0	0	12	0	0
6	16046850	.	G	A	10	9	19	0	0	19	0	0
6	16047197	.	C	T	0	6	6	0	11	17	0	0
6	16084168	.	T	C	1	1	2	0	0	2	0	0
6	16104448	.	G	T	4	8	12	0	0	12	0	0
6	16129824	.	G	T	0	1	1	0	0	1	0	0
6	16135963	.	C	T	1	4	5	0	0	5	0	0
6	16135966	.	C	T	4	1	5	0	0	5	0	0
6	16162994	.	G	A	1	0	1	0	0	1	0	0
6	16196326	.	G	A	0	1	1	0	1	2	0	0
6	16393459	.	G	T	4	8	12	0	0	12	0	0
6	16393518	.	G	A	7	3	10	0	0	10	0	0
6	16393570	.	G	T	2	5	7	0	1	8	0	0
6	16393792	.	G	C	4	4	8	0	0	8	0	0
6	16393816	.	G	C	4	2	6	0	0	6	0	0
6	16393890	.	C	G	1	3	4	0	2	6	0	0
6	16394004	.	G	A	3	2	5	0	2	7	0	0
6	16394244	.	A	G	1	2	3	0	0	3	0	0
6	16474853	.	T	C	5	5	10	0	0	10	0	0
6	16474879	.	T	C	7	5	12	0	0	12	0	0
6	16474948	.	T	C	8	8	16	0	0	16	0	0
6	16475047	.	T	A	10	9	19	0	1	20	0	0
6	16475395	.	A	C	4	5	9	0	0	9	0	0
6	16475499	.	G	A	3	9	12	0	0	12	0	0
6	16475502	.	G	T	3	9	12	0	0	12	0	0
6	16475559	.	T	A	1	3	4	0	0	4	0	0
6	16475582	.	G	T	1	1	2	0	0	2	0	0
6	16475728	.	G	A	0	12	12	0	3	15	0	0
6	16478198	.	C	A	0	7	7	0	7	14	0	0
6	16478200	.	T	G	7	6	13	0	1	14	0	0
6	16485073	.	A	T	5	4	9	0	0	9	0	0
6	16493381	.	A	T	16	9	25	0	1	26	0	0
6	16499206	.	G	A	5	9	14	0	0	14	0	0
6	16499260	.	A	G	8	5	13	0	0	13	0	0
6	16499422	.	A	G	5	3	8	0	0	8	0	0
6	16521166	.	C	A	3	6	9	0	2	11	0	0
6	16523647	.	A	G	3	1	4	0	0	4	0	0
6	16523704	.	A	G	8	3	11	0	0	11	0	0
6	16524019	.	G	A	4	3	7	0	1	8	0	0
6	16524618	.	C	G	0	4	4	0	0	4	0	0
6	16524653	.	G	A	4	5	9	0	0	9	0	0
6	16524663	.	T	C	4	5	9	0	0	9	0	0
6	16526848	.	A	T	7	2	9	0	1	10	0	0
6	16544879	.	G	A	1	4	5	0	0	5	0	0
6	16545661	.	A	G	2	2	4	0	0	4	0	0
6	16552235	.	T	G	5	2	7	0	0	7	0	0
6	16561379	.	C	T	2	4	6	0	0	6	0	0
6	16571935	.	G	A	1	3	4	0	0	4	0	0
6	16572007	.	C	T	1	2	3	0	0	3	0	0
6	16577229	.	C	T	0	0	0	0	2	2	0	0
6	16585984	.	G	A	2	3	5	0	1	6	0	0
6	16594190	.	T	C	3	0	3	0	2	5	0	0
6	16599048	.	A	G	1	2	3	0	0	3	0	0
6	16664776	.	C	T	1	2	3	0	0	3	0	0
6	16673876	.	C	T	3	1	4	0	1	5	0	0
6	16674296	.	A	G	10	7	17	0	2	19	0	0
6	16674344	.	T	A	11	10	21	0	4	25	0	0
6	16674371	.	T	C	10	7	17	0	1	18	0	0
6	16674435	.	A	C	10	10	20	0	1	21	0	0
6	16674618	.	G	A	7	9	16	0	2	18	0	0
6	16674808	.	T	C	0	6	6	0	0	6	0	0
6	16683385	.	T	C	3	6	9	0	1	10	0	0
6	16683421	.	A	G	7	6	13	0	0	13	0	0
6	16684004	.	A	G	6	7	13	0	0	13	0	0
6	16687429	.	C	A	7	8	15	0	1	16	0	0
6	16687432	.	T	A	7	6	13	0	2	15	0	0
6	16688900	.	T	C	4	1	5	0	0	5	0	0
6	16688921	.	A	G	2	5	7	0	0	7	0	0
6	16689416	.	T	A	4	3	7	0	1	8	0	0
6	16695771	.	C	T	0	1	1	0	0	1	0	0
6	16696083	.	C	T	0	1	1	0	0	1	0	0
6	16699626	.	C	G	5	2	7	0	0	7	0	0
6	16704848	.	T	C	1	2	3	0	0	3	0	0
6	16717795	.	A	C	5	5	10	0	1	11	0	0
6	16717807	.	C	A	0	4	4	0	6	10	0	0
6	17726078	.	G	A	3	2	5	0	1	6	0	0
6	17910266	.	C	T	1	0	1	0	0	1	0	0
6	17980479	.	A	T	1	1	2	0	1	3	0	0
6	18078439	.	G	A	2	5	7	0	0	7	0	0
6	18203842	.	G	A	11	17	28	0	0	28	0	0
6	18220141	.	G	A	4	2	6	0	0	6	0	0
6	18228324	.	G	A	5	8	13	0	0	13	0	0
6	18245385	.	G	A	10	9	19	0	1	20	0	0
6	18267795	.	G	C	1	0	1	0	0	1	0	0
6	18267829	.	G	C	1	0	1	0	0	1	0	0
6	18270731	.	G	A	3	3	6	0	0	6	0	0
6	18272540	.	T	C	4	5	9	0	0	9	0	0
6	18274351	.	T	A	3	3	6	0	0	6	0	0
6	18290937	.	G	A	0	2	2	0	2	4	0	0
6	18359389	.	G	A	8	9	17	0	1	18	0	0
6	18361359	.	A	T	7	8	15	0	2	17	0	0
6	18361609	.	T	C	11	7	18	0	0	18	0	0
6	18362043	.	T	G	8	0	8	0	6	14	0	0
6	18364051	.	A	T	3	2	5	0	0	5	0	0
6	18364081	.	G	A	0	2	2	0	4	6	0	0
6	18375692	.	A	C	1	1	2	0	0	2	0	0
6	18375693	.	T	C	1	1	2	0	0	2	0	0
6	18381278	.	G	A	0	3	3	0	4	7	0	0
6	18388387	.	T	G	3	3	6	0	0	6	0	0
6	18388569	.	C	T	5	4	9	0	0	9	0	0
6	18389220	.	G	A	7	9	16	0	0	16	0	0
6	18389541	.	C	T	6	7	13	0	2	15	0	0
6	18389655	.	G	A	9	5	14	0	0	14	0	0
6	18390031	.	T	A	2	0	2	0	0	2	0	0
6	18393826	.	A	T	1	0	1	0	0	1	0	0
6	18399975	.	C	T	0	2	2	0	0	2	0	0
6	18399981	.	C	T	1	1	2	0	1	3	0	0
6	18400286	.	G	T	3	6	9	0	0	9	0	0
6	18418714	.	T	G	7	3	10	0	0	10	0	0
6	18418760	.	G	A	4	4	8	0	0	8	0	0
6	18437514	.	T	G	7	0	7	0	14	21	0	0
6	18438459	.	A	G	1	0	1	0	0	1	0	0
6	18439256	.	C	A	5	6	11	0	0	11	0	0
6	18439481	.	A	T	14	9	23	0	0	23	0	0
6	18439723	.	G	A	6	6	12	0	0	12	0	0
6	18439774	.	G	A	0	3	3	0	12	15	0	0
6	18520930	.	T	A	25	12	37	0	0	37	0	0
6	18523549	.	C	A	10	14	24	0	1	25	0	0
6	18523770	.	A	T	14	15	29	0	0	29	0	0
6	18523772	.	C	G	15	14	29	0	0	29	0	0
6	18523817	.	T	A	13	10	23	0	0	23	0	0
6	18523895	.	C	G	6	3	9	0	0	9	0	0
6	18524550	.	A	G	4	5	9	0	1	10	0	0
6	18524579	.	A	G	11	7	18	0	0	18	0	0
6	18526432	.	A	G	1	2	3	0	0	3	0	0
6	18529148	.	G	T	1	0	1	0	0	1	0	0
6	18529589	.	G	A	2	0	2	0	0	2	0	0
6	18529593	.	T	G	2	1	3	0	0	3	0	0
6	18531946	.	T	C	2	6	8	0	1	9	0	0
6	18532000	.	A	T	2	7	9	0	0	9	0	0
6	18532012	.	C	T	1	4	5	0	0	5	0	0
6	18532445	.	A	T	3	3	6	0	0	6	0	0
6	18536239	.	G	T	0	3	3	0	0	3	0	0
6	18536748	.	C	T	2	1	3	0	0	3	0	0
6	18540815	.	G	T	1	1	2	0	0	2	0	0
6	18542836	.	C	A	2	2	4	0	0	4	0	0
6	18542933	.	T	C	4	6	10	0	0	10	0	0
6	18543385	.	C	T	12	12	24	0	1	25	0	0
6	18543400	.	A	G	9	13	22	0	0	22	0	0
6	18543637	.	A	G	10	8	18	0	3	21	0	0
6	18543735	.	A	G	9	10	19	0	0	19	0	0
6	18543950	.	G	T	8	3	11	0	0	11	0	0
6	18554177	.	T	G	3	6	9	0	0	9	0	0
6	18554702	.	C	G	3	3	6	0	0	6	0	0
6	18554719	.	T	C	3	0	3	0	3	6	0	0
6	18555195	.	T	C	2	4	6	0	0	6	0	0
6	18555651	.	A	T	1	1	2	0	0	2	0	0
6	18555657	.	G	A	0	1	1	0	1	2	0	0
6	18557997	.	C	G	0	4	4	0	0	4	0	0
6	18558137	.	G	A	1	2	3	0	0	3	0	0
6	18584793	.	T	A	1	1	2	0	0	2	0	0
6	18589235	.	T	C	4	1	5	0	0	5	0	0
6	18592209	.	G	A	2	7	9	0	2	11	0	0
6	18598494	.	A	T	3	4	7	0	0	7	0	0
6	18600213	.	A	G	1	4	5	0	0	5	0	0
6	18600234	.	T	G	2	3	5	0	0	5	0	0
6	18606063	.	T	C	10	3	13	0	0	13	0	0
6	18606135	.	T	G	5	7	12	0	0	12	0	0
6	18607590	.	G	A	15	16	31	0	0	31	0	0
6	18624371	.	A	G	6	3	9	0	0	9	0	0
6	18624426	.	C	T	9	3	12	0	1	13	0	0
6	18624464	.	T	A	8	3	11	0	0	11	0	0
6	18624805	.	C	T	0	2	2	0	1	3	0	0
6	18624964	.	C	T	0	2	2	0	11	13	0	0
6	18714845	.	A	C	5	7	12	0	0	12	0	0
6	18714890	.	T	A	5	12	17	0	0	17	0	0
6	18714910	.	T	C	11	3	14	0	0	14	0	0
6	18714937	.	A	G	13	5	18	0	1	19	0	0
6	18715540	.	A	G	1	4	5	0	1	6	0	0
6	18715544	.	C	T	4	2	6	0	0	6	0	0
6	18715879	.	A	C	6	5	11	0	0	11	0	0
6	18716054	.	G	A	6	5	11	0	0	11	0	0
6	18716085	.	C	T	6	7	13	0	0	13	0	0
6	18716242	.	G	A	6	5	11	0	0	11	0	0
6	18716269	.	A	G	2	3	5	0	1	6	0	0
6	18716330	.	C	T	3	4	7	0	1	8	0	0
6	18716539	.	C	T	1	7	8	0	4	12	0	0
6	18716551	.	T	C	8	5	13	0	0	13	0	0
6	18717315	.	T	C	7	4	11	0	0	11	0	0
6	18717319	.	A	T	7	4	11	0	1	12	0	0
6	18717449	.	C	A	0	6	6	0	2	8	0	0
6	18717539	.	T	C	2	0	2	0	6	8	0	0
6	18717610	.	T	A	2	2	4	0	0	4	0	0
6	18717682	.	A	G	1	2	3	0	0	3	0	0
6	18717934	.	T	C	4	2	6	0	0	6	0	0
6	18717991	.	T	A	3	2	5	0	2	7	0	0
6	18718205	.	A	C	1	5	6	0	0	6	0	0
6	18718245	.	T	C	3	0	3	0	3	6	0	0
6	18718438	.	T	G	3	4	7	0	0	7	0	0
6	18718485	.	C	T	0	2	2	0	3	5	0	0
6	18718662	.	G	A	5	5	10	0	0	10	0	0
6	18718663	.	C	T	5	5	10	0	0	10	0	0
6	18718846	.	A	T	5	2	7	0	0	7	0	0
6	18718964	.	A	G	4	5	9	0	0	9	0	0
6	18721099	.	T	C	1	3	4	0	0	4	0	0
6	18724415	.	T	A	4	2	6	0	0	6	0	0
6	18725196	.	C	T	1	3	4	0	0	4	0	0
6	18725232	.	A	G	2	4	6	0	0	6	0	0
6	18736460	.	A	G	0	2	2	0	0	2	0	0
6	18737442	.	A	G	2	1	3	0	2	5	0	0
6	18738593	.	T	A	2	2	4	0	0	4	0	0
6	18953406	.	G	C	5	3	8	0	0	8	0	0
6	19265802	.	C	A	2	4	6	0	0	6	0	0
6	19295015	.	T	A	22	14	36	0	0	36	0	0
6	19295044	.	A	T	17	14	31	0	4	35	0	0
6	19295469	.	T	C	23	0	23	0	21	44	0	0
6	19295609	.	A	T	11	15	26	0	0	26	0	0
6	19295644	.	C	T	0	14	14	0	15	29	0	0
6	19320696	.	C	T	0	4	4	0	3	7	0	0
6	19327239	.	C	T	0	2	2	0	3	5	0	0
6	19327320	.	T	G	2	4	6	0	0	6	0	0
6	19330729	.	T	C	2	2	4	0	0	4	0	0
6	19334722	.	A	C	2	3	5	0	0	5	0	0
6	19334948	.	A	T	4	3	7	0	0	7	0	0
6	19334949	.	C	A	4	3	7	0	0	7	0	0
6	19335232	.	A	G	3	5	8	0	0	8	0	0
6	19339426	.	C	T	2	2	4	0	0	4	0	0
6	19344846	.	C	T	9	11	20	0	1	21	0	0
6	19344930	.	G	C	6	8	14	0	0	14	0	0
6	19344950	.	C	T	6	9	15	0	2	17	0	0
6	19345191	.	G	A	3	1	4	0	0	4	0	0
6	19347426	.	C	T	0	6	6	0	10	16	0	0
6	19381640	.	G	T	1	4	5	0	1	6	0	0
6	19381679	.	C	G	3	6	9	0	1	10	0	0
6	19381843	.	A	G	2	7	9	0	0	9	0	0
6	19381856	.	C	T	6	4	10	0	0	10	0	0
6	19667869	.	C	T	1	3	4	0	0	4	0	0
6	19668461	.	C	T	2	2	4	0	1	5	0	0
6	19715507	.	A	C	0	1	1	0	0	1	0	0
6	19802042	.	T	C	8	6	14	0	0	14	0	0
6	19802242	.	C	T	10	6	16	0	1	17	0	0
6	19802330	.	G	A	6	5	11	0	0	11	0	0
6	19802354	.	G	A	4	4	8	0	0	8	0	0
6	19802414	.	C	G	5	0	5	0	6	11	0	0
6	19802415	.	G	A	5	6	11	0	0	11	0	0
6	19804702	.	A	C	7	4	11	0	0	11	0	0
6	19804743	.	A	T	7	6	13	0	0	13	0	0
6	19807574	.	A	G	0	2	2	0	0	2	0	0
6	19808670	.	C	T	4	5	9	0	0	9	0	0
6	19808818	.	G	A	3	5	8	0	0	8	0	0
6	20766136	.	C	T	2	5	7	0	0	7	0	0
6	20766307	.	A	G	13	13	26	0	0	26	0	0
6	20766500	.	G	T	6	6	12	0	1	13	0	0
6	20767015	.	T	A	18	14	32	0	0	32	0	0
6	20767537	.	A	G	17	17	34	0	0	34	0	0
6	20767830	.	T	G	12	4	16	0	0	16	0	0
6	20767958	.	T	G	6	4	10	0	0	10	0	0
6	20767994	.	T	C	9	11	20	0	0	20	0	0
6	20768061	.	A	G	10	5	15	0	0	15	0	0
6	20768076	.	C	A	9	4	13	0	0	13	0	0
6	20768107	.	A	T	9	6	15	0	2	17	0	0
6	20768239	.	A	G	13	2	15	0	0	15	0	0
6	20768338	.	G	A	13	11	24	0	2	26	0	0
6	20768346	.	T	G	13	12	25	0	0	25	0	0
6	20773961	.	G	A	20	9	29	0	1	30	0	0
6	20774048	.	A	C	15	10	25	0	1	26	0	0
6	20774701	.	G	A	6	3	9	0	2	11	0	0
6	20774768	.	C	T	13	2	15	0	0	15	0	0
6	20785089	.	A	G	6	7	13	0	0	13	0	0
6	20785105	.	C	T	0	8	8	0	7	15	0	0
6	20785144	.	G	A	6	12	18	0	0	18	0	0
6	20789072	.	A	G	14	14	28	0	1	29	0	0
6	20789162	.	G	A	11	10	21	0	0	21	0	0
6	20789195	.	C	T	11	11	22	0	0	22	0	0
6	20789351	.	T	C	10	6	16	0	0	16	0	0
6	20789369	.	T	A	7	5	12	0	2	14	0	0
6	20789489	.	T	C	5	6	11	0	0	11	0	0
6	20815058	.	A	T	1	1	2	0	0	2	0	0
6	20822000	.	A	G	1	2	3	0	0	3	0	0
6	20822108	.	T	C	0	1	1	0	0	1	0	0
6	20910627	.	A	C	3	4	7	0	0	7	0	0
6	20910713	.	G	T	2	3	5	0	0	5	0	0
6	20910759	.	A	T	3	2	5	0	0	5	0	0
6	20910880	.	G	A	4	5	9	0	0	9	0	0
6	20917730	.	A	T	4	5	9	0	1	10	0	0
6	20917780	.	T	A	5	3	8	0	0	8	0	0
6	20917921	.	G	A	8	8	16	0	1	17	0	0
6	20917922	.	A	C	7	9	16	0	1	17	0	0
6	20918237	.	A	G	5	8	13	0	0	13	0	0
6	20918258	.	A	G	6	3	9	0	0	9	0	0
6	20918456	.	C	A	6	2	8	0	0	8	0	0
6	20918613	.	G	T	7	7	14	0	0	14	0	0
6	20918673	.	T	C	13	6	19	0	0	19	0	0
6	20921859	.	G	A	10	4	14	0	1	15	0	0
6	20921888	.	T	C	6	6	12	0	1	13	0	0
6	20922057	.	A	T	8	8	16	0	0	16	0	0
6	20922316	.	G	C	9	0	9	0	2	11	0	0
6	20922330	.	G	A	7	3	10	0	1	11	0	0
6	20922396	.	G	A	5	13	18	0	1	19	0	0
6	20922468	.	G	A	3	4	7	0	1	8	0	0
6	20952104	.	A	C	3	2	5	0	0	5	0	0
6	20961760	.	T	A	3	2	5	0	0	5	0	0
6	20961775	.	C	T	3	2	5	0	0	5	0	0
6	20961799	.	T	C	2	2	4	0	1	5	0	0
6	20961820	.	G	A	1	0	1	0	0	1	0	0
6	20965710	.	G	A	0	4	4	0	3	7	0	0
6	20965745	.	T	A	3	4	7	0	1	8	0	0
6	20965873	.	T	A	6	8	14	0	0	14	0	0
6	20970989	.	T	A	1	1	2	0	0	2	0	0
6	20978972	.	C	T	3	0	3	0	0	3	0	0
6	20995800	.	A	G	3	6	9	0	1	10	0	0
6	20996640	.	C	T	5	5	10	0	0	10	0	0
6	20996733	.	A	C	4	6	10	0	1	11	0	0
6	21116134	.	C	G	0	5	5	0	0	5	0	0
6	21118608	.	G	A	3	4	7	0	0	7	0	0
6	21119598	.	C	T	1	2	3	0	1	4	0	0
6	21119779	.	G	A	2	2	4	0	0	4	0	0
6	21119842	.	G	A	0	4	4	0	7	11	0	0
6	21119847	.	G	A	7	5	12	0	0	12	0	0
6	21119994	.	T	C	7	2	9	0	1	10	0	0
6	21120001	.	A	G	8	2	10	0	1	11	0	0
6	21120080	.	A	G	4	3	7	0	1	8	0	0
6	21120146	.	G	C	3	4	7	0	1	8	0	0
6	21120193	.	T	C	3	4	7	0	0	7	0	0
6	21120201	.	T	C	3	4	7	0	0	7	0	0
6	21120261	.	C	T	5	3	8	0	0	8	0	0
6	21120341	.	A	C	8	10	18	0	0	18	0	0
6	21120387	.	T	C	5	6	11	0	2	13	0	0
6	21121977	.	T	C	0	1	1	0	0	1	0	0
6	21121986	.	G	C	0	1	1	0	0	1	0	0
6	21130593	.	G	A	4	4	8	0	1	9	0	0
6	21130623	.	C	T	3	5	8	0	0	8	0	0
6	21130668	.	A	C	1	3	4	0	0	4	0	0
6	21130850	.	T	G	2	0	2	0	0	2	0	0
6	21131142	.	A	T	1	3	4	0	0	4	0	0
6	21131414	.	C	A	0	2	2	0	0	2	0	0
6	21138869	.	C	T	0	2	2	0	0	2	0	0
6	21138870	.	T	G	0	2	2	0	0	2	0	0
6	21140553	.	G	T	1	3	4	0	0	4	0	0
6	21143033	.	T	C	2	2	4	0	0	4	0	0
6	21144245	.	C	T	5	3	8	0	0	8	0	0
6	21144285	.	T	C	2	1	3	0	0	3	0	0
6	21146813	.	T	G	2	0	2	0	5	7	0	0
6	21147218	.	G	A	0	4	4	0	3	7	0	0
6	21147240	.	A	G	3	3	6	0	0	6	0	0
6	21147291	.	C	A	3	4	7	0	0	7	0	0
6	21147332	.	T	A	1	4	5	0	1	6	0	0
6	21147334	.	T	A	1	5	6	0	0	6	0	0
6	21147818	.	T	C	6	4	10	0	1	11	0	0
6	21147837	.	A	G	5	5	10	0	0	10	0	0
6	21147920	.	A	C	2	7	9	0	1	10	0	0
6	21148166	.	A	T	8	3	11	0	2	13	0	0
6	21148167	.	T	C	10	3	13	0	0	13	0	0
6	21148736	.	T	A	3	2	5	0	0	5	0	0
6	21148737	.	A	T	3	2	5	0	0	5	0	0
6	21149337	.	G	A	2	0	2	0	0	2	0	0
6	21150661	.	T	C	5	11	16	0	0	16	0	0
6	21150672	.	G	A	5	12	17	0	0	17	0	0
6	21150712	.	A	T	8	17	25	0	1	26	0	0
6	21150872	.	C	T	16	16	32	0	1	33	0	0
6	21150958	.	A	G	9	13	22	0	0	22	0	0
6	21151027	.	A	G	6	8	14	0	0	14	0	0
6	21151078	.	T	C	8	10	18	0	1	19	0	0
6	21151312	.	T	C	3	2	5	0	0	5	0	0
6	21151379	.	A	C	6	9	15	0	0	15	0	0
6	21151415	.	T	C	3	8	11	0	0	11	0	0
6	21151459	.	T	C	7	3	10	0	0	10	0	0
6	21153285	.	G	A	0	7	7	0	5	12	0	0
6	21154996	.	T	A	6	6	12	0	0	12	0	0
6	21363258	.	A	G	2	2	4	0	0	4	0	0
6	21390316	.	G	A	0	4	4	0	2	6	0	0
6	21391439	.	G	A	3	5	8	0	0	8	0	0
6	21391444	.	C	T	4	5	9	0	0	9	0	0
6	21391499	.	T	A	2	3	5	0	0	5	0	0
6	21391675	.	A	G	6	8	14	0	1	15	0	0
6	21392126	.	A	G	11	8	19	0	1	20	0	0
6	21392545	.	C	T	2	1	3	0	1	4	0	0
6	21392584	.	C	A	3	3	6	0	1	7	0	0
6	21392722	.	T	C	7	8	15	0	0	15	0	0
6	21393635	.	G	A	0	6	6	0	6	12	0	0
6	21395153	.	T	G	4	4	8	0	1	9	0	0
6	21395164	.	C	T	3	4	7	0	0	7	0	0
6	21436342	.	G	A	2	0	2	0	0	2	0	0
6	21454984	.	C	A	6	3	9	0	0	9	0	0
6	21513773	.	G	C	5	4	9	0	1	10	0	0
6	21513778	.	A	G	3	5	8	0	0	8	0	0
6	21513826	.	C	A	1	4	5	0	0	5	0	0
6	21513885	.	G	T	3	3	6	0	0	6	0	0
6	21514460	.	T	C	1	4	5	0	0	5	0	0
6	21514529	.	C	T	4	4	8	0	1	9	0	0
6	21516593	.	A	G	4	2	6	0	1	7	0	0
6	21525887	.	C	A	3	6	9	0	1	10	0	0
6	21525916	.	A	G	6	6	12	0	0	12	0	0
6	21525943	.	T	A	5	14	19	0	0	19	0	0
6	21526047	.	C	A	6	5	11	0	1	12	0	0
6	21526069	.	T	C	9	0	9	0	7	16	0	0
6	21526109	.	A	G	14	5	19	0	0	19	0	0
6	21526322	.	A	G	9	17	26	0	1	27	0	0
6	21526357	.	C	T	0	17	17	0	5	22	0	0
6	21526620	.	T	C	4	2	6	0	0	6	0	0
6	21529229	.	A	G	4	5	9	0	0	9	0	0
6	21529253	.	C	A	7	15	22	0	0	22	0	0
6	21529379	.	A	T	2	4	6	0	0	6	0	0
6	21570468	.	A	G	1	0	1	0	1	2	0	0
6	21577839	.	G	A	4	0	4	0	0	4	0	0
6	21578702	.	G	A	2	0	2	0	0	2	0	0
6	21578732	.	A	T	4	1	5	0	0	5	0	0
6	21578760	.	C	T	1	6	7	0	1	8	0	0
6	21588594	.	C	A	0	13	13	0	5	18	0	0
6	21588597	.	T	G	4	12	16	0	2	18	0	0
6	21588727	.	T	A	6	6	12	0	0	12	0	0
6	21598085	.	C	T	5	5	10	0	1	11	0	0
6	21602679	.	T	G	4	4	8	0	0	8	0	0
6	21615529	.	C	T	2	4	6	0	0	6	0	0
6	21633833	.	A	C	1	2	3	0	0	3	0	0
6	21634540	.	C	A	1	2	3	0	0	3	0	0
6	21693910	.	A	G	4	10	14	0	0	14	0	0
6	21694306	.	G	A	11	9	20	0	0	20	0	0
6	21694369	.	T	A	6	7	13	0	0	13	0	0
6	21694486	.	C	A	11	4	15	0	0	15	0	0
6	21694544	.	A	G	9	10	19	0	0	19	0	0
6	21694591	.	C	A	7	10	17	0	0	17	0	0
6	21694652	.	T	A	10	11	21	0	0	21	0	0
6	21694917	.	C	A	5	4	9	0	0	9	0	0
6	21695033	.	C	A	5	2	7	0	2	9	0	0
6	21695034	.	C	T	4	2	6	0	3	9	0	0
6	21726584	.	C	T	6	2	8	0	1	9	0	0
6	21726758	.	A	G	4	3	7	0	0	7	0	0
6	21811551	.	G	A	7	3	10	0	0	10	0	0
6	21815389	.	G	A	3	4	7	0	0	7	0	0
6	21861324	.	G	T	22	18	40	0	2	42	0	0
6	21861490	.	C	A	2	23	25	0	15	40	0	0
6	21861590	.	G	T	9	4	13	0	0	13	0	0
6	21861725	.	A	T	8	2	10	0	1	11	0	0
6	21861736	.	T	G	4	6	10	0	1	11	0	0
6	21862054	.	C	A	15	16	31	0	1	32	0	0
6	21862158	.	G	C	19	11	30	0	1	31	0	0
6	21862486	.	G	A	23	15	38	1	2	41	0	0
6	21875511	.	T	C	2	2	4	0	0	4	0	0
6	21875691	.	T	C	6	0	6	0	4	10	0	0
6	21875960	.	A	G	2	2	4	0	0	4	0	0
6	21876060	.	G	A	4	2	6	0	0	6	0	0
6	21876131	.	T	A	6	4	10	0	1	11	0	0
6	21876182	.	T	C	5	6	11	0	1	12	0	0
6	21876183	.	T	C	5	7	12	0	0	12	0	0
6	21877981	.	G	A	0	5	5	0	0	5	0	0
6	21878474	.	T	C	7	0	7	0	4	11	0	0
6	21891917	.	T	A	0	0	0	0	1	1	0	0
6	21996194	.	A	C	4	10	14	0	0	14	0	0
6	21996281	.	C	A	5	2	7	0	0	7	0	0
6	21996452	.	C	A	4	7	11	0	0	11	0	0
6	21999860	.	A	T	1	2	3	0	0	3	0	0
6	22007420	.	G	A	2	2	4	0	0	4	0	0
6	22026088	.	A	G	2	0	2	0	5	7	0	0
6	22026339	.	T	A	3	6	9	0	2	11	0	0
6	22026431	.	G	C	1	8	9	0	1	10	0	0
6	22026440	.	G	A	2	8	10	0	1	11	0	0
6	22026636	.	A	G	1	5	6	0	0	6	0	0
6	22026645	.	A	C	3	5	8	0	0	8	0	0
6	22026825	.	C	A	3	2	5	0	0	5	0	0
6	22027263	.	A	G	6	0	6	0	4	10	0	0
6	22028009	.	A	T	2	2	4	0	0	4	0	0
6	22034802	.	A	G	7	2	9	0	0	9	0	0
6	22034961	.	A	C	8	7	15	0	3	18	0	0
6	22035222	.	G	A	0	10	10	0	14	24	0	0
6	22035426	.	A	G	8	12	20	0	0	20	0	0
6	22035519	.	G	A	6	9	15	0	0	15	0	0
6	22037517	.	A	G	5	0	5	0	5	10	0	0
6	22037553	.	G	A	7	7	14	0	2	16	0	0
6	22037565	.	A	G	9	1	10	0	7	17	0	0
6	22037625	.	C	T	6	4	10	0	0	10	0	0
6	22048636	.	A	G	4	4	8	0	0	8	0	0
6	22053067	.	C	T	4	2	6	0	0	6	0	0
6	22055545	.	A	G	5	3	8	0	0	8	0	0
6	22058288	.	G	A	0	2	2	0	0	2	0	0
6	22058321	.	G	C	0	3	3	0	0	3	0	0
6	22078734	.	C	T	0	1	1	0	0	1	0	0
6	22078752	.	G	A	0	2	2	0	0	2	0	0
6	22079075	.	A	C	3	1	4	0	0	4	0	0
6	22082074	.	G	A	1	2	3	0	0	3	0	0
6	22085645	.	G	A	0	3	3	0	0	3	0	0
6	22085651	.	A	G	0	3	3	0	0	3	0	0
6	22085711	.	C	T	4	4	8	0	0	8	0	0
6	22088129	.	G	A	3	1	4	0	0	4	0	0
6	22088135	.	G	A	3	1	4	0	0	4	0	0
6	22093528	.	T	C	1	1	2	0	0	2	0	0
6	22093674	.	T	A	1	2	3	0	0	3	0	0
6	22093707	.	A	G	1	2	3	0	0	3	0	0
6	22093722	.	A	G	1	0	1	0	0	1	0	0
6	22099448	.	C	T	3	1	4	0	0	4	0	0
6	22102090	.	T	A	2	2	4	0	0	4	0	0
6	22102195	.	C	T	1	2	3	0	0	3	0	0
6	22105061	.	G	C	4	10	14	0	0	14	0	0
6	22105118	.	A	T	3	6	9	0	0	9	0	0
6	22105135	.	C	A	0	3	3	0	0	3	0	0
6	22105289	.	T	G	1	2	3	0	0	3	0	0
6	22107277	.	C	T	2	3	5	0	1	6	0	0
6	22107813	.	T	G	7	0	7	0	6	13	0	0
6	22107858	.	C	T	2	2	4	0	0	4	0	0
6	22108307	.	C	A	7	1	8	0	1	9	0	0
6	22109552	.	T	G	6	0	6	0	1	7	0	0
6	22109678	.	A	T	4	1	5	0	2	7	0	0
6	22111594	.	A	G	13	17	30	0	2	32	0	0
6	22112416	.	C	T	5	2	7	0	0	7	0	0
6	22118497	.	G	C	12	16	28	0	1	29	0	0
6	22118630	.	G	A	21	15	36	0	3	39	0	0
6	22118681	.	C	T	17	12	29	0	1	30	0	0
6	22119201	.	T	A	8	6	14	0	2	16	0	0
6	22119241	.	A	T	6	9	15	0	1	16	0	0
6	22119376	.	A	C	8	15	23	0	1	24	0	0
6	22119516	.	T	C	17	25	42	0	3	45	0	0
6	22119582	.	T	C	25	12	37	0	0	37	0	0
6	22119668	.	T	C	1	5	6	0	0	6	0	0
6	22119836	.	T	A	6	4	10	0	0	10	0	0
6	22119977	.	T	A	5	10	15	0	0	16	1	0
6	22120342	.	T	A	3	6	9	0	0	9	0	0
6	22120445	.	A	G	8	8	16	0	2	18	0	0
6	22127270	.	C	T	5	8	13	0	0	13	0	0
6	22327331	.	T	C	1	1	2	0	1	3	0	0
6	22328821	.	A	G	5	0	5	0	5	10	0	0
6	22333884	.	A	T	2	4	6	0	0	6	0	0
6	22344452	.	C	T	6	10	16	0	0	16	0	0
6	22351692	.	T	C	21	25	46	0	2	48	0	0
6	22351727	.	T	C	27	25	52	0	0	52	0	0
6	22351770	.	A	C	24	21	45	0	0	45	0	0
6	22351780	.	T	A	23	17	40	0	3	43	0	0
6	22352229	.	T	C	9	9	18	0	0	18	0	0
6	22352370	.	C	T	6	10	16	0	1	17	0	0
6	22352539	.	C	T	8	27	35	0	0	35	0	0
6	22354759	.	A	G	2	1	3	0	0	3	0	0
6	22364151	.	T	C	3	5	8	0	0	8	0	0
6	22463151	.	A	G	0	1	1	0	0	1	0	0
6	22463346	.	C	T	1	2	3	0	0	3	0	0
6	22597503	.	G	A	11	15	26	0	2	28	0	0
6	22615546	.	G	A	7	21	28	0	1	29	0	0
6	22628073	.	T	G	11	11	22	0	1	23	0	0
6	22628112	.	A	G	9	10	19	0	0	19	0	0
6	22628483	.	G	A	0	11	11	0	21	32	0	0
6	22628779	.	T	C	17	18	35	0	2	37	0	0
6	22628997	.	T	G	3	1	4	0	4	8	0	0
6	22629099	.	A	T	9	6	15	0	1	16	0	0
6	22629182	.	A	G	0	2	2	0	0	2	0	0
6	22966966	.	C	A	2	1	3	0	0	3	0	0
6	23010648	.	C	T	1	2	3	0	0	3	0	0
6	23010673	.	G	A	2	2	4	0	0	4	0	0
6	23010748	.	T	C	1	2	3	0	0	3	0	0
6	23010957	.	G	A	3	2	5	0	0	5	0	0
6	23010975	.	A	C	3	2	5	0	0	5	0	0
6	23010996	.	T	A	1	2	3	0	0	3	0	0
6	23042113	.	G	T	0	0	0	0	1	1	0	0
6	23053129	.	C	T	4	5	9	0	0	9	0	0
6	23053296	.	A	G	7	3	10	0	1	11	0	0
6	23053374	.	G	A	0	15	15	0	8	23	0	0
6	23053482	.	G	C	9	6	15	0	0	15	0	0
6	23053761	.	A	G	5	11	16	0	2	18	0	0
6	23053980	.	A	T	10	13	23	0	1	24	0	0
6	23054266	.	C	T	10	11	21	0	0	21	0	0
6	23054267	.	A	G	11	4	15	0	6	21	0	0
6	23054569	.	C	T	4	9	13	0	1	14	0	0
6	23054705	.	A	G	5	0	5	0	4	9	0	0
6	23137335	.	T	A	6	2	8	0	0	8	0	0
6	23617815	.	C	T	5	4	9	0	0	9	0	0
6	23752615	.	G	A	0	7	7	0	4	11	0	0
6	23781314	.	C	T	5	10	15	0	0	15	0	0
6	23810518	.	T	C	5	2	7	0	0	7	0	0
6	23810922	.	G	C	3	5	8	0	0	8	0	0
6	23811154	.	C	T	11	12	23	0	0	23	0	0
6	23812768	.	T	A	8	5	13	0	0	13	0	0
6	23812771	.	C	G	8	5	13	0	1	14	0	0
6	23812885	.	T	C	21	11	32	0	0	32	0	0
6	23813554	.	C	A	23	19	42	0	2	44	0	0
6	23813767	.	C	A	13	29	42	0	0	42	0	0
6	23938676	.	A	C	6	8	14	0	0	14	0	0
6	23938738	.	A	G	4	12	16	0	1	17	0	0
6	24055743	.	T	A	9	8	17	0	0	17	0	0
6	24055784	.	G	A	7	10	17	0	1	18	0	0
6	24055866	.	G	T	9	5	14	0	0	15	1	0
6	24056103	.	C	T	0	7	7	0	6	13	0	0
6	24065975	.	C	G	0	2	2	0	1	3	0	0
6	24066253	.	T	C	9	0	9	0	9	18	0	0
6	24066345	.	A	G	5	12	17	0	1	18	0	0
6	24066382	.	T	A	5	12	17	0	2	19	0	0
6	24066547	.	C	T	0	5	5	0	9	14	0	0
6	24066575	.	T	C	9	8	17	0	1	18	0	0
6	24066662	.	A	T	0	5	5	0	0	5	0	0
6	24096675	.	G	A	0	1	1	0	0	1	0	0
6	24153159	.	C	T	15	16	31	0	1	32	0	0
6	24155442	.	A	T	17	13	30	0	0	31	1	0
6	24155744	.	T	C	14	9	23	0	1	24	0	0
6	24155766	.	T	C	10	12	22	0	1	23	0	0
6	24155886	.	A	C	9	0	9	0	10	19	0	0
6	24155898	.	C	T	8	7	15	0	0	15	0	0
6	24156027	.	T	C	22	18	40	0	0	40	0	0
6	24156344	.	T	G	13	9	22	0	1	23	0	0
6	24156399	.	C	G	14	11	25	0	0	25	0	0
6	24156428	.	A	T	9	11	20	0	0	20	0	0
6	24156476	.	T	G	4	10	14	0	1	15	0	0
6	24156486	.	A	C	10	5	15	0	0	15	0	0
6	24156567	.	T	C	12	0	12	0	13	25	0	0
6	24157177	.	C	T	5	5	10	0	0	10	0	0
6	24158601	.	T	C	5	0	5	0	20	25	0	0
6	24161409	.	G	A	8	16	24	0	0	24	0	0
6	24163420	.	T	C	1	2	3	0	0	3	0	0
6	24163448	.	C	T	1	4	5	0	0	5	0	0
6	24163505	.	C	T	3	1	4	0	1	5	0	0
6	24163535	.	A	C	0	3	3	0	0	3	0	0
6	24163543	.	T	C	0	2	2	0	0	2	0	0
6	24203928	.	C	T	2	3	5	0	0	5	0	0
6	24338496	.	T	A	12	20	32	0	1	33	0	0
6	24338526	.	G	A	13	7	20	0	0	20	0	0
6	24358326	.	G	A	4	13	17	0	5	22	0	0
6	24358596	.	G	A	2	5	7	0	2	9	0	0
6	24358608	.	T	A	7	3	10	0	1	11	0	0
6	24365205	.	T	A	4	4	8	0	0	8	0	0
6	24365482	.	C	A	5	3	8	0	0	8	0	0
6	24370637	.	C	T	5	4	9	0	1	10	0	0
6	24370646	.	T	C	6	5	11	0	0	11	0	0
6	24379802	.	T	G	4	2	6	0	0	6	0	0
6	24379865	.	G	A	16	8	24	0	0	24	0	0
6	24380335	.	C	A	5	7	12	0	2	14	0	0
6	24384613	.	T	C	4	8	12	0	0	12	0	0
6	24389518	.	A	T	1	2	3	0	0	3	0	0
6	24392318	.	C	T	7	8	15	0	0	15	0	0
6	24392562	.	T	C	5	0	5	0	3	8	0	0
6	24392674	.	G	T	3	5	8	0	0	8	0	0
6	24392732	.	T	C	4	2	6	0	0	6	0	0
6	24392837	.	T	C	2	2	4	0	0	4	0	0
6	24681047	.	C	T	4	4	8	0	0	8	0	0
6	24681529	.	C	T	11	7	18	0	1	19	0	0
6	24682165	.	G	C	4	4	8	0	1	9	0	0
6	24682721	.	C	T	10	7	17	0	0	18	1	0
6	24682759	.	G	T	9	8	17	0	0	17	0	0
6	24682925	.	T	C	2	4	6	0	0	6	0	0
6	24683354	.	C	T	5	5	10	0	0	10	0	0
6	24683723	.	A	T	6	5	11	0	1	12	0	0
6	24683854	.	A	G	5	0	5	0	3	8	0	0
6	24697940	.	G	C	5	7	12	0	0	12	0	0
6	24698036	.	A	G	4	0	4	0	4	8	0	0
6	24818037	.	G	T	4	2	6	0	0	6	0	0
6	24818240	.	C	A	6	8	14	0	2	16	0	0
6	24818312	.	C	G	11	13	24	0	1	25	0	0
6	25168647	.	G	C	3	2	5	0	1	6	0	0
6	25169277	.	C	T	0	2	2	0	3	5	0	0
6	25170438	.	T	C	6	11	17	0	0	17	0	0
6	25170579	.	A	G	3	5	8	0	0	8	0	0
6	25170743	.	G	A	2	4	6	0	0	6	0	0
6	25171078	.	T	A	1	5	6	0	0	6	0	0
6	25171100	.	A	G	5	2	7	0	0	7	0	0
6	25171285	.	A	G	6	6	12	0	0	12	0	0
6	25171940	.	A	G	3	4	7	0	0	7	0	0
6	25173005	.	G	A	6	4	10	0	0	10	0	0
6	25173026	.	A	G	7	3	10	0	0	10	0	0
6	25174178	.	T	C	1	0	1	0	2	3	0	0
6	25261426	.	T	A	5	3	8	0	0	8	0	0
6	25265306	.	G	A	2	2	4	0	0	4	0	0
6	25315051	.	A	G	1	4	5	0	0	5	0	0
6	25933917	.	T	C	17	0	17	0	17	34	0	0
6	25934214	.	A	G	16	11	27	0	2	33	4	0
6	25934313	.	A	T	13	11	24	0	1	25	0	0
6	26065499	.	A	C	6	4	10	0	0	10	0	0
6	26065508	.	C	A	0	5	5	0	6	11	0	0
6	26066097	.	A	T	2	0	2	0	0	2	0	0
6	26080187	.	A	G	5	5	10	0	0	10	0	0
6	26080352	.	C	T	1	2	3	0	0	3	0	0
6	26225456	.	G	A	4	5	9	0	0	9	0	0
6	26225479	.	T	G	3	7	10	0	0	10	0	0
6	26225657	.	G	C	8	3	11	0	0	11	0	0
6	26225700	.	A	G	0	3	3	0	0	3	0	0
6	26558837	.	C	T	0	13	13	0	17	30	0	0
6	26558927	.	C	T	0	20	20	0	11	31	0	0
6	26559179	.	T	C	14	1	15	0	22	37	0	0
6	26559780	.	A	G	16	8	24	0	1	25	0	0
6	26559807	.	A	G	18	12	30	0	0	30	0	0
6	26875804	.	C	A	5	16	21	0	0	21	0	0
6	26875944	.	T	A	19	13	32	0	2	34	0	0
6	26878802	.	G	A	0	3	3	0	0	3	0	0
6	26879486	.	G	T	9	6	15	0	0	15	0	0
6	26879510	.	T	C	8	3	11	0	0	11	0	0
6	26883895	.	T	G	3	8	11	0	0	11	0	0
6	26891891	.	A	G	7	5	12	0	1	13	0	0
6	27038198	.	G	A	5	4	9	0	0	9	0	0
6	27038507	.	A	T	4	3	7	0	0	7	0	0
6	27041723	.	C	G	2	2	4	0	0	4	0	0
6	27041886	.	T	C	7	9	16	0	0	16	0	0
6	27041988	.	C	T	3	1	4	0	0	4	0	0
6	27045205	.	G	A	11	9	20	0	0	20	0	0
6	27045238	.	A	G	5	3	8	0	0	8	0	0
6	27045424	.	T	C	0	0	0	0	1	1	0	0
6	27048800	.	T	A	8	6	14	0	1	15	0	0
6	27048976	.	A	G	5	6	11	0	2	13	0	0
6	27051710	.	G	A	3	2	5	0	0	5	0	0
6	27051749	.	C	T	4	10	14	0	1	15	0	0
6	27051836	.	G	A	2	4	6	0	0	6	0	0
6	27055569	.	T	C	2	2	4	0	0	4	0	0
6	27057438	.	A	G	1	3	4	0	0	4	0	0
6	27057561	.	A	G	8	10	18	0	0	18	0	0
6	27057586	.	T	C	10	9	19	0	0	19	0	0
6	27057598	.	A	T	9	11	20	0	0	20	0	0
6	27063155	.	T	A	0	1	1	0	0	1	0	0
6	27063158	.	G	A	0	1	1	0	0	1	0	0
6	27067473	.	G	A	2	1	3	0	0	3	0	0
6	27087515	.	T	A	5	3	8	0	0	8	0	0
6	27087776	.	A	G	4	3	7	0	0	7	0	0
6	27087788	.	C	T	4	2	6	0	0	6	0	0
6	27087827	.	A	T	3	3	6	0	1	7	0	0
6	27087843	.	A	G	3	3	6	0	0	6	0	0
6	27088076	.	G	C	14	5	19	0	0	19	0	0
6	27088260	.	A	G	4	3	7	0	1	8	0	0
6	27099004	.	T	C	3	1	4	0	0	4	0	0
6	27104458	.	G	C	8	6	14	0	0	14	0	0
6	27104584	.	T	C	13	12	25	0	1	26	0	0
6	27104898	.	A	T	4	3	7	0	1	8	0	0
6	27104906	.	C	G	4	3	7	0	0	7	0	0
6	27106554	.	G	A	1	2	3	0	0	3	0	0
6	27106952	.	A	G	1	0	1	0	0	1	0	0
6	27108716	.	T	A	2	2	4	0	0	4	0	0
6	27146872	.	C	T	10	5	15	0	1	16	0	0
6	27146902	.	C	T	5	8	13	0	1	14	0	0
6	27146933	.	C	T	7	4	11	0	0	11	0	0
6	27146992	.	T	C	3	5	8	0	1	9	0	0
6	27216458	.	T	A	1	0	1	0	0	1	0	0
6	27220245	.	C	T	11	6	17	0	0	17	0	0
6	27231706	.	G	A	0	3	3	0	3	6	0	0
6	27233775	.	G	A	0	13	13	0	8	21	0	0
6	27234032	.	T	G	7	3	10	0	1	11	0	0
6	27234250	.	C	T	1	5	6	0	1	7	0	0
6	27259107	.	T	A	5	8	13	0	1	14	0	0
6	27260541	.	A	G	14	0	14	0	8	22	0	0
6	27265434	.	C	T	0	2	2	0	0	2	0	0
6	27269862	.	G	A	0	24	24	0	14	38	0	0
6	27269873	.	C	T	26	10	36	0	0	36	0	0
6	27269902	.	T	A	11	16	27	0	1	28	0	0
6	27270548	.	G	A	16	14	30	0	1	31	0	0
6	27270738	.	A	G	15	1	16	0	15	31	0	0
6	27270959	.	C	A	10	9	19	0	1	20	0	0
6	27271352	.	G	A	3	10	13	0	18	31	0	0
6	27271355	.	C	T	20	10	30	0	0	30	0	0
6	27271390	.	T	A	13	17	30	0	0	31	1	0
6	27271409	.	G	A	19	15	34	0	1	35	0	0
6	27271443	.	G	A	25	20	45	0	2	47	0	0
6	27271498	.	C	T	14	28	42	0	1	43	0	0
6	27271543	.	C	T	14	18	32	0	1	33	0	0
6	27271610	.	A	T	18	9	27	0	2	29	0	0
6	27271617	.	G	A	20	10	30	0	1	31	0	0
6	27272205	.	G	C	19	19	38	0	0	38	0	0
6	27272440	.	C	T	16	17	33	0	2	35	0	0
6	27272487	.	A	T	21	7	28	0	0	28	0	0
6	27272488	.	T	C	21	4	25	0	3	28	0	0
6	27272623	.	A	G	17	33	50	0	4	54	0	0
6	27272660	.	C	G	17	27	44	0	1	45	0	0
6	27272835	.	G	T	15	14	29	0	0	29	0	0
6	27277994	.	C	T	0	1	1	0	0	1	0	0
6	27284678	.	G	A	0	2	2	0	1	3	0	0
6	27431926	.	A	G	2	0	2	0	2	4	0	0
6	27445553	.	C	A	2	4	6	0	0	6	0	0
6	27449472	.	T	G	3	2	5	0	0	5	0	0
6	27449502	.	C	T	0	2	2	0	0	2	0	0
6	27574439	.	C	G	3	4	7	0	1	8	0	0
6	27574472	.	G	A	1	1	2	0	0	2	0	0
6	27613633	.	C	T	2	1	3	0	0	3	0	0
6	27614989	.	A	T	5	3	8	0	0	8	0	0
6	27614993	.	T	C	5	3	8	0	0	8	0	0
6	27664264	.	G	T	1	2	3	0	0	3	0	0
6	27664368	.	T	A	2	3	5	0	0	5	0	0
6	27667415	.	A	C	17	28	45	0	3	48	0	0
6	27874674	.	T	C	8	17	25	0	2	27	0	0
6	27874680	.	C	G	10	19	29	0	0	29	0	0
6	27874730	.	A	G	7	0	7	0	13	20	0	0
6	27874753	.	G	C	1	7	8	0	6	14	0	0
6	27874769	.	T	A	9	5	14	0	1	15	0	0
6	27874896	.	T	A	12	19	31	0	0	31	0	0
6	27875309	.	T	C	23	21	44	0	2	46	0	0
6	27875383	.	G	T	20	28	48	0	1	49	0	0
6	27875519	.	G	T	24	31	55	0	2	57	0	0
6	27875598	.	T	C	0	27	27	0	0	27	0	0
6	27875600	.	A	C	27	0	27	0	0	27	0	0
6	27875873	.	A	G	17	29	46	0	0	46	0	0
6	27876060	.	T	A	28	25	53	0	1	54	0	0
6	27876134	.	C	T	28	20	48	0	1	49	0	0
6	27884952	.	G	A	5	2	7	0	0	7	0	0
6	27922335	.	G	A	1	2	3	0	0	3	0	0
6	27925037	.	C	T	3	3	6	0	0	6	0	0
6	27993450	.	A	T	7	4	11	0	0	11	0	0
6	27997333	.	C	T	1	3	4	0	1	5	0	0
6	27997528	.	A	G	1	4	5	0	0	5	0	0
6	27998329	.	C	A	0	1	1	0	1	2	0	0
6	27999396	.	G	C	2	3	5	0	0	5	0	0
6	27999645	.	C	T	2	4	6	0	0	6	0	0
6	27999744	.	A	C	5	7	12	0	1	13	0	0
6	28000242	.	T	A	13	7	20	0	0	20	0	0
6	28000316	.	G	A	0	5	5	0	9	14	0	0
6	28000597	.	A	C	3	3	6	0	1	7	0	0
6	28000768	.	G	T	11	2	13	0	1	14	0	0
6	28031468	.	G	A	2	0	2	0	0	2	0	0
6	28031474	.	T	C	2	0	2	0	0	2	0	0
6	28033221	.	T	A	4	2	6	0	1	7	0	0
6	28036311	.	C	T	1	4	5	0	0	5	0	0
6	28039034	.	C	T	11	7	18	0	0	18	0	0
6	28039175	.	T	A	4	2	6	0	0	6	0	0
6	28041161	.	G	A	0	3	3	0	9	12	0	0
6	28048870	.	C	T	3	1	4	0	0	4	0	0
6	28048923	.	C	A	3	5	8	0	1	9	0	0
6	28124454	.	C	T	3	2	5	0	0	5	0	0
6	28124470	.	A	G	3	0	3	0	2	5	0	0
6	28124936	.	C	T	5	3	8	0	0	8	0	0
6	28125286	.	A	C	7	6	13	0	0	13	0	0
6	28206442	.	G	A	0	1	1	0	0	1	0	0
6	28207340	.	C	T	2	6	8	0	0	8	0	0
6	28207418	.	C	G	7	17	24	0	0	24	0	0
6	28207532	.	C	A	4	3	7	0	1	8	0	0
6	28207534	.	A	G	4	4	8	0	0	8	0	0
6	28208187	.	A	G	1	2	3	0	1	4	0	0
6	28209026	.	T	G	1	3	4	0	0	4	0	0
6	28217596	.	C	T	0	10	10	0	9	19	0	0
6	28218159	.	G	T	2	8	10	0	1	11	0	0
6	28218555	.	T	G	7	7	14	0	0	14	0	0
6	28224044	.	T	A	1	3	4	0	0	4	0	0
6	28224157	.	C	A	1	2	3	0	0	3	0	0
6	28224158	.	A	T	1	2	3	0	0	3	0	0
6	28224481	.	A	T	0	2	2	0	0	2	0	0
6	28913682	.	C	A	1	3	4	0	0	4	0	0
6	28914331	.	A	G	7	3	10	0	0	10	0	0
6	28914336	.	C	T	4	7	11	0	1	12	0	0
6	28914418	.	A	G	13	13	26	0	0	26	0	0
6	28914523	.	G	A	13	12	25	0	0	25	0	0
6	28914571	.	T	A	15	11	26	0	0	26	0	0
6	28914886	.	G	A	9	10	19	0	0	19	0	0
6	28914975	.	T	A	9	14	23	0	0	23	0	0
6	28923667	.	G	A	2	0	2	0	0	2	0	0
6	28926540	.	C	T	3	4	7	0	0	7	0	0
6	28926567	.	T	A	7	7	14	0	0	14	0	0
6	28931184	.	C	T	3	5	8	0	0	8	0	0
6	28932634	.	G	A	1	4	5	0	0	5	0	0
6	28946199	.	T	G	14	17	31	0	1	32	0	0
6	28956323	.	A	G	11	13	24	0	1	25	0	0
6	28957089	.	G	A	8	3	11	0	0	11	0	0
6	28957814	.	C	G	2	7	9	0	0	9	0	0
6	28961407	.	A	G	3	4	7	0	1	8	0	0
6	29011988	.	C	T	9	7	16	0	1	17	0	0
6	29012037	.	A	T	5	8	13	0	0	13	0	0
6	29034576	.	G	C	9	7	16	0	0	16	0	0
6	29040789	.	C	T	0	4	4	0	2	6	0	0
6	29040885	.	C	T	0	4	4	0	2	6	0	0
6	29043162	.	T	G	0	4	4	0	0	4	0	0
6	29043673	.	G	A	2	4	6	0	1	7	0	0
6	29044465	.	A	G	1	0	1	0	0	1	0	0
6	29044900	.	G	A	4	4	8	0	0	8	0	0
6	29044933	.	A	G	2	3	5	0	0	5	0	0
6	29086613	.	C	T	1	5	6	0	0	6	0	0
6	29087164	.	T	G	1	0	1	0	0	1	0	0
6	29096659	.	A	C	6	10	16	0	4	20	0	0
6	29097297	.	G	A	32	17	49	0	2	51	0	0
6	29097344	.	T	C	10	7	17	0	5	22	0	0
6	29097384	.	G	A	2	2	4	0	0	4	0	0
6	29103005	.	G	A	2	3	5	0	0	5	0	0
6	29103419	.	G	A	4	6	10	0	0	10	0	0
6	29105698	.	C	T	2	7	9	0	0	9	0	0
6	29108423	.	T	G	1	0	1	0	0	1	0	0
6	29143365	.	A	T	3	1	4	0	0	4	0	0
6	29144951	.	T	A	5	3	8	0	1	9	0	0
6	29144952	.	A	T	7	2	9	0	0	9	0	0
6	29145433	.	C	A	0	11	11	0	4	15	0	0
6	29145742	.	T	A	6	5	11	0	1	12	0	0
6	29152208	.	C	T	3	5	8	0	0	8	0	0
6	29152618	.	A	G	1	1	2	0	0	2	0	0
6	29152819	.	C	T	4	6	10	0	0	10	0	0
6	29154280	.	T	A	7	3	10	0	0	10	0	0
6	29154295	.	T	C	5	0	5	0	5	10	0	0
6	29154520	.	C	T	3	7	10	0	0	10	0	0
6	29154721	.	G	A	3	2	5	0	0	5	0	0
6	29154889	.	C	A	4	7	11	0	0	11	0	0
6	29155039	.	G	A	4	3	7	0	0	7	0	0
6	29156522	.	T	C	5	6	11	0	0	11	0	0
6	29221040	.	C	T	7	4	11	0	0	11	0	0
6	29222796	.	A	C	13	8	21	0	1	22	0	0
6	29223651	.	T	C	5	9	14	0	1	15	0	0
6	29226126	.	G	A	0	9	9	0	15	24	0	0
6	29226186	.	A	G	16	14	30	0	0	30	0	0
6	29226189	.	C	T	15	13	28	0	2	30	0	0
6	29226767	.	A	T	11	12	23	0	1	24	0	0
6	29226790	.	G	A	19	11	30	0	0	30	0	0
6	29226823	.	A	C	16	8	24	0	0	24	0	0
6	29273855	.	G	A	5	0	5	0	0	5	0	0
6	29278868	.	T	G	0	4	4	0	0	4	0	0
6	29278874	.	G	A	0	6	6	0	0	6	0	0
6	29289386	.	G	A	0	2	2	0	1	3	0	0
6	29289411	.	G	A	0	1	1	0	2	3	0	0
6	29289437	.	G	A	1	3	4	0	0	4	0	0
6	29289844	.	A	T	2	5	7	0	0	7	0	0
6	29289883	.	C	T	2	5	7	0	1	8	0	0
6	29291666	.	G	A	2	6	8	0	0	8	0	0
6	29292447	.	T	C	3	2	5	0	0	5	0	0
6	29292610	.	A	C	3	2	5	0	0	5	0	0
6	29292651	.	A	G	4	3	7	0	0	7	0	0
6	29292728	.	C	T	1	9	10	0	0	10	0	0
6	29292780	.	G	A	8	3	11	0	0	11	0	0
6	29295492	.	T	A	8	10	18	0	0	18	0	0
6	29295517	.	G	C	12	9	21	0	0	21	0	0
6	29295535	.	T	A	10	10	20	0	2	22	0	0
6	29295713	.	C	A	9	10	19	0	0	19	0	0
6	29295714	.	G	A	10	9	19	0	0	19	0	0
6	29295851	.	G	A	6	3	9	0	2	11	0	0
6	29295860	.	C	T	6	2	8	0	2	10	0	0
6	29303573	.	C	T	10	4	14	0	1	15	0	0
6	29303625	.	G	A	4	5	9	0	1	10	0	0
6	29303630	.	G	A	6	4	10	0	1	11	0	0
6	29303778	.	C	T	1	10	11	0	11	22	0	0
6	29303925	.	C	T	3	4	7	0	1	8	0	0
6	29303958	.	C	T	0	1	1	0	0	1	0	0
6	29322547	.	G	A	2	3	5	0	0	5	0	0
6	29328308	.	G	A	3	4	7	0	2	9	0	0
6	29328524	.	A	G	4	10	14	0	0	14	0	0
6	29328866	.	G	A	2	2	4	0	0	4	0	0
6	29330676	.	G	A	7	5	12	0	0	12	0	0
6	29330727	.	A	G	5	3	8	0	0	8	0	0
6	29332546	.	A	T	0	1	1	0	0	1	0	0
6	29337926	.	A	G	1	2	3	0	0	3	0	0
6	29343892	.	G	A	2	5	7	0	1	8	0	0
6	29348152	.	T	A	1	2	3	0	0	3	0	0
6	29393714	.	C	T	1	1	2	0	0	2	0	0
6	29395424	.	G	A	7	10	17	0	1	19	1	0
6	29395497	.	T	A	7	7	14	0	0	14	0	0
6	29395577	.	T	G	2	2	4	0	1	5	0	0
6	29395583	.	T	G	2	3	5	0	0	5	0	0
6	29397697	.	G	A	4	6	10	0	0	10	0	0
6	29401837	.	T	C	2	4	6	0	0	6	0	0
6	29402451	.	C	A	0	3	3	0	7	10	0	0
6	29403052	.	G	T	0	8	8	0	20	28	0	0
6	29403076	.	C	T	12	23	35	0	0	35	0	0
6	29410040	.	C	T	0	5	5	0	0	5	0	0
6	29441055	.	G	A	0	2	2	0	1	3	0	0
6	29466478	.	T	G	1	0	1	0	3	4	0	0
6	29467644	.	A	G	1	2	3	0	0	3	0	0
6	29468320	.	C	T	5	4	9	0	1	10	0	0
6	29468331	.	A	T	7	4	11	0	0	11	0	0
6	29468551	.	A	T	3	3	6	0	0	6	0	0
6	29468556	.	T	G	2	3	5	0	0	5	0	0
6	29477526	.	C	T	2	4	6	0	0	6	0	0
6	29477739	.	C	T	3	4	7	0	0	7	0	0
6	29477962	.	C	T	1	2	3	0	1	4	0	0
6	29477989	.	C	T	0	0	0	0	2	2	0	0
6	29611994	.	T	A	2	2	4	0	1	5	0	0
6	29705343	.	C	T	5	2	7	0	1	8	0	0
6	29705561	.	A	T	5	15	20	0	3	23	0	0
6	29705614	.	G	A	3	12	15	0	1	16	0	0
6	29708100	.	C	T	3	5	8	0	0	8	0	0
6	29710252	.	T	C	3	6	9	0	0	9	0	0
6	29713920	.	G	T	9	3	12	0	0	12	0	0
6	29713926	.	T	C	9	5	14	0	0	14	0	0
6	29714017	.	A	G	6	6	12	0	0	12	0	0
6	29714054	.	A	C	2	3	5	0	0	5	0	0
6	29714064	.	C	T	2	3	5	0	1	6	0	0
6	29714123	.	C	T	1	2	3	0	0	3	0	0
6	29714128	.	C	T	1	4	5	0	0	5	0	0
6	29714190	.	A	G	1	3	4	0	1	5	0	0
6	29793814	.	C	T	9	12	21	0	2	23	0	0
6	29794003	.	T	G	9	6	15	0	0	15	0	0
6	29794042	.	G	A	6	7	13	0	2	15	0	0
6	29794695	.	T	C	30	29	59	0	1	60	0	0
6	30027896	.	C	A	7	8	15	0	2	17	0	0
6	30032574	.	A	G	8	0	8	0	13	21	0	0
6	30048285	.	A	G	5	0	5	0	6	11	0	0
6	30052061	.	C	A	9	10	19	0	0	19	0	0
6	30052085	.	A	G	7	5	12	0	0	12	0	0
6	30060296	.	C	T	18	18	36	0	2	38	0	0
6	30081420	.	C	T	13	12	25	0	3	28	0	0
6	30081421	.	T	C	16	9	25	0	3	28	0	0
6	30081503	.	A	G	24	15	39	0	3	42	0	0
6	30081725	.	C	T	12	24	36	0	1	37	0	0
6	30082838	.	G	T	6	12	18	0	0	18	0	0
6	30124575	.	C	T	8	17	25	0	2	27	0	0
6	30133958	.	G	T	14	14	28	0	5	33	0	0
6	30147249	.	T	C	11	1	12	0	11	23	0	0
6	30148182	.	G	A	9	9	18	0	1	19	0	0
6	30148422	.	C	T	17	14	31	0	0	31	0	0
6	30148863	.	T	C	9	9	18	0	0	18	0	0
6	30151519	.	G	A	13	9	22	0	0	22	0	0
6	30151537	.	G	A	14	12	26	0	0	26	0	0
6	30160956	.	C	T	13	12	25	0	1	26	0	0
6	30177635	.	G	A	1	5	6	0	0	6	0	0
6	30177742	.	T	C	0	1	1	0	0	1	0	0
6	30432533	.	T	G	3	3	6	0	0	6	0	0
6	30433029	.	T	C	1	1	2	0	1	3	0	0
6	30433053	.	C	T	2	2	4	0	0	4	0	0
6	30433069	.	G	A	2	2	4	0	0	4	0	0
6	30433337	.	T	A	1	3	4	0	0	4	0	0
6	30434201	.	G	A	4	3	7	0	0	7	0	0
6	30440099	.	A	C	5	6	11	0	0	11	0	0
6	30441536	.	G	A	2	2	4	0	0	4	0	0
6	30441762	.	G	A	1	3	4	0	0	4	0	0
6	30450458	.	T	C	3	6	9	0	1	10	0	0
6	30452540	.	T	G	4	0	4	0	5	9	0	0
6	30452573	.	C	T	3	3	6	0	1	7	0	0
6	30452669	.	A	T	3	5	8	0	0	8	0	0
6	30452932	.	G	C	3	3	6	0	0	6	0	0
6	30579371	.	A	T	1	3	4	0	0	4	0	0
6	30583746	.	A	G	3	0	3	0	0	3	0	0
6	30583815	.	A	G	4	3	7	0	1	8	0	0
6	30592556	.	T	C	2	1	3	0	1	4	0	0
6	30592558	.	A	T	1	2	3	0	1	4	0	0
6	30592804	.	T	A	2	2	4	0	0	4	0	0
6	30626630	.	T	G	7	8	15	0	0	15	0	0
6	30626931	.	T	C	6	3	9	0	0	9	0	0
6	30627182	.	T	A	7	10	17	0	1	18	0	0
6	30627228	.	A	C	15	15	30	0	1	31	0	0
6	30627549	.	G	A	11	9	20	0	0	20	0	0
6	30627674	.	G	T	15	5	20	0	1	21	0	0
6	30627764	.	G	T	14	9	23	0	0	23	0	0
6	30627807	.	G	T	8	8	16	0	1	17	0	0
6	30627811	.	T	C	7	8	15	0	1	16	0	0
6	30628066	.	T	C	4	9	13	0	0	13	0	0
6	30628097	.	C	T	9	5	14	0	0	14	0	0
6	30628185	.	G	A	3	7	10	0	1	11	0	0
6	30628447	.	G	A	7	5	12	0	0	12	0	0
6	30628459	.	A	G	6	5	11	0	0	11	0	0
6	30628540	.	T	C	4	0	4	0	7	11	0	0
6	30628651	.	G	A	6	4	10	0	0	10	0	0
6	30628684	.	C	A	6	5	11	0	0	11	0	0
6	30628848	.	C	T	10	12	22	0	0	22	0	0
6	30628976	.	T	A	6	8	14	0	1	15	0	0
6	30628978	.	C	T	8	5	13	0	2	15	0	0
6	30629229	.	T	A	1	4	5	0	0	5	0	0
6	30629278	.	A	G	3	4	7	0	0	7	0	0
6	30629285	.	G	A	3	4	7	0	0	7	0	0
6	30629373	.	A	T	5	2	7	0	0	7	0	0
6	30629384	.	T	C	3	0	3	0	7	10	0	0
6	30629553	.	C	T	0	3	3	1	4	8	0	0
6	30629734	.	A	G	3	4	7	0	0	7	0	0
6	30629827	.	C	A	2	7	9	0	0	9	0	0
6	30629935	.	T	C	0	1	1	0	6	7	0	0
6	30630017	.	C	T	0	5	5	0	4	9	0	0
6	30630057	.	G	A	3	3	6	0	0	6	0	0
6	30630454	.	T	G	6	9	15	0	0	15	0	0
6	30630811	.	T	C	5	10	15	0	0	15	0	0
6	30630904	.	A	G	7	4	11	0	0	11	0	0
6	30658102	.	T	C	6	5	11	0	0	11	0	0
6	30658524	.	T	C	2	3	5	0	0	5	0	0
6	30658545	.	G	A	3	6	9	0	0	9	0	0
6	30677330	.	G	A	2	2	4	0	1	5	0	0
6	30677347	.	G	T	3	3	6	0	1	7	0	0
6	30677475	.	A	G	2	3	5	0	1	6	0	0
6	30677582	.	T	C	2	3	5	0	0	5	0	0
6	30677602	.	A	T	2	5	7	0	0	7	0	0
6	30677646	.	A	G	4	5	9	0	0	9	0	0
6	30677701	.	C	T	0	3	3	0	2	5	0	0
6	30677734	.	A	C	1	0	1	0	1	2	0	0
6	30677920	.	T	A	1	0	1	0	0	1	0	0
6	30678396	.	T	C	4	2	6	0	1	7	0	0
6	30678406	.	C	A	2	4	6	0	0	6	0	0
6	30681208	.	C	T	2	0	2	0	0	2	0	0
6	30681291	.	C	A	1	2	3	0	0	3	0	0
6	30683109	.	G	A	1	1	2	0	0	2	0	0
6	30683127	.	A	G	1	2	3	0	0	3	0	0
6	30683571	.	T	A	2	8	10	0	1	11	0	0
6	30683578	.	T	C	2	8	10	0	0	10	0	0
6	30685027	.	T	C	4	5	9	0	0	9	0	0
6	30685078	.	A	T	5	6	11	0	0	11	0	0
6	30689103	.	A	C	1	2	3	0	0	3	0	0
6	30710313	.	C	A	18	14	32	0	2	34	0	0
6	30710591	.	G	A	2	6	8	0	0	8	0	0
6	30711447	.	C	T	3	7	10	0	0	10	0	0
6	30711485	.	A	T	7	8	15	0	0	15	0	0
6	30711511	.	C	T	11	8	19	0	0	19	0	0
6	30711554	.	C	T	0	9	9	0	10	19	0	0
6	30711586	.	A	C	8	0	8	0	11	19	0	0
6	30711612	.	G	A	12	11	23	0	0	23	0	0
6	30711777	.	C	T	3	9	12	0	0	12	0	0
6	30712121	.	G	T	15	17	32	0	3	35	0	0
6	30712458	.	A	G	9	0	9	0	0	9	0	0
6	30712508	.	G	A	6	8	14	0	1	15	0	0
6	30712616	.	C	T	1	5	6	0	7	13	0	0
6	30712622	.	A	G	7	6	13	0	1	14	0	0
6	30712883	.	A	C	6	7	13	0	0	13	0	0
6	30712917	.	G	A	8	9	17	0	1	18	0	0
6	30713184	.	T	A	9	8	17	0	0	17	0	0
6	30713334	.	G	C	13	7	20	0	1	22	1	0
6	30713341	.	G	A	8	15	23	0	0	23	0	0
6	30713647	.	C	T	5	3	8	0	1	9	0	0
6	30713910	.	C	T	20	13	33	0	2	35	0	0
6	30713929	.	C	G	19	21	40	0	1	41	0	0
6	30714177	.	T	A	9	3	12	0	0	12	0	0
6	30715647	.	A	T	12	7	19	0	1	20	0	0
6	30715865	.	A	T	3	10	13	0	0	13	0	0
6	30719391	.	A	T	4	1	5	0	1	6	0	0
6	30719935	.	C	T	10	5	15	0	1	16	0	0
6	30721397	.	G	A	7	8	15	0	0	15	0	0
6	30740160	.	C	A	1	6	7	0	0	7	0	0
6	30851611	.	A	T	2	2	4	0	0	4	0	0
6	30853053	.	T	A	24	32	56	0	3	59	0	0
6	30855423	.	G	A	5	5	10	0	1	11	0	0
6	30859381	.	T	A	15	13	28	0	2	30	0	0
6	30931362	.	C	T	0	0	0	0	2	2	0	0
6	30931476	.	A	T	1	2	3	0	0	3	0	0
6	30931479	.	T	C	1	0	1	0	2	3	0	0
6	31069622	.	T	A	2	2	4	0	1	5	0	0
6	31146723	.	G	A	3	2	5	0	0	5	0	0
6	31146776	.	T	A	2	3	5	0	1	6	0	0
6	31146849	.	T	C	2	2	4	0	0	4	0	0
6	31146993	.	T	C	6	0	6	0	2	8	0	0
6	31147002	.	A	G	6	2	8	0	0	8	0	0
6	31184478	.	A	G	2	5	7	0	0	7	0	0
6	31184532	.	T	C	5	2	7	0	0	7	0	0
6	31184600	.	T	G	3	3	6	0	0	6	0	0
6	31184880	.	G	A	1	2	3	0	0	3	0	0
6	31184952	.	T	C	3	2	5	0	0	5	0	0
6	31185037	.	T	C	1	2	3	0	1	4	0	0
6	31185074	.	C	T	1	3	4	0	1	5	0	0
6	31185133	.	G	A	5	5	10	0	0	10	0	0
6	31185247	.	C	G	4	6	10	0	0	10	0	0
6	31185457	.	C	T	6	0	6	0	1	7	0	0
6	31186737	.	A	C	3	4	7	0	0	7	0	0
6	31186794	.	G	A	4	3	7	0	0	7	0	0
6	31186981	.	G	A	5	4	9	0	0	9	0	0
6	31187043	.	A	C	1	2	3	0	0	3	0	0
6	31198291	.	C	T	1	0	1	0	0	1	0	0
6	31209550	.	T	C	0	2	2	0	0	2	0	0
6	31209552	.	T	C	0	0	0	0	2	2	0	0
6	31214421	.	C	G	0	1	1	0	0	1	0	0
6	31219005	.	G	A	0	1	1	0	0	1	0	0
6	31279834	.	G	A	9	16	25	0	1	26	0	0
6	31280141	.	G	A	22	12	34	0	1	35	0	0
6	31280185	.	T	A	23	17	40	0	1	41	0	0
6	31280495	.	C	T	8	10	18	0	0	18	0	0
6	31280586	.	A	G	12	17	29	0	2	31	0	0
6	31280646	.	A	C	5	1	6	0	1	7	0	0
6	31280681	.	C	A	5	6	11	0	0	11	0	0
6	31280936	.	A	T	8	9	17	0	1	18	0	0
6	31281006	.	C	T	0	9	9	0	11	20	0	0
6	31281130	.	A	G	26	15	41	0	1	42	0	0
6	31281304	.	C	A	15	18	33	0	0	33	0	0
6	31281533	.	T	A	3	4	7	0	0	7	0	0
6	31281537	.	A	G	3	4	7	0	0	7	0	0
6	31281594	.	A	T	8	8	16	0	0	16	0	0
6	31281694	.	C	T	8	4	12	0	0	12	0	0
6	31281994	.	T	A	4	11	15	0	0	15	0	0
6	31282028	.	T	G	2	9	11	0	0	11	0	0
6	31282118	.	T	G	4	3	7	0	0	7	0	0
6	31282170	.	T	C	7	0	7	0	5	12	0	0
6	31282205	.	C	T	4	7	11	0	2	13	0	0
6	31282768	.	C	T	3	2	5	0	1	6	0	0
6	31283049	.	C	A	2	2	4	0	3	7	0	0
6	31283055	.	G	A	4	6	10	0	0	10	0	0
6	31283280	.	T	A	4	2	6	0	2	8	0	0
6	31309823	.	C	T	0	1	1	0	4	5	0	0
6	31336156	.	G	A	7	4	11	0	1	12	0	0
6	31352298	.	T	A	7	8	15	0	1	16	0	0
6	31352406	.	C	A	11	6	17	0	1	18	0	0
6	31352556	.	G	A	4	4	8	0	0	8	0	0
6	31352635	.	T	G	2	2	4	0	0	4	0	0
6	31352664	.	C	T	3	2	5	0	0	5	0	0
6	31353022	.	G	C	14	11	25	0	0	25	0	0
6	31353065	.	T	C	16	0	16	0	6	22	0	0
6	31353345	.	T	A	9	6	15	0	1	16	0	0
6	31353451	.	A	T	7	7	14	0	0	14	0	0
6	31355787	.	C	T	3	4	7	0	0	7	0	0
6	31358525	.	C	T	0	3	3	0	2	5	0	0
6	31361481	.	C	T	0	1	1	0	0	1	0	0
6	31368096	.	C	T	1	3	4	0	0	4	0	0
6	31394453	.	A	C	1	2	3	0	0	3	0	0
6	31394508	.	T	C	3	3	6	0	0	6	0	0
6	31395724	.	T	C	1	0	1	0	0	1	0	0
6	31395746	.	C	T	1	1	2	0	0	2	0	0
6	31395835	.	G	A	1	2	3	0	1	4	0	0
6	31395943	.	C	T	2	5	7	0	0	7	0	0
6	31396249	.	A	T	2	4	6	0	0	6	0	0
6	31405898	.	G	A	0	1	1	0	2	3	0	0
6	31405923	.	C	T	1	2	3	0	1	4	0	0
6	31411751	.	C	T	3	4	7	0	0	7	0	0
6	31414061	.	A	C	4	5	9	0	0	9	0	0
6	31417667	.	C	T	3	2	5	0	1	6	0	0
6	31419749	.	T	C	1	1	2	0	0	2	0	0
6	31426246	.	A	G	9	4	13	0	7	20	0	0
6	31426727	.	C	G	3	7	10	0	0	10	0	0
6	31426881	.	C	T	9	13	22	0	1	23	0	0
6	31426886	.	C	T	13	10	23	0	0	23	0	0
6	31427468	.	A	G	6	7	13	0	0	13	0	0
6	31427646	.	A	T	6	3	9	0	0	9	0	0
6	31427815	.	G	T	0	6	6	0	5	11	0	0
6	31428283	.	C	A	12	14	26	0	0	26	0	0
6	31428565	.	T	G	7	4	11	0	0	11	0	0
6	31428566	.	A	G	7	3	10	0	1	11	0	0
6	31428705	.	C	T	16	6	22	0	0	22	0	0
6	31428954	.	C	T	3	3	6	0	0	6	0	0
6	31428980	.	C	G	3	0	3	0	4	7	0	0
6	31431145	.	T	G	3	4	7	0	1	8	0	0
6	31431355	.	G	A	9	18	27	0	0	27	0	0
6	31431520	.	A	G	18	13	31	0	0	31	0	0
6	31431775	.	T	C	11	12	23	0	3	26	0	0
6	31431870	.	G	A	20	5	25	0	0	25	0	0
6	31431926	.	A	T	19	19	38	0	2	40	0	0
6	31432302	.	G	A	4	3	7	0	1	8	0	0
6	31432391	.	T	A	4	3	7	0	4	11	0	0
6	31432554	.	A	T	5	4	9	0	0	9	0	0
6	31432563	.	T	C	4	5	9	0	0	9	0	0
6	31432617	.	T	G	0	5	5	0	1	6	0	0
6	31432679	.	T	A	2	6	8	0	0	8	0	0
6	31432684	.	T	C	5	2	7	0	1	8	0	0
6	31432881	.	C	T	0	5	5	1	3	9	0	0
6	31432950	.	G	A	5	2	7	0	0	7	0	0
6	31432955	.	T	C	3	2	5	0	0	5	0	0
6	31433412	.	A	G	5	5	10	0	1	11	0	0
6	31433572	.	T	A	5	6	11	0	1	12	0	0
6	31433692	.	A	T	5	5	10	0	0	10	0	0
6	31433846	.	G	A	4	4	8	0	0	8	0	0
6	31434050	.	C	A	3	3	6	0	0	6	0	0
6	31434245	.	A	T	5	8	13	0	0	13	0	0
6	31434830	.	A	G	2	6	8	0	0	8	0	0
6	31434923	.	C	T	1	5	6	0	3	9	0	0
6	31435017	.	C	T	0	5	5	0	3	8	0	0
6	31441574	.	A	T	2	2	4	0	0	4	0	0
6	31462606	.	G	A	4	4	8	0	0	8	0	0
6	31463147	.	A	T	1	2	3	0	0	3	0	0
6	31465978	.	G	C	1	0	1	0	0	1	0	0
6	31470029	.	G	C	2	1	3	0	2	5	0	0
6	31470041	.	T	C	2	1	3	0	0	3	0	0
6	31591116	.	C	T	2	7	9	0	4	13	0	0
6	31591452	.	C	T	8	15	23	0	1	24	0	0
6	31591838	.	T	G	12	19	31	0	1	32	0	0
6	31591841	.	G	A	19	10	29	0	3	32	0	0
6	31591883	.	C	T	0	3	3	0	18	21	0	0
6	31591997	.	A	C	8	1	9	0	19	29	1	0
6	31598783	.	C	T	5	3	8	0	1	9	0	0
6	31624107	.	T	C	2	0	2	0	0	2	0	0
6	31627223	.	G	A	0	1	1	0	0	1	0	0
6	31627425	.	G	A	2	1	3	0	0	3	0	0
6	31632508	.	T	C	6	4	10	0	0	10	0	0
6	31632519	.	G	A	5	5	10	0	2	12	0	0
6	31632550	.	G	C	5	0	5	0	4	9	0	0
6	31638814	.	A	G	0	4	4	0	1	5	0	0
6	32010259	.	G	A	8	4	12	0	0	12	0	0
6	32010341	.	C	T	0	13	13	0	18	31	0	0
6	32010475	.	A	G	2	3	5	0	0	5	0	0
6	32014771	.	T	G	2	4	6	0	0	6	0	0
6	32016492	.	T	C	5	3	8	0	0	8	0	0
6	32020326	.	G	A	6	8	14	0	0	14	0	0
6	32020327	.	T	A	5	7	12	0	2	14	0	0
6	32024960	.	C	T	8	12	20	0	1	21	0	0
6	32025005	.	C	T	0	10	10	0	11	21	0	0
6	32025109	.	C	A	18	10	28	0	1	29	0	0
6	32029267	.	A	T	2	3	5	0	0	5	0	0
6	32029269	.	A	T	2	3	5	0	0	5	0	0
6	32032371	.	A	C	5	7	12	0	0	12	0	0
6	32032479	.	C	T	5	3	8	1	0	9	0	0
6	32035921	.	G	A	1	2	3	0	0	3	0	0
6	32040581	.	G	A	5	2	7	0	1	8	0	0
6	32040620	.	G	A	4	1	5	0	0	5	0	0
6	32042325	.	C	T	2	0	2	0	0	2	0	0
6	32042381	.	G	A	3	6	9	0	0	9	0	0
6	32042501	.	G	A	2	0	2	0	0	2	0	0
6	32043513	.	G	C	3	4	7	0	0	7	0	0
6	32043514	.	G	T	3	3	6	0	1	7	0	0
6	32065310	.	C	T	2	2	4	0	0	4	0	0
6	32068390	.	C	T	0	3	3	0	5	8	0	0
6	32068411	.	G	C	3	4	7	0	1	8	0	0
6	32068488	.	G	A	0	2	2	0	0	2	0	0
6	32092853	.	G	A	2	3	5	0	0	5	0	0
6	32300873	.	T	C	3	2	5	0	0	5	0	0
6	32301040	.	G	C	2	3	5	0	0	5	0	0
6	32301137	.	A	T	8	7	15	0	0	15	0	0
6	32301161	.	C	T	8	10	18	0	0	18	0	0
6	32301214	.	A	T	7	4	11	0	0	11	0	0
6	32301265	.	A	T	5	15	20	0	1	21	0	0
6	32301462	.	C	T	4	4	8	0	0	8	0	0
6	32301487	.	G	C	2	3	5	0	0	5	0	0
6	32301900	.	C	G	1	4	5	0	6	11	0	0
6	32301969	.	T	G	8	8	16	0	0	16	0	0
6	32302182	.	T	A	10	1	11	0	3	14	0	0
6	32331333	.	G	A	0	1	1	0	3	4	0	0
6	32331344	.	G	T	1	2	3	0	0	3	0	0
6	32336532	.	C	T	1	1	2	0	0	2	0	0
6	32339831	.	C	A	3	3	6	0	0	6	0	0
6	32340005	.	C	T	3	7	10	0	0	10	0	0
6	32344261	.	T	C	2	3	5	0	0	5	0	0
6	32344428	.	T	A	2	2	4	0	1	5	0	0
6	32359470	.	G	A	2	2	4	0	0	4	0	0
6	32364439	.	C	T	2	0	2	0	0	2	0	0
6	32368952	.	C	T	5	3	8	0	0	8	0	0
6	32368970	.	A	T	4	2	6	0	0	6	0	0
6	32371466	.	A	T	0	3	3	0	0	3	0	0
6	32375838	.	T	C	0	1	1	0	0	1	0	0
6	32382629	.	C	T	3	3	6	0	0	6	0	0
6	32397588	.	C	T	11	24	35	0	1	36	0	0
6	32398844	.	G	A	9	11	20	0	0	20	0	0
6	32403028	.	G	A	13	15	28	0	2	30	0	0
6	32403052	.	T	C	9	10	19	0	1	20	0	0
6	32404206	.	C	G	3	3	6	0	0	6	0	0
6	32404863	.	C	T	1	8	9	0	8	17	0	0
6	32405020	.	G	A	13	9	22	0	0	22	0	0
6	32405741	.	A	T	3	7	10	0	0	10	0	0
6	32405784	.	A	G	7	8	15	0	0	15	0	0
6	32405952	.	C	T	5	4	9	0	1	10	0	0
6	32406216	.	G	A	7	7	14	0	0	14	0	0
6	32408742	.	A	T	0	1	1	0	0	1	0	0
6	32411039	.	C	T	0	2	2	0	0	2	0	0
6	32481835	.	G	A	1	3	4	0	0	4	0	0
6	32481868	.	G	A	1	1	2	0	1	3	0	0
6	32481998	.	T	C	5	3	8	0	0	8	0	0
6	32482213	.	A	G	2	3	5	0	1	6	0	0
6	32482376	.	G	A	4	3	7	0	0	7	0	0
6	32482525	.	C	T	3	6	9	0	0	9	0	0
6	32482727	.	G	A	2	3	5	0	0	5	0	0
6	32482984	.	C	T	4	4	8	0	1	9	0	0
6	32483443	.	C	G	3	6	9	0	0	9	0	0
6	32483750	.	T	C	5	5	10	0	0	10	0	0
6	32483869	.	C	T	1	2	3	0	0	3	0	0
6	32493039	.	C	A	3	4	7	0	0	7	0	0
6	32493103	.	C	T	3	4	7	0	0	7	0	0
6	32497690	.	A	G	1	0	1	0	0	1	0	0
6	32504356	.	C	T	4	1	5	0	1	6	0	0
6	32506349	.	T	A	2	4	6	0	0	6	0	0
6	32506386	.	C	T	8	8	16	0	0	16	0	0
6	32506473	.	G	A	0	6	6	0	6	12	0	0
6	32506526	.	A	G	4	4	8	0	0	8	0	0
6	32507040	.	G	C	0	1	1	0	1	2	0	0
6	32699666	.	G	A	5	6	11	0	0	11	0	0
6	32699682	.	T	A	5	7	12	0	0	12	0	0
6	32699870	.	A	T	2	3	5	0	1	6	0	0
6	32700228	.	G	A	3	4	7	0	0	7	0	0
6	32702198	.	C	T	4	4	8	0	0	8	0	0
6	32722579	.	A	G	1	3	4	0	0	4	0	0
6	32722640	.	C	T	0	3	3	0	9	12	0	0
6	32739226	.	A	G	2	2	4	0	0	4	0	0
6	32744121	.	G	A	1	0	1	0	0	1	0	0
6	32747707	.	T	G	1	1	2	0	0	2	0	0
6	32747709	.	A	G	1	1	2	0	0	2	0	0
6	32830083	.	A	G	1	5	6	0	0	6	0	0
6	32831529	.	C	T	0	3	3	0	1	4	0	0
6	32831584	.	A	G	1	2	3	0	0	3	0	0
6	32831871	.	G	T	1	1	2	0	0	2	0	0
6	32831881	.	C	T	1	2	3	0	0	3	0	0
6	32832045	.	T	C	1	0	1	0	4	5	0	0
6	32832166	.	T	C	1	0	1	0	2	3	0	0
6	32832499	.	C	T	3	3	6	0	2	8	0	0
6	32883071	.	A	T	2	3	5	0	0	5	0	0
6	32883097	.	G	A	2	3	5	0	0	5	0	0
6	32883127	.	G	A	0	1	1	0	0	1	0	0
6	32923189	.	C	T	1	1	2	0	0	2	0	0
6	32966915	.	G	C	7	12	19	0	1	20	0	0
6	32967065	.	C	T	2	2	4	0	0	4	0	0
6	32967080	.	T	C	2	4	6	0	0	6	0	0
6	32967174	.	G	A	10	17	27	0	2	29	0	0
6	32967182	.	A	T	9	16	25	0	3	28	0	0
6	32967357	.	G	A	13	11	24	0	2	26	0	0
6	32969517	.	G	A	1	2	3	0	0	3	0	0
6	32970032	.	G	A	3	0	3	0	1	4	0	0
6	32976281	.	G	A	3	6	9	0	1	10	0	0
6	32979285	.	A	C	4	1	5	0	0	5	0	0
6	32999747	.	A	C	4	0	4	0	1	5	0	0
6	33023389	.	T	A	3	1	4	0	0	4	0	0
6	33023439	.	G	A	6	3	9	0	1	10	0	0
6	33023545	.	T	C	4	0	4	0	12	16	0	0
6	33023601	.	A	G	6	15	21	0	3	24	0	0
6	33023625	.	G	C	11	8	19	0	0	19	0	0
6	33085555	.	G	T	2	4	6	0	0	6	0	0
6	33085558	.	G	T	4	2	6	0	0	6	0	0
6	33085730	.	G	A	0	3	3	0	0	3	0	0
6	33089475	.	G	A	1	4	5	0	0	5	0	0
6	33091561	.	C	T	1	3	4	0	0	4	0	0
6	33092969	.	A	C	1	0	1	0	0	1	0	0
6	33094767	.	A	C	4	5	9	0	0	9	0	0
6	33095174	.	G	A	1	7	8	0	0	8	0	0
6	33549187	.	T	G	12	1	13	0	8	21	0	0
6	33552793	.	A	G	0	5	5	0	1	6	0	0
6	33553084	.	G	A	5	6	11	0	0	11	0	0
6	33553406	.	T	C	3	3	6	0	0	6	0	0
6	33554433	.	A	T	5	3	8	0	0	8	0	0
6	33554435	.	C	T	5	3	8	0	0	8	0	0
6	33555159	.	G	A	0	6	6	0	4	10	0	0
6	33555168	.	C	T	4	10	14	0	0	14	0	0
6	33555351	.	A	G	7	4	11	0	0	11	0	0
6	33555374	.	G	A	0	2	2	0	9	11	0	0
6	33555427	.	G	A	0	2	2	0	9	11	0	0
6	33555448	.	A	C	7	3	10	0	0	10	0	0
6	33555570	.	G	A	5	6	11	0	1	12	0	0
6	33555594	.	T	C	2	5	7	0	0	7	0	0
6	33555691	.	T	G	4	0	4	0	3	7	0	0
6	33555952	.	T	A	9	8	17	0	0	17	0	0
6	33556036	.	T	A	11	7	18	0	1	19	0	0
6	33556316	.	C	T	9	10	19	0	1	20	0	0
6	33556424	.	A	G	3	7	10	0	0	10	0	0
6	33556441	.	G	A	8	5	13	0	0	13	0	0
6	33556493	.	A	T	0	17	17	0	2	19	0	0
6	33556497	.	A	T	10	9	19	0	5	24	0	0
6	33556706	.	G	C	14	11	25	0	0	25	0	0
6	33556877	.	G	A	0	11	11	0	13	24	0	0
6	33556968	.	G	C	9	9	18	0	1	19	0	0
6	33557077	.	G	A	1	9	10	0	9	19	0	0
6	33557141	.	G	C	6	9	15	0	0	15	0	0
6	33557438	.	T	A	3	11	14	0	0	14	0	0
6	33557625	.	C	T	15	15	30	0	2	32	0	0
6	33558204	.	G	A	5	5	10	0	0	10	0	0
6	33558437	.	G	A	21	20	41	0	1	42	0	0
6	33558711	.	G	C	18	17	35	0	0	35	0	0
6	33558837	.	C	T	11	3	14	0	0	14	0	0
6	33663690	.	T	C	8	5	13	0	0	13	0	0
6	33663701	.	T	C	10	7	17	0	0	17	0	0
6	33663839	.	C	T	0	12	12	0	15	27	0	0
6	33664182	.	A	G	11	10	21	0	1	22	0	0
6	33664556	.	C	T	1	8	9	0	0	9	0	0
6	33664801	.	A	G	3	7	10	0	0	10	0	0
6	33664899	.	G	A	9	5	14	0	0	14	0	0
6	33664917	.	C	T	0	8	8	0	3	11	0	0
6	33665123	.	T	G	8	12	20	0	1	21	0	0
6	33665320	.	G	A	4	3	7	0	0	7	0	0
6	33665513	.	C	T	0	8	8	0	8	16	0	0
6	33665734	.	C	T	11	10	21	0	1	22	0	0
6	33665867	.	G	T	8	6	14	0	0	14	0	0
6	33665968	.	C	T	11	15	26	0	0	26	0	0
6	33666166	.	G	A	8	12	20	0	0	20	0	0
6	33666250	.	C	A	1	4	5	0	6	11	0	0
6	33666302	.	C	A	5	9	14	0	0	14	0	0
6	33666308	.	G	A	6	9	15	0	1	16	0	0
6	33666472	.	G	T	10	18	28	0	0	28	0	0
6	33666578	.	G	T	14	10	24	0	2	26	0	0
6	33666631	.	C	T	14	9	23	0	1	24	0	0
6	33666715	.	C	A	6	20	26	0	1	27	0	0
6	33666733	.	A	G	9	19	28	0	0	28	0	0
6	33666871	.	A	T	13	7	20	0	0	20	0	0
6	33666910	.	G	T	4	12	16	0	0	16	0	0
6	33667006	.	C	T	6	6	12	0	0	12	0	0
6	33667056	.	T	C	6	0	6	0	6	12	0	0
6	33667180	.	C	T	2	7	9	0	5	14	0	0
6	33667234	.	T	A	12	7	19	0	1	20	0	0
6	33667369	.	G	A	13	8	21	0	0	21	0	0
6	33667492	.	G	T	13	4	17	0	11	28	0	0
6	33668228	.	A	T	2	6	8	0	0	8	0	0
6	33668729	.	A	T	7	7	14	0	2	16	0	0
6	33669168	.	G	C	5	0	5	0	7	12	0	0
6	33669460	.	A	C	1	1	2	0	0	2	0	0
6	33672116	.	C	A	1	0	1	0	0	1	0	0
6	33674305	.	T	C	1	3	4	0	0	4	0	0
6	33683816	.	A	G	2	0	2	0	0	2	0	0
6	33683837	.	G	A	2	3	5	0	0	5	0	0
6	33683882	.	A	G	3	4	7	0	1	8	0	0
6	33683885	.	T	A	4	4	8	0	0	8	0	0
6	33694269	.	G	A	0	1	1	0	0	1	0	0
6	33875138	.	T	G	1	3	4	0	0	4	0	0
6	33875746	.	T	A	1	4	5	0	1	6	0	0
6	33875833	.	G	A	2	2	4	0	0	4	0	0
6	33875839	.	G	A	2	2	4	0	0	4	0	0
6	33875902	.	C	T	0	3	3	0	7	10	0	0
6	33883580	.	C	T	1	4	5	0	0	5	0	0
6	33896399	.	T	A	22	17	39	0	0	39	0	0
6	33896457	.	A	G	13	25	38	0	0	38	0	0
6	33896538	.	T	C	26	10	36	0	3	39	0	0
6	33896562	.	A	G	22	16	38	0	1	39	0	0
6	33896615	.	G	A	1	19	20	0	13	33	0	0
6	33896620	.	C	T	20	9	29	0	1	30	0	0
6	33897505	.	G	A	7	6	13	0	0	13	0	0
6	33898356	.	T	G	1	2	3	0	0	3	0	0
6	33898368	.	A	G	2	3	5	0	0	5	0	0
6	33902836	.	G	A	0	1	1	0	2	3	0	0
6	33902855	.	G	A	2	2	4	0	0	4	0	0
6	33905862	.	G	A	0	1	1	0	0	1	0	0
6	33905876	.	G	A	2	1	3	0	0	3	0	0
6	33912228	.	G	T	2	0	2	0	1	3	0	0
6	33912708	.	A	C	5	0	5	0	2	7	0	0
6	33913904	.	A	G	1	4	5	0	0	5	0	0
6	33913956	.	G	A	0	2	2	0	0	2	0	0
6	33916648	.	T	C	3	2	5	0	5	10	0	0
6	33921298	.	C	T	6	3	9	0	1	10	0	0
6	33921511	.	G	A	1	3	4	0	0	4	0	0
6	33921631	.	A	G	3	7	10	0	1	11	0	0
6	33923900	.	C	T	1	1	2	0	0	2	0	0
6	33924693	.	A	G	3	2	5	0	0	5	0	0
6	33927040	.	A	T	5	9	14	0	2	16	0	0
6	33931582	.	T	C	16	7	23	0	3	26	0	0
6	33982409	.	T	A	3	2	5	0	0	5	0	0
6	33982412	.	G	A	2	3	5	0	0	5	0	0
6	33982486	.	A	T	2	3	5	0	1	6	0	0
6	33982683	.	C	T	2	2	4	0	0	4	0	0
6	33983055	.	G	A	5	2	7	0	0	7	0	0
6	33983405	.	G	T	2	2	4	0	0	4	0	0
6	33984216	.	T	A	2	3	5	0	0	5	0	0
6	34039046	.	T	A	4	2	6	0	0	6	0	0
6	34072026	.	C	A	1	2	3	0	0	3	0	0
6	34767154	.	T	C	5	3	8	0	0	8	0	0
6	34767157	.	T	A	5	3	8	0	0	8	0	0
6	34767193	.	T	C	3	2	5	0	0	5	0	0
6	34767202	.	C	T	3	2	5	0	0	5	0	0
6	34769061	.	G	T	1	2	3	0	0	3	0	0
6	34806307	.	T	C	6	2	8	0	2	10	0	0
6	34806745	.	G	A	1	7	8	0	0	8	0	0
6	34807374	.	T	A	1	2	3	0	1	4	0	0
6	34807534	.	C	A	3	4	7	0	0	7	0	0
6	34807605	.	C	G	1	3	4	0	0	4	0	0
6	34807682	.	C	T	2	2	4	0	0	4	0	0
6	34807843	.	A	T	2	5	7	0	0	7	0	0
6	34807927	.	T	A	5	2	7	0	0	7	0	0
6	34807933	.	G	T	5	2	7	0	0	7	0	0
6	34807999	.	G	T	7	3	10	0	0	10	0	0
6	34808591	.	G	A	9	7	16	0	0	16	0	0
6	34808754	.	C	T	6	8	14	0	1	15	0	0
6	34808821	.	G	A	3	3	6	0	0	6	0	0
6	34808996	.	A	G	7	0	7	0	4	11	0	0
6	34809697	.	C	G	7	1	8	0	6	14	0	0
6	34810495	.	G	A	1	5	6	0	13	20	1	0
6	34810748	.	A	C	6	7	13	0	0	13	0	0
6	34810763	.	T	A	7	8	15	0	0	15	0	0
6	34810896	.	G	A	7	5	12	0	0	12	0	0
6	34810908	.	T	C	6	7	13	0	0	13	0	0
6	34811130	.	A	T	2	4	6	0	0	6	0	0
6	34811175	.	T	C	10	5	15	0	0	15	0	0
6	34825949	.	C	T	3	3	6	0	0	6	0	0
6	34825955	.	C	T	0	3	3	0	3	6	0	0
6	34826051	.	T	C	2	4	6	0	0	6	0	0
6	34826214	.	G	A	1	3	4	0	0	4	0	0
6	34826598	.	G	A	2	3	5	0	0	5	0	0
6	34826638	.	C	T	2	3	5	0	0	5	0	0
6	34826640	.	C	T	5	0	5	0	0	5	0	0
6	34826870	.	G	A	11	7	18	0	0	18	0	0
6	34826882	.	T	G	10	7	17	0	1	18	0	0
6	34828893	.	A	T	3	0	3	0	0	3	0	0
6	34831124	.	A	C	1	0	1	0	1	2	0	0
6	34848447	.	C	A	1	4	5	0	0	5	0	0
6	34854397	.	G	A	1	0	1	0	0	1	0	0
6	34925393	.	G	T	1	3	4	0	0	4	0	0
6	34925405	.	C	A	1	2	3	0	0	3	0	0
6	34931646	.	G	A	17	14	31	2	1	34	0	0
6	34931911	.	C	T	20	26	46	0	1	47	0	0
6	34931912	.	C	T	20	26	46	0	1	47	0	0
6	34933574	.	C	T	2	2	4	0	0	4	0	0
6	34934903	.	G	T	26	27	53	0	0	53	0	0
6	34943714	.	G	A	8	4	12	0	1	13	0	0
6	34943760	.	A	G	4	3	7	0	1	8	0	0
6	34943824	.	A	T	4	2	6	0	1	7	0	0
6	34944523	.	G	A	1	2	3	0	0	3	0	0
6	34947415	.	G	A	1	2	3	0	0	3	0	0
6	34951839	.	C	G	2	1	3	0	0	3	0	0
6	35036303	.	C	T	3	3	6	0	0	6	0	0
6	35036320	.	C	T	2	3	5	0	1	6	0	0
6	35036459	.	A	T	7	3	10	0	0	10	0	0
6	35036463	.	T	C	7	0	7	0	3	10	0	0
6	35036520	.	A	G	3	3	6	0	0	6	0	0
6	35036525	.	T	G	3	3	6	0	0	6	0	0
6	35036755	.	T	A	7	3	10	0	0	10	0	0
6	35039912	.	G	T	5	5	10	0	1	11	0	0
6	35039966	.	C	T	8	5	13	0	2	15	0	0
6	35042176	.	C	T	4	2	6	0	2	8	0	0
6	35046783	.	G	A	1	2	3	0	0	3	0	0
6	35046852	.	T	C	0	2	2	0	0	2	0	0
6	35051403	.	T	G	2	1	3	0	0	3	0	0
6	35054984	.	T	G	4	2	6	0	0	6	0	0
6	35055004	.	A	T	4	3	7	0	0	7	0	0
6	35056519	.	C	A	1	2	3	0	0	3	0	0
6	35056547	.	C	T	2	3	5	0	0	5	0	0
6	35056578	.	T	A	2	3	5	0	1	6	0	0
6	35058696	.	A	G	1	0	1	0	0	1	0	0
6	35061226	.	C	T	6	2	8	0	0	8	0	0
6	35061237	.	C	T	4	2	6	0	0	6	0	0
6	35100423	.	C	T	2	5	7	0	0	7	0	0
6	35100442	.	T	C	2	3	5	0	0	5	0	0
6	35100528	.	A	G	2	3	5	0	0	5	0	0
6	35100795	.	C	G	0	5	5	0	3	8	0	0
6	35100801	.	T	G	3	8	11	0	0	11	0	0
6	35100857	.	A	G	3	8	11	0	0	11	0	0
6	35100868	.	T	A	3	8	11	0	0	11	0	0
6	35100894	.	C	T	0	7	7	0	1	8	0	0
6	35100933	.	A	G	0	1	1	0	1	2	0	0
6	35101184	.	A	T	5	5	10	0	0	10	0	0
6	35102136	.	C	A	1	3	4	0	0	4	0	0
6	35102174	.	G	T	1	3	4	0	0	4	0	0
6	35102178	.	A	C	1	2	3	0	0	3	0	0
6	35102555	.	G	C	2	4	6	0	0	6	0	0
6	35102576	.	C	T	2	4	6	0	0	6	0	0
6	35102886	.	T	G	2	2	4	0	0	4	0	0
6	35106162	.	T	C	1	2	3	0	0	3	0	0
6	35106428	.	A	G	1	2	3	0	0	3	0	0
6	35106614	.	G	T	2	2	4	0	0	4	0	0
6	35136451	.	T	C	8	4	12	0	0	12	0	0
6	35136471	.	C	T	0	4	4	0	9	13	0	0
6	35136505	.	T	A	8	5	13	0	0	13	0	0
6	35136558	.	G	A	3	3	6	0	0	6	0	0
6	35136693	.	A	T	3	6	9	0	0	9	0	0
6	35136778	.	G	T	3	4	7	0	0	7	0	0
6	35136781	.	C	T	0	4	4	0	2	6	0	0
6	35136983	.	A	G	3	4	7	0	0	7	0	0
6	35137320	.	A	G	5	2	7	0	0	7	0	0
6	35137587	.	A	G	3	2	5	0	0	5	0	0
6	35139248	.	T	C	2	3	5	0	1	6	0	0
6	35194786	.	G	A	2	1	3	0	0	3	0	0
6	35309798	.	T	G	5	2	7	0	0	7	0	0
6	35309823	.	A	T	5	3	8	0	1	9	0	0
6	35309876	.	T	A	2	2	4	0	0	4	0	0
6	35309901	.	T	G	2	4	6	0	0	6	0	0
6	35309942	.	G	A	1	5	6	0	0	6	0	0
6	35365098	.	A	T	5	7	12	0	0	12	0	0
6	35365234	.	C	T	3	5	8	0	0	8	0	0
6	35365441	.	C	A	1	3	4	0	0	4	0	0
6	35365462	.	T	A	1	6	7	0	0	7	0	0
6	35365492	.	A	G	0	5	5	0	0	5	0	0
6	35365872	.	C	T	10	5	15	0	1	16	0	0
6	35365877	.	C	T	10	6	16	0	0	16	0	0
6	35366140	.	G	T	0	9	9	0	11	20	0	0
6	35366141	.	A	G	9	10	19	0	1	20	0	0
6	35366640	.	C	G	9	8	17	0	1	18	0	0
6	35389384	.	T	A	12	4	16	0	0	16	0	0
6	35389517	.	C	G	0	3	3	0	6	9	0	0
6	35398617	.	T	C	1	0	1	0	1	2	0	0
6	35461688	.	T	C	3	4	7	0	0	7	0	0
6	35461812	.	A	T	1	1	2	0	1	3	0	0
6	35461859	.	A	G	1	2	3	0	0	3	0	0
6	35462087	.	G	A	13	14	27	0	2	29	0	0
6	35462088	.	A	G	15	13	28	0	1	29	0	0
6	35462134	.	G	A	12	6	18	0	2	20	0	0
6	35462186	.	A	G	15	12	27	0	1	28	0	0
6	35462470	.	G	A	18	16	34	0	0	34	0	0
6	35472834	.	C	T	4	8	12	0	0	12	0	0
6	35472858	.	G	T	6	13	19	0	0	19	0	0
6	35676784	.	A	G	12	13	25	0	1	26	0	0
6	35676799	.	C	T	17	16	33	0	0	33	0	0
6	35688231	.	G	A	5	3	8	0	1	9	0	0
6	35693656	.	C	T	4	5	9	0	0	9	0	0
6	35713078	.	T	A	0	1	1	0	0	1	0	0
6	35718058	.	T	C	6	7	13	0	0	13	0	0
6	35737276	.	G	T	5	4	9	0	0	9	0	0
6	35737289	.	A	G	5	4	9	0	0	9	0	0
6	35738397	.	G	A	4	4	8	0	1	9	0	0
6	35738430	.	C	A	0	6	6	0	7	13	0	0
6	36129033	.	C	T	2	2	4	0	0	4	0	0
6	36129066	.	A	G	1	3	4	0	0	4	0	0
6	36129115	.	C	G	1	4	5	0	0	5	0	0
6	36129135	.	T	A	1	4	5	0	0	5	0	0
6	36129202	.	G	A	4	2	6	0	0	6	0	0
6	36130084	.	G	A	7	2	9	0	1	10	0	0
6	36130245	.	G	A	2	6	8	0	0	8	0	0
6	36130351	.	T	A	6	6	12	0	0	12	0	0
6	36130358	.	A	C	4	6	10	0	0	10	0	0
6	36131055	.	A	G	3	5	8	0	0	8	0	0
6	36131097	.	A	T	7	5	12	0	1	13	0	0
6	36131376	.	A	G	5	6	11	0	0	11	0	0
6	36131876	.	G	A	4	3	7	0	0	7	0	0
6	36132072	.	C	T	0	9	9	0	5	14	0	0
6	36137010	.	G	A	2	3	5	0	0	5	0	0
6	36141739	.	T	G	4	3	7	0	0	7	0	0
6	36141741	.	A	G	4	3	7	0	0	7	0	0
6	36178531	.	A	G	4	3	7	0	0	7	0	0
6	36462764	.	C	T	1	2	3	0	0	3	0	0
6	36469225	.	A	C	1	2	3	0	0	3	0	0
6	36758758	.	A	G	4	4	8	0	0	8	0	0
6	36760065	.	A	C	7	2	9	0	17	26	0	0
6	36760080	.	T	A	10	17	27	0	1	28	0	0
6	36760140	.	C	T	3	2	5	0	0	5	0	0
6	36770666	.	C	T	0	2	2	0	0	2	0	0
6	36783178	.	T	C	3	2	5	0	0	5	0	0
6	36783187	.	T	A	2	2	4	0	0	4	0	0
6	36789072	.	A	G	8	6	14	0	0	14	0	0
6	36792028	.	A	C	5	5	10	0	1	11	0	0
6	36792112	.	A	G	8	5	13	0	1	14	0	0
6	36792130	.	A	T	8	6	14	0	3	17	0	0
6	36792163	.	C	G	10	9	19	0	1	20	0	0
6	36792294	.	A	G	3	3	6	0	0	6	0	0
6	36813910	.	G	A	1	2	3	0	0	3	0	0
6	36818840	.	C	T	4	2	6	0	0	6	0	0
6	36868015	.	G	A	1	0	1	0	0	1	0	0
6	36876875	.	A	G	1	4	5	0	0	5	0	0
6	36876881	.	A	G	2	3	5	0	0	5	0	0
6	36877259	.	A	G	3	6	9	0	0	9	0	0
6	36896798	.	T	C	1	6	7	0	0	7	0	0
6	36896843	.	A	G	1	7	8	0	0	8	0	0
6	37071353	.	G	A	11	8	19	0	0	19	0	0
6	37071374	.	A	G	8	7	15	0	4	19	0	0
6	37163366	.	A	T	17	13	30	0	1	31	0	0
6	37163449	.	G	A	0	13	13	0	23	36	0	0
6	37163488	.	G	A	19	18	37	0	3	40	0	0
6	37163588	.	G	T	0	20	20	0	17	37	0	0
6	37163932	.	T	C	22	20	42	0	0	42	0	0
6	37163943	.	C	T	17	21	38	0	1	39	0	0
6	37164060	.	T	C	22	11	33	0	2	35	0	0
6	37164173	.	T	G	17	13	30	0	0	30	0	0
6	37301386	.	G	A	2	2	4	0	0	4	0	0
6	37301438	.	G	T	13	9	22	0	0	22	0	0
6	37301458	.	A	G	15	14	29	0	0	29	0	0
6	37301479	.	A	T	17	14	31	0	2	33	0	0
6	37305142	.	A	C	11	10	21	0	2	23	0	0
6	37305383	.	A	G	5	2	7	0	0	7	0	0
6	37305532	.	G	T	0	2	2	0	0	2	0	0
6	37305539	.	G	T	0	2	2	0	1	3	0	0
6	37306620	.	A	T	13	5	18	0	0	19	1	0
6	37306827	.	C	T	9	4	13	0	0	13	0	0
6	37307034	.	C	T	4	5	9	0	1	10	0	0
6	37409738	.	C	T	8	13	21	0	1	22	0	0
6	37409986	.	C	T	3	5	8	0	0	8	0	0
6	37410029	.	A	G	3	4	7	0	2	9	0	0
6	37410047	.	C	T	6	9	15	0	1	16	0	0
6	37410119	.	C	T	1	1	2	0	0	2	0	0
6	37417345	.	T	A	1	3	4	0	0	4	0	0
6	37419449	.	G	A	0	2	2	0	0	2	0	0
6	37419479	.	G	A	0	2	2	0	0	2	0	0
6	37422787	.	A	G	3	8	11	0	1	12	0	0
6	37431476	.	T	G	1	4	5	0	0	5	0	0
6	37431532	.	G	C	3	9	12	0	0	12	0	0
6	37431592	.	C	T	6	7	13	0	0	13	0	0
6	37431649	.	T	C	2	3	5	0	0	5	0	0
6	37438497	.	T	A	1	3	4	0	0	4	0	0
6	37440068	.	G	A	2	0	2	0	0	2	0	0
6	37440302	.	A	G	2	1	3	0	0	3	0	0
6	37440515	.	G	T	0	2	2	0	0	2	0	0
6	37442129	.	C	T	2	4	6	0	0	6	0	0
6	37442276	.	A	G	4	2	6	0	0	6	0	0
6	37442314	.	A	T	2	1	3	0	0	3	0	0
6	37445258	.	T	A	1	2	3	0	0	3	0	0
6	37445357	.	T	C	1	2	3	0	0	3	0	0
6	37460601	.	G	T	1	1	2	0	1	3	0	0
6	37460889	.	C	T	5	2	7	0	0	7	0	0
6	37461661	.	G	A	2	4	6	0	0	6	0	0
6	37461662	.	T	A	1	4	5	0	1	6	0	0
6	37469418	.	G	T	3	2	5	0	0	5	0	0
6	37469571	.	C	A	0	2	2	0	2	4	0	0
6	37479506	.	G	A	6	7	13	0	1	14	0	0
6	37479563	.	C	G	7	2	9	0	0	9	0	0
6	37479578	.	G	A	5	2	7	0	0	7	0	0
6	37479779	.	A	C	6	4	10	0	1	11	0	0
6	37479785	.	A	C	4	8	12	0	0	12	0	0
6	37479910	.	T	G	6	7	13	0	0	13	0	0
6	37479932	.	G	A	6	10	16	0	0	16	0	0
6	37479998	.	A	G	2	2	4	0	1	5	0	0
6	37480028	.	A	G	5	2	7	0	0	7	0	0
6	37480100	.	T	A	3	1	4	0	0	4	0	0
6	37489092	.	C	G	1	1	2	0	0	2	0	0
6	37495147	.	G	A	6	3	9	0	0	9	0	0
6	37514749	.	T	C	3	2	5	0	0	5	0	0
6	37515300	.	C	T	9	3	12	0	0	12	0	0
6	37515353	.	T	A	6	8	14	0	0	14	0	0
6	37521529	.	A	T	8	8	16	0	1	17	0	0
6	37521594	.	C	A	5	6	11	0	2	13	0	0
6	37521778	.	G	A	4	8	12	0	0	12	0	0
6	37525748	.	G	A	9	5	14	0	0	14	0	0
6	37529504	.	C	A	15	14	29	0	1	30	0	0
6	37548605	.	T	C	3	4	7	0	0	7	0	0
6	37548897	.	C	T	2	6	8	0	0	8	0	0
6	37551165	.	G	A	0	9	9	0	5	14	0	0
6	37551548	.	T	C	4	4	8	0	0	8	0	0
6	37552621	.	C	T	3	8	11	0	1	12	0	0
6	37554293	.	C	T	3	2	5	0	0	5	0	0
6	37598966	.	C	T	12	24	36	0	1	37	0	0
6	37599293	.	C	T	8	15	23	0	1	24	0	0
6	37599406	.	G	A	13	11	24	0	0	24	0	0
6	37599499	.	G	T	8	15	23	0	1	24	0	0
6	37599687	.	A	T	22	13	35	0	1	36	0	0
6	37599937	.	T	G	11	13	24	0	1	25	0	0
6	37599954	.	C	T	12	10	22	0	1	23	0	0
6	37600173	.	A	G	21	0	21	0	13	34	0	0
6	37600210	.	G	A	0	20	20	0	13	33	0	0
6	37600233	.	G	A	14	22	36	0	1	37	0	0
6	37603982	.	T	G	6	4	10	0	0	10	0	0
6	37603983	.	A	G	6	4	10	0	0	10	0	0
6	37604410	.	T	A	4	5	9	0	0	9	0	0
6	37604547	.	A	G	7	3	10	0	0	10	0	0
6	37604724	.	G	A	7	4	11	0	0	11	0	0
6	37604866	.	A	C	11	11	22	0	1	23	0	0
6	37621150	.	T	C	7	10	17	0	0	17	0	0
6	37621204	.	A	G	5	7	12	0	1	13	0	0
6	37621213	.	A	G	5	5	10	0	2	12	0	0
6	37621918	.	A	G	5	8	13	0	0	13	0	0
6	37622089	.	C	T	0	5	5	0	7	12	0	0
6	37627114	.	G	A	2	1	3	0	0	3	0	0
6	37627141	.	C	A	2	1	3	0	0	3	0	0
6	37628973	.	G	A	4	1	5	0	0	5	0	0
6	37628991	.	C	T	2	0	2	0	0	2	0	0
6	37629402	.	A	G	0	0	0	0	1	1	0	0
6	37631456	.	A	G	1	4	5	0	0	5	0	0
6	37632921	.	G	A	2	2	4	0	1	5	0	0
6	37632963	.	A	G	4	0	4	0	1	5	0	0
6	37632966	.	C	T	4	2	6	0	0	6	0	0
6	37633005	.	C	A	5	7	12	0	0	12	0	0
6	37633549	.	G	A	0	0	0	0	3	3	0	0
6	37635589	.	G	A	4	12	16	0	1	17	0	0
6	37635595	.	C	A	4	12	16	0	0	16	0	0
6	37637987	.	G	A	7	6	13	0	2	15	0	0
6	37648171	.	C	G	0	1	1	0	0	1	0	0
6	37651619	.	T	C	4	7	11	0	2	13	0	0
6	37702925	.	C	T	3	2	5	0	0	5	0	0
6	37716969	.	C	T	1	1	2	0	0	2	0	0
6	37728484	.	T	C	2	4	6	0	0	6	0	0
6	37728496	.	T	C	3	7	10	0	0	10	0	0
6	37729880	.	T	C	3	1	4	0	0	4	0	0
6	37730423	.	G	T	7	3	10	0	0	10	0	0
6	37730520	.	C	T	4	2	6	0	0	6	0	0
6	37730527	.	C	T	2	2	4	0	1	5	0	0
6	37734548	.	G	A	6	2	8	0	0	8	0	0
6	37737188	.	C	A	2	1	3	0	0	3	0	0
6	37743319	.	A	C	0	0	0	0	1	1	0	0
6	37743456	.	T	C	4	0	4	0	7	11	0	0
6	37744420	.	G	A	0	2	2	0	0	2	0	0
6	37745985	.	T	G	1	3	4	0	0	4	0	0
6	37772316	.	T	C	0	2	2	0	0	2	0	0
6	37772400	.	C	T	1	1	2	0	0	2	0	0
6	37772406	.	A	G	1	1	2	0	0	2	0	0
6	37775562	.	G	A	0	1	1	0	0	1	0	0
6	37786017	.	T	C	0	2	2	0	0	2	0	0
6	37794637	.	C	A	3	3	6	0	0	6	0	0
6	37801954	.	A	G	1	0	1	0	0	1	0	0
6	37808238	.	G	A	0	2	2	0	2	4	0	0
6	37808262	.	G	C	0	4	4	0	3	7	0	0
6	37808349	.	G	A	1	5	6	0	0	6	0	0
6	37809918	.	C	T	0	2	2	0	0	2	0	0
6	37810029	.	T	C	3	2	5	0	2	7	0	0
6	37810256	.	C	T	1	1	2	0	0	2	0	0
6	37812199	.	A	G	3	2	5	0	0	5	0	0
6	37815525	.	T	C	0	2	2	0	0	2	0	0
6	37815621	.	T	G	5	7	12	0	1	13	0	0
6	37815799	.	C	T	1	1	2	0	0	2	0	0
6	37818324	.	A	C	3	2	5	0	0	5	0	0
6	37818327	.	G	A	3	2	5	0	0	5	0	0
6	37820306	.	C	T	5	5	10	0	0	10	0	0
6	37820960	.	T	C	6	4	10	0	1	11	0	0
6	37821169	.	G	T	0	2	2	0	1	3	0	0
6	37824355	.	G	T	9	8	17	0	1	18	0	0
6	37824645	.	T	C	6	2	8	0	0	9	1	0
6	37825508	.	T	G	2	0	2	0	6	8	0	0
6	37829585	.	G	A	7	6	13	0	1	14	0	0
6	37829613	.	T	C	4	2	6	0	0	6	0	0
6	37830742	.	A	T	7	3	10	0	0	10	0	0
6	37830784	.	C	T	14	13	27	0	0	27	0	0
6	37830811	.	C	T	11	14	25	0	0	25	0	0
6	37832947	.	C	T	9	11	20	0	1	21	0	0
6	37832953	.	G	A	7	10	17	0	1	18	0	0
6	37833493	.	T	C	7	4	11	0	0	11	0	0
6	37835767	.	T	C	11	9	20	0	0	20	0	0
6	37835797	.	C	T	7	4	11	0	0	11	0	0
6	37836387	.	G	A	8	14	22	0	1	23	0	0
6	37841100	.	C	T	6	3	9	0	0	9	0	0
6	37846026	.	C	T	16	23	39	0	4	43	0	0
6	38367062	.	G	C	20	0	20	0	8	28	0	0
6	38367107	.	T	C	12	17	29	0	0	29	0	0
6	38375020	.	G	A	11	18	29	0	0	29	0	0
6	38381094	.	G	A	12	12	24	0	0	24	0	0
6	38415315	.	G	A	1	2	3	0	0	3	0	0
6	38415385	.	A	G	6	12	18	0	0	18	0	0
6	38477019	.	G	T	3	6	9	0	1	10	0	0
6	38503673	.	C	T	2	4	6	0	0	6	0	0
6	38511604	.	G	A	12	5	17	0	0	17	0	0
6	38511739	.	C	T	13	10	23	0	1	24	0	0
6	38511921	.	T	C	5	8	13	0	1	14	0	0
6	38511967	.	A	T	6	4	10	0	1	11	0	0
6	38512160	.	T	C	17	7	24	0	2	26	0	0
6	38512178	.	G	A	15	11	26	0	1	27	0	0
6	38512236	.	C	T	10	19	29	0	0	29	0	0
6	38512629	.	C	T	7	17	24	0	0	24	0	0
6	38513231	.	C	T	13	7	20	0	0	20	0	0
6	38513377	.	C	T	1	12	13	0	1	14	0	0
6	38778327	.	T	C	4	1	5	0	1	6	0	0
6	38782025	.	C	T	8	5	13	0	0	13	0	0
6	38782439	.	C	A	6	6	12	0	0	12	0	0
6	38782442	.	C	T	6	5	11	0	1	12	0	0
6	38782511	.	A	G	3	4	7	0	0	7	0	0
6	38782712	.	T	C	3	7	10	0	0	10	0	0
6	38782794	.	C	T	2	4	6	0	0	6	0	0
6	38782799	.	T	A	2	3	5	0	0	5	0	0
6	38783002	.	T	A	8	11	19	0	0	19	0	0
6	38783044	.	T	A	4	6	10	0	0	10	0	0
6	38786622	.	C	A	1	1	2	0	0	2	0	0
6	38789065	.	C	A	9	12	21	0	0	21	0	0
6	38789292	.	C	T	10	9	19	0	1	20	0	0
6	38789317	.	C	T	11	8	19	0	0	19	0	0
6	38789507	.	A	T	8	5	13	0	0	13	0	0
6	38789583	.	G	C	6	11	17	0	1	18	0	0
6	38789733	.	A	G	9	8	17	0	3	20	0	0
6	38789832	.	A	G	7	13	20	0	0	20	0	0
6	38789853	.	T	A	8	13	21	0	0	21	0	0
6	38845817	.	T	C	5	4	9	0	0	9	0	0
6	38845865	.	G	A	8	10	18	0	2	20	0	0
6	38845943	.	C	G	6	3	9	0	1	10	0	0
6	38845964	.	A	G	3	4	7	0	1	8	0	0
6	38845986	.	A	G	4	1	5	0	3	8	0	0
6	38846240	.	A	G	3	4	7	0	1	8	0	0
6	38858036	.	G	T	0	1	1	0	1	2	0	0
6	38858558	.	T	A	1	5	6	0	0	6	0	0
6	38858784	.	T	G	10	5	15	0	0	15	0	0
6	38858832	.	T	G	6	6	12	0	0	12	0	0
6	38859796	.	T	A	3	4	7	0	0	7	0	0
6	38860293	.	C	G	5	4	9	0	6	15	0	0
6	38860362	.	T	A	7	7	14	0	0	14	0	0
6	38860421	.	C	T	3	4	7	0	0	7	0	0
6	38860815	.	A	G	1	12	13	0	0	13	0	0
6	38860898	.	T	C	5	14	19	0	0	19	0	0
6	38860905	.	C	T	5	15	20	0	0	20	0	0
6	38860981	.	T	C	11	7	18	1	0	19	0	0
6	38860985	.	T	G	10	8	18	1	1	20	0	0
6	38861020	.	G	A	10	11	21	0	0	21	0	0
6	38861035	.	C	A	8	10	18	0	0	18	0	0
6	38902329	.	C	T	3	2	5	0	1	6	0	0
6	39162607	.	C	T	2	19	21	0	0	21	0	0
6	41435866	.	A	G	15	8	23	0	0	23	0	0
6	41460563	.	A	T	0	7	7	0	0	7	0	0
6	42039261	.	T	C	7	3	10	0	1	11	0	0
6	44007062	.	T	A	2	3	5	0	0	5	0	0
6	44922563	.	A	C	0	2	2	0	0	2	0	0
6	44931081	.	T	G	3	10	13	0	0	13	0	0
6	44939209	.	A	G	4	3	7	0	1	8	0	0
6	44942314	.	G	A	0	2	2	0	2	4	0	0
6	44945233	.	A	G	1	0	1	0	0	1	0	0
6	44945279	.	C	A	7	3	10	0	0	10	0	0
6	44945301	.	C	T	9	4	13	0	3	16	0	0
6	44947635	.	G	A	0	0	0	0	1	1	0	0
6	44950364	.	C	T	7	6	13	0	0	13	0	0
6	44950644	.	C	T	4	3	7	0	0	7	0	0
6	44950701	.	T	G	1	6	7	0	2	9	0	0
6	44961519	.	A	G	8	11	19	0	0	19	0	0
6	44977406	.	G	A	19	9	28	0	0	28	0	0
6	46357708	.	C	A	0	1	1	0	3	4	0	0
6	46413942	.	T	C	1	2	3	0	0	3	0	0
6	46413948	.	G	A	1	2	3	0	0	3	0	0
6	46414595	.	G	A	1	4	5	0	0	5	0	0
6	46422955	.	G	A	1	9	10	0	0	10	0	0
6	46423470	.	C	A	5	1	6	0	1	7	0	0
6	46423593	.	G	T	6	6	12	0	0	12	0	0
6	46425620	.	A	G	8	8	16	0	2	18	0	0
6	46431113	.	G	A	1	3	4	0	7	11	0	0
6	46431950	.	A	G	28	22	50	0	0	50	0	0
6	46432016	.	G	A	6	6	12	0	0	12	0	0
6	46450487	.	C	G	27	24	51	0	1	52	0	0
6	46450547	.	T	C	21	24	45	0	4	49	0	0
6	46450804	.	C	T	13	11	24	0	3	27	0	0
6	46452997	.	C	T	3	3	6	0	0	6	0	0
6	46454103	.	C	A	19	11	30	0	0	30	0	0
6	46454148	.	G	A	20	9	29	0	0	29	0	0
6	46454173	.	T	G	20	14	34	0	0	34	0	0
6	46454396	.	T	A	23	26	49	0	2	51	0	0
6	46507612	.	A	G	2	3	5	0	0	5	0	0
6	46508072	.	G	T	4	5	9	0	0	9	0	0
6	46559848	.	C	T	4	3	7	0	1	8	0	0
6	46559932	.	G	A	3	5	8	0	0	8	0	0
6	46697930	.	T	C	4	8	12	0	1	13	0	0
6	46701953	.	C	T	4	2	6	0	0	6	0	0
6	46715399	.	A	G	0	1	1	0	0	1	0	0
6	46716897	.	T	C	7	7	14	0	0	14	0	0
6	46716915	.	C	T	5	10	15	0	1	16	0	0
6	46716954	.	T	C	4	6	10	0	2	12	0	0
6	46717535	.	T	C	3	5	8	0	0	8	0	0
6	46717731	.	A	G	4	0	4	0	8	12	0	0
6	46717772	.	T	C	7	7	14	0	0	14	0	0
6	46718103	.	T	G	9	6	15	0	0	15	0	0
6	46718193	.	G	T	14	12	26	0	0	26	0	0
6	46718237	.	G	A	7	2	9	0	0	9	0	0
6	46718243	.	G	A	5	1	6	0	1	7	0	0
6	46721369	.	C	T	0	4	4	0	0	4	0	0
6	46722670	.	G	A	5	5	10	0	1	11	0	0
6	46722671	.	G	T	4	5	9	0	2	11	0	0
6	46722783	.	G	T	0	10	10	0	5	15	0	0
6	46722786	.	C	G	4	9	13	0	1	14	0	0
6	46722883	.	T	G	6	9	15	0	2	17	0	0
6	46725949	.	T	C	1	2	3	0	0	3	0	0
6	46725966	.	T	A	1	5	6	0	0	6	0	0
6	46726080	.	A	G	12	4	16	0	0	16	0	0
6	46726234	.	T	G	4	3	7	0	3	10	0	0
6	46726254	.	G	A	1	6	7	0	0	7	0	0
6	46726901	.	C	T	3	2	5	0	1	6	0	0
6	47006599	.	G	A	1	3	4	0	0	4	0	0
6	47006611	.	A	G	4	4	8	0	1	9	0	0
6	47032679	.	C	T	9	8	17	0	1	18	0	0
6	47032772	.	A	G	7	9	16	0	0	16	0	0
6	47054448	.	A	G	3	1	4	0	0	4	0	0
6	47246513	.	C	T	9	7	16	0	3	19	0	0
6	47460346	.	T	A	1	3	4	0	1	5	0	0
6	47460906	.	G	A	1	2	3	0	1	4	0	0
6	47530011	.	A	G	2	2	4	0	0	4	0	0
6	47530428	.	T	C	2	4	6	0	0	6	0	0
6	47530562	.	G	T	2	2	4	0	0	4	0	0
6	47530563	.	T	A	2	2	4	0	0	4	0	0
6	47530828	.	C	T	0	5	5	0	3	8	0	0
6	47531176	.	G	C	2	0	2	0	3	5	0	0
6	47540279	.	C	T	3	0	3	0	0	3	0	0
6	47540405	.	A	T	1	2	3	0	0	3	0	0
6	47558374	.	C	T	0	1	1	0	1	2	0	0
6	47558827	.	C	T	0	2	2	0	1	3	0	0
6	47582179	.	G	A	1	3	4	0	0	4	0	0
6	47809905	.	T	G	3	2	5	0	0	5	0	0
6	47810323	.	A	G	6	6	12	0	0	12	0	0
6	47810671	.	T	A	11	7	18	0	0	18	0	0
6	47810688	.	T	C	8	0	8	0	5	13	0	0
6	47810804	.	A	T	6	3	9	0	1	10	0	0
6	47810810	.	T	A	3	5	8	0	0	8	0	0
6	47810941	.	C	T	0	3	3	0	3	6	0	0
6	47811024	.	G	A	11	6	17	0	1	18	0	0
6	47811463	.	G	A	3	2	5	0	0	5	0	0
6	47811473	.	G	A	2	2	4	0	0	4	0	0
6	47811875	.	A	C	5	3	8	0	0	8	0	0
6	47811890	.	G	A	6	3	9	0	1	10	0	0
6	47811940	.	G	A	5	7	12	0	0	12	0	0
6	47811993	.	A	G	3	4	7	0	1	8	0	0
6	47812193	.	C	A	4	3	7	0	0	7	0	0
6	47812280	.	G	C	3	0	3	0	2	5	0	0
6	47812678	.	T	C	1	2	3	0	0	3	0	0
6	47812843	.	C	T	0	3	3	0	6	9	0	0
6	47812880	.	C	G	3	2	5	0	0	5	0	0
6	47812893	.	G	A	1	2	3	0	0	3	0	0
6	47813100	.	T	G	2	3	5	0	2	7	0	0
6	47813366	.	G	A	5	4	9	0	0	9	0	0
6	47813407	.	T	A	6	3	9	0	0	9	0	0
6	47813499	.	G	A	1	4	5	0	0	5	0	0
6	47813548	.	T	C	3	3	6	0	0	6	0	0
6	47813877	.	G	A	9	3	12	0	0	12	0	0
6	47816406	.	G	C	3	5	8	0	0	8	0	0
6	47816512	.	G	A	2	3	5	0	0	5	0	0
6	47820011	.	C	A	0	3	3	0	2	5	0	0
6	47820092	.	G	A	1	2	3	0	0	3	0	0
6	47825404	.	C	A	3	2	5	0	0	5	0	0
6	47825488	.	G	A	4	2	6	0	0	6	0	0
6	47838337	.	C	T	3	1	4	0	0	4	0	0
6	47865238	.	C	G	7	2	9	0	0	9	0	0
6	47865287	.	C	A	7	7	14	0	2	16	0	0
6	47865322	.	C	T	10	8	18	0	0	18	0	0
6	47865391	.	C	T	8	12	20	0	1	21	0	0
6	47865553	.	T	C	6	3	9	0	1	10	0	0
6	47865554	.	C	G	7	0	7	0	3	10	0	0
6	47865588	.	T	C	3	8	11	0	0	11	0	0
6	47865626	.	G	T	2	4	6	0	0	6	0	0
6	47865661	.	A	T	0	4	4	0	0	4	0	0
6	47865770	.	A	C	5	4	9	0	0	9	0	0
6	47865780	.	C	G	5	3	8	0	0	8	0	0
6	47869454	.	C	T	2	5	7	0	0	7	0	0
6	47869500	.	C	T	1	6	7	0	0	7	0	0
6	47869510	.	C	G	4	2	6	0	0	6	0	0
6	47870185	.	T	C	3	0	3	0	6	9	0	0
6	47870463	.	G	A	3	2	5	0	0	5	0	0
6	47879230	.	C	T	1	2	3	0	0	3	0	0
6	48047026	.	G	A	0	1	1	0	2	3	0	0
6	48051616	.	A	G	1	0	1	0	1	2	0	0
6	48051766	.	G	A	2	1	3	0	0	3	0	0
6	48052310	.	C	T	3	8	11	0	1	12	0	0
6	48054766	.	C	T	3	3	6	0	0	6	0	0
6	48057928	.	C	T	10	15	25	0	0	25	0	0
6	48058088	.	T	A	1	4	5	0	0	5	0	0
6	48058160	.	T	G	4	5	9	1	1	11	0	0
6	48058628	.	A	G	4	6	10	0	0	10	0	0
6	48241515	.	T	C	1	1	2	0	1	3	0	0
6	48294637	.	A	G	1	5	6	0	0	6	0	0
6	48312582	.	A	G	1	1	2	0	0	2	0	0
6	48323373	.	A	T	18	10	28	0	0	28	0	0
6	48323476	.	A	G	6	4	10	0	11	21	0	0
6	48325997	.	C	G	15	10	25	0	1	26	0	0
6	48333375	.	C	T	0	1	1	0	3	4	0	0
6	48333480	.	C	T	0	12	12	0	11	23	0	0
6	48333483	.	C	T	11	9	20	0	2	22	0	0
6	48350213	.	G	A	1	3	4	0	0	4	0	0
6	48352739	.	C	T	2	2	4	0	0	4	0	0
6	48366555	.	T	C	0	1	1	0	0	1	0	0
6	48366570	.	A	C	0	1	1	0	0	1	0	0
6	48368655	.	T	C	1	2	3	0	0	3	0	0
6	48369069	.	A	T	3	6	9	0	0	9	0	0
6	48370800	.	T	C	1	1	2	0	0	2	0	0
6	48375954	.	T	G	2	6	8	0	0	8	0	0
6	48381090	.	T	C	4	0	4	0	3	7	0	0
6	48381104	.	G	T	4	1	5	0	1	6	0	0
6	48383029	.	C	T	3	1	4	0	2	6	0	0
6	48383068	.	T	C	3	6	9	0	0	9	0	0
6	48383105	.	G	C	2	4	6	1	1	8	0	0
6	48383142	.	C	A	2	5	7	1	1	9	0	0
6	48383149	.	A	T	3	5	8	1	0	9	0	0
6	48383239	.	G	A	7	3	10	0	1	11	0	0
6	48383291	.	T	C	7	3	10	0	0	10	0	0
6	48383353	.	A	G	9	2	11	0	0	11	0	0
6	48383371	.	A	C	8	2	10	0	1	11	0	0
6	48383414	.	G	A	3	5	8	0	0	8	0	0
6	48383573	.	G	A	6	7	13	0	0	13	0	0
6	48383653	.	A	C	6	4	10	0	0	10	0	0
6	48383713	.	T	A	2	2	4	0	1	5	0	0
6	48384368	.	T	C	2	4	6	0	0	6	0	0
6	48384602	.	G	A	3	6	9	0	2	11	0	0
6	48394224	.	T	C	5	0	5	0	4	9	0	0
6	48417892	.	A	T	5	2	7	0	1	8	0	0
6	48425552	.	A	T	2	5	7	0	2	9	0	0
6	48425967	.	A	C	2	2	4	0	2	6	0	0
6	48425975	.	C	T	2	4	6	0	0	6	0	0
6	48426052	.	A	G	1	2	3	0	0	3	0	0
6	48426171	.	C	T	4	6	10	0	1	11	0	0
6	48426381	.	C	T	9	6	15	0	1	16	0	0
6	48426400	.	G	A	11	6	17	0	0	17	0	0
6	48426429	.	A	T	11	6	17	0	1	18	0	0
6	48426535	.	G	A	4	6	10	0	0	10	0	0
6	48426754	.	A	G	4	3	7	0	0	7	0	0
6	48437957	.	G	A	2	2	4	0	0	4	0	0
6	48439781	.	C	T	2	2	4	0	0	4	0	0
6	48439949	.	G	A	6	5	11	0	0	11	0	0
6	48440054	.	A	G	2	0	2	0	0	2	0	0
6	48473183	.	G	A	0	1	1	0	1	2	0	0
6	48689312	.	T	G	11	15	26	0	2	28	0	0
6	48689484	.	G	A	5	7	12	0	0	12	0	0
6	49048698	.	A	C	1	1	2	0	0	2	0	0
6	49098617	.	C	A	5	2	7	0	1	8	0	0
6	49100132	.	G	A	1	2	3	0	0	3	0	0
6	49105852	.	G	T	3	3	6	0	0	6	0	0
6	49106450	.	C	T	7	10	17	0	0	17	0	0
6	49106605	.	C	T	18	17	35	0	1	36	0	0
6	49106744	.	C	T	8	7	15	0	0	15	0	0
6	49107156	.	A	C	15	31	46	0	1	47	0	0
6	49107390	.	G	A	24	25	49	0	2	51	0	0
6	49107477	.	T	G	19	17	36	0	3	39	0	0
6	49108157	.	T	C	7	9	16	0	1	17	0	0
6	49108244	.	T	A	12	8	20	0	0	20	0	0
6	49108313	.	T	C	11	14	25	0	0	25	0	0
6	49108352	.	A	T	14	14	28	0	1	29	0	0
6	49108355	.	T	G	12	16	28	0	2	30	0	0
6	49108604	.	T	C	19	18	37	0	1	38	0	0
6	49108739	.	T	C	20	27	47	0	5	52	0	0
6	49108838	.	A	T	20	18	38	0	1	39	0	0
6	49108954	.	C	G	15	22	37	0	2	39	0	0
6	49108970	.	T	C	11	17	28	0	0	28	0	0
6	49108999	.	T	C	15	7	22	0	1	23	0	0
6	49109347	.	T	C	31	24	55	0	1	56	0	0
6	49109366	.	G	A	31	25	56	0	0	56	0	0
6	49115141	.	T	C	5	5	10	0	0	10	0	0
6	49115259	.	A	G	0	2	2	0	0	2	0	0
6	49115292	.	A	G	0	2	2	0	0	2	0	0
6	49139928	.	G	A	11	4	15	0	1	16	0	0
6	49159082	.	G	A	5	11	16	0	1	17	0	0
6	49413209	.	C	T	6	3	9	0	0	9	0	0
6	49413281	.	A	T	1	4	5	0	1	6	0	0
6	49413437	.	C	T	4	3	7	0	0	7	0	0
6	49413500	.	T	C	2	3	5	0	0	5	0	0
6	49413653	.	T	C	5	4	9	0	0	9	0	0
6	49414007	.	G	C	2	4	6	0	0	6	0	0
6	49414010	.	A	G	2	4	6	0	0	6	0	0
6	49520723	.	C	T	7	5	12	0	4	16	0	0
6	49534100	.	A	G	1	2	3	0	0	3	0	0
6	49534301	.	T	G	4	0	4	0	0	4	0	0
6	49544385	.	T	C	1	0	1	0	5	6	0	0
6	49551892	.	C	T	6	0	6	0	0	6	0	0
6	49556795	.	T	C	1	1	2	0	0	2	0	0
6	49556822	.	T	C	1	1	2	0	0	2	0	0
6	49573883	.	T	C	4	5	9	0	0	9	0	0
6	49575605	.	T	C	11	5	16	0	0	16	0	0
6	49575715	.	A	C	5	11	16	0	0	16	0	0
6	49575745	.	T	C	3	9	12	0	1	13	0	0
6	49575756	.	C	G	3	7	10	0	0	10	0	0
6	49575792	.	A	C	8	4	12	0	0	12	0	0
6	49575795	.	C	T	7	4	11	0	1	12	0	0
6	49576099	.	A	G	1	2	3	0	0	3	0	0
6	49576723	.	T	C	7	4	11	0	1	12	0	0
6	49576770	.	T	C	4	4	8	0	0	8	0	0
6	49577047	.	C	T	10	6	16	0	1	17	0	0
6	49577139	.	C	G	10	3	13	0	2	15	0	0
6	49577157	.	A	G	10	3	13	0	0	13	0	0
6	49577340	.	A	G	1	2	3	0	1	4	0	0
6	49577363	.	G	T	4	3	7	0	0	7	0	0
6	49577473	.	G	A	1	16	17	0	0	17	0	0
6	49577873	.	C	T	12	4	16	0	0	16	0	0
6	49578468	.	G	C	2	6	8	0	1	10	1	0
6	49579458	.	G	T	0	4	4	0	8	12	0	0
6	49580020	.	G	A	0	4	4	0	2	6	0	0
6	49583348	.	C	T	12	13	25	0	1	26	0	0
6	49628476	.	T	C	8	7	15	0	0	15	0	0
6	49635461	.	G	A	33	21	54	0	0	54	0	0
6	49636372	.	T	C	17	16	33	0	1	34	0	0
6	49651390	.	T	G	1	2	3	0	0	3	0	0
6	49652727	.	T	C	1	0	1	0	2	3	0	0
6	49652745	.	A	G	2	2	4	0	0	4	0	0
6	49652780	.	A	G	3	3	6	0	0	6	0	0
6	49723071	.	G	A	4	3	7	0	0	7	0	0
6	49730334	.	G	A	0	7	7	0	5	12	0	0
6	49732244	.	C	T	2	2	4	0	0	4	0	0
6	49734513	.	G	A	0	3	3	0	2	5	0	0
6	49737251	.	A	T	6	6	12	0	0	12	0	0
6	49737331	.	A	C	5	5	10	0	0	10	0	0
6	49737337	.	C	A	6	4	10	0	1	11	0	0
6	49737477	.	T	A	4	6	10	0	1	11	0	0
6	49737524	.	T	G	3	4	7	0	0	7	0	0
6	49737584	.	A	G	0	0	0	0	3	3	0	0
6	49737590	.	A	G	0	3	3	0	0	3	0	0
6	49737842	.	T	G	3	4	7	0	1	8	0	0
6	49737847	.	A	C	3	6	9	0	0	9	0	0
6	49737914	.	A	G	8	3	11	0	0	11	0	0
6	49738006	.	A	G	7	4	11	0	1	12	0	0
6	49738348	.	A	G	2	0	2	0	3	5	0	0
6	49738787	.	G	A	5	9	14	0	3	17	0	0
6	49738863	.	A	G	6	0	6	0	8	14	0	0
6	49739084	.	G	A	10	7	17	0	0	17	0	0
6	49739151	.	A	G	6	7	13	0	1	14	0	0
6	49739579	.	G	A	0	3	3	0	5	8	0	0
6	49739628	.	C	T	1	3	4	0	0	4	0	0
6	49739698	.	A	T	6	8	14	0	0	14	0	0
6	49739845	.	T	C	6	7	13	0	2	15	0	0
6	49739868	.	A	G	3	10	13	0	0	13	0	0
6	49740059	.	A	G	3	12	15	0	0	15	0	0
6	49740067	.	C	A	3	10	13	0	0	13	0	0
6	49740247	.	G	A	8	12	20	0	0	20	0	0
6	49744383	.	T	C	9	10	19	0	0	19	0	0
6	49744443	.	C	T	2	4	6	0	0	6	0	0
6	49749689	.	G	A	0	4	4	0	3	7	0	0
6	49751721	.	T	C	11	14	25	0	1	26	0	0
6	49757650	.	T	C	6	9	15	0	1	16	0	0
6	49760016	.	T	C	3	1	4	0	0	4	0	0
6	49760278	.	G	C	10	21	31	0	1	32	0	0
6	49760581	.	A	T	5	13	18	0	0	18	0	0
6	49760609	.	A	G	7	9	16	0	1	17	0	0
6	49760740	.	A	G	7	6	13	1	1	17	2	0
6	49761714	.	T	G	1	2	3	0	0	3	0	0
6	49771734	.	A	C	0	1	1	0	0	1	0	0
6	49777598	.	C	T	2	1	3	0	0	3	0	0
6	49777640	.	A	C	5	3	8	0	0	8	0	0
6	49780905	.	T	A	2	3	5	0	1	6	0	0
6	49782564	.	A	G	2	2	4	1	0	5	0	0
6	49789216	.	C	T	0	3	3	0	3	6	0	0
6	49793870	.	T	G	1	1	2	0	0	2	0	0
6	49796925	.	A	T	7	1	8	0	1	9	0	0
6	49799982	.	C	T	3	2	5	0	1	6	0	0
6	49811940	.	C	T	0	6	6	0	8	14	0	0
6	49812476	.	G	A	12	8	20	0	1	21	0	0
6	49816372	.	A	G	8	4	12	0	0	12	0	0
6	49901591	.	C	T	12	13	25	0	0	25	0	0
6	49914387	.	T	C	19	15	34	0	1	35	0	0
6	49919063	.	A	G	2	0	2	0	0	2	0	0
6	49919211	.	C	T	7	15	22	0	2	24	0	0
6	49919232	.	A	T	10	11	21	0	0	21	0	0
6	49919326	.	T	A	12	19	31	0	0	31	0	0
6	49919358	.	C	T	15	21	36	0	1	37	0	0
6	49919908	.	A	G	15	0	15	0	17	32	0	0
6	49920159	.	T	A	6	3	9	0	1	10	0	0
6	49920218	.	A	T	8	12	20	0	2	22	0	0
6	49920253	.	A	G	7	0	7	0	11	18	0	0
6	49920392	.	C	T	2	4	6	0	0	6	0	0
6	49920405	.	A	C	1	4	5	0	0	5	0	0
6	49920433	.	A	G	3	0	3	0	6	9	0	0
6	49920442	.	C	T	3	6	9	0	0	9	0	0
6	49920468	.	G	A	3	13	16	0	1	17	0	0
6	49920498	.	T	A	2	13	15	0	0	15	0	0
6	49920514	.	T	C	2	13	15	0	0	15	0	0
6	49920614	.	T	C	2	2	4	0	1	5	0	0
6	49920626	.	T	A	2	0	2	0	1	3	0	0
6	49921770	.	G	A	0	4	4	0	8	12	0	0
6	49921853	.	T	A	8	9	17	2	0	19	0	0
6	50382957	.	G	A	1	12	13	0	15	28	0	0
6	50389352	.	C	T	13	10	23	0	1	24	0	0
6	50389424	.	G	A	2	1	3	0	0	3	0	0
6	50401756	.	T	A	15	16	31	0	1	32	0	0
6	50401894	.	A	T	16	17	33	0	1	34	0	0
6	50402037	.	T	G	16	21	37	0	1	38	0	0
6	50402294	.	G	A	10	14	24	0	3	27	0	0
6	50404635	.	T	A	10	7	17	0	0	17	0	0
6	50404677	.	A	G	14	19	33	0	1	34	0	0
6	50408885	.	G	A	0	1	1	0	1	2	0	0
6	50413410	.	G	A	11	16	27	0	0	27	0	0
6	50413422	.	C	A	14	15	29	0	0	29	0	0
6	50413449	.	T	A	13	13	26	0	1	27	0	0
6	50414033	.	C	A	5	11	16	0	0	16	0	0
6	50414089	.	A	G	5	2	7	0	0	7	0	0
6	50453092	.	T	C	2	4	6	0	0	6	0	0
6	50453119	.	C	T	2	5	7	0	0	7	0	0
6	50453956	.	T	C	4	7	11	0	0	11	0	0
6	50454183	.	G	T	3	4	7	0	0	7	0	0
6	50454666	.	T	C	1	1	2	0	1	3	0	0
6	50581261	.	A	G	3	10	13	0	0	13	0	0
6	50581320	.	C	G	0	5	5	0	12	17	0	0
6	50581346	.	C	A	11	4	15	0	0	15	0	0
6	50581794	.	G	T	8	6	14	0	0	14	0	0
6	50581851	.	C	T	0	9	9	0	6	15	0	0
6	50582087	.	A	T	3	3	6	0	0	6	0	0
6	50582513	.	G	A	12	11	23	0	0	23	0	0
6	50582597	.	C	G	0	1	1	0	1	2	0	0
6	50590597	.	C	T	3	1	4	0	1	5	0	0
6	50596389	.	T	C	2	4	6	0	0	6	0	0
6	50685246	.	T	A	0	1	1	0	1	2	0	0
6	50685346	.	T	C	2	5	7	0	1	8	0	0
6	50685617	.	A	G	1	4	5	0	0	5	0	0
6	50685722	.	G	A	8	3	11	0	0	11	0	0
6	50695455	.	T	C	7	0	7	0	5	12	0	0
6	50695470	.	C	T	8	3	11	0	0	11	0	0
6	50695569	.	T	C	3	5	8	0	0	8	0	0
6	50695625	.	A	G	2	5	7	0	0	7	0	0
6	50696328	.	C	T	5	7	12	0	1	13	0	0
6	50696376	.	A	G	2	5	7	0	0	7	0	0
6	50699674	.	C	T	0	1	1	0	2	3	0	0
6	50699700	.	T	G	2	4	6	0	0	6	0	0
6	50699761	.	G	A	4	4	8	0	0	8	0	0
6	50701168	.	C	T	0	3	3	0	0	3	0	0
6	50704598	.	G	A	4	3	7	0	1	8	0	0
6	50704605	.	A	T	6	5	11	0	0	11	0	0
6	50714196	.	T	G	2	3	5	0	2	7	0	0
6	50714298	.	G	A	3	4	7	0	0	7	0	0
6	50721807	.	C	T	0	1	1	0	0	1	0	0
6	50722230	.	T	C	0	2	2	0	2	4	0	0
6	50730682	.	C	T	5	2	7	0	1	8	0	0
6	51010098	.	T	A	6	8	14	0	1	15	0	0
6	51010126	.	G	A	9	7	16	0	0	16	0	0
6	51010143	.	T	A	5	9	14	0	0	14	0	0
6	51021093	.	C	T	4	5	9	0	0	9	0	0
6	51045352	.	G	C	2	2	4	0	0	4	0	0
6	51054581	.	G	A	1	3	4	0	0	4	0	0
6	51054614	.	G	A	4	5	9	0	0	9	0	0
6	51054671	.	G	A	6	5	11	0	0	11	0	0
6	51086166	.	G	A	1	2	3	0	0	3	0	0
6	51101562	.	A	G	0	1	1	0	1	2	0	0
6	51195641	.	A	C	4	0	4	0	3	7	0	0
6	51237577	.	G	A	6	3	9	0	0	9	0	0
6	51328737	.	G	A	1	2	3	0	0	3	0	0
6	51529305	.	G	C	5	3	8	0	0	8	0	0
6	51529336	.	A	G	5	4	9	0	0	9	0	0
6	51529477	.	A	T	5	7	12	0	1	13	0	0
6	51529725	.	G	A	7	1	8	0	0	8	0	0
6	51529747	.	A	C	4	1	5	0	0	5	0	0
6	51530973	.	G	A	3	7	10	0	1	11	0	0
6	51530979	.	G	A	3	8	11	0	0	11	0	0
6	51531046	.	C	A	2	3	5	0	3	8	0	0
6	51531067	.	G	A	4	2	6	0	0	6	0	0
6	51531155	.	C	T	1	5	6	0	0	6	0	0
6	51531195	.	C	A	0	4	4	0	0	4	0	0
6	51532140	.	G	A	5	5	10	0	0	10	0	0
6	51532156	.	G	C	4	5	9	0	0	9	0	0
6	51532334	.	G	T	3	0	3	0	0	3	0	0
6	51535160	.	C	G	2	4	6	0	0	6	0	0
6	51535191	.	A	T	3	1	4	0	0	4	0	0
6	51541255	.	A	T	2	6	8	0	0	9	1	0
6	51549513	.	G	A	2	1	3	0	0	3	0	0
6	51576035	.	A	C	8	3	11	0	0	11	0	0
6	51576055	.	A	T	5	8	13	0	2	15	0	0
6	51576177	.	T	G	12	10	22	0	1	23	0	0
6	51576374	.	A	T	7	7	14	0	2	16	0	0
6	51576375	.	C	G	0	8	8	0	8	16	0	0
6	51577116	.	G	A	10	4	14	0	0	14	0	0
6	51577938	.	T	A	5	2	7	0	0	8	1	0
6	51577963	.	A	C	5	4	9	0	1	10	0	0
6	51578224	.	A	G	7	11	18	0	0	18	0	0
6	51578436	.	A	C	4	7	11	0	0	11	0	0
6	51578476	.	C	T	0	3	3	0	1	4	0	0
6	51578537	.	A	G	5	2	7	0	0	7	0	0
6	51578595	.	A	G	6	4	10	0	0	10	0	0
6	51578666	.	G	C	3	3	6	0	0	6	0	0
6	51578704	.	A	G	5	4	9	0	0	9	0	0
6	51578713	.	G	A	4	5	9	0	0	9	0	0
6	51579271	.	G	A	3	5	8	0	0	8	0	0
6	51579298	.	T	C	1	2	3	0	1	4	0	0
6	51579538	.	A	T	3	5	8	0	0	8	0	0
6	51579813	.	T	C	3	0	3	0	4	7	0	0
6	51579840	.	C	T	5	1	6	0	0	6	0	0
6	51579901	.	G	A	5	4	9	0	0	9	0	0
6	51580529	.	A	G	9	10	19	0	1	20	0	0
6	51581201	.	A	G	1	3	4	0	0	4	0	0
6	51583877	.	T	C	3	1	4	0	0	4	0	0
6	51594452	.	T	C	8	1	9	0	5	14	0	0
6	51594454	.	A	T	8	6	14	0	0	14	0	0
6	51594490	.	T	C	4	4	8	0	0	8	0	0
6	51594884	.	T	C	1	4	5	0	0	5	0	0
6	51594926	.	C	T	0	3	3	0	6	9	0	0
6	51595484	.	G	T	4	2	6	0	1	7	0	0
6	51595561	.	A	C	3	3	6	0	0	6	0	0
6	51596326	.	G	A	2	0	2	0	0	2	0	0
6	51601868	.	C	A	0	1	1	0	0	1	0	0
6	51605080	.	G	A	2	4	6	0	0	6	0	0
6	51608662	.	T	G	1	4	5	0	0	5	0	0
6	51612628	.	G	A	0	3	3	0	0	3	0	0
6	51666397	.	C	A	1	4	5	0	0	5	0	0
6	51666427	.	T	C	1	3	4	0	0	4	0	0
6	51666438	.	T	C	1	2	3	0	0	3	0	0
6	51770340	.	C	T	16	26	42	0	1	43	0	0
6	51770436	.	C	T	1	16	17	0	17	34	0	0
6	51770503	.	A	G	11	22	33	0	0	33	0	0
6	51779980	.	T	A	1	3	4	0	0	4	0	0
6	51780612	.	C	T	2	4	6	0	0	6	0	0
6	51780636	.	T	A	2	3	5	0	0	5	0	0
6	51780651	.	G	A	2	2	4	0	0	4	0	0
6	51806186	.	T	A	4	4	8	0	0	8	0	0
6	51806238	.	T	G	6	9	15	0	0	15	0	0
6	51808819	.	C	T	2	1	3	0	0	3	0	0
6	51808858	.	C	T	0	1	1	0	2	3	0	0
6	51809065	.	T	A	8	8	16	0	0	16	0	0
6	51810896	.	A	G	4	9	13	0	0	13	0	0
6	51810941	.	A	C	7	0	7	0	7	14	0	0
6	51810957	.	A	G	6	7	13	0	0	13	0	0
6	51810987	.	T	G	5	12	17	0	0	17	0	0
6	51811051	.	A	T	4	10	14	0	0	14	0	0
6	52082034	.	G	A	6	3	9	0	0	9	0	0
6	52082262	.	A	G	3	3	6	0	0	6	0	0
6	52082391	.	A	G	6	4	10	0	0	10	0	0
6	52082402	.	A	G	5	4	9	0	0	9	0	0
6	52082433	.	G	A	7	3	10	0	0	10	0	0
6	52082569	.	C	A	4	7	11	0	0	11	0	0
6	52082811	.	A	G	11	8	19	0	0	19	0	0
6	52082832	.	A	G	9	9	18	0	1	19	0	0
6	52082880	.	G	A	5	4	9	0	0	9	0	0
6	52155931	.	G	A	4	8	12	0	0	12	0	0
6	52156247	.	A	G	17	6	23	0	0	23	0	0
6	52220316	.	G	A	0	28	28	0	36	64	0	0
6	52222481	.	G	T	28	26	54	0	2	56	0	0
6	52222564	.	C	T	36	40	76	0	0	76	0	0
6	52222654	.	G	A	3	30	33	0	35	68	0	0
6	52223247	.	G	A	1	36	37	0	27	64	0	0
6	52223369	.	T	C	22	26	48	0	2	50	0	0
6	52223517	.	A	C	22	8	30	0	1	31	0	0
6	52223827	.	A	G	24	5	29	0	2	31	0	0
6	52223956	.	A	G	21	8	29	0	0	33	4	0
6	52224090	.	A	G	24	12	36	0	1	37	0	0
6	52224525	.	T	C	16	16	32	0	2	34	0	0
6	52224539	.	A	T	15	22	37	0	0	37	0	0
6	52224590	.	A	G	22	20	42	0	4	46	0	0
6	52227755	.	T	C	4	0	4	0	3	7	0	0
6	52227844	.	A	G	4	0	4	0	1	5	0	0
6	52234688	.	T	C	2	1	3	0	2	5	0	0
6	52239517	.	A	G	2	0	2	0	3	5	0	0
6	52239573	.	T	C	29	30	59	0	2	61	0	0
6	52239613	.	G	C	14	25	39	0	3	42	0	0
6	52248124	.	A	T	2	2	4	0	0	4	0	0
6	52248223	.	A	G	3	4	7	0	0	7	0	0
6	52248250	.	A	G	5	3	8	0	0	8	0	0
6	52248262	.	A	C	6	4	10	0	1	11	0	0
6	52248679	.	T	C	2	3	5	0	1	6	0	0
6	52248802	.	T	C	3	3	6	0	0	6	0	0
6	52249015	.	T	G	3	3	6	0	0	6	0	0
6	52249042	.	T	C	3	3	6	0	0	6	0	0
6	52249075	.	C	A	2	2	4	0	0	4	0	0
6	52253402	.	T	C	6	2	8	0	0	8	0	0
6	52253411	.	T	G	5	2	7	0	0	7	0	0
6	52254417	.	A	G	2	5	7	0	0	7	0	0
6	52306429	.	C	T	0	1	1	0	0	1	0	0
6	52318129	.	C	A	0	1	1	0	0	1	0	0
6	52324871	.	T	C	0	2	2	0	0	2	0	0
6	52324872	.	A	G	0	0	0	0	2	2	0	0
6	52332506	.	C	T	1	4	5	0	0	5	0	0
6	52333777	.	A	T	4	3	7	0	0	7	0	0
6	52339728	.	G	A	4	2	6	0	0	6	0	0
6	52339847	.	T	C	2	0	2	0	3	5	0	0
6	52341721	.	G	A	0	2	2	0	0	2	0	0
6	52341742	.	A	G	2	5	7	0	0	7	0	0
6	52351748	.	A	C	7	3	10	0	0	10	0	0
6	52352028	.	G	T	8	5	13	0	0	13	0	0
6	52352570	.	T	C	3	3	6	0	0	6	0	0
6	52352743	.	A	G	5	7	12	0	0	12	0	0
6	52352802	.	T	C	6	9	15	0	1	16	0	0
6	52352971	.	C	T	4	3	7	0	0	7	0	0
6	52353019	.	T	C	1	3	4	0	0	4	0	0
6	52353029	.	A	G	1	3	4	0	0	4	0	0
6	52353246	.	A	G	5	7	12	0	0	12	0	0
6	52353262	.	C	A	5	7	12	0	0	12	0	0
6	52353497	.	T	C	1	4	5	0	0	5	0	0
6	52353505	.	A	G	2	3	5	0	0	5	0	0
6	52354067	.	A	G	1	1	2	0	0	2	0	0
6	52354259	.	A	T	3	6	9	0	0	9	0	0
6	52354307	.	A	G	2	0	2	0	3	5	0	0
6	52354536	.	T	C	7	5	12	0	0	12	0	0
6	52354694	.	A	T	5	7	12	0	0	12	0	0
6	52354698	.	C	T	6	7	13	0	0	13	0	0
6	52354783	.	T	C	5	8	13	0	2	15	0	0
6	52354830	.	G	A	5	13	18	0	0	18	0	0
6	52354852	.	A	T	4	14	18	0	1	19	0	0
6	52354909	.	A	G	4	5	9	0	0	9	0	0
6	52356024	.	T	G	3	2	5	0	0	5	0	0
6	52356457	.	C	G	1	3	4	0	2	6	0	0
6	52356755	.	G	C	6	10	16	0	2	18	0	0
6	52362427	.	G	A	9	7	16	0	0	16	0	0
6	52362498	.	C	T	0	6	6	0	4	10	0	0
6	52362517	.	A	T	3	7	10	0	0	10	0	0
6	52362553	.	T	C	5	9	14	0	0	14	0	0
6	52362578	.	A	G	8	13	21	0	0	21	0	0
6	52362605	.	T	C	8	7	15	0	1	16	0	0
6	52362798	.	A	G	1	3	4	0	0	4	0	0
6	52362980	.	T	C	1	3	4	0	0	4	0	0
6	52363153	.	G	T	4	5	9	0	0	9	0	0
6	52363175	.	T	G	6	3	9	0	0	9	0	0
6	52363477	.	G	A	4	3	7	0	0	7	0	0
6	52363487	.	A	T	3	4	7	0	0	7	0	0
6	52364352	.	T	C	6	5	11	0	1	12	0	0
6	52364371	.	G	C	6	4	10	0	0	10	0	0
6	52364497	.	G	T	8	5	13	0	1	14	0	0
6	52372701	.	C	T	0	3	3	0	1	4	0	0
6	52397137	.	A	G	2	2	4	0	0	4	0	0
6	52397218	.	A	G	5	4	9	0	0	9	0	0
6	52533195	.	G	A	3	2	5	0	0	5	0	0
6	52566456	.	C	G	1	2	3	0	0	3	0	0
6	52663242	.	C	G	10	10	20	0	2	22	0	0
6	52664233	.	T	A	2	5	7	0	2	9	0	0
6	52664299	.	G	A	1	2	3	0	0	3	0	0
6	52667345	.	T	C	3	0	3	0	0	3	0	0
6	52675465	.	A	T	1	2	3	0	1	4	0	0
6	52716053	.	T	C	4	3	7	0	0	7	0	0
6	52716119	.	T	G	9	5	14	0	0	14	0	0
6	52716714	.	G	T	12	16	28	0	5	33	0	0
6	52720695	.	G	A	5	10	15	0	0	15	0	0
6	52830485	.	T	C	3	2	5	0	0	5	0	0
6	52830561	.	G	A	0	3	3	0	3	6	0	0
6	52830566	.	T	A	3	2	5	0	1	6	0	0
6	52830743	.	T	A	1	4	5	0	0	5	0	0
6	52840313	.	G	A	0	2	2	0	1	3	0	0
6	53050517	.	G	A	29	22	51	0	2	53	0	0
6	53050847	.	G	A	31	20	51	1	0	52	0	0
6	53050895	.	C	T	24	18	42	0	3	45	0	0
6	53052693	.	C	T	13	16	29	1	3	33	0	0
6	53052741	.	G	A	4	3	7	0	2	9	0	0
6	53055338	.	T	C	3	1	4	0	6	10	0	0
6	53264192	.	T	C	26	24	50	0	2	52	0	0
6	53271887	.	T	C	9	13	22	0	0	22	0	0
6	53272571	.	A	G	7	14	21	0	0	21	0	0
6	53272637	.	G	C	19	15	34	0	2	36	0	0
6	53279886	.	G	T	8	3	11	0	1	12	0	0
6	53279995	.	C	T	6	5	11	0	0	11	0	0
6	53305888	.	T	C	18	8	26	0	8	34	0	0
6	53305968	.	C	G	8	11	19	0	0	19	0	0
6	53306034	.	A	T	10	19	29	0	2	31	0	0
6	53306170	.	T	G	12	14	26	0	1	27	0	0
6	53326383	.	G	C	11	10	21	0	1	22	0	0
6	53334014	.	A	G	20	11	31	0	2	33	0	0
6	53334082	.	T	G	17	20	37	0	0	37	0	0
6	53350083	.	T	C	2	5	7	0	0	7	0	0
6	53350105	.	A	T	2	7	9	0	0	9	0	0
6	53350217	.	G	A	5	3	8	0	0	8	0	0
6	53434364	.	C	G	2	0	2	0	3	5	0	0
6	53435439	.	C	T	3	3	6	0	0	6	0	0
6	53435440	.	A	T	4	2	6	0	0	6	0	0
6	53583122	.	T	C	1	2	3	0	0	3	0	0
6	53611488	.	A	G	1	1	2	0	0	2	0	0
6	54078764	.	G	T	0	5	5	1	9	15	0	0
6	54079807	.	G	A	7	5	12	0	1	13	0	0
6	54079816	.	A	C	9	4	13	0	0	13	0	0
6	54117367	.	A	G	10	3	13	0	0	13	0	0
6	54142313	.	G	A	9	13	22	0	0	22	0	0
6	54142351	.	T	G	14	11	25	0	2	27	0	0
6	54149554	.	C	T	6	5	11	0	0	11	0	0
6	54150237	.	G	A	0	4	4	0	6	10	0	0
6	54150488	.	T	C	10	8	18	0	0	18	0	0
6	54150640	.	C	G	11	17	28	0	0	28	0	0
6	54150730	.	G	A	0	15	15	0	9	24	0	0
6	54151027	.	A	G	2	0	2	0	10	12	0	0
6	54151318	.	G	C	1	7	8	0	0	8	0	0
6	54151406	.	G	A	9	10	19	0	0	19	0	0
6	54151408	.	T	G	10	9	19	0	0	19	0	0
6	54151615	.	C	G	7	8	15	0	0	15	0	0
6	54151768	.	G	A	3	19	22	1	0	23	0	0
6	54151798	.	A	C	20	4	24	0	0	24	0	0
6	54152151	.	T	A	5	6	11	1	2	15	1	0
6	54152492	.	C	T	15	18	33	0	1	34	0	0
6	54152529	.	T	A	17	11	28	0	0	28	0	0
6	54154905	.	A	T	5	4	9	0	0	9	0	0
6	54154909	.	G	T	0	4	4	0	5	9	0	0
6	54164974	.	A	T	3	2	5	0	0	5	0	0
6	54175384	.	A	G	3	2	5	0	1	6	0	0
6	54179724	.	C	G	5	9	14	0	1	15	0	0
6	54179733	.	G	A	7	14	21	0	0	21	0	0
6	54266317	.	T	C	10	10	20	0	1	21	0	0
6	54266337	.	T	A	11	9	20	0	2	22	0	0
6	54270296	.	G	A	4	4	8	0	1	9	0	0
6	54270760	.	C	T	5	12	17	0	1	18	0	0
6	54270773	.	T	A	7	10	17	0	0	17	0	0
6	54270896	.	T	G	3	3	6	0	0	6	0	0
6	54270923	.	T	G	3	5	8	0	0	8	0	0
6	54270951	.	T	G	2	3	5	0	0	5	0	0
6	54271196	.	A	T	3	4	7	0	0	7	0	0
6	54325148	.	T	A	6	2	8	1	0	9	0	0
6	54325234	.	A	G	7	5	12	0	2	14	0	0
6	54325658	.	C	A	4	5	9	0	1	10	0	0
6	54326008	.	T	C	6	4	10	0	0	10	0	0
6	54326031	.	T	A	3	5	8	0	1	9	0	0
6	54337547	.	G	A	8	11	19	0	0	19	0	0
6	54397805	.	C	T	1	2	3	0	0	3	0	0
6	54409160	.	T	A	0	3	3	0	0	3	0	0
6	54409807	.	A	T	1	0	1	0	0	1	0	0
6	54417304	.	A	C	1	1	2	0	2	4	0	0
6	54417312	.	T	G	1	0	1	0	3	4	0	0
6	54421228	.	T	G	4	0	4	0	5	9	0	0
6	54422087	.	A	G	1	6	7	0	0	7	0	0
6	54422599	.	T	A	4	5	9	0	0	9	0	0
6	54422635	.	T	A	3	3	6	0	0	6	0	0
6	54438466	.	G	A	14	8	22	0	0	22	0	0
6	54698232	.	A	G	2	1	3	0	0	3	0	0
6	54702162	.	G	A	1	2	3	0	0	3	0	0
6	54702166	.	A	G	1	0	1	0	2	3	0	0
6	54704856	.	T	A	3	5	8	0	0	8	0	0
6	54807158	.	G	A	1	1	2	0	0	2	0	0
6	54815767	.	A	C	1	1	2	0	0	2	0	0
6	54838467	.	G	A	15	14	29	0	0	29	0	0
6	54838496	.	T	C	16	17	33	0	1	34	0	0
6	54840083	.	T	C	7	1	8	0	12	20	0	0
6	54843108	.	T	G	15	11	26	0	0	26	0	0
6	54888903	.	C	T	1	2	3	0	0	3	0	0
6	54888975	.	T	C	4	3	7	0	0	7	0	0
6	54889038	.	C	T	4	4	8	0	0	8	0	0
6	54900913	.	A	C	3	1	4	0	0	4	0	0
6	54959695	.	T	C	2	2	4	0	0	4	0	0
6	54970317	.	T	C	1	3	4	0	0	4	0	0
6	54970870	.	C	T	1	0	1	0	0	1	0	0
6	54978063	.	G	A	3	1	4	0	0	4	0	0
6	54998449	.	C	T	1	1	2	0	0	2	0	0
6	54998500	.	A	G	1	1	2	0	0	2	0	0
6	55000756	.	T	C	4	3	7	0	0	7	0	0
6	55006252	.	A	G	3	3	6	0	0	6	0	0
6	55006778	.	C	T	4	5	9	0	0	9	0	0
6	55006971	.	C	T	0	1	1	0	0	1	0	0
6	55010951	.	T	C	3	3	6	0	0	6	0	0
6	55010972	.	C	T	1	2	3	0	0	3	0	0
6	55016579	.	G	T	3	4	7	0	1	8	0	0
6	55017151	.	T	G	3	3	6	0	0	6	0	0
6	55020076	.	A	C	1	4	5	0	0	5	0	0
6	55020094	.	G	A	0	6	6	0	5	11	0	0
6	55020288	.	A	G	6	0	6	0	13	19	0	0
6	55020327	.	A	T	11	8	19	0	2	21	0	0
6	55020477	.	C	A	5	6	11	0	0	11	0	0
6	55020526	.	A	T	3	3	6	0	0	6	0	0
6	55021617	.	T	C	3	4	7	0	1	8	0	0
6	55021941	.	A	T	4	7	11	0	3	14	0	0
6	55021943	.	G	T	0	8	8	0	6	14	0	0
6	55022039	.	A	G	6	11	17	0	0	17	0	0
6	55022109	.	T	C	7	10	17	0	0	17	0	0
6	55022114	.	T	A	7	11	18	0	0	18	0	0
6	55022263	.	G	C	3	2	5	0	0	5	0	0
6	55022286	.	A	T	3	2	5	0	0	5	0	0
6	55022319	.	A	T	5	3	8	0	0	8	0	0
6	55022330	.	A	T	5	3	8	0	0	8	0	0
6	55022437	.	C	T	5	6	11	0	0	11	0	0
6	55217796	.	A	G	12	6	18	0	0	18	0	0
6	55217903	.	A	G	3	2	5	0	0	5	0	0
6	55218047	.	A	G	2	5	7	0	0	7	0	0
6	55218127	.	A	G	4	7	11	0	0	11	0	0
6	55218137	.	A	G	4	8	12	0	0	12	0	0
6	55218340	.	A	G	4	5	9	0	0	9	0	0
6	55218360	.	C	T	0	9	9	0	1	10	0	0
6	55277487	.	G	T	12	15	27	0	0	27	0	0
6	55277559	.	T	G	17	12	29	0	0	29	0	0
6	55291948	.	C	T	1	2	3	0	0	3	0	0
6	55299921	.	C	T	0	0	0	0	1	1	0	0
6	55302512	.	G	A	0	0	0	0	1	1	0	0
6	55302515	.	G	A	1	0	1	0	0	1	0	0
6	55328532	.	A	C	3	0	3	0	0	3	0	0
6	55332516	.	G	A	2	1	3	0	0	3	0	0
6	55337385	.	G	A	5	5	10	0	1	11	0	0
6	55346191	.	A	T	1	2	3	0	0	3	0	0
6	55353174	.	G	T	0	2	2	0	2	4	0	0
6	55366636	.	C	T	3	0	3	0	0	3	0	0
6	55373039	.	C	T	7	5	12	0	0	12	0	0
6	55373048	.	T	C	7	6	13	0	1	14	0	0
6	55373081	.	C	T	4	2	6	0	0	6	0	0
6	55383374	.	T	C	0	2	2	0	0	2	0	0
6	55393020	.	C	T	19	9	28	0	1	29	0	0
6	55393047	.	C	T	15	11	26	0	0	26	0	0
6	55397061	.	A	G	3	3	6	0	0	6	0	0
6	55397150	.	T	A	8	4	12	0	0	12	0	0
6	55397261	.	T	C	6	0	6	0	5	11	0	0
6	55397302	.	T	C	7	3	10	0	0	10	0	0
6	55399124	.	A	G	3	3	6	0	0	6	0	0
6	55415774	.	A	G	1	1	2	0	0	2	0	0
6	55422890	.	C	T	2	0	2	0	0	2	0	0
6	55429885	.	A	C	7	6	13	0	0	14	1	0
6	55429903	.	C	T	3	5	8	0	0	8	0	0
6	55432278	.	C	G	8	1	9	0	14	23	0	0
6	55432787	.	A	G	16	21	37	0	2	39	0	0
6	55432811	.	T	C	15	21	36	0	1	37	0	0
6	55434178	.	C	T	8	2	10	0	2	12	0	0
6	55436386	.	G	A	25	27	52	0	1	53	0	0
6	55436548	.	A	G	28	0	28	0	26	54	0	0
6	55436644	.	C	T	15	20	35	0	1	36	0	0
6	55436665	.	C	T	16	23	39	0	0	39	0	0
6	55436701	.	C	T	19	14	33	0	2	35	0	0
6	55436881	.	A	C	3	13	16	0	0	16	0	0
6	55449309	.	A	T	8	4	12	0	0	12	0	0
6	55449409	.	A	C	5	1	6	0	1	7	0	0
6	55449451	.	A	G	2	4	6	0	1	7	0	0
6	55449483	.	G	A	5	4	9	0	0	9	0	0
6	55451944	.	T	C	3	0	3	0	3	6	0	0
6	55452013	.	A	G	5	5	10	0	0	10	0	0
6	55453891	.	G	C	8	0	8	0	5	13	0	0
6	55469606	.	G	A	7	9	16	0	0	16	0	0
6	55476356	.	G	A	1	2	3	0	0	3	0	0
6	55479036	.	T	C	5	2	7	0	0	7	0	0
6	55482224	.	G	C	1	0	1	0	3	4	0	0
6	55486027	.	A	G	1	1	2	0	0	2	0	0
6	55910674	.	A	C	2	0	2	1	2	5	0	0
6	56076919	.	C	T	6	8	14	0	1	15	0	0
6	56079175	.	A	G	3	1	4	0	0	4	0	0
6	56080308	.	A	C	2	5	7	0	0	7	0	0
6	56116724	.	C	T	5	5	10	0	0	10	0	0
6	56116741	.	C	T	1	2	3	0	0	3	0	0
6	56132336	.	C	A	2	6	8	0	1	9	0	0
6	56132360	.	A	G	2	7	9	0	0	9	0	0
6	56138404	.	C	T	16	14	30	0	1	31	0	0
6	56138953	.	T	A	5	3	8	0	0	8	0	0
6	56139130	.	A	G	1	0	1	0	7	8	0	0
6	56139188	.	T	A	7	5	12	0	0	12	0	0
6	56683093	.	G	T	1	0	1	0	0	1	0	0
6	56683099	.	G	A	1	0	1	0	0	1	0	0
6	56779752	.	A	G	2	2	4	0	0	4	0	0
6	56779781	.	C	T	0	3	3	0	2	5	0	0
6	56804191	.	A	G	1	2	3	0	0	3	0	0
6	57401665	.	C	T	1	2	3	0	0	3	0	0
6	57403545	.	G	A	1	2	3	0	1	4	0	0
6	57409712	.	T	G	0	1	1	0	0	1	0	0
6	57425812	.	G	C	1	2	3	0	1	4	0	0
6	57436347	.	A	G	1	4	5	0	0	5	0	0
6	57439021	.	T	C	7	4	11	0	0	11	0	0
6	57439089	.	T	G	0	2	2	0	0	2	0	0
6	57455557	.	T	C	3	3	6	0	0	6	0	0
6	57459343	.	G	A	5	1	6	0	0	6	0	0
6	57465261	.	T	C	1	0	1	0	0	1	0	0
6	57465762	.	A	G	3	1	4	0	0	4	0	0
6	57476328	.	A	C	1	0	1	0	3	4	0	0
6	57476343	.	G	A	1	2	3	0	1	4	0	0
6	57492086	.	G	A	12	6	18	0	2	20	0	0
6	57492141	.	G	A	6	7	13	0	0	13	0	0
6	57492167	.	T	A	6	4	10	0	0	10	0	0
6	57494342	.	T	C	0	0	0	0	1	1	0	0
6	57494354	.	C	G	0	1	1	0	0	1	0	0
6	57498034	.	C	A	2	1	3	0	0	3	0	0
6	57498040	.	G	A	2	1	3	0	0	3	0	0
6	57498088	.	T	C	2	1	3	0	0	3	0	0
6	57498253	.	A	G	4	4	8	0	0	8	0	0
6	57498255	.	A	T	4	3	7	0	1	8	0	0
6	57500563	.	G	A	1	3	4	0	0	4	0	0
6	57516039	.	A	C	1	3	4	0	0	4	0	0
6	57523301	.	G	A	1	1	2	0	0	2	0	0
6	57523315	.	T	G	1	1	2	0	0	2	0	0
6	57526109	.	G	A	0	1	1	0	0	1	0	0
6	57630961	.	T	C	7	5	12	0	0	12	0	0
6	57722768	.	A	G	1	3	4	0	0	4	0	0
6	57781827	.	G	A	0	2	2	0	1	3	0	0
6	57909090	.	T	C	9	0	9	0	16	25	0	0
6	57930218	.	A	G	4	2	6	0	0	6	0	0
6	57930338	.	C	T	0	3	3	0	5	8	0	0
6	57984041	.	C	T	3	3	6	0	1	7	0	0
6	57984173	.	T	C	12	0	12	0	12	24	0	0
6	58038322	.	T	C	2	0	2	0	0	2	0	0
6	58300429	.	C	T	2	3	5	0	0	5	0	0
6	58304147	.	T	C	1	1	2	0	0	2	0	0
6	58307489	.	A	G	1	1	2	0	1	3	0	0
6	58315258	.	T	A	1	1	2	0	0	2	0	0
6	58315270	.	G	C	0	1	1	0	2	3	0	0
6	58315333	.	T	C	10	5	15	0	0	15	0	0
6	58334566	.	A	C	8	5	13	0	1	14	0	0
6	58359460	.	T	C	2	2	4	0	0	4	0	0
6	58373985	.	T	A	5	3	8	0	1	9	0	0
6	58374508	.	T	C	2	1	3	0	1	4	0	0
6	58376845	.	T	C	3	2	5	0	0	5	0	0
6	58382815	.	A	G	0	1	1	0	0	1	0	0
6	58384122	.	C	T	2	1	3	0	0	3	0	0
6	58389139	.	C	T	2	6	8	0	0	8	0	0
6	58395372	.	G	A	2	5	7	0	1	8	0	0
6	58395451	.	C	A	11	13	24	0	0	24	0	0
6	58459515	.	A	G	0	4	4	0	0	4	0	0
6	58459557	.	G	C	0	4	4	0	0	4	0	0
6	58495256	.	C	T	5	8	13	0	0	13	0	0
6	58495315	.	A	C	4	5	9	0	1	10	0	0
6	58495436	.	C	T	7	5	12	0	0	12	0	0
6	58495634	.	G	A	1	8	9	0	4	13	0	0
6	58496002	.	A	G	5	0	5	0	7	12	0	0
6	58496148	.	T	C	5	7	12	0	1	13	0	0
6	58496313	.	A	G	1	1	2	0	1	3	0	0
6	58496698	.	A	G	1	6	7	0	0	7	0	0
6	58496761	.	T	C	3	3	6	0	0	6	0	0
6	58496801	.	G	T	3	2	5	0	0	5	0	0
6	58497227	.	T	G	1	4	5	0	0	5	0	0
6	58497267	.	G	T	3	2	5	0	0	5	0	0
6	58497554	.	A	C	3	3	6	0	0	6	0	0
6	58497628	.	T	C	1	2	3	0	0	3	0	0
6	58497805	.	A	C	2	2	4	0	0	4	0	0
6	58498021	.	C	T	2	5	7	0	0	7	0	0
6	58498101	.	T	G	3	2	5	0	0	5	0	0
6	58498107	.	C	A	3	2	5	0	0	5	0	0
6	58499600	.	A	C	6	2	8	0	0	8	0	0
6	58522689	.	C	G	13	0	13	0	10	23	0	0
6	58522695	.	A	G	14	8	22	0	1	23	0	0
6	58524509	.	C	A	1	2	3	0	0	3	0	0
6	58528602	.	A	G	3	1	4	0	0	4	0	0
6	58528617	.	A	G	1	0	1	0	0	1	0	0
6	58553387	.	G	A	5	10	15	0	0	15	0	0
6	58553424	.	T	C	21	16	37	0	1	38	0	0
6	58560795	.	C	T	29	19	48	0	0	48	0	0
6	58561003	.	C	T	13	18	31	0	2	33	0	0
6	58561080	.	T	G	15	22	37	0	0	37	0	0
6	58561186	.	A	C	10	19	29	0	1	30	0	0
6	58561190	.	C	G	11	20	31	0	0	31	0	0
6	58562114	.	G	A	28	2	30	0	0	30	0	0
6	58562146	.	T	A	23	1	24	0	5	29	0	0
6	58562407	.	T	A	8	7	15	0	5	20	0	0
6	58562935	.	G	A	18	31	49	0	1	50	0	0
6	58563093	.	T	A	17	30	47	0	1	48	0	0
6	58563157	.	T	C	18	24	42	0	2	44	0	0
6	58563159	.	G	A	17	26	43	0	1	44	0	0
6	58563229	.	A	C	19	15	34	0	0	34	0	0
6	58563302	.	A	T	16	12	28	0	3	31	0	0
6	58563305	.	G	A	1	14	15	0	17	32	0	0
6	58563374	.	C	T	12	11	23	0	1	24	0	0
6	58563415	.	A	T	10	5	15	0	0	15	0	0
6	58698673	.	A	G	8	5	13	0	2	15	0	0
6	58698875	.	C	A	6	11	17	0	0	17	0	0
6	58698960	.	C	T	8	3	11	0	0	11	0	0
6	58708185	.	A	G	3	9	12	0	0	12	0	0
6	58708194	.	T	C	5	12	17	0	0	17	0	0
6	58708227	.	T	G	7	12	19	0	0	19	0	0
6	58712268	.	C	T	6	7	13	0	1	14	0	0
6	58712564	.	A	T	8	5	13	0	0	13	0	0
6	58723254	.	C	G	5	4	9	0	1	10	0	0
6	58723383	.	T	G	14	9	23	0	0	23	0	0
6	58725930	.	T	C	8	9	17	0	0	17	0	0
6	58726066	.	G	A	0	15	15	0	9	24	0	0
6	58728670	.	G	A	0	0	0	0	1	1	0	0
6	58728907	.	C	T	5	6	11	0	0	11	0	0
6	58728915	.	G	T	6	5	11	0	0	11	0	0
6	58730208	.	A	T	3	7	10	0	0	10	0	0
6	58730603	.	A	G	3	4	7	0	0	7	0	0
6	58730657	.	T	C	6	5	11	0	4	15	0	0
6	58768370	.	G	A	5	0	5	1	1	7	0	0
6	58773647	.	T	G	4	0	4	0	0	4	0	0
6	58773785	.	C	T	0	15	15	0	12	27	0	0
6	58773788	.	A	G	11	16	27	0	0	27	0	0
6	58773824	.	G	T	4	8	12	0	0	12	0	0
6	58780811	.	C	T	5	6	11	0	0	11	0	0
6	58781083	.	A	G	12	7	19	0	0	19	0	0
6	58781128	.	C	T	14	6	20	0	0	20	0	0
6	58784777	.	C	T	1	5	6	0	11	17	0	0
6	58786939	.	C	T	12	4	16	0	0	16	0	0
6	58789896	.	A	G	1	3	4	0	0	4	0	0
6	58828036	.	A	G	10	5	15	0	0	15	0	0
6	58828322	.	A	T	10	3	13	0	2	15	0	0
6	58852853	.	G	A	7	1	8	0	0	8	0	0
6	58856151	.	C	T	2	3	5	0	0	5	0	0
6	58857940	.	A	G	1	0	1	0	0	1	0	0
6	58862328	.	A	G	13	0	13	0	13	26	0	0
6	58863294	.	T	C	4	5	9	0	0	9	0	0
6	58867018	.	A	G	30	2	32	0	19	51	0	0
6	58867048	.	A	G	26	1	27	0	12	40	1	0
6	58867090	.	A	T	20	12	32	0	0	32	0	0
6	58867093	.	C	T	18	12	30	0	2	32	0	0
6	58867206	.	A	G	9	0	9	0	10	19	0	0
6	58867282	.	G	A	5	3	8	0	1	9	0	0
6	58867329	.	G	C	10	3	13	0	1	14	0	0
6	58867372	.	A	T	16	10	26	0	3	29	0	0
6	58873800	.	T	C	1	1	2	0	0	2	0	0
6	58873918	.	T	C	4	4	8	0	0	8	0	0
6	58873926	.	G	C	7	4	11	0	0	11	0	0
6	58874121	.	T	C	5	0	5	0	4	9	0	0
6	58875650	.	C	T	0	2	2	0	4	6	0	0
6	58875665	.	T	C	4	1	5	0	2	7	0	0
6	58878032	.	A	C	3	5	8	0	0	8	0	0
6	58878077	.	T	C	0	3	3	0	0	3	0	0
6	58886232	.	A	C	0	2	2	0	0	2	0	0
6	58886247	.	C	T	0	1	1	0	0	1	0	0
6	58889093	.	T	G	2	2	4	0	1	5	0	0
6	58889258	.	T	G	7	7	14	0	0	14	0	0
6	58889488	.	G	A	4	3	7	0	0	7	0	0
6	58889531	.	A	T	3	3	6	0	0	6	0	0
6	58889552	.	A	G	2	2	4	0	0	4	0	0
6	58889713	.	T	C	3	5	8	0	2	10	0	0
6	58892027	.	A	G	1	9	10	0	0	10	0	0
6	58892363	.	G	A	5	2	7	0	1	8	0	0
6	58918095	.	T	C	3	2	5	0	0	5	0	0
6	58918506	.	A	G	20	0	20	0	16	36	0	0
6	58934546	.	T	C	2	3	5	0	0	5	0	0
6	58939261	.	T	C	1	4	5	0	0	5	0	0
6	58942857	.	G	T	1	3	4	0	0	4	0	0
6	58950079	.	C	G	2	1	3	0	0	3	0	0
6	59428824	.	T	A	1	2	3	0	1	4	0	0
6	59429530	.	T	C	2	3	5	0	0	5	0	0
6	59671954	.	A	G	4	1	5	0	7	12	0	0
6	59679633	.	G	A	0	7	7	0	10	17	0	0
6	59679636	.	C	A	7	8	15	0	1	16	0	0
6	59681450	.	A	T	2	2	4	0	0	4	0	0
6	59681464	.	G	A	2	2	4	0	0	4	0	0
6	59691533	.	C	T	9	7	16	0	2	18	0	0
6	59813578	.	G	A	0	3	3	0	1	4	0	0
6	59813608	.	A	G	3	13	16	0	1	17	0	0
6	59813857	.	G	A	1	0	1	0	1	2	0	0
6	59813905	.	A	G	11	0	11	0	7	18	0	0
6	59819362	.	C	T	14	9	23	0	3	26	0	0
6	59824482	.	C	T	19	18	37	0	0	37	0	0
6	59824496	.	C	T	18	15	33	0	2	35	0	0
6	59824672	.	C	T	20	15	35	0	2	37	0	0
6	59824736	.	C	T	16	11	27	0	1	28	0	0
6	59832922	.	T	C	12	10	22	0	0	22	0	0
6	59833006	.	T	A	10	13	23	0	0	23	0	0
6	59833007	.	A	G	9	13	22	0	1	23	0	0
6	59837587	.	C	G	3	5	8	0	0	8	0	0
6	59837747	.	G	A	1	5	6	0	12	18	0	0
6	59839033	.	G	A	2	7	9	0	14	23	0	0
6	59839048	.	G	A	12	5	17	0	1	18	0	0
6	59841394	.	G	A	2	8	10	0	5	15	0	0
6	59848119	.	C	T	10	11	21	0	0	21	0	0
6	59848345	.	T	C	23	22	45	0	2	47	0	0
6	59848894	.	T	C	14	22	36	0	1	37	0	0
6	59850253	.	C	T	19	13	32	0	0	32	0	0
6	59850308	.	T	C	14	16	30	0	1	31	0	0
6	59854344	.	G	T	0	3	3	0	6	9	0	0
6	59874147	.	G	A	0	2	2	0	2	4	0	0
6	59882680	.	T	C	11	11	22	0	2	24	0	0
6	59882704	.	T	C	11	10	21	0	1	22	0	0
6	59883154	.	G	A	9	6	15	0	0	15	0	0
6	59889640	.	G	T	0	0	0	0	2	2	0	0
6	59891289	.	T	C	0	8	8	0	0	8	0	0
6	59892864	.	C	T	3	2	5	0	0	5	0	0
6	59894548	.	T	C	11	9	20	0	1	21	0	0
6	59894580	.	T	A	14	7	21	0	1	22	0	0
6	59915599	.	T	C	0	1	1	0	0	1	0	0
6	59915608	.	T	C	0	1	1	0	0	1	0	0
6	59921661	.	T	G	17	6	23	0	0	23	0	0
6	59921685	.	T	C	11	10	21	0	1	22	0	0
6	59921788	.	A	C	6	6	12	0	0	12	0	0
6	59939277	.	G	A	3	10	13	0	1	14	0	0
6	59945088	.	A	G	2	1	3	2	0	5	0	0
6	59947097	.	C	A	1	1	2	0	0	2	0	0
6	59949374	.	C	A	2	3	5	0	0	5	0	0
6	59949585	.	A	G	1	1	2	0	3	5	0	0
6	59949591	.	G	A	1	2	3	0	2	5	0	0
6	59971374	.	T	C	14	2	16	0	21	37	0	0
6	59971416	.	C	T	16	28	44	0	2	46	0	0
6	59971711	.	G	A	17	15	32	0	1	33	0	0
6	59971718	.	C	A	12	19	31	0	3	34	0	0
6	59972137	.	A	G	11	5	16	0	1	17	0	0
6	59972259	.	T	A	8	13	21	1	0	22	0	0
6	59985833	.	C	T	1	2	3	0	0	3	0	0
6	59999765	.	C	T	1	5	6	0	0	6	0	0
6	60031520	.	G	A	10	9	19	0	0	19	0	0
6	60031641	.	C	T	1	4	5	0	5	10	0	0
6	60043179	.	T	C	0	2	2	0	0	2	0	0
6	60043229	.	A	T	0	2	2	0	0	2	0	0
6	60043413	.	G	A	5	6	11	0	0	11	0	0
6	60043792	.	T	C	3	9	12	0	0	12	0	0
6	60043842	.	C	T	9	4	13	0	0	13	0	0
7	622648	.	A	C	4	0	4	0	16	20	0	0
7	742828	.	T	C	6	20	26	0	1	27	0	0
7	762326	.	G	A	2	2	4	0	0	4	0	0
7	841689	.	G	A	1	1	2	0	1	3	0	0
7	841887	.	C	T	0	3	3	1	0	4	0	0
7	847189	.	A	T	5	10	15	0	0	15	0	0
7	854854	.	C	G	1	0	1	0	0	1	0	0
7	860914	.	A	G	3	2	5	0	1	6	0	0
7	861057	.	G	C	1	4	5	0	0	5	0	0
7	1417308	.	C	G	4	4	8	0	4	12	0	0
7	1418299	.	A	G	3	3	6	0	0	7	1	0
7	1418310	.	T	C	3	2	5	0	1	6	0	0
7	1418631	.	T	C	0	4	4	0	0	4	0	0
7	1527081	.	A	G	11	5	16	0	0	16	0	0
7	1527099	.	C	T	13	6	19	0	0	19	0	0
7	1535799	.	C	T	2	2	4	0	0	4	0	0
7	1535874	.	G	C	0	1	1	0	1	2	0	0
7	1535877	.	T	C	0	2	2	0	0	2	0	0
7	1539463	.	C	T	2	2	4	0	0	4	0	0
7	1539481	.	C	T	5	2	7	0	0	7	0	0
7	1539532	.	C	T	4	2	6	0	0	6	0	0
7	1539538	.	C	T	4	2	6	0	0	6	0	0
7	1541117	.	G	T	0	6	6	0	6	12	0	0
7	1543693	.	G	C	0	3	3	0	4	7	0	0
7	1543698	.	T	C	0	0	0	0	6	6	0	0
7	1543897	.	A	C	3	3	6	0	0	6	0	0
7	1588610	.	C	T	0	2	2	0	0	2	0	0
7	1594408	.	C	T	3	3	6	0	0	6	0	0
7	1594606	.	C	A	0	1	1	0	0	1	0	0
7	1600153	.	C	T	3	2	5	0	0	5	0	0
7	1600263	.	A	T	4	1	5	0	1	6	0	0
7	1603053	.	G	T	0	9	9	0	6	15	0	0
7	1603116	.	T	G	1	0	1	0	13	14	0	0
7	1606334	.	C	T	11	6	17	0	1	18	0	0
7	1609555	.	C	T	17	8	25	0	1	26	0	0
7	1613117	.	T	C	5	9	14	0	0	14	0	0
7	1613131	.	A	G	10	9	19	0	0	19	0	0
7	1613230	.	T	G	5	0	5	0	0	5	0	0
7	1615439	.	C	T	3	1	4	0	0	4	0	0
7	1617209	.	T	A	6	7	13	0	0	13	0	0
7	1617433	.	A	C	1	11	12	0	0	12	0	0
7	1618771	.	G	A	0	11	11	0	12	23	0	0
7	1618863	.	T	C	23	8	31	0	0	31	0	0
7	1618865	.	G	A	7	21	28	0	3	31	0	0
7	3931029	.	A	G	31	12	43	0	0	43	0	0
7	3931264	.	C	T	21	23	44	0	3	47	0	0
7	3931396	.	A	T	28	27	55	0	1	56	0	0
7	3931543	.	A	T	32	13	45	0	1	46	0	0
7	3931598	.	G	T	28	24	52	0	3	55	0	0
7	3932209	.	A	T	11	16	27	0	1	29	1	0
7	3932402	.	T	C	6	9	15	0	0	15	0	0
7	3932405	.	A	T	6	10	16	0	0	16	0	0
7	3932546	.	C	A	2	2	4	0	0	4	0	0
7	3932694	.	G	A	24	4	28	0	0	28	0	0
7	3932698	.	T	C	24	4	28	0	1	29	0	0
7	3932935	.	C	A	16	14	30	0	1	31	0	0
7	3933121	.	G	A	29	20	49	0	1	50	0	0
7	3933243	.	C	A	12	14	26	0	1	27	0	0
7	3933271	.	C	T	15	15	30	0	0	30	0	0
7	3933383	.	A	C	8	0	8	0	16	24	0	0
7	3933481	.	T	C	22	0	22	0	5	27	0	0
7	3933483	.	C	T	0	5	5	0	22	27	0	0
7	3933998	.	C	T	15	9	24	0	2	26	0	0
7	3934038	.	A	T	8	13	21	0	1	22	0	0
7	3934208	.	T	C	18	6	24	0	3	27	0	0
7	3934387	.	C	T	12	10	22	0	1	23	0	0
7	3934428	.	G	T	17	11	28	0	3	31	0	0
7	3934551	.	A	T	12	3	15	0	1	16	0	0
7	3934645	.	A	C	4	8	12	0	0	12	0	0
7	3934818	.	G	A	10	3	13	0	2	15	0	0
7	3934840	.	T	A	13	3	16	0	0	16	0	0
7	3934970	.	A	G	3	16	19	0	0	19	0	0
7	3935055	.	T	C	5	13	18	0	1	19	0	0
7	3935123	.	A	G	15	13	28	0	1	29	0	0
7	3935171	.	G	C	14	8	22	0	0	22	0	0
7	3935283	.	G	A	13	11	24	0	0	24	0	0
7	3935737	.	C	T	0	14	14	0	15	29	0	0
7	3935788	.	C	A	5	9	14	0	0	14	0	0
7	3936127	.	C	T	0	7	7	0	11	18	0	0
7	3936702	.	A	G	2	3	5	0	0	5	0	0
7	3936764	.	G	A	5	7	12	0	0	12	0	0
7	3936946	.	C	T	0	6	6	0	5	11	0	0
7	3951115	.	G	A	2	0	2	0	0	2	0	0
7	3952993	.	A	G	1	0	1	0	0	1	0	0
7	3955628	.	G	A	1	0	1	0	0	1	0	0
7	4088334	.	C	T	12	14	26	0	1	27	0	0
7	4088545	.	C	T	0	16	16	0	8	24	0	0
7	4088680	.	G	A	14	19	33	0	1	34	0	0
7	4088727	.	A	T	24	15	39	0	0	39	0	0
7	4088832	.	A	G	11	28	39	0	3	42	0	0
7	4089042	.	A	G	16	14	30	0	1	31	0	0
7	4089090	.	G	A	19	6	25	0	0	25	0	0
7	4095265	.	C	T	0	11	11	0	16	27	0	0
7	4100931	.	C	T	5	10	15	0	3	18	0	0
7	4100967	.	G	A	10	23	33	0	2	35	0	0
7	4110441	.	T	C	4	0	4	0	0	4	0	0
7	4174990	.	T	C	1	2	3	0	0	3	0	0
7	4178506	.	C	A	2	4	6	0	0	6	0	0
7	4181062	.	A	T	2	2	4	0	0	4	0	0
7	4181064	.	C	T	2	2	4	0	0	4	0	0
7	4181192	.	G	A	0	3	3	0	0	3	0	0
7	4183403	.	A	T	2	2	4	0	2	6	0	0
7	4183572	.	C	T	2	3	5	0	0	5	0	0
7	4183575	.	G	A	2	3	5	0	0	5	0	0
7	4183996	.	C	T	3	5	8	0	0	8	0	0
7	4184897	.	G	T	2	5	7	0	0	7	0	0
7	4186499	.	A	G	1	3	4	0	0	4	0	0
7	4186629	.	C	T	2	2	4	0	0	4	0	0
7	5326785	.	T	A	4	5	9	0	0	9	0	0
7	5328096	.	A	C	1	1	2	0	0	2	0	0
7	7002248	.	C	T	7	4	11	0	0	11	0	0
7	7011428	.	A	C	3	3	6	2	0	8	0	0
7	7011484	.	A	C	2	2	4	0	0	4	0	0
7	7031161	.	C	T	3	2	5	0	0	5	0	0
7	7035949	.	G	A	0	2	2	0	0	2	0	0
7	7037943	.	A	G	4	3	7	0	0	7	0	0
7	7038414	.	A	G	4	3	7	0	0	7	0	0
7	7038426	.	C	T	5	5	10	0	0	10	0	0
7	7038541	.	G	A	4	5	9	2	1	12	0	0
7	7038762	.	G	A	0	3	3	0	4	7	0	0
7	7038776	.	A	T	5	3	8	0	0	8	0	0
7	7039446	.	T	A	6	3	9	0	0	9	0	0
7	7039475	.	C	G	9	7	16	0	0	16	0	0
7	7042506	.	C	T	3	3	6	0	0	6	0	0
7	7042604	.	C	T	16	11	27	0	1	28	0	0
7	7042626	.	T	G	12	13	25	0	1	26	0	0
7	7241575	.	T	C	1	3	4	0	0	4	0	0
7	7245297	.	A	G	4	2	6	0	0	6	0	0
7	7246169	.	G	T	3	2	5	0	0	5	0	0
7	7247149	.	T	G	5	3	8	0	0	8	0	0
7	7248193	.	C	T	7	8	15	0	5	20	0	0
7	7248212	.	A	T	3	7	10	0	5	15	0	0
7	7248849	.	A	G	2	2	4	0	0	4	0	0
7	7248862	.	A	G	3	3	6	0	0	6	0	0
7	7249515	.	T	A	7	4	11	0	1	12	0	0
7	7324749	.	C	T	3	3	6	0	0	6	0	0
7	7324821	.	G	T	0	3	3	0	2	5	0	0
7	7333188	.	C	T	1	5	6	0	0	6	0	0
7	7361863	.	G	A	3	3	6	0	0	6	0	0
7	7364417	.	T	C	2	2	4	0	0	4	0	0
7	7364737	.	C	A	7	5	12	0	0	12	0	0
7	7364788	.	T	C	3	8	11	0	0	11	0	0
7	7365111	.	G	T	5	2	7	0	0	7	0	0
7	7365155	.	G	A	0	4	4	0	4	8	0	0
7	7365165	.	G	A	5	4	9	0	0	9	0	0
7	7365195	.	A	T	4	4	8	0	1	9	0	0
7	7365207	.	G	A	3	3	6	0	0	6	0	0
7	7365331	.	T	A	0	2	2	0	1	3	0	0
7	7365336	.	A	T	0	3	3	0	0	3	0	0
7	7365433	.	A	G	3	0	3	0	5	8	0	0
7	7367315	.	T	A	2	1	3	0	0	3	0	0
7	7367690	.	A	G	3	0	3	0	7	10	0	0
7	7368109	.	G	C	6	5	11	0	3	14	0	0
7	7368148	.	T	C	3	8	11	0	2	13	0	0
7	7368187	.	A	G	3	3	6	0	3	9	0	0
7	7368199	.	C	T	4	3	7	0	2	9	0	0
7	7368463	.	T	A	5	2	7	0	0	7	0	0
7	7368503	.	A	T	2	6	8	0	0	8	0	0
7	7368515	.	A	G	1	6	7	0	1	8	0	0
7	7368582	.	C	T	1	5	6	0	0	6	0	0
7	7368744	.	A	G	1	8	9	0	0	9	0	0
7	7368834	.	G	T	8	11	19	0	0	19	0	0
7	7368869	.	T	C	6	10	16	0	0	16	0	0
7	7368972	.	T	A	7	4	11	0	1	12	0	0
7	7369000	.	G	T	0	4	4	0	4	8	0	0
7	7369040	.	G	A	0	8	8	0	4	12	0	0
7	7369404	.	C	T	7	4	11	0	0	11	0	0
7	7369729	.	T	A	6	5	11	0	0	11	0	0
7	7369768	.	G	A	0	6	6	0	8	14	0	0
7	7370412	.	C	A	3	4	7	0	1	8	0	0
7	7371062	.	C	T	2	4	6	0	0	6	0	0
7	7371210	.	A	G	7	3	10	0	1	11	0	0
7	7372404	.	A	G	11	9	20	0	1	21	0	0
7	7372694	.	A	G	6	20	26	0	0	26	0	0
7	7372772	.	A	G	5	0	5	0	16	21	0	0
7	7372892	.	A	G	10	10	20	0	0	20	0	0
7	7466227	.	A	T	7	3	10	0	1	11	0	0
7	7466495	.	A	G	7	9	16	0	0	16	0	0
7	7466603	.	C	T	0	9	9	0	8	17	0	0
7	7466706	.	A	G	3	6	9	0	1	10	0	0
7	7466827	.	A	T	3	3	6	0	0	6	0	0
7	7466910	.	A	G	1	4	5	0	0	5	0	0
7	7467303	.	A	T	8	4	12	0	1	13	0	0
7	7467308	.	C	T	8	6	14	0	1	15	0	0
7	7467376	.	A	G	8	6	14	0	0	15	1	0
7	7467386	.	G	A	7	5	12	0	1	13	0	0
7	7467509	.	C	A	3	3	6	0	1	7	0	0
7	7467906	.	T	A	6	10	16	0	0	16	0	0
7	7468719	.	C	T	1	3	4	0	0	4	0	0
7	7468721	.	T	C	1	0	1	0	3	4	0	0
7	7468854	.	T	C	3	0	3	0	7	10	0	0
7	7473361	.	G	A	2	2	4	0	0	4	0	0
7	7473408	.	A	G	2	2	4	0	0	4	0	0
7	7473427	.	A	C	2	0	2	0	2	4	0	0
7	7473451	.	C	A	1	3	4	0	0	4	0	0
7	7473466	.	C	T	0	3	3	0	2	5	0	0
7	7473634	.	G	T	6	5	11	0	0	11	0	0
7	7474027	.	G	A	2	2	4	0	0	4	0	0
7	7474069	.	A	G	3	2	5	0	0	5	0	0
7	7474078	.	C	A	3	3	6	0	0	6	0	0
7	7474180	.	G	A	3	2	5	0	0	5	0	0
7	7474189	.	A	G	3	2	5	0	0	5	0	0
7	7474536	.	A	G	4	4	8	0	0	8	0	0
7	7474584	.	A	T	1	1	2	0	0	2	0	0
7	7477594	.	A	T	9	16	25	0	0	25	0	0
7	7477981	.	G	T	4	2	6	0	0	6	0	0
7	7478105	.	A	G	6	8	14	0	0	14	0	0
7	7478137	.	A	G	5	4	9	0	0	9	0	0
7	7478178	.	T	C	3	3	6	0	1	7	0	0
7	7478506	.	G	T	12	9	21	0	0	21	0	0
7	7478654	.	T	C	14	10	24	0	0	24	0	0
7	7478717	.	T	G	12	11	23	0	1	24	0	0
7	7478806	.	G	A	11	12	23	0	1	24	0	0
7	7482475	.	G	A	11	15	26	0	1	27	0	0
7	7552069	.	C	T	8	5	13	0	0	13	0	0
7	7552113	.	G	A	9	12	21	0	1	22	0	0
7	7597059	.	A	G	2	0	2	0	1	3	0	0
7	7608920	.	G	A	0	5	5	0	6	11	0	0
7	7608965	.	C	T	7	5	12	0	0	12	0	0
7	7611758	.	C	T	12	13	25	0	0	25	0	0
7	7617861	.	G	A	1	17	18	0	19	37	0	0
7	7624082	.	A	G	20	15	35	0	5	40	0	0
7	7641230	.	A	T	14	18	32	0	2	34	0	0
7	7641240	.	T	G	21	18	39	0	0	39	0	0
7	7641351	.	G	A	16	18	34	0	0	34	0	0
7	7641353	.	G	A	15	19	34	0	0	34	0	0
7	7641481	.	C	T	18	12	30	0	0	30	0	0
7	7641504	.	G	A	0	12	12	0	23	35	0	0
7	7641678	.	T	A	0	16	16	0	0	16	0	0
7	7641765	.	T	C	9	4	13	0	0	13	0	0
7	7641856	.	C	A	6	4	10	0	1	11	0	0
7	7642554	.	T	A	16	10	26	0	2	28	0	0
7	7642578	.	A	G	10	1	11	0	8	19	0	0
7	7642787	.	A	T	15	15	30	0	0	30	0	0
7	7643277	.	T	C	17	17	34	0	1	35	0	0
7	7643313	.	T	C	18	18	36	0	2	38	0	0
7	7643488	.	A	G	20	23	43	0	3	46	0	0
7	7643676	.	G	A	2	19	21	0	20	41	0	0
7	7643711	.	C	A	11	19	30	0	2	32	0	0
7	7643712	.	T	C	11	19	30	0	2	32	0	0
7	7643867	.	C	T	2	3	5	0	0	6	1	0
7	7662467	.	C	G	11	13	24	0	0	24	0	0
7	7662825	.	A	C	14	0	14	0	6	20	0	0
7	7663132	.	A	G	14	8	22	0	0	22	0	0
7	7663453	.	A	T	14	9	23	0	0	23	0	0
7	7663682	.	C	T	0	6	6	0	4	10	0	0
7	7663902	.	G	T	5	8	13	2	0	15	0	0
7	7664237	.	C	T	2	3	5	0	0	5	0	0
7	7664473	.	C	T	0	5	5	0	1	6	0	0
7	7664535	.	T	A	3	3	6	0	0	6	0	0
7	7664708	.	T	A	13	16	29	0	3	32	0	0
7	7664760	.	G	T	19	13	32	0	1	33	0	0
7	7664815	.	C	A	8	4	12	0	1	13	0	0
7	7664838	.	G	T	6	5	11	0	0	11	0	0
7	7664870	.	G	T	2	1	3	0	1	4	0	0
7	7664882	.	G	C	3	2	5	0	0	5	0	0
7	7664912	.	A	C	1	4	5	0	0	5	0	0
7	7665075	.	G	T	2	3	5	0	0	5	0	0
7	7665480	.	A	C	7	8	15	0	0	15	0	0
7	7665559	.	T	A	10	12	22	0	0	22	0	0
7	7665952	.	T	A	2	2	4	0	0	4	0	0
7	7665961	.	T	C	2	1	3	0	0	3	0	0
7	7666388	.	G	A	13	9	22	0	0	22	0	0
7	7666760	.	T	A	7	6	13	0	0	13	0	0
7	7674378	.	T	C	10	0	10	0	16	26	0	0
7	7674462	.	C	G	1	5	6	0	0	6	0	0
7	7674474	.	T	A	0	3	3	0	0	3	0	0
7	7676112	.	C	T	4	7	11	0	0	11	0	0
7	7676185	.	C	T	6	3	9	0	0	9	0	0
7	7684895	.	T	A	2	1	3	0	0	3	0	0
7	7684902	.	T	C	1	0	1	0	2	3	0	0
7	7696785	.	T	A	5	8	13	0	0	13	0	0
7	7696794	.	G	T	0	9	9	0	7	16	0	0
7	7696875	.	C	A	5	8	13	0	1	14	0	0
7	7700965	.	T	G	9	1	10	0	9	19	0	0
7	7705993	.	C	G	6	0	6	0	5	11	0	0
7	7706005	.	C	T	6	9	15	0	0	15	0	0
7	7706950	.	A	G	6	6	12	0	0	12	0	0
7	7707029	.	T	G	7	8	15	0	1	16	0	0
7	7707191	.	A	C	3	2	5	0	1	6	0	0
7	7708572	.	T	C	5	5	10	0	1	11	0	0
7	7708642	.	G	A	7	3	10	0	0	10	0	0
7	7708666	.	A	C	3	8	11	0	0	11	0	0
7	7708826	.	T	G	1	4	5	0	0	5	0	0
7	7708944	.	T	A	2	3	5	0	0	5	0	0
7	7708972	.	A	C	2	4	6	0	0	6	0	0
7	7709053	.	C	T	5	3	8	0	0	8	0	0
7	7717449	.	A	G	0	1	1	0	0	1	0	0
7	7720185	.	G	A	1	2	3	0	0	3	0	0
7	7785604	.	C	T	0	1	1	0	0	1	0	0
7	7797397	.	T	G	2	2	4	0	1	5	0	0
7	7797616	.	C	A	1	2	3	0	0	3	0	0
7	8890460	.	T	A	4	3	7	0	0	7	0	0
7	8890576	.	T	C	4	4	8	0	0	8	0	0
7	8890616	.	T	C	1	0	1	0	2	3	0	0
7	8890884	.	A	G	19	19	38	0	2	40	0	0
7	8890903	.	G	A	22	15	37	0	3	40	0	0
7	8890983	.	C	A	0	16	16	0	13	29	0	0
7	8891057	.	A	T	11	15	26	0	0	26	0	0
7	8891062	.	G	T	13	10	23	0	1	24	0	0
7	8891236	.	C	G	13	12	25	0	0	25	0	0
7	8891412	.	T	C	3	2	5	0	0	5	0	0
7	8891755	.	T	G	6	5	11	4	0	15	0	0
7	8892008	.	G	T	7	2	9	0	0	9	0	0
7	8892011	.	T	A	8	2	10	0	0	10	0	0
7	8894407	.	A	G	5	2	7	0	0	7	0	0
7	8894919	.	C	T	0	5	5	0	4	9	0	0
7	8898730	.	T	C	0	3	3	0	0	3	0	0
7	8924507	.	T	C	1	0	1	0	2	3	0	0
7	8924570	.	G	A	1	0	1	0	1	2	0	0
7	8950314	.	C	A	0	1	1	0	1	2	0	0
7	9192375	.	C	A	0	1	1	0	0	1	0	0
7	9229327	.	A	C	3	8	11	0	0	11	0	0
7	9232621	.	C	G	0	4	4	0	0	4	0	0
7	9302796	.	A	G	4	4	8	0	0	8	0	0
7	9844342	.	T	C	3	0	3	0	2	5	0	0
7	10351322	.	A	G	1	3	4	0	1	5	0	0
7	10351376	.	T	C	2	3	5	0	0	5	0	0
7	10352447	.	G	A	1	4	5	0	0	5	0	0
7	10352780	.	T	A	1	6	7	0	0	7	0	0
7	10352834	.	C	A	1	4	5	0	0	5	0	0
7	10353111	.	G	A	2	3	5	0	0	5	0	0
7	10353266	.	C	A	3	5	8	0	0	8	0	0
7	10372319	.	T	G	1	6	7	0	1	8	0	0
7	10372340	.	G	A	0	3	3	0	1	4	0	0
7	10551629	.	A	G	5	3	8	0	1	9	0	0
7	10560861	.	G	A	4	2	6	0	0	6	0	0
7	10578316	.	G	T	1	1	2	0	0	2	0	0
7	10582510	.	T	C	5	3	8	0	0	8	0	0
7	10582851	.	T	C	5	2	7	0	0	7	0	0
7	10701814	.	C	A	6	9	15	0	0	15	0	0
7	10701966	.	A	T	2	4	6	0	0	6	0	0
7	10725106	.	A	T	10	2	12	0	0	12	0	0
7	10740494	.	A	G	7	0	7	0	12	19	0	0
7	10740506	.	T	C	7	14	21	0	1	22	0	0
7	10766511	.	A	G	4	1	5	0	1	6	0	0
7	10820643	.	T	C	7	8	15	0	0	16	1	0
7	10845526	.	T	C	1	1	2	0	0	2	0	0
7	10845567	.	G	C	6	16	22	0	0	22	0	0
7	10854748	.	G	A	4	6	10	0	0	10	0	0
7	10873382	.	G	T	6	7	13	0	0	13	0	0
7	10873415	.	G	A	7	6	13	0	1	14	0	0
7	10873567	.	C	T	6	12	18	0	0	18	0	0
7	10873826	.	A	G	1	3	4	0	0	4	0	0
7	10873883	.	C	T	2	2	4	0	0	4	0	0
7	10873921	.	A	G	7	0	7	0	4	11	0	0
7	10873923	.	A	C	7	4	11	0	0	11	0	0
7	10874053	.	G	A	7	4	11	0	2	13	0	0
7	10874141	.	A	T	2	3	5	0	0	6	1	0
7	10874170	.	A	T	9	5	14	0	0	14	0	0
7	10874231	.	T	C	13	11	24	0	2	26	0	0
7	10874252	.	A	C	15	11	26	0	1	27	0	0
7	10874377	.	A	T	8	9	17	0	1	18	0	0
7	10874424	.	T	C	10	13	23	0	0	23	0	0
7	10874753	.	T	C	6	12	18	0	1	19	0	0
7	10874761	.	A	T	6	11	17	0	1	18	0	0
7	10874837	.	T	A	5	7	12	0	2	14	0	0
7	10874857	.	G	C	7	8	15	0	0	15	0	0
7	10874878	.	A	G	7	10	17	0	2	19	0	0
7	10874949	.	A	G	11	1	12	0	19	31	0	0
7	10875246	.	A	T	9	12	21	0	0	21	0	0
7	10875433	.	A	G	2	10	12	0	2	14	0	0
7	10875489	.	C	T	5	9	14	0	0	14	0	0
7	10875539	.	A	G	5	12	17	0	2	19	0	0
7	10875552	.	A	G	10	9	19	0	0	19	0	0
7	10875626	.	A	G	17	0	17	0	17	34	0	0
7	10875627	.	T	C	16	17	33	0	1	34	0	0
7	10875661	.	A	G	22	7	29	0	5	34	0	0
7	10875692	.	G	C	1	16	17	0	20	37	0	0
7	10875870	.	G	A	0	6	6	0	12	18	0	0
7	10875898	.	C	T	14	9	23	0	1	24	0	0
7	10875992	.	G	A	12	9	21	0	1	22	0	0
7	10876464	.	A	G	13	15	28	0	0	28	0	0
7	10876503	.	C	A	17	20	37	0	0	37	0	0
7	10876643	.	A	G	16	23	39	1	1	41	0	0
7	10876719	.	T	C	14	19	33	0	2	35	0	0
7	10876726	.	T	C	14	20	34	0	0	34	0	0
7	10876870	.	A	G	20	0	20	0	0	20	0	0
7	10876890	.	A	T	17	8	25	0	0	25	0	0
7	10876997	.	A	G	16	2	18	0	22	40	0	0
7	10877036	.	A	C	19	18	37	0	0	37	0	0
7	10877229	.	A	G	31	16	47	0	0	47	0	0
7	10911431	.	A	G	4	3	7	0	0	7	0	0
7	10911514	.	T	G	4	3	7	0	0	7	0	0
7	10911610	.	C	A	2	2	4	0	1	5	0	0
7	10911934	.	C	G	2	5	7	0	1	8	0	0
7	10912108	.	T	C	1	6	7	0	2	9	0	0
7	11004175	.	T	C	4	16	20	2	0	22	0	0
7	11004374	.	G	T	8	8	16	0	0	16	0	0
7	11004405	.	C	T	5	3	8	0	1	9	0	0
7	11004820	.	A	G	5	0	5	0	0	5	0	0
7	11004869	.	C	G	0	9	9	0	0	9	0	0
7	11004885	.	T	C	0	11	11	0	0	11	0	0
7	11005098	.	A	C	7	8	15	0	0	15	0	0
7	11005270	.	G	A	0	7	7	0	5	12	0	0
7	11005603	.	G	A	2	3	5	0	0	5	0	0
7	11218486	.	C	T	0	2	2	0	0	2	0	0
7	11281382	.	C	T	2	0	2	0	1	3	0	0
7	11314675	.	C	T	1	1	2	0	0	2	0	0
7	11314693	.	C	T	0	1	1	0	0	1	0	0
7	11318875	.	G	A	7	4	11	0	0	11	0	0
7	11323296	.	C	G	9	1	10	0	9	19	0	0
7	11332095	.	T	G	0	1	1	0	1	2	0	0
7	11339674	.	G	A	7	5	12	0	1	13	0	0
7	11340098	.	G	A	0	3	3	0	0	3	0	0
7	11340718	.	A	G	2	5	7	0	1	8	0	0
7	11340720	.	T	C	3	4	7	0	1	8	0	0
7	11340758	.	G	T	2	3	5	0	0	5	0	0
7	11340925	.	G	A	3	0	3	0	0	3	0	0
7	11341472	.	T	G	10	13	23	0	0	23	0	0
7	11341521	.	T	C	12	9	21	0	1	22	0	0
7	11341809	.	T	C	2	10	12	0	2	14	0	0
7	11341815	.	T	A	2	11	13	0	0	13	0	0
7	11341951	.	A	C	1	6	7	0	0	7	0	0
7	11341952	.	T	A	1	6	7	0	0	7	0	0
7	11342252	.	G	T	6	4	10	0	1	11	0	0
7	11378961	.	A	T	7	8	15	0	0	15	0	0
7	11379135	.	T	C	6	4	10	0	0	10	0	0
7	11384178	.	A	G	16	10	26	0	1	27	0	0
7	11539834	.	G	A	1	2	3	0	0	3	0	0
7	11573712	.	C	T	1	1	2	0	0	2	0	0
7	11580761	.	A	G	1	2	3	0	0	3	0	0
7	11581379	.	C	T	1	2	3	0	0	3	0	0
7	11581838	.	T	C	2	2	4	0	0	4	0	0
7	11581860	.	A	T	2	2	4	0	0	4	0	0
7	11587724	.	A	T	2	2	4	0	0	4	0	0
7	11605120	.	T	G	1	0	1	0	0	1	0	0
7	12062314	.	C	T	6	5	11	0	1	12	0	0
7	12062340	.	A	G	8	10	18	0	0	18	0	0
7	12063789	.	G	A	8	5	13	0	3	16	0	0
7	12064002	.	A	G	19	10	29	0	0	29	0	0
7	12065319	.	A	T	9	14	23	0	1	24	0	0
7	12141093	.	A	C	1	2	3	0	1	4	0	0
7	12141254	.	C	A	5	2	7	0	1	8	0	0
7	12141333	.	G	A	3	3	6	0	0	6	0	0
7	12141334	.	G	A	2	3	5	0	1	6	0	0
7	12141420	.	T	C	2	2	4	0	1	5	0	0
7	12141496	.	C	A	3	2	5	0	1	6	0	0
7	12372927	.	G	A	0	0	0	0	1	1	0	0
7	12379463	.	C	T	1	3	4	0	0	4	0	0
7	12390138	.	T	G	3	3	6	0	0	6	0	0
7	12390365	.	A	T	3	6	9	0	1	10	0	0
7	12401677	.	G	T	3	3	6	0	0	6	0	0
7	12418214	.	C	A	3	5	8	0	0	8	0	0
7	12421116	.	A	G	2	0	2	0	0	2	0	0
7	12421122	.	C	T	2	0	2	0	0	2	0	0
7	12464207	.	G	A	2	2	4	0	0	4	0	0
7	12468350	.	C	G	0	5	5	0	6	11	0	0
7	12843987	.	T	C	1	8	9	0	0	9	0	0
7	12844513	.	T	C	6	4	10	0	0	10	0	0
7	12844549	.	T	C	7	1	8	0	1	9	0	0
7	13327824	.	A	C	1	0	1	0	5	6	0	0
7	13328890	.	A	T	4	2	6	0	0	6	0	0
7	13354334	.	T	C	15	7	22	0	1	23	0	0
7	13486841	.	A	T	4	9	13	0	0	13	0	0
7	13566588	.	A	G	1	2	3	0	0	3	0	0
7	13570652	.	A	G	0	0	0	1	7	8	0	0
7	13858831	.	G	A	4	2	6	0	0	6	0	0
7	13858929	.	G	A	2	2	4	0	0	4	0	0
7	13897711	.	T	C	5	2	7	0	0	7	0	0
7	13897765	.	A	C	4	6	10	0	0	10	0	0
7	13897768	.	A	C	4	0	4	0	6	10	0	0
7	13897822	.	G	A	5	3	8	0	0	8	0	0
7	13900898	.	A	G	2	4	6	0	0	6	0	0
7	13900964	.	A	G	0	2	2	0	0	2	0	0
7	13900967	.	G	A	0	2	2	0	0	2	0	0
7	14202790	.	C	T	1	3	4	0	0	4	0	0
7	14205503	.	G	A	3	3	6	0	1	7	0	0
7	14205527	.	G	C	4	3	7	0	0	7	0	0
7	14205559	.	T	C	1	4	5	0	0	5	0	0
7	14206269	.	A	G	0	1	1	0	0	1	0	0
7	14206790	.	T	G	4	3	7	0	1	8	0	0
7	14240991	.	T	C	2	3	5	0	0	5	0	0
7	14262108	.	A	T	0	1	1	0	0	1	0	0
7	14262111	.	G	T	0	1	1	0	1	2	0	0
7	14265966	.	A	T	1	3	4	0	0	4	0	0
7	14354038	.	T	C	1	4	5	0	0	5	0	0
7	14393180	.	G	A	1	3	4	0	0	4	0	0
7	14393796	.	T	C	1	2	3	0	0	3	0	0
7	14394194	.	G	A	1	2	3	0	0	3	0	0
7	14394824	.	G	T	2	6	8	0	0	8	0	0
7	14394839	.	G	C	2	7	9	0	1	10	0	0
7	14394860	.	A	C	1	6	7	0	0	8	1	0
7	14394891	.	G	A	1	5	6	0	1	7	0	0
7	14394925	.	A	G	3	7	10	0	0	10	0	0
7	14394991	.	G	A	3	4	7	0	0	7	0	0
7	14395029	.	A	G	1	2	3	0	0	3	0	0
7	14400446	.	G	A	0	2	2	0	0	2	0	0
7	14400512	.	C	T	3	4	7	0	0	7	0	0
7	14512064	.	G	A	5	3	8	0	0	8	0	0
7	14512081	.	A	C	6	2	8	0	0	8	0	0
7	14512099	.	C	G	8	3	11	0	0	11	0	0
7	14532066	.	T	C	2	4	6	0	0	6	0	0
7	14534326	.	T	C	5	0	5	0	6	11	0	0
7	14534789	.	T	C	3	1	4	0	0	4	0	0
7	14535719	.	T	C	2	4	6	0	0	6	0	0
7	14535749	.	T	A	10	10	20	0	1	21	0	0
7	14535782	.	G	T	16	15	31	0	0	31	0	0
7	14535834	.	A	C	3	6	9	0	0	9	0	0
7	14536163	.	A	G	8	4	12	0	0	12	0	0
7	14539470	.	T	C	5	3	8	0	0	8	0	0
7	14542854	.	C	T	4	5	9	0	0	9	0	0
7	14542893	.	C	T	2	5	7	0	0	7	0	0
7	14543002	.	T	C	7	11	18	0	0	18	0	0
7	14543031	.	G	A	5	9	14	0	1	15	0	0
7	14543128	.	A	T	1	4	5	0	1	6	0	0
7	14543454	.	G	T	2	3	5	0	0	5	0	0
7	14632554	.	A	C	1	1	2	0	1	3	0	0
7	14632664	.	G	A	7	5	12	0	0	12	0	0
7	14789964	.	G	A	0	4	4	0	4	8	0	0
7	14860521	.	C	T	6	10	16	0	1	17	0	0
7	14860524	.	A	C	6	10	16	0	0	16	0	0
7	14900869	.	G	A	1	2	3	0	0	3	0	0
7	14905516	.	G	C	6	0	6	0	0	6	0	0
7	14938134	.	C	T	6	7	13	0	1	14	0	0
7	14938404	.	C	T	2	3	5	0	0	5	0	0
7	15087643	.	G	A	1	2	3	0	0	3	0	0
7	15603667	.	A	T	1	3	4	0	0	4	0	0
7	15604146	.	G	A	0	2	2	0	2	4	0	0
7	15605180	.	A	T	1	3	4	0	0	4	0	0
7	15605844	.	C	T	4	2	6	0	0	6	0	0
7	15605846	.	T	C	4	2	6	0	0	6	0	0
7	15605950	.	T	C	5	5	10	0	0	10	0	0
7	15605968	.	T	A	6	3	9	0	0	9	0	0
7	15607650	.	C	T	5	6	11	0	2	13	0	0
7	15607757	.	G	A	1	8	9	0	3	12	0	0
7	15607867	.	C	T	5	3	8	0	0	8	0	0
7	15608471	.	C	T	6	6	12	0	0	12	0	0
7	15608520	.	G	A	3	5	8	0	0	8	0	0
7	15608620	.	G	A	2	4	6	0	0	6	0	0
7	15608707	.	T	G	3	2	5	0	0	5	0	0
7	15608730	.	A	C	3	2	5	0	1	6	0	0
7	15608767	.	T	A	3	2	5	0	1	6	0	0
7	15608774	.	C	G	2	2	4	0	1	5	0	0
7	15608993	.	A	G	2	2	4	1	1	6	0	0
7	15609137	.	A	C	2	6	8	0	1	9	0	0
7	15609156	.	G	A	1	3	4	0	1	5	0	0
7	15609387	.	T	A	6	2	8	0	0	8	0	0
7	15609469	.	C	T	8	12	20	0	1	21	0	0
7	15609520	.	G	A	6	5	11	0	1	12	0	0
7	15609961	.	C	T	6	10	16	0	0	16	0	0
7	15618216	.	T	C	0	1	1	0	0	1	0	0
7	15648755	.	C	T	3	5	8	0	0	8	0	0
7	15653514	.	G	A	2	6	8	0	0	8	0	0
7	15653537	.	G	A	1	2	3	0	0	3	0	0
7	15819692	.	C	T	0	1	1	0	1	2	0	0
7	15825888	.	T	C	3	0	3	0	0	3	0	0
7	15826026	.	G	A	0	1	1	0	0	1	0	0
7	15830007	.	T	C	2	4	6	0	0	6	0	0
7	15830026	.	A	G	4	4	8	0	0	8	0	0
7	15830095	.	C	T	1	4	5	0	2	7	0	0
7	15875886	.	C	T	1	2	3	0	0	3	0	0
7	15875919	.	G	C	3	3	6	0	0	6	0	0
7	15875951	.	T	G	2	2	4	0	0	4	0	0
7	15891623	.	C	A	4	1	5	0	2	7	0	0
7	15896959	.	G	C	4	2	6	0	0	6	0	0
7	15896998	.	G	A	0	2	2	0	4	6	0	0
7	15897024	.	G	A	3	4	7	0	0	7	0	0
7	15897076	.	G	A	3	2	5	0	0	5	0	0
7	15897178	.	G	A	1	2	3	0	0	3	0	0
7	15897615	.	G	T	0	4	4	0	0	4	0	0
7	15897671	.	G	T	2	3	5	0	0	5	0	0
7	15897676	.	T	C	2	3	5	0	0	5	0	0
7	15897755	.	A	G	5	7	12	0	0	12	0	0
7	15898112	.	G	T	1	4	5	0	0	5	0	0
7	15898280	.	T	C	3	4	7	0	0	7	0	0
7	15898400	.	T	C	5	2	7	0	0	7	0	0
7	15899189	.	T	C	4	3	7	0	0	7	0	0
7	15899191	.	A	G	4	3	7	0	0	7	0	0
7	15899286	.	A	G	3	4	7	0	1	8	0	0
7	15899468	.	A	T	2	7	9	0	0	9	0	0
7	15899532	.	T	A	1	11	12	0	4	16	0	0
7	15906357	.	T	G	1	3	4	0	0	4	0	0
7	15959883	.	G	T	1	0	1	0	0	1	0	0
7	16033726	.	A	G	3	2	5	0	0	5	0	0
7	16033730	.	A	G	3	2	5	0	0	5	0	0
7	16051826	.	A	T	1	1	2	0	0	2	0	0
7	16348898	.	A	G	8	13	21	0	3	24	0	0
7	16388262	.	C	T	1	2	3	0	0	3	0	0
7	16388307	.	C	T	6	8	14	0	1	15	0	0
7	16388310	.	G	C	6	9	15	0	0	15	0	0
7	16388358	.	T	C	5	8	13	0	1	14	0	0
7	16456854	.	C	T	0	6	6	0	0	6	0	0
7	16460093	.	C	T	4	5	9	0	3	12	0	0
7	16460252	.	G	A	6	4	10	0	0	10	0	0
7	16529613	.	T	C	0	1	1	0	0	1	0	0
7	16534940	.	A	G	1	2	3	0	0	3	0	0
7	16534946	.	A	G	1	1	2	0	0	2	0	0
7	16545638	.	C	T	3	6	9	0	0	9	0	0
7	16545847	.	G	A	0	2	2	0	2	4	0	0
7	16545860	.	G	T	2	2	4	0	0	4	0	0
7	16546048	.	T	A	1	1	2	0	1	3	0	0
7	16546052	.	G	C	1	2	3	0	0	3	0	0
7	16922258	.	C	T	1	2	3	0	0	3	0	0
7	16958050	.	C	T	1	3	4	0	0	4	0	0
7	16963367	.	A	G	1	0	1	0	2	3	0	0
7	16963409	.	C	T	1	1	2	0	1	3	0	0
7	16963444	.	C	A	3	2	5	0	1	6	0	0
7	16996078	.	C	T	0	3	3	0	0	3	0	0
7	17000956	.	G	A	0	1	1	0	0	1	0	0
7	17003499	.	A	T	0	1	1	0	0	1	0	0
7	17003562	.	A	G	2	0	2	0	3	5	0	0
7	17007283	.	C	T	0	1	1	0	0	1	0	0
7	17008188	.	G	T	1	0	1	0	0	1	0	0
7	17008305	.	C	T	2	2	4	0	0	4	0	0
7	17010015	.	T	C	2	2	4	0	0	4	0	0
7	17011427	.	T	C	1	5	6	0	0	6	0	0
7	17012233	.	T	G	3	2	5	0	0	5	0	0
7	17013825	.	T	C	1	2	3	0	0	3	0	0
7	17013827	.	T	A	1	2	3	0	0	3	0	0
7	17013899	.	C	T	2	2	4	0	0	4	0	0
7	17014017	.	G	C	3	2	5	0	0	5	0	0
7	17014219	.	A	G	1	4	5	0	0	5	0	0
7	17014301	.	T	C	1	4	5	0	0	5	0	0
7	17014453	.	A	C	4	7	11	0	0	11	0	0
7	17014531	.	C	A	3	7	10	0	0	10	0	0
7	17014548	.	G	T	2	7	9	0	1	10	0	0
7	17014621	.	T	A	8	4	12	0	0	12	0	0
7	17014653	.	C	T	7	3	10	0	0	10	0	0
7	17014748	.	T	C	5	4	9	0	1	10	0	0
7	17014809	.	A	C	2	3	5	0	0	5	0	0
7	17014815	.	T	C	2	4	6	0	0	6	0	0
7	17096421	.	T	C	5	4	9	0	0	9	0	0
7	17097176	.	G	A	6	4	10	0	0	10	0	0
7	17097191	.	C	T	8	7	15	0	1	16	0	0
7	17100076	.	T	C	14	5	19	0	0	19	0	0
7	17103021	.	A	G	5	3	8	0	0	8	0	0
7	17104053	.	G	A	0	4	4	0	0	4	0	0
7	17104092	.	T	A	0	2	2	0	0	2	0	0
7	17104105	.	C	T	0	2	2	0	0	2	0	0
7	17109072	.	G	C	0	1	1	0	0	1	0	0
7	17110064	.	C	T	1	1	2	0	0	2	0	0
7	17238028	.	T	C	1	3	4	0	1	5	0	0
7	17238034	.	T	G	2	3	5	0	0	5	0	0
7	17238293	.	C	T	0	5	5	0	0	5	0	0
7	17238335	.	G	A	1	6	7	0	0	7	0	0
7	17240390	.	C	T	1	2	3	0	0	3	0	0
7	17246018	.	G	A	0	3	3	0	7	10	0	0
7	17246036	.	C	T	7	3	10	0	0	10	0	0
7	17247785	.	T	A	5	11	16	0	0	16	0	0
7	17247804	.	G	C	7	2	9	0	0	9	0	0
7	17247899	.	A	C	8	9	17	0	0	17	0	0
7	17248373	.	T	G	4	0	4	0	9	13	0	0
7	17248433	.	G	A	5	5	10	0	0	10	0	0
7	17248436	.	G	A	0	5	5	0	5	10	0	0
7	17248476	.	G	T	5	4	9	0	1	10	0	0
7	17248484	.	A	C	4	4	8	0	0	8	0	0
7	17248656	.	G	A	9	3	12	0	0	12	0	0
7	17248865	.	T	A	6	3	9	0	1	10	0	0
7	17249020	.	T	C	2	4	6	0	0	6	0	0
7	17249044	.	A	G	1	4	5	0	0	5	0	0
7	17249121	.	C	T	8	7	15	0	1	16	0	0
7	17249240	.	C	A	4	4	8	0	0	8	0	0
7	17249293	.	A	T	4	2	6	0	0	6	0	0
7	17249392	.	G	A	4	3	7	0	0	7	0	0
7	17249439	.	T	A	7	6	13	0	1	14	0	0
7	17249463	.	C	A	8	4	12	0	0	12	0	0
7	17249500	.	G	C	1	2	3	0	0	3	0	0
7	17249599	.	A	G	3	2	5	0	2	7	0	0
7	17249642	.	C	T	3	5	8	0	0	8	0	0
7	17249829	.	A	T	2	6	8	0	0	8	0	0
7	17249885	.	G	A	1	7	8	0	0	8	0	0
7	17249941	.	A	T	5	4	9	0	0	9	0	0
7	17249945	.	A	C	4	4	8	0	1	9	0	0
7	17250069	.	C	T	3	5	8	0	1	9	0	0
7	17250073	.	C	A	7	3	10	0	0	10	0	0
7	17250191	.	C	T	4	19	23	0	0	23	0	0
7	17250249	.	G	A	0	11	11	0	2	13	0	0
7	17250298	.	C	T	1	4	5	0	0	5	0	0
7	17250422	.	G	T	2	10	12	0	0	12	0	0
7	17250430	.	T	A	11	3	14	0	0	14	0	0
7	17250832	.	C	T	2	11	13	0	1	14	0	0
7	17250861	.	A	G	4	8	12	0	0	12	0	0
7	17251098	.	C	A	20	8	28	0	1	29	0	0
7	17251222	.	G	A	0	20	20	0	14	34	0	0
7	17251234	.	A	G	16	19	35	0	0	35	0	0
7	17663134	.	C	T	1	1	2	0	0	2	0	0
7	17663289	.	T	C	2	3	5	0	0	5	0	0
7	17690786	.	C	T	4	4	8	0	0	8	0	0
7	17690789	.	T	C	3	3	6	0	1	7	0	0
7	17690835	.	C	T	0	3	3	0	1	4	0	0
7	17690859	.	T	A	1	3	4	0	0	4	0	0
7	17692797	.	G	A	2	7	9	0	0	9	0	0
7	17692857	.	T	C	4	5	9	0	0	9	0	0
7	17695039	.	C	T	1	4	5	0	0	5	0	0
7	17695051	.	A	G	4	3	7	0	1	8	0	0
7	17708783	.	C	T	2	4	6	0	0	6	0	0
7	17708811	.	G	A	4	3	7	0	0	7	0	0
7	17708968	.	G	A	2	2	4	0	0	4	0	0
7	17754299	.	G	A	14	13	27	0	0	27	0	0
7	17757019	.	A	G	27	26	53	0	2	55	0	0
7	17757024	.	C	T	29	26	55	0	1	56	0	0
7	17757078	.	A	G	36	17	53	0	1	54	0	0
7	17757243	.	T	G	35	6	41	0	2	43	0	0
7	17757261	.	T	G	0	40	40	0	2	42	0	0
7	17757371	.	T	C	17	33	50	0	2	52	0	0
7	17757408	.	G	A	27	20	47	0	2	49	0	0
7	17761063	.	A	C	2	3	5	0	0	5	0	0
7	17761117	.	T	G	1	2	3	0	0	3	0	0
7	17761342	.	T	G	2	4	6	0	0	6	0	0
7	17762395	.	C	T	1	0	1	0	0	1	0	0
7	17762455	.	C	G	0	2	2	0	0	2	0	0
7	17762931	.	A	T	1	4	5	0	0	5	0	0
7	17767011	.	G	T	1	0	1	0	0	1	0	0
7	17772438	.	C	G	2	2	4	0	0	4	0	0
7	17792032	.	A	C	2	2	4	0	0	4	0	0
7	17800748	.	C	T	3	2	5	0	0	5	0	0
7	17800956	.	A	G	1	3	4	0	0	4	0	0
7	17801064	.	A	C	1	4	5	0	0	5	0	0
7	17801339	.	C	A	6	2	8	0	0	8	0	0
7	17801385	.	A	G	2	4	6	0	0	6	0	0
7	17801398	.	C	T	4	2	6	0	0	6	0	0
7	17801775	.	T	C	1	2	3	0	0	3	0	0
7	17801778	.	C	T	1	2	3	0	0	3	0	0
7	17801841	.	C	T	2	4	6	0	0	6	0	0
7	17801857	.	C	A	5	2	7	0	0	7	0	0
7	17801896	.	T	G	4	1	5	0	0	5	0	0
7	17801900	.	A	G	4	0	4	0	1	5	0	0
7	17802497	.	C	A	2	2	4	0	0	4	0	0
7	17802711	.	A	T	1	4	5	0	0	5	0	0
7	17803056	.	T	G	1	3	4	0	0	4	0	0
7	17803484	.	A	G	0	2	2	0	1	3	0	0
7	17805586	.	G	C	4	0	4	0	4	8	0	0
7	17805595	.	T	A	5	4	9	0	0	9	0	0
7	17805706	.	C	G	6	2	8	0	0	8	0	0
7	17809860	.	C	T	1	1	2	0	0	2	0	0
7	17810581	.	C	T	5	7	12	0	0	12	0	0
7	17810611	.	G	A	5	6	11	0	0	11	0	0
7	17810624	.	C	T	3	5	8	0	0	8	0	0
7	17812892	.	T	A	2	5	7	0	0	7	0	0
7	17813283	.	A	G	5	8	13	0	0	13	0	0
7	17813987	.	T	C	1	1	2	0	1	3	0	0
7	17905065	.	T	A	3	2	5	0	2	7	0	0
7	17933314	.	C	G	1	0	1	0	0	1	0	0
7	17933323	.	C	T	1	0	1	0	0	1	0	0
7	17933350	.	G	A	0	5	5	0	6	11	0	0
7	17933362	.	A	G	7	0	7	0	6	13	0	0
7	17933413	.	T	A	7	11	18	0	1	19	0	0
7	17936753	.	C	G	9	12	21	0	1	22	0	0
7	17936795	.	G	A	0	6	6	0	8	14	0	0
7	17938069	.	C	A	7	8	15	0	0	15	0	0
7	17941936	.	C	T	11	7	18	0	3	21	0	0
7	17942370	.	G	A	4	5	9	0	2	11	0	0
7	17942883	.	T	G	16	14	30	0	1	31	0	0
7	17943078	.	A	G	8	12	20	0	1	21	0	0
7	17943133	.	C	T	12	9	21	0	0	21	0	0
7	17943170	.	G	A	0	13	13	0	11	25	1	0
7	17943376	.	C	G	16	9	25	0	0	25	0	0
7	17943509	.	A	G	17	1	18	0	23	41	0	0
7	17943851	.	G	C	1	4	5	0	0	5	0	0
7	17953986	.	G	A	2	3	5	0	0	5	0	0
7	17957514	.	C	A	0	2	2	0	0	2	0	0
7	17957770	.	C	A	3	0	3	0	0	3	0	0
7	17958994	.	G	A	0	1	1	0	0	1	0	0
7	17963800	.	C	G	1	1	2	0	0	2	0	0
7	17963815	.	C	T	0	2	2	0	1	3	0	0
7	17965749	.	G	A	7	3	10	0	1	11	0	0
7	17969145	.	C	T	9	11	20	0	0	20	0	0
7	17969461	.	T	A	4	4	8	0	0	8	0	0
7	17969720	.	C	T	1	3	4	0	1	5	0	0
7	17969792	.	A	G	1	5	6	0	0	6	0	0
7	17969851	.	A	G	4	5	9	0	0	9	0	0
7	17969883	.	G	C	0	4	4	0	1	5	0	0
7	17970016	.	C	T	2	4	6	0	0	6	0	0
7	17970186	.	G	A	5	6	11	0	0	11	0	0
7	17970337	.	A	G	3	0	3	0	3	6	0	0
7	17970338	.	C	T	4	2	6	0	0	6	0	0
7	17970654	.	G	A	3	3	6	0	0	6	0	0
7	17970790	.	A	G	2	3	5	0	0	5	0	0
7	18072762	.	C	A	3	2	5	0	0	5	0	0
7	18072797	.	T	G	2	3	5	0	0	5	0	0
7	18072800	.	C	T	3	2	5	0	0	5	0	0
7	18114316	.	G	A	6	27	33	0	37	70	0	0
7	18114495	.	C	T	14	14	28	0	5	33	0	0
7	18114518	.	A	T	4	10	14	0	12	26	0	0
7	18115220	.	T	A	24	15	39	0	1	40	0	0
7	18115261	.	G	T	14	19	33	0	2	35	0	0
7	18115302	.	G	A	0	16	16	0	15	31	0	0
7	18115470	.	C	T	18	21	39	0	2	41	0	0
7	18115584	.	T	G	14	11	25	1	3	29	0	0
7	18115721	.	G	A	0	22	22	0	21	43	0	0
7	18116037	.	C	T	15	6	21	0	0	21	0	0
7	18116204	.	G	A	22	20	42	0	1	44	1	0
7	18122445	.	C	G	6	8	14	0	0	14	0	0
7	18122541	.	G	C	14	1	15	0	17	32	0	0
7	18124218	.	C	T	6	4	10	0	0	10	0	0
7	18124314	.	C	T	12	12	24	0	0	24	0	0
7	18124329	.	T	A	6	11	17	0	0	17	0	0
7	18137325	.	C	T	0	12	12	0	14	26	0	0
7	18146699	.	T	G	6	4	10	0	0	10	0	0
7	18168253	.	T	A	14	13	27	0	0	27	0	0
7	18168419	.	A	T	2	4	6	0	0	6	0	0
7	18366583	.	T	A	4	2	6	0	0	6	0	0
7	18366718	.	C	T	2	2	4	0	0	4	0	0
7	18366932	.	T	C	2	3	5	0	0	5	0	0
7	18366936	.	A	T	2	3	5	0	0	5	0	0
7	18367075	.	A	C	6	6	12	0	0	12	0	0
7	18367165	.	A	T	4	2	6	0	1	7	0	0
7	18412779	.	A	G	3	5	8	0	0	8	0	0
7	18413348	.	C	G	5	2	7	0	0	7	0	0
7	18413585	.	A	C	2	4	6	0	0	6	0	0
7	18413642	.	A	G	1	3	4	0	0	4	0	0
7	18413798	.	G	A	0	2	2	0	0	2	0	0
7	18414038	.	A	C	2	2	4	0	0	4	0	0
7	18416136	.	G	A	5	3	8	0	0	8	0	0
7	18462498	.	A	G	1	2	3	0	0	3	0	0
7	18462733	.	G	A	10	9	19	0	0	19	0	0
7	18463259	.	T	C	1	4	5	0	0	5	0	0
7	18463488	.	A	T	4	5	9	0	0	9	0	0
7	18463589	.	A	T	3	4	7	0	0	7	0	0
7	18464700	.	A	C	2	4	6	0	0	6	0	0
7	18464919	.	C	T	8	6	14	0	1	15	0	0
7	18465000	.	G	A	7	11	18	0	0	18	0	0
7	18465096	.	A	G	12	10	22	0	1	23	0	0
7	18465435	.	T	G	5	3	8	0	0	8	0	0
7	18470277	.	G	A	1	2	3	0	0	3	0	0
7	18470294	.	G	T	1	2	3	0	1	4	0	0
7	18470573	.	C	A	5	2	7	0	1	8	0	0
7	18470813	.	C	A	6	2	8	0	0	8	0	0
7	18474773	.	C	T	0	4	4	0	1	5	0	0
7	18474945	.	G	A	0	3	3	0	0	3	0	0
7	18474994	.	C	T	2	2	4	0	0	4	0	0
7	18475150	.	C	G	1	2	3	0	0	3	0	0
7	18486217	.	G	C	0	1	1	0	0	1	0	0
7	18550292	.	G	A	1	2	3	0	0	3	0	0
7	18550403	.	A	G	1	2	3	0	0	3	0	0
7	18550622	.	G	A	2	2	4	0	0	4	0	0
7	18558504	.	C	T	11	10	21	0	0	21	0	0
7	18558806	.	A	T	13	4	17	0	1	18	0	0
7	18558871	.	G	A	10	11	21	0	2	23	0	0
7	18558906	.	T	G	11	14	25	0	0	25	0	0
7	18559197	.	G	T	4	4	8	0	0	8	0	0
7	18559212	.	C	A	3	6	9	0	0	9	0	0
7	18559258	.	A	G	4	12	16	0	1	17	0	0
7	18560013	.	C	A	5	14	19	0	0	19	0	0
7	18560047	.	G	A	4	9	13	0	1	14	0	0
7	18560397	.	C	T	0	5	5	0	3	8	0	0
7	18560474	.	C	T	1	6	7	0	6	13	0	0
7	18560478	.	T	A	5	7	12	0	1	13	0	0
7	18560952	.	C	T	0	5	5	0	5	10	0	0
7	18564318	.	G	A	4	2	6	0	0	6	0	0
7	18594557	.	T	C	10	0	10	0	14	24	0	0
7	18607380	.	C	A	0	2	2	0	2	4	0	0
7	18607790	.	A	G	2	7	9	0	0	9	0	0
7	18607852	.	T	A	5	7	12	0	0	12	0	0
7	18608190	.	A	G	3	6	9	0	0	9	0	0
7	18608221	.	C	G	2	3	5	0	1	6	0	0
7	18609192	.	C	T	4	4	8	0	0	8	0	0
7	18618113	.	T	A	8	7	15	0	1	16	0	0
7	18618776	.	T	C	12	10	22	0	1	23	0	0
7	18618859	.	A	G	8	2	10	0	0	10	0	0
7	18618860	.	T	C	2	0	2	0	8	10	0	0
7	18618927	.	T	C	17	8	25	0	0	25	0	0
7	18619067	.	A	G	5	1	6	0	0	6	0	0
7	18619426	.	C	G	7	2	9	0	2	11	0	0
7	18619990	.	C	T	1	6	7	0	0	7	0	0
7	18620027	.	A	T	9	2	11	0	0	11	0	0
7	18620049	.	A	C	10	4	14	0	0	14	0	0
7	18620223	.	C	T	0	3	3	0	6	9	0	0
7	18620273	.	T	C	6	3	9	0	1	10	0	0
7	18620481	.	C	A	3	4	7	0	0	7	0	0
7	18645360	.	G	A	3	1	4	0	1	5	0	0
7	18650823	.	C	G	2	3	5	0	0	5	0	0
7	18655921	.	G	A	2	9	11	0	0	11	0	0
7	18655949	.	T	G	1	5	6	0	0	6	0	0
7	18656025	.	G	A	6	7	13	0	1	14	0	0
7	18704821	.	A	T	1	2	3	0	0	3	0	0
7	18705665	.	G	A	3	3	6	0	1	7	0	0
7	18711374	.	G	C	5	6	11	0	1	12	0	0
7	18711378	.	G	C	5	6	11	0	0	11	0	0
7	18780119	.	A	G	3	2	5	0	0	5	0	0
7	18780196	.	A	G	5	4	9	0	1	10	0	0
7	18810675	.	A	G	2	4	6	0	0	6	0	0
7	18810692	.	T	C	5	4	9	0	0	9	0	0
7	18810710	.	C	T	5	4	9	0	0	9	0	0
7	18810768	.	C	A	0	3	3	0	1	4	0	0
7	18810971	.	C	T	0	5	5	0	3	8	0	0
7	18810990	.	C	A	2	5	7	0	0	7	0	0
7	18811128	.	A	G	3	6	9	0	0	9	0	0
7	18876417	.	A	C	3	4	7	0	0	7	0	0
7	18876519	.	G	A	2	3	5	0	0	5	0	0
7	18958373	.	T	C	1	1	2	0	0	2	0	0
7	18970218	.	G	A	0	3	3	0	0	3	0	0
7	18971066	.	G	T	4	2	6	0	0	6	0	0
7	18971068	.	C	A	4	2	6	0	0	6	0	0
7	18983123	.	G	A	0	2	2	0	2	4	0	0
7	19028850	.	G	A	3	4	7	0	1	8	0	0
7	19028857	.	A	T	4	4	8	0	0	8	0	0
7	19055605	.	C	T	12	16	28	0	1	29	0	0
7	19065861	.	A	G	4	8	12	0	0	12	0	0
7	19070994	.	C	T	0	14	14	0	17	31	0	0
7	19071420	.	T	C	6	1	7	0	12	19	0	0
7	19071639	.	C	A	10	8	18	1	1	20	0	0
7	19073202	.	T	C	1	0	1	0	5	6	0	0
7	19073481	.	T	C	6	11	17	0	1	18	0	0
7	19073495	.	G	A	6	16	22	0	0	22	0	0
7	19073563	.	A	T	12	8	20	0	0	20	0	0
7	19073576	.	T	A	12	6	18	0	1	19	0	0
7	19073788	.	T	C	5	15	20	0	0	20	0	0
7	19073818	.	T	C	1	6	7	0	0	7	0	0
7	19073833	.	G	A	4	3	7	0	0	7	0	0
7	19073918	.	G	A	10	8	18	0	0	18	0	0
7	19074041	.	G	A	4	8	12	0	0	12	0	0
7	19074056	.	T	C	4	10	14	0	0	14	0	0
7	19074173	.	C	T	8	9	17	0	2	19	0	0
7	19074194	.	A	T	7	11	18	0	0	18	0	0
7	19074270	.	G	A	7	8	15	0	1	16	0	0
7	19074363	.	T	C	3	7	10	0	0	10	0	0
7	19074666	.	C	G	2	3	5	0	0	5	0	0
7	19075025	.	C	T	0	6	6	0	6	12	0	0
7	19075058	.	T	C	6	0	6	0	5	11	0	0
7	19075591	.	T	C	3	5	8	0	0	8	0	0
7	19075605	.	A	C	3	4	7	0	0	7	0	0
7	19075760	.	A	G	5	3	8	0	1	9	0	0
7	19076154	.	A	G	3	2	5	0	1	6	0	0
7	19076219	.	C	T	4	2	6	0	2	8	0	0
7	19076354	.	C	G	2	2	4	0	0	4	0	0
7	19076536	.	A	G	6	2	8	0	0	8	0	0
7	19076550	.	G	A	6	3	9	0	0	9	0	0
7	19076759	.	C	A	3	4	7	0	2	9	0	0
7	19077092	.	G	A	7	7	14	0	0	14	0	0
7	19083600	.	G	A	5	3	8	0	0	9	1	0
7	19095988	.	C	A	0	3	3	0	1	4	0	0
7	19099986	.	G	A	3	4	7	0	0	7	0	0
7	19101929	.	C	T	0	1	1	0	1	2	0	0
7	19179977	.	C	T	0	2	2	0	2	4	0	0
7	19180024	.	T	C	3	0	3	0	3	6	0	0
7	19180029	.	A	G	3	2	5	0	0	5	0	0
7	19180152	.	T	A	3	2	5	0	0	5	0	0
7	19180589	.	C	T	5	4	9	0	0	9	0	0
7	19759696	.	A	T	1	6	7	0	0	7	0	0
7	20294276	.	A	G	1	3	4	0	0	4	0	0
7	20459960	.	A	C	3	2	5	0	0	5	0	0
7	20459975	.	G	C	1	2	3	0	1	4	0	0
7	20463715	.	T	C	2	0	2	0	0	2	0	0
7	20464015	.	T	A	1	3	4	0	0	4	0	0
7	20464044	.	T	A	1	2	3	0	0	3	0	0
7	20529043	.	A	C	7	1	8	0	0	8	0	0
7	20529155	.	A	G	8	7	15	0	0	15	0	0
7	20529578	.	A	C	3	2	5	0	0	5	0	0
7	20529725	.	C	T	12	10	22	0	0	22	0	0
7	20529728	.	G	A	12	11	23	0	0	23	0	0
7	20529760	.	C	T	12	15	27	0	0	27	0	0
7	20529773	.	T	C	10	16	26	0	0	26	0	0
7	20530284	.	A	T	11	10	21	0	0	21	0	0
7	20530314	.	G	A	14	10	24	0	0	24	0	0
7	20530338	.	C	T	9	10	19	0	1	20	0	0
7	20530373	.	T	A	8	7	15	0	0	15	0	0
7	20537117	.	A	G	5	4	9	0	0	9	0	0
7	20537118	.	T	C	4	4	8	0	1	9	0	0
7	20539015	.	T	C	1	0	1	0	0	1	0	0
7	20539326	.	C	A	1	3	4	0	1	5	0	0
7	20539345	.	A	G	1	3	4	0	0	4	0	0
7	20540284	.	C	T	7	4	11	0	1	12	0	0
7	20540299	.	T	C	5	2	7	0	1	8	0	0
7	20542251	.	G	A	11	4	15	0	2	17	0	0
7	20542262	.	C	A	10	6	16	0	1	17	0	0
7	20587681	.	G	T	11	5	16	0	1	17	0	0
7	20587685	.	T	G	11	5	16	0	0	16	0	0
7	20587812	.	T	C	2	7	9	0	0	9	0	0
7	20588229	.	G	A	1	0	1	0	0	1	0	0
7	20588280	.	C	G	1	1	2	0	0	2	0	0
7	20593682	.	G	A	0	2	2	0	2	4	0	0
7	20593809	.	G	A	2	5	7	0	0	7	0	0
7	20597132	.	C	T	6	8	14	0	0	14	0	0
7	20600211	.	T	A	1	1	2	0	0	2	0	0
7	20600398	.	C	T	7	5	12	0	0	12	0	0
7	20600447	.	A	G	6	0	6	0	13	19	0	0
7	20601052	.	G	A	11	3	14	0	0	14	0	0
7	20601072	.	T	C	11	4	15	0	2	17	0	0
7	20601192	.	C	T	9	3	12	0	0	12	0	0
7	20601250	.	A	G	9	4	13	0	0	13	0	0
7	20601325	.	A	G	6	8	14	0	0	14	0	0
7	20601524	.	G	A	3	6	9	0	0	9	0	0
7	20601539	.	T	C	5	4	9	0	0	9	0	0
7	20601578	.	T	C	4	4	8	0	2	10	0	0
7	20601583	.	T	C	4	4	8	0	2	10	0	0
7	20601644	.	C	T	4	2	6	0	1	7	0	0
7	20601649	.	C	G	4	3	7	0	0	7	0	0
7	20601835	.	G	T	6	8	14	0	1	15	0	0
7	20601907	.	A	T	6	9	15	0	0	15	0	0
7	20601925	.	T	C	7	9	16	0	0	16	0	0
7	20602205	.	A	G	1	3	4	0	0	4	0	0
7	20605541	.	C	T	1	3	4	0	0	4	0	0
7	20605661	.	A	G	4	9	13	0	1	14	0	0
7	20629684	.	T	C	1	7	8	0	0	8	0	0
7	20629792	.	G	A	3	13	16	0	0	16	0	0
7	20629801	.	A	G	4	11	15	0	2	17	0	0
7	20633683	.	A	C	4	1	5	0	0	5	0	0
7	20633686	.	T	A	4	1	5	0	0	5	0	0
7	20634045	.	A	G	0	0	0	0	4	4	0	0
7	20634202	.	C	G	4	4	8	0	0	8	0	0
7	20634444	.	A	T	4	5	9	0	2	11	0	0
7	20634498	.	T	A	7	13	20	0	0	20	0	0
7	20634577	.	T	G	6	18	24	0	1	25	0	0
7	20635495	.	T	A	4	10	14	0	0	14	0	0
7	20635519	.	A	G	6	6	12	0	1	14	1	0
7	20635616	.	T	C	6	8	14	0	0	14	0	0
7	20635760	.	A	G	2	11	13	0	0	13	0	0
7	20636344	.	A	G	4	13	17	0	0	17	0	0
7	20636379	.	A	T	10	10	20	0	0	20	0	0
7	20636410	.	C	T	10	10	20	0	0	20	0	0
7	20636414	.	T	G	9	11	20	0	0	20	0	0
7	20636464	.	G	A	6	14	20	0	0	21	1	0
7	20636465	.	A	G	6	15	21	0	0	21	0	0
7	20636802	.	T	G	4	20	24	0	0	24	0	0
7	20636833	.	A	G	5	18	23	0	0	23	0	0
7	20636844	.	T	A	7	14	21	0	2	23	0	0
7	20664621	.	A	T	5	3	8	0	1	9	0	0
7	20693673	.	G	T	13	11	24	0	0	24	0	0
7	20695949	.	G	T	9	6	15	0	0	15	0	0
7	20698208	.	T	A	1	1	2	0	1	3	0	0
7	20712555	.	C	T	5	5	10	0	0	10	0	0
7	20715178	.	G	A	2	4	6	0	1	7	0	0
7	20715434	.	C	T	2	1	3	0	0	3	0	0
7	20731052	.	C	T	4	4	8	0	2	10	0	0
7	20731166	.	A	G	4	4	8	0	0	8	0	0
7	20735155	.	G	A	3	2	5	0	1	6	0	0
7	20738148	.	A	G	9	7	16	0	0	16	0	0
7	20743984	.	C	T	0	0	0	0	2	2	0	0
7	20754669	.	G	A	0	3	3	0	0	3	0	0
7	20778491	.	A	C	2	3	5	0	0	5	0	0
7	20780285	.	G	A	4	4	8	0	1	9	0	0
7	20780317	.	C	T	5	4	9	0	1	10	0	0
7	20780337	.	A	C	4	2	6	0	0	7	1	0
7	20780356	.	A	G	3	5	8	0	0	8	0	0
7	20780424	.	A	T	4	6	10	0	0	10	0	0
7	20780453	.	C	A	5	5	10	0	0	10	0	0
7	20780500	.	A	C	5	0	5	0	4	9	0	0
7	20780732	.	A	C	3	9	12	0	0	12	0	0
7	20780758	.	T	C	5	4	9	0	0	9	0	0
7	20780918	.	C	T	0	9	9	0	9	18	0	0
7	20780987	.	G	A	7	13	20	0	1	21	0	0
7	20781110	.	C	T	7	5	12	0	0	12	0	0
7	20781327	.	A	G	7	3	10	0	0	10	0	0
7	20781996	.	T	G	3	2	5	0	0	5	0	0
7	20784496	.	C	T	3	4	7	0	0	7	0	0
7	20784772	.	G	A	2	2	4	0	1	5	0	0
7	20787233	.	C	T	3	1	4	0	0	4	0	0
7	20796929	.	T	C	7	5	12	0	0	12	0	0
7	20859446	.	G	C	11	6	17	0	0	17	0	0
7	20859823	.	T	A	4	3	7	0	0	7	0	0
7	20859975	.	G	A	6	1	7	0	0	7	0	0
7	20860011	.	T	C	2	0	2	0	0	2	0	0
7	20864097	.	A	G	0	3	3	0	0	3	0	0
7	20864256	.	T	C	3	0	3	0	0	3	0	0
7	20876624	.	A	T	5	3	8	0	0	8	0	0
7	20890420	.	T	C	7	5	12	0	1	13	0	0
7	20890435	.	C	T	8	7	15	0	1	16	0	0
7	20890715	.	G	A	3	1	4	0	0	4	0	0
7	20890718	.	G	A	3	1	4	0	0	4	0	0
7	20892307	.	A	T	3	7	10	0	1	11	0	0
7	20894701	.	G	A	0	2	2	0	4	6	0	0
7	20897911	.	G	A	1	5	6	0	0	6	0	0
7	20904582	.	G	A	0	0	0	0	3	3	0	0
7	20923330	.	A	G	0	1	1	0	0	1	0	0
7	20924115	.	C	T	1	2	3	0	0	3	0	0
7	20935058	.	T	C	4	4	8	0	0	8	0	0
7	20935547	.	G	A	2	0	2	0	0	2	0	0
7	20935684	.	C	T	1	1	2	0	0	2	0	0
7	20935737	.	T	A	4	3	7	0	0	7	0	0
7	20935765	.	A	G	2	3	5	0	0	5	0	0
7	20938812	.	C	T	4	2	6	0	0	6	0	0
7	20966203	.	A	C	1	3	4	0	0	4	0	0
7	20966365	.	G	A	4	3	7	0	0	7	0	0
7	20966508	.	G	T	0	2	2	0	2	4	0	0
7	21626312	.	G	A	3	3	6	0	0	6	0	0
7	21765244	.	G	A	5	5	10	0	0	10	0	0
7	21765562	.	C	A	1	5	6	0	0	6	0	0
7	21765702	.	T	A	4	5	9	0	0	9	0	0
7	21766917	.	G	A	5	4	9	0	0	9	0	0
7	21766937	.	C	A	4	3	7	0	0	7	0	0
7	21767423	.	A	G	6	9	15	0	0	15	0	0
7	21768002	.	T	C	5	7	12	0	0	12	0	0
7	21768060	.	A	G	4	3	7	0	0	7	0	0
7	21768270	.	G	A	8	6	14	0	1	15	0	0
7	21768334	.	C	A	7	10	17	0	2	19	0	0
7	21768540	.	T	A	7	2	9	1	0	11	1	0
7	21769286	.	T	G	4	6	10	0	0	10	0	0
7	21769318	.	A	G	2	4	6	0	0	6	0	0
7	21769733	.	G	A	3	3	6	0	0	6	0	0
7	21770567	.	C	T	10	10	20	0	0	20	0	0
7	21770819	.	G	T	0	2	2	0	6	8	0	0
7	21773542	.	C	T	8	6	14	0	0	14	0	0
7	21773626	.	C	T	4	5	9	0	1	10	0	0
7	21774127	.	G	A	7	2	9	0	0	9	0	0
7	21776426	.	C	T	0	5	5	0	0	5	0	0
7	21776683	.	G	A	6	6	12	0	0	12	0	0
7	21776693	.	T	C	6	5	11	0	0	11	0	0
7	21777203	.	G	T	4	5	9	0	0	9	0	0
7	21777720	.	G	A	10	8	18	0	0	18	0	0
7	21777978	.	T	G	7	11	18	0	0	18	0	0
7	21778070	.	T	C	2	3	5	0	0	5	0	0
7	21859402	.	C	T	1	5	6	0	0	6	0	0
7	21872364	.	G	A	0	3	3	0	0	3	0	0
7	21872656	.	G	A	1	2	3	0	0	3	0	0
7	21872716	.	G	A	5	4	9	0	0	9	0	0
7	21872759	.	T	A	4	6	10	0	1	11	0	0
7	21872969	.	G	C	1	2	3	0	0	3	0	0
7	21873176	.	G	A	6	3	9	0	0	9	0	0
7	21873246	.	C	G	6	3	9	0	0	9	0	0
7	21873266	.	G	A	0	3	3	0	6	9	0	0
7	21874075	.	T	C	5	3	8	0	0	8	0	0
7	21874092	.	A	G	4	0	4	0	1	5	0	0
7	21874117	.	G	A	2	2	4	0	0	4	0	0
7	21876652	.	T	C	2	2	4	0	0	4	0	0
7	21884138	.	C	A	0	0	0	0	1	1	0	0
7	21887797	.	A	T	1	1	2	0	0	2	0	0
7	21887967	.	C	T	21	21	42	0	0	42	0	0
7	21888084	.	T	A	18	24	42	0	1	43	0	0
7	21888274	.	T	A	9	8	17	0	0	17	0	0
7	21888362	.	C	T	4	2	6	0	0	6	0	0
7	21890998	.	C	T	2	4	6	0	1	7	0	0
7	21891031	.	G	A	1	4	5	0	1	6	0	0
7	21891208	.	C	T	6	3	9	0	1	10	0	0
7	21891540	.	T	G	3	3	6	0	0	6	0	0
7	21917927	.	C	A	3	4	7	0	0	7	0	0
7	21918235	.	G	A	2	2	4	0	0	4	0	0
7	21918410	.	G	A	0	4	4	0	2	6	0	0
7	21918412	.	T	A	2	4	6	0	0	6	0	0
7	21940965	.	T	G	2	6	8	0	1	9	0	0
7	21940992	.	A	G	6	8	14	0	0	14	0	0
7	21941016	.	T	G	15	11	26	0	0	26	0	0
7	21941460	.	G	A	7	6	13	0	0	13	0	0
7	21941477	.	C	A	8	7	15	0	2	17	0	0
7	21941568	.	C	T	9	8	17	0	0	17	0	0
7	21941579	.	A	C	6	7	13	0	1	14	0	0
7	21942378	.	C	T	8	8	16	0	0	16	0	0
7	21942513	.	A	T	10	11	21	0	0	21	0	0
7	21942644	.	T	A	12	9	21	0	1	22	0	0
7	21942672	.	C	T	11	12	23	0	0	23	0	0
7	21943553	.	A	G	5	13	18	0	1	19	0	0
7	21943625	.	G	A	8	5	13	0	1	14	0	0
7	21943716	.	T	G	6	7	13	0	0	13	0	0
7	21943772	.	T	C	5	12	17	0	1	18	0	0
7	21943886	.	C	A	5	5	10	0	1	11	0	0
7	21944495	.	T	C	6	6	12	0	1	13	0	0
7	21944753	.	G	A	7	4	11	0	2	13	0	0
7	21945257	.	C	T	1	6	7	0	6	13	0	0
7	21945347	.	C	T	1	13	14	0	15	29	0	0
7	21947228	.	G	A	15	4	19	0	0	19	0	0
7	21947237	.	C	T	5	14	19	0	0	19	0	0
7	21951353	.	G	A	7	6	13	0	1	14	0	0
7	21956571	.	A	G	1	1	2	0	0	2	0	0
7	22131815	.	C	T	0	4	4	0	2	6	0	0
7	22132134	.	A	G	7	3	10	0	0	10	0	0
7	22295624	.	G	A	0	2	2	0	2	4	0	0
7	22295636	.	T	G	2	0	2	0	2	4	0	0
7	22322330	.	C	T	3	3	6	0	0	6	0	0
7	22322492	.	T	C	1	3	4	0	0	4	0	0
7	22323574	.	G	C	2	4	6	0	0	6	0	0
7	22323712	.	C	T	4	2	6	0	0	6	0	0
7	22323723	.	A	G	5	2	7	0	0	7	0	0
7	22323821	.	A	G	5	3	8	0	0	8	0	0
7	22323884	.	T	G	5	4	9	0	0	9	0	0
7	22323934	.	C	T	5	3	8	0	1	9	0	0
7	22324727	.	A	G	2	3	5	0	0	5	0	0
7	22324880	.	C	T	4	2	6	0	0	6	0	0
7	22324900	.	A	T	5	1	6	0	4	10	0	0
7	22626223	.	T	A	10	4	14	0	0	14	0	0
7	22626525	.	A	T	4	7	11	0	0	11	0	0
7	22626669	.	A	G	3	4	7	0	0	7	0	0
7	22630003	.	T	A	18	13	31	0	1	32	0	0
7	22630087	.	A	G	17	21	38	0	0	38	0	0
7	22630096	.	T	C	15	2	17	0	15	33	1	0
7	22630189	.	C	T	15	20	35	0	1	36	0	0
7	22630297	.	A	G	14	19	33	0	1	34	0	0
7	22630581	.	C	T	2	22	24	0	24	48	0	0
7	22630655	.	T	C	11	0	11	0	29	40	0	0
7	22630670	.	A	G	6	22	28	0	0	28	0	0
7	22632253	.	T	A	21	21	42	0	1	43	0	0
7	22632850	.	C	A	0	3	3	0	4	7	0	0
7	22632873	.	G	A	2	2	4	0	0	4	0	0
7	22709863	.	C	A	0	4	4	0	0	4	0	0
7	22718516	.	C	T	9	6	15	0	0	15	0	0
7	22718686	.	C	G	7	10	17	0	0	17	0	0
7	22723701	.	G	A	0	2	2	0	2	4	0	0
7	22726604	.	A	G	1	0	1	0	0	1	0	0
7	22732755	.	T	C	2	0	2	0	0	2	0	0
7	22735394	.	C	A	6	9	15	0	0	15	0	0
7	22735421	.	A	T	1	2	3	0	1	4	0	0
7	22751600	.	G	A	4	10	14	0	0	14	0	0
7	22760761	.	G	T	11	9	20	0	0	20	0	0
7	22793731	.	A	C	3	4	7	0	6	13	0	0
7	22795566	.	G	A	3	3	6	0	0	6	0	0
7	22796784	.	A	G	1	4	5	0	0	5	0	0
7	22806668	.	G	A	0	12	12	0	15	27	0	0
7	22809956	.	G	A	8	9	17	0	0	17	0	0
7	22810208	.	C	T	5	11	16	0	0	16	0	0
7	22816078	.	G	A	1	10	11	0	11	22	0	0
7	22816487	.	T	C	3	8	11	0	1	12	0	0
7	22819933	.	T	A	17	24	41	0	5	46	0	0
7	22819975	.	A	T	8	11	19	0	21	40	0	0
7	22820704	.	C	G	1	1	2	0	3	5	0	0
7	22824278	.	A	G	4	3	7	0	0	7	0	0
7	22830405	.	G	A	2	3	5	0	0	5	0	0
7	22830423	.	G	A	2	3	5	0	0	5	0	0
7	22833512	.	T	C	5	1	6	0	2	8	0	0
7	22833739	.	C	T	2	2	4	0	0	4	0	0
7	22834021	.	G	A	1	5	6	0	0	6	0	0
7	22838359	.	T	C	9	10	19	0	0	19	0	0
7	22843256	.	A	G	3	4	7	0	0	7	0	0
7	22843310	.	A	T	13	20	33	0	3	36	0	0
7	22849948	.	A	T	17	22	39	0	2	41	0	0
7	22849949	.	C	T	19	21	40	0	1	41	0	0
7	22850098	.	T	C	20	23	43	0	1	44	0	0
7	22850137	.	T	A	15	19	34	0	0	34	0	0
7	22850231	.	T	G	15	4	19	0	0	19	0	0
7	22850234	.	C	T	15	5	20	0	0	20	0	0
7	22850277	.	A	T	7	12	19	0	1	20	0	0
7	22850340	.	T	A	11	13	24	0	1	25	0	0
7	22850365	.	C	T	16	16	32	0	0	32	0	0
7	22851036	.	C	T	13	18	31	0	0	31	0	0
7	22851133	.	C	T	23	22	45	0	2	47	0	0
7	22851739	.	A	C	25	26	51	0	3	54	0	0
7	22898354	.	A	T	1	2	3	0	0	3	0	0
7	22899058	.	G	A	0	3	3	0	1	4	0	0
7	22899059	.	G	A	1	3	4	0	0	4	0	0
7	22911938	.	T	C	10	6	16	0	0	16	0	0
7	22911984	.	G	T	4	7	11	0	0	11	0	0
7	22912419	.	G	T	4	3	7	0	0	7	0	0
7	22912642	.	A	G	6	2	8	0	1	9	0	0
7	22912755	.	A	T	4	3	7	0	0	7	0	0
7	22912762	.	T	G	3	3	6	0	0	6	0	0
7	22912919	.	C	T	2	3	5	0	0	5	0	0
7	22912928	.	G	A	2	3	5	0	0	5	0	0
7	22913385	.	A	T	1	2	3	0	0	3	0	0
7	22913408	.	G	T	0	2	2	0	0	2	0	0
7	22914429	.	G	C	2	2	4	0	0	4	0	0
7	23000316	.	C	T	1	2	3	0	0	3	0	0
7	23457851	.	T	C	1	2	3	0	0	3	0	0
7	23458202	.	A	G	1	0	1	0	1	2	0	0
7	23482722	.	T	C	0	1	1	0	0	1	0	0
7	23482728	.	C	T	0	1	1	0	0	1	0	0
7	23492311	.	C	T	0	5	5	0	1	6	0	0
7	23492312	.	A	G	0	6	6	0	0	6	0	0
7	23492644	.	T	C	3	4	7	0	1	8	0	0
7	23492695	.	T	C	3	6	9	0	0	9	0	0
7	23492704	.	C	T	3	5	8	0	0	8	0	0
7	23493268	.	C	T	2	2	4	0	0	4	0	0
7	23493485	.	T	G	4	3	7	0	0	7	0	0
7	23493841	.	T	C	6	2	8	0	0	8	0	0
7	23494082	.	T	G	3	2	5	0	0	5	0	0
7	23494107	.	A	T	2	2	4	0	0	4	0	0
7	23496152	.	G	A	7	4	11	0	0	11	0	0
7	23533440	.	G	T	0	8	8	0	11	19	0	0
7	23533464	.	A	G	7	0	7	0	6	13	0	0
7	23536981	.	T	A	12	15	27	0	2	29	0	0
7	23539695	.	C	A	15	10	25	0	3	28	0	0
7	23539824	.	G	A	9	8	17	0	1	18	0	0
7	23539951	.	G	A	1	12	13	0	16	29	0	0
7	23540270	.	T	A	7	5	12	0	0	12	0	0
7	23540323	.	G	A	12	3	15	0	1	16	0	0
7	23540328	.	C	T	13	2	15	0	1	16	0	0
7	23540414	.	T	C	11	6	17	0	0	17	0	0
7	23540505	.	A	C	7	13	20	0	0	23	3	0
7	23540540	.	A	G	14	0	14	0	17	31	0	0
7	23540629	.	T	C	7	12	19	0	0	19	0	0
7	23540643	.	A	G	8	9	17	0	1	18	0	0
7	23540887	.	G	A	15	16	31	0	0	31	0	0
7	23541083	.	C	T	11	6	17	0	0	17	0	0
7	23541230	.	A	C	12	10	22	0	1	23	0	0
7	23541508	.	T	G	3	7	10	0	2	12	0	0
7	23541696	.	G	T	11	13	24	0	0	24	0	0
7	23541847	.	G	C	15	17	32	0	1	33	0	0
7	23541852	.	T	C	17	16	33	0	1	34	0	0
7	23542151	.	T	G	3	10	13	0	0	13	0	0
7	23542543	.	C	T	17	15	32	0	1	33	0	0
7	23542586	.	G	T	16	5	21	0	1	22	0	0
7	23542678	.	C	A	11	18	29	0	2	31	0	0
7	23542785	.	T	G	13	0	13	0	18	31	0	0
7	23542794	.	T	C	14	17	31	0	2	33	0	0
7	23561158	.	C	T	0	7	7	0	1	8	0	0
7	23561431	.	G	A	8	5	13	0	1	14	0	0
7	23561605	.	A	G	6	5	11	0	1	12	0	0
7	23563034	.	C	T	3	7	10	0	0	10	0	0
7	23688670	.	C	G	2	2	4	0	0	4	0	0
7	23691846	.	G	A	2	5	7	0	0	7	0	0
7	23696140	.	C	T	3	4	7	0	0	7	0	0
7	23704869	.	G	A	2	0	2	0	0	2	0	0
7	23707079	.	G	A	2	2	4	0	0	4	0	0
7	23710275	.	T	A	3	8	11	0	0	11	0	0
7	23710311	.	C	T	7	21	28	0	0	28	0	0
7	23713828	.	G	T	7	2	9	0	0	9	0	0
7	23713855	.	T	G	2	0	2	0	7	9	0	0
7	23718778	.	C	G	3	1	4	0	0	4	0	0
7	23718924	.	A	G	10	11	21	0	0	21	0	0
7	23724311	.	T	A	9	10	19	0	0	19	0	0
7	23724418	.	C	T	14	13	27	0	2	29	0	0
7	23724556	.	C	A	7	22	29	0	0	29	0	0
7	23724607	.	C	T	10	18	28	0	3	31	0	0
7	23725087	.	A	G	7	8	15	0	0	15	0	0
7	23725239	.	C	T	9	10	19	0	3	22	0	0
7	23725276	.	T	C	11	14	25	0	0	25	0	0
7	23725285	.	A	T	11	13	24	0	2	26	0	0
7	23725366	.	T	A	9	6	15	0	1	16	0	0
7	23725426	.	C	A	9	12	21	0	1	22	0	0
7	23728297	.	C	G	4	2	6	0	0	6	0	0
7	23728312	.	A	G	1	3	4	0	0	4	0	0
7	23728504	.	T	C	2	3	5	0	0	5	0	0
7	23731275	.	A	C	0	1	1	0	0	1	0	0
7	23731278	.	A	G	0	1	1	0	0	1	0	0
7	23749277	.	G	A	11	11	22	0	1	23	0	0
7	23749490	.	G	A	14	10	24	0	1	25	0	0
7	23749513	.	A	T	11	13	24	0	2	26	0	0
7	23749679	.	A	G	9	8	17	0	0	17	0	0
7	23749831	.	C	A	3	5	8	0	0	8	0	0
7	23749954	.	A	T	10	15	25	0	1	26	0	0
7	23750665	.	C	T	4	3	7	0	0	7	0	0
7	23750955	.	C	T	3	4	7	0	0	7	0	0
7	23750962	.	A	T	3	3	6	0	0	6	0	0
7	23750992	.	T	A	3	5	8	0	0	8	0	0
7	23751043	.	C	T	7	12	19	0	3	22	0	0
7	23751106	.	A	C	14	0	14	0	11	25	0	0
7	23751188	.	T	G	4	3	7	0	1	8	0	0
7	23751197	.	A	T	5	3	8	0	0	8	0	0
7	23751348	.	A	C	3	3	6	0	1	7	0	0
7	23751363	.	A	T	5	6	11	0	1	12	0	0
7	23751866	.	C	G	12	8	20	0	0	20	0	0
7	23752519	.	C	T	3	2	5	0	0	5	0	0
7	23752637	.	G	T	5	3	8	0	0	8	0	0
7	23753061	.	A	G	6	3	9	0	1	10	0	0
7	23753070	.	T	C	6	3	9	0	0	9	0	0
7	23753154	.	C	T	7	3	10	0	1	11	0	0
7	23753341	.	T	A	8	3	11	0	0	11	0	0
7	23753450	.	A	T	7	6	13	0	0	13	0	0
7	23753713	.	T	C	8	1	9	0	7	16	0	0
7	23753873	.	T	C	1	5	6	0	2	8	0	0
7	23753999	.	A	G	4	2	6	0	0	6	0	0
7	23754338	.	C	T	4	2	6	0	0	6	0	0
7	23754467	.	T	A	7	12	19	0	1	20	0	0
7	23754498	.	G	A	8	9	17	0	0	17	0	0
7	23754927	.	T	C	3	8	11	0	0	11	0	0
7	23755082	.	C	G	1	5	6	0	1	7	0	0
7	23755354	.	C	T	1	3	4	0	0	4	0	0
7	23755668	.	G	C	3	3	6	0	0	6	0	0
7	23755734	.	C	T	3	2	5	0	0	5	0	0
7	23755933	.	T	A	0	3	3	0	0	3	0	0
7	23755949	.	G	A	1	3	4	0	0	4	0	0
7	23756208	.	T	C	7	5	12	0	4	16	0	0
7	23756545	.	C	T	8	4	12	0	1	13	0	0
7	23768138	.	G	A	3	4	7	0	0	7	0	0
7	23768153	.	G	A	1	6	7	0	1	8	0	0
7	23768222	.	C	A	2	0	2	0	0	2	0	0
7	23854779	.	A	T	1	2	3	0	0	3	0	0
7	23857923	.	T	C	6	0	6	0	3	9	0	0
7	23883399	.	G	A	10	15	25	0	0	25	0	0
7	23883548	.	A	C	19	15	34	0	6	40	0	0
7	23883970	.	C	T	7	14	21	0	0	21	0	0
7	23884004	.	G	A	11	11	22	0	0	22	0	0
7	23884058	.	T	C	14	12	26	0	2	28	0	0
7	23884061	.	C	G	13	13	26	0	1	27	0	0
7	23884445	.	C	T	24	25	49	0	0	49	0	0
7	23884641	.	A	G	13	0	13	0	16	29	0	0
7	23884667	.	C	A	13	14	27	0	0	27	0	0
7	23887738	.	T	G	6	5	11	0	0	11	0	0
7	23887784	.	C	T	12	7	19	0	0	19	0	0
7	23887865	.	T	C	15	16	31	0	2	33	0	0
7	23888099	.	A	G	6	7	13	0	1	14	0	0
7	23888155	.	T	G	8	11	19	0	0	19	0	0
7	23889947	.	C	T	13	5	18	0	2	20	0	0
7	23892884	.	G	A	1	2	3	0	0	3	0	0
7	23894605	.	G	A	2	6	8	0	2	10	0	0
7	23907784	.	G	T	23	20	43	0	1	44	0	0
7	23907785	.	C	A	19	23	42	0	2	44	0	0
7	23909699	.	C	G	17	1	18	0	28	46	0	0
7	23909735	.	T	C	17	27	44	0	1	45	0	0
7	23909757	.	C	T	16	24	40	0	3	43	0	0
7	23909975	.	A	G	22	26	48	0	1	50	1	0
7	23915203	.	C	T	29	27	56	0	4	60	0	0
7	23915359	.	G	A	2	26	28	0	27	55	0	0
7	23915485	.	A	T	28	26	54	0	0	55	1	0
7	23915700	.	G	T	12	10	22	0	3	25	0	0
7	23915916	.	T	A	27	31	58	0	1	60	1	0
7	23967878	.	G	A	14	14	28	0	0	28	0	0
7	23968108	.	G	A	15	8	23	0	1	24	0	0
7	23968267	.	A	C	4	7	11	0	0	11	0	0
7	23968292	.	T	G	5	7	12	0	0	12	0	0
7	23968330	.	C	G	4	8	12	0	1	13	0	0
7	23968344	.	C	T	6	7	13	0	0	13	0	0
7	23968920	.	C	T	11	4	15	0	0	15	0	0
7	23969163	.	G	A	4	4	8	0	0	8	0	0
7	23969191	.	C	T	0	6	6	0	5	11	0	0
7	23969226	.	G	A	3	4	7	0	0	7	0	0
7	23969361	.	G	A	7	8	15	0	1	16	0	0
7	23969535	.	G	A	12	5	17	0	0	17	0	0
7	23969970	.	T	C	4	2	6	0	0	6	0	0
7	23970320	.	G	T	9	14	23	0	0	24	1	0
7	23970331	.	G	A	11	13	24	0	2	26	0	0
7	23970559	.	T	G	7	5	12	0	0	12	0	0
7	23971418	.	T	C	8	9	17	0	0	17	0	0
7	23971627	.	G	A	2	9	11	0	2	13	0	0
7	23971636	.	C	A	11	4	15	0	0	15	0	0
7	23971682	.	T	A	8	4	12	0	0	12	0	0
7	23974326	.	T	A	1	4	5	0	0	5	0	0
7	23977711	.	T	C	3	1	4	0	1	5	0	0
7	23977905	.	A	C	4	4	8	0	0	8	0	0
7	23977915	.	C	T	4	4	8	0	0	8	0	0
7	23979686	.	C	T	0	1	1	0	0	1	0	0
7	23979703	.	C	T	1	1	2	0	0	2	0	0
7	23982433	.	A	G	4	6	10	0	0	10	0	0
7	24006951	.	G	T	0	2	2	0	1	3	0	0
7	24007097	.	A	G	3	4	7	0	1	8	0	0
7	24007222	.	T	C	3	4	7	0	0	7	0	0
7	24011474	.	C	A	2	3	5	0	0	5	0	0
7	24012794	.	T	C	5	6	11	0	0	11	0	0
7	24013044	.	A	G	2	0	2	0	7	9	0	0
7	24013269	.	G	A	6	3	9	0	0	9	0	0
7	24013274	.	A	C	3	4	7	0	1	8	0	0
7	24013489	.	G	A	0	13	13	0	4	17	0	0
7	24013560	.	T	C	5	4	9	0	1	10	0	0
7	24013662	.	C	A	4	3	7	0	0	7	0	0
7	24033579	.	T	G	2	0	2	0	3	5	0	0
7	24034112	.	G	A	1	2	3	0	0	3	0	0
7	24039800	.	C	A	2	3	5	0	0	5	0	0
7	24039823	.	C	T	2	3	5	0	0	5	0	0
7	24043250	.	C	T	2	0	2	0	0	2	0	0
7	24053673	.	A	G	1	5	6	0	1	7	0	0
7	24059773	.	C	T	2	3	5	0	1	6	0	0
7	24067056	.	G	T	2	5	7	0	0	7	0	0
7	24067359	.	C	T	5	5	10	0	0	10	0	0
7	24067403	.	A	T	9	4	13	0	0	13	0	0
7	24067571	.	C	T	7	6	13	0	1	14	0	0
7	24067611	.	C	T	6	7	13	0	1	14	0	0
7	24067906	.	C	A	7	8	15	0	0	15	0	0
7	24067907	.	T	A	7	8	15	0	0	15	0	0
7	24068224	.	A	T	7	5	12	0	1	13	0	0
7	24068230	.	C	T	5	8	13	0	0	13	0	0
7	24068491	.	C	T	5	4	9	0	0	9	0	0
7	24068722	.	T	C	4	2	6	0	0	6	0	0
7	24069592	.	A	G	0	2	2	0	0	2	0	0
7	24069598	.	G	A	0	1	1	0	0	1	0	0
7	24075226	.	C	G	3	5	8	0	2	10	0	0
7	24084879	.	C	T	3	5	8	0	0	8	0	0
7	24084887	.	G	A	0	3	3	0	4	7	0	0
7	24087622	.	T	A	8	3	11	0	0	11	0	0
7	24090128	.	A	G	1	0	1	0	0	1	0	0
7	24091054	.	G	A	8	11	19	0	0	19	0	0
7	24091249	.	A	G	12	11	23	0	0	23	0	0
7	24093102	.	C	T	17	23	40	0	2	42	0	0
7	24093105	.	C	T	16	23	39	0	2	41	0	0
7	24093165	.	C	G	13	19	32	0	0	32	0	0
7	24093372	.	A	G	1	1	2	0	0	2	0	0
7	24095515	.	C	G	26	14	40	0	0	40	0	0
7	24095776	.	G	A	13	15	28	0	0	28	0	0
7	24095926	.	A	C	9	13	22	0	1	23	0	0
7	24096015	.	C	T	20	8	28	0	2	30	0	0
7	24096165	.	T	C	18	8	26	0	0	26	0	0
7	24096195	.	C	G	18	9	27	0	0	27	0	0
7	24096399	.	C	A	13	16	29	0	0	29	0	0
7	24096447	.	T	G	17	14	31	0	2	33	0	0
7	24096505	.	G	A	0	7	7	0	9	16	0	0
7	24096767	.	A	C	15	16	31	0	1	32	0	0
7	24100511	.	G	A	2	2	4	0	0	4	0	0
7	24100743	.	A	C	2	0	2	0	2	4	0	0
7	24100761	.	C	T	1	1	2	0	0	2	0	0
7	24115186	.	G	A	0	1	1	0	0	1	0	0
7	24124877	.	G	A	2	2	4	0	0	4	0	0
7	24125714	.	T	C	2	1	3	0	0	3	0	0
7	24125721	.	C	T	2	2	4	0	0	4	0	0
7	24125923	.	C	T	0	2	2	0	0	2	0	0
7	24161648	.	G	A	0	7	7	0	20	27	0	0
7	24161776	.	C	G	3	5	8	0	0	9	1	0
7	24161786	.	G	C	4	6	10	0	0	10	0	0
7	24162047	.	T	A	2	3	5	0	1	6	0	0
7	24162267	.	G	T	7	5	12	0	0	12	0	0
7	24162457	.	T	C	8	8	16	0	1	17	0	0
7	24162485	.	C	T	9	6	15	0	0	15	0	0
7	24162782	.	G	A	2	3	5	0	0	5	0	0
7	24197574	.	C	A	6	2	8	0	1	9	0	0
7	24197841	.	G	A	5	4	9	0	0	9	0	0
7	24197867	.	T	A	5	2	7	0	0	7	0	0
7	24198334	.	C	T	8	5	13	0	0	13	0	0
7	24198335	.	C	T	0	6	6	0	7	13	0	0
7	24200112	.	A	G	4	10	14	0	0	14	0	0
7	24201447	.	A	T	3	4	7	0	1	8	0	0
7	24201453	.	G	A	4	4	8	0	0	8	0	0
7	24201686	.	A	G	0	2	2	0	0	2	0	0
7	24204166	.	T	A	9	2	11	0	0	11	0	0
7	24205077	.	C	A	14	11	25	0	0	25	0	0
7	24207520	.	A	C	18	19	37	0	0	37	0	0
7	24207552	.	A	G	21	0	21	0	20	41	0	0
7	24207590	.	A	T	20	23	43	0	0	43	0	0
7	24207632	.	G	C	16	18	34	0	0	34	0	0
7	24210422	.	T	C	11	13	24	0	0	24	0	0
7	24210913	.	T	C	12	0	12	0	15	27	0	0
7	24211015	.	A	T	4	9	13	0	0	13	0	0
7	24211027	.	G	T	6	3	9	0	0	9	0	0
7	24211054	.	G	A	10	3	13	0	0	13	0	0
7	24211081	.	T	A	10	5	15	0	0	15	0	0
7	24211104	.	C	T	0	7	7	0	13	20	0	0
7	24211482	.	C	T	0	7	7	0	0	7	0	0
7	24211542	.	G	T	2	9	11	0	0	11	0	0
7	24211646	.	C	T	0	2	2	0	3	5	0	0
7	24211672	.	A	T	7	3	10	0	1	11	0	0
7	24211900	.	A	C	1	1	2	0	2	4	0	0
7	24211978	.	G	A	10	10	20	1	0	21	0	0
7	24212159	.	G	C	11	1	12	0	7	19	0	0
7	24213387	.	A	T	9	10	19	0	0	19	0	0
7	24213401	.	G	A	10	8	18	0	0	18	0	0
7	24213426	.	G	A	5	4	9	0	0	9	0	0
7	24214655	.	C	T	3	2	5	0	1	6	0	0
7	24235722	.	G	T	7	9	16	0	0	16	0	0
7	24235806	.	G	A	6	2	8	0	0	8	0	0
7	24236035	.	A	G	8	3	11	0	0	11	0	0
7	24337519	.	T	C	1	2	3	0	0	3	0	0
7	24343631	.	G	T	0	1	1	0	0	1	0	0
7	24357313	.	T	A	1	2	3	0	0	3	0	0
7	24457647	.	A	T	34	27	61	0	1	62	0	0
7	24457845	.	T	C	22	9	31	0	1	32	0	0
7	24458128	.	G	C	17	23	40	0	3	43	0	0
7	24458282	.	C	T	19	21	40	0	0	40	0	0
7	24458345	.	C	A	16	26	42	0	1	43	0	0
7	24458349	.	A	C	17	25	42	0	3	45	0	0
7	24458513	.	T	C	18	18	36	0	2	38	0	0
7	24458713	.	T	C	8	0	8	0	19	27	0	0
7	24458717	.	G	A	7	17	24	0	0	24	0	0
7	24458866	.	T	C	23	16	39	0	1	40	0	0
7	24458894	.	T	A	19	19	38	0	2	40	0	0
7	24459667	.	T	A	26	18	44	0	2	46	0	0
7	24459847	.	A	G	30	14	44	0	2	46	0	0
7	24459932	.	T	C	14	24	38	0	0	38	0	0
7	24460443	.	G	A	12	23	35	0	5	40	0	0
7	24460461	.	G	A	17	20	37	0	3	40	0	0
7	24461115	.	A	C	13	19	32	0	0	32	0	0
7	24461298	.	G	A	5	12	17	0	0	17	0	0
7	24461601	.	A	G	19	10	29	0	2	31	0	0
7	24462394	.	A	G	10	8	18	0	0	18	0	0
7	24485558	.	G	T	4	2	6	0	0	6	0	0
7	24486345	.	A	G	20	23	43	0	3	46	0	0
7	24486515	.	A	C	34	30	64	0	1	65	0	0
7	24486721	.	G	A	36	33	69	0	2	71	0	0
7	24491382	.	G	A	6	5	11	0	0	11	0	0
7	24497012	.	G	A	1	1	2	0	1	3	0	0
7	24498912	.	C	T	3	7	10	0	1	11	0	0
7	24501156	.	T	C	0	2	2	0	2	4	0	0
7	24501168	.	T	C	0	0	0	0	1	1	0	0
7	24502016	.	C	T	1	5	6	0	0	6	0	0
7	24502858	.	G	A	1	15	16	0	12	28	0	0
7	24502867	.	C	T	11	12	23	0	1	24	0	0
7	24502948	.	C	T	4	0	4	0	1	5	0	0
7	24504508	.	C	T	4	3	7	0	1	8	0	0
7	24504875	.	C	T	6	4	10	0	1	11	0	0
7	24505063	.	A	G	2	3	5	0	1	6	0	0
7	24505321	.	T	C	3	3	6	0	0	6	0	0
7	25348326	.	C	T	1	2	3	0	1	4	0	0
7	25843643	.	A	G	3	0	3	0	3	6	0	0
7	25843661	.	G	A	3	3	6	0	0	6	0	0
7	25852549	.	A	G	0	0	0	0	1	1	0	0
7	25854380	.	C	T	2	2	4	0	1	5	0	0
7	25858611	.	C	A	2	4	6	0	0	6	0	0
7	25863631	.	C	T	1	0	1	0	0	1	0	0
7	25863708	.	C	T	6	1	7	0	0	7	0	0
7	25869617	.	C	T	3	1	4	0	0	4	0	0
7	25869960	.	C	T	1	1	2	0	0	2	0	0
7	25870003	.	C	T	9	5	14	0	1	15	0	0
7	25870065	.	C	T	2	8	10	0	0	10	0	0
7	25870068	.	T	C	2	8	10	0	0	10	0	0
7	25876947	.	A	C	7	11	18	0	0	18	0	0
7	25877109	.	A	T	10	10	20	0	0	20	0	0
7	25877215	.	C	A	5	5	10	0	0	10	0	0
7	25878282	.	G	A	7	23	30	0	1	31	0	0
7	25878432	.	C	T	7	3	10	0	0	10	0	0
7	25878901	.	G	A	14	16	30	0	5	35	0	0
7	25878977	.	A	G	25	19	44	0	1	45	0	0
7	25879116	.	T	G	22	21	43	0	1	44	0	0
7	25879130	.	G	C	19	24	43	0	3	46	0	0
7	25879534	.	C	T	21	22	43	0	0	43	0	0
7	25879637	.	A	G	22	12	34	0	2	36	0	0
7	25879787	.	C	G	19	16	35	0	1	36	0	0
7	25879936	.	G	T	7	23	30	0	1	31	0	0
7	25880046	.	C	A	21	11	32	0	1	33	0	0
7	25880207	.	T	A	8	13	21	0	1	22	0	0
7	25880313	.	T	A	16	18	34	0	2	36	0	0
7	25880413	.	G	A	19	23	42	0	1	43	0	0
7	25880730	.	G	T	10	7	17	0	5	22	0	0
7	25880737	.	C	T	0	5	5	0	19	24	0	0
7	25880979	.	C	G	17	16	33	0	0	33	0	0
7	25881103	.	T	G	10	16	26	0	1	27	0	0
7	25881215	.	C	T	12	19	31	0	0	31	0	0
7	25881303	.	C	T	14	13	27	0	3	30	0	0
7	25881589	.	C	T	17	12	29	0	3	32	0	0
7	25881605	.	A	C	10	19	29	0	0	29	0	0
7	25884148	.	A	G	1	0	1	0	0	1	0	0
7	25895150	.	A	G	9	11	20	0	1	21	0	0
7	25895154	.	G	T	11	8	19	0	1	20	0	0
7	25917046	.	A	G	15	15	30	0	1	31	0	0
7	25917473	.	G	A	0	25	25	0	38	63	0	0
7	25917634	.	A	T	29	38	67	0	0	67	0	0
7	25918101	.	T	G	30	3	33	0	27	60	0	0
7	25918112	.	A	T	30	24	54	0	1	55	0	0
7	25920966	.	A	G	4	1	5	0	7	12	0	0
7	25979372	.	C	T	6	2	8	0	0	8	0	0
7	25979417	.	C	T	13	13	26	0	1	27	0	0
7	25979468	.	C	T	15	15	30	0	0	30	0	0
7	25986069	.	G	T	0	3	3	0	1	4	0	0
7	25986099	.	C	T	11	6	17	0	0	17	0	0
7	25986186	.	A	G	3	0	3	0	2	5	0	0
7	25988324	.	C	A	1	2	3	0	0	3	0	0
7	25998602	.	C	T	3	5	8	0	0	8	0	0
7	26002812	.	T	C	15	16	31	0	2	33	0	0
7	26003424	.	G	A	12	21	33	0	2	35	0	0
7	26003853	.	C	T	2	4	6	0	0	6	0	0
7	26004014	.	G	T	0	2	2	0	0	2	0	0
7	26004391	.	C	A	12	9	21	0	3	24	0	0
7	26004519	.	G	A	10	13	23	0	1	24	0	0
7	26005384	.	A	T	1	2	3	0	0	3	0	0
7	26020078	.	T	C	2	3	5	0	0	5	0	0
7	26020174	.	A	T	7	11	18	0	3	21	0	0
7	26020273	.	G	A	0	11	11	0	12	23	0	0
7	26020370	.	T	C	12	6	18	0	0	18	0	0
7	26020408	.	A	C	8	10	18	0	2	20	0	0
7	26026220	.	A	T	4	7	11	0	0	11	0	0
7	26026298	.	T	G	3	2	5	0	7	12	0	0
7	26026330	.	A	T	6	5	11	0	0	11	0	0
7	26026358	.	A	C	7	3	10	0	0	10	0	0
7	26026375	.	G	A	6	3	9	0	0	9	0	0
7	26048375	.	G	A	1	2	3	0	0	3	0	0
7	26073519	.	A	T	7	6	13	0	0	13	0	0
7	26074160	.	C	A	10	9	19	0	0	19	0	0
7	26076368	.	A	G	2	8	10	0	1	11	0	0
7	26076458	.	A	T	5	9	14	0	1	15	0	0
7	26078243	.	A	C	17	18	35	0	2	37	0	0
7	26078284	.	C	T	20	17	37	0	2	39	0	0
7	26078435	.	G	T	10	15	25	0	0	25	0	0
7	26078516	.	T	A	14	6	20	0	1	21	0	0
7	26078967	.	A	G	18	24	42	0	3	45	0	0
7	26078983	.	G	A	20	16	36	0	0	36	0	0
7	26079370	.	T	G	14	29	43	0	3	46	0	0
7	26081171	.	C	T	13	19	32	0	2	34	0	0
7	26081546	.	T	G	16	21	37	0	3	40	0	0
7	26081951	.	T	C	14	15	29	0	0	29	0	0
7	26082281	.	G	A	14	7	21	0	0	21	0	0
7	26082311	.	A	G	10	10	20	0	0	20	0	0
7	26082371	.	G	A	7	8	15	0	2	17	0	0
7	26082428	.	A	G	4	8	12	0	0	12	0	0
7	26116554	.	A	G	0	2	2	0	0	2	0	0
7	26116586	.	G	A	1	3	4	0	0	4	0	0
7	26116600	.	C	A	3	2	5	0	0	5	0	0
7	26116876	.	A	G	4	2	6	0	0	6	0	0
7	26118564	.	T	C	1	5	6	0	0	6	0	0
7	26118734	.	T	C	3	0	3	0	4	7	0	0
7	26118856	.	C	T	1	4	5	0	1	6	0	0
7	26118930	.	T	G	4	3	7	0	0	7	0	0
7	26140767	.	A	G	4	5	9	0	0	9	0	0
7	26141022	.	C	T	17	21	38	0	2	40	0	0
7	26141310	.	C	T	24	15	39	0	3	42	0	0
7	26141519	.	T	A	16	9	25	0	0	25	0	0
7	26141853	.	C	T	9	15	24	0	1	25	0	0
7	26142315	.	T	A	5	6	11	0	4	15	0	0
7	26142339	.	T	C	8	7	15	0	2	17	0	0
7	26142489	.	G	A	16	15	31	0	2	33	0	0
7	26142525	.	T	G	10	1	11	0	17	28	0	0
7	26142606	.	G	A	0	23	23	0	19	42	0	0
7	26143022	.	G	A	13	9	22	0	0	22	0	0
7	26143501	.	T	C	13	21	34	0	3	37	0	0
7	26143668	.	G	T	0	9	9	0	14	23	0	0
7	26144271	.	A	G	16	0	16	0	18	34	0	0
7	26144305	.	T	A	23	15	38	0	2	40	0	0
7	26144628	.	C	T	1	7	8	0	0	8	0	0
7	26144882	.	A	G	13	0	13	0	21	34	0	0
7	26144944	.	A	G	24	0	24	0	17	41	0	0
7	26145252	.	A	C	19	19	38	0	2	40	0	0
7	26145267	.	T	A	21	18	39	0	0	39	0	0
7	26145329	.	T	A	24	21	45	0	1	46	0	0
7	26145441	.	C	G	15	19	34	0	2	36	0	0
7	26145451	.	A	G	15	18	33	0	2	35	0	0
7	26145491	.	G	A	16	19	35	0	1	36	0	0
7	26145492	.	G	A	15	19	34	0	2	36	0	0
7	26145605	.	T	C	19	19	38	0	0	38	0	0
7	26145816	.	C	T	1	3	4	0	1	5	0	0
7	26146176	.	A	C	26	26	52	0	0	52	0	0
7	26146188	.	T	C	28	23	51	0	0	51	0	0
7	26146411	.	T	C	34	27	61	0	0	61	0	0
7	26146952	.	A	G	23	32	55	0	3	58	0	0
7	26146998	.	G	A	0	32	32	0	27	59	0	0
7	26147167	.	T	C	22	28	50	0	2	52	0	0
7	26147756	.	C	T	38	25	63	0	0	63	0	0
7	26148169	.	C	T	27	26	53	0	1	54	0	0
7	26148181	.	A	C	25	25	50	0	2	52	0	0
7	26148312	.	T	G	26	18	44	0	1	46	1	0
7	26148567	.	T	C	21	22	43	0	4	47	0	0
7	26148796	.	C	T	8	3	11	0	1	12	0	0
7	26149067	.	C	T	17	12	29	0	1	30	0	0
7	26149069	.	A	T	18	12	30	0	0	30	0	0
7	26173884	.	G	A	0	3	3	0	1	4	0	0
7	26173892	.	C	T	1	3	4	0	0	4	0	0
7	26224320	.	A	G	16	15	31	0	3	34	0	0
7	26224365	.	A	T	8	17	25	0	0	25	0	0
7	26226772	.	G	C	15	15	30	0	0	30	0	0
7	26226977	.	C	T	12	23	35	0	2	37	0	0
7	26227149	.	C	T	15	13	28	0	0	28	0	0
7	26227242	.	T	C	16	17	33	0	1	34	0	0
7	26227527	.	T	C	17	20	37	0	1	38	0	0
7	26227539	.	T	C	18	19	37	0	1	38	0	0
7	26228639	.	T	C	21	16	37	0	0	37	0	0
7	26229449	.	G	A	12	11	23	0	0	23	0	0
7	26229551	.	T	A	22	29	51	0	1	52	0	0
7	26229584	.	G	A	1	22	23	0	30	53	0	0
7	26229640	.	T	C	18	26	44	0	1	45	0	0
7	26229935	.	C	T	15	15	30	0	3	33	0	0
7	26229979	.	A	G	5	9	14	0	0	14	0	0
7	26245318	.	T	A	13	12	25	0	1	26	0	0
7	26245668	.	T	C	7	16	23	0	0	23	0	0
7	26245714	.	A	T	16	14	30	0	2	32	0	0
7	26246528	.	T	C	2	0	2	0	13	15	0	0
7	26263174	.	T	C	6	0	6	0	3	9	0	0
7	26266069	.	G	C	1	6	7	0	0	7	0	0
7	26266096	.	A	G	1	4	5	0	0	5	0	0
7	26266126	.	T	C	0	0	0	0	1	1	0	0
7	26266295	.	C	T	0	6	6	0	1	7	0	0
7	26268588	.	T	C	1	2	3	0	0	3	0	0
7	26269944	.	C	T	1	0	1	0	0	1	0	0
7	26300184	.	A	G	3	4	7	0	1	8	0	0
7	26300359	.	A	G	8	6	14	0	0	14	0	0
7	26300506	.	C	T	4	5	9	0	0	9	0	0
7	26303299	.	G	C	2	0	2	0	1	3	0	0
7	26306336	.	A	G	0	1	1	0	0	1	0	0
7	26306361	.	G	A	0	1	1	0	0	1	0	0
7	26366778	.	G	A	9	4	13	0	0	13	0	0
7	26366846	.	C	T	0	6	6	0	9	15	0	0
7	26366897	.	A	C	2	3	5	0	1	6	0	0
7	26366919	.	G	A	1	4	5	0	1	6	0	0
7	26366991	.	C	T	0	10	10	0	9	19	0	0
7	26367111	.	T	C	8	5	13	0	0	13	0	0
7	26367218	.	G	C	9	7	16	0	1	17	0	0
7	26367260	.	A	T	8	4	12	0	1	13	0	0
7	26367364	.	T	G	1	2	3	0	0	3	0	0
7	26367369	.	C	T	1	3	4	0	0	4	0	0
7	26367486	.	A	C	3	2	5	0	1	6	0	0
7	26367797	.	T	C	1	3	4	0	0	4	0	0
7	26368087	.	G	C	6	6	12	0	1	13	0	0
7	26368240	.	C	A	4	3	7	0	1	8	0	0
7	26368281	.	A	G	6	2	8	0	1	9	0	0
7	26368291	.	A	C	3	2	5	0	2	7	0	0
7	26368719	.	C	A	3	7	10	0	0	10	0	0
7	26368836	.	A	T	2	7	9	0	0	9	0	0
7	26368881	.	T	C	4	8	12	0	1	13	0	0
7	26368897	.	C	A	5	9	14	0	0	14	0	0
7	26369230	.	A	C	4	5	9	0	0	9	0	0
7	26369240	.	G	A	4	3	7	0	1	8	0	0
7	26369394	.	T	C	1	6	7	0	0	7	0	0
7	26369583	.	A	C	7	0	7	0	9	16	0	0
7	26371702	.	G	A	5	3	8	0	0	8	0	0
7	26378455	.	A	G	3	3	6	0	0	6	0	0
7	26380335	.	G	A	3	3	6	0	0	6	0	0
7	26389805	.	A	G	4	6	10	0	0	10	0	0
7	26394208	.	A	T	17	17	34	1	1	36	0	0
7	26394285	.	A	T	10	9	19	1	2	22	0	0
7	26394382	.	C	T	0	16	16	0	20	36	0	0
7	26394476	.	G	A	18	14	32	0	0	32	0	0
7	26394848	.	G	A	21	11	32	0	0	32	0	0
7	26395359	.	G	A	6	13	19	0	0	19	0	0
7	26395380	.	A	C	3	14	17	0	0	17	0	0
7	26395538	.	T	C	5	10	15	0	2	17	0	0
7	26395625	.	T	A	4	11	15	0	0	15	0	0
7	26395816	.	T	C	10	6	16	0	0	16	0	0
7	26396013	.	T	A	12	13	25	0	1	26	0	0
7	26396418	.	A	T	9	4	13	0	0	13	0	0
7	26396506	.	T	A	8	3	11	0	1	12	0	0
7	26396560	.	C	G	5	5	10	0	0	10	0	0
7	26396783	.	C	G	1	9	10	0	18	29	1	0
7	26396886	.	G	A	9	7	16	0	0	16	0	0
7	26396915	.	A	C	7	8	15	0	0	15	0	0
7	26397129	.	A	G	3	7	10	0	0	10	0	0
7	26397289	.	G	A	9	11	20	0	0	20	0	0
7	26397336	.	C	T	0	25	25	0	8	33	0	0
7	26397365	.	A	T	5	20	25	0	1	26	0	0
7	26397475	.	T	A	6	7	13	0	0	13	0	0
7	26397760	.	C	T	13	8	21	0	2	23	0	0
7	26398189	.	C	T	5	8	13	0	1	14	0	0
7	26398360	.	G	A	13	12	25	0	0	25	0	0
7	26398867	.	G	A	11	12	23	0	0	23	0	0
7	26402680	.	C	A	9	7	16	0	1	17	0	0
7	26402788	.	T	G	9	6	15	0	3	18	0	0
7	26408466	.	C	A	0	3	3	0	6	9	0	0
7	26432073	.	G	C	3	4	7	0	0	7	0	0
7	26432105	.	G	A	2	3	5	0	0	5	0	0
7	26432306	.	T	C	2	2	4	0	0	4	0	0
7	26432403	.	A	G	5	4	9	0	3	12	0	0
7	26432464	.	A	T	6	6	12	0	1	13	0	0
7	26432553	.	C	T	0	5	5	0	9	14	0	0
7	26432649	.	G	A	3	3	6	0	0	6	0	0
7	26432733	.	A	G	0	1	1	0	0	1	0	0
7	26472244	.	G	A	10	2	12	0	1	13	0	0
7	26472333	.	T	A	7	4	11	0	0	11	0	0
7	26472413	.	A	G	5	4	9	0	0	10	1	0
7	26472489	.	T	C	3	2	5	0	0	5	0	0
7	26472622	.	T	C	5	2	7	0	0	7	0	0
7	26472663	.	T	G	8	4	12	0	1	13	0	0
7	26472676	.	A	G	7	6	13	0	0	13	0	0
7	26472971	.	C	G	5	8	13	0	0	13	0	0
7	26473163	.	G	A	8	2	10	0	0	10	0	0
7	26497577	.	C	T	2	2	4	0	1	5	0	0
7	26511439	.	A	T	24	16	40	0	0	40	0	0
7	26511691	.	G	A	23	16	39	0	1	40	0	0
7	26511760	.	A	G	17	17	34	0	2	36	0	0
7	26511801	.	T	G	15	16	31	0	1	32	0	0
7	26519052	.	A	G	1	5	6	0	1	7	0	0
7	26519150	.	A	T	15	12	27	0	0	27	0	0
7	26522358	.	T	C	5	8	13	0	0	13	0	0
7	26522364	.	C	T	5	7	12	0	0	12	0	0
7	26523169	.	A	G	1	0	1	0	0	1	0	0
7	26525463	.	C	T	2	2	4	0	0	4	0	0
7	27327543	.	C	T	4	2	6	0	0	6	0	0
7	28042060	.	G	A	0	9	9	0	1	10	0	0
7	28042070	.	A	C	2	7	9	0	1	10	0	0
7	28043797	.	A	G	2	1	3	1	0	4	0	0
7	28044604	.	A	G	6	3	9	0	0	9	0	0
7	28407669	.	A	G	4	2	6	0	0	6	0	0
7	28998518	.	C	G	1	8	9	0	0	9	0	0
7	29109417	.	C	A	0	4	4	0	0	4	0	0
7	29109604	.	A	G	7	3	10	0	0	10	0	0
7	29177295	.	G	A	0	8	8	0	1	9	0	0
7	29177427	.	T	C	2	4	6	0	0	6	0	0
7	29182733	.	A	G	2	0	2	0	0	2	0	0
7	29185910	.	C	G	4	0	4	0	7	11	0	0
7	29186433	.	T	C	8	7	15	0	1	16	0	0
7	29186453	.	A	C	9	10	19	0	0	19	0	0
7	29186483	.	C	T	5	14	19	0	0	19	0	0
7	29186504	.	T	C	1	15	16	0	2	18	0	0
7	29186640	.	G	A	6	6	12	0	0	12	0	0
7	29186677	.	C	T	2	5	7	0	0	7	0	0
7	29189503	.	C	A	13	14	27	0	1	28	0	0
7	29192331	.	C	T	1	18	19	0	10	29	0	0
7	29199576	.	A	T	6	5	11	0	0	11	0	0
7	29205418	.	T	G	12	11	23	0	0	23	0	0
7	29207187	.	A	G	4	2	6	0	0	6	0	0
7	29207208	.	T	A	1	2	3	0	0	3	0	0
7	29210014	.	G	A	4	3	7	0	0	7	0	0
7	29211102	.	C	T	3	1	4	0	0	4	0	0
7	29215945	.	T	A	3	7	10	0	0	10	0	0
7	29220089	.	G	A	4	5	9	0	0	9	0	0
7	29220161	.	G	A	6	4	10	0	0	10	0	0
7	29223536	.	G	T	1	1	2	0	0	2	0	0
7	29227361	.	A	G	1	2	3	0	0	3	0	0
7	29227602	.	G	A	1	1	2	0	0	2	0	0
7	29229624	.	G	A	1	2	3	0	1	4	0	0
7	29229687	.	G	A	1	1	2	0	0	2	0	0
7	29231444	.	G	A	2	4	6	0	1	7	0	0
7	29231558	.	A	G	4	2	6	0	0	6	0	0
7	29235738	.	C	G	0	1	1	0	0	1	0	0
7	29250406	.	C	T	0	1	1	0	0	1	0	0
7	29250692	.	C	T	0	1	1	0	1	2	0	0
7	29252324	.	G	T	2	3	5	0	0	5	0	0
7	29281752	.	C	T	2	2	4	0	0	4	0	0
7	29301751	.	C	T	1	0	1	0	0	1	0	0
7	29308886	.	C	A	3	7	10	0	0	10	0	0
7	29309315	.	A	C	4	5	9	0	0	9	0	0
7	29309454	.	C	T	4	8	12	0	0	12	0	0
7	29309726	.	G	A	5	3	8	0	0	8	0	0
7	29309897	.	T	C	5	7	12	0	0	12	0	0
7	29310537	.	C	T	5	9	14	0	0	14	0	0
7	29310543	.	G	A	0	9	9	0	6	15	0	0
7	29310618	.	G	A	7	9	16	0	1	17	0	0
7	29310654	.	C	T	4	4	8	0	0	8	0	0
7	29310700	.	G	A	5	4	9	0	0	9	0	0
7	29355244	.	G	C	7	0	7	0	9	16	0	0
7	29356006	.	A	C	19	0	19	0	15	34	0	0
7	29461255	.	T	C	1	2	3	0	0	3	0	0
7	29539862	.	T	C	7	10	17	0	0	17	0	0
7	29540207	.	A	G	8	3	11	0	1	12	0	0
7	29540311	.	A	C	6	12	18	0	0	18	0	0
7	29540536	.	A	T	15	7	22	0	1	23	0	0
7	29540537	.	C	T	0	7	7	0	16	23	0	0
7	29540885	.	T	A	10	15	25	0	2	28	1	0
7	29540999	.	A	G	6	15	21	0	0	21	0	0
7	29542909	.	T	G	3	2	5	0	0	5	0	0
7	29542916	.	T	C	3	2	5	0	0	5	0	0
7	29553317	.	A	T	7	5	12	0	2	14	0	0
7	29553338	.	G	A	6	6	12	0	3	15	0	0
7	29553446	.	G	A	6	10	16	0	2	18	0	0
7	29553473	.	G	A	4	5	9	0	0	9	0	0
7	29625326	.	C	T	4	7	11	0	1	12	0	0
7	29629457	.	G	C	1	0	1	0	3	4	0	0
7	29629613	.	T	A	0	3	3	0	1	4	0	0
7	29630186	.	C	T	0	4	4	0	1	5	0	0
7	29630906	.	A	G	0	2	2	0	0	2	0	0
7	29633693	.	T	C	4	3	7	0	0	7	0	0
7	29651413	.	C	T	0	5	5	0	4	9	0	0
7	29653500	.	C	T	0	3	3	0	2	5	0	0
7	29653521	.	C	T	2	2	4	0	0	4	0	0
7	29658306	.	T	C	1	1	2	0	0	2	0	0
7	29660410	.	G	A	4	2	6	0	0	6	0	0
7	29662964	.	G	A	7	3	10	0	1	11	0	0
7	29663064	.	T	A	2	5	7	0	0	7	0	0
7	29664300	.	G	T	1	4	5	0	0	6	1	0
7	29666328	.	C	T	2	1	3	0	0	3	0	0
7	29670445	.	G	A	3	2	5	0	1	6	0	0
7	29670934	.	C	T	0	5	5	0	1	6	0	0
7	29675489	.	T	C	1	0	1	0	0	1	0	0
7	29677810	.	T	A	2	0	2	0	0	2	0	0
7	29683915	.	A	G	0	1	1	0	0	1	0	0
7	29688494	.	A	G	0	1	1	0	0	1	0	0
7	29688501	.	G	A	0	1	1	0	0	1	0	0
7	29894964	.	T	G	3	3	6	0	0	6	0	0
7	29906436	.	A	G	2	0	2	0	0	2	0	0
7	29911268	.	T	C	1	2	3	0	0	3	0	0
7	29911385	.	G	C	1	0	1	0	0	1	0	0
7	29912773	.	C	T	1	2	3	0	0	3	0	0
7	29923340	.	A	G	1	2	3	0	0	3	0	0
7	29923392	.	T	C	1	0	1	0	0	1	0	0
7	29924109	.	A	G	0	3	3	0	1	4	0	0
7	29924142	.	T	C	2	3	5	0	0	5	0	0
7	29927724	.	A	G	2	0	2	0	1	3	0	0
7	29928164	.	T	G	1	1	2	0	0	2	0	0
7	29930146	.	G	A	0	0	0	0	1	1	0	0
7	29930445	.	C	T	1	2	3	0	0	3	0	0
7	29935803	.	C	T	1	2	3	0	0	3	0	0
7	29939497	.	A	C	1	0	1	0	0	1	0	0
7	29939655	.	G	A	0	0	0	0	3	3	0	0
7	29939673	.	T	C	2	0	2	0	1	3	0	0
7	29944366	.	G	C	0	5	5	0	8	13	0	0
7	29944461	.	T	C	3	4	7	0	0	7	0	0
7	29944935	.	A	T	4	5	9	0	3	12	0	0
7	29945050	.	A	T	1	5	6	0	0	6	0	0
7	29945136	.	G	A	2	3	5	0	0	5	0	0
7	29945482	.	A	G	4	5	9	0	0	9	0	0
7	29945493	.	A	G	5	4	9	0	3	12	0	0
7	29945609	.	C	A	7	8	15	0	0	15	0	0
7	29945659	.	A	G	9	0	9	0	3	12	0	0
7	29945881	.	A	T	6	13	19	1	0	20	0	0
7	29961038	.	G	A	3	6	9	0	1	10	0	0
7	29961106	.	C	T	8	7	15	0	2	17	0	0
7	29961455	.	G	C	10	5	15	0	0	15	0	0
7	29961479	.	A	T	5	5	10	0	0	10	0	0
7	29961567	.	C	T	18	10	28	0	0	28	0	0
7	29961649	.	G	A	3	7	10	0	0	10	0	0
7	29961658	.	T	A	2	6	8	0	0	8	0	0
7	29961876	.	T	C	2	5	7	0	0	7	0	0
7	29964289	.	A	G	1	0	1	0	0	1	0	0
7	29964713	.	G	A	2	3	5	0	0	5	0	0
7	29966892	.	A	G	4	3	7	0	1	8	0	0
7	29968012	.	G	C	4	4	8	0	0	8	0	0
7	29968144	.	T	C	6	4	10	0	0	10	0	0
7	29968298	.	G	A	4	5	9	0	0	9	0	0
7	29968454	.	T	A	3	5	8	0	0	8	0	0
7	29968505	.	G	A	3	5	8	0	1	9	0	0
7	29969607	.	A	G	7	1	8	0	3	11	0	0
7	29969644	.	G	A	0	4	4	0	13	17	0	0
7	29969724	.	A	C	2	4	6	0	0	6	0	0
7	29969996	.	A	T	5	5	10	0	0	10	0	0
7	29970194	.	T	G	5	2	7	0	0	7	0	0
7	29970195	.	C	T	4	2	6	0	1	7	0	0
7	30075430	.	G	A	8	8	16	0	0	16	0	0
7	30075631	.	C	A	5	16	21	0	1	22	0	0
7	30075823	.	C	T	3	14	17	0	1	18	0	0
7	30075845	.	T	C	7	21	28	0	0	28	0	0
7	30075974	.	A	G	17	21	38	0	0	38	0	0
7	30075983	.	G	A	14	25	39	0	2	41	0	0
7	30076036	.	A	C	13	13	26	0	0	26	0	0
7	30076083	.	A	T	6	4	10	0	0	10	0	0
7	30076141	.	T	G	8	7	15	0	2	17	0	0
7	30076217	.	T	C	6	7	13	0	0	13	0	0
7	30076241	.	G	T	9	5	14	0	0	14	0	0
7	30076591	.	G	A	14	12	26	1	1	28	0	0
7	30076608	.	T	G	14	7	21	0	1	22	0	0
7	30076653	.	C	A	15	16	31	0	0	31	0	0
7	30076692	.	C	T	17	21	38	0	0	38	0	0
7	30076744	.	G	A	13	20	33	0	0	33	0	0
7	30076852	.	A	T	11	21	32	0	1	33	0	0
7	30076872	.	T	C	12	0	12	0	19	31	0	0
7	30076962	.	A	T	3	9	12	0	1	13	0	0
7	30076966	.	A	G	3	8	11	0	0	11	0	0
7	30077288	.	C	T	3	4	7	0	0	7	0	0
7	30077328	.	A	G	3	2	5	0	0	5	0	0
7	30080032	.	G	A	2	4	6	0	0	6	0	0
7	30080166	.	A	G	6	1	7	0	0	7	0	0
7	30080468	.	C	G	3	4	7	0	0	7	0	0
7	30080603	.	T	C	3	1	4	0	0	4	0	0
7	30080872	.	G	A	10	7	17	0	0	17	0	0
7	30082857	.	C	A	18	13	31	0	0	31	0	0
7	30082871	.	T	A	17	9	26	0	0	26	0	0
7	30082894	.	G	C	9	6	15	0	0	15	0	0
7	30086732	.	T	C	2	4	6	0	0	6	0	0
7	30136304	.	C	G	4	6	10	0	1	11	0	0
7	30136604	.	C	T	2	4	6	0	0	6	0	0
7	30136899	.	A	T	1	3	4	0	0	4	0	0
7	30137261	.	A	G	1	2	3	0	0	3	0	0
7	30137350	.	C	T	8	3	11	0	1	12	0	0
7	30137667	.	C	T	3	4	7	0	1	8	0	0
7	30138737	.	G	A	5	4	9	0	1	10	0	0
7	30139465	.	T	G	1	2	3	0	1	4	0	0
7	30139490	.	C	T	1	4	5	0	0	5	0	0
7	30139655	.	C	T	2	3	5	0	0	5	0	0
7	30139952	.	G	A	6	4	10	0	0	10	0	0
7	30139991	.	T	A	3	4	7	0	0	7	0	0
7	30140027	.	G	A	0	3	3	0	0	3	0	0
7	30177500	.	G	A	2	5	7	0	0	7	0	0
7	30178807	.	G	A	3	2	5	0	0	5	0	0
7	30188324	.	T	C	0	1	1	0	0	1	0	0
7	30210151	.	T	A	10	6	16	0	0	16	0	0
7	30210359	.	C	T	3	7	10	0	1	11	0	0
7	30210362	.	T	C	2	7	9	0	1	10	0	0
7	30210445	.	C	G	0	15	15	0	9	24	0	0
7	30210579	.	G	T	10	12	22	0	0	22	0	0
7	30210659	.	T	C	9	6	15	0	0	15	0	0
7	30210741	.	G	A	5	4	9	0	0	9	0	0
7	30210785	.	A	G	2	4	6	0	0	6	0	0
7	30211482	.	C	T	3	10	13	0	0	13	0	0
7	30211530	.	T	A	2	6	8	0	0	8	0	0
7	30213948	.	A	G	9	9	18	0	1	19	0	0
7	30216972	.	T	G	2	2	4	0	0	4	0	0
7	30260812	.	T	A	0	1	1	0	0	1	0	0
7	30263870	.	C	T	3	3	6	0	0	6	0	0
7	30263889	.	G	A	0	2	2	0	4	6	0	0
7	30275668	.	A	T	9	10	19	0	0	19	0	0
7	30275676	.	A	T	12	7	19	0	2	21	0	0
7	30280856	.	C	G	6	6	12	0	1	13	0	0
7	30283329	.	C	A	2	2	4	0	0	4	0	0
7	30286057	.	C	G	3	3	6	0	0	6	0	0
7	30327330	.	A	T	7	2	9	0	0	9	0	0
7	30327708	.	C	T	0	2	2	0	5	7	0	0
7	30330368	.	G	A	0	1	1	0	0	1	0	0
7	30330605	.	G	A	0	2	2	0	0	2	0	0
7	30410687	.	T	A	8	11	19	0	0	19	0	0
7	30411187	.	T	C	12	7	19	1	1	21	0	0
7	30412857	.	C	T	2	5	7	0	1	8	0	0
7	30412884	.	C	T	10	5	15	0	1	16	0	0
7	30416824	.	A	T	2	3	5	0	0	5	0	0
7	30421532	.	G	A	0	2	2	0	0	2	0	0
7	30518843	.	C	T	5	3	8	0	0	8	0	0
7	30519636	.	C	A	1	0	1	0	0	1	0	0
7	30522713	.	C	T	1	1	2	0	0	2	0	0
7	30525721	.	G	T	1	2	3	0	0	3	0	0
7	30534433	.	G	T	5	4	9	0	0	9	0	0
7	30534499	.	C	G	5	4	9	0	0	9	0	0
7	30534678	.	G	A	0	7	7	0	4	11	0	0
7	30534930	.	T	A	3	3	6	0	0	6	0	0
7	30535113	.	G	T	2	6	8	0	0	8	0	0
7	30535162	.	T	G	1	10	11	0	0	11	0	0
7	30535163	.	G	T	1	10	11	0	0	11	0	0
7	30535422	.	A	G	1	3	4	0	0	4	0	0
7	30535645	.	T	C	2	2	4	0	0	4	0	0
7	30535874	.	T	A	3	2	5	0	0	5	0	0
7	30536377	.	T	A	4	3	7	0	0	7	0	0
7	30536396	.	C	G	5	4	9	0	1	10	0	0
7	30536958	.	T	A	7	5	12	0	0	12	0	0
7	30537014	.	G	A	10	5	15	0	0	15	0	0
7	30537114	.	T	C	4	5	9	0	0	9	0	0
7	30537365	.	G	T	8	6	14	0	0	14	0	0
7	30537370	.	T	A	6	7	13	0	0	13	0	0
7	30537783	.	A	T	5	5	10	0	0	10	0	0
7	30537804	.	C	T	8	8	16	0	0	16	0	0
7	30537858	.	G	A	12	10	22	0	1	23	0	0
7	30538280	.	G	A	8	5	13	0	0	13	0	0
7	30541693	.	G	A	11	10	21	0	0	21	0	0
7	30542295	.	C	T	5	3	8	0	1	9	0	0
7	30543682	.	T	C	20	19	39	0	2	41	0	0
7	30552992	.	G	A	9	3	12	0	1	13	0	0
7	30562290	.	C	T	0	8	8	0	7	15	0	0
7	30562552	.	T	A	5	9	14	0	0	14	0	0
7	30563116	.	G	A	2	4	6	0	2	8	0	0
7	30578818	.	C	T	0	2	2	0	1	3	0	0
7	30578916	.	G	A	11	7	18	0	1	19	0	0
7	30583147	.	G	A	2	1	3	0	0	3	0	0
7	30604616	.	T	A	1	2	3	0	0	3	0	0
7	30604922	.	C	T	0	3	3	0	3	6	0	0
7	30624214	.	G	A	1	3	4	0	0	4	0	0
7	30632737	.	G	T	4	9	13	0	0	13	0	0
7	30632807	.	G	C	5	0	5	0	8	13	0	0
7	30641151	.	G	T	3	6	9	0	0	9	0	0
7	30641187	.	G	T	2	1	3	0	0	3	0	0
7	30652369	.	T	C	2	0	2	0	1	3	0	0
7	30763671	.	G	A	2	2	4	0	0	4	0	0
7	30765760	.	C	T	2	1	3	0	0	3	0	0
7	30768073	.	C	T	3	5	8	0	0	8	0	0
7	30768392	.	A	G	2	3	5	0	1	6	0	0
7	30768551	.	T	A	0	3	3	0	1	4	0	0
7	30770041	.	A	G	6	2	8	0	1	9	0	0
7	30770971	.	T	A	5	5	10	0	0	10	0	0
7	30773168	.	T	A	6	2	8	0	0	8	0	0
7	30773169	.	T	A	4	2	6	0	2	8	0	0
7	30777549	.	C	T	1	7	8	0	0	8	0	0
7	30777617	.	G	A	11	3	14	0	0	14	0	0
7	30778363	.	A	G	1	1	2	0	0	2	0	0
7	30778657	.	T	C	5	3	8	0	1	9	0	0
7	30778703	.	C	G	2	5	7	0	1	8	0	0
7	30778714	.	G	A	2	5	7	0	0	7	0	0
7	30778840	.	A	T	7	4	11	0	0	11	0	0
7	30778859	.	G	A	7	4	11	0	0	11	0	0
7	30780017	.	A	G	2	1	3	0	0	3	0	0
7	30780272	.	G	A	6	4	10	0	0	10	0	0
7	30782104	.	C	T	7	3	10	0	1	11	0	0
7	30782559	.	G	A	6	8	14	0	1	15	0	0
7	30782669	.	A	G	7	6	13	0	0	13	0	0
7	30867006	.	C	T	13	12	25	0	1	26	0	0
7	30867658	.	T	A	6	19	25	0	2	27	0	0
7	30867670	.	A	G	6	0	6	0	23	29	0	0
7	30867731	.	A	G	16	16	32	0	3	35	0	0
7	30867775	.	T	G	16	16	32	0	1	33	0	0
7	30868009	.	C	T	25	19	44	0	0	44	0	0
7	30875257	.	G	A	1	3	4	0	0	4	0	0
7	30911937	.	C	T	3	3	6	0	1	7	0	0
7	30914622	.	C	T	16	9	25	0	1	26	0	0
7	30914706	.	C	T	30	16	46	0	3	49	0	0
7	30915040	.	A	G	3	10	13	0	0	13	0	0
7	30915306	.	G	A	20	30	50	0	2	52	0	0
7	30915388	.	A	G	22	19	41	0	4	45	0	0
7	30915823	.	G	A	2	24	26	0	17	43	0	0
7	30923638	.	C	T	0	6	6	0	2	8	0	0
7	30923658	.	C	A	1	1	2	0	0	2	0	0
7	30924031	.	A	G	3	3	6	0	0	6	0	0
7	30924646	.	T	A	1	0	1	0	0	1	0	0
7	30924772	.	T	C	0	1	1	0	0	1	0	0
7	30970131	.	G	T	9	3	12	0	0	12	0	0
7	31093055	.	A	G	4	0	4	0	4	8	0	0
7	31107735	.	G	A	0	0	0	0	1	1	0	0
7	31108139	.	A	T	0	2	2	0	0	2	0	0
7	31112204	.	G	A	7	8	15	0	0	15	0	0
7	31112264	.	G	T	1	3	4	0	1	5	0	0
7	31120825	.	G	A	0	9	9	0	12	21	0	0
7	31120906	.	C	A	13	15	28	0	2	30	0	0
7	31121005	.	C	T	16	16	32	0	1	33	0	0
7	31125653	.	C	T	5	4	9	0	1	10	0	0
7	31125776	.	G	A	0	11	11	0	13	24	0	0
7	31125860	.	T	C	17	15	32	0	4	36	0	0
7	31125980	.	C	A	14	17	31	0	1	32	0	0
7	31126127	.	C	A	4	8	12	0	2	14	0	0
7	31128396	.	T	C	15	17	32	0	0	32	0	0
7	31128475	.	A	C	12	17	29	0	3	32	0	0
7	31130267	.	A	G	2	0	2	0	1	3	0	0
7	31130285	.	T	C	5	7	12	0	0	12	0	0
7	31132771	.	A	C	3	0	3	0	1	4	0	0
7	31140479	.	C	A	13	3	16	0	0	16	0	0
7	31140594	.	G	A	14	10	24	0	0	24	0	0
7	31140634	.	A	C	9	10	19	0	0	19	0	0
7	31140976	.	A	C	4	8	12	0	1	13	0	0
7	31141044	.	C	T	10	10	20	0	1	21	0	0
7	31141086	.	G	A	0	9	9	0	5	14	0	0
7	31141372	.	T	C	16	14	30	0	1	31	0	0
7	31141747	.	T	A	10	4	14	0	1	15	0	0
7	31142030	.	C	T	10	8	18	0	0	18	0	0
7	31145438	.	G	A	2	3	5	0	0	5	0	0
7	31326689	.	G	A	6	5	11	0	1	12	0	0
7	31326862	.	T	C	5	9	14	0	0	14	0	0
7	31335951	.	A	C	4	2	6	0	0	6	0	0
7	31339177	.	T	A	6	6	12	0	1	13	0	0
7	31339344	.	T	C	11	14	25	0	0	25	0	0
7	31359003	.	T	C	0	3	3	0	0	3	0	0
7	31364072	.	C	T	11	3	14	0	0	14	0	0
7	31366684	.	C	T	6	9	15	0	0	15	0	0
7	31367057	.	A	G	12	11	23	0	0	23	0	0
7	31367667	.	A	T	7	4	11	0	1	12	0	0
7	31367668	.	C	T	8	4	12	0	0	12	0	0
7	31367777	.	C	G	15	9	24	0	0	25	1	0
7	31367850	.	C	T	5	9	14	0	2	16	0	0
7	31381100	.	A	T	7	10	17	0	1	18	0	0
7	31381129	.	G	T	3	6	9	0	0	9	0	0
7	31381713	.	C	T	6	3	9	0	1	10	0	0
7	31388206	.	C	T	1	2	3	0	0	3	0	0
7	31390492	.	T	A	5	2	7	0	0	7	0	0
7	31390995	.	T	G	5	5	10	0	0	10	0	0
7	31391020	.	T	C	6	7	13	0	0	13	0	0
7	31391316	.	C	T	2	2	4	0	0	4	0	0
7	31391429	.	C	T	6	6	12	0	0	12	0	0
7	31391784	.	G	A	6	6	12	0	0	12	0	0
7	31391799	.	C	G	5	6	11	0	0	11	0	0
7	31392315	.	T	A	7	12	19	0	3	22	0	0
7	31392485	.	A	G	2	15	17	0	2	19	0	0
7	31392492	.	G	A	4	13	17	0	1	18	0	0
7	31426008	.	A	G	4	0	4	0	5	9	0	0
7	31427812	.	T	C	4	2	6	0	0	6	0	0
7	31428824	.	G	T	0	6	6	0	4	10	0	0
7	31431507	.	T	C	3	3	6	0	0	6	0	0
7	31431548	.	T	A	3	4	7	0	0	7	0	0
7	31431745	.	C	G	9	8	17	0	0	17	0	0
7	31431898	.	T	C	9	4	13	0	1	14	0	0
7	31495021	.	T	A	1	2	3	0	0	3	0	0
7	31495208	.	A	G	9	8	17	0	1	18	0	0
7	31495329	.	C	T	5	6	11	0	0	11	0	0
7	31495353	.	C	T	4	3	7	0	1	8	0	0
7	31495377	.	C	T	5	5	10	0	0	10	0	0
7	31496279	.	C	T	1	3	4	0	0	4	0	0
7	31496402	.	A	G	3	3	6	0	0	6	0	0
7	31496405	.	A	T	3	2	5	0	1	6	0	0
7	31496524	.	T	C	3	0	3	0	6	9	0	0
7	31496544	.	C	T	4	6	10	0	0	10	0	0
7	31496601	.	T	A	2	2	4	0	0	4	0	0
7	31496641	.	T	A	6	2	8	0	0	8	0	0
7	31497462	.	G	A	4	2	6	0	0	6	0	0
7	31497627	.	A	G	2	2	4	0	0	4	0	0
7	31497662	.	T	C	2	5	7	0	0	7	0	0
7	31497827	.	T	C	4	0	4	0	4	8	0	0
7	31497837	.	T	C	4	3	7	0	0	7	0	0
7	31498394	.	A	T	2	2	4	0	0	4	0	0
7	31498395	.	G	A	2	2	4	0	0	4	0	0
7	31498469	.	G	A	6	6	12	0	1	13	0	0
7	31498903	.	A	G	1	2	3	0	0	3	0	0
7	31498909	.	C	T	1	2	3	0	0	3	0	0
7	31501433	.	C	T	0	3	3	0	1	4	0	0
7	31501443	.	T	G	1	5	6	0	0	6	0	0
7	31504763	.	G	A	1	0	1	0	0	1	0	0
7	31537299	.	C	T	0	2	2	0	1	3	0	0
7	31603260	.	T	C	1	1	2	0	1	3	0	0
7	31603329	.	C	T	1	2	3	0	0	3	0	0
7	31625690	.	C	T	0	2	2	0	4	6	0	0
7	31626277	.	G	T	2	4	6	0	0	6	0	0
7	31626335	.	T	C	2	3	5	0	0	5	0	0
7	31627107	.	T	A	1	2	3	0	0	3	0	0
7	31628372	.	T	A	2	3	5	0	0	5	0	0
7	31776224	.	G	A	16	10	26	0	1	27	0	0
7	31776645	.	T	A	10	8	18	0	1	21	2	0
7	31776706	.	G	A	9	10	19	0	0	19	0	0
7	31776735	.	T	C	13	12	25	0	1	26	0	0
7	31776877	.	C	T	5	9	14	0	0	14	0	0
7	31777227	.	T	C	7	10	17	0	0	17	0	0
7	31777337	.	T	G	10	4	14	0	0	14	0	0
7	31777528	.	C	T	11	6	17	0	0	17	0	0
7	31777569	.	G	C	8	1	9	0	11	20	0	0
7	31782235	.	A	G	9	5	14	0	0	14	0	0
7	31784996	.	T	C	4	3	7	0	0	7	0	0
7	31796453	.	G	A	10	7	17	0	1	18	0	0
7	31796725	.	T	C	5	0	5	0	9	14	0	0
7	31796845	.	A	G	2	9	11	0	1	12	0	0
7	31796861	.	T	G	2	9	11	0	0	11	0	0
7	31796990	.	C	T	0	4	4	0	3	7	0	0
7	31802890	.	C	T	4	2	6	0	0	6	0	0
7	31802938	.	A	T	3	1	4	0	0	4	0	0
7	31817903	.	C	T	6	2	8	0	0	8	0	0
7	31818640	.	A	G	1	0	1	0	0	1	0	0
7	31827218	.	C	A	1	3	4	0	0	4	0	0
7	31902535	.	G	T	6	8	14	0	0	14	0	0
7	31902536	.	A	T	5	9	14	0	0	14	0	0
7	31902633	.	T	A	5	9	14	0	0	14	0	0
7	31902757	.	T	A	21	21	42	0	0	42	0	0
7	31903205	.	T	A	5	2	7	0	1	8	0	0
7	31903276	.	G	A	8	3	11	0	0	11	0	0
7	31903516	.	T	G	2	4	6	0	2	8	0	0
7	31903823	.	G	T	0	2	2	0	1	3	0	0
7	31903993	.	A	T	4	5	9	0	0	9	0	0
7	31904146	.	G	A	3	7	10	0	0	10	0	0
7	31904180	.	G	A	6	7	13	0	0	13	0	0
7	31904192	.	G	T	8	8	16	0	0	16	0	0
7	31904381	.	C	A	13	8	21	0	0	21	0	0
7	31904442	.	T	G	8	9	17	0	0	17	0	0
7	31905040	.	T	C	4	0	4	0	6	12	2	0
7	31905126	.	C	T	11	9	20	0	0	20	0	0
7	31905217	.	T	A	2	11	13	0	1	14	0	0
7	31907970	.	C	A	1	5	6	0	0	6	0	0
7	31925975	.	C	T	20	21	41	0	1	42	0	0
7	31940373	.	A	G	2	3	5	0	0	5	0	0
7	31941475	.	T	A	2	3	5	0	0	5	0	0
7	31978323	.	C	A	3	3	6	0	0	6	0	0
7	31978346	.	C	A	0	3	3	0	3	6	0	0
7	32142302	.	A	C	2	8	10	0	0	10	0	0
7	32456307	.	C	T	2	2	4	0	0	4	0	0
7	32456423	.	G	A	1	3	4	0	0	4	0	0
7	32456619	.	A	C	2	3	5	0	0	5	0	0
7	32457300	.	C	T	1	3	4	0	0	4	0	0
7	32457363	.	C	T	2	2	4	0	1	5	0	0
7	32457655	.	C	A	1	2	3	0	1	4	0	0
7	32458136	.	C	A	2	9	11	0	0	11	0	0
7	32458183	.	G	A	0	2	2	0	7	9	0	0
7	32458227	.	A	T	3	6	9	0	0	9	0	0
7	32458270	.	C	A	2	4	6	0	0	6	0	0
7	32458467	.	G	C	0	3	3	0	0	3	0	0
7	32458846	.	A	T	3	3	6	0	0	6	0	0
7	32459107	.	C	A	6	4	10	0	0	10	0	0
7	32459126	.	G	T	3	5	8	0	0	8	0	0
7	32459256	.	G	T	3	3	6	0	0	6	0	0
7	32459411	.	C	T	6	4	10	0	0	10	0	0
7	32538091	.	G	T	3	1	4	0	1	5	0	0
7	32597340	.	G	A	3	4	7	0	0	7	0	0
7	32599347	.	T	C	2	2	4	0	0	4	0	0
7	32624814	.	T	A	9	10	19	0	1	20	0	0
7	32624823	.	G	A	11	10	21	0	0	21	0	0
7	32624892	.	C	T	10	10	20	0	0	20	0	0
7	32628387	.	T	C	9	12	21	0	0	21	0	0
7	32629309	.	C	A	0	5	5	0	4	9	0	0
7	32629349	.	G	T	12	10	22	0	0	22	0	0
7	32637565	.	C	T	1	4	5	0	0	5	0	0
7	32637580	.	C	T	1	3	4	0	0	4	0	0
7	32645754	.	T	G	2	2	4	0	0	4	0	0
7	32645758	.	G	C	2	2	4	0	0	4	0	0
7	32696011	.	A	G	2	0	2	0	4	6	0	0
7	32696038	.	A	C	1	5	6	0	0	6	0	0
7	32700594	.	C	T	1	5	6	0	0	6	0	0
7	32714730	.	T	C	1	5	6	0	0	6	0	0
7	32714833	.	C	T	5	6	11	0	0	11	0	0
7	32722539	.	G	A	6	5	11	0	1	12	0	0
7	32722694	.	G	T	3	8	11	0	1	12	0	0
7	32742572	.	G	A	4	6	10	0	1	11	0	0
7	32742962	.	T	C	3	5	8	0	0	8	0	0
7	32742967	.	G	A	2	4	6	0	1	7	0	0
7	32743091	.	A	T	8	7	15	0	0	15	0	0
7	32743110	.	A	T	7	6	13	0	0	13	0	0
7	32743370	.	C	A	6	2	8	0	1	9	0	0
7	32743459	.	A	G	2	0	2	0	3	5	0	0
7	32743512	.	T	C	4	4	8	0	0	8	0	0
7	32743688	.	A	T	2	3	5	0	0	5	0	0
7	32743728	.	C	G	4	6	10	0	1	11	0	0
7	32743751	.	C	A	4	7	11	0	0	11	0	0
7	32743811	.	T	A	5	4	9	0	0	9	0	0
7	32743818	.	T	A	7	2	9	0	1	10	0	0
7	32743918	.	G	C	4	8	12	0	2	14	0	0
7	32743959	.	A	C	2	8	10	0	1	11	0	0
7	32743961	.	A	G	2	9	11	0	0	11	0	0
7	32744027	.	T	C	10	10	20	0	2	22	0	0
7	32744459	.	T	A	9	6	15	0	1	16	0	0
7	32744485	.	A	G	4	5	9	0	1	10	0	0
7	32744540	.	T	C	16	4	20	0	0	20	0	0
7	32744542	.	A	G	17	0	17	0	3	20	0	0
7	32744648	.	A	G	8	15	23	0	0	23	0	0
7	32744663	.	T	A	7	13	20	0	1	21	0	0
7	32744856	.	G	A	8	7	15	0	1	16	0	0
7	32744906	.	T	C	7	12	19	0	1	20	0	0
7	32744919	.	T	G	5	11	16	0	2	18	0	0
7	32745025	.	T	C	9	11	20	0	0	20	0	0
7	32745170	.	A	G	5	7	12	0	0	12	0	0
7	32745190	.	T	C	6	8	14	0	0	14	0	0
7	32745461	.	C	T	3	12	15	0	0	15	0	0
7	32746026	.	T	C	8	3	11	0	0	11	0	0
7	32746152	.	A	C	5	7	12	0	1	13	0	0
7	32746213	.	A	G	11	9	20	0	1	21	0	0
7	32746324	.	G	A	17	12	29	0	2	31	0	0
7	32746327	.	A	C	17	12	29	0	2	31	0	0
7	32746370	.	C	T	17	10	27	0	1	28	0	0
7	32746457	.	A	C	17	15	32	0	0	32	0	0
7	32746584	.	C	T	10	15	25	0	1	26	0	0
7	32746614	.	C	T	15	12	27	0	0	27	0	0
7	32746676	.	T	C	12	15	27	0	1	28	0	0
7	32746732	.	A	G	12	12	24	0	0	24	0	0
7	32747029	.	A	T	4	2	6	0	1	7	0	0
7	32747033	.	G	A	5	2	7	0	1	8	0	0
7	32747135	.	T	C	6	11	17	0	0	17	0	0
7	32747424	.	T	A	2	5	7	0	0	7	0	0
7	32747956	.	A	G	17	0	17	0	11	28	0	0
7	32747973	.	A	G	13	15	28	0	0	28	0	0
7	32748006	.	T	C	8	13	21	0	2	23	0	0
7	32748203	.	A	G	13	10	23	0	1	24	0	0
7	32748319	.	C	A	12	20	32	0	1	33	0	0
7	32748486	.	A	T	7	6	13	0	2	15	0	0
7	32748725	.	G	A	11	19	30	0	1	31	0	0
7	32748914	.	G	A	23	13	36	0	0	36	0	0
7	32749048	.	T	A	22	13	35	0	1	36	0	0
7	32749144	.	T	C	14	18	32	0	0	32	0	0
7	32749146	.	A	G	14	18	32	0	0	32	0	0
7	32812361	.	A	G	22	21	43	0	0	43	0	0
7	32812472	.	G	A	15	12	27	1	1	29	0	0
7	32812804	.	G	A	5	12	17	0	4	21	0	0
7	32812830	.	A	G	7	7	14	0	1	15	0	0
7	32813004	.	T	C	18	15	33	0	1	34	0	0
7	32813366	.	A	G	11	27	38	0	1	39	0	0
7	32813605	.	T	G	7	6	13	0	1	14	0	0
7	32813689	.	C	T	7	5	12	0	1	13	0	0
7	32813962	.	A	C	6	4	10	0	0	10	0	0
7	32814139	.	C	G	5	4	9	0	2	11	0	0
7	32814141	.	G	C	5	5	10	0	1	11	0	0
7	32814502	.	T	C	11	0	11	0	7	18	0	0
7	32814542	.	C	T	12	9	21	0	0	21	0	0
7	32814600	.	C	G	20	6	26	0	1	27	0	0
7	32814636	.	A	G	17	6	23	0	0	23	0	0
7	32814830	.	A	G	14	15	29	0	1	30	0	0
7	32815485	.	A	T	8	6	14	0	0	14	0	0
7	32815506	.	A	G	10	11	21	0	0	21	0	0
7	32815910	.	C	T	1	21	22	0	15	37	0	0
7	32818809	.	G	T	7	1	8	0	0	8	0	0
7	32818848	.	A	T	15	11	26	0	0	26	0	0
7	32827457	.	A	G	1	5	6	0	1	7	0	0
7	32831592	.	G	A	13	18	31	0	0	31	0	0
7	32833155	.	T	G	17	9	26	0	0	26	0	0
7	32834445	.	G	T	3	2	5	0	0	5	0	0
7	32834650	.	C	A	1	6	7	0	0	7	0	0
7	32834674	.	G	A	2	8	10	0	0	10	0	0
7	32834835	.	G	A	4	7	11	0	2	13	0	0
7	32835042	.	T	G	5	7	12	0	0	12	0	0
7	32835053	.	T	C	5	5	10	0	1	11	0	0
7	32835182	.	G	A	4	7	11	0	0	11	0	0
7	32835349	.	A	G	2	7	9	0	0	9	0	0
7	32836032	.	T	C	3	3	6	0	2	8	0	0
7	32836100	.	G	A	3	7	10	0	0	10	0	0
7	32836163	.	A	G	3	3	6	0	1	7	0	0
7	32836203	.	A	T	2	5	7	0	0	7	0	0
7	32836227	.	A	G	2	6	8	0	0	8	0	0
7	32836334	.	T	C	2	0	2	0	10	12	0	0
7	32843511	.	T	C	1	0	1	0	2	3	0	0
7	32854978	.	C	T	2	3	5	0	0	5	0	0
7	32855050	.	A	G	0	1	1	0	0	1	0	0
7	32895388	.	A	C	0	4	4	0	1	5	0	0
7	32895566	.	G	A	2	6	8	0	0	8	0	0
7	32895595	.	A	C	3	3	6	0	0	6	0	0
7	32898148	.	T	G	6	0	6	0	5	11	0	0
7	32898640	.	A	T	3	3	6	0	1	7	0	0
7	32898696	.	C	T	11	10	21	0	0	21	0	0
7	32898744	.	C	T	15	14	29	0	2	31	0	0
7	32898747	.	T	A	14	16	30	0	2	32	0	0
7	32898827	.	C	A	9	15	24	0	3	27	0	0
7	32899602	.	A	T	15	15	30	0	0	30	0	0
7	32899744	.	A	G	9	8	17	0	1	18	0	0
7	32928226	.	T	A	4	2	6	0	0	6	0	0
7	32928369	.	G	A	4	6	10	0	0	10	0	0
7	32946639	.	C	T	1	2	3	0	0	3	0	0
7	32983726	.	T	A	24	27	51	0	3	54	0	0
7	32983948	.	A	C	24	6	30	0	31	61	0	0
7	32984127	.	T	A	39	24	63	0	3	66	0	0
7	32984604	.	C	T	34	25	59	0	1	60	0	0
7	32984625	.	T	A	34	23	57	0	0	57	0	0
7	32984804	.	T	A	36	21	57	0	2	59	0	0
7	32984812	.	C	A	31	22	53	0	2	55	0	0
7	32985013	.	A	T	29	16	45	0	0	45	0	0
7	32985128	.	T	C	31	24	55	0	1	56	0	0
7	32985274	.	A	T	12	15	27	0	0	27	0	0
7	32985282	.	T	A	12	13	25	0	0	25	0	0
7	32985401	.	A	C	7	3	10	0	1	11	0	0
7	32985405	.	T	G	6	2	8	0	2	10	0	0
7	32985602	.	G	A	28	16	44	0	1	45	0	0
7	32985616	.	A	T	27	25	52	0	0	52	0	0
7	32985716	.	A	G	25	26	51	0	1	52	0	0
7	32985847	.	A	G	31	16	47	0	1	48	0	0
7	32986043	.	T	A	13	36	49	0	2	51	0	0
7	32986311	.	T	G	21	20	41	0	1	42	0	0
7	32986422	.	G	T	18	14	32	0	2	34	0	0
7	32988848	.	T	C	6	0	6	0	4	10	0	0
7	32992111	.	G	A	4	6	10	0	0	10	0	0
7	33014041	.	T	C	19	0	19	0	5	24	0	0
7	33028462	.	G	A	2	15	17	0	16	33	0	0
7	33028564	.	T	G	6	13	19	0	1	20	0	0
7	33028738	.	T	C	13	16	29	0	0	29	0	0
7	33068415	.	C	T	7	4	11	0	1	12	0	0
7	33068436	.	T	C	10	11	21	0	0	21	0	0
7	33068457	.	G	A	8	16	24	0	2	26	0	0
7	33068640	.	T	C	12	14	26	0	1	27	0	0
7	33068718	.	A	G	8	15	23	0	1	24	0	0
7	33083616	.	A	C	12	9	21	0	0	21	0	0
7	33083665	.	A	G	11	11	22	0	1	23	0	0
7	33083699	.	C	T	9	10	19	0	0	19	0	0
7	33084411	.	A	G	3	9	12	0	0	12	0	0
7	33084487	.	T	G	4	2	6	0	0	6	0	0
7	33084644	.	C	T	6	5	11	0	1	12	0	0
7	33084659	.	A	G	6	5	11	0	0	11	0	0
7	33084693	.	C	A	3	5	8	0	1	9	0	0
7	33084697	.	T	A	3	3	6	0	1	7	0	0
7	33084768	.	G	A	0	4	4	0	7	11	0	0
7	33084769	.	G	A	5	5	10	0	1	11	0	0
7	33085039	.	G	A	7	2	9	0	1	10	0	0
7	33085069	.	A	T	8	3	11	0	0	11	0	0
7	33085082	.	C	A	6	4	10	0	0	10	0	0
7	33085212	.	C	T	15	12	27	0	2	29	0	0
7	33085359	.	G	C	10	6	16	0	3	19	0	0
7	33085667	.	T	A	5	4	9	0	0	9	0	0
7	33086384	.	C	T	10	11	21	0	0	22	1	0
7	33086491	.	T	C	13	12	25	0	0	25	0	0
7	33086564	.	G	C	5	9	14	0	0	14	0	0
7	33086569	.	T	A	5	7	12	0	0	12	0	0
7	33086865	.	G	T	0	10	10	0	13	23	0	0
7	33087209	.	T	G	19	21	40	0	1	41	0	0
7	33087276	.	C	T	12	4	16	0	0	16	0	0
7	33087334	.	A	T	19	9	28	0	0	28	0	0
7	33087472	.	A	G	12	8	20	0	2	22	0	0
7	33087841	.	T	G	14	22	36	0	0	36	0	0
7	33318208	.	C	A	5	5	10	0	0	10	0	0
7	33318226	.	C	T	7	6	13	0	0	13	0	0
7	33318298	.	A	T	4	2	6	0	0	6	0	0
7	33318322	.	A	C	2	1	3	0	0	3	0	0
7	33328477	.	G	A	0	3	3	0	1	4	0	0
7	33328487	.	G	C	2	3	5	0	0	5	0	0
7	33328542	.	C	G	2	2	4	0	0	4	0	0
7	33331303	.	G	A	2	1	3	0	0	3	0	0
7	33332438	.	A	G	3	4	7	0	0	7	0	0
7	33332472	.	T	C	1	2	3	0	0	3	0	0
7	33334977	.	T	C	1	2	3	0	0	3	0	0
7	33340607	.	C	T	7	8	15	0	0	15	0	0
7	33340645	.	C	T	5	6	11	0	2	13	0	0
7	33340747	.	C	T	7	7	14	0	1	15	0	0
7	33341082	.	A	C	3	4	7	0	0	7	0	0
7	33341124	.	T	A	4	4	8	0	0	8	0	0
7	33341143	.	T	G	3	4	7	0	0	7	0	0
7	33341853	.	G	T	8	5	13	0	0	13	0	0
7	33346451	.	C	T	13	21	34	0	6	40	0	0
7	33347436	.	T	C	13	19	32	0	1	33	0	0
7	33348416	.	A	G	1	1	2	0	0	2	0	0
7	33351362	.	A	C	3	3	6	0	0	6	0	0
7	33372801	.	A	T	4	2	6	0	0	6	0	0
7	33440463	.	C	T	4	3	7	0	0	7	0	0
7	33440466	.	C	G	3	1	4	0	3	7	0	0
7	33440571	.	A	T	5	6	11	0	0	11	0	0
7	33441689	.	G	A	5	8	13	0	1	14	0	0
7	33441762	.	A	G	3	0	3	0	5	8	0	0
7	33442265	.	G	T	1	2	3	0	0	3	0	0
7	33442270	.	C	A	1	2	3	0	0	3	0	0
7	33442491	.	C	T	0	5	5	0	0	5	0	0
7	33442507	.	A	C	4	6	10	0	0	10	0	0
7	33442639	.	C	A	8	4	12	0	1	13	0	0
7	33442680	.	T	C	6	6	12	0	0	12	0	0
7	33442795	.	G	A	5	5	10	0	0	10	0	0
7	33443246	.	A	T	4	5	9	0	0	9	0	0
7	33443587	.	T	A	3	4	7	0	0	7	0	0
7	33443684	.	A	G	7	2	9	0	1	10	0	0
7	33443748	.	C	G	7	7	14	0	0	14	0	0
7	33443808	.	T	C	3	4	7	0	0	7	0	0
7	33645876	.	A	T	5	10	15	0	2	17	0	0
7	33645932	.	C	A	0	10	10	0	10	20	0	0
7	33646044	.	G	C	6	14	20	0	0	20	0	0
7	33646409	.	C	T	9	13	22	0	0	22	0	0
7	33646459	.	G	A	10	10	20	0	0	20	0	0
7	33649963	.	G	A	14	4	18	0	1	19	0	0
7	33653910	.	G	T	8	8	16	0	1	17	0	0
7	33653982	.	T	C	5	0	5	0	0	5	0	0
7	33682981	.	T	C	1	2	3	0	0	3	0	0
7	33683934	.	C	T	3	1	4	0	2	6	0	0
7	33802258	.	C	T	4	1	5	0	0	5	0	0
7	33804705	.	G	T	3	5	8	0	0	8	0	0
7	33804748	.	G	T	1	4	5	0	0	5	0	0
7	33804829	.	C	T	0	2	2	0	6	8	0	0
7	33804985	.	C	T	0	6	6	0	10	16	0	0
7	33805171	.	G	C	1	4	5	0	0	5	0	0
7	33805382	.	T	C	1	0	1	0	3	4	0	0
7	33805952	.	G	A	2	3	5	0	0	5	0	0
7	33806206	.	C	T	5	3	8	0	0	8	0	0
7	33806218	.	C	T	6	3	9	0	0	9	0	0
7	33823199	.	C	T	0	2	2	0	0	2	0	0
7	33880549	.	G	T	4	2	6	0	0	6	0	0
7	33880934	.	A	G	1	2	3	0	1	4	0	0
7	33883830	.	A	C	4	5	9	0	0	9	0	0
7	33884325	.	A	C	2	2	4	0	0	4	0	0
7	33886721	.	C	T	3	2	5	0	1	6	0	0
7	33893337	.	T	A	0	1	1	0	0	1	0	0
7	33954855	.	G	C	1	4	5	0	0	5	0	0
7	33955029	.	T	A	3	5	8	0	0	8	0	0
7	33958567	.	C	T	1	1	2	0	1	3	0	0
7	33958732	.	G	C	2	2	4	0	0	4	0	0
7	33959106	.	A	G	2	2	4	0	0	4	0	0
7	33959445	.	C	T	0	3	3	0	2	5	0	0
7	33959718	.	T	C	1	2	3	0	0	3	0	0
7	33971021	.	A	T	4	5	9	0	0	9	0	0
7	33971304	.	A	C	4	14	18	0	2	20	0	0
7	33971429	.	C	T	10	7	17	0	0	17	0	0
7	33972407	.	C	T	3	4	7	0	0	7	0	0
7	34104755	.	G	T	2	4	6	0	0	6	0	0
7	34106188	.	C	A	1	3	4	0	0	4	0	0
7	34106738	.	T	G	2	2	4	0	0	4	0	0
7	34117914	.	G	A	1	2	3	0	0	3	0	0
7	34118099	.	G	T	1	2	3	0	1	4	0	0
7	34124478	.	G	C	4	0	4	0	3	7	0	0
7	34183237	.	T	A	5	2	7	0	1	8	0	0
7	34191534	.	G	A	0	3	3	0	0	3	0	0
7	34237264	.	T	C	1	3	4	0	0	4	0	0
7	34237303	.	C	T	0	1	1	0	0	1	0	0
7	34240336	.	T	A	5	4	9	0	0	9	0	0
7	34240646	.	G	T	2	2	4	0	0	4	0	0
7	34241474	.	T	C	2	0	2	0	2	4	0	0
7	34241815	.	G	A	6	2	8	0	1	9	0	0
7	34246750	.	C	T	0	2	2	0	0	2	0	0
7	34290102	.	A	C	2	4	6	0	0	6	0	0
7	34290420	.	G	A	0	3	3	0	4	7	0	0
7	34291237	.	A	T	2	3	5	0	0	5	0	0
7	34291342	.	T	A	3	2	5	0	0	5	0	0
7	34292207	.	T	A	6	2	8	0	0	8	0	0
7	34292306	.	T	C	2	3	5	0	0	5	0	0
7	34292434	.	C	A	6	2	8	0	0	8	0	0
7	34292617	.	G	A	2	7	9	0	0	9	0	0
7	34292877	.	G	A	1	5	6	0	0	6	0	0
7	34318079	.	T	C	30	11	41	0	0	41	0	0
7	34318619	.	C	T	3	18	21	0	20	41	0	0
7	34318750	.	A	G	20	22	42	0	0	42	0	0
7	34321638	.	C	T	5	6	11	0	0	11	0	0
7	34321887	.	T	G	9	4	13	0	0	13	0	0
7	34324215	.	T	C	1	0	1	0	0	1	0	0
7	34329845	.	A	G	3	5	8	0	0	8	0	0
7	34341457	.	A	G	6	22	28	0	2	30	0	0
7	34341538	.	A	G	2	0	2	0	0	2	0	0
7	34342185	.	T	C	11	23	34	0	1	36	1	0
7	34342251	.	C	T	10	8	18	0	0	18	0	0
7	34351132	.	A	G	4	2	6	0	0	6	0	0
7	34352928	.	G	A	14	14	28	0	1	29	0	0
7	34352941	.	T	A	11	12	23	0	2	25	0	0
7	34353164	.	T	C	20	0	20	0	15	35	0	0
7	34353202	.	T	C	14	8	22	0	1	23	0	0
7	34360337	.	A	G	8	11	19	0	0	19	0	0
7	34360380	.	T	C	2	4	6	0	0	6	0	0
7	34361708	.	A	G	8	4	12	0	0	12	0	0
7	34361781	.	G	T	5	8	13	0	2	15	0	0
7	34361832	.	G	C	4	9	13	0	0	13	0	0
7	34383082	.	G	A	14	6	20	0	2	22	0	0
7	34385248	.	G	A	18	7	25	0	0	25	0	0
7	34413123	.	T	A	6	4	10	0	1	11	0	0
7	34413218	.	A	G	12	8	20	0	0	20	0	0
7	34413240	.	A	T	15	6	21	0	1	22	0	0
7	34415865	.	G	T	8	1	9	0	0	9	0	0
7	34416106	.	G	A	9	7	16	0	1	17	0	0
7	34416511	.	A	C	10	4	14	0	0	14	0	0
7	34417109	.	C	A	2	2	4	0	0	4	0	0
7	34417113	.	C	A	2	2	4	0	0	4	0	0
7	34417696	.	C	T	0	4	4	0	2	6	0	0
7	34417729	.	C	A	1	3	4	0	0	4	0	0
7	34417846	.	T	C	2	4	6	0	0	6	0	0
7	34418240	.	G	A	4	4	8	0	1	9	0	0
7	34418365	.	G	A	4	7	11	0	0	11	0	0
7	34418457	.	G	T	3	4	7	0	0	7	0	0
7	34418546	.	A	T	7	4	11	0	0	11	0	0
7	34418547	.	C	T	7	4	11	0	0	11	0	0
7	34421271	.	C	T	1	3	4	0	0	4	0	0
7	34426954	.	T	C	2	6	8	0	0	8	0	0
7	34426959	.	C	T	2	4	6	0	0	6	0	0
7	34427649	.	G	A	4	9	13	0	0	13	0	0
7	34427727	.	T	C	4	0	4	0	6	10	0	0
7	34429119	.	T	C	0	0	0	0	1	1	0	0
7	34431708	.	T	C	2	6	8	0	0	8	0	0
7	34487882	.	A	G	2	3	5	0	0	5	0	0
7	34491872	.	C	T	10	8	18	0	0	18	0	0
7	34491878	.	T	A	8	10	18	0	1	19	0	0
7	34491935	.	G	C	5	10	15	0	2	17	0	0
7	34492136	.	A	G	7	0	7	0	6	13	0	0
7	34501680	.	G	T	1	1	2	0	0	2	0	0
7	34501782	.	T	G	0	1	1	0	0	1	0	0
7	34540380	.	C	T	2	4	6	0	0	6	0	0
7	34540500	.	A	G	5	4	9	0	0	9	0	0
7	34540827	.	G	T	2	4	6	0	1	7	0	0
7	34541163	.	C	T	1	5	6	0	0	6	0	0
7	34541955	.	A	G	2	5	7	0	0	7	0	0
7	34542108	.	A	G	5	0	5	0	4	9	0	0
7	34542156	.	T	C	3	5	8	0	1	9	0	0
7	34544751	.	T	A	8	8	16	0	1	17	0	0
7	34545068	.	C	T	10	10	20	0	0	20	0	0
7	34635498	.	C	T	1	2	3	0	0	3	0	0
7	34643983	.	G	A	1	2	3	0	1	4	0	0
7	34651419	.	G	A	0	5	5	0	4	9	0	0
7	34652081	.	C	G	11	8	19	0	1	20	0	0
7	34769187	.	G	A	1	3	4	0	0	4	0	0
7	34769222	.	A	G	5	3	8	0	0	8	0	0
7	34769272	.	C	T	2	0	2	0	0	2	0	0
7	34776487	.	T	C	7	5	12	0	0	12	0	0
7	34823861	.	A	G	5	2	7	0	0	7	0	0
7	34823909	.	A	T	6	3	9	0	2	11	0	0
7	34825400	.	C	T	1	2	3	0	0	3	0	0
7	34828382	.	T	A	4	2	6	0	0	6	0	0
7	34849786	.	G	A	2	3	5	0	0	5	0	0
7	34963887	.	C	T	5	3	8	0	0	8	0	0
7	34964479	.	C	T	1	2	3	0	0	3	0	0
7	34965199	.	A	G	4	0	4	0	5	9	0	0
7	34965445	.	G	A	1	2	3	0	0	3	0	0
7	34979972	.	G	A	3	4	7	0	0	7	0	0
7	35086461	.	C	T	18	19	37	0	1	38	0	0
7	35088435	.	T	C	14	17	31	0	1	32	0	0
7	35091113	.	A	T	2	3	5	0	0	5	0	0
7	35091118	.	A	G	2	2	4	0	1	5	0	0
7	35091293	.	G	A	1	5	6	0	2	8	0	0
7	35091365	.	T	A	21	23	44	0	3	47	0	0
7	35093784	.	C	T	3	8	11	0	0	11	0	0
7	35093968	.	A	C	25	29	54	0	1	55	0	0
7	35094025	.	T	A	26	26	52	0	6	58	0	0
7	35094218	.	T	C	25	24	49	0	3	52	0	0
7	35094292	.	T	G	23	0	23	0	12	36	1	0
7	35094604	.	T	G	14	12	26	0	2	28	0	0
7	35094647	.	T	C	16	16	32	0	1	33	0	0
7	35094682	.	T	C	35	0	35	0	2	37	0	0
7	35094859	.	C	T	8	10	18	0	1	19	0	0
7	35112919	.	T	C	4	3	7	0	1	8	0	0
7	35112994	.	G	T	3	4	7	0	0	7	0	0
7	35113143	.	A	G	2	2	4	0	0	4	0	0
7	35113310	.	A	G	1	3	4	0	1	5	0	0
7	35113404	.	G	A	1	4	5	0	0	5	0	0
7	35113508	.	A	G	2	3	5	0	0	5	0	0
7	35191299	.	C	T	1	2	3	0	0	3	0	0
7	35208379	.	G	A	3	6	9	0	1	10	0	0
7	35208381	.	C	T	3	7	10	0	0	10	0	0
7	35210921	.	C	G	8	7	15	0	0	15	0	0
7	35210924	.	C	A	8	7	15	0	1	16	0	0
7	35211010	.	T	G	5	8	13	0	0	13	0	0
7	35211073	.	A	C	4	5	9	0	0	9	0	0
7	35211825	.	G	A	0	2	2	0	6	8	0	0
7	35212066	.	C	T	2	1	3	0	0	3	0	0
7	35212070	.	T	A	2	2	4	0	0	4	0	0
7	35212252	.	G	A	2	4	6	0	0	6	0	0
7	35212255	.	C	T	2	2	4	0	2	6	0	0
7	35241563	.	C	T	2	2	4	0	0	4	0	0
7	35241571	.	G	T	3	2	5	0	0	5	0	0
7	35241706	.	T	C	3	5	8	0	0	8	0	0
7	35283238	.	T	A	6	3	9	0	0	9	0	0
7	35410171	.	G	A	2	2	4	0	1	5	0	0
7	36314372	.	G	A	9	6	15	0	0	15	0	0
7	37585016	.	T	A	5	3	8	0	0	8	0	0
7	37762107	.	C	A	10	4	14	0	0	14	0	0
7	38532570	.	A	G	1	3	4	0	0	4	0	0
7	38735790	.	A	G	13	4	17	0	0	17	0	0
7	38736788	.	A	G	3	3	6	0	1	7	0	0
7	38737021	.	A	G	6	2	8	0	0	8	0	0
7	38775075	.	A	G	6	3	9	0	0	9	0	0
7	38775078	.	C	T	6	5	11	0	0	11	0	0
7	38777330	.	T	C	3	11	14	0	0	14	0	0
7	38779297	.	T	A	3	1	4	0	0	4	0	0
7	38779695	.	T	A	1	1	2	0	0	2	0	0
7	38779696	.	T	C	1	1	2	0	0	2	0	0
7	38779759	.	A	G	7	0	7	0	7	14	0	0
7	38783439	.	C	T	19	20	39	0	2	41	0	0
7	38783644	.	A	G	21	16	37	0	2	39	0	0
7	38783718	.	A	G	16	17	33	0	2	35	0	0
7	38783799	.	A	T	20	17	37	0	3	40	0	0
7	38783881	.	T	A	13	11	24	0	0	24	0	0
7	38783984	.	G	T	0	13	13	0	4	17	0	0
7	38784407	.	A	G	6	20	26	0	1	27	0	0
7	38784681	.	G	A	21	27	48	0	1	49	0	0
7	38784786	.	T	A	21	28	49	0	2	51	0	0
7	38784976	.	T	A	21	20	41	0	1	42	0	0
7	38784985	.	T	G	22	5	27	0	7	38	4	0
7	38785069	.	C	T	13	12	25	0	5	30	0	0
7	38785224	.	G	A	1	20	21	0	21	42	0	0
7	38785311	.	T	A	18	16	34	0	0	34	0	0
7	38794090	.	T	G	13	12	25	0	2	27	0	0
7	38794233	.	C	T	0	16	16	0	17	33	0	0
7	38794411	.	A	G	18	12	30	0	1	31	0	0
7	38794562	.	A	G	19	15	34	0	0	34	0	0
7	38798630	.	A	G	2	5	7	0	0	7	0	0
7	38799622	.	T	C	13	0	13	0	7	20	0	0
7	38807677	.	T	G	7	4	11	0	1	12	0	0
7	38807750	.	C	T	12	22	34	0	1	35	0	0
7	38807797	.	G	A	4	7	11	0	2	13	0	0
7	38809322	.	A	G	4	6	10	0	0	10	0	0
7	38809502	.	T	C	5	4	9	0	1	10	0	0
7	38809556	.	T	C	2	4	6	0	0	6	0	0
7	38809625	.	T	C	6	8	14	0	0	14	0	0
7	38810173	.	C	A	2	5	7	0	1	8	0	0
7	38820266	.	T	A	1	2	3	0	0	3	0	0
7	38822327	.	C	T	4	5	9	0	0	9	0	0
7	38822365	.	T	A	5	2	7	0	0	7	0	0
7	38822801	.	A	G	1	2	3	0	1	4	0	0
7	38824259	.	G	A	3	6	9	0	1	10	0	0
7	38824972	.	G	A	0	1	1	0	1	2	0	0
7	38954102	.	T	C	1	2	3	0	0	3	0	0
7	39089696	.	C	A	2	3	5	0	0	5	0	0
7	39097193	.	T	C	2	2	4	0	0	4	0	0
7	39100137	.	C	A	0	1	1	0	0	1	0	0
7	39123095	.	G	A	0	1	1	0	5	6	0	0
7	39142946	.	G	T	3	0	3	0	0	3	0	0
7	39142961	.	C	T	5	2	7	0	0	7	0	0
7	39143018	.	G	A	8	6	14	0	0	14	0	0
7	39153769	.	C	A	5	7	12	0	0	12	0	0
7	39153975	.	G	A	4	6	10	0	0	10	0	0
7	39154119	.	C	T	5	9	14	0	1	15	0	0
7	39154272	.	A	T	3	8	11	0	0	11	0	0
7	39154273	.	C	G	3	8	11	0	0	11	0	0
7	39154984	.	T	G	2	3	5	0	0	5	0	0
7	39155099	.	C	T	6	4	10	0	0	10	0	0
7	39155115	.	T	C	10	5	15	0	0	15	0	0
7	39155344	.	G	A	5	3	8	0	1	9	0	0
7	39155508	.	A	T	6	8	14	0	0	14	0	0
7	39155943	.	T	C	4	6	10	0	0	10	0	0
7	39156101	.	T	G	12	5	17	0	1	18	0	0
7	39156161	.	C	T	10	5	15	0	0	15	0	0
7	39156376	.	A	G	10	7	17	0	1	18	0	0
7	39156474	.	T	C	18	12	30	0	0	30	0	0
7	39156567	.	G	C	12	9	21	0	0	21	0	0
7	39156698	.	G	A	0	11	11	0	6	17	0	0
7	39156846	.	T	C	9	8	17	0	1	18	0	0
7	39156969	.	T	C	7	12	19	0	1	20	0	0
7	39157175	.	A	T	10	8	18	0	0	18	0	0
7	39157239	.	C	A	6	6	12	0	3	15	0	0
7	39174145	.	T	C	20	20	40	0	1	41	0	0
7	39176261	.	G	A	0	13	13	0	11	24	0	0
7	39176444	.	G	A	2	29	31	0	21	52	0	0
7	39176447	.	A	C	22	25	47	0	3	50	0	0
7	39176790	.	T	G	20	20	40	0	1	41	0	0
7	39176863	.	G	A	17	32	49	0	1	50	0	0
7	39176922	.	T	A	16	15	31	0	0	32	1	0
7	39177132	.	A	T	2	3	5	0	0	5	0	0
7	39177524	.	T	A	16	13	29	0	0	29	0	0
7	39177527	.	G	A	15	10	25	0	2	27	0	0
7	39177601	.	C	A	13	12	25	0	1	26	0	0
7	39177643	.	A	G	15	8	23	0	1	24	0	0
7	39177679	.	C	T	16	6	22	0	1	23	0	0
7	39177717	.	A	G	13	6	19	0	0	19	0	0
7	39177729	.	A	G	11	7	18	0	1	19	0	0
7	39177962	.	T	C	3	5	8	0	1	9	0	0
7	39181264	.	T	C	10	0	10	0	10	20	0	0
7	39181275	.	A	G	7	9	16	0	2	18	0	0
7	39181318	.	C	T	11	12	23	0	1	24	0	0
7	39181347	.	G	A	10	13	23	0	1	24	0	0
7	39181597	.	C	A	9	13	22	0	0	22	0	0
7	39182127	.	T	C	12	10	22	0	0	22	0	0
7	39182265	.	T	C	6	16	22	0	0	22	0	0
7	39203411	.	G	A	2	0	2	0	0	2	0	0
7	39256326	.	A	G	3	4	7	0	0	7	0	0
7	39351762	.	C	G	3	2	5	0	1	6	0	0
7	39360222	.	A	T	2	4	6	0	1	7	0	0
7	39360250	.	T	C	1	3	4	0	0	4	0	0
7	39360263	.	G	A	1	3	4	0	0	4	0	0
7	39364137	.	G	C	0	3	3	0	0	3	0	0
7	39366672	.	C	A	0	3	3	0	0	3	0	0
7	39366892	.	A	G	0	0	0	0	1	1	0	0
7	39367765	.	G	A	2	1	3	0	0	3	0	0
7	39371295	.	T	C	7	4	11	0	0	11	0	0
7	39373263	.	T	C	1	2	3	0	0	3	0	0
7	39373331	.	A	G	1	4	5	0	0	5	0	0
7	39414813	.	T	G	0	0	0	0	1	1	0	0
7	39414840	.	C	T	0	1	1	0	0	1	0	0
7	39538001	.	T	C	4	7	11	0	0	11	0	0
7	39548697	.	G	A	2	2	4	0	0	4	0	0
7	39551812	.	T	C	2	3	5	0	0	5	0	0
7	39551815	.	G	C	2	3	5	0	0	5	0	0
7	39552310	.	A	C	2	2	4	0	0	4	0	0
7	39636727	.	T	C	1	2	3	0	0	3	0	0
7	39640249	.	C	T	3	2	5	0	0	5	0	0
7	39643046	.	A	G	1	2	3	0	0	3	0	0
7	39648980	.	A	G	3	0	3	0	0	3	0	0
7	39649070	.	C	T	0	1	1	0	0	1	0	0
7	39655237	.	T	A	6	5	11	0	0	11	0	0
7	39655524	.	T	A	5	4	9	0	0	9	0	0
7	39655586	.	C	G	3	4	7	0	0	7	0	0
7	39655618	.	A	G	2	1	3	0	4	7	0	0
7	39656372	.	C	T	2	3	5	0	1	6	0	0
7	39656974	.	G	A	5	5	10	1	0	11	0	0
7	39657389	.	C	A	6	4	10	0	0	10	0	0
7	39657467	.	T	A	7	3	10	0	0	10	0	0
7	39657693	.	G	T	7	2	9	0	0	9	0	0
7	39658195	.	C	T	12	10	22	0	1	23	0	0
7	39658224	.	A	C	11	6	17	0	1	18	0	0
7	39658356	.	T	C	2	7	9	0	0	9	0	0
7	39658441	.	T	C	10	5	15	0	0	15	0	0
7	39658831	.	T	G	12	11	23	0	0	23	0	0
7	39659400	.	T	A	4	2	6	0	0	6	0	0
7	39659758	.	C	A	3	1	4	0	1	5	0	0
7	39659792	.	T	C	2	4	6	0	0	6	0	0
7	39659806	.	G	A	2	4	6	0	0	6	0	0
7	39660054	.	A	C	3	2	5	0	0	5	0	0
7	39660201	.	G	A	12	10	22	0	4	26	0	0
7	39660239	.	A	T	8	7	15	0	1	16	0	0
7	39660304	.	A	G	20	14	34	0	3	37	0	0
7	39660624	.	C	A	15	7	22	0	1	23	0	0
7	39670892	.	G	C	11	9	20	0	0	20	0	0
7	39671118	.	T	A	12	7	19	0	0	19	0	0
7	39671281	.	G	A	6	10	16	0	0	16	0	0
7	39671647	.	C	T	9	9	18	0	0	18	0	0
7	39671715	.	A	C	6	5	11	0	0	11	0	0
7	39672054	.	A	T	5	10	15	0	0	15	0	0
7	39672165	.	G	A	4	6	10	0	2	12	0	0
7	39672741	.	A	G	11	8	19	0	0	19	0	0
7	39673095	.	A	G	8	0	8	0	8	16	0	0
7	39673773	.	G	C	1	6	7	0	14	21	0	0
7	39675838	.	A	G	9	6	15	0	2	17	0	0
7	39675961	.	T	A	2	3	5	0	1	6	0	0
7	39675991	.	C	T	1	2	3	0	0	3	0	0
7	39676183	.	T	A	3	7	10	0	0	10	0	0
7	39676301	.	G	T	5	3	8	0	0	8	0	0
7	39676303	.	A	T	5	3	8	0	0	8	0	0
7	39676364	.	T	G	3	4	7	0	0	7	0	0
7	39676365	.	C	T	3	4	7	0	0	7	0	0
7	39676446	.	A	T	6	5	11	0	0	11	0	0
7	39676518	.	A	G	8	8	16	0	0	16	0	0
7	39676776	.	C	G	14	9	23	0	0	23	0	0
7	39676947	.	T	G	9	5	14	0	3	17	0	0
7	39677257	.	A	T	4	5	9	0	1	10	0	0
7	39677347	.	G	A	10	9	19	0	0	19	0	0
7	39677549	.	T	C	14	12	26	0	0	26	0	0
7	39677625	.	G	T	10	13	23	0	2	25	0	0
7	39677755	.	C	T	3	8	11	0	3	14	0	0
7	39677878	.	G	C	12	13	25	0	2	27	0	0
7	39677924	.	A	G	10	13	23	0	2	25	0	0
7	39677948	.	G	T	11	11	22	0	0	22	0	0
7	39677998	.	C	G	9	12	21	0	0	21	0	0
7	39691143	.	T	C	12	11	23	0	0	23	0	0
7	39691328	.	A	T	7	8	15	0	0	15	0	0
7	39691394	.	A	G	3	7	10	0	1	11	0	0
7	39695483	.	C	T	2	2	4	0	0	4	0	0
7	39695527	.	A	G	2	0	2	0	2	4	0	0
7	39695535	.	T	C	2	2	4	0	0	4	0	0
7	39695776	.	A	C	0	3	3	0	1	4	0	0
7	39698691	.	G	A	0	1	1	0	1	2	0	0
7	39698963	.	T	C	8	15	23	0	0	23	0	0
7	39701913	.	A	C	5	8	13	0	0	13	0	0
7	39702022	.	C	G	10	3	13	0	0	13	0	0
7	39702537	.	C	A	4	2	6	0	1	7	0	0
7	39702827	.	C	T	3	2	5	0	0	5	0	0
7	39703898	.	G	C	3	2	5	0	1	6	0	0
7	39704229	.	C	T	4	4	8	0	1	9	0	0
7	39704340	.	T	A	4	4	8	0	0	8	0	0
7	39704345	.	C	T	4	3	7	0	0	7	0	0
7	39704599	.	G	T	5	3	8	0	1	9	0	0
7	39704632	.	C	T	4	5	9	0	0	9	0	0
7	39704928	.	G	A	0	13	13	0	6	19	0	0
7	39704955	.	T	A	7	15	22	0	0	22	0	0
7	39705178	.	C	T	16	4	20	1	0	21	0	0
7	39705187	.	T	G	15	4	19	1	1	21	0	0
7	39705337	.	A	C	11	4	15	0	0	17	2	0
7	39740651	.	A	G	5	4	9	0	0	9	0	0
7	39742784	.	A	G	6	4	10	0	1	11	0	0
7	39742841	.	A	T	4	7	11	0	1	12	0	0
7	39742941	.	G	T	2	3	5	0	0	5	0	0
7	39742946	.	G	T	3	3	6	0	0	6	0	0
7	39744494	.	G	A	6	15	21	0	0	21	0	0
7	39744543	.	G	A	3	3	6	0	0	6	0	0
7	39745110	.	A	T	3	6	9	0	0	9	0	0
7	39745580	.	A	G	1	5	6	0	1	7	0	0
7	39748847	.	T	C	2	2	4	0	0	4	0	0
7	39748934	.	A	C	8	13	21	0	2	23	0	0
7	39758749	.	G	A	2	2	4	0	0	4	0	0
7	40492740	.	T	A	3	2	5	0	0	5	0	0
7	40492764	.	G	C	0	3	3	0	3	6	0	0
7	40492789	.	T	C	2	3	5	0	0	5	0	0
7	40492800	.	G	T	2	3	5	0	0	5	0	0
7	41714385	.	T	C	5	5	10	0	0	10	0	0
7	41714386	.	T	C	4	5	9	0	1	10	0	0
7	41714440	.	T	C	11	4	15	0	0	15	0	0
7	41714453	.	T	C	7	9	16	0	1	17	0	0
7	41714554	.	T	C	4	0	4	0	2	6	0	0
7	41714557	.	T	C	2	0	2	0	3	5	0	0
7	41900402	.	G	C	0	6	6	0	0	6	0	0
7	41901217	.	A	G	10	3	13	0	0	13	0	0
7	44588458	.	A	G	9	3	12	0	0	12	0	0
7	48829926	.	A	T	0	4	4	0	0	4	0	0
7	49325033	.	T	A	8	3	11	0	0	11	0	0
7	50376186	.	A	G	3	2	5	0	0	5	0	0
7	50474702	.	T	G	2	4	6	0	0	6	0	0
7	50586497	.	A	T	0	1	1	0	0	1	0	0
7	50766151	.	T	C	7	7	14	0	0	14	0	0
7	50766240	.	A	C	1	4	5	0	0	5	0	0
7	50828894	.	T	A	2	5	7	0	0	7	0	0
7	50828998	.	C	T	5	3	8	0	0	8	0	0
7	50829201	.	A	C	10	5	15	0	1	16	0	0
7	50829360	.	G	C	6	2	8	0	0	8	0	0
7	50829393	.	G	A	6	4	10	0	1	11	0	0
7	50830997	.	C	T	5	1	6	0	0	6	0	0
7	50831901	.	G	A	5	2	7	0	0	7	0	0
7	50833143	.	T	C	0	3	3	0	0	3	0	0
7	50833262	.	C	T	3	2	5	0	0	5	0	0
7	50833928	.	C	G	3	0	3	0	1	4	0	0
7	50833943	.	C	A	3	3	6	0	0	6	0	0
7	50836382	.	C	T	6	4	10	0	0	10	0	0
7	50836424	.	C	T	4	3	7	0	0	7	0	0
7	50837949	.	G	A	2	4	6	0	0	6	0	0
7	50838135	.	G	C	0	1	1	0	1	2	0	0
7	50838194	.	C	A	5	5	10	0	0	10	0	0
7	50838210	.	G	T	0	6	6	0	6	12	0	0
7	50838251	.	C	T	2	3	5	0	0	5	0	0
7	50840008	.	C	T	5	9	14	0	0	14	0	0
7	50840428	.	G	A	4	14	18	0	1	19	0	0
7	50840512	.	C	T	2	3	5	0	0	5	0	0
7	50841072	.	G	A	9	10	19	0	0	19	0	0
7	50841237	.	C	T	11	16	27	0	0	27	0	0
7	50841690	.	G	A	0	10	10	0	9	19	0	0
7	50841693	.	A	T	9	10	19	0	1	20	0	0
7	50843813	.	C	A	4	1	5	0	0	5	0	0
7	50843827	.	A	G	6	2	8	0	0	8	0	0
7	50844117	.	G	A	0	16	16	0	14	30	0	0
7	50844142	.	G	A	16	9	25	0	0	25	0	0
7	50844165	.	C	T	8	16	24	0	0	24	0	0
7	50844830	.	G	T	8	5	13	0	2	15	0	0
7	50844834	.	G	A	0	9	9	0	6	15	0	0
7	50844895	.	A	T	9	8	17	0	1	18	0	0
7	50844936	.	A	T	8	8	16	0	0	16	0	0
7	50845000	.	G	A	9	10	19	0	1	20	0	0
7	50845105	.	A	T	8	10	18	0	2	20	0	0
7	50845158	.	A	G	7	7	14	0	1	15	0	0
7	50845210	.	A	G	9	11	20	0	0	20	0	0
7	50845331	.	G	A	0	3	3	0	3	6	0	0
7	50845486	.	A	T	1	5	6	0	0	6	0	0
7	50845646	.	C	T	9	6	15	0	1	16	0	0
7	50845892	.	C	A	17	13	30	0	3	33	0	0
7	50846055	.	T	C	7	12	19	0	0	19	0	0
7	50846081	.	T	A	10	7	17	0	0	17	0	0
7	50877064	.	T	C	3	4	7	0	0	7	0	0
7	50878385	.	T	C	5	4	9	0	0	9	0	0
7	50878864	.	A	T	3	2	5	0	0	5	0	0
7	50879166	.	C	T	3	2	5	0	0	5	0	0
7	50879168	.	C	G	2	2	4	0	1	5	0	0
7	50879257	.	C	G	2	3	5	0	0	5	0	0
7	50880243	.	T	C	1	3	4	0	0	4	0	0
7	50880467	.	C	G	3	3	6	0	0	6	0	0
7	50880471	.	G	A	3	3	6	0	0	6	0	0
7	50880703	.	G	A	1	3	4	0	0	4	0	0
7	50881363	.	C	T	2	4	6	0	0	6	0	0
7	50881641	.	G	T	5	3	8	0	1	9	0	0
7	50882104	.	G	A	3	2	5	0	0	5	0	0
7	50882736	.	T	A	1	2	3	0	0	3	0	0
7	50911223	.	T	A	6	10	16	0	0	16	0	0
7	50911278	.	C	T	14	18	32	0	3	35	0	0
7	50912212	.	C	T	6	11	17	0	0	17	0	0
7	50912227	.	C	G	7	4	11	0	0	11	0	0
7	50917219	.	C	T	6	1	7	0	0	7	0	0
7	51219420	.	C	G	7	4	11	0	1	12	0	0
7	51219436	.	A	C	7	5	12	0	0	12	0	0
7	51219972	.	T	C	17	5	22	0	0	22	0	0
7	51220283	.	C	T	2	15	17	0	2	19	0	0
7	51220739	.	A	G	5	6	11	0	0	11	0	0
7	51220740	.	C	A	0	6	6	0	5	11	0	0
7	51221418	.	T	A	6	7	13	0	1	14	0	0
7	51221475	.	C	T	2	4	6	0	0	6	0	0
7	51222115	.	G	A	7	4	11	0	0	11	0	0
7	51222297	.	G	A	0	1	1	0	0	1	0	0
7	51246426	.	G	A	4	5	9	0	0	9	0	0
7	51246457	.	G	T	10	3	13	0	0	13	0	0
7	51247467	.	C	T	0	5	5	0	4	9	0	0
7	51248010	.	C	A	2	2	4	0	0	4	0	0
7	51248756	.	C	A	0	2	2	0	3	5	0	0
7	51249032	.	C	T	3	2	5	0	0	5	0	0
7	51249441	.	G	T	6	4	10	0	0	10	0	0
7	51353191	.	G	A	3	5	8	0	0	8	0	0
7	51353421	.	C	T	4	6	10	0	0	10	0	0
7	51353447	.	G	T	6	4	10	0	0	10	0	0
7	51353989	.	G	T	2	2	4	0	1	5	0	0
7	51354066	.	G	A	1	4	5	0	2	7	0	0
7	51354296	.	A	G	0	7	7	0	0	7	0	0
7	51354306	.	T	C	9	0	9	0	1	10	0	0
7	51354424	.	T	A	5	4	9	0	0	9	0	0
7	51354442	.	C	A	5	4	9	0	0	9	0	0
7	51355000	.	C	T	5	2	7	0	0	7	0	0
7	51355195	.	A	G	5	4	9	0	1	10	0	0
7	51355197	.	A	G	5	5	10	0	0	10	0	0
7	51355437	.	A	G	3	3	6	0	0	6	0	0
7	51355515	.	A	T	3	6	9	0	0	9	0	0
7	51355531	.	T	A	4	5	9	0	0	9	0	0
7	51356212	.	A	G	5	2	7	0	0	7	0	0
7	51356319	.	G	A	0	3	3	0	1	4	0	0
7	51356542	.	C	G	8	9	17	0	1	18	0	0
7	51356625	.	C	A	5	5	10	0	0	10	0	0
7	51356733	.	G	T	3	6	9	0	1	10	0	0
7	51356767	.	C	A	1	4	5	0	0	5	0	0
7	51368654	.	T	G	3	5	8	0	0	8	0	0
7	51395580	.	T	A	1	2	3	0	0	3	0	0
7	51468119	.	C	T	15	15	30	0	0	30	0	0
7	51468241	.	C	T	15	8	23	0	1	24	0	0
7	51468389	.	C	T	2	12	14	0	17	31	0	0
7	51468411	.	A	T	15	10	25	0	0	25	0	0
7	51468577	.	C	A	16	10	26	0	0	26	0	0
7	51469048	.	T	G	13	11	24	0	3	27	0	0
7	51469166	.	A	T	14	13	27	0	3	30	0	0
7	51469267	.	G	C	6	11	17	0	0	17	0	0
7	51469304	.	T	A	7	8	15	0	0	15	0	0
7	51469518	.	T	A	7	6	13	0	1	14	0	0
7	51469578	.	T	G	8	8	16	0	0	16	0	0
7	51469814	.	C	T	0	9	9	0	7	16	0	0
7	51469897	.	A	G	4	4	8	0	1	9	0	0
7	51470070	.	T	C	4	0	4	0	9	13	0	0
7	51470230	.	T	A	2	4	6	0	0	6	0	0
7	51470286	.	T	C	2	2	4	0	0	4	0	0
7	51470569	.	G	T	2	8	10	0	1	11	0	0
7	51471379	.	G	A	7	8	15	0	0	15	0	0
7	51471560	.	T	C	10	4	14	0	0	14	0	0
7	51471591	.	T	C	7	3	10	0	2	12	0	0
7	51471714	.	A	G	4	3	7	0	0	7	0	0
7	51472456	.	C	T	2	6	8	0	0	8	0	0
7	51472534	.	T	A	5	4	9	0	0	9	0	0
7	51472536	.	T	A	4	4	8	0	1	9	0	0
7	51472793	.	A	C	4	0	4	0	7	11	0	0
7	51472853	.	G	A	4	6	10	0	0	10	0	0
7	51473021	.	C	T	0	1	1	0	0	1	0	0
7	51473585	.	T	C	2	0	2	0	5	7	0	0
7	51473814	.	C	T	4	4	8	0	0	8	0	0
7	51473831	.	T	G	5	4	9	0	1	10	0	0
7	51474238	.	G	A	6	6	12	0	0	12	0	0
7	51474279	.	C	A	11	7	18	0	0	18	0	0
7	51474300	.	G	T	9	7	16	0	0	16	0	0
7	51474832	.	T	G	3	5	8	0	0	8	0	0
7	51475180	.	A	G	6	3	9	0	0	9	0	0
7	51475288	.	G	A	6	2	8	0	2	10	0	0
7	51483327	.	G	A	2	4	6	0	0	6	0	0
7	51483357	.	G	A	3	2	5	0	0	5	0	0
7	51634285	.	C	T	16	13	29	0	0	29	0	0
7	51634480	.	G	A	37	35	72	0	1	73	0	0
7	51635615	.	A	G	15	14	29	0	1	30	0	0
7	51643163	.	A	G	7	7	14	0	0	14	0	0
7	51643212	.	G	A	7	5	12	0	1	13	0	0
7	51643409	.	C	A	7	2	9	0	1	10	0	0
7	51643639	.	A	C	4	8	12	0	0	12	0	0
7	51656560	.	A	T	2	2	4	0	0	4	0	0
7	51656576	.	A	G	2	2	4	0	0	4	0	0
7	51702899	.	G	C	0	0	0	0	1	1	0	0
7	51705806	.	C	G	3	3	6	0	0	6	0	0
7	51709914	.	C	A	6	3	9	0	0	9	0	0
7	51713193	.	C	A	0	4	4	0	2	6	0	0
7	51713257	.	G	A	3	6	9	0	0	9	0	0
7	51713267	.	G	A	2	6	8	0	0	8	0	0
7	51713670	.	A	C	1	2	3	0	0	3	0	0
7	51714712	.	A	G	1	3	4	0	0	4	0	0
7	51779628	.	G	A	9	1	10	0	0	10	0	0
7	51779636	.	T	C	8	0	8	0	1	9	0	0
7	51788227	.	T	G	11	11	22	0	1	23	0	0
7	51788756	.	A	C	9	8	17	0	0	17	0	0
7	51795788	.	T	C	9	3	12	0	0	12	0	0
7	51795791	.	G	T	9	3	12	0	0	12	0	0
7	51795827	.	C	T	4	6	10	0	0	10	0	0
7	51808319	.	T	A	0	1	1	0	0	1	0	0
7	51808327	.	T	C	1	1	2	0	0	2	0	0
7	51808615	.	A	T	2	3	5	0	0	5	0	0
7	51811165	.	G	A	6	3	9	0	0	9	0	0
7	51813925	.	A	C	4	0	4	0	2	6	0	0
7	51813946	.	T	G	1	2	3	0	0	3	0	0
7	51814287	.	C	G	3	9	12	0	1	13	0	0
7	51814445	.	T	A	8	3	11	0	0	11	0	0
7	51814512	.	C	T	2	6	8	0	1	9	0	0
7	52151265	.	T	G	0	1	1	0	0	1	0	0
7	52152053	.	A	T	1	2	3	0	0	3	0	0
7	52152063	.	C	T	0	3	3	0	2	5	0	0
7	52152101	.	C	T	1	2	3	0	0	3	0	0
7	52156113	.	G	A	0	2	2	0	1	3	0	0
7	52156137	.	T	A	4	5	9	0	0	9	0	0
7	52157845	.	A	T	7	4	11	0	1	12	0	0
7	52165601	.	C	T	2	2	4	0	0	4	0	0
7	52165631	.	C	T	4	5	9	0	0	9	0	0
7	52173207	.	G	A	6	5	11	0	0	11	0	0
7	52173228	.	A	G	3	5	8	0	1	9	0	0
7	52285027	.	T	C	7	8	15	0	2	17	0	0
7	52285035	.	C	T	6	4	10	0	0	10	0	0
7	52285113	.	C	G	6	9	15	0	1	16	0	0
7	52294540	.	A	T	13	6	19	0	0	19	0	0
7	52294579	.	C	T	7	6	13	0	0	13	0	0
7	52294756	.	A	T	13	8	21	0	0	21	0	0
7	52295016	.	C	T	1	12	13	0	10	23	0	0
7	52295183	.	G	A	20	12	32	0	2	34	0	0
7	52295795	.	C	T	0	14	14	0	8	22	0	0
7	52295935	.	T	C	13	7	20	0	1	21	0	0
7	52296064	.	A	C	9	0	9	0	12	21	0	0
7	52296221	.	G	A	10	13	23	0	2	25	0	0
7	52296320	.	G	A	5	7	12	0	0	12	0	0
7	52296352	.	G	T	6	6	12	0	0	12	0	0
7	52296791	.	G	A	15	15	30	0	0	30	0	0
7	52309924	.	G	A	0	1	1	0	1	2	0	0
7	52315434	.	C	G	0	11	11	0	4	15	0	0
7	52328569	.	C	T	9	6	15	0	0	15	0	0
7	52432249	.	G	A	1	4	5	0	1	6	0	0
7	52432459	.	G	A	2	3	5	0	0	5	0	0
7	52448991	.	C	T	1	2	3	0	0	3	0	0
7	52517759	.	G	A	1	5	6	0	0	6	0	0
7	52518529	.	T	G	5	6	11	0	1	12	0	0
7	52518813	.	C	T	9	7	16	0	1	17	0	0
7	52519015	.	T	C	10	9	19	0	0	19	0	0
7	52521352	.	G	A	8	4	12	0	0	12	0	0
7	52522182	.	T	C	12	7	19	0	0	19	0	0
7	52531152	.	C	T	0	6	6	0	5	11	0	0
7	52551518	.	G	A	1	1	2	0	1	3	0	0
7	52716875	.	C	A	1	2	3	0	0	3	0	0
7	52717095	.	T	C	8	6	14	0	1	15	0	0
7	52750565	.	C	T	11	9	20	0	0	20	0	0
7	52750656	.	G	A	2	5	7	0	0	7	0	0
7	52750776	.	G	T	7	10	17	0	0	17	0	0
7	52750847	.	C	T	7	6	13	0	1	14	0	0
7	52751306	.	T	C	1	4	5	0	1	6	0	0
7	52765884	.	C	A	3	2	5	0	0	5	0	0
7	52765985	.	G	T	1	3	4	0	3	7	0	0
7	52765999	.	T	A	2	4	6	0	0	6	0	0
7	52766191	.	C	T	3	5	8	0	0	8	0	0
7	52778290	.	C	T	1	3	4	0	0	4	0	0
7	52780616	.	C	T	1	3	4	0	0	4	0	0
7	52780861	.	A	T	0	1	1	0	0	1	0	0
7	52788912	.	T	G	4	0	4	0	5	9	0	0
7	52789065	.	C	T	0	2	2	0	0	2	0	0
7	52793313	.	C	T	2	1	3	0	0	3	0	0
7	52820092	.	G	C	9	10	19	0	0	19	0	0
7	52820221	.	G	A	0	4	4	0	10	14	0	0
7	52820320	.	C	T	4	8	12	0	1	13	0	0
7	52821561	.	T	A	2	2	4	0	0	4	0	0
7	52821658	.	C	A	5	2	7	0	0	7	0	0
7	52821691	.	A	C	1	2	3	0	1	4	0	0
7	52821904	.	G	A	8	8	16	0	0	16	0	0
7	52822136	.	G	A	9	8	17	0	0	17	0	0
7	52822351	.	A	T	11	6	17	0	1	18	0	0
7	52822493	.	A	C	5	6	11	0	0	11	0	0
7	52822773	.	C	T	7	3	10	0	1	11	0	0
7	52822791	.	T	G	6	1	7	0	3	10	0	0
7	52822860	.	A	G	2	5	7	0	0	7	0	0
7	52823161	.	G	A	8	5	13	0	1	14	0	0
7	52823210	.	C	G	12	8	20	0	1	21	0	0
7	52823377	.	T	A	1	5	6	0	0	6	0	0
7	52823388	.	C	T	3	6	9	0	0	9	0	0
7	52823429	.	A	T	7	7	14	0	1	15	0	0
7	52830447	.	G	T	3	4	7	0	1	8	0	0
7	52830591	.	A	T	23	15	38	0	0	38	0	0
7	52830601	.	T	G	14	19	33	0	1	34	0	0
7	52830639	.	C	T	18	18	36	0	0	36	0	0
7	52831053	.	G	T	15	30	45	0	0	45	0	0
7	52831198	.	T	A	7	9	16	0	2	18	0	0
7	52831236	.	A	G	13	11	24	0	1	25	0	0
7	52831430	.	C	T	11	10	21	0	0	21	0	0
7	52833126	.	C	G	9	3	12	0	0	12	0	0
7	52833248	.	A	T	15	6	21	0	1	22	0	0
7	52833329	.	G	T	17	17	34	0	0	34	0	0
7	52833682	.	T	A	13	14	27	0	0	27	0	0
7	52833792	.	G	A	22	7	29	0	0	29	0	0
7	52834334	.	T	G	9	3	12	0	0	12	0	0
7	52836325	.	C	T	9	28	37	0	2	39	0	0
7	52836403	.	A	G	11	22	33	0	3	36	0	0
7	52836451	.	C	T	18	20	38	0	0	38	0	0
7	52837644	.	G	A	25	9	34	0	0	34	0	0
7	52837686	.	C	A	24	9	33	0	1	34	0	0
7	52837687	.	T	A	24	9	33	0	1	34	0	0
7	52839062	.	C	T	7	9	16	0	0	16	0	0
7	52840871	.	T	A	14	13	27	0	6	33	0	0
7	52841033	.	T	C	9	0	9	0	8	17	0	0
7	52841276	.	A	G	11	10	21	0	0	21	0	0
7	52842329	.	C	T	6	4	10	0	0	10	0	0
7	52900987	.	C	T	5	10	15	0	1	16	0	0
7	52921521	.	C	A	7	15	22	0	0	22	0	0
7	52924873	.	T	A	4	7	11	0	0	11	0	0
7	52929182	.	G	A	6	9	15	0	2	17	0	0
7	52933088	.	C	A	19	16	35	0	2	37	0	0
7	52933191	.	C	T	3	2	5	0	1	6	0	0
7	52937334	.	G	A	8	9	17	0	0	17	0	0
7	52942312	.	G	T	4	7	11	0	1	12	0	0
7	52942472	.	C	T	3	1	4	0	0	4	0	0
7	52944199	.	G	A	8	9	17	0	0	17	0	0
7	52959270	.	G	T	4	2	6	0	0	6	0	0
7	52959391	.	C	A	0	2	2	0	0	2	0	0
7	52962765	.	T	C	6	1	7	0	2	9	0	0
7	53162425	.	T	C	1	2	3	1	0	4	0	0
7	55261074	.	C	T	3	2	5	0	1	6	0	0
7	55530884	.	G	C	1	1	2	0	1	4	1	0
7	55532234	.	C	T	1	2	3	0	0	3	0	0
7	55532316	.	A	G	6	4	10	0	0	10	0	0
7	55536487	.	G	A	2	2	4	0	0	4	0	0
7	55593170	.	T	C	3	0	3	0	2	5	0	0
7	55635202	.	T	C	0	1	1	0	0	1	0	0
7	55637360	.	G	A	2	3	5	0	1	6	0	0
7	55660269	.	G	A	11	9	20	0	0	20	0	0
7	55669479	.	G	A	1	0	1	0	0	1	0	0
7	55671547	.	T	C	3	10	13	0	1	14	0	0
7	55675544	.	T	C	6	1	7	0	21	28	0	0
7	55675577	.	G	A	4	7	11	0	1	12	0	0
7	55952877	.	C	T	1	2	3	0	0	3	0	0
7	55953094	.	A	T	2	2	4	0	0	4	0	0
7	55953452	.	C	T	3	3	6	0	0	6	0	0
7	55955842	.	G	T	1	3	4	0	0	4	0	0
7	55955890	.	G	A	2	1	3	0	0	3	0	0
7	56152686	.	G	C	16	6	22	0	0	22	0	0
7	56158111	.	G	A	3	4	7	0	0	7	0	0
7	56158197	.	G	A	9	11	20	0	0	20	0	0
7	56158823	.	A	G	11	5	16	0	0	16	0	0
7	56158874	.	C	T	3	1	4	0	0	4	0	0
7	56172458	.	T	C	3	4	7	0	0	7	0	0
7	56174222	.	T	C	2	6	8	0	0	8	0	0
7	56177177	.	C	T	0	1	1	0	1	2	0	0
7	56177188	.	T	G	1	1	2	0	0	2	0	0
7	56180258	.	C	T	3	3	6	0	0	6	0	0
7	56180399	.	A	G	3	4	7	0	1	8	0	0
7	56180417	.	A	C	3	5	8	0	0	8	0	0
7	56180482	.	G	A	0	9	9	0	0	9	0	0
7	56180589	.	C	A	0	4	4	0	2	6	0	0
7	56398522	.	A	T	4	6	10	0	0	10	0	0
7	56398651	.	C	T	5	2	7	0	0	7	0	0
7	56401049	.	A	G	7	7	14	0	0	14	0	0
7	56401173	.	T	C	6	5	11	0	0	11	0	0
7	56405508	.	T	C	6	5	11	0	2	13	0	0
7	56483078	.	T	C	1	1	2	0	1	3	0	0
7	56483101	.	G	T	2	2	4	0	0	4	0	0
7	56484426	.	G	A	12	15	27	0	0	27	0	0
7	56529301	.	T	A	5	7	12	0	0	12	0	0
7	56529352	.	T	C	3	5	8	0	0	8	0	0
7	56830948	.	C	T	3	2	5	0	0	5	0	0
7	56831382	.	G	A	3	2	5	0	0	5	0	0
7	56831424	.	C	T	0	2	2	0	4	6	0	0
7	56831631	.	C	T	0	0	0	0	1	1	0	0
7	57047942	.	G	A	1	2	3	0	0	3	0	0
7	57047947	.	G	A	0	2	2	0	1	3	0	0
7	57049578	.	C	T	6	6	12	0	0	12	0	0
7	57049715	.	T	C	2	6	8	0	1	9	0	0
7	57049863	.	C	T	3	2	5	0	0	5	0	0
7	57049865	.	G	C	0	2	2	0	3	5	0	0
7	57049911	.	C	T	0	2	2	0	0	2	0	0
7	57049917	.	G	C	0	1	1	0	0	1	0	0
7	57065256	.	G	T	1	0	1	0	0	1	0	0
7	57071707	.	C	T	5	2	7	0	0	7	0	0
7	57081146	.	T	C	4	3	7	0	0	7	0	0
7	57083156	.	A	T	1	0	1	0	0	1	0	0
7	57086153	.	C	T	6	2	8	0	1	9	0	0
7	57116381	.	A	C	1	1	2	0	0	2	0	0
7	57116400	.	T	C	1	1	2	0	0	2	0	0
7	57122408	.	T	A	0	1	1	0	0	1	0	0
7	57129590	.	G	T	0	2	2	0	1	3	0	0
7	57342345	.	A	G	2	2	4	0	1	5	0	0
7	57342608	.	A	G	4	1	5	0	2	7	0	0
7	57342623	.	A	G	4	2	6	0	1	7	0	0
7	57485461	.	T	C	3	5	8	0	0	8	0	0
7	57485484	.	T	C	2	3	5	0	0	5	0	0
7	57485710	.	T	C	7	9	16	0	0	16	0	0
7	57485736	.	A	G	4	5	9	0	0	9	0	0
7	57485766	.	A	G	5	9	14	0	1	15	0	0
7	57494115	.	C	T	9	7	16	0	0	16	0	0
7	57504905	.	C	G	8	11	19	0	0	19	0	0
7	57509353	.	C	T	4	7	11	0	0	11	0	0
7	59443876	.	A	G	2	0	2	0	0	2	0	0
7	59586515	.	C	T	4	2	6	0	0	6	0	0
7	59588569	.	A	T	0	1	1	0	0	1	0	0
7	61588762	.	T	C	3	2	5	0	1	6	0	0
7	65306355	.	G	A	0	3	3	0	2	5	0	0
7	65473814	.	T	C	28	25	53	0	0	53	0	0
7	65922495	.	A	G	2	0	2	0	3	5	0	0
7	66112490	.	G	A	1	2	3	0	0	3	0	0
7	66112491	.	G	A	1	2	3	0	0	3	0	0
7	67079370	.	T	C	5	1	6	0	0	6	0	0
7	67743901	.	A	G	5	4	9	0	0	9	0	0
7	69143989	.	T	C	6	7	13	0	0	13	0	0
7	69143996	.	T	C	7	3	10	0	0	10	0	0
7	69144036	.	T	C	1	3	4	0	0	4	0	0
7	69144037	.	T	C	1	3	4	0	0	4	0	0
7	69144657	.	T	C	6	3	9	0	0	9	0	0
7	69145047	.	T	C	4	4	8	0	0	8	0	0
7	69145065	.	T	C	6	2	8	0	0	8	0	0
7	69145394	.	T	C	2	3	5	0	0	5	0	0
7	69146065	.	T	C	2	2	4	0	0	4	0	0
7	69146066	.	T	C	2	2	4	0	0	4	0	0
7	69313357	.	T	G	3	0	3	0	2	5	0	0
7	69518021	.	T	A	5	5	10	0	0	10	0	0
7	69518077	.	T	A	4	2	6	0	2	8	0	0
7	69521129	.	A	T	2	0	2	0	0	2	0	0
7	69540248	.	G	A	1	3	4	0	0	4	0	0
7	69540312	.	T	C	2	1	3	0	0	3	0	0
7	69566848	.	G	A	1	0	1	0	0	1	0	0
7	69566908	.	G	A	0	6	6	0	5	11	0	0
7	69576019	.	C	A	1	4	5	0	0	5	0	0
7	69576031	.	G	A	2	0	2	0	0	2	0	0
7	69583133	.	A	T	3	4	7	0	1	8	0	0
7	69583139	.	C	T	3	3	6	0	2	8	0	0
7	69615015	.	G	A	5	4	9	0	0	9	0	0
7	69636439	.	G	A	3	5	8	0	0	8	0	0
7	69636454	.	T	C	1	5	6	0	0	6	0	0
7	69643975	.	G	A	1	3	4	0	0	4	0	0
7	69749380	.	G	A	1	2	3	0	0	3	0	0
7	69913830	.	C	T	1	1	2	0	0	2	0	0
7	69921912	.	C	A	1	1	2	0	0	2	0	0
7	69943002	.	C	T	2	1	3	0	0	3	0	0
7	69946805	.	C	T	1	3	4	0	0	4	0	0
7	69950322	.	G	A	2	5	7	0	0	7	0	0
7	69959980	.	G	A	1	3	4	0	0	4	0	0
7	71792765	.	T	C	3	5	8	0	0	8	0	0
7	72018290	.	G	T	0	17	17	0	14	31	0	0
7	72024034	.	T	G	6	17	23	0	0	23	0	0
7	72024081	.	G	T	7	13	20	0	0	20	0	0
7	72024117	.	C	G	8	16	24	0	1	25	0	0
7	72024239	.	T	A	9	13	22	0	0	22	0	0
7	72024350	.	T	C	8	7	15	0	0	15	0	0
7	72024446	.	C	G	10	9	19	0	0	19	0	0
7	72024467	.	G	A	9	11	20	0	1	21	0	0
7	72024491	.	A	T	8	9	17	0	1	18	0	0
7	72024733	.	A	G	3	8	11	0	0	11	0	0
7	72025428	.	T	A	10	16	26	0	2	28	0	0
7	72025430	.	G	A	1	18	19	0	9	28	0	0
7	72025548	.	A	T	10	12	22	0	0	22	0	0
7	72025748	.	G	A	10	11	21	0	1	22	0	0
7	72025774	.	T	C	11	15	26	0	0	26	0	0
7	72025966	.	A	G	3	5	8	0	0	8	0	0
7	72027982	.	C	T	26	16	42	0	0	42	0	0
7	72028015	.	C	T	26	17	43	0	0	43	0	0
7	72028386	.	T	A	20	18	38	0	0	38	0	0
7	72028442	.	G	T	20	14	34	0	1	35	0	0
7	72028458	.	T	C	23	12	35	0	0	35	0	0
7	72028841	.	A	G	19	18	37	0	0	37	0	0
7	72028893	.	G	T	0	6	6	0	14	20	0	0
7	72028976	.	A	T	12	5	17	0	1	18	0	0
7	72029011	.	C	T	15	7	22	0	2	24	0	0
7	72029083	.	T	C	17	13	30	0	1	31	0	0
7	72029127	.	G	T	16	25	41	0	0	41	0	0
7	72029383	.	G	C	14	18	32	0	1	33	0	0
7	72029424	.	G	A	16	17	33	0	0	33	0	0
7	72029429	.	T	G	18	0	18	0	15	33	0	0
7	72032982	.	A	T	18	9	27	0	1	28	0	0
7	72033024	.	G	C	16	6	22	0	0	22	0	0
7	72033053	.	A	C	12	11	23	0	0	23	0	0
7	72033186	.	A	C	17	23	40	0	1	42	1	0
7	72033264	.	G	A	12	21	33	0	0	33	0	0
7	72033286	.	C	T	14	20	34	0	1	35	0	0
7	72033312	.	G	A	13	20	33	0	1	34	0	0
7	72033370	.	A	C	10	16	26	0	2	28	0	0
7	72033384	.	A	C	10	15	25	0	0	25	0	0
7	72034012	.	T	C	2	12	14	0	2	16	0	0
7	72034024	.	C	T	3	9	12	0	1	13	0	0
7	72034151	.	T	C	9	12	21	0	0	21	0	0
7	72034304	.	G	A	15	6	21	0	1	22	0	0
7	72034339	.	C	A	27	8	35	0	1	36	0	0
7	72034534	.	T	C	2	10	12	0	2	14	0	0
7	72034535	.	A	T	8	6	14	0	0	14	0	0
7	72034612	.	T	A	6	2	8	0	0	8	0	0
7	72034720	.	A	C	1	2	3	0	0	3	0	0
7	72034776	.	C	T	3	3	6	0	0	6	0	0
7	72034805	.	T	C	2	0	2	0	5	7	0	0
7	72034856	.	A	G	5	6	11	0	0	11	0	0
7	72034874	.	T	C	5	5	10	0	0	10	0	0
7	72035075	.	G	A	7	13	20	0	0	20	0	0
7	72035258	.	G	T	4	3	7	0	1	8	0	0
7	72035321	.	A	T	4	13	17	0	0	17	0	0
7	72035339	.	T	G	6	15	21	0	0	21	0	0
7	72035475	.	C	T	0	7	7	0	9	16	0	0
7	72040996	.	G	C	4	7	11	0	0	11	0	0
7	72045451	.	A	C	1	0	1	0	3	4	0	0
7	72051864	.	C	T	2	9	11	0	0	11	0	0
7	72103333	.	T	A	5	4	9	0	7	16	0	0
7	72410082	.	A	G	4	12	16	0	0	16	0	0
7	72415298	.	A	T	0	1	1	0	1	2	0	0
7	72416996	.	T	G	4	4	8	0	0	8	0	0
7	72417089	.	G	A	3	3	6	0	0	6	0	0
7	72417095	.	C	T	0	1	1	0	4	5	0	0
7	72417322	.	G	A	3	6	9	1	1	11	0	0
7	72417355	.	T	A	5	6	11	0	1	12	0	0
7	72419933	.	G	A	1	0	1	0	0	1	0	0
7	72421715	.	T	C	5	3	8	0	0	8	0	0
7	72421754	.	T	A	3	2	5	0	0	5	0	0
7	72434962	.	T	C	0	0	0	0	6	6	0	0
7	72434978	.	A	T	0	5	5	0	1	6	0	0
7	72482873	.	G	A	0	1	1	0	1	2	0	0
7	72484114	.	A	G	1	0	1	0	2	3	0	0
7	72492354	.	A	C	0	3	3	0	0	3	0	0
7	72517569	.	G	A	1	3	4	0	0	4	0	0
7	72528428	.	T	C	2	2	4	0	0	4	0	0
7	72535023	.	G	A	0	2	2	0	4	6	0	0
7	72538088	.	C	A	1	2	3	0	0	3	0	0
7	72541307	.	T	C	2	2	4	0	0	4	0	0
7	72541310	.	G	A	2	2	4	0	0	4	0	0
7	72545962	.	C	T	1	5	6	0	0	6	0	0
7	72546664	.	T	A	1	3	4	0	0	4	0	0
7	72549193	.	A	G	2	3	5	0	0	5	0	0
7	72552129	.	A	G	0	1	1	0	0	1	0	0
7	72558361	.	T	C	5	2	7	0	0	7	0	0
7	72567016	.	G	A	0	1	1	0	0	1	0	0
7	72567240	.	A	G	4	2	6	0	0	6	0	0
7	72569230	.	C	G	3	0	3	0	3	6	0	0
7	72570359	.	A	G	10	8	18	0	1	19	0	0
7	72578005	.	C	G	5	10	15	0	1	16	0	0
7	72583540	.	G	T	0	1	1	0	0	1	0	0
7	73617792	.	A	G	5	11	16	0	0	16	0	0
7	73618821	.	A	G	3	2	5	0	0	5	0	0
7	73618841	.	A	G	4	1	5	0	0	5	0	0
7	74056606	.	G	T	10	22	32	0	3	35	0	0
7	74086382	.	T	C	1	0	1	0	2	3	0	0
7	74134988	.	T	C	8	4	12	0	0	12	0	0
7	74135136	.	G	A	0	9	9	0	19	28	0	0
7	74135375	.	C	T	16	28	44	0	5	49	0	0
7	74135462	.	A	G	16	17	33	0	3	36	0	0
7	74143628	.	C	T	2	0	2	0	0	2	0	0
7	74144167	.	A	G	0	0	0	0	1	1	0	0
7	74154066	.	C	T	3	6	9	0	0	9	0	0
8	6440	.	A	T	1	10	11	0	0	11	0	0
8	6612	.	A	G	3	6	9	0	0	9	0	0
8	41751	.	G	C	6	4	10	0	1	11	0	0
8	41754	.	C	T	6	4	10	0	1	11	0	0
8	43740	.	T	C	1	0	1	0	0	1	0	0
8	43800	.	A	G	4	4	8	0	0	8	0	0
8	44337	.	G	A	2	3	5	0	0	5	0	0
8	56225	.	T	G	1	1	2	0	0	2	0	0
8	56285	.	A	G	6	5	11	0	0	11	0	0
8	56884	.	C	T	2	5	7	0	0	7	0	0
8	57732	.	C	T	0	2	2	0	7	9	0	0
8	58399	.	C	G	5	3	8	0	0	8	0	0
8	61833	.	G	A	1	1	2	0	0	2	0	0
8	75188	.	C	A	6	7	13	0	1	14	0	0
8	75446	.	G	T	0	8	8	0	6	14	0	0
8	109321	.	G	A	1	6	7	0	3	10	0	0
8	109489	.	T	C	0	1	1	0	0	1	0	0
8	115080	.	T	C	3	1	4	0	0	4	0	0
8	118378	.	T	C	1	1	2	0	0	2	0	0
8	120282	.	G	A	0	1	1	0	0	1	0	0
8	120377	.	A	G	1	0	1	0	3	4	0	0
8	120839	.	G	A	0	8	8	0	12	20	0	0
8	120896	.	T	C	7	11	18	0	0	18	0	0
8	173841	.	A	G	2	2	4	0	0	4	0	0
8	174020	.	G	A	2	0	2	0	0	2	0	0
8	262012	.	C	T	4	4	8	0	0	8	0	0
8	262054	.	C	A	1	2	3	0	0	3	0	0
8	262858	.	G	T	0	1	1	0	0	1	0	0
8	268215	.	G	A	0	1	1	0	0	1	0	0
8	269360	.	G	T	2	3	5	0	0	5	0	0
8	276277	.	C	T	1	3	4	0	0	4	0	0
8	276334	.	A	G	3	3	6	0	0	6	0	0
8	286192	.	A	G	7	7	14	0	2	16	0	0
8	286251	.	C	T	6	7	13	0	0	13	0	0
8	286302	.	G	A	10	7	17	0	2	19	0	0
8	387853	.	A	T	1	4	5	0	1	6	0	0
8	387915	.	A	G	3	4	7	0	0	7	0	0
8	388020	.	G	C	4	4	8	0	0	8	0	0
8	388885	.	C	T	10	13	23	0	1	24	0	0
8	388949	.	G	A	9	11	20	0	1	21	0	0
8	388997	.	T	A	12	6	18	0	3	21	0	0
8	389114	.	T	A	6	14	20	0	1	21	0	0
8	391988	.	C	A	8	5	13	0	1	14	0	0
8	392047	.	G	T	4	12	16	0	0	16	0	0
8	392160	.	C	A	0	6	6	0	0	7	1	0
8	395281	.	C	A	0	5	5	0	8	13	0	0
8	395287	.	C	T	10	5	15	0	0	15	0	0
8	397233	.	G	A	0	1	1	0	1	2	0	0
8	397341	.	C	T	0	10	10	0	11	21	0	0
8	400185	.	C	G	8	6	14	0	0	14	0	0
8	412303	.	G	A	3	2	5	0	1	6	0	0
8	412504	.	T	C	9	0	9	0	11	20	0	0
8	413845	.	G	C	2	0	2	0	2	4	0	0
8	423533	.	T	C	5	6	11	0	0	11	0	0
8	423723	.	C	T	9	5	14	0	1	15	0	0
8	423815	.	C	A	16	10	26	0	0	26	0	0
8	424123	.	G	A	6	12	18	0	1	19	0	0
8	424969	.	G	A	10	6	16	0	0	16	0	0
8	471390	.	A	C	1	0	1	0	0	1	0	0
8	473773	.	G	A	2	2	4	0	0	4	0	0
8	478844	.	T	C	6	4	10	0	0	10	0	0
8	478889	.	G	T	0	1	1	0	0	1	0	0
8	481970	.	C	T	4	3	7	0	1	8	0	0
8	481976	.	G	C	4	5	9	0	0	9	0	0
8	482033	.	A	G	4	7	11	0	1	12	0	0
8	484740	.	A	G	1	0	1	0	3	4	0	0
8	487208	.	G	A	4	2	6	0	0	6	0	0
8	487241	.	T	C	9	5	14	0	0	14	0	0
8	489169	.	C	T	5	3	8	0	0	8	0	0
8	489194	.	T	A	5	5	10	0	0	10	0	0
8	532895	.	T	A	1	4	5	0	1	6	0	0
8	532923	.	C	T	2	3	5	0	0	5	0	0
8	540214	.	G	A	0	0	0	0	1	1	0	0
8	541376	.	C	A	16	3	19	0	1	20	0	0
8	595166	.	C	T	0	4	4	1	3	8	0	0
8	630228	.	T	C	1	2	3	0	0	3	0	0
8	657489	.	G	A	0	4	4	0	4	8	0	0
8	657645	.	A	G	1	0	1	0	0	1	0	0
8	660467	.	T	C	1	0	1	0	0	1	0	0
8	705549	.	C	T	2	4	6	0	0	6	0	0
8	927337	.	G	A	12	8	20	0	1	21	0	0
8	1094910	.	T	A	12	9	21	0	0	21	0	0
8	1094973	.	G	T	0	8	8	0	8	16	0	0
8	1100463	.	C	T	12	19	31	0	0	31	0	0
8	1102404	.	T	C	7	7	14	0	0	14	0	0
8	1102533	.	G	T	13	9	22	0	0	22	0	0
8	1102551	.	C	T	13	5	18	0	2	20	0	0
8	1106494	.	C	A	6	5	11	0	1	12	0	0
8	1121315	.	C	G	0	1	1	0	0	1	0	0
8	1129971	.	T	G	2	2	4	0	1	5	0	0
8	1130331	.	C	T	4	5	9	0	0	9	0	0
8	1130450	.	C	G	6	0	6	0	5	11	0	0
8	1130526	.	C	A	9	5	14	0	1	15	0	0
8	1130544	.	T	C	6	9	15	0	0	15	0	0
8	1130574	.	G	A	4	5	9	0	0	9	0	0
8	1130590	.	A	T	2	9	11	0	0	11	0	0
8	1133753	.	C	G	3	3	6	0	0	6	0	0
8	1151416	.	T	C	0	2	2	0	0	2	0	0
8	1222417	.	T	C	7	0	7	0	6	13	0	0
8	1222504	.	T	C	9	0	9	0	20	29	0	0
8	1255292	.	C	G	0	6	6	0	4	10	0	0
8	1255304	.	G	A	2	1	3	0	0	3	0	0
8	1259023	.	G	A	3	6	9	0	0	9	0	0
8	1264645	.	A	G	2	1	3	0	0	3	0	0
8	1265705	.	T	G	8	2	10	0	0	10	0	0
8	1267074	.	T	A	11	11	22	0	0	22	0	0
8	1267153	.	G	A	7	17	24	0	0	24	0	0
8	1267157	.	G	A	8	17	25	0	0	25	0	0
8	1267233	.	G	T	1	3	4	0	0	4	0	0
8	1298813	.	C	T	7	2	9	0	0	9	0	0
8	1852056	.	A	G	1	5	6	0	0	6	0	0
8	1852078	.	A	G	4	2	6	0	0	6	0	0
8	1852196	.	A	G	1	5	6	0	0	6	0	0
8	1855256	.	A	G	6	3	9	0	2	11	0	0
8	3085466	.	C	A	2	2	4	0	0	4	0	0
8	3085565	.	A	G	2	5	7	0	0	7	0	0
8	3085841	.	T	A	4	7	11	0	0	11	0	0
8	3085863	.	A	G	3	4	7	0	0	7	0	0
8	3099585	.	G	A	0	6	6	0	8	14	0	0
8	3101241	.	G	T	6	4	10	0	0	10	0	0
8	3101277	.	T	C	4	9	13	0	1	14	0	0
8	3426764	.	C	T	1	3	4	0	0	4	0	0
8	3426825	.	T	C	2	2	4	0	0	4	0	0
8	3427385	.	A	G	1	4	5	0	0	5	0	0
8	3434245	.	C	T	3	3	6	0	0	6	0	0
8	3434368	.	G	A	1	2	3	0	0	3	0	0
8	3434449	.	C	T	1	3	4	0	0	4	0	0
8	3438703	.	A	G	1	1	2	0	0	2	0	0
8	3439164	.	G	A	1	3	4	0	0	4	0	0
8	3439283	.	G	C	3	3	6	0	0	6	0	0
8	3439309	.	C	T	3	5	8	0	0	8	0	0
8	3537152	.	G	A	0	3	3	0	1	4	0	0
8	3545327	.	C	T	2	2	4	0	0	4	0	0
8	3545328	.	G	A	0	2	2	0	2	4	0	0
8	3561501	.	T	C	1	0	1	0	0	1	0	0
8	3561515	.	G	A	1	0	1	0	0	1	0	0
8	3568037	.	C	T	0	3	3	0	0	3	0	0
8	3569907	.	C	T	5	6	11	0	0	11	0	0
8	3571727	.	T	A	3	1	4	0	0	4	0	0
8	3586385	.	C	T	1	1	2	0	0	2	0	0
8	3591154	.	T	C	1	1	2	0	0	2	0	0
8	3591211	.	C	A	2	5	7	0	0	7	0	0
8	3594308	.	A	G	2	0	2	0	2	4	0	0
8	3595161	.	G	A	0	1	1	0	0	1	0	0
8	3595359	.	C	T	3	3	6	0	0	6	0	0
8	3597233	.	T	C	1	6	7	0	0	7	0	0
8	3605050	.	A	G	3	0	3	0	4	7	0	0
8	3612263	.	T	A	1	1	2	0	0	2	0	0
8	3612308	.	A	T	8	5	13	0	0	13	0	0
8	3624208	.	G	C	5	1	6	0	0	6	0	0
8	3628683	.	C	T	1	2	3	0	0	3	0	0
8	3628747	.	C	A	5	11	16	0	0	16	0	0
8	3628758	.	T	A	5	9	14	0	0	14	0	0
8	3628782	.	G	A	1	11	12	0	9	21	0	0
8	3631932	.	C	T	1	1	2	0	0	2	0	0
8	3641218	.	G	C	1	7	8	0	0	8	0	0
8	3643299	.	T	C	12	14	26	0	0	26	0	0
8	3660034	.	C	T	1	2	3	0	0	3	0	0
8	3716675	.	C	T	0	3	3	0	2	5	0	0
8	3756287	.	C	A	0	2	2	0	3	5	0	0
8	3859383	.	T	A	4	6	10	0	0	10	0	0
8	3865233	.	T	C	9	10	19	0	1	20	0	0
8	3883831	.	C	G	3	5	8	0	1	9	0	0
8	3886220	.	T	C	0	2	2	0	0	2	0	0
8	3889662	.	G	A	0	7	7	0	2	9	0	0
8	3890837	.	T	C	2	0	2	0	0	2	0	0
8	3904963	.	C	T	5	8	13	0	0	13	0	0
8	3915909	.	G	A	1	1	2	0	0	2	0	0
8	3923371	.	C	T	3	5	8	0	0	8	0	0
8	3932974	.	A	G	9	5	14	0	0	14	0	0
8	3932990	.	A	G	10	8	18	0	0	18	0	0
8	3933498	.	T	A	8	11	19	0	1	20	0	0
8	3949558	.	G	T	3	2	5	0	0	5	0	0
8	3950039	.	C	G	7	3	10	0	0	10	0	0
8	3950317	.	G	A	4	5	9	0	0	9	0	0
8	3950529	.	C	T	1	3	4	0	0	4	0	0
8	3950554	.	C	T	1	2	3	0	0	3	0	0
8	3950655	.	C	T	4	4	8	0	0	8	0	0
8	3952495	.	G	T	1	4	5	0	0	5	0	0
8	3956898	.	G	A	3	2	5	0	0	5	0	0
8	4044846	.	G	A	4	2	6	0	0	6	0	0
8	4044965	.	T	A	1	3	4	0	0	4	0	0
8	4044974	.	G	A	1	2	3	0	0	3	0	0
8	4048565	.	G	A	1	2	3	0	0	3	0	0
8	4059087	.	G	A	2	2	4	0	0	4	0	0
8	4059838	.	G	A	1	0	1	0	0	1	0	0
8	4067419	.	T	A	1	2	3	0	0	3	0	0
8	4074424	.	G	A	2	1	3	0	1	4	0	0
8	4154512	.	T	C	1	0	1	0	0	1	0	0
8	4368586	.	T	G	3	8	11	0	0	11	0	0
8	4368714	.	C	G	3	3	6	0	0	6	0	0
8	4369021	.	A	C	1	4	5	0	0	5	0	0
8	4381510	.	A	G	2	1	3	0	4	7	0	0
8	4381624	.	G	A	2	1	3	0	0	3	0	0
8	4386198	.	A	G	2	2	4	0	0	4	0	0
8	4393910	.	C	G	3	6	9	0	0	9	0	0
8	4398425	.	A	T	3	7	10	0	0	10	0	0
8	4398531	.	T	C	4	3	7	0	0	7	0	0
8	4398737	.	C	T	7	7	14	0	0	14	0	0
8	4398762	.	A	G	6	8	14	0	2	16	0	0
8	4398981	.	G	A	0	4	4	0	5	9	0	0
8	4399366	.	G	A	0	5	5	0	1	6	0	0
8	4399394	.	C	G	2	7	9	0	0	9	0	0
8	4399623	.	A	G	4	5	9	0	0	9	0	0
8	4399624	.	A	G	7	2	9	0	0	9	0	0
8	4400337	.	A	G	0	2	2	0	0	2	0	0
8	4400357	.	T	G	1	2	3	1	0	4	0	0
8	4400699	.	C	A	7	6	13	0	0	13	0	0
8	4400861	.	T	C	3	8	11	0	1	12	0	0
8	4400872	.	G	A	0	5	5	0	4	9	0	0
8	4401053	.	T	G	4	5	9	0	0	9	0	0
8	4401068	.	C	T	6	6	12	0	0	12	0	0
8	4401374	.	G	A	1	6	7	0	9	16	0	0
8	4401514	.	A	T	5	8	13	0	0	13	0	0
8	4401687	.	G	A	9	18	27	0	2	29	0	0
8	4401708	.	C	T	9	22	31	0	0	31	0	0
8	4401813	.	G	T	15	14	29	0	0	29	0	0
8	4401913	.	T	G	3	8	11	0	1	12	0	0
8	4401931	.	T	C	3	9	12	0	0	12	0	0
8	4440705	.	A	C	3	2	5	0	0	5	0	0
8	4440720	.	T	C	2	2	4	0	1	5	0	0
8	4442655	.	G	A	0	0	0	0	1	1	0	0
8	4444201	.	A	G	3	2	5	0	0	5	0	0
8	4444313	.	G	A	0	2	2	0	3	5	0	0
8	4446247	.	A	C	4	0	4	0	2	6	0	0
8	4446266	.	C	T	1	2	3	0	2	5	0	0
8	4446303	.	T	C	5	3	8	0	0	8	0	0
8	4446407	.	T	C	4	1	5	0	1	6	0	0
8	4455801	.	A	G	1	0	1	0	0	1	0	0
8	4516962	.	G	A	4	4	8	0	0	8	0	0
8	4519161	.	C	T	0	2	2	0	1	3	0	0
8	4522035	.	T	A	1	2	3	0	0	3	0	0
8	4525126	.	C	T	2	3	5	0	0	5	0	0
8	4525174	.	A	G	0	3	3	0	0	3	0	0
8	4530578	.	C	A	1	2	3	0	0	3	0	0
8	4530581	.	C	T	0	2	2	0	1	3	0	0
8	4530635	.	C	A	3	2	5	0	0	5	0	0
8	4530647	.	G	A	2	2	4	0	0	4	0	0
8	4563416	.	A	G	0	2	2	0	0	2	0	0
8	4564296	.	A	T	1	2	3	0	0	3	0	0
8	4573481	.	T	C	4	2	6	0	1	7	0	0
8	4589148	.	A	G	21	24	45	0	3	48	0	0
8	4589169	.	T	G	25	24	49	0	1	50	0	0
8	4589216	.	A	T	24	16	40	0	2	42	0	0
8	4589402	.	C	T	22	32	54	0	1	55	0	0
8	4596649	.	T	A	5	11	16	0	0	16	0	0
8	4609822	.	T	C	14	0	14	0	13	27	0	0
8	4618536	.	G	A	11	10	21	0	1	22	0	0
8	4618562	.	C	T	0	11	11	0	13	24	0	0
8	4621454	.	A	G	7	4	11	0	0	11	0	0
8	4621742	.	A	G	6	0	6	0	0	6	0	0
8	4621744	.	C	T	6	0	6	0	0	6	0	0
8	4621817	.	G	T	9	5	14	0	0	14	0	0
8	4698518	.	G	A	0	5	5	0	2	7	0	0
8	4776243	.	A	T	18	6	24	0	2	26	0	0
8	4780127	.	A	T	4	6	10	0	0	10	0	0
8	4780147	.	T	C	9	3	12	0	0	12	0	0
8	4780368	.	T	A	3	6	9	0	0	9	0	0
8	4780552	.	C	T	1	8	9	0	13	22	0	0
8	4780637	.	G	T	2	6	8	0	2	10	0	0
8	4782879	.	C	T	0	1	1	0	1	2	0	0
8	4788942	.	T	C	11	0	11	0	11	22	0	0
8	4799942	.	T	C	1	2	3	0	0	3	0	0
8	4799945	.	T	C	1	2	3	0	0	3	0	0
8	4800185	.	C	T	1	2	3	0	0	3	0	0
8	4800683	.	G	A	1	3	4	0	1	5	0	0
8	4803950	.	C	T	12	2	14	0	0	14	0	0
8	4803956	.	C	T	12	3	15	0	0	15	0	0
8	4807033	.	G	C	0	2	2	0	3	5	0	0
8	4809221	.	C	T	2	4	6	0	1	7	0	0
8	4809230	.	C	T	2	3	5	0	2	7	0	0
8	4813592	.	C	T	7	4	11	0	0	11	0	0
8	4813635	.	G	A	8	5	13	0	0	13	0	0
8	4859369	.	G	T	0	1	1	0	1	2	0	0
8	5119396	.	A	G	5	9	14	0	0	14	0	0
8	5122568	.	G	A	9	11	20	0	1	21	0	0
8	5141521	.	G	A	4	6	10	0	0	10	0	0
8	5144347	.	T	G	0	1	1	0	0	1	0	0
8	5148911	.	A	G	1	0	1	0	0	1	0	0
8	5149030	.	G	T	8	3	11	0	1	12	0	0
8	7119123	.	A	G	3	3	6	0	0	6	0	0
8	7122313	.	A	G	6	4	10	0	0	10	0	0
8	7122332	.	A	G	3	7	10	0	0	10	0	0
8	7122403	.	A	G	6	0	6	0	8	14	0	0
8	7122404	.	A	G	9	4	13	0	1	14	0	0
8	7908287	.	A	G	1	0	1	0	2	3	0	0
8	7908288	.	A	G	1	2	3	0	0	3	0	0
8	7908374	.	A	G	1	0	1	0	3	4	0	0
8	7908520	.	A	G	1	2	3	0	0	3	0	0
8	8686441	.	T	C	5	2	7	0	0	7	0	0
8	8686875	.	T	C	5	2	7	0	0	7	0	0
8	11201880	.	A	G	1	2	3	0	0	3	0	0
8	11202058	.	C	T	2	2	4	0	0	4	0	0
8	11204174	.	C	T	3	2	5	0	0	5	0	0
8	11204365	.	C	A	1	3	4	0	0	4	0	0
8	11204699	.	C	T	5	2	7	0	0	7	0	0
8	11204879	.	A	T	1	2	3	0	0	3	0	0
8	11234333	.	A	C	0	0	0	0	2	2	0	0
8	11234334	.	T	G	0	2	2	0	0	2	0	0
8	11234489	.	T	C	6	0	6	0	7	13	0	0
8	11234573	.	A	G	7	6	13	0	0	13	0	0
8	11236914	.	T	C	3	2	5	0	0	5	0	0
8	11245918	.	C	T	1	6	7	0	0	7	0	0
8	11268795	.	G	A	5	4	9	0	0	9	0	0
8	11278615	.	G	A	4	4	8	0	0	8	0	0
8	11289267	.	G	C	2	1	3	0	0	3	0	0
8	11289274	.	C	A	1	1	2	0	0	2	0	0
8	11327947	.	C	G	1	0	1	0	0	1	0	0
8	11337395	.	C	T	2	3	5	0	0	5	0	0
8	11337692	.	T	G	2	2	4	0	0	4	0	0
8	11337703	.	A	C	2	3	5	0	0	5	0	0
8	11337743	.	T	A	2	2	4	0	0	4	0	0
8	11337770	.	C	T	1	2	3	0	0	3	0	0
8	11339307	.	T	C	7	7	14	0	0	14	0	0
8	11339453	.	T	G	2	0	2	0	2	4	0	0
8	11339458	.	A	T	1	1	2	0	1	3	0	0
8	11477573	.	C	T	5	3	8	0	1	9	0	0
8	11483097	.	G	A	0	12	12	0	12	24	0	0
8	11483163	.	C	T	13	13	26	0	4	30	0	0
8	11488414	.	C	T	10	4	14	0	0	14	0	0
8	11491308	.	A	G	8	6	14	0	1	15	0	0
8	11491332	.	C	T	5	3	8	0	1	9	0	0
8	11491347	.	G	C	1	1	2	0	5	7	0	0
8	11503000	.	A	C	1	3	4	0	0	4	0	0
8	11503006	.	T	C	1	2	3	0	0	3	0	0
8	11504174	.	T	A	2	4	6	0	0	6	0	0
8	11520599	.	C	T	1	1	2	0	0	2	0	0
8	11521110	.	A	T	5	4	9	0	0	9	0	0
8	11521145	.	G	A	7	7	14	0	1	15	0	0
8	11521229	.	C	T	4	3	7	0	0	7	0	0
8	11521244	.	A	G	3	1	4	0	0	4	0	0
8	11535261	.	A	G	5	5	10	0	1	11	0	0
8	11540815	.	G	T	1	0	1	0	0	1	0	0
8	11541829	.	A	G	7	10	17	0	0	17	0	0
8	11541844	.	C	A	8	9	17	0	0	17	0	0
8	11541880	.	T	C	7	7	14	0	0	14	0	0
8	11543631	.	C	T	1	0	1	0	0	1	0	0
8	11548311	.	G	T	1	3	4	0	0	4	0	0
8	11578414	.	G	T	4	5	9	0	1	10	0	0
8	11584163	.	T	C	4	0	4	0	0	4	0	0
8	11590898	.	G	A	6	2	8	0	1	9	0	0
8	11590903	.	G	A	7	3	10	0	0	10	0	0
8	11615923	.	C	T	0	1	1	0	0	1	0	0
8	11648725	.	C	T	1	1	2	0	0	2	0	0
8	11649993	.	T	C	1	1	2	0	0	2	0	0
8	11728191	.	C	T	1	3	4	0	0	4	0	0
8	11728655	.	C	A	3	5	8	0	0	8	0	0
8	11730896	.	C	A	5	2	7	0	0	7	0	0
8	11730911	.	C	T	4	1	5	0	0	5	0	0
8	11734317	.	C	T	3	4	7	0	2	9	0	0
8	11734353	.	C	A	3	1	4	0	0	4	0	0
8	11736671	.	T	A	0	1	1	0	0	1	0	0
8	11737826	.	T	C	2	1	3	0	0	3	0	0
8	11740220	.	T	C	9	8	17	0	0	17	0	0
8	11740370	.	G	A	8	12	20	0	1	21	0	0
8	11746684	.	A	G	3	5	8	0	0	8	0	0
8	11746701	.	G	T	3	5	8	0	1	9	0	0
8	11746741	.	G	A	8	8	16	0	1	17	0	0
8	11752669	.	C	T	0	2	2	0	0	2	0	0
8	11752672	.	T	A	0	2	2	0	0	2	0	0
8	11761820	.	C	T	0	1	1	0	3	4	0	0
8	11761862	.	T	C	3	0	3	0	1	4	0	0
8	11770027	.	A	G	3	3	6	0	0	6	0	0
8	11770033	.	T	A	2	3	5	0	0	5	0	0
8	11779630	.	C	A	0	2	2	0	2	4	0	0
8	11788795	.	C	T	3	0	3	0	0	3	0	0
8	11792633	.	A	G	3	2	5	0	0	5	0	0
8	11831881	.	A	G	0	2	2	0	0	2	0	0
8	11884749	.	A	G	3	2	5	0	0	5	0	0
8	11884789	.	A	T	1	3	4	0	0	4	0	0
8	11885082	.	T	C	1	0	1	0	0	1	0	0
8	11987931	.	C	T	5	5	10	0	0	10	0	0
8	12016451	.	T	C	14	14	28	0	0	28	0	0
8	12111198	.	C	T	8	12	20	0	2	22	0	0
8	12135190	.	G	A	0	1	1	0	0	1	0	0
8	12135193	.	A	G	0	1	1	0	0	1	0	0
8	12135256	.	G	A	0	1	1	0	0	1	0	0
8	12136448	.	A	G	6	7	13	0	0	13	0	0
8	12142180	.	T	A	1	0	1	0	0	1	0	0
8	12149994	.	G	A	4	2	6	0	0	6	0	0
8	12150480	.	A	G	4	5	9	0	1	10	0	0
8	12150516	.	G	C	2	0	2	0	2	4	0	0
8	12182923	.	G	A	1	4	5	0	0	5	0	0
8	12209354	.	C	G	1	2	3	0	0	3	0	0
8	12340595	.	A	G	1	2	3	0	0	3	0	0
8	12340621	.	C	T	1	2	3	0	0	3	0	0
8	12452284	.	C	T	0	12	12	0	12	24	0	0
8	12521420	.	A	G	2	6	8	0	0	8	0	0
8	12574533	.	A	G	2	5	7	0	0	7	0	0
8	12601513	.	G	A	5	6	11	0	0	11	0	0
8	12668578	.	G	T	1	6	7	0	2	9	0	0
8	12668714	.	C	T	4	8	12	0	0	12	0	0
8	12925505	.	T	C	8	5	13	0	0	13	0	0
8	12932734	.	G	A	4	5	9	0	2	11	0	0
8	12935793	.	A	G	3	0	3	0	5	8	0	0
8	12935799	.	T	C	2	5	7	0	0	7	0	0
8	12935844	.	C	T	0	1	1	0	0	1	0	0
8	12936041	.	A	G	0	1	1	0	0	1	0	0
8	12936857	.	A	C	13	12	25	0	1	26	0	0
8	12937147	.	T	C	1	7	8	0	0	8	0	0
8	12951260	.	C	G	2	2	4	0	0	4	0	0
8	12955081	.	G	A	3	1	4	0	1	5	0	0
8	12955111	.	C	T	3	2	5	0	0	5	0	0
8	12989640	.	T	A	11	4	15	0	0	15	0	0
8	12991628	.	C	T	1	3	4	0	0	4	0	0
8	12994619	.	C	T	0	2	2	0	0	2	0	0
8	13068237	.	A	T	6	3	9	0	0	9	0	0
8	13068315	.	C	T	3	1	4	0	3	7	0	0
8	13093677	.	C	T	0	4	4	0	0	4	0	0
8	13094340	.	C	T	1	0	1	0	0	1	0	0
8	13097535	.	C	T	9	8	17	0	2	19	0	0
8	13097538	.	C	A	10	7	17	0	1	18	0	0
8	13098033	.	A	G	2	2	4	0	0	4	0	0
8	13137192	.	G	A	1	2	3	0	0	3	0	0
8	13137204	.	T	C	1	2	3	0	0	3	0	0
8	13158601	.	G	A	0	2	2	0	5	7	0	0
8	13159126	.	A	C	1	2	3	0	0	3	0	0
8	13159145	.	C	A	2	2	4	0	0	4	0	0
8	13159280	.	T	A	1	4	5	0	0	5	0	0
8	13161999	.	A	G	7	4	11	0	1	12	0	0
8	13162008	.	T	C	8	4	12	0	0	12	0	0
8	13166176	.	T	A	1	2	3	0	0	3	0	0
8	13192061	.	T	C	5	1	6	0	0	6	0	0
8	13194912	.	C	T	0	5	5	0	3	8	0	0
8	13210957	.	T	C	2	0	2	0	2	4	0	0
8	13211089	.	C	A	0	3	3	0	2	5	0	0
8	13211198	.	A	G	1	2	3	0	0	3	0	0
8	13244683	.	T	C	1	5	6	0	0	6	0	0
8	13352100	.	C	A	0	15	15	0	16	31	0	0
8	13352103	.	T	A	17	14	31	0	1	32	0	0
8	13352166	.	T	C	14	18	32	0	1	33	0	0
8	13352318	.	G	A	16	16	32	0	2	34	0	0
8	13352428	.	A	G	24	27	51	0	1	52	0	0
8	13355949	.	C	T	13	21	34	0	3	37	0	0
8	13362699	.	T	C	20	25	45	0	1	46	0	0
8	13382207	.	G	T	0	2	2	0	0	2	0	0
8	13630504	.	T	C	3	2	5	0	0	5	0	0
8	13643800	.	G	A	1	2	3	0	0	3	0	0
8	13644051	.	A	T	0	2	2	0	1	3	0	0
8	13779556	.	C	T	2	8	10	0	0	10	0	0
8	13779604	.	T	C	0	3	3	0	1	4	0	0
8	13782862	.	C	G	6	5	11	0	0	11	0	0
8	13782902	.	C	A	8	5	13	0	2	15	0	0
8	13784177	.	A	G	2	4	6	0	1	7	0	0
8	13784180	.	G	A	3	5	8	0	0	8	0	0
8	13784219	.	C	T	12	12	24	0	1	25	0	0
8	13784231	.	A	G	11	14	25	0	0	25	0	0
8	13784288	.	A	T	2	1	3	0	2	5	0	0
8	13786944	.	G	C	12	18	30	0	0	30	0	0
8	13787093	.	G	A	0	4	4	0	6	10	0	0
8	13787132	.	G	A	14	6	20	0	0	20	0	0
8	13787150	.	A	T	13	6	19	0	1	20	0	0
8	13787528	.	G	A	15	7	22	0	0	22	0	0
8	13850246	.	A	C	1	2	3	0	0	3	0	0
8	13852774	.	C	T	17	17	34	0	1	35	0	0
8	13852795	.	T	C	11	23	34	0	4	38	0	0
8	13852864	.	T	C	13	14	27	0	2	29	0	0
8	13852930	.	G	A	12	13	25	0	2	27	0	0
8	13853026	.	C	T	2	2	4	0	0	4	0	0
8	13910234	.	C	A	7	7	14	0	0	14	0	0
8	13944193	.	T	C	5	4	9	0	0	9	0	0
8	13991828	.	G	A	3	3	6	0	0	6	0	0
8	13991875	.	C	A	1	5	6	0	0	6	0	0
8	13993704	.	A	G	0	2	2	0	0	2	0	0
8	13998483	.	A	C	2	3	5	0	1	6	0	0
8	13998502	.	C	A	4	3	7	0	0	7	0	0
8	14003374	.	G	A	25	24	49	0	2	51	0	0
8	14012346	.	C	T	1	13	14	0	16	30	0	0
8	14018790	.	C	T	5	4	9	0	0	9	0	0
8	14020571	.	A	G	20	25	45	0	1	46	0	0
8	14027241	.	A	C	14	13	27	0	2	29	0	0
8	14041319	.	A	G	22	19	41	0	1	42	0	0
8	14043810	.	A	G	16	19	35	0	4	39	0	0
8	14049333	.	A	C	11	13	24	0	1	25	0	0
8	14049447	.	G	A	23	29	52	0	1	53	0	0
8	14049462	.	A	G	20	35	55	0	1	56	0	0
8	14049641	.	G	A	28	14	42	0	1	43	0	0
8	14049702	.	T	C	17	17	34	0	0	34	0	0
8	14061963	.	C	A	1	2	3	0	0	3	0	0
8	14063418	.	T	A	14	4	18	0	0	18	0	0
8	14064253	.	T	A	2	2	4	0	0	4	0	0
8	14064374	.	G	A	3	4	7	0	0	7	0	0
8	14064441	.	C	A	4	4	8	0	0	8	0	0
8	14070490	.	T	C	1	4	5	0	1	6	0	0
8	14075809	.	C	T	8	11	19	0	1	20	0	0
8	14076247	.	G	A	7	3	10	0	0	10	0	0
8	14076340	.	T	G	9	10	19	0	3	22	0	0
8	14133855	.	G	A	2	1	3	0	0	3	0	0
8	14134678	.	G	T	1	3	4	0	0	4	0	0
8	14141184	.	C	T	1	2	3	0	0	3	0	0
8	14144661	.	A	G	1	2	3	0	0	3	0	0
8	14163845	.	A	G	5	8	13	0	1	14	0	0
8	14170428	.	C	A	7	9	16	0	0	16	0	0
8	14170546	.	A	T	6	3	9	0	0	9	0	0
8	14170712	.	C	T	24	11	35	0	0	35	0	0
8	14170789	.	A	T	6	11	17	0	4	21	0	0
8	14171076	.	A	T	18	10	28	1	5	34	0	0
8	14171346	.	T	C	20	15	35	0	2	37	0	0
8	14171414	.	G	A	15	21	36	0	1	37	0	0
8	14171660	.	T	C	17	21	38	0	2	40	0	0
8	14171825	.	C	T	2	18	20	0	20	40	0	0
8	14171875	.	G	T	27	16	43	0	0	43	0	0
8	14171955	.	T	C	24	14	38	0	1	39	0	0
8	14172113	.	A	T	22	18	40	0	1	41	0	0
8	14174231	.	G	A	15	17	32	0	0	32	0	0
8	14176574	.	T	C	1	1	2	0	0	2	0	0
8	14176592	.	A	G	4	7	11	0	0	11	0	0
8	14184198	.	C	T	0	5	5	0	25	30	0	0
8	14184246	.	A	G	22	22	44	0	2	46	0	0
8	14211960	.	A	G	3	5	8	0	0	8	0	0
8	14212264	.	T	G	3	4	7	0	0	7	0	0
8	14212545	.	T	C	4	0	4	0	11	15	0	0
8	14212676	.	A	G	7	10	17	0	0	17	0	0
8	14213303	.	T	C	7	4	11	0	0	11	0	0
8	14217986	.	T	C	2	4	6	0	0	6	0	0
8	14219756	.	C	T	0	3	3	0	4	7	0	0
8	14225269	.	G	A	3	7	10	0	0	10	0	0
8	14228320	.	G	A	0	1	1	0	0	1	0	0
8	14229557	.	A	G	1	2	3	0	0	3	0	0
8	14238810	.	G	A	3	2	5	0	1	6	0	0
8	14238826	.	C	T	3	2	5	0	0	5	0	0
8	14244494	.	A	G	11	10	21	0	2	23	0	0
8	14246405	.	G	A	24	19	43	0	0	43	0	0
8	14246411	.	A	G	23	17	40	0	2	42	0	0
8	14247431	.	A	G	4	2	6	0	0	6	0	0
8	14250036	.	C	T	14	10	24	0	0	24	0	0
8	14250063	.	A	T	14	15	29	0	0	29	0	0
8	14272806	.	A	G	8	6	14	0	0	14	0	0
8	14275609	.	G	A	2	3	5	0	0	5	0	0
8	14278444	.	G	A	6	11	17	0	0	17	0	0
8	14375543	.	A	T	12	11	23	0	1	24	0	0
8	14375718	.	T	A	9	10	19	0	0	19	0	0
8	14375742	.	C	A	9	10	19	0	0	19	0	0
8	14375841	.	T	C	12	5	17	0	1	18	0	0
8	14375873	.	T	C	3	2	5	0	1	6	0	0
8	14384377	.	A	G	7	4	11	0	0	11	0	0
8	14388428	.	A	G	0	2	2	0	0	2	0	0
8	14388482	.	G	A	0	1	1	0	0	1	0	0
8	14439556	.	T	G	6	3	9	0	0	9	0	0
8	14440447	.	A	C	8	3	11	0	0	11	0	0
8	14440526	.	A	G	2	0	2	0	3	5	0	0
8	14440528	.	T	C	2	2	4	0	1	5	0	0
8	14440564	.	A	G	4	4	8	0	0	8	0	0
8	14440580	.	C	A	5	5	10	0	0	10	0	0
8	14441120	.	A	G	13	5	18	0	2	20	0	0
8	14441149	.	A	G	13	4	17	0	1	18	0	0
8	14441344	.	C	T	7	7	14	0	0	14	0	0
8	14441416	.	C	A	7	13	20	0	0	20	0	0
8	14441524	.	A	G	2	8	10	0	0	10	0	0
8	14441596	.	A	G	9	4	13	0	0	13	0	0
8	14441656	.	A	C	7	10	17	0	0	17	0	0
8	14441657	.	C	A	7	10	17	0	0	17	0	0
8	14441728	.	A	C	1	4	5	0	0	5	0	0
8	14504624	.	A	G	1	2	3	0	0	3	0	0
8	14504669	.	A	G	1	2	3	0	0	3	0	0
8	14559476	.	A	G	2	4	6	0	1	7	0	0
8	14559709	.	T	A	5	2	7	0	0	7	0	0
8	14560242	.	A	C	2	5	7	0	0	7	0	0
8	14560252	.	A	G	2	5	7	0	0	7	0	0
8	14560612	.	G	A	2	4	6	0	0	6	0	0
8	14560888	.	A	T	2	3	5	0	0	5	0	0
8	14561114	.	G	T	1	3	4	0	0	4	0	0
8	14561129	.	T	G	1	3	4	0	0	4	0	0
8	14561195	.	A	C	1	2	3	0	0	3	0	0
8	14564126	.	C	T	0	3	3	0	4	7	0	0
8	14564717	.	T	A	6	5	11	0	0	11	0	0
8	14564813	.	G	T	3	5	8	0	1	9	0	0
8	14565180	.	T	C	4	4	8	0	0	8	0	0
8	14565303	.	T	A	1	2	3	0	0	3	0	0
8	14565350	.	G	A	4	4	8	0	0	8	0	0
8	14565376	.	T	C	6	4	10	0	0	10	0	0
8	14565457	.	T	C	2	4	6	0	1	7	0	0
8	14566360	.	C	A	2	5	7	0	0	7	0	0
8	14566380	.	A	C	1	0	1	0	3	4	0	0
8	14568457	.	T	C	5	0	5	0	3	8	0	0
8	14568760	.	G	A	2	2	4	0	0	4	0	0
8	14571053	.	A	G	4	4	8	0	0	8	0	0
8	14580484	.	A	G	0	1	1	0	0	1	0	0
8	14581138	.	A	T	1	7	8	0	0	8	0	0
8	14581171	.	C	A	0	3	3	0	1	4	0	0
8	14591771	.	C	T	0	2	2	0	2	4	0	0
8	14781631	.	G	A	0	2	2	0	1	3	0	0
8	14790282	.	T	C	10	7	17	0	0	17	0	0
8	14790559	.	A	G	4	4	8	0	2	10	0	0
8	14790733	.	C	T	3	2	5	0	0	5	0	0
8	14792860	.	A	G	5	5	10	0	0	10	0	0
8	14801544	.	G	A	1	2	3	0	0	3	0	0
8	14802951	.	T	C	3	1	4	0	0	4	0	0
8	14805109	.	C	T	1	1	2	0	0	2	0	0
8	14810527	.	A	G	4	3	7	0	0	7	0	0
8	14972782	.	T	A	0	0	0	0	1	1	0	0
8	14978906	.	T	C	4	3	7	0	0	7	0	0
8	14979893	.	A	C	6	7	13	0	1	14	0	0
8	14980933	.	C	A	3	3	6	0	1	7	0	0
8	14981059	.	A	T	1	7	8	0	0	8	0	0
8	14981124	.	A	T	1	4	5	0	1	6	0	0
8	14981189	.	T	A	4	3	7	0	0	7	0	0
8	14981235	.	C	T	4	2	6	0	0	6	0	0
8	14982022	.	A	G	3	4	7	0	0	7	0	0
8	14982919	.	C	T	7	3	10	0	1	11	0	0
8	14982962	.	A	T	5	1	6	0	1	7	0	0
8	14983034	.	A	G	5	3	8	0	2	10	0	0
8	14983117	.	A	G	3	2	5	0	0	5	0	0
8	14983191	.	A	G	0	6	6	0	0	6	0	0
8	14983211	.	A	G	2	3	5	0	0	5	0	0
8	14983259	.	A	G	1	0	1	0	3	4	0	0
8	14983866	.	C	T	5	5	10	0	0	10	0	0
8	15056624	.	C	G	5	5	10	0	0	10	0	0
8	15072236	.	A	C	0	2	2	0	0	2	0	0
8	15080551	.	G	A	10	5	15	0	0	15	0	0
8	15080566	.	A	G	9	5	14	0	0	14	0	0
8	15084458	.	G	A	4	3	7	0	0	7	0	0
8	15088972	.	T	C	7	0	7	0	2	9	0	0
8	15088981	.	T	C	7	0	7	0	3	10	0	0
8	15090910	.	A	G	2	3	5	0	0	5	0	0
8	15091708	.	C	T	6	4	10	0	0	10	0	0
8	15091727	.	T	A	5	3	8	0	0	8	0	0
8	15094241	.	T	C	8	6	14	0	0	14	0	0
8	15094262	.	C	T	7	5	12	0	0	12	0	0
8	15094525	.	A	G	4	6	10	0	1	11	0	0
8	15094599	.	C	A	0	5	5	0	5	10	0	0
8	15094803	.	C	G	0	0	0	0	1	1	0	0
8	15094809	.	G	A	1	0	1	0	0	1	0	0
8	15100461	.	A	G	2	2	4	0	0	4	0	0
8	15100653	.	T	C	5	0	5	0	7	12	0	0
8	15100731	.	A	G	4	4	8	0	0	8	0	0
8	15162295	.	T	C	2	2	4	0	0	4	0	0
8	15252141	.	A	G	7	4	11	0	0	11	0	0
8	15252250	.	C	G	21	13	34	1	1	36	0	0
8	15252306	.	G	A	2	3	5	0	0	5	0	0
8	15253365	.	C	A	3	1	4	0	0	4	0	0
8	15253384	.	T	C	6	3	9	0	0	9	0	0
8	15253496	.	G	A	9	5	14	0	0	14	0	0
8	15272931	.	C	T	0	1	1	0	0	1	0	0
8	15275665	.	T	C	4	12	16	0	0	16	0	0
8	15275704	.	G	A	4	7	11	0	0	11	0	0
8	15276587	.	T	A	16	14	30	0	0	30	0	0
8	15276588	.	C	G	16	14	30	0	0	30	0	0
8	15276678	.	G	A	4	7	11	0	0	11	0	0
8	15276684	.	G	A	0	6	6	0	4	10	0	0
8	15276944	.	T	G	4	5	9	0	0	9	0	0
8	15281446	.	A	T	1	3	4	0	0	4	0	0
8	15289348	.	G	T	0	1	1	0	0	1	0	0
8	15312985	.	A	G	3	1	4	0	0	4	0	0
8	15479282	.	T	A	1	2	3	0	0	3	0	0
8	15951146	.	C	T	0	3	3	0	3	6	0	0
8	15951185	.	A	G	2	3	5	0	1	6	0	0
8	16054374	.	C	T	19	16	35	0	1	36	0	0
8	16054389	.	T	C	14	14	28	0	0	28	0	0
8	16112107	.	G	A	0	22	22	0	28	50	0	0
8	16112212	.	C	T	34	18	52	0	2	54	0	0
8	16113850	.	C	A	17	13	30	0	1	31	0	0
8	16115682	.	C	T	6	7	13	1	5	21	2	0
8	16259053	.	C	T	1	2	3	0	1	4	0	0
8	16275011	.	G	C	5	4	9	0	1	10	0	0
8	16294511	.	G	A	11	10	21	0	1	22	0	0
8	16406283	.	C	A	8	4	12	0	0	12	0	0
8	16408621	.	A	G	3	4	7	0	0	7	0	0
8	16408914	.	T	A	1	2	3	0	1	4	0	0
8	16411637	.	G	T	0	2	2	0	0	2	0	0
8	16425038	.	C	T	6	13	19	0	1	20	0	0
8	16425079	.	C	T	2	10	12	0	8	20	0	0
8	16425383	.	T	C	14	11	25	0	0	25	0	0
8	16439114	.	G	T	8	6	14	0	0	14	0	0
8	16464296	.	T	A	3	9	12	0	1	13	0	0
8	16464306	.	T	G	5	9	14	0	0	14	0	0
8	16470624	.	T	C	5	3	8	0	0	8	0	0
8	16470703	.	C	A	1	2	3	0	0	3	0	0
8	16471018	.	A	C	3	2	5	0	0	5	0	0
8	16517310	.	C	G	1	6	7	0	1	8	0	0
8	16517553	.	G	A	6	2	8	0	1	9	0	0
8	16517558	.	T	C	5	2	7	0	1	8	0	0
8	16519102	.	T	G	9	9	18	0	0	18	0	0
8	16519560	.	A	G	5	6	11	0	0	11	0	0
8	16519692	.	G	A	13	7	20	0	0	20	0	0
8	16519695	.	G	C	14	7	21	0	0	21	0	0
8	16519782	.	C	T	5	3	8	0	0	8	0	0
8	16524401	.	G	C	3	0	3	0	2	5	0	0
8	16525366	.	T	A	4	2	6	0	0	6	0	0
8	16525417	.	A	G	2	5	7	0	0	7	0	0
8	16525504	.	T	A	3	1	4	0	0	4	0	0
8	16525519	.	A	G	1	0	1	0	0	1	0	0
8	16527060	.	T	C	2	0	2	0	3	5	0	0
8	16527091	.	G	A	2	2	4	0	0	4	0	0
8	16528223	.	A	G	7	8	15	0	1	16	0	0
8	16528390	.	T	G	6	4	10	0	0	10	0	0
8	16528454	.	C	T	0	5	5	0	8	13	0	0
8	16582410	.	A	G	9	9	18	1	0	19	0	0
8	16582417	.	A	G	8	8	16	1	1	18	0	0
8	16582608	.	G	A	20	20	40	0	1	41	0	0
8	16583127	.	C	T	6	19	25	0	1	26	0	0
8	16583142	.	A	C	20	9	29	0	1	30	0	0
8	16583174	.	C	A	20	16	36	0	0	36	0	0
8	16583447	.	C	T	19	16	35	0	1	36	0	0
8	16583528	.	C	T	18	14	32	1	4	40	3	0
8	16583534	.	G	A	13	11	24	1	4	39	10	0
8	16583591	.	C	T	17	10	27	1	2	30	0	0
8	16583648	.	G	A	3	7	10	4	1	15	0	0
8	16584037	.	C	T	1	3	4	0	6	10	0	0
8	16587510	.	T	A	15	11	26	0	1	27	0	0
8	16588157	.	A	G	8	1	9	0	0	9	0	0
8	16588421	.	C	T	12	10	22	0	0	22	0	0
8	16592465	.	G	C	19	15	34	0	1	35	0	0
8	16597215	.	C	T	4	8	12	0	0	12	0	0
8	16597238	.	G	A	4	11	15	0	0	15	0	0
8	16597252	.	G	A	8	14	22	0	0	22	0	0
8	16597424	.	T	C	10	5	15	0	1	16	0	0
8	16597889	.	G	A	7	7	14	0	0	14	0	0
8	16598148	.	C	T	0	2	2	0	3	5	0	0
8	16600671	.	T	C	4	2	6	0	0	6	0	0
8	16602571	.	G	A	3	1	4	0	0	4	0	0
8	16605597	.	A	G	4	3	7	0	0	7	0	0
8	16605615	.	G	A	4	3	7	0	0	7	0	0
8	16608287	.	G	A	1	2	3	0	1	4	0	0
8	16610387	.	G	A	3	2	5	0	1	6	0	0
8	16610585	.	T	C	1	0	1	0	0	1	0	0
8	16615802	.	T	C	3	6	9	0	1	10	0	0
8	16615866	.	T	C	5	5	10	0	1	11	0	0
8	16615867	.	A	G	5	6	11	0	0	11	0	0
8	16615929	.	A	T	13	6	19	0	1	20	0	0
8	16616190	.	C	A	11	9	20	0	0	20	0	0
8	16616899	.	G	A	3	2	5	0	0	5	0	0
8	16625575	.	C	A	4	10	14	0	0	14	0	0
8	16632794	.	G	A	9	3	12	0	2	14	0	0
8	16682943	.	G	A	1	1	2	0	0	2	0	0
8	16685821	.	A	G	1	2	3	0	0	3	0	0
8	16702658	.	G	A	0	2	2	0	1	3	0	0
8	16706195	.	G	A	1	1	2	0	0	2	0	0
8	16729938	.	A	G	9	18	27	0	1	28	0	0
8	16729941	.	G	A	10	18	28	0	1	29	0	0
8	16734037	.	A	T	5	5	10	0	0	10	0	0
8	16734074	.	C	G	5	4	9	0	0	9	0	0
8	16734247	.	C	A	14	14	28	0	0	28	0	0
8	16736489	.	A	T	7	2	9	0	0	9	0	0
8	16738054	.	G	A	10	9	19	0	2	21	0	0
8	16738149	.	G	T	12	11	23	0	0	23	0	0
8	16738481	.	C	T	4	2	6	0	0	6	0	0
8	16740792	.	A	G	4	2	6	0	1	7	0	0
8	16740977	.	C	T	1	1	2	0	0	2	0	0
8	16748538	.	T	C	0	1	1	0	0	1	0	0
8	16755381	.	G	A	11	6	17	0	0	17	0	0
8	16756847	.	G	C	6	3	9	0	0	9	0	0
8	16768992	.	A	G	12	1	13	0	9	22	0	0
8	16769126	.	C	T	7	10	17	0	0	17	0	0
8	16769396	.	T	G	4	5	9	0	0	9	0	0
8	16769641	.	G	A	5	2	7	0	1	8	0	0
8	17055751	.	C	T	21	15	36	0	11	47	0	0
8	17055802	.	C	T	1	25	26	0	21	47	0	0
8	17067268	.	A	T	24	14	38	0	1	39	0	0
8	17079902	.	C	T	7	3	10	0	1	11	0	0
8	17081758	.	C	T	17	15	32	0	1	33	0	0
8	17081782	.	C	T	17	13	30	0	2	32	0	0
8	17081863	.	G	A	4	6	10	0	0	10	0	0
8	17081976	.	C	T	0	1	1	0	0	1	0	0
8	17082927	.	G	A	0	4	4	0	7	11	0	0
8	17084733	.	C	G	6	11	17	0	0	17	0	0
8	17086002	.	C	T	11	15	26	0	2	28	0	0
8	17086043	.	C	T	9	6	15	0	1	16	0	0
8	17146887	.	T	C	4	2	6	0	0	6	0	0
8	17151997	.	A	G	5	3	8	0	0	8	0	0
8	17152057	.	C	A	3	3	6	0	0	6	0	0
8	17152826	.	A	G	1	1	2	0	0	2	0	0
8	17154080	.	A	C	0	0	0	0	1	1	0	0
8	17154406	.	T	C	2	0	2	0	0	2	0	0
8	17163611	.	A	G	7	14	21	0	2	23	0	0
8	17164208	.	G	A	19	26	45	0	0	45	0	0
8	17164302	.	A	G	2	6	8	0	0	8	0	0
8	17177754	.	T	C	0	0	0	0	1	1	0	0
8	17178794	.	A	G	1	3	4	0	0	4	0	0
8	17181187	.	T	C	0	0	0	0	1	1	0	0
8	17181190	.	T	A	0	1	1	0	0	1	0	0
8	17184662	.	A	C	1	2	3	0	0	3	0	0
8	17191921	.	A	G	3	3	6	0	0	6	0	0
8	17192129	.	A	G	4	4	8	0	0	8	0	0
8	17396056	.	G	T	10	11	21	0	2	23	0	0
8	17396186	.	T	G	11	24	35	0	1	36	0	0
8	17396303	.	G	A	12	10	22	0	3	25	0	0
8	17396815	.	T	A	1	3	4	1	0	5	0	0
8	17397780	.	T	C	2	5	7	0	0	7	0	0
8	17397793	.	T	A	2	7	9	0	0	9	0	0
8	17397995	.	A	T	12	8	20	0	1	21	0	0
8	17398113	.	C	T	0	11	11	0	3	14	0	0
8	17398229	.	A	T	2	10	12	0	0	12	0	0
8	17398277	.	G	A	6	3	9	0	0	9	0	0
8	17398712	.	G	A	6	11	17	0	0	17	0	0
8	17398775	.	G	A	12	11	23	0	0	23	0	0
8	17399281	.	A	T	4	6	10	0	1	11	0	0
8	17399586	.	T	A	7	20	27	0	0	27	0	0
8	17404605	.	C	A	0	1	1	0	3	4	0	0
8	17515848	.	G	A	8	8	16	0	0	16	0	0
8	17516304	.	C	T	0	4	4	0	8	12	0	0
8	17534887	.	C	T	2	1	3	0	0	3	0	0
8	17534908	.	T	G	2	0	2	0	2	4	0	0
8	17583923	.	T	G	5	1	6	0	0	6	0	0
8	17609003	.	C	T	2	6	8	0	0	8	0	0
8	17775728	.	A	G	0	0	0	0	3	3	0	0
8	17781076	.	G	A	0	8	8	0	7	15	0	0
8	17781096	.	C	A	6	5	11	0	1	12	0	0
8	17781165	.	A	G	7	3	10	0	1	11	0	0
8	17781468	.	C	G	12	4	16	0	1	17	0	0
8	17781537	.	T	C	7	7	14	0	1	15	0	0
8	17781555	.	C	T	5	5	10	0	0	10	0	0
8	17781576	.	T	C	4	5	9	0	0	9	0	0
8	17783277	.	A	G	1	1	2	0	0	2	0	0
8	17783286	.	G	A	1	2	3	0	0	3	0	0
8	17783674	.	A	G	1	2	3	0	0	3	0	0
8	17783703	.	G	T	4	2	6	0	0	6	0	0
8	17783735	.	G	A	4	7	11	0	0	11	0	0
8	17783775	.	C	T	6	6	12	0	0	12	0	0
8	17784308	.	A	G	9	4	13	0	0	13	0	0
8	17787660	.	G	A	3	2	5	0	0	5	0	0
8	17787833	.	A	T	2	4	6	0	1	7	0	0
8	17788008	.	T	G	2	3	5	0	0	5	0	0
8	17788049	.	C	T	0	0	0	0	2	2	0	0
8	17788302	.	T	C	2	0	2	0	0	2	0	0
8	17790883	.	A	C	2	0	2	0	3	5	0	0
8	17800823	.	A	T	3	3	6	0	0	6	0	0
8	17800833	.	A	G	2	3	5	0	0	5	0	0
8	17801060	.	C	T	3	5	8	0	0	8	0	0
8	17808331	.	A	G	4	5	9	0	1	10	0	0
8	17906181	.	C	A	5	2	7	0	0	7	0	0
8	17911215	.	C	T	1	1	2	0	0	2	0	0
8	17937121	.	C	G	1	0	1	0	0	1	0	0
8	17944398	.	C	T	1	0	1	0	0	1	0	0
8	17983772	.	C	A	5	5	10	0	0	10	0	0
8	17983773	.	C	A	5	5	10	0	0	10	0	0
8	17983867	.	A	C	3	0	3	0	4	7	0	0
8	17983938	.	T	G	1	4	5	0	0	5	0	0
8	17984265	.	T	G	1	2	3	0	0	3	0	0
8	17984266	.	C	G	1	2	3	0	0	3	0	0
8	17984761	.	A	G	3	3	6	0	0	6	0	0
8	17987497	.	C	A	2	5	7	0	0	7	0	0
8	18033113	.	T	C	5	2	7	0	2	9	0	0
8	18035129	.	A	T	9	14	23	0	1	24	0	0
8	18035231	.	T	A	6	15	21	0	3	24	0	0
8	18035290	.	T	C	9	10	19	0	1	20	0	0
8	18035303	.	T	A	12	10	22	0	1	23	0	0
8	18035371	.	T	C	17	8	25	0	1	26	0	0
8	18035428	.	G	A	19	10	29	0	0	29	0	0
8	18035946	.	T	A	8	11	19	0	1	20	0	0
8	18035963	.	T	C	10	10	20	0	0	20	0	0
8	18041793	.	C	T	7	2	9	0	0	9	0	0
8	18041814	.	G	A	2	7	9	0	0	9	0	0
8	18042024	.	C	T	1	2	3	0	0	3	0	0
8	18196462	.	A	G	28	20	48	0	1	49	0	0
8	18206394	.	A	G	0	0	0	0	1	1	0	0
8	18207465	.	C	T	0	0	0	0	1	1	0	0
8	18231160	.	C	T	3	2	5	0	0	5	0	0
8	18242977	.	C	A	0	2	2	0	0	2	0	0
8	18242978	.	A	C	0	2	2	0	0	2	0	0
8	18243871	.	T	C	2	0	2	0	0	2	0	0
8	18356208	.	T	C	2	0	2	0	2	4	0	0
8	18358694	.	T	G	2	6	8	0	0	8	0	0
8	18364066	.	G	A	3	1	4	0	0	4	0	0
8	18365134	.	G	A	0	1	1	0	0	1	0	0
8	18365788	.	C	T	1	1	2	0	0	2	0	0
8	18450469	.	A	C	1	0	1	0	3	4	0	0
8	18510560	.	A	G	1	3	4	0	0	4	0	0
8	18512195	.	G	A	2	1	3	0	0	3	0	0
8	18512273	.	T	C	0	1	1	0	0	1	0	0
8	18514407	.	C	T	1	2	3	0	0	3	0	0
8	18514466	.	C	T	4	2	6	0	1	7	0	0
8	18514476	.	A	G	6	2	8	0	0	8	0	0
8	18514855	.	A	T	9	3	12	0	1	13	0	0
8	18515092	.	G	T	0	1	1	0	0	1	0	0
8	18515137	.	G	A	3	4	7	0	0	7	0	0
8	18515138	.	G	A	3	4	7	0	0	7	0	0
8	18515206	.	T	G	1	2	3	0	0	3	0	0
8	18515256	.	A	G	1	1	2	0	0	2	0	0
8	18515778	.	G	A	2	4	6	0	0	6	0	0
8	18516279	.	A	T	2	2	4	0	1	5	0	0
8	18517772	.	A	G	2	2	4	0	0	4	0	0
8	18517971	.	A	G	1	3	4	0	0	4	0	0
8	18519593	.	T	C	2	2	4	0	0	4	0	0
8	18550469	.	T	A	0	1	1	0	0	1	0	0
8	18554651	.	T	C	4	4	8	0	0	8	0	0
8	18554720	.	G	T	7	6	13	0	1	14	0	0
8	18554731	.	T	A	8	8	16	0	0	16	0	0
8	18554825	.	T	C	6	11	17	0	0	17	0	0
8	18554826	.	G	A	6	9	15	0	2	17	0	0
8	18555104	.	A	G	12	0	12	0	9	21	0	0
8	18562153	.	A	G	4	5	9	0	0	9	0	0
8	18562283	.	G	A	1	15	16	0	12	28	0	0
8	18562317	.	C	T	11	13	24	0	1	25	0	0
8	18562570	.	C	T	7	4	11	0	1	12	0	0
8	18562576	.	G	A	9	3	12	0	0	12	0	0
8	18566970	.	C	A	19	12	31	0	1	32	0	0
8	18567020	.	G	A	11	16	27	0	2	29	0	0
8	18567260	.	A	G	7	15	22	0	2	24	0	0
8	18567291	.	A	C	5	6	11	1	1	13	0	0
8	18567342	.	G	A	9	15	24	0	1	25	0	0
8	18568022	.	G	C	9	9	18	0	0	18	0	0
8	18568121	.	C	T	9	5	14	0	2	16	0	0
8	18568167	.	G	T	13	2	15	0	0	15	0	0
8	18568189	.	C	A	18	5	23	0	0	23	0	0
8	18568264	.	T	A	12	8	20	0	1	21	0	0
8	18568350	.	C	G	11	6	17	0	0	17	0	0
8	18568468	.	A	T	5	5	10	0	0	10	0	0
8	18568473	.	T	G	6	5	11	0	0	11	0	0
8	18568527	.	C	T	4	0	4	0	0	4	0	0
8	18568571	.	T	G	6	9	15	0	1	16	0	0
8	18568677	.	C	T	0	10	10	0	14	24	0	0
8	18568687	.	A	G	14	11	25	0	0	25	0	0
8	18568739	.	T	A	15	9	24	0	2	26	0	0
8	18568740	.	C	A	0	9	9	0	17	26	0	0
8	18568800	.	A	G	8	5	13	0	0	13	0	0
8	18568812	.	C	G	8	4	12	0	0	12	0	0
8	18569605	.	A	T	10	3	13	0	1	14	0	0
8	18569763	.	C	G	0	8	8	0	4	13	1	0
8	18569767	.	A	T	4	9	13	0	2	15	0	0
8	18569856	.	T	C	10	5	15	0	0	15	0	0
8	18569871	.	G	A	8	6	14	0	0	14	0	0
8	18570116	.	A	T	5	12	17	0	0	17	0	0
8	18570239	.	A	G	6	7	13	0	0	13	0	0
8	18582554	.	C	T	1	1	2	0	0	2	0	0
8	18582626	.	G	A	9	6	15	0	0	15	0	0
8	18582710	.	C	A	9	5	14	0	1	15	0	0
8	18582789	.	C	G	4	4	8	0	0	8	0	0
8	18582857	.	T	C	5	8	13	0	0	13	0	0
8	18589779	.	C	T	2	4	6	0	0	6	0	0
8	18592714	.	T	C	4	5	9	0	0	9	0	0
8	18593245	.	G	A	1	2	3	0	1	4	0	0
8	18593388	.	T	C	2	4	6	0	3	9	0	0
8	18593405	.	G	A	4	4	8	0	1	9	0	0
8	18598351	.	A	T	7	10	17	0	0	17	0	0
8	18598391	.	T	A	8	7	15	0	2	17	0	0
8	18598533	.	G	A	3	5	8	0	0	8	0	0
8	18598544	.	T	C	2	5	7	0	1	8	0	0
8	18598590	.	T	G	7	0	7	0	6	13	0	0
8	18598593	.	C	G	7	6	13	0	0	13	0	0
8	18598782	.	T	C	10	8	18	0	1	19	0	0
8	18598915	.	A	G	12	5	17	0	2	19	0	0
8	18598920	.	G	C	11	7	18	0	3	21	0	0
8	18598997	.	G	T	15	7	22	0	1	23	0	0
8	18599014	.	G	T	1	3	4	0	15	19	0	0
8	18599088	.	C	A	13	7	20	0	1	21	0	0
8	18599123	.	T	C	7	9	16	0	0	16	0	0
8	18599147	.	A	G	5	14	19	0	2	21	0	0
8	18601873	.	T	C	2	0	2	0	4	6	0	0
8	18611625	.	T	C	3	0	3	0	2	5	0	0
8	18613661	.	A	T	8	7	15	0	1	16	0	0
8	18613763	.	C	T	5	5	10	0	0	10	0	0
8	18613770	.	A	C	5	3	8	0	0	8	0	0
8	18618075	.	G	A	2	2	4	0	0	4	0	0
8	18618804	.	G	A	0	4	4	0	5	9	0	0
8	18633221	.	C	T	0	2	2	0	0	2	0	0
8	18635266	.	G	A	5	5	10	0	0	10	0	0
8	18635278	.	T	C	4	6	10	0	0	10	0	0
8	18640339	.	T	C	5	7	12	0	0	12	0	0
8	18640342	.	T	C	5	9	14	0	0	14	0	0
8	18641712	.	T	C	3	5	8	0	0	8	0	0
8	18646867	.	T	G	9	5	14	0	0	14	0	0
8	18646894	.	C	T	5	10	15	0	0	15	0	0
8	18647252	.	A	G	6	9	15	0	0	15	0	0
8	18647298	.	G	A	0	5	5	0	0	5	0	0
8	18647357	.	G	T	1	6	7	0	0	7	0	0
8	18836881	.	T	C	1	2	3	0	0	3	0	0
8	18837494	.	C	A	6	5	11	0	1	12	0	0
8	18837533	.	A	G	0	2	2	0	0	2	0	0
8	18840561	.	T	A	4	7	11	0	0	11	0	0
8	18842586	.	T	C	2	2	4	0	0	4	0	0
8	18842587	.	A	T	2	2	4	0	0	4	0	0
8	18842799	.	G	A	2	1	3	0	0	3	0	0
8	18853540	.	T	C	4	2	6	0	1	7	0	0
8	18885207	.	G	A	8	8	16	0	0	16	0	0
8	18885507	.	G	A	4	7	11	0	1	12	0	0
8	18888742	.	G	A	1	3	4	0	0	4	0	0
8	18888748	.	G	A	1	3	4	0	0	4	0	0
8	18890966	.	A	G	8	3	11	0	0	11	0	0
8	18893166	.	G	T	1	0	1	0	0	1	0	0
8	18936643	.	A	C	2	5	7	0	0	7	0	0
8	18936665	.	C	T	3	5	8	0	1	9	0	0
8	18971535	.	C	T	0	1	1	0	0	1	0	0
8	18977632	.	C	T	3	4	7	0	0	7	0	0
8	18977684	.	A	C	4	0	4	0	5	9	0	0
8	18977710	.	T	G	3	4	7	0	0	7	0	0
8	18982386	.	A	C	4	0	4	0	2	6	0	0
8	19232588	.	C	A	0	2	2	0	0	2	0	0
8	19232618	.	A	G	0	1	1	0	0	1	0	0
8	19253718	.	G	A	7	5	12	0	0	12	0	0
8	19258719	.	C	T	0	1	1	0	1	2	0	0
8	19258761	.	G	A	8	4	12	0	0	12	0	0
8	19275338	.	T	C	3	2	5	0	0	5	0	0
8	19296306	.	G	A	0	1	1	0	0	1	0	0
8	19401508	.	C	T	2	12	14	0	23	37	0	0
8	19472131	.	C	G	10	6	16	0	0	16	0	0
8	19476613	.	C	T	6	5	11	0	0	11	0	0
8	19477798	.	C	T	0	1	1	0	1	2	0	0
8	19481921	.	G	A	3	2	5	0	0	5	0	0
8	19481987	.	G	A	0	4	4	0	0	4	0	0
8	19499729	.	G	A	3	3	6	0	0	6	0	0
8	19499929	.	A	G	1	4	5	0	0	5	0	0
8	19504059	.	A	G	9	10	19	0	1	20	0	0
8	19504081	.	T	A	11	11	22	0	2	24	0	0
8	19511480	.	G	A	1	11	12	0	10	22	0	0
8	19511673	.	C	G	10	9	19	0	0	19	0	0
8	19511674	.	C	A	9	9	18	0	1	19	0	0
8	19511770	.	A	C	11	16	27	0	1	30	2	0
8	19512186	.	A	G	11	0	11	0	8	19	0	0
8	19512187	.	C	A	9	8	17	0	1	19	1	0
8	19632538	.	C	T	2	0	2	0	0	2	0	0
8	19642764	.	A	C	1	0	1	0	4	5	0	0
8	19675481	.	C	A	3	2	5	0	1	6	0	0
8	19676049	.	A	C	5	2	7	0	0	7	0	0
8	19904047	.	A	T	1	2	3	0	0	3	0	0
8	19904055	.	T	C	1	2	3	0	0	3	0	0
8	19984806	.	C	A	5	6	11	0	0	11	0	0
8	19997914	.	G	A	2	2	4	0	0	4	0	0
8	19997918	.	A	G	2	2	4	0	0	4	0	0
8	19998025	.	C	T	2	2	4	0	0	4	0	0
8	19998192	.	G	A	2	2	4	0	0	4	0	0
8	20053600	.	G	A	3	1	4	0	0	4	0	0
8	20059115	.	T	C	0	1	1	0	0	1	0	0
8	20059302	.	A	C	5	8	13	0	0	13	0	0
8	20059563	.	C	A	3	5	8	0	0	8	0	0
8	20059860	.	T	A	1	3	4	0	0	4	0	0
8	20062344	.	C	T	2	4	6	0	0	6	0	0
8	20065519	.	T	G	2	0	2	0	5	7	0	0
8	20068125	.	T	C	4	5	9	0	0	9	0	0
8	20073257	.	C	T	2	3	5	0	0	5	0	0
8	20073872	.	G	C	3	3	6	0	0	6	0	0
8	20074460	.	T	C	3	2	5	0	0	5	0	0
8	20075796	.	A	G	3	2	5	0	1	6	0	0
8	20075808	.	T	G	3	3	6	0	0	6	0	0
8	20080141	.	A	G	2	0	2	0	0	2	0	0
8	20106868	.	C	G	0	0	0	0	1	1	0	0
8	20157840	.	A	G	10	7	17	0	0	17	0	0
8	20170561	.	C	T	5	2	7	0	0	7	0	0
8	20170672	.	T	C	6	7	13	0	1	14	0	0
8	20170795	.	T	C	1	3	4	0	0	4	0	0
8	20175907	.	A	C	9	4	13	0	1	14	0	0
8	20177126	.	C	G	2	0	2	0	4	6	0	0
8	20183420	.	T	C	9	12	21	0	0	21	0	0
8	20184545	.	A	G	6	4	10	0	0	10	0	0
8	20184698	.	T	C	12	4	16	0	1	17	0	0
8	20185652	.	A	G	5	0	5	0	6	11	0	0
8	20185664	.	A	G	9	0	9	0	5	14	0	0
8	20185694	.	C	T	15	8	23	0	1	24	0	0
8	20185718	.	G	T	18	9	27	0	0	27	0	0
8	20185793	.	G	A	0	8	8	0	10	18	0	0
8	20185796	.	G	C	9	8	17	0	1	18	0	0
8	20187793	.	T	C	3	1	4	0	0	4	0	0
8	20187829	.	A	T	14	7	21	0	0	21	0	0
8	20187835	.	A	G	15	0	15	0	8	23	0	0
8	20190489	.	A	G	11	8	19	0	0	19	0	0
8	20190764	.	G	C	7	11	18	0	0	18	0	0
8	20190790	.	T	C	10	20	30	0	0	30	0	0
8	20190809	.	G	C	8	22	30	0	0	30	0	0
8	20190876	.	A	G	10	13	23	0	2	25	0	0
8	20190967	.	G	A	0	13	13	0	13	26	0	0
8	20191067	.	T	C	9	11	20	0	0	20	0	0
8	20191286	.	A	G	17	1	18	0	12	30	0	0
8	20191301	.	C	A	13	9	22	0	7	29	0	0
8	20191354	.	A	G	8	15	23	0	0	23	0	0
8	20191561	.	A	G	12	20	32	0	4	36	0	0
8	20191651	.	T	C	20	13	33	0	0	33	0	0
8	20191965	.	T	A	19	17	36	0	2	38	0	0
8	20191999	.	C	T	12	10	22	0	0	22	0	0
8	20192046	.	A	G	5	1	6	0	10	16	0	0
8	20192049	.	G	A	5	13	18	0	0	18	0	0
8	20194647	.	T	C	7	6	13	0	1	14	0	0
8	20195674	.	T	G	1	3	4	0	0	4	0	0
8	20195688	.	A	G	1	3	4	0	0	4	0	0
8	20197237	.	A	G	5	2	7	0	0	7	0	0
8	20197240	.	A	T	5	2	7	0	0	7	0	0
8	20207046	.	A	G	2	2	4	0	1	5	0	0
8	20298465	.	C	A	0	2	2	0	2	4	0	0
8	20298639	.	G	A	2	4	6	0	0	6	0	0
8	20305295	.	G	A	1	0	1	0	1	2	0	0
8	20440330	.	C	A	4	3	7	0	0	7	0	0
8	20440699	.	G	A	3	3	6	0	0	6	0	0
8	20443562	.	C	T	1	0	1	0	0	1	0	0
8	20448181	.	G	A	6	5	11	0	0	11	0	0
8	20449016	.	G	A	0	10	10	0	5	15	0	0
8	20449478	.	G	A	0	9	9	0	11	20	0	0
8	20449590	.	G	A	13	5	18	0	1	19	0	0
8	20449614	.	A	G	15	8	23	0	2	25	0	0
8	20449847	.	A	G	7	5	12	0	0	12	0	0
8	20449851	.	T	A	7	5	12	0	0	12	0	0
8	20450168	.	C	T	8	20	28	0	0	28	0	0
8	20450249	.	T	A	8	11	19	0	1	20	0	0
8	20458303	.	C	G	2	3	5	0	0	5	0	0
8	20460509	.	A	G	1	0	1	0	2	3	0	0
8	20471387	.	G	A	3	4	7	0	0	7	0	0
8	20471480	.	C	T	2	5	7	0	1	8	0	0
8	20503838	.	G	A	4	3	7	0	1	8	0	0
8	20559103	.	T	C	5	13	18	0	1	19	0	0
8	20559127	.	A	G	11	3	14	0	2	16	0	0
8	20559169	.	A	G	9	0	9	0	16	25	0	0
8	20559202	.	A	G	11	0	11	0	14	25	0	0
8	20559211	.	T	A	9	15	24	0	1	25	0	0
8	20559270	.	A	G	13	21	34	0	1	35	0	0
8	20559373	.	G	A	15	11	26	0	1	27	0	0
8	20559682	.	G	A	15	17	32	0	1	33	0	0
8	20559683	.	A	G	11	18	29	0	4	33	0	0
8	20782390	.	G	T	0	0	0	0	2	2	0	0
8	20846257	.	T	A	3	3	6	0	0	6	0	0
8	20846303	.	G	T	4	6	10	0	0	10	0	0
8	20846336	.	C	T	7	5	12	0	1	13	0	0
8	20846615	.	C	G	2	4	6	0	0	6	0	0
8	20846625	.	C	G	2	4	6	0	0	6	0	0
8	20850246	.	T	A	2	0	2	0	0	2	0	0
8	20850254	.	T	A	3	1	4	0	0	4	0	0
8	20853149	.	A	G	13	10	23	0	1	24	0	0
8	20853314	.	A	G	11	13	24	0	0	24	0	0
8	20853803	.	G	A	5	7	12	0	2	14	0	0
8	20853900	.	G	A	6	7	13	0	0	13	0	0
8	20853951	.	G	C	1	7	8	0	0	8	0	0
8	20853987	.	C	G	0	4	4	0	0	4	0	0
8	20856365	.	T	G	4	4	8	0	1	9	0	0
8	20856383	.	G	A	6	7	13	0	0	13	0	0
8	20856505	.	A	G	12	11	23	0	0	23	0	0
8	20856646	.	C	A	2	4	6	0	0	6	0	0
8	20861582	.	T	C	1	2	3	0	1	4	0	0
8	20861672	.	T	C	1	2	3	0	0	3	0	0
8	20861801	.	G	A	4	5	9	0	0	9	0	0
8	20862385	.	C	A	1	3	4	0	0	4	0	0
8	20863117	.	A	G	8	8	16	0	1	17	0	0
8	20865545	.	A	C	4	6	10	0	1	11	0	0
8	20868122	.	G	A	4	8	12	0	0	12	0	0
8	20870439	.	A	T	0	4	4	0	1	5	0	0
8	20870639	.	G	C	0	1	1	0	0	1	0	0
8	20871596	.	A	G	0	1	1	0	0	1	0	0
8	20873011	.	G	A	0	4	4	0	2	6	0	0
8	20873113	.	C	T	11	16	27	0	0	27	0	0
8	20873116	.	T	C	16	11	27	0	0	27	0	0
8	20873183	.	C	T	3	5	8	0	0	8	0	0
8	20876466	.	C	T	10	5	15	0	1	16	0	0
8	21050439	.	G	T	0	2	2	0	0	2	0	0
8	21071433	.	G	A	1	1	2	0	0	2	0	0
8	21071672	.	T	C	2	0	2	0	3	5	0	0
8	21071724	.	C	T	3	1	4	0	0	4	0	0
8	21095506	.	G	A	6	11	17	0	1	18	0	0
8	21100075	.	G	A	2	5	7	0	0	7	0	0
8	21100096	.	A	G	2	5	7	0	0	7	0	0
8	21100278	.	T	A	3	1	4	0	0	4	0	0
8	21100290	.	G	A	3	3	6	0	0	6	0	0
8	21101847	.	G	A	7	3	10	0	0	10	0	0
8	21104787	.	C	T	2	3	5	0	0	5	0	0
8	21104793	.	T	A	1	4	5	0	0	5	0	0
8	21104837	.	G	A	2	2	4	0	0	4	0	0
8	21105045	.	G	A	3	4	7	0	0	7	0	0
8	21105504	.	G	A	6	8	14	0	0	14	0	0
8	21123525	.	A	T	1	1	2	0	0	2	0	0
8	21130028	.	A	G	4	8	12	0	1	13	0	0
8	21130049	.	C	T	8	6	14	0	1	15	0	0
8	21130746	.	T	C	6	4	10	0	0	10	0	0
8	21130849	.	G	A	3	2	5	0	0	5	0	0
8	21130910	.	C	T	3	3	6	0	0	6	0	0
8	21131089	.	A	T	1	3	4	0	0	4	0	0
8	21131310	.	C	T	2	3	5	0	1	6	0	0
8	21131373	.	C	A	3	3	6	0	1	7	0	0
8	21131532	.	T	C	5	4	9	0	2	11	0	0
8	21131702	.	A	G	2	4	6	0	0	6	0	0
8	21131926	.	A	G	6	5	11	0	0	11	0	0
8	21131996	.	A	G	3	0	3	0	4	7	0	0
8	21132039	.	A	T	2	2	4	0	0	4	0	0
8	21132200	.	T	G	3	5	8	0	0	8	0	0
8	21132300	.	C	T	8	11	19	0	1	20	0	0
8	21132318	.	G	A	7	7	14	0	3	17	0	0
8	21132445	.	A	C	10	7	17	0	1	18	0	0
8	21132538	.	C	G	19	10	29	0	0	29	0	0
8	21132696	.	C	T	15	8	23	0	0	23	0	0
8	21132956	.	G	A	4	5	9	0	0	9	0	0
8	21134088	.	G	T	15	5	20	0	0	20	0	0
8	21135606	.	T	C	3	3	6	0	1	7	0	0
8	21137675	.	G	A	6	4	10	0	0	10	0	0
8	21137733	.	T	C	4	5	9	0	1	10	0	0
8	21139989	.	G	A	9	5	14	0	0	14	0	0
8	21140121	.	G	C	5	0	5	0	5	10	0	0
8	21140175	.	G	T	2	7	9	0	0	9	0	0
8	21140181	.	G	T	2	7	9	0	0	9	0	0
8	21140313	.	A	C	3	0	3	0	4	7	0	0
8	21140369	.	A	G	2	5	7	0	0	7	0	0
8	21141088	.	G	A	3	2	5	0	0	5	0	0
8	21146789	.	C	T	1	2	3	0	0	3	0	0
8	21146840	.	T	G	1	2	3	0	0	3	0	0
8	21152728	.	C	G	2	1	3	0	0	3	0	0
8	21152737	.	C	A	2	1	3	0	0	3	0	0
8	21155392	.	T	G	0	2	2	0	0	2	0	0
8	21155871	.	T	C	1	3	4	0	0	4	0	0
8	21155937	.	T	G	8	4	12	0	2	14	0	0
8	21159196	.	A	G	8	6	14	0	1	15	0	0
8	21159288	.	A	G	8	1	9	0	0	9	0	0
8	21162191	.	C	T	9	12	21	0	1	22	0	0
8	21162209	.	T	C	15	8	23	0	0	23	0	0
8	21225172	.	A	G	8	9	17	0	1	18	0	0
8	21229867	.	T	C	2	1	3	0	0	3	0	0
8	21239835	.	A	C	9	4	13	0	1	14	0	0
8	21240124	.	T	C	9	6	15	0	0	15	0	0
8	21241111	.	T	G	8	0	8	0	7	15	0	0
8	21241122	.	T	C	8	5	13	0	0	13	0	0
8	21247280	.	G	A	4	5	9	0	0	9	0	0
8	21250183	.	T	A	8	11	19	0	0	19	0	0
8	21250458	.	C	A	3	6	9	0	0	9	0	0
8	21250485	.	C	A	5	7	12	0	1	13	0	0
8	21250694	.	A	G	16	0	16	0	11	27	0	0
8	21250709	.	C	A	14	16	30	0	0	30	0	0
8	21250982	.	G	A	8	9	17	0	0	17	0	0
8	21250988	.	C	T	10	9	19	0	0	19	0	0
8	21251171	.	C	G	17	26	43	0	0	43	0	0
8	21251172	.	C	T	15	23	38	0	5	43	0	0
8	21251241	.	G	A	26	19	45	0	1	46	0	0
8	21251325	.	C	A	10	31	41	0	0	41	0	0
8	21251732	.	C	T	12	11	23	0	2	25	0	0
8	21251820	.	A	T	15	12	27	0	2	29	0	0
8	21251856	.	G	A	16	11	27	0	0	27	0	0
8	21251993	.	A	C	7	7	14	0	0	14	0	0
8	21252042	.	G	T	10	5	15	0	1	16	0	0
8	21252163	.	A	G	25	22	47	0	1	48	0	0
8	21252472	.	C	G	13	28	41	0	0	41	0	0
8	21265272	.	G	A	9	4	13	0	0	13	0	0
8	21265688	.	G	T	4	3	7	0	0	7	0	0
8	21265728	.	C	G	1	5	6	0	0	6	0	0
8	21265892	.	C	A	2	2	4	0	0	4	0	0
8	21344235	.	C	T	1	1	2	0	0	2	0	0
8	21344241	.	T	C	1	1	2	0	0	2	0	0
8	21352676	.	T	C	1	2	3	0	0	3	0	0
8	21360211	.	C	T	2	2	4	0	0	4	0	0
8	21365130	.	A	C	4	3	7	0	0	7	0	0
8	21368033	.	A	T	0	3	3	0	1	4	0	0
8	21368351	.	A	G	5	2	7	0	0	7	0	0
8	21408468	.	G	A	0	3	3	0	1	4	0	0
8	21588321	.	C	T	3	2	5	0	0	5	0	0
8	21629800	.	T	G	11	0	11	0	13	24	0	0
8	21664443	.	C	T	5	10	15	0	1	16	0	0
8	21664464	.	C	T	5	5	10	0	0	10	0	0
8	21671568	.	G	A	0	9	9	0	5	14	0	0
8	21671593	.	A	T	3	8	11	0	1	12	0	0
8	21671769	.	G	A	7	6	13	0	0	13	0	0
8	21672280	.	T	A	1	5	6	0	2	8	0	0
8	21672329	.	T	A	7	7	14	0	0	14	0	0
8	21672526	.	C	A	4	3	7	0	0	7	0	0
8	21672637	.	A	T	6	5	11	0	0	11	0	0
8	21672688	.	T	G	5	8	13	0	1	14	0	0
8	21672758	.	A	T	0	5	5	0	0	5	0	0
8	21672840	.	A	G	3	4	7	0	0	7	0	0
8	21673091	.	T	C	8	3	11	0	1	12	0	0
8	21673629	.	T	G	2	8	10	0	0	10	0	0
8	21673650	.	G	T	4	7	11	0	0	11	0	0
8	21673666	.	G	A	5	5	10	0	2	12	0	0
8	21673765	.	C	T	12	5	17	0	0	17	0	0
8	21673813	.	C	T	8	8	16	0	1	17	0	0
8	21673880	.	A	C	9	4	13	0	0	13	0	0
8	21673886	.	A	G	11	0	11	0	2	13	0	0
8	21674252	.	A	G	2	8	10	0	0	10	0	0
8	21674359	.	A	T	3	8	11	0	0	11	0	0
8	21674662	.	T	C	2	2	4	0	0	4	0	0
8	21674841	.	A	G	9	0	9	0	10	19	0	0
8	21675000	.	G	A	4	12	16	0	1	17	0	0
8	21675004	.	G	A	12	3	15	0	0	15	0	0
8	21675043	.	G	C	3	14	17	0	1	18	0	0
8	21675054	.	A	G	15	0	15	0	0	15	0	0
8	21675200	.	A	G	7	5	12	0	1	13	0	0
8	21675208	.	T	C	7	7	14	0	0	14	0	0
8	21675551	.	A	G	5	15	20	0	1	21	0	0
8	21675575	.	T	C	12	4	16	0	0	16	0	0
8	21675608	.	G	C	8	6	14	0	0	14	0	0
8	21675695	.	G	T	0	8	8	0	4	12	0	0
8	21675698	.	G	A	0	8	8	0	5	13	0	0
8	21675787	.	T	A	3	2	5	0	0	5	0	0
8	21675882	.	A	G	4	6	10	0	1	11	0	0
8	21978302	.	A	C	5	2	7	0	0	7	0	0
8	21978306	.	G	A	5	2	7	0	0	7	0	0
8	22011057	.	A	G	1	2	3	0	0	3	0	0
8	22014523	.	T	A	1	3	4	0	0	4	0	0
8	22277274	.	A	T	4	3	7	0	0	7	0	0
8	22278411	.	T	C	1	2	3	0	0	3	0	0
8	22278432	.	C	T	3	2	5	0	0	5	0	0
8	22279967	.	T	C	6	4	10	0	1	11	0	0
8	22284206	.	G	T	9	4	13	0	0	13	0	0
8	22284262	.	C	T	4	5	9	0	1	10	0	0
8	22284306	.	C	T	4	4	8	0	1	9	0	0
8	22284509	.	T	C	3	13	16	0	0	16	0	0
8	22284570	.	T	G	10	10	20	0	1	21	0	0
8	22286820	.	G	A	9	13	22	0	1	23	0	0
8	22287063	.	A	C	9	0	9	0	10	19	0	0
8	22287163	.	A	G	6	5	11	0	0	11	0	0
8	22298241	.	A	C	2	1	3	0	0	3	0	0
8	22298242	.	G	T	2	1	3	0	0	3	0	0
8	22301156	.	T	C	3	1	4	0	1	5	0	0
8	22303766	.	A	G	0	2	2	0	0	2	0	0
8	22303922	.	A	T	1	2	3	0	0	3	0	0
8	22317465	.	T	C	1	1	2	0	0	2	0	0
8	22319173	.	G	A	1	3	4	0	0	4	0	0
8	22319331	.	T	G	0	1	1	0	0	1	0	0
8	22321160	.	T	C	4	2	6	0	0	6	0	0
8	22321163	.	T	C	4	2	6	0	0	6	0	0
8	22321217	.	A	T	1	2	3	0	0	3	0	0
8	22321232	.	C	T	0	2	2	0	0	2	0	0
8	22327353	.	G	A	4	5	9	0	1	10	0	0
8	22327770	.	C	T	1	5	6	0	0	6	0	0
8	22329434	.	A	G	3	9	12	0	2	14	0	0
8	22329678	.	T	C	0	1	1	0	0	1	0	0
8	22335414	.	A	G	3	2	5	0	0	5	0	0
8	22335420	.	T	C	3	1	4	0	0	5	1	0
8	22337301	.	T	C	1	2	3	0	0	3	0	0
8	22337337	.	G	A	0	5	5	0	6	11	0	0
8	22337436	.	T	C	11	5	16	0	1	17	0	0
8	22345747	.	A	C	8	1	9	0	0	9	0	0
8	22346502	.	C	T	2	1	3	0	0	3	0	0
8	22346508	.	T	C	2	1	3	0	0	3	0	0
8	22500274	.	C	T	0	5	5	0	3	8	0	0
8	22500307	.	A	C	4	0	4	0	7	11	0	0
8	22500406	.	A	T	4	5	9	0	1	10	0	0
8	22500436	.	G	A	8	3	11	0	0	11	0	0
8	22500543	.	T	C	3	0	3	0	13	16	0	0
8	22502731	.	C	T	3	0	3	0	0	3	0	0
8	22503469	.	G	C	2	4	6	0	0	6	0	0
8	22503709	.	T	A	3	6	9	0	0	9	0	0
8	22504329	.	C	G	6	4	10	0	1	11	0	0
8	22504337	.	A	C	5	4	9	0	1	10	0	0
8	22511045	.	G	A	1	4	5	0	0	5	0	0
8	22511375	.	C	T	6	6	12	0	0	12	0	0
8	22511471	.	C	T	3	5	8	0	0	8	0	0
8	22511654	.	C	T	0	3	3	0	4	7	0	0
8	22512539	.	T	A	0	0	0	0	1	1	0	0
8	22512567	.	C	T	0	1	1	0	0	1	0	0
8	22514226	.	A	C	4	3	7	0	0	7	0	0
8	22514227	.	C	T	4	3	7	0	0	7	0	0
8	22521792	.	G	C	5	7	12	0	1	13	0	0
8	22522136	.	A	G	16	16	32	0	1	33	0	0
8	22522397	.	G	A	4	6	10	0	0	10	0	0
8	22522688	.	G	A	13	11	24	0	4	28	0	0
8	22522699	.	C	G	0	7	7	0	19	28	2	0
8	22522742	.	T	C	15	14	29	0	0	29	0	0
8	22522913	.	T	A	13	15	28	0	1	29	0	0
8	22523118	.	G	A	17	17	34	0	0	34	0	0
8	22524820	.	C	T	8	8	16	0	0	16	0	0
8	22525773	.	C	T	0	11	11	0	9	20	0	0
8	22525978	.	C	T	21	9	30	0	0	30	0	0
8	22526355	.	T	G	5	5	10	0	1	11	0	0
8	22530423	.	T	C	10	10	20	0	0	20	0	0
8	22530480	.	G	A	8	6	14	0	0	14	0	0
8	22531978	.	G	A	2	2	4	0	0	4	0	0
8	22533535	.	C	T	8	9	17	0	0	17	0	0
8	22536031	.	C	T	2	1	3	0	0	3	0	0
8	22551311	.	G	A	4	1	5	0	0	5	0	0
8	22554321	.	C	G	3	3	6	0	0	6	0	0
8	22556630	.	A	G	1	3	4	0	0	4	0	0
8	22558582	.	G	A	1	4	5	0	0	5	0	0
8	22558686	.	T	A	3	4	7	0	0	7	0	0
8	22607125	.	T	C	0	2	2	0	0	2	0	0
8	22612068	.	C	A	9	5	14	0	1	15	0	0
8	22612069	.	C	A	10	5	15	0	0	15	0	0
8	22612258	.	G	A	7	5	12	0	0	12	0	0
8	22612608	.	T	C	8	7	15	0	1	16	0	0
8	22612712	.	C	T	5	2	7	0	1	8	0	0
8	22612869	.	C	A	1	10	11	0	1	12	0	0
8	22612977	.	T	A	5	4	9	0	0	9	0	0
8	22612979	.	A	T	5	4	9	0	0	9	0	0
8	22613051	.	A	G	4	0	4	0	4	8	0	0
8	22613062	.	T	G	5	4	9	0	0	9	0	0
8	22619212	.	T	C	14	1	15	0	15	30	0	0
8	22619443	.	G	A	18	26	44	0	2	46	0	0
8	22622733	.	A	T	3	5	8	0	0	8	0	0
8	22627917	.	A	C	9	2	11	0	0	11	0	0
8	22630366	.	A	G	3	8	11	0	1	12	0	0
8	22631775	.	T	C	7	9	16	0	0	16	0	0
8	22632687	.	T	A	3	2	5	0	0	5	0	0
8	22635807	.	C	T	0	3	3	0	2	5	0	0
8	22637674	.	G	A	11	2	13	0	0	13	0	0
8	22637699	.	T	G	7	6	13	0	0	13	0	0
8	22660118	.	A	T	1	5	6	0	0	6	0	0
8	22762173	.	C	T	3	5	8	0	0	8	0	0
8	22762194	.	A	C	2	5	7	0	1	9	1	0
8	22762380	.	C	G	1	2	3	0	0	3	0	0
8	22788971	.	A	G	7	6	13	0	0	13	0	0
8	22788994	.	C	T	8	5	13	0	1	14	0	0
8	22789112	.	A	G	6	5	11	0	1	12	0	0
8	22826868	.	T	C	3	1	4	0	2	6	0	0
8	22837646	.	G	A	1	3	4	0	0	4	0	0
8	22851725	.	A	C	2	2	4	0	0	4	0	0
8	22851726	.	T	C	2	2	4	0	0	4	0	0
8	22922731	.	C	T	3	2	5	0	0	5	0	0
8	22922845	.	A	G	2	2	4	0	0	4	0	0
8	22922887	.	C	T	1	1	2	0	0	2	0	0
8	22926258	.	A	C	1	2	3	0	0	3	0	0
8	22945572	.	T	C	33	26	59	0	2	61	0	0
8	22947209	.	C	T	27	34	61	0	9	70	0	0
8	22951053	.	G	A	23	26	49	0	4	53	0	0
8	22951054	.	C	G	23	29	52	0	1	53	0	0
8	22951203	.	A	T	33	23	56	0	2	58	0	0
8	22951364	.	A	T	22	8	30	0	2	32	0	0
8	22951730	.	G	A	28	22	50	0	2	52	0	0
8	22951847	.	A	T	29	25	54	0	0	54	0	0
8	22951919	.	C	T	29	26	55	0	1	56	0	0
8	22951979	.	T	G	35	20	55	0	0	55	0	0
8	22952330	.	A	T	36	31	67	0	1	69	1	0
8	22952758	.	G	A	0	2	2	0	5	7	0	0
8	22953314	.	C	T	1	3	4	0	0	4	0	0
8	22977306	.	A	G	4	2	6	0	0	6	0	0
8	23041461	.	C	T	0	11	11	0	9	20	0	0
8	23044478	.	G	T	7	13	20	0	1	21	0	0
8	23044554	.	T	C	13	0	13	0	8	21	0	0
8	23044620	.	G	A	12	10	22	0	1	23	0	0
8	23105304	.	T	A	4	11	15	0	0	15	0	0
8	23105429	.	A	G	8	5	13	0	0	13	0	0
8	23109308	.	C	T	7	5	12	0	0	12	0	0
8	23109443	.	G	A	5	6	11	0	2	13	0	0
8	23109554	.	C	A	6	11	17	0	0	17	0	0
8	23119100	.	T	A	10	10	20	0	0	20	0	0
8	23122265	.	T	C	1	2	3	0	0	3	0	0
8	23143137	.	G	A	1	2	3	0	1	4	0	0
8	23143144	.	G	A	2	1	3	0	1	4	0	0
8	23147682	.	C	G	4	6	10	0	2	12	0	0
8	23149956	.	G	A	0	6	6	0	11	17	0	0
8	23151740	.	A	T	4	2	6	0	0	6	0	0
8	23165835	.	G	T	0	15	15	0	7	22	0	0
8	23175234	.	C	T	3	9	12	0	0	12	0	0
8	23177298	.	C	T	17	21	38	0	5	43	0	0
8	23179659	.	G	T	18	19	37	0	1	38	0	0
8	23179702	.	T	G	23	21	44	0	1	45	0	0
8	23195394	.	C	T	0	2	2	0	0	2	0	0
8	23202689	.	C	T	3	5	8	0	0	8	0	0
8	23202730	.	T	C	5	5	10	0	0	10	0	0
8	23206628	.	G	T	1	2	3	0	0	3	0	0
8	23206666	.	T	A	2	1	3	0	2	5	0	0
8	23206667	.	T	C	2	3	5	0	0	5	0	0
8	23206939	.	C	T	2	1	3	0	0	3	0	0
8	23210492	.	T	C	15	13	28	0	0	28	0	0
8	23210579	.	G	A	11	10	21	0	0	21	0	0
8	23210598	.	G	C	9	15	24	0	0	24	0	0
8	23210652	.	G	A	7	7	14	0	1	15	0	0
8	23210955	.	C	T	7	8	15	0	0	15	0	0
8	23211047	.	A	C	0	1	1	0	0	1	0	0
8	23211054	.	C	T	0	2	2	0	0	2	0	0
8	23211120	.	C	T	5	6	11	0	2	13	0	0
8	23211200	.	G	T	7	3	10	0	1	11	0	0
8	23211233	.	G	T	5	8	13	0	0	13	0	0
8	23211402	.	T	C	9	11	20	0	2	22	0	0
8	23211424	.	C	A	8	11	19	0	0	19	0	0
8	23211446	.	A	C	6	8	14	0	1	15	0	0
8	23213414	.	C	T	19	4	23	0	1	24	0	0
8	23215697	.	G	A	1	9	10	0	16	26	0	0
8	23215801	.	T	C	14	9	23	0	0	23	0	0
8	23253068	.	T	A	5	5	10	0	0	10	0	0
8	23253238	.	A	T	1	4	5	0	0	5	0	0
8	23253656	.	C	T	0	2	2	0	1	3	0	0
8	23253720	.	G	A	3	3	6	0	0	6	0	0
8	23253892	.	A	G	5	7	12	0	0	12	0	0
8	23256703	.	C	T	3	1	4	0	0	4	0	0
8	23258522	.	T	C	2	0	2	0	4	6	0	0
8	23260866	.	G	A	3	4	7	0	0	7	0	0
8	23261031	.	A	G	0	1	1	0	0	1	0	0
8	23327460	.	G	A	2	3	5	0	0	5	0	0
8	23383928	.	G	A	5	1	6	0	0	6	0	0
8	23384003	.	G	A	2	4	6	0	0	6	0	0
8	23388348	.	T	C	1	0	1	0	1	2	0	0
8	23389588	.	A	C	1	2	3	0	0	3	0	0
8	23389610	.	C	A	1	2	3	0	0	3	0	0
8	23389692	.	A	C	1	3	4	0	0	4	0	0
8	23389781	.	T	A	6	4	10	0	0	10	0	0
8	23415693	.	G	A	10	3	13	0	0	13	0	0
8	23415717	.	A	G	3	7	10	0	2	12	0	0
8	23553476	.	A	G	4	7	11	0	0	11	0	0
8	23553648	.	C	T	1	4	5	0	0	5	0	0
8	23553785	.	A	G	4	3	7	0	0	7	0	0
8	23567780	.	T	G	1	0	1	0	0	1	0	0
8	23580927	.	C	T	3	3	6	0	0	6	0	0
8	23615247	.	C	T	2	3	5	0	0	5	0	0
8	23615446	.	G	A	4	7	11	0	0	11	0	0
8	23615456	.	C	T	7	3	10	0	0	10	0	0
8	23625823	.	T	G	6	5	11	0	2	13	0	0
8	23627345	.	G	A	0	0	0	0	1	1	0	0
8	23631692	.	C	T	2	2	4	0	0	4	0	0
8	23636779	.	A	C	8	5	13	0	2	15	0	0
8	23636901	.	C	A	5	8	13	0	0	13	0	0
8	23636923	.	C	T	4	5	9	0	0	9	0	0
8	23637140	.	A	G	7	4	11	0	0	11	0	0
8	23637395	.	C	T	1	3	4	0	0	4	0	0
8	23637680	.	C	T	2	4	6	0	0	6	0	0
8	23639298	.	C	A	12	3	15	0	1	16	0	0
8	23639472	.	T	C	3	4	7	0	0	7	0	0
8	23642271	.	T	C	1	0	1	0	0	1	0	0
8	23647389	.	T	A	2	4	6	0	0	6	0	0
8	23648725	.	G	A	3	0	3	0	1	4	0	0
8	23651328	.	C	T	6	8	14	0	1	15	0	0
8	23651370	.	C	T	9	4	13	0	0	13	0	0
8	23651397	.	G	A	0	0	0	0	5	5	0	0
8	23655968	.	C	T	2	6	8	0	0	8	0	0
8	23656125	.	G	T	7	10	17	0	0	17	0	0
8	23656212	.	A	T	12	6	18	0	0	18	0	0
8	23656321	.	C	A	6	9	15	0	0	15	0	0
8	23666962	.	T	C	2	2	4	0	0	4	0	0
8	23667561	.	C	T	1	2	3	0	0	3	0	0
8	23667739	.	C	T	3	2	5	0	0	5	0	0
8	23667902	.	C	A	1	3	4	1	0	5	0	0
8	23667909	.	G	T	1	3	4	1	0	5	0	0
8	23667966	.	G	A	4	7	11	0	0	11	0	0
8	23668050	.	G	A	2	5	7	0	1	8	0	0
8	23668060	.	C	T	2	5	7	0	0	7	0	0
8	23669276	.	C	T	2	3	5	0	0	5	0	0
8	23669423	.	T	C	3	3	6	0	0	6	0	0
8	23669617	.	T	C	10	4	14	0	0	14	0	0
8	23669642	.	C	T	6	7	13	0	0	13	0	0
8	23669736	.	A	T	7	3	10	0	0	10	0	0
8	23669802	.	C	A	3	8	11	0	0	11	0	0
8	23669821	.	G	A	0	5	5	0	5	10	0	0
8	23669885	.	G	T	5	5	10	0	1	11	0	0
8	23669933	.	C	A	5	4	9	0	1	10	0	0
8	23669968	.	C	T	5	4	9	0	0	9	0	0
8	23669983	.	T	C	5	5	10	0	0	10	0	0
8	23670019	.	T	C	8	4	12	0	0	12	0	0
8	23670115	.	T	C	1	4	5	0	1	6	0	0
8	23670202	.	A	G	4	2	6	0	0	6	0	0
8	23670246	.	T	G	4	0	4	0	4	8	0	0
8	23672388	.	A	C	1	3	4	0	0	4	0	0
8	23672740	.	G	C	2	2	4	0	0	4	0	0
8	23673051	.	A	G	1	3	4	0	0	4	0	0
8	23691751	.	G	C	1	2	3	0	0	3	0	0
8	23703739	.	C	T	4	2	6	0	0	6	0	0
8	23712098	.	C	T	4	1	5	0	2	7	0	0
8	23713488	.	C	T	0	2	2	0	0	2	0	0
8	23713578	.	T	C	1	2	3	0	0	3	0	0
8	23716979	.	G	T	1	4	5	0	0	5	0	0
8	23717117	.	C	A	1	4	5	0	0	5	0	0
8	23720518	.	A	G	1	1	2	0	0	2	0	0
8	23723736	.	G	A	2	4	6	0	0	6	0	0
8	23723762	.	G	A	2	4	6	0	0	6	0	0
8	23724620	.	G	A	0	3	3	0	8	11	0	0
8	23724752	.	A	T	2	3	5	0	0	5	0	0
8	23733184	.	G	T	0	1	1	0	1	2	0	0
8	23733198	.	G	A	0	1	1	0	3	4	0	0
8	23733221	.	C	T	3	2	5	0	0	5	0	0
8	23733248	.	C	A	4	3	7	0	0	7	0	0
8	23735725	.	G	A	0	1	1	0	0	1	0	0
8	23736063	.	G	A	1	5	6	0	3	9	0	0
8	23740148	.	T	C	6	11	17	0	0	17	0	0
8	23753934	.	G	A	1	3	4	0	0	4	0	0
8	23756089	.	A	T	1	2	3	0	0	3	0	0
8	23756172	.	C	T	0	5	5	0	3	8	0	0
8	23756536	.	C	G	0	13	13	0	7	20	0	0
8	23756557	.	G	A	16	6	22	0	0	22	0	0
8	23756680	.	T	A	9	6	15	0	2	17	0	0
8	23756749	.	G	C	5	1	6	0	0	6	0	0
8	23760288	.	C	T	0	9	9	0	4	13	0	0
8	23760297	.	C	T	0	4	4	0	6	10	0	0
8	23760323	.	G	A	4	5	9	0	0	9	0	0
8	23762559	.	A	G	2	0	2	0	0	2	0	0
8	23781194	.	G	A	3	6	9	0	0	9	0	0
8	23781195	.	C	A	3	6	9	0	0	9	0	0
8	23781358	.	G	C	3	3	6	0	0	6	0	0
8	23783073	.	A	G	0	1	1	0	0	1	0	0
8	23810153	.	G	A	2	2	4	0	0	4	0	0
8	23815904	.	G	C	0	3	3	0	1	4	0	0
8	23824548	.	T	C	0	1	1	0	1	2	0	0
8	23827610	.	C	T	12	5	17	0	0	17	0	0
8	23827617	.	G	A	10	6	16	0	0	16	0	0
8	23827670	.	C	T	5	6	11	0	0	11	0	0
8	23833257	.	G	A	3	2	5	0	0	5	0	0
8	23860200	.	G	A	3	3	6	0	0	6	0	0
8	23860641	.	G	T	0	4	4	0	9	13	0	0
8	23865804	.	A	C	8	8	16	0	1	17	0	0
8	23868598	.	T	C	6	12	18	0	0	18	0	0
8	23869978	.	C	T	9	7	16	0	0	16	0	0
8	23871782	.	C	T	2	3	5	0	0	5	0	0
8	23878994	.	G	A	10	10	20	0	1	21	0	0
8	23879461	.	C	T	4	5	9	0	1	10	0	0
8	23961168	.	G	T	0	1	1	0	0	1	0	0
8	24063987	.	T	C	1	3	4	0	0	4	0	0
8	24064017	.	G	A	1	1	2	0	0	2	0	0
8	24108887	.	A	G	7	3	10	0	0	10	0	0
8	24108899	.	T	C	5	3	8	0	1	9	0	0
8	24109195	.	A	T	3	11	14	0	0	14	0	0
8	24109317	.	T	A	7	4	11	0	0	11	0	0
8	24109336	.	A	G	4	8	12	0	0	12	0	0
8	24109399	.	A	G	7	6	13	0	0	13	0	0
8	24109496	.	C	T	1	11	12	0	5	17	0	0
8	24109561	.	C	T	6	5	11	0	0	11	0	0
8	24109562	.	T	C	6	5	11	0	0	11	0	0
8	24109693	.	A	G	6	11	17	0	1	18	0	0
8	24109787	.	C	T	9	4	13	0	1	14	0	0
8	24109860	.	G	A	5	12	17	0	0	17	0	0
8	24109879	.	G	A	11	7	18	0	0	18	0	0
8	24111082	.	T	C	5	9	14	0	1	15	0	0
8	24113044	.	C	A	6	4	10	0	0	10	0	0
8	24113075	.	A	G	1	2	3	0	0	3	0	0
8	24113420	.	A	G	9	5	14	0	0	14	0	0
8	24122960	.	C	A	0	6	6	0	7	13	0	0
8	24123161	.	G	T	1	2	3	0	0	3	0	0
8	24135019	.	C	T	5	3	8	0	0	8	0	0
8	24303896	.	T	A	4	2	6	0	1	7	0	0
8	24304217	.	T	A	3	2	5	0	0	5	0	0
8	24304440	.	G	A	0	2	2	0	1	3	0	0
8	24310532	.	T	G	0	2	2	0	0	2	0	0
8	24322223	.	G	A	1	1	2	0	0	2	0	0
8	24322229	.	G	T	1	1	2	0	0	2	0	0
8	24325254	.	G	A	1	2	3	0	0	3	0	0
8	24325363	.	A	G	4	2	6	0	0	6	0	0
8	24740093	.	T	A	3	6	9	0	0	9	0	0
8	24740094	.	A	C	3	6	9	0	0	9	0	0
8	24743696	.	T	G	6	0	6	0	13	19	0	0
8	24743756	.	A	C	1	4	5	0	2	7	0	0
8	24743823	.	C	A	0	5	5	0	0	5	0	0
8	24743874	.	G	A	0	2	2	0	5	7	0	0
8	24743969	.	T	A	2	2	4	0	0	4	0	0
8	24788514	.	C	T	7	8	15	0	0	15	0	0
8	24789174	.	C	T	4	7	11	0	0	11	0	0
8	24790017	.	G	A	8	4	12	0	0	12	0	0
8	24790139	.	A	G	1	8	9	0	0	9	0	0
8	24790194	.	A	G	7	7	14	0	0	14	0	0
8	24790724	.	C	T	3	6	9	0	1	10	0	0
8	24870426	.	C	T	1	0	1	0	0	1	0	0
8	24880220	.	G	A	9	4	13	0	1	14	0	0
8	24880304	.	C	T	2	7	9	0	0	9	0	0
8	24881058	.	T	C	1	3	4	0	0	4	0	0
8	24883433	.	G	A	0	2	2	0	5	7	0	0
8	24883873	.	C	T	4	3	7	0	0	7	0	0
8	24883963	.	C	A	1	6	7	0	2	9	0	0
8	24889230	.	G	A	0	15	15	0	19	34	0	0
8	24889468	.	C	T	19	7	26	0	0	26	0	0
8	24889674	.	C	T	23	9	32	0	4	36	0	0
8	24890238	.	T	A	9	8	17	0	1	18	0	0
8	24890913	.	T	G	5	21	26	0	0	26	0	0
8	24938274	.	C	T	7	2	9	0	0	9	0	0
8	24940165	.	C	T	2	4	6	0	1	7	0	0
8	24940282	.	G	A	2	4	6	0	0	6	0	0
8	24940303	.	G	A	1	3	4	0	0	4	0	0
8	24968362	.	A	T	1	2	3	0	0	3	0	0
8	24972107	.	T	A	15	22	37	0	1	38	0	0
8	24972119	.	G	T	15	21	36	0	3	39	0	0
8	24972413	.	A	C	3	6	9	0	0	9	0	0
8	24972665	.	T	C	16	12	28	0	1	29	0	0
8	24973010	.	T	A	11	16	27	0	0	27	0	0
8	24973088	.	G	C	9	12	21	0	0	21	0	0
8	24973116	.	C	G	12	10	22	0	1	23	0	0
8	24973239	.	T	A	11	15	26	0	0	26	0	0
8	24983245	.	C	G	0	8	8	0	6	14	0	0
8	24991082	.	G	T	4	3	7	0	0	7	0	0
8	24991127	.	G	A	9	3	12	0	1	13	0	0
8	25010904	.	C	A	0	18	18	0	10	28	0	0
8	25022506	.	C	T	1	6	7	0	5	12	0	0
8	25022808	.	C	T	7	3	10	0	0	10	0	0
8	25036367	.	A	T	2	3	5	0	0	5	0	0
8	25036450	.	T	A	5	2	7	0	0	7	0	0
8	25036462	.	C	T	5	2	7	0	0	7	0	0
8	25036493	.	C	T	5	6	11	0	1	12	0	0
8	25036679	.	T	A	5	6	11	0	0	11	0	0
8	25039840	.	T	C	5	14	19	0	0	19	0	0
8	25039967	.	C	A	9	9	18	0	0	18	0	0
8	25040295	.	A	G	4	5	9	0	0	9	0	0
8	25041986	.	G	A	6	4	10	0	0	10	0	0
8	25042269	.	T	C	4	8	12	0	0	12	0	0
8	25042275	.	T	C	4	8	12	0	0	12	0	0
8	25042328	.	A	G	3	12	15	0	1	16	0	0
8	25042352	.	G	A	5	13	18	0	0	18	0	0
8	25042447	.	T	C	7	8	15	0	1	16	0	0
8	25042474	.	T	C	11	1	12	0	11	23	0	0
8	25043112	.	T	G	7	9	16	0	2	18	0	0
8	25043125	.	A	G	8	10	18	0	0	18	0	0
8	25043167	.	A	T	7	9	16	0	0	16	0	0
8	25044564	.	C	G	1	4	5	0	4	9	0	0
8	25044591	.	C	T	0	7	7	0	8	15	0	0
8	25056207	.	A	G	4	7	11	0	0	11	0	0
8	25065675	.	T	A	4	7	11	0	0	11	0	0
8	25065762	.	A	G	2	2	4	0	0	4	0	0
8	25066100	.	C	T	2	1	3	0	0	3	0	0
8	25074028	.	T	C	5	7	12	0	4	16	0	0
8	25094247	.	G	A	0	4	4	0	5	9	0	0
8	25094248	.	A	T	5	4	9	0	0	9	0	0
8	25094288	.	C	T	4	2	6	0	1	7	0	0
8	25094326	.	A	C	5	2	7	0	0	7	0	0
8	25097431	.	G	A	2	2	4	0	0	4	0	0
8	25103407	.	C	T	6	6	12	0	0	12	0	0
8	25103801	.	A	G	1	0	1	0	4	5	0	0
8	25103887	.	G	A	6	5	11	0	1	12	0	0
8	25117759	.	A	G	5	9	14	0	1	15	0	0
8	25117981	.	G	A	7	11	18	0	0	18	0	0
8	25117990	.	T	C	7	11	18	0	0	18	0	0
8	25118128	.	C	T	14	6	20	0	0	21	1	0
8	25118164	.	C	A	13	13	26	0	0	26	0	0
8	25118587	.	A	G	4	4	8	0	0	8	0	0
8	25118608	.	A	T	1	1	2	0	0	2	0	0
8	25176197	.	C	T	4	3	7	0	0	7	0	0
8	25176257	.	T	C	9	7	16	0	0	16	0	0
8	25176303	.	A	G	7	8	15	0	2	17	0	0
8	25176677	.	T	C	4	2	6	0	0	6	0	0
8	25176957	.	C	G	5	2	7	0	0	7	0	0
8	25177264	.	G	C	3	5	8	0	1	9	0	0
8	25177285	.	A	G	3	3	6	0	1	7	0	0
8	25177501	.	T	G	5	7	12	0	0	12	0	0
8	25190442	.	C	T	2	2	4	0	0	4	0	0
8	25225853	.	T	G	3	4	7	0	0	7	0	0
8	25225949	.	T	A	4	2	6	0	0	6	0	0
8	25247355	.	A	G	2	0	2	0	5	7	0	0
8	25267833	.	T	C	0	3	3	0	0	3	0	0
8	25269942	.	G	A	0	2	2	0	0	2	0	0
8	25269993	.	G	A	2	2	4	0	0	4	0	0
8	25271544	.	T	C	0	1	1	0	0	1	0	0
8	25271550	.	G	A	0	1	1	0	0	1	0	0
8	25272575	.	T	C	0	2	2	0	0	2	0	0
8	25277047	.	G	A	0	2	2	0	13	15	0	0
8	25280530	.	T	C	5	5	10	0	0	10	0	0
8	25280807	.	C	T	5	5	10	0	0	10	0	0
8	25281877	.	A	G	4	0	4	0	4	8	0	0
8	25288980	.	T	C	8	6	14	0	0	14	0	0
8	25289156	.	A	G	0	0	0	0	1	1	0	0
8	25291308	.	C	T	11	9	20	0	3	23	0	0
8	25291652	.	C	T	5	9	14	0	0	14	0	0
8	25291742	.	A	C	10	12	22	0	0	22	0	0
8	25291839	.	T	C	13	16	29	0	2	31	0	0
8	25291876	.	A	G	14	16	30	0	1	31	0	0
8	25292020	.	A	T	20	17	37	0	1	38	0	0
8	25292274	.	G	A	0	7	7	0	15	22	0	0
8	25292330	.	C	T	11	11	22	0	1	23	0	0
8	25292407	.	G	T	8	9	17	0	2	19	0	0
8	25292667	.	G	T	11	11	22	0	0	22	0	0
8	25293008	.	A	G	17	15	32	0	2	34	0	0
8	25293145	.	C	T	18	20	38	0	0	38	0	0
8	25293275	.	A	G	16	0	16	0	12	28	0	0
8	25293445	.	T	C	4	2	6	0	0	6	0	0
8	25297371	.	T	C	6	0	6	0	0	6	0	0
8	25297523	.	A	G	18	0	18	0	19	37	0	0
8	25301512	.	G	T	10	4	14	0	2	16	0	0
8	25301524	.	A	G	11	4	15	0	1	16	0	0
8	25329946	.	A	G	10	4	14	0	1	15	0	0
8	25329981	.	A	T	13	6	19	0	0	19	0	0
8	25330229	.	G	A	8	5	13	0	1	14	0	0
8	25330334	.	T	A	8	6	14	0	0	14	0	0
8	25330367	.	A	C	12	7	19	0	0	19	0	0
8	25330498	.	G	A	30	23	53	0	0	53	0	0
8	25368374	.	A	G	3	5	8	0	0	8	0	0
8	25368613	.	G	A	9	4	13	0	0	13	0	0
8	25397537	.	A	G	0	1	1	0	0	1	0	0
8	25398628	.	A	T	2	2	4	0	0	4	0	0
8	25398679	.	T	C	0	0	0	0	1	1	0	0
8	25422063	.	G	T	1	2	3	0	0	3	0	0
8	25422072	.	A	C	1	0	1	0	2	3	0	0
8	25424375	.	C	A	11	5	16	0	0	16	0	0
8	25424558	.	A	G	5	6	11	0	0	11	0	0
8	25424865	.	T	A	5	5	10	0	1	11	0	0
8	25425033	.	T	C	6	4	10	0	0	10	0	0
8	25425137	.	C	T	5	2	7	0	0	7	0	0
8	25425311	.	T	C	2	3	5	0	0	5	0	0
8	25425391	.	C	T	3	4	7	0	0	7	0	0
8	25425453	.	G	A	3	5	8	0	0	8	0	0
8	25425621	.	T	A	3	2	5	0	0	5	0	0
8	25426405	.	G	A	2	6	8	0	0	8	0	0
8	25426521	.	T	A	5	3	8	0	0	8	0	0
8	25426563	.	T	G	5	2	7	0	0	7	0	0
8	25433771	.	A	G	1	2	3	0	0	3	0	0
8	25438858	.	C	A	0	1	1	0	2	3	0	0
8	25445451	.	A	G	0	1	1	0	0	1	0	0
8	25452117	.	T	C	4	4	8	0	0	8	0	0
8	25455917	.	C	A	4	3	7	0	0	7	0	0
8	25467852	.	T	C	0	1	1	0	0	1	0	0
8	25591038	.	C	A	2	2	4	0	0	4	0	0
8	25591187	.	T	C	1	1	2	0	2	4	0	0
8	25650250	.	A	G	1	3	4	0	0	4	0	0
8	25650512	.	T	C	2	3	5	0	0	5	0	0
8	25650518	.	T	C	2	0	2	0	3	5	0	0
8	25659531	.	A	G	1	0	1	0	0	1	0	0
8	25708998	.	C	T	2	8	10	0	0	10	0	0
8	25709085	.	T	G	10	7	17	0	0	17	0	0
8	25709426	.	G	T	10	5	15	0	0	15	0	0
8	25709521	.	T	A	5	12	17	0	3	20	0	0
8	25709522	.	A	C	6	14	20	0	0	20	0	0
8	25713035	.	T	A	4	5	9	0	0	9	0	0
8	25715118	.	A	C	8	0	8	0	6	14	0	0
8	25715181	.	C	T	4	8	12	0	0	12	0	0
8	25715325	.	G	C	12	2	14	0	4	18	0	0
8	25715950	.	C	A	3	8	11	0	0	11	0	0
8	25716000	.	C	A	11	15	26	0	1	27	0	0
8	25717075	.	C	T	2	2	4	0	0	4	0	0
8	25734814	.	C	A	6	3	9	0	0	9	0	0
8	25734892	.	G	A	3	4	7	0	0	7	0	0
8	25745877	.	T	A	11	7	18	0	0	18	0	0
8	25745915	.	A	T	6	3	9	0	1	10	0	0
8	25746125	.	C	T	1	3	4	0	0	4	0	0
8	25746183	.	G	A	0	10	10	0	4	14	0	0
8	25746213	.	A	G	7	0	7	0	5	12	0	0
8	25746376	.	G	A	1	2	3	0	0	3	0	0
8	25746508	.	A	G	3	5	8	0	1	9	0	0
8	25746535	.	C	A	2	5	7	0	1	8	0	0
8	25746650	.	T	G	4	4	8	0	0	9	1	0
8	25746684	.	C	T	3	4	7	0	0	7	0	0
8	25746788	.	C	G	7	7	14	0	1	15	0	0
8	25746881	.	A	G	3	2	5	0	0	5	0	0
8	25746909	.	A	C	3	2	5	0	0	5	0	0
8	25746923	.	T	C	4	2	6	0	0	6	0	0
8	25746999	.	G	A	0	10	10	0	7	17	0	0
8	25747028	.	T	A	6	8	14	0	1	15	0	0
8	25747202	.	A	C	4	9	13	0	0	13	0	0
8	25747365	.	T	C	9	6	15	0	0	15	0	0
8	25747425	.	A	T	6	11	17	0	1	18	0	0
8	25747502	.	T	C	8	8	16	0	2	18	0	0
8	25747518	.	T	C	7	8	15	0	1	16	0	0
8	25747644	.	T	G	6	8	14	0	1	15	0	0
8	25747704	.	C	A	8	6	14	0	0	14	0	0
8	25747705	.	A	G	8	6	14	0	0	14	0	0
8	25747993	.	G	A	0	12	12	0	3	15	0	0
8	25748047	.	G	A	0	8	8	0	6	14	0	0
8	25748185	.	T	C	4	5	9	0	2	11	0	0
8	25748244	.	G	A	5	4	9	0	3	12	0	0
8	25748329	.	A	T	8	6	14	0	2	16	0	0
8	25748330	.	T	A	10	6	16	0	0	16	0	0
8	25748405	.	T	C	9	12	21	0	5	26	0	0
8	25748434	.	G	A	10	17	27	0	0	27	0	0
8	25748562	.	T	A	18	5	23	0	0	23	0	0
8	25748685	.	G	A	8	4	12	0	0	12	0	0
8	25751167	.	A	G	14	0	14	0	8	22	0	0
8	25751348	.	A	T	3	4	7	0	0	7	0	0
8	25765640	.	T	A	11	7	18	0	0	18	0	0
8	25766249	.	A	G	2	3	5	0	0	5	0	0
8	25766301	.	T	A	2	3	5	0	0	5	0	0
8	25812113	.	G	A	14	11	25	0	0	25	0	0
8	25812324	.	A	G	15	12	27	0	2	29	0	0
8	25812327	.	G	A	12	15	27	0	2	29	0	0
8	25813904	.	A	G	6	10	16	0	0	16	0	0
8	25813937	.	G	T	12	11	23	0	0	23	0	0
8	25816849	.	G	A	18	16	34	0	2	36	0	0
8	25816863	.	G	A	18	17	35	0	0	35	0	0
8	25816959	.	G	T	13	29	42	0	1	43	0	0
8	25817058	.	A	G	3	2	5	0	0	5	0	0
8	25818670	.	T	G	1	2	3	0	0	3	0	0
8	25818836	.	C	T	1	7	8	0	13	21	0	0
8	25819090	.	G	T	11	6	17	0	1	18	0	0
8	25819128	.	A	G	8	6	14	0	0	14	0	0
8	25819137	.	T	C	7	3	10	0	0	10	0	0
8	25819248	.	G	A	1	2	3	0	2	5	0	0
8	25819478	.	G	A	7	11	18	0	0	18	0	0
8	25820917	.	G	T	4	7	11	0	0	11	0	0
8	25821105	.	T	A	0	3	3	0	0	3	0	0
8	25821140	.	G	A	6	3	9	0	0	9	0	0
8	25821426	.	T	C	12	16	28	0	0	28	0	0
8	25845780	.	C	T	7	16	23	0	3	26	0	0
8	25845885	.	G	C	18	13	31	0	0	32	1	0
8	25858532	.	C	T	0	3	3	0	2	5	0	0
8	25892736	.	A	C	4	6	10	0	0	10	0	0
8	25893862	.	C	T	5	4	9	0	0	9	0	0
8	25894080	.	C	G	4	5	9	0	0	9	0	0
8	25894222	.	G	A	0	8	8	0	5	13	0	0
8	25894300	.	C	T	9	10	19	0	0	19	0	0
8	25897145	.	T	A	10	9	19	0	1	20	0	0
8	25897287	.	C	T	4	5	9	0	0	9	0	0
8	25897373	.	G	A	0	5	5	0	2	7	0	0
8	25897378	.	C	T	2	4	6	0	1	7	0	0
8	25897489	.	G	A	7	5	12	0	0	12	0	0
8	25897694	.	C	T	4	5	9	0	0	9	0	0
8	25898011	.	T	A	4	2	6	0	0	6	0	0
8	25898067	.	G	T	3	2	5	0	1	6	0	0
8	25902319	.	C	T	3	6	9	0	1	10	0	0
8	25902970	.	T	A	19	14	33	0	7	40	0	0
8	25905524	.	T	A	14	4	18	0	0	18	0	0
8	25905686	.	T	A	20	20	40	0	0	40	0	0
8	25905744	.	T	G	12	22	34	0	0	34	0	0
8	25913795	.	A	C	3	2	5	0	0	5	0	0
8	25913896	.	C	T	2	4	6	0	0	6	0	0
8	25925483	.	G	A	0	1	1	0	5	6	0	0
8	25925497	.	G	A	3	4	7	0	0	7	0	0
8	25927455	.	C	T	2	0	2	0	0	2	0	0
8	25927472	.	C	T	1	4	5	0	1	6	0	0
8	25927496	.	G	A	0	3	3	0	2	5	0	0
8	25940273	.	A	G	2	4	6	0	0	6	0	0
8	25948519	.	A	C	2	3	5	0	1	6	0	0
8	25950577	.	G	A	1	6	7	0	0	7	0	0
8	25950704	.	G	C	1	2	3	0	0	3	0	0
8	25950707	.	G	C	2	1	3	0	0	3	0	0
8	25950772	.	G	A	12	5	17	0	0	17	0	0
8	25950803	.	G	A	0	13	13	0	3	16	0	0
8	25950877	.	C	T	11	12	23	0	0	23	0	0
8	25950880	.	G	T	12	12	24	0	1	25	0	0
8	25950999	.	G	A	0	13	13	0	11	24	0	0
8	25951265	.	A	T	3	8	11	0	0	12	1	0
8	25951293	.	A	T	2	4	6	0	0	6	0	0
8	25951417	.	A	T	8	22	30	0	1	32	1	0
8	25951437	.	A	C	8	20	28	0	0	28	0	0
8	25951473	.	A	T	9	14	23	0	0	23	0	0
8	25951517	.	C	T	6	11	17	0	0	17	0	0
8	25951575	.	A	T	3	2	5	0	0	5	0	0
8	25951626	.	T	C	0	5	5	0	1	6	0	0
8	25951762	.	C	T	9	9	18	0	0	18	0	0
8	25951804	.	A	G	6	3	9	0	1	10	0	0
8	25951806	.	A	T	7	2	9	0	1	10	0	0
8	25960115	.	G	A	0	3	3	0	2	5	0	0
8	25963150	.	A	G	10	11	21	0	1	22	0	0
8	25963151	.	C	A	10	11	21	0	1	22	0	0
8	25963223	.	A	C	9	6	15	0	1	16	0	0
8	25964397	.	A	C	7	6	13	0	0	13	0	0
8	25964398	.	T	C	7	6	13	0	0	13	0	0
8	25964669	.	A	G	5	3	8	0	0	8	0	0
8	25969188	.	C	T	3	1	4	0	0	4	0	0
8	25969466	.	C	T	4	6	10	0	0	10	0	0
8	25969498	.	A	G	6	9	15	0	0	15	0	0
8	25969506	.	G	A	0	10	10	0	7	17	0	0
8	25969778	.	T	A	4	6	10	0	1	11	0	0
8	25970647	.	A	T	4	3	7	0	0	7	0	0
8	25970772	.	A	G	17	4	21	0	0	21	0	0
8	25970816	.	G	T	8	7	15	0	1	16	0	0
8	25970932	.	G	A	3	13	16	0	1	17	0	0
8	25971143	.	C	A	5	3	8	0	1	9	0	0
8	25971306	.	T	A	11	11	22	0	1	23	0	0
8	25971367	.	C	T	4	9	13	0	0	13	0	0
8	25971397	.	G	A	4	6	10	0	0	10	0	0
8	25971488	.	A	C	2	1	3	0	2	5	0	0
8	25971489	.	G	A	3	2	5	0	0	5	0	0
8	26008143	.	C	G	3	4	7	0	0	7	0	0
8	26019075	.	G	A	1	1	2	0	0	2	0	0
8	26019103	.	G	A	1	2	3	0	0	3	0	0
8	26019765	.	G	A	0	3	3	0	0	3	0	0
8	26025040	.	T	C	3	1	4	0	0	4	0	0
8	26026772	.	C	T	3	4	7	0	0	7	0	0
8	26026787	.	C	T	4	5	9	0	0	9	0	0
8	26030223	.	C	T	3	0	3	0	0	3	0	0
8	26030226	.	G	A	3	0	3	0	0	3	0	0
8	26030808	.	C	A	2	2	4	0	0	4	0	0
8	26030852	.	A	G	2	5	7	0	0	7	0	0
8	26034676	.	C	T	10	5	15	0	1	16	0	0
8	26038309	.	G	A	10	11	21	0	0	21	0	0
8	26056801	.	G	A	20	13	33	0	2	35	0	0
8	26056891	.	T	G	20	11	31	0	1	32	0	0
8	26057130	.	T	C	19	15	34	0	2	36	0	0
8	26066234	.	C	T	1	2	3	0	0	3	0	0
8	26073777	.	G	A	1	3	4	0	0	4	0	0
8	26075413	.	T	C	3	3	6	0	0	6	0	0
8	26075518	.	C	T	4	0	4	0	0	4	0	0
8	26078551	.	C	T	7	8	15	0	0	15	0	0
8	26078898	.	C	A	2	5	7	0	1	8	0	0
8	26083987	.	C	T	7	7	14	0	0	14	0	0
8	26091767	.	C	T	6	9	15	0	1	16	0	0
8	26091939	.	G	A	0	2	2	0	2	4	0	0
8	26092050	.	A	G	19	12	31	0	0	31	0	0
8	26095683	.	G	A	1	0	1	0	0	1	0	0
8	26097321	.	C	T	17	17	34	0	1	35	0	0
8	26097744	.	G	T	0	7	7	0	2	9	0	0
8	26097881	.	T	C	6	9	15	0	0	15	0	0
8	26097895	.	C	A	12	8	20	0	0	20	0	0
8	26097966	.	C	T	7	8	15	0	0	15	0	0
8	26125496	.	T	C	3	3	6	0	0	6	0	0
8	26125649	.	T	C	3	2	5	0	1	6	0	0
8	26126279	.	G	T	2	2	4	0	0	4	0	0
8	26126672	.	T	C	1	4	5	0	0	5	0	0
8	26126765	.	C	A	2	2	4	0	0	4	0	0
8	26127764	.	G	A	0	2	2	0	1	3	0	0
8	26151750	.	G	T	1	3	4	0	0	4	0	0
8	26166320	.	C	T	1	3	4	0	0	4	0	0
8	26166467	.	T	C	0	1	1	0	0	1	0	0
8	26176023	.	G	A	1	0	1	0	0	1	0	0
8	26176125	.	T	C	0	6	6	0	0	6	0	0
8	26179738	.	T	C	2	1	3	0	0	3	0	0
8	26189449	.	G	A	0	2	2	0	1	3	0	0
8	26192708	.	G	A	0	5	5	0	3	8	0	0
8	26192798	.	C	T	0	2	2	0	0	2	0	0
8	26205537	.	C	T	2	1	3	0	0	3	0	0
8	26208387	.	T	C	2	3	5	0	2	7	0	0
8	26230167	.	G	T	0	2	2	0	0	2	0	0
8	26234078	.	G	A	5	3	8	0	1	9	0	0
8	26234169	.	G	A	2	3	5	0	0	5	0	0
8	26234599	.	A	T	2	3	5	0	0	5	0	0
8	26235117	.	A	C	4	4	8	0	0	8	0	0
8	26235554	.	C	T	4	5	9	0	0	9	0	0
8	26235560	.	T	G	4	4	8	0	0	8	0	0
8	26240196	.	C	T	2	3	5	0	0	5	0	0
8	26240199	.	C	T	3	2	5	0	0	5	0	0
8	26317376	.	T	C	3	2	5	0	0	5	0	0
8	26321296	.	C	T	12	11	23	0	0	23	0	0
8	26321359	.	G	A	7	3	10	0	1	11	0	0
8	26323458	.	A	T	6	8	14	0	1	15	0	0
8	26323511	.	T	A	13	7	20	0	2	22	0	0
8	26324647	.	A	T	4	7	11	0	0	11	0	0
8	26325519	.	A	T	13	16	29	0	0	29	0	0
8	26325600	.	T	C	16	11	27	0	0	27	0	0
8	26325679	.	C	T	20	20	40	0	0	40	0	0
8	26325680	.	G	A	19	18	37	0	3	40	0	0
8	26325888	.	G	A	0	18	18	0	13	31	0	0
8	26326046	.	G	A	17	19	36	0	1	37	0	0
8	26326152	.	T	C	20	27	47	0	1	48	0	0
8	26330047	.	A	C	7	7	14	0	2	16	0	0
8	26330134	.	A	T	6	8	14	0	0	14	0	0
8	26330352	.	T	A	4	7	11	0	1	12	0	0
8	26330545	.	C	T	15	10	25	0	0	25	0	0
8	26360974	.	G	T	8	5	13	0	0	13	0	0
8	26361294	.	G	A	5	3	8	0	1	9	0	0
8	26368150	.	C	T	31	15	46	0	3	49	0	0
8	26368356	.	G	A	0	12	12	0	13	25	0	0
8	26368446	.	A	T	7	3	10	0	0	10	0	0
8	26369055	.	C	T	3	3	6	0	0	6	0	0
8	26417276	.	C	T	2	1	3	0	0	3	0	0
8	26424873	.	A	G	2	3	5	0	0	5	0	0
8	26426478	.	G	A	2	5	7	0	0	7	0	0
8	26426487	.	G	A	2	7	9	0	0	9	0	0
8	26426621	.	C	T	4	7	11	0	0	11	0	0
8	26432701	.	C	T	4	3	7	0	0	7	0	0
8	26436030	.	A	G	2	2	4	0	0	4	0	0
8	26438912	.	A	G	0	1	1	0	0	1	0	0
8	26439101	.	G	T	2	2	4	0	0	4	0	0
8	26444877	.	C	T	1	1	2	0	0	2	0	0
8	26444892	.	T	A	1	1	2	0	0	2	0	0
8	26445075	.	T	C	0	6	6	0	0	6	0	0
8	26449218	.	A	T	3	1	4	0	0	4	0	0
8	26449383	.	G	A	2	1	3	0	0	3	0	0
8	26702982	.	A	G	0	3	3	0	0	3	0	0
8	26838245	.	A	G	3	2	5	0	0	5	0	0
8	27623973	.	A	G	0	2	2	0	24	26	0	0
8	28066167	.	G	A	8	8	16	0	0	16	0	0
8	28066168	.	C	A	8	8	16	0	0	16	0	0
8	28066291	.	G	T	0	3	3	0	6	9	0	0
8	28224987	.	G	A	5	6	11	0	0	11	0	0
8	28229971	.	C	T	16	4	20	0	3	23	0	0
8	28232496	.	G	A	10	4	14	0	1	15	0	0
8	28232512	.	G	T	5	7	12	0	0	12	0	0
8	28232557	.	T	A	11	8	19	0	0	20	1	0
8	28232745	.	G	T	13	13	26	0	1	27	0	0
8	28232812	.	G	T	10	4	14	0	1	16	1	0
8	28243292	.	A	G	1	2	3	0	0	3	0	0
8	28243362	.	A	G	2	2	4	0	0	4	0	0
8	28243579	.	C	T	5	4	9	0	1	10	0	0
8	28243707	.	C	G	3	5	8	0	0	8	0	0
8	28243830	.	T	G	2	5	7	0	1	8	0	0
8	28244076	.	C	T	2	3	5	0	0	5	0	0
8	28244116	.	G	A	4	3	7	0	0	7	0	0
8	28244193	.	G	A	7	3	10	0	0	10	0	0
8	28244267	.	C	A	2	4	6	0	0	6	0	0
8	28248692	.	G	T	0	1	1	0	0	1	0	0
8	28252294	.	A	G	3	3	6	0	0	6	0	0
8	28256649	.	A	C	2	0	2	0	3	5	0	0
8	28313256	.	G	A	11	10	21	0	1	22	0	0
8	28315258	.	A	G	3	8	11	0	0	11	0	0
8	28315301	.	T	C	13	0	13	0	19	32	0	0
8	28315378	.	A	G	6	14	20	0	0	20	0	0
8	28315424	.	C	G	7	9	16	0	1	17	0	0
8	28315436	.	G	T	7	11	18	0	0	18	0	0
8	28315481	.	A	G	10	11	21	0	1	22	0	0
8	28315694	.	A	G	1	1	2	0	0	2	0	0
8	28315699	.	A	G	1	0	1	0	0	1	0	0
8	28317844	.	T	C	3	0	3	0	2	5	0	0
8	28323403	.	C	A	0	11	11	0	3	14	0	0
8	28323442	.	A	G	0	3	3	0	1	4	0	0
8	28345479	.	G	A	1	4	5	0	0	5	0	0
8	28346143	.	A	G	5	4	9	0	0	9	0	0
8	28346146	.	C	T	5	4	9	0	0	9	0	0
8	28346569	.	A	G	10	3	13	0	1	14	0	0
8	28346656	.	A	G	2	5	7	0	0	7	0	0
8	28346659	.	G	C	1	5	6	0	0	6	0	0
8	28346701	.	A	C	2	2	4	0	0	4	0	0
8	28351147	.	T	A	9	7	16	0	0	16	0	0
8	28351678	.	T	C	4	4	8	0	0	8	0	0
8	28351679	.	C	T	4	4	8	0	0	8	0	0
8	28356317	.	A	G	5	0	5	0	0	5	0	0
8	28358501	.	C	A	4	6	10	0	0	10	0	0
8	28359559	.	T	C	1	2	3	0	0	3	0	0
8	28364854	.	G	A	0	5	5	0	6	11	0	0
8	28364923	.	T	A	9	9	18	0	1	19	0	0
8	28365119	.	C	T	6	9	15	0	0	15	0	0
8	28365328	.	A	T	6	11	17	0	1	18	0	0
8	28365361	.	C	T	5	10	15	0	1	16	0	0
8	28365417	.	A	G	9	3	12	0	0	12	0	0
8	28365479	.	C	T	4	5	9	0	0	9	0	0
8	28365496	.	C	A	4	4	8	0	0	8	0	0
8	28379375	.	T	A	3	2	5	0	0	5	0	0
8	28399297	.	T	A	5	5	10	0	0	10	0	0
8	28399580	.	T	A	5	8	13	0	0	13	0	0
8	28399625	.	A	C	9	3	12	0	1	13	0	0
8	28399672	.	A	G	2	8	10	0	0	10	0	0
8	28401003	.	C	A	5	2	7	0	1	8	0	0
8	28463137	.	C	T	3	2	5	0	0	5	0	0
8	28463373	.	A	T	8	5	13	0	0	13	0	0
8	28463587	.	T	C	1	6	7	0	0	7	0	0
8	28463785	.	A	T	9	8	17	0	0	17	0	0
8	28464556	.	C	T	7	8	15	0	1	16	0	0
8	28465184	.	G	A	6	1	7	0	0	7	0	0
8	28527921	.	G	A	0	2	2	0	3	5	0	0
8	28528277	.	A	T	2	8	10	0	0	10	0	0
8	28532166	.	G	A	0	2	2	0	2	4	0	0
8	28532304	.	C	T	5	9	14	0	1	15	0	0
8	28532490	.	C	T	10	7	17	0	0	17	0	0
8	28532715	.	C	T	5	5	10	0	0	10	0	0
8	28594221	.	G	A	4	2	6	0	0	6	0	0
8	28594395	.	C	T	0	3	3	0	0	3	0	0
8	28726907	.	C	G	0	3	3	0	1	4	0	0
8	28726914	.	G	A	3	1	4	0	0	4	0	0
8	28727168	.	T	C	1	3	4	0	1	5	0	0
8	28727396	.	A	G	2	4	6	0	0	6	0	0
8	28727828	.	G	T	5	2	7	0	0	7	0	0
8	28772494	.	G	A	0	5	5	0	1	6	0	0
8	28868120	.	G	A	0	2	2	0	1	3	0	0
8	28868245	.	T	C	3	3	6	0	0	6	0	0
8	28868416	.	G	A	0	8	8	0	3	11	0	0
8	28900870	.	G	T	0	10	10	0	7	17	0	0
8	28901165	.	C	T	3	8	11	0	1	12	0	0
8	29267122	.	A	C	6	3	9	0	0	9	0	0
8	29267218	.	C	T	7	11	18	0	0	18	0	0
8	29267269	.	T	C	7	10	17	0	1	18	0	0
8	29285574	.	T	C	11	6	17	0	0	17	0	0
8	29336744	.	C	A	3	1	4	0	0	4	0	0
8	29336828	.	C	T	5	7	12	0	1	13	0	0
8	29427894	.	C	T	11	6	17	0	1	18	0	0
8	29427918	.	G	A	0	10	10	0	8	18	0	0
8	29427954	.	T	C	9	9	18	0	2	20	0	0
8	29428071	.	G	A	0	10	10	0	8	18	0	0
8	29428110	.	C	T	3	2	5	0	2	7	0	0
8	29476190	.	T	C	4	5	9	0	0	9	0	0
8	29587232	.	C	T	15	19	34	0	0	34	0	0
8	29644195	.	G	A	1	2	3	0	1	4	0	0
8	29644838	.	T	A	2	3	5	0	0	5	0	0
8	29644845	.	C	T	3	0	3	0	0	3	0	0
8	29645127	.	G	A	0	1	1	0	0	1	0	0
8	29647473	.	G	T	3	3	6	0	0	6	0	0
8	29647488	.	A	T	1	3	4	0	0	4	0	0
8	29647548	.	C	T	2	1	3	0	0	3	0	0
8	29647558	.	G	A	2	0	2	0	0	2	0	0
8	29647748	.	T	C	3	2	5	0	0	5	0	0
8	29651670	.	G	A	2	3	5	0	0	5	0	0
8	29651951	.	A	G	5	8	13	0	1	14	0	0
8	29652100	.	A	G	4	1	5	0	3	8	0	0
8	29652143	.	A	G	5	6	11	0	0	11	0	0
8	29652174	.	G	A	6	4	10	0	0	10	0	0
8	29701593	.	C	T	1	2	3	0	0	3	0	0
8	29710722	.	G	A	6	4	10	0	0	10	0	0
8	29718974	.	G	T	5	9	14	0	0	14	0	0
8	29719149	.	A	G	5	5	10	0	1	11	0	0
8	29742483	.	C	T	2	2	4	0	1	5	0	0
8	29749008	.	C	T	0	2	2	0	0	2	0	0
8	29749346	.	C	T	3	3	6	0	0	6	0	0
8	29758468	.	T	C	4	1	5	0	0	5	0	0
8	29759705	.	C	T	1	2	3	0	0	3	0	0
8	29759726	.	A	C	4	2	6	0	0	6	0	0
8	29760980	.	G	A	0	0	0	0	1	1	0	0
8	29763383	.	A	G	3	0	3	0	6	9	0	0
8	29763621	.	G	T	5	5	10	0	0	10	0	0
8	29763812	.	G	C	7	8	15	0	0	15	0	0
8	29763822	.	A	G	9	0	9	0	7	16	0	0
8	29763954	.	A	G	2	4	6	0	0	6	0	0
8	29764150	.	A	T	5	4	9	0	0	9	0	0
8	29764695	.	G	T	3	2	5	0	0	5	0	0
8	29764843	.	A	G	3	3	6	0	0	6	0	0
8	29764926	.	T	C	4	5	9	0	0	9	0	0
8	29765010	.	G	C	0	4	4	0	5	9	0	0
8	29765493	.	A	G	2	3	5	0	0	5	0	0
8	29765677	.	G	C	1	2	3	0	0	3	0	0
8	29765702	.	A	G	1	2	3	0	0	3	0	0
8	29766516	.	T	C	1	2	3	0	0	3	0	0
8	29766576	.	G	T	2	2	4	0	0	4	0	0
8	29770185	.	C	T	19	9	28	0	1	29	0	0
8	29770207	.	G	A	17	18	35	0	0	35	0	0
8	29770592	.	G	A	26	12	38	0	1	39	0	0
8	29770734	.	T	A	23	24	47	0	0	47	0	0
8	29770771	.	A	C	19	26	45	0	2	47	0	0
8	29770775	.	A	T	20	24	44	0	3	47	0	0
8	29771013	.	G	A	23	14	37	1	0	38	0	0
8	29771032	.	T	A	25	12	37	0	0	37	0	0
8	29771173	.	G	A	11	14	25	0	0	25	0	0
8	29771336	.	T	C	2	0	2	0	3	5	0	0
8	29771773	.	C	T	1	3	4	0	2	6	0	0
8	29772253	.	G	A	10	10	20	0	0	20	0	0
8	29772268	.	T	C	10	9	19	0	1	20	0	0
8	29772933	.	C	T	0	6	6	0	12	18	0	0
8	29773164	.	G	A	13	14	27	0	0	27	0	0
8	29773263	.	G	A	16	14	30	0	1	31	0	0
8	29773329	.	C	A	11	10	21	0	1	22	0	0
8	29773444	.	A	G	19	21	40	0	0	40	0	0
8	29774042	.	C	G	0	8	8	0	15	23	0	0
8	29774309	.	A	T	16	9	25	0	2	27	0	0
8	29774370	.	T	A	10	10	20	0	0	20	0	0
8	29774570	.	C	T	9	11	20	0	0	20	0	0
8	29774747	.	A	T	2	2	4	0	0	4	0	0
8	29774827	.	C	T	0	7	7	0	10	17	0	0
8	29775340	.	A	T	14	6	20	0	0	20	0	0
8	29775342	.	T	A	6	14	20	0	0	20	0	0
8	29787292	.	C	T	0	3	3	0	3	6	0	0
8	29793782	.	A	G	8	11	19	0	0	19	0	0
8	29799045	.	C	T	4	3	7	0	0	7	0	0
8	29799192	.	T	C	9	0	9	0	11	20	0	0
8	29801150	.	C	G	2	4	6	0	0	6	0	0
8	29806615	.	G	A	5	3	8	0	0	8	0	0
8	29819604	.	C	T	0	8	8	0	4	12	0	0
8	29819610	.	C	T	5	8	13	0	0	13	0	0
8	29851592	.	T	G	8	3	11	0	1	12	0	0
8	29875544	.	A	T	1	1	2	0	1	3	0	0
8	29875593	.	C	G	2	2	4	0	0	4	0	0
8	29898834	.	T	C	3	0	3	0	2	5	0	0
8	29899027	.	G	A	3	3	6	0	0	6	0	0
8	29899082	.	C	T	1	10	11	0	3	14	0	0
8	29899087	.	G	C	4	0	4	0	10	14	0	0
8	29899117	.	G	A	7	9	16	0	0	16	0	0
8	29899209	.	T	C	4	6	10	0	0	10	0	0
8	29899248	.	T	C	4	5	9	0	0	9	0	0
8	29899318	.	T	C	4	10	14	0	1	15	0	0
8	29899477	.	C	G	8	8	16	0	0	16	0	0
8	29899543	.	A	G	1	6	7	0	0	7	0	0
8	29902962	.	T	C	4	0	4	0	6	10	0	0
8	29904949	.	G	A	0	3	3	0	0	3	0	0
8	29904952	.	C	A	0	3	3	0	0	3	0	0
8	29907648	.	A	C	1	2	3	0	0	3	0	0
8	29911381	.	G	T	2	6	8	0	2	10	0	0
8	29923997	.	C	T	0	2	2	0	2	4	0	0
8	29927023	.	A	C	1	1	2	0	0	2	0	0
8	29927034	.	A	T	0	1	1	0	0	1	0	0
8	30021383	.	C	T	0	1	1	0	0	1	0	0
8	30021416	.	A	G	2	0	2	0	3	5	0	0
8	30022393	.	G	T	1	1	2	0	0	2	0	0
8	30063293	.	G	A	0	4	4	0	4	8	0	0
8	30065903	.	G	A	7	3	10	0	0	10	0	0
8	30159394	.	G	C	2	2	4	0	0	4	0	0
8	30326441	.	C	T	2	3	5	0	0	5	0	0
8	30326544	.	A	T	4	2	6	0	1	7	0	0
8	30326557	.	A	T	5	2	7	0	0	7	0	0
8	30326594	.	T	C	3	2	5	0	1	6	0	0
8	30330694	.	A	T	4	2	6	0	1	7	0	0
8	30338857	.	G	A	8	6	14	0	0	14	0	0
8	30338887	.	G	A	3	6	9	0	0	9	0	0
8	30358354	.	G	A	3	2	5	0	0	5	0	0
8	30358397	.	T	G	2	3	5	0	0	5	0	0
8	30425723	.	T	A	3	4	7	0	0	7	0	0
8	30426211	.	C	A	2	4	6	0	0	6	0	0
8	30453799	.	T	A	1	2	3	0	0	3	0	0
8	30501524	.	C	T	3	2	5	0	0	5	0	0
8	30502189	.	G	A	0	3	3	0	1	4	0	0
8	30546080	.	T	C	1	1	2	0	0	2	0	0
8	30546140	.	C	T	2	2	4	0	0	4	0	0
8	30560867	.	C	T	2	1	3	0	0	3	0	0
8	30560889	.	C	T	3	2	5	0	0	5	0	0
8	30570483	.	T	C	3	6	9	0	0	9	0	0
8	30570496	.	G	A	4	4	8	0	0	8	0	0
8	30570674	.	T	C	1	0	1	0	0	1	0	0
8	30576118	.	G	A	2	0	2	0	0	2	0	0
8	30590805	.	A	G	4	2	6	0	0	6	0	0
8	30593538	.	A	G	11	0	11	0	10	21	0	0
8	30600668	.	G	C	2	1	3	0	0	3	0	0
8	30620073	.	C	T	1	1	2	0	0	2	0	0
8	30621203	.	A	T	4	2	6	0	0	6	0	0
8	30623106	.	T	C	2	3	5	0	0	5	0	0
8	30624247	.	G	A	1	1	2	0	0	2	0	0
8	30624340	.	T	C	4	3	7	0	0	7	0	0
8	30652064	.	T	G	3	0	3	0	2	5	0	0
8	30661568	.	G	A	0	11	11	0	6	17	0	0
8	30661645	.	G	A	4	13	17	0	1	18	0	0
8	30661762	.	A	G	3	0	3	0	6	9	0	0
8	30662366	.	A	T	5	4	9	0	0	9	0	0
8	30662417	.	C	T	3	5	8	0	0	8	0	0
8	30662461	.	C	T	3	11	14	0	0	14	0	0
8	30662505	.	A	T	6	5	11	0	0	11	0	0
8	30662713	.	C	T	1	4	5	0	0	5	0	0
8	30681332	.	T	C	1	2	3	0	0	3	0	0
8	30730803	.	C	A	2	2	4	0	0	4	0	0
8	30730974	.	A	G	6	3	9	0	0	9	0	0
8	30731158	.	T	G	6	3	9	0	0	9	0	0
8	30731197	.	G	T	5	2	7	0	0	7	0	0
8	30731362	.	C	T	3	3	6	0	0	6	0	0
8	30731709	.	A	C	6	5	11	0	0	11	0	0
8	30731763	.	A	G	1	2	3	0	0	3	0	0
8	30734914	.	G	A	0	3	3	0	0	3	0	0
8	30742130	.	C	T	0	5	5	0	5	10	0	0
8	30744528	.	C	T	1	1	2	0	0	2	0	0
8	30758304	.	G	A	2	2	4	0	0	4	0	0
8	30758334	.	T	C	3	3	6	0	0	6	0	0
8	30758485	.	A	G	1	2	3	0	0	3	0	0
8	30758557	.	C	T	4	4	8	0	0	8	0	0
8	30764690	.	C	G	0	1	1	0	0	1	0	0
8	30769576	.	T	C	0	1	1	0	0	1	0	0
8	30921457	.	C	G	2	5	7	0	0	7	0	0
8	30921546	.	G	T	1	8	9	0	0	9	0	0
8	30928624	.	G	A	4	4	8	0	0	8	0	0
8	30928987	.	C	T	6	13	19	0	2	21	0	0
8	30929006	.	T	A	6	11	17	0	1	18	0	0
8	30929143	.	T	A	6	9	15	0	0	15	0	0
8	30929261	.	C	T	13	4	17	0	1	18	0	0
8	30929267	.	A	G	13	0	13	0	4	17	0	0
8	30929313	.	C	T	14	5	19	0	0	19	0	0
8	30929886	.	A	G	13	4	17	0	1	18	0	0
8	30938396	.	T	C	2	4	6	0	1	7	0	0
8	30938408	.	T	A	7	6	13	0	1	14	0	0
8	30940072	.	T	G	9	11	20	0	0	20	0	0
8	30949969	.	C	T	7	10	17	0	0	17	0	0
8	30951562	.	G	A	0	1	1	0	0	1	0	0
8	30960906	.	G	C	1	0	1	0	2	3	0	0
8	30960975	.	G	A	2	4	6	0	2	8	0	0
8	30961032	.	T	C	1	3	4	0	0	4	0	0
8	30962897	.	C	T	0	3	3	0	4	7	0	0
8	30963942	.	G	A	2	4	6	0	0	6	0	0
8	30963943	.	G	A	2	4	6	0	0	6	0	0
8	30964038	.	G	A	3	2	5	0	1	6	0	0
8	31008426	.	G	A	0	11	11	0	18	29	0	0
8	31008514	.	G	C	9	8	17	0	0	17	0	0
8	31008525	.	A	T	7	8	15	0	1	16	0	0
8	31010623	.	A	C	2	2	4	0	0	4	0	0
8	31010648	.	T	C	5	7	12	0	0	12	0	0
8	31010988	.	T	A	7	8	15	0	0	15	0	0
8	31012948	.	A	C	10	17	27	0	4	31	0	0
8	31013027	.	C	T	15	11	26	0	0	26	0	0
8	31013220	.	A	G	7	5	12	0	0	12	0	0
8	31013318	.	C	T	5	3	8	0	0	8	0	0
8	31013319	.	G	A	0	3	3	0	5	8	0	0
8	31013493	.	A	C	2	1	3	0	0	3	0	0
8	31013525	.	A	T	1	2	3	0	0	3	0	0
8	31013547	.	A	G	1	3	4	0	0	4	0	0
8	31030838	.	G	C	1	7	8	0	0	8	0	0
8	31031068	.	A	G	6	17	23	0	0	23	0	0
8	31031180	.	T	G	3	8	11	0	1	12	0	0
8	31031639	.	C	T	1	10	11	0	10	21	0	0
8	31031740	.	A	G	16	14	30	0	1	31	0	0
8	31032510	.	G	A	3	3	6	0	0	6	0	0
8	31033861	.	A	T	7	18	25	0	0	25	0	0
8	31034924	.	A	G	4	6	10	0	1	11	0	0
8	31036057	.	G	A	2	1	3	0	0	3	0	0
8	31037647	.	A	G	2	2	4	0	1	5	0	0
8	31038890	.	C	T	3	1	4	0	1	5	0	0
8	31040175	.	A	G	10	6	16	0	0	16	0	0
8	31040211	.	A	G	5	3	8	0	0	8	0	0
8	31040765	.	T	C	9	3	12	0	0	13	1	0
8	31040988	.	C	A	4	4	8	0	1	9	0	0
8	31041913	.	G	A	2	1	3	0	0	3	0	0
8	31042318	.	G	A	1	0	1	0	0	1	0	0
8	31044577	.	A	C	3	4	7	0	0	7	0	0
8	31048748	.	G	T	1	0	1	0	0	1	0	0
8	31119730	.	A	G	2	6	8	0	1	9	0	0
8	31119865	.	T	C	6	4	10	0	1	11	0	0
8	31119909	.	T	G	13	1	14	0	12	27	1	0
8	31131277	.	A	G	2	2	4	0	0	4	0	0
8	31131394	.	A	C	2	4	6	0	2	8	0	0
8	31135892	.	A	G	17	9	26	0	0	26	0	0
8	31135934	.	C	T	7	1	8	0	1	9	0	0
8	31139439	.	C	T	1	0	1	0	0	1	0	0
8	31142311	.	C	T	27	20	47	0	0	47	0	0
8	31145897	.	C	T	28	26	54	0	1	55	0	0
8	31145940	.	G	C	25	28	53	0	1	54	0	0
8	31145948	.	G	A	25	27	52	0	4	56	0	0
8	31146748	.	G	A	11	34	45	0	1	46	0	0
8	31146805	.	T	C	16	26	42	0	1	43	0	0
8	31146862	.	T	A	20	14	34	0	2	36	0	0
8	31146913	.	G	A	19	16	35	0	0	35	0	0
8	31147159	.	C	T	22	37	59	0	1	60	0	0
8	31147208	.	C	A	16	30	46	0	3	49	0	0
8	31147241	.	A	T	22	22	44	0	0	44	0	0
8	31147315	.	C	T	12	11	23	0	0	23	0	0
8	31147380	.	T	G	17	16	33	1	0	34	0	0
8	31147651	.	C	T	18	18	36	0	1	37	0	0
8	31147898	.	G	A	14	27	41	0	2	43	0	0
8	31250357	.	A	G	16	0	16	0	11	27	0	0
8	31250384	.	T	G	15	12	27	0	2	29	0	0
8	31251354	.	T	C	10	17	27	0	0	27	0	0
8	31251426	.	T	C	11	12	23	0	2	25	0	0
8	31251510	.	C	A	24	19	43	0	0	43	0	0
8	31251555	.	G	A	0	15	15	0	16	31	0	0
8	31251792	.	G	C	0	15	15	0	15	30	0	0
8	31251873	.	T	C	18	12	30	0	0	30	0	0
8	31253582	.	C	T	15	9	24	0	1	25	0	0
8	31253729	.	T	A	8	7	15	0	1	16	0	0
8	31253911	.	A	G	2	2	4	0	0	4	0	0
8	31254046	.	C	A	9	13	22	0	1	24	1	0
8	31254163	.	G	A	17	15	32	0	0	32	0	0
8	31254176	.	A	T	11	10	21	0	0	21	0	0
8	31367705	.	C	A	2	2	4	0	0	4	0	0
8	31367747	.	T	C	6	2	8	0	0	8	0	0
8	31368279	.	T	G	6	8	14	0	0	14	0	0
8	31368557	.	A	G	8	8	16	0	0	16	0	0
8	31368611	.	T	C	3	3	6	0	0	6	0	0
8	31368865	.	T	A	5	4	9	0	0	9	0	0
8	31375195	.	A	G	0	3	3	0	0	3	0	0
8	31375338	.	T	C	3	4	7	0	0	7	0	0
8	31375405	.	T	C	2	1	3	0	0	3	0	0
8	31375434	.	T	A	4	4	8	0	0	8	0	0
8	31375524	.	G	C	7	7	14	0	0	14	0	0
8	31375529	.	T	C	7	6	13	0	0	13	0	0
8	31375670	.	T	G	12	26	38	0	1	39	0	0
8	31375928	.	A	G	2	6	8	0	0	8	0	0
8	31376117	.	T	G	4	11	15	0	0	15	0	0
8	31376125	.	A	T	4	13	17	0	0	17	0	0
8	31381731	.	T	A	2	1	3	0	0	3	0	0
8	31387695	.	A	G	10	6	16	0	0	16	0	0
8	31387728	.	T	G	14	7	21	0	1	22	0	0
8	31388280	.	C	T	2	3	5	0	0	5	0	0
8	31390061	.	T	C	3	1	4	0	0	4	0	0
8	31393376	.	G	A	1	5	6	0	0	6	0	0
8	31395471	.	A	G	3	2	5	0	0	5	0	0
8	31395485	.	T	C	2	3	5	0	1	6	0	0
8	31395587	.	C	A	0	5	5	0	3	8	0	0
8	31395606	.	C	T	0	5	5	0	4	9	0	0
8	31395644	.	T	C	2	3	5	0	0	5	0	0
8	31395713	.	C	A	3	3	6	0	0	6	0	0
8	31395884	.	A	G	1	2	3	0	0	3	0	0
8	31400775	.	A	G	1	0	1	0	0	1	0	0
8	31407168	.	C	A	3	12	15	0	2	17	0	0
8	31407294	.	A	G	4	3	7	0	0	7	0	0
8	31411089	.	C	T	0	7	7	0	9	16	0	0
8	31411545	.	A	T	6	7	13	0	1	14	0	0
8	31411578	.	G	A	9	6	15	0	2	17	0	0
8	31411646	.	T	A	3	1	4	0	0	4	0	0
8	31437626	.	C	T	18	21	39	0	1	40	0	0
8	31437768	.	C	G	4	6	10	0	0	10	0	0
8	31441698	.	C	A	22	26	48	0	3	51	0	0
8	31441814	.	G	A	27	25	52	0	3	55	0	0
8	31441850	.	T	C	30	22	52	0	6	58	0	0
8	31441870	.	T	C	22	33	55	0	0	55	0	0
8	31442000	.	G	A	32	23	55	0	4	59	0	0
8	31442523	.	C	G	18	14	32	0	1	33	0	0
8	31442595	.	G	A	26	12	38	0	0	38	0	0
8	31442648	.	C	T	23	25	48	0	2	50	0	0
8	31442794	.	G	T	24	11	35	0	1	36	0	0
8	31442886	.	T	C	21	27	48	0	0	48	0	0
8	31711411	.	T	C	10	0	10	0	16	26	0	0
8	31716001	.	G	T	0	4	4	0	0	4	0	0
8	31716221	.	C	G	0	3	3	0	3	6	0	0
8	31719059	.	C	T	6	6	12	0	0	12	0	0
8	31730419	.	G	T	10	9	19	0	0	19	0	0
8	31730762	.	C	A	15	18	33	0	1	34	0	0
8	31730771	.	C	T	11	15	26	0	1	27	0	0
8	31730801	.	C	T	2	7	9	0	1	10	0	0
8	31733870	.	C	T	5	7	12	0	0	12	0	0
8	31760785	.	C	T	4	1	5	0	0	5	0	0
8	31765077	.	C	T	1	1	2	0	0	2	0	0
8	31817931	.	A	C	1	0	1	0	0	1	0	0
8	31818018	.	T	C	18	13	31	0	0	31	0	0
8	31818022	.	G	A	0	14	14	0	19	33	0	0
8	31818083	.	A	T	12	15	27	0	1	28	0	0
8	31818196	.	G	A	8	23	31	0	1	32	0	0
8	31818267	.	T	G	16	16	32	0	1	33	0	0
8	31818273	.	T	A	13	15	28	0	2	30	0	0
8	31818335	.	G	A	6	11	17	0	0	17	0	0
8	31818425	.	A	C	9	10	19	0	0	19	0	0
8	31818456	.	A	G	4	11	15	0	1	16	0	0
8	31818460	.	A	G	6	11	17	0	0	17	0	0
8	31818748	.	T	C	3	18	21	0	0	21	0	0
8	31818800	.	G	A	6	9	15	0	0	15	0	0
8	31818835	.	T	G	3	7	10	0	2	12	0	0
8	31851336	.	A	G	7	16	23	0	1	24	0	0
8	31851582	.	A	G	5	5	10	0	0	10	0	0
8	31851594	.	T	C	1	2	3	0	0	3	0	0
8	31861425	.	A	G	12	10	22	0	0	22	0	0
8	31861479	.	C	T	17	18	35	0	0	35	0	0
8	31861580	.	G	C	8	18	26	0	0	27	1	0
8	31861616	.	T	A	11	19	30	0	0	31	1	0
8	31862063	.	T	C	18	25	43	0	0	43	0	0
8	31862165	.	C	T	15	15	30	0	0	30	0	0
8	31862384	.	A	G	13	19	32	0	2	34	0	0
8	31862407	.	G	A	14	24	38	0	0	38	0	0
8	31862670	.	T	A	14	10	24	0	3	27	0	0
8	31885790	.	T	C	1	2	3	0	0	3	0	0
8	31898671	.	A	G	0	1	1	0	0	1	0	0
8	31899124	.	A	T	1	2	3	0	0	3	0	0
8	31901659	.	A	G	4	10	14	0	0	14	0	0
8	31901757	.	T	C	1	3	4	0	0	4	0	0
8	31906886	.	G	A	0	1	1	0	0	1	0	0
8	31906910	.	C	A	7	6	13	0	0	13	0	0
8	31914427	.	A	T	1	1	2	0	0	2	0	0
8	31919101	.	G	C	3	3	6	0	0	6	0	0
8	31919110	.	A	C	3	0	3	0	3	6	0	0
8	31919548	.	C	T	9	15	24	0	1	25	0	0
8	31919558	.	A	C	8	17	25	0	2	27	0	0
8	31941853	.	C	T	10	8	18	0	1	19	0	0
8	31942723	.	G	A	8	8	16	0	0	16	0	0
8	32028856	.	G	T	7	5	12	0	1	13	0	0
8	32028921	.	T	A	9	8	17	0	0	17	0	0
8	32029044	.	T	G	3	5	8	0	0	8	0	0
8	32029258	.	T	C	5	3	8	0	0	8	0	0
8	32029663	.	C	T	5	2	7	0	0	7	0	0
8	32029692	.	T	C	4	4	8	0	0	8	0	0
8	32029699	.	T	C	4	0	4	0	4	8	0	0
8	32030341	.	A	G	5	7	12	0	0	12	0	0
8	32030771	.	T	G	5	7	12	0	0	12	0	0
8	32191744	.	G	A	1	2	3	0	0	3	0	0
8	32354596	.	G	A	1	0	1	0	0	1	0	0
8	32390401	.	A	G	2	2	4	0	0	4	0	0
8	32393278	.	C	T	2	2	4	0	0	4	0	0
8	32483905	.	G	C	1	1	2	0	0	2	0	0
8	32486956	.	C	T	0	15	15	0	15	30	0	0
8	32497755	.	T	C	5	4	9	0	1	10	0	0
8	32501541	.	A	G	8	5	13	0	0	13	0	0
8	32516233	.	T	C	4	2	6	0	0	6	0	0
8	32516240	.	G	A	4	2	6	0	0	6	0	0
8	32516331	.	C	T	8	3	11	0	0	11	0	0
8	32516557	.	T	C	8	8	16	0	0	16	0	0
8	32516629	.	A	C	9	4	13	0	0	13	0	0
8	32588542	.	G	T	0	1	1	0	1	2	0	0
8	32596634	.	A	T	1	1	2	0	0	2	0	0
8	32598963	.	C	A	1	7	8	0	0	8	0	0
8	32599121	.	G	T	6	9	15	0	1	16	0	0
8	32599147	.	G	A	11	8	19	0	0	19	0	0
8	32599288	.	T	C	1	4	5	0	0	5	0	0
8	32599295	.	A	G	1	4	5	0	1	6	0	0
8	32599363	.	T	C	4	4	8	0	0	8	0	0
8	32599421	.	T	C	7	9	16	0	1	17	0	0
8	32599432	.	T	G	8	11	19	0	1	20	0	0
8	32599484	.	C	T	8	9	17	0	1	18	0	0
8	32599556	.	C	G	7	9	16	0	0	16	0	0
8	32914748	.	G	T	12	12	24	0	0	24	0	0
8	32914853	.	C	T	3	6	9	0	0	9	0	0
8	32914931	.	T	C	6	2	8	0	0	8	0	0
8	32916957	.	T	A	1	2	3	0	0	3	0	0
8	32925670	.	T	G	5	5	10	0	0	10	0	0
8	32925721	.	A	G	2	0	2	0	0	2	0	0
8	32930789	.	A	G	0	4	4	0	1	5	0	0
8	32930837	.	C	T	6	8	14	0	0	14	0	0
8	33113932	.	A	G	6	1	7	0	2	9	0	0
8	33114094	.	T	A	5	4	9	0	0	9	0	0
8	33261014	.	T	A	1	3	4	0	0	4	0	0
8	33381410	.	C	G	0	1	1	0	0	1	0	0
8	33896463	.	A	T	1	5	6	0	0	6	0	0
8	33896471	.	T	A	5	1	6	0	0	6	0	0
8	33896964	.	T	G	15	12	27	0	0	27	0	0
8	33910008	.	G	A	20	20	40	0	2	42	0	0
8	33918520	.	C	T	8	3	11	0	3	14	0	0
8	33918631	.	C	T	10	6	16	0	2	18	0	0
8	33924333	.	G	T	14	20	34	0	2	36	0	0
8	34051619	.	G	T	19	12	31	0	3	34	0	0
8	34051719	.	G	A	14	10	24	0	1	25	0	0
8	34051795	.	T	C	18	12	30	0	0	30	0	0
8	34342123	.	G	C	6	0	6	0	11	17	0	0
8	34342376	.	G	A	9	8	17	0	0	17	0	0
8	34345285	.	G	A	5	5	10	0	0	10	0	0
8	34345556	.	A	G	0	1	1	0	0	1	0	0
8	34348958	.	A	C	1	1	2	0	0	2	0	0
8	34376669	.	A	G	2	0	2	0	0	2	0	0
8	34394513	.	G	A	1	1	2	0	0	2	0	0
8	34397046	.	C	T	3	0	3	0	0	3	0	0
8	35357568	.	G	A	2	1	3	0	1	4	0	0
8	35759276	.	G	A	0	6	6	0	2	8	0	0
8	35759444	.	C	T	3	5	8	0	0	8	0	0
8	35759524	.	A	G	4	3	7	0	0	7	0	0
8	35759726	.	C	T	3	2	5	0	0	5	0	0
8	35760328	.	C	T	1	2	3	0	0	3	0	0
8	35760338	.	T	C	2	2	4	0	0	4	0	0
8	35960479	.	T	A	0	2	2	0	0	2	0	0
8	36061541	.	C	T	0	2	2	0	1	3	0	0
8	36061577	.	T	C	1	2	3	0	0	3	0	0
8	36061579	.	A	G	1	2	3	0	0	3	0	0
8	36466904	.	T	A	7	8	15	2	0	17	0	0
8	36473141	.	G	T	8	3	11	0	0	11	0	0
8	36473144	.	A	G	7	3	10	0	0	10	0	0
8	36473183	.	G	A	7	5	12	0	1	13	0	0
8	36473189	.	G	A	7	6	13	0	0	13	0	0
8	36473313	.	G	A	3	8	11	0	0	11	0	0
8	36473319	.	T	C	2	6	8	0	2	10	0	0
8	36474230	.	T	G	0	3	3	0	0	3	0	0
8	36474411	.	A	G	5	16	21	0	1	23	1	0
8	36500330	.	T	A	0	1	1	0	0	1	0	0
8	36504530	.	C	T	1	3	4	0	0	4	0	0
8	36504728	.	T	G	1	6	7	0	0	7	0	0
8	36507260	.	T	G	2	2	4	0	0	4	0	0
8	36507344	.	C	T	2	2	4	0	0	4	0	0
8	36507449	.	T	C	5	2	7	0	0	7	0	0
8	36507567	.	C	A	2	5	7	0	0	7	0	0
8	36507764	.	G	A	3	1	4	0	0	4	0	0
8	36507770	.	G	A	0	1	1	0	4	5	0	0
8	36509865	.	A	G	1	0	1	0	0	1	0	0
8	36512716	.	G	A	0	3	3	0	4	7	0	0
8	36515721	.	A	G	4	6	10	0	0	10	0	0
8	36561939	.	C	T	8	7	15	0	0	15	0	0
8	36561942	.	A	T	6	9	15	0	2	17	0	0
8	36561987	.	C	T	9	6	15	0	0	15	0	0
8	36562293	.	C	T	16	6	22	0	0	22	0	0
8	36562328	.	C	T	8	4	12	0	0	12	0	0
8	36562451	.	A	G	1	0	1	0	0	1	0	0
8	36563192	.	G	A	1	1	2	0	0	2	0	0
8	36564746	.	C	T	3	3	6	0	0	6	0	0
8	36566182	.	T	C	21	15	36	0	1	37	0	0
8	36566353	.	T	C	10	5	15	0	0	15	0	0
8	36567193	.	T	A	13	8	21	0	0	21	0	0
8	36567208	.	A	T	17	11	28	0	1	29	0	0
8	36567316	.	T	C	21	10	31	0	2	33	0	0
8	36567349	.	A	C	6	1	7	0	5	12	0	0
8	36568304	.	C	T	14	13	27	0	0	27	0	0
8	36568492	.	T	C	1	2	3	0	0	3	0	0
8	36568561	.	A	G	6	4	10	0	0	10	0	0
8	36568755	.	T	C	2	0	2	0	0	2	0	0
8	36570147	.	T	C	5	3	8	0	0	8	0	0
8	36570866	.	A	G	0	3	3	0	0	3	0	0
8	36570884	.	G	A	0	4	4	0	0	4	0	0
8	36571018	.	A	C	3	0	3	0	0	3	0	0
8	36571153	.	G	A	1	1	2	0	0	2	0	0
8	36571161	.	A	G	2	1	3	0	0	3	0	0
8	36573418	.	T	C	2	1	3	0	0	3	0	0
8	36573429	.	A	C	2	2	4	0	0	4	0	0
8	36573472	.	T	C	0	2	2	0	0	2	0	0
8	36573796	.	C	T	3	3	6	0	0	6	0	0
8	36573808	.	A	T	4	3	7	0	0	7	0	0
8	36577187	.	G	T	2	3	5	0	0	5	0	0
8	36583834	.	T	C	2	3	5	0	0	5	0	0
8	36583877	.	C	A	3	7	10	0	1	11	0	0
8	36587934	.	A	G	5	8	13	0	0	13	0	0
8	36587936	.	A	G	5	0	5	0	8	13	0	0
8	36587970	.	C	A	6	11	17	0	1	18	0	0
8	36587981	.	G	T	5	10	15	0	0	15	0	0
8	36588600	.	G	T	1	2	3	0	1	4	0	0
8	36589226	.	T	C	4	7	11	0	0	11	0	0
8	36592011	.	A	G	5	6	11	0	2	13	0	0
8	36592018	.	A	G	6	8	14	0	1	15	0	0
8	36592101	.	T	C	5	0	5	0	6	11	0	0
8	36592237	.	T	C	3	7	10	0	0	10	0	0
8	36592374	.	A	G	4	3	7	0	0	7	0	0
8	36600801	.	C	G	6	4	10	0	0	10	0	0
8	36600803	.	T	G	6	4	10	0	0	10	0	0
8	36600840	.	T	C	10	0	10	0	11	21	0	0
8	36602459	.	C	T	1	3	4	0	0	4	0	0
8	36613882	.	G	T	6	9	15	0	0	15	0	0
8	36617635	.	C	G	5	3	8	0	1	9	0	0
8	36617669	.	A	G	9	6	15	0	1	16	0	0
8	36621687	.	A	G	1	2	3	0	0	3	0	0
8	36621689	.	G	A	1	2	3	0	0	3	0	0
8	36621727	.	A	G	1	0	1	0	2	3	0	0
8	36666851	.	A	G	1	0	1	0	3	4	0	0
8	36743530	.	G	A	0	2	2	0	2	4	0	0
8	36746770	.	T	A	2	2	4	0	0	4	0	0
8	36746967	.	T	C	1	3	4	0	0	4	0	0
8	36781596	.	A	G	3	0	3	0	2	5	0	0
8	36781722	.	C	T	2	1	3	0	0	3	0	0
8	36803574	.	C	A	11	15	26	0	1	27	0	0
8	36803850	.	T	C	0	1	1	0	0	1	0	0
8	36951346	.	C	T	20	5	25	0	0	25	0	0
8	36951481	.	C	T	14	11	25	0	1	26	0	0
8	36951610	.	T	C	7	12	19	0	1	20	0	0
8	36952015	.	A	G	18	1	19	0	30	49	0	0
8	36953884	.	A	G	3	5	8	0	0	8	0	0
8	36953947	.	C	T	8	5	13	0	0	13	0	0
8	36953950	.	G	C	8	5	13	0	0	13	0	0
8	36956254	.	C	T	14	12	26	0	1	27	0	0
8	36956269	.	T	C	13	10	23	0	0	23	0	0
8	36956516	.	G	A	1	3	4	0	0	4	0	0
8	36956540	.	C	A	5	5	10	0	1	11	0	0
8	36964126	.	G	A	10	15	25	0	2	27	0	0
8	36974076	.	C	A	16	13	29	0	0	29	0	0
8	36976089	.	T	C	8	9	17	0	0	17	0	0
8	36976557	.	G	A	19	13	32	0	3	35	0	0
8	36976966	.	C	T	17	24	41	0	0	41	0	0
8	36977170	.	C	T	16	20	36	0	2	38	0	0
8	36994205	.	T	C	2	0	2	0	0	2	0	0
8	36994223	.	A	G	3	1	4	0	0	4	0	0
8	37001591	.	T	A	0	3	3	0	0	3	0	0
8	37007527	.	T	C	1	0	1	0	0	1	0	0
8	37010662	.	T	C	4	7	11	0	0	11	0	0
8	37010668	.	C	T	4	6	10	0	1	11	0	0
8	37012762	.	T	A	4	7	11	0	1	12	0	0
8	37012825	.	C	T	7	5	12	0	0	12	0	0
8	37012872	.	C	G	3	0	3	0	0	3	0	0
8	37013093	.	A	G	9	5	14	0	1	15	0	0
8	37013210	.	G	A	5	6	11	0	0	11	0	0
8	37013255	.	T	C	3	6	9	0	1	10	0	0
8	37013282	.	T	C	4	7	11	0	0	11	0	0
8	37013833	.	C	T	12	7	19	0	1	20	0	0
8	37013877	.	A	T	4	0	4	0	0	4	0	0
8	37014535	.	G	C	2	0	2	0	0	2	0	0
8	37014582	.	T	C	5	4	9	0	0	9	0	0
8	37016584	.	G	T	1	19	20	0	13	33	0	0
8	37016658	.	C	A	15	13	28	0	6	34	0	0
8	37016752	.	A	G	11	8	19	0	0	19	0	0
8	37016790	.	T	C	10	13	23	0	0	23	0	0
8	37017149	.	G	A	1	4	5	0	0	5	0	0
8	37017159	.	C	T	1	3	4	0	0	4	0	0
8	37019059	.	G	A	12	13	25	0	1	26	0	0
8	37019113	.	G	A	12	15	27	0	2	29	0	0
8	37025566	.	C	T	15	13	28	0	1	29	0	0
8	37025576	.	A	T	15	11	26	0	0	26	0	0
8	37025614	.	T	A	5	7	12	0	1	13	0	0
8	37025633	.	A	G	1	0	1	0	1	2	0	0
8	37025896	.	T	C	8	11	19	0	1	20	0	0
8	37038912	.	T	C	3	3	6	0	0	6	0	0
8	37038963	.	G	A	2	4	6	0	0	6	0	0
8	37038990	.	C	T	1	3	4	0	0	4	0	0
8	37060000	.	C	T	6	2	8	0	0	8	0	0
8	37060012	.	C	T	0	2	2	0	6	8	0	0
8	37060149	.	G	T	2	3	5	0	1	6	0	0
8	37060234	.	T	A	3	7	10	0	0	10	0	0
8	37060305	.	C	T	0	6	6	0	8	14	0	0
8	37060580	.	G	A	7	14	21	0	0	21	0	0
8	37060595	.	A	T	8	12	20	0	2	22	0	0
8	37060702	.	C	T	3	10	13	0	0	13	0	0
8	37068600	.	T	G	1	1	2	0	1	3	0	0
8	37075536	.	A	G	2	2	4	0	0	4	0	0
8	37075742	.	T	A	2	2	4	0	0	4	0	0
8	37082888	.	C	A	1	4	5	0	1	6	0	0
8	37082927	.	A	G	2	3	5	0	0	5	0	0
8	37086959	.	C	T	1	2	3	0	0	3	0	0
8	37101319	.	C	T	1	1	2	0	0	2	0	0
8	37101370	.	G	C	6	4	10	0	0	10	0	0
8	37232135	.	G	C	7	0	7	0	5	12	0	0
8	37232289	.	T	A	8	14	22	0	1	23	0	0
8	37232312	.	G	C	5	15	20	0	0	20	0	0
8	37232419	.	G	A	13	10	23	0	0	23	0	0
8	37232487	.	A	C	19	17	36	0	4	40	0	0
8	37238801	.	C	G	3	0	3	0	0	3	0	0
8	37242374	.	A	T	3	6	9	0	1	10	0	0
8	37242438	.	T	C	1	2	3	0	0	3	0	0
8	37280748	.	T	C	10	10	20	0	0	20	0	0
8	37280752	.	C	T	11	9	20	0	0	20	0	0
8	37280809	.	G	T	8	10	18	0	0	18	0	0
8	37280845	.	G	A	7	12	19	0	1	20	0	0
8	37280865	.	C	T	7	9	16	0	0	16	0	0
8	37280923	.	T	A	12	4	16	0	2	18	0	0
8	37281109	.	T	C	8	4	12	0	0	12	0	0
8	37281382	.	A	T	3	2	5	0	2	7	0	0
8	37281440	.	T	A	8	11	19	0	0	19	0	0
8	37281444	.	T	A	7	13	20	0	1	22	1	0
8	37281547	.	G	A	11	16	27	0	2	29	0	0
8	37282088	.	C	T	11	10	21	0	0	21	0	0
8	37282110	.	A	T	9	7	16	0	0	16	0	0
8	37282126	.	G	T	7	8	15	0	0	16	1	0
8	37282407	.	G	A	16	13	29	0	0	29	0	0
8	37282848	.	C	T	14	16	30	0	1	31	0	0
8	37282888	.	G	A	16	13	29	0	1	30	0	0
8	37282986	.	G	A	12	8	20	0	0	20	0	0
8	37283016	.	T	A	11	10	21	0	1	22	0	0
8	37283435	.	C	T	0	3	3	0	5	8	0	0
8	37283452	.	C	T	5	2	7	0	1	8	0	0
8	37283486	.	A	G	7	3	10	0	0	10	0	0
8	37283487	.	A	C	7	3	10	0	0	10	0	0
8	37283663	.	C	T	6	5	11	0	3	14	0	0
8	37283743	.	A	G	8	7	15	0	1	16	0	0
8	37283748	.	G	T	6	8	14	0	1	15	0	0
8	37283836	.	A	G	5	2	7	0	1	8	0	0
8	37284386	.	A	G	24	19	43	0	0	43	0	0
8	37284428	.	T	G	19	20	39	0	4	43	0	0
8	37284478	.	A	G	15	14	29	0	3	32	0	0
8	37294894	.	A	T	14	18	32	0	1	33	0	0
8	37294930	.	A	G	9	8	17	0	5	22	0	0
8	37295395	.	C	T	0	9	9	0	9	18	0	0
8	37303244	.	G	A	1	0	1	0	0	1	0	0
8	37303271	.	A	C	3	0	3	0	5	8	0	0
8	37303673	.	T	C	5	5	10	0	0	10	0	0
8	37303891	.	G	A	0	6	6	0	0	6	0	0
8	37306114	.	A	G	1	1	2	0	0	2	0	0
8	37317224	.	G	A	2	5	7	0	0	7	0	0
8	37317248	.	G	A	4	7	11	0	0	11	0	0
8	37317290	.	G	T	3	7	10	0	1	11	0	0
8	37320810	.	A	T	3	7	10	0	0	10	0	0
8	37390950	.	T	A	13	13	26	1	1	28	0	0
8	37447683	.	T	A	1	4	5	0	0	5	0	0
8	37447751	.	C	T	2	0	2	0	0	2	0	0
8	37453403	.	A	G	3	3	6	0	0	6	0	0
8	37453430	.	T	A	2	3	5	0	0	5	0	0
8	37453646	.	T	A	1	4	5	0	1	6	0	0
8	37456801	.	T	A	1	5	6	0	1	7	0	0
8	37456826	.	C	A	2	3	5	0	0	5	0	0
8	37460616	.	A	T	3	1	4	0	1	5	0	0
8	37460942	.	G	A	3	1	4	0	0	4	0	0
8	37461060	.	C	T	1	1	2	0	0	2	0	0
8	37701082	.	C	T	2	2	4	0	0	4	0	0
8	38191562	.	G	C	2	0	2	0	2	4	0	0
8	38191564	.	G	C	2	2	4	0	0	4	0	0
8	38319906	.	A	T	1	5	6	0	0	6	0	0
8	38319999	.	T	G	1	5	6	0	1	7	0	0
8	38320306	.	T	G	0	2	2	0	0	2	0	0
8	38321269	.	C	T	2	3	5	0	0	5	0	0
8	38321300	.	G	T	3	2	5	0	0	5	0	0
8	38326274	.	G	A	0	1	1	0	0	1	0	0
8	38421515	.	C	A	4	5	9	0	0	9	0	0
8	38421535	.	A	C	5	5	10	0	0	10	0	0
8	38421627	.	T	A	3	2	5	0	0	5	0	0
8	38421640	.	A	T	3	4	7	0	0	7	0	0
8	38421820	.	C	T	7	6	13	0	0	13	0	0
8	38422058	.	G	A	5	11	16	0	0	16	0	0
8	38422439	.	G	A	5	7	12	0	0	12	0	0
8	38422748	.	C	G	5	3	8	0	0	8	0	0
8	38423170	.	T	C	5	1	6	0	2	8	0	0
8	38423210	.	A	G	8	3	11	0	1	12	0	0
8	38423250	.	G	A	8	6	14	0	0	14	0	0
8	38423297	.	A	G	6	7	13	0	0	13	0	0
8	38423373	.	A	T	4	8	12	0	1	13	0	0
8	38423462	.	A	G	8	13	21	0	0	21	0	0
8	38423529	.	C	G	0	6	6	0	8	15	1	0
8	38423617	.	C	T	3	6	9	0	0	9	0	0
8	38430297	.	G	A	2	1	3	0	0	3	0	0
8	38436657	.	G	A	1	0	1	0	0	1	0	0
8	38565008	.	A	G	2	9	11	0	1	12	0	0
8	38565040	.	C	T	6	12	18	0	0	18	0	0
8	38571041	.	T	A	1	2	3	0	0	3	0	0
8	39574982	.	G	A	1	2	3	0	0	3	0	0
8	39575223	.	G	A	1	2	3	0	0	3	0	0
8	39646024	.	A	T	4	6	10	0	0	10	0	0
8	39646768	.	G	A	7	9	16	0	1	17	0	0
8	39646781	.	T	C	5	9	14	0	1	15	0	0
8	39647008	.	A	C	1	6	7	0	0	7	0	0
8	39676552	.	C	T	5	6	11	0	0	11	0	0
8	39693130	.	C	T	3	6	9	0	2	11	0	0
8	39703321	.	G	A	4	3	7	0	0	7	0	0
8	39760860	.	C	T	18	31	49	0	5	54	0	0
8	39765798	.	A	G	34	30	64	0	4	68	0	0
8	39773564	.	T	C	0	1	1	0	0	1	0	0
8	39773605	.	C	T	0	2	2	0	0	2	0	0
8	39773611	.	T	C	0	2	2	0	0	2	0	0
8	39781500	.	A	C	1	2	3	0	0	3	0	0
8	39781517	.	G	C	1	2	3	0	1	4	0	0
8	39786378	.	T	G	1	1	2	0	0	2	0	0
8	39816887	.	C	G	8	4	12	0	0	12	0	0
8	39816992	.	C	T	7	6	13	0	1	14	0	0
8	39817011	.	A	G	5	8	13	0	1	14	0	0
8	39817031	.	T	G	2	7	9	0	0	9	0	0
8	39817054	.	A	T	1	3	4	0	0	4	0	0
8	39822634	.	G	A	4	4	8	0	0	8	0	0
8	39822689	.	T	C	7	2	9	0	0	9	0	0
8	39849439	.	G	T	5	3	8	0	0	8	0	0
8	39849686	.	C	G	4	6	10	0	0	10	0	0
8	39850031	.	C	A	8	4	12	0	0	12	0	0
8	39850251	.	C	T	7	4	11	0	0	11	0	0
8	39858164	.	T	C	1	0	1	0	1	2	0	0
8	39859520	.	T	C	4	0	4	0	3	7	0	0
8	39870765	.	C	T	0	2	2	0	2	4	0	0
8	39870857	.	C	T	2	7	9	0	0	9	0	0
8	39878550	.	C	T	5	2	7	0	0	7	0	0
8	39884127	.	A	T	2	3	5	0	0	5	0	0
8	39884352	.	G	A	6	4	10	0	0	10	0	0
8	39890197	.	T	C	6	5	11	0	0	11	0	0
8	39901781	.	A	G	3	2	5	0	0	5	0	0
8	39951571	.	G	A	7	5	12	0	1	13	0	0
8	39976817	.	C	T	11	9	20	0	0	20	0	0
8	39976850	.	G	C	14	0	14	0	12	26	0	0
8	39977153	.	C	G	21	12	33	0	1	34	0	0
8	39977333	.	G	A	11	17	28	0	1	29	0	0
8	39978559	.	A	G	1	2	3	0	0	3	0	0
8	40004740	.	T	A	1	3	4	0	0	4	0	0
8	40025733	.	C	T	0	1	1	0	0	1	0	0
8	40081408	.	G	C	10	8	18	0	0	18	0	0
8	40081462	.	T	G	13	12	25	0	0	25	0	0
8	40081718	.	T	C	11	10	21	0	0	21	0	0
8	40163223	.	C	T	14	15	29	0	0	29	0	0
8	40178280	.	T	C	1	0	1	0	2	3	0	0
8	40186747	.	A	G	1	5	6	0	0	6	0	0
8	40186982	.	A	T	5	6	11	0	0	11	0	0
8	40189693	.	T	C	2	0	2	0	4	6	0	0
8	40189738	.	A	T	6	3	9	0	0	9	0	0
8	40196220	.	T	C	6	3	9	0	0	9	0	0
8	40196570	.	G	A	2	1	3	0	0	3	0	0
8	40199093	.	A	G	1	0	1	0	0	1	0	0
8	40201496	.	G	A	3	3	6	0	0	6	0	0
8	40204865	.	A	C	1	0	1	0	2	3	0	0
8	40204899	.	T	A	1	2	3	0	0	3	0	0
8	40217948	.	G	A	2	2	4	0	2	6	0	0
8	40226297	.	T	C	2	1	3	0	0	3	0	0
8	40234764	.	C	T	3	5	8	1	0	9	0	0
8	40234830	.	A	G	7	6	13	0	0	13	0	0
8	40234831	.	T	A	7	6	13	0	0	13	0	0
8	40235184	.	A	T	4	5	9	0	0	9	0	0
8	40235244	.	C	T	9	5	14	0	0	14	0	0
8	40235348	.	G	C	8	5	13	0	1	14	0	0
8	40235984	.	A	T	2	2	4	0	0	4	0	0
8	40236448	.	C	A	7	2	9	0	0	9	0	0
8	40236453	.	A	T	7	2	9	0	0	9	0	0
8	40238057	.	G	A	1	2	3	0	0	3	0	0
8	40240922	.	C	G	7	6	13	0	0	13	0	0
8	40241161	.	A	G	13	10	23	0	2	25	0	0
8	40241304	.	C	T	1	19	20	0	11	31	0	0
8	40241364	.	T	G	10	19	29	0	0	29	0	0
8	40241441	.	A	G	13	7	20	6	1	27	0	0
8	40241446	.	A	G	10	10	20	6	1	27	0	0
8	40241640	.	A	T	11	9	20	2	1	23	0	0
8	40241681	.	A	G	13	10	23	0	1	24	0	0
8	40241695	.	T	A	9	6	15	0	2	18	1	0
8	40241718	.	T	C	9	5	14	0	1	15	0	0
8	40241748	.	G	A	5	6	11	2	0	13	0	0
8	40241976	.	C	A	20	21	41	0	2	43	0	0
8	40242005	.	T	G	17	21	38	0	0	38	0	0
8	40242107	.	A	T	19	10	29	0	0	29	0	0
8	40242131	.	A	C	16	8	24	0	0	24	0	0
8	40242243	.	A	C	22	15	37	0	0	37	0	0
8	40242424	.	T	A	16	4	20	0	0	20	0	0
8	40242453	.	G	A	14	6	20	0	0	20	0	0
8	40242613	.	T	A	5	6	11	0	2	13	0	0
8	40242653	.	C	T	5	4	9	0	1	10	0	0
8	40242683	.	A	C	3	6	9	0	0	9	0	0
8	40243052	.	G	C	17	12	29	0	0	29	0	0
8	40243148	.	T	C	11	11	22	0	3	25	0	0
8	40248373	.	T	G	8	6	14	0	0	14	0	0
8	40248673	.	T	C	4	2	6	0	0	6	0	0
8	40248976	.	G	T	5	4	9	0	2	11	0	0
8	40250747	.	C	A	0	15	15	0	10	25	0	0
8	40250798	.	G	A	10	22	32	0	0	32	0	0
8	40251045	.	A	T	10	15	25	0	0	25	0	0
8	40251380	.	G	T	11	9	20	0	0	20	0	0
8	40251700	.	C	G	3	0	3	0	0	3	0	0
8	40254366	.	A	G	10	10	20	0	2	22	0	0
8	40254375	.	T	G	11	11	22	0	2	24	0	0
8	40254499	.	T	C	1	0	1	1	1	3	0	0
8	40270856	.	G	A	4	4	8	0	2	10	0	0
8	40270905	.	A	G	14	9	23	0	0	23	0	0
8	40325798	.	C	T	7	5	12	0	0	12	0	0
8	40326072	.	A	T	14	16	30	0	2	32	0	0
8	40326087	.	A	T	10	17	27	0	4	31	0	0
8	40326128	.	C	T	11	11	22	0	4	26	0	0
8	40326736	.	A	G	11	5	16	0	2	18	0	0
8	40327227	.	A	G	7	5	12	0	0	12	0	0
8	40427065	.	G	A	3	1	4	0	1	5	0	0
8	40427737	.	T	A	1	2	3	0	0	3	0	0
8	40428287	.	C	A	1	4	5	0	0	5	0	0
8	40428966	.	C	T	0	2	2	0	2	4	0	0
8	40433871	.	C	T	1	3	4	0	0	4	0	0
8	40629350	.	C	T	2	3	5	0	1	6	0	0
8	40631442	.	C	G	2	2	4	0	0	4	0	0
8	40632014	.	T	C	6	4	10	0	1	11	0	0
8	40632305	.	C	T	5	4	9	0	2	11	0	0
8	40632313	.	C	G	4	6	10	0	0	10	0	0
8	40632499	.	T	C	7	5	12	0	0	12	0	0
8	40632509	.	C	A	7	7	14	0	0	14	0	0
8	40632534	.	G	A	7	7	14	0	0	14	0	0
8	40632545	.	C	T	7	7	14	0	0	14	0	0
8	40645113	.	C	T	4	7	11	0	0	11	0	0
8	40645602	.	A	G	8	14	22	0	0	22	0	0
8	40645723	.	G	A	6	14	20	0	1	21	0	0
8	40646283	.	C	T	1	9	10	0	1	11	0	0
8	41186524	.	C	T	0	4	4	0	2	6	0	0
8	41193270	.	G	A	2	0	2	0	1	3	0	0
8	41194542	.	C	G	1	2	3	0	0	3	0	0
8	41197155	.	A	G	2	3	5	0	0	5	0	0
8	41206757	.	T	A	1	3	4	0	0	4	0	0
8	41206801	.	C	G	3	1	4	0	0	4	0	0
8	41235191	.	G	A	1	2	3	0	0	3	0	0
8	41235767	.	G	T	2	1	3	0	0	3	0	0
8	41235780	.	A	C	2	1	3	0	0	3	0	0
8	41238110	.	G	A	0	0	0	0	1	1	0	0
8	41243315	.	A	G	1	0	1	0	0	1	0	0
8	41243772	.	T	C	1	2	3	0	0	3	0	0
8	41249879	.	A	G	13	9	22	0	0	22	0	0
8	41249882	.	T	C	13	11	24	0	0	24	0	0
8	41249942	.	T	C	4	7	11	0	1	12	0	0
8	41255346	.	C	T	6	8	14	0	1	15	0	0
8	41255439	.	G	A	13	11	24	0	0	24	0	0
8	41255615	.	C	T	8	5	13	0	1	14	0	0
8	41255789	.	G	C	1	4	5	0	0	5	0	0
8	41260534	.	C	T	17	21	38	0	0	38	0	0
8	41260634	.	A	G	16	25	41	0	3	44	0	0
8	41260668	.	A	G	20	18	38	0	3	41	0	0
8	41260823	.	G	C	24	15	39	0	0	39	0	0
8	41260877	.	A	G	29	20	49	0	1	50	0	0
8	41260880	.	T	C	28	2	30	0	19	49	0	0
8	41260923	.	T	A	24	19	43	0	1	44	0	0
8	41261002	.	A	G	20	22	42	0	1	43	0	0
8	41261092	.	T	A	17	24	41	0	1	42	0	0
8	41261178	.	T	C	22	17	39	0	0	39	0	0
8	41261190	.	A	G	22	15	37	0	0	37	0	0
8	41261294	.	A	G	13	20	33	0	2	35	0	0
8	41263005	.	A	G	24	29	53	0	1	54	0	0
8	41263085	.	G	A	2	5	7	0	0	7	0	0
8	41264447	.	A	T	8	5	13	0	3	16	0	0
8	41264549	.	C	G	7	4	11	0	0	11	0	0
8	41264786	.	A	C	1	1	2	0	0	2	0	0
8	41264788	.	T	A	0	1	1	0	1	2	0	0
8	41265180	.	T	C	2	2	4	0	0	4	0	0
8	41265264	.	G	A	14	11	25	0	2	27	0	0
8	41265549	.	T	C	22	17	39	0	3	42	0	0
8	41266567	.	T	C	2	2	4	0	0	4	0	0
8	41266573	.	A	T	1	1	2	0	0	2	0	0
8	41267976	.	C	T	6	2	8	0	0	8	0	0
8	41462497	.	A	G	1	0	1	0	15	16	0	0
8	42138863	.	C	T	5	6	11	0	0	11	0	0
8	42138878	.	G	A	4	9	13	0	0	13	0	0
8	42642058	.	A	T	6	4	10	0	1	11	0	0
8	42642139	.	T	C	7	6	13	0	0	13	0	0
8	42642199	.	T	G	7	6	13	0	2	15	0	0
8	42642235	.	A	G	12	8	20	0	0	20	0	0
8	42642247	.	G	C	9	8	17	0	0	17	0	0
8	42642434	.	C	T	12	5	17	0	0	17	0	0
8	42642671	.	T	A	5	3	8	0	0	8	0	0
8	42642803	.	A	C	2	5	7	0	0	7	0	0
8	42642833	.	A	G	3	2	5	0	0	5	0	0
8	42643153	.	G	T	3	7	10	0	1	11	0	0
8	42649431	.	G	C	2	2	4	0	0	4	0	0
8	42649485	.	G	A	12	5	17	0	1	18	0	0
8	42650538	.	T	C	0	1	1	0	0	1	0	0
8	42650613	.	T	C	7	4	11	0	0	11	0	0
8	42653344	.	A	T	1	0	1	0	0	1	0	0
8	42653389	.	A	G	6	3	9	0	1	10	0	0
8	43379779	.	T	C	11	13	24	0	1	25	0	0
8	43380067	.	G	A	22	10	32	0	1	33	0	0
8	43380290	.	A	T	13	12	25	0	1	26	0	0
8	43380543	.	T	G	11	10	21	0	0	21	0	0
8	43380781	.	C	T	1	12	13	0	10	23	0	0
8	43380905	.	A	T	7	10	17	0	0	17	0	0
8	43380923	.	C	T	0	7	7	0	7	14	0	0
8	43381239	.	A	T	7	10	17	0	1	18	0	0
8	43381306	.	A	T	14	12	26	0	0	26	0	0
8	43381417	.	T	G	7	6	13	0	2	15	0	0
8	43381500	.	A	G	6	11	17	0	0	17	0	0
8	43381664	.	A	T	6	9	15	0	0	15	0	0
8	43382046	.	A	T	21	9	30	0	4	34	0	0
8	43386194	.	G	A	9	10	19	0	1	20	0	0
8	43386677	.	T	A	10	7	17	0	2	19	0	0
8	43393575	.	C	A	0	5	5	0	9	14	0	0
8	43400484	.	A	G	3	2	5	0	0	5	0	0
8	43400820	.	G	A	7	9	16	0	2	18	0	0
8	43400880	.	G	A	11	14	25	0	0	25	0	0
8	43401134	.	A	G	2	0	2	0	1	3	0	0
8	43401161	.	T	C	7	0	7	0	2	9	0	0
8	43401423	.	G	A	0	2	2	0	0	2	0	0
8	43413787	.	C	T	0	7	7	0	6	13	0	0
8	43419175	.	C	T	0	2	2	0	3	5	0	0
8	43419763	.	A	C	5	6	11	0	0	11	0	0
8	43423931	.	C	T	6	3	9	0	1	10	0	0
8	43424006	.	C	T	0	1	1	0	0	1	0	0
8	43424205	.	C	T	8	6	14	0	1	15	0	0
8	43455875	.	G	A	2	0	2	0	1	3	0	0
8	43486712	.	T	C	7	3	10	0	2	12	0	0
8	43501983	.	T	G	0	2	2	0	1	3	0	0
8	43574555	.	A	T	3	5	8	0	0	8	0	0
8	43668521	.	A	G	9	14	23	0	1	24	0	0
8	43668716	.	T	G	17	18	35	0	2	37	0	0
8	43671871	.	C	T	5	4	9	0	0	9	0	0
8	43675370	.	G	A	5	5	10	0	0	10	0	0
8	43675698	.	T	A	5	6	11	0	0	11	0	0
8	43677718	.	T	C	3	4	7	0	0	7	0	0
8	43677736	.	A	C	2	3	5	0	0	5	0	0
8	43680438	.	A	G	2	1	3	0	0	3	0	0
8	43680469	.	T	G	5	3	8	0	0	8	0	0
8	43680500	.	T	C	4	4	8	0	0	8	0	0
8	43680510	.	A	G	4	3	7	0	0	7	0	0
8	43682544	.	A	G	0	4	4	0	0	4	0	0
8	43683133	.	G	A	8	2	10	0	0	10	0	0
8	43688536	.	A	G	2	0	2	0	0	2	0	0
8	43688847	.	G	A	5	3	8	0	0	8	0	0
8	43691854	.	G	T	0	3	3	0	0	3	0	0
8	43693140	.	A	C	6	3	9	0	0	9	0	0
8	43693392	.	A	G	2	2	4	0	0	4	0	0
8	43700901	.	T	A	1	1	2	0	0	2	0	0
8	43700951	.	G	T	1	3	4	0	0	4	0	0
8	43701731	.	A	G	3	3	6	0	0	6	0	0
8	43703589	.	T	G	6	6	12	0	2	14	0	0
8	43706509	.	T	C	0	0	0	0	2	2	0	0
8	43706512	.	G	A	0	1	1	0	0	1	0	0
8	43708257	.	A	C	0	2	2	0	0	2	0	0
8	43708440	.	C	T	0	1	1	0	0	1	0	0
8	43711819	.	G	T	3	3	6	0	1	7	0	0
8	43717174	.	A	T	3	2	5	0	0	5	0	0
8	43717198	.	T	A	1	2	3	0	0	3	0	0
8	43720121	.	C	T	5	2	7	0	0	7	0	0
8	43720811	.	A	G	1	2	3	0	0	3	0	0
8	43736314	.	C	T	0	3	3	0	2	5	0	0
8	43736354	.	G	T	4	2	6	0	0	6	0	0
8	43934966	.	G	A	5	2	7	0	0	7	0	0
8	43935120	.	A	G	18	13	31	0	0	31	0	0
8	43935351	.	A	T	4	3	7	0	0	7	0	0
8	43935481	.	C	T	3	14	17	0	0	17	0	0
8	43935552	.	A	G	4	16	20	0	0	20	0	0
8	43935679	.	A	T	5	2	7	0	0	7	0	0
8	43935680	.	A	C	5	2	7	0	0	7	0	0
8	43935731	.	C	T	2	2	4	0	0	4	0	0
8	43935879	.	C	G	11	5	16	0	0	16	0	0
8	43960570	.	T	C	2	1	3	0	0	3	0	0
8	43967218	.	A	G	4	4	8	0	1	9	0	0
8	43967244	.	A	G	5	2	7	0	0	7	0	0
8	43967698	.	A	G	3	2	5	0	0	5	0	0
8	43974538	.	T	A	4	6	10	0	1	11	0	0
8	44003950	.	A	G	1	1	2	0	0	2	0	0
8	45396028	.	T	C	6	0	6	0	3	9	0	0
8	45427189	.	C	A	3	3	6	0	0	6	0	0
8	45428039	.	C	T	18	18	36	0	0	36	0	0
8	45430757	.	G	A	6	8	14	0	0	14	0	0
8	45755078	.	A	G	1	2	3	0	0	3	0	0
8	45755263	.	T	C	3	3	6	0	0	6	0	0
8	45755732	.	C	T	30	23	53	0	2	55	0	0
8	45755973	.	C	G	21	15	36	0	2	38	0	0
8	45759960	.	C	T	22	6	28	0	3	31	0	0
8	45760071	.	A	C	11	1	12	0	9	21	0	0
8	45762577	.	G	T	1	3	4	0	0	4	0	0
8	45762654	.	C	T	0	2	2	0	1	3	0	0
8	45763350	.	C	T	1	2	3	0	0	3	0	0
8	45763511	.	T	G	1	5	6	0	0	6	0	0
8	45763537	.	A	T	7	5	12	0	0	12	0	0
8	45763562	.	G	A	10	12	22	0	2	24	0	0
8	45763670	.	C	T	16	18	34	0	1	35	0	0
8	45763872	.	T	A	17	9	26	0	4	30	0	0
8	45763991	.	A	G	16	17	33	0	1	34	0	0
8	45764006	.	G	C	16	13	29	0	4	33	0	0
8	45764274	.	T	C	5	19	24	0	1	25	0	0
8	45764353	.	T	C	0	9	9	0	0	9	0	0
8	45765170	.	C	T	0	11	11	0	11	22	0	0
8	45765188	.	A	T	3	6	9	0	0	9	0	0
8	45765326	.	G	A	16	11	27	0	1	28	0	0
8	45772961	.	G	C	9	14	23	0	1	24	0	0
8	45774471	.	C	T	0	1	1	0	1	2	0	0
8	45775089	.	C	T	7	8	15	0	1	16	0	0
8	45779729	.	A	C	7	11	18	0	0	18	0	0
8	45786186	.	C	T	0	3	3	0	2	5	0	0
8	45786612	.	G	T	4	6	10	0	0	10	0	0
8	45786615	.	A	G	5	6	11	0	0	11	0	0
8	45787137	.	A	G	9	6	15	0	0	15	0	0
8	45788941	.	T	G	6	12	18	0	0	18	0	0
8	45789130	.	T	C	3	5	8	0	0	8	0	0
8	45793550	.	A	C	4	5	9	0	0	9	0	0
8	45797305	.	G	A	1	3	4	0	0	4	0	0
8	45834940	.	G	A	7	3	10	0	0	10	0	0
8	45838228	.	C	T	2	3	5	0	0	5	0	0
8	45852874	.	C	A	5	3	8	0	0	8	0	0
8	45852911	.	A	T	2	2	4	0	0	4	0	0
8	45853465	.	C	A	0	6	6	0	3	9	0	0
8	45853475	.	G	A	5	2	7	0	1	8	0	0
8	45853533	.	T	C	2	2	4	0	2	6	0	0
8	45853574	.	A	G	5	2	7	0	0	7	0	0
8	45853626	.	G	A	5	7	12	0	0	12	0	0
8	45880125	.	G	A	3	1	4	0	0	4	0	0
8	45896997	.	T	C	0	0	0	0	2	2	0	0
8	45939385	.	G	A	1	2	3	0	0	3	0	0
8	45939398	.	A	G	1	5	6	0	0	6	0	0
8	45939533	.	G	C	5	3	8	0	0	8	0	0
8	45939585	.	G	A	3	3	6	0	0	6	0	0
8	45939607	.	A	G	2	4	6	0	0	6	0	0
8	45939648	.	C	G	2	4	6	0	0	8	2	0
8	45944896	.	T	A	2	7	9	0	0	9	0	0
8	45944983	.	G	A	4	6	10	0	0	10	0	0
8	45948718	.	G	A	8	6	14	0	0	14	0	0
8	45952072	.	C	G	5	2	7	0	0	7	0	0
8	45952152	.	A	T	7	4	11	0	0	11	0	0
8	45952231	.	T	C	6	5	11	0	0	11	0	0
8	45952352	.	G	C	9	4	13	0	1	14	0	0
8	45952423	.	A	G	9	5	14	0	0	14	0	0
8	45952500	.	A	G	2	0	2	0	5	7	0	0
8	45962391	.	G	C	1	4	5	0	0	5	0	0
8	45965749	.	G	A	2	4	6	0	0	6	0	0
8	45986769	.	A	T	1	0	1	0	0	1	0	0
8	46011055	.	T	A	2	5	7	0	0	7	0	0
8	46077675	.	A	G	3	4	7	0	0	7	0	0
8	46077757	.	C	T	7	8	15	0	2	17	0	0
8	46077819	.	G	A	19	4	23	0	0	23	0	0
8	46077832	.	T	A	18	2	20	0	1	21	0	0
8	46077879	.	C	A	6	2	8	0	0	8	0	0
8	46078168	.	C	A	3	2	5	0	0	5	0	0
8	46078287	.	A	G	11	4	15	0	0	15	0	0
8	46078309	.	C	T	5	6	11	0	0	11	0	0
8	46078342	.	C	G	4	10	14	0	0	14	0	0
8	46085480	.	A	T	5	4	9	0	0	9	0	0
8	46089037	.	G	T	0	1	1	0	0	1	0	0
8	46089052	.	T	C	0	1	1	0	0	1	0	0
8	46089634	.	C	T	10	10	20	0	0	20	0	0
8	46123731	.	G	A	1	3	4	0	0	4	0	0
8	46125509	.	G	A	1	0	1	0	0	1	0	0
8	46132662	.	G	C	1	0	1	0	2	3	0	0
8	46188003	.	A	G	3	4	7	0	0	7	0	0
8	46188018	.	A	G	3	6	9	0	0	9	0	0
8	46220600	.	C	T	0	3	3	0	0	3	0	0
8	46228719	.	C	T	0	2	2	0	1	3	0	0
8	46231128	.	A	G	4	7	11	0	0	11	0	0
8	46247717	.	T	C	3	3	6	0	0	6	0	0
8	46296796	.	G	A	2	2	4	0	0	4	0	0
8	46296830	.	A	G	4	3	7	0	0	7	0	0
8	46296851	.	T	C	2	3	5	0	0	5	0	0
8	46310717	.	G	A	2	2	4	0	0	4	0	0
8	46310897	.	A	G	0	3	3	0	0	3	0	0
8	46337310	.	A	G	4	4	8	0	0	8	0	0
8	46337316	.	C	T	7	2	9	0	0	9	0	0
8	46346857	.	T	C	5	2	7	0	0	7	0	0
8	46347060	.	A	G	9	3	12	0	0	12	0	0
8	46347099	.	A	T	9	7	16	0	1	17	0	0
8	46347183	.	A	G	2	1	3	0	2	5	0	0
8	46348083	.	A	T	6	6	12	0	0	12	0	0
8	46348121	.	G	A	0	7	7	0	8	15	0	0
8	46348178	.	A	G	3	3	6	0	0	6	0	0
8	46348391	.	T	A	5	2	7	0	0	7	0	0
8	46356282	.	G	A	1	2	3	0	0	3	0	0
8	46362082	.	G	A	3	0	3	0	0	3	0	0
8	46362083	.	G	T	3	0	3	0	0	3	0	0
8	46370217	.	C	T	0	2	2	0	4	6	0	0
8	47834998	.	G	A	3	3	6	0	0	6	0	0
8	47835146	.	T	C	8	4	12	0	1	13	0	0
8	47835148	.	C	T	9	4	13	0	0	13	0	0
8	47835307	.	A	T	3	5	8	0	0	8	0	0
8	47835337	.	A	G	2	2	4	0	1	5	0	0
8	47843557	.	T	A	3	1	4	0	0	4	0	0
8	47843962	.	A	T	6	3	9	0	0	9	0	0
8	47911031	.	C	G	4	0	4	0	1	5	0	0
8	47917304	.	C	T	4	6	10	0	0	10	0	0
8	47927814	.	C	T	1	3	4	0	0	4	0	0
8	47928187	.	T	A	1	1	2	0	0	2	0	0
8	47932409	.	C	T	2	4	6	0	0	6	0	0
8	47932442	.	G	A	3	2	5	0	0	5	0	0
8	47937152	.	T	C	4	4	8	0	0	8	0	0
8	47937156	.	A	G	4	0	4	0	4	8	0	0
8	47937263	.	T	C	17	8	25	0	0	25	0	0
8	47946517	.	T	C	10	9	19	0	1	20	0	0
8	47946674	.	G	A	5	4	9	0	0	9	0	0
8	47946753	.	C	T	13	7	20	0	1	21	0	0
8	47946776	.	T	C	10	8	18	0	1	19	0	0
8	47946833	.	A	G	7	11	18	0	1	19	0	0
8	47946846	.	A	G	10	8	18	0	1	19	0	0
8	47947052	.	A	C	8	3	11	0	0	11	0	0
8	47947297	.	C	T	6	14	20	0	0	20	0	0
8	47947341	.	C	A	9	8	17	0	1	18	0	0
8	47947391	.	A	G	5	5	10	0	0	10	0	0
8	47947460	.	A	G	15	9	24	0	4	28	0	0
8	47947772	.	A	G	10	0	10	0	7	17	0	0
8	47947996	.	T	G	10	9	19	0	3	22	0	0
8	47948102	.	T	A	12	10	22	0	0	22	0	0
8	47948602	.	G	A	1	13	14	0	17	31	0	0
8	47948755	.	C	T	12	14	26	0	0	26	0	0
8	47948820	.	A	C	5	8	13	0	0	13	0	0
8	47948866	.	C	A	5	4	9	0	0	9	0	0
8	48093139	.	T	C	4	3	7	0	0	7	0	0
8	48603552	.	T	C	2	2	4	0	0	4	0	0
8	48603788	.	G	C	0	5	5	0	2	7	0	0
8	48603978	.	T	A	3	5	8	0	0	8	0	0
8	48629640	.	T	A	4	3	7	0	0	7	0	0
8	48629668	.	G	A	3	4	7	0	0	7	0	0
8	48629797	.	C	A	8	5	13	0	0	13	0	0
8	48629946	.	A	T	12	3	15	0	0	15	0	0
8	48629969	.	T	C	14	0	14	0	6	20	0	0
8	48630017	.	A	G	6	4	10	0	0	10	0	0
8	48642433	.	G	A	5	8	13	0	0	13	0	0
8	48642496	.	A	G	3	4	7	0	0	7	0	0
8	48646053	.	A	G	1	2	3	0	0	3	0	0
8	48649106	.	A	C	0	2	2	0	0	2	0	0
8	48801480	.	G	A	0	2	2	0	6	8	0	0
8	48801678	.	C	T	4	2	6	0	0	6	0	0
8	48809531	.	C	G	5	3	8	0	0	8	0	0
8	48809570	.	G	A	1	5	6	0	0	6	0	0
8	48809587	.	T	G	1	5	6	0	0	6	0	0
8	48809678	.	A	C	4	8	12	0	1	13	0	0
8	48816242	.	T	C	1	1	2	0	1	3	0	0
8	48816412	.	C	G	2	2	4	0	0	4	0	0
8	48819365	.	C	T	0	3	3	0	2	5	0	0
8	48836148	.	G	A	0	1	1	0	0	1	0	0
8	48958468	.	C	T	5	3	8	0	0	8	0	0
8	48958637	.	A	G	7	6	13	0	0	13	0	0
8	48958822	.	C	T	5	10	15	0	0	15	0	0
8	48959047	.	G	A	4	4	8	0	1	9	0	0
8	48965853	.	C	G	2	2	4	0	0	4	0	0
8	48966016	.	A	C	3	2	5	0	0	5	0	0
8	48966140	.	C	G	7	4	11	0	0	11	0	0
8	48991948	.	C	T	3	4	7	0	0	7	0	0
8	49002116	.	A	G	1	0	1	0	2	3	0	0
8	49003785	.	A	G	1	0	1	0	1	2	0	0
8	49009822	.	C	A	3	0	3	0	0	3	0	0
8	49009829	.	C	T	1	3	4	0	0	4	0	0
8	49021126	.	C	T	1	2	3	0	0	3	0	0
8	49067166	.	G	C	2	3	5	0	0	5	0	0
8	49067370	.	A	T	1	1	2	0	0	2	0	0
8	49071247	.	T	A	2	2	4	0	0	4	0	0
8	49071293	.	A	T	2	2	4	0	0	4	0	0
8	49078792	.	G	A	0	2	2	0	6	8	0	0
8	49078817	.	C	T	3	3	6	0	0	6	0	0
8	49078827	.	A	C	3	3	6	0	0	6	0	0
8	49082598	.	C	A	0	1	1	0	0	1	0	0
8	49092063	.	T	A	3	8	11	0	0	11	0	0
8	49092108	.	C	T	3	10	13	0	0	13	0	0
8	49092129	.	C	T	1	1	2	0	1	3	0	0
8	49096541	.	G	T	3	6	9	0	1	10	0	0
8	49108347	.	A	T	15	8	23	0	0	23	0	0
8	49170190	.	T	A	7	3	10	0	0	10	0	0
8	49170366	.	T	A	6	9	15	0	2	17	0	0
8	49172338	.	A	G	2	6	8	0	1	9	0	0
8	49310830	.	C	T	5	10	15	0	3	18	0	0
8	49310928	.	T	C	3	10	13	0	1	14	0	0
8	49311090	.	C	T	20	17	37	0	0	37	0	0
8	49311242	.	G	A	10	8	18	0	1	19	0	0
8	49311355	.	T	C	23	20	43	0	1	44	0	0
8	49311396	.	C	A	18	16	34	0	2	37	1	0
8	49311398	.	G	C	19	17	36	0	1	37	0	0
8	49345116	.	C	T	10	8	18	0	1	19	0	0
8	49345191	.	T	C	10	22	32	0	0	32	0	0
8	49345212	.	G	T	22	5	27	0	0	27	0	0
8	49345272	.	A	G	18	12	30	0	2	32	0	0
8	49404152	.	G	T	22	14	36	0	5	41	0	0
8	49404262	.	C	T	28	29	57	0	3	60	0	0
8	49404502	.	C	T	40	29	69	0	1	70	0	0
8	49404928	.	C	T	31	35	66	0	2	68	0	0
8	49405199	.	C	T	2	2	4	0	0	4	0	0
8	49405214	.	G	C	3	2	5	0	0	5	0	0
8	49405248	.	A	G	1	0	1	0	0	1	0	0
8	49413417	.	G	T	44	28	72	0	1	73	0	0
8	49413444	.	G	A	24	35	59	0	6	65	0	0
8	49413459	.	G	A	29	31	60	0	5	65	0	0
8	49415718	.	G	C	5	3	8	0	0	8	0	0
8	49435964	.	C	G	1	2	3	0	0	3	0	0
8	49443191	.	A	G	2	0	2	0	2	4	0	0
8	49447458	.	A	T	1	0	1	0	1	2	0	0
8	49447519	.	G	A	3	12	15	0	0	15	0	0
8	49447559	.	G	T	2	12	14	0	0	14	0	0
8	49447574	.	T	G	3	6	9	0	0	9	0	0
8	49447657	.	C	A	1	7	8	0	0	8	0	0
8	49478284	.	A	G	1	2	3	0	0	3	0	0
8	49746187	.	G	A	6	5	11	0	9	20	0	0
8	50949903	.	A	G	29	0	29	0	19	48	0	0
8	51094338	.	T	C	0	2	2	0	0	2	0	0
8	51228659	.	G	A	1	0	1	0	0	1	0	0
8	51247891	.	G	C	2	2	4	0	0	4	0	0
8	51309145	.	T	G	11	8	19	0	0	19	0	0
8	51309311	.	A	G	4	5	9	0	0	9	0	0
8	51314087	.	G	A	3	11	14	0	2	16	0	0
8	51320547	.	C	T	5	5	10	0	0	10	0	0
8	51320652	.	C	T	5	2	7	0	0	7	0	0
8	51325510	.	T	G	4	7	11	0	0	11	0	0
8	51330776	.	T	C	5	1	6	0	0	6	0	0
8	51330836	.	A	T	6	2	8	0	0	8	0	0
8	51351155	.	T	A	12	4	16	0	0	16	0	0
8	51351200	.	A	T	7	9	16	0	0	16	0	0
8	51352480	.	A	G	9	8	17	0	0	17	0	0
8	51352525	.	A	T	1	0	1	0	0	1	0	0
8	51358769	.	G	A	2	2	4	0	0	4	0	0
8	51364515	.	T	C	3	4	7	0	0	7	0	0
8	51364644	.	C	A	1	11	12	0	8	20	0	0
8	51364665	.	T	C	8	11	19	0	0	19	0	0
8	51364696	.	C	G	4	5	9	0	0	9	0	0
8	51364713	.	C	A	0	1	1	0	2	3	0	0
8	51367178	.	A	T	1	1	2	0	0	2	0	0
8	51367206	.	C	T	5	3	8	0	0	8	0	0
8	51367217	.	C	T	7	7	14	0	0	14	0	0
8	51367267	.	A	T	8	12	20	0	0	20	0	0
8	51375405	.	T	G	14	19	33	0	1	34	0	0
8	51379609	.	G	A	7	4	11	0	1	12	0	0
8	51379699	.	G	A	9	9	18	0	0	18	0	0
8	51431396	.	C	T	0	3	3	0	6	9	0	0
8	51431468	.	A	T	4	3	7	0	1	8	0	0
8	51431477	.	G	A	4	4	8	0	0	8	0	0
8	51431526	.	A	T	6	4	10	0	0	10	0	0
8	51431561	.	A	G	3	11	14	0	0	14	0	0
8	51431573	.	A	T	3	11	14	0	0	14	0	0
8	51431604	.	A	C	1	8	9	0	0	9	0	0
8	51431628	.	C	T	5	2	7	0	0	7	0	0
8	51431712	.	T	C	3	2	5	0	0	5	0	0
8	51431805	.	T	A	9	3	12	0	0	12	0	0
8	51432881	.	T	C	3	4	7	0	0	7	0	0
8	51433088	.	C	T	3	4	7	0	1	8	0	0
8	51433141	.	G	T	2	4	6	0	0	6	0	0
8	51433258	.	C	A	3	1	4	0	0	4	0	0
8	51433604	.	C	T	0	3	3	0	0	3	0	0
8	51434020	.	T	A	2	3	5	0	0	5	0	0
8	51434081	.	A	G	4	3	7	0	0	7	0	0
8	51434289	.	C	T	1	4	5	0	0	5	0	0
8	51434330	.	C	A	0	1	1	0	1	2	0	0
8	51434357	.	C	G	1	2	3	0	0	3	0	0
8	51437323	.	A	G	5	3	8	0	0	8	0	0
8	51481945	.	G	A	1	3	4	0	0	4	0	0
8	51485935	.	T	C	1	2	3	0	0	3	0	0
8	51573138	.	T	A	1	2	3	0	0	3	0	0
8	51573293	.	A	G	1	2	3	0	0	3	0	0
8	51573346	.	C	G	1	2	3	0	0	3	0	0
8	51573385	.	C	T	1	3	4	0	0	4	0	0
8	51573406	.	A	T	1	3	4	0	0	4	0	0
8	51576856	.	C	T	0	4	4	0	2	6	0	0
8	51576887	.	C	T	0	5	5	0	2	7	0	0
8	51576925	.	C	T	0	3	3	0	2	5	0	0
8	51587236	.	A	G	1	2	3	0	0	3	0	0
8	51587259	.	A	G	1	2	3	0	0	3	0	0
8	51634935	.	T	C	3	0	3	0	4	7	0	0
8	51635607	.	C	T	0	2	2	0	1	3	0	0
8	51635631	.	C	T	1	2	3	0	0	3	0	0
8	51713647	.	T	C	0	2	2	0	0	2	0	0
8	51718619	.	T	C	1	2	3	0	0	3	0	0
8	51721300	.	C	T	2	3	5	0	0	5	0	0
8	51723164	.	C	T	5	4	9	0	0	9	0	0
8	51723206	.	G	A	0	2	2	0	4	6	0	0
8	51723249	.	A	G	4	2	6	2	0	8	0	0
8	51723957	.	T	C	2	6	8	0	0	8	0	0
8	51723984	.	A	T	4	6	10	0	0	10	0	0
8	51724029	.	T	G	5	4	9	0	0	9	0	0
8	51724067	.	C	T	3	7	10	0	0	10	0	0
8	51724288	.	G	A	1	3	4	0	0	4	0	0
8	51724548	.	T	C	3	2	5	0	0	5	0	0
8	51724599	.	T	C	2	2	4	0	0	4	0	0
8	51724857	.	G	A	2	2	4	0	0	4	0	0
8	51724928	.	G	T	1	2	3	0	0	3	0	0
8	51724974	.	G	A	3	2	5	0	0	5	0	0
8	51725058	.	G	T	2	2	4	0	0	4	0	0
8	51725237	.	C	G	2	3	5	0	0	5	0	0
8	51725241	.	G	T	2	4	6	0	0	6	0	0
8	51726166	.	C	T	4	2	6	0	0	6	0	0
8	51726260	.	C	G	2	4	6	0	1	7	0	0
8	51726299	.	T	A	3	3	6	0	1	7	0	0
8	52109368	.	T	C	2	3	5	0	0	5	0	0
8	52109386	.	T	C	1	5	6	0	0	6	0	0
8	52226378	.	A	C	1	1	2	0	0	2	0	0
8	52292515	.	T	C	0	2	2	0	0	2	0	0
8	52296833	.	T	G	7	3	10	0	0	10	0	0
8	52296834	.	T	G	7	3	10	0	0	10	0	0
8	52314637	.	G	T	0	7	7	0	3	10	0	0
8	52336870	.	T	C	1	1	2	0	0	2	0	0
8	52342586	.	A	C	4	4	8	0	0	8	0	0
8	52345733	.	T	C	1	4	5	0	0	5	0	0
8	52345751	.	T	C	2	8	10	0	0	10	0	0
8	52345915	.	T	C	9	8	17	0	1	18	0	0
8	52346035	.	T	C	3	3	6	0	0	6	0	0
8	52346072	.	A	T	1	2	3	0	0	3	0	0
8	52346111	.	A	C	2	3	5	0	0	5	0	0
8	52346225	.	A	T	4	2	6	0	0	6	0	0
8	52346299	.	T	G	1	0	1	0	3	4	0	0
8	52347460	.	C	T	7	8	15	0	0	15	0	0
8	52348237	.	A	G	3	5	8	0	0	8	0	0
8	52348242	.	A	G	6	2	8	0	0	8	0	0
8	52348685	.	T	C	5	4	9	0	0	9	0	0
8	52349080	.	T	G	5	5	10	0	1	11	0	0
8	52350007	.	T	C	6	4	10	0	1	11	0	0
8	52350026	.	A	T	7	8	15	0	0	15	0	0
8	52350101	.	A	G	7	0	7	0	10	18	1	0
8	52350146	.	A	G	13	0	13	0	13	26	0	0
8	52350251	.	A	G	10	14	24	0	2	26	0	0
8	52350322	.	T	G	4	3	7	0	2	9	0	0
8	52401962	.	A	G	0	2	2	0	0	2	0	0
8	52408619	.	G	A	23	23	46	0	4	50	0	0
8	52411451	.	T	C	6	4	10	0	1	11	0	0
8	52412982	.	A	G	16	14	30	0	0	30	0	0
8	52412985	.	C	G	16	14	30	0	0	30	0	0
8	52453432	.	A	C	3	2	5	0	0	5	0	0
8	52453862	.	T	A	1	0	1	0	0	1	0	0
8	52455588	.	A	G	3	2	5	0	0	5	0	0
8	52455610	.	A	G	5	3	8	0	3	11	0	0
8	52455638	.	C	G	6	4	10	0	0	10	0	0
8	52463828	.	T	A	3	6	9	0	0	9	0	0
8	52463855	.	C	T	0	5	5	0	4	9	0	0
8	52472930	.	C	G	2	3	5	0	0	5	0	0
8	52472955	.	C	T	0	4	4	0	4	8	0	0
8	52472997	.	T	C	3	3	6	0	0	6	0	0
8	52491586	.	G	A	10	7	17	0	0	17	0	0
8	52509559	.	C	A	4	4	8	0	0	8	0	0
8	52509624	.	G	A	2	3	5	0	0	5	0	0
8	52509762	.	A	T	4	2	6	0	1	7	0	0
8	52509859	.	C	T	6	4	10	0	1	11	0	0
8	52510088	.	C	T	3	3	6	0	0	6	0	0
8	52521261	.	T	C	0	5	5	0	0	5	0	0
8	52521280	.	T	G	1	5	6	0	0	6	0	0
8	52521802	.	A	T	5	8	13	0	0	13	0	0
8	52521832	.	T	G	9	0	9	0	5	14	0	0
8	52524436	.	A	T	2	1	3	0	0	3	0	0
8	52527359	.	C	G	5	4	9	0	0	9	0	0
8	52527391	.	A	T	6	5	11	0	0	11	0	0
8	52527452	.	T	C	3	2	5	0	0	5	0	0
8	52527486	.	G	A	1	3	4	0	1	5	0	0
8	52527547	.	A	C	3	2	5	0	0	5	0	0
8	52528665	.	A	G	11	7	18	0	0	18	0	0
8	52528717	.	A	G	4	14	18	0	2	20	0	0
8	52528856	.	C	G	5	2	7	0	0	7	0	0
8	52529169	.	A	G	4	6	10	0	0	10	0	0
8	52529206	.	T	C	9	6	15	0	1	16	0	0
8	52529397	.	A	G	12	5	17	0	1	18	0	0
8	52534158	.	A	G	3	1	4	0	0	4	0	0
8	52537984	.	A	G	4	0	4	0	7	11	0	0
8	52538042	.	A	T	1	5	6	0	0	6	0	0
8	52543717	.	C	A	2	3	5	0	0	5	0	0
8	52547038	.	T	G	7	8	15	0	0	15	0	0
8	52547091	.	T	C	5	6	11	0	1	12	0	0
8	52547356	.	A	G	3	7	10	0	1	11	0	0
8	52547522	.	C	T	2	6	8	0	0	8	0	0
8	52547523	.	G	A	0	6	6	0	2	8	0	0
8	52547569	.	T	A	4	4	8	0	1	10	1	0
8	52547664	.	A	C	0	5	5	0	0	5	0	0
8	52547677	.	C	T	0	6	6	0	0	6	0	0
8	52547706	.	A	T	2	9	11	0	0	11	0	0
8	52547727	.	G	C	2	10	12	0	0	12	0	0
8	52547787	.	T	A	1	5	6	0	0	6	0	0
8	52547829	.	T	G	2	2	4	0	0	4	0	0
8	52547902	.	T	A	1	8	9	0	0	9	0	0
8	52550373	.	T	C	3	1	4	0	2	6	0	0
8	52550462	.	A	G	5	5	10	0	1	11	0	0
8	52550502	.	T	A	6	5	11	0	0	11	0	0
8	52553193	.	A	T	4	2	6	0	3	9	0	0
8	52553197	.	A	G	5	2	7	0	0	7	0	0
8	52554679	.	T	C	0	0	0	0	2	2	0	0
8	52554937	.	T	G	7	4	11	0	0	11	0	0
8	52554983	.	C	T	9	4	13	0	1	14	0	0
8	52555018	.	T	G	5	7	12	0	1	13	0	0
8	52555050	.	G	A	6	9	15	0	0	15	0	0
8	52555077	.	C	G	8	11	19	0	0	19	0	0
8	52555112	.	G	T	7	9	16	0	0	16	0	0
8	52555137	.	G	A	5	8	13	0	0	13	0	0
8	52557454	.	G	T	1	3	4	0	0	4	0	0
8	52562746	.	C	T	1	4	5	0	0	5	0	0
8	52564816	.	T	C	4	1	5	0	0	5	0	0
8	52564922	.	C	T	0	3	3	0	0	3	0	0
8	52565319	.	T	C	1	4	5	0	0	5	0	0
8	52571198	.	T	C	1	1	2	0	0	2	0	0
8	52575791	.	C	T	0	1	1	0	0	1	0	0
8	52580094	.	A	G	0	1	1	0	0	1	0	0
8	52580169	.	A	G	3	2	5	0	0	5	0	0
8	52580196	.	A	T	0	1	1	0	0	1	0	0
8	52588519	.	G	A	0	2	2	0	0	2	0	0
8	52588540	.	G	A	1	1	2	0	0	2	0	0
8	52630431	.	C	A	3	3	6	0	1	7	0	0
8	52630433	.	T	A	4	2	6	0	1	7	0	0
8	53082186	.	G	C	5	6	11	0	0	11	0	0
8	53087090	.	C	T	5	3	8	0	0	8	0	0
8	53089843	.	G	A	0	5	5	0	1	6	0	0
8	53095146	.	G	A	5	4	9	0	0	9	0	0
8	53095179	.	A	G	0	2	2	0	0	2	0	0
8	53148951	.	T	C	2	3	5	0	1	6	0	0
8	53150356	.	T	C	11	3	14	0	0	14	0	0
8	53150630	.	T	C	10	2	12	0	1	13	0	0
8	53398617	.	A	G	1	4	5	0	0	5	0	0
8	53398618	.	A	G	2	3	5	0	0	5	0	0
8	53398992	.	A	G	5	3	8	0	1	9	0	0
8	53399003	.	A	G	4	3	7	0	1	8	0	0
8	53399179	.	A	G	6	2	8	0	0	8	0	0
8	53399192	.	A	G	2	7	9	0	0	9	0	0
8	53752762	.	C	T	0	2	2	0	1	3	0	0
8	53756168	.	C	T	2	0	2	0	0	2	0	0
8	53767752	.	A	G	0	2	2	0	0	2	0	0
8	53769634	.	C	T	0	2	2	0	0	2	0	0
8	53772380	.	C	A	0	1	1	0	1	2	0	0
8	53794163	.	T	A	12	13	25	0	0	25	0	0
8	53794250	.	T	C	13	5	18	0	2	20	0	0
8	53794943	.	T	G	5	9	14	0	1	15	0	0
8	53795006	.	C	T	11	14	25	0	0	25	0	0
8	53795162	.	A	G	7	8	15	0	0	15	0	0
8	53795249	.	G	A	10	9	19	0	0	19	0	0
8	53795411	.	T	C	5	7	12	0	1	13	0	0
8	53795602	.	T	A	5	9	14	0	2	16	0	0
8	53795636	.	A	T	2	16	18	0	1	19	0	0
8	53795640	.	A	G	2	17	19	0	0	19	0	0
8	53795684	.	T	C	1	0	1	0	16	17	0	0
8	53795892	.	G	T	17	12	29	0	1	30	0	0
8	53796620	.	G	A	4	2	6	0	0	6	0	0
8	53796657	.	C	T	3	3	6	0	0	6	0	0
8	53796833	.	T	C	7	7	14	0	1	15	0	0
8	53797040	.	A	G	8	7	15	0	0	15	0	0
8	53797118	.	G	T	8	8	16	0	0	16	0	0
8	53797265	.	C	T	2	8	10	0	0	10	0	0
8	53797451	.	C	T	0	6	6	0	4	10	0	0
8	53797741	.	T	G	5	8	13	0	0	13	0	0
8	53797802	.	A	C	4	4	8	0	1	9	0	0
8	53798130	.	A	G	4	10	14	0	0	14	0	0
8	53798168	.	A	G	7	6	13	0	0	13	0	0
8	53798321	.	T	A	5	8	13	0	1	14	0	0
8	53798333	.	G	A	8	9	17	0	0	17	0	0
8	53798450	.	T	G	13	5	18	0	1	19	0	0
8	53798864	.	A	G	8	10	18	0	0	18	0	0
8	53798981	.	C	T	0	5	5	0	4	9	0	0
8	53799017	.	A	G	3	3	6	0	1	7	0	0
8	53799491	.	T	A	8	6	14	0	1	15	0	0
8	53799521	.	G	A	5	5	10	0	1	11	0	0
8	53800064	.	A	G	4	8	12	0	1	13	0	0
8	53803121	.	G	T	5	9	14	0	0	14	0	0
8	53803139	.	A	T	2	6	8	0	0	8	0	0
8	53803376	.	T	C	3	13	16	0	1	17	0	0
8	53851453	.	C	T	0	2	2	0	2	4	0	0
8	53866884	.	C	T	2	3	5	0	0	5	0	0
8	53876632	.	C	T	1	0	1	0	0	1	0	0
8	53876716	.	G	A	3	1	4	0	0	4	0	0
8	53918281	.	T	G	3	4	7	0	0	7	0	0
8	53918323	.	A	T	7	11	18	0	0	19	1	0
8	53918472	.	T	C	7	9	16	0	1	17	0	0
8	53918600	.	T	A	4	7	11	0	0	11	0	0
8	53918664	.	C	T	6	7	13	0	0	13	0	0
8	53918730	.	T	C	8	7	15	0	0	15	0	0
8	53918790	.	G	T	4	3	7	0	0	7	0	0
8	53918899	.	C	T	1	3	4	0	0	4	0	0
8	53921722	.	A	G	4	4	8	0	3	11	0	0
8	53921779	.	G	A	6	11	17	0	0	17	0	0
8	53921797	.	A	G	5	8	13	0	0	13	0	0
8	53921815	.	A	G	8	8	16	0	1	17	0	0
8	53922034	.	A	G	9	12	21	0	2	23	0	0
8	53942440	.	T	C	1	3	4	0	0	4	0	0
8	53948412	.	C	T	8	6	14	0	0	14	0	0
8	53948434	.	G	A	9	6	15	0	1	16	0	0
8	53948501	.	T	C	11	4	15	0	1	16	0	0
8	53949706	.	G	A	5	2	7	0	0	7	0	0
8	53950181	.	T	C	5	0	5	0	8	13	0	0
8	53953420	.	C	G	5	6	11	0	0	11	0	0
8	53956476	.	T	G	6	7	13	0	0	13	0	0
8	53956530	.	T	G	0	1	1	0	0	1	0	0
8	53959378	.	T	C	5	7	12	0	0	12	0	0
8	54013347	.	A	T	10	8	18	0	1	19	0	0
8	54013594	.	G	T	3	5	8	1	0	9	0	0
8	54023714	.	A	G	3	0	3	0	2	5	0	0
8	54128964	.	A	G	4	0	4	0	3	7	0	0
8	54129735	.	G	A	0	13	13	0	14	27	0	0
8	54129767	.	G	A	16	10	26	0	1	27	0	0
8	54129774	.	T	C	17	10	27	0	1	28	0	0
8	54129867	.	A	C	11	8	19	0	0	19	0	0
8	54130203	.	T	G	8	7	15	0	0	15	0	0
8	54130346	.	A	G	1	0	1	0	4	6	1	0
8	54131889	.	T	G	5	7	12	0	0	12	0	0
8	54132024	.	C	G	11	4	15	0	1	16	0	0
8	54132044	.	C	T	10	3	13	0	1	14	0	0
8	54132084	.	C	G	6	5	11	0	0	11	0	0
8	54132555	.	A	G	0	0	0	0	2	2	0	0
8	54133376	.	A	G	13	12	25	0	2	27	0	0
8	54133403	.	A	T	11	7	18	0	1	19	0	0
8	54133450	.	G	A	11	4	15	0	0	15	0	0
8	54133522	.	G	A	8	8	16	0	0	16	0	0
8	54135717	.	T	C	0	1	1	0	0	1	0	0
8	54135720	.	A	T	0	1	1	0	0	1	0	0
8	54137658	.	T	C	4	2	6	0	0	6	0	0
8	54137805	.	T	G	4	4	8	0	0	8	0	0
8	54142752	.	C	T	6	2	8	0	0	8	0	0
8	54145198	.	A	G	1	0	1	0	0	1	0	0
8	54147056	.	T	C	1	2	3	0	0	3	0	0
8	54155012	.	C	A	9	8	17	0	0	17	0	0
8	54202655	.	C	T	1	2	3	0	0	3	0	0
8	54203198	.	A	G	1	0	1	0	1	2	0	0
8	54208231	.	A	G	1	4	5	0	0	5	0	0
8	54208282	.	C	T	1	4	5	0	0	5	0	0
8	54208572	.	C	T	3	5	8	0	0	8	0	0
8	54210066	.	G	A	1	2	3	0	0	3	0	0
8	54210081	.	C	T	1	8	9	0	1	10	0	0
8	54211989	.	G	A	5	2	7	0	0	7	0	0
8	54211991	.	G	A	5	2	7	0	0	7	0	0
8	54213074	.	G	A	4	3	7	0	0	7	0	0
8	54213461	.	A	G	2	9	11	0	0	11	0	0
8	54213462	.	C	T	2	7	9	0	2	11	0	0
8	54220876	.	T	A	14	14	28	0	1	29	0	0
8	54221065	.	A	T	18	24	42	0	1	43	0	0
8	54221067	.	T	C	27	14	41	0	2	43	0	0
8	54221243	.	T	C	16	1	17	0	19	36	0	0
8	54221573	.	T	C	14	0	14	0	18	32	0	0
8	54221812	.	G	C	21	17	38	0	1	39	0	0
8	54221927	.	C	T	17	23	40	0	2	42	0	0
8	54221966	.	G	A	18	24	42	0	1	43	0	0
8	54303407	.	A	G	27	26	53	0	1	54	0	0
9	83785	.	T	C	3	3	6	0	0	6	0	0
9	462959	.	T	G	12	2	14	0	3	17	0	0
9	527734	.	C	A	4	3	7	0	1	8	0	0
9	527777	.	T	C	3	3	6	0	0	6	0	0
9	528345	.	A	T	1	3	4	0	0	4	0	0
9	528441	.	T	G	2	3	5	0	1	6	0	0
9	529012	.	G	T	1	2	3	0	0	3	0	0
9	529036	.	G	A	0	3	3	0	1	4	0	0
9	529675	.	A	G	2	2	4	0	0	4	0	0
9	529692	.	A	G	1	3	4	0	0	4	0	0
9	529824	.	C	A	0	1	1	0	1	2	0	0
9	529849	.	G	A	0	3	3	0	2	5	0	0
9	529930	.	G	A	4	2	6	0	0	6	0	0
9	531629	.	G	A	1	4	5	0	0	5	0	0
9	531700	.	A	G	1	1	2	0	1	3	0	0
9	585887	.	A	G	1	1	2	0	0	2	0	0
9	595354	.	G	A	7	3	10	0	0	10	0	0
9	604848	.	A	G	1	1	2	0	0	2	0	0
9	606794	.	T	A	0	1	1	0	0	1	0	0
9	607208	.	G	A	1	0	1	0	1	2	0	0
9	612647	.	C	G	4	4	8	0	0	8	0	0
9	701934	.	T	C	1	0	1	0	0	1	0	0
9	704662	.	T	A	5	4	9	0	0	9	0	0
9	707754	.	T	A	0	3	3	0	1	4	0	0
9	708075	.	T	C	37	2	39	0	22	61	0	0
9	716225	.	A	G	0	0	0	0	1	1	0	0
9	719825	.	A	G	2	0	2	0	0	2	0	0
9	724664	.	G	C	5	2	7	0	1	8	0	0
9	724670	.	A	C	5	1	6	0	0	6	0	0
9	732227	.	C	T	3	2	5	0	0	5	0	0
9	734643	.	T	G	6	1	7	0	1	8	0	0
9	735860	.	A	G	0	0	0	0	0	1	1	0
9	740907	.	C	T	7	2	9	0	0	9	0	0
9	746040	.	A	G	2	1	3	0	0	3	0	0
9	746071	.	T	C	7	5	12	0	0	12	0	0
9	748018	.	T	C	4	2	6	0	0	6	0	0
9	751441	.	A	G	1	4	5	0	0	5	0	0
9	784574	.	C	T	1	3	4	0	0	4	0	0
9	795832	.	A	G	1	2	3	0	0	3	0	0
9	795839	.	C	T	1	2	3	0	0	3	0	0
9	796093	.	G	A	0	1	1	0	0	1	0	0
9	848860	.	G	A	3	3	6	0	0	6	0	0
9	848875	.	G	C	1	2	3	0	0	3	0	0
9	881905	.	A	C	16	6	22	0	0	22	0	0
9	881999	.	C	T	14	9	23	0	0	23	0	0
9	884904	.	C	T	1	2	3	0	0	3	0	0
9	887854	.	A	G	2	0	2	0	0	2	0	0
9	889433	.	G	A	6	4	10	0	0	10	0	0
9	900550	.	A	T	1	4	5	0	0	5	0	0
9	900592	.	G	A	1	4	5	0	0	5	0	0
9	901137	.	A	G	3	1	4	0	0	4	0	0
9	902265	.	T	C	1	0	1	0	0	1	0	0
9	904118	.	A	T	12	10	22	0	0	22	0	0
9	907496	.	A	T	0	3	3	0	0	3	0	0
9	907500	.	C	A	1	3	4	0	0	4	0	0
9	907564	.	A	G	5	4	9	0	0	9	0	0
9	910882	.	C	T	5	9	14	0	0	14	0	0
9	913874	.	T	C	27	24	51	0	5	56	0	0
9	913882	.	C	T	28	29	57	0	0	57	0	0
9	913909	.	G	A	4	28	32	0	19	51	0	0
9	914097	.	G	T	9	4	13	0	1	14	0	0
9	914190	.	C	T	2	2	4	0	0	4	0	0
9	914506	.	C	A	2	7	9	0	0	9	0	0
9	914507	.	C	T	2	7	9	0	0	9	0	0
9	914616	.	C	G	16	4	20	0	0	20	0	0
9	914675	.	C	T	15	3	18	0	0	18	0	0
9	914702	.	A	T	16	2	18	0	0	18	0	0
9	920806	.	A	G	3	4	7	0	0	7	0	0
9	921602	.	C	T	0	2	2	0	1	3	0	0
9	921767	.	A	T	1	2	3	0	0	3	0	0
9	921859	.	T	A	6	2	8	0	0	8	0	0
9	922646	.	C	T	2	3	5	0	0	5	0	0
9	922656	.	A	G	2	3	5	0	0	5	0	0
9	963731	.	C	T	3	2	5	0	1	6	0	0
9	963851	.	C	G	3	4	7	0	0	7	0	0
9	1188029	.	T	C	1	2	3	0	1	4	0	0
9	1368428	.	T	A	2	0	2	0	0	2	0	0
9	1371190	.	C	G	5	2	7	0	1	8	0	0
9	1371227	.	A	G	6	1	7	0	2	9	0	0
9	1373000	.	A	G	3	3	6	0	0	6	0	0
9	1373075	.	T	G	3	11	14	0	3	17	0	0
9	1373144	.	C	A	7	4	11	0	1	12	0	0
9	1396039	.	A	G	0	2	2	0	0	2	0	0
9	1465005	.	G	A	3	1	4	0	1	5	0	0
9	1469002	.	T	C	2	2	4	0	0	4	0	0
9	1477756	.	C	T	5	3	8	0	0	8	0	0
9	1479254	.	C	T	0	2	2	0	3	5	0	0
9	1479290	.	G	T	3	1	4	0	1	5	0	0
9	1483810	.	T	C	2	3	5	0	0	5	0	0
9	1510742	.	C	G	0	4	4	0	0	4	0	0
9	1510764	.	C	T	0	2	2	0	0	2	0	0
9	1553122	.	G	A	0	1	1	0	0	1	0	0
9	1577542	.	C	A	0	12	12	0	0	12	0	0
9	1579792	.	T	C	5	4	9	0	0	9	0	0
9	1603024	.	G	A	1	2	3	0	0	3	0	0
9	1673601	.	C	T	2	5	7	0	2	9	0	0
9	1679360	.	A	C	1	1	2	0	0	2	0	0
9	1679551	.	A	T	2	2	4	0	0	4	0	0
9	1679969	.	C	A	3	4	7	0	0	7	0	0
9	1680126	.	A	C	2	4	6	0	0	6	0	0
9	1680468	.	A	G	1	3	4	0	0	4	0	0
9	1680636	.	A	G	2	4	6	0	0	6	0	0
9	1680660	.	T	A	2	4	6	0	0	6	0	0
9	1680700	.	T	A	1	3	4	0	0	4	0	0
9	1680809	.	A	C	5	3	8	0	0	8	0	0
9	1681054	.	C	A	1	2	3	0	0	3	0	0
9	1681787	.	A	T	2	2	4	0	0	4	0	0
9	1682647	.	A	T	4	3	7	0	0	7	0	0
9	1682740	.	G	C	0	13	13	0	9	22	0	0
9	1693082	.	A	C	9	10	19	0	1	20	0	0
9	1693092	.	G	A	11	11	22	0	0	22	0	0
9	1693443	.	G	A	9	10	19	0	0	19	0	0
9	1693494	.	T	G	11	5	16	0	0	16	0	0
9	1693574	.	G	A	2	1	3	0	0	3	0	0
9	1693577	.	A	T	2	1	3	0	0	3	0	0
9	1694277	.	A	G	7	1	8	0	0	8	0	0
9	1932212	.	C	A	0	2	2	0	2	4	0	0
9	1938924	.	T	G	2	3	5	0	0	5	0	0
9	1939007	.	T	A	1	3	4	0	1	5	0	0
9	1948879	.	C	T	1	2	3	0	0	3	0	0
9	1949040	.	C	G	0	2	2	0	0	2	0	0
9	1949041	.	T	C	0	2	2	0	0	2	0	0
9	1950360	.	C	G	0	3	3	0	0	3	0	0
9	2044701	.	C	A	2	4	6	0	1	7	0	0
9	2045046	.	G	T	1	3	4	0	0	4	0	0
9	2045125	.	T	G	3	3	6	0	0	6	0	0
9	2045265	.	G	A	2	3	5	0	0	5	0	0
9	2334127	.	T	A	5	2	7	0	0	7	0	0
9	2334164	.	C	T	5	5	10	0	0	10	0	0
9	2336682	.	A	G	3	0	3	0	0	3	0	0
9	2337291	.	C	T	1	3	4	0	0	4	0	0
9	2340561	.	G	A	6	9	15	0	0	15	0	0
9	2340564	.	G	A	7	7	14	0	2	16	0	0
9	2340618	.	C	T	25	27	52	0	3	55	0	0
9	2340776	.	C	T	38	30	68	0	5	73	0	0
9	2340957	.	T	A	8	15	23	0	1	24	0	0
9	2340964	.	G	A	28	2	30	0	2	32	0	0
9	2351661	.	C	T	2	0	2	0	0	2	0	0
9	2351723	.	G	C	7	5	12	0	0	12	0	0
9	2351795	.	C	G	2	1	3	0	0	3	0	0
9	2365092	.	T	C	1	1	2	0	1	3	0	0
9	2365125	.	T	C	3	2	5	0	0	5	0	0
9	2404624	.	A	C	1	0	1	0	0	1	0	0
9	2421012	.	T	A	1	2	3	0	0	3	0	0
9	2423119	.	C	T	11	3	14	0	0	14	0	0
9	2452697	.	T	C	11	17	28	0	2	30	0	0
9	2483524	.	A	G	3	5	8	0	0	8	0	0
9	2483649	.	A	G	4	8	12	0	1	13	0	0
9	2483650	.	A	G	6	7	13	0	0	13	0	0
9	2536809	.	C	T	1	2	3	0	0	3	0	0
9	2555975	.	T	G	5	3	8	0	0	8	0	0
9	2556277	.	A	G	0	3	3	0	0	3	0	0
9	2556339	.	T	C	2	2	4	0	0	4	0	0
9	2556683	.	C	T	5	3	8	0	0	8	0	0
9	2556849	.	G	A	0	2	2	0	2	4	0	0
9	2558355	.	G	T	2	10	12	0	0	12	0	0
9	2558649	.	G	A	1	2	3	0	0	3	0	0
9	2559138	.	C	T	0	2	2	0	1	3	0	0
9	2559177	.	C	T	4	5	9	0	0	9	0	0
9	2559204	.	C	T	5	6	11	0	2	13	0	0
9	2559640	.	A	T	1	3	4	0	0	4	0	0
9	2559856	.	A	C	1	4	5	0	0	5	0	0
9	2560765	.	C	T	1	1	2	0	1	3	0	0
9	2561205	.	G	T	3	5	8	0	0	8	0	0
9	2561604	.	C	T	16	12	28	0	0	28	0	0
9	2561632	.	A	T	16	13	29	0	1	30	0	0
9	2564178	.	C	A	17	21	38	0	1	39	0	0
9	2564699	.	A	G	14	6	20	0	1	21	0	0
9	2564788	.	A	T	2	1	3	0	0	3	0	0
9	2567323	.	G	A	15	7	22	0	0	22	0	0
9	2568670	.	T	A	13	8	21	0	4	25	0	0
9	2568768	.	G	T	11	13	24	0	0	24	0	0
9	2568777	.	C	T	11	10	21	0	0	21	0	0
9	2569372	.	T	G	5	2	7	0	0	7	0	0
9	2572316	.	G	A	14	8	22	0	0	22	0	0
9	2574159	.	T	C	5	3	8	0	0	8	0	0
9	2574225	.	T	C	14	8	22	0	0	22	0	0
9	2574227	.	A	G	14	8	22	0	0	22	0	0
9	2576099	.	T	C	2	2	4	0	0	4	0	0
9	2579867	.	C	T	1	1	2	0	0	2	0	0
9	2582003	.	G	A	0	5	5	0	0	5	0	0
9	2592246	.	C	T	7	16	23	0	1	24	0	0
9	2592933	.	T	C	8	9	17	0	0	17	0	0
9	2592984	.	C	A	0	6	6	0	13	19	0	0
9	2767353	.	T	G	2	1	3	0	2	5	0	0
9	2949273	.	G	A	4	3	7	0	0	7	0	0
9	2949522	.	G	A	1	3	4	0	1	5	0	0
9	2949640	.	T	C	4	5	9	0	0	9	0	0
9	2964172	.	C	T	0	0	0	0	1	1	0	0
9	3135171	.	T	C	4	0	4	0	13	17	0	0
9	3135794	.	A	G	3	3	6	0	0	6	0	0
9	3135809	.	A	G	5	5	10	0	2	12	0	0
9	3136107	.	C	T	1	3	4	0	3	7	0	0
9	3149541	.	T	C	9	13	22	0	2	24	0	0
9	3149661	.	C	T	6	7	13	0	0	13	0	0
9	3228214	.	C	T	1	0	1	0	0	1	0	0
9	3231242	.	C	T	3	3	6	0	0	6	0	0
9	3231378	.	C	A	0	11	11	0	0	11	0	0
9	3231396	.	C	G	6	7	13	0	0	13	0	0
9	3231746	.	C	A	1	4	5	0	0	5	0	0
9	3231778	.	G	T	0	4	4	0	2	6	0	0
9	3231795	.	T	C	1	5	6	0	0	6	0	0
9	3231978	.	C	A	5	4	9	0	0	9	0	0
9	3231991	.	A	G	5	3	8	0	0	8	0	0
9	3232198	.	C	T	6	3	9	0	0	9	0	0
9	3232607	.	T	A	5	6	11	0	0	11	0	0
9	3232672	.	C	T	2	7	9	0	0	9	0	0
9	3232763	.	T	C	1	5	6	0	0	6	0	0
9	3232808	.	A	T	1	3	4	0	0	4	0	0
9	3232818	.	T	G	1	0	1	0	3	4	0	0
9	3286386	.	G	A	2	2	4	0	1	5	0	0
9	3313920	.	G	T	11	14	25	0	0	25	0	0
9	3388974	.	C	T	1	3	4	0	0	4	0	0
9	3389545	.	G	A	0	1	1	0	0	1	0	0
9	3389921	.	A	G	14	1	15	0	20	35	0	0
9	3390035	.	G	A	12	11	23	0	0	23	0	0
9	3397558	.	G	A	3	3	6	0	0	6	0	0
9	3397648	.	A	C	7	6	13	0	0	13	0	0
9	3398243	.	T	A	5	4	9	0	1	10	0	0
9	3398247	.	G	A	6	4	10	0	0	10	0	0
9	3398328	.	C	A	0	8	8	0	10	18	0	0
9	3398354	.	T	C	10	1	11	0	7	18	0	0
9	3400331	.	A	G	6	3	9	0	1	10	0	0
9	3400361	.	G	A	3	3	6	0	1	7	0	0
9	3455742	.	G	A	1	0	1	0	1	2	0	0
9	3457410	.	G	A	0	4	4	0	1	5	0	0
9	3463198	.	T	C	0	2	2	0	0	2	0	0
9	3463212	.	G	A	0	1	1	0	0	1	0	0
9	3465279	.	G	A	4	1	5	0	0	5	0	0
9	3465285	.	T	C	3	3	6	0	1	7	0	0
9	3466114	.	G	A	0	1	1	0	2	3	0	0
9	3471076	.	C	T	1	6	7	0	0	7	0	0
9	3471077	.	A	G	1	6	7	0	0	7	0	0
9	3474856	.	T	C	1	1	2	0	0	2	0	0
9	3477113	.	T	G	0	6	6	0	0	6	0	0
9	3480057	.	A	G	2	7	9	0	0	9	0	0
9	3480076	.	C	T	0	2	2	0	0	2	0	0
9	3483164	.	T	C	1	4	5	0	2	7	0	0
9	3485822	.	G	A	0	3	3	0	4	7	0	0
9	3485867	.	A	T	3	2	5	0	0	5	0	0
9	3485868	.	T	C	3	2	5	0	0	5	0	0
9	3486134	.	T	G	2	6	8	0	0	8	0	0
9	3486220	.	C	T	5	3	8	0	0	8	0	0
9	3486223	.	C	T	5	3	8	0	0	8	0	0
9	3499266	.	G	T	1	2	3	0	0	3	0	0
9	3501269	.	A	G	2	4	6	0	0	6	0	0
9	3503954	.	G	A	0	0	0	0	1	1	0	0
9	3509076	.	A	G	2	1	3	0	0	3	0	0
9	3509096	.	T	C	2	1	3	0	0	3	0	0
9	3524431	.	G	C	1	6	7	0	0	7	0	0
9	3524455	.	G	A	0	5	5	0	1	6	0	0
9	3569470	.	C	A	0	2	2	0	0	2	0	0
9	3605652	.	C	T	5	8	13	0	0	13	0	0
9	3605682	.	A	G	5	0	5	0	8	13	0	0
9	3608867	.	T	A	12	12	24	0	1	25	0	0
9	3621980	.	T	C	6	8	14	0	0	14	0	0
9	3627189	.	T	C	4	3	7	0	0	7	0	0
9	3635791	.	G	A	1	2	3	0	0	3	0	0
9	3646864	.	A	G	5	8	13	0	1	14	0	0
9	3653187	.	G	C	0	1	1	0	1	2	0	0
9	3666458	.	G	A	1	2	3	0	0	3	0	0
9	3666469	.	C	T	1	2	3	0	0	3	0	0
9	3666494	.	C	T	2	3	5	0	0	5	0	0
9	3666511	.	A	G	4	3	7	0	0	7	0	0
9	3666541	.	A	C	5	5	10	0	0	10	0	0
9	3666601	.	A	T	7	6	13	0	0	13	0	0
9	3666666	.	T	C	7	10	17	0	2	19	0	0
9	3666947	.	G	A	6	3	9	0	0	9	0	0
9	3666948	.	T	C	4	0	4	0	5	9	0	0
9	3667136	.	G	A	4	4	8	0	1	9	0	0
9	3667338	.	T	A	3	5	8	0	1	9	0	0
9	3667377	.	C	A	8	3	11	0	0	11	0	0
9	3667398	.	C	A	7	2	9	0	0	9	0	0
9	3667572	.	A	C	4	1	5	0	0	5	0	0
9	3667575	.	T	C	4	1	5	0	0	5	0	0
9	3668198	.	A	C	6	3	9	0	1	10	0	0
9	3668199	.	G	C	6	4	10	0	0	10	0	0
9	3759373	.	G	A	2	1	3	0	1	4	0	0
9	3898275	.	T	C	2	4	6	0	0	6	0	0
9	3898276	.	T	C	2	0	2	0	4	6	0	0
9	3900878	.	T	A	2	3	5	0	0	5	0	0
9	3901007	.	A	T	5	4	9	0	2	11	0	0
9	3901081	.	C	T	4	7	11	0	0	11	0	0
9	3901118	.	A	C	7	4	11	0	0	11	0	0
9	3901187	.	T	A	5	6	11	0	0	11	0	0
9	3905921	.	G	A	3	2	5	0	0	5	0	0
9	3912739	.	G	A	0	1	1	0	0	1	0	0
9	3932238	.	T	G	4	5	9	0	0	9	0	0
9	3997209	.	G	C	4	0	4	0	3	7	0	0
9	4000799	.	G	A	1	2	3	0	0	3	0	0
9	4254304	.	T	C	4	6	10	0	1	11	0	0
9	4266699	.	C	T	6	2	8	0	0	8	0	0
9	4267062	.	T	C	6	7	13	0	0	13	0	0
9	4267072	.	T	C	5	9	14	0	0	14	0	0
9	4267101	.	C	G	4	5	9	0	1	10	0	0
9	4272316	.	T	C	2	2	4	0	0	4	0	0
9	4277125	.	C	T	1	1	2	0	0	2	0	0
9	4282581	.	G	A	0	5	5	0	4	9	0	0
9	4310069	.	C	T	1	0	1	0	0	1	0	0
9	4310096	.	G	A	6	6	12	0	0	12	0	0
9	4323147	.	C	T	6	12	18	0	0	18	0	0
9	4323249	.	C	T	3	3	6	0	0	6	0	0
9	4332223	.	C	T	1	4	5	0	0	5	0	0
9	4336543	.	A	G	1	7	8	0	0	8	0	0
9	4336585	.	T	C	1	5	6	0	0	6	0	0
9	4344553	.	C	T	5	10	15	0	2	17	0	0
9	4606163	.	G	A	1	6	7	0	0	7	0	0
9	5042784	.	A	G	3	3	6	0	0	6	0	0
9	5044370	.	G	T	5	2	7	0	0	7	0	0
9	5045284	.	C	G	0	2	2	0	0	2	0	0
9	5345770	.	G	A	2	2	4	0	1	5	0	0
9	5346115	.	T	G	4	3	7	0	0	7	0	0
9	5346148	.	A	G	3	4	7	0	0	7	0	0
9	5904817	.	G	A	2	1	3	0	1	4	0	0
9	5908920	.	T	A	0	2	2	0	0	2	0	0
9	6009282	.	C	T	17	10	27	0	1	28	0	0
9	6083012	.	G	A	0	10	10	0	27	37	0	0
9	6083026	.	C	T	16	14	30	0	1	31	0	0
9	6083113	.	C	T	8	14	22	0	0	22	0	0
9	6083226	.	C	G	5	2	7	0	2	9	0	0
9	6083262	.	G	C	2	4	6	0	0	6	0	0
9	6083401	.	G	A	18	13	31	0	2	33	0	0
9	6109544	.	A	G	10	10	20	0	0	20	0	0
9	6123441	.	G	A	14	19	33	0	1	34	0	0
9	6123490	.	G	T	13	12	25	0	0	25	0	0
9	6123742	.	A	C	4	14	18	0	1	19	0	0
9	6123857	.	C	T	5	7	12	0	2	14	0	0
9	6124057	.	G	A	0	11	11	0	11	22	0	0
9	6124100	.	T	C	11	8	19	0	1	20	0	0
9	6124201	.	G	A	0	9	9	0	11	20	0	0
9	6124393	.	C	T	8	4	12	0	0	12	0	0
9	6124478	.	G	A	13	6	19	0	1	20	0	0
9	6124759	.	T	A	14	14	28	0	0	28	0	0
9	6124761	.	T	G	14	14	28	0	0	28	0	0
9	6124884	.	T	C	8	6	14	0	2	16	0	0
9	6125346	.	T	A	6	3	9	0	2	11	0	0
9	6125427	.	G	C	1	5	6	0	0	6	0	0
9	6125501	.	A	C	1	5	6	0	0	6	0	0
9	6125707	.	T	C	4	4	8	0	0	8	0	0
9	6125732	.	C	T	4	3	7	0	1	8	0	0
9	6125761	.	G	T	6	5	11	0	0	11	0	0
9	6125859	.	T	A	14	10	24	0	2	26	0	0
9	6126074	.	T	A	9	19	28	0	0	28	0	0
9	6126288	.	A	C	18	15	33	0	1	34	0	0
9	6126410	.	G	A	12	10	22	0	3	25	0	0
9	6126469	.	G	A	10	13	23	0	2	25	0	0
9	6126781	.	T	G	16	13	29	0	0	29	0	0
9	6126900	.	C	T	11	7	18	0	1	19	0	0
9	6126911	.	C	A	7	7	14	0	1	15	0	0
9	6127075	.	G	A	0	30	30	0	27	57	0	0
9	6127346	.	C	A	15	8	23	0	2	25	0	0
9	6127357	.	C	T	16	12	28	0	2	30	0	0
9	6256165	.	C	T	7	7	14	0	2	16	0	0
9	6256184	.	C	T	2	8	10	0	0	10	0	0
9	6256349	.	A	T	6	2	8	0	2	10	0	0
9	6256541	.	G	A	0	9	9	0	7	16	0	0
9	6380575	.	G	T	1	2	3	0	0	3	0	0
9	6380576	.	T	A	1	2	3	0	0	3	0	0
9	6395548	.	T	C	2	0	2	0	6	8	0	0
9	6395679	.	C	G	10	8	18	0	0	18	0	0
9	6395713	.	G	A	10	12	22	0	0	22	0	0
9	6395792	.	T	A	5	6	11	0	0	11	0	0
9	6395806	.	A	G	0	9	9	0	0	9	0	0
9	6395859	.	G	A	10	5	15	0	0	15	0	0
9	6395957	.	C	T	7	7	14	0	1	15	0	0
9	6396181	.	G	A	5	5	10	0	0	10	0	0
9	6396235	.	A	G	2	5	7	0	1	8	0	0
9	6396242	.	G	A	2	6	8	0	0	8	0	0
9	6396477	.	A	G	4	6	10	0	1	11	0	0
9	6399592	.	C	T	0	0	0	0	1	1	0	0
9	6399610	.	A	G	2	1	3	0	0	3	0	0
9	6399721	.	T	C	5	0	5	0	8	13	0	0
9	6399762	.	C	T	4	4	8	0	0	8	0	0
9	6399869	.	T	C	5	2	7	0	0	7	0	0
9	6399949	.	A	G	4	6	10	0	0	10	0	0
9	6400005	.	A	C	3	3	6	0	0	6	0	0
9	6400191	.	G	A	4	2	6	0	0	6	0	0
9	6400240	.	C	T	0	3	3	0	5	8	0	0
9	6400251	.	G	A	5	3	8	0	0	8	0	0
9	6415385	.	G	A	4	3	7	0	1	8	0	0
9	7092424	.	T	C	6	7	13	0	1	14	0	0
9	7093819	.	A	T	0	5	5	0	0	6	1	0
9	7094141	.	T	C	10	3	13	0	1	14	0	0
9	7094898	.	T	C	16	8	24	0	0	24	0	0
9	7213591	.	T	C	2	1	3	0	1	4	0	0
9	7909585	.	T	C	1	7	8	0	0	8	0	0
9	9736493	.	T	C	8	16	24	0	0	24	0	0
9	10154491	.	T	C	6	4	10	0	0	10	0	0
9	10155977	.	G	A	0	3	3	1	0	4	0	0
9	14197103	.	A	G	11	6	17	0	0	17	0	0
9	16853423	.	C	T	1	1	2	0	0	2	0	0
9	16867489	.	C	T	1	3	4	0	0	4	0	0
9	16867495	.	G	C	1	2	3	0	0	3	0	0
9	16867634	.	C	T	5	3	8	0	0	8	0	0
9	16867646	.	G	A	6	2	8	0	1	9	0	0
9	16867806	.	A	G	12	6	18	0	1	19	0	0
9	16867909	.	A	G	9	10	19	0	1	20	0	0
9	16868233	.	A	G	14	7	21	0	3	24	0	0
9	16868242	.	G	A	14	11	25	0	0	25	0	0
9	16868326	.	T	C	7	1	8	0	16	24	0	0
9	16872592	.	G	A	3	4	7	0	0	7	0	0
9	16872764	.	T	C	10	6	16	0	1	17	0	0
9	16872767	.	T	C	11	6	17	0	0	17	0	0
9	16877408	.	G	A	17	7	24	0	2	26	0	0
9	16877518	.	A	G	4	1	5	0	0	5	0	0
9	17046020	.	T	C	15	19	34	0	1	35	0	0
9	17046736	.	A	G	15	16	31	0	1	32	0	0
9	17047014	.	A	G	23	9	32	0	1	33	0	0
9	17057365	.	T	C	6	7	13	0	2	15	0	0
9	17060311	.	G	A	10	7	17	0	1	18	0	0
9	17067934	.	C	T	7	9	16	0	1	17	0	0
9	17068057	.	T	G	19	9	28	0	0	29	1	0
9	17073498	.	T	C	1	2	3	0	0	3	0	0
9	17074714	.	T	C	18	7	25	0	0	25	0	0
9	17074720	.	T	C	16	6	22	0	1	23	0	0
9	17074792	.	G	A	12	7	19	0	0	19	0	0
9	17077376	.	A	G	8	13	21	0	2	23	0	0
9	17077430	.	C	T	0	3	3	0	6	9	0	0
9	17077439	.	A	G	5	1	6	0	0	6	0	0
9	17080224	.	G	T	9	13	22	0	1	23	0	0
9	17080517	.	G	A	8	15	23	0	0	23	0	0
9	17080970	.	A	G	5	6	11	0	0	11	0	0
9	17082273	.	A	T	13	8	21	0	1	22	0	0
9	17082926	.	G	T	1	0	1	0	0	1	0	0
9	17083053	.	G	A	1	3	4	0	0	4	0	0
9	17083221	.	T	C	9	7	16	0	0	16	0	0
9	17083278	.	G	A	11	13	24	0	0	24	0	0
9	17083296	.	T	A	12	12	24	0	0	24	0	0
9	17083434	.	C	T	7	9	16	0	0	16	0	0
9	17083581	.	G	T	5	14	19	0	1	20	0	0
9	17083908	.	T	C	7	0	7	0	16	23	0	0
9	17083989	.	G	A	7	8	15	0	0	15	0	0
9	17084127	.	T	C	5	1	6	0	4	10	0	0
9	17084229	.	T	C	9	0	9	0	12	21	0	0
9	17084253	.	G	A	7	10	17	0	1	18	0	0
9	17094362	.	A	T	5	3	8	0	0	8	0	0
9	17119143	.	G	A	1	2	3	0	0	3	0	0
9	17119789	.	G	A	5	4	9	0	0	9	0	0
9	17127025	.	C	T	2	2	4	0	0	4	0	0
9	17130282	.	G	A	6	1	7	0	0	7	0	0
9	17139140	.	A	C	1	4	5	0	0	5	0	0
9	17139350	.	A	T	1	9	10	0	1	11	0	0
9	17139378	.	T	C	1	1	2	0	3	5	0	0
9	17145472	.	T	C	1	3	4	0	0	4	0	0
9	17145508	.	T	C	3	3	6	0	0	6	0	0
9	17148204	.	G	A	1	1	2	0	0	2	0	0
9	17163711	.	A	C	0	0	0	0	1	1	0	0
9	17167397	.	A	T	1	1	2	0	2	4	0	0
9	17169110	.	C	T	2	2	4	0	1	5	0	0
9	17169406	.	G	C	2	0	2	0	9	11	0	0
9	17169430	.	A	C	3	6	9	0	1	10	0	0
9	17169681	.	G	A	5	2	7	0	0	7	0	0
9	17169741	.	G	C	1	0	1	0	0	1	0	0
9	17182513	.	C	T	6	4	10	0	0	10	0	0
9	17193186	.	A	G	0	3	3	0	0	3	0	0
9	17193434	.	G	T	5	3	8	0	0	8	0	0
9	17193462	.	G	A	1	1	2	0	0	2	0	0
9	17221785	.	A	G	0	1	1	0	0	1	0	0
9	17221884	.	T	C	1	3	4	0	0	4	0	0
9	17248228	.	A	G	3	4	7	0	2	9	0	0
9	17248464	.	G	T	1	2	3	0	0	3	0	0
9	17349073	.	T	C	4	4	8	0	0	8	0	0
9	17349103	.	G	T	0	2	2	0	4	6	0	0
9	17349125	.	G	A	0	3	3	0	5	8	0	0
9	17349272	.	C	T	2	1	3	0	0	3	0	0
9	17364337	.	C	G	4	3	7	0	0	7	0	0
9	17365231	.	G	A	2	0	2	0	0	2	0	0
9	17368889	.	A	C	8	17	25	0	0	25	0	0
9	17368904	.	C	T	6	19	25	0	0	25	0	0
9	17369071	.	G	A	14	8	22	0	1	23	0	0
9	17379954	.	C	T	14	15	29	0	2	31	0	0
9	17386152	.	C	A	2	9	11	0	0	11	0	0
9	17386154	.	C	T	2	9	11	0	0	11	0	0
9	17386338	.	A	G	4	0	4	0	9	13	0	0
9	17386341	.	G	T	4	9	13	0	0	13	0	0
9	17424198	.	T	C	1	4	5	0	0	5	0	0
9	17424639	.	T	G	2	2	4	0	0	4	0	0
9	17425308	.	T	C	1	3	4	0	0	4	0	0
9	17431469	.	A	G	1	0	1	0	2	3	0	0
9	17431499	.	T	C	1	2	3	0	0	3	0	0
9	17431709	.	T	A	3	5	8	0	0	8	0	0
9	17431720	.	A	G	4	5	9	0	1	10	0	0
9	17431798	.	A	G	3	7	10	0	0	10	0	0
9	17431818	.	C	T	2	6	8	0	0	8	0	0
9	17431925	.	A	T	4	4	8	0	0	8	0	0
9	17431938	.	A	G	4	4	8	0	0	8	0	0
9	17432023	.	T	C	2	2	4	0	0	4	0	0
9	17432155	.	C	T	3	5	8	0	0	8	0	0
9	17432170	.	T	C	2	4	6	0	0	6	0	0
9	17432297	.	G	T	3	3	6	0	2	8	0	0
9	17432484	.	C	A	5	6	11	0	1	12	0	0
9	17433483	.	A	G	5	0	5	0	0	7	2	0
9	17433794	.	G	C	3	2	5	0	1	6	0	0
9	17433983	.	T	G	1	3	4	0	0	4	0	0
9	17445217	.	A	G	4	4	8	0	1	9	0	0
9	17445268	.	T	C	3	2	5	0	0	5	0	0
9	17540692	.	A	C	1	3	4	0	0	4	0	0
9	17540701	.	T	C	1	1	2	0	0	2	0	0
9	17542983	.	C	T	0	2	2	0	1	3	0	0
9	17560343	.	A	G	2	2	4	0	0	4	0	0
9	17563067	.	C	T	1	1	2	0	0	2	0	0
9	17583192	.	G	A	0	1	1	0	0	1	0	0
9	17641518	.	C	T	0	3	3	0	0	3	0	0
9	17647072	.	C	A	4	6	10	0	0	10	0	0
9	17647110	.	G	C	3	2	5	0	0	5	0	0
9	17647111	.	T	C	2	2	4	0	1	5	0	0
9	17745246	.	T	C	1	1	2	0	0	2	0	0
9	17745261	.	T	C	1	1	2	0	0	2	0	0
9	17766253	.	C	T	1	2	3	0	0	3	0	0
9	17766300	.	C	T	0	1	1	0	0	1	0	0
9	17772268	.	C	T	2	2	4	0	0	4	0	0
9	17772295	.	A	G	2	3	5	0	0	5	0	0
9	17781175	.	T	G	0	2	2	0	0	2	0	0
9	17830270	.	T	G	0	2	2	0	0	2	0	0
9	17899179	.	G	A	0	2	2	0	7	9	0	0
9	17907768	.	G	A	1	0	1	0	0	1	0	0
9	17908898	.	A	G	5	7	12	0	0	12	0	0
9	17908958	.	A	C	10	11	21	0	1	22	0	0
9	17912372	.	C	G	0	2	2	0	0	2	0	0
9	17918428	.	A	G	4	5	9	0	0	9	0	0
9	17918485	.	A	G	0	1	1	0	0	1	0	0
9	17918681	.	G	A	0	1	1	0	0	1	0	0
9	17922172	.	T	A	6	6	12	0	0	12	0	0
9	17922191	.	G	C	5	6	11	0	0	11	0	0
9	17934202	.	T	G	4	2	6	0	0	6	0	0
9	17971972	.	C	G	0	2	2	0	0	2	0	0
9	17979350	.	A	C	2	4	6	0	1	7	0	0
9	17979389	.	G	A	3	4	7	0	0	7	0	0
9	17979603	.	T	A	2	4	6	0	1	7	0	0
9	17984914	.	G	T	4	9	13	0	1	14	0	0
9	17987998	.	A	G	10	11	21	0	2	23	0	0
9	17988011	.	C	A	9	10	19	0	1	20	0	0
9	17988072	.	A	C	9	12	21	0	1	22	0	0
9	17988091	.	A	G	9	13	22	0	2	24	0	0
9	18001161	.	T	G	14	15	29	0	0	29	0	0
9	18001200	.	A	C	5	2	7	0	0	7	0	0
9	18003664	.	T	C	13	23	36	0	0	36	0	0
9	18003684	.	C	G	11	24	35	0	1	36	0	0
9	18003807	.	C	T	17	25	42	0	1	43	0	0
9	18003856	.	T	G	23	0	23	0	17	40	0	0
9	18004476	.	A	C	10	17	27	0	4	31	0	0
9	18005023	.	C	T	11	12	23	0	3	27	1	0
9	18005065	.	C	T	18	15	33	0	1	34	0	0
9	18005217	.	A	T	8	14	22	0	0	22	0	0
9	18005245	.	T	C	12	9	21	0	0	21	0	0
9	18005507	.	C	T	9	4	13	0	2	15	0	0
9	18005806	.	A	G	13	7	20	0	2	22	0	0
9	18005864	.	G	A	11	18	29	0	1	30	0	0
9	18005879	.	T	A	8	17	25	0	2	27	0	0
9	18005977	.	T	C	13	17	30	0	1	31	0	0
9	18006144	.	T	A	15	21	36	0	5	41	0	0
9	18006282	.	C	T	20	28	48	0	2	50	0	0
9	18235383	.	A	G	0	1	1	0	0	1	0	0
9	18310309	.	G	A	8	3	11	0	1	12	0	0
9	18320009	.	G	A	3	0	3	0	0	3	0	0
9	18390631	.	T	C	2	2	4	0	0	4	0	0
9	18392777	.	T	G	6	2	8	0	0	8	0	0
9	18392903	.	C	A	4	5	9	0	1	10	0	0
9	18392924	.	G	A	2	3	5	0	0	5	0	0
9	18424739	.	A	T	1	3	4	0	0	4	0	0
9	18568860	.	C	T	0	6	6	0	5	11	0	0
9	18721152	.	A	G	10	12	22	0	0	22	0	0
9	18732543	.	T	A	5	6	11	0	0	11	0	0
9	18732878	.	C	T	0	25	25	0	14	39	0	0
9	18732899	.	G	A	21	25	46	0	1	47	0	0
9	18733592	.	T	C	36	3	39	0	34	73	0	0
9	18735081	.	A	G	26	30	56	0	0	56	0	0
9	18812765	.	A	G	8	7	15	0	0	15	0	0
9	18812960	.	A	G	6	10	16	0	1	17	0	0
9	18813462	.	G	A	10	10	20	0	0	20	0	0
9	18813467	.	A	G	9	10	19	0	0	19	0	0
9	18813624	.	G	A	4	7	11	0	0	11	0	0
9	18813650	.	T	C	4	7	11	0	0	11	0	0
9	18813755	.	T	C	3	3	6	0	0	6	0	0
9	18814328	.	A	G	5	4	9	0	0	9	0	0
9	18814379	.	A	G	3	4	7	0	1	8	0	0
9	18814598	.	T	C	10	7	17	0	0	17	0	0
9	18876332	.	A	T	20	18	38	0	1	39	0	0
9	18876545	.	G	T	17	16	33	0	0	33	0	0
9	18876937	.	C	G	0	18	18	0	17	35	0	0
9	18877051	.	G	A	14	20	34	0	1	35	0	0
9	18877078	.	G	A	15	13	28	0	1	29	0	0
9	18877485	.	T	C	11	0	11	0	25	36	0	0
9	18908954	.	T	C	1	2	3	0	0	3	0	0
9	18909205	.	T	C	4	2	6	0	0	6	0	0
9	18909235	.	A	T	3	2	5	0	0	5	0	0
9	18909242	.	A	T	3	1	4	0	0	4	0	0
9	18909748	.	A	C	3	3	6	0	0	6	0	0
9	18911575	.	G	A	5	5	10	0	0	10	0	0
9	18911593	.	A	C	1	2	3	0	0	3	0	0
9	19027536	.	T	A	7	3	10	0	0	10	0	0
9	19027560	.	G	C	4	3	7	0	1	8	0	0
9	19027582	.	A	T	4	4	8	0	0	8	0	0
9	19027630	.	T	A	4	5	9	0	0	9	0	0
9	19027637	.	G	T	5	4	9	0	0	9	0	0
9	19027748	.	T	C	8	5	13	0	1	14	0	0
9	19074628	.	T	C	4	4	8	0	0	8	0	0
9	19074642	.	G	T	4	4	8	0	0	8	0	0
9	19074687	.	G	A	5	3	8	0	0	8	0	0
9	19086473	.	C	T	2	3	5	0	0	5	0	0
9	19088285	.	C	T	0	1	1	0	0	1	0	0
9	19109043	.	C	T	0	1	1	0	0	1	0	0
9	19114304	.	C	T	1	1	2	0	0	2	0	0
9	19118853	.	T	C	3	11	14	0	0	14	0	0
9	19118990	.	G	A	3	7	10	0	0	10	0	0
9	19119000	.	G	A	3	7	10	0	0	10	0	0
9	19119185	.	T	C	6	9	15	0	1	16	0	0
9	19119214	.	A	G	3	7	10	0	0	10	0	0
9	19119285	.	T	C	4	4	8	0	0	8	0	0
9	19307064	.	C	T	2	2	4	0	0	4	0	0
9	19351977	.	T	C	3	1	4	0	0	4	0	0
9	19351983	.	A	G	3	1	4	0	0	4	0	0
9	19352221	.	T	C	2	2	4	0	0	4	0	0
9	19364025	.	G	A	1	2	3	0	0	3	0	0
9	19368167	.	A	C	1	3	4	0	0	4	0	0
9	19368168	.	A	C	1	3	4	0	0	4	0	0
9	19368235	.	T	C	3	2	5	0	0	5	0	0
9	19393557	.	T	C	0	1	1	0	0	1	0	0
9	19393566	.	T	G	0	1	1	0	0	1	0	0
9	19405943	.	A	G	0	0	0	0	2	2	0	0
9	19405989	.	C	G	2	0	2	0	3	5	0	0
9	19406425	.	T	A	6	5	11	0	0	11	0	0
9	19406564	.	A	T	1	4	5	0	0	5	0	0
9	19406607	.	T	C	1	3	4	0	0	4	0	0
9	19407483	.	G	T	1	2	3	0	1	4	0	0
9	19407546	.	G	T	9	2	11	0	0	11	0	0
9	19407587	.	G	T	1	3	4	0	0	4	0	0
9	19407614	.	G	T	4	4	8	0	0	8	0	0
9	19407998	.	T	A	0	4	4	0	0	4	0	0
9	19408038	.	A	G	1	3	4	0	0	4	0	0
9	19408248	.	A	G	4	3	7	0	1	8	0	0
9	19408345	.	G	A	4	2	6	0	0	6	0	0
9	19469175	.	C	T	4	3	7	0	0	7	0	0
9	19471377	.	A	G	7	4	11	0	0	11	0	0
9	19477792	.	C	T	2	4	6	0	0	6	0	0
9	19477856	.	A	G	1	3	4	0	0	4	0	0
9	19477882	.	T	G	3	3	6	0	0	6	0	0
9	19477979	.	A	G	0	2	2	0	0	2	0	0
9	19480893	.	T	C	4	1	5	0	0	5	0	0
9	19504678	.	C	T	13	3	16	0	0	16	0	0
9	19510730	.	T	G	12	7	19	0	0	19	0	0
9	19510773	.	A	G	9	3	12	0	0	12	0	0
9	19510887	.	T	C	2	5	7	0	1	8	0	0
9	19518690	.	A	T	1	1	2	0	0	2	0	0
9	19523889	.	C	A	2	2	4	0	0	4	0	0
9	19527883	.	T	C	10	17	27	0	1	28	0	0
9	19539222	.	C	T	6	4	10	0	0	10	0	0
9	19539770	.	C	A	3	1	4	0	0	4	0	0
9	19539840	.	T	C	2	0	2	0	0	2	0	0
9	19545511	.	T	G	3	2	5	0	0	5	0	0
9	19545529	.	T	C	2	0	2	0	0	2	0	0
9	19545550	.	T	C	2	0	2	0	0	2	0	0
9	19549346	.	A	G	5	0	5	0	10	15	0	0
9	19549349	.	G	C	5	10	15	0	0	15	0	0
9	19549790	.	G	T	0	5	5	0	5	10	0	0
9	19549868	.	A	T	7	6	13	0	0	13	0	0
9	19549958	.	C	A	2	5	7	0	0	7	0	0
9	19549989	.	G	A	1	3	4	0	0	4	0	0
9	19636514	.	G	A	0	6	6	0	1	7	0	0
9	19639402	.	A	G	0	2	2	0	0	2	0	0
9	19641135	.	A	T	2	4	6	0	0	6	0	0
9	19641138	.	C	A	2	2	4	0	2	6	0	0
9	19648295	.	T	C	5	0	5	0	0	5	0	0
9	19652691	.	A	C	3	4	7	0	1	8	0	0
9	19653200	.	C	T	7	11	18	0	0	18	0	0
9	20076691	.	G	C	13	11	24	0	0	24	0	0
9	20076799	.	A	G	13	8	21	0	1	22	0	0
9	20076847	.	A	G	12	7	19	0	0	19	0	0
9	20076850	.	A	G	12	7	19	0	1	20	0	0
9	20076913	.	T	C	7	2	9	0	18	27	0	0
9	20078034	.	G	A	18	5	23	0	0	23	0	0
9	20095725	.	C	G	8	6	14	0	1	15	0	0
9	20160291	.	T	A	8	4	12	0	0	12	0	0
9	20160387	.	C	T	12	6	18	0	1	19	0	0
9	20174733	.	G	C	3	2	5	0	0	5	0	0
9	20174927	.	T	C	3	0	3	0	3	6	0	0
9	20174954	.	T	C	3	0	3	0	4	7	0	0
9	20191222	.	A	T	2	5	7	0	0	7	0	0
9	20191377	.	T	C	2	0	2	0	5	7	0	0
9	20315509	.	G	A	9	4	13	0	0	13	0	0
9	20315614	.	A	G	4	5	9	0	0	9	0	0
9	20372940	.	C	T	3	3	6	0	0	6	0	0
9	20498630	.	A	T	2	2	4	0	0	4	0	0
9	20498644	.	T	G	2	2	4	0	0	4	0	0
9	20500337	.	A	C	1	3	4	0	2	6	0	0
9	20500347	.	G	A	3	3	6	0	0	6	0	0
9	20501111	.	C	G	3	0	3	0	2	5	0	0
9	20501138	.	G	C	1	2	3	0	1	4	0	0
9	20623998	.	G	A	6	7	13	0	0	13	0	0
9	20700073	.	T	C	3	0	3	0	0	3	0	0
9	20700130	.	T	C	5	4	9	0	0	9	0	0
9	20731284	.	G	A	0	2	2	0	2	4	0	0
9	20731311	.	A	G	0	1	1	0	0	1	0	0
9	20763517	.	C	T	2	8	10	0	0	10	0	0
9	20763564	.	C	T	12	17	29	0	2	31	0	0
9	20763585	.	C	T	16	18	34	0	0	34	0	0
9	20763877	.	C	T	11	10	21	0	1	22	0	0
9	20763907	.	A	T	15	12	27	0	0	27	0	0
9	20764019	.	T	A	9	13	22	0	0	22	0	0
9	20764276	.	A	G	21	0	21	0	10	31	0	0
9	20764468	.	C	T	5	11	16	0	2	18	0	0
9	20764685	.	C	T	15	11	26	0	1	27	0	0
9	20764795	.	T	A	6	5	11	0	2	13	0	0
9	20764877	.	T	C	11	14	25	0	1	26	0	0
9	20765065	.	T	A	9	9	18	0	0	18	0	0
9	20765104	.	A	G	11	3	14	0	0	14	0	0
9	20765193	.	A	G	7	13	20	0	1	21	0	0
9	20806460	.	T	C	1	0	1	0	2	3	0	0
9	20806648	.	A	T	1	2	3	0	0	3	0	0
9	20806657	.	A	G	1	2	3	0	0	3	0	0
9	20806925	.	C	T	6	7	13	0	0	13	0	0
9	20806942	.	C	T	4	3	7	0	2	9	0	0
9	20807171	.	C	T	3	6	9	0	2	11	0	0
9	20807216	.	T	C	6	0	6	0	4	10	0	0
9	20831162	.	T	G	0	3	3	0	0	3	0	0
9	20846506	.	A	G	1	2	3	0	0	3	0	0
9	20849415	.	G	A	1	0	1	0	0	1	0	0
9	20850584	.	A	G	4	3	7	0	0	7	0	0
9	20850647	.	C	A	5	3	8	0	1	9	0	0
9	20850664	.	C	T	2	5	7	0	0	7	0	0
9	20850693	.	G	A	2	3	5	0	0	5	0	0
9	20856381	.	C	T	2	1	3	0	0	3	0	0
9	20859226	.	A	T	1	1	2	0	0	2	0	0
9	20860161	.	G	C	1	2	3	0	0	3	0	0
9	20869156	.	G	T	0	1	1	0	0	1	0	0
9	20870779	.	T	C	1	5	6	0	1	7	0	0
9	20872390	.	G	A	6	3	9	0	0	9	0	0
9	21084729	.	G	A	0	3	3	0	0	3	0	0
9	21084858	.	A	C	4	4	8	0	0	8	0	0
9	21084894	.	G	C	4	3	7	0	0	7	0	0
9	21204063	.	T	G	2	3	5	0	0	5	0	0
9	21204244	.	T	G	2	7	9	0	1	10	0	0
9	21205138	.	A	G	0	2	2	0	0	2	0	0
9	21216897	.	T	C	5	16	21	0	1	22	0	0
9	21216898	.	T	C	6	16	22	0	0	22	0	0
9	21217302	.	C	T	0	3	3	0	1	4	0	0
9	21217438	.	A	G	7	6	13	0	0	13	0	0
9	21221932	.	T	A	1	1	2	0	0	2	0	0
9	21222749	.	G	A	0	12	12	0	3	15	0	0
9	21222750	.	T	A	2	12	14	0	1	15	0	0
9	21222807	.	G	A	0	10	10	0	0	10	0	0
9	21224505	.	A	G	5	1	6	0	13	19	0	0
9	21224671	.	A	C	2	10	12	0	0	12	0	0
9	21224703	.	T	C	3	13	16	0	0	16	0	0
9	21224753	.	G	A	5	15	20	0	0	20	0	0
9	21224768	.	T	G	5	14	19	0	0	19	0	0
9	21224963	.	T	C	4	14	18	0	0	18	0	0
9	21225011	.	C	A	5	9	14	0	0	14	0	0
9	21225461	.	C	A	2	11	13	0	1	14	0	0
9	21225503	.	G	T	0	7	7	0	3	10	0	0
9	21225550	.	G	A	1	6	7	0	1	8	0	0
9	21225761	.	T	A	1	6	7	0	0	7	0	0
9	21225987	.	C	A	1	12	13	0	0	13	0	0
9	21235770	.	A	T	9	12	21	0	1	22	0	0
9	21266854	.	A	G	12	19	31	0	0	31	0	0
9	21266878	.	C	T	1	15	16	0	9	25	0	0
9	21267097	.	T	A	25	22	47	0	4	51	0	0
9	21267133	.	C	T	14	8	22	0	2	24	0	0
9	21272117	.	A	G	1	3	4	0	0	4	0	0
9	21272118	.	A	G	1	2	3	0	1	4	0	0
9	21273105	.	C	A	1	2	3	0	0	3	0	0
9	21273348	.	C	A	2	2	4	0	0	4	0	0
9	21316480	.	C	T	2	1	3	0	0	3	0	0
9	21339110	.	C	T	0	1	1	0	0	1	0	0
9	21347189	.	G	T	0	4	4	0	1	5	0	0
9	21347234	.	G	A	1	4	5	0	0	5	0	0
9	21356621	.	G	A	0	2	2	0	1	3	0	0
9	21357172	.	A	C	2	8	10	0	1	11	0	0
9	21357501	.	T	C	4	2	6	0	0	6	0	0
9	21357526	.	A	C	4	1	5	0	0	5	0	0
9	21361507	.	C	T	0	2	2	0	0	2	0	0
9	21362858	.	A	G	6	8	14	0	0	14	0	0
9	21363388	.	T	C	2	3	5	0	1	6	0	0
9	21365805	.	A	T	1	2	3	0	0	3	0	0
9	21366340	.	G	A	6	11	17	0	0	17	0	0
9	21366346	.	A	G	4	9	13	0	0	13	0	0
9	21374039	.	G	A	4	7	11	0	0	11	0	0
9	21375928	.	G	A	0	4	4	0	0	4	0	0
9	21375997	.	G	A	6	2	8	0	1	9	0	0
9	21376217	.	C	T	2	1	3	0	0	3	0	0
9	21376279	.	G	A	5	3	8	0	0	8	0	0
9	21376280	.	A	G	5	3	8	0	0	8	0	0
9	21377476	.	A	G	1	0	1	0	0	1	0	0
9	21379041	.	C	T	4	5	9	0	0	9	0	0
9	21383354	.	C	T	2	6	8	0	0	8	0	0
9	21383375	.	G	A	2	5	7	0	0	7	0	0
9	21383474	.	T	A	4	2	6	0	0	6	0	0
9	21383483	.	A	T	2	2	4	0	1	5	0	0
9	21383725	.	G	A	6	3	9	0	0	9	0	0
9	21383758	.	G	A	4	2	6	0	0	6	0	0
9	21385937	.	C	T	2	2	4	0	0	4	0	0
9	21385956	.	A	G	4	0	4	0	6	10	0	0
9	21388976	.	A	G	0	2	2	0	1	3	0	0
9	21391949	.	C	T	7	8	15	0	0	15	0	0
9	21399392	.	T	G	1	5	6	0	0	6	0	0
9	21430647	.	C	T	10	3	13	0	1	14	0	0
9	21430889	.	T	C	5	8	13	0	1	14	0	0
9	21437038	.	C	T	1	1	2	0	1	3	0	0
9	21437060	.	G	A	2	1	3	0	0	3	0	0
9	21437094	.	A	G	1	1	2	0	0	2	0	0
9	21437349	.	G	A	5	2	7	0	0	7	0	0
9	21440071	.	A	G	2	4	6	0	0	6	0	0
9	21448023	.	T	G	3	3	6	0	0	6	0	0
9	21449792	.	G	C	2	0	2	0	2	4	0	0
9	21449914	.	A	T	7	4	11	0	0	11	0	0
9	21453954	.	G	A	0	4	4	0	0	4	0	0
9	21453986	.	G	A	1	7	8	0	0	8	0	0
9	21462651	.	T	C	5	9	14	0	0	14	0	0
9	21462692	.	C	T	0	9	9	0	6	15	0	0
9	21463152	.	C	T	0	13	13	0	13	26	0	0
9	21463333	.	T	A	5	10	15	0	2	17	0	0
9	21470362	.	A	G	10	5	15	0	1	16	0	0
9	21470446	.	T	C	2	0	2	0	0	2	0	0
9	21471685	.	T	C	6	5	11	0	0	11	0	0
9	21472758	.	G	T	1	3	4	0	0	4	0	0
9	21476284	.	T	C	2	5	7	0	0	7	0	0
9	21476307	.	T	G	2	5	7	0	0	7	0	0
9	21478881	.	C	T	0	10	10	0	6	16	0	0
9	21478935	.	T	C	9	7	16	0	1	17	0	0
9	21479115	.	C	T	0	8	8	0	6	14	0	0
9	21479295	.	G	A	7	6	13	0	1	14	0	0
9	21496662	.	T	C	1	2	3	0	0	3	0	0
9	21535963	.	A	G	11	1	12	0	11	23	0	0
9	21540992	.	C	T	2	2	4	0	0	4	0	0
9	21550306	.	T	C	5	2	7	0	0	7	0	0
9	21554226	.	A	G	4	4	8	0	2	10	0	0
9	21558019	.	G	A	6	6	12	0	1	13	0	0
9	21558276	.	T	C	4	6	10	0	0	10	0	0
9	21558279	.	A	G	4	0	4	0	5	9	0	0
9	21560580	.	G	A	1	1	2	0	0	2	0	0
9	21560749	.	T	C	9	16	25	0	2	27	0	0
9	21561709	.	A	T	17	16	33	0	1	34	0	0
9	21563194	.	T	C	3	3	6	0	0	6	0	0
9	21722951	.	T	C	12	13	25	0	0	25	0	0
9	21723202	.	C	A	7	9	16	0	1	17	0	0
9	21724003	.	G	A	0	7	7	0	15	22	0	0
9	21802933	.	A	T	1	1	2	0	0	2	0	0
9	21803062	.	A	T	3	2	5	0	0	5	0	0
9	21805160	.	T	C	2	2	4	0	0	4	0	0
9	21808049	.	T	C	4	2	6	0	0	6	0	0
9	21810866	.	C	T	0	2	2	0	1	3	0	0
9	21810899	.	G	A	2	4	6	0	1	7	0	0
9	21811157	.	A	G	1	3	4	0	0	4	0	0
9	21811211	.	C	G	4	2	6	0	0	6	0	0
9	21811829	.	T	C	7	7	14	0	0	14	0	0
9	21811872	.	T	G	2	2	4	0	1	5	0	0
9	21812480	.	C	T	11	4	15	0	0	15	0	0
9	21821061	.	T	C	8	5	13	0	0	13	0	0
9	21821362	.	A	G	21	0	21	0	15	36	0	0
9	21821437	.	C	T	12	12	24	0	1	25	0	0
9	21824069	.	C	G	10	1	11	0	11	22	0	0
9	21824124	.	G	A	1	19	20	0	8	28	0	0
9	21824510	.	T	C	8	24	32	0	0	32	0	0
9	21824564	.	A	C	7	10	17	0	1	18	0	0
9	21824788	.	G	A	6	3	9	0	0	9	0	0
9	21824847	.	T	C	12	16	28	0	2	30	0	0
9	21825345	.	C	T	1	1	2	0	0	2	0	0
9	21825632	.	G	A	13	13	26	0	0	26	0	0
9	21825819	.	C	A	11	17	28	0	2	30	0	0
9	21825844	.	A	G	6	11	17	0	0	17	0	0
9	21826752	.	T	A	2	2	4	0	1	5	0	0
9	21826817	.	C	T	7	10	17	0	0	17	0	0
9	21826893	.	G	A	7	9	16	0	0	16	0	0
9	21829505	.	C	T	6	8	14	0	1	15	0	0
9	21831293	.	T	A	3	4	7	0	0	7	0	0
9	21834366	.	G	T	1	3	4	0	0	4	0	0
9	21843991	.	C	T	13	14	27	0	0	27	0	0
9	21844190	.	C	A	10	7	17	0	1	18	0	0
9	21844438	.	T	A	9	7	16	0	0	16	0	0
9	21844702	.	A	G	10	5	15	0	0	15	0	0
9	21844944	.	T	C	12	11	23	0	0	23	0	0
9	21845038	.	C	A	6	4	10	0	1	12	1	0
9	21845142	.	G	A	6	9	15	0	2	17	0	0
9	21845208	.	G	A	6	9	15	0	1	16	0	0
9	21845365	.	G	C	13	8	21	0	0	21	0	0
9	21845366	.	G	A	13	8	21	0	0	21	0	0
9	21845541	.	T	C	5	7	12	0	0	12	0	0
9	21893856	.	A	G	10	10	20	0	1	21	0	0
9	21893862	.	G	A	10	10	20	0	2	22	0	0
9	21894057	.	T	G	13	8	21	0	0	21	0	0
9	21899687	.	T	C	8	9	17	0	2	19	0	0
9	21899795	.	T	C	10	0	10	0	8	18	0	0
9	21899973	.	G	A	1	1	2	0	0	2	0	0
9	21900123	.	C	A	2	7	9	0	0	9	0	0
9	21904973	.	G	A	8	5	13	0	0	13	0	0
9	21906892	.	T	C	1	2	3	0	0	3	0	0
9	21914170	.	A	G	2	4	6	0	0	6	0	0
9	21914184	.	C	G	0	5	5	0	3	8	0	0
9	21919162	.	G	C	9	6	15	0	1	16	0	0
9	21919360	.	G	T	6	6	12	0	0	12	0	0
9	21919908	.	G	T	2	5	7	0	0	7	0	0
9	21927072	.	C	T	5	4	9	0	0	9	0	0
9	21927241	.	T	C	6	0	6	0	5	11	0	0
9	21927288	.	C	T	5	2	7	0	1	8	0	0
9	21930120	.	G	T	5	6	11	0	1	12	0	0
9	21931277	.	G	C	4	4	8	0	0	8	0	0
9	21931295	.	A	G	4	4	8	0	0	8	0	0
9	21971511	.	G	T	2	4	6	0	0	6	0	0
9	21974246	.	T	C	1	1	2	0	0	2	0	0
9	21974252	.	A	C	2	2	4	0	0	4	0	0
9	21976540	.	T	C	3	14	17	0	3	20	0	0
9	22483715	.	G	C	3	4	7	0	0	7	0	0
9	22483724	.	G	A	0	4	4	0	4	8	0	0
9	22489092	.	A	C	1	2	3	0	0	3	0	0
9	22634324	.	T	C	1	0	1	0	1	2	0	0
9	22636747	.	C	T	14	18	32	0	1	33	0	0
9	22636988	.	C	T	16	15	31	0	3	34	0	0
9	22637031	.	C	G	19	25	44	0	1	45	0	0
9	22637082	.	A	T	19	22	41	0	3	44	0	0
9	22638738	.	C	G	23	16	39	0	1	40	0	0
9	22647331	.	T	C	16	20	36	0	0	36	0	0
9	22647373	.	A	G	19	0	19	0	22	41	0	0
9	22647391	.	C	T	18	20	38	0	3	41	0	0
9	22647607	.	A	T	18	18	36	0	0	36	0	0
9	22647754	.	A	T	12	19	31	0	0	31	0	0
9	22647755	.	A	T	13	18	31	0	0	31	0	0
9	22648004	.	A	G	6	1	7	0	12	19	0	0
9	22648010	.	G	A	0	12	12	0	8	20	0	0
9	22648051	.	T	C	11	13	24	0	0	24	0	0
9	22648355	.	A	T	14	27	41	0	1	42	0	0
9	22648747	.	T	G	20	19	39	0	2	41	0	0
9	22649019	.	T	A	3	2	5	0	0	5	0	0
9	22677597	.	T	G	4	2	6	0	0	6	0	0
9	22677657	.	G	T	1	3	4	0	0	4	0	0
9	22677684	.	G	C	1	3	4	0	0	4	0	0
9	22694612	.	T	C	1	0	1	0	0	1	0	0
9	22694621	.	G	A	1	0	1	0	0	1	0	0
9	22707105	.	T	C	1	1	2	0	0	2	0	0
9	22707477	.	C	T	3	1	4	0	0	4	0	0
9	22707493	.	C	A	2	1	3	0	0	3	0	0
9	22747419	.	A	G	4	0	4	0	13	17	0	0
9	22747557	.	A	G	17	8	25	0	0	25	0	0
9	22747644	.	G	A	0	8	8	0	11	19	0	0
9	22747811	.	G	T	3	3	6	0	0	6	0	0
9	22747865	.	A	C	1	4	5	0	0	5	0	0
9	22747943	.	G	T	0	2	2	0	2	4	0	0
9	22797500	.	G	A	3	5	8	0	0	8	0	0
9	22797816	.	C	A	4	8	12	0	0	12	0	0
9	22797962	.	A	C	2	5	7	0	0	7	0	0
9	22798087	.	C	T	3	8	11	0	0	11	0	0
9	22798789	.	C	T	7	2	9	0	0	9	0	0
9	22799115	.	T	A	4	4	8	0	0	8	0	0
9	22799157	.	G	A	2	4	6	0	1	7	0	0
9	22799456	.	G	C	1	5	6	0	10	16	0	0
9	22799508	.	T	C	8	4	12	0	0	12	0	0
9	22799810	.	A	G	11	6	17	0	1	18	0	0
9	22799883	.	C	T	6	8	14	0	0	14	0	0
9	22800271	.	T	C	2	1	3	0	0	3	0	0
9	22801205	.	C	T	1	3	4	0	0	4	0	0
9	22801527	.	C	T	6	6	12	0	1	13	0	0
9	22801746	.	A	G	4	6	10	0	1	11	0	0
9	22801785	.	A	G	3	0	3	0	6	9	0	0
9	22801860	.	C	A	5	3	8	0	0	8	0	0
9	22801929	.	A	G	4	3	7	0	1	8	0	0
9	22802045	.	A	G	3	0	3	0	2	5	0	0
9	22802066	.	G	A	0	4	4	0	4	8	0	0
9	22902938	.	A	T	5	5	10	0	0	10	0	0
9	22902997	.	G	A	6	6	12	0	2	14	0	0
9	22903012	.	T	G	5	8	13	0	0	13	0	0
9	22903166	.	C	T	0	16	16	0	16	32	0	0
9	22903270	.	A	T	13	15	28	0	1	29	0	0
9	22906425	.	C	T	1	4	5	0	0	5	0	0
9	22932366	.	T	G	9	3	12	0	0	12	0	0
9	22937852	.	G	A	1	1	2	0	0	2	0	0
9	22938719	.	A	T	10	7	17	0	0	17	0	0
9	22938828	.	T	G	3	5	8	0	1	9	0	0
9	22938932	.	T	G	9	0	9	0	12	21	0	0
9	22938967	.	T	G	6	17	23	0	0	23	0	0
9	22939068	.	A	G	5	10	15	0	2	17	0	0
9	22939201	.	C	G	4	7	11	0	2	13	0	0
9	22939308	.	A	T	3	2	5	0	0	5	0	0
9	22941166	.	C	A	5	6	11	0	0	11	0	0
9	22941285	.	G	T	4	8	12	0	0	12	0	0
9	22946494	.	G	A	1	4	5	0	0	5	0	0
9	22949353	.	C	T	6	4	10	0	2	12	0	0
9	22962612	.	A	G	1	2	3	0	0	3	0	0
9	22963331	.	C	T	0	3	3	0	1	4	0	0
9	23004411	.	C	A	3	2	5	0	0	5	0	0
9	23009721	.	C	G	3	3	6	0	0	6	0	0
9	23009730	.	T	C	3	2	5	0	0	5	0	0
9	23009923	.	G	A	1	2	3	0	0	3	0	0
9	23016422	.	T	C	4	2	6	0	0	6	0	0
9	23016482	.	T	A	1	0	1	0	0	1	0	0
9	23016709	.	G	A	2	2	4	0	0	4	0	0
9	23018709	.	C	A	7	3	10	0	0	10	0	0
9	23022763	.	A	T	3	6	9	0	0	9	0	0
9	23023047	.	A	T	6	4	10	0	0	10	0	0
9	23023064	.	C	T	5	5	10	0	0	10	0	0
9	23023103	.	G	C	3	6	9	0	2	11	0	0
9	23026412	.	A	T	5	5	10	0	1	11	0	0
9	23026901	.	C	T	15	8	23	0	3	26	0	0
9	23033771	.	T	C	11	0	11	0	6	17	0	0
9	23049577	.	A	G	1	0	1	0	0	1	0	0
9	23055635	.	C	T	5	7	12	0	1	13	0	0
9	23055644	.	A	G	5	13	18	0	0	18	0	0
9	23055674	.	G	C	4	14	18	0	4	22	0	0
9	23056098	.	A	T	3	5	8	0	0	8	0	0
9	23056104	.	G	C	3	4	7	0	0	7	0	0
9	23056148	.	A	T	0	4	4	0	0	4	0	0
9	23071272	.	A	G	1	2	3	0	0	3	0	0
9	23185674	.	A	G	11	15	26	0	3	29	0	0
9	23185786	.	A	C	9	4	13	0	0	13	0	0
9	23185801	.	T	A	6	1	7	0	0	7	0	0
9	23186163	.	A	C	21	6	27	0	0	28	1	0
9	23188003	.	C	T	1	0	1	0	0	1	0	0
9	23194587	.	G	A	4	8	12	0	0	12	0	0
9	23194608	.	A	T	7	8	15	0	1	16	0	0
9	23198166	.	C	T	4	2	6	0	0	6	0	0
9	23202123	.	C	T	1	0	1	0	0	1	0	0
9	23202433	.	A	T	2	5	7	0	0	7	0	0
9	23202743	.	G	A	3	6	9	0	0	9	0	0
9	23216991	.	G	T	3	4	7	0	1	8	0	0
9	23216995	.	A	T	3	3	6	0	1	7	0	0
9	23217093	.	C	T	5	7	12	0	0	12	0	0
9	23234567	.	T	C	11	0	11	0	6	17	0	0
9	23234777	.	C	T	2	12	14	0	9	23	0	0
9	23236339	.	T	C	10	8	18	0	1	19	0	0
9	23236465	.	G	C	9	13	22	0	2	24	0	0
9	23236515	.	G	A	13	13	26	0	1	27	0	0
9	23236531	.	C	T	0	15	15	0	12	27	0	0
9	23357063	.	T	A	1	4	5	0	0	5	0	0
9	23357134	.	A	G	5	5	10	0	1	11	0	0
9	23357142	.	G	C	5	1	6	0	4	10	0	0
9	23357194	.	C	T	7	8	15	0	1	16	0	0
9	23357200	.	T	C	7	8	15	0	1	16	0	0
9	23357234	.	C	G	6	9	15	0	2	17	0	0
9	23357317	.	T	C	6	0	6	0	8	14	0	0
9	23357528	.	C	T	13	7	20	0	2	22	0	0
9	23597979	.	A	C	1	2	3	0	0	3	0	0
9	23718066	.	G	T	1	2	3	0	0	3	0	0
9	23740555	.	G	C	5	9	14	0	1	15	0	0
9	23740676	.	A	G	13	9	22	0	0	22	0	0
9	23745176	.	C	T	0	5	5	0	3	8	0	0
9	23745201	.	T	A	3	3	6	0	0	6	0	0
9	23745471	.	C	A	15	13	28	0	1	29	0	0
9	23745504	.	A	G	13	14	27	0	2	29	0	0
9	23745531	.	C	T	15	16	31	0	0	31	0	0
9	23745558	.	T	C	11	0	11	0	9	20	0	0
9	23745570	.	G	A	6	8	14	0	1	15	0	0
9	23746628	.	A	G	11	14	25	0	0	25	0	0
9	23746676	.	G	A	11	12	23	0	2	25	0	0
9	23747118	.	G	A	2	2	4	0	0	4	0	0
9	23747226	.	A	C	9	7	16	0	0	16	0	0
9	23748417	.	C	G	5	8	13	0	0	13	0	0
9	23748421	.	A	G	4	10	14	0	1	15	0	0
9	23748993	.	G	C	1	3	4	0	0	4	0	0
9	23750634	.	T	C	6	6	12	0	0	12	0	0
9	23750643	.	C	T	5	3	8	0	0	8	0	0
9	23754905	.	T	C	8	10	18	0	0	18	0	0
9	23754989	.	C	A	5	9	14	0	0	14	0	0
9	23755024	.	A	T	6	13	19	0	0	19	0	0
9	23755083	.	C	G	7	8	15	0	0	15	0	0
9	23755647	.	C	T	3	2	5	0	0	5	0	0
9	23755650	.	G	A	3	2	5	0	0	5	0	0
9	23755774	.	G	A	11	4	15	0	0	15	0	0
9	23755883	.	C	T	3	5	8	0	0	8	0	0
9	23755897	.	G	C	3	5	8	0	0	8	0	0
9	23756108	.	G	C	4	3	7	0	0	7	0	0
9	23756268	.	G	A	4	8	12	0	0	12	0	0
9	23756298	.	A	G	5	1	6	0	3	9	0	0
9	23756332	.	T	A	2	7	9	0	1	10	0	0
9	23756377	.	G	A	6	3	9	0	0	9	0	0
9	23756519	.	C	T	4	10	14	0	0	14	0	0
9	23756552	.	C	T	7	8	15	0	1	16	0	0
9	23756584	.	T	C	6	6	12	0	1	13	0	0
9	23756636	.	T	A	2	6	8	0	0	8	0	0
9	23756640	.	C	G	2	4	6	0	2	8	0	0
9	23810426	.	A	G	3	4	7	0	0	7	0	0
9	23814104	.	G	C	13	11	24	0	1	25	0	0
9	23823895	.	A	G	9	20	29	0	0	30	1	0
9	23826525	.	A	G	2	3	5	0	0	5	0	0
9	23826534	.	G	A	2	3	5	0	0	5	0	0
9	23832650	.	C	A	3	2	5	0	3	8	0	0
9	23832689	.	C	T	1	5	6	0	0	6	0	0
9	23836415	.	T	C	2	0	2	0	0	2	0	0
9	23838898	.	C	T	1	2	3	0	0	3	0	0
9	23840554	.	G	A	3	2	5	0	0	5	0	0
9	23840775	.	G	C	1	7	8	0	2	10	0	0
9	23840824	.	C	T	3	5	8	0	0	8	0	0
9	23841000	.	A	G	1	0	1	0	4	5	0	0
9	23841037	.	T	G	2	4	6	0	0	6	0	0
9	23841088	.	G	A	1	4	5	0	0	5	0	0
9	23841139	.	T	C	2	5	7	0	0	7	0	0
9	23841507	.	C	G	3	3	6	0	0	6	0	0
9	23841533	.	A	G	3	0	3	0	1	4	0	0
9	23843116	.	A	G	2	1	3	0	0	3	0	0
9	23843157	.	G	A	2	2	4	0	0	4	0	0
9	23843173	.	A	C	2	2	4	0	0	4	0	0
9	23862447	.	T	G	2	2	4	0	0	4	0	0
9	23862467	.	A	T	1	2	3	0	1	4	0	0
9	23862851	.	C	T	0	2	2	0	1	3	0	0
9	23914555	.	T	C	6	6	12	0	0	12	0	0
9	24026088	.	G	T	1	2	3	0	0	3	0	0
9	24026116	.	C	A	2	3	5	0	0	5	0	0
9	24026205	.	C	A	2	4	6	0	1	7	0	0
9	24026332	.	G	T	8	4	12	0	0	12	0	0
9	24026397	.	G	A	7	6	13	0	1	14	0	0
9	24026400	.	G	A	7	7	14	0	0	14	0	0
9	24044847	.	T	C	2	2	4	0	0	4	0	0
9	24107215	.	G	A	3	3	6	0	0	6	0	0
9	24107251	.	C	A	2	1	3	0	1	4	0	0
9	24114126	.	C	T	0	2	2	0	0	2	0	0
9	24114826	.	C	T	2	6	8	0	0	8	0	0
9	24114994	.	G	A	2	4	6	0	0	6	0	0
9	24115004	.	C	T	2	4	6	0	0	6	0	0
9	24116512	.	T	C	5	0	5	0	3	8	0	0
9	24116814	.	G	A	4	5	9	0	1	10	0	0
9	24116915	.	C	A	4	6	10	0	0	10	0	0
9	24117048	.	C	A	0	10	10	0	3	13	0	0
9	24122676	.	C	T	3	2	5	0	1	6	0	0
9	24122715	.	G	T	0	6	6	0	3	9	0	0
9	24123504	.	T	C	4	3	7	0	0	7	0	0
9	24159317	.	T	G	2	1	3	0	0	3	0	0
9	24159634	.	G	A	0	3	3	0	2	5	0	0
9	24159805	.	C	A	3	7	10	0	2	12	0	0
9	24165519	.	C	T	0	2	2	0	0	2	0	0
9	24166729	.	T	C	6	3	9	0	0	9	0	0
9	24166846	.	C	T	2	1	3	0	2	5	0	0
9	24166867	.	A	G	3	3	6	0	0	6	0	0
9	24167180	.	A	G	2	0	2	0	5	7	0	0
9	24178660	.	G	A	2	1	3	0	0	3	0	0
9	24183438	.	T	C	3	4	7	0	0	7	0	0
9	24183603	.	C	T	0	1	1	0	0	1	0	0
9	24186269	.	G	A	2	1	3	0	0	3	0	0
9	24187510	.	C	A	6	7	13	0	0	13	0	0
9	24187675	.	T	G	7	3	10	0	0	10	0	0
9	24187805	.	C	G	3	5	8	0	0	9	1	0
9	24187967	.	A	G	9	0	9	0	11	20	0	0
9	24188100	.	A	T	2	4	6	0	0	6	0	0
9	24188110	.	A	T	3	3	6	0	0	6	0	0
9	24188729	.	C	G	3	7	10	0	0	10	0	0
9	24188969	.	T	G	10	7	17	0	1	18	0	0
9	24189179	.	T	G	7	4	11	0	2	13	0	0
9	24189198	.	A	G	5	6	11	0	0	11	0	0
9	24189283	.	G	A	5	3	8	0	1	9	0	0
9	24189407	.	A	G	9	12	21	0	3	24	0	0
9	24189757	.	C	A	8	9	17	0	0	17	0	0
9	24189825	.	T	A	10	6	16	0	0	16	0	0
9	24189946	.	C	T	8	4	12	3	1	16	0	0
9	24190010	.	G	A	11	6	17	0	0	17	0	0
9	24190020	.	G	A	10	7	17	0	1	18	0	0
9	24190048	.	T	C	7	14	21	0	1	22	0	0
9	24190139	.	A	G	5	11	16	0	0	16	0	0
9	24190295	.	T	C	5	5	10	0	1	11	0	0
9	24190302	.	A	G	5	5	10	0	0	10	0	0
9	24190419	.	G	A	11	8	19	0	0	19	0	0
9	24190466	.	G	T	8	7	15	0	0	15	0	0
9	24190489	.	C	G	7	8	15	0	1	16	0	0
9	24190547	.	C	A	5	7	12	0	0	12	0	0
9	24190748	.	G	T	9	5	14	0	0	14	0	0
9	24190792	.	A	G	14	7	21	0	0	21	0	0
9	24191053	.	T	A	6	10	16	0	1	17	0	0
9	24191462	.	G	A	6	11	17	0	3	20	0	0
9	24192423	.	T	C	2	2	4	0	0	4	0	0
9	24197435	.	G	A	0	3	3	0	2	5	0	0
9	24197447	.	T	C	4	3	7	0	0	7	0	0
9	24201111	.	A	G	1	1	2	0	1	3	0	0
9	24204218	.	C	T	3	4	7	0	0	7	0	0
9	24204231	.	A	T	3	5	8	0	0	8	0	0
9	24204661	.	T	A	5	4	9	0	0	9	0	0
9	24204723	.	T	A	8	6	14	0	0	14	0	0
9	24204749	.	T	A	8	7	15	0	0	15	0	0
9	24204762	.	A	G	6	5	11	0	1	12	0	0
9	24204806	.	T	C	7	0	7	0	3	10	0	0
9	24204905	.	T	A	8	8	16	0	0	16	0	0
9	24204913	.	G	C	9	7	16	0	0	16	0	0
9	24204947	.	A	C	6	9	15	0	0	15	0	0
9	24205136	.	G	A	5	5	10	0	0	11	1	0
9	24205242	.	C	G	5	8	13	0	0	13	0	0
9	24205260	.	C	T	6	3	9	0	0	9	0	0
9	24205292	.	C	T	4	2	6	0	0	6	0	0
9	24205318	.	A	G	2	7	9	0	0	9	0	0
9	24205484	.	A	G	5	4	9	0	0	9	0	0
9	24205596	.	C	T	7	10	17	0	1	18	0	0
9	24205681	.	G	T	10	7	17	0	0	17	0	0
9	24205818	.	G	T	7	6	13	0	3	16	0	0
9	24205916	.	G	A	10	9	19	0	1	20	0	0
9	24208774	.	T	C	4	5	9	0	0	9	0	0
9	24208779	.	T	A	5	5	10	0	1	11	0	0
9	24208825	.	T	C	7	1	8	0	8	16	0	0
9	24209052	.	G	A	4	8	12	0	1	13	0	0
9	24209663	.	C	T	1	2	3	0	0	3	0	0
9	24210083	.	A	G	2	0	2	0	0	2	0	0
9	24210301	.	T	C	0	1	1	0	0	1	0	0
9	24211172	.	A	G	7	1	8	0	2	10	0	0
9	24212157	.	C	T	3	2	5	0	3	8	0	0
9	24212230	.	T	G	1	0	1	0	5	6	0	0
9	24212277	.	C	T	2	3	5	0	1	6	0	0
9	24212299	.	G	A	4	4	8	0	0	8	0	0
9	24212585	.	A	C	0	2	2	0	0	2	0	0
9	24212629	.	T	A	3	6	9	0	0	9	0	0
9	24212654	.	T	A	4	4	8	0	1	9	0	0
9	24212748	.	T	C	3	3	6	0	0	6	0	0
9	24216417	.	C	T	0	1	1	0	0	1	0	0
9	24217459	.	G	A	4	3	7	0	0	7	0	0
9	24217801	.	T	A	6	3	9	0	1	10	0	0
9	24217829	.	T	G	2	5	7	0	0	7	0	0
9	24217894	.	T	A	7	2	9	0	0	9	0	0
9	24217910	.	T	C	2	6	8	0	0	8	0	0
9	24249396	.	T	G	18	14	32	0	2	34	0	0
9	24249414	.	T	C	15	0	15	0	15	30	0	0
9	24252457	.	C	T	1	21	22	0	13	35	0	0
9	24252490	.	T	C	14	0	14	0	22	36	0	0
9	24255690	.	G	T	0	1	1	0	0	1	0	0
9	24366142	.	G	A	27	10	37	0	0	37	0	0
9	24412781	.	A	G	12	13	25	0	6	31	0	0
9	24412790	.	A	G	14	17	31	0	1	32	0	0
9	24950673	.	T	G	2	2	4	0	0	4	0	0
9	24950674	.	A	T	2	2	4	0	0	4	0	0
9	25123436	.	A	C	2	2	4	0	0	4	0	0
9	25132516	.	C	T	3	1	4	0	1	5	0	0
9	25148540	.	C	A	1	0	1	0	0	1	0	0
9	25154910	.	T	A	2	0	2	0	0	2	0	0
9	25167271	.	C	T	0	2	2	0	1	3	0	0
9	25167404	.	T	A	2	2	4	0	1	5	0	0
9	25167433	.	A	T	3	3	6	0	1	7	0	0
9	25169258	.	A	T	1	4	5	0	0	5	0	0
9	25169295	.	T	A	2	4	6	0	0	6	0	0
9	25169380	.	A	G	3	9	12	0	1	13	0	0
9	25169399	.	T	A	4	7	11	0	0	11	0	0
9	25169444	.	T	G	1	7	8	0	0	8	0	0
9	25169609	.	T	C	4	5	9	0	0	9	0	0
9	25169738	.	G	A	6	4	10	0	0	10	0	0
9	25177600	.	A	G	6	4	10	0	0	10	0	0
9	25177642	.	A	G	1	3	4	0	0	4	0	0
9	25180196	.	G	A	4	1	5	0	0	5	0	0
9	25198560	.	T	C	5	2	7	0	0	7	0	0
9	25198606	.	T	G	3	2	5	0	0	5	0	0
9	25320812	.	C	T	4	2	6	0	0	6	0	0
9	25320914	.	T	A	7	5	12	0	0	12	0	0
9	25320980	.	A	T	7	9	16	0	0	16	0	0
9	25321538	.	G	A	5	5	10	0	0	10	0	0
9	25326386	.	G	A	0	1	1	0	1	2	0	0
9	25326482	.	C	T	2	2	4	0	7	11	0	0
9	25337403	.	C	T	0	2	2	0	0	2	0	0
9	25337468	.	C	T	3	8	11	0	0	11	0	0
9	25337499	.	G	A	2	4	6	0	0	6	0	0
9	25337529	.	G	A	1	5	6	0	0	6	0	0
9	25345948	.	A	G	4	6	10	0	1	11	0	0
9	25345974	.	A	G	4	6	10	0	0	10	0	0
9	25346001	.	G	T	1	8	9	0	2	11	0	0
9	25347908	.	T	A	4	3	7	0	1	8	0	0
9	25347916	.	G	T	4	2	6	0	2	8	0	0
9	25349838	.	G	A	7	8	15	0	0	15	0	0
9	25353387	.	C	T	0	7	7	0	6	14	1	0
9	25356838	.	A	G	3	5	8	0	0	8	0	0
9	25381021	.	A	G	13	11	24	0	3	27	0	0
9	25381150	.	A	G	10	12	22	0	0	22	0	0
9	25382028	.	T	C	7	0	7	0	4	11	0	0
9	25382097	.	T	C	6	5	11	0	0	11	0	0
9	25382322	.	C	G	8	5	13	0	0	13	0	0
9	25382478	.	C	A	5	4	9	0	0	9	0	0
9	25383046	.	C	A	5	9	14	0	0	14	0	0
9	25383124	.	T	C	10	0	10	0	6	16	0	0
9	25383780	.	A	C	4	7	11	0	0	11	0	0
9	25384091	.	G	A	6	8	14	0	0	14	0	0
9	25388150	.	T	C	1	0	1	0	0	1	0	0
9	25389823	.	G	A	0	1	1	0	0	1	0	0
9	25389931	.	G	A	6	3	9	0	0	9	0	0
9	25392985	.	C	T	2	3	5	0	1	6	0	0
9	25393036	.	T	C	7	4	11	0	0	11	0	0
9	25419211	.	C	G	2	3	5	0	0	5	0	0
9	25443163	.	T	A	2	4	6	0	1	7	0	0
9	25443330	.	A	T	4	3	7	0	0	7	0	0
9	25443352	.	A	T	3	3	6	0	0	6	0	0
9	25443419	.	G	T	2	3	5	0	0	5	0	0
9	25443575	.	A	T	8	4	12	0	0	12	0	0
9	25443650	.	C	T	4	3	7	0	0	7	0	0
9	25443667	.	A	G	3	4	7	0	0	7	0	0
9	25443702	.	T	C	3	2	5	0	1	6	0	0
9	25444055	.	T	G	2	3	5	0	0	5	0	0
9	25837206	.	A	T	1	5	6	0	0	6	0	0
9	27390711	.	T	A	1	0	1	0	0	1	0	0
9	27691970	.	A	G	2	2	4	0	0	4	0	0
9	27692017	.	T	C	1	3	4	0	0	4	0	0
9	27692075	.	G	T	2	3	5	0	0	5	0	0
9	27692121	.	C	A	0	3	3	0	7	10	0	0
9	27692325	.	A	G	10	7	17	0	0	17	0	0
9	27692329	.	G	T	11	8	19	0	0	19	0	0
9	27692389	.	A	G	5	6	11	0	0	11	0	0
9	27692402	.	G	T	3	4	7	0	0	7	0	0
9	27692471	.	C	T	0	5	5	0	5	10	0	0
9	27692699	.	C	G	0	8	8	0	11	19	0	0
9	27694630	.	T	C	4	5	9	0	0	9	0	0
9	27694690	.	C	A	0	0	0	0	1	1	0	0
9	27716762	.	A	G	2	2	4	0	0	4	0	0
9	27716974	.	A	G	6	7	13	0	1	14	0	0
9	27717219	.	A	G	2	5	7	0	0	7	0	0
9	27720032	.	G	A	0	1	1	0	0	1	0	0
9	27733526	.	C	T	1	2	3	0	0	3	0	0
9	27741286	.	C	T	1	0	1	0	2	3	0	0
9	27757831	.	C	T	10	7	17	0	1	18	0	0
9	27757893	.	A	G	7	0	7	0	7	14	0	0
9	27860734	.	C	T	0	6	6	0	5	11	0	0
9	27861293	.	C	G	0	10	10	0	7	17	0	0
9	27884383	.	G	T	0	1	1	0	0	1	0	0
9	27887864	.	C	T	1	2	3	0	0	3	0	0
9	27894444	.	G	T	1	3	4	0	0	4	0	0
9	27894656	.	T	C	3	5	8	0	0	8	0	0
9	27901012	.	A	T	1	3	4	0	0	4	0	0
9	27901013	.	C	T	1	3	4	0	0	4	0	0
9	27909933	.	C	T	3	7	10	0	1	11	0	0
9	27912962	.	G	A	3	4	7	0	0	7	0	0
9	27912995	.	A	G	0	1	1	0	0	1	0	0
9	27920595	.	T	A	3	4	7	0	0	7	0	0
9	27920649	.	G	A	5	3	8	0	2	10	0	0
9	27975589	.	G	A	0	1	1	0	0	1	0	0
9	28115886	.	A	G	9	0	9	0	6	15	0	0
9	28115901	.	A	G	10	6	16	0	1	17	0	0
9	28116064	.	T	C	7	8	15	0	1	16	0	0
9	28124661	.	G	A	2	4	6	0	0	6	0	0
9	28124775	.	A	G	1	0	1	0	2	3	0	0
9	28127334	.	A	G	0	0	0	0	1	1	0	0
9	28127471	.	A	G	5	13	18	0	3	21	0	0
9	28127513	.	A	C	10	6	16	0	0	16	0	0
9	28127532	.	A	C	8	6	14	0	0	14	0	0
9	28127573	.	A	G	8	9	17	0	0	17	0	0
9	28127706	.	C	G	17	10	27	0	1	28	0	0
9	28150855	.	G	C	1	0	1	0	0	1	0	0
9	28151141	.	C	T	5	2	7	0	0	7	0	0
9	28160479	.	T	C	1	3	4	0	0	4	0	0
9	28160821	.	C	T	3	4	7	0	0	7	0	0
9	28204464	.	C	A	2	2	4	0	0	5	1	0
9	28204872	.	T	A	4	3	7	0	1	8	0	0
9	28205484	.	C	A	2	1	3	0	1	4	0	0
9	28205743	.	T	C	2	3	5	0	0	5	0	0
9	28205952	.	C	A	2	2	4	0	1	5	0	0
9	28206218	.	A	G	1	3	4	0	0	4	0	0
9	28207339	.	T	A	4	2	6	0	0	6	0	0
9	28207392	.	T	A	4	4	8	0	0	8	0	0
9	28207647	.	C	T	4	3	7	0	0	7	0	0
9	28207804	.	C	T	1	6	7	0	0	7	0	0
9	28233904	.	T	C	1	2	3	0	0	3	0	0
9	28238302	.	C	T	3	3	6	0	1	7	0	0
9	28238305	.	C	T	0	5	5	0	3	8	0	0
9	28245874	.	G	A	5	5	10	0	0	10	0	0
9	28254633	.	C	T	6	7	13	0	2	15	0	0
9	28254783	.	C	T	0	5	5	0	15	20	0	0
9	28254810	.	G	A	11	6	17	0	1	18	0	0
9	28254909	.	G	A	3	5	8	0	0	8	0	0
9	28263971	.	C	T	17	10	27	0	0	27	0	0
9	28264469	.	T	C	13	1	14	0	7	21	0	0
9	28267158	.	G	A	7	15	22	0	1	23	0	0
9	28268543	.	G	A	3	2	5	0	0	5	0	0
9	28270529	.	A	C	5	0	5	0	5	10	0	0
9	28271181	.	T	C	1	1	2	0	0	2	0	0
9	28341330	.	C	A	0	6	6	0	5	11	0	0
9	28341382	.	G	A	7	4	11	0	0	11	0	0
9	28341591	.	C	A	4	13	17	0	1	18	0	0
9	28341593	.	T	A	4	13	17	0	1	18	0	0
9	28342963	.	G	A	3	10	13	0	0	13	0	0
9	28343054	.	G	A	10	8	18	0	0	18	0	0
9	28343100	.	A	G	10	10	20	0	0	20	0	0
9	28343121	.	T	G	8	14	22	0	0	22	0	0
9	28343549	.	C	T	3	5	8	0	0	8	0	0
9	28343590	.	G	A	7	4	11	0	1	12	0	0
9	28344026	.	T	C	7	7	14	0	0	14	0	0
9	28344126	.	A	C	6	7	13	0	1	14	0	0
9	28344320	.	T	G	6	4	10	0	0	10	0	0
9	28345531	.	T	C	3	8	11	0	1	12	0	0
9	28363208	.	G	A	10	9	19	0	1	20	0	0
9	28398942	.	G	C	3	5	8	0	0	8	0	0
9	28688667	.	T	G	10	0	10	0	7	17	0	0
9	28688956	.	C	G	16	0	16	0	7	23	0	0
9	28688965	.	A	G	15	6	21	0	2	23	0	0
9	28689032	.	G	A	13	11	24	0	0	24	0	0
9	28689033	.	C	A	13	10	23	0	1	24	0	0
9	28691645	.	T	C	3	7	10	0	1	11	0	0
9	28693734	.	A	T	1	1	2	0	0	2	0	0
9	28693737	.	C	T	1	1	2	0	0	2	0	0
9	28693928	.	G	C	2	2	4	0	0	4	0	0
9	28696610	.	A	C	4	7	11	0	0	11	0	0
9	28696643	.	A	G	2	2	4	0	0	4	0	0
9	28696887	.	A	C	1	5	6	0	0	6	0	0
9	28696911	.	T	A	1	3	4	0	1	5	0	0
9	28816388	.	C	T	2	2	4	0	0	4	0	0
9	28816407	.	T	G	3	3	6	0	0	6	0	0
9	28818106	.	G	A	3	2	5	0	0	5	0	0
9	28818498	.	A	T	1	4	5	0	0	5	0	0
9	28839859	.	G	A	7	6	13	0	0	13	0	0
9	28839879	.	T	A	8	9	17	0	0	17	0	0
9	28867390	.	T	C	8	0	8	0	7	15	0	0
9	28867421	.	A	C	3	8	11	0	0	11	0	0
9	28867426	.	A	C	3	7	10	0	0	10	0	0
9	28867459	.	C	T	4	4	8	0	0	8	0	0
9	28867555	.	G	A	2	4	6	0	0	6	0	0
9	28871367	.	A	T	6	6	12	0	0	12	0	0
9	28872253	.	T	G	2	6	8	0	0	8	0	0
9	28872341	.	G	A	1	0	1	0	0	1	0	0
9	28875319	.	C	T	5	4	9	0	0	9	0	0
9	28879348	.	C	T	1	1	2	0	0	2	0	0
9	28890020	.	A	C	3	1	4	0	0	4	0	0
9	28922866	.	G	A	0	1	1	0	0	1	0	0
9	28940998	.	G	A	11	13	24	0	0	24	0	0
9	28941003	.	T	C	11	0	11	0	11	22	0	0
9	28941179	.	A	G	7	4	11	0	0	11	0	0
9	28941234	.	C	T	3	2	5	0	0	5	0	0
9	28941414	.	A	G	17	13	30	0	0	30	0	0
9	28941446	.	A	G	17	10	27	0	1	28	0	0
9	28941488	.	T	A	10	8	18	0	1	19	0	0
9	28941498	.	C	G	9	10	19	0	0	19	0	0
9	28941629	.	G	A	11	6	17	0	1	18	0	0
9	28941630	.	G	A	11	7	18	0	0	18	0	0
9	28941684	.	C	G	3	5	8	0	0	8	0	0
9	28941709	.	G	C	3	2	5	0	0	5	0	0
9	28941723	.	A	G	3	3	6	0	0	6	0	0
9	28941795	.	C	T	2	4	6	0	0	6	0	0
9	28941832	.	A	G	3	6	9	0	0	9	0	0
9	28941879	.	A	T	3	5	8	0	0	8	0	0
9	28941897	.	T	G	3	7	10	0	0	10	0	0
9	28942018	.	G	A	5	6	11	0	0	11	0	0
9	28942111	.	A	G	2	6	8	0	0	8	0	0
9	28942542	.	T	A	8	10	18	0	0	18	0	0
9	28942553	.	T	A	7	11	18	0	0	18	0	0
9	28946132	.	A	T	4	4	8	0	1	9	0	0
9	28952959	.	G	A	6	2	8	0	0	8	0	0
9	28955543	.	A	G	0	1	1	0	0	1	0	0
9	28964849	.	C	A	9	11	20	0	0	20	0	0
9	28967048	.	A	G	0	2	2	0	0	2	0	0
9	28972347	.	A	C	1	0	1	0	0	1	0	0
9	29035086	.	A	C	3	2	5	0	0	5	0	0
9	29035139	.	A	G	4	2	6	0	0	6	0	0
9	29035744	.	A	T	2	3	5	0	0	5	0	0
9	29035977	.	A	G	8	3	11	0	0	11	0	0
9	29036073	.	G	A	2	5	7	0	0	7	0	0
9	29036107	.	T	C	2	2	4	0	0	4	0	0
9	29036245	.	A	G	2	1	3	0	0	3	0	0
9	29040544	.	G	A	1	1	2	0	0	2	0	0
9	29122536	.	T	A	6	4	10	0	2	12	0	0
9	29122725	.	C	T	4	3	7	0	0	7	0	0
9	29195268	.	A	G	1	3	4	0	0	4	0	0
9	29225281	.	G	A	3	0	3	0	0	3	0	0
9	29230754	.	A	G	1	0	1	0	0	1	0	0
9	29339133	.	G	C	5	1	6	0	0	6	0	0
9	29339139	.	A	T	5	2	7	0	0	7	0	0
9	29448320	.	A	G	1	3	4	0	0	4	0	0
9	29448372	.	T	G	1	0	1	0	1	2	0	0
9	29448703	.	T	G	0	0	0	0	5	5	0	0
9	29448727	.	C	A	0	3	3	0	0	3	0	0
9	29455415	.	T	C	1	2	3	0	0	3	0	0
9	29458319	.	A	G	1	0	1	0	4	5	0	0
9	29470325	.	G	A	0	1	1	0	0	1	0	0
9	29470326	.	G	A	0	1	1	0	0	1	0	0
9	29473879	.	T	A	0	2	2	0	0	2	0	0
9	29477021	.	G	C	3	6	9	0	0	9	0	0
9	29481518	.	T	C	5	13	18	0	0	18	0	0
9	29481732	.	A	G	5	3	8	0	0	8	0	0
9	29481747	.	G	A	0	4	4	0	5	9	0	0
9	29481795	.	T	C	3	4	7	0	0	7	0	0
9	29484238	.	G	A	7	2	9	0	0	9	0	0
9	29484291	.	T	G	3	3	6	0	0	6	0	0
9	29487130	.	C	T	6	2	8	0	0	8	0	0
9	29489797	.	A	G	4	5	9	0	0	9	0	0
9	29492658	.	G	A	6	2	8	0	0	8	0	0
9	29496672	.	A	T	1	0	1	0	0	1	0	0
9	29497181	.	C	T	0	1	1	0	1	2	0	0
9	29497200	.	A	T	0	1	1	0	0	1	0	0
9	29520819	.	A	G	14	14	28	0	5	33	0	0
9	29523552	.	T	G	4	0	4	0	5	9	0	0
9	29542822	.	T	C	1	4	5	0	0	5	0	0
9	29542942	.	G	A	1	2	3	0	0	3	0	0
9	29602959	.	T	C	0	4	4	0	0	4	0	0
9	29607543	.	C	T	1	0	1	0	0	1	0	0
9	29615087	.	C	G	16	20	36	0	1	37	0	0
9	29615238	.	T	A	15	16	31	0	1	33	1	0
9	29615575	.	C	T	10	13	23	0	2	25	0	0
9	29647469	.	G	A	35	10	45	0	1	46	0	0
9	29647470	.	C	T	32	10	42	0	4	46	0	0
9	29649571	.	C	A	26	19	45	0	2	47	0	0
9	29654693	.	T	C	1	1	2	0	0	2	0	0
9	29654858	.	T	C	1	4	5	0	0	5	0	0
9	29684037	.	G	A	1	2	3	0	0	3	0	0
9	29731041	.	T	C	2	3	5	0	0	5	0	0
9	29992145	.	A	G	2	0	2	0	2	4	0	0
9	29992332	.	G	A	2	1	3	0	0	3	0	0
9	30022468	.	G	T	3	2	5	0	0	5	0	0
9	30028016	.	C	T	0	4	4	0	6	10	0	0
9	30028056	.	T	C	4	0	4	0	2	6	0	0
9	30048300	.	G	C	3	2	5	0	0	5	0	0
9	30054096	.	T	C	1	2	3	0	0	3	0	0
9	30106009	.	G	A	6	5	11	0	0	11	0	0
9	30108779	.	T	C	3	1	4	0	0	4	0	0
9	30110026	.	T	C	1	2	3	0	0	3	0	0
9	30110217	.	T	C	10	9	19	0	1	20	0	0
9	30112544	.	A	G	0	0	0	0	1	1	0	0
9	30114853	.	A	G	7	7	14	0	2	16	0	0
9	30121155	.	C	A	15	15	30	0	0	30	0	0
9	30121167	.	C	T	10	15	25	0	4	29	0	0
9	30126136	.	A	G	4	0	4	0	5	9	0	0
9	30128084	.	C	G	28	28	56	0	1	57	0	0
9	30128085	.	C	T	27	27	54	0	3	57	0	0
9	30144811	.	A	G	1	3	4	0	0	4	0	0
9	30144847	.	A	G	1	2	3	0	0	3	0	0
9	30218140	.	C	T	0	3	3	0	0	3	0	0
9	30218310	.	G	A	4	5	9	0	0	9	0	0
9	30218323	.	A	G	5	5	10	0	0	10	0	0
9	30220931	.	C	T	0	1	1	0	0	1	0	0
9	30220968	.	T	A	3	5	8	0	0	8	0	0
9	30220975	.	C	T	2	5	7	0	1	8	0	0
9	30226160	.	T	C	3	0	3	0	4	7	0	0
9	30226583	.	T	C	0	0	0	0	2	2	0	0
9	30231309	.	G	A	0	2	2	0	0	2	0	0
9	30231360	.	A	C	0	0	0	0	2	2	0	0
9	30233169	.	A	T	2	2	4	0	0	4	0	0
9	30233386	.	T	C	0	1	1	0	0	1	0	0
9	30236090	.	A	C	4	2	6	0	1	7	0	0
9	30236303	.	A	G	2	3	5	0	0	5	0	0
9	30236417	.	C	A	0	4	4	0	2	6	0	0
9	30243319	.	T	C	3	0	3	0	0	3	0	0
9	30243324	.	C	T	3	0	3	0	0	3	0	0
9	30246172	.	C	G	5	4	9	0	0	9	0	0
9	30247941	.	A	G	13	7	20	0	0	20	0	0
9	30247992	.	A	C	2	2	4	0	0	4	0	0
9	30248005	.	G	A	0	2	2	0	0	2	0	0
9	30249039	.	C	T	0	6	6	0	2	8	0	0
9	30255146	.	C	G	0	2	2	0	0	2	0	0
9	30259418	.	C	G	2	6	8	0	0	8	0	0
9	30316447	.	C	T	2	2	4	0	0	4	0	0
9	30326347	.	G	A	1	1	2	0	0	2	0	0
9	30326377	.	A	G	3	1	4	0	0	4	0	0
9	30330206	.	C	T	0	3	3	0	1	4	0	0
9	30330462	.	A	G	3	2	5	0	0	5	0	0
9	30340154	.	A	G	2	1	3	0	0	3	0	0
9	30342030	.	T	C	3	0	3	0	4	7	0	0
9	30342072	.	T	C	4	0	4	0	5	9	0	0
9	30344279	.	A	G	1	4	5	0	0	5	0	0
9	30346237	.	T	C	1	2	3	0	0	3	0	0
9	30346243	.	T	G	1	1	2	0	1	3	0	0
9	30375082	.	T	A	3	3	6	0	0	6	0	0
9	30375117	.	A	C	1	3	4	0	0	4	0	0
9	30375150	.	C	T	1	2	3	0	0	3	0	0
9	30375470	.	A	T	8	5	13	0	0	13	0	0
9	30377562	.	C	T	0	1	1	0	0	1	0	0
9	30377582	.	G	T	0	2	2	0	0	2	0	0
9	30381813	.	C	G	0	4	4	0	5	9	0	0
9	30381921	.	A	C	3	0	3	0	3	6	0	0
9	30426702	.	G	A	2	2	4	0	0	4	0	0
9	30482794	.	G	A	0	1	1	0	0	1	0	0
9	30484621	.	C	A	2	1	3	0	0	3	0	0
9	30486902	.	G	A	0	2	2	0	0	2	0	0
9	30487596	.	C	A	1	1	2	0	0	2	0	0
9	30487599	.	T	C	1	0	1	0	1	2	0	0
9	30490311	.	A	G	0	2	2	0	0	2	0	0
9	30490949	.	G	T	3	5	8	0	0	8	0	0
9	30491197	.	G	A	11	3	14	0	0	14	0	0
9	30491560	.	C	T	0	1	1	0	0	1	0	0
9	30494225	.	T	C	2	1	3	0	1	4	0	0
9	30494498	.	C	G	0	7	7	0	7	14	0	0
9	30494839	.	A	G	6	4	10	0	0	10	0	0
9	30494854	.	T	A	5	5	10	0	0	10	0	0
9	30494965	.	G	A	4	5	9	0	2	11	0	0
9	30495139	.	C	T	1	5	6	0	3	9	0	0
9	30496325	.	C	T	1	3	4	0	2	6	0	0
9	30496377	.	A	G	2	5	7	0	0	7	0	0
9	30496436	.	A	G	3	5	8	0	0	8	0	0
9	30496446	.	G	T	3	5	8	0	0	8	0	0
9	30496952	.	A	G	2	2	4	0	0	4	0	0
9	30545712	.	A	G	0	3	3	0	0	3	0	0
9	30562611	.	T	C	3	2	5	0	0	5	0	0
9	30562659	.	A	G	5	3	8	0	0	8	0	0
9	30562689	.	A	T	3	5	8	0	0	8	0	0
9	30562911	.	T	A	4	5	9	0	1	10	0	0
9	30562947	.	A	G	2	7	9	0	0	9	0	0
9	30563541	.	T	C	6	0	6	0	9	15	0	0
9	30563568	.	T	C	3	0	3	0	9	12	0	0
9	30578018	.	A	G	1	3	4	0	1	5	0	0
9	30581779	.	G	C	6	2	8	0	0	8	0	0
9	30581942	.	C	T	3	4	7	0	0	7	0	0
9	30630597	.	C	G	2	2	4	0	0	4	0	0
9	30636682	.	A	G	1	1	2	0	0	2	0	0
9	30639079	.	T	C	3	2	5	0	0	5	0	0
9	30639148	.	C	T	3	3	6	0	0	6	0	0
9	30639149	.	T	C	3	3	6	0	0	6	0	0
9	30639191	.	C	G	1	2	3	0	0	3	0	0
9	30764489	.	A	T	5	4	9	0	0	9	0	0
9	30780813	.	A	G	1	3	4	0	0	4	0	0
9	30783316	.	T	C	3	2	5	0	0	5	0	0
9	30783321	.	A	T	3	2	5	0	0	5	0	0
9	30783533	.	A	C	1	1	2	0	1	3	0	0
9	30783828	.	A	T	2	2	4	0	0	4	0	0
9	30800990	.	C	T	2	5	7	0	0	7	0	0
9	30806492	.	A	G	3	2	5	0	0	5	0	0
9	30806642	.	G	T	4	0	4	0	0	4	0	0
9	30807902	.	T	C	3	2	5	0	0	5	0	0
9	30807944	.	C	T	2	5	7	0	0	7	0	0
9	30990731	.	T	C	1	1	2	0	0	2	0	0
9	30990845	.	A	G	6	1	7	0	0	7	0	0
9	31042584	.	T	C	2	4	6	0	0	6	0	0
9	31062518	.	T	A	13	16	29	0	1	30	0	0
9	31062588	.	G	A	18	20	38	0	0	38	0	0
9	31062589	.	G	A	18	20	38	0	0	38	0	0
9	31214307	.	T	G	3	5	8	0	0	8	0	0
9	31214442	.	A	C	2	1	3	0	0	3	0	0
9	31239258	.	A	G	2	0	2	0	2	4	0	0
9	31248923	.	C	T	9	15	24	0	0	24	0	0
9	31258832	.	G	A	8	7	15	0	2	17	0	0
9	31268856	.	G	T	7	8	15	0	0	15	0	0
9	31274993	.	T	C	13	1	14	0	7	21	0	0
9	31276912	.	C	T	13	10	23	0	4	27	0	0
9	31286938	.	T	A	2	2	4	0	0	4	0	0
9	31510724	.	T	A	0	2	2	0	0	2	0	0
9	31518804	.	C	T	3	3	6	0	0	6	0	0
9	31524405	.	G	A	1	3	4	0	0	4	0	0
9	31524406	.	T	C	1	3	4	0	0	4	0	0
9	31524633	.	G	T	1	0	1	0	0	1	0	0
9	31586434	.	G	A	2	3	5	0	0	5	0	0
9	31595634	.	C	T	6	14	20	0	1	21	0	0
9	31604943	.	G	A	6	2	8	0	0	8	0	0
9	31605235	.	A	G	0	1	1	0	0	1	0	0
9	31605260	.	T	C	0	0	0	0	1	1	0	0
9	31605281	.	C	A	0	1	1	0	0	1	0	0
9	31606333	.	C	T	5	8	13	0	1	14	0	0
9	31612184	.	C	T	1	1	2	0	0	2	0	0
9	31617687	.	A	G	1	1	2	0	0	2	0	0
9	31619998	.	A	G	7	9	16	0	1	17	0	0
9	31639107	.	C	T	0	6	6	0	8	14	0	0
9	31716932	.	G	A	0	1	1	0	0	1	0	0
9	31735673	.	A	G	3	3	6	0	0	6	0	0
9	31735676	.	A	C	3	3	6	0	0	6	0	0
9	31736102	.	G	A	0	1	1	0	0	1	0	0
9	31787077	.	G	A	3	2	5	0	0	5	0	0
9	31795397	.	G	A	2	1	3	0	0	3	0	0
9	32169182	.	A	G	9	14	23	0	0	23	0	0
9	32169287	.	G	A	27	23	50	0	1	51	0	0
9	32181865	.	A	G	3	2	5	0	0	5	0	0
9	32187866	.	A	T	4	4	8	0	0	8	0	0
9	32286804	.	C	G	5	6	11	0	0	11	0	0
9	32286858	.	C	T	5	10	15	0	1	16	0	0
9	32287162	.	A	G	12	12	24	0	3	27	0	0
9	32287208	.	A	C	20	15	35	0	0	35	0	0
9	32287418	.	A	G	8	9	17	0	0	17	0	0
9	32287419	.	A	G	8	9	17	0	0	17	0	0
9	32287481	.	T	C	10	15	25	0	0	25	0	0
9	32287688	.	A	G	4	6	10	0	2	12	0	0
9	32289064	.	C	A	0	15	15	0	14	29	0	0
9	32289281	.	G	A	15	11	26	0	0	26	0	0
9	32290957	.	G	A	5	0	5	0	0	5	0	0
9	32297376	.	G	A	7	3	10	0	1	11	0	0
9	32297472	.	T	C	12	6	18	0	0	18	0	0
9	32297487	.	C	T	13	6	19	0	0	19	0	0
9	32304476	.	G	A	9	8	17	0	1	18	0	0
9	32304643	.	C	T	3	1	4	0	0	4	0	0
9	32304655	.	A	G	2	2	4	0	0	4	0	0
9	32304799	.	C	T	1	2	3	0	0	3	0	0
9	32304951	.	T	G	5	5	10	0	0	10	0	0
9	32308523	.	A	C	4	5	9	0	1	10	0	0
9	32312472	.	C	T	30	20	50	0	0	50	0	0
9	32312600	.	A	G	22	1	23	0	19	42	0	0
9	32312683	.	C	A	12	15	27	0	3	30	0	0
9	32313260	.	T	C	7	4	11	0	0	11	0	0
9	32313318	.	T	C	7	4	11	0	1	12	0	0
9	32313626	.	C	T	8	4	12	0	0	12	0	0
9	32313689	.	A	G	11	4	15	0	0	15	0	0
9	32313875	.	G	T	9	5	14	0	0	14	0	0
9	32313964	.	G	A	10	9	19	0	2	21	0	0
9	32320286	.	T	C	1	4	5	0	0	5	0	0
9	32324043	.	T	C	1	2	3	0	0	3	0	0
9	32328645	.	T	C	0	1	1	0	0	1	0	0
9	32343479	.	C	A	4	2	6	0	0	6	0	0
9	32433925	.	C	T	3	3	6	0	0	6	0	0
9	32433957	.	A	T	2	4	6	0	0	6	0	0
9	32435052	.	G	A	5	4	9	0	0	9	0	0
9	32435121	.	T	A	7	8	15	0	0	15	0	0
9	32435127	.	T	A	6	8	14	0	0	14	0	0
9	32441761	.	A	G	14	1	15	0	8	23	0	0
9	32441800	.	T	C	6	3	9	0	2	11	0	0
9	32457192	.	C	T	14	13	27	0	0	27	0	0
9	32641131	.	T	A	4	5	9	0	1	10	0	0
9	32641175	.	T	G	10	5	15	0	1	16	0	0
9	32641278	.	A	T	11	10	21	0	1	22	0	0
9	32641294	.	G	T	13	12	25	0	1	26	0	0
9	32641424	.	G	A	6	4	10	0	0	10	0	0
9	32641442	.	G	C	8	5	13	0	0	13	0	0
9	32641548	.	T	A	5	3	8	0	1	9	0	0
9	32641682	.	A	G	11	9	20	0	1	21	0	0
9	32641731	.	C	A	10	5	15	0	0	15	0	0
9	32641737	.	A	G	8	8	16	0	0	16	0	0
9	32641802	.	T	C	2	9	11	0	2	13	0	0
9	32641805	.	A	G	2	8	10	0	2	12	0	0
9	32642342	.	A	G	3	8	11	0	1	12	0	0
9	32643643	.	G	A	0	2	2	0	0	2	0	0
9	32645615	.	G	C	9	14	23	0	0	23	0	0
9	32645939	.	T	C	5	4	9	0	0	9	0	0
9	32651241	.	A	T	7	2	9	0	0	9	0	0
9	32651826	.	T	C	7	1	8	0	0	8	0	0
9	32652059	.	A	G	1	0	1	0	3	4	0	0
9	32652072	.	T	C	1	4	5	0	0	5	0	0
9	32652129	.	C	T	1	2	3	0	0	3	0	0
9	32681720	.	A	T	1	2	3	0	0	3	0	0
9	32681804	.	A	T	1	3	4	0	0	4	0	0
9	32681877	.	A	C	9	5	14	0	0	14	0	0
9	32681880	.	A	C	9	5	14	0	0	14	0	0
9	32728896	.	G	C	7	9	16	0	0	16	0	0
9	32728969	.	A	G	6	10	16	0	1	17	0	0
9	32728984	.	C	A	8	6	14	0	1	15	0	0
9	32729022	.	T	C	7	6	13	0	2	15	0	0
9	32729072	.	G	A	6	7	13	0	0	13	0	0
9	32729183	.	T	G	4	5	9	0	0	9	0	0
9	32729908	.	C	A	3	3	6	0	0	6	0	0
9	32751579	.	A	G	2	6	8	0	1	9	0	0
9	32751640	.	A	G	10	16	26	0	1	27	0	0
9	32751812	.	A	G	14	13	27	0	1	28	0	0
9	32751825	.	C	T	11	11	22	0	2	24	0	0
9	32752272	.	C	T	15	18	33	0	2	35	0	0
9	32752555	.	C	T	20	24	44	0	0	44	0	0
9	32752794	.	A	C	21	0	21	0	16	37	0	0
9	32752824	.	G	T	22	15	37	0	0	37	0	0
9	32752864	.	G	T	19	17	36	0	0	36	0	0
9	32752995	.	T	C	3	3	6	0	0	6	0	0
9	32753016	.	C	G	0	1	1	0	0	1	0	0
9	32804802	.	C	T	1	1	2	0	0	2	0	0
9	32804898	.	C	A	0	3	3	0	6	9	0	0
9	32860395	.	A	C	1	1	2	0	0	2	0	0
9	32860396	.	A	C	1	1	2	0	0	2	0	0
9	32871408	.	C	T	1	2	3	0	0	3	0	0
9	32871441	.	A	G	1	2	3	0	0	3	0	0
9	32871509	.	A	G	4	4	8	0	1	9	0	0
9	32871514	.	T	C	5	4	9	0	1	10	0	0
9	32871562	.	G	A	6	4	10	0	0	10	0	0
9	32872881	.	G	A	5	3	8	0	0	8	0	0
9	32872932	.	T	C	1	4	5	0	0	5	0	0
9	32873040	.	C	T	5	2	7	0	0	7	0	0
9	32873064	.	T	C	3	2	5	0	2	7	0	0
9	32873127	.	G	T	7	4	11	0	0	11	0	0
9	32873151	.	G	A	0	3	3	0	6	9	0	0
9	32873544	.	G	T	0	7	7	0	14	21	0	0
9	32873788	.	C	A	7	3	10	0	1	11	0	0
9	32873792	.	C	A	7	3	10	0	1	11	0	0
9	32873834	.	A	T	8	4	12	0	0	12	0	0
9	32873940	.	G	A	10	7	17	0	1	18	0	0
9	32874222	.	T	G	9	7	16	0	1	17	0	0
9	32874603	.	G	A	1	13	14	0	11	25	0	0
9	32895294	.	A	T	1	0	1	0	0	1	0	0
9	32897304	.	C	T	3	2	5	0	0	5	0	0
9	32900000	.	T	C	4	0	4	0	5	9	0	0
9	32900267	.	C	T	0	7	7	0	4	11	0	0
9	32900453	.	A	G	8	3	11	0	1	12	0	0
9	32900628	.	G	A	9	4	13	0	1	14	0	0
9	32900768	.	A	G	8	6	14	0	1	15	0	0
9	32900849	.	G	A	3	5	8	0	0	8	0	0
9	32901173	.	A	G	9	5	14	0	0	14	0	0
9	32901176	.	T	A	9	5	14	0	0	14	0	0
9	32912464	.	A	G	1	4	5	0	0	5	0	0
9	32980971	.	G	A	3	2	5	0	2	7	0	0
9	32981252	.	C	T	3	7	10	0	0	10	0	0
9	32981302	.	C	T	3	7	10	0	0	10	0	0
9	32981317	.	T	C	4	7	11	0	0	11	0	0
9	33323107	.	G	T	3	2	5	0	1	6	0	0
9	33411227	.	C	A	5	0	5	0	0	5	0	0
9	33411228	.	A	G	5	0	5	0	0	5	0	0
9	33661399	.	A	G	10	11	21	0	0	21	0	0
9	33661424	.	G	A	9	13	22	0	0	22	0	0
9	33661645	.	A	T	7	10	17	0	1	18	0	0
9	33661691	.	A	T	5	9	14	0	0	14	0	0
9	33661714	.	G	A	4	7	11	0	1	12	0	0
9	33661765	.	C	T	4	7	11	0	0	11	0	0
9	33661773	.	A	C	4	6	10	0	0	10	0	0
9	33661939	.	T	A	8	6	14	0	0	14	0	0
9	33662043	.	A	G	6	5	11	0	1	12	0	0
9	33662134	.	C	T	11	7	18	0	0	18	0	0
9	33662158	.	A	G	10	11	21	0	0	21	0	0
9	33662175	.	T	G	11	12	23	0	1	24	0	0
9	33662223	.	A	T	9	5	14	0	0	14	0	0
9	33662250	.	A	T	5	2	7	0	0	7	0	0
9	33662273	.	A	C	2	3	5	0	0	5	0	0
9	33663300	.	G	A	8	10	18	0	0	18	0	0
9	33663331	.	A	G	9	11	20	0	0	20	0	0
9	33663455	.	A	G	10	6	16	0	0	16	0	0
9	33663816	.	T	C	6	0	6	0	4	10	0	0
9	33678095	.	G	A	3	6	9	0	1	10	0	0
9	33678124	.	A	G	4	10	14	0	1	15	0	0
9	33678164	.	T	G	1	5	6	0	0	6	0	0
9	33741738	.	C	T	1	3	4	0	0	4	0	0
9	33771331	.	T	C	0	0	0	0	1	1	0	0
9	33783731	.	T	A	4	5	9	0	1	10	0	0
9	33783761	.	T	A	6	4	10	0	0	10	0	0
9	33783800	.	A	T	8	7	15	0	1	16	0	0
9	33783822	.	T	A	18	11	29	0	0	29	0	0
9	33783852	.	A	G	30	8	38	0	0	38	0	0
9	33783884	.	C	G	30	13	43	0	1	44	0	0
9	33783956	.	T	C	32	19	51	0	1	52	0	0
9	33784689	.	T	G	7	7	14	0	0	14	0	0
9	33797118	.	A	G	0	1	1	0	0	1	0	0
9	33816267	.	C	T	3	2	5	0	0	5	0	0
9	33816289	.	C	T	3	2	5	0	0	5	0	0
9	33853510	.	A	G	5	0	5	0	10	15	0	0
9	33858088	.	G	A	5	5	10	0	2	12	0	0
9	33858111	.	T	C	4	6	10	0	1	11	0	0
9	33861813	.	A	T	5	3	8	0	0	8	0	0
9	34090223	.	G	C	2	3	5	0	0	5	0	0
9	34090292	.	T	C	5	3	8	0	0	8	0	0
9	34090295	.	C	T	5	4	9	0	0	9	0	0
9	34090523	.	C	G	1	0	1	0	2	3	0	0
9	34090618	.	A	G	1	3	4	0	0	4	0	0
9	34090715	.	T	A	4	3	7	0	1	8	0	0
9	34112981	.	T	C	1	7	8	0	0	8	0	0
9	34113140	.	G	A	4	4	8	0	0	8	0	0
9	34116933	.	A	G	2	0	2	0	0	2	0	0
9	34117293	.	A	C	7	9	16	0	0	16	0	0
9	34117578	.	C	G	8	4	12	0	1	13	0	0
9	34120207	.	T	A	2	2	4	0	0	4	0	0
9	34154365	.	T	G	1	0	1	0	3	4	0	0
9	34154428	.	A	C	1	6	7	0	0	7	0	0
9	34155005	.	T	G	1	1	2	0	0	2	0	0
9	34161749	.	G	A	4	3	7	0	0	7	0	0
9	34174561	.	C	T	4	4	8	0	0	8	0	0
9	34174682	.	G	A	2	7	9	0	0	9	0	0
9	34191597	.	G	A	3	1	4	0	1	5	0	0
9	34200253	.	T	A	4	6	10	0	1	11	0	0
9	34205537	.	A	G	2	2	4	0	0	4	0	0
9	34219058	.	G	T	1	2	3	0	0	3	0	0
9	34219241	.	A	G	2	4	6	0	0	6	0	0
9	34222113	.	C	T	24	19	43	0	0	43	0	0
9	34225055	.	A	G	4	10	14	0	0	14	0	0
9	34225316	.	G	C	5	5	10	0	0	10	0	0
9	34226884	.	G	A	23	22	45	0	2	47	0	0
9	34226888	.	G	A	2	22	24	0	23	47	0	0
9	34226960	.	A	C	21	23	44	0	0	44	0	0
9	34227016	.	A	T	11	19	30	0	1	31	0	0
9	34227020	.	C	G	10	18	28	0	2	30	0	0
9	34227054	.	C	T	11	13	24	0	1	25	0	0
9	34227074	.	C	A	12	8	20	0	0	20	0	0
9	34236709	.	G	A	1	1	2	0	0	2	0	0
9	34238915	.	T	C	2	5	7	0	0	7	0	0
9	34239119	.	T	C	2	4	6	0	0	6	0	0
9	34243122	.	G	C	6	6	12	0	0	12	0	0
9	34246473	.	G	A	6	5	11	0	1	12	0	0
9	34246524	.	G	A	11	4	15	0	0	15	0	0
9	34246628	.	G	A	5	5	10	0	0	10	0	0
9	34246710	.	G	A	7	8	15	0	0	15	0	0
9	34246932	.	A	G	14	13	27	0	1	28	0	0
9	34247086	.	G	T	19	5	24	0	1	25	0	0
9	34247087	.	C	T	18	5	23	0	2	25	0	0
9	34247356	.	G	A	2	3	5	0	1	6	0	0
9	34251632	.	G	A	5	5	10	0	1	11	0	0
9	34251707	.	C	G	10	14	24	0	1	25	0	0
9	34251752	.	G	A	4	6	10	0	0	10	0	0
9	34251764	.	G	A	3	3	6	0	0	6	0	0
9	34251963	.	A	G	13	8	21	0	1	22	0	0
9	34254678	.	A	G	2	1	3	0	0	3	0	0
9	34254685	.	G	A	2	0	2	0	0	2	0	0
9	34254851	.	A	G	5	5	10	0	0	10	0	0
9	34254896	.	G	A	4	5	9	0	0	9	0	0
9	34256016	.	A	C	3	0	3	0	0	3	0	0
9	34258384	.	A	G	6	8	14	0	1	15	0	0
9	34258565	.	T	G	2	0	2	0	0	2	0	0
9	34258580	.	C	T	0	1	1	0	2	3	0	0
9	34259406	.	T	A	6	8	14	0	0	14	0	0
9	34259418	.	T	A	8	8	16	0	0	16	0	0
9	34260164	.	C	T	8	5	13	0	0	13	0	0
9	34334173	.	T	G	1	0	1	0	2	3	0	0
9	34338283	.	C	T	4	2	6	0	0	6	0	0
9	34352271	.	G	A	6	3	9	0	2	11	0	0
9	34380503	.	T	A	13	16	29	0	0	29	0	0
9	34380525	.	T	A	10	8	18	0	2	20	0	0
9	34382946	.	A	T	15	22	37	0	1	38	0	0
9	34385396	.	A	G	14	0	14	0	15	29	0	0
9	34388882	.	G	A	8	20	28	0	1	29	0	0
9	34389077	.	T	C	7	9	16	0	0	16	0	0
9	34389101	.	C	G	6	7	13	0	3	16	0	0
9	34389288	.	T	G	12	14	26	0	0	26	0	0
9	34389299	.	T	G	14	0	14	0	14	28	0	0
9	34389427	.	C	T	10	21	31	0	1	32	0	0
9	34389602	.	A	G	15	0	15	0	13	28	0	0
9	34389666	.	A	G	12	18	30	0	1	31	0	0
9	34389701	.	A	T	13	18	31	0	2	33	0	0
9	34389704	.	G	C	13	18	31	0	2	33	0	0
9	34389743	.	G	T	12	18	30	0	0	30	0	0
9	34389748	.	A	C	12	18	30	0	1	31	0	0
9	34389791	.	A	G	5	11	16	0	0	16	0	0
9	34397996	.	G	A	0	3	3	0	2	5	0	0
9	34404827	.	C	T	1	5	6	0	0	6	0	0
9	34404830	.	T	G	1	5	6	0	0	6	0	0
9	34405078	.	A	T	3	2	5	0	0	5	0	0
9	34408154	.	C	T	1	1	2	0	0	2	0	0
9	34410156	.	G	A	3	3	6	0	1	7	0	0
9	34410237	.	T	C	2	0	2	0	0	2	0	0
9	34415308	.	T	C	8	4	12	0	0	12	0	0
9	34416575	.	A	T	1	3	4	0	0	4	0	0
9	34423397	.	C	A	10	4	14	0	3	17	0	0
9	34423415	.	T	A	8	8	16	0	0	16	0	0
9	34423468	.	T	A	7	8	15	0	0	15	0	0
9	34423474	.	A	G	8	0	8	0	9	17	0	0
9	34425920	.	C	T	6	6	12	0	0	12	0	0
9	34647415	.	A	G	12	0	12	0	13	25	0	0
9	34647427	.	A	C	13	10	23	0	3	26	0	0
9	34866579	.	T	G	11	7	18	0	2	20	0	0
9	34866684	.	T	A	5	7	12	0	1	13	0	0
9	34866888	.	C	T	18	11	29	0	1	30	0	0
9	34867007	.	C	A	0	16	16	0	16	32	0	0
9	34867015	.	T	C	11	0	11	0	15	26	0	0
9	34869699	.	A	G	16	12	28	0	1	29	0	0
9	34869813	.	G	A	11	22	33	0	1	34	0	0
9	34869945	.	G	A	5	2	7	0	0	7	0	0
9	34871796	.	G	C	1	1	2	0	0	2	0	0
9	34877024	.	G	A	0	1	1	0	0	1	0	0
9	34877042	.	G	A	0	3	3	0	0	3	0	0
9	34877074	.	C	T	0	5	5	0	0	5	0	0
9	34878209	.	C	T	1	0	1	0	0	1	0	0
9	34880471	.	T	C	1	3	4	0	0	4	0	0
9	34903218	.	T	G	26	20	46	0	0	46	0	0
9	34906337	.	C	G	24	30	54	0	3	57	0	0
9	34912626	.	A	T	3	5	8	0	0	8	0	0
9	34912695	.	T	C	0	1	1	0	4	5	0	0
9	34912895	.	T	A	7	12	19	0	0	19	0	0
9	34920395	.	G	A	6	7	13	0	0	13	0	0
9	34922670	.	C	T	0	0	0	0	3	3	0	0
9	34922898	.	A	G	3	4	7	0	1	8	0	0
9	34937145	.	C	G	4	2	6	0	0	6	0	0
9	34937154	.	A	T	4	3	7	0	0	7	0	0
9	34938795	.	C	T	7	5	12	0	0	12	0	0
9	34939336	.	A	G	3	5	8	0	1	9	0	0
9	34939800	.	T	C	8	7	15	0	1	16	0	0
9	34967565	.	A	G	5	3	8	0	1	9	0	0
9	34967647	.	C	T	7	2	9	0	0	9	0	0
9	34967649	.	C	T	7	2	9	0	0	9	0	0
9	34967733	.	A	G	2	3	5	0	0	6	1	0
9	34967743	.	A	C	3	2	5	0	1	6	0	0
9	34968005	.	A	G	3	5	8	0	0	8	0	0
9	35022050	.	A	G	6	3	9	0	1	10	0	0
9	35024459	.	G	C	1	3	4	0	4	8	0	0
9	35025183	.	C	T	3	3	6	0	0	6	0	0
9	35025243	.	A	T	5	6	11	0	1	13	1	0
9	35025430	.	C	T	4	4	8	0	1	9	0	0
9	35026418	.	G	T	2	2	4	0	0	4	0	0
9	35026736	.	T	A	29	23	52	0	0	52	0	0
9	35026941	.	T	C	26	32	58	0	3	61	0	0
9	35027262	.	A	G	36	22	58	0	1	59	0	0
9	35027309	.	T	C	21	1	22	0	36	58	0	0
9	35027333	.	A	G	22	31	53	0	1	54	0	0
9	35027365	.	G	T	32	26	58	0	0	58	0	0
9	35027371	.	G	T	34	25	59	0	0	61	2	0
9	35027402	.	G	A	36	20	56	0	3	59	0	0
9	35027549	.	T	G	25	29	54	0	0	54	0	0
9	35027705	.	G	A	20	2	22	0	0	23	1	0
9	35028086	.	T	C	38	4	42	0	32	74	0	0
9	35028282	.	T	C	36	5	41	0	38	79	0	0
9	35030977	.	G	A	29	28	57	0	2	59	0	0
9	35032640	.	A	G	3	5	8	0	1	9	0	0
9	35032643	.	A	G	3	7	10	0	1	11	0	0
9	35033347	.	C	T	24	20	44	0	2	46	0	0
9	35039175	.	T	C	22	22	44	0	2	46	0	0
9	35048839	.	G	C	23	28	51	0	2	53	0	0
9	35048840	.	A	C	24	28	52	0	1	53	0	0
9	35170671	.	G	A	11	10	21	0	0	21	0	0
9	35176030	.	A	G	15	16	31	0	0	31	0	0
9	35228165	.	G	A	2	3	5	0	0	5	0	0
9	35230740	.	G	A	0	1	1	0	0	1	0	0
9	35254679	.	G	A	2	2	4	0	0	4	0	0
9	35296835	.	C	T	0	2	2	0	0	2	0	0
9	35836674	.	T	G	5	5	10	0	0	10	0	0
9	35836721	.	T	A	5	6	11	0	0	11	0	0
9	35837194	.	C	G	8	0	8	0	6	14	0	0
9	35837404	.	C	A	6	2	8	0	0	8	0	0
9	35838477	.	T	A	17	14	31	0	0	31	0	0
9	35840713	.	G	A	3	12	15	0	0	15	0	0
9	35840782	.	T	C	4	7	11	0	0	11	0	0
9	35841279	.	G	T	1	3	4	0	0	4	0	0
9	35841282	.	A	G	2	3	5	0	0	5	0	0
9	35841663	.	G	T	7	5	12	0	0	12	0	0
9	35841879	.	T	A	9	7	16	0	1	17	0	0
9	35841994	.	A	G	4	2	6	0	0	6	0	0
9	35842164	.	T	A	15	13	28	0	0	28	0	0
9	35842209	.	G	T	10	7	17	0	0	17	0	0
9	35843866	.	C	T	1	3	4	0	0	4	0	0
9	35860982	.	G	A	5	10	15	0	0	15	0	0
9	35860983	.	A	T	5	10	15	0	0	15	0	0
9	35862299	.	G	A	15	14	29	0	0	29	0	0
9	35863132	.	C	T	12	10	22	0	0	22	0	0
9	35863555	.	T	C	12	13	25	0	1	26	0	0
9	35863603	.	T	C	13	17	30	0	0	30	0	0
9	35863798	.	C	T	15	10	25	0	4	29	0	0
9	35863968	.	A	T	9	8	17	0	0	17	0	0
9	35864155	.	A	T	10	6	16	0	0	16	0	0
9	35864210	.	C	T	6	11	17	0	0	17	0	0
9	35864266	.	C	A	10	7	17	0	0	17	0	0
9	35864277	.	C	T	9	6	15	0	0	15	0	0
9	35864356	.	A	G	2	2	4	0	0	4	0	0
9	35864486	.	C	T	2	1	3	0	0	3	0	0
9	35864565	.	A	G	8	1	9	0	0	9	0	0
9	35864598	.	C	T	6	3	9	0	2	11	0	0
9	35865073	.	C	T	21	13	34	0	0	34	0	0
9	35865162	.	G	T	18	12	30	0	0	30	0	0
9	35865270	.	C	G	8	15	23	0	1	24	0	0
9	35872993	.	A	T	3	6	9	0	0	9	0	0
9	35873884	.	A	G	4	2	6	0	1	7	0	0
9	35901598	.	G	C	2	2	4	0	0	4	0	0
9	35901654	.	T	A	3	3	6	0	0	6	0	0
9	35907553	.	C	T	1	2	3	0	1	4	0	0
9	35909794	.	T	C	4	8	12	0	0	12	0	0
9	35909842	.	A	G	2	7	9	0	0	9	0	0
9	35910390	.	C	G	2	0	2	0	0	2	0	0
9	35910672	.	T	C	3	3	6	0	0	6	0	0
9	35912447	.	A	T	5	13	18	0	2	20	0	0
9	35912459	.	G	A	6	12	18	0	2	20	0	0
9	35912661	.	G	C	1	4	5	0	0	5	0	0
9	35915327	.	C	A	4	7	11	0	0	11	0	0
9	35915548	.	C	T	4	16	20	0	0	20	0	0
9	35915557	.	G	A	0	14	14	0	3	17	0	0
9	35916518	.	T	G	3	2	5	0	0	5	0	0
9	35916786	.	G	A	7	6	13	0	1	14	0	0
9	35922046	.	T	G	20	22	42	0	0	42	0	0
9	35922115	.	T	C	12	13	25	0	2	27	0	0
9	36393805	.	C	T	3	3	6	0	0	6	0	0
9	36423962	.	G	A	1	0	1	0	0	1	0	0
9	36468396	.	G	A	1	2	3	0	1	4	0	0
9	36500748	.	A	G	0	0	0	0	2	2	0	0
9	36527309	.	G	A	2	0	2	0	0	2	0	0
9	36610121	.	A	G	0	0	0	0	1	1	0	0
9	36613178	.	C	T	2	1	3	0	0	3	0	0
9	36659702	.	T	G	2	3	5	0	2	7	0	0
9	36896761	.	C	A	0	2	2	0	4	6	0	0
9	36896791	.	C	T	2	4	6	0	2	8	0	0
9	36898724	.	C	T	14	10	24	0	0	24	0	0
9	36899065	.	C	T	0	15	15	0	8	23	0	0
9	36972858	.	A	G	1	0	1	0	2	3	0	0
9	36972936	.	T	C	2	2	4	0	0	4	0	0
9	36973147	.	T	C	1	2	3	0	0	3	0	0
9	36973841	.	C	G	2	4	6	0	0	6	0	0
9	36974170	.	G	T	1	1	2	0	1	3	0	0
9	36974191	.	T	C	1	3	4	0	0	4	0	0
9	36974233	.	A	T	1	6	7	0	0	7	0	0
9	37271103	.	A	C	1	2	3	0	0	3	0	0
9	37296192	.	G	A	3	2	5	0	0	5	0	0
9	37296454	.	T	A	1	2	3	0	0	3	0	0
9	37341551	.	T	C	1	2	3	0	0	3	0	0
9	37341554	.	T	C	1	2	3	0	0	3	0	0
9	37345228	.	T	C	2	1	3	0	0	3	0	0
9	37371515	.	A	T	0	0	0	0	1	1	0	0
9	37387230	.	T	C	4	2	6	0	0	6	0	0
9	37387233	.	T	C	4	2	6	0	1	7	0	0
9	37390314	.	C	T	3	2	5	0	0	5	0	0
9	37451609	.	T	G	5	3	8	0	0	8	0	0
9	37451809	.	A	G	18	5	23	0	1	24	0	0
9	37452012	.	A	T	10	10	20	0	2	22	0	0
9	37452223	.	C	T	4	10	14	0	1	15	0	0
9	37452432	.	G	A	11	6	17	0	1	18	0	0
9	37452499	.	T	G	14	4	18	0	0	18	0	0
9	37452515	.	G	T	15	4	19	0	0	19	0	0
9	37452616	.	T	G	16	10	26	0	4	30	0	0
9	37452819	.	G	C	9	4	13	0	0	13	0	0
9	37452862	.	T	C	16	6	22	0	0	22	0	0
9	37452924	.	C	G	12	7	19	0	0	19	0	0
9	37492798	.	G	A	1	4	5	0	0	5	0	0
9	37492807	.	A	G	1	2	3	0	1	4	0	0
9	37517008	.	C	G	0	1	1	0	0	1	0	0
9	37563478	.	T	C	1	3	4	0	0	4	0	0
9	37771849	.	A	G	1	0	1	0	0	1	0	0
9	37815548	.	A	G	1	0	1	0	2	3	0	0
9	37840024	.	G	T	4	2	6	0	1	7	0	0
9	37850479	.	G	C	5	2	7	0	0	7	0	0
9	37850559	.	T	A	1	1	2	0	0	2	0	0
9	37850574	.	A	G	1	1	2	0	0	2	0	0
9	37853970	.	A	C	8	2	10	0	1	11	0	0
9	37856541	.	C	T	12	9	21	0	0	21	0	0
9	37856895	.	T	A	4	1	5	0	1	6	0	0
9	37859807	.	G	T	4	4	8	0	0	8	0	0
9	37859881	.	T	G	11	14	25	0	2	27	0	0
9	37860116	.	T	C	4	2	6	0	0	6	0	0
9	37860645	.	A	T	5	2	7	0	0	7	0	0
9	37860712	.	C	T	4	3	7	0	0	7	0	0
9	37861834	.	G	A	3	3	6	0	0	6	0	0
9	37861844	.	G	A	4	3	7	0	0	7	0	0
9	37862065	.	T	G	3	0	3	0	6	9	0	0
9	37879113	.	A	G	1	1	2	0	0	2	0	0
9	38021291	.	A	T	1	3	4	0	0	4	0	0
9	38030131	.	A	T	16	10	26	0	0	26	0	0
9	38030366	.	A	T	8	11	19	0	0	19	0	0
9	38030485	.	A	T	10	8	18	0	0	18	0	0
9	38030503	.	C	T	0	8	8	0	13	21	0	0
9	38030574	.	G	A	10	10	20	0	1	21	0	0
9	38033363	.	T	C	15	1	16	0	11	27	0	0
9	38033578	.	A	G	5	2	7	0	0	7	0	0
9	38042752	.	G	A	4	6	10	0	1	11	0	0
9	38043476	.	T	C	1	2	3	0	0	3	0	0
9	38057075	.	A	G	0	1	1	0	1	2	0	0
9	38058608	.	T	C	1	0	1	0	0	1	0	0
9	38059042	.	C	T	0	1	1	0	0	1	0	0
9	38061311	.	G	A	0	1	1	0	0	1	0	0
9	38061525	.	G	T	0	5	5	0	4	9	0	0
9	38061699	.	T	C	5	2	7	0	0	7	0	0
9	38061788	.	T	C	7	2	9	0	0	9	0	0
9	38063688	.	C	A	10	4	14	0	0	14	0	0
9	38063689	.	C	A	10	4	14	0	0	14	0	0
9	38064165	.	A	T	2	7	9	0	0	9	0	0
9	38064268	.	T	C	9	6	15	0	1	16	0	0
9	38064420	.	T	G	2	7	9	0	0	9	0	0
9	38064421	.	C	A	2	7	9	0	0	9	0	0
9	38064672	.	A	C	4	4	8	0	1	9	0	0
9	38074140	.	A	T	3	2	5	0	2	7	0	0
9	38129312	.	C	G	2	6	8	0	0	8	0	0
9	38129632	.	A	G	1	0	1	0	3	4	0	0
9	38129902	.	C	T	1	2	3	0	0	3	0	0
9	38161842	.	C	T	4	3	7	0	1	8	0	0
9	38167747	.	T	G	3	5	8	0	0	8	0	0
9	38167761	.	G	A	3	4	7	0	0	7	0	0
9	38167782	.	G	A	1	2	3	0	0	3	0	0
9	38167875	.	T	C	1	4	5	0	0	5	0	0
9	38168005	.	A	G	2	0	2	0	2	4	0	0
9	38168065	.	G	A	0	4	4	0	3	7	0	0
9	38207504	.	C	T	2	2	4	0	0	4	0	0
9	38207964	.	G	A	2	2	4	0	0	4	0	0
9	38238917	.	G	A	0	2	2	0	2	4	0	0
9	38251409	.	T	C	7	4	11	0	1	12	0	0
9	38266131	.	T	C	3	4	7	0	0	7	0	0
9	38269630	.	A	G	1	2	3	0	0	3	0	0
9	38273171	.	G	A	10	4	14	0	1	15	0	0
9	38273264	.	T	A	5	0	5	0	0	5	0	0
9	38277513	.	A	G	4	5	9	0	0	9	0	0
9	38278121	.	A	G	2	1	3	0	0	3	0	0
9	38278289	.	C	T	7	13	20	0	0	20	0	0
9	38278301	.	T	C	7	11	18	0	1	19	0	0
9	38278337	.	T	C	1	3	4	0	1	5	0	0
9	38283647	.	G	A	10	7	17	0	0	17	0	0
9	38283659	.	C	T	9	7	16	0	1	17	0	0
9	38284317	.	A	G	8	0	8	0	11	19	0	0
9	38285598	.	A	G	4	8	12	0	0	12	0	0
9	38286823	.	G	A	14	6	20	0	0	20	0	0
9	38290165	.	C	T	7	16	23	0	0	23	0	0
9	38290210	.	A	G	10	7	17	0	0	17	0	0
9	38290220	.	T	G	12	0	12	0	5	17	0	0
9	38290245	.	C	T	16	8	24	0	0	24	0	0
9	38290414	.	A	G	12	6	18	0	0	18	0	0
9	38290517	.	A	C	14	5	19	0	1	20	0	0
9	38290530	.	A	T	11	6	17	0	1	18	0	0
9	38290561	.	C	T	8	4	12	0	0	12	0	0
9	38290777	.	G	T	0	10	10	0	17	28	1	0
9	38290959	.	A	C	25	19	44	0	3	47	0	0
9	38291439	.	G	T	17	10	27	0	1	28	0	0
9	38291616	.	C	T	10	5	15	0	1	16	0	0
9	38291737	.	C	A	4	8	12	0	2	14	0	0
9	38315128	.	T	G	3	8	11	0	0	11	0	0
9	38316758	.	G	A	1	2	3	0	0	3	0	0
9	38316769	.	T	C	1	1	2	0	0	2	0	0
9	38348458	.	G	A	3	3	6	0	0	6	0	0
9	38351016	.	T	C	4	7	11	0	0	11	0	0
9	38353794	.	T	C	10	3	13	0	1	14	0	0
9	38354000	.	T	C	9	4	13	0	0	13	0	0
9	38354689	.	G	A	7	0	7	0	0	7	0	0
9	38359027	.	A	C	0	2	2	0	0	2	0	0
9	38359737	.	G	A	1	0	1	0	0	1	0	0
9	38360102	.	C	T	0	3	3	0	3	6	0	0
9	38362354	.	G	A	6	6	12	0	0	12	0	0
9	38362380	.	C	T	3	5	8	0	1	9	0	0
9	38365213	.	T	C	1	0	1	0	1	2	0	0
9	38366653	.	T	C	0	1	1	0	0	1	0	0
9	38366656	.	C	A	0	1	1	0	0	1	0	0
9	38366826	.	A	G	0	1	1	0	0	1	0	0
9	38366883	.	C	G	0	1	1	0	0	1	0	0
9	38376129	.	A	T	1	2	3	0	0	3	0	0
9	38385734	.	G	A	1	2	3	0	0	3	0	0
9	38386066	.	A	G	2	0	2	0	0	2	0	0
9	38386205	.	C	T	3	1	4	0	0	4	0	0
9	38386615	.	C	A	2	1	3	0	0	3	0	0
9	38388017	.	G	A	3	2	5	0	0	5	0	0
9	38388492	.	C	T	6	6	12	0	2	14	0	0
9	38388493	.	C	T	3	6	9	0	5	14	0	0
9	38388703	.	T	C	3	4	7	0	2	9	0	0
9	38389026	.	T	A	8	3	11	0	0	11	0	0
9	38389194	.	C	T	7	7	14	0	0	14	0	0
9	38389263	.	T	A	6	5	11	0	1	12	0	0
9	38389426	.	G	A	16	11	27	0	0	27	0	0
9	38389603	.	A	G	11	0	11	0	4	15	0	0
9	38389616	.	C	T	12	5	17	0	0	17	0	0
9	38389644	.	A	T	14	6	20	0	0	20	0	0
9	38389722	.	G	T	5	4	9	0	0	9	0	0
9	38389746	.	T	C	6	9	15	0	1	16	0	0
9	38389886	.	C	T	5	7	12	0	0	12	0	0
9	38390973	.	A	G	1	1	2	0	1	3	0	0
9	38390976	.	G	A	1	2	3	0	0	3	0	0
9	38391549	.	C	T	2	4	6	0	0	6	0	0
9	38392097	.	T	C	2	2	4	0	0	4	0	0
9	38392460	.	C	T	0	2	2	0	1	3	0	0
9	38392563	.	G	T	2	3	5	0	0	5	0	0
9	38400139	.	T	C	1	2	3	0	0	3	0	0
9	38400169	.	A	C	3	4	7	0	0	7	0	0
9	38400232	.	T	A	1	1	2	0	2	4	0	0
9	38400233	.	T	C	1	3	4	0	0	4	0	0
9	38405238	.	A	G	4	8	12	0	0	12	0	0
9	38405271	.	G	C	3	4	7	0	1	9	1	0
9	38413298	.	C	T	1	0	1	0	0	1	0	0
9	38418864	.	T	C	3	3	6	0	0	6	0	0
9	38420509	.	C	T	2	2	4	0	0	4	0	0
9	38429647	.	A	G	3	0	3	0	2	5	0	0
9	38456091	.	A	C	0	1	1	0	0	1	0	0
9	38456111	.	T	C	0	1	1	0	0	1	0	0
9	38456782	.	C	T	0	1	1	0	0	1	0	0
9	38458369	.	A	C	0	3	3	0	1	4	0	0
9	38458530	.	A	C	2	3	5	0	0	5	0	0
9	38464295	.	A	G	1	0	1	0	0	1	0	0
9	38473937	.	T	C	1	3	4	0	0	4	0	0
9	38473973	.	C	T	1	2	3	0	0	3	0	0
9	38475598	.	T	C	0	1	1	0	0	1	0	0
9	38476650	.	A	C	1	2	3	0	0	3	0	0
9	38476748	.	G	A	6	2	8	0	0	8	0	0
9	38476780	.	G	C	5	2	7	0	0	7	0	0
9	38478424	.	T	C	2	2	4	0	0	4	0	0
9	38478477	.	G	A	0	1	1	0	1	2	0	0
9	38478643	.	A	T	1	2	3	0	1	4	0	0
9	38479579	.	A	G	4	2	6	0	1	7	0	0
9	38494774	.	G	A	0	1	1	0	0	1	0	0
9	38495985	.	C	T	2	0	2	0	0	2	0	0
9	38497393	.	C	T	2	1	3	0	0	3	0	0
9	38502734	.	T	A	1	2	3	0	0	3	0	0
9	38550889	.	T	C	4	2	6	0	0	6	0	0
9	38550910	.	T	C	3	2	5	0	0	5	0	0
9	38577046	.	C	G	2	2	4	0	0	4	0	0
9	38600006	.	G	A	0	3	3	0	3	6	0	0
9	38620058	.	C	T	9	13	22	0	3	25	0	0
9	38620308	.	C	A	1	5	6	0	0	6	0	0
9	38620673	.	A	G	14	15	29	0	2	31	0	0
9	38635435	.	G	A	1	0	1	0	0	1	0	0
9	38636152	.	A	G	4	0	4	0	2	6	0	0
9	38636170	.	A	G	4	2	6	0	0	6	0	0
9	38636413	.	G	T	0	3	3	0	6	9	0	0
9	38636797	.	T	C	5	4	9	0	0	9	0	0
9	38638452	.	A	T	3	5	8	0	0	8	0	0
9	38638461	.	C	G	3	5	8	0	0	8	0	0
9	38638492	.	A	G	4	0	4	0	8	12	0	0
9	38638518	.	T	C	6	9	15	0	0	15	0	0
9	38638743	.	T	C	4	7	11	0	0	11	0	0
9	38638862	.	C	T	5	1	6	0	1	7	0	0
9	38638863	.	C	A	5	2	7	0	0	7	0	0
9	38638970	.	G	A	3	4	7	0	0	7	0	0
9	38639799	.	T	C	5	3	8	0	0	8	0	0
9	38639846	.	C	T	3	4	7	0	0	7	0	0
9	38639907	.	A	C	4	5	9	0	0	9	0	0
9	38639999	.	C	T	3	5	8	0	0	8	0	0
9	38640114	.	T	A	5	5	10	0	0	10	0	0
9	38640598	.	A	G	5	0	5	0	4	9	0	0
9	38640773	.	A	T	3	3	6	0	1	7	0	0
9	38641111	.	C	T	3	3	6	0	1	7	0	0
9	38706191	.	T	C	2	3	5	0	0	5	0	0
9	38737930	.	C	T	1	2	3	0	0	3	0	0
9	38764924	.	A	C	0	2	2	0	0	2	0	0
9	38764931	.	T	A	0	2	2	0	0	2	0	0
9	38765158	.	C	T	0	2	2	0	0	2	0	0
9	38888025	.	A	T	1	4	5	0	0	5	0	0
9	40928245	.	T	C	4	2	6	0	0	6	0	0
9	40928279	.	T	C	5	1	6	0	0	6	0	0
9	40928284	.	T	C	3	0	3	0	4	7	0	0
9	40928706	.	T	C	2	2	4	0	0	4	0	0
9	40928720	.	T	C	1	2	3	0	0	3	0	0
9	40930316	.	T	C	1	4	5	0	1	6	0	0
9	40930319	.	T	C	0	5	5	0	1	6	0	0
9	41479972	.	A	G	5	3	8	0	1	9	0	0
9	41679684	.	A	T	1	2	3	0	0	3	0	0
9	42360743	.	C	G	4	5	9	0	1	10	0	0
9	42360893	.	C	T	0	6	6	0	4	10	0	0
9	42360899	.	G	A	4	5	9	0	0	9	0	0
9	42372354	.	T	A	3	4	7	0	0	7	0	0
9	42421027	.	G	A	6	2	8	0	0	8	0	0
9	42421044	.	G	T	7	4	11	0	0	11	0	0
9	42644892	.	A	G	2	0	2	0	9	11	0	0
9	42649583	.	A	G	1	5	6	0	0	6	0	0
9	42649636	.	T	A	3	3	6	0	1	7	0	0
9	42649653	.	T	C	6	7	13	0	0	13	0	0
9	42649739	.	C	T	4	5	9	0	0	9	0	0
9	42649743	.	A	G	4	5	9	0	0	9	0	0
9	42657418	.	A	T	2	4	6	0	0	6	0	0
9	42658401	.	G	C	0	1	1	0	0	1	0	0
9	42660036	.	T	C	3	4	7	0	0	7	0	0
9	42728866	.	C	A	0	1	1	0	0	1	0	0
9	42730451	.	A	C	2	1	3	0	0	3	0	0
9	42730591	.	A	G	3	2	5	0	0	5	0	0
9	42730602	.	A	G	3	2	5	0	0	5	0	0
9	43082319	.	T	A	1	3	4	0	0	4	0	0
9	43082373	.	A	T	1	3	4	0	0	4	0	0
9	43082717	.	T	G	1	3	4	0	0	4	0	0
9	43085369	.	G	T	5	3	8	0	0	8	0	0
9	43085728	.	A	C	2	2	4	0	0	4	0	0
9	43085879	.	C	T	10	2	12	0	2	14	0	0
9	43085949	.	A	C	3	0	3	0	0	3	0	0
9	43088841	.	C	A	1	3	4	0	0	4	0	0
9	43088870	.	T	A	0	3	3	0	1	4	0	0
9	43088884	.	G	A	1	3	4	0	0	4	0	0
9	43088984	.	A	G	2	4	6	0	0	6	0	0
9	43107296	.	C	T	0	2	2	0	2	4	0	0
9	43107318	.	A	T	1	2	3	0	1	4	0	0
9	43111013	.	A	G	1	1	2	0	0	2	0	0
9	43113358	.	T	A	0	1	1	0	1	2	0	0
9	43113395	.	C	T	1	2	3	0	0	3	0	0
9	43116652	.	T	C	2	3	5	0	0	5	0	0
9	43150018	.	T	A	6	5	11	0	2	13	0	0
9	43150278	.	T	G	6	12	18	0	1	19	0	0
9	43150604	.	A	G	13	21	34	0	0	35	1	0
9	43150817	.	C	T	0	19	19	0	12	31	0	0
9	43153287	.	C	T	4	5	9	0	0	9	0	0
9	43154841	.	C	T	4	3	7	0	0	7	0	0
9	43202097	.	T	C	0	0	0	0	1	1	0	0
9	43243265	.	A	C	7	6	13	0	0	13	0	0
9	43243266	.	T	C	7	6	13	0	0	13	0	0
9	43261951	.	T	A	9	3	12	0	0	12	0	0
9	43375122	.	G	A	1	6	7	0	1	8	0	0
9	43552604	.	C	A	6	2	8	0	0	8	0	0
9	43553036	.	G	T	9	5	14	0	0	14	0	0
9	43612482	.	T	G	4	3	7	0	1	8	0	0
9	43617899	.	A	G	3	4	7	0	0	7	0	0
9	43617962	.	A	G	6	4	10	0	0	10	0	0
9	44094445	.	T	A	2	2	4	0	0	4	0	0
9	44097854	.	C	T	0	0	0	0	1	1	0	0
9	44109589	.	T	C	5	0	5	0	2	7	0	0
9	44109595	.	T	C	4	0	4	0	2	6	0	0
9	44292285	.	A	C	22	0	22	0	20	42	0	0
9	44292737	.	T	C	34	13	47	0	0	47	0	0
9	44292909	.	C	T	1	33	34	0	16	50	0	0
9	44293488	.	C	T	15	37	52	0	3	55	0	0
9	44294792	.	A	G	3	5	8	0	0	8	0	0
9	44391395	.	G	A	3	2	5	0	0	5	0	0
9	44391664	.	T	C	3	7	10	0	0	10	0	0
9	44391666	.	G	A	3	6	9	0	1	10	0	0
9	44391780	.	G	A	0	3	3	0	1	4	0	0
9	44398141	.	G	A	1	1	2	0	0	2	0	0
9	44399446	.	C	A	5	2	7	0	0	7	0	0
9	44399521	.	C	T	3	2	5	0	0	5	0	0
9	44400091	.	T	G	8	6	14	0	1	15	0	0
9	44400119	.	G	A	9	10	19	0	0	19	0	0
9	44400580	.	G	A	7	13	20	0	2	22	0	0
9	44400706	.	C	A	8	3	11	0	0	11	0	0
9	44411647	.	A	G	10	15	25	0	5	30	0	0
9	44411652	.	C	A	12	18	30	0	1	31	0	0
9	44411828	.	A	C	2	2	4	0	1	5	0	0
9	44419652	.	T	A	9	10	19	0	1	20	0	0
9	44419793	.	C	A	8	8	16	0	4	20	0	0
9	44431117	.	G	A	7	2	9	0	1	10	0	0
9	44486011	.	A	G	6	2	8	0	0	8	0	0
9	44488578	.	T	A	6	3	9	0	0	9	0	0
9	44488620	.	G	A	1	0	1	0	0	1	0	0
9	44489843	.	G	A	0	6	6	0	5	11	0	0
9	44489844	.	T	A	4	7	11	0	0	11	0	0
9	44498332	.	T	C	5	14	19	0	2	21	0	0
9	44509181	.	G	A	2	1	3	0	0	3	0	0
9	44511218	.	C	T	0	5	5	0	0	5	0	0
9	44515937	.	G	A	3	8	11	0	0	11	0	0
9	44526546	.	G	A	1	1	2	0	0	2	0	0
9	44641974	.	A	T	8	8	16	0	2	18	0	0
9	44642017	.	G	A	8	8	16	0	1	17	0	0
9	44642057	.	T	C	5	0	5	0	16	21	0	0
9	44961166	.	A	G	5	5	10	0	0	10	0	0
9	44965715	.	C	T	1	2	3	0	0	3	0	0
9	45504135	.	G	A	0	2	2	0	3	5	0	0
9	45504199	.	C	T	2	3	5	0	1	6	0	0
9	45504357	.	A	C	4	2	6	0	0	6	0	0
9	45504485	.	A	G	2	6	8	0	0	8	0	0
9	45504819	.	A	G	5	0	5	0	6	11	0	0
9	45504888	.	G	A	0	4	4	0	1	5	0	0
9	45541036	.	C	A	4	5	9	0	1	10	0	0
9	45541239	.	G	A	3	3	6	0	0	6	0	0
9	45551225	.	T	C	14	8	22	0	1	23	0	0
9	45551235	.	C	A	15	6	21	0	0	21	0	0
9	45551273	.	T	C	10	5	15	0	2	17	0	0
9	45552338	.	T	G	3	6	9	0	0	9	0	0
9	45552364	.	G	A	0	7	7	0	3	10	0	0
9	45552386	.	C	G	4	10	14	0	0	14	0	0
9	45552567	.	G	A	0	8	8	0	15	23	0	0
9	45552715	.	C	T	10	14	24	0	0	24	0	0
9	45552806	.	G	A	0	12	12	0	10	22	0	0
9	45552881	.	T	C	10	9	19	0	1	20	0	0
9	45552924	.	C	A	13	10	23	0	1	24	0	0
9	45552957	.	C	T	17	6	23	0	1	24	0	0
9	45617551	.	T	C	2	2	4	0	0	4	0	0
9	45623346	.	C	T	3	6	9	0	0	9	0	0
9	45623446	.	A	G	4	4	8	0	0	8	0	0
9	45666600	.	G	A	1	1	2	0	0	2	0	0
9	45689056	.	A	C	1	2	3	0	0	3	0	0
9	45884426	.	C	T	1	3	4	0	0	4	0	0
9	45884711	.	G	A	3	3	6	0	1	7	0	0
9	45884768	.	T	G	2	3	5	0	0	5	0	0
9	45975846	.	C	T	0	6	6	0	6	12	0	0
9	45997103	.	G	A	2	4	6	0	0	6	0	0
9	46029269	.	G	T	1	2	3	0	0	3	0	0
9	46029344	.	G	A	2	3	5	0	0	5	0	0
9	46409508	.	G	A	2	2	4	0	0	4	0	0
9	46525673	.	A	G	4	7	11	0	0	11	0	0
9	46598134	.	T	C	2	0	2	0	1	3	0	0
9	46604056	.	T	C	1	1	2	0	0	2	0	0
9	46604068	.	A	G	0	0	0	0	1	1	0	0
9	46604930	.	C	T	1	0	1	0	0	1	0	0
9	46650764	.	T	C	4	3	7	0	1	8	0	0
9	46656990	.	G	C	0	2	2	0	3	5	0	0
9	46667831	.	A	T	0	1	1	0	0	1	0	0
9	46670756	.	A	T	0	1	1	0	0	1	0	0
9	46671108	.	G	A	0	0	0	0	1	1	0	0
9	46671174	.	C	T	2	3	5	0	0	5	0	0
9	46676385	.	C	T	0	3	3	0	0	3	0	0
9	46678159	.	A	C	3	5	8	0	0	8	0	0
9	46678196	.	C	T	3	9	12	0	0	12	0	0
9	46678255	.	T	C	1	2	3	0	0	3	0	0
9	46678279	.	A	T	0	2	2	0	0	2	0	0
9	46683760	.	C	A	4	6	10	0	1	12	1	0
9	46683861	.	A	C	4	4	8	0	0	8	0	0
9	46692261	.	T	G	12	15	27	0	1	28	0	0
9	46745653	.	A	G	4	1	5	0	0	5	0	0
9	46799102	.	T	C	3	2	5	0	0	5	0	0
9	46820807	.	T	C	3	3	6	1	0	7	0	0
9	46821464	.	C	T	8	9	17	0	0	17	0	0
9	46821568	.	C	A	3	4	7	0	0	7	0	0
9	46821576	.	G	A	4	4	8	0	0	8	0	0
9	46821685	.	A	G	3	4	7	0	0	7	0	0
9	46821741	.	A	G	0	4	4	0	2	6	0	0
9	46821810	.	C	G	1	5	6	0	1	7	0	0
9	46821853	.	G	A	2	9	11	0	0	11	0	0
9	46821855	.	G	T	2	9	11	0	0	11	0	0
9	46821905	.	A	G	4	8	12	0	0	12	0	0
9	46821916	.	A	T	4	9	13	0	2	15	0	0
9	46822002	.	T	C	5	5	10	0	0	10	0	0
9	46822079	.	C	T	3	4	7	0	0	7	0	0
9	46822120	.	C	T	1	8	9	0	4	13	0	0
9	46822144	.	T	C	6	7	13	0	1	14	0	0
9	46823198	.	C	T	7	13	20	0	0	20	0	0
9	46823325	.	G	A	9	13	22	0	0	22	0	0
9	46823366	.	T	C	6	9	15	0	3	18	0	0
9	46823524	.	A	G	8	15	23	0	3	26	0	0
9	46824110	.	A	G	9	6	15	0	0	15	0	0
9	46824160	.	T	A	8	10	18	0	0	18	0	0
9	46825094	.	A	T	5	5	10	0	0	10	0	0
9	46841787	.	C	G	3	5	8	0	0	8	0	0
9	47459398	.	C	T	0	2	2	0	0	2	0	0
9	47463251	.	A	T	3	0	3	0	0	3	0	0
9	47502293	.	A	T	4	4	8	0	0	8	0	0
9	47502415	.	G	A	1	2	3	0	0	3	0	0
9	47502446	.	G	C	1	3	4	0	0	4	0	0
9	47502658	.	A	G	2	2	4	0	0	4	0	0
9	48054753	.	G	A	11	13	24	0	3	27	0	0
9	48060592	.	G	C	13	20	33	0	1	34	0	0
9	48076973	.	C	T	15	28	43	0	2	45	0	0
9	48123109	.	C	G	1	4	5	0	0	5	0	0
9	48123142	.	G	A	3	9	12	0	1	13	0	0
9	48123222	.	G	C	7	3	10	0	1	11	0	0
9	48127200	.	G	A	3	2	5	0	0	5	0	0
9	48128027	.	G	T	0	2	2	0	2	4	0	0
9	48131814	.	A	T	4	4	8	0	0	8	0	0
9	48131865	.	G	A	1	2	3	0	0	3	0	0
9	48131883	.	A	G	1	2	3	0	0	3	0	0
9	48131956	.	G	A	2	3	5	0	0	5	0	0
9	48131997	.	C	T	2	5	7	0	1	8	0	0
9	48132029	.	T	C	3	0	3	0	5	8	0	0
9	48132037	.	T	A	3	6	9	0	0	9	0	0
9	48132095	.	A	C	4	7	11	0	0	11	0	0
9	48132156	.	A	C	5	4	9	0	0	9	0	0
9	48132176	.	C	T	5	2	7	0	1	8	0	0
9	48132194	.	G	T	7	3	10	0	0	10	0	0
9	48132309	.	G	T	3	6	9	0	1	10	0	0
9	48132336	.	C	T	0	6	6	0	3	9	0	0
9	48132439	.	G	A	3	4	7	0	1	8	0	0
9	48132441	.	A	G	4	4	8	0	0	8	0	0
9	48132531	.	G	A	2	6	8	0	0	8	0	0
9	48132592	.	G	T	4	6	10	0	1	11	0	0
9	48133013	.	T	C	2	1	3	0	1	4	0	0
9	48133105	.	G	T	4	5	9	0	1	10	0	0
9	48133541	.	T	C	4	8	12	0	0	12	0	0
9	48133900	.	G	T	11	4	15	0	0	15	0	0
9	48134351	.	G	A	2	3	5	0	0	5	0	0
9	48134568	.	G	A	3	6	9	0	8	17	0	0
9	48134678	.	A	T	4	5	9	0	0	9	0	0
9	48178975	.	A	G	1	2	3	0	0	3	0	0
9	48178990	.	C	T	0	2	2	0	1	3	0	0
9	48179081	.	T	C	3	4	7	0	0	7	0	0
9	48184354	.	A	C	2	2	4	0	0	4	0	0
9	48186272	.	T	C	2	0	2	0	2	4	0	0
9	48186325	.	G	T	1	3	4	0	0	4	0	0
9	48186519	.	C	A	5	2	7	0	0	7	0	0
9	48189403	.	C	G	0	2	2	0	4	6	0	0
9	48189411	.	T	C	3	1	4	0	0	4	0	0
9	48195432	.	C	T	0	1	1	0	1	2	0	0
9	48195441	.	G	A	1	1	2	0	0	2	0	0
9	48197935	.	T	A	3	2	5	0	0	5	0	0
9	48197944	.	A	G	2	2	4	0	0	4	0	0
9	48201122	.	A	G	4	2	6	0	1	7	0	0
9	48201127	.	G	A	5	2	7	0	0	7	0	0
9	48203875	.	G	A	1	0	1	0	0	1	0	0
9	48203896	.	A	G	1	0	1	0	0	1	0	0
9	48214157	.	T	A	4	2	6	0	0	6	0	0
9	48219649	.	T	G	2	0	2	0	2	4	0	0
9	48222670	.	G	A	0	1	1	0	1	2	0	0
9	48225779	.	T	C	2	4	6	0	0	6	0	0
9	48225854	.	G	A	1	1	2	0	0	2	0	0
9	48227847	.	T	A	5	4	9	0	1	10	0	0
9	48227885	.	T	G	3	5	8	0	1	9	0	0
9	48227953	.	T	C	1	2	3	0	0	3	0	0
9	48228950	.	T	C	0	2	2	0	0	2	0	0
9	48229039	.	C	G	2	4	6	0	0	6	0	0
9	48229074	.	T	C	1	2	3	0	1	4	0	0
9	48230669	.	C	T	4	3	7	0	1	8	0	0
9	48230871	.	C	A	1	2	3	0	0	3	0	0
9	48232785	.	A	C	1	1	2	0	0	2	0	0
9	48239744	.	G	A	0	2	2	0	1	3	0	0
9	48239757	.	C	A	2	2	4	0	0	4	0	0
9	48239975	.	C	T	1	1	2	0	0	2	0	0
9	48252433	.	C	T	2	2	4	0	0	4	0	0
9	48266750	.	T	A	1	2	3	0	0	3	0	0
9	48266752	.	C	T	1	2	3	0	0	3	0	0
9	48284901	.	T	C	11	10	21	0	0	21	0	0
9	48284917	.	C	A	0	8	8	0	13	21	0	0
9	48284972	.	T	C	7	4	11	0	0	11	0	0
9	48285019	.	G	A	1	1	2	0	0	2	0	0
9	48286702	.	G	A	0	1	1	0	0	1	0	0
9	48287441	.	G	A	2	4	6	0	2	8	0	0
9	48289758	.	G	A	2	3	5	0	1	6	0	0
9	48289797	.	A	T	2	4	6	0	0	6	0	0
9	48289961	.	A	G	2	1	3	0	0	3	0	0
9	48289991	.	T	C	5	3	8	0	1	9	0	0
9	48295210	.	G	A	1	0	1	0	0	1	0	0
9	48295211	.	T	G	1	0	1	0	0	1	0	0
9	48296346	.	C	T	0	10	10	0	8	18	0	0
9	48390858	.	G	T	1	5	6	0	0	6	0	0
9	48397350	.	T	C	2	0	2	0	5	7	0	0
9	48609109	.	G	T	1	2	3	0	0	3	0	0
9	48640511	.	C	T	2	2	4	0	0	4	0	0
9	48665654	.	G	A	1	0	1	0	0	1	0	0
9	48666890	.	A	G	1	0	1	0	0	1	0	0
9	48668834	.	C	G	3	3	6	0	0	6	0	0
9	48670193	.	C	G	2	2	4	0	0	4	0	0
9	48670194	.	C	T	2	2	4	0	0	4	0	0
9	48670316	.	C	T	2	2	4	0	0	4	0	0
9	48670395	.	A	C	5	3	8	0	0	8	0	0
9	48670454	.	T	G	1	4	5	0	0	5	0	0
9	48671010	.	T	G	1	2	3	1	0	4	0	0
9	48671052	.	A	G	1	2	3	0	1	4	0	0
9	48671520	.	G	A	0	0	0	0	1	1	0	0
9	48706302	.	C	T	7	1	8	0	0	8	0	0
9	48706305	.	C	T	7	1	8	0	0	8	0	0
9	48718225	.	C	A	0	3	3	0	2	5	0	0
9	48718229	.	C	G	2	3	5	0	0	5	0	0
9	48721088	.	C	T	2	4	6	0	0	6	0	0
9	48721107	.	C	T	4	2	6	0	0	6	0	0
9	48721265	.	T	C	3	3	6	0	0	6	0	0
9	48816846	.	T	C	1	2	3	0	0	3	0	0
9	48870578	.	T	C	11	0	11	0	10	21	0	0
9	48870593	.	A	T	7	11	18	0	0	18	0	0
9	48870627	.	T	A	4	9	13	0	1	14	0	0
9	48870680	.	A	G	4	7	11	0	0	11	0	0
9	48870886	.	C	T	6	5	11	0	0	11	0	0
9	48871080	.	G	C	2	8	10	0	0	10	0	0
9	48871966	.	T	G	5	8	13	0	3	16	0	0
9	48871973	.	A	C	10	6	16	0	0	16	0	0
9	48872039	.	C	G	0	2	2	1	0	3	0	0
9	48872615	.	A	G	5	1	6	0	0	6	0	0
9	48872620	.	C	T	4	3	7	0	1	8	0	0
9	48872688	.	A	T	3	3	6	0	0	6	0	0
9	48872694	.	A	G	2	3	5	0	1	6	0	0
9	48872924	.	A	G	4	3	7	0	1	8	0	0
9	48872926	.	C	T	0	2	2	0	6	8	0	0
9	48873144	.	A	G	1	4	5	0	0	5	0	0
9	48873302	.	T	C	4	6	10	0	0	10	0	0
9	48873371	.	A	G	2	3	5	0	0	5	0	0
9	48873522	.	C	G	7	6	13	0	0	13	0	0
9	48874562	.	G	A	7	5	12	0	0	12	0	0
9	48874577	.	G	A	6	4	10	0	1	11	0	0
9	48874728	.	T	C	4	5	9	0	0	9	0	0
9	48875171	.	C	T	1	1	2	0	0	2	0	0
9	48875218	.	G	T	1	4	5	0	0	5	0	0
9	48875516	.	G	A	1	3	4	0	1	5	0	0
9	48875595	.	A	C	0	2	2	0	0	2	0	0
9	48876544	.	C	T	5	3	8	0	1	9	0	0
9	48876587	.	A	G	6	3	9	0	0	9	0	0
9	48876798	.	C	T	0	5	5	0	2	7	0	0
9	48877005	.	A	C	2	2	4	0	1	5	0	0
9	48937081	.	G	C	2	2	4	0	1	5	0	0
9	49713606	.	G	T	0	5	5	0	0	5	0	0
9	50195138	.	C	G	5	2	7	0	0	7	0	0
9	50195221	.	C	T	3	5	8	0	0	8	0	0
9	50195615	.	G	A	2	2	4	0	0	4	0	0
9	50196047	.	A	C	2	3	5	0	1	6	0	0
9	51302422	.	A	G	3	5	8	0	2	10	0	0
9	51307387	.	G	T	3	1	4	0	1	5	0	0
9	51345386	.	C	A	1	3	4	0	1	5	0	0
9	51804640	.	A	C	1	1	2	0	0	2	0	0
9	51996280	.	T	A	9	3	12	0	1	13	0	0
9	51996281	.	G	A	9	4	13	0	0	13	0	0
9	51996444	.	T	G	10	9	19	0	0	19	0	0
9	51996743	.	A	G	5	6	11	0	0	11	0	0
9	51996788	.	A	G	1	0	1	0	0	1	0	0
9	51996868	.	T	A	1	3	4	0	0	4	0	0
9	51996974	.	C	T	4	3	7	0	0	7	0	0
9	51998495	.	A	C	6	0	6	0	4	10	0	0
9	51998539	.	G	T	6	3	9	0	0	9	0	0
9	51998648	.	C	T	7	5	12	0	0	12	0	0
9	51998866	.	A	T	10	3	13	0	0	13	0	0
9	51999767	.	A	G	2	1	3	1	1	5	0	0
9	51999815	.	T	C	5	5	10	0	0	10	0	0
9	51999842	.	C	G	4	5	9	0	0	9	0	0
9	51999855	.	T	G	7	4	11	0	0	11	0	0
9	51999885	.	C	T	6	6	12	0	0	12	0	0
9	51999924	.	T	A	5	4	9	0	1	10	0	0
9	52000032	.	C	T	0	2	2	0	9	11	0	0
9	52000127	.	C	G	7	2	9	0	0	9	0	0
9	52000164	.	G	A	3	2	5	0	1	6	0	0
9	52000335	.	A	T	7	3	10	0	0	10	0	0
9	52000827	.	T	A	7	3	10	0	0	10	0	0
9	52000869	.	G	C	2	0	2	0	3	5	0	0
9	52057315	.	A	G	2	2	4	0	0	4	0	0
9	52062698	.	T	C	4	5	9	0	0	9	0	0
9	52062710	.	T	G	3	5	8	0	1	9	0	0
9	52378697	.	A	G	21	11	32	0	1	33	0	0
9	52378832	.	T	A	8	16	24	0	0	24	0	0
9	52411575	.	C	T	1	2	3	0	0	3	0	0
9	52416005	.	G	A	0	1	1	0	0	1	0	0
9	52432669	.	T	C	1	0	1	0	0	1	0	0
9	52433174	.	A	C	3	5	8	0	0	8	0	0
9	52435058	.	G	C	2	3	5	0	0	5	0	0
9	52435112	.	C	T	0	2	2	0	0	2	0	0
9	52479815	.	C	T	0	2	2	0	1	3	0	0
9	52479822	.	C	G	0	1	1	0	1	2	0	0
9	52487535	.	T	C	1	0	1	0	2	3	0	0
9	52489838	.	C	A	1	1	2	0	0	2	0	0
9	52489899	.	T	C	2	0	2	0	4	6	0	0
9	52490015	.	A	G	1	3	4	0	0	4	0	0
9	52490250	.	C	T	0	2	2	0	1	3	0	0
9	52490254	.	G	T	1	2	3	0	0	3	0	0
9	52492641	.	A	C	6	6	12	0	1	13	0	0
9	52492705	.	A	G	12	5	17	0	0	17	0	0
9	52492853	.	C	G	4	0	4	0	3	7	0	0
9	52493059	.	A	T	14	2	16	0	0	16	0	0
9	52493231	.	A	T	8	10	18	0	0	18	0	0
9	52493406	.	C	T	5	9	14	0	0	14	0	0
9	52539290	.	G	A	0	4	4	0	7	11	0	0
9	52539453	.	C	T	7	16	23	0	2	25	0	0
9	52539629	.	C	T	12	8	20	0	0	20	0	0
9	52564578	.	T	C	2	0	2	0	4	6	0	0
9	52564622	.	T	C	1	1	2	0	0	2	0	0
9	52572555	.	C	T	1	3	4	0	0	4	0	0
9	52572573	.	G	A	8	3	11	0	0	11	0	0
9	52572609	.	C	G	5	3	8	0	1	9	0	0
9	52574737	.	C	G	1	3	4	0	0	4	0	0
9	52577760	.	C	T	1	1	2	0	0	2	0	0
9	52589588	.	G	A	1	0	1	0	0	1	0	0
9	52594558	.	G	C	2	2	4	0	1	5	0	0
9	52594594	.	C	T	2	2	4	0	0	4	0	0
9	52594600	.	G	A	2	3	5	0	0	5	0	0
9	52595710	.	C	T	1	1	2	0	0	2	0	0
9	52629113	.	C	T	4	6	10	0	0	10	0	0
9	52629119	.	C	T	6	4	10	0	0	10	0	0
9	52631620	.	G	A	4	5	9	0	1	10	0	0
9	52633184	.	C	G	3	0	3	0	0	3	0	0
9	52642012	.	G	A	3	0	3	0	0	3	0	0
9	52645687	.	C	T	0	3	3	0	3	6	0	0
9	52649704	.	C	T	0	2	2	0	0	2	0	0
9	52649740	.	C	A	0	3	3	0	4	7	0	0
9	52649758	.	T	A	3	3	6	0	1	7	0	0
9	52649794	.	A	G	1	2	3	0	0	3	0	0
9	52649941	.	G	A	1	0	1	0	1	2	0	0
9	52651985	.	T	C	3	2	5	0	0	5	0	0
9	52652015	.	A	G	2	3	5	0	0	5	0	0
9	52874947	.	G	A	1	1	2	0	0	2	0	0
9	53276550	.	A	C	7	3	10	0	3	13	0	0
9	53276681	.	G	A	0	9	9	0	9	18	0	0
9	53276978	.	A	G	3	8	11	0	0	11	0	0
9	53277068	.	C	G	11	0	11	0	5	16	0	0
9	53277131	.	A	T	11	6	17	0	0	17	0	0
9	53277453	.	G	A	0	7	7	0	7	14	0	0
9	53277493	.	A	T	6	8	14	0	0	14	0	0
9	53535713	.	C	T	1	4	5	0	0	5	0	0
9	53536208	.	C	A	0	3	3	0	1	4	0	0
9	53537396	.	C	T	0	2	2	0	2	4	0	0
9	53537510	.	A	T	2	5	7	0	0	7	0	0
9	53707638	.	G	C	2	2	4	0	4	8	0	0
9	53707653	.	A	T	4	6	10	0	0	10	0	0
9	53707995	.	C	T	4	4	8	0	0	8	0	0
9	53708037	.	G	A	4	6	10	0	0	10	0	0
9	53708055	.	T	C	4	6	10	0	0	10	0	0
9	53708316	.	G	A	0	6	6	0	1	7	0	0
9	53709003	.	C	T	4	6	10	0	1	11	0	0
9	53709184	.	T	C	2	3	5	0	0	5	0	0
9	53709365	.	C	T	6	3	9	0	1	10	0	0
9	53715525	.	G	A	1	3	4	0	4	8	0	0
9	53719342	.	T	C	6	9	15	0	0	15	0	0
9	53741033	.	G	A	1	3	4	0	0	4	0	0
9	53843404	.	C	T	9	10	19	0	0	19	0	0
9	53843590	.	A	T	5	5	10	0	0	10	0	0
9	53843737	.	T	C	4	0	4	0	8	12	0	0
9	53843909	.	C	T	0	4	4	0	1	5	0	0
9	53844188	.	T	C	3	0	3	0	2	5	0	0
9	53845537	.	A	G	5	8	13	0	0	13	0	0
9	53849389	.	T	C	4	1	5	0	5	10	0	0
9	53849440	.	G	A	7	4	11	0	0	11	0	0
9	53851676	.	C	T	0	0	0	0	1	1	0	0
9	53853662	.	G	C	3	0	3	0	4	7	0	0
9	53864227	.	A	C	2	2	4	0	0	4	0	0
9	53869247	.	G	A	0	4	4	0	0	4	0	0
9	53869344	.	T	C	4	2	6	0	1	7	0	0
9	53882893	.	C	A	0	4	4	0	0	4	0	0
9	53890327	.	C	A	1	5	6	0	0	6	0	0
9	53890345	.	G	T	2	5	7	0	0	7	0	0
9	53896187	.	C	T	0	1	1	0	3	4	0	0
9	53937614	.	G	A	1	2	3	0	1	4	0	0
9	54105713	.	T	C	3	1	4	0	0	4	0	0
9	54112139	.	G	C	2	4	6	0	0	6	0	0
9	54112151	.	T	A	2	4	6	0	0	6	0	0
9	54112469	.	T	C	3	12	15	0	0	15	0	0
9	54112526	.	T	A	3	8	11	0	0	11	0	0
9	54112571	.	A	G	1	8	9	0	0	9	0	0
9	54113324	.	C	T	1	3	4	0	0	4	0	0
9	54113954	.	C	T	2	5	7	0	0	7	0	0
9	54114050	.	A	G	5	0	5	0	9	14	0	0
9	54114242	.	T	G	0	0	0	0	5	6	1	0
9	54245010	.	T	A	2	2	4	0	1	5	0	0
9	54247334	.	A	G	4	2	6	0	0	6	0	0
9	54247336	.	T	C	3	2	5	0	1	6	0	0
9	54256286	.	C	A	3	4	7	0	0	7	0	0
9	54261104	.	G	A	0	3	3	0	1	4	0	0
9	54263996	.	C	T	4	3	7	0	0	7	0	0
9	54264236	.	T	C	3	5	8	0	0	8	0	0
9	54264245	.	T	C	3	4	7	0	0	7	0	0
9	54264272	.	C	T	3	6	9	0	0	9	0	0
9	54264299	.	C	A	4	5	9	0	0	9	0	0
9	54270324	.	C	T	1	1	2	0	0	2	0	0
9	54270348	.	T	A	1	1	2	0	0	2	0	0
9	54273514	.	G	T	2	4	6	0	0	6	0	0
9	54315617	.	T	G	2	3	5	0	0	5	0	0
9	54329537	.	T	C	2	7	9	0	0	9	0	0
9	54329593	.	C	A	0	4	4	0	4	8	0	0
9	54331562	.	G	A	0	2	2	0	0	2	0	0
9	54331637	.	T	C	0	4	4	0	0	4	0	0
9	54331768	.	G	A	5	1	6	0	0	6	0	0
9	54336738	.	A	G	1	2	3	0	0	3	0	0
9	54340140	.	C	T	1	1	2	0	0	2	0	0
9	54340248	.	G	A	2	2	4	0	0	4	0	0
9	54351499	.	T	C	1	2	3	0	0	3	0	0
9	54417949	.	A	T	4	6	10	0	0	10	0	0
9	54418687	.	T	C	2	7	9	0	0	9	0	0
9	54661105	.	T	C	1	3	4	0	0	4	0	0
9	54711020	.	G	T	11	5	16	0	0	16	0	0
9	54712225	.	T	C	6	5	11	0	0	11	0	0
9	54712232	.	T	C	2	9	11	0	0	11	0	0
9	54712384	.	T	C	4	2	6	0	0	6	0	0
9	54712704	.	A	G	4	9	13	0	0	13	0	0
9	54712745	.	T	C	13	12	25	0	0	25	0	0
9	54712751	.	C	T	14	10	24	0	0	24	0	0
9	54712917	.	A	T	7	9	16	0	0	16	0	0
9	54712945	.	G	A	9	8	17	0	0	17	0	0
9	54712985	.	A	C	9	10	19	0	0	19	0	0
9	54715157	.	T	C	3	4	7	0	0	7	0	0
9	54716349	.	G	A	11	7	18	0	0	19	1	0
9	54723323	.	G	A	3	2	5	0	0	5	0	0
9	54725256	.	G	A	1	2	3	0	0	3	0	0
9	54730650	.	G	C	2	2	4	0	0	4	0	0
9	54738987	.	C	T	5	8	13	0	0	13	0	0
9	54739015	.	A	T	4	10	14	0	0	14	0	0
9	54739181	.	C	G	1	1	2	0	0	2	0	0
9	54739182	.	C	A	1	0	1	0	1	2	0	0
9	54739539	.	C	A	2	4	6	0	0	6	0	0
9	54751753	.	T	C	6	9	15	0	0	15	0	0
9	54763880	.	C	A	10	14	24	0	1	25	0	0
9	54763930	.	A	T	1	4	5	0	0	5	0	0
9	54763977	.	T	A	3	5	8	0	2	10	0	0
9	54764102	.	C	T	7	6	13	0	0	13	0	0
9	54764143	.	G	A	14	10	24	0	0	24	0	0
9	54764349	.	G	A	20	16	36	0	1	37	0	0
9	54769705	.	T	C	6	1	7	0	9	16	0	0
9	54770768	.	G	A	2	0	2	0	1	3	0	0
9	54770792	.	A	G	3	3	6	0	1	7	0	0
9	54775967	.	A	G	3	4	7	0	0	7	0	0
9	54775995	.	G	A	6	5	11	0	0	11	0	0
9	54776055	.	T	C	6	0	6	0	4	10	0	0
9	54776075	.	G	A	3	1	4	0	0	4	0	0
9	55382313	.	A	G	2	2	4	0	0	4	0	0
9	55382350	.	T	C	1	5	6	0	0	6	0	0
9	55382368	.	A	G	6	1	7	0	0	7	0	0
9	55382620	.	G	C	0	1	1	0	2	3	0	0
9	55413395	.	C	A	4	3	7	0	0	7	0	0
9	55413485	.	C	A	5	5	10	0	0	10	0	0
9	55413677	.	C	T	1	7	8	0	0	8	0	0
9	55417638	.	G	A	0	3	3	0	5	8	0	0
9	55417665	.	A	G	4	0	4	0	5	9	0	0
9	55418067	.	C	T	3	7	10	0	0	10	0	0
9	55418095	.	A	G	3	3	6	0	0	6	0	0
9	55585960	.	T	C	3	4	7	0	0	7	0	0
9	55666354	.	A	T	1	1	2	0	0	2	0	0
9	55730341	.	G	A	19	20	39	0	0	39	0	0
9	55736311	.	G	A	0	1	1	0	0	1	0	0
9	55741892	.	G	A	0	4	4	0	0	4	0	0
9	55744118	.	C	G	3	2	5	0	0	5	0	0
9	55748631	.	T	C	2	0	2	0	4	6	0	0
9	55748983	.	G	A	4	4	8	0	0	8	0	0
9	55749083	.	T	C	3	0	3	0	4	7	0	0
9	55749108	.	T	C	3	2	5	0	0	5	0	0
9	55749194	.	C	T	0	4	4	0	2	6	0	0
9	55749940	.	A	C	1	3	4	0	0	4	0	0
9	55750015	.	A	G	4	3	7	0	0	7	0	0
9	55750022	.	C	T	4	4	8	0	1	9	0	0
9	55750092	.	G	T	2	4	6	0	0	6	0	0
9	55750255	.	C	G	0	4	4	0	3	7	0	0
9	55750306	.	C	T	6	3	9	0	0	9	0	0
9	55750543	.	C	T	4	3	7	0	0	7	0	0
9	55750649	.	G	C	4	7	11	0	0	11	0	0
9	55750756	.	C	T	12	8	20	0	1	21	0	0
9	55750792	.	C	T	0	6	6	0	6	12	0	0
9	55756519	.	A	T	2	5	7	0	1	8	0	0
9	55756582	.	T	A	1	8	9	0	1	10	0	0
9	55771721	.	G	C	5	4	9	0	0	9	0	0
9	55771841	.	C	T	3	6	9	0	0	9	0	0
9	55783746	.	C	T	0	4	4	0	0	4	0	0
9	55784001	.	C	T	0	3	3	0	6	9	0	0
9	55784148	.	C	T	1	3	4	0	1	5	0	0
9	55857228	.	A	C	4	2	6	0	0	6	0	0
9	55857271	.	C	A	2	4	6	0	0	6	0	0
9	55860036	.	T	C	1	4	5	0	0	5	0	0
9	55860096	.	G	A	0	8	8	0	5	13	0	0
9	55860127	.	C	T	3	4	7	0	0	7	0	0
9	55860460	.	C	T	2	0	2	0	0	2	0	0
9	55870475	.	G	A	0	3	3	0	3	6	0	0
9	55870562	.	C	A	3	3	6	0	0	6	0	0
9	55874434	.	T	A	0	9	9	0	1	10	0	0
9	55874548	.	A	T	5	7	12	0	1	13	0	0
9	55874753	.	T	G	5	5	10	0	0	10	0	0
9	55929910	.	T	C	1	0	1	0	3	4	0	0
9	56197522	.	G	A	2	2	4	0	0	4	0	0
9	56225740	.	T	A	5	15	20	0	0	20	0	0
9	56226132	.	T	C	2	7	9	0	0	9	0	0
9	56230655	.	A	G	17	15	32	0	1	33	0	0
9	56230676	.	G	T	23	26	49	0	0	49	0	0
9	56231322	.	T	C	20	15	35	0	2	37	0	0
9	56231325	.	A	G	20	15	35	0	2	37	0	0
9	56235538	.	C	T	2	6	8	0	0	8	0	0
9	56237883	.	T	C	2	2	4	0	1	5	0	0
9	56350968	.	C	T	0	5	5	0	5	10	0	0
9	56351059	.	C	T	10	10	20	0	1	21	0	0
9	56353479	.	G	A	3	5	8	0	1	9	0	0
9	56363292	.	T	A	6	7	13	0	2	15	0	0
9	56369168	.	G	T	5	2	7	0	1	8	0	0
9	56369252	.	G	A	10	8	18	0	1	19	0	0
9	56369319	.	C	A	2	1	3	0	1	4	0	0
9	56389303	.	A	G	1	2	3	0	0	3	0	0
9	56457309	.	A	T	6	9	15	0	0	15	0	0
