contig	position	variantID	refAllele	altAllele	refCount	altCount	totalCount	lowMAPQDepth	lowBaseQDepth	rawDepth	otherBases	improperPairs
1	6698	.	G	A	14	13	27	0	2	29	0	0
1	6746	.	T	C	5	0	5	0	2	7	0	0
1	10093	.	C	T	6	7	13	0	1	14	0	0
1	14083	.	G	A	0	3	3	0	6	9	0	0
1	15050	.	G	A	1	5	6	0	5	11	0	0
1	15772	.	G	A	0	5	5	0	9	14	0	0
1	15828	.	G	A	0	11	11	0	5	16	0	0
1	16072	.	C	T	5	5	10	0	1	11	0	0
1	20128	.	C	T	3	7	10	0	0	10	0	0
1	32450	.	T	C	2	5	7	0	1	8	0	0
1	33036	.	C	T	9	5	14	0	0	14	0	0
1	38106	.	C	T	13	16	29	0	0	29	0	0
1	38814	.	G	A	1	14	15	0	8	23	0	0
1	39620	.	C	A	0	6	6	0	7	13	0	0
1	39621	.	G	C	7	6	13	0	0	13	0	0
1	39717	.	T	G	6	8	14	0	3	17	0	0
1	41287	.	C	T	0	0	0	0	1	1	0	0
1	42590	.	G	A	3	2	5	0	0	5	0	0
1	46097	.	G	A	1	2	3	0	0	3	0	0
1	62771	.	G	A	1	6	7	0	0	7	0	0
1	119069	.	G	A	1	0	1	0	1	2	0	0
1	119075	.	A	G	1	2	3	0	0	3	0	0
1	153527	.	A	G	2	0	2	0	0	2	0	0
1	154104	.	G	C	1	0	1	0	0	1	0	0
1	154113	.	G	A	1	0	1	0	0	1	0	0
1	154140	.	C	A	0	0	0	0	1	1	0	0
1	157915	.	T	A	3	4	7	0	0	7	0	0
1	160229	.	G	A	2	2	4	0	0	4	0	0
1	176642	.	C	T	11	11	22	0	0	22	0	0
1	176774	.	C	T	6	5	11	0	1	12	0	0
1	181717	.	T	C	11	9	20	0	0	20	0	0
1	181754	.	C	T	4	11	15	0	1	16	0	0
1	181763	.	A	G	3	8	11	0	1	12	0	0
1	185010	.	A	G	2	2	4	0	0	4	0	0
1	185057	.	G	A	4	2	6	0	0	6	0	0
1	191914	.	C	G	1	4	5	0	0	5	0	0
1	208408	.	T	A	8	18	26	0	3	29	0	0
1	208564	.	T	C	7	6	13	0	0	13	0	0
1	208570	.	T	C	4	9	13	0	1	14	0	0
1	209063	.	T	C	14	13	27	0	0	27	0	0
1	212162	.	G	A	4	4	8	0	0	8	0	0
1	213203	.	G	C	0	0	0	0	1	1	0	0
1	222797	.	C	T	4	2	6	0	0	6	0	0
1	222800	.	C	T	2	4	6	0	0	6	0	0
1	225044	.	G	A	0	5	5	0	6	11	0	0
1	225083	.	C	T	9	5	14	0	0	14	0	0
1	411320	.	C	T	1	4	5	0	0	5	0	0
1	442456	.	T	C	2	2	4	1	2	7	0	0
1	474273	.	C	G	0	3	3	0	1	4	0	0
1	474398	.	C	A	0	2	2	0	6	8	0	0
1	474465	.	C	T	11	3	14	0	0	14	0	0
1	474473	.	A	G	11	2	13	0	0	13	0	0
1	476034	.	G	A	0	2	2	0	0	2	0	0
1	477001	.	C	T	0	4	4	0	10	14	0	0
1	477013	.	G	T	9	4	13	0	1	14	0	0
1	477046	.	G	A	10	5	15	0	0	15	0	0
1	477070	.	C	T	0	4	4	0	7	11	0	0
1	477109	.	C	T	0	2	2	0	1	3	0	0
1	477817	.	C	T	1	0	1	0	0	1	0	0
1	477823	.	G	C	1	0	1	0	0	1	0	0
1	479986	.	A	G	0	1	1	0	0	1	0	0
1	484094	.	G	A	3	1	4	0	0	4	0	0
1	484418	.	G	A	1	3	4	0	0	4	0	0
1	484434	.	C	T	4	2	6	0	0	6	0	0
1	486775	.	T	C	2	4	6	0	0	6	0	0
1	489306	.	A	G	1	0	1	0	0	6	5	0
1	496760	.	A	G	1	0	1	0	4	5	0	0
1	499220	.	A	G	3	8	11	0	0	11	0	0
1	501381	.	T	A	2	2	4	0	0	4	0	0
1	502079	.	C	A	3	5	8	0	1	9	0	0
1	503900	.	C	T	3	3	6	0	0	6	0	0
1	504696	.	A	G	9	1	10	0	12	22	0	0
1	504947	.	G	T	5	6	11	0	0	11	0	0
1	504948	.	A	T	6	5	11	0	0	11	0	0
1	505178	.	G	A	6	4	10	0	0	10	0	0
1	505260	.	A	G	9	0	9	0	6	15	0	0
1	505298	.	C	T	12	4	16	0	0	16	0	0
1	505560	.	T	C	2	3	5	0	2	7	0	0
1	509222	.	T	G	1	4	5	0	0	5	0	0
1	509387	.	A	G	4	4	8	0	0	8	0	0
1	509718	.	T	A	5	3	8	0	1	9	0	0
1	509769	.	G	T	5	2	7	0	3	10	0	0
1	511525	.	G	A	1	3	4	0	0	4	0	0
1	511544	.	C	T	2	5	7	0	0	7	0	0
1	511957	.	G	A	1	4	5	0	0	5	0	0
1	513655	.	C	T	3	2	5	0	0	5	0	0
1	514114	.	G	A	0	6	6	0	3	9	0	0
1	515549	.	G	A	2	4	6	0	0	6	0	0
1	515575	.	G	C	5	4	9	0	0	9	0	0
1	517515	.	C	T	3	5	8	0	0	8	0	0
1	517733	.	C	T	4	4	8	0	0	8	0	0
1	524344	.	T	C	1	2	3	0	0	3	0	0
1	524806	.	G	A	7	5	12	0	3	15	0	0
1	524828	.	C	T	3	7	10	0	1	11	0	0
1	528522	.	G	A	0	9	9	0	22	31	0	0
1	528552	.	A	C	11	19	30	0	1	31	0	0
1	530497	.	T	A	0	2	2	0	1	3	0	0
1	546147	.	A	G	0	1	1	0	0	1	0	0
1	553187	.	G	T	1	2	3	0	0	3	0	0
1	553214	.	G	A	0	2	2	0	1	3	0	0
1	586161	.	G	A	0	6	6	0	7	13	0	0
1	586165	.	C	T	6	5	11	0	1	12	0	0
1	586765	.	C	T	1	3	4	0	0	4	0	0
1	589044	.	A	T	5	4	9	0	1	10	0	0
1	589056	.	C	T	10	6	16	0	0	16	0	0
1	589115	.	G	A	0	9	9	0	13	22	0	0
1	601873	.	C	T	2	0	2	0	0	2	0	0
1	601882	.	G	A	2	0	2	0	0	2	0	0
1	601954	.	C	T	0	0	0	0	1	1	0	0
1	603292	.	A	G	3	4	7	0	1	8	0	0
1	606128	.	A	C	1	0	1	0	0	1	0	0
1	610451	.	C	G	2	6	8	0	1	9	0	0
1	610606	.	C	T	1	4	5	0	0	5	0	0
1	610722	.	T	C	11	10	21	0	3	24	0	0
1	611267	.	T	C	14	26	40	0	2	42	0	0
1	617676	.	T	C	1	2	3	0	0	3	0	0
1	617950	.	C	T	0	29	29	0	27	56	0	0
1	618190	.	A	C	28	3	31	0	27	58	0	0
1	618210	.	G	A	25	24	49	0	5	54	0	0
1	618277	.	A	G	27	23	50	0	4	54	0	0
1	618434	.	C	T	31	33	64	0	3	67	0	0
1	618760	.	C	T	3	8	11	0	20	31	0	0
1	618776	.	C	A	11	23	34	0	1	35	0	0
1	618826	.	C	T	13	9	22	0	2	24	0	0
1	618918	.	A	T	14	44	58	0	1	59	0	0
1	618932	.	A	G	12	44	56	0	3	59	0	0
1	619679	.	T	A	15	8	23	0	1	24	0	0
1	619703	.	C	T	2	15	17	0	14	31	0	0
1	619764	.	C	T	21	9	30	0	1	31	0	0
1	620244	.	A	T	33	19	52	0	5	57	0	0
1	620314	.	G	A	24	28	52	0	1	53	0	0
1	620516	.	A	T	18	35	53	1	1	55	0	0
1	620517	.	T	G	17	35	52	1	2	55	0	0
1	621027	.	C	T	1	27	28	0	19	47	0	0
1	621063	.	T	A	9	32	41	0	1	42	0	0
1	621069	.	G	A	10	31	41	0	0	41	0	0
1	621102	.	A	T	26	13	39	0	1	40	0	0
1	621141	.	T	A	11	21	32	0	0	32	0	0
1	621283	.	C	T	0	26	26	0	17	43	0	0
1	621336	.	G	A	12	33	45	0	3	48	0	0
1	621389	.	C	T	27	25	52	0	1	53	0	0
1	621440	.	C	T	17	13	30	0	1	31	0	0
1	626601	.	G	A	22	25	47	0	5	52	0	0
1	629610	.	G	A	0	2	2	0	0	2	0	0
1	629619	.	A	G	0	2	2	0	0	2	0	0
1	634882	.	T	C	16	12	28	0	1	29	0	0
1	634933	.	T	C	12	9	21	0	1	24	2	0
1	638431	.	C	T	0	4	4	0	0	4	0	0
1	692224	.	C	T	0	2	2	0	1	3	0	0
1	2217661	.	T	A	10	0	10	0	10	25	5	0
1	5273659	.	G	A	2	3	5	0	0	5	0	0
1	5273712	.	A	T	1	2	3	0	0	3	0	0
1	5275892	.	G	A	5	2	7	0	0	7	0	0
1	5276189	.	G	A	4	3	7	0	0	8	1	0
1	5276257	.	T	C	5	6	11	0	0	11	0	0
1	5276343	.	G	A	3	2	5	0	0	5	0	0
1	5354765	.	C	A	16	25	41	0	2	43	0	0
1	5354768	.	A	G	17	21	38	0	4	42	0	0
1	5354929	.	T	C	15	23	38	0	3	41	0	0
1	5355024	.	G	T	31	13	44	0	0	44	0	0
1	5355334	.	G	A	23	29	52	0	5	57	0	0
1	5355435	.	C	T	2	14	16	0	20	36	0	0
1	5355514	.	G	A	33	26	59	0	2	61	0	0
1	5355707	.	T	A	23	34	57	0	2	59	0	0
1	5355804	.	C	T	2	20	22	0	26	48	0	0
1	5356001	.	C	A	20	22	42	0	1	43	0	0
1	5356002	.	A	C	20	0	20	0	23	43	0	0
1	5356075	.	A	T	20	16	36	0	1	37	0	0
1	5356087	.	C	T	20	16	36	0	1	37	0	0
1	5356268	.	T	G	14	10	24	12	0	36	0	0
1	5356455	.	T	G	18	10	28	0	2	30	0	0
1	5356497	.	C	A	13	16	29	0	0	29	0	0
1	5356499	.	G	T	13	16	29	0	0	29	0	0
1	5356667	.	A	T	15	11	26	0	0	26	0	0
1	5356681	.	T	C	21	0	21	0	11	32	0	0
1	5357405	.	T	C	9	17	26	0	0	26	0	0
1	5357528	.	C	G	17	6	23	0	2	25	0	0
1	5357541	.	T	C	11	10	21	0	6	27	0	0
1	5357630	.	T	C	21	5	26	0	2	28	0	0
1	5357742	.	C	A	18	14	32	0	0	32	0	0
1	5357772	.	C	G	13	13	26	2	0	28	0	0
1	5357845	.	C	A	16	16	32	1	1	34	0	0
1	5358265	.	C	T	2	16	18	0	14	32	0	0
1	5358448	.	A	G	12	11	23	0	1	24	0	0
1	5358480	.	G	T	14	10	24	0	1	25	0	0
1	5358528	.	T	C	5	10	15	0	0	15	0	0
1	5358531	.	A	C	5	10	15	0	0	15	0	0
1	5358792	.	C	A	20	10	30	0	0	30	0	0
1	5375285	.	C	T	3	5	8	0	0	8	0	0
1	5378957	.	T	G	3	7	10	0	0	10	0	0
1	5402605	.	T	A	6	10	16	0	1	17	0	0
1	5414300	.	T	C	4	3	7	0	0	7	0	0
1	5414327	.	C	T	8	5	13	0	0	13	0	0
1	5415859	.	T	C	3	2	5	0	0	5	0	0
1	5415970	.	C	G	3	4	7	0	0	7	0	0
1	5418692	.	C	T	12	15	27	0	0	27	0	0
1	5418971	.	A	T	20	19	39	0	0	39	0	0
1	5419043	.	G	T	4	6	10	0	0	10	0	0
1	5422518	.	G	T	0	1	1	0	0	1	0	0
1	5425428	.	G	C	0	2	2	0	1	3	0	0
1	5430806	.	G	A	3	1	4	0	0	4	0	0
1	5430819	.	C	A	2	1	3	0	0	3	0	0
1	5433554	.	C	T	3	1	4	0	0	4	0	0
1	5433709	.	C	T	9	6	15	0	0	15	0	0
1	5433712	.	T	C	9	6	15	0	0	15	0	0
1	5433890	.	T	C	4	2	6	0	0	6	0	0
1	5503722	.	G	T	2	2	4	0	0	4	0	0
1	5503809	.	T	C	0	2	2	0	1	3	0	0
1	5503898	.	C	A	2	1	3	0	0	3	0	0
1	5503961	.	A	T	1	3	4	0	2	6	0	0
1	5507533	.	G	A	1	0	1	0	0	1	0	0
1	5586908	.	G	C	0	1	1	0	0	1	0	0
1	5681131	.	A	G	4	2	6	0	0	6	0	0
1	6166479	.	G	T	0	3	3	0	5	8	0	0
1	6210567	.	C	T	3	5	8	0	0	8	0	0
1	6226084	.	A	G	1	1	2	0	0	2	0	0
1	6226388	.	A	G	4	0	4	0	3	7	0	0
1	6236844	.	A	G	4	0	4	0	2	6	0	0
1	6238639	.	C	T	3	2	5	0	0	5	0	0
1	6241379	.	G	T	0	3	3	0	2	5	0	0
1	6241427	.	T	G	2	1	3	0	0	3	0	0
1	6243549	.	A	G	0	0	0	0	1	1	0	0
1	6243620	.	T	C	5	4	9	0	0	9	0	0
1	6243626	.	A	C	3	4	7	0	1	8	0	0
1	6243962	.	C	T	1	1	2	0	1	3	0	0
1	6243975	.	T	G	2	2	4	0	0	4	0	0
1	6244279	.	A	T	0	2	2	0	0	2	0	0
1	6244281	.	G	C	0	2	2	0	0	2	0	0
1	6247104	.	C	T	2	1	3	0	0	3	0	0
1	6248059	.	C	T	1	2	3	0	0	3	0	0
1	6252869	.	A	G	1	0	1	0	5	6	0	0
1	6252887	.	T	C	1	2	3	0	1	4	0	0
1	6262918	.	C	T	1	0	1	0	0	1	0	0
1	6264973	.	C	A	3	3	6	0	0	6	0	0
1	6266294	.	C	T	1	5	6	0	0	6	0	0
1	6359952	.	G	A	1	0	1	0	0	1	0	0
1	6365673	.	A	G	7	2	9	0	0	9	0	0
1	6365711	.	T	G	2	5	7	0	0	7	0	0
1	6366000	.	T	A	1	2	3	0	1	4	0	0
1	6366024	.	A	C	1	3	4	0	1	5	0	0
1	6404145	.	G	C	3	5	8	0	0	8	0	0
1	6404205	.	A	T	4	7	11	0	0	11	0	0
1	6404250	.	G	A	1	8	9	0	0	9	0	0
1	6404659	.	G	A	3	2	5	0	0	5	0	0
1	6429260	.	C	T	0	1	1	0	1	2	0	0
1	6494126	.	A	G	1	2	3	0	0	3	0	0
1	6494181	.	G	A	1	3	4	0	0	4	0	0
1	6924578	.	C	T	2	4	6	0	0	6	0	0
1	6924858	.	G	C	2	4	6	0	1	7	0	0
1	7518644	.	C	T	6	10	16	0	0	16	0	0
1	7523258	.	A	C	1	0	1	0	0	1	0	0
1	7523264	.	C	T	3	1	4	0	0	4	0	0
1	7526839	.	G	A	6	3	9	0	0	9	0	0
1	7528289	.	G	C	1	13	14	0	29	43	0	0
1	7530123	.	C	T	0	2	2	0	0	2	0	0
1	7538822	.	C	T	8	14	22	0	0	22	0	0
1	7538971	.	T	C	20	22	42	0	0	42	0	0
1	7539000	.	C	A	16	16	32	0	7	39	0	0
1	7539053	.	G	C	19	17	36	0	1	37	0	0
1	7539074	.	A	C	17	14	31	0	3	34	0	0
1	7539531	.	G	A	8	8	16	0	2	18	0	0
1	7539616	.	T	A	10	9	19	0	0	19	0	0
1	7554068	.	T	C	3	3	6	0	2	8	0	0
1	7560705	.	T	A	15	10	25	0	2	27	0	0
1	7662275	.	T	C	10	17	27	0	4	31	0	0
1	7662628	.	G	A	21	14	35	0	1	36	0	0
1	7662880	.	A	T	15	8	23	0	1	25	1	0
1	7662949	.	C	T	19	20	39	0	1	40	0	0
1	7668211	.	A	G	7	19	26	0	0	26	0	0
1	7668298	.	C	T	9	18	27	0	0	27	0	0
1	7673070	.	C	T	14	12	26	0	1	27	0	0
1	7673129	.	C	A	7	18	25	0	0	25	0	0
1	7682912	.	A	C	6	6	12	0	3	15	0	0
1	7682923	.	A	G	8	6	14	0	2	16	0	0
1	7682949	.	G	A	4	9	13	0	1	14	0	0
1	7853375	.	T	G	6	7	13	0	0	13	0	0
1	7853399	.	G	A	6	5	11	0	1	12	0	0
1	7853465	.	C	A	6	1	7	0	0	7	0	0
1	7859852	.	G	A	0	1	1	0	1	2	0	0
1	7864780	.	A	G	1	3	4	0	0	4	0	0
1	7875073	.	C	T	0	5	5	0	2	7	0	0
1	7889423	.	G	T	0	2	2	0	0	2	0	0
1	7889426	.	A	G	1	1	2	0	0	2	0	0
1	8022503	.	T	A	13	9	22	0	0	22	0	0
1	8022505	.	T	C	13	9	22	0	0	22	0	0
1	8022817	.	T	A	15	11	26	0	8	34	0	0
1	8023471	.	A	T	5	11	16	0	1	17	0	0
1	8023490	.	A	C	6	10	16	0	1	17	0	0
1	8023559	.	A	T	12	11	23	0	3	27	1	0
1	8023587	.	A	G	10	15	25	0	0	25	0	0
1	8023639	.	C	A	11	12	23	0	1	24	0	0
1	8023658	.	A	T	15	6	21	0	0	21	0	0
1	8023730	.	C	T	12	13	25	0	1	26	0	0
1	8026148	.	T	G	11	15	26	0	1	27	0	0
1	8026404	.	T	A	18	12	30	0	2	32	0	0
1	8026415	.	C	T	0	16	16	0	13	29	0	0
1	8026478	.	T	C	18	0	18	0	11	29	0	0
1	8026975	.	T	C	8	4	12	0	1	13	0	0
1	8028177	.	T	A	7	15	22	0	0	22	0	0
1	8028696	.	G	T	8	14	22	0	2	24	0	0
1	8028912	.	G	C	7	13	20	0	0	20	0	0
1	8028925	.	C	A	9	6	15	0	0	15	0	0
1	8028979	.	G	A	3	3	6	0	0	6	0	0
1	8029002	.	T	A	3	5	8	0	0	8	0	0
1	8030418	.	T	C	1	4	5	0	0	5	0	0
1	8032956	.	G	C	2	2	4	0	1	5	0	0
1	8032986	.	A	G	0	1	1	0	0	1	0	0
1	8049495	.	C	T	0	4	4	0	1	5	0	0
1	8051513	.	G	A	4	3	7	0	0	7	0	0
1	8051528	.	C	T	0	3	3	0	4	7	0	0
1	8055927	.	T	C	2	0	2	0	2	4	0	0
1	8131002	.	A	G	0	2	2	0	0	2	0	0
1	8165609	.	C	T	6	10	16	0	0	16	0	0
1	8165802	.	C	T	3	5	8	0	1	9	0	0
1	8165937	.	G	A	6	8	14	0	0	14	0	0
1	8165947	.	C	T	5	7	12	0	0	12	0	0
1	8166788	.	A	T	8	14	22	0	0	22	0	0
1	8166992	.	A	G	7	4	11	0	1	12	0	0
1	8167319	.	A	G	3	6	9	0	0	9	0	0
1	8167383	.	G	A	5	8	13	0	1	14	0	0
1	8167526	.	C	T	11	11	22	0	0	22	0	0
1	8167668	.	G	A	7	11	18	0	0	18	0	0
1	8169262	.	C	T	0	1	1	0	0	1	0	0
1	8169268	.	C	T	0	1	1	0	0	1	0	0
1	8169361	.	G	A	5	3	8	0	0	8	0	0
1	8189518	.	G	T	1	1	2	0	0	2	0	0
1	8192102	.	G	A	1	3	4	0	0	4	0	0
1	8367414	.	C	A	1	2	3	0	0	3	0	0
1	8401250	.	A	T	0	0	0	0	1	1	0	0
1	8403299	.	G	A	0	2	2	0	2	4	0	0
1	8403438	.	A	C	1	6	7	0	0	7	0	0
1	8417896	.	T	C	18	24	42	0	1	43	0	0
1	8418058	.	T	A	13	10	23	0	0	23	0	0
1	8422521	.	A	G	17	12	29	0	0	29	0	0
1	8424735	.	G	A	13	23	36	0	0	36	0	0
1	8527007	.	G	A	1	2	3	0	0	3	0	0
1	8527205	.	G	T	1	0	1	0	0	1	0	0
1	8531343	.	G	A	3	2	5	0	1	6	0	0
1	8531505	.	T	C	1	6	7	0	0	7	0	0
1	8544483	.	G	A	0	1	1	0	0	1	0	0
1	8557075	.	G	A	4	3	7	0	0	7	0	0
1	8560237	.	C	T	1	3	4	0	0	4	0	0
1	8560266	.	C	T	1	3	4	0	0	4	0	0
1	8562005	.	G	C	2	1	3	0	0	3	0	0
1	8563792	.	G	A	1	5	6	0	0	6	0	0
1	8566188	.	T	G	2	2	4	0	0	4	0	0
1	8566467	.	G	A	2	2	4	0	0	4	0	0
1	8566485	.	T	C	5	3	8	0	0	8	0	0
1	8604175	.	C	T	6	3	9	0	0	9	0	0
1	8606561	.	C	T	1	3	4	0	0	4	0	0
1	8606632	.	C	T	5	6	11	0	2	13	0	0
1	8606767	.	G	A	2	3	5	0	0	5	0	0
1	8607547	.	C	T	4	5	9	0	0	9	0	0
1	8607556	.	T	C	2	4	6	0	0	6	0	0
1	8608300	.	C	T	12	7	19	0	0	19	0	0
1	8638537	.	T	G	3	9	12	0	0	12	0	0
1	8639877	.	G	A	2	1	3	0	0	3	0	0
1	8642800	.	C	T	2	6	8	0	1	9	0	0
1	8642824	.	A	T	3	4	7	0	0	7	0	0
1	8642938	.	A	G	2	8	10	0	0	10	0	0
1	8642953	.	C	T	2	9	11	0	0	11	0	0
1	8643112	.	G	C	3	2	5	0	0	5	0	0
1	8644000	.	G	A	2	2	4	0	0	4	0	0
1	8646164	.	T	A	1	2	3	0	0	3	0	0
1	8649726	.	A	G	9	12	21	0	1	22	0	0
1	8649865	.	C	T	23	12	35	0	1	36	0	0
1	8649988	.	A	G	8	12	20	0	1	21	0	0
1	8649994	.	A	T	7	10	17	0	1	18	0	0
1	8650317	.	G	A	27	23	50	0	2	52	0	0
1	8650371	.	C	T	32	26	58	0	4	62	0	0
1	8651036	.	G	A	25	16	41	0	2	43	0	0
1	8651060	.	T	C	13	12	25	0	1	26	0	0
1	8651576	.	G	A	17	16	33	0	1	34	0	0
1	8662553	.	G	A	15	21	36	0	0	36	0	0
1	8663048	.	G	A	0	15	15	0	18	33	0	0
1	8663195	.	T	G	17	13	30	0	1	31	0	0
1	8663295	.	T	C	17	14	31	0	3	34	0	0
1	8667377	.	G	A	9	5	14	0	1	15	0	0
1	8667606	.	C	T	14	14	28	0	3	31	0	0
1	8668166	.	T	C	26	21	47	0	2	49	0	0
1	8668238	.	G	T	22	17	39	0	1	40	0	0
1	8668452	.	C	A	13	5	18	0	1	19	0	0
1	8668532	.	C	A	9	5	14	1	0	15	0	0
1	8669325	.	G	A	0	2	2	0	2	4	0	0
1	8669543	.	A	G	10	5	15	0	0	15	0	0
1	8669669	.	A	G	12	7	19	0	1	20	0	0
1	8669673	.	A	G	16	4	20	0	0	20	0	0
1	8669717	.	T	G	15	17	32	0	2	34	0	0
1	8669718	.	T	C	16	18	34	0	0	34	0	0
1	8669753	.	T	A	19	18	37	0	0	37	0	0
1	8669847	.	G	T	28	18	46	0	2	48	0	0
1	8670031	.	T	C	20	31	51	0	2	53	0	0
1	8670032	.	G	T	1	20	21	0	32	53	0	0
1	8670402	.	G	A	22	18	40	0	1	41	0	0
1	8670460	.	A	G	4	5	9	0	0	9	0	0
1	8694404	.	G	A	8	9	17	0	3	20	0	0
1	8698765	.	T	C	16	20	36	0	3	39	0	0
1	8698799	.	C	T	15	14	29	0	1	30	0	0
1	8698834	.	T	A	8	9	17	0	0	17	0	0
1	8701548	.	A	G	18	1	19	0	19	38	0	0
1	8701623	.	C	T	23	22	45	0	3	48	0	0
1	8701747	.	G	A	16	13	29	1	0	30	0	0
1	8702158	.	G	A	18	6	24	0	0	24	0	0
1	8702325	.	G	T	20	24	44	0	0	44	0	0
1	8763824	.	A	G	7	7	14	0	0	14	0	0
1	8763832	.	A	C	7	0	7	0	6	13	0	0
1	8764123	.	C	T	2	10	12	0	1	13	0	0
1	8764612	.	T	C	9	0	9	0	8	17	0	0
1	8764661	.	T	A	11	9	20	0	2	22	0	0
1	8764729	.	C	T	14	11	25	0	0	25	0	0
1	8764760	.	G	A	15	9	24	0	0	24	0	0
1	8764811	.	C	T	0	7	7	0	6	13	0	0
1	8764812	.	G	A	6	7	13	0	0	13	0	0
1	8765315	.	A	G	20	21	41	0	2	43	0	0
1	8765422	.	G	A	13	14	27	0	1	28	0	0
1	8765713	.	A	C	19	21	40	0	0	40	0	0
1	8765724	.	A	G	20	22	42	0	1	43	0	0
1	8766267	.	T	C	7	0	7	0	16	23	0	0
1	8766453	.	C	T	20	12	32	0	3	35	0	0
1	8766471	.	C	T	0	12	12	0	19	31	0	0
1	8766501	.	C	T	11	13	24	0	0	24	0	0
1	8766693	.	G	A	4	9	13	0	1	14	0	0
1	8767002	.	C	T	10	5	15	0	2	17	0	0
1	8767080	.	G	A	19	7	26	0	1	27	0	0
1	8767155	.	C	T	10	7	17	0	2	19	0	0
1	8767185	.	T	C	10	11	21	0	0	21	0	0
1	8767260	.	T	C	8	7	15	0	2	17	0	0
1	8767395	.	A	G	5	5	10	0	0	10	0	0
1	8767536	.	T	C	3	0	3	0	9	12	0	0
1	8767629	.	G	A	6	3	9	0	0	9	0	0
1	8767725	.	T	C	4	5	9	0	0	9	0	0
1	8768307	.	A	G	6	7	13	0	0	13	0	0
1	8770773	.	G	A	2	0	2	0	0	2	0	0
1	8771020	.	T	G	1	5	6	0	0	6	0	0
1	8773269	.	T	C	5	8	13	0	0	13	0	0
1	8773320	.	G	A	1	9	10	0	0	10	0	0
1	8773383	.	A	G	0	2	2	0	0	2	0	0
1	8776497	.	A	G	2	2	4	0	0	4	0	0
1	8810701	.	T	G	4	4	8	0	1	9	0	0
1	8917623	.	C	T	5	4	9	0	1	10	0	0
1	8974695	.	A	T	2	6	8	0	0	8	0	0
1	8975415	.	T	C	1	4	5	0	0	5	0	0
1	9004942	.	T	C	7	11	18	0	0	18	0	0
1	9044745	.	C	T	4	7	11	0	1	12	0	0
1	9051092	.	T	C	3	4	7	0	0	7	0	0
1	9056045	.	T	G	2	3	5	0	0	5	0	0
1	9056886	.	T	C	8	12	20	0	0	20	0	0
1	9064791	.	C	A	5	8	13	0	0	13	0	0
1	9064864	.	T	C	4	5	9	0	0	9	0	0
1	9064885	.	C	A	4	4	8	0	1	9	0	0
1	9074440	.	T	C	13	20	33	0	0	33	0	0
1	9118497	.	T	A	10	8	18	0	1	20	1	0
1	9123262	.	A	G	4	4	8	0	1	9	0	0
1	9145260	.	C	T	2	3	5	0	0	5	0	0
1	9145541	.	T	C	1	5	6	0	0	6	0	0
1	9262077	.	A	G	6	12	18	0	0	19	1	0
1	9262080	.	A	G	7	12	19	0	1	20	0	0
1	9265578	.	T	C	2	1	3	0	0	3	0	0
1	9270198	.	T	C	1	1	2	0	0	2	0	0
1	9273347	.	A	G	0	3	3	0	1	4	0	0
1	9273947	.	G	C	3	0	3	0	0	3	0	0
1	9276360	.	T	C	0	0	0	0	5	5	0	0
1	9276420	.	C	T	0	4	4	0	0	4	0	0
1	9277858	.	T	C	8	8	16	0	1	17	0	0
1	9278150	.	G	A	2	4	6	0	1	7	0	0
1	9290500	.	G	T	0	3	3	0	1	4	0	0
1	9293041	.	C	T	10	7	17	0	0	17	0	0
1	9293117	.	G	A	0	10	10	0	6	16	0	0
1	9293156	.	G	A	9	7	16	0	0	16	0	0
1	9293215	.	G	A	9	5	14	0	1	15	0	0
1	9293495	.	A	G	8	11	19	0	1	20	0	0
1	9293580	.	C	T	8	9	17	0	0	17	0	0
1	9293740	.	T	C	6	6	12	0	1	13	0	0
1	9293889	.	C	A	1	4	5	0	0	5	0	0
1	9499764	.	C	T	13	7	20	0	4	24	0	0
1	9500312	.	A	T	2	7	9	0	2	11	0	0
1	9500757	.	A	T	3	2	5	0	2	7	0	0
1	9500835	.	A	G	4	7	11	0	1	12	0	0
1	9500944	.	T	C	9	3	12	0	0	12	0	0
1	9500947	.	G	T	6	5	11	0	0	11	0	0
1	9501011	.	T	C	5	2	7	0	0	7	0	0
1	9501031	.	C	T	3	3	6	0	0	6	0	0
1	9501229	.	C	T	7	16	23	0	1	24	0	0
1	9501231	.	G	A	15	8	23	0	0	23	0	0
1	9501365	.	T	C	12	1	13	0	12	25	0	0
1	9501394	.	T	A	10	7	17	0	0	17	0	0
1	9508752	.	T	A	5	16	21	0	1	22	0	0
1	9510571	.	A	G	2	0	2	0	0	2	0	0
1	9510574	.	G	A	2	0	2	0	0	2	0	0
1	9512342	.	C	T	1	1	2	0	1	3	0	0
1	9516905	.	A	C	1	1	2	0	1	3	0	0
1	9527076	.	T	A	2	4	6	0	0	6	0	0
1	9527108	.	T	C	3	2	5	0	0	5	0	0
1	9527119	.	T	C	2	0	2	0	2	4	0	0
1	9557456	.	T	C	0	0	0	0	1	1	0	0
1	9708660	.	T	A	3	3	6	0	0	6	0	0
1	9709280	.	G	A	5	3	8	0	0	8	0	0
1	9709340	.	C	T	3	2	5	0	0	5	0	0
1	9709500	.	G	A	0	2	2	0	1	3	0	0
1	9710759	.	C	T	4	4	8	0	0	8	0	0
1	9710853	.	T	C	5	3	8	0	0	8	0	0
1	9711158	.	G	A	3	3	6	0	0	6	0	0
1	9711161	.	G	A	3	3	6	0	0	6	0	0
1	9711405	.	T	A	2	4	6	0	0	6	0	0
1	9711593	.	A	C	5	2	7	0	0	7	0	0
1	9711956	.	A	G	5	4	9	0	0	9	0	0
1	9712111	.	G	A	1	6	7	0	4	11	0	0
1	9712253	.	T	A	3	2	5	0	0	5	0	0
1	9712266	.	G	T	1	1	2	0	0	2	0	0
1	9793219	.	C	T	2	1	3	0	1	4	0	0
1	9793220	.	T	C	2	2	4	0	0	4	0	0
1	9793286	.	C	T	2	3	5	0	0	5	0	0
1	9808324	.	A	G	3	2	5	0	0	5	0	0
1	9808345	.	T	A	3	2	5	0	0	5	0	0
1	9808365	.	C	T	3	2	5	0	0	5	0	0
1	9866852	.	G	A	1	2	3	0	0	3	0	0
1	9873485	.	G	A	3	5	8	0	0	8	0	0
1	9873509	.	G	A	4	5	9	0	0	9	0	0
1	9873538	.	G	A	4	4	8	0	0	8	0	0
1	9873607	.	A	T	1	6	7	0	6	13	0	0
1	9873616	.	T	C	5	0	5	0	12	17	0	0
1	9873787	.	G	A	4	3	7	0	0	7	0	0
1	9877576	.	C	T	0	1	1	0	0	1	0	0
1	9880387	.	A	G	2	4	6	0	1	7	0	0
1	9883339	.	T	C	0	1	1	0	0	1	0	0
1	9914164	.	C	T	2	1	3	0	0	3	0	0
1	10033032	.	A	T	9	4	13	0	0	13	0	0
1	10667856	.	A	G	2	2	4	0	0	4	0	0
1	10667879	.	G	A	2	2	4	0	0	4	0	0
1	10675585	.	A	T	2	0	2	0	0	2	0	0
1	10680561	.	G	C	2	0	2	0	3	5	0	0
1	10683868	.	A	T	13	9	22	0	0	22	0	0
1	10683955	.	A	G	12	16	28	0	0	28	0	0
1	10683974	.	A	C	13	23	36	0	1	37	0	0
1	10684037	.	A	G	18	2	20	0	14	34	0	0
1	10684105	.	G	A	2	13	15	0	11	26	0	0
1	10688731	.	T	G	2	0	2	0	3	5	0	0
1	10692078	.	T	C	11	5	16	0	0	16	0	0
1	10692090	.	G	A	7	4	11	0	1	12	0	0
1	10696587	.	C	T	10	7	17	0	0	17	0	0
1	10736181	.	G	A	12	7	19	0	0	19	0	0
1	10738176	.	A	G	24	10	34	0	0	34	0	0
1	10738177	.	A	G	24	9	33	0	1	34	0	0
1	10738509	.	T	C	29	29	58	0	0	58	0	0
1	10738535	.	G	A	27	31	58	0	1	59	0	0
1	10738568	.	A	G	24	1	25	0	37	62	0	0
1	10738863	.	C	A	20	38	58	0	6	64	0	0
1	10841254	.	T	C	9	12	21	0	0	21	0	0
1	10841275	.	T	C	10	7	17	0	0	17	0	0
1	10841356	.	G	A	1	4	5	0	0	5	0	0
1	10885173	.	A	C	1	2	3	0	0	3	0	0
1	10885266	.	T	A	3	6	9	0	0	9	0	0
1	10897373	.	A	G	3	2	5	0	0	5	0	0
1	11124918	.	C	T	0	4	4	0	4	8	0	0
1	11125074	.	T	A	1	2	3	0	0	3	0	0
1	11125149	.	C	T	0	5	5	0	4	9	0	0
1	11125177	.	C	T	2	4	6	0	1	7	0	0
1	11125195	.	C	T	2	7	9	0	0	9	0	0
1	11127938	.	G	A	11	2	13	0	0	13	0	0
1	11128515	.	C	A	0	1	1	0	1	2	0	0
1	11130713	.	G	A	1	2	3	0	1	4	0	0
1	11132905	.	C	T	0	3	3	0	2	5	0	0
1	11139245	.	C	G	2	3	5	0	0	5	0	0
1	11141082	.	C	T	1	0	1	0	0	1	0	0
1	11150984	.	G	A	0	2	2	0	0	2	0	0
1	11157060	.	T	C	0	1	1	0	0	1	0	0
1	11180740	.	C	T	0	2	2	0	0	2	0	0
1	11275073	.	A	G	2	3	5	0	0	5	0	0
1	11670963	.	T	C	3	3	6	0	0	6	0	0
1	11671059	.	A	G	7	5	12	0	0	12	0	0
1	11671527	.	G	A	7	2	9	0	2	11	0	0
1	11671580	.	C	T	4	3	7	0	0	7	0	0
1	11783388	.	T	C	11	20	31	0	1	32	0	0
1	11783410	.	T	C	17	12	29	0	0	29	0	0
1	11783650	.	T	C	28	19	47	0	2	49	0	0
1	11784522	.	T	C	30	15	45	0	3	48	0	0
1	11784609	.	T	C	27	9	36	0	0	36	0	0
1	11784679	.	T	C	14	23	37	0	3	40	0	0
1	15254249	.	A	G	11	1	12	0	5	17	0	0
1	17523030	.	A	G	12	0	12	0	14	26	0	0
1	17535021	.	G	A	0	10	10	0	0	10	0	0
1	17535858	.	A	G	5	0	5	0	3	8	0	0
1	17535859	.	A	G	4	3	7	0	1	8	0	0
1	17538085	.	T	C	2	0	2	0	5	7	0	0
1	18780360	.	T	A	0	2	2	0	1	3	0	0
1	19188751	.	G	A	1	0	1	0	0	1	0	0
1	19866347	.	C	T	0	1	1	0	0	1	0	0
1	19874550	.	G	A	1	0	1	0	1	2	0	0
1	19882538	.	C	A	1	1	2	0	0	2	0	0
1	19886159	.	A	C	3	2	5	0	0	5	0	0
1	19936259	.	G	T	0	3	3	0	6	9	0	0
1	19936298	.	G	A	4	2	6	0	1	7	0	0
1	19936358	.	T	C	2	5	7	0	0	7	0	0
1	19936418	.	T	A	6	6	12	0	0	12	0	0
1	19936682	.	C	T	4	5	9	0	1	10	0	0
1	19937090	.	A	G	4	0	4	0	9	13	0	0
1	19950478	.	A	T	7	6	13	0	2	15	0	0
1	19955706	.	C	T	0	1	1	0	0	1	0	0
1	19966416	.	C	T	9	5	14	0	1	15	0	0
1	19978049	.	A	G	5	0	5	0	4	9	0	0
1	19984448	.	C	T	4	2	6	0	0	6	0	0
1	19988952	.	C	G	11	12	23	0	0	23	0	0
1	19989008	.	T	G	9	12	21	0	1	22	0	0
1	19989023	.	G	A	0	12	12	0	10	22	0	0
1	20063678	.	A	G	1	2	3	0	0	3	0	0
1	20063843	.	C	A	0	2	2	0	1	3	0	0
1	20065156	.	A	G	2	3	5	0	0	5	0	0
1	20092616	.	T	A	3	1	4	0	2	6	0	0
1	20094234	.	G	A	2	0	2	0	0	2	0	0
1	20094327	.	G	T	0	3	3	0	0	3	0	0
1	20117629	.	T	C	2	4	6	0	0	6	0	0
1	20129562	.	C	T	5	2	7	0	0	7	0	0
1	20129652	.	T	C	3	4	7	0	0	7	0	0
1	20138674	.	C	A	3	4	7	0	1	8	0	0
1	20138713	.	A	C	5	4	9	0	2	11	0	0
1	20138901	.	A	G	5	2	7	0	0	7	0	0
1	20139187	.	A	C	7	1	8	0	2	10	0	0
1	20139551	.	G	A	2	1	3	0	0	3	0	0
1	20139566	.	A	G	2	3	5	0	0	5	0	0
1	20139815	.	T	C	8	4	12	0	0	12	0	0
1	20139962	.	A	T	15	6	21	0	1	22	0	0
1	20140042	.	G	T	0	8	8	0	8	16	0	0
1	20140048	.	A	T	8	7	15	0	0	15	0	0
1	20140120	.	C	T	9	3	12	0	1	13	0	0
1	20140200	.	C	T	8	1	9	0	2	11	0	0
1	20140363	.	T	G	5	4	9	0	0	9	0	0
1	20140951	.	G	A	0	12	12	0	13	25	0	0
1	20140952	.	G	A	12	13	25	0	1	26	0	0
1	20141070	.	C	A	10	5	15	0	2	17	0	0
1	20141106	.	A	G	8	11	19	0	1	20	0	0
1	20141218	.	T	G	7	4	11	0	0	11	0	0
1	20141232	.	T	A	9	6	15	0	0	15	0	0
1	20141253	.	G	A	11	12	23	0	2	25	0	0
1	20141310	.	G	A	14	22	36	0	1	37	0	0
1	20141378	.	C	G	8	1	9	0	23	32	0	0
1	20141411	.	A	T	10	15	25	0	0	25	0	0
1	20141611	.	T	C	7	5	12	1	0	13	0	0
1	20141661	.	A	C	11	13	24	0	0	25	1	0
1	20147248	.	T	A	11	6	17	0	1	18	0	0
1	20160882	.	T	A	6	8	14	0	0	14	0	0
1	20166536	.	C	A	12	7	19	0	1	20	0	0
1	20166600	.	A	G	4	5	9	0	0	9	0	0
1	20173954	.	A	G	5	3	8	0	0	8	0	0
1	20194118	.	C	T	7	4	11	0	1	12	0	0
1	20212239	.	G	A	3	4	7	0	0	7	0	0
1	20212284	.	C	T	6	6	12	0	0	12	0	0
1	20212362	.	G	A	0	2	2	0	0	2	0	0
1	20221498	.	G	A	1	3	4	0	0	4	0	0
1	20270080	.	G	A	2	2	4	0	1	5	0	0
1	20270486	.	A	T	2	3	5	0	2	7	0	0
1	20270779	.	G	A	11	5	16	0	1	17	0	0
1	20557447	.	G	A	20	15	35	0	1	36	0	0
1	20557625	.	A	C	4	0	4	0	11	15	0	0
1	20557650	.	C	T	5	11	16	0	0	16	0	0
1	20557938	.	C	T	3	2	5	0	0	5	0	0
1	20558594	.	C	A	0	2	2	0	1	3	0	0
1	20559093	.	A	G	3	2	5	0	0	5	0	0
1	20559321	.	T	C	3	1	4	0	3	7	0	0
1	20559324	.	T	A	3	4	7	0	0	7	0	0
1	20559538	.	G	A	2	4	6	0	2	8	0	0
1	20559830	.	G	A	2	2	4	0	0	4	0	0
1	20581101	.	A	G	1	1	2	0	0	2	0	0
1	20581502	.	A	G	1	2	3	0	0	3	0	0
1	20678674	.	G	C	12	6	18	0	0	18	0	0
1	20694916	.	G	A	0	9	9	0	7	16	0	0
1	20694955	.	A	G	12	17	29	0	3	32	0	0
1	20695073	.	G	A	0	12	12	0	13	25	0	0
1	20700473	.	T	C	23	22	45	0	1	46	0	0
1	20700524	.	G	A	0	13	13	0	16	29	0	0
1	20704896	.	T	C	14	20	34	0	1	35	0	0
1	20705237	.	C	T	28	20	48	0	2	50	0	0
1	20705863	.	A	G	24	9	33	0	0	33	0	0
1	20733884	.	T	A	1	2	3	0	0	3	0	0
1	20866886	.	C	T	21	14	35	0	1	36	0	0
1	20866996	.	T	G	35	24	59	0	0	59	0	0
1	20867057	.	A	T	26	33	59	0	2	61	0	0
1	20867092	.	C	T	27	26	53	0	2	55	0	0
1	20867185	.	A	T	34	19	53	0	0	53	0	0
1	20867186	.	G	T	32	17	49	0	4	53	0	0
1	20867321	.	C	T	2	21	23	0	22	45	0	0
1	20867345	.	C	T	29	17	46	0	2	48	0	0
1	20867359	.	C	T	32	15	47	0	1	48	0	0
1	20867623	.	T	C	30	35	65	0	2	67	0	0
1	20867968	.	T	G	40	22	62	0	1	64	1	0
1	20868165	.	C	G	31	35	66	0	2	68	0	0
1	20868258	.	T	A	35	30	65	0	2	67	0	0
1	20868301	.	A	G	39	28	67	0	3	70	0	0
1	20868309	.	C	G	28	35	63	0	7	70	0	0
1	20868338	.	G	T	49	22	71	0	3	74	0	0
1	20868504	.	T	C	34	28	62	0	1	63	0	0
1	20868530	.	C	T	20	28	48	0	3	51	0	0
1	20868546	.	G	A	25	15	40	0	2	42	0	0
1	20868684	.	A	T	30	34	64	0	5	69	0	0
1	20868802	.	T	G	9	10	19	2	0	21	0	0
1	20868825	.	G	A	17	17	34	1	2	37	0	0
1	20868850	.	G	A	22	21	43	1	2	46	0	0
1	20868927	.	A	G	27	31	58	0	1	59	0	0
1	20868953	.	C	T	0	27	27	0	30	57	0	0
1	20869064	.	T	A	7	5	12	0	0	12	0	0
1	20870387	.	T	C	13	11	24	1	2	27	0	0
1	20870632	.	T	C	13	16	29	1	0	30	0	0
1	20870846	.	C	T	12	35	47	0	0	47	0	0
1	20871144	.	C	G	15	19	34	0	3	37	0	0
1	20886924	.	G	A	10	12	22	0	2	24	0	0
1	20886936	.	G	A	13	19	32	0	1	33	0	0
1	20910967	.	A	G	25	28	53	0	8	61	0	0
1	20911171	.	G	T	25	39	64	0	7	71	0	0
1	20916928	.	T	A	3	4	7	0	0	7	0	0
1	20925532	.	G	A	0	1	1	0	0	1	0	0
1	20925544	.	G	T	1	1	2	0	0	2	0	0
1	20932137	.	T	A	4	3	7	0	0	7	0	0
1	20932138	.	C	T	4	3	7	0	0	7	0	0
1	20941573	.	G	A	2	3	5	0	0	5	0	0
1	20946897	.	A	G	0	1	1	0	0	1	0	0
1	20959028	.	T	C	0	1	1	0	0	1	0	0
1	20970109	.	G	T	4	3	7	0	0	7	0	0
1	21138623	.	T	C	2	4	6	0	0	6	0	0
1	21139142	.	G	A	4	8	12	0	0	12	0	0
1	21139355	.	G	A	4	4	8	0	0	8	0	0
1	21139367	.	G	A	4	4	8	0	0	8	0	0
1	21139404	.	T	C	4	3	7	0	0	7	0	0
1	21139456	.	G	C	3	0	3	0	1	4	0	0
1	21141701	.	A	G	5	3	8	0	2	10	0	0
1	21141894	.	C	T	0	8	8	0	4	12	0	0
1	21146729	.	C	G	0	2	2	0	3	5	0	0
1	21159366	.	T	C	3	0	3	0	3	6	0	0
1	21309424	.	G	T	1	3	4	0	0	4	0	0
1	21309461	.	A	T	6	7	13	0	0	13	0	0
1	21312067	.	A	G	1	1	2	0	0	2	0	0
1	21312112	.	C	T	6	10	16	0	1	17	0	0
1	21313828	.	T	A	5	2	7	0	0	7	0	0
1	21313861	.	T	A	2	4	6	0	0	6	0	0
1	21333205	.	C	G	0	16	16	0	22	38	0	0
1	21333223	.	A	T	14	19	33	0	0	33	0	0
1	21333337	.	G	C	15	17	32	0	1	33	0	0
1	21341577	.	T	C	0	4	4	0	0	4	0	0
1	21344500	.	G	A	16	23	39	0	0	39	0	0
1	21344518	.	C	G	0	17	17	0	17	34	0	0
1	21346015	.	T	C	5	10	15	0	1	16	0	0
1	21368014	.	C	A	13	7	20	0	1	21	0	0
1	21368074	.	C	A	24	15	39	0	0	39	0	0
1	21368206	.	G	T	2	3	5	0	0	5	0	0
1	21423093	.	A	T	5	3	8	0	1	9	0	0
1	21423307	.	C	T	9	9	18	0	1	19	0	0
1	21423756	.	A	G	6	8	14	0	0	14	0	0
1	21423765	.	C	A	7	3	10	0	1	11	0	0
1	21449804	.	A	G	6	3	9	0	1	10	0	0
1	21483684	.	G	A	4	2	6	0	0	6	0	0
1	21500209	.	T	A	2	4	6	0	0	6	0	0
1	21500451	.	G	T	0	2	2	0	0	2	0	0
1	21513826	.	G	A	4	6	10	0	0	10	0	0
1	21514069	.	G	A	1	1	2	0	0	2	0	0
1	21515903	.	G	T	0	1	1	0	0	1	0	0
1	21532624	.	C	T	0	2	2	0	0	2	0	0
1	21610564	.	T	C	1	4	5	0	0	5	0	0
1	21611043	.	T	C	0	1	1	0	1	2	0	0
1	21611062	.	A	G	0	1	1	0	0	1	0	0
1	21612127	.	C	T	1	3	4	0	1	5	0	0
1	21612153	.	T	G	2	3	5	0	3	8	0	0
1	21612400	.	G	A	4	3	7	0	2	9	0	0
1	21612418	.	G	C	5	4	9	0	0	9	0	0
1	21944731	.	C	T	0	1	1	0	0	1	0	0
1	21954946	.	G	A	0	5	5	0	2	7	0	0
1	22236735	.	T	G	2	4	6	0	0	6	0	0
1	22236891	.	A	T	5	3	8	0	0	8	0	0
1	22236990	.	G	A	3	1	4	0	0	4	0	0
1	22388955	.	C	T	2	3	5	0	0	5	0	0
1	22389122	.	C	T	2	5	7	0	0	7	0	0
1	22389246	.	C	T	1	9	10	0	6	16	0	0
1	22389264	.	T	A	7	11	18	0	2	20	0	0
1	22389395	.	T	C	4	3	7	0	0	7	0	0
1	22412005	.	G	A	8	10	18	0	0	18	0	0
1	22484544	.	C	A	3	6	9	0	1	10	0	0
1	22490795	.	C	T	0	4	4	0	4	8	0	0
1	22511909	.	A	G	1	2	3	0	0	3	0	0
1	22511922	.	G	A	1	2	3	0	0	3	0	0
1	22542770	.	C	A	0	4	4	0	0	4	0	0
1	22542771	.	T	C	0	0	0	0	4	4	0	0
1	22647772	.	T	C	5	1	6	0	3	9	0	0
1	22648037	.	T	A	20	28	48	2	2	52	0	0
1	22648038	.	A	C	20	30	50	2	0	52	0	0
1	22651348	.	C	A	0	1	1	0	1	2	0	0
1	22651934	.	T	A	2	2	4	0	0	4	0	0
1	22652021	.	A	G	6	2	8	0	0	8	0	0
1	22652028	.	C	T	5	2	7	0	0	7	0	0
1	22664924	.	A	T	2	2	4	0	0	4	0	0
1	22713087	.	A	T	2	1	3	0	0	3	0	0
1	22713088	.	C	G	2	1	3	0	0	3	0	0
1	22713349	.	G	C	1	2	3	0	0	3	0	0
1	22713595	.	G	C	1	2	3	0	1	4	0	0
1	22713635	.	T	C	1	2	3	0	0	3	0	0
1	22770608	.	A	T	17	9	26	0	2	28	0	0
1	22770723	.	C	T	9	8	17	0	4	21	0	0
1	22770810	.	C	T	5	9	14	0	0	14	0	0
1	22771305	.	T	G	11	11	22	0	0	22	0	0
1	22771437	.	G	A	9	8	17	0	0	17	0	0
1	22771677	.	C	T	0	7	7	0	9	16	0	0
1	22771911	.	A	T	9	9	18	0	1	19	0	0
1	22771936	.	C	T	8	10	18	0	0	18	0	0
1	22771952	.	A	T	10	7	17	0	1	18	0	0
1	22772213	.	C	A	9	9	18	0	1	19	0	0
1	22772308	.	C	T	6	10	16	0	0	16	0	0
1	22772545	.	A	T	12	9	21	0	1	22	0	0
1	22772711	.	G	A	10	9	19	0	2	21	0	0
1	22777201	.	G	A	1	0	1	0	0	1	0	0
1	22805615	.	C	T	8	14	22	0	1	23	0	0
1	22805630	.	G	C	5	13	18	0	0	18	0	0
1	22805750	.	T	A	5	3	8	0	0	8	0	0
1	22805766	.	C	T	6	1	7	0	1	8	0	0
1	22805861	.	G	A	4	3	7	0	0	7	0	0
1	22805880	.	G	T	4	5	9	0	0	9	0	0
1	22805906	.	A	C	6	3	9	0	1	10	0	0
1	22805927	.	C	A	7	3	10	0	0	10	0	0
1	22806089	.	C	T	11	15	26	0	0	26	0	0
1	22806108	.	A	G	16	11	27	0	1	28	0	0
1	22806254	.	T	C	5	4	9	0	2	11	0	0
1	22806643	.	C	A	18	13	31	0	0	31	0	0
1	22806825	.	C	T	0	6	6	0	6	12	0	0
1	22806845	.	C	A	4	2	6	0	1	7	0	0
1	22806936	.	C	T	0	13	13	0	3	16	0	0
1	22806980	.	G	A	8	3	11	0	0	11	0	0
1	22807043	.	G	A	5	4	9	1	0	10	0	0
1	22807110	.	T	C	14	0	14	0	9	23	0	0
1	22807169	.	A	G	8	8	16	0	2	18	0	0
1	22807238	.	G	A	6	5	11	0	1	12	0	0
1	22807275	.	C	G	9	5	14	0	0	14	0	0
1	22807304	.	C	G	15	7	22	0	1	23	0	0
1	22807321	.	G	A	15	7	22	0	2	24	0	0
1	22807632	.	C	T	6	4	10	0	0	10	0	0
1	22807639	.	G	A	5	4	9	0	1	10	0	0
1	22807744	.	G	T	5	3	8	0	1	9	0	0
1	22808009	.	G	T	6	14	20	0	0	20	0	0
1	22808090	.	C	A	8	2	10	0	0	10	0	0
1	22808093	.	T	A	2	7	9	0	0	9	0	0
1	22808149	.	T	A	6	6	12	0	1	13	0	0
1	22808181	.	T	C	7	0	7	0	8	15	0	0
1	22808264	.	T	G	3	5	8	0	1	9	0	0
1	22808296	.	A	T	0	4	4	0	0	7	3	0
1	22808301	.	C	G	0	3	3	0	1	4	0	0
1	22808384	.	C	T	0	8	8	0	4	12	0	0
1	22808444	.	G	A	1	8	9	0	0	9	0	0
1	22808479	.	G	T	2	5	7	0	1	8	0	0
1	22808514	.	A	T	4	3	7	0	1	8	0	0
1	22808665	.	C	T	9	8	17	0	0	17	0	0
1	22814910	.	A	G	6	11	17	0	0	17	0	0
1	22829325	.	G	A	4	6	10	0	0	10	0	0
1	22851380	.	T	C	7	4	11	0	0	11	0	0
1	22851422	.	T	A	2	3	5	0	2	7	0	0
1	22851828	.	A	T	4	12	16	0	0	16	0	0
1	22856087	.	C	T	4	4	8	0	0	8	0	0
1	22857882	.	A	C	1	5	6	0	0	6	0	0
1	22857979	.	C	T	9	11	20	0	0	20	0	0
1	22857995	.	A	G	13	8	21	0	1	22	0	0
1	22858194	.	G	A	17	16	33	0	2	35	0	0
1	22858275	.	T	C	20	21	41	0	1	42	0	0
1	22858397	.	G	A	19	22	41	0	7	48	0	0
1	22858478	.	G	A	26	11	37	0	1	38	0	0
1	22861267	.	G	A	2	2	4	0	0	4	0	0
1	22943748	.	G	A	7	16	23	0	3	26	0	0
1	22944056	.	C	T	0	24	24	0	16	40	0	0
1	22944068	.	C	T	22	18	40	0	4	44	0	0
1	22944386	.	A	C	29	23	52	0	1	53	0	0
1	22945054	.	T	C	10	19	29	0	4	33	0	0
1	22945173	.	T	G	24	18	42	0	1	43	0	0
1	22945190	.	G	T	24	13	37	0	0	37	0	0
1	22945444	.	G	A	22	16	38	0	1	39	0	0
1	22945519	.	C	T	14	18	32	0	1	33	0	0
1	22945888	.	G	C	23	1	24	0	26	50	0	0
1	22945903	.	T	C	18	25	43	0	1	44	0	0
1	22946108	.	C	T	18	11	29	0	1	30	0	0
1	22956429	.	C	T	0	6	6	0	7	13	0	0
1	22966877	.	C	A	1	10	11	0	1	12	0	0
1	22987960	.	A	G	2	3	5	0	0	5	0	0
1	22992058	.	G	A	8	10	18	0	1	19	0	0
1	22996606	.	G	A	14	7	21	0	0	21	0	0
1	23072224	.	G	A	5	4	9	0	1	10	0	0
1	23072304	.	G	T	4	7	11	0	0	11	0	0
1	23072461	.	G	A	6	3	9	0	0	9	0	0
1	23072533	.	G	A	4	5	9	0	0	9	0	0
1	23072683	.	T	C	10	0	10	0	6	16	0	0
1	23072746	.	T	A	0	2	2	0	0	2	0	0
1	23094638	.	C	T	2	3	5	0	0	5	0	0
1	23094677	.	G	A	4	5	9	0	0	9	0	0
1	23110816	.	T	C	1	1	2	0	1	3	0	0
1	23239896	.	C	A	2	2	4	0	0	4	0	0
1	23243179	.	C	T	0	2	2	0	3	5	0	0
1	23243230	.	A	G	4	2	6	0	0	6	0	0
1	23243733	.	C	T	3	3	6	0	0	6	0	0
1	23251104	.	C	T	1	0	1	0	0	1	0	0
1	23254712	.	G	A	3	3	6	0	0	6	0	0
1	23259276	.	T	C	2	4	6	0	1	7	0	0
1	23261992	.	G	T	1	2	3	0	0	3	0	0
1	23265582	.	A	T	3	2	5	0	0	5	0	0
1	23265590	.	C	T	0	2	2	0	2	4	0	0
1	23265710	.	C	A	3	3	6	0	0	6	0	0
1	23265711	.	C	T	0	3	3	0	3	6	0	0
1	23271345	.	G	A	4	5	9	0	1	10	0	0
1	23271500	.	G	A	12	7	19	0	0	19	0	0
1	23271608	.	G	A	0	1	1	0	0	1	0	0
1	23271770	.	T	G	12	9	21	0	0	21	0	0
1	23274820	.	G	A	4	6	10	0	0	10	0	0
1	23275228	.	C	G	6	8	14	0	0	14	0	0
1	23277619	.	A	G	1	0	1	0	2	3	0	0
1	23283819	.	G	A	1	2	3	0	0	3	0	0
1	23284094	.	T	A	2	2	4	0	0	4	0	0
1	23287163	.	T	C	3	3	6	0	0	6	0	0
1	23297750	.	A	G	2	3	5	0	0	5	0	0
1	23298642	.	A	T	2	4	6	0	1	7	0	0
1	23298892	.	A	G	4	2	6	0	1	7	0	0
1	23298921	.	G	A	6	5	11	0	0	11	0	0
1	23308208	.	A	C	2	3	5	0	0	5	0	0
1	23311750	.	G	A	2	2	4	0	0	4	0	0
1	23311756	.	T	A	2	2	4	0	0	4	0	0
1	23311908	.	C	A	1	3	4	0	0	4	0	0
1	23506660	.	C	A	8	5	13	0	0	13	0	0
1	23506711	.	A	T	4	5	9	0	3	12	0	0
1	23506787	.	A	T	11	20	31	0	1	32	0	0
1	23506865	.	C	A	10	19	29	0	2	31	0	0
1	23508009	.	G	T	19	18	37	0	2	39	0	0
1	23526644	.	T	C	5	7	12	0	0	12	0	0
1	23528066	.	C	T	8	5	13	0	1	14	0	0
1	23530438	.	C	T	2	6	8	0	1	9	0	0
1	23535880	.	C	T	0	11	11	0	13	24	0	0
1	23536012	.	T	C	5	5	10	0	3	13	0	0
1	23536222	.	T	A	3	3	6	0	0	6	0	0
1	23573582	.	C	T	5	4	9	0	0	9	0	0
1	23573823	.	A	T	4	8	12	0	0	12	0	0
1	23578362	.	C	G	0	2	2	0	4	6	0	0
1	23579819	.	C	G	1	3	4	0	0	4	0	0
1	23579980	.	G	T	2	2	4	0	0	4	0	0
1	23581960	.	T	G	2	3	5	0	0	5	0	0
1	23585275	.	C	T	1	2	3	0	0	3	0	0
1	23585802	.	C	A	0	4	4	0	3	7	0	0
1	23586025	.	C	T	0	2	2	0	3	5	0	0
1	23586133	.	A	G	3	3	6	0	0	6	0	0
1	23586581	.	G	A	1	2	3	0	0	3	0	0
1	23586780	.	C	T	0	5	5	0	6	11	0	0
1	23589017	.	C	T	2	4	6	0	0	6	0	0
1	23889648	.	A	G	0	1	1	0	0	1	0	0
1	23908939	.	T	G	6	3	9	0	1	10	0	0
1	23908940	.	T	G	6	4	10	0	0	10	0	0
1	23909090	.	A	G	9	12	21	0	0	22	1	0
1	23909522	.	A	C	3	7	10	0	1	11	0	0
1	23909748	.	A	T	6	10	16	0	0	16	0	0
1	23920983	.	C	T	0	7	7	0	12	19	0	0
1	23921071	.	A	T	10	10	20	0	0	20	0	0
1	23921284	.	T	C	7	8	15	0	0	15	0	0
1	23921302	.	C	A	8	5	13	0	0	13	0	0
1	23921427	.	T	C	3	0	3	0	7	10	0	0
1	23921564	.	T	A	4	4	8	0	0	8	0	0
1	23921793	.	A	C	5	5	10	0	0	10	0	0
1	23936154	.	C	T	2	2	4	0	0	4	0	0
1	23943726	.	G	A	2	5	7	0	0	7	0	0
1	23945132	.	T	A	3	2	5	0	0	5	0	0
1	23947833	.	A	C	1	0	1	0	6	7	0	0
1	23947881	.	T	A	2	3	5	0	0	5	0	0
1	23975366	.	A	G	4	6	10	0	0	10	0	0
1	24023560	.	T	C	1	1	2	0	0	2	0	0
1	24045920	.	G	T	1	0	1	0	0	1	0	0
1	24076527	.	C	T	9	3	12	0	1	13	0	0
1	24076890	.	A	G	4	7	11	0	0	11	0	0
1	24077274	.	A	G	10	3	13	0	6	19	0	0
1	24077791	.	G	A	1	21	22	0	11	33	0	0
1	24077902	.	A	G	7	8	15	0	0	15	0	0
1	24197375	.	C	T	0	4	4	0	3	7	0	0
1	24228250	.	G	C	1	3	4	0	0	4	0	0
1	24357931	.	C	T	6	9	15	0	1	16	0	0
1	24520823	.	T	C	1	3	4	0	0	4	0	0
1	24523415	.	T	C	0	1	1	0	0	1	0	0
1	24540619	.	C	T	0	2	2	0	0	2	0	0
1	24540785	.	A	G	1	0	1	0	0	1	0	0
1	24540959	.	A	G	1	0	1	0	0	1	0	0
1	24554843	.	G	A	1	3	4	0	0	4	0	0
1	24557100	.	A	G	0	1	1	0	0	1	0	0
1	24557510	.	G	A	1	5	6	0	0	6	0	0
1	24558336	.	C	G	2	7	9	0	0	9	0	0
1	24558410	.	T	A	3	5	8	0	0	8	0	0
1	24871075	.	A	G	7	8	15	0	1	16	0	0
1	24871079	.	A	G	7	9	16	0	1	17	0	0
1	24879994	.	C	T	2	4	6	0	0	6	0	0
1	24908001	.	T	C	4	0	4	0	9	13	0	0
1	25024060	.	T	C	4	0	4	0	5	9	0	0
1	25024066	.	C	T	0	3	3	0	5	8	0	0
1	25144330	.	A	C	2	2	4	0	0	4	0	0
1	25216208	.	C	T	2	2	4	0	0	4	0	0
1	25281601	.	A	C	5	0	5	0	0	5	0	0
1	25296797	.	C	T	5	11	16	0	1	17	0	0
1	25296831	.	C	T	5	9	14	0	1	15	0	0
1	25305290	.	A	T	3	8	11	0	0	11	0	0
1	25305446	.	T	G	9	0	9	0	5	14	0	0
1	25310899	.	C	A	6	3	9	0	0	9	0	0
1	25310912	.	T	A	2	4	6	0	0	6	0	0
1	25313056	.	C	T	6	5	11	0	0	11	0	0
1	25313261	.	T	C	1	1	2	0	1	3	0	0
1	25313300	.	G	A	0	2	2	0	2	4	0	0
1	25322892	.	G	A	1	2	3	0	0	3	0	0
1	25400247	.	C	T	1	4	5	0	0	5	0	0
1	25400814	.	T	A	1	3	4	0	1	5	0	0
1	25400842	.	A	T	2	2	4	0	0	4	0	0
1	25401158	.	T	C	3	0	3	0	3	6	0	0
1	25401181	.	G	A	5	2	7	0	0	7	0	0
1	25401362	.	T	C	2	0	2	0	3	5	0	0
1	25402203	.	C	T	0	1	1	0	1	2	0	0
1	25403244	.	G	C	3	4	7	0	0	7	0	0
1	25419936	.	A	G	1	3	4	0	0	4	0	0
1	25419962	.	G	A	2	3	5	0	1	6	0	0
1	25654976	.	C	T	1	0	1	0	0	1	0	0
1	25660719	.	C	T	2	2	4	0	1	5	0	0
1	25741901	.	A	G	2	1	3	0	0	3	0	0
1	25743046	.	G	C	0	1	1	0	0	1	0	0
1	25798792	.	T	A	4	5	9	0	1	10	0	0
1	25798863	.	G	C	9	4	13	0	0	13	0	0
1	25798983	.	A	C	2	6	8	0	1	9	0	0
1	25812658	.	C	T	1	3	4	0	0	4	0	0
1	25863511	.	G	A	6	9	15	0	0	15	0	0
1	25863638	.	A	T	8	6	14	0	2	16	0	0
1	25918405	.	C	T	5	3	8	0	0	8	0	0
1	26046323	.	A	G	7	10	17	0	2	19	0	0
1	26046950	.	T	A	7	14	21	0	0	21	0	0
1	26046996	.	A	T	6	17	23	0	1	24	0	0
1	26063007	.	G	T	2	4	6	0	0	6	0	0
1	26063030	.	G	A	3	4	7	0	0	7	0	0
1	26096124	.	A	T	4	0	4	0	0	4	0	0
1	26096270	.	C	T	3	6	9	0	0	9	0	0
1	26096522	.	G	T	12	7	19	0	0	19	0	0
1	26127339	.	A	G	4	4	8	0	0	8	0	0
1	26127856	.	A	T	7	10	17	0	1	18	0	0
1	26252033	.	C	T	0	2	2	0	6	8	0	0
1	26252215	.	T	C	4	2	6	0	1	7	0	0
1	26252814	.	C	T	8	3	11	0	0	11	0	0
1	26252877	.	G	A	3	2	5	0	0	5	0	0
1	26293231	.	T	A	4	5	9	0	1	10	0	0
1	26375218	.	C	T	4	4	8	0	0	8	0	0
1	26375404	.	C	A	4	6	10	0	0	10	0	0
1	26376327	.	C	T	1	3	4	0	1	5	0	0
1	26376816	.	A	T	7	4	11	0	0	11	0	0
1	26382809	.	A	T	11	13	24	0	2	26	0	0
1	26383281	.	G	T	0	5	5	0	6	11	0	0
1	26383466	.	G	A	5	5	10	0	1	11	0	0
1	26384629	.	C	T	5	2	7	0	0	7	0	0
1	26384638	.	G	A	5	2	7	0	0	7	0	0
1	26384682	.	G	A	3	4	7	0	0	7	0	0
1	26384721	.	A	G	1	2	3	0	0	3	0	0
1	26384774	.	C	T	4	3	7	0	0	7	0	0
1	26384779	.	C	A	4	3	7	0	0	7	0	0
1	26385222	.	C	G	7	8	15	0	0	15	0	0
1	26385939	.	A	G	8	8	16	0	1	17	0	0
1	26387194	.	C	A	2	2	4	0	0	4	0	0
1	26391649	.	C	T	0	4	4	0	2	6	0	0
1	26391698	.	A	G	1	4	5	0	0	5	0	0
1	26391720	.	A	G	2	3	5	0	0	5	0	0
1	26392422	.	G	A	0	2	2	0	0	2	0	0
1	26445032	.	C	A	3	7	10	0	0	10	0	0
1	26454576	.	G	C	1	1	2	0	0	2	0	0
1	26463488	.	T	G	4	0	4	0	6	10	0	0
1	26463671	.	T	A	12	5	17	0	0	17	0	0
1	26463692	.	C	T	6	10	16	0	1	17	0	0
1	26463779	.	T	A	3	5	8	0	0	8	0	0
1	26463878	.	C	A	7	4	11	0	0	11	0	0
1	26463931	.	A	T	6	8	14	0	0	14	0	0
1	26464175	.	G	A	3	3	6	0	0	6	0	0
1	26464259	.	C	T	7	4	11	0	0	11	0	0
1	26464353	.	A	G	8	14	22	0	0	22	0	0
1	26464446	.	G	A	4	12	16	0	0	16	0	0
1	26464758	.	T	A	12	6	18	0	0	18	0	0
1	26465041	.	G	T	11	6	17	0	0	17	0	0
1	26465047	.	A	C	7	10	17	0	2	19	0	0
1	26465224	.	T	A	6	10	16	0	0	16	0	0
1	26465368	.	G	A	0	3	3	0	3	6	0	0
1	26467243	.	G	A	2	1	3	0	0	3	0	0
1	26473790	.	C	T	0	1	1	0	0	1	0	0
1	26489854	.	G	A	3	4	7	0	0	7	0	0
1	26498400	.	C	T	2	7	9	0	0	9	0	0
1	26498657	.	G	A	0	4	4	0	6	10	0	0
1	26504998	.	G	A	7	5	12	0	0	12	0	0
1	26505282	.	T	C	8	14	22	0	1	23	0	0
1	26505291	.	C	T	10	13	23	0	0	23	0	0
1	26507356	.	G	A	4	10	14	0	0	14	0	0
1	26507392	.	T	A	7	4	11	0	1	12	0	0
1	26507582	.	G	A	13	6	19	0	0	19	0	0
1	26638053	.	G	C	3	2	5	0	1	6	0	0
1	26653943	.	C	T	1	7	8	0	0	8	0	0
1	26827238	.	A	G	2	3	5	0	0	5	0	0
1	26827449	.	T	C	3	2	5	0	0	5	0	0
1	26827519	.	G	A	6	6	12	0	0	12	0	0
1	27207986	.	A	G	7	0	7	0	4	11	0	0
1	27208703	.	A	T	1	3	4	0	0	4	0	0
1	27209628	.	A	C	3	8	11	0	0	11	0	0
1	27209904	.	T	G	6	4	10	0	0	10	0	0
1	27210057	.	T	C	1	7	8	0	0	8	0	0
1	27210231	.	C	T	5	4	9	0	0	9	0	0
1	27210929	.	C	T	13	9	22	0	2	24	0	0
1	27809162	.	T	C	7	6	13	0	0	13	0	0
1	27826090	.	C	A	6	5	11	0	1	12	0	0
1	27826198	.	C	T	8	7	15	0	0	15	0	0
1	27826651	.	T	C	17	16	33	0	1	34	0	0
1	27842373	.	G	A	0	3	3	0	2	5	0	0
1	27860743	.	T	A	5	3	8	0	1	9	0	0
1	27860876	.	A	T	1	2	3	0	0	3	0	0
1	27893920	.	A	T	10	7	17	0	0	17	0	0
1	28018821	.	C	T	7	12	19	0	0	19	0	0
1	28018988	.	T	A	10	9	19	0	1	20	0	0
1	28035786	.	C	T	1	3	4	0	0	4	0	0
1	28036159	.	A	C	5	4	9	0	0	9	0	0
1	28046218	.	T	C	13	8	21	0	0	22	1	0
1	28046224	.	A	G	14	0	14	0	7	21	0	0
1	28046717	.	T	A	2	3	5	0	0	5	0	0
1	28391882	.	C	G	8	3	11	0	1	12	0	0
1	28391914	.	C	T	0	2	2	0	4	6	0	0
1	28422569	.	C	T	0	4	4	0	0	4	0	0
1	28724010	.	G	T	3	3	6	0	1	7	0	0
1	28788272	.	G	A	1	2	3	0	1	4	0	0
1	28834156	.	C	T	5	3	8	0	0	8	0	0
1	28835669	.	T	C	5	5	10	0	0	10	0	0
1	28847677	.	C	T	0	2	2	0	3	5	0	0
1	28874819	.	C	T	3	4	7	0	0	7	0	0
1	28899350	.	G	A	4	5	9	0	0	9	0	0
1	28899483	.	G	A	3	4	7	0	0	7	0	0
1	28899530	.	T	C	4	3	7	0	0	7	0	0
1	28965095	.	G	A	6	2	8	0	0	8	0	0
1	28979161	.	G	C	18	1	19	0	17	36	0	0
1	28986486	.	C	T	10	8	18	0	0	18	0	0
1	29045226	.	G	A	20	18	38	0	0	38	0	0
1	29201933	.	G	C	9	6	15	0	1	16	0	0
1	29202110	.	T	C	0	2	2	0	0	2	0	0
1	29211619	.	T	A	4	4	8	0	0	8	0	0
1	29211636	.	T	C	6	1	7	0	0	7	0	0
1	29211895	.	T	A	4	4	8	0	1	9	0	0
1	29212165	.	T	C	2	6	8	0	0	8	0	0
1	29213107	.	A	G	5	0	5	0	5	10	0	0
1	29227642	.	T	A	8	3	11	0	1	12	0	0
1	29227770	.	C	T	4	2	6	0	0	6	0	0
1	29227880	.	G	T	9	5	14	0	0	14	0	0
1	29228261	.	A	G	3	1	4	0	3	7	0	0
1	29228390	.	A	T	1	6	7	0	0	7	0	0
1	29282145	.	C	T	4	2	6	0	1	7	0	0
1	29389601	.	C	T	1	1	2	0	0	2	0	0
1	29389987	.	C	T	2	6	8	0	0	8	0	0
1	29390999	.	G	T	3	4	7	0	0	7	0	0
1	29731965	.	T	G	1	5	6	0	0	6	0	0
1	29732217	.	C	T	1	2	3	0	0	3	0	0
1	29732256	.	T	C	0	1	1	0	0	1	0	0
1	29751447	.	C	T	2	3	5	0	0	5	0	0
1	29751529	.	T	G	1	3	4	0	0	4	0	0
1	29751594	.	T	G	1	6	7	0	1	8	0	0
1	29751638	.	G	T	2	2	4	0	0	4	0	0
1	29752319	.	T	C	7	12	19	0	1	20	0	0
1	29752421	.	A	G	2	3	5	0	0	5	0	0
1	29754673	.	A	G	5	7	12	0	0	12	0	0
1	29754963	.	G	A	3	3	6	0	0	6	0	0
1	29754981	.	A	G	1	3	4	0	0	4	0	0
1	29757083	.	G	A	1	2	3	0	0	3	0	0
1	29770360	.	T	A	0	3	3	0	0	3	0	0
1	29772391	.	A	G	2	6	8	0	0	8	0	0
1	29772741	.	C	T	4	3	7	0	0	7	0	0
1	29775664	.	C	A	5	3	8	0	3	11	0	0
1	29779300	.	G	C	7	6	13	0	1	14	0	0
1	29779402	.	G	A	0	5	5	0	7	12	0	0
1	29781462	.	G	A	2	6	8	0	0	8	0	0
1	29781597	.	A	T	6	6	12	0	3	15	0	0
1	29786570	.	G	A	6	10	16	0	0	16	0	0
1	29786659	.	T	G	5	0	5	0	9	14	0	0
1	29786704	.	A	G	7	11	18	0	2	20	0	0
1	29787397	.	G	A	8	5	13	0	0	13	0	0
1	29789889	.	C	T	5	12	17	0	0	17	0	0
1	29790030	.	A	T	7	7	14	0	0	14	0	0
1	29795692	.	G	A	5	12	17	0	3	20	0	0
1	29797191	.	T	C	4	0	4	0	0	4	0	0
1	29797344	.	G	T	9	11	20	0	1	21	0	0
1	29797345	.	A	T	8	10	18	0	3	21	0	0
1	29797387	.	A	C	9	5	14	0	0	14	0	0
1	29797699	.	T	G	2	4	6	0	0	6	0	0
1	29798203	.	A	G	10	7	17	0	0	17	0	0
1	29798262	.	T	C	5	7	12	0	0	12	0	0
1	29798324	.	G	T	0	3	3	0	5	8	0	0
1	29798340	.	G	A	0	4	4	0	4	8	0	0
1	29804658	.	A	T	0	1	1	0	0	1	0	0
1	29804682	.	A	G	0	1	1	0	0	1	0	0
1	29805251	.	C	T	4	4	8	0	0	8	0	0
1	29806547	.	C	T	6	3	9	0	1	10	0	0
1	29813246	.	C	A	0	1	1	0	0	1	0	0
1	29813276	.	C	T	4	7	11	0	2	13	0	0
1	29817451	.	C	A	6	5	11	0	1	12	0	0
1	29820831	.	C	T	14	17	31	0	3	34	0	0
1	29823603	.	T	C	7	15	22	0	1	23	0	0
1	29823690	.	T	A	21	19	40	0	1	41	0	0
1	29823701	.	A	G	24	15	39	0	3	42	0	0
1	29860326	.	T	A	3	2	5	0	0	5	0	0
1	29862155	.	A	C	1	0	1	0	0	1	0	0
1	29872653	.	T	G	0	0	0	0	3	3	0	0
1	29891910	.	C	A	3	2	5	0	0	5	0	0
1	29891937	.	C	T	0	1	1	0	0	1	0	0
1	29900692	.	G	A	2	0	2	0	0	2	0	0
1	29900931	.	A	G	0	0	0	0	7	7	0	0
1	29916178	.	G	A	3	3	6	0	0	6	0	0
1	29952918	.	A	T	5	2	7	0	0	7	0	0
1	29953069	.	G	A	7	3	10	0	0	10	0	0
1	29953239	.	G	T	0	10	10	0	14	24	0	0
1	29953253	.	A	G	13	0	13	0	14	27	0	0
1	29953433	.	A	T	4	6	10	0	0	10	0	0
1	29953616	.	A	T	4	3	7	0	0	7	0	0
1	29954795	.	A	C	1	6	7	0	0	7	0	0
1	29954844	.	T	C	5	10	15	0	0	15	0	0
1	29954972	.	C	T	8	9	17	0	1	18	0	0
1	29955006	.	G	A	6	12	18	0	0	18	0	0
1	29955171	.	G	A	12	18	30	0	0	30	0	0
1	29955179	.	A	G	9	18	27	0	0	27	0	0
1	29955228	.	C	T	7	2	9	0	0	9	0	0
1	29955249	.	A	G	1	1	2	0	0	2	0	0
1	30038844	.	A	C	3	3	6	0	0	6	0	0
1	30118166	.	C	T	0	1	1	0	0	1	0	0
1	30180924	.	G	A	0	1	1	0	0	1	0	0
1	30183309	.	C	G	0	1	1	0	0	1	0	0
1	30212461	.	G	A	1	4	5	0	0	5	0	0
1	30212793	.	G	A	2	3	5	0	0	5	0	0
1	30250557	.	T	C	5	1	6	0	0	6	0	0
1	30255365	.	G	A	10	9	19	0	2	21	0	0
1	30255458	.	A	C	3	3	6	0	0	6	0	0
1	30282841	.	G	T	3	3	6	0	0	6	0	0
1	30343802	.	A	T	1	1	2	0	1	3	0	0
1	30343967	.	T	G	5	11	16	0	2	18	0	0
1	30344842	.	A	G	3	4	7	0	0	7	0	0
1	30345026	.	T	C	4	8	12	0	0	12	0	0
1	30345029	.	C	T	3	8	11	0	0	11	0	0
1	30345075	.	G	T	4	10	14	0	0	14	0	0
1	30345131	.	C	T	0	9	9	0	6	15	0	0
1	30345239	.	G	C	6	6	12	0	0	12	0	0
1	30345243	.	T	C	6	6	12	0	0	12	0	0
1	30345421	.	C	T	3	3	6	0	0	6	0	0
1	30345485	.	A	C	2	3	5	0	0	5	0	0
1	30345531	.	A	G	4	5	9	0	0	9	0	0
1	30345635	.	T	G	3	8	11	0	0	11	0	0
1	30345669	.	T	G	6	4	10	0	0	10	0	0
1	30345925	.	G	A	6	1	7	0	0	7	0	0
1	30345948	.	C	T	0	2	2	0	6	8	0	0
1	30346042	.	G	A	3	5	8	0	1	9	0	0
1	30346112	.	T	C	7	4	11	0	0	11	0	0
1	30346124	.	T	A	7	3	10	0	0	10	0	0
1	30346233	.	G	A	7	5	12	0	1	13	0	0
1	30346377	.	G	A	4	4	8	0	0	8	0	0
1	30346385	.	G	A	5	4	9	0	0	9	0	0
1	30346432	.	T	G	2	6	8	0	0	8	0	0
1	30346456	.	G	A	3	2	5	0	1	6	0	0
1	30346624	.	G	T	4	2	6	0	0	6	0	0
1	30346845	.	G	T	5	5	10	0	1	11	0	0
1	30346906	.	C	A	4	9	13	0	0	13	0	0
1	30346977	.	C	A	3	8	11	0	1	12	0	0
1	30347027	.	C	A	12	5	17	0	0	17	0	0
1	30347043	.	T	C	10	0	10	0	7	17	0	0
1	30347586	.	C	T	2	5	7	0	0	7	0	0
1	30540535	.	C	T	4	5	9	0	0	9	0	0
1	30557628	.	G	T	0	1	1	0	0	1	0	0
1	30568183	.	C	T	0	3	3	0	2	5	0	0
1	30589258	.	C	A	0	1	1	0	0	1	0	0
1	30641038	.	T	C	0	1	1	0	0	1	0	0
1	30641077	.	C	A	0	1	1	0	0	1	0	0
1	30688453	.	G	A	3	3	6	0	0	6	0	0
1	30688802	.	G	A	2	2	4	0	0	4	0	0
1	30688901	.	G	A	5	3	8	0	0	8	0	0
1	30688924	.	G	T	3	6	9	0	0	9	0	0
1	30718394	.	T	C	3	0	3	0	5	8	0	0
1	30718463	.	T	A	1	4	5	0	0	5	0	0
1	30718538	.	C	G	6	7	13	0	0	13	0	0
1	30718567	.	A	C	3	0	3	0	1	4	0	0
1	31063923	.	T	C	1	6	7	0	0	7	0	0
1	31063928	.	G	A	1	5	6	0	1	7	0	0
1	31064011	.	A	C	1	2	3	0	0	3	0	0
1	31064024	.	T	C	2	1	3	0	0	3	0	0
1	31064166	.	G	T	0	2	2	0	2	4	0	0
1	31071824	.	A	G	0	0	0	0	2	2	0	0
1	31072348	.	A	C	4	6	10	0	0	10	0	0
1	31072843	.	C	T	2	3	5	0	0	5	0	0
1	31072863	.	A	G	1	0	1	0	0	1	0	0
1	31075158	.	C	T	0	3	3	0	1	4	0	0
1	31085882	.	C	T	0	1	1	0	0	1	0	0
1	31090873	.	G	A	2	3	5	0	0	5	0	0
1	31091995	.	T	A	1	1	2	0	0	2	0	0
1	31102986	.	C	T	2	3	5	0	0	5	0	0
1	31112466	.	G	C	5	6	11	0	0	11	0	0
1	31112468	.	G	A	5	6	11	0	0	11	0	0
1	31117686	.	G	A	22	14	36	0	2	38	0	0
1	31117695	.	T	C	22	15	37	0	1	38	0	0
1	31119296	.	C	T	29	16	45	0	0	45	0	0
1	31122596	.	G	A	24	23	47	0	3	50	0	0
1	31130005	.	T	C	19	23	42	0	2	44	0	0
1	31130028	.	T	C	16	22	38	0	4	42	0	0
1	31130094	.	G	A	1	19	20	0	14	34	0	0
1	31130176	.	T	C	8	9	17	0	1	18	0	0
1	31136018	.	G	A	7	5	12	0	1	13	0	0
1	31136477	.	A	G	4	4	8	0	0	8	0	0
1	31374780	.	A	T	11	9	20	0	0	20	0	0
1	31386255	.	T	C	11	7	18	0	1	19	0	0
1	31423014	.	C	T	0	5	5	0	7	12	0	0
1	31423099	.	G	T	2	0	2	0	1	3	0	0
1	31428150	.	G	A	6	3	9	0	0	9	0	0
1	31430665	.	A	G	1	2	3	0	0	3	0	0
1	31445874	.	T	A	5	5	10	0	0	10	0	0
1	31472033	.	A	G	7	5	12	0	0	12	0	0
1	31657604	.	T	C	1	0	1	0	0	1	0	0
1	31660214	.	T	G	1	0	1	0	0	1	0	0
1	31660952	.	A	G	3	0	3	0	3	6	0	0
1	31664892	.	C	T	4	5	9	0	0	9	0	0
1	31667491	.	C	T	4	3	7	0	0	7	0	0
1	31671721	.	C	T	6	4	10	0	0	10	0	0
1	31671746	.	C	A	7	7	14	0	0	14	0	0
1	31671958	.	G	A	0	3	3	0	8	11	0	0
1	31672078	.	G	A	2	2	4	0	0	4	0	0
1	31793998	.	A	G	1	3	4	0	0	4	0	0
1	31797386	.	A	G	1	1	2	0	0	2	0	0
1	31797459	.	G	A	1	3	4	0	1	5	0	0
1	31797488	.	C	T	1	2	3	0	1	4	0	0
1	31797503	.	G	A	0	2	2	0	4	6	0	0
1	31797533	.	C	T	3	3	6	0	0	6	0	0
1	31797597	.	G	A	2	2	4	0	0	4	0	0
1	31798507	.	C	A	1	2	3	0	0	3	0	0
1	31798794	.	T	C	1	2	3	0	0	3	0	0
1	31798821	.	C	T	1	4	5	0	0	5	0	0
1	31798974	.	G	C	2	4	6	0	0	6	0	0
1	31798980	.	C	T	2	4	6	0	0	6	0	0
1	31809302	.	G	A	1	5	6	0	0	6	0	0
1	31809332	.	G	A	4	5	9	0	0	9	0	0
1	31809496	.	G	A	6	10	16	0	0	16	0	0
1	31813283	.	A	G	10	4	14	0	0	14	0	0
1	31865172	.	G	A	3	4	7	0	1	8	0	0
1	31865387	.	G	A	4	6	10	0	0	10	0	0
1	31866684	.	G	A	1	3	4	0	1	5	0	0
1	31867264	.	T	A	12	13	25	0	2	27	0	0
1	31867314	.	C	T	9	11	20	0	1	21	0	0
1	31867449	.	C	T	9	13	22	0	1	23	0	0
1	31943042	.	T	G	5	0	5	0	5	10	0	0
1	33355989	.	C	T	2	2	4	0	0	4	0	0
1	33356004	.	C	T	1	2	3	0	0	3	0	0
1	33356398	.	T	C	4	2	6	0	1	7	0	0
1	33384062	.	G	A	8	4	12	0	0	12	0	0
1	33449334	.	C	A	2	1	3	0	0	3	0	0
1	33457733	.	C	T	10	4	14	0	0	14	0	0
1	33484129	.	C	G	8	6	14	0	2	16	0	0
1	33484288	.	T	C	9	9	18	0	3	21	0	0
1	33484293	.	C	A	8	9	17	0	2	19	0	0
1	33484404	.	C	T	14	6	20	0	1	21	0	0
1	33484652	.	T	C	13	8	21	0	0	21	0	0
1	33485692	.	A	G	12	0	12	0	12	24	0	0
1	33547900	.	A	C	0	9	9	0	0	9	0	0
1	33556056	.	G	A	5	5	10	0	0	10	0	0
1	33561520	.	A	G	4	0	4	0	2	6	0	0
1	33561544	.	C	T	7	9	16	0	0	16	0	0
1	33568153	.	A	T	7	11	18	0	1	19	0	0
1	33568211	.	A	G	7	1	8	0	8	16	0	0
1	33568303	.	G	A	0	6	6	0	0	6	0	0
1	33568454	.	G	T	5	8	13	0	0	13	0	0
1	33568520	.	G	A	7	14	21	0	1	22	0	0
1	33568836	.	T	G	0	20	20	0	4	24	0	0
1	33568976	.	G	T	0	18	18	0	10	28	0	0
1	33656560	.	C	G	4	3	7	0	0	7	0	0
1	33656831	.	G	A	5	3	8	0	0	8	0	0
1	33656900	.	T	G	4	3	7	0	0	7	0	0
1	33657904	.	G	A	0	4	4	0	7	11	0	0
1	33658030	.	G	A	0	3	3	0	3	6	0	0
1	33658065	.	T	G	4	3	7	0	2	9	0	0
1	33658669	.	A	G	1	0	1	0	5	6	0	0
1	33658852	.	C	A	3	4	7	0	0	7	0	0
1	33658945	.	C	T	4	7	11	0	1	12	0	0
1	33658971	.	C	T	7	4	11	0	0	11	0	0
1	33659374	.	C	T	1	0	1	0	0	1	0	0
1	33686477	.	G	A	2	3	5	0	0	5	0	0
1	33686513	.	G	T	8	6	14	0	0	14	0	0
1	33687177	.	A	T	4	11	15	0	0	15	0	0
1	33693919	.	C	A	3	2	5	0	0	5	0	0
1	33694165	.	A	T	5	2	7	0	0	7	0	0
1	33694198	.	T	A	3	4	7	0	0	7	0	0
1	33694327	.	C	T	7	8	15	0	2	17	0	0
1	33694357	.	T	A	9	6	15	0	2	17	0	0
1	33694517	.	T	A	1	7	8	0	0	8	0	0
1	33694573	.	T	C	4	5	9	0	0	9	0	0
1	33701445	.	C	T	2	2	4	0	0	4	0	0
1	33969389	.	A	T	6	5	11	0	0	11	0	0
1	34043394	.	T	C	7	9	16	0	0	16	0	0
1	34134691	.	G	A	0	9	9	0	7	16	0	0
1	34137711	.	T	C	5	6	11	0	2	13	0	0
1	34137741	.	T	C	2	5	7	0	0	7	0	0
1	34137768	.	A	C	0	3	3	0	0	3	0	0
1	34176504	.	C	T	1	6	7	0	0	7	0	0
1	34176808	.	A	T	2	2	4	0	0	4	0	0
1	34182333	.	C	T	1	1	2	0	1	3	0	0
1	34199906	.	G	T	16	23	39	0	1	40	0	0
1	34199913	.	C	T	17	25	42	0	1	43	0	0
1	34232407	.	A	G	7	3	10	0	0	10	0	0
1	34232551	.	A	C	10	4	14	0	0	14	0	0
1	34232744	.	T	A	8	15	23	0	2	25	0	0
1	34232761	.	A	G	8	19	27	0	0	27	0	0
1	34232879	.	T	C	13	8	21	0	2	23	0	0
1	34232929	.	C	T	10	6	16	0	3	19	0	0
1	34232931	.	G	A	9	8	17	0	2	19	0	0
1	34233096	.	C	A	8	13	21	0	0	21	0	0
1	34233145	.	G	T	5	8	13	0	0	13	0	0
1	34233198	.	C	A	5	3	8	0	1	9	0	0
1	34233238	.	A	G	8	5	13	0	0	13	0	0
1	34233301	.	A	G	10	0	10	0	11	21	0	0
1	34233312	.	A	G	11	7	18	0	3	21	0	0
1	34233548	.	T	G	9	3	12	0	0	12	0	0
1	34258077	.	C	A	2	2	4	0	0	4	0	0
1	34258971	.	C	T	3	7	10	0	1	11	0	0
1	34259098	.	C	A	4	5	9	0	0	9	0	0
1	34259343	.	C	T	3	4	7	0	0	7	0	0
1	34259411	.	A	T	2	3	5	0	0	5	0	0
1	34259452	.	T	A	3	6	9	0	1	10	0	0
1	34260100	.	C	T	3	3	6	0	1	7	0	0
1	34260914	.	C	T	2	6	8	0	0	8	0	0
1	34260977	.	T	A	10	2	12	0	0	12	0	0
1	34261230	.	A	T	7	6	13	0	1	14	0	0
1	34261358	.	A	G	14	0	14	0	18	32	0	0
1	34261393	.	G	A	1	13	14	0	9	23	0	0
1	34261654	.	T	C	5	5	10	0	0	10	0	0
1	34296606	.	A	T	7	10	17	0	0	17	0	0
1	34297112	.	C	A	12	10	22	0	0	22	0	0
1	34297135	.	C	T	9	12	21	0	1	22	0	0
1	34540552	.	C	G	2	0	2	0	6	8	0	0
1	34540564	.	G	A	0	4	4	0	4	8	0	0
1	34540639	.	A	G	1	4	5	0	0	5	0	0
1	34540714	.	G	A	0	2	2	0	3	5	0	0
1	34540750	.	G	T	2	1	3	0	0	3	0	0
1	34555559	.	C	T	5	4	9	0	0	9	0	0
1	34556148	.	T	A	3	2	5	0	0	5	0	0
1	34556241	.	A	C	6	4	10	0	1	11	0	0
1	34617680	.	C	A	4	4	8	0	0	8	0	0
1	34657924	.	T	C	2	0	2	0	0	2	0	0
1	34679820	.	T	C	1	3	4	0	0	4	0	0
1	34688988	.	C	T	10	9	19	0	0	19	0	0
1	34689001	.	T	C	13	11	24	0	0	24	0	0
1	34693831	.	C	T	5	4	9	0	1	10	0	0
1	34695423	.	G	A	1	18	19	0	2	21	0	0
1	34695476	.	G	A	4	14	18	0	3	21	0	0
1	34696017	.	G	A	0	3	3	0	0	3	0	0
1	34703048	.	T	A	2	2	4	0	0	4	0	0
1	34703272	.	A	G	2	3	5	0	1	6	0	0
1	34706526	.	G	A	7	4	11	0	3	14	0	0
1	34707958	.	T	C	8	6	14	0	3	17	0	0
1	34708145	.	C	T	1	29	30	0	19	49	0	0
1	34712097	.	A	G	2	4	6	0	0	6	0	0
1	35232521	.	A	C	3	4	7	0	0	7	0	0
1	35481768	.	T	C	3	1	4	0	0	4	0	0
1	35481777	.	G	A	3	2	5	0	0	5	0	0
1	35482482	.	G	A	0	2	2	0	3	5	0	0
1	35482485	.	C	T	3	2	5	0	0	5	0	0
1	35484358	.	C	T	1	2	3	0	2	5	0	0
1	35485056	.	G	A	7	2	9	0	0	9	0	0
1	35485105	.	G	A	0	3	3	0	3	6	0	0
1	35485263	.	C	A	4	3	7	0	0	8	1	0
1	35485289	.	C	T	5	3	8	0	0	8	0	0
1	35485378	.	C	T	10	3	13	0	0	13	0	0
1	35488211	.	A	T	5	5	10	0	0	10	0	0
1	35488332	.	G	A	1	5	6	0	1	7	0	0
1	35597542	.	A	G	1	2	3	0	0	3	0	0
1	35607830	.	G	A	4	2	6	0	0	6	0	0
1	35608041	.	G	A	0	9	9	0	2	11	0	0
1	35608821	.	G	A	1	2	3	0	0	3	0	0
1	35608826	.	G	T	1	2	3	0	0	3	0	0
1	35608941	.	A	C	3	4	7	0	0	7	0	0
1	35609192	.	A	G	1	6	7	0	0	7	0	0
1	35609431	.	T	C	5	4	9	0	0	9	0	0
1	35609474	.	G	A	2	3	5	0	0	5	0	0
1	35609530	.	T	A	1	3	4	0	0	4	0	0
1	35793852	.	T	C	1	1	2	0	0	2	0	0
1	35811779	.	C	A	0	2	2	0	0	2	0	0
1	35811854	.	C	T	4	5	9	0	1	10	0	0
1	35812128	.	T	C	2	2	4	0	0	4	0	0
1	35812155	.	T	C	1	0	1	0	0	1	0	0
1	35815706	.	A	C	1	0	1	0	0	1	0	0
1	35834307	.	T	A	3	3	6	0	0	6	0	0
1	35834554	.	G	T	3	4	7	0	0	7	0	0
1	35834712	.	A	C	1	4	5	0	0	5	0	0
1	35835125	.	T	G	6	0	6	0	7	13	0	0
1	35835237	.	G	A	0	8	8	0	4	12	0	0
1	35835371	.	A	C	8	15	23	0	0	23	0	0
1	35835502	.	C	T	9	9	18	0	0	18	0	0
1	35897450	.	G	C	2	2	4	0	0	4	0	0
1	35897622	.	T	A	5	2	7	0	0	7	0	0
1	35897623	.	G	A	5	2	7	0	0	7	0	0
1	35908381	.	T	C	1	0	1	0	2	3	0	0
1	35949965	.	T	C	3	6	9	0	0	9	0	0
1	35949969	.	C	A	3	6	9	0	0	9	0	0
1	35950082	.	T	G	3	8	11	0	0	11	0	0
1	35950100	.	T	G	3	7	10	0	1	11	0	0
1	35956508	.	C	G	0	6	6	0	0	6	0	0
1	35956549	.	C	T	1	2	3	0	2	5	0	0
1	35959327	.	G	C	1	6	7	0	0	7	0	0
1	35959826	.	T	C	3	2	5	0	0	5	0	0
1	35962990	.	C	T	1	2	3	0	0	3	0	0
1	35963306	.	G	A	0	1	1	0	4	5	0	0
1	35963822	.	C	T	3	3	6	0	0	6	0	0
1	35969716	.	G	A	1	1	2	0	1	3	0	0
1	35969836	.	G	C	12	12	24	0	0	24	0	0
1	35969878	.	C	T	13	16	29	0	0	29	0	0
1	36018817	.	T	C	7	0	7	0	11	18	0	0
1	36019227	.	C	T	8	10	18	0	2	20	0	0
1	36019361	.	T	C	9	0	9	0	16	25	0	0
1	36019416	.	G	T	13	18	31	0	3	34	0	0
1	36020092	.	A	T	5	4	9	0	1	10	0	0
1	36020097	.	A	C	5	4	9	0	0	9	0	0
1	36020154	.	T	C	2	3	5	0	0	5	0	0
1	36020492	.	T	G	10	4	14	0	1	15	0	0
1	36020642	.	T	A	15	8	23	0	0	23	0	0
1	36021110	.	G	A	5	10	15	0	0	15	0	0
1	36021158	.	C	G	7	4	11	0	0	11	0	0
1	36021399	.	A	G	20	11	31	0	3	34	0	0
1	36036829	.	G	A	3	4	7	0	1	8	0	0
1	36057147	.	G	A	1	1	2	0	0	2	0	0
1	36057303	.	A	G	3	4	7	0	0	7	0	0
1	36057306	.	C	T	3	3	6	0	0	6	0	0
1	36078513	.	G	A	5	6	11	0	3	14	0	0
1	36104830	.	C	T	0	4	4	0	0	4	0	0
1	36105018	.	A	C	8	0	8	0	5	13	0	0
1	36105117	.	C	T	0	9	9	0	7	16	0	0
1	36119094	.	C	T	0	3	3	0	4	7	0	0
1	36119106	.	A	G	4	3	7	0	0	7	0	0
1	36194799	.	G	T	0	2	2	0	2	4	0	0
1	36195039	.	A	C	0	2	2	0	0	2	0	0
1	36200014	.	C	T	2	1	3	0	0	3	0	0
1	36438671	.	T	A	13	14	27	0	1	28	0	0
1	36438882	.	T	A	28	14	42	0	1	43	0	0
1	36439186	.	T	A	13	11	24	0	2	26	0	0
1	36439204	.	G	T	13	13	26	0	1	27	0	0
1	36439248	.	G	A	9	17	26	0	0	26	0	0
1	36439380	.	G	T	14	13	27	0	0	27	0	0
1	36701333	.	C	T	1	3	4	0	0	4	0	0
1	36701999	.	C	T	6	3	9	0	1	10	0	0
1	36725468	.	T	C	1	1	2	0	1	3	0	0
1	36735123	.	C	T	2	2	4	0	0	4	0	0
1	36735144	.	G	A	2	2	4	0	0	4	0	0
1	36737712	.	T	C	1	3	4	0	0	4	0	0
1	36738004	.	C	T	2	2	4	0	1	5	0	0
1	36738356	.	C	T	4	2	6	0	0	6	0	0
1	36738434	.	A	C	1	2	3	0	0	3	0	0
1	36738574	.	C	A	2	4	6	0	0	6	0	0
1	36738595	.	A	T	3	6	9	0	0	9	0	0
1	36738810	.	C	T	3	4	7	0	0	7	0	0
1	36739086	.	A	T	3	1	4	0	0	4	0	0
1	36739104	.	C	T	4	2	6	0	0	6	0	0
1	36739124	.	G	A	0	3	3	0	4	7	0	0
1	36740205	.	A	G	1	2	3	0	0	3	0	0
1	36740468	.	T	A	2	5	7	0	0	7	0	0
1	36740764	.	C	A	6	5	11	0	0	11	0	0
1	36740961	.	G	T	0	4	4	0	8	12	0	0
1	36740995	.	G	C	2	7	9	0	0	9	0	0
1	36741087	.	T	A	4	5	9	0	1	10	0	0
1	36741110	.	G	T	2	3	5	0	0	5	0	0
1	36741149	.	A	C	2	0	2	0	0	2	0	0
1	36741279	.	T	C	6	5	11	0	0	11	0	0
1	36741396	.	T	G	1	3	4	0	0	4	0	0
1	36741493	.	A	G	6	2	8	0	0	8	0	0
1	36741499	.	T	A	6	2	8	0	0	8	0	0
1	36741581	.	C	T	3	6	9	0	1	10	0	0
1	36741602	.	A	C	4	6	10	0	0	10	0	0
1	36741796	.	T	G	5	4	9	0	0	9	0	0
1	36741863	.	A	C	3	3	6	0	0	6	0	0
1	36742074	.	G	C	2	1	3	0	0	3	0	0
1	36742075	.	G	A	2	1	3	0	0	3	0	0
1	36749872	.	T	C	3	2	5	0	0	5	0	0
1	36769270	.	G	A	1	2	3	0	0	3	0	0
1	36769288	.	C	T	0	2	2	0	1	3	0	0
1	36771622	.	A	C	2	4	6	0	1	7	0	0
1	36887811	.	C	A	2	0	2	0	0	2	0	0
1	36887880	.	C	A	4	3	7	0	0	7	0	0
1	36911491	.	A	C	1	1	2	0	0	2	0	0
1	36911647	.	A	T	4	3	7	0	0	7	0	0
1	36912176	.	G	A	4	5	9	0	0	9	0	0
1	36935559	.	T	C	2	3	5	0	0	5	0	0
1	37083319	.	G	A	4	4	8	0	0	8	0	0
1	37083463	.	G	A	1	3	4	0	0	4	0	0
1	37083817	.	C	T	0	3	3	0	4	7	0	0
1	37083876	.	G	A	2	2	4	0	0	4	0	0
1	37195950	.	G	A	4	2	6	0	0	6	0	0
1	37212301	.	T	A	5	3	8	0	0	8	0	0
1	37212331	.	C	T	3	2	5	0	0	5	0	0
1	37284382	.	C	T	1	0	1	0	0	1	0	0
1	37287291	.	A	T	1	5	6	0	0	6	0	0
1	37287294	.	G	A	1	6	7	0	0	7	0	0
1	37291884	.	A	C	2	1	3	0	0	3	0	0
1	37304354	.	C	A	11	9	20	0	1	22	1	0
1	37304439	.	C	T	10	6	16	0	1	17	0	0
1	37304494	.	T	A	9	12	21	0	0	21	0	0
1	37304510	.	T	G	10	11	21	0	0	21	0	0
1	37304536	.	G	A	9	10	19	0	1	20	0	0
1	37304929	.	G	A	4	8	12	0	1	13	0	0
1	37305148	.	C	T	3	7	10	0	0	10	0	0
1	37306726	.	G	T	0	18	18	0	10	28	0	0
1	37306913	.	T	A	14	7	21	0	0	21	0	0
1	37306942	.	A	C	11	11	22	0	0	22	0	0
1	37339689	.	T	C	1	3	4	0	0	4	0	0
1	37344832	.	T	C	4	5	9	0	0	9	0	0
1	37355591	.	G	A	7	3	10	0	0	10	0	0
1	37355606	.	C	T	6	7	13	0	0	13	0	0
1	37359071	.	C	T	5	8	13	0	0	13	0	0
1	37359352	.	A	G	2	3	5	0	0	5	0	0
1	37361554	.	A	G	2	6	8	0	1	9	0	0
1	37361759	.	C	T	7	4	11	0	0	11	0	0
1	37361879	.	T	A	2	3	5	0	0	5	0	0
1	37361919	.	T	C	1	3	4	0	1	5	0	0
1	37361960	.	C	T	2	2	4	0	0	4	0	0
1	37752392	.	A	G	3	0	3	0	3	6	0	0
1	37752563	.	G	T	4	2	6	0	0	6	0	0
1	37752569	.	A	G	2	3	5	0	2	7	0	0
1	38125431	.	C	A	6	9	15	0	0	15	0	0
1	38125684	.	T	C	1	10	11	0	1	12	0	0
1	38131058	.	C	T	14	13	27	0	0	27	0	0
1	38131073	.	T	C	14	13	27	0	1	28	0	0
1	38131094	.	G	A	12	10	22	0	3	25	0	0
1	38131288	.	G	A	17	10	27	0	1	28	0	0
1	38131360	.	G	A	20	23	43	0	1	44	0	0
1	38131486	.	G	A	13	14	27	0	2	29	0	0
1	38131812	.	T	C	1	4	5	0	0	5	0	0
1	38132103	.	T	A	2	1	3	0	2	5	0	0
1	38146192	.	G	T	0	2	2	0	0	2	0	0
1	38150605	.	A	C	5	2	7	0	1	8	0	0
1	38163017	.	C	T	2	1	3	0	1	4	0	0
1	38163132	.	G	A	2	4	6	0	0	6	0	0
1	38166009	.	G	C	11	6	17	0	0	17	0	0
1	38166268	.	A	C	15	14	29	0	1	30	0	0
1	38166429	.	T	C	20	11	31	0	0	31	0	0
1	38166431	.	T	G	20	11	31	0	0	31	0	0
1	38166520	.	A	G	16	17	33	0	1	34	0	0
1	38169771	.	T	A	8	6	14	0	1	15	0	0
1	38169972	.	T	G	11	14	25	0	3	29	1	0
1	38170553	.	G	A	3	4	7	0	0	7	0	0
1	38346578	.	G	T	2	8	10	0	1	11	0	0
1	38346649	.	C	T	0	6	6	0	1	7	0	0
1	38346739	.	G	A	2	7	9	0	1	10	0	0
1	38416352	.	G	C	1	3	4	0	0	4	0	0
1	38416477	.	G	A	6	7	13	0	0	13	0	0
1	38416536	.	A	G	6	2	8	0	0	8	0	0
1	38417116	.	A	T	1	5	6	0	0	6	0	0
1	38417229	.	G	A	5	4	9	0	1	10	0	0
1	38417332	.	A	G	3	5	8	0	0	8	0	0
1	38417370	.	G	A	6	4	10	0	0	10	0	0
1	38417531	.	G	T	2	5	7	0	0	7	0	0
1	38417571	.	G	T	3	3	6	0	1	7	0	0
1	38417588	.	T	G	2	6	8	0	1	9	0	0
1	38417615	.	A	T	1	5	6	0	1	7	0	0
1	38417625	.	A	T	7	6	13	0	0	13	0	0
1	38417680	.	T	A	5	3	8	0	0	8	0	0
1	38418087	.	C	T	2	3	5	0	0	5	0	0
1	38418243	.	A	G	3	4	7	0	0	7	0	0
1	38418294	.	G	T	3	6	9	0	0	9	0	0
1	38649340	.	A	G	39	24	63	0	1	64	0	0
1	38649947	.	G	A	34	30	64	0	6	70	0	0
1	38650132	.	G	T	29	32	61	0	1	62	0	0
1	38650298	.	G	A	27	23	50	0	0	50	0	0
1	38650382	.	G	C	33	27	60	0	4	64	0	0
1	38650467	.	A	G	22	33	55	0	5	60	0	0
1	38650510	.	G	C	24	33	57	0	0	58	1	0
1	38650516	.	T	C	24	31	55	0	4	59	0	0
1	38650545	.	T	C	29	36	65	0	2	67	0	0
1	38651063	.	G	T	40	4	44	0	1	45	0	0
1	38651065	.	T	A	37	5	42	0	3	45	0	0
1	38651361	.	C	T	18	16	34	0	0	34	0	0
1	38651370	.	G	A	16	16	32	0	3	35	0	0
1	38651469	.	C	A	19	24	43	0	0	43	0	0
1	38651822	.	G	A	7	0	7	0	0	7	0	0
1	38655522	.	C	T	0	0	0	0	2	2	0	0
1	38657689	.	G	A	5	3	8	0	1	9	0	0
1	38660240	.	T	C	17	1	18	0	14	32	0	0
1	38660252	.	A	G	22	14	36	0	3	39	0	0
1	38660369	.	G	A	2	1	3	0	0	3	0	0
1	38709242	.	T	A	8	3	11	0	2	13	0	0
1	38709243	.	G	A	8	4	12	0	1	13	0	0
1	38709351	.	A	C	6	1	7	0	10	17	0	0
1	38709381	.	G	C	7	4	11	0	0	11	0	0
1	38709480	.	G	A	11	8	19	0	0	19	0	0
1	38709535	.	T	A	7	8	15	0	0	15	0	0
1	38784551	.	A	T	2	2	4	0	0	4	0	0
1	38791569	.	C	T	0	2	2	0	1	3	0	0
1	38793983	.	G	A	2	1	3	0	0	3	0	0
1	38797663	.	A	C	8	8	16	0	0	16	0	0
1	38799513	.	G	A	1	2	3	0	0	3	0	0
1	38799585	.	A	G	3	3	6	0	1	7	0	0
1	38799588	.	T	A	2	4	6	0	1	7	0	0
1	38802537	.	G	A	7	11	18	0	1	19	0	0
1	38802703	.	A	G	11	6	17	0	2	19	0	0
1	38802718	.	G	A	10	13	23	0	0	23	0	0
1	38802747	.	A	G	10	0	10	0	11	21	0	0
1	38802855	.	C	A	11	9	20	0	0	21	1	0
1	38803033	.	T	C	5	3	8	0	1	9	0	0
1	38803042	.	A	C	5	3	8	0	0	8	0	0
1	38803092	.	C	T	4	3	7	0	0	7	0	0
1	38803127	.	C	T	5	7	12	0	1	13	0	0
1	38803154	.	T	A	9	8	17	0	1	18	0	0
1	38803205	.	A	T	8	9	17	0	0	17	0	0
1	38803404	.	A	G	15	7	22	0	0	22	0	0
1	38805128	.	G	T	11	3	14	0	0	14	0	0
1	38805135	.	C	T	10	3	13	0	1	14	0	0
1	38805439	.	G	A	9	12	21	0	1	22	0	0
1	38805450	.	A	G	7	15	22	0	2	24	0	0
1	38805506	.	G	A	10	14	24	0	1	25	0	0
1	38807255	.	G	C	3	5	8	0	0	8	0	0
1	38808259	.	C	A	1	1	2	0	0	2	0	0
1	38808379	.	C	T	0	1	1	0	0	1	0	0
1	38808723	.	T	A	2	6	8	0	0	8	0	0
1	38820219	.	G	A	0	5	5	0	7	12	0	0
1	38822092	.	A	T	4	8	12	0	1	13	0	0
1	39482532	.	C	T	3	1	4	0	0	4	0	0
1	39639723	.	C	T	2	0	2	0	0	2	0	0
1	39700498	.	T	C	2	4	6	0	0	6	0	0
1	39732521	.	T	C	2	1	3	0	0	3	0	0
1	39732544	.	C	T	1	0	1	0	2	3	0	0
1	39735491	.	T	C	2	2	4	0	0	4	0	0
1	39770416	.	C	T	2	6	8	0	0	8	0	0
1	39771429	.	T	A	11	8	19	0	0	19	0	0
1	39772010	.	T	C	5	6	11	0	0	11	0	0
1	39772042	.	A	G	10	5	15	0	0	15	0	0
1	39772135	.	C	A	8	6	14	0	3	17	0	0
1	39772225	.	C	T	7	4	11	0	0	11	0	0
1	39774096	.	C	T	9	7	16	0	0	16	0	0
1	39774225	.	C	T	11	8	19	0	0	19	0	0
1	39774363	.	G	A	7	7	14	0	0	14	0	0
1	39774618	.	A	G	12	11	23	0	3	26	0	0
1	39774690	.	A	G	4	10	14	0	0	14	0	0
1	39774727	.	C	A	2	14	16	0	0	16	0	0
1	39774891	.	C	T	15	13	28	0	2	30	0	0
1	39774915	.	G	A	16	11	27	0	3	30	0	0
1	39775089	.	C	T	9	9	18	0	0	18	0	0
1	39775131	.	C	T	9	8	17	0	2	19	0	0
1	39775227	.	C	T	5	9	14	0	0	14	0	0
1	39776356	.	A	C	13	22	35	0	1	36	0	0
1	39777089	.	G	A	12	12	24	0	2	26	0	0
1	39777836	.	G	A	0	11	11	0	11	22	0	0
1	39777975	.	A	T	11	11	22	0	1	23	0	0
1	39778047	.	A	G	10	0	10	0	21	31	0	0
1	39778075	.	T	G	12	17	29	0	0	29	0	0
1	39778332	.	G	C	22	18	40	0	1	41	0	0
1	39778661	.	G	A	9	7	16	0	1	17	0	0
1	39778663	.	G	A	9	7	16	0	1	17	0	0
1	39778949	.	G	C	18	20	38	0	1	39	0	0
1	39779225	.	G	C	7	9	16	0	2	18	0	0
1	39779468	.	A	T	4	4	8	0	1	9	0	0
1	39813515	.	A	T	1	2	3	0	0	3	0	0
1	39869917	.	T	A	3	3	6	0	1	7	0	0
1	39869974	.	G	A	5	2	7	0	0	7	0	0
1	39870008	.	T	C	2	3	5	0	0	5	0	0
1	39879560	.	T	C	2	2	4	0	0	4	0	0
1	39879863	.	A	T	2	3	5	0	0	5	0	0
1	39882764	.	A	T	6	2	8	0	0	8	0	0
1	39882899	.	A	G	4	6	10	0	3	13	0	0
1	39882906	.	T	A	7	6	13	0	0	13	0	0
1	39899477	.	G	C	21	15	36	0	1	37	0	0
1	39899494	.	A	G	11	26	37	0	1	38	0	0
1	39899663	.	G	A	17	26	43	0	0	43	0	0
1	39900056	.	G	A	27	23	50	0	2	52	0	0
1	39900129	.	G	A	24	25	49	0	1	50	0	0
1	39900137	.	G	T	25	21	46	0	0	46	0	0
1	39900360	.	G	A	7	15	22	0	4	26	0	0
1	39900432	.	C	T	0	22	22	0	7	29	0	0
1	39900750	.	C	T	0	16	16	0	14	30	0	0
1	39901269	.	G	A	7	5	12	0	0	12	0	0
1	39901378	.	T	A	6	13	19	0	0	19	0	0
1	39901500	.	T	C	5	9	14	0	0	14	0	0
1	39901501	.	G	A	5	9	14	0	0	14	0	0
1	39901729	.	T	C	15	0	15	0	19	34	0	0
1	39907291	.	A	C	6	6	12	0	0	12	0	0
1	39907492	.	T	C	20	0	20	0	10	30	0	0
1	39907611	.	C	T	1	10	11	0	4	15	0	0
1	39908047	.	G	A	7	11	18	0	0	18	0	0
1	39908680	.	C	T	5	9	14	0	1	15	0	0
1	39908854	.	A	G	9	12	21	0	2	23	0	0
1	39908881	.	C	T	16	8	24	0	1	25	0	0
1	39908926	.	A	G	13	5	18	0	0	18	0	0
1	39909003	.	A	T	8	8	16	0	2	18	0	0
1	39909247	.	A	T	18	10	28	0	2	30	0	0
1	39909274	.	A	T	17	9	26	0	4	30	0	0
1	39995100	.	C	T	3	12	15	0	0	15	0	0
1	39998875	.	G	A	12	4	16	0	0	16	0	0
1	40001853	.	A	T	7	4	11	0	2	13	0	0
1	40001873	.	C	A	4	1	5	0	1	6	0	0
1	40002113	.	G	A	12	11	23	0	2	25	0	0
1	40002148	.	C	G	10	12	22	0	2	24	0	0
1	40008905	.	T	C	31	9	40	0	3	43	0	0
1	40008906	.	G	A	34	9	43	0	0	43	0	0
1	40009227	.	T	A	14	12	26	0	0	26	0	0
1	40009258	.	C	T	13	12	25	0	1	26	0	0
1	40009291	.	A	G	13	13	26	0	0	26	0	0
1	40009382	.	G	A	22	12	34	0	0	34	0	0
1	40009526	.	T	C	6	7	13	0	2	15	0	0
1	40009625	.	T	C	10	6	16	0	0	16	0	0
1	40009671	.	C	A	12	9	21	0	1	22	0	0
1	40009697	.	C	T	9	7	16	0	0	16	0	0
1	40009778	.	C	T	1	2	3	0	0	3	0	0
1	40009779	.	G	A	0	2	2	0	1	3	0	0
1	40015189	.	A	G	4	11	15	0	0	15	0	0
1	40015219	.	C	T	4	9	13	0	0	13	0	0
1	40015265	.	C	T	0	1	1	0	1	2	0	0
1	40015553	.	A	G	0	2	2	0	0	2	0	0
1	40015697	.	A	G	2	8	10	0	0	10	0	0
1	40023692	.	T	C	2	2	4	0	0	4	0	0
1	40028208	.	C	A	2	2	4	0	0	4	0	0
1	40028424	.	C	T	6	2	8	0	0	8	0	0
1	40028508	.	C	T	6	4	10	0	0	10	0	0
1	40028568	.	G	T	1	3	4	0	0	4	0	0
1	40028613	.	G	A	2	4	6	0	0	6	0	0
1	40028637	.	C	T	6	3	9	0	0	9	0	0
1	40041528	.	C	T	1	1	2	0	0	2	0	0
1	40042241	.	G	A	1	0	1	0	1	2	0	0
1	40044562	.	G	A	7	7	14	0	0	14	0	0
1	40044578	.	C	T	6	7	13	0	0	13	0	0
1	40046859	.	G	A	0	2	2	0	0	2	0	0
1	40051918	.	T	C	6	5	11	0	1	12	0	0
1	40051923	.	G	C	6	7	13	0	0	13	0	0
1	40051988	.	G	C	0	11	11	0	12	23	0	0
1	40052033	.	A	G	15	9	24	0	2	26	0	0
1	40052066	.	G	C	9	10	19	0	1	20	0	0
1	40052083	.	G	A	11	6	17	0	1	18	0	0
1	40052481	.	A	C	7	9	16	0	0	16	0	0
1	40052550	.	A	C	9	10	19	0	1	20	0	0
1	40052562	.	A	G	8	4	12	0	3	15	0	0
1	40052638	.	T	A	3	2	5	0	0	5	0	0
1	40052666	.	T	A	1	2	3	0	0	3	0	0
1	40057483	.	C	T	5	5	10	0	0	10	0	0
1	40057604	.	A	G	4	5	9	0	0	9	0	0
1	40057655	.	C	T	6	4	10	0	0	10	0	0
1	40057805	.	C	T	4	3	7	0	0	7	0	0
1	40060860	.	T	C	3	3	6	0	0	6	0	0
1	40060968	.	A	C	3	5	8	0	0	8	0	0
1	40060992	.	C	T	0	4	4	0	5	9	0	0
1	40061061	.	C	T	0	4	4	0	2	6	0	0
1	40061285	.	C	T	6	4	10	0	0	10	0	0
1	40062593	.	T	G	4	5	9	0	0	9	0	0
1	40107874	.	T	G	6	9	15	0	1	16	0	0
1	40107961	.	C	T	1	2	3	0	0	3	0	0
1	40111679	.	C	G	11	14	25	0	0	25	0	0
1	40111702	.	T	G	13	11	24	0	0	24	0	0
1	40111737	.	A	C	7	13	20	0	0	20	0	0
1	40111738	.	G	A	6	12	18	0	2	20	0	0
1	40111776	.	C	T	12	5	17	0	1	18	0	0
1	40111918	.	C	T	11	9	20	0	1	21	0	0
1	40112206	.	T	C	8	4	12	0	3	15	0	0
1	40112347	.	C	T	4	8	12	0	0	12	0	0
1	40112410	.	C	T	7	7	14	0	2	16	0	0
1	40112500	.	A	G	6	8	14	0	0	14	0	0
1	40112760	.	T	A	7	11	18	0	0	18	0	0
1	40112822	.	A	T	7	6	13	0	0	13	0	0
1	40112837	.	C	T	7	5	12	0	1	13	0	0
1	40112869	.	C	T	5	8	13	0	0	14	1	0
1	40112879	.	A	G	5	5	10	0	1	11	0	0
1	40112938	.	G	C	4	5	9	0	1	10	0	0
1	40113008	.	A	T	3	4	7	0	0	7	0	0
1	40113079	.	A	G	1	5	6	0	0	6	0	0
1	40113259	.	A	T	3	5	8	0	1	9	0	0
1	40113272	.	G	C	2	4	6	0	2	8	0	0
1	40113314	.	A	G	2	0	2	0	7	9	0	0
1	40113374	.	T	A	1	3	4	0	0	4	0	0
1	40113486	.	A	G	2	3	5	0	1	6	0	0
1	40113589	.	T	C	2	5	7	0	0	7	0	0
1	40114057	.	G	T	1	2	3	0	0	3	0	0
1	40114155	.	T	A	1	4	5	0	0	5	0	0
1	40114326	.	C	T	3	3	6	0	0	6	0	0
1	40115065	.	T	C	1	2	3	0	0	3	0	0
1	40115167	.	A	T	2	3	5	0	0	5	0	0
1	40116747	.	G	A	7	7	14	0	0	14	0	0
1	40116823	.	C	T	0	3	3	0	2	5	0	0
1	40116915	.	T	G	1	3	4	0	0	4	0	0
1	40116946	.	C	T	1	5	6	0	3	9	0	0
1	40117345	.	G	A	11	15	26	0	1	27	0	0
1	40123964	.	C	T	0	2	2	0	0	2	0	0
1	40132692	.	G	C	6	4	10	0	0	10	0	0
1	40210865	.	G	T	15	10	25	0	2	27	0	0
1	40211048	.	C	T	0	13	13	0	4	17	0	0
1	40211065	.	T	C	4	10	14	0	1	15	0	0
1	40211217	.	A	C	2	10	12	0	0	12	0	0
1	40211465	.	T	C	9	0	9	0	4	13	0	0
1	40212065	.	C	T	9	6	15	0	0	15	0	0
1	40212084	.	C	A	0	7	7	0	11	18	0	0
1	40212305	.	C	T	12	18	30	0	2	32	0	0
1	40221359	.	A	G	0	1	1	0	0	1	0	0
1	40221458	.	A	T	1	1	2	0	0	2	0	0
1	40227029	.	T	G	10	7	17	0	0	17	0	0
1	40248173	.	C	T	2	5	7	0	0	7	0	0
1	40252219	.	T	A	1	0	1	0	0	1	0	0
1	40257631	.	C	T	9	9	18	0	1	19	0	0
1	40257751	.	C	T	8	11	19	0	0	19	0	0
1	40257834	.	T	G	7	0	7	0	7	14	0	0
1	40263675	.	C	A	2	3	5	0	0	5	0	0
1	40263684	.	C	G	0	4	4	0	0	4	0	0
1	40266618	.	C	T	5	5	10	0	0	10	0	0
1	40269998	.	T	G	3	1	4	0	1	5	0	0
1	40270054	.	C	T	1	3	4	0	0	4	0	0
1	40270094	.	G	A	0	1	1	0	0	1	0	0
1	40270095	.	G	A	0	1	1	0	0	1	0	0
1	40270554	.	G	A	1	2	3	0	0	3	0	0
1	40336372	.	T	A	1	3	4	0	0	4	0	0
1	40336396	.	A	C	2	0	2	0	2	4	0	0
1	40336789	.	G	A	1	3	4	0	0	4	0	0
1	40337314	.	C	T	5	4	9	0	1	10	0	0
1	40337464	.	C	A	1	7	8	0	6	14	0	0
1	40340571	.	C	T	9	4	13	0	1	14	0	0
1	40340598	.	C	T	5	9	14	0	1	15	0	0
1	40410608	.	C	T	0	2	2	0	4	6	0	0
1	40410839	.	A	T	8	7	15	0	1	16	0	0
1	40410908	.	C	T	5	5	10	0	1	11	0	0
1	40411091	.	T	A	4	4	8	0	0	8	0	0
1	40567094	.	G	A	6	7	13	0	0	13	0	0
1	40568601	.	G	A	6	6	12	0	0	12	0	0
1	40568707	.	A	G	10	0	10	0	6	16	0	0
1	40568883	.	G	A	0	15	15	0	10	25	0	0
1	40568990	.	A	G	12	12	24	0	0	24	0	0
1	40569153	.	C	T	3	7	10	0	1	11	0	0
1	40569168	.	C	T	4	6	10	0	0	10	0	0
1	40569231	.	G	A	9	13	22	0	0	22	0	0
1	40569295	.	A	T	6	4	10	0	0	10	0	0
1	40569386	.	T	A	13	5	18	0	1	19	0	0
1	40569466	.	A	T	18	17	35	0	2	37	0	0
1	40569538	.	G	A	11	9	20	0	1	21	0	0
1	40569548	.	T	C	8	8	16	0	2	18	0	0
1	40573703	.	G	T	8	8	16	0	0	16	0	0
1	40590967	.	T	G	5	8	13	0	0	13	0	0
1	40591262	.	T	C	14	25	39	0	2	41	0	0
1	40591272	.	T	C	13	20	33	0	1	34	0	0
1	40594373	.	C	T	3	2	5	0	0	5	0	0
1	40594415	.	C	T	0	11	11	0	8	19	0	0
1	40594517	.	T	C	11	0	11	0	14	25	0	0
1	40594526	.	G	A	8	12	20	0	2	22	0	0
1	40597332	.	A	C	7	0	7	0	17	24	0	0
1	40600992	.	A	T	4	5	9	0	0	9	0	0
1	40601547	.	G	A	10	8	18	0	0	18	0	0
1	40601595	.	G	C	2	0	2	0	5	7	0	0
1	40618861	.	C	T	1	1	2	0	0	2	0	0
1	40638246	.	A	T	3	4	7	0	0	7	0	0
1	40795231	.	A	T	0	2	2	0	1	3	0	0
1	40796779	.	G	T	1	3	4	0	0	4	0	0
1	40796791	.	G	A	3	1	4	0	0	4	0	0
1	40796985	.	A	T	3	2	5	0	0	5	0	0
1	40798883	.	G	A	0	2	2	0	0	2	0	0
1	40992716	.	T	A	3	8	11	0	0	11	0	0
1	40992823	.	A	G	5	7	12	0	0	12	0	0
1	40993349	.	C	T	0	7	7	0	12	19	0	0
1	40993714	.	G	A	4	4	8	0	0	8	0	0
1	40994068	.	T	A	4	2	6	0	1	7	0	0
1	41131608	.	C	T	12	13	25	0	0	25	0	0
1	41133944	.	G	A	6	6	12	0	0	12	0	0
1	41136245	.	T	C	1	1	2	0	0	2	0	0
1	41138641	.	C	T	2	1	3	0	0	3	0	0
1	41140465	.	T	C	3	3	6	0	0	6	0	0
1	41140640	.	C	T	10	13	23	0	2	25	0	0
1	41140754	.	C	T	9	7	16	0	2	18	0	0
1	41140787	.	T	A	8	10	18	0	2	20	0	0
1	41215289	.	T	A	5	10	15	0	1	16	0	0
1	41215312	.	T	G	5	16	21	0	0	21	0	0
1	41215547	.	G	A	8	11	19	0	1	20	0	0
1	41215746	.	T	A	10	10	20	0	0	20	0	0
1	41215868	.	T	G	3	10	13	0	2	15	0	0
1	41215869	.	G	T	9	4	13	0	2	15	0	0
1	41215998	.	T	C	8	3	11	0	2	13	0	0
1	41222341	.	T	C	1	1	2	0	0	2	0	0
1	41230927	.	C	T	1	0	1	0	0	1	0	0
1	41294719	.	A	G	9	12	21	0	1	22	0	0
1	41294760	.	T	C	9	9	18	0	2	20	0	0
1	41294790	.	G	T	6	9	15	0	0	15	0	0
1	41297453	.	C	T	0	3	3	0	4	7	0	0
1	41297495	.	G	A	9	11	20	0	0	20	0	0
1	41297561	.	C	T	4	2	6	0	1	7	0	0
1	41297564	.	A	T	2	5	7	0	0	7	0	0
1	41300133	.	C	T	5	4	9	0	0	9	0	0
1	41309208	.	C	G	5	4	9	0	0	9	0	0
1	41310074	.	A	G	2	2	4	0	1	5	0	0
1	41312210	.	G	A	4	1	5	0	0	5	0	0
1	41318203	.	T	G	2	2	4	0	0	4	0	0
1	41320781	.	A	G	1	2	3	0	0	3	0	0
1	41324327	.	C	T	0	1	1	0	0	1	0	0
1	41324444	.	C	T	0	3	3	0	1	4	0	0
1	41330594	.	G	C	0	4	4	0	0	4	0	0
1	41331692	.	G	A	1	3	4	0	0	4	0	0
1	41337314	.	G	A	1	0	1	0	0	1	0	0
1	41470524	.	T	C	30	19	49	0	2	51	0	0
1	41471529	.	T	C	22	25	47	0	4	51	0	0
1	41487811	.	C	T	0	2	2	0	0	2	0	0
1	41487960	.	A	T	0	0	0	0	1	1	0	0
1	41487973	.	T	C	3	1	4	0	0	4	0	0
1	41488643	.	A	C	1	1	2	0	0	2	0	0
1	41489068	.	C	T	3	4	7	0	0	7	0	0
1	41489274	.	G	C	2	5	7	0	0	7	0	0
1	41489343	.	G	A	4	2	6	0	0	6	0	0
1	41491990	.	G	T	2	2	4	0	1	5	0	0
1	41492367	.	A	T	2	4	6	0	0	6	0	0
1	41498219	.	A	G	5	5	10	0	1	11	0	0
1	41512895	.	C	T	3	3	6	0	0	6	0	0
1	41513332	.	G	A	3	3	6	0	0	6	0	0
1	41513497	.	G	A	7	3	10	0	0	10	0	0
1	41530370	.	C	T	3	4	7	0	0	7	0	0
1	41596148	.	A	T	2	2	4	0	0	4	0	0
1	41596182	.	A	G	5	3	8	0	0	8	0	0
1	41596199	.	A	G	4	4	8	0	2	10	0	0
1	41596291	.	C	T	2	3	5	0	1	6	0	0
1	41596420	.	A	C	1	1	2	0	0	2	0	0
1	41600339	.	T	C	1	0	1	0	0	1	0	0
1	41604931	.	C	G	2	1	3	0	3	6	0	0
1	41604934	.	C	G	2	0	2	0	4	6	0	0
1	41604985	.	G	A	0	2	2	0	2	4	0	0
1	41605011	.	T	C	2	5	7	0	0	7	0	0
1	41605065	.	C	A	3	2	5	0	1	6	0	0
1	41605149	.	T	C	3	5	8	0	0	8	0	0
1	41605203	.	C	T	3	4	7	0	0	7	0	0
1	41605675	.	G	A	3	3	6	0	0	6	0	0
1	41615874	.	C	T	2	5	7	0	0	7	0	0
1	41615904	.	T	C	4	6	10	0	1	11	0	0
1	41615949	.	T	C	4	9	13	0	0	13	0	0
1	41616081	.	T	G	3	8	11	0	0	11	0	0
1	41616186	.	A	C	3	2	5	0	0	5	0	0
1	41616867	.	T	A	5	4	9	0	0	9	0	0
1	41616902	.	A	T	4	4	8	0	0	8	0	0
1	41690506	.	C	T	10	5	15	0	0	15	0	0
1	41730609	.	C	T	9	8	17	0	1	18	0	0
1	41730669	.	G	A	10	14	24	0	0	24	0	0
1	41744103	.	C	T	2	3	5	0	0	5	0	0
1	41755157	.	C	T	15	7	22	0	0	22	0	0
1	41755158	.	A	T	14	6	20	0	2	22	0	0
1	41755195	.	C	T	9	12	21	0	1	22	0	0
1	41770847	.	T	A	8	10	18	0	0	18	0	0
1	41770872	.	T	C	9	7	16	0	1	17	0	0
1	41770959	.	T	C	7	4	11	0	0	11	0	0
1	41817556	.	G	A	4	3	7	0	0	7	0	0
1	41817574	.	T	C	4	2	6	0	0	6	0	0
1	41849293	.	A	G	9	2	11	0	2	13	0	0
1	41849310	.	A	G	5	3	8	0	3	11	0	0
1	41865471	.	C	T	7	3	10	0	0	10	0	0
1	41959067	.	T	C	1	0	1	0	3	4	0	0
1	42375005	.	C	A	4	8	12	0	2	14	0	0
1	42375071	.	C	T	1	6	7	0	0	7	0	0
1	42386349	.	T	C	5	3	8	0	0	8	0	0
1	42391172	.	T	C	4	3	7	0	0	7	0	0
1	42391194	.	T	C	2	2	4	0	1	5	0	0
1	42391214	.	G	A	0	1	1	0	0	1	0	0
1	42776652	.	T	C	22	20	42	0	1	43	0	0
1	42776787	.	C	T	1	16	17	0	20	37	0	0
1	42776806	.	A	T	19	13	32	0	1	33	0	0
1	42776853	.	T	C	15	14	29	0	1	30	0	0
1	42776906	.	A	G	26	14	40	0	1	41	0	0
1	42777116	.	G	A	16	22	38	0	1	39	0	0
1	42777146	.	C	G	3	12	15	0	19	34	0	0
1	42777383	.	A	G	15	14	29	0	0	29	0	0
1	42777593	.	T	G	12	15	27	0	1	28	0	0
1	42777674	.	G	A	13	13	26	0	0	26	0	0
1	42882955	.	C	T	9	4	13	0	0	13	0	0
1	43023630	.	G	A	1	7	8	0	0	8	0	0
1	43034947	.	C	T	19	11	30	0	3	33	0	0
1	43035178	.	T	C	11	14	25	0	1	26	0	0
1	43035546	.	T	A	3	10	13	0	0	13	0	0
1	43714454	.	C	T	0	2	2	0	0	2	0	0
1	43994103	.	A	G	1	4	5	0	0	5	0	0
1	45015442	.	C	T	0	3	3	0	0	3	0	0
1	45016216	.	G	A	4	3	7	0	0	7	0	0
1	45016221	.	G	T	6	2	8	0	0	8	0	0
1	45095019	.	T	C	3	4	7	5	0	12	0	0
1	45095197	.	G	A	2	1	3	0	0	3	0	0
1	45570224	.	T	A	0	12	12	0	7	19	0	0
1	45570225	.	T	A	0	16	16	0	3	19	0	0
1	45834490	.	A	G	4	2	6	0	0	6	0	0
1	45834493	.	A	G	3	3	6	0	0	6	0	0
1	45868178	.	C	T	9	16	25	0	0	25	0	0
1	46302882	.	A	G	0	2	2	0	1	3	0	0
1	46302891	.	G	A	0	3	3	0	0	3	0	0
1	46560667	.	A	G	1	0	1	0	6	7	0	0
1	47120514	.	A	T	0	1	1	0	0	1	0	0
1	48583000	.	T	C	10	5	15	0	0	15	0	0
1	48583115	.	T	C	6	2	8	0	0	8	0	0
1	49271317	.	G	A	13	18	31	0	3	34	0	0
1	49289729	.	C	G	13	0	13	0	6	19	0	0
1	49293808	.	T	C	20	15	35	0	5	40	0	0
1	49293954	.	C	T	21	13	34	0	1	35	0	0
1	49294032	.	A	T	16	8	24	0	0	24	0	0
1	49294686	.	A	G	11	15	26	0	0	26	0	0
1	49374392	.	A	G	1	6	7	0	0	7	0	0
1	49418197	.	A	T	5	2	7	0	0	7	0	0
1	49483555	.	T	C	10	4	14	0	0	14	0	0
1	49814674	.	T	C	8	14	22	0	3	25	0	0
1	49814732	.	C	T	16	11	27	0	1	28	0	0
1	49814844	.	C	T	12	13	25	0	3	28	0	0
1	49869672	.	G	A	4	5	9	0	2	11	0	0
1	49903376	.	A	C	2	2	4	0	2	6	0	0
1	49910164	.	A	G	1	0	1	0	0	1	0	0
1	49910173	.	G	A	2	2	4	0	0	4	0	0
1	49912665	.	C	T	0	2	2	0	0	2	0	0
1	49912841	.	C	A	0	1	1	0	4	5	0	0
1	49912866	.	C	T	0	1	1	0	3	4	0	0
1	49913071	.	G	A	7	7	14	0	3	17	0	0
1	49913110	.	T	C	1	2	3	0	0	3	0	0
1	49915231	.	C	T	3	3	6	0	0	6	0	0
1	49915278	.	G	C	0	0	0	0	1	1	0	0
1	49915598	.	C	T	4	4	8	0	0	8	0	0
1	49929579	.	G	A	0	1	1	0	0	1	0	0
1	49929726	.	A	G	1	2	3	0	0	3	0	0
1	49930146	.	G	A	3	2	5	0	0	5	0	0
1	50065325	.	T	A	1	2	3	0	0	3	0	0
1	50171219	.	T	C	1	2	3	0	1	4	0	0
1	50172815	.	A	G	6	1	7	0	0	7	0	0
1	50178612	.	T	C	1	1	2	0	0	2	0	0
1	50178643	.	A	G	5	0	5	0	4	9	0	0
1	50178829	.	C	A	13	12	25	0	0	25	0	0
1	50178963	.	G	A	2	5	7	0	0	7	0	0
1	50178988	.	A	G	0	0	0	0	4	4	0	0
1	50185244	.	G	A	0	6	6	0	5	11	0	0
1	50187511	.	C	T	5	3	8	0	1	9	0	0
1	50187733	.	A	T	2	6	8	0	1	9	0	0
1	50187782	.	A	G	2	2	4	0	0	4	0	0
1	50187836	.	T	G	1	2	3	0	0	3	0	0
1	50187866	.	A	G	1	0	1	0	3	4	0	0
1	50198619	.	C	A	1	3	4	0	0	4	0	0
1	50198815	.	C	T	0	3	3	0	4	7	0	0
1	50199365	.	A	T	0	1	1	0	0	1	0	0
1	50199368	.	G	A	0	1	1	0	0	1	0	0
1	50221045	.	G	A	1	1	2	0	0	2	0	0
1	50270234	.	C	G	1	3	4	0	0	4	0	0
1	50270241	.	T	A	0	2	2	0	0	2	0	0
1	50293876	.	A	G	6	4	10	0	0	10	0	0
1	50301833	.	A	G	1	1	2	0	0	2	0	0
1	50303960	.	C	T	5	2	7	0	0	7	0	0
1	50303989	.	G	A	0	7	7	0	7	14	0	0
1	50317687	.	G	A	0	6	6	0	9	15	0	0
1	50317723	.	A	C	8	2	10	0	0	10	0	0
1	50319584	.	A	G	3	4	7	0	1	8	0	0
1	50414777	.	G	T	0	1	1	0	0	1	0	0
1	50487762	.	G	C	12	1	13	0	4	17	0	0
1	50487837	.	C	A	7	4	11	0	1	12	0	0
1	50487844	.	G	A	7	4	11	0	0	11	0	0
1	50488002	.	A	G	6	6	12	0	0	12	0	0
1	50496598	.	A	G	12	7	19	0	0	19	0	0
1	50502852	.	C	T	0	2	2	0	1	3	0	0
1	50503237	.	G	A	3	2	5	0	0	5	0	0
1	50520003	.	A	G	0	1	1	0	0	1	0	0
1	50524745	.	G	A	0	1	1	0	0	1	0	0
1	50594239	.	T	A	16	20	36	0	0	36	0	0
1	50594647	.	G	A	0	5	5	0	0	5	0	0
1	50594670	.	A	T	0	5	5	0	0	5	0	0
1	50594771	.	C	A	15	8	23	0	2	25	0	0
1	50594777	.	C	T	15	10	25	0	0	25	0	0
1	50594986	.	T	C	4	0	4	0	14	18	0	0
1	50595289	.	G	A	15	11	26	0	0	26	0	0
1	50595387	.	C	T	10	13	23	0	0	23	0	0
1	50595476	.	G	A	9	12	21	0	0	21	0	0
1	50595530	.	A	G	2	1	3	0	0	3	0	0
1	50595608	.	G	C	7	9	16	0	2	18	0	0
1	50595748	.	T	C	10	10	20	0	0	20	0	0
1	50595805	.	G	A	12	13	25	0	1	26	0	0
1	50596748	.	G	T	13	7	20	0	0	20	0	0
1	50598793	.	C	T	0	6	6	0	13	19	0	0
1	50598848	.	G	A	13	13	26	0	0	26	0	0
1	50608505	.	T	C	7	9	16	0	0	16	0	0
1	50608584	.	G	A	12	7	19	0	1	20	0	0
1	50611013	.	G	A	0	3	3	0	0	3	0	0
1	50657117	.	C	A	1	2	3	0	0	3	0	0
1	50673749	.	G	A	0	2	2	0	0	2	0	0
1	50691194	.	G	C	0	2	2	0	2	4	0	0
1	50694993	.	T	C	12	10	22	0	0	22	0	0
1	50694994	.	G	T	12	9	21	0	1	22	0	0
1	50698089	.	G	A	4	3	7	0	0	7	0	0
1	50799728	.	A	T	1	1	2	0	0	2	0	0
1	50847905	.	T	C	5	4	9	0	1	10	0	0
1	50848484	.	C	T	13	5	18	0	5	23	0	0
1	50848555	.	A	G	8	9	17	0	2	19	0	0
1	50849078	.	A	T	14	12	26	0	0	26	0	0
1	50849199	.	T	C	14	1	15	0	15	30	0	0
1	50849839	.	T	C	3	4	7	0	1	8	0	0
1	50849938	.	T	A	14	6	20	0	1	21	0	0
1	50849942	.	G	A	14	6	20	0	3	23	0	0
1	50850041	.	T	A	7	11	18	0	1	19	0	0
1	50968923	.	A	G	4	3	7	0	0	7	0	0
1	50969209	.	G	A	11	10	21	0	1	22	0	0
1	50977072	.	C	A	4	7	11	0	1	12	0	0
1	50977089	.	C	T	8	4	12	0	0	12	0	0
1	50977707	.	G	A	0	7	7	0	9	16	0	0
1	50983906	.	T	C	15	12	27	0	4	31	0	0
1	50985169	.	C	T	13	13	26	0	0	26	0	0
1	50987742	.	C	A	6	14	20	0	0	20	0	0
1	50990605	.	G	A	23	32	55	0	4	59	0	0
1	50990698	.	A	T	22	18	40	0	2	42	0	0
1	50990709	.	T	C	15	17	32	0	2	41	7	0
1	50990815	.	G	A	29	16	45	0	4	49	0	0
1	51015493	.	G	A	0	2	2	0	0	2	0	0
1	51015594	.	T	A	2	4	6	0	0	6	0	0
1	51015622	.	A	T	2	2	4	0	0	4	0	0
1	51021529	.	C	A	7	4	11	0	1	12	0	0
1	51021591	.	C	A	8	4	12	0	0	12	0	0
1	51031291	.	T	C	4	0	4	0	2	6	0	0
1	51038819	.	A	G	3	2	5	0	0	5	0	0
1	51041363	.	G	A	0	2	2	0	6	8	0	0
1	51042230	.	G	C	16	11	27	0	0	27	0	0
1	51052276	.	C	T	0	1	1	0	0	1	0	0
1	51053971	.	A	G	2	2	4	0	0	4	0	0
1	51108130	.	T	C	2	0	2	0	2	4	0	0
1	51192069	.	C	T	1	0	1	0	0	1	0	0
1	51192074	.	C	A	1	1	2	0	0	2	0	0
1	51193686	.	T	C	1	0	1	0	0	1	0	0
1	51193701	.	G	T	0	0	0	0	1	1	0	0
1	51196071	.	G	C	0	1	1	0	1	2	0	0
1	51196161	.	C	T	3	2	5	0	0	5	0	0
1	51196203	.	T	C	4	3	7	0	0	7	0	0
1	51196233	.	T	C	1	2	3	0	0	3	0	0
1	51196863	.	G	A	0	6	6	0	5	11	0	0
1	51197082	.	G	A	4	2	6	0	0	6	0	0
1	51197434	.	C	T	3	2	5	0	0	5	0	0
1	51211052	.	A	G	1	6	7	0	0	7	0	0
1	51211393	.	T	A	0	3	3	0	0	3	0	0
1	51211394	.	C	T	0	3	3	0	0	3	0	0
1	51217156	.	T	A	0	2	2	0	0	2	0	0
1	51217822	.	T	C	2	1	3	0	1	4	0	0
1	51217888	.	A	C	1	4	5	0	1	6	0	0
1	51221347	.	A	G	7	0	7	0	5	12	0	0
1	51221349	.	A	T	7	5	12	0	0	12	0	0
1	51229355	.	C	T	3	9	12	0	1	13	0	0
1	51229464	.	C	G	1	4	5	0	0	5	0	0
1	51229471	.	C	T	1	3	4	0	2	6	0	0
1	51230090	.	T	C	8	4	12	0	2	14	0	0
1	51230106	.	T	C	3	6	9	0	1	10	0	0
1	51230277	.	C	G	5	7	12	0	0	12	0	0
1	51230404	.	A	G	0	5	5	0	0	5	0	0
1	51230427	.	A	G	0	4	4	0	0	4	0	0
1	51230467	.	T	C	1	5	6	0	0	6	0	0
1	51230487	.	A	T	1	6	7	0	0	7	0	0
1	51230564	.	C	T	1	1	2	0	0	2	0	0
1	51230573	.	C	T	2	2	4	0	0	4	0	0
1	51230957	.	C	A	0	7	7	0	4	11	0	0
1	51231225	.	A	T	2	2	4	0	0	4	0	0
1	51231228	.	G	T	2	2	4	0	0	4	0	0
1	51242401	.	G	T	5	3	8	0	1	9	0	0
1	51246693	.	T	C	2	6	8	0	0	8	0	0
1	51258598	.	A	G	1	1	2	0	0	2	0	0
1	51264192	.	T	A	2	2	4	0	0	4	0	0
1	51264198	.	A	G	2	2	4	0	0	4	0	0
1	51349146	.	G	A	0	2	2	0	0	2	0	0
1	51369612	.	A	G	1	2	3	0	0	3	0	0
1	51371090	.	G	A	0	2	2	0	0	2	0	0
1	51372742	.	C	T	4	3	7	0	0	7	0	0
1	51372951	.	C	T	2	1	3	0	0	3	0	0
1	51373730	.	A	C	0	3	3	0	0	3	0	0
1	51373808	.	C	T	3	3	6	0	2	8	0	0
1	51373904	.	A	G	5	5	10	0	0	10	0	0
1	51373952	.	A	C	5	3	8	0	0	8	0	0
1	51374009	.	T	C	3	3	6	0	0	6	0	0
1	51374844	.	C	T	4	6	10	0	0	10	0	0
1	51374905	.	A	G	2	5	7	0	0	7	0	0
1	51374976	.	G	A	3	7	10	0	0	10	0	0
1	51375149	.	T	C	5	2	7	0	0	7	0	0
1	51375170	.	A	T	5	3	8	0	1	9	0	0
1	51375361	.	C	A	4	2	6	0	0	6	0	0
1	51377798	.	G	A	0	3	3	0	4	7	0	0
1	51395366	.	G	T	4	2	6	0	1	7	0	0
1	51403499	.	C	A	4	1	5	0	0	5	0	0
1	51403544	.	G	C	12	3	15	0	0	15	0	0
1	51403562	.	C	T	12	2	14	0	2	16	0	0
1	51403872	.	T	C	2	4	6	0	2	8	0	0
1	51405058	.	G	A	3	3	6	0	0	6	0	0
1	51405323	.	C	A	6	6	12	0	0	12	0	0
1	51405721	.	G	A	7	2	9	0	0	9	0	0
1	51406142	.	G	A	7	4	11	0	1	12	0	0
1	51406288	.	C	T	13	12	25	0	0	25	0	0
1	51406510	.	G	T	1	1	2	0	0	2	0	0
1	51406521	.	G	A	1	1	2	0	0	2	0	0
1	51413315	.	T	C	2	7	9	0	1	10	0	0
1	51416963	.	C	T	1	1	2	0	0	2	0	0
1	51417125	.	C	G	5	0	5	0	6	11	0	0
1	51424779	.	A	T	4	12	16	0	1	17	0	0
1	51424813	.	G	A	1	6	7	0	5	12	0	0
1	51425221	.	G	T	0	8	8	0	6	14	0	0
1	51425296	.	G	A	9	5	14	0	0	14	0	0
1	51426834	.	A	T	1	7	8	0	0	8	0	0
1	51427152	.	G	T	9	8	17	0	0	17	0	0
1	51427153	.	G	T	8	7	15	0	2	17	0	0
1	51427671	.	G	T	9	16	25	0	1	26	0	0
1	51427779	.	T	C	15	10	25	0	0	25	0	0
1	51427837	.	A	C	25	10	35	0	0	35	0	0
1	51445437	.	A	T	6	11	17	0	0	17	0	0
1	51445450	.	A	T	5	14	19	0	0	19	0	0
1	51445598	.	T	C	5	0	5	0	5	10	0	0
1	51445732	.	A	G	6	11	17	0	3	20	0	0
1	51446004	.	G	A	1	3	4	0	0	4	0	0
1	51446030	.	C	A	1	1	2	0	0	2	0	0
1	51446230	.	T	A	4	3	7	0	0	7	0	0
1	51446451	.	C	T	3	4	7	0	0	7	0	0
1	51446462	.	C	T	4	3	7	0	0	7	0	0
1	51446511	.	G	A	3	2	5	0	0	5	0	0
1	51446597	.	A	T	4	5	9	0	0	9	0	0
1	51447543	.	T	G	4	5	9	0	0	9	0	0
1	51448249	.	C	A	9	4	13	0	0	13	0	0
1	51448485	.	C	T	6	7	13	0	1	14	0	0
1	51448517	.	C	T	6	3	9	0	1	10	0	0
1	51448781	.	A	G	2	2	4	0	0	4	0	0
1	51449298	.	T	C	5	2	7	0	0	7	0	0
1	51449543	.	G	A	4	3	7	0	0	7	0	0
1	51449556	.	G	A	3	3	6	0	0	6	0	0
1	51449720	.	G	A	2	3	5	0	0	5	0	0
1	51450018	.	C	T	0	3	3	0	2	5	0	0
1	51450180	.	C	T	0	2	2	0	4	6	0	0
1	51450713	.	G	A	1	1	2	0	0	2	0	0
1	51450752	.	G	A	1	2	3	0	0	3	0	0
1	51557903	.	C	T	1	23	24	0	15	39	0	0
1	51558133	.	G	T	20	7	27	0	2	29	0	0
1	51558150	.	A	T	16	8	24	0	1	25	0	0
1	51558354	.	T	A	12	10	22	0	6	28	0	0
1	51558463	.	G	A	34	13	47	0	0	47	0	0
1	51558730	.	G	T	20	23	43	0	3	46	0	0
1	51558897	.	T	A	21	25	46	0	0	46	0	0
1	51558903	.	A	C	24	19	43	0	0	43	0	0
1	51559269	.	G	C	14	19	33	0	1	34	0	0
1	51559815	.	C	T	22	8	30	0	1	31	0	0
1	51562803	.	T	C	8	11	19	0	0	19	0	0
1	51594058	.	A	T	9	11	20	0	2	22	0	0
1	51594068	.	A	C	12	3	15	0	2	17	0	0
1	51594453	.	A	G	22	18	40	0	0	40	0	0
1	51594690	.	C	G	0	15	15	0	18	33	0	0
1	51594701	.	C	T	0	17	17	0	16	33	0	0
1	51594883	.	C	T	0	2	2	0	1	3	0	0
1	51606302	.	C	G	7	2	9	0	1	10	0	0
1	51612371	.	G	T	10	21	31	0	0	32	1	0
1	51612408	.	C	G	14	25	39	0	1	40	0	0
1	51615110	.	T	C	10	0	10	0	6	16	0	0
1	51702259	.	C	T	0	2	2	0	5	7	0	0
1	51702266	.	T	C	2	4	6	0	0	6	0	0
1	51703824	.	C	T	3	4	7	0	0	7	0	0
1	51710007	.	C	T	1	3	4	0	0	4	0	0
1	51712960	.	G	A	4	2	6	0	0	6	0	0
1	51712983	.	A	G	9	3	12	0	0	12	0	0
1	51713077	.	G	A	6	5	11	0	0	11	0	0
1	51713468	.	C	T	1	0	1	0	0	1	0	0
1	51719005	.	G	A	3	0	3	0	0	3	0	0
1	51721923	.	T	G	1	1	2	0	0	2	0	0
1	51723093	.	T	G	6	0	6	0	5	11	0	0
1	51726524	.	C	T	10	9	19	0	0	19	0	0
1	51727432	.	C	A	3	5	8	0	0	8	0	0
1	51729605	.	G	A	10	11	21	0	1	22	0	0
1	51729608	.	G	T	10	12	22	0	1	23	0	0
1	51729645	.	A	C	13	7	20	0	2	22	0	0
1	51729687	.	C	T	4	9	13	0	0	13	0	0
1	51729697	.	C	A	3	11	14	0	2	16	0	0
1	51729735	.	C	A	12	13	25	0	0	25	0	0
1	51729798	.	A	C	7	10	17	0	0	17	0	0
1	51733129	.	T	A	7	11	18	0	0	18	0	0
1	51733284	.	T	A	19	13	32	0	1	33	0	0
1	51903897	.	A	T	1	1	2	0	0	2	0	0
1	51903903	.	A	T	1	2	3	0	0	3	0	0
1	51960576	.	G	C	1	1	2	0	1	3	0	0
1	52054116	.	A	G	1	1	2	0	0	2	0	0
1	52073807	.	C	G	1	0	1	0	0	1	0	0
1	52113225	.	T	C	1	1	2	0	5	7	0	0
1	52113251	.	G	A	2	6	8	0	0	8	0	0
1	52113274	.	C	T	5	2	7	0	0	7	0	0
1	52115862	.	C	T	1	3	4	0	10	14	0	0
1	52115880	.	G	C	9	3	12	0	1	13	0	0
1	52117007	.	T	C	0	0	0	0	1	1	0	0
1	52121311	.	A	G	2	4	6	0	1	7	0	0
1	52121450	.	C	T	0	1	1	0	0	1	0	0
1	52124240	.	C	T	0	6	6	0	3	9	0	0
1	52130268	.	G	A	0	8	8	0	11	19	0	0
1	52130328	.	T	C	8	6	14	0	7	21	0	0
1	52130339	.	A	G	10	6	16	0	5	21	0	0
1	52130431	.	G	A	7	13	20	0	0	20	0	0
1	52134992	.	G	A	0	4	4	0	0	4	0	0
1	52135254	.	T	C	16	8	24	0	0	24	0	0
1	52135303	.	T	C	8	7	15	0	0	15	0	0
1	52135513	.	G	A	6	5	11	0	0	11	0	0
1	52135840	.	C	A	11	4	15	0	0	15	0	0
1	52135972	.	A	T	15	8	23	0	0	23	0	0
1	52136027	.	T	C	13	9	22	0	3	25	0	0
1	52136117	.	A	C	11	8	19	0	2	21	0	0
1	52136294	.	T	C	9	3	12	0	0	12	0	0
1	52136454	.	A	C	10	8	18	0	0	18	0	0
1	52136641	.	A	G	12	2	14	0	0	14	0	0
1	52136759	.	A	T	17	16	33	0	0	33	0	0
1	52136762	.	A	C	16	16	32	0	1	33	0	0
1	52136868	.	A	G	7	16	23	0	1	24	0	0
1	52136894	.	T	C	10	17	27	0	0	27	0	0
1	52136917	.	A	C	7	17	24	0	1	25	0	0
1	52137013	.	T	A	8	9	17	0	1	18	0	0
1	52137147	.	T	A	2	4	6	0	1	7	0	0
1	52137152	.	T	A	2	5	7	0	0	7	0	0
1	52137580	.	T	C	4	2	6	0	0	6	0	0
1	52137591	.	T	C	4	2	6	0	0	6	0	0
1	52137639	.	A	G	9	9	18	0	2	20	0	0
1	52146021	.	A	T	9	6	15	0	0	15	0	0
1	52149554	.	A	T	14	21	35	0	9	44	0	0
1	52149794	.	A	G	15	6	21	0	2	23	0	0
1	52149952	.	A	G	9	1	10	0	8	18	0	0
1	52149977	.	T	A	8	7	15	0	1	16	0	0
1	52150029	.	T	C	17	7	24	0	2	26	0	0
1	52150152	.	G	A	9	8	17	0	3	20	0	0
1	52150182	.	G	T	0	11	11	0	14	25	0	0
1	52150231	.	C	T	15	10	25	0	0	25	0	0
1	52150400	.	A	G	13	4	17	0	0	17	0	0
1	52150812	.	A	G	10	11	21	0	0	21	0	0
1	52150826	.	A	G	12	6	18	0	0	18	0	0
1	52150900	.	G	T	6	7	13	0	0	13	0	0
1	52151311	.	A	G	2	4	6	0	0	6	0	0
1	52151865	.	T	C	4	5	9	0	0	9	0	0
1	52152043	.	A	G	6	4	10	0	1	11	0	0
1	52152188	.	G	A	0	13	13	0	14	27	0	0
1	52152202	.	A	G	12	13	25	0	1	26	0	0
1	52152300	.	A	T	6	11	17	0	0	17	0	0
1	52152363	.	A	G	19	4	23	0	2	25	0	0
1	52152398	.	T	C	11	21	32	0	1	34	1	0
1	52152406	.	A	C	13	18	31	0	3	34	0	0
1	52152488	.	A	G	11	21	32	0	0	32	0	0
1	52179066	.	C	T	0	9	9	0	6	15	0	0
1	52198293	.	T	G	3	2	5	0	0	5	0	0
1	52452275	.	G	T	4	5	9	0	2	11	0	0
1	52452332	.	C	T	3	2	5	0	1	6	0	0
1	52455908	.	G	A	6	5	11	0	0	11	0	0
1	52455960	.	C	T	8	7	15	0	0	15	0	0
1	52456002	.	G	A	0	2	2	0	0	2	0	0
1	52460737	.	C	T	11	5	16	0	0	16	0	0
1	52460739	.	T	C	9	5	14	0	2	16	0	0
1	52460906	.	T	C	1	4	5	0	1	6	0	0
1	52460944	.	G	T	6	8	14	0	0	14	0	0
1	52471788	.	G	A	2	0	2	0	0	2	0	0
1	52478413	.	G	A	0	2	2	0	1	3	0	0
1	52478600	.	A	T	3	4	7	0	0	7	0	0
1	52482756	.	C	T	1	2	3	0	0	3	0	0
1	52486008	.	G	A	0	1	1	0	3	4	0	0
1	52486125	.	T	C	5	2	7	0	0	7	0	0
1	52486198	.	A	G	3	1	4	0	4	8	0	0
1	52486209	.	A	G	3	3	6	0	2	8	0	0
1	52486772	.	C	G	1	5	6	0	0	6	0	0
1	52489974	.	G	A	1	2	3	0	4	7	0	0
1	52495004	.	T	A	1	1	2	0	0	2	0	0
1	52495045	.	C	T	0	2	2	0	2	4	0	0
1	52495082	.	C	G	1	2	3	0	0	3	0	0
1	52495088	.	G	A	0	2	2	0	1	3	0	0
1	52501213	.	A	C	3	0	3	0	1	4	0	0
1	52501794	.	T	C	2	2	4	0	0	4	0	0
1	52501800	.	G	A	2	2	4	0	0	4	0	0
1	52538330	.	A	G	0	2	2	0	1	3	0	0
1	52560607	.	G	A	0	3	3	0	2	5	0	0
1	52598538	.	C	T	2	3	5	0	0	5	0	0
1	52598549	.	A	G	3	3	6	0	0	6	0	0
1	52609654	.	T	G	1	0	1	0	1	2	0	0
1	52610788	.	G	A	1	3	4	0	0	4	0	0
1	52611769	.	G	T	0	2	2	0	2	4	0	0
1	52611963	.	A	G	2	1	3	0	0	3	0	0
1	52614253	.	C	T	1	2	3	0	1	4	0	0
1	52614377	.	C	T	3	2	5	0	0	5	0	0
1	52615031	.	C	T	2	1	3	0	0	3	0	0
1	52618405	.	C	T	11	9	20	0	0	20	0	0
1	52621542	.	C	T	1	5	6	0	0	6	0	0
1	52621545	.	C	T	1	3	4	0	2	6	0	0
1	52623591	.	G	A	2	1	3	0	1	4	0	0
1	52625747	.	C	G	9	2	11	0	6	17	0	0
1	52626826	.	T	A	4	5	9	0	2	11	0	0
1	52627572	.	G	A	0	24	24	0	21	45	0	0
1	52627678	.	A	T	20	11	31	0	4	35	0	0
1	52627679	.	C	T	21	12	33	0	2	35	0	0
1	52627794	.	G	A	14	9	23	0	0	23	0	0
1	52627984	.	T	C	12	13	25	0	0	25	0	0
1	52628253	.	G	T	11	8	19	0	0	19	0	0
1	52628322	.	A	T	4	7	11	0	1	12	0	0
1	52655415	.	C	T	0	2	2	0	2	4	0	0
1	52655421	.	G	A	2	2	4	0	0	4	0	0
1	52659459	.	T	C	3	1	4	0	0	4	0	0
1	52659498	.	A	G	2	1	3	0	0	3	0	0
1	52676495	.	G	A	1	2	3	0	0	3	0	0
1	52681212	.	T	C	1	5	6	0	0	6	0	0
1	52681296	.	C	A	1	2	3	0	0	3	0	0
1	52685099	.	G	A	0	2	2	0	0	2	0	0
1	52685145	.	A	C	2	0	2	0	0	2	0	0
1	52688151	.	C	T	1	0	1	0	0	1	0	0
1	52688223	.	G	A	0	3	3	0	5	8	0	0
1	52698944	.	G	T	5	6	11	0	0	11	0	0
1	52698955	.	C	T	5	7	12	0	0	12	0	0
1	52764824	.	A	T	9	9	18	0	0	18	0	0
1	52773311	.	A	G	4	6	10	0	0	10	0	0
1	52775649	.	A	G	13	13	26	0	2	28	0	0
1	52779785	.	G	A	6	12	18	0	0	18	0	0
1	52782161	.	G	A	9	11	20	0	2	22	0	0
1	52782220	.	G	T	9	3	12	0	0	12	0	0
1	52784483	.	C	A	2	7	9	0	0	9	0	0
1	52784527	.	C	T	0	5	5	0	3	8	0	0
1	52784549	.	A	T	6	3	9	0	1	10	0	0
1	52784600	.	G	A	4	3	7	0	0	7	0	0
1	52784679	.	G	C	5	4	9	0	0	9	0	0
1	52784702	.	G	A	6	8	14	0	0	14	0	0
1	52792476	.	C	A	0	9	9	0	0	9	0	0
1	52796142	.	T	C	1	4	5	0	0	5	0	0
1	52796148	.	A	G	1	3	4	0	1	5	0	0
1	52796844	.	T	G	1	0	1	0	0	1	0	0
1	52796850	.	C	T	1	1	2	0	0	2	0	0
1	52796964	.	T	C	5	3	8	0	0	8	0	0
1	52797128	.	C	T	2	1	3	0	0	3	0	0
1	52797152	.	T	C	2	1	3	0	2	5	0	0
1	52798991	.	T	C	6	1	7	0	0	7	0	0
1	52798994	.	C	T	6	0	6	0	1	7	0	0
1	52812162	.	G	A	3	4	7	0	0	7	0	0
1	52812219	.	C	G	10	4	14	0	1	15	0	0
1	52813633	.	A	T	13	9	22	0	0	22	0	0
1	52817949	.	C	G	0	3	3	0	1	4	0	0
1	53007935	.	A	G	4	7	11	0	2	13	0	0
1	53025666	.	C	T	0	1	1	0	0	1	0	0
1	53025708	.	C	G	0	1	1	0	0	1	0	0
1	53025711	.	C	T	0	1	1	0	0	1	0	0
1	53132860	.	T	C	1	2	3	0	0	3	0	0
1	53156324	.	A	G	6	7	13	0	0	13	0	0
1	53156413	.	C	T	4	1	5	0	0	5	0	0
1	53166094	.	A	G	3	10	13	0	1	14	0	0
1	53168227	.	A	G	10	0	10	0	7	17	0	0
1	53185877	.	A	C	3	1	4	0	0	4	0	0
1	53185906	.	T	C	6	2	8	0	1	9	0	0
1	53185945	.	T	C	11	6	17	0	2	19	0	0
1	53234989	.	C	T	1	3	4	0	0	4	0	0
1	53259727	.	T	G	1	2	3	0	0	3	0	0
1	53259731	.	A	C	2	2	4	0	0	4	0	0
1	53267349	.	A	G	4	4	8	0	1	9	0	0
1	53269670	.	A	C	8	3	11	0	0	11	0	0
1	53269694	.	A	G	2	0	2	0	0	2	0	0
1	53277043	.	T	C	2	2	4	0	3	7	0	0
1	53277064	.	C	T	3	5	8	0	0	8	0	0
1	53296759	.	T	A	1	2	3	0	0	3	0	0
1	53296792	.	A	G	2	0	2	0	2	4	0	0
1	53298561	.	C	T	1	1	2	0	0	2	0	0
1	53334460	.	C	T	1	4	5	0	0	5	0	0
1	53338551	.	T	C	1	3	4	0	0	4	0	0
1	53341664	.	A	G	5	0	5	0	0	5	0	0
1	53343124	.	G	A	2	4	6	0	0	6	0	0
1	53344200	.	T	C	2	5	7	0	1	8	0	0
1	53344204	.	T	G	2	6	8	0	0	8	0	0
1	53348920	.	A	G	3	4	7	0	0	7	0	0
1	53352481	.	T	C	2	1	3	0	0	3	0	0
1	53359002	.	C	T	1	0	1	0	1	2	0	0
1	53360153	.	T	C	11	11	22	0	1	23	0	0
1	53360308	.	G	A	9	8	17	0	1	18	0	0
1	53360342	.	C	T	8	9	17	0	0	17	0	0
1	53360369	.	C	T	6	9	15	0	1	16	0	0
1	53360459	.	C	T	9	19	28	0	1	29	0	0
1	53360549	.	T	C	13	13	26	0	1	27	0	0
1	53360871	.	G	A	3	6	9	0	1	10	0	0
1	53387431	.	T	A	4	3	7	0	0	7	0	0
1	53387573	.	T	C	1	2	3	0	0	3	0	0
1	53387633	.	T	A	2	2	4	0	0	4	0	0
1	53387722	.	G	A	1	7	8	0	0	8	0	0
1	53387779	.	T	G	1	6	7	0	0	7	0	0
1	53387786	.	C	T	2	7	9	0	0	9	0	0
1	53387829	.	C	T	5	4	9	0	1	10	0	0
1	53387954	.	A	G	3	5	8	0	1	9	0	0
1	53387990	.	T	C	5	3	8	0	0	8	0	0
1	53388005	.	T	C	7	5	12	0	0	12	0	0
1	53388135	.	A	C	11	11	22	0	0	22	0	0
1	53388309	.	G	C	10	10	20	0	1	21	0	0
1	53388476	.	A	C	4	8	12	0	2	14	0	0
1	53388540	.	T	A	10	9	19	0	1	20	0	0
1	53388590	.	T	G	12	8	20	0	0	20	0	0
1	53391669	.	A	C	20	9	29	0	0	29	0	0
1	53391729	.	T	C	19	0	19	0	5	24	0	0
1	53391860	.	G	T	4	2	6	0	1	7	0	0
1	53392002	.	A	T	8	9	17	0	1	18	0	0
1	53392064	.	T	C	19	0	19	0	12	31	0	0
1	53392161	.	T	C	5	8	13	0	0	13	0	0
1	53392220	.	C	A	0	4	4	0	4	8	0	0
1	53392227	.	A	T	3	5	8	0	0	8	0	0
1	53392266	.	T	A	3	2	5	0	0	5	0	0
1	53393510	.	C	T	0	4	4	0	1	5	0	0
1	53395011	.	T	C	1	5	6	0	1	7	0	0
1	53395012	.	G	A	1	3	4	0	3	7	0	0
1	53395328	.	C	T	2	2	4	0	0	4	0	0
1	53395342	.	A	G	2	2	4	0	0	4	0	0
1	53395627	.	T	C	2	3	5	0	1	6	0	0
1	53395688	.	G	A	2	2	4	0	0	4	0	0
1	53395710	.	G	C	1	3	4	0	0	4	0	0
1	53395828	.	G	A	8	11	19	0	1	20	0	0
1	53401794	.	T	C	1	2	3	0	0	3	0	0
1	53403876	.	T	A	1	2	3	0	0	3	0	0
1	53491565	.	A	G	11	3	14	0	2	16	0	0
1	53491937	.	A	G	11	6	17	0	0	17	0	0
1	53491964	.	T	A	8	6	14	0	4	18	0	0
1	53492000	.	C	A	11	5	16	0	0	16	0	0
1	53568645	.	A	G	4	2	6	0	0	6	0	0
1	53668926	.	C	A	0	0	0	0	1	1	0	0
1	53669651	.	A	G	1	3	4	0	0	4	0	0
1	53670917	.	G	T	0	0	0	0	1	1	0	0
1	53672795	.	G	A	4	2	6	0	0	6	0	0
1	53684729	.	C	T	1	5	6	0	0	6	0	0
1	53701875	.	A	G	7	12	19	0	0	19	0	0
1	53701905	.	T	G	1	8	9	0	0	9	0	0
1	53703194	.	G	T	12	17	29	0	2	31	0	0
1	53704485	.	C	A	15	18	33	0	3	36	0	0
1	53705191	.	G	A	3	5	8	0	1	9	0	0
1	53705203	.	G	A	6	13	19	0	2	21	0	0
1	53705266	.	A	G	14	13	27	0	2	29	0	0
1	53709732	.	C	A	0	13	13	0	12	25	0	0
1	53709762	.	C	T	11	10	21	0	0	21	0	0
1	53713449	.	G	T	2	4	6	0	0	6	0	0
1	53714586	.	A	G	0	2	2	0	1	3	0	0
1	53714592	.	T	G	2	3	5	0	0	5	0	0
1	53714790	.	T	A	15	15	30	0	1	31	0	0
1	53715069	.	T	G	0	0	0	0	3	3	0	0
1	53715083	.	G	A	0	2	2	0	0	2	0	0
1	53720360	.	T	G	0	1	1	0	0	1	0	0
1	53722489	.	A	T	1	1	2	0	0	2	0	0
1	53724724	.	T	A	4	5	9	0	1	10	0	0
1	53726457	.	G	A	0	1	1	0	0	1	0	0
1	53727755	.	C	T	2	2	4	0	1	5	0	0
1	53729997	.	C	T	0	1	1	0	1	2	0	0
1	53735245	.	C	T	13	5	18	0	0	18	0	0
1	53735249	.	C	T	12	5	17	0	1	18	0	0
1	53735648	.	A	G	13	16	29	0	0	29	0	0
1	53735702	.	T	G	5	5	10	0	0	11	1	0
1	53735712	.	G	A	4	5	9	0	0	9	0	0
1	53739397	.	G	A	9	7	16	0	0	16	0	0
1	53756723	.	C	T	0	7	7	0	19	26	0	0
1	53865940	.	T	G	1	1	2	0	0	2	0	0
1	53866223	.	A	T	4	2	6	0	0	6	0	0
1	53871326	.	T	A	0	3	3	0	0	3	0	0
1	53871338	.	C	A	3	0	3	0	0	3	0	0
1	53871383	.	A	G	3	5	8	0	0	8	0	0
1	53871416	.	C	A	4	2	6	0	0	6	0	0
1	53872031	.	C	A	7	3	10	0	0	10	0	0
1	53873112	.	T	C	7	0	7	0	7	14	0	0
1	53879314	.	T	A	1	0	1	0	0	1	0	0
1	53879397	.	C	T	3	5	8	0	0	8	0	0
1	53912307	.	A	G	2	2	4	0	0	4	0	0
1	53912607	.	T	C	2	0	2	0	3	5	0	0
1	53913130	.	G	A	1	2	3	0	0	3	0	0
1	53919292	.	A	G	1	2	3	0	0	3	0	0
1	53921786	.	G	A	0	2	2	0	0	2	0	0
1	53929218	.	G	A	3	3	6	0	0	6	0	0
1	53929219	.	C	A	3	3	6	0	0	6	0	0
1	53932271	.	A	G	2	3	5	0	0	5	0	0
1	53935236	.	G	A	1	2	3	0	1	4	0	0
1	53935248	.	G	T	0	3	3	0	3	6	0	0
1	53935287	.	A	G	3	0	3	0	3	6	0	0
1	53935314	.	T	C	2	2	4	0	0	4	0	0
1	53937423	.	C	T	1	2	3	0	0	3	0	0
1	53939430	.	A	G	4	3	7	0	0	7	0	0
1	53939604	.	C	T	2	1	3	0	0	3	0	0
1	53954314	.	G	A	0	5	5	0	10	15	0	0
1	53954361	.	C	A	8	6	14	0	1	15	0	0
1	53954385	.	A	C	5	3	8	0	0	8	0	0
1	53955055	.	G	A	6	8	14	0	0	14	0	0
1	53958136	.	G	A	0	11	11	0	10	21	0	0
1	53958263	.	C	T	11	14	25	0	2	27	0	0
1	53962227	.	A	T	5	2	7	0	2	9	0	0
1	53962264	.	T	C	7	6	13	0	3	16	0	0
1	53962490	.	T	G	14	8	22	0	1	23	0	0
1	53962860	.	G	A	0	6	6	0	4	10	0	0
1	53962863	.	C	T	5	6	11	0	0	11	0	0
1	53962900	.	T	A	5	6	11	0	0	11	0	0
1	53962961	.	C	T	8	3	11	0	0	11	0	0
1	53963108	.	C	A	10	7	17	0	0	17	0	0
1	53963159	.	C	T	11	11	22	0	0	22	0	0
1	53963263	.	T	C	3	2	5	0	0	5	0	0
1	53963264	.	G	A	3	2	5	0	0	5	0	0
1	53963782	.	A	G	4	9	13	0	1	14	0	0
1	53980283	.	A	G	1	2	3	0	0	3	0	0
1	53980293	.	A	G	1	1	2	0	1	3	0	0
1	53980446	.	C	T	0	4	4	0	0	4	0	0
1	54022391	.	G	C	3	2	5	0	0	5	0	0
1	54022438	.	T	C	3	3	6	0	0	6	0	0
1	54022458	.	T	C	2	3	5	0	0	5	0	0
1	54022669	.	A	T	1	2	3	0	0	3	0	0
1	54022701	.	G	A	1	2	3	0	0	3	0	0
1	54025576	.	A	G	1	1	2	0	4	6	0	0
1	54048786	.	G	A	3	2	5	0	1	6	0	0
1	54061812	.	C	T	1	3	4	0	0	4	0	0
1	54061824	.	C	T	2	3	5	0	0	5	0	0
1	54062020	.	G	A	1	4	5	0	0	5	0	0
1	54062551	.	T	A	1	2	3	0	0	3	0	0
1	54062754	.	G	A	1	3	4	0	0	4	0	0
1	54062858	.	A	G	2	6	8	0	1	9	0	0
1	54069513	.	G	T	1	2	3	0	0	3	0	0
1	54069515	.	C	A	1	2	3	0	0	3	0	0
1	54070981	.	G	A	0	1	1	0	0	1	0	0
1	54073171	.	C	T	1	0	1	0	0	1	0	0
1	54075326	.	A	G	0	1	1	0	0	1	0	0
1	54077472	.	T	C	0	1	1	0	0	1	0	0
1	54080189	.	T	G	4	0	4	0	8	12	0	0
1	54080361	.	T	G	1	1	2	0	1	3	0	0
1	54080516	.	T	C	1	5	6	0	0	6	0	0
1	54080550	.	T	G	0	1	1	0	1	2	0	0
1	54084473	.	G	C	6	5	11	0	0	11	0	0
1	54084613	.	G	A	0	3	3	0	3	6	0	0
1	54084616	.	C	T	2	4	6	0	0	6	0	0
1	54092621	.	T	C	1	0	1	0	2	3	0	0
1	54137238	.	A	G	3	4	7	0	1	8	0	0
1	54140472	.	A	T	0	1	1	0	0	1	0	0
1	54142097	.	T	C	0	3	3	0	0	3	0	0
1	54142130	.	G	T	0	5	5	0	1	6	0	0
1	54144024	.	T	G	3	0	3	0	1	4	0	0
1	54146383	.	C	T	6	5	11	0	0	11	0	0
1	54146416	.	T	C	9	7	16	0	1	17	0	0
1	54154371	.	T	C	6	0	6	0	6	12	0	0
1	54154383	.	T	G	7	4	11	0	1	12	0	0
1	54161774	.	A	G	0	3	3	0	1	4	0	0
1	54167196	.	G	A	2	3	5	0	0	5	0	0
1	54167551	.	T	C	1	0	1	0	2	3	0	0
1	54178755	.	G	C	5	5	10	0	0	10	0	0
1	54190661	.	A	G	1	3	4	0	0	4	0	0
1	54195029	.	T	C	0	1	1	0	0	1	0	0
1	54197443	.	G	A	1	1	2	0	1	3	0	0
1	54199009	.	G	A	1	2	3	0	0	3	0	0
1	54210220	.	A	G	1	1	2	0	0	2	0	0
1	54219462	.	A	G	1	0	1	0	4	5	0	0
1	54244041	.	T	C	2	5	7	0	0	7	0	0
1	54244432	.	T	C	1	5	6	0	0	6	0	0
1	54245914	.	G	A	4	3	7	0	0	7	0	0
1	54248366	.	A	C	2	1	3	0	0	3	0	0
1	54253768	.	G	A	0	2	2	0	1	3	0	0
1	54255651	.	C	T	7	8	15	0	3	18	0	0
1	54262843	.	G	A	0	1	1	0	1	2	0	0
1	54327034	.	C	T	0	2	2	0	1	3	0	0
1	54674027	.	A	T	1	2	3	0	0	3	0	0
1	54674388	.	A	G	4	6	10	0	0	10	0	0
1	54674430	.	A	G	5	0	5	0	9	14	0	0
1	54683743	.	C	T	1	0	1	0	0	1	0	0
1	54685468	.	T	A	5	3	8	0	2	10	0	0
1	54685590	.	A	G	8	4	12	0	0	12	0	0
1	54685610	.	T	C	6	4	10	0	1	11	0	0
1	54687580	.	C	T	6	3	9	0	0	9	0	0
1	54687649	.	G	T	6	9	15	0	0	15	0	0
1	54687715	.	C	A	2	8	10	0	0	10	0	0
1	54687756	.	A	C	2	7	9	0	0	9	0	0
1	54687766	.	A	C	4	8	12	0	0	12	0	0
1	54687798	.	A	C	8	10	18	0	0	18	0	0
1	54687928	.	G	T	8	4	12	0	0	12	0	0
1	54687981	.	A	G	6	6	12	0	0	12	0	0
1	54701201	.	C	G	1	1	2	0	4	6	0	0
1	54701231	.	G	A	2	3	5	0	0	5	0	0
1	54707977	.	G	A	31	24	55	0	4	59	0	0
1	54708098	.	G	T	35	29	64	0	3	67	0	0
1	54708191	.	C	A	29	28	57	0	2	59	0	0
1	54708253	.	G	A	25	29	54	0	6	60	0	0
1	54708281	.	A	T	27	22	49	0	3	52	0	0
1	54708301	.	A	C	28	20	48	0	1	49	0	0
1	54708317	.	C	T	29	13	42	0	3	45	0	0
1	54708359	.	C	T	28	16	44	0	1	45	0	0
1	54708551	.	C	T	11	8	19	0	3	22	0	0
1	54708679	.	T	C	1	13	14	0	0	14	0	0
1	54708886	.	C	T	0	8	8	0	9	17	0	0
1	54709334	.	G	A	28	18	46	0	2	48	0	0
1	54737506	.	C	A	3	7	10	0	0	10	0	0
1	54747720	.	T	C	3	2	5	0	0	5	0	0
1	54747729	.	A	G	3	0	3	0	2	5	0	0
1	54748062	.	T	G	1	0	1	0	6	7	0	0
1	54753167	.	A	G	3	3	6	0	0	6	0	0
1	54753173	.	G	C	0	2	2	0	3	5	0	0
1	54753687	.	A	T	1	3	4	0	0	4	0	0
1	54754356	.	C	T	8	7	15	0	1	16	0	0
1	54754482	.	T	G	12	9	21	0	0	21	0	0
1	54754503	.	G	A	13	6	19	0	0	19	0	0
1	54754550	.	C	A	5	4	9	0	1	10	0	0
1	54754565	.	C	T	6	4	10	0	2	12	0	0
1	54754623	.	A	T	6	2	8	0	2	10	0	0
1	54754626	.	T	A	6	2	8	0	1	9	0	0
1	54754744	.	C	T	2	6	8	0	0	8	0	0
1	54754754	.	T	C	2	7	9	0	0	9	0	0
1	54755390	.	G	T	4	1	5	0	0	5	0	0
1	54758624	.	A	T	7	4	11	0	0	11	0	0
1	54758725	.	C	T	0	20	20	0	9	29	0	0
1	54758810	.	C	T	15	10	25	0	1	26	0	0
1	54758975	.	T	C	15	24	39	0	1	40	0	0
1	54759065	.	G	A	4	10	14	0	0	14	0	0
1	54762947	.	G	A	3	1	4	0	0	4	0	0
1	54762997	.	G	T	12	14	26	0	1	27	0	0
1	54763022	.	G	C	9	16	25	0	0	25	0	0
1	54763106	.	A	G	3	7	10	0	0	10	0	0
1	54763133	.	T	C	4	5	9	0	2	11	0	0
1	54763182	.	A	G	10	11	21	0	1	22	0	0
1	54763187	.	G	A	9	11	20	0	2	22	0	0
1	54763298	.	G	A	1	6	7	0	0	7	0	0
1	54765216	.	A	C	16	1	17	0	16	33	0	0
1	54765218	.	C	T	0	16	16	0	17	33	0	0
1	54772474	.	C	T	0	2	2	0	1	3	0	0
1	54772483	.	A	C	1	2	3	0	0	3	0	0
1	54893126	.	C	G	1	2	3	0	0	3	0	0
1	54893140	.	G	A	0	1	1	0	3	4	0	0
1	54893265	.	G	C	3	1	4	0	0	4	0	0
1	54897256	.	C	T	3	3	6	0	0	6	0	0
1	54897288	.	C	T	3	1	4	0	0	4	0	0
1	54898178	.	G	A	0	2	2	0	1	3	0	0
1	54898238	.	C	T	0	1	1	0	0	1	0	0
1	54906069	.	T	C	1	0	1	0	0	1	0	0
1	54906192	.	T	C	1	0	1	0	0	1	0	0
1	54906476	.	G	C	0	2	2	0	3	5	0	0
1	54906619	.	T	A	5	3	8	0	0	8	0	0
1	54907021	.	G	A	2	5	7	0	1	8	0	0
1	54907549	.	T	C	13	4	17	0	0	17	0	0
1	54907585	.	G	C	11	7	18	0	1	19	0	0
1	54907600	.	A	T	9	7	16	0	1	17	0	0
1	54907622	.	T	C	12	7	19	0	0	19	0	0
1	54907698	.	G	T	7	6	13	0	0	13	0	0
1	54907707	.	C	T	8	5	13	0	0	13	0	0
1	54927198	.	T	C	2	2	4	0	0	4	0	0
1	54929168	.	G	A	14	11	25	0	1	26	0	0
1	54929256	.	T	C	5	10	15	0	0	15	0	0
1	54929281	.	G	A	0	9	9	0	7	16	0	0
1	54929293	.	C	T	6	9	15	0	0	15	0	0
1	54929994	.	T	C	9	4	13	0	1	15	1	0
1	54930316	.	G	A	4	3	7	0	0	7	0	0
1	54930428	.	T	A	9	10	19	0	3	22	0	0
1	54930486	.	G	A	8	4	12	0	0	12	0	0
1	54930598	.	A	G	6	10	16	0	1	17	0	0
1	54930626	.	A	C	5	11	16	0	0	16	0	0
1	54930693	.	T	C	9	4	13	0	2	15	0	0
1	54930711	.	G	A	10	9	19	0	0	19	0	0
1	54930776	.	A	G	7	10	17	0	0	17	0	0
1	54930868	.	C	A	8	3	11	0	0	11	0	0
1	54931111	.	T	C	6	9	15	0	2	17	0	0
1	54931122	.	G	A	0	10	10	0	7	17	0	0
1	54931211	.	A	T	4	11	15	0	1	16	0	0
1	54931230	.	T	A	5	14	19	0	0	19	0	0
1	54931791	.	G	C	2	9	11	0	10	21	0	0
1	54931862	.	A	G	6	3	9	0	0	9	0	0
1	54934639	.	T	A	1	4	5	0	0	5	0	0
1	54934658	.	T	G	1	4	5	0	0	5	0	0
1	54934690	.	T	C	0	6	6	0	0	6	0	0
1	54934694	.	G	T	0	6	6	0	0	6	0	0
1	54936471	.	T	C	13	0	13	0	14	27	0	0
1	54938274	.	T	C	4	3	7	0	0	7	0	0
1	54939536	.	A	T	2	3	5	0	0	5	0	0
1	54941036	.	G	A	2	4	6	0	0	6	0	0
1	54950534	.	T	C	6	16	22	0	0	22	0	0
1	54950572	.	G	A	8	13	21	0	2	23	0	0
1	54950661	.	G	A	13	6	19	0	0	19	0	0
1	54950801	.	A	G	3	3	6	0	0	6	0	0
1	54955207	.	G	A	1	3	4	0	1	5	0	0
1	54955234	.	A	G	2	3	5	0	1	6	0	0
1	54958033	.	G	A	0	3	3	0	7	10	0	0
1	54960328	.	A	G	11	10	21	0	0	21	0	0
1	54960368	.	T	G	14	15	29	0	2	31	0	0
1	54960416	.	A	C	19	16	35	0	1	36	0	0
1	54960563	.	T	A	15	13	28	0	3	31	0	0
1	54960881	.	A	G	11	23	34	0	7	41	0	0
1	54962466	.	A	G	6	7	13	0	1	14	0	0
1	54963314	.	A	G	14	16	30	0	0	30	0	0
1	54964724	.	A	G	14	16	30	0	0	30	0	0
1	54974321	.	C	T	2	2	4	0	0	4	0	0
1	54974437	.	C	A	3	2	5	0	0	5	0	0
1	54974438	.	A	G	3	2	5	0	0	5	0	0
1	54974477	.	G	A	4	1	5	0	0	5	0	0
1	54974500	.	T	A	3	8	11	0	0	11	0	0
1	54974538	.	A	G	4	12	16	0	1	17	0	0
1	54974660	.	T	C	7	5	12	0	2	14	0	0
1	54974774	.	G	A	10	6	16	0	0	16	0	0
1	54974810	.	G	T	10	3	13	0	0	13	0	0
1	54975136	.	A	T	8	11	19	0	0	19	0	0
1	54975155	.	A	G	8	6	14	0	0	14	0	0
1	54975284	.	C	G	0	1	1	0	0	1	0	0
1	54975286	.	C	T	0	1	1	0	0	1	0	0
1	54975404	.	C	T	0	4	4	0	5	9	0	0
1	54975431	.	C	T	4	6	10	0	0	10	0	0
1	54975484	.	G	T	9	6	15	0	0	15	0	0
1	54975519	.	C	T	8	7	15	0	0	15	0	0
1	54975636	.	C	T	6	5	11	0	1	12	0	0
1	54975658	.	A	G	8	3	11	0	1	12	0	0
1	54975762	.	A	T	4	6	10	0	0	10	0	0
1	54975884	.	A	G	9	4	13	0	0	13	0	0
1	54975911	.	G	A	5	4	9	0	0	9	0	0
1	54976026	.	T	A	6	9	15	0	0	15	0	0
1	54976035	.	T	A	4	9	13	0	0	13	0	0
1	54976104	.	G	A	5	5	10	0	0	10	0	0
1	54976178	.	T	C	7	0	7	0	6	13	0	0
1	54976213	.	T	C	11	4	15	0	1	16	0	0
1	54976249	.	T	A	13	8	21	0	0	21	0	0
1	54976256	.	C	T	13	11	24	0	0	24	0	0
1	54976731	.	C	T	4	2	6	0	1	7	0	0
1	54976732	.	A	G	4	3	7	0	0	7	0	0
1	54976768	.	T	C	2	1	3	0	0	3	0	0
1	54976769	.	T	C	2	1	3	0	0	3	0	0
1	54976827	.	T	C	2	5	7	0	0	7	0	0
1	54976835	.	C	T	2	6	8	0	0	8	0	0
1	54977057	.	A	G	5	5	10	1	1	12	0	0
1	54977572	.	G	A	3	6	9	0	0	9	0	0
1	54977618	.	G	A	5	4	9	0	0	9	0	0
1	54977697	.	G	A	5	4	9	0	0	9	0	0
1	54977719	.	T	A	5	1	6	0	1	7	0	0
1	54978022	.	T	G	1	3	4	0	0	4	0	0
1	54978023	.	C	T	0	3	3	0	1	4	0	0
1	54978478	.	T	C	5	4	9	0	0	9	0	0
1	54981628	.	G	A	5	3	8	0	0	8	0	0
1	54981706	.	C	T	2	1	3	0	0	3	0	0
1	54984172	.	A	G	3	6	9	0	0	9	0	0
1	54984206	.	T	C	3	0	3	0	5	8	0	0
1	54984587	.	C	T	0	1	1	0	1	2	0	0
1	54985320	.	C	T	3	7	10	0	0	10	0	0
1	54986910	.	T	C	1	0	1	0	0	1	0	0
1	54987539	.	A	G	3	1	4	0	0	4	0	0
1	54988259	.	G	A	4	5	9	0	0	9	0	0
1	55008322	.	A	G	13	8	21	0	0	21	0	0
1	55008382	.	C	T	13	10	23	0	1	24	0	0
1	55008405	.	G	A	12	9	21	0	2	23	0	0
1	55008772	.	T	C	5	9	14	0	2	16	0	0
1	55009513	.	C	A	2	3	5	0	0	5	0	0
1	55009618	.	A	G	3	2	5	0	1	6	0	0
1	55011353	.	G	C	2	3	5	0	0	5	0	0
1	55011514	.	C	T	4	12	16	0	1	17	0	0
1	55011539	.	A	T	7	10	17	0	1	18	0	0
1	55011550	.	G	A	7	10	17	0	1	18	0	0
1	55011692	.	C	T	0	3	3	0	5	8	0	0
1	55018538	.	G	A	1	0	1	0	0	1	0	0
1	55022075	.	T	C	2	0	2	0	2	4	0	0
1	55022162	.	T	A	1	3	4	0	1	5	0	0
1	55038186	.	G	A	3	0	3	0	0	3	0	0
1	55038249	.	A	G	6	3	9	0	0	9	0	0
1	55045973	.	T	A	3	3	6	0	0	6	0	0
1	55046026	.	A	T	1	2	3	0	0	3	0	0
1	55046591	.	G	A	3	5	8	0	0	8	0	0
1	55046697	.	C	G	1	2	3	0	0	3	0	0
1	55057587	.	A	C	0	0	0	0	1	1	0	0
1	55080832	.	A	G	4	2	6	0	0	6	0	0
1	55080840	.	A	G	6	0	6	0	3	9	0	0
1	55080893	.	G	C	2	1	3	0	0	3	0	0
1	55080905	.	A	G	2	1	3	0	0	3	0	0
1	55085782	.	A	G	0	0	0	0	2	2	0	0
1	55085830	.	A	T	3	3	6	0	0	6	0	0
1	55089078	.	T	A	5	4	9	0	1	10	0	0
1	55089115	.	G	T	0	2	2	0	5	7	0	0
1	55089120	.	G	T	5	2	7	0	0	7	0	0
1	55089316	.	G	A	0	5	5	0	5	10	0	0
1	55089328	.	G	A	4	6	10	0	0	10	0	0
1	55089396	.	C	T	3	6	9	0	1	10	0	0
1	55089449	.	G	A	5	5	10	0	0	10	0	0
1	55089825	.	T	A	5	4	9	0	0	9	0	0
1	55089877	.	C	T	4	4	8	0	2	10	0	0
1	55099316	.	T	C	6	8	14	0	0	14	0	0
1	55099411	.	G	A	5	6	11	0	0	11	0	0
1	55099880	.	C	G	6	5	11	0	3	14	0	0
1	55100378	.	G	A	1	9	10	0	10	20	0	0
1	55100397	.	G	C	6	9	15	0	0	15	0	0
1	55100422	.	T	A	6	7	13	0	0	13	0	0
1	55101439	.	C	A	1	4	5	0	0	5	0	0
1	55103163	.	A	C	8	8	16	0	1	17	0	0
1	55109717	.	A	T	4	12	16	0	0	16	0	0
1	55126626	.	A	C	4	0	4	0	6	10	0	0
1	55126635	.	G	A	6	3	9	0	0	9	0	0
1	55127910	.	C	T	1	3	4	0	0	4	0	0
1	55131337	.	A	T	6	10	16	0	0	16	0	0
1	55131359	.	A	T	5	6	11	0	0	11	0	0
1	55141839	.	C	T	1	2	3	0	0	3	0	0
1	55161252	.	T	C	7	0	7	0	2	9	0	0
1	55169244	.	G	C	6	2	8	0	1	9	0	0
1	55169260	.	G	A	4	8	12	0	1	13	0	0
1	55169349	.	G	C	7	5	12	0	0	12	0	0
1	55170051	.	T	A	6	10	16	0	1	17	0	0
1	55170161	.	C	A	5	3	8	0	1	9	0	0
1	55170856	.	T	C	2	0	2	0	7	9	0	0
1	55170866	.	T	C	6	0	6	0	5	11	0	0
1	55170920	.	C	T	4	3	7	0	0	7	0	0
1	55171249	.	G	A	7	6	13	0	1	14	0	0
1	55179434	.	C	T	1	1	2	0	0	2	0	0
1	55179470	.	C	T	0	1	1	0	0	1	0	0
1	55182808	.	C	T	5	6	11	0	0	11	0	0
1	55183074	.	G	A	2	2	4	0	2	6	0	0
1	55191256	.	A	T	3	5	8	0	0	8	0	0
1	55191471	.	T	C	10	1	11	0	11	22	0	0
1	55191559	.	G	A	5	13	18	0	1	19	0	0
1	55191675	.	A	G	10	5	15	0	0	15	0	0
1	55195384	.	G	T	4	5	9	0	0	9	0	0
1	55196024	.	G	T	7	7	14	0	0	14	0	0
1	55223241	.	G	C	0	3	3	0	1	4	0	0
1	55228575	.	C	T	0	2	2	0	0	2	0	0
1	55229456	.	A	G	0	4	4	0	0	4	0	0
1	55229531	.	T	A	1	1	2	0	0	2	0	0
1	55229767	.	T	C	0	0	0	0	1	1	0	0
1	55233785	.	G	T	0	2	2	0	0	2	0	0
1	55233984	.	C	T	0	1	1	0	1	2	0	0
1	55234020	.	A	G	2	2	4	0	0	4	0	0
1	55236239	.	G	A	1	2	3	0	0	3	0	0
1	55745816	.	C	T	1	2	3	0	0	3	0	0
1	55749954	.	C	T	1	2	3	0	1	4	0	0
1	55776909	.	A	C	17	4	21	0	0	25	4	0
1	55785527	.	C	A	1	28	29	0	34	63	0	0
1	55785654	.	C	T	15	23	38	0	1	39	0	0
1	55787507	.	A	G	3	6	9	0	0	9	0	0
1	55817658	.	T	C	5	0	5	0	9	14	0	0
1	55817661	.	A	T	5	9	14	0	0	14	0	0
1	55817728	.	C	T	2	5	7	0	0	7	0	0
1	55818073	.	T	C	1	5	6	0	0	6	0	0
1	55818218	.	A	T	4	6	10	0	0	10	0	0
1	55818319	.	T	C	2	4	6	0	0	6	0	0
1	55833185	.	G	A	4	3	7	0	0	7	0	0
1	55833276	.	C	T	3	4	7	0	0	7	0	0
1	55833281	.	C	T	3	3	6	0	0	6	0	0
1	55839132	.	G	C	5	3	8	0	1	9	0	0
1	55839282	.	A	C	3	5	8	0	0	8	0	0
1	55843902	.	C	T	17	16	33	0	4	37	0	0
1	55843968	.	G	A	15	25	40	0	1	41	0	0
1	55844044	.	T	A	17	14	31	0	2	33	0	0
1	55844401	.	A	G	20	20	40	0	0	40	0	0
1	55853320	.	G	A	6	7	13	0	0	13	0	0
1	55872892	.	C	G	12	9	21	0	0	21	0	0
1	55873073	.	C	T	8	12	20	0	0	20	0	0
1	55878243	.	C	T	0	3	3	0	4	7	0	0
1	55878257	.	T	A	3	3	6	0	0	6	0	0
1	55878496	.	T	C	3	0	3	0	7	10	0	0
1	55878624	.	T	A	4	4	8	0	0	8	0	0
1	55878626	.	A	C	4	4	8	0	0	8	0	0
1	55885148	.	C	T	0	3	3	0	5	8	0	0
1	55888583	.	C	A	2	3	5	0	0	5	0	0
1	55888632	.	T	C	3	0	3	0	4	7	0	0
1	55888654	.	C	T	2	5	7	0	0	7	0	0
1	55888690	.	A	G	4	3	7	0	0	7	0	0
1	55888693	.	T	A	4	3	7	0	0	7	0	0
1	55888810	.	A	C	2	3	5	0	0	5	0	0
1	55888816	.	G	A	2	3	5	0	0	5	0	0
1	55888852	.	A	C	0	4	4	0	0	4	0	0
1	55888857	.	A	C	1	0	1	0	5	6	0	0
1	56217450	.	G	T	7	2	9	0	5	14	0	0
1	56217510	.	A	G	22	23	45	0	1	46	0	0
1	56217925	.	G	A	33	35	68	0	4	72	0	0
1	56218141	.	A	G	29	38	67	0	6	73	0	0
1	56218189	.	C	T	2	29	31	0	39	70	0	0
1	56218360	.	G	C	31	2	33	0	33	66	0	0
1	56424791	.	C	T	0	1	1	0	0	1	0	0
1	56424794	.	T	C	0	0	0	0	1	1	0	0
1	56425252	.	A	G	0	2	2	0	1	3	0	0
1	56425843	.	T	C	0	0	0	0	1	1	0	0
1	56425864	.	C	T	0	0	0	0	1	1	0	0
1	56428320	.	G	A	0	3	3	0	0	3	0	0
1	57278282	.	T	G	6	4	10	0	1	11	0	0
1	57278610	.	T	G	3	4	7	0	0	7	0	0
1	57278690	.	G	A	2	10	12	0	0	12	0	0
1	57278714	.	C	T	0	4	4	0	11	15	0	0
1	57280184	.	G	T	8	7	15	0	0	15	0	0
1	57280292	.	T	C	5	2	7	0	0	7	0	0
1	57280400	.	G	A	5	4	9	0	0	9	0	0
1	57280502	.	T	C	7	9	16	0	0	16	0	0
1	57331951	.	G	A	0	2	2	0	2	4	0	0
1	57331957	.	C	T	2	2	4	0	0	4	0	0
1	57337107	.	T	C	1	3	4	0	0	4	0	0
1	57337110	.	C	T	1	3	4	0	0	4	0	0
1	57338226	.	G	A	0	3	3	0	6	9	0	0
1	57338268	.	G	A	0	3	3	0	1	4	0	0
1	58013423	.	C	T	0	4	4	0	4	8	0	0
1	58013554	.	G	A	4	2	6	0	1	7	0	0
1	58014042	.	G	C	3	7	10	0	0	10	0	0
1	58014083	.	G	T	3	8	11	0	0	11	0	0
1	58018790	.	C	T	0	1	1	0	0	1	0	0
1	58019888	.	A	T	3	2	5	0	0	5	0	0
1	58022096	.	G	A	0	1	1	0	0	1	0	0
1	58544937	.	A	G	2	2	4	0	0	4	0	0
1	58547286	.	C	T	0	3	3	0	3	6	0	0
1	58547300	.	A	G	4	2	6	0	0	6	0	0
1	58547354	.	C	A	0	1	1	0	0	1	0	0
1	58547783	.	T	C	5	4	9	0	0	9	0	0
1	58548428	.	T	C	1	2	3	0	0	3	0	0
1	58593586	.	C	A	1	3	4	0	1	5	0	0
1	58593605	.	C	T	1	3	4	0	0	4	0	0
1	58593634	.	C	T	1	3	4	0	0	4	0	0
1	58593731	.	G	A	6	4	10	0	0	10	0	0
1	58593768	.	T	G	7	7	14	0	0	14	0	0
1	58593833	.	C	A	4	6	10	0	1	11	0	0
1	58593835	.	T	C	3	7	10	0	1	11	0	0
1	58593912	.	C	T	7	5	12	0	0	12	0	0
1	58594066	.	T	C	7	0	7	0	7	14	0	0
1	58594143	.	A	C	1	2	3	0	0	3	0	0
1	58594144	.	G	A	1	2	3	0	0	3	0	0
1	58594219	.	T	C	6	6	12	0	0	12	0	0
1	58594611	.	T	G	1	2	3	0	0	3	0	0
1	58595018	.	C	T	10	8	18	0	1	19	0	0
1	58595386	.	G	A	4	3	7	0	0	7	0	0
1	58595455	.	G	A	4	8	12	0	0	12	0	0
1	58595545	.	T	C	7	5	12	0	0	12	0	0
1	58598802	.	T	C	4	0	4	0	4	8	0	0
1	58598830	.	A	T	3	2	5	0	0	5	0	0
1	58612762	.	A	G	1	2	3	0	3	6	0	0
1	58613091	.	A	C	3	3	6	0	0	6	0	0
1	58613126	.	T	A	5	2	7	0	0	7	0	0
1	58615380	.	G	T	0	3	3	0	0	3	0	0
1	58618411	.	A	G	1	3	4	0	1	5	0	0
1	58618688	.	T	A	0	1	1	0	1	2	0	0
1	58631609	.	C	T	4	2	6	0	0	6	0	0
1	58677839	.	T	C	5	15	20	0	0	20	0	0
1	58677856	.	C	T	4	16	20	0	1	21	0	0
1	58678077	.	T	A	3	0	3	0	0	3	0	0
1	58680499	.	C	A	11	7	18	0	0	18	0	0
1	58680708	.	T	C	2	10	12	0	0	13	1	0
1	58680718	.	C	G	3	12	15	0	0	15	0	0
1	58680792	.	T	C	4	7	11	0	1	12	0	0
1	58680913	.	T	C	7	6	13	0	1	16	2	0
1	58681068	.	C	T	2	8	10	0	0	10	0	0
1	58681491	.	T	C	6	6	12	0	1	13	0	0
1	58762985	.	T	G	6	7	13	0	0	13	0	0
1	58766341	.	G	A	4	6	10	0	0	10	0	0
1	58846670	.	C	A	0	4	4	0	0	4	0	0
1	58850562	.	C	T	1	5	6	0	1	7	0	0
1	58978742	.	T	A	3	0	3	0	3	6	0	0
1	58978749	.	C	A	3	3	6	0	0	6	0	0
1	58982147	.	G	A	0	7	7	0	6	13	0	0
1	58982195	.	C	G	6	4	10	0	1	11	0	0
1	58984368	.	G	A	0	1	1	0	1	2	0	0
1	58984640	.	C	T	5	2	7	0	0	7	0	0
1	58985530	.	G	A	5	9	14	0	0	14	0	0
1	58985579	.	T	G	5	6	11	0	1	12	0	0
1	58985730	.	C	A	6	7	13	0	0	13	0	0
1	58993039	.	T	G	1	1	2	0	0	2	0	0
1	58999960	.	T	A	2	5	7	0	1	8	0	0
1	59009732	.	A	G	21	1	22	0	11	33	0	0
1	59010618	.	G	A	1	2	3	0	0	3	0	0
1	59015569	.	C	T	1	5	6	0	6	12	0	0
1	59015592	.	C	G	9	7	16	0	0	16	0	0
1	59015647	.	C	T	0	3	3	0	5	8	0	0
1	59018886	.	C	T	0	5	5	0	7	12	0	0
1	59019006	.	C	G	3	2	5	0	0	5	0	0
1	59019084	.	T	A	3	7	10	0	1	11	0	0
1	59019093	.	A	G	4	8	12	0	0	12	0	0
1	59062665	.	T	C	27	20	47	0	7	54	0	0
1	59065889	.	G	A	0	12	12	0	18	30	0	0
1	59141415	.	C	A	1	1	2	0	0	2	0	0
1	59141550	.	T	C	2	1	3	0	0	3	0	0
1	59141556	.	G	C	2	1	3	0	0	3	0	0
1	59142891	.	A	G	4	0	4	0	7	11	0	0
1	59146790	.	A	G	0	1	1	0	0	1	0	0
1	59148260	.	T	C	1	2	3	0	0	3	0	0
1	59149117	.	C	T	6	8	14	0	0	14	0	0
1	59149968	.	T	C	10	10	20	0	1	21	0	0
1	59150450	.	A	G	8	5	13	0	0	13	0	0
1	59150482	.	G	T	9	3	12	0	0	12	0	0
1	59150518	.	T	C	5	13	18	0	1	19	0	0
1	59150559	.	T	G	5	19	24	0	1	25	0	0
1	59150583	.	T	A	5	19	24	0	0	24	0	0
1	59150683	.	T	C	6	11	17	0	1	18	0	0
1	59150737	.	T	C	9	7	16	0	1	17	0	0
1	59150762	.	G	T	11	5	16	0	0	16	0	0
1	59150781	.	T	C	12	6	18	0	0	18	0	0
1	59156827	.	T	G	5	4	9	0	0	9	0	0
1	59157536	.	T	C	4	4	8	0	1	9	0	0
1	59157856	.	T	A	2	10	12	0	1	13	0	0
1	59157888	.	T	C	6	22	28	0	0	28	0	0
1	59157977	.	A	C	7	14	21	0	3	24	0	0
1	59158035	.	C	A	9	10	19	0	1	20	0	0
1	59158062	.	A	T	9	11	20	0	0	20	0	0
1	59158070	.	G	A	10	10	20	0	2	22	0	0
1	59172876	.	A	G	15	10	25	0	1	26	0	0
1	59172900	.	A	G	18	11	29	0	1	30	0	0
1	59172969	.	G	A	14	12	26	0	3	29	0	0
1	59173358	.	G	T	7	8	15	0	0	15	0	0
1	59173701	.	G	T	1	2	3	0	0	3	0	0
1	59173758	.	A	G	10	9	19	0	0	19	0	0
1	59173866	.	T	G	9	6	15	0	2	18	1	0
1	59173896	.	T	C	12	0	12	0	12	24	0	0
1	59174387	.	A	G	12	6	18	0	0	18	0	0
1	59174408	.	G	A	10	3	13	0	1	14	0	0
1	59174492	.	T	G	5	5	10	0	3	13	0	0
1	59174525	.	A	C	8	5	13	0	0	13	0	0
1	59174576	.	C	T	4	8	12	0	0	12	0	0
1	59174645	.	G	A	8	14	22	0	3	25	0	0
1	59174797	.	A	C	13	12	25	0	0	25	0	0
1	59174962	.	T	C	12	8	20	0	0	20	0	0
1	59175511	.	T	C	7	5	12	0	1	13	0	0
1	59175572	.	A	G	5	5	10	0	0	10	0	0
1	59175626	.	G	A	5	5	10	0	1	11	0	0
1	59175635	.	G	A	6	6	12	0	0	12	0	0
1	59175740	.	G	T	9	4	13	0	1	14	0	0
1	59175983	.	T	C	7	6	13	0	2	15	0	0
1	59175989	.	A	G	8	7	15	0	0	15	0	0
1	59176636	.	C	T	0	1	1	0	0	1	0	0
1	59176887	.	G	T	2	3	5	0	1	6	0	0
1	59176935	.	A	C	3	0	3	0	4	7	0	0
1	59218477	.	C	G	1	3	4	0	4	8	0	0
1	59218594	.	A	G	9	11	20	0	1	21	0	0
1	59226049	.	T	C	6	9	15	0	2	17	0	0
1	59226052	.	A	G	8	10	18	0	1	19	0	0
1	59226374	.	A	G	0	1	1	0	0	1	0	0
1	59228569	.	A	C	5	0	5	0	7	12	0	0
1	59229211	.	G	A	1	2	3	0	0	3	0	0
1	59232206	.	A	G	14	11	25	0	0	25	0	0
1	59232509	.	G	A	13	7	20	0	1	21	0	0
1	59235016	.	T	G	2	3	5	0	0	5	0	0
1	59238037	.	T	C	2	2	4	0	0	4	0	0
1	59238038	.	A	C	1	2	3	0	1	4	0	0
1	59244312	.	A	G	10	7	17	0	1	18	0	0
1	59244635	.	A	T	14	20	34	0	0	34	0	0
1	59244916	.	T	A	34	10	44	0	1	45	0	0
1	59244928	.	C	T	27	13	40	0	3	43	0	0
1	59245142	.	C	G	31	18	49	0	7	56	0	0
1	59245658	.	G	A	6	6	12	0	1	13	0	0
1	59245873	.	T	C	7	2	9	0	0	9	0	0
1	59245900	.	C	T	10	7	17	0	0	17	0	0
1	59246189	.	T	C	12	1	13	0	10	23	0	0
1	59247893	.	T	G	10	5	15	0	0	15	0	0
1	59247944	.	C	T	4	5	9	0	0	9	0	0
1	59248138	.	T	A	7	7	14	0	1	15	0	0
1	59251658	.	C	G	6	3	9	0	0	9	0	0
1	59251839	.	T	C	11	0	11	0	11	22	0	0
1	59293966	.	A	G	1	6	7	0	0	7	0	0
1	59298069	.	T	C	0	1	1	0	0	1	0	0
1	59298261	.	T	G	0	1	1	0	0	1	0	0
1	59302210	.	G	A	0	2	2	0	0	2	0	0
1	59302276	.	C	T	5	6	11	0	0	11	0	0
1	59302372	.	T	G	3	10	13	0	0	13	0	0
1	59302523	.	A	T	3	4	7	0	1	8	0	0
1	59303024	.	C	A	2	8	10	0	0	10	0	0
1	59303294	.	C	G	1	0	1	0	4	5	0	0
1	59303334	.	A	G	1	2	3	0	0	3	0	0
1	59304427	.	T	C	2	0	2	0	0	2	0	0
1	59304816	.	C	T	4	3	7	0	0	7	0	0
1	59305059	.	A	C	6	0	6	0	9	15	0	0
1	59305200	.	T	C	4	9	13	0	0	13	0	0
1	59309932	.	C	T	3	2	5	0	0	5	0	0
1	59309945	.	G	A	3	2	5	0	0	5	0	0
1	59310354	.	C	T	1	1	2	0	0	2	0	0
1	59313443	.	A	G	1	1	2	0	1	3	0	0
1	59314966	.	A	G	0	1	1	0	0	1	0	0
1	59318769	.	A	G	1	3	4	0	0	4	0	0
1	59318771	.	C	A	1	3	4	0	0	4	0	0
1	59318886	.	A	G	1	0	1	0	3	4	0	0
1	59321447	.	A	G	14	0	14	0	12	26	0	0
1	59324067	.	T	C	7	8	15	0	0	15	0	0
1	59328110	.	T	G	5	0	5	0	3	8	0	0
1	59328287	.	C	T	3	2	5	0	2	7	0	0
1	59329950	.	A	G	1	8	9	0	0	9	0	0
1	59329957	.	T	C	1	10	11	0	0	11	0	0
1	59330135	.	T	C	3	9	12	0	0	12	0	0
1	59330169	.	C	T	2	9	11	0	0	11	0	0
1	59412025	.	G	A	0	1	1	0	0	1	0	0
1	59417867	.	C	A	0	1	1	0	0	1	0	0
1	59417882	.	A	C	0	0	0	0	2	2	0	0
1	59422034	.	A	G	1	1	2	0	0	2	0	0
1	59565350	.	G	A	0	2	2	0	0	2	0	0
1	59565365	.	T	C	0	4	4	0	0	4	0	0
10	16061	.	A	C	0	3	3	0	1	4	0	0
10	18509	.	A	G	2	4	6	0	1	7	0	0
10	18533	.	T	C	6	10	16	0	0	16	0	0
10	22333	.	C	G	9	5	14	0	2	16	0	0
10	22434	.	G	T	0	10	10	0	4	14	0	0
10	22435	.	G	T	4	10	14	0	0	14	0	0
10	22507	.	A	G	6	2	8	0	2	10	0	0
10	22543	.	T	A	3	5	8	0	0	8	0	0
10	22554	.	A	T	2	5	7	0	0	7	0	0
10	22672	.	A	T	3	5	8	0	0	8	0	0
10	23959	.	C	T	1	3	4	0	1	5	0	0
10	24733	.	G	A	6	1	7	0	0	7	0	0
10	27705	.	A	G	2	3	5	0	0	5	0	0
10	32978	.	T	C	3	0	3	0	0	3	0	0
10	33237	.	T	C	5	3	8	0	0	8	0	0
10	33287	.	G	C	2	5	7	0	0	7	0	0
10	33427	.	G	A	10	5	15	0	0	15	0	0
10	33441	.	A	G	10	6	16	0	0	16	0	0
10	33665	.	T	C	3	2	5	0	0	5	0	0
10	33689	.	G	C	2	2	4	0	0	4	0	0
10	33986	.	G	T	3	2	5	0	0	5	0	0
10	34053	.	C	T	0	3	3	0	2	5	0	0
10	34082	.	T	C	1	0	1	0	3	4	0	0
10	34302	.	G	T	3	5	8	0	0	8	0	0
10	34401	.	G	A	1	5	6	0	1	7	0	0
10	34432	.	T	C	3	5	8	0	0	8	0	0
10	34799	.	G	C	9	0	9	0	6	15	0	0
10	34839	.	G	C	6	9	15	0	0	15	0	0
10	56792	.	T	G	6	4	10	0	2	12	0	0
10	62459	.	A	C	18	2	20	0	12	32	0	0
10	63587	.	A	G	18	12	30	0	5	35	0	0
10	64855	.	G	A	12	12	24	0	0	24	0	0
10	65086	.	A	G	3	6	9	0	0	9	0	0
10	66886	.	A	G	9	13	22	0	1	23	0	0
10	66967	.	A	G	9	11	20	0	4	24	0	0
10	67063	.	T	C	3	4	7	0	1	8	0	0
10	72381	.	A	G	9	6	15	0	0	15	0	0
10	78461	.	G	C	0	13	13	0	12	25	0	0
10	81276	.	C	T	7	5	12	0	2	14	0	0
10	81579	.	G	T	1	9	10	0	5	15	0	0
10	82213	.	T	G	15	17	32	0	9	41	0	0
10	85353	.	A	G	1	0	1	0	0	1	0	0
10	87417	.	G	A	9	3	12	0	0	12	0	0
10	87426	.	T	C	6	5	11	0	0	11	0	0
10	89893	.	T	C	0	0	0	0	1	1	0	0
10	110895	.	G	A	0	0	0	0	0	0	0	0
10	114066	.	A	G	5	15	20	0	1	21	0	0
10	115136	.	T	C	2	6	8	0	0	8	0	0
10	115493	.	G	T	3	11	14	0	0	14	0	0
10	115506	.	T	G	4	10	14	0	1	15	0	0
10	115578	.	T	C	5	7	12	0	0	12	0	0
10	115615	.	T	C	4	10	14	0	1	15	0	0
10	115626	.	C	A	6	11	17	0	1	18	0	0
10	115679	.	A	T	5	10	15	0	0	15	0	0
10	115874	.	T	A	2	4	6	0	0	6	0	0
10	115967	.	A	G	1	0	1	0	6	7	0	0
10	115982	.	T	C	2	4	6	0	1	7	0	0
10	116015	.	T	G	1	3	4	0	0	4	0	0
10	116020	.	T	G	1	2	3	0	0	3	0	0
10	134661	.	C	T	1	17	18	0	17	35	0	0
10	134749	.	C	T	0	19	19	0	12	31	0	0
10	134809	.	G	A	13	12	25	0	2	28	1	0
10	187823	.	C	T	9	5	14	0	0	14	0	0
10	190039	.	G	A	2	2	4	0	0	4	0	0
10	190917	.	C	T	6	5	11	0	0	11	0	0
10	193726	.	A	G	4	6	10	0	1	11	0	0
10	194316	.	A	G	7	6	13	0	3	16	0	0
10	195321	.	T	C	1	2	3	0	0	3	0	0
10	195327	.	T	C	1	2	3	0	0	3	0	0
10	196051	.	G	T	1	9	10	0	9	19	0	0
10	196052	.	C	G	8	9	17	0	2	19	0	0
10	196342	.	C	G	12	5	17	0	1	18	0	0
10	196426	.	T	A	8	16	24	0	0	24	0	0
10	196429	.	A	T	7	19	26	0	0	26	0	0
10	196524	.	A	G	10	0	10	0	12	22	0	0
10	196563	.	C	G	8	6	14	0	1	15	0	0
10	196693	.	T	A	21	13	34	0	1	35	0	0
10	196773	.	T	C	5	3	8	0	0	8	0	0
10	207128	.	G	A	6	6	12	0	0	12	0	0
10	207279	.	G	A	3	7	10	0	0	10	0	0
10	207992	.	T	C	11	2	13	0	14	27	0	0
10	207994	.	T	C	11	2	13	0	14	27	0	0
10	208104	.	G	A	6	2	8	0	0	8	0	0
10	208674	.	G	A	7	1	8	0	0	8	0	0
10	208714	.	C	T	0	4	4	0	8	12	0	0
10	210692	.	C	A	0	4	4	0	4	8	0	0
10	214013	.	T	A	6	4	10	0	1	11	0	0
10	216122	.	T	C	5	3	8	0	0	8	0	0
10	591476	.	A	G	6	0	6	0	5	11	0	0
10	1052692	.	A	G	2	0	2	0	4	6	0	0
10	1052728	.	C	T	3	4	7	0	0	7	0	0
10	1056227	.	A	G	2	1	3	0	0	3	0	0
10	1056409	.	A	G	4	2	6	0	0	6	0	0
10	1073456	.	T	C	1	2	3	0	2	5	0	0
10	1073519	.	G	C	0	1	1	0	2	3	0	0
10	1075972	.	G	A	0	2	2	0	3	5	0	0
10	1076044	.	C	T	3	10	13	0	0	13	0	0
10	1076116	.	C	T	6	7	13	0	0	13	0	0
10	1076251	.	T	C	2	1	3	0	1	4	0	0
10	1082985	.	T	G	5	7	12	0	0	12	0	0
10	1083030	.	T	A	3	6	9	0	0	9	0	0
10	1084628	.	A	G	1	1	2	0	0	2	0	0
10	1107441	.	G	A	0	4	4	0	10	14	0	0
10	1107540	.	C	A	13	13	26	0	1	27	0	0
10	1133195	.	G	A	0	2	2	0	1	3	0	0
10	1710017	.	G	A	0	5	5	1	5	11	0	0
10	1712091	.	G	A	0	8	8	0	0	8	0	0
10	1712100	.	T	A	0	5	5	0	3	8	0	0
10	1890481	.	T	G	9	0	9	0	29	38	0	0
10	2898260	.	T	G	7	5	12	0	0	12	0	0
10	3319502	.	A	G	2	3	5	0	0	5	0	0
10	3321262	.	A	G	15	19	34	0	0	34	0	0
10	3450825	.	G	C	0	12	12	0	0	12	0	0
10	3451222	.	C	T	6	2	8	0	0	8	0	0
10	5093140	.	T	C	5	4	9	0	0	9	0	0
10	5535047	.	A	T	8	5	13	0	1	14	0	0
10	5535048	.	C	G	9	5	14	0	0	14	0	0
10	5789215	.	T	C	11	0	11	0	6	17	0	0
10	5789241	.	T	C	9	7	16	0	1	17	0	0
10	5789294	.	T	C	5	0	5	0	2	7	0	0
10	5789995	.	C	T	5	3	8	0	0	8	0	0
10	5844763	.	A	G	0	3	3	0	0	3	0	0
10	5991093	.	T	C	2	3	5	0	0	5	0	0
10	6016242	.	G	A	1	3	4	0	0	4	0	0
10	6016545	.	G	T	1	4	5	0	1	6	0	0
10	6028157	.	A	G	8	4	12	0	0	12	0	0
10	6033469	.	A	C	1	2	3	0	0	3	0	0
10	6033612	.	G	A	0	7	7	0	6	13	0	0
10	6033627	.	A	T	6	5	11	0	0	11	0	0
10	6263593	.	G	A	0	3	3	0	0	3	0	0
10	6267255	.	C	T	2	2	4	0	0	4	0	0
10	6280939	.	G	A	0	2	2	0	0	2	0	0
10	6280948	.	G	A	0	2	2	0	1	3	0	0
10	6301828	.	C	T	1	0	1	0	0	1	0	0
10	6301930	.	C	T	5	5	10	0	0	10	0	0
10	6313001	.	A	T	7	6	13	0	0	13	0	0
10	6313003	.	C	T	7	6	13	0	0	13	0	0
10	6340597	.	T	C	8	8	16	0	1	17	0	0
10	6340715	.	T	G	10	8	18	0	0	19	1	0
10	6348571	.	C	A	4	2	6	0	0	6	0	0
10	6372501	.	C	T	8	11	19	0	0	19	0	0
10	6372915	.	G	A	10	5	15	0	1	16	0	0
10	6372964	.	T	C	7	8	15	0	1	16	0	0
10	6372965	.	G	A	1	7	8	0	8	16	0	0
10	6373003	.	T	C	1	6	7	0	1	8	0	0
10	6373332	.	A	T	5	2	7	0	2	9	0	0
10	6373336	.	C	G	7	2	9	0	0	9	0	0
10	6373430	.	G	A	1	2	3	0	1	4	0	0
10	6373524	.	A	G	10	5	15	0	4	19	0	0
10	6373708	.	A	G	8	0	8	0	8	16	0	0
10	6373931	.	C	T	6	3	9	0	0	9	0	0
10	6374279	.	G	A	0	17	17	0	13	30	0	0
10	6374352	.	C	T	11	9	20	0	0	20	0	0
10	6374372	.	A	G	7	15	22	0	2	24	0	0
10	6374484	.	A	G	8	3	11	0	1	12	0	0
10	6374501	.	A	G	5	6	11	0	2	13	0	0
10	6374573	.	A	T	7	14	21	0	1	22	0	0
10	6374597	.	A	G	15	6	21	0	1	22	0	0
10	6374771	.	C	A	4	11	15	0	0	15	0	0
10	6374906	.	C	T	11	8	19	0	0	19	0	0
10	6374982	.	A	G	7	7	14	0	1	15	0	0
10	6375041	.	T	A	2	4	6	0	0	6	0	0
10	6400176	.	C	G	1	2	3	0	0	3	0	0
10	6402694	.	T	A	2	2	4	0	0	4	0	0
10	6402797	.	G	T	0	1	1	0	3	4	0	0
10	6402859	.	C	T	1	3	4	0	1	5	0	0
10	6404031	.	C	T	1	2	3	0	0	3	0	0
10	6404035	.	A	T	1	2	3	0	0	3	0	0
10	6404899	.	G	T	2	5	7	0	0	7	0	0
10	6404900	.	G	T	2	5	7	0	0	7	0	0
10	6405275	.	A	T	7	3	10	0	0	10	0	0
10	6405430	.	A	T	6	5	11	0	1	12	0	0
10	6407457	.	T	G	2	2	4	0	0	4	0	0
10	6407744	.	A	G	1	2	3	0	0	3	0	0
10	6408549	.	T	G	2	2	4	0	0	4	0	0
10	6408577	.	G	A	3	2	5	0	0	5	0	0
10	6408843	.	G	A	0	8	8	0	5	13	0	0
10	6408955	.	T	G	7	0	7	0	8	15	0	0
10	6408986	.	A	G	2	9	11	0	0	11	0	0
10	6409067	.	T	C	7	9	16	0	1	17	0	0
10	6409095	.	G	A	0	8	8	0	5	13	0	0
10	6409120	.	G	A	5	4	9	0	1	10	0	0
10	6409267	.	C	A	1	5	6	0	0	6	0	0
10	6409380	.	A	C	4	3	7	0	0	7	0	0
10	6409453	.	G	A	5	3	8	0	0	8	0	0
10	6409455	.	T	A	5	3	8	0	0	8	0	0
10	6409488	.	C	G	6	5	11	0	1	12	0	0
10	6409515	.	T	A	7	6	13	0	1	14	0	0
10	6409583	.	C	T	4	2	6	0	1	7	0	0
10	6473293	.	A	C	5	8	13	0	0	13	0	0
10	6473412	.	C	T	0	15	15	0	17	32	0	0
10	6473544	.	T	C	8	15	23	0	0	23	0	0
10	6473553	.	G	A	13	7	20	0	1	21	0	0
10	6473685	.	T	C	7	9	16	0	0	16	0	0
10	6473704	.	C	G	5	12	17	0	0	17	0	0
10	6473851	.	A	G	8	8	16	0	1	17	0	0
10	6473908	.	A	G	8	9	17	0	0	17	0	0
10	6473996	.	T	C	6	10	16	0	1	17	0	0
10	6474014	.	C	T	7	9	16	0	1	17	0	0
10	6474057	.	T	A	2	5	7	0	0	7	0	0
10	6486330	.	T	C	6	7	13	0	0	13	0	0
10	6490083	.	A	G	12	14	26	0	0	26	0	0
10	6496294	.	C	A	27	19	46	0	2	48	0	0
10	6517593	.	T	A	33	20	53	0	3	56	0	0
10	6517726	.	C	T	17	21	38	0	1	39	0	0
10	6521716	.	C	T	0	4	4	0	3	7	0	0
10	6521877	.	A	C	10	6	16	0	0	16	0	0
10	6522232	.	A	T	3	2	5	0	0	5	0	0
10	6522297	.	C	T	0	9	9	0	4	13	0	0
10	6531014	.	A	G	3	2	5	0	0	5	0	0
10	6536350	.	C	T	2	7	9	0	0	9	0	0
10	6549276	.	T	C	0	2	2	0	0	2	0	0
10	6549363	.	G	A	1	2	3	0	0	3	0	0
10	6553319	.	G	A	3	2	5	0	0	5	0	0
10	6781372	.	T	A	10	12	22	0	2	24	0	0
10	6781742	.	G	T	6	7	13	0	0	13	0	0
10	6781786	.	A	T	3	2	5	0	0	5	0	0
10	6781976	.	C	T	7	8	15	0	0	15	0	0
10	6782020	.	G	C	8	9	17	0	2	19	0	0
10	6782288	.	T	G	6	4	10	0	0	10	0	0
10	6782454	.	C	G	8	17	25	0	0	25	0	0
10	6782489	.	T	G	11	13	24	0	2	26	0	0
10	6782636	.	T	A	13	19	32	0	1	33	0	0
10	6786326	.	C	T	0	3	3	0	2	5	0	0
10	6786386	.	G	A	4	5	9	0	1	10	0	0
10	6804756	.	T	C	4	0	4	0	6	10	0	0
10	6824845	.	A	T	9	8	17	0	1	18	0	0
10	6824877	.	T	G	4	4	8	0	0	8	0	0
10	6825172	.	A	G	1	1	2	0	0	2	0	0
10	6831298	.	C	T	0	1	1	0	1	2	0	0
10	6831446	.	T	C	4	3	7	0	0	7	0	0
10	6831455	.	G	A	3	4	7	0	0	7	0	0
10	6834065	.	A	T	0	1	1	0	0	1	0	0
10	6834341	.	G	A	6	10	16	0	0	16	0	0
10	6834380	.	C	A	0	6	6	0	4	10	0	0
10	6850866	.	G	A	7	4	11	0	0	11	0	0
10	6858115	.	G	C	5	3	8	0	3	11	0	0
10	6858160	.	C	T	2	4	6	0	0	6	0	0
10	7050408	.	A	G	4	8	12	0	1	13	0	0
10	7050476	.	C	T	1	3	4	0	2	6	0	0
10	7050718	.	A	T	4	13	17	0	1	18	0	0
10	7051093	.	A	T	2	3	5	0	1	6	0	0
10	7057746	.	C	T	3	4	7	0	0	7	0	0
10	7057800	.	C	T	2	4	6	0	0	6	0	0
10	7057881	.	T	C	7	3	10	0	1	11	0	0
10	7057984	.	C	A	6	8	14	0	0	14	0	0
10	7058082	.	A	T	3	0	3	0	0	3	0	0
10	7102468	.	T	G	4	1	5	0	0	5	0	0
10	7210001	.	G	A	0	9	9	0	12	21	0	0
10	7221810	.	A	G	8	4	12	0	0	12	0	0
10	7222187	.	T	C	3	0	3	0	0	3	0	0
10	7222213	.	T	C	10	9	19	0	0	19	0	0
10	7222289	.	C	T	14	3	17	0	2	19	0	0
10	7224964	.	A	G	1	7	8	0	0	8	0	0
10	7231914	.	A	C	23	22	45	0	3	48	0	0
10	7231964	.	G	C	26	10	36	0	2	38	0	0
10	7232083	.	C	T	8	13	21	0	0	21	0	0
10	7232640	.	C	T	16	18	34	0	2	36	0	0
10	7232896	.	A	T	10	10	20	0	0	20	0	0
10	7232897	.	A	G	10	10	20	0	0	20	0	0
10	7232971	.	C	T	16	18	34	0	2	36	0	0
10	7233203	.	G	A	23	21	44	0	2	46	0	0
10	7233440	.	A	T	28	31	59	0	4	63	0	0
10	7233631	.	T	C	26	31	57	0	2	59	0	0
10	7233649	.	A	T	27	27	54	0	3	57	0	0
10	7233747	.	A	G	23	2	25	0	19	44	0	0
10	7233854	.	A	T	8	19	27	0	6	34	1	0
10	7284282	.	A	T	4	6	10	0	1	11	0	0
10	7284371	.	A	G	6	9	15	0	0	15	0	0
10	7284403	.	C	T	6	4	10	0	0	10	0	0
10	7284423	.	G	T	6	3	9	0	0	9	0	0
10	7284442	.	A	G	5	3	8	0	0	8	0	0
10	7285429	.	G	A	10	7	17	0	0	17	0	0
10	7312057	.	A	G	2	6	8	0	1	9	0	0
10	7346820	.	A	C	2	3	5	0	0	5	0	0
10	7347192	.	C	A	0	2	2	0	1	3	0	0
10	7483623	.	C	T	1	4	5	0	0	5	0	0
10	7494297	.	G	A	1	1	2	0	0	2	0	0
10	7494356	.	A	T	1	1	2	0	0	2	0	0
10	7498939	.	G	A	1	4	5	0	0	5	0	0
10	7519387	.	A	G	1	1	2	0	0	2	0	0
10	7564255	.	C	T	5	4	9	0	2	11	0	0
10	7564294	.	C	T	2	3	5	0	0	5	0	0
10	7564804	.	G	A	0	2	2	0	7	9	0	0
10	7601552	.	G	A	7	15	22	0	1	23	0	0
10	7617113	.	A	T	36	26	62	0	1	63	0	0
10	7617241	.	T	G	39	22	61	0	0	61	0	0
10	7617242	.	G	A	22	34	56	0	5	61	0	0
10	7617327	.	A	C	18	17	35	0	5	40	0	0
10	7617636	.	A	G	12	1	13	0	27	40	0	0
10	7624022	.	T	G	2	4	6	0	0	6	0	0
10	7624362	.	C	A	0	1	1	0	0	1	0	0
10	7635334	.	C	A	2	2	4	0	0	4	0	0
10	7671425	.	G	A	7	6	13	0	0	13	0	0
10	7671473	.	A	T	8	6	14	0	0	14	0	0
10	7672859	.	C	T	6	5	11	0	1	12	0	0
10	7674079	.	T	G	6	9	15	0	1	16	0	0
10	7674136	.	C	T	8	4	12	0	2	14	0	0
10	7674429	.	C	T	2	2	4	0	0	4	0	0
10	7678121	.	T	C	0	2	2	0	0	2	0	0
10	7678393	.	G	A	0	1	1	0	0	1	0	0
10	7678525	.	C	T	0	0	0	0	2	2	0	0
10	7700615	.	A	G	4	6	10	0	0	10	0	0
10	7700676	.	G	A	2	1	3	0	0	3	0	0
10	7701903	.	G	A	3	2	5	0	0	5	0	0
10	7701950	.	G	A	2	6	8	0	0	8	0	0
10	7703338	.	A	G	1	3	4	0	0	4	0	0
10	7704436	.	G	A	0	3	3	0	1	4	0	0
10	7704548	.	C	T	1	0	1	0	0	1	0	0
10	7709761	.	T	C	5	7	12	0	0	12	0	0
10	7709800	.	C	A	11	7	18	0	0	18	0	0
10	7712206	.	G	A	6	3	9	0	0	9	0	0
10	7712228	.	C	T	3	2	5	0	0	5	0	0
10	7713952	.	A	C	5	3	8	0	0	8	0	0
10	7721459	.	A	G	6	8	14	0	0	14	0	0
10	7721746	.	G	A	5	8	13	0	1	14	0	0
10	7722595	.	A	G	7	7	14	0	0	14	0	0
10	7722797	.	T	A	1	2	3	0	0	3	0	0
10	7722936	.	C	T	5	5	10	0	0	10	0	0
10	7723004	.	T	C	6	9	15	0	0	15	0	0
10	7723157	.	A	G	14	11	25	0	0	25	0	0
10	7723218	.	T	C	11	11	22	0	2	24	0	0
10	7723275	.	C	A	16	13	29	0	0	29	0	0
10	7723337	.	C	G	8	4	12	0	0	12	0	0
10	7723413	.	T	G	1	3	4	0	0	4	0	0
10	7727393	.	T	C	3	4	7	0	0	7	0	0
10	7727505	.	T	A	2	4	6	0	1	7	0	0
10	7727598	.	A	T	2	5	7	0	0	7	0	0
10	7734401	.	G	A	5	4	9	0	0	9	0	0
10	7734465	.	C	T	5	4	9	0	2	11	0	0
10	7769959	.	G	A	1	2	3	0	0	3	0	0
10	7769965	.	A	G	1	2	3	0	0	3	0	0
10	7770200	.	A	G	3	2	5	0	0	5	0	0
10	7770201	.	G	A	3	2	5	0	0	5	0	0
10	7772012	.	T	G	6	3	9	0	0	9	0	0
10	7804690	.	C	A	1	2	3	0	0	3	0	0
10	7810461	.	A	T	21	19	40	0	1	41	0	0
10	7810565	.	G	A	19	15	34	0	0	34	0	0
10	7811062	.	T	A	3	6	9	0	0	9	0	0
10	7811075	.	T	C	2	7	9	0	0	9	0	0
10	7811935	.	A	G	20	9	29	0	0	29	0	0
10	7812420	.	A	G	2	4	6	0	0	6	0	0
10	7812430	.	A	G	4	6	10	0	0	10	0	0
10	7815118	.	G	A	5	8	13	0	0	13	0	0
10	7815187	.	G	A	3	0	3	0	0	3	0	0
10	7831879	.	C	T	3	4	7	0	0	7	0	0
10	7847200	.	C	T	0	2	2	0	1	3	0	0
10	7850786	.	G	A	4	2	6	0	0	6	0	0
10	7850804	.	C	A	4	2	6	0	0	6	0	0
10	7901347	.	G	A	3	2	5	0	1	6	0	0
10	7901378	.	T	C	1	2	3	0	0	3	0	0
10	7902030	.	T	A	5	2	7	0	0	7	0	0
10	7902255	.	A	G	2	2	4	0	0	4	0	0
10	7909665	.	T	A	1	3	4	0	1	5	0	0
10	7916820	.	G	A	10	5	15	0	0	15	0	0
10	7916966	.	A	T	10	7	17	0	0	17	0	0
10	7917036	.	A	T	8	9	17	0	0	17	0	0
10	7917072	.	A	C	8	12	20	0	0	20	0	0
10	7917331	.	A	T	13	15	28	0	2	30	0	0
10	7917411	.	C	A	1	8	9	0	11	20	0	0
10	7917538	.	G	A	8	10	18	0	1	19	0	0
10	7917551	.	A	G	11	12	23	0	1	24	0	0
10	7917592	.	T	C	15	22	37	0	0	37	0	0
10	7917686	.	T	C	12	20	32	0	2	34	0	0
10	7917690	.	A	T	11	22	33	0	2	35	0	0
10	7920865	.	G	C	14	0	14	0	21	35	0	0
10	7922294	.	C	A	10	5	15	0	0	15	0	0
10	7922309	.	G	A	5	9	14	0	0	14	0	0
10	7922514	.	A	G	2	10	12	0	2	14	0	0
10	7929469	.	A	G	9	4	13	0	0	13	0	0
10	7929611	.	C	A	0	17	17	0	7	24	0	0
10	7938629	.	C	T	5	4	9	0	2	11	0	0
10	7968274	.	G	T	5	5	10	0	1	11	0	0
10	7974090	.	A	C	3	0	3	0	7	10	0	0
10	7974093	.	G	A	3	7	10	0	0	10	0	0
10	7975692	.	T	C	17	19	36	0	0	36	0	0
10	7976105	.	C	G	23	15	38	0	1	39	0	0
10	7976118	.	C	T	22	9	31	0	0	31	0	0
10	7976316	.	G	C	15	20	35	0	2	37	0	0
10	7976343	.	C	T	16	31	47	0	2	49	0	0
10	7976574	.	A	C	1	0	1	0	1	2	0	0
10	7976851	.	G	A	23	14	37	0	1	38	0	0
10	7979229	.	A	G	2	4	6	0	0	6	0	0
10	7984479	.	C	T	1	9	10	0	22	32	0	0
10	7984482	.	A	G	16	15	31	0	2	33	0	0
10	7984677	.	A	T	2	3	5	0	0	5	0	0
10	7989082	.	T	A	9	11	20	0	0	20	0	0
10	7989132	.	T	A	10	6	16	0	0	16	0	0
10	7989162	.	T	G	4	6	10	0	0	10	0	0
10	7989237	.	G	A	8	5	13	0	0	13	0	0
10	7989287	.	G	A	11	7	18	0	0	18	0	0
10	7989290	.	G	A	6	11	17	0	0	17	0	0
10	7989576	.	C	T	5	5	10	0	0	10	0	0
10	7996021	.	G	A	4	1	5	0	0	5	0	0
10	7996022	.	C	G	1	3	4	0	1	5	0	0
10	8001365	.	A	G	1	2	3	0	0	3	0	0
10	8005785	.	T	A	5	6	11	0	0	11	0	0
10	8009996	.	A	C	5	4	9	0	0	9	0	0
10	8010064	.	A	G	0	1	1	0	0	1	0	0
10	8014445	.	T	C	3	1	4	0	0	4	0	0
10	8412643	.	A	G	1	2	3	0	0	3	0	0
10	8418768	.	C	A	0	2	2	0	0	2	0	0
10	8423986	.	C	T	0	1	1	0	0	1	0	0
10	8437947	.	T	C	2	3	5	0	0	5	0	0
10	8466562	.	G	A	1	0	1	0	0	1	0	0
10	8468942	.	A	C	2	2	4	0	0	4	0	0
10	8575828	.	G	A	0	1	1	0	0	1	0	0
10	8629847	.	A	G	2	0	2	0	4	6	0	0
10	8630102	.	C	T	11	9	20	0	0	20	0	0
10	8630402	.	G	T	0	5	5	0	9	14	0	0
10	8630452	.	G	T	10	6	16	0	1	17	0	0
10	8630585	.	A	G	7	0	7	0	6	13	0	0
10	8630618	.	C	T	9	4	13	0	0	13	0	0
10	8630690	.	G	A	6	6	12	0	1	13	0	0
10	8630808	.	G	A	5	3	8	0	1	9	0	0
10	8630914	.	A	G	3	2	5	0	0	5	0	0
10	8631103	.	G	A	0	5	5	0	3	8	0	0
10	8631152	.	A	T	2	11	13	0	0	13	0	0
10	8631201	.	A	G	11	9	20	0	2	22	0	0
10	8660722	.	C	T	16	9	25	0	1	26	0	0
10	8670121	.	A	C	5	3	8	0	1	9	0	0
10	8672510	.	A	G	15	11	26	0	4	30	0	0
10	8672519	.	T	C	16	11	27	0	0	27	0	0
10	8672672	.	C	G	10	12	22	0	1	23	0	0
10	8672707	.	A	T	12	16	28	0	0	28	0	0
10	8829937	.	C	T	1	0	1	0	0	1	0	0
10	8835269	.	C	T	0	1	1	0	0	1	0	0
10	8952018	.	T	C	1	0	1	0	5	6	0	0
10	8952019	.	A	G	1	5	6	0	0	6	0	0
10	8968250	.	G	C	1	3	4	0	0	4	0	0
10	8970757	.	T	C	2	3	5	0	0	5	0	0
10	8970802	.	T	C	1	2	3	0	0	3	0	0
10	8974771	.	C	T	0	2	2	0	0	2	0	0
10	9006634	.	T	C	10	6	16	0	0	16	0	0
10	9165056	.	T	C	1	2	3	0	0	3	0	0
10	9169479	.	C	T	7	6	13	0	0	13	0	0
10	9169574	.	T	G	2	4	6	0	0	6	0	0
10	9177175	.	T	C	3	3	6	0	0	6	0	0
10	9177608	.	C	T	8	5	13	0	1	14	0	0
10	9184327	.	A	C	10	4	14	0	2	17	1	0
10	9184533	.	C	T	4	7	11	0	1	12	0	0
10	9184556	.	A	G	3	9	12	0	0	12	0	0
10	9233869	.	C	T	2	3	5	0	0	5	0	0
10	9234476	.	C	G	5	2	7	0	1	8	0	0
10	9234529	.	G	A	4	2	6	0	0	6	0	0
10	9234626	.	T	G	6	5	11	0	1	12	0	0
10	9837250	.	G	A	6	2	8	0	0	8	0	0
10	9856390	.	T	C	4	0	4	0	7	11	0	0
10	10254730	.	C	T	8	2	10	0	0	10	0	0
10	10254751	.	A	C	6	4	10	0	0	10	0	0
10	10254787	.	A	G	4	0	4	0	8	12	0	0
10	10254922	.	A	G	0	2	2	0	1	3	0	0
10	10261887	.	G	C	2	4	6	0	0	6	0	0
10	10261893	.	C	A	2	4	6	0	0	6	0	0
10	10262013	.	T	C	5	6	11	0	0	11	0	0
10	10269930	.	T	C	1	1	2	0	0	2	0	0
10	10270959	.	G	A	7	8	15	0	0	15	0	0
10	10270977	.	G	A	5	10	15	0	0	15	0	0
10	10271061	.	C	T	3	2	5	0	0	5	0	0
10	10317392	.	A	T	1	0	1	0	0	1	0	0
10	10325451	.	T	C	6	4	10	0	0	10	0	0
10	10325493	.	G	A	0	6	6	0	7	13	0	0
10	10561112	.	T	A	2	7	9	0	0	9	0	0
10	10561156	.	T	A	7	2	9	0	1	10	0	0
10	10561625	.	G	A	0	1	1	0	0	1	0	0
10	10564587	.	G	T	3	0	3	0	0	3	0	0
10	10567262	.	A	G	1	0	1	0	0	1	0	0
10	10636799	.	C	A	4	2	6	0	1	7	0	0
10	10636896	.	G	A	0	4	4	0	4	8	0	0
10	10636946	.	A	G	6	3	9	0	0	9	0	0
10	10700463	.	A	G	4	0	4	0	2	6	0	0
10	10700532	.	C	T	14	14	28	0	0	28	0	0
10	10700583	.	C	T	14	10	24	0	0	24	0	0
10	10729041	.	A	T	1	6	7	0	0	7	0	0
10	10729064	.	G	A	2	6	8	0	0	8	0	0
10	10729097	.	C	A	5	3	8	0	0	8	0	0
10	10729139	.	C	G	1	2	3	0	0	3	0	0
10	10731381	.	C	A	1	2	3	0	0	3	0	0
10	10747781	.	G	A	1	3	4	0	0	4	0	0
10	10758431	.	A	G	1	1	2	0	0	2	0	0
10	10782786	.	C	T	4	5	9	0	1	10	0	0
10	10860932	.	A	T	6	5	11	0	1	12	0	0
10	10861085	.	G	T	4	3	7	0	0	7	0	0
10	10861610	.	T	C	5	2	7	0	0	7	0	0
10	10861847	.	T	A	6	6	12	0	0	12	0	0
10	10862969	.	C	T	0	3	3	0	1	4	0	0
10	10880671	.	G	A	2	3	5	0	0	5	0	0
10	10880692	.	C	T	0	1	1	0	4	5	0	0
10	10880847	.	C	G	2	3	5	0	0	5	0	0
10	10930143	.	G	T	1	4	5	0	0	5	0	0
10	10930188	.	G	A	0	1	1	0	0	1	0	0
10	10930388	.	A	T	0	2	2	0	0	2	0	0
10	10998496	.	T	G	1	4	5	0	1	6	0	0
10	11001720	.	T	C	3	11	14	0	0	14	0	0
10	11001867	.	A	G	2	5	7	0	1	8	0	0
10	11002005	.	T	A	2	6	8	0	1	9	0	0
10	11092782	.	T	A	7	5	12	0	0	12	0	0
10	11092797	.	A	T	2	5	7	0	4	11	0	0
10	11092936	.	C	T	12	7	19	0	1	20	0	0
10	11093251	.	G	A	7	12	19	0	0	19	0	0
10	11093626	.	C	T	11	6	17	0	1	18	0	0
10	11093968	.	T	C	10	7	17	0	4	21	0	0
10	11146361	.	A	T	1	1	2	0	0	2	0	0
10	11146585	.	A	T	3	5	8	0	0	8	0	0
10	11149391	.	G	A	7	2	9	0	1	10	0	0
10	11166798	.	G	A	0	1	1	0	1	2	0	0
10	11178600	.	C	A	6	2	8	0	0	8	0	0
10	11183301	.	C	T	0	3	3	0	4	7	0	0
10	11279555	.	G	A	2	0	2	0	0	2	0	0
10	11280441	.	G	A	2	4	6	0	0	6	0	0
10	11286674	.	C	T	2	6	8	0	0	8	0	0
10	11286830	.	C	T	8	4	12	0	1	13	0	0
10	11286902	.	C	T	3	3	6	0	0	6	0	0
10	11286911	.	C	A	4	2	6	0	1	7	0	0
10	11298651	.	G	A	0	1	1	0	0	1	0	0
10	11298652	.	A	C	0	1	1	0	0	1	0	0
10	11298852	.	G	A	3	7	10	0	0	10	0	0
10	11298975	.	C	T	0	2	2	0	1	3	0	0
10	11320031	.	G	A	1	1	2	0	0	2	0	0
10	11320087	.	A	C	3	2	5	0	1	6	0	0
10	11322659	.	C	T	0	2	2	0	0	2	0	0
10	11327604	.	T	C	6	3	9	0	0	9	0	0
10	11327657	.	C	T	4	3	7	0	1	8	0	0
10	11328334	.	G	A	5	7	12	0	0	12	0	0
10	11331922	.	C	T	0	6	6	0	3	9	0	0
10	11339235	.	G	A	6	4	10	0	0	10	0	0
10	11339283	.	G	A	4	3	7	0	2	9	0	0
10	11347906	.	G	T	3	1	4	0	2	6	0	0
10	11347961	.	G	T	5	8	13	0	0	13	0	0
10	11348147	.	C	T	0	1	1	0	1	2	0	0
10	11362275	.	C	T	16	18	34	0	2	36	0	0
10	11367979	.	C	T	15	14	29	0	1	30	0	0
10	11367980	.	T	C	15	14	29	0	1	30	0	0
10	11368106	.	T	C	3	4	7	0	0	7	0	0
10	11368195	.	G	A	4	2	6	0	0	6	0	0
10	11368249	.	A	G	8	9	17	0	0	17	0	0
10	11501181	.	C	A	6	3	9	0	0	9	0	0
10	11774203	.	C	T	6	9	15	0	0	15	0	0
10	11838927	.	C	T	0	3	3	0	3	6	0	0
10	12664210	.	T	A	0	2	2	0	0	2	0	0
10	13063611	.	A	T	1	4	5	0	0	5	0	0
10	13063921	.	C	T	2	2	4	0	0	4	0	0
10	13236364	.	T	A	2	4	6	0	1	7	0	0
10	13236384	.	A	G	4	6	10	0	0	10	0	0
10	13239089	.	G	A	4	3	7	0	0	7	0	0
10	13283594	.	C	T	4	6	10	0	0	10	0	0
10	13283660	.	C	A	3	5	8	0	1	9	0	0
10	13283729	.	C	T	2	2	4	0	0	4	0	0
10	13283741	.	G	A	0	3	3	0	2	5	0	0
10	13283792	.	T	C	1	2	3	0	0	3	0	0
10	13283891	.	G	A	0	4	4	0	3	7	0	0
10	13286430	.	C	T	4	4	8	0	1	9	0	0
10	13286951	.	C	G	2	2	4	0	0	4	0	0
10	13460494	.	A	C	8	6	14	0	0	14	0	0
10	13460615	.	C	T	7	15	22	0	2	24	0	0
10	13460699	.	G	A	14	8	22	0	4	26	0	0
10	13460730	.	C	T	14	14	28	0	3	31	0	0
10	13461150	.	G	A	10	15	25	0	0	25	0	0
10	14275033	.	T	A	1	2	3	0	0	3	0	0
10	14491139	.	C	T	5	4	9	0	0	9	0	0
10	14493798	.	T	C	7	13	20	0	0	20	0	0
10	14493819	.	A	T	9	10	19	0	0	19	0	0
10	14493878	.	G	T	0	11	11	0	12	23	0	0
10	14493967	.	G	C	0	8	8	0	14	22	0	0
10	14533337	.	G	A	8	7	15	0	0	15	0	0
10	14533352	.	A	G	8	9	17	0	0	17	0	0
10	14542886	.	A	G	10	6	16	0	0	16	0	0
10	14542962	.	G	A	6	10	16	0	0	16	0	0
10	14543044	.	A	T	3	7	10	0	6	16	0	0
10	14543256	.	A	C	12	6	18	0	0	18	0	0
10	14543259	.	G	T	11	6	17	0	1	18	0	0
10	14543307	.	C	T	18	9	27	0	0	27	0	0
10	14545572	.	A	G	17	8	25	0	1	26	0	0
10	14871409	.	T	A	9	14	23	0	2	25	0	0
10	14871412	.	T	A	10	12	22	0	1	23	0	0
10	14871768	.	A	G	11	17	28	0	1	29	0	0
10	14871801	.	A	C	13	14	27	0	1	28	0	0
10	14872703	.	G	A	11	6	17	0	1	18	0	0
10	14920777	.	G	A	1	0	1	0	0	1	0	0
10	14921086	.	A	C	8	0	8	0	9	17	0	0
10	14929560	.	G	A	3	10	13	0	1	14	0	0
10	15598769	.	A	T	11	4	15	0	1	16	0	0
10	16061756	.	T	C	1	4	5	1	0	6	0	0
10	16562835	.	A	G	9	3	12	0	0	12	0	0
10	18887819	.	A	G	1	0	1	0	0	1	0	0
10	18906617	.	C	A	6	6	12	0	7	21	2	0
10	18906618	.	A	G	8	5	13	0	8	21	0	0
10	18911166	.	A	G	4	4	8	0	0	8	0	0
10	18927910	.	C	T	1	0	1	0	0	1	0	0
10	18930403	.	T	C	5	7	12	0	0	12	0	0
10	18934147	.	T	C	6	4	10	0	0	10	0	0
10	18934215	.	C	A	8	4	12	0	1	13	0	0
10	18934291	.	T	C	6	5	11	0	0	11	0	0
10	18934499	.	C	T	6	6	12	0	0	12	0	0
10	18934530	.	A	G	3	5	8	0	0	8	0	0
10	18934590	.	A	C	9	16	25	0	1	26	0	0
10	18934634	.	G	T	7	18	25	0	0	25	0	0
10	18934683	.	T	C	8	12	20	0	2	22	0	0
10	18934821	.	A	C	7	9	16	0	0	16	0	0
10	18935246	.	T	C	14	18	32	0	1	33	0	0
10	18935316	.	C	T	11	16	27	0	0	27	0	0
10	18935413	.	C	T	14	18	32	0	1	33	0	0
10	18935430	.	A	T	14	19	33	0	0	33	0	0
10	18935874	.	T	A	6	7	13	0	0	13	0	0
10	18970673	.	C	T	3	4	7	0	1	8	0	0
10	18970742	.	G	T	3	0	3	0	0	3	0	0
10	18977233	.	G	A	0	0	0	0	5	5	0	0
10	19017284	.	C	T	1	4	5	0	0	5	0	0
10	19017316	.	C	T	1	0	1	0	0	1	0	0
10	19020475	.	A	G	7	10	17	0	1	18	0	0
10	19020537	.	G	A	9	9	18	0	0	18	0	0
10	19021075	.	G	A	9	4	13	0	3	16	0	0
10	19021432	.	A	G	1	2	3	0	0	3	0	0
10	19090766	.	A	T	1	2	3	0	0	3	0	0
10	19090780	.	C	G	1	2	3	0	0	3	0	0
10	19559235	.	A	G	6	5	11	0	0	11	0	0
10	19559274	.	C	T	12	10	22	0	3	25	0	0
10	19561232	.	C	A	10	7	17	0	0	17	0	0
10	19561837	.	G	A	14	18	32	0	4	36	0	0
10	19562120	.	C	T	6	0	6	0	1	7	0	0
10	19562945	.	C	T	6	5	11	0	1	12	0	0
10	19564401	.	G	A	16	15	31	0	0	31	0	0
10	19565792	.	C	A	25	24	49	0	1	50	0	0
10	19565988	.	G	C	27	31	58	0	3	61	0	0
10	19566142	.	A	T	28	31	59	0	1	60	0	0
10	19566373	.	C	T	15	12	27	0	1	28	0	0
10	20527571	.	C	T	0	5	5	0	0	5	0	0
10	20604555	.	T	C	3	33	36	0	0	36	0	0
10	20636479	.	T	C	3	5	8	0	0	8	0	0
10	20636480	.	T	C	0	8	8	0	0	8	0	0
10	21679442	.	T	C	2	2	4	0	0	4	0	0
10	21679496	.	G	A	1	1	2	0	1	3	0	0
10	21679497	.	C	A	2	1	3	0	0	3	0	0
10	21702907	.	G	T	0	1	1	0	0	1	0	0
10	21702953	.	G	T	5	1	6	0	0	6	0	0
10	21702955	.	A	T	5	1	6	0	0	6	0	0
10	21778980	.	C	T	5	5	10	3	0	13	0	0
10	21781313	.	C	T	3	2	5	0	0	5	0	0
10	21781710	.	T	C	15	10	25	1	0	26	0	0
10	21785677	.	C	T	12	8	20	0	0	20	0	0
10	21785734	.	C	T	8	3	11	0	0	11	0	0
10	21788725	.	A	C	10	0	10	3	0	13	0	0
10	21788732	.	A	G	10	0	10	4	0	14	0	0
10	21791552	.	G	T	1	4	5	0	1	6	0	0
10	21795805	.	G	A	1	8	9	0	2	11	0	0
10	21798215	.	C	A	3	7	10	0	1	11	0	0
10	21799605	.	C	T	5	5	10	1	0	11	0	0
10	21802959	.	T	C	5	11	16	0	0	16	0	0
10	21802989	.	T	C	5	11	16	0	0	16	0	0
10	21803004	.	G	A	8	8	16	0	0	16	0	0
10	21803031	.	G	A	0	12	12	0	2	14	0	0
10	21917929	.	G	T	1	2	3	0	0	3	0	0
10	22163002	.	G	T	4	5	9	0	0	9	0	0
10	22248334	.	C	T	0	3	3	0	0	3	0	0
10	22382167	.	G	A	1	5	6	0	11	17	0	0
10	22382454	.	C	T	3	8	11	0	0	11	0	0
10	22439796	.	G	A	0	5	5	0	2	7	0	0
10	22477694	.	C	A	3	12	15	0	1	16	0	0
10	22477724	.	G	A	10	8	18	0	3	21	0	0
10	22477880	.	A	G	25	0	25	0	16	41	0	0
10	22477952	.	A	T	15	22	37	0	2	39	0	0
10	22510550	.	C	A	1	5	6	0	1	7	0	0
10	22510670	.	T	A	4	3	7	0	0	7	0	0
10	22516643	.	C	G	1	6	7	0	1	8	0	0
10	22516710	.	G	A	6	5	11	0	0	11	0	0
10	22516903	.	A	G	3	2	5	0	0	5	0	0
10	22518237	.	G	A	0	8	8	0	7	15	0	0
10	22518267	.	T	A	7	10	17	0	1	18	0	0
10	22519465	.	A	G	4	3	7	0	0	7	0	0
10	22525652	.	G	A	3	4	7	0	0	7	0	0
10	22531003	.	T	A	3	3	6	0	1	7	0	0
10	22531179	.	A	G	8	4	12	0	0	12	0	0
10	22531422	.	A	G	2	0	2	0	9	11	0	0
10	22531803	.	A	T	6	2	8	0	1	9	0	0
10	22531912	.	G	A	13	5	18	0	1	19	0	0
10	22532133	.	G	T	6	9	15	0	1	16	0	0
10	22532287	.	T	A	10	12	22	0	2	24	0	0
10	22532316	.	G	A	18	7	25	0	0	25	0	0
10	22532347	.	C	T	13	4	17	0	0	17	0	0
10	22532610	.	A	T	10	15	25	0	1	26	0	0
10	22532918	.	A	T	12	6	18	0	0	18	0	0
10	22745285	.	T	C	4	4	8	0	0	8	0	0
10	22745661	.	C	T	7	8	15	0	0	15	0	0
10	22747913	.	T	C	6	3	9	0	1	10	0	0
10	22747995	.	T	C	7	6	13	0	0	13	0	0
10	22748442	.	G	T	6	2	8	0	0	8	0	0
10	22749361	.	T	G	5	0	5	0	9	14	0	0
10	22749466	.	T	C	1	5	6	0	1	7	0	0
10	22749681	.	G	A	2	7	9	0	0	9	0	0
10	22751095	.	G	A	1	1	2	0	0	2	0	0
10	22753455	.	G	A	4	6	10	0	0	10	0	0
10	22754289	.	C	T	3	8	11	0	0	11	0	0
10	22755164	.	C	T	5	4	9	0	0	9	0	0
10	22758016	.	G	A	3	4	7	0	0	7	0	0
10	22758094	.	A	G	0	0	0	0	4	4	0	0
10	22758303	.	A	G	1	3	4	0	0	4	0	0
10	22760658	.	A	C	6	6	12	0	1	13	0	0
10	22782648	.	A	C	11	7	18	0	1	19	0	0
10	22785632	.	C	T	4	3	7	0	0	7	0	0
10	22785820	.	C	A	5	1	6	0	0	6	0	0
10	22785983	.	C	T	8	3	11	0	0	11	0	0
10	22786044	.	C	A	5	7	12	0	1	13	0	0
10	22786054	.	A	G	5	8	13	0	0	13	0	0
10	22786128	.	T	A	5	7	12	0	0	12	0	0
10	22786281	.	G	A	1	1	2	0	1	3	0	0
10	22811406	.	T	C	4	0	4	0	6	10	0	0
10	22811621	.	A	C	4	0	4	0	6	10	0	0
10	22811633	.	C	T	7	3	10	0	0	10	0	0
10	22813194	.	C	T	3	3	6	0	0	6	0	0
10	22814722	.	A	C	4	3	7	0	0	7	0	0
10	22814750	.	G	A	2	5	7	0	0	7	0	0
10	22814833	.	G	A	9	7	16	0	0	16	0	0
10	22814847	.	A	T	10	4	14	0	2	16	0	0
10	22814905	.	C	T	2	2	4	0	0	4	0	0
10	22815243	.	T	C	0	0	0	0	1	1	0	0
10	22838530	.	C	T	0	22	22	0	32	54	0	0
10	22841955	.	G	T	11	11	22	0	2	24	0	0
10	22845286	.	C	A	7	17	24	0	0	24	0	0
10	22845293	.	C	T	1	9	10	0	17	27	0	0
10	22854976	.	A	T	2	2	4	0	0	4	0	0
10	22854977	.	G	A	2	2	4	0	0	4	0	0
10	22861834	.	A	G	2	5	7	0	0	7	0	0
10	22861836	.	C	T	2	5	7	0	0	7	0	0
10	22891212	.	A	G	6	7	13	0	1	14	0	0
10	22891237	.	A	T	6	4	10	0	2	12	0	0
10	22894100	.	G	A	3	0	3	0	1	4	0	0
10	22895312	.	T	C	1	3	4	0	0	4	0	0
10	22896775	.	C	T	1	1	2	0	0	2	0	0
10	22896782	.	C	A	1	1	2	0	0	2	0	0
10	22896950	.	C	T	1	0	1	0	0	1	0	0
10	22896959	.	G	A	0	0	0	0	1	1	0	0
10	22897187	.	C	T	7	4	11	0	1	12	0	0
10	22906783	.	T	C	5	11	16	0	0	16	0	0
10	22906844	.	C	T	11	10	21	0	1	22	0	0
10	22906916	.	A	T	15	8	23	0	2	25	0	0
10	22907242	.	A	T	12	2	14	0	0	14	0	0
10	22907330	.	G	A	4	2	6	0	0	6	0	0
10	22915777	.	T	C	12	7	19	0	0	19	0	0
10	22915958	.	C	G	4	0	4	0	1	5	0	0
10	22915975	.	T	G	4	2	6	0	0	6	0	0
10	22915993	.	T	C	3	3	6	0	0	6	0	0
10	22916490	.	G	A	26	22	48	0	1	49	0	0
10	22916520	.	T	C	23	24	47	0	2	49	0	0
10	22916661	.	G	C	37	18	55	0	2	57	0	0
10	22916739	.	G	A	24	12	36	0	2	38	0	0
10	22918122	.	A	T	18	38	56	0	3	60	1	0
10	22918124	.	A	C	22	0	22	0	38	60	0	0
10	22918214	.	T	G	5	4	9	0	0	9	0	0
10	22921942	.	T	C	5	3	8	0	0	8	0	0
10	22921976	.	A	T	5	3	8	0	1	9	0	0
10	22924978	.	A	C	5	12	17	0	2	19	0	0
10	22925049	.	G	A	0	7	7	0	8	15	0	0
10	22925326	.	G	A	1	4	5	0	0	5	0	0
10	22925983	.	A	C	2	4	6	0	0	6	0	0
10	23024360	.	C	T	11	11	22	0	2	24	0	0
10	23024584	.	A	C	17	17	34	0	1	35	0	0
10	23026025	.	T	C	14	17	31	0	1	32	0	0
10	23060643	.	C	T	6	5	11	0	1	12	0	0
10	23060740	.	G	A	0	3	3	0	0	3	0	0
10	23061326	.	G	A	0	3	3	0	3	6	0	0
10	23065084	.	G	A	2	2	4	0	0	4	0	0
10	23065247	.	T	C	1	1	2	0	0	2	0	0
10	23065295	.	C	T	2	1	3	0	0	3	0	0
10	23068553	.	G	T	3	7	10	0	2	12	0	0
10	23068907	.	T	G	9	11	20	0	1	21	0	0
10	23069068	.	C	T	14	4	18	0	1	19	0	0
10	23071025	.	A	T	5	2	7	0	1	8	0	0
10	23071465	.	T	C	1	0	1	0	4	5	0	0
10	23071524	.	G	T	4	4	8	0	0	8	0	0
10	23071619	.	A	G	4	4	8	0	1	9	0	0
10	23125011	.	A	G	1	0	1	0	4	5	0	0
10	23126558	.	T	C	0	1	1	0	0	1	0	0
10	23126678	.	T	C	3	2	5	0	0	5	0	0
10	23135655	.	C	T	5	3	8	0	0	8	0	0
10	23139296	.	C	T	2	4	6	0	0	6	0	0
10	23220530	.	T	A	2	6	8	0	3	11	0	0
10	23220533	.	A	G	7	2	9	0	3	12	0	0
10	23246073	.	G	T	3	3	6	0	0	6	0	0
10	24302893	.	C	T	3	2	5	0	0	5	0	0
10	24324014	.	G	T	20	15	35	0	4	39	0	0
10	24325590	.	C	T	2	1	3	0	0	3	0	0
10	24326242	.	C	T	2	9	11	0	0	11	0	0
10	24334999	.	T	G	4	3	7	1	0	8	0	0
10	24340993	.	T	C	2	0	2	0	4	6	0	0
10	24373701	.	A	T	2	2	4	0	0	4	0	0
10	24373721	.	G	T	1	2	3	0	0	3	0	0
10	24422070	.	T	A	8	6	14	0	0	14	0	0
10	24422205	.	G	A	5	5	10	0	3	13	0	0
10	24422311	.	G	A	4	5	9	0	0	9	0	0
10	24425257	.	A	G	5	9	14	0	0	14	0	0
10	24425653	.	A	G	3	2	5	0	0	5	0	0
10	24426924	.	A	G	2	2	4	0	1	5	0	0
10	24427010	.	G	C	3	4	7	0	0	7	0	0
10	24429282	.	A	C	0	2	2	0	1	3	0	0
10	24429386	.	C	T	4	4	8	0	0	8	0	0
10	24431479	.	C	T	4	3	7	0	0	7	0	0
10	24431719	.	A	T	8	8	16	0	1	17	0	0
10	24431762	.	C	T	3	3	6	0	0	6	0	0
10	24431795	.	T	C	1	0	1	0	0	1	0	0
10	24431807	.	C	T	1	0	1	0	0	1	0	0
10	24437128	.	A	G	1	1	2	0	0	2	0	0
10	24439910	.	A	G	6	0	6	0	6	12	0	0
10	24442373	.	C	A	10	5	15	0	1	16	0	0
10	24563892	.	T	G	3	8	11	0	0	11	0	0
10	24564040	.	T	C	8	10	18	0	3	21	0	0
10	24564935	.	C	A	10	8	18	0	0	18	0	0
10	24565137	.	G	A	1	17	18	0	5	23	0	0
10	24565139	.	A	T	6	15	21	0	2	23	0	0
10	24566124	.	T	C	12	7	19	0	0	19	0	0
10	24573740	.	G	A	0	1	1	0	2	3	0	0
10	24573827	.	C	T	10	8	18	0	1	19	0	0
10	24600110	.	A	G	5	0	5	0	10	15	0	0
10	24600128	.	A	G	13	10	23	0	1	24	0	0
10	24609175	.	G	A	0	1	1	0	0	1	0	0
10	24621534	.	T	A	13	13	26	0	1	28	1	0
10	24621722	.	C	G	1	4	5	0	0	5	0	0
10	24621730	.	A	T	1	5	6	0	0	6	0	0
10	24621757	.	T	A	2	2	4	0	1	5	0	0
10	24650194	.	A	G	5	6	11	0	0	11	0	0
10	24650769	.	T	C	3	0	3	0	5	8	0	0
10	24652174	.	A	T	1	2	3	0	0	3	0	0
10	24653833	.	G	A	3	3	6	0	0	6	0	0
10	24653920	.	C	T	7	4	11	0	3	14	0	0
10	24653989	.	T	A	2	10	12	0	0	12	0	0
10	24654142	.	A	C	8	0	8	0	6	14	0	0
10	24654376	.	G	T	4	3	7	0	3	10	0	0
10	24654906	.	T	C	0	0	0	0	8	8	0	0
10	24659337	.	T	C	2	0	2	0	0	2	0	0
10	24659358	.	T	G	0	2	2	0	0	2	0	0
10	24659511	.	C	T	2	2	4	0	0	4	0	0
10	24659769	.	T	A	4	2	6	0	0	6	0	0
10	24662393	.	G	A	1	2	3	0	0	3	0	0
10	24662642	.	T	C	1	0	1	0	0	1	0	0
10	24677119	.	A	G	4	5	9	0	0	9	0	0
10	24685215	.	G	A	0	2	2	0	1	3	0	0
10	24685901	.	G	A	1	2	3	0	0	3	0	0
10	24686104	.	A	T	2	6	8	0	0	8	0	0
10	24686143	.	G	A	0	2	2	0	2	4	0	0
10	24710282	.	A	T	4	3	7	0	0	7	0	0
10	24710599	.	A	C	3	8	11	0	0	11	0	0
10	24710977	.	G	A	2	2	4	0	0	4	0	0
10	24716499	.	A	C	1	0	1	0	0	1	0	0
10	24725871	.	C	A	4	11	15	0	1	16	0	0
10	24726059	.	A	C	2	7	9	0	0	9	0	0
10	24726453	.	G	A	3	4	7	0	0	7	0	0
10	24726532	.	T	C	5	3	8	0	0	8	0	0
10	24726551	.	T	C	3	3	6	0	0	6	0	0
10	24727085	.	G	A	5	3	8	0	0	8	0	0
10	24736924	.	G	A	2	2	4	0	0	4	0	0
10	24762377	.	G	A	5	3	8	0	0	8	0	0
10	24762402	.	C	A	8	4	12	0	1	13	0	0
10	24762427	.	C	T	3	11	14	0	1	15	0	0
10	24762543	.	G	A	4	4	8	0	2	10	0	0
10	24762553	.	G	A	5	5	10	0	1	11	0	0
10	24762579	.	T	C	7	0	7	0	6	13	0	0
10	24762707	.	T	C	5	0	5	0	5	10	0	0
10	24762759	.	T	A	3	9	12	0	1	13	0	0
10	25035544	.	C	T	5	2	7	0	0	7	0	0
10	25035588	.	G	T	2	3	5	0	0	5	0	0
10	25035589	.	G	A	2	3	5	0	0	5	0	0
10	25109225	.	A	C	6	6	12	0	0	12	0	0
10	25109234	.	C	T	7	6	13	0	0	13	0	0
10	25109288	.	G	A	2	5	7	0	0	7	0	0
10	25109591	.	C	T	2	2	4	0	1	5	0	0
10	25109597	.	G	A	2	3	5	0	0	5	0	0
10	25141616	.	A	G	0	1	1	0	0	1	0	0
10	25205338	.	C	A	5	3	8	0	1	9	0	0
10	25209612	.	G	A	7	4	11	0	0	11	0	0
10	25209935	.	C	T	1	0	1	0	0	1	0	0
10	25210125	.	C	A	5	9	14	0	0	14	0	0
10	25212215	.	C	G	9	0	9	0	14	23	0	0
10	25222392	.	G	T	2	3	5	0	0	5	0	0
10	25252426	.	G	A	0	1	1	0	0	1	0	0
10	25252522	.	C	T	3	6	9	0	0	9	0	0
10	25262003	.	C	T	8	7	15	0	0	15	0	0
10	25262279	.	C	T	14	4	18	0	0	18	0	0
10	25267829	.	A	T	21	14	35	0	2	37	0	0
10	25267952	.	T	C	8	16	24	0	2	26	0	0
10	25268191	.	C	A	9	5	14	0	0	14	0	0
10	25268394	.	C	T	7	8	15	0	1	16	0	0
10	25268882	.	T	A	1	3	4	0	0	4	0	0
10	25269492	.	A	G	13	1	14	0	18	32	0	0
10	25270184	.	A	G	18	0	18	0	7	25	0	0
10	25270395	.	A	G	20	7	27	0	1	28	0	0
10	25270471	.	A	G	11	12	23	0	2	25	0	0
10	25271121	.	G	A	21	20	41	0	3	44	0	0
10	25271323	.	A	G	10	16	26	0	0	26	0	0
10	25271368	.	C	T	3	4	7	0	0	7	0	0
10	25312828	.	T	G	10	9	19	0	3	22	0	0
10	25312906	.	A	C	3	3	6	0	0	6	0	0
10	25313204	.	G	A	8	6	14	0	1	15	0	0
10	25313364	.	T	C	5	8	13	0	1	14	0	0
10	25313372	.	T	G	2	7	9	0	2	11	0	0
10	25318957	.	A	G	1	0	1	0	0	1	0	0
10	25321269	.	T	C	2	0	2	0	4	6	0	0
10	25336095	.	G	A	6	2	8	0	0	8	0	0
10	25338762	.	G	A	14	12	26	0	0	26	0	0
10	25342915	.	A	T	6	13	19	0	1	20	0	0
10	25381409	.	C	G	1	2	3	0	0	3	0	0
10	25383998	.	C	A	2	2	4	0	0	4	0	0
10	25403153	.	C	T	0	4	4	0	2	6	0	0
10	25403402	.	C	T	0	11	11	0	6	17	0	0
10	25410389	.	A	G	9	8	17	0	0	17	0	0
10	25426586	.	C	T	0	1	1	0	1	2	0	0
10	25435335	.	G	C	2	0	2	0	3	5	0	0
10	25436518	.	C	A	2	2	4	0	0	4	0	0
10	25436557	.	C	T	0	1	1	0	0	1	0	0
10	25461335	.	C	T	0	1	1	0	3	4	0	0
10	25462325	.	A	T	2	3	5	0	1	6	0	0
10	25573218	.	A	G	10	10	20	0	1	21	0	0
10	25573365	.	C	A	10	10	20	0	0	20	0	0
10	25573393	.	T	C	8	0	8	0	11	19	0	0
10	25573410	.	T	C	6	6	12	0	0	12	0	0
10	25573436	.	C	G	7	6	13	0	1	14	0	0
10	25574092	.	T	C	5	0	5	0	8	13	0	0
10	25574127	.	T	A	4	8	12	0	0	12	0	0
10	25574171	.	A	G	3	10	13	0	0	13	0	0
10	25574316	.	A	G	7	5	12	0	0	12	0	0
10	25580119	.	A	T	0	0	0	0	1	1	0	0
10	25581999	.	G	A	3	1	4	0	0	4	0	0
10	25582029	.	A	G	1	1	2	0	1	3	0	0
10	25582074	.	G	T	0	3	3	0	0	3	0	0
10	25582101	.	G	A	2	0	2	0	0	2	0	0
10	25582656	.	C	T	3	2	5	0	0	5	0	0
10	25582689	.	G	A	0	1	1	0	0	1	0	0
10	25601719	.	G	A	3	6	9	0	1	10	0	0
10	25657238	.	C	T	2	1	3	0	0	3	0	0
10	25657262	.	T	G	2	2	4	0	0	4	0	0
10	25657307	.	A	T	1	2	3	0	0	3	0	0
10	25694637	.	G	A	22	21	43	0	2	45	0	0
10	25694844	.	G	A	13	14	27	0	0	27	0	0
10	25694848	.	C	T	16	15	31	0	0	31	0	0
10	25694920	.	G	A	3	1	4	0	0	4	0	0
10	25697655	.	A	G	9	6	15	0	0	15	0	0
10	25697715	.	G	C	5	7	12	0	0	12	0	0
10	25706449	.	C	T	0	1	1	0	0	1	0	0
10	25829536	.	T	A	1	3	4	0	0	4	0	0
10	25829724	.	C	T	0	3	3	0	1	4	0	0
10	25830373	.	A	G	6	6	12	0	0	12	0	0
10	25830544	.	T	G	6	14	20	0	0	20	0	0
10	25830687	.	A	G	8	14	22	0	0	22	0	0
10	25830723	.	T	G	2	12	14	0	0	14	0	0
10	25834681	.	G	C	2	0	2	0	4	6	0	0
10	25837574	.	T	G	3	6	9	0	0	9	0	0
10	25837613	.	A	G	3	5	8	0	0	8	0	0
10	25841059	.	T	C	3	3	6	0	0	6	0	0
10	25960676	.	A	C	6	11	17	0	1	18	0	0
10	25960718	.	T	C	8	7	15	0	0	15	0	0
10	25960728	.	G	T	7	7	14	0	0	14	0	0
10	25961061	.	T	C	1	2	3	0	0	3	0	0
10	25961129	.	T	A	1	3	4	0	0	4	0	0
10	25961396	.	T	C	3	9	12	0	0	12	0	0
10	25961397	.	T	A	3	9	12	0	0	12	0	0
10	25961454	.	G	C	6	20	26	0	1	27	0	0
10	25961510	.	A	C	11	21	32	0	1	33	0	0
10	25961778	.	A	G	6	12	18	0	0	18	0	0
10	25961933	.	C	T	3	4	7	1	0	9	1	0
10	25983400	.	T	C	1	2	3	0	0	3	0	0
10	25985794	.	C	A	1	2	3	0	0	3	0	0
10	25986499	.	T	C	1	3	4	0	0	4	0	0
10	25987288	.	C	T	1	3	4	0	0	4	0	0
10	26098663	.	C	T	3	2	5	0	0	5	0	0
10	26100267	.	C	T	0	2	2	0	0	2	0	0
10	26106098	.	A	G	1	1	2	0	0	2	0	0
10	26107729	.	G	A	0	1	1	0	0	1	0	0
10	26111487	.	T	C	2	2	4	0	2	6	0	0
10	26111631	.	T	C	3	4	7	0	0	7	0	0
10	26112160	.	A	C	2	4	6	0	0	6	0	0
10	26113095	.	C	G	3	5	8	0	1	9	0	0
10	26113370	.	G	A	5	4	9	0	0	9	0	0
10	26113522	.	A	T	1	2	3	0	0	3	0	0
10	26113542	.	A	C	1	2	3	0	0	3	0	0
10	26113931	.	C	T	4	6	10	0	2	12	0	0
10	26114472	.	G	C	2	3	5	0	0	5	0	0
10	26114474	.	T	C	2	3	5	0	0	5	0	0
10	26114508	.	A	T	5	1	6	0	1	7	0	0
10	26114509	.	C	T	5	2	7	0	0	7	0	0
10	26114562	.	C	G	4	5	9	0	0	9	0	0
10	26114894	.	A	T	2	5	7	0	1	8	0	0
10	26114922	.	A	C	5	5	10	0	0	10	0	0
10	26114952	.	A	T	5	4	9	0	1	10	0	0
10	26115080	.	G	C	6	6	12	0	0	12	0	0
10	26115225	.	C	T	3	5	8	0	0	8	0	0
10	26118717	.	G	C	3	4	7	0	0	7	0	0
10	26123308	.	A	C	4	3	7	0	0	7	0	0
10	26123649	.	A	T	2	3	5	0	0	5	0	0
10	26123667	.	A	C	1	1	2	0	0	2	0	0
10	26126639	.	C	G	7	4	11	0	1	12	0	0
10	26126643	.	T	C	9	4	13	0	0	13	0	0
10	26126903	.	C	T	5	2	7	0	0	7	0	0
10	26126995	.	A	T	5	6	11	0	2	13	0	0
10	26127054	.	G	A	8	9	17	0	0	17	0	0
10	26127075	.	T	C	4	10	14	0	0	14	0	0
10	26127291	.	T	C	15	16	31	0	0	31	0	0
10	26127479	.	C	A	2	10	12	0	0	12	0	0
10	26127484	.	C	T	2	9	11	0	0	11	0	0
10	26127731	.	C	T	8	5	13	0	0	13	0	0
10	26127968	.	G	T	9	4	13	0	0	13	0	0
10	26128067	.	A	T	6	5	11	0	1	12	0	0
10	26128107	.	C	T	3	4	7	0	0	7	0	0
10	26131166	.	G	A	12	9	21	0	0	21	0	0
10	26131195	.	C	T	0	11	11	0	10	21	0	0
10	26131551	.	C	G	18	13	31	0	2	33	0	0
10	26131622	.	T	C	18	0	18	0	10	28	0	0
10	26131653	.	C	T	15	10	25	0	2	27	0	0
10	26131717	.	A	T	14	6	20	0	0	20	0	0
10	26131719	.	T	C	13	6	19	0	1	20	0	0
10	26131806	.	A	T	11	8	19	0	3	22	0	0
10	26131989	.	C	T	11	6	17	0	1	18	0	0
10	26132084	.	G	T	5	8	13	0	0	13	0	0
10	26132159	.	T	A	3	3	6	0	0	6	0	0
10	26132356	.	A	G	7	5	12	0	0	12	0	0
10	26132437	.	A	T	12	10	22	0	0	22	0	0
10	26132553	.	A	G	18	14	32	0	0	32	0	0
10	26132630	.	C	A	0	2	2	0	1	3	0	0
10	26139304	.	G	A	16	15	31	0	1	32	0	0
10	26139352	.	A	T	6	7	13	0	0	13	0	0
10	26141198	.	C	T	3	2	5	0	1	6	0	0
10	26144153	.	T	G	10	9	19	0	1	20	0	0
10	26144180	.	A	G	10	6	16	0	3	19	0	0
10	26144243	.	A	G	9	10	19	0	0	19	0	0
10	26144249	.	C	A	10	12	22	0	0	22	0	0
10	26150862	.	A	G	12	3	15	0	1	16	0	0
10	26155871	.	T	G	2	6	8	0	3	11	0	0
10	26163911	.	G	A	1	4	5	0	0	5	0	0
10	26204886	.	A	T	10	7	17	0	0	17	0	0
10	26204897	.	G	C	9	7	16	0	0	16	0	0
10	26205057	.	A	T	1	4	5	0	0	5	0	0
10	26205169	.	G	A	5	6	11	0	1	12	0	0
10	26205176	.	A	T	5	6	11	0	0	11	0	0
10	26205206	.	A	T	7	3	10	0	0	10	0	0
10	26205805	.	A	T	2	9	11	0	0	11	0	0
10	26205909	.	C	A	8	3	11	0	0	11	0	0
10	26206509	.	C	T	0	1	1	0	2	3	0	0
10	26209385	.	C	T	4	6	10	0	0	10	0	0
10	26209400	.	C	T	5	2	7	0	2	9	0	0
10	26225398	.	T	C	3	0	3	0	1	4	0	0
10	26269180	.	C	G	2	3	5	0	0	5	0	0
10	26269186	.	A	G	2	3	5	0	0	5	0	0
10	26270388	.	C	A	2	5	7	0	1	8	0	0
10	26271159	.	G	T	4	1	5	0	1	6	0	0
10	26271168	.	G	A	4	2	6	0	0	6	0	0
10	26271357	.	C	A	1	5	6	0	0	6	0	0
10	26271867	.	G	A	2	2	4	0	0	4	0	0
10	26272941	.	A	T	2	2	4	0	0	4	0	0
10	26273046	.	T	C	1	0	1	0	2	3	0	0
10	26273521	.	C	G	0	3	3	0	1	4	0	0
10	26273557	.	T	C	2	3	5	0	0	5	0	0
10	26279124	.	G	A	2	3	5	0	0	5	0	0
10	26279519	.	T	C	3	2	5	0	0	5	0	0
10	26666839	.	T	C	11	20	31	0	0	31	0	0
10	26717237	.	C	T	12	10	22	0	0	22	0	0
10	26717246	.	G	A	13	10	23	0	0	23	0	0
10	26717582	.	T	A	8	9	17	0	1	18	0	0
10	26717687	.	G	A	12	7	19	0	0	19	0	0
10	26717740	.	A	G	14	7	21	0	2	23	0	0
10	26717783	.	A	G	17	13	30	0	3	33	0	0
10	26717954	.	G	T	5	4	9	0	0	9	0	0
10	26723422	.	C	T	0	9	9	0	3	12	0	0
10	26729687	.	T	C	6	3	9	0	0	9	0	0
10	26744012	.	A	G	3	5	8	0	0	8	0	0
10	26762944	.	T	C	4	8	12	0	2	14	0	0
10	26774709	.	T	G	4	5	9	0	2	11	0	0
10	26774943	.	G	A	3	4	7	0	0	7	0	0
10	26777572	.	A	G	0	1	1	0	0	1	0	0
10	26780983	.	T	C	1	2	3	0	0	3	0	0
10	26781140	.	T	C	0	1	1	0	1	2	0	0
10	26781419	.	T	C	1	0	1	0	0	1	0	0
10	26783968	.	C	T	1	4	5	0	0	5	0	0
10	26785444	.	C	T	0	2	2	0	0	2	0	0
10	26790577	.	A	G	3	2	5	0	0	5	0	0
10	26831932	.	T	A	4	3	7	0	1	8	0	0
10	26831989	.	A	C	4	7	11	0	0	11	0	0
10	26832007	.	A	C	4	7	11	0	0	11	0	0
10	26835004	.	G	A	2	3	5	0	0	5	0	0
10	26835024	.	T	C	2	4	6	0	0	6	0	0
10	26835172	.	T	C	1	4	5	0	0	5	0	0
10	26835227	.	G	T	1	7	8	0	0	8	0	0
10	26835299	.	G	A	1	7	8	0	1	9	0	0
10	26835316	.	G	C	1	4	5	0	0	5	0	0
10	26835389	.	A	T	3	7	10	0	0	10	0	0
10	26836990	.	G	A	10	18	28	0	0	29	1	0
10	26924408	.	C	A	3	3	6	0	1	7	0	0
10	26924542	.	T	C	2	3	5	0	0	5	0	0
10	26926741	.	A	G	15	15	30	0	0	30	0	0
10	26929291	.	A	T	1	0	1	0	0	1	0	0
10	26930061	.	C	A	0	1	1	0	0	1	0	0
10	26933176	.	G	T	10	6	16	0	0	16	0	0
10	26933222	.	C	T	9	8	17	0	0	17	0	0
10	26933250	.	C	A	9	6	15	0	0	15	0	0
10	26950584	.	G	A	0	1	1	0	0	1	0	0
10	26950683	.	G	T	2	4	6	0	0	6	0	0
10	26958666	.	G	C	1	2	3	0	0	3	0	0
10	26959271	.	T	A	2	4	6	0	0	6	0	0
10	26959462	.	T	C	0	3	3	0	0	3	0	0
10	26959464	.	A	G	0	3	3	0	0	3	0	0
10	26963839	.	T	A	1	0	1	0	0	1	0	0
10	26965668	.	C	G	2	2	4	0	0	4	0	0
10	26965971	.	G	A	4	3	7	0	0	7	0	0
10	26969077	.	G	T	0	7	7	0	10	17	0	0
10	26971300	.	T	A	2	3	5	0	1	6	0	0
10	26971982	.	C	T	6	7	13	0	0	13	0	0
10	26972009	.	T	C	9	8	17	0	1	18	0	0
10	26972018	.	C	T	9	8	17	0	1	18	0	0
10	26972064	.	T	C	5	10	15	0	2	17	0	0
10	26972321	.	T	A	3	2	5	0	1	6	0	0
10	26972349	.	T	C	3	6	9	0	0	9	0	0
10	26972364	.	T	C	3	6	9	0	0	9	0	0
10	26972392	.	A	T	4	3	7	0	0	7	0	0
10	26972429	.	A	T	1	2	3	0	0	3	0	0
10	26976729	.	C	A	1	1	2	0	0	2	0	0
10	26977132	.	G	T	0	2	2	0	0	2	0	0
10	26978031	.	C	T	0	2	2	0	0	2	0	0
10	26978169	.	C	G	9	8	17	0	0	17	0	0
10	26982338	.	T	C	3	2	5	0	0	5	0	0
10	26982455	.	C	T	3	2	5	0	0	5	0	0
10	26982495	.	T	C	3	4	7	0	0	7	0	0
10	26982572	.	C	G	5	2	7	0	0	7	0	0
10	26982786	.	C	T	1	5	6	0	1	7	0	0
10	26982828	.	G	A	5	2	7	0	0	7	0	0
10	26982953	.	A	G	3	5	8	0	0	8	0	0
10	26983020	.	T	C	2	4	6	0	0	6	0	0
10	26983092	.	A	C	1	2	3	0	1	4	0	0
10	26987399	.	T	C	8	0	8	0	10	18	0	0
10	26991556	.	C	T	5	20	25	0	0	25	0	0
10	26991914	.	A	T	6	5	11	0	0	11	0	0
10	26991917	.	A	G	5	5	10	0	0	10	0	0
10	26991984	.	G	C	5	1	6	0	0	6	0	0
10	26991990	.	T	C	1	1	2	0	1	3	0	0
10	26997077	.	C	A	8	7	15	0	0	15	0	0
10	26997139	.	G	T	12	11	23	0	0	23	0	0
10	26999102	.	C	T	0	5	5	0	3	8	0	0
10	26999407	.	A	T	8	11	19	0	0	19	0	0
10	26999414	.	A	G	8	8	16	0	0	16	0	0
10	27006512	.	T	A	13	17	30	0	2	32	0	0
10	27028146	.	A	G	19	19	38	0	1	39	0	0
10	27028334	.	G	T	9	23	32	0	0	32	0	0
10	27028346	.	A	G	9	18	27	0	2	29	0	0
10	27155949	.	A	G	0	0	0	0	2	2	0	0
10	27155994	.	C	T	1	3	4	0	0	4	0	0
10	27183418	.	C	T	13	15	28	0	0	28	0	0
10	27183580	.	T	C	9	0	9	0	14	23	0	0
10	27183685	.	A	T	11	17	28	0	1	29	0	0
10	27183735	.	C	T	0	14	14	0	17	31	0	0
10	27184351	.	C	T	11	11	22	0	7	29	0	0
10	27184384	.	C	T	14	15	29	0	1	30	0	0
10	27184456	.	A	G	21	10	31	0	2	33	0	0
10	27184600	.	G	A	6	12	18	0	0	18	0	0
10	27184729	.	C	T	7	9	16	0	1	17	0	0
10	27184789	.	G	A	10	11	21	0	2	23	0	0
10	27184824	.	C	A	0	13	13	0	11	24	0	0
10	27184843	.	G	A	11	10	21	0	0	21	0	0
10	27184891	.	T	A	12	17	29	0	0	29	0	0
10	27185104	.	G	A	10	10	20	0	3	23	0	0
10	27223120	.	A	T	2	3	5	0	0	5	0	0
10	27608655	.	G	A	1	5	6	0	0	6	0	0
10	27977678	.	C	T	3	3	6	0	0	6	0	0
10	27980508	.	C	T	0	5	5	0	3	8	0	0
10	27989627	.	A	T	1	1	2	0	0	2	0	0
10	28030710	.	C	T	0	4	4	0	12	16	0	0
10	28036370	.	G	A	12	14	26	0	1	27	0	0
10	28037735	.	C	T	9	4	13	0	2	15	0	0
10	28037759	.	C	T	8	2	10	0	0	10	0	0
10	28038008	.	A	G	1	5	6	0	0	6	0	0
10	28038167	.	G	A	3	4	7	0	0	7	0	0
10	28038926	.	G	A	3	2	5	0	0	5	0	0
10	28039040	.	C	T	7	6	13	0	2	15	0	0
10	28040705	.	G	T	5	9	14	0	0	14	0	0
10	28041218	.	G	C	7	8	15	0	1	16	0	0
10	28046081	.	G	A	1	0	1	0	0	1	0	0
10	28046578	.	C	A	1	1	2	0	0	2	0	0
10	28057010	.	A	G	2	7	9	0	0	9	0	0
10	28057325	.	C	T	0	4	4	0	2	6	0	0
10	28057364	.	T	C	1	0	1	0	3	4	0	0
10	28063976	.	G	A	1	3	4	0	1	5	0	0
10	28161671	.	C	G	1	2	3	0	0	3	0	0
10	28161902	.	C	T	3	3	6	0	0	6	0	0
10	28165212	.	T	C	1	2	3	0	0	3	0	0
10	28166640	.	G	A	0	1	1	0	2	3	0	0
10	28168769	.	A	G	1	1	2	0	0	2	0	0
10	28168779	.	A	G	0	0	0	0	3	3	0	0
10	28169061	.	G	A	5	3	8	0	0	8	0	0
10	28183429	.	A	C	0	1	1	0	0	1	0	0
10	28308522	.	G	A	3	3	6	0	0	6	0	0
10	28308799	.	C	T	6	2	8	0	2	10	0	0
10	28311161	.	A	G	24	15	39	0	0	39	0	0
10	28311301	.	C	T	15	22	37	0	1	38	0	0
10	28311553	.	G	T	27	16	43	0	0	43	0	0
10	28312156	.	T	A	29	27	56	0	2	58	0	0
10	28315149	.	G	A	14	16	30	0	5	35	0	0
10	28315396	.	A	G	21	14	35	0	1	36	0	0
10	28315421	.	C	G	14	14	28	0	2	30	0	0
10	28319489	.	A	G	11	16	27	0	0	27	0	0
10	28319552	.	G	A	14	11	25	0	1	26	0	0
10	28320381	.	A	G	12	6	18	0	0	18	0	0
10	28320675	.	G	A	3	2	5	0	0	5	0	0
10	28323048	.	T	G	4	12	16	0	1	17	0	0
10	28323054	.	A	G	5	13	18	0	0	18	0	0
10	28328174	.	T	C	5	5	10	0	0	10	0	0
10	28332868	.	T	C	2	4	6	0	0	6	0	0
10	28334806	.	G	A	2	1	3	0	0	3	0	0
10	28339621	.	C	T	1	2	3	0	1	4	0	0
10	28351484	.	C	T	0	2	2	0	4	6	0	0
10	28351520	.	G	T	7	6	13	0	0	13	0	0
10	28351616	.	C	T	2	3	5	0	0	5	0	0
10	28355728	.	A	G	5	1	6	0	0	6	0	0
10	28371045	.	A	G	5	4	9	0	0	9	0	0
10	28371198	.	G	A	15	5	20	0	3	23	0	0
10	28473577	.	C	G	0	2	2	0	2	4	0	0
10	28483440	.	G	T	3	3	6	0	0	6	0	0
10	28483542	.	A	G	2	5	7	0	0	7	0	0
10	28483561	.	G	A	2	5	7	0	0	7	0	0
10	28483781	.	G	T	2	2	4	0	0	4	0	0
10	28483815	.	A	T	1	2	3	0	0	3	0	0
10	28690862	.	T	G	0	0	0	0	2	2	0	0
10	28696336	.	C	A	2	1	3	0	0	3	0	0
10	28723769	.	A	T	2	4	6	0	1	7	0	0
10	28723805	.	G	A	0	3	3	0	7	10	0	0
10	28727265	.	C	T	1	4	5	0	0	5	0	0
10	28727461	.	C	T	3	3	6	0	0	6	0	0
10	28729808	.	G	C	2	2	4	0	0	4	0	0
10	28730216	.	C	T	3	2	5	0	0	5	0	0
10	28730325	.	T	G	4	9	13	0	1	14	0	0
10	28730337	.	T	G	3	12	15	0	1	16	0	0
10	28730437	.	G	T	6	7	13	0	0	13	0	0
10	28730503	.	G	A	5	3	8	0	2	10	0	0
10	28730620	.	G	T	2	3	5	0	0	5	0	0
10	28730621	.	T	A	2	2	4	0	1	5	0	0
10	28730800	.	A	T	4	0	4	0	0	8	4	0
10	28730869	.	C	T	4	12	16	0	1	17	0	0
10	28731333	.	C	T	2	5	7	0	1	8	0	0
10	28732104	.	T	C	11	14	25	0	0	25	0	0
10	28733132	.	T	A	13	14	27	0	0	27	0	0
10	28737345	.	C	T	5	7	12	0	1	13	0	0
10	28745583	.	G	A	9	8	17	0	0	17	0	0
10	28745833	.	G	A	1	2	3	0	1	4	0	0
10	28748741	.	C	T	0	2	2	0	4	6	0	0
10	28748996	.	G	A	0	1	1	0	0	1	0	0
10	28749053	.	A	G	1	1	2	0	1	3	0	0
10	28761022	.	C	T	6	3	9	0	0	9	0	0
10	28761049	.	C	T	4	5	9	0	0	9	0	0
10	28761094	.	G	A	2	5	7	0	1	8	0	0
10	28761100	.	G	A	6	3	9	0	1	10	0	0
10	28835566	.	C	A	2	2	4	0	0	4	0	0
10	29166502	.	A	G	7	4	11	0	0	11	0	0
10	29185800	.	C	G	17	1	18	0	15	33	0	0
10	29205679	.	G	T	0	6	6	0	4	10	0	0
10	29266279	.	C	A	1	0	1	0	0	1	0	0
10	29270291	.	T	C	7	4	11	0	0	11	0	0
10	29271980	.	A	C	3	0	3	0	0	3	0	0
10	29272693	.	C	T	6	5	11	0	0	11	0	0
10	29572857	.	C	T	7	5	12	0	0	12	0	0
10	29575542	.	C	T	1	1	2	0	0	2	0	0
10	29578738	.	C	T	5	6	11	0	0	11	0	0
10	29661410	.	C	T	0	2	2	0	0	2	0	0
10	29678256	.	A	G	13	0	13	0	9	22	0	0
10	29701347	.	C	T	7	6	13	1	1	15	0	0
10	29701405	.	G	A	0	4	4	0	4	8	0	0
10	29702103	.	G	A	1	2	3	0	0	3	0	0
10	29708101	.	C	T	17	15	32	0	0	32	0	0
10	29708154	.	A	G	13	0	13	0	18	31	0	0
10	29736255	.	G	C	2	4	6	0	0	6	0	0
10	29736746	.	C	T	0	5	5	0	3	8	0	0
10	29751221	.	T	C	2	0	2	0	4	6	0	0
10	29751328	.	G	A	10	8	18	0	0	18	0	0
10	29751638	.	G	T	5	4	9	0	2	11	0	0
10	29754464	.	G	T	4	5	9	0	0	9	0	0
10	29761761	.	A	T	2	5	7	0	0	7	0	0
10	29761767	.	G	A	2	5	7	0	0	7	0	0
10	29762926	.	G	A	2	1	3	0	0	3	0	0
10	29766072	.	C	G	1	1	2	0	0	2	0	0
10	29766841	.	C	T	2	2	4	0	0	4	0	0
10	29767470	.	G	A	3	4	7	0	0	7	0	0
10	29778375	.	A	G	2	0	2	0	1	3	0	0
10	29778396	.	C	T	4	4	8	0	0	8	0	0
10	29778433	.	T	C	2	3	5	0	0	5	0	0
10	29782137	.	G	A	1	2	3	0	0	3	0	0
10	29782273	.	A	G	2	0	2	0	4	6	0	0
10	29785682	.	C	A	4	5	9	0	1	10	0	0
10	29788229	.	G	T	3	0	3	0	0	3	0	0
10	29815697	.	A	C	3	1	4	0	5	9	0	0
10	29815802	.	A	G	23	21	44	0	0	44	0	0
10	29816113	.	T	C	20	31	51	0	2	53	0	0
10	29816290	.	T	A	19	28	47	0	0	47	0	0
10	29816439	.	A	T	19	16	35	0	1	36	0	0
10	29816904	.	C	T	30	28	58	0	2	60	0	0
10	29817111	.	C	T	37	36	73	0	1	74	0	0
10	29817207	.	C	T	31	33	64	0	2	66	0	0
10	29817416	.	A	T	30	17	47	0	3	50	0	0
10	29820414	.	G	C	3	3	6	0	0	6	0	0
10	29824248	.	C	T	1	2	3	0	2	5	0	0
10	29824262	.	C	T	2	4	6	0	2	8	0	0
10	29851722	.	C	T	28	30	58	0	2	60	0	0
10	29852317	.	G	A	1	4	5	0	0	5	0	0
10	29852476	.	A	G	16	1	17	0	19	36	0	0
10	29852485	.	A	G	14	2	16	0	15	31	0	0
10	29853684	.	A	G	20	8	28	0	12	40	0	0
10	30540800	.	C	T	5	4	9	0	0	9	0	0
10	30576061	.	G	A	5	2	7	0	1	8	0	0
10	30618121	.	C	T	3	3	6	0	0	6	0	0
10	30618313	.	T	A	5	10	15	0	0	15	0	0
10	30618429	.	A	T	1	5	6	0	0	6	0	0
10	30627092	.	A	T	4	7	11	0	1	12	0	0
10	30691384	.	C	T	0	2	2	0	0	2	0	0
10	30691387	.	T	A	0	2	2	0	0	2	0	0
10	30785055	.	T	G	4	4	8	0	0	8	0	0
10	30785463	.	G	A	5	4	9	0	0	9	0	0
10	31021505	.	T	C	4	10	14	0	3	17	0	0
10	31021550	.	G	A	8	6	14	0	0	14	0	0
10	31021811	.	C	T	0	4	4	0	12	16	0	0
10	31023520	.	A	G	6	11	17	0	3	20	0	0
10	31023824	.	C	T	1	2	3	0	0	3	0	0
10	31031543	.	C	T	0	1	1	0	3	4	0	0
10	31035030	.	G	A	3	3	6	0	0	6	0	0
10	31035147	.	C	T	2	5	7	0	0	7	0	0
10	31066888	.	C	T	0	5	5	0	5	10	0	0
10	31280293	.	G	A	2	2	4	0	0	4	0	0
10	31280410	.	C	T	1	2	3	0	0	3	0	0
10	31280980	.	A	T	1	2	3	0	1	4	0	0
10	31306727	.	C	T	1	8	9	0	18	27	0	0
10	31306956	.	C	G	0	6	6	0	7	13	0	0
10	31315631	.	C	T	0	7	7	0	12	19	0	0
10	31317976	.	T	C	14	15	29	0	0	29	0	0
10	31317978	.	A	G	14	15	29	0	0	29	0	0
10	31325248	.	C	A	7	11	18	0	1	19	0	0
10	31326235	.	T	C	3	0	3	0	1	4	0	0
10	31328373	.	A	T	2	3	5	0	3	8	0	0
10	31328531	.	C	T	2	2	4	0	0	4	0	0
10	31328612	.	A	C	1	0	1	0	0	1	0	0
10	31337822	.	G	A	3	5	8	0	0	8	0	0
10	31562967	.	G	T	1	2	3	0	0	3	0	0
10	31628325	.	A	C	4	3	7	0	0	7	0	0
10	31628481	.	T	C	1	1	2	0	0	2	0	0
10	31632643	.	C	T	6	4	10	0	0	10	0	0
10	31632838	.	C	T	4	4	8	0	1	9	0	0
10	31632916	.	T	C	1	7	8	0	0	8	0	0
10	31633077	.	A	C	3	4	7	0	0	7	0	0
10	31633751	.	T	A	0	2	2	0	0	2	0	0
10	31726330	.	C	T	2	2	4	0	1	5	0	0
10	31739181	.	G	T	16	30	46	0	7	53	0	0
10	31751941	.	C	T	3	3	6	0	0	6	0	0
10	31772041	.	G	A	22	21	43	0	3	46	0	0
10	31772112	.	A	G	4	8	12	0	0	12	0	0
10	31782605	.	C	T	3	5	8	0	1	9	0	0
10	31803651	.	G	A	6	5	11	0	0	11	0	0
10	31805648	.	C	T	7	3	10	0	0	10	0	0
10	31805736	.	G	A	3	5	8	0	0	8	0	0
10	31951383	.	G	A	1	3	4	0	0	4	0	0
10	31951431	.	G	A	3	2	5	0	0	5	0	0
10	31953565	.	A	G	2	2	4	0	0	4	0	0
10	31953627	.	T	C	4	2	6	0	0	6	0	0
10	32037794	.	T	A	1	3	4	0	0	4	0	0
10	32038054	.	A	T	3	2	5	0	0	5	0	0
10	32038071	.	A	T	4	2	6	0	0	6	0	0
10	32038184	.	T	C	2	2	4	0	0	4	0	0
10	32062434	.	G	A	1	4	5	0	0	5	0	0
10	32062738	.	C	T	1	4	5	0	1	6	0	0
10	32063266	.	T	A	1	3	4	0	0	4	0	0
10	32063275	.	A	G	1	0	1	0	3	4	0	0
10	32063401	.	C	T	5	2	7	0	0	7	0	0
10	32063605	.	C	T	4	2	6	0	0	6	0	0
10	32064222	.	A	T	3	5	8	0	0	8	0	0
10	32122840	.	T	A	1	2	3	0	0	3	0	0
10	32122926	.	G	A	0	3	3	0	1	4	0	0
10	32122952	.	T	A	2	3	5	0	0	5	0	0
10	32383514	.	G	A	0	1	1	0	0	1	0	0
10	32398296	.	T	A	0	1	1	0	0	1	0	0
10	32561338	.	G	A	6	3	9	0	0	9	0	0
10	32561427	.	A	C	7	5	12	0	0	12	0	0
10	32561437	.	T	A	7	6	13	0	1	14	0	0
10	32561564	.	A	C	5	7	12	0	1	13	0	0
10	32561575	.	C	T	5	4	9	0	0	9	0	0
10	32561817	.	G	A	1	8	9	0	9	18	0	0
10	32561820	.	G	T	10	7	17	0	1	18	0	0
10	32562267	.	C	T	6	5	11	0	0	11	0	0
10	32577486	.	G	A	8	2	10	0	0	10	0	0
10	32577489	.	A	G	8	3	11	0	0	11	0	0
10	32577522	.	C	T	10	9	19	0	1	20	0	0
10	32577549	.	T	C	9	11	20	0	0	20	0	0
10	32577621	.	G	A	3	7	10	0	1	11	0	0
10	32857386	.	C	T	7	29	36	1	0	37	0	0
10	32857419	.	T	C	22	1	23	0	15	38	0	0
10	32858132	.	T	C	14	0	14	0	10	24	0	0
10	33244534	.	T	C	1	3	4	0	0	4	0	0
10	33255113	.	G	A	5	5	10	0	1	11	0	0
10	33260799	.	T	C	2	2	4	0	1	5	0	0
10	33269688	.	G	T	1	3	4	0	1	5	0	0
10	33328553	.	T	C	0	0	0	0	1	1	0	0
10	33368649	.	G	A	1	4	5	0	0	5	0	0
10	33369860	.	T	A	5	5	10	0	0	10	0	0
10	33369973	.	C	A	11	12	23	0	2	25	0	0
10	33370260	.	G	T	1	4	5	0	0	5	0	0
10	33370284	.	A	G	3	4	7	0	1	8	0	0
10	33386316	.	G	A	3	8	11	0	0	11	0	0
10	33389469	.	A	G	11	0	11	0	8	19	0	0
10	33391844	.	G	A	27	23	50	0	1	51	0	0
10	33391930	.	G	A	25	11	36	0	6	42	0	0
10	33392065	.	C	T	7	19	26	0	1	27	0	0
10	33392103	.	G	A	16	15	31	0	0	31	0	0
10	33392111	.	T	C	15	9	24	0	3	27	0	0
10	33392264	.	C	T	6	21	27	0	0	27	0	0
10	33392370	.	T	C	14	11	25	0	0	25	0	0
10	33392396	.	T	G	10	10	20	0	1	21	0	0
10	33392781	.	G	C	1	2	3	0	0	3	0	0
10	33392788	.	G	A	1	2	3	0	0	3	0	0
10	33577656	.	A	G	2	1	3	0	0	3	0	0
10	33578816	.	T	A	6	4	10	0	0	10	0	0
10	33614968	.	G	A	3	1	4	0	0	4	0	0
10	33626390	.	G	T	0	1	1	0	0	1	0	0
10	33626400	.	C	T	1	1	2	0	0	2	0	0
10	33626437	.	A	C	0	2	2	0	1	3	0	0
10	33659230	.	C	T	0	1	1	0	0	1	0	0
10	33863568	.	G	A	3	3	6	0	2	8	0	0
10	33867365	.	C	T	7	9	16	0	0	16	0	0
10	33902326	.	C	A	1	2	3	0	0	3	0	0
10	33908264	.	A	G	1	3	4	0	0	4	0	0
10	33919504	.	G	A	0	1	1	0	2	3	0	0
10	33921928	.	A	G	0	2	2	0	0	2	0	0
10	33921934	.	T	C	0	2	2	0	0	2	0	0
10	33942126	.	C	T	2	0	2	0	0	2	0	0
10	33943456	.	T	C	1	1	2	0	0	2	0	0
10	33943820	.	C	T	5	4	9	0	0	9	0	0
10	33943856	.	A	T	5	3	8	0	1	9	0	0
10	33952766	.	C	T	10	5	15	0	0	15	0	0
10	33956714	.	T	C	2	6	8	0	0	8	0	0
10	33957780	.	C	T	5	7	12	0	0	12	0	0
10	33958993	.	C	T	1	0	1	0	0	1	0	0
10	33960793	.	C	T	5	10	15	0	1	16	0	0
10	33960814	.	A	G	2	0	2	0	13	15	0	0
10	33960829	.	C	A	4	9	13	0	1	14	0	0
10	33961093	.	A	T	5	6	11	0	1	12	0	0
10	33961132	.	T	A	2	5	7	0	0	7	0	0
10	33982141	.	G	C	13	15	28	0	2	30	0	0
10	33990957	.	C	T	4	2	6	0	0	6	0	0
10	33994424	.	A	G	10	4	14	0	0	14	0	0
10	33994445	.	A	G	15	10	25	0	0	25	0	0
10	33997759	.	A	T	19	32	51	0	4	55	0	0
10	33997970	.	T	C	11	10	21	0	2	23	0	0
10	33998010	.	C	T	14	9	23	0	0	23	0	0
10	33998106	.	G	C	2	4	6	0	0	6	0	0
10	34025077	.	T	C	6	5	11	0	0	11	0	0
10	34033394	.	C	T	1	2	3	0	0	3	0	0
10	34378005	.	G	A	3	5	8	0	0	8	0	0
10	34378053	.	G	A	2	2	4	0	0	4	0	0
10	34378302	.	A	C	8	5	13	0	0	13	0	0
10	34378584	.	G	A	1	2	3	0	1	4	0	0
10	34380603	.	C	A	0	1	1	0	1	2	0	0
10	34388888	.	G	A	5	7	12	0	0	12	0	0
10	34389617	.	C	T	2	10	12	0	0	12	0	0
10	34396026	.	G	A	4	4	8	0	0	8	0	0
10	34399775	.	G	T	0	3	3	0	5	8	0	0
10	34402546	.	C	T	8	5	13	0	0	13	0	0
10	34402897	.	A	G	13	3	16	0	0	16	0	0
10	34403157	.	G	A	6	2	8	0	2	10	0	0
10	34403349	.	C	G	10	10	20	0	0	20	0	0
10	34403495	.	C	T	7	8	15	0	0	15	0	0
10	34403980	.	A	G	8	0	8	0	5	13	0	0
10	34404149	.	G	A	0	3	3	0	1	4	0	0
10	34404158	.	T	A	2	5	7	0	0	7	0	0
10	34404552	.	T	G	9	13	22	0	0	22	0	0
10	34404593	.	T	C	8	3	11	0	0	11	0	0
10	34426656	.	C	T	2	3	5	0	0	5	0	0
10	34565381	.	G	A	0	3	3	0	4	7	0	0
10	34580529	.	C	T	1	0	1	0	0	1	0	0
10	34588881	.	C	T	5	8	13	0	1	14	0	0
10	34606450	.	G	A	0	1	1	0	1	2	0	0
10	34611453	.	A	G	0	0	0	0	1	1	0	0
10	34661821	.	T	C	5	4	9	0	0	9	0	0
10	34661857	.	A	G	2	3	5	0	2	7	0	0
10	34662013	.	T	C	5	3	8	0	0	8	0	0
10	34662024	.	T	G	4	5	9	0	0	9	0	0
10	34662052	.	T	C	3	7	10	0	0	10	0	0
10	34662334	.	T	C	5	9	14	0	1	15	0	0
10	34662724	.	C	A	8	6	14	0	0	14	0	0
10	34677521	.	G	T	3	6	9	0	1	10	0	0
10	34677539	.	T	C	1	7	8	0	0	8	0	0
10	34677585	.	T	G	3	0	3	0	5	8	0	0
10	34691122	.	C	T	5	1	6	0	0	6	0	0
10	34701365	.	T	C	3	7	10	0	0	10	0	0
10	34701434	.	A	C	6	2	8	0	0	9	1	0
10	34707043	.	C	T	1	3	4	0	0	4	0	0
10	34707549	.	G	T	1	3	4	0	0	4	0	0
10	34731660	.	C	T	12	31	43	0	0	43	0	0
10	34733578	.	A	G	17	0	17	0	31	48	0	0
10	34734568	.	G	T	0	18	18	0	20	38	0	0
10	34734590	.	A	G	19	20	39	0	3	42	0	0
10	34734784	.	G	T	1	12	13	0	15	28	0	0
10	34737599	.	G	A	25	21	46	0	4	50	0	0
10	34737686	.	A	G	19	19	38	0	2	40	0	0
10	34737959	.	G	A	21	16	37	0	4	41	0	0
10	34738125	.	T	C	21	30	51	0	0	51	0	0
10	34738378	.	T	G	17	12	29	0	0	29	0	0
10	34741649	.	T	A	5	7	12	0	0	12	0	0
10	34756936	.	A	C	4	2	6	0	0	6	0	0
10	34867259	.	T	C	6	0	6	0	4	10	0	0
10	34871672	.	G	T	6	9	15	0	0	15	0	0
10	34951354	.	T	C	3	2	5	0	0	5	0	0
10	34951611	.	G	A	0	2	2	0	0	2	0	0
10	34958760	.	A	T	18	11	29	0	1	30	0	0
10	34961149	.	C	A	10	16	26	0	1	27	0	0
10	34973943	.	A	G	2	2	4	0	0	4	0	0
10	34976841	.	A	T	1	2	3	0	1	4	0	0
10	34984675	.	T	A	1	2	3	0	0	3	0	0
10	34984836	.	A	G	19	11	30	0	1	31	0	0
10	34984923	.	T	C	5	12	17	0	0	17	0	0
10	34984931	.	C	A	0	10	10	0	4	14	0	0
10	34989149	.	T	C	7	0	7	0	14	21	0	0
10	34998281	.	G	C	6	3	9	0	0	9	0	0
10	35002400	.	C	A	1	2	3	0	0	3	0	0
10	35006358	.	T	C	1	1	2	0	0	2	0	0
10	35008963	.	C	T	3	1	4	0	0	4	0	0
10	35011325	.	C	T	3	6	9	0	0	9	0	0
10	35011337	.	A	G	4	4	8	0	1	9	0	0
10	35011482	.	G	A	1	2	3	0	5	8	0	0
10	35012184	.	C	T	1	5	6	0	9	15	0	0
10	35025832	.	G	C	1	1	2	0	0	2	0	0
10	35029172	.	G	A	5	3	8	0	2	10	0	0
10	35035754	.	G	A	1	2	3	0	0	3	0	0
10	35103155	.	A	G	2	3	5	0	0	5	0	0
10	35538349	.	A	C	0	10	10	0	2	12	0	0
10	35538350	.	C	A	0	10	10	0	2	12	0	0
10	36159292	.	A	G	2	0	2	0	2	4	0	0
10	36443018	.	T	C	5	10	15	0	1	16	0	0
10	36443541	.	T	C	11	4	15	0	1	16	0	0
10	36443676	.	G	A	0	9	9	0	5	14	0	0
10	36443714	.	G	A	3	8	11	0	1	12	0	0
10	36443818	.	T	G	1	1	2	0	4	6	0	0
10	36446799	.	A	T	3	3	6	0	0	6	0	0
10	36451615	.	T	C	2	2	4	0	0	4	0	0
10	36451661	.	G	A	6	13	19	0	0	19	0	0
10	36454567	.	C	A	9	10	19	0	1	20	0	0
10	36454649	.	A	G	12	0	12	0	12	24	0	0
10	36454650	.	C	A	12	12	24	0	0	24	0	0
10	36454902	.	G	T	11	13	24	0	0	24	0	0
10	36455146	.	C	T	11	6	17	0	0	17	0	0
10	36455215	.	T	C	9	7	16	0	0	16	0	0
10	36455229	.	C	G	9	9	18	0	0	18	0	0
10	36455344	.	A	G	14	9	23	0	0	23	0	0
10	36455847	.	G	A	0	2	2	0	1	3	0	0
10	36476481	.	C	T	0	12	12	0	14	26	0	0
10	36476529	.	C	T	7	13	20	0	0	20	0	0
10	36476639	.	C	T	0	13	13	0	12	25	0	0
10	36476717	.	A	G	14	17	31	0	3	34	0	0
10	36476834	.	G	A	12	14	26	0	3	29	0	0
10	36476852	.	A	G	15	17	32	0	0	32	0	0
10	36476922	.	C	T	1	2	3	0	1	4	0	0
10	36481915	.	A	C	8	10	18	0	1	19	0	0
10	36482588	.	G	A	17	11	28	0	0	28	0	0
10	36487530	.	G	A	6	7	13	0	0	13	0	0
10	36489882	.	A	G	4	2	6	0	0	6	0	0
10	36489893	.	A	G	5	3	8	0	0	8	0	0
10	36492091	.	C	T	1	3	4	0	0	4	0	0
10	36494336	.	G	A	2	2	4	0	1	5	0	0
10	36494590	.	C	G	1	2	3	0	0	3	0	0
10	36495580	.	T	G	1	0	1	0	0	1	0	0
10	36496544	.	A	G	4	2	6	0	0	6	0	0
10	36496595	.	G	A	1	1	2	0	1	3	0	0
10	36498379	.	C	T	0	1	1	0	1	2	0	0
10	36498397	.	G	A	1	1	2	0	0	2	0	0
10	36500581	.	C	T	3	2	5	0	1	6	0	0
10	36500674	.	G	A	2	1	3	0	0	3	0	0
10	36506103	.	G	A	4	3	7	0	0	7	0	0
10	36519788	.	T	C	2	2	4	0	1	5	0	0
10	36520003	.	C	T	0	1	1	0	1	2	0	0
10	36520024	.	C	A	1	2	3	0	0	3	0	0
10	36520711	.	G	A	1	2	3	0	0	3	0	0
10	36520945	.	A	G	5	3	8	0	2	10	0	0
10	36521605	.	C	T	2	3	5	0	0	5	0	0
10	36522713	.	A	C	1	0	1	0	2	4	1	0
10	36523826	.	G	A	2	3	5	0	0	5	0	0
10	36528549	.	A	G	1	1	2	0	0	2	0	0
10	36558839	.	A	G	8	6	14	0	0	14	0	0
10	36558895	.	G	A	8	11	19	0	3	22	0	0
10	36570469	.	A	G	8	7	15	0	1	16	0	0
10	36572622	.	G	A	4	2	6	0	0	6	0	0
10	36572640	.	C	A	0	4	4	0	4	8	0	0
10	36572814	.	A	T	1	2	3	0	0	3	0	0
10	36575992	.	C	T	0	2	2	0	0	2	0	0
10	36584462	.	T	C	2	4	6	0	0	6	0	0
10	36613095	.	T	C	8	12	20	0	1	21	0	0
10	36613145	.	G	T	7	8	15	0	1	17	1	0
10	36613164	.	C	T	0	8	8	0	8	16	0	0
10	36613276	.	C	T	3	9	12	0	0	12	0	0
10	36615367	.	G	A	0	0	0	0	1	1	0	0
10	36615907	.	C	A	5	6	11	0	3	14	0	0
10	36618787	.	C	T	2	1	3	0	0	3	0	0
10	36625258	.	C	A	0	4	4	0	12	16	0	0
10	36625534	.	G	A	2	2	4	0	0	4	0	0
10	36625602	.	C	G	7	8	15	0	1	16	0	0
10	36625761	.	T	A	2	4	6	0	3	9	0	0
10	36626201	.	C	T	4	2	6	0	0	6	0	0
10	36627009	.	G	C	3	4	7	0	0	7	0	0
10	36627314	.	C	T	6	3	9	0	0	9	0	0
10	36627326	.	C	T	6	3	9	0	1	10	0	0
10	36627390	.	A	G	3	6	9	0	0	9	0	0
10	36627414	.	C	A	6	4	10	0	0	10	0	0
10	36627820	.	C	T	2	5	7	0	1	8	0	0
10	36628569	.	C	T	0	6	6	0	1	7	0	0
10	36628626	.	G	A	0	3	3	0	1	4	0	0
10	36670106	.	T	C	1	2	3	0	0	3	0	0
10	36673237	.	G	T	1	5	6	0	1	7	0	0
10	36688455	.	C	T	4	1	5	0	0	5	0	0
10	36689850	.	G	T	2	0	2	0	0	2	0	0
10	36689893	.	A	G	2	0	2	0	0	2	0	0
10	36695781	.	G	C	7	11	18	0	2	20	0	0
10	36695785	.	C	T	6	12	18	0	1	19	0	0
10	36704842	.	A	G	10	5	15	0	0	15	0	0
10	36708401	.	A	G	4	0	4	0	15	19	0	0
10	36708453	.	C	T	11	4	15	0	1	16	0	0
10	36710559	.	A	C	11	9	20	0	2	22	0	0
10	36710599	.	C	T	13	13	26	0	2	28	0	0
10	36710871	.	G	A	0	12	12	0	20	32	0	0
10	36710893	.	G	T	0	21	21	0	14	35	0	0
10	36711260	.	T	A	6	6	12	0	0	12	0	0
10	36711329	.	T	A	15	10	25	0	2	27	0	0
10	36711613	.	C	T	4	8	12	0	2	15	1	0
10	36774339	.	A	C	2	4	6	0	0	6	0	0
10	36774379	.	T	A	1	2	3	0	0	3	0	0
10	36796083	.	A	G	1	4	5	0	0	5	0	0
10	36796131	.	T	A	2	7	9	0	1	10	0	0
10	36800465	.	G	A	7	9	16	0	0	16	0	0
10	36800518	.	C	T	7	5	12	0	0	12	0	0
10	36800600	.	G	A	7	4	11	0	1	12	0	0
10	36800642	.	A	G	6	7	13	0	0	13	0	0
10	36807986	.	G	A	3	8	11	0	0	11	0	0
10	36808032	.	G	A	3	10	13	0	0	13	0	0
10	36811815	.	A	G	7	7	14	0	0	14	0	0
10	36812214	.	A	C	3	4	7	0	0	7	0	0
10	36814912	.	G	A	4	3	7	0	0	7	0	0
10	36815330	.	T	C	2	0	2	0	5	7	0	0
10	36817197	.	A	C	0	2	2	0	0	2	0	0
10	36817355	.	C	T	1	6	7	0	2	9	0	0
10	36817442	.	A	G	0	6	6	0	2	8	0	0
10	36817464	.	A	G	1	6	7	0	0	7	0	0
10	36817530	.	C	T	6	5	11	0	1	12	0	0
10	36817979	.	T	G	1	3	4	0	0	4	0	0
10	36819664	.	G	T	3	6	9	0	0	9	0	0
10	36819671	.	C	T	6	3	9	0	0	9	0	0
10	36820601	.	C	T	0	6	6	0	5	11	0	0
10	36820611	.	A	G	3	7	10	0	0	10	0	0
10	36820664	.	C	T	1	4	5	0	0	5	0	0
10	36820688	.	C	G	0	5	5	0	2	7	0	0
10	36820736	.	G	A	2	4	6	0	0	6	0	0
10	36820892	.	G	A	3	2	5	0	0	5	0	0
10	36825650	.	C	T	0	2	2	0	1	3	0	0
10	36825818	.	T	C	3	2	5	0	0	5	0	0
10	36828227	.	T	C	9	4	13	0	1	14	0	0
10	36828265	.	G	A	7	4	11	0	1	12	0	0
10	36828469	.	T	C	3	0	3	0	5	8	0	0
10	36828475	.	C	T	6	3	9	0	0	9	0	0
10	36835641	.	A	T	2	1	3	0	0	3	0	0
10	36835740	.	G	A	3	3	6	0	0	6	0	0
10	36841230	.	G	T	3	6	9	0	0	9	0	0
10	36843114	.	C	G	0	1	1	0	0	1	0	0
10	36848872	.	G	A	2	1	3	0	0	3	0	0
10	36848938	.	A	G	1	3	4	0	0	4	0	0
10	36850674	.	C	T	1	2	3	0	0	3	0	0
10	36850752	.	A	G	5	4	9	0	0	9	0	0
10	36867407	.	T	C	0	1	1	0	0	1	0	0
10	36878362	.	C	A	1	2	3	0	1	4	0	0
10	36878638	.	T	C	3	0	3	0	8	11	0	0
10	36950935	.	A	T	4	2	6	0	1	8	1	0
10	36951044	.	A	T	9	6	15	0	0	15	0	0
10	36951076	.	G	C	6	5	11	0	0	11	0	0
10	36951223	.	A	C	12	10	22	0	0	22	0	0
10	36951378	.	A	G	1	4	5	0	0	5	0	0
10	36951582	.	C	G	7	9	16	0	0	16	0	0
10	36951660	.	T	A	4	9	13	0	1	14	0	0
10	36963456	.	G	A	4	7	11	0	2	13	0	0
10	36967206	.	T	C	4	6	10	0	0	10	0	0
10	36969510	.	T	C	0	1	1	0	0	1	0	0
10	36969519	.	A	G	0	1	1	0	0	1	0	0
10	36974901	.	G	A	7	4	11	0	0	11	0	0
10	36976271	.	C	T	0	1	1	0	0	1	0	0
10	36976318	.	G	A	3	2	5	0	0	5	0	0
10	36987831	.	T	G	2	1	3	0	2	5	0	0
10	37007508	.	G	C	2	2	4	0	1	5	0	0
10	37126295	.	C	T	1	5	6	0	0	6	0	0
10	37137549	.	G	A	0	4	4	0	3	7	0	0
10	37145178	.	G	A	14	5	19	0	1	20	0	0
10	37152081	.	G	A	2	2	4	0	0	4	0	0
10	37152105	.	A	G	9	0	9	0	9	18	0	0
10	37163252	.	C	A	0	1	1	0	0	1	0	0
10	37167151	.	G	C	11	11	22	0	1	23	0	0
10	37167342	.	A	T	1	3	4	0	1	5	0	0
10	37227524	.	C	T	8	5	13	0	3	16	0	0
10	37234093	.	A	G	5	1	6	0	3	9	0	0
10	37239229	.	G	A	2	2	4	0	0	4	0	0
10	37252054	.	G	A	0	1	1	0	1	2	0	0
10	37253986	.	A	G	4	3	7	0	2	9	0	0
10	37373873	.	G	A	0	3	3	0	1	4	0	0
10	37385317	.	T	C	0	3	3	0	0	3	0	0
10	37394478	.	G	A	1	3	4	0	0	4	0	0
10	37394486	.	G	A	1	2	3	0	2	5	0	0
10	37394535	.	C	T	6	5	11	0	1	12	0	0
10	37764473	.	C	T	9	13	22	0	1	23	0	0
10	37779765	.	A	C	1	1	2	0	0	2	0	0
10	37779778	.	T	A	1	1	2	0	0	2	0	0
10	37783114	.	A	G	11	9	20	0	1	21	0	0
10	37783179	.	A	G	11	0	11	0	15	26	0	0
10	37783323	.	A	G	7	10	17	0	0	17	0	0
10	37783575	.	C	A	2	2	4	0	0	4	0	0
10	37783669	.	C	A	6	7	13	0	0	13	0	0
10	37992679	.	G	A	0	3	3	0	2	5	0	0
10	37992839	.	A	T	3	2	5	0	0	5	0	0
10	37997567	.	C	G	3	4	7	0	0	7	0	0
10	38000082	.	C	G	1	4	5	0	0	5	0	0
10	38000084	.	G	T	0	1	1	0	4	5	0	0
10	38003011	.	A	G	9	5	14	0	0	14	0	0
10	38005466	.	A	C	4	4	8	0	0	9	1	0
10	38149713	.	C	A	0	1	1	0	1	2	0	0
10	38149715	.	A	G	1	1	2	0	0	2	0	0
10	38170574	.	A	G	2	8	10	0	0	10	0	0
10	38170737	.	G	A	9	5	14	0	1	15	0	0
10	38171149	.	G	C	3	0	3	0	8	11	0	0
10	38171207	.	C	A	3	9	12	0	1	13	0	0
10	38171356	.	A	T	6	9	15	0	1	16	0	0
10	38171490	.	T	A	7	12	19	0	0	19	0	0
10	38173383	.	C	A	0	3	3	0	7	10	0	0
10	38177999	.	C	T	0	7	7	0	9	16	0	0
10	38178357	.	G	A	1	0	1	0	1	2	0	0
10	38180732	.	A	T	0	1	1	0	0	1	0	0
10	38199097	.	G	A	3	4	7	0	0	7	0	0
10	38199169	.	T	C	1	1	2	0	0	2	0	0
10	38201513	.	G	A	1	0	1	0	0	1	0	0
10	38205149	.	T	C	2	0	2	0	2	4	0	0
10	38211810	.	C	G	1	2	3	0	0	3	0	0
10	38218990	.	C	T	0	0	0	0	1	1	0	0
10	38231165	.	C	T	0	2	2	0	0	2	0	0
10	38235957	.	G	C	4	2	6	0	0	6	0	0
10	38257247	.	A	G	5	2	7	0	0	7	0	0
10	38257295	.	G	A	4	5	9	0	1	10	0	0
10	38257509	.	C	G	0	2	2	0	8	10	0	0
10	38257558	.	C	T	3	4	7	0	0	7	0	0
10	38257870	.	T	C	9	19	28	0	1	29	0	0
10	38258729	.	C	G	9	9	18	0	0	18	0	0
10	38259033	.	C	T	0	5	5	0	0	5	0	0
10	38259034	.	A	G	0	5	5	0	0	5	0	0
10	38259204	.	G	A	10	3	13	0	0	13	0	0
10	38259217	.	A	G	9	4	13	0	0	13	0	0
10	38259268	.	G	C	3	2	5	0	1	6	0	0
10	38259276	.	A	G	3	3	6	0	0	6	0	0
10	38259339	.	A	T	3	2	5	0	1	6	0	0
10	38259449	.	A	C	6	0	6	0	7	13	0	0
10	38259451	.	A	G	6	7	13	0	0	13	0	0
10	38260002	.	G	A	4	2	6	0	0	6	0	0
10	38260210	.	T	A	14	8	22	0	2	24	0	0
10	38260626	.	A	T	3	10	13	0	1	14	0	0
10	38261453	.	G	A	1	4	5	0	1	6	0	0
10	38261485	.	C	T	3	5	8	0	0	8	0	0
10	38261495	.	T	G	2	2	4	0	1	5	0	0
10	38261638	.	G	A	2	2	4	0	0	4	0	0
10	38261696	.	C	T	2	2	4	0	0	4	0	0
10	38665994	.	C	T	0	2	2	0	0	2	0	0
10	38666063	.	T	C	5	6	11	0	1	12	0	0
10	38686126	.	T	C	6	2	8	0	0	8	0	0
10	38695152	.	A	C	14	10	24	0	0	24	0	0
10	38695510	.	A	G	13	9	22	0	2	24	0	0
10	38695656	.	A	G	11	10	21	0	1	22	0	0
10	38695877	.	C	T	10	5	15	0	2	17	0	0
10	38695888	.	C	T	10	5	15	0	2	17	0	0
10	38712431	.	C	T	1	4	5	0	0	5	0	0
10	38775780	.	C	G	1	3	4	0	0	4	0	0
10	38885821	.	T	C	2	3	5	0	0	5	0	0
10	38891454	.	C	A	4	4	8	0	0	8	0	0
10	38924557	.	C	T	3	2	5	0	0	5	0	0
10	38924560	.	T	C	2	2	4	0	1	5	0	0
10	38934391	.	A	G	6	1	7	0	0	7	0	0
10	38940232	.	A	G	3	4	7	0	2	9	0	0
10	38943265	.	C	G	7	7	14	0	0	15	1	0
10	38950115	.	T	C	1	2	3	0	0	3	0	0
10	38950430	.	G	A	0	13	13	0	10	23	0	0
10	38950484	.	A	G	11	16	27	0	0	27	0	0
10	38950538	.	T	C	7	4	11	0	0	11	0	0
10	38954126	.	C	T	11	7	18	0	1	19	0	0
10	38954141	.	T	C	11	7	18	0	1	19	0	0
10	38954798	.	T	C	4	11	15	0	0	15	0	0
10	38954801	.	C	T	5	12	17	0	0	17	0	0
10	38957061	.	T	C	13	11	24	0	2	26	0	0
10	38957127	.	G	A	0	10	10	0	12	22	0	0
10	38957193	.	C	T	1	2	3	0	0	3	0	0
10	38957748	.	A	C	3	14	17	0	0	17	0	0
10	38957754	.	A	C	4	14	18	0	0	18	0	0
10	38969552	.	A	C	36	10	46	0	3	49	0	0
10	38969598	.	A	C	26	21	47	0	2	49	0	0
10	38969629	.	C	T	22	23	45	0	0	45	0	0
10	38969685	.	A	G	26	16	42	0	5	47	0	0
10	38969778	.	C	T	27	20	47	0	0	47	0	0
10	39011484	.	C	T	9	14	23	0	4	27	0	0
10	39086981	.	G	A	22	23	45	0	0	45	0	0
10	39087391	.	A	G	35	1	36	0	26	62	0	0
10	39087625	.	T	A	24	29	53	0	1	54	0	0
10	39087659	.	T	A	22	24	46	0	3	49	0	0
10	39091684	.	C	A	1	3	4	0	0	4	0	0
10	39091792	.	A	G	2	0	2	0	2	4	0	0
10	39102672	.	G	C	0	1	1	0	0	1	0	0
10	39110452	.	G	C	2	3	5	0	0	5	0	0
10	39115595	.	G	T	3	2	5	0	0	5	0	0
10	39115596	.	T	C	3	2	5	0	0	5	0	0
10	39120132	.	T	C	7	4	11	0	0	11	0	0
10	39130460	.	C	T	11	12	23	0	4	27	0	0
10	39140465	.	A	G	1	0	1	0	0	1	0	0
10	39140741	.	T	C	1	2	3	0	0	3	0	0
10	39152038	.	A	G	0	2	2	0	0	2	0	0
10	39153470	.	G	A	1	2	3	0	0	3	0	0
10	39153494	.	A	G	1	2	3	0	0	3	0	0
10	39153805	.	T	C	0	3	3	0	0	3	0	0
10	39170798	.	A	C	1	1	2	0	0	2	0	0
10	39175139	.	T	C	6	6	12	0	1	13	0	0
10	39175418	.	T	C	4	2	6	0	1	7	0	0
10	39177751	.	C	A	2	2	4	0	0	4	0	0
10	39179525	.	G	A	1	2	3	0	0	3	0	0
10	39179565	.	C	T	4	3	7	0	0	7	0	0
10	39179992	.	G	C	5	6	11	0	1	12	0	0
10	39180884	.	A	G	1	1	2	0	3	5	0	0
10	39180912	.	T	C	4	3	7	0	1	8	0	0
10	39180965	.	T	C	7	1	8	0	0	8	0	0
10	39181040	.	G	T	5	3	8	0	0	8	0	0
10	39181141	.	T	A	7	4	11	0	0	11	0	0
10	39182173	.	A	G	9	6	15	0	0	15	0	0
10	39182310	.	C	A	5	10	15	0	2	17	0	0
10	39182342	.	A	T	4	11	15	0	0	15	0	0
10	39182401	.	C	A	7	6	13	0	1	14	0	0
10	39182497	.	C	T	7	5	12	0	0	12	0	0
10	39182602	.	G	A	0	5	5	0	4	9	0	0
10	39182640	.	T	A	5	2	7	0	0	7	0	0
10	39182659	.	G	T	4	2	6	0	0	6	0	0
10	39205021	.	C	T	2	1	3	0	1	4	0	0
10	39205256	.	C	G	1	1	2	0	0	2	0	0
10	39206945	.	A	G	4	5	9	0	2	11	0	0
10	39207104	.	C	A	4	2	6	0	0	6	0	0
10	39207114	.	C	A	2	2	4	0	0	4	0	0
10	39207629	.	A	G	4	4	8	0	0	8	0	0
10	39207637	.	A	T	4	3	7	0	0	7	0	0
10	39207749	.	C	T	2	3	5	0	0	5	0	0
10	39216625	.	C	T	8	4	12	0	0	12	0	0
10	39219390	.	T	C	1	1	2	0	0	2	0	0
10	39219540	.	T	A	5	5	10	0	0	10	0	0
10	39222134	.	A	C	1	3	4	0	0	4	0	0
10	39222182	.	A	G	6	15	21	0	0	21	0	0
10	39225504	.	A	C	9	9	18	0	0	18	0	0
10	39225555	.	T	C	7	9	16	0	3	19	0	0
10	39231387	.	G	A	2	7	9	0	1	10	0	0
10	39249061	.	G	T	2	2	4	0	0	4	0	0
10	39265717	.	C	T	1	0	1	0	0	1	0	0
10	39265733	.	C	T	1	0	1	0	0	1	0	0
10	39266350	.	G	T	0	3	3	0	4	7	0	0
10	39266422	.	C	T	2	2	4	0	0	4	0	0
10	39266669	.	A	C	4	3	7	0	0	7	0	0
10	39266702	.	A	G	4	0	4	0	6	10	0	0
10	39266756	.	A	G	1	1	2	0	1	3	0	0
10	39266758	.	G	A	1	2	3	0	0	3	0	0
10	39269012	.	G	T	2	3	5	0	0	5	0	0
10	39278032	.	A	T	2	2	4	0	0	4	0	0
10	39284032	.	A	G	2	3	5	0	0	5	0	0
10	39285246	.	A	G	3	3	6	0	0	6	0	0
10	39292583	.	A	C	0	1	1	0	0	1	0	0
10	39293705	.	A	G	4	2	6	0	1	7	0	0
10	39293707	.	A	T	5	2	7	0	0	7	0	0
10	39306709	.	G	A	1	2	3	0	0	3	0	0
10	39904851	.	A	T	3	8	11	0	0	11	0	0
10	39904915	.	A	G	7	12	19	0	1	20	0	0
10	39904966	.	T	C	2	3	5	0	0	5	0	0
10	39905085	.	A	T	3	4	7	0	0	7	0	0
10	39905089	.	T	G	3	4	7	0	0	7	0	0
10	40086018	.	A	G	3	3	6	0	0	6	0	0
10	40086024	.	T	C	3	3	6	0	0	6	0	0
10	40089829	.	C	A	1	2	3	0	0	3	0	0
10	40089838	.	C	T	2	2	4	0	0	4	0	0
10	40097252	.	C	A	1	0	1	0	0	1	0	0
10	40109378	.	C	T	6	3	9	0	2	11	0	0
10	40109439	.	G	A	1	3	4	0	5	9	0	0
10	40109681	.	A	G	2	3	5	0	0	5	0	0
10	40110226	.	T	C	2	2	4	0	0	4	0	0
10	40110243	.	A	T	1	2	3	0	0	3	0	0
10	40110768	.	A	G	2	2	4	0	0	4	0	0
10	40110782	.	A	T	2	2	4	0	0	4	0	0
10	40110809	.	G	A	0	2	2	0	7	9	0	0
10	40111549	.	T	C	6	2	8	0	0	8	0	0
10	40111666	.	G	C	2	2	4	0	0	4	0	0
10	40111706	.	A	G	3	5	8	0	0	8	0	0
10	40111732	.	C	T	2	8	10	0	1	11	0	0
10	40111952	.	C	T	2	2	4	0	0	4	0	0
10	40111964	.	C	A	3	2	5	0	1	6	0	0
10	40112096	.	C	A	2	2	4	0	1	5	0	0
10	40112121	.	A	G	2	3	5	0	0	5	0	0
10	40112157	.	G	A	3	3	6	0	0	6	0	0
10	40112159	.	T	A	3	3	6	0	0	6	0	0
10	40112347	.	A	T	5	5	10	0	0	10	0	0
10	40112638	.	C	T	3	2	5	0	0	5	0	0
10	40112769	.	T	G	4	2	6	0	0	6	0	0
10	40112793	.	G	A	6	2	8	0	0	8	0	0
10	40112834	.	G	A	5	3	8	0	0	8	0	0
10	40113082	.	T	C	3	2	5	0	1	6	0	0
10	40113113	.	C	G	5	4	9	0	0	9	0	0
10	40113161	.	C	A	4	5	9	0	0	9	0	0
10	40113197	.	G	A	0	8	8	0	6	14	0	0
10	40113408	.	A	G	4	4	8	0	0	8	0	0
10	40113446	.	T	C	4	4	8	0	0	8	0	0
10	40113508	.	A	T	2	3	5	0	0	5	0	0
10	40113592	.	G	A	3	3	6	0	0	6	0	0
10	40113676	.	C	T	2	2	4	0	0	4	0	0
10	40167908	.	C	T	1	3	4	0	0	4	0	0
10	40262338	.	T	C	1	2	3	0	0	3	0	0
10	40262347	.	A	G	1	0	1	0	2	3	0	0
10	40266160	.	A	G	0	1	1	0	0	1	0	0
10	40266259	.	A	C	2	2	4	0	0	4	0	0
10	40274541	.	G	A	0	7	7	0	7	14	0	0
10	40274626	.	C	T	2	1	3	0	1	4	0	0
10	40275158	.	G	A	0	4	4	0	3	7	0	0
10	40296645	.	T	C	0	2	2	0	0	2	0	0
10	40296841	.	G	A	0	3	3	0	0	3	0	0
10	40307553	.	T	C	1	0	1	0	0	1	0	0
10	40307622	.	C	T	3	2	5	0	0	5	0	0
10	40311286	.	G	T	0	0	0	0	1	1	0	0
10	40314175	.	A	C	5	6	11	0	2	13	0	0
10	40314177	.	A	C	6	5	11	0	2	13	0	0
10	40317095	.	G	T	7	5	12	0	0	12	0	0
10	40317285	.	A	T	5	5	10	0	0	10	0	0
10	40317323	.	A	G	5	0	5	0	3	8	0	0
10	40317341	.	A	G	4	1	5	0	1	6	0	0
10	40822252	.	C	T	0	6	6	0	8	14	0	0
10	40825192	.	T	C	1	0	1	0	0	1	0	0
10	40826436	.	A	G	5	7	12	0	1	13	0	0
10	40826516	.	A	G	3	5	8	0	1	9	0	0
10	40826589	.	C	T	10	7	17	0	0	17	0	0
10	40826590	.	A	G	9	7	16	0	1	17	0	0
10	40859601	.	T	C	3	0	3	0	4	7	0	0
10	40859633	.	C	T	1	2	3	0	0	3	0	0
10	40859647	.	A	C	1	3	4	0	1	5	0	0
10	40859885	.	A	G	2	3	5	0	0	5	0	0
10	40859968	.	T	C	7	11	18	0	0	18	0	0
10	40861650	.	G	A	3	2	5	0	0	5	0	0
10	40861701	.	G	T	2	2	4	0	0	4	0	0
10	40872816	.	A	G	1	3	4	0	0	4	0	0
10	41397437	.	A	G	1	7	8	0	0	8	0	0
10	41837039	.	T	C	4	2	6	0	1	7	0	0
10	41837425	.	G	C	3	5	8	0	0	8	0	0
10	41837486	.	T	C	3	7	10	0	0	10	0	0
10	41837528	.	A	G	6	5	11	0	0	11	0	0
10	41841119	.	G	A	8	7	15	0	0	15	0	0
10	41841209	.	C	G	8	11	19	0	0	19	0	0
10	41843743	.	C	A	0	0	0	0	1	1	0	0
10	41846770	.	A	G	2	5	7	0	0	7	0	0
10	41865722	.	G	A	1	6	7	0	0	7	0	0
10	41914189	.	C	G	0	3	3	0	0	3	0	0
10	41970027	.	T	C	1	0	1	0	1	2	0	0
10	41970031	.	T	C	0	2	2	0	1	3	0	0
10	41983494	.	T	C	3	0	3	0	3	6	0	0
10	41984251	.	G	A	3	3	6	0	0	6	0	0
10	41985911	.	G	A	2	2	4	0	0	4	0	0
10	41995555	.	C	T	2	2	4	0	0	4	0	0
10	41995573	.	C	T	3	4	7	0	0	7	0	0
10	41995624	.	A	G	5	3	8	0	1	9	0	0
10	41995644	.	A	T	4	3	7	0	1	8	0	0
10	41995678	.	A	G	4	2	6	0	0	6	0	0
10	42002429	.	G	A	0	6	6	0	3	9	0	0
10	42010915	.	C	G	6	3	9	0	0	9	0	0
10	42011128	.	T	C	3	3	6	0	0	6	0	0
10	42011197	.	G	A	0	5	5	0	3	8	0	0
10	42011245	.	C	T	1	5	6	0	1	7	0	0
10	42011293	.	G	A	3	5	8	0	1	9	0	0
10	42020285	.	G	A	7	4	11	0	0	11	0	0
10	42020422	.	C	T	5	3	8	0	0	8	0	0
10	42020565	.	C	T	8	7	15	0	1	16	0	0
10	42020684	.	A	G	3	0	3	0	5	8	0	0
10	42021194	.	A	G	3	2	5	0	0	5	0	0
10	42021279	.	A	G	3	2	5	0	0	5	0	0
10	42021611	.	C	A	3	7	10	0	0	10	0	0
10	42022014	.	C	G	10	6	16	0	1	17	0	0
10	42030956	.	C	T	1	6	7	0	0	7	0	0
10	42044337	.	C	T	7	11	18	0	1	19	0	0
10	42044409	.	A	G	16	17	33	0	1	34	0	0
10	42044497	.	A	G	14	9	23	0	1	24	0	0
10	42044745	.	T	G	13	11	24	0	3	27	0	0
10	42044746	.	C	T	14	11	25	0	2	27	0	0
10	42044809	.	T	A	18	17	35	0	0	35	0	0
10	42044859	.	G	A	15	10	25	0	1	26	0	0
10	42045041	.	G	C	13	18	31	0	0	31	0	0
10	42045370	.	G	A	9	7	16	0	0	16	0	0
10	42045534	.	A	T	3	4	7	0	1	8	0	0
10	42047636	.	G	T	2	2	4	0	0	4	0	0
10	42048267	.	T	C	1	2	3	0	1	4	0	0
10	42089403	.	C	T	0	3	3	0	4	7	0	0
10	42089421	.	A	T	3	2	5	0	0	5	0	0
10	42104361	.	T	G	2	4	6	0	2	8	0	0
10	42104371	.	C	T	0	4	4	0	3	7	0	0
10	42105921	.	C	T	4	4	8	0	1	9	0	0
10	42111610	.	A	T	5	5	10	0	0	10	0	0
10	42111669	.	C	A	5	8	13	0	0	13	0	0
10	42111673	.	G	A	5	7	12	0	0	12	0	0
10	42111895	.	G	A	6	3	9	0	1	10	0	0
10	42112062	.	T	A	3	7	10	0	0	10	0	0
10	42112075	.	T	C	4	0	4	0	8	12	0	0
10	42112227	.	G	T	9	8	17	0	1	18	0	0
10	42114366	.	G	A	2	4	6	0	0	6	0	0
10	42119810	.	C	T	1	3	4	0	0	4	0	0
10	42128886	.	A	G	8	8	16	0	0	16	0	0
10	42128898	.	C	T	7	6	13	0	0	13	0	0
10	42135272	.	A	C	2	0	2	0	5	7	0	0
10	42135472	.	A	G	2	2	4	0	0	4	0	0
10	42136570	.	A	G	2	6	8	0	0	9	1	0
10	42136576	.	G	A	3	5	8	0	0	8	0	0
10	42136847	.	T	C	1	3	4	0	0	4	0	0
10	42136856	.	T	C	2	2	4	0	0	4	0	0
10	42138380	.	T	C	1	0	1	0	3	4	0	0
10	42196374	.	C	T	0	2	2	0	5	7	0	0
10	42196404	.	T	C	2	0	2	0	6	8	0	0
10	42196524	.	A	G	8	3	11	0	0	11	0	0
10	42378334	.	A	T	34	31	65	0	0	65	0	0
10	42501067	.	A	G	5	9	14	0	1	15	0	0
10	42501175	.	T	A	4	6	10	0	0	10	0	0
10	42501365	.	A	G	12	14	26	0	2	28	0	0
10	42505845	.	T	C	8	2	10	0	0	10	0	0
10	42507081	.	T	C	5	8	13	0	0	13	0	0
10	42507120	.	T	C	6	7	13	0	0	13	0	0
10	42507141	.	A	G	4	8	12	0	0	12	0	0
10	42519641	.	C	T	3	2	5	0	0	5	0	0
10	42526213	.	C	T	7	4	11	0	0	11	0	0
10	42531713	.	C	T	10	13	23	0	2	25	0	0
10	42539630	.	C	T	28	24	52	0	2	54	0	0
10	42539849	.	C	T	18	24	42	0	0	42	0	0
10	42539955	.	T	C	14	13	27	0	3	30	0	0
10	42540132	.	A	T	18	14	32	0	1	33	0	0
10	42540172	.	A	C	17	9	26	0	0	26	0	0
10	42540726	.	A	G	7	3	10	0	0	10	0	0
10	42542568	.	A	C	6	2	8	0	0	8	0	0
10	42542883	.	C	T	1	0	1	0	0	1	0	0
10	42550828	.	C	T	4	2	6	0	0	6	0	0
10	42555504	.	A	G	3	1	4	0	5	9	0	0
10	42555543	.	G	A	0	7	7	0	5	12	0	0
10	42555577	.	C	A	3	4	7	0	1	8	0	0
10	42555578	.	G	A	0	4	4	0	4	8	0	0
10	42555728	.	G	A	0	2	2	0	5	7	0	0
10	42555732	.	G	T	5	3	8	0	0	8	0	0
10	42555764	.	C	A	2	3	5	0	0	5	0	0
10	42656885	.	A	G	0	1	1	0	0	1	0	0
10	42691349	.	T	C	5	5	10	0	0	10	0	0
10	42694471	.	A	G	4	0	4	0	7	11	0	0
10	42694477	.	T	C	4	8	12	0	0	12	0	0
10	42694552	.	C	A	3	0	3	0	0	3	0	0
10	42694573	.	A	G	1	0	1	0	0	1	0	0
10	42700932	.	C	T	6	2	8	0	0	8	0	0
10	42701006	.	C	T	8	5	13	0	1	14	0	0
10	42701027	.	C	G	9	9	18	0	0	18	0	0
10	42701051	.	T	C	8	8	16	0	0	16	0	0
10	42701129	.	A	G	3	1	4	0	2	6	0	0
10	42701216	.	C	T	5	8	13	0	0	13	0	0
10	42701317	.	A	G	1	1	2	0	2	4	0	0
10	42704661	.	G	T	2	4	6	0	1	7	0	0
10	42704671	.	G	A	2	4	6	0	1	7	0	0
10	42704848	.	T	C	7	7	14	0	0	14	0	0
10	42708084	.	A	G	1	1	2	0	0	2	0	0
10	42715853	.	C	T	20	18	38	0	6	44	0	0
10	42716398	.	G	C	0	5	5	0	2	7	0	0
10	42738094	.	A	G	5	3	8	0	0	8	0	0
10	42738095	.	C	T	5	3	8	0	0	8	0	0
10	42738176	.	T	C	7	6	13	0	1	14	0	0
10	42738400	.	A	G	3	4	7	0	1	8	0	0
10	42738452	.	A	T	2	1	3	0	1	4	0	0
10	42738671	.	C	T	4	3	7	0	1	8	0	0
10	42739527	.	A	G	10	8	18	0	1	19	0	0
10	42739938	.	C	T	4	6	10	0	0	10	0	0
10	42740111	.	G	A	1	10	11	0	14	25	0	0
10	42740386	.	A	C	8	6	14	0	2	16	0	0
10	42741417	.	T	A	18	19	37	0	4	41	0	0
10	42741469	.	T	A	25	18	43	0	0	43	0	0
10	42741519	.	G	T	34	11	45	0	1	46	0	0
10	42741661	.	C	A	2	9	11	0	26	37	0	0
10	42741840	.	T	A	23	23	46	0	5	51	0	0
10	42741872	.	A	G	17	27	44	0	3	47	0	0
10	42741938	.	A	C	21	0	21	0	20	41	0	0
10	42742058	.	T	C	10	0	10	0	7	17	0	0
10	42742104	.	T	A	9	6	15	0	0	15	0	0
10	42742135	.	C	T	0	5	5	0	8	13	0	0
10	42742140	.	T	A	7	4	11	0	0	11	0	0
10	42742600	.	C	T	9	7	16	0	0	16	0	0
10	42742671	.	A	C	16	2	18	0	3	21	0	0
10	42742692	.	A	T	18	6	24	0	1	25	0	0
10	42742744	.	C	A	5	8	13	0	0	13	0	0
10	42743711	.	T	C	12	0	12	0	4	16	0	0
10	42744585	.	C	T	7	6	13	0	0	13	0	0
10	42744598	.	C	A	8	5	13	0	1	14	0	0
10	42744705	.	A	T	8	10	18	0	0	18	0	0
10	42744720	.	G	C	9	7	16	0	0	16	0	0
10	42744831	.	T	G	7	2	9	0	0	9	0	0
10	42744912	.	C	A	8	10	18	0	0	18	0	0
10	42744951	.	G	C	9	8	17	0	0	17	0	0
10	42744970	.	T	A	9	4	13	0	0	13	0	0
10	42745147	.	A	G	3	5	8	0	2	10	0	0
10	42745151	.	C	T	3	4	7	0	2	9	0	0
10	42767123	.	G	A	11	9	20	0	4	24	0	0
10	42767252	.	C	T	0	8	8	0	9	17	0	0
10	42771558	.	A	T	5	1	6	0	1	7	0	0
10	42876255	.	A	T	2	2	4	0	0	4	0	0
10	42876420	.	A	G	2	2	4	0	0	4	0	0
10	42882121	.	G	A	2	2	4	0	0	4	0	0
10	42882124	.	A	C	2	2	4	0	0	4	0	0
10	42900713	.	G	C	4	4	8	0	0	8	0	0
10	42903629	.	G	A	0	2	2	0	0	2	0	0
10	42930776	.	T	C	10	0	10	0	5	15	0	0
10	42930781	.	T	C	8	0	8	0	5	13	0	0
10	42930814	.	T	C	9	5	14	0	0	14	0	0
10	42930828	.	T	C	4	5	9	0	1	10	0	0
10	42930933	.	T	C	3	3	6	0	0	6	0	0
10	42931315	.	T	A	3	4	7	0	0	7	0	0
10	42935346	.	C	T	0	1	1	0	0	1	0	0
10	43126994	.	T	C	1	3	4	0	0	4	0	0
10	43149237	.	A	G	2	0	2	0	3	5	0	0
10	43151516	.	G	A	1	3	4	0	1	5	0	0
10	43157401	.	C	G	3	4	7	0	0	7	0	0
10	43225154	.	G	C	1	2	3	0	0	3	0	0
10	43232158	.	G	A	0	2	2	0	5	7	0	0
10	43294835	.	G	T	2	2	4	0	0	4	0	0
10	43365046	.	A	G	6	7	13	0	1	14	0	0
10	43372035	.	A	G	4	2	6	0	0	6	0	0
10	43372466	.	C	T	3	1	4	0	0	4	0	0
10	43372493	.	G	A	4	4	8	0	0	8	0	0
10	43375468	.	G	A	8	3	11	0	0	11	0	0
10	43499974	.	T	C	0	1	1	0	0	1	0	0
10	43545284	.	A	C	7	8	15	0	0	15	0	0
10	43545288	.	C	T	8	8	16	0	0	16	0	0
10	43545434	.	G	C	7	9	16	0	2	18	0	0
10	43545475	.	A	C	12	7	19	0	1	20	0	0
10	43545577	.	C	A	0	6	6	0	9	15	0	0
10	43545681	.	C	T	4	7	11	0	0	11	0	0
10	43545747	.	A	G	4	8	12	0	0	12	0	0
10	43545757	.	C	T	0	4	4	0	8	12	0	0
10	43546802	.	G	T	1	2	3	0	0	3	0	0
10	43546890	.	T	C	4	4	8	0	0	8	0	0
10	43547036	.	T	C	3	4	7	0	0	7	0	0
10	43547046	.	T	C	3	3	6	0	0	6	0	0
10	43547820	.	A	T	1	3	4	0	0	4	0	0
10	43547905	.	G	A	2	2	4	0	1	5	0	0
10	43547937	.	A	G	0	4	4	0	0	4	0	0
10	43547972	.	T	C	2	0	2	0	3	5	0	0
10	43548194	.	C	A	4	2	6	0	0	6	0	0
10	43548195	.	C	A	4	2	6	0	0	6	0	0
10	43548301	.	A	G	4	3	7	0	0	7	0	0
10	43548344	.	T	C	1	2	3	0	0	3	0	0
10	43548352	.	C	T	1	2	3	0	0	3	0	0
10	43548944	.	A	T	5	3	8	0	1	9	0	0
10	43549062	.	G	T	7	4	11	0	0	11	0	0
10	43549393	.	C	T	2	3	5	0	1	6	0	0
10	43549403	.	T	C	3	3	6	0	1	7	0	0
10	43549502	.	A	C	4	0	4	0	6	10	0	0
10	43549559	.	G	C	2	4	6	0	0	6	0	0
10	43549734	.	A	C	4	4	8	0	0	8	0	0
10	43549744	.	T	A	4	3	7	0	0	7	0	0
10	43709042	.	A	T	1	3	4	0	0	4	0	0
10	43709084	.	T	C	2	5	7	0	1	8	0	0
10	43709085	.	G	C	2	6	8	0	0	8	0	0
10	43709204	.	A	G	9	9	18	0	0	18	0	0
10	43711059	.	T	A	2	4	6	0	0	6	0	0
10	43715981	.	G	A	13	8	21	0	0	21	0	0
10	43721415	.	C	T	11	6	17	0	0	17	0	0
10	43761719	.	T	A	10	10	20	0	0	20	0	0
10	43761755	.	A	G	10	12	22	0	0	22	0	0
10	43761996	.	G	A	5	8	13	0	0	13	0	0
10	43762021	.	C	T	5	9	14	0	0	14	0	0
10	43762142	.	C	T	0	7	7	0	3	10	0	0
10	43762519	.	A	G	7	5	12	0	0	12	0	0
10	43762654	.	A	G	11	12	23	0	2	25	0	0
10	43762717	.	A	G	7	16	23	0	1	24	0	0
10	43762755	.	A	C	6	10	16	0	1	18	1	0
10	43765291	.	G	C	1	2	3	0	0	3	0	0
10	43766589	.	T	C	0	0	0	0	1	1	0	0
10	43766688	.	T	G	6	5	11	0	1	12	0	0
10	43766733	.	G	A	5	8	13	0	0	13	0	0
10	43766817	.	A	C	2	0	2	0	3	5	0	0
10	43771142	.	C	T	1	7	8	0	0	8	0	0
10	43807568	.	A	G	2	2	4	0	0	4	0	0
10	43863792	.	T	G	2	3	5	0	0	5	0	0
10	43863951	.	G	A	1	4	5	0	0	5	0	0
10	43863990	.	C	G	1	5	6	0	0	6	0	0
10	43864002	.	C	T	0	2	2	0	2	4	0	0
10	43865118	.	G	A	5	2	7	0	0	7	0	0
10	43865127	.	T	G	4	2	6	0	0	6	0	0
10	43906719	.	C	T	0	1	1	0	0	1	0	0
10	43936313	.	A	T	9	8	17	0	2	19	0	0
10	43937850	.	A	G	6	3	9	0	0	9	0	0
10	43950092	.	T	G	0	4	4	0	0	4	0	0
10	43958439	.	A	C	0	1	1	0	0	1	0	0
10	43999511	.	T	C	3	3	6	0	0	6	0	0
10	44010073	.	C	T	0	4	4	0	1	5	0	0
10	44057415	.	C	A	5	4	9	0	0	9	0	0
10	44137259	.	G	A	0	0	0	0	1	1	0	0
10	44176257	.	C	T	2	3	5	0	0	5	0	0
10	44180320	.	C	T	12	11	23	0	0	23	0	0
10	44189322	.	G	T	5	3	8	0	0	8	0	0
10	44297245	.	G	T	5	7	12	0	2	14	0	0
10	44314569	.	C	T	0	1	1	0	0	1	0	0
10	44314579	.	A	G	1	0	1	0	0	1	0	0
10	44320823	.	G	C	2	11	13	0	1	14	0	0
10	44337652	.	G	T	2	2	4	0	0	4	0	0
10	44337710	.	G	A	2	4	6	0	0	6	0	0
10	44340944	.	C	T	1	3	4	0	0	4	0	0
10	44345005	.	C	T	0	4	4	0	4	8	0	0
10	44353914	.	G	A	2	2	4	0	0	4	0	0
10	44354053	.	G	C	4	7	11	0	0	11	0	0
10	44354718	.	T	C	0	0	0	0	2	2	0	0
10	44354736	.	A	C	1	1	2	0	1	3	0	0
10	44363242	.	G	T	7	7	14	0	0	14	0	0
10	44364604	.	A	T	0	1	1	0	0	1	0	0
10	44371710	.	G	T	0	11	11	0	14	25	0	0
10	44375738	.	T	G	8	0	8	0	4	12	0	0
10	44375785	.	G	A	0	2	2	0	2	4	0	0
10	44410082	.	C	T	2	3	5	0	0	5	0	0
10	44410088	.	G	A	2	2	4	0	1	5	0	0
10	44410241	.	G	A	0	1	1	0	0	1	0	0
10	44410975	.	T	C	0	2	2	0	0	2	0	0
10	44437145	.	T	C	6	9	15	0	0	15	0	0
10	44466844	.	G	A	3	3	6	0	0	6	0	0
10	44503882	.	G	A	9	10	19	0	0	19	0	0
10	44513232	.	T	C	3	3	6	0	0	6	0	0
10	44513270	.	T	C	1	0	1	0	4	5	0	0
10	44513307	.	T	C	3	4	7	0	0	7	0	0
10	44513402	.	T	C	7	0	7	0	10	17	0	0
10	44513421	.	C	T	0	9	9	0	6	15	0	0
10	44515927	.	T	C	4	3	7	0	1	8	0	0
10	44516001	.	C	T	0	3	3	0	6	9	0	0
10	44516535	.	A	T	2	3	5	0	0	5	0	0
10	44516559	.	T	C	2	0	2	0	3	5	0	0
10	44516907	.	G	T	1	3	4	0	0	4	0	0
10	44516908	.	T	C	1	0	1	0	3	4	0	0
10	44517092	.	G	A	2	2	4	0	0	4	0	0
10	44640688	.	A	C	2	8	10	0	0	10	0	0
10	44640700	.	C	T	3	8	11	0	0	11	0	0
10	44640832	.	G	A	7	9	16	0	3	19	0	0
10	44640843	.	T	C	8	9	17	0	1	18	0	0
10	44640873	.	G	A	7	4	11	0	0	11	0	0
10	44640965	.	G	A	4	6	10	0	0	10	0	0
10	44648115	.	G	T	0	6	6	0	4	10	0	0
10	44648627	.	C	T	0	3	3	0	0	3	0	0
10	44648746	.	T	A	5	1	6	0	2	8	0	0
10	44650913	.	G	A	0	4	4	0	15	19	0	0
10	44652510	.	C	T	6	8	14	0	2	16	0	0
10	44652561	.	G	A	0	2	2	0	5	7	0	0
10	44656821	.	C	G	0	1	1	0	2	3	0	0
10	44656905	.	G	A	3	1	4	0	0	4	0	0
10	44663025	.	C	T	5	12	17	0	2	19	0	0
10	44663082	.	A	G	15	11	26	0	0	26	0	0
10	44663109	.	A	G	12	8	20	0	0	20	0	0
10	44665345	.	G	T	0	8	8	0	4	12	0	0
10	44665536	.	A	T	7	10	17	0	0	17	0	0
10	44665620	.	C	T	5	3	8	0	0	8	0	0
10	44669263	.	G	A	3	3	6	0	0	6	0	0
10	44669779	.	A	G	14	0	14	0	11	25	0	0
10	44669825	.	T	G	11	12	23	0	0	23	0	0
10	44669937	.	G	A	4	5	9	0	0	9	0	0
10	44669986	.	G	A	2	2	4	0	0	4	0	0
10	44670081	.	A	T	3	4	7	0	0	7	0	0
10	44670894	.	C	T	16	10	26	0	0	26	0	0
10	44670923	.	T	C	12	8	20	0	1	21	0	0
10	44671818	.	A	C	12	13	25	0	1	26	0	0
10	44672009	.	T	A	20	23	43	0	3	46	0	0
10	44672036	.	T	A	24	18	42	0	0	43	1	0
10	44693397	.	G	A	0	1	1	0	0	1	0	0
10	44693445	.	G	A	3	2	5	11	1	17	0	0
10	44693523	.	T	G	21	1	22	0	19	41	0	0
10	44693556	.	C	T	11	17	28	0	2	30	0	0
10	44693706	.	C	T	23	5	28	0	4	32	0	0
10	44693769	.	C	T	17	11	28	0	1	29	0	0
10	44693868	.	G	A	1	1	2	3	0	5	0	0
10	44694108	.	C	T	11	7	18	0	1	19	0	0
10	44694354	.	G	A	0	16	16	1	3	20	0	0
10	44700063	.	G	C	0	2	2	0	1	3	0	0
10	44738290	.	C	T	4	3	7	0	0	7	0	0
10	44745648	.	T	G	0	2	2	0	0	2	0	0
10	44745730	.	A	G	1	0	1	0	2	3	0	0
10	44745774	.	A	T	1	2	3	0	1	4	0	0
10	44745787	.	A	G	0	0	0	0	2	2	0	0
10	44900254	.	G	A	1	2	3	0	0	3	0	0
10	44900534	.	T	A	3	2	5	0	0	5	0	0
10	44914623	.	A	G	9	0	9	0	10	19	0	0
10	44914685	.	G	T	7	6	13	0	0	13	0	0
10	44914761	.	T	A	4	6	10	0	0	10	0	0
10	44941408	.	G	A	1	2	3	0	0	3	0	0
10	44979593	.	A	T	4	2	6	0	0	6	0	0
10	44979712	.	A	G	0	5	5	0	0	5	0	0
10	44979767	.	A	G	2	3	5	0	0	5	0	0
10	44980379	.	T	C	3	2	5	0	0	5	0	0
10	44980391	.	C	T	3	4	7	0	0	7	0	0
10	44980913	.	C	T	4	5	9	0	1	10	0	0
10	44989378	.	C	T	7	0	7	0	0	7	0	0
10	44989384	.	T	C	7	3	10	0	0	10	0	0
10	44990917	.	C	T	6	9	15	0	2	17	0	0
10	45055879	.	G	A	4	6	10	0	1	11	0	0
10	45055948	.	G	A	3	0	3	0	0	3	0	0
10	45059822	.	C	T	1	3	4	0	0	4	0	0
10	45064957	.	C	T	9	15	24	0	2	26	0	0
10	45085679	.	C	T	0	1	1	0	0	1	0	0
10	45099498	.	T	C	1	1	2	0	0	2	0	0
10	45099522	.	T	C	1	1	2	0	0	2	0	0
10	45103519	.	C	T	0	1	1	0	0	1	0	0
10	45105244	.	T	C	2	1	3	0	0	3	0	0
10	45180294	.	C	T	1	0	1	0	0	1	0	0
10	45180335	.	C	T	0	4	4	0	1	5	0	0
10	45187450	.	T	C	1	3	4	0	0	4	0	0
10	45190629	.	C	T	0	2	2	0	0	2	0	0
10	45203109	.	T	C	4	1	5	0	0	5	0	0
10	45203154	.	A	G	7	3	10	0	0	10	0	0
10	45203271	.	T	A	4	3	7	0	1	8	0	0
10	45203419	.	A	T	4	3	7	0	0	7	0	0
10	45203429	.	A	G	3	1	4	0	1	5	0	0
10	45203513	.	A	G	0	2	2	0	1	3	0	0
10	45203646	.	A	G	5	2	7	0	1	8	0	0
10	45203793	.	G	A	0	3	3	0	2	5	0	0
10	45203856	.	G	A	6	6	12	0	0	12	0	0
10	45203882	.	A	G	6	4	10	0	1	11	0	0
10	45203951	.	G	A	0	2	2	0	7	9	0	0
10	45203952	.	C	T	6	2	8	0	1	9	0	0
10	45204024	.	A	G	2	4	6	0	0	6	0	0
10	45204029	.	A	T	2	4	6	0	0	6	0	0
10	45204218	.	A	G	6	0	6	0	4	10	0	0
10	45204527	.	A	G	1	2	3	0	0	3	0	0
10	45204731	.	A	G	1	5	6	0	1	7	0	0
10	45204769	.	T	A	1	2	3	0	0	3	0	0
10	45204786	.	A	C	1	4	5	0	0	5	0	0
10	45205166	.	A	C	7	10	17	1	0	18	0	0
10	45205175	.	A	G	7	0	7	0	9	16	0	0
10	45205226	.	A	G	6	1	7	0	9	16	0	0
10	45205237	.	C	G	8	1	9	0	9	18	0	0
10	45205284	.	A	C	10	11	21	0	0	21	0	0
10	45205295	.	A	G	8	0	8	0	13	21	0	0
10	45205400	.	C	A	2	7	9	0	1	10	0	0
10	45205506	.	A	C	4	4	8	0	0	8	0	0
10	45205518	.	T	G	4	4	8	0	0	8	0	0
10	45205757	.	C	A	2	8	10	0	1	11	0	0
10	45205758	.	A	G	2	9	11	0	0	11	0	0
10	45206103	.	C	G	4	1	5	0	1	7	1	0
10	45206182	.	G	A	0	5	5	0	0	5	0	0
10	45206199	.	A	C	1	0	1	0	4	5	0	0
10	45206217	.	C	A	2	1	3	0	0	3	0	0
10	45206241	.	T	A	4	6	10	0	1	11	0	0
10	45206289	.	G	C	6	0	6	0	9	15	0	0
10	45206326	.	G	T	3	4	7	0	1	8	0	0
10	45206450	.	T	C	11	0	11	0	14	25	0	0
10	45206478	.	G	T	17	4	21	0	0	21	0	0
10	45208153	.	A	G	2	3	5	0	0	5	0	0
10	45208667	.	C	T	0	3	3	0	2	5	0	0
10	45208875	.	G	A	1	7	8	0	1	9	0	0
10	45208899	.	C	A	0	2	2	0	1	3	0	0
10	45213798	.	C	T	0	1	1	0	1	2	0	0
10	45222613	.	T	C	3	0	3	0	1	4	0	0
10	45229624	.	C	A	3	2	5	0	2	7	0	0
10	45248548	.	T	A	1	4	5	0	0	5	0	0
10	45248638	.	G	A	5	4	9	0	0	9	0	0
10	45313560	.	C	T	0	2	2	0	0	2	0	0
10	45313623	.	G	A	0	3	3	0	5	8	0	0
10	45313671	.	C	T	3	5	8	0	0	8	0	0
10	45322668	.	A	G	2	1	3	0	3	6	0	0
10	45325302	.	G	A	0	2	2	0	5	7	0	0
10	45334688	.	C	T	4	4	8	0	0	8	0	0
10	45336565	.	T	C	3	8	11	0	0	11	0	0
10	45340105	.	G	T	0	10	10	0	5	15	0	0
10	45340625	.	A	C	4	2	6	0	0	6	0	0
10	45340654	.	A	G	5	4	9	0	0	9	0	0
10	45340835	.	G	C	4	10	14	0	0	14	0	0
10	45340930	.	G	T	5	6	11	0	0	11	0	0
10	45341403	.	A	G	1	11	12	0	0	12	0	0
10	45341410	.	A	G	1	0	1	0	12	13	0	0
10	45341452	.	T	G	3	5	8	0	0	8	0	0
10	45341537	.	A	C	9	7	16	0	0	16	0	0
10	45341546	.	A	C	9	6	15	0	0	15	0	0
10	45341572	.	G	C	0	7	7	0	7	14	0	0
10	45341596	.	C	T	1	6	7	0	0	7	0	0
10	45341762	.	A	T	1	8	9	0	0	9	0	0
10	45349924	.	G	A	12	12	24	0	0	24	0	0
10	45351037	.	C	T	9	5	14	0	0	14	0	0
10	45352231	.	C	T	13	18	31	0	2	33	0	0
10	45375714	.	G	T	2	0	2	0	0	2	0	0
11	356255	.	T	C	1	3	4	1	0	5	0	0
11	359403	.	A	G	14	0	14	0	5	19	0	0
11	410915	.	A	G	1	5	6	0	0	6	0	0
11	410965	.	C	T	2	2	4	0	0	4	0	0
11	411119	.	C	T	5	4	9	0	0	9	0	0
11	411207	.	A	T	3	2	5	0	0	5	0	0
11	411260	.	C	T	0	3	3	0	8	11	0	0
11	411424	.	T	C	2	6	8	0	0	8	0	0
11	411437	.	T	G	1	5	6	0	0	6	0	0
11	413129	.	C	T	1	2	3	0	0	3	0	0
11	421491	.	T	G	3	3	6	0	0	6	0	0
11	421513	.	G	T	3	3	6	0	1	7	0	0
11	421673	.	T	A	2	2	4	0	0	4	0	0
11	421765	.	C	G	0	2	2	0	0	2	0	0
11	421774	.	G	A	1	2	3	0	0	3	0	0
11	421820	.	A	G	2	2	4	0	0	4	0	0
11	421860	.	G	T	1	3	4	0	1	5	0	0
11	422412	.	C	T	1	2	3	0	0	3	0	0
11	429940	.	G	A	1	3	4	0	0	4	0	0
11	431330	.	T	C	1	0	1	0	2	3	0	0
11	431342	.	C	T	0	2	2	0	0	2	0	0
11	440411	.	T	G	1	0	1	0	2	3	0	0
11	446351	.	A	G	0	0	0	0	2	2	0	0
11	448782	.	C	T	1	3	4	0	0	4	0	0
11	448882	.	A	C	1	2	3	0	0	3	0	0
11	449008	.	T	A	1	3	4	0	0	4	0	0
11	449684	.	G	A	4	2	6	0	0	6	0	0
11	457707	.	C	T	0	14	14	0	11	25	0	0
11	458062	.	G	A	10	20	30	0	0	30	0	0
11	458083	.	A	G	10	21	31	0	0	31	0	0
11	460665	.	C	T	0	7	7	0	8	15	0	0
11	460752	.	G	A	1	2	3	0	1	4	0	0
11	474734	.	T	C	4	2	6	0	0	6	0	0
11	474917	.	C	A	7	3	10	0	0	10	0	0
11	475152	.	A	G	1	3	4	0	0	4	0	0
11	475359	.	A	G	5	3	8	0	0	8	0	0
11	475376	.	T	A	6	3	9	0	0	9	0	0
11	475399	.	G	A	2	4	6	0	1	7	0	0
11	475449	.	A	G	1	3	4	0	0	4	0	0
11	475911	.	G	T	7	3	10	0	0	10	0	0
11	476145	.	G	T	4	2	6	0	0	6	0	0
11	480611	.	G	A	3	1	4	0	0	4	0	0
11	481943	.	A	T	2	3	5	0	0	5	0	0
11	492659	.	C	T	4	31	35	0	22	57	0	0
11	494399	.	T	C	20	34	54	0	3	57	0	0
11	494405	.	A	G	23	30	53	0	8	61	0	0
11	495003	.	T	C	1	0	1	0	0	1	0	0
11	527956	.	C	T	6	4	10	0	0	10	0	0
11	537443	.	C	T	3	3	6	0	0	6	0	0
11	539425	.	T	C	1	4	5	0	1	6	0	0
11	539470	.	G	A	0	11	11	0	3	14	0	0
11	539573	.	A	C	13	3	16	0	0	16	0	0
11	539586	.	C	T	11	5	16	0	1	17	0	0
11	539899	.	T	C	3	4	7	0	0	7	0	0
11	570876	.	A	G	1	3	4	0	0	4	0	0
11	570881	.	T	C	1	0	1	0	3	4	0	0
11	570942	.	C	T	5	7	12	0	1	13	0	0
11	570979	.	C	T	6	5	11	0	1	12	0	0
11	575845	.	G	A	2	5	7	0	0	7	0	0
11	575870	.	C	T	2	5	7	0	0	7	0	0
11	575948	.	T	C	3	1	4	0	0	4	0	0
11	588201	.	A	G	5	9	14	0	0	14	0	0
11	675382	.	G	C	28	25	53	0	1	55	1	0
11	675477	.	G	A	19	23	42	0	0	42	0	0
11	676888	.	G	A	21	24	45	0	2	47	0	0
11	676899	.	A	T	21	24	45	0	5	50	0	0
11	677089	.	A	T	13	21	34	0	3	37	0	0
11	687501	.	G	A	9	4	13	0	0	13	0	0
11	690601	.	C	T	0	4	4	0	10	14	0	0
11	714954	.	G	A	0	2	2	0	0	2	0	0
11	718423	.	G	T	4	3	7	0	0	7	0	0
11	719800	.	G	T	5	5	10	0	0	10	0	0
11	813851	.	T	C	1	0	1	0	9	10	0	0
11	1529838	.	A	G	7	8	15	0	0	15	0	0
11	1530234	.	A	G	20	8	28	0	3	31	0	0
11	2253154	.	G	A	8	3	11	0	1	12	0	0
11	2254486	.	A	G	1	1	2	0	0	2	0	0
11	2254889	.	T	G	1	2	3	0	0	3	0	0
11	2254891	.	C	G	1	2	3	0	0	3	0	0
11	2255025	.	T	G	6	6	12	0	0	12	0	0
11	2255027	.	T	G	6	6	12	0	0	12	0	0
11	2541792	.	T	C	5	2	7	0	0	7	0	0
11	2681953	.	A	G	3	0	3	0	6	9	0	0
11	2681998	.	A	G	4	2	6	0	1	7	0	0
11	2682700	.	A	G	5	2	7	0	1	8	0	0
11	2705657	.	A	G	8	4	12	0	1	13	0	0
11	2759425	.	A	G	6	3	9	0	0	9	0	0
11	2759461	.	T	C	4	12	16	0	0	16	0	0
11	2759475	.	G	T	4	13	17	0	1	18	0	0
11	2759498	.	G	A	5	20	25	0	0	25	0	0
11	2759541	.	C	A	2	20	22	0	0	22	0	0
11	3211910	.	G	A	3	4	7	0	0	7	0	0
11	3211926	.	G	A	3	5	8	0	0	8	0	0
11	3230284	.	G	A	3	2	5	0	0	5	0	0
11	3233455	.	T	G	2	1	3	0	0	3	0	0
11	3235516	.	G	A	2	3	5	0	0	5	0	0
11	3235543	.	C	T	5	4	9	0	0	9	0	0
11	3235558	.	G	A	0	4	4	0	5	9	0	0
11	3237023	.	T	C	2	2	4	0	0	4	0	0
11	3243316	.	T	C	1	4	5	0	0	5	0	0
11	3246120	.	A	G	6	5	11	0	0	11	0	0
11	3249158	.	A	G	6	0	6	0	9	15	0	0
11	3249253	.	C	T	3	7	10	0	0	10	0	0
11	3249268	.	T	C	3	8	11	0	4	15	0	0
11	3249334	.	T	C	4	9	13	0	0	13	0	0
11	3249346	.	C	T	4	8	12	0	0	12	0	0
11	3249370	.	A	G	5	0	5	0	4	9	0	0
11	3312137	.	T	C	4	8	12	0	0	12	0	0
11	3323411	.	A	G	4	1	5	0	1	6	0	0
11	3323414	.	G	A	4	2	6	0	0	6	0	0
11	3337038	.	A	G	36	27	63	0	5	68	0	0
11	3337253	.	A	G	30	32	62	0	4	66	0	0
11	3337256	.	T	C	29	0	29	0	36	65	0	0
11	3337698	.	T	A	22	19	41	0	1	42	0	0
11	3337718	.	G	C	22	21	43	0	1	44	0	0
11	3338060	.	C	G	17	21	38	0	2	40	0	0
11	3338144	.	T	C	29	21	50	0	6	56	0	0
11	3338236	.	T	C	29	1	30	0	21	51	0	0
11	3338288	.	T	A	32	15	47	1	1	49	0	0
11	3338299	.	T	G	29	15	44	1	1	47	1	0
11	3338431	.	C	T	0	25	25	0	34	59	0	0
11	3338491	.	G	A	19	29	48	0	2	50	0	0
11	3338514	.	C	A	25	28	53	0	1	54	0	0
11	3338624	.	G	A	31	20	51	0	3	54	0	0
11	3338638	.	A	G	36	21	57	0	2	59	0	0
11	3338708	.	A	G	20	31	51	0	6	57	0	0
11	3338813	.	T	C	36	1	37	0	23	60	0	0
11	3338933	.	A	G	26	17	43	0	1	44	0	0
11	3339107	.	C	T	0	18	18	0	25	43	0	0
11	3339425	.	G	A	33	28	61	0	0	61	0	0
11	3340306	.	G	A	14	14	28	0	1	29	0	0
11	3341350	.	C	G	0	18	18	0	15	33	0	0
11	3345676	.	A	G	3	3	6	0	0	6	0	0
11	3345716	.	T	C	2	4	6	0	0	6	0	0
11	3345741	.	T	C	3	0	3	0	6	9	0	0
11	3345779	.	T	C	4	2	6	0	0	6	0	0
11	3345877	.	T	C	2	4	6	0	0	6	0	0
11	3345900	.	G	A	1	7	8	0	0	8	0	0
11	3345952	.	T	C	0	7	7	0	0	7	0	0
11	3346066	.	C	A	7	2	9	0	1	10	0	0
11	3346076	.	G	C	9	2	11	0	1	12	0	0
11	3346222	.	A	G	2	4	6	0	0	6	0	0
11	3347414	.	C	A	0	2	2	0	6	8	0	0
11	3348004	.	T	G	1	3	4	0	0	4	0	0
11	3367924	.	G	C	7	10	17	0	0	17	0	0
11	3369891	.	A	G	2	3	5	0	0	5	0	0
11	3373418	.	A	G	2	1	3	0	1	4	0	0
11	3377127	.	T	C	2	0	2	0	1	3	0	0
11	3379999	.	G	T	1	3	4	0	0	4	0	0
11	3380012	.	C	G	1	4	5	0	1	6	0	0
11	3380135	.	A	G	0	2	2	0	0	2	0	0
11	3381243	.	T	A	4	4	8	0	1	9	0	0
11	3381261	.	C	A	4	8	12	0	0	12	0	0
11	3381290	.	A	G	3	5	8	0	0	8	0	0
11	3395069	.	G	A	3	2	5	0	0	5	0	0
11	3395070	.	A	T	3	2	5	0	0	5	0	0
11	3395303	.	G	A	1	0	1	0	0	1	0	0
11	3395324	.	C	T	12	1	13	0	0	13	0	0
11	3395501	.	A	G	1	6	7	0	0	7	0	0
11	3395693	.	A	T	2	3	5	0	0	5	0	0
11	3395699	.	G	A	2	3	5	0	0	5	0	0
11	3398738	.	A	C	0	0	0	0	1	1	0	0
11	3425136	.	G	A	0	1	1	0	0	1	0	0
11	3425175	.	G	A	7	4	11	0	0	11	0	0
11	3494930	.	T	A	2	7	9	0	0	9	0	0
11	3499160	.	A	G	1	0	1	0	2	3	0	0
11	3499197	.	G	A	3	2	5	0	0	5	0	0
11	3499204	.	G	T	3	2	5	0	0	5	0	0
11	3510055	.	G	A	0	3	3	0	1	4	0	0
11	3510067	.	A	G	1	3	4	0	0	4	0	0
11	3520631	.	A	G	1	2	3	0	0	3	0	0
11	3520670	.	T	C	1	2	3	0	0	3	0	0
11	3520694	.	C	A	2	2	4	0	0	4	0	0
11	3523493	.	G	A	5	9	14	0	1	15	0	0
11	3523976	.	A	C	12	0	12	0	9	21	0	0
11	3524111	.	G	A	9	6	15	0	0	15	0	0
11	3524196	.	A	G	17	17	34	0	0	34	0	0
11	3524236	.	C	T	18	19	37	0	1	38	0	0
11	3524541	.	A	T	4	8	12	0	0	12	0	0
11	3524591	.	G	A	6	4	10	0	0	10	0	0
11	3524715	.	A	C	4	2	6	0	0	6	0	0
11	3526443	.	T	C	1	1	2	0	0	2	0	0
11	3526458	.	A	G	3	4	7	0	0	7	0	0
11	3526521	.	A	G	4	5	9	0	2	12	1	0
11	3526605	.	C	G	4	4	8	0	0	8	0	0
11	3528320	.	A	T	8	8	16	0	0	16	0	0
11	3530443	.	G	T	8	5	13	0	1	14	0	0
11	3530991	.	T	C	0	0	0	0	1	1	0	0
11	3551074	.	T	C	28	17	45	0	0	45	0	0
11	3551944	.	G	A	23	30	53	0	1	54	0	0
11	3551986	.	C	T	0	17	17	0	17	34	0	0
11	3563124	.	G	A	2	2	4	0	0	4	0	0
11	3563644	.	C	T	0	3	3	0	4	7	0	0
11	3563647	.	G	A	4	3	7	0	0	7	0	0
11	3563680	.	A	G	2	2	4	0	0	4	0	0
11	3593309	.	T	C	3	8	11	0	0	11	0	0
11	3593490	.	A	C	3	14	17	0	0	17	0	0
11	3593748	.	A	G	5	9	14	0	1	15	0	0
11	3593859	.	T	C	6	4	10	0	0	10	0	0
11	3593878	.	T	C	2	1	3	0	6	9	0	0
11	3594062	.	T	C	10	11	21	0	1	22	0	0
11	3594070	.	T	C	10	10	20	0	1	21	0	0
11	3594147	.	A	T	11	5	16	0	0	16	0	0
11	3594277	.	T	G	6	9	15	0	3	18	0	0
11	3594321	.	T	C	4	0	4	0	11	15	0	0
11	3594327	.	T	A	4	9	13	0	1	14	0	0
11	3594366	.	A	G	4	12	16	0	3	19	0	0
11	3594452	.	T	G	3	7	10	0	7	17	0	0
11	3594541	.	A	T	6	8	14	0	1	15	0	0
11	3594573	.	A	T	6	3	9	0	1	10	0	0
11	3594618	.	G	A	5	5	10	0	0	10	0	0
11	3594649	.	T	G	5	6	11	0	1	12	0	0
11	3595140	.	A	C	3	0	3	0	3	6	0	0
11	3595308	.	G	A	5	7	12	0	0	12	0	0
11	3595579	.	A	G	10	6	16	0	0	16	0	0
11	3600246	.	C	A	1	0	1	0	0	1	0	0
11	3602382	.	T	C	5	7	12	0	2	14	0	0
11	3603392	.	A	G	2	1	3	0	1	4	0	0
11	3606914	.	T	C	2	0	2	0	2	4	0	0
11	3609448	.	A	T	4	2	6	0	0	6	0	0
11	3848656	.	C	T	8	14	22	0	1	23	0	0
11	3858081	.	T	G	8	3	11	0	1	12	0	0
11	3858318	.	A	G	9	13	22	0	1	23	0	0
11	3860104	.	C	G	7	4	11	0	0	11	0	0
11	3860149	.	G	T	4	2	6	0	0	6	0	0
11	3860524	.	C	G	3	2	5	0	0	5	0	0
11	3893429	.	A	C	14	23	37	0	1	38	0	0
11	3893564	.	A	G	14	17	31	0	3	34	0	0
11	3893635	.	C	T	9	19	28	0	3	32	1	0
11	3893636	.	T	G	10	21	31	0	1	32	0	0
11	3893928	.	G	C	10	21	31	0	2	33	0	0
11	3893933	.	G	C	10	18	28	0	2	30	0	0
11	3894023	.	T	C	11	9	20	0	0	20	0	0
11	3898787	.	C	T	0	12	12	0	10	22	0	0
11	3899066	.	C	A	0	15	15	0	7	22	0	0
11	3901375	.	C	A	0	9	9	0	11	20	0	0
11	3901414	.	C	T	10	9	19	0	2	21	0	0
11	3901733	.	C	G	1	19	20	0	7	27	0	0
11	3904517	.	C	G	0	11	11	0	13	24	0	0
11	3904674	.	T	G	6	3	9	0	0	9	0	0
11	3910103	.	T	C	14	16	30	0	2	32	0	0
11	3910304	.	G	A	12	8	20	0	0	20	0	0
11	3910310	.	C	T	12	7	19	0	0	19	0	0
11	3917723	.	A	G	1	0	1	0	1	2	0	0
11	3922983	.	G	A	4	4	8	0	0	8	0	0
11	3925822	.	T	C	1	0	1	0	5	6	0	0
11	3925906	.	A	G	5	8	13	0	0	13	0	0
11	3925939	.	T	C	2	4	6	0	0	6	0	0
11	3927859	.	G	A	5	5	10	0	1	11	0	0
11	3928044	.	A	T	2	5	7	0	0	7	0	0
11	3934043	.	A	G	6	3	9	0	0	9	0	0
11	3934190	.	A	G	5	4	9	0	0	9	0	0
11	3934319	.	T	G	3	2	5	0	0	5	0	0
11	3936111	.	A	G	0	2	2	0	1	3	0	0
11	3936378	.	T	A	5	3	8	0	1	9	0	0
11	3941634	.	A	G	1	0	1	0	0	1	0	0
11	3941649	.	G	T	2	1	3	0	0	3	0	0
11	3941697	.	A	T	2	1	3	0	0	3	0	0
11	3951531	.	T	A	2	3	5	0	0	5	0	0
11	3954572	.	T	C	1	0	1	0	0	1	0	0
11	3959435	.	T	C	4	3	7	0	0	7	0	0
11	3962979	.	A	C	0	1	1	0	0	1	0	0
11	3963388	.	C	T	1	0	1	0	0	1	0	0
11	3963639	.	T	A	4	1	5	0	0	5	0	0
11	3964193	.	T	A	0	3	3	0	0	3	0	0
11	3965984	.	T	A	4	2	6	0	0	6	0	0
11	3967408	.	A	G	3	0	3	0	2	5	0	0
11	3968877	.	G	A	6	5	11	0	0	11	0	0
11	3968915	.	T	G	2	2	4	0	0	4	0	0
11	3970955	.	C	A	1	3	4	0	3	7	0	0
11	3989472	.	A	G	15	0	15	0	13	28	0	0
11	3993452	.	G	A	2	9	11	0	4	15	0	0
11	3994901	.	C	A	1	2	3	0	0	3	0	0
11	3995468	.	T	C	2	4	6	0	0	6	0	0
11	3995515	.	A	G	3	7	10	0	1	11	0	0
11	4010744	.	C	G	2	4	6	0	1	7	0	0
11	4010752	.	T	G	2	5	7	0	0	7	0	0
11	4010895	.	C	T	1	3	4	0	1	5	0	0
11	4011001	.	T	C	4	0	4	0	5	9	0	0
11	4014428	.	A	T	0	1	1	0	0	1	0	0
11	4014737	.	C	T	2	1	3	0	0	3	0	0
11	4014758	.	T	C	0	0	0	0	1	1	0	0
11	4021231	.	G	A	1	2	3	0	1	4	0	0
11	4053390	.	G	A	0	5	5	0	4	9	0	0
11	4113807	.	C	T	1	5	6	0	0	6	0	0
11	4131070	.	A	T	3	4	7	0	0	7	0	0
11	4131080	.	A	G	4	0	4	0	4	8	0	0
11	4131150	.	G	A	1	1	2	0	0	2	0	0
11	4131229	.	G	A	6	5	11	0	0	11	0	0
11	4131300	.	A	T	4	5	9	0	2	11	0	0
11	4131313	.	C	T	6	7	13	0	0	13	0	0
11	4131933	.	T	A	13	10	23	0	1	24	0	0
11	4132159	.	C	A	16	14	30	0	1	31	0	0
11	4132229	.	A	G	23	15	38	0	4	42	0	0
11	4132295	.	C	T	29	26	55	0	0	55	0	0
11	4132296	.	A	C	29	26	55	0	0	55	0	0
11	4132378	.	G	C	18	11	29	0	0	29	0	0
11	4132440	.	A	G	16	12	28	0	0	28	0	0
11	5072285	.	T	C	2	0	2	0	0	2	0	0
11	5513352	.	C	T	1	6	7	0	0	7	0	0
11	5648358	.	G	A	0	2	2	0	4	6	0	0
11	5648643	.	C	T	6	6	12	0	0	12	0	0
11	5658587	.	T	A	4	4	8	0	0	8	0	0
11	5658889	.	A	G	1	3	4	0	0	4	0	0
11	5658941	.	A	G	4	3	7	0	0	7	0	0
11	5659097	.	G	A	5	3	8	0	0	8	0	0
11	5659177	.	T	A	5	2	7	0	2	9	0	0
11	5669671	.	T	C	3	1	4	0	0	4	0	0
11	5669722	.	G	A	0	1	1	0	3	4	0	0
11	5669907	.	G	A	0	5	5	0	1	6	0	0
11	5669917	.	A	T	1	5	6	0	0	6	0	0
11	5669950	.	T	C	1	3	4	0	0	4	0	0
11	5674134	.	G	A	6	5	11	0	0	11	0	0
11	5674150	.	A	G	6	7	13	0	1	14	0	0
11	5674183	.	G	C	8	4	12	0	0	12	0	0
11	5674731	.	T	G	5	0	5	0	12	17	0	0
11	5817345	.	T	C	5	10	15	0	0	15	0	0
11	5817397	.	A	T	8	6	14	0	0	14	0	0
11	5817472	.	C	A	8	4	12	0	3	15	0	0
11	5821096	.	C	G	2	2	4	0	1	5	0	0
11	5825477	.	T	C	3	1	4	0	0	4	0	0
11	5836012	.	G	A	9	10	19	0	0	19	0	0
11	5836049	.	A	C	12	6	18	0	1	19	0	0
11	5844303	.	T	A	1	0	1	0	0	1	0	0
11	5844333	.	T	C	0	1	1	0	0	1	0	0
11	5844525	.	G	A	10	17	27	0	1	28	0	0
11	5844579	.	G	A	0	1	1	0	5	6	0	0
11	5847511	.	G	A	10	6	16	0	1	17	0	0
11	5852424	.	G	T	0	12	12	0	12	24	0	0
11	5923335	.	C	A	19	11	30	0	2	32	0	0
11	5923515	.	G	A	0	2	2	0	4	6	0	0
11	5945836	.	A	T	3	5	8	0	0	8	0	0
11	5945840	.	G	A	3	5	8	0	1	9	0	0
11	5945919	.	T	A	6	4	10	0	0	10	0	0
11	5946023	.	T	A	12	11	23	0	0	23	0	0
11	5946564	.	T	C	9	12	21	0	3	24	0	0
11	5946854	.	G	C	19	18	37	0	3	40	0	0
11	5947191	.	T	G	11	19	30	0	1	31	0	0
11	5953436	.	G	T	4	4	8	0	0	8	0	0
11	5953521	.	T	C	7	0	7	0	4	11	0	0
11	5953547	.	C	T	0	5	5	0	8	13	0	0
11	5965633	.	G	A	2	2	4	0	0	4	0	0
11	5966340	.	C	T	2	2	4	0	0	4	0	0
11	6034494	.	T	C	0	3	3	0	0	3	0	0
11	6034530	.	T	C	0	2	2	0	0	2	0	0
11	6051362	.	C	G	5	3	8	0	1	9	0	0
11	6051431	.	G	A	6	3	9	0	1	10	0	0
11	6051632	.	G	A	8	10	18	0	0	18	0	0
11	6051648	.	C	T	0	12	12	0	10	22	0	0
11	6051679	.	C	T	10	12	22	0	0	22	0	0
11	6051880	.	A	C	10	1	11	0	12	23	0	0
11	6057335	.	G	A	1	3	4	0	0	4	0	0
11	6062107	.	T	A	0	2	2	0	0	2	0	0
11	6071523	.	C	G	0	1	1	0	0	1	0	0
11	6072558	.	A	G	2	2	4	0	0	4	0	0
11	6132985	.	T	G	3	2	5	0	0	5	0	0
11	6133293	.	G	C	2	2	4	0	0	4	0	0
11	6133335	.	G	A	2	5	7	0	0	7	0	0
11	6144355	.	A	C	3	2	5	0	0	5	0	0
11	6144776	.	T	C	1	6	7	0	0	7	0	0
11	6144800	.	G	A	0	4	4	0	1	5	0	0
11	6167971	.	C	T	0	2	2	0	0	2	0	0
11	6168047	.	C	T	0	1	1	0	0	1	0	0
11	6170596	.	C	A	3	3	6	0	0	6	0	0
11	6170662	.	T	C	2	2	4	0	0	4	0	0
11	6183030	.	T	C	3	10	13	0	0	13	0	0
11	6187412	.	C	G	0	9	9	0	8	17	0	0
11	6197446	.	A	T	2	6	8	0	0	8	0	0
11	6197495	.	C	T	0	5	5	0	0	5	0	0
11	6261988	.	C	T	1	2	3	0	1	4	0	0
11	6290039	.	C	T	1	0	1	0	0	1	0	0
11	6300374	.	T	C	1	0	1	0	0	1	0	0
11	6446730	.	G	A	0	2	2	0	1	3	0	0
11	6446950	.	G	A	3	1	4	0	1	5	0	0
11	6456177	.	C	T	11	6	17	0	0	17	0	0
11	6456447	.	C	T	1	3	4	0	0	4	0	0
11	6456677	.	T	C	8	10	18	0	2	20	0	0
11	6456829	.	C	T	16	19	35	0	1	36	0	0
11	6456889	.	C	T	4	2	6	0	0	6	0	0
11	6456891	.	T	A	4	2	6	0	0	6	0	0
11	6456934	.	C	A	1	2	3	0	0	3	0	0
11	6457442	.	G	A	15	12	27	0	2	29	0	0
11	6457500	.	A	T	14	6	20	0	0	20	0	0
11	6457518	.	T	C	16	7	23	0	1	24	0	0
11	6457594	.	C	A	7	7	14	0	2	16	0	0
11	6457619	.	T	C	5	10	15	0	0	15	0	0
11	6942501	.	A	G	5	3	8	0	0	8	0	0
11	6942509	.	A	G	6	2	8	0	0	8	0	0
11	6977456	.	A	T	1	2	3	0	0	3	0	0
11	6977580	.	G	A	1	2	3	0	0	3	0	0
11	6977626	.	T	C	0	3	3	0	0	3	0	0
11	6978499	.	C	T	1	3	4	0	0	4	0	0
11	6985237	.	A	G	2	2	4	0	0	4	0	0
11	6987168	.	A	G	2	2	4	0	0	4	0	0
11	10468756	.	T	C	5	3	8	0	0	8	0	0
11	10468772	.	T	A	4	1	5	0	1	6	0	0
11	10671891	.	T	C	9	5	14	0	0	14	0	0
11	10671892	.	T	C	9	5	14	0	0	14	0	0
11	10672024	.	T	C	20	7	27	0	3	30	0	0
11	10672025	.	T	C	20	0	20	0	10	30	0	0
11	10672180	.	T	C	1	3	4	0	1	5	0	0
11	10672191	.	T	C	3	0	3	0	3	6	0	0
11	12720049	.	T	A	2	1	3	0	0	3	0	0
11	12727225	.	A	G	8	6	14	0	0	14	0	0
11	12727446	.	C	T	25	23	48	0	3	51	0	0
11	12727685	.	T	C	11	28	39	0	1	40	0	0
11	12727708	.	C	A	10	22	32	0	0	32	0	0
11	12727879	.	A	C	8	8	16	0	1	17	0	0
11	12727990	.	T	A	13	16	29	0	0	29	0	0
11	12727999	.	C	T	11	11	22	0	1	23	0	0
11	12728195	.	T	G	10	8	18	0	0	18	0	0
11	12728249	.	C	T	8	6	14	0	1	15	0	0
11	12732521	.	T	C	4	0	4	0	7	11	0	0
11	12732569	.	C	T	3	6	9	0	0	9	0	0
11	12732573	.	T	G	2	5	7	0	0	7	0	0
11	12732696	.	T	A	1	2	3	0	0	3	0	0
11	12732699	.	A	T	1	2	3	0	0	3	0	0
11	12733104	.	G	A	1	3	4	0	0	4	0	0
11	12733235	.	T	C	2	0	2	0	3	5	0	0
11	12733261	.	T	C	4	2	6	0	0	6	0	0
11	12733278	.	G	C	2	3	5	0	0	5	0	0
11	12733892	.	T	G	3	5	8	0	0	8	0	0
11	12734223	.	G	A	0	2	2	0	0	2	0	0
11	12744740	.	T	C	3	2	5	0	0	5	0	0
11	12751500	.	G	A	3	1	4	0	0	4	0	0
11	12751831	.	T	C	0	3	3	0	0	3	0	0
11	12752161	.	A	T	1	4	5	0	0	5	0	0
11	12767964	.	A	G	2	0	2	0	2	4	0	0
11	12767982	.	T	C	3	3	6	0	0	6	0	0
11	12768214	.	G	A	0	8	8	0	6	14	0	0
11	12768221	.	C	T	5	11	16	0	0	16	0	0
11	12768351	.	A	G	7	10	17	0	0	17	0	0
11	12768394	.	A	C	7	4	11	0	0	11	0	0
11	12768480	.	C	T	3	1	4	0	2	6	0	0
11	12782802	.	G	A	1	5	6	0	0	6	0	0
11	12783139	.	T	A	3	3	6	0	0	6	0	0
11	12800927	.	A	C	0	2	2	0	0	2	0	0
11	12829985	.	C	T	1	2	3	0	0	3	0	0
11	12829994	.	G	T	1	2	3	0	0	3	0	0
11	12834044	.	C	T	1	1	2	0	0	2	0	0
11	12839413	.	T	C	1	1	2	0	1	3	0	0
11	12845066	.	A	G	1	0	1	0	0	1	0	0
11	12860525	.	T	C	4	5	9	0	0	9	0	0
11	12860552	.	G	A	0	5	5	0	4	9	0	0
11	12860924	.	A	G	4	3	7	0	0	7	0	0
11	12860931	.	C	G	3	2	5	0	0	5	0	0
11	12861196	.	A	G	2	3	5	0	1	6	0	0
11	12864070	.	C	T	3	1	4	0	0	4	0	0
11	12864361	.	A	G	1	0	1	0	3	4	0	0
11	12869192	.	G	T	0	6	6	0	8	14	0	0
11	12869309	.	T	C	8	3	11	0	0	11	0	0
11	12869409	.	C	A	5	7	12	0	0	12	0	0
11	12869414	.	C	T	5	5	10	0	1	11	0	0
11	12872855	.	G	C	1	3	4	0	0	4	0	0
11	12982480	.	A	G	4	2	6	0	0	6	0	0
11	13055470	.	G	A	10	7	17	0	1	18	0	0
11	13055694	.	C	A	12	4	16	0	1	17	0	0
11	13062000	.	T	C	3	3	6	0	0	6	0	0
11	13071920	.	A	G	0	3	3	0	0	3	0	0
11	13074127	.	T	C	1	2	3	0	0	3	0	0
11	13094199	.	C	T	14	7	21	0	0	21	0	0
11	13094203	.	C	T	6	14	20	0	1	21	0	0
11	13094368	.	T	A	4	7	11	0	2	13	0	0
11	13094473	.	A	T	17	12	29	0	0	29	0	0
11	13094581	.	C	T	6	22	28	0	23	51	0	0
11	13094668	.	C	A	18	17	35	0	3	38	0	0
11	13094678	.	T	C	16	16	32	0	3	35	0	0
11	13094778	.	T	C	16	13	29	0	1	30	0	0
11	13095049	.	G	A	14	10	24	0	2	26	0	0
11	13176674	.	C	A	0	1	1	0	0	1	0	0
11	13188425	.	G	C	4	2	6	0	0	6	0	0
11	13189339	.	G	T	2	5	7	0	0	7	0	0
11	13189592	.	G	A	3	3	6	0	0	6	0	0
11	13208755	.	T	A	10	14	24	0	0	24	0	0
11	13209037	.	T	G	25	20	45	0	2	47	0	0
11	13209391	.	C	T	9	10	19	0	0	19	0	0
11	13210604	.	G	A	24	26	50	0	3	53	0	0
11	13210650	.	A	C	27	29	56	0	1	57	0	0
11	13210897	.	A	T	28	28	56	0	2	58	0	0
11	13212234	.	T	C	45	27	72	0	2	74	0	0
11	13212306	.	C	T	28	23	51	0	1	52	0	0
11	13212333	.	T	C	18	7	25	0	1	26	0	0
11	13212357	.	T	C	5	2	7	0	1	8	0	0
11	13212567	.	T	C	25	32	57	0	4	61	0	0
11	13212908	.	T	A	28	23	51	0	3	54	0	0
11	13280346	.	T	A	1	4	5	0	1	6	0	0
11	13280420	.	G	C	3	2	5	0	1	6	0	0
11	13280565	.	T	C	16	3	19	0	11	30	0	0
11	13280579	.	A	C	17	6	23	0	4	27	0	0
11	13281122	.	T	C	13	9	22	0	0	22	0	0
11	13281158	.	A	T	10	6	16	0	0	16	0	0
11	13281238	.	A	G	6	1	7	0	0	7	0	0
11	13281243	.	C	A	7	0	7	0	0	7	0	0
11	13281331	.	A	T	9	5	14	0	2	16	0	0
11	13281594	.	T	C	14	9	23	0	0	23	0	0
11	13281734	.	G	A	14	12	26	0	2	28	0	0
11	13281794	.	G	T	7	10	17	0	2	19	0	0
11	13281864	.	C	T	4	6	10	0	0	10	0	0
11	13282201	.	G	T	10	4	14	0	1	15	0	0
11	13283335	.	A	G	8	6	14	0	0	14	0	0
11	13283368	.	C	A	5	8	13	0	0	13	0	0
11	13283398	.	G	C	4	6	10	0	1	11	0	0
11	13283403	.	T	G	5	6	11	0	0	11	0	0
11	13283447	.	G	A	10	6	16	0	0	16	0	0
11	13283476	.	C	T	10	6	16	0	1	17	0	0
11	13283569	.	G	A	7	4	11	0	2	13	0	0
11	13283634	.	C	T	7	5	12	0	1	13	0	0
11	13283713	.	G	A	6	10	16	0	2	18	0	0
11	13292084	.	A	G	4	10	14	0	1	15	0	0
11	13292105	.	C	T	0	9	9	0	8	17	0	0
11	13292462	.	C	T	2	3	5	0	1	6	0	0
11	13292576	.	C	T	0	4	4	0	6	10	0	0
11	13306186	.	C	T	2	0	2	0	0	2	0	0
11	13313524	.	G	A	0	2	2	0	0	2	0	0
11	13424543	.	G	A	1	0	1	0	0	1	0	0
11	13485140	.	A	G	2	0	2	0	2	4	0	0
11	13494666	.	T	A	2	2	4	0	0	4	0	0
11	13504230	.	A	G	4	2	6	0	0	6	0	0
11	13504343	.	A	C	5	3	8	0	0	8	0	0
11	13504403	.	C	T	3	3	6	0	1	7	0	0
11	13504473	.	A	T	2	2	4	0	0	4	0	0
11	13505186	.	C	A	11	4	15	0	1	16	0	0
11	13505247	.	A	T	5	2	7	0	0	7	0	0
11	13532024	.	G	T	11	7	18	0	0	18	0	0
11	13532034	.	G	A	0	7	7	0	7	15	1	0
11	13532070	.	T	G	2	0	2	0	4	6	0	0
11	13532071	.	T	C	1	4	5	0	1	6	0	0
11	13532567	.	T	C	1	1	2	0	1	3	0	0
11	13532763	.	C	T	6	4	10	0	1	11	0	0
11	13532922	.	C	T	3	3	6	0	0	6	0	0
11	13533094	.	T	G	5	7	12	0	0	12	0	0
11	13533124	.	G	A	6	9	15	0	1	16	0	0
11	13533214	.	A	G	6	0	6	0	4	10	0	0
11	13533388	.	T	A	6	9	15	0	0	15	0	0
11	13533429	.	G	T	6	8	14	0	1	15	0	0
11	13636198	.	C	T	2	3	5	0	0	5	0	0
11	13639185	.	C	G	3	2	5	0	0	5	0	0
11	13697910	.	T	C	1	0	1	0	0	1	0	0
11	14014617	.	T	C	2	2	4	0	1	5	0	0
11	14035391	.	T	C	5	3	8	0	1	9	0	0
11	14062138	.	T	C	2	3	5	0	0	5	0	0
11	14062157	.	T	G	2	2	4	0	0	4	0	0
11	14062357	.	C	T	3	2	5	0	0	5	0	0
11	14062583	.	C	T	1	2	3	0	0	3	0	0
11	14062662	.	A	G	2	2	4	0	0	4	0	0
11	14062667	.	A	G	2	2	4	0	0	4	0	0
11	14063588	.	A	G	1	3	4	0	0	4	0	0
11	14064006	.	C	G	2	5	7	0	0	7	0	0
11	14064156	.	A	T	1	3	4	0	0	4	0	0
11	14064487	.	G	C	2	5	7	0	1	8	0	0
11	14073049	.	T	A	4	7	11	0	0	11	0	0
11	14073444	.	C	T	10	6	16	0	1	17	0	0
11	14073503	.	G	A	4	10	14	0	0	14	0	0
11	14073560	.	T	A	8	13	21	0	1	22	0	0
11	14073730	.	G	T	11	8	19	0	2	21	0	0
11	14073857	.	C	A	7	4	11	0	0	12	1	0
11	14073858	.	A	T	7	5	12	0	0	12	0	0
11	14074125	.	T	C	6	8	14	0	0	14	0	0
11	14074245	.	T	C	3	6	9	0	1	10	0	0
11	14074628	.	T	A	3	2	5	0	0	5	0	0
11	14074649	.	A	G	5	5	10	0	0	10	0	0
11	14074738	.	G	A	4	4	8	0	0	8	0	0
11	14074951	.	C	T	5	5	10	0	0	10	0	0
11	14074952	.	A	T	5	4	9	0	1	10	0	0
11	14075147	.	G	A	5	4	9	0	1	10	0	0
11	14075302	.	A	G	4	9	13	0	1	14	0	0
11	14101295	.	C	A	0	6	6	0	2	8	0	0
11	14101497	.	A	T	2	2	4	0	0	4	0	0
11	14101521	.	A	T	2	3	5	0	0	5	0	0
11	14104721	.	T	C	1	2	3	0	0	3	0	0
11	14132176	.	C	G	3	0	3	0	3	6	0	0
11	14137563	.	C	T	3	3	6	0	0	6	0	0
11	14137901	.	C	A	4	5	9	0	0	9	0	0
11	14137988	.	C	T	1	3	4	0	0	4	0	0
11	14138006	.	T	G	0	2	2	0	0	2	0	0
11	14143452	.	C	A	7	2	9	0	3	12	0	0
11	14199913	.	G	C	0	5	5	0	8	13	0	0
11	14266826	.	G	T	1	9	10	0	10	20	0	0
11	14267075	.	T	C	15	9	24	0	0	24	0	0
11	14267076	.	G	A	15	8	23	0	0	24	1	0
11	14267239	.	C	G	8	4	12	0	0	12	0	0
11	14289776	.	C	A	1	2	3	0	0	3	0	0
11	14290616	.	C	A	2	2	4	0	0	4	0	0
11	14318207	.	T	A	2	2	4	0	0	4	0	0
11	14318637	.	A	G	3	6	9	0	0	9	0	0
11	14340928	.	C	T	1	2	3	0	0	3	0	0
11	14343567	.	A	C	5	6	11	0	0	11	0	0
11	14343612	.	T	G	3	4	7	0	1	8	0	0
11	14344976	.	G	T	1	2	3	0	0	3	0	0
11	14344989	.	G	A	0	2	2	0	1	3	0	0
11	14345062	.	T	A	3	2	5	0	0	5	0	0
11	14345064	.	C	T	3	2	5	0	0	5	0	0
11	14345156	.	C	A	2	3	5	0	0	5	0	0
11	14345215	.	A	G	1	2	3	0	1	4	0	0
11	14345221	.	T	G	2	1	3	0	1	4	0	0
11	14345562	.	T	G	3	4	7	0	0	7	0	0
11	14345638	.	C	T	5	2	7	0	2	9	0	0
11	14345753	.	A	G	5	3	8	0	0	8	0	0
11	14345830	.	T	C	6	5	11	0	0	11	0	0
11	14345884	.	T	G	2	4	6	0	0	6	0	0
11	14345910	.	A	T	3	3	6	0	0	6	0	0
11	14345922	.	T	G	2	2	4	0	0	4	0	0
11	14346028	.	A	C	1	2	3	0	0	3	0	0
11	14346039	.	A	G	1	2	3	0	0	3	0	0
11	14639030	.	T	C	4	8	12	0	2	14	0	0
11	14640002	.	G	T	0	4	4	0	1	5	0	0
11	14640155	.	A	G	2	5	7	0	0	7	0	0
11	14749156	.	G	A	4	2	6	0	0	6	0	0
11	14955592	.	A	G	9	5	14	0	1	15	0	0
11	15250544	.	T	C	5	7	12	0	0	12	0	0
11	15586740	.	C	A	0	1	1	0	0	1	0	0
11	15586757	.	T	C	1	1	2	0	0	2	0	0
11	15587041	.	G	A	0	2	2	0	0	2	0	0
11	15587066	.	G	A	0	1	1	0	0	1	0	0
11	15834110	.	T	G	2	4	6	0	0	6	0	0
11	15850735	.	C	T	1	1	2	0	0	2	0	0
11	15874809	.	C	A	0	1	1	0	2	3	0	0
11	15874820	.	A	G	1	2	3	0	0	3	0	0
11	15878458	.	T	C	4	2	6	0	0	6	0	0
11	15888117	.	G	C	0	2	2	0	2	4	0	0
11	15894885	.	G	A	0	3	3	0	5	8	0	0
11	15910604	.	G	C	2	2	4	0	0	4	0	0
11	15972599	.	T	C	3	2	5	0	0	5	0	0
11	15975556	.	C	T	1	3	4	0	0	4	0	0
11	16005711	.	C	T	3	6	9	0	0	9	0	0
11	16005862	.	G	A	0	2	2	0	0	2	0	0
11	16005883	.	G	T	0	3	3	0	0	3	0	0
11	16005985	.	A	T	2	6	8	0	0	8	0	0
11	16006246	.	A	T	1	4	5	0	0	5	0	0
11	16006249	.	T	C	1	5	6	0	0	6	0	0
11	16007461	.	A	G	2	3	5	0	0	5	0	0
11	16007462	.	A	G	3	2	5	0	0	5	0	0
11	16010502	.	A	G	1	0	1	0	4	5	0	0
11	16010656	.	T	C	12	1	13	0	0	13	0	0
11	16010842	.	C	T	4	3	7	0	0	7	0	0
11	16010849	.	A	G	4	0	4	0	3	7	0	0
11	16010978	.	G	A	8	3	11	0	0	11	0	0
11	16010986	.	A	T	8	3	11	0	0	11	0	0
11	16011185	.	C	A	2	2	4	0	1	5	0	0
11	16011622	.	T	C	7	7	14	0	0	14	0	0
11	16011632	.	T	G	6	0	6	0	7	13	0	0
11	16011705	.	T	C	9	7	16	0	2	18	0	0
11	16011745	.	C	G	11	10	21	0	1	22	0	0
11	16011770	.	T	C	14	18	32	0	1	33	0	0
11	16011807	.	T	C	9	15	24	0	1	25	0	0
11	16011895	.	A	C	9	4	13	0	0	14	1	0
11	16012021	.	G	A	7	8	15	0	1	16	0	0
11	16012117	.	G	T	0	15	15	0	15	30	0	0
11	16012140	.	G	A	0	14	14	0	16	30	0	0
11	16012152	.	A	G	14	0	14	0	16	30	0	0
11	16012191	.	C	T	11	17	28	0	1	29	0	0
11	16012201	.	C	T	12	15	27	0	0	27	0	0
11	16012251	.	T	A	6	12	18	0	0	18	0	0
11	16012256	.	C	T	6	12	18	0	0	18	0	0
11	16012316	.	T	G	4	8	12	0	0	12	0	0
11	16012364	.	G	T	0	6	6	0	6	12	0	0
11	16012414	.	T	C	4	5	9	0	0	9	0	0
11	16012508	.	A	C	7	7	14	0	1	15	0	0
11	16012512	.	C	T	5	8	13	0	1	14	0	0
11	16012654	.	A	G	8	1	9	0	11	20	0	0
11	16012785	.	T	G	10	15	25	0	1	26	0	0
11	16012786	.	A	G	9	16	25	0	1	26	0	0
11	16012829	.	G	T	11	15	26	0	1	27	0	0
11	16012882	.	G	A	10	10	20	0	0	20	0	0
11	16013018	.	T	C	6	11	17	0	0	17	0	0
11	16013036	.	T	A	2	4	6	0	2	8	0	0
11	16099700	.	G	A	1	0	1	0	0	1	0	0
11	16104175	.	T	C	5	7	12	0	0	12	0	0
11	16115692	.	C	T	7	8	15	0	0	15	0	0
11	16143781	.	T	C	15	23	38	0	3	41	0	0
11	16143829	.	T	C	15	22	37	0	1	38	0	0
11	16153290	.	C	T	9	5	14	0	1	15	0	0
11	16158555	.	G	A	6	12	18	0	1	19	0	0
11	16159056	.	A	G	3	3	6	0	0	6	0	0
11	16159316	.	C	T	4	2	6	0	0	6	0	0
11	16159875	.	T	C	2	1	3	0	0	3	0	0
11	16159903	.	C	T	6	3	9	0	0	9	0	0
11	16160137	.	A	G	4	0	4	0	4	8	0	0
11	16165293	.	T	C	8	10	18	0	1	19	0	0
11	16165298	.	G	A	0	8	8	0	10	18	0	0
11	16165605	.	T	A	10	8	18	0	0	18	0	0
11	16165665	.	A	G	17	10	27	1	0	28	0	0
11	16165710	.	T	A	10	6	16	0	2	18	0	0
11	16166137	.	C	G	0	2	2	0	0	2	0	0
11	16179136	.	A	T	2	3	5	0	0	5	0	0
11	16180033	.	G	A	32	24	56	0	3	59	0	0
11	16184739	.	A	G	12	9	21	0	0	21	0	0
11	16184865	.	A	T	8	12	20	0	0	20	0	0
11	16237915	.	C	G	3	3	6	0	0	6	0	0
11	16585724	.	C	A	1	2	3	0	0	3	0	0
11	16586136	.	A	G	0	2	2	0	0	2	0	0
11	16586137	.	A	G	0	2	2	0	0	2	0	0
11	16586747	.	A	G	1	4	5	0	0	5	0	0
11	16587715	.	A	G	6	6	12	0	0	12	0	0
11	16738655	.	C	T	2	3	5	0	0	5	0	0
11	16739039	.	C	T	0	4	4	0	2	6	0	0
11	16849887	.	T	G	2	1	3	0	0	3	0	0
11	16849896	.	G	A	2	1	3	0	0	3	0	0
11	16849962	.	A	G	1	1	2	0	0	2	0	0
11	17511788	.	T	C	6	7	13	0	1	14	0	0
11	17511902	.	C	A	3	5	8	0	1	9	0	0
11	17511964	.	C	G	5	0	5	0	8	13	0	0
11	17512139	.	T	C	5	11	16	0	0	16	0	0
11	17512289	.	T	C	8	8	16	0	4	20	0	0
11	17513371	.	G	T	3	2	5	0	1	6	0	0
11	17513405	.	C	T	2	3	5	0	0	5	0	0
11	17513424	.	T	A	3	2	5	0	0	5	0	0
11	17513440	.	A	G	1	2	3	0	0	3	0	0
11	17597424	.	G	A	1	3	4	0	0	4	0	0
11	17713672	.	T	C	4	3	7	0	0	7	0	0
11	17757767	.	T	C	7	9	16	0	1	17	0	0
11	17757859	.	T	C	3	4	7	0	1	10	2	0
11	17758019	.	C	T	2	4	6	0	0	6	0	0
11	17758113	.	T	A	3	5	8	0	0	8	0	0
11	17763137	.	A	G	7	7	14	0	0	14	0	0
11	17763160	.	T	C	7	7	14	0	1	15	0	0
11	17763173	.	C	A	7	6	13	0	0	13	0	0
11	17763393	.	C	T	7	8	15	0	0	15	0	0
11	17765170	.	C	T	1	4	5	0	2	7	0	0
11	17765618	.	T	C	3	0	3	0	1	4	0	0
11	17769238	.	C	T	1	5	6	0	0	6	0	0
11	17769801	.	A	T	6	8	14	0	0	14	0	0
11	17770594	.	C	T	2	5	7	0	1	8	0	0
11	17770627	.	T	C	4	8	12	0	0	12	0	0
11	17771185	.	T	C	4	1	5	0	0	5	0	0
11	17771478	.	C	T	1	0	1	0	0	1	0	0
11	17774893	.	G	A	0	1	1	0	0	1	0	0
11	17774917	.	T	C	0	1	1	0	0	1	0	0
11	17778492	.	T	A	3	9	12	0	0	12	0	0
11	17778528	.	T	C	4	0	4	0	7	11	0	0
11	17778597	.	A	G	2	3	5	0	0	5	0	0
11	17778618	.	T	G	3	3	6	0	1	7	0	0
11	17778690	.	G	T	3	5	8	0	0	8	0	0
11	17778819	.	G	A	3	3	6	0	0	6	0	0
11	17778846	.	G	A	3	4	7	0	0	7	0	0
11	17778978	.	A	T	2	2	4	0	0	4	0	0
11	17779023	.	T	C	2	2	4	0	1	5	0	0
11	17779028	.	T	G	2	3	5	0	0	5	0	0
11	17779159	.	A	G	5	4	9	0	0	9	0	0
11	17779254	.	T	C	1	0	1	0	2	3	0	0
11	17779279	.	C	A	2	6	8	0	0	8	0	0
11	17779435	.	G	T	6	3	9	0	0	10	1	0
11	17779656	.	C	T	0	0	0	0	1	1	0	0
11	17782529	.	A	C	4	0	4	0	7	11	0	0
11	17782845	.	C	T	5	2	7	0	2	9	0	0
11	17782849	.	A	G	3	3	6	0	2	8	0	0
11	17785280	.	C	T	0	3	3	0	2	5	0	0
11	17785402	.	T	G	10	5	15	0	0	15	0	0
11	17785412	.	C	A	11	3	14	0	1	15	0	0
11	17785591	.	A	G	17	8	25	0	0	25	0	0
11	17789069	.	G	T	3	4	7	0	0	7	0	0
11	17789210	.	T	C	3	1	4	0	0	4	0	0
11	17792991	.	C	T	0	7	7	0	4	11	0	0
11	17793676	.	G	A	1	0	1	0	0	1	0	0
11	17797072	.	T	C	0	0	0	0	1	1	0	0
11	17797280	.	G	A	0	1	1	0	0	1	0	0
11	17984308	.	T	C	2	6	8	0	1	9	0	0
11	17984426	.	G	C	0	2	2	0	2	4	0	0
11	17984459	.	G	T	1	3	4	0	0	4	0	0
11	17987289	.	C	A	1	4	5	0	0	5	0	0
11	18223383	.	C	T	6	5	11	0	0	11	0	0
11	18238076	.	C	T	9	7	16	0	0	16	0	0
11	18244388	.	T	C	6	5	11	0	3	14	0	0
11	18277370	.	C	T	0	4	4	0	2	6	0	0
11	18277388	.	G	A	1	0	1	0	1	2	0	0
11	18283013	.	G	A	2	3	5	0	0	5	0	0
11	18283440	.	A	G	3	4	7	0	0	7	0	0
11	18283525	.	T	C	2	0	2	0	3	5	0	0
11	18287280	.	A	G	5	4	9	0	0	9	0	0
11	18287283	.	A	T	5	3	8	0	1	9	0	0
11	18287693	.	A	G	6	7	13	0	1	14	0	0
11	18287779	.	G	A	3	5	8	0	0	8	0	0
11	18288018	.	T	C	10	6	16	0	2	18	0	0
11	18288212	.	T	C	4	12	16	0	0	16	0	0
11	18289425	.	T	G	3	2	5	0	0	5	0	0
11	18290095	.	G	A	1	1	2	0	0	2	0	0
11	18291865	.	A	G	2	3	5	0	1	6	0	0
11	18292595	.	C	T	0	1	1	0	3	4	0	0
11	18292633	.	A	G	6	4	10	0	0	10	0	0
11	18292699	.	T	A	1	1	2	0	0	2	0	0
11	18293166	.	A	G	4	3	7	0	0	7	0	0
11	18297113	.	A	G	0	1	1	0	0	1	0	0
11	18299674	.	A	G	0	1	1	0	0	1	0	0
11	18304271	.	T	A	0	4	4	0	0	4	0	0
11	18315937	.	G	A	1	3	4	0	0	4	0	0
11	18315955	.	C	T	1	3	4	0	1	5	0	0
11	18345719	.	T	G	3	2	5	0	1	6	0	0
11	18345887	.	C	G	4	3	7	0	0	7	0	0
11	18347424	.	T	C	3	0	3	0	2	5	0	0
11	18397744	.	T	C	1	5	6	0	0	6	0	0
11	18398555	.	T	G	1	4	5	0	0	5	0	0
11	18398578	.	T	G	1	3	4	0	0	4	0	0
11	18535666	.	C	T	20	12	32	0	0	32	0	0
11	18535761	.	G	C	12	18	30	0	3	33	0	0
11	18537180	.	A	G	7	3	10	0	2	12	0	0
11	18537244	.	G	A	4	10	14	0	2	16	0	0
11	18537447	.	T	C	7	4	11	0	0	11	0	0
11	18537561	.	T	A	5	6	11	0	3	14	0	0
11	18537636	.	T	A	7	6	13	0	1	14	0	0
11	18538219	.	A	T	8	14	22	0	0	22	0	0
11	18538259	.	G	T	8	13	21	0	3	24	0	0
11	18538336	.	A	C	12	1	13	0	12	25	0	0
11	18538362	.	T	C	12	0	12	0	10	22	0	0
11	18541931	.	C	T	0	2	2	0	3	5	0	0
11	18542168	.	T	C	1	2	3	0	0	3	0	0
11	18543520	.	T	A	2	2	4	0	0	4	0	0
11	18543543	.	T	A	1	2	3	0	0	3	0	0
11	18543828	.	T	C	2	3	5	0	1	6	0	0
11	18543870	.	A	G	1	3	4	0	0	4	0	0
11	18546088	.	G	T	1	0	1	0	0	1	0	0
11	18546276	.	T	A	2	4	6	0	0	6	0	0
11	18547125	.	A	G	5	11	16	0	1	17	0	0
11	18551011	.	C	A	0	6	6	0	0	6	0	0
11	18551076	.	C	T	1	5	6	0	2	8	0	0
11	18551089	.	G	A	1	3	4	0	1	5	0	0
11	18551605	.	C	T	0	6	6	0	2	8	0	0
11	18568971	.	G	A	0	3	3	0	0	3	0	0
11	18572364	.	T	C	8	0	8	0	9	17	0	0
11	18572574	.	G	A	10	8	18	0	2	20	0	0
11	18572586	.	C	T	13	6	19	0	1	20	0	0
11	18572640	.	T	G	10	10	20	0	0	20	0	0
11	18572648	.	G	A	10	10	20	0	2	22	0	0
11	18572751	.	G	A	5	8	13	0	1	14	0	0
11	18575095	.	C	A	4	2	6	0	0	6	0	0
11	18575161	.	C	G	7	4	11	0	0	11	0	0
11	18575173	.	G	T	5	3	8	0	0	8	0	0
11	18575258	.	T	G	4	5	9	0	1	10	0	0
11	18575326	.	G	T	8	4	12	0	0	12	0	0
11	18577787	.	A	G	1	2	3	0	0	3	0	0
11	18579921	.	C	T	0	4	4	0	6	10	0	0
11	18580059	.	C	T	0	3	3	0	6	9	0	0
11	18592065	.	A	G	6	6	12	0	0	12	0	0
11	18665791	.	A	T	0	2	2	0	0	2	0	0
11	18677979	.	A	G	0	0	0	0	1	1	0	0
11	18678103	.	G	A	1	2	3	0	0	3	0	0
11	18678321	.	T	C	1	4	5	0	0	5	0	0
11	18681103	.	G	A	0	3	3	0	2	5	0	0
11	18682826	.	T	C	1	1	2	0	0	2	0	0
11	18697720	.	A	G	9	4	13	0	0	13	0	0
11	18697817	.	T	G	10	8	18	0	0	18	0	0
11	18697822	.	A	G	11	1	12	0	8	20	0	0
11	18698138	.	A	G	2	0	2	0	10	12	0	0
11	18698184	.	G	A	0	8	8	0	4	12	0	0
11	18698221	.	A	C	3	2	5	0	0	5	0	0
11	18698526	.	G	A	5	4	9	0	0	9	0	0
11	18699104	.	T	C	11	12	23	0	1	24	0	0
11	18704378	.	G	C	3	0	3	0	5	8	0	0
11	18704500	.	G	A	11	9	20	0	2	22	0	0
11	18704620	.	C	T	0	10	10	0	16	26	0	0
11	18705108	.	A	G	11	8	19	0	1	20	0	0
11	18784949	.	A	T	9	6	15	0	1	16	0	0
11	18785130	.	A	G	17	10	27	0	2	29	0	0
11	18785250	.	C	T	0	20	20	0	23	43	0	0
11	18785294	.	T	G	17	19	36	0	0	36	0	0
11	18785296	.	C	T	17	17	34	0	2	36	0	0
11	18785346	.	A	T	10	15	25	0	0	26	1	0
11	18785410	.	G	A	9	10	19	0	0	19	0	0
11	18785421	.	A	G	9	8	17	0	1	18	0	0
11	18785570	.	T	A	6	4	10	0	0	10	0	0
11	18785600	.	A	T	7	5	12	0	0	12	0	0
11	18785623	.	A	T	8	5	13	0	0	13	0	0
11	18785749	.	C	G	3	4	7	0	0	7	0	0
11	18785921	.	G	A	8	12	20	0	0	21	1	0
11	18785975	.	T	C	8	12	20	0	0	20	0	0
11	18785997	.	T	A	7	12	19	0	0	19	0	0
11	18786085	.	A	T	7	17	24	0	1	25	0	0
11	18786250	.	A	C	15	16	31	0	2	33	0	0
11	18786329	.	C	A	0	4	4	0	8	12	0	0
11	18794157	.	C	A	0	1	1	0	2	3	0	0
11	18799800	.	C	T	3	2	5	0	0	5	0	0
11	18802570	.	T	C	2	2	4	0	1	5	0	0
11	18802879	.	A	G	1	2	3	0	0	3	0	0
11	18803621	.	A	G	0	1	1	0	0	1	0	0
11	18810393	.	A	G	3	1	4	0	0	4	0	0
11	18814506	.	T	G	0	2	2	0	0	2	0	0
11	19041518	.	G	A	3	5	8	0	0	8	0	0
11	19041647	.	T	G	0	1	1	0	1	2	0	0
11	19042020	.	T	C	11	5	16	0	0	16	0	0
11	19042026	.	A	G	10	4	14	0	0	14	0	0
11	19068394	.	C	T	2	0	2	0	0	2	0	0
11	19072608	.	T	A	15	19	34	0	2	37	1	0
11	19072746	.	A	T	1	2	3	0	0	3	0	0
11	19084820	.	C	T	5	6	11	0	1	12	0	0
11	19089286	.	A	G	25	20	45	0	4	49	0	0
11	19089362	.	A	G	28	29	57	0	4	61	0	0
11	19089368	.	C	T	29	33	62	0	1	63	0	0
11	19089608	.	G	A	1	26	27	0	26	53	0	0
11	19089839	.	G	A	0	23	23	0	14	37	0	0
11	19090203	.	G	A	0	15	15	0	8	23	0	0
11	19434043	.	G	C	7	9	16	0	0	16	0	0
11	19434095	.	A	C	1	6	7	0	1	8	0	0
11	19434132	.	T	C	3	2	5	0	0	5	0	0
11	19434239	.	T	C	4	4	8	0	0	8	0	0
11	19434279	.	T	C	1	1	2	0	0	2	0	0
11	19434290	.	T	C	0	1	1	0	0	1	0	0
11	19462920	.	C	T	3	2	5	0	1	6	0	0
11	19462971	.	A	G	7	0	7	0	5	12	0	0
11	19464759	.	C	G	4	7	11	0	0	11	0	0
11	19464813	.	A	G	3	6	9	0	0	9	0	0
11	19465029	.	T	C	12	8	20	0	0	20	0	0
11	19465080	.	T	C	12	10	22	0	0	22	0	0
11	19465428	.	C	T	6	2	8	0	1	9	0	0
11	19467792	.	G	A	1	14	15	0	14	29	0	0
11	19467838	.	C	T	14	10	24	0	1	25	0	0
11	19468104	.	C	T	16	12	28	0	3	31	0	0
11	19468123	.	T	C	15	17	32	0	0	32	0	0
11	19468301	.	A	G	12	2	14	0	16	30	0	0
11	19468547	.	C	A	13	16	29	0	2	31	0	0
11	19468697	.	G	T	10	8	18	0	2	20	0	0
11	19468718	.	A	G	9	11	20	0	1	21	0	0
11	19502433	.	C	T	13	19	32	0	1	33	0	0
11	19502479	.	T	C	14	19	33	0	2	35	0	0
11	19503920	.	T	A	8	12	20	0	0	20	0	0
11	19506155	.	A	G	3	2	5	0	0	5	0	0
11	19506260	.	C	T	8	12	20	0	1	21	0	0
11	19509643	.	T	C	3	4	7	0	0	7	0	0
11	19511392	.	G	A	9	11	20	0	1	21	0	0
11	19511922	.	A	C	1	2	3	0	0	3	0	0
11	19511983	.	G	A	3	4	7	0	1	8	0	0
11	19512285	.	T	C	2	4	6	0	0	6	0	0
11	19512430	.	C	T	0	3	3	0	8	11	0	0
11	19512659	.	G	T	2	2	4	0	0	4	0	0
11	19513358	.	T	C	4	4	8	0	0	8	0	0
11	19513364	.	T	C	4	0	4	0	4	8	0	0
11	19513395	.	A	G	3	2	5	0	0	5	0	0
11	19514511	.	A	C	1	2	3	0	0	3	0	0
11	19514982	.	A	G	1	2	3	0	0	3	0	0
11	19515126	.	C	T	1	2	3	0	0	3	0	0
11	19515190	.	G	T	3	4	7	0	0	7	0	0
11	19515275	.	C	T	1	2	3	0	0	3	0	0
11	19515286	.	A	G	1	3	4	0	0	4	0	0
11	19522962	.	G	C	1	2	3	0	0	3	0	0
11	19523585	.	A	G	1	2	3	0	0	3	0	0
11	19604223	.	A	C	5	8	13	0	0	13	0	0
11	19626534	.	A	T	5	2	7	0	0	7	0	0
11	19626556	.	A	G	4	3	7	0	0	7	0	0
11	19626972	.	C	G	5	3	8	0	0	8	0	0
11	19626980	.	C	T	1	2	3	0	5	8	0	0
11	19632816	.	G	A	3	2	5	0	0	5	0	0
11	19729842	.	A	T	1	3	4	0	0	4	0	0
11	19733160	.	A	G	2	7	9	0	0	9	0	0
11	19733388	.	A	G	4	5	9	0	0	9	0	0
11	19951119	.	G	A	2	2	4	0	0	4	0	0
11	19999131	.	T	C	1	0	1	0	0	1	0	0
11	20017802	.	A	G	1	3	4	0	0	4	0	0
11	20371248	.	A	G	2	0	2	0	4	6	0	0
11	20657517	.	A	C	2	1	3	0	0	3	0	0
11	20657574	.	G	C	4	2	6	0	0	6	0	0
11	20657661	.	T	C	1	1	2	0	0	2	0	0
11	20979901	.	A	C	2	1	3	0	0	3	0	0
11	21158792	.	G	A	0	1	1	0	0	1	0	0
11	21173971	.	T	C	0	3	3	0	0	3	0	0
11	21217542	.	T	C	3	3	6	0	0	6	0	0
11	21217834	.	T	C	2	4	6	0	1	7	0	0
11	21217994	.	G	A	1	3	4	0	0	4	0	0
11	21259435	.	A	C	1	5	6	0	0	6	0	0
11	21259773	.	G	C	7	4	11	0	0	11	0	0
11	21260009	.	T	C	2	5	7	0	1	8	0	0
11	21260018	.	A	T	4	3	7	0	0	7	0	0
11	21260213	.	G	A	1	2	3	0	0	3	0	0
11	21260676	.	C	T	7	3	10	0	0	10	0	0
11	21262085	.	T	C	2	2	4	0	1	5	0	0
11	21278950	.	T	A	17	14	31	0	4	35	0	0
11	21279194	.	G	T	13	6	19	0	1	20	0	0
11	21279703	.	T	C	8	2	10	1	0	11	0	0
11	21279704	.	T	A	8	2	10	1	0	11	0	0
11	21280202	.	A	T	3	10	13	0	0	13	0	0
11	21280504	.	A	C	3	10	13	0	1	14	0	0
11	21280555	.	A	T	5	6	11	0	0	11	0	0
11	21280689	.	T	A	7	5	12	0	0	12	0	0
11	21280801	.	T	A	13	9	22	0	0	22	0	0
11	21280974	.	G	A	5	6	11	0	2	13	0	0
11	21281087	.	C	T	6	14	20	0	3	23	0	0
11	21281110	.	G	A	12	17	29	0	0	29	0	0
11	21281219	.	G	A	11	13	24	0	2	26	0	0
11	21281269	.	T	C	5	13	18	0	0	18	0	0
11	21281273	.	A	G	6	10	16	0	1	17	0	0
11	21281516	.	G	A	7	3	10	1	4	15	0	0
11	21281657	.	T	C	16	12	28	0	0	28	0	0
11	21281673	.	T	C	19	8	27	0	2	29	0	0
11	21281876	.	T	C	1	7	8	0	0	8	0	0
11	21281888	.	G	A	1	7	8	0	0	8	0	0
11	21281916	.	A	G	3	6	9	0	0	9	0	0
11	21281951	.	A	G	2	2	4	0	0	4	0	0
11	21282068	.	G	A	11	6	17	0	0	17	0	0
11	21282072	.	G	A	10	6	16	0	0	16	0	0
11	21282302	.	A	C	4	0	4	0	5	9	0	0
11	21282414	.	G	A	3	6	9	0	0	9	0	0
11	21282424	.	C	G	4	6	10	0	0	10	0	0
11	21282500	.	C	A	6	9	15	0	0	15	0	0
11	21282571	.	G	A	7	5	12	0	0	12	0	0
11	21282673	.	G	T	7	13	20	0	0	20	0	0
11	21282747	.	T	C	3	4	7	0	0	7	0	0
11	21282809	.	A	T	3	4	7	0	0	7	0	0
11	21282957	.	T	C	3	0	3	0	7	10	0	0
11	21283211	.	G	A	1	0	1	0	0	1	0	0
11	21284382	.	G	A	0	2	2	0	0	2	0	0
11	21284588	.	A	G	2	5	7	0	1	8	0	0
11	21284701	.	A	C	7	0	7	0	13	20	0	0
11	21284733	.	C	T	6	14	20	0	0	20	0	0
11	21323564	.	A	G	2	2	4	0	0	4	0	0
11	21352744	.	G	C	9	7	16	0	0	16	0	0
11	21352773	.	A	T	6	5	11	0	2	13	0	0
11	21363120	.	T	C	2	3	5	0	0	5	0	0
11	21363229	.	T	C	2	2	4	0	0	4	0	0
11	21363298	.	T	C	3	1	4	0	1	5	0	0
11	21363310	.	G	A	3	2	5	0	0	5	0	0
11	21363411	.	T	C	1	0	1	0	4	5	0	0
11	21407500	.	G	A	7	7	14	0	1	15	0	0
11	21407692	.	C	G	6	12	18	0	1	19	0	0
11	21407782	.	G	T	11	13	24	0	0	24	0	0
11	21409415	.	A	T	11	17	28	0	2	30	0	0
11	21409417	.	T	C	11	17	28	0	2	30	0	0
11	21427219	.	T	C	7	9	16	0	0	16	0	0
11	21583065	.	T	C	3	4	7	0	0	7	0	0
11	21593849	.	A	T	4	2	6	0	1	7	0	0
11	21593869	.	G	C	6	2	8	0	1	9	0	0
11	21594510	.	C	T	1	3	4	0	0	4	0	0
11	21595189	.	G	A	4	3	7	0	0	7	0	0
11	21595191	.	G	A	0	3	3	0	4	7	0	0
11	21595615	.	G	A	1	3	4	0	0	4	0	0
11	21596133	.	A	C	1	1	2	0	2	4	0	0
11	21596134	.	G	A	1	3	4	0	0	4	0	0
11	21596459	.	T	C	6	3	9	0	0	9	0	0
11	21596492	.	A	G	7	0	7	0	3	10	0	0
11	21596713	.	C	G	1	2	3	0	0	3	0	0
11	21596865	.	A	T	1	2	3	0	0	3	0	0
11	21596979	.	A	T	4	2	6	0	1	7	0	0
11	21596982	.	G	T	4	2	6	0	1	7	0	0
11	21597055	.	T	G	7	10	17	0	1	18	0	0
11	21597166	.	A	G	4	0	4	0	4	8	0	0
11	21597256	.	A	C	4	5	9	0	0	9	0	0
11	21597337	.	A	G	4	3	7	0	0	7	0	0
11	21597584	.	T	C	1	5	6	0	0	6	0	0
11	21597659	.	T	C	3	8	11	0	0	11	0	0
11	21597676	.	C	A	3	7	10	0	1	11	0	0
11	21597702	.	A	G	1	4	5	0	1	6	0	0
11	21597754	.	T	G	1	2	3	0	0	3	0	0
11	21597988	.	C	T	7	7	14	0	1	15	0	0
11	21598002	.	T	C	8	6	14	0	2	16	0	0
11	21598036	.	T	C	6	5	11	0	0	11	0	0
11	21598121	.	G	A	0	5	5	0	3	8	0	0
11	21962831	.	A	G	0	1	1	0	0	1	0	0
11	22091956	.	C	A	11	12	23	0	0	23	0	0
11	22092158	.	G	A	14	15	29	0	1	30	0	0
11	22092244	.	A	T	4	11	15	0	0	15	0	0
11	22092689	.	T	A	13	5	18	0	2	20	0	0
11	22092743	.	T	A	3	3	6	0	0	6	0	0
11	22093634	.	G	A	12	17	29	0	2	31	0	0
11	22093848	.	A	C	7	14	21	0	1	22	0	0
11	22094072	.	T	C	10	10	20	0	1	21	0	0
11	22363756	.	A	T	5	6	11	0	0	11	0	0
11	22363768	.	A	T	7	4	11	0	0	11	0	0
11	22363994	.	T	G	5	12	17	0	1	18	0	0
11	22364128	.	A	T	10	9	19	0	0	19	0	0
11	22364140	.	T	A	9	11	20	0	1	21	0	0
11	22364228	.	G	A	9	8	17	0	0	17	0	0
11	22364359	.	A	G	5	6	11	0	0	11	0	0
11	22364416	.	A	G	1	7	8	0	0	8	0	0
11	22364502	.	C	A	0	9	9	0	10	19	0	0
11	22364558	.	T	C	6	10	16	0	0	16	0	0
11	22366841	.	T	C	1	2	3	0	0	3	0	0
11	22367200	.	A	T	8	11	19	0	3	22	0	0
11	22367251	.	A	G	5	9	14	0	0	14	0	0
11	22369932	.	G	A	4	3	7	0	1	8	0	0
11	22369981	.	A	G	12	9	21	0	0	21	0	0
11	22369991	.	C	A	10	8	18	0	1	19	0	0
11	22371944	.	T	G	8	3	11	0	0	11	0	0
11	22374626	.	T	C	6	5	11	0	0	11	0	0
11	22375072	.	T	C	6	3	9	0	0	9	0	0
11	22495182	.	T	C	5	4	9	0	0	9	0	0
11	22521220	.	G	A	0	1	1	0	0	1	0	0
11	22582243	.	G	C	4	4	8	0	0	8	0	0
11	22582573	.	C	A	3	3	6	0	0	6	0	0
11	22582607	.	T	C	6	2	8	0	1	9	0	0
11	22582706	.	T	C	5	6	11	0	0	11	0	0
11	22582739	.	A	T	4	5	9	0	0	9	0	0
11	22582773	.	G	A	0	4	4	0	10	14	0	0
11	22582830	.	T	C	13	5	18	0	0	18	0	0
11	22582878	.	A	G	14	5	19	0	0	19	0	0
11	22582923	.	C	T	10	4	14	0	1	15	0	0
11	22583023	.	A	T	13	4	17	0	0	17	0	0
11	22583547	.	G	T	11	5	16	0	1	17	0	0
11	22583858	.	C	A	8	7	15	0	0	15	0	0
11	22583974	.	T	C	13	7	20	0	0	20	0	0
11	22583984	.	T	C	11	7	18	0	0	18	0	0
11	22584173	.	G	A	7	4	11	0	0	11	0	0
11	22584229	.	T	C	8	3	11	0	1	12	0	0
11	22584365	.	G	A	6	1	7	0	0	7	0	0
11	22584414	.	T	A	5	2	7	0	0	7	0	0
11	22584417	.	A	C	5	3	8	0	0	8	0	0
11	22623334	.	T	A	3	4	7	0	0	7	0	0
11	22623502	.	T	G	1	2	3	0	0	3	0	0
11	22624550	.	A	G	1	3	4	0	0	4	0	0
11	22629148	.	C	A	5	2	7	0	0	7	0	0
11	22629970	.	G	A	2	2	4	0	1	5	0	0
11	22629980	.	T	A	1	3	4	0	0	4	0	0
11	22630020	.	A	T	2	2	4	0	1	5	0	0
11	22630190	.	T	A	2	3	5	0	0	5	0	0
11	22891305	.	C	G	18	7	25	0	2	27	0	0
11	22891574	.	G	A	18	8	26	0	1	27	0	0
11	22891575	.	T	C	17	0	17	0	10	27	0	0
11	22891624	.	C	T	7	9	16	0	5	21	0	0
11	22891683	.	G	A	18	13	31	0	1	32	0	0
11	22891692	.	C	T	1	14	15	0	18	33	0	0
11	22892028	.	C	T	11	12	23	0	3	26	0	0
11	22892205	.	A	G	21	16	37	0	2	39	0	0
11	22892345	.	C	A	1	9	10	0	8	18	0	0
11	22892395	.	G	A	13	11	24	0	0	24	0	0
11	22892432	.	C	T	12	11	23	0	2	25	0	0
11	22892534	.	G	A	17	12	29	0	1	30	0	0
11	22892573	.	G	A	14	14	28	0	0	28	0	0
11	22892859	.	A	T	16	11	27	0	3	30	0	0
11	22906133	.	T	G	9	8	17	0	1	18	0	0
11	22906383	.	T	C	4	1	5	1	0	6	0	0
11	22911841	.	C	G	6	4	10	0	1	11	0	0
11	22920796	.	T	A	15	22	37	0	0	37	0	0
11	22921124	.	G	T	32	20	52	0	3	56	1	0
11	22921168	.	C	T	28	23	51	0	1	52	0	0
11	22921326	.	G	A	15	19	34	0	2	36	0	0
11	22921568	.	G	C	30	26	56	0	1	57	0	0
11	22921800	.	T	G	19	27	46	0	0	46	0	0
11	22921865	.	T	C	29	3	32	0	17	49	0	0
11	22921953	.	C	T	20	19	39	0	2	41	0	0
11	22922075	.	A	G	21	27	48	0	1	49	0	0
11	22922114	.	A	T	18	26	44	0	3	47	0	0
11	22922115	.	A	T	17	28	45	0	2	47	0	0
11	22922251	.	C	T	26	18	44	0	3	47	0	0
11	22922266	.	A	G	24	17	41	0	1	42	0	0
11	22922290	.	A	G	22	18	40	0	2	42	0	0
11	22922309	.	T	A	20	20	40	0	2	42	0	0
11	22922333	.	A	T	19	20	39	0	0	39	0	0
11	22922355	.	A	T	17	22	39	0	2	41	0	0
11	22922405	.	G	A	19	25	44	0	2	46	0	0
11	22922668	.	T	C	19	27	46	0	2	48	0	0
11	22922762	.	T	A	29	20	49	0	2	51	0	0
11	22922841	.	C	A	27	10	37	0	0	37	0	0
11	22922909	.	A	T	23	9	32	0	1	33	0	0
11	22923397	.	A	T	25	23	48	0	3	51	0	0
11	22923485	.	G	T	23	28	51	0	2	53	0	0
11	22923613	.	T	C	26	1	27	0	24	51	0	0
11	22924449	.	C	T	11	6	17	0	0	17	0	0
11	22924505	.	A	C	11	8	19	0	0	20	1	0
11	22924650	.	A	C	13	10	23	0	0	23	0	0
11	22924746	.	C	T	0	13	13	0	5	18	0	0
11	22925048	.	G	A	6	10	16	0	1	17	0	0
11	22925266	.	G	A	20	17	37	0	3	40	0	0
11	22925370	.	A	G	26	17	43	0	0	43	0	0
11	22926213	.	A	C	11	0	11	0	13	24	0	0
11	22950984	.	C	T	25	11	36	0	2	38	0	0
11	22964006	.	G	T	8	8	16	0	1	17	0	0
11	22969056	.	T	C	13	0	13	0	14	27	0	0
11	22969098	.	C	G	8	9	17	0	2	19	0	0
11	22983958	.	A	T	8	6	14	0	0	14	0	0
11	22983965	.	C	G	0	5	5	0	6	11	0	0
11	22984008	.	G	A	0	1	1	0	0	1	0	0
11	22995813	.	A	G	0	4	4	0	0	4	0	0
11	23080447	.	C	T	0	9	9	0	0	9	0	0
11	23312451	.	T	A	1	2	3	0	0	3	0	0
11	23312543	.	G	A	1	3	4	0	0	4	0	0
11	23313911	.	G	A	2	2	4	0	0	4	0	0
11	23313928	.	T	C	2	2	4	0	0	4	0	0
11	23343154	.	A	G	7	4	11	0	0	11	0	0
11	23343231	.	G	A	4	11	15	0	1	16	0	0
11	23343594	.	T	A	8	9	17	0	0	17	0	0
11	23343775	.	A	G	8	7	15	0	1	16	0	0
11	23344143	.	C	A	12	6	18	0	0	18	0	0
11	23344421	.	G	C	6	12	18	0	1	19	0	0
11	23344790	.	T	A	11	10	21	0	1	22	0	0
11	23353706	.	C	T	0	1	1	0	1	2	0	0
11	23377379	.	A	G	4	4	8	0	0	8	0	0
11	23377538	.	G	T	4	3	7	0	0	7	0	0
11	23595538	.	G	T	3	4	7	0	0	8	1	0
11	23595627	.	C	T	8	7	15	0	0	15	0	0
11	23595766	.	C	A	8	8	16	0	0	16	0	0
11	23596240	.	A	G	12	6	18	0	0	18	0	0
11	23596264	.	G	T	10	6	16	0	4	20	0	0
11	23596333	.	T	C	10	4	14	0	0	14	0	0
11	23596725	.	T	C	7	4	11	0	1	12	0	0
11	23596732	.	A	T	9	4	13	0	0	13	0	0
11	23597047	.	G	A	2	3	5	0	0	5	0	0
11	23597310	.	A	G	7	8	15	0	0	15	0	0
11	23597589	.	C	T	0	2	2	0	1	3	0	0
11	23604954	.	A	G	1	4	5	0	0	5	0	0
11	23607048	.	G	C	0	1	1	0	0	1	0	0
11	23659051	.	G	A	3	1	4	0	2	6	0	0
11	23682048	.	C	A	1	4	5	0	0	5	0	0
11	23825607	.	C	T	1	2	3	0	0	3	0	0
11	23825610	.	T	C	1	2	3	0	0	3	0	0
11	23826524	.	C	T	1	1	2	0	0	2	0	0
11	23828197	.	G	C	0	3	3	0	0	3	0	0
11	23828245	.	A	G	2	4	6	0	1	7	0	0
11	23834884	.	A	G	0	1	1	0	0	1	0	0
11	23842789	.	A	G	2	1	3	0	0	3	0	0
11	23843015	.	C	T	1	1	2	0	0	2	0	0
11	23843072	.	T	A	3	3	6	0	0	6	0	0
11	23843117	.	A	T	4	8	12	0	0	12	0	0
11	23843180	.	G	A	3	4	7	0	0	7	0	0
11	23843362	.	A	G	1	2	3	0	0	3	0	0
11	23845323	.	C	T	1	2	3	0	1	4	0	0
11	23845329	.	C	A	1	0	1	0	0	1	0	0
11	23856440	.	A	G	1	5	6	0	1	7	0	0
11	23879654	.	C	A	13	15	28	0	0	28	0	0
11	23879825	.	A	T	8	6	14	0	1	15	0	0
11	23879938	.	C	T	13	10	23	0	0	23	0	0
11	23880084	.	T	C	8	10	18	0	0	18	0	0
11	23880476	.	T	G	6	5	11	0	1	12	0	0
11	23880486	.	G	T	5	5	10	0	1	11	0	0
11	23880607	.	C	T	0	11	11	0	1	12	0	0
11	23880631	.	G	T	1	14	15	0	1	16	0	0
11	23881038	.	C	A	5	3	8	0	0	8	0	0
11	23881070	.	C	T	6	3	9	0	0	9	0	0
11	23881101	.	G	A	7	3	10	0	0	10	0	0
11	23882438	.	A	G	7	7	14	0	3	17	0	0
11	23882525	.	T	C	10	11	21	0	2	23	0	0
11	23882572	.	A	T	8	15	23	0	1	24	0	0
11	23882646	.	A	T	16	17	33	0	1	34	0	0
11	23882655	.	C	T	13	16	29	0	1	30	0	0
11	23882747	.	C	T	17	10	27	0	1	28	0	0
11	23882748	.	C	T	15	9	24	0	4	28	0	0
11	23882836	.	A	G	7	12	19	0	3	22	0	0
11	23883302	.	G	A	2	10	12	0	0	12	0	0
11	23883699	.	A	T	9	9	18	0	0	18	0	0
11	23884416	.	G	A	25	19	44	0	1	45	0	0
11	23884419	.	T	A	21	24	45	0	0	45	0	0
11	23884742	.	G	A	13	9	22	0	0	22	0	0
11	23884805	.	A	C	0	3	3	0	0	3	0	0
11	23933059	.	C	T	2	5	7	0	1	8	0	0
11	23957496	.	A	G	0	0	0	0	1	1	0	0
11	23970126	.	G	A	4	2	6	0	0	6	0	0
11	23976169	.	C	T	6	9	15	0	0	15	0	0
11	24035841	.	G	T	0	2	2	0	4	6	0	0
11	24036035	.	C	T	2	2	4	0	0	4	0	0
11	24038795	.	T	G	1	1	2	0	0	2	0	0
11	24039086	.	A	G	11	10	21	0	0	21	0	0
11	24039241	.	A	G	15	0	15	0	12	27	0	0
11	24039246	.	T	G	13	12	25	0	2	27	0	0
11	24039728	.	G	A	8	14	22	0	0	22	0	0
11	24039732	.	C	T	8	13	21	0	2	23	0	0
11	24039773	.	A	C	8	14	22	0	0	22	0	0
11	24039791	.	A	C	11	13	24	0	0	24	0	0
11	24039912	.	T	C	17	12	29	0	0	29	0	0
11	24039949	.	C	A	10	15	25	0	0	25	0	0
11	24043500	.	C	T	8	5	13	0	0	14	1	0
11	24044318	.	G	T	15	9	24	0	0	24	0	0
11	24044351	.	C	T	11	4	15	0	2	17	0	0
11	24044413	.	T	A	6	9	15	0	0	15	0	0
11	24046235	.	C	T	6	7	13	0	0	13	0	0
11	24050607	.	G	A	4	2	6	0	0	6	0	0
11	24054363	.	G	T	6	3	9	0	1	10	0	0
11	24054807	.	C	A	7	4	11	0	1	12	0	0
11	24055699	.	A	T	6	9	15	0	1	16	0	0
11	24055884	.	A	G	6	0	6	0	8	14	0	0
11	24056205	.	C	T	13	19	32	0	1	33	0	0
11	24056377	.	G	C	17	13	30	0	4	34	0	0
11	24058749	.	G	A	10	7	17	0	0	17	0	0
11	24058963	.	G	A	5	6	11	0	0	11	0	0
11	24059236	.	T	A	2	5	7	0	0	7	0	0
11	24059268	.	G	A	2	2	4	0	1	5	0	0
11	24059476	.	A	T	3	4	7	0	0	7	0	0
11	24059873	.	A	T	2	4	6	0	1	7	0	0
11	24059963	.	G	A	5	2	7	0	0	7	0	0
11	24060014	.	C	G	3	1	4	0	0	4	0	0
11	24187748	.	A	G	5	3	8	0	0	8	0	0
11	24188088	.	G	T	10	4	14	0	1	15	0	0
11	24188221	.	C	T	0	7	7	0	2	9	0	0
11	24188227	.	G	T	6	2	8	0	1	9	0	0
11	24188385	.	T	A	5	6	11	0	0	11	0	0
11	24188436	.	T	A	7	4	11	0	1	12	0	0
11	24188437	.	G	T	8	4	12	0	0	12	0	0
11	24188884	.	C	T	0	8	8	0	3	11	0	0
11	24189765	.	G	A	5	5	10	0	0	10	0	0
11	24189786	.	C	T	0	7	7	0	3	10	0	0
11	24189811	.	G	C	4	2	6	0	1	7	0	0
11	24190606	.	C	T	3	4	7	0	0	7	0	0
11	24190821	.	G	A	4	3	7	0	0	7	0	0
11	24190989	.	A	T	1	4	5	0	0	5	0	0
11	24340745	.	T	A	2	6	8	0	0	8	0	0
11	24340931	.	G	A	3	6	9	0	0	9	0	0
11	24343537	.	T	C	2	2	4	0	0	4	0	0
11	24344983	.	T	G	12	17	29	0	0	29	0	0
11	24348553	.	C	G	1	7	8	0	1	9	0	0
11	24349265	.	A	C	1	0	1	0	0	1	0	0
11	24360891	.	C	G	4	7	11	0	0	11	0	0
11	24360924	.	A	G	9	7	16	0	0	16	0	0
11	24361207	.	T	G	6	2	8	0	0	8	0	0
11	24369586	.	A	G	4	4	8	0	0	8	0	0
11	24369652	.	G	A	4	4	8	0	0	8	0	0
11	24379360	.	C	T	2	2	4	0	0	4	0	0
11	24379384	.	G	A	2	2	4	0	1	5	0	0
11	24382547	.	C	T	0	2	2	0	0	2	0	0
11	24471330	.	T	C	0	2	2	0	1	3	0	0
11	24471518	.	C	T	0	10	10	0	3	13	0	0
11	24472065	.	A	G	2	2	4	0	2	6	0	0
11	24472145	.	T	A	2	3	5	0	0	5	0	0
11	24472176	.	A	G	1	1	2	0	0	2	0	0
11	24474384	.	G	A	1	4	5	0	0	5	0	0
11	24474483	.	A	C	4	2	6	0	0	6	0	0
11	24476587	.	C	T	4	3	7	0	2	9	0	0
11	24478940	.	G	A	0	1	1	0	0	1	0	0
11	24480781	.	C	T	1	3	4	0	0	4	0	0
11	24481382	.	G	A	1	2	3	0	0	3	0	0
11	24643337	.	T	G	4	1	5	0	0	5	0	0
11	24658335	.	T	C	0	1	1	0	0	1	0	0
11	24658606	.	G	A	0	13	13	0	4	17	0	0
11	24662794	.	A	G	4	0	4	0	7	11	0	0
11	24662830	.	T	A	6	4	10	0	1	11	0	0
11	24662898	.	C	A	5	6	11	0	0	11	0	0
11	24663768	.	G	A	4	4	8	0	0	8	0	0
11	24663808	.	T	C	7	7	14	0	1	15	0	0
11	24672292	.	C	T	1	4	5	0	0	5	0	0
11	24759130	.	T	A	1	3	4	0	0	4	0	0
11	24774976	.	G	C	0	2	2	0	1	3	0	0
11	24782271	.	G	A	0	2	2	0	1	3	0	0
11	24786415	.	G	A	0	2	2	0	1	3	0	0
11	24786466	.	T	A	1	0	1	0	0	1	0	0
11	24789357	.	C	G	4	8	12	0	0	12	0	0
11	24792102	.	T	A	3	3	6	0	1	7	0	0
11	24792201	.	G	A	1	2	3	0	0	3	0	0
11	24796820	.	T	G	2	0	2	0	0	2	0	0
11	24799378	.	G	A	7	10	17	0	1	18	0	0
11	24799408	.	G	A	0	12	12	0	8	20	0	0
11	24799433	.	T	G	7	7	14	0	0	14	0	0
11	24799495	.	T	A	3	3	6	0	1	7	0	0
11	24804565	.	A	T	1	1	2	0	0	2	0	0
11	24805106	.	A	C	3	4	7	0	1	8	0	0
11	24807966	.	A	G	1	0	1	0	0	1	0	0
11	24809738	.	C	T	14	24	38	0	1	39	0	0
11	24810510	.	C	A	7	3	10	0	0	10	0	0
11	24813651	.	G	A	14	12	26	0	2	28	0	0
11	24813810	.	A	G	20	15	35	0	0	35	0	0
11	24814014	.	A	G	18	9	27	0	0	27	0	0
11	24814110	.	G	T	22	18	40	0	3	43	0	0
11	24814564	.	C	G	1	3	4	0	0	4	0	0
11	24816648	.	G	A	3	6	9	0	0	9	0	0
11	24817054	.	T	A	6	12	18	0	0	18	0	0
11	24817198	.	G	A	3	2	5	0	0	5	0	0
11	24817352	.	G	T	3	4	7	0	0	7	0	0
11	24819457	.	G	T	1	3	4	0	0	4	0	0
11	24819667	.	C	T	6	10	16	0	0	16	0	0
11	24823323	.	G	A	0	5	5	0	5	10	0	0
11	24825549	.	C	T	1	2	3	0	0	3	0	0
11	24825583	.	G	A	1	2	3	0	0	3	0	0
11	24825598	.	C	T	2	1	3	0	0	3	0	0
11	24831674	.	T	C	6	2	8	0	0	8	0	0
11	24833382	.	G	A	6	10	16	0	0	16	0	0
11	24835762	.	A	C	4	3	7	0	2	9	0	0
11	24835764	.	A	G	5	3	8	0	1	9	0	0
11	24836409	.	C	T	5	7	12	0	0	12	0	0
11	24843031	.	C	A	7	7	14	0	1	15	0	0
11	24843058	.	G	A	0	10	10	0	4	14	0	0
11	24843079	.	A	G	4	1	5	0	9	14	0	0
11	24843154	.	G	A	0	4	4	0	2	6	0	0
11	24843219	.	C	T	5	7	12	0	0	12	0	0
11	24848221	.	T	A	6	4	10	0	0	10	0	0
11	24848409	.	G	T	2	4	6	0	0	6	0	0
11	24850428	.	A	G	2	2	4	0	0	4	0	0
11	24851182	.	A	T	3	5	8	0	0	8	0	0
11	24851804	.	T	C	2	2	4	0	2	6	0	0
11	24862554	.	C	T	2	0	2	0	0	2	0	0
11	24865281	.	A	G	3	3	6	0	1	7	0	0
11	24865602	.	T	A	2	2	4	0	0	4	0	0
11	24869046	.	G	A	5	3	8	0	0	8	0	0
11	24874841	.	A	G	8	7	15	0	0	15	0	0
11	24874960	.	C	A	7	0	7	1	9	17	0	0
11	24875331	.	T	C	7	11	18	0	1	19	0	0
11	24875382	.	G	C	6	6	12	0	0	12	0	0
11	24878011	.	C	T	4	8	12	0	0	12	0	0
11	24880785	.	T	C	4	8	12	0	0	12	0	0
11	24884840	.	G	C	12	10	22	0	0	22	0	0
11	24884967	.	C	T	11	14	25	0	1	26	0	0
11	24885282	.	T	C	7	5	12	0	0	12	0	0
11	24885332	.	C	T	4	3	7	0	0	7	0	0
11	24885357	.	A	T	3	2	5	0	0	5	0	0
11	24885734	.	T	C	2	3	5	0	0	5	0	0
11	24885738	.	A	G	2	3	5	0	0	5	0	0
11	24885901	.	A	T	3	7	10	0	0	10	0	0
11	24885928	.	C	T	3	9	12	0	0	12	0	0
11	24885937	.	C	T	5	9	14	0	0	14	0	0
11	24886152	.	C	A	7	23	30	0	0	30	0	0
11	24886420	.	T	A	7	3	10	0	0	10	0	0
11	24886438	.	T	G	3	2	5	0	0	5	0	0
11	24886499	.	T	A	4	5	9	0	0	9	0	0
11	24886602	.	G	T	0	8	8	0	3	11	0	0
11	24886672	.	T	C	7	12	19	0	1	20	0	0
11	24886686	.	G	T	13	6	19	0	0	19	0	0
11	24886739	.	G	T	13	12	25	0	1	26	0	0
11	24886754	.	G	A	14	11	25	0	1	26	0	0
11	24887321	.	T	C	31	9	40	0	2	42	0	0
11	24887501	.	C	T	16	13	29	0	0	29	0	0
11	24887703	.	C	T	7	6	13	0	1	14	0	0
11	24888272	.	C	T	12	9	21	0	0	21	0	0
11	24888379	.	C	A	19	15	34	0	0	34	0	0
11	24888560	.	A	T	6	5	11	0	2	13	0	0
11	24901897	.	C	T	8	7	15	0	0	15	0	0
11	24903143	.	G	T	3	13	16	0	1	17	0	0
11	24905477	.	C	T	23	18	41	0	0	41	0	0
11	24905526	.	G	T	15	12	27	0	1	28	0	0
11	24905541	.	C	T	17	8	25	0	1	26	0	0
11	24905574	.	G	A	20	9	29	0	0	29	0	0
11	24905576	.	C	A	20	9	29	0	0	29	0	0
11	24905632	.	T	G	19	21	40	0	0	40	0	0
11	24905692	.	G	A	1	19	20	0	23	43	0	0
11	24905742	.	C	T	26	11	37	0	0	37	0	0
11	24905748	.	A	G	22	11	33	0	3	36	0	0
11	24905877	.	A	G	15	8	23	0	1	24	0	0
11	24905901	.	C	T	18	2	20	0	2	22	0	0
11	24906177	.	G	T	7	12	19	0	2	21	0	0
11	24906178	.	G	A	6	14	20	0	1	21	0	0
11	24966841	.	G	A	1	3	4	0	0	4	0	0
11	24966928	.	A	G	1	0	1	0	2	3	0	0
11	24972396	.	G	A	0	5	5	0	3	8	0	0
11	24973655	.	T	C	2	1	3	0	0	3	0	0
11	24975714	.	C	T	0	2	2	0	1	3	0	0
11	24975855	.	C	T	1	2	3	0	0	3	0	0
11	24980631	.	C	A	0	6	6	0	0	6	0	0
11	24980684	.	C	T	4	2	6	0	0	6	0	0
11	24980714	.	A	C	3	4	7	0	0	7	0	0
11	24981190	.	A	T	1	3	4	0	1	5	0	0
11	24987226	.	C	T	1	2	3	0	1	4	0	0
11	24992298	.	A	G	8	3	11	0	0	11	0	0
11	24992445	.	T	A	9	12	21	0	0	21	0	0
11	24992522	.	T	G	5	2	7	0	4	11	0	0
11	24992539	.	G	C	5	5	10	0	2	12	0	0
11	24992899	.	C	A	7	7	14	0	1	15	0	0
11	24992928	.	G	A	5	6	11	0	0	11	0	0
11	24994833	.	A	C	6	5	11	0	0	11	0	0
11	25010619	.	A	C	4	7	11	0	1	12	0	0
11	25010873	.	A	G	3	0	3	0	14	17	0	0
11	25025783	.	T	G	9	10	19	0	1	20	0	0
11	25026004	.	C	G	4	5	9	0	0	9	0	0
11	25026437	.	A	G	7	16	23	0	0	23	0	0
11	25026450	.	A	T	8	15	23	0	1	24	0	0
11	25031086	.	T	A	1	1	2	0	0	2	0	0
11	25031272	.	A	C	10	16	26	0	1	27	0	0
11	25031362	.	C	T	8	12	20	0	1	21	0	0
11	25031497	.	A	T	20	8	28	0	1	29	0	0
11	25031527	.	G	A	9	19	28	0	0	28	0	0
11	25035439	.	C	T	1	1	2	0	0	2	0	0
11	25036942	.	C	T	13	6	19	0	1	20	0	0
11	25037017	.	C	T	6	8	14	0	1	15	0	0
11	25038572	.	T	C	1	0	1	0	0	1	0	0
11	25038625	.	G	C	11	13	24	0	0	24	0	0
11	25038652	.	G	A	1	11	12	0	17	29	0	0
11	25040808	.	A	T	11	8	19	0	2	21	0	0
11	25041204	.	C	T	9	7	16	0	1	17	0	0
11	25041607	.	G	C	1	23	24	0	17	41	0	0
11	25053236	.	C	T	3	0	3	0	0	3	0	0
11	25053820	.	G	A	2	4	6	0	0	6	0	0
11	25059082	.	G	T	4	2	6	0	0	6	0	0
11	25059156	.	T	A	3	3	6	0	0	6	0	0
11	25063080	.	G	A	1	6	7	0	0	7	0	0
11	25063103	.	G	A	2	3	5	0	1	6	0	0
11	25063120	.	T	G	2	3	5	0	1	6	0	0
11	25063291	.	A	T	4	3	7	0	0	7	0	0
11	25063293	.	T	C	3	3	6	0	1	7	0	0
11	25064623	.	C	G	9	6	15	0	0	15	0	0
11	25129232	.	C	G	12	0	12	0	9	21	0	0
11	25138485	.	A	C	23	28	51	0	11	62	0	0
11	25138656	.	T	C	18	29	47	0	6	53	0	0
11	25138673	.	T	A	11	30	41	0	2	43	0	0
11	25138845	.	C	T	33	40	73	0	2	75	0	0
11	25139000	.	G	C	19	23	42	0	2	45	1	0
11	25166824	.	G	A	2	2	4	0	1	5	0	0
11	25167856	.	T	C	4	3	7	0	0	7	0	0
11	25167980	.	G	A	2	0	2	0	0	2	0	0
11	25169680	.	G	A	0	1	1	0	0	1	0	0
11	25169704	.	T	C	2	1	3	0	0	3	0	0
11	25169749	.	G	A	0	2	2	0	3	5	0	0
11	25173328	.	T	C	2	2	4	0	0	4	0	0
11	25173348	.	G	A	1	0	1	0	0	1	0	0
11	25178862	.	C	T	9	5	14	0	0	14	0	0
11	25178865	.	T	A	8	5	13	0	0	13	0	0
11	25179014	.	C	T	7	4	11	0	1	12	0	0
11	25179057	.	A	C	8	2	10	0	1	11	0	0
11	25179069	.	A	G	3	8	11	0	0	11	0	0
11	25179099	.	C	T	5	4	9	0	0	9	0	0
11	25179365	.	G	T	0	3	3	0	2	5	0	0
11	25179430	.	T	A	4	4	8	0	0	8	0	0
11	25179641	.	C	T	9	5	14	0	1	15	0	0
11	25180225	.	C	T	7	4	11	0	1	12	0	0
11	25180243	.	A	G	6	3	9	0	0	9	0	0
11	25260187	.	C	T	5	11	16	0	1	17	0	0
11	25261660	.	T	A	3	4	7	0	1	8	0	0
11	25265777	.	G	A	0	2	2	0	0	2	0	0
11	25265950	.	T	C	8	14	22	0	1	23	0	0
11	25302183	.	C	T	2	0	2	0	0	2	0	0
11	25303803	.	C	T	5	10	15	0	1	16	0	0
11	25303887	.	T	C	6	10	16	0	0	16	0	0
11	25307345	.	T	C	1	3	4	0	0	4	0	0
11	25310329	.	G	C	8	13	21	0	2	23	0	0
11	25310777	.	T	G	6	8	14	0	2	16	0	0
11	25310859	.	A	T	8	12	20	0	1	21	0	0
11	25314551	.	G	A	6	4	10	0	1	11	0	0
11	25314910	.	C	T	6	5	11	0	0	11	0	0
11	25317875	.	G	A	4	2	6	0	0	6	0	0
11	25403825	.	A	G	2	2	4	0	0	4	0	0
11	25403830	.	A	T	2	2	4	0	0	4	0	0
11	25405613	.	T	C	3	2	5	0	0	5	0	0
11	25405655	.	T	C	3	3	6	0	0	6	0	0
11	25405901	.	C	T	5	2	7	0	0	7	0	0
11	25405910	.	C	T	2	5	7	0	0	7	0	0
11	25406186	.	T	C	3	4	7	0	0	7	0	0
11	25406343	.	A	G	10	5	15	0	1	16	0	0
11	25406366	.	T	G	7	0	7	0	4	11	0	0
11	25406381	.	C	T	4	3	7	0	1	8	0	0
11	25406534	.	C	T	5	3	8	0	0	8	0	0
11	25407014	.	G	A	1	7	8	0	1	9	0	0
11	25407380	.	C	T	6	5	11	0	0	11	0	0
11	25407626	.	T	C	7	5	12	0	2	14	0	0
11	25407987	.	A	T	4	5	9	0	1	10	0	0
11	25408139	.	C	T	12	14	26	0	1	27	0	0
11	25408283	.	C	G	8	5	13	0	0	13	0	0
11	25408352	.	T	C	4	4	8	0	0	8	0	0
11	25436961	.	T	A	10	9	19	0	0	19	0	0
11	25437080	.	C	T	12	9	21	0	1	22	0	0
11	25437299	.	C	T	14	16	30	0	0	30	0	0
11	25437417	.	C	T	10	14	24	0	0	24	0	0
11	25437684	.	G	A	3	4	7	0	0	7	0	0
11	25437866	.	T	G	11	6	17	0	0	17	0	0
11	25437901	.	G	A	8	4	12	0	1	13	0	0
11	25439860	.	G	T	6	5	11	0	0	11	0	0
11	25440511	.	G	A	3	2	5	0	1	6	0	0
11	25440649	.	G	C	1	0	1	0	2	3	0	0
11	25441979	.	T	A	2	3	5	0	0	5	0	0
11	25442057	.	A	C	6	0	6	0	3	9	0	0
11	25442096	.	C	T	3	6	9	0	1	10	0	0
11	25442147	.	G	T	2	4	6	0	0	6	0	0
11	25442313	.	A	G	4	4	8	0	0	8	0	0
11	25442424	.	A	G	9	5	14	0	0	14	0	0
11	25442457	.	G	T	5	3	8	0	0	8	0	0
11	25447276	.	A	G	5	4	9	0	2	11	0	0
11	25447279	.	T	C	2	0	2	0	9	11	0	0
11	25449437	.	T	A	2	6	8	0	1	9	0	0
11	25449899	.	C	T	0	2	2	0	2	4	0	0
11	25450113	.	G	A	1	1	2	0	0	2	0	0
11	25450155	.	T	C	2	4	6	0	1	7	0	0
11	25453201	.	C	T	0	1	1	0	0	1	0	0
11	25453344	.	G	T	1	3	4	0	0	4	0	0
11	25459346	.	C	A	0	2	2	0	4	6	0	0
11	25540580	.	G	C	3	2	5	0	0	5	0	0
11	25540583	.	G	A	0	2	2	0	3	5	0	0
11	25542320	.	A	T	6	3	9	0	1	10	0	0
11	25542906	.	A	G	1	3	4	0	0	4	0	0
11	25548007	.	G	A	5	2	7	0	0	7	0	0
11	25548043	.	G	T	0	4	4	0	7	11	0	0
11	25570711	.	A	C	2	3	5	0	0	5	0	0
11	25573888	.	T	A	0	1	1	0	0	1	0	0
11	25573921	.	T	A	1	3	4	0	0	4	0	0
11	25575139	.	A	G	5	7	12	0	0	12	0	0
11	25575365	.	C	T	4	3	7	0	1	8	0	0
11	25575725	.	A	T	3	5	8	0	1	9	0	0
11	25575872	.	A	G	7	1	8	0	5	13	0	0
11	25617944	.	A	G	10	9	19	0	2	21	0	0
11	25618218	.	C	T	11	4	15	0	0	15	0	0
11	25618353	.	T	A	2	9	11	0	0	11	0	0
11	25618408	.	C	T	3	2	5	0	1	6	0	0
11	25618469	.	A	T	1	2	3	0	0	3	0	0
11	25631050	.	T	G	3	0	3	0	2	5	0	0
11	25668264	.	G	A	2	2	4	0	0	4	0	0
11	25668431	.	G	A	0	3	3	0	1	4	0	0
11	25668729	.	C	A	1	5	6	0	0	6	0	0
11	25678793	.	C	T	1	2	3	0	2	5	0	0
11	25678971	.	T	A	3	2	5	0	0	5	0	0
11	25679010	.	A	T	1	3	4	0	0	4	0	0
11	25681594	.	C	T	3	11	14	0	1	15	0	0
11	25681602	.	C	A	3	12	15	0	1	16	0	0
11	25681659	.	G	A	0	7	7	0	5	12	0	0
11	25681677	.	G	A	0	5	5	0	6	11	0	0
11	25686079	.	T	A	5	5	10	0	0	10	0	0
11	25689209	.	T	C	1	7	8	0	1	9	0	0
11	25689233	.	G	C	1	7	8	0	1	9	0	0
11	25693911	.	T	C	1	3	4	0	0	4	0	0
11	25695436	.	G	A	1	2	3	0	0	3	0	0
11	25695509	.	G	A	0	3	3	0	2	5	0	0
11	25695577	.	C	T	3	3	6	0	0	6	0	0
11	25695625	.	A	G	2	7	9	0	1	10	0	0
11	25695643	.	T	C	5	3	8	0	0	8	0	0
11	25695724	.	C	A	4	3	7	0	2	9	0	0
11	25695733	.	C	T	4	4	8	0	0	8	0	0
11	25698776	.	G	C	4	2	6	0	0	6	0	0
11	25698866	.	T	C	2	2	4	0	0	4	0	0
11	25698869	.	G	C	0	2	2	0	2	4	0	0
11	25698951	.	C	T	5	3	8	0	0	8	0	0
11	25699406	.	G	A	0	8	8	0	6	14	0	0
11	25702397	.	C	T	5	3	8	0	1	9	0	0
11	25705225	.	C	T	8	8	16	0	0	16	0	0
11	25708008	.	A	G	1	6	7	0	0	7	0	0
11	25713028	.	A	G	3	4	7	0	0	7	0	0
11	25713124	.	T	A	6	3	9	0	0	9	0	0
11	25713361	.	T	A	1	2	3	0	0	3	0	0
11	25713362	.	T	A	1	2	3	0	0	3	0	0
11	25713526	.	A	G	3	7	10	0	0	10	0	0
11	25713683	.	G	A	6	5	11	0	1	12	0	0
11	25713725	.	T	A	8	6	14	0	2	16	0	0
11	25713727	.	A	C	7	8	15	0	1	16	0	0
11	25713842	.	T	A	7	6	13	0	0	13	0	0
11	25713871	.	T	C	5	4	9	0	0	9	0	0
11	25713913	.	T	C	1	6	7	0	0	7	0	0
11	25714148	.	G	A	4	13	17	0	1	18	0	0
11	25714425	.	G	T	10	6	16	0	0	16	0	0
11	25714441	.	C	A	6	10	16	0	0	16	0	0
11	25718194	.	C	T	3	6	9	0	0	9	0	0
11	25718438	.	T	G	8	4	12	0	0	12	0	0
11	25721865	.	C	T	5	2	7	0	0	7	0	0
11	25729190	.	G	T	3	4	7	0	0	7	0	0
11	25730281	.	G	A	1	4	5	0	1	6	0	0
11	25730282	.	A	T	2	4	6	0	0	6	0	0
11	25743414	.	G	A	2	2	4	0	0	4	0	0
11	25743531	.	G	A	0	1	1	0	0	1	0	0
11	25749579	.	T	A	1	3	4	0	0	4	0	0
11	25749826	.	A	C	10	16	26	0	0	26	0	0
11	25749873	.	T	A	23	10	33	0	1	34	0	0
11	25750003	.	G	A	4	4	8	0	0	8	0	0
11	25750008	.	A	G	3	4	7	0	0	7	0	0
11	25783118	.	C	T	0	7	7	0	5	12	0	0
11	25783432	.	G	A	9	7	16	0	0	16	0	0
11	25783704	.	C	T	10	10	20	0	1	21	0	0
11	25789211	.	C	G	4	6	10	0	0	10	0	0
11	25791044	.	C	A	0	4	4	0	3	7	0	0
11	25893627	.	C	T	4	11	15	0	0	15	0	0
11	25893943	.	A	G	4	6	10	0	0	10	0	0
11	25894003	.	T	C	8	10	18	0	1	19	0	0
11	25944661	.	A	C	7	3	10	0	0	10	0	0
11	26180292	.	C	T	0	3	3	0	2	5	0	0
11	26180460	.	G	A	1	2	3	0	0	3	0	0
11	26190562	.	A	T	7	3	10	0	0	10	0	0
11	26190763	.	C	T	3	12	15	0	2	17	0	0
11	26191478	.	T	A	6	5	11	0	0	11	0	0
11	26191661	.	T	A	3	12	15	0	2	17	0	0
11	26191901	.	A	T	7	6	13	0	0	13	0	0
11	26193071	.	G	A	2	2	4	0	1	5	0	0
11	26193377	.	C	T	0	2	2	0	6	8	0	0
11	26193721	.	T	G	2	5	7	0	0	7	0	0
11	26194061	.	T	G	7	5	12	0	0	12	0	0
11	26194237	.	G	T	2	4	6	0	0	6	0	0
11	26195300	.	T	C	3	3	6	0	0	6	0	0
11	26229093	.	G	A	14	17	31	0	0	31	0	0
11	26229801	.	G	A	14	12	26	0	0	26	0	0
11	26229809	.	T	C	12	11	23	0	2	25	0	0
11	26229900	.	C	T	0	16	16	0	14	30	0	0
11	26230425	.	G	C	5	13	18	0	2	20	0	0
11	26230644	.	G	A	2	1	3	0	0	3	0	0
11	26230774	.	T	A	6	5	11	0	1	12	0	0
11	26230972	.	A	G	7	9	16	0	0	16	0	0
11	26231804	.	T	C	7	15	22	0	0	22	0	0
11	26231890	.	G	A	6	8	14	0	0	14	0	0
11	26233522	.	A	T	2	1	3	0	1	4	0	0
11	26311763	.	C	T	0	3	3	0	2	5	0	0
11	26367058	.	T	G	2	3	5	0	0	5	0	0
11	26367130	.	T	C	0	4	4	0	0	4	0	0
11	26367131	.	G	A	0	4	4	0	0	4	0	0
11	26367201	.	C	T	0	2	2	0	0	2	0	0
11	26369402	.	A	T	2	2	4	0	0	4	0	0
11	26369416	.	A	G	2	2	4	0	0	4	0	0
11	26370780	.	A	G	3	4	7	0	0	7	0	0
11	26370804	.	G	A	1	3	4	0	0	4	0	0
11	26372243	.	C	G	0	1	1	0	0	1	0	0
11	26372296	.	C	T	0	7	7	0	9	16	0	0
11	26373641	.	G	A	0	1	1	0	0	1	0	0
11	26373647	.	C	T	0	1	1	0	0	1	0	0
11	26374063	.	G	A	1	2	3	0	0	3	0	0
11	26380938	.	G	A	3	4	7	0	0	7	0	0
11	26380977	.	G	A	1	4	5	0	0	5	0	0
11	26381145	.	C	T	5	3	8	0	0	8	0	0
11	26381313	.	T	A	4	4	8	0	2	10	0	0
11	26381908	.	G	A	2	6	8	0	2	10	0	0
11	26382551	.	A	G	1	0	1	0	7	8	0	0
11	26382756	.	T	C	12	8	20	0	1	21	0	0
11	26383068	.	C	T	2	3	5	0	1	6	0	0
11	26383120	.	T	C	3	5	8	0	0	8	0	0
11	26383338	.	G	T	0	3	3	0	1	4	0	0
11	26398012	.	T	C	6	2	8	0	0	8	0	0
11	26398081	.	A	T	5	1	6	0	0	6	0	0
11	26400503	.	G	A	11	12	23	0	0	23	0	0
11	26400796	.	C	T	1	4	5	0	0	5	0	0
11	26400916	.	C	T	12	10	22	0	1	23	0	0
11	26401116	.	G	A	0	4	4	0	5	9	0	0
11	26401248	.	G	T	5	7	12	0	0	12	0	0
11	26401407	.	C	T	10	11	21	0	0	21	0	0
11	26401413	.	C	T	11	10	21	0	1	22	0	0
11	26545819	.	A	G	3	3	6	0	1	7	0	0
11	26561119	.	G	A	2	2	4	0	0	4	0	0
11	26561780	.	G	T	1	2	3	0	0	3	0	0
11	26562132	.	C	A	4	2	6	0	1	7	0	0
11	26562253	.	G	A	1	6	7	0	0	7	0	0
11	26562292	.	T	A	1	3	4	0	0	4	0	0
11	26562306	.	C	G	2	3	5	0	0	5	0	0
11	26614389	.	T	C	6	5	11	0	0	11	0	0
11	26614487	.	G	T	24	33	57	0	1	58	0	0
11	26614552	.	G	C	3	31	34	0	23	57	0	0
11	26614615	.	T	A	21	28	49	0	1	50	0	0
11	26614649	.	A	G	29	1	30	0	28	58	0	0
11	26615112	.	T	G	18	15	33	0	1	34	0	0
11	26615294	.	G	A	20	14	34	0	2	36	0	0
11	26615525	.	A	C	1	2	3	0	0	3	0	0
11	26683200	.	C	A	6	6	12	0	0	12	0	0
11	26683250	.	C	T	4	4	8	0	1	9	0	0
11	26683692	.	A	T	3	3	6	0	0	6	0	0
11	26704347	.	C	A	1	15	16	0	20	36	0	0
11	26704961	.	A	T	13	2	15	0	0	15	0	0
11	26705196	.	C	T	15	10	25	0	0	25	0	0
11	26705239	.	C	A	12	13	25	0	3	28	0	0
11	26705738	.	G	T	17	13	30	0	0	30	0	0
11	26705995	.	C	A	10	5	15	0	1	16	0	0
11	26706015	.	G	A	12	5	17	0	2	19	0	0
11	26706572	.	C	T	0	12	12	0	9	21	0	0
11	26706862	.	A	C	7	10	17	0	1	18	0	0
11	26707325	.	T	C	13	1	14	0	13	27	0	0
11	26707634	.	A	G	20	20	40	0	7	47	0	0
11	26707679	.	G	A	19	19	38	0	2	40	0	0
11	26707733	.	A	G	11	20	31	0	3	34	0	0
11	26715590	.	C	T	2	3	5	0	0	5	0	0
11	26722188	.	G	A	3	3	6	0	2	8	0	0
11	26739994	.	T	G	5	4	9	0	0	9	0	0
11	26740393	.	T	C	5	8	13	0	0	13	0	0
11	26740751	.	T	C	5	0	5	0	4	9	0	0
11	26740784	.	A	G	1	4	5	0	0	5	0	0
11	27136614	.	C	T	1	3	4	0	0	4	0	0
11	27143590	.	A	G	0	0	0	0	4	4	0	0
11	27195745	.	A	T	3	2	5	0	0	5	0	0
11	27197211	.	A	G	4	0	4	0	3	7	0	0
11	27197299	.	T	C	4	2	6	0	1	7	0	0
11	27486825	.	C	T	5	5	10	0	0	10	0	0
11	27487368	.	T	A	0	4	4	0	2	6	0	0
11	27487411	.	A	G	6	8	14	0	0	14	0	0
11	27487557	.	G	T	4	4	8	0	1	9	0	0
11	27487689	.	T	C	5	5	10	0	0	10	0	0
11	27487862	.	T	C	1	3	4	0	0	4	0	0
11	27487904	.	T	A	2	2	4	0	0	4	0	0
11	27488158	.	C	T	6	4	10	0	0	10	0	0
11	27488300	.	A	G	2	3	5	0	0	5	0	0
11	27488312	.	C	T	4	3	7	0	0	7	0	0
11	27488369	.	G	C	6	5	11	0	1	12	0	0
11	27488669	.	G	A	1	5	6	0	0	6	0	0
11	27512047	.	T	A	1	2	3	0	0	3	0	0
11	27512112	.	A	G	1	1	2	0	0	2	0	0
11	27512114	.	G	A	1	1	2	0	0	2	0	0
11	27516630	.	T	G	2	5	7	0	1	8	0	0
11	27516891	.	C	T	0	4	4	0	4	8	0	0
11	27517115	.	G	A	2	2	4	0	0	4	0	0
11	27517238	.	C	T	0	2	2	0	3	5	0	0
11	27517296	.	T	C	8	3	11	0	0	11	0	0
11	27517635	.	C	T	0	1	1	0	2	3	0	0
11	27517653	.	C	T	1	2	3	0	0	3	0	0
11	27517776	.	G	T	4	2	6	0	0	6	0	0
11	27526278	.	A	G	1	0	1	0	0	1	0	0
11	27537552	.	C	T	0	1	1	0	1	2	0	0
11	27644826	.	A	G	6	7	13	0	3	16	0	0
11	27644922	.	G	A	13	7	20	0	0	20	0	0
11	27645742	.	T	A	8	4	12	0	1	13	0	0
11	27646063	.	T	A	4	6	10	0	0	10	0	0
11	27646172	.	T	C	3	4	7	0	1	8	0	0
11	27646210	.	G	C	10	4	14	0	0	14	0	0
11	27646298	.	A	G	7	8	15	0	1	16	0	0
11	27649527	.	G	A	10	11	21	0	0	21	0	0
11	27655732	.	A	G	8	12	20	0	1	21	0	0
11	27655774	.	C	T	0	9	9	0	9	18	0	0
11	27661241	.	C	T	0	4	4	0	3	7	0	0
11	27668314	.	A	G	2	6	8	0	0	8	0	0
11	27669744	.	G	C	3	4	7	0	1	8	0	0
11	27671163	.	C	T	2	10	12	0	1	13	0	0
11	27671251	.	G	A	6	3	9	0	0	9	0	0
11	27673289	.	C	T	5	3	8	0	0	8	0	0
11	27677815	.	C	T	0	1	1	0	1	2	0	0
11	27677939	.	T	G	4	4	8	0	0	8	0	0
11	27677948	.	G	A	4	4	8	0	0	8	0	0
11	27705165	.	G	A	6	5	11	0	4	15	0	0
11	27705215	.	T	A	5	8	13	0	0	13	0	0
11	27705219	.	G	T	6	9	15	0	1	16	0	0
11	27705960	.	G	A	11	13	24	0	0	24	0	0
11	27706308	.	G	A	3	6	9	0	0	9	0	0
11	27706434	.	T	A	3	3	6	0	0	6	0	0
11	27706441	.	T	C	5	0	5	0	3	8	0	0
11	27706741	.	T	A	4	6	10	0	0	10	0	0
11	27706742	.	A	C	4	6	10	0	0	10	0	0
11	27708665	.	A	C	0	4	4	0	1	5	0	0
11	27710381	.	G	T	2	4	6	0	1	7	0	0
11	27713556	.	G	T	8	4	12	0	0	12	0	0
11	27719203	.	A	G	1	0	1	0	0	1	0	0
11	27719350	.	G	T	2	4	6	0	0	6	0	0
11	27725145	.	T	G	2	1	3	0	0	3	0	0
11	27727592	.	G	A	2	4	6	0	0	6	0	0
11	27727631	.	A	G	1	4	5	0	1	6	0	0
11	27738118	.	A	G	2	4	6	0	1	7	0	0
11	27817706	.	T	A	1	6	7	0	1	8	0	0
11	27817767	.	G	A	1	3	4	0	0	4	0	0
11	27817948	.	C	T	0	2	2	0	1	3	0	0
11	27818236	.	A	C	10	5	15	0	0	15	0	0
11	27818239	.	T	C	9	6	15	0	1	16	0	0
11	27818343	.	G	C	5	4	9	0	1	10	0	0
11	27820431	.	T	G	2	7	9	0	0	9	0	0
11	27820992	.	C	T	0	3	3	0	6	9	0	0
11	27828919	.	A	T	11	7	18	0	1	19	0	0
11	27829402	.	A	G	6	2	8	0	2	10	0	0
11	27829592	.	A	G	7	7	14	0	0	14	0	0
11	27829702	.	T	C	18	9	27	0	1	28	0	0
11	27829772	.	G	A	7	5	12	0	0	12	0	0
11	27829928	.	G	A	13	9	22	0	1	23	0	0
11	27835073	.	T	C	1	5	6	0	0	6	0	0
11	27835372	.	C	A	1	1	2	0	0	2	0	0
11	27836045	.	T	C	3	8	11	0	0	11	0	0
11	27840160	.	A	G	0	1	1	0	1	2	0	0
11	27845701	.	A	G	2	1	3	0	0	3	0	0
11	27857373	.	C	T	7	5	12	0	1	13	0	0
11	27867140	.	T	G	0	1	1	0	0	1	0	0
11	27874042	.	T	C	8	0	8	0	5	13	0	0
11	28005245	.	C	T	1	2	3	0	0	3	0	0
11	28005535	.	C	T	0	1	1	0	0	1	0	0
11	28123088	.	T	G	4	0	4	0	3	7	0	0
11	28123186	.	T	C	3	2	5	0	0	5	0	0
11	28124217	.	G	A	0	4	4	0	4	8	0	0
11	28124776	.	C	T	2	2	4	0	0	4	0	0
11	28310756	.	T	C	1	2	3	0	0	3	0	0
11	28396869	.	A	T	2	2	4	0	0	4	0	0
11	28404161	.	G	A	1	2	3	0	0	3	0	0
11	28409862	.	T	C	3	4	7	0	1	8	0	0
11	28409976	.	G	A	0	0	0	0	1	1	0	0
11	28410154	.	C	T	2	3	5	0	0	5	0	0
11	28410157	.	T	C	2	4	6	0	0	6	0	0
11	28412858	.	C	T	3	4	7	0	0	7	0	0
11	28412868	.	A	C	4	4	8	0	0	8	0	0
11	28419753	.	C	T	6	6	12	0	1	13	0	0
11	28419948	.	C	T	1	6	7	0	0	7	0	0
11	28420051	.	A	G	1	0	1	0	6	7	0	0
11	28420264	.	T	G	4	1	5	0	4	9	0	0
11	28420600	.	G	A	0	6	6	0	3	9	0	0
11	28420602	.	T	C	3	6	9	0	0	9	0	0
11	28420880	.	T	C	2	4	6	0	1	7	0	0
11	28421115	.	T	G	6	7	13	0	0	13	0	0
11	28421234	.	A	G	5	0	5	0	7	12	0	0
11	28422273	.	C	T	4	10	14	0	1	15	0	0
11	28422542	.	A	G	10	8	18	0	0	18	0	0
11	28422892	.	C	A	14	2	16	0	0	17	1	0
11	28423137	.	A	G	5	0	5	0	4	9	0	0
11	28423147	.	T	A	6	6	12	0	0	12	0	0
11	28423325	.	C	T	7	9	16	0	0	16	0	0
11	28423457	.	T	C	12	3	15	0	0	16	1	0
11	28423497	.	G	T	11	7	18	0	0	18	0	0
11	28423628	.	A	T	6	10	16	0	0	16	0	0
11	28477137	.	C	T	6	2	8	0	1	9	0	0
11	28477338	.	T	C	4	7	11	0	1	12	0	0
11	28477697	.	T	C	4	7	11	0	0	11	0	0
11	28477720	.	T	A	6	3	9	0	0	9	0	0
11	28478026	.	T	C	4	4	8	0	0	8	0	0
11	28513960	.	T	C	3	5	8	0	0	8	0	0
11	28514053	.	G	A	2	3	5	0	1	6	0	0
11	28514089	.	T	C	5	6	11	0	1	12	0	0
11	28514307	.	T	G	3	4	7	0	1	8	0	0
11	28514946	.	T	C	2	2	4	0	0	4	0	0
11	28514963	.	C	T	1	2	3	0	0	3	0	0
11	28643141	.	G	A	23	23	46	0	0	46	0	0
11	28643281	.	A	T	19	22	41	0	4	45	0	0
11	28643890	.	G	C	4	24	28	0	2	30	0	0
11	28644087	.	A	C	12	26	38	0	4	42	0	0
11	28644110	.	T	C	18	1	19	0	25	44	0	0
11	28661028	.	A	G	9	12	21	0	2	23	0	0
11	28789260	.	C	T	1	3	4	0	0	4	0	0
11	28808965	.	G	A	7	4	11	0	0	11	0	0
11	29331317	.	A	T	2	0	2	0	2	4	0	0
11	29331334	.	C	A	3	2	5	0	0	5	0	0
11	29331413	.	A	G	3	5	8	0	0	8	0	0
11	29331532	.	A	G	3	6	9	0	0	9	0	0
11	29331609	.	T	C	6	5	11	0	0	11	0	0
11	29331695	.	A	G	6	9	15	0	1	16	0	0
11	29331854	.	T	C	4	4	8	0	1	9	0	0
11	29332113	.	T	G	9	4	13	0	0	13	0	0
11	29332255	.	T	C	0	0	0	0	4	4	0	0
11	29332357	.	A	G	3	3	6	0	2	8	0	0
11	29332591	.	G	A	8	6	14	0	0	14	0	0
11	29332831	.	A	C	5	4	9	0	0	9	0	0
11	29575390	.	G	A	21	13	34	0	2	36	0	0
11	29575429	.	G	T	21	19	40	0	0	40	0	0
11	29575527	.	C	T	17	20	37	0	5	42	0	0
11	29575897	.	C	T	12	9	21	0	0	21	0	0
11	29576344	.	T	A	2	2	4	0	0	4	0	0
11	29577107	.	G	A	12	10	22	0	2	24	0	0
11	29577163	.	C	T	12	6	18	0	2	20	0	0
11	29577431	.	T	C	5	9	14	0	2	16	0	0
11	29577481	.	T	A	6	6	12	0	0	12	0	0
11	29577566	.	C	T	10	6	16	0	1	17	0	0
11	29577598	.	T	C	10	0	10	0	11	21	0	0
11	29577970	.	T	C	2	6	8	0	0	8	0	0
11	29577979	.	T	A	2	6	8	0	0	8	0	0
11	29578070	.	C	T	0	12	12	0	6	18	0	0
11	29578133	.	T	C	7	0	7	0	13	21	1	0
11	29578139	.	A	G	7	11	18	0	0	18	0	0
11	29578265	.	G	A	3	0	3	0	0	3	0	0
11	29581774	.	T	C	14	1	15	0	10	25	0	0
11	29581828	.	A	G	1	3	4	0	0	4	0	0
11	29587885	.	A	G	2	3	5	0	0	5	0	0
11	29587927	.	T	C	5	7	12	0	0	12	0	0
11	29588525	.	G	A	4	0	4	0	0	4	0	0
11	29589199	.	T	C	12	6	18	0	1	19	0	0
11	29589370	.	C	T	1	0	1	0	0	1	0	0
11	29589512	.	T	G	1	1	2	0	0	2	0	0
11	29589578	.	T	C	9	0	9	0	5	14	0	0
11	29589602	.	T	A	6	5	11	0	2	13	0	0
11	29593372	.	T	C	2	4	6	0	0	6	0	0
11	29596227	.	A	G	4	8	12	0	0	12	0	0
11	29601936	.	T	C	3	2	5	0	1	6	0	0
11	29602407	.	T	A	0	6	6	0	0	6	0	0
11	29609844	.	G	A	0	2	2	0	0	2	0	0
11	29614074	.	T	C	5	0	5	0	5	10	0	0
11	29614086	.	T	C	7	5	12	0	0	12	0	0
11	29617672	.	G	A	2	1	3	0	0	3	0	0
11	29623647	.	T	C	1	3	4	0	1	5	0	0
11	29624186	.	T	C	6	0	6	0	5	11	0	0
11	29626180	.	G	A	1	2	3	0	0	3	0	0
11	29637556	.	T	C	2	5	7	0	0	7	0	0
11	29685445	.	T	C	3	4	7	0	0	7	0	0
11	29685616	.	T	G	3	2	5	0	1	6	0	0
11	29757258	.	T	C	6	7	13	0	0	13	0	0
11	29757636	.	A	C	9	8	17	0	0	17	0	0
11	29762946	.	G	A	9	9	18	0	1	19	0	0
11	29764554	.	A	G	1	0	1	0	0	1	0	0
11	29776479	.	A	G	5	3	8	0	0	8	0	0
11	29785019	.	C	T	3	2	5	0	0	5	0	0
11	29785034	.	G	A	2	2	4	0	1	5	0	0
11	29785731	.	A	G	3	3	6	0	0	6	0	0
11	29785844	.	C	G	1	3	4	0	0	4	0	0
11	29785942	.	C	G	3	2	5	0	0	5	0	0
11	29788042	.	G	A	8	3	11	0	1	12	0	0
11	29789405	.	A	C	1	0	1	0	0	1	0	0
11	29789776	.	T	A	1	3	4	0	0	4	0	0
11	29790631	.	A	G	0	0	0	0	5	5	0	0
11	29791911	.	C	A	3	0	3	0	1	4	0	0
11	29793547	.	T	C	9	11	20	0	0	20	0	0
11	29793553	.	T	C	10	14	24	0	0	24	0	0
11	29793694	.	A	C	15	11	26	0	2	28	0	0
11	29793726	.	C	A	10	12	22	0	1	23	0	0
11	29794009	.	A	G	23	13	36	0	0	36	0	0
11	29795584	.	A	G	1	3	4	0	0	4	0	0
11	29795601	.	C	T	1	3	4	0	0	4	0	0
11	29795893	.	A	C	1	2	3	0	0	3	0	0
11	29796270	.	A	C	2	0	2	0	9	11	0	0
11	29796512	.	A	C	1	0	1	0	4	5	0	0
11	29818491	.	C	A	4	3	7	0	0	7	0	0
11	29876865	.	C	T	4	2	6	0	1	7	0	0
11	29876974	.	C	A	9	3	12	0	0	12	0	0
11	29877077	.	A	G	6	5	11	0	0	11	0	0
11	29917851	.	G	T	2	2	4	0	0	4	0	0
11	29917861	.	A	T	1	2	3	0	0	3	0	0
11	29917966	.	G	T	5	3	8	0	1	9	0	0
11	29918109	.	A	T	3	0	3	0	0	3	0	0
11	29918110	.	A	G	3	0	3	0	0	3	0	0
11	29918168	.	T	C	2	5	7	0	0	7	0	0
11	29918294	.	G	T	3	11	14	0	1	15	0	0
11	29918306	.	A	G	4	11	15	0	0	15	0	0
11	29936156	.	G	A	2	2	4	0	0	4	0	0
11	29936168	.	T	C	2	1	3	0	1	4	0	0
11	30001081	.	A	C	1	0	1	0	0	1	0	0
11	30082769	.	G	A	2	2	4	0	0	4	0	0
11	30083525	.	A	G	3	6	9	0	0	9	0	0
11	30083603	.	C	A	5	2	7	0	1	8	0	0
11	30083795	.	C	T	3	5	8	0	0	8	0	0
11	30084212	.	C	T	4	3	7	0	1	8	0	0
11	30086845	.	A	C	4	2	6	0	1	7	0	0
11	30087147	.	T	G	3	0	3	0	5	8	0	0
11	30087271	.	A	G	1	4	5	0	0	5	0	0
11	30087274	.	T	C	1	4	5	0	1	6	0	0
11	30087312	.	A	T	3	5	8	0	0	8	0	0
11	30087429	.	G	A	6	6	12	0	0	12	0	0
11	30087885	.	C	T	0	4	4	0	1	5	0	0
11	30088392	.	A	T	8	7	15	0	0	15	0	0
11	30088427	.	G	A	5	4	9	0	0	9	0	0
11	30088560	.	G	T	5	10	15	0	0	15	0	0
11	30089649	.	A	G	15	7	22	0	0	22	0	0
11	30089671	.	G	A	13	4	17	0	0	17	0	0
11	30106429	.	C	T	2	3	5	0	1	6	0	0
11	30106790	.	A	C	3	2	5	0	1	6	0	0
11	30107299	.	T	G	5	10	15	0	0	15	0	0
11	30107366	.	A	G	2	8	10	0	0	10	0	0
11	30107405	.	T	C	2	7	9	0	0	9	0	0
11	30107417	.	C	T	2	5	7	0	1	8	0	0
11	30118970	.	A	G	6	3	9	0	0	9	0	0
11	30122741	.	G	A	2	3	5	0	0	5	0	0
11	30147877	.	G	A	2	0	2	0	0	2	0	0
11	30148024	.	G	A	1	2	3	0	1	4	0	0
11	30149880	.	A	G	1	0	1	0	0	1	0	0
11	30205713	.	C	T	4	4	8	0	0	8	0	0
11	30222912	.	T	C	2	3	5	0	0	5	0	0
11	30222963	.	G	A	0	7	7	0	17	24	0	0
11	30231104	.	C	T	5	7	12	0	1	13	0	0
11	30231269	.	A	G	27	16	43	0	2	45	0	0
11	30231416	.	T	A	14	7	21	0	2	23	0	0
11	30251411	.	G	A	2	4	6	0	0	6	0	0
11	30251859	.	A	T	2	2	4	0	0	4	0	0
11	30946960	.	A	G	2	3	5	0	0	5	0	0
11	31024887	.	A	G	6	8	14	0	0	14	0	0
11	31275453	.	A	G	0	1	1	0	0	1	0	0
11	31558251	.	G	A	0	10	10	0	4	14	0	0
11	31558634	.	C	A	11	10	21	0	1	22	0	0
11	31558782	.	C	T	9	6	15	0	1	16	0	0
11	31602828	.	G	T	10	9	19	0	0	19	0	0
11	31603346	.	G	A	0	5	5	0	7	12	0	0
11	31621018	.	T	C	2	2	4	0	2	6	0	0
11	31621106	.	C	A	3	2	5	0	0	5	0	0
11	31647283	.	A	C	1	6	7	0	0	7	0	0
11	31649781	.	G	A	0	1	1	0	2	3	0	0
11	31653670	.	T	G	4	0	4	0	1	5	0	0
11	31653700	.	T	C	5	4	9	0	0	9	0	0
11	31664070	.	T	C	8	5	13	0	1	14	0	0
11	31664108	.	T	C	3	1	4	0	0	4	0	0
11	31667490	.	C	A	2	0	2	0	0	2	0	0
11	31667592	.	C	T	12	16	28	0	0	28	0	0
11	31667658	.	C	T	17	18	35	0	1	36	0	0
11	31667946	.	G	A	10	11	21	0	0	21	0	0
11	31668186	.	A	G	4	4	8	0	0	10	2	0
11	31668191	.	A	T	3	2	5	0	1	8	2	0
11	31668330	.	C	A	5	8	13	0	2	15	0	0
11	31668394	.	T	G	12	8	20	0	0	20	0	0
11	31668824	.	T	A	6	1	7	0	2	9	0	0
11	31668849	.	A	T	5	2	7	0	0	7	0	0
11	31668893	.	T	C	4	3	7	0	0	7	0	0
11	31668964	.	G	C	2	8	10	0	0	10	0	0
11	31670216	.	A	T	10	13	23	0	0	23	0	0
11	31670534	.	T	C	2	2	4	0	0	4	0	0
11	31670605	.	T	A	3	4	7	0	2	9	0	0
11	31670610	.	A	T	4	5	9	0	0	9	0	0
11	31670648	.	T	C	5	0	5	0	0	5	0	0
11	31670661	.	T	G	5	0	5	0	0	5	0	0
11	31670686	.	A	G	4	2	6	0	0	6	0	0
11	31670724	.	A	G	3	0	3	0	9	12	0	0
11	31670749	.	C	A	3	8	11	0	0	11	0	0
11	31670789	.	C	T	2	5	7	0	1	8	0	0
11	31670808	.	C	A	3	7	10	0	0	10	0	0
11	31670830	.	T	C	2	8	10	0	2	12	0	0
11	31670868	.	T	C	8	10	18	0	1	19	0	0
11	31670881	.	T	A	9	8	17	0	2	19	0	0
11	31671165	.	G	C	8	3	11	0	0	11	0	0
11	31671189	.	A	G	4	5	9	0	0	9	0	0
11	31671326	.	G	T	0	4	4	0	0	4	0	0
11	31671328	.	T	G	0	4	4	0	0	4	0	0
11	32576695	.	C	T	13	9	22	0	0	22	0	0
11	32577076	.	T	A	4	3	7	0	0	7	0	0
11	32577258	.	C	T	0	10	10	0	10	20	0	0
11	32577404	.	A	G	10	12	22	0	2	24	0	0
11	32577439	.	G	A	14	13	27	0	2	29	0	0
11	32577800	.	G	A	14	14	28	0	1	29	0	0
11	32577830	.	G	A	15	17	32	0	0	32	0	0
11	32578082	.	C	T	12	13	25	0	3	28	0	0
11	32578172	.	G	A	18	16	34	0	0	34	0	0
11	32720124	.	C	T	7	16	23	0	1	24	0	0
11	32720427	.	A	T	9	7	16	0	0	16	0	0
11	32720505	.	C	T	6	5	11	0	0	11	0	0
11	32720730	.	C	G	10	9	19	0	0	19	0	0
11	32720856	.	A	G	5	6	11	0	0	11	0	0
11	32721057	.	T	A	11	3	14	0	1	15	0	0
11	32721144	.	A	G	8	8	16	0	1	17	0	0
11	32721168	.	A	G	8	10	18	0	2	20	0	0
11	32721333	.	A	G	8	9	17	0	1	18	0	0
11	32721492	.	A	C	6	0	6	0	5	11	0	0
11	32721498	.	T	G	5	5	10	0	1	11	0	0
11	32721765	.	A	G	4	3	7	0	0	7	0	0
11	32721843	.	G	A	3	7	10	0	1	11	0	0
11	32723520	.	G	A	4	2	6	0	0	6	0	0
11	32723691	.	C	T	6	9	15	0	0	15	0	0
11	33599938	.	T	C	6	3	9	0	0	9	0	0
11	33846497	.	T	C	9	5	14	0	2	16	0	0
11	33846519	.	T	C	3	8	11	0	2	13	0	0
11	33846566	.	T	C	4	8	12	0	1	13	0	0
11	33846577	.	T	C	7	4	11	0	1	12	0	0
11	34236917	.	A	G	10	3	13	0	1	14	0	0
11	34531049	.	T	C	4	2	6	0	0	6	0	0
11	34911094	.	A	G	6	7	13	0	0	13	0	0
11	34911103	.	C	T	1	10	11	0	0	11	0	0
11	34911229	.	G	A	6	7	13	0	1	14	0	0
11	36158379	.	A	C	3	3	6	0	0	6	0	0
11	36158839	.	G	T	3	1	4	0	0	4	0	0
11	36180612	.	C	T	4	4	8	0	0	8	0	0
11	36180774	.	A	G	5	3	8	0	0	8	0	0
11	36180775	.	T	C	5	3	8	0	0	8	0	0
11	36180831	.	G	T	0	4	4	0	1	5	0	0
11	36180876	.	C	A	2	4	6	0	0	6	0	0
11	36205992	.	C	T	2	6	8	0	0	8	0	0
11	36208199	.	G	A	5	7	12	0	1	13	0	0
11	36208328	.	G	A	0	7	7	0	4	11	0	0
11	36214517	.	C	T	18	11	29	0	0	29	0	0
11	36214601	.	G	A	0	6	6	0	11	17	0	0
11	36214815	.	G	A	0	13	13	0	16	29	0	0
11	36215346	.	G	A	13	12	25	0	3	28	0	0
11	36215459	.	A	G	3	9	12	0	1	13	0	0
11	36215930	.	G	A	1	2	3	0	0	3	0	0
11	36224767	.	G	A	0	1	1	0	0	1	0	0
11	36254992	.	T	C	8	3	11	0	1	12	0	0
11	36254996	.	T	C	6	5	11	0	0	11	0	0
11	36258658	.	T	C	2	2	4	0	0	4	0	0
11	36258699	.	A	G	3	2	5	0	0	5	0	0
11	36258951	.	A	G	2	6	8	0	0	8	0	0
11	36263954	.	A	G	1	3	4	0	0	4	0	0
11	36269682	.	G	A	4	3	7	0	0	7	0	0
11	36269768	.	A	G	2	1	3	0	0	3	0	0
11	36281881	.	A	G	8	4	12	0	1	13	0	0
11	36281939	.	T	G	4	4	8	0	1	9	0	0
11	36281943	.	G	A	5	5	10	0	0	10	0	0
11	36282081	.	A	T	10	10	20	0	1	21	0	0
11	36282259	.	A	T	3	3	6	0	1	7	0	0
11	36282361	.	A	C	5	8	13	0	0	13	0	0
11	36282494	.	G	T	3	4	7	0	0	7	0	0
11	36282501	.	C	T	3	3	6	0	0	6	0	0
11	36283433	.	C	A	1	2	3	0	0	3	0	0
11	36290822	.	T	C	5	4	9	0	0	9	0	0
11	36291207	.	G	A	2	2	4	0	0	4	0	0
11	36293926	.	G	A	2	1	3	0	0	3	0	0
11	36343054	.	A	T	5	1	6	0	1	7	0	0
11	36343167	.	G	C	14	23	37	0	0	37	0	0
11	36347775	.	C	T	7	5	12	0	0	12	0	0
11	36372889	.	G	A	3	6	9	0	0	9	0	0
11	36373200	.	C	T	1	2	3	0	0	3	0	0
11	36689027	.	C	T	0	4	4	0	1	5	0	0
11	36689328	.	G	C	3	3	6	0	0	6	0	0
11	36689344	.	A	G	2	4	6	0	0	6	0	0
11	36689372	.	T	G	1	2	3	0	0	3	0	0
11	36689425	.	T	C	1	4	5	0	0	5	0	0
11	36689426	.	T	C	1	4	5	0	0	5	0	0
11	36689486	.	A	G	0	1	1	0	0	1	0	0
11	36691538	.	T	A	1	0	1	0	0	1	0	0
11	36695103	.	G	A	1	1	2	0	1	3	0	0
11	36788527	.	T	A	15	11	26	0	1	27	0	0
11	36793616	.	A	C	2	7	9	0	1	10	0	0
11	36793697	.	G	T	8	5	13	0	0	13	0	0
11	36793730	.	T	G	6	7	13	0	0	13	0	0
11	36793760	.	A	C	10	8	18	0	0	18	0	0
11	36793859	.	G	A	2	4	6	0	0	6	0	0
11	36795564	.	G	T	8	5	13	0	0	13	0	0
11	36810576	.	A	G	4	4	8	0	1	9	0	0
11	36816163	.	T	C	4	5	9	0	0	9	0	0
11	36816171	.	T	C	2	6	8	0	0	8	0	0
11	36818832	.	G	T	4	2	6	0	0	6	0	0
11	36819859	.	A	T	1	1	2	0	0	2	0	0
11	36989853	.	T	A	3	3	6	0	1	7	0	0
11	37015956	.	C	T	1	1	2	0	0	2	0	0
11	37015968	.	T	C	0	1	1	0	0	1	0	0
11	37023776	.	T	C	1	2	3	0	0	3	0	0
11	37031950	.	C	T	5	3	8	0	0	8	0	0
11	37032055	.	G	A	11	7	18	0	1	19	0	0
11	37032669	.	G	A	0	4	4	0	9	13	0	0
11	37032739	.	C	T	6	4	10	0	1	11	0	0
11	37032740	.	A	T	5	5	10	0	1	11	0	0
11	37033333	.	A	C	1	6	7	0	0	7	0	0
11	37033348	.	C	A	2	3	5	0	0	5	0	0
11	37033446	.	A	C	1	3	4	0	0	4	0	0
11	37033475	.	T	C	1	2	3	0	1	4	0	0
11	37033505	.	G	A	0	2	2	0	1	3	0	0
11	37033676	.	C	T	2	5	7	0	1	8	0	0
11	37033813	.	C	G	2	3	5	0	1	6	0	0
11	37033846	.	G	C	1	5	6	0	1	7	0	0
11	37033855	.	T	A	1	5	6	0	1	7	0	0
11	37034263	.	G	A	4	2	6	0	0	6	0	0
11	37034359	.	G	A	0	4	4	0	2	6	0	0
11	37080550	.	C	T	0	2	2	0	0	2	0	0
11	37080614	.	T	C	1	3	4	0	0	4	0	0
11	37081040	.	T	G	1	0	1	0	2	3	0	0
11	37081058	.	T	C	1	2	3	0	0	3	0	0
11	37081112	.	A	G	1	5	6	0	0	6	0	0
11	37081142	.	A	G	1	0	1	0	4	5	0	0
11	37082084	.	G	A	1	1	2	0	0	2	0	0
11	37082099	.	T	C	1	1	2	0	0	2	0	0
11	37101087	.	C	T	1	2	3	0	0	3	0	0
11	37152069	.	G	A	1	3	4	0	0	4	0	0
11	37152126	.	C	A	2	2	4	0	0	4	0	0
11	37153439	.	A	T	2	2	4	0	0	4	0	0
11	37153687	.	T	C	2	3	5	0	0	5	0	0
11	37155247	.	A	T	4	4	8	0	2	10	0	0
11	37155353	.	A	G	4	0	4	0	5	9	0	0
11	37155394	.	A	G	8	5	13	0	1	14	0	0
11	37158932	.	A	T	4	3	7	0	2	9	0	0
11	37158947	.	C	A	3	1	4	0	0	4	0	0
11	37159490	.	C	T	14	6	20	0	1	21	0	0
11	37159517	.	T	A	6	9	15	0	0	15	0	0
11	37159977	.	A	T	4	3	7	0	1	8	0	0
11	37163760	.	T	C	6	4	10	0	0	10	0	0
11	37164191	.	G	C	2	4	6	0	0	6	0	0
11	37164456	.	G	A	8	7	15	0	0	15	0	0
11	37164510	.	T	C	6	2	8	0	0	8	0	0
11	37167289	.	A	G	3	1	4	0	0	4	0	0
11	37167522	.	G	C	9	10	19	0	0	19	0	0
11	37167549	.	T	C	6	7	13	0	1	14	0	0
11	37167603	.	A	G	8	8	16	0	1	17	0	0
11	37167955	.	G	A	4	4	8	0	0	8	0	0
11	37169231	.	C	A	9	4	13	0	2	15	0	0
11	37169269	.	G	A	4	0	4	0	1	5	0	0
11	37274811	.	G	A	1	2	3	0	0	3	0	0
11	37274880	.	G	T	4	4	8	0	0	8	0	0
11	37297811	.	A	T	22	18	40	0	1	41	0	0
11	37298499	.	C	T	13	20	33	0	0	33	0	0
11	37298796	.	G	A	9	5	14	0	0	14	0	0
11	37298808	.	A	G	6	2	8	0	0	8	0	0
11	37313196	.	T	G	2	1	3	0	11	14	0	0
11	37337360	.	C	T	2	1	3	0	0	3	0	0
11	37411007	.	C	G	2	3	5	0	0	5	0	0
11	37411522	.	G	T	4	2	6	0	0	6	0	0
11	37431722	.	C	T	6	6	12	0	0	12	0	0
11	37431953	.	C	T	28	22	50	0	0	50	0	0
11	37434618	.	C	T	6	3	9	0	0	9	0	0
11	37440957	.	A	C	17	25	42	0	2	44	0	0
11	37440990	.	A	G	14	26	40	0	1	41	0	0
11	37441021	.	G	A	15	27	42	0	2	44	0	0
11	37441053	.	C	G	1	25	26	0	17	43	0	0
11	37441086	.	A	G	17	20	37	0	6	43	0	0
11	37442134	.	G	A	8	12	20	0	0	20	0	0
11	37442557	.	G	A	14	12	26	0	0	26	0	0
11	37442772	.	G	T	9	13	22	0	3	25	0	0
11	37445084	.	G	A	18	17	35	0	0	35	0	0
11	37445327	.	G	A	16	19	35	0	0	35	0	0
11	37446224	.	G	C	7	1	8	0	7	15	0	0
11	37446700	.	C	T	10	11	21	0	4	25	0	0
11	37446823	.	A	G	12	11	23	0	2	25	0	0
11	37447402	.	T	G	7	5	12	0	0	12	0	0
11	37447595	.	C	G	0	2	2	0	5	7	0	0
11	37447634	.	C	T	0	3	3	0	7	10	0	0
11	37447925	.	T	G	5	5	10	0	0	10	0	0
11	37448264	.	G	A	6	8	14	0	1	15	0	0
11	37448374	.	G	A	8	7	15	0	1	16	0	0
11	37448894	.	G	A	8	5	13	0	1	14	0	0
11	37449098	.	G	T	1	4	5	0	2	7	0	0
11	37449428	.	T	G	7	6	13	0	0	13	0	0
11	37450166	.	C	T	5	3	8	0	0	8	0	0
11	37450619	.	A	C	5	4	9	0	1	10	0	0
11	37450777	.	T	C	2	2	4	0	0	4	0	0
11	37450847	.	C	T	0	7	7	0	4	11	0	0
11	37451120	.	G	A	5	5	10	0	0	10	0	0
11	37451201	.	C	T	7	6	13	0	0	13	0	0
11	37452021	.	G	A	7	2	9	0	1	10	0	0
11	37548618	.	A	T	4	3	7	0	1	8	0	0
11	37613572	.	C	T	15	15	30	0	0	30	0	0
11	37613633	.	G	A	1	17	18	0	18	36	0	0
11	37616372	.	T	A	7	14	21	0	0	21	0	0
11	37616775	.	T	C	16	10	26	0	2	28	0	0
11	37616823	.	A	G	9	6	15	0	0	15	0	0
11	37622121	.	G	T	2	2	4	0	1	5	0	0
11	37709031	.	A	C	13	7	20	0	0	20	0	0
11	37709119	.	C	T	9	10	19	0	0	19	0	0
11	37709222	.	C	T	5	4	9	0	1	10	0	0
11	37709303	.	C	A	8	11	19	0	1	20	0	0
11	37709334	.	T	C	5	18	23	0	0	24	1	0
11	37709359	.	C	T	6	14	20	0	1	21	0	0
11	37709450	.	T	C	9	0	9	0	7	16	0	0
11	37709475	.	C	A	2	8	10	0	2	12	0	0
11	37709542	.	T	C	10	3	13	0	2	15	0	0
11	37709545	.	G	A	12	3	15	0	0	15	0	0
11	37709677	.	A	G	3	3	6	0	0	6	0	0
11	37709998	.	A	C	1	3	4	0	0	4	0	0
11	37710026	.	T	A	3	2	5	0	1	6	0	0
11	37710327	.	A	G	3	4	7	0	0	7	0	0
11	37710680	.	A	G	4	4	8	0	0	8	0	0
11	37710709	.	T	C	5	0	5	0	4	9	0	0
11	37710960	.	A	G	5	6	11	0	0	11	0	0
11	37710962	.	A	G	5	6	11	0	0	11	0	0
11	37711005	.	G	A	6	4	10	0	0	10	0	0
11	37711582	.	T	C	2	3	5	0	0	5	0	0
11	37717702	.	G	T	0	1	1	0	0	1	0	0
11	37725854	.	C	T	2	1	3	0	1	4	0	0
11	37830890	.	A	T	1	4	5	0	0	5	0	0
11	37831034	.	T	C	9	3	12	0	1	13	0	0
11	37831082	.	T	G	8	3	11	0	1	12	0	0
11	37831111	.	A	C	2	3	5	0	0	5	0	0
11	37831153	.	A	T	4	1	5	0	0	5	0	0
11	37848961	.	G	A	2	3	5	0	0	5	0	0
11	37854394	.	T	G	0	1	1	0	0	1	0	0
11	37868492	.	G	A	1	4	5	0	0	5	0	0
11	38033264	.	C	T	0	4	4	0	6	10	0	0
11	38033370	.	A	T	0	6	6	0	1	7	0	0
11	38033419	.	C	T	0	2	2	0	4	6	0	0
11	38048821	.	G	A	2	3	5	0	0	5	0	0
11	38332405	.	T	A	1	0	1	0	0	1	0	0
11	38375925	.	C	G	2	0	2	0	5	7	0	0
11	38393213	.	G	A	0	1	1	0	6	7	0	0
11	38413037	.	G	A	2	0	2	0	0	2	0	0
11	38477219	.	G	A	0	3	3	0	0	3	0	0
11	38505380	.	G	A	7	4	11	0	0	11	0	0
11	38505453	.	T	C	8	8	16	0	0	16	0	0
11	38505489	.	G	A	9	5	14	0	0	14	0	0
11	38505781	.	A	G	7	6	13	0	0	13	0	0
11	38506442	.	A	T	0	7	7	0	0	7	0	0
11	38508781	.	A	G	3	3	6	0	0	6	0	0
11	38509151	.	C	T	2	2	4	0	1	5	0	0
11	38509167	.	G	A	2	4	6	0	0	6	0	0
11	38509550	.	T	C	3	3	6	0	0	6	0	0
11	38509553	.	A	C	3	0	3	0	3	6	0	0
11	38509799	.	C	T	3	2	5	0	0	5	0	0
11	38509901	.	A	C	5	2	7	0	0	7	0	0
11	38510312	.	G	A	4	2	6	0	0	6	0	0
11	38510402	.	G	A	3	3	6	0	0	6	0	0
11	38540824	.	C	T	24	17	41	0	1	42	0	0
11	38540870	.	G	A	14	22	36	0	0	37	1	0
11	38541063	.	T	A	17	19	36	0	1	37	0	0
11	38541100	.	A	C	16	22	38	0	0	38	0	0
11	38541355	.	A	G	18	15	33	0	3	36	0	0
11	38541371	.	T	C	18	4	22	0	14	37	1	0
11	38541401	.	C	G	11	19	30	0	1	31	0	0
11	38541484	.	A	G	13	10	23	0	2	25	0	0
11	38541708	.	A	C	11	13	24	0	0	24	0	0
11	38542003	.	G	A	14	16	30	0	2	32	0	0
11	38542142	.	G	A	22	13	35	0	0	35	0	0
11	38542171	.	G	T	8	19	27	0	0	27	0	0
11	38542218	.	G	A	6	14	20	0	1	21	0	0
11	38542305	.	C	T	17	9	26	0	2	28	0	0
11	38542308	.	G	A	18	9	27	0	0	27	0	0
11	38545790	.	G	C	2	1	3	0	0	3	0	0
11	38545826	.	G	T	18	7	25	0	1	26	0	0
11	38807987	.	C	T	11	5	16	0	0	16	0	0
11	38844445	.	G	C	8	3	11	0	0	11	0	0
11	38844481	.	T	C	7	13	20	0	1	21	0	0
11	38846152	.	G	A	1	3	4	0	0	4	0	0
11	38846316	.	T	A	11	9	20	0	1	21	0	0
11	38846361	.	G	A	9	11	20	0	2	22	0	0
11	38850244	.	G	A	0	6	6	0	5	11	0	0
11	38865710	.	A	G	14	16	30	0	2	32	0	0
11	38875221	.	A	G	20	12	32	0	0	32	0	0
11	38875283	.	A	T	14	17	31	0	4	35	0	0
11	38875352	.	G	A	20	12	32	0	0	32	0	0
11	38875397	.	T	G	16	3	19	0	1	20	0	0
11	38875484	.	A	C	14	12	26	0	2	28	0	0
11	38875660	.	T	C	19	12	31	0	1	32	0	0
11	38875867	.	T	C	6	8	14	0	2	16	0	0
11	39044541	.	G	C	7	6	13	0	0	13	0	0
11	39076002	.	T	A	3	4	7	0	0	7	0	0
11	39109555	.	C	T	1	0	1	0	1	2	0	0
11	39109968	.	C	T	3	4	7	0	1	8	0	0
11	39112035	.	A	G	11	12	23	0	0	23	0	0
11	39112578	.	T	G	2	2	4	0	0	4	0	0
11	39112957	.	G	A	1	5	6	0	0	6	0	0
11	39113067	.	G	T	1	2	3	0	0	3	0	0
11	39113143	.	A	G	6	3	9	0	0	9	0	0
11	39113410	.	C	T	0	3	3	0	1	4	0	0
11	39113423	.	C	G	1	2	3	0	0	3	0	0
11	39113548	.	G	A	2	2	4	0	0	4	0	0
11	39114164	.	C	G	1	3	4	0	0	4	0	0
11	39135160	.	T	A	10	9	19	0	0	19	0	0
11	39135834	.	C	G	10	14	24	0	1	25	0	0
11	39141536	.	A	C	28	19	47	0	0	47	0	0
11	39141732	.	T	G	10	16	26	0	2	28	0	0
11	39877711	.	C	T	3	3	6	0	1	7	0	0
11	39878200	.	A	G	5	0	5	0	7	12	0	0
11	39878442	.	A	C	8	11	19	0	1	20	0	0
11	39878503	.	C	A	9	5	14	0	3	17	0	0
11	39878515	.	G	T	0	7	7	0	8	15	0	0
11	39878558	.	A	C	7	6	13	0	1	14	0	0
11	39878740	.	G	A	9	9	18	0	0	18	0	0
11	39878788	.	T	A	7	9	16	0	2	18	0	0
11	39878882	.	A	T	6	5	11	0	0	11	0	0
11	39878980	.	C	T	8	5	13	0	0	13	0	0
11	39879009	.	C	G	4	6	10	0	2	12	0	0
11	39879242	.	C	A	14	6	20	0	0	20	0	0
11	39879316	.	A	G	11	7	18	0	3	21	0	0
11	39905164	.	C	T	12	9	21	0	0	21	0	0
11	39906110	.	C	T	9	18	27	0	0	27	0	0
11	39907021	.	C	G	12	14	26	0	4	30	0	0
11	39907585	.	G	A	1	5	6	0	0	6	0	0
11	39907618	.	C	G	6	8	14	0	0	14	0	0
11	39908020	.	T	G	5	11	16	0	1	17	0	0
11	39922402	.	G	A	1	26	27	0	10	37	0	0
11	39922407	.	G	A	8	22	30	0	4	34	0	0
11	39922714	.	A	C	12	8	20	0	2	22	0	0
11	39923551	.	T	A	18	12	30	0	0	30	0	0
11	39923653	.	C	T	15	16	31	0	0	31	0	0
11	39924083	.	A	T	12	22	34	0	1	35	0	0
11	39924235	.	G	C	13	9	22	0	0	22	0	0
11	39924243	.	G	T	14	8	22	0	0	22	0	0
11	39924341	.	C	G	11	17	28	0	0	28	0	0
11	39924358	.	T	C	9	18	27	0	1	28	0	0
11	39924413	.	G	A	22	9	31	0	0	31	0	0
11	39924639	.	C	T	13	24	37	0	1	38	0	0
11	39924652	.	C	T	16	19	35	0	3	38	0	0
11	39924711	.	A	T	11	21	32	0	2	34	0	0
11	39924736	.	A	G	11	20	31	0	2	33	0	0
11	39924783	.	T	A	15	15	30	0	1	31	0	0
11	39924784	.	A	T	15	13	28	0	3	31	0	0
11	39924929	.	G	A	9	6	15	0	1	16	0	0
11	39924946	.	C	T	11	6	17	0	0	17	0	0
11	39924989	.	G	T	9	19	28	0	2	30	0	0
11	39924999	.	C	T	19	13	32	0	1	33	0	0
11	39925225	.	C	A	11	25	36	0	2	38	0	0
11	39925458	.	G	A	18	12	30	0	6	36	0	0
11	39925529	.	C	T	14	19	33	0	1	34	0	0
11	39926041	.	C	T	18	14	32	0	1	33	0	0
11	39926216	.	A	G	9	9	18	0	1	19	0	0
11	39941661	.	A	G	1	0	1	0	2	3	0	0
11	39949703	.	C	T	2	2	4	0	1	5	0	0
11	39954026	.	T	G	4	10	14	0	0	14	0	0
11	39954319	.	G	A	0	6	6	0	11	17	0	0
11	39969082	.	A	T	0	1	1	0	0	1	0	0
11	39969102	.	C	T	2	3	5	0	0	5	0	0
11	39969123	.	T	A	2	3	5	0	0	5	0	0
11	39969260	.	A	C	5	2	7	0	2	9	0	0
11	39976568	.	G	T	0	4	4	0	0	4	0	0
11	40002096	.	A	T	3	2	5	0	0	5	0	0
11	40009040	.	T	C	3	2	5	0	0	5	0	0
11	40014079	.	A	G	4	2	6	0	0	6	0	0
11	40014346	.	G	A	4	5	9	0	0	9	0	0
11	40014929	.	A	G	2	0	2	0	2	4	0	0
11	40015113	.	G	A	7	4	11	0	1	12	0	0
11	40015380	.	C	G	1	5	6	0	0	6	0	0
11	40015529	.	T	C	6	6	12	0	0	12	0	0
11	40015537	.	G	A	6	5	11	0	0	11	0	0
11	40015696	.	C	T	2	2	4	0	1	5	0	0
11	40016032	.	A	G	8	4	12	0	0	12	0	0
11	40016253	.	C	T	1	4	5	0	0	5	0	0
11	40016261	.	A	T	1	4	5	0	0	5	0	0
11	40016477	.	T	C	3	2	5	0	0	5	0	0
11	40016524	.	G	A	0	1	1	0	4	5	0	0
11	40016528	.	T	C	4	1	5	0	0	5	0	0
11	40016649	.	A	C	4	5	9	0	0	9	0	0
11	40017183	.	G	T	11	7	18	0	0	18	0	0
11	40017290	.	G	C	7	4	11	0	0	11	0	0
11	40017333	.	A	T	4	3	7	0	0	7	0	0
11	40017501	.	A	T	1	3	4	0	0	4	0	0
11	40017504	.	T	A	1	4	5	0	0	5	0	0
11	40017604	.	T	C	10	11	21	0	0	21	0	0
11	40017698	.	T	C	4	8	12	0	0	12	0	0
11	40017865	.	T	A	5	3	8	0	0	8	0	0
11	40017885	.	G	A	4	5	9	0	1	10	0	0
11	40017949	.	A	T	6	4	10	0	0	10	0	0
11	40017994	.	T	C	5	11	16	0	0	16	0	0
11	40018042	.	T	C	6	17	23	0	0	23	0	0
11	40018633	.	G	A	10	4	14	0	0	14	0	0
11	40018668	.	A	T	8	8	16	0	1	17	0	0
11	40018799	.	G	T	0	7	7	0	4	11	0	0
11	40019076	.	G	A	5	3	8	0	1	9	0	0
11	40019078	.	A	G	5	0	5	0	4	9	0	0
11	40019276	.	A	C	3	9	12	0	0	12	0	0
11	40019278	.	T	A	3	9	12	0	0	12	0	0
11	40019411	.	C	T	8	0	8	0	0	8	0	0
11	40020303	.	A	G	7	3	10	0	2	12	0	0
11	40020304	.	G	C	9	3	12	0	0	12	0	0
11	40020354	.	T	C	9	4	13	0	1	14	0	0
11	40020376	.	A	G	3	3	6	0	1	7	0	0
11	40020683	.	G	T	6	11	17	1	2	20	0	0
11	40020760	.	T	C	1	4	5	0	0	5	0	0
11	40020928	.	G	A	12	10	22	0	1	23	0	0
11	40020950	.	A	G	8	4	12	0	3	15	0	0
11	40653819	.	G	A	1	3	4	0	0	4	0	0
11	40657839	.	G	A	9	15	24	0	3	27	0	0
11	40657905	.	G	A	7	11	18	0	4	22	0	0
11	40658022	.	C	T	12	7	19	0	2	21	0	0
11	40658232	.	C	T	5	7	12	0	0	12	0	0
11	40658322	.	T	G	4	4	8	0	0	8	0	0
11	40658352	.	G	A	0	3	3	0	5	8	0	0
11	40661378	.	T	C	3	9	12	0	0	12	0	0
11	40665494	.	C	T	2	1	3	0	1	4	0	0
11	40665602	.	G	T	0	14	14	0	18	32	0	0
11	40673658	.	T	G	6	5	11	0	0	11	0	0
11	40673797	.	C	T	14	8	22	0	1	23	0	0
11	40677967	.	T	C	34	20	54	0	2	56	0	0
11	40678445	.	A	C	31	0	31	0	22	53	0	0
11	40831754	.	A	G	1	0	1	0	1	2	0	0
11	40843055	.	G	T	0	10	10	0	5	15	0	0
11	40843064	.	C	A	4	8	12	0	1	13	0	0
11	40843439	.	A	G	8	0	8	0	8	16	0	0
11	40843502	.	C	T	10	15	25	0	0	25	0	0
11	40843835	.	G	A	0	6	6	0	6	12	0	0
11	40845006	.	C	T	11	21	32	0	2	34	0	0
11	40845071	.	C	T	5	10	15	0	0	15	0	0
11	40845080	.	G	A	1	6	7	0	4	11	0	0
11	40845117	.	T	C	3	8	11	0	3	14	0	0
11	41066190	.	T	G	0	0	0	0	1	1	0	0
11	41066765	.	T	G	16	7	23	0	1	24	0	0
11	41066871	.	C	T	10	12	22	0	0	22	0	0
11	41066888	.	C	T	12	12	24	0	1	25	0	0
11	41066950	.	A	G	16	21	37	0	0	37	0	0
11	41067275	.	G	A	2	13	15	0	0	15	0	0
11	41067430	.	A	T	6	5	11	0	0	11	0	0
11	41067442	.	C	T	6	9	15	0	0	15	0	0
11	41067488	.	A	C	6	10	16	0	1	17	0	0
11	41067502	.	G	A	5	14	19	0	0	19	0	0
11	41078289	.	T	C	2	0	2	0	2	4	0	0
11	41078522	.	C	A	3	7	10	0	0	10	0	0
11	41078578	.	A	T	3	6	9	0	0	9	0	0
11	41078762	.	A	T	2	2	4	0	0	4	0	0
11	41082558	.	G	C	2	1	3	0	0	3	0	0
11	41089631	.	G	T	7	6	13	0	0	13	0	0
11	41089641	.	T	C	6	6	12	0	0	12	0	0
11	41101666	.	A	G	6	9	15	0	0	15	0	0
11	41101800	.	T	A	2	4	6	0	0	6	0	0
11	41101866	.	C	T	0	5	5	0	0	5	0	0
11	41101910	.	G	A	3	3	6	0	0	6	0	0
11	41101918	.	C	T	3	4	7	0	0	7	0	0
11	41101948	.	A	G	4	0	4	0	4	8	0	0
11	41104934	.	G	A	2	5	7	0	0	7	0	0
11	41104954	.	C	T	3	6	9	0	0	9	0	0
11	41105030	.	G	A	0	3	3	0	6	9	0	0
11	41105144	.	T	G	4	0	4	0	4	8	0	0
11	41105210	.	G	A	0	3	3	0	3	6	0	0
11	41111301	.	A	G	5	9	14	0	1	15	0	0
11	41111334	.	T	C	4	11	15	0	1	16	0	0
11	41111370	.	C	T	7	9	16	0	0	16	0	0
11	41111422	.	A	G	4	7	11	0	0	11	0	0
11	41111431	.	A	C	2	4	6	0	0	6	0	0
11	41111561	.	T	A	1	6	7	0	0	7	0	0
11	41111735	.	G	A	10	4	14	0	0	14	0	0
11	41114055	.	C	T	0	3	3	0	4	7	0	0
11	41114186	.	A	C	4	4	8	0	0	8	0	0
11	41125040	.	A	G	1	2	3	0	0	3	0	0
11	41216254	.	C	G	0	2	2	0	2	4	0	0
11	41216315	.	C	T	0	4	4	0	2	6	0	0
11	41216586	.	C	T	3	5	8	0	0	8	0	0
11	41222940	.	A	G	15	13	28	0	0	28	0	0
11	41284762	.	C	T	4	1	5	0	0	5	0	0
11	41306035	.	G	A	0	3	3	0	8	11	0	0
11	41363814	.	T	C	5	9	14	0	0	14	0	0
11	41459981	.	G	C	0	1	1	0	2	3	0	0
11	41461369	.	T	C	6	4	10	0	0	10	0	0
11	41461417	.	C	G	9	12	21	0	1	22	0	0
11	41463534	.	C	G	1	1	2	0	1	3	0	0
11	41468791	.	C	T	3	5	8	0	0	8	0	0
11	41474041	.	T	A	9	10	19	0	1	20	0	0
11	41474042	.	G	T	8	11	19	0	1	20	0	0
11	41666612	.	A	C	0	1	1	0	0	1	0	0
11	41838999	.	G	T	1	2	3	0	1	4	0	0
11	41840493	.	T	C	3	2	5	0	0	5	0	0
11	41844192	.	C	A	1	0	1	0	0	1	0	0
11	41844342	.	T	C	1	3	4	0	0	4	0	0
11	41844396	.	A	G	1	0	1	0	1	2	0	0
11	41846429	.	C	A	6	8	14	0	2	16	0	0
11	41846430	.	C	A	0	7	7	0	9	16	0	0
11	41849977	.	C	T	1	3	4	0	3	7	0	0
11	41850058	.	A	G	4	3	7	0	0	7	0	0
11	41850559	.	G	A	1	0	1	0	0	1	0	0
11	41850565	.	G	A	1	0	1	0	0	1	0	0
11	41938546	.	A	G	0	1	1	0	0	1	0	0
11	41938594	.	G	A	0	2	2	0	0	2	0	0
11	41940293	.	G	A	0	2	2	0	0	2	0	0
11	41946225	.	A	G	3	0	3	0	0	3	0	0
11	41958013	.	C	T	4	3	7	0	1	8	0	0
11	41958058	.	C	T	4	1	5	0	0	5	0	0
11	41958278	.	A	T	2	2	4	0	1	5	0	0
11	41958317	.	T	C	5	8	13	0	0	13	0	0
11	41960058	.	A	C	10	9	19	0	3	22	0	0
11	41960059	.	C	T	13	8	21	0	1	22	0	0
11	41960101	.	A	G	14	12	26	0	0	26	0	0
11	41960111	.	C	T	14	13	27	0	0	27	0	0
11	42128555	.	T	A	3	4	7	0	0	7	0	0
11	42128561	.	G	A	4	3	7	0	0	7	0	0
11	42128627	.	T	C	7	2	9	0	1	10	0	0
11	42128633	.	C	T	6	3	9	0	1	10	0	0
11	42150929	.	A	G	2	0	2	0	0	2	0	0
11	42174601	.	G	A	1	3	4	0	2	6	0	0
11	42305824	.	C	T	6	4	10	0	0	10	0	0
11	42305868	.	C	A	0	4	4	0	6	10	0	0
11	42306414	.	A	G	0	1	1	0	0	1	0	0
11	42307344	.	T	G	11	7	18	0	0	18	0	0
11	42307671	.	G	A	7	9	16	0	0	16	0	0
11	42307816	.	C	T	0	9	9	0	14	23	0	0
11	42315366	.	G	C	9	4	13	0	0	13	0	0
11	42315414	.	A	C	1	0	1	0	4	5	0	0
11	42319372	.	C	A	1	0	1	0	0	1	0	0
11	42325520	.	G	A	1	1	2	0	0	2	0	0
11	42325535	.	C	T	3	4	7	0	0	7	0	0
11	42329113	.	C	T	7	5	12	0	0	12	0	0
11	42350787	.	G	A	6	4	10	0	0	10	0	0
11	42350793	.	G	A	6	3	9	0	1	10	0	0
11	42350847	.	C	T	4	9	13	0	0	13	0	0
11	42353054	.	G	A	7	7	14	0	0	14	0	0
11	42385761	.	A	T	4	5	9	0	0	9	0	0
11	42417409	.	T	C	6	5	11	0	0	11	0	0
11	42418246	.	C	T	6	7	13	0	0	13	0	0
11	42418268	.	A	G	7	5	12	0	0	12	0	0
11	42418310	.	A	T	5	4	9	0	0	9	0	0
11	42457216	.	C	T	1	1	2	0	0	2	0	0
11	42457325	.	T	C	4	3	7	0	0	7	0	0
11	42457328	.	A	C	4	4	8	0	0	8	0	0
11	42500691	.	G	A	1	1	2	0	1	3	0	0
11	42502164	.	C	T	2	2	4	0	0	4	0	0
11	42502328	.	C	T	2	1	3	0	1	4	0	0
11	42502349	.	A	G	0	0	0	0	3	3	0	0
11	42502817	.	G	A	4	3	7	0	1	8	0	0
11	42506201	.	T	G	2	2	4	0	0	4	0	0
11	42521958	.	T	A	1	3	4	0	0	4	0	0
11	42521985	.	G	A	1	4	5	0	0	5	0	0
11	42522076	.	C	A	2	4	6	0	0	6	0	0
11	42522162	.	A	T	4	5	9	0	0	9	0	0
11	42525232	.	T	A	1	3	4	0	0	4	0	0
11	42525345	.	A	T	4	2	6	0	0	6	0	0
11	42525399	.	C	A	0	2	2	0	2	4	0	0
11	42533180	.	C	G	0	10	10	0	8	18	0	0
11	42533237	.	G	A	8	12	20	0	0	20	0	0
11	42560439	.	G	A	22	27	49	0	2	51	0	0
11	42560475	.	C	T	10	13	23	0	3	26	0	0
11	42600856	.	A	T	1	3	4	0	0	4	0	0
11	42600867	.	A	T	2	1	3	0	0	3	0	0
11	42608394	.	T	C	0	4	4	0	0	4	0	0
11	42618675	.	A	G	5	0	5	0	8	13	0	0
11	42618726	.	C	T	3	3	6	0	0	6	0	0
11	42621491	.	G	A	0	4	4	0	2	6	0	0
11	42626276	.	C	T	2	3	5	0	0	5	0	0
11	42730834	.	C	G	5	7	12	0	0	13	1	0
11	42730895	.	C	T	16	11	27	0	1	28	0	0
11	42730901	.	C	T	17	12	29	0	1	30	0	0
11	42730931	.	C	T	12	11	23	0	2	25	0	0
11	42730974	.	T	A	2	4	6	0	0	6	0	0
11	42730982	.	T	C	1	2	3	0	0	3	0	0
11	42731172	.	G	C	4	3	7	0	0	7	0	0
11	42731173	.	G	T	3	3	6	0	1	7	0	0
11	42732496	.	C	T	3	4	7	0	0	7	0	0
11	42732575	.	A	G	0	3	3	0	2	5	0	0
11	42771442	.	G	A	1	2	3	0	0	3	0	0
11	42783985	.	G	A	1	4	5	0	0	5	0	0
11	42801451	.	A	T	1	2	3	0	1	4	0	0
11	42808988	.	C	T	8	5	13	0	2	15	0	0
11	42809162	.	G	A	0	5	5	0	4	9	0	0
11	42809233	.	A	G	1	6	7	0	0	7	0	0
11	42809288	.	T	C	7	2	9	0	0	9	0	0
11	42809300	.	T	C	6	2	8	0	0	8	0	0
11	42809345	.	T	C	3	5	8	0	0	8	0	0
11	42809438	.	G	C	4	5	9	0	0	9	0	0
11	42809579	.	T	G	3	4	7	0	0	7	0	0
11	42809657	.	G	T	0	3	3	0	2	5	0	0
11	42809683	.	T	A	0	3	3	0	0	3	0	0
11	42809717	.	G	A	0	0	0	0	2	2	0	0
11	42815207	.	C	A	4	5	9	0	1	10	0	0
11	42816262	.	C	G	3	0	3	0	9	12	0	0
11	42816263	.	G	C	8	3	11	0	1	12	0	0
11	42816921	.	C	A	1	1	2	0	0	2	0	0
11	42817067	.	A	G	3	1	4	0	0	4	0	0
11	42817113	.	A	T	2	3	5	0	1	6	0	0
11	42817257	.	T	G	3	11	14	0	0	14	0	0
11	42817359	.	A	T	2	4	6	0	2	8	0	0
11	42817411	.	T	C	5	7	12	0	1	13	0	0
11	42817459	.	A	T	3	8	11	0	0	11	0	0
11	42817476	.	G	C	0	6	6	0	2	8	0	0
11	42817534	.	G	A	12	7	19	0	0	19	0	0
11	42817552	.	A	G	11	9	20	0	1	21	0	0
11	42817604	.	G	T	4	8	12	0	1	13	0	0
11	42912098	.	T	C	2	3	5	0	0	5	0	0
11	42912126	.	A	G	1	2	3	0	0	3	0	0
11	42912723	.	A	G	3	3	6	0	0	6	0	0
11	42915665	.	G	A	1	3	4	0	0	4	0	0
11	42933167	.	G	A	3	3	6	0	1	7	0	0
11	42933703	.	T	C	7	3	10	0	1	11	0	0
11	42940748	.	C	T	1	2	3	0	0	3	0	0
11	42942852	.	T	C	3	1	4	0	0	4	0	0
11	42942930	.	G	A	3	3	6	0	0	6	0	0
11	42947471	.	A	G	0	2	2	0	1	3	0	0
11	42947480	.	G	A	1	4	5	0	0	5	0	0
11	42949086	.	T	C	1	1	2	0	4	6	0	0
11	42949819	.	G	A	3	1	4	0	1	5	0	0
11	42949828	.	T	G	3	4	7	0	0	7	0	0
11	42954479	.	G	A	2	1	3	0	0	3	0	0
11	42956694	.	A	G	0	3	3	0	0	3	0	0
11	42971336	.	A	G	2	1	3	0	0	3	0	0
11	42971441	.	C	T	2	1	3	0	1	4	0	0
11	42974959	.	G	T	2	2	4	0	0	4	0	0
11	42974962	.	G	A	2	2	4	0	0	4	0	0
11	42975395	.	A	T	0	3	3	0	0	3	0	0
11	42975432	.	C	G	0	2	2	0	0	2	0	0
11	42978318	.	A	T	2	4	6	0	0	6	0	0
11	43045604	.	G	A	1	3	4	0	0	4	0	0
11	43137659	.	C	T	22	30	52	0	1	53	0	0
11	43151260	.	C	T	18	24	42	0	2	44	0	0
11	43164302	.	G	T	13	11	24	0	4	28	0	0
11	43170699	.	A	G	20	17	37	0	0	37	0	0
11	43170804	.	G	A	19	17	36	0	1	37	0	0
11	43170924	.	A	G	19	12	31	0	1	32	0	0
11	43170992	.	G	T	20	19	39	0	2	41	0	0
11	43171230	.	T	A	9	12	21	0	0	21	0	0
11	43171263	.	G	A	15	6	21	0	0	21	0	0
11	43171281	.	A	G	5	18	23	0	0	23	0	0
11	43171314	.	A	G	16	7	23	0	1	24	0	0
11	43178811	.	T	A	3	4	7	0	1	8	0	0
11	43178823	.	G	A	4	7	11	0	1	12	0	0
11	43178958	.	C	T	13	9	22	0	0	22	0	0
11	43178991	.	G	A	10	11	21	0	2	23	0	0
11	43179248	.	T	G	8	11	19	0	0	19	0	0
11	43179639	.	G	A	4	6	10	0	0	10	0	0
11	43179651	.	A	G	2	2	4	0	0	4	0	0
11	43189115	.	G	A	3	5	8	0	0	8	0	0
11	43189118	.	G	A	3	5	8	0	0	8	0	0
11	43190846	.	G	A	2	1	3	0	2	5	0	0
11	43200347	.	C	T	3	4	7	0	0	7	0	0
11	43200419	.	T	A	10	7	17	0	2	19	0	0
11	43387546	.	T	C	3	2	5	0	0	5	0	0
11	43387562	.	C	T	2	2	4	0	0	4	0	0
11	43411231	.	C	T	4	3	7	0	0	7	0	0
11	43470332	.	T	C	5	4	9	0	0	9	0	0
11	43470473	.	T	A	5	4	9	0	1	10	0	0
11	43470619	.	C	T	1	2	3	0	0	3	0	0
11	43712829	.	T	C	1	2	3	0	0	3	0	0
11	44024006	.	C	T	0	1	1	0	0	1	0	0
11	44144697	.	T	C	1	4	5	0	0	5	0	0
11	44144749	.	A	C	9	17	26	0	0	26	0	0
11	44144820	.	A	G	18	15	33	0	2	35	0	0
11	44144928	.	G	A	25	23	48	0	1	49	0	0
11	44145001	.	T	A	27	23	50	0	4	54	0	0
11	44148453	.	A	G	23	16	39	0	0	39	0	0
11	44149701	.	T	C	7	0	7	0	7	14	0	0
11	44152693	.	T	G	23	19	42	0	2	44	0	0
11	44152750	.	A	G	25	18	43	0	3	46	0	0
11	44153038	.	G	A	11	1	12	0	1	13	0	0
11	44155583	.	T	C	4	3	7	0	0	7	0	0
11	44155640	.	C	A	7	13	20	0	0	20	0	0
11	44155703	.	C	A	7	14	21	0	0	21	0	0
11	44155766	.	G	T	0	2	2	0	0	2	0	0
11	44157752	.	G	A	8	13	21	0	0	21	0	0
11	44157872	.	C	T	1	2	3	0	0	3	0	0
11	44159320	.	G	C	2	5	7	0	0	7	0	0
11	44161525	.	A	G	7	8	15	0	0	15	0	0
11	44244880	.	T	C	1	3	4	0	0	4	0	0
11	44244895	.	T	C	0	2	2	0	0	2	0	0
11	44329172	.	C	T	10	10	20	0	0	20	0	0
11	44329208	.	G	A	2	0	2	0	0	2	0	0
11	44334915	.	C	T	18	20	38	0	3	41	0	0
11	44335201	.	A	T	6	4	10	0	2	12	0	0
11	44356772	.	T	A	6	5	11	0	0	11	0	0
11	44356791	.	A	G	4	4	8	0	2	10	0	0
11	44358904	.	C	T	3	9	12	0	2	14	0	0
11	44359735	.	C	T	7	5	12	0	0	12	0	0
11	44361689	.	C	G	10	7	17	0	0	17	0	0
11	44361701	.	C	T	8	10	18	0	1	19	0	0
11	44400918	.	G	A	1	8	9	0	0	9	0	0
11	44400960	.	G	T	4	6	10	0	0	10	0	0
11	44442530	.	C	T	11	2	13	0	0	13	0	0
11	44445500	.	G	A	4	2	6	0	0	6	0	0
11	44445554	.	A	G	3	9	12	0	1	13	0	0
11	44445561	.	C	T	3	9	12	0	0	12	0	0
11	44445733	.	A	G	8	0	8	0	4	12	0	0
11	44445736	.	C	T	8	5	13	0	0	13	0	0
11	44445828	.	T	C	3	4	7	0	0	7	0	0
11	44452732	.	T	C	7	8	15	0	1	16	0	0
11	44452849	.	G	A	6	6	12	0	0	12	0	0
11	44452886	.	A	G	2	5	7	0	0	7	0	0
11	44455901	.	C	T	12	7	19	0	0	19	0	0
11	44457239	.	G	A	7	9	16	0	0	16	0	0
11	44457254	.	A	G	4	7	11	0	0	11	0	0
11	44461386	.	G	C	9	6	15	0	1	16	0	0
11	44461458	.	G	A	13	11	24	0	0	24	0	0
11	44466931	.	T	C	0	3	3	0	0	3	0	0
11	44468838	.	G	A	0	7	7	0	0	7	0	0
11	44468842	.	T	C	0	5	5	0	0	5	0	0
11	44483622	.	G	T	1	2	3	0	0	3	0	0
11	44484548	.	A	G	0	1	1	0	0	1	0	0
11	44502515	.	T	G	1	3	4	0	1	5	0	0
11	44502554	.	C	T	2	2	4	0	1	5	0	0
11	44502592	.	G	A	3	3	6	0	0	6	0	0
11	44523348	.	A	G	5	2	7	0	0	7	0	0
11	44606844	.	G	T	10	8	18	0	0	18	0	0
11	44607019	.	T	A	9	3	12	0	0	12	0	0
11	44607052	.	G	A	11	4	15	0	0	15	0	0
11	44619132	.	A	T	1	0	1	0	0	1	0	0
11	44624723	.	A	C	5	3	8	0	0	8	0	0
11	44633294	.	T	C	6	1	7	0	0	7	0	0
11	44634908	.	G	A	0	6	6	0	3	9	0	0
11	44637569	.	T	A	4	6	10	0	0	10	0	0
11	44637950	.	A	G	26	22	48	0	2	50	0	0
11	44643882	.	C	T	2	2	4	0	0	4	0	0
11	44647227	.	A	C	27	0	27	0	20	47	0	0
11	44647269	.	T	G	20	13	33	0	0	33	0	0
11	44723130	.	C	G	6	10	16	0	0	16	0	0
11	44723353	.	G	A	2	14	16	0	16	32	0	0
11	44723374	.	T	C	14	20	34	0	3	37	0	0
11	44723416	.	T	G	15	1	16	0	24	40	0	0
11	44723653	.	T	G	20	14	34	0	0	34	0	0
11	44723746	.	A	G	16	21	37	0	4	41	0	0
11	44725596	.	C	T	18	23	41	0	0	41	0	0
11	44725926	.	G	A	1	22	23	0	29	52	0	0
11	44805701	.	G	A	1	1	2	0	0	2	0	0
11	44834268	.	G	A	0	1	1	0	1	2	0	0
11	44838743	.	G	A	0	1	1	0	4	5	0	0
11	44852248	.	A	G	6	0	6	0	11	17	0	0
11	44852285	.	C	A	5	7	12	0	0	12	0	0
11	44852732	.	G	A	0	2	2	0	2	4	0	0
11	44852756	.	A	T	2	3	5	0	1	6	0	0
11	44852771	.	T	A	4	4	8	0	0	8	0	0
11	44852988	.	T	A	4	2	6	0	1	7	0	0
11	44853325	.	T	C	3	4	7	0	0	7	0	0
11	44853670	.	C	T	1	2	3	0	0	3	0	0
11	44853908	.	A	T	9	3	12	0	0	12	0	0
11	44854146	.	T	A	2	2	4	0	0	4	0	0
11	44854631	.	C	T	2	6	8	0	0	8	0	0
11	44854636	.	G	T	2	4	6	0	1	7	0	0
11	44854894	.	T	G	13	8	21	0	2	23	0	0
11	44854918	.	G	A	0	9	9	0	14	23	0	0
11	44854996	.	T	C	12	10	22	0	0	22	0	0
11	44855027	.	G	A	0	14	14	0	12	26	0	0
11	44880288	.	A	G	11	17	28	0	4	32	0	0
11	44880291	.	T	A	10	22	32	0	2	34	0	0
11	44880332	.	G	A	18	8	26	0	1	27	0	0
11	44880345	.	C	G	7	15	22	0	0	22	0	0
11	44887200	.	G	A	10	10	20	0	1	21	0	0
11	44887224	.	T	C	7	0	7	0	7	14	0	0
11	44887612	.	G	T	13	15	28	0	1	29	0	0
11	44891507	.	G	A	1	4	5	0	0	5	0	0
11	44892859	.	T	A	1	1	2	0	0	2	0	0
11	44892883	.	G	A	4	4	8	0	0	8	0	0
11	44892943	.	G	A	12	8	20	0	0	20	0	0
11	44892979	.	T	A	3	3	6	0	0	6	0	0
11	44897584	.	C	T	10	14	24	0	2	26	0	0
11	44897647	.	A	C	9	11	20	0	2	22	0	0
11	44901315	.	C	T	1	5	6	0	10	16	0	0
11	44901373	.	C	A	23	35	58	0	4	62	0	0
11	44906468	.	A	G	0	1	1	0	0	1	0	0
11	44910758	.	T	G	1	1	2	0	0	2	0	0
11	44912485	.	C	A	0	2	2	0	4	6	0	0
11	44912992	.	C	T	0	0	0	0	1	1	0	0
11	44913176	.	C	A	0	4	4	0	6	10	0	0
11	44914943	.	G	C	10	9	19	0	0	19	0	0
11	44922524	.	T	G	2	4	6	0	0	6	0	0
11	44927159	.	C	A	2	1	3	0	0	3	0	0
11	44927833	.	G	T	1	1	2	0	0	2	0	0
11	44935375	.	A	G	0	3	3	0	0	3	0	0
11	44939425	.	G	A	0	2	2	0	0	2	0	0
11	44960620	.	G	A	3	2	5	0	0	5	0	0
11	45098121	.	A	C	1	2	3	0	0	3	0	0
11	45122734	.	A	G	0	2	2	0	0	2	0	0
11	45125627	.	T	C	2	2	4	0	0	4	0	0
11	45126658	.	C	T	0	11	11	0	10	21	0	0
11	45126913	.	A	T	1	3	4	0	0	4	0	0
11	45126985	.	A	G	3	2	5	0	0	5	0	0
11	45127029	.	C	T	3	3	6	0	1	7	0	0
11	45127191	.	G	A	4	10	14	0	1	15	0	0
11	45127266	.	A	G	4	6	10	0	0	10	0	0
11	45127329	.	G	A	5	7	12	0	0	12	0	0
11	45127335	.	C	T	0	4	4	0	8	12	0	0
11	45127374	.	G	A	6	4	10	0	0	10	0	0
11	45129347	.	C	A	2	3	5	0	0	5	0	0
11	45130909	.	G	A	2	3	5	0	0	5	0	0
11	45131119	.	C	T	2	3	5	0	1	6	0	0
11	45140020	.	T	G	2	4	6	0	0	6	0	0
11	45140116	.	C	G	4	8	12	0	0	12	0	0
11	45140210	.	G	C	0	1	1	0	0	1	0	0
11	45141286	.	T	C	3	1	4	0	1	5	0	0
11	45143417	.	G	T	3	1	4	0	0	4	0	0
11	45240568	.	C	T	0	2	2	0	0	2	0	0
11	45242360	.	T	C	5	2	7	0	7	14	0	0
11	45242450	.	C	T	1	2	3	0	0	3	0	0
11	45242912	.	T	C	3	0	3	0	0	3	0	0
11	45244372	.	C	T	0	1	1	0	0	1	0	0
11	45244861	.	G	T	1	0	1	0	0	1	0	0
11	45245862	.	G	A	3	3	6	0	0	6	0	0
11	45245964	.	C	T	0	4	4	0	2	6	0	0
11	45262079	.	C	T	8	9	17	0	0	17	0	0
11	45262178	.	C	T	5	9	14	0	0	14	0	0
11	45262186	.	G	A	1	6	7	0	8	15	0	0
11	45262342	.	C	T	10	11	21	0	0	21	0	0
11	45265829	.	G	A	0	1	1	0	0	1	0	0
11	45265898	.	C	T	3	6	9	0	0	9	0	0
11	45269752	.	T	C	1	0	1	0	0	1	0	0
11	45272686	.	G	A	0	3	3	0	1	4	0	0
11	45287575	.	G	A	1	6	7	0	0	7	0	0
11	45290839	.	A	G	0	0	0	0	3	3	0	0
11	45291926	.	G	A	0	4	4	0	0	4	0	0
11	45327056	.	T	C	2	2	4	0	1	5	0	0
11	45327493	.	T	G	2	2	4	0	0	4	0	0
11	45327508	.	A	G	3	1	4	0	0	4	0	0
11	45327609	.	T	C	4	2	6	0	0	6	0	0
11	45328046	.	C	T	3	2	5	0	0	5	0	0
11	45343231	.	T	A	2	5	7	0	0	7	0	0
11	45343264	.	A	T	3	4	7	0	0	7	0	0
11	45343492	.	G	C	0	3	3	0	2	5	0	0
11	45344090	.	C	T	0	1	1	0	0	1	0	0
11	45348465	.	G	A	1	1	2	0	1	3	0	0
11	45355022	.	C	G	11	8	19	1	0	20	0	0
11	45355155	.	C	T	4	9	13	0	0	13	0	0
11	45355436	.	C	G	13	17	30	0	0	30	0	0
11	45355473	.	C	T	0	18	18	0	10	28	0	0
11	45355717	.	A	G	12	7	19	0	0	19	0	0
11	45356114	.	G	A	9	9	18	0	2	20	0	0
11	45356352	.	G	A	3	6	9	0	0	9	0	0
11	45356666	.	A	G	3	4	7	0	0	7	0	0
11	45359878	.	C	T	1	3	4	0	0	4	0	0
11	45362172	.	A	T	3	10	13	0	2	15	0	0
11	45362862	.	T	C	1	2	3	0	0	3	0	0
11	45370259	.	G	A	4	3	7	0	0	7	0	0
11	45371831	.	A	G	0	1	1	0	0	1	0	0
11	45371868	.	A	G	1	4	5	0	0	5	0	0
11	45375266	.	G	T	1	2	3	0	0	3	0	0
11	45385555	.	C	T	2	0	2	0	0	2	0	0
11	45389891	.	G	A	3	4	7	0	0	7	0	0
11	45390057	.	G	A	3	3	6	0	0	6	0	0
11	45391683	.	G	A	1	7	8	0	11	19	0	0
11	45391725	.	A	G	10	3	13	0	1	14	0	0
11	45391727	.	T	C	10	4	14	0	0	14	0	0
11	45391788	.	C	T	2	4	6	0	0	6	0	0
11	45393395	.	C	T	7	12	19	0	1	20	0	0
11	45393520	.	A	C	1	4	5	0	13	18	0	0
11	45398744	.	A	G	2	8	10	0	1	11	0	0
11	45398804	.	T	C	11	4	15	0	1	16	0	0
11	45399589	.	A	G	23	15	38	0	3	41	0	0
11	45399799	.	G	T	11	9	20	0	0	20	0	0
11	45402861	.	G	A	11	10	21	0	0	21	0	0
11	45402945	.	G	A	17	9	26	0	1	27	0	0
11	45403209	.	A	T	19	12	31	0	1	32	0	0
11	45403712	.	G	A	9	17	26	0	2	28	0	0
11	45403733	.	G	A	18	9	27	0	0	27	0	0
11	45403854	.	G	A	14	14	28	0	1	29	0	0
11	45403866	.	G	A	11	12	23	0	1	24	0	0
11	45403914	.	C	T	0	2	2	0	3	5	0	0
11	45407215	.	G	A	2	2	4	0	0	4	0	0
11	45410613	.	A	G	5	4	9	0	1	10	0	0
11	45419948	.	C	G	0	1	1	0	1	2	0	0
11	45428466	.	A	T	0	1	1	0	0	1	0	0
11	45448187	.	G	A	0	1	1	0	0	1	0	0
11	45448277	.	G	A	0	2	2	0	1	3	0	0
11	45448289	.	C	T	1	2	3	0	0	3	0	0
11	45452373	.	C	T	3	3	6	0	0	6	0	0
11	45460337	.	G	A	9	5	14	0	0	14	0	0
11	45461318	.	G	A	0	11	11	0	14	25	0	0
11	45463352	.	T	C	2	1	3	0	0	3	0	0
11	45463490	.	G	T	2	11	13	0	21	34	0	0
11	45463730	.	G	A	0	14	14	0	14	28	0	0
11	45464041	.	T	C	1	7	8	0	0	8	0	0
11	45464098	.	A	G	1	6	7	0	2	9	0	0
11	45464132	.	A	G	2	4	6	0	0	6	0	0
11	45464188	.	G	C	2	5	7	0	2	9	0	0
11	45464673	.	C	T	6	5	11	0	1	12	0	0
11	45465080	.	T	A	11	4	15	0	1	16	0	0
11	45468821	.	A	C	5	2	7	0	0	7	0	0
11	45468899	.	C	T	0	3	3	0	2	5	0	0
11	45468906	.	T	A	4	2	6	0	0	6	0	0
11	45469766	.	A	G	5	3	8	0	0	8	0	0
11	45469775	.	T	C	6	2	8	0	0	8	0	0
11	45469882	.	T	C	2	3	5	0	0	5	0	0
11	45469914	.	G	T	1	4	5	0	1	6	0	0
11	45470243	.	C	T	3	5	8	0	8	16	0	0
11	45470277	.	C	T	4	7	11	0	1	12	0	0
11	45470279	.	C	A	2	5	7	0	5	12	0	0
12	1387384	.	A	C	1	2	3	0	0	3	0	0
12	1387902	.	T	C	1	2	3	0	0	3	0	0
12	1388107	.	G	A	2	3	5	0	0	5	0	0
12	1388305	.	A	T	1	5	6	0	1	7	0	0
12	1388344	.	C	T	2	4	6	0	0	6	0	0
12	1398661	.	T	A	4	11	15	0	0	15	0	0
12	1406346	.	C	G	0	2	2	0	2	4	0	0
12	1947596	.	T	C	2	0	2	0	6	8	0	0
12	1947645	.	G	A	2	3	5	0	0	5	0	0
12	1947656	.	A	T	2	2	4	0	1	5	0	0
12	1947999	.	G	A	2	7	9	0	1	10	0	0
12	2488237	.	C	T	2	2	4	0	0	4	0	0
12	2488770	.	C	T	3	3	6	0	0	6	0	0
12	2488808	.	C	T	3	3	6	0	0	6	0	0
12	2488815	.	T	C	2	3	5	0	0	5	0	0
12	2492299	.	A	G	4	4	8	0	0	8	0	0
12	2492423	.	G	T	0	4	4	0	6	10	0	0
12	2505557	.	T	G	13	9	22	0	1	23	0	0
12	2505614	.	G	A	8	10	18	0	2	20	0	0
12	2505921	.	G	C	10	0	10	0	14	24	0	0
12	2506007	.	A	G	19	3	22	0	0	22	0	0
12	2506027	.	G	A	19	5	24	0	2	26	0	0
12	2507295	.	G	A	0	2	2	0	0	2	0	0
12	2514396	.	G	T	4	3	7	0	0	7	0	0
12	2514434	.	G	T	3	2	5	0	0	5	0	0
12	2516187	.	T	C	1	0	1	0	4	5	0	0
12	2518125	.	T	C	1	0	1	0	3	4	0	0
12	2518220	.	G	A	1	1	2	0	0	2	0	0
12	2743988	.	A	C	5	2	7	0	1	8	0	0
12	2744549	.	A	G	3	2	5	0	0	5	0	0
12	2780796	.	G	T	1	2	3	0	0	3	0	0
12	2829919	.	G	C	1	1	2	0	0	2	0	0
12	2833422	.	C	G	0	1	1	0	0	1	0	0
12	2833488	.	C	A	0	1	1	0	0	1	0	0
12	2843700	.	C	G	3	0	3	0	3	6	0	0
12	2846146	.	G	T	0	0	0	0	3	3	0	0
12	2846164	.	G	C	1	5	6	0	0	6	0	0
12	2846215	.	G	A	1	3	4	0	1	5	0	0
12	2848162	.	C	T	5	2	7	0	2	9	0	0
12	2849970	.	A	G	2	4	6	0	0	6	0	0
12	2849974	.	A	G	3	3	6	0	1	7	0	0
12	2850023	.	A	G	4	2	6	0	0	6	0	0
12	2850025	.	A	G	3	3	6	0	0	6	0	0
12	2850096	.	C	T	7	3	10	0	1	12	1	0
12	2850569	.	T	C	3	4	7	0	1	8	0	0
12	2850623	.	G	A	2	6	8	0	0	8	0	0
12	2850637	.	G	A	3	10	13	0	0	13	0	0
12	2850816	.	T	C	2	1	3	0	4	7	0	0
12	2851070	.	T	A	3	6	9	0	0	9	0	0
12	2851126	.	C	T	4	4	8	0	1	9	0	0
12	2851355	.	C	T	4	3	7	0	0	7	0	0
12	2869468	.	T	G	0	2	2	0	0	2	0	0
12	2869479	.	T	C	1	2	3	0	0	3	0	0
12	2870733	.	G	A	0	1	1	0	1	2	0	0
12	2893006	.	G	A	0	3	3	0	0	3	0	0
12	2895248	.	T	C	7	4	11	0	0	11	0	0
12	2895264	.	G	T	0	8	8	0	2	10	0	0
12	2895389	.	T	G	8	3	11	0	0	11	0	0
12	2895463	.	A	G	2	6	8	0	0	8	0	0
12	2996070	.	A	G	1	0	1	0	3	4	0	0
12	3003904	.	T	C	1	1	2	0	0	2	0	0
12	3022947	.	C	A	9	15	24	0	3	27	0	0
12	3033357	.	T	C	13	15	28	0	1	29	0	0
12	3033360	.	A	C	13	15	28	0	1	29	0	0
12	3038920	.	G	A	3	26	29	0	19	48	0	0
12	3038929	.	A	G	24	2	26	0	21	47	0	0
12	3039078	.	G	C	0	21	21	0	24	45	0	0
12	3039210	.	C	T	27	18	45	0	2	47	0	0
12	3039283	.	T	A	5	19	24	0	0	24	0	0
12	3039311	.	T	C	8	17	25	0	2	27	0	0
12	3039321	.	A	G	8	18	26	0	0	26	0	0
12	3039423	.	G	A	1	11	12	0	12	24	0	0
12	3039522	.	T	C	21	16	37	0	1	38	0	0
12	3039652	.	T	C	18	36	54	0	2	56	0	0
12	3039682	.	A	C	19	25	44	0	1	45	0	0
12	3039940	.	A	G	17	19	36	0	1	37	0	0
12	3040158	.	A	T	12	10	22	0	1	23	0	0
12	3040178	.	T	C	15	10	25	0	0	25	0	0
12	3040329	.	A	G	16	15	31	0	0	31	0	0
12	3040370	.	G	A	0	16	16	0	4	20	0	0
12	3040819	.	T	A	15	9	24	0	2	26	0	0
12	3041087	.	C	A	3	7	10	0	3	13	0	0
12	3041088	.	G	T	1	7	8	0	5	13	0	0
12	3041179	.	T	A	20	14	34	0	1	35	0	0
12	3041390	.	A	T	18	17	35	0	3	38	0	0
12	3041497	.	G	A	0	16	16	0	17	33	0	0
12	3041587	.	A	T	22	18	40	0	4	44	0	0
12	3041606	.	A	T	27	16	43	0	3	47	1	0
12	3041721	.	G	A	0	17	17	0	35	52	0	0
12	3041871	.	C	T	23	17	40	0	11	51	0	0
12	3041905	.	C	A	13	30	43	0	1	44	0	0
12	3049366	.	G	C	1	0	1	0	0	1	0	0
12	3059630	.	G	T	2	1	3	0	0	3	0	0
12	3059634	.	G	C	2	2	4	0	0	4	0	0
12	3059668	.	G	T	2	2	4	0	0	4	0	0
12	3059691	.	C	T	0	2	2	0	0	2	0	0
12	3060156	.	A	G	3	2	5	0	0	5	0	0
12	3072985	.	A	G	4	3	7	0	1	8	0	0
12	3092782	.	G	A	4	3	7	0	0	7	0	0
12	3092826	.	G	C	2	2	4	0	0	4	0	0
12	3271553	.	G	A	5	6	11	0	1	12	0	0
12	3272148	.	A	G	6	3	9	0	0	9	0	0
12	3272483	.	A	G	8	5	13	0	0	13	0	0
12	3714650	.	T	C	1	4	5	0	0	5	0	0
12	3714934	.	T	C	6	7	13	0	2	15	0	0
12	3714977	.	T	C	3	0	3	0	16	19	0	0
12	3715544	.	T	C	9	7	16	0	0	16	0	0
12	3805977	.	T	C	2	2	4	0	0	4	0	0
12	3805979	.	G	A	2	2	4	0	0	4	0	0
12	3806810	.	C	T	3	3	6	0	0	6	0	0
12	3807942	.	G	A	1	2	3	0	0	3	0	0
12	3807948	.	C	T	1	2	3	0	0	3	0	0
12	3808832	.	G	A	1	3	4	0	0	4	0	0
12	3811570	.	C	G	0	3	3	0	5	8	0	0
12	3855125	.	G	A	1	0	1	0	0	1	0	0
12	3860868	.	T	C	2	4	6	0	0	6	0	0
12	3860893	.	G	A	2	5	7	0	0	7	0	0
12	3861246	.	A	G	3	3	6	0	0	6	0	0
12	3871480	.	C	T	0	1	1	0	0	1	0	0
12	3875596	.	A	G	5	4	9	0	1	10	0	0
12	3875892	.	A	G	2	0	2	0	2	4	0	0
12	3875931	.	A	G	1	0	1	0	6	7	0	0
12	3877941	.	G	A	4	3	7	0	0	7	0	0
12	3880610	.	A	G	2	2	4	0	0	4	0	0
12	3880612	.	G	T	2	2	4	0	0	4	0	0
12	3880646	.	C	A	3	2	5	0	0	5	0	0
12	3880661	.	A	G	3	0	3	0	1	4	0	0
12	3885358	.	C	T	0	1	1	0	0	1	0	0
12	3889922	.	C	T	1	2	3	0	0	3	0	0
12	3889974	.	A	G	4	0	4	0	4	8	0	0
12	3921537	.	T	A	2	3	5	0	0	5	0	0
12	3921813	.	G	A	3	3	6	0	0	6	0	0
12	3922503	.	C	T	3	3	6	0	0	6	0	0
12	3944265	.	T	C	2	4	6	0	1	7	0	0
12	3944488	.	C	G	0	21	21	0	33	54	0	0
12	3944543	.	A	G	18	13	31	0	2	33	0	0
12	3947484	.	A	G	12	21	33	0	0	33	0	0
12	3947902	.	G	A	21	20	41	0	1	42	0	0
12	3947929	.	A	G	17	23	40	0	1	41	0	0
12	3948701	.	G	A	26	29	55	0	0	55	0	0
12	3949194	.	A	G	16	26	42	0	2	44	0	0
12	3949212	.	G	A	15	24	39	0	0	39	0	0
12	3951117	.	C	T	8	3	11	0	0	11	0	0
12	3953946	.	A	G	13	16	29	0	1	30	0	0
12	3954072	.	C	T	3	10	13	0	0	13	0	0
12	3955573	.	A	C	5	0	5	0	2	7	0	0
12	3957973	.	A	G	22	10	32	0	1	33	0	0
12	3964599	.	A	G	10	14	24	0	1	25	0	0
12	3964631	.	G	A	7	15	22	0	0	22	0	0
12	3964770	.	A	G	5	15	20	0	1	21	0	0
12	3964936	.	C	A	5	14	19	0	0	19	0	0
12	3964937	.	C	G	5	14	19	0	0	19	0	0
12	3965237	.	G	A	0	2	2	0	1	3	0	0
12	3967756	.	A	G	5	7	12	0	1	13	0	0
12	3971655	.	A	G	1	9	10	0	0	10	0	0
12	3978242	.	T	G	2	5	7	0	0	7	0	0
12	3998833	.	A	T	5	2	7	0	0	7	0	0
12	3998925	.	T	A	2	3	5	0	0	5	0	0
12	3998943	.	T	C	2	3	5	0	0	5	0	0
12	4002615	.	A	T	1	3	4	0	0	4	0	0
12	4002687	.	C	A	3	3	6	0	1	7	0	0
12	4004237	.	T	G	0	2	2	0	0	2	0	0
12	4004255	.	T	G	0	2	2	0	0	2	0	0
12	4004361	.	G	A	5	5	10	0	1	11	0	0
12	4004367	.	G	T	5	4	9	0	1	10	0	0
12	4004466	.	C	T	0	2	2	0	1	3	0	0
12	4009165	.	A	G	0	4	4	0	0	4	0	0
12	4009393	.	G	C	1	2	3	0	2	5	0	0
12	4014416	.	G	A	2	3	5	0	0	5	0	0
12	4144988	.	G	A	1	3	4	0	0	4	0	0
12	4144992	.	T	A	0	3	3	0	0	3	0	0
12	4226483	.	T	A	2	3	5	0	0	5	0	0
12	4226492	.	G	C	1	2	3	0	0	3	0	0
12	4226846	.	T	A	1	3	4	0	1	5	0	0
12	4227308	.	C	G	5	2	7	0	0	7	0	0
12	4227632	.	G	A	0	0	0	0	1	1	0	0
12	4231548	.	C	T	4	2	6	0	0	6	0	0
12	4231990	.	A	G	3	1	4	0	0	4	0	0
12	4232028	.	G	A	0	4	4	0	5	9	0	0
12	4232055	.	G	C	8	5	13	0	0	13	0	0
12	4232208	.	C	G	6	7	13	0	0	13	0	0
12	4232210	.	T	A	6	7	13	0	0	13	0	0
12	4232313	.	A	G	3	0	3	0	5	8	0	0
12	4232369	.	G	T	6	3	9	0	1	10	0	0
12	4238464	.	A	G	14	0	14	0	9	23	0	0
12	4238519	.	C	A	5	13	18	0	2	20	0	0
12	4601769	.	A	G	22	17	39	0	1	40	0	0
12	4602322	.	G	A	18	18	36	0	0	36	0	0
12	4602436	.	A	T	11	10	21	0	4	25	0	0
12	4602464	.	G	C	12	0	12	0	13	25	0	0
12	4602503	.	C	A	16	19	35	0	1	36	0	0
12	4606693	.	G	A	8	4	12	0	0	12	0	0
12	4609172	.	T	G	7	7	14	0	0	14	0	0
12	4609343	.	C	G	0	6	6	0	10	16	0	0
12	4611092	.	C	T	1	3	4	0	4	8	0	0
12	4611521	.	T	C	6	0	6	0	15	21	0	0
12	4615281	.	T	C	11	0	11	0	7	18	0	0
12	4615329	.	G	A	8	12	20	0	0	20	0	0
12	4616974	.	G	A	19	6	25	0	1	26	0	0
12	4617024	.	G	T	13	8	21	0	2	23	0	0
12	4617070	.	T	C	11	10	21	0	3	24	0	0
12	4617091	.	T	C	12	10	22	0	2	24	0	0
12	4617286	.	T	C	17	0	17	0	14	31	0	0
12	4617304	.	A	G	17	10	27	0	0	27	0	0
12	4618033	.	C	T	2	2	4	0	1	5	0	0
12	4618087	.	T	G	11	7	18	0	1	19	0	0
12	4618588	.	G	A	3	5	8	0	0	8	0	0
12	4619718	.	C	T	6	4	10	0	0	10	0	0
12	4619895	.	G	A	4	10	14	0	0	14	0	0
12	4620211	.	T	A	11	8	19	0	2	21	0	0
12	4620483	.	C	T	0	8	8	0	6	14	0	0
12	4621060	.	C	T	1	3	4	0	0	4	0	0
12	4621363	.	C	G	0	4	4	0	1	5	0	0
12	4621618	.	A	G	11	9	20	0	1	21	0	0
12	4621909	.	G	T	8	7	15	0	1	16	0	0
12	4622884	.	G	A	2	3	5	0	0	5	0	0
12	4622899	.	A	G	2	0	2	0	0	2	0	0
12	4631461	.	G	A	2	4	6	0	0	6	0	0
12	4632074	.	A	G	1	2	3	0	0	3	0	0
12	4632078	.	C	T	2	2	4	0	0	4	0	0
12	4644028	.	A	C	1	2	3	0	0	3	0	0
12	4644090	.	C	T	3	6	9	0	0	9	0	0
12	4645262	.	C	G	4	4	8	0	0	8	0	0
12	4721721	.	C	G	4	1	5	0	0	5	0	0
12	4721727	.	A	G	3	0	3	0	1	4	0	0
12	4722415	.	C	T	4	9	13	0	1	14	0	0
12	4724397	.	A	T	4	0	4	0	0	4	0	0
12	4724455	.	A	G	14	0	14	0	6	20	0	0
12	4724464	.	T	C	15	7	22	0	1	23	0	0
12	4724634	.	G	A	0	4	4	0	4	8	0	0
12	4724710	.	G	A	11	7	18	0	0	18	0	0
12	4724765	.	G	A	0	2	2	0	6	8	0	0
12	4724787	.	T	G	4	7	11	0	0	11	0	0
12	4724983	.	G	A	7	6	13	0	1	14	0	0
12	4725114	.	A	C	5	3	8	0	0	8	0	0
12	4725371	.	A	G	8	8	16	0	3	19	0	0
12	4962027	.	A	G	2	3	5	0	0	5	0	0
12	6465898	.	T	C	2	1	3	0	0	3	0	0
12	6465919	.	T	C	1	2	3	0	1	4	0	0
12	6465982	.	C	T	2	2	4	0	0	4	0	0
12	6543197	.	G	A	2	2	4	0	1	5	0	0
12	6543906	.	G	C	9	9	18	0	0	18	0	0
12	6549689	.	A	G	0	1	1	0	0	1	0	0
12	6584481	.	C	T	0	1	1	0	0	1	0	0
12	6606982	.	G	A	1	4	5	0	1	6	0	0
12	6612744	.	T	C	2	0	2	0	0	2	0	0
12	6713949	.	G	A	3	2	5	0	1	6	0	0
12	6742562	.	A	G	1	0	1	0	0	1	0	0
12	6756277	.	A	G	1	1	2	0	1	3	0	0
12	6766140	.	C	T	0	1	1	0	0	1	0	0
12	7194423	.	T	C	19	0	19	0	11	30	0	0
12	7194932	.	G	A	8	6	14	0	1	16	1	0
12	7195024	.	T	C	5	12	17	0	1	18	0	0
12	7195139	.	A	T	14	5	19	0	3	22	0	0
12	7195192	.	G	T	9	13	22	0	2	24	0	0
12	7195365	.	T	C	6	9	15	0	1	16	0	0
12	7195454	.	T	A	9	10	19	0	1	20	0	0
12	7195518	.	A	C	12	8	20	0	0	20	0	0
12	7195524	.	G	T	12	5	17	0	3	20	0	0
12	7195600	.	T	C	12	8	20	0	0	20	0	0
12	7195676	.	C	T	1	7	8	0	6	14	0	0
12	7195888	.	T	C	6	6	12	1	0	13	0	0
12	7196059	.	G	A	13	12	25	0	1	26	0	0
12	7196114	.	G	A	10	9	19	0	2	21	0	0
12	7196175	.	G	A	6	6	12	0	0	12	0	0
12	7196201	.	G	A	5	5	10	0	0	10	0	0
12	7196230	.	A	T	3	5	8	0	1	9	0	0
12	7196346	.	G	A	4	9	13	0	0	13	0	0
12	7196392	.	T	A	8	3	11	0	2	13	0	0
12	7196404	.	A	T	8	3	11	0	0	11	0	0
12	7196456	.	A	G	4	3	7	0	0	7	0	0
12	7196639	.	A	G	4	3	7	0	0	7	0	0
12	7197112	.	G	A	3	2	5	0	0	5	0	0
12	7197278	.	A	G	4	4	8	0	1	9	0	0
12	7197280	.	A	T	4	4	8	0	1	9	0	0
12	7197584	.	A	G	5	2	7	0	0	7	0	0
12	7198142	.	T	C	2	0	2	0	9	11	0	0
12	7198625	.	C	A	3	2	5	0	0	5	0	0
12	7199215	.	T	A	3	3	6	0	0	6	0	0
12	7199229	.	C	A	5	3	8	0	0	8	0	0
12	7199738	.	A	G	0	3	3	0	0	3	0	0
12	7199759	.	T	C	0	1	1	0	0	1	0	0
12	7254324	.	A	T	2	1	3	0	0	3	0	0
12	7263777	.	C	T	3	4	7	0	0	7	0	0
12	7268804	.	T	C	2	2	4	0	0	4	0	0
12	7269266	.	G	A	2	0	2	0	0	2	0	0
12	7269673	.	G	A	3	2	5	0	0	5	0	0
12	7269679	.	A	C	2	0	2	0	1	3	0	0
12	7271805	.	A	C	0	1	1	0	0	1	0	0
12	7271895	.	A	G	4	6	10	0	1	11	0	0
12	7275695	.	T	C	3	1	4	0	1	5	0	0
12	7280057	.	C	T	3	6	9	0	0	9	0	0
12	7454704	.	C	T	2	1	3	0	0	3	0	0
12	7504066	.	C	T	2	1	3	0	0	3	0	0
12	7507050	.	C	T	2	2	4	0	0	4	0	0
12	7507073	.	A	G	2	2	4	0	0	4	0	0
12	7512347	.	T	C	6	8	14	0	1	15	0	0
12	7512469	.	C	T	10	5	15	0	0	15	0	0
12	7512637	.	T	C	6	14	20	0	4	24	0	0
12	7512788	.	G	A	0	4	4	0	9	13	0	0
12	7512793	.	T	C	3	9	12	0	1	13	0	0
12	7513613	.	G	A	0	4	4	0	13	17	0	0
12	7513650	.	G	A	12	4	16	0	0	16	0	0
12	7589579	.	G	A	5	4	9	0	0	9	0	0
12	7589581	.	T	G	5	4	9	0	0	9	0	0
12	7589795	.	A	G	10	5	15	0	0	15	0	0
12	7589816	.	A	G	9	5	14	0	0	14	0	0
12	7589845	.	C	A	7	4	11	0	0	11	0	0
12	7589917	.	C	G	3	3	6	0	1	7	0	0
12	7589995	.	C	A	5	6	11	0	1	12	0	0
12	7590024	.	C	A	8	5	13	0	0	13	0	0
12	7595179	.	C	T	7	7	14	0	0	14	0	0
12	7595204	.	G	A	8	7	15	0	1	16	0	0
12	7595726	.	C	A	4	5	9	0	1	10	0	0
12	7597751	.	T	C	1	1	2	0	0	2	0	0
12	7610033	.	A	G	7	4	11	0	0	11	0	0
12	7610236	.	A	T	5	3	8	0	2	10	0	0
12	7610354	.	C	T	0	2	2	0	2	4	0	0
12	7610478	.	T	A	5	8	13	0	2	15	0	0
12	7610532	.	T	G	3	6	9	0	0	9	0	0
12	7610663	.	T	C	5	0	5	0	7	12	0	0
12	7610740	.	T	C	10	6	16	0	0	16	0	0
12	7610969	.	T	C	5	4	9	0	0	9	0	0
12	7611510	.	C	T	4	4	8	0	0	8	0	0
12	7611514	.	C	T	3	5	8	0	0	8	0	0
12	7611595	.	A	G	7	4	11	0	0	11	0	0
12	7611625	.	G	T	5	7	12	0	0	12	0	0
12	7611751	.	A	C	4	4	8	0	1	9	0	0
12	7612117	.	G	A	5	4	9	0	0	9	0	0
12	7612852	.	G	T	3	2	5	0	0	5	0	0
12	7620242	.	G	T	4	1	5	0	1	6	0	0
12	7628945	.	A	C	2	0	2	0	0	2	0	0
12	7629226	.	T	C	1	4	5	0	0	5	0	0
12	7633156	.	A	G	3	2	5	0	0	5	0	0
12	7757781	.	A	G	5	4	9	0	0	9	0	0
12	7785502	.	C	A	1	1	2	0	3	5	0	0
12	7792956	.	A	G	0	2	2	0	0	2	0	0
12	7801357	.	T	A	1	1	2	0	0	2	0	0
12	7805033	.	C	G	0	2	2	0	2	4	0	0
12	7805039	.	A	G	2	2	4	0	0	4	0	0
12	7853833	.	G	T	1	2	3	0	1	4	0	0
12	7853846	.	A	T	4	2	6	0	0	6	0	0
12	8018992	.	C	T	1	2	3	0	0	3	0	0
12	8019361	.	T	C	1	2	3	0	0	3	0	0
12	8019406	.	T	C	2	4	6	0	0	6	0	0
12	8033554	.	C	T	2	0	2	0	0	2	0	0
12	8227133	.	T	C	5	2	7	0	0	7	0	0
12	8227145	.	G	C	4	2	6	0	2	8	0	0
12	8307569	.	G	A	0	1	1	0	2	3	0	0
12	8307615	.	A	G	2	0	2	0	2	4	0	0
12	8307734	.	A	C	0	3	3	0	0	3	0	0
12	8656201	.	C	T	1	0	1	0	0	1	0	0
12	8822961	.	T	C	1	4	5	0	0	5	0	0
12	8877343	.	A	C	3	3	6	0	0	6	0	0
12	8877412	.	T	C	5	4	9	0	0	9	0	0
12	8881469	.	G	A	3	5	8	0	0	8	0	0
12	8881470	.	C	G	5	3	8	0	0	8	0	0
12	8882062	.	G	T	3	3	6	0	0	6	0	0
12	8882142	.	G	A	0	3	3	0	1	4	0	0
12	8882143	.	A	C	0	3	3	0	1	4	0	0
12	8968456	.	T	A	4	7	11	0	1	12	0	0
12	8968487	.	T	A	3	10	13	0	2	15	0	0
12	8968721	.	A	G	15	14	29	0	0	29	0	0
12	8968979	.	C	A	7	11	18	0	0	18	0	0
12	8969084	.	T	C	12	11	23	0	1	24	0	0
12	8969102	.	C	T	1	14	15	0	15	30	0	0
12	8969155	.	C	G	17	10	27	0	2	29	0	0
12	8969426	.	T	C	5	7	12	0	1	13	0	0
12	8969485	.	T	C	10	14	24	0	0	24	0	0
12	8969499	.	G	A	10	17	27	0	1	28	0	0
12	8987502	.	T	C	0	1	1	0	0	1	0	0
12	8997654	.	A	G	0	1	1	0	0	1	0	0
12	9010979	.	G	A	3	5	8	0	0	8	0	0
12	9010988	.	C	T	1	6	7	0	5	12	0	0
12	9039610	.	G	A	2	2	4	0	0	4	0	0
12	9049343	.	C	T	9	5	14	0	0	14	0	0
12	9064504	.	G	A	2	0	2	0	0	2	0	0
12	9084590	.	T	C	4	5	9	0	1	10	0	0
12	9188488	.	A	G	2	5	7	0	0	7	0	0
12	9190882	.	T	C	1	0	1	0	0	1	0	0
12	9200402	.	C	T	1	3	4	0	0	4	0	0
12	9206038	.	T	C	5	3	8	0	0	8	0	0
12	9206044	.	C	T	5	3	8	0	0	8	0	0
12	9208468	.	T	G	1	0	1	0	5	6	0	0
12	9210441	.	G	A	0	2	2	0	0	2	0	0
12	9210489	.	T	C	5	5	10	0	1	11	0	0
12	9210504	.	A	G	5	5	10	0	0	10	0	0
12	9210528	.	C	T	3	4	7	0	0	7	0	0
12	9217989	.	A	G	1	0	1	0	0	1	0	0
12	9218054	.	T	C	8	4	12	0	2	14	0	0
12	9218142	.	A	G	4	2	6	0	0	6	0	0
12	9218176	.	T	C	1	3	4	0	0	4	0	0
12	9218183	.	G	A	1	3	4	0	0	4	0	0
12	9218229	.	A	G	1	1	2	0	1	3	0	0
12	9452838	.	T	C	1	0	1	0	2	3	0	0
12	9452880	.	G	C	1	1	2	0	0	2	0	0
12	9463678	.	T	C	3	1	4	0	0	4	0	0
12	9463879	.	G	A	1	1	2	0	0	2	0	0
12	9463885	.	G	A	1	1	2	0	0	2	0	0
12	9468373	.	C	T	0	3	3	0	4	7	0	0
12	9468440	.	G	A	1	2	3	0	1	4	0	0
12	9623751	.	T	C	1	2	3	0	0	3	0	0
12	9626057	.	A	C	1	4	5	0	0	5	0	0
12	9627980	.	A	G	3	2	5	0	0	5	0	0
12	9628007	.	T	C	0	1	1	0	0	1	0	0
12	9630730	.	G	A	2	1	3	0	0	3	0	0
12	9630745	.	G	A	1	1	2	0	0	2	0	0
12	9633827	.	G	A	8	7	15	0	1	16	0	0
12	9636616	.	A	G	4	4	8	0	1	9	0	0
12	9640309	.	C	T	1	3	4	0	0	4	0	0
12	9658251	.	G	A	2	1	3	0	0	3	0	0
12	9658260	.	A	G	1	0	1	0	1	2	0	0
12	9703260	.	C	T	3	7	10	0	1	11	0	0
12	9703831	.	C	T	3	6	9	0	0	9	0	0
12	9704233	.	T	C	4	4	8	0	0	8	0	0
12	9704254	.	G	T	6	6	12	0	2	14	0	0
12	9704431	.	C	T	6	8	14	0	0	14	0	0
12	9704443	.	G	T	0	6	6	0	6	12	0	0
12	9744544	.	C	T	3	5	8	0	0	8	0	0
12	9749830	.	A	G	10	4	14	0	0	14	0	0
12	9755833	.	C	T	5	15	20	0	4	24	0	0
12	9755869	.	A	G	2	12	14	0	1	15	0	0
12	9761792	.	C	T	8	8	16	0	1	17	0	0
12	9769880	.	A	T	4	3	7	0	0	7	0	0
12	9773157	.	G	A	3	2	5	0	0	5	0	0
12	9773281	.	C	T	4	4	8	0	1	10	1	0
12	9773308	.	G	A	5	7	12	0	1	13	0	0
12	9773465	.	G	A	0	13	13	0	6	19	0	0
12	9781701	.	T	G	2	3	5	0	0	5	0	0
12	9782230	.	C	T	4	2	6	0	0	6	0	0
12	9782404	.	G	A	3	4	7	0	2	9	0	0
12	9782428	.	T	C	4	7	11	0	0	11	0	0
12	9782756	.	G	A	1	3	4	0	0	4	0	0
12	9783145	.	G	A	5	4	9	0	0	9	0	0
12	9783596	.	G	A	1	1	2	0	1	3	0	0
12	9790384	.	C	T	1	2	3	0	0	3	0	0
12	9817737	.	A	T	9	10	19	0	0	19	0	0
12	9817771	.	C	T	13	10	23	0	0	23	0	0
12	9817883	.	T	A	11	6	17	0	2	19	0	0
12	9824735	.	C	T	14	6	20	0	0	20	0	0
12	9824762	.	C	A	9	16	25	0	0	25	0	0
12	9824807	.	C	A	2	3	5	0	0	5	0	0
12	9829697	.	C	T	2	0	2	0	0	2	0	0
12	9830983	.	G	A	2	8	10	0	0	10	0	0
12	9830986	.	G	A	8	1	9	0	2	11	0	0
12	9883526	.	G	A	16	29	45	0	1	46	0	0
12	9883849	.	C	T	29	36	65	0	1	66	0	0
12	9883944	.	C	T	38	22	60	0	2	62	0	0
12	9884248	.	A	T	1	6	7	0	0	7	0	0
12	9884259	.	T	A	1	5	6	0	0	6	0	0
12	9953545	.	G	A	2	2	4	0	0	4	0	0
12	9981077	.	G	A	2	2	4	0	0	4	0	0
12	10124691	.	G	T	5	3	8	0	0	8	0	0
12	10124815	.	T	G	10	5	15	0	4	19	0	0
12	10124819	.	C	T	8	6	14	0	4	18	0	0
12	10125030	.	G	T	0	3	3	0	5	8	0	0
12	10125031	.	C	A	5	2	7	0	1	8	0	0
12	10125342	.	A	G	2	2	4	0	0	4	0	0
12	10125359	.	A	G	3	2	5	0	0	5	0	0
12	10167070	.	A	G	0	2	2	0	0	2	0	0
12	10169521	.	T	C	8	7	15	0	0	15	0	0
12	10169614	.	G	A	14	17	31	0	0	31	0	0
12	10169884	.	G	T	8	11	19	0	2	21	0	0
12	10175161	.	C	T	0	2	2	0	0	2	0	0
12	10199695	.	A	G	21	15	36	0	0	36	0	0
12	10199760	.	A	T	10	17	27	0	0	27	0	0
12	10199869	.	C	T	0	14	14	0	14	28	0	0
12	10200028	.	A	G	21	18	39	0	1	40	0	0
12	10209431	.	A	G	9	8	17	0	2	19	0	0
12	10209452	.	T	A	3	5	8	0	1	9	0	0
12	10217660	.	C	T	12	6	18	0	1	19	0	0
12	10217708	.	C	T	5	3	8	0	0	8	0	0
12	10220000	.	G	T	2	1	3	0	0	3	0	0
12	10220117	.	A	G	1	0	1	0	0	1	0	0
12	10243911	.	C	T	1	2	3	0	0	3	0	0
12	10243926	.	C	T	2	3	5	0	0	5	0	0
12	10243971	.	A	C	3	2	5	0	0	5	0	0
12	10304660	.	T	A	5	7	12	0	1	13	0	0
12	10304706	.	G	A	4	3	7	0	0	7	0	0
12	10313241	.	G	A	5	1	6	0	0	6	0	0
12	10369038	.	G	T	3	3	6	0	0	6	0	0
12	10369153	.	T	G	1	5	6	0	0	6	0	0
12	10369459	.	T	G	3	2	5	0	0	5	0	0
12	10369466	.	C	T	0	2	2	0	3	5	0	0
12	10369780	.	A	G	2	2	4	0	0	4	0	0
12	10370170	.	T	G	3	2	5	0	0	5	0	0
12	10382220	.	C	T	7	3	10	0	0	10	0	0
12	10382588	.	C	T	7	2	9	0	1	10	0	0
12	10384982	.	G	A	7	4	11	0	0	11	0	0
12	10387071	.	A	G	5	6	11	0	0	11	0	0
12	10391883	.	C	T	1	1	2	0	0	2	0	0
12	10398820	.	A	G	3	1	4	0	0	4	0	0
12	10399471	.	G	A	1	0	1	0	0	1	0	0
12	10399766	.	T	C	3	2	5	0	0	5	0	0
12	10412190	.	C	G	0	2	2	0	2	4	0	0
12	10412477	.	A	G	1	2	3	0	1	4	0	0
12	10412825	.	A	C	3	2	5	0	0	5	0	0
12	10424741	.	C	G	0	9	9	0	10	19	0	0
12	10425346	.	T	C	7	9	16	0	1	17	0	0
12	10425465	.	C	T	1	2	3	0	0	3	0	0
12	10425586	.	G	T	2	1	3	0	0	3	0	0
12	10425630	.	A	T	1	2	3	0	0	3	0	0
12	10429054	.	G	A	6	6	12	0	1	13	0	0
12	10429105	.	C	A	0	2	2	0	0	2	0	0
12	10439619	.	C	A	2	2	4	0	1	5	0	0
12	10439641	.	T	G	2	3	5	0	0	5	0	0
12	10439662	.	G	A	2	2	4	0	1	5	0	0
12	10439686	.	T	C	2	0	2	0	0	2	0	0
12	10443916	.	G	T	5	5	10	0	0	10	0	0
12	10443923	.	T	C	4	2	6	0	1	7	0	0
12	10444321	.	A	T	5	3	8	0	0	8	0	0
12	10465000	.	A	C	10	10	20	0	0	20	0	0
12	10465182	.	A	C	4	5	9	0	0	9	0	0
12	10471105	.	A	G	4	2	6	0	0	6	0	0
12	10471120	.	T	C	2	0	2	0	4	6	0	0
12	10471159	.	G	A	2	1	3	0	0	3	0	0
12	10478804	.	C	A	0	2	2	0	2	4	0	0
12	10478857	.	T	C	3	4	7	0	1	8	0	0
12	10478961	.	G	T	3	4	7	0	0	7	0	0
12	10482230	.	C	A	1	2	3	0	0	3	0	0
12	10482792	.	T	G	6	2	8	0	0	8	0	0
12	10487620	.	G	T	1	3	4	0	0	4	0	0
12	10487662	.	G	C	2	0	2	0	3	5	0	0
12	10503774	.	A	T	2	2	4	0	0	4	0	0
12	10646482	.	A	T	1	1	2	0	0	2	0	0
12	10651719	.	T	C	2	0	2	0	5	7	0	0
12	10651761	.	A	G	3	4	7	0	0	7	0	0
12	10679279	.	T	G	7	3	10	0	0	10	0	0
12	10679289	.	G	A	2	6	8	0	0	8	0	0
12	10682392	.	A	G	1	1	2	0	0	2	0	0
12	10688640	.	C	T	11	5	16	0	1	17	0	0
12	10688704	.	G	A	6	11	17	0	5	22	0	0
12	10705765	.	T	A	5	6	11	0	1	12	0	0
12	10705775	.	C	G	6	5	11	0	1	12	0	0
12	10733464	.	C	T	1	2	3	0	0	3	0	0
12	10733494	.	C	A	2	3	5	0	0	5	0	0
12	11389082	.	T	C	7	3	10	0	0	10	0	0
12	11389229	.	T	C	11	7	18	0	0	18	0	0
12	11390305	.	T	C	4	3	7	0	0	7	0	0
12	11390306	.	T	C	4	2	6	0	1	7	0	0
12	11390365	.	T	C	2	5	7	0	0	7	0	0
12	11762849	.	A	T	9	9	18	0	0	18	0	0
12	13473277	.	A	G	4	2	6	0	0	6	0	0
12	13473314	.	A	G	4	2	6	0	1	7	0	0
12	13474461	.	A	G	15	7	22	0	1	23	0	0
12	13475225	.	A	G	14	7	21	0	0	21	0	0
12	16099066	.	C	T	3	2	5	0	0	5	0	0
12	18529360	.	A	T	3	2	5	0	0	5	0	0
12	18694220	.	A	C	2	0	2	0	0	2	0	0
12	18713926	.	C	T	8	4	12	0	0	12	0	0
12	18714000	.	C	T	13	5	18	0	1	19	0	0
12	18716985	.	C	T	6	7	13	0	0	13	0	0
12	18717085	.	A	G	8	14	22	0	0	22	0	0
12	18717471	.	T	C	3	4	7	0	0	7	0	0
12	18717477	.	T	A	3	5	8	0	0	8	0	0
12	18779450	.	T	A	0	1	1	0	0	1	0	0
12	18779648	.	T	C	1	0	1	0	0	1	0	0
12	18782541	.	G	A	10	6	16	0	2	18	0	0
12	18782763	.	G	A	3	1	4	0	0	4	0	0
12	18786773	.	T	C	4	14	18	0	1	19	0	0
12	18786917	.	T	C	14	12	26	0	0	26	0	0
12	18787009	.	G	A	12	8	20	0	0	20	0	0
12	18787205	.	C	T	5	6	11	0	0	11	0	0
12	18794074	.	C	A	4	2	6	0	0	6	0	0
12	18795943	.	T	C	1	0	1	0	4	5	0	0
12	18895837	.	T	C	2	2	4	0	0	4	0	0
12	18913503	.	A	G	6	6	12	0	0	12	0	0
12	18913850	.	A	G	15	6	21	0	0	21	0	0
12	18914010	.	A	G	4	8	12	0	0	12	0	0
12	18914021	.	A	G	7	5	12	0	0	12	0	0
12	19062233	.	A	G	16	5	21	0	1	22	0	0
12	19317745	.	G	A	21	2	23	0	0	23	0	0
12	19317791	.	G	A	25	22	47	0	1	48	0	0
12	19317875	.	G	A	20	15	35	0	3	38	0	0
12	19317930	.	G	T	0	14	14	0	17	31	0	0
12	19318157	.	T	C	11	20	31	0	0	31	0	0
12	19318158	.	G	A	10	20	30	0	1	31	0	0
12	19318194	.	G	C	13	20	33	0	1	34	0	0
12	19318210	.	T	C	13	23	36	0	1	37	0	0
12	19318441	.	A	T	5	7	12	0	1	13	0	0
12	19318475	.	G	A	4	5	9	0	0	10	1	0
12	19318487	.	C	A	3	7	10	0	1	11	0	0
12	19318539	.	G	A	4	16	20	0	1	21	0	0
12	19318615	.	A	T	11	11	22	0	5	27	0	0
12	19318823	.	A	G	8	0	8	1	14	23	0	0
12	19318855	.	C	T	7	21	28	0	1	29	0	0
12	19319085	.	T	G	1	3	4	0	0	4	0	0
12	19337850	.	G	A	3	4	7	0	0	7	0	0
12	19338003	.	G	T	2	5	7	0	0	7	0	0
12	19338032	.	T	A	2	2	4	0	0	4	0	0
12	19338280	.	G	A	7	6	13	1	0	14	0	0
12	19338387	.	T	G	7	6	13	0	0	13	0	0
12	19338819	.	T	A	3	2	5	0	0	5	0	0
12	19338821	.	G	T	3	1	4	0	1	5	0	0
12	19339065	.	G	T	4	4	8	0	0	8	0	0
12	19339257	.	A	G	1	4	5	0	0	5	0	0
12	19340086	.	A	G	3	2	5	0	0	5	0	0
12	19340180	.	C	T	1	1	2	0	1	3	0	0
12	19341869	.	G	A	19	13	32	0	1	33	0	0
12	19348622	.	A	G	19	23	42	0	1	43	0	0
12	19348678	.	T	C	15	16	31	0	0	31	0	0
12	19353091	.	C	T	18	22	40	0	2	42	0	0
12	19353174	.	C	T	10	18	28	0	1	29	0	0
12	19353203	.	A	C	16	16	32	0	0	32	0	0
12	19353513	.	A	G	11	9	20	0	3	23	0	0
12	19353622	.	A	T	13	14	27	0	0	27	0	0
12	19362426	.	T	C	1	4	5	0	0	5	0	0
12	19362500	.	C	T	6	4	10	0	0	10	0	0
12	19362624	.	A	G	7	7	14	0	1	15	0	0
12	19369292	.	G	A	4	10	14	0	0	14	0	0
12	19369414	.	A	G	4	1	5	0	0	5	0	0
12	19371801	.	A	G	5	0	5	0	4	9	0	0
12	19373175	.	G	A	2	2	4	0	1	5	0	0
12	19375729	.	T	C	3	2	5	0	0	5	0	0
12	19375741	.	C	T	3	1	4	0	1	5	0	0
12	19379564	.	G	C	0	11	11	0	6	17	0	0
12	19379642	.	C	T	5	4	9	0	1	10	0	0
12	19380120	.	A	G	0	3	3	0	0	3	0	0
12	19383137	.	A	G	8	9	17	0	0	17	0	0
12	19383139	.	T	C	7	8	15	0	2	17	0	0
12	19383217	.	T	C	13	6	19	0	1	20	0	0
12	19383242	.	T	A	9	7	16	0	1	17	0	0
12	19383260	.	A	T	7	7	14	0	2	16	0	0
12	19383417	.	T	C	10	7	17	0	1	18	0	0
12	19383539	.	C	T	9	4	13	0	0	13	0	0
12	19383843	.	G	A	5	3	8	0	1	9	0	0
12	19385072	.	G	A	1	2	3	0	0	3	0	0
12	19385664	.	C	T	3	3	6	0	0	6	0	0
12	19393863	.	A	G	2	3	5	0	0	5	0	0
12	19393875	.	A	G	2	2	4	0	0	4	0	0
12	19408650	.	G	T	0	1	1	0	2	3	0	0
12	19412850	.	C	T	1	1	2	0	0	2	0	0
12	19422319	.	T	C	5	4	9	0	0	9	0	0
12	19422410	.	G	A	0	2	2	0	4	6	0	0
12	19430068	.	G	A	0	3	3	0	0	3	0	0
12	19433542	.	C	G	1	2	3	0	0	3	0	0
12	19447036	.	C	T	1	0	1	0	0	1	0	0
12	19637039	.	T	G	6	11	17	0	1	18	0	0
12	19658488	.	G	T	2	5	7	0	2	9	0	0
12	19658505	.	T	C	2	3	5	0	0	5	0	0
12	19658587	.	A	G	2	5	7	0	1	8	0	0
12	19658626	.	C	T	1	4	5	0	1	6	0	0
12	19658691	.	A	G	4	0	4	0	9	13	0	0
12	19658735	.	A	T	8	9	17	0	1	18	0	0
12	19658836	.	G	A	6	9	15	0	2	17	0	0
12	19792385	.	G	A	3	2	5	0	0	5	0	0
12	19792566	.	T	C	6	11	17	0	1	18	0	0
12	19792945	.	C	G	10	6	16	0	1	17	0	0
12	19792970	.	G	A	12	12	24	0	1	25	0	0
12	19793001	.	G	A	18	13	31	0	0	31	0	0
12	19793039	.	T	A	15	11	26	0	1	27	0	0
12	19793470	.	C	G	16	19	35	0	2	37	0	0
12	19793534	.	T	A	12	15	27	0	2	29	0	0
12	19793657	.	G	A	7	11	18	0	1	19	0	0
12	19793693	.	A	G	3	2	5	0	0	5	0	0
12	19865090	.	T	C	8	1	9	0	12	21	0	0
12	19865347	.	C	T	8	11	19	0	0	19	0	0
12	19865567	.	G	A	5	8	13	0	0	13	0	0
12	19866983	.	A	G	3	3	6	0	1	7	0	0
12	19907100	.	A	T	1	1	2	0	0	2	0	0
12	19931421	.	T	C	1	2	3	0	1	4	0	0
12	19931970	.	A	T	3	3	6	0	0	6	0	0
12	19932072	.	T	C	7	3	10	0	0	10	0	0
12	19932122	.	C	A	4	4	8	0	2	10	0	0
12	19932195	.	A	T	4	5	9	0	0	9	0	0
12	19967552	.	A	G	0	1	1	0	0	1	0	0
12	19967554	.	A	G	0	1	1	0	0	1	0	0
12	19970362	.	T	A	2	3	5	0	1	6	0	0
12	19973564	.	T	C	4	3	7	0	0	7	0	0
12	19974092	.	G	A	0	8	8	0	6	14	0	0
12	19974196	.	G	A	4	2	6	0	0	6	0	0
12	19974421	.	T	G	1	2	3	0	0	3	0	0
12	19974460	.	T	C	1	2	3	0	0	3	0	0
12	19992114	.	T	A	1	1	2	0	0	2	0	0
12	20026573	.	T	G	2	3	5	0	0	5	0	0
12	20026597	.	G	A	1	3	4	0	0	4	0	0
12	20029538	.	G	A	1	1	2	0	0	2	0	0
12	20034735	.	T	C	4	1	5	0	1	6	0	0
12	20034744	.	T	C	3	3	6	0	0	6	0	0
12	20044390	.	T	A	2	2	4	0	1	5	0	0
12	20099085	.	A	G	12	11	23	0	0	23	0	0
12	20099478	.	A	G	11	13	24	0	0	24	0	0
12	20099657	.	T	C	12	11	23	0	0	23	0	0
12	20099708	.	T	A	5	11	16	0	0	16	0	0
12	20100109	.	A	G	11	10	21	0	0	21	0	0
12	20100169	.	A	G	14	17	31	0	0	31	0	0
12	20100190	.	T	C	13	0	13	0	13	26	0	0
12	20100391	.	G	A	15	13	28	0	0	28	0	0
12	20122600	.	G	C	3	3	6	0	0	6	0	0
12	20122709	.	A	T	5	3	8	0	1	9	0	0
12	20122785	.	T	C	5	8	13	0	0	13	0	0
12	20123320	.	G	A	1	0	1	0	0	1	0	0
12	20123881	.	A	C	2	4	6	0	0	6	0	0
12	20125561	.	A	G	5	0	5	0	5	10	0	0
12	20147218	.	G	C	15	6	21	0	2	23	0	0
12	20147229	.	A	G	15	1	16	0	0	16	0	0
12	20147260	.	G	A	12	4	16	0	0	16	0	0
12	20147428	.	G	A	15	7	22	0	2	24	0	0
12	20147486	.	A	G	10	1	11	0	12	23	0	0
12	20147504	.	T	C	12	10	22	0	2	24	0	0
12	20147564	.	A	T	12	9	21	0	0	21	0	0
12	20149786	.	G	A	0	2	2	0	2	4	0	0
12	20155804	.	T	A	1	2	3	0	1	4	0	0
12	20227724	.	A	G	2	3	5	0	0	5	0	0
12	20378924	.	G	T	1	1	2	0	0	2	0	0
12	20378942	.	T	G	1	1	2	0	0	2	0	0
12	20379323	.	A	T	4	3	7	0	0	7	0	0
12	20379356	.	A	C	7	3	10	0	0	10	0	0
12	20379586	.	G	C	3	5	8	0	2	10	0	0
12	20380050	.	C	G	2	1	3	0	0	3	0	0
12	20396459	.	T	A	6	3	9	0	0	9	0	0
12	20406815	.	T	C	1	0	1	0	0	1	0	0
12	20406818	.	G	A	1	0	1	0	0	1	0	0
12	20407789	.	A	G	2	2	4	0	0	4	0	0
12	20409495	.	G	T	5	5	10	0	0	10	0	0
12	20409523	.	A	G	8	7	15	0	0	15	0	0
12	20455225	.	G	A	1	2	3	0	0	3	0	0
12	20455228	.	A	G	1	2	3	0	0	3	0	0
12	20478586	.	T	C	1	2	3	0	1	4	0	0
12	20478606	.	C	A	2	0	2	0	2	4	0	0
12	20478784	.	T	C	1	2	3	0	0	3	0	0
12	20607308	.	C	T	1	2	3	0	1	4	0	0
12	20607515	.	G	A	7	2	9	0	1	10	0	0
12	20608370	.	T	A	1	4	5	0	0	5	0	0
12	20608397	.	G	A	3	6	9	0	0	9	0	0
12	20608518	.	C	T	2	4	6	0	1	7	0	0
12	20651401	.	G	T	3	2	5	0	0	5	0	0
12	20651414	.	T	G	2	5	7	0	0	7	0	0
12	20651441	.	G	A	2	3	5	0	0	5	0	0
12	20651532	.	C	G	1	3	4	0	0	4	0	0
12	20652683	.	C	T	1	3	4	0	0	4	0	0
12	20653080	.	A	T	0	4	4	0	0	4	0	0
12	20653081	.	A	T	0	4	4	0	0	4	0	0
12	20653128	.	C	T	2	4	6	0	0	6	0	0
12	20653159	.	G	A	2	4	6	0	0	6	0	0
12	20653244	.	A	T	3	3	6	0	0	6	0	0
12	20658037	.	T	C	3	7	10	0	0	10	0	0
12	20676252	.	C	T	4	6	10	0	0	10	0	0
12	20676345	.	C	T	1	2	3	0	2	5	0	0
12	20677184	.	A	T	8	3	11	0	1	12	0	0
12	20677202	.	C	A	7	3	10	0	1	11	0	0
12	20677706	.	T	A	2	4	6	0	0	6	0	0
12	20677874	.	A	G	2	6	8	0	0	8	0	0
12	20777733	.	C	T	0	1	1	0	0	1	0	0
12	21539855	.	T	C	1	0	1	0	0	1	0	0
12	21549172	.	G	A	8	21	29	0	6	35	0	0
12	21687757	.	T	C	4	3	7	0	0	7	0	0
12	21799194	.	G	T	6	2	8	0	0	8	0	0
12	22237749	.	T	C	0	2	2	0	0	2	0	0
12	22410014	.	C	T	0	1	1	0	0	1	0	0
12	22410077	.	G	T	2	2	4	0	1	5	0	0
12	22412630	.	A	G	2	4	6	0	0	6	0	0
12	22415825	.	A	G	2	4	6	0	0	6	0	0
12	22415849	.	T	C	2	5	7	0	0	7	0	0
12	22415880	.	T	C	1	3	4	0	0	4	0	0
12	22418297	.	T	C	2	3	5	0	0	5	0	0
12	22420645	.	A	G	6	7	13	0	0	13	0	0
12	22420669	.	T	C	2	5	7	0	0	7	0	0
12	22429115	.	A	G	4	2	6	0	1	7	0	0
12	22429127	.	A	C	4	2	6	0	1	7	0	0
12	22431304	.	G	A	4	6	10	0	1	11	0	0
12	22433246	.	G	A	0	3	3	0	4	7	0	0
12	22435203	.	T	C	1	3	4	0	0	4	0	0
12	22437160	.	T	C	1	4	5	0	0	5	0	0
12	22444470	.	C	T	4	11	15	0	0	15	0	0
12	22444613	.	A	T	10	6	16	0	2	18	0	0
12	22451083	.	T	A	4	3	7	0	0	7	0	0
12	22451304	.	T	C	4	7	11	0	1	12	0	0
12	22451793	.	A	C	4	10	14	0	1	15	0	0
12	22451811	.	A	G	6	12	18	0	0	18	0	0
12	22456934	.	A	G	2	3	5	0	0	5	0	0
12	22460101	.	C	G	3	0	3	0	0	3	0	0
12	22460316	.	G	T	0	3	3	0	0	3	0	0
12	22462021	.	C	G	0	1	1	0	2	3	0	0
12	22468286	.	C	G	2	4	6	0	0	6	0	0
12	22470282	.	T	C	1	2	3	0	1	4	0	0
12	22470303	.	T	C	1	2	3	0	0	3	0	0
12	22473640	.	A	G	3	2	5	0	0	5	0	0
12	22473736	.	G	A	1	1	2	0	0	2	0	0
12	22480599	.	A	G	1	2	3	0	0	3	0	0
12	22480610	.	A	G	2	2	4	0	0	4	0	0
12	22480850	.	T	C	0	1	1	0	0	1	0	0
12	22480862	.	T	C	0	2	2	0	0	2	0	0
12	22480955	.	C	A	3	2	5	0	0	5	0	0
12	22487415	.	T	C	1	2	3	0	0	3	0	0
12	22487472	.	T	C	4	0	4	0	4	8	0	0
12	22487625	.	A	T	1	2	3	0	0	3	0	0
12	22528869	.	G	A	20	21	41	0	1	42	0	0
12	22529407	.	C	T	16	14	30	0	0	30	0	0
12	22529560	.	T	A	27	20	47	0	3	50	0	0
12	22529655	.	C	G	18	10	28	0	1	29	0	0
12	22529952	.	T	C	5	7	12	0	1	13	0	0
12	22530053	.	A	G	11	10	21	0	2	23	0	0
12	22530056	.	G	A	9	12	21	0	2	23	0	0
12	22530352	.	G	A	15	17	32	0	1	33	0	0
12	22530362	.	C	T	0	18	18	0	18	37	1	0
12	22530849	.	C	G	7	13	20	0	0	20	0	0
12	22531212	.	T	A	17	11	28	0	0	28	0	0
12	22531929	.	T	A	11	15	26	0	1	27	0	0
12	22532594	.	C	T	1	9	10	0	18	28	0	0
12	22533319	.	G	A	13	8	21	0	0	21	0	0
12	22533884	.	A	T	14	9	23	0	1	24	0	0
12	22534389	.	T	C	11	0	11	0	13	24	0	0
12	22534794	.	C	T	9	8	17	0	0	17	0	0
12	22535121	.	C	G	6	9	15	0	0	15	0	0
12	22535186	.	C	T	13	7	20	0	1	21	0	0
12	22535380	.	C	T	0	5	5	0	12	17	0	0
12	22535640	.	G	A	8	4	12	0	0	12	0	0
12	22536969	.	C	T	3	2	5	0	0	5	0	0
12	22537244	.	T	C	7	5	12	0	1	13	0	0
12	22537485	.	G	A	2	4	6	0	0	6	0	0
12	22560249	.	A	G	3	4	7	0	0	7	0	0
12	22562554	.	C	T	0	2	2	0	1	3	0	0
12	22562906	.	G	A	0	1	1	0	0	1	0	0
12	22563891	.	G	T	3	8	11	0	1	12	0	0
12	22569785	.	C	T	3	2	5	0	0	5	0	0
12	22570379	.	A	T	13	18	31	0	5	36	0	0
12	22570499	.	T	C	12	14	26	0	0	26	0	0
12	22571368	.	G	C	4	7	11	0	0	11	0	0
12	22571592	.	A	T	6	5	11	0	0	11	0	0
12	22572367	.	C	T	17	14	31	0	1	32	0	0
12	22572528	.	T	G	10	11	21	0	0	21	0	0
12	22572585	.	G	A	18	18	36	0	1	37	0	0
12	22572650	.	T	C	14	8	22	0	1	23	0	0
12	22572660	.	G	A	13	7	20	0	1	21	0	0
12	22572738	.	C	T	14	10	24	0	1	25	0	0
12	22572756	.	C	T	10	16	26	0	1	27	0	0
12	22572937	.	C	T	12	10	22	0	0	22	0	0
12	22573185	.	G	A	8	4	12	0	0	12	0	0
12	22643556	.	C	G	1	1	2	0	0	2	0	0
12	22643876	.	T	C	1	3	4	0	0	4	0	0
12	22644208	.	T	C	1	8	9	0	0	9	0	0
12	22644209	.	T	C	1	6	7	0	2	9	0	0
12	22644263	.	T	C	4	2	6	0	0	6	0	0
12	22644406	.	C	T	2	5	7	0	1	8	0	0
12	22644429	.	T	C	3	3	6	0	0	6	0	0
12	22644576	.	A	G	1	1	2	0	6	8	0	0
12	22644634	.	T	C	2	3	5	0	1	6	0	0
12	22644852	.	C	T	2	4	6	0	0	6	0	0
12	22644878	.	G	A	1	3	4	0	1	5	0	0
12	22644993	.	C	T	4	2	6	0	0	6	0	0
12	22644998	.	A	G	4	2	6	0	0	6	0	0
12	22645691	.	C	T	3	3	6	0	0	6	0	0
12	22670131	.	A	G	1	2	3	0	0	3	0	0
12	22670137	.	T	G	1	2	3	0	0	3	0	0
12	22670217	.	A	T	1	2	3	0	1	4	0	0
12	22680352	.	C	A	2	2	4	0	0	4	0	0
12	22774778	.	C	T	0	2	2	0	0	2	0	0
12	22774793	.	C	T	0	2	2	0	0	2	0	0
12	22780905	.	G	A	1	2	3	0	0	3	0	0
12	22814994	.	A	G	9	11	20	0	0	20	0	0
12	22815672	.	G	A	1	4	5	0	0	5	0	0
12	22915433	.	T	C	1	2	3	0	0	3	0	0
12	22927981	.	T	C	8	8	16	0	0	16	0	0
12	22932674	.	T	A	13	12	25	0	1	26	0	0
12	22932675	.	A	T	12	12	24	0	2	26	0	0
12	22962764	.	T	C	7	4	11	0	0	11	0	0
12	22962864	.	G	A	3	4	7	0	0	7	0	0
12	22962911	.	C	A	3	4	7	0	2	9	0	0
12	22963104	.	A	C	2	5	7	0	0	7	0	0
12	22963141	.	G	C	3	3	6	0	0	6	0	0
12	22963197	.	G	A	4	2	6	0	2	8	0	0
12	22963667	.	C	G	2	7	9	0	1	10	0	0
12	23001466	.	G	A	1	1	2	0	0	2	0	0
12	23008283	.	T	G	0	2	2	0	0	2	0	0
12	23009275	.	C	T	4	2	6	0	1	7	0	0
12	23385168	.	G	A	6	3	9	0	0	9	0	0
12	23400469	.	C	T	12	10	22	0	2	24	0	0
12	23403091	.	T	C	9	10	19	0	2	21	0	0
12	23403149	.	T	C	3	2	5	0	0	5	0	0
12	23406439	.	A	G	12	13	25	0	0	25	0	0
12	23415280	.	C	T	14	14	28	0	2	30	0	0
12	23415347	.	C	T	19	12	31	0	1	32	0	0
12	23415672	.	C	A	12	21	33	0	1	34	0	0
12	23415715	.	T	C	13	15	28	0	4	32	0	0
12	23424190	.	C	T	2	2	4	0	0	4	0	0
12	23674331	.	T	A	1	3	4	0	0	4	0	0
12	23674354	.	T	C	4	5	9	0	0	9	0	0
12	23674468	.	C	T	1	6	7	0	0	7	0	0
12	23674469	.	A	G	2	5	7	0	0	7	0	0
12	23784201	.	C	G	1	3	4	0	0	4	0	0
12	23787989	.	T	A	1	1	2	0	4	6	0	0
12	23794034	.	G	A	0	3	3	0	4	7	0	0
12	23794547	.	G	A	0	2	2	0	3	5	0	0
12	23917156	.	T	G	2	0	2	0	1	3	0	0
12	23917160	.	T	G	2	1	3	0	0	3	0	0
12	23917460	.	G	C	1	0	1	0	0	1	0	0
12	23920090	.	G	A	0	2	2	0	0	2	0	0
12	23923434	.	G	A	0	1	1	0	0	1	0	0
12	23925093	.	A	G	3	1	4	0	0	4	0	0
12	23932067	.	T	G	4	11	15	0	0	15	0	0
12	24007733	.	A	C	1	1	2	0	0	2	0	0
12	24030454	.	C	T	4	2	6	0	0	6	0	0
12	24036870	.	T	C	1	0	1	0	0	1	0	0
12	24038517	.	A	G	2	1	3	0	0	3	0	0
12	24038542	.	T	C	5	1	6	0	1	7	0	0
12	24041322	.	T	A	2	2	4	0	1	5	0	0
12	24041367	.	A	T	6	3	9	0	0	9	0	0
12	24041600	.	A	G	3	0	3	0	4	7	0	0
12	24043703	.	C	T	6	3	9	0	0	9	0	0
12	24043736	.	C	T	5	2	7	0	0	7	0	0
12	24043909	.	C	T	5	0	5	0	1	6	0	0
12	24043942	.	C	T	8	6	14	0	0	14	0	0
12	24045914	.	T	G	5	0	5	0	4	9	0	0
12	24051717	.	C	G	11	7	18	0	1	19	0	0
12	24051737	.	C	G	9	6	15	0	1	16	0	0
12	24051755	.	T	A	6	2	8	0	0	8	0	0
12	24051894	.	G	T	1	4	5	0	0	5	0	0
12	24051944	.	T	G	3	3	6	0	0	6	0	0
12	24052133	.	A	G	3	0	3	0	5	8	0	0
12	24052256	.	G	C	5	3	8	0	0	8	0	0
12	24052288	.	T	C	4	2	6	0	0	6	0	0
12	24342518	.	T	A	1	2	3	0	0	3	0	0
12	24345427	.	C	A	2	4	6	0	0	6	0	0
12	24345832	.	G	A	0	6	6	0	12	18	0	0
12	24465454	.	C	T	4	1	5	0	0	5	0	0
12	24465466	.	T	C	4	3	7	0	0	7	0	0
12	24465541	.	C	T	15	12	27	0	0	27	0	0
12	24465565	.	T	C	13	12	25	0	0	25	0	0
12	24465607	.	C	T	17	12	29	0	2	31	0	0
12	24484131	.	G	T	13	20	33	0	0	33	0	0
12	24484134	.	C	T	12	21	33	0	0	33	0	0
12	24484215	.	T	C	10	11	21	0	0	21	0	0
12	24562410	.	A	G	1	2	3	0	0	3	0	0
12	24562909	.	C	T	7	5	12	0	0	12	0	0
12	24606963	.	C	T	13	18	31	0	1	32	0	0
12	24635925	.	A	G	46	1	47	0	14	61	0	0
12	24636261	.	C	A	22	20	42	0	6	48	0	0
12	24636746	.	A	G	34	16	50	0	1	51	0	0
12	24637148	.	G	T	4	2	6	0	0	6	0	0
12	24796653	.	G	A	4	6	10	0	0	10	0	0
12	24797128	.	A	T	11	6	17	0	0	17	0	0
12	24797351	.	C	T	11	10	21	0	3	24	0	0
12	24797413	.	C	T	15	15	30	0	1	31	0	0
12	24797541	.	G	A	10	5	15	0	3	18	0	0
12	24797603	.	T	C	7	9	16	0	1	17	0	0
12	24797908	.	C	T	4	7	11	1	1	13	0	0
12	24798358	.	A	G	7	7	14	0	0	14	0	0
12	24811423	.	G	A	6	5	11	0	0	11	0	0
12	24811441	.	C	A	4	5	9	0	0	9	0	0
12	24811468	.	G	A	5	2	7	0	0	7	0	0
12	24842121	.	G	A	11	13	24	0	1	25	0	0
12	24842267	.	T	G	10	12	22	0	5	27	0	0
12	24843292	.	C	T	1	15	16	0	10	26	0	0
12	24843424	.	T	C	7	0	7	0	6	13	0	0
12	24843451	.	C	T	2	1	3	0	0	3	0	0
12	24847330	.	T	G	6	8	14	0	0	14	0	0
12	24848399	.	G	A	4	1	5	0	1	6	0	0
12	24851165	.	T	C	2	7	9	0	0	9	0	0
12	24851264	.	G	A	5	7	12	0	0	12	0	0
12	24851297	.	G	A	4	1	5	0	0	5	0	0
12	24857033	.	G	A	2	1	3	0	0	3	0	0
12	24857814	.	T	C	3	1	4	0	0	4	0	0
12	24906618	.	T	C	4	4	8	0	0	8	0	0
12	24910492	.	A	C	3	4	7	0	1	8	0	0
12	24913442	.	C	G	3	1	4	0	0	4	0	0
12	24913609	.	C	A	0	4	4	0	0	4	0	0
12	24918034	.	C	T	2	0	2	0	0	2	0	0
12	24953532	.	C	G	2	0	2	0	0	2	0	0
12	24957267	.	A	G	21	11	32	0	1	33	0	0
12	24957416	.	T	C	16	11	27	0	7	34	0	0
12	24957806	.	A	G	34	39	73	0	5	78	0	0
12	25043221	.	A	G	7	3	10	0	0	10	0	0
12	25043594	.	C	T	4	6	10	0	0	10	0	0
12	25044516	.	A	G	5	4	9	0	0	9	0	0
12	25044540	.	C	T	7	6	13	0	0	13	0	0
12	25044786	.	T	G	13	5	18	0	1	19	0	0
12	25045074	.	T	C	2	6	8	0	1	9	0	0
12	25045174	.	C	T	7	6	13	0	0	13	0	0
12	25045315	.	C	T	0	3	3	0	0	3	0	0
12	25065680	.	A	G	2	5	7	0	0	7	0	0
12	25094107	.	T	G	13	14	27	0	2	29	0	0
12	25094201	.	T	C	6	8	14	0	1	15	0	0
12	25094401	.	C	T	10	3	13	0	0	13	0	0
12	25094520	.	T	C	7	4	11	0	0	11	0	0
12	25230976	.	A	G	1	1	2	0	0	2	0	0
12	25251716	.	G	A	2	2	4	0	0	4	0	0
12	25254891	.	T	C	5	3	8	0	0	8	0	0
12	25271404	.	T	G	3	1	4	0	0	4	0	0
12	25271409	.	C	A	3	1	4	0	0	4	0	0
12	25271598	.	C	T	7	14	21	0	0	21	0	0
12	25284375	.	G	A	10	5	15	0	0	15	0	0
12	25284414	.	T	C	15	7	22	0	2	24	0	0
12	25284423	.	G	A	13	7	20	0	3	23	0	0
12	25377318	.	A	C	2	0	2	0	2	4	0	0
12	25377345	.	A	T	2	2	4	0	0	4	0	0
12	25377354	.	A	C	3	2	5	0	0	5	0	0
12	25377690	.	T	A	3	3	6	0	0	6	0	0
12	25377797	.	A	T	6	3	9	0	0	9	0	0
12	25377817	.	C	G	6	2	8	0	0	8	0	0
12	25378351	.	G	A	13	7	20	0	1	21	0	0
12	25378354	.	C	T	0	5	5	0	15	20	0	0
12	25378420	.	A	G	5	9	14	0	1	15	0	0
12	25378475	.	G	A	3	4	7	0	4	11	0	0
12	25378506	.	C	A	1	4	5	0	7	12	0	0
12	25378555	.	T	C	3	4	7	0	1	8	0	0
12	25467742	.	C	T	7	7	14	0	0	14	0	0
12	25467823	.	T	C	7	6	13	0	2	15	0	0
12	25467887	.	T	C	8	5	13	0	0	13	0	0
12	25468312	.	C	T	17	9	26	0	1	27	0	0
12	25472281	.	C	T	8	11	19	0	0	19	0	0
12	25472290	.	A	G	9	0	9	0	12	21	0	0
12	25483514	.	T	C	5	4	9	0	4	13	0	0
12	25484586	.	G	A	18	13	31	0	1	32	0	0
12	25484676	.	T	G	14	19	33	0	2	35	0	0
12	25485203	.	C	T	17	12	29	0	0	29	0	0
12	25600834	.	A	G	3	6	9	0	0	9	0	0
12	25602616	.	T	A	5	7	12	0	0	12	0	0
12	25602820	.	T	A	9	7	16	0	0	16	0	0
12	25602828	.	T	A	8	8	16	0	0	16	0	0
12	25713629	.	G	C	9	3	12	0	0	12	0	0
12	25714409	.	T	C	1	2	3	0	0	3	0	0
12	25714480	.	T	G	9	14	23	0	0	23	0	0
12	25754150	.	C	T	5	14	19	0	1	20	0	0
12	25754225	.	C	T	3	3	6	0	0	6	0	0
12	25768096	.	C	T	16	17	33	0	0	33	0	0
12	25768326	.	T	A	21	22	43	0	4	48	1	0
12	25768580	.	G	A	2	21	23	0	13	36	0	0
12	25768660	.	A	T	2	8	10	0	0	10	0	0
12	25768695	.	T	A	3	2	5	0	0	5	0	0
12	25768830	.	T	C	5	8	13	0	2	15	0	0
12	25768836	.	T	C	5	3	8	0	3	11	0	0
12	25769012	.	G	A	16	20	36	0	4	40	0	0
12	25769177	.	A	T	14	19	33	0	1	34	0	0
12	25769752	.	G	A	18	23	41	0	4	45	0	0
12	25769889	.	G	A	10	8	18	0	2	20	0	0
12	25828251	.	G	A	2	2	4	0	0	4	0	0
12	25828756	.	G	A	1	2	3	0	1	4	0	0
12	25829025	.	G	A	3	7	10	0	0	10	0	0
12	25829046	.	T	C	1	6	7	0	0	7	0	0
12	25829105	.	T	C	2	6	8	0	0	8	0	0
12	25829168	.	A	G	1	6	7	0	0	7	0	0
12	25845511	.	T	C	6	2	8	0	0	8	0	0
12	25845512	.	G	A	6	2	8	0	0	8	0	0
12	25846021	.	T	C	13	12	25	0	1	26	0	0
12	25856178	.	T	A	1	2	3	0	0	3	0	0
12	25861006	.	T	C	1	3	4	0	1	5	0	0
12	25866543	.	G	A	12	13	25	0	2	27	0	0
12	25872834	.	C	A	0	1	1	0	0	1	0	0
12	25872933	.	C	T	4	7	11	0	1	12	0	0
12	25872938	.	C	A	2	7	9	0	1	10	0	0
12	25873241	.	C	T	2	6	8	0	1	9	0	0
12	25873289	.	C	T	8	10	18	0	0	18	0	0
12	25881185	.	G	C	1	20	21	0	18	39	0	0
12	25881254	.	A	C	16	14	30	0	0	30	0	0
12	25881778	.	T	C	17	15	32	0	0	32	0	0
12	25886171	.	G	A	1	3	4	0	1	5	0	0
12	25951057	.	A	G	4	6	10	0	0	10	0	0
12	25951101	.	C	T	4	4	8	0	0	8	0	0
12	25951781	.	C	A	4	2	6	0	0	6	0	0
12	25952026	.	A	G	2	4	6	0	0	6	0	0
12	25952027	.	C	G	2	4	6	0	0	6	0	0
12	25954423	.	G	C	1	3	4	0	0	4	0	0
12	25982664	.	A	T	2	3	5	0	0	5	0	0
12	26105074	.	A	G	1	2	3	0	0	3	0	0
12	26203891	.	C	T	0	4	4	0	6	10	0	0
12	26203900	.	A	T	8	7	15	0	0	15	0	0
12	26226655	.	C	G	0	2	2	0	10	12	0	0
12	26241724	.	G	A	1	1	2	0	0	2	0	0
12	26241745	.	G	A	2	1	3	0	0	3	0	0
12	26318397	.	C	T	0	2	2	0	4	6	0	0
12	26318515	.	A	G	11	6	17	0	1	18	0	0
12	26318625	.	G	A	5	3	8	0	0	8	0	0
12	26318702	.	A	G	5	4	9	0	1	10	0	0
12	26409797	.	C	A	2	5	7	0	0	7	0	0
12	26476093	.	C	G	5	7	12	0	0	12	0	0
12	26476319	.	A	G	1	0	1	0	0	1	0	0
12	26476424	.	A	G	4	3	7	0	0	7	0	0
12	26486421	.	C	G	13	11	24	0	0	24	0	0
12	26486446	.	A	C	16	17	33	0	2	36	1	0
12	26486580	.	T	C	13	17	30	0	1	31	0	0
12	26486753	.	T	C	10	7	17	0	0	17	0	0
12	26486934	.	T	A	7	15	22	0	3	25	0	0
12	26487002	.	A	T	12	12	24	0	0	24	0	0
12	26487044	.	G	A	6	11	17	0	1	18	0	0
12	26487292	.	T	G	1	4	5	0	0	5	0	0
12	26489766	.	A	T	7	3	10	0	0	10	0	0
12	26491376	.	A	T	7	4	11	0	0	11	0	0
12	26491380	.	G	A	6	4	10	0	0	10	0	0
12	26493755	.	G	A	0	2	2	0	2	4	0	0
12	26493806	.	C	T	4	7	11	0	0	11	0	0
12	26493836	.	G	A	0	5	5	0	6	11	0	0
12	26493870	.	G	T	2	6	8	0	0	8	0	0
12	26524969	.	A	C	4	2	6	0	0	6	0	0
12	26546965	.	A	G	4	5	9	0	0	9	0	0
12	26546966	.	A	G	4	5	9	0	0	9	0	0
12	26547261	.	A	C	3	0	3	0	5	8	0	0
12	26547276	.	A	C	2	5	7	0	0	7	0	0
12	26549505	.	G	T	1	0	1	0	0	1	0	0
12	26549729	.	G	A	1	1	2	0	1	3	0	0
12	26586957	.	C	T	2	4	6	0	0	6	0	0
12	26587065	.	T	C	1	5	6	0	0	6	0	0
12	26594165	.	C	T	0	4	4	0	11	15	0	0
12	26594216	.	G	A	6	9	15	0	1	16	0	0
12	26597512	.	C	T	0	0	0	0	3	3	0	0
12	26608882	.	C	T	0	6	6	0	1	7	0	0
12	26611673	.	A	T	3	2	5	0	0	5	0	0
12	26612038	.	A	G	2	1	3	0	0	3	0	0
12	26612188	.	T	C	1	0	1	0	7	8	0	0
12	26612225	.	C	G	2	6	8	0	0	8	0	0
12	26612390	.	G	C	0	2	2	0	0	2	0	0
12	26617621	.	C	A	1	3	4	0	0	4	0	0
12	26617882	.	G	A	1	1	2	0	0	2	0	0
12	26620426	.	A	G	0	1	1	0	0	1	0	0
12	26620612	.	T	G	3	2	5	0	1	6	0	0
12	26638166	.	G	A	4	2	6	0	1	7	0	0
12	26638274	.	G	A	7	3	10	0	0	10	0	0
12	26638640	.	C	T	3	4	7	0	0	7	0	0
12	26693547	.	G	A	7	8	15	0	1	16	0	0
12	26704300	.	C	T	1	1	2	0	0	2	0	0
12	26724285	.	A	T	5	5	10	0	0	10	0	0
12	26724327	.	C	A	6	6	12	0	0	12	0	0
12	26724413	.	G	T	2	5	7	0	0	7	0	0
12	26724975	.	A	G	9	0	9	0	10	19	0	0
12	26724984	.	A	T	9	10	19	0	0	19	0	0
12	26725079	.	C	A	6	6	12	0	1	13	0	0
12	26725402	.	A	G	12	6	18	0	0	18	0	0
12	26750431	.	G	A	5	2	7	0	3	10	0	0
12	26750619	.	A	G	15	14	29	0	2	31	0	0
12	26750924	.	A	C	5	4	9	0	0	9	0	0
12	26751414	.	G	A	8	14	22	0	1	23	0	0
12	26751489	.	A	G	3	10	13	0	1	14	0	0
12	26752074	.	A	C	1	6	7	0	0	7	0	0
12	26752528	.	C	T	5	5	10	0	1	11	0	0
12	26752730	.	C	T	0	15	15	0	8	23	0	0
12	26752778	.	G	C	11	10	21	0	0	21	0	0
12	26752871	.	G	A	2	6	8	0	1	9	0	0
12	26752946	.	G	A	3	1	4	0	0	4	0	0
12	26758251	.	A	G	9	4	13	0	1	14	0	0
12	26758521	.	A	G	5	9	14	0	0	14	0	0
12	26758710	.	A	C	2	4	6	0	1	7	0	0
12	26758722	.	T	C	3	4	7	0	0	7	0	0
12	26758793	.	G	T	5	3	8	0	0	8	0	0
12	26761017	.	G	A	4	2	6	0	0	6	0	0
12	26764315	.	C	T	0	2	2	0	0	2	0	0
12	26764416	.	C	T	0	2	2	0	0	2	0	0
12	27023301	.	C	T	1	3	4	0	0	4	0	0
12	27023677	.	C	T	5	6	11	0	1	12	0	0
12	27025481	.	C	T	6	6	12	0	0	12	0	0
12	27026528	.	A	C	5	3	8	0	0	8	0	0
12	27029347	.	T	C	9	0	9	0	6	15	0	0
12	27029648	.	C	T	6	9	15	0	1	16	0	0
12	27030917	.	T	C	2	0	2	0	5	7	0	0
12	27036570	.	A	C	2	2	4	0	0	4	0	0
12	27037804	.	C	T	7	4	11	0	0	11	0	0
12	27037813	.	C	T	5	3	8	0	0	8	0	0
12	27050766	.	A	G	1	4	5	0	2	7	0	0
12	27059070	.	A	G	11	5	16	0	3	19	0	0
12	27059581	.	T	C	11	9	20	0	0	20	0	0
12	27059901	.	A	T	18	9	27	0	3	30	0	0
12	27059910	.	A	T	20	7	27	0	1	28	0	0
12	27060018	.	C	T	9	7	16	0	1	17	0	0
12	27060087	.	C	A	5	14	19	0	0	19	0	0
12	27060572	.	G	A	7	8	15	0	0	15	0	0
12	27065470	.	A	C	1	2	3	0	0	3	0	0
12	27065471	.	C	A	1	2	3	0	0	3	0	0
12	27068492	.	G	A	2	2	4	0	1	5	0	0
12	27068513	.	C	A	6	4	10	0	0	10	0	0
12	27072033	.	T	C	2	2	4	0	1	5	0	0
12	27073084	.	A	G	0	1	1	0	0	1	0	0
12	27073135	.	T	C	0	2	2	0	0	2	0	0
12	27078324	.	A	T	5	4	9	0	1	10	0	0
12	27086658	.	C	T	8	4	12	0	1	13	0	0
12	27086943	.	T	C	5	6	11	0	0	11	0	0
12	27086958	.	C	T	4	5	9	0	1	10	0	0
12	27087235	.	T	G	3	3	6	0	0	6	0	0
12	27087261	.	A	G	2	5	7	0	0	7	0	0
12	27087342	.	C	A	4	3	7	0	1	8	0	0
12	27087570	.	A	T	8	5	13	0	1	14	0	0
12	27087635	.	T	C	4	9	13	0	1	14	0	0
12	27087844	.	G	A	5	9	14	0	0	14	0	0
12	27088199	.	T	C	8	6	14	0	0	14	0	0
12	27088286	.	G	T	12	7	19	0	0	19	0	0
12	27088304	.	T	C	11	9	20	0	0	20	0	0
12	27088357	.	C	T	12	7	19	0	0	19	0	0
12	27088383	.	A	C	10	5	15	0	0	15	0	0
12	27088646	.	T	A	7	11	18	0	1	19	0	0
12	27088758	.	A	C	2	11	13	0	0	13	0	0
12	27088767	.	G	A	4	13	17	0	0	17	0	0
12	27088821	.	A	G	9	0	9	0	12	21	0	0
12	27088836	.	T	C	8	9	17	0	1	18	0	0
12	27089531	.	G	C	7	7	14	0	1	15	0	0
12	27089857	.	T	C	12	11	23	0	2	25	0	0
12	27090630	.	A	C	8	12	20	0	1	21	0	0
12	27090663	.	G	A	0	14	14	0	10	24	0	0
12	27090696	.	A	T	5	17	22	0	0	22	0	0
12	27090756	.	A	G	5	14	19	0	0	19	0	0
12	27090824	.	T	G	11	14	25	0	0	25	0	0
12	27090856	.	A	T	9	8	17	0	0	17	0	0
12	27090864	.	G	C	10	7	17	0	0	17	0	0
12	27090918	.	G	A	8	5	13	0	1	14	0	0
12	27091163	.	C	A	9	5	14	0	1	15	0	0
12	27091305	.	T	C	8	15	23	0	1	24	0	0
12	27114254	.	G	A	0	2	2	0	2	4	0	0
12	27130237	.	G	A	1	2	3	0	4	7	0	0
12	27131224	.	T	C	5	5	10	0	0	10	0	0
12	27141915	.	C	T	2	2	4	0	0	4	0	0
12	27142089	.	T	A	0	1	1	0	0	1	0	0
12	27142340	.	A	G	3	2	5	0	0	5	0	0
12	27207050	.	T	G	8	4	12	0	2	14	0	0
12	27207053	.	C	T	9	4	13	0	1	14	0	0
12	27207130	.	G	A	7	5	12	0	0	12	0	0
12	27207466	.	T	C	12	18	30	0	3	33	0	0
12	27219143	.	C	T	6	4	10	0	1	11	0	0
12	27219450	.	T	C	4	2	6	0	1	7	0	0
12	27219761	.	T	A	2	6	8	0	0	8	0	0
12	27219818	.	G	A	0	9	9	0	5	14	0	0
12	27220582	.	T	C	2	1	3	0	0	3	0	0
12	27221491	.	G	A	1	2	3	0	0	3	0	0
12	27221505	.	A	T	2	4	6	0	0	6	0	0
12	27224057	.	G	A	4	9	13	0	0	13	0	0
12	27224090	.	C	G	1	0	1	0	4	5	0	0
12	27224727	.	T	C	0	1	1	0	0	1	0	0
12	27229078	.	A	G	11	6	17	0	0	17	0	0
12	27229216	.	T	A	8	16	24	0	2	26	0	0
12	27229438	.	T	G	12	6	18	0	0	18	0	0
12	27229545	.	G	A	0	5	5	0	6	11	0	0
12	27232225	.	A	C	1	2	3	0	0	3	0	0
12	27236496	.	C	A	1	2	3	0	0	3	0	0
12	27236500	.	A	T	1	2	3	0	0	3	0	0
12	27243208	.	A	G	10	5	15	0	0	15	0	0
12	27243236	.	T	C	12	7	19	0	0	19	0	0
12	27303000	.	A	G	4	3	7	0	1	8	0	0
12	27303211	.	C	T	5	6	11	0	1	12	0	0
12	27303288	.	C	T	6	8	14	0	0	14	0	0
12	27303295	.	A	C	6	8	14	0	0	14	0	0
12	27303328	.	T	C	4	6	10	0	2	12	0	0
12	27303486	.	A	T	12	11	23	0	2	25	0	0
12	27303496	.	T	C	11	12	23	0	0	23	0	0
12	27303521	.	C	T	8	10	18	0	1	19	0	0
12	27304064	.	C	T	3	6	9	0	1	10	0	0
12	27304215	.	G	A	0	5	5	0	8	13	0	0
12	27304316	.	A	T	3	7	10	0	0	10	0	0
12	27304596	.	T	A	5	13	18	0	1	19	0	0
12	27304650	.	A	G	7	0	7	0	5	12	0	0
12	27304704	.	A	C	7	7	14	0	0	14	0	0
12	27305054	.	G	A	6	14	20	0	0	20	0	0
12	27305495	.	C	A	7	10	17	0	0	17	0	0
12	27305503	.	A	G	7	11	18	0	0	18	0	0
12	27558619	.	G	C	3	2	5	0	0	5	0	0
12	27558705	.	G	T	1	5	6	0	0	6	0	0
12	27559653	.	T	C	1	2	3	0	0	3	0	0
12	27566659	.	T	C	1	0	1	0	0	1	0	0
12	27568288	.	T	A	3	5	8	0	0	8	0	0
12	27570675	.	A	G	7	8	15	0	0	15	0	0
12	27570725	.	T	A	6	9	15	0	1	16	0	0
12	27570759	.	T	G	7	8	15	0	0	15	0	0
12	27570838	.	C	G	5	6	11	0	0	11	0	0
12	27570869	.	A	T	6	7	13	0	0	13	0	0
12	27570964	.	G	A	5	3	8	0	0	8	0	0
12	27570998	.	T	A	4	3	7	0	0	7	0	0
12	27571015	.	A	G	3	4	7	0	0	7	0	0
12	27571076	.	C	A	4	3	7	0	0	7	0	0
12	27571142	.	A	C	3	6	9	0	0	9	0	0
12	27571151	.	A	T	3	8	11	0	0	11	0	0
12	27571213	.	T	C	7	0	7	0	7	14	0	0
12	27571224	.	C	T	8	5	13	0	0	13	0	0
12	27571625	.	G	A	12	9	21	0	0	21	0	0
12	27573030	.	G	A	2	4	6	0	1	7	0	0
12	27573072	.	G	A	6	8	14	0	0	14	0	0
12	27575444	.	T	C	4	3	7	0	0	7	0	0
12	27584590	.	A	T	2	3	5	0	0	5	0	0
12	27584827	.	C	T	0	2	2	0	1	3	0	0
12	27591232	.	G	A	1	3	4	0	0	4	0	0
12	27593856	.	G	A	0	2	2	0	3	5	0	0
12	27593868	.	A	C	4	2	6	0	0	6	0	0
12	27593892	.	C	T	2	2	4	0	0	4	0	0
12	27593922	.	T	G	1	0	1	0	0	1	0	0
12	27595297	.	T	A	2	2	4	0	1	5	0	0
12	27602080	.	A	T	3	7	10	0	0	10	0	0
12	27615642	.	A	G	1	0	1	0	0	1	0	0
12	27622254	.	C	T	5	5	10	0	0	10	0	0
12	27622321	.	G	A	7	6	13	0	1	14	0	0
12	27622336	.	C	A	5	9	14	0	2	16	0	0
12	27627528	.	G	C	4	1	5	0	0	5	0	0
12	27665035	.	T	C	11	9	20	0	0	20	0	0
12	27665289	.	G	C	11	13	24	0	1	25	0	0
12	27902871	.	A	G	4	0	4	0	3	7	0	0
12	27943009	.	T	C	3	2	5	0	0	5	0	0
12	28003340	.	C	T	1	2	3	0	0	3	0	0
12	28003358	.	C	T	2	2	4	0	0	4	0	0
12	28033169	.	C	T	1	0	1	0	0	1	0	0
12	28049096	.	G	A	5	4	9	0	0	9	0	0
12	28180193	.	A	G	2	1	3	0	2	5	0	0
12	28298889	.	C	A	2	2	4	0	0	4	0	0
12	28348521	.	G	A	1	2	3	0	0	3	0	0
12	28350566	.	A	G	9	12	21	0	3	24	0	0
12	28351160	.	G	C	0	3	3	0	0	3	0	0
12	28355486	.	G	A	8	7	15	0	0	15	0	0
12	28359161	.	G	A	1	1	2	0	0	2	0	0
12	28367757	.	T	A	15	17	32	0	0	32	0	0
12	28369391	.	G	A	0	1	1	0	6	7	0	0
12	28369412	.	G	T	13	7	20	0	1	21	0	0
12	28369540	.	C	A	18	15	33	0	3	36	0	0
12	28369615	.	G	C	0	11	11	0	21	33	1	0
12	28369909	.	G	T	0	18	18	0	17	35	0	0
12	28369981	.	C	T	16	15	31	0	0	31	0	0
12	28370062	.	G	C	0	14	14	0	11	25	0	0
12	28370335	.	A	C	18	24	42	0	1	43	0	0
12	28370474	.	T	G	8	1	9	0	20	29	0	0
12	28377796	.	A	G	0	3	3	0	0	3	0	0
12	28377797	.	G	C	0	3	3	0	0	3	0	0
12	28377909	.	T	A	3	4	7	0	1	8	0	0
12	28378139	.	G	A	4	4	8	0	0	8	0	0
12	28378200	.	T	G	2	2	4	0	0	4	0	0
12	28378237	.	A	C	3	2	5	0	0	5	0	0
12	28378394	.	C	A	0	7	7	0	4	11	0	0
12	28378418	.	G	A	5	7	12	0	0	12	0	0
12	28378645	.	C	T	2	3	5	0	0	5	0	0
12	28378958	.	C	T	1	2	3	0	0	3	0	0
12	28379042	.	T	C	1	2	3	0	0	3	0	0
12	28379120	.	G	T	5	2	7	0	0	7	0	0
12	28379215	.	C	T	2	3	5	0	0	5	0	0
12	28379218	.	C	T	1	4	5	0	0	5	0	0
12	28379646	.	T	C	3	3	6	0	0	6	0	0
12	28379647	.	G	A	3	3	6	0	0	6	0	0
12	28449032	.	G	T	0	2	2	0	0	2	0	0
12	28559939	.	T	C	5	6	11	0	0	11	0	0
12	28559973	.	A	C	3	3	6	0	0	6	0	0
12	28560354	.	T	A	4	2	6	0	1	7	0	0
12	28560370	.	G	T	5	2	7	0	1	8	0	0
12	28560494	.	T	C	1	5	6	0	0	6	0	0
12	28560734	.	T	C	4	6	10	0	0	10	0	0
12	28560990	.	T	C	3	5	8	0	0	8	0	0
12	28561253	.	G	A	2	1	3	0	1	4	0	0
12	28561420	.	C	T	3	3	6	0	0	6	0	0
12	28561875	.	A	C	3	0	3	0	0	3	0	0
12	28568138	.	T	A	0	3	3	0	0	3	0	0
12	28668713	.	A	T	7	8	15	0	0	15	0	0
12	28676131	.	C	T	11	9	20	0	1	21	0	0
12	28676551	.	A	G	11	0	11	0	10	21	0	0
12	28676844	.	A	T	7	9	16	0	2	18	0	0
12	28677202	.	C	T	14	7	21	0	0	21	0	0
12	28677314	.	A	G	13	10	23	0	1	24	0	0
12	28677413	.	T	C	9	15	24	0	1	25	0	0
12	28677576	.	A	T	6	10	16	0	0	16	0	0
12	28800029	.	A	G	2	4	6	0	0	6	0	0
12	28801271	.	A	G	3	1	4	0	3	7	0	0
12	28806022	.	G	A	0	10	10	0	9	19	0	0
12	28806062	.	C	T	11	9	20	0	0	20	0	0
12	28806180	.	C	T	6	11	17	0	0	17	0	0
12	28806220	.	G	T	4	8	12	0	0	12	0	0
12	28806241	.	T	G	1	6	7	0	1	8	0	0
12	28806285	.	G	A	6	4	10	0	0	10	0	0
12	28806396	.	C	A	8	9	17	0	0	17	0	0
12	28806459	.	A	T	6	7	13	0	1	14	0	0
12	28806494	.	G	A	9	8	17	0	0	17	0	0
12	28806530	.	G	C	12	12	24	0	0	24	0	0
12	28806584	.	T	G	18	8	26	0	0	26	0	0
12	28806586	.	A	T	18	7	25	0	1	26	0	0
12	28827553	.	T	A	2	3	5	0	1	6	0	0
12	28828016	.	A	C	1	2	3	0	1	4	0	0
12	28828207	.	A	T	2	2	4	0	0	4	0	0
12	28828358	.	G	A	1	0	1	0	0	1	0	0
12	28830363	.	A	G	4	9	13	0	0	13	0	0
12	28847439	.	A	C	3	1	4	0	0	4	0	0
12	28856200	.	T	C	3	3	6	0	0	6	0	0
12	28856227	.	T	C	2	1	3	0	0	3	0	0
12	28863046	.	A	T	9	8	17	0	1	18	0	0
12	28863086	.	T	A	6	5	11	0	1	12	0	0
12	28863101	.	T	C	4	5	9	0	0	9	0	0
12	28863582	.	A	G	9	6	15	0	0	15	0	0
12	28863711	.	T	C	6	6	12	0	0	12	0	0
12	28863783	.	A	C	10	9	19	0	0	19	0	0
12	28863811	.	T	C	9	7	16	0	0	16	0	0
12	28864217	.	T	C	12	7	19	0	3	22	0	0
12	28864575	.	T	G	9	0	9	0	7	16	0	0
12	28864719	.	G	C	8	12	20	0	1	21	0	0
12	28864778	.	C	G	16	11	27	0	1	28	0	0
12	28864792	.	A	C	15	10	25	0	1	26	0	0
12	28864847	.	T	C	17	16	33	0	1	34	0	0
12	28865106	.	G	T	19	10	29	0	1	30	0	0
12	28865298	.	T	A	21	20	41	0	1	42	0	0
12	28865668	.	T	G	11	11	22	0	0	22	0	0
12	28865679	.	G	A	14	11	25	0	1	26	0	0
12	28865805	.	A	C	7	13	20	0	1	22	1	0
12	28870626	.	T	C	14	5	19	0	0	19	0	0
12	28870912	.	C	A	13	21	34	0	2	37	1	0
12	28871068	.	G	T	19	15	34	0	1	35	0	0
12	28871433	.	C	A	1	14	15	0	20	35	0	0
12	28878343	.	C	T	18	20	38	0	2	40	0	0
12	28899989	.	C	A	4	2	6	0	0	6	0	0
12	28901049	.	A	G	1	2	3	0	0	3	0	0
12	28918699	.	G	A	2	1	3	0	0	3	0	0
12	28924363	.	G	A	5	1	6	0	0	6	0	0
12	28927051	.	G	A	5	5	10	0	0	10	0	0
12	28930455	.	T	C	2	2	4	0	1	5	0	0
12	28932389	.	C	T	1	1	2	0	0	2	0	0
12	28932428	.	C	T	2	8	10	0	0	10	0	0
12	28932571	.	G	A	6	2	8	0	0	8	0	0
12	28932581	.	T	A	5	5	10	0	0	10	0	0
12	28948117	.	T	C	2	7	9	0	0	9	0	0
12	28949067	.	A	G	4	3	7	0	0	7	0	0
12	28949112	.	C	A	3	0	3	0	0	3	0	0
12	28950009	.	T	C	8	0	8	0	3	11	0	0
12	28950678	.	G	T	2	4	6	0	0	6	0	0
12	28951019	.	C	T	0	2	2	0	3	5	0	0
12	28952139	.	T	C	6	3	9	0	0	9	0	0
12	28955614	.	T	C	0	0	0	0	1	1	0	0
12	28956566	.	T	C	1	3	4	0	0	4	0	0
12	28956615	.	A	G	1	1	2	0	0	2	0	0
12	28959298	.	C	T	1	2	3	0	0	3	0	0
12	28960284	.	T	C	3	5	8	0	0	8	0	0
12	28960321	.	G	A	4	4	8	0	0	8	0	0
12	28960357	.	G	A	0	4	4	0	4	8	0	0
12	28960441	.	C	T	2	2	4	0	0	4	0	0
12	29063346	.	G	A	2	0	2	0	0	2	0	0
12	29084032	.	T	C	4	3	7	0	0	7	0	0
12	29102585	.	T	C	6	13	19	0	0	19	0	0
12	29103004	.	T	C	5	4	9	0	0	9	0	0
12	29103041	.	T	A	5	4	9	0	0	9	0	0
12	29173678	.	C	G	3	2	5	0	0	5	0	0
12	29173712	.	T	C	3	2	5	0	0	5	0	0
12	29207473	.	G	A	0	4	4	0	7	11	0	0
12	29207533	.	T	C	5	6	11	0	1	12	0	0
12	29207590	.	G	A	1	6	7	0	7	14	0	0
12	29207683	.	G	T	11	9	20	0	0	21	1	0
12	29208099	.	T	G	6	5	11	0	0	11	0	0
12	29209834	.	G	A	6	8	14	0	0	14	0	0
12	29209840	.	A	T	6	8	14	0	0	14	0	0
12	29210371	.	C	A	12	14	26	0	0	26	0	0
12	29210435	.	C	G	14	4	18	0	2	20	0	0
12	29210600	.	C	T	9	12	21	0	0	21	0	0
12	29210719	.	T	A	10	13	23	0	0	23	0	0
12	29210873	.	T	A	9	4	13	0	0	13	0	0
12	29210917	.	T	C	5	6	11	0	1	12	0	0
12	29211082	.	G	A	10	2	12	0	2	14	0	0
12	29211195	.	T	A	9	10	19	0	1	20	0	0
12	29211232	.	G	A	0	10	10	0	14	24	0	0
12	29211289	.	T	A	14	16	30	0	0	30	0	0
12	29211292	.	A	G	10	15	25	0	4	29	0	0
12	29223498	.	A	G	5	7	12	0	0	12	0	0
12	29223921	.	G	A	2	3	5	0	1	6	0	0
12	29223969	.	A	T	1	3	4	0	0	4	0	0
12	29224521	.	A	T	3	4	7	0	0	7	0	0
12	29224655	.	T	C	1	2	3	0	0	3	0	0
12	29225282	.	A	C	0	4	4	0	0	4	0	0
12	29225285	.	T	G	0	4	4	0	0	4	0	0
12	29251520	.	A	G	3	4	7	0	0	7	0	0
12	29258629	.	G	T	0	3	3	0	0	3	0	0
12	29266917	.	T	C	5	10	15	0	0	15	0	0
12	29269689	.	G	A	1	3	4	0	0	4	0	0
12	29269695	.	A	G	1	0	1	0	3	4	0	0
12	29269770	.	G	T	0	2	2	0	5	7	0	0
12	29269774	.	T	G	5	2	7	0	0	7	0	0
12	29351320	.	A	G	17	6	23	0	2	25	0	0
12	29351810	.	A	G	15	9	24	0	0	24	0	0
12	29358277	.	T	C	3	5	8	0	1	9	0	0
12	29358370	.	G	C	9	0	9	0	7	16	0	0
12	29358384	.	A	G	5	6	11	0	0	11	0	0
12	29358418	.	A	G	1	1	2	0	0	2	0	0
12	29624017	.	G	A	16	15	31	0	1	32	0	0
12	29624272	.	C	A	6	6	12	0	1	13	0	0
12	29801179	.	T	C	1	6	7	0	0	7	0	0
12	29811009	.	A	G	2	0	2	0	2	4	0	0
12	29843460	.	A	G	12	18	30	0	1	31	0	0
12	29844434	.	T	C	10	5	15	0	0	15	0	0
12	29873273	.	C	G	0	1	1	0	0	1	0	0
12	29921114	.	T	G	3	7	10	0	0	10	0	0
12	29947132	.	A	G	4	4	8	0	0	8	0	0
12	29947147	.	C	A	3	4	7	0	0	7	0	0
12	29957074	.	C	T	3	3	6	0	0	6	0	0
12	29957164	.	C	T	4	6	10	0	0	10	0	0
12	29966039	.	T	C	1	0	1	0	0	1	0	0
12	29966048	.	T	C	0	0	0	0	1	1	0	0
12	29968087	.	T	C	2	0	2	0	0	2	0	0
12	29973800	.	G	A	1	3	4	0	0	4	0	0
12	29976936	.	G	A	1	2	3	0	1	4	0	0
12	30031290	.	C	A	1	3	4	0	0	4	0	0
12	30109838	.	C	T	1	3	4	0	0	4	0	0
12	30153676	.	G	A	0	2	2	0	4	6	0	0
12	30153772	.	T	C	0	2	2	0	0	2	0	0
12	30156540	.	G	A	0	0	0	0	1	1	0	0
12	30192526	.	A	T	5	2	7	0	1	8	0	0
12	30200741	.	C	T	3	5	8	0	1	9	0	0
12	30208905	.	T	C	1	1	2	0	0	2	0	0
12	30216034	.	C	A	2	1	3	0	0	3	0	0
12	30216040	.	A	T	0	1	1	0	0	1	0	0
12	30216090	.	G	T	2	3	5	0	0	5	0	0
12	30216436	.	T	C	4	6	10	0	0	10	0	0
12	30216490	.	T	C	8	4	12	0	3	15	0	0
12	30216693	.	C	T	3	2	5	0	0	5	0	0
12	30216697	.	G	A	1	2	3	0	2	5	0	0
12	30217423	.	T	C	1	2	3	0	1	4	0	0
12	30217705	.	G	A	0	4	4	0	5	9	0	0
12	30217747	.	C	T	6	4	10	0	0	10	0	0
12	30217782	.	T	G	3	3	6	0	1	7	0	0
12	30217783	.	C	A	3	2	5	0	2	7	0	0
12	30217893	.	C	A	3	2	5	0	1	6	0	0
12	30217898	.	T	A	3	2	5	0	0	5	0	0
12	30217966	.	G	A	2	6	8	0	2	10	0	0
12	30217986	.	C	T	6	6	12	0	0	12	0	0
12	30218073	.	A	G	2	3	5	0	0	5	0	0
12	30218086	.	G	T	3	4	7	0	0	7	0	0
12	30218135	.	C	A	5	5	10	0	0	10	0	0
12	30218150	.	G	A	7	4	11	0	0	11	0	0
12	30218173	.	C	T	7	6	13	0	0	13	0	0
12	30219306	.	A	T	13	15	28	0	3	31	0	0
12	30219687	.	T	A	1	6	7	0	1	8	0	0
12	30219694	.	A	T	1	6	7	0	0	7	0	0
12	30219739	.	G	A	7	2	9	0	2	11	0	0
12	30219804	.	C	T	12	1	13	0	1	14	0	0
12	30303081	.	C	A	1	3	4	0	0	4	0	0
12	30304909	.	A	G	2	0	2	0	0	2	0	0
12	30305983	.	T	C	0	1	1	0	0	1	0	0
12	30307010	.	C	T	5	8	13	0	2	15	0	0
12	30307788	.	G	T	2	3	5	0	1	6	0	0
12	30307913	.	G	T	5	17	22	0	2	24	0	0
12	30372463	.	G	A	0	3	3	0	3	6	0	0
12	30382341	.	C	T	2	3	5	0	1	6	0	0
12	30383960	.	G	A	0	1	1	0	1	2	0	0
12	30385562	.	C	T	4	2	6	0	0	6	0	0
12	30391136	.	G	A	4	3	7	0	2	9	0	0
12	30418108	.	T	C	7	6	13	0	0	13	0	0
12	30418513	.	C	G	10	9	19	0	0	19	0	0
12	30419123	.	A	T	4	7	11	0	0	11	0	0
12	30419134	.	C	A	7	5	12	0	0	12	0	0
12	30419260	.	T	G	9	11	20	0	0	20	0	0
12	30419646	.	T	C	9	6	15	0	1	16	0	0
12	30419655	.	T	C	7	6	13	0	1	14	0	0
12	30419695	.	T	C	6	5	11	0	1	12	0	0
12	30419727	.	A	G	4	4	8	0	0	8	0	0
12	30442406	.	C	A	4	4	8	0	1	9	0	0
12	30442783	.	G	A	10	4	14	0	1	15	0	0
12	30443462	.	T	C	1	7	8	0	0	8	0	0
12	30459404	.	G	A	3	2	5	0	0	5	0	0
12	30459422	.	A	C	5	3	8	0	0	8	0	0
12	30459474	.	G	T	0	3	3	0	0	3	0	0
12	30459584	.	C	T	4	3	7	0	1	8	0	0
12	30459585	.	C	T	5	2	7	0	1	8	0	0
12	30475008	.	A	G	2	2	4	0	0	4	0	0
12	30497808	.	G	A	2	2	4	0	0	4	0	0
12	30567198	.	T	A	1	2	3	0	0	3	0	0
12	30706173	.	T	A	2	2	4	0	1	5	0	0
12	30706176	.	T	C	2	3	5	0	0	5	0	0
12	30741380	.	A	G	2	1	3	0	0	3	0	0
12	30796322	.	C	A	2	3	5	0	1	6	0	0
12	30796345	.	C	T	2	6	8	0	0	8	0	0
12	30798079	.	G	A	2	3	5	0	1	6	0	0
12	30798085	.	A	T	4	2	6	0	0	6	0	0
12	30803166	.	G	A	0	7	7	0	5	12	0	0
12	30803196	.	T	C	5	6	11	0	0	11	0	0
12	30803629	.	A	G	3	2	5	0	1	6	0	0
12	30805335	.	T	C	1	1	2	0	0	2	0	0
12	30805359	.	T	C	3	1	4	0	0	4	0	0
12	30805455	.	C	T	0	3	3	0	0	3	0	0
12	30806928	.	G	T	0	2	2	0	5	7	0	0
12	30807038	.	A	G	3	5	8	0	0	8	0	0
12	30807290	.	A	G	2	4	6	0	0	6	0	0
12	30807458	.	C	T	4	7	11	0	1	12	0	0
12	30807494	.	G	A	4	6	10	0	0	10	0	0
12	30807504	.	A	C	2	7	9	0	0	9	0	0
12	30808065	.	A	G	1	2	3	0	0	3	0	0
12	30808094	.	C	T	4	3	7	0	0	7	0	0
12	30808150	.	T	A	7	5	12	0	2	14	0	0
12	30808342	.	A	T	5	4	9	0	0	9	0	0
12	30808531	.	G	C	6	4	10	0	0	10	0	0
12	30808766	.	C	T	5	3	8	0	0	8	0	0
12	30808812	.	A	G	5	0	5	0	3	8	0	0
12	30808817	.	T	G	3	7	10	0	0	10	0	0
12	30979815	.	A	C	10	18	28	0	3	31	0	0
12	30979923	.	T	A	12	5	17	0	4	21	0	0
12	30980566	.	G	A	19	28	47	0	0	47	0	0
12	30981795	.	G	A	21	28	49	0	2	51	0	0
12	30986452	.	G	A	3	2	5	0	0	5	0	0
12	31102981	.	A	G	8	8	16	0	2	18	0	0
12	31435977	.	T	A	1	2	3	0	1	4	0	0
12	31438056	.	G	T	7	4	11	0	1	12	0	0
12	31438352	.	A	T	1	6	7	0	2	9	0	0
12	31438440	.	C	A	3	2	5	0	0	5	0	0
12	31523203	.	T	C	0	2	2	0	0	2	0	0
12	31528169	.	G	C	0	0	0	0	1	1	0	0
12	31531950	.	T	G	5	5	10	0	0	10	0	0
12	31532371	.	G	A	0	2	2	0	5	7	0	0
12	31532577	.	T	C	5	8	13	0	0	13	0	0
12	31532638	.	A	C	6	4	10	0	2	12	0	0
12	31532715	.	T	C	1	2	3	0	0	3	0	0
12	31629611	.	C	T	2	1	3	0	0	3	0	0
12	31664846	.	A	T	3	2	5	0	0	5	0	0
12	31704077	.	A	C	3	2	5	0	0	5	0	0
12	31704548	.	T	C	2	3	5	0	0	5	0	0
12	31708020	.	C	T	4	3	7	0	0	7	0	0
12	31708025	.	G	A	2	4	6	0	0	6	0	0
12	31708125	.	C	A	3	2	5	0	0	5	0	0
12	31720799	.	C	T	24	16	40	0	1	41	0	0
12	31722593	.	G	T	10	9	19	0	2	21	0	0
12	31722811	.	G	T	6	7	13	0	0	13	0	0
12	31722875	.	A	C	6	0	6	0	17	23	0	0
12	31724245	.	A	C	14	18	32	0	1	33	0	0
12	31724252	.	C	T	15	19	34	0	0	34	0	0
12	31729236	.	G	A	8	7	15	0	1	16	0	0
12	31740822	.	C	T	4	0	4	0	0	4	0	0
12	31753752	.	C	T	2	4	6	0	1	7	0	0
12	31753755	.	C	T	2	4	6	0	0	6	0	0
12	31764523	.	T	C	18	10	28	0	0	28	0	0
12	31764526	.	C	A	17	9	26	0	1	27	0	0
12	31765407	.	G	A	8	6	14	0	2	16	0	0
12	31765485	.	G	A	4	7	11	0	0	11	0	0
12	31765517	.	T	C	5	4	9	0	0	9	0	0
12	31765540	.	T	G	7	5	12	0	0	12	0	0
12	31789799	.	C	T	11	15	26	0	0	26	0	0
12	31794655	.	G	A	2	3	5	0	0	5	0	0
12	31911406	.	A	G	2	2	4	0	0	4	0	0
12	32039443	.	C	T	0	9	9	0	7	16	0	0
12	32039527	.	A	G	14	9	23	0	1	24	0	0
12	32039546	.	G	A	18	10	28	0	0	28	0	0
12	32039635	.	A	C	11	19	30	0	3	33	0	0
12	32039678	.	C	T	20	25	45	0	1	46	0	0
12	32039937	.	G	A	19	17	36	0	1	37	0	0
12	32039958	.	T	C	24	0	24	0	17	41	0	0
12	32040093	.	G	A	23	19	42	0	1	43	0	0
12	32045155	.	G	A	15	16	31	0	2	33	0	0
12	32045212	.	T	C	15	1	16	0	8	24	0	0
12	32066061	.	C	A	12	7	19	0	0	19	0	0
12	32068470	.	C	A	4	3	7	0	0	7	0	0
12	32068487	.	A	G	4	3	7	0	0	7	0	0
12	33336119	.	A	C	8	0	8	0	18	26	0	0
12	33350716	.	T	A	4	2	6	0	0	6	0	0
12	33351440	.	T	A	2	9	11	0	1	12	0	0
12	33473646	.	T	C	1	8	9	0	0	9	0	0
12	33603545	.	G	T	0	7	7	0	0	7	0	0
12	33604491	.	A	C	0	4	4	0	0	4	0	0
12	33967603	.	T	C	9	8	17	0	1	18	0	0
12	33967618	.	T	C	8	8	16	0	1	17	0	0
12	33967689	.	T	C	3	0	3	0	3	6	0	0
12	33988643	.	A	G	6	3	9	0	1	10	0	0
12	33991610	.	T	C	20	6	26	0	0	26	0	0
12	33991622	.	T	C	17	6	23	0	2	25	0	0
12	34821824	.	A	G	2	0	2	0	3	5	0	0
12	34877017	.	T	C	0	7	7	0	1	8	0	0
12	34953641	.	G	T	0	0	0	0	11	11	0	0
12	35008681	.	A	G	4	2	6	0	1	7	0	0
12	35012040	.	C	T	13	8	21	0	5	26	0	0
12	35012127	.	T	C	4	3	7	0	2	9	0	0
12	35014147	.	C	A	2	4	6	0	0	6	0	0
12	35014151	.	C	A	2	4	6	0	0	6	0	0
12	35018127	.	C	T	24	14	38	0	2	40	0	0
12	35046821	.	A	G	17	10	27	0	1	28	0	0
12	35046875	.	C	T	14	8	22	0	2	24	0	0
12	35046900	.	G	A	11	10	21	0	0	21	0	0
12	35046928	.	T	C	10	8	18	0	0	18	0	0
12	35046956	.	T	G	5	9	14	0	2	16	0	0
12	35046965	.	G	T	7	12	19	0	0	19	0	0
12	35047014	.	A	G	8	9	17	0	1	18	0	0
12	35051250	.	A	G	10	8	18	0	0	18	0	0
12	35099532	.	G	T	1	2	3	0	0	3	0	0
12	35099571	.	G	A	1	3	4	0	0	4	0	0
12	35099601	.	C	T	2	3	5	0	1	6	0	0
12	35099805	.	G	A	1	3	4	0	1	5	0	0
12	35103405	.	A	G	2	2	4	0	0	4	0	0
12	35103606	.	T	C	4	1	5	0	4	9	0	0
12	35103665	.	C	T	4	6	10	0	0	10	0	0
12	35103710	.	G	C	2	1	3	0	0	3	0	0
12	35105596	.	G	C	1	3	4	0	1	5	0	0
12	35146537	.	G	A	0	4	4	0	3	7	0	0
12	35146616	.	T	C	2	1	3	0	0	3	0	0
12	35149868	.	G	A	2	2	4	0	0	4	0	0
12	35158344	.	C	T	2	2	4	0	0	4	0	0
12	35189264	.	G	T	6	7	13	0	1	14	0	0
12	35189295	.	C	T	6	9	15	0	2	17	0	0
12	35189306	.	A	G	5	11	16	0	0	16	0	0
12	35189402	.	A	G	7	0	7	0	5	12	0	0
12	35189471	.	T	A	2	2	4	0	0	4	0	0
12	35191080	.	A	T	8	10	18	0	0	18	0	0
12	35191856	.	C	T	11	11	22	0	0	22	0	0
12	35270573	.	G	A	0	0	0	0	1	1	0	0
12	35317147	.	G	A	2	4	6	0	0	6	0	0
12	35317222	.	A	G	2	2	4	0	1	5	0	0
12	35317520	.	C	A	5	2	7	0	0	7	0	0
12	35317609	.	C	T	3	4	7	0	0	7	0	0
12	35325811	.	C	T	0	1	1	0	0	1	0	0
12	35328139	.	C	T	2	4	6	0	0	6	0	0
12	35330107	.	C	T	4	2	6	0	1	7	0	0
12	35332283	.	T	A	5	4	9	0	1	10	0	0
12	35339212	.	A	G	8	6	14	0	2	16	0	0
12	35339263	.	A	T	4	5	9	0	0	9	0	0
12	35339395	.	C	T	0	2	2	0	0	2	0	0
12	35346498	.	G	A	5	24	29	0	4	33	0	0
12	35346597	.	A	T	25	24	49	0	3	52	0	0
12	35346842	.	T	C	14	20	34	0	2	37	1	0
12	35346873	.	C	T	21	29	50	0	2	52	0	0
12	35347002	.	A	T	16	22	38	0	2	40	0	0
12	35347078	.	G	A	28	20	48	0	3	51	0	0
12	35347084	.	C	T	1	28	29	0	23	52	0	0
12	35347318	.	C	T	25	25	50	0	3	53	0	0
12	35347485	.	T	G	25	24	49	0	7	56	0	0
12	35347795	.	C	T	0	9	9	0	6	15	0	0
12	35347951	.	A	G	24	15	39	0	1	40	0	0
12	35350686	.	G	A	17	20	37	0	1	38	0	0
12	35351392	.	G	T	4	1	5	0	0	5	0	0
12	35381726	.	T	C	1	0	1	0	1	2	0	0
12	35381729	.	T	C	0	0	0	0	2	2	0	0
12	35386919	.	A	G	7	6	13	0	0	13	0	0
12	35543736	.	T	G	6	9	15	0	2	17	0	0
12	35543971	.	T	G	9	11	20	0	0	20	0	0
12	35544320	.	T	G	6	9	15	0	0	15	0	0
12	35544460	.	A	G	9	7	16	0	0	16	0	0
12	35544596	.	C	A	2	4	6	0	0	6	0	0
12	35544968	.	A	G	11	12	23	0	2	25	0	0
12	35556821	.	G	C	0	2	2	0	0	2	0	0
12	35559393	.	G	A	1	2	3	0	0	3	0	0
12	35559614	.	T	G	1	1	2	0	1	3	0	0
12	35568231	.	G	A	4	4	8	0	0	8	0	0
12	35568249	.	C	T	0	4	4	0	5	9	0	0
12	35568270	.	T	A	3	4	7	0	1	8	0	0
12	35568303	.	C	G	4	4	8	0	0	8	0	0
12	35568691	.	A	G	3	0	3	0	0	3	0	0
12	35568787	.	G	A	3	2	5	0	0	5	0	0
12	35568793	.	A	G	3	2	5	0	0	5	0	0
12	35593188	.	C	T	18	17	35	0	2	37	0	0
12	35593469	.	T	A	8	7	15	0	1	16	0	0
12	35593729	.	A	G	9	0	9	0	5	14	0	0
12	35594069	.	T	A	13	17	30	0	1	31	0	0
12	35594154	.	C	T	14	8	22	0	1	23	0	0
12	35594169	.	C	T	12	9	21	0	1	22	0	0
12	35594436	.	C	T	20	6	26	0	1	27	0	0
12	35594474	.	A	G	21	9	30	0	1	31	0	0
12	35594495	.	G	A	0	10	10	0	19	29	0	0
12	35594512	.	T	C	15	14	29	0	0	29	0	0
12	35594541	.	C	A	13	16	29	0	0	29	0	0
12	35594605	.	C	T	20	10	30	0	1	31	0	0
12	35594623	.	T	A	19	9	28	0	2	30	0	0
12	35674952	.	G	A	5	6	11	0	4	15	0	0
12	35689209	.	C	T	4	1	5	0	0	5	0	0
12	35689210	.	A	G	4	1	5	0	0	5	0	0
12	35704426	.	G	T	19	22	41	0	3	44	0	0
12	35704435	.	G	T	22	22	44	0	0	44	0	0
12	35704735	.	A	G	5	0	5	0	1	6	0	0
12	35704852	.	G	A	1	0	1	0	0	1	0	0
12	35704921	.	A	C	18	13	31	0	1	32	0	0
12	35704996	.	T	G	9	15	24	0	2	26	0	0
12	35705131	.	C	T	13	20	33	0	3	36	0	0
12	35705140	.	A	C	14	0	14	0	22	36	0	0
12	35705224	.	A	G	16	14	30	0	2	32	0	0
12	35705252	.	T	G	15	19	34	0	1	35	0	0
12	35705323	.	G	A	8	15	23	0	1	24	0	0
12	35705367	.	C	T	1	10	11	0	17	28	0	0
12	35705565	.	C	T	0	6	6	0	10	16	0	0
12	35705606	.	A	T	10	7	17	0	1	18	0	0
12	35705661	.	T	C	16	11	27	0	1	28	0	0
12	35705926	.	C	T	25	12	37	0	3	40	0	0
12	35706091	.	C	T	11	10	21	0	0	21	0	0
12	35706124	.	A	G	10	10	20	0	1	21	0	0
12	35706253	.	A	T	10	14	24	0	0	24	0	0
12	35706304	.	A	G	11	15	26	0	0	26	0	0
12	35706524	.	G	A	14	12	26	0	2	28	0	0
12	35706568	.	C	T	11	12	23	0	1	24	0	0
12	35706859	.	C	T	0	7	7	0	13	20	0	0
12	35706970	.	G	T	13	7	20	0	1	21	0	0
12	35707155	.	C	T	5	13	18	0	0	18	0	0
12	35707171	.	T	C	5	10	15	0	1	16	0	0
12	35707225	.	G	A	8	6	14	0	1	15	0	0
12	35707537	.	A	G	7	6	13	0	0	13	0	0
12	35707636	.	G	A	6	8	14	0	0	14	0	0
12	35707660	.	A	C	3	6	9	0	2	11	0	0
12	35707747	.	A	G	11	4	15	0	0	15	0	0
12	35707987	.	G	A	7	4	11	0	0	11	0	0
12	35708139	.	T	G	6	4	10	0	0	10	0	0
12	35708235	.	A	G	8	10	18	0	0	18	0	0
12	35708272	.	C	T	2	5	7	0	0	7	0	0
12	35708950	.	G	A	8	3	11	0	0	11	0	0
12	35709007	.	G	A	5	5	10	0	0	10	0	0
12	35709028	.	A	G	0	4	4	0	0	4	0	0
12	35710837	.	T	C	3	3	6	0	1	7	0	0
12	35715339	.	A	G	2	4	6	0	1	7	0	0
12	35716116	.	T	G	0	1	1	0	0	1	0	0
12	35740605	.	G	T	1	0	1	0	0	1	0	0
12	35837354	.	C	T	0	4	4	0	3	7	0	0
12	35837425	.	T	A	2	4	6	0	1	7	0	0
12	35837468	.	C	A	5	7	12	0	0	12	0	0
12	35837499	.	G	C	5	6	11	0	1	12	0	0
12	35837503	.	T	G	4	6	10	0	2	12	0	0
12	35837751	.	G	A	4	5	9	0	1	10	0	0
12	35837828	.	T	A	7	4	11	0	0	11	0	0
12	35838102	.	A	G	1	2	3	0	0	3	0	0
12	35838683	.	A	G	2	3	5	0	0	5	0	0
12	35839063	.	A	T	2	8	10	0	0	10	0	0
12	35839090	.	C	T	1	6	7	0	1	8	0	0
12	35839159	.	C	T	4	7	11	0	0	11	0	0
12	35839165	.	C	G	3	6	9	0	0	9	0	0
12	35839261	.	C	A	11	6	17	0	0	17	0	0
12	35839680	.	G	A	4	4	8	0	2	10	0	0
12	35839879	.	C	A	0	5	5	0	6	11	0	0
12	35840003	.	T	C	5	0	5	0	2	7	0	0
12	35840008	.	C	A	5	2	7	0	0	7	0	0
12	35840329	.	C	T	4	3	7	0	0	7	0	0
12	35840360	.	C	T	5	3	8	0	0	8	0	0
12	35840369	.	T	A	5	3	8	0	0	8	0	0
12	35840483	.	G	A	2	0	2	0	0	2	0	0
12	35840543	.	A	C	3	2	5	0	0	5	0	0
12	35841438	.	G	A	2	4	6	0	0	6	0	0
12	35841457	.	G	A	3	3	6	0	1	7	0	0
12	35841749	.	C	T	0	2	2	0	2	4	0	0
12	35847493	.	A	T	1	0	1	0	0	1	0	0
12	35847535	.	T	C	2	4	6	0	0	6	0	0
12	35847538	.	C	T	2	4	6	0	0	6	0	0
12	35853678	.	A	G	1	2	3	0	0	3	0	0
12	35853693	.	T	C	1	2	3	0	0	3	0	0
12	35865689	.	C	T	1	4	5	0	0	5	0	0
12	35875766	.	A	G	1	2	3	0	0	3	0	0
12	35883704	.	T	C	2	0	2	0	2	4	0	0
12	35963575	.	T	C	4	3	7	0	0	7	0	0
12	35967239	.	T	C	1	3	4	0	0	4	0	0
12	35980632	.	T	C	1	4	5	0	0	5	0	0
12	35980758	.	C	T	2	4	6	0	1	7	0	0
12	35980764	.	T	C	2	4	6	0	1	7	0	0
12	35980817	.	T	A	1	2	3	0	2	5	0	0
12	35980917	.	T	G	8	3	11	0	2	13	0	0
12	35981206	.	T	C	3	0	3	0	10	13	0	0
12	35981260	.	T	A	4	6	10	0	0	10	0	0
12	35981303	.	T	G	1	2	3	0	0	3	0	0
12	35981304	.	G	C	1	2	3	0	0	3	0	0
12	35981478	.	A	G	3	5	8	0	0	8	0	0
12	35981627	.	C	T	3	6	9	0	2	11	0	0
12	35981713	.	C	T	0	3	3	0	0	3	0	0
12	35981795	.	T	A	1	9	10	0	1	11	0	0
12	35981832	.	A	G	3	4	7	0	0	7	0	0
12	35988544	.	A	G	2	3	5	0	0	5	0	0
12	35988553	.	G	A	3	5	8	0	0	8	0	0
12	36103688	.	C	T	2	3	5	0	0	5	0	0
12	36158056	.	A	C	6	6	12	0	0	12	0	0
12	36158098	.	G	C	16	11	27	0	0	27	0	0
12	36158099	.	T	C	14	10	24	0	3	27	0	0
12	36158225	.	T	C	10	16	26	0	1	27	0	0
12	36158349	.	G	A	0	19	19	0	12	31	0	0
12	36158538	.	C	T	5	4	9	0	1	10	0	0
12	36159597	.	C	G	3	4	7	0	0	7	0	0
12	36413894	.	G	T	2	4	6	0	0	6	0	0
12	36413937	.	A	T	2	1	3	0	0	3	0	0
12	36416714	.	G	A	0	1	1	0	0	1	0	0
12	36420141	.	T	C	0	2	2	0	0	2	0	0
12	36422537	.	A	G	2	2	4	0	0	4	0	0
12	36424613	.	G	A	5	2	7	0	0	7	0	0
12	36424618	.	G	A	3	5	8	0	0	8	0	0
12	36462038	.	G	A	2	2	4	0	0	4	0	0
12	36468999	.	G	T	0	3	3	0	2	5	0	0
12	36469011	.	T	A	1	3	4	0	0	4	0	0
12	36471149	.	A	C	3	2	5	0	0	5	0	0
12	36471455	.	A	T	1	2	3	0	0	3	0	0
12	36471473	.	A	T	1	2	3	0	0	3	0	0
12	36471725	.	A	G	0	2	2	0	1	3	0	0
12	36891583	.	C	T	2	2	4	0	1	5	0	0
12	36895025	.	A	G	6	4	10	0	1	11	0	0
12	36895057	.	T	C	6	2	8	0	2	10	0	0
12	36895067	.	G	A	8	2	10	0	0	10	0	0
12	36952648	.	T	G	0	0	0	0	1	1	0	0
12	36952744	.	C	T	8	8	16	0	0	16	0	0
12	36960197	.	T	C	5	6	11	0	0	11	0	0
12	36960200	.	A	T	4	4	8	0	1	9	0	0
12	37003216	.	C	A	1	4	5	0	0	5	0	0
12	37003372	.	T	G	1	1	2	0	1	3	0	0
12	37003374	.	A	G	1	2	3	0	0	3	0	0
12	37003460	.	T	C	1	1	2	0	2	4	0	0
12	37003937	.	G	A	1	2	3	0	0	3	0	0
12	37005586	.	A	G	5	0	5	0	5	10	0	0
12	37275601	.	C	T	3	2	5	0	0	5	0	0
12	37275712	.	A	T	1	3	4	0	0	4	0	0
12	37275719	.	G	T	2	3	5	0	0	5	0	0
12	37275774	.	T	G	2	2	4	0	0	4	0	0
12	37407249	.	G	T	5	4	9	0	0	9	0	0
12	37407392	.	T	A	5	5	10	0	0	10	0	0
12	37407477	.	T	C	3	8	11	0	2	13	0	0
12	37407524	.	C	A	4	7	11	0	0	11	0	0
12	37407632	.	T	A	4	8	12	0	0	12	0	0
12	37407813	.	C	T	4	4	8	0	0	8	0	0
12	37408206	.	A	G	1	6	7	0	0	7	0	0
12	37408232	.	T	A	3	5	8	0	0	8	0	0
12	37409269	.	C	T	1	6	7	0	0	7	0	0
12	37409481	.	G	A	7	3	10	0	0	10	0	0
12	37409611	.	A	G	1	2	3	0	1	4	0	0
12	37409802	.	C	T	2	2	4	0	0	4	0	0
12	37409836	.	T	G	4	3	7	0	0	7	0	0
12	37410018	.	T	C	1	0	1	0	5	6	0	0
12	37410111	.	T	C	3	5	8	0	1	9	0	0
12	37410469	.	T	G	1	2	3	0	1	4	0	0
12	37410519	.	C	T	2	2	4	0	0	4	0	0
12	37410816	.	A	G	1	2	3	0	0	3	0	0
12	37410966	.	T	C	1	2	3	0	0	3	0	0
12	37463606	.	T	C	10	0	10	0	13	23	0	0
12	37490224	.	G	T	2	2	4	0	1	5	0	0
12	37497149	.	G	A	4	5	9	0	0	9	0	0
12	37515112	.	T	C	1	0	1	0	2	3	0	0
12	37530969	.	T	C	1	0	1	0	0	1	0	0
12	37531008	.	G	A	3	2	5	0	1	6	0	0
12	37531014	.	A	G	3	2	5	0	1	6	0	0
12	38556545	.	A	G	1	2	3	0	0	3	0	0
12	38556562	.	G	T	1	3	4	0	0	4	0	0
12	38561258	.	C	A	2	3	5	0	0	5	0	0
12	38787630	.	G	A	1	1	2	0	0	2	0	0
12	38799732	.	G	A	5	7	12	0	0	12	0	0
12	38799759	.	C	T	5	5	10	0	1	11	0	0
12	38799822	.	A	C	0	1	1	0	0	1	0	0
12	38802875	.	T	C	6	5	11	0	1	12	0	0
12	38803012	.	T	C	5	0	5	0	0	5	0	0
12	38803148	.	T	A	4	3	7	0	0	7	0	0
12	38803411	.	A	G	7	0	7	0	5	12	0	0
12	38803586	.	T	C	0	4	4	0	0	4	0	0
12	38803633	.	C	T	1	5	6	0	0	6	0	0
12	38803649	.	G	C	1	4	5	0	0	5	0	0
12	38804305	.	A	G	7	5	12	0	0	12	0	0
12	38804314	.	C	T	5	7	12	0	0	12	0	0
12	38804350	.	G	A	7	8	15	0	0	15	0	0
12	38804466	.	G	A	1	5	6	0	0	6	0	0
12	38819727	.	C	T	3	3	6	0	0	6	0	0
12	38828655	.	C	A	2	4	6	0	0	6	0	0
12	38843587	.	A	G	1	1	2	0	0	2	0	0
12	38847925	.	C	T	2	3	5	0	0	5	0	0
12	38849546	.	C	A	1	3	4	0	0	4	0	0
12	38850889	.	C	T	3	1	4	0	0	4	0	0
12	38854919	.	G	T	0	4	4	0	4	8	0	0
12	38855344	.	G	A	0	4	4	0	4	8	0	0
12	38855596	.	T	G	2	0	2	0	9	11	0	0
12	38855601	.	G	A	5	4	9	0	0	9	0	0
12	39744954	.	G	C	0	2	2	0	6	8	0	0
12	40206716	.	G	A	0	2	2	0	2	4	0	0
12	40348899	.	G	T	0	3	3	0	3	6	0	0
12	40497143	.	T	C	1	1	2	0	0	2	0	0
12	40518043	.	T	C	14	9	23	0	0	23	0	0
12	40518088	.	C	T	13	8	21	0	0	21	0	0
12	40518094	.	T	C	12	6	18	0	0	18	0	0
12	40905584	.	G	C	0	1	1	0	0	1	0	0
12	40905599	.	G	A	0	3	3	0	4	7	0	0
12	40945691	.	G	A	2	2	4	0	0	4	0	0
12	40945980	.	C	T	4	7	11	0	1	12	0	0
12	41000900	.	G	A	0	6	6	0	1	7	0	0
12	41000969	.	A	G	0	1	1	0	2	3	0	0
12	41028550	.	A	G	11	4	15	0	0	15	0	0
12	41028626	.	G	A	0	4	4	0	3	7	0	0
12	41037024	.	A	C	11	9	20	0	1	21	0	0
12	41071775	.	T	C	2	2	4	0	0	4	0	0
12	41071841	.	T	C	5	2	7	0	0	7	0	0
12	41112962	.	C	T	3	2	5	0	0	5	0	0
12	41113007	.	T	C	7	5	12	0	0	12	0	0
12	41113040	.	G	A	7	7	14	0	0	14	0	0
12	41113049	.	C	A	7	7	14	0	0	14	0	0
12	41113313	.	A	T	10	14	24	0	2	26	0	0
12	41113489	.	G	T	0	5	5	0	9	14	0	0
12	41369485	.	C	T	1	2	3	0	0	3	0	0
12	41437046	.	G	A	0	1	1	0	0	1	0	0
12	41449931	.	C	T	2	1	3	0	0	3	0	0
12	41455861	.	T	C	0	1	1	0	1	2	0	0
12	41461321	.	A	T	5	6	11	0	1	12	0	0
12	41535844	.	C	T	7	7	14	0	0	14	0	0
12	41535886	.	A	C	7	8	15	0	1	16	0	0
12	41535898	.	C	T	9	8	17	0	1	18	0	0
12	41535937	.	T	A	5	5	10	0	1	11	0	0
12	41539161	.	C	T	3	1	4	0	0	4	0	0
12	41549214	.	G	A	0	4	4	0	3	7	0	0
12	41549404	.	C	G	7	3	10	0	0	10	0	0
12	41549413	.	G	T	6	7	13	0	0	13	0	0
12	41549476	.	T	C	20	19	39	0	2	41	0	0
12	41581092	.	A	G	6	4	10	0	3	13	0	0
12	41581257	.	A	T	10	9	19	0	1	20	0	0
12	41593093	.	T	A	5	8	13	0	0	13	0	0
12	41612061	.	A	G	3	0	3	0	0	3	0	0
12	41631703	.	A	T	5	2	7	0	3	10	0	0
12	41632117	.	A	G	8	10	18	0	0	18	0	0
12	41633644	.	C	A	0	8	8	0	4	12	0	0
12	41636655	.	C	T	8	9	17	0	1	18	0	0
12	41636658	.	G	T	6	11	17	0	2	19	0	0
12	41643177	.	T	A	1	4	5	0	1	6	0	0
12	41643178	.	C	T	1	5	6	0	0	6	0	0
12	41643214	.	C	T	1	6	7	0	0	7	0	0
12	41643217	.	G	A	1	6	7	0	0	7	0	0
12	41647273	.	T	C	1	1	2	0	0	2	0	0
12	41647312	.	C	T	5	2	7	0	0	7	0	0
12	41653151	.	G	A	6	11	17	0	0	17	0	0
12	41656554	.	G	A	1	4	5	0	0	5	0	0
12	41661349	.	C	T	3	4	7	0	1	8	0	0
12	41684634	.	G	A	4	8	12	0	1	13	0	0
12	41698056	.	G	A	16	15	31	0	3	34	0	0
12	41702044	.	A	C	2	4	6	0	0	6	0	0
12	41723148	.	T	A	4	5	9	0	0	9	0	0
12	41723310	.	C	T	1	9	10	0	10	20	0	0
12	41723457	.	G	A	13	6	19	0	0	19	0	0
12	41723477	.	C	T	3	7	10	0	4	14	0	0
12	41723501	.	A	T	0	5	5	0	1	6	0	0
12	41723608	.	T	A	16	10	26	0	2	28	0	0
12	41723747	.	C	T	6	8	14	0	1	15	0	0
12	41731908	.	G	A	2	1	3	0	0	3	0	0
12	41732013	.	C	T	0	4	4	0	7	11	0	0
12	41735790	.	T	C	4	2	6	0	0	6	0	0
12	41739297	.	G	T	2	2	4	0	1	5	0	0
12	41759621	.	A	C	11	0	11	0	8	19	0	0
12	41759669	.	C	T	0	7	7	0	10	17	0	0
12	41991699	.	T	A	1	2	3	0	0	3	0	0
12	41991744	.	T	G	3	7	10	0	0	10	0	0
12	41991796	.	A	C	4	6	10	0	0	10	0	0
12	41991797	.	C	T	4	6	10	0	0	10	0	0
12	41992005	.	A	C	4	2	6	0	1	7	0	0
12	41992094	.	G	A	1	5	6	0	1	7	0	0
12	41992971	.	A	T	3	6	9	0	1	10	0	0
12	42007693	.	A	G	10	1	11	0	8	19	0	0
12	42153216	.	A	G	3	6	9	0	0	9	0	0
12	42182963	.	G	A	2	0	2	0	0	2	0	0
12	42186478	.	A	G	3	2	5	0	0	5	0	0
12	42195697	.	A	T	8	7	15	0	0	15	0	0
12	42196136	.	T	A	2	2	4	0	0	4	0	0
12	42196571	.	T	A	3	6	9	0	0	9	0	0
12	42196924	.	A	G	10	5	15	0	2	17	0	0
12	42196933	.	T	G	10	7	17	0	0	17	0	0
12	42197759	.	G	A	2	3	5	0	1	6	0	0
12	42365296	.	A	T	1	2	3	0	0	3	0	0
12	42369668	.	G	T	10	11	21	0	1	22	0	0
12	42369685	.	C	T	0	10	10	0	8	18	0	0
12	42369848	.	G	A	11	6	17	0	0	17	0	0
12	42369912	.	A	G	15	10	25	0	1	26	0	0
12	42378970	.	T	C	6	2	8	0	0	8	0	0
12	42384900	.	G	T	9	7	16	0	0	16	0	0
12	42384924	.	T	C	3	0	3	0	4	7	0	0
12	42406210	.	T	C	5	3	8	0	0	8	0	0
12	42576815	.	C	T	15	17	32	0	1	33	0	0
12	42577187	.	C	T	20	16	36	0	2	38	0	0
12	42577492	.	T	G	11	10	21	0	0	21	0	0
12	42578024	.	G	A	1	14	15	0	13	28	0	0
12	42578117	.	A	T	12	5	17	0	0	17	0	0
12	42578127	.	T	A	9	11	20	0	1	21	0	0
12	42578958	.	A	G	8	13	21	0	1	22	0	0
12	43376709	.	C	T	0	9	9	0	7	16	0	0
12	43376960	.	A	T	6	3	9	0	0	9	0	0
12	43377049	.	G	T	6	3	9	0	3	12	0	0
12	43377281	.	G	C	9	9	18	0	1	19	0	0
12	43377505	.	A	T	9	12	21	0	0	21	0	0
12	43377558	.	T	C	4	3	7	0	0	7	0	0
12	43378839	.	T	A	1	2	3	0	0	3	0	0
12	43391390	.	T	C	2	0	2	0	1	3	0	0
12	43395597	.	G	A	9	4	13	0	0	13	0	0
12	43395955	.	A	G	2	3	5	0	1	6	0	0
12	43426072	.	A	G	2	3	5	0	0	5	0	0
12	44611693	.	C	T	2	3	5	0	0	5	0	0
12	44611943	.	G	A	0	2	2	0	1	3	0	0
12	46608849	.	A	T	7	2	9	0	0	9	0	0
12	46608873	.	T	C	6	2	8	0	1	9	0	0
12	46608946	.	C	G	3	6	9	0	0	9	0	0
12	46616449	.	C	T	0	1	1	0	0	1	0	0
12	46620187	.	A	G	3	1	4	0	0	4	0	0
12	46620220	.	T	C	5	6	11	0	0	11	0	0
12	46624466	.	C	T	1	3	4	0	0	4	0	0
12	46629215	.	A	T	4	3	7	0	0	7	0	0
12	46629345	.	A	G	6	8	14	0	1	15	0	0
12	46630805	.	C	T	6	3	9	0	1	10	0	0
12	46631038	.	A	G	10	3	13	2	0	15	0	0
12	46631267	.	G	T	2	4	6	0	0	6	0	0
12	46631329	.	T	A	2	2	4	0	0	4	0	0
12	46688007	.	C	T	5	4	9	0	0	9	0	0
12	46688224	.	T	C	0	2	2	0	0	2	0	0
12	46693103	.	C	T	1	1	2	0	0	2	0	0
12	46695674	.	A	G	4	3	7	0	0	7	0	0
12	46699492	.	A	G	0	0	0	0	2	2	0	0
12	46699624	.	C	T	2	4	6	0	0	6	0	0
12	46737278	.	T	C	2	1	3	0	0	3	0	0
12	46738259	.	A	T	14	0	14	0	0	14	0	0
12	46738288	.	C	A	6	5	11	0	1	12	0	0
12	46738325	.	T	G	3	0	3	0	4	7	0	0
12	46738363	.	G	A	1	2	3	0	1	4	0	0
12	46852982	.	C	T	3	6	9	0	0	9	0	0
12	46855065	.	A	G	3	0	3	0	3	6	0	0
12	46855074	.	C	T	3	3	6	0	0	6	0	0
12	46867324	.	C	T	15	13	28	0	0	28	0	0
12	46915362	.	C	T	2	3	5	0	0	5	0	0
12	46915452	.	T	C	2	2	4	0	0	4	0	0
12	46930412	.	G	C	1	2	3	0	0	3	0	0
12	46930650	.	A	G	3	5	8	0	0	8	0	0
12	46930676	.	T	C	4	5	9	0	0	9	0	0
12	46937461	.	G	A	6	5	11	0	2	13	0	0
12	46937814	.	A	C	2	4	6	0	0	6	0	0
12	46950880	.	A	T	2	2	4	0	0	4	0	0
12	46950892	.	A	C	2	2	4	0	0	4	0	0
12	46953552	.	A	G	0	2	2	0	0	2	0	0
12	46956898	.	C	T	0	3	3	0	1	4	0	0
12	46956916	.	G	A	1	4	5	0	0	5	0	0
12	46967967	.	C	T	4	3	7	0	1	8	0	0
12	46969482	.	T	C	7	9	16	0	0	16	0	0
12	46969488	.	G	A	0	5	5	0	9	14	0	0
12	46969602	.	T	C	2	1	3	0	0	3	0	0
12	46975549	.	T	G	9	4	13	0	2	15	0	0
12	46976021	.	C	T	6	10	16	0	1	17	0	0
12	46976075	.	A	G	1	3	4	0	0	4	0	0
12	46978207	.	A	G	2	0	2	0	10	12	0	0
12	46978237	.	C	T	1	5	6	0	1	7	0	0
12	46985337	.	A	C	7	7	14	0	0	14	0	0
12	46985461	.	C	T	11	8	19	0	3	22	0	0
12	46985540	.	T	A	9	9	18	0	0	18	0	0
12	46985648	.	G	A	8	7	15	0	0	15	0	0
12	46985691	.	A	T	9	3	12	0	0	12	0	0
12	46985740	.	T	A	8	2	10	0	1	11	0	0
12	46985749	.	T	G	7	3	10	0	0	10	0	0
12	46985818	.	T	G	11	3	14	0	0	14	0	0
12	46985838	.	G	A	12	5	17	0	0	17	0	0
12	47044825	.	C	T	8	5	13	0	1	14	0	0
12	47044834	.	A	G	7	10	17	0	1	18	0	0
12	47044878	.	A	T	8	15	23	0	3	26	0	0
12	47044890	.	C	A	5	17	22	0	3	25	0	0
12	47044920	.	G	A	2	10	12	0	8	20	0	0
12	47044952	.	G	A	5	3	8	0	2	10	0	0
12	47051363	.	A	G	9	15	24	0	2	26	0	0
12	47051481	.	C	T	20	15	35	0	0	35	0	0
12	47055306	.	A	G	3	5	8	0	1	9	0	0
12	47055396	.	T	A	15	17	32	0	2	34	0	0
12	47055513	.	T	C	11	13	24	0	2	26	0	0
12	47055609	.	A	G	12	0	12	0	12	24	0	0
12	47062513	.	C	A	13	15	28	0	0	28	0	0
12	47063007	.	G	A	10	9	19	0	0	19	0	0
12	47064418	.	T	C	19	15	34	0	0	34	0	0
12	47064466	.	G	A	12	7	19	0	1	20	0	0
12	47064615	.	G	A	0	3	3	1	2	6	0	0
12	47064654	.	C	T	7	16	23	0	2	26	1	0
12	47064657	.	G	C	8	17	25	0	2	27	0	0
12	47064864	.	G	T	8	13	21	0	1	22	0	0
12	47064888	.	G	A	8	11	19	0	0	19	0	0
12	47068657	.	A	G	13	0	13	0	14	27	0	0
12	47068720	.	C	A	8	13	21	0	0	21	0	0
12	47068738	.	C	T	16	7	23	0	2	25	0	0
12	47167452	.	A	G	1	0	1	0	2	3	0	0
12	47206404	.	C	G	0	0	0	0	1	1	0	0
12	47208338	.	C	G	1	3	4	0	0	4	0	0
12	47210442	.	C	G	0	2	2	0	0	2	0	0
12	47210460	.	A	G	1	0	1	0	2	3	0	0
12	47224612	.	G	A	0	0	0	0	1	1	0	0
12	47233256	.	A	G	0	3	3	0	0	3	0	0
12	47233265	.	A	T	0	1	1	0	0	1	0	0
12	47233541	.	G	A	3	3	6	0	0	6	0	0
12	47240404	.	G	A	2	3	5	0	0	5	0	0
12	47240410	.	G	A	0	4	4	0	2	6	0	0
12	47241585	.	G	C	0	4	4	0	4	8	0	0
12	47241609	.	G	T	0	5	5	0	4	9	0	0
12	47241630	.	C	T	2	7	9	0	0	9	0	0
12	47245151	.	T	C	1	2	3	0	0	3	0	0
12	47247858	.	C	T	2	2	4	0	0	4	0	0
12	47247963	.	G	T	1	6	7	0	0	7	0	0
12	47258993	.	T	G	1	0	1	0	4	5	0	0
12	47261099	.	C	T	3	2	5	0	0	5	0	0
12	47262385	.	A	T	3	2	5	0	0	5	0	0
12	47270288	.	C	T	7	4	11	0	0	11	0	0
12	47275233	.	A	G	2	0	2	0	1	3	0	0
12	47275326	.	C	G	2	2	4	0	0	4	0	0
12	47281118	.	C	A	5	5	10	0	1	11	0	0
12	47282131	.	G	A	0	3	3	0	5	8	0	0
12	47282137	.	G	A	5	2	7	0	1	8	0	0
12	47283544	.	G	C	3	2	5	0	0	5	0	0
12	47291529	.	G	C	0	4	4	0	6	10	0	0
12	47291685	.	G	A	8	6	14	0	0	15	1	0
12	47325323	.	G	T	0	3	3	0	0	3	0	0
12	47327631	.	C	T	1	1	2	0	0	2	0	0
12	47331855	.	C	T	4	9	13	0	0	13	0	0
12	47332134	.	A	T	11	11	22	0	2	24	0	0
12	47332185	.	A	G	10	15	25	0	0	25	0	0
12	47332236	.	A	G	10	15	25	0	0	25	0	0
12	47332389	.	G	A	12	14	26	0	1	27	0	0
12	47335472	.	C	T	2	2	4	0	0	4	0	0
12	47338311	.	A	G	14	21	35	0	0	35	0	0
12	47347875	.	C	T	5	5	10	1	0	11	0	0
12	47355211	.	C	T	6	17	23	0	0	23	0	0
12	47355358	.	T	G	0	1	1	0	0	1	0	0
12	47448986	.	C	T	17	9	26	0	2	28	0	0
12	47449481	.	C	T	4	10	14	0	1	15	0	0
12	47449793	.	C	A	5	5	10	0	1	11	0	0
12	47449886	.	T	C	6	9	15	0	2	17	0	0
12	47449967	.	G	A	10	9	19	0	1	20	0	0
12	47461261	.	T	C	3	3	6	0	0	6	0	0
12	47461282	.	C	T	5	4	9	0	0	9	0	0
12	47469850	.	G	C	2	0	2	0	0	2	0	0
12	47480299	.	A	C	2	1	3	0	0	3	0	0
12	47480404	.	G	A	7	6	13	0	0	13	0	0
12	47480536	.	A	C	4	11	15	0	0	15	0	0
12	47481229	.	G	C	1	6	7	0	6	13	0	0
12	47481611	.	G	A	5	8	13	0	0	13	0	0
12	47505208	.	G	A	4	0	4	0	0	4	0	0
12	47516762	.	G	A	2	6	8	0	0	8	0	0
12	47536254	.	C	T	4	0	4	0	1	5	0	0
12	47540933	.	T	C	23	22	45	0	1	46	0	0
12	47540934	.	C	T	23	21	44	0	2	46	0	0
12	47544339	.	G	T	3	3	6	0	1	7	0	0
12	47544543	.	A	G	2	2	4	0	0	4	0	0
12	47781034	.	C	T	1	2	3	0	1	4	0	0
12	47793646	.	A	G	2	1	3	0	0	3	0	0
12	47838942	.	C	T	1	2	3	0	0	3	0	0
12	47851950	.	T	C	1	0	1	0	0	1	0	0
12	47909053	.	C	T	1	0	1	0	0	1	0	0
12	47918826	.	C	A	1	1	2	0	0	2	0	0
12	48094293	.	G	T	4	3	7	0	0	7	0	0
12	48094308	.	G	A	5	2	7	0	0	7	0	0
12	48607024	.	C	G	1	3	4	0	0	4	0	0
12	48607149	.	C	A	3	2	5	0	0	5	0	0
12	48611371	.	G	A	1	2	3	0	0	3	0	0
12	48611461	.	C	T	3	3	6	0	0	6	0	0
12	48677792	.	G	A	1	1	2	0	1	3	0	0
12	48681663	.	G	A	0	3	3	0	5	8	0	0
12	48681708	.	C	T	6	6	12	0	0	12	0	0
12	48681711	.	T	C	7	6	13	0	0	13	0	0
12	48681826	.	A	T	7	7	14	0	1	15	0	0
12	48681827	.	T	A	7	8	15	0	0	15	0	0
12	48681942	.	A	T	5	6	11	0	0	11	0	0
12	48681997	.	A	T	3	4	7	0	1	8	0	0
12	48682002	.	A	G	3	4	7	0	0	7	0	0
12	48682228	.	G	T	0	7	7	0	4	11	0	0
12	48682237	.	C	G	4	5	9	0	1	10	0	0
12	48682301	.	G	A	0	5	5	0	5	10	0	0
12	48682317	.	A	G	7	5	12	0	0	13	1	0
12	48682419	.	A	G	7	3	10	0	0	10	0	0
12	48682424	.	A	T	7	3	10	0	0	10	0	0
12	48682629	.	T	G	6	9	15	0	0	15	0	0
12	48796933	.	G	A	0	1	1	0	1	2	0	0
12	48799268	.	G	A	7	7	14	0	0	14	0	0
12	48800641	.	A	C	0	2	2	0	0	2	0	0
12	48803225	.	T	C	11	10	21	0	0	21	0	0
12	48807955	.	T	C	6	6	12	0	0	12	0	0
12	48810690	.	C	T	5	3	8	0	1	9	0	0
12	48810879	.	C	T	9	8	17	0	1	18	0	0
12	48826461	.	T	C	10	10	20	0	2	22	0	0
12	48826626	.	G	A	5	4	9	0	0	9	0	0
12	48828356	.	C	G	1	1	2	0	0	2	0	0
12	48828431	.	G	A	0	5	5	0	6	11	0	0
12	48829379	.	T	C	0	1	1	0	0	1	0	0
12	48835113	.	C	T	0	1	1	0	0	1	0	0
12	48836553	.	A	C	5	18	23	0	0	23	0	0
12	48836576	.	A	G	4	1	5	0	14	19	0	0
12	48836627	.	T	C	8	3	11	0	0	11	0	0
12	48836705	.	T	A	3	3	6	0	1	7	0	0
12	48836966	.	G	T	15	8	23	0	0	23	0	0
12	48837047	.	T	G	9	4	13	0	0	13	0	0
12	48837219	.	C	G	5	7	12	0	1	13	0	0
13	113197	.	C	G	0	7	7	0	7	14	0	0
13	113203	.	C	G	0	12	12	0	1	13	0	0
13	216429	.	T	A	6	4	10	0	5	15	0	0
13	343567	.	G	T	0	5	5	0	0	5	0	0
13	343581	.	C	G	0	4	4	0	0	4	0	0
13	809779	.	A	G	9	4	13	0	1	14	0	0
13	2254668	.	A	C	1	0	1	0	1	3	1	0
13	2255239	.	G	A	2	1	3	0	1	4	0	0
13	2262104	.	G	A	2	2	4	0	0	4	0	0
13	2357775	.	G	C	3	4	7	0	0	7	0	0
13	2358026	.	A	T	4	6	10	0	0	10	0	0
13	2370556	.	G	T	0	8	8	0	9	17	0	0
13	2382376	.	A	G	2	0	2	0	4	6	0	0
13	2391803	.	A	G	17	0	17	0	14	31	0	0
13	2391818	.	A	G	17	11	28	0	4	32	0	0
13	2391948	.	G	A	0	13	13	0	15	28	0	0
13	2392397	.	G	A	8	8	16	0	1	17	0	0
13	2392434	.	G	A	6	5	11	0	1	12	0	0
13	2416904	.	A	C	1	3	4	0	0	4	0	0
13	2417235	.	C	T	2	2	4	0	0	4	0	0
13	2417251	.	C	T	1	2	3	0	0	3	0	0
13	2427331	.	T	C	5	6	11	0	3	14	0	0
13	2427569	.	T	C	10	0	10	0	17	27	0	0
13	2427702	.	T	C	23	4	27	0	23	50	0	0
13	2429080	.	C	A	27	19	46	0	3	49	0	0
13	2429300	.	A	G	4	4	8	0	0	8	0	0
13	2434335	.	G	T	10	6	16	0	0	16	0	0
13	2439886	.	C	T	1	2	3	0	0	3	0	0
13	2460487	.	T	C	2	2	4	0	0	4	0	0
13	2468070	.	G	A	2	5	7	0	0	7	0	0
13	2468112	.	G	A	3	5	8	0	0	8	0	0
13	2473421	.	G	A	3	2	5	0	0	5	0	0
13	2473424	.	T	C	3	2	5	0	0	5	0	0
13	2746311	.	A	C	9	10	19	0	2	21	0	0
13	2746350	.	A	G	7	0	7	0	9	16	0	0
13	2766946	.	A	G	1	0	1	0	3	4	0	0
13	2767003	.	T	C	4	6	10	0	0	10	0	0
13	2769810	.	T	C	1	1	2	0	0	2	0	0
13	2807099	.	A	C	3	4	7	0	0	7	0	0
13	2814352	.	G	A	8	9	17	0	0	17	0	0
13	2814421	.	T	C	2	3	5	0	1	6	0	0
13	2819432	.	C	T	3	2	5	0	1	6	0	0
13	2820601	.	C	G	1	0	1	0	0	1	0	0
13	2824513	.	T	C	1	2	3	0	0	3	0	0
13	2826324	.	A	G	21	0	21	0	11	32	0	0
13	2826397	.	T	C	13	14	27	0	0	27	0	0
13	2826445	.	G	C	0	9	9	0	18	27	0	0
13	2826473	.	T	A	22	6	28	0	1	29	0	0
13	2827560	.	A	C	13	13	26	0	3	29	0	0
13	2827578	.	C	A	11	19	30	0	1	31	0	0
13	2827605	.	G	T	14	21	35	0	1	36	0	0
13	2827700	.	G	C	9	28	37	0	1	38	0	0
13	2827808	.	A	G	21	5	26	0	0	26	0	0
13	2827867	.	A	G	15	12	27	0	5	32	0	0
13	2827918	.	A	T	10	5	15	0	1	16	0	0
13	2827998	.	G	A	11	15	26	0	0	26	0	0
13	2828028	.	T	C	12	18	30	0	2	32	0	0
13	2882632	.	C	T	1	2	3	0	0	3	0	0
13	2885473	.	A	G	2	2	4	0	0	4	0	0
13	2885485	.	C	G	2	0	2	0	2	4	0	0
13	2897475	.	T	A	2	2	4	0	0	4	0	0
13	2899483	.	G	A	4	5	9	0	0	9	0	0
13	2913844	.	T	C	6	11	17	0	0	17	0	0
13	2927778	.	G	A	8	10	18	0	1	19	0	0
13	2927832	.	T	A	8	9	17	0	4	21	0	0
13	3874618	.	T	C	4	3	7	0	0	7	0	0
13	3874815	.	T	C	2	0	2	0	3	5	0	0
13	3874831	.	T	C	2	3	5	0	0	5	0	0
13	3881204	.	T	C	1	3	4	0	0	4	0	0
13	3881208	.	G	T	1	3	4	0	0	4	0	0
13	3915333	.	A	G	8	5	13	0	0	13	0	0
13	3915383	.	C	A	10	7	17	0	1	18	0	0
13	3915476	.	A	C	11	8	19	0	2	21	0	0
13	3915644	.	A	C	20	5	25	0	0	25	0	0
13	3915981	.	C	T	0	4	4	1	18	23	0	0
13	3919353	.	T	G	12	11	23	0	1	24	0	0
13	3919632	.	A	G	18	7	25	0	1	26	0	0
13	3919672	.	T	G	9	9	18	0	0	18	0	0
13	3919686	.	G	A	8	7	15	0	1	16	0	0
13	3920727	.	A	G	1	0	1	0	0	1	0	0
13	3920759	.	C	T	1	0	1	0	0	1	0	0
13	3922791	.	T	C	1	0	1	0	0	1	0	0
13	3927916	.	T	C	2	1	3	0	2	5	0	0
13	3927931	.	T	C	5	2	7	0	2	9	0	0
13	3927975	.	T	A	6	3	9	0	0	9	0	0
13	3942055	.	G	A	1	12	13	0	9	22	0	0
13	3945643	.	C	T	3	11	14	0	1	15	0	0
13	3950007	.	G	A	7	12	19	0	0	21	2	0
13	3950044	.	A	G	10	14	24	0	3	27	0	0
13	3950307	.	A	G	7	8	15	0	1	16	0	0
13	3950577	.	C	G	11	10	21	0	0	21	0	0
13	3950669	.	T	A	6	5	11	0	2	13	0	0
13	3954695	.	G	T	5	3	8	0	0	8	0	0
13	3960979	.	A	C	2	2	4	0	0	4	0	0
13	3962812	.	T	C	5	3	8	0	0	8	0	0
13	3962853	.	A	G	2	0	2	0	4	6	0	0
13	3965910	.	T	C	9	5	14	0	0	14	0	0
13	3980349	.	C	T	0	3	3	0	2	5	0	0
13	3980947	.	T	C	11	1	12	0	14	26	0	0
13	3980962	.	G	A	9	8	17	0	3	20	0	0
13	3980993	.	C	T	0	7	7	0	10	17	0	0
13	3981471	.	A	G	1	2	3	0	0	3	0	0
13	3981579	.	G	T	5	5	10	0	2	12	0	0
13	3981832	.	T	A	3	1	4	0	1	5	0	0
13	3982679	.	A	G	1	4	5	0	0	5	0	0
13	3983112	.	G	C	1	2	3	0	0	3	0	0
13	4205733	.	C	T	1	1	2	0	0	2	0	0
13	4213477	.	C	A	5	4	9	0	0	9	0	0
13	4213594	.	G	T	0	1	1	0	1	2	0	0
13	4213598	.	C	T	1	1	2	0	1	3	0	0
13	4213861	.	T	C	9	8	17	0	0	17	0	0
13	4226678	.	C	A	15	8	23	0	0	23	0	0
13	4231368	.	G	T	1	19	20	0	18	38	0	0
13	4231396	.	C	T	15	17	32	0	2	34	0	0
13	4231438	.	T	A	12	10	22	0	1	23	0	0
13	4231652	.	A	G	2	13	15	0	0	15	0	0
13	4231819	.	G	A	12	9	21	1	1	23	0	0
13	4232014	.	T	A	4	8	12	0	0	12	0	0
13	4232016	.	G	A	1	5	6	0	6	12	0	0
13	4232054	.	A	T	10	6	16	0	1	17	0	0
13	4232112	.	A	G	14	9	23	0	3	26	0	0
13	4232171	.	C	T	9	21	30	0	2	32	0	0
13	4232737	.	A	G	10	7	17	0	0	17	0	0
13	4233030	.	C	T	0	24	24	0	11	35	0	0
13	4233033	.	G	A	22	9	31	0	2	33	0	0
13	4233361	.	G	T	11	8	19	0	0	19	0	0
13	4233365	.	G	A	7	10	17	0	1	18	0	0
13	4233625	.	T	A	13	9	22	0	1	24	1	0
13	4233779	.	G	A	18	12	30	0	0	30	0	0
13	4233889	.	G	A	9	7	16	0	1	17	0	0
13	4233911	.	G	C	9	10	19	0	1	20	0	0
13	4233970	.	A	G	10	11	21	0	1	22	0	0
13	4234139	.	A	T	10	2	12	2	0	14	0	0
13	4234337	.	G	A	8	12	20	0	1	21	0	0
13	4234349	.	G	T	13	4	17	0	3	20	0	0
13	4238449	.	T	C	4	4	8	0	0	8	0	0
13	4247007	.	G	A	2	1	3	0	0	3	0	0
13	4256617	.	A	G	1	3	4	0	1	5	0	0
13	4302690	.	A	T	0	4	4	0	0	4	0	0
13	4307782	.	C	T	9	8	17	0	0	17	0	0
13	4308714	.	C	A	9	15	24	0	1	25	0	0
13	4308948	.	C	T	6	9	15	0	1	16	0	0
13	4308983	.	G	C	9	1	10	0	15	25	0	0
13	4309166	.	T	G	10	12	22	0	0	22	0	0
13	4309607	.	T	C	13	6	19	0	0	19	0	0
13	4309746	.	A	G	7	7	14	0	1	15	0	0
13	4309778	.	T	A	2	5	7	0	1	8	0	0
13	4309866	.	T	C	10	6	16	0	1	17	0	0
13	4310247	.	G	A	10	8	18	0	0	18	0	0
13	4310349	.	T	A	10	17	27	0	0	27	0	0
13	4310367	.	C	G	0	19	19	0	13	32	0	0
13	4310511	.	C	T	0	11	11	0	21	32	0	0
13	4310565	.	G	A	14	20	34	0	0	34	0	0
13	4310610	.	C	T	10	11	21	0	4	25	0	0
13	4310976	.	T	C	5	0	5	0	3	8	0	0
13	4311114	.	A	G	8	12	20	0	0	20	0	0
13	4311912	.	C	T	5	1	6	0	0	6	0	0
13	4314226	.	T	G	4	1	5	0	0	5	0	0
13	4314227	.	C	T	4	1	5	0	0	5	0	0
13	4317721	.	T	C	4	4	8	0	0	8	0	0
13	4320781	.	G	C	5	3	8	0	0	8	0	0
13	4325371	.	T	C	2	5	7	0	0	7	0	0
13	4325443	.	C	G	6	2	8	0	0	8	0	0
13	4330240	.	G	A	1	0	1	0	0	1	0	0
13	4332807	.	G	A	1	3	4	0	0	4	0	0
13	4332851	.	T	G	2	3	5	0	4	9	0	0
13	4333087	.	T	G	4	4	8	0	0	8	0	0
13	4339638	.	T	C	5	0	5	0	6	11	0	0
13	4343183	.	C	T	0	9	9	0	3	12	0	0
13	4343437	.	C	T	0	7	7	0	10	17	0	0
13	4343468	.	T	A	6	6	12	0	3	15	0	0
13	4343490	.	G	A	9	6	15	0	1	16	0	0
13	4344100	.	C	G	3	3	6	0	0	6	0	0
13	4344159	.	C	G	6	3	9	0	0	9	0	0
13	4344378	.	A	T	2	2	4	0	0	4	0	0
13	4344800	.	T	C	2	2	4	0	0	4	0	0
13	4344872	.	G	C	3	5	8	0	0	8	0	0
13	4344938	.	T	C	4	5	9	0	1	10	0	0
13	4347474	.	T	G	4	2	6	0	0	6	0	0
13	4349830	.	G	T	1	1	2	0	0	2	0	0
13	4361847	.	A	G	0	1	1	0	1	2	0	0
13	4399510	.	T	C	0	2	2	0	0	2	0	0
13	4606072	.	T	A	2	0	2	0	0	2	0	0
13	4608482	.	C	T	2	1	3	0	0	3	0	0
13	4615169	.	T	C	2	1	3	0	0	3	0	0
13	4951747	.	T	C	5	9	14	0	1	15	0	0
13	4956118	.	G	A	8	8	16	0	1	17	0	0
13	4956151	.	C	T	3	3	6	0	0	6	0	0
13	4968421	.	A	G	1	3	4	0	0	4	0	0
13	4968583	.	T	A	12	7	19	0	0	19	0	0
13	4968849	.	A	G	10	8	18	0	1	19	0	0
13	4968890	.	T	C	12	10	22	0	1	23	0	0
13	4968905	.	T	C	13	9	22	0	2	24	0	0
13	4969380	.	A	G	4	15	19	0	1	20	0	0
13	4973701	.	T	A	6	6	12	0	1	13	0	0
13	4973775	.	C	A	4	7	11	0	0	11	0	0
13	4973856	.	C	T	0	4	4	0	5	9	0	0
13	4973979	.	A	G	4	6	10	0	0	10	0	0
13	4977950	.	C	T	0	1	1	0	1	2	0	0
13	4977962	.	A	G	1	1	2	0	0	2	0	0
13	4978620	.	G	A	1	0	1	0	0	1	0	0
13	4978680	.	A	G	8	10	18	0	1	19	0	0
13	4978821	.	T	C	10	0	10	0	15	25	0	0
13	4979150	.	C	T	2	2	4	0	1	5	0	0
13	4979163	.	A	T	3	2	5	0	1	6	0	0
13	4979190	.	T	C	6	4	10	0	0	10	0	0
13	4979550	.	A	G	7	4	11	0	1	12	0	0
13	4979754	.	A	G	3	10	13	0	0	13	0	0
13	4982091	.	C	T	0	3	3	0	8	11	0	0
13	4982199	.	T	C	9	6	15	0	0	15	0	0
13	4982217	.	A	C	11	1	12	0	6	18	0	0
13	4982336	.	T	C	5	4	9	0	0	9	0	0
13	4984377	.	T	G	3	1	4	0	0	4	0	0
13	4986095	.	A	G	2	0	2	0	0	2	0	0
13	4987706	.	T	C	1	0	1	0	1	2	0	0
13	4995638	.	G	T	0	13	13	0	11	24	0	0
13	4995902	.	A	G	8	5	13	0	0	14	1	0
13	4995916	.	T	A	4	4	8	0	0	8	0	0
13	5000490	.	G	A	0	3	3	0	1	4	0	0
13	5000606	.	G	A	5	4	9	0	0	9	0	0
13	5000615	.	T	A	3	0	3	0	1	4	0	0
13	5013813	.	T	C	0	2	2	0	0	2	0	0
13	5013999	.	A	G	5	8	13	0	0	13	0	0
13	5017657	.	A	G	11	10	21	0	1	22	0	0
13	5017699	.	G	A	19	18	37	0	2	39	0	0
13	5017866	.	T	C	0	1	1	0	0	1	0	0
13	5245655	.	T	C	1	3	4	0	0	4	0	0
13	5245660	.	T	C	2	1	3	0	1	4	0	0
13	5246035	.	T	C	1	2	3	0	0	3	0	0
13	5246065	.	T	C	1	3	4	0	0	4	0	0
13	5246113	.	G	A	3	2	5	0	0	5	0	0
13	5246898	.	C	A	2	2	4	0	0	4	0	0
13	5491234	.	G	A	21	23	44	0	1	45	0	0
13	5531709	.	A	G	10	8	18	0	0	18	0	0
13	5568993	.	G	A	5	13	18	0	0	18	0	0
13	5569344	.	C	T	5	4	9	0	0	9	0	0
13	5870703	.	C	G	1	3	4	0	0	4	0	0
13	5871084	.	C	A	1	4	5	0	1	6	0	0
13	5871145	.	C	G	3	4	7	0	0	7	0	0
13	5871281	.	A	T	3	3	6	0	0	6	0	0
13	5871538	.	A	G	2	3	5	0	0	5	0	0
13	5872027	.	G	A	2	5	7	0	0	7	0	0
13	5872126	.	G	A	2	3	5	0	0	5	0	0
13	5872300	.	G	A	1	1	2	0	1	3	0	0
13	5872354	.	T	C	3	2	5	0	0	5	0	0
13	5872355	.	T	C	3	0	3	0	2	5	0	0
13	5872596	.	G	C	8	4	12	0	0	12	0	0
13	5894374	.	A	G	0	2	2	0	1	3	0	0
13	5936945	.	T	G	4	6	10	0	1	11	0	0
13	5953766	.	G	C	1	2	3	0	1	4	0	0
13	5974373	.	C	G	2	3	5	0	0	5	0	0
13	5978865	.	T	C	0	1	1	0	0	1	0	0
13	5978871	.	A	G	0	0	0	0	1	1	0	0
13	5985772	.	A	G	0	2	2	0	0	2	0	0
13	5987702	.	T	C	8	5	13	0	1	14	0	0
13	5987712	.	A	G	7	4	11	0	0	11	0	0
13	6092108	.	C	G	1	0	1	0	0	1	0	0
13	6095996	.	A	C	0	1	1	0	0	1	0	0
13	6205274	.	T	A	1	9	10	0	0	10	0	0
13	7051470	.	C	T	1	2	3	0	0	3	0	0
13	7061380	.	C	T	0	1	1	0	0	1	0	0
13	7061413	.	G	A	0	3	3	0	0	3	0	0
13	7062882	.	C	T	1	2	3	0	0	3	0	0
13	7062883	.	T	A	1	1	2	0	1	3	0	0
13	7062945	.	A	T	4	6	10	0	0	10	0	0
13	7062963	.	T	G	4	7	11	0	0	11	0	0
13	7063446	.	T	C	1	2	3	0	1	4	0	0
13	7063494	.	G	T	0	3	3	0	4	7	0	0
13	7063602	.	C	G	8	8	16	0	2	18	0	0
13	7063708	.	T	A	5	4	9	0	0	9	0	0
13	7063709	.	G	A	5	4	9	0	0	9	0	0
13	7114439	.	T	C	0	1	1	0	0	1	0	0
13	7156984	.	A	G	5	0	5	0	2	7	0	0
13	7156987	.	A	G	5	0	5	0	2	7	0	0
13	7170061	.	C	T	2	2	4	0	0	4	0	0
13	7170250	.	C	T	1	2	3	0	0	3	0	0
13	7180323	.	C	T	0	2	2	0	1	3	0	0
13	7184389	.	G	T	2	2	4	0	0	4	0	0
13	7209994	.	A	G	1	2	3	0	0	3	0	0
13	7241234	.	A	C	3	1	4	0	0	4	0	0
13	7243056	.	T	C	3	4	7	0	0	7	0	0
13	7243059	.	G	A	0	4	4	0	3	7	0	0
13	7243397	.	T	C	1	2	3	0	0	3	0	0
13	7243431	.	A	G	1	7	8	0	0	8	0	0
13	7243445	.	T	G	1	0	1	0	7	8	0	0
13	7243484	.	C	T	0	3	3	0	0	3	0	0
13	7243610	.	C	G	2	0	2	0	4	6	0	0
13	7258946	.	T	C	4	7	11	0	0	11	0	0
13	7306144	.	T	A	3	3	6	0	0	6	0	0
13	7307082	.	A	G	2	4	6	0	0	6	0	0
13	7307087	.	T	C	2	4	6	0	1	7	0	0
13	7308197	.	G	A	0	2	2	0	1	3	0	0
13	7308199	.	T	C	0	2	2	0	1	3	0	0
13	7310288	.	A	G	3	3	6	0	0	6	0	0
13	7310386	.	C	A	6	4	10	0	0	10	0	0
13	7310428	.	G	A	2	2	4	0	1	5	0	0
13	7310628	.	A	C	0	3	3	0	0	3	0	0
13	7311324	.	T	G	2	4	6	0	0	6	0	0
13	7312170	.	C	T	0	5	5	0	0	5	0	0
13	7312527	.	G	A	0	3	3	0	3	6	0	0
13	7312931	.	A	G	6	10	16	0	0	16	0	0
13	7313324	.	T	A	7	7	14	0	1	15	0	0
13	7313436	.	T	C	5	3	8	0	1	9	0	0
13	7313443	.	A	T	3	6	9	0	0	9	0	0
13	7313703	.	C	T	10	10	20	0	0	20	0	0
13	7313898	.	C	T	6	6	12	0	0	12	0	0
13	7314451	.	A	G	9	0	9	0	9	18	0	0
13	7314509	.	C	T	10	5	15	0	1	16	0	0
13	7314736	.	A	C	12	15	27	0	1	28	0	0
13	7314859	.	C	A	3	14	17	0	0	17	0	0
13	7315123	.	C	T	15	15	30	0	0	30	0	0
13	7315174	.	C	A	16	17	33	0	0	33	0	0
13	7315197	.	A	G	20	0	20	0	10	30	0	0
13	7315234	.	A	G	17	12	29	0	1	30	0	0
13	7316463	.	G	A	11	5	16	0	0	16	0	0
13	7316603	.	A	T	8	5	13	0	0	13	0	0
13	7316746	.	A	G	15	1	16	0	5	21	0	0
13	7316784	.	G	A	6	9	15	0	0	15	0	0
13	7316830	.	C	G	7	6	13	0	0	13	0	0
13	7316849	.	A	T	6	3	9	0	2	11	0	0
13	7322456	.	T	A	3	8	11	0	0	11	0	0
13	7333342	.	G	T	3	2	5	0	0	5	0	0
13	7346655	.	C	A	15	0	15	0	0	15	0	0
13	7346683	.	A	G	13	8	21	0	0	21	0	0
13	7346798	.	A	G	32	8	40	0	2	42	0	0
13	7346965	.	A	G	6	7	13	0	2	15	0	0
13	7346966	.	A	T	8	7	15	0	0	15	0	0
13	7347026	.	A	G	10	11	21	0	4	25	0	0
13	7347060	.	G	T	7	9	16	0	1	17	0	0
13	7347061	.	A	T	8	9	17	0	0	17	0	0
13	7347125	.	G	A	5	6	11	0	0	11	0	0
13	7556891	.	G	A	1	1	2	0	1	3	0	0
13	7725965	.	C	T	4	6	10	0	0	10	0	0
13	7728958	.	C	T	1	2	3	0	0	3	0	0
13	7744443	.	G	A	3	1	4	0	0	4	0	0
13	7744624	.	T	G	13	14	27	0	2	29	0	0
13	7745372	.	G	A	0	2	2	0	1	3	0	0
13	7745378	.	G	T	1	2	3	0	0	3	0	0
13	7745463	.	C	G	5	7	12	0	1	13	0	0
13	7746796	.	A	G	2	1	3	0	1	4	0	0
13	7746804	.	A	G	1	2	3	0	0	3	0	0
13	7747175	.	T	C	1	3	4	0	0	4	0	0
13	7747513	.	C	G	5	4	9	0	0	9	0	0
13	7747760	.	T	C	5	16	21	0	1	22	0	0
13	7748021	.	G	T	11	8	19	0	0	19	0	0
13	7748164	.	A	G	9	0	9	0	4	13	0	0
13	7748218	.	T	C	9	9	18	0	0	18	0	0
13	7748497	.	T	G	5	4	9	0	1	10	0	0
13	7748882	.	A	T	10	13	23	0	0	23	0	0
13	7748995	.	T	A	5	8	13	0	0	13	0	0
13	7749000	.	G	C	4	8	12	0	0	12	0	0
13	7755764	.	A	C	2	0	2	0	2	4	0	0
13	7759403	.	T	C	10	5	15	0	0	15	0	0
13	7766936	.	C	T	0	14	14	0	18	32	0	0
13	8142558	.	A	G	4	1	5	0	0	5	0	0
13	8152973	.	T	C	2	2	4	0	0	5	1	0
13	8153006	.	T	C	3	2	5	0	0	5	0	0
13	8777991	.	A	G	20	2	22	0	0	25	3	0
13	9760513	.	A	G	1	0	1	0	3	4	0	0
13	9825710	.	T	A	0	2	2	0	0	2	0	0
13	9825852	.	G	A	0	1	1	0	0	1	0	0
13	9825882	.	G	A	0	1	1	0	0	1	0	0
13	9828780	.	G	A	3	3	6	0	0	6	0	0
13	9828849	.	G	A	8	3	11	0	0	11	0	0
13	9828933	.	G	T	9	3	12	0	0	12	0	0
13	9829007	.	A	G	5	5	10	0	0	10	0	0
13	9829013	.	C	T	5	5	10	0	1	11	0	0
13	9829197	.	T	C	0	3	3	0	0	3	0	0
13	9829855	.	C	T	4	3	7	0	1	8	0	0
13	9830066	.	A	T	4	2	6	0	2	8	0	0
13	9830089	.	T	C	2	7	9	0	1	10	0	0
13	9830571	.	A	G	6	2	8	0	0	8	0	0
13	9830597	.	C	A	1	2	3	0	0	3	0	0
13	9841702	.	T	A	4	17	21	0	0	21	0	0
13	9844440	.	G	A	4	3	7	0	1	8	0	0
13	9844527	.	A	G	2	1	3	0	1	4	0	0
13	9848385	.	G	A	2	5	7	0	1	8	0	0
13	9848577	.	A	G	21	32	53	0	3	56	0	0
13	9855508	.	G	T	15	12	27	0	1	28	0	0
13	9855874	.	G	A	11	15	26	0	1	27	0	0
13	9856319	.	A	G	8	16	24	0	0	24	0	0
13	9856427	.	A	G	13	14	27	0	1	28	0	0
13	9856493	.	A	T	22	16	38	0	3	41	0	0
13	9856658	.	A	G	15	13	28	0	3	31	0	0
13	9863888	.	G	A	0	2	2	0	0	2	0	0
13	9866911	.	A	G	2	5	7	0	0	7	0	0
13	9870586	.	G	T	0	1	1	0	0	1	0	0
13	10360768	.	G	T	2	2	4	0	0	4	0	0
13	10380372	.	A	G	1	1	2	0	0	2	0	0
13	11007087	.	G	A	0	2	2	0	0	2	0	0
13	11869127	.	C	T	1	3	4	0	1	5	0	0
13	12635862	.	C	A	2	1	3	0	1	4	0	0
13	12665183	.	T	C	6	0	6	0	3	9	0	0
13	12665595	.	T	C	10	4	14	0	1	15	0	0
13	12665745	.	T	C	3	4	7	0	1	8	0	0
13	12993890	.	C	T	0	1	1	0	2	3	0	0
13	12994738	.	A	T	14	5	19	0	1	20	0	0
13	12994743	.	G	T	6	11	17	0	3	20	0	0
13	12997845	.	C	T	5	6	11	0	1	12	0	0
13	13001540	.	G	T	2	2	4	0	0	4	0	0
13	13006639	.	C	T	1	0	1	0	0	1	0	0
13	13006642	.	A	T	1	0	1	0	0	1	0	0
13	13019277	.	C	G	1	3	4	0	0	4	0	0
13	13027068	.	A	C	2	2	4	0	1	5	0	0
13	13072658	.	G	T	2	3	5	0	1	6	0	0
13	13091079	.	T	C	3	6	9	0	0	9	0	0
13	13094191	.	A	G	1	0	1	0	0	1	0	0
13	13096526	.	T	C	5	6	11	0	0	11	0	0
13	13099710	.	A	T	2	3	5	0	0	5	0	0
13	13213863	.	G	A	4	2	6	0	0	6	0	0
13	13214412	.	G	A	9	10	19	0	3	22	0	0
13	13214571	.	T	A	4	3	7	0	2	9	0	0
13	13214648	.	C	T	3	2	5	0	0	5	0	0
13	13215010	.	A	G	4	5	9	0	0	9	0	0
13	13215332	.	C	G	3	2	5	0	1	6	0	0
13	13215675	.	T	C	1	4	5	0	0	5	0	0
13	13215680	.	T	C	4	2	6	0	0	6	0	0
13	13216071	.	A	T	4	6	10	0	2	12	0	0
13	13216381	.	T	A	3	1	4	0	0	4	0	0
13	13216424	.	T	C	4	0	4	0	0	4	0	0
13	13218594	.	C	T	4	3	7	0	0	7	0	0
13	13228465	.	G	A	1	2	3	0	0	3	0	0
13	13228489	.	T	C	3	1	4	0	1	5	0	0
13	13693781	.	A	T	3	7	10	0	0	10	0	0
13	13697957	.	G	A	0	1	1	0	0	1	0	0
13	13698240	.	G	T	4	0	4	0	0	4	0	0
13	13704011	.	T	G	0	2	2	0	0	2	0	0
13	13711149	.	A	G	2	0	2	0	0	2	0	0
13	13713106	.	C	G	2	3	5	0	0	5	0	0
13	13733417	.	G	T	15	6	21	0	1	22	0	0
13	13988647	.	G	A	1	5	6	0	0	6	0	0
13	13997097	.	C	T	1	3	4	0	0	4	0	0
13	13997299	.	C	T	4	6	10	0	0	10	0	0
13	13997545	.	G	A	1	2	3	0	0	3	0	0
13	13997829	.	G	A	2	3	5	0	0	5	0	0
13	14002936	.	A	T	3	2	5	0	0	5	0	0
13	14002979	.	G	T	3	3	6	0	0	6	0	0
13	14003099	.	A	G	4	5	9	0	0	9	0	0
13	14004141	.	C	T	5	3	8	0	1	9	0	0
13	14004209	.	C	T	4	9	13	0	0	13	0	0
13	14004246	.	T	A	5	6	11	0	0	11	0	0
13	14070774	.	A	T	1	1	2	0	0	2	0	0
13	14070961	.	C	T	2	2	4	0	0	4	0	0
13	14078691	.	G	A	0	2	2	0	3	5	0	0
13	14078752	.	T	C	0	1	1	0	0	1	0	0
13	14088909	.	G	T	2	2	4	0	0	4	0	0
13	14092489	.	C	T	0	3	3	0	0	3	0	0
13	14092573	.	G	A	3	4	7	0	0	7	0	0
13	14094441	.	G	A	1	0	1	0	0	1	0	0
13	14098156	.	T	C	1	0	1	0	0	1	0	0
13	14102253	.	C	T	4	2	6	0	0	6	0	0
13	14103916	.	C	T	3	5	8	0	1	9	0	0
13	14116632	.	C	T	1	1	2	0	0	2	0	0
13	14116869	.	T	C	6	9	15	0	0	15	0	0
13	14137061	.	C	T	1	2	3	0	0	3	0	0
13	14181846	.	A	T	14	5	19	0	0	19	0	0
13	14181912	.	A	C	7	7	14	0	0	14	0	0
13	14181952	.	T	C	2	10	12	0	0	12	0	0
13	14190780	.	C	T	0	15	15	0	11	26	0	0
13	14191033	.	T	C	7	12	19	0	1	20	0	0
13	14191045	.	G	C	8	12	20	0	2	22	0	0
13	14192110	.	T	C	10	8	18	0	0	18	0	0
13	14192131	.	G	A	7	7	14	0	0	14	0	0
13	14192178	.	A	T	8	6	14	0	0	14	0	0
13	14192376	.	A	G	4	8	12	0	2	14	0	0
13	14192511	.	A	T	4	8	12	0	0	12	0	0
13	14194241	.	C	G	2	7	9	0	6	15	0	0
13	14194256	.	A	G	9	10	19	0	1	20	0	0
13	14194640	.	C	T	11	9	20	0	0	20	0	0
13	14194660	.	G	A	9	10	19	0	1	20	0	0
13	14194836	.	C	T	0	8	8	0	12	20	0	0
13	14194968	.	T	A	7	6	13	0	1	14	0	0
13	14195100	.	A	G	3	3	6	0	0	6	0	0
13	14199220	.	A	T	12	13	25	0	1	26	0	0
13	14220900	.	G	A	6	6	12	0	0	12	0	0
13	14241819	.	C	T	3	10	13	0	0	13	0	0
13	14251160	.	G	A	8	4	12	0	0	12	0	0
13	14251280	.	C	T	0	3	3	0	3	6	0	0
13	14251313	.	C	A	0	1	1	0	0	1	0	0
13	14487429	.	T	A	1	7	8	0	0	8	0	0
13	14902500	.	C	A	8	4	12	0	0	12	0	0
13	14902507	.	T	C	6	4	10	0	0	10	0	0
13	14902546	.	C	T	9	5	14	0	0	14	0	0
13	14906587	.	G	C	10	7	17	0	0	17	0	0
13	14906614	.	G	A	5	7	12	0	0	12	0	0
13	14908880	.	A	G	4	4	8	0	1	9	0	0
13	14908903	.	T	C	3	3	6	0	0	6	0	0
13	15141803	.	A	T	1	2	3	0	0	3	0	0
13	15194509	.	A	G	2	3	5	0	0	5	0	0
13	15210557	.	C	T	3	2	5	0	0	5	0	0
13	15212395	.	G	T	1	2	3	0	0	3	0	0
13	15212460	.	G	C	0	2	2	0	3	5	0	0
13	15215789	.	A	T	13	11	24	0	1	25	0	0
13	15580864	.	T	A	13	13	26	0	3	29	0	0
13	15580879	.	T	G	13	0	13	0	15	28	0	0
13	15580948	.	G	T	10	13	23	0	1	24	0	0
13	15647444	.	A	G	3	9	12	0	0	12	0	0
13	15657987	.	A	G	22	27	49	0	1	50	0	0
13	15668124	.	A	T	5	11	16	0	0	16	0	0
13	15725311	.	A	T	1	2	3	0	0	3	0	0
13	15762515	.	T	C	3	6	9	0	2	11	0	0
13	15763061	.	G	T	3	4	7	0	0	7	0	0
13	15763139	.	C	T	0	3	3	0	0	3	0	0
13	15763233	.	T	C	3	0	3	0	4	7	0	0
13	15763273	.	T	C	1	5	6	0	0	6	0	0
13	15763733	.	T	C	4	6	10	0	0	10	0	0
13	15800977	.	T	G	1	3	4	0	0	4	0	0
13	15801705	.	T	A	2	2	4	0	0	4	0	0
13	15801726	.	T	C	3	6	9	0	0	9	0	0
13	15814429	.	A	G	6	7	13	0	1	14	0	0
13	15814724	.	T	A	3	3	6	0	0	6	0	0
13	15816637	.	G	A	16	10	26	0	0	26	0	0
13	15848817	.	A	G	13	13	26	0	0	26	0	0
13	15848895	.	C	T	15	5	20	0	3	23	0	0
13	15849541	.	T	C	2	5	7	0	0	7	0	0
13	15869322	.	A	G	1	2	3	0	0	3	0	0
13	15872256	.	A	G	10	13	23	0	2	25	0	0
13	15882860	.	A	C	22	18	40	0	2	42	0	0
13	15897090	.	C	T	0	1	1	0	0	1	0	0
13	15897108	.	A	G	0	1	1	0	0	1	0	0
13	15897141	.	A	G	3	4	7	0	0	7	0	0
13	15929049	.	A	G	1	2	3	0	0	3	0	0
13	15942669	.	C	A	1	2	3	0	0	3	0	0
13	15943473	.	A	G	2	0	2	0	2	4	0	0
13	15958663	.	A	G	2	2	4	0	0	4	0	0
13	16186182	.	G	A	6	6	12	0	1	13	0	0
13	16186209	.	T	C	6	0	6	0	7	13	0	0
13	16191517	.	A	T	2	4	6	0	0	6	0	0
13	16191580	.	A	G	5	6	11	0	1	12	0	0
13	16191635	.	A	T	3	5	8	0	0	8	0	0
13	16300653	.	G	A	1	3	4	0	0	4	0	0
13	16300670	.	T	C	2	4	6	0	1	7	0	0
13	16313525	.	G	C	1	0	1	0	0	1	0	0
13	16413254	.	A	G	4	0	4	0	4	8	0	0
13	16413293	.	C	T	2	2	4	0	0	4	0	0
13	16413366	.	T	C	0	4	4	0	0	4	0	0
13	16420480	.	T	A	1	0	1	0	0	1	0	0
13	16420799	.	A	G	1	1	2	0	0	2	0	0
13	16425241	.	C	T	0	2	2	0	1	3	0	0
13	16428604	.	T	C	2	2	4	0	0	4	0	0
13	16436786	.	T	C	3	8	11	0	0	11	0	0
13	16448511	.	G	A	0	3	3	0	3	6	0	0
13	16474382	.	A	G	0	1	1	0	3	4	0	0
13	16479914	.	T	A	3	3	6	0	0	6	0	0
13	16496254	.	T	C	5	8	13	0	1	14	0	0
13	16496377	.	G	A	0	3	3	0	6	9	0	0
13	16496770	.	T	A	12	8	20	0	0	20	0	0
13	16522880	.	C	T	0	3	3	0	0	3	0	0
13	16852953	.	G	A	1	0	1	0	0	1	0	0
13	16855387	.	C	A	7	3	10	0	1	11	0	0
13	16856045	.	T	A	10	10	20	0	1	21	0	0
13	16871830	.	A	C	1	6	7	0	0	7	0	0
13	16878895	.	A	C	11	12	23	0	5	28	0	0
13	16886040	.	C	T	12	14	26	1	0	27	0	0
13	16886068	.	C	T	12	8	20	0	1	21	0	0
13	17470079	.	C	T	7	5	12	0	1	14	1	0
13	17470112	.	A	G	7	0	7	0	8	15	0	0
13	17470430	.	T	C	10	13	23	0	0	23	0	0
13	17702802	.	C	T	2	4	6	0	0	6	0	0
13	17703097	.	A	G	2	1	3	0	6	9	0	0
13	17703164	.	A	T	5	3	8	0	0	8	0	0
13	17703308	.	G	A	8	8	16	0	1	17	0	0
13	17705633	.	C	T	3	5	8	0	1	9	0	0
13	17705669	.	C	T	6	6	12	0	0	12	0	0
13	17705681	.	C	T	4	4	8	0	1	9	0	0
13	17714530	.	C	A	26	21	47	0	2	49	0	0
13	17714905	.	T	C	19	22	41	0	1	42	0	0
13	17714942	.	A	G	30	20	50	0	1	51	0	0
13	17717608	.	G	A	2	3	5	0	0	5	0	0
13	17752932	.	A	T	3	10	13	0	0	13	0	0
13	17753144	.	A	C	4	0	4	0	6	10	0	0
13	17753311	.	T	A	2	4	6	0	0	6	0	0
13	17753668	.	A	C	5	14	19	0	2	21	0	0
13	17753732	.	A	T	10	11	21	0	1	22	0	0
13	17753821	.	A	T	5	4	9	0	0	9	0	0
13	17754071	.	T	G	2	3	5	0	0	6	1	0
13	17754313	.	T	G	0	2	2	0	0	2	0	0
13	17754329	.	C	T	0	1	1	0	0	1	0	0
13	17754510	.	T	C	2	2	4	0	0	4	0	0
13	17754518	.	T	G	2	2	4	0	0	4	0	0
13	17755011	.	T	C	1	4	5	0	0	7	2	0
13	17755579	.	A	G	4	4	8	0	0	8	0	0
13	17755743	.	G	C	8	0	8	0	3	11	0	0
13	17755830	.	C	A	4	6	10	0	0	10	0	0
13	17755898	.	G	A	4	4	8	0	0	8	0	0
13	17756043	.	G	A	6	6	12	0	0	12	0	0
13	17756112	.	G	A	4	6	10	0	0	10	0	0
13	17756131	.	A	T	3	5	8	0	1	9	0	0
13	17756186	.	C	A	3	6	9	0	0	9	0	0
13	17756235	.	G	A	3	7	10	0	0	10	0	0
13	17756322	.	G	A	5	4	9	0	2	11	0	0
13	18019724	.	T	C	1	3	4	0	0	4	0	0
13	18019786	.	C	T	0	3	3	0	1	4	0	0
13	18024418	.	C	T	2	3	5	0	1	6	0	0
13	18024419	.	A	G	2	3	5	0	1	6	0	0
13	18033053	.	A	G	2	4	6	0	0	6	0	0
13	18033073	.	T	G	2	4	6	0	0	6	0	0
13	18064364	.	T	G	2	2	4	0	0	4	0	0
13	18064536	.	C	T	0	2	2	0	0	2	0	0
13	18073433	.	A	G	8	16	24	0	1	25	0	0
13	18073524	.	G	T	11	9	20	0	0	20	0	0
13	18073582	.	G	T	8	3	11	0	0	11	0	0
13	18073706	.	G	A	9	5	14	0	0	14	0	0
13	18076710	.	T	G	2	8	10	0	1	11	0	0
13	18076788	.	G	C	12	8	20	0	0	20	0	0
13	18076818	.	G	A	11	18	29	0	0	29	0	0
13	18077056	.	G	T	10	13	23	0	3	26	0	0
13	18077116	.	G	A	11	13	24	0	2	26	0	0
13	18077191	.	C	G	9	7	16	0	0	16	0	0
13	18080348	.	G	A	7	12	19	0	0	19	0	0
13	18080411	.	G	T	8	8	16	0	1	17	0	0
13	18083391	.	C	T	0	1	1	0	2	3	0	0
13	18083415	.	G	A	1	2	3	0	0	3	0	0
13	18087946	.	G	A	4	3	7	0	1	8	0	0
13	18088276	.	T	G	2	4	6	0	0	6	0	0
13	18092062	.	G	T	1	1	2	0	0	2	0	0
13	18092084	.	A	G	3	2	5	0	0	5	0	0
13	18092108	.	T	C	3	2	5	0	0	5	0	0
13	18092266	.	C	T	0	1	1	0	0	1	0	0
13	18092279	.	A	G	0	2	2	0	0	2	0	0
13	18092417	.	A	G	2	0	2	0	0	2	0	0
13	18099947	.	T	C	0	0	0	0	3	3	0	0
13	18104890	.	C	T	0	3	3	0	1	4	0	0
13	18104929	.	A	T	3	8	11	0	0	11	0	0
13	18105175	.	G	A	5	3	8	0	1	9	0	0
13	18105382	.	A	G	0	3	3	0	0	3	0	0
13	18107622	.	A	G	0	1	1	0	0	1	0	0
13	18119488	.	T	C	1	0	1	0	0	1	0	0
13	18119489	.	C	T	1	0	1	0	0	1	0	0
13	18122193	.	C	T	0	2	2	0	0	2	0	0
13	18122263	.	C	G	0	4	4	0	2	6	0	0
13	18179151	.	C	A	2	7	9	0	0	9	0	0
13	18179391	.	G	C	2	0	2	0	11	13	0	0
13	18179521	.	A	G	7	4	11	0	0	11	0	0
13	18179535	.	G	T	6	3	9	0	1	10	0	0
13	18179757	.	T	C	8	16	24	0	1	25	0	0
13	18179859	.	C	A	12	15	27	0	0	27	0	0
13	18185457	.	A	C	0	0	0	0	5	5	0	0
13	18185463	.	C	A	0	4	4	0	0	4	0	0
13	18195926	.	G	A	0	3	3	0	0	3	0	0
13	18275935	.	T	C	2	2	4	0	0	4	0	0
13	18276387	.	T	G	1	3	4	0	1	5	0	0
13	18295212	.	C	T	2	2	4	0	0	4	0	0
13	18295423	.	G	A	0	2	2	0	2	4	0	0
13	18295680	.	T	C	1	3	4	0	0	4	0	0
13	18314113	.	T	G	2	0	2	0	1	3	0	0
13	18321156	.	T	C	4	3	7	0	0	7	0	0
13	18323464	.	A	G	6	10	16	0	2	18	0	0
13	18323595	.	G	A	0	11	11	0	12	23	0	0
13	18323653	.	A	G	13	1	14	0	16	30	0	0
13	18323787	.	T	A	10	7	17	0	1	19	1	0
13	18358890	.	G	C	19	16	35	0	1	36	0	0
13	18359112	.	G	C	11	23	34	0	1	35	0	0
13	18359304	.	A	T	5	10	15	0	0	15	0	0
13	18359374	.	C	T	14	13	27	0	5	32	0	0
13	18359507	.	A	T	7	10	17	0	0	17	0	0
13	18371186	.	A	C	1	2	3	0	0	3	0	0
13	18375465	.	C	A	3	5	8	0	2	10	0	0
13	18375512	.	T	A	3	1	4	0	0	4	0	0
13	18382192	.	T	C	2	3	5	0	1	6	0	0
13	18385497	.	C	T	0	1	1	0	0	1	0	0
13	18385512	.	C	T	1	2	3	0	0	3	0	0
13	18385797	.	T	A	1	3	4	0	0	4	0	0
13	18394755	.	T	A	4	3	7	0	0	7	0	0
13	18397138	.	C	G	2	8	10	0	0	10	0	0
13	18397189	.	A	G	1	1	2	0	1	3	0	0
13	18397449	.	T	C	1	2	3	0	0	3	0	0
13	18397452	.	T	C	1	2	3	0	0	3	0	0
13	18418337	.	C	A	5	5	10	0	1	11	0	0
13	18418528	.	G	A	2	2	4	0	0	4	0	0
13	18428103	.	A	G	3	3	6	0	1	7	0	0
13	18431278	.	T	A	3	2	5	0	0	5	0	0
13	18431301	.	C	T	4	3	7	0	0	7	0	0
13	18431430	.	C	T	4	2	6	0	0	6	0	0
13	18434354	.	T	C	5	5	10	0	0	10	0	0
13	18434818	.	C	G	7	7	14	0	0	14	0	0
13	18434902	.	C	T	6	5	11	0	2	13	0	0
13	18434957	.	G	A	5	4	9	0	1	10	0	0
13	18434962	.	A	G	5	4	9	0	0	9	0	0
13	18499773	.	A	T	2	3	5	0	0	5	0	0
13	18499807	.	A	G	1	4	5	0	0	5	0	0
13	18507735	.	A	G	0	1	1	0	0	1	0	0
13	18509592	.	G	A	0	10	10	0	16	26	0	0
13	18509925	.	T	C	6	5	11	0	1	12	0	0
13	18509940	.	C	T	8	4	12	0	0	12	0	0
13	18510319	.	C	A	13	16	29	0	0	29	0	0
13	18510324	.	A	G	13	16	29	0	0	29	0	0
13	18510540	.	G	A	1	10	11	0	7	18	0	0
13	18511023	.	C	T	17	7	24	0	0	24	0	0
13	18511140	.	A	G	14	2	16	0	11	27	0	0
13	18511637	.	A	C	9	7	16	0	1	17	0	0
13	18511763	.	T	A	12	9	21	0	0	21	0	0
13	18511996	.	A	T	13	13	26	0	1	27	0	0
13	18512030	.	A	T	11	11	22	0	1	23	0	0
13	18512082	.	C	G	8	9	17	0	0	17	0	0
13	18663103	.	G	A	3	3	6	0	0	6	0	0
13	18663947	.	G	A	7	6	13	0	1	14	0	0
13	18677437	.	T	C	8	5	13	0	2	15	0	0
13	18677467	.	G	A	8	4	12	0	0	12	0	0
13	18677726	.	T	C	7	5	12	0	0	12	0	0
13	18677749	.	C	A	3	4	7	0	0	7	0	0
13	18677761	.	C	T	3	3	6	0	0	6	0	0
13	18677925	.	A	T	7	7	14	0	0	14	0	0
13	18680027	.	G	A	6	6	12	0	0	12	0	0
13	18685598	.	A	G	7	11	18	0	1	19	0	0
13	18685673	.	G	A	1	4	5	0	1	6	0	0
13	18801820	.	T	C	3	3	6	0	0	6	0	0
13	19304688	.	A	G	12	12	24	0	0	24	0	0
13	19316930	.	G	C	12	8	20	0	0	20	0	0
13	19317016	.	T	A	4	6	10	0	3	13	0	0
13	19317018	.	C	G	6	6	12	0	1	13	0	0
13	19317051	.	T	G	2	5	7	0	1	8	0	0
13	19627266	.	A	C	0	1	1	0	0	1	0	0
13	19629266	.	C	G	5	2	7	0	0	7	0	0
13	19629278	.	T	C	1	0	1	0	7	8	0	0
13	19799192	.	A	G	1	1	2	0	0	2	0	0
13	19799467	.	G	A	10	12	22	0	1	23	0	0
13	19799522	.	C	T	10	10	20	0	1	21	0	0
13	19799535	.	T	A	8	13	21	0	0	21	0	0
13	19799623	.	T	C	9	13	22	0	2	24	0	0
13	19799646	.	C	A	0	9	9	0	13	22	0	0
13	19799705	.	A	G	11	9	20	0	0	20	0	0
13	19799799	.	C	T	0	4	4	0	4	8	0	0
13	20328046	.	G	T	1	0	1	0	0	1	0	0
13	20401263	.	C	A	0	10	10	0	8	18	0	0
13	20425396	.	C	T	0	12	12	0	8	20	0	0
13	20518620	.	C	T	0	2	2	0	3	5	0	0
13	20518711	.	C	T	10	6	16	0	2	18	0	0
13	21680844	.	A	T	1	0	1	0	0	1	0	0
13	21683057	.	A	C	6	9	15	0	0	15	0	0
13	21683077	.	T	C	3	7	10	0	0	10	0	0
13	21683488	.	A	T	19	17	36	0	0	36	0	0
13	21683511	.	T	G	16	13	29	0	0	29	0	0
13	21683546	.	C	T	8	16	24	0	0	24	0	0
13	21689438	.	A	C	9	6	15	0	0	15	0	0
13	21689439	.	C	T	9	5	14	0	1	15	0	0
13	21689530	.	A	T	6	8	14	0	0	14	0	0
13	21689839	.	C	T	1	10	11	0	0	11	0	0
13	21689854	.	C	T	8	0	8	1	0	9	0	0
13	21689982	.	G	A	6	6	12	0	1	13	0	0
13	21690096	.	C	G	3	7	10	0	0	10	0	0
13	21690229	.	A	C	6	5	11	0	0	11	0	0
13	21690374	.	G	A	12	9	21	0	0	21	0	0
13	21690530	.	C	T	0	9	9	0	13	22	0	0
13	21690724	.	A	T	4	11	15	0	1	16	0	0
13	21690877	.	A	C	5	0	5	0	11	16	0	0
13	21691611	.	G	A	4	4	8	0	0	8	0	0
13	21691794	.	G	A	8	5	13	0	0	13	0	0
13	21692328	.	C	A	5	5	10	0	1	11	0	0
13	21692338	.	C	T	6	6	12	0	1	13	0	0
13	21692705	.	C	G	0	8	8	0	6	14	0	0
13	21692859	.	C	T	7	2	9	0	1	10	0	0
13	21693187	.	A	G	6	10	16	0	2	18	0	0
13	21693208	.	A	C	12	0	12	0	6	18	0	0
13	21693285	.	A	T	4	6	10	0	0	10	0	0
13	21693342	.	C	T	11	4	15	0	0	15	0	0
13	21693361	.	C	T	3	11	14	0	1	15	0	0
13	21693410	.	G	C	5	4	9	0	0	9	0	0
13	21693514	.	A	T	12	6	18	0	0	18	0	0
13	21695438	.	G	T	7	4	11	0	0	11	0	0
13	21712507	.	G	A	3	14	17	0	0	17	0	0
13	21712526	.	G	A	3	10	13	0	0	13	0	0
13	21712755	.	G	C	5	0	5	0	0	5	0	0
13	21716581	.	T	C	1	2	3	0	0	3	0	0
13	21725502	.	G	T	1	2	3	0	0	3	0	0
13	21725526	.	T	C	1	0	1	0	0	1	0	0
13	21727796	.	T	A	0	2	2	0	0	2	0	0
13	21770891	.	T	C	8	7	15	0	0	15	0	0
13	21775469	.	C	T	9	11	20	0	0	20	0	0
13	21775697	.	C	T	10	8	18	0	1	19	0	0
13	21776081	.	C	T	2	4	6	0	0	6	0	0
13	21776213	.	G	A	3	2	5	0	0	5	0	0
13	21819997	.	G	A	0	2	2	0	0	2	0	0
13	21826203	.	G	T	1	2	3	0	0	3	0	0
13	21853237	.	A	G	3	4	7	0	1	8	0	0
13	21853240	.	C	T	4	4	8	0	0	8	0	0
13	21855811	.	C	T	0	4	4	0	0	4	0	0
13	21855868	.	C	T	3	6	9	0	0	9	0	0
13	21856741	.	G	A	3	2	5	0	0	5	0	0
13	21856849	.	G	A	1	6	7	0	4	11	0	0
13	21860111	.	G	A	0	3	3	0	0	3	0	0
13	21861775	.	A	C	7	4	11	0	0	11	0	0
13	21861777	.	G	A	7	4	11	0	0	11	0	0
13	21862288	.	T	A	1	4	5	0	0	5	0	0
13	21864182	.	T	A	0	2	2	0	0	2	0	0
13	21866357	.	A	C	2	5	7	0	1	8	0	0
13	21869927	.	C	T	4	5	9	0	0	9	0	0
13	21870467	.	G	C	0	18	18	0	9	27	0	0
13	21870575	.	A	G	13	1	14	0	11	25	0	0
13	21870608	.	A	T	12	6	18	0	0	18	0	0
13	21874107	.	C	T	5	3	8	0	0	8	0	0
13	21874149	.	G	T	0	8	8	0	8	17	1	0
13	21874649	.	C	T	8	5	13	0	0	13	0	0
13	21884298	.	C	T	9	11	20	1	0	21	0	0
13	21884328	.	G	A	11	9	20	0	0	20	0	0
13	21884407	.	T	C	13	9	22	0	0	22	0	0
13	21884408	.	C	T	13	9	22	0	0	22	0	0
13	21884979	.	T	C	5	8	13	0	1	14	0	0
13	21884980	.	C	T	5	8	13	0	1	14	0	0
13	21885143	.	C	A	11	15	26	0	2	28	0	0
13	21885198	.	T	A	14	20	34	0	1	35	0	0
13	21919855	.	A	G	3	0	3	0	1	4	0	0
13	22064678	.	G	A	1	3	4	0	0	4	0	0
13	22064775	.	G	A	1	3	4	0	0	4	0	0
13	22065631	.	A	G	3	4	7	0	0	7	0	0
13	22065661	.	G	A	4	4	8	0	1	9	0	0
13	22066024	.	C	T	2	3	5	0	0	5	0	0
13	22066042	.	T	C	1	4	5	0	0	5	0	0
13	22066066	.	C	T	2	3	5	0	0	5	0	0
13	22076892	.	C	T	1	0	1	0	0	1	0	0
13	22087098	.	C	T	2	1	3	0	0	3	0	0
13	22087508	.	C	T	5	9	14	0	0	14	0	0
13	22088061	.	T	G	1	1	2	0	5	7	0	0
13	22094800	.	T	C	5	11	16	0	0	16	0	0
13	22094871	.	T	G	7	15	22	0	2	24	0	0
13	22095589	.	G	A	3	6	9	0	0	9	0	0
13	22095594	.	T	A	2	7	9	0	1	10	0	0
13	22119935	.	T	C	1	1	2	0	0	2	0	0
13	22198502	.	G	A	3	2	5	0	0	5	0	0
13	22207003	.	C	T	4	2	6	0	0	6	0	0
13	22238125	.	C	A	7	6	13	0	0	13	0	0
13	22238209	.	T	C	7	17	24	0	2	26	0	0
13	22238233	.	G	A	10	14	24	0	1	25	0	0
13	22240672	.	T	A	6	3	9	0	0	9	0	0
13	22241103	.	T	A	16	11	27	0	0	27	0	0
13	22241123	.	G	T	1	10	11	0	11	22	0	0
13	22241374	.	A	C	22	17	39	0	0	39	0	0
13	22241482	.	G	C	10	17	27	0	1	28	0	0
13	22241648	.	T	G	23	17	40	0	0	41	1	0
13	22241730	.	G	C	30	23	53	0	0	53	0	0
13	22241731	.	A	T	30	23	53	0	0	53	0	0
13	22242197	.	G	C	18	19	37	0	5	42	0	0
13	22242299	.	C	G	20	17	37	0	0	37	0	0
13	22242394	.	C	G	28	16	44	0	1	45	0	0
13	22242837	.	T	G	25	21	46	0	1	47	0	0
13	22243211	.	A	C	11	21	32	0	0	32	0	0
13	22317066	.	T	C	2	2	4	0	1	5	0	0
13	22340444	.	C	T	0	3	3	0	0	3	0	0
13	22340456	.	G	A	0	3	3	0	0	3	0	0
13	22351817	.	G	A	1	2	3	0	1	4	0	0
13	22351910	.	A	G	1	0	1	0	0	1	0	0
13	22357236	.	T	G	4	4	8	0	2	10	0	0
13	22357850	.	A	G	2	1	3	0	4	7	0	0
13	22358021	.	A	G	5	4	9	0	0	9	0	0
13	22361332	.	G	A	8	6	14	0	0	14	0	0
13	22361718	.	A	C	1	1	2	0	0	2	0	0
13	22364908	.	T	C	11	9	20	0	1	21	0	0
13	22365016	.	C	T	10	16	26	0	4	30	0	0
13	22365404	.	C	T	8	14	22	0	1	23	0	0
13	22365461	.	A	G	2	6	8	0	2	10	0	0
13	22367600	.	C	A	2	6	8	0	0	8	0	0
13	22369262	.	C	T	2	1	3	0	0	3	0	0
13	22369295	.	T	C	4	5	9	0	0	9	0	0
13	22369349	.	C	T	5	9	14	0	0	14	0	0
13	22369399	.	A	C	5	9	14	0	1	15	0	0
13	22369445	.	C	T	4	5	9	0	0	9	0	0
13	22371981	.	G	A	0	19	19	0	20	39	0	0
13	22372015	.	C	G	21	25	46	0	1	47	0	0
13	22372075	.	T	C	17	15	32	0	1	33	0	0
13	22372105	.	G	A	1	16	17	0	18	35	0	0
13	22372126	.	C	T	16	16	32	0	2	34	0	0
13	22372205	.	A	G	17	18	35	0	1	36	0	0
13	22372932	.	G	T	8	2	10	0	1	11	0	0
13	22555909	.	G	A	1	2	3	0	0	3	0	0
13	22618353	.	A	T	3	2	5	0	0	5	0	0
13	22618393	.	T	A	2	2	4	0	1	5	0	0
13	22619067	.	G	A	6	7	13	0	7	20	0	0
13	22619157	.	C	T	7	4	11	0	1	12	0	0
13	22620095	.	G	A	1	2	3	0	0	3	0	0
13	22659195	.	C	G	12	0	12	0	10	22	0	0
13	22659196	.	A	G	13	9	22	0	0	22	0	0
13	22659231	.	G	A	0	18	18	0	16	34	0	0
13	22659291	.	A	G	23	10	33	0	2	35	0	0
13	22659363	.	G	A	1	2	3	0	0	3	0	0
13	22659375	.	A	C	0	0	0	0	1	1	0	0
13	22669319	.	T	C	6	15	21	0	1	22	0	0
13	22679837	.	G	A	1	3	4	0	0	4	0	0
13	22725613	.	C	T	0	1	1	0	0	1	0	0
13	22735063	.	T	C	6	4	10	0	2	12	0	0
13	22735139	.	A	G	9	7	16	0	3	19	0	0
13	22742791	.	G	A	2	5	7	0	0	7	0	0
13	22744359	.	A	G	3	6	9	0	0	9	0	0
13	22867888	.	G	A	0	5	5	0	4	9	0	0
13	22867910	.	A	G	5	4	9	0	0	9	0	0
13	22867953	.	G	T	3	8	11	0	0	11	0	0
13	22868017	.	G	A	2	1	3	0	1	4	0	0
13	22871900	.	C	A	2	2	4	0	0	4	0	0
13	22871989	.	A	G	5	3	8	0	0	8	0	0
13	22872330	.	T	C	1	2	3	0	0	3	0	0
13	22872862	.	A	G	2	2	4	0	1	5	0	0
13	22872915	.	A	T	5	2	7	0	1	8	0	0
13	22872918	.	T	C	6	1	7	0	0	7	0	0
13	22876576	.	T	C	4	0	4	0	4	8	0	0
13	22876623	.	G	A	3	10	13	0	0	13	0	0
13	22876678	.	A	T	6	6	12	0	0	12	0	0
13	22877076	.	C	T	3	9	12	0	1	13	0	0
13	22877130	.	G	T	6	10	16	0	0	16	0	0
13	22878754	.	G	A	1	2	3	0	1	4	0	0
13	22879149	.	A	T	4	2	6	0	0	6	0	0
13	22890835	.	A	C	12	1	13	0	10	23	0	0
13	22898042	.	A	G	6	1	7	0	0	7	0	0
13	22900733	.	G	A	3	6	9	0	0	9	0	0
13	22900742	.	A	T	2	5	7	0	0	7	0	0
13	22902882	.	A	C	5	4	9	0	0	9	0	0
13	22902987	.	G	A	8	6	14	0	0	14	0	0
13	22925780	.	G	T	1	2	3	0	0	3	0	0
13	22925800	.	A	G	1	2	3	0	0	3	0	0
13	22970628	.	G	A	1	3	4	0	0	4	0	0
13	22973314	.	A	G	25	29	54	0	3	57	0	0
13	22973348	.	A	G	25	22	47	0	0	47	0	0
13	22973531	.	T	C	23	0	23	0	24	47	0	0
13	22973895	.	A	G	17	26	43	0	8	51	0	0
13	22974033	.	A	G	20	22	42	0	0	42	0	0
13	22974108	.	C	T	12	6	18	0	0	18	0	0
13	22976067	.	C	A	14	19	33	0	0	33	0	0
13	22976070	.	G	A	13	19	32	0	0	32	0	0
13	22976383	.	T	C	10	0	10	0	10	20	0	0
13	22977283	.	G	A	13	8	21	0	2	23	0	0
13	22977319	.	A	G	22	17	39	0	0	39	0	0
13	22977343	.	A	G	17	16	33	0	1	34	0	0
13	22978059	.	T	C	8	1	9	0	5	14	0	0
13	22978062	.	G	A	7	6	13	0	1	14	0	0
13	22983106	.	A	G	3	0	3	0	0	3	0	0
13	22983109	.	A	G	3	0	3	0	0	3	0	0
13	23002697	.	G	A	1	1	2	0	0	2	0	0
13	23007677	.	A	G	7	4	11	0	1	12	0	0
13	23037831	.	C	A	6	4	10	0	0	10	0	0
13	23042321	.	A	G	1	0	1	0	1	2	0	0
13	23042387	.	C	G	4	5	9	0	2	11	0	0
13	23042676	.	A	G	4	3	7	0	0	7	0	0
13	23042745	.	G	A	4	4	8	0	0	8	0	0
13	23042929	.	G	T	1	2	3	0	0	3	0	0
13	23043112	.	T	C	4	2	6	0	0	6	0	0
13	23043117	.	A	G	4	2	6	0	0	6	0	0
13	23058975	.	G	A	2	4	6	0	7	13	0	0
13	23070787	.	C	T	1	6	7	0	1	8	0	0
13	23070895	.	T	C	3	6	9	0	1	10	0	0
13	23071125	.	A	G	1	3	4	0	0	4	0	0
13	23084177	.	C	G	11	15	26	2	3	31	0	0
13	23084841	.	G	C	6	15	21	0	1	22	0	0
13	23090190	.	A	C	13	11	24	0	2	26	0	0
13	23094356	.	T	C	2	0	2	0	5	7	0	0
13	23094895	.	G	T	7	12	19	0	2	21	0	0
13	23128675	.	A	G	3	0	3	0	5	8	0	0
13	23128685	.	A	G	4	3	7	0	0	7	0	0
13	23201307	.	T	A	1	0	1	0	0	1	0	0
13	23204849	.	A	C	4	3	7	0	0	7	0	0
13	23222899	.	A	T	2	3	5	0	0	5	0	0
13	23223122	.	A	G	2	2	4	0	0	4	0	0
13	23223469	.	T	A	8	1	9	0	0	9	0	0
13	23223486	.	C	T	6	2	8	0	0	8	0	0
13	23223567	.	C	T	4	3	7	0	1	8	0	0
13	23223572	.	C	T	4	3	7	0	0	7	0	0
13	23223875	.	C	A	4	4	8	0	0	8	0	0
13	23224087	.	G	A	6	6	12	0	0	12	0	0
13	23224113	.	A	T	3	5	8	0	0	8	0	0
13	23224360	.	A	G	9	5	14	0	0	14	0	0
13	23224363	.	T	G	9	5	14	0	0	14	0	0
13	23224427	.	C	T	10	3	13	0	0	13	0	0
13	23224470	.	G	A	7	6	13	0	0	13	0	0
13	23224605	.	G	T	10	8	18	0	1	19	0	0
13	23224727	.	C	T	6	3	9	0	1	10	0	0
13	23224735	.	A	G	7	5	12	0	0	12	0	0
13	23224821	.	T	A	9	10	19	0	2	21	0	0
13	23224860	.	T	A	8	11	19	0	0	19	0	0
13	23225541	.	T	C	11	6	17	0	1	18	0	0
13	23225776	.	T	A	8	8	16	0	0	16	0	0
13	23226114	.	G	A	0	11	11	0	9	20	0	0
13	23226213	.	A	C	9	8	17	0	0	17	0	0
13	23314904	.	T	G	6	5	11	0	0	11	0	0
13	23382393	.	G	A	3	4	7	0	0	7	0	0
13	23387337	.	C	T	10	4	14	0	1	15	0	0
13	23669773	.	C	T	2	7	9	0	0	9	0	0
13	23669870	.	T	G	5	5	10	0	1	11	0	0
13	23669916	.	C	A	5	4	9	0	1	10	0	0
13	23675183	.	C	T	7	2	9	0	0	9	0	0
13	23675510	.	T	C	7	8	15	0	0	15	0	0
13	23675892	.	G	C	1	4	5	0	6	11	0	0
13	23676856	.	G	A	0	4	4	0	2	6	0	0
13	23676913	.	C	A	7	9	16	0	3	19	0	0
13	23679546	.	G	A	0	1	1	0	1	2	0	0
13	23679888	.	G	A	1	7	8	0	0	8	0	0
13	23685301	.	G	A	2	2	4	0	0	4	0	0
13	23685361	.	T	G	0	0	0	0	1	1	0	0
13	23692515	.	C	T	11	17	28	0	0	28	0	0
13	23692572	.	C	T	4	2	6	0	0	6	0	0
13	23703048	.	G	C	4	16	20	0	1	21	0	0
13	23703053	.	T	C	5	18	23	0	0	23	0	0
13	23709532	.	C	T	6	4	10	0	0	10	0	0
13	23709562	.	T	C	12	15	27	0	0	27	0	0
13	23709592	.	A	G	14	16	30	0	3	33	0	0
13	23711937	.	G	A	8	8	16	0	2	18	0	0
13	23728490	.	T	A	4	4	8	0	0	8	0	0
13	23730801	.	G	A	2	7	9	0	0	9	0	0
13	23876865	.	C	T	2	3	5	0	0	5	0	0
13	23882629	.	T	C	3	6	9	0	0	9	0	0
13	23882686	.	C	T	4	2	6	0	0	6	0	0
13	23882946	.	A	G	2	2	4	0	0	4	0	0
13	23898045	.	T	G	7	12	19	0	1	20	0	0
13	23901334	.	C	T	10	10	20	0	0	20	0	0
13	23901349	.	T	C	11	7	18	0	3	21	0	0
13	23901502	.	A	G	9	10	19	0	1	20	0	0
13	23901555	.	A	G	7	0	7	0	7	14	0	0
13	23901570	.	T	C	7	5	12	0	0	12	0	0
13	23920791	.	A	G	0	1	1	0	0	1	0	0
13	23931192	.	T	C	3	0	3	0	9	12	0	0
13	23940708	.	T	C	2	0	2	0	1	3	0	0
13	23940754	.	C	A	3	5	8	0	0	8	0	0
13	23996192	.	G	A	2	2	4	0	0	4	0	0
13	23999129	.	G	A	1	1	2	0	0	2	0	0
13	23999264	.	G	C	1	0	1	0	0	1	0	0
13	23999274	.	T	A	3	1	4	0	0	4	0	0
13	24000394	.	G	A	1	3	4	0	0	4	0	0
13	24010630	.	C	T	1	1	2	0	1	3	0	0
13	24014332	.	A	G	1	2	3	0	0	3	0	0
13	24014341	.	G	A	2	0	2	0	0	2	0	0
13	24014578	.	T	C	3	0	3	0	0	3	0	0
13	24023036	.	G	T	8	6	14	0	0	14	0	0
13	24034158	.	A	G	1	4	5	0	0	5	0	0
13	24034206	.	A	G	2	1	3	0	1	4	0	0
13	24034215	.	G	A	2	2	4	0	0	4	0	0
13	24046953	.	G	A	0	2	2	0	2	4	0	0
13	24056221	.	C	T	8	16	24	0	1	25	0	0
13	24068790	.	C	T	0	7	7	0	13	20	0	0
13	24069624	.	C	A	7	6	13	0	1	14	0	0
13	24069902	.	A	T	11	10	21	0	1	22	0	0
13	24070242	.	C	T	1	7	8	0	8	16	0	0
13	24070730	.	C	T	5	5	10	0	1	11	0	0
13	24234815	.	C	A	3	6	9	0	0	9	0	0
13	24263453	.	G	A	1	4	5	0	0	5	0	0
13	24276046	.	G	A	1	1	2	0	0	2	0	0
13	24276128	.	T	A	1	2	3	0	0	3	0	0
13	24287895	.	C	T	2	4	6	0	0	6	0	0
13	24290132	.	A	T	2	3	5	0	1	6	0	0
13	24290140	.	A	G	3	4	7	0	0	7	0	0
13	24290169	.	T	G	5	0	5	0	7	12	0	0
13	24292374	.	A	G	6	2	8	0	0	8	0	0
13	24292398	.	G	A	7	5	12	0	1	13	0	0
13	24292675	.	A	G	6	5	11	0	2	13	0	0
13	24292727	.	G	A	9	11	20	0	1	21	0	0
13	24292796	.	T	A	15	10	25	0	1	26	0	0
13	24292800	.	A	T	14	10	24	0	0	24	0	0
13	24292947	.	A	T	5	13	18	0	0	18	0	0
13	24293381	.	A	T	14	23	37	0	4	41	0	0
13	24293465	.	C	T	10	15	25	0	10	35	0	0
13	24293516	.	G	A	11	22	33	0	6	39	0	0
13	24293518	.	C	A	16	21	37	0	2	39	0	0
13	24293615	.	G	A	15	18	33	0	11	44	0	0
13	24293698	.	C	T	20	13	33	0	2	35	0	0
13	24293793	.	A	G	18	13	31	0	2	33	0	0
13	24294046	.	A	G	12	13	25	0	1	26	0	0
13	24295907	.	A	T	3	3	6	0	0	6	0	0
13	24295921	.	C	A	2	3	5	0	0	5	0	0
13	24295999	.	T	C	4	3	7	0	0	7	0	0
13	24296071	.	G	A	5	4	9	0	0	9	0	0
13	24296094	.	A	C	6	4	10	0	0	10	0	0
13	24296141	.	G	A	2	4	6	0	0	6	0	0
13	24296198	.	A	T	3	3	6	0	0	6	0	0
13	24296250	.	A	G	0	2	2	0	3	5	0	0
13	24303840	.	G	A	1	0	1	0	0	1	0	0
13	24305975	.	T	G	6	10	16	0	1	17	0	0
13	24311510	.	G	A	0	3	3	0	0	3	0	0
13	24371898	.	C	T	2	3	5	0	0	5	0	0
13	24371933	.	A	C	2	0	2	0	2	4	0	0
13	24372197	.	C	T	2	7	9	0	0	9	0	0
13	24372943	.	C	T	1	3	4	0	0	4	0	0
13	24373081	.	A	G	1	2	3	0	0	3	0	0
13	24378978	.	A	T	2	2	4	0	0	4	0	0
13	24381350	.	A	G	1	3	4	0	0	4	0	0
13	24382152	.	T	C	0	2	2	0	0	2	0	0
13	24382539	.	T	C	2	1	3	0	0	3	0	0
13	24401618	.	A	G	2	7	9	0	0	9	0	0
13	24401663	.	C	A	4	2	6	0	0	6	0	0
13	24402560	.	T	C	1	3	4	0	1	5	0	0
13	24411029	.	A	G	22	14	36	0	1	37	0	0
13	24424014	.	C	T	2	3	5	0	0	5	0	0
13	24424051	.	G	A	5	2	7	0	0	7	0	0
13	24424260	.	A	T	2	2	4	0	0	4	0	0
13	24424899	.	T	G	1	3	4	0	0	4	0	0
13	24424918	.	A	G	1	4	5	0	0	5	0	0
13	24425112	.	T	C	1	0	1	0	2	3	0	0
13	24431365	.	T	G	7	8	15	0	2	17	0	0
13	24432096	.	C	T	11	8	19	0	0	19	0	0
13	24432162	.	G	C	7	8	15	0	0	15	0	0
13	24432350	.	C	T	0	14	14	0	10	24	0	0
13	24436011	.	C	G	3	5	8	0	1	9	0	0
13	24436054	.	G	A	8	5	13	0	1	14	0	0
13	24437225	.	G	A	4	6	10	0	0	10	0	0
13	24447235	.	T	G	5	4	9	0	0	9	0	0
13	24447364	.	G	C	3	5	8	0	0	8	0	0
13	24521036	.	C	T	1	3	4	0	0	4	0	0
13	24523425	.	A	G	3	3	6	0	0	6	0	0
13	24523469	.	G	A	0	3	3	0	8	11	0	0
13	24524206	.	G	A	3	4	7	0	0	7	0	0
13	24552508	.	C	T	2	1	3	0	0	3	0	0
13	24580372	.	G	A	1	3	4	0	0	4	0	0
13	24580411	.	G	A	9	10	19	0	1	20	0	0
13	24580705	.	C	T	8	9	17	0	0	17	0	0
13	24580756	.	G	C	0	1	1	0	4	5	0	0
13	24580869	.	T	C	0	4	4	0	0	4	0	0
13	24580941	.	T	C	0	0	0	0	1	1	0	0
13	24581274	.	G	A	6	8	14	0	0	14	0	0
13	24581316	.	C	A	13	11	24	0	2	26	0	0
13	24581334	.	G	C	7	8	15	0	3	18	0	0
13	24581358	.	T	C	3	4	7	0	0	7	0	0
13	24581748	.	A	C	15	9	24	0	1	25	0	0
13	24581798	.	T	A	10	12	22	0	2	24	0	0
13	24581840	.	T	G	17	12	29	0	3	32	0	0
13	24581854	.	C	T	17	14	31	0	2	33	0	0
13	24582047	.	A	G	8	7	15	0	1	16	0	0
13	24582211	.	C	T	5	9	14	0	0	14	0	0
13	24582213	.	G	A	9	5	14	0	0	14	0	0
13	24664317	.	T	G	3	4	7	0	0	7	0	0
13	24665407	.	C	T	1	3	4	0	0	4	0	0
13	24665421	.	G	T	3	3	6	0	0	6	0	0
13	24665759	.	T	G	1	0	1	0	0	1	0	0
13	24669108	.	T	C	2	2	4	0	1	5	0	0
13	24702033	.	C	A	0	8	8	0	4	12	0	0
13	24702112	.	T	C	9	2	11	0	3	14	0	0
13	24702114	.	T	C	8	4	12	0	2	14	0	0
13	24702415	.	T	C	5	10	15	0	1	16	0	0
13	24702478	.	T	G	5	8	13	0	0	13	0	0
13	24702602	.	T	A	6	11	17	0	0	17	0	0
13	24702652	.	A	T	5	5	10	0	1	11	0	0
13	24702724	.	C	T	5	2	7	0	1	8	0	0
13	24702883	.	A	T	10	3	13	0	0	13	0	0
13	24703276	.	C	T	1	5	6	0	0	6	0	0
13	24703354	.	C	A	2	3	5	0	0	5	0	0
13	24703362	.	C	A	1	3	4	0	0	4	0	0
13	24703512	.	G	A	1	1	2	0	0	2	0	0
13	24704032	.	A	G	2	3	5	0	0	5	0	0
13	24716363	.	T	C	0	4	4	0	1	5	0	0
13	24716375	.	A	T	1	4	5	0	0	5	0	0
13	24716415	.	T	C	1	2	3	0	0	3	0	0
13	24740152	.	A	C	0	1	1	0	0	1	0	0
13	24745047	.	T	C	0	1	1	0	0	1	0	0
13	24745049	.	G	T	0	0	0	0	1	1	0	0
13	24781536	.	G	A	9	16	25	0	0	25	0	0
13	24781580	.	T	C	13	10	23	0	1	24	0	0
13	24781605	.	T	C	15	12	27	0	0	28	1	0
13	24781640	.	G	A	13	13	26	0	1	27	0	0
13	24781713	.	A	G	6	11	17	0	2	19	0	0
13	24781885	.	G	A	11	13	24	0	0	24	0	0
13	24786900	.	T	A	7	15	22	0	1	23	0	0
13	24803986	.	G	A	5	1	6	0	0	6	0	0
13	24804104	.	C	T	6	5	11	0	0	11	0	0
13	24804224	.	G	C	3	4	7	0	0	7	0	0
13	24804436	.	A	G	1	2	3	0	1	4	0	0
13	24804478	.	C	T	2	3	5	0	0	5	0	0
13	24804484	.	A	G	2	3	5	0	0	5	0	0
13	24805068	.	A	C	1	4	5	0	0	5	0	0
13	24805148	.	A	C	1	3	4	0	0	4	0	0
13	24805687	.	G	A	0	1	1	0	0	1	0	0
13	24834446	.	C	T	4	6	10	0	0	10	0	0
13	24837627	.	A	G	15	12	27	0	0	27	0	0
13	24837876	.	T	C	4	10	14	0	1	15	0	0
13	24871866	.	A	G	9	16	25	0	1	26	0	0
13	24872667	.	A	G	9	6	15	0	0	15	0	0
13	24872733	.	G	A	5	11	16	1	0	17	0	0
13	24873141	.	C	A	0	4	4	0	10	14	0	0
13	24873186	.	A	T	5	7	12	0	0	12	0	0
13	24873480	.	A	G	7	12	19	0	2	21	0	0
13	24873579	.	C	T	8	3	11	0	1	12	0	0
13	24874897	.	G	A	5	11	16	0	0	16	0	0
13	24875948	.	A	C	0	2	2	0	0	2	0	0
13	24878687	.	T	C	0	1	1	0	1	2	0	0
13	24881635	.	T	C	4	3	7	0	0	7	0	0
13	24885195	.	G	A	0	2	2	0	0	2	0	0
13	24905897	.	G	A	2	4	6	0	0	6	0	0
13	24918814	.	T	A	7	8	15	0	1	16	0	0
13	24918820	.	T	C	7	8	15	0	1	16	0	0
13	24986203	.	G	A	3	2	5	0	0	5	0	0
13	24986238	.	G	T	6	9	15	0	0	15	0	0
13	24986272	.	T	C	4	0	4	0	12	16	0	0
13	25199240	.	T	C	2	0	2	0	4	6	0	0
13	25207064	.	G	C	1	0	1	0	0	1	0	0
13	25207068	.	C	T	1	0	1	0	0	1	0	0
13	25208484	.	T	G	1	2	3	0	0	3	0	0
13	25208545	.	T	A	2	2	4	0	0	4	0	0
13	25208605	.	A	T	0	4	4	0	0	4	0	0
13	25214739	.	G	A	3	2	5	0	0	5	0	0
13	25229672	.	C	T	0	2	2	0	2	4	0	0
13	25365034	.	G	A	4	3	7	0	0	7	0	0
13	25366380	.	T	G	0	1	1	0	0	1	0	0
13	25369449	.	C	T	3	2	5	0	1	6	0	0
13	25371436	.	A	G	7	3	10	0	1	11	0	0
13	25371475	.	C	A	11	5	16	0	1	17	0	0
13	25371918	.	A	G	1	3	4	0	0	4	0	0
13	25378924	.	T	G	6	10	16	0	0	16	0	0
13	25379263	.	A	T	14	12	26	0	1	27	0	0
13	25379304	.	A	G	8	1	9	0	9	18	0	0
13	25379352	.	A	C	8	8	16	0	1	17	0	0
13	25384281	.	T	C	6	5	11	0	1	12	0	0
13	25386904	.	C	T	2	1	3	0	0	3	0	0
13	25388389	.	G	A	3	5	8	0	0	8	0	0
13	25388764	.	T	G	0	0	0	0	3	3	0	0
13	25388839	.	A	T	2	2	4	0	2	6	0	0
13	25429048	.	T	A	7	4	11	0	0	11	0	0
13	25429145	.	G	A	5	7	12	0	0	12	0	0
13	25429158	.	G	A	6	5	11	0	0	11	0	0
13	25436360	.	A	T	8	9	17	0	0	17	0	0
13	25449867	.	C	A	1	2	3	0	0	3	0	0
13	25450114	.	G	A	1	1	2	0	1	3	0	0
13	25472084	.	C	T	7	5	12	0	0	12	0	0
13	25472336	.	G	A	24	16	40	0	2	42	0	0
13	25472735	.	G	A	14	7	21	0	0	21	0	0
13	25472859	.	G	A	17	10	27	0	1	28	0	0
13	25473084	.	T	A	10	22	32	0	4	36	0	0
13	25473325	.	G	A	4	2	6	0	1	7	0	0
13	25474019	.	G	T	8	17	25	0	1	26	0	0
13	25475904	.	A	G	4	5	9	0	0	9	0	0
13	25477304	.	A	G	4	5	9	0	0	9	0	0
13	25495556	.	C	T	3	2	5	0	0	5	0	0
13	25495781	.	G	A	1	6	7	0	0	7	0	0
13	25497320	.	A	G	4	0	4	0	6	10	0	0
13	25497575	.	T	C	7	4	11	0	0	11	0	0
13	25497581	.	C	T	8	4	12	0	0	12	0	0
13	25497700	.	G	C	7	7	14	0	1	15	0	0
13	25497769	.	T	A	11	9	20	0	1	21	0	0
13	25516204	.	T	C	2	4	6	0	1	7	0	0
13	25519063	.	G	A	0	5	5	0	9	14	0	0
13	25523629	.	T	C	2	4	6	0	0	6	0	0
13	25523677	.	G	A	0	3	3	0	1	4	0	0
13	25523680	.	T	A	3	1	4	0	0	4	0	0
13	25525947	.	C	T	1	1	2	0	0	2	0	0
13	25525989	.	G	A	2	4	6	0	0	6	0	0
13	25531776	.	T	C	10	7	17	0	0	17	0	0
13	25532352	.	C	T	12	10	22	0	4	26	0	0
13	25532574	.	C	A	15	10	25	0	0	25	0	0
13	25532857	.	A	G	6	5	11	0	1	12	0	0
13	25533233	.	G	A	15	11	26	0	1	27	0	0
13	25533258	.	T	A	11	12	23	0	2	25	0	0
13	25533452	.	A	T	11	10	21	0	0	21	0	0
13	25533657	.	C	G	11	1	12	0	8	20	0	0
13	25533767	.	G	T	13	13	26	0	0	26	0	0
13	25533846	.	G	A	13	7	20	0	3	23	0	0
13	25533897	.	C	T	6	4	10	0	1	11	0	0
13	25534172	.	T	A	9	9	18	0	0	18	0	0
13	25534368	.	A	G	18	0	18	0	16	34	0	0
13	25534551	.	G	A	4	5	9	0	0	9	0	0
13	25535405	.	G	A	1	4	5	0	2	7	0	0
13	25540358	.	C	A	0	0	0	0	1	1	0	0
13	25549516	.	A	G	7	0	7	0	6	13	0	0
13	25551781	.	C	A	5	3	8	0	0	8	0	0
13	25551865	.	T	C	5	7	12	0	0	12	0	0
13	25552219	.	T	C	1	0	1	0	0	1	0	0
13	25554553	.	T	G	2	0	2	0	1	3	0	0
13	25559610	.	G	A	2	3	5	0	0	5	0	0
13	25560458	.	A	T	1	1	2	0	0	2	0	0
13	25560471	.	G	A	0	1	1	0	1	2	0	0
13	25563221	.	C	A	4	2	6	0	0	6	0	0
13	25565379	.	T	C	4	9	13	0	1	14	0	0
13	25565985	.	G	A	3	4	7	0	1	8	0	0
13	25565988	.	A	C	3	2	5	0	2	7	0	0
13	25566205	.	A	T	4	7	11	0	1	12	0	0
13	25566222	.	C	T	3	5	8	0	1	9	0	0
13	25569940	.	A	C	5	7	12	0	1	13	0	0
13	25570044	.	C	T	0	6	6	0	4	10	0	0
13	25570104	.	C	T	3	4	7	0	1	8	0	0
13	25570164	.	A	C	4	0	4	0	4	8	0	0
13	25570341	.	T	C	3	0	3	0	5	8	0	0
13	25570410	.	A	G	11	11	22	0	0	22	0	0
13	25570477	.	G	A	10	7	17	0	1	18	0	0
13	25570532	.	A	C	6	0	6	0	7	14	1	0
13	25570610	.	T	C	5	2	7	0	0	7	0	0
13	25570618	.	A	T	4	4	8	0	0	8	0	0
13	25570709	.	T	C	7	0	7	0	7	14	0	0
13	25570715	.	C	T	6	7	13	0	0	13	0	0
13	25570821	.	T	C	3	2	5	0	0	5	0	0
13	25570854	.	A	T	1	12	13	0	0	13	0	0
13	25571113	.	A	T	8	3	11	0	0	11	0	0
13	25571274	.	C	T	4	9	13	0	0	13	0	0
13	25575396	.	C	T	1	4	5	0	1	6	0	0
13	25575411	.	A	C	1	5	6	0	0	6	0	0
13	25580764	.	C	A	2	6	8	0	0	8	0	0
13	25584983	.	T	G	2	4	6	0	0	6	0	0
13	25584993	.	A	T	4	2	6	0	0	7	1	0
13	25585757	.	G	A	3	5	8	0	0	8	0	0
13	25585785	.	T	C	1	2	3	0	0	3	0	0
13	25585876	.	G	T	1	2	3	0	0	3	0	0
13	25585879	.	G	A	1	2	3	0	0	3	0	0
13	25589241	.	G	A	1	3	4	0	0	4	0	0
13	25726201	.	C	T	3	7	10	0	1	11	0	0
13	25728453	.	A	C	9	5	14	0	1	15	0	0
13	25728606	.	A	T	3	3	6	0	0	6	0	0
13	25824718	.	C	T	17	10	27	0	1	28	0	0
13	25825016	.	G	A	15	17	32	0	2	34	0	0
13	25825445	.	A	T	4	5	9	0	1	10	0	0
13	25827421	.	G	A	7	5	12	0	0	12	0	0
13	25842020	.	T	C	5	0	5	0	5	10	0	0
13	25923392	.	A	G	11	11	22	0	1	23	0	0
13	25923450	.	A	T	8	6	14	0	1	15	0	0
13	25924388	.	C	T	9	11	20	0	1	21	0	0
13	25924523	.	C	T	16	5	21	0	0	21	0	0
13	26699790	.	G	A	0	2	2	0	0	2	0	0
13	26780130	.	C	T	1	1	2	0	0	2	0	0
13	27000394	.	C	T	0	5	5	0	1	6	0	0
13	27036582	.	T	C	5	0	5	0	3	8	0	0
13	27036660	.	T	C	5	6	11	0	0	11	0	0
13	27036676	.	T	C	8	5	13	0	0	13	0	0
13	27036766	.	G	A	5	5	10	0	0	10	0	0
13	27036847	.	C	T	4	5	9	0	0	9	0	0
13	27036898	.	T	C	8	9	17	0	0	17	0	0
13	27189898	.	C	T	2	0	2	0	0	2	0	0
13	27190435	.	C	T	2	1	3	0	0	3	0	0
13	27201606	.	T	C	2	2	4	0	0	4	0	0
13	27201624	.	A	T	1	1	2	0	0	2	0	0
13	27204440	.	T	A	7	9	16	0	0	16	0	0
13	27207707	.	G	T	1	5	6	0	0	6	0	0
13	27294187	.	G	T	2	3	5	0	0	5	0	0
13	27294656	.	G	A	2	1	3	0	1	4	0	0
13	27294735	.	G	A	1	2	3	0	0	3	0	0
13	27296278	.	A	G	6	3	9	0	0	9	0	0
13	27296291	.	T	C	6	4	10	0	0	10	0	0
13	27296396	.	G	A	2	3	5	0	0	5	0	0
13	27296433	.	A	G	3	2	5	0	0	5	0	0
13	27296576	.	C	T	4	8	12	0	0	12	0	0
13	27296616	.	T	C	2	9	11	0	0	11	0	0
13	27303822	.	T	C	1	2	3	0	1	4	0	0
13	27309080	.	C	T	3	2	5	0	1	6	0	0
13	27309143	.	C	T	6	8	14	0	0	14	0	0
13	27313025	.	T	A	2	3	5	0	0	5	0	0
13	27313236	.	A	G	4	9	13	0	0	13	0	0
13	27313258	.	G	T	10	5	15	0	0	15	0	0
13	27316862	.	T	G	4	4	8	0	0	8	0	0
13	27317499	.	C	T	18	17	35	0	0	35	0	0
13	27320574	.	T	C	20	10	30	0	0	30	0	0
13	27320583	.	C	T	21	16	37	0	0	37	0	0
13	27320628	.	T	A	19	25	44	0	2	46	0	0
13	27320771	.	C	T	2	0	2	0	0	2	0	0
13	27320849	.	T	C	20	35	55	0	5	60	0	0
13	27321211	.	C	T	24	37	61	0	4	65	0	0
13	27321271	.	G	A	1	28	29	0	24	53	0	0
13	27323970	.	G	A	1	16	17	0	12	29	0	0
13	27323976	.	G	A	0	17	17	0	17	34	0	0
13	27324341	.	A	T	27	27	54	0	1	55	0	0
13	27324346	.	T	C	25	27	52	0	4	56	0	0
13	27632915	.	C	T	0	18	18	0	8	26	0	0
13	27633628	.	G	A	22	19	41	0	0	41	0	0
13	27633833	.	A	G	17	10	27	0	0	27	0	0
13	27633906	.	A	G	9	22	31	0	0	31	0	0
13	27634634	.	A	G	11	10	21	0	6	27	0	0
13	27634670	.	G	T	24	9	33	0	1	35	1	0
13	27634678	.	G	T	24	12	36	0	2	38	0	0
13	27634726	.	T	C	18	0	18	0	23	41	0	0
13	27634789	.	A	G	13	23	36	0	1	37	0	0
13	27634903	.	A	G	7	8	15	0	0	15	0	0
13	27650537	.	G	A	18	12	30	0	1	31	0	0
13	27653458	.	C	A	0	3	3	0	0	3	0	0
13	27668056	.	G	T	15	7	22	0	0	22	0	0
13	27674408	.	C	T	7	5	12	0	0	12	0	0
13	27675462	.	T	C	5	0	5	0	6	11	0	0
13	27677945	.	C	T	0	1	1	0	0	1	0	0
13	27685233	.	G	A	9	9	18	0	1	19	0	0
13	27685329	.	C	T	0	9	9	0	11	20	0	0
13	27685363	.	G	A	10	11	21	0	0	21	0	0
13	27685446	.	C	T	7	7	14	0	0	14	0	0
13	27685552	.	G	A	12	9	21	0	1	22	0	0
13	27685583	.	C	T	0	12	12	0	15	27	0	0
13	27686252	.	G	A	6	8	14	0	0	14	0	0
13	27686259	.	C	T	6	9	15	1	1	17	0	0
13	27770575	.	T	C	9	5	14	0	3	17	0	0
13	27776846	.	A	G	6	3	9	0	1	10	0	0
13	27782086	.	C	A	3	10	13	0	0	13	0	0
13	27782192	.	A	T	3	4	7	0	0	7	0	0
13	27782193	.	G	A	3	4	7	0	0	7	0	0
13	27782448	.	G	A	0	6	6	0	7	13	0	0
13	27782585	.	G	A	5	4	9	0	0	9	0	0
13	27951758	.	T	A	2	5	7	0	0	7	0	0
13	27951989	.	A	C	4	11	15	0	2	17	0	0
13	27952207	.	G	A	9	11	20	0	0	20	0	0
13	27952330	.	G	T	11	13	24	0	2	26	0	0
13	27963912	.	T	C	2	9	11	0	0	11	0	0
13	28009108	.	C	T	12	11	23	0	0	23	0	0
13	28009159	.	G	A	8	15	23	0	1	24	0	0
13	28009178	.	A	C	8	17	25	0	1	26	0	0
13	28009246	.	A	T	25	11	36	0	1	37	0	0
13	28009302	.	G	A	0	17	17	0	16	33	0	0
13	28009567	.	G	A	15	14	29	0	0	29	0	0
13	28010214	.	C	A	7	33	40	0	22	62	0	0
13	28010572	.	C	A	25	19	44	0	5	49	0	0
13	28062552	.	T	G	0	1	1	0	0	1	0	0
13	28176651	.	T	C	0	0	0	0	1	1	0	0
13	28306325	.	A	G	3	2	5	0	0	5	0	0
13	28498793	.	G	A	0	2	2	0	0	2	0	0
13	28498812	.	G	A	0	2	2	0	0	2	0	0
13	28501360	.	C	T	6	5	11	0	0	11	0	0
13	28501535	.	G	C	1	2	3	0	0	3	0	0
13	28513036	.	T	C	3	2	5	0	0	5	0	0
13	28561116	.	T	C	2	3	5	0	0	5	0	0
13	28561184	.	T	C	2	1	3	0	0	3	0	0
13	28561190	.	A	T	3	2	5	0	0	5	0	0
13	28561244	.	G	C	3	6	9	0	0	9	0	0
13	28596162	.	C	A	2	5	7	0	0	7	0	0
13	28596166	.	T	C	2	5	7	0	0	7	0	0
13	28615556	.	C	T	6	5	11	0	1	12	0	0
13	28615622	.	T	C	1	2	3	0	0	3	0	0
13	28619373	.	T	G	2	2	4	0	0	4	0	0
13	28650349	.	A	T	9	16	25	0	1	26	0	0
13	28650416	.	G	C	11	9	20	0	1	21	0	0
13	28650683	.	A	G	15	6	21	0	0	21	0	0
13	28651365	.	A	G	19	17	36	0	2	38	0	0
13	28676034	.	G	A	7	6	13	0	0	13	0	0
13	28676083	.	A	C	5	5	10	0	1	11	0	0
13	28678176	.	C	G	7	3	10	0	0	10	0	0
13	28680681	.	G	A	3	2	5	0	0	5	0	0
13	28680879	.	T	C	4	4	8	0	0	8	0	0
13	28682983	.	G	T	1	2	3	0	0	3	0	0
13	28692778	.	C	T	3	5	8	0	0	8	0	0
13	28694447	.	G	A	2	4	6	0	0	6	0	0
13	28701246	.	G	A	0	1	1	0	3	4	0	0
13	28741042	.	A	T	1	5	6	0	0	6	0	0
13	28744159	.	G	A	3	4	7	0	0	7	0	0
13	28744690	.	C	T	18	11	29	0	2	31	0	0
13	28744831	.	C	T	11	11	22	0	0	22	0	0
13	28745188	.	G	A	10	18	28	0	1	29	0	0
13	28745825	.	G	A	6	12	18	0	1	19	0	0
13	28745963	.	C	T	11	7	18	0	0	18	0	0
13	28746326	.	A	G	2	3	5	0	1	6	0	0
13	28746349	.	A	G	2	3	5	0	1	6	0	0
13	28841987	.	C	T	7	10	17	0	1	18	0	0
13	28841990	.	G	T	7	11	18	0	0	18	0	0
13	28866485	.	A	G	19	16	35	0	3	38	0	0
13	28866518	.	C	A	14	19	33	0	4	37	0	0
13	28866553	.	A	G	16	27	43	0	1	44	0	0
13	28866590	.	A	G	17	24	41	0	3	44	0	0
13	28866615	.	C	T	16	26	42	0	3	45	0	0
13	28866722	.	T	C	16	19	35	0	1	36	0	0
13	28866857	.	G	T	1	18	19	0	17	36	0	0
13	28867071	.	G	T	19	18	37	0	2	39	0	0
13	28867382	.	A	T	25	19	44	0	3	47	0	0
13	28901463	.	T	A	26	26	52	0	0	52	0	0
13	28901714	.	T	A	33	20	53	0	4	57	0	0
13	28901871	.	A	T	13	14	27	0	0	27	0	0
13	28901957	.	A	G	11	16	27	0	2	29	0	0
13	28901996	.	T	C	13	18	31	0	3	34	0	0
13	28902058	.	C	T	19	11	30	0	3	33	0	0
13	29208761	.	G	A	0	2	2	0	1	3	0	0
13	29208776	.	C	T	1	2	3	0	0	3	0	0
13	29295759	.	A	C	1	2	3	0	0	3	0	0
13	29298163	.	C	T	0	1	1	0	0	1	0	0
13	29333853	.	C	A	6	5	11	0	1	12	0	0
13	29346927	.	G	A	0	7	7	0	6	13	0	0
13	29347252	.	T	C	2	5	7	0	3	10	0	0
13	29357115	.	T	A	1	0	1	0	0	1	0	0
13	29374153	.	G	A	0	1	1	0	3	4	0	0
13	29374165	.	G	A	3	2	5	0	0	5	0	0
13	29374514	.	C	T	2	3	5	0	0	5	0	0
13	29381047	.	A	C	5	3	8	0	0	8	0	0
13	29385786	.	A	G	1	1	2	0	0	2	0	0
13	29385831	.	G	A	5	4	9	0	0	9	0	0
13	29385894	.	G	A	2	3	5	0	0	5	0	0
13	29392238	.	C	T	3	0	3	0	0	3	0	0
13	29392261	.	G	A	0	4	4	0	0	4	0	0
13	29402613	.	T	G	6	9	15	0	0	15	0	0
13	29402669	.	C	T	4	2	6	0	0	6	0	0
13	29403953	.	A	C	5	6	11	0	2	13	0	0
13	29403957	.	C	T	7	6	13	0	1	14	0	0
13	29404145	.	T	C	7	11	18	0	0	18	0	0
13	29404218	.	T	A	4	10	14	0	0	14	0	0
13	29404323	.	G	T	14	17	31	0	0	31	0	0
13	29404399	.	A	T	11	9	20	0	2	22	0	0
13	29404400	.	C	T	12	9	21	0	1	22	0	0
13	29404576	.	A	G	8	18	26	0	3	29	0	0
13	29404633	.	C	T	18	13	31	0	2	33	0	0
13	29404660	.	T	G	17	1	18	0	19	37	0	0
13	29404754	.	T	A	3	6	9	0	0	9	0	0
13	29407196	.	C	T	5	8	13	0	0	13	0	0
13	29407397	.	C	A	0	6	6	0	6	12	0	0
13	29407896	.	A	G	2	9	11	0	0	11	0	0
13	29408052	.	G	T	6	3	9	0	0	9	0	0
13	29408192	.	T	A	6	7	13	0	0	13	0	0
13	29408650	.	A	G	8	6	14	0	1	15	0	0
13	29408677	.	T	A	9	7	16	0	1	17	0	0
13	29408989	.	G	A	11	5	16	0	0	16	0	0
13	29409206	.	T	G	5	5	10	0	0	10	0	0
13	29409210	.	T	A	5	4	9	0	0	9	0	0
13	29409530	.	G	A	9	7	16	0	3	19	0	0
13	29409558	.	G	A	9	9	18	0	1	19	0	0
13	29411895	.	T	G	1	2	3	0	0	3	0	0
13	29414441	.	G	C	2	0	2	0	0	2	0	0
13	29414482	.	A	T	3	4	7	0	2	9	0	0
13	29414509	.	G	A	4	5	9	0	0	9	0	0
13	29415184	.	A	T	0	3	3	0	1	4	0	0
13	29416798	.	A	T	4	1	5	0	1	6	0	0
13	29417792	.	T	C	1	0	1	0	0	1	0	0
13	29417814	.	G	A	2	1	3	0	0	3	0	0
13	29419583	.	G	A	4	5	9	0	0	9	0	0
13	29421296	.	C	T	7	4	11	0	0	11	0	0
13	29422391	.	A	C	6	7	13	0	2	15	0	0
13	29422459	.	C	T	7	3	10	0	0	10	0	0
13	29422511	.	T	A	3	4	7	0	0	7	0	0
13	29422808	.	G	A	4	11	15	0	1	16	0	0
13	29771323	.	T	C	5	2	7	0	0	7	0	0
13	29804178	.	T	A	6	3	9	0	0	9	0	0
13	29804207	.	C	A	3	3	6	0	0	6	0	0
13	29804362	.	T	C	4	5	9	0	0	9	0	0
13	29925560	.	A	T	1	1	2	0	1	3	0	0
13	29926242	.	C	T	1	0	1	0	0	1	0	0
13	29928675	.	A	G	7	6	13	0	0	13	0	0
13	29935371	.	A	G	5	3	8	0	0	8	0	0
13	29935678	.	T	G	2	4	6	0	0	6	0	0
13	29935682	.	T	C	3	4	7	0	0	7	0	0
13	29935983	.	C	G	1	6	7	0	0	7	0	0
13	29952902	.	C	T	4	5	9	0	1	10	0	0
13	29952914	.	G	A	5	6	11	0	0	11	0	0
13	29952972	.	C	T	8	8	16	0	1	17	0	0
13	29952973	.	A	T	9	8	17	0	0	17	0	0
13	29953265	.	T	G	10	5	15	0	0	15	0	0
13	29953267	.	C	A	10	5	15	0	0	15	0	0
13	29953383	.	G	T	8	11	19	0	0	19	0	0
13	29953522	.	T	C	7	0	7	0	11	18	0	0
13	29958513	.	T	A	5	3	8	0	1	9	0	0
13	29958551	.	G	A	5	2	7	0	0	7	0	0
13	29965856	.	G	A	4	2	6	0	0	6	0	0
13	29979966	.	T	C	8	4	12	0	0	12	0	0
13	30008596	.	A	T	23	19	42	0	3	46	1	0
13	30008631	.	T	C	24	15	39	0	4	43	0	0
13	30008737	.	T	C	23	18	41	0	1	42	0	0
13	30009128	.	G	C	7	7	14	0	1	15	0	0
13	30009818	.	A	C	24	26	50	0	1	51	0	0
13	30009968	.	T	C	19	10	29	3	1	33	0	0
13	30010059	.	C	A	16	19	35	0	0	35	0	0
13	30010137	.	T	C	19	12	31	1	1	33	0	0
13	30021321	.	T	A	4	8	12	0	1	14	1	0
13	30027133	.	T	G	7	12	19	0	1	21	1	0
13	30027523	.	T	A	8	5	13	0	0	13	0	0
13	30027659	.	C	T	3	5	8	0	1	9	0	0
13	30039013	.	C	T	2	3	5	0	0	5	0	0
13	30041662	.	G	A	3	0	3	0	1	4	0	0
13	30043395	.	T	G	1	0	1	0	2	3	0	0
13	30043579	.	A	G	2	3	5	0	0	5	0	0
13	30055098	.	C	T	1	2	3	0	1	4	0	0
13	30106137	.	C	G	9	0	9	0	7	16	0	0
13	30112396	.	C	T	11	14	25	0	2	27	0	0
13	30112414	.	T	A	7	8	15	0	1	16	0	0
13	30115125	.	A	G	6	6	12	0	1	13	0	0
13	30115217	.	C	T	6	0	6	0	0	6	0	0
13	30128388	.	A	T	3	1	4	0	0	4	0	0
13	30131722	.	G	T	22	19	41	0	0	41	0	0
13	30131804	.	G	A	23	21	44	0	0	44	0	0
13	30132190	.	T	C	33	19	52	0	1	53	0	0
13	30138763	.	T	A	0	3	3	0	0	3	0	0
13	30138790	.	C	T	2	3	5	0	0	5	0	0
13	30139773	.	G	A	2	1	3	0	0	3	0	0
13	30145217	.	A	G	2	3	5	0	0	5	0	0
13	30145514	.	T	A	5	5	10	0	0	10	0	0
13	30145616	.	T	A	4	4	8	0	1	9	0	0
13	30146199	.	C	A	2	3	5	0	1	6	0	0
13	30146447	.	T	A	2	2	4	0	0	4	0	0
13	30152310	.	A	C	4	2	6	0	0	6	0	0
13	30152502	.	G	C	9	13	22	0	0	22	0	0
13	30155934	.	C	T	4	14	18	0	2	20	0	0
13	30155973	.	T	A	3	6	9	0	0	9	0	0
13	30156176	.	T	C	3	7	10	0	1	11	0	0
13	30156347	.	A	T	1	2	3	0	0	3	0	0
13	30158975	.	A	G	4	6	10	0	0	10	0	0
13	30161553	.	T	A	7	10	17	0	1	18	0	0
13	30166340	.	C	A	14	12	26	0	1	27	0	0
13	30167097	.	C	A	4	2	6	0	0	6	0	0
13	30167430	.	T	G	11	19	30	0	2	32	0	0
13	30167432	.	A	G	12	20	32	0	0	32	0	0
13	30167711	.	G	A	20	9	29	0	2	31	0	0
13	30167716	.	T	C	23	10	33	0	0	33	0	0
13	30167807	.	G	A	0	23	23	0	21	44	0	0
13	30168662	.	T	A	18	12	30	0	4	34	0	0
13	30190019	.	A	T	2	3	5	0	0	5	0	0
13	30190031	.	C	T	2	3	5	0	0	5	0	0
13	30199107	.	T	G	0	1	1	0	0	1	0	0
13	30229090	.	A	G	23	3	26	0	35	61	0	0
13	30234351	.	A	C	4	2	6	0	0	6	0	0
13	30498325	.	A	G	3	0	3	0	3	6	0	0
13	30551479	.	T	C	3	7	10	0	0	10	0	0
13	30552253	.	A	G	1	0	1	0	4	5	0	0
13	30552504	.	T	A	5	3	8	0	1	9	0	0
13	30552915	.	T	C	0	1	1	0	0	1	0	0
13	30553404	.	T	C	3	5	8	0	0	8	0	0
13	30553682	.	C	T	13	5	18	0	0	18	0	0
13	30555751	.	G	A	2	5	7	0	0	7	0	0
13	30556278	.	C	T	4	4	8	0	0	8	0	0
13	30558555	.	C	A	1	3	4	0	0	4	0	0
13	30558896	.	T	C	1	1	2	0	0	2	0	0
13	30559044	.	A	G	5	1	6	0	0	6	0	0
13	30562079	.	T	G	8	4	12	0	0	12	0	0
13	30562673	.	T	C	1	5	6	0	0	6	0	0
13	30568158	.	T	C	2	5	7	0	0	7	0	0
13	30568176	.	A	G	4	1	5	0	3	8	0	0
13	30568316	.	T	A	6	6	12	0	0	12	0	0
13	30568875	.	A	G	9	14	23	0	1	24	0	0
13	30569650	.	A	C	5	2	7	0	0	7	0	0
13	30569687	.	A	G	7	9	16	0	0	16	0	0
13	30572333	.	A	C	3	3	6	0	0	6	0	0
13	30575206	.	G	A	1	1	2	0	0	2	0	0
13	30575325	.	A	G	1	0	1	0	0	1	0	0
13	30575452	.	C	A	3	5	8	0	0	8	0	0
13	30575637	.	T	A	3	5	8	0	1	9	0	0
13	30579792	.	T	C	5	0	5	0	6	11	0	0
13	30580465	.	T	G	1	2	3	0	0	3	0	0
13	30580786	.	A	T	3	2	5	0	0	5	0	0
13	30580935	.	T	C	7	0	7	0	6	13	0	0
13	30580966	.	T	G	4	6	10	0	0	10	0	0
13	30581329	.	C	T	0	6	6	0	5	11	0	0
13	30581334	.	A	T	4	7	11	0	0	11	0	0
13	30581755	.	C	T	3	4	7	0	0	7	0	0
13	30582347	.	T	C	1	0	1	0	2	3	0	0
13	30582461	.	T	C	4	0	4	0	2	6	0	0
13	30582468	.	A	G	4	2	6	0	0	6	0	0
13	30582729	.	G	A	1	4	5	0	0	5	0	0
13	30582746	.	C	T	0	5	5	0	4	9	0	0
13	30582781	.	G	A	4	3	7	0	0	7	0	0
13	30583573	.	A	G	1	2	3	0	0	3	0	0
13	30817617	.	G	T	5	6	11	0	0	11	0	0
13	30817633	.	G	A	5	4	9	0	0	9	0	0
13	30817872	.	A	G	3	0	3	0	6	9	0	0
13	30817951	.	C	T	5	3	8	0	0	8	0	0
13	30817983	.	T	C	7	4	11	0	0	11	0	0
13	30818107	.	C	G	9	8	17	0	0	17	0	0
13	30818246	.	C	T	12	9	21	0	1	22	0	0
13	30818319	.	A	T	3	8	11	0	0	11	0	0
13	30818597	.	A	G	4	2	6	0	0	6	0	0
13	30818849	.	A	G	7	10	17	0	0	17	0	0
13	30818876	.	C	T	6	7	13	0	0	13	0	0
13	30818986	.	T	A	7	6	13	0	1	14	0	0
13	30819133	.	G	C	11	19	30	0	2	32	0	0
13	30819334	.	T	C	13	2	15	0	2	17	0	0
13	30819444	.	A	T	8	8	16	0	2	18	0	0
13	30819445	.	T	G	9	8	17	0	1	18	0	0
13	30819645	.	T	C	3	5	8	0	3	11	0	0
13	30878903	.	A	G	1	3	4	0	0	4	0	0
13	30879062	.	G	A	1	2	3	0	0	3	0	0
13	30892629	.	C	T	2	4	6	0	0	6	0	0
13	30905716	.	T	C	4	4	8	0	0	8	0	0
13	30905827	.	G	A	0	5	5	0	5	10	0	0
13	30906016	.	A	G	1	3	4	0	0	4	0	0
13	30906190	.	A	T	1	1	2	0	0	2	0	0
13	30908977	.	T	C	3	3	6	0	0	6	0	0
13	30909200	.	C	T	2	2	4	0	0	4	0	0
13	30909624	.	T	A	1	4	5	0	1	6	0	0
13	31925701	.	A	G	5	3	8	0	0	8	0	0
13	31933666	.	A	G	1	3	4	0	0	4	0	0
13	31933684	.	G	A	1	5	6	0	0	6	0	0
13	31935288	.	C	T	4	2	6	0	0	6	0	0
13	31936700	.	G	T	1	2	3	0	0	3	0	0
13	31936707	.	T	A	1	2	3	0	0	3	0	0
13	32150021	.	T	C	0	3	3	0	0	3	0	0
13	32452658	.	C	T	3	4	7	0	0	7	0	0
13	32452949	.	T	G	3	4	7	0	1	8	0	0
13	32453362	.	T	G	2	7	9	0	1	10	0	0
13	32453661	.	G	T	3	5	8	0	0	8	0	0
13	32453721	.	A	C	1	5	6	0	0	6	0	0
13	32453730	.	C	T	1	4	5	0	1	6	0	0
13	32454381	.	A	T	6	8	14	0	0	14	0	0
13	32454546	.	A	G	5	2	7	0	4	11	0	0
13	32454565	.	T	A	4	7	11	0	1	12	0	0
13	32454617	.	G	A	1	3	4	0	0	4	0	0
13	32455754	.	C	T	8	8	16	0	0	16	0	0
13	32455943	.	A	G	8	6	14	0	0	14	0	0
13	32456312	.	C	G	3	8	11	0	0	11	0	0
13	32575822	.	G	C	5	2	7	0	0	7	0	0
13	32575859	.	T	G	5	2	7	0	0	7	0	0
13	32575964	.	T	G	3	2	5	0	0	5	0	0
13	32575983	.	T	C	4	0	4	0	1	5	0	0
13	32580556	.	T	G	4	3	7	0	0	7	0	0
13	32580572	.	A	C	5	4	9	0	0	9	0	0
13	32580616	.	G	A	5	5	10	0	0	10	0	0
13	32580618	.	C	G	5	5	10	0	0	10	0	0
13	32583864	.	C	T	4	6	10	0	0	10	0	0
13	32583930	.	A	G	10	12	22	0	1	23	0	0
13	32593009	.	T	C	3	0	3	0	4	7	0	0
13	32630423	.	T	C	1	2	3	0	0	3	0	0
13	32638670	.	T	C	9	11	20	0	0	20	0	0
13	32638718	.	A	G	6	6	12	0	0	12	0	0
13	32638737	.	T	C	8	10	18	0	0	18	0	0
13	32638991	.	T	C	1	4	5	0	0	5	0	0
13	32640975	.	C	A	9	5	14	0	0	14	0	0
13	32641146	.	A	T	1	4	5	0	0	5	0	0
13	32641165	.	G	A	2	3	5	0	0	5	0	0
13	32641215	.	A	G	2	2	4	0	0	4	0	0
13	32641480	.	T	C	2	2	4	0	0	4	0	0
13	32641979	.	C	T	0	2	2	0	1	3	0	0
13	32642012	.	A	C	1	4	5	0	0	5	0	0
13	32642015	.	T	A	1	2	3	0	1	4	0	0
13	32642047	.	G	C	3	2	5	0	0	5	0	0
13	32642050	.	G	C	2	2	4	0	0	5	1	0
13	32642238	.	A	G	4	6	10	0	1	11	0	0
13	32642284	.	C	A	4	7	11	0	0	11	0	0
13	32642293	.	A	G	3	5	8	0	2	10	0	0
13	32642488	.	A	G	11	8	19	0	1	20	0	0
13	32642684	.	T	C	5	0	5	0	4	9	0	0
13	32642690	.	T	C	5	3	8	0	0	8	0	0
13	32642964	.	C	T	3	2	5	0	0	5	0	0
13	32643326	.	G	A	5	3	8	0	0	8	0	0
13	32643414	.	A	T	3	2	5	0	1	6	0	0
13	32644425	.	C	T	0	2	2	0	1	3	0	0
13	32665008	.	A	C	2	3	5	0	0	5	0	0
13	32665035	.	G	A	2	2	4	0	0	4	0	0
13	32679964	.	C	T	1	4	5	0	0	5	0	0
13	32679982	.	C	T	1	2	3	0	1	4	0	0
13	32794025	.	T	G	4	1	5	0	4	9	0	0
13	32794139	.	C	A	1	3	4	0	0	4	0	0
13	32794214	.	G	A	2	2	4	0	2	6	0	0
13	32794413	.	T	C	5	6	11	0	0	11	0	0
13	32794925	.	T	C	1	3	4	0	0	4	0	0
13	32794999	.	C	T	11	7	18	0	0	18	0	0
13	32795108	.	T	C	5	2	7	0	0	7	0	0
13	32795615	.	G	A	4	5	9	0	0	9	0	0
13	32795882	.	A	C	1	5	6	0	0	6	0	0
13	32807497	.	T	G	3	0	3	0	2	5	0	0
13	32812332	.	A	G	2	3	5	0	0	5	0	0
13	32812885	.	A	G	6	0	6	0	5	11	0	0
13	32815668	.	G	A	9	10	19	0	1	20	0	0
13	32815765	.	C	T	6	5	11	0	0	11	0	0
13	32815884	.	T	C	7	7	14	0	0	14	0	0
13	32815981	.	A	T	12	8	20	0	2	22	0	0
13	32816055	.	G	C	9	9	18	0	1	19	0	0
13	32816128	.	T	G	12	14	26	0	2	28	0	0
13	32816338	.	C	G	13	9	22	0	1	23	0	0
13	32825086	.	C	T	5	3	8	0	0	8	0	0
13	32825137	.	G	A	15	13	28	0	1	29	0	0
13	32825503	.	A	G	0	1	1	0	0	1	0	0
13	32826966	.	T	C	4	1	5	0	0	5	0	0
13	32826978	.	A	G	4	1	5	0	0	5	0	0
13	32827410	.	T	C	0	0	0	0	1	1	0	0
13	32827434	.	C	T	0	1	1	0	0	1	0	0
13	32827754	.	A	G	0	1	1	0	0	1	0	0
13	32830255	.	G	T	0	3	3	0	0	3	0	0
13	32831770	.	C	T	1	1	2	0	0	2	0	0
13	32831965	.	T	C	6	4	10	0	0	10	0	0
13	32831971	.	T	C	6	4	10	0	0	10	0	0
13	32832055	.	A	G	1	4	5	0	0	5	0	0
13	32832058	.	T	A	1	3	4	0	0	4	0	0
13	32838217	.	T	C	1	3	4	0	0	4	0	0
13	32838254	.	C	T	1	2	3	0	0	3	0	0
13	32838399	.	T	C	3	0	3	0	4	7	0	0
13	32838417	.	T	C	4	0	4	0	4	8	0	0
13	32838507	.	T	C	4	3	7	0	1	8	0	0
13	32841314	.	A	G	4	2	6	0	1	7	0	0
13	32841377	.	C	T	4	5	9	0	0	9	0	0
13	32841598	.	A	G	2	3	5	0	0	5	0	0
13	32901468	.	A	C	2	3	5	0	0	5	0	0
13	32902243	.	C	T	0	4	4	0	4	8	0	0
13	32902537	.	T	G	1	1	2	0	0	2	0	0
13	32902545	.	G	A	1	2	3	0	0	3	0	0
13	33028797	.	A	G	15	9	24	0	3	27	0	0
13	33029624	.	G	T	0	13	13	0	11	24	0	0
13	33031915	.	A	G	2	1	3	0	0	3	0	0
13	33033354	.	A	G	19	23	42	0	1	43	0	0
13	33048095	.	T	C	6	0	6	0	5	11	0	0
13	33054598	.	T	C	1	1	2	0	0	2	0	0
13	33059182	.	C	T	0	2	2	0	0	2	0	0
13	33059257	.	T	C	4	6	10	0	0	10	0	0
13	33059260	.	A	G	4	5	9	0	0	9	0	0
13	33062352	.	G	C	16	6	22	0	0	22	0	0
13	33065614	.	A	C	10	8	18	0	0	18	0	0
13	33065670	.	G	A	11	5	16	0	0	16	0	0
13	33066618	.	A	T	1	3	4	0	0	4	0	0
13	33066629	.	T	C	2	5	7	0	1	8	0	0
13	33066691	.	C	A	0	8	8	0	5	13	0	0
13	33066778	.	T	C	2	3	5	0	0	5	0	0
13	33066782	.	G	T	1	2	3	0	1	4	0	0
13	33066882	.	A	C	1	3	4	0	1	5	0	0
13	33066893	.	A	T	1	4	5	0	1	6	0	0
13	33067116	.	T	A	1	1	2	0	1	3	0	0
13	33067129	.	A	T	2	2	4	0	0	4	0	0
13	33067157	.	T	G	2	3	5	0	0	5	0	0
13	33067406	.	A	C	4	0	4	0	3	7	0	0
13	33067413	.	A	G	4	1	5	0	1	6	0	0
13	33067624	.	C	T	5	2	7	0	0	7	0	0
13	33083495	.	A	G	1	3	4	0	0	4	0	0
13	33089068	.	A	G	3	3	6	0	0	6	0	0
13	33089092	.	A	G	3	4	7	0	0	7	0	0
13	33089123	.	T	A	2	2	4	0	0	4	0	0
13	33096437	.	A	G	2	2	4	0	0	4	0	0
13	33122594	.	G	A	5	3	8	0	0	8	0	0
13	33122941	.	C	T	4	13	17	0	1	18	0	0
13	33122949	.	G	C	5	7	12	0	2	14	0	0
13	33263786	.	T	C	8	2	10	2	1	13	0	0
13	33447700	.	T	A	1	2	3	0	0	3	0	0
13	35751036	.	T	A	9	2	11	0	0	11	0	0
13	35872373	.	T	C	0	5	5	0	1	6	0	0
13	36680611	.	G	A	0	0	0	0	1	1	0	0
13	36683911	.	C	T	2	3	5	0	0	5	0	0
13	36691543	.	T	C	13	12	25	0	2	27	0	0
13	36705778	.	A	G	1	2	3	0	0	3	0	0
13	36706013	.	T	G	10	6	16	0	0	16	0	0
13	36764791	.	C	T	19	16	35	0	0	35	0	0
13	36764838	.	C	G	11	4	15	0	0	15	0	0
13	36771815	.	G	A	13	9	22	0	1	23	0	0
13	36781068	.	G	C	1	6	7	0	10	17	0	0
13	36781407	.	A	G	25	3	28	0	18	46	0	0
13	36783998	.	G	A	1	23	24	0	26	50	0	0
13	36784262	.	G	A	0	12	12	0	13	25	0	0
13	36784347	.	G	A	0	5	5	0	4	9	0	0
13	36784350	.	G	A	4	5	9	0	0	9	0	0
13	36787176	.	C	A	1	2	3	0	0	3	0	0
13	36787766	.	G	A	1	2	3	0	1	4	0	0
13	36787783	.	G	A	1	4	5	0	0	5	0	0
13	36802371	.	T	C	3	2	5	0	0	5	0	0
13	36802632	.	T	C	2	0	2	0	2	4	0	0
13	36868450	.	C	T	2	3	5	0	0	5	0	0
13	36868564	.	G	A	16	11	27	0	2	29	0	0
13	36868635	.	T	G	17	17	34	0	2	36	0	0
13	36868938	.	C	A	25	17	42	0	0	42	0	0
13	36869639	.	C	T	2	20	22	1	30	53	0	0
13	36872777	.	A	G	15	13	28	0	0	28	0	0
13	36872814	.	A	C	5	0	5	0	1	6	0	0
13	36879965	.	T	C	11	0	11	0	12	23	0	0
13	36879983	.	G	A	11	12	23	0	0	23	0	0
13	36880028	.	A	C	3	0	3	0	1	4	0	0
13	36887746	.	C	A	0	3	3	0	4	7	0	0
13	36887779	.	G	A	0	1	1	0	0	1	0	0
13	36898229	.	G	A	2	1	3	0	0	3	0	0
13	36910378	.	G	A	15	17	32	0	0	32	0	0
13	36910387	.	C	T	14	14	28	0	2	30	0	0
13	36910591	.	A	G	12	10	22	0	2	24	0	0
13	36910729	.	G	C	20	14	34	0	0	34	0	0
13	36911037	.	T	C	16	0	16	0	16	32	0	0
13	36923217	.	A	C	5	4	9	0	0	9	0	0
13	36923228	.	G	C	5	5	10	0	0	10	0	0
13	36926967	.	G	A	1	2	3	0	0	3	0	0
13	36932289	.	G	A	11	8	19	0	0	19	0	0
13	36932356	.	A	G	6	3	9	0	0	9	0	0
13	36932581	.	A	C	2	3	5	0	0	5	0	0
13	36932907	.	G	A	3	4	7	0	0	7	0	0
13	36932912	.	A	G	3	4	7	0	0	7	0	0
13	36932970	.	T	G	2	3	5	0	1	6	0	0
13	36933206	.	C	T	3	4	7	0	0	7	0	0
13	36994954	.	T	G	1	2	3	0	0	3	0	0
13	36995363	.	C	G	2	3	5	0	0	5	0	0
13	36995832	.	G	A	2	3	5	0	0	5	0	0
13	36995873	.	G	T	0	2	2	0	0	2	0	0
13	36995874	.	A	G	0	2	2	0	0	2	0	0
13	36996681	.	C	T	2	3	5	0	0	5	0	0
13	36997170	.	G	T	1	3	4	0	0	4	0	0
13	36997459	.	G	A	0	4	4	0	5	9	0	0
13	37065471	.	C	T	0	1	1	0	0	1	0	0
13	37075528	.	T	A	6	2	8	0	1	9	0	0
13	37075547	.	T	A	6	2	8	0	3	11	0	0
13	37075970	.	A	G	1	5	6	0	0	6	0	0
13	37075986	.	C	G	3	2	5	0	0	5	0	0
13	37076093	.	A	T	5	7	12	0	1	13	0	0
13	37076152	.	A	G	6	6	12	0	1	13	0	0
13	37076269	.	T	C	12	9	21	0	1	22	0	0
13	37076373	.	T	G	12	9	21	0	0	21	0	0
13	37076382	.	C	T	0	9	9	0	15	24	0	0
13	37076415	.	T	C	12	4	16	0	1	17	0	0
13	37076501	.	C	T	5	5	10	0	0	10	0	0
13	37076510	.	C	T	5	2	7	0	1	8	0	0
13	37076710	.	C	T	5	6	11	0	0	11	0	0
13	37076934	.	C	T	7	5	12	0	0	12	0	0
13	37076960	.	A	C	7	4	11	0	0	11	0	0
13	37077127	.	T	C	5	4	9	0	3	12	0	0
13	37077245	.	T	C	9	2	11	0	0	11	0	0
13	37077629	.	T	C	1	2	3	0	0	3	0	0
13	37077829	.	C	A	0	8	8	0	5	13	0	0
13	37077844	.	G	A	2	8	10	0	1	11	0	0
13	37077903	.	A	G	11	8	19	0	2	21	0	0
13	37077961	.	C	T	0	5	5	0	10	15	0	0
13	37078181	.	C	T	0	2	2	0	3	5	0	0
13	37090658	.	A	G	2	3	5	0	0	5	0	0
13	37093324	.	G	A	1	3	4	0	0	4	0	0
13	37103094	.	A	G	1	0	1	0	0	1	0	0
13	37105516	.	C	T	2	2	4	0	0	4	0	0
13	37105799	.	A	T	1	1	2	0	0	2	0	0
13	37108099	.	T	C	0	2	2	0	0	2	0	0
13	37303235	.	A	G	1	6	7	0	0	7	0	0
13	37303316	.	C	T	0	4	4	0	1	5	0	0
13	37303499	.	G	A	4	3	7	0	0	7	0	0
13	37336790	.	T	C	1	2	3	0	0	3	0	0
13	37336792	.	G	T	1	2	3	0	0	3	0	0
13	37421509	.	C	T	0	8	8	0	6	14	0	0
13	37421604	.	A	C	4	14	18	0	4	22	0	0
13	37422417	.	C	T	0	16	16	0	16	32	0	0
13	37425730	.	G	A	0	1	1	0	0	1	0	0
13	37429469	.	G	A	1	1	2	0	0	2	0	0
13	37469396	.	T	C	1	1	2	0	0	2	0	0
13	37469762	.	G	A	4	2	6	0	0	6	0	0
13	37469763	.	C	A	4	2	6	0	0	6	0	0
13	37528544	.	T	C	3	4	7	0	0	7	0	0
13	37528612	.	T	A	3	7	10	0	1	11	0	0
13	37528624	.	T	C	4	0	4	0	6	10	0	0
13	37528793	.	T	G	3	4	7	0	1	8	0	0
13	37532764	.	G	T	2	1	3	0	0	3	0	0
13	37545464	.	T	C	3	0	3	0	1	4	0	0
13	37545480	.	T	C	1	0	1	0	1	2	0	0
13	37586960	.	A	C	1	2	3	0	0	3	0	0
13	37607804	.	A	G	0	1	1	0	0	1	0	0
13	37607807	.	A	T	0	1	1	0	0	1	0	0
13	37653780	.	T	C	10	3	13	0	1	14	0	0
13	37658843	.	G	C	2	4	6	0	0	6	0	0
13	37659192	.	G	A	0	3	3	0	4	7	0	0
13	37659208	.	T	C	3	3	6	0	1	7	0	0
13	37659570	.	C	T	3	7	10	0	0	10	0	0
13	37666322	.	C	T	2	5	7	0	0	7	0	0
13	37671948	.	T	C	2	6	8	0	0	8	0	0
13	37671949	.	T	C	2	6	8	0	0	8	0	0
13	37672082	.	T	G	6	3	9	0	1	10	0	0
13	37672087	.	A	C	6	3	9	0	1	10	0	0
13	37672129	.	G	A	0	8	8	0	9	17	0	0
13	37672133	.	G	A	9	8	17	0	0	17	0	0
13	37672716	.	C	T	12	5	17	0	1	18	0	0
13	37672777	.	A	G	15	5	20	0	0	20	0	0
13	37673230	.	A	T	2	3	5	0	1	6	0	0
13	38304688	.	G	A	9	4	13	0	0	13	0	0
13	38304739	.	C	A	3	7	10	0	1	11	0	0
13	38304791	.	C	A	5	3	8	0	0	8	0	0
13	38304824	.	A	G	3	4	7	0	0	7	0	0
13	39114793	.	A	G	3	2	5	0	0	5	0	0
13	39349323	.	A	G	1	1	2	0	0	2	0	0
13	39349619	.	T	C	2	2	4	0	0	4	0	0
13	39656651	.	A	G	4	3	7	0	0	7	0	0
13	39657068	.	A	G	8	7	15	0	0	15	0	0
13	39657140	.	C	T	0	2	2	0	6	8	0	0
13	39657156	.	T	G	4	3	7	0	0	7	0	0
13	39657285	.	T	C	3	6	9	0	0	9	0	0
13	39657358	.	C	T	1	4	5	0	1	6	0	0
13	39657625	.	A	C	2	6	8	0	0	8	0	0
13	39657652	.	A	G	2	5	7	0	0	7	0	0
13	40352476	.	A	G	7	12	19	0	0	19	0	0
13	40352830	.	A	G	7	5	12	1	0	13	0	0
13	40749104	.	T	C	4	3	7	0	1	8	0	0
13	41289189	.	T	C	1	2	3	0	0	3	0	0
13	41911276	.	T	C	15	5	20	0	0	21	1	0
13	41911474	.	T	C	14	8	22	0	0	22	0	0
13	42400473	.	C	T	8	4	12	0	2	14	0	0
13	42407519	.	C	T	3	5	8	0	1	9	0	0
13	42407526	.	A	G	4	5	9	0	0	9	0	0
13	42407618	.	A	C	2	2	4	0	0	4	0	0
13	42443532	.	T	C	2	1	3	0	0	3	0	0
13	42467430	.	T	C	4	4	8	0	0	8	0	0
13	42469651	.	C	T	2	3	5	0	1	6	0	0
13	42481256	.	A	G	5	7	12	0	1	13	0	0
13	42481575	.	T	C	8	8	16	0	0	16	0	0
13	42485110	.	G	A	5	10	15	0	1	16	0	0
13	42487319	.	T	C	2	1	3	0	0	3	0	0
13	42490775	.	C	T	2	3	5	0	0	5	0	0
13	42500513	.	A	T	0	1	1	0	1	2	0	0
13	42502713	.	T	C	2	1	3	0	0	3	0	0
13	42507075	.	C	T	2	1	3	0	0	3	0	0
13	42513589	.	T	G	0	0	0	0	1	1	0	0
13	42513607	.	G	A	2	0	2	0	0	2	0	0
13	42516915	.	C	G	0	1	1	0	0	1	0	0
13	42524065	.	C	G	0	3	3	0	3	6	0	0
13	42524107	.	C	T	3	2	5	0	0	5	0	0
13	42602533	.	A	T	2	2	4	0	0	4	0	0
13	42606895	.	G	T	1	0	1	0	0	1	0	0
13	42610840	.	A	G	0	0	0	0	2	2	0	0
13	42610900	.	C	T	2	2	4	0	0	4	0	0
13	42615073	.	T	G	2	3	5	0	0	5	0	0
13	42616527	.	C	A	1	3	4	0	0	4	0	0
13	42676516	.	C	A	1	0	1	0	0	1	0	0
13	42678806	.	C	T	9	11	20	0	0	20	0	0
13	42681514	.	G	A	5	2	7	0	1	8	0	0
13	42681759	.	G	T	5	7	12	0	0	12	0	0
13	42691626	.	A	G	9	6	15	0	0	15	0	0
13	42691644	.	G	A	7	6	13	0	0	13	0	0
13	42693028	.	C	T	0	3	3	0	3	6	0	0
13	42693030	.	G	A	3	3	6	0	0	6	0	0
13	43223722	.	T	G	9	9	18	0	1	19	0	0
13	43223961	.	G	A	4	1	5	0	1	6	0	0
13	43226429	.	C	T	0	16	16	0	7	23	0	0
13	43229923	.	G	A	12	14	26	0	0	26	0	0
13	43232179	.	A	G	4	3	7	0	0	7	0	0
13	43232266	.	G	A	7	8	15	0	0	15	0	0
13	43237120	.	A	G	1	4	5	0	0	5	0	0
13	43237153	.	G	A	2	4	6	0	0	6	0	0
13	43238513	.	C	A	5	18	23	0	0	23	0	0
13	43300391	.	T	C	3	3	6	0	0	6	0	0
13	43507468	.	T	C	5	0	5	0	2	7	0	0
13	43507470	.	A	G	5	2	7	0	0	7	0	0
13	43507520	.	A	G	7	2	9	0	0	9	0	0
13	43507541	.	A	G	8	5	13	0	1	14	0	0
13	43507711	.	A	T	11	2	13	0	1	14	0	0
13	43507747	.	A	G	7	5	12	0	2	14	0	0
13	43507797	.	A	C	6	4	10	0	2	12	0	0
13	43507889	.	G	A	13	16	29	0	1	30	0	0
13	43508674	.	A	T	13	11	24	0	0	24	0	0
13	43508696	.	A	G	12	10	22	0	0	22	0	0
13	43508868	.	G	A	14	13	27	0	0	27	0	0
13	43508986	.	A	G	11	7	18	0	0	18	0	0
13	43508987	.	T	A	11	7	18	0	0	18	0	0
13	43509318	.	G	A	15	14	29	0	2	31	0	0
13	43509386	.	G	A	14	16	30	0	3	33	0	0
13	43509443	.	A	T	8	15	23	0	0	23	0	0
13	43509537	.	A	G	10	10	20	0	0	20	0	0
13	43509600	.	T	A	5	14	19	0	3	22	0	0
13	43512320	.	C	T	0	1	1	0	2	3	0	0
13	43512546	.	G	A	1	0	1	0	0	1	0	0
13	43515153	.	G	A	1	1	2	0	1	3	0	0
13	43515168	.	T	A	3	3	6	0	1	7	0	0
13	43637067	.	T	C	1	1	2	0	0	2	0	0
13	43637079	.	A	G	2	1	3	0	0	3	0	0
13	43647035	.	T	C	2	10	12	0	0	12	0	0
13	43650627	.	A	T	2	0	2	0	0	2	0	0
13	43658881	.	G	A	6	10	16	0	2	18	0	0
13	43659018	.	C	T	17	14	31	0	0	31	0	0
13	43659107	.	G	A	0	7	7	0	14	21	0	0
13	43659357	.	G	T	8	8	16	0	1	17	0	0
13	44308161	.	T	C	1	0	1	0	2	3	0	0
13	44702469	.	T	C	10	1	11	0	12	23	0	0
13	44738328	.	G	A	16	11	27	0	5	32	0	0
13	44767765	.	T	C	1	1	2	0	0	2	0	0
13	44772073	.	A	G	2	1	3	0	1	4	0	0
13	44775714	.	G	A	6	5	11	0	0	11	0	0
13	44775895	.	C	T	0	5	5	0	1	6	0	0
13	44779071	.	A	G	3	3	6	0	0	6	0	0
13	44779083	.	A	G	3	2	5	0	0	5	0	0
13	44788217	.	C	T	4	4	8	0	0	8	0	0
13	44788358	.	G	A	7	6	13	0	0	13	0	0
13	44788361	.	T	A	6	6	12	0	1	13	0	0
13	44808582	.	A	C	6	0	6	0	6	12	0	0
13	44842810	.	G	T	2	3	5	0	0	5	0	0
13	44842832	.	C	A	0	2	2	0	3	5	0	0
13	44860837	.	T	A	1	0	1	0	0	1	0	0
13	44888309	.	A	C	6	7	13	0	2	15	0	0
13	45010064	.	A	G	3	7	10	0	0	10	0	0
13	45012835	.	A	T	7	7	14	0	1	15	0	0
13	45015355	.	A	T	19	13	32	0	1	33	0	0
13	45015655	.	T	G	12	19	31	0	3	34	0	0
13	45015776	.	T	C	27	37	64	0	1	65	0	0
13	45016119	.	G	A	27	37	64	0	1	65	0	0
13	45035991	.	A	G	7	8	15	0	1	16	0	0
13	45039294	.	G	A	4	0	4	0	0	4	0	0
13	45039330	.	T	A	1	0	1	0	0	1	0	0
13	45049177	.	A	G	2	2	4	0	0	4	0	0
13	45432170	.	A	G	6	5	11	0	1	12	0	0
13	45434952	.	T	G	2	4	6	0	0	6	0	0
13	45436554	.	A	G	2	1	3	0	0	3	0	0
13	45436561	.	G	T	1	1	2	0	0	2	0	0
13	45468567	.	A	T	14	31	45	0	2	47	0	0
13	45468827	.	G	C	4	1	5	0	8	13	0	0
13	45470601	.	A	G	32	24	56	0	1	57	0	0
13	45470815	.	A	T	24	18	42	0	1	43	0	0
13	45470926	.	G	C	13	12	25	0	1	26	0	0
13	45470983	.	A	G	11	11	22	0	1	23	0	0
13	45471048	.	A	G	10	15	25	0	0	25	0	0
13	45471052	.	A	G	10	17	27	0	0	27	0	0
13	45471086	.	T	A	15	8	23	0	0	23	0	0
13	45471243	.	G	A	21	17	38	0	2	40	0	0
13	45471367	.	A	T	20	17	37	0	2	40	1	0
13	45471475	.	C	A	12	11	23	0	1	24	0	0
13	45471669	.	C	T	26	29	55	0	0	55	0	0
13	45471888	.	C	T	0	15	15	0	13	28	0	0
13	45472124	.	T	G	7	6	13	0	0	13	0	0
13	45472215	.	G	C	7	7	14	0	0	14	0	0
13	45472653	.	G	A	9	13	22	0	1	23	0	0
13	45472924	.	G	A	34	34	68	0	0	68	0	0
13	45472954	.	G	A	31	35	66	0	1	68	1	0
13	45476360	.	A	C	17	8	25	0	0	25	0	0
13	45476711	.	C	T	8	5	13	0	1	14	0	0
13	45476731	.	A	T	2	1	3	0	0	3	0	0
13	45481475	.	G	A	14	10	24	0	1	25	0	0
13	45481703	.	G	T	6	9	15	0	1	16	0	0
13	45481729	.	A	G	9	0	9	0	6	15	0	0
13	45481740	.	A	G	9	4	13	0	2	15	0	0
13	45481792	.	A	G	2	5	7	0	1	8	0	0
13	45494912	.	G	C	13	18	31	0	6	37	0	0
13	45495227	.	C	A	20	17	37	0	0	37	0	0
13	45495442	.	G	T	5	3	8	0	1	9	0	0
13	45495488	.	T	A	1	2	3	0	0	3	0	0
13	45524500	.	T	C	7	9	16	0	0	16	0	0
13	45553072	.	G	A	4	6	10	0	1	11	0	0
13	45565508	.	C	T	4	1	5	0	0	5	0	0
13	45565637	.	G	A	7	4	11	0	1	12	0	0
13	45565646	.	G	A	0	6	6	0	4	10	0	0
13	45570300	.	A	C	4	5	9	0	1	10	0	0
13	45794475	.	C	T	4	3	7	0	0	7	0	0
13	45991772	.	T	C	14	20	34	0	4	38	0	0
13	45991801	.	C	T	12	14	26	0	1	27	0	0
13	45999530	.	G	A	0	17	17	0	13	30	0	0
13	45999723	.	C	T	24	14	38	0	2	40	0	0
13	46000060	.	G	A	0	2	2	0	4	6	0	0
13	46179340	.	C	T	32	32	64	0	1	65	0	0
13	46179387	.	C	T	30	29	59	0	4	63	0	0
13	46179392	.	G	A	31	27	58	0	4	62	0	0
13	46179806	.	T	A	29	23	52	0	4	56	0	0
13	46179814	.	A	G	33	24	57	0	0	57	0	0
13	46298734	.	G	A	5	7	12	0	1	13	0	0
13	46299677	.	G	T	3	6	9	0	0	9	0	0
13	46299812	.	C	T	0	4	4	0	2	6	0	0
13	46299827	.	A	G	2	2	4	0	0	4	0	0
13	46299934	.	G	A	2	2	4	0	0	4	0	0
13	46300224	.	T	A	5	3	8	0	1	9	0	0
13	46300247	.	A	T	6	3	9	0	0	9	0	0
13	46300259	.	T	G	5	3	8	0	0	8	0	0
13	46300421	.	C	T	4	3	7	0	0	7	0	0
13	46300450	.	C	T	2	4	6	0	0	6	0	0
13	46300694	.	T	A	1	4	5	0	0	5	0	0
13	46300737	.	G	A	4	7	11	0	2	13	0	0
13	46343432	.	T	C	1	0	1	0	3	4	0	0
13	46343471	.	G	A	2	3	5	0	1	6	0	0
13	46343486	.	G	A	2	2	4	0	0	4	0	0
13	46356661	.	G	T	0	2	2	0	0	2	0	0
13	46520845	.	T	C	3	3	6	0	0	6	0	0
13	46520924	.	T	C	5	7	12	0	2	14	0	0
13	46521542	.	C	T	0	5	5	0	5	10	0	0
13	46521633	.	G	A	11	4	15	0	2	17	0	0
13	46521762	.	T	A	7	6	13	0	0	13	0	0
13	46686936	.	T	C	2	2	4	0	0	4	0	0
13	46687008	.	C	G	2	2	4	0	0	4	0	0
13	46687037	.	G	T	1	3	4	0	0	4	0	0
13	46687086	.	G	A	1	4	5	0	0	5	0	0
13	46718871	.	A	C	1	3	4	0	2	6	0	0
13	46718930	.	T	C	3	1	4	0	0	4	0	0
13	46771366	.	A	C	3	2	5	0	0	5	0	0
13	46793193	.	G	A	0	1	1	0	1	2	0	0
13	46795515	.	G	A	0	8	8	0	8	16	0	0
13	46831698	.	C	T	0	3	3	0	8	11	0	0
13	46831831	.	A	T	2	5	7	0	2	9	0	0
13	46832084	.	A	G	2	5	7	0	1	8	0	0
13	46832371	.	A	C	1	2	3	0	0	3	0	0
13	46832374	.	T	C	1	2	3	0	0	3	0	0
13	46832449	.	A	T	6	4	10	0	0	10	0	0
13	46832471	.	A	C	6	7	13	0	0	13	0	0
13	46832724	.	C	A	0	11	11	0	5	16	0	0
13	46832981	.	A	T	4	2	6	0	0	6	0	0
13	46833050	.	C	G	1	4	5	0	0	5	0	0
13	46833064	.	C	T	2	3	5	0	0	5	0	0
13	46833197	.	A	G	5	2	7	0	0	7	0	0
13	46834550	.	G	A	5	6	11	0	0	11	0	0
13	46835270	.	C	G	4	2	6	0	0	6	0	0
13	46835304	.	C	T	5	3	8	0	0	8	0	0
13	46844205	.	G	A	2	3	5	0	0	5	0	0
13	46864873	.	C	A	0	1	1	0	2	3	0	0
13	46935014	.	T	G	2	4	6	0	0	6	0	0
13	46935089	.	C	T	1	1	2	0	0	2	0	0
13	46988299	.	C	T	8	16	24	0	1	25	0	0
13	46988390	.	T	C	12	0	12	0	14	26	0	0
13	46988457	.	C	A	0	2	2	0	0	2	0	0
13	46988561	.	A	G	2	6	8	0	0	8	0	0
13	46988588	.	A	G	7	18	25	0	0	25	0	0
13	46988638	.	T	G	4	11	15	0	0	15	0	0
13	46989607	.	C	T	0	7	7	0	8	15	0	0
13	47030991	.	T	C	1	0	1	0	0	1	0	0
13	47031125	.	C	A	0	1	1	0	1	2	0	0
13	47099900	.	A	T	1	0	1	0	0	1	0	0
13	47146860	.	C	T	2	1	3	0	0	3	0	0
13	47683807	.	T	C	0	1	1	0	0	1	0	0
13	47689478	.	A	C	2	2	4	0	0	4	0	0
13	47690269	.	A	T	4	3	7	0	0	7	0	0
13	47690300	.	A	T	2	3	5	0	0	5	0	0
13	47690383	.	C	G	2	2	4	0	0	4	0	0
13	47690434	.	A	G	2	2	4	0	0	4	0	0
13	47691316	.	G	A	2	1	3	0	1	4	0	0
13	47691328	.	T	C	2	2	4	0	0	4	0	0
13	47714064	.	T	C	0	1	1	0	0	1	0	0
13	47723765	.	C	T	1	1	2	0	0	2	0	0
13	47723778	.	A	G	0	0	0	0	1	1	0	0
13	47751748	.	T	A	1	1	2	0	0	2	0	0
13	47751953	.	C	T	1	2	3	0	0	3	0	0
13	47751989	.	T	G	2	2	4	0	0	4	0	0
13	47752592	.	G	A	2	2	4	0	0	4	0	0
13	47831531	.	T	C	1	0	1	0	0	1	0	0
13	47834276	.	C	A	1	2	3	0	0	3	0	0
13	47835638	.	G	T	2	0	2	0	0	2	0	0
13	47838024	.	G	A	4	8	12	0	1	13	0	0
13	47838052	.	G	A	0	7	7	0	5	12	0	0
13	47838650	.	G	C	2	1	3	0	1	4	0	0
13	47839071	.	C	T	5	6	11	0	0	11	0	0
13	47839119	.	A	T	3	7	10	0	1	11	0	0
13	48747857	.	T	C	5	2	7	0	0	7	0	0
13	48747876	.	T	C	3	1	4	0	1	5	0	0
13	48748637	.	A	G	1	2	3	0	1	4	0	0
13	48748722	.	A	G	4	4	8	0	0	8	0	0
13	48755035	.	A	G	1	2	3	0	0	3	0	0
13	48755122	.	T	C	0	1	1	0	0	1	0	0
13	48758725	.	T	C	3	0	3	0	2	5	0	0
13	48758775	.	T	C	1	0	1	0	3	4	0	0
13	48759038	.	T	C	2	3	5	0	0	5	0	0
13	48760628	.	C	T	0	2	2	0	2	4	0	0
13	48760634	.	G	T	2	2	4	0	0	4	0	0
13	48766270	.	C	T	5	3	8	0	0	8	0	0
13	49153904	.	T	C	2	5	7	0	0	7	0	0
13	49153938	.	G	A	4	3	7	0	0	7	0	0
13	49154048	.	G	A	10	9	19	0	0	19	0	0
13	49154631	.	T	C	13	0	13	0	16	29	0	0
13	49158734	.	G	A	1	6	7	0	0	7	0	0
13	49167185	.	T	G	5	3	8	0	0	8	0	0
13	49167195	.	C	T	5	3	8	0	0	8	0	0
13	49169071	.	A	T	1	3	4	0	0	4	0	0
13	49169121	.	G	C	2	3	5	0	0	5	0	0
13	49443721	.	C	T	15	20	35	0	0	35	0	0
13	49443868	.	T	C	20	1	21	0	21	42	0	0
13	49444090	.	C	T	18	24	42	0	1	43	0	0
13	49444177	.	C	A	0	31	31	0	10	41	0	0
13	49444224	.	G	A	14	25	39	0	1	40	0	0
13	49444446	.	C	A	16	15	31	0	2	33	0	0
13	49543145	.	A	T	1	3	4	0	2	6	0	0
13	49544641	.	T	C	1	5	6	0	1	7	0	0
13	49544833	.	C	T	14	20	34	0	1	35	0	0
13	49544873	.	T	A	18	17	35	0	2	37	0	0
13	49544973	.	G	T	15	28	43	0	1	44	0	0
13	49545039	.	A	G	3	7	10	0	0	10	0	0
13	49585341	.	T	A	16	11	27	0	0	27	0	0
13	49585344	.	A	T	14	12	26	0	2	28	0	0
13	49585384	.	T	G	6	3	9	0	0	9	0	0
13	49597297	.	C	T	0	4	4	0	9	13	0	0
13	49599521	.	G	A	0	1	1	0	0	1	0	0
13	49609268	.	C	T	2	3	5	0	0	5	0	0
13	49612336	.	C	T	1	2	3	0	0	3	0	0
13	49636115	.	G	T	0	2	2	0	0	2	0	0
13	49666565	.	T	C	1	1	2	0	0	2	0	0
13	49727448	.	A	G	3	2	5	0	0	5	0	0
13	49727463	.	T	G	3	5	8	0	0	8	0	0
13	49727548	.	A	G	0	4	4	0	0	4	0	0
13	49727550	.	A	G	0	3	3	0	1	4	0	0
13	49765713	.	G	T	0	0	0	0	3	3	0	0
13	49765806	.	C	T	2	3	5	0	1	6	0	0
13	49765815	.	G	T	0	4	4	0	2	6	0	0
13	49765896	.	T	C	3	4	7	0	1	8	0	0
13	49766022	.	T	C	1	6	7	0	0	7	0	0
13	49766268	.	G	A	0	6	6	0	4	10	0	0
13	49767539	.	A	G	7	6	13	0	3	16	0	0
13	49767570	.	G	A	11	8	19	0	0	19	0	0
13	49767736	.	T	G	3	9	12	0	0	12	0	0
13	49767806	.	T	A	6	3	9	0	1	10	0	0
13	49767807	.	G	T	6	4	10	0	0	10	0	0
13	49767953	.	T	A	3	4	7	0	3	10	0	0
13	49768095	.	A	G	8	12	20	0	1	21	0	0
13	49768207	.	C	T	6	3	9	0	1	10	0	0
13	49768401	.	C	T	7	13	20	0	1	21	0	0
13	49768402	.	A	C	7	13	20	0	1	21	0	0
13	49768592	.	A	T	4	7	11	0	1	12	0	0
13	49768646	.	A	G	5	2	7	0	1	8	0	0
13	49769060	.	C	T	11	10	21	0	1	22	0	0
13	49769141	.	G	C	4	9	13	0	1	14	0	0
13	49769274	.	G	A	0	4	4	0	6	10	0	0
13	49774860	.	A	C	0	0	0	0	3	3	0	0
13	49774893	.	G	T	4	4	8	0	1	9	0	0
13	49775018	.	T	G	4	9	13	0	1	14	0	0
13	49775075	.	T	G	3	3	6	0	1	7	0	0
13	49785412	.	C	T	6	5	11	0	0	11	0	0
13	49785417	.	T	C	6	5	11	0	0	11	0	0
13	49785455	.	C	G	5	1	6	0	0	6	0	0
13	49785456	.	A	G	5	1	6	0	0	6	0	0
13	49788102	.	A	T	2	2	4	0	0	4	0	0
13	49802010	.	C	A	1	1	2	0	0	2	0	0
13	49802025	.	T	G	1	1	2	0	0	2	0	0
13	49818982	.	A	G	2	6	8	0	0	8	0	0
13	49819001	.	C	A	0	7	7	0	3	10	0	0
13	49819019	.	A	G	5	11	16	0	0	16	0	0
13	49898458	.	G	T	1	2	3	0	0	3	0	0
13	49907480	.	A	G	4	4	8	0	0	8	0	0
13	49907549	.	C	T	0	1	1	0	0	1	0	0
13	49915580	.	A	G	1	3	4	0	0	4	0	0
13	49917748	.	T	C	1	2	3	0	0	3	0	0
13	49922904	.	A	G	4	2	6	0	0	6	0	0
13	49922970	.	C	T	0	3	3	0	2	5	0	0
13	49923570	.	G	T	3	3	6	0	0	6	0	0
13	49923678	.	C	A	1	1	2	0	0	2	0	0
13	49931689	.	C	T	0	2	2	0	1	3	0	0
13	49940894	.	C	A	1	2	3	0	0	3	0	0
13	49940936	.	C	T	0	2	2	0	1	3	0	0
13	50169004	.	C	T	6	7	13	0	4	17	0	0
13	50670846	.	A	T	9	5	14	0	0	14	0	0
13	50670911	.	G	C	7	4	11	0	0	11	0	0
13	50672297	.	T	C	1	0	1	0	7	8	0	0
13	51140665	.	A	G	18	13	31	0	0	31	0	0
13	51140782	.	A	G	8	3	11	0	0	11	0	0
13	51147152	.	G	A	7	5	12	0	1	13	0	0
13	51147164	.	A	G	5	3	8	0	0	8	0	0
13	51162561	.	A	G	2	1	3	0	0	3	0	0
13	51162579	.	T	G	2	1	3	0	0	3	0	0
13	51169874	.	C	G	6	3	9	0	0	9	0	0
13	51520086	.	C	T	3	2	5	0	0	5	0	0
13	51520197	.	G	A	1	3	4	0	0	4	0	0
13	51526839	.	G	A	3	2	5	0	0	5	0	0
13	51580096	.	G	T	1	8	9	0	6	15	0	0
13	51580105	.	T	C	6	10	16	0	1	17	0	0
13	51582507	.	T	G	5	4	9	0	0	9	0	0
13	51583019	.	C	A	4	7	11	0	0	11	0	0
13	51583043	.	T	C	6	9	15	0	0	15	0	0
13	51583130	.	A	G	9	3	12	0	9	21	0	0
13	51719661	.	G	C	2	2	4	0	0	4	0	0
13	51719767	.	A	C	4	7	11	0	0	11	0	0
13	51719850	.	G	A	0	7	7	0	7	14	0	0
13	51720057	.	T	C	4	7	11	0	0	11	0	0
13	51720126	.	C	A	4	4	8	0	0	8	0	0
13	51720291	.	A	G	6	0	6	0	8	14	0	0
13	51720993	.	G	C	0	12	12	0	5	17	0	0
13	51721143	.	T	C	10	10	20	0	0	20	0	0
13	51728520	.	G	A	4	6	10	0	1	11	0	0
13	51728597	.	A	G	10	0	10	0	4	14	0	0
13	51728782	.	C	G	9	6	15	0	1	16	0	0
13	51728902	.	A	C	13	7	20	0	0	20	0	0
13	51728937	.	A	G	8	9	17	0	2	19	0	0
13	51878368	.	A	T	2	1	3	0	0	3	0	0
13	51893777	.	A	T	12	8	20	0	2	22	0	0
13	51893807	.	C	T	15	9	24	0	0	24	0	0
13	51893951	.	G	T	29	11	40	1	7	48	0	0
13	51894134	.	T	A	7	4	11	0	1	12	0	0
13	51894143	.	C	G	8	0	8	0	1	9	0	0
13	51894204	.	C	T	14	15	29	0	4	33	0	0
13	51894215	.	A	G	15	19	34	0	2	36	0	0
13	51894264	.	C	T	2	13	15	0	20	35	0	0
13	51898991	.	C	G	2	1	3	0	0	3	0	0
13	51899138	.	C	T	0	14	14	0	19	33	0	0
13	51899707	.	C	T	8	5	13	0	0	13	0	0
13	51903040	.	A	G	3	2	5	0	1	6	0	0
13	51909851	.	G	T	2	2	4	0	0	4	0	0
13	51909876	.	A	G	1	2	3	0	0	3	0	0
13	51956414	.	T	C	5	5	10	0	0	10	0	0
13	51956418	.	G	A	5	5	10	0	0	10	0	0
13	51961780	.	T	C	5	5	10	0	0	10	0	0
13	51962017	.	G	T	7	2	9	0	1	10	0	0
13	51962211	.	C	T	8	8	16	0	0	16	0	0
13	51962754	.	G	A	0	7	7	0	10	17	0	0
13	51962802	.	G	A	11	6	17	0	0	17	0	0
13	51962836	.	A	G	4	1	5	0	4	11	2	0
13	51962892	.	C	A	10	8	18	0	2	20	0	0
13	51962961	.	C	G	9	11	20	0	0	21	1	0
13	51963039	.	C	T	1	3	4	0	0	4	0	0
13	51963071	.	T	C	5	6	11	0	0	11	0	0
13	51963383	.	C	T	6	10	16	0	2	18	0	0
13	51967129	.	C	T	0	3	3	0	3	6	0	0
13	51967149	.	T	C	3	1	4	0	4	8	0	0
13	51967259	.	G	A	4	4	8	0	0	8	0	0
13	51969156	.	G	A	1	3	4	0	0	4	0	0
13	51969219	.	A	G	4	5	9	0	1	10	0	0
13	52013908	.	T	A	8	4	12	0	0	12	0	0
14	469321	.	T	C	1	0	1	0	7	8	0	0
14	938503	.	T	C	2	3	5	0	1	6	0	0
14	938638	.	T	C	1	3	4	0	0	4	0	0
14	1119225	.	C	T	1	4	5	0	1	6	0	0
14	1597072	.	T	C	3	2	5	0	0	5	0	0
14	1888624	.	T	C	0	0	0	0	38	38	0	0
14	1889644	.	T	C	7	3	10	2	0	12	0	0
14	2205747	.	A	G	2	2	4	0	0	4	0	0
14	2206272	.	G	A	1	3	4	0	0	4	0	0
14	2220101	.	C	T	1	2	3	0	0	3	0	0
14	2351565	.	A	T	1	7	8	0	0	8	0	0
14	2351566	.	G	T	1	7	8	0	0	8	0	0
14	2356447	.	G	A	1	1	2	0	0	2	0	0
14	2356450	.	G	A	1	1	2	0	0	2	0	0
14	2360116	.	T	A	4	10	14	0	0	14	0	0
14	2558920	.	A	G	4	2	6	0	1	7	0	0
14	3576236	.	C	T	3	2	5	0	0	5	0	0
14	4290631	.	A	G	5	3	8	0	0	8	0	0
14	4807695	.	A	G	1	0	1	0	2	3	0	0
14	5588315	.	A	T	1	2	3	0	0	3	0	0
14	6214744	.	G	A	1	4	5	0	0	5	0	0
14	6624558	.	A	G	14	0	14	0	10	24	0	0
14	6624621	.	A	G	6	20	26	0	2	29	1	0
14	6625002	.	A	C	3	15	18	4	1	23	0	0
14	6625521	.	G	C	12	37	49	0	1	50	0	0
14	7051250	.	C	T	1	5	6	0	0	6	0	0
14	7916773	.	A	G	20	4	24	0	0	24	0	0
14	7965330	.	G	T	5	2	7	0	0	7	0	0
14	8264562	.	T	C	0	9	9	0	0	9	0	0
14	8495668	.	A	T	0	6	6	1	1	8	0	0
14	8496257	.	A	G	4	2	6	1	2	9	0	0
14	8569740	.	A	G	4	2	6	0	0	6	0	0
14	8570277	.	G	A	0	4	4	0	0	4	0	0
14	8571942	.	A	G	3	0	3	0	3	6	0	0
14	8770425	.	A	G	5	5	10	0	0	10	0	0
14	8770436	.	A	C	8	4	12	0	0	12	0	0
14	8770589	.	C	T	5	7	12	0	0	12	0	0
14	8770931	.	T	A	3	4	7	0	1	8	0	0
14	8806477	.	G	A	0	2	2	0	1	3	0	0
14	8806481	.	G	A	0	2	2	0	1	3	0	0
14	8806587	.	A	C	6	0	6	0	6	12	0	0
14	8806590	.	A	G	6	4	10	0	1	11	0	0
14	8806680	.	T	C	14	6	20	0	1	21	0	0
14	8806722	.	A	G	8	3	11	0	0	11	0	0
14	8806730	.	G	T	6	3	9	0	0	9	0	0
14	8809693	.	A	G	4	7	11	0	5	16	0	0
14	8816113	.	T	C	6	4	10	0	0	10	0	0
14	8816135	.	A	T	5	7	12	0	2	14	0	0
14	8816194	.	C	T	10	12	22	0	0	22	0	0
14	8816261	.	G	A	9	10	19	0	1	20	0	0
14	8816283	.	T	G	8	5	13	0	0	13	0	0
14	8816339	.	A	G	5	4	9	0	1	10	0	0
14	8816457	.	A	G	5	8	13	0	0	13	0	0
14	8816482	.	A	T	5	8	13	0	0	13	0	0
14	8816755	.	A	C	12	0	12	0	5	17	0	0
14	8816782	.	G	A	13	3	16	0	0	16	0	0
14	8816848	.	A	G	9	6	15	0	0	15	0	0
14	8816877	.	C	A	0	2	2	0	10	12	0	0
14	8819082	.	T	C	2	0	2	0	2	4	0	0
14	8830302	.	C	T	0	1	1	0	0	1	0	0
14	8832736	.	A	C	1	0	1	0	0	1	0	0
14	8836160	.	G	A	2	3	5	0	1	6	0	0
14	8836298	.	T	C	1	1	2	0	0	2	0	0
14	8841352	.	A	T	6	11	17	0	0	17	0	0
14	8860664	.	A	G	3	2	5	0	0	5	0	0
14	8860702	.	G	A	2	2	4	0	0	4	0	0
14	8868956	.	C	T	0	1	1	0	0	1	0	0
14	8947464	.	A	T	6	6	12	0	1	13	0	0
14	8947497	.	C	A	6	7	13	0	0	13	0	0
14	8982390	.	C	T	6	6	12	0	0	12	0	0
14	8991718	.	A	T	0	3	3	0	0	3	0	0
14	8991823	.	T	C	8	9	17	0	1	18	0	0
14	9001411	.	G	A	4	11	15	0	0	15	0	0
14	9001426	.	C	T	7	15	22	0	1	23	0	0
14	9001752	.	C	G	3	0	3	0	13	16	0	0
14	9001875	.	T	C	10	10	20	0	1	21	0	0
14	9033783	.	G	A	6	5	11	0	0	11	0	0
14	9034161	.	C	T	3	3	6	0	0	6	0	0
14	9034701	.	C	T	1	5	6	0	3	9	0	0
14	9034742	.	C	T	4	3	7	0	2	9	0	0
14	9034743	.	T	C	4	1	5	0	4	9	0	0
14	9034932	.	A	G	8	8	16	0	1	17	0	0
14	9035100	.	C	T	5	8	13	0	0	13	0	0
14	9035110	.	C	T	0	6	6	0	10	16	0	0
14	9035175	.	G	A	7	2	9	0	1	10	0	0
14	9035249	.	G	T	2	4	6	0	0	6	0	0
14	9035541	.	C	T	0	5	5	0	2	7	0	0
14	9035740	.	A	G	8	7	15	0	0	15	0	0
14	9035786	.	C	G	6	4	10	0	0	10	0	0
14	9035866	.	A	G	10	4	14	0	0	14	0	0
14	9035873	.	T	C	10	4	14	0	0	14	0	0
14	9036323	.	T	G	1	2	3	0	0	3	0	0
14	9036480	.	C	T	3	4	7	0	1	8	0	0
14	9036530	.	C	T	4	3	7	0	0	7	0	0
14	9036624	.	C	T	4	4	8	0	0	8	0	0
14	9050440	.	G	C	4	0	4	0	3	7	0	0
14	9142412	.	A	T	14	5	19	0	0	19	0	0
14	9142602	.	A	T	18	29	47	0	1	48	0	0
14	9142795	.	T	C	15	11	26	0	1	27	0	0
14	9142893	.	T	C	21	1	22	0	17	40	1	0
14	9142911	.	T	C	21	1	22	0	15	37	0	0
14	9142952	.	C	T	1	14	15	0	16	31	0	0
14	9143081	.	G	C	24	0	24	0	22	46	0	0
14	9143179	.	C	T	3	13	16	2	13	31	0	0
14	9143427	.	A	T	20	26	46	0	0	46	0	0
14	9143446	.	T	C	17	1	18	0	16	34	0	0
14	9143878	.	T	C	14	16	30	0	3	33	0	0
14	9144099	.	T	C	12	24	36	0	4	40	0	0
14	9144191	.	A	G	15	8	23	0	4	27	0	0
14	9144248	.	A	G	5	13	18	0	1	19	0	0
14	9144361	.	A	G	7	7	14	0	0	14	0	0
14	9144658	.	A	G	8	9	17	0	0	17	0	0
14	9145050	.	G	A	9	7	16	0	0	16	0	0
14	9157880	.	T	A	3	1	4	0	0	4	0	0
14	9159845	.	A	G	11	14	25	0	0	25	0	0
14	9159860	.	G	C	10	0	10	0	11	21	0	0
14	9163286	.	G	A	13	13	26	0	0	26	0	0
14	9173909	.	C	T	0	3	3	0	0	3	0	0
14	9177619	.	G	A	11	8	19	0	2	21	0	0
14	9344247	.	G	A	3	5	8	0	0	8	0	0
14	9344250	.	C	T	3	5	8	0	2	10	0	0
14	9344366	.	T	G	5	5	10	0	0	10	0	0
14	9405178	.	A	G	1	3	4	0	0	4	0	0
14	9405383	.	T	C	1	1	2	0	3	5	0	0
14	9405570	.	T	A	6	6	12	0	0	12	0	0
14	9405571	.	G	C	6	6	12	0	0	12	0	0
14	9405728	.	G	C	7	0	7	0	11	18	0	0
14	9405760	.	T	C	2	10	12	0	0	12	0	0
14	9405927	.	C	T	3	4	7	0	2	9	0	0
14	9405940	.	A	C	5	4	9	0	0	9	0	0
14	9406320	.	T	C	11	0	11	0	4	15	0	0
14	9406453	.	A	T	4	3	7	0	0	7	0	0
14	9406485	.	A	G	2	7	9	0	0	9	0	0
14	9406509	.	T	C	0	11	11	0	1	12	0	0
14	9406607	.	T	C	6	7	13	0	0	13	0	0
14	9406773	.	T	A	3	5	8	0	1	9	0	0
14	9406791	.	A	G	5	10	15	0	0	15	0	0
14	9407707	.	C	T	5	5	10	0	0	10	0	0
14	9407763	.	A	G	4	3	7	0	0	7	0	0
14	9408260	.	C	G	3	5	8	0	0	8	0	0
14	9420810	.	G	A	0	3	3	0	0	3	0	0
14	9420871	.	C	A	3	4	7	0	0	7	0	0
14	9421583	.	A	G	1	3	4	0	0	4	0	0
14	9421608	.	C	A	2	3	5	0	0	5	0	0
14	9469559	.	T	C	2	3	5	0	0	5	0	0
14	9481647	.	C	A	0	2	2	0	0	2	0	0
14	9481924	.	C	T	3	6	9	0	1	10	0	0
14	9481926	.	G	T	3	7	10	0	0	10	0	0
14	9482062	.	A	G	2	5	7	0	1	8	0	0
14	9485121	.	A	T	2	4	6	0	0	6	0	0
14	9485366	.	T	A	1	1	2	0	0	2	0	0
14	9494939	.	A	G	2	0	2	0	2	4	0	0
14	9495107	.	G	A	0	4	4	0	5	9	0	0
14	9498163	.	C	T	5	9	14	0	2	16	0	0
14	9498308	.	G	A	5	5	10	0	1	11	0	0
14	9498570	.	C	T	6	4	10	0	0	10	0	0
14	9498728	.	A	T	4	3	7	0	0	7	0	0
14	9498841	.	C	G	7	8	15	0	1	16	0	0
14	9498879	.	T	A	10	9	19	0	1	20	0	0
14	9499048	.	G	T	9	7	16	0	1	17	0	0
14	9508186	.	T	C	1	2	3	0	0	3	0	0
14	9516565	.	C	T	1	2	3	0	0	3	0	0
14	9522061	.	C	T	1	2	3	0	0	3	0	0
14	9522284	.	G	C	1	0	1	0	2	3	0	0
14	9587639	.	A	G	2	2	4	0	0	4	0	0
14	9588102	.	T	A	3	2	5	0	1	6	0	0
14	9588210	.	G	A	0	2	2	0	1	3	0	0
14	9588221	.	G	C	1	3	4	0	0	4	0	0
14	9589028	.	T	C	1	3	4	0	0	4	0	0
14	9593273	.	T	A	9	2	11	0	0	11	0	0
14	9593505	.	A	G	27	10	37	0	2	40	1	0
14	9593610	.	T	A	19	15	34	0	0	34	0	0
14	9593622	.	A	T	18	16	34	0	0	34	0	0
14	9593974	.	C	T	25	8	33	0	3	36	0	0
14	9594466	.	G	A	11	7	18	0	0	18	0	0
14	9594577	.	C	T	13	7	20	0	0	20	0	0
14	9594578	.	A	G	13	7	20	0	0	20	0	0
14	9594623	.	C	T	13	10	23	0	0	23	0	0
14	9594677	.	G	C	6	11	17	0	0	17	0	0
14	9595086	.	A	C	12	6	18	0	0	18	0	0
14	9595119	.	G	A	9	14	23	0	0	23	0	0
14	9595330	.	T	C	8	11	19	0	2	21	0	0
14	9595593	.	T	G	2	12	14	0	0	14	0	0
14	9595890	.	C	T	4	12	16	0	0	16	0	0
14	9596338	.	C	T	10	8	18	0	1	19	0	0
14	9717978	.	C	A	0	8	8	0	7	15	0	0
14	9739987	.	G	T	2	3	5	0	0	5	0	0
14	10338507	.	G	C	7	5	12	0	1	13	0	0
14	10338670	.	G	A	4	2	6	0	1	7	0	0
14	10338763	.	G	T	1	2	3	0	0	3	0	0
14	10338942	.	A	G	4	6	10	0	0	10	0	0
14	10339032	.	G	A	4	6	10	0	0	10	0	0
14	10339081	.	T	G	5	5	10	0	1	11	0	0
14	10339325	.	T	G	5	4	9	0	0	9	0	0
14	10339333	.	T	G	6	3	9	0	0	9	0	0
14	10339883	.	A	C	10	13	23	0	5	28	0	0
14	10339943	.	A	G	12	9	21	0	1	22	0	0
14	10340068	.	G	A	8	11	19	0	0	19	0	0
14	10340096	.	G	A	10	9	19	0	2	21	0	0
14	10340189	.	T	A	8	6	14	0	0	14	0	0
14	10340193	.	C	G	9	5	14	0	0	14	0	0
14	10340250	.	A	T	8	6	14	0	0	14	0	0
14	10340288	.	C	A	7	8	15	0	1	16	0	0
14	10340358	.	G	A	9	11	20	0	0	20	0	0
14	10340606	.	A	G	16	9	25	0	1	26	0	0
14	10340840	.	C	A	18	7	25	0	1	26	0	0
14	10341237	.	A	T	7	5	12	0	0	12	0	0
14	10341586	.	C	T	0	7	7	0	12	19	0	0
14	10341627	.	A	T	8	9	17	0	0	17	0	0
14	10341690	.	G	T	9	8	17	0	0	17	0	0
14	10341703	.	T	C	8	0	8	0	9	17	0	0
14	10341966	.	A	C	13	7	20	0	0	20	0	0
14	10342246	.	G	T	7	6	13	0	0	13	0	0
14	10342379	.	A	C	4	0	4	0	10	14	0	0
14	10342570	.	G	A	5	7	12	0	0	12	0	0
14	10342591	.	C	A	0	7	7	0	5	12	0	0
14	10342825	.	G	C	2	6	8	0	2	10	0	0
14	10342843	.	C	T	0	6	6	0	4	10	0	0
14	10342926	.	G	A	8	2	10	0	1	11	0	0
14	10342929	.	T	A	7	2	9	0	1	10	0	0
14	10342971	.	G	T	9	6	15	0	1	16	0	0
14	10343112	.	C	T	2	2	4	0	0	4	0	0
14	10343232	.	T	C	2	3	5	0	1	6	0	0
14	10343266	.	C	A	0	2	2	0	3	5	0	0
14	10343678	.	A	T	3	9	12	0	0	12	0	0
14	10343686	.	T	C	2	0	2	0	10	12	0	0
14	10344075	.	C	A	10	4	14	0	0	14	0	0
14	10344218	.	G	A	3	3	6	0	1	7	0	0
14	10344451	.	C	T	2	1	3	0	0	3	0	0
14	10348091	.	T	C	5	3	8	0	0	8	0	0
14	10356522	.	A	G	3	2	5	0	0	5	0	0
14	10356817	.	A	C	2	1	3	0	5	8	0	0
14	10356826	.	G	C	2	7	9	0	0	9	0	0
14	10365369	.	A	T	1	1	2	0	0	2	0	0
14	10374674	.	T	G	3	2	5	0	0	5	0	0
14	10374709	.	T	A	4	2	6	0	0	6	0	0
14	10374716	.	G	T	3	2	5	0	0	5	0	0
14	10379652	.	G	A	1	0	1	0	0	1	0	0
14	10384529	.	C	T	1	1	2	0	2	4	0	0
14	11048599	.	A	G	3	2	5	0	1	6	0	0
14	11053934	.	G	C	1	2	3	0	0	3	0	0
14	11069560	.	C	T	7	5	12	0	1	13	0	0
14	11069593	.	C	T	4	10	14	0	0	14	0	0
14	11069774	.	G	A	8	2	10	0	0	10	0	0
14	11261691	.	C	T	4	3	7	0	0	7	0	0
14	11261718	.	T	C	4	2	6	0	0	6	0	0
14	11262084	.	T	C	2	8	10	0	0	10	0	0
14	11262733	.	C	T	1	6	7	0	0	7	0	0
14	11263017	.	A	G	3	0	3	0	4	7	0	0
14	11263084	.	C	G	5	4	9	0	0	9	0	0
14	11263096	.	C	A	3	4	7	0	0	7	0	0
14	11263147	.	G	A	0	3	3	0	2	5	0	0
14	11263479	.	T	A	3	8	11	0	1	12	0	0
14	11264058	.	C	T	3	4	7	0	0	7	0	0
14	11264726	.	A	T	9	8	17	0	3	20	0	0
14	11265310	.	A	G	6	4	10	0	0	10	0	0
14	11265312	.	T	C	6	4	10	0	0	10	0	0
14	11265567	.	C	T	5	5	10	0	0	10	0	0
14	11266436	.	C	T	1	3	4	0	0	4	0	0
14	11266644	.	A	T	9	5	14	0	0	14	0	0
14	11267900	.	A	T	15	13	28	0	1	29	0	0
14	11268145	.	G	A	5	4	9	0	0	9	0	0
14	11268224	.	A	T	2	3	5	0	0	5	0	0
14	11299563	.	G	A	0	3	3	0	1	4	0	0
14	11300058	.	T	C	3	4	7	0	0	7	0	0
14	11300154	.	G	A	4	3	7	0	0	7	0	0
14	11300179	.	T	G	4	3	7	0	0	7	0	0
14	11300238	.	G	A	4	3	7	0	1	8	0	0
14	11300298	.	C	T	4	4	8	0	0	8	0	0
14	11301027	.	G	A	7	8	15	0	1	16	0	0
14	11301069	.	A	G	15	1	16	0	12	28	0	0
14	11302190	.	C	A	9	13	22	0	2	24	0	0
14	11302492	.	G	A	2	2	4	0	0	4	0	0
14	11302565	.	T	A	4	3	7	0	0	7	0	0
14	11302662	.	C	A	1	3	4	0	0	4	0	0
14	11302829	.	T	A	1	4	5	0	0	5	0	0
14	11303025	.	A	G	2	0	2	0	3	5	0	0
14	11303157	.	A	C	2	4	6	0	0	6	0	0
14	11303819	.	T	G	1	3	4	0	1	5	0	0
14	11303867	.	G	T	1	3	4	0	0	4	0	0
14	11979548	.	A	G	3	1	4	0	0	4	0	0
14	12021366	.	T	C	7	5	12	0	0	12	0	0
14	12021550	.	T	C	3	5	8	0	1	9	0	0
14	12021610	.	T	G	1	2	3	0	0	3	0	0
14	12021926	.	A	T	3	3	6	0	0	6	0	0
14	12022056	.	C	T	4	3	7	0	1	8	0	0
14	12036538	.	C	G	2	3	5	0	1	6	0	0
14	12036731	.	A	G	4	6	10	0	1	11	0	0
14	12036768	.	A	C	2	0	2	0	4	6	0	0
14	12050577	.	T	C	0	2	2	0	1	3	0	0
14	12050868	.	A	C	1	0	1	0	5	6	0	0
14	12069754	.	C	T	8	8	16	0	0	16	0	0
14	12071446	.	A	G	8	8	16	0	1	17	0	0
14	12077109	.	C	T	2	5	7	0	0	7	0	0
14	12085165	.	T	C	3	9	12	0	0	12	0	0
14	12085267	.	G	A	3	4	7	0	0	7	0	0
14	12089512	.	G	T	6	4	10	0	0	10	0	0
14	12099566	.	G	T	2	1	3	0	0	3	0	0
14	12099605	.	T	G	3	2	5	0	0	5	0	0
14	12111019	.	C	T	1	3	4	0	0	4	0	0
14	12157456	.	C	T	2	4	6	0	0	6	0	0
14	12159384	.	C	G	5	5	10	0	0	10	0	0
14	12162692	.	C	T	12	4	16	0	0	16	0	0
14	12162731	.	A	C	22	10	32	0	1	33	0	0
14	12164364	.	C	A	8	5	13	0	1	14	0	0
14	12166656	.	A	G	21	25	46	0	1	47	0	0
14	12166956	.	C	T	18	19	37	0	1	38	0	0
14	12166974	.	A	G	22	17	39	0	1	40	0	0
14	12167321	.	T	A	20	25	45	0	0	45	0	0
14	12167615	.	G	A	0	11	11	0	17	28	0	0
14	12167670	.	C	T	9	8	17	0	0	17	0	0
14	12167679	.	A	T	9	6	15	0	0	15	0	0
14	12175964	.	T	A	1	2	3	0	0	3	0	0
14	12189019	.	T	C	0	2	2	0	0	2	0	0
14	12191579	.	T	A	4	3	7	0	0	7	0	0
14	12191615	.	A	G	1	1	2	0	0	2	0	0
14	12195119	.	T	A	1	0	1	0	0	1	0	0
14	12205329	.	T	C	9	4	13	0	1	14	0	0
14	12205521	.	C	T	12	4	16	0	0	18	2	0
14	12205566	.	T	C	9	7	16	0	2	18	0	0
14	12428324	.	G	T	3	1	4	0	1	5	0	0
14	12429901	.	A	G	1	2	3	0	0	3	0	0
14	12452477	.	C	T	4	5	9	0	1	10	0	0
14	12452516	.	G	A	0	4	4	0	4	8	0	0
14	12465519	.	C	A	1	6	7	0	1	8	0	0
14	12472233	.	C	T	10	10	20	0	1	21	0	0
14	12473599	.	T	A	3	2	5	0	2	7	0	0
14	12473932	.	T	C	7	3	10	0	1	11	0	0
14	12473992	.	A	T	2	2	4	0	0	4	0	0
14	12474159	.	T	C	4	5	9	0	0	9	0	0
14	12481591	.	C	T	2	6	8	0	0	8	0	0
14	12481600	.	T	C	2	6	8	0	0	8	0	0
14	12535403	.	T	G	24	15	39	0	2	41	0	0
14	12535568	.	A	G	24	6	30	0	2	32	0	0
14	12535622	.	G	T	21	11	32	0	1	33	0	0
14	12535775	.	G	T	8	14	22	0	2	24	0	0
14	12535901	.	A	G	7	7	14	0	0	14	0	0
14	12536229	.	G	A	11	12	23	0	0	23	0	0
14	12536420	.	T	G	7	7	14	0	0	14	0	0
14	12636012	.	A	T	3	2	5	0	0	5	0	0
14	12837003	.	C	T	6	5	11	0	1	12	0	0
14	12837079	.	A	G	5	13	18	0	0	18	0	0
14	12837120	.	G	A	1	6	7	0	0	7	0	0
14	12837130	.	A	C	1	0	1	0	2	3	0	0
14	13524092	.	A	G	1	0	1	0	0	1	0	0
14	13525082	.	A	G	4	4	8	0	2	10	0	0
14	14094032	.	C	T	1	4	5	0	0	5	0	0
14	14225233	.	C	G	2	6	8	0	1	9	0	0
14	14315233	.	C	T	5	3	8	0	2	10	0	0
14	14502450	.	C	T	3	2	5	0	0	5	0	0
14	14502708	.	T	C	10	6	16	0	0	16	0	0
14	14502846	.	C	T	7	6	13	0	2	15	0	0
14	14502885	.	C	T	7	9	16	0	0	16	0	0
14	14532450	.	T	C	20	16	36	0	0	36	0	0
14	14532696	.	T	G	20	13	33	0	0	33	0	0
14	14532831	.	A	G	9	8	17	0	1	18	0	0
14	14534219	.	G	A	7	17	24	0	1	25	0	0
14	14582432	.	A	G	3	2	5	0	0	5	0	0
14	14593109	.	T	C	2	3	5	0	1	6	0	0
14	14593175	.	T	C	1	5	6	0	0	6	0	0
14	14593889	.	G	A	9	3	12	0	0	12	0	0
14	14594453	.	C	T	1	2	3	0	0	3	0	0
14	14595152	.	C	T	5	2	7	0	0	7	0	0
14	14595535	.	A	G	2	3	5	0	0	5	0	0
14	14595576	.	T	G	4	5	9	0	0	9	0	0
14	14595695	.	A	C	5	6	11	0	0	11	0	0
14	14595734	.	C	G	2	3	5	0	0	5	0	0
14	14595803	.	C	A	4	3	7	0	0	7	0	0
14	14596121	.	T	G	2	10	12	0	0	12	0	0
14	14596176	.	T	C	3	4	7	0	0	7	0	0
14	14604525	.	G	A	0	1	1	0	0	1	0	0
14	14622414	.	A	C	1	2	3	0	0	3	0	0
14	14662597	.	A	T	14	8	22	0	1	23	0	0
14	14662606	.	A	G	15	9	24	0	1	25	0	0
14	14662663	.	C	T	7	11	18	0	2	20	0	0
14	14662684	.	C	T	5	7	12	0	1	13	0	0
14	14664974	.	T	C	3	0	3	0	0	3	0	0
14	14664998	.	G	A	5	3	8	0	1	9	0	0
14	14665175	.	T	C	15	9	24	0	1	25	0	0
14	14665229	.	A	G	15	6	21	0	0	21	0	0
14	14665270	.	T	G	6	6	12	0	0	12	0	0
14	14665432	.	A	G	6	7	13	0	1	14	0	0
14	14665502	.	C	G	11	9	20	0	0	20	0	0
14	14666173	.	A	T	7	9	16	0	2	18	0	0
14	14666394	.	G	A	10	15	25	0	1	26	0	0
14	14690710	.	G	T	6	11	17	0	0	17	0	0
14	14690831	.	C	A	6	9	15	0	0	15	0	0
14	14690837	.	G	A	5	7	12	0	0	12	0	0
14	14694930	.	A	G	3	3	6	0	1	7	0	0
14	14695136	.	A	G	9	16	25	0	1	26	0	0
14	14695181	.	A	G	8	11	19	0	0	19	0	0
14	14695428	.	C	T	0	4	4	2	8	14	0	0
14	14695864	.	T	C	12	0	12	0	14	26	0	0
14	14722530	.	A	T	7	8	15	0	0	15	0	0
14	14722556	.	T	C	8	6	14	0	1	15	0	0
14	14722929	.	G	A	7	6	13	0	0	13	0	0
14	14723381	.	A	T	3	6	9	0	0	9	0	0
14	14723410	.	G	T	3	3	6	0	0	6	0	0
14	14724026	.	C	T	2	2	4	0	0	4	0	0
14	14724951	.	G	A	13	26	39	0	3	42	0	0
14	14724953	.	A	G	19	19	38	0	4	42	0	0
14	14724987	.	G	A	18	21	39	0	1	40	0	0
14	14725132	.	A	T	17	6	23	0	6	29	0	0
14	14725142	.	G	A	7	7	14	0	17	31	0	0
14	14725314	.	G	A	19	31	50	0	1	51	0	0
14	14728192	.	G	T	15	6	21	0	0	21	0	0
14	14729069	.	G	A	23	27	50	0	0	50	0	0
14	14739116	.	T	C	5	7	12	0	0	12	0	0
14	14836656	.	T	C	4	0	4	0	0	4	0	0
14	14837729	.	A	C	1	0	1	0	0	1	0	0
14	14844346	.	A	C	2	4	6	0	0	6	0	0
14	14845532	.	G	A	0	2	2	0	3	5	0	0
14	14854654	.	G	A	0	3	3	0	4	7	0	0
14	14855017	.	T	C	5	2	7	0	0	7	0	0
14	14855456	.	C	T	4	3	7	0	0	7	0	0
14	15086220	.	G	A	3	2	5	0	0	5	0	0
14	15087088	.	C	T	0	1	1	0	0	1	0	0
14	15662731	.	G	A	2	8	10	0	0	10	0	0
14	15662795	.	G	C	1	8	9	0	0	9	0	0
14	15662836	.	A	T	3	7	10	0	1	11	0	0
14	15663014	.	C	T	4	7	11	0	0	11	0	0
14	15663053	.	T	A	8	4	12	0	0	12	0	0
14	15663174	.	T	C	1	3	4	0	0	4	0	0
14	15663237	.	T	C	4	2	6	0	0	6	0	0
14	15663730	.	C	G	11	4	15	0	0	15	0	0
14	15663766	.	T	A	4	2	6	0	1	7	0	0
14	15663925	.	C	T	0	2	2	0	3	5	0	0
14	15664251	.	T	A	7	12	19	0	1	20	0	0
14	15664263	.	T	C	8	9	17	0	4	21	0	0
14	15664494	.	T	C	4	2	6	0	0	6	0	0
14	15664942	.	T	C	1	0	1	0	2	3	0	0
14	15677882	.	C	T	1	4	5	0	0	5	0	0
14	15677907	.	A	G	2	3	5	0	0	5	0	0
14	15678291	.	A	G	6	4	10	0	1	11	0	0
14	15678362	.	G	A	2	3	5	0	0	5	0	0
14	15678444	.	A	G	1	2	3	0	0	3	0	0
14	15678447	.	A	T	1	2	3	0	0	3	0	0
14	15808004	.	C	A	1	0	1	0	0	1	0	0
14	15812577	.	A	G	2	6	8	0	1	9	0	0
14	15812685	.	C	T	4	5	9	0	0	9	0	0
14	15812732	.	A	C	3	2	5	0	0	5	0	0
14	15812947	.	G	T	1	2	3	0	0	3	0	0
14	15813702	.	G	T	6	7	13	0	0	13	0	0
14	15813985	.	G	A	0	3	3	0	1	4	0	0
14	15814770	.	C	T	4	4	8	0	0	8	0	0
14	15814887	.	T	G	1	3	4	0	1	5	0	0
14	15972435	.	C	A	6	3	9	0	1	10	0	0
14	15972491	.	T	A	0	5	5	0	0	5	0	0
14	15972666	.	G	A	5	4	9	0	2	11	0	0
14	15973920	.	G	A	5	5	10	0	0	10	0	0
14	15973981	.	C	A	4	6	10	0	1	11	0	0
14	15974188	.	T	A	2	3	5	0	0	5	0	0
14	15974232	.	G	A	4	3	7	0	0	7	0	0
14	15974313	.	A	G	2	4	6	0	1	7	0	0
14	15983792	.	G	A	1	1	2	0	0	2	0	0
14	15983824	.	C	A	0	1	1	0	1	2	0	0
14	16042530	.	C	A	3	3	6	0	0	6	0	0
14	16069264	.	A	C	2	4	6	0	0	6	0	0
14	16069449	.	T	A	0	2	2	0	2	4	0	0
14	16084339	.	C	T	3	8	11	0	0	11	0	0
14	16090261	.	C	T	6	11	17	0	1	18	0	0
14	16090764	.	T	C	7	12	19	0	0	19	0	0
14	16090939	.	A	C	11	7	18	0	0	18	0	0
14	16091586	.	T	A	10	14	24	0	0	25	1	0
14	16091709	.	T	G	6	8	14	0	0	14	0	0
14	16091765	.	T	C	5	4	9	0	0	9	0	0
14	16093983	.	G	A	15	15	30	0	4	34	0	0
14	16095683	.	A	G	10	8	18	0	0	18	0	0
14	16115353	.	A	G	1	2	3	0	0	3	0	0
14	16122866	.	T	C	13	18	31	0	3	34	0	0
14	16122913	.	G	A	1	21	22	0	14	36	0	0
14	16127308	.	C	T	1	0	1	0	0	1	0	0
14	16127346	.	G	T	4	10	14	0	1	15	0	0
14	16127362	.	C	A	1	12	13	0	5	18	0	0
14	16130167	.	C	G	2	0	2	0	0	2	0	0
14	16145112	.	T	A	2	1	3	0	0	3	0	0
14	16208059	.	T	G	1	6	7	0	0	7	0	0
14	16383196	.	G	A	3	3	6	0	0	6	0	0
14	16435150	.	G	A	7	9	16	0	0	16	0	0
14	16484577	.	G	A	8	3	11	0	1	12	0	0
14	16484633	.	G	T	5	3	8	0	0	8	0	0
14	16484763	.	C	T	0	8	8	0	4	12	0	0
14	16485222	.	C	T	0	8	8	0	2	10	0	0
14	16606649	.	C	A	1	3	4	0	7	11	0	0
14	16754060	.	C	T	0	1	1	0	0	1	0	0
14	16754192	.	A	C	3	3	6	0	0	6	0	0
14	16769067	.	A	G	14	14	28	0	1	29	0	0
14	16769109	.	T	C	12	15	27	0	0	27	0	0
14	16769189	.	C	T	6	17	23	0	1	24	0	0
14	16769246	.	C	T	17	10	27	0	1	28	0	0
14	16769550	.	A	G	2	0	2	0	3	5	0	0
14	16770338	.	T	A	9	8	17	0	1	18	0	0
14	16770646	.	C	A	15	9	24	0	1	25	0	0
14	16770847	.	C	T	10	16	26	0	1	27	0	0
14	16770959	.	T	A	7	6	13	0	0	13	0	0
14	16771194	.	A	T	5	3	8	0	0	8	0	0
14	16771265	.	A	T	8	8	16	0	0	16	0	0
14	16771339	.	T	C	9	5	14	0	0	14	0	0
14	16771340	.	A	G	8	0	8	0	6	14	0	0
14	16777829	.	T	C	1	2	3	0	0	3	0	0
14	16777865	.	A	G	2	2	4	0	1	5	0	0
14	16803880	.	A	G	0	0	0	0	1	1	0	0
14	16968260	.	C	T	2	6	8	0	0	8	0	0
14	16968302	.	T	C	4	0	4	0	0	4	0	0
14	17003333	.	G	A	10	2	12	0	2	14	0	0
14	17003628	.	G	A	0	1	1	0	0	1	0	0
14	17016521	.	G	A	4	2	6	0	0	6	0	0
14	17016650	.	C	T	1	1	2	0	0	2	0	0
14	17025353	.	G	C	1	3	4	0	0	4	0	0
14	17025388	.	A	T	1	2	3	0	0	3	0	0
14	17025472	.	T	A	6	5	11	0	0	11	0	0
14	17025574	.	A	G	9	3	12	0	1	13	0	0
14	17025586	.	C	T	5	5	10	0	0	11	1	0
14	17025807	.	T	C	7	5	12	0	1	13	0	0
14	17025960	.	A	T	6	7	13	0	1	14	0	0
14	17026001	.	A	G	2	1	3	0	0	3	0	0
14	17026103	.	G	A	10	4	14	0	0	14	0	0
14	17026534	.	G	A	4	7	11	0	0	11	0	0
14	17026550	.	C	T	6	8	14	0	1	15	0	0
14	17026724	.	T	C	11	13	24	0	1	25	0	0
14	17026840	.	T	C	7	10	17	0	1	18	0	0
14	17197240	.	A	C	1	0	1	0	0	1	0	0
14	17198928	.	A	G	10	9	19	0	1	20	0	0
14	17198953	.	G	A	8	8	16	0	3	19	0	0
14	17198988	.	T	G	3	8	11	1	1	13	0	0
14	17199349	.	C	T	10	14	24	0	1	25	0	0
14	17199990	.	A	G	15	21	36	0	0	36	0	0
14	17200159	.	C	T	9	10	19	0	0	19	0	0
14	17200174	.	G	T	0	10	10	0	12	22	0	0
14	17200407	.	C	A	6	12	18	0	0	18	0	0
14	17200482	.	T	C	12	12	24	0	1	25	0	0
14	17200653	.	A	C	10	14	24	0	0	24	0	0
14	17230387	.	C	T	0	2	2	0	3	5	0	0
14	17233541	.	C	T	2	2	4	0	0	4	0	0
14	17240569	.	G	T	1	4	5	0	0	5	0	0
14	17240587	.	A	G	0	3	3	0	0	3	0	0
14	17266013	.	A	T	6	10	16	0	0	16	0	0
14	17275609	.	T	A	2	0	2	0	0	2	0	0
14	17275708	.	C	G	5	5	10	0	0	10	0	0
14	17278972	.	C	T	8	3	11	0	0	11	0	0
14	17279305	.	T	C	5	0	5	0	0	5	0	0
14	17281713	.	G	A	1	2	3	0	1	4	0	0
14	17281727	.	C	G	1	2	3	0	1	4	0	0
14	17281818	.	T	C	4	5	9	0	1	10	0	0
14	17281831	.	G	A	4	4	8	0	0	8	0	0
14	17282058	.	G	A	1	3	4	0	0	4	0	0
14	17282061	.	C	T	1	3	4	0	0	4	0	0
14	17282095	.	C	G	2	4	6	0	0	6	0	0
14	17282100	.	C	T	0	4	4	0	4	8	0	0
14	17329967	.	A	T	1	2	3	0	0	3	0	0
14	17347911	.	T	C	2	1	3	0	0	3	0	0
14	17347920	.	G	A	0	2	2	0	2	4	0	0
14	17349069	.	G	C	4	3	7	0	0	7	0	0
14	17349464	.	T	C	5	7	12	0	1	13	0	0
14	17349472	.	C	T	4	8	12	0	2	14	0	0
14	17349639	.	T	C	5	3	8	0	1	9	0	0
14	17350799	.	T	G	1	0	1	0	3	4	0	0
14	17350804	.	A	T	1	2	3	0	0	3	0	0
14	17447733	.	G	T	1	2	3	0	0	3	0	0
14	17568072	.	T	A	3	3	6	0	0	6	0	0
14	17568099	.	A	G	5	5	10	0	1	11	0	0
14	17572743	.	T	C	2	0	2	0	0	2	0	0
14	17575834	.	C	G	2	7	9	0	0	9	0	0
14	17575868	.	G	A	2	6	8	0	1	9	0	0
14	17575872	.	C	T	2	7	9	0	0	9	0	0
14	17580662	.	G	A	10	12	22	0	0	22	0	0
14	17580917	.	G	A	26	21	47	0	5	52	0	0
14	17580922	.	C	A	32	18	50	0	1	51	0	0
14	17581036	.	C	A	17	19	36	0	1	37	0	0
14	17586527	.	A	G	10	11	21	0	1	22	0	0
14	17586693	.	G	A	0	4	4	0	0	4	0	0
14	17588131	.	G	T	9	9	18	0	2	21	1	0
14	17593654	.	T	A	5	3	8	0	0	8	0	0
14	17593685	.	G	C	7	5	12	0	0	12	0	0
14	17593767	.	A	T	10	12	22	0	1	23	0	0
14	17593783	.	T	A	9	13	22	0	0	22	0	0
14	17593803	.	A	T	8	16	24	0	1	25	0	0
14	17593823	.	A	T	11	14	25	0	0	25	0	0
14	17593992	.	T	A	6	8	14	0	1	15	0	0
14	17594137	.	G	A	3	4	7	0	1	8	0	0
14	17594365	.	A	C	4	2	6	0	0	6	0	0
14	17594556	.	C	T	5	7	12	0	0	12	0	0
14	17595063	.	G	A	4	2	6	0	1	7	0	0
14	17595121	.	G	A	6	2	8	0	0	8	0	0
14	17595264	.	T	A	5	9	14	0	1	15	0	0
14	18667559	.	T	C	15	18	33	0	1	34	0	0
14	18667852	.	T	C	7	22	29	0	2	31	0	0
14	18668731	.	A	G	6	3	9	0	0	9	0	0
14	18669481	.	C	A	10	15	25	0	1	26	0	0
14	18670446	.	C	T	12	6	18	0	0	18	0	0
14	18670582	.	T	A	10	14	24	0	3	27	0	0
14	18670665	.	A	G	8	6	14	1	0	15	0	0
14	18671011	.	A	T	5	11	16	0	0	16	0	0
14	18672233	.	G	A	2	3	5	0	0	5	0	0
14	18672491	.	C	T	7	9	16	0	1	17	0	0
14	19258995	.	C	T	4	4	8	0	2	10	0	0
14	19259292	.	A	G	10	3	13	0	1	14	0	0
14	19260261	.	A	G	5	14	19	0	6	25	0	0
14	19261044	.	C	T	15	17	32	0	3	35	0	0
14	20159151	.	T	C	3	5	8	0	1	9	0	0
14	20188941	.	G	A	0	14	14	0	11	25	0	0
14	20189180	.	T	C	13	11	24	0	0	24	0	0
14	20189188	.	G	A	12	11	23	0	0	23	0	0
14	20189339	.	T	A	3	5	8	0	0	8	0	0
14	20190023	.	A	C	12	5	17	0	0	17	0	0
14	20190297	.	C	G	14	23	37	0	4	41	0	0
14	20190494	.	G	T	0	11	11	0	19	30	0	0
14	20190532	.	G	A	22	10	32	0	4	36	0	0
14	20342750	.	C	T	1	2	3	0	0	3	0	0
14	20703272	.	A	G	1	0	1	0	0	1	0	0
14	20706109	.	A	C	1	2	3	0	0	3	0	0
14	20728633	.	A	G	2	2	4	0	0	4	0	0
14	20730865	.	T	A	0	3	3	0	1	4	0	0
14	20730907	.	T	A	1	3	4	0	0	4	0	0
14	20730958	.	A	T	2	2	4	0	0	4	0	0
14	20731633	.	A	T	3	3	6	0	1	7	0	0
14	20731656	.	T	A	5	3	8	0	2	10	0	0
14	20731675	.	A	T	6	4	10	0	0	10	0	0
14	20731756	.	G	A	3	3	6	0	0	6	0	0
14	20731797	.	C	T	3	3	6	0	0	6	0	0
14	20732426	.	T	C	2	4	6	0	0	6	0	0
14	20732457	.	T	C	1	4	5	0	1	6	0	0
14	20732546	.	G	C	3	4	7	0	0	7	0	0
14	20732793	.	A	T	0	4	4	0	0	4	0	0
14	20733160	.	A	G	2	4	6	0	0	6	0	0
14	20733188	.	A	G	1	6	7	0	0	7	0	0
14	20733285	.	G	A	1	3	4	0	0	4	0	0
14	20733486	.	T	C	5	3	8	0	0	8	0	0
14	20734382	.	T	G	1	2	3	0	0	3	0	0
14	20734823	.	A	G	2	8	10	0	0	10	0	0
14	20734827	.	G	A	2	7	9	0	0	9	0	0
14	20735034	.	T	A	5	0	5	0	0	5	0	0
14	20735042	.	T	A	5	1	6	0	0	6	0	0
14	20735084	.	C	G	2	4	6	0	0	6	0	0
14	20735388	.	T	G	10	9	19	0	2	21	0	0
14	20735481	.	T	C	8	13	21	0	1	22	0	0
14	20735525	.	T	A	6	3	9	0	0	9	0	0
14	20735626	.	G	T	6	4	10	0	1	11	0	0
14	20735841	.	A	G	10	0	10	0	12	22	0	0
14	20736251	.	A	G	10	12	22	0	1	23	0	0
14	20736829	.	A	G	3	0	3	0	7	10	0	0
14	20869833	.	G	A	0	2	2	0	0	2	0	0
14	20869866	.	C	A	0	5	5	0	0	5	0	0
14	20869943	.	T	C	2	0	2	0	9	11	0	0
14	20869949	.	G	A	2	9	11	0	0	11	0	0
14	20870141	.	G	T	6	9	15	0	0	15	0	0
14	20870153	.	A	G	4	8	12	0	1	13	0	0
14	20870257	.	A	G	7	3	10	0	1	11	0	0
14	20870321	.	G	T	2	3	5	0	1	6	0	0
14	20891506	.	G	A	1	2	3	0	0	3	0	0
14	20891638	.	A	C	1	3	4	0	0	4	0	0
14	20896049	.	T	G	2	0	2	0	2	4	0	0
14	20896058	.	C	T	2	3	5	0	0	5	0	0
14	20988121	.	T	C	2	2	4	0	0	4	0	0
14	20994005	.	T	C	1	2	3	0	0	3	0	0
14	20994047	.	A	G	1	0	1	0	3	4	0	0
14	20994051	.	G	A	0	3	3	0	1	4	0	0
14	20994493	.	G	A	0	2	2	0	2	4	0	0
14	20994695	.	G	A	1	5	6	1	2	9	0	0
14	20994967	.	T	C	2	4	6	0	0	6	0	0
14	20999918	.	C	T	1	2	3	0	1	4	0	0
14	21000109	.	T	C	1	4	5	0	0	5	0	0
14	21000170	.	C	G	6	12	18	0	0	18	0	0
14	21000193	.	T	C	7	8	15	0	4	19	0	0
14	21000256	.	C	A	1	5	6	0	0	6	0	0
14	21000257	.	A	G	1	5	6	0	0	6	0	0
14	21067455	.	G	A	10	5	15	0	0	15	0	0
14	21067935	.	A	G	3	11	14	0	0	14	0	0
14	21067938	.	T	C	2	8	10	0	2	12	0	0
14	21071965	.	T	C	1	0	1	0	0	1	0	0
14	21072037	.	G	A	7	10	17	0	1	18	0	0
14	21072729	.	A	G	4	6	10	0	0	10	0	0
14	21072792	.	C	T	3	12	15	0	0	15	0	0
14	21072834	.	C	T	2	3	5	0	0	5	0	0
14	21079991	.	A	T	2	3	5	0	0	5	0	0
14	21087521	.	C	A	5	4	9	0	0	9	0	0
14	21090848	.	A	C	5	0	5	0	4	9	0	0
14	21098305	.	A	G	2	1	3	0	0	3	0	0
14	21098316	.	A	C	2	1	3	0	0	3	0	0
14	21124321	.	T	C	5	12	17	0	0	17	0	0
14	21124360	.	G	T	9	8	17	0	0	17	0	0
14	21129362	.	T	G	0	2	2	0	0	2	0	0
14	21129629	.	G	T	1	0	1	0	0	1	0	0
14	21132180	.	G	A	5	4	9	0	0	9	0	0
14	21159943	.	T	G	8	0	8	0	4	12	0	0
14	21159949	.	A	T	8	4	12	0	0	12	0	0
14	21183865	.	G	A	6	8	14	0	1	15	0	0
14	21183910	.	A	G	2	2	4	0	1	5	0	0
14	21187563	.	C	T	6	14	20	0	0	20	0	0
14	21187631	.	C	T	11	11	22	0	0	22	0	0
14	21195795	.	C	T	5	10	15	0	1	16	0	0
14	21198328	.	A	C	13	29	42	0	1	43	0	0
14	21198349	.	T	A	9	17	26	0	6	32	0	0
14	21198391	.	A	C	10	11	21	0	0	21	0	0
14	21198403	.	T	C	13	14	27	0	1	28	0	0
14	21198689	.	T	A	12	12	24	0	1	25	0	0
14	21198818	.	C	T	14	16	30	0	2	32	0	0
14	21199092	.	G	T	9	6	15	0	3	18	0	0
14	21204542	.	G	A	4	2	6	0	0	6	0	0
14	21204553	.	T	A	3	3	6	0	0	6	0	0
14	21204814	.	T	A	5	10	15	0	0	15	0	0
14	21205297	.	T	C	6	7	13	0	0	13	0	0
14	21205429	.	T	C	8	0	8	0	17	25	0	0
14	21205471	.	G	A	11	16	27	0	2	29	0	0
14	21205623	.	G	T	13	6	19	0	3	22	0	0
14	21211802	.	A	C	1	1	2	0	0	2	0	0
14	21211859	.	T	A	3	8	11	0	1	12	0	0
14	21219450	.	A	G	4	5	9	0	0	9	0	0
14	21237963	.	T	C	1	2	3	0	0	3	0	0
14	21238759	.	T	C	12	0	12	0	3	15	0	0
14	21238782	.	T	A	7	7	14	0	1	15	0	0
14	21241695	.	G	A	0	13	13	0	12	25	0	0
14	21241870	.	T	A	3	3	6	0	0	6	0	0
14	21241899	.	A	G	6	4	10	0	1	11	0	0
14	21242082	.	T	A	8	7	15	0	0	15	0	0
14	21242148	.	C	T	5	6	11	0	2	13	0	0
14	21245050	.	T	G	5	3	8	0	0	8	0	0
14	21245142	.	C	T	4	3	7	0	0	7	0	0
14	21245180	.	T	G	4	2	6	0	0	6	0	0
14	21245315	.	G	T	2	5	7	0	0	7	0	0
14	21245506	.	A	G	2	1	3	0	0	3	0	0
14	21245513	.	A	T	2	2	4	0	0	4	0	0
14	21245545	.	G	A	0	4	4	0	1	5	0	0
14	21245657	.	A	C	3	4	7	0	0	7	0	0
14	21332964	.	G	A	23	31	54	0	3	57	0	0
14	21333795	.	G	A	31	35	66	0	2	68	0	0
14	21333867	.	C	A	4	26	30	0	32	62	0	0
14	21333957	.	G	A	35	37	72	0	1	73	0	0
14	21334257	.	G	T	25	27	52	0	0	52	0	0
14	21334338	.	A	G	21	39	60	0	1	61	0	0
14	21334840	.	G	C	28	20	48	0	4	52	0	0
14	21334968	.	G	A	28	19	47	0	0	47	0	0
14	21334985	.	G	T	24	11	35	0	4	39	0	0
14	21597044	.	A	G	17	12	29	0	4	33	0	0
14	21597140	.	C	A	29	16	45	0	3	48	0	0
14	21597264	.	G	A	20	20	40	0	2	42	0	0
14	21597363	.	A	G	26	12	38	0	1	39	0	0
14	21597451	.	T	C	7	7	14	0	0	14	0	0
14	21597469	.	T	C	4	6	10	0	1	11	0	0
14	21597671	.	T	C	7	7	14	0	0	14	0	0
14	21597730	.	C	T	18	15	33	0	1	34	0	0
14	21597755	.	T	A	18	12	30	0	1	31	0	0
14	21597814	.	C	T	21	10	31	0	2	33	0	0
14	21598035	.	C	T	18	11	29	0	4	33	0	0
14	21598354	.	T	C	13	0	13	0	14	27	0	0
14	21598372	.	G	A	11	14	25	0	1	26	0	0
14	21598402	.	C	A	8	15	23	0	0	23	0	0
14	21598488	.	C	T	18	13	31	0	0	31	0	0
14	21598724	.	T	G	16	15	31	0	3	34	0	0
14	21598831	.	G	T	25	21	46	0	2	48	0	0
14	21603294	.	G	C	27	16	43	0	2	45	0	0
14	21603335	.	A	G	26	11	37	0	1	38	0	0
14	21609707	.	A	G	15	7	22	0	1	23	0	0
14	21609733	.	A	G	26	16	42	0	0	42	0	0
14	21617939	.	G	A	12	7	19	0	0	19	0	0
14	21617947	.	G	C	11	8	19	0	0	19	0	0
14	21623128	.	A	T	7	15	22	0	0	22	0	0
14	21623324	.	C	T	8	4	12	0	0	12	0	0
14	21630153	.	A	G	9	8	17	0	0	17	0	0
14	21636953	.	G	A	7	11	18	0	0	18	0	0
14	21636965	.	A	G	7	11	18	0	0	18	0	0
14	21639583	.	A	G	2	0	2	0	0	2	0	0
14	21643550	.	T	C	0	2	2	0	0	2	0	0
14	21643647	.	T	A	4	6	10	0	1	11	0	0
14	21646110	.	G	A	8	8	16	0	0	16	0	0
14	21652399	.	G	T	1	1	2	0	0	2	0	0
14	21654600	.	G	A	3	6	9	0	1	10	0	0
14	21654748	.	G	C	2	5	7	0	0	7	0	0
14	21654808	.	A	G	1	3	4	0	0	4	0	0
14	21655086	.	C	T	0	6	6	0	3	9	0	0
14	21655177	.	T	C	1	3	4	0	0	4	0	0
14	21655533	.	T	C	1	6	7	0	0	7	0	0
14	21656452	.	C	G	3	2	5	0	0	5	0	0
14	21660484	.	A	G	4	2	6	0	1	7	0	0
14	21689852	.	C	T	8	3	11	0	2	13	0	0
14	21693251	.	G	A	0	3	3	0	1	4	0	0
14	21693584	.	T	G	33	29	62	0	0	62	0	0
14	21745784	.	G	A	3	4	7	0	0	7	0	0
14	21745871	.	C	A	1	2	3	0	3	6	0	0
14	21745879	.	A	T	1	5	6	0	0	6	0	0
14	21745917	.	G	C	1	3	4	0	0	4	0	0
14	21745977	.	C	T	3	3	6	0	0	6	0	0
14	21745982	.	C	A	3	3	6	0	0	6	0	0
14	21746076	.	C	T	2	2	4	0	0	4	0	0
14	21746096	.	A	T	2	2	4	0	0	4	0	0
14	21746226	.	T	G	3	3	6	0	0	6	0	0
14	21746255	.	G	C	3	3	6	0	0	6	0	0
14	21750970	.	C	T	3	5	8	0	0	8	0	0
14	21768244	.	G	A	0	5	5	0	4	9	0	0
14	21768418	.	G	A	1	1	2	0	0	2	0	0
14	21770666	.	C	G	3	3	6	0	0	6	0	0
14	21772412	.	C	T	4	5	9	0	1	10	0	0
14	21779102	.	C	T	3	7	10	0	0	10	0	0
14	21779141	.	G	A	1	2	3	0	4	7	0	0
14	21779241	.	G	A	7	11	18	0	0	18	0	0
14	21779518	.	C	T	5	4	9	0	0	9	0	0
14	21779551	.	A	G	4	2	6	0	0	6	0	0
14	21779975	.	C	A	5	6	11	0	1	12	0	0
14	21779977	.	G	A	7	5	12	0	0	12	0	0
14	21780206	.	A	G	8	9	17	0	1	18	0	0
14	21780274	.	A	C	6	9	15	0	2	17	0	0
14	21780321	.	T	C	4	4	8	0	0	8	0	0
14	21790748	.	C	T	3	2	5	0	0	5	0	0
14	21801383	.	G	A	4	11	15	0	0	15	0	0
14	21804912	.	T	C	11	5	16	0	0	16	0	0
14	21806190	.	C	T	4	8	12	0	0	12	0	0
14	21806196	.	G	C	0	8	8	0	4	12	0	0
14	21813696	.	G	A	10	7	17	0	0	17	0	0
14	21816388	.	T	C	14	10	24	0	2	26	0	0
14	21834912	.	C	T	6	5	11	0	0	11	0	0
14	21838379	.	T	C	4	3	7	0	0	7	0	0
14	21842804	.	T	C	19	16	35	0	1	36	0	0
14	21843726	.	G	A	0	7	7	0	14	21	0	0
14	21844187	.	T	A	10	13	23	0	2	25	0	0
14	21844486	.	C	T	4	9	13	0	0	13	0	0
14	21924382	.	A	G	0	3	3	0	0	3	0	0
14	21924547	.	G	A	3	2	5	0	0	5	0	0
14	22012883	.	G	A	1	2	3	0	0	3	0	0
14	22104906	.	T	C	4	1	5	0	0	5	0	0
14	22108215	.	C	T	9	12	21	0	0	21	0	0
14	22132510	.	A	T	9	7	16	0	5	21	0	0
14	22132536	.	A	T	4	8	12	0	0	12	0	0
14	22134069	.	G	A	9	7	16	0	1	17	0	0
14	22139160	.	T	C	2	4	6	0	1	7	0	0
14	22139194	.	C	T	12	16	28	0	1	29	0	0
14	22139254	.	G	A	29	21	50	0	2	52	0	0
14	22139308	.	C	T	21	33	54	0	2	56	0	0
14	22139358	.	G	A	33	20	53	0	1	54	0	0
14	22139392	.	G	T	28	24	52	0	0	52	0	0
14	22139668	.	G	A	2	29	31	0	27	58	0	0
14	22139816	.	G	A	1	24	25	0	27	52	0	0
14	22140150	.	G	A	5	4	9	0	0	9	0	0
14	22140158	.	T	C	4	4	8	0	0	8	0	0
14	22140417	.	T	C	7	7	14	0	1	15	0	0
14	22140542	.	G	A	9	3	12	0	1	13	0	0
14	22145661	.	G	C	4	0	4	0	9	13	0	0
14	22151827	.	A	T	7	11	18	0	0	18	0	0
14	22151913	.	C	T	8	12	20	0	0	20	0	0
14	22151958	.	T	A	11	11	22	0	0	22	0	0
14	22151966	.	A	C	8	10	18	0	1	19	0	0
14	22152004	.	T	G	2	3	5	0	0	5	0	0
14	22172138	.	C	T	11	16	27	0	4	31	0	0
14	22249344	.	G	A	4	8	12	0	1	13	0	0
14	22254184	.	T	C	11	9	20	0	0	20	0	0
14	22272340	.	G	A	21	17	38	0	3	41	0	0
14	22272351	.	G	A	22	18	40	0	0	40	0	0
14	22272749	.	A	G	21	0	21	0	15	36	0	0
14	22366550	.	C	T	1	2	3	0	0	3	0	0
14	22367871	.	T	C	2	0	2	0	2	4	0	0
14	22421001	.	G	T	0	1	1	0	1	2	0	0
14	22431765	.	G	A	4	2	6	0	0	6	0	0
14	22432004	.	G	A	0	2	2	0	0	2	0	0
14	22437413	.	G	T	0	1	1	0	0	1	0	0
14	22438924	.	A	G	2	3	5	0	0	5	0	0
14	22439183	.	C	G	2	6	8	0	0	8	0	0
14	22439210	.	G	T	1	4	5	0	1	6	0	0
14	22439258	.	G	T	2	2	4	0	0	4	0	0
14	22439347	.	G	T	3	1	4	0	0	4	0	0
14	22439350	.	C	T	3	2	5	0	0	5	0	0
14	22439455	.	A	T	1	3	4	0	0	4	0	0
14	22439516	.	A	G	2	4	6	0	0	6	0	0
14	22440022	.	A	G	1	3	4	0	0	4	0	0
14	22440063	.	C	A	1	1	2	0	0	2	0	0
14	22440520	.	C	A	1	2	3	0	0	3	0	0
14	22440528	.	G	A	1	2	3	0	0	3	0	0
14	22440918	.	G	A	1	3	4	0	0	4	0	0
14	22441057	.	T	C	4	5	9	0	0	9	0	0
14	22441110	.	G	A	5	2	7	0	0	7	0	0
14	22441322	.	A	G	0	4	4	0	0	4	0	0
14	22441532	.	T	C	1	6	7	0	1	8	0	0
14	22441581	.	C	A	6	4	10	0	1	11	0	0
14	22441634	.	G	A	0	4	4	0	4	8	0	0
14	22441650	.	C	T	5	5	10	0	0	10	0	0
14	22441730	.	A	G	2	4	6	0	1	7	0	0
14	22441793	.	G	A	1	6	7	0	2	9	0	0
14	22441873	.	T	C	3	7	10	0	0	10	0	0
14	22441995	.	G	A	5	3	8	0	0	8	0	0
14	22470213	.	T	C	1	3	4	0	0	4	0	0
14	22478348	.	C	T	6	5	11	0	0	11	0	0
14	22478380	.	C	T	8	3	11	0	0	11	0	0
14	22478913	.	T	C	1	0	1	0	2	3	0	0
14	22479381	.	T	A	1	3	4	0	0	4	0	0
14	22516166	.	T	C	2	1	3	0	0	3	0	0
14	22523608	.	C	A	3	4	7	0	0	7	0	0
14	22689737	.	A	G	1	0	1	0	4	5	0	0
14	22696456	.	C	T	0	2	2	0	0	2	0	0
14	22708325	.	A	G	2	2	4	0	0	4	0	0
14	22708446	.	C	T	5	3	8	0	0	8	0	0
14	23411619	.	C	G	3	0	3	0	4	7	0	0
14	23455989	.	G	A	4	11	15	0	0	15	0	0
14	23463681	.	G	A	0	1	1	0	2	3	0	0
14	23463708	.	A	G	3	1	4	0	0	4	0	0
14	23463717	.	A	G	3	0	3	0	1	4	0	0
14	23463760	.	C	A	1	0	1	0	0	1	0	0
14	23478997	.	G	C	5	6	11	0	0	11	0	0
14	24094722	.	G	A	2	3	5	0	0	5	0	0
14	24097523	.	C	T	9	19	28	0	0	28	0	0
14	24097686	.	A	G	12	10	22	0	0	22	0	0
14	24097734	.	G	A	12	12	24	0	0	24	0	0
14	24098408	.	C	G	5	5	10	0	1	11	0	0
14	24098912	.	C	T	1	8	9	0	11	20	0	0
14	24108731	.	G	A	9	3	12	0	0	12	0	0
14	24108983	.	G	A	6	8	14	0	1	15	0	0
14	24109031	.	A	G	11	8	19	0	0	19	0	0
14	24109067	.	G	C	14	1	15	0	10	25	0	0
14	24109184	.	G	A	18	11	29	0	0	29	0	0
14	24109355	.	C	G	5	9	14	0	0	14	0	0
14	24109451	.	A	G	6	7	13	0	0	13	0	0
14	24109706	.	T	G	9	15	24	0	0	24	0	0
14	24215187	.	C	G	9	3	12	0	1	13	0	0
14	24215231	.	G	A	3	3	6	0	0	6	0	0
14	24217550	.	C	T	3	1	4	0	1	5	0	0
14	24220467	.	A	G	24	1	25	0	12	37	0	0
14	24220659	.	A	C	6	6	12	0	0	12	0	0
14	24221356	.	G	A	0	15	15	0	12	27	0	0
14	24243925	.	G	A	1	2	3	0	0	3	0	0
14	24248495	.	T	G	4	3	7	0	0	7	0	0
14	24248575	.	C	T	5	3	8	0	0	8	0	0
14	24250463	.	C	T	1	1	2	0	0	2	0	0
14	24250583	.	G	A	3	1	4	0	0	4	0	0
14	24268222	.	G	T	3	4	7	0	0	7	0	0
14	24268262	.	A	G	10	5	15	0	0	15	0	0
14	24268332	.	A	C	16	0	16	0	7	23	0	0
14	24268374	.	G	A	5	5	10	0	1	11	0	0
14	24268505	.	G	A	6	3	9	0	0	9	0	0
14	24268712	.	C	T	0	11	11	0	10	21	0	0
14	24274521	.	T	G	3	2	5	0	1	6	0	0
14	24274575	.	C	T	2	2	4	0	1	5	0	0
14	24274783	.	G	A	4	5	9	0	1	10	0	0
14	24276634	.	C	T	7	3	10	0	0	10	0	0
14	24278144	.	C	G	24	23	47	0	2	49	0	0
14	24278162	.	C	G	24	23	47	0	3	50	0	0
14	24278831	.	T	C	20	18	38	0	3	41	0	0
14	24278882	.	C	A	11	20	31	0	3	34	0	0
14	24278917	.	G	A	13	19	32	0	1	33	0	0
14	24279126	.	A	G	32	12	44	0	2	46	0	0
14	24279148	.	G	A	37	8	45	0	3	48	0	0
14	24279305	.	A	T	8	13	21	0	1	22	0	0
14	24279326	.	A	C	8	12	20	0	3	23	0	0
14	24279367	.	A	T	13	15	28	0	0	28	0	0
14	24279383	.	T	A	13	13	26	0	2	28	0	0
14	24279682	.	T	C	13	22	35	0	1	36	0	0
14	24279701	.	C	G	6	20	26	0	0	26	0	0
14	24280452	.	T	C	9	6	15	0	0	15	0	0
14	24280517	.	A	C	7	16	23	0	0	23	0	0
14	24280842	.	T	C	17	15	32	0	2	34	0	0
14	24280904	.	T	G	8	16	24	0	1	25	0	0
14	24280918	.	T	G	7	14	21	0	2	23	0	0
14	24280975	.	A	G	10	10	20	0	0	20	0	0
14	24281118	.	T	A	12	11	23	0	0	23	0	0
14	24281149	.	A	C	4	4	8	0	1	9	0	0
14	24283609	.	G	A	15	7	22	0	0	22	0	0
14	24284089	.	T	C	2	3	5	0	1	6	0	0
14	24301750	.	G	T	7	10	17	0	0	17	0	0
14	24301946	.	C	A	6	6	12	0	0	12	0	0
14	24302052	.	T	C	2	2	4	0	0	4	0	0
14	24302089	.	A	T	3	5	8	0	1	9	0	0
14	24302137	.	C	T	6	5	11	0	0	11	0	0
14	24302177	.	A	T	1	4	5	0	0	5	0	0
14	24302214	.	T	C	1	5	6	0	1	7	0	0
14	24302236	.	A	C	1	6	7	0	0	7	0	0
14	24302280	.	G	T	4	2	6	0	0	6	0	0
14	24302310	.	A	C	5	5	10	0	0	10	0	0
14	24302363	.	T	A	6	5	11	0	1	12	0	0
14	24302428	.	T	C	1	4	5	0	0	5	0	0
14	24302439	.	G	A	0	2	2	0	2	4	0	0
14	24302560	.	G	A	6	5	11	0	1	12	0	0
14	24302766	.	T	G	4	4	8	0	0	8	0	0
14	24302825	.	T	C	2	5	7	0	0	7	0	0
14	24302920	.	C	T	4	4	8	0	2	10	0	0
14	24303103	.	A	G	8	3	11	0	0	11	0	0
14	24303205	.	T	A	4	1	5	0	0	5	0	0
14	24303217	.	G	A	2	1	3	0	0	3	0	0
14	24303465	.	G	T	0	10	10	0	9	19	0	0
14	24303523	.	G	T	14	14	28	0	0	28	0	0
14	24303660	.	T	C	7	4	11	0	0	11	0	0
14	24303665	.	C	A	7	4	11	0	0	11	0	0
14	24303786	.	A	T	5	6	11	0	0	11	0	0
14	24303851	.	C	A	3	2	5	0	0	5	0	0
14	24303873	.	C	A	3	1	4	0	1	5	0	0
14	24304271	.	T	A	10	11	21	0	0	21	0	0
14	24304298	.	A	C	9	12	21	0	0	21	0	0
14	24304518	.	T	C	5	5	10	0	1	11	0	0
14	24304753	.	T	C	5	6	11	0	0	11	0	0
14	24317226	.	G	A	18	20	38	0	3	41	0	0
14	24317301	.	G	T	34	26	60	0	3	63	0	0
14	24317751	.	C	A	0	19	19	0	22	41	0	0
14	24318041	.	A	T	26	19	45	0	0	45	0	0
14	24318102	.	A	T	23	23	46	0	2	48	0	0
14	24318160	.	T	G	15	13	28	0	3	31	0	0
14	24318196	.	G	A	14	15	29	0	2	31	0	0
14	24318232	.	G	C	19	18	37	0	2	39	0	0
14	24318335	.	G	T	19	20	39	0	0	39	0	0
14	24318631	.	C	T	16	23	39	0	1	40	0	0
14	24318652	.	G	A	17	20	37	0	2	39	0	0
14	24318709	.	A	T	14	20	34	0	1	35	0	0
14	24318723	.	T	C	14	18	32	0	3	35	0	0
14	24369500	.	C	T	13	8	21	0	0	21	0	0
14	24369578	.	A	G	1	2	3	0	0	3	0	0
14	24376787	.	G	A	24	12	36	0	1	37	0	0
14	24391397	.	G	A	12	8	20	0	1	21	0	0
14	24406609	.	C	G	0	6	6	0	4	10	0	0
14	24410450	.	A	C	10	17	27	0	0	27	0	0
14	24410553	.	C	A	11	17	28	0	2	30	0	0
14	24497832	.	G	T	3	4	7	0	1	8	0	0
14	24497868	.	T	C	2	0	2	0	4	6	0	0
14	24512823	.	G	A	1	3	4	0	0	4	0	0
14	24840837	.	C	A	1	2	3	0	0	3	0	0
14	24841001	.	C	T	2	3	5	0	0	5	0	0
14	24852639	.	T	C	3	4	7	0	0	7	0	0
14	24867270	.	T	C	4	4	8	0	1	9	0	0
14	24873327	.	A	G	1	0	1	0	2	3	0	0
14	24873487	.	A	G	4	3	7	0	3	10	0	0
14	24985474	.	T	C	6	2	8	0	0	8	0	0
14	24985478	.	C	T	5	2	7	0	1	8	0	0
14	24985582	.	C	A	3	3	6	0	0	6	0	0
14	24990428	.	G	T	0	6	6	0	0	6	0	0
14	24994819	.	G	A	1	4	5	0	2	7	0	0
14	24997850	.	G	A	0	5	5	0	3	8	0	0
14	24997910	.	C	T	2	3	5	0	0	5	0	0
14	24997911	.	C	T	1	3	4	0	1	5	0	0
14	24997954	.	C	A	6	4	10	0	0	10	0	0
14	24998019	.	A	T	7	6	13	0	0	13	0	0
14	24998345	.	C	A	5	4	9	0	0	9	0	0
14	24998359	.	C	A	4	4	8	0	0	8	0	0
14	24998430	.	G	A	0	8	8	0	9	17	0	0
14	24998737	.	A	C	6	8	14	0	0	14	0	0
14	24999546	.	T	A	16	5	21	0	0	21	0	0
14	24999573	.	A	G	13	1	14	0	16	30	0	0
14	24999722	.	T	C	6	11	17	0	1	18	0	0
14	25000492	.	A	T	6	10	16	0	2	18	0	0
14	25040089	.	A	C	2	0	2	0	2	4	0	0
14	25040313	.	G	A	1	4	5	0	0	5	0	0
14	25063367	.	A	C	1	2	3	0	0	3	0	0
14	25063456	.	C	T	2	2	4	0	0	4	0	0
14	25063459	.	C	T	2	2	4	0	0	4	0	0
14	25063607	.	G	T	2	1	3	0	0	3	0	0
14	25066002	.	C	A	0	1	1	0	2	3	0	0
14	25066722	.	T	A	1	0	1	0	0	1	0	0
14	25067471	.	C	T	2	1	3	0	1	4	0	0
14	25067665	.	C	T	9	6	15	0	0	15	0	0
14	25067700	.	C	A	1	0	1	0	0	1	0	0
14	25067857	.	G	A	8	6	14	0	0	14	0	0
14	25067862	.	A	C	8	6	14	0	0	14	0	0
14	25067984	.	C	T	11	10	21	0	0	21	0	0
14	25068007	.	G	C	8	5	13	0	1	15	1	0
14	25068206	.	G	T	6	7	13	0	0	13	0	0
14	25068215	.	T	G	6	7	13	0	0	13	0	0
14	25072307	.	G	T	17	7	24	0	0	24	0	0
14	25072351	.	C	T	14	10	24	0	1	25	0	0
14	25072447	.	A	G	15	10	25	0	2	27	0	0
14	25072468	.	C	T	16	13	29	0	1	30	0	0
14	25072489	.	T	G	15	15	30	0	1	31	0	0
14	25072662	.	T	C	9	0	9	0	13	22	0	0
14	25072737	.	C	T	8	16	24	0	0	24	0	0
14	25073178	.	C	G	0	1	1	0	0	1	0	0
14	25073511	.	C	T	0	1	1	0	0	1	0	0
14	25075173	.	G	A	4	2	6	0	0	6	0	0
14	25079821	.	C	A	6	3	9	0	1	10	0	0
14	25080035	.	A	G	15	21	36	0	2	39	1	0
14	25080687	.	C	G	16	15	31	0	1	32	0	0
14	25090999	.	T	G	11	18	29	0	3	32	0	0
14	25091063	.	A	G	13	11	24	0	0	24	0	0
14	25091467	.	C	T	2	6	8	0	0	8	0	0
14	25091840	.	C	T	5	3	8	0	1	9	0	0
14	25095719	.	G	A	3	2	5	0	0	5	0	0
14	25101097	.	T	C	2	0	2	0	2	4	0	0
14	25199866	.	G	A	1	2	3	0	0	3	0	0
14	25480219	.	C	T	0	2	2	0	0	2	0	0
14	25495423	.	A	G	3	2	5	0	0	5	0	0
14	25498423	.	T	C	0	1	1	0	0	1	0	0
14	25498930	.	A	G	1	2	3	0	1	4	0	0
14	25498932	.	A	T	2	2	4	0	0	4	0	0
14	25499275	.	A	G	2	0	2	0	3	5	0	0
14	25499293	.	C	A	1	3	4	0	0	4	0	0
14	25499602	.	A	G	2	3	5	0	0	5	0	0
14	25499651	.	G	A	1	1	2	0	0	2	0	0
14	25499695	.	G	A	0	3	3	0	1	4	0	0
14	25499750	.	C	T	1	2	3	0	0	3	0	0
14	25499752	.	C	T	1	2	3	0	0	3	0	0
14	25500093	.	A	T	1	4	5	0	0	5	0	0
14	25500110	.	G	A	0	3	3	0	3	6	0	0
14	25500594	.	T	A	8	9	17	0	0	17	0	0
14	25501405	.	C	T	5	4	9	0	0	9	0	0
14	25501581	.	T	C	7	9	16	0	0	16	0	0
14	25501740	.	T	G	1	5	6	0	1	7	0	0
14	25501851	.	T	G	6	9	15	0	1	16	0	0
14	25502142	.	T	C	5	15	20	0	2	22	0	0
14	25510803	.	A	G	5	4	9	0	0	9	0	0
14	25534862	.	G	T	5	1	6	0	0	6	0	0
14	25534863	.	T	G	4	0	4	0	2	6	0	0
14	25535003	.	C	T	0	10	10	0	6	16	0	0
14	25535005	.	T	C	5	10	15	0	1	16	0	0
14	25535067	.	A	T	9	14	23	0	0	23	0	0
14	25535167	.	T	G	7	10	17	0	2	19	0	0
14	25535607	.	G	A	19	22	41	0	1	42	0	0
14	25535706	.	G	T	16	32	48	0	0	48	0	0
14	25535742	.	T	A	8	21	29	0	0	29	0	0
14	25535768	.	G	T	9	9	18	0	0	18	0	0
14	25535820	.	C	T	0	4	4	0	10	14	0	0
14	25535947	.	A	T	4	3	7	0	0	7	0	0
14	25536132	.	T	C	8	8	16	0	1	17	0	0
14	25536148	.	G	A	9	8	17	0	0	17	0	0
14	25536326	.	C	T	11	5	16	0	3	19	0	0
14	25536422	.	A	G	14	5	19	0	2	21	0	0
14	25536577	.	G	C	16	15	31	0	0	32	1	0
14	25536619	.	A	G	24	15	39	0	2	41	0	0
14	25536657	.	A	C	26	15	41	0	1	42	0	0
14	25536770	.	A	T	24	12	36	0	2	38	0	0
14	25536782	.	C	T	0	9	9	0	25	34	0	0
14	25537019	.	C	A	9	17	26	0	3	29	0	0
14	25537068	.	G	A	13	9	22	0	1	23	0	0
14	25537136	.	T	C	17	8	25	0	1	26	0	0
14	25537145	.	G	A	16	8	24	0	1	25	0	0
14	25537189	.	A	T	21	13	34	0	0	34	0	0
14	25537200	.	C	T	19	12	31	0	2	33	0	0
14	25537307	.	A	T	9	7	16	0	5	21	0	0
14	25537332	.	T	A	10	7	17	0	1	18	0	0
14	25537345	.	A	G	9	5	14	0	0	14	0	0
14	25537405	.	A	G	7	13	20	0	1	21	0	0
14	25537700	.	C	T	0	20	20	0	7	27	0	0
14	25537975	.	G	T	12	15	27	0	1	28	0	0
14	25538121	.	T	C	16	13	29	0	4	33	0	0
14	25538355	.	A	T	11	6	17	0	2	19	0	0
14	25538364	.	A	C	13	5	18	0	0	18	0	0
14	25538433	.	T	A	9	5	14	0	0	14	0	0
14	25538490	.	T	C	4	2	6	0	0	6	0	0
14	25538497	.	C	A	4	0	4	0	1	5	0	0
14	25538618	.	T	A	11	8	19	0	0	19	0	0
14	25539423	.	C	T	0	12	12	0	10	22	0	0
14	25817573	.	T	C	2	2	4	0	0	4	0	0
14	25874600	.	G	A	1	1	2	0	0	2	0	0
14	25885793	.	G	C	0	8	8	0	2	10	0	0
14	25904733	.	C	T	2	2	4	0	0	4	0	0
14	25904739	.	C	T	2	4	6	0	0	6	0	0
14	25904781	.	C	T	6	5	11	0	0	11	0	0
14	25904811	.	C	T	6	5	11	0	0	11	0	0
14	25904868	.	C	T	9	4	13	0	0	13	0	0
14	25905091	.	C	T	6	4	10	0	0	10	0	0
14	25906074	.	A	G	2	4	6	0	0	6	0	0
14	25906079	.	G	A	6	2	8	0	0	8	0	0
14	25906539	.	C	T	6	3	9	0	0	9	0	0
14	25906572	.	G	A	3	5	8	0	2	10	0	0
14	25906652	.	G	T	6	5	11	0	0	11	0	0
14	25906727	.	A	G	3	4	7	0	1	8	0	0
14	25907006	.	T	C	4	7	11	0	0	11	0	0
14	25907143	.	A	G	4	0	4	0	5	9	0	0
14	25907233	.	T	C	8	3	11	0	0	11	0	0
14	25907335	.	A	G	2	2	4	0	2	6	0	0
14	25907541	.	C	T	1	5	6	0	0	6	0	0
14	25907578	.	T	A	2	2	4	0	0	4	0	0
14	25907737	.	T	C	4	2	6	0	0	6	0	0
14	25907893	.	G	A	0	4	4	0	3	7	0	0
14	25908021	.	T	A	2	4	6	0	1	7	0	0
14	25908149	.	A	T	1	2	3	0	0	3	0	0
14	25908191	.	G	A	1	3	4	0	0	4	0	0
14	25908640	.	G	A	1	2	3	0	0	3	0	0
14	25908659	.	G	C	2	1	3	0	1	4	0	0
14	25908680	.	A	T	2	2	4	0	0	4	0	0
14	25908753	.	A	C	2	10	12	0	1	13	0	0
14	25908802	.	A	C	10	8	18	0	2	20	0	0
14	25908843	.	A	T	11	7	18	0	1	19	0	0
14	25908901	.	C	T	8	4	12	0	0	12	0	0
14	25908984	.	T	G	6	6	12	0	0	12	0	0
14	25909736	.	G	A	3	6	9	0	0	9	0	0
14	25910037	.	T	A	8	10	18	0	1	19	0	0
14	25910186	.	C	A	4	7	11	0	0	11	0	0
14	25910296	.	A	G	10	4	14	1	0	15	0	0
14	25910314	.	A	T	3	10	13	1	1	15	0	0
14	25910636	.	G	C	16	9	25	0	2	27	0	0
14	25910715	.	T	C	8	12	20	0	1	21	0	0
14	25910747	.	C	T	14	9	23	0	3	26	0	0
14	25910825	.	A	C	15	18	33	0	2	35	0	0
14	25910834	.	T	A	18	15	33	0	2	35	0	0
14	25911097	.	C	T	12	10	22	0	0	22	0	0
14	25911098	.	G	A	10	12	22	0	0	22	0	0
14	25923510	.	C	G	5	2	7	0	0	7	0	0
14	25924369	.	T	A	6	7	13	0	0	13	0	0
14	25924429	.	C	T	0	5	5	0	1	6	0	0
14	25924661	.	T	C	4	4	8	0	0	8	0	0
14	25925552	.	C	A	0	2	2	0	1	3	0	0
14	25925600	.	C	T	1	4	5	0	0	5	0	0
14	25925973	.	T	A	6	7	13	0	0	13	0	0
14	25926048	.	C	T	1	9	10	0	7	17	0	0
14	25926134	.	G	A	9	13	22	0	0	22	0	0
14	25926195	.	G	A	7	11	18	0	0	18	0	0
14	25926276	.	G	A	14	10	24	0	1	25	0	0
14	25932650	.	C	A	3	2	5	0	1	6	0	0
14	25935090	.	G	T	8	2	10	0	0	10	0	0
14	25939622	.	G	A	6	7	13	0	0	13	0	0
14	25942653	.	G	A	2	2	4	0	0	4	0	0
14	25985448	.	A	C	1	1	2	0	0	2	0	0
14	25985733	.	T	A	2	3	5	0	1	6	0	0
14	25986978	.	G	C	5	2	7	0	0	7	0	0
14	26002310	.	T	C	1	0	1	0	0	1	0	0
14	26008943	.	A	G	2	0	2	0	1	3	0	0
14	26008951	.	G	A	0	2	2	0	2	4	0	0
14	26009136	.	A	G	1	1	2	0	0	2	0	0
14	26009147	.	C	G	1	1	2	0	0	2	0	0
14	26011975	.	C	T	2	3	5	0	1	6	0	0
14	26011987	.	G	A	0	4	4	0	4	8	0	0
14	26012017	.	G	A	6	4	10	0	1	11	0	0
14	26012026	.	A	G	5	0	5	0	4	9	0	0
14	26066198	.	T	G	3	9	12	0	0	12	0	0
14	26066617	.	A	G	5	3	8	0	0	8	0	0
14	26066969	.	T	C	4	6	10	0	0	10	0	0
14	26067378	.	T	G	3	4	7	0	1	8	0	0
14	26067757	.	T	A	6	11	17	0	0	17	0	0
14	26067797	.	A	T	7	5	12	0	2	14	0	0
14	26067798	.	A	G	9	5	14	0	0	14	0	0
14	26103439	.	A	T	2	5	7	0	1	8	0	0
14	26103547	.	T	A	15	11	26	0	4	30	0	0
14	26104350	.	C	A	0	18	18	0	18	36	0	0
14	26104442	.	C	T	16	15	31	0	2	33	0	0
14	26104503	.	C	T	19	12	31	0	1	32	0	0
14	26104614	.	A	C	5	10	15	0	3	18	0	0
14	26104674	.	A	T	7	7	14	0	0	14	0	0
14	26104679	.	A	C	7	0	7	0	8	15	0	0
14	26104710	.	G	T	8	9	17	0	1	18	0	0
14	26104762	.	G	A	7	5	12	0	0	12	0	0
14	26104775	.	T	A	6	4	10	0	0	10	0	0
14	26104854	.	C	T	6	6	12	0	0	12	0	0
14	26105086	.	A	C	5	10	15	1	0	16	0	0
14	26105221	.	A	G	6	1	7	0	0	7	0	0
14	26106231	.	G	T	14	10	24	0	0	24	0	0
14	26106493	.	C	T	16	17	33	0	1	34	0	0
14	26106697	.	C	T	1	17	18	0	17	35	0	0
14	26108958	.	T	G	2	2	4	0	0	4	0	0
14	26109353	.	T	G	7	9	16	0	0	16	0	0
14	26109356	.	G	A	6	9	15	0	1	16	0	0
14	26111237	.	T	C	6	9	15	0	1	16	0	0
14	26114037	.	A	T	1	5	6	0	0	6	0	0
14	26114044	.	A	C	2	6	8	0	0	8	0	0
14	26114277	.	G	A	8	10	18	0	0	18	0	0
14	26114286	.	T	C	8	0	8	0	9	17	0	0
14	26127373	.	G	A	1	1	2	0	1	3	0	0
14	26127561	.	G	A	13	7	20	0	0	20	0	0
14	26127736	.	G	A	2	11	13	0	0	13	0	0
14	26127754	.	T	A	10	3	13	0	0	13	0	0
14	26127845	.	C	T	7	5	12	0	0	12	0	0
14	26127856	.	G	A	6	4	10	0	1	11	0	0
14	26147181	.	A	G	3	1	4	0	1	5	0	0
14	26147418	.	A	G	3	3	6	0	1	7	0	0
14	26149915	.	G	T	1	2	3	0	0	3	0	0
14	26152751	.	C	T	2	4	6	0	0	6	0	0
14	26153604	.	A	G	1	3	4	0	0	4	0	0
14	26154376	.	C	T	0	3	3	0	0	3	0	0
14	26154385	.	G	T	3	1	4	0	1	5	0	0
14	26154623	.	T	C	4	0	4	0	4	8	0	0
14	26155267	.	T	C	1	0	1	0	4	5	0	0
14	26165223	.	G	A	3	2	5	0	0	5	0	0
14	26169722	.	C	T	0	3	3	0	1	4	0	0
14	26224807	.	T	G	0	4	4	0	1	5	0	0
14	26227681	.	G	A	4	4	8	0	0	8	0	0
14	26227843	.	G	C	0	4	4	0	0	4	0	0
14	26364270	.	C	T	2	2	4	0	0	4	0	0
14	26364277	.	A	G	2	2	4	0	0	4	0	0
14	26364833	.	G	A	2	4	6	0	0	6	0	0
14	26376936	.	A	G	1	2	3	0	0	3	0	0
14	26381396	.	T	C	5	2	7	0	0	7	0	0
14	26381406	.	A	G	3	4	7	0	0	7	0	0
14	26404803	.	C	T	10	13	23	0	0	23	0	0
14	26404830	.	C	A	12	12	24	0	0	24	0	0
14	26405027	.	G	A	11	13	24	0	0	24	0	0
14	26405205	.	A	G	6	12	18	0	0	18	0	0
14	26405228	.	G	A	8	5	13	0	0	13	0	0
14	26405269	.	T	A	1	8	9	0	2	11	0	0
14	26405330	.	C	T	9	4	13	0	0	13	0	0
14	26413771	.	C	T	13	16	29	0	0	29	0	0
14	26414115	.	C	A	20	16	36	0	2	38	0	0
14	26414157	.	C	T	19	13	32	0	1	33	0	0
14	26414692	.	C	T	2	4	6	0	0	6	0	0
14	27281038	.	C	G	11	11	22	0	3	25	0	0
14	27281182	.	T	C	10	8	18	0	0	18	0	0
14	27281407	.	T	C	2	0	2	0	3	5	0	0
14	27281529	.	A	G	3	3	6	0	0	6	0	0
14	27281665	.	G	A	4	3	7	0	0	7	0	0
14	27288491	.	C	T	1	2	3	0	0	3	0	0
14	27288737	.	T	G	7	5	12	0	0	12	0	0
14	27998933	.	T	A	13	24	37	0	1	38	0	0
14	28001490	.	G	A	0	2	2	0	0	2	0	0
14	28282150	.	G	A	1	6	7	0	4	11	0	0
14	28282528	.	A	G	4	4	8	0	0	8	0	0
14	28351739	.	C	T	6	2	8	0	0	8	0	0
14	28351745	.	G	A	6	3	9	0	0	9	0	0
14	28351793	.	C	T	8	6	14	0	1	15	0	0
14	28385289	.	C	T	5	13	18	0	0	18	0	0
14	28385564	.	G	A	6	8	14	0	0	14	0	0
14	28443175	.	C	T	3	2	5	0	0	5	0	0
14	28448925	.	T	C	2	3	5	0	0	5	0	0
14	28449193	.	A	C	1	0	1	0	0	1	0	0
14	28452247	.	C	T	0	1	1	0	0	1	0	0
14	28452270	.	T	C	0	1	1	0	0	1	0	0
14	28454613	.	A	T	12	14	26	0	2	28	0	0
14	28458110	.	T	C	15	10	25	0	0	25	0	0
14	28458175	.	G	A	13	10	23	0	4	27	0	0
14	28458199	.	T	C	7	9	16	0	2	18	0	0
14	28458345	.	G	A	1	10	11	0	7	18	0	0
14	28458533	.	G	A	12	14	26	0	1	27	0	0
14	28458656	.	A	T	18	15	33	0	3	36	0	0
14	28458980	.	C	G	1	7	8	0	2	10	0	0
14	28459275	.	A	C	16	14	30	0	1	31	0	0
14	28459292	.	G	C	2	13	15	0	12	27	0	0
14	28459324	.	T	A	16	15	31	0	0	31	0	0
14	28459664	.	A	G	3	8	11	0	0	11	0	0
14	28459703	.	C	A	0	6	6	0	1	7	0	0
14	28463860	.	T	A	0	1	1	0	0	1	0	0
14	28464821	.	C	T	3	4	7	0	1	8	0	0
14	28473556	.	C	T	2	3	5	0	0	5	0	0
14	28476860	.	G	A	0	7	7	0	3	10	0	0
14	28477115	.	A	G	8	3	11	0	4	15	0	0
14	28477384	.	C	T	6	2	8	0	0	8	0	0
14	28477400	.	A	G	5	0	5	0	3	8	0	0
14	28483121	.	T	A	3	5	8	0	0	8	0	0
14	28483168	.	A	C	1	5	6	0	1	7	0	0
14	28493222	.	T	C	1	2	3	0	0	3	0	0
14	28502783	.	C	T	2	2	4	0	0	4	0	0
14	28504579	.	A	G	1	5	6	0	1	7	0	0
14	28507764	.	C	T	4	4	8	0	1	9	0	0
14	28512717	.	C	T	3	3	6	0	0	6	0	0
14	28514094	.	T	C	3	1	4	0	0	4	0	0
14	28514289	.	G	C	1	2	3	0	0	3	0	0
14	28514295	.	C	T	1	2	3	0	0	3	0	0
14	28514328	.	C	G	2	3	5	0	0	5	0	0
14	28520068	.	C	T	9	3	12	0	2	14	0	0
14	28520213	.	T	C	2	3	5	0	0	5	0	0
14	28525002	.	A	C	5	9	14	0	0	14	0	0
14	28525367	.	G	A	10	9	19	0	0	19	0	0
14	28525731	.	T	A	6	3	9	0	1	10	0	0
14	28526081	.	G	A	13	5	18	0	3	21	0	0
14	28526110	.	A	G	17	5	22	0	0	22	0	0
14	28526281	.	A	G	10	0	10	0	8	18	0	0
14	28526797	.	C	T	12	12	24	0	1	25	0	0
14	28526815	.	G	T	13	13	26	0	0	26	0	0
14	28526950	.	T	C	15	10	25	0	0	25	0	0
14	28527130	.	T	G	8	15	23	0	1	24	0	0
14	28551504	.	C	T	1	3	4	0	0	4	0	0
14	29582372	.	A	G	2	0	2	0	4	6	0	0
14	30105929	.	C	T	2	2	4	0	0	4	0	0
14	30107693	.	C	T	0	2	2	0	2	4	0	0
14	30107703	.	T	C	2	2	4	0	0	4	0	0
14	30107741	.	G	T	1	2	3	0	0	3	0	0
14	30156705	.	G	C	0	0	0	0	2	2	0	0
14	30156718	.	A	T	1	2	3	0	0	3	0	0
14	30157004	.	T	G	2	5	7	0	0	7	0	0
14	30157030	.	A	T	2	2	4	0	0	4	0	0
14	30158001	.	C	A	2	3	5	0	0	5	0	0
14	30158018	.	A	G	1	3	4	0	0	4	0	0
14	30158062	.	C	A	3	2	5	0	0	5	0	0
14	30158528	.	T	C	1	4	5	0	0	5	0	0
14	30159105	.	T	C	2	2	4	0	0	4	0	0
14	30164041	.	C	T	2	0	2	0	0	2	0	0
14	30274051	.	A	T	0	1	1	0	0	1	0	0
14	30274274	.	T	A	0	1	1	0	0	1	0	0
14	30274282	.	A	T	0	1	1	0	0	1	0	0
14	30276294	.	A	G	1	1	2	0	0	2	0	0
14	30276438	.	A	C	1	0	1	0	0	1	0	0
14	30276441	.	A	G	1	0	1	0	0	1	0	0
14	30277652	.	G	A	0	6	6	0	1	7	0	0
14	30277693	.	C	T	2	2	4	0	0	4	0	0
14	30356063	.	C	T	1	3	4	0	0	4	0	0
14	30356947	.	T	A	2	2	4	0	0	4	0	0
14	30357099	.	C	T	1	2	3	0	0	3	0	0
14	30360991	.	G	A	1	2	3	0	0	3	0	0
14	30361224	.	C	A	3	2	5	0	1	6	0	0
14	30398672	.	C	T	2	6	8	0	0	8	0	0
14	30401100	.	C	T	3	0	3	0	0	3	0	0
14	30403830	.	G	A	4	0	4	0	0	4	0	0
14	30407638	.	C	A	1	0	1	0	0	1	0	0
14	30410882	.	G	A	0	2	2	0	7	9	0	0
14	30410911	.	G	A	1	3	4	0	0	4	0	0
14	30411292	.	T	C	14	13	27	0	0	28	1	0
14	30411707	.	C	T	1	3	4	0	0	4	0	0
14	30411774	.	G	A	4	7	11	0	0	11	0	0
14	30411937	.	A	G	4	5	9	0	0	9	0	0
14	30412086	.	C	T	1	2	3	0	0	3	0	0
14	30423953	.	T	A	2	2	4	0	0	4	0	0
14	30424213	.	C	A	0	2	2	0	1	3	0	0
14	30427682	.	T	C	1	5	6	0	2	8	0	0
14	30427688	.	A	G	1	6	7	0	1	8	0	0
14	30427834	.	G	A	2	4	6	0	0	6	0	0
14	30428031	.	C	T	4	9	13	0	0	13	0	0
14	30428193	.	G	T	6	8	14	0	0	14	0	0
14	30435578	.	G	A	4	1	5	0	0	5	0	0
14	30454979	.	A	T	5	6	11	0	4	15	0	0
14	30455833	.	T	A	3	2	5	0	0	5	0	0
14	30455842	.	T	A	1	2	3	0	1	4	0	0
14	30456463	.	C	T	0	1	1	0	0	1	0	0
14	30460630	.	G	A	5	8	13	0	2	15	0	0
14	30551452	.	A	T	6	9	15	0	3	18	0	0
14	30551488	.	C	T	6	9	15	0	1	16	0	0
14	30551712	.	G	T	6	3	9	0	0	9	0	0
14	30551775	.	C	T	0	2	2	0	6	8	0	0
14	30569108	.	G	A	0	1	1	0	6	7	0	0
14	30580844	.	C	T	2	2	4	0	1	5	0	0
14	30580906	.	A	G	4	3	7	0	0	7	0	0
14	30581910	.	A	G	3	2	5	0	0	5	0	0
14	30588022	.	C	A	2	3	5	0	1	6	0	0
14	30613469	.	C	A	3	1	4	0	0	4	0	0
14	30620229	.	G	C	15	8	23	0	0	23	0	0
14	30637866	.	T	C	20	1	21	0	24	45	0	0
14	30637907	.	G	A	13	27	40	0	0	40	0	0
14	30638071	.	G	A	15	17	32	0	0	32	0	0
14	30638087	.	G	A	15	21	36	0	1	37	0	0
14	30638336	.	C	T	16	17	33	0	0	33	0	0
14	30638599	.	G	A	3	5	8	0	0	8	0	0
14	30642513	.	A	G	4	12	16	0	1	17	0	0
14	30642529	.	A	T	4	8	12	0	1	13	0	0
14	30642757	.	T	G	12	18	30	0	1	32	1	0
14	30713964	.	T	C	20	22	42	0	2	44	0	0
14	30720354	.	C	T	0	7	7	0	9	16	0	0
14	30720372	.	T	G	8	9	17	0	0	17	0	0
14	30720399	.	C	T	0	5	5	0	8	13	0	0
14	30731046	.	T	C	13	5	18	0	1	19	0	0
14	30731073	.	C	A	9	2	11	0	1	12	0	0
14	30731174	.	C	T	10	5	15	0	1	16	0	0
14	30731565	.	T	C	2	2	4	0	0	4	0	0
14	30731577	.	A	G	4	2	6	0	0	6	0	0
14	30732136	.	C	G	17	8	25	0	2	27	0	0
14	30732828	.	T	G	5	9	14	0	0	14	0	0
14	30732899	.	C	T	12	10	22	0	1	23	0	0
14	30733008	.	C	T	7	9	16	0	2	18	0	0
14	30733164	.	G	A	9	11	20	0	3	23	0	0
14	30733279	.	C	A	16	11	27	0	1	28	0	0
14	30733411	.	A	G	13	11	24	0	0	24	0	0
14	30733685	.	G	A	14	10	24	0	1	25	0	0
14	30733689	.	G	A	14	10	24	0	0	24	0	0
14	30733779	.	G	A	0	12	12	0	11	23	0	0
14	30733783	.	C	A	12	12	24	0	0	24	0	0
14	30733964	.	C	T	18	18	36	0	1	37	0	0
14	30734183	.	C	T	5	19	24	0	1	25	0	0
14	30734215	.	A	T	17	13	30	0	0	30	0	0
14	30734221	.	A	G	15	1	16	0	16	32	0	0
14	30734295	.	A	G	10	23	33	0	5	38	0	0
14	30734347	.	A	G	10	20	30	0	4	34	0	0
14	30734389	.	A	T	12	18	30	0	1	31	0	0
14	30734390	.	T	A	11	18	29	0	2	31	0	0
14	30734516	.	T	C	15	22	37	0	3	40	0	0
14	30740058	.	G	T	2	2	4	0	0	4	0	0
14	30741091	.	A	T	1	2	3	0	0	3	0	0
14	30757309	.	C	T	0	2	2	0	0	2	0	0
14	30759357	.	A	G	2	3	5	0	1	6	0	0
14	30759358	.	C	A	3	3	6	0	0	6	0	0
14	30776398	.	G	A	0	2	2	0	3	5	0	0
14	30776405	.	C	A	3	2	5	0	0	5	0	0
14	30791109	.	C	T	3	3	6	0	0	6	0	0
14	30791127	.	C	T	2	2	4	0	0	4	0	0
14	30793046	.	G	A	4	5	9	0	0	9	0	0
14	30793161	.	C	T	5	5	10	0	0	10	0	0
14	30793618	.	T	A	2	2	4	0	0	4	0	0
14	30793625	.	C	T	2	2	4	0	0	4	0	0
14	30800528	.	T	C	12	8	20	0	1	21	0	0
14	30800809	.	A	C	33	26	59	0	1	60	0	0
14	30801329	.	G	A	24	11	35	0	0	35	0	0
14	30801379	.	G	A	19	17	36	0	2	38	0	0
14	30801389	.	A	G	18	15	33	0	2	35	0	0
14	30801451	.	G	C	11	11	22	0	0	22	0	0
14	30802645	.	G	A	0	2	2	0	1	3	0	0
14	30803026	.	G	A	1	3	4	0	0	4	0	0
14	30803394	.	G	T	2	1	3	0	1	4	0	0
14	30803662	.	G	A	2	2	4	0	0	4	0	0
14	30803794	.	C	G	1	2	3	0	0	3	0	0
14	30854710	.	A	T	17	18	35	0	3	38	0	0
14	30854742	.	A	C	12	15	27	0	1	28	0	0
14	30855218	.	A	G	20	16	36	0	2	38	0	0
14	30855303	.	C	T	0	14	14	0	17	31	0	0
14	30855649	.	C	A	17	23	40	0	3	43	0	0
14	30855767	.	G	T	22	20	42	0	1	43	0	0
14	30855824	.	T	A	20	18	38	0	2	40	0	0
14	30876425	.	A	G	7	2	9	0	0	9	0	0
14	30876670	.	A	T	11	6	17	0	1	18	0	0
14	30878068	.	T	A	3	2	5	0	0	5	0	0
14	30878357	.	C	A	5	4	9	0	0	10	1	0
14	30878587	.	G	A	6	3	9	0	1	10	0	0
14	30878604	.	C	T	9	1	10	0	1	11	0	0
14	30878800	.	A	C	5	3	8	0	0	8	0	0
14	30879932	.	T	A	2	3	5	0	0	5	0	0
14	30880035	.	G	A	2	2	4	0	0	4	0	0
14	30880091	.	A	C	7	5	12	0	0	12	0	0
14	30880477	.	C	T	1	11	12	0	4	16	0	0
14	30880497	.	C	T	3	8	11	0	1	12	0	0
14	30880532	.	A	G	4	3	7	0	1	8	0	0
14	30880534	.	A	G	3	4	7	0	1	8	0	0
14	30880586	.	A	G	1	3	4	0	0	4	0	0
14	30880587	.	T	G	1	3	4	0	0	4	0	0
14	30880817	.	A	G	2	6	8	0	1	9	0	0
14	30880973	.	G	A	2	3	5	0	0	5	0	0
14	30881073	.	A	T	5	3	8	0	1	9	0	0
14	30881162	.	C	G	2	2	4	0	0	4	0	0
14	30912058	.	T	C	3	4	7	0	1	8	0	0
14	30912397	.	A	T	2	2	4	0	0	4	0	0
14	30912925	.	C	T	3	2	5	0	0	5	0	0
14	30913330	.	T	C	2	4	6	0	1	7	0	0
14	30913423	.	G	A	3	2	5	0	0	5	0	0
14	30914894	.	C	T	3	2	5	0	0	5	0	0
14	30914895	.	T	A	3	2	5	0	0	5	0	0
14	30915362	.	A	G	0	0	0	0	4	4	0	0
14	30915466	.	G	A	0	2	2	0	5	7	0	0
14	30915608	.	T	A	6	5	11	0	0	11	0	0
14	30916902	.	G	A	8	5	13	0	1	14	0	0
14	30925570	.	A	C	4	0	4	0	7	11	0	0
14	30927430	.	G	A	5	4	9	0	0	9	0	0
14	30929684	.	G	A	1	3	4	0	1	5	0	0
14	30929846	.	T	A	1	2	3	0	1	4	0	0
14	30929861	.	C	T	2	2	4	0	0	4	0	0
14	30967732	.	C	T	1	7	8	0	2	10	0	0
14	30967975	.	T	G	1	0	1	0	0	1	0	0
14	30970827	.	G	C	6	3	9	0	0	9	0	0
14	30970834	.	A	C	3	4	7	0	2	9	0	0
14	30970895	.	C	T	1	1	2	0	0	2	0	0
14	30971181	.	A	C	3	0	3	0	0	3	0	0
14	30975367	.	A	G	11	7	18	2	0	20	0	0
14	30975479	.	G	T	17	25	42	0	5	47	0	0
14	30978661	.	T	C	13	13	26	0	2	28	0	0
14	30982468	.	A	G	13	12	25	0	1	26	0	0
14	30987167	.	G	T	16	13	29	0	0	29	0	0
14	30987702	.	T	A	16	9	25	0	1	26	0	0
14	30987930	.	G	A	19	15	34	0	0	34	0	0
14	30987985	.	A	G	20	14	34	0	1	35	0	0
14	30988280	.	T	C	6	0	6	0	14	20	0	0
14	30988494	.	G	A	10	11	21	0	1	22	0	0
14	30988644	.	G	A	12	2	14	0	0	14	0	0
14	30988707	.	T	G	7	6	13	0	0	13	0	0
14	30988756	.	G	T	4	4	8	0	1	9	0	0
14	30989535	.	A	G	3	6	9	0	0	9	0	0
14	30990436	.	C	A	9	5	14	0	2	16	0	0
14	30991272	.	C	T	1	10	11	0	8	19	0	0
14	30991311	.	A	G	9	9	18	0	0	18	0	0
14	31014047	.	G	A	6	3	9	0	0	9	0	0
14	31024014	.	G	A	4	8	12	0	0	12	0	0
14	31024077	.	C	A	3	3	6	0	0	6	0	0
14	31082249	.	C	T	2	7	9	0	0	9	0	0
14	31082474	.	G	T	4	6	10	0	1	11	0	0
14	31082501	.	T	G	6	3	9	0	0	9	0	0
14	31082537	.	C	T	4	5	9	0	0	9	0	0
14	31082569	.	C	T	4	4	8	0	1	9	0	0
14	31082717	.	G	A	7	4	11	0	0	11	0	0
14	31082745	.	A	T	6	5	11	0	2	13	0	0
14	31082857	.	C	T	12	9	21	0	4	25	0	0
14	31083206	.	C	A	7	6	13	0	0	13	0	0
14	31083227	.	G	A	5	6	11	0	0	11	0	0
14	31083242	.	C	A	0	4	4	0	6	10	0	0
14	31090935	.	C	T	1	4	5	0	1	6	0	0
14	31091264	.	C	T	0	4	4	0	3	7	0	0
14	31091589	.	T	A	2	7	9	0	0	9	0	0
14	31092404	.	G	A	1	2	3	0	0	3	0	0
14	31177633	.	A	G	3	3	6	0	0	6	0	0
14	31177651	.	G	A	4	2	6	0	0	6	0	0
14	31474255	.	A	G	1	0	1	0	2	3	0	0
14	31474500	.	G	C	1	2	3	0	0	3	0	0
14	31477482	.	A	G	8	3	11	0	1	12	0	0
14	31478444	.	A	T	0	6	6	0	0	6	0	0
14	31493317	.	C	T	2	1	3	0	1	4	0	0
14	31497559	.	C	T	3	2	5	0	0	5	0	0
14	31498368	.	C	G	2	0	2	0	5	7	0	0
14	31498392	.	G	A	0	6	6	0	5	11	0	0
14	31507444	.	G	A	10	7	17	0	0	17	0	0
14	31510055	.	G	A	0	5	5	0	4	9	0	0
14	31514394	.	G	A	0	4	4	0	2	6	0	0
14	31518812	.	T	A	5	8	13	0	2	15	0	0
14	31519018	.	A	C	7	4	11	0	0	11	0	0
14	31519213	.	C	T	6	3	9	0	1	10	0	0
14	31519777	.	T	A	4	9	13	0	0	13	0	0
14	31520371	.	A	T	3	7	10	0	0	10	0	0
14	31520590	.	A	G	11	1	12	0	6	18	0	0
14	31520750	.	T	C	3	6	9	0	1	10	0	0
14	31521346	.	T	A	4	2	6	0	0	6	0	0
14	31530046	.	C	T	5	3	8	0	0	8	0	0
14	31530171	.	G	T	4	7	11	0	0	11	0	0
14	31530186	.	A	G	7	6	13	0	0	13	0	0
14	31530421	.	G	A	6	7	13	0	0	13	0	0
14	31530439	.	G	A	3	2	5	0	1	6	0	0
14	31541318	.	C	T	4	6	10	0	0	10	0	0
14	31544922	.	A	T	13	7	20	0	1	21	0	0
14	31544947	.	C	T	8	8	16	0	1	17	0	0
14	31545181	.	A	T	11	6	17	0	2	19	0	0
14	31545272	.	C	T	5	6	11	0	0	11	0	0
14	31545433	.	A	T	3	10	13	0	1	14	0	0
14	31545794	.	A	G	13	7	20	0	2	22	0	0
14	31545795	.	G	A	13	8	21	0	1	22	0	0
14	31545902	.	T	A	10	9	19	0	1	20	0	0
14	31545919	.	A	T	11	8	19	0	0	19	0	0
14	31546107	.	T	G	13	0	13	0	9	22	0	0
14	31546137	.	T	A	9	13	22	0	0	22	0	0
14	31546320	.	C	T	6	11	17	0	1	18	0	0
14	31551477	.	G	A	10	16	26	0	0	26	0	0
14	31556308	.	G	A	11	10	21	0	1	22	0	0
14	31556326	.	T	C	14	0	14	0	12	26	0	0
14	31556371	.	A	G	13	9	22	0	1	23	0	0
14	31559062	.	A	G	10	5	15	0	2	17	0	0
14	31562713	.	G	A	3	3	6	0	0	6	0	0
14	31601312	.	T	C	1	2	3	0	0	3	0	0
14	31601330	.	G	A	0	2	2	0	1	3	0	0
14	31608076	.	G	T	1	2	3	0	1	4	0	0
14	31615629	.	G	A	5	4	9	0	1	10	0	0
14	31615658	.	C	T	4	5	9	0	1	10	0	0
14	31616139	.	G	T	9	15	24	0	2	26	0	0
14	31616151	.	C	T	9	17	26	0	0	26	0	0
14	31636502	.	T	G	0	0	0	0	1	1	0	0
14	31641799	.	G	A	0	8	8	0	3	11	0	0
14	31641847	.	A	G	5	6	11	0	0	11	0	0
14	31641886	.	G	A	0	5	5	0	5	10	0	0
14	31641962	.	A	G	5	4	9	0	0	9	0	0
14	31643177	.	G	A	2	6	8	0	0	8	0	0
14	31643437	.	C	T	3	2	5	0	0	5	0	0
14	31644291	.	C	T	17	10	27	0	2	29	0	0
14	31644520	.	T	G	10	5	15	0	0	15	0	0
14	31644638	.	A	G	3	8	11	0	0	11	0	0
14	31644646	.	A	G	5	4	9	0	1	10	0	0
14	31644758	.	G	T	0	5	5	0	0	5	0	0
14	31644813	.	G	C	8	5	13	0	0	13	0	0
14	31644859	.	T	A	8	4	12	0	2	14	0	0
14	31645022	.	C	T	3	7	10	0	0	10	0	0
14	31645473	.	C	G	1	2	3	0	0	3	0	0
14	31646016	.	T	A	3	6	9	0	0	9	0	0
14	31646121	.	G	A	4	6	10	0	0	10	0	0
14	31646224	.	G	A	7	8	15	0	1	17	1	0
14	31646275	.	C	A	11	5	16	0	0	16	0	0
14	31646307	.	G	T	5	2	7	0	0	7	0	0
14	31646650	.	A	G	9	0	9	0	8	17	0	0
14	31646869	.	A	G	4	7	11	0	0	11	0	0
14	31647217	.	A	G	1	12	13	0	1	14	0	0
14	31647516	.	A	T	6	5	11	0	0	11	0	0
14	31647538	.	T	A	11	5	16	0	0	16	0	0
14	31647553	.	G	T	8	12	20	0	0	20	0	0
14	31647730	.	T	C	7	12	19	0	0	19	0	0
14	31647829	.	C	A	11	7	18	0	0	18	0	0
14	31668646	.	G	A	9	9	18	0	0	18	0	0
14	31668719	.	C	T	0	9	9	0	6	15	0	0
14	31668758	.	G	A	11	9	20	0	0	20	0	0
14	31669376	.	T	G	4	4	8	0	0	8	0	0
14	31669377	.	G	T	4	2	6	0	2	8	0	0
14	31669466	.	C	G	8	9	17	0	1	18	0	0
14	31669488	.	A	G	8	10	18	0	1	19	0	0
14	31669551	.	T	C	10	14	24	0	0	24	0	0
14	31669558	.	C	A	9	13	22	0	0	22	0	0
14	31669907	.	A	T	2	3	5	0	0	5	0	0
14	31670364	.	G	A	1	2	3	0	0	3	0	0
14	31677655	.	C	T	1	0	1	0	0	1	0	0
14	31766255	.	G	A	0	2	2	0	1	3	0	0
14	31779690	.	G	A	0	2	2	0	0	2	0	0
14	31779716	.	A	G	1	3	4	0	0	4	0	0
14	31779896	.	T	A	2	2	4	0	0	4	0	0
14	31780186	.	C	A	5	3	8	0	0	8	0	0
14	31780273	.	G	T	0	2	2	0	4	6	0	0
14	31780311	.	A	G	2	0	2	0	7	9	0	0
14	31780398	.	T	A	2	1	3	0	0	3	0	0
14	31799878	.	G	A	4	2	6	0	1	7	0	0
14	31799879	.	A	T	4	3	7	0	0	7	0	0
14	31800090	.	T	C	7	3	10	0	2	12	0	0
14	31800175	.	G	T	6	8	14	0	0	14	0	0
14	31800206	.	T	A	7	8	15	0	0	15	0	0
14	31800369	.	T	C	2	0	2	0	5	7	0	0
14	31800371	.	A	G	2	5	7	0	0	7	0	0
14	31800870	.	C	G	7	9	16	0	0	16	0	0
14	31801168	.	A	G	1	2	3	0	1	4	0	0
14	31801454	.	C	T	0	6	6	0	8	14	0	0
14	31801715	.	A	G	7	5	12	0	0	12	0	0
14	31802067	.	A	T	7	12	19	0	1	20	0	0
14	31802541	.	C	A	1	3	4	0	1	5	0	0
14	31803148	.	A	G	4	4	8	0	0	8	0	0
14	31803191	.	T	C	1	0	1	0	2	3	0	0
14	31806317	.	C	T	3	2	5	0	1	6	0	0
14	31806744	.	G	A	2	1	3	0	0	3	0	0
14	31822694	.	C	T	1	1	2	0	0	2	0	0
14	31860525	.	C	T	5	2	7	0	3	10	0	0
14	31861179	.	A	G	3	2	5	0	0	5	0	0
14	31881728	.	A	G	6	6	12	0	0	12	0	0
14	31881740	.	A	G	6	6	12	0	0	12	0	0
14	31882101	.	G	T	1	3	4	0	0	4	0	0
14	31882252	.	C	A	3	3	6	0	0	6	0	0
14	31882268	.	C	A	2	3	5	0	2	7	0	0
14	31882422	.	T	C	4	3	7	0	0	7	0	0
14	31882481	.	A	G	2	0	2	0	3	5	0	0
14	31882587	.	T	C	2	4	6	0	0	6	0	0
14	31882656	.	C	T	5	2	7	0	0	7	0	0
14	31882672	.	G	T	1	6	7	0	0	7	0	0
14	31882709	.	A	T	6	2	8	0	0	8	0	0
14	31882714	.	A	T	6	2	8	0	0	8	0	0
14	31882802	.	C	T	6	4	10	0	1	11	0	0
14	31883231	.	G	C	2	6	8	0	0	8	0	0
14	31883426	.	C	T	4	4	8	0	0	8	0	0
14	31883475	.	A	T	4	3	7	0	0	7	0	0
14	31883519	.	G	C	0	5	5	0	3	8	0	0
14	31890334	.	G	A	1	3	4	0	0	4	0	0
14	31890748	.	T	C	3	0	3	0	6	9	0	0
14	31890757	.	C	G	0	3	3	0	6	9	0	0
14	31890817	.	G	A	5	4	9	0	0	9	0	0
14	31890874	.	G	A	6	4	10	0	0	10	0	0
14	31893726	.	C	G	1	3	4	0	0	4	0	0
14	31893733	.	C	T	3	1	4	0	1	5	0	0
14	31936927	.	G	A	3	12	15	0	0	15	0	0
14	31936928	.	A	G	3	12	15	0	0	15	0	0
14	31936994	.	T	C	1	2	3	0	0	3	0	0
14	32011929	.	C	G	1	16	17	0	12	29	0	0
14	32013167	.	C	A	0	8	8	0	13	21	0	0
14	32025381	.	T	C	1	1	2	0	0	2	0	0
14	32025466	.	T	G	11	4	15	0	0	15	0	0
14	32025732	.	G	T	3	5	8	0	0	8	0	0
14	32184469	.	C	T	13	21	34	0	0	34	0	0
14	32184927	.	C	A	17	12	29	0	3	32	0	0
14	32184937	.	C	T	9	20	29	0	0	29	0	0
14	32185036	.	C	A	1	13	14	0	24	38	0	0
14	32185374	.	C	T	6	10	16	0	0	16	0	0
14	32254770	.	C	T	6	4	10	0	0	10	0	0
14	32443572	.	A	C	2	4	6	0	1	7	0	0
14	32443727	.	C	T	0	9	9	0	11	20	0	0
14	32443811	.	A	C	9	10	19	0	2	21	0	0
14	32444064	.	C	G	10	9	19	0	2	21	0	0
14	32444114	.	C	G	7	7	14	0	0	14	0	0
14	32444392	.	C	T	2	7	9	0	0	9	0	0
14	32444496	.	G	T	3	4	7	0	1	8	0	0
14	32444651	.	G	A	6	6	12	0	0	12	0	0
14	32444878	.	C	A	1	2	3	0	1	4	0	0
14	32475280	.	G	A	1	3	4	0	0	4	0	0
14	32475417	.	T	C	1	0	1	0	0	1	0	0
14	32479378	.	G	A	2	4	6	0	0	6	0	0
14	32486680	.	A	G	1	1	2	0	0	2	0	0
14	32515783	.	C	T	2	1	3	0	0	3	0	0
14	32518669	.	A	G	2	2	4	0	0	4	0	0
14	32518852	.	G	A	3	2	5	0	0	5	0	0
14	32524195	.	C	T	1	2	3	0	0	3	0	0
14	32526563	.	A	G	1	0	1	0	0	1	0	0
14	32526677	.	A	G	3	4	7	0	0	7	0	0
14	32534834	.	G	A	1	1	2	0	0	2	0	0
14	32549305	.	G	A	2	0	2	0	0	2	0	0
14	32631370	.	T	C	1	4	5	0	0	5	0	0
14	32631384	.	C	T	0	4	4	0	1	5	0	0
14	32952148	.	C	T	2	3	5	0	0	5	0	0
14	32952180	.	T	A	3	3	6	0	0	6	0	0
14	32952467	.	C	T	4	5	9	0	0	9	0	0
14	32952493	.	G	A	4	4	8	0	1	9	0	0
14	32952606	.	C	T	0	2	2	0	8	10	0	0
14	32952665	.	C	T	0	7	7	0	3	10	0	0
14	32952825	.	C	T	0	9	9	0	2	11	0	0
14	32952857	.	T	A	4	5	9	0	0	9	0	0
14	32953035	.	T	C	3	0	3	0	0	3	0	0
14	32984047	.	G	A	2	4	6	0	0	6	0	0
14	32984128	.	C	A	8	6	14	0	0	14	0	0
14	32984139	.	A	C	6	5	11	0	2	13	0	0
14	32984239	.	G	A	4	3	7	0	0	7	0	0
14	32985277	.	A	G	4	2	6	0	0	6	0	0
14	33071522	.	A	G	9	12	21	0	5	26	0	0
14	33071814	.	G	A	6	9	15	0	0	15	0	0
14	33073954	.	G	A	5	7	12	0	0	12	0	0
14	33120461	.	G	A	1	1	2	0	0	2	0	0
14	33120875	.	A	G	2	3	5	0	1	6	0	0
14	33177681	.	A	G	4	10	14	0	1	15	0	0
14	33177949	.	G	C	11	0	11	0	10	21	0	0
14	33220247	.	T	C	1	2	3	0	0	3	0	0
14	33268115	.	T	G	2	11	13	0	0	13	0	0
14	33268211	.	T	A	9	6	15	0	1	16	0	0
14	33268219	.	A	G	7	9	16	0	1	17	0	0
14	33268254	.	C	A	7	9	16	0	0	16	0	0
14	33268297	.	T	C	4	11	15	0	0	15	0	0
14	33280818	.	C	T	16	16	32	0	1	33	0	0
14	33281240	.	T	A	22	31	53	0	1	54	0	0
14	33281690	.	A	G	12	11	23	0	1	24	0	0
14	33281777	.	C	T	0	7	7	0	18	25	0	0
14	33281816	.	C	T	1	21	22	0	18	40	0	0
14	33281856	.	T	A	24	19	43	0	1	44	0	0
14	33281964	.	T	C	21	16	37	0	1	38	0	0
14	33282050	.	C	T	21	19	40	0	4	44	0	0
14	33288448	.	A	G	10	15	25	0	1	26	0	0
14	33297882	.	A	T	8	16	24	0	1	25	0	0
14	33298098	.	C	A	7	8	15	0	0	15	0	0
14	33298397	.	T	C	11	15	26	0	2	28	0	0
14	33298436	.	C	T	13	11	24	0	2	26	0	0
14	33298637	.	C	T	18	24	42	0	1	43	0	0
14	33302377	.	C	T	0	1	1	0	0	1	0	0
14	33302380	.	T	C	0	1	1	0	1	2	0	0
14	33302416	.	A	T	0	2	2	0	0	2	0	0
14	33306505	.	C	T	25	19	44	0	0	44	0	0
14	33307831	.	C	T	7	6	13	0	1	14	0	0
14	33308039	.	A	G	25	26	51	0	1	52	0	0
14	33308120	.	G	A	13	8	21	0	0	21	0	0
14	33330524	.	C	T	2	2	4	0	0	4	0	0
14	33333741	.	A	G	20	13	33	0	1	34	0	0
14	33339472	.	T	C	2	4	6	0	0	6	0	0
14	33339761	.	G	C	4	2	6	0	0	6	0	0
14	33339791	.	G	T	3	4	7	0	0	7	0	0
14	33339895	.	G	A	4	4	8	0	0	8	0	0
14	33340099	.	C	T	7	7	14	0	0	14	0	0
14	33414060	.	G	C	0	6	6	0	4	10	0	0
14	33414105	.	T	A	16	19	35	0	2	38	1	0
14	33414590	.	G	A	6	2	8	0	0	8	0	0
14	33414596	.	C	T	6	2	8	0	0	8	0	0
14	33415120	.	G	C	0	5	5	0	1	6	0	0
14	33419714	.	G	A	4	1	5	1	0	6	0	0
14	33423037	.	C	T	0	1	1	0	0	1	0	0
14	33424626	.	T	C	11	5	16	0	0	16	0	0
14	33424869	.	C	T	17	24	41	0	1	42	0	0
14	33424931	.	T	C	26	13	39	0	0	39	0	0
14	33425013	.	C	T	0	15	15	0	13	28	0	0
14	33427885	.	C	G	0	3	3	0	0	3	0	0
14	33431337	.	G	T	0	2	2	0	2	4	0	0
14	33431815	.	A	C	5	3	8	0	0	8	0	0
14	33431823	.	C	A	3	3	6	0	1	7	0	0
14	33432060	.	C	T	1	3	4	0	0	4	0	0
14	33432078	.	G	A	0	2	2	0	2	4	0	0
14	33432594	.	T	G	3	0	3	0	7	10	0	0
14	33433127	.	A	G	1	1	2	0	0	2	0	0
14	33433589	.	C	G	1	2	3	0	0	3	0	0
14	33433626	.	A	G	3	3	6	0	0	6	0	0
14	33433669	.	G	A	4	2	6	0	1	7	0	0
14	33434018	.	A	T	3	3	6	0	0	6	0	0
14	33434076	.	A	T	3	8	11	0	0	11	0	0
14	33435384	.	G	A	8	4	12	0	0	12	0	0
14	33435415	.	A	G	4	1	5	0	5	10	0	0
14	33435460	.	G	T	7	5	12	0	0	12	0	0
14	33435598	.	C	T	8	4	12	0	1	13	0	0
14	33435768	.	C	A	3	6	9	0	1	10	0	0
14	33436514	.	G	A	12	14	26	0	1	27	0	0
14	33437009	.	G	T	15	10	25	0	0	25	0	0
14	33437056	.	C	A	14	7	21	0	1	22	0	0
14	33441928	.	C	T	4	6	10	0	1	11	0	0
14	33442006	.	A	G	21	23	44	0	0	44	0	0
14	33442069	.	C	T	7	5	12	0	0	12	0	0
14	33454561	.	T	C	17	1	18	0	18	36	0	0
14	33454570	.	C	T	0	17	17	0	17	34	0	0
14	33469026	.	C	A	14	21	35	0	3	38	0	0
14	33469094	.	T	A	17	13	30	0	0	30	0	0
14	33469177	.	C	A	11	13	24	0	0	24	0	0
14	33469180	.	A	G	10	0	10	0	13	23	0	0
14	33469241	.	A	G	10	0	10	0	11	21	0	0
14	33469356	.	C	T	6	5	11	0	1	12	0	0
14	33469419	.	G	A	0	4	4	0	2	6	0	0
14	33469636	.	A	G	7	5	12	0	0	12	0	0
14	33474745	.	T	C	11	0	11	0	11	22	0	0
14	33474762	.	G	C	9	14	23	0	0	23	0	0
14	33474869	.	A	C	13	0	13	0	10	23	0	0
14	33475273	.	G	C	5	5	10	0	0	10	0	0
14	33475445	.	A	C	8	6	14	0	1	15	0	0
14	33475767	.	C	T	6	3	9	0	0	9	0	0
14	33486539	.	A	C	6	5	11	0	1	12	0	0
14	33486543	.	C	G	7	6	13	0	1	14	0	0
14	33487022	.	A	T	1	2	3	0	1	4	0	0
14	33498960	.	G	A	2	3	5	0	0	5	0	0
14	33504633	.	C	A	14	7	21	0	0	21	0	0
14	33505055	.	G	C	13	6	19	0	3	22	0	0
14	33507743	.	C	T	15	8	23	0	0	23	0	0
14	33515522	.	A	G	1	2	3	0	0	3	0	0
14	33515983	.	C	T	7	11	18	0	0	18	0	0
14	33516015	.	G	A	6	8	14	0	1	15	0	0
14	33516131	.	A	G	11	8	19	0	0	19	0	0
14	33516218	.	G	C	5	0	5	0	8	13	0	0
14	33516237	.	C	T	3	7	10	0	0	10	0	0
14	33516314	.	A	G	2	6	8	0	2	10	0	0
14	33516603	.	T	C	1	0	1	0	5	6	0	0
14	33516619	.	A	G	2	2	4	0	0	4	0	0
14	33516706	.	T	C	3	1	4	0	3	7	0	0
14	33516832	.	A	T	7	1	8	0	0	8	0	0
14	33516839	.	A	T	5	3	8	0	0	8	0	0
14	33516905	.	G	A	5	2	7	0	0	7	0	0
14	33517203	.	A	C	2	4	6	0	1	7	0	0
14	33517333	.	T	C	3	3	6	0	1	7	0	0
14	33517334	.	T	A	3	3	6	0	1	7	0	0
14	33517377	.	G	C	5	4	9	0	0	9	0	0
14	33517654	.	C	A	4	6	10	0	0	10	0	0
14	33518128	.	C	T	4	5	9	0	0	9	0	0
14	33518164	.	C	G	3	6	9	0	0	9	0	0
14	33518254	.	G	A	4	2	6	0	1	7	0	0
14	33518323	.	G	A	5	6	11	0	0	11	0	0
14	33518341	.	G	A	3	6	9	0	0	9	0	0
14	33518551	.	T	G	1	4	5	0	0	5	0	0
14	33518722	.	A	G	1	1	2	0	0	2	0	0
14	33525236	.	C	T	6	4	10	0	0	10	0	0
14	33525250	.	A	T	4	5	9	0	0	9	0	0
14	33549786	.	G	A	6	5	11	0	0	11	0	0
14	33554764	.	C	T	2	3	5	0	0	5	0	0
14	33564916	.	C	T	5	5	10	0	0	10	0	0
14	33564994	.	A	G	16	11	27	0	0	27	0	0
14	33565054	.	C	A	11	9	20	0	2	22	0	0
14	33565209	.	C	T	12	10	22	0	0	22	0	0
14	33565794	.	A	C	2	4	6	0	1	7	0	0
14	33566052	.	G	T	6	2	8	0	0	8	0	0
14	33566128	.	A	G	6	3	9	0	0	9	0	0
14	33566151	.	A	G	4	3	7	0	0	7	0	0
14	33566515	.	G	A	0	6	6	0	14	20	0	0
14	33566542	.	A	T	9	14	23	0	1	24	0	0
14	33566578	.	G	C	11	10	21	0	2	23	0	0
14	33566613	.	G	A	10	7	17	0	1	18	0	0
14	33566617	.	C	T	4	9	13	0	3	16	0	0
14	33566651	.	A	G	6	11	17	0	2	19	0	0
14	33566744	.	G	T	14	11	25	0	0	25	0	0
14	33566945	.	C	T	19	16	35	0	3	38	0	0
14	33567023	.	T	A	3	15	18	0	0	18	0	0
14	33567024	.	T	A	3	15	18	0	0	18	0	0
14	33567085	.	A	G	14	5	19	0	0	19	0	0
14	33723199	.	G	A	0	4	4	0	2	6	0	0
14	33754549	.	G	A	11	10	21	0	0	21	0	0
14	33754581	.	C	T	11	9	20	0	1	21	0	0
14	33754587	.	C	T	12	10	22	0	0	22	0	0
14	33754710	.	T	G	11	13	24	0	1	25	0	0
14	33755677	.	C	A	18	16	34	0	0	34	0	0
14	33755810	.	A	C	14	5	19	0	0	19	0	0
14	33755813	.	C	A	7	11	18	0	2	20	0	0
14	33755847	.	T	C	14	20	34	0	0	34	0	0
14	33756950	.	G	A	28	15	43	0	1	44	0	0
14	33757152	.	A	C	24	23	47	0	1	48	0	0
14	33826267	.	A	T	4	10	14	0	1	15	0	0
14	33826491	.	T	G	8	5	13	0	1	14	0	0
14	33826580	.	T	A	3	6	9	0	0	9	0	0
14	33826655	.	T	G	7	8	15	0	0	15	0	0
14	33826682	.	G	A	5	7	12	0	0	12	0	0
14	33826707	.	C	T	0	4	4	0	5	9	0	0
14	33826767	.	T	A	7	10	17	0	0	17	0	0
14	33826827	.	C	T	4	5	9	0	1	10	0	0
14	33827434	.	T	C	1	3	4	0	1	5	0	0
14	33827532	.	T	C	6	4	10	0	0	10	0	0
14	33827698	.	A	T	7	2	9	0	1	10	0	0
14	33827771	.	G	A	4	5	9	0	0	9	0	0
14	33827791	.	A	T	7	2	9	0	0	9	0	0
14	33827869	.	C	A	4	4	8	0	1	9	0	0
14	33827903	.	C	T	0	2	2	0	5	7	0	0
14	33827966	.	T	A	2	6	8	0	0	8	0	0
14	33828422	.	C	T	6	2	8	0	1	9	0	0
14	33828707	.	C	T	7	13	20	0	0	20	0	0
14	33829143	.	C	T	0	6	6	0	2	8	0	0
14	33830689	.	G	A	3	1	4	0	0	4	0	0
14	33835840	.	G	A	9	4	13	0	0	13	0	0
14	33838587	.	T	C	1	1	2	0	0	2	0	0
14	33838806	.	C	G	1	1	2	0	0	2	0	0
14	33848540	.	C	A	4	2	6	0	0	6	0	0
14	33850298	.	C	T	0	3	3	0	1	4	0	0
14	33860183	.	G	C	8	5	13	0	0	13	0	0
14	33860250	.	T	A	10	7	17	0	2	19	0	0
14	33860262	.	C	T	0	13	13	0	8	21	0	0
14	33860372	.	T	C	19	12	31	0	1	32	0	0
14	33860567	.	C	A	23	11	34	0	2	36	0	0
14	33864388	.	G	A	18	16	34	0	1	35	0	0
14	33865764	.	C	T	8	4	12	0	0	12	0	0
14	33865954	.	C	T	10	8	18	0	1	19	0	0
14	33866024	.	T	C	2	4	6	0	0	6	0	0
14	33872095	.	G	C	1	5	6	0	0	6	0	0
14	33883119	.	G	A	0	2	2	0	5	7	0	0
14	33883120	.	A	C	4	3	7	0	0	7	0	0
14	33883167	.	A	C	3	1	4	0	0	4	0	0
14	33889544	.	T	C	2	0	2	0	0	2	0	0
14	33891711	.	G	A	1	19	20	0	17	37	0	0
14	33891981	.	A	T	5	6	11	0	0	11	0	0
14	33892126	.	A	T	10	8	18	0	0	18	0	0
14	33892388	.	A	G	10	0	10	0	7	17	0	0
14	33892501	.	C	T	7	7	14	0	0	14	0	0
14	33893406	.	G	A	0	1	1	0	0	1	0	0
14	33899145	.	T	A	1	5	6	0	0	6	0	0
14	33899315	.	G	A	3	3	6	0	1	7	0	0
14	33899337	.	A	G	3	2	5	0	0	5	0	0
14	33899674	.	T	C	7	0	7	0	17	24	0	0
14	33899786	.	G	A	13	23	36	0	1	37	0	0
14	33899912	.	C	A	0	26	26	0	19	45	0	0
14	33900150	.	A	C	16	14	30	0	1	31	0	0
14	33900155	.	T	C	16	1	17	0	15	32	0	0
14	33900229	.	C	A	8	7	15	0	1	16	0	0
14	33900278	.	A	C	8	2	10	0	1	11	0	0
14	33900289	.	C	T	10	5	15	0	0	15	0	0
14	33900561	.	T	A	13	13	26	0	2	28	0	0
14	33900575	.	A	T	13	15	28	0	2	30	0	0
14	33900611	.	G	A	14	17	31	0	4	35	0	0
14	33900663	.	T	A	19	12	31	0	3	34	0	0
14	33900955	.	A	T	7	14	21	1	0	22	0	0
14	33901129	.	C	T	7	14	21	0	2	23	0	0
14	33901195	.	C	T	0	5	5	0	16	21	0	0
14	33901217	.	T	A	15	2	17	0	1	18	0	0
14	33901267	.	C	A	12	9	21	0	0	21	0	0
14	33901293	.	A	C	15	16	31	0	1	32	0	0
14	33901445	.	T	G	9	8	17	0	0	17	0	0
14	33901591	.	T	C	1	5	6	0	1	7	0	0
14	33901617	.	G	A	5	5	10	0	0	10	0	0
14	33901704	.	G	A	15	8	23	0	1	24	0	0
14	33901766	.	G	C	19	17	36	0	0	36	0	0
14	33901790	.	C	G	1	15	16	0	16	32	0	0
14	33901807	.	A	G	13	9	22	0	1	23	0	0
14	33901865	.	C	A	16	9	25	0	1	26	0	0
14	33901907	.	G	A	11	13	24	0	0	24	0	0
14	33901946	.	A	T	5	11	16	0	0	16	0	0
14	33901957	.	C	A	11	6	17	0	0	17	0	0
14	33901993	.	G	A	7	9	16	0	1	17	0	0
14	33902094	.	G	A	3	7	10	0	0	10	0	0
14	33903090	.	G	A	2	2	4	0	0	4	0	0
14	33909978	.	C	T	9	4	13	0	1	14	0	0
14	33916539	.	G	A	2	0	2	0	0	2	0	0
14	33936378	.	T	A	5	11	16	0	4	20	0	0
14	33936502	.	A	G	1	6	7	0	0	7	0	0
14	33941041	.	A	T	2	2	4	0	0	4	0	0
14	33941266	.	G	A	2	11	13	0	0	13	0	0
14	33941274	.	T	C	1	9	10	0	0	10	0	0
14	33941436	.	C	T	0	4	4	0	3	7	0	0
14	33943652	.	G	A	1	2	3	0	0	3	0	0
14	33983966	.	G	A	23	32	55	0	1	56	0	0
14	33984308	.	A	T	11	11	22	0	1	26	3	0
14	33984436	.	A	T	9	10	19	0	1	20	0	0
14	33984610	.	A	G	19	27	46	0	1	47	0	0
14	33987455	.	T	A	6	9	15	0	0	15	0	0
14	33989580	.	G	A	16	21	37	0	2	39	0	0
14	33991784	.	G	A	0	0	0	0	1	1	0	0
14	33991799	.	G	T	0	0	0	0	1	1	0	0
14	33997606	.	G	A	5	4	9	0	0	9	0	0
14	33997681	.	G	A	3	7	10	0	0	10	0	0
14	33997861	.	A	G	4	2	6	0	0	6	0	0
14	33997873	.	G	A	4	2	6	0	0	6	0	0
14	33998078	.	G	A	14	14	28	1	0	29	0	0
14	33998090	.	A	G	14	17	31	0	0	31	0	0
14	34002325	.	G	A	12	5	17	0	1	18	0	0
14	34002571	.	T	A	11	11	22	0	0	22	0	0
14	34044318	.	C	T	0	5	5	0	7	12	0	0
14	34064401	.	G	A	2	0	2	0	0	2	0	0
14	34065115	.	A	T	9	8	17	0	1	18	0	0
14	34065244	.	A	G	8	6	14	0	0	14	0	0
14	34065442	.	A	G	12	9	21	0	1	22	0	0
14	34065586	.	G	A	8	5	13	0	1	14	0	0
14	34065596	.	T	G	10	4	14	0	1	15	0	0
14	34065785	.	G	A	4	6	10	0	0	10	0	0
14	34065905	.	A	G	1	0	1	0	2	3	0	0
14	34068458	.	C	T	5	2	7	0	0	7	0	0
14	34068760	.	G	A	7	10	17	0	0	17	0	0
14	34075094	.	T	G	0	0	0	0	2	2	0	0
14	34077401	.	C	A	7	6	13	0	0	13	0	0
14	34082694	.	T	A	9	16	25	0	1	26	0	0
14	34089508	.	A	G	16	1	17	0	6	23	0	0
14	34089559	.	C	A	7	6	13	0	1	14	0	0
14	34089597	.	T	C	6	8	14	0	2	16	0	0
14	34089636	.	A	G	8	0	8	0	13	21	0	0
14	34089653	.	G	A	9	10	19	0	1	20	0	0
14	34089676	.	C	T	11	13	24	0	1	25	0	0
14	34089707	.	T	C	8	10	18	0	0	18	0	0
14	34090034	.	A	T	6	4	10	0	1	11	0	0
14	34090093	.	A	C	6	6	12	0	1	13	0	0
14	34090169	.	T	C	8	4	12	0	0	12	0	0
14	34090228	.	G	A	10	8	18	0	3	21	0	0
14	34090248	.	C	G	7	10	17	0	1	18	0	0
14	34090315	.	T	G	14	7	21	0	1	22	0	0
14	34090342	.	G	A	11	4	15	0	1	16	0	0
14	34090647	.	G	A	0	12	12	0	17	29	0	0
14	34090784	.	A	T	4	3	7	0	0	7	0	0
14	34091123	.	G	T	7	9	16	0	0	16	0	0
14	34091238	.	C	A	16	14	30	0	0	30	0	0
14	34091423	.	C	T	10	11	21	0	1	22	0	0
14	34091461	.	G	T	9	8	17	0	1	18	0	0
14	34091717	.	T	G	19	10	29	0	1	30	0	0
14	34091787	.	T	A	14	17	31	0	1	33	1	0
14	34092369	.	C	T	9	17	26	1	2	29	0	0
14	34092507	.	T	G	11	16	27	0	0	27	0	0
14	34092722	.	A	T	3	2	5	0	1	6	0	0
14	34126353	.	A	T	21	27	48	0	4	53	1	0
14	34127925	.	T	A	14	4	18	0	0	18	0	0
14	34128023	.	C	T	8	8	16	0	0	16	0	0
14	34128399	.	A	C	7	12	19	0	0	19	0	0
14	34128477	.	A	C	18	0	18	0	11	29	0	0
14	34128528	.	C	T	12	17	29	0	1	30	0	0
14	34128744	.	G	A	8	13	21	0	0	21	0	0
14	34128796	.	G	T	13	8	21	0	0	21	0	0
14	34128799	.	C	T	0	11	11	0	9	20	0	0
14	34129092	.	C	T	1	6	7	0	12	19	0	0
14	34129433	.	T	G	4	12	16	0	2	18	0	0
14	34129644	.	T	A	3	7	10	0	2	12	0	0
14	34129724	.	C	T	4	5	9	0	1	10	0	0
14	34129780	.	T	C	3	6	9	0	1	10	0	0
14	34129822	.	A	G	4	3	7	0	0	7	0	0
14	34129878	.	A	G	4	5	9	0	2	11	0	0
14	34129937	.	G	A	5	9	14	0	0	14	0	0
14	34129946	.	G	A	5	7	12	0	0	12	0	0
14	34130372	.	C	T	0	3	3	0	1	4	0	0
14	34130397	.	C	T	3	1	4	0	1	5	0	0
14	34130458	.	G	A	3	6	9	0	1	10	0	0
14	34130690	.	C	T	4	4	8	0	0	8	0	0
14	34131056	.	T	C	12	10	22	0	0	22	0	0
14	34139713	.	G	A	2	5	7	0	0	7	0	0
14	34154746	.	C	T	0	2	2	0	6	8	0	0
14	34180461	.	A	G	3	2	5	0	1	6	0	0
14	34180491	.	G	A	2	2	4	0	1	5	0	0
14	34180557	.	T	G	6	2	8	0	1	9	0	0
14	34191157	.	G	A	3	2	5	0	0	5	0	0
14	34194564	.	A	G	2	4	6	0	0	6	0	0
14	34195879	.	C	T	0	1	1	0	0	1	0	0
14	34210874	.	C	A	0	3	3	0	4	7	0	0
14	34210898	.	C	T	3	3	6	0	0	6	0	0
14	34240844	.	G	A	4	2	6	0	0	6	0	0
14	34486663	.	C	A	7	4	11	0	0	11	0	0
14	34486720	.	A	G	11	1	12	0	11	23	0	0
14	34487972	.	C	T	4	1	5	0	0	5	0	0
14	34488456	.	T	C	3	24	27	0	2	29	0	0
14	34488687	.	C	A	29	22	51	0	3	54	0	0
14	34488787	.	G	T	36	16	52	0	2	54	0	0
14	34488843	.	C	A	20	6	26	0	0	26	0	0
14	34488929	.	C	T	3	3	6	0	0	6	0	0
14	34553502	.	A	G	0	2	2	0	0	2	0	0
14	34553535	.	G	A	0	1	1	0	0	1	0	0
14	34556758	.	C	T	2	2	4	0	1	5	0	0
14	34556986	.	C	T	6	4	10	0	0	10	0	0
14	34637134	.	A	T	1	1	2	0	0	2	0	0
14	34672611	.	C	T	1	1	2	0	0	2	0	0
14	34794940	.	A	T	2	3	5	0	0	5	0	0
14	34797711	.	T	C	8	4	12	0	0	12	0	0
14	34797810	.	C	A	6	3	9	1	0	10	0	0
14	34797908	.	T	C	2	4	6	0	0	6	0	0
14	34797972	.	C	T	6	2	8	0	0	8	0	0
14	34798017	.	C	T	7	4	11	0	1	12	0	0
14	34798031	.	C	T	4	4	8	0	2	10	0	0
14	34825745	.	T	C	8	7	15	0	1	16	0	0
14	34825761	.	A	G	9	6	15	0	0	15	0	0
14	34826502	.	T	A	2	2	4	0	0	4	0	0
14	34826951	.	T	A	3	3	6	0	0	6	0	0
14	34827938	.	A	G	1	2	3	0	0	3	0	0
14	34828113	.	G	T	2	4	6	0	1	7	0	0
14	34830026	.	T	C	1	2	3	0	0	3	0	0
14	35003880	.	C	T	3	5	8	0	0	8	0	0
14	35008665	.	C	T	4	6	10	0	0	10	0	0
14	35008780	.	T	A	7	7	14	0	0	14	0	0
14	35008804	.	T	C	7	8	15	0	0	15	0	0
14	35008885	.	G	A	1	4	5	0	0	5	0	0
14	35008887	.	C	A	1	4	5	0	0	5	0	0
14	35009182	.	T	A	2	2	4	0	0	4	0	0
14	35009651	.	T	C	19	12	31	0	4	35	0	0
14	35009652	.	G	T	21	14	35	0	0	35	0	0
14	35009736	.	A	T	12	11	23	0	0	23	0	0
14	35009739	.	A	G	12	8	20	0	0	20	0	0
14	35009989	.	G	A	0	4	4	0	3	7	0	0
14	35010026	.	A	T	11	5	16	0	0	16	0	0
14	35010230	.	C	T	8	11	19	0	0	19	0	0
14	35010236	.	A	T	9	13	22	0	0	22	0	0
14	35010936	.	T	A	4	5	9	0	1	10	0	0
14	35011140	.	G	A	7	6	13	0	3	16	0	0
14	35011174	.	C	T	9	7	16	0	0	17	1	0
14	35011301	.	C	T	11	10	21	0	1	22	0	0
14	35011398	.	G	T	6	5	11	0	0	11	0	0
14	35011445	.	C	A	11	2	13	0	0	13	0	0
14	35011570	.	C	T	8	16	24	0	1	25	0	0
14	35011857	.	G	A	10	9	19	0	1	20	0	0
14	35011944	.	G	A	6	13	19	0	2	21	0	0
14	35227456	.	C	T	1	2	3	0	0	3	0	0
14	35377283	.	C	A	2	0	2	0	0	2	0	0
14	35387478	.	T	C	2	9	11	0	0	11	0	0
14	35387545	.	T	C	2	1	3	0	0	3	0	0
14	35393022	.	G	A	3	3	6	0	0	6	0	0
14	35400356	.	T	C	2	2	4	0	0	4	0	0
14	35409510	.	A	G	5	2	7	0	0	7	0	0
14	35409903	.	A	T	4	5	9	0	1	10	0	0
14	35409940	.	G	T	3	3	6	0	0	6	0	0
14	35409944	.	C	A	3	3	6	0	0	6	0	0
14	35410166	.	C	A	0	2	2	0	1	3	0	0
14	35410583	.	G	A	6	3	9	0	0	9	0	0
14	35410992	.	G	A	5	4	9	0	1	10	0	0
14	35411076	.	C	T	4	4	8	0	0	8	0	0
14	35415591	.	T	C	1	1	2	0	0	2	0	0
14	35415615	.	C	A	0	1	1	0	1	2	0	0
14	35418186	.	G	A	0	3	3	0	0	3	0	0
14	35418190	.	G	A	0	3	3	0	0	3	0	0
14	35418290	.	A	C	1	0	1	0	0	1	0	0
14	35418300	.	C	A	1	0	1	0	0	1	0	0
14	35422417	.	T	C	4	4	8	0	0	8	0	0
14	35478598	.	G	A	1	2	3	0	0	3	0	0
14	35500249	.	G	T	8	11	19	0	1	20	0	0
14	35500300	.	A	C	4	0	4	0	6	10	0	0
14	35505312	.	C	A	0	4	4	0	15	19	0	0
14	35505376	.	C	A	7	5	12	0	1	13	0	0
14	35692149	.	A	G	3	3	6	0	0	6	0	0
14	35699039	.	G	A	4	4	8	0	1	9	0	0
14	35699109	.	C	A	5	3	8	0	0	8	0	0
14	35715815	.	T	C	1	2	3	0	1	4	0	0
14	35719354	.	G	A	5	12	17	0	1	18	0	0
14	35731558	.	C	T	19	32	51	0	4	55	0	0
14	35732110	.	C	T	13	6	19	0	2	21	0	0
14	35732189	.	C	T	4	2	6	0	0	6	0	0
14	35732195	.	C	T	2	3	5	0	0	5	0	0
14	35780186	.	G	A	1	9	10	0	15	25	0	0
14	35780249	.	G	A	5	7	12	0	0	12	0	0
14	35796120	.	C	T	16	5	21	0	0	21	0	0
14	35797645	.	T	A	7	2	9	0	0	9	0	0
14	35797654	.	G	A	0	6	6	0	2	8	0	0
14	35799400	.	G	A	4	3	7	0	0	7	0	0
14	35799409	.	C	T	3	1	4	0	0	4	0	0
14	35800228	.	T	C	18	8	26	0	1	27	0	0
14	35804592	.	T	C	3	2	5	0	0	5	0	0
14	35804688	.	G	A	21	22	43	0	0	43	0	0
14	35804833	.	A	G	0	2	2	0	0	2	0	0
14	35811971	.	C	T	28	26	54	0	1	55	0	0
14	35812355	.	G	A	30	20	50	0	2	52	0	0
14	35812718	.	C	A	20	24	44	0	4	48	0	0
14	35813367	.	C	A	25	26	51	0	2	53	0	0
14	35813384	.	G	A	0	23	23	0	31	54	0	0
14	35813407	.	C	T	23	34	57	0	1	58	0	0
14	35813424	.	C	T	19	31	50	0	5	55	0	0
14	35813479	.	T	A	21	29	50	0	1	52	1	0
14	35895983	.	G	A	1	2	3	0	0	3	0	0
14	35897751	.	A	T	1	2	3	0	0	3	0	0
14	35906286	.	A	T	0	1	1	0	1	2	0	0
14	35906312	.	T	C	2	3	5	0	1	6	0	0
14	35906345	.	C	A	3	2	5	0	0	5	0	0
14	36226312	.	C	T	1	3	4	0	0	4	0	0
14	36229211	.	T	A	8	7	15	0	0	15	0	0
14	36229227	.	T	G	5	6	11	0	1	13	1	0
14	36246854	.	C	T	14	15	29	0	1	30	0	0
14	36259377	.	G	A	0	4	4	0	1	5	0	0
14	36267395	.	C	A	14	17	31	0	0	31	0	0
14	36268152	.	C	T	9	6	15	0	0	15	0	0
14	36268339	.	C	T	12	14	26	0	0	26	0	0
14	36268426	.	T	C	0	4	4	0	1	5	0	0
14	36329023	.	C	A	0	2	2	0	3	5	0	0
14	36348652	.	G	A	4	7	11	0	0	11	0	0
14	36348793	.	A	G	10	18	28	0	1	29	0	0
14	36348878	.	G	A	20	24	44	0	3	47	0	0
14	36349387	.	A	T	29	37	66	0	3	69	0	0
14	36349409	.	A	G	27	32	59	0	10	69	0	0
14	36349607	.	C	G	4	34	38	0	36	75	1	0
14	36350639	.	G	T	38	25	63	0	4	67	0	0
14	36350669	.	T	C	38	2	40	0	28	68	0	0
14	36350917	.	A	T	37	24	61	0	1	62	0	0
14	36350932	.	T	A	32	28	60	0	1	61	0	0
14	36350980	.	T	C	23	0	23	0	24	47	0	0
14	36351004	.	C	T	20	25	45	0	0	45	0	0
14	36351064	.	G	A	41	17	58	0	1	59	0	0
14	36351143	.	A	G	39	25	64	0	1	65	0	0
14	36351148	.	C	T	38	26	64	0	1	65	0	0
14	36351209	.	G	A	28	30	58	0	0	58	0	0
14	36351217	.	A	G	27	28	55	0	2	57	0	0
14	36351347	.	G	A	26	36	62	0	2	64	0	0
14	36351350	.	C	T	39	25	64	0	1	65	0	0
14	36352148	.	T	C	25	2	27	0	36	63	0	0
14	36352265	.	G	A	3	1	4	0	0	4	0	0
14	36363689	.	G	A	24	10	34	0	3	37	0	0
14	36433568	.	T	C	2	0	2	0	3	5	0	0
14	36434258	.	C	T	0	1	1	0	0	1	0	0
14	36437002	.	T	C	2	1	3	0	0	3	0	0
14	36437217	.	C	A	2	3	5	0	0	5	0	0
14	36497659	.	C	T	1	0	1	0	0	1	0	0
14	36638417	.	C	T	0	2	2	0	0	2	0	0
14	36655991	.	C	T	1	1	2	0	0	2	0	0
14	36655994	.	C	T	1	1	2	0	0	2	0	0
14	36660823	.	A	C	1	2	3	0	0	3	0	0
14	36676112	.	T	G	2	5	7	0	0	7	0	0
14	36708741	.	T	C	2	2	4	0	0	4	0	0
14	36713653	.	A	G	2	0	2	0	3	5	0	0
14	36716843	.	T	C	4	3	7	0	0	7	0	0
14	36717107	.	T	C	1	3	4	0	0	4	0	0
14	36717230	.	T	C	7	4	11	0	0	11	0	0
14	36717315	.	A	G	5	0	5	0	4	9	0	0
14	36717320	.	A	G	6	4	10	0	0	10	0	0
14	36717368	.	T	C	4	2	6	0	1	7	0	0
14	36717374	.	T	C	5	2	7	0	1	8	0	0
14	36717629	.	T	C	1	2	3	0	0	3	0	0
14	36717689	.	C	T	3	4	7	0	0	7	0	0
14	36717800	.	G	A	4	2	6	0	1	7	0	0
14	36718265	.	C	T	0	1	1	0	0	1	0	0
14	36720770	.	C	T	2	9	11	0	1	12	0	0
14	36720985	.	A	G	8	3	11	0	0	11	0	0
14	36721033	.	A	G	5	0	5	0	8	13	0	0
14	36721102	.	T	A	2	10	12	0	1	13	0	0
14	36721153	.	G	A	4	9	13	0	0	13	0	0
14	36721175	.	C	G	5	7	12	0	0	12	0	0
14	36721229	.	G	A	5	5	10	0	0	10	0	0
14	36721379	.	G	C	1	6	7	0	1	8	0	0
14	36721437	.	G	A	0	7	7	0	3	10	0	0
14	36721497	.	C	G	9	8	17	0	0	17	0	0
14	36721564	.	G	A	5	3	8	0	0	8	0	0
14	36721599	.	C	A	5	3	8	0	0	8	0	0
14	36721675	.	T	C	2	5	7	0	0	7	0	0
14	36721676	.	G	A	2	5	7	0	0	7	0	0
14	36721724	.	T	A	5	3	8	0	0	8	0	0
14	36721730	.	T	A	5	2	7	0	0	7	0	0
14	36721984	.	G	C	4	4	8	0	1	9	0	0
14	36722015	.	C	T	3	5	8	0	0	8	0	0
14	36722095	.	T	C	5	6	11	0	1	12	0	0
14	36722140	.	C	A	4	4	8	0	1	9	0	0
14	36722364	.	C	T	8	5	13	0	0	13	0	0
14	36722405	.	G	A	13	8	21	0	1	22	0	0
14	36722568	.	A	T	2	10	12	0	2	14	0	0
14	36722601	.	T	G	3	0	3	0	8	11	0	0
14	36723134	.	A	T	4	5	9	0	1	10	0	0
14	36723213	.	G	A	5	2	7	0	2	9	0	0
14	36723270	.	A	G	5	0	5	0	8	13	0	0
14	36723276	.	T	C	4	7	11	0	4	15	0	0
14	36723326	.	C	T	9	8	17	0	2	19	0	0
14	36723367	.	A	C	10	1	11	0	0	11	0	0
14	36723402	.	C	G	8	5	13	0	0	13	0	0
14	36723690	.	C	G	4	2	6	0	0	6	0	0
14	36723694	.	C	A	4	3	7	0	0	7	0	0
14	36738081	.	T	G	2	2	4	0	0	4	0	0
14	36752477	.	T	C	2	2	4	0	1	5	0	0
14	36758413	.	A	C	0	0	0	0	3	3	0	0
14	36761340	.	A	C	0	0	0	0	1	1	0	0
14	36761663	.	C	T	2	4	6	0	0	6	0	0
14	36763191	.	A	T	1	2	3	0	0	3	0	0
14	36765662	.	G	A	4	3	7	0	1	8	0	0
14	36765721	.	C	T	12	6	18	0	1	19	0	0
14	36766273	.	A	T	10	8	18	0	0	18	0	0
14	36766394	.	A	C	10	10	20	0	3	23	0	0
14	36766624	.	T	A	8	7	15	0	2	17	0	0
14	36777121	.	A	G	5	2	7	0	0	7	0	0
14	36803100	.	G	T	11	5	16	0	0	16	0	0
14	36863407	.	T	C	2	0	2	0	3	5	0	0
14	37553282	.	C	A	1	3	4	0	1	5	0	0
14	37553438	.	C	T	1	3	4	0	0	4	0	0
14	37553618	.	T	C	3	2	5	0	0	5	0	0
14	37556752	.	T	A	4	5	9	0	0	9	0	0
14	38941554	.	T	C	0	1	1	0	0	1	0	0
14	39651463	.	C	T	1	3	4	0	0	4	0	0
14	39876050	.	G	C	1	1	2	0	0	2	0	0
14	39953291	.	G	A	4	4	8	0	0	8	0	0
14	39953293	.	C	T	4	4	8	0	0	8	0	0
14	39953337	.	T	A	4	3	7	0	0	7	0	0
14	39954169	.	C	T	3	2	5	0	0	5	0	0
14	39954272	.	A	G	4	3	7	0	1	8	0	0
14	39954356	.	T	C	2	5	7	0	0	7	0	0
14	39954493	.	A	G	1	3	4	0	0	4	0	0
14	39954572	.	C	T	4	3	7	0	0	7	0	0
14	39955231	.	T	A	2	5	7	0	0	7	0	0
14	39955278	.	C	A	2	6	8	0	0	8	0	0
14	39955448	.	C	T	7	9	16	0	0	16	0	0
14	39955457	.	C	A	8	6	14	0	0	14	0	0
14	39955612	.	A	T	6	6	12	0	1	13	0	0
14	39955646	.	T	C	7	4	11	0	1	12	0	0
14	39955772	.	T	A	9	4	13	0	0	13	0	0
14	39955823	.	T	C	3	4	7	0	0	7	0	0
14	39956075	.	G	A	6	7	13	1	0	14	0	0
14	39956380	.	T	C	4	3	7	0	0	7	0	0
14	39956804	.	G	T	4	6	10	0	0	10	0	0
14	39956825	.	T	C	5	3	8	0	0	8	0	0
14	39957077	.	C	G	2	11	13	0	1	14	0	0
14	39957304	.	T	G	1	7	8	0	0	8	0	0
14	40303348	.	A	T	23	11	34	0	2	36	0	0
14	40303366	.	C	T	25	6	31	0	2	33	0	0
14	40303775	.	T	C	7	4	11	0	5	16	0	0
14	40304488	.	C	G	2	12	14	0	15	29	0	0
14	40305230	.	G	A	18	16	34	0	1	35	0	0
14	40305287	.	C	A	1	22	23	0	12	36	1	0
14	40305635	.	C	T	1	19	20	0	12	32	0	0
14	40305659	.	C	T	0	18	18	0	17	35	0	0
14	40387603	.	C	T	9	5	14	0	2	16	0	0
14	40387627	.	G	A	8	9	17	0	2	19	0	0
14	40388107	.	A	G	15	12	27	0	1	28	0	0
14	40388185	.	A	G	11	8	19	0	0	19	0	0
14	40388440	.	G	A	11	15	26	0	1	27	0	0
14	40388460	.	T	G	10	11	21	0	2	23	0	0
14	40388629	.	T	C	7	12	19	0	1	20	0	0
14	40389145	.	C	G	10	5	15	0	0	15	0	0
14	40389789	.	A	T	1	8	9	0	0	9	0	0
14	40389823	.	T	A	1	9	10	0	0	10	0	0
14	40389978	.	C	T	4	5	9	0	0	9	0	0
14	40389988	.	T	A	6	6	12	0	0	12	0	0
14	40390587	.	G	T	5	4	9	0	0	9	0	0
14	41277456	.	T	C	20	4	24	0	1	25	0	0
14	41277518	.	T	C	10	29	39	0	1	40	0	0
14	41278386	.	C	T	25	8	33	0	1	34	0	0
14	41511540	.	G	A	1	2	3	1	0	4	0	0
14	41924593	.	T	C	1	2	3	0	0	3	0	0
14	42172306	.	C	T	0	2	2	0	0	2	0	0
14	42172389	.	A	C	6	5	11	0	0	11	0	0
14	42172396	.	C	T	6	6	12	0	0	12	0	0
14	42172527	.	G	A	0	6	6	0	5	11	0	0
14	42172732	.	G	A	0	3	3	0	4	7	0	0
14	42172745	.	C	T	4	4	8	0	0	8	0	0
14	42173572	.	A	T	6	3	9	0	0	9	0	0
14	42174385	.	C	T	3	12	15	0	0	15	0	0
14	42174401	.	C	T	2	11	13	0	1	14	0	0
14	42174645	.	A	T	12	6	18	0	0	18	0	0
14	42174724	.	C	T	8	16	24	0	0	24	0	0
14	42178503	.	C	T	8	5	13	0	1	14	0	0
14	42178626	.	C	T	12	12	24	0	0	24	0	0
14	42178728	.	G	A	11	11	22	0	1	23	0	0
14	42178974	.	G	A	15	9	24	0	3	27	0	0
14	42978742	.	T	C	1	0	1	0	3	4	0	0
14	42978789	.	G	A	5	10	15	0	0	15	0	0
14	42978975	.	A	G	16	9	25	0	0	25	0	0
14	42978980	.	A	C	14	10	24	0	0	24	0	0
14	42979090	.	T	A	5	9	14	0	1	15	0	0
14	42979233	.	G	C	12	10	22	0	4	26	0	0
14	42979513	.	C	T	15	20	35	0	2	37	0	0
14	42997943	.	G	A	10	18	28	0	2	30	0	0
14	42998114	.	G	A	12	17	29	0	0	29	0	0
14	42998740	.	A	G	10	16	26	0	0	26	0	0
14	42998900	.	G	A	7	7	14	0	1	15	0	0
14	42999314	.	C	T	8	8	16	0	0	16	0	0
14	42999662	.	T	C	6	9	15	0	2	17	0	0
14	43000743	.	T	A	3	2	5	0	0	5	0	0
14	43000785	.	A	T	5	7	12	0	0	12	0	0
14	43572499	.	A	G	1	3	4	0	0	4	0	0
14	43577704	.	G	A	8	8	16	0	1	17	0	0
14	43577916	.	G	A	1	0	1	0	0	1	0	0
14	43579983	.	A	G	10	8	18	0	0	18	0	0
14	43580004	.	A	G	7	5	12	0	0	12	0	0
14	43590849	.	C	T	1	2	3	0	0	3	0	0
14	43591152	.	G	T	6	6	12	0	0	12	0	0
14	43591188	.	G	A	12	11	23	0	1	24	0	0
14	43596699	.	G	A	4	13	17	0	0	17	0	0
14	43596774	.	C	A	3	2	5	0	0	5	0	0
14	43598196	.	C	T	0	1	1	0	1	2	0	0
14	43605462	.	C	T	3	6	9	0	0	9	0	0
14	43605498	.	T	C	4	1	5	0	6	11	0	0
14	43612822	.	T	C	3	5	8	0	0	8	0	0
14	43615151	.	G	A	1	1	2	0	0	2	0	0
14	44013794	.	C	A	6	4	10	0	0	10	0	0
14	44208093	.	G	A	0	1	1	0	2	3	0	0
14	44589624	.	C	T	9	12	21	0	1	22	0	0
14	44589711	.	T	A	8	10	18	0	0	18	0	0
14	44589834	.	A	G	11	5	16	0	1	17	0	0
14	44590297	.	G	C	10	11	21	0	0	21	0	0
14	44590301	.	A	G	10	1	11	0	10	21	0	0
14	44590644	.	C	T	16	17	33	0	1	34	0	0
14	44590838	.	T	A	12	12	24	0	0	24	0	0
14	44590935	.	G	A	0	11	11	0	16	27	0	0
14	44590992	.	A	G	10	8	18	0	0	18	0	0
14	45201220	.	C	T	0	2	2	0	2	4	0	0
14	45201255	.	C	G	1	2	3	0	0	3	0	0
14	45201361	.	C	T	1	2	3	0	0	3	0	0
14	45214236	.	T	C	3	2	5	0	0	5	0	0
14	45242058	.	C	A	1	2	3	0	0	3	0	0
14	45259961	.	A	G	3	7	10	0	0	10	0	0
14	45260118	.	C	T	3	6	9	0	0	9	0	0
14	45260381	.	G	T	4	3	7	0	0	7	0	0
14	45271464	.	G	A	7	6	13	0	1	14	0	0
14	45271622	.	T	C	2	8	10	0	1	11	0	0
14	45276551	.	T	C	3	11	14	0	0	14	0	0
14	45276603	.	G	A	0	7	7	0	3	10	0	0
14	45276629	.	C	G	4	5	9	0	0	9	0	0
14	45276671	.	C	T	4	6	10	0	3	13	0	0
14	45276826	.	T	C	2	7	9	0	0	9	0	0
14	45293316	.	T	G	7	3	10	0	2	12	0	0
14	45293345	.	C	G	8	0	8	0	4	12	0	0
14	45293390	.	G	A	7	8	15	0	0	15	0	0
14	45293511	.	G	A	0	6	6	0	8	14	0	0
14	45293599	.	G	T	4	4	8	0	0	8	0	0
14	45293625	.	A	G	3	5	8	0	0	8	0	0
14	45293640	.	T	A	5	7	12	0	0	12	0	0
14	45293722	.	G	A	1	4	5	0	0	5	0	0
14	45293898	.	C	T	1	3	4	0	0	4	0	0
14	45293956	.	G	A	3	4	7	0	0	7	0	0
14	45293965	.	G	A	2	6	8	0	0	8	0	0
14	45293995	.	G	A	7	6	13	0	0	13	0	0
14	45294114	.	C	A	5	6	11	0	0	11	0	0
14	45295314	.	T	C	3	6	9	0	0	9	0	0
14	45295547	.	A	G	2	3	5	0	0	5	0	0
14	45295548	.	A	G	3	2	5	0	0	5	0	0
14	45435045	.	T	C	1	4	5	0	0	5	0	0
14	45435597	.	T	C	3	4	7	0	0	7	0	0
14	45435891	.	T	C	4	11	15	0	0	15	0	0
14	45435978	.	T	C	3	0	3	0	7	10	0	0
14	45435982	.	T	C	5	4	9	0	0	9	0	0
14	45530665	.	T	C	1	1	2	0	0	2	0	0
14	45534043	.	T	G	0	1	1	0	0	1	0	0
14	45534178	.	A	G	5	4	9	0	1	10	0	0
14	45542357	.	T	A	1	0	1	0	0	1	0	0
14	45548614	.	G	A	1	2	3	0	0	3	0	0
14	45552410	.	A	G	0	3	3	0	0	3	0	0
14	45553777	.	G	C	1	2	3	0	0	3	0	0
14	45554089	.	A	C	1	4	5	0	0	5	0	0
14	45554374	.	A	T	2	3	5	0	0	5	0	0
14	45555686	.	G	C	0	3	3	0	0	3	0	0
14	45568736	.	G	T	2	5	7	0	0	7	0	0
14	45570967	.	G	A	10	18	28	0	1	29	0	0
14	45571124	.	A	T	5	3	8	0	0	8	0	0
14	45571501	.	G	A	8	10	18	0	1	19	0	0
14	45571593	.	C	T	8	5	13	1	1	15	0	0
14	45571679	.	T	C	5	4	9	0	1	10	0	0
14	45575139	.	G	A	2	3	5	0	1	6	0	0
14	45575203	.	C	A	8	4	12	0	0	12	0	0
14	45575214	.	T	C	9	1	10	0	7	17	0	0
14	45575336	.	A	G	11	6	17	0	0	17	0	0
14	45575495	.	T	C	12	9	21	0	0	21	0	0
14	45581382	.	T	C	2	0	2	0	0	2	0	0
14	45582312	.	C	A	0	7	7	0	12	19	0	0
14	45582314	.	T	A	10	7	17	0	2	19	0	0
14	45584078	.	T	C	4	0	4	0	9	13	0	0
14	45584312	.	T	C	7	7	14	0	1	15	0	0
14	45586237	.	G	A	2	3	5	0	1	6	0	0
14	45592634	.	T	C	1	2	3	0	0	3	0	0
14	45594741	.	C	T	2	3	5	0	0	5	0	0
14	45594753	.	T	C	1	4	5	0	0	5	0	0
14	45594792	.	G	C	1	0	1	0	0	1	0	0
14	45603874	.	C	T	11	4	15	0	0	15	0	0
14	45603951	.	T	C	15	0	15	0	6	21	0	0
14	45603976	.	G	A	10	5	15	0	0	15	0	0
14	45608886	.	A	G	8	7	15	0	1	16	0	0
14	45614526	.	C	G	4	0	4	0	7	11	0	0
14	45614795	.	A	G	5	0	5	0	2	7	0	0
14	45631345	.	C	T	0	9	9	0	4	13	0	0
14	45631716	.	C	T	10	9	19	0	0	19	0	0
14	45631768	.	G	T	21	12	33	0	1	35	1	0
14	45632834	.	A	C	24	30	54	0	1	55	0	0
14	45632967	.	T	C	19	2	21	0	22	43	0	0
14	45634860	.	A	T	31	46	77	0	2	79	0	0
14	45634960	.	C	T	4	30	34	0	15	49	0	0
14	45635333	.	C	T	6	41	47	0	35	82	0	0
14	45635767	.	T	C	39	45	84	0	7	91	0	0
14	45636078	.	A	G	13	6	19	0	2	21	0	0
14	45636701	.	G	A	33	12	45	0	4	49	0	0
14	45636716	.	T	A	41	7	48	0	1	49	0	0
14	45637058	.	C	G	23	27	50	0	8	58	0	0
14	45637103	.	A	C	25	2	27	0	18	45	0	0
14	45637200	.	C	T	28	31	59	0	4	63	0	0
14	45637201	.	T	A	29	32	61	0	2	63	0	0
14	45637382	.	A	G	16	11	27	0	3	30	0	0
14	45637545	.	T	G	18	8	26	0	4	30	0	0
14	45637804	.	G	T	18	29	47	0	0	47	0	0
14	45638280	.	G	C	20	29	49	0	1	50	0	0
14	45638509	.	C	T	13	21	34	0	1	35	0	0
14	45638562	.	T	G	16	19	35	0	1	36	0	0
14	45638563	.	T	A	14	19	33	0	3	36	0	0
14	45769019	.	T	C	1	3	4	0	0	4	0	0
14	45789912	.	T	G	4	3	7	0	0	7	0	0
14	45789920	.	G	A	3	1	4	0	0	4	0	0
14	45790275	.	A	C	4	0	4	0	4	8	0	0
14	45925992	.	A	C	2	2	4	0	0	4	0	0
14	45926559	.	T	C	1	3	4	0	0	4	0	0
14	45926910	.	C	T	1	2	3	0	0	3	0	0
14	45927849	.	C	T	1	2	3	0	0	3	0	0
14	45927861	.	T	C	1	2	3	0	0	3	0	0
14	45928333	.	T	G	2	2	4	0	1	5	0	0
14	45928533	.	A	G	1	2	3	0	1	4	0	0
14	45928539	.	A	G	2	2	4	0	0	4	0	0
14	45929280	.	C	T	4	2	6	0	0	6	0	0
14	45929591	.	T	A	3	2	5	0	0	5	0	0
14	45929837	.	T	A	5	4	9	0	0	9	0	0
14	45929974	.	T	C	2	3	5	0	1	6	0	0
14	45930135	.	T	C	5	2	7	0	0	7	0	0
14	45930196	.	A	C	4	2	6	0	0	6	0	0
14	45930399	.	C	T	2	7	9	0	0	9	0	0
14	45930508	.	A	G	2	4	6	0	1	7	0	0
14	45930515	.	G	A	3	3	6	0	0	6	0	0
14	45930572	.	A	G	3	2	5	0	0	5	0	0
14	45930573	.	T	G	3	1	4	0	1	5	0	0
14	45930617	.	A	G	4	1	5	0	0	5	0	0
14	45930669	.	A	G	7	4	11	0	0	11	0	0
14	45930735	.	T	A	5	2	7	0	0	8	1	0
14	45930794	.	G	A	7	4	11	0	0	11	0	0
14	45931079	.	C	G	9	6	15	0	0	15	0	0
14	45931194	.	G	T	11	12	23	0	1	24	0	0
14	45931504	.	C	G	9	8	17	0	0	17	0	0
14	45931637	.	C	T	10	6	16	0	1	17	0	0
14	45931899	.	C	T	4	6	10	0	1	11	0	0
14	45932128	.	T	G	11	2	13	0	1	14	0	0
14	46007306	.	A	G	5	9	14	0	0	14	0	0
14	46007321	.	G	A	3	5	8	0	0	8	0	0
14	46009611	.	G	A	10	7	17	0	2	19	0	0
14	46009683	.	A	T	3	1	4	0	1	5	0	0
14	46010711	.	C	T	2	0	2	0	0	2	0	0
14	46010909	.	T	C	0	2	2	0	1	3	0	0
14	46013121	.	A	T	2	4	6	0	0	6	0	0
14	46013402	.	C	T	6	21	27	0	1	28	0	0
14	46015888	.	C	A	2	1	3	0	0	3	0	0
14	46016107	.	A	G	3	3	6	0	0	6	0	0
14	46017969	.	G	A	12	16	28	0	1	29	0	0
14	46018029	.	C	T	12	14	26	0	1	27	0	0
14	46018548	.	A	G	9	22	31	0	1	32	0	0
14	46018560	.	A	G	21	6	27	0	1	28	0	0
14	46028329	.	G	T	5	4	9	0	0	9	0	0
14	46028330	.	T	A	5	4	9	0	0	9	0	0
14	46028376	.	G	A	3	3	6	0	0	6	0	0
14	46028548	.	G	C	0	1	1	0	0	1	0	0
14	46037489	.	T	C	6	4	10	0	0	10	0	0
14	46039751	.	T	C	9	6	15	0	0	15	0	0
14	46039904	.	C	G	5	0	5	0	4	9	0	0
14	46040318	.	T	C	3	4	7	0	0	7	0	0
14	46041036	.	G	A	4	4	8	0	0	8	0	0
14	46041325	.	A	G	1	2	3	0	0	3	0	0
14	46041763	.	T	G	2	4	6	0	1	7	0	0
14	46041800	.	C	T	3	6	9	0	0	9	0	0
14	46041861	.	A	T	14	6	20	0	1	21	0	0
14	46048396	.	A	G	5	4	9	0	0	9	0	0
14	46048644	.	C	T	0	13	13	0	10	23	0	0
14	46048704	.	C	G	0	11	11	0	10	21	0	0
14	46048875	.	T	C	10	19	29	0	2	31	0	0
14	46052172	.	T	A	6	11	17	0	2	19	0	0
14	46052244	.	G	T	9	4	13	0	0	13	0	0
14	46067317	.	A	T	2	2	4	0	0	5	1	0
14	46074568	.	C	T	5	1	6	0	0	6	0	0
14	46074576	.	G	A	5	0	5	0	0	5	0	0
14	46074626	.	C	G	5	3	8	0	0	8	0	0
14	46074646	.	G	T	6	3	9	0	0	9	0	0
14	46075015	.	T	C	2	4	6	0	0	6	0	0
14	46075016	.	T	C	3	3	6	0	0	6	0	0
14	46075749	.	A	G	4	5	9	0	0	9	0	0
14	46075937	.	T	A	6	2	8	0	0	8	0	0
14	46076110	.	C	T	2	2	4	0	0	4	0	0
14	46076120	.	A	G	2	1	3	0	0	3	0	0
14	46076407	.	T	C	2	2	4	0	0	4	0	0
14	46076858	.	T	C	1	2	3	0	0	3	0	0
14	46089176	.	C	T	3	4	7	0	0	7	0	0
14	46089297	.	A	C	5	2	7	0	1	8	0	0
14	46089433	.	T	G	4	2	6	0	0	6	0	0
14	46089532	.	T	C	6	2	8	0	0	8	0	0
14	46090027	.	T	C	3	0	3	0	3	6	0	0
14	46090508	.	T	A	4	3	7	0	0	7	0	0
14	46094922	.	C	T	7	10	17	0	3	20	0	0
14	46095043	.	A	G	22	8	30	0	0	30	0	0
14	46095058	.	A	G	22	4	26	0	2	28	0	0
14	46095108	.	A	G	21	27	48	0	0	48	0	0
14	46104150	.	C	T	10	5	15	0	3	18	0	0
14	46104222	.	C	T	0	4	4	0	4	8	0	0
14	46104935	.	G	A	5	5	10	0	0	10	0	0
14	46114944	.	G	A	0	1	1	0	0	1	0	0
14	46133637	.	T	C	1	3	4	0	1	5	0	0
14	46146715	.	G	A	9	2	11	0	2	13	0	0
14	46146730	.	G	A	8	2	10	0	1	11	0	0
14	46154358	.	C	A	12	7	19	0	1	20	0	0
14	46154561	.	G	A	0	9	9	0	4	13	0	0
14	46154713	.	A	G	4	8	12	0	1	13	0	0
14	46154723	.	G	A	9	5	14	0	1	15	0	0
14	46154798	.	T	C	6	7	13	0	0	13	0	0
14	46154854	.	G	T	1	10	11	0	8	19	0	0
14	46182249	.	G	A	2	3	5	0	1	6	0	0
14	46182994	.	C	T	2	2	4	0	0	4	0	0
14	46183009	.	A	T	2	2	4	0	0	4	0	0
14	46183099	.	C	T	1	3	4	0	0	4	0	0
14	46183535	.	A	G	2	3	5	0	0	5	0	0
14	46184509	.	G	C	0	5	5	0	0	5	0	0
14	46184576	.	A	G	3	0	3	0	4	7	0	0
14	46184953	.	G	C	1	3	4	0	0	4	0	0
14	46185313	.	T	C	2	2	4	0	0	4	0	0
14	46185334	.	A	T	2	4	6	0	1	7	0	0
14	46185402	.	G	C	5	2	7	0	0	7	0	0
14	46186092	.	T	C	2	3	5	0	0	5	0	0
14	46186175	.	T	G	3	2	5	0	0	5	0	0
14	46186746	.	G	A	0	4	4	1	4	9	0	0
14	46186827	.	A	G	7	0	7	0	8	15	0	0
14	46187544	.	C	T	2	2	4	0	0	4	0	0
14	46187641	.	C	T	2	4	6	0	2	8	0	0
14	46187644	.	T	G	2	0	2	0	6	8	0	0
14	46187730	.	G	A	4	2	6	0	1	7	0	0
14	46187879	.	C	T	2	2	4	0	0	4	0	0
14	46188109	.	A	T	12	5	17	0	0	17	0	0
14	46188114	.	C	T	4	11	15	0	0	15	0	0
14	46188561	.	A	C	8	11	19	0	0	19	0	0
14	46188578	.	C	T	11	5	16	0	0	16	0	0
14	46189008	.	G	C	2	0	2	0	0	2	0	0
14	46189037	.	C	T	2	1	3	0	0	3	0	0
14	46189130	.	G	A	12	5	17	0	0	17	0	0
14	46189158	.	C	T	10	7	17	0	0	17	0	0
14	46189173	.	G	T	9	5	14	0	1	15	0	0
14	46189251	.	A	G	6	9	15	0	1	16	0	0
14	46189268	.	C	T	7	7	14	0	1	15	0	0
14	46189342	.	T	C	3	6	9	0	0	9	0	0
14	46189460	.	T	C	8	5	13	0	1	14	0	0
14	46189531	.	C	T	1	7	8	0	0	8	0	0
14	46200128	.	G	A	10	11	21	0	2	23	0	0
14	46200244	.	A	C	11	8	19	0	0	19	0	0
14	46200396	.	A	G	7	4	11	0	0	11	0	0
14	46200422	.	A	T	6	6	12	0	1	13	0	0
14	46200445	.	C	A	7	7	14	0	0	14	0	0
14	46200636	.	G	T	20	6	26	0	0	26	0	0
14	46200814	.	G	A	16	11	27	0	0	27	0	0
14	46204139	.	A	G	11	9	20	0	0	20	0	0
14	46206097	.	C	G	0	4	4	0	11	15	0	0
14	46208722	.	G	A	8	10	18	0	0	18	0	0
14	46208725	.	T	C	11	9	20	0	0	20	0	0
14	46208818	.	A	T	15	7	22	0	1	23	0	0
14	46210481	.	G	A	1	4	5	0	0	5	0	0
14	46211002	.	G	T	1	5	6	0	0	6	0	0
14	46346878	.	T	A	2	1	3	0	0	3	0	0
14	46352475	.	A	T	16	12	28	0	1	29	0	0
14	46352654	.	A	T	11	8	19	0	0	19	0	0
14	46376580	.	C	T	1	1	2	0	1	3	0	0
14	46442029	.	G	A	1	2	3	0	0	3	0	0
14	46456501	.	T	G	16	17	33	0	4	37	0	0
14	46456905	.	T	A	9	18	27	0	1	28	0	0
14	46456989	.	C	T	17	8	25	0	1	26	0	0
14	46457009	.	T	G	12	10	22	0	2	24	0	0
14	46457684	.	A	G	3	5	8	0	0	8	0	0
14	46457700	.	A	G	2	4	6	0	1	7	0	0
14	46458185	.	T	G	5	2	7	0	0	7	0	0
14	46458338	.	C	G	4	5	9	0	1	10	0	0
14	46458790	.	A	G	3	5	8	0	0	8	0	0
14	46458915	.	C	G	5	10	15	0	0	15	0	0
14	46459269	.	G	A	3	3	6	0	0	6	0	0
14	46495047	.	G	A	0	1	1	0	0	1	0	0
14	46503589	.	A	C	0	0	0	0	2	2	0	0
14	46540360	.	C	T	4	3	7	0	0	7	0	0
14	46633753	.	G	C	2	2	4	0	0	4	0	0
14	46678919	.	A	G	1	9	10	0	0	10	0	0
14	46679263	.	C	T	10	2	12	0	1	13	0	0
14	46679304	.	A	G	10	6	16	0	1	17	0	0
14	46679307	.	A	T	8	5	13	0	2	16	1	0
14	46679348	.	C	T	8	7	15	0	0	15	0	0
14	46679375	.	C	T	6	3	9	0	1	10	0	0
14	46679902	.	A	C	6	2	8	3	0	11	0	0
14	46679912	.	G	A	6	5	11	2	0	13	0	0
14	46679999	.	A	G	15	6	21	0	1	22	0	0
14	46680043	.	T	C	12	5	17	2	1	20	0	0
14	46680183	.	G	T	1	3	4	0	1	5	0	0
14	46680210	.	G	T	8	4	12	0	0	12	0	0
14	46680226	.	C	A	12	4	16	0	0	16	0	0
14	46680904	.	A	T	5	3	8	0	0	8	0	0
14	46680966	.	T	C	10	4	14	0	0	14	0	0
14	46681005	.	A	C	6	8	14	0	0	14	0	0
14	46681020	.	T	A	4	9	13	0	0	13	0	0
14	46682783	.	A	C	3	7	10	0	0	10	0	0
14	46682877	.	T	G	4	3	7	0	1	8	0	0
14	46683101	.	T	A	4	6	10	0	1	11	0	0
14	46683419	.	A	G	2	2	4	0	0	4	0	0
14	46683431	.	C	T	1	2	3	0	0	3	0	0
14	46683502	.	A	G	2	2	4	0	0	4	0	0
14	46683725	.	A	G	2	2	4	0	0	4	0	0
14	46684102	.	C	T	0	3	3	0	5	8	0	0
14	46684195	.	A	C	5	4	9	0	0	9	0	0
14	46684227	.	T	C	6	5	11	0	0	11	0	0
14	46684233	.	G	T	6	3	9	0	2	11	0	0
14	46684565	.	C	T	6	3	9	0	0	9	0	0
14	46684800	.	T	G	8	4	12	0	1	13	0	0
14	46789421	.	A	G	1	2	3	0	0	3	0	0
14	46873289	.	T	C	3	1	4	0	0	4	0	0
14	46873315	.	T	C	4	2	6	0	0	6	0	0
14	46873439	.	C	A	5	5	10	0	0	10	0	0
14	46873543	.	G	A	7	4	11	0	2	13	0	0
14	46873806	.	G	A	4	6	10	0	2	12	0	0
14	46873868	.	C	T	9	4	13	0	0	13	0	0
14	46874001	.	G	A	11	9	20	0	0	20	0	0
14	46874095	.	G	A	4	4	8	0	0	8	0	0
14	46874098	.	T	A	3	5	8	0	1	9	0	0
14	46874605	.	T	A	4	1	5	0	1	6	0	0
14	46874740	.	C	T	3	2	5	0	2	7	0	0
14	46876680	.	G	A	2	2	4	0	0	4	0	0
14	46876711	.	T	A	4	2	6	0	1	7	0	0
14	46876717	.	A	T	4	3	7	0	1	8	0	0
14	46876970	.	C	T	9	3	12	0	0	12	0	0
14	46877085	.	T	C	3	2	5	0	0	5	0	0
14	47142035	.	A	G	2	1	3	0	0	3	0	0
14	47264962	.	T	C	4	0	4	0	3	7	0	0
14	47265031	.	A	G	3	3	6	0	0	6	0	0
14	47882878	.	T	A	1	4	5	0	0	5	0	0
14	48107558	.	C	T	1	2	3	0	0	3	0	0
14	48740763	.	T	C	1	2	3	0	0	3	0	0
14	48740764	.	T	C	1	2	3	0	0	3	0	0
14	48932470	.	T	A	28	14	42	0	0	42	0	0
14	48932712	.	G	A	11	20	31	0	0	31	0	0
14	48932880	.	A	T	33	11	44	0	0	44	0	0
14	48932970	.	T	A	11	22	33	0	3	36	0	0
14	48933224	.	A	G	25	17	42	0	2	44	0	0
14	48933273	.	C	A	24	13	37	1	0	38	0	0
14	48933361	.	T	A	26	11	37	0	0	37	0	0
14	48933513	.	T	C	10	8	18	0	1	19	0	0
14	48933575	.	A	G	15	5	20	0	2	22	0	0
14	48934025	.	G	A	10	25	35	0	3	38	0	0
14	48934052	.	G	A	12	22	34	0	3	37	0	0
14	48934253	.	G	A	20	5	25	0	0	25	0	0
14	48934276	.	G	A	19	4	23	0	0	23	0	0
14	48934299	.	C	A	13	1	14	0	0	14	0	0
14	48934547	.	A	T	22	21	43	0	0	43	0	0
14	48934577	.	G	T	24	22	46	0	1	47	0	0
14	48934630	.	C	G	24	8	32	0	2	34	0	0
14	48934639	.	T	C	26	0	26	0	5	31	0	0
14	48934701	.	T	C	14	20	34	0	5	39	0	0
14	48934719	.	T	G	19	21	40	0	1	41	0	0
14	48934829	.	T	A	21	17	38	0	7	45	0	0
14	48945057	.	T	C	1	4	5	0	0	5	0	0
14	48964697	.	T	C	9	9	18	0	0	18	0	0
14	48995443	.	G	A	0	1	1	0	0	1	0	0
14	48995894	.	C	A	2	5	7	0	0	7	0	0
14	48995962	.	A	T	3	3	6	0	0	6	0	0
14	48997367	.	G	A	1	4	5	0	0	5	0	0
14	48997882	.	C	G	0	2	2	0	0	2	0	0
14	49015183	.	T	C	0	2	2	0	0	2	0	0
14	49015393	.	C	T	1	1	2	0	0	2	0	0
14	49021945	.	C	T	5	5	10	0	0	10	0	0
14	49021960	.	C	T	4	6	10	0	1	11	0	0
14	49022002	.	C	T	5	2	7	0	0	7	0	0
14	49022071	.	A	G	2	0	2	0	5	7	0	0
14	49022145	.	A	G	5	0	5	0	10	15	0	0
14	49022290	.	G	T	0	3	3	0	5	8	0	0
14	49022328	.	T	C	3	3	6	0	0	6	0	0
14	49028477	.	T	A	0	1	1	0	0	1	0	0
14	49029159	.	C	A	4	2	6	0	0	6	0	0
14	49030054	.	A	G	6	2	8	0	1	9	0	0
14	49030155	.	C	T	3	3	6	0	0	6	0	0
14	49031081	.	T	G	1	1	2	0	2	4	0	0
14	49031086	.	G	A	3	2	5	0	0	5	0	0
14	49031116	.	C	T	3	4	7	0	0	7	0	0
14	49031149	.	T	C	2	7	9	0	0	9	0	0
14	49031162	.	C	T	3	7	10	0	0	10	0	0
14	49031304	.	T	A	4	8	12	0	0	12	0	0
14	49031382	.	G	T	11	7	18	0	0	18	0	0
14	49031385	.	G	A	10	7	17	0	0	17	0	0
14	49040303	.	A	C	3	3	6	0	0	6	0	0
14	49040308	.	T	A	4	3	7	0	0	7	0	0
14	49040425	.	A	G	2	7	9	0	0	9	0	0
14	49040563	.	T	A	7	10	17	0	1	18	0	0
14	49040574	.	G	A	6	9	15	0	0	15	0	0
14	49040773	.	G	A	2	5	7	0	1	8	0	0
14	49047525	.	T	G	9	14	23	0	2	25	0	0
14	49053391	.	G	A	0	6	6	0	0	6	0	0
14	49053402	.	C	G	0	6	6	0	0	6	0	0
14	49053431	.	T	G	2	5	7	0	0	7	0	0
14	49057237	.	T	C	2	4	6	0	0	6	0	0
14	49079061	.	C	T	1	2	3	0	0	3	0	0
14	49079067	.	A	C	1	2	3	0	0	3	0	0
14	49091420	.	G	A	0	2	2	0	0	2	0	0
14	49119048	.	G	T	7	19	26	0	1	27	0	0
14	49119062	.	G	A	24	12	36	0	0	36	0	0
14	49119115	.	T	G	25	23	48	0	3	51	0	0
14	49119192	.	T	A	14	22	36	0	2	38	0	0
14	49119321	.	A	C	24	29	53	0	3	56	0	0
14	49119484	.	T	A	23	15	38	0	2	40	0	0
14	49124645	.	G	C	2	6	8	0	0	8	0	0
14	49124711	.	A	C	10	16	26	0	3	29	0	0
14	49126924	.	G	A	7	9	16	0	1	17	0	0
14	49133139	.	A	G	10	9	19	0	0	19	0	0
14	49135328	.	A	T	12	16	28	0	0	28	0	0
14	49136483	.	C	T	17	10	27	0	2	29	0	0
14	49136530	.	T	G	5	2	7	0	9	16	0	0
14	49136835	.	G	A	8	10	18	0	1	19	0	0
14	49136886	.	C	A	6	7	13	0	0	13	0	0
14	49136909	.	C	T	5	4	9	0	1	10	0	0
14	49152660	.	A	T	1	0	1	0	0	1	0	0
14	49172185	.	A	T	1	2	3	0	1	4	0	0
14	49172884	.	C	A	5	3	8	0	0	8	0	0
14	49174995	.	G	T	4	1	5	0	0	5	0	0
14	49175348	.	T	A	2	3	5	0	0	5	0	0
14	49182980	.	T	G	1	1	2	0	0	2	0	0
14	49192488	.	C	T	2	3	5	0	0	5	0	0
14	49192533	.	A	G	2	0	2	0	4	6	0	0
14	49195504	.	C	T	0	2	2	0	0	2	0	0
14	49202015	.	C	T	4	2	6	0	1	7	0	0
14	49203983	.	C	T	2	0	2	0	0	2	0	0
14	49204136	.	G	A	0	1	1	0	4	5	0	0
14	49206876	.	G	C	2	2	4	0	2	6	0	0
14	49206879	.	C	T	2	4	6	0	0	6	0	0
14	49206948	.	G	A	0	2	2	0	0	2	0	0
14	49209848	.	G	A	0	0	0	0	2	2	0	0
14	49209983	.	C	T	7	6	13	0	1	14	0	0
14	49210055	.	T	C	2	4	6	0	2	8	0	0
14	49210231	.	A	G	6	3	9	0	1	10	0	0
14	49210569	.	G	C	6	4	10	0	0	10	0	0
14	49210686	.	T	G	0	2	2	0	0	2	0	0
14	49211001	.	A	G	6	4	10	0	0	10	0	0
14	49211045	.	T	C	5	6	11	0	2	13	0	0
14	49211172	.	A	G	1	4	5	0	0	5	0	0
14	49211545	.	G	A	0	2	2	0	7	9	0	0
14	49212350	.	C	T	6	3	9	0	0	9	0	0
14	49212395	.	T	C	6	4	10	0	1	11	0	0
14	49212415	.	A	G	3	0	3	0	3	6	0	0
14	49212501	.	A	G	3	3	6	0	0	6	0	0
14	49212505	.	A	G	0	3	3	0	2	5	0	0
14	49212547	.	A	G	5	0	5	0	3	8	0	0
14	49212550	.	A	G	5	3	8	0	0	8	0	0
14	49212586	.	A	G	3	4	7	0	0	7	0	0
14	49212716	.	A	G	3	4	7	0	1	8	0	0
14	49212744	.	A	G	5	3	8	0	1	9	0	0
14	49212757	.	A	T	6	4	10	0	0	10	0	0
14	49212838	.	C	T	2	3	5	0	0	5	0	0
14	49212867	.	A	C	2	2	4	0	0	4	0	0
14	49212887	.	A	C	1	2	3	0	1	4	0	0
14	49212985	.	A	T	5	2	7	0	0	7	0	0
14	49212986	.	G	A	5	2	7	0	0	7	0	0
14	49213126	.	A	T	7	7	14	0	0	14	0	0
14	49213250	.	C	T	3	7	10	0	0	10	0	0
14	49213725	.	A	G	2	4	6	0	0	6	0	0
14	49213732	.	A	G	1	5	6	0	0	6	0	0
14	49213871	.	A	T	3	2	5	0	0	5	0	0
14	49213926	.	A	C	0	2	2	0	0	2	0	0
14	49214158	.	G	A	6	3	9	0	0	9	0	0
14	49214170	.	A	G	6	0	6	0	3	9	0	0
14	49214286	.	T	G	3	2	5	0	1	6	0	0
14	49214323	.	A	T	3	2	5	0	0	5	0	0
14	49214347	.	T	G	3	0	3	0	2	5	0	0
14	49214392	.	G	A	3	2	5	0	1	6	0	0
14	49231813	.	C	T	2	4	6	0	0	6	0	0
14	49231903	.	C	G	1	4	5	0	0	5	0	0
14	49233937	.	A	G	1	1	2	0	1	3	0	0
14	49236476	.	A	G	2	4	6	0	0	6	0	0
14	49237917	.	A	G	1	5	6	0	0	6	0	0
14	49244377	.	T	C	12	20	32	0	1	33	0	0
14	49244425	.	A	G	16	0	16	0	22	38	0	0
14	49244496	.	C	T	19	11	30	0	0	30	0	0
14	49244740	.	A	T	13	10	23	0	0	23	0	0
14	49244874	.	A	G	7	8	15	0	0	15	0	0
14	49245255	.	G	C	10	17	27	0	0	27	0	0
14	49430817	.	A	G	12	17	29	0	1	30	0	0
14	49865367	.	T	A	8	10	18	0	1	19	0	0
14	49865508	.	G	A	12	11	23	0	1	25	1	0
14	49865563	.	C	T	6	5	11	0	0	11	0	0
14	49865711	.	A	G	13	19	32	0	2	34	0	0
14	49865747	.	C	T	1	22	23	0	13	36	0	0
14	49878814	.	T	C	3	0	3	0	6	9	0	0
14	49938797	.	C	A	3	3	6	0	0	6	0	0
14	49939493	.	C	T	0	1	1	0	0	1	0	0
14	49939498	.	A	G	0	1	1	0	0	1	0	0
14	49943137	.	G	A	3	3	6	0	1	7	0	0
14	49943171	.	G	T	10	5	15	0	0	15	0	0
14	49943185	.	T	A	14	7	21	0	0	21	0	0
14	49947717	.	T	C	4	5	9	0	0	9	0	0
14	49947724	.	C	T	5	5	10	0	0	10	0	0
14	49947846	.	G	A	5	3	8	0	0	8	0	0
14	49947868	.	T	C	3	0	3	0	6	9	0	0
14	49948196	.	G	T	5	3	8	0	0	8	0	0
14	49948589	.	G	A	3	8	11	0	0	11	0	0
14	49952434	.	C	A	0	2	2	0	4	6	0	0
14	49952515	.	A	G	8	6	14	0	0	14	0	0
14	49952554	.	A	G	9	8	17	0	0	17	0	0
14	49952819	.	G	A	5	8	13	0	2	15	0	0
14	49953128	.	A	G	4	2	6	0	0	6	0	0
14	49962203	.	C	T	1	1	2	0	0	2	0	0
14	49962227	.	A	G	1	3	4	0	0	4	0	0
14	49962383	.	G	A	1	0	1	0	0	1	0	0
14	49970407	.	A	G	3	1	4	0	0	4	0	0
14	49992217	.	A	C	3	2	5	0	0	5	0	0
14	49997004	.	G	A	1	5	6	0	0	6	0	0
14	49997040	.	A	G	1	2	3	0	1	4	0	0
14	49997043	.	T	C	1	3	4	0	0	4	0	0
14	49997115	.	G	A	2	4	6	0	0	6	0	0
14	49997246	.	A	G	1	4	5	0	0	5	0	0
14	49997276	.	G	A	1	2	3	0	0	3	0	0
14	49997867	.	G	A	3	1	4	0	1	5	0	0
14	50027311	.	A	G	1	0	1	0	0	1	0	0
14	50798988	.	C	T	7	6	13	0	1	14	0	0
14	50808063	.	A	C	1	2	3	0	0	3	0	0
14	50815277	.	T	C	2	2	4	0	0	4	0	0
14	50815344	.	C	A	1	2	3	0	0	3	0	0
14	50815375	.	A	T	1	3	4	0	0	4	0	0
14	50815384	.	A	G	1	1	2	0	2	4	0	0
14	50944705	.	C	A	3	1	4	0	1	5	0	0
14	50950535	.	T	C	3	9	12	0	0	12	0	0
14	50962369	.	T	C	1	2	3	0	0	3	0	0
14	50964260	.	C	T	0	1	1	0	0	1	0	0
14	50968017	.	T	C	0	5	5	0	0	5	0	0
14	50972229	.	A	T	2	2	4	0	0	4	0	0
14	50972733	.	G	A	0	4	4	0	3	7	0	0
14	50972921	.	G	A	0	3	3	0	1	4	0	0
14	50973219	.	A	G	4	8	12	0	1	13	0	0
14	50973374	.	C	A	1	4	5	0	0	5	0	0
14	50973537	.	G	C	2	4	6	0	0	6	0	0
14	50973563	.	T	A	3	4	7	0	0	7	0	0
14	50974433	.	A	G	1	0	1	0	6	7	0	0
14	50974538	.	C	A	1	5	6	0	0	6	0	0
14	50974827	.	A	G	1	2	3	0	0	3	0	0
14	50975094	.	A	G	3	3	6	0	1	7	0	0
14	50994361	.	A	G	6	7	13	0	0	13	0	0
14	50994436	.	C	G	3	7	10	0	1	11	0	0
14	50994687	.	G	T	22	10	32	0	2	34	0	0
14	50994695	.	G	C	19	12	31	0	2	33	0	0
14	50999698	.	A	G	10	9	19	0	1	20	0	0
14	51002874	.	G	C	7	0	7	0	6	13	0	0
14	51014221	.	T	G	1	0	1	0	0	1	0	0
14	51015245	.	C	T	10	10	20	0	1	21	0	0
14	51015264	.	A	G	12	14	26	0	3	29	0	0
14	51015359	.	G	C	7	4	11	0	0	11	0	0
14	51017771	.	G	A	0	21	21	0	6	27	0	0
14	51017841	.	A	G	7	17	24	0	0	24	0	0
14	51017906	.	A	T	8	5	13	0	1	14	0	0
14	51017952	.	G	A	1	7	8	0	8	16	0	0
14	51024089	.	A	G	0	2	2	0	0	2	0	0
14	51038976	.	A	G	2	3	5	0	0	5	0	0
14	51038980	.	G	T	2	3	5	0	0	5	0	0
14	51829341	.	G	A	47	28	75	0	1	76	0	0
14	51830952	.	G	A	2	9	11	0	1	12	0	0
14	52358971	.	G	C	3	2	5	0	0	5	0	0
14	52366401	.	G	A	7	6	13	0	0	13	0	0
14	52379740	.	T	A	10	10	20	0	2	22	0	0
14	52379749	.	T	A	8	10	18	0	2	20	0	0
14	52379937	.	G	A	0	3	3	0	2	5	0	0
14	52383871	.	G	A	7	5	12	0	0	12	0	0
14	52386667	.	G	A	7	7	14	0	0	14	0	0
14	52388115	.	G	A	0	3	3	0	0	3	0	0
14	52388136	.	G	C	0	3	3	0	0	3	0	0
14	52388357	.	G	A	1	0	1	0	0	1	0	0
14	52397323	.	G	A	3	5	8	0	0	8	0	0
14	52399977	.	A	G	1	2	3	0	0	3	0	0
14	52408677	.	C	T	2	2	4	0	0	4	0	0
14	52408678	.	A	G	2	1	3	0	1	4	0	0
14	52411301	.	G	A	0	7	7	0	4	11	0	0
14	52411315	.	C	G	3	7	10	0	0	10	0	0
14	52413182	.	C	T	3	3	6	0	0	6	0	0
14	52417384	.	C	T	5	5	10	0	1	11	0	0
14	52417385	.	T	C	5	6	11	0	0	11	0	0
14	52417537	.	C	T	6	3	9	0	0	9	0	0
14	52417555	.	T	C	5	2	7	0	0	7	0	0
14	52418070	.	T	G	5	6	11	0	0	11	0	0
14	52418307	.	T	G	4	8	12	0	0	12	0	0
14	52418308	.	T	A	3	8	11	0	1	12	0	0
14	52418565	.	T	G	9	0	9	0	7	16	0	0
14	52418772	.	G	T	7	4	11	0	0	11	0	0
14	52418818	.	A	G	6	7	13	0	0	13	0	0
14	52490168	.	C	G	5	5	10	0	0	10	0	0
14	52490198	.	G	A	0	2	2	0	6	8	0	0
14	52517782	.	T	A	6	2	8	0	1	9	0	0
14	52517957	.	T	C	8	11	19	0	1	20	0	0
14	52518002	.	A	G	8	6	14	0	1	15	0	0
14	52518030	.	G	A	0	12	12	0	9	21	0	0
14	52518125	.	C	A	7	9	16	0	1	17	0	0
14	52518278	.	G	C	0	6	6	0	6	12	0	0
14	52518538	.	T	C	2	3	5	0	1	6	0	0
14	52518542	.	G	A	3	2	5	0	1	6	0	0
14	52522732	.	G	A	6	4	10	0	0	10	0	0
14	52522820	.	T	C	10	9	19	0	0	19	0	0
14	52522822	.	C	T	10	9	19	0	0	19	0	0
14	52522876	.	C	T	5	8	13	0	2	15	0	0
14	52523087	.	G	A	15	13	28	0	0	28	0	0
14	52523131	.	G	A	3	7	10	0	0	10	0	0
14	52523290	.	C	T	0	7	7	0	4	11	0	0
14	52523707	.	A	G	5	9	14	0	0	14	0	0
14	52523798	.	C	T	8	6	14	0	1	15	0	0
14	52524195	.	C	A	11	4	15	0	0	15	0	0
14	52524307	.	G	A	4	10	14	0	0	14	0	0
14	52524399	.	G	A	4	4	8	0	0	8	0	0
14	52524525	.	A	T	1	6	7	0	0	7	0	0
14	52524603	.	C	T	4	4	8	0	0	8	0	0
14	52524651	.	A	T	12	2	14	0	2	16	0	0
14	52524792	.	A	G	5	3	8	0	0	8	0	0
14	52524889	.	G	A	2	2	4	0	0	4	0	0
14	52524890	.	A	T	2	2	4	0	0	4	0	0
14	52525016	.	C	T	1	6	7	0	13	20	0	0
14	52525326	.	C	T	1	5	6	0	8	14	0	0
14	52525340	.	T	A	10	3	13	0	0	13	0	0
14	52525673	.	G	A	6	5	11	0	0	11	0	0
14	52525812	.	C	T	0	6	6	0	12	18	0	0
14	52528210	.	G	A	2	0	2	0	0	2	0	0
14	52531368	.	G	C	9	0	9	0	6	15	0	0
14	52531384	.	T	C	7	4	11	0	2	13	0	0
14	52533500	.	G	A	7	10	17	0	0	17	0	0
14	52533578	.	T	C	6	4	10	0	0	10	0	0
14	52533584	.	T	C	5	0	5	0	3	8	0	0
14	52538887	.	G	A	6	8	14	0	0	14	0	0
14	52565823	.	C	T	6	2	8	0	0	8	0	0
14	52571230	.	A	G	1	2	3	0	0	3	0	0
14	52574434	.	C	G	2	4	6	0	1	7	0	0
14	52574497	.	C	A	0	2	2	0	0	2	0	0
14	52574520	.	C	T	1	2	3	0	0	3	0	0
14	52575095	.	T	A	4	4	8	0	0	8	0	0
14	52575646	.	C	T	1	4	5	0	1	6	0	0
14	52575738	.	C	T	4	4	8	0	4	12	0	0
14	52575878	.	A	G	7	3	10	0	2	12	0	0
14	52575879	.	T	A	5	5	10	0	2	12	0	0
14	52577036	.	G	A	5	4	9	0	0	9	0	0
14	52580608	.	G	A	2	5	7	0	0	7	0	0
14	52583001	.	C	A	2	6	8	0	1	9	0	0
15	636847	.	G	A	1	2	3	0	0	3	0	0
15	784368	.	G	C	3	2	5	0	0	5	0	0
15	886233	.	A	G	1	0	1	0	2	3	0	0
15	894804	.	G	A	0	3	3	0	1	4	0	0
15	910070	.	T	A	1	2	3	0	0	3	0	0
15	1026323	.	A	G	2	3	5	0	0	5	0	0
15	1026440	.	G	C	3	2	5	0	0	5	0	0
15	1026462	.	G	A	2	2	4	0	0	4	0	0
15	1033479	.	T	G	3	5	8	0	0	8	0	0
15	1033564	.	G	T	3	4	7	0	0	7	0	0
15	1033853	.	A	G	4	3	7	0	0	7	0	0
15	1033955	.	C	T	0	5	5	0	2	7	0	0
15	1036614	.	C	T	0	0	0	0	1	1	0	0
15	1036677	.	C	T	0	2	2	0	4	6	0	0
15	1036825	.	T	C	2	3	5	0	0	5	0	0
15	1152067	.	T	C	1	1	2	0	1	3	0	0
15	1173067	.	C	T	5	4	9	0	0	9	0	0
15	1173542	.	C	T	3	3	6	0	0	6	0	0
15	1176447	.	G	A	1	5	6	0	10	16	0	0
15	1178927	.	C	A	6	6	12	0	0	12	0	0
15	1183930	.	G	T	2	2	4	0	0	4	0	0
15	1183984	.	C	T	0	7	7	0	8	15	0	0
15	1186181	.	A	G	3	10	13	0	0	13	0	0
15	1186202	.	C	T	0	9	9	0	3	12	0	0
15	1189664	.	C	T	9	9	18	0	3	21	0	0
15	1191750	.	A	G	4	3	7	0	0	7	0	0
15	1191792	.	G	A	1	5	6	0	12	18	0	0
15	1191822	.	A	G	10	0	10	0	5	15	0	0
15	1194590	.	A	G	15	8	23	0	1	24	0	0
15	1194619	.	G	A	0	10	10	0	13	23	0	0
15	1194633	.	A	G	10	10	20	0	0	20	0	0
15	1194670	.	G	A	15	6	21	0	2	23	0	0
15	1194739	.	G	T	5	4	9	0	1	10	0	0
15	1194754	.	T	C	5	3	8	0	3	11	0	0
15	1417032	.	G	A	0	13	13	0	19	32	0	0
15	1417104	.	C	T	2	0	2	0	1	3	0	0
15	1434192	.	T	A	25	16	41	0	2	43	0	0
15	1434228	.	T	C	23	14	37	0	2	39	0	0
15	1434786	.	T	C	8	15	23	0	2	25	0	0
15	1434792	.	G	A	7	22	29	0	1	30	0	0
15	1434885	.	T	C	18	16	34	0	1	35	0	0
15	1435024	.	T	C	16	9	25	0	2	27	0	0
15	1435047	.	A	G	18	13	31	0	3	34	0	0
15	1435176	.	A	G	22	0	22	0	19	41	0	0
15	1435368	.	T	A	18	14	32	0	2	34	0	0
15	1435462	.	G	A	0	8	8	0	20	28	0	0
15	1435626	.	G	A	14	8	22	0	1	23	0	0
15	1435680	.	T	A	19	5	24	0	0	24	0	0
15	1436041	.	C	A	14	7	21	0	0	22	1	0
15	1436072	.	T	A	16	19	35	0	3	38	0	0
15	1436154	.	T	C	5	30	35	0	2	37	0	0
15	1436386	.	G	A	0	22	22	0	25	47	0	0
15	1436457	.	C	A	11	13	24	0	11	35	0	0
15	1436461	.	A	G	11	17	28	0	6	34	0	0
15	1436537	.	C	T	16	26	42	0	3	45	0	0
15	1436629	.	T	C	6	7	13	0	1	14	0	0
15	1453153	.	T	C	1	3	4	0	1	5	0	0
15	1453163	.	G	C	2	2	4	0	0	4	0	0
15	1495037	.	C	A	0	1	1	0	1	2	0	0
15	1495040	.	C	T	1	1	2	0	0	2	0	0
15	1497353	.	G	A	4	4	8	0	0	8	0	0
15	1497398	.	C	G	3	11	14	0	1	15	0	0
15	1497443	.	A	G	4	6	10	0	0	10	0	0
15	1497982	.	T	A	3	1	4	0	0	4	0	0
15	1499732	.	C	T	4	1	5	0	0	5	0	0
15	1502474	.	A	C	3	1	4	0	0	4	0	0
15	1506503	.	C	T	0	3	3	0	6	9	0	0
15	1606802	.	G	C	9	2	11	0	9	20	0	0
15	1607707	.	G	A	2	7	9	0	0	9	0	0
15	1612770	.	T	C	1	1	2	0	0	2	0	0
15	1617111	.	G	A	1	2	3	0	0	3	0	0
15	1622341	.	C	T	11	6	17	0	0	17	0	0
15	1622390	.	G	C	19	0	19	0	17	36	0	0
15	1630895	.	G	T	4	6	10	0	0	10	0	0
15	1631004	.	C	A	2	1	3	0	0	3	0	0
15	1631011	.	T	A	1	1	2	0	0	2	0	0
15	1631209	.	T	C	4	0	4	0	11	15	0	0
15	1631336	.	A	T	5	15	20	0	1	21	0	0
15	1631345	.	C	T	5	21	26	0	0	26	0	0
15	1631408	.	C	T	0	22	22	0	5	27	0	0
15	1631528	.	G	A	4	10	14	0	0	14	0	0
15	1633353	.	A	G	3	18	21	0	1	22	0	0
15	1651295	.	G	A	5	16	21	0	0	21	0	0
15	1651298	.	A	G	4	14	18	0	3	21	0	0
15	1651555	.	G	C	3	0	3	0	6	9	0	0
15	1651634	.	C	A	6	9	15	0	0	15	0	0
15	1661684	.	T	C	0	2	2	0	0	2	0	0
15	1661732	.	T	C	0	2	2	0	0	2	0	0
15	1667813	.	T	C	1	3	4	0	0	4	0	0
15	1669719	.	C	T	2	2	4	0	0	4	0	0
15	1672050	.	G	A	0	4	4	0	1	5	0	0
15	1672060	.	G	A	1	5	6	0	0	6	0	0
15	1672130	.	C	T	6	4	10	0	0	10	0	0
15	1672151	.	A	C	4	4	8	0	0	8	0	0
15	1680090	.	C	T	4	4	8	0	0	8	0	0
15	1680092	.	A	C	4	4	8	0	0	8	0	0
15	1682103	.	T	C	3	2	5	0	0	5	0	0
15	1682674	.	G	A	3	3	6	0	1	7	0	0
15	1719109	.	T	C	2	0	2	0	2	4	0	0
15	1719144	.	C	T	1	2	3	0	0	3	0	0
15	1719371	.	C	T	0	3	3	0	5	8	0	0
15	1719389	.	A	G	4	5	9	0	0	9	0	0
15	1719413	.	C	T	0	3	3	0	4	7	0	0
15	1730643	.	A	G	3	2	5	0	0	5	0	0
15	1750044	.	G	C	4	6	10	0	0	10	0	0
15	1750047	.	A	C	3	7	10	0	1	11	0	0
15	1753501	.	A	G	0	2	2	0	0	2	0	0
15	1758037	.	C	T	0	1	1	0	0	1	0	0
15	1758058	.	G	A	0	1	1	0	0	1	0	0
15	1758636	.	G	A	0	2	2	0	1	3	0	0
15	1758675	.	T	C	1	0	1	0	1	2	0	0
15	1766675	.	C	T	4	3	7	0	0	7	0	0
15	1774417	.	T	C	0	2	2	0	0	2	0	0
15	1778720	.	C	T	0	2	2	0	0	2	0	0
15	1782156	.	T	C	5	6	11	0	1	12	0	0
15	1789281	.	T	A	9	13	22	0	2	24	0	0
15	1789302	.	T	C	6	12	18	0	1	19	0	0
15	1792532	.	T	G	11	6	17	0	2	19	0	0
15	1799057	.	T	G	2	0	2	0	4	6	0	0
15	1801577	.	C	T	2	2	4	0	0	4	0	0
15	1801609	.	C	T	0	2	2	0	1	3	0	0
15	1801618	.	A	C	1	1	2	0	0	2	0	0
15	1828388	.	C	T	4	5	9	0	0	9	0	0
15	1829166	.	C	T	10	7	17	0	1	18	0	0
15	1830259	.	T	C	2	1	3	0	0	3	0	0
15	1830275	.	A	G	2	1	3	0	0	3	0	0
15	1830452	.	G	A	2	5	7	0	0	7	0	0
15	1834326	.	A	G	11	11	22	0	0	22	0	0
15	1837854	.	T	G	4	6	10	0	0	10	0	0
15	1837878	.	G	T	0	4	4	0	0	4	0	0
15	1847358	.	A	G	7	6	13	0	0	13	0	0
15	1847432	.	A	C	14	5	19	0	1	20	0	0
15	1847533	.	C	T	8	5	13	0	0	13	0	0
15	1847679	.	A	G	9	5	14	0	0	14	0	0
15	1847728	.	G	A	11	7	18	0	1	19	0	0
15	1847755	.	G	T	9	10	19	0	1	20	0	0
15	1847908	.	A	C	10	8	18	0	1	19	0	0
15	1847931	.	G	A	7	7	14	0	0	14	0	0
15	1847951	.	G	A	6	4	10	0	1	11	0	0
15	1848098	.	T	C	4	6	10	0	0	10	0	0
15	1848106	.	T	C	5	5	10	0	1	11	0	0
15	1848135	.	T	C	7	0	7	0	7	14	0	0
15	1848188	.	T	C	6	0	6	0	6	12	0	0
15	1848202	.	G	T	2	5	7	0	1	8	0	0
15	1848612	.	G	C	1	0	1	0	4	5	0	0
15	1858712	.	T	C	1	0	1	0	2	3	0	0
15	1858715	.	A	G	1	2	3	0	0	3	0	0
15	1871248	.	G	A	2	2	4	0	0	4	0	0
15	1893323	.	G	A	0	7	7	0	11	18	0	0
15	1893356	.	A	G	5	0	5	0	3	8	0	0
15	1897928	.	T	A	4	6	10	0	0	10	0	0
15	1898051	.	A	C	5	4	9	0	0	9	0	0
15	1898173	.	T	A	2	4	6	0	0	6	0	0
15	1898187	.	C	A	3	4	7	0	1	8	0	0
15	1898359	.	G	T	2	6	8	0	0	8	0	0
15	1898384	.	T	C	1	3	4	0	0	4	0	0
15	1899401	.	A	T	4	4	8	0	0	8	0	0
15	1899831	.	G	A	8	18	26	0	3	29	0	0
15	1899878	.	T	C	11	9	20	0	2	22	0	0
15	1902259	.	A	G	2	2	4	0	0	4	0	0
15	1902271	.	C	T	2	2	4	0	0	4	0	0
15	1903029	.	A	G	6	1	7	0	0	7	0	0
15	1905364	.	T	G	4	5	9	0	0	9	0	0
15	1905412	.	T	C	2	5	7	0	0	7	0	0
15	1914743	.	G	A	1	0	1	0	0	1	0	0
15	1926926	.	A	T	0	1	1	0	0	1	0	0
15	2414214	.	A	G	6	4	10	0	0	10	0	0
15	2414764	.	A	G	5	3	8	0	0	8	0	0
15	2415216	.	A	G	3	1	4	0	0	4	0	0
15	2415228	.	A	G	2	3	5	0	1	6	0	0
15	2415256	.	A	G	3	0	3	0	3	6	0	0
15	2729508	.	T	C	0	0	0	0	3	3	0	0
15	2729515	.	T	C	0	0	0	0	2	2	0	0
15	2729971	.	T	C	4	8	12	0	3	15	0	0
15	2730358	.	T	C	4	7	11	0	3	14	0	0
15	2730399	.	T	C	16	4	20	0	0	20	0	0
15	2855334	.	T	A	1	2	3	0	1	4	0	0
15	3160212	.	A	G	1	3	4	0	0	4	0	0
15	3160990	.	A	G	4	5	9	0	0	9	0	0
15	3377050	.	C	G	5	6	11	0	1	13	1	0
15	3377106	.	C	T	3	3	6	0	1	7	0	0
15	3900322	.	A	C	1	3	4	0	0	4	0	0
15	3900485	.	G	A	2	3	5	0	0	5	0	0
15	3920926	.	A	G	1	0	1	0	2	3	0	0
15	3921292	.	A	G	0	0	0	0	3	3	0	0
15	3922677	.	G	A	2	4	6	0	0	6	0	0
15	3922718	.	T	C	1	3	4	0	0	4	0	0
15	3922949	.	T	A	1	3	4	0	0	4	0	0
15	3924312	.	A	T	5	2	7	0	0	7	0	0
15	3924471	.	C	T	2	2	4	0	0	4	0	0
15	3924542	.	G	A	3	2	5	0	0	5	0	0
15	3925206	.	G	T	0	2	2	0	1	3	0	0
15	3925241	.	A	T	1	4	5	0	0	5	0	0
15	3925276	.	A	T	1	3	4	0	0	4	0	0
15	3925286	.	G	A	1	2	3	0	1	4	0	0
15	3927437	.	G	A	0	2	2	0	0	2	0	0
15	3927438	.	G	A	0	2	2	0	0	2	0	0
15	3927637	.	T	C	1	2	3	0	0	3	0	0
15	4105009	.	A	G	4	9	13	0	0	13	0	0
15	4105235	.	T	C	6	3	9	0	0	9	0	0
15	4105262	.	A	G	5	4	9	0	0	9	0	0
15	4105328	.	A	G	4	2	6	0	1	7	0	0
15	4105416	.	G	T	3	5	8	0	0	8	0	0
15	4111821	.	A	G	2	0	2	0	0	2	0	0
15	4112123	.	A	T	1	3	4	0	0	4	0	0
15	4112132	.	T	C	1	3	4	0	0	4	0	0
15	4112233	.	C	T	2	1	3	0	0	3	0	0
15	4119323	.	G	A	3	2	5	0	0	5	0	0
15	4119329	.	A	G	2	3	5	0	1	6	0	0
15	4172366	.	C	G	3	3	6	0	0	6	0	0
15	4172371	.	G	T	3	2	5	0	0	5	0	0
15	4174147	.	T	G	0	3	3	0	0	3	0	0
15	4174174	.	C	T	0	3	3	0	0	3	0	0
15	4174191	.	G	T	0	3	3	0	0	3	0	0
15	4177160	.	C	A	8	4	12	0	0	12	0	0
15	4210264	.	C	G	1	0	1	0	0	1	0	0
15	4210315	.	G	A	2	2	4	0	0	4	0	0
15	4214139	.	T	C	0	2	2	0	0	2	0	0
15	4353311	.	G	T	9	18	27	0	1	28	0	0
15	4353353	.	C	T	8	15	23	0	0	23	0	0
15	4353858	.	C	T	27	23	50	0	3	53	0	0
15	4353965	.	G	A	32	29	61	0	8	69	0	0
15	4354071	.	G	A	37	28	65	0	3	68	0	0
15	4367594	.	T	C	29	32	61	0	1	62	0	0
15	4371833	.	T	C	10	9	19	0	0	19	0	0
15	4371863	.	C	T	6	4	10	0	1	11	0	0
15	4422496	.	A	G	2	4	6	0	0	6	0	0
15	4422514	.	G	C	4	4	8	0	1	9	0	0
15	4422580	.	A	G	1	3	4	0	0	4	0	0
15	4585282	.	T	C	3	0	3	0	2	5	0	0
15	4585316	.	C	A	0	2	2	0	2	4	0	0
15	4585517	.	T	C	11	0	11	0	10	21	0	0
15	4585771	.	T	A	9	9	18	0	0	18	0	0
15	4586190	.	C	G	1	19	20	0	15	35	0	0
15	4586235	.	A	G	14	15	29	0	0	29	0	0
15	4586299	.	G	T	5	6	11	0	2	13	0	0
15	4633700	.	C	G	17	0	17	0	29	46	0	0
15	4634063	.	C	T	19	24	43	0	2	45	0	0
15	4634196	.	T	C	22	22	44	0	1	45	0	0
15	4634354	.	A	G	17	25	42	0	2	44	0	0
15	4634454	.	A	G	24	28	52	0	3	55	0	0
15	4634627	.	A	G	17	13	30	0	4	34	0	0
15	4634698	.	C	A	19	3	22	1	1	24	0	0
15	4635055	.	G	A	2	34	36	0	17	53	0	0
15	4635073	.	T	C	15	36	51	0	2	53	0	0
15	4635179	.	C	A	30	23	53	0	3	56	0	0
15	4635387	.	C	T	24	16	40	0	6	46	0	0
15	4635517	.	G	A	21	13	34	0	1	35	0	0
15	4635573	.	C	T	27	12	39	0	1	40	0	0
15	4635730	.	G	A	13	5	18	0	0	18	0	0
15	4969267	.	T	C	3	2	5	0	4	9	0	0
15	4969331	.	C	T	4	3	7	0	0	7	0	0
15	4969522	.	C	G	2	3	5	0	0	5	0	0
15	4969558	.	C	T	1	1	2	0	0	2	0	0
15	4976152	.	A	C	1	0	1	0	0	1	0	0
15	4976164	.	C	T	1	0	1	0	0	1	0	0
15	4981963	.	C	T	2	3	5	0	0	5	0	0
15	4982502	.	G	T	1	3	4	0	0	4	0	0
15	4982609	.	A	G	5	2	7	0	0	7	0	0
15	4982614	.	T	C	3	5	8	0	0	8	0	0
15	4982744	.	C	A	3	2	5	0	2	7	0	0
15	4982828	.	A	T	3	1	4	0	1	5	0	0
15	4983708	.	A	T	4	4	8	0	0	8	0	0
15	4983781	.	T	C	3	4	7	0	0	7	0	0
15	4984277	.	G	T	0	3	3	0	0	3	0	0
15	4984303	.	T	C	0	4	4	0	0	4	0	0
15	4984740	.	T	C	4	6	10	0	1	11	0	0
15	4984759	.	T	C	5	8	13	0	2	15	0	0
15	4991716	.	T	C	1	1	2	0	0	2	0	0
15	4991722	.	A	G	1	0	1	0	1	2	0	0
15	4995166	.	A	G	7	13	20	0	1	21	0	0
15	4999347	.	G	C	7	11	18	0	1	19	0	0
15	4999572	.	G	C	13	13	26	0	2	28	0	0
15	5054514	.	C	G	0	0	0	0	1	1	0	0
15	5073641	.	G	A	0	2	2	0	0	2	0	0
15	5073848	.	A	G	4	0	4	0	6	10	0	0
15	5074033	.	G	A	3	3	6	0	2	8	0	0
15	5074298	.	T	C	2	3	5	0	0	5	0	0
15	5074718	.	A	T	1	3	4	0	1	5	0	0
15	5074793	.	T	G	4	2	6	0	0	6	0	0
15	5074799	.	T	C	3	2	5	0	0	5	0	0
15	5074873	.	A	G	7	3	10	0	1	11	0	0
15	5133457	.	G	A	1	0	1	0	0	1	0	0
15	5140867	.	A	T	4	1	5	0	1	6	0	0
15	5140882	.	G	A	4	2	6	0	0	6	0	0
15	5144775	.	T	C	1	0	1	0	0	1	0	0
15	5144805	.	A	C	3	1	4	0	0	4	0	0
15	5144931	.	G	A	1	0	1	0	0	1	0	0
15	5147722	.	T	C	5	3	8	0	3	11	0	0
15	5147723	.	A	T	5	4	9	0	2	11	0	0
15	5147843	.	C	T	6	3	9	0	0	9	0	0
15	5147987	.	T	C	2	7	9	0	0	9	0	0
15	5148519	.	T	A	2	2	4	0	0	4	0	0
15	5403687	.	A	C	1	3	4	0	0	4	0	0
15	5406334	.	A	G	2	3	5	0	0	5	0	0
15	5467178	.	T	G	3	3	6	0	0	6	0	0
15	5467289	.	C	T	1	6	7	0	5	12	0	0
15	5566452	.	C	A	0	2	2	0	0	2	0	0
15	5632677	.	A	G	3	2	5	0	1	6	0	0
15	5632683	.	C	T	3	1	4	0	2	6	0	0
15	5645211	.	A	G	3	4	7	0	0	7	0	0
15	5660030	.	G	A	4	2	6	0	0	6	0	0
15	5679683	.	C	T	0	2	2	0	2	4	0	0
15	5723734	.	C	A	2	4	6	0	0	6	0	0
15	5723938	.	T	G	7	6	13	0	0	13	0	0
15	5723980	.	C	G	0	6	6	0	8	14	0	0
15	5726178	.	T	A	3	7	10	0	0	10	0	0
15	5728461	.	A	G	3	3	6	0	1	7	0	0
15	5738967	.	A	G	2	0	2	0	0	2	0	0
15	5829662	.	A	C	3	0	3	0	3	6	0	0
15	5829881	.	A	C	2	0	2	0	4	6	0	0
15	5829922	.	C	T	7	7	14	0	0	14	0	0
15	5830106	.	G	T	4	5	9	0	0	9	0	0
15	5830218	.	T	C	2	5	7	0	0	7	0	0
15	5830383	.	T	C	1	6	7	0	0	7	0	0
15	5830443	.	T	G	5	5	10	0	1	11	0	0
15	5830655	.	C	T	0	3	3	0	4	7	0	0
15	5830691	.	T	C	1	4	5	0	0	5	0	0
15	5830740	.	G	T	6	6	12	0	0	12	0	0
15	5831375	.	T	G	6	3	9	0	0	9	0	0
15	5831388	.	C	T	1	5	6	0	0	6	0	0
15	5836499	.	G	A	3	2	5	0	0	5	0	0
15	5836532	.	C	T	1	2	3	0	0	3	0	0
15	5836542	.	C	T	1	2	3	0	0	3	0	0
15	5836610	.	G	T	6	4	10	0	1	11	0	0
15	5837181	.	T	C	1	1	2	0	1	3	0	0
15	5853119	.	A	T	3	2	5	0	0	5	0	0
15	5857224	.	A	G	2	2	4	0	0	4	0	0
15	5898511	.	T	A	10	9	19	0	2	21	0	0
15	5898856	.	A	G	16	20	36	0	4	40	0	0
15	5898920	.	A	C	18	14	32	0	0	32	0	0
15	5899083	.	C	T	0	19	19	0	20	39	0	0
15	5899113	.	G	A	0	28	28	0	3	35	4	0
15	5899237	.	C	A	0	9	9	0	13	22	0	0
15	5899277	.	A	G	6	4	10	0	1	11	0	0
15	5904761	.	T	C	11	5	16	0	0	16	0	0
15	5914994	.	G	A	0	0	0	0	4	4	0	0
15	5916387	.	C	A	16	17	33	0	3	36	0	0
15	5916389	.	G	C	18	18	36	0	0	36	0	0
15	5916442	.	G	A	10	10	20	0	2	22	0	0
15	6139624	.	G	C	9	7	16	0	1	17	0	0
15	6139800	.	G	A	14	26	40	0	3	43	0	0
15	6139803	.	C	T	15	23	38	0	5	43	0	0
15	6154439	.	T	A	9	9	18	0	0	18	0	0
15	6161235	.	A	G	1	1	2	0	0	2	0	0
15	6161789	.	A	G	5	4	9	0	0	9	0	0
15	6161804	.	C	T	1	2	3	0	0	3	0	0
15	6174544	.	T	G	6	4	10	0	0	10	0	0
15	6186503	.	A	G	1	1	2	0	0	2	0	0
15	6217600	.	A	G	6	3	9	0	0	9	0	0
15	6234255	.	G	A	8	6	14	0	1	15	0	0
15	6515063	.	T	C	1	2	3	0	0	3	0	0
15	6541406	.	A	G	1	2	3	0	0	3	0	0
15	6652600	.	T	C	8	12	20	0	1	21	0	0
15	6653094	.	T	G	1	2	3	0	0	3	0	0
15	6653209	.	G	T	0	1	1	0	0	1	0	0
15	6653282	.	C	G	0	2	2	0	0	2	0	0
15	6654524	.	T	G	1	2	3	0	1	4	0	0
15	6654587	.	C	A	12	13	25	0	1	26	0	0
15	6659159	.	G	A	9	4	13	0	0	13	0	0
15	6661390	.	G	A	7	14	21	0	1	22	0	0
15	6661449	.	T	C	8	13	21	0	0	21	0	0
15	6661499	.	G	A	0	1	1	0	0	1	0	0
15	6778813	.	A	G	0	2	2	0	0	2	0	0
15	6778825	.	A	G	0	2	2	0	0	2	0	0
15	6778856	.	C	A	4	4	8	0	0	8	0	0
15	6778877	.	A	G	3	4	7	0	1	8	0	0
15	6784093	.	T	C	1	3	4	0	0	4	0	0
15	6784118	.	C	T	1	3	4	0	0	4	0	0
15	6799903	.	G	A	1	4	5	0	0	5	0	0
15	6806712	.	G	C	17	19	36	0	3	39	0	0
15	6806836	.	G	A	9	13	22	0	3	25	0	0
15	6806912	.	T	G	7	15	22	0	0	22	0	0
15	6806931	.	T	G	7	10	17	0	0	17	0	0
15	6807014	.	A	T	4	2	6	0	1	7	0	0
15	6807406	.	C	A	1	8	9	0	1	10	0	0
15	6807500	.	C	G	15	13	28	0	0	28	0	0
15	6807514	.	G	A	12	13	25	0	3	28	0	0
15	6807563	.	A	T	13	20	33	0	1	34	0	0
15	6807874	.	C	T	4	9	13	0	1	14	0	0
15	6838126	.	G	A	3	2	5	0	0	5	0	0
15	6838554	.	T	C	7	0	7	0	3	10	0	0
15	6838580	.	G	C	6	4	10	0	0	10	0	0
15	6838771	.	T	C	6	3	9	0	0	9	0	0
15	6838786	.	T	C	6	3	9	0	0	9	0	0
15	6845567	.	A	G	1	3	4	0	0	4	0	0
15	6845636	.	T	A	4	1	5	0	0	5	0	0
15	6863048	.	C	T	0	0	0	0	1	1	0	0
15	7300900	.	T	C	2	3	5	0	0	5	0	0
15	7300901	.	T	C	2	0	2	0	3	5	0	0
15	8394927	.	T	G	3	3	6	0	0	6	0	0
15	8394942	.	G	A	3	4	7	0	0	7	0	0
15	8394965	.	G	A	0	4	4	0	3	7	0	0
15	8394987	.	C	T	3	2	5	0	0	5	0	0
15	8399624	.	C	T	2	2	4	0	0	4	0	0
15	8425772	.	G	A	3	3	6	0	0	6	0	0
15	8426123	.	T	G	2	5	7	0	0	7	0	0
15	8426205	.	A	T	1	2	3	0	0	3	0	0
15	8426594	.	T	C	0	0	0	0	3	3	0	0
15	8427062	.	A	G	3	3	6	0	1	7	0	0
15	8604835	.	A	C	6	12	18	2	0	20	0	0
15	8605259	.	C	A	13	14	27	0	0	27	0	0
15	8605318	.	G	A	9	13	22	0	0	22	0	0
15	8605452	.	C	A	10	10	20	0	1	21	0	0
15	8605838	.	T	A	10	10	20	0	3	23	0	0
15	8605839	.	A	T	10	11	21	0	2	23	0	0
15	8605972	.	T	A	15	11	26	0	0	26	0	0
15	8606207	.	A	T	5	6	11	0	0	11	0	0
15	8606224	.	G	A	5	6	11	0	0	11	0	0
15	8606256	.	A	C	9	6	15	0	2	17	0	0
15	8606464	.	A	G	9	12	21	0	1	22	0	0
15	8606501	.	G	A	6	13	19	0	1	20	0	0
15	8606507	.	G	A	6	12	18	0	1	19	0	0
15	8606555	.	C	T	5	8	13	0	0	13	0	0
15	8606601	.	A	C	6	9	15	0	0	15	0	0
15	8606619	.	A	G	7	8	15	0	1	16	0	0
15	8606733	.	T	C	4	2	6	0	0	6	0	0
15	8606739	.	A	T	4	5	9	0	0	9	0	0
15	8606799	.	T	G	4	4	8	0	0	8	0	0
15	8606872	.	C	A	7	11	18	0	0	18	0	0
15	8606897	.	T	C	13	5	18	0	0	18	0	0
15	8606940	.	T	G	8	12	20	0	0	20	0	0
15	8606943	.	T	G	8	13	21	0	0	21	0	0
15	8607025	.	T	A	6	15	21	0	1	22	0	0
15	8607182	.	T	A	6	13	19	0	0	19	0	0
15	8607365	.	G	T	7	15	22	0	11	33	0	0
15	8607846	.	T	A	4	5	9	0	0	9	0	0
15	8661671	.	C	T	6	3	9	0	1	10	0	0
15	8663798	.	A	G	2	2	4	0	0	4	0	0
15	8665414	.	G	A	3	1	4	0	0	4	0	0
15	8665459	.	C	T	0	2	2	0	1	3	0	0
15	8665481	.	G	A	2	2	4	0	0	4	0	0
15	8797850	.	T	C	14	29	43	0	2	45	0	0
15	8799141	.	T	A	19	13	32	0	3	35	0	0
15	8799462	.	T	A	20	8	28	0	1	29	0	0
15	8799713	.	G	A	17	31	48	0	2	50	0	0
15	8799730	.	T	G	13	4	17	0	32	50	1	0
15	8799831	.	T	C	11	22	33	0	0	33	0	0
15	8799856	.	G	A	15	14	29	0	1	30	0	0
15	8799872	.	C	A	15	13	28	0	1	29	0	0
15	8799892	.	C	T	15	12	27	0	3	30	0	0
15	8799916	.	T	C	14	8	22	0	3	25	0	0
15	8814221	.	G	T	2	2	4	0	0	4	0	0
15	8814272	.	A	C	1	0	1	0	0	3	2	0
15	8990820	.	G	A	1	3	4	0	0	4	0	0
15	8991591	.	T	C	3	2	5	0	0	5	0	0
15	8992752	.	A	T	1	2	3	0	0	3	0	0
15	9011092	.	A	G	1	3	4	0	1	5	0	0
15	9011178	.	C	T	1	3	4	0	0	4	0	0
15	9011230	.	G	A	3	2	5	0	0	5	0	0
15	9020621	.	C	T	3	3	6	0	0	6	0	0
15	9022736	.	C	T	0	1	1	0	1	2	0	0
15	9234102	.	A	C	12	18	30	0	4	34	0	0
15	9234114	.	A	G	15	22	37	0	3	40	0	0
15	9234156	.	A	C	22	29	51	0	1	52	0	0
15	9234634	.	A	T	19	21	40	0	5	45	0	0
15	9234885	.	A	G	38	28	66	0	2	68	0	0
15	9234960	.	C	T	40	23	63	0	3	66	0	0
15	9234972	.	T	C	42	22	64	0	5	69	0	0
15	9235081	.	C	G	27	39	66	0	3	69	0	0
15	9235128	.	A	C	22	32	54	0	2	56	0	0
15	9235254	.	A	G	26	33	59	0	2	61	0	0
15	9235319	.	C	T	32	27	59	0	3	62	0	0
15	9235461	.	T	G	38	11	49	0	2	51	0	0
15	9238101	.	G	A	9	7	16	0	0	16	0	0
15	9249293	.	G	A	2	3	5	0	1	6	0	0
15	9249344	.	C	T	17	33	50	0	2	52	0	0
15	9249346	.	A	G	18	34	52	0	0	52	0	0
15	9315612	.	C	A	3	4	7	0	1	8	0	0
15	9319051	.	T	C	4	0	4	0	4	8	0	0
15	9367842	.	T	C	2	6	8	0	1	9	0	0
15	9368757	.	G	A	6	7	13	0	0	13	0	0
15	9368834	.	A	G	12	6	18	1	1	20	0	0
15	9369114	.	T	C	4	16	20	0	2	22	0	0
15	9369293	.	T	A	6	3	9	0	0	9	0	0
15	9369344	.	G	T	5	5	10	0	0	10	0	0
15	9369571	.	A	T	4	9	13	0	0	13	0	0
15	9369610	.	A	T	4	7	11	0	0	11	0	0
15	9369651	.	G	C	4	8	12	0	0	12	0	0
15	9369689	.	G	A	8	11	19	0	1	20	0	0
15	9369733	.	C	T	11	5	16	0	1	17	0	0
15	9369737	.	C	G	7	11	18	0	0	18	0	0
15	9369949	.	C	A	2	5	7	0	0	7	0	0
15	9369950	.	T	C	2	5	7	0	0	7	0	0
15	9370068	.	G	A	5	2	7	0	1	8	0	0
15	9370096	.	T	C	1	9	10	0	1	11	0	0
15	9370400	.	T	C	2	4	6	0	0	6	0	0
15	9370477	.	A	G	4	5	9	0	0	9	0	0
15	9370492	.	C	G	4	7	11	0	1	12	0	0
15	9370534	.	T	A	9	4	13	0	0	13	0	0
15	9370553	.	C	T	7	9	16	0	1	17	0	0
15	9370967	.	T	C	6	1	7	0	4	11	0	0
15	9371303	.	G	A	5	5	10	0	1	11	0	0
15	9371564	.	A	G	3	6	9	0	0	9	0	0
15	9371678	.	A	G	1	4	5	0	0	5	0	0
15	9372053	.	T	C	6	5	11	0	0	11	0	0
15	9372356	.	T	A	7	8	15	0	0	15	0	0
15	9372500	.	G	A	4	5	9	0	0	9	0	0
15	9372539	.	G	A	1	2	3	0	0	3	0	0
15	9372730	.	G	A	1	3	4	0	0	4	0	0
15	9372929	.	C	T	1	4	5	0	0	5	0	0
15	9373205	.	G	A	3	2	5	0	0	5	0	0
15	9373801	.	C	T	2	2	4	0	0	4	0	0
15	9374627	.	A	T	3	7	10	0	0	10	0	0
15	9375002	.	G	T	1	2	3	0	0	3	0	0
15	9378090	.	A	T	1	4	5	0	0	5	0	0
15	9382293	.	G	T	1	2	3	0	0	3	0	0
15	9390073	.	A	T	1	2	3	0	0	3	0	0
15	9390112	.	T	G	2	3	5	0	0	5	0	0
15	9608710	.	A	C	1	0	1	0	1	2	0	0
15	9613709	.	C	T	1	4	5	0	1	6	0	0
15	10001851	.	A	G	15	15	30	0	1	31	0	0
15	10002281	.	G	A	5	7	12	0	2	14	0	0
15	10002317	.	G	A	5	5	10	0	1	11	0	0
15	10002475	.	A	T	4	2	6	0	0	6	0	0
15	10002545	.	C	T	7	3	10	0	0	10	0	0
15	10002591	.	A	G	10	8	18	0	0	18	0	0
15	10003274	.	C	T	10	10	20	0	0	20	0	0
15	10003357	.	G	A	7	5	12	0	0	12	0	0
15	10003379	.	G	A	7	7	14	0	0	14	0	0
15	10003647	.	C	T	0	7	7	0	9	16	0	0
15	10003767	.	C	T	0	6	6	0	1	7	0	0
15	10025010	.	T	C	6	4	10	0	0	10	0	0
15	10025185	.	A	G	3	4	7	0	1	8	0	0
15	10025508	.	A	G	4	3	7	0	0	7	0	0
15	10025688	.	G	A	3	4	7	0	0	7	0	0
15	10025760	.	T	G	5	6	11	0	0	11	0	0
15	10025949	.	C	T	2	6	8	0	2	10	0	0
15	10027257	.	T	C	3	7	10	0	0	10	0	0
15	10039622	.	T	C	0	1	1	0	0	1	0	0
15	10039643	.	T	C	2	1	3	0	0	3	0	0
15	10039775	.	A	G	2	4	6	0	0	6	0	0
15	10065534	.	T	A	5	2	7	0	0	7	0	0
15	10065735	.	G	A	1	3	4	0	0	4	0	0
15	10065843	.	T	G	2	4	6	0	0	6	0	0
15	10065846	.	A	G	2	4	6	0	0	6	0	0
15	10066008	.	T	C	3	0	3	0	3	6	0	0
15	10088588	.	C	T	3	2	5	0	0	5	0	0
15	10114779	.	G	A	4	3	7	0	0	7	0	0
15	10114788	.	A	G	4	4	8	0	0	8	0	0
15	10114854	.	T	C	3	0	3	0	3	6	0	0
15	10114884	.	G	A	2	2	4	0	1	5	0	0
15	10455411	.	G	A	1	3	4	0	0	4	0	0
15	11668633	.	C	T	5	6	11	0	0	11	0	0
15	11670283	.	A	C	4	2	6	0	0	6	0	0
15	11680132	.	C	T	1	2	3	0	1	4	0	0
15	11681447	.	A	G	3	2	5	0	0	5	0	0
15	11690967	.	T	C	6	4	10	0	0	10	0	0
15	11691008	.	T	G	2	0	2	0	6	8	0	0
15	11757580	.	T	A	11	8	19	0	2	21	0	0
15	11874021	.	A	G	3	0	3	0	2	5	0	0
15	11874022	.	A	T	3	2	5	0	0	5	0	0
15	11874647	.	T	C	2	3	5	0	0	5	0	0
15	13137876	.	T	G	0	6	6	0	1	7	0	0
15	14388588	.	C	T	0	2	2	0	0	2	0	0
15	14554421	.	G	A	0	5	5	0	0	5	0	0
15	14631930	.	T	C	2	12	14	0	1	15	0	0
15	15349978	.	C	T	27	10	37	1	4	42	0	0
15	15406925	.	T	G	3	0	3	0	0	3	0	0
15	15406934	.	C	T	3	0	3	0	0	3	0	0
15	15445769	.	T	C	5	0	5	0	4	9	0	0
15	16937519	.	T	C	2	0	2	0	3	5	0	0
15	16937529	.	T	C	2	0	2	0	3	5	0	0
15	16937653	.	T	C	2	6	8	0	0	8	0	0
15	16937662	.	T	C	1	1	2	0	6	8	0	0
15	16937688	.	T	C	5	4	9	0	0	9	0	0
15	17095298	.	C	T	0	2	2	0	0	2	0	0
15	17125044	.	A	G	5	2	7	0	0	7	0	0
15	17487277	.	A	G	4	4	8	0	0	8	0	0
15	17487293	.	A	G	3	4	7	0	0	7	0	0
15	17487544	.	A	G	9	9	18	0	0	18	0	0
15	19209468	.	G	A	2	2	4	0	0	4	0	0
15	19293919	.	G	T	12	5	17	0	0	17	0	0
15	19293920	.	G	T	11	5	16	0	1	17	0	0
15	19301259	.	A	G	2	7	9	0	0	9	0	0
15	19316437	.	C	A	4	7	11	0	0	11	0	0
15	19316497	.	A	T	5	6	11	0	0	11	0	0
15	19316573	.	T	C	7	5	12	0	0	12	0	0
15	19318408	.	T	C	2	5	7	0	0	7	0	0
15	19318445	.	T	G	3	0	3	0	3	6	0	0
15	19318513	.	T	A	5	2	7	0	0	7	0	0
15	19318545	.	G	T	4	5	9	0	0	9	0	0
15	19318795	.	G	A	3	2	5	0	0	5	0	0
15	19318835	.	C	A	1	2	3	0	0	3	0	0
15	19319128	.	A	C	1	3	4	0	0	4	0	0
15	19319150	.	A	G	3	0	3	0	3	6	0	0
15	19319227	.	C	G	3	9	12	0	0	13	1	0
15	19319250	.	T	C	5	7	12	0	0	12	0	0
15	19319272	.	G	C	6	7	13	0	0	13	0	0
15	19319429	.	G	A	2	6	8	0	0	8	0	0
15	19319523	.	A	C	8	7	15	0	1	16	0	0
15	19319666	.	A	G	3	1	4	0	8	12	0	0
15	19324762	.	T	A	3	5	8	0	0	8	0	0
15	19324900	.	G	A	0	3	3	0	0	3	0	0
15	19324910	.	C	A	3	2	5	0	0	5	0	0
15	19327665	.	G	A	0	3	3	0	2	5	0	0
15	19328334	.	G	A	4	3	7	0	0	7	0	0
15	19329944	.	G	A	6	4	10	0	0	10	0	0
15	19329950	.	C	T	6	2	8	0	1	9	0	0
15	19330144	.	C	T	2	8	10	0	0	10	0	0
15	19330652	.	A	G	1	0	1	0	6	7	0	0
15	19330745	.	T	A	4	6	10	0	1	11	0	0
15	19330748	.	C	A	5	5	10	0	0	10	0	0
15	19331011	.	C	A	2	2	4	0	0	4	0	0
15	19331303	.	A	G	3	2	5	0	0	5	0	0
15	19332719	.	C	T	1	1	2	0	0	2	0	0
15	19336799	.	G	A	0	1	1	0	0	1	0	0
15	19337247	.	A	C	1	4	5	0	0	5	0	0
15	19337251	.	C	T	4	1	5	0	0	5	0	0
15	19345530	.	G	T	2	0	2	0	0	2	0	0
15	19345614	.	C	T	7	5	12	0	1	13	0	0
15	19347821	.	C	T	4	8	12	0	0	12	0	0
15	19347878	.	G	T	6	8	14	0	0	14	0	0
15	19348275	.	C	T	8	6	14	0	1	15	0	0
15	19482640	.	G	A	1	1	2	0	0	2	0	0
15	19482724	.	C	T	2	4	6	0	0	6	0	0
15	19482748	.	C	T	1	6	7	0	0	7	0	0
15	19522085	.	T	C	0	0	0	0	1	1	0	0
15	19544143	.	T	C	2	0	2	0	0	2	0	0
15	19576879	.	A	G	0	1	1	0	0	1	0	0
15	19577066	.	C	T	2	3	5	0	1	6	0	0
15	19577072	.	C	T	3	3	6	0	0	6	0	0
15	19577242	.	G	A	0	5	5	0	0	5	0	0
15	19577367	.	C	A	0	0	0	0	1	1	0	0
15	19583841	.	C	T	10	12	22	0	0	22	0	0
15	19584132	.	G	T	4	0	4	0	0	4	0	0
15	19584187	.	T	C	10	5	15	0	0	15	0	0
15	19595508	.	C	T	5	6	11	0	3	14	0	0
15	19595509	.	T	G	6	2	8	0	6	14	0	0
15	19600214	.	C	T	10	10	20	0	1	21	0	0
15	19600390	.	A	T	5	3	8	0	1	9	0	0
15	19600570	.	A	C	11	8	19	0	1	20	0	0
15	19600589	.	C	T	10	8	18	0	0	18	0	0
15	19600606	.	A	G	7	1	8	0	11	19	0	0
15	19600746	.	T	G	2	0	2	0	3	5	0	0
15	19661664	.	T	A	7	6	13	0	1	14	0	0
15	19661756	.	T	A	19	5	24	0	1	25	0	0
15	19661820	.	G	T	7	12	19	0	1	20	0	0
15	19668294	.	T	G	5	4	9	0	0	9	0	0
15	19668354	.	A	G	6	3	9	0	1	10	0	0
15	19668375	.	G	A	8	5	13	0	0	13	0	0
15	19668534	.	A	G	4	12	16	0	0	16	0	0
15	19668558	.	G	A	6	8	14	0	1	15	0	0
15	19668585	.	A	G	7	7	14	0	0	14	0	0
15	19668638	.	T	G	1	0	1	0	0	1	0	0
15	19669146	.	T	C	2	1	3	0	3	6	0	0
15	19726987	.	C	A	1	3	4	0	0	4	0	0
15	19727056	.	A	C	1	2	3	0	0	3	0	0
15	19727683	.	A	C	2	3	5	0	0	5	0	0
15	19727684	.	C	T	0	3	3	0	2	5	0	0
15	19728131	.	A	T	8	8	16	0	0	16	0	0
15	19728638	.	A	G	19	19	38	0	5	43	0	0
15	19728853	.	T	A	3	9	12	0	1	13	0	0
15	19728989	.	A	C	16	9	25	0	1	26	0	0
15	19737755	.	C	T	0	1	1	0	2	3	0	0
15	19742655	.	T	C	7	4	11	0	0	11	0	0
15	19745764	.	C	A	0	4	4	0	3	7	0	0
15	19760449	.	T	C	1	0	1	0	0	1	0	0
15	19878323	.	C	T	3	2	5	0	0	5	0	0
15	19878798	.	A	G	2	3	5	0	1	6	0	0
15	19878869	.	G	A	4	1	5	0	1	6	0	0
15	19878877	.	C	A	5	2	7	0	0	7	0	0
15	19891082	.	A	T	3	4	7	0	0	7	0	0
15	19891939	.	T	C	8	10	18	0	0	18	0	0
15	19892083	.	G	A	0	8	8	0	6	14	0	0
15	19894898	.	T	G	6	0	6	0	6	12	0	0
15	19895304	.	T	A	4	7	11	0	1	12	0	0
15	19895991	.	A	G	5	0	5	0	11	16	0	0
15	19896052	.	A	C	9	8	17	0	0	17	0	0
15	19906969	.	A	C	3	2	5	0	1	6	0	0
15	19907233	.	T	C	1	3	4	0	0	4	0	0
15	19907241	.	A	G	0	3	3	0	1	4	0	0
15	19908328	.	T	A	2	6	8	0	0	8	0	0
15	19908340	.	T	A	1	6	7	0	1	8	0	0
15	19908777	.	A	T	4	2	6	0	0	6	0	0
15	20004823	.	T	A	1	1	2	0	0	2	0	0
15	20004837	.	C	A	1	2	3	0	0	3	0	0
15	20005301	.	A	G	14	8	22	0	1	23	0	0
15	20005665	.	C	A	1	4	5	0	0	5	0	0
15	20005943	.	A	G	6	6	12	0	0	12	0	0
15	20006747	.	T	G	5	6	11	0	1	12	0	0
15	20007033	.	T	A	1	2	3	0	0	3	0	0
15	20008357	.	C	T	2	3	5	0	1	6	0	0
15	20012153	.	G	A	3	2	5	0	0	5	0	0
15	20012199	.	G	T	2	3	5	0	0	5	0	0
15	20061367	.	G	A	9	8	17	0	0	17	0	0
15	20065029	.	T	C	3	3	6	0	0	6	0	0
15	20065074	.	G	A	5	8	13	0	0	13	0	0
15	20065125	.	A	G	0	1	1	0	1	2	0	0
15	20069165	.	T	C	1	4	5	0	0	5	0	0
15	20069201	.	G	A	2	5	7	0	0	7	0	0
15	20071596	.	G	A	6	2	8	0	0	8	0	0
15	20074627	.	A	G	2	0	2	0	0	2	0	0
15	20081245	.	T	G	1	4	5	0	0	5	0	0
15	20081275	.	T	A	1	3	4	0	0	4	0	0
15	20081731	.	G	A	9	5	14	0	0	14	0	0
15	20081803	.	A	T	9	0	9	0	3	12	0	0
15	20081806	.	T	G	6	4	10	0	3	13	0	0
15	20081903	.	G	A	3	1	4	0	0	4	0	0
15	20111554	.	G	A	1	3	4	0	0	4	0	0
15	20350535	.	G	A	0	1	1	0	1	2	0	0
15	20369562	.	G	A	3	2	5	0	0	5	0	0
15	20374712	.	G	A	0	0	0	0	3	3	0	0
15	20376393	.	A	G	3	2	5	0	0	5	0	0
15	20377873	.	A	T	1	1	2	0	0	2	0	0
15	20377946	.	C	T	6	9	15	0	0	15	0	0
15	20378302	.	C	T	1	2	3	0	0	3	0	0
15	20378479	.	T	C	8	7	15	0	1	16	0	0
15	20379860	.	C	T	6	6	12	0	0	12	0	0
15	20380144	.	C	A	1	0	1	0	0	1	0	0
15	20383150	.	C	T	6	3	9	0	2	11	0	0
15	20384539	.	A	G	6	0	6	0	9	15	0	0
15	20394672	.	T	C	10	8	18	0	2	20	0	0
15	20395141	.	G	A	0	11	11	0	9	20	0	0
15	20395528	.	C	T	0	3	3	0	1	4	0	0
15	20406270	.	A	C	5	10	15	0	0	15	0	0
15	20406413	.	C	T	0	3	3	0	4	7	0	0
15	20406484	.	G	C	4	7	11	0	0	11	0	0
15	20406628	.	G	A	1	3	4	0	0	4	0	0
15	20407026	.	T	A	4	2	6	0	0	6	0	0
15	20407045	.	G	A	2	3	5	0	0	5	0	0
15	20407407	.	C	T	1	1	2	0	0	2	0	0
15	20407938	.	G	T	1	4	5	0	0	5	0	0
15	20407951	.	G	T	1	3	4	0	0	4	0	0
15	20411321	.	G	A	1	0	1	0	0	1	0	0
15	20412107	.	G	T	4	4	8	0	0	8	0	0
15	20412171	.	G	C	3	6	9	0	0	9	0	0
15	20475817	.	A	G	3	2	5	0	0	5	0	0
15	20478820	.	G	A	5	3	8	0	1	9	0	0
15	20479056	.	A	G	5	2	7	0	2	9	0	0
15	20489875	.	G	A	3	5	8	0	0	8	0	0
15	20525533	.	C	T	0	4	4	0	0	4	0	0
15	20540641	.	T	A	3	5	8	0	0	8	0	0
15	20605194	.	G	A	0	1	1	0	0	1	0	0
15	20628220	.	G	A	0	1	1	0	0	1	0	0
15	20629658	.	T	C	0	1	1	0	0	1	0	0
15	20637832	.	C	T	1	3	4	0	0	4	0	0
15	20652746	.	G	A	3	5	8	0	0	8	0	0
15	20652813	.	A	T	13	12	25	0	0	25	0	0
15	20652955	.	A	G	21	20	41	0	1	42	0	0
15	20653005	.	T	A	7	21	28	0	3	31	0	0
15	20653258	.	T	A	23	25	48	1	3	52	0	0
15	20709184	.	T	A	11	6	17	0	0	17	0	0
15	20709340	.	G	C	9	19	28	0	3	31	0	0
15	20709490	.	A	G	11	8	19	0	2	21	0	0
15	20709925	.	G	A	17	16	33	0	1	34	0	0
15	20731260	.	G	C	14	15	29	0	0	29	0	0
15	20832831	.	C	T	7	6	13	0	0	13	0	0
15	20833302	.	A	G	0	1	1	0	0	1	0	0
15	20836008	.	A	G	1	2	3	0	0	3	0	0
15	20843256	.	T	C	5	3	8	0	0	8	0	0
15	20843348	.	C	T	4	3	7	0	0	7	0	0
15	20843441	.	C	T	4	6	10	0	0	10	0	0
15	20843859	.	G	C	0	4	4	0	5	9	0	0
15	20844016	.	C	T	4	2	6	0	1	7	0	0
15	20844018	.	C	T	4	3	7	0	0	7	0	0
15	20844074	.	A	C	4	2	6	0	0	6	0	0
15	20875296	.	C	T	5	4	9	0	0	9	0	0
15	20883185	.	A	T	8	5	13	0	2	15	0	0
15	20886090	.	T	C	3	7	10	0	0	10	0	0
15	20891063	.	T	C	0	1	1	0	0	1	0	0
15	20891154	.	T	A	5	5	10	0	1	11	0	0
15	20893920	.	T	A	9	4	13	0	0	13	0	0
15	20894094	.	A	G	10	0	10	0	14	24	0	0
15	20894177	.	C	A	11	15	26	0	0	26	0	0
15	20901053	.	T	C	12	26	38	0	1	39	0	0
15	20901133	.	A	G	20	15	35	0	1	36	0	0
15	20901366	.	T	A	20	14	34	0	0	34	0	0
15	20901540	.	C	T	1	7	8	0	10	18	0	0
15	20901562	.	G	A	9	11	20	0	4	24	0	0
15	20907603	.	A	G	6	5	11	0	1	12	0	0
15	20941492	.	T	A	7	3	10	0	1	11	0	0
15	22046568	.	T	C	2	5	7	0	0	7	0	0
15	22046647	.	T	C	12	4	16	0	1	17	0	0
15	22047026	.	T	C	0	0	0	0	2	2	0	0
15	22047131	.	C	G	3	2	5	0	0	5	0	0
15	22047389	.	T	C	2	3	5	0	0	5	0	0
15	22074224	.	G	A	1	2	3	0	0	3	0	0
15	22133987	.	A	C	8	1	9	0	5	14	0	0
15	22143027	.	G	A	2	3	5	0	0	5	0	0
15	22147174	.	C	G	5	4	9	0	0	9	0	0
15	22147186	.	G	T	5	4	9	0	0	9	0	0
15	22319797	.	C	T	1	2	3	0	0	3	0	0
15	22319830	.	G	A	3	4	7	0	0	7	0	0
15	22324529	.	A	T	1	1	2	0	0	2	0	0
15	22324538	.	T	A	0	1	1	0	1	2	0	0
15	22324760	.	A	G	10	17	27	0	2	29	0	0
15	22324948	.	T	C	4	6	10	0	0	10	0	0
15	22325278	.	A	G	7	0	7	0	7	14	0	0
15	22325617	.	G	T	6	13	19	0	2	21	0	0
15	22435473	.	G	A	2	7	9	0	0	9	0	0
15	22435565	.	T	G	1	0	1	0	4	5	0	0
15	22441703	.	C	T	6	2	8	0	0	8	0	0
15	22441744	.	A	G	2	4	6	0	0	6	0	0
15	22441852	.	A	G	6	0	6	0	4	10	0	0
15	22441855	.	C	T	3	6	9	0	1	10	0	0
15	22441972	.	G	A	7	4	11	0	1	12	0	0
15	22442875	.	G	A	0	3	3	0	5	8	0	0
15	22443048	.	T	G	2	4	6	0	0	6	0	0
15	22443136	.	C	T	12	12	24	0	1	25	0	0
15	22443282	.	C	T	6	2	8	0	0	8	0	0
15	22443289	.	A	T	7	2	9	0	2	11	0	0
15	22443460	.	G	A	0	3	3	0	10	13	0	0
15	22443462	.	A	G	10	0	10	0	3	13	0	0
15	22443520	.	A	G	10	7	17	0	0	17	0	0
15	22443615	.	G	A	12	8	20	0	0	20	0	0
15	22443630	.	G	T	0	10	10	0	12	22	0	0
15	22443798	.	A	G	15	15	30	0	1	31	0	0
15	22443858	.	A	G	17	14	31	0	0	31	0	0
15	22443934	.	G	A	0	12	12	0	19	31	0	0
15	22444062	.	A	G	15	15	30	0	1	31	0	0
15	22444239	.	G	A	1	10	11	0	10	21	0	0
15	22444266	.	A	G	11	13	24	0	0	24	0	0
15	22444310	.	T	A	9	13	22	0	1	23	0	0
15	22444331	.	G	A	8	7	15	0	2	17	0	0
15	22444483	.	T	G	11	0	11	0	6	17	0	0
15	22444486	.	A	T	11	5	16	0	1	17	0	0
15	22500750	.	G	A	0	1	1	0	1	2	0	0
15	22524099	.	C	A	2	0	2	0	0	2	0	0
15	22533518	.	G	A	3	4	7	0	0	7	0	0
15	22536756	.	C	T	1	4	5	0	0	5	0	0
15	22536795	.	G	C	0	2	2	0	4	6	0	0
15	22537008	.	T	A	1	5	6	0	2	8	0	0
15	22945140	.	G	A	1	0	1	0	0	1	0	0
15	23181511	.	C	A	6	4	10	0	0	10	0	0
15	23187879	.	T	A	2	3	5	0	0	5	0	0
15	23187902	.	T	G	4	0	4	0	4	8	0	0
15	23188188	.	T	G	7	7	14	0	0	14	0	0
15	23188190	.	C	T	6	7	13	0	1	14	0	0
15	23188245	.	T	A	6	8	14	0	0	14	0	0
15	23244134	.	A	C	1	0	1	0	0	1	0	0
15	23256320	.	C	T	2	0	2	0	0	2	0	0
15	23256449	.	T	C	4	9	13	0	0	13	0	0
15	23256546	.	C	A	11	3	14	0	1	15	0	0
15	23256547	.	C	T	11	4	15	0	0	15	0	0
15	23256674	.	C	T	1	0	1	0	0	1	0	0
15	23256779	.	G	A	0	1	1	0	0	1	0	0
15	23264471	.	G	A	0	5	5	1	9	15	0	0
15	23264547	.	G	A	0	10	10	0	0	10	0	0
15	23264945	.	T	C	8	3	11	0	0	11	0	0
15	23265217	.	C	T	4	4	8	0	0	8	0	0
15	23273262	.	G	A	3	4	7	0	1	8	0	0
15	23356938	.	T	G	1	2	3	0	0	3	0	0
15	23356950	.	C	T	2	2	4	0	0	4	0	0
15	23357870	.	G	T	0	4	4	0	3	7	0	0
15	23357890	.	T	C	4	1	5	0	0	5	0	0
15	23357909	.	C	T	2	2	4	0	0	4	0	0
15	23357957	.	G	C	3	2	5	0	0	5	0	0
15	23358257	.	C	A	2	7	9	0	0	9	0	0
15	23358455	.	G	C	2	4	6	0	1	7	0	0
15	23382243	.	C	T	0	2	2	0	4	6	0	0
15	23386976	.	C	T	0	5	5	0	9	14	0	0
15	23387010	.	A	G	4	7	11	0	0	11	0	0
15	23387334	.	G	A	3	3	6	0	0	6	0	0
15	23387567	.	G	A	4	5	9	0	0	9	0	0
15	23387577	.	G	A	3	4	7	0	0	7	0	0
15	23388471	.	G	T	10	3	13	0	0	13	0	0
15	23388609	.	C	T	1	7	8	0	1	9	0	0
15	23389139	.	C	G	3	4	7	0	0	7	0	0
15	23389809	.	G	A	0	1	1	0	0	1	0	0
15	23391110	.	C	T	0	1	1	0	0	1	0	0
15	23391196	.	G	A	0	1	1	0	0	1	0	0
15	23391741	.	A	G	1	2	3	0	0	3	0	0
15	23394773	.	G	A	0	2	2	0	0	2	0	0
15	23397588	.	A	G	0	1	1	0	0	1	0	0
15	23397614	.	C	T	0	2	2	0	1	3	0	0
15	23400954	.	G	A	2	7	9	0	0	9	0	0
15	23400961	.	A	G	3	7	10	0	0	10	0	0
15	23403191	.	T	C	1	0	1	0	3	4	0	0
15	23405150	.	T	C	1	2	3	0	0	3	0	0
15	23419931	.	T	A	2	2	4	0	0	4	0	0
15	23423674	.	C	T	2	6	8	0	0	8	0	0
15	23423724	.	G	A	5	2	7	0	0	7	0	0
15	23426717	.	T	A	4	3	7	0	0	7	0	0
15	23427075	.	G	A	4	1	5	0	0	5	0	0
15	23429593	.	G	A	6	5	11	0	0	11	0	0
15	23429915	.	G	A	1	1	2	0	0	2	0	0
15	23431734	.	C	T	1	6	7	0	11	18	0	0
15	23434037	.	G	A	4	3	7	0	0	7	0	0
15	23434242	.	C	T	1	2	3	0	0	3	0	0
15	23434251	.	G	A	2	0	2	0	0	2	0	0
15	23437095	.	C	T	0	4	4	0	0	4	0	0
15	23437162	.	T	A	3	5	8	0	0	8	0	0
15	23440676	.	T	C	3	2	5	0	0	5	0	0
15	23440721	.	G	A	7	6	13	0	0	13	0	0
15	23440751	.	A	G	3	4	7	0	1	8	0	0
15	23442571	.	T	C	4	0	4	0	2	6	0	0
15	23442577	.	G	A	4	2	6	0	0	6	0	0
15	23442817	.	G	A	1	1	2	0	0	2	0	0
15	23442841	.	T	A	1	1	2	0	0	2	0	0
15	23451149	.	C	A	0	3	3	0	0	3	0	0
15	23451195	.	T	C	0	3	3	0	0	3	0	0
15	23451197	.	T	C	0	3	3	0	0	3	0	0
15	23468157	.	A	G	3	2	5	0	0	5	0	0
15	23468224	.	C	A	4	2	6	0	0	6	0	0
15	23468340	.	C	G	0	2	2	0	1	3	0	0
15	23468754	.	T	A	1	2	3	0	0	3	0	0
15	23474815	.	C	G	4	9	13	0	1	14	0	0
15	23512017	.	C	A	2	2	4	0	0	4	0	0
15	23512522	.	C	T	3	2	5	0	0	5	0	0
15	23512882	.	T	C	4	2	6	0	0	6	0	0
15	23513009	.	G	C	1	3	4	0	0	4	0	0
15	23516184	.	G	A	1	2	3	0	0	3	0	0
15	23532119	.	G	A	0	9	9	0	3	12	0	0
15	23532146	.	A	T	8	3	11	0	0	11	0	0
15	23541136	.	A	C	3	2	5	0	0	5	0	0
15	23541616	.	C	T	2	2	4	0	0	4	0	0
15	23541943	.	T	G	1	2	3	0	0	3	0	0
15	23551272	.	C	T	3	3	6	0	0	6	0	0
15	23551295	.	T	A	2	2	4	0	0	4	0	0
15	23551704	.	G	A	0	4	4	0	2	6	0	0
15	23551769	.	T	G	5	0	5	0	8	13	0	0
15	23551775	.	C	T	5	8	13	0	0	13	0	0
15	23617364	.	G	A	0	5	5	0	5	10	0	0
15	23617612	.	G	T	1	1	2	0	0	2	0	0
15	23619093	.	G	A	0	10	10	0	13	23	0	0
15	23620453	.	T	G	1	0	1	0	0	1	0	0
15	23620511	.	G	A	7	11	18	0	0	18	0	0
15	23620541	.	C	T	10	9	19	0	0	19	0	0
15	23640374	.	T	A	11	8	19	0	7	26	0	0
15	23640678	.	A	C	4	1	5	0	22	27	0	0
15	23640807	.	C	T	14	14	28	0	0	28	0	0
15	23641057	.	C	T	13	4	17	0	0	17	0	0
15	23641102	.	T	G	9	10	19	0	0	19	0	0
15	23641107	.	G	C	10	9	19	0	0	19	0	0
15	23641426	.	G	A	8	9	17	0	1	18	0	0
15	23644609	.	A	G	0	3	3	0	0	3	0	0
15	23645698	.	G	A	1	2	3	0	1	4	0	0
15	23686857	.	G	A	1	2	3	0	0	3	0	0
15	23686877	.	G	A	1	1	2	0	0	2	0	0
15	23693952	.	A	G	2	2	4	0	0	4	0	0
15	23693997	.	C	G	0	2	2	0	0	2	0	0
15	23694050	.	G	A	0	2	2	0	0	2	0	0
15	23694059	.	G	A	0	2	2	0	0	2	0	0
15	23709660	.	G	A	3	6	9	0	1	10	0	0
15	23709925	.	T	C	3	3	6	0	0	6	0	0
15	23710339	.	T	C	8	8	16	0	0	16	0	0
15	23710465	.	C	T	7	10	17	0	0	17	0	0
15	23710490	.	G	T	6	7	13	0	0	13	0	0
15	23710515	.	G	A	3	7	10	0	1	11	0	0
15	23710539	.	T	C	4	5	9	0	0	9	0	0
15	23710811	.	A	G	3	4	7	0	1	8	0	0
15	23711890	.	C	T	0	4	4	0	8	12	0	0
15	23711953	.	G	A	9	5	14	0	0	14	0	0
15	23712082	.	A	G	8	14	22	0	2	24	0	0
15	23713116	.	C	T	1	1	2	0	2	4	0	0
15	23713158	.	A	G	4	3	7	0	0	7	0	0
15	23713174	.	G	C	4	5	9	0	1	10	0	0
15	23713323	.	A	G	5	2	7	0	2	9	0	0
15	23713335	.	T	G	3	3	6	0	1	7	0	0
15	23713923	.	C	T	1	3	4	0	0	4	0	0
15	23718008	.	G	A	1	1	2	0	0	2	0	0
15	23718403	.	C	T	2	6	8	0	0	8	0	0
15	23723607	.	T	A	2	1	3	0	1	4	0	0
15	23724153	.	G	A	2	2	4	0	2	6	0	0
15	23730816	.	C	A	0	1	1	0	0	1	0	0
15	23733485	.	C	A	4	2	6	0	0	6	0	0
15	23738914	.	C	T	14	8	22	0	0	22	0	0
15	23738915	.	G	C	0	7	7	0	15	22	0	0
15	23739032	.	C	T	3	2	5	0	0	5	0	0
15	23745659	.	G	A	4	3	7	0	0	7	0	0
15	23780791	.	A	T	1	4	5	0	0	5	0	0
15	23780834	.	G	T	2	5	7	0	0	7	0	0
15	23780887	.	A	G	3	3	6	0	0	6	0	0
15	23781320	.	G	A	0	2	2	0	0	2	0	0
15	23788266	.	G	A	4	2	6	0	0	6	0	0
15	23793206	.	C	T	4	4	8	0	0	8	0	0
15	23817403	.	T	A	8	6	14	0	1	15	0	0
15	23817517	.	G	A	12	8	20	0	0	20	0	0
15	23817901	.	C	T	0	9	9	0	10	19	0	0
15	23818313	.	T	A	5	5	10	0	1	11	0	0
15	23818542	.	T	A	2	2	4	0	1	5	0	0
15	23818765	.	G	A	4	5	9	0	0	9	0	0
15	23818788	.	G	C	2	0	2	0	3	5	0	0
15	23818905	.	C	T	9	4	13	0	0	13	0	0
15	23819248	.	T	A	7	2	9	0	0	9	0	0
15	23819253	.	C	T	2	7	9	0	0	9	0	0
15	23819423	.	G	A	6	9	15	0	1	16	0	0
15	23823508	.	C	T	8	5	13	0	0	13	0	0
15	23823638	.	G	C	1	3	4	0	1	5	0	0
15	23829245	.	C	T	2	1	3	0	0	3	0	0
15	23830658	.	G	A	2	3	5	0	0	5	0	0
15	23831007	.	C	T	0	1	1	0	0	1	0	0
15	23841498	.	G	A	1	3	4	0	1	5	0	0
15	23911881	.	A	G	0	2	2	0	1	3	0	0
15	23912118	.	C	T	2	1	3	0	0	3	0	0
15	23918058	.	C	T	1	2	3	0	0	3	0	0
15	23922714	.	G	A	9	18	27	0	0	27	0	0
15	23922994	.	G	T	12	10	22	0	0	22	0	0
15	23923261	.	T	G	8	9	17	0	1	18	0	0
15	23925372	.	G	C	5	3	8	0	0	8	0	0
15	23927992	.	G	T	16	11	27	0	2	29	0	0
15	23931187	.	A	G	5	2	7	0	0	7	0	0
15	23931454	.	A	G	4	2	6	0	0	6	0	0
15	23942804	.	T	G	10	9	19	0	1	20	0	0
15	24016739	.	T	C	1	1	2	0	0	2	0	0
15	24017280	.	G	A	1	1	2	0	0	2	0	0
15	24027998	.	T	G	0	0	0	0	1	1	0	0
15	24036108	.	T	C	0	1	1	0	0	1	0	0
15	24052264	.	C	T	1	1	2	0	0	2	0	0
15	24054101	.	C	T	2	0	2	0	0	2	0	0
15	24084737	.	T	A	1	2	3	0	1	4	0	0
15	24084773	.	C	T	1	4	5	0	0	5	0	0
15	24094697	.	T	C	2	3	5	0	1	6	0	0
15	24096474	.	G	A	1	2	3	0	3	6	0	0
15	24096657	.	C	A	7	8	15	0	2	17	0	0
15	24104648	.	C	T	1	6	7	0	1	8	0	0
15	24106821	.	C	T	5	6	11	0	0	11	0	0
15	24119372	.	A	G	5	7	12	0	0	12	0	0
15	24119391	.	C	T	5	4	9	0	1	10	0	0
15	24119571	.	T	C	8	11	19	0	1	20	0	0
15	24119720	.	G	A	0	7	7	0	6	13	0	0
15	24120490	.	G	A	0	2	2	0	5	7	0	0
15	24120588	.	C	T	7	5	12	0	0	12	0	0
15	24388860	.	C	T	3	8	11	0	0	11	0	0
15	24391755	.	G	A	0	0	0	0	1	1	0	0
15	24439290	.	G	A	0	1	1	0	0	1	0	0
15	24439382	.	T	C	5	2	7	0	0	7	0	0
15	24489776	.	G	A	1	0	1	0	0	1	0	0
15	24500648	.	G	A	1	3	4	0	0	4	0	0
15	24525815	.	A	G	3	0	3	0	3	6	0	0
15	24525890	.	T	C	2	7	9	0	3	12	0	0
15	24530477	.	G	A	0	7	7	0	9	16	0	0
15	24535495	.	C	T	5	5	10	0	0	10	0	0
15	24543991	.	C	T	3	1	4	0	0	4	0	0
15	24544305	.	T	A	3	3	6	0	0	6	0	0
15	24544325	.	G	A	2	8	10	0	0	10	0	0
15	24544653	.	A	T	7	4	11	0	1	12	0	0
15	24544657	.	A	G	6	0	6	0	6	12	0	0
15	24554786	.	C	A	2	5	7	0	0	7	0	0
15	24557185	.	C	T	4	5	9	0	0	9	0	0
15	24557432	.	A	G	2	4	6	0	0	6	0	0
15	24557540	.	G	A	2	7	9	0	1	10	0	0
15	24557810	.	A	C	4	4	8	0	0	8	0	0
15	24561055	.	T	C	5	0	5	0	0	5	0	0
15	24561414	.	G	A	3	0	3	0	0	3	0	0
15	24561501	.	C	T	9	9	18	0	0	18	0	0
15	24568588	.	T	C	1	1	2	0	0	2	0	0
15	24673723	.	T	A	6	10	16	0	1	17	0	0
15	24673997	.	A	G	6	3	9	0	0	9	0	0
15	24678088	.	G	A	1	0	1	0	0	1	0	0
15	24679744	.	T	C	1	0	1	0	0	1	0	0
15	24679944	.	T	C	2	0	2	0	0	2	0	0
15	24683236	.	A	G	7	4	11	0	0	11	0	0
15	24686282	.	C	T	4	6	10	0	1	11	0	0
15	24686450	.	G	A	0	0	0	0	2	2	0	0
15	24689592	.	G	A	0	19	19	0	11	30	0	0
15	24689701	.	G	A	1	13	14	0	7	21	0	0
15	24689948	.	T	C	5	8	13	0	0	13	0	0
15	24691290	.	A	G	4	0	4	0	4	8	0	0
15	24692197	.	A	T	1	2	3	0	0	3	0	0
15	24692351	.	A	T	3	4	7	0	0	7	0	0
15	24692359	.	G	A	3	4	7	0	0	7	0	0
15	24692716	.	T	A	4	4	8	0	0	8	0	0
15	24733689	.	G	A	13	7	20	0	1	21	0	0
15	24733791	.	T	G	7	5	12	0	1	13	0	0
15	24733896	.	G	A	6	6	12	0	0	12	0	0
15	24733932	.	T	C	5	4	9	0	0	9	0	0
15	24735111	.	G	T	14	7	21	0	1	22	0	0
15	24735163	.	C	G	6	5	11	0	1	12	0	0
15	24735341	.	C	T	10	6	16	0	0	16	0	0
15	24735472	.	T	C	2	5	7	0	0	7	0	0
15	24735529	.	A	G	3	8	11	0	1	12	0	0
15	24735535	.	A	T	8	3	11	0	0	11	0	0
15	24735677	.	G	T	10	10	20	0	1	21	0	0
15	24735935	.	T	G	3	2	5	0	0	5	0	0
15	24736187	.	G	A	2	2	4	0	0	4	0	0
15	24736413	.	A	G	4	6	10	0	2	12	0	0
15	24736446	.	C	A	2	9	11	0	0	11	0	0
15	24736525	.	A	G	9	5	14	0	1	15	0	0
15	24736814	.	C	A	2	1	3	0	1	4	0	0
15	24737745	.	A	G	8	14	22	0	0	22	0	0
15	24742930	.	G	A	2	13	15	0	15	30	0	0
15	24743843	.	G	A	10	6	16	0	1	17	0	0
15	24744691	.	G	C	6	15	21	0	0	21	0	0
15	24744724	.	A	T	4	15	19	0	2	21	0	0
15	24749895	.	G	A	0	19	19	0	24	43	0	0
15	24751322	.	C	T	8	15	23	0	0	23	0	0
15	24754524	.	G	A	13	21	34	0	1	35	0	0
15	24791413	.	C	T	4	6	10	0	0	10	0	0
15	24791431	.	C	T	3	5	8	0	1	9	0	0
15	24791806	.	G	C	1	4	5	0	0	5	0	0
15	24791911	.	G	C	3	2	5	0	0	5	0	0
15	24791950	.	A	G	3	1	4	0	1	5	0	0
15	24792183	.	G	A	3	3	6	0	1	7	0	0
15	24792604	.	T	C	3	7	10	0	0	10	0	0
15	24793432	.	A	G	4	2	6	0	0	6	0	0
15	24794104	.	C	T	8	7	15	0	0	15	0	0
15	24794441	.	T	A	4	2	6	0	1	7	0	0
15	24798529	.	G	A	2	0	2	0	0	2	0	0
15	24806288	.	G	A	0	0	0	0	1	1	0	0
15	24837105	.	G	A	0	7	7	0	7	14	0	0
15	24837402	.	C	T	3	8	11	0	1	12	0	0
15	24837474	.	A	G	4	5	9	0	0	9	0	0
15	24845205	.	G	A	21	13	34	0	1	35	0	0
15	24845460	.	C	T	0	5	5	0	5	10	0	0
15	24845500	.	G	T	6	11	17	0	2	19	0	0
15	24846070	.	G	A	2	7	9	0	0	9	0	0
15	24846186	.	T	C	4	9	13	0	1	14	0	0
15	24846311	.	T	A	6	7	13	0	0	13	0	0
15	24846594	.	T	C	5	0	5	0	3	8	0	0
15	24869684	.	G	A	4	2	6	0	2	8	0	0
15	24946807	.	C	T	0	7	7	0	6	13	0	0
15	24946809	.	C	G	7	5	12	0	1	13	0	0
15	24946864	.	A	G	2	1	3	0	0	3	0	0
15	24947144	.	A	C	1	2	3	0	0	3	0	0
15	24948537	.	C	G	4	6	10	0	0	10	0	0
15	24959877	.	G	T	3	2	5	0	1	6	0	0
15	24960463	.	G	A	3	4	7	0	1	8	0	0
15	25096386	.	G	T	1	2	3	0	1	4	0	0
15	25096677	.	T	C	7	8	15	0	0	15	0	0
15	25097582	.	C	T	3	3	6	0	0	6	0	0
15	25101042	.	C	T	7	5	12	0	1	13	0	0
15	25101083	.	A	G	6	4	10	0	1	11	0	0
15	25101085	.	T	G	5	5	10	0	1	11	0	0
15	25101260	.	T	C	3	5	8	0	2	10	0	0
15	25101267	.	A	G	2	8	10	0	3	13	0	0
15	25101302	.	G	A	2	7	9	0	1	10	0	0
15	25101538	.	G	A	3	12	15	0	2	17	0	0
15	25101619	.	A	G	6	14	20	0	0	20	0	0
15	25101740	.	C	A	15	11	26	0	1	27	0	0
15	25101990	.	A	G	6	10	16	0	0	16	0	0
15	25127854	.	A	G	3	1	4	0	0	4	0	0
15	25152258	.	A	G	0	2	2	0	0	2	0	0
15	25153250	.	C	A	2	3	5	0	0	5	0	0
15	25153294	.	G	A	4	6	10	0	0	10	0	0
15	25153307	.	T	A	1	7	8	0	0	8	0	0
15	25173015	.	C	T	0	5	5	0	1	6	0	0
15	25173157	.	A	G	9	10	19	0	2	21	0	0
15	25173188	.	A	T	9	8	17	0	0	17	0	0
15	25173494	.	A	C	5	7	12	0	1	13	0	0
15	25173714	.	C	T	1	19	20	0	0	20	0	0
15	25173759	.	T	C	2	9	11	0	0	11	0	0
15	25173877	.	C	T	0	2	2	0	0	2	0	0
15	25174048	.	C	A	0	9	9	0	5	14	0	0
15	25174634	.	G	A	11	3	14	0	0	14	0	0
15	25175811	.	A	C	4	5	9	0	0	9	0	0
15	25176191	.	G	C	7	0	7	0	3	10	0	0
15	25176527	.	C	T	0	6	6	0	10	16	0	0
15	25214384	.	A	G	6	6	12	0	0	12	0	0
15	25273187	.	C	T	11	10	21	0	0	21	0	0
15	25278986	.	A	G	13	12	25	0	0	25	0	0
15	25281387	.	G	A	6	8	14	0	0	14	0	0
15	25283846	.	A	C	7	0	7	0	3	10	0	0
15	25283963	.	A	G	3	10	13	0	0	13	0	0
15	25304678	.	C	A	14	9	23	0	1	24	0	0
15	25321973	.	G	A	3	7	10	0	1	11	0	0
15	25321982	.	A	C	6	4	10	0	1	11	0	0
15	25322410	.	C	A	0	7	7	0	6	13	0	0
15	25322607	.	T	G	18	11	29	0	1	30	0	0
15	25322783	.	G	A	10	8	18	0	0	18	0	0
15	25322853	.	C	T	5	14	19	0	0	19	0	0
15	25323064	.	G	C	12	7	19	0	0	19	0	0
15	25333922	.	C	T	0	3	3	0	2	5	0	0
15	25344998	.	G	A	4	7	11	0	0	11	0	0
15	25352062	.	C	A	2	2	4	0	0	4	0	0
15	25352251	.	C	T	0	1	1	0	1	2	0	0
15	25352260	.	G	C	1	0	1	0	1	2	0	0
15	25357191	.	A	G	2	3	5	0	0	5	0	0
15	25375950	.	C	A	5	1	6	0	0	6	0	0
15	25376190	.	T	C	9	2	11	0	0	11	0	0
15	25376212	.	T	G	8	5	13	0	0	13	0	0
15	25376332	.	A	T	2	3	5	0	1	6	0	0
15	25376673	.	G	C	4	6	10	0	0	10	0	0
15	25376674	.	C	T	0	5	5	0	5	10	0	0
15	25376842	.	A	G	1	3	4	0	0	4	0	0
15	25377137	.	C	T	0	7	7	0	6	13	0	0
15	25377155	.	C	T	0	6	6	0	5	11	0	0
15	25398406	.	A	C	2	3	5	0	0	5	0	0
15	25398665	.	C	A	2	4	6	0	1	7	0	0
15	25400018	.	A	G	2	2	4	0	1	5	0	0
15	25484052	.	A	G	4	2	6	0	0	6	0	0
15	25485155	.	A	G	2	0	2	0	4	6	0	0
15	25485394	.	A	G	3	3	6	0	0	6	0	0
15	25498645	.	G	C	0	8	8	0	5	13	0	0
15	25498718	.	C	A	7	3	10	0	0	10	0	0
15	25498946	.	C	T	4	9	13	0	1	14	0	0
15	25499171	.	A	G	4	2	6	0	0	6	0	0
15	25504064	.	A	G	2	4	6	0	1	7	0	0
15	25504397	.	A	C	5	0	5	0	3	8	0	0
15	25504399	.	T	A	5	3	8	0	0	8	0	0
15	25507942	.	A	T	1	3	4	0	1	5	0	0
15	25508539	.	T	G	3	3	6	0	0	6	0	0
15	25508852	.	T	G	1	1	2	0	1	3	0	0
15	25509414	.	C	A	0	3	3	0	2	5	0	0
15	25509498	.	G	A	1	1	2	0	0	2	0	0
15	25509500	.	C	T	0	1	1	0	1	2	0	0
15	25510372	.	G	T	3	4	7	0	0	7	0	0
15	25512525	.	T	C	2	0	2	0	2	4	0	0
15	25515702	.	G	A	2	0	2	0	0	2	0	0
15	25528359	.	C	A	1	2	3	0	0	3	0	0
15	25531955	.	G	A	2	1	3	0	0	3	0	0
15	25531957	.	A	G	2	0	2	0	1	3	0	0
15	25533361	.	T	A	2	2	4	0	0	4	0	0
15	25533363	.	T	C	2	2	4	0	0	4	0	0
15	25534200	.	T	C	1	2	3	0	0	3	0	0
15	25537641	.	C	A	1	2	3	0	0	3	0	0
15	25538178	.	A	G	8	8	16	0	1	17	0	0
15	25538381	.	T	C	8	6	14	0	0	14	0	0
15	25538793	.	G	A	0	4	4	0	4	8	0	0
15	25588805	.	A	G	10	17	27	0	0	27	0	0
15	25588836	.	A	C	16	17	33	0	1	34	0	0
15	25588840	.	T	C	16	0	16	0	16	32	0	0
15	25589119	.	G	T	9	7	16	0	1	17	0	0
15	25589197	.	T	A	17	16	33	0	1	34	0	0
15	25589280	.	G	T	12	17	29	0	3	32	0	0
15	25589321	.	A	G	11	10	21	0	3	25	1	0
15	25589438	.	C	G	12	16	28	0	1	29	0	0
15	25589582	.	G	C	9	20	29	0	2	31	0	0
15	25589624	.	C	T	12	9	21	0	1	22	0	0
15	25589640	.	T	C	9	7	16	0	3	19	0	0
15	25589708	.	A	G	23	8	31	0	0	31	0	0
15	25589812	.	A	T	8	12	20	0	0	20	0	0
15	25589838	.	A	G	8	8	16	0	1	17	0	0
15	25589979	.	T	A	5	13	18	0	1	19	0	0
15	25589983	.	C	T	6	14	20	0	1	21	0	0
15	25590022	.	A	G	6	10	16	0	1	17	0	0
15	25590129	.	A	G	8	12	20	0	0	20	0	0
15	25590155	.	T	C	8	13	21	0	0	21	0	0
15	25590235	.	A	G	2	3	5	0	1	6	0	0
15	25590240	.	A	G	4	3	7	0	0	7	0	0
15	25590297	.	A	G	6	10	16	0	0	16	0	0
15	25590394	.	T	A	5	11	16	0	0	16	0	0
15	25590474	.	G	A	9	8	17	0	1	18	0	0
15	25590585	.	G	T	5	9	14	0	0	14	0	0
15	25590820	.	A	G	4	10	14	0	0	14	0	0
15	25591541	.	A	T	14	12	26	0	1	27	0	0
15	25591553	.	A	C	12	13	25	0	1	26	0	0
15	25591807	.	C	G	9	8	17	0	2	19	0	0
15	25591820	.	A	T	7	8	15	0	2	17	0	0
15	25591846	.	A	G	8	6	14	0	2	16	0	0
15	25591938	.	C	T	1	3	4	0	0	4	0	0
15	25592013	.	A	G	2	2	4	0	0	4	0	0
15	25592064	.	C	T	3	3	6	0	0	6	0	0
15	25592080	.	C	T	0	4	4	0	1	5	0	0
15	25592126	.	C	G	2	3	5	0	0	5	0	0
15	25592223	.	A	G	2	5	7	0	0	7	0	0
15	25592606	.	T	A	3	4	7	0	0	7	0	0
15	25593187	.	T	G	5	5	10	0	1	11	0	0
15	25594091	.	A	G	2	6	8	0	2	10	0	0
15	25594345	.	C	T	0	4	4	0	2	6	0	0
15	25594810	.	A	C	2	2	4	0	0	4	0	0
15	25595049	.	G	T	2	2	4	0	0	4	0	0
15	25595187	.	T	C	1	4	5	0	1	6	0	0
15	25595350	.	T	A	5	3	8	0	0	8	0	0
15	25595352	.	A	T	5	3	8	0	0	8	0	0
15	25595702	.	T	C	5	7	12	0	0	12	0	0
15	25598963	.	G	A	10	3	13	0	0	13	0	0
15	25602628	.	G	A	2	1	3	0	0	3	0	0
15	25602915	.	A	G	5	3	8	0	1	9	0	0
15	25603017	.	G	A	0	1	1	0	0	1	0	0
15	25605041	.	A	G	4	2	6	0	1	7	0	0
15	25608056	.	A	G	0	2	2	0	0	2	0	0
15	25608288	.	A	G	2	1	3	0	0	3	0	0
15	25628766	.	T	C	1	3	4	0	0	4	0	0
15	25635424	.	C	T	2	4	6	0	1	7	0	0
15	25640533	.	T	C	2	0	2	0	0	2	0	0
15	25640540	.	A	G	2	0	2	0	0	2	0	0
15	25640891	.	C	T	3	3	6	0	0	6	0	0
15	25640892	.	T	G	3	3	6	0	0	6	0	0
15	25649944	.	G	A	4	3	7	0	0	7	0	0
15	25650100	.	T	G	0	0	0	0	1	1	0	0
15	25653349	.	A	G	2	3	5	0	1	6	0	0
15	25656103	.	C	T	6	9	15	0	0	15	0	0
15	25656175	.	A	G	5	4	9	0	0	9	0	0
15	25910655	.	A	C	2	2	4	0	0	4	0	0
15	26399801	.	T	C	2	3	5	0	0	5	0	0
15	26400297	.	G	C	2	5	7	0	1	8	0	0
15	26400300	.	A	C	4	4	8	0	0	8	0	0
15	26400743	.	T	G	5	3	8	0	0	8	0	0
15	26400766	.	A	G	8	3	11	0	0	11	0	0
15	26400819	.	A	G	6	6	12	0	2	14	0	0
15	26400836	.	G	A	4	8	12	0	3	15	0	0
15	26400876	.	G	A	11	11	22	0	1	23	0	0
15	26400900	.	C	T	10	9	19	0	2	21	0	0
15	26400924	.	A	T	9	6	15	0	2	17	0	0
15	26401101	.	A	G	8	9	17	0	1	18	0	0
15	26401194	.	T	G	5	6	11	0	0	11	0	0
15	26401200	.	C	T	4	6	10	0	0	10	0	0
15	26401259	.	A	C	8	3	11	0	0	11	0	0
15	26401623	.	A	T	6	9	15	0	0	15	0	0
15	26401779	.	A	G	13	12	25	0	0	25	0	0
15	26401880	.	A	T	1	2	3	0	1	4	0	0
15	26401888	.	G	C	3	2	5	0	0	5	0	0
15	26402167	.	G	A	12	7	19	0	0	19	0	0
15	26498455	.	A	T	5	5	10	0	1	11	0	0
15	26498615	.	C	T	5	19	24	0	1	25	0	0
15	26498621	.	C	A	7	18	25	0	0	25	0	0
15	26498716	.	A	G	17	13	30	0	0	30	0	0
15	26498749	.	A	T	20	12	32	0	0	32	0	0
15	26498820	.	T	G	9	18	27	0	1	28	0	0
15	26505495	.	C	A	1	4	5	0	0	5	0	0
15	26515021	.	C	T	0	0	0	0	4	4	0	0
15	26534203	.	G	A	2	2	4	0	0	4	0	0
15	26538885	.	G	A	1	1	2	0	1	3	0	0
15	26553093	.	A	T	5	8	13	0	1	14	0	0
15	26553095	.	T	C	6	8	14	0	0	14	0	0
15	26554008	.	G	A	3	3	6	0	0	6	0	0
15	26554014	.	A	T	3	3	6	0	0	6	0	0
15	26554516	.	T	A	2	2	4	0	0	4	0	0
15	26554686	.	G	A	3	4	7	0	0	7	0	0
15	26561058	.	A	C	2	4	6	0	0	6	0	0
15	26561347	.	G	A	2	3	5	0	1	6	0	0
15	26561468	.	C	T	2	2	4	0	0	4	0	0
15	26563456	.	C	T	0	1	1	0	1	2	0	0
15	26564209	.	G	A	1	2	3	0	0	3	0	0
15	26566472	.	A	C	2	0	2	0	2	4	0	0
15	26678917	.	C	A	0	7	7	0	3	10	0	0
15	26678932	.	T	A	2	8	10	0	1	11	0	0
15	26679070	.	T	A	2	6	8	0	2	10	0	0
15	26679374	.	C	T	2	2	4	0	0	4	0	0
15	26679908	.	C	T	0	12	12	0	5	17	0	0
15	26683504	.	A	G	1	1	2	0	0	2	0	0
15	26686828	.	A	T	0	0	0	0	1	15	14	0
15	26707518	.	G	A	2	4	6	0	0	6	0	0
15	26707569	.	G	T	1	0	1	0	0	1	0	0
15	26710306	.	G	A	1	3	4	0	1	5	0	0
15	26720581	.	C	T	0	3	3	0	2	5	0	0
15	26729480	.	G	A	2	3	5	0	0	5	0	0
15	26843956	.	A	G	1	1	2	0	0	2	0	0
15	26849351	.	A	G	1	3	4	0	0	4	0	0
15	26849637	.	A	G	2	2	4	0	0	4	0	0
15	26849890	.	G	A	1	3	4	0	0	4	0	0
15	26855004	.	G	C	5	2	7	0	0	7	0	0
15	26855019	.	A	G	5	2	7	0	0	7	0	0
15	26877497	.	G	T	3	0	3	0	0	3	0	0
15	26883982	.	T	A	1	2	3	0	0	3	0	0
15	26884010	.	G	C	1	0	1	0	3	4	0	0
15	26904430	.	A	G	5	4	9	0	0	9	0	0
15	26904779	.	G	A	4	7	11	0	0	11	0	0
15	26904838	.	A	G	1	5	6	0	1	7	0	0
15	26904899	.	A	G	1	2	3	0	0	3	0	0
15	26904989	.	C	A	4	6	10	0	0	10	0	0
15	26905002	.	C	T	3	7	10	0	2	12	0	0
15	26915384	.	T	A	15	6	21	0	0	21	0	0
15	26915531	.	A	G	5	7	12	0	1	13	0	0
15	26915568	.	G	A	7	9	16	0	0	16	0	0
15	26915633	.	C	T	3	2	5	0	1	6	0	0
15	26915651	.	T	C	0	2	2	0	0	2	0	0
15	26919255	.	T	C	3	3	6	0	1	7	0	0
15	26924056	.	T	C	6	6	12	0	0	12	0	0
15	26924080	.	C	G	0	3	3	0	8	11	0	0
15	26926474	.	G	A	4	3	7	0	0	7	0	0
15	26935032	.	A	T	5	5	10	0	0	10	0	0
15	26935696	.	G	A	1	1	2	0	0	2	0	0
15	26938324	.	A	C	5	2	7	0	0	7	0	0
15	26939031	.	C	A	5	10	15	0	0	15	0	0
15	26939224	.	G	T	8	3	11	0	0	11	0	0
15	26939233	.	A	C	2	6	8	0	0	8	0	0
15	26939279	.	G	A	0	6	6	0	1	7	0	0
15	26941892	.	G	A	0	1	1	0	1	2	0	0
15	26993973	.	C	A	4	2	6	0	1	7	0	0
15	27071063	.	A	G	5	0	5	0	3	8	0	0
15	27071096	.	C	G	1	1	2	0	0	2	0	0
15	27071099	.	A	G	1	1	2	0	0	2	0	0
15	27071735	.	G	A	0	1	1	0	0	1	0	0
15	27071792	.	T	G	5	4	9	0	0	9	0	0
15	27071849	.	G	A	4	2	6	0	0	6	0	0
15	27328142	.	T	G	3	0	3	0	4	7	0	0
15	27352608	.	G	A	3	5	8	0	0	8	0	0
15	27353481	.	G	A	4	4	8	0	0	8	0	0
15	27354412	.	T	A	17	15	32	0	3	36	1	0
15	27371021	.	T	A	3	4	7	0	0	7	0	0
15	27703845	.	A	G	13	14	27	0	0	27	0	0
15	27704220	.	C	A	0	6	6	0	22	28	0	0
15	27710392	.	A	G	3	6	9	0	1	10	0	0
15	27710396	.	C	T	5	4	9	0	0	9	0	0
15	28079249	.	A	T	1	3	4	0	0	4	0	0
15	28079317	.	T	A	1	3	4	0	0	4	0	0
15	28079355	.	A	T	1	2	3	0	0	3	0	0
15	28085382	.	T	C	6	5	11	0	0	11	0	0
15	28085422	.	G	A	5	3	8	0	0	8	0	0
15	28089297	.	A	G	2	1	3	0	0	3	0	0
15	28106804	.	A	G	1	4	5	0	2	7	0	0
15	28124642	.	C	T	0	1	1	0	0	1	0	0
15	28124913	.	T	C	0	2	2	0	0	2	0	0
15	28125146	.	A	G	3	0	3	0	5	8	0	0
15	28125186	.	A	G	3	8	11	0	0	11	0	0
15	28182837	.	A	G	1	2	3	0	0	3	0	0
15	28182924	.	T	C	2	2	4	0	0	4	0	0
15	28182927	.	T	C	1	2	3	0	1	4	0	0
15	28182964	.	G	A	1	0	1	0	0	1	0	0
15	28189029	.	T	A	3	5	8	0	1	9	0	0
15	28189046	.	T	G	3	5	8	0	0	8	0	0
15	28189589	.	T	C	4	0	4	0	5	9	0	0
15	28189591	.	T	C	3	5	8	0	1	9	0	0
15	28189945	.	T	G	2	0	2	0	1	3	0	0
15	28192706	.	A	G	4	6	10	0	0	10	0	0
15	28194669	.	T	C	1	3	4	0	1	5	0	0
15	28194708	.	A	G	3	9	12	0	0	12	0	0
15	28199233	.	G	A	3	2	5	0	0	5	0	0
15	28199431	.	A	G	4	2	6	0	0	6	0	0
15	28199437	.	A	T	2	2	4	0	0	4	0	0
15	28199905	.	T	G	1	1	2	0	0	2	0	0
15	28207548	.	G	C	2	2	4	0	0	4	0	0
15	28242043	.	T	C	0	1	1	0	0	1	0	0
15	28249301	.	G	T	3	5	8	0	0	8	0	0
15	28251094	.	T	A	1	0	1	0	0	1	0	0
15	28252597	.	T	C	7	8	15	0	2	17	0	0
15	28252599	.	A	G	9	7	16	0	1	17	0	0
15	28253171	.	C	A	0	9	9	0	14	23	0	0
15	28253522	.	C	T	0	5	5	0	0	5	0	0
15	28253773	.	C	T	5	9	14	0	0	14	0	0
15	28254202	.	G	T	1	3	4	0	0	4	0	0
15	28256036	.	A	G	1	0	1	0	0	1	0	0
15	28257277	.	A	G	1	0	1	0	0	1	0	0
15	28259321	.	T	C	1	0	1	0	0	1	0	0
15	28260381	.	A	T	3	1	4	0	0	4	0	0
15	28260522	.	T	A	3	3	6	0	0	6	0	0
15	28343667	.	C	T	1	1	2	0	1	3	0	0
15	28349816	.	C	T	1	1	2	0	0	2	0	0
15	28350079	.	C	G	1	4	5	0	1	6	0	0
15	28350095	.	C	T	2	5	7	0	0	7	0	0
15	28350953	.	C	A	3	2	5	0	1	6	0	0
15	28351089	.	C	G	5	3	8	0	1	9	0	0
15	28351132	.	G	A	5	2	7	0	0	7	0	0
15	28352138	.	T	C	9	4	13	0	1	14	0	0
15	28392769	.	G	T	2	3	5	0	1	6	0	0
15	28403365	.	C	T	2	4	6	0	0	6	0	0
15	28432697	.	C	A	11	10	21	0	0	21	0	0
15	28432739	.	C	T	9	10	19	0	1	20	0	0
15	28432741	.	A	T	8	11	19	0	1	20	0	0
15	28432871	.	T	C	7	5	12	0	1	13	0	0
15	28432993	.	C	T	0	8	8	0	13	21	0	0
15	28433073	.	A	G	12	10	22	0	0	22	0	0
15	28433102	.	C	A	9	7	16	0	0	16	0	0
15	28433282	.	G	A	11	8	19	0	1	20	0	0
15	28433947	.	A	G	16	6	22	0	0	22	0	0
15	28437178	.	G	T	2	3	5	0	0	5	0	0
15	28439441	.	G	A	1	1	2	0	0	2	0	0
15	28446791	.	A	T	4	4	8	0	0	8	0	0
15	28452844	.	A	G	3	0	3	0	0	3	0	0
15	28453081	.	C	A	1	4	5	0	3	8	0	0
15	28453102	.	C	T	1	3	4	0	0	4	0	0
15	28463609	.	C	T	0	1	1	0	0	1	0	0
15	28480293	.	A	G	2	5	7	0	0	7	0	0
15	28483333	.	A	C	1	1	2	0	0	2	0	0
15	28509840	.	G	A	3	2	5	0	0	5	0	0
15	28515428	.	C	A	4	2	6	0	0	6	0	0
15	28520856	.	A	G	2	0	2	0	2	4	0	0
15	28526386	.	A	T	0	4	4	0	0	4	0	0
15	28537810	.	T	A	4	4	8	0	0	8	0	0
15	28537852	.	T	C	4	4	8	0	0	8	0	0
15	28537872	.	G	A	0	4	4	0	5	9	0	0
15	28537906	.	A	C	4	4	8	0	0	8	0	0
15	28538173	.	G	A	4	8	12	0	0	12	0	0
15	28538199	.	T	C	7	7	14	0	0	14	0	0
15	28538239	.	G	T	5	4	9	0	0	9	0	0
15	28538761	.	A	G	11	12	23	0	0	23	0	0
15	28538765	.	C	T	11	13	24	0	0	24	0	0
15	28538984	.	C	T	6	3	9	0	0	9	0	0
15	28539022	.	C	A	4	7	11	0	1	12	0	0
15	28539112	.	C	T	5	6	11	0	0	11	0	0
15	28539160	.	T	C	6	3	9	0	0	9	0	0
15	28539232	.	C	T	2	6	8	0	0	8	0	0
15	28539381	.	A	T	2	4	6	0	0	6	0	0
15	28539383	.	A	T	2	3	5	0	1	6	0	0
15	28539523	.	T	C	7	5	12	0	1	13	0	0
15	28539556	.	G	A	6	4	10	0	0	10	0	0
15	28539649	.	T	A	7	6	13	0	1	14	0	0
15	28549003	.	G	A	6	7	13	0	0	13	0	0
15	28549347	.	G	T	7	6	13	0	1	14	0	0
15	28549348	.	T	A	7	7	14	0	0	14	0	0
15	28549392	.	A	C	9	8	17	0	0	17	0	0
15	28549665	.	T	C	2	0	2	0	4	6	0	0
15	28549872	.	A	C	2	4	6	0	0	6	0	0
15	28550088	.	A	G	2	3	5	0	0	5	0	0
15	28551281	.	G	A	2	3	5	0	1	6	0	0
15	28551285	.	G	A	2	4	6	0	0	6	0	0
15	28551498	.	A	G	1	3	4	0	0	4	0	0
15	28609097	.	G	A	3	6	9	0	0	9	0	0
15	28611934	.	G	A	0	1	1	0	0	1	0	0
15	28634719	.	G	A	9	9	18	0	1	19	0	0
15	28646687	.	G	A	0	1	1	0	0	1	0	0
15	28646696	.	T	C	1	0	1	0	1	2	0	0
15	28677558	.	T	A	1	0	1	0	0	1	0	0
15	28686433	.	A	T	7	14	21	0	4	25	0	0
15	28758907	.	G	C	0	14	14	0	13	27	0	0
15	28758988	.	C	T	10	9	19	0	0	19	0	0
15	28759171	.	T	G	15	0	15	0	19	34	0	0
15	28759246	.	G	C	0	14	14	0	21	36	1	0
15	28759558	.	C	G	9	0	9	0	7	16	0	0
15	28759639	.	G	A	6	10	16	0	0	16	0	0
15	28760090	.	T	C	10	18	28	0	1	29	0	0
15	28760675	.	A	T	13	16	29	0	2	31	0	0
15	28761031	.	T	C	8	8	16	0	0	16	0	0
15	28761173	.	T	C	16	15	31	0	3	34	0	0
15	28761284	.	T	A	12	16	28	0	0	29	1	0
15	28762440	.	C	T	15	23	38	0	1	39	0	0
15	28763124	.	T	C	23	18	41	0	2	43	0	0
15	28763134	.	T	C	22	18	40	0	0	40	0	0
15	28763677	.	C	A	18	17	35	0	0	35	0	0
15	28763770	.	T	C	25	24	49	0	0	49	0	0
15	28763927	.	G	A	0	25	25	0	18	43	0	0
15	28763986	.	G	A	0	23	23	0	22	45	0	0
15	28764206	.	G	T	1	8	9	0	19	28	0	0
15	28764252	.	A	G	26	0	26	0	28	54	0	0
15	28766069	.	A	G	7	8	15	0	1	16	0	0
15	28787262	.	T	A	1	2	3	0	0	3	0	0
15	28881717	.	G	A	5	2	7	0	0	7	0	0
15	28882675	.	T	A	4	6	10	0	1	11	0	0
15	28882687	.	A	G	3	4	7	0	1	8	0	0
15	28886882	.	A	T	4	1	5	0	0	5	0	0
15	28887280	.	G	T	0	2	2	0	0	2	0	0
15	28887667	.	A	G	1	2	3	0	0	3	0	0
15	28960057	.	T	C	0	2	2	0	0	2	0	0
15	29000989	.	C	T	10	15	25	0	2	27	0	0
15	29001556	.	C	T	15	15	30	0	1	31	0	0
15	29001583	.	T	C	11	9	20	0	1	21	0	0
15	29005346	.	T	A	12	14	26	0	1	27	0	0
15	29005363	.	A	C	10	9	19	1	7	27	0	0
15	29005564	.	T	G	9	7	16	0	0	16	0	0
15	29005600	.	A	C	12	10	22	0	0	22	0	0
15	29005935	.	C	T	16	14	30	0	0	30	0	0
15	29005984	.	C	T	21	13	34	0	0	34	0	0
15	29005996	.	C	A	20	12	32	0	2	34	0	0
15	29006097	.	C	T	22	17	39	0	0	39	0	0
15	29006142	.	G	A	0	16	16	0	33	49	0	0
15	29089143	.	T	A	15	23	38	0	2	40	0	0
15	29089279	.	C	A	25	18	43	0	3	46	0	0
15	29089317	.	A	G	15	25	40	0	0	40	0	0
15	29089392	.	A	G	16	14	30	0	2	32	0	0
15	29089524	.	T	C	27	17	44	0	0	44	0	0
15	29089788	.	G	A	23	23	46	0	0	46	0	0
15	29089827	.	G	T	2	19	21	0	26	47	0	0
15	29089870	.	C	T	24	26	50	0	4	54	0	0
15	29090181	.	A	G	26	23	49	0	7	56	0	0
15	29091565	.	G	A	28	17	45	0	4	49	0	0
15	29092592	.	G	A	1	2	3	0	0	3	0	0
15	29092871	.	C	T	2	3	5	0	1	6	0	0
15	29093073	.	C	A	6	6	12	0	0	12	0	0
15	29097468	.	T	C	1	0	1	0	0	1	0	0
15	29097640	.	A	G	7	8	15	0	2	17	0	0
15	29100574	.	T	G	3	5	8	0	1	9	0	0
15	29100623	.	G	A	2	4	6	0	0	6	0	0
15	29104050	.	G	A	3	3	6	0	0	6	0	0
15	29106691	.	T	C	0	1	1	0	0	1	0	0
15	29108812	.	T	C	4	8	12	0	0	12	0	0
15	29108872	.	A	G	1	0	1	0	0	1	0	0
15	29111902	.	A	C	1	0	1	0	3	4	0	0
15	29111969	.	C	T	0	3	3	0	0	3	0	0
15	29111970	.	T	C	0	3	3	0	0	3	0	0
15	29112164	.	C	T	0	1	1	0	0	1	0	0
15	29114289	.	C	A	0	2	2	0	0	2	0	0
15	29114337	.	C	G	0	5	5	0	2	7	0	0
15	29114361	.	A	T	2	6	8	0	0	8	0	0
15	29116177	.	T	C	5	6	11	0	0	11	0	0
15	29116264	.	A	G	7	7	14	0	5	19	0	0
15	29119813	.	A	C	1	3	4	0	2	6	0	0
15	29119829	.	A	C	1	5	6	0	0	6	0	0
15	29122072	.	T	A	9	16	25	0	2	27	0	0
15	29136127	.	A	T	1	1	2	0	0	2	0	0
15	29148674	.	T	C	1	3	4	0	1	5	0	0
15	29148675	.	T	G	1	0	1	0	4	5	0	0
15	29152041	.	G	T	3	3	6	0	0	6	0	0
15	29312303	.	C	A	1	4	5	0	0	5	0	0
15	29316951	.	C	A	3	2	5	0	1	6	0	0
15	29343748	.	A	G	2	3	5	0	0	5	0	0
15	29343786	.	T	C	1	6	7	0	0	7	0	0
15	29343863	.	A	G	1	4	5	0	0	5	0	0
15	29456387	.	A	G	3	2	5	0	0	5	0	0
15	29456410	.	C	T	2	1	3	0	0	3	0	0
15	29459013	.	A	G	6	2	8	0	0	8	0	0
15	29459046	.	G	A	7	5	12	0	1	13	0	0
15	29465874	.	T	C	4	5	9	0	3	12	0	0
15	29467216	.	T	A	6	10	16	0	0	16	0	0
15	29467254	.	A	G	3	2	5	0	8	13	0	0
15	29467339	.	A	G	1	2	3	0	0	3	0	0
15	29469851	.	G	T	3	2	5	0	0	5	0	0
15	29481884	.	A	G	12	9	21	0	3	24	0	0
15	29481921	.	G	A	0	8	8	0	16	24	0	0
15	29482286	.	G	C	8	15	23	0	1	24	0	0
15	29482439	.	A	G	3	5	8	0	0	8	0	0
15	29483095	.	T	G	3	4	7	0	1	8	0	0
15	29483236	.	T	G	4	5	9	0	0	9	0	0
15	29483326	.	G	A	0	1	1	0	6	7	0	0
15	29483434	.	G	C	12	7	19	0	0	19	0	0
15	29483608	.	A	T	9	8	17	0	1	18	0	0
15	29483712	.	T	A	10	4	14	0	0	14	0	0
15	29483851	.	G	T	15	10	25	0	1	26	0	0
15	29549217	.	A	G	6	4	10	0	0	10	0	0
15	29555569	.	G	T	0	1	1	0	0	1	0	0
15	29555886	.	G	A	2	1	3	0	0	3	0	0
15	29555892	.	C	A	0	2	2	0	2	4	0	0
15	29556667	.	T	C	2	1	3	0	0	3	0	0
15	29709048	.	G	T	0	2	2	0	0	2	0	0
15	29710065	.	A	G	3	8	11	0	1	12	0	0
15	29710737	.	G	T	5	3	8	0	0	8	0	0
15	29712127	.	C	A	2	9	11	0	0	11	0	0
15	29712210	.	G	A	0	10	10	0	7	17	0	0
15	29712221	.	C	T	5	14	19	0	0	19	0	0
15	29712405	.	G	A	7	7	14	0	3	17	0	0
15	29889709	.	C	T	0	3	3	0	3	6	0	0
15	30127451	.	T	C	2	3	5	0	0	5	0	0
15	30130286	.	G	T	3	2	5	0	0	5	0	0
15	30130530	.	A	C	5	5	10	0	1	11	0	0
15	30130664	.	G	A	0	6	6	0	3	9	0	0
15	30131482	.	G	A	4	5	9	0	1	10	0	0
15	30131585	.	C	T	3	2	5	0	0	5	0	0
15	30131803	.	G	A	2	3	5	0	0	5	0	0
15	30134489	.	G	A	9	4	13	0	0	13	0	0
15	30134679	.	C	G	2	2	4	0	0	4	0	0
15	30134779	.	G	T	4	4	8	0	0	8	0	0
15	30135016	.	T	A	4	4	8	0	0	8	0	0
15	30135206	.	G	A	0	5	5	0	6	11	0	0
15	30135572	.	A	G	6	1	7	0	8	15	0	0
15	30135920	.	A	G	6	6	12	0	0	12	0	0
15	30135948	.	G	A	4	6	10	0	0	10	0	0
15	30136962	.	A	G	7	1	8	0	12	20	0	0
15	30137561	.	C	T	13	12	25	0	0	25	0	0
15	30157713	.	A	G	3	0	3	0	7	10	0	0
15	30158096	.	G	T	0	6	6	0	7	13	0	0
15	30159050	.	A	T	10	7	17	0	0	17	0	0
15	30252414	.	T	C	4	2	6	0	1	7	0	0
15	30265017	.	C	T	6	7	13	0	1	14	0	0
15	30301196	.	G	A	0	5	5	0	7	12	0	0
15	30301239	.	G	A	0	4	4	0	6	10	0	0
15	30301320	.	T	C	4	5	9	0	0	9	0	0
15	30301447	.	G	A	7	3	10	0	2	12	0	0
15	30301474	.	G	A	3	4	7	0	0	7	0	0
15	30311016	.	C	T	3	5	8	0	0	8	0	0
15	30311062	.	G	T	0	7	7	0	3	10	0	0
15	30311616	.	T	G	1	3	4	0	0	4	0	0
15	30350666	.	A	T	1	2	3	0	0	3	0	0
15	30354513	.	G	T	4	8	12	0	0	12	0	0
15	30424673	.	C	T	0	5	5	0	5	10	0	0
15	30425936	.	G	A	5	5	10	0	0	10	0	0
15	30838455	.	C	G	5	2	7	0	1	8	0	0
15	30838498	.	G	A	0	10	10	0	3	13	0	0
15	30838501	.	A	G	8	1	9	0	6	15	0	0
15	30838777	.	G	A	18	16	34	0	0	35	1	0
15	30838867	.	C	T	9	12	21	0	0	21	0	0
15	30839168	.	A	T	10	9	19	0	0	19	0	0
15	30852433	.	G	A	6	5	11	0	0	11	0	0
15	30852598	.	T	C	4	9	13	0	0	13	0	0
15	30853039	.	G	T	6	7	13	0	1	14	0	0
15	30853096	.	T	A	11	6	17	0	2	19	0	0
15	30861987	.	C	A	0	5	5	0	9	14	0	0
15	30862251	.	A	T	8	5	13	0	0	13	0	0
15	30862449	.	A	G	8	9	17	0	2	19	0	0
15	30862452	.	G	T	9	10	19	0	0	19	0	0
15	30862517	.	G	A	3	6	9	0	0	9	0	0
15	30862712	.	G	A	5	9	14	0	1	15	0	0
15	30862785	.	C	T	13	8	21	0	0	21	0	0
15	30862814	.	A	G	11	10	21	0	1	22	0	0
15	30862997	.	T	G	3	4	7	0	0	7	0	0
15	30863059	.	T	C	4	0	4	0	4	8	0	0
15	30863117	.	T	C	6	5	11	0	0	11	0	0
15	30863123	.	A	C	6	5	11	0	0	11	0	0
15	30863354	.	C	T	5	4	9	0	0	9	0	0
15	30863535	.	G	T	13	10	23	0	3	26	0	0
15	30863569	.	G	A	12	14	26	0	0	26	0	0
15	30863799	.	T	C	14	0	14	0	5	19	0	0
15	30863834	.	G	T	12	7	19	0	0	19	0	0
15	30863850	.	T	C	9	7	16	0	0	16	0	0
15	30864308	.	C	A	8	5	13	0	1	14	0	0
15	30864354	.	T	C	6	0	6	0	6	12	0	0
15	30874327	.	A	G	11	11	22	0	0	22	0	0
15	30874387	.	G	A	3	4	7	0	0	7	0	0
15	30891570	.	A	G	3	3	6	0	1	7	0	0
15	30900478	.	A	G	1	3	4	0	0	4	0	0
15	30904802	.	G	A	2	0	2	0	2	4	0	0
15	30906972	.	G	A	1	1	2	0	1	3	0	0
15	30907811	.	A	G	4	0	4	0	1	5	0	0
15	30907818	.	G	A	0	2	2	0	5	7	0	0
15	30907884	.	C	A	7	5	12	0	0	12	0	0
15	30907888	.	A	G	7	0	7	0	3	10	0	0
15	30909175	.	C	G	15	0	15	0	13	28	0	0
15	30909308	.	G	A	0	8	8	0	19	27	0	0
15	30909572	.	C	A	6	14	20	0	0	20	0	0
15	30909639	.	A	G	11	11	22	0	0	22	0	0
15	30909663	.	G	A	9	5	14	0	1	15	0	0
15	30909771	.	T	C	6	9	15	0	0	15	0	0
15	30909798	.	A	G	8	0	8	0	5	13	0	0
15	30909824	.	A	C	10	9	19	0	0	19	0	0
15	30909884	.	C	T	11	8	19	0	1	20	0	0
15	30919478	.	C	T	9	5	14	0	1	15	0	0
15	30919595	.	T	C	12	11	23	0	0	23	0	0
15	30919676	.	G	T	6	6	12	0	0	12	0	0
15	30919784	.	A	G	5	7	12	0	1	13	0	0
15	30919854	.	T	G	5	4	9	0	0	9	0	0
15	30920135	.	A	G	7	4	11	0	0	11	0	0
15	30920242	.	A	C	6	6	12	0	0	12	0	0
15	30920698	.	C	A	19	5	24	0	1	25	0	0
15	30920780	.	T	C	3	7	10	0	0	10	0	0
15	30920795	.	A	G	3	6	9	0	0	9	0	0
15	30965387	.	C	T	0	2	2	0	0	2	0	0
15	31032622	.	A	G	1	2	3	0	0	3	0	0
15	31072449	.	A	T	0	2	2	0	1	3	0	0
15	31162074	.	T	A	14	15	29	0	1	30	0	0
15	31162122	.	A	G	12	13	25	0	1	26	0	0
15	31162186	.	G	C	18	10	28	0	1	29	0	0
15	31162795	.	G	A	10	6	16	0	1	17	0	0
15	31162836	.	A	G	10	7	17	0	1	18	0	0
15	31163089	.	G	A	3	9	12	0	0	12	0	0
15	31163148	.	T	A	10	16	26	0	1	27	0	0
15	31163335	.	A	T	6	12	18	0	0	18	0	0
15	31163621	.	T	A	16	14	30	0	1	31	0	0
15	31166755	.	C	A	1	2	3	0	0	3	0	0
15	31166788	.	A	G	1	0	1	0	0	1	0	0
15	31173414	.	G	A	4	8	12	0	0	12	0	0
15	31177214	.	T	G	4	7	11	0	1	12	0	0
15	31203002	.	A	G	2	5	7	0	0	7	0	0
15	31205723	.	A	G	2	5	7	0	0	7	0	0
15	31206401	.	A	G	1	7	8	0	0	8	0	0
15	31213017	.	T	C	2	0	2	0	7	9	0	0
15	31213046	.	T	G	2	8	10	0	1	11	0	0
15	31213105	.	C	T	0	6	6	0	1	7	0	0
15	31213171	.	A	G	3	10	13	0	0	13	0	0
15	31213208	.	C	T	2	6	8	0	0	8	0	0
15	31244298	.	C	T	0	3	3	0	3	6	0	0
15	31244412	.	C	T	2	5	7	0	6	13	0	0
15	31250527	.	A	T	2	2	4	0	0	4	0	0
15	31513561	.	G	A	25	28	53	0	7	60	0	0
15	31513842	.	A	G	26	16	42	0	1	43	0	0
15	31513848	.	T	C	23	15	38	0	2	40	0	0
15	31513893	.	C	A	0	4	4	0	3	7	0	0
15	31514325	.	A	G	14	22	36	0	1	37	0	0
15	31516046	.	G	A	2	4	6	0	0	6	0	0
15	31564864	.	G	T	3	5	8	0	0	8	0	0
15	31564885	.	A	G	4	3	7	0	0	7	0	0
15	31568159	.	C	T	0	1	1	0	2	3	0	0
15	31571496	.	A	G	3	2	5	0	0	5	0	0
15	31573941	.	C	G	0	1	1	0	1	2	0	0
15	31582653	.	G	C	0	1	1	0	0	1	0	0
15	31674120	.	G	T	0	2	2	0	0	2	0	0
15	31706200	.	G	C	2	1	3	0	0	3	0	0
15	31732502	.	A	G	5	6	11	0	1	12	0	0
15	31840371	.	G	A	1	3	4	0	1	5	0	0
15	31862250	.	T	C	2	2	4	0	0	4	0	0
15	31864426	.	G	A	3	2	5	0	0	5	0	0
15	31877363	.	C	T	1	1	2	0	0	2	0	0
15	31881825	.	G	A	3	3	6	0	0	6	0	0
15	31881873	.	G	A	0	2	2	0	3	5	0	0
15	31881954	.	T	C	2	4	6	0	0	6	0	0
15	31882044	.	A	G	3	2	5	0	0	5	0	0
15	31882167	.	G	A	2	3	5	0	0	5	0	0
15	31882176	.	A	G	1	3	4	0	0	4	0	0
15	31882269	.	G	A	3	6	9	0	0	9	0	0
15	31882272	.	A	G	2	6	8	0	1	9	0	0
15	31889005	.	T	G	1	4	5	0	0	5	0	0
15	31889086	.	A	G	0	4	4	0	2	6	0	0
15	31889332	.	C	T	1	0	1	0	0	1	0	0
15	31890902	.	T	G	4	3	7	0	0	7	0	0
15	31893536	.	A	C	5	4	9	0	0	9	0	0
15	31893599	.	C	T	0	2	2	0	0	2	0	0
15	31895248	.	A	G	2	0	2	0	4	6	0	0
15	31905040	.	G	A	9	13	22	0	2	24	0	0
15	31905097	.	A	G	6	8	14	0	1	15	0	0
15	31909454	.	A	C	8	8	16	0	2	18	0	0
15	31909819	.	G	A	1	4	5	0	4	9	0	0
15	32194630	.	C	A	3	2	5	0	0	5	0	0
15	32194708	.	A	G	1	3	4	0	0	4	0	0
15	32195395	.	T	C	2	2	4	0	0	4	0	0
15	32195718	.	G	A	3	2	5	0	1	6	0	0
15	32195729	.	A	G	2	5	7	0	0	7	0	0
15	32196363	.	A	T	0	2	2	0	0	2	0	0
15	32196412	.	C	T	1	1	2	0	0	2	0	0
15	32197313	.	T	A	1	3	4	0	0	4	0	0
15	32197354	.	G	T	1	1	2	0	1	3	0	0
15	32249188	.	G	A	11	10	21	0	2	23	0	0
15	32259056	.	G	A	7	6	13	0	0	13	0	0
15	32261461	.	G	C	1	6	7	0	15	22	0	0
15	32261464	.	T	C	9	13	22	0	1	23	0	0
15	32265889	.	T	C	8	16	24	0	1	25	0	0
15	32266441	.	A	G	6	4	10	0	1	11	0	0
15	32266557	.	A	T	9	10	19	0	1	20	0	0
15	32266921	.	G	A	2	8	10	0	11	21	0	0
15	32267078	.	A	G	9	7	16	0	0	16	0	0
15	32349398	.	G	T	6	3	9	0	1	10	0	0
15	32349742	.	A	G	3	5	8	0	0	8	0	0
15	32349754	.	A	G	6	2	8	0	0	8	0	0
15	32350116	.	G	T	7	8	15	0	0	15	0	0
15	32351476	.	A	G	3	5	8	1	2	11	0	0
15	32437032	.	G	A	1	2	3	0	2	5	0	0
15	32887803	.	A	G	4	0	4	1	3	8	0	0
15	32887816	.	A	G	2	2	4	1	1	6	0	0
15	32887858	.	A	G	3	5	8	0	0	8	0	0
15	32888352	.	A	G	0	0	0	0	2	2	0	0
15	33853701	.	C	T	4	2	6	0	1	7	0	0
15	33864152	.	A	G	5	5	10	0	0	10	0	0
15	33864266	.	G	A	10	7	17	0	1	18	0	0
15	33864585	.	G	A	8	7	15	0	0	15	0	0
15	33891825	.	G	A	14	7	21	0	1	22	0	0
15	33891826	.	G	A	13	8	21	0	1	22	0	0
15	33891869	.	G	T	7	9	16	0	2	18	0	0
15	33896117	.	G	T	16	10	26	0	3	29	0	0
15	33896177	.	T	C	12	26	38	0	1	39	0	0
15	33896213	.	T	C	14	2	16	0	21	37	0	0
15	33896303	.	T	A	26	14	40	0	2	42	0	0
15	33896306	.	A	G	14	26	40	0	1	41	0	0
15	33896832	.	T	C	14	12	26	0	0	26	0	0
15	33899556	.	C	G	4	10	14	0	0	15	1	0
15	33899808	.	T	A	9	10	19	0	2	21	0	0
15	33902388	.	C	G	1	9	10	0	6	16	0	0
15	33910546	.	G	C	2	6	8	0	0	8	0	0
15	33970841	.	A	G	12	0	12	0	16	28	0	0
15	33970854	.	C	T	15	14	29	0	1	30	0	0
15	33970907	.	C	T	5	4	9	0	0	9	0	0
15	33971097	.	G	C	18	15	33	0	1	34	0	0
15	33977716	.	A	T	11	14	25	0	1	26	0	0
15	33977760	.	A	G	11	1	12	0	18	30	0	0
15	33977942	.	A	C	8	11	19	0	1	20	0	0
15	33978613	.	G	A	4	2	6	0	0	6	0	0
15	33978633	.	T	C	1	4	5	0	0	5	0	0
15	34074132	.	A	T	2	2	4	0	0	4	0	0
15	34074141	.	T	C	2	2	4	0	0	4	0	0
15	34074246	.	G	A	0	2	2	0	1	3	0	0
15	34074558	.	C	T	2	3	5	0	0	5	0	0
15	34174532	.	T	A	15	11	26	0	1	27	0	0
15	34174568	.	T	A	14	11	25	0	0	26	1	0
15	34174635	.	T	C	12	10	22	0	1	23	0	0
15	34175101	.	T	C	27	19	46	0	1	47	0	0
15	34175359	.	G	A	11	5	16	0	1	17	0	0
15	34175426	.	T	A	3	12	15	0	0	15	0	0
15	34175718	.	G	A	5	5	10	0	0	10	0	0
15	34175917	.	C	T	6	9	15	0	1	16	0	0
15	34175929	.	C	T	12	9	21	0	0	21	0	0
15	34176203	.	A	T	12	10	22	0	0	23	1	0
15	34176214	.	C	T	11	12	23	0	1	24	0	0
15	34176336	.	G	T	3	2	5	0	0	5	0	0
15	34176379	.	A	C	8	9	17	0	1	18	0	0
15	34176841	.	A	T	3	8	11	0	0	11	0	0
15	34176993	.	G	A	9	5	14	0	1	15	0	0
15	34182135	.	G	A	1	1	2	0	0	2	0	0
15	34189452	.	G	A	11	9	20	0	0	20	0	0
15	34334949	.	T	A	2	2	4	0	0	4	0	0
15	34335130	.	T	C	1	3	4	0	0	4	0	0
15	34335147	.	G	A	2	3	5	0	0	5	0	0
15	34335272	.	C	T	2	1	3	0	0	3	0	0
15	34532525	.	C	T	0	1	1	0	0	1	0	0
15	34534245	.	C	G	1	0	1	0	0	1	0	0
15	34534265	.	C	T	0	1	1	0	0	1	0	0
15	34573337	.	C	T	5	3	8	0	0	8	0	0
15	34573343	.	A	G	5	4	9	0	0	9	0	0
15	34573424	.	A	T	3	5	8	0	0	8	0	0
15	34573437	.	G	A	2	6	8	0	1	9	0	0
15	34573959	.	A	T	7	3	10	0	0	10	0	0
15	34574116	.	G	A	4	9	13	0	0	13	0	0
15	34577749	.	G	A	1	0	1	0	0	1	0	0
15	34586304	.	A	G	2	1	3	0	0	3	0	0
15	34590772	.	A	G	5	4	9	0	0	9	0	0
15	34618456	.	T	G	5	6	11	0	0	11	0	0
15	34618669	.	A	T	14	14	28	0	1	29	0	0
15	34618906	.	C	A	11	9	20	0	2	22	0	0
15	34618948	.	T	G	18	9	27	0	0	27	0	0
15	34618958	.	G	A	14	12	26	0	3	29	0	0
15	34621868	.	G	A	9	9	18	0	1	19	0	0
15	34621875	.	G	A	13	10	23	0	1	24	0	0
15	34627792	.	T	A	1	2	3	0	0	3	0	0
15	34627874	.	T	C	4	12	16	0	1	17	0	0
15	34635321	.	C	A	8	8	16	0	0	16	0	0
15	34635336	.	A	C	7	0	7	0	7	14	0	0
15	34637582	.	C	T	0	1	1	0	2	3	0	0
15	34638847	.	C	T	0	5	5	0	10	15	0	0
15	34641300	.	G	A	4	2	6	0	1	7	0	0
15	34641384	.	G	A	6	5	11	0	0	11	0	0
15	34657370	.	C	T	1	1	2	0	0	2	0	0
15	34657919	.	T	A	3	3	6	0	0	6	0	0
15	35091290	.	G	T	0	5	5	0	1	6	0	0
15	35091591	.	A	G	2	2	4	0	0	4	0	0
15	35103129	.	T	C	2	3	5	0	0	5	0	0
15	35103145	.	T	C	2	3	5	0	0	5	0	0
15	35156477	.	T	A	1	2	3	0	0	3	0	0
15	35157052	.	T	A	5	5	10	0	0	10	0	0
15	35157054	.	G	A	5	3	8	0	2	10	0	0
15	35158661	.	T	G	5	2	7	0	0	7	0	0
15	35167298	.	A	G	0	1	1	0	0	1	0	0
15	35187682	.	C	T	0	3	3	0	0	3	0	0
15	35212147	.	C	G	0	2	2	0	0	2	0	0
15	35212318	.	A	T	4	3	7	0	0	7	0	0
15	35212418	.	G	C	3	2	5	0	0	5	0	0
15	35214784	.	T	A	2	7	9	0	1	10	0	0
15	35214859	.	A	C	8	0	8	0	11	19	0	0
15	35214901	.	G	A	13	4	17	0	1	18	0	0
15	35217424	.	G	A	0	1	1	0	0	1	0	0
15	35217475	.	T	C	3	6	9	0	2	11	0	0
15	35217487	.	C	A	1	9	10	0	6	16	0	0
15	35221304	.	A	T	2	3	5	0	0	5	0	0
15	35224269	.	G	C	4	2	6	0	1	7	0	0
15	35227221	.	A	T	15	5	20	0	0	20	0	0
15	35247678	.	A	T	15	11	26	0	1	27	0	0
15	35247687	.	A	G	18	15	33	0	0	33	0	0
15	35247729	.	A	G	18	15	33	0	1	34	0	0
15	35247762	.	T	C	14	8	22	0	5	27	0	0
15	35709983	.	G	A	0	2	2	0	1	3	0	0
15	35709988	.	C	T	2	1	3	0	0	3	0	0
15	35718398	.	A	C	1	7	8	0	0	8	0	0
15	35737680	.	T	C	6	2	8	0	0	8	0	0
15	35760970	.	G	A	4	3	7	0	1	8	0	0
15	35761024	.	T	C	4	4	8	0	0	8	0	0
15	35761027	.	A	G	4	4	8	0	1	9	0	0
15	35761126	.	G	A	0	5	5	0	9	14	0	0
15	35761225	.	G	A	5	9	14	0	1	15	0	0
15	35761516	.	T	C	3	2	5	0	0	5	0	0
15	35889139	.	G	A	3	3	6	0	0	6	0	0
15	35889674	.	T	C	0	1	1	0	3	4	0	0
15	35889691	.	G	A	4	2	6	0	0	6	0	0
15	35890046	.	G	A	4	4	8	0	0	8	0	0
15	35890372	.	T	A	1	2	3	0	1	4	0	0
15	35891203	.	A	T	1	2	3	0	0	3	0	0
15	37222589	.	T	C	1	0	1	0	0	1	0	0
15	37227033	.	T	G	27	33	60	0	3	63	0	0
15	37227059	.	A	G	32	2	34	0	35	69	0	0
15	37227509	.	A	G	23	0	23	0	25	48	0	0
15	37227714	.	A	G	15	0	15	0	32	47	0	0
15	37227770	.	G	A	23	24	47	0	0	52	5	0
15	37228164	.	A	G	23	33	56	0	1	57	0	0
15	37228266	.	T	C	24	27	51	0	0	51	0	0
15	37228301	.	T	A	21	23	44	0	2	46	0	0
15	37228338	.	T	A	22	7	29	0	1	30	0	0
15	37228620	.	G	C	34	28	62	0	2	64	0	0
15	37228626	.	G	A	35	27	62	0	3	65	0	0
15	37228665	.	C	G	26	32	58	0	0	58	0	0
15	37228843	.	T	A	38	14	52	2	4	58	0	0
15	37228845	.	T	G	36	14	50	2	5	58	1	0
15	37229871	.	A	T	28	32	60	0	3	63	0	0
15	37229991	.	C	A	31	35	66	0	2	68	0	0
15	37230038	.	G	A	28	31	59	0	2	61	0	0
15	37230100	.	G	A	25	36	61	0	2	63	0	0
15	37459156	.	T	C	3	3	6	0	2	8	0	0
15	37459194	.	T	C	6	5	11	0	1	12	0	0
15	37459201	.	T	C	6	0	6	0	6	12	0	0
15	37459369	.	T	C	5	4	9	0	1	10	0	0
15	37459819	.	T	C	5	4	9	0	0	9	0	0
15	37460201	.	T	C	2	0	2	0	3	5	0	0
15	37561708	.	A	G	2	0	2	0	2	4	0	0
15	37561838	.	A	G	1	4	5	0	0	5	0	0
15	38892060	.	T	C	3	7	10	0	0	10	0	0
15	39128662	.	C	T	4	4	8	0	0	8	0	0
15	39140121	.	C	A	8	8	16	0	0	16	0	0
15	39141465	.	T	C	1	4	5	0	0	5	0	0
15	39208133	.	C	A	10	9	19	0	2	21	0	0
15	39208150	.	C	T	7	9	16	0	4	20	0	0
15	39208201	.	C	A	11	14	25	0	2	27	0	0
15	39208211	.	C	T	11	14	25	0	2	27	0	0
15	39208258	.	C	T	10	8	18	0	1	19	0	0
15	39228174	.	A	G	13	23	36	0	1	37	0	0
15	39278501	.	G	T	6	7	13	0	1	14	0	0
15	39281923	.	A	G	11	10	21	0	1	22	0	0
15	39282007	.	G	C	9	0	9	0	11	20	0	0
15	39282070	.	A	G	4	5	9	0	0	9	0	0
15	39282091	.	G	A	1	1	2	0	0	2	0	0
15	39294391	.	C	T	15	8	23	0	0	23	0	0
15	39296706	.	A	G	6	5	11	0	1	12	0	0
15	39296730	.	G	A	6	5	11	0	3	14	0	0
15	39297051	.	G	A	8	6	14	0	2	16	0	0
15	39297081	.	A	G	3	3	6	0	2	8	0	0
15	39305598	.	G	A	1	2	3	0	0	3	0	0
15	39326986	.	C	T	4	5	9	0	0	9	0	0
15	39339460	.	T	A	3	2	5	0	0	5	0	0
15	39339511	.	C	G	0	2	2	0	2	4	0	0
15	39967275	.	G	A	13	16	29	0	0	29	0	0
15	39969923	.	T	G	13	17	30	0	1	31	0	0
15	39986125	.	C	A	4	2	6	0	0	6	0	0
15	39987655	.	C	T	1	1	2	0	0	2	0	0
15	39987691	.	T	C	5	5	10	0	0	10	0	0
15	39992053	.	C	T	1	4	5	0	0	5	0	0
15	40000981	.	A	T	3	4	7	0	0	7	0	0
15	40002242	.	C	T	3	5	8	0	0	8	0	0
15	40002319	.	C	T	6	13	19	0	0	19	0	0
15	40002325	.	C	T	7	11	18	0	1	19	0	0
15	40002534	.	A	T	6	5	11	0	0	11	0	0
15	40005279	.	C	T	6	3	9	0	0	9	0	0
15	40005297	.	A	C	3	5	8	0	0	8	0	0
15	40005318	.	T	A	1	3	4	0	1	5	0	0
15	40005466	.	C	T	7	13	20	0	0	20	0	0
15	40005545	.	T	C	9	8	17	0	3	20	0	0
15	40006090	.	A	C	10	5	15	0	0	15	0	0
15	40008449	.	C	T	19	14	33	0	0	33	0	0
15	40008498	.	C	T	17	19	36	0	0	36	0	0
15	40008544	.	C	A	19	30	49	0	1	50	0	0
15	40018239	.	G	A	0	14	14	0	15	29	0	0
15	40018290	.	C	T	3	3	6	0	1	7	0	0
15	40027138	.	C	T	21	28	49	0	2	51	0	0
15	40027279	.	T	C	42	23	65	1	2	68	0	0
15	40027484	.	T	G	21	0	21	0	34	55	0	0
15	40027540	.	A	C	21	26	47	0	3	50	0	0
15	40027717	.	A	G	27	25	52	0	5	57	0	0
15	40028457	.	T	G	34	30	64	0	2	66	0	0
15	40028568	.	G	A	24	25	49	0	1	50	0	0
15	40028574	.	A	G	20	29	49	0	4	53	0	0
15	40091068	.	C	T	4	4	8	0	0	8	0	0
15	40099812	.	C	T	2	4	6	0	2	8	0	0
15	40099844	.	T	C	1	3	4	0	2	6	0	0
15	40104028	.	T	C	4	5	9	0	1	10	0	0
15	40108886	.	T	C	8	13	21	0	0	21	0	0
15	40108898	.	C	T	4	9	13	0	0	13	0	0
15	40115610	.	A	T	2	3	5	0	0	5	0	0
15	40115676	.	C	T	4	10	14	0	0	14	0	0
15	40122221	.	A	G	2	2	4	0	2	6	0	0
15	40122625	.	G	A	6	9	15	0	0	15	0	0
15	40126698	.	A	G	6	1	7	0	8	15	0	0
15	40128979	.	C	G	11	15	26	0	2	28	0	0
15	40129543	.	G	C	8	11	19	0	1	20	0	0
15	40129594	.	T	G	14	10	24	0	0	24	0	0
15	40129604	.	A	T	15	9	24	0	1	25	0	0
15	40129810	.	A	C	10	9	19	0	0	19	0	0
15	40130181	.	G	A	0	8	8	0	7	15	0	0
15	40130208	.	G	A	7	8	15	0	0	15	0	0
15	40130362	.	T	C	4	8	12	0	0	12	0	0
15	40130389	.	A	G	3	7	10	0	0	10	0	0
15	40130563	.	A	G	7	0	7	0	5	12	0	0
15	40131001	.	G	A	0	4	4	0	9	13	0	0
15	40131060	.	A	G	6	9	15	0	1	16	0	0
15	40131112	.	C	A	10	17	27	0	0	27	0	0
15	40131139	.	T	A	16	17	33	0	0	33	0	0
15	40131157	.	A	G	14	14	28	0	0	28	0	0
15	40131216	.	G	A	11	4	15	0	1	16	0	0
15	40131232	.	C	T	11	3	14	0	0	14	0	0
15	40131276	.	C	G	9	13	22	0	0	22	0	0
15	40131297	.	C	G	9	12	21	0	0	21	0	0
15	40131316	.	C	A	10	7	17	0	4	21	0	0
15	40131363	.	G	T	1	15	16	0	18	34	0	0
15	40131498	.	A	G	9	1	10	0	26	36	0	0
15	40131500	.	A	G	9	27	36	0	0	36	0	0
15	40131547	.	T	C	14	21	35	0	2	37	0	0
15	40131560	.	T	A	13	24	37	0	1	38	0	0
15	40131586	.	C	T	14	25	39	0	1	40	0	0
15	40131619	.	T	C	12	19	31	0	1	32	0	0
15	40131624	.	T	A	12	18	30	0	2	32	0	0
15	40131769	.	T	C	10	8	18	0	3	21	0	0
15	40202354	.	T	G	20	15	35	0	0	35	0	0
15	40202393	.	C	T	7	5	12	0	1	13	0	0
15	40211507	.	T	C	6	3	9	0	1	10	0	0
15	40211591	.	A	C	17	28	45	0	5	50	0	0
15	40211618	.	A	G	20	2	22	0	27	49	0	0
15	40211741	.	C	G	23	20	43	0	1	44	0	0
15	40211954	.	G	T	10	14	24	0	1	25	0	0
15	40877098	.	G	A	0	0	0	0	1	1	0	0
15	40888430	.	A	G	1	0	1	0	2	3	0	0
15	40893929	.	T	G	1	0	1	0	4	5	0	0
15	40893932	.	G	A	0	4	4	0	1	5	0	0
15	40926702	.	C	T	5	1	6	0	1	7	0	0
15	40935869	.	T	C	3	1	4	0	0	4	0	0
15	40938072	.	C	T	4	4	8	0	0	8	0	0
15	40938119	.	G	A	7	7	14	0	0	14	0	0
15	40938305	.	C	T	2	4	6	0	0	6	0	0
15	40938498	.	T	C	3	2	5	0	1	6	0	0
15	40941322	.	G	A	4	2	6	0	0	6	0	0
15	40945651	.	A	G	0	2	2	0	0	2	0	0
15	40945690	.	T	C	5	3	8	0	0	8	0	0
15	40945879	.	G	A	0	2	2	0	1	3	0	0
15	40945884	.	T	G	1	2	3	0	0	3	0	0
15	40952226	.	A	G	2	1	3	0	0	3	0	0
15	40962073	.	G	T	3	3	6	0	0	6	0	0
15	40962160	.	T	C	7	5	12	0	0	12	0	0
15	40962186	.	C	T	5	2	7	0	0	7	0	0
15	40962280	.	G	C	0	2	2	0	2	4	0	0
15	40988189	.	T	C	10	8	18	0	3	21	0	0
15	40988228	.	C	T	9	10	19	0	2	21	0	0
15	40988565	.	A	G	13	8	21	0	1	22	0	0
15	40988659	.	C	A	4	2	6	0	1	7	0	0
15	40989327	.	A	G	0	3	3	0	1	4	0	0
15	40989614	.	C	T	3	3	6	0	0	6	0	0
15	40989690	.	A	G	2	4	6	0	0	6	0	0
15	40989801	.	A	G	6	0	6	0	6	12	0	0
15	41170289	.	A	G	10	15	25	0	0	25	0	0
15	41170445	.	G	T	13	12	25	0	0	25	0	0
15	41170710	.	G	A	14	8	22	0	0	22	0	0
15	41170968	.	C	A	3	7	10	0	0	10	0	0
15	41170992	.	G	A	6	5	11	0	0	11	0	0
15	41171081	.	T	C	12	0	12	0	8	20	0	0
15	41171135	.	A	G	4	7	11	0	1	12	0	0
15	41171335	.	A	T	4	12	16	0	1	17	0	0
15	41171448	.	A	C	15	10	25	0	0	25	0	0
15	41171471	.	G	T	12	10	22	0	0	22	0	0
15	41171516	.	C	A	0	12	12	0	20	32	0	0
15	41171878	.	C	A	4	8	12	0	0	12	0	0
15	41172103	.	G	A	5	5	10	0	0	10	0	0
15	41172303	.	G	T	9	3	12	0	0	12	0	0
15	41172325	.	G	T	4	5	9	1	0	10	0	0
15	41172731	.	G	A	2	3	5	0	0	5	0	0
15	41172745	.	C	T	2	3	5	0	0	5	0	0
15	41172893	.	A	C	13	4	17	0	0	17	0	0
15	41172904	.	G	C	11	4	15	0	0	15	0	0
15	41173093	.	A	T	2	8	10	0	0	10	0	0
15	41173109	.	C	T	2	4	6	0	1	7	0	0
15	41173142	.	G	A	1	3	4	0	0	4	0	0
15	41173261	.	T	G	9	4	13	0	0	13	0	0
15	41173326	.	C	T	11	11	22	0	2	25	1	0
15	41173620	.	G	A	3	4	7	0	1	8	0	0
15	41769338	.	A	C	0	3	3	0	0	3	0	0
15	41845139	.	C	T	2	3	5	0	0	5	0	0
15	41845211	.	G	A	0	2	2	0	3	5	0	0
15	41845213	.	T	A	3	1	4	0	1	5	0	0
15	41845310	.	G	T	6	4	10	0	0	10	0	0
15	41845526	.	G	A	1	2	3	0	4	7	0	0
15	41845678	.	A	T	3	3	6	0	0	6	0	0
15	41845681	.	C	A	3	3	6	0	0	6	0	0
15	41948220	.	C	G	2	3	5	0	0	5	0	0
15	41949825	.	A	G	0	1	1	0	0	1	0	0
15	41949929	.	T	C	2	2	4	0	0	4	0	0
15	41950245	.	G	T	3	5	8	0	2	10	0	0
15	41950802	.	G	A	2	3	5	0	0	5	0	0
15	41951091	.	A	G	2	2	4	0	0	4	0	0
15	41954412	.	G	A	1	2	3	0	0	3	0	0
15	42264934	.	C	T	4	4	8	0	0	8	0	0
15	42264955	.	C	T	0	5	5	0	5	10	0	0
15	42265070	.	G	C	8	10	18	0	2	20	0	0
15	42265197	.	G	A	25	19	44	0	1	45	0	0
15	42265263	.	A	G	5	5	10	0	0	10	0	0
15	42267390	.	C	T	0	2	2	0	2	4	0	0
15	42267408	.	T	A	6	5	11	0	0	11	0	0
15	42272452	.	C	A	4	4	8	0	1	9	0	0
15	42278936	.	T	A	4	1	5	0	1	6	0	0
15	42279535	.	A	G	8	11	19	0	0	19	0	0
15	42280689	.	G	A	6	5	11	0	0	11	0	0
15	42283746	.	C	T	2	3	5	0	0	5	0	0
15	42285766	.	A	G	3	0	3	0	9	12	0	0
15	42285767	.	G	T	4	7	11	0	1	12	0	0
15	42297528	.	A	G	0	0	0	0	1	1	0	0
15	42302915	.	A	G	13	7	20	0	1	21	0	0
15	42317277	.	C	G	1	4	5	0	0	5	0	0
15	42344847	.	C	T	4	2	6	0	2	8	0	0
15	42346196	.	T	C	8	3	11	0	0	11	0	0
15	42346260	.	T	A	9	5	14	0	3	17	0	0
15	42346584	.	C	T	7	2	9	0	0	9	0	0
15	42346771	.	C	A	2	7	9	0	1	10	0	0
15	42346818	.	A	T	4	9	13	0	0	13	0	0
15	42346841	.	T	C	4	3	7	0	1	8	0	0
15	42346902	.	C	T	4	12	16	0	0	16	0	0
15	42443122	.	C	T	1	2	3	0	0	3	0	0
15	42486260	.	C	T	0	1	1	0	0	1	0	0
15	42522032	.	C	T	2	2	4	0	1	5	0	0
15	42522033	.	C	T	2	2	4	0	1	5	0	0
15	42538243	.	A	G	2	2	4	0	1	5	0	0
15	42538267	.	C	T	2	2	4	0	0	4	0	0
15	42543850	.	G	A	0	4	4	0	1	5	0	0
15	42550856	.	G	A	4	5	9	0	1	10	0	0
15	42550961	.	C	T	4	6	10	0	0	10	0	0
15	42551067	.	G	A	0	7	7	0	5	12	0	0
15	42676401	.	T	C	0	1	1	0	0	1	0	0
15	42743477	.	A	G	4	2	6	0	0	6	0	0
15	42758927	.	T	C	0	0	0	0	4	4	0	0
15	42767880	.	G	A	0	3	3	0	1	4	0	0
15	42947514	.	C	T	1	2	3	0	0	3	0	0
15	42952872	.	G	T	2	2	4	0	0	4	0	0
15	42976368	.	C	T	1	2	3	0	0	3	0	0
15	42976371	.	C	A	1	2	3	0	0	3	0	0
15	42980862	.	T	C	5	7	12	0	0	12	0	0
15	42981069	.	C	T	3	4	7	0	1	8	0	0
15	42981223	.	A	G	5	5	10	0	0	10	0	0
15	42981303	.	T	A	6	2	8	0	0	8	0	0
15	42981321	.	G	A	4	3	7	0	0	7	0	0
15	42981345	.	A	G	3	0	3	0	4	7	0	0
15	42981395	.	T	A	2	5	7	0	0	7	0	0
15	43187423	.	T	C	14	23	37	0	1	38	0	0
15	43195924	.	G	A	1	2	3	0	0	3	0	0
15	43196102	.	A	T	21	51	72	0	0	72	0	0
15	43196106	.	A	G	21	7	28	0	46	74	0	0
15	43196202	.	C	A	25	31	56	0	4	60	0	0
15	43196306	.	C	T	21	49	70	0	3	73	0	0
15	43196341	.	T	A	21	44	65	0	6	73	2	0
15	43509790	.	A	G	18	4	22	0	1	23	0	0
15	43604150	.	G	C	3	1	4	0	0	4	0	0
15	43604190	.	G	A	5	1	6	0	0	6	0	0
15	43604325	.	G	A	1	3	4	0	0	4	0	0
15	43604903	.	C	G	5	2	7	0	0	7	0	0
15	43604988	.	G	C	4	3	7	0	0	7	0	0
15	43604996	.	A	G	4	2	6	0	0	7	1	0
15	43605544	.	G	A	6	2	8	0	1	9	0	0
15	43605585	.	G	A	3	6	9	0	0	9	0	0
15	43605616	.	T	A	5	3	8	0	0	8	0	0
15	43656334	.	T	C	2	0	2	0	2	4	0	0
15	43656619	.	C	T	2	2	4	0	0	4	0	0
15	43671093	.	G	A	0	2	2	0	0	2	0	0
15	43917543	.	G	A	1	0	1	0	0	1	0	0
15	43931233	.	G	A	1	1	2	0	0	2	0	0
15	43936577	.	T	C	1	6	7	0	1	8	0	0
15	43938527	.	C	T	0	1	1	0	1	2	0	0
15	43938539	.	C	G	0	2	2	0	0	2	0	0
15	43982517	.	T	C	3	2	5	0	0	5	0	0
15	44029527	.	A	T	1	4	5	0	1	6	0	0
15	44029553	.	G	A	1	2	3	0	0	3	0	0
15	44075125	.	C	T	0	5	5	0	6	11	0	0
15	44077766	.	A	T	9	5	14	0	0	14	0	0
15	44140324	.	T	G	2	0	2	0	2	4	0	0
15	44140458	.	G	A	0	2	2	0	2	4	0	0
15	44140666	.	C	T	1	2	3	0	0	3	0	0
15	44141644	.	A	C	2	4	6	0	2	8	0	0
15	44252374	.	T	C	2	0	2	0	1	3	0	0
15	44255001	.	G	A	1	2	3	0	1	4	0	0
15	44255130	.	A	T	2	2	4	0	0	4	0	0
15	44255212	.	A	C	6	6	12	0	0	12	0	0
15	44283812	.	A	G	1	0	1	0	0	1	0	0
15	44290546	.	C	T	2	1	3	0	0	3	0	0
15	44295044	.	G	A	0	1	1	0	0	1	0	0
15	44323349	.	T	C	0	1	1	0	0	1	0	0
15	44323436	.	G	A	0	2	2	0	2	4	0	0
15	44323442	.	G	A	2	2	4	0	0	4	0	0
15	44336923	.	A	T	3	8	11	0	1	12	0	0
15	44340093	.	C	T	0	3	3	0	1	4	0	0
15	44344283	.	G	A	0	1	1	0	0	1	0	0
15	44370890	.	C	A	3	6	9	0	0	9	0	0
15	44371076	.	C	T	4	11	15	0	0	15	0	0
15	44371289	.	C	T	9	6	15	0	0	15	0	0
15	44384767	.	T	C	8	5	13	0	1	14	0	0
15	44385117	.	T	C	5	6	11	0	1	12	0	0
15	44385126	.	C	T	7	6	13	0	0	13	0	0
15	44399204	.	C	T	5	3	8	0	0	8	0	0
15	44445243	.	C	T	4	5	9	0	0	9	0	0
15	44447906	.	C	T	1	3	4	0	0	4	0	0
15	44475197	.	G	A	0	4	4	0	2	6	0	0
15	44499445	.	A	G	12	16	28	0	1	29	0	0
15	44499653	.	T	A	17	20	37	0	1	38	0	0
15	44499730	.	C	T	16	21	37	0	2	39	0	0
15	44534976	.	G	A	6	9	15	0	0	15	0	0
15	44733135	.	G	A	4	10	14	0	0	14	0	0
15	44733157	.	A	G	4	9	13	0	1	14	0	0
15	44755727	.	G	A	0	0	0	0	1	1	0	0
15	45027401	.	G	A	3	6	9	0	1	10	0	0
15	46723744	.	C	A	0	2	2	0	0	2	0	0
15	46727382	.	G	A	2	1	3	0	0	3	0	0
15	46727571	.	G	A	1	0	1	0	0	1	0	0
15	46736088	.	A	T	1	3	4	0	0	4	0	0
15	46736096	.	C	T	0	2	2	0	2	4	0	0
15	46736165	.	A	C	1	0	1	0	3	4	0	0
15	46792154	.	G	A	2	2	4	0	0	4	0	0
15	47029331	.	G	A	2	2	4	0	0	4	0	0
15	47107256	.	A	G	2	3	5	0	1	6	0	0
15	47115252	.	G	A	1	1	2	0	0	2	0	0
15	47336295	.	G	A	4	6	10	0	2	12	0	0
15	47386982	.	T	A	6	7	13	0	0	13	0	0
15	47410231	.	C	A	1	3	4	0	1	5	0	0
15	47418607	.	G	A	0	8	8	0	5	13	0	0
15	47418627	.	G	A	5	8	13	0	0	13	0	0
15	47419090	.	G	A	0	12	12	0	21	33	0	0
15	47419096	.	C	T	21	12	33	0	1	34	0	0
15	47419240	.	C	T	13	17	30	0	1	31	0	0
15	47419394	.	C	T	7	21	28	0	0	28	0	0
15	47419395	.	A	T	7	21	28	0	0	28	0	0
15	47420838	.	T	A	27	19	46	0	0	47	1	0
15	47420920	.	G	C	0	32	32	0	1	33	0	0
15	47421203	.	T	C	8	12	20	0	1	21	0	0
15	47421329	.	A	G	9	10	19	0	1	20	0	0
15	47421669	.	C	T	17	10	27	0	6	33	0	0
15	47421675	.	G	C	11	16	27	0	5	32	0	0
15	47448596	.	G	C	2	2	4	0	1	5	0	0
15	47449028	.	A	T	2	2	4	0	0	4	0	0
15	47452875	.	G	A	4	3	7	0	0	7	0	0
15	47452895	.	C	A	5	3	8	0	0	8	0	0
15	47453288	.	C	G	1	2	3	0	0	3	0	0
15	47571416	.	A	C	5	0	5	0	13	18	0	0
15	47830783	.	C	T	5	3	8	0	0	8	0	0
15	47830973	.	C	A	7	6	13	0	1	14	0	0
15	47831096	.	C	T	7	14	21	0	0	21	0	0
15	47831195	.	G	C	8	8	16	0	0	16	0	0
15	47831249	.	C	T	5	3	8	0	0	8	0	0
15	47831265	.	T	A	1	6	7	0	1	8	0	0
15	47831495	.	C	G	11	6	17	0	2	19	0	0
15	47831511	.	C	T	1	6	7	0	13	20	0	0
15	47831565	.	C	A	12	14	26	0	1	27	0	0
15	47832930	.	C	T	4	6	10	0	0	10	0	0
15	47832931	.	C	T	0	6	6	0	4	10	0	0
15	47833083	.	G	A	4	7	11	0	0	11	0	0
15	47833392	.	G	A	4	8	12	0	0	12	0	0
15	47833395	.	C	T	0	8	8	0	4	12	0	0
15	47833436	.	C	T	0	4	4	0	2	6	0	0
15	47833493	.	C	T	0	3	3	0	5	8	0	0
15	47833662	.	C	T	4	4	8	0	0	8	0	0
15	47833814	.	C	T	2	2	4	0	0	4	0	0
15	47833875	.	A	G	4	6	10	0	0	10	0	0
15	47834202	.	T	C	7	0	7	0	5	12	0	0
15	47834327	.	C	G	8	6	14	0	0	14	0	0
15	47834487	.	C	T	0	5	5	0	3	8	0	0
15	47834559	.	G	A	2	4	6	0	0	6	0	0
15	47839080	.	G	A	1	2	3	0	0	3	0	0
15	47845908	.	A	G	0	1	1	0	0	1	0	0
15	47847373	.	G	A	2	3	5	0	0	5	0	0
15	47848495	.	C	T	14	23	37	0	5	42	0	0
15	47851205	.	T	A	33	24	57	0	2	59	0	0
15	47851342	.	C	G	44	12	56	1	2	59	0	0
15	47851455	.	T	G	24	32	56	0	1	57	0	0
15	47851486	.	G	A	31	28	59	0	1	60	0	0
15	47851522	.	C	T	3	25	28	0	34	62	0	0
15	47851751	.	A	G	33	21	54	0	0	54	0	0
15	47851828	.	G	A	30	17	47	0	0	47	0	0
15	47851978	.	C	T	10	5	15	0	2	17	0	0
15	47851979	.	A	G	9	7	16	0	1	17	0	0
15	47852049	.	G	T	14	13	27	0	2	29	0	0
15	47855085	.	A	G	7	21	28	0	3	31	0	0
15	47855169	.	G	A	14	9	23	1	0	24	0	0
15	47856351	.	T	C	2	0	2	12	10	24	0	0
15	47856418	.	T	C	3	3	6	0	0	6	0	0
15	47860443	.	C	T	0	15	15	0	12	27	0	0
16	277852	.	T	C	4	2	6	0	1	7	0	0
16	815859	.	C	T	9	12	21	0	0	21	0	0
16	815967	.	G	A	6	11	17	0	1	18	0	0
16	816096	.	A	G	12	11	23	0	0	23	0	0
16	1199273	.	C	T	0	2	2	0	1	3	0	0
16	1199324	.	C	T	0	2	2	0	2	4	0	0
16	1199699	.	C	T	2	4	6	0	0	6	0	0
16	1199740	.	A	G	3	4	7	0	1	8	0	0
16	1199741	.	C	T	3	4	7	0	1	8	0	0
16	1207124	.	C	T	4	0	4	0	1	5	0	0
16	1207227	.	G	A	9	3	12	0	2	14	0	0
16	1207291	.	T	C	3	8	11	0	1	12	0	0
16	1207948	.	C	G	5	2	7	0	1	8	0	0
16	1209528	.	C	T	6	6	12	0	0	12	0	0
16	1209597	.	A	C	2	2	4	0	0	4	0	0
16	1209985	.	T	G	8	3	11	0	0	11	0	0
16	1210280	.	G	A	7	10	17	0	0	17	0	0
16	1210403	.	C	T	10	8	18	0	0	18	0	0
16	1228093	.	A	C	5	9	14	0	1	15	0	0
16	1234138	.	A	T	1	0	1	0	0	1	0	0
16	1239500	.	T	C	7	4	11	0	1	12	0	0
16	1354513	.	A	G	0	1	1	0	0	1	0	0
16	1355316	.	A	T	6	8	14	0	0	14	0	0
16	1355720	.	T	C	6	5	11	0	1	12	0	0
16	1359119	.	T	C	1	2	3	0	0	3	0	0
16	1398604	.	A	G	4	0	4	0	6	10	0	0
16	1466033	.	C	T	2	2	4	0	0	4	0	0
16	1466528	.	C	G	0	2	2	0	1	3	0	0
16	1523892	.	A	G	8	5	13	0	1	14	0	0
16	1523911	.	G	C	10	0	10	0	6	16	0	0
16	1572508	.	C	T	2	1	3	0	1	4	0	0
16	1906682	.	C	A	7	2	9	0	1	10	0	0
16	2009844	.	T	G	8	4	12	0	0	12	0	0
16	2009949	.	A	G	2	0	2	0	0	2	0	0
16	2043122	.	G	C	0	3	3	0	5	8	0	0
16	2071535	.	G	A	0	7	7	0	4	11	0	0
16	2102037	.	T	C	9	5	14	0	0	14	0	0
16	2102468	.	A	T	8	5	13	0	3	16	0	0
16	2102495	.	A	G	5	0	5	0	6	11	0	0
16	2102544	.	T	A	4	2	6	0	0	6	0	0
16	2102683	.	C	T	2	2	4	0	0	4	0	0
16	2102972	.	G	T	2	2	4	0	1	5	0	0
16	2103052	.	C	T	11	6	17	0	0	17	0	0
16	2103058	.	G	T	10	6	16	0	0	16	0	0
16	2103088	.	G	A	0	5	5	0	11	16	0	0
16	2103167	.	C	T	5	11	16	0	1	17	0	0
16	2103209	.	C	T	11	5	16	0	0	16	0	0
16	2103241	.	T	A	9	4	13	0	0	13	0	0
16	2103268	.	A	T	6	5	11	0	0	11	0	0
16	2103307	.	T	C	4	5	9	0	0	9	0	0
16	2103714	.	A	T	2	5	7	0	0	7	0	0
16	2103783	.	A	T	4	4	8	0	1	9	0	0
16	2103798	.	C	T	4	3	7	0	0	7	0	0
16	2104312	.	A	C	7	12	19	0	0	19	0	0
16	2104400	.	T	C	13	11	24	0	0	24	0	0
16	2104597	.	T	C	27	25	52	0	2	54	0	0
16	2104604	.	A	G	26	1	27	0	27	54	0	0
16	2105035	.	A	G	4	4	8	0	0	8	0	0
16	2353020	.	C	A	1	2	3	0	0	3	0	0
16	2353023	.	T	C	1	2	3	0	0	3	0	0
16	2353191	.	C	A	5	2	7	0	0	7	0	0
16	2365716	.	G	A	2	1	3	0	0	3	0	0
16	2368422	.	T	C	2	0	2	0	0	2	0	0
16	2382011	.	G	T	1	0	1	0	0	1	0	0
16	2472263	.	G	A	5	4	9	0	2	11	0	0
16	2472284	.	T	C	4	2	6	0	1	7	0	0
16	2484064	.	C	T	0	5	5	0	3	8	0	0
16	2485904	.	G	A	1	1	2	0	0	2	0	0
16	2494323	.	T	C	3	0	3	0	4	7	0	0
16	2495649	.	G	C	2	2	4	0	0	4	0	0
16	2517184	.	G	T	6	4	10	0	1	11	0	0
16	2519056	.	T	C	4	3	7	0	0	7	0	0
16	2519071	.	T	C	1	1	2	0	0	2	0	0
16	2525891	.	A	G	1	0	1	0	0	1	0	0
16	2528209	.	A	G	4	8	12	0	1	13	0	0
16	2539405	.	G	A	3	3	6	0	0	6	0	0
16	2540235	.	G	A	4	8	12	0	1	13	0	0
16	2545290	.	C	T	3	1	4	0	1	5	0	0
16	2557990	.	A	G	0	0	0	0	1	1	0	0
16	2568847	.	G	A	0	6	6	0	11	17	0	0
16	2574963	.	C	T	1	0	1	0	0	1	0	0
16	2577717	.	T	A	1	0	1	0	0	1	0	0
16	2580255	.	T	A	10	10	20	0	1	21	0	0
16	2647134	.	T	C	2	0	2	0	2	4	0	0
16	2825870	.	A	G	1	3	4	0	0	4	0	0
16	2829139	.	T	C	0	1	1	0	0	1	0	0
16	2843932	.	T	C	4	2	6	0	0	6	0	0
16	2843950	.	A	C	4	3	7	0	0	7	0	0
16	2844103	.	G	A	1	2	3	0	0	3	0	0
16	2847861	.	G	C	1	2	3	0	0	3	0	0
16	2847869	.	T	C	0	0	0	0	2	2	0	0
16	2964078	.	T	C	0	1	1	0	0	1	0	0
16	2987527	.	G	A	0	1	1	0	0	1	0	0
16	3075265	.	G	A	0	1	1	0	0	1	0	0
16	3091195	.	A	G	1	1	2	0	0	2	0	0
16	3091279	.	A	C	1	2	3	0	1	4	0	0
16	3091288	.	G	A	1	1	2	0	0	2	0	0
16	3095897	.	T	C	1	1	2	0	0	2	0	0
16	3096319	.	T	C	7	5	12	0	0	12	0	0
16	3096384	.	C	T	6	6	12	0	0	12	0	0
16	3096420	.	T	C	4	4	8	0	1	9	0	0
16	3096446	.	A	T	4	3	7	0	1	8	0	0
16	3096516	.	G	A	5	2	7	0	0	7	0	0
16	3463895	.	A	G	7	13	20	0	0	20	0	0
16	3470212	.	G	A	5	6	11	0	1	12	0	0
16	3470332	.	A	G	4	3	7	0	1	8	0	0
16	3499306	.	G	A	1	0	1	0	0	1	0	0
16	3499423	.	A	C	2	0	2	0	3	5	0	0
16	3523597	.	T	A	2	2	4	0	0	4	0	0
16	3576790	.	A	G	1	3	4	0	0	4	0	0
16	3579786	.	T	G	1	3	4	0	0	4	0	0
16	4071284	.	G	T	0	2	2	0	2	4	0	0
16	4115198	.	C	T	1	4	5	0	0	5	0	0
16	4117624	.	G	A	1	0	1	0	0	1	0	0
16	4117843	.	A	G	1	5	6	0	0	6	0	0
16	4126464	.	C	T	1	2	3	0	0	3	0	0
16	4126903	.	C	A	0	0	0	0	1	1	0	0
16	4126927	.	C	T	3	1	4	0	0	4	0	0
16	4131062	.	T	C	1	2	3	0	0	3	0	0
16	4131167	.	G	A	0	3	3	0	1	4	0	0
16	4131174	.	T	A	1	2	3	0	0	3	0	0
16	4138416	.	G	A	2	2	4	0	0	4	0	0
16	4138638	.	G	A	2	2	4	0	0	4	0	0
16	4163503	.	C	T	6	7	13	0	0	13	0	0
16	4163671	.	A	G	1	0	1	0	4	5	0	0
16	4168036	.	T	A	3	4	7	1	1	9	0	0
16	4168139	.	A	G	2	2	4	0	1	5	0	0
16	4189894	.	G	C	3	3	6	0	0	6	0	0
16	4190091	.	T	A	2	2	4	0	0	4	0	0
16	4190094	.	C	A	2	2	4	0	0	4	0	0
16	4190599	.	G	A	4	2	6	0	0	6	0	0
16	4197130	.	T	A	5	6	11	0	0	11	0	0
16	4200749	.	G	T	4	1	5	0	0	5	0	0
16	4201948	.	C	G	4	13	17	0	2	19	0	0
16	4202038	.	C	T	9	7	16	0	0	16	0	0
16	4202128	.	A	G	2	1	3	0	1	4	0	0
16	4202946	.	A	G	0	0	0	0	1	1	0	0
16	4287757	.	C	G	3	5	8	0	0	8	0	0
16	4287783	.	C	T	1	3	4	0	0	4	0	0
16	4287936	.	C	T	0	5	5	0	6	11	0	0
16	4287961	.	G	A	1	4	5	0	2	7	0	0
16	4288078	.	C	A	0	1	1	0	5	6	0	0
16	4288081	.	T	A	2	1	3	0	3	6	0	0
16	4288656	.	T	A	6	3	9	0	1	10	0	0
16	4317343	.	A	T	1	2	3	0	0	3	0	0
16	4513775	.	A	G	2	5	7	0	0	7	0	0
16	4513876	.	A	T	4	4	8	0	0	8	0	0
16	4513901	.	T	C	9	9	18	0	0	18	0	0
16	4513920	.	C	G	8	8	16	0	0	16	0	0
16	4514114	.	T	C	5	0	5	0	7	12	0	0
16	4514467	.	A	T	5	6	11	0	0	11	0	0
16	4514592	.	A	C	7	11	18	0	0	18	0	0
16	4514594	.	T	A	7	11	18	0	0	18	0	0
16	4514633	.	T	C	8	8	16	0	0	16	0	0
16	4514666	.	T	C	8	0	8	0	5	13	0	0
16	4514746	.	T	C	3	0	3	0	7	10	0	0
16	4514795	.	T	C	1	1	2	0	0	3	1	0
16	4515770	.	G	C	1	2	3	0	0	3	0	0
16	4515798	.	G	T	1	2	3	0	0	3	0	0
16	4515808	.	A	T	0	1	1	0	0	1	0	0
16	4517456	.	C	T	3	3	6	0	0	6	0	0
16	4517477	.	G	A	5	5	10	0	0	10	0	0
16	4517606	.	A	G	3	8	11	0	0	11	0	0
16	4517704	.	C	T	1	5	6	0	0	6	0	0
16	4533768	.	T	C	8	7	15	0	4	19	0	0
16	4538422	.	A	G	4	2	6	0	1	7	0	0
16	4540805	.	G	T	6	14	20	0	2	22	0	0
16	4540864	.	G	C	6	10	16	0	3	19	0	0
16	4541022	.	A	C	6	9	15	0	0	15	0	0
16	4541061	.	T	G	7	4	11	0	2	13	0	0
16	4541085	.	T	C	7	4	11	0	0	11	0	0
16	4541233	.	T	C	8	6	14	0	0	14	0	0
16	4541250	.	C	T	8	5	13	0	0	13	0	0
16	4541281	.	A	T	3	4	7	0	0	7	0	0
16	4541931	.	A	C	5	2	7	1	4	12	0	0
16	4541936	.	G	C	5	5	10	1	1	12	0	0
16	4542051	.	T	C	0	1	1	0	0	1	0	0
16	4542054	.	T	C	0	2	2	0	0	2	0	0
16	4542252	.	A	G	3	2	5	0	2	7	0	0
16	4542273	.	T	A	5	4	9	0	0	9	0	0
16	4542518	.	C	T	0	11	11	0	20	31	0	0
16	4545454	.	T	C	1	1	2	0	0	2	0	0
16	4546606	.	A	C	0	0	0	0	1	1	0	0
16	4546651	.	G	A	0	1	1	0	0	1	0	0
16	4573450	.	G	T	0	3	3	0	0	3	0	0
16	4573458	.	C	T	0	4	4	0	0	4	0	0
16	4573556	.	A	T	3	5	8	0	0	8	0	0
16	4573588	.	A	G	0	3	3	0	0	3	0	0
16	4587184	.	C	T	0	1	1	0	0	1	0	0
16	4587187	.	G	A	0	1	1	0	0	1	0	0
16	4591911	.	T	C	1	0	1	0	1	2	0	0
16	4615993	.	C	A	6	11	17	0	0	17	0	0
16	4616071	.	A	T	3	6	9	0	0	9	0	0
16	4619598	.	A	T	1	0	1	0	0	1	0	0
16	4619614	.	A	G	1	0	1	0	0	1	0	0
16	4628953	.	T	C	2	1	3	0	0	3	0	0
16	4695172	.	G	C	0	5	5	0	9	14	0	0
16	4695323	.	A	C	3	2	5	0	0	5	0	0
16	4695368	.	T	A	0	1	1	0	0	1	0	0
16	4695530	.	A	G	1	1	2	0	1	3	0	0
16	4697599	.	A	G	0	1	1	0	0	1	0	0
16	4697713	.	A	G	1	0	1	0	0	1	0	0
16	4697821	.	G	A	3	0	3	0	0	3	0	0
16	4697829	.	C	G	2	0	2	0	0	2	0	0
16	4700766	.	T	C	2	2	4	0	0	4	0	0
16	4707211	.	G	T	0	4	4	0	3	7	0	0
16	4707480	.	G	A	1	6	7	0	0	7	0	0
16	4707544	.	G	A	1	3	4	0	1	5	0	0
16	4711613	.	G	A	1	4	5	0	0	5	0	0
16	4711616	.	T	C	1	0	1	0	4	5	0	0
16	4755816	.	A	T	3	5	8	0	0	8	0	0
16	4759113	.	G	A	1	0	1	0	0	1	0	0
16	4761133	.	T	C	2	0	2	0	2	4	0	0
16	4770454	.	A	C	1	0	1	0	0	1	0	0
16	4772790	.	G	A	0	1	1	0	1	2	0	0
16	4772837	.	G	A	0	4	4	0	1	5	0	0
16	4784020	.	T	C	6	3	9	0	0	9	0	0
16	4842203	.	T	A	9	9	18	0	0	18	0	0
16	4858779	.	G	T	0	2	2	0	1	3	0	0
16	4860430	.	C	T	1	0	1	0	0	1	0	0
16	4860516	.	A	G	3	2	5	0	0	5	0	0
16	4867445	.	C	T	8	5	13	0	0	13	0	0
16	4867487	.	C	T	2	2	4	0	2	6	0	0
16	4869973	.	G	A	9	6	15	0	0	15	0	0
16	4870180	.	C	T	2	5	7	0	2	9	0	0
16	4872260	.	C	T	0	1	1	0	1	2	0	0
16	4872281	.	G	A	2	1	3	0	0	3	0	0
16	4872320	.	G	A	1	2	3	0	0	3	0	0
16	4872453	.	C	T	0	2	2	0	0	2	0	0
16	4875417	.	C	T	1	0	1	0	0	1	0	0
16	4876470	.	C	T	4	2	6	0	0	6	0	0
16	4882206	.	C	T	9	7	16	0	0	16	0	0
16	4882491	.	C	T	6	8	14	0	0	14	0	0
16	4882492	.	G	A	0	8	8	0	6	14	0	0
16	4885458	.	T	A	1	1	2	0	1	3	0	0
16	4895423	.	T	C	1	5	6	0	0	6	0	0
16	5014354	.	T	C	1	3	4	0	0	4	0	0
16	5014564	.	A	G	8	3	11	0	0	11	0	0
16	5025494	.	G	A	4	4	8	0	0	8	0	0
16	5105221	.	G	A	11	12	23	0	3	26	0	0
16	5105291	.	C	A	0	5	5	0	0	5	0	0
16	5145459	.	T	C	10	11	21	0	1	22	0	0
16	5145599	.	C	A	16	16	32	0	0	32	0	0
16	5145622	.	G	A	13	19	32	0	2	35	1	0
16	5149298	.	T	C	2	2	4	0	0	4	0	0
16	5153956	.	T	C	22	10	32	0	3	35	0	0
16	5153996	.	T	G	10	4	14	0	0	14	0	0
16	5156563	.	G	A	0	4	4	0	10	14	0	0
16	5159283	.	A	G	1	2	3	0	0	3	0	0
16	5159289	.	C	T	2	3	5	0	0	5	0	0
16	5159328	.	T	C	7	6	13	0	0	13	0	0
16	5163275	.	T	C	4	1	5	0	1	6	0	0
16	5164569	.	C	T	1	0	1	0	0	1	0	0
16	5166015	.	G	A	0	8	8	0	8	16	0	0
16	5166030	.	C	T	11	10	21	0	1	22	0	0
16	5166288	.	G	A	10	12	22	0	0	22	0	0
16	5166332	.	T	A	10	14	24	0	0	24	0	0
16	5166351	.	T	C	12	14	26	0	0	26	0	0
16	5166546	.	G	A	10	9	19	0	0	19	0	0
16	5166645	.	A	C	4	11	15	0	0	15	0	0
16	5166719	.	A	G	8	8	16	0	1	17	0	0
16	5166805	.	A	G	9	0	9	0	6	15	0	0
16	5166889	.	G	T	14	10	24	0	1	25	0	0
16	5166977	.	G	T	10	7	17	0	0	17	0	0
16	5167030	.	G	A	4	7	11	0	0	11	0	0
16	5167249	.	A	C	7	13	20	1	1	22	0	0
16	5167257	.	A	G	11	6	17	0	2	19	0	0
16	5187795	.	G	A	6	5	11	0	0	11	0	0
16	5190168	.	C	T	1	1	2	0	1	3	0	0
16	5190210	.	C	T	3	3	6	0	0	6	0	0
16	5190590	.	A	G	1	3	4	0	0	4	0	0
16	5193539	.	G	A	5	8	13	0	0	13	0	0
16	5193605	.	T	G	6	2	8	0	0	8	0	0
16	5193644	.	G	A	7	3	10	0	0	10	0	0
16	5199264	.	A	G	1	1	2	0	0	2	0	0
16	5199381	.	C	T	3	5	8	0	0	8	0	0
16	5199399	.	C	T	2	8	10	0	0	10	0	0
16	5199476	.	C	T	5	5	10	0	2	12	0	0
16	5199503	.	C	T	4	4	8	0	0	8	0	0
16	5205146	.	G	A	0	5	5	0	1	6	0	0
16	5216548	.	G	A	10	7	17	0	0	17	0	0
16	5216707	.	G	C	4	4	8	0	0	8	0	0
16	5221680	.	A	C	4	2	6	0	1	7	0	0
16	5221888	.	T	C	8	10	18	0	0	18	0	0
16	5223355	.	G	A	6	8	14	0	0	14	0	0
16	5223375	.	A	G	6	10	16	0	1	17	0	0
16	5223454	.	C	T	4	8	12	0	0	12	0	0
16	5223470	.	G	A	3	11	14	0	0	14	0	0
16	5223740	.	C	T	8	7	15	0	0	15	0	0
16	5224328	.	A	G	10	13	23	0	2	25	0	0
16	5230627	.	G	A	0	8	8	0	11	19	0	0
16	5230782	.	A	T	10	11	21	0	0	21	0	0
16	5475078	.	G	A	1	2	3	0	0	3	0	0
16	5475108	.	T	C	1	2	3	0	0	3	0	0
16	5493285	.	A	G	2	5	7	0	0	7	0	0
16	5496874	.	C	A	5	3	8	0	0	8	0	0
16	5612617	.	A	T	8	4	12	0	2	14	0	0
16	5612631	.	A	T	7	5	12	0	2	14	0	0
16	5624209	.	C	T	1	1	2	0	0	2	0	0
16	5633881	.	C	T	0	1	1	0	0	1	0	0
16	5636328	.	T	G	3	0	3	0	2	5	0	0
16	5693445	.	G	A	3	1	4	0	0	4	0	0
16	5697114	.	C	T	0	1	1	0	0	1	0	0
16	5700055	.	G	A	1	2	3	0	3	6	0	0
16	5700058	.	T	C	2	4	6	0	0	6	0	0
16	5700402	.	A	G	6	6	12	0	2	14	0	0
16	5700534	.	C	T	7	9	16	0	0	16	0	0
16	5702807	.	C	T	7	5	12	0	0	12	0	0
16	5702891	.	T	G	3	4	7	0	0	7	0	0
16	5702906	.	T	C	2	3	5	0	0	5	0	0
16	5702948	.	C	T	0	1	1	0	0	1	0	0
16	5708077	.	C	A	5	9	14	0	0	14	0	0
16	5708175	.	C	T	4	3	7	0	0	7	0	0
16	5708181	.	G	A	4	2	6	0	0	6	0	0
16	5710483	.	G	A	0	3	3	0	0	3	0	0
16	5710627	.	G	T	3	4	7	0	0	7	0	0
16	5776245	.	T	C	12	21	33	0	1	34	0	0
16	5778882	.	A	G	17	15	32	0	2	34	0	0
16	5778913	.	T	C	24	14	38	0	2	40	0	0
16	5786977	.	G	A	4	6	10	0	0	10	0	0
16	5786989	.	C	T	0	5	5	0	7	12	0	0
16	5787396	.	A	G	7	1	8	0	5	13	0	0
16	5787399	.	T	A	5	6	11	0	1	12	0	0
16	5787436	.	C	A	8	7	15	0	1	16	0	0
16	5787562	.	G	A	5	8	13	0	0	14	1	0
16	5787670	.	A	G	3	6	9	0	1	10	0	0
16	5787671	.	G	C	6	4	10	0	0	10	0	0
16	5787911	.	T	G	1	7	8	0	0	8	0	0
16	5788163	.	T	A	5	3	8	0	0	8	0	0
16	5788451	.	G	A	4	3	7	0	0	7	0	0
16	5788534	.	G	C	3	3	6	0	0	6	0	0
16	5789124	.	C	A	0	10	10	0	11	21	0	0
16	5789340	.	G	C	5	0	5	0	12	17	0	0
16	5795721	.	C	T	0	3	3	0	3	6	0	0
16	5800670	.	C	T	0	5	5	0	8	13	0	0
16	5806440	.	G	A	3	4	7	0	0	7	0	0
16	5806578	.	G	T	6	4	10	0	0	10	0	0
16	5808868	.	G	T	7	2	9	0	1	10	0	0
16	5808931	.	G	A	1	1	2	0	0	2	0	0
16	5820045	.	C	T	2	0	2	0	0	2	0	0
16	6182755	.	C	T	27	19	46	0	1	47	0	0
16	6191514	.	A	G	34	22	56	0	2	58	0	0
16	6191526	.	G	C	33	21	54	0	3	57	0	0
16	6191622	.	C	G	26	29	55	0	2	57	0	0
16	6192811	.	A	G	13	9	22	0	0	22	0	0
16	6197593	.	G	A	1	1	2	0	0	2	0	0
16	6205657	.	G	T	4	4	8	0	0	8	0	0
16	6356766	.	A	G	4	3	7	0	0	7	0	0
16	6356850	.	T	C	4	3	7	0	0	7	0	0
16	6387037	.	G	A	25	19	44	0	3	47	0	0
16	6387121	.	G	A	15	22	37	0	0	37	0	0
16	6387143	.	A	C	10	1	11	0	11	22	0	0
16	6387157	.	A	C	10	5	15	0	0	15	0	0
16	6395904	.	A	G	2	2	4	0	0	4	0	0
16	6395906	.	A	G	2	2	4	0	0	4	0	0
16	6649103	.	T	C	1	2	3	0	0	3	0	0
16	6650631	.	C	A	3	3	6	0	0	6	0	0
16	6650889	.	G	T	0	6	6	0	2	8	0	0
16	6650931	.	C	T	2	2	4	0	0	4	0	0
16	6653587	.	T	A	1	2	3	0	1	4	0	0
16	6653875	.	G	T	2	6	8	0	0	8	0	0
16	6653883	.	A	G	2	6	8	0	0	8	0	0
16	6746003	.	C	T	4	3	7	0	0	7	0	0
16	6746038	.	C	A	2	5	7	0	0	7	0	0
16	6747256	.	G	T	2	3	5	0	0	5	0	0
16	6760915	.	C	T	0	1	1	0	0	1	0	0
16	6763017	.	A	T	1	1	2	0	1	3	0	0
16	6770411	.	A	G	1	0	1	0	3	4	0	0
16	6779823	.	C	T	2	1	3	0	0	3	0	0
16	6784866	.	C	T	3	2	5	0	0	5	0	0
16	6787491	.	G	A	0	3	3	0	2	5	0	0
16	6787801	.	A	G	5	0	5	0	4	9	0	0
16	6790964	.	C	T	2	1	3	0	0	3	0	0
16	6790978	.	C	T	3	1	4	0	0	4	0	0
16	6792044	.	C	T	2	5	7	0	0	7	0	0
16	6792059	.	C	G	2	2	4	0	0	4	0	0
16	6796118	.	C	T	3	1	4	0	0	4	0	0
16	6800043	.	G	A	0	3	3	0	6	9	0	0
16	6800127	.	A	G	4	0	4	0	9	13	0	0
16	6800330	.	G	C	0	4	4	0	0	4	0	0
16	6800383	.	G	A	4	5	9	0	0	9	0	0
16	6803429	.	T	C	7	11	18	0	0	18	0	0
16	6803650	.	A	T	18	15	33	0	1	34	0	0
16	6803725	.	T	C	17	12	29	0	1	30	0	0
16	6803887	.	A	G	16	10	26	0	0	26	0	0
16	6820746	.	G	C	13	14	27	0	0	27	0	0
16	6821214	.	G	A	9	8	17	0	0	17	0	0
16	6821248	.	C	T	0	8	8	0	4	12	0	0
16	6821332	.	A	G	8	10	18	0	1	19	0	0
16	6821423	.	A	G	6	8	14	0	1	15	0	0
16	6821465	.	C	T	0	6	6	0	8	14	0	0
16	6822014	.	G	A	4	17	21	0	0	21	0	0
16	6864838	.	G	A	0	2	2	0	0	2	0	0
16	6920023	.	T	C	2	2	4	0	0	4	0	0
16	6920026	.	G	A	0	2	2	0	2	4	0	0
16	6923646	.	A	T	0	3	3	0	0	3	0	0
16	6929670	.	C	A	2	2	4	0	0	4	0	0
16	6929671	.	A	T	2	2	4	0	0	4	0	0
16	6929860	.	G	A	4	3	7	0	0	7	0	0
16	6932735	.	A	T	1	2	3	0	0	3	0	0
16	6937191	.	G	A	1	2	3	0	0	3	0	0
16	6944713	.	G	T	3	3	6	0	0	6	0	0
16	6944720	.	A	G	4	7	11	0	0	11	0	0
16	6944766	.	T	C	6	13	19	0	3	22	0	0
16	6955048	.	G	A	16	20	36	0	1	37	0	0
16	6955368	.	A	G	10	8	18	0	1	19	0	0
16	7202377	.	G	A	4	2	6	0	0	6	0	0
16	7202513	.	A	C	5	0	5	0	0	9	4	0
16	7202573	.	T	C	2	0	2	0	3	5	0	0
16	7203424	.	A	G	1	3	4	0	0	4	0	0
16	7208484	.	C	T	1	1	2	0	0	2	0	0
16	7208565	.	C	T	0	2	2	0	1	3	0	0
16	7217013	.	A	G	9	8	17	0	1	18	0	0
16	7217052	.	G	T	11	13	24	0	1	25	0	0
16	7220142	.	A	G	3	4	7	0	0	7	0	0
16	7220225	.	C	T	0	6	6	0	4	10	0	0
16	7221846	.	C	T	0	1	1	0	2	3	0	0
16	7239374	.	A	C	1	3	4	0	2	6	0	0
16	7239470	.	A	G	1	3	4	0	0	4	0	0
16	7239479	.	G	A	1	2	3	0	0	3	0	0
16	7242729	.	A	T	3	3	6	0	1	7	0	0
16	7242735	.	T	A	3	3	6	0	1	7	0	0
16	7242790	.	A	G	2	2	4	0	1	5	0	0
16	7242821	.	A	T	8	3	11	0	1	12	0	0
16	7242878	.	A	G	16	6	22	0	0	22	0	0
16	7252871	.	T	C	11	17	28	0	0	28	0	0
16	7254778	.	G	A	0	15	15	0	9	24	0	0
16	7259719	.	T	C	4	4	8	0	1	9	0	0
16	7259869	.	T	A	3	15	18	0	1	19	0	0
16	7259900	.	A	G	8	17	25	0	1	26	0	0
16	7259956	.	A	T	9	17	26	0	0	26	0	0
16	7259957	.	G	A	9	16	25	0	1	26	0	0
16	7260156	.	T	C	2	4	6	0	1	7	0	0
16	7260262	.	G	A	5	4	9	0	1	10	0	0
16	7260280	.	T	A	4	4	8	0	1	9	0	0
16	7315933	.	G	A	3	2	5	0	1	6	0	0
16	7316083	.	G	A	2	5	7	0	0	7	0	0
16	7316409	.	G	A	6	4	10	0	0	10	0	0
16	7379094	.	A	G	3	2	5	0	0	5	0	0
16	7379097	.	A	G	3	2	5	0	0	5	0	0
16	7385807	.	C	T	1	0	1	0	0	1	0	0
16	7415254	.	T	A	16	9	25	0	1	26	0	0
16	7415423	.	C	A	10	16	26	0	0	26	0	0
16	7415435	.	G	A	9	11	20	0	1	21	0	0
16	7415542	.	A	T	9	9	18	0	2	20	0	0
16	7415559	.	C	A	11	10	21	0	0	21	0	0
16	7415761	.	G	A	9	11	20	0	0	20	0	0
16	7415793	.	G	A	8	8	16	0	1	17	0	0
16	7416236	.	C	T	4	7	11	0	0	11	0	0
16	7416320	.	C	T	6	5	11	0	0	11	0	0
16	7416352	.	T	A	5	4	9	0	0	9	0	0
16	7626589	.	T	C	1	0	1	0	0	1	0	0
16	7630612	.	T	C	8	14	22	0	2	25	1	0
16	7635527	.	C	T	1	0	1	0	0	1	0	0
16	7635721	.	T	A	8	3	11	0	0	11	0	0
16	7638788	.	T	C	14	14	28	0	0	28	0	0
16	7638815	.	A	T	13	17	30	0	0	30	0	0
16	7638828	.	A	G	13	0	13	0	17	30	0	0
16	7638866	.	A	T	17	15	32	0	0	32	0	0
16	7638979	.	C	T	17	22	39	0	1	40	0	0
16	7638984	.	C	A	15	19	34	0	5	39	0	0
16	7639085	.	A	C	24	21	45	0	2	47	0	0
16	7639100	.	T	A	20	30	50	0	2	52	0	0
16	7639262	.	G	A	0	1	1	0	29	30	0	0
16	7639401	.	A	C	25	24	49	0	2	51	0	0
16	7639527	.	C	T	27	13	40	0	1	41	0	0
16	7639534	.	G	C	0	15	15	0	30	45	0	0
16	7639621	.	C	T	15	15	30	0	2	32	0	0
16	7639643	.	A	T	19	13	32	0	3	35	0	0
16	7639684	.	A	G	14	21	35	0	1	36	0	0
16	7639774	.	T	A	15	15	30	0	5	35	0	0
16	7639856	.	T	C	13	25	38	0	1	39	0	0
16	7640116	.	A	G	19	16	35	0	4	39	0	0
16	7640127	.	G	A	0	19	19	0	22	41	0	0
16	7640410	.	A	G	25	11	36	0	1	37	0	0
16	7640425	.	T	A	22	15	37	0	5	42	0	0
16	7640757	.	T	A	13	13	26	0	2	28	0	0
16	7679406	.	T	C	2	3	5	0	0	5	0	0
16	7705796	.	T	C	0	1	1	0	0	1	0	0
16	7725555	.	A	T	0	2	2	0	0	2	0	0
16	7728408	.	C	T	2	2	4	0	0	4	0	0
16	7743398	.	C	T	1	6	7	0	3	10	0	0
16	7743598	.	T	A	3	4	7	0	1	8	0	0
16	7743687	.	A	G	3	2	5	0	0	5	0	0
16	7745027	.	C	A	3	3	6	0	0	6	0	0
16	7745053	.	C	G	3	4	7	0	0	7	0	0
16	7746040	.	G	A	1	2	3	0	3	6	0	0
16	7748211	.	G	A	3	2	5	0	0	5	0	0
16	7803023	.	T	C	5	9	14	0	2	16	0	0
16	7803298	.	T	C	6	4	10	0	0	10	0	0
16	7803340	.	T	C	5	2	7	0	0	7	0	0
16	7803560	.	A	G	9	5	14	0	1	15	0	0
16	7803627	.	T	A	6	6	12	0	0	12	0	0
16	7803765	.	C	G	8	5	13	0	0	13	0	0
16	7803782	.	C	A	1	3	4	0	7	11	0	0
16	7803825	.	A	T	7	4	11	0	1	12	0	0
16	7803859	.	A	C	4	5	9	0	0	9	0	0
16	7803905	.	G	C	4	0	4	0	4	8	0	0
16	7803923	.	T	A	6	4	10	0	0	10	0	0
16	7803971	.	T	A	4	6	10	0	0	10	0	0
16	7804081	.	T	A	9	3	12	0	0	12	0	0
16	7804196	.	A	G	1	2	3	0	0	3	0	0
16	7804209	.	C	A	0	3	3	0	2	5	0	0
16	7804269	.	A	T	5	6	11	0	2	13	0	0
16	7804270	.	C	T	5	7	12	0	1	13	0	0
16	7804355	.	C	G	1	8	9	0	0	9	0	0
16	7804391	.	T	C	3	0	3	0	5	8	0	0
16	7804458	.	A	C	2	2	4	0	0	4	0	0
16	7804569	.	C	A	3	3	6	0	0	6	0	0
16	7804588	.	C	A	2	3	5	0	0	5	0	0
16	7804688	.	C	T	0	3	3	0	2	5	0	0
16	7804914	.	C	T	2	2	4	0	0	4	0	0
16	7805423	.	C	T	0	5	5	0	3	8	0	0
16	7805524	.	C	A	0	4	4	0	2	6	0	0
16	7821241	.	C	T	4	5	9	0	0	9	0	0
16	7821244	.	G	A	5	5	10	0	0	10	0	0
16	7828792	.	G	T	0	2	2	0	0	2	0	0
16	7985896	.	T	A	3	3	6	0	0	6	0	0
16	7999368	.	A	G	1	0	1	0	0	1	0	0
16	8041173	.	G	A	8	5	13	0	0	13	0	0
16	8041179	.	A	G	7	6	13	0	0	13	0	0
16	8041234	.	G	A	1	2	3	0	4	7	0	0
16	8051941	.	T	C	14	1	15	0	14	29	0	0
16	8052033	.	T	C	10	9	19	0	2	21	0	0
16	8052049	.	G	A	11	13	24	0	0	24	0	0
16	8052145	.	C	A	19	19	38	0	1	39	0	0
16	8052537	.	C	T	11	14	25	0	1	26	0	0
16	8052606	.	T	C	10	2	12	0	11	23	0	0
16	8052651	.	T	C	14	10	24	0	3	27	0	0
16	8052673	.	G	C	20	0	20	0	12	33	1	0
16	8052747	.	A	G	5	8	13	0	1	14	0	0
16	8052831	.	T	A	7	7	14	0	2	16	0	0
16	8052866	.	C	A	0	4	4	0	8	12	0	0
16	8052909	.	T	A	4	3	7	0	0	7	0	0
16	8052982	.	T	C	4	7	11	0	2	13	0	0
16	8053403	.	C	T	11	10	21	0	2	23	0	0
16	8053485	.	C	T	10	12	22	0	1	23	0	0
16	8053716	.	A	G	17	12	29	0	2	31	0	0
16	8053717	.	T	C	16	14	30	0	1	31	0	0
16	8054260	.	T	G	1	3	4	0	0	4	0	0
16	8054290	.	C	T	1	6	7	0	0	7	0	0
16	8054389	.	C	T	0	9	9	0	5	14	0	0
16	8054434	.	T	C	7	1	8	0	10	18	0	0
16	8055037	.	A	G	3	3	6	0	0	6	0	0
16	8059585	.	T	C	6	7	13	0	0	13	0	0
16	8066237	.	A	C	9	6	15	0	0	15	0	0
16	8066318	.	A	G	5	7	12	0	0	12	0	0
16	8119672	.	G	A	3	9	12	0	0	12	0	0
16	8119976	.	A	G	12	6	18	0	1	19	0	0
16	8120033	.	G	A	12	5	17	0	0	17	0	0
16	8120171	.	C	T	5	6	11	0	0	11	0	0
16	8139585	.	G	A	4	2	6	0	0	6	0	0
16	8139752	.	A	T	1	4	5	0	0	5	0	0
16	8139786	.	T	C	1	1	2	0	0	2	0	0
16	8160484	.	T	C	2	2	4	0	0	4	0	0
16	8161330	.	C	T	2	3	5	0	0	5	0	0
16	8161471	.	T	C	6	3	9	0	0	9	0	0
16	8161484	.	C	T	4	3	7	0	0	7	0	0
16	8161573	.	C	A	3	2	5	0	0	5	0	0
16	8161591	.	G	A	4	4	8	0	0	8	0	0
16	8161875	.	C	T	4	2	6	0	0	6	0	0
16	8162076	.	C	T	0	2	2	0	0	2	0	0
16	8162081	.	C	T	0	2	2	0	0	2	0	0
16	8298607	.	C	T	2	5	7	0	0	7	0	0
16	8298642	.	T	C	2	5	7	0	1	8	0	0
16	8298775	.	A	G	1	1	2	0	0	2	0	0
16	8298781	.	T	A	1	2	3	0	0	3	0	0
16	8298915	.	T	C	2	3	5	0	0	5	0	0
16	8299123	.	T	A	5	6	11	0	0	11	0	0
16	8299302	.	G	A	2	4	6	0	0	6	0	0
16	8299308	.	T	A	4	2	6	0	0	6	0	0
16	8299410	.	T	A	3	3	6	0	0	6	0	0
16	8299705	.	G	A	1	2	3	0	0	3	0	0
16	8300218	.	T	A	5	2	7	0	0	7	0	0
16	8300225	.	C	T	0	2	2	0	4	6	0	0
16	8300255	.	G	A	5	4	9	0	0	9	0	0
16	8300269	.	T	C	4	3	7	0	0	7	0	0
16	8300823	.	T	A	1	5	6	0	0	6	0	0
16	8300895	.	C	G	2	2	4	0	1	5	0	0
16	8300989	.	A	G	2	4	6	0	0	6	0	0
16	8323386	.	T	C	1	0	1	0	0	1	0	0
16	8530992	.	A	T	5	4	9	0	0	9	0	0
16	8532430	.	G	T	1	0	1	0	0	1	0	0
16	8539523	.	C	T	1	3	4	0	0	4	0	0
16	8752017	.	T	A	15	19	34	0	2	36	0	0
16	8752091	.	A	G	15	14	29	0	2	31	0	0
16	8752223	.	C	T	16	5	21	0	0	21	0	0
16	8752316	.	G	T	11	5	16	0	0	16	0	0
16	8752334	.	C	T	0	4	4	0	5	9	0	0
16	8759975	.	G	A	11	8	19	0	0	19	0	0
16	8771091	.	A	G	1	3	4	0	0	4	0	0
16	8788386	.	T	C	0	1	1	0	0	1	0	0
16	8788446	.	A	G	5	14	19	0	1	20	0	0
16	8816122	.	G	A	2	0	2	0	0	2	0	0
16	8818958	.	T	C	2	2	4	0	1	5	0	0
16	8844580	.	A	G	1	0	1	0	0	1	0	0
16	8844586	.	C	A	1	0	1	0	0	1	0	0
16	8845738	.	T	G	8	9	17	0	0	17	0	0
16	8847272	.	T	C	4	2	6	0	0	6	0	0
16	8862269	.	G	A	2	2	4	0	0	4	0	0
16	9253592	.	A	C	5	2	7	0	0	7	0	0
16	9276038	.	T	A	2	6	8	0	0	8	0	0
16	9281297	.	T	C	2	2	4	0	0	4	0	0
16	9281534	.	G	A	0	1	1	0	0	1	0	0
16	9286987	.	A	G	2	1	3	0	0	3	0	0
16	9292698	.	T	C	1	0	1	0	1	2	0	0
16	9313279	.	G	A	1	0	1	0	0	1	0	0
16	9348891	.	C	T	0	3	3	0	0	3	0	0
16	9383456	.	T	A	3	2	5	0	0	5	0	0
16	9409013	.	C	A	2	2	4	0	0	4	0	0
16	9410978	.	C	G	2	3	5	0	0	5	0	0
16	9412024	.	A	T	1	7	8	0	0	8	0	0
16	9412048	.	T	C	4	5	9	0	1	10	0	0
16	9412401	.	C	T	4	3	7	0	2	9	0	0
16	9420260	.	A	G	2	2	4	0	0	4	0	0
16	9433766	.	T	A	3	2	5	0	0	5	0	0
16	9433786	.	A	G	2	3	5	0	0	5	0	0
16	9433808	.	T	A	1	2	3	0	0	3	0	0
16	9434023	.	G	A	2	6	8	0	0	8	0	0
16	9434036	.	G	A	1	7	8	0	1	9	0	0
16	9437789	.	G	A	1	0	1	0	1	2	0	0
16	9438075	.	A	G	2	1	3	0	0	3	0	0
16	9440440	.	T	C	0	2	2	0	1	3	0	0
16	9581981	.	T	C	1	0	1	0	0	1	0	0
16	9585373	.	G	T	0	2	2	0	3	5	0	0
16	9590394	.	G	T	1	0	1	0	0	1	0	0
16	9590406	.	A	G	1	0	1	0	0	1	0	0
16	9596127	.	C	T	3	5	8	0	0	8	0	0
16	9603382	.	T	C	1	5	6	0	0	6	0	0
16	9605947	.	A	G	10	6	16	0	0	16	0	0
16	9606011	.	G	T	8	6	14	0	1	15	0	0
16	9606024	.	C	T	8	4	12	0	2	14	0	0
16	9606048	.	G	A	4	2	6	0	2	8	0	0
16	9716237	.	C	A	0	3	3	0	1	4	0	0
16	9716258	.	T	C	2	4	6	0	0	6	0	0
16	9718216	.	G	A	3	3	6	0	1	7	0	0
16	9724878	.	A	T	6	6	12	0	0	12	0	0
16	9724909	.	T	A	4	5	9	0	0	9	0	0
16	9725137	.	A	T	3	4	7	0	0	7	0	0
16	9748874	.	C	G	2	4	6	0	0	6	0	0
16	9751693	.	A	C	5	9	14	0	1	15	0	0
16	9752999	.	A	G	2	4	6	0	0	6	0	0
16	9753005	.	C	G	2	4	6	0	0	6	0	0
16	9753083	.	A	T	1	1	2	0	0	2	0	0
16	9755701	.	G	A	4	0	4	0	0	4	0	0
16	9755719	.	G	T	0	0	0	0	1	1	0	0
16	9758164	.	C	T	3	3	6	0	0	6	0	0
16	9758561	.	T	C	1	4	5	0	0	5	0	0
16	9758944	.	G	A	0	4	4	0	4	8	0	0
16	9758958	.	T	C	2	5	7	0	0	7	0	0
16	9759090	.	T	C	0	11	11	0	1	12	0	0
16	9759244	.	A	G	5	8	13	0	0	14	1	0
16	9759336	.	C	T	5	7	12	0	0	12	0	0
16	9759376	.	C	T	5	8	13	0	0	13	0	0
16	9759464	.	C	G	7	3	10	0	1	11	0	0
16	9759554	.	G	A	0	6	6	0	12	18	0	0
16	9759605	.	A	T	3	10	13	0	1	14	0	0
16	9759820	.	T	A	6	5	11	0	0	11	0	0
16	9759842	.	A	G	7	4	11	0	0	11	0	0
16	9760006	.	C	T	5	5	10	0	0	10	0	0
16	9760564	.	C	T	2	5	7	0	1	8	0	0
16	9760718	.	T	C	1	2	3	0	0	3	0	0
16	9761004	.	A	G	6	9	15	0	1	16	0	0
16	9761141	.	G	A	0	6	6	0	6	12	0	0
16	9761246	.	A	G	6	0	6	0	9	15	0	0
16	9761339	.	A	C	6	7	13	0	4	17	0	0
16	9766586	.	A	C	1	1	2	0	0	2	0	0
16	9769846	.	C	T	0	0	0	0	0	0	0	0
16	9777613	.	A	G	9	12	21	0	1	22	0	0
16	9781031	.	T	C	10	6	16	0	1	17	0	0
16	9785860	.	G	A	15	12	27	0	2	29	0	0
16	9785868	.	T	G	15	16	31	0	1	32	0	0
16	9785990	.	G	A	18	4	22	0	1	23	0	0
16	9787392	.	T	A	10	5	15	0	2	17	0	0
16	9787620	.	G	A	2	3	5	0	0	5	0	0
16	9787642	.	C	A	2	5	7	0	0	7	0	0
16	9788005	.	C	T	21	21	42	0	1	43	0	0
16	9788019	.	T	A	24	20	44	0	1	45	0	0
16	9788110	.	C	T	7	9	16	0	0	16	0	0
16	9788194	.	A	C	4	6	10	0	1	11	0	0
16	9788486	.	G	A	14	8	22	0	0	22	0	0
16	9789007	.	A	T	10	10	20	0	1	21	0	0
16	9789317	.	T	C	13	19	32	0	0	32	0	0
16	9789984	.	T	C	10	18	28	0	1	29	0	0
16	9807425	.	C	A	1	2	3	0	1	4	0	0
16	9807463	.	A	G	1	2	3	0	0	3	0	0
16	9807475	.	C	T	1	2	3	0	0	3	0	0
16	9833887	.	T	A	23	17	40	0	0	40	0	0
16	9833889	.	C	A	22	17	39	0	1	40	0	0
16	9833936	.	A	G	23	17	40	0	0	40	0	0
16	9833974	.	G	A	24	28	52	0	2	54	0	0
16	9834135	.	A	C	25	15	40	0	0	41	1	0
16	9835070	.	A	G	18	6	24	0	13	37	0	0
16	9835250	.	C	G	7	15	22	0	1	23	0	0
16	9847182	.	T	C	21	8	29	0	1	30	0	0
16	9868953	.	C	T	18	23	41	0	3	44	0	0
16	9980299	.	A	T	10	17	27	0	1	28	0	0
16	10027167	.	G	C	0	1	1	0	2	3	0	0
16	10055557	.	C	T	0	3	3	0	2	5	0	0
16	10055592	.	T	A	1	2	3	0	0	3	0	0
16	10055799	.	A	T	3	3	6	0	0	6	0	0
16	10055952	.	A	G	1	4	5	0	2	7	0	0
16	10055956	.	G	C	1	0	1	0	6	7	0	0
16	10056127	.	T	G	0	1	1	0	0	1	0	0
16	10066194	.	G	A	2	1	3	0	0	3	0	0
16	10071730	.	G	A	1	3	4	0	1	5	0	0
16	10097362	.	T	C	1	0	1	0	2	3	0	0
16	10199573	.	C	A	4	1	5	0	0	5	0	0
16	10284475	.	T	A	1	2	3	0	0	3	0	0
16	10284480	.	T	A	1	2	3	0	0	3	0	0
16	10284582	.	A	T	5	4	9	0	0	9	0	0
16	10284593	.	T	A	4	3	7	0	0	7	0	0
16	10287699	.	A	G	1	6	7	0	0	7	0	0
16	10288311	.	G	C	3	4	7	0	0	7	0	0
16	10288859	.	A	T	1	4	5	0	1	6	0	0
16	10288882	.	T	A	1	7	8	0	0	8	0	0
16	10300046	.	C	T	3	2	5	0	1	6	0	0
16	10303374	.	A	G	1	1	2	0	0	2	0	0
16	10325723	.	G	A	0	4	4	0	5	9	0	0
16	10325732	.	T	C	4	6	10	0	0	10	0	0
16	10325870	.	C	T	18	9	27	0	0	27	0	0
16	10325960	.	G	A	0	11	11	0	14	25	0	0
16	10326305	.	G	A	0	10	10	0	16	26	0	0
16	10326704	.	C	T	28	20	48	0	1	49	0	0
16	10326737	.	A	G	28	19	47	0	1	48	0	0
16	10326990	.	G	A	1	13	14	0	23	37	0	0
16	10326993	.	A	T	14	19	33	0	3	36	0	0
16	10327128	.	C	T	14	18	32	0	1	33	0	0
16	10327530	.	C	A	19	11	30	0	2	32	0	0
16	10327594	.	T	A	6	2	8	0	0	8	0	0
16	10338255	.	C	G	2	5	7	0	0	7	0	0
16	10339436	.	T	C	3	3	6	0	0	6	0	0
16	10339709	.	A	C	1	3	4	0	0	4	0	0
16	10340349	.	G	A	3	4	7	0	0	7	0	0
16	10340399	.	A	T	1	2	3	0	1	4	0	0
16	10340840	.	G	A	5	5	10	0	2	12	0	0
16	10340935	.	G	C	5	3	8	0	2	10	0	0
16	10340941	.	T	C	2	3	5	0	2	7	0	0
16	10341355	.	G	A	6	2	8	0	0	8	0	0
16	10341452	.	G	A	2	2	4	0	1	5	0	0
16	10341470	.	G	A	6	3	9	0	0	9	0	0
16	10341778	.	C	A	4	4	8	0	1	9	0	0
16	10341816	.	A	C	1	4	5	0	0	5	0	0
16	10341881	.	A	G	2	7	9	0	1	10	0	0
16	10345223	.	T	C	2	1	3	0	1	4	0	0
16	10345720	.	A	G	11	6	17	0	0	17	0	0
16	10346378	.	A	T	4	3	7	0	0	7	0	0
16	10360911	.	T	C	2	4	6	0	1	7	0	0
16	10360935	.	T	C	1	4	5	0	1	6	0	0
16	10361049	.	T	C	1	0	1	0	0	1	0	0
16	10367171	.	G	A	2	1	3	0	0	3	0	0
16	10367475	.	C	A	10	13	23	0	3	26	0	0
16	10367499	.	C	T	15	9	24	0	1	25	0	0
16	10367674	.	C	T	6	13	19	0	0	20	1	0
16	10369027	.	T	A	0	9	9	0	0	9	0	0
16	10413724	.	A	C	5	4	9	0	0	9	0	0
16	10413726	.	G	T	3	5	8	0	1	9	0	0
16	10413815	.	C	A	8	3	11	0	1	12	0	0
16	10413957	.	T	C	3	3	6	0	0	6	0	0
16	10417124	.	G	C	7	10	17	0	0	17	0	0
16	10423046	.	C	T	1	3	4	0	1	5	0	0
16	10425842	.	C	T	3	2	5	0	0	5	0	0
16	10426247	.	T	A	3	3	6	0	1	7	0	0
16	10426378	.	C	T	2	3	5	0	0	5	0	0
16	10426612	.	T	A	3	3	6	0	1	7	0	0
16	10426975	.	A	T	4	3	7	0	0	7	0	0
16	10427021	.	T	C	2	2	4	0	0	4	0	0
16	10427590	.	G	C	6	4	10	0	0	10	0	0
16	10427722	.	A	T	3	4	7	0	0	7	0	0
16	10427746	.	T	G	3	5	8	0	0	8	0	0
16	10440612	.	G	A	0	1	1	0	1	2	0	0
16	10445228	.	C	T	0	1	1	0	0	1	0	0
16	10447453	.	C	T	0	1	1	0	0	1	0	0
16	10447923	.	C	A	1	1	2	0	0	2	0	0
16	10447983	.	C	T	2	1	3	0	0	3	0	0
16	10448008	.	G	C	1	0	1	0	0	1	0	0
16	10458749	.	A	G	3	4	7	0	0	7	0	0
16	10459006	.	C	A	1	1	2	0	0	2	0	0
16	10464534	.	A	C	1	0	1	0	0	1	0	0
16	10464570	.	T	C	5	5	10	0	1	11	0	0
16	10464571	.	C	T	5	6	11	0	0	11	0	0
16	10464609	.	A	G	10	7	17	0	0	17	0	0
16	10468283	.	T	C	3	4	7	0	0	7	0	0
16	10472192	.	T	C	1	0	1	0	0	1	0	0
16	10475006	.	C	T	16	8	24	0	0	24	0	0
16	10475645	.	C	T	8	4	12	0	0	12	0	0
16	10477905	.	A	G	10	8	18	0	2	20	0	0
16	10478061	.	G	T	17	11	28	0	0	28	0	0
16	10481425	.	C	T	5	4	9	0	0	9	0	0
16	10502065	.	A	G	1	0	1	0	0	1	0	0
16	10502069	.	A	G	0	1	1	0	0	1	0	0
16	10502169	.	G	A	0	0	0	0	1	1	0	0
16	10617196	.	C	T	1	2	3	0	0	3	0	0
16	10620018	.	G	A	0	5	5	0	3	8	0	0
16	10620129	.	T	C	4	3	7	0	0	7	0	0
16	10620183	.	T	C	5	5	10	0	0	10	0	0
16	10633215	.	A	G	3	5	8	0	2	10	0	0
16	10633287	.	C	A	3	5	8	0	0	8	0	0
16	10634013	.	A	G	1	1	2	0	5	7	0	0
16	10634027	.	A	G	0	0	0	0	8	8	0	0
16	10634510	.	C	T	2	4	6	0	0	6	0	0
16	10634568	.	A	T	2	4	6	0	0	6	0	0
16	10634846	.	T	C	1	2	3	0	0	3	0	0
16	10635148	.	G	A	3	5	8	0	0	8	0	0
16	10636168	.	C	T	8	9	17	0	0	17	0	0
16	10636173	.	A	G	11	5	16	0	1	17	0	0
16	10636534	.	A	G	6	15	21	0	4	25	0	0
16	10636550	.	A	G	12	5	17	0	0	17	0	0
16	10636658	.	T	G	2	5	7	0	0	7	0	0
16	10636947	.	T	G	8	0	8	0	6	14	0	0
16	10637050	.	C	T	13	7	20	0	0	20	0	0
16	10637259	.	A	G	11	9	20	0	3	23	0	0
16	10637510	.	T	C	11	7	18	0	0	18	0	0
16	10637629	.	T	C	1	6	7	0	0	7	0	0
16	10637701	.	T	A	1	3	4	0	0	4	0	0
16	10637705	.	A	C	1	4	5	0	0	5	0	0
16	10724941	.	T	C	2	2	4	0	0	4	0	0
16	10724995	.	C	G	2	0	2	0	3	5	0	0
16	10731333	.	C	T	7	5	12	0	0	12	0	0
16	10731388	.	G	C	8	5	13	0	2	15	0	0
16	10731717	.	C	G	3	5	8	0	0	8	0	0
16	10732140	.	G	A	1	2	3	0	1	4	0	0
16	10732162	.	T	C	2	1	3	0	0	3	0	0
16	10732407	.	G	A	0	2	2	0	3	5	0	0
16	10732429	.	A	T	1	3	4	0	0	4	0	0
16	10732450	.	C	T	3	1	4	0	0	4	0	0
16	10733751	.	A	G	2	3	5	0	0	5	0	0
16	10733829	.	G	C	1	4	5	0	1	6	0	0
16	10734190	.	T	C	3	5	8	0	0	8	0	0
16	10776922	.	A	C	11	14	25	0	1	26	0	0
16	10795620	.	G	A	6	12	18	0	1	19	0	0
16	10795647	.	T	C	6	3	9	0	0	9	0	0
16	10798995	.	A	T	3	4	7	0	1	8	0	0
16	10801121	.	G	A	7	7	14	0	1	15	0	0
16	10801374	.	T	C	9	14	23	0	2	25	0	0
16	10801422	.	G	A	1	3	4	0	0	4	0	0
16	10801682	.	C	T	13	12	25	0	1	26	0	0
16	10801772	.	C	T	0	1	1	0	0	1	0	0
16	10804843	.	T	C	23	29	52	0	1	53	0	0
16	10804862	.	A	T	26	27	53	0	0	53	0	0
16	10804878	.	C	T	23	20	43	0	2	45	0	0
16	10806318	.	C	T	2	0	2	0	0	2	0	0
16	10807471	.	A	G	19	18	37	0	0	37	0	0
16	10813138	.	A	C	24	24	48	0	3	51	0	0
16	10815877	.	T	C	10	16	26	0	1	27	0	0
16	10815907	.	A	G	15	0	15	0	12	27	0	0
16	10820667	.	T	C	27	31	58	0	8	66	0	0
16	10828887	.	T	C	7	1	8	0	0	8	0	0
16	10829019	.	T	C	12	16	28	0	0	28	0	0
16	10829139	.	A	G	7	15	22	0	1	23	0	0
16	10829872	.	G	C	4	11	15	0	1	16	0	0
16	10830309	.	T	A	10	3	13	0	1	14	0	0
16	10830431	.	G	A	10	23	33	0	1	34	0	0
16	10832217	.	C	T	4	0	4	0	0	4	0	0
16	10833987	.	G	A	14	5	19	0	0	19	0	0
16	10833993	.	C	T	1	14	15	0	7	22	0	0
16	10834715	.	A	C	2	0	2	0	1	3	0	0
16	10841177	.	A	G	1	3	4	0	1	5	0	0
16	10843402	.	A	G	3	0	3	0	3	6	0	0
16	10856130	.	A	G	7	5	12	0	0	12	0	0
16	10859434	.	C	T	21	19	40	0	1	41	0	0
16	10859435	.	T	C	20	19	39	0	2	41	0	0
16	10862159	.	T	A	9	21	30	0	2	32	0	0
16	10862162	.	T	A	7	22	29	0	1	30	0	0
16	10862279	.	A	G	15	7	22	0	0	22	0	0
16	10862280	.	G	T	15	7	22	0	0	22	0	0
16	10862331	.	C	G	8	8	16	0	0	16	0	0
16	10862773	.	T	C	15	20	35	0	0	35	0	0
16	10919290	.	C	T	0	3	3	0	1	4	0	0
16	10987970	.	A	C	2	3	5	0	0	5	0	0
16	10990445	.	T	A	1	2	3	0	0	3	0	0
16	10990490	.	G	A	2	5	7	0	0	7	0	0
16	10990633	.	A	G	0	2	2	0	0	2	0	0
16	10990915	.	T	A	2	4	6	0	0	6	0	0
16	10991162	.	T	A	2	3	5	0	0	5	0	0
16	11140430	.	A	G	9	4	13	0	1	14	0	0
16	11140435	.	A	G	3	7	10	0	2	12	0	0
16	11140800	.	A	G	1	2	3	0	0	3	0	0
16	11141573	.	G	A	1	3	4	0	1	5	0	0
16	11222031	.	T	A	9	17	26	0	0	26	0	0
16	11965486	.	T	C	5	2	7	0	0	7	0	0
16	11965673	.	G	T	14	24	38	0	0	38	0	0
16	11965803	.	G	T	17	21	38	0	4	42	0	0
16	11965931	.	T	C	19	3	22	0	14	36	0	0
16	11970239	.	C	T	10	5	15	0	0	15	0	0
16	11974658	.	G	A	2	1	3	0	0	3	0	0
16	11974703	.	G	A	5	6	11	0	1	12	0	0
16	11974720	.	G	T	7	4	11	0	0	11	0	0
16	11978045	.	G	A	6	19	25	0	1	26	0	0
16	11980484	.	C	T	0	1	1	0	2	3	0	0
16	11985606	.	C	T	1	3	4	0	0	4	0	0
16	12054138	.	C	T	0	2	2	0	2	4	0	0
16	12064771	.	T	A	6	6	12	0	1	13	0	0
16	12064946	.	C	T	14	8	22	0	0	22	0	0
16	12065025	.	G	A	10	10	20	0	1	21	0	0
16	12065201	.	C	T	13	10	23	0	1	24	0	0
16	12065392	.	G	A	11	10	21	0	0	21	0	0
16	12073577	.	G	A	1	2	3	0	0	3	0	0
16	12078976	.	C	T	2	0	2	0	1	3	0	0
16	12078982	.	C	T	1	1	2	0	0	2	0	0
16	12095043	.	G	A	3	1	4	0	0	4	0	0
16	12095065	.	C	T	2	2	4	0	0	4	0	0
16	12097241	.	T	C	3	4	7	0	0	7	0	0
16	12097292	.	G	T	3	3	6	0	1	7	0	0
16	12097325	.	G	A	5	8	13	0	1	14	0	0
16	12097354	.	G	T	6	8	14	0	2	16	0	0
16	12102412	.	A	T	18	24	42	0	0	42	0	0
16	12102671	.	T	C	22	41	63	0	0	63	0	0
16	12102708	.	A	G	32	35	67	0	2	69	0	0
16	12103083	.	T	C	23	2	25	0	32	57	0	0
16	12103331	.	T	A	32	22	54	0	4	58	0	0
16	12103344	.	A	G	26	30	56	0	2	58	0	0
16	12103530	.	G	A	26	27	53	0	2	55	0	0
16	12103540	.	G	A	28	25	53	0	2	55	0	0
16	12103598	.	G	A	20	25	45	0	2	47	0	0
16	12103732	.	C	T	0	15	15	0	21	36	0	0
16	12103749	.	C	T	16	14	30	0	3	33	0	0
16	12103982	.	G	A	23	33	56	0	3	59	0	0
16	12104042	.	C	T	26	25	51	0	1	52	0	0
16	12104043	.	A	T	26	24	50	0	2	52	0	0
16	12104083	.	C	T	23	26	49	0	2	51	0	0
16	12104209	.	A	C	24	8	32	2	3	37	0	0
16	12104316	.	T	A	24	11	35	1	0	36	0	0
16	12104601	.	G	A	32	18	50	1	2	53	0	0
16	12104665	.	A	G	27	17	44	4	2	50	0	0
16	12104794	.	C	T	10	14	24	0	0	24	0	0
16	12105206	.	A	G	16	20	36	0	4	40	0	0
16	12105265	.	T	A	37	11	48	0	1	49	0	0
16	12105443	.	A	T	11	4	15	0	1	17	1	0
16	12105689	.	C	T	0	26	26	0	11	37	0	0
16	12105796	.	C	T	1	30	31	0	28	59	0	0
16	12114975	.	G	A	5	11	16	0	0	16	0	0
16	12117537	.	G	A	10	6	16	0	2	18	0	0
16	12117645	.	G	A	3	2	5	0	0	5	0	0
16	12117648	.	G	A	3	2	5	0	0	5	0	0
16	12118207	.	G	A	11	22	33	0	1	34	0	0
16	12118210	.	C	T	13	21	34	0	1	35	0	0
16	12135754	.	G	A	17	6	23	0	3	26	0	0
16	12138841	.	G	A	17	18	35	0	0	35	0	0
16	12138940	.	A	G	13	14	27	0	0	27	0	0
16	12143710	.	C	T	4	2	6	0	1	7	0	0
16	12150856	.	C	A	0	9	9	0	5	14	0	0
16	12162370	.	A	C	1	0	1	0	1	2	0	0
16	12173511	.	T	A	5	5	10	0	2	13	1	0
16	12175377	.	T	C	3	6	9	0	0	9	0	0
16	12175594	.	A	G	3	3	6	0	1	7	0	0
16	12245751	.	T	C	8	7	15	0	1	16	0	0
16	12245954	.	C	T	3	1	4	0	0	4	0	0
16	12254457	.	C	T	31	26	57	0	3	60	0	0
16	12254469	.	T	C	36	25	61	0	0	61	0	0
16	12254592	.	T	C	24	28	52	0	3	55	0	0
16	12254674	.	C	T	29	17	46	0	0	46	0	0
16	12254776	.	A	T	26	22	48	0	1	49	0	0
16	12256585	.	C	T	5	8	13	0	0	13	0	0
16	12256614	.	G	A	9	14	23	0	0	23	0	0
16	12256629	.	A	G	10	17	27	0	2	29	0	0
16	12256681	.	C	A	0	24	24	0	21	45	0	0
16	12256801	.	C	T	28	16	44	0	2	46	0	0
16	12256816	.	G	T	26	9	35	0	5	40	0	0
16	12257154	.	T	C	17	20	37	0	1	38	0	0
16	12257216	.	A	T	14	21	35	0	2	37	0	0
16	12257401	.	A	C	18	1	19	0	0	19	0	0
16	12257506	.	G	A	16	8	24	0	0	24	0	0
16	12257904	.	C	T	18	20	38	0	0	38	0	0
16	12257921	.	T	G	17	16	33	0	2	35	0	0
16	12258044	.	C	T	11	11	22	0	0	22	0	0
16	12258128	.	A	T	8	10	18	0	0	18	0	0
16	12258264	.	G	C	3	8	11	0	2	13	0	0
16	12258268	.	C	T	4	9	13	0	0	13	0	0
16	12258302	.	A	T	3	5	8	0	1	9	0	0
16	12258593	.	T	G	6	9	15	0	2	17	0	0
16	12258733	.	A	T	6	3	9	0	0	9	0	0
16	12258999	.	G	C	10	18	28	0	1	29	0	0
16	12259298	.	G	C	15	4	19	0	0	19	0	0
16	12259302	.	A	T	14	4	18	0	1	19	0	0
16	12259589	.	G	A	19	13	32	0	0	32	0	0
16	12259678	.	T	C	10	13	23	0	0	23	0	0
16	12259737	.	A	T	10	6	16	0	0	16	0	0
16	12260002	.	T	G	13	9	22	0	2	24	0	0
16	12260134	.	A	T	8	9	17	0	1	18	0	0
16	12260291	.	G	T	9	10	19	0	1	20	0	0
16	12261211	.	A	G	3	4	7	0	0	7	0	0
16	12261625	.	A	G	3	7	10	0	0	10	0	0
16	12262453	.	T	G	1	0	1	0	0	1	0	0
16	12263047	.	C	T	0	0	0	0	4	4	0	0
16	12263385	.	G	A	10	8	18	0	2	20	0	0
16	12264912	.	A	T	7	3	10	0	0	10	0	0
16	12264999	.	T	C	2	1	3	0	5	8	0	0
16	12265237	.	A	G	1	3	4	0	0	4	0	0
16	12265917	.	C	G	3	0	3	0	0	3	0	0
16	12266073	.	G	A	10	7	17	0	0	17	0	0
16	12267706	.	C	G	0	1	1	0	2	3	0	0
16	12273636	.	G	A	0	0	0	0	2	2	0	0
16	12276030	.	G	A	12	10	22	0	2	24	0	0
16	12276033	.	A	T	13	10	23	0	1	24	0	0
16	12276065	.	A	T	9	2	11	0	0	11	0	0
16	12276102	.	G	A	3	6	9	0	0	9	0	0
16	12286264	.	C	A	5	8	13	0	0	13	0	0
16	12292467	.	G	A	0	23	23	0	8	31	0	0
16	12292599	.	T	C	0	2	2	0	0	2	0	0
16	12292622	.	G	A	3	12	15	0	0	15	0	0
16	12292648	.	T	C	4	13	17	0	1	18	0	0
16	12294316	.	C	A	2	8	10	0	1	11	0	0
16	12340701	.	T	C	2	0	2	0	3	5	0	0
16	12346516	.	A	C	1	0	1	0	2	3	0	0
16	12367100	.	A	G	1	0	1	0	0	1	0	0
16	12367103	.	G	A	1	0	1	0	0	1	0	0
16	12475737	.	T	C	4	2	6	0	0	6	0	0
16	12475750	.	A	G	4	3	7	0	0	7	0	0
16	12477825	.	G	A	2	3	5	0	0	5	0	0
16	12478550	.	G	A	2	3	5	0	0	5	0	0
16	12478565	.	G	A	1	2	3	0	0	3	0	0
16	12478727	.	G	A	1	2	3	0	0	3	0	0
16	12478772	.	T	C	1	0	1	0	3	4	0	0
16	12632593	.	G	C	3	2	5	0	0	5	0	0
16	12632664	.	T	C	0	1	1	0	0	1	0	0
16	12636347	.	T	C	1	1	2	0	0	2	0	0
16	12636546	.	T	C	4	7	11	0	0	11	0	0
16	12637140	.	T	C	7	2	9	0	1	10	0	0
16	12637160	.	A	T	5	3	8	0	0	8	0	0
16	12637271	.	G	A	2	3	5	0	0	5	0	0
16	12637284	.	T	C	1	3	4	0	0	4	0	0
16	12637552	.	A	T	7	5	12	0	0	12	0	0
16	12637681	.	T	G	5	4	9	0	0	9	0	0
16	12637779	.	C	T	2	9	11	0	0	11	0	0
16	12637822	.	T	C	3	10	13	0	0	13	0	0
16	12637824	.	G	A	0	10	10	0	3	13	0	0
16	12638030	.	A	C	1	2	3	0	0	3	0	0
16	12638062	.	A	G	2	2	4	0	0	4	0	0
16	12638612	.	C	G	2	5	7	0	0	7	0	0
16	12638622	.	A	G	3	5	8	0	0	8	0	0
16	12639125	.	A	T	4	7	11	0	1	12	0	0
16	12639184	.	C	G	4	6	10	0	1	11	0	0
16	12639320	.	C	G	6	4	10	0	1	11	0	0
16	12639488	.	G	A	2	2	4	2	0	6	0	0
16	12730380	.	A	G	4	7	11	0	0	11	0	0
16	12738324	.	G	A	4	4	8	0	0	8	0	0
16	12738351	.	T	C	0	2	2	0	1	3	0	0
16	12740779	.	C	T	3	9	12	0	0	12	0	0
16	12740949	.	C	G	10	7	17	0	0	17	0	0
16	12743927	.	G	A	1	9	10	0	6	16	0	0
16	12748944	.	A	G	16	5	21	0	1	22	0	0
16	12755992	.	C	T	11	13	24	0	4	28	0	0
16	12756094	.	A	C	12	7	19	0	0	19	0	0
16	12756255	.	C	T	9	12	21	0	0	21	0	0
16	12764221	.	G	A	5	2	7	0	0	7	0	0
16	12764321	.	G	A	1	4	5	0	0	5	0	0
16	12764399	.	G	A	2	2	4	0	0	4	0	0
16	12794075	.	C	G	2	6	8	0	0	8	0	0
16	12807038	.	G	A	1	1	2	0	0	2	0	0
16	12812496	.	T	C	2	5	7	0	0	7	0	0
16	12814102	.	A	T	6	3	9	0	0	9	0	0
16	12816486	.	T	C	1	5	6	0	0	6	0	0
16	12816745	.	A	C	5	5	10	0	1	11	0	0
16	12816975	.	G	A	2	2	4	0	0	4	0	0
16	12818220	.	G	T	4	2	6	0	1	7	0	0
16	12820952	.	C	T	5	7	12	0	4	16	0	0
16	12821091	.	C	A	13	19	32	0	1	33	0	0
16	12821106	.	C	T	19	16	35	0	1	36	0	0
16	12821221	.	G	A	10	18	28	0	3	31	0	0
16	12821300	.	G	C	0	11	11	0	18	29	0	0
16	12821449	.	G	A	16	15	31	0	0	31	0	0
16	12821459	.	A	G	12	15	27	0	4	31	0	0
16	12882612	.	C	T	0	15	15	0	30	45	0	0
16	12883126	.	G	A	15	17	32	0	5	37	0	0
16	12883618	.	C	T	17	15	32	0	1	33	0	0
16	12884054	.	A	T	15	17	32	0	1	33	0	0
16	12884510	.	A	T	2	6	8	0	0	8	0	0
16	12884513	.	G	A	5	2	7	0	0	7	0	0
16	12953670	.	C	T	11	7	18	0	1	19	0	0
16	12963274	.	A	T	11	11	22	0	4	26	0	0
16	12963368	.	G	A	17	5	22	0	2	24	0	0
16	12963975	.	A	G	21	23	44	0	1	45	0	0
16	12967855	.	G	A	8	8	16	0	0	16	0	0
16	12981637	.	G	A	2	1	3	0	0	3	0	0
16	12984488	.	C	G	7	7	14	0	0	14	0	0
16	13049162	.	A	G	2	4	6	0	0	6	0	0
16	13179335	.	G	A	3	5	8	0	0	8	0	0
16	13180175	.	T	C	3	2	5	0	0	5	0	0
16	13180193	.	G	A	2	6	8	0	0	8	0	0
16	13180298	.	T	C	2	8	10	0	0	10	0	0
16	13180389	.	T	C	3	4	7	0	0	7	0	0
16	13181465	.	T	C	5	3	8	0	0	8	0	0
16	13568841	.	A	G	3	2	5	0	0	5	0	0
16	13568844	.	A	T	3	1	4	0	0	4	0	0
16	13600680	.	A	C	14	17	31	0	1	32	0	0
16	13601013	.	A	G	9	11	20	0	0	20	0	0
16	13601026	.	T	C	7	9	16	0	0	16	0	0
16	13601228	.	A	T	6	12	18	0	2	20	0	0
16	13601286	.	G	T	6	5	11	0	0	11	0	0
16	13601328	.	C	T	1	6	7	0	0	7	0	0
16	13601964	.	T	C	10	1	11	0	12	23	0	0
16	13602164	.	T	C	7	10	17	0	2	19	0	0
16	13602454	.	T	A	9	9	18	0	1	19	0	0
16	13602488	.	T	C	6	6	12	0	2	14	0	0
16	13602800	.	T	A	6	7	13	0	0	13	0	0
16	13602922	.	A	G	4	10	14	0	0	14	0	0
16	13603007	.	T	G	7	16	23	0	1	24	0	0
16	13606896	.	A	T	4	5	9	0	0	9	0	0
16	13610651	.	A	T	1	5	6	0	2	8	0	0
16	13610966	.	A	G	10	12	22	0	0	22	0	0
16	13611035	.	G	A	3	7	10	0	1	11	0	0
16	13612999	.	T	A	5	4	9	0	0	9	0	0
16	13613104	.	T	C	4	5	9	0	1	10	0	0
16	13613148	.	C	T	1	3	4	0	0	4	0	0
16	13613208	.	A	T	1	3	4	0	0	4	0	0
16	13613210	.	C	A	1	3	4	0	0	4	0	0
16	13616698	.	A	T	12	19	31	0	0	31	0	0
16	13616862	.	G	C	8	4	12	0	2	14	0	0
16	13617152	.	C	T	13	11	24	0	1	25	0	0
16	13617291	.	G	A	5	7	12	0	0	12	0	0
16	13618172	.	C	G	10	10	20	0	2	22	0	0
16	13618374	.	A	T	13	11	24	0	2	26	0	0
16	13618662	.	T	A	12	7	19	0	1	20	0	0
16	13620832	.	T	C	3	4	7	0	0	7	0	0
16	13621056	.	G	A	3	6	9	0	1	10	0	0
16	13622769	.	T	A	1	1	2	0	1	3	0	0
16	13622770	.	G	T	2	1	3	0	0	3	0	0
16	13623642	.	T	A	7	5	12	0	0	12	0	0
16	13643504	.	C	T	0	21	21	0	16	37	0	0
16	13643974	.	C	T	0	11	11	0	14	25	0	0
16	13644781	.	T	A	5	5	10	0	2	12	0	0
16	13645495	.	C	T	5	7	12	0	1	13	0	0
16	13673660	.	T	A	3	2	5	0	1	6	0	0
16	13673734	.	A	C	5	5	10	0	1	11	0	0
16	13674176	.	T	G	7	10	17	0	0	17	0	0
16	13680487	.	T	G	3	2	5	0	0	5	0	0
16	13685800	.	G	A	3	2	5	0	0	5	0	0
16	13701482	.	C	T	6	5	11	0	0	11	0	0
16	13701599	.	A	G	7	3	10	0	0	10	0	0
16	13706207	.	G	C	6	4	10	0	0	10	0	0
16	13721408	.	C	T	4	6	10	0	0	10	0	0
16	13729810	.	C	T	3	4	7	0	1	8	0	0
16	13741610	.	G	A	3	5	8	0	0	8	0	0
16	13743390	.	G	A	3	4	7	0	0	7	0	0
16	13780375	.	G	A	6	1	7	0	0	7	0	0
16	13789765	.	G	A	3	3	6	0	0	6	0	0
16	13810372	.	G	A	2	4	6	0	0	6	0	0
16	13810417	.	G	A	1	2	3	0	0	3	0	0
16	13810528	.	C	T	0	2	2	0	0	2	0	0
16	13826195	.	C	T	2	3	5	0	1	6	0	0
16	13841360	.	T	A	3	2	5	0	1	6	0	0
16	13845350	.	G	A	8	12	20	0	1	21	0	0
16	13845368	.	G	A	0	10	10	0	12	22	0	0
16	13845571	.	T	A	9	6	15	0	0	15	0	0
16	13855121	.	C	T	9	8	17	0	0	17	0	0
16	13855142	.	T	C	9	11	20	0	2	22	0	0
16	13855179	.	A	G	13	1	14	0	12	26	0	0
16	13855482	.	T	A	7	8	15	0	0	15	0	0
16	13856159	.	A	C	0	3	3	0	0	3	0	0
16	13856192	.	C	A	0	0	0	0	0	2	2	0
16	13858356	.	C	A	12	12	24	0	1	25	0	0
16	13858436	.	C	A	11	10	21	0	1	22	0	0
16	13858570	.	C	T	17	16	33	0	1	34	0	0
16	13858673	.	T	C	16	17	33	0	1	34	0	0
16	13858866	.	T	A	12	9	21	0	1	22	0	0
16	13860459	.	G	A	0	2	2	0	1	3	0	0
16	13866763	.	G	A	3	0	3	0	1	4	0	0
16	13870827	.	C	T	2	4	6	0	0	6	0	0
16	13883968	.	C	A	6	9	15	0	0	15	0	0
16	13883980	.	A	C	6	9	15	0	1	16	0	0
16	14010210	.	G	T	2	0	2	0	0	2	0	0
16	14010241	.	C	A	1	0	1	0	0	1	0	0
16	14010794	.	C	T	0	1	1	0	0	1	0	0
16	14021817	.	G	T	5	2	7	0	0	7	0	0
16	14022252	.	G	A	1	7	8	0	16	24	0	0
16	14022520	.	G	A	6	4	10	0	0	10	0	0
16	14022830	.	T	C	2	6	8	0	0	8	0	0
16	14023087	.	A	C	2	2	4	0	0	4	0	0
16	14029329	.	A	T	9	6	15	0	0	15	0	0
16	14029424	.	A	C	10	9	19	0	0	19	0	0
16	14029437	.	T	C	9	8	17	0	0	17	0	0
16	14055048	.	G	C	6	7	13	0	0	13	0	0
16	14055284	.	A	T	5	6	11	0	1	12	0	0
16	14095097	.	C	T	0	4	4	0	6	10	0	0
16	14115928	.	G	T	2	1	3	0	0	3	0	0
16	14115931	.	G	A	2	1	3	0	0	3	0	0
16	14133851	.	G	A	2	5	7	0	0	7	0	0
16	14133907	.	C	T	3	5	8	0	0	8	0	0
16	14154226	.	C	T	6	3	9	0	0	9	0	0
16	14154240	.	T	A	3	4	7	0	1	8	0	0
16	14154708	.	G	A	5	3	8	0	0	8	0	0
16	14154798	.	C	T	0	10	10	0	8	18	0	0
16	14154870	.	A	G	10	11	21	0	0	21	0	0
16	14154944	.	C	T	4	7	11	0	0	11	0	0
16	14155038	.	G	A	7	4	11	0	0	11	0	0
16	14155169	.	C	T	2	2	4	0	0	4	0	0
16	14155563	.	T	C	2	11	13	0	3	16	0	0
16	14155684	.	G	A	2	8	10	0	0	10	0	0
16	14155686	.	C	T	2	7	9	0	1	10	0	0
16	14156157	.	T	C	3	4	7	0	0	7	0	0
16	14156518	.	T	A	2	3	5	0	0	5	0	0
16	14156556	.	T	C	3	2	5	0	0	5	0	0
16	14156646	.	G	A	2	4	6	0	0	6	0	0
16	14156695	.	C	T	0	5	5	0	7	12	0	0
16	14156775	.	C	A	0	3	3	0	2	5	0	0
16	14157055	.	C	T	1	2	3	0	0	3	0	0
16	14157371	.	G	A	5	3	8	0	0	8	0	0
16	14158170	.	G	A	0	4	4	0	0	4	0	0
16	14158490	.	G	A	4	2	6	0	0	6	0	0
16	14202197	.	T	A	3	3	6	0	0	6	0	0
16	14206289	.	G	A	2	1	3	0	0	3	0	0
16	14209195	.	G	A	2	2	4	0	1	5	0	0
16	14209348	.	T	C	7	11	18	0	1	19	0	0
16	14212079	.	G	C	0	6	6	0	7	13	0	0
16	14214534	.	G	A	0	1	1	0	0	1	0	0
16	14214543	.	A	G	0	1	1	0	0	1	0	0
16	14227913	.	C	T	1	3	4	0	0	4	0	0
16	14228033	.	A	G	0	0	0	0	2	2	0	0
16	14228668	.	A	G	2	2	4	0	0	4	0	0
16	14228677	.	C	T	3	2	5	0	0	5	0	0
16	14228743	.	C	T	1	0	1	0	0	1	0	0
16	14228902	.	C	T	4	2	6	0	0	6	0	0
16	14228979	.	A	G	0	2	2	0	1	3	0	0
16	14229031	.	T	A	2	2	4	0	0	4	0	0
16	14229397	.	A	G	3	3	6	0	0	6	0	0
16	14229501	.	A	C	2	1	3	0	1	4	0	0
16	14229539	.	C	T	2	3	5	0	0	5	0	0
16	14229614	.	A	G	2	5	7	0	0	7	0	0
16	14229946	.	T	C	4	4	8	0	0	8	0	0
16	14229947	.	A	T	4	4	8	0	0	8	0	0
16	14230143	.	A	G	5	0	5	0	6	11	0	0
16	14230155	.	A	G	2	8	10	0	0	10	0	0
16	14230329	.	G	C	3	1	4	0	0	4	0	0
16	14230373	.	T	C	1	2	3	0	1	4	0	0
16	14230514	.	T	A	3	1	4	0	1	5	0	0
16	14230517	.	C	T	3	2	5	0	0	5	0	0
16	14230570	.	C	T	3	4	7	0	0	7	0	0
16	14231038	.	A	G	10	4	14	0	1	15	0	0
16	14231063	.	G	A	0	6	6	0	9	15	0	0
16	14231079	.	G	A	0	7	7	0	7	14	0	0
16	14231207	.	T	A	6	3	9	0	0	9	0	0
16	14231250	.	T	A	0	3	3	0	1	4	0	0
16	14231941	.	A	G	6	17	23	0	0	23	0	0
16	14231952	.	A	T	6	15	21	0	1	22	0	0
16	14232005	.	G	A	10	8	18	0	3	21	0	0
16	14266647	.	A	T	0	2	2	0	0	2	0	0
16	14269885	.	G	A	1	3	4	0	0	4	0	0
16	14269906	.	G	A	2	6	8	0	1	9	0	0
16	14416599	.	C	T	2	6	8	0	1	9	0	0
16	14416876	.	T	G	4	3	7	0	1	8	0	0
16	14417299	.	A	T	2	2	4	0	0	4	0	0
16	14588209	.	G	A	6	5	11	0	1	12	0	0
16	14588301	.	A	G	3	2	5	0	1	6	0	0
16	14588311	.	G	A	4	3	7	0	0	7	0	0
16	14597927	.	A	C	1	0	1	0	0	1	0	0
16	14627294	.	G	A	2	3	5	0	0	5	0	0
16	14638476	.	C	T	2	4	6	0	0	6	0	0
16	14664767	.	T	A	3	0	3	0	0	3	0	0
16	14670990	.	A	G	4	0	4	0	4	8	0	0
16	14670994	.	T	A	2	4	6	0	1	7	0	0
16	14671097	.	A	T	2	5	7	0	0	7	0	0
16	14671099	.	A	T	5	2	7	0	0	7	0	0
16	14671135	.	A	G	1	3	4	0	0	4	0	0
16	14671227	.	C	T	3	2	5	0	0	5	0	0
16	14671249	.	T	G	2	0	2	0	3	5	0	0
16	14675175	.	C	T	9	5	14	0	0	14	0	0
16	14675373	.	A	C	5	9	14	0	0	14	0	0
16	14675413	.	G	T	0	2	2	0	7	9	0	0
16	14675487	.	T	A	5	4	9	0	0	9	0	0
16	14675572	.	G	A	8	13	21	0	0	21	0	0
16	14798212	.	T	C	1	2	3	0	0	3	0	0
16	14819173	.	T	G	0	2	2	0	0	2	0	0
16	14908825	.	C	T	1	2	3	0	0	3	0	0
16	14973890	.	G	A	0	5	5	0	1	6	0	0
16	14973968	.	A	T	0	3	3	0	0	3	0	0
16	15034797	.	G	A	0	8	8	0	10	18	0	0
16	15037778	.	C	T	4	5	9	0	1	10	0	0
16	15048737	.	A	T	7	3	10	0	0	10	0	0
16	15049133	.	A	G	4	3	7	0	3	10	0	0
16	15050112	.	C	G	6	6	12	0	0	12	0	0
16	15050135	.	C	T	5	4	9	0	0	9	0	0
16	15050277	.	G	A	9	9	18	0	1	19	0	0
16	15050623	.	C	T	9	7	16	0	1	17	0	0
16	15114963	.	G	T	1	1	2	0	0	2	0	0
16	15133150	.	A	G	1	3	4	0	0	4	0	0
16	15168740	.	G	A	1	0	1	0	0	1	0	0
16	15193716	.	G	A	0	3	3	0	0	3	0	0
16	15943424	.	C	T	6	9	15	0	2	17	0	0
16	15956855	.	C	A	1	3	4	0	0	4	0	0
16	15958358	.	T	C	1	3	4	0	0	4	0	0
16	15958715	.	T	C	1	0	1	0	1	2	0	0
16	16041698	.	A	T	4	3	7	0	0	7	0	0
16	16043191	.	T	G	7	13	20	0	1	21	0	0
16	16043218	.	A	G	5	11	16	0	0	16	0	0
16	16069884	.	A	G	4	2	6	0	0	6	0	0
16	16103927	.	C	T	5	3	8	0	0	8	0	0
16	16113853	.	G	A	3	2	5	0	0	5	0	0
16	16120849	.	C	T	2	3	5	0	0	5	0	0
16	16165179	.	T	A	31	28	59	0	1	60	0	0
16	16165418	.	C	T	29	35	64	0	5	69	0	0
16	16182195	.	T	C	4	2	6	0	0	6	0	0
16	16232902	.	A	T	6	8	14	0	0	14	0	0
16	16232911	.	A	G	6	8	14	0	0	14	0	0
16	16233250	.	T	G	4	8	12	0	0	12	0	0
16	16233410	.	A	G	0	8	8	0	1	9	0	0
16	16233447	.	T	C	6	7	13	0	0	13	0	0
16	16233448	.	G	A	6	7	13	0	0	13	0	0
16	16233907	.	A	T	3	5	8	0	0	8	0	0
16	16233937	.	G	T	7	7	14	0	0	14	0	0
16	16233952	.	C	A	0	7	7	0	10	17	0	0
16	16234297	.	C	T	5	2	7	0	1	8	0	0
16	16234309	.	C	A	0	6	6	0	2	8	0	0
16	16234633	.	T	C	5	0	5	0	2	7	0	0
16	16234642	.	C	T	4	2	6	0	0	6	0	0
16	16234693	.	T	C	3	1	4	0	2	6	0	0
16	16234697	.	C	T	5	2	7	0	0	7	0	0
16	16234747	.	T	A	13	5	18	0	0	18	0	0
16	16234948	.	C	T	0	3	3	0	6	9	0	0
16	16235056	.	G	C	7	7	14	0	0	14	0	0
16	16237745	.	G	C	1	3	4	0	0	4	0	0
16	16266593	.	C	T	0	2	2	0	0	2	0	0
16	16267013	.	T	A	1	2	3	0	0	3	0	0
16	16267033	.	C	G	1	2	3	0	0	3	0	0
16	16268205	.	A	T	1	2	3	0	0	3	0	0
16	16268208	.	G	A	0	2	2	0	1	3	0	0
16	16268885	.	G	A	2	2	4	0	0	4	0	0
16	16268899	.	A	T	3	2	5	0	0	5	0	0
16	16269690	.	G	A	0	5	5	0	4	9	0	0
16	16269724	.	G	A	3	8	11	0	0	11	0	0
16	16269926	.	G	C	3	2	5	0	0	5	0	0
16	16269964	.	T	C	1	5	6	0	0	6	0	0
16	16270163	.	C	A	4	2	6	0	1	7	0	0
16	16270424	.	T	C	1	1	2	0	0	2	0	0
16	16275288	.	T	C	2	1	3	0	0	3	0	0
16	16277689	.	A	G	5	4	9	0	0	9	0	0
16	16277810	.	G	A	3	5	8	0	0	8	0	0
16	16277954	.	G	A	1	4	5	0	0	5	0	0
16	16278013	.	A	T	5	4	9	0	0	9	0	0
16	16278043	.	T	C	3	6	9	0	1	10	0	0
16	16278057	.	C	T	7	2	9	0	0	9	0	0
16	16278096	.	A	C	1	5	6	0	1	8	1	0
16	16278172	.	G	T	0	2	2	0	5	7	0	0
16	16281740	.	A	C	5	5	10	0	1	11	0	0
16	16284057	.	T	C	4	13	17	0	0	17	0	0
16	16284159	.	G	A	0	14	14	0	8	22	0	0
16	16284192	.	C	A	10	11	21	0	1	22	0	0
16	16289121	.	C	T	10	5	15	0	0	15	0	0
16	16297057	.	G	A	2	0	2	0	0	2	0	0
16	16302166	.	T	C	5	8	13	0	0	13	0	0
16	16302244	.	A	G	8	0	8	0	12	20	0	0
16	16302247	.	A	T	9	11	20	0	0	20	0	0
16	16302371	.	A	C	4	6	10	0	2	12	0	0
16	16302426	.	T	A	7	12	19	0	2	21	0	0
16	16302477	.	G	A	0	11	11	0	9	20	0	0
16	16302835	.	T	C	8	8	16	0	3	19	0	0
16	16303025	.	C	T	10	23	33	0	1	34	0	0
16	16303065	.	A	G	11	12	23	0	1	24	0	0
16	16303086	.	T	A	8	10	18	0	3	21	0	0
16	16303163	.	G	A	0	13	13	0	11	24	0	0
16	16303196	.	A	G	9	1	10	0	9	19	0	0
16	16303293	.	T	G	6	6	12	0	1	13	0	0
16	16553899	.	C	T	6	3	9	0	0	9	0	0
16	16554693	.	A	T	2	8	10	0	0	10	0	0
16	16554695	.	T	C	1	9	10	0	0	10	0	0
16	16554875	.	A	T	0	2	2	0	0	2	0	0
16	16555484	.	A	C	10	4	14	0	0	14	0	0
16	16555611	.	A	G	6	18	24	0	0	24	0	0
16	16555628	.	A	T	14	9	23	0	0	23	0	0
16	16555975	.	T	A	4	5	9	0	0	9	0	0
16	16556223	.	C	A	4	16	20	0	0	20	0	0
16	16565998	.	C	T	3	3	6	0	1	7	0	0
16	16569578	.	C	G	2	4	6	0	0	6	0	0
16	16586232	.	C	T	9	9	18	0	2	20	0	0
16	16586290	.	G	A	8	10	18	0	1	19	0	0
16	16589462	.	G	A	2	0	2	0	1	3	0	0
16	16589552	.	G	A	1	5	6	0	0	6	0	0
16	16590439	.	C	T	0	8	8	0	5	13	0	0
16	16598043	.	G	A	1	3	4	0	0	4	0	0
16	16598049	.	T	C	1	2	3	0	0	3	0	0
16	16598232	.	C	T	0	2	2	0	2	4	0	0
16	16887296	.	G	A	0	3	3	0	3	6	0	0
16	16887359	.	C	T	2	2	4	0	0	4	0	0
16	16887371	.	T	C	1	2	3	0	0	3	0	0
16	16912252	.	T	G	1	0	1	0	0	1	0	0
16	16913096	.	C	T	3	1	4	0	0	4	0	0
16	16913102	.	G	A	1	3	4	0	0	4	0	0
16	16921088	.	C	T	3	6	9	0	0	9	0	0
16	16921134	.	G	A	5	4	9	0	0	9	0	0
16	16923663	.	G	A	3	1	4	0	0	4	0	0
16	16924638	.	T	C	3	3	6	0	0	6	0	0
16	16928396	.	T	C	2	1	3	0	0	3	0	0
16	16928424	.	A	G	3	3	6	0	0	6	0	0
16	16928437	.	C	T	3	2	5	0	0	5	0	0
16	16932986	.	C	T	1	3	4	0	0	4	0	0
16	16939462	.	C	T	5	2	7	0	0	7	0	0
16	16940824	.	A	C	9	9	18	0	0	18	0	0
16	16941019	.	T	C	3	14	17	0	0	17	0	0
16	16941162	.	T	C	6	8	14	0	0	14	0	0
16	16941270	.	G	A	0	8	8	0	12	20	0	0
16	16941343	.	G	A	8	8	16	0	0	16	0	0
16	16941527	.	A	C	4	3	7	0	0	7	0	0
16	16941533	.	G	T	4	3	7	0	0	7	0	0
16	16941741	.	C	T	8	5	13	0	0	13	0	0
16	16941776	.	A	T	4	3	7	0	1	8	0	0
16	16941979	.	C	A	6	9	15	0	0	15	0	0
16	16942001	.	G	A	1	7	8	0	3	11	0	0
16	16942097	.	C	T	1	2	3	0	0	3	0	0
16	16942293	.	T	A	6	6	12	0	0	12	0	0
16	16942906	.	C	G	4	11	15	0	0	15	0	0
16	16943024	.	C	T	14	8	22	0	0	22	0	0
16	16943111	.	A	G	3	8	11	0	0	11	0	0
16	16943348	.	C	A	11	13	24	0	1	25	0	0
16	16943720	.	G	A	4	11	15	0	0	15	0	0
16	16943930	.	G	T	15	8	23	0	0	23	0	0
16	16944259	.	A	T	8	15	23	0	1	24	0	0
16	16944260	.	C	T	9	15	24	0	0	24	0	0
16	16944348	.	G	A	11	11	22	0	0	22	0	0
16	16944941	.	G	T	7	10	17	0	1	18	0	0
16	16945128	.	T	G	5	10	15	0	0	15	0	0
16	16945261	.	A	G	5	6	11	0	0	11	0	0
16	16945585	.	A	C	6	3	9	0	2	11	0	0
16	16985499	.	C	T	3	3	6	0	3	9	0	0
16	16985511	.	A	T	3	0	3	0	0	3	0	0
16	17062727	.	C	T	3	2	5	0	0	5	0	0
16	17120136	.	C	T	12	8	20	0	1	21	0	0
16	17122132	.	C	A	0	8	8	0	6	14	0	0
16	17137034	.	T	A	4	3	7	0	1	8	0	0
16	17161580	.	T	C	3	0	3	0	7	10	0	0
16	17161739	.	G	A	7	10	17	0	3	20	0	0
16	17161877	.	A	G	13	4	17	0	1	18	0	0
16	17162558	.	G	A	6	4	10	0	1	11	0	0
16	17192957	.	G	A	0	1	1	0	0	1	0	0
16	17193489	.	C	G	1	1	2	0	0	2	0	0
16	17193510	.	G	C	1	1	2	0	0	2	0	0
16	17235251	.	G	A	1	3	4	0	0	4	0	0
16	17238757	.	A	T	1	1	2	0	0	2	0	0
16	17252774	.	G	T	6	7	13	0	0	13	0	0
16	17253023	.	G	A	0	9	9	0	9	18	0	0
16	17253105	.	C	A	6	8	14	0	0	14	0	0
16	17253223	.	A	G	2	6	8	0	1	9	0	0
16	17256113	.	C	T	2	5	7	0	1	8	0	0
16	17256243	.	G	C	0	1	1	0	0	1	0	0
16	17302526	.	T	C	4	4	8	0	0	8	0	0
16	17302821	.	A	G	2	3	5	0	0	5	0	0
16	17305481	.	T	C	4	1	5	0	1	6	0	0
16	17305579	.	G	A	3	3	6	0	1	7	0	0
16	17305597	.	C	T	2	1	3	0	0	3	0	0
16	17305620	.	A	G	1	1	2	0	0	2	0	0
16	17311420	.	A	G	2	2	4	0	1	5	0	0
16	17316782	.	G	A	2	3	5	0	0	5	0	0
16	17442933	.	G	A	0	6	6	0	3	9	0	0
16	17465977	.	T	A	1	6	7	0	0	7	0	0
16	17466463	.	C	G	3	2	5	0	0	5	0	0
16	17466824	.	A	T	5	7	12	0	0	12	0	0
16	17466839	.	T	G	4	7	11	0	0	11	0	0
16	17548995	.	C	A	4	4	8	0	0	8	0	0
16	17549176	.	G	T	2	2	4	0	0	4	0	0
16	17550514	.	A	T	2	2	4	0	0	4	0	0
16	17580036	.	C	T	6	2	8	0	0	8	0	0
16	17585730	.	T	A	2	6	8	0	0	8	0	0
16	17646269	.	T	C	5	4	9	0	0	9	0	0
16	18535689	.	G	A	6	4	10	0	0	10	0	0
16	19100141	.	C	T	2	3	5	0	0	5	0	0
16	19100144	.	T	A	2	3	5	0	0	5	0	0
16	19124404	.	T	C	1	0	1	0	0	1	0	0
16	19124452	.	A	G	1	0	1	0	0	1	0	0
16	19126439	.	A	G	1	0	1	0	3	4	0	0
16	19136123	.	A	G	1	0	1	0	0	1	0	0
16	19136328	.	C	T	1	2	3	0	0	3	0	0
16	19141337	.	T	C	0	2	2	0	0	2	0	0
16	19143714	.	G	T	1	0	1	0	0	1	0	0
16	19150643	.	A	T	1	4	5	0	0	5	0	0
16	19150678	.	C	T	6	6	12	0	0	12	0	0
16	19150973	.	A	G	1	3	4	0	1	5	0	0
16	19151174	.	C	A	7	5	12	0	0	12	0	0
16	19151534	.	T	C	4	8	12	0	1	13	0	0
16	19151656	.	G	T	3	7	10	0	0	10	0	0
16	19538923	.	G	A	2	5	7	0	1	8	0	0
16	19539394	.	T	A	1	1	2	0	0	2	0	0
16	19840562	.	T	C	7	15	22	0	1	23	0	0
16	19840645	.	T	A	10	7	17	0	0	17	0	0
16	19840658	.	A	C	9	5	14	0	0	14	0	0
16	19840792	.	C	T	14	14	28	0	0	28	0	0
16	19841213	.	G	A	13	15	28	0	1	29	0	0
16	19841215	.	C	T	13	15	28	0	1	29	0	0
16	19841443	.	G	C	3	6	9	0	0	9	0	0
16	19841591	.	A	G	9	11	20	0	0	20	0	0
16	19841720	.	A	G	8	4	12	0	1	13	0	0
16	19841786	.	A	T	6	7	13	0	0	13	0	0
16	19841890	.	G	A	2	4	6	0	0	6	0	0
16	19842493	.	G	A	6	7	13	0	2	15	0	0
16	19842530	.	A	G	4	5	9	0	3	12	0	0
16	19843053	.	G	T	12	10	22	0	2	24	0	0
16	19843056	.	G	T	11	12	23	0	0	23	0	0
16	19850746	.	G	A	2	7	9	0	0	9	0	0
16	19853074	.	G	A	2	2	4	0	0	4	0	0
16	19853098	.	C	T	4	8	12	0	2	14	0	0
16	19853125	.	A	T	11	12	23	0	1	24	0	0
16	19853230	.	A	C	7	3	10	0	1	11	0	0
16	19854886	.	C	T	0	2	2	0	2	4	0	0
16	19861463	.	A	G	3	6	9	0	0	9	0	0
16	19864588	.	G	T	5	5	10	0	0	10	0	0
16	19878856	.	G	A	6	6	12	0	0	12	0	0
16	20055989	.	T	C	4	2	6	0	0	6	0	0
16	20126448	.	G	T	0	1	1	0	3	4	0	0
16	20140877	.	T	G	1	3	4	0	1	5	0	0
16	20151309	.	C	T	8	6	14	0	0	14	0	0
16	20151397	.	C	T	10	9	19	0	0	19	0	0
16	20151841	.	T	C	8	4	12	0	1	13	0	0
16	20151991	.	G	A	7	5	12	0	1	13	0	0
16	20152044	.	C	A	7	2	9	0	1	11	1	0
16	20152128	.	G	A	0	8	8	0	6	14	0	0
16	20152474	.	A	G	1	3	4	0	0	4	0	0
16	20164230	.	A	G	0	3	3	0	0	3	0	0
16	20265655	.	T	C	0	3	3	0	3	6	0	0
16	20266321	.	T	C	1	4	5	0	0	5	0	0
16	20266799	.	A	C	9	7	16	0	1	17	0	0
16	20266840	.	T	A	6	9	15	0	1	16	0	0
16	20267424	.	A	T	3	4	7	0	0	7	0	0
16	20267909	.	A	T	5	5	10	0	1	11	0	0
16	20268143	.	T	A	2	2	4	0	0	4	0	0
16	20268145	.	T	A	2	2	4	0	0	4	0	0
16	20268328	.	A	T	3	2	5	0	0	5	0	0
16	20289511	.	T	C	0	2	2	0	0	2	0	0
16	20289537	.	T	C	0	1	1	0	0	1	0	0
16	20292156	.	T	C	4	3	7	0	0	7	0	0
16	20318550	.	G	A	1	1	2	0	0	2	0	0
16	20324870	.	C	T	12	9	21	0	0	21	0	0
16	20324891	.	A	G	6	7	13	0	1	14	0	0
16	20328092	.	C	T	0	4	4	0	3	7	0	0
16	20402034	.	A	C	2	0	2	0	3	5	0	0
16	20492447	.	G	T	4	2	6	0	0	6	0	0
16	20499859	.	G	A	1	1	2	0	0	2	0	0
16	20500142	.	A	G	1	1	2	0	0	2	0	0
16	20512661	.	T	C	7	5	12	0	0	12	0	0
16	20513103	.	T	G	8	0	8	0	8	16	0	0
16	20513152	.	A	G	11	9	20	0	1	21	0	0
16	20800347	.	C	T	6	8	14	0	0	14	0	0
16	20806487	.	C	T	20	23	43	0	1	44	0	0
16	20813628	.	C	T	0	22	22	0	12	34	0	0
16	20822881	.	T	C	3	4	7	0	1	8	0	0
16	20824566	.	C	T	11	12	23	0	3	26	0	0
16	20826697	.	T	C	8	10	18	0	2	20	0	0
16	20826703	.	G	A	10	6	16	0	0	16	0	0
16	20836206	.	C	T	4	8	12	0	0	12	0	0
16	20836218	.	G	A	10	5	15	0	0	15	0	0
16	20855582	.	G	A	9	4	13	0	1	14	0	0
16	20855636	.	C	T	11	16	27	0	2	29	0	0
16	20889325	.	C	T	6	3	9	0	0	9	0	0
16	21038585	.	A	T	3	3	6	0	0	6	0	0
16	21038697	.	A	C	4	3	7	0	1	8	0	0
16	21038801	.	T	A	10	7	17	0	0	17	0	0
16	21038832	.	T	A	13	5	18	0	0	18	0	0
16	21038924	.	G	A	11	8	19	0	0	19	0	0
16	21039939	.	G	C	6	8	14	0	0	14	0	0
16	21398935	.	G	A	1	2	3	0	0	3	0	0
16	21417168	.	C	G	1	1	2	0	0	2	0	0
16	21443326	.	C	A	1	3	4	0	1	5	0	0
16	21444560	.	T	G	1	7	8	0	0	8	0	0
16	21444572	.	T	G	1	5	6	0	0	6	0	0
16	21548398	.	T	C	2	4	6	0	0	6	0	0
16	21548456	.	C	T	6	5	11	0	1	12	0	0
16	21548547	.	G	A	5	3	8	0	0	8	0	0
16	21548556	.	G	A	6	3	9	0	0	9	0	0
16	21548625	.	G	T	3	5	8	0	1	9	0	0
16	21548881	.	T	C	5	2	7	0	0	7	0	0
16	21548891	.	A	T	6	2	8	0	0	8	0	0
16	21549231	.	T	A	1	2	3	0	1	4	0	0
16	21549520	.	C	T	0	11	11	0	6	17	0	0
16	21549539	.	A	C	9	5	14	0	0	14	0	0
16	21549924	.	C	T	3	4	7	0	0	7	0	0
16	21550251	.	C	A	1	3	4	0	0	4	0	0
16	21550255	.	T	A	0	4	4	0	1	5	0	0
16	21550318	.	C	T	3	3	6	0	0	6	0	0
16	21551743	.	C	T	3	3	6	0	0	6	0	0
16	21551749	.	T	G	4	2	6	0	1	7	0	0
16	21551928	.	T	C	1	3	4	0	0	4	0	0
16	21551929	.	C	A	1	3	4	0	0	4	0	0
16	21552026	.	C	T	0	2	2	0	1	3	0	0
16	21552029	.	T	C	1	1	2	0	1	3	0	0
16	21553079	.	C	T	1	2	3	0	2	5	0	0
16	21556301	.	C	T	0	2	2	0	2	4	0	0
16	21556328	.	T	C	1	2	3	0	1	4	0	0
16	21651780	.	T	C	6	0	6	0	8	14	0	0
16	21652059	.	T	A	5	1	6	0	0	6	0	0
16	21655336	.	C	T	1	5	6	0	0	6	0	0
16	21655611	.	G	A	8	5	13	0	0	13	0	0
16	21663023	.	G	A	3	3	6	0	1	7	0	0
16	21665403	.	G	C	4	4	8	0	0	8	0	0
16	21665605	.	G	T	6	3	9	0	1	10	0	0
16	21668063	.	T	C	3	4	7	0	0	7	0	0
16	21673735	.	G	A	3	4	7	0	0	7	0	0
16	21689469	.	C	T	0	1	1	0	0	1	0	0
16	21691065	.	T	G	2	2	4	0	0	4	0	0
16	21734574	.	A	G	0	3	3	0	0	3	0	0
16	21738666	.	A	T	0	1	1	0	1	2	0	0
16	21739233	.	G	A	2	4	6	0	0	6	0	0
16	21763843	.	G	A	12	11	23	0	0	23	0	0
16	21769044	.	G	A	3	1	4	0	1	5	0	0
16	21780023	.	G	A	4	5	9	0	0	9	0	0
16	21782076	.	C	A	3	0	3	0	1	4	0	0
16	21892068	.	G	A	1	2	3	0	0	3	0	0
16	21892173	.	G	A	5	3	8	0	1	9	0	0
16	21892304	.	T	C	12	0	12	0	6	18	0	0
16	21892312	.	C	A	14	5	19	0	0	19	0	0
16	21898159	.	T	A	7	4	11	0	0	11	0	0
16	21898267	.	A	T	2	1	3	0	0	3	0	0
16	21898279	.	C	T	1	2	3	0	0	3	0	0
16	21899211	.	C	T	0	2	2	0	0	2	0	0
16	21899384	.	C	G	0	5	5	0	6	11	0	0
16	21900294	.	A	G	6	6	12	0	0	12	0	0
16	21900333	.	C	A	0	10	10	0	11	21	0	0
16	21901015	.	G	A	3	1	4	0	0	4	0	0
16	21902949	.	G	A	2	0	2	0	0	2	0	0
16	21903803	.	A	G	2	2	4	0	1	5	0	0
16	21903845	.	C	T	3	4	7	0	0	7	0	0
16	21903911	.	C	A	1	6	7	0	2	9	0	0
16	21904091	.	G	A	0	2	2	0	0	2	0	0
16	21905681	.	A	G	0	2	2	0	0	2	0	0
16	21905814	.	G	A	10	5	15	0	0	15	0	0
16	21906282	.	A	C	5	0	5	0	7	12	0	0
16	21908890	.	A	G	1	0	1	0	0	1	0	0
16	21912189	.	A	G	1	4	5	0	1	6	0	0
16	21912963	.	C	A	7	6	13	0	0	13	0	0
16	21912997	.	G	A	12	5	17	0	1	18	0	0
16	21913069	.	T	A	4	3	7	0	0	7	0	0
16	21913091	.	T	A	3	3	6	0	0	6	0	0
16	21913221	.	A	C	2	2	4	0	0	4	0	0
16	21913227	.	G	C	2	1	3	0	0	3	0	0
16	21917148	.	A	C	4	4	8	0	1	9	0	0
16	21937834	.	C	G	2	3	5	0	0	5	0	0
16	22218355	.	C	A	2	3	5	0	0	5	0	0
16	22224698	.	A	G	2	1	3	0	0	3	0	0
16	22224707	.	C	G	2	1	3	0	0	3	0	0
16	22225094	.	C	T	1	1	2	0	0	2	0	0
16	22358841	.	T	A	0	1	1	0	0	1	0	0
16	22358944	.	A	T	1	8	9	0	1	10	0	0
16	22358947	.	T	A	2	8	10	0	0	10	0	0
16	22361101	.	T	C	9	8	17	0	2	19	0	0
16	22363956	.	G	A	12	6	18	0	0	18	0	0
16	22363957	.	G	A	12	6	18	0	0	18	0	0
16	22364064	.	C	T	9	13	22	0	0	22	0	0
16	22364067	.	T	G	9	13	22	0	0	22	0	0
16	22364241	.	A	C	18	15	33	0	0	33	0	0
16	22364501	.	A	C	4	7	11	0	0	11	0	0
16	22365562	.	C	G	3	1	4	0	0	4	0	0
16	22368962	.	T	A	4	9	13	0	1	14	0	0
16	22659905	.	A	G	5	7	12	0	0	12	0	0
16	22673219	.	C	T	5	6	11	0	0	11	0	0
16	22673234	.	C	T	6	7	13	0	0	13	0	0
16	22673528	.	C	G	14	13	27	0	0	27	0	0
16	22673804	.	G	T	9	4	13	0	0	13	0	0
16	22673817	.	G	T	11	6	17	0	0	17	0	0
16	22674181	.	A	C	5	5	10	0	0	10	0	0
16	22674317	.	A	G	8	4	12	0	0	12	0	0
16	22674427	.	C	T	8	3	11	0	0	11	0	0
16	22674490	.	G	A	5	2	7	0	1	8	0	0
16	22674509	.	A	C	7	2	9	0	0	9	0	0
16	22675081	.	T	A	8	8	16	0	0	16	0	0
16	22675110	.	A	T	9	9	18	0	0	18	0	0
16	22675253	.	C	T	3	2	5	0	0	5	0	0
16	22675310	.	T	A	5	3	8	0	1	9	0	0
16	22675367	.	C	A	9	8	17	0	0	17	0	0
16	22675418	.	T	C	5	11	16	0	2	18	0	0
16	22675574	.	T	C	6	6	12	0	1	13	0	0
16	22675663	.	T	C	11	10	21	0	0	21	0	0
16	22675795	.	G	A	0	8	8	0	4	12	0	0
16	22676478	.	G	C	5	8	13	0	0	13	0	0
16	22676527	.	C	T	6	4	10	0	0	10	0	0
16	22676589	.	G	T	9	5	14	0	1	15	0	0
16	22676671	.	T	A	16	6	22	0	1	23	0	0
16	22677037	.	C	A	10	9	19	0	0	19	0	0
16	22677086	.	G	A	10	13	23	0	1	24	0	0
16	22677206	.	C	A	14	12	26	0	2	29	1	0
16	22677276	.	A	G	14	13	27	0	0	27	0	0
16	22750244	.	A	T	10	10	20	0	2	22	0	0
16	22750506	.	A	G	10	15	25	0	2	27	0	0
16	22750566	.	G	A	18	16	34	0	2	36	0	0
16	22750579	.	A	G	18	17	35	0	0	35	0	0
16	22750610	.	A	T	11	17	28	0	0	28	0	0
16	22750693	.	G	A	18	14	32	0	1	33	0	0
16	22750718	.	A	T	16	11	27	0	0	27	0	0
16	22750754	.	G	A	9	10	19	0	1	20	0	0
16	22750781	.	A	G	11	10	21	0	1	22	0	0
16	22750839	.	A	G	8	10	18	0	0	18	0	0
16	22751093	.	C	A	7	13	20	0	0	20	0	0
16	22751101	.	C	T	6	11	17	0	1	18	0	0
16	22751129	.	T	A	5	11	16	0	0	16	0	0
16	22751141	.	T	G	4	6	10	0	0	10	0	0
16	22751167	.	T	A	5	8	13	0	0	13	0	0
16	22751181	.	C	T	6	9	15	0	0	15	0	0
16	22751221	.	G	C	5	6	11	0	1	12	0	0
16	22751376	.	A	C	4	5	9	0	0	9	0	0
16	22751426	.	T	C	4	5	9	0	0	9	0	0
16	22751435	.	A	G	4	2	6	0	0	6	0	0
16	22751490	.	G	A	5	4	9	0	0	9	0	0
16	22751783	.	A	T	13	4	17	0	0	17	0	0
16	22751795	.	C	A	13	3	16	0	1	17	0	0
16	22751926	.	C	T	6	7	13	0	1	14	0	0
16	22752009	.	T	C	4	0	4	0	5	9	0	0
16	22752154	.	G	A	3	16	19	0	0	19	0	0
16	22752182	.	G	T	13	6	19	0	1	20	0	0
16	22752274	.	G	C	8	5	13	0	0	15	2	0
16	22752279	.	T	C	7	6	13	0	0	13	0	0
16	22752328	.	G	A	8	5	13	0	0	13	0	0
16	22752345	.	C	T	7	5	12	0	2	14	0	0
16	22752399	.	G	A	6	3	9	0	1	10	0	0
16	22752531	.	T	C	7	5	12	0	1	13	0	0
16	22752624	.	C	T	3	10	13	0	1	14	0	0
16	22752625	.	G	A	10	3	13	0	1	14	0	0
16	22752779	.	A	G	8	5	13	0	1	14	0	0
16	22752829	.	C	A	6	7	13	0	1	14	0	0
16	22752868	.	C	T	6	4	10	0	0	10	0	0
16	22752954	.	T	C	2	2	4	0	0	4	0	0
16	22753017	.	G	A	4	3	7	0	0	7	0	0
16	22753116	.	C	A	1	3	4	0	4	8	0	0
16	22753185	.	C	T	13	5	18	0	2	20	0	0
16	22753380	.	T	G	15	14	29	0	3	32	0	0
16	22753452	.	G	A	11	10	21	0	2	23	0	0
16	22753574	.	C	T	0	5	5	0	10	15	0	0
16	22753583	.	T	C	8	0	8	0	7	15	0	0
16	22753626	.	C	T	9	11	20	0	1	21	0	0
16	22753631	.	C	T	7	11	18	0	3	21	0	0
16	22753784	.	T	C	6	0	6	0	13	19	0	0
16	22767597	.	A	G	2	6	8	0	1	9	0	0
16	22767732	.	A	G	3	3	6	0	3	9	0	0
16	22767796	.	C	G	0	2	2	0	0	2	0	0
16	22771212	.	T	A	1	2	3	0	0	3	0	0
16	22779311	.	G	A	3	2	5	0	0	5	0	0
16	22779318	.	T	A	3	3	6	0	0	6	0	0
16	22782175	.	G	T	4	3	7	0	0	7	0	0
16	22782306	.	A	T	12	8	20	0	0	20	0	0
16	22782308	.	A	T	12	8	20	0	0	20	0	0
16	22782422	.	C	T	0	12	12	0	17	29	0	0
16	22782443	.	A	T	13	15	28	0	2	30	0	0
16	22782458	.	T	C	12	14	26	0	1	27	0	0
16	22782682	.	T	G	6	4	10	0	2	12	0	0
16	22782904	.	G	C	13	13	26	0	0	26	0	0
16	22783338	.	C	G	0	5	5	0	12	17	0	0
16	22783978	.	A	G	8	4	12	0	3	15	0	0
16	22866015	.	T	C	6	2	8	0	0	8	0	0
16	22866017	.	C	A	6	2	8	0	0	8	0	0
16	22868973	.	T	C	0	2	2	0	0	2	0	0
16	22872011	.	A	G	4	0	4	0	3	7	0	0
16	22872317	.	A	C	3	5	8	0	2	10	0	0
16	22872602	.	G	A	5	3	8	0	0	8	0	0
16	22872657	.	A	C	7	3	10	0	1	11	0	0
16	22872693	.	T	C	3	1	4	0	0	4	0	0
16	22872694	.	C	T	2	1	3	0	1	4	0	0
16	22872927	.	T	C	12	5	17	0	0	17	0	0
16	22878965	.	T	A	4	7	11	0	0	11	0	0
16	22879055	.	G	T	7	2	9	0	0	9	0	0
16	23087656	.	G	A	3	4	7	0	0	7	0	0
16	23087803	.	G	A	1	4	5	0	0	5	0	0
16	23961572	.	C	G	3	0	3	0	5	8	0	0
16	23961950	.	C	A	9	6	15	0	1	16	0	0
16	23962010	.	T	C	13	11	24	0	1	25	0	0
16	23963246	.	C	T	22	17	39	0	2	41	0	0
16	23963315	.	G	T	15	29	44	0	1	45	0	0
16	23973477	.	G	A	15	24	39	0	2	41	0	0
16	24190607	.	T	A	1	2	3	0	0	3	0	0
16	24191564	.	G	A	20	13	33	0	3	36	0	0
16	24213444	.	T	A	20	12	32	0	0	33	1	0
16	24213446	.	T	A	21	11	32	0	1	33	0	0
16	24213538	.	G	T	26	17	43	0	4	47	0	0
16	24213657	.	G	A	17	19	36	0	2	38	0	0
16	24213666	.	T	G	16	20	36	0	3	39	0	0
16	24213793	.	T	C	14	28	42	0	2	44	0	0
16	24214023	.	A	G	28	27	55	0	4	59	0	0
16	24214106	.	T	C	24	0	24	0	20	44	0	0
16	24214468	.	T	C	28	25	53	0	2	55	0	0
16	24261594	.	C	G	6	8	14	0	1	15	0	0
16	24277750	.	C	T	17	9	26	0	2	28	0	0
16	24302164	.	G	A	2	5	7	0	0	7	0	0
16	24552024	.	A	T	0	5	5	0	0	5	0	0
16	24552081	.	C	T	4	5	9	0	3	12	0	0
16	24553018	.	G	T	2	3	5	0	0	5	0	0
16	24553082	.	T	A	2	7	9	0	1	10	0	0
16	24553141	.	T	A	3	2	5	0	0	5	0	0
16	24553225	.	C	G	5	3	8	0	0	8	0	0
16	24553450	.	T	C	5	3	8	0	1	9	0	0
16	24553621	.	C	T	2	4	6	0	0	6	0	0
16	24553633	.	A	G	3	2	5	0	1	6	0	0
16	24553843	.	A	G	1	1	2	0	0	2	0	0
16	24553861	.	T	C	2	2	4	0	0	4	0	0
16	24554475	.	A	G	6	4	10	0	0	10	0	0
16	24590767	.	T	A	12	8	20	0	1	21	0	0
16	24590823	.	C	T	11	10	21	0	3	24	0	0
16	24591172	.	A	G	13	21	34	0	1	35	0	0
16	24591245	.	A	T	9	7	16	0	2	18	0	0
16	24591258	.	A	G	9	10	19	0	0	19	0	0
16	24591287	.	C	T	0	8	8	0	11	19	0	0
16	24591330	.	A	G	12	7	19	0	0	19	0	0
16	24591360	.	G	A	12	8	20	0	0	20	0	0
16	24591410	.	G	A	4	5	9	0	1	10	0	0
16	24591693	.	G	C	25	13	38	0	3	41	0	0
16	24591751	.	C	T	12	14	26	0	1	27	0	0
16	24591794	.	G	T	5	2	7	0	0	7	0	0
16	24632121	.	G	T	6	7	13	0	0	13	0	0
16	24632231	.	C	T	12	8	20	0	1	21	0	0
16	24645448	.	C	G	8	6	14	0	0	14	0	0
16	24645620	.	T	G	6	5	11	0	0	11	0	0
16	24670772	.	C	A	0	2	2	0	1	3	0	0
16	24671344	.	C	T	1	0	1	0	0	1	0	0
16	24695160	.	G	T	11	21	32	0	3	35	0	0
16	24695301	.	T	C	26	30	56	0	0	56	0	0
16	24695322	.	G	T	1	27	28	0	27	55	0	0
16	24695520	.	G	A	36	21	57	0	2	59	0	0
16	24695525	.	A	C	35	18	53	0	5	58	0	0
16	24695681	.	A	T	35	19	54	0	5	60	1	0
16	24730634	.	C	A	0	1	1	0	0	1	0	0
16	24732602	.	A	G	1	0	1	0	0	1	0	0
16	24819515	.	A	T	1	5	6	0	0	6	0	0
16	24820061	.	A	G	2	3	5	0	1	6	0	0
16	24820627	.	T	C	1	0	1	0	2	3	0	0
16	24978275	.	C	G	3	5	8	0	0	8	0	0
16	24989232	.	C	T	1	2	3	0	0	3	0	0
16	24989407	.	G	T	1	2	3	0	0	3	0	0
16	24989410	.	G	A	1	2	3	0	0	3	0	0
16	24990255	.	T	A	1	5	6	0	2	8	0	0
16	24990261	.	A	G	1	4	5	0	2	7	0	0
16	24990672	.	C	T	1	2	3	0	0	3	0	0
16	24990850	.	C	T	2	2	4	0	0	4	0	0
16	24991164	.	G	T	0	6	6	0	5	11	0	0
16	24991225	.	C	G	5	7	12	0	1	13	0	0
16	24991239	.	G	A	0	7	7	0	7	14	0	0
16	24991333	.	T	C	5	6	11	0	0	11	0	0
16	24991593	.	A	T	5	3	8	0	0	8	0	0
16	24991636	.	G	A	1	3	4	0	0	4	0	0
16	24991637	.	C	T	1	3	4	0	0	4	0	0
16	24991741	.	T	C	4	2	6	0	0	6	0	0
16	24991763	.	G	C	1	1	2	0	3	5	0	0
16	24991919	.	T	A	2	3	5	0	0	5	0	0
16	24992017	.	A	C	6	7	13	0	0	13	0	0
16	24992080	.	A	G	2	7	9	0	1	10	0	0
16	24992103	.	T	C	2	3	5	0	0	5	0	0
16	24992580	.	T	G	3	2	5	0	0	5	0	0
16	24992598	.	A	G	2	2	4	0	0	4	0	0
16	25033173	.	G	A	2	4	6	0	1	7	0	0
16	25033191	.	C	T	1	2	3	0	0	3	0	0
16	25033809	.	G	A	4	1	5	0	2	7	0	0
16	25034683	.	A	T	12	6	18	0	1	19	0	0
16	25034715	.	C	T	10	5	15	0	0	15	0	0
16	25036217	.	C	T	6	10	16	0	0	16	0	0
16	25038185	.	A	T	4	7	11	0	2	13	0	0
16	25038429	.	C	T	8	13	21	0	0	21	0	0
16	25038696	.	A	T	1	3	4	0	0	4	0	0
16	25068711	.	C	T	1	6	7	0	0	7	0	0
16	25070393	.	A	C	2	5	7	0	0	7	0	0
16	25071019	.	G	A	9	4	13	0	0	13	0	0
16	25071614	.	C	T	11	4	15	0	1	16	0	0
16	25071782	.	G	A	0	10	10	0	7	17	0	0
16	25072355	.	G	A	3	2	5	0	0	5	0	0
16	25077410	.	G	A	0	6	6	0	3	9	0	0
16	25077608	.	C	T	1	3	4	0	0	4	0	0
16	25078397	.	G	T	6	6	12	0	0	12	0	0
16	25078715	.	A	G	9	4	13	0	0	13	0	0
16	25078907	.	T	A	3	2	5	0	0	5	0	0
16	25080042	.	G	T	2	2	4	0	0	4	0	0
16	25080207	.	C	T	1	2	3	0	1	4	0	0
16	25080236	.	G	T	3	4	7	0	0	7	0	0
16	25080252	.	A	T	3	7	10	0	0	10	0	0
16	25080306	.	T	C	5	5	10	0	0	10	0	0
16	25080367	.	G	A	6	2	8	0	0	8	0	0
16	25104031	.	T	C	16	12	28	0	0	28	0	0
16	25104454	.	C	G	10	20	30	0	2	32	0	0
16	25104543	.	C	T	11	10	21	0	0	21	0	0
16	25104850	.	A	C	6	10	16	0	0	16	0	0
16	25104899	.	T	G	10	9	19	0	0	19	0	0
16	25104941	.	T	C	13	8	21	0	1	22	0	0
16	25111794	.	G	A	2	6	8	0	0	8	0	0
16	25111899	.	G	A	2	6	8	0	0	8	0	0
16	25111920	.	G	A	0	5	5	0	2	7	0	0
16	25112001	.	A	G	4	2	6	0	1	7	0	0
16	25112769	.	C	T	2	3	5	0	0	5	0	0
16	25113741	.	G	A	0	5	5	0	5	10	0	0
16	25119537	.	C	T	3	2	5	0	0	5	0	0
16	25121958	.	C	T	2	6	8	0	0	8	0	0
16	25122240	.	C	T	2	4	6	0	0	6	0	0
16	25122387	.	C	T	3	5	8	0	0	8	0	0
16	25122798	.	C	T	8	3	11	0	1	12	0	0
16	25123382	.	G	T	9	8	17	0	0	17	0	0
16	25123884	.	C	G	1	3	4	0	0	4	0	0
16	25124500	.	G	A	2	5	7	0	0	7	0	0
16	25124662	.	G	T	3	6	9	0	0	9	0	0
16	25142221	.	T	A	1	4	5	0	0	5	0	0
16	25148515	.	C	T	1	2	3	0	0	3	0	0
16	25148565	.	G	A	0	3	3	0	2	5	0	0
16	25148725	.	C	T	1	3	4	0	0	4	0	0
16	25149191	.	G	A	3	2	5	0	0	5	0	0
16	25149228	.	C	T	1	5	6	0	0	6	0	0
16	25149254	.	G	T	0	4	4	0	1	5	0	0
16	25149294	.	T	A	1	4	5	0	0	5	0	0
16	25149654	.	T	C	1	4	5	0	0	5	0	0
16	25149797	.	C	G	3	4	7	0	0	7	0	0
16	25149819	.	T	C	1	2	3	0	0	3	0	0
16	25149939	.	G	A	6	2	8	0	1	9	0	0
16	25150329	.	A	G	2	3	5	0	0	5	0	0
16	25151059	.	G	A	0	3	3	0	1	4	0	0
16	25151079	.	A	G	3	0	3	0	4	7	0	0
16	25151456	.	G	A	1	3	4	0	0	4	0	0
16	25151553	.	T	C	1	5	6	0	0	6	0	0
16	25151573	.	T	C	2	7	9	0	0	9	0	0
16	25154081	.	A	C	1	2	3	0	0	3	0	0
16	25154115	.	C	T	2	3	5	0	0	5	0	0
16	25160985	.	G	A	0	3	3	0	3	6	0	0
16	25161693	.	G	A	7	9	16	0	2	18	0	0
16	25161873	.	G	A	1	7	8	0	7	15	0	0
16	25161876	.	T	C	7	7	14	0	1	15	0	0
16	25164326	.	C	A	2	0	2	0	0	2	0	0
16	25168548	.	G	A	9	13	22	0	1	23	0	0
16	25168765	.	C	A	13	10	23	0	0	23	0	0
16	25169336	.	G	A	8	4	12	0	0	12	0	0
16	25169616	.	A	T	6	3	9	0	1	10	0	0
16	25176780	.	C	A	2	5	7	0	0	7	0	0
16	25180397	.	A	C	4	2	6	0	0	6	0	0
16	25180415	.	C	T	1	3	4	0	0	4	0	0
16	25180737	.	C	T	3	2	5	0	0	5	0	0
16	25180775	.	G	A	2	4	6	0	0	6	0	0
16	25199291	.	G	C	3	3	6	0	0	6	0	0
16	25232203	.	T	C	4	2	6	0	0	6	0	0
16	25232288	.	C	A	0	3	3	0	4	7	0	0
16	25232421	.	T	C	1	3	4	0	1	5	0	0
16	25232433	.	C	T	0	3	3	0	2	5	0	0
16	25268017	.	C	T	2	2	4	0	0	4	0	0
16	25272148	.	G	T	0	2	2	0	2	4	0	0
16	25272149	.	A	G	2	2	4	0	0	4	0	0
16	25272196	.	C	G	3	2	5	0	0	5	0	0
16	25272529	.	A	C	2	2	4	0	0	4	0	0
16	25272603	.	G	T	3	2	5	0	0	5	0	0
16	25275842	.	C	A	2	2	4	0	0	4	0	0
16	25275848	.	T	C	3	2	5	0	1	6	0	0
16	25275909	.	A	C	8	14	22	0	1	23	0	0
16	25275957	.	C	T	15	13	28	0	0	28	0	0
16	25276281	.	G	A	11	13	24	0	3	27	0	0
16	25276387	.	T	A	0	1	1	0	0	1	0	0
16	25285506	.	G	A	16	17	33	0	2	35	0	0
16	25285507	.	G	A	17	17	34	0	1	35	0	0
16	25308516	.	C	T	2	2	4	0	0	4	0	0
16	25311000	.	T	C	1	1	2	0	0	2	0	0
16	25311038	.	A	T	1	1	2	0	0	2	0	0
16	25311772	.	G	A	3	2	5	0	0	5	0	0
16	25314682	.	C	T	0	1	1	0	1	2	0	0
16	25317000	.	G	A	3	7	10	0	0	10	0	0
16	25327155	.	C	A	4	3	7	0	1	8	0	0
16	25327181	.	C	T	4	4	8	0	0	8	0	0
16	25327202	.	G	A	4	3	7	0	0	7	0	0
16	25329319	.	C	T	1	0	1	0	0	1	0	0
16	25333270	.	A	G	9	7	16	0	0	16	0	0
16	25337248	.	C	A	3	8	11	0	1	12	0	0
16	25337286	.	C	T	19	13	32	0	1	33	0	0
16	25337319	.	G	A	24	8	32	0	0	32	0	0
16	25345961	.	A	G	1	3	4	0	0	4	0	0
16	25348767	.	G	A	2	2	4	0	0	4	0	0
16	25348860	.	C	T	1	3	4	0	0	4	0	0
16	25349471	.	C	T	0	1	1	0	0	1	0	0
16	25351283	.	A	T	1	2	3	0	0	3	0	0
16	25354571	.	A	G	1	0	1	0	3	4	0	0
16	25360557	.	T	A	1	1	2	0	0	2	0	0
16	25360762	.	G	A	1	2	3	0	0	3	0	0
16	25364479	.	T	C	4	5	9	0	0	9	0	0
16	25364589	.	T	C	7	8	15	0	0	15	0	0
16	25364742	.	T	C	1	0	1	0	5	6	0	0
16	25365156	.	C	T	1	2	3	0	0	3	0	0
16	25367503	.	G	A	0	1	1	0	0	1	0	0
16	25367902	.	C	T	0	4	4	0	3	7	0	0
16	25367917	.	C	G	2	4	6	0	0	6	0	0
16	25367938	.	G	C	3	0	3	0	5	8	0	0
16	25373979	.	T	A	5	3	8	0	0	8	0	0
16	25374275	.	T	C	6	3	9	0	0	9	0	0
16	25374507	.	T	C	4	0	4	0	11	15	0	0
16	25375019	.	T	C	4	0	4	0	7	11	0	0
16	25376046	.	T	A	2	4	6	0	1	7	0	0
16	25376808	.	T	C	3	2	5	0	0	5	0	0
16	25380786	.	T	G	4	4	8	0	0	8	0	0
16	25389094	.	G	A	6	10	16	0	0	16	0	0
16	25389106	.	C	T	5	10	15	0	0	15	0	0
16	25394879	.	C	A	2	3	5	0	0	5	0	0
16	25394883	.	C	T	2	3	5	0	0	5	0	0
16	25395154	.	G	T	5	5	10	0	1	11	0	0
16	25395702	.	G	T	2	2	4	0	0	4	0	0
16	25399585	.	A	T	3	4	7	0	0	7	0	0
16	25399588	.	A	T	3	4	7	0	1	8	0	0
16	25407426	.	A	T	2	2	4	0	0	4	0	0
16	25445746	.	G	A	3	2	5	0	0	5	0	0
16	25454790	.	C	T	2	3	5	0	0	5	0	0
16	25454829	.	G	T	0	1	1	0	1	2	0	0
16	25463401	.	C	A	3	2	5	0	0	5	0	0
16	25470975	.	A	G	3	2	5	0	0	5	0	0
16	25477428	.	G	A	5	4	9	0	1	10	0	0
16	25477736	.	A	G	2	4	6	0	0	6	0	0
16	25498402	.	T	A	3	4	7	0	0	7	0	0
16	25500137	.	A	G	1	3	4	0	1	5	0	0
16	25504192	.	G	C	10	11	21	0	0	21	0	0
16	25504337	.	G	A	12	9	21	0	0	21	0	0
16	25504466	.	C	T	15	9	24	0	0	24	0	0
16	25504467	.	G	A	9	15	24	0	0	24	0	0
16	25504792	.	G	C	25	19	44	0	1	45	0	0
16	25504900	.	G	A	25	21	46	0	2	48	0	0
16	25507574	.	A	G	2	2	4	0	0	4	0	0
16	25535229	.	C	T	0	8	8	0	8	16	0	0
16	25556650	.	T	A	11	11	22	0	1	23	0	0
16	25556697	.	A	G	13	7	20	0	1	21	0	0
16	25556710	.	C	T	13	9	22	0	0	22	0	0
16	25556766	.	C	G	0	7	7	0	5	12	0	0
16	25556780	.	A	G	7	4	11	0	0	11	0	0
16	25556802	.	C	A	5	3	8	0	1	9	0	0
16	25556930	.	A	G	8	10	18	0	0	18	0	0
16	25556966	.	T	A	13	12	25	0	1	26	0	0
16	25557352	.	C	T	0	5	5	0	2	7	0	0
16	25557400	.	A	G	1	6	7	0	0	7	0	0
16	25557403	.	T	C	1	6	7	0	0	7	0	0
16	25557690	.	C	T	5	4	9	0	0	9	0	0
16	25557806	.	C	T	11	8	19	0	0	19	0	0
16	25558135	.	C	T	8	5	13	0	1	14	0	0
16	25558223	.	A	G	5	10	15	0	0	15	0	0
16	25558351	.	C	T	0	10	10	0	5	15	0	0
16	25558439	.	G	T	9	7	16	0	0	16	0	0
16	25558704	.	T	G	6	4	10	0	0	10	0	0
16	25558829	.	C	T	9	4	13	0	0	13	0	0
16	25558892	.	G	A	7	4	11	0	1	12	0	0
16	25558986	.	A	G	7	4	11	0	1	12	0	0
16	25559028	.	A	C	8	3	11	0	0	11	0	0
16	25559193	.	A	G	3	8	11	0	0	11	0	0
16	25559274	.	C	T	3	4	7	0	1	8	0	0
16	25559495	.	T	A	6	3	9	0	0	9	0	0
16	25559632	.	G	A	3	5	8	0	0	8	0	0
16	25559743	.	A	T	7	5	12	0	0	12	0	0
16	25560135	.	T	C	2	0	2	0	2	4	0	0
16	25560184	.	A	G	5	7	12	0	0	12	0	0
16	25560322	.	G	A	2	4	6	0	0	6	0	0
16	25560586	.	A	G	2	2	4	0	0	4	0	0
16	25561175	.	A	G	3	3	6	0	0	6	0	0
16	25561471	.	C	G	0	3	3	0	2	5	0	0
16	25561795	.	C	A	7	4	11	0	0	11	0	0
16	25562480	.	G	A	7	4	11	0	0	11	0	0
16	25562549	.	G	A	8	4	12	0	0	12	0	0
16	25563428	.	C	T	7	2	9	0	0	9	0	0
16	25597510	.	G	A	5	2	7	0	0	7	0	0
16	25642663	.	G	A	9	12	21	0	0	21	0	0
16	25642673	.	C	T	16	10	26	0	0	26	0	0
16	25643038	.	G	A	8	10	18	0	0	18	0	0
16	25643041	.	G	A	5	10	15	0	3	18	0	0
16	25643113	.	G	C	11	10	21	0	0	21	0	0
16	25643452	.	T	A	6	7	13	0	1	14	0	0
16	25643818	.	G	T	9	7	16	0	0	16	0	0
16	25644357	.	C	A	6	7	13	0	0	13	0	0
16	25644378	.	A	T	7	6	13	0	0	13	0	0
16	25673249	.	T	A	2	11	13	0	0	13	0	0
16	25683018	.	T	C	5	7	12	0	1	13	0	0
16	25683387	.	C	T	0	16	16	0	7	23	0	0
16	25698449	.	A	C	2	4	6	0	0	6	0	0
16	26043044	.	T	A	2	4	6	0	0	6	0	0
16	26141785	.	C	A	0	8	8	0	6	14	0	0
16	26141817	.	T	G	7	12	19	0	0	19	0	0
16	26142105	.	C	T	2	6	8	0	0	8	0	0
16	26142311	.	A	C	6	12	18	0	0	18	0	0
16	26142646	.	A	C	6	4	10	0	0	10	0	0
16	26142652	.	A	G	7	4	11	0	0	11	0	0
16	26142900	.	T	C	4	1	5	0	8	13	0	0
16	26143332	.	T	C	5	7	12	0	0	13	1	0
16	26143371	.	T	G	5	6	11	0	0	11	0	0
16	26143538	.	C	T	4	3	7	0	0	7	0	0
16	26143561	.	C	T	2	3	5	0	0	5	0	0
16	26146174	.	G	A	5	5	10	0	2	12	0	0
16	26146736	.	G	A	2	3	5	0	1	6	0	0
16	26148741	.	C	T	2	3	5	0	0	5	0	0
16	26148962	.	C	A	1	0	1	0	0	1	0	0
16	26148963	.	C	A	1	0	1	0	0	1	0	0
16	26149005	.	A	T	1	0	1	0	0	1	0	0
16	26169515	.	T	G	1	1	2	0	0	2	0	0
16	26186178	.	C	A	0	2	2	0	0	2	0	0
16	26186187	.	G	C	0	0	0	0	2	2	0	0
16	26236259	.	C	T	3	2	5	0	0	5	0	0
16	26378553	.	T	A	2	2	4	0	0	4	0	0
16	26379397	.	G	A	0	2	2	0	1	3	0	0
16	26379437	.	T	C	2	0	2	0	2	4	0	0
16	26380517	.	G	T	1	3	4	0	0	4	0	0
16	26380536	.	A	G	2	5	7	0	1	8	0	0
16	26380784	.	C	T	1	5	6	0	9	15	0	0
16	26380866	.	G	A	5	9	14	0	0	14	0	0
16	26381192	.	T	G	14	5	19	0	1	20	0	0
16	26381271	.	C	T	15	10	25	0	1	26	0	0
16	26381344	.	T	G	2	8	10	0	4	14	0	0
16	26381416	.	C	T	1	23	24	0	11	35	0	0
16	26381463	.	C	T	1	12	13	0	16	29	0	0
16	26381768	.	C	T	0	5	5	0	6	11	0	0
16	26382084	.	T	C	13	11	24	0	1	25	0	0
16	26382225	.	A	T	20	15	35	0	0	35	0	0
16	26382243	.	G	A	17	16	33	0	2	35	0	0
16	26382308	.	T	C	13	11	24	0	3	27	0	0
16	26382453	.	T	C	0	0	0	0	9	9	0	0
16	26382942	.	T	C	13	10	23	0	2	25	0	0
16	26383016	.	C	T	0	15	15	0	21	36	0	0
16	26384188	.	C	G	8	3	11	0	0	11	0	0
16	26384219	.	G	A	5	5	10	0	1	11	0	0
16	26386817	.	T	C	2	1	3	0	0	3	0	0
16	26388840	.	A	G	3	3	6	0	0	6	0	0
16	26391447	.	A	G	2	1	3	0	0	3	0	0
16	26391450	.	C	T	2	1	3	0	0	3	0	0
16	26393459	.	G	T	3	2	5	0	0	5	0	0
16	26393525	.	G	A	0	1	1	0	0	1	0	0
16	26398268	.	C	T	0	2	2	0	0	2	0	0
16	26408819	.	G	A	3	2	5	0	0	5	0	0
16	26439576	.	A	G	2	7	9	0	0	9	0	0
16	26439610	.	A	T	0	6	6	0	0	6	0	0
16	26439617	.	C	A	3	3	6	0	0	6	0	0
16	26439809	.	T	G	2	3	5	0	0	5	0	0
16	26440252	.	G	A	1	0	1	0	0	1	0	0
16	26441526	.	T	A	2	2	4	0	0	4	0	0
16	26441532	.	T	C	2	3	5	0	0	5	0	0
16	26441561	.	G	A	1	2	3	0	0	3	0	0
16	26443498	.	A	T	1	1	2	0	0	2	0	0
16	26443781	.	G	A	1	3	4	0	0	4	0	0
16	26443835	.	C	T	0	3	3	0	0	3	0	0
16	26443958	.	A	T	3	3	6	0	0	6	0	0
16	26443976	.	C	T	4	2	6	0	0	6	0	0
16	26444135	.	T	C	1	4	5	0	0	5	0	0
16	26444431	.	T	A	3	6	9	0	0	9	0	0
16	26444443	.	A	G	5	6	11	0	0	11	0	0
16	26444505	.	C	T	7	8	15	0	1	16	0	0
16	26444668	.	C	T	1	2	3	0	0	3	0	0
16	26444776	.	G	A	2	3	5	0	1	6	0	0
16	26444830	.	G	A	0	7	7	0	2	9	0	0
16	26445209	.	A	T	1	5	6	0	0	6	0	0
16	26445484	.	T	C	1	4	5	0	1	6	0	0
16	26445512	.	A	C	2	4	6	0	1	7	0	0
16	26445547	.	A	G	2	2	4	0	2	6	0	0
16	26483122	.	C	A	1	0	1	0	0	1	0	0
16	26483363	.	T	A	2	2	4	0	0	4	0	0
16	26643598	.	G	C	6	5	11	0	0	11	0	0
16	26688229	.	T	C	1	1	2	0	0	2	0	0
16	26689957	.	G	A	2	3	5	0	0	5	0	0
16	26690971	.	C	A	1	2	3	0	0	3	0	0
16	26691832	.	A	T	1	4	5	0	0	5	0	0
16	26694669	.	C	T	3	4	7	0	0	7	0	0
16	26702648	.	A	C	6	2	8	0	0	8	0	0
16	26702780	.	G	T	0	7	7	0	14	21	0	0
16	26706875	.	C	T	1	0	1	0	0	1	0	0
16	26707494	.	A	G	0	2	2	0	0	2	0	0
16	26710900	.	C	A	15	10	25	0	1	26	0	0
16	26710954	.	A	T	14	10	24	0	0	24	0	0
16	26710957	.	G	A	14	11	25	0	0	25	0	0
16	26713964	.	G	T	12	5	17	0	0	17	0	0
16	26717318	.	C	T	11	8	19	0	1	20	0	0
16	26717457	.	C	A	6	7	13	0	0	13	0	0
16	26766926	.	G	A	4	3	7	0	0	7	0	0
16	26769118	.	C	T	5	2	7	0	0	7	0	0
16	26816799	.	A	G	10	3	13	0	0	13	0	0
16	26816806	.	G	T	9	2	11	0	0	11	0	0
16	26816852	.	G	T	4	6	10	0	2	12	0	0
16	26816885	.	A	G	12	3	15	0	0	15	0	0
16	26816918	.	T	A	10	4	14	0	0	14	0	0
16	26817046	.	T	G	5	7	12	0	0	12	0	0
16	26817069	.	C	T	0	5	5	0	4	9	0	0
16	26817178	.	T	A	5	13	18	0	1	19	0	0
16	26817358	.	C	T	8	5	13	0	0	13	0	0
16	26817631	.	C	T	0	9	9	0	2	11	0	0
16	26817754	.	C	T	0	8	8	0	4	12	0	0
16	26818658	.	C	T	2	5	7	0	0	7	0	0
16	26846525	.	G	A	1	1	2	0	0	2	0	0
16	26846547	.	T	G	1	2	3	0	0	3	0	0
16	26850885	.	C	T	8	10	18	0	1	19	0	0
16	26851025	.	C	G	2	3	5	0	0	5	0	0
16	26851036	.	T	A	2	3	5	0	0	5	0	0
16	26851110	.	A	C	0	3	3	0	0	3	0	0
16	26851236	.	C	T	0	4	4	0	2	6	0	0
16	26855729	.	C	A	17	7	24	0	0	24	0	0
16	26855786	.	G	A	14	9	23	0	0	24	1	0
16	26855833	.	C	A	0	8	8	0	7	15	0	0
16	26855859	.	C	A	0	9	9	0	10	19	0	0
16	27064864	.	A	G	2	4	6	0	0	6	0	0
16	27069608	.	A	G	1	0	1	0	1	2	0	0
16	27072488	.	G	A	0	9	9	0	8	17	0	0
16	27089100	.	T	G	4	8	12	0	0	12	0	0
16	27098305	.	T	C	6	10	16	0	0	16	0	0
16	27098530	.	A	G	8	8	16	0	1	17	0	0
16	27098549	.	A	T	10	8	18	0	0	18	0	0
16	27099121	.	A	T	3	6	9	0	0	9	0	0
16	27099508	.	G	A	3	7	10	0	1	11	0	0
16	27100042	.	T	G	3	4	7	0	0	7	0	0
16	27100133	.	A	C	8	9	17	0	2	19	0	0
16	27100139	.	A	T	9	11	20	0	1	21	0	0
16	27100198	.	T	A	19	9	28	0	0	28	0	0
16	27100222	.	T	C	12	14	26	0	3	29	0	0
16	27126647	.	C	T	0	10	10	0	9	19	0	0
16	27126998	.	A	G	3	8	11	0	1	12	0	0
16	27126999	.	T	A	3	9	12	0	0	12	0	0
16	27127157	.	G	C	10	13	23	0	1	24	0	0
16	27127158	.	C	A	10	14	24	0	0	24	0	0
16	27127576	.	T	C	11	14	25	0	0	25	0	0
16	27127959	.	G	A	3	9	12	0	0	12	0	0
16	27131005	.	C	T	0	5	5	0	3	8	0	0
16	27136541	.	A	G	2	7	9	0	0	9	0	0
16	27138207	.	C	G	0	2	2	0	0	2	0	0
16	27138391	.	C	G	0	2	2	0	1	3	0	0
16	27148691	.	C	T	5	7	12	0	2	14	0	0
16	27158741	.	A	T	5	3	8	0	0	8	0	0
16	27159124	.	G	C	0	0	0	0	5	5	0	0
16	27161089	.	G	A	5	4	9	0	0	9	0	0
16	27169529	.	G	A	14	15	29	0	1	30	0	0
16	27169586	.	G	A	8	9	17	0	1	18	0	0
16	27169664	.	A	T	4	8	12	0	1	13	0	0
16	27169809	.	G	A	3	8	11	0	0	11	0	0
16	27170206	.	A	G	2	0	2	0	0	2	0	0
16	27217103	.	G	C	1	2	3	0	0	3	0	0
16	27224450	.	G	C	9	0	9	0	0	9	0	0
16	27225215	.	C	A	2	7	9	0	1	10	0	0
16	27231337	.	T	A	15	12	27	0	1	28	0	0
16	27231416	.	C	T	17	30	47	0	4	51	0	0
16	27345418	.	C	T	1	0	1	0	0	1	0	0
16	27345748	.	C	T	2	3	5	0	1	6	0	0
16	27356127	.	G	A	3	3	6	0	1	7	0	0
16	27368175	.	G	A	8	11	19	0	1	20	0	0
16	27368290	.	G	A	0	12	12	0	14	26	0	0
16	27368315	.	G	A	0	13	13	0	13	26	0	0
16	27368577	.	A	G	4	7	11	0	1	12	0	0
16	27368688	.	A	C	10	14	24	0	2	26	0	0
16	27368756	.	A	G	9	3	12	0	1	13	0	0
16	27368823	.	T	G	7	12	19	0	0	19	0	0
16	27368863	.	C	T	6	17	23	0	1	24	0	0
16	27417415	.	C	A	5	2	7	0	0	7	0	0
16	27417573	.	T	C	8	8	16	0	1	17	0	0
16	27417659	.	T	G	7	15	22	0	3	25	0	0
16	27417925	.	A	T	20	10	30	0	1	31	0	0
16	27427064	.	A	G	3	7	10	0	0	10	0	0
16	27427760	.	G	A	1	1	2	0	1	3	0	0
16	27428048	.	G	A	1	3	4	0	0	4	0	0
16	27502151	.	G	C	1	0	1	0	0	1	0	0
16	27508505	.	G	A	7	2	9	0	0	9	0	0
16	27513694	.	T	C	3	4	7	0	0	7	0	0
16	27529856	.	G	A	4	4	8	0	0	8	0	0
16	27536796	.	C	A	0	1	1	0	2	3	0	0
16	27554909	.	C	G	12	6	18	0	1	19	0	0
16	27555010	.	T	C	10	10	20	0	1	21	0	0
16	27555011	.	A	C	11	10	21	0	0	21	0	0
16	27555069	.	C	T	12	9	21	0	2	23	0	0
16	27555221	.	C	T	3	1	4	0	0	4	0	0
16	27555395	.	G	A	7	3	10	0	0	10	0	0
16	27558765	.	C	A	2	2	4	0	2	6	0	0
16	27578538	.	C	A	1	1	2	0	0	2	0	0
16	27621786	.	A	T	11	3	14	0	0	14	0	0
16	27622109	.	G	A	0	6	6	0	0	6	0	0
16	27626240	.	A	G	13	6	19	0	0	19	0	0
16	27626566	.	G	T	17	30	47	0	2	49	0	0
16	27627051	.	T	C	1	1	2	0	0	2	0	0
16	27629038	.	C	T	0	23	23	0	15	38	0	0
16	27629343	.	A	G	8	8	16	0	2	18	0	0
16	27629365	.	G	T	17	16	33	0	0	33	0	0
16	27629639	.	C	A	24	21	45	0	2	47	0	0
16	27629798	.	A	T	17	15	32	0	3	35	0	0
16	27630174	.	A	T	17	22	39	0	0	39	0	0
16	27630207	.	C	T	14	15	29	0	1	30	0	0
16	27630302	.	A	T	22	14	36	0	0	36	0	0
16	27630552	.	G	A	16	13	29	0	0	29	0	0
16	27630663	.	G	A	13	13	26	0	2	28	0	0
16	27631229	.	A	T	13	6	19	0	0	20	1	0
16	27631585	.	T	A	8	12	20	0	1	21	0	0
16	27631690	.	T	G	7	12	19	0	0	19	0	0
16	27631695	.	T	C	12	6	18	0	0	18	0	0
16	27631741	.	C	A	7	9	16	0	0	16	0	0
16	27631751	.	T	A	4	11	15	0	1	16	0	0
16	27632153	.	C	T	7	5	12	0	2	14	0	0
16	27632189	.	G	A	7	7	14	0	1	15	0	0
16	27632228	.	C	T	7	13	20	0	1	21	0	0
16	27632814	.	G	A	7	7	14	0	1	15	0	0
16	27632934	.	T	C	4	2	6	0	0	6	0	0
16	27633002	.	G	A	5	5	10	0	0	10	0	0
16	27633180	.	C	T	1	7	8	0	11	19	0	0
16	27633812	.	C	T	12	7	19	0	0	19	0	0
16	27633839	.	T	C	7	0	7	0	7	14	0	0
16	27633950	.	G	T	7	5	12	0	0	12	0	0
16	27669917	.	T	G	3	3	6	0	0	6	0	0
16	27670010	.	A	T	2	4	6	0	0	6	0	0
16	27670032	.	T	C	3	3	6	0	1	7	0	0
16	27675763	.	C	T	1	3	4	0	1	5	0	0
16	27675950	.	G	A	2	3	5	0	0	5	0	0
16	27676008	.	G	A	1	3	4	0	0	4	0	0
16	27735451	.	A	G	2	2	4	0	0	4	0	0
16	27736007	.	T	A	1	2	3	0	0	3	0	0
16	28112706	.	A	T	3	3	6	0	0	6	0	0
16	28112772	.	G	A	2	5	7	0	1	8	0	0
16	28113049	.	G	A	6	6	12	0	0	12	0	0
16	28256800	.	G	T	4	2	6	0	0	6	0	0
16	28263526	.	G	A	5	2	7	0	0	7	0	0
16	28264350	.	C	T	3	6	9	0	0	9	0	0
16	28268273	.	C	A	4	3	7	0	0	7	0	0
16	28270067	.	G	T	0	3	3	0	5	8	0	0
16	28270118	.	C	T	5	6	11	0	1	12	0	0
16	28270443	.	T	C	5	3	8	0	0	8	0	0
16	28270561	.	C	T	2	4	6	0	0	6	0	0
16	28276389	.	C	T	6	8	14	0	0	14	0	0
16	28278360	.	T	C	0	1	1	0	0	1	0	0
16	28280057	.	T	C	0	1	1	0	0	1	0	0
16	28370872	.	T	A	2	3	5	0	1	6	0	0
16	28370943	.	A	T	2	5	7	0	2	9	0	0
16	28511709	.	C	T	2	2	4	0	0	4	0	0
16	28573328	.	G	C	0	2	2	0	3	5	0	0
16	28573665	.	C	A	4	6	10	0	0	10	0	0
16	28573871	.	A	C	6	4	10	0	2	12	0	0
16	28573928	.	C	T	4	2	6	0	0	6	0	0
16	28573957	.	T	A	2	4	6	0	0	6	0	0
16	28574403	.	C	T	2	3	5	0	1	6	0	0
16	28574531	.	T	G	7	8	15	0	0	15	0	0
16	28574664	.	G	A	3	5	8	0	0	8	0	0
16	28591186	.	T	A	9	10	19	0	1	20	0	0
16	28591277	.	A	G	8	18	26	0	1	27	0	0
16	28591312	.	G	A	0	12	12	0	18	30	0	0
16	28591353	.	A	C	10	12	22	0	3	25	0	0
16	28591385	.	C	G	9	9	18	0	1	19	0	0
16	28591498	.	G	T	15	5	20	0	2	22	0	0
16	28592758	.	A	T	1	3	4	0	1	5	0	0
16	28593394	.	G	A	2	3	5	0	0	5	0	0
16	28593430	.	G	A	2	4	6	0	0	6	0	0
16	28593679	.	T	C	3	0	3	0	2	5	0	0
16	28593705	.	C	T	1	4	5	0	0	5	0	0
16	28594102	.	G	T	1	5	6	0	0	6	0	0
16	28607658	.	T	C	1	1	2	0	0	2	0	0
16	28622321	.	G	A	0	2	2	0	1	3	0	0
16	28624580	.	T	C	1	1	2	0	0	2	0	0
16	28624646	.	C	T	3	3	6	0	0	6	0	0
16	28624648	.	G	C	1	3	4	0	2	6	0	0
16	28626282	.	G	A	4	6	10	0	1	11	0	0
16	28626997	.	C	T	3	2	5	0	0	5	0	0
16	28627005	.	C	T	1	2	3	0	1	4	0	0
16	28627127	.	C	T	4	4	8	0	0	8	0	0
16	28627198	.	T	A	4	2	6	0	0	6	0	0
16	28627341	.	T	G	6	5	11	0	0	11	0	0
16	28627342	.	T	A	6	4	10	0	0	11	1	0
16	28627467	.	C	T	1	4	5	0	0	5	0	0
16	28627507	.	G	A	2	3	5	0	0	5	0	0
16	28629299	.	C	T	0	6	6	0	4	10	0	0
16	28629504	.	C	T	1	3	4	0	0	4	0	0
16	28664970	.	T	G	2	4	6	0	0	6	0	0
16	28671302	.	C	T	0	1	1	0	0	1	0	0
16	28674282	.	G	A	2	3	5	0	1	6	0	0
16	28678327	.	T	C	0	0	0	0	1	1	0	0
16	28842438	.	C	T	23	15	38	0	0	38	0	0
16	28856026	.	G	A	13	17	30	0	1	31	0	0
16	28983644	.	G	A	1	0	1	0	0	1	0	0
16	28990523	.	C	G	2	4	6	0	0	6	0	0
16	28991213	.	C	T	2	3	5	0	0	5	0	0
16	28991214	.	C	T	2	3	5	0	0	5	0	0
16	28995628	.	A	T	2	0	2	0	0	2	0	0
16	29009092	.	G	T	1	2	3	0	0	3	0	0
16	29010155	.	T	A	0	2	2	0	0	2	0	0
16	29012933	.	G	T	0	4	4	0	9	13	0	0
16	29012961	.	C	T	11	4	15	0	0	15	0	0
16	29012992	.	A	G	5	0	5	0	3	8	0	0
16	29013039	.	C	G	5	2	7	0	0	7	0	0
16	29013126	.	C	T	5	3	8	0	1	9	0	0
16	29013134	.	C	A	5	3	8	0	0	8	0	0
16	29013188	.	C	T	5	2	7	0	0	7	0	0
16	29013327	.	C	A	5	4	9	0	0	9	0	0
16	29013377	.	C	T	3	6	9	0	1	10	0	0
16	29014091	.	A	T	4	5	9	0	2	11	0	0
16	29014109	.	T	C	5	3	8	0	0	8	0	0
16	29016659	.	C	T	3	8	11	0	1	12	0	0
16	29016904	.	T	C	2	4	6	0	0	6	0	0
16	29017221	.	T	C	6	2	8	0	0	8	0	0
16	29019039	.	G	A	13	7	20	0	1	21	0	0
16	29020482	.	G	T	5	2	7	0	0	7	0	0
16	29022955	.	C	A	8	5	13	0	0	13	0	0
16	29023266	.	A	T	3	3	6	0	1	7	0	0
16	29024181	.	A	G	2	0	2	0	0	2	0	0
16	29024280	.	T	G	4	0	4	0	4	8	0	0
16	29024341	.	T	C	3	2	5	0	1	6	0	0
16	29024405	.	C	T	1	4	5	0	1	6	0	0
16	29024409	.	C	T	2	3	5	0	0	5	0	0
16	29024512	.	A	T	4	8	12	0	1	13	0	0
16	29024551	.	A	T	4	7	11	0	1	12	0	0
16	29024552	.	T	G	5	7	12	0	0	12	0	0
16	29025304	.	C	T	0	2	2	0	0	2	0	0
16	29030198	.	A	G	2	0	2	0	2	4	0	0
16	29030199	.	A	G	1	3	4	0	0	4	0	0
16	29051102	.	G	A	0	3	3	0	0	3	0	0
16	29052030	.	C	T	1	5	6	0	0	6	0	0
16	29052096	.	G	T	0	4	4	0	2	6	0	0
16	29052120	.	A	G	2	3	5	0	0	5	0	0
16	29052137	.	A	G	2	2	4	0	0	4	0	0
16	29052752	.	C	G	1	0	1	0	2	3	0	0
16	29052914	.	G	A	2	5	7	0	0	7	0	0
16	29053045	.	T	A	3	3	6	0	1	7	0	0
16	29053527	.	A	G	4	2	6	0	0	6	0	0
16	29053798	.	C	G	0	0	0	0	14	14	0	0
16	29073068	.	G	A	7	6	13	0	1	14	0	0
16	29073621	.	T	A	10	4	14	0	1	15	0	0
16	29074254	.	G	A	22	19	41	0	2	43	0	0
16	29075137	.	C	T	9	13	22	0	1	23	0	0
16	29075195	.	A	G	8	18	26	0	1	27	0	0
16	29075222	.	T	A	15	9	24	0	0	24	0	0
16	29075305	.	G	A	12	3	15	0	0	15	0	0
16	29075343	.	G	A	7	12	19	0	0	19	0	0
16	29075347	.	C	G	12	8	20	0	0	20	0	0
16	29075674	.	C	A	18	10	28	0	1	29	0	0
16	29075870	.	G	T	9	17	26	0	0	26	0	0
16	29075959	.	C	T	11	6	17	0	2	19	0	0
16	29075962	.	C	T	8	10	18	0	1	19	0	0
16	29076270	.	G	T	26	16	42	0	4	46	0	0
16	29076407	.	C	T	0	15	15	0	19	34	0	0
16	29076471	.	G	A	16	14	30	0	0	30	0	0
16	29076575	.	C	G	0	15	15	0	15	30	0	0
16	29076633	.	G	A	17	8	25	0	1	26	0	0
16	29076669	.	A	G	5	3	8	0	1	9	0	0
16	29076678	.	T	C	3	0	3	0	1	4	0	0
16	29111066	.	T	C	8	0	8	0	14	22	0	0
16	29225873	.	C	G	6	14	20	0	1	21	0	0
16	29226129	.	A	T	2	7	9	0	0	9	0	0
16	29226241	.	A	T	1	3	4	0	0	4	0	0
16	29226538	.	G	T	1	6	7	0	0	7	0	0
16	29226588	.	A	T	2	4	6	0	1	7	0	0
16	29266014	.	G	T	5	3	8	0	0	8	0	0
16	29266162	.	T	C	3	2	5	0	0	5	0	0
16	29266332	.	G	C	1	3	4	0	0	4	0	0
16	29310150	.	T	A	3	5	8	0	0	8	0	0
16	29310206	.	A	G	11	5	16	0	2	18	0	0
16	29310213	.	C	A	15	4	19	0	1	20	0	0
16	29310455	.	C	T	9	11	20	0	0	20	0	0
16	29310530	.	C	A	11	12	23	0	1	24	0	0
16	29310541	.	A	G	13	9	22	0	0	22	0	0
16	29310760	.	C	A	13	8	21	0	1	22	0	0
16	29310893	.	G	A	7	6	13	0	2	15	0	0
16	29310917	.	G	T	9	3	12	0	2	14	0	0
16	29311381	.	G	A	12	7	19	0	1	20	0	0
16	29311493	.	A	G	17	7	24	0	0	24	0	0
16	29311720	.	T	C	2	0	2	0	0	2	0	0
16	29314147	.	C	A	2	2	4	0	0	4	0	0
16	29320647	.	A	G	2	3	5	0	1	6	0	0
16	29320674	.	T	G	4	7	11	0	0	11	0	0
16	29320870	.	T	C	7	0	7	0	9	16	0	0
16	29321013	.	G	A	9	7	16	0	0	16	0	0
16	29321269	.	C	T	8	6	14	0	0	14	0	0
16	29321310	.	C	T	10	4	14	0	0	14	0	0
16	29323307	.	T	C	7	3	10	0	0	10	0	0
16	29323394	.	T	C	4	3	7	0	0	7	0	0
16	29323864	.	C	T	0	3	3	0	2	5	0	0
16	29330481	.	G	A	3	1	4	0	0	4	0	0
16	29370972	.	A	G	2	3	5	0	1	6	0	0
16	29371029	.	C	T	1	5	6	0	0	6	0	0
16	29371084	.	T	A	2	2	4	0	1	5	0	0
16	29371164	.	A	G	1	3	4	0	0	4	0	0
16	29371187	.	T	C	2	3	5	0	0	5	0	0
16	29374075	.	A	C	3	3	6	0	0	6	0	0
16	29380992	.	G	A	3	6	9	0	0	9	0	0
16	29381204	.	G	T	4	4	8	0	0	8	0	0
16	29381369	.	G	A	1	1	2	0	0	2	0	0
16	29381391	.	T	C	1	0	1	0	0	1	0	0
16	29384090	.	T	C	1	2	3	0	0	3	0	0
16	29384099	.	T	A	1	2	3	0	0	3	0	0
16	29384139	.	G	A	0	4	4	0	0	4	0	0
16	29384425	.	A	T	2	2	4	0	0	4	0	0
16	29384431	.	C	T	2	2	4	0	0	4	0	0
16	29407754	.	C	T	2	3	5	0	2	7	0	0
16	29407791	.	C	A	15	4	19	0	0	19	0	0
16	29408024	.	A	C	24	8	32	0	0	32	0	0
16	29408926	.	A	T	22	18	40	0	1	41	0	0
16	29408948	.	T	A	16	21	37	0	2	39	0	0
16	29409134	.	A	G	5	9	14	0	0	14	0	0
16	29409181	.	T	A	4	5	9	0	0	9	0	0
16	29409476	.	T	C	28	14	42	0	2	44	0	0
16	29409480	.	T	C	28	14	42	0	0	42	0	0
16	29409646	.	T	G	17	20	37	0	1	38	0	0
16	29410425	.	A	G	27	24	51	0	2	53	0	0
16	29410520	.	A	G	14	19	33	0	1	34	0	0
16	29411209	.	G	A	9	43	52	0	1	53	0	0
16	29411830	.	T	G	1	2	3	0	1	4	0	0
16	29413193	.	C	T	1	16	17	0	20	37	0	0
16	29414004	.	A	C	6	9	15	0	2	17	0	0
16	29420803	.	T	C	4	3	7	0	1	8	0	0
16	29421026	.	C	T	4	6	10	0	0	10	0	0
16	29424985	.	T	A	7	6	13	0	1	14	0	0
16	29425278	.	G	A	3	5	8	0	0	8	0	0
16	29427615	.	T	A	4	2	6	0	0	6	0	0
16	29456052	.	A	G	6	7	13	0	1	14	0	0
16	29456131	.	T	A	5	3	8	0	0	8	0	0
16	29456165	.	G	T	1	3	4	0	0	4	0	0
16	29456630	.	A	C	1	0	1	0	2	3	0	0
16	29456966	.	G	A	3	12	15	0	0	15	0	0
16	29456996	.	A	G	5	6	11	0	0	11	0	0
16	29457158	.	A	G	5	4	9	0	0	9	0	0
16	29457473	.	T	A	6	9	15	0	0	15	0	0
16	29457819	.	C	T	0	2	2	0	5	7	0	0
16	29458226	.	C	G	5	5	10	0	1	11	0	0
16	29458388	.	T	C	2	0	2	0	3	5	0	0
16	29502302	.	A	C	1	2	3	0	0	3	0	0
16	29526432	.	C	T	2	2	4	0	1	5	0	0
16	29586680	.	A	G	3	8	11	0	2	13	0	0
16	29644223	.	C	T	6	4	10	0	2	12	0	0
16	29686355	.	G	C	8	4	12	0	0	12	0	0
16	29686370	.	G	T	7	5	12	0	0	12	0	0
16	29691131	.	C	T	1	1	2	0	1	3	0	0
16	29695845	.	T	C	1	2	3	0	0	3	0	0
16	29695989	.	G	T	1	3	4	0	0	4	0	0
16	29696018	.	A	G	1	3	4	0	0	4	0	0
16	30036158	.	G	T	1	0	1	0	0	1	0	0
16	30036561	.	A	T	3	3	6	0	0	6	0	0
16	30202951	.	T	C	4	2	6	0	0	6	0	0
16	30205225	.	T	C	2	4	6	0	0	6	0	0
16	30266844	.	G	A	5	8	13	0	0	13	0	0
16	30267228	.	A	G	11	0	11	0	14	25	0	0
16	30267841	.	T	C	5	4	9	0	2	11	0	0
16	30268242	.	T	C	9	4	13	0	1	14	0	0
16	30268290	.	G	A	12	7	19	0	1	20	0	0
16	30268475	.	A	C	7	3	10	0	2	12	0	0
16	30269159	.	A	C	7	5	12	0	0	12	0	0
16	30270332	.	G	T	0	4	4	0	7	11	0	0
16	30270381	.	T	G	6	3	9	0	0	9	0	0
16	30270601	.	C	T	23	16	39	0	0	39	0	0
16	30323168	.	T	G	1	2	3	0	0	3	0	0
16	30408725	.	A	T	2	3	5	0	0	5	0	0
16	30408917	.	A	G	17	24	41	0	0	41	0	0
16	30409055	.	A	T	24	28	52	0	0	52	0	0
16	30409313	.	A	T	9	15	24	0	2	26	0	0
16	30415027	.	C	T	18	16	34	0	4	38	0	0
16	30417511	.	A	G	1	3	4	0	0	4	0	0
16	30417977	.	A	G	7	7	14	0	0	14	0	0
16	30417986	.	A	G	6	4	10	0	1	11	0	0
16	30419504	.	A	G	4	7	11	0	0	11	0	0
16	30422582	.	C	G	9	14	23	0	0	23	0	0
16	30422807	.	T	C	14	0	14	0	6	20	0	0
16	30422891	.	G	A	12	4	16	0	0	16	0	0
16	30423297	.	A	C	1	2	3	0	0	3	0	0
16	30423313	.	C	T	1	2	3	0	0	3	0	0
16	30423680	.	G	C	1	6	7	0	0	7	0	0
16	30423953	.	G	A	12	12	24	0	2	26	0	0
16	30425795	.	G	A	6	0	6	0	0	6	0	0
16	30426496	.	T	A	3	5	8	0	0	8	0	0
16	30429159	.	A	G	5	2	7	0	0	7	0	0
16	30432287	.	A	G	1	0	1	0	0	1	0	0
16	30434127	.	A	G	2	4	6	0	0	6	0	0
16	30434156	.	C	T	2	2	4	0	0	4	0	0
16	30515689	.	A	T	1	1	2	0	0	2	0	0
16	30521704	.	A	T	4	4	8	0	0	8	0	0
16	30522108	.	T	A	1	4	5	0	1	6	0	0
16	30522109	.	T	G	2	4	6	0	0	6	0	0
16	30522176	.	G	C	3	9	12	0	0	12	0	0
16	30522317	.	G	C	3	5	8	0	1	9	0	0
16	30522334	.	C	T	2	4	6	0	0	6	0	0
16	30522391	.	T	C	2	4	6	0	0	7	1	0
16	30522688	.	A	T	1	2	3	0	0	3	0	0
16	30522724	.	T	C	1	3	4	0	0	4	0	0
16	30522809	.	C	T	2	4	6	0	0	6	0	0
16	30522815	.	T	C	5	2	7	0	0	7	0	0
16	30522862	.	T	C	4	0	4	0	4	8	0	0
16	30522923	.	C	T	0	7	7	0	5	12	0	0
16	30522959	.	C	T	4	4	8	0	1	9	0	0
16	30523253	.	C	G	3	3	6	0	1	7	0	0
16	30525458	.	A	G	2	10	12	0	0	12	0	0
16	30525499	.	A	G	2	6	8	0	0	8	0	0
16	30530401	.	C	T	3	2	5	0	1	6	0	0
16	30531304	.	C	T	0	3	3	0	0	3	0	0
16	30562816	.	T	G	1	4	5	0	0	5	0	0
16	30562862	.	G	A	1	4	5	0	0	5	0	0
16	30737594	.	A	G	11	7	18	0	1	19	0	0
16	30737638	.	C	T	17	15	32	0	0	32	0	0
16	30737770	.	A	G	15	17	32	0	1	33	0	0
16	30738108	.	C	T	0	3	3	0	1	4	0	0
16	30740719	.	T	G	5	8	13	0	0	13	0	0
16	30760879	.	A	C	2	0	2	0	1	3	0	0
16	30772417	.	C	T	0	1	1	0	2	3	0	0
16	30785451	.	T	C	3	2	5	0	0	5	0	0
16	30788182	.	A	G	1	1	2	0	1	3	0	0
16	30794822	.	T	G	1	1	2	0	0	2	0	0
16	30808411	.	T	C	3	1	4	0	1	5	0	0
16	30808429	.	C	T	0	0	0	0	1	1	0	0
16	30826525	.	A	G	3	2	5	0	0	5	0	0
16	30826614	.	A	C	6	7	13	0	0	13	0	0
16	30869597	.	C	G	0	0	0	0	1	1	0	0
16	30869623	.	A	T	2	4	6	0	0	6	0	0
16	30908825	.	A	C	4	2	6	0	0	6	0	0
16	30909201	.	A	G	1	2	3	0	0	3	0	0
16	30910272	.	A	G	1	2	3	0	0	3	0	0
16	30914543	.	C	G	1	0	1	0	0	1	0	0
16	30918951	.	A	T	5	4	9	0	1	10	0	0
16	30919193	.	C	T	0	2	2	0	3	5	0	0
16	30919222	.	C	T	4	2	6	0	1	7	0	0
16	30927301	.	C	A	1	2	3	0	0	3	0	0
16	30927311	.	G	A	1	1	2	0	0	2	0	0
16	30948634	.	T	G	1	4	5	0	0	5	0	0
16	30948644	.	A	T	1	2	3	0	0	3	0	0
16	30980453	.	C	T	1	0	1	0	0	1	0	0
16	30984581	.	G	A	1	0	1	0	0	1	0	0
16	31186631	.	A	T	14	13	27	0	2	29	0	0
16	31187097	.	C	T	0	5	5	0	5	10	0	0
16	31187322	.	A	G	15	12	27	0	0	27	0	0
16	31188481	.	G	A	5	4	9	0	0	9	0	0
16	31188654	.	G	A	1	5	6	0	0	6	0	0
16	31260754	.	G	A	2	6	8	0	0	8	0	0
16	31261003	.	A	T	3	4	7	0	1	8	0	0
16	31261344	.	C	T	5	9	14	0	1	15	0	0
16	31267559	.	C	T	0	0	0	0	2	2	0	0
16	31268860	.	G	C	2	0	2	0	1	3	0	0
16	31268893	.	C	A	7	3	10	0	0	10	0	0
16	31272424	.	C	G	2	3	5	0	0	5	0	0
16	31274289	.	T	A	4	4	8	0	1	9	0	0
16	31274491	.	G	A	4	3	7	0	0	7	0	0
16	31280355	.	G	A	2	2	4	0	0	4	0	0
16	31306646	.	A	G	1	0	1	0	1	2	0	0
16	31314157	.	G	A	0	1	1	0	0	1	0	0
16	31342344	.	C	T	1	0	1	0	0	1	0	0
16	31428861	.	C	G	2	2	4	0	0	4	0	0
16	31434978	.	T	G	1	2	3	0	0	3	0	0
16	31436504	.	A	T	1	3	4	0	0	4	0	0
16	31437115	.	A	G	12	4	16	0	0	16	0	0
16	31437955	.	A	G	21	20	41	0	0	41	0	0
16	31444428	.	G	A	5	5	10	0	0	10	0	0
16	31445516	.	T	C	5	3	8	0	0	8	0	0
16	31454548	.	A	G	4	3	7	0	0	7	0	0
16	31454928	.	T	A	2	2	4	0	0	4	0	0
16	31455092	.	T	C	0	3	3	0	0	3	0	0
16	31455301	.	T	C	0	1	1	0	2	3	0	0
16	31516536	.	T	C	1	0	1	0	0	1	0	0
16	31516778	.	A	G	3	3	6	0	1	7	0	0
16	31602170	.	A	G	1	2	3	0	0	3	0	0
16	31608012	.	A	G	2	3	5	0	0	5	0	0
16	31608101	.	C	T	0	4	4	0	5	9	0	0
16	31608967	.	G	T	2	3	5	0	0	5	0	0
16	31609241	.	C	T	0	1	1	0	0	1	0	0
16	31610375	.	C	T	0	2	2	0	0	2	0	0
16	31613619	.	A	G	2	5	7	0	0	7	0	0
16	31614272	.	C	G	3	3	6	0	0	6	0	0
16	31614918	.	G	A	2	4	6	0	1	7	0	0
16	31615114	.	G	A	2	4	6	0	1	7	0	0
16	31728192	.	A	G	1	2	3	0	0	3	0	0
16	31728258	.	A	G	1	3	4	0	0	4	0	0
16	31728261	.	T	A	1	3	4	0	0	4	0	0
16	31762960	.	C	T	17	12	29	0	0	29	0	0
16	31763316	.	T	C	17	9	26	0	0	26	0	0
16	31763318	.	C	T	17	9	26	0	0	26	0	0
16	31763668	.	C	G	10	13	23	0	2	25	0	0
16	31763743	.	T	A	23	14	37	0	1	38	0	0
16	31763751	.	A	C	22	15	37	0	0	37	0	0
16	31763785	.	G	A	18	16	34	0	3	37	0	0
16	31763786	.	C	A	19	16	35	0	2	37	0	0
16	31763880	.	A	G	21	13	34	0	1	35	0	0
16	31764987	.	C	T	1	2	3	0	0	3	0	0
16	31766937	.	T	A	3	0	3	0	0	3	0	0
16	31767116	.	T	C	6	0	6	0	9	15	0	0
16	31767152	.	A	G	6	4	10	0	0	10	0	0
16	31767163	.	G	A	4	3	7	0	0	7	0	0
16	31768343	.	C	G	8	14	22	0	0	22	0	0
16	31768394	.	T	C	6	11	17	0	0	17	0	0
16	31768436	.	T	C	11	11	22	0	1	23	0	0
16	31769317	.	G	A	4	5	9	0	1	10	0	0
16	31769395	.	A	G	5	12	17	0	0	17	0	0
16	31769428	.	G	A	3	2	5	0	0	5	0	0
16	31770050	.	T	C	8	0	8	0	6	14	0	0
16	31776125	.	C	T	0	2	2	0	0	2	0	0
16	31780108	.	C	T	0	3	3	0	3	6	0	0
16	31789327	.	C	T	3	2	5	0	0	5	0	0
16	31815638	.	C	T	12	9	21	0	1	22	0	0
16	31815878	.	G	A	10	10	20	0	0	20	0	0
16	31816005	.	C	A	12	4	16	0	0	16	0	0
16	31816205	.	C	T	11	3	14	0	1	15	0	0
16	31816336	.	C	T	0	4	4	0	5	9	0	0
16	31816596	.	C	T	8	11	19	0	1	20	0	0
16	31827642	.	T	A	20	9	29	0	1	30	0	0
16	31827703	.	C	T	11	22	33	0	2	35	0	0
16	31832606	.	A	G	17	0	17	0	19	36	0	0
16	31853932	.	T	A	0	1	1	0	0	1	0	0
16	31854325	.	C	A	2	0	2	0	0	2	0	0
16	31855271	.	T	C	4	4	8	0	0	8	0	0
16	31855327	.	G	A	3	3	6	0	0	6	0	0
16	31855351	.	G	C	3	5	8	0	0	8	0	0
16	31855575	.	C	T	7	12	19	0	0	19	0	0
16	31855576	.	C	T	7	12	19	0	0	19	0	0
16	31855814	.	T	G	7	0	7	0	8	15	0	0
16	31856239	.	A	G	3	4	7	0	0	7	0	0
16	31856276	.	G	A	1	4	5	0	4	9	0	0
16	31859065	.	A	G	2	0	2	0	13	15	0	0
16	31859227	.	T	C	17	23	40	0	2	42	0	0
16	31859341	.	C	T	19	19	38	0	4	42	0	0
16	31859371	.	T	C	17	18	35	0	1	36	0	0
16	31859416	.	T	C	8	26	34	0	4	38	0	0
16	31859686	.	G	A	4	10	14	0	0	14	0	0
16	31868443	.	G	A	8	18	26	0	0	26	0	0
16	31922892	.	A	G	2	5	7	0	1	8	0	0
16	31923083	.	G	A	14	33	47	0	1	48	0	0
16	31923435	.	A	G	31	21	52	0	1	53	0	0
16	31924485	.	T	C	25	15	40	0	0	40	0	0
16	31924501	.	A	C	24	17	41	0	1	42	0	0
16	31946857	.	T	C	1	1	2	0	0	2	0	0
16	31952252	.	G	C	1	3	4	0	0	4	0	0
16	31955226	.	C	G	1	2	3	0	0	3	0	0
16	31958957	.	G	T	0	1	1	0	0	1	0	0
16	31959156	.	G	A	6	2	8	0	0	8	0	0
16	31959476	.	G	A	2	2	4	0	1	5	0	0
16	31959496	.	A	G	2	0	2	0	4	6	0	0
16	31959612	.	G	A	2	2	4	0	0	4	0	0
16	31959845	.	A	G	4	0	4	0	6	10	0	0
16	31960037	.	G	A	0	5	5	0	1	6	0	0
16	31960064	.	G	C	2	7	9	0	0	9	0	0
16	31960145	.	C	T	7	6	13	0	1	14	0	0
16	31960152	.	C	T	6	6	12	0	2	14	0	0
16	32011649	.	C	T	3	7	10	0	0	10	0	0
16	32011673	.	A	G	1	3	4	0	0	4	0	0
16	32013272	.	G	A	1	2	3	0	0	3	0	0
16	32013766	.	T	G	2	3	5	0	0	5	0	0
16	32019695	.	G	A	1	0	1	0	0	1	0	0
16	32021999	.	C	T	6	1	7	0	0	7	0	0
16	32023124	.	T	A	3	4	7	0	0	7	0	0
16	32025648	.	T	A	5	14	19	0	1	20	0	0
16	32025978	.	G	A	3	10	13	0	0	13	0	0
16	32025987	.	T	A	4	11	15	0	1	16	0	0
16	32026063	.	G	A	0	5	5	0	11	16	0	0
16	32026105	.	T	A	9	6	15	0	0	15	0	0
16	32026154	.	T	G	4	3	7	0	0	7	0	0
16	32051854	.	A	C	7	5	12	0	0	12	0	0
16	32052004	.	T	G	3	4	7	0	0	7	0	0
16	32052283	.	T	A	1	1	2	0	0	2	0	0
16	32052307	.	T	C	3	3	6	0	0	6	0	0
16	32052328	.	T	A	5	8	13	0	0	13	0	0
16	32052404	.	G	T	0	4	4	0	5	9	0	0
16	32055726	.	T	G	13	12	25	0	2	27	0	0
16	32057809	.	T	C	12	6	18	0	0	18	0	0
16	32057853	.	G	A	0	7	7	0	5	12	0	0
16	32060021	.	G	A	0	6	6	0	6	12	0	0
16	32060121	.	G	T	5	5	10	0	0	10	0	0
16	32060130	.	C	A	4	4	8	0	1	9	0	0
16	32063433	.	C	T	5	6	11	0	0	11	0	0
16	32068332	.	G	A	8	6	14	0	0	14	0	0
16	32068452	.	C	A	4	6	10	0	0	10	0	0
16	32068503	.	T	C	7	8	15	0	1	16	0	0
16	32068824	.	G	C	4	2	6	0	0	6	0	0
16	32069310	.	T	A	9	10	19	0	4	23	0	0
16	32069653	.	A	G	10	10	20	0	1	21	0	0
16	32070489	.	A	G	5	0	5	0	8	14	1	0
16	32070570	.	C	T	12	8	20	0	0	20	0	0
16	32070981	.	G	C	13	8	21	0	1	22	0	0
16	32071965	.	G	C	3	12	15	0	0	15	0	0
16	32071997	.	C	A	2	8	10	0	1	11	0	0
16	32072334	.	A	G	13	7	20	0	0	20	0	0
16	32073301	.	A	C	16	21	37	0	0	37	0	0
16	32073507	.	A	C	20	19	39	0	1	40	0	0
16	32073555	.	A	G	24	20	44	0	1	45	0	0
16	32073760	.	G	A	22	16	38	0	0	38	0	0
16	32074041	.	G	A	13	15	28	0	2	30	0	0
16	32074257	.	A	G	28	0	28	0	17	45	0	0
16	32074293	.	T	A	25	16	41	0	0	41	0	0
16	32074294	.	A	G	25	14	39	0	2	41	0	0
16	32080069	.	G	T	0	6	6	0	9	15	0	0
16	32080099	.	G	A	3	4	7	0	1	8	0	0
16	32080196	.	T	C	2	2	4	0	2	6	0	0
16	32080206	.	T	C	3	3	6	0	0	6	0	0
16	32080306	.	T	A	9	7	16	0	1	17	0	0
16	32080508	.	T	A	11	17	28	0	0	28	0	0
16	32080738	.	G	A	6	4	10	0	1	11	0	0
16	32082397	.	T	C	3	3	6	0	0	6	0	0
16	32082589	.	G	A	3	4	7	0	1	8	0	0
16	32082597	.	G	A	4	4	8	0	0	8	0	0
16	32082642	.	G	A	3	3	6	0	3	9	0	0
16	32085319	.	T	A	1	1	2	0	0	2	0	0
16	32085631	.	A	G	1	0	1	0	0	1	0	0
16	32085778	.	A	C	1	2	3	0	0	3	0	0
16	32086136	.	C	T	4	7	11	0	0	11	0	0
16	32090349	.	C	T	13	4	17	0	1	18	0	0
16	32090425	.	G	C	6	7	13	0	0	13	0	0
16	32110659	.	A	G	13	10	23	0	0	23	0	0
16	32111246	.	G	T	11	15	26	0	2	28	0	0
16	32113155	.	G	A	8	6	14	0	0	14	0	0
16	32113218	.	G	A	7	3	10	0	0	10	0	0
16	32116790	.	A	T	3	2	5	0	0	5	0	0
16	32117345	.	T	A	1	7	8	0	6	14	0	0
16	32119581	.	C	A	5	4	9	0	0	9	0	0
16	32119618	.	C	T	5	3	8	0	0	8	0	0
16	32119895	.	G	T	5	7	12	0	1	13	0	0
16	32120138	.	G	T	7	6	13	0	1	14	0	0
16	32120141	.	T	C	8	0	8	0	6	14	0	0
16	32120173	.	G	A	8	6	14	0	0	14	0	0
16	32120204	.	G	T	5	9	14	0	3	17	0	0
16	32120279	.	A	C	7	6	13	0	0	13	0	0
16	32128259	.	T	A	1	2	3	0	0	3	0	0
16	32140638	.	G	C	3	2	5	0	0	5	0	0
16	32140767	.	G	A	1	2	3	0	0	3	0	0
16	32140977	.	C	T	3	3	6	0	0	6	0	0
16	32140999	.	A	G	2	3	5	0	0	5	0	0
16	32141544	.	A	G	8	0	8	0	11	19	0	0
16	32141565	.	A	C	5	8	13	0	0	14	1	0
16	32141604	.	A	T	2	4	6	0	0	6	0	0
16	32144337	.	T	C	4	7	11	0	3	14	0	0
16	32144377	.	T	C	6	10	16	0	0	16	0	0
16	32144854	.	G	T	0	7	7	0	3	10	0	0
16	32144989	.	T	C	2	3	5	0	0	5	0	0
16	32145160	.	T	A	3	5	8	0	0	8	0	0
16	32145391	.	G	A	2	3	5	0	0	5	0	0
16	32145636	.	A	G	8	12	20	0	0	20	0	0
16	32145885	.	A	G	3	2	5	0	0	5	0	0
16	32197612	.	G	A	0	7	7	0	0	7	0	0
16	32241591	.	C	T	1	1	2	0	0	2	0	0
16	32257179	.	T	A	1	1	2	0	0	2	0	0
16	32267128	.	G	A	3	3	6	0	0	6	0	0
16	32267203	.	G	A	0	4	4	0	8	12	0	0
16	32273066	.	G	T	1	2	3	0	0	3	0	0
16	32273192	.	G	A	0	2	2	0	5	7	0	0
16	32274935	.	G	A	2	2	4	0	0	4	0	0
16	32275628	.	A	T	3	8	11	0	1	12	0	0
16	33735481	.	G	A	4	3	7	0	1	8	0	0
16	33735849	.	A	T	1	2	3	0	0	3	0	0
16	33736068	.	A	G	1	3	4	0	0	4	0	0
16	33806174	.	C	A	1	3	4	0	0	4	0	0
16	33902151	.	C	T	2	2	4	0	0	4	0	0
16	33910305	.	G	A	0	1	1	0	0	1	0	0
16	33919623	.	G	A	0	1	1	0	0	1	0	0
16	33923421	.	G	T	1	2	3	0	0	3	0	0
16	33923448	.	G	T	2	4	6	0	0	6	0	0
16	33923514	.	G	A	6	8	14	0	0	14	0	0
16	33925356	.	G	A	0	4	4	0	7	11	0	0
16	33928015	.	G	A	0	1	1	0	1	2	0	0
16	33933213	.	C	T	0	1	1	0	0	1	0	0
16	33933496	.	G	C	5	4	9	0	0	9	0	0
16	33933498	.	C	T	4	5	9	0	0	9	0	0
16	33933732	.	G	A	0	2	2	0	5	7	0	0
16	33939824	.	T	C	3	3	6	0	0	6	0	0
16	33939859	.	C	T	6	6	12	0	0	12	0	0
16	33940098	.	G	A	1	5	6	0	0	6	0	0
16	33940122	.	G	A	2	3	5	0	0	5	0	0
16	33940364	.	A	G	4	0	4	0	2	6	0	0
16	33940379	.	T	A	4	5	9	0	0	9	0	0
16	33953968	.	C	T	7	4	11	0	1	12	0	0
16	33964788	.	G	T	1	1	2	0	0	2	0	0
16	33971993	.	G	A	0	3	3	0	6	9	0	0
16	33972008	.	G	A	7	6	13	0	1	14	0	0
16	33972037	.	A	C	6	5	11	0	1	12	0	0
16	33972067	.	A	G	6	6	12	0	1	13	0	0
16	33972193	.	G	A	0	5	5	0	5	10	0	0
16	33972242	.	G	T	6	5	11	0	0	11	0	0
16	33972249	.	C	T	5	5	10	0	0	10	0	0
16	33972454	.	C	T	5	3	8	0	0	8	0	0
16	33978019	.	A	G	3	0	3	0	4	7	0	0
16	33981439	.	C	T	2	1	3	0	0	3	0	0
16	33981873	.	A	G	11	0	11	0	6	17	0	0
16	33983784	.	T	G	6	4	10	0	0	10	0	0
16	33983904	.	C	T	6	8	14	0	2	16	0	0
16	33984178	.	C	T	7	3	10	0	0	10	0	0
16	33984190	.	C	T	8	3	11	0	0	11	0	0
16	33985050	.	G	T	0	17	17	0	10	27	0	0
16	33985362	.	C	T	11	13	24	0	0	24	0	0
16	33986179	.	A	T	6	3	9	0	5	14	0	0
16	33986452	.	T	G	22	16	38	0	0	38	0	0
16	33987972	.	A	G	1	2	3	0	0	3	0	0
16	33987974	.	C	T	1	2	3	0	0	3	0	0
16	33989391	.	A	G	3	0	3	0	2	5	0	0
16	33989606	.	G	T	0	3	3	0	2	5	0	0
16	33989933	.	G	A	0	3	3	0	1	4	0	0
16	33994640	.	G	A	0	4	4	0	3	7	0	0
16	33996739	.	C	T	1	2	3	0	0	3	0	0
16	34004562	.	G	A	0	4	4	0	3	7	0	0
16	34004595	.	T	C	6	9	15	0	1	16	0	0
16	34004862	.	C	T	5	7	12	0	0	12	0	0
16	34005290	.	C	T	3	3	6	0	0	6	0	0
16	34005415	.	C	T	4	4	8	0	0	8	0	0
16	34005500	.	C	A	4	2	6	0	0	6	0	0
16	34005577	.	A	G	4	2	6	0	2	8	0	0
16	34005669	.	C	T	8	7	15	0	0	15	0	0
16	34005686	.	C	T	7	7	14	0	2	16	0	0
16	34005812	.	T	A	9	4	13	0	1	14	0	0
16	34005981	.	A	G	4	2	6	0	1	7	0	0
16	34006020	.	G	C	1	4	5	0	0	5	0	0
16	34006108	.	A	G	0	4	4	0	0	4	0	0
16	34046775	.	A	G	1	2	3	0	0	3	0	0
16	34054345	.	A	G	1	0	1	0	3	4	0	0
16	34054464	.	C	A	2	5	7	0	0	7	0	0
16	34054712	.	T	G	2	0	2	0	7	9	0	0
16	34054778	.	G	A	5	2	7	0	0	7	0	0
16	34054786	.	T	G	5	2	7	0	0	7	0	0
16	34054837	.	A	C	1	3	4	0	0	4	0	0
16	34055599	.	T	A	3	2	5	0	0	5	0	0
16	34055747	.	A	T	2	2	4	0	0	4	0	0
16	34055754	.	C	T	3	2	5	0	0	5	0	0
16	34056324	.	T	G	4	2	6	0	0	6	0	0
16	34172916	.	G	A	3	3	6	0	0	6	0	0
16	34173000	.	T	C	5	3	8	0	1	9	0	0
16	34173624	.	G	A	1	3	4	0	0	4	0	0
16	34173821	.	G	A	1	2	3	0	0	3	0	0
16	34173954	.	G	T	2	2	4	0	0	4	0	0
16	34185709	.	A	C	4	3	7	0	0	7	0	0
16	34185906	.	A	T	7	3	10	0	0	10	0	0
16	34200704	.	C	T	4	1	5	0	0	5	0	0
16	34201023	.	A	G	3	8	11	0	0	11	0	0
16	34208582	.	T	C	27	0	27	0	13	40	0	0
16	34208696	.	A	G	26	13	39	0	1	40	0	0
16	34212477	.	A	G	16	9	25	0	0	25	0	0
16	34212516	.	A	G	16	9	25	0	0	25	0	0
16	34212565	.	G	A	8	19	27	0	3	30	0	0
16	34212567	.	G	C	9	20	29	0	1	30	0	0
16	34212630	.	T	C	19	3	22	0	19	41	0	0
16	34212676	.	G	C	14	1	15	0	12	27	0	0
16	34222439	.	T	G	13	16	29	0	1	30	0	0
16	34225173	.	T	C	2	0	2	0	0	2	0	0
16	34225392	.	A	G	13	11	24	0	2	26	0	0
16	34225472	.	G	A	13	16	29	0	0	29	0	0
16	34267938	.	C	T	0	4	4	0	3	7	0	0
16	34267991	.	G	C	4	4	8	0	0	8	0	0
16	34304263	.	T	C	1	4	5	0	0	5	0	0
16	34321568	.	A	T	4	4	8	0	1	9	0	0
16	34322036	.	G	T	5	6	11	0	0	11	0	0
16	34322346	.	G	A	20	13	33	0	0	33	0	0
16	34322372	.	C	T	0	15	15	0	14	29	0	0
16	34331489	.	A	G	1	1	2	0	3	5	0	0
16	34337976	.	A	T	9	8	17	0	0	17	0	0
16	34338475	.	A	G	5	13	18	0	1	19	0	0
16	34339168	.	A	C	9	10	19	0	1	20	0	0
16	34339432	.	A	T	10	9	19	0	7	26	0	0
16	34339693	.	C	T	13	4	17	0	0	17	0	0
16	34339808	.	A	G	3	7	10	0	1	11	0	0
16	34339857	.	T	G	5	6	11	0	1	12	0	0
16	34340179	.	A	T	5	6	11	0	2	13	0	0
16	34340311	.	T	C	9	0	9	0	6	15	0	0
16	34340397	.	A	C	5	4	9	0	0	9	0	0
16	34340520	.	G	T	7	3	10	0	2	12	0	0
16	34340538	.	C	T	6	3	9	0	1	10	0	0
16	34340965	.	C	T	1	5	6	0	2	8	0	0
16	34340967	.	A	G	2	6	8	0	0	8	0	0
16	34341012	.	C	T	3	5	8	0	0	8	0	0
16	34341021	.	C	T	3	4	7	0	0	7	0	0
16	34341080	.	T	C	1	2	3	0	0	3	0	0
16	34342541	.	C	T	3	2	5	0	0	5	0	0
16	34342542	.	A	G	3	2	5	0	0	5	0	0
16	34461347	.	A	T	1	3	4	0	0	4	0	0
16	34499892	.	A	C	3	3	6	0	0	6	0	0
16	34499940	.	A	G	8	6	14	0	0	14	0	0
16	34500283	.	A	G	1	2	3	0	0	3	0	0
16	34500542	.	G	C	7	11	18	0	1	19	0	0
16	34500582	.	G	A	1	5	6	0	0	6	0	0
16	34500683	.	A	G	3	2	5	0	0	5	0	0
16	34500899	.	G	A	12	12	24	0	0	24	0	0
16	34501292	.	A	G	5	3	8	0	5	13	0	0
16	34501348	.	C	T	11	5	16	0	0	16	0	0
16	34501380	.	C	T	5	10	15	0	2	17	0	0
16	34501496	.	G	A	0	3	3	0	6	9	0	0
16	34525621	.	C	A	21	20	41	0	1	42	0	0
16	34526092	.	C	G	26	36	62	0	0	62	0	0
16	34526093	.	A	C	16	35	51	0	11	62	0	0
16	34526795	.	A	T	28	40	68	0	0	68	0	0
16	34526926	.	A	T	22	25	47	0	20	67	0	0
16	34532040	.	C	T	4	3	7	0	1	9	1	0
16	34532205	.	G	A	0	6	6	0	13	19	0	0
16	34532782	.	C	G	6	5	11	0	0	11	0	0
16	34930635	.	A	G	4	1	5	0	1	6	0	0
16	34930719	.	C	T	0	7	7	0	10	17	0	0
16	34948262	.	C	T	3	7	10	0	1	11	0	0
16	34953166	.	C	T	4	5	9	0	1	10	0	0
16	34975908	.	A	G	1	1	2	0	0	2	0	0
16	34989800	.	C	T	0	0	0	0	1	1	0	0
16	34993814	.	T	C	3	0	3	0	2	5	0	0
16	35022679	.	G	A	6	4	10	0	1	11	0	0
16	35023920	.	C	T	2	1	3	0	0	3	0	0
16	35023934	.	T	C	1	1	2	0	1	3	0	0
16	35043863	.	C	T	1	2	3	0	3	6	0	0
16	35053907	.	C	G	3	3	6	0	0	6	0	0
16	35366055	.	T	C	1	2	3	0	0	3	0	0
16	35376825	.	C	T	2	3	5	0	0	5	0	0
16	35409483	.	C	T	0	14	14	0	22	36	0	0
16	35409783	.	G	A	5	2	7	0	1	8	0	0
16	35414455	.	A	G	6	2	8	0	0	8	0	0
16	35414470	.	T	C	2	2	4	0	0	4	0	0
16	35414991	.	C	T	11	10	21	0	0	21	0	0
16	35416113	.	A	G	11	5	16	0	2	18	0	0
16	35416158	.	C	T	1	2	3	0	0	3	0	0
16	35416786	.	A	G	6	5	11	0	0	11	0	0
16	35418744	.	T	C	1	0	1	0	2	3	0	0
16	35420600	.	T	C	3	0	3	0	3	7	1	0
16	35423585	.	C	T	0	11	11	0	8	19	0	0
16	35426998	.	T	C	9	0	9	0	7	16	0	0
16	35536574	.	C	A	8	9	17	0	0	17	0	0
16	35536576	.	G	A	0	9	9	0	8	17	0	0
16	35536848	.	G	A	5	7	12	0	0	12	0	0
16	35536900	.	A	G	5	3	8	0	0	8	0	0
16	35536960	.	T	C	16	9	25	0	0	25	0	0
16	35536990	.	C	T	10	16	26	0	2	28	0	0
16	35537153	.	G	A	13	4	17	0	3	20	0	0
16	35537270	.	C	A	16	8	24	0	2	26	0	0
16	35556303	.	C	T	5	2	7	0	0	7	0	0
16	35556365	.	A	G	3	3	6	0	0	6	0	0
16	35662078	.	T	G	2	1	3	0	0	3	0	0
16	35662132	.	A	C	0	1	1	0	0	1	0	0
16	35743849	.	A	T	2	2	4	0	0	4	0	0
16	35750714	.	T	A	6	13	19	0	3	22	0	0
16	35752670	.	C	T	19	7	26	0	2	28	0	0
16	35752785	.	T	C	17	10	27	0	3	30	0	0
16	35773005	.	A	G	3	8	11	0	2	13	0	0
16	36075471	.	G	A	6	9	15	0	0	15	0	0
16	36075478	.	T	A	6	10	16	0	1	17	0	0
16	36075677	.	C	A	9	9	18	0	1	19	0	0
16	36075999	.	A	G	3	5	8	0	0	8	0	0
16	36076082	.	G	A	5	8	13	0	0	13	0	0
16	36080364	.	C	T	13	13	26	0	0	26	0	0
16	36080376	.	A	C	11	10	21	0	3	24	0	0
16	36087550	.	A	C	1	0	1	0	2	3	0	0
16	36118070	.	T	C	2	0	2	0	5	7	0	0
16	36118166	.	T	C	7	1	8	0	4	12	0	0
16	36150674	.	A	G	8	2	10	0	0	10	0	0
16	36150707	.	C	T	13	8	21	0	1	22	0	0
16	36150949	.	C	T	10	14	24	0	2	26	0	0
16	36150964	.	C	T	8	13	21	0	1	22	0	0
16	36151000	.	C	A	3	4	7	0	0	7	0	0
16	36159928	.	T	C	17	15	32	0	3	35	0	0
16	36162013	.	C	T	10	15	25	0	1	26	0	0
16	36162201	.	A	G	11	5	16	0	0	16	0	0
16	36162584	.	G	C	0	6	6	0	17	23	0	0
16	36162650	.	T	C	12	13	25	0	1	26	0	0
16	36162727	.	A	G	9	10	19	0	2	21	0	0
16	36162754	.	A	G	9	16	25	0	1	26	0	0
16	36163005	.	G	A	7	3	10	0	1	11	0	0
16	36163006	.	A	C	7	4	11	0	0	11	0	0
16	36168251	.	C	T	6	4	10	0	1	11	0	0
16	36168317	.	G	C	5	3	8	0	1	9	0	0
16	36168416	.	T	C	4	3	7	0	2	9	0	0
16	36168510	.	A	T	4	6	10	0	0	10	0	0
16	36168575	.	T	G	5	3	8	0	1	9	0	0
16	36168787	.	T	A	3	3	6	0	0	6	0	0
16	36169057	.	T	G	3	3	6	0	0	6	0	0
16	36169098	.	T	C	8	3	11	0	0	11	0	0
16	36169150	.	T	C	4	4	8	0	0	8	0	0
16	36169568	.	G	T	7	3	10	0	1	11	0	0
16	36169868	.	A	C	5	0	5	0	1	6	0	0
16	36171552	.	A	G	1	0	1	0	0	1	0	0
16	36172961	.	A	G	1	1	2	0	0	2	0	0
16	36172982	.	C	T	1	2	3	0	0	3	0	0
16	36173406	.	A	T	4	6	10	0	0	10	0	0
16	36180810	.	T	A	1	3	4	0	0	4	0	0
16	36185315	.	G	A	1	1	2	0	0	2	0	0
16	36196411	.	T	C	3	2	5	0	0	5	0	0
16	36721560	.	A	T	2	5	7	0	0	7	0	0
16	36721589	.	T	G	3	5	8	0	0	8	0	0
16	36724010	.	C	G	1	3	4	0	3	7	0	0
16	36729322	.	A	T	3	3	6	0	1	7	0	0
16	36729352	.	G	T	3	6	9	0	3	13	1	0
16	36729373	.	A	G	10	8	18	0	0	18	0	0
16	36731307	.	A	G	8	6	14	0	0	14	0	0
16	36743328	.	G	A	4	5	9	0	0	9	0	0
16	36743351	.	G	A	3	3	6	0	0	6	0	0
16	36743757	.	T	C	3	2	5	0	0	5	0	0
16	36743787	.	A	G	3	2	5	0	0	5	0	0
16	36745973	.	C	T	0	0	0	0	1	1	0	0
16	36746103	.	C	T	3	1	4	0	0	4	0	0
16	36746466	.	G	A	3	2	5	0	0	5	0	0
16	36746484	.	A	G	4	3	7	0	0	7	0	0
16	36748366	.	T	C	4	0	4	0	6	10	0	0
16	36752254	.	A	G	2	3	5	0	0	5	0	0
16	36752278	.	T	C	2	4	6	0	0	6	0	0
16	36759908	.	A	T	2	4	6	0	1	7	0	0
16	36759937	.	A	G	1	3	4	0	0	4	0	0
16	36766180	.	T	G	15	11	26	0	0	26	0	0
16	36766467	.	G	T	5	11	16	0	3	19	0	0
16	36908630	.	C	T	2	4	6	0	0	6	0	0
16	36908844	.	C	A	4	3	7	0	0	7	0	0
16	36911214	.	C	A	1	2	3	0	0	3	0	0
16	36911257	.	A	G	2	0	2	0	3	5	0	0
16	36914935	.	T	C	0	1	1	0	0	1	0	0
16	36918992	.	G	A	6	2	8	0	0	8	0	0
16	36923298	.	C	T	7	7	14	0	0	14	0	0
16	36925462	.	G	A	0	1	1	0	0	1	0	0
16	36926775	.	C	A	2	1	3	0	0	3	0	0
16	36926779	.	A	C	2	0	2	0	0	2	0	0
16	36928169	.	A	T	4	1	5	0	0	5	0	0
16	36928179	.	A	C	4	1	5	0	0	5	0	0
16	36928429	.	A	G	4	4	8	0	1	9	0	0
16	36931728	.	T	C	18	7	25	0	0	25	0	0
16	36934191	.	T	A	10	5	15	0	0	15	0	0
16	36934340	.	C	A	0	1	1	0	2	3	0	0
16	36934398	.	G	C	6	2	8	0	1	9	0	0
16	36939973	.	T	C	1	0	1	0	0	1	0	0
16	36939982	.	A	G	1	1	2	0	0	2	0	0
16	36940045	.	C	T	5	8	13	0	3	16	0	0
16	36941706	.	T	C	1	0	1	0	0	1	0	0
16	36941790	.	T	C	4	3	7	0	0	7	0	0
16	36941961	.	T	C	1	0	1	0	0	1	0	0
16	36942068	.	C	A	1	0	1	0	0	1	0	0
16	36945182	.	T	G	2	5	7	0	0	7	0	0
16	36945564	.	T	C	0	7	7	0	0	7	0	0
16	36945566	.	T	A	0	7	7	0	0	7	0	0
16	36975141	.	G	A	5	2	7	0	1	8	0	0
16	36975146	.	C	T	0	2	2	0	5	7	0	0
16	36975183	.	G	C	0	1	1	0	0	1	0	0
16	36975318	.	T	A	1	2	3	0	0	3	0	0
16	36976721	.	A	G	7	3	10	0	0	10	0	0
16	36977289	.	C	T	1	2	3	0	0	3	0	0
16	36977387	.	A	G	0	3	3	0	0	3	0	0
16	36979518	.	G	A	10	12	22	0	0	22	0	0
16	36979521	.	A	G	10	11	21	0	1	22	0	0
16	37167545	.	T	A	2	12	14	0	0	14	0	0
16	37167784	.	C	G	3	5	8	0	0	8	0	0
16	37306905	.	G	A	4	7	11	0	0	11	0	0
16	37323594	.	A	C	1	0	1	0	0	1	0	0
16	37470964	.	T	C	2	3	5	0	1	6	0	0
16	37471169	.	A	T	2	2	4	0	1	5	0	0
16	37521130	.	A	G	2	3	5	0	0	5	0	0
16	37521301	.	G	C	0	2	2	0	3	5	0	0
16	37552966	.	G	A	5	7	12	0	1	13	0	0
16	37563601	.	G	A	0	1	1	0	0	1	0	0
16	37563643	.	T	G	0	0	0	0	1	1	0	0
16	37565676	.	C	G	0	1	1	0	0	1	0	0
16	37593444	.	G	A	4	1	5	0	1	6	0	0
16	37596645	.	C	T	4	2	6	0	0	6	0	0
16	37596669	.	G	A	2	2	4	0	0	4	0	0
16	37614071	.	A	G	3	3	6	0	0	6	0	0
16	37617219	.	A	G	12	0	12	0	10	22	0	0
16	37617304	.	A	G	9	1	10	0	15	25	0	0
16	37617738	.	T	C	18	17	35	0	0	35	0	0
16	37627218	.	T	G	12	11	23	1	4	28	0	0
16	37627762	.	G	A	3	18	21	0	19	40	0	0
16	37627997	.	T	G	22	22	44	0	1	45	0	0
16	37947769	.	T	C	5	2	7	0	0	7	0	0
16	37948242	.	C	G	1	3	4	0	0	4	0	0
16	37948256	.	G	T	5	2	7	0	0	7	0	0
16	37948355	.	C	T	6	3	9	0	0	9	0	0
16	37948389	.	G	T	8	4	12	0	0	12	0	0
16	37948624	.	G	A	7	3	10	0	0	10	0	0
16	37948625	.	G	A	7	3	10	0	0	10	0	0
16	37963955	.	T	A	2	0	2	0	0	2	0	0
16	37964222	.	T	A	2	5	7	0	0	7	0	0
16	38017964	.	A	G	1	2	3	0	0	3	0	0
16	38018672	.	T	A	1	3	4	0	0	4	0	0
16	38020417	.	A	T	1	3	4	0	1	5	0	0
16	38020424	.	C	G	2	3	5	0	0	5	0	0
16	38121528	.	G	A	0	2	2	0	0	2	0	0
16	38127708	.	T	A	0	3	3	0	0	3	0	0
16	38130661	.	T	C	3	3	6	0	0	6	0	0
16	38135699	.	T	C	3	13	16	0	0	16	0	0
16	38135816	.	T	C	3	3	6	0	0	6	0	0
16	38136117	.	C	T	8	5	13	0	2	15	0	0
16	38136278	.	C	T	5	7	12	0	2	14	0	0
16	38136317	.	G	A	10	5	15	0	0	15	0	0
16	38136346	.	C	T	8	9	17	0	1	18	0	0
16	38136491	.	G	C	5	8	13	0	0	13	0	0
16	38159817	.	C	A	2	7	9	0	0	9	0	0
16	38167493	.	G	C	3	5	8	0	0	8	0	0
16	38167511	.	C	T	5	4	9	0	0	9	0	0
16	38167904	.	A	G	7	0	7	0	9	16	0	0
16	38168095	.	G	A	0	4	4	0	2	6	0	0
16	38188955	.	G	A	0	8	8	0	8	16	0	0
16	38189099	.	T	C	3	2	5	0	0	5	0	0
16	38191645	.	C	T	5	2	7	0	0	7	0	0
16	38194017	.	T	C	4	4	8	0	0	8	0	0
16	38198182	.	T	G	4	0	4	0	5	9	0	0
16	38199647	.	G	A	10	3	13	0	0	13	0	0
16	38266390	.	A	T	1	3	4	0	0	4	0	0
16	38266416	.	G	A	0	2	2	0	1	3	0	0
16	38266477	.	T	C	1	1	2	0	1	3	0	0
16	38266613	.	T	A	2	2	4	0	0	4	0	0
16	38299559	.	G	A	1	2	3	0	0	3	0	0
16	38355299	.	G	A	2	3	5	0	0	5	0	0
16	38454535	.	A	G	1	2	3	0	0	3	0	0
16	38454783	.	T	A	1	4	5	0	0	5	0	0
16	38499053	.	C	T	0	2	2	0	4	6	0	0
16	38518207	.	G	A	2	4	6	0	0	6	0	0
16	38553647	.	C	T	0	1	1	0	0	1	0	0
16	38556912	.	G	A	9	12	21	0	1	22	0	0
16	38556922	.	C	G	1	12	13	0	7	20	0	0
16	38557876	.	G	C	10	0	10	0	10	20	0	0
16	38568644	.	G	C	4	9	13	0	1	14	0	0
16	38729548	.	G	A	2	5	7	0	0	7	0	0
16	38729551	.	G	T	0	2	2	0	5	7	0	0
16	38824751	.	C	T	1	2	3	0	0	3	0	0
16	38943253	.	C	T	1	0	1	0	0	1	0	0
16	38943547	.	A	G	6	0	6	0	5	11	0	0
16	39146871	.	A	C	9	12	21	0	0	22	1	0
16	39154953	.	G	A	1	0	1	0	0	1	0	0
16	39157751	.	C	A	16	17	33	0	0	33	0	0
16	39157885	.	T	A	4	3	7	0	0	7	0	0
16	39160458	.	A	C	2	5	7	0	0	7	0	0
16	39162786	.	C	T	16	13	29	0	1	30	0	0
16	39164213	.	G	A	0	4	4	0	0	4	0	0
16	39166773	.	C	T	19	17	36	0	3	39	0	0
16	39166854	.	C	T	20	25	45	0	1	46	0	0
16	39167028	.	C	A	20	14	34	0	1	35	0	0
16	39167088	.	C	T	11	11	22	0	3	25	0	0
16	39185271	.	T	G	3	3	6	0	0	6	0	0
16	39185580	.	G	A	16	14	30	0	1	32	1	0
16	39191557	.	T	C	3	0	3	0	6	9	0	0
16	39196890	.	A	C	4	4	8	0	0	8	0	0
16	39196956	.	A	G	1	0	1	0	0	1	0	0
16	39213237	.	G	A	0	2	2	0	2	4	0	0
16	39238437	.	A	C	4	0	4	0	6	10	0	0
16	39238539	.	A	T	4	4	8	0	0	8	0	0
16	39238547	.	A	T	2	3	5	0	0	5	0	0
16	39244286	.	T	C	14	21	35	0	1	36	0	0
16	39248745	.	T	A	5	3	8	0	1	9	0	0
16	39248811	.	C	G	3	1	4	0	2	6	0	0
16	39248813	.	T	A	4	2	6	0	0	6	0	0
16	39248976	.	G	A	3	10	13	0	0	13	0	0
16	39249056	.	G	A	11	1	12	0	1	13	0	0
16	39249229	.	C	T	4	6	10	0	0	10	0	0
16	39249475	.	C	A	3	2	5	0	0	5	0	0
16	39249995	.	T	C	1	3	4	0	0	4	0	0
16	39250197	.	C	T	5	1	6	0	0	6	0	0
16	39253272	.	C	T	0	1	1	0	0	1	0	0
16	39271329	.	A	C	3	5	8	0	1	9	0	0
16	39271394	.	G	C	2	3	5	0	0	5	0	0
16	39297336	.	C	A	2	3	5	0	1	6	0	0
16	39297344	.	A	T	2	3	5	0	0	5	0	0
16	39297378	.	C	T	3	3	6	0	0	6	0	0
16	39323716	.	C	T	9	7	16	0	0	16	0	0
16	39362312	.	G	T	0	0	0	0	1	1	0	0
16	39372345	.	G	A	3	4	7	0	1	8	0	0
16	39372372	.	T	C	3	5	8	0	1	9	0	0
16	39372735	.	G	C	0	8	8	0	4	12	0	0
16	39372780	.	C	A	7	7	14	0	1	15	0	0
16	39378744	.	A	G	2	0	2	0	2	4	0	0
16	39382047	.	C	G	4	11	15	0	0	15	0	0
16	39382084	.	C	T	7	10	17	0	0	17	0	0
16	39382098	.	G	A	7	4	11	0	1	12	0	0
16	39382208	.	T	C	2	6	8	0	0	8	0	0
16	39382467	.	C	G	2	6	8	0	0	8	0	0
16	39382482	.	G	A	2	6	8	0	0	8	0	0
16	39385755	.	T	C	16	0	16	0	13	29	0	0
16	39386184	.	T	C	14	14	28	0	1	29	0	0
16	39386239	.	T	A	12	19	31	0	3	34	0	0
16	39386915	.	C	T	17	12	29	0	2	31	0	0
16	39390139	.	T	C	19	1	20	0	17	37	0	0
16	39390175	.	G	A	12	17	29	0	0	29	0	0
16	39393370	.	A	G	5	3	8	0	0	8	0	0
16	39394630	.	A	G	14	12	26	0	2	28	0	0
16	39399140	.	A	C	5	0	5	0	2	7	0	0
16	39413514	.	C	T	4	4	8	0	0	8	0	0
16	39643512	.	G	A	1	2	3	0	0	3	0	0
16	39901274	.	G	A	3	3	6	0	1	7	0	0
16	40026573	.	A	G	1	0	1	0	1	2	0	0
16	40031649	.	A	G	0	2	2	0	2	4	0	0
16	40066964	.	C	T	0	1	1	0	0	1	0	0
16	40131552	.	T	A	2	2	4	1	0	5	0	0
16	40131556	.	T	G	2	2	4	1	0	5	0	0
16	40153313	.	G	C	1	3	4	0	0	4	0	0
16	40340706	.	T	G	1	2	3	0	0	3	0	0
16	40340953	.	C	G	4	0	4	0	3	7	0	0
16	40340967	.	A	G	1	3	4	0	0	4	0	0
16	40343747	.	T	C	2	0	2	0	0	2	0	0
16	40495482	.	C	T	0	2	2	0	0	2	0	0
16	40503994	.	G	A	0	4	4	0	0	4	0	0
16	40530380	.	G	A	0	2	2	0	0	2	0	0
16	40560713	.	C	T	5	3	8	0	0	8	0	0
16	40568162	.	A	G	0	0	0	0	1	1	0	0
16	40568274	.	G	A	0	4	4	0	2	6	0	0
16	40568336	.	A	G	3	0	3	0	6	9	0	0
16	40569480	.	C	G	3	2	5	0	0	5	0	0
16	40584954	.	G	A	0	3	3	0	1	4	0	0
16	40602886	.	G	A	4	3	7	0	0	7	0	0
16	40606844	.	T	A	3	5	8	0	0	8	0	0
16	40607436	.	C	T	0	1	1	0	0	1	0	0
16	40610727	.	C	T	6	3	9	0	0	9	0	0
16	40622799	.	G	A	0	1	1	0	0	1	0	0
16	40625099	.	T	C	0	1	1	0	0	1	0	0
16	40625168	.	G	A	4	4	8	0	0	8	0	0
16	40632787	.	A	C	4	0	4	0	5	9	0	0
16	40672891	.	C	T	0	1	1	0	0	1	0	0
16	40954538	.	C	T	9	5	14	0	1	15	0	0
16	40954866	.	T	C	8	14	22	0	0	22	0	0
16	40954983	.	A	C	10	11	21	0	2	23	0	0
16	40955515	.	G	T	8	2	10	0	1	11	0	0
16	40955525	.	C	T	6	3	9	0	2	11	0	0
16	40991926	.	T	C	4	3	7	0	1	8	0	0
16	40991933	.	T	C	4	3	7	0	2	9	0	0
16	40991986	.	G	T	2	2	4	0	0	4	0	0
16	40992113	.	G	C	2	2	4	0	0	4	0	0
16	40992490	.	A	G	2	4	6	0	0	6	0	0
16	40992529	.	G	A	1	7	8	0	0	8	0	0
16	41003692	.	T	C	1	0	1	0	2	3	0	0
16	41003923	.	G	A	2	2	4	0	0	4	0	0
16	41004016	.	A	G	0	3	3	0	0	3	0	0
16	41026725	.	G	C	8	3	11	0	0	11	0	0
16	41026735	.	G	A	7	3	10	0	0	10	0	0
16	41029588	.	G	A	0	3	3	0	4	7	0	0
16	41029626	.	G	T	4	3	7	0	1	8	0	0
16	41029649	.	T	C	1	1	2	0	0	2	0	0
16	41029713	.	A	T	1	2	3	0	0	3	0	0
16	41029836	.	A	G	2	4	6	0	0	6	0	0
16	41030017	.	A	C	10	4	14	0	0	14	0	0
16	41030560	.	T	C	4	2	6	0	0	6	0	0
16	41084891	.	C	T	1	1	2	0	0	2	0	0
16	41112493	.	C	T	0	3	3	0	1	4	0	0
16	41112571	.	T	C	4	4	8	0	0	8	0	0
16	41112861	.	G	C	4	0	4	0	3	7	0	0
16	41113676	.	T	G	1	1	2	0	0	2	0	0
16	41113698	.	A	T	1	2	3	0	0	3	0	0
16	41113752	.	G	A	2	1	3	0	0	3	0	0
16	41113755	.	C	T	1	1	2	0	0	2	0	0
16	41114779	.	G	A	8	4	12	0	0	12	0	0
16	41114800	.	A	T	4	7	11	0	0	11	0	0
16	41114976	.	G	T	5	3	8	0	0	8	0	0
16	41115079	.	T	G	5	3	8	0	1	9	0	0
16	41115997	.	A	T	8	6	14	0	3	17	0	0
16	41115998	.	C	T	0	8	8	0	9	17	0	0
16	41116367	.	G	A	7	9	16	0	0	16	0	0
16	41116548	.	G	A	5	2	7	0	1	8	0	0
16	41116613	.	G	C	1	6	7	0	0	7	0	0
16	41116783	.	C	T	2	2	4	0	0	4	0	0
16	41117169	.	G	A	1	2	3	0	1	4	0	0
16	41345826	.	G	T	6	4	10	0	1	11	0	0
16	41346007	.	C	A	1	13	14	0	9	23	0	0
16	41353140	.	G	A	7	4	11	0	0	11	0	0
16	41393773	.	C	T	4	0	4	0	0	4	0	0
16	41467838	.	G	A	0	1	1	0	0	1	0	0
16	41467840	.	A	G	1	0	1	0	0	1	0	0
16	41468848	.	T	G	5	4	9	0	0	9	0	0
16	41469008	.	G	A	2	3	5	0	0	5	0	0
16	41469029	.	C	A	3	2	5	0	0	5	0	0
16	41469130	.	T	A	3	3	6	0	0	6	0	0
16	41469329	.	G	A	4	3	7	0	0	7	0	0
16	41469390	.	A	C	8	4	12	0	1	13	0	0
16	41469472	.	T	C	1	2	3	0	0	3	0	0
16	41507316	.	C	A	0	2	2	0	2	4	0	0
16	41533866	.	G	A	2	4	6	0	0	6	0	0
16	41585743	.	C	T	0	3	3	0	3	6	0	0
16	41589214	.	A	G	3	1	4	0	0	4	0	0
16	41599917	.	C	T	0	1	1	0	0	1	0	0
16	41601658	.	T	C	1	1	2	0	0	2	0	0
16	41685875	.	T	C	2	2	4	0	0	4	0	0
16	41717479	.	G	A	8	6	14	0	0	14	0	0
16	41717482	.	A	G	8	6	14	0	0	14	0	0
16	41717666	.	G	A	0	10	10	0	15	25	0	0
16	41720533	.	G	T	2	0	2	0	0	2	0	0
16	41720536	.	T	G	2	2	4	0	0	4	0	0
16	41720587	.	T	C	1	2	3	0	1	4	0	0
16	41723228	.	T	G	10	1	11	0	17	28	0	0
16	41723280	.	A	G	9	0	9	0	5	14	0	0
16	41725215	.	T	C	6	6	12	0	1	13	0	0
16	41725238	.	T	C	6	3	9	0	1	10	0	0
16	41730625	.	C	G	0	1	1	0	0	1	0	0
16	41731928	.	A	T	3	5	8	0	0	8	0	0
16	41731929	.	C	A	3	5	8	0	0	8	0	0
16	41732009	.	G	T	8	6	14	0	0	14	0	0
16	41732031	.	G	T	0	3	3	0	8	11	0	0
16	41732067	.	T	C	3	4	7	0	0	7	0	0
16	41732262	.	T	C	6	7	13	0	1	14	0	0
16	41732295	.	G	T	5	7	12	0	2	14	0	0
16	41732343	.	C	T	2	4	6	0	1	7	0	0
16	41732366	.	A	G	4	4	8	0	0	8	0	0
16	41732398	.	A	G	10	6	16	0	0	16	0	0
16	41732409	.	A	G	10	4	14	0	0	14	0	0
16	41740704	.	A	T	1	3	4	0	0	4	0	0
16	41740815	.	T	A	2	2	4	0	0	4	0	0
16	41741050	.	C	T	0	6	6	0	3	9	0	0
16	41741398	.	A	G	1	4	5	0	0	5	0	0
16	41742460	.	T	C	2	4	6	0	1	7	0	0
16	41742481	.	C	T	2	7	9	0	0	9	0	0
16	41794900	.	C	A	0	17	17	0	14	31	0	0
16	41801525	.	G	T	7	7	14	0	1	15	0	0
16	41873717	.	T	A	7	11	18	0	2	20	0	0
16	41873797	.	G	A	7	9	16	0	0	16	0	0
16	41873992	.	C	T	4	7	11	0	0	11	0	0
16	41874039	.	G	C	1	2	3	0	0	3	0	0
16	41891572	.	C	T	17	22	39	0	1	40	0	0
16	41891662	.	A	C	4	2	6	0	1	7	0	0
16	41896361	.	G	A	17	5	22	0	1	23	0	0
16	41897244	.	A	G	9	7	16	0	1	17	0	0
16	41897332	.	A	G	6	16	22	0	0	22	0	0
16	41897347	.	G	A	6	15	21	0	1	22	0	0
16	41897375	.	A	T	8	21	29	0	1	30	0	0
16	41897452	.	C	A	18	5	23	0	0	24	1	0
16	41897593	.	A	C	0	6	6	0	2	8	0	0
16	41897599	.	A	T	0	8	8	0	0	8	0	0
16	41903475	.	A	T	10	7	17	0	2	19	0	0
16	41903686	.	G	A	17	8	25	0	1	26	0	0
16	41903770	.	T	C	8	11	19	0	0	19	0	0
16	41903801	.	T	G	5	9	14	0	1	15	0	0
16	41903957	.	T	C	11	11	22	0	1	23	0	0
16	41904121	.	T	G	8	8	16	0	0	16	0	0
16	41904209	.	T	C	10	6	16	0	1	17	0	0
16	41904261	.	G	A	14	6	20	0	1	21	0	0
16	41904430	.	C	A	17	11	28	0	0	28	0	0
16	41904440	.	C	A	1	9	10	0	16	26	0	0
16	41904615	.	T	C	10	0	10	0	8	18	0	0
16	41904650	.	G	A	11	1	12	0	0	12	0	0
16	41904879	.	A	T	2	4	6	0	0	6	0	0
16	41904961	.	A	G	10	4	14	0	0	14	0	0
16	41905631	.	A	G	4	13	17	0	1	18	0	0
16	41905666	.	A	G	4	11	15	0	0	15	0	0
16	41905682	.	G	T	6	10	16	0	0	16	0	0
16	41905720	.	T	A	5	5	10	0	0	10	0	0
16	41905807	.	G	C	3	12	15	0	0	15	0	0
16	41912225	.	G	A	0	1	1	0	0	1	0	0
16	41916819	.	A	G	3	2	5	0	0	5	0	0
16	41925227	.	G	C	13	0	13	0	11	24	0	0
16	41933222	.	A	C	3	2	5	0	0	5	0	0
16	41933411	.	G	A	0	1	1	0	0	1	0	0
16	42072207	.	T	A	17	11	28	0	1	29	0	0
16	42072719	.	A	C	22	12	34	0	0	34	0	0
16	42073086	.	A	G	6	4	10	0	0	10	0	0
16	42073488	.	T	C	22	1	23	0	15	38	0	0
16	42083039	.	G	A	7	3	10	0	0	10	0	0
16	42091814	.	A	G	3	3	6	0	0	6	0	0
16	42177840	.	C	T	3	5	8	0	1	9	0	0
16	42178002	.	C	T	0	2	2	0	8	10	0	0
16	42178012	.	A	G	5	1	6	0	1	7	0	0
16	42179879	.	C	A	12	7	19	0	0	19	0	0
16	42180079	.	A	G	4	0	4	0	0	4	0	0
16	42180271	.	G	A	2	4	6	0	1	7	0	0
16	42186022	.	G	A	4	4	8	0	0	8	0	0
16	42186043	.	A	T	3	4	7	0	1	8	0	0
16	42186063	.	A	G	0	3	3	0	1	4	0	0
16	42193194	.	T	A	2	2	4	0	0	4	0	0
16	42193489	.	G	A	2	5	7	0	1	8	0	0
16	42193504	.	G	A	2	4	6	0	0	6	0	0
16	42322458	.	T	G	33	41	74	0	1	75	0	0
16	42373933	.	A	C	14	28	42	0	0	42	0	0
16	42374020	.	C	T	1	19	20	0	25	45	0	0
16	42374080	.	G	T	17	29	46	0	2	48	0	0
16	42374254	.	C	T	22	24	46	0	1	47	0	0
16	42374290	.	G	A	19	26	45	0	2	47	0	0
16	42374425	.	A	G	17	26	43	0	3	46	0	0
16	42374434	.	A	C	19	25	44	0	0	44	0	0
16	42390176	.	T	C	9	0	9	0	17	26	0	0
16	42423606	.	G	T	0	6	6	0	1	7	0	0
16	42424189	.	G	A	12	14	26	0	1	27	0	0
16	42424240	.	G	A	13	10	23	0	1	24	0	0
16	42424348	.	T	C	4	9	13	0	1	14	0	0
16	42424352	.	G	A	3	7	10	0	1	11	0	0
16	42424504	.	C	A	15	7	22	0	0	22	0	0
16	42424505	.	A	C	15	7	22	0	0	22	0	0
16	42424653	.	G	C	3	3	6	0	0	6	0	0
16	42424762	.	G	A	13	8	21	0	3	24	0	0
16	42453542	.	C	T	0	2	2	0	1	3	0	0
16	42459378	.	T	C	0	3	3	0	0	3	0	0
16	42461066	.	A	G	2	0	2	0	0	2	0	0
16	42472715	.	C	T	6	3	9	0	0	9	0	0
16	42487947	.	A	G	5	12	17	0	6	23	0	0
16	42490255	.	C	T	12	8	20	0	0	20	0	0
16	42490264	.	T	C	10	6	16	0	1	17	0	0
16	42493796	.	G	C	0	14	14	0	17	31	0	0
16	42494084	.	G	A	0	2	2	0	6	8	0	0
16	42494143	.	A	T	2	5	7	0	1	8	0	0
16	42683149	.	T	C	2	2	4	0	0	4	0	0
16	42842991	.	G	C	6	11	17	0	1	18	0	0
16	42842995	.	A	G	8	13	21	0	0	21	0	0
16	42843128	.	G	A	3	4	7	0	2	9	0	0
16	42900598	.	G	A	0	3	3	0	2	5	0	0
16	42938992	.	G	T	8	4	12	0	0	12	0	0
16	42939061	.	A	T	6	4	10	0	0	10	0	0
16	42939088	.	C	A	3	3	6	0	0	6	0	0
16	42939097	.	A	G	2	5	7	0	1	8	0	0
16	42939124	.	T	A	6	2	8	0	0	8	0	0
16	42939343	.	C	T	0	1	1	0	17	18	0	0
16	42939351	.	T	C	2	11	13	0	2	15	0	0
16	42939443	.	A	C	8	0	8	0	15	23	0	0
16	42939479	.	A	G	16	13	29	0	2	31	0	0
16	42939480	.	C	T	0	9	9	0	22	31	0	0
16	42939561	.	G	C	11	14	25	0	1	26	0	0
16	42939695	.	A	G	9	7	16	0	1	17	0	0
16	42940259	.	A	G	4	2	6	0	0	6	0	0
16	42940836	.	A	C	3	2	5	0	0	5	0	0
16	42940916	.	G	A	3	4	7	0	0	7	0	0
16	42941124	.	C	A	7	3	10	0	0	10	0	0
16	42941189	.	C	A	1	1	2	0	0	2	0	0
16	42993052	.	G	A	3	0	3	0	0	3	0	0
16	43001246	.	G	C	3	0	3	0	11	14	0	0
16	43001354	.	C	T	0	8	8	0	16	24	0	0
16	43003080	.	A	G	4	5	9	0	0	9	0	0
16	43026164	.	G	T	1	4	5	0	0	5	0	0
16	43026201	.	G	T	1	3	4	0	0	4	0	0
16	43028295	.	T	C	3	8	11	0	1	12	0	0
16	43028303	.	C	T	2	9	11	0	0	11	0	0
16	43028353	.	G	A	1	4	5	0	0	5	0	0
16	43028369	.	A	G	4	4	8	0	0	8	0	0
16	43028453	.	C	T	2	5	7	0	0	7	0	0
16	43028542	.	A	T	8	6	14	0	0	14	0	0
16	43028546	.	C	T	8	6	14	0	0	14	0	0
16	43031834	.	C	G	1	1	2	0	0	2	0	0
16	43126424	.	A	T	2	5	7	0	0	7	0	0
16	43126425	.	C	T	2	5	7	0	0	7	0	0
16	43126502	.	G	T	1	2	3	0	0	3	0	0
16	43126546	.	A	C	3	0	3	0	7	10	0	0
16	43126566	.	G	A	8	4	12	0	0	12	0	0
16	43126603	.	A	T	2	6	8	0	0	8	0	0
16	43126886	.	A	G	6	9	15	0	0	15	0	0
16	43126887	.	C	T	1	7	8	0	7	15	0	0
16	43145747	.	A	G	0	0	0	0	1	1	0	0
16	43149687	.	C	G	2	2	4	0	0	4	0	0
16	43149733	.	C	T	2	2	4	0	0	4	0	0
16	43153076	.	C	A	6	2	8	0	1	9	0	0
16	43153537	.	C	A	1	3	4	0	0	4	0	0
16	43283941	.	C	T	1	6	7	0	0	7	0	0
16	43971245	.	T	C	2	2	4	0	0	4	0	0
16	43971248	.	G	A	2	1	3	0	0	3	0	0
16	44044497	.	C	T	2	5	7	0	0	7	0	0
16	44338921	.	T	A	21	23	44	0	0	44	0	0
16	44339284	.	C	T	0	16	16	0	18	34	0	0
16	44339466	.	A	G	23	14	37	0	1	38	0	0
16	44339475	.	A	G	21	10	31	0	0	31	0	0
16	44342679	.	C	T	2	7	9	0	0	9	0	0
16	44379120	.	A	G	15	12	27	0	1	28	0	0
16	44379168	.	T	C	18	14	32	0	2	34	0	0
16	44379219	.	T	A	15	13	28	0	0	28	0	0
16	45590078	.	C	G	1	0	1	0	4	5	0	0
16	46091291	.	C	T	0	6	6	0	0	6	0	0
16	46091412	.	T	C	1	1	2	0	0	2	0	0
16	46091415	.	T	C	1	2	3	0	0	3	0	0
16	46198406	.	A	G	21	16	37	0	0	37	0	0
16	46399586	.	T	C	3	3	6	0	0	6	0	0
16	46399587	.	T	C	2	0	2	0	4	6	0	0
16	46400937	.	T	A	1	2	3	0	0	3	0	0
16	46464219	.	G	A	8	6	14	0	1	15	0	0
16	46464279	.	G	A	17	5	22	0	1	23	0	0
16	51094724	.	G	A	1	4	5	0	0	5	0	0
16	51244464	.	T	C	3	3	6	0	0	6	0	0
16	51244487	.	T	C	1	4	5	0	0	5	0	0
16	51244500	.	T	C	2	1	3	0	0	3	0	0
16	51370935	.	T	C	0	0	0	0	2	2	0	0
16	51559527	.	C	T	2	5	7	0	0	7	0	0
16	51885808	.	G	A	23	21	44	0	2	46	0	0
16	51885855	.	A	T	6	8	14	0	1	15	0	0
16	51888929	.	C	T	13	15	28	0	1	29	0	0
16	51941865	.	T	C	2	0	2	0	6	8	0	0
16	51941885	.	C	G	3	4	7	0	0	7	0	0
16	51942108	.	G	A	1	3	4	0	0	4	0	0
16	51950726	.	C	A	12	31	43	0	1	44	0	0
16	51950754	.	C	T	20	34	54	0	0	54	0	0
16	51950814	.	A	T	33	0	33	0	0	33	0	0
16	51950877	.	G	C	22	25	47	0	0	47	0	0
16	51951690	.	T	C	3	21	24	0	1	25	0	0
16	51951691	.	T	C	5	17	22	0	3	25	0	0
16	51951861	.	G	C	12	12	24	0	2	26	0	0
16	51952002	.	T	G	5	21	26	0	5	31	0	0
16	51952023	.	A	T	7	19	26	0	3	29	0	0
16	51952063	.	A	C	10	11	21	0	6	27	0	0
16	51952817	.	C	T	3	3	6	0	0	6	0	0
16	51952826	.	C	A	5	4	9	0	1	10	0	0
16	51953009	.	G	A	23	17	40	0	0	40	0	0
16	51953048	.	T	C	23	22	45	0	3	48	0	0
16	51953057	.	T	A	20	24	44	0	1	45	0	0
16	51953189	.	G	T	3	7	10	0	2	12	0	0
16	51954683	.	C	T	1	15	16	0	12	28	0	0
16	51954800	.	C	T	5	15	20	0	1	21	0	0
16	51955675	.	G	A	12	15	27	0	2	29	0	0
16	51955696	.	G	A	8	9	17	0	0	17	0	0
16	51962068	.	A	G	4	8	12	0	2	14	0	0
16	51962089	.	C	T	16	6	22	0	4	26	0	0
16	51966774	.	C	G	4	0	4	0	0	4	0	0
16	52208238	.	C	T	2	1	3	0	0	3	0	0
16	52214476	.	C	T	4	3	7	0	0	7	0	0
16	52218769	.	C	T	3	2	5	0	0	5	0	0
16	52218876	.	C	G	1	1	2	0	0	2	0	0
16	52223760	.	C	G	0	2	2	0	0	2	0	0
16	52226039	.	G	T	0	4	4	0	0	4	0	0
16	52226060	.	G	A	2	7	9	0	1	10	0	0
16	53247109	.	T	A	2	1	3	0	0	3	0	0
16	53278406	.	A	G	2	0	2	0	2	4	0	0
16	53278513	.	A	G	6	0	6	0	5	11	0	0
16	53290842	.	G	A	0	5	5	0	2	7	0	0
16	53401854	.	T	C	1	2	3	0	0	3	0	0
16	53433215	.	G	A	0	2	2	0	1	3	0	0
16	53449943	.	T	C	1	2	3	0	2	5	0	0
16	53495455	.	G	A	0	4	4	0	6	10	0	0
16	53495521	.	C	T	5	3	8	0	0	8	0	0
16	53502390	.	C	T	2	2	4	0	0	4	0	0
16	53513549	.	C	T	6	4	10	0	0	10	0	0
16	53516147	.	T	G	11	9	20	1	1	22	0	0
16	53516232	.	G	A	13	12	25	0	2	27	0	0
16	53516303	.	T	C	6	7	13	1	2	16	0	0
16	53529665	.	T	C	3	1	4	0	1	5	0	0
16	53530490	.	A	T	3	3	6	0	0	6	0	0
16	53537205	.	C	T	1	0	1	0	0	1	0	0
16	53539389	.	G	A	5	0	5	0	0	5	0	0
16	53539399	.	T	C	0	3	3	0	1	4	0	0
16	53541879	.	A	G	11	7	18	0	0	18	0	0
16	53541963	.	T	A	7	7	14	0	1	15	0	0
16	53591908	.	C	G	1	6	7	0	0	7	0	0
16	53592058	.	T	A	11	4	15	0	1	16	0	0
16	53592375	.	C	T	11	7	18	0	9	27	0	0
16	53601486	.	A	G	3	0	3	0	12	15	0	0
16	53609408	.	T	C	0	1	1	0	0	1	0	0
16	53609415	.	A	G	0	1	1	0	0	1	0	0
16	53610144	.	C	T	1	3	4	0	0	4	0	0
16	53626853	.	T	C	1	1	2	0	0	2	0	0
16	53701171	.	A	C	8	8	16	0	3	19	0	0
16	53708312	.	C	G	29	39	68	0	4	72	0	0
16	53708537	.	G	T	2	3	5	0	0	5	0	0
16	53708564	.	T	C	8	3	11	0	0	11	0	0
16	53734044	.	C	T	1	5	6	0	0	6	0	0
16	53734064	.	T	A	1	2	3	0	0	3	0	0
16	53734226	.	C	T	0	2	2	0	3	5	0	0
16	53734454	.	G	T	1	3	4	0	0	4	0	0
16	54186911	.	C	T	1	0	1	0	0	1	0	0
16	54217347	.	A	C	0	1	1	0	1	2	0	0
16	54217408	.	G	A	0	2	2	0	0	2	0	0
16	54222382	.	C	T	2	6	8	0	0	8	0	0
16	54222433	.	T	C	1	5	6	0	1	7	0	0
16	54222448	.	G	A	2	4	6	0	0	6	0	0
16	54245580	.	T	A	3	4	7	0	0	8	1	0
16	54245609	.	C	T	2	4	6	0	0	6	0	0
16	54245812	.	T	C	1	3	4	0	0	4	0	0
16	54245832	.	A	C	1	3	4	0	0	4	0	0
16	54303499	.	G	A	7	3	10	0	1	11	0	0
16	54313643	.	T	A	4	1	5	0	0	5	0	0
16	54314226	.	G	A	0	0	0	0	1	1	0	0
16	54314463	.	C	G	3	0	3	0	0	3	0	0
16	54320243	.	A	G	2	3	5	0	0	5	0	0
16	54474858	.	A	G	2	6	8	0	1	9	0	0
16	54474942	.	G	A	5	4	9	0	2	11	0	0
16	54474943	.	C	T	6	4	10	0	1	11	0	0
16	54479732	.	G	A	1	3	4	0	0	4	0	0
16	54521124	.	T	C	2	2	4	0	1	5	0	0
16	54568542	.	G	T	3	3	6	0	0	6	0	0
16	54568755	.	C	A	8	8	16	0	1	17	0	0
16	54568813	.	G	C	4	0	4	0	0	4	0	0
16	54574282	.	C	G	8	10	18	0	2	20	0	0
16	54580891	.	G	A	7	3	10	0	0	10	0	0
16	54580999	.	T	C	2	0	2	0	0	2	0	0
16	54582681	.	G	A	3	4	7	0	1	8	0	0
16	54583177	.	C	T	1	0	1	0	0	1	0	0
16	54584176	.	C	T	2	4	6	0	1	7	0	0
16	54585298	.	T	A	7	9	16	0	0	16	0	0
16	54585799	.	C	T	5	7	12	0	0	12	0	0
16	54586574	.	C	G	2	4	6	0	0	6	0	0
16	54588989	.	G	A	7	11	18	0	2	20	0	0
16	54590186	.	G	A	0	5	5	0	1	6	0	0
16	54592503	.	T	C	11	16	27	0	0	27	0	0
16	54593401	.	A	G	13	15	28	0	1	29	0	0
16	54594270	.	A	T	13	17	30	0	3	33	0	0
16	54594511	.	A	G	9	0	9	0	12	21	0	0
16	54594602	.	C	T	7	18	25	0	0	25	0	0
16	54594605	.	T	C	8	16	24	0	1	25	0	0
16	54594664	.	A	T	6	7	13	1	0	14	0	0
16	54636692	.	G	A	3	3	6	0	0	6	0	0
16	54636792	.	A	G	0	2	2	0	0	2	0	0
16	54780612	.	G	A	15	13	28	0	0	28	0	0
16	54780864	.	G	A	0	7	7	0	7	14	0	0
16	54782373	.	T	C	3	1	4	0	0	4	0	0
16	54785429	.	A	T	8	12	20	0	2	22	0	0
16	54786967	.	C	T	8	12	20	0	2	22	0	0
16	54787564	.	T	G	3	4	7	0	0	7	0	0
16	54793964	.	C	A	5	6	11	0	3	14	0	0
16	54794100	.	G	A	14	13	27	0	2	29	0	0
16	54795141	.	A	G	5	2	7	0	0	7	0	0
16	54795732	.	A	G	4	6	10	0	0	10	0	0
16	54795735	.	G	A	3	6	9	0	1	10	0	0
16	54800128	.	A	T	9	5	14	0	0	14	0	0
16	54805173	.	G	A	1	2	3	0	0	3	0	0
16	54806775	.	T	C	1	3	4	0	0	4	0	0
16	54829650	.	C	T	18	32	50	0	0	50	0	0
16	54829656	.	A	G	18	27	45	0	4	49	0	0
16	54837250	.	T	C	11	4	15	0	2	18	1	0
16	54843723	.	C	T	29	33	62	0	4	66	0	0
16	54843798	.	A	G	16	2	18	0	19	37	0	0
16	54846250	.	G	A	0	7	7	0	5	12	0	0
16	54925474	.	A	G	2	2	4	0	0	4	0	0
16	54930903	.	A	G	2	4	6	0	0	6	0	0
16	54930916	.	T	A	1	3	4	0	1	5	0	0
16	54947827	.	T	G	1	3	4	0	0	5	1	0
16	54947978	.	G	A	5	5	10	0	1	11	0	0
16	54948369	.	T	A	8	5	13	0	0	13	0	0
16	54948467	.	C	A	0	7	7	0	0	7	0	0
16	54948483	.	T	A	2	4	6	0	1	7	0	0
16	54948511	.	C	A	0	6	6	0	2	8	0	0
16	54948538	.	A	T	3	2	5	0	0	5	0	0
16	54948571	.	T	C	3	2	5	0	1	6	0	0
16	54949140	.	G	A	17	5	22	0	2	24	0	0
16	54952935	.	G	A	10	3	13	0	0	13	0	0
16	54953031	.	C	T	0	9	9	0	11	20	0	0
16	54953067	.	G	A	5	3	8	0	0	8	0	0
16	54956620	.	C	T	2	4	6	0	0	6	0	0
16	54956777	.	T	C	5	4	9	0	0	9	0	0
16	54957387	.	A	G	0	2	2	0	0	2	0	0
16	54957388	.	C	G	0	2	2	0	0	2	0	0
16	54958913	.	G	A	1	0	1	0	0	1	0	0
16	54964224	.	C	A	0	6	6	0	2	8	0	0
16	54964281	.	G	C	0	2	2	0	0	2	0	0
16	54964287	.	G	A	0	2	2	0	0	2	0	0
16	54967883	.	C	T	3	1	4	0	0	4	0	0
16	54969116	.	G	A	0	1	1	0	0	1	0	0
16	55004716	.	T	C	10	0	10	0	6	16	0	0
16	55004723	.	C	G	9	8	17	0	0	17	0	0
16	55012643	.	G	A	1	2	3	0	0	3	0	0
16	55090786	.	C	T	2	0	2	0	0	2	0	0
16	55090796	.	C	A	2	1	3	0	0	3	0	0
16	55102422	.	C	G	6	0	6	0	5	11	0	0
16	55102568	.	T	C	3	3	6	0	0	6	0	0
16	55102781	.	C	G	1	2	3	0	0	3	0	0
16	55106111	.	A	C	4	4	8	0	0	9	1	0
16	55106474	.	C	T	0	8	8	0	8	16	0	0
16	55106640	.	T	C	16	0	16	0	7	23	0	0
16	55106724	.	A	C	18	0	18	0	18	36	0	0
16	55108801	.	C	T	3	5	8	0	1	9	0	0
16	55108828	.	C	T	4	5	9	0	0	9	0	0
16	55181068	.	G	A	0	1	1	0	0	1	0	0
16	55181164	.	G	C	5	4	9	0	0	9	0	0
16	55181504	.	T	C	3	2	5	0	0	5	0	0
16	55182133	.	A	G	3	5	8	0	0	8	0	0
16	55182146	.	T	G	3	6	9	0	0	9	0	0
17	743600	.	T	C	10	1	11	0	4	15	0	0
17	1068814	.	C	T	8	5	13	0	1	14	0	0
17	1074636	.	C	G	0	6	6	1	2	9	0	0
17	1141376	.	G	T	0	1	1	0	0	1	0	0
17	1141380	.	G	A	0	1	1	0	1	2	0	0
17	1174929	.	G	C	1	3	4	0	1	5	0	0
17	1258380	.	C	T	1	3	4	0	0	4	0	0
17	1353211	.	C	A	1	2	3	0	0	3	0	0
17	1355379	.	A	G	1	3	4	0	0	4	0	0
17	1355509	.	T	C	0	2	2	0	0	2	0	0
17	1355561	.	A	T	2	4	6	0	0	6	0	0
17	1355562	.	C	T	2	4	6	0	0	6	0	0
17	1362244	.	C	T	3	5	8	0	0	8	0	0
17	1407072	.	T	C	1	1	2	0	2	4	0	0
17	1528411	.	A	T	1	1	2	0	0	2	0	0
17	2121955	.	T	A	1	1	2	0	0	2	0	0
17	2122196	.	G	A	7	5	12	0	1	13	0	0
17	2122252	.	C	T	11	12	23	0	0	23	0	0
17	2149168	.	C	T	0	1	1	0	0	1	0	0
17	2149174	.	A	G	0	1	1	0	0	1	0	0
17	2214274	.	T	C	0	1	1	0	0	1	0	0
17	2214291	.	C	G	1	2	3	0	0	3	0	0
17	2231674	.	A	T	1	2	3	0	0	3	0	0
17	2231779	.	C	A	2	1	3	0	0	3	0	0
17	2236042	.	C	T	0	2	2	0	1	3	0	0
17	2236075	.	T	C	1	3	4	0	1	5	0	0
17	2264942	.	G	T	3	2	5	0	0	5	0	0
17	2373246	.	G	A	1	1	2	0	0	2	0	0
17	2373962	.	C	T	0	3	3	0	1	4	0	0
17	2374549	.	A	G	2	0	2	0	0	2	0	0
17	2374558	.	A	G	3	0	3	0	0	3	0	0
17	2378161	.	A	C	4	0	4	0	1	5	0	0
17	2479601	.	G	C	8	3	11	0	1	12	0	0
17	2479620	.	C	A	2	4	6	0	0	6	0	0
17	2498487	.	T	C	2	1	3	0	0	3	0	0
17	2694982	.	T	G	1	2	3	0	0	3	0	0
17	2695693	.	C	A	2	2	4	0	0	4	0	0
17	2695716	.	T	C	5	3	8	0	0	8	0	0
17	2697588	.	A	G	2	2	4	0	0	4	0	0
17	2697596	.	G	A	2	2	4	0	0	4	0	0
17	2698289	.	C	T	0	2	2	0	1	3	0	0
17	2705875	.	G	C	0	1	1	0	0	1	0	0
17	2715262	.	G	A	0	1	1	0	0	1	0	0
17	2715377	.	C	G	1	2	3	0	0	3	0	0
17	2902815	.	G	T	3	3	6	0	0	6	0	0
17	2902880	.	A	G	3	7	10	0	1	11	0	0
17	2902911	.	T	G	4	7	11	0	1	12	0	0
17	2905019	.	A	G	6	3	9	0	0	9	0	0
17	2905049	.	T	A	6	4	10	0	0	10	0	0
17	2905078	.	A	G	5	3	8	0	0	8	0	0
17	2905873	.	G	A	2	2	4	0	0	4	0	0
17	3183970	.	A	G	1	2	3	0	0	3	0	0
17	3184594	.	G	A	1	2	3	0	0	3	0	0
17	3282028	.	G	A	4	2	6	0	0	6	0	0
17	3282034	.	G	A	4	2	6	0	0	6	0	0
17	3282307	.	C	T	4	2	6	0	0	6	0	0
17	3282367	.	A	G	2	1	3	0	1	4	0	0
17	3282394	.	A	G	2	2	4	0	0	4	0	0
17	3283250	.	A	T	2	4	6	0	1	7	0	0
17	3288101	.	A	G	4	4	8	0	0	8	0	0
17	3290657	.	G	C	5	0	5	0	3	8	0	0
17	3290700	.	A	G	5	3	8	0	0	8	0	0
17	3290771	.	A	T	1	0	1	0	0	1	0	0
17	3446847	.	T	C	0	8	8	0	1	9	0	0
17	3514131	.	C	T	2	3	5	0	0	5	0	0
17	3530178	.	G	C	0	1	1	0	0	1	0	0
17	3569169	.	A	G	8	5	13	0	2	15	0	0
17	3854266	.	T	C	11	4	15	0	0	15	0	0
17	3854290	.	C	T	7	10	17	0	0	17	0	0
17	3855436	.	T	C	5	0	5	0	7	12	0	0
17	3860857	.	C	T	0	0	0	0	3	3	0	0
17	3870739	.	T	A	1	4	5	0	1	6	0	0
17	3970905	.	C	T	0	1	1	0	0	1	0	0
17	4009449	.	T	C	1	2	3	0	0	3	0	0
17	4017271	.	G	A	2	1	3	0	0	3	0	0
17	4017277	.	T	C	2	3	5	0	0	5	0	0
17	4017321	.	A	G	4	2	6	0	0	6	0	0
17	4017369	.	C	G	1	3	4	0	0	4	0	0
17	4054565	.	C	T	1	1	2	0	0	2	0	0
17	4239975	.	C	T	1	12	13	0	0	13	0	0
17	4240385	.	T	A	1	2	3	0	0	3	0	0
17	4297232	.	G	A	19	11	30	0	1	31	0	0
17	4297546	.	C	T	12	15	27	0	1	28	0	0
17	4297795	.	T	C	1	3	4	0	0	4	0	0
17	4298221	.	T	A	15	13	28	0	7	35	0	0
17	4298349	.	T	A	19	15	34	1	3	38	0	0
17	4298768	.	T	G	4	9	13	0	0	13	0	0
17	4298945	.	G	A	15	8	23	0	1	24	0	0
17	4298990	.	A	G	11	17	28	0	2	30	0	0
17	4298996	.	C	T	14	18	32	0	1	33	0	0
17	4299031	.	C	T	12	21	33	0	2	35	0	0
17	4307164	.	G	A	8	4	12	0	0	12	0	0
17	4317738	.	G	A	8	2	10	0	1	11	0	0
17	4368900	.	T	A	2	4	6	0	1	7	0	0
17	4368968	.	G	A	6	2	8	0	0	8	0	0
17	4369064	.	A	G	4	4	8	0	0	8	0	0
17	4369304	.	T	C	4	2	6	0	0	6	0	0
17	4378219	.	C	T	2	0	2	0	1	3	0	0
17	5061184	.	G	C	5	3	8	0	0	8	0	0
17	5071257	.	G	A	1	1	2	0	0	2	0	0
17	5079706	.	C	T	5	1	6	0	0	6	0	0
17	5081445	.	G	A	0	9	9	0	12	21	0	0
17	5084892	.	G	A	6	18	24	0	5	29	0	0
17	5087222	.	G	A	8	6	14	0	0	14	0	0
17	5090829	.	G	A	0	14	14	0	14	28	0	0
17	5090871	.	T	C	23	13	36	0	1	38	1	0
17	5091108	.	T	C	4	3	7	0	1	8	0	0
17	5094330	.	T	A	12	6	18	0	1	19	0	0
17	5094355	.	T	C	13	19	32	0	0	32	0	0
17	5094519	.	C	T	7	4	11	0	0	11	0	0
17	5096691	.	T	C	29	13	42	0	2	44	0	0
17	5101234	.	A	G	13	0	13	0	5	18	0	0
17	5105702	.	T	A	13	11	24	0	0	24	0	0
17	5105828	.	T	C	13	7	20	0	1	21	0	0
17	5217050	.	T	C	1	0	1	0	0	1	0	0
17	5239046	.	C	T	0	1	1	0	2	3	0	0
17	7781413	.	G	A	1	2	3	0	0	3	0	0
17	7781599	.	G	A	1	2	3	0	0	3	0	0
17	7781648	.	A	C	1	2	3	0	0	3	0	0
17	7795583	.	T	A	3	5	8	0	0	8	0	0
17	7795593	.	G	A	2	2	4	0	1	5	0	0
17	7799980	.	A	G	2	1	3	0	0	3	0	0
17	7812480	.	A	T	0	2	2	0	0	2	0	0
17	7815212	.	C	T	1	4	5	0	0	5	0	0
17	7818872	.	T	A	0	1	1	0	0	1	0	0
17	7845085	.	T	A	11	4	15	0	0	15	0	0
17	7845288	.	A	G	4	4	8	0	0	8	0	0
17	7845364	.	G	C	16	17	33	0	0	33	0	0
17	7845412	.	T	C	11	20	31	0	1	32	0	0
17	7845566	.	C	T	8	19	27	0	0	27	0	0
17	7845604	.	G	A	11	21	32	0	1	33	0	0
17	7845661	.	G	T	16	29	45	0	1	46	0	0
17	7845733	.	G	A	21	22	43	0	1	44	0	0
17	7845776	.	C	G	0	16	16	0	11	27	0	0
17	7845800	.	A	G	2	13	15	0	1	16	0	0
17	7861124	.	C	T	11	19	30	0	2	32	0	0
17	7868632	.	G	A	2	0	2	0	0	2	0	0
17	7879327	.	C	G	3	2	5	0	1	6	0	0
17	7882941	.	G	A	2	9	11	0	0	11	0	0
17	7882998	.	G	A	12	6	18	0	1	19	0	0
17	7883016	.	C	T	6	8	14	0	1	15	0	0
17	7885635	.	G	A	3	4	7	0	1	8	0	0
17	7885662	.	A	G	9	7	16	0	0	16	0	0
17	7888351	.	G	A	10	5	15	0	1	16	0	0
17	7888369	.	G	A	18	5	23	0	0	23	0	0
17	7896340	.	G	A	9	7	16	0	0	16	0	0
17	7896356	.	C	T	0	12	12	0	10	22	0	0
17	7902203	.	A	G	1	2	3	0	0	3	0	0
17	7906612	.	G	A	6	6	12	0	0	12	0	0
17	7910537	.	C	T	6	6	12	0	1	13	0	0
17	7917414	.	T	A	8	9	17	0	0	17	0	0
17	7917997	.	G	A	1	3	4	0	0	4	0	0
17	7918075	.	C	T	5	3	8	0	0	8	0	0
17	7918244	.	C	T	0	5	5	0	7	12	0	0
17	7918310	.	C	T	0	5	5	0	9	14	0	0
17	7924263	.	G	A	3	1	4	0	0	4	0	0
17	7928615	.	T	G	5	4	9	0	0	9	0	0
17	7929597	.	T	C	2	2	4	0	1	5	0	0
17	7931722	.	T	A	1	0	1	0	1	2	0	0
17	7931737	.	G	A	1	1	2	0	0	2	0	0
17	7942122	.	G	A	3	5	8	0	1	9	0	0
17	7942127	.	T	C	3	4	7	0	2	9	0	0
17	7942191	.	T	G	2	3	5	0	0	5	0	0
17	7945421	.	C	G	2	4	6	0	0	6	0	0
17	7945485	.	A	G	0	1	1	0	0	1	0	0
17	7949119	.	G	T	4	6	10	0	0	10	0	0
17	7950339	.	G	T	2	4	6	0	1	7	0	0
17	7974804	.	T	C	4	2	6	0	0	6	0	0
17	7977746	.	A	T	1	2	3	0	1	4	0	0
17	7981566	.	C	T	3	2	5	0	0	5	0	0
17	7985633	.	G	C	1	3	4	0	0	4	0	0
17	7985693	.	G	A	3	2	5	0	0	5	0	0
17	7988467	.	C	T	0	3	3	0	2	5	0	0
17	7991338	.	G	A	4	1	5	0	0	5	0	0
17	7994305	.	A	G	0	1	1	0	0	1	0	0
17	8000122	.	C	A	3	2	5	0	1	6	0	0
17	8002895	.	G	T	2	2	4	0	0	4	0	0
17	8002932	.	G	A	2	4	6	0	0	6	0	0
17	8003009	.	G	A	2	2	4	0	0	4	0	0
17	8006696	.	T	C	2	2	4	0	0	4	0	0
17	8014187	.	G	A	1	2	3	0	1	4	0	0
17	8015404	.	G	A	2	0	2	0	0	2	0	0
17	8024551	.	G	A	1	2	3	0	1	4	0	0
17	8029730	.	T	C	2	0	2	0	3	5	0	0
17	8036086	.	T	C	3	2	5	0	0	5	0	0
17	8054868	.	A	T	1	0	1	0	0	1	0	0
17	8064770	.	G	A	1	1	2	0	0	2	0	0
17	8184435	.	A	G	3	0	3	0	7	10	0	0
17	8184515	.	A	T	3	3	6	0	0	6	0	0
17	8188963	.	G	T	0	5	5	0	2	7	0	0
17	8191370	.	C	A	3	1	4	0	0	4	0	0
17	8191475	.	A	G	2	2	4	0	0	4	0	0
17	8194715	.	C	A	3	2	5	0	0	5	0	0
17	8197141	.	G	A	0	0	0	0	1	1	0	0
17	8197569	.	C	A	1	2	3	0	0	3	0	0
17	8199812	.	C	T	3	2	5	0	0	5	0	0
17	8202778	.	T	C	7	14	21	0	0	21	0	0
17	8203231	.	T	A	14	15	29	0	2	31	0	0
17	8203234	.	G	A	14	16	30	0	2	32	0	0
17	8203471	.	C	T	9	6	15	0	1	16	0	0
17	8203498	.	G	A	12	6	18	0	1	19	0	0
17	8203729	.	T	C	16	17	33	0	0	33	0	0
17	8204248	.	A	G	9	0	9	0	10	19	0	0
17	8204533	.	C	T	10	14	24	0	1	25	0	0
17	8204755	.	A	G	14	21	35	0	3	38	0	0
17	8204818	.	A	G	18	16	34	0	1	35	0	0
17	8204962	.	C	T	22	14	36	0	0	36	0	0
17	8205508	.	T	C	16	15	31	0	1	32	0	0
17	8209686	.	A	G	10	13	23	1	0	24	0	0
17	8209931	.	C	A	13	10	23	0	0	23	0	0
17	8210327	.	A	T	10	11	21	0	2	23	0	0
17	8210355	.	T	A	12	12	24	0	1	25	0	0
17	8210365	.	C	T	17	9	26	0	0	26	0	0
17	8210415	.	C	A	12	10	22	0	1	23	0	0
17	8210552	.	A	G	8	15	23	0	1	24	0	0
17	8210596	.	A	C	13	15	28	0	2	30	0	0
17	8210801	.	C	T	18	10	28	0	3	31	0	0
17	8234886	.	C	G	0	1	1	0	0	1	0	0
17	8234889	.	C	T	0	2	2	0	0	2	0	0
17	8245868	.	G	A	1	2	3	0	0	3	0	0
17	8248987	.	A	G	0	2	2	0	0	2	0	0
17	8249153	.	A	T	3	4	7	0	0	7	0	0
17	8249270	.	C	T	0	1	1	0	1	2	0	0
17	8259808	.	T	C	0	1	1	0	0	1	0	0
17	8261685	.	A	T	1	5	6	0	1	7	0	0
17	8261799	.	C	T	6	2	8	0	2	10	0	0
17	8427443	.	G	A	0	2	2	0	1	3	0	0
17	8499025	.	C	T	0	4	4	0	1	5	0	0
17	8502883	.	G	A	5	3	8	0	0	8	0	0
17	8502931	.	G	A	1	4	5	0	0	5	0	0
17	8502949	.	G	C	4	0	4	0	4	8	0	0
17	8505413	.	G	A	1	2	3	0	0	3	0	0
17	8515363	.	G	A	3	4	7	0	1	8	0	0
17	8562671	.	T	C	1	2	3	0	0	3	0	0
17	8597078	.	C	A	0	21	21	0	16	37	0	0
17	8597174	.	T	A	12	12	24	0	2	26	0	0
17	8597515	.	A	T	16	15	31	0	2	33	0	0
17	8597702	.	A	T	13	12	25	0	0	25	0	0
17	8597871	.	T	C	16	8	24	0	1	25	0	0
17	8598070	.	C	T	0	25	25	0	21	46	0	0
17	8598168	.	G	A	20	22	42	0	1	43	0	0
17	8598345	.	T	A	10	9	19	0	1	20	0	0
17	8623396	.	G	A	5	8	13	0	0	13	0	0
17	8623480	.	C	T	3	17	20	0	24	44	0	0
17	8623540	.	C	T	1	5	6	0	16	22	0	0
17	8630043	.	C	A	10	11	21	0	0	21	0	0
17	8762239	.	A	G	1	0	1	0	0	1	0	0
17	8764027	.	A	G	2	0	2	0	3	5	0	0
17	8766176	.	G	A	0	3	3	0	0	3	0	0
17	8766185	.	G	A	3	1	4	0	1	5	0	0
17	8772776	.	C	T	0	2	2	0	0	2	0	0
17	8780716	.	G	A	3	3	6	0	0	6	0	0
17	8780728	.	C	T	3	3	6	0	0	6	0	0
17	8784742	.	G	A	0	3	3	0	5	8	0	0
17	8785774	.	C	T	4	2	6	0	0	6	0	0
17	8785795	.	G	A	3	2	5	0	0	5	0	0
17	8791613	.	T	A	8	4	12	0	0	12	0	0
17	8791618	.	C	G	4	9	13	0	0	13	0	0
17	8791863	.	C	T	2	2	4	0	0	4	0	0
17	8792020	.	C	T	1	2	3	0	0	3	0	0
17	8927638	.	A	G	3	4	7	0	0	7	0	0
17	8927641	.	A	G	4	4	8	0	0	8	0	0
17	8930017	.	C	T	7	4	11	0	0	11	0	0
17	8934235	.	C	T	14	6	20	0	0	20	0	0
17	8938011	.	G	A	6	4	10	0	1	11	0	0
17	8938249	.	T	C	6	7	13	0	1	14	0	0
17	8938269	.	G	A	14	5	19	0	5	24	0	0
17	8941206	.	G	A	6	1	7	0	1	8	0	0
17	8941264	.	T	C	6	11	17	0	1	18	0	0
17	8951606	.	C	G	0	12	12	0	9	21	0	0
17	8951867	.	C	T	0	3	3	0	2	5	0	0
17	8954377	.	G	A	13	9	22	0	0	22	0	0
17	8954482	.	C	T	7	10	17	0	0	17	0	0
17	8969278	.	A	G	2	6	8	0	0	8	0	0
17	8972806	.	T	C	12	0	12	0	9	21	0	0
17	8972821	.	G	A	5	10	15	0	0	15	0	0
17	8976273	.	A	G	5	12	17	0	0	17	0	0
17	9017898	.	A	T	3	8	11	0	0	11	0	0
17	9017899	.	T	G	3	8	11	0	0	11	0	0
17	9017950	.	A	G	5	4	9	0	0	9	0	0
17	9042447	.	C	T	1	2	3	0	0	3	0	0
17	9042623	.	T	C	2	5	7	0	0	7	0	0
17	9042652	.	T	C	3	6	9	0	0	9	0	0
17	9059105	.	A	G	1	2	3	0	0	3	0	0
17	9225184	.	G	A	0	7	7	0	6	13	0	0
17	9225223	.	A	G	2	3	5	0	0	5	0	0
17	9248656	.	A	G	1	0	1	0	3	4	0	0
17	9253504	.	A	T	4	4	8	0	0	8	0	0
17	9254269	.	T	A	2	4	6	0	0	6	0	0
17	9255196	.	G	A	0	9	9	0	7	16	0	0
17	9255547	.	G	C	7	8	15	0	1	16	0	0
17	9255703	.	C	T	11	8	19	0	2	21	0	0
17	9266298	.	C	T	14	11	25	0	2	27	0	0
17	9266501	.	G	T	0	14	14	0	10	24	0	0
17	9501630	.	A	G	2	4	6	0	0	6	0	0
17	9847215	.	C	T	2	3	5	0	0	5	0	0
17	9888958	.	C	G	7	10	17	0	1	18	0	0
17	9889223	.	C	T	14	14	28	0	3	31	0	0
17	9889427	.	G	A	9	9	18	0	0	18	0	0
17	9944725	.	A	G	4	4	8	0	0	8	0	0
17	9944733	.	A	G	3	4	7	0	0	7	0	0
17	9944848	.	T	A	2	5	7	0	1	8	0	0
17	9944874	.	C	T	3	5	8	0	0	8	0	0
17	9944960	.	A	T	4	3	7	0	0	7	0	0
17	9951885	.	G	A	6	5	11	0	0	11	0	0
17	9952033	.	C	T	0	8	8	0	4	12	0	0
17	9955952	.	C	T	1	1	2	0	0	2	0	0
17	9957881	.	C	T	1	3	4	0	0	4	0	0
17	9962505	.	A	G	4	3	7	0	0	7	0	0
17	9963519	.	G	A	4	7	11	0	1	12	0	0
17	9964032	.	T	A	6	3	9	0	2	11	0	0
17	9964437	.	A	T	3	2	5	0	0	5	0	0
17	9964602	.	T	A	0	7	7	0	0	7	0	0
17	9964663	.	C	A	2	4	6	0	0	6	0	0
17	9965010	.	C	A	2	2	4	0	0	4	0	0
17	9965344	.	T	A	0	3	3	0	0	3	0	0
17	10062318	.	C	T	1	2	3	0	0	3	0	0
17	10062617	.	G	T	0	2	2	0	0	2	0	0
17	10079554	.	G	A	5	3	8	0	0	8	0	0
17	10089583	.	G	T	6	4	10	7	2	19	0	0
17	10089786	.	C	T	9	4	13	0	0	13	0	0
17	10095554	.	A	G	1	1	2	0	0	2	0	0
17	10095961	.	G	C	0	1	1	0	1	2	0	0
17	10133901	.	G	A	2	1	3	0	0	3	0	0
17	10133902	.	C	T	2	1	3	0	0	3	0	0
17	10142416	.	G	C	4	9	13	0	0	13	0	0
17	10142474	.	T	G	3	5	8	0	0	8	0	0
17	10142481	.	A	G	3	3	6	0	0	6	0	0
17	10143772	.	A	G	11	3	14	0	1	15	0	0
17	10143870	.	A	T	2	3	5	0	0	5	0	0
17	10143960	.	C	T	2	5	7	0	0	7	0	0
17	10144027	.	A	C	4	2	6	0	1	7	0	0
17	10144316	.	A	G	2	0	2	0	5	7	0	0
17	10144336	.	G	A	3	5	8	0	0	8	0	0
17	10144616	.	C	T	2	2	4	0	0	4	0	0
17	10145004	.	G	T	10	19	29	0	1	30	0	0
17	10145281	.	C	T	6	15	21	0	1	22	0	0
17	10247875	.	C	A	3	2	5	0	0	5	0	0
17	10248157	.	A	G	8	7	15	0	0	15	0	0
17	10318127	.	A	T	1	2	3	0	0	3	0	0
17	10320093	.	T	C	3	2	5	0	0	5	0	0
17	10573312	.	C	A	1	3	4	0	0	4	0	0
17	10573327	.	T	C	2	3	5	0	0	5	0	0
17	10573366	.	C	T	2	4	6	0	1	7	0	0
17	10574230	.	C	T	1	0	1	0	0	1	0	0
17	10577887	.	A	G	2	3	5	0	0	5	0	0
17	10578540	.	C	T	1	2	3	0	0	3	0	0
17	10581404	.	T	A	3	3	6	0	0	6	0	0
17	10582757	.	G	A	2	2	4	0	0	4	0	0
17	10582758	.	C	T	2	2	4	0	0	4	0	0
17	10585140	.	C	T	5	5	10	0	2	12	0	0
17	10585363	.	A	T	3	3	6	0	0	6	0	0
17	10586161	.	A	T	3	4	7	0	0	7	0	0
17	10586449	.	A	G	9	6	15	0	1	16	0	0
17	10586664	.	A	C	11	10	21	0	0	21	0	0
17	10587020	.	G	T	7	5	12	0	0	12	0	0
17	10587330	.	A	C	4	4	8	0	0	8	0	0
17	10587601	.	A	G	3	5	8	0	0	8	0	0
17	10679990	.	T	C	1	1	2	0	1	3	0	0
17	10680447	.	A	G	2	1	3	0	0	3	0	0
17	10686248	.	A	T	4	3	7	0	0	7	0	0
17	10686287	.	A	G	3	3	6	0	1	7	0	0
17	10694756	.	T	C	0	1	1	0	0	1	0	0
17	10695904	.	G	A	4	3	7	0	0	7	0	0
17	10695922	.	A	G	3	1	4	0	0	4	0	0
17	10696006	.	C	T	0	1	1	0	0	1	0	0
17	10696137	.	A	T	1	1	2	0	0	2	0	0
17	10696498	.	A	T	0	2	2	0	0	2	0	0
17	10696676	.	A	T	7	3	10	0	0	10	0	0
17	10696688	.	T	C	7	4	11	0	0	11	0	0
17	10698537	.	A	C	7	3	10	0	0	10	0	0
17	10698681	.	G	T	3	10	13	0	2	15	0	0
17	10698977	.	A	C	4	2	6	0	0	6	0	0
17	10699076	.	G	T	0	5	5	0	4	9	0	0
17	10699077	.	A	C	4	5	9	0	0	9	0	0
17	10699151	.	A	G	2	0	2	0	5	8	1	0
17	10703731	.	C	T	0	5	5	0	1	6	0	0
17	10703764	.	C	A	4	7	11	0	0	11	0	0
17	10726617	.	C	T	3	1	4	0	1	5	0	0
17	10737844	.	T	A	6	1	7	0	0	7	0	0
17	10748708	.	G	C	0	2	2	0	9	11	0	0
17	10751051	.	T	C	1	0	1	0	1	2	0	0
17	10755512	.	A	G	5	11	16	0	1	17	0	0
17	10755656	.	T	C	4	1	5	0	0	5	0	0
17	10761763	.	T	C	0	3	3	0	0	3	0	0
17	10765286	.	C	T	3	2	5	0	0	5	0	0
17	10765328	.	A	G	6	0	6	0	6	12	0	0
17	10765683	.	T	A	6	2	8	0	0	8	0	0
17	10765720	.	A	G	2	2	4	0	1	5	0	0
17	10765722	.	T	C	3	2	5	0	0	5	0	0
17	10765766	.	A	G	1	2	3	0	1	4	0	0
17	10765773	.	A	G	1	3	4	0	1	5	0	0
17	10766142	.	T	A	11	4	15	0	1	16	0	0
17	10766181	.	A	G	2	5	7	0	0	7	0	0
17	10766205	.	G	T	1	2	3	0	0	3	0	0
17	10766219	.	A	T	2	2	4	0	0	4	0	0
17	10783885	.	A	G	8	6	14	0	0	14	0	0
17	10784149	.	C	T	0	14	14	0	12	26	0	0
17	10784151	.	T	C	10	13	23	0	3	26	0	0
17	10784210	.	A	C	10	0	10	0	13	23	0	0
17	10784441	.	A	G	13	10	23	0	0	23	0	0
17	10784618	.	G	A	8	7	15	0	1	16	0	0
17	10784646	.	C	G	10	9	19	0	0	19	0	0
17	10784948	.	A	T	11	8	19	0	1	20	0	0
17	10785020	.	A	G	9	5	14	0	0	14	0	0
17	10785206	.	A	G	7	8	15	0	0	15	0	0
17	10785289	.	T	C	10	6	16	0	1	17	0	0
17	10785552	.	A	G	2	5	7	0	0	7	0	0
17	10785616	.	T	A	8	4	12	0	0	12	0	0
17	10785619	.	C	T	8	4	12	0	0	12	0	0
17	10786085	.	C	A	5	7	12	0	0	12	0	0
17	10786149	.	T	A	1	2	3	0	0	3	0	0
17	10786520	.	T	C	4	5	9	0	0	9	0	0
17	10813718	.	G	A	3	2	5	0	0	5	0	0
17	10813783	.	A	T	9	6	15	0	1	16	0	0
17	10813817	.	G	T	11	4	15	0	0	15	0	0
17	10825196	.	C	T	1	1	2	0	1	3	0	0
17	11378906	.	T	A	1	3	4	0	0	4	0	0
17	11507319	.	T	A	1	2	3	0	0	3	0	0
17	11585063	.	C	G	1	0	1	0	0	1	0	0
17	11658769	.	C	T	2	2	4	0	0	4	0	0
17	11708690	.	G	A	5	3	8	0	1	9	0	0
17	11708797	.	G	A	0	3	3	0	3	6	0	0
17	11709632	.	G	A	4	3	7	0	0	7	0	0
17	11711365	.	C	T	3	0	3	0	0	3	0	0
17	11714598	.	T	A	6	4	10	0	0	10	0	0
17	11714635	.	G	C	7	7	14	0	0	14	0	0
17	11714874	.	T	C	3	2	5	0	0	5	0	0
17	11715917	.	G	C	7	9	16	0	1	17	0	0
17	11716068	.	T	C	5	3	8	0	0	8	0	0
17	11716113	.	T	G	1	9	10	0	3	13	0	0
17	11716487	.	T	C	1	1	2	0	0	2	0	0
17	11716509	.	G	T	1	4	5	0	1	6	0	0
17	11716702	.	A	G	0	5	5	0	0	5	0	0
17	11717109	.	C	T	11	11	22	0	6	28	0	0
17	11717131	.	C	T	9	8	17	0	7	24	0	0
17	11718038	.	A	C	17	7	24	0	0	24	0	0
17	12236923	.	C	T	3	1	4	0	0	4	0	0
17	13763454	.	T	C	2	2	4	0	0	4	0	0
17	13763835	.	C	T	3	5	8	0	0	8	0	0
17	13764198	.	C	T	3	4	7	0	0	7	0	0
17	13764513	.	A	C	2	4	6	0	0	6	0	0
17	13764624	.	T	C	4	3	7	0	0	7	0	0
17	14443633	.	T	A	5	4	9	0	2	11	0	0
17	14443651	.	T	C	9	0	9	0	5	14	0	0
17	14443697	.	G	A	7	8	15	0	0	15	0	0
17	14443820	.	T	G	6	4	10	0	0	10	0	0
17	14443969	.	A	C	2	2	4	0	0	4	0	0
17	14444166	.	A	G	9	8	17	0	2	19	0	0
17	14444167	.	G	A	11	8	19	0	0	19	0	0
17	14447282	.	A	G	0	1	1	0	0	1	0	0
17	14451264	.	T	C	1	2	3	0	0	3	0	0
17	14457452	.	T	G	2	2	4	0	0	4	0	0
17	14458364	.	T	C	1	4	5	0	0	5	0	0
17	14467471	.	G	A	6	7	13	0	1	14	0	0
17	14468247	.	C	T	1	7	8	0	9	17	0	0
17	14468263	.	T	G	9	5	14	0	4	18	0	0
17	14468370	.	A	T	15	7	22	0	2	24	0	0
17	14468386	.	T	A	17	7	24	0	1	25	0	0
17	14468433	.	G	A	14	14	28	0	0	28	0	0
17	14470340	.	A	G	0	0	0	0	1	1	0	0
17	14494395	.	A	G	8	4	12	0	1	13	0	0
17	14494429	.	A	G	14	5	19	0	1	20	0	0
17	14502454	.	T	A	4	7	11	0	1	12	0	0
17	14523518	.	G	T	1	3	4	0	0	4	0	0
17	14614452	.	T	C	9	8	17	0	0	17	0	0
17	14614471	.	A	G	10	11	21	0	0	21	0	0
17	14614509	.	C	A	15	15	30	0	0	30	0	0
17	14614863	.	C	A	9	10	19	0	2	21	0	0
17	14614900	.	G	A	7	10	17	0	0	17	0	0
17	14614973	.	C	G	5	10	15	0	1	16	0	0
17	14615089	.	T	C	7	16	23	0	0	23	0	0
17	14617171	.	G	A	1	0	1	0	0	1	0	0
17	14618038	.	C	G	5	1	6	0	0	6	0	0
17	14618051	.	G	A	5	2	7	0	0	7	0	0
17	14618842	.	C	T	0	1	1	0	0	1	0	0
17	14618857	.	C	T	1	3	4	0	2	6	0	0
17	14620476	.	T	G	2	3	5	0	0	5	0	0
17	14623340	.	A	G	1	1	2	0	0	2	0	0
17	14623352	.	T	A	2	2	4	0	0	4	0	0
17	14623391	.	A	T	2	3	5	0	0	5	0	0
17	14624088	.	G	T	4	0	4	0	1	5	0	0
17	14627407	.	A	G	2	0	2	0	0	2	0	0
17	14694711	.	C	A	17	20	37	0	1	38	0	0
17	14694744	.	A	G	10	23	33	0	3	36	0	0
17	14694802	.	C	G	16	17	33	0	1	34	0	0
17	14722223	.	A	G	5	5	10	0	1	11	0	0
17	14723137	.	C	T	16	15	31	0	1	32	0	0
17	14723208	.	T	C	12	14	26	0	0	26	0	0
17	14723302	.	A	G	14	11	25	0	0	25	0	0
17	14724005	.	C	A	9	4	13	0	0	13	0	0
17	14724057	.	T	C	11	15	26	0	0	26	0	0
17	14724489	.	T	C	6	9	15	0	1	16	0	0
17	14724514	.	T	C	6	0	6	0	7	13	0	0
17	14725246	.	A	C	10	0	10	0	6	16	0	0
17	14725561	.	C	T	2	4	6	0	6	12	0	0
17	14725648	.	C	T	5	7	12	0	0	12	0	0
17	14725831	.	T	A	11	7	18	0	0	18	0	0
17	14731522	.	G	T	3	7	10	0	0	11	1	0
17	14731560	.	T	C	9	7	16	0	0	16	0	0
17	14731819	.	T	C	1	3	4	0	0	4	0	0
17	14734632	.	C	T	6	1	7	0	0	7	0	0
17	14734734	.	G	A	5	7	12	0	1	13	0	0
17	14737070	.	G	A	3	4	7	0	0	7	0	0
17	14751227	.	T	A	2	1	3	0	1	4	0	0
17	14755275	.	A	G	3	6	9	0	0	9	0	0
17	14755320	.	G	C	1	0	1	0	1	2	0	0
17	14755852	.	G	A	1	2	3	0	0	3	0	0
17	14756129	.	A	G	2	4	6	0	0	6	0	0
17	14758562	.	G	A	2	6	8	0	0	8	0	0
17	14768411	.	G	A	4	2	6	0	1	7	0	0
17	14768475	.	G	A	4	2	6	0	1	7	0	0
17	14768652	.	T	A	2	4	6	0	2	8	0	0
17	14770877	.	A	T	1	1	2	0	0	2	0	0
17	14784323	.	T	C	7	6	13	0	0	13	0	0
17	14785663	.	C	T	4	6	10	0	0	10	0	0
17	14794285	.	A	G	4	4	8	0	0	8	0	0
17	14794485	.	G	T	13	16	29	0	2	31	0	0
17	14794639	.	A	T	3	4	7	0	2	9	0	0
17	14794672	.	C	G	1	3	4	0	0	4	0	0
17	14919126	.	T	G	1	5	6	0	0	6	0	0
17	14933455	.	A	G	0	2	2	0	0	2	0	0
17	14938834	.	C	T	1	3	4	0	0	4	0	0
17	14945613	.	T	C	2	0	2	0	0	2	0	0
17	14948957	.	G	T	2	1	3	0	0	3	0	0
17	14948958	.	T	C	1	1	2	0	1	3	0	0
17	14953698	.	A	G	0	3	3	0	0	3	0	0
17	14953761	.	G	A	1	3	4	0	0	4	0	0
17	14953989	.	C	G	1	3	4	0	0	4	0	0
17	14953999	.	C	G	1	3	4	0	0	4	0	0
17	14954037	.	C	T	0	4	4	0	0	4	0	0
17	15113519	.	C	T	1	2	3	0	0	3	0	0
17	15113545	.	G	A	1	2	3	0	0	3	0	0
17	15117257	.	A	T	1	2	3	0	0	3	0	0
17	15117289	.	T	C	1	4	5	0	0	5	0	0
17	15122021	.	T	G	4	2	6	0	2	8	0	0
17	15122177	.	T	C	4	0	4	0	4	8	0	0
17	15123023	.	A	G	3	3	6	0	0	6	0	0
17	15124513	.	G	A	4	4	8	0	0	8	0	0
17	15125230	.	A	G	2	2	4	0	0	4	0	0
17	15125233	.	G	C	2	2	4	0	0	4	0	0
17	15126894	.	A	T	1	2	3	0	0	3	0	0
17	15126897	.	T	C	1	2	3	0	0	3	0	0
17	15149034	.	T	C	2	2	4	0	0	4	0	0
17	15213620	.	C	T	3	3	6	0	0	6	0	0
17	15219107	.	G	A	3	4	7	0	0	7	0	0
17	15219325	.	A	C	3	2	5	0	0	5	0	0
17	15219739	.	T	A	2	3	5	0	0	5	0	0
17	15220092	.	C	T	2	3	5	0	1	6	0	0
17	15224052	.	G	A	6	3	9	0	0	9	0	0
17	15229577	.	T	C	1	1	2	0	0	2	0	0
17	15309621	.	C	T	0	8	8	0	8	16	0	0
17	15316001	.	T	C	6	9	15	0	2	17	0	0
17	15316022	.	T	C	4	6	10	0	0	10	0	0
17	15319232	.	G	A	12	4	16	0	3	19	0	0
17	15353984	.	G	A	14	5	19	0	0	19	0	0
17	15374185	.	T	C	8	14	22	0	1	23	0	0
17	15374507	.	G	A	9	11	20	0	0	20	0	0
17	15382421	.	T	A	11	7	18	0	1	19	0	0
17	15382486	.	C	T	15	8	23	0	1	24	0	0
17	15633721	.	T	C	7	5	12	0	2	14	0	0
17	15639989	.	A	G	1	6	7	0	1	8	0	0
17	15741117	.	A	G	5	4	9	0	0	9	0	0
17	15741554	.	A	G	2	1	3	0	0	3	0	0
17	15892233	.	G	A	7	1	8	0	0	8	0	0
17	15892479	.	G	A	0	4	4	0	4	8	0	0
17	15933470	.	C	T	2	2	4	0	0	4	0	0
17	15943808	.	C	T	0	3	3	0	0	3	0	0
17	15943839	.	G	A	0	2	2	0	0	2	0	0
17	15964443	.	A	C	1	1	2	0	0	2	0	0
17	15964462	.	C	A	1	2	3	0	0	3	0	0
17	15964488	.	C	T	2	2	4	0	0	4	0	0
17	15965589	.	C	A	0	3	3	0	0	3	0	0
17	15965708	.	T	A	1	4	5	0	0	5	0	0
17	15983530	.	C	T	7	5	12	0	0	12	0	0
17	16022530	.	C	T	2	5	7	0	0	7	0	0
17	16024587	.	A	G	3	7	10	0	1	11	0	0
17	16024590	.	G	A	3	7	10	0	1	11	0	0
17	16024677	.	A	G	0	0	0	0	1	1	0	0
17	16026207	.	T	A	2	1	3	0	0	3	0	0
17	16026293	.	A	G	8	10	18	0	0	18	0	0
17	16026345	.	A	G	17	7	24	0	0	24	0	0
17	16026486	.	C	T	3	5	8	0	1	9	0	0
17	16026593	.	C	T	3	3	6	0	0	6	0	0
17	16027718	.	G	A	7	7	14	0	0	14	0	0
17	16027720	.	A	G	7	7	14	0	0	14	0	0
17	16027935	.	G	T	10	9	19	0	2	21	0	0
17	16027983	.	A	T	13	12	25	0	0	25	0	0
17	16028040	.	G	A	9	9	18	0	0	18	0	0
17	16028118	.	A	G	6	0	6	0	7	13	0	0
17	16051968	.	G	A	4	3	7	0	0	7	0	0
17	16052075	.	A	G	7	8	15	0	1	16	0	0
17	16052229	.	C	T	7	5	12	0	0	12	0	0
17	16052563	.	G	A	7	3	10	0	2	12	0	0
17	16052587	.	T	G	1	4	5	0	1	6	0	0
17	16055049	.	T	C	3	4	7	0	1	8	0	0
17	16055179	.	G	A	4	1	5	0	0	5	0	0
17	16057798	.	C	T	8	14	22	0	2	24	0	0
17	16057877	.	C	A	0	0	0	0	3	3	0	0
17	16059802	.	T	G	4	4	8	0	0	8	0	0
17	16059831	.	T	G	6	5	11	0	0	11	0	0
17	16059854	.	G	T	6	6	12	0	0	12	0	0
17	16059889	.	A	C	5	0	5	0	6	11	0	0
17	16059928	.	T	A	2	0	2	0	0	2	0	0
17	16064779	.	A	T	3	1	4	0	0	4	0	0
17	16064843	.	G	T	2	5	7	0	0	7	0	0
17	16096383	.	G	C	0	1	1	0	0	1	0	0
17	16096389	.	G	T	0	1	1	0	0	1	0	0
17	16107111	.	C	T	4	5	9	0	1	10	0	0
17	16107167	.	T	A	3	2	5	0	0	5	0	0
17	16107557	.	G	T	2	2	4	0	0	4	0	0
17	16107882	.	A	G	4	0	4	0	8	13	1	0
17	16108231	.	T	A	2	1	3	0	0	3	0	0
17	16108242	.	T	G	3	0	3	0	2	5	0	0
17	16110234	.	A	G	6	9	15	0	0	15	0	0
17	16110336	.	T	C	9	6	15	0	0	15	0	0
17	16110447	.	T	G	9	7	16	0	0	16	0	0
17	16110527	.	C	G	0	5	5	0	4	9	0	0
17	16110552	.	C	T	3	3	6	0	1	7	0	0
17	16110573	.	A	G	2	4	6	0	0	6	0	0
17	16110687	.	G	A	3	4	7	0	0	7	0	0
17	16111427	.	C	T	2	3	5	0	0	5	0	0
17	16342331	.	G	T	0	3	3	0	0	3	0	0
17	16804782	.	T	A	1	10	11	0	0	11	0	0
17	16805708	.	A	G	1	2	3	0	1	4	0	0
17	18070138	.	G	A	2	14	16	0	1	17	0	0
17	18179927	.	T	C	6	6	12	1	2	15	0	0
17	19431598	.	A	G	1	5	6	0	0	6	0	0
17	19439990	.	G	A	1	5	6	0	0	6	0	0
17	20202425	.	G	A	4	1	5	0	0	5	0	0
17	20202446	.	T	C	0	2	2	0	0	2	0	0
17	21156140	.	G	T	0	3	3	0	2	5	0	0
17	21821605	.	C	T	10	4	14	0	0	14	0	0
17	23575242	.	A	G	2	2	4	0	1	5	0	0
17	24081209	.	A	G	2	2	4	0	1	5	0	0
17	24443182	.	G	C	0	5	5	0	0	5	0	0
17	26285347	.	A	G	2	0	2	0	1	3	0	0
17	26285350	.	G	T	2	1	3	0	0	3	0	0
17	26298967	.	C	T	2	3	5	0	0	5	0	0
17	26335000	.	G	A	1	1	2	0	0	2	0	0
17	26362130	.	G	A	5	5	10	0	4	14	0	0
17	26362500	.	C	T	3	2	5	0	0	5	0	0
17	26362512	.	A	C	2	4	6	0	0	6	0	0
17	26362539	.	C	T	4	3	7	0	0	7	0	0
17	26362741	.	C	T	2	7	9	0	1	11	1	0
17	26477857	.	T	C	4	10	14	0	0	14	0	0
17	26477860	.	C	T	4	10	14	0	1	15	0	0
17	26478023	.	T	C	9	5	14	0	0	14	0	0
17	26478403	.	T	G	2	7	9	0	1	10	0	0
17	26478592	.	A	G	10	17	27	0	1	28	0	0
17	26478818	.	T	C	5	0	5	0	6	11	0	0
17	26478952	.	G	A	8	6	14	0	0	14	0	0
17	26478986	.	A	G	7	8	15	0	0	15	0	0
17	26479145	.	T	C	14	10	24	0	2	26	0	0
17	26479960	.	C	T	3	4	7	0	0	7	0	0
17	26479997	.	A	T	3	2	5	0	0	5	0	0
17	26480421	.	A	G	5	4	9	0	1	10	0	0
17	26480423	.	T	C	5	4	9	0	1	10	0	0
17	26480622	.	A	T	3	6	9	0	0	9	0	0
17	26480683	.	A	G	4	3	7	0	0	7	0	0
17	26480926	.	T	G	1	2	3	0	0	3	0	0
17	26502047	.	A	C	0	0	0	0	1	1	0	0
17	26502107	.	G	A	10	4	14	0	0	14	0	0
17	26507294	.	G	A	3	1	4	0	0	4	0	0
17	26516745	.	G	C	1	2	3	0	1	4	0	0
17	26516878	.	G	A	1	2	3	0	1	4	0	0
17	26519475	.	T	C	1	0	1	0	2	3	0	0
17	26577293	.	T	C	2	2	4	0	0	4	0	0
17	26585135	.	G	T	5	6	11	0	0	11	0	0
17	26585163	.	A	T	5	5	10	0	0	10	0	0
17	26585298	.	G	T	0	7	7	0	4	11	0	0
17	26585316	.	C	T	10	4	14	0	0	14	0	0
17	26585727	.	C	T	6	14	20	0	1	21	0	0
17	26585748	.	A	G	17	0	17	0	8	25	0	0
17	26585763	.	T	A	15	10	25	0	2	27	0	0
17	26590001	.	T	G	8	5	13	0	3	16	0	0
17	26590054	.	C	T	9	4	13	0	2	15	0	0
17	26590091	.	C	T	6	7	13	0	0	13	0	0
17	26590330	.	T	C	11	6	17	0	0	17	0	0
17	26590536	.	G	A	1	4	5	0	1	6	0	0
17	26590650	.	G	T	3	6	9	0	0	9	0	0
17	26594931	.	C	T	6	7	13	0	1	14	0	0
17	26594968	.	G	C	4	3	7	0	0	7	0	0
17	26599208	.	C	T	0	1	1	0	2	3	0	0
17	26600555	.	T	A	4	2	6	0	0	6	0	0
17	26600639	.	G	A	2	6	8	0	0	8	0	0
17	26600667	.	C	T	4	0	4	0	0	4	0	0
17	26600785	.	G	A	1	1	2	0	0	2	0	0
17	26600881	.	G	A	2	4	6	0	1	7	0	0
17	26603369	.	A	T	5	0	5	0	0	5	0	0
17	26604751	.	G	C	3	3	6	0	0	6	0	0
17	26604758	.	C	T	3	3	6	0	0	6	0	0
17	26604801	.	C	A	6	2	8	0	0	8	0	0
17	26604917	.	G	A	3	2	5	0	0	5	0	0
17	26612007	.	G	T	2	3	5	0	0	5	0	0
17	26630909	.	C	T	4	4	8	0	0	8	0	0
17	26639659	.	C	T	6	9	15	0	1	16	0	0
17	26639725	.	A	G	3	0	3	0	8	11	0	0
17	26642775	.	C	A	5	4	9	0	0	9	0	0
17	26642817	.	T	G	8	0	8	0	5	13	0	0
17	26642818	.	T	C	8	4	12	0	1	13	0	0
17	26657852	.	T	C	9	10	19	0	0	19	0	0
17	26662347	.	C	T	3	4	7	0	0	7	0	0
17	26683526	.	C	T	14	10	24	0	0	24	0	0
17	26689753	.	G	A	11	17	28	0	7	35	0	0
17	26689768	.	C	A	19	8	27	0	4	31	0	0
17	26689792	.	C	A	4	20	24	0	0	24	0	0
17	26690112	.	T	A	19	10	29	0	1	30	0	0
17	26690250	.	C	T	8	6	14	0	1	15	0	0
17	26690276	.	C	T	10	10	20	0	0	20	0	0
17	26690478	.	C	T	11	18	29	0	0	30	1	0
17	26690558	.	G	A	0	15	15	0	14	29	0	0
17	26714009	.	C	T	30	29	59	0	5	65	1	0
17	26735735	.	T	C	1	2	3	0	0	3	0	0
17	26740350	.	A	G	0	0	0	0	2	2	0	0
17	26741362	.	A	G	1	0	1	0	1	2	0	0
17	26744174	.	G	A	2	2	4	0	0	4	0	0
17	26744207	.	G	C	1	2	3	0	0	3	0	0
17	26744706	.	T	C	4	2	6	0	0	6	0	0
17	26744981	.	C	T	2	3	5	0	1	6	0	0
17	26745106	.	T	C	5	3	8	0	0	8	0	0
17	26745110	.	C	T	5	3	8	0	0	8	0	0
17	26747392	.	G	T	1	0	1	0	0	1	0	0
17	26810380	.	C	T	8	14	22	0	0	22	0	0
17	26846203	.	C	T	4	9	13	0	1	14	0	0
17	26846650	.	G	A	2	3	5	0	3	8	0	0
17	26846707	.	G	A	0	5	5	0	4	9	0	0
17	26846901	.	T	G	10	5	15	0	0	15	0	0
17	26847905	.	C	A	4	2	6	0	0	6	0	0
17	26879854	.	A	C	14	11	25	0	0	25	0	0
17	26879869	.	A	G	17	9	26	0	1	27	0	0
17	26879893	.	A	G	13	22	35	0	2	37	0	0
17	26880107	.	G	A	14	19	33	0	1	34	0	0
17	26880231	.	T	C	22	22	44	0	3	47	0	0
17	26880424	.	T	C	28	18	46	0	1	47	0	0
17	26880699	.	T	C	13	8	21	0	3	24	0	0
17	26880765	.	T	C	3	10	13	0	0	13	0	0
17	26880781	.	T	C	8	8	16	0	1	17	0	0
17	26880926	.	T	C	15	1	16	0	21	37	0	0
17	26880964	.	A	G	23	19	42	0	0	42	0	0
17	26881131	.	T	A	20	6	26	0	4	30	0	0
17	26881354	.	A	G	20	16	36	0	2	38	0	0
17	26881777	.	A	G	21	18	39	0	2	41	0	0
17	26911747	.	A	G	19	18	37	0	2	39	0	0
17	26924308	.	C	T	0	2	2	0	4	6	0	0
17	26928727	.	T	C	0	2	2	0	0	2	0	0
17	26928994	.	C	T	1	5	6	1	0	7	0	0
17	26929475	.	T	C	4	4	8	0	0	8	0	0
17	26929577	.	C	A	3	6	9	0	0	9	0	0
17	26929649	.	A	G	4	2	6	0	0	6	0	0
17	26929654	.	T	A	2	4	6	0	0	6	0	0
17	26929776	.	C	T	2	5	7	0	0	7	0	0
17	26929893	.	G	A	7	5	12	0	0	12	0	0
17	26933328	.	C	T	0	1	1	0	1	2	0	0
17	26934417	.	C	T	0	6	6	0	3	9	0	0
17	26935160	.	C	T	1	0	1	0	0	1	0	0
17	26935274	.	G	T	6	2	8	0	0	8	0	0
17	26985158	.	G	A	0	11	11	0	11	22	0	0
17	26985544	.	T	A	2	2	4	0	2	6	0	0
17	26985561	.	T	G	3	0	3	0	6	9	0	0
17	26985586	.	C	T	3	8	11	0	0	11	0	0
17	26985638	.	T	G	7	11	18	0	0	18	0	0
17	26985656	.	T	A	6	9	15	0	1	16	0	0
17	26985692	.	G	T	1	7	8	0	1	9	0	0
17	27064523	.	T	A	1	3	4	0	0	4	0	0
17	27064840	.	G	C	1	4	5	0	3	8	0	0
17	27162479	.	C	T	1	0	1	0	0	1	0	0
17	27164530	.	C	T	1	2	3	0	0	3	0	0
17	27166257	.	T	C	2	2	4	0	1	5	0	0
17	27166521	.	C	T	1	1	2	0	0	2	0	0
17	27168957	.	G	T	0	1	1	0	2	3	0	0
17	27169783	.	A	C	5	6	11	0	3	14	0	0
17	27170153	.	A	T	3	6	9	0	0	9	0	0
17	27170341	.	G	A	3	2	5	0	0	5	0	0
17	27170390	.	G	T	4	2	6	0	0	6	0	0
17	27170516	.	G	A	0	8	8	0	6	14	0	0
17	27170549	.	G	A	5	7	12	0	1	13	0	0
17	27170605	.	T	G	15	5	20	0	0	20	0	0
17	27170678	.	C	A	7	7	14	0	0	14	0	0
17	27170730	.	T	G	5	6	11	0	0	11	0	0
17	27170746	.	A	T	2	10	12	0	1	13	0	0
17	27171314	.	A	C	2	3	5	0	0	5	0	0
17	27176640	.	G	A	6	4	10	0	0	10	0	0
17	27176871	.	G	A	4	3	7	0	0	7	0	0
17	27176967	.	G	C	1	5	6	0	0	6	0	0
17	27176991	.	C	T	1	7	8	0	0	8	0	0
17	27177083	.	G	A	0	4	4	0	2	6	0	0
17	27177251	.	A	G	2	3	5	0	0	5	0	0
17	27177302	.	A	G	2	0	2	0	3	5	0	0
17	27177473	.	C	T	4	5	9	0	1	10	0	0
17	27177560	.	A	C	1	3	4	0	0	4	0	0
17	27177945	.	G	T	0	5	5	0	0	5	0	0
17	27178024	.	T	A	3	5	8	0	0	8	0	0
17	27178088	.	T	A	3	2	5	0	0	5	0	0
17	27178191	.	G	A	2	5	7	0	0	7	0	0
17	27178232	.	A	G	2	4	6	0	0	6	0	0
17	27178254	.	C	A	5	2	7	0	0	7	0	0
17	27178273	.	G	T	2	2	4	0	0	4	0	0
17	27178296	.	G	A	0	2	2	0	2	4	0	0
17	27178356	.	T	A	2	5	7	0	0	7	0	0
17	27178383	.	C	G	2	6	8	0	0	8	0	0
17	27178401	.	C	T	5	2	7	0	0	7	0	0
17	27178557	.	C	T	7	9	16	0	0	16	0	0
17	27178638	.	C	G	3	3	6	0	1	7	0	0
17	27178730	.	C	A	2	5	7	0	0	7	0	0
17	27178870	.	T	C	3	4	7	0	0	7	0	0
17	27179189	.	A	G	6	4	10	0	0	10	0	0
17	27179203	.	G	T	1	4	5	0	5	10	0	0
17	27179434	.	G	T	4	3	7	0	0	7	0	0
17	27179848	.	A	G	1	5	6	0	0	6	0	0
17	27180022	.	C	A	1	2	3	0	0	3	0	0
17	27180407	.	T	A	4	2	6	0	0	6	0	0
17	27180447	.	A	T	2	2	4	0	0	4	0	0
17	27180847	.	A	G	5	6	11	0	2	13	0	0
17	27181021	.	T	C	3	6	9	0	1	10	0	0
17	27181048	.	C	G	5	6	11	0	0	11	0	0
17	27181129	.	G	A	7	12	19	0	1	20	0	0
17	27181130	.	G	A	7	12	19	0	1	20	0	0
17	27181257	.	A	C	13	7	20	0	0	20	0	0
17	27181323	.	A	G	9	0	9	0	11	20	0	0
17	27181411	.	A	G	10	1	11	0	5	16	0	0
17	27181427	.	C	T	6	7	13	0	0	13	0	0
17	27181463	.	A	G	3	0	3	0	4	7	0	0
17	27181481	.	A	G	1	4	5	0	0	5	0	0
17	27181618	.	C	A	2	3	5	0	0	5	0	0
17	27181680	.	C	T	2	6	8	0	0	8	0	0
17	27182006	.	G	T	13	3	16	0	0	17	1	0
17	27182039	.	T	C	11	8	19	0	0	19	0	0
17	27182114	.	A	G	3	12	15	0	0	15	0	0
17	27182146	.	C	T	6	7	13	0	2	15	0	0
17	27182331	.	T	G	2	4	6	0	0	6	0	0
17	27182340	.	C	T	1	4	5	0	0	5	0	0
17	27182449	.	G	T	3	7	10	0	0	10	0	0
17	27182484	.	T	C	4	13	17	0	0	17	0	0
17	27182645	.	G	T	15	12	27	0	0	27	0	0
17	27182649	.	A	G	16	12	28	0	1	29	0	0
17	27182769	.	A	G	8	5	13	0	0	13	0	0
17	27182894	.	T	C	8	11	19	0	0	19	0	0
17	27182925	.	A	T	7	10	17	0	0	17	0	0
17	27182979	.	C	T	8	10	18	0	1	19	0	0
17	27192698	.	C	T	1	2	3	0	0	3	0	0
17	27194183	.	A	G	3	2	5	0	0	5	0	0
17	27194669	.	C	T	1	1	2	0	0	2	0	0
17	27272913	.	T	C	6	5	11	0	1	12	0	0
17	27273013	.	C	T	6	4	10	0	0	10	0	0
17	27337154	.	A	G	1	2	3	0	0	3	0	0
17	27401038	.	A	T	4	6	10	0	5	15	0	0
17	27401304	.	C	T	3	2	5	0	1	6	0	0
17	27408386	.	A	G	8	12	20	0	0	20	0	0
17	27408472	.	C	T	9	10	19	0	5	24	0	0
17	27408523	.	G	T	5	6	11	0	3	14	0	0
17	27408531	.	T	A	5	6	11	0	1	12	0	0
17	27408836	.	T	G	1	9	10	0	0	10	0	0
17	27408889	.	T	C	2	6	8	0	0	8	0	0
17	27413564	.	T	C	1	1	2	0	1	3	0	0
17	27413705	.	T	C	7	11	18	0	0	18	0	0
17	27414035	.	G	A	3	6	9	0	2	11	0	0
17	27414098	.	C	A	6	11	17	0	0	17	0	0
17	27414203	.	G	A	5	9	14	0	3	17	0	0
17	27414215	.	C	T	0	7	7	0	10	17	0	0
17	27414367	.	A	G	10	5	15	0	2	17	0	0
17	27414658	.	T	C	7	7	14	0	0	14	0	0
17	27414701	.	A	G	7	3	10	0	0	10	0	0
17	27414791	.	A	G	3	8	11	0	0	11	0	0
17	27414815	.	G	A	4	9	13	0	0	13	0	0
17	27415010	.	C	T	1	4	5	0	8	13	0	0
17	27723800	.	G	T	5	9	14	0	1	15	0	0
17	27807455	.	T	C	18	16	34	0	1	35	0	0
17	27808190	.	A	G	6	0	6	0	11	17	0	0
17	27808335	.	A	G	15	13	28	0	1	29	0	0
17	27808686	.	G	A	5	6	11	0	0	11	0	0
17	27808700	.	G	A	6	8	14	0	0	14	0	0
17	27808987	.	G	T	0	22	22	0	25	47	0	0
17	27809548	.	T	A	15	14	29	0	0	29	0	0
17	27809631	.	G	T	0	6	6	0	12	18	0	0
17	27809779	.	C	A	18	18	36	0	0	36	0	0
17	27809885	.	A	G	23	18	41	0	1	42	0	0
17	27811199	.	T	A	4	4	8	0	0	8	0	0
17	27811209	.	A	G	4	4	8	0	1	9	0	0
17	27811254	.	T	C	4	3	7	0	0	7	0	0
17	27811277	.	C	G	2	4	6	0	0	6	0	0
17	27812292	.	T	A	3	2	5	0	1	6	0	0
17	27812525	.	A	C	18	9	27	0	2	29	0	0
17	27812562	.	G	A	0	11	11	0	21	32	0	0
17	27812702	.	A	T	17	9	26	0	0	26	0	0
17	27812780	.	T	A	2	3	5	0	0	5	0	0
17	27812885	.	C	T	4	3	7	0	1	8	0	0
17	27813221	.	C	T	11	4	15	0	0	15	0	0
17	27813222	.	A	G	11	4	15	0	0	15	0	0
17	27813549	.	C	G	6	4	10	0	1	11	0	0
17	27813553	.	C	G	8	4	12	0	0	12	0	0
17	28049663	.	A	T	4	4	8	0	0	8	0	0
17	28049804	.	G	T	8	4	12	0	0	12	0	0
17	28050500	.	T	A	4	4	8	0	0	8	0	0
17	28050530	.	A	G	6	2	8	0	1	9	0	0
17	28050954	.	G	A	3	2	5	0	1	6	0	0
17	28051465	.	T	C	1	5	6	0	0	6	0	0
17	28051504	.	G	T	3	5	8	0	0	8	0	0
17	28051739	.	A	G	10	10	20	0	0	20	0	0
17	28052322	.	C	A	7	8	15	0	0	15	0	0
17	28067389	.	C	T	7	5	12	0	0	12	0	0
17	28067472	.	A	C	9	12	21	0	1	22	0	0
17	28067618	.	A	G	3	5	8	0	0	8	0	0
17	28067856	.	C	T	7	7	14	0	1	15	0	0
17	28068083	.	T	C	7	8	15	0	0	15	0	0
17	28068087	.	G	T	7	8	15	0	0	15	0	0
17	28068168	.	G	A	5	3	8	0	0	8	0	0
17	28068262	.	T	G	10	0	10	0	11	21	0	0
17	28068276	.	C	T	8	10	18	0	0	18	0	0
17	28068507	.	A	G	11	3	14	0	0	14	0	0
17	28068514	.	T	C	10	5	15	0	0	15	0	0
17	28068832	.	T	A	6	5	11	0	0	11	0	0
17	28068916	.	C	T	8	4	12	0	0	12	0	0
17	28069170	.	G	A	11	11	22	0	0	22	0	0
17	28069341	.	G	T	8	8	16	0	0	16	0	0
17	28069342	.	T	C	8	8	16	0	0	16	0	0
17	28069645	.	G	T	7	12	19	0	0	19	0	0
17	28069716	.	G	C	15	14	29	0	1	30	0	0
17	28069787	.	G	A	0	15	15	0	11	26	0	0
17	28070078	.	G	C	10	8	18	0	0	18	0	0
17	28070167	.	C	T	9	9	18	0	0	18	0	0
17	28070284	.	G	A	5	4	9	0	3	12	0	0
17	28070286	.	A	C	7	4	11	0	0	12	1	0
17	28070481	.	T	A	14	15	29	0	0	29	0	0
17	28070600	.	C	A	11	16	27	0	2	29	0	0
17	28070840	.	G	A	4	12	16	0	0	16	0	0
17	28070879	.	T	G	6	7	13	0	2	15	0	0
17	28070897	.	T	A	6	8	14	0	0	14	0	0
17	28071260	.	A	G	9	8	17	0	0	17	0	0
17	28084592	.	C	T	8	7	15	0	2	17	0	0
17	28084908	.	C	T	14	16	30	0	0	30	0	0
17	28097235	.	G	A	0	3	3	0	0	3	0	0
17	28100598	.	C	T	0	5	5	0	11	16	0	0
17	28167312	.	G	A	4	2	6	0	0	6	0	0
17	28167313	.	A	T	4	2	6	0	0	6	0	0
17	28168645	.	C	T	2	2	4	0	0	4	0	0
17	28168712	.	T	A	2	7	9	0	0	9	0	0
17	28168941	.	A	T	1	3	4	0	0	4	0	0
17	28340740	.	A	T	2	4	6	0	1	7	0	0
17	28440212	.	T	A	4	2	6	0	1	7	0	0
17	28461857	.	G	A	0	6	6	0	6	12	0	0
17	28466273	.	C	T	3	2	5	0	0	5	0	0
17	28640625	.	C	T	1	4	5	0	0	5	0	0
17	28655195	.	G	A	0	1	1	0	1	2	0	0
17	28658563	.	A	G	2	2	4	0	0	4	0	0
17	28661931	.	G	T	0	3	3	0	4	7	0	0
17	28666381	.	C	T	1	0	1	0	0	1	0	0
17	28670351	.	T	A	2	3	5	0	0	5	0	0
17	28670352	.	C	T	2	3	5	0	0	5	0	0
17	28680593	.	T	C	5	4	9	0	0	9	0	0
17	28683074	.	C	T	1	2	3	0	0	3	0	0
17	28688931	.	G	T	2	7	9	0	2	12	1	0
17	28694574	.	A	T	1	0	1	0	0	1	0	0
17	28694589	.	T	C	2	3	5	0	0	5	0	0
17	28695956	.	G	A	3	10	13	0	2	15	0	0
17	28696109	.	C	A	10	11	21	0	0	21	0	0
17	28696160	.	C	T	13	10	23	0	2	25	0	0
17	28696311	.	C	T	9	12	21	0	0	21	0	0
17	28696397	.	A	G	9	0	9	0	11	20	0	0
17	28700311	.	T	C	2	1	3	0	0	3	0	0
17	28700428	.	G	A	18	19	37	0	1	38	0	0
17	28701100	.	G	A	8	10	18	0	0	18	0	0
17	28707851	.	C	A	0	6	6	0	5	11	0	0
17	28730705	.	C	T	3	1	4	0	0	4	0	0
17	28738387	.	C	T	6	4	10	0	0	10	0	0
17	28741421	.	A	C	13	5	18	0	1	19	0	0
17	28741540	.	A	G	16	0	16	0	7	23	0	0
17	28741752	.	C	T	12	9	21	0	0	21	0	0
17	28741934	.	C	T	9	8	17	0	1	18	0	0
17	28742263	.	G	C	6	17	23	0	2	25	0	0
17	28742385	.	T	A	8	7	15	0	3	18	0	0
17	28742395	.	G	A	0	9	9	0	10	19	0	0
17	28742559	.	C	T	19	13	32	0	0	32	0	0
17	28742681	.	C	T	4	3	7	0	0	7	0	0
17	28771228	.	T	A	1	3	4	0	0	4	0	0
17	28777803	.	C	T	1	3	4	0	0	4	0	0
17	28784090	.	G	T	3	3	6	0	1	7	0	0
17	28784102	.	G	A	3	3	6	0	1	7	0	0
17	28785010	.	G	A	1	5	6	0	1	7	0	0
17	28785013	.	C	T	5	1	6	0	1	7	0	0
17	28789014	.	C	T	0	4	4	0	0	4	0	0
17	28793818	.	G	A	2	1	3	0	0	3	0	0
17	28948818	.	G	A	2	2	4	0	0	4	0	0
17	28958371	.	C	T	1	2	3	0	0	3	0	0
17	28959148	.	T	C	7	9	16	0	1	17	0	0
17	28968461	.	T	C	8	15	23	0	1	24	0	0
17	28968611	.	C	T	5	6	11	0	1	12	0	0
17	29252207	.	G	A	5	6	11	0	0	11	0	0
17	29252254	.	C	T	1	7	8	0	0	8	0	0
17	29253050	.	T	C	2	1	3	0	0	3	0	0
17	29282901	.	C	A	8	2	10	0	0	10	0	0
17	29283380	.	T	A	3	4	7	0	0	7	0	0
17	29283421	.	G	A	4	2	6	0	1	7	0	0
17	29283422	.	C	T	5	2	7	0	0	7	0	0
17	29283688	.	G	C	4	3	7	0	0	7	0	0
17	29283866	.	T	C	9	4	13	0	0	13	0	0
17	29283920	.	A	C	4	0	4	0	7	12	1	0
17	29283943	.	A	G	2	7	9	0	0	9	0	0
17	29283962	.	A	G	1	3	4	0	0	4	0	0
17	29288057	.	G	T	3	2	5	0	0	5	0	0
17	29288718	.	A	G	3	2	5	0	0	5	0	0
17	29297901	.	A	G	3	3	6	0	0	6	0	0
17	29297907	.	C	A	0	3	3	0	3	6	0	0
17	29298191	.	G	C	2	0	2	0	1	3	0	0
17	29300641	.	A	T	0	3	3	0	0	3	0	0
17	29300650	.	A	G	1	3	4	0	0	4	0	0
17	29306455	.	G	A	3	3	6	0	0	6	0	0
17	29306598	.	A	C	1	4	5	0	1	6	0	0
17	29306670	.	C	T	1	4	5	0	0	5	0	0
17	29306854	.	C	T	0	0	0	0	1	1	0	0
17	29308693	.	G	A	6	3	9	0	1	10	0	0
17	29308706	.	G	A	6	4	10	0	0	10	0	0
17	29308987	.	A	T	0	2	2	0	1	3	0	0
17	29310619	.	T	C	2	3	5	0	0	5	0	0
17	29311791	.	C	T	0	2	2	0	1	3	0	0
17	29312376	.	G	A	0	2	2	0	0	2	0	0
17	29334520	.	T	A	2	2	4	0	0	4	0	0
17	29334569	.	A	C	3	4	7	0	0	7	0	0
17	29335645	.	G	A	2	1	3	0	0	3	0	0
17	29336179	.	G	A	3	2	5	0	0	5	0	0
17	29336180	.	G	T	2	2	4	0	1	5	0	0
17	29341079	.	C	T	7	8	15	0	1	16	0	0
17	29341123	.	C	A	6	6	12	0	0	12	0	0
17	29345725	.	T	G	2	2	4	0	0	4	0	0
17	29345890	.	T	A	3	4	7	0	0	7	0	0
17	29366113	.	G	A	0	5	5	0	5	10	0	0
17	29369642	.	G	T	8	11	19	0	0	19	0	0
17	29369644	.	G	A	8	11	19	0	0	19	0	0
17	29797906	.	C	T	10	9	19	0	1	20	0	0
17	29804291	.	G	C	8	6	14	0	0	14	0	0
17	29876956	.	G	A	0	2	2	0	1	3	0	0
17	29877079	.	C	T	0	5	5	0	1	6	0	0
17	29877094	.	A	G	3	2	5	0	0	5	0	0
17	29877283	.	C	A	0	3	3	0	7	10	0	0
17	30412354	.	G	A	1	6	7	0	0	7	0	0
17	30450275	.	G	A	3	2	5	0	0	5	0	0
17	30453514	.	A	G	2	0	2	0	2	4	0	0
17	30460090	.	C	T	2	1	3	0	0	3	0	0
17	30585555	.	A	T	6	2	8	0	1	9	0	0
17	30590075	.	A	T	8	9	17	0	1	18	0	0
17	30590661	.	G	A	2	2	4	0	0	4	0	0
17	30590663	.	T	A	1	2	3	0	1	4	0	0
17	30857431	.	A	T	2	4	6	0	0	6	0	0
17	30857433	.	A	T	1	4	5	0	1	6	0	0
17	30979391	.	T	C	11	0	11	0	7	18	0	0
17	30979465	.	T	C	4	6	10	0	1	11	0	0
17	31277674	.	C	A	5	2	7	0	0	7	0	0
17	31393051	.	T	C	3	2	5	0	0	5	0	0
17	33306079	.	A	G	4	1	5	0	3	8	0	0
17	33306088	.	A	G	1	5	6	0	2	8	0	0
17	33306121	.	A	G	0	10	10	0	3	13	0	0
17	33306743	.	A	G	4	0	4	0	4	8	0	0
17	35248121	.	T	A	3	7	10	0	2	12	0	0
17	35295189	.	G	A	1	1	2	0	0	2	0	0
17	36938782	.	T	C	9	0	9	0	7	16	0	0
17	37362076	.	A	T	10	0	10	0	2	13	1	0
17	37363938	.	A	G	1	0	1	0	3	4	0	0
17	37364026	.	A	G	9	0	9	0	4	13	0	0
17	37445729	.	G	A	1	2	3	0	0	3	0	0
17	37445924	.	G	A	10	3	13	0	0	13	0	0
17	37445926	.	A	T	3	10	13	0	0	13	0	0
17	37446208	.	A	T	6	8	14	0	0	14	0	0
17	37446379	.	T	C	3	2	5	0	0	5	0	0
17	37446443	.	T	G	6	2	8	0	0	8	0	0
17	37446555	.	T	A	6	10	16	0	0	16	0	0
17	37446563	.	G	A	6	10	16	0	0	16	0	0
17	37446735	.	G	A	8	16	24	0	1	25	0	0
17	37446789	.	A	C	10	2	12	0	2	14	0	0
17	37449200	.	G	C	1	2	3	0	1	4	0	0
17	37570871	.	A	G	3	3	6	0	1	7	0	0
17	37585002	.	A	G	3	4	7	0	0	7	0	0
17	37590024	.	C	T	1	0	1	0	0	1	0	0
17	37593662	.	C	T	1	1	2	0	0	2	0	0
17	37603748	.	G	A	0	3	3	0	4	7	0	0
17	37605870	.	A	G	4	0	4	0	4	8	0	0
17	37606011	.	G	A	0	2	2	0	5	7	0	0
17	37606101	.	G	A	0	4	4	0	6	10	0	0
17	37606116	.	G	A	2	2	4	0	1	5	0	0
17	37618028	.	C	G	0	5	5	0	0	5	0	0
17	37618070	.	T	C	1	7	8	0	1	9	0	0
17	37618083	.	T	G	5	7	12	0	0	12	0	0
17	37618157	.	A	C	3	7	10	0	1	11	0	0
17	37618485	.	C	T	6	7	13	0	1	14	0	0
17	37624913	.	A	T	4	12	16	0	0	16	0	0
17	37648766	.	C	T	2	4	6	0	0	6	0	0
17	37792745	.	A	G	7	5	12	0	0	12	0	0
17	37793456	.	C	T	0	3	3	0	5	8	0	0
17	37793606	.	T	A	1	2	3	0	3	6	0	0
17	37793627	.	G	A	5	3	8	0	0	8	0	0
17	37794035	.	G	A	2	4	6	0	0	6	0	0
17	37795730	.	C	T	1	3	4	0	0	4	0	0
17	37795756	.	A	T	1	3	4	0	0	4	0	0
17	38021778	.	G	A	2	2	4	0	0	4	0	0
17	38232211	.	A	T	4	6	10	0	0	11	1	0
17	38232237	.	T	C	3	3	6	0	0	6	0	0
17	38263804	.	A	G	4	8	12	0	1	13	0	0
17	38263912	.	G	C	0	4	4	0	2	6	0	0
17	38264044	.	G	T	8	5	13	0	0	13	0	0
17	38295991	.	C	T	0	5	5	0	0	5	0	0
17	38296644	.	T	G	1	4	5	0	0	5	0	0
17	38303423	.	C	T	6	6	12	0	0	12	0	0
17	38303607	.	A	G	2	3	5	0	0	5	0	0
17	38303652	.	G	A	0	2	2	0	2	4	0	0
17	38393473	.	A	C	1	0	1	0	2	3	0	0
17	38393633	.	G	A	3	2	5	0	0	5	0	0
17	38393663	.	C	T	0	3	3	0	3	6	0	0
17	38393681	.	G	T	2	4	6	0	0	6	0	0
17	38394151	.	G	T	3	2	5	0	0	5	0	0
17	38471166	.	G	T	1	1	2	0	0	2	0	0
17	38471564	.	C	T	1	1	2	0	0	2	0	0
17	38712775	.	T	G	3	3	6	0	0	6	0	0
17	38714125	.	A	T	1	3	4	0	1	5	0	0
17	38714133	.	G	T	2	3	5	0	0	5	0	0
17	38714280	.	A	T	3	4	7	0	0	7	0	0
17	38714578	.	A	T	4	3	7	0	1	8	0	0
17	38740684	.	T	C	3	7	10	0	0	10	0	0
17	38740698	.	A	T	3	7	10	0	0	10	0	0
17	38749800	.	G	A	1	0	1	0	0	1	0	0
17	38749807	.	G	A	0	1	1	0	0	1	0	0
17	38751711	.	T	A	1	3	4	0	0	4	0	0
17	38754825	.	C	A	0	1	1	0	0	1	0	0
17	38755038	.	A	G	3	7	10	0	2	12	0	0
17	38756777	.	T	G	7	11	18	0	1	19	0	0
17	38758682	.	G	A	4	4	8	0	0	9	1	0
17	38760619	.	G	A	1	1	2	0	0	2	0	0
17	38761035	.	A	G	4	3	7	0	0	7	0	0
17	38768370	.	G	T	0	1	1	0	0	1	0	0
17	38768433	.	C	T	0	2	2	0	3	5	0	0
17	38768483	.	G	A	1	1	2	0	0	2	0	0
17	38769924	.	T	A	0	1	1	0	0	1	0	0
17	38769935	.	T	C	0	1	1	0	0	1	0	0
17	38769975	.	G	A	0	1	1	0	0	1	0	0
17	38784385	.	G	A	14	8	22	0	2	24	0	0
17	38784387	.	T	A	1	22	23	0	1	24	0	0
17	38784477	.	T	C	19	9	28	0	1	29	0	0
17	38784545	.	G	T	4	6	10	0	0	10	0	0
17	38784642	.	T	C	7	10	17	0	0	17	0	0
17	38787327	.	G	A	2	4	6	0	0	6	0	0
17	38787498	.	G	A	1	3	4	0	1	5	0	0
17	38787540	.	A	T	3	1	4	0	0	4	0	0
17	38804808	.	C	T	1	1	2	0	0	2	0	0
17	38804853	.	A	T	2	8	10	0	0	10	0	0
17	38887156	.	C	T	0	3	3	0	4	7	0	0
17	38887271	.	T	G	1	2	3	0	3	6	0	0
17	38928073	.	A	T	1	4	5	0	0	5	0	0
17	38928947	.	A	T	1	2	3	0	0	3	0	0
17	38929142	.	T	G	8	6	14	0	0	14	0	0
17	38929437	.	C	T	1	4	5	0	1	6	0	0
17	38938727	.	G	A	2	3	5	0	0	5	0	0
17	38941286	.	G	A	3	4	7	0	0	7	0	0
17	39184321	.	G	C	1	2	3	0	2	5	0	0
17	39697690	.	T	C	2	3	5	0	1	6	0	0
17	39704680	.	C	T	0	2	2	0	1	3	0	0
17	39707421	.	C	T	4	4	8	0	0	8	0	0
17	39717616	.	T	C	1	1	2	0	0	2	0	0
17	39717645	.	A	G	2	0	2	0	5	7	0	0
17	39720791	.	T	C	7	3	10	0	0	10	0	0
17	39728239	.	C	T	7	5	12	0	1	13	0	0
17	39728261	.	G	T	7	10	17	0	0	17	0	0
17	39728423	.	T	A	6	6	12	0	1	13	0	0
17	39729014	.	G	A	4	9	13	0	3	16	0	0
17	39732512	.	C	T	7	6	13	0	2	15	0	0
17	39732573	.	C	A	6	9	15	0	2	17	0	0
17	39732584	.	G	A	8	9	17	0	0	17	0	0
17	39736088	.	T	A	11	9	20	0	0	20	0	0
17	39736103	.	G	A	13	10	23	0	0	23	0	0
17	39736130	.	T	C	9	11	20	0	0	20	0	0
17	39739842	.	A	T	6	8	14	0	1	15	0	0
17	39862334	.	A	G	0	1	1	0	0	1	0	0
17	39862536	.	C	G	1	4	5	0	0	5	0	0
17	40860266	.	C	T	3	2	5	0	0	5	0	0
17	40879510	.	A	G	5	2	7	0	0	7	0	0
17	40889011	.	A	G	1	2	3	0	0	3	0	0
17	40889017	.	C	T	1	2	3	0	0	3	0	0
17	40889613	.	C	A	0	1	1	0	0	1	0	0
17	40889637	.	T	C	0	1	1	0	0	1	0	0
17	40889697	.	A	G	3	3	6	0	0	6	0	0
17	40890056	.	C	T	4	0	4	0	0	4	0	0
17	40890107	.	G	T	3	1	4	0	0	4	0	0
17	40890396	.	C	T	5	2	7	0	1	8	0	0
17	40890433	.	G	A	3	0	3	0	1	4	0	0
17	40890443	.	C	T	2	0	2	0	0	2	0	0
17	40893919	.	A	T	1	0	1	0	0	1	0	0
17	40899449	.	A	G	2	2	4	0	0	4	0	0
17	40899805	.	G	C	1	2	3	0	0	3	0	0
17	40899809	.	C	A	1	1	2	0	0	2	0	0
17	40899873	.	T	G	1	5	6	0	0	6	0	0
17	40899880	.	C	T	1	5	6	0	0	6	0	0
17	40900414	.	T	C	3	4	7	0	1	8	0	0
17	40900415	.	G	A	4	4	8	0	0	8	0	0
17	40901439	.	T	C	3	3	6	0	0	6	0	0
17	40901695	.	G	C	4	7	11	0	0	11	0	0
17	40901712	.	C	G	3	7	10	0	0	10	0	0
17	40901752	.	G	A	1	3	4	0	0	4	0	0
17	40901799	.	A	C	0	2	2	0	0	2	0	0
17	40901804	.	A	T	0	2	2	0	0	2	0	0
17	40902005	.	C	A	3	4	7	0	6	13	0	0
17	40902065	.	G	A	6	9	15	0	0	15	0	0
17	40902148	.	G	T	3	8	11	0	0	11	0	0
17	40902180	.	G	C	8	4	12	0	1	13	0	0
17	40902256	.	G	T	0	3	3	0	1	4	0	0
17	40902297	.	A	G	4	8	12	0	0	12	0	0
17	40902347	.	C	T	9	7	16	0	2	18	0	0
17	40902368	.	T	G	9	7	16	0	0	16	0	0
17	40902598	.	G	A	11	3	14	0	0	14	0	0
17	40902657	.	A	C	6	7	13	0	0	13	0	0
17	40902830	.	A	T	7	4	11	0	2	13	0	0
17	40903162	.	C	T	4	4	8	0	1	9	0	0
17	40955529	.	G	C	1	2	3	0	1	4	0	0
17	40955577	.	A	T	1	2	3	0	0	3	0	0
17	40990061	.	T	A	11	4	15	0	1	16	0	0
17	40990097	.	T	A	5	0	5	0	0	5	0	0
17	40999460	.	A	G	11	5	16	1	0	17	0	0
17	40999697	.	C	G	10	4	14	0	0	14	0	0
17	40999700	.	C	A	10	4	14	0	1	15	0	0
17	40999732	.	A	G	6	6	12	0	1	13	0	0
17	41084623	.	C	T	0	1	1	0	0	1	0	0
17	41084670	.	T	C	5	5	10	0	0	10	0	0
17	41092465	.	C	T	0	1	1	0	0	1	0	0
17	41121783	.	C	G	2	0	2	0	0	2	0	0
17	41254741	.	C	T	0	2	2	0	0	2	0	0
17	41264045	.	T	A	0	1	1	0	0	1	0	0
17	41264054	.	G	A	1	0	1	0	0	1	0	0
17	41264165	.	C	A	3	7	10	0	0	10	0	0
17	41314040	.	G	T	1	7	8	0	15	23	0	0
17	41314097	.	T	C	12	7	19	0	2	21	0	0
17	41314471	.	G	A	12	11	23	0	0	23	0	0
17	41317234	.	A	G	9	0	9	0	8	17	0	0
17	41317494	.	G	A	10	16	26	0	1	27	0	0
17	41317999	.	G	A	7	14	21	0	2	23	0	0
17	41318310	.	A	G	7	16	23	0	1	24	0	0
17	41464090	.	G	A	1	5	6	0	5	11	0	0
17	41465504	.	A	C	8	3	11	0	1	12	0	0
17	41475863	.	T	C	11	12	23	0	0	23	0	0
17	41476104	.	T	C	10	0	10	0	23	33	0	0
17	41476161	.	A	G	9	21	30	0	1	31	0	0
17	41476279	.	G	A	15	17	32	0	3	35	0	0
17	41476298	.	T	A	14	14	28	0	2	30	0	0
17	41476833	.	T	C	5	8	13	0	0	13	0	0
17	41476906	.	A	C	3	0	3	0	5	8	0	0
17	41476917	.	C	T	0	4	4	0	4	8	0	0
17	41477157	.	T	C	3	6	9	0	1	10	0	0
17	41477324	.	G	A	8	9	17	0	1	18	0	0
17	41571328	.	T	A	5	5	10	0	0	10	0	0
17	41583555	.	C	G	0	4	4	0	6	10	0	0
17	41583747	.	G	T	10	6	16	0	0	16	0	0
17	41583768	.	T	C	5	0	5	0	9	14	0	0
17	41583786	.	A	G	5	6	11	0	0	11	0	0
17	41601633	.	G	A	1	4	5	0	1	6	0	0
17	41602081	.	T	C	4	2	6	0	0	6	0	0
17	41610991	.	G	A	1	2	3	0	0	3	0	0
17	41630729	.	A	G	2	0	2	0	1	3	0	0
17	41630736	.	C	T	4	0	4	0	0	4	0	0
17	41631083	.	C	A	0	2	2	0	1	3	0	0
17	41639674	.	A	G	1	0	1	0	1	2	0	0
17	41639675	.	G	A	1	1	2	0	0	2	0	0
17	41659641	.	C	T	0	0	0	0	4	4	0	0
17	41666581	.	G	A	1	2	3	0	0	3	0	0
17	41667069	.	G	A	3	2	5	0	0	5	0	0
17	41667109	.	C	T	0	1	1	0	2	3	0	0
17	41669288	.	G	A	2	2	4	0	0	4	0	0
17	41673488	.	C	T	0	1	1	0	0	1	0	0
17	41675511	.	T	C	2	1	3	0	1	4	0	0
17	41685644	.	G	A	1	1	2	0	0	2	0	0
17	42003872	.	C	T	1	3	4	0	0	4	0	0
17	42027915	.	C	T	4	5	9	0	0	9	0	0
17	42030083	.	A	G	4	0	4	0	1	5	0	0
17	42095539	.	A	T	2	2	4	0	0	4	0	0
17	42095602	.	A	G	1	2	3	0	0	3	0	0
17	42095620	.	C	T	2	2	4	0	0	4	0	0
17	42096960	.	C	G	0	2	2	0	2	4	0	0
17	42566263	.	T	A	1	3	4	0	0	4	0	0
17	42871419	.	G	T	8	6	14	0	0	14	0	0
17	43013675	.	G	A	6	6	12	0	0	12	0	0
17	43017672	.	C	T	13	10	23	0	1	24	0	0
17	43017687	.	G	A	16	11	27	0	0	27	0	0
17	43017830	.	A	G	12	7	19	0	2	21	0	0
17	43017863	.	A	C	16	10	26	0	0	26	0	0
17	43018037	.	G	A	0	11	11	0	19	30	0	0
17	43018124	.	A	G	15	0	15	0	5	20	0	0
17	43018273	.	G	A	17	22	39	0	1	40	0	0
17	43018382	.	T	G	17	10	27	0	2	29	0	0
17	43018502	.	T	A	17	22	39	0	2	41	0	0
17	43018549	.	C	G	15	14	29	0	3	32	0	0
17	43018638	.	A	T	15	19	34	0	0	34	0	0
17	43018815	.	A	G	13	13	26	0	0	26	0	0
17	43018899	.	T	A	15	18	33	0	1	34	0	0
17	43030737	.	T	G	6	8	14	0	0	14	0	0
17	43030828	.	G	A	5	9	14	1	0	15	0	0
17	43031495	.	G	A	4	3	7	0	1	8	0	0
17	43033177	.	G	A	7	8	15	0	2	17	0	0
17	43035798	.	T	C	18	15	33	0	2	35	0	0
17	43035979	.	A	G	14	5	19	0	2	21	0	0
17	43035996	.	G	T	5	13	18	0	2	20	0	0
17	43036025	.	A	G	4	14	18	0	1	19	0	0
17	43036055	.	T	C	9	6	15	0	2	17	0	0
17	43039706	.	A	G	2	2	4	0	0	4	0	0
17	43040422	.	T	A	3	5	8	0	0	8	0	0
17	43075560	.	G	T	1	0	1	0	0	1	0	0
17	43075561	.	G	A	1	0	1	0	0	1	0	0
17	43077265	.	G	T	1	1	2	0	0	2	0	0
17	43077327	.	C	T	1	1	2	0	0	2	0	0
17	43082871	.	G	A	2	1	3	0	0	3	0	0
17	43082976	.	A	T	4	3	7	0	0	7	0	0
17	43087252	.	A	T	1	3	4	0	0	4	0	0
17	43146508	.	C	T	2	2	4	0	0	4	0	0
17	43146607	.	G	C	2	1	3	0	0	3	0	0
17	43174889	.	G	A	2	2	4	0	0	4	0	0
17	43174925	.	C	T	2	2	4	0	1	5	0	0
17	43297946	.	G	C	11	15	26	0	0	26	0	0
17	43298011	.	G	A	11	20	31	0	0	31	0	0
17	43298068	.	G	A	13	11	24	0	1	25	0	0
17	43302492	.	G	A	10	7	17	0	0	17	0	0
17	43309095	.	A	G	8	4	12	0	0	12	0	0
17	43309164	.	C	T	0	7	7	0	5	12	0	0
17	43315085	.	C	T	3	1	4	0	0	4	0	0
17	43348986	.	T	C	2	6	8	0	2	10	0	0
17	43436782	.	T	C	12	0	12	0	16	28	0	0
17	43437305	.	G	C	10	12	22	0	0	22	0	0
17	43437365	.	C	G	4	5	9	0	0	9	0	0
17	43439720	.	G	T	6	14	20	0	3	23	0	0
17	43441575	.	A	T	0	2	2	0	0	2	0	0
17	43453507	.	T	C	5	3	8	0	0	8	0	0
17	43453531	.	G	A	8	7	15	0	1	16	0	0
17	43456825	.	C	T	11	16	27	0	0	27	0	0
17	43456900	.	G	A	13	9	22	0	0	22	0	0
17	43456921	.	T	C	9	9	18	0	0	18	0	0
17	43461181	.	G	A	2	2	4	0	0	4	0	0
17	43469515	.	G	T	5	1	6	0	1	7	0	0
17	43475562	.	T	C	12	9	21	0	2	23	0	0
17	43475577	.	G	A	0	10	10	0	8	18	0	0
17	43475619	.	A	G	6	0	6	0	10	16	0	0
17	43475691	.	T	A	7	2	9	0	1	10	0	0
17	43475994	.	T	G	8	6	14	0	0	14	0	0
17	43476137	.	T	A	6	10	16	0	0	16	0	0
17	43476232	.	A	G	4	2	6	0	0	6	0	0
17	43476241	.	A	G	4	1	5	0	0	5	0	0
17	43513318	.	C	T	0	1	1	0	2	3	0	0
17	43516451	.	T	A	0	1	1	0	0	1	0	0
17	43516464	.	T	A	0	3	3	0	0	3	0	0
17	43516502	.	G	T	1	9	10	0	1	11	0	0
17	43516506	.	A	C	1	9	10	0	1	11	0	0
17	43516548	.	A	G	1	8	9	0	2	11	0	0
17	43524233	.	T	C	1	2	3	0	0	3	0	0
17	43524245	.	T	G	1	2	3	0	0	3	0	0
17	43525600	.	C	G	2	1	3	0	0	3	0	0
17	43538081	.	G	A	4	5	9	0	1	10	0	0
17	43538097	.	C	T	3	5	8	0	1	9	0	0
17	43538209	.	C	T	4	3	7	0	1	8	0	0
17	43547945	.	A	G	2	3	5	0	0	5	0	0
17	43551841	.	G	C	2	2	4	0	1	5	0	0
17	43551865	.	C	T	4	3	7	0	0	7	0	0
17	43575504	.	C	T	0	3	3	0	0	3	0	0
17	43575782	.	C	T	3	2	5	0	0	5	0	0
17	43575886	.	G	T	1	3	4	0	0	4	0	0
17	43575924	.	G	C	1	2	3	0	0	3	0	0
17	43576107	.	T	A	1	2	3	0	0	3	0	0
17	43594693	.	C	A	1	2	3	0	0	3	0	0
17	43594709	.	A	T	1	2	3	0	0	3	0	0
17	43612212	.	C	T	0	2	2	0	0	2	0	0
17	43623955	.	G	T	1	2	3	0	0	3	0	0
17	43629604	.	T	C	2	2	4	0	0	4	0	0
17	43629622	.	C	T	2	1	3	0	0	3	0	0
17	43659950	.	T	G	4	3	7	0	0	7	0	0
17	43660168	.	C	T	6	8	14	0	0	14	0	0
17	43660232	.	G	A	10	10	20	0	0	20	0	0
17	43660779	.	T	C	7	8	15	0	0	15	0	0
17	43661176	.	C	G	10	4	14	0	0	14	0	0
17	43661291	.	G	T	10	3	13	0	1	14	0	0
17	43661293	.	A	T	9	3	12	0	2	14	0	0
17	43661578	.	A	G	14	4	18	0	0	18	0	0
17	43661618	.	T	A	6	6	12	0	0	12	0	0
17	43663611	.	T	G	4	4	8	0	0	8	0	0
17	43664128	.	G	C	12	17	29	0	1	31	1	0
17	43664176	.	C	A	0	9	9	0	13	22	0	0
17	43664605	.	G	A	11	6	17	0	0	17	0	0
17	43708608	.	C	T	7	10	17	0	0	17	0	0
17	43711502	.	G	A	1	1	2	0	1	3	0	0
17	43853767	.	A	T	2	10	12	0	1	13	0	0
17	43853778	.	C	T	0	3	3	0	10	13	0	0
17	43854010	.	T	G	7	4	11	0	2	13	0	0
17	43856232	.	T	C	1	1	2	0	2	4	0	0
17	43859306	.	A	T	8	10	18	0	1	20	1	0
17	43859378	.	C	T	15	5	20	0	0	20	0	0
17	43859387	.	C	T	12	6	18	0	1	19	0	0
17	43863540	.	C	A	6	7	13	0	1	14	0	0
17	43926650	.	C	A	1	1	2	0	0	2	0	0
17	43946490	.	T	G	3	0	3	0	3	6	0	0
17	43951792	.	A	C	4	3	7	0	1	8	0	0
17	43952984	.	C	T	5	2	7	0	0	7	0	0
17	43954926	.	A	C	1	4	5	0	1	6	0	0
17	43955964	.	G	A	0	3	3	0	2	5	0	0
17	43956910	.	T	C	1	4	5	0	1	6	0	0
17	43959078	.	A	G	0	0	0	0	7	7	0	0
17	43959098	.	A	G	4	0	4	0	9	13	0	0
17	43959594	.	A	G	2	0	2	0	0	2	0	0
17	43961801	.	T	C	4	7	11	0	0	11	0	0
17	43968686	.	A	G	0	2	2	0	0	2	0	0
17	43976947	.	C	A	1	0	1	0	1	2	0	0
17	43977416	.	G	A	2	1	3	0	2	5	0	0
17	43977433	.	T	G	4	3	7	0	0	7	0	0
17	43985045	.	G	A	2	1	3	0	0	3	0	0
17	43985075	.	C	T	2	2	4	0	1	5	0	0
17	43986863	.	C	T	5	1	6	0	0	6	0	0
17	43996483	.	G	A	4	5	9	0	0	9	0	0
17	43996485	.	G	A	4	5	9	0	0	9	0	0
17	43996620	.	A	T	3	2	5	0	1	6	0	0
17	43996667	.	G	A	7	4	11	0	1	12	0	0
17	44001833	.	T	C	14	14	28	0	1	29	0	0
17	44001880	.	T	A	12	10	22	0	1	23	0	0
17	44002000	.	C	G	9	1	10	0	13	23	0	0
17	44006579	.	G	T	1	3	4	0	3	7	0	0
17	44006614	.	T	A	3	3	6	0	0	6	0	0
17	44006618	.	C	G	3	3	6	0	0	6	0	0
17	44006654	.	A	G	3	2	5	0	0	5	0	0
17	44006924	.	G	C	4	2	6	0	1	7	0	0
17	44006927	.	G	A	4	3	7	0	0	7	0	0
17	44007314	.	G	C	1	0	1	0	2	3	0	0
17	44074532	.	A	C	1	2	3	0	0	3	0	0
17	44079803	.	G	T	6	4	10	0	0	10	0	0
17	44079925	.	G	C	2	2	4	0	0	4	0	0
17	44080212	.	G	A	4	3	7	0	0	7	0	0
17	44080227	.	C	T	4	3	7	0	1	8	0	0
17	44080530	.	A	G	1	2	3	0	0	3	0	0
17	44245452	.	T	C	17	15	32	0	0	32	0	0
17	44247495	.	G	A	14	12	26	0	1	27	0	0
17	44249428	.	T	G	1	1	2	0	1	3	0	0
17	44252640	.	T	A	9	7	16	0	1	17	0	0
17	44413925	.	C	T	5	3	8	0	2	10	0	0
17	44413980	.	G	A	3	3	6	0	2	8	0	0
17	44414030	.	A	G	5	5	10	0	0	10	0	0
17	44420201	.	G	A	4	1	5	0	0	5	0	0
17	44420406	.	T	C	2	0	2	0	0	2	0	0
17	44420602	.	G	A	3	4	7	0	0	7	0	0
17	44422527	.	G	T	1	0	1	0	0	1	0	0
17	44430544	.	A	G	1	3	4	0	0	4	0	0
17	44444188	.	C	T	4	2	6	0	0	6	0	0
17	44451094	.	A	G	5	3	8	0	0	8	0	0
17	44453771	.	G	A	0	2	2	0	1	3	0	0
17	44463892	.	A	G	5	5	10	0	0	10	0	0
17	44463903	.	G	T	3	5	8	0	0	8	0	0
17	44473954	.	G	C	3	4	7	0	0	7	0	0
17	44474284	.	G	A	6	4	10	0	0	10	0	0
17	44474392	.	A	G	7	5	12	0	2	14	0	0
17	44474445	.	C	A	5	6	11	0	1	12	0	0
17	44474592	.	T	G	1	2	3	0	0	3	0	0
17	44474658	.	A	G	2	0	2	0	4	6	0	0
17	44475047	.	T	G	8	3	11	0	0	11	0	0
17	44475093	.	C	G	5	5	10	0	0	10	0	0
17	44475940	.	C	G	3	10	13	0	0	13	0	0
17	44502836	.	A	G	2	8	10	0	0	10	0	0
17	44539266	.	T	A	3	4	7	0	0	7	0	0
17	44542577	.	A	G	4	2	6	0	0	6	0	0
17	44542598	.	G	C	4	2	6	0	0	6	0	0
17	44542790	.	A	G	1	3	4	0	0	4	0	0
17	44756390	.	G	A	0	2	2	0	0	2	0	0
17	44756895	.	A	C	2	0	2	0	0	2	0	0
17	44758078	.	T	C	1	2	3	0	0	3	0	0
17	44760273	.	T	G	0	0	0	0	2	2	0	0
17	44760544	.	C	A	1	5	6	0	0	6	0	0
17	44760618	.	C	T	6	12	18	0	1	19	0	0
17	44760774	.	C	T	4	9	13	0	0	13	0	0
17	44760858	.	A	G	3	3	6	0	0	6	0	0
17	44761011	.	A	G	3	2	5	0	0	5	0	0
17	44761103	.	G	T	2	3	5	0	1	6	0	0
17	44761124	.	A	T	2	3	5	0	0	5	0	0
17	44761140	.	G	T	1	3	4	0	0	4	0	0
17	44761349	.	G	A	7	8	15	0	0	15	0	0
17	44761356	.	G	T	7	7	14	0	2	16	0	0
17	44761504	.	T	C	5	3	8	0	0	8	0	0
17	44761542	.	T	A	5	6	11	0	0	11	0	0
17	44768459	.	T	C	0	2	2	0	0	2	0	0
17	44769039	.	T	A	1	3	4	0	0	4	0	0
17	44769379	.	A	G	1	3	4	0	0	4	0	0
17	44771236	.	C	G	4	5	9	0	0	9	0	0
17	44771353	.	A	C	0	1	1	0	0	1	0	0
17	44775971	.	C	T	2	2	4	0	0	4	0	0
17	44833808	.	G	A	0	1	1	0	0	1	0	0
17	44862308	.	G	C	1	2	3	0	0	3	0	0
17	44870978	.	G	A	0	2	2	0	0	2	0	0
17	44873988	.	C	T	3	4	7	0	0	7	0	0
17	44878504	.	G	T	4	2	6	0	0	6	0	0
17	44884946	.	C	T	1	2	3	0	0	3	0	0
17	44884955	.	G	A	0	3	3	0	1	4	0	0
17	44884997	.	C	T	4	4	8	0	0	8	0	0
17	44899562	.	G	A	0	5	5	0	8	13	0	0
17	44911803	.	A	G	3	1	4	0	1	5	0	0
17	44922442	.	C	T	8	8	16	0	0	16	0	0
17	44922685	.	G	T	11	11	22	0	2	24	0	0
17	44922743	.	G	A	3	9	12	0	0	12	0	0
17	44922788	.	C	A	4	6	10	0	1	11	0	0
17	44922819	.	A	T	7	5	12	0	0	12	0	0
17	44922866	.	C	T	5	8	13	0	1	14	0	0
17	44923053	.	C	T	3	4	7	0	0	7	0	0
17	44923083	.	T	A	3	6	9	0	0	9	0	0
17	44923322	.	T	A	2	3	5	0	1	6	0	0
17	44923345	.	T	C	6	2	8	0	1	9	0	0
17	44923389	.	G	A	2	9	11	0	0	11	0	0
17	44962056	.	G	A	13	16	29	0	1	30	0	0
17	44962502	.	A	T	7	6	13	0	1	14	0	0
17	44962507	.	A	G	6	8	14	0	2	16	0	0
17	44962575	.	G	T	11	7	18	0	0	18	0	0
17	44962693	.	T	C	7	8	15	0	1	16	0	0
17	44962799	.	A	G	9	4	13	0	0	13	0	0
17	44962826	.	C	T	7	5	12	0	0	12	0	0
17	44962860	.	T	G	5	7	12	0	0	12	0	0
17	44962861	.	A	T	7	5	12	0	0	12	0	0
17	44962901	.	A	T	6	5	11	0	0	11	0	0
17	44967819	.	G	A	14	11	25	0	0	25	0	0
17	44968095	.	C	T	3	3	6	0	0	6	0	0
17	44980976	.	T	G	4	2	6	0	0	6	0	0
17	44981175	.	T	C	6	4	10	0	0	10	0	0
17	44998615	.	C	G	2	2	4	0	1	5	0	0
17	45002782	.	T	G	2	3	5	0	2	7	0	0
17	45007013	.	C	T	2	2	4	0	0	4	0	0
17	45010190	.	A	C	5	2	7	0	0	7	0	0
17	45010200	.	G	T	7	3	10	0	0	10	0	0
17	45010337	.	C	T	3	5	8	0	0	8	0	0
17	45010338	.	T	A	3	5	8	0	0	8	0	0
17	45022535	.	T	G	4	0	4	0	5	9	0	0
17	45028213	.	G	C	1	4	5	0	0	5	0	0
17	45028248	.	G	A	4	3	7	0	0	7	0	0
17	45073467	.	T	A	3	2	5	0	0	5	0	0
17	45073490	.	C	A	1	4	5	0	5	10	0	0
17	45076111	.	A	G	5	4	9	0	1	10	0	0
17	45082331	.	T	G	6	2	8	0	2	10	0	0
17	45082406	.	A	G	11	13	24	0	1	25	0	0
17	45082466	.	C	A	0	5	5	0	2	7	0	0
17	45085085	.	G	A	7	10	17	0	1	18	0	0
17	45085100	.	C	T	12	14	26	0	0	26	0	0
17	45093134	.	G	T	7	8	15	0	0	15	0	0
17	45093155	.	G	A	4	3	7	0	0	7	0	0
17	45099042	.	G	T	1	3	4	0	2	6	0	0
17	45099141	.	C	A	4	3	7	0	0	7	0	0
17	45138048	.	C	G	9	16	25	0	0	25	0	0
17	45138255	.	C	A	0	8	8	0	6	14	0	0
17	45138329	.	A	C	9	12	21	0	1	22	0	0
17	45138391	.	G	T	8	7	15	0	0	17	2	0
17	45138446	.	C	T	0	4	4	0	13	17	0	0
17	45138733	.	T	C	16	9	25	0	0	25	0	0
17	45138741	.	T	C	17	10	27	0	1	28	0	0
17	45138796	.	T	C	17	7	24	0	1	25	0	0
17	45139177	.	G	A	4	3	7	0	0	7	0	0
17	45139179	.	T	C	4	3	7	0	0	7	0	0
17	45139291	.	T	C	7	7	14	0	1	15	0	0
17	45139750	.	C	T	6	9	15	0	0	15	0	0
17	45139805	.	A	T	7	7	14	0	0	14	0	0
17	45139879	.	C	T	6	18	24	0	0	24	0	0
17	45139881	.	G	A	6	17	23	0	1	24	0	0
17	45140376	.	A	T	3	3	6	0	0	6	0	0
17	45145056	.	A	G	9	7	16	0	0	16	0	0
17	45145065	.	T	C	6	0	6	0	8	14	0	0
17	45145143	.	T	C	4	0	4	0	3	7	0	0
17	45148190	.	G	T	1	1	2	0	0	2	0	0
17	45148302	.	T	A	0	1	1	0	0	1	0	0
17	45148303	.	A	G	0	0	0	0	1	1	0	0
17	45216125	.	C	T	5	5	10	0	0	10	0	0
17	45216142	.	T	G	4	3	7	0	2	9	0	0
17	45216312	.	C	T	0	5	5	0	7	12	0	0
17	45216388	.	G	A	1	3	4	0	0	4	0	0
17	45216612	.	G	A	3	4	7	0	1	8	0	0
17	45232733	.	G	C	8	5	13	0	1	14	0	0
17	45232756	.	T	C	4	4	8	0	0	8	0	0
17	45232993	.	T	A	5	2	7	0	1	8	0	0
17	45234663	.	T	A	2	1	3	0	1	4	0	0
17	45234816	.	G	C	2	3	5	0	0	5	0	0
17	45235138	.	G	A	2	4	6	0	0	6	0	0
17	45238851	.	G	A	0	2	2	0	0	2	0	0
17	45247199	.	A	G	4	1	5	0	0	5	0	0
17	45254339	.	C	T	1	2	3	0	0	3	0	0
17	45294969	.	C	G	2	0	2	0	2	4	0	0
17	45297950	.	A	G	0	3	3	0	0	3	0	0
17	45348585	.	T	A	3	4	7	0	0	7	0	0
17	45348616	.	T	C	2	2	4	0	0	4	0	0
17	45350315	.	C	A	0	2	2	0	1	3	0	0
17	45350346	.	C	T	2	2	4	0	0	4	0	0
17	45379484	.	C	T	0	2	2	0	2	4	0	0
17	45379486	.	G	A	0	3	3	0	1	4	0	0
17	45458154	.	C	G	5	0	5	0	5	10	0	0
17	45476871	.	G	A	1	1	2	0	0	2	0	0
17	45482121	.	T	C	1	3	4	0	0	4	0	0
17	45482160	.	G	A	0	5	5	0	0	5	0	0
17	45482194	.	A	T	4	4	8	0	1	9	0	0
17	45482689	.	T	A	1	2	3	0	0	3	0	0
17	45532532	.	T	A	16	20	36	0	3	39	0	0
17	45532637	.	A	T	15	23	38	0	1	39	0	0
17	45731991	.	T	C	5	10	15	0	1	16	0	0
17	45732147	.	T	C	7	16	23	0	1	24	0	0
17	45732173	.	C	T	0	15	15	0	11	26	0	0
17	45732327	.	G	A	9	6	15	0	0	15	0	0
17	45732601	.	G	A	9	4	13	0	0	13	0	0
17	45732765	.	A	T	13	9	22	0	0	22	0	0
17	45732785	.	T	C	11	14	25	0	0	25	0	0
17	45732802	.	G	T	10	15	25	0	0	25	0	0
17	45733537	.	A	G	2	3	5	0	0	5	0	0
17	45733664	.	G	A	5	2	7	0	0	7	0	0
17	45748014	.	A	G	2	0	2	0	5	7	0	0
17	45748623	.	C	T	3	1	4	0	0	4	0	0
17	45750485	.	C	T	1	0	1	0	0	1	0	0
17	45751385	.	C	T	3	3	6	0	0	6	0	0
17	45751404	.	T	C	2	2	4	0	0	4	0	0
17	45756484	.	A	G	1	1	2	0	0	2	0	0
17	45756547	.	C	T	3	4	7	0	0	7	0	0
17	45756610	.	T	C	4	3	7	0	0	7	0	0
17	45759087	.	C	T	3	7	10	0	0	10	0	0
17	45765222	.	C	T	2	3	5	0	0	5	0	0
17	45765234	.	G	A	2	2	4	0	0	4	0	0
17	45773982	.	T	G	4	2	6	0	0	6	0	0
17	45981457	.	G	A	1	1	2	0	1	3	0	0
17	45983269	.	C	T	1	2	3	0	0	3	0	0
17	45983321	.	T	A	0	2	2	0	1	3	0	0
17	45983322	.	C	T	1	2	3	0	0	3	0	0
17	45983392	.	G	A	1	4	5	0	0	5	0	0
17	45983410	.	C	T	1	3	4	0	0	4	0	0
17	45984415	.	A	G	2	0	2	0	4	6	0	0
17	45987075	.	G	A	0	2	2	0	1	3	0	0
17	45987120	.	C	T	2	3	5	0	1	6	0	0
17	45987143	.	A	T	2	2	4	0	0	4	0	0
17	45987629	.	A	T	3	3	6	0	0	6	0	0
17	45987788	.	T	C	1	3	4	0	0	4	0	0
17	45987789	.	G	A	1	3	4	0	0	4	0	0
17	45988446	.	G	A	0	5	5	0	1	6	0	0
17	46387226	.	C	A	4	2	6	0	0	6	0	0
17	46387253	.	G	T	0	3	3	0	2	5	0	0
17	46387291	.	C	A	3	2	5	0	0	5	0	0
17	46439098	.	G	A	1	1	2	0	0	2	0	0
17	46439102	.	C	T	1	2	3	0	0	3	0	0
17	46439186	.	A	G	1	2	3	0	0	3	0	0
17	47140969	.	G	A	0	3	3	0	6	9	0	0
17	47169660	.	G	C	0	1	1	0	5	6	0	0
17	47175456	.	G	A	4	7	11	0	1	12	0	0
17	47175569	.	G	A	5	5	10	0	0	10	0	0
17	47188778	.	G	A	7	4	11	0	0	11	0	0
17	47188932	.	C	T	1	12	13	0	6	19	0	0
17	47188984	.	G	A	6	7	13	0	0	13	0	0
17	47189025	.	C	A	4	2	6	1	1	8	0	0
17	47189221	.	C	T	10	4	14	0	0	14	0	0
17	47189243	.	T	C	5	4	9	0	2	11	0	0
17	47189258	.	G	T	7	4	11	0	0	11	0	0
17	47189283	.	A	T	6	4	10	0	0	10	0	0
17	47189684	.	G	A	12	6	18	0	0	18	0	0
17	47189725	.	G	A	7	9	16	0	0	16	0	0
17	47189741	.	G	T	7	7	14	0	0	14	0	0
17	47189765	.	G	T	5	5	10	0	0	10	0	0
17	47189937	.	T	A	5	13	18	0	0	18	0	0
17	47190941	.	G	T	7	4	11	0	1	12	0	0
17	47191229	.	G	A	1	3	4	0	0	4	0	0
17	47191248	.	G	A	2	3	5	0	0	5	0	0
17	47191795	.	C	A	3	3	6	0	0	6	0	0
17	47192178	.	C	T	2	2	4	0	1	5	0	0
17	47193180	.	T	A	3	3	6	0	0	6	0	0
17	47193200	.	A	G	6	3	9	0	0	9	0	0
17	47193313	.	T	C	4	5	9	0	4	13	0	0
17	47193857	.	T	C	5	0	5	0	2	7	0	0
17	47193902	.	C	T	0	4	4	0	4	8	0	0
17	47193995	.	T	C	4	3	7	0	1	8	0	0
17	47289395	.	C	A	0	1	1	0	1	2	0	0
17	48139427	.	T	C	0	1	1	0	0	1	0	0
17	48156580	.	C	T	2	2	4	0	0	4	0	0
17	48156631	.	G	A	1	5	6	0	1	7	0	0
17	48867458	.	T	A	1	2	3	0	0	3	0	0
17	48908911	.	A	G	1	5	6	0	0	6	0	0
17	48911097	.	T	G	4	3	7	0	1	8	0	0
17	48911419	.	G	T	3	1	4	0	0	4	0	0
17	48915387	.	A	T	0	3	3	0	1	4	0	0
17	48922267	.	T	A	1	3	4	0	0	4	0	0
17	49003651	.	A	G	3	4	7	0	0	7	0	0
17	49010678	.	T	C	1	2	3	0	0	3	0	0
17	49010727	.	T	C	6	4	10	0	0	10	0	0
17	49011174	.	A	G	4	5	9	0	2	11	0	0
17	49011177	.	C	A	6	5	11	0	0	11	0	0
17	49011627	.	T	C	1	1	2	0	0	2	0	0
17	49016534	.	C	T	0	5	5	0	2	7	0	0
17	49016858	.	C	T	3	0	3	0	0	3	0	0
17	49018224	.	G	A	0	7	7	0	7	14	0	0
17	49018575	.	G	A	8	11	19	0	0	19	0	0
17	49019177	.	C	A	23	17	40	0	0	40	0	0
17	49306256	.	C	T	11	4	15	0	0	15	0	0
17	49416044	.	T	G	6	8	14	0	0	15	1	0
17	49416151	.	T	C	10	0	10	0	6	16	0	0
17	49416259	.	T	C	6	0	6	0	7	13	0	0
17	49416327	.	T	C	6	4	10	0	2	12	0	0
17	49416992	.	G	A	4	5	9	0	0	9	0	0
17	49417137	.	C	T	3	5	8	0	1	9	0	0
17	49417148	.	A	T	2	3	5	0	2	7	0	0
17	49417414	.	T	A	9	9	18	0	0	18	0	0
17	49417569	.	T	C	8	8	16	0	0	16	0	0
17	49417599	.	G	C	6	8	14	0	0	14	0	0
17	49417835	.	G	A	7	4	11	0	0	11	0	0
17	49417838	.	A	G	9	4	13	0	0	13	0	0
17	49417961	.	A	C	5	5	10	0	0	10	0	0
17	49417974	.	C	A	5	5	10	0	0	10	0	0
17	49418122	.	C	G	3	2	5	0	0	5	0	0
17	49419311	.	C	T	1	5	6	0	0	6	0	0
17	49419323	.	G	A	1	5	6	0	0	6	0	0
17	49419410	.	T	C	4	2	6	0	0	6	0	0
17	49419761	.	G	T	5	3	8	0	0	8	0	0
17	49420049	.	T	G	4	5	9	0	0	9	0	0
17	49420565	.	A	C	1	0	1	0	5	6	0	0
17	49420727	.	C	A	0	4	4	0	2	6	0	0
17	49421117	.	A	G	1	2	3	0	1	4	0	0
17	49421141	.	A	G	0	2	2	0	2	4	0	0
17	49429877	.	C	T	1	3	4	0	0	4	0	0
17	49528441	.	A	T	0	6	6	0	0	6	0	0
17	49528442	.	G	A	0	6	6	0	0	6	0	0
17	49635656	.	C	T	1	2	3	0	1	4	0	0
17	49640903	.	A	G	7	4	11	0	1	12	0	0
17	49640957	.	A	G	2	5	7	0	0	7	0	0
17	49640986	.	C	G	2	2	4	0	0	4	0	0
17	49642268	.	G	A	0	2	2	0	0	2	0	0
17	49785789	.	A	G	2	2	4	0	0	4	0	0
17	49983202	.	A	T	8	7	15	0	2	17	0	0
17	49983273	.	C	T	21	21	42	0	1	43	0	0
17	49987618	.	A	T	7	9	16	0	0	16	0	0
17	49992629	.	G	A	4	13	17	0	1	18	0	0
17	49998167	.	C	T	16	10	26	0	1	27	0	0
17	49998221	.	G	A	16	15	31	0	2	33	0	0
17	49998591	.	T	G	9	4	13	0	1	14	0	0
17	49998804	.	C	A	22	26	48	0	2	50	0	0
17	49998995	.	G	C	28	0	28	0	11	39	0	0
17	49999037	.	G	T	14	23	37	0	3	40	0	0
17	50002381	.	A	G	24	26	50	0	4	54	0	0
17	50010011	.	A	G	15	11	26	0	1	27	0	0
17	50010024	.	G	C	16	11	27	0	1	28	0	0
17	50097129	.	G	A	1	0	1	0	1	2	0	0
17	50097168	.	G	A	2	1	3	0	0	3	0	0
17	50099911	.	A	G	0	0	0	0	1	1	0	0
17	50099985	.	A	C	0	1	1	0	0	1	0	0
17	50110192	.	C	A	1	4	5	0	0	5	0	0
17	50110255	.	G	C	1	3	4	0	0	4	0	0
17	50110304	.	T	A	2	7	9	0	0	9	0	0
17	50110517	.	G	A	0	3	3	0	4	7	0	0
17	50110574	.	A	G	1	0	1	0	2	3	0	0
17	50110862	.	T	A	1	3	4	0	0	4	0	0
17	50111397	.	A	G	2	5	7	0	1	8	0	0
17	50111406	.	G	A	3	4	7	0	2	9	0	0
17	50111549	.	A	G	2	5	7	0	0	7	0	0
17	50111746	.	A	T	2	4	6	0	0	6	0	0
17	50112054	.	T	A	8	4	12	0	0	12	0	0
17	50112390	.	C	G	0	2	2	0	0	2	0	0
17	50112413	.	C	A	0	3	3	0	0	3	0	0
17	50112829	.	C	A	0	6	6	0	0	6	0	0
17	50113141	.	G	A	5	6	11	0	0	11	0	0
17	50141766	.	T	A	9	4	13	0	0	13	0	0
17	50171937	.	T	C	3	4	7	0	0	7	0	0
17	50176061	.	G	A	1	1	2	0	0	2	0	0
17	50176139	.	T	C	5	3	8	0	0	8	0	0
17	50176519	.	C	A	2	1	3	0	0	3	0	0
17	50178553	.	G	C	3	2	5	0	0	5	0	0
17	50185659	.	C	A	8	14	22	0	0	22	0	0
17	50185665	.	T	A	14	8	22	0	1	23	0	0
17	50185831	.	C	A	10	12	22	0	1	23	0	0
17	50185930	.	T	C	12	11	23	0	1	24	0	0
17	50186011	.	G	A	0	5	5	0	6	11	0	0
17	50186041	.	T	A	6	3	9	0	0	9	0	0
17	50186097	.	G	A	9	3	12	0	0	12	0	0
17	50229337	.	A	G	13	7	20	0	0	20	0	0
17	50233858	.	C	A	0	4	4	0	6	10	0	0
17	50233869	.	G	T	5	9	14	0	0	14	0	0
17	50245400	.	G	A	2	5	7	0	1	8	0	0
17	50245673	.	T	C	20	13	33	0	0	33	0	0
17	50245715	.	C	G	15	20	35	0	1	36	0	0
17	50247886	.	T	C	0	0	0	0	2	2	0	0
17	50254703	.	G	A	1	0	1	0	0	1	0	0
17	50272729	.	G	A	1	2	3	0	0	3	0	0
17	50278884	.	C	A	1	1	2	0	0	2	0	0
17	50284899	.	T	A	18	7	25	0	0	25	0	0
17	50284935	.	A	T	7	17	24	0	2	26	0	0
17	50285009	.	A	T	6	7	13	0	0	13	0	0
17	50416033	.	C	A	5	2	7	0	0	7	0	0
17	50416269	.	C	T	0	4	4	0	1	5	0	0
17	50420326	.	T	C	0	2	2	0	0	2	0	0
17	51206396	.	G	A	15	11	26	0	1	27	0	0
17	51206825	.	T	C	18	0	18	0	9	27	0	0
17	51206951	.	T	A	16	7	23	0	0	23	0	0
17	51207200	.	G	C	7	10	17	0	0	18	1	0
17	51209442	.	G	A	6	2	8	0	0	8	0	0
17	51213963	.	C	T	1	1	2	0	0	2	0	0
17	51214185	.	C	T	2	2	4	0	1	5	0	0
17	51214302	.	C	T	5	2	7	0	0	7	0	0
17	51218418	.	G	A	5	3	8	0	0	8	0	0
17	51224484	.	G	A	0	4	4	0	4	8	0	0
17	51226879	.	C	T	3	4	7	0	0	7	0	0
17	51228936	.	G	A	3	2	5	0	0	5	0	0
17	51229451	.	A	G	2	2	4	0	0	4	0	0
17	51231538	.	T	C	10	8	18	0	1	19	0	0
17	51231756	.	T	C	6	3	9	0	1	10	0	0
17	51231837	.	A	C	3	2	5	0	0	5	0	0
17	51231838	.	C	A	3	2	5	0	0	5	0	0
17	51231980	.	T	C	6	4	10	0	0	10	0	0
17	51232759	.	C	T	0	14	14	0	12	26	0	0
17	51241203	.	C	T	2	1	3	0	0	3	0	0
17	51253952	.	A	G	0	1	1	0	0	1	0	0
17	51256927	.	C	T	0	2	2	0	6	8	0	0
17	51256933	.	C	G	5	2	7	0	0	7	0	0
17	51257013	.	A	G	2	4	6	0	1	7	0	0
17	51303112	.	C	T	1	8	9	0	0	9	0	0
17	51303130	.	G	A	0	11	11	0	2	13	0	0
17	51305422	.	A	T	9	14	23	0	2	25	0	0
17	51305458	.	G	C	9	12	21	0	1	22	0	0
17	51307706	.	G	A	8	5	13	1	0	14	0	0
17	51307871	.	A	G	8	0	8	0	8	16	0	0
17	51308331	.	G	A	0	2	2	0	1	3	0	0
17	51308355	.	G	A	1	2	3	0	0	3	0	0
17	51313965	.	A	T	1	2	3	0	0	3	0	0
17	51313994	.	C	T	2	0	2	0	1	3	0	0
17	51314002	.	G	C	2	1	3	0	0	3	0	0
17	51314066	.	A	T	1	4	5	0	0	5	0	0
17	51708541	.	G	A	0	2	2	0	0	2	0	0
17	51711040	.	A	G	4	2	6	0	0	6	0	0
17	51711184	.	C	A	5	4	9	0	1	10	0	0
17	51711194	.	C	A	5	6	11	0	0	11	0	0
17	51711268	.	G	A	0	2	2	0	0	2	0	0
17	51715641	.	G	A	0	2	2	0	0	2	0	0
17	51743916	.	A	G	2	3	5	0	0	5	0	0
17	51749051	.	G	T	0	1	1	0	0	1	0	0
17	51749545	.	G	T	1	9	10	0	2	12	0	0
17	51752790	.	A	G	6	8	14	0	0	14	0	0
17	51753138	.	T	G	2	3	5	0	0	5	0	0
17	51757010	.	G	A	4	13	17	0	1	18	0	0
17	51757380	.	T	G	5	9	14	0	1	15	0	0
17	51757387	.	A	T	5	7	12	0	1	13	0	0
17	51780543	.	G	A	1	0	1	0	0	1	0	0
17	51788933	.	A	G	2	2	4	0	0	4	0	0
17	51789314	.	T	A	2	2	4	0	0	4	0	0
17	51796837	.	A	G	3	2	5	0	3	8	0	0
17	51796843	.	A	T	4	3	7	0	0	7	0	0
17	51796888	.	G	A	1	3	4	0	0	4	0	0
17	51797004	.	G	A	3	4	7	0	0	7	0	0
17	51797015	.	T	C	3	1	4	0	5	9	0	0
17	51797145	.	A	G	4	2	6	0	0	6	0	0
17	51797223	.	G	A	9	5	14	0	1	15	0	0
17	51797333	.	A	G	3	6	9	0	0	9	0	0
17	51797782	.	C	T	7	3	10	0	4	14	0	0
17	51797788	.	T	A	5	5	10	0	4	14	0	0
17	51797863	.	G	A	8	6	14	0	0	14	0	0
17	51805764	.	T	G	2	2	4	0	0	4	0	0
17	51805976	.	G	A	0	3	3	0	0	3	0	0
17	51815206	.	C	G	0	1	1	0	0	1	0	0
17	51822481	.	G	A	3	3	6	0	1	7	0	0
17	51823152	.	A	G	5	8	13	0	0	13	0	0
17	51823568	.	G	A	10	7	17	0	1	18	0	0
17	51823617	.	G	T	12	5	17	0	1	18	0	0
17	51823903	.	T	G	4	2	6	0	0	6	0	0
17	51823989	.	G	T	3	2	5	0	0	5	0	0
17	51824046	.	C	T	3	4	7	0	0	7	0	0
17	51824061	.	G	A	3	3	6	0	1	7	0	0
17	51824171	.	C	T	1	2	3	0	0	3	0	0
17	51824490	.	T	C	2	2	4	1	0	5	0	0
17	51824574	.	T	C	1	4	5	0	0	5	0	0
17	51824591	.	G	A	3	3	6	0	0	6	0	0
17	51824790	.	T	C	1	4	5	0	0	5	0	0
17	51825086	.	A	G	3	5	8	0	1	9	0	0
17	51825094	.	G	A	3	5	8	0	0	8	0	0
17	51825138	.	C	T	0	4	4	0	7	11	0	0
17	51825421	.	T	G	4	3	7	0	0	7	0	0
17	51825455	.	A	G	3	8	11	0	0	11	0	0
17	51825576	.	A	C	8	0	8	0	9	17	0	0
17	51825813	.	T	A	8	7	15	0	2	17	0	0
17	51825969	.	A	T	6	3	9	0	2	11	0	0
17	51826025	.	G	T	3	1	4	0	2	6	0	0
17	51826035	.	C	T	4	1	5	0	4	9	0	0
17	51826062	.	G	T	3	7	10	0	2	12	0	0
17	51826088	.	A	G	8	8	16	0	1	17	0	0
17	51826149	.	A	C	10	1	11	0	11	22	0	0
17	51826172	.	T	C	7	0	7	0	9	16	0	0
17	51826236	.	T	C	1	0	1	0	0	1	0	0
17	51893050	.	T	G	4	4	8	0	1	9	0	0
17	52090860	.	G	A	1	2	3	0	0	3	0	0
17	52385529	.	A	G	1	3	4	0	0	4	0	0
17	52533036	.	C	G	5	10	15	0	1	16	0	0
17	52533073	.	C	T	5	4	9	0	0	9	0	0
17	52534241	.	G	A	0	7	7	0	7	14	0	0
17	52534343	.	G	A	6	6	12	0	11	23	0	0
17	52541342	.	G	A	0	12	12	0	14	26	0	0
17	52553107	.	C	A	17	18	35	0	2	37	0	0
17	52553141	.	T	C	18	14	32	0	2	34	0	0
17	52553270	.	G	A	16	15	31	0	1	32	0	0
17	52560036	.	G	A	1	5	6	0	0	6	0	0
17	52560050	.	G	C	2	2	4	0	0	4	0	0
17	52565832	.	T	G	1	0	1	0	0	1	0	0
17	52565833	.	C	T	0	0	0	0	1	1	0	0
17	52566100	.	C	T	0	9	9	0	2	11	0	0
17	52566423	.	T	C	8	0	8	0	6	14	0	0
17	52566925	.	A	G	3	4	7	0	0	7	0	0
17	52568040	.	A	C	0	0	0	0	4	4	0	0
17	52568112	.	C	G	1	4	5	0	0	5	0	0
17	52576250	.	G	A	1	3	4	0	0	4	0	0
17	52576316	.	G	A	2	5	7	0	1	8	0	0
17	52576380	.	A	G	1	3	4	0	1	5	0	0
17	52578489	.	A	G	0	2	2	0	0	2	0	0
17	52578491	.	A	G	0	2	2	0	0	2	0	0
17	52630641	.	A	G	2	5	7	0	0	7	0	0
17	52630796	.	G	A	5	2	7	0	1	8	0	0
17	52630810	.	C	T	4	0	4	0	0	4	0	0
17	52632139	.	A	G	4	12	16	0	0	16	0	0
17	52632151	.	G	C	4	10	14	0	0	14	0	0
17	52632386	.	T	C	3	0	3	0	3	6	0	0
17	52632404	.	G	A	3	2	5	0	0	5	0	0
17	52635258	.	A	G	3	5	8	0	0	8	0	0
17	52635261	.	C	T	0	4	4	0	4	8	0	0
17	52635954	.	C	T	0	1	1	0	0	1	0	0
17	52636829	.	C	T	3	11	14	0	1	15	0	0
17	52636831	.	C	G	3	12	15	0	0	15	0	0
17	52639729	.	C	T	0	12	12	0	15	27	0	0
17	52640311	.	G	A	14	23	37	0	1	38	0	0
17	52640385	.	G	C	14	19	33	0	2	35	0	0
17	52640419	.	C	T	1	15	16	0	17	33	0	0
17	52640540	.	C	T	0	17	17	0	17	34	0	0
17	52640645	.	T	G	10	15	25	0	0	25	0	0
17	52641091	.	A	T	13	8	21	0	1	22	0	0
17	52641571	.	C	T	13	6	19	0	3	23	1	0
17	52641724	.	A	C	13	8	21	0	2	23	0	0
17	52641751	.	G	C	14	0	14	0	12	26	0	0
17	52650878	.	G	C	1	0	1	0	1	2	0	0
17	52856614	.	T	C	12	12	24	0	1	25	0	0
17	52920792	.	C	T	30	14	44	1	1	46	0	0
17	52940864	.	C	T	0	3	3	0	5	8	0	0
17	52940880	.	T	C	6	3	9	0	0	9	0	0
17	52991249	.	C	T	0	1	1	0	0	1	0	0
17	53156722	.	A	C	2	2	4	0	0	4	0	0
17	53190761	.	C	G	1	0	1	0	0	1	0	0
17	53250861	.	C	T	3	5	8	0	1	9	0	0
17	53250909	.	G	A	0	5	5	0	7	12	0	0
17	53251101	.	A	G	2	2	4	0	0	4	0	0
17	53259471	.	C	G	1	0	1	0	4	5	0	0
17	53274587	.	A	G	0	1	1	0	0	1	0	0
17	53298000	.	C	G	3	0	3	0	7	10	0	0
17	53298033	.	C	T	7	6	13	0	0	13	0	0
17	53298051	.	G	A	4	7	11	0	0	11	0	0
17	53298616	.	G	A	3	3	6	0	1	7	0	0
17	53299485	.	T	C	8	3	11	0	0	11	0	0
17	53301275	.	A	G	1	0	1	0	1	2	0	0
17	53301281	.	C	T	1	1	2	0	0	2	0	0
17	53302527	.	T	C	3	1	4	0	0	4	0	0
17	53303258	.	G	A	0	7	7	0	7	14	0	0
17	53303980	.	G	C	4	7	11	0	1	12	0	0
17	53304566	.	G	A	3	5	8	0	0	8	0	0
17	53304635	.	A	T	7	5	12	0	1	13	0	0
17	53305318	.	G	C	5	8	13	0	0	13	0	0
17	53305327	.	C	T	3	4	7	0	0	7	0	0
17	53307580	.	C	G	14	7	21	0	1	22	0	0
17	53308737	.	T	C	7	9	16	0	1	17	0	0
17	53314981	.	A	G	1	0	1	0	3	4	0	0
17	53315422	.	C	T	6	2	8	0	0	8	0	0
17	53315604	.	G	A	5	6	11	0	0	11	0	0
17	53315750	.	C	G	4	4	8	0	0	8	0	0
17	53317065	.	C	T	2	0	2	0	0	2	0	0
17	53317123	.	T	C	0	5	5	0	0	5	0	0
17	53317175	.	G	A	0	3	3	0	2	5	0	0
17	53317663	.	T	C	4	2	6	0	0	6	0	0
17	53317664	.	C	A	4	2	6	0	0	6	0	0
17	53317917	.	A	G	2	3	5	0	0	5	0	0
17	53346648	.	C	A	2	4	6	0	0	6	0	0
17	53349843	.	T	G	1	3	4	0	0	4	0	0
17	53364181	.	C	T	2	7	9	0	0	9	0	0
17	53393165	.	G	A	15	11	26	0	0	26	0	0
18	1689	.	A	C	9	8	17	0	0	17	0	0
18	1983	.	T	C	2	2	4	0	0	4	0	0
18	2725	.	G	A	13	4	17	0	2	19	0	0
18	11295	.	A	G	3	2	5	0	1	6	0	0
18	17639	.	G	A	5	3	8	0	1	9	0	0
18	17786	.	G	A	3	5	8	0	0	8	0	0
18	17795	.	G	A	3	7	10	0	0	10	0	0
18	18731	.	A	G	0	0	0	0	0	0	0	0
18	22746	.	A	G	2	2	4	0	0	4	0	0
18	35902	.	G	A	2	5	7	0	0	7	0	0
18	35921	.	A	G	3	5	8	0	0	8	0	0
18	54387	.	C	G	2	1	3	0	0	3	0	0
18	54502	.	C	T	1	2	3	0	0	3	0	0
18	60408	.	T	C	1	1	2	0	0	2	0	0
18	73584	.	G	A	9	7	16	0	0	16	0	0
18	73714	.	C	G	5	6	11	0	1	12	0	0
18	73740	.	A	C	8	0	8	0	7	15	0	0
18	74095	.	T	C	4	3	7	0	1	8	0	0
18	74680	.	G	A	5	7	12	0	3	15	0	0
18	74788	.	C	T	1	7	8	0	9	17	0	0
18	74866	.	C	T	11	11	22	0	2	24	0	0
18	81898	.	C	T	4	4	8	0	0	8	0	0
18	81944	.	A	T	4	3	7	0	0	7	0	0
18	82705	.	C	T	6	10	16	0	0	16	0	0
18	97588	.	C	T	0	1	1	0	0	1	0	0
18	97762	.	G	A	4	4	8	0	0	8	0	0
18	97789	.	C	T	1	3	4	0	0	4	0	0
18	98622	.	G	A	8	5	13	0	0	13	0	0
18	100483	.	A	G	4	0	4	0	18	22	0	0
18	100944	.	G	A	0	11	11	0	12	23	0	0
18	102350	.	T	G	13	0	13	0	7	20	0	0
18	102353	.	A	G	13	5	18	0	1	19	0	0
18	103101	.	G	C	0	1	1	0	1	2	0	0
18	104405	.	G	A	0	5	5	0	3	8	0	0
18	106814	.	T	C	11	11	22	0	3	25	0	0
18	107015	.	T	C	9	12	21	0	2	23	0	0
18	107135	.	A	T	10	14	24	0	2	26	0	0
18	107345	.	A	G	17	0	17	0	18	35	0	0
18	114089	.	A	C	12	5	17	0	2	19	0	0
18	114502	.	T	C	2	1	3	0	5	8	0	0
18	114713	.	A	T	8	5	13	0	0	13	0	0
18	117788	.	G	A	3	9	12	0	0	12	0	0
18	118729	.	G	A	5	6	11	0	0	11	0	0
18	118912	.	G	A	2	7	9	0	0	9	0	0
18	123917	.	T	C	1	0	1	0	0	1	0	0
18	127438	.	G	A	3	5	8	0	0	8	0	0
18	127444	.	A	G	3	4	7	0	0	7	0	0
18	127678	.	A	G	1	3	4	0	0	4	0	0
18	130779	.	T	A	1	1	2	0	0	2	0	0
18	131065	.	T	C	1	0	1	0	5	6	0	0
18	131092	.	C	T	0	4	4	0	5	9	0	0
18	144447	.	G	A	5	4	9	0	0	9	0	0
18	146940	.	C	A	1	1	2	0	0	2	0	0
18	173660	.	C	T	9	7	16	0	2	18	0	0
18	173903	.	C	A	12	8	20	0	1	21	0	0
18	184917	.	T	C	5	3	8	0	0	8	0	0
18	193689	.	A	C	6	16	22	0	0	22	0	0
18	193982	.	C	T	6	10	16	0	3	19	0	0
18	194006	.	A	G	7	0	7	0	12	19	0	0
18	194078	.	C	T	17	17	34	0	2	36	0	0
18	194162	.	G	C	0	22	22	0	22	44	0	0
18	194318	.	A	G	13	12	25	0	0	25	0	0
18	194460	.	C	G	10	3	13	0	0	13	0	0
18	194464	.	C	T	9	4	13	0	0	13	0	0
18	194799	.	T	C	6	3	9	0	2	11	0	0
18	194836	.	T	A	5	2	7	0	0	7	0	0
18	204678	.	A	C	6	4	10	0	1	11	0	0
18	204742	.	G	A	9	12	21	0	0	21	0	0
18	204828	.	G	A	14	12	26	0	2	28	0	0
18	204866	.	T	A	10	16	26	0	11	37	0	0
18	204980	.	C	T	14	18	32	0	4	36	0	0
18	204982	.	G	A	18	16	34	0	2	36	0	0
18	205095	.	C	T	1	23	24	0	17	41	0	0
18	205105	.	A	G	15	22	37	0	4	41	0	0
18	205152	.	G	A	27	4	31	0	1	32	0	0
18	205179	.	G	A	11	19	30	0	1	31	0	0
18	207172	.	T	C	1	3	4	0	1	5	0	0
18	207184	.	G	A	4	4	8	0	0	8	0	0
18	209114	.	G	A	12	13	25	0	0	25	0	0
18	209118	.	A	G	12	12	24	0	0	24	0	0
18	209321	.	T	G	2	1	3	0	0	3	0	0
18	209382	.	A	G	6	6	12	0	0	12	0	0
18	210385	.	T	A	16	11	27	0	1	28	0	0
18	210899	.	T	A	4	4	8	0	0	8	0	0
18	211101	.	G	A	8	7	15	0	0	15	0	0
18	211186	.	T	A	25	18	43	0	0	43	0	0
18	211304	.	T	C	18	1	19	0	8	27	0	0
18	211346	.	C	T	1	8	9	0	16	25	0	0
18	211380	.	G	A	19	17	36	0	0	36	0	0
18	211399	.	T	C	20	17	37	0	0	37	0	0
18	211438	.	T	A	13	10	23	0	1	24	0	0
18	211469	.	C	A	8	14	22	0	1	23	0	0
18	211483	.	A	T	10	10	20	0	3	23	0	0
18	211605	.	A	G	18	11	29	0	0	29	0	0
18	211610	.	T	C	18	0	18	0	12	30	0	0
18	211812	.	T	A	5	7	12	0	1	13	0	0
18	212305	.	A	G	15	3	18	0	0	18	0	0
18	214688	.	A	G	2	12	14	0	0	14	0	0
18	214717	.	T	C	2	15	17	0	0	17	0	0
18	216775	.	G	A	1	5	6	0	0	6	0	0
18	216779	.	G	A	2	5	7	0	0	7	0	0
18	220144	.	G	A	15	10	25	0	0	25	0	0
18	222448	.	T	C	2	0	2	0	3	5	0	0
18	334298	.	T	C	6	8	14	0	0	14	0	0
18	334983	.	A	C	1	2	3	0	0	3	0	0
18	580961	.	G	A	0	0	0	0	3	3	0	0
18	581075	.	G	A	0	1	1	0	1	2	0	0
18	597148	.	C	T	1	0	1	0	0	1	0	0
18	609280	.	G	A	1	2	3	0	0	3	0	0
18	609365	.	A	G	5	2	7	0	0	7	0	0
18	609877	.	G	A	8	4	12	0	0	12	0	0
18	609935	.	G	A	0	8	8	0	8	16	0	0
18	610126	.	A	T	6	12	18	0	1	19	0	0
18	610148	.	A	T	5	10	15	0	1	16	0	0
18	610184	.	G	T	1	8	9	0	0	9	0	0
18	610187	.	G	T	1	9	10	0	0	10	0	0
18	610291	.	T	C	5	9	14	0	0	14	0	0
18	610631	.	T	A	6	2	8	0	0	8	0	0
18	643517	.	C	T	4	4	8	0	0	8	0	0
18	660688	.	T	C	5	3	8	0	0	8	0	0
18	660752	.	G	C	0	2	2	0	3	5	0	0
18	660846	.	C	A	1	3	4	0	0	4	0	0
18	789974	.	T	A	8	7	15	0	0	15	0	0
18	790247	.	T	C	6	8	14	0	0	14	0	0
18	790301	.	T	A	9	7	16	0	0	16	0	0
18	790451	.	T	G	13	2	15	0	13	28	0	0
18	790962	.	T	G	11	10	21	0	1	22	0	0
18	791069	.	A	G	9	0	9	0	6	15	0	0
18	791076	.	G	C	8	6	14	0	1	15	0	0
18	791137	.	T	A	5	10	15	0	0	15	0	0
18	791171	.	G	C	4	10	14	0	0	14	0	0
18	791246	.	G	A	10	10	20	0	1	21	0	0
18	791348	.	T	A	4	3	7	0	1	8	0	0
18	791350	.	T	A	3	3	6	0	2	8	0	0
18	791582	.	G	A	0	2	2	0	5	7	0	0
18	809012	.	G	T	18	18	36	0	1	37	0	0
18	824921	.	G	A	1	3	4	0	0	4	0	0
18	824994	.	G	A	0	2	2	0	1	3	0	0
18	825078	.	A	T	4	2	6	0	0	6	0	0
18	825130	.	G	C	4	2	6	0	0	6	0	0
18	826190	.	A	T	7	7	14	0	1	15	0	0
18	826574	.	C	T	7	5	12	0	1	13	0	0
18	827232	.	G	A	1	2	3	0	1	4	0	0
18	888440	.	G	A	2	3	5	0	0	5	0	0
18	891534	.	C	A	5	4	9	0	1	10	0	0
18	891586	.	G	A	1	0	1	0	0	1	0	0
18	911036	.	C	A	1	1	2	0	0	2	0	0
18	911076	.	A	G	0	0	0	0	1	1	0	0
18	925088	.	C	T	13	15	28	0	4	32	0	0
18	925100	.	A	C	9	13	22	0	1	23	0	0
18	933299	.	G	A	9	20	29	0	1	30	0	0
18	936728	.	C	T	39	26	65	0	2	67	0	0
18	939430	.	C	T	14	18	32	0	2	34	0	0
18	951004	.	A	T	34	28	62	0	3	65	0	0
18	951005	.	T	C	33	30	63	0	2	65	0	0
18	1154270	.	A	G	2	2	4	0	0	4	0	0
18	1154278	.	A	G	2	2	4	0	0	4	0	0
18	1158399	.	G	A	1	0	1	0	0	1	0	0
18	1161750	.	A	G	5	12	17	0	1	18	0	0
18	1173819	.	G	A	2	3	5	0	0	5	0	0
18	1173856	.	G	A	15	14	29	0	1	30	0	0
18	1173898	.	A	G	25	24	49	0	2	51	0	0
18	1292100	.	C	T	1	6	7	0	5	12	0	0
18	1292164	.	G	A	8	0	8	0	0	8	0	0
18	1292668	.	T	C	2	0	2	0	1	3	0	0
18	1293182	.	G	A	4	3	7	0	1	8	0	0
18	2173451	.	T	C	1	0	1	0	0	1	0	0
18	2197638	.	A	C	4	4	8	0	0	8	0	0
18	2205302	.	T	A	3	4	7	0	0	7	0	0
18	2208642	.	A	C	1	0	1	0	1	2	0	0
18	2211091	.	T	C	1	3	4	0	0	4	0	0
18	2214873	.	A	G	1	2	3	0	0	3	0	0
18	2215557	.	C	T	1	0	1	0	0	1	0	0
18	2225632	.	C	T	2	1	3	0	0	3	0	0
18	2225661	.	C	T	4	7	11	0	0	11	0	0
18	2225947	.	T	C	1	4	5	0	0	5	0	0
18	2377645	.	T	C	5	0	5	0	14	19	0	0
18	2377860	.	G	A	13	6	19	0	0	19	0	0
18	2378273	.	T	C	1	2	3	0	0	3	0	0
18	2378462	.	A	T	5	3	8	0	0	8	0	0
18	2378495	.	T	A	4	2	6	0	0	6	0	0
18	2378510	.	C	A	1	5	6	0	0	6	0	0
18	2378687	.	A	C	7	5	12	0	0	12	0	0
18	2378713	.	T	G	7	8	15	0	0	15	0	0
18	2378722	.	C	T	0	7	7	0	8	15	0	0
18	2379073	.	G	A	1	7	8	0	0	8	0	0
18	2408681	.	C	A	0	2	2	0	0	2	0	0
18	2412660	.	T	C	2	8	10	0	0	10	0	0
18	2412726	.	G	C	1	0	1	0	0	1	0	0
18	2533391	.	C	A	0	1	1	0	0	1	0	0
18	2603576	.	T	G	9	4	13	0	0	13	0	0
18	2603786	.	A	G	5	10	15	0	0	15	0	0
18	2612259	.	A	G	2	3	5	0	0	5	0	0
18	2612293	.	A	G	7	6	13	0	0	13	0	0
18	2619228	.	A	G	2	1	3	0	0	3	0	0
18	2629229	.	T	C	1	0	1	0	1	2	0	0
18	2629415	.	C	T	2	2	4	0	0	4	0	0
18	2634309	.	T	G	1	0	1	0	0	1	0	0
18	2668603	.	G	A	3	2	5	0	0	5	0	0
18	2681965	.	G	A	14	12	26	0	0	26	0	0
18	2682182	.	C	T	0	13	13	0	12	25	0	0
18	2682203	.	A	T	9	15	24	0	1	25	0	0
18	2682610	.	T	C	14	11	25	0	1	26	0	0
18	2682683	.	C	T	14	10	24	0	2	26	0	0
18	2682700	.	T	C	18	10	28	0	0	28	0	0
18	2683365	.	G	T	4	6	10	0	1	11	0	0
18	2683508	.	A	C	3	0	3	0	1	6	2	0
18	2684456	.	T	C	1	3	4	0	0	4	0	0
18	2684458	.	A	G	1	3	4	0	0	4	0	0
18	2684589	.	T	C	4	0	4	0	6	10	0	0
18	2684731	.	A	C	5	2	7	0	1	9	1	0
18	2684872	.	A	G	7	4	11	0	1	12	0	0
18	2684889	.	A	T	9	4	13	0	1	14	0	0
18	2685127	.	C	A	6	4	10	0	0	10	0	0
18	2685138	.	C	T	0	5	5	0	8	13	0	0
18	2685162	.	T	C	8	0	8	0	7	15	0	0
18	2685263	.	A	G	6	3	9	0	1	10	0	0
18	2685297	.	A	G	8	3	11	0	2	13	0	0
18	2685312	.	G	A	7	5	12	0	0	12	0	0
18	2685348	.	C	T	0	3	3	0	13	16	0	0
18	2687992	.	C	T	0	0	0	0	1	1	0	0
18	2692381	.	A	C	0	2	2	0	0	2	0	0
18	2702458	.	G	A	4	8	12	0	0	12	0	0
18	2702524	.	C	T	7	8	15	0	0	15	0	0
18	2702536	.	A	G	7	5	12	0	2	14	0	0
18	2702569	.	C	T	0	6	6	0	5	11	0	0
18	2702976	.	A	C	7	3	10	0	0	10	0	0
18	2703120	.	A	G	2	0	2	0	0	2	0	0
18	2708467	.	G	A	2	2	4	0	0	4	0	0
18	2708505	.	C	T	2	2	4	0	0	4	0	0
18	2710216	.	A	G	1	2	3	0	0	3	0	0
18	2710231	.	T	C	2	0	2	0	3	5	0	0
18	2711894	.	C	G	0	6	6	0	3	9	0	0
18	2713199	.	C	T	1	2	3	0	0	3	0	0
18	2721565	.	A	G	3	2	5	0	0	5	0	0
18	2902985	.	A	G	0	0	0	0	1	1	0	0
18	2934856	.	A	G	5	5	10	0	0	10	0	0
18	2935243	.	G	C	4	4	8	0	0	8	0	0
18	2935265	.	A	T	3	6	9	0	1	10	0	0
18	2935480	.	C	T	13	12	25	0	1	26	0	0
18	3006843	.	C	T	4	3	7	0	1	8	0	0
18	3039440	.	A	G	22	18	40	0	2	42	0	0
18	3049752	.	T	G	2	2	4	0	0	4	0	0
18	3049756	.	A	G	3	2	5	0	0	5	0	0
18	3078582	.	C	T	0	3	3	0	0	3	0	0
18	3087662	.	G	A	0	1	1	0	0	1	0	0
18	3087695	.	T	G	0	5	5	0	0	5	0	0
18	3087704	.	T	A	0	5	5	0	0	5	0	0
18	3087776	.	G	A	6	2	8	0	0	8	0	0
18	3089906	.	T	C	2	4	6	0	0	6	0	0
18	3096926	.	C	T	2	2	4	0	0	4	0	0
18	3100651	.	A	G	0	5	5	0	0	5	0	0
18	3140800	.	G	A	0	2	2	0	3	5	0	0
18	3142685	.	A	G	5	7	12	0	0	12	0	0
18	3144677	.	G	A	0	2	2	0	3	5	0	0
18	3144742	.	A	T	5	4	9	0	0	9	0	0
18	3153072	.	G	C	9	4	13	0	0	13	0	0
18	3153231	.	A	T	2	5	7	0	1	8	0	0
18	3158739	.	A	G	8	15	23	0	0	23	0	0
18	3158776	.	G	A	11	7	18	0	0	18	0	0
18	3158896	.	C	T	3	3	6	0	0	6	0	0
18	3159140	.	C	A	3	6	9	0	0	9	0	0
18	3159193	.	G	A	3	4	7	0	0	7	0	0
18	3159656	.	C	A	0	3	3	0	0	3	0	0
18	3159658	.	C	G	0	3	3	0	0	3	0	0
18	3159713	.	T	C	8	4	12	0	0	12	0	0
18	3159965	.	A	T	5	3	8	0	0	8	0	0
18	3160218	.	C	T	0	6	6	0	8	14	0	0
18	3160308	.	A	G	7	6	13	0	0	13	0	0
18	3160354	.	C	T	0	6	6	0	3	9	0	0
18	3160406	.	T	C	1	1	2	0	4	6	0	0
18	3259736	.	C	T	18	17	35	0	4	39	0	0
18	3259807	.	C	A	11	14	25	0	4	29	0	0
18	3259847	.	C	T	22	18	40	0	2	42	0	0
18	3276085	.	G	C	11	23	34	0	0	34	0	0
18	3276187	.	A	G	2	0	2	0	1	3	0	0
18	3283882	.	T	C	20	19	39	0	1	40	0	0
18	3334609	.	C	T	2	3	5	0	0	5	0	0
18	3339152	.	G	C	6	5	11	0	0	11	0	0
18	3345093	.	A	G	3	0	3	0	3	6	0	0
18	3345141	.	T	A	4	4	8	0	0	8	0	0
18	3501282	.	C	T	2	2	4	0	1	5	0	0
18	3501283	.	C	G	3	2	5	0	0	5	0	0
18	3536868	.	A	T	7	1	8	0	1	9	0	0
18	3536937	.	T	C	1	0	1	0	0	1	0	0
18	3539989	.	C	T	0	3	3	0	5	8	0	0
18	3540027	.	C	T	2	1	3	0	0	3	0	0
18	3556542	.	A	G	1	1	2	0	0	2	0	0
18	3556626	.	C	T	1	14	15	0	13	28	0	0
18	3556935	.	C	T	5	5	10	0	0	10	0	0
18	3562608	.	A	G	0	1	1	0	0	1	0	0
18	3565635	.	T	C	3	1	4	0	1	5	0	0
18	3572547	.	G	A	1	3	4	0	0	4	0	0
18	3575938	.	C	A	3	5	8	0	0	8	0	0
18	3576104	.	C	T	15	5	20	0	3	23	0	0
18	3576212	.	A	C	1	2	3	0	1	4	0	0
18	3617759	.	C	T	0	1	1	0	0	1	0	0
18	3618015	.	C	G	1	0	1	0	0	1	0	0
18	5167603	.	A	G	22	6	28	0	5	33	0	0
18	5167604	.	A	G	21	9	30	0	3	33	0	0
18	5170069	.	A	G	15	0	15	0	32	47	0	0
18	5234937	.	C	A	0	18	18	0	15	33	0	0
18	5234990	.	T	G	11	8	19	0	0	19	0	0
18	5235033	.	C	T	0	2	2	0	0	2	0	0
18	5242329	.	G	A	4	7	11	0	1	12	0	0
18	5243234	.	A	G	2	6	8	0	0	8	0	0
18	5243255	.	T	C	2	7	9	0	1	10	0	0
18	5244986	.	G	A	4	3	7	0	0	7	0	0
18	5245615	.	G	A	1	2	3	0	0	3	0	0
18	5245806	.	T	C	14	18	32	0	0	32	0	0
18	5245818	.	C	T	0	17	17	0	13	30	0	0
18	5308441	.	T	G	2	6	8	0	0	8	0	0
18	5375143	.	A	G	4	5	9	0	2	11	0	0
18	5378093	.	C	A	0	1	1	0	0	1	0	0
18	5454381	.	G	A	2	4	6	0	0	6	0	0
18	5455347	.	G	T	0	6	6	0	5	11	0	0
18	5456883	.	C	T	1	2	3	0	0	3	0	0
18	5456940	.	G	A	2	4	6	0	0	6	0	0
18	5491697	.	G	A	3	7	10	0	0	10	0	0
18	5494980	.	A	G	3	4	7	0	0	7	0	0
18	5495903	.	T	C	8	17	25	0	7	32	0	0
18	5506578	.	C	T	5	4	9	0	0	9	0	0
18	5509426	.	G	C	2	7	9	0	0	9	0	0
18	5514544	.	T	A	4	4	8	0	1	9	0	0
18	5514678	.	G	A	1	6	7	0	3	10	0	0
18	5518108	.	C	T	3	2	5	0	1	6	0	0
18	5518128	.	T	C	1	0	1	0	0	1	0	0
18	5518749	.	T	C	9	4	13	0	1	14	0	0
18	5519052	.	C	T	6	9	15	0	0	15	0	0
18	5519119	.	A	G	7	5	12	0	0	12	0	0
18	5519138	.	A	G	10	3	13	0	3	16	0	0
18	5519269	.	T	C	7	7	14	0	1	15	0	0
18	5519534	.	T	A	3	3	6	0	0	6	0	0
18	5533186	.	A	C	2	0	2	0	6	8	0	0
18	5535243	.	G	A	0	1	1	0	0	1	0	0
18	5537171	.	A	C	2	0	2	0	2	4	0	0
18	5537255	.	T	C	2	2	4	0	0	4	0	0
18	5539488	.	T	C	2	1	3	0	2	5	0	0
18	5539517	.	T	C	2	1	3	0	1	4	0	0
18	5624614	.	A	G	6	6	12	0	1	13	0	0
18	5624654	.	T	A	13	9	22	0	0	22	0	0
18	5626583	.	G	A	1	1	2	0	0	2	0	0
18	5626661	.	A	C	1	1	2	0	0	2	0	0
18	5692205	.	A	G	11	15	26	0	0	26	0	0
18	5692222	.	A	T	10	16	26	0	1	27	0	0
18	6862971	.	T	C	0	5	5	1	0	6	0	0
18	6868483	.	A	G	23	8	31	0	4	35	0	0
18	7571628	.	C	T	3	6	9	0	0	9	0	0
18	10693123	.	C	T	2	6	8	0	1	9	0	0
18	10693155	.	T	A	2	6	8	0	2	10	0	0
18	10693322	.	A	T	5	8	13	0	0	13	0	0
18	10698083	.	T	C	4	9	13	0	0	13	0	0
18	10698161	.	T	G	4	9	13	0	0	13	0	0
18	10698215	.	T	C	6	6	12	0	1	13	0	0
18	10703669	.	A	G	1	2	3	0	0	3	0	0
18	10710190	.	C	T	0	1	1	0	0	1	0	0
18	10820428	.	A	C	6	5	11	0	0	11	0	0
18	10825951	.	A	G	2	3	5	0	0	5	0	0
18	10840094	.	C	A	3	3	6	0	0	6	0	0
18	10840722	.	C	G	8	8	16	0	1	17	0	0
18	10846601	.	T	C	6	6	12	0	1	13	0	0
18	10847743	.	C	T	7	7	14	0	1	15	0	0
18	10847872	.	A	G	1	0	1	0	0	1	0	0
18	10867181	.	A	C	8	4	12	0	1	13	0	0
18	10870806	.	T	C	3	1	4	0	0	4	0	0
18	10877499	.	G	A	9	7	16	0	0	16	0	0
18	10879495	.	G	A	5	13	18	0	0	18	0	0
18	10888245	.	A	C	1	1	2	0	0	2	0	0
18	10888551	.	T	C	4	1	5	0	1	6	0	0
18	10888836	.	T	C	12	13	25	0	0	25	0	0
18	10889049	.	C	G	5	0	5	0	5	10	0	0
18	10889880	.	G	A	0	4	4	0	7	11	0	0
18	10889901	.	T	A	7	6	13	0	0	13	0	0
18	10889951	.	G	A	3	6	9	0	0	9	0	0
18	10890432	.	G	A	4	9	13	0	0	13	0	0
18	10921408	.	A	T	13	5	18	0	0	18	0	0
18	10921630	.	A	T	4	8	12	0	2	14	0	0
18	10921734	.	T	C	8	8	16	0	0	16	0	0
18	10921791	.	T	C	8	13	21	0	1	22	0	0
18	10921927	.	C	T	4	13	17	0	0	17	0	0
18	11507028	.	T	G	5	2	7	0	0	7	0	0
18	11507253	.	T	G	4	3	7	0	1	8	0	0
18	11507263	.	G	A	4	4	8	0	1	9	0	0
18	11515830	.	C	T	5	2	7	0	0	7	0	0
18	11537535	.	T	C	2	3	5	0	0	5	0	0
18	11537540	.	T	C	4	1	5	0	0	5	0	0
18	11541046	.	A	G	1	0	1	0	0	1	0	0
18	11558187	.	G	A	1	1	2	0	0	2	0	0
18	11558197	.	T	C	0	2	2	0	0	2	0	0
18	11858876	.	A	G	1	0	1	0	2	3	0	0
18	11878643	.	G	C	0	0	0	0	1	1	0	0
18	12058480	.	T	A	6	5	11	0	0	11	0	0
18	12105432	.	T	C	3	3	6	0	0	6	0	0
18	12105548	.	G	A	0	3	3	0	2	5	0	0
18	12111431	.	A	C	1	0	1	0	0	1	0	0
18	12111625	.	A	G	8	3	11	0	0	11	0	0
18	12111628	.	A	T	8	4	12	0	0	12	0	0
18	12111784	.	G	T	6	3	9	0	0	9	0	0
18	12111925	.	G	A	2	1	3	0	1	4	0	0
18	12112105	.	T	C	3	6	9	0	1	10	0	0
18	12112219	.	C	T	8	3	11	0	1	12	0	0
18	12112726	.	C	T	0	2	2	0	0	2	0	0
18	12112750	.	G	A	0	1	1	0	0	1	0	0
18	12113515	.	C	A	6	7	13	0	0	13	0	0
18	12113516	.	C	T	6	7	13	0	0	13	0	0
18	12116183	.	G	T	2	1	3	0	1	4	0	0
18	12171277	.	C	T	1	2	3	0	0	3	0	0
18	12171313	.	A	G	0	0	0	0	2	2	0	0
18	12196939	.	G	A	0	2	2	0	1	3	0	0
18	12207046	.	A	G	6	4	10	0	0	10	0	0
18	12207070	.	C	A	6	2	8	0	2	10	0	0
18	12214299	.	A	G	2	2	4	0	0	4	0	0
18	12228217	.	C	A	1	3	4	0	0	4	0	0
18	12228758	.	C	T	3	2	5	0	0	5	0	0
18	12228834	.	G	C	0	2	2	0	0	2	0	0
18	12229120	.	A	T	1	4	5	0	1	6	0	0
18	12229223	.	A	C	5	5	10	0	0	10	0	0
18	12229245	.	C	T	5	4	9	0	0	9	0	0
18	12229405	.	G	A	3	3	6	0	0	6	0	0
18	12236126	.	T	A	1	3	4	0	0	4	0	0
18	12236351	.	C	T	3	2	5	0	0	5	0	0
18	12238082	.	G	A	3	2	5	0	0	5	0	0
18	12240681	.	C	T	7	3	10	0	2	12	0	0
18	12240740	.	G	C	0	1	1	0	0	1	0	0
18	12242967	.	C	T	0	1	1	0	0	1	0	0
18	12245525	.	A	G	4	6	10	0	0	10	0	0
18	12245576	.	A	G	3	2	5	0	0	5	0	0
18	12250727	.	G	A	3	2	5	0	0	5	0	0
18	12254409	.	G	A	3	1	4	0	0	4	0	0
18	12254905	.	G	A	2	3	5	0	0	5	0	0
18	12276859	.	C	T	16	7	23	0	2	25	0	0
18	12277052	.	A	G	11	4	15	0	0	15	0	0
18	12277206	.	G	C	11	14	25	0	0	25	0	0
18	12277490	.	G	A	24	14	38	0	2	40	0	0
18	12280269	.	C	T	16	6	22	0	0	22	0	0
18	12292017	.	G	A	19	10	29	0	6	35	0	0
18	12327321	.	C	A	0	2	2	0	0	2	0	0
18	12364876	.	G	A	2	4	6	0	0	6	0	0
18	12366097	.	G	T	1	2	3	0	0	3	0	0
18	12374108	.	C	A	0	1	1	0	0	1	0	0
18	12374168	.	A	G	5	2	7	0	0	7	0	0
18	12374497	.	C	T	0	2	2	0	2	4	0	0
18	12374521	.	A	G	2	2	4	0	0	4	0	0
18	12397571	.	T	C	4	0	4	0	4	8	0	0
18	12409681	.	C	T	0	2	2	0	0	2	0	0
18	12409705	.	A	T	0	3	3	0	0	3	0	0
18	12417543	.	G	A	1	3	4	0	0	4	0	0
18	12417547	.	G	A	1	2	3	0	0	3	0	0
18	12418207	.	G	A	2	2	4	0	0	4	0	0
18	12464867	.	C	A	5	5	10	0	0	10	0	0
18	12465290	.	G	A	6	3	9	0	1	10	0	0
18	12465316	.	C	T	4	3	7	0	1	8	0	0
18	12467834	.	G	C	2	0	2	0	5	7	0	0
18	12470013	.	G	T	7	7	14	0	2	16	0	0
18	12470136	.	G	A	4	10	14	0	1	15	0	0
18	12470148	.	A	G	8	4	12	0	2	14	0	0
18	12470211	.	C	T	0	7	7	0	2	9	0	0
18	12471210	.	T	C	1	0	1	0	0	1	0	0
18	12471225	.	G	A	1	1	2	0	0	2	0	0
18	12495185	.	C	T	2	1	3	0	1	4	0	0
18	12611569	.	T	C	1	1	2	0	0	2	0	0
18	12612160	.	A	G	4	3	7	0	2	9	0	0
18	12659197	.	C	T	4	5	9	0	0	9	0	0
18	12659226	.	C	T	0	2	2	0	0	2	0	0
18	12776727	.	C	T	5	5	10	0	0	10	0	0
18	12779357	.	T	A	5	5	10	0	0	10	0	0
18	12833894	.	A	G	4	9	13	0	0	13	0	0
18	12833983	.	A	T	4	3	7	0	0	7	0	0
18	12834211	.	C	T	2	3	5	0	0	5	0	0
18	12867505	.	A	G	1	4	5	0	1	6	0	0
18	12867594	.	C	T	0	2	2	0	1	3	0	0
18	12867807	.	G	A	1	1	2	0	1	3	0	0
18	12871545	.	G	T	4	4	8	0	0	8	0	0
18	12871605	.	C	T	1	3	4	0	6	10	0	0
18	12871650	.	G	A	6	7	13	0	0	13	0	0
18	12949899	.	A	G	2	4	6	0	0	6	0	0
18	12949932	.	C	T	0	4	4	0	4	8	0	0
18	13063534	.	G	A	10	13	23	0	2	25	0	0
18	13121754	.	G	A	0	1	1	0	0	1	0	0
18	13133040	.	C	T	4	1	5	0	0	5	0	0
18	13196113	.	A	G	4	3	7	0	0	7	0	0
18	13196306	.	C	T	3	1	4	0	1	5	0	0
18	13203319	.	A	T	1	1	2	0	0	2	0	0
18	13203385	.	A	G	1	2	3	0	0	3	0	0
18	13215966	.	G	A	22	20	42	0	1	43	0	0
18	13216051	.	C	T	21	15	36	0	0	36	0	0
18	13216566	.	T	A	10	8	18	0	0	18	0	0
18	13238078	.	G	A	0	2	2	0	2	4	0	0
18	13240208	.	T	A	0	1	1	0	0	1	0	0
18	13245795	.	G	A	3	9	12	0	0	12	0	0
18	13245803	.	A	G	4	8	12	0	0	12	0	0
18	13324391	.	G	A	15	9	24	0	0	24	0	0
18	13324416	.	T	C	15	13	28	0	2	30	0	0
18	13324473	.	G	A	17	24	41	0	4	45	0	0
18	13324494	.	T	C	24	0	24	0	15	39	0	0
18	13324747	.	A	G	19	25	44	0	0	44	0	0
18	13325224	.	A	G	16	29	45	0	1	46	0	0
18	13325225	.	C	T	16	28	44	0	2	46	0	0
18	13325451	.	G	T	17	18	35	0	0	35	0	0
18	13325492	.	C	T	15	19	34	0	0	34	0	0
18	13325679	.	C	T	0	9	9	0	6	15	0	0
18	13325912	.	G	A	13	10	23	0	0	23	0	0
18	13326124	.	A	C	13	1	14	0	10	24	0	0
18	13326178	.	G	T	7	12	19	0	2	21	0	0
18	13326400	.	C	T	0	6	6	0	7	13	0	0
18	13326593	.	G	C	14	17	31	0	0	31	0	0
18	13336278	.	G	A	3	3	6	0	0	6	0	0
18	13345001	.	C	G	3	4	7	0	1	8	0	0
18	13345088	.	G	A	14	10	24	0	3	27	0	0
18	13345166	.	A	C	10	0	10	0	13	23	0	0
18	13356438	.	A	G	11	11	22	0	0	22	0	0
18	13837843	.	T	C	2	2	4	0	0	4	0	0
18	13888370	.	A	T	10	4	14	0	3	17	0	0
18	13888406	.	G	A	4	5	9	0	2	11	0	0
18	14041036	.	C	T	12	15	27	0	1	28	0	0
18	14075262	.	A	G	8	9	17	0	0	17	0	0
18	14114915	.	G	A	3	4	7	0	0	7	0	0
18	14114930	.	C	T	8	6	14	0	1	15	0	0
18	14115011	.	A	G	14	16	30	0	1	31	0	0
18	14115083	.	G	C	6	12	18	0	1	19	0	0
18	14132006	.	G	A	0	4	4	0	5	9	0	0
18	14132077	.	A	T	18	29	47	0	2	49	0	0
18	14132360	.	G	A	0	18	18	0	16	34	0	0
18	14132836	.	A	G	23	11	34	0	1	35	0	0
18	14132892	.	T	C	20	13	33	0	0	33	0	0
18	14337320	.	T	A	14	6	20	0	1	21	0	0
18	14529721	.	T	C	3	3	6	0	0	6	0	0
18	14529971	.	A	T	4	3	7	0	0	7	0	0
18	14624038	.	T	C	3	2	5	0	0	5	0	0
18	14624885	.	T	C	1	3	4	0	0	4	0	0
18	14637888	.	T	C	1	3	4	0	0	4	0	0
18	14642018	.	T	C	0	4	4	0	0	4	0	0
18	14648859	.	C	A	0	1	1	0	0	1	0	0
18	14649227	.	G	A	1	6	7	0	5	12	0	0
18	14649408	.	A	T	4	1	5	0	0	5	0	0
18	14660205	.	C	G	4	3	7	0	0	7	0	0
18	14667830	.	A	T	3	5	8	0	1	9	0	0
18	14672230	.	G	A	3	4	7	0	0	7	0	0
18	14672353	.	A	G	3	1	4	0	0	4	0	0
18	14672542	.	A	T	5	2	7	0	0	7	0	0
18	14690967	.	G	A	4	2	6	0	0	6	0	0
18	14691037	.	T	C	2	4	6	0	0	6	0	0
18	14691634	.	G	C	1	3	4	0	0	4	0	0
18	14698371	.	C	T	6	4	10	0	1	11	0	0
18	14698538	.	A	G	4	4	8	0	1	9	0	0
18	14698860	.	A	C	8	10	18	0	1	19	0	0
18	14698928	.	G	T	11	7	18	0	1	19	0	0
18	14699012	.	T	A	1	0	1	0	0	1	0	0
18	14700684	.	A	G	11	0	11	0	9	20	0	0
18	14700731	.	A	T	10	4	14	0	2	16	0	0
18	14702153	.	G	A	8	2	10	0	0	10	0	0
18	14702427	.	G	A	3	11	14	0	0	14	0	0
18	14702439	.	T	C	3	10	13	0	0	13	0	0
18	14702511	.	G	T	0	4	4	0	5	9	0	0
18	14705287	.	T	C	12	8	20	0	0	20	0	0
18	14705308	.	A	G	7	9	16	0	1	17	0	0
18	14705371	.	T	C	14	15	29	0	3	32	0	0
18	14705518	.	G	A	1	2	3	0	6	9	0	0
18	14705656	.	A	T	7	2	9	0	0	9	0	0
18	14705667	.	G	T	8	2	10	0	0	10	0	0
18	14705770	.	A	T	5	2	7	0	0	7	0	0
18	14705808	.	A	G	4	2	6	0	0	6	0	0
18	14705936	.	A	C	1	2	3	0	0	3	0	0
18	14731967	.	T	C	12	0	12	0	12	24	0	0
18	14732128	.	G	A	8	8	16	0	0	16	0	0
18	14732809	.	T	C	10	5	15	0	0	15	0	0
18	14732840	.	T	G	10	6	16	0	0	16	0	0
18	14732859	.	C	T	0	6	6	0	10	16	0	0
18	14732885	.	T	C	9	10	19	0	0	19	0	0
18	14732903	.	T	A	8	11	19	0	0	19	0	0
18	14732923	.	G	A	10	14	24	0	1	25	0	0
18	14732996	.	T	C	5	11	16	0	0	16	0	0
18	14733019	.	C	A	8	8	16	0	0	16	0	0
18	14733114	.	A	T	3	7	10	0	0	10	0	0
18	14733362	.	G	A	2	4	6	0	1	7	0	0
18	14733402	.	C	T	2	4	6	0	0	6	0	0
18	14733638	.	A	G	5	3	8	0	1	9	0	0
18	14733839	.	A	G	1	5	6	0	0	6	0	0
18	14734651	.	C	T	2	6	8	0	0	8	0	0
18	14772889	.	A	G	3	7	10	0	0	10	0	0
18	14772957	.	A	T	7	3	10	0	2	12	0	0
18	14773020	.	T	A	12	4	16	0	1	17	0	0
18	14773140	.	C	T	7	5	12	0	2	14	0	0
18	14779171	.	G	A	3	2	5	0	0	5	0	0
18	14779192	.	A	G	2	2	4	0	0	4	0	0
18	14780608	.	G	T	0	1	1	0	1	2	0	0
18	14780644	.	A	G	0	2	2	0	0	2	0	0
18	14780650	.	G	C	0	2	2	0	0	2	0	0
18	14782677	.	C	T	2	2	4	0	0	4	0	0
18	14792337	.	T	A	2	0	2	0	0	2	0	0
18	14836628	.	C	G	1	2	3	0	0	3	0	0
18	14836678	.	C	T	2	4	6	0	0	6	0	0
18	14836684	.	G	A	3	3	6	0	0	6	0	0
18	14836744	.	T	C	2	7	9	0	0	9	0	0
18	14863613	.	T	A	3	4	7	0	0	7	0	0
18	14863675	.	A	G	4	3	7	0	0	7	0	0
18	14863680	.	T	A	4	3	7	0	0	7	0	0
18	14863799	.	A	C	8	0	8	0	5	13	0	0
18	14866506	.	G	A	2	4	6	0	0	6	0	0
18	14867144	.	A	C	4	0	4	0	5	10	1	0
18	14867153	.	C	T	4	4	8	0	1	9	0	0
18	14871133	.	C	T	4	4	8	0	0	8	0	0
18	14871145	.	A	G	5	3	8	0	0	8	0	0
18	14871280	.	A	C	1	0	1	0	2	3	0	0
18	14886129	.	C	T	2	2	4	0	0	4	0	0
18	14893764	.	A	G	2	1	3	0	0	3	0	0
18	14909831	.	A	T	4	7	11	0	0	11	0	0
18	14911346	.	G	A	2	3	5	0	0	5	0	0
18	14917016	.	T	C	2	0	2	0	2	4	0	0
18	14928654	.	C	T	0	1	1	0	0	1	0	0
18	15106612	.	A	G	4	2	6	0	0	6	0	0
18	15106813	.	G	T	1	3	4	0	0	4	0	0
18	15107012	.	C	A	1	1	2	0	0	2	0	0
18	15121465	.	G	A	0	3	3	0	2	5	0	0
18	15122894	.	C	T	0	1	1	0	0	1	0	0
18	15122915	.	G	A	0	3	3	0	1	4	0	0
18	15123008	.	C	A	4	4	8	0	0	8	0	0
18	15123011	.	A	G	3	4	7	0	1	8	0	0
18	15125193	.	A	C	1	0	1	0	0	1	0	0
18	15125418	.	C	A	1	0	1	0	0	1	0	0
18	15128960	.	T	C	3	3	6	0	0	6	0	0
18	15129302	.	G	T	1	4	5	0	0	5	0	0
18	15129309	.	T	C	1	4	5	0	0	5	0	0
18	15132372	.	T	C	3	7	10	0	0	10	0	0
18	15132383	.	T	C	2	6	8	0	0	8	0	0
18	15134001	.	A	G	0	1	1	0	0	1	0	0
18	15139004	.	T	A	4	3	7	0	0	7	0	0
18	15139049	.	A	G	3	0	3	0	3	6	0	0
18	15139150	.	G	A	2	4	6	0	1	7	0	0
18	15139540	.	C	T	8	8	16	0	0	16	0	0
18	15139757	.	G	A	3	8	11	0	0	11	0	0
18	15139784	.	T	C	3	5	8	0	0	8	0	0
18	15148021	.	T	C	1	5	6	0	0	6	0	0
18	15148063	.	A	C	4	0	4	0	4	8	0	0
18	15148199	.	T	C	7	3	10	0	0	10	0	0
18	15148207	.	A	C	6	3	9	0	0	9	0	0
18	15148248	.	T	C	4	3	7	0	4	11	0	0
18	15148482	.	A	G	3	4	7	0	1	8	0	0
18	15148886	.	G	A	2	5	7	0	0	7	0	0
18	15148985	.	A	G	2	3	5	0	0	5	0	0
18	15149067	.	G	A	1	4	5	0	0	5	0	0
18	15149068	.	G	T	1	3	4	0	1	5	0	0
18	15285346	.	C	T	3	1	4	0	0	4	0	0
18	15289895	.	G	A	0	2	2	0	3	5	0	0
18	15295925	.	C	T	0	5	5	0	7	12	0	0
18	15295976	.	G	T	11	4	15	0	0	15	0	0
18	15309513	.	T	C	6	0	6	0	2	8	0	0
18	15320831	.	T	C	0	0	0	0	4	4	0	0
18	15329361	.	G	A	3	2	5	0	0	5	0	0
18	15383683	.	C	T	5	2	7	0	0	7	0	0
18	15393324	.	G	A	3	0	3	0	0	3	0	0
18	15393787	.	C	G	1	1	2	0	0	2	0	0
18	15395535	.	A	G	2	2	4	0	0	4	0	0
18	15403754	.	C	T	3	2	5	0	0	5	0	0
18	15459835	.	T	A	3	5	8	0	0	8	0	0
18	15459871	.	C	T	2	4	6	0	0	6	0	0
18	15470114	.	T	G	1	0	1	0	0	1	0	0
18	15478597	.	A	G	2	1	3	0	0	3	0	0
18	15481636	.	C	T	0	1	1	0	0	1	0	0
18	15569644	.	T	C	4	2	6	0	0	6	0	0
18	15635311	.	A	G	2	3	5	0	0	5	0	0
18	15635323	.	A	G	2	3	5	0	0	5	0	0
18	15792294	.	T	G	13	13	26	0	2	28	0	0
18	15792368	.	G	C	16	15	31	0	4	35	0	0
18	15792459	.	A	C	21	17	38	0	1	39	0	0
18	15792596	.	T	A	20	24	44	0	0	44	0	0
18	15792611	.	A	G	21	24	45	0	1	46	0	0
18	15792743	.	T	A	20	18	38	0	0	38	0	0
18	15793064	.	A	G	3	12	15	0	1	16	0	0
18	15829588	.	A	G	1	1	2	0	1	3	0	0
18	15858916	.	G	A	3	0	3	0	0	3	0	0
18	15865154	.	T	C	3	2	5	0	0	5	0	0
18	15865196	.	C	G	2	3	5	0	0	5	0	0
18	15872397	.	G	C	2	2	4	0	0	4	0	0
18	15872435	.	A	G	2	1	3	0	2	5	0	0
18	15872452	.	G	A	0	2	2	0	0	2	0	0
18	15874550	.	C	T	3	5	8	0	0	8	0	0
18	15875196	.	G	A	1	0	1	0	0	1	0	0
18	15889750	.	G	A	0	2	2	0	0	2	0	0
18	16127885	.	A	G	23	18	41	0	1	42	0	0
18	16127927	.	A	C	20	12	32	0	1	33	0	0
18	16128427	.	T	A	7	6	13	0	0	13	0	0
18	16128730	.	A	G	7	10	17	0	0	17	0	0
18	16128960	.	T	G	29	11	40	0	2	43	1	0
18	16129210	.	A	C	23	11	34	0	0	34	0	0
18	16129583	.	T	A	20	12	32	0	2	35	1	0
18	16129862	.	C	T	21	13	34	0	1	35	0	0
18	16133772	.	C	G	8	8	16	0	0	16	0	0
18	16133773	.	T	A	7	8	15	0	1	16	0	0
18	16133822	.	T	C	3	2	5	0	0	5	0	0
18	16140047	.	G	A	2	1	3	0	0	3	0	0
18	16140337	.	G	T	0	16	16	0	17	33	0	0
18	16145618	.	T	G	26	24	50	0	1	51	0	0
18	16145621	.	C	T	26	24	50	0	0	50	0	0
18	16145994	.	C	G	9	8	17	0	0	17	0	0
18	16151809	.	T	A	8	3	11	0	0	11	0	0
18	16152149	.	G	A	2	2	4	0	0	4	0	0
18	16153487	.	T	C	6	0	6	0	4	10	0	0
18	16158279	.	G	T	1	3	4	0	0	4	0	0
18	16388294	.	G	C	3	0	3	0	3	6	0	0
18	16388342	.	G	A	5	3	8	0	0	8	0	0
18	16388387	.	G	A	1	1	2	0	1	3	0	0
18	16388579	.	A	G	6	3	9	0	0	9	0	0
18	16388825	.	A	G	1	4	5	0	0	5	0	0
18	16388864	.	C	T	1	1	2	0	0	2	0	0
18	16391712	.	G	A	1	1	2	0	1	3	0	0
18	16589760	.	G	T	1	3	4	0	0	4	0	0
18	16719963	.	T	C	10	9	19	0	0	19	0	0
18	16720197	.	G	A	2	3	5	0	1	6	0	0
18	16721705	.	G	A	13	11	24	0	4	28	0	0
18	16721741	.	G	A	6	8	14	0	0	14	0	0
18	16722124	.	G	A	18	20	38	0	3	41	0	0
18	16722584	.	G	A	10	11	21	0	2	23	0	0
18	16723514	.	T	C	13	15	28	0	0	28	0	0
18	16723520	.	A	G	12	0	12	0	15	27	0	0
18	16723785	.	A	G	8	0	8	0	11	19	0	0
18	16725225	.	G	A	0	22	22	0	9	31	0	0
18	16725309	.	C	T	17	4	21	0	0	21	0	0
18	16725917	.	A	G	12	12	24	0	1	25	0	0
18	16726011	.	C	T	11	11	22	0	0	22	0	0
18	16755962	.	C	A	15	25	40	0	1	41	0	0
18	16756001	.	C	T	14	22	36	0	4	40	0	0
18	16756058	.	T	A	11	10	21	0	1	22	0	0
18	16756065	.	G	A	11	8	19	0	1	20	0	0
18	16876903	.	A	G	6	4	10	0	1	11	0	0
18	16877282	.	C	T	2	3	5	0	0	5	0	0
18	16877283	.	A	G	2	3	5	0	0	5	0	0
18	16886079	.	C	T	1	1	2	0	0	2	0	0
18	16894571	.	T	A	7	9	16	0	1	17	0	0
18	16894594	.	T	G	7	7	14	0	1	15	0	0
18	16894630	.	A	G	2	2	4	0	0	4	0	0
18	16906522	.	A	G	3	0	3	0	0	3	0	0
18	16915433	.	T	C	1	1	2	0	0	2	0	0
18	16918725	.	G	A	2	2	4	0	0	4	0	0
18	16929772	.	G	A	2	12	14	0	1	15	0	0
18	16961046	.	A	G	5	6	11	0	2	13	0	0
18	16962778	.	A	G	7	5	12	0	1	13	0	0
18	16962783	.	C	T	6	5	11	0	2	13	0	0
18	16962823	.	C	T	0	1	1	0	0	1	0	0
18	16963091	.	C	G	4	5	9	0	1	10	0	0
18	16966911	.	T	C	7	3	10	0	0	10	0	0
18	16968314	.	T	C	7	6	13	0	0	13	0	0
18	16970059	.	G	A	6	3	9	0	0	9	0	0
18	16970132	.	C	T	3	4	7	0	0	7	0	0
18	16970158	.	G	A	0	4	4	0	4	8	0	0
18	16970455	.	A	T	9	6	15	0	0	15	0	0
18	16970459	.	G	A	0	7	7	0	9	16	0	0
18	16970598	.	C	T	14	6	20	0	0	20	0	0
18	16970683	.	C	A	4	2	6	0	1	7	0	0
18	16970684	.	A	G	3	3	6	0	1	7	0	0
18	16970912	.	T	C	12	4	16	0	0	17	1	0
18	16970916	.	T	C	13	4	17	0	0	17	0	0
18	16970997	.	G	C	1	9	10	0	18	28	0	0
18	16971129	.	C	T	9	5	14	0	1	15	0	0
18	16971255	.	T	A	2	3	5	0	0	5	0	0
18	16990385	.	A	C	2	0	2	0	1	3	0	0
18	16990520	.	C	T	0	0	0	0	1	1	0	0
18	16990550	.	A	G	0	4	4	0	2	6	0	0
18	17002614	.	T	C	7	0	7	0	8	15	0	0
18	17003602	.	A	G	1	1	2	0	0	2	0	0
18	17005917	.	T	C	1	1	2	0	1	3	0	0
18	17016697	.	T	C	0	2	2	0	0	2	0	0
18	17016721	.	G	T	0	2	2	0	0	2	0	0
18	17051417	.	G	A	2	2	4	0	1	5	0	0
18	17062226	.	G	A	3	3	6	0	0	6	0	0
18	17062227	.	G	A	3	3	6	0	0	6	0	0
18	17062323	.	G	A	3	4	7	0	0	7	0	0
18	17062336	.	T	C	3	3	6	0	0	6	0	0
18	17062364	.	T	G	4	3	7	0	0	7	0	0
18	17062487	.	G	T	4	2	6	0	0	6	0	0
18	17078575	.	A	T	2	3	5	0	0	5	0	0
18	17078946	.	A	G	1	2	3	0	0	3	0	0
18	17079156	.	G	C	1	4	5	0	0	5	0	0
18	17079541	.	T	C	17	7	24	1	0	25	0	0
18	17079724	.	C	T	0	8	8	0	8	16	0	0
18	17080122	.	A	G	7	4	11	0	0	11	0	0
18	17080131	.	T	C	6	0	6	0	5	11	0	0
18	17097893	.	T	C	10	10	20	0	4	24	0	0
18	17098317	.	T	A	1	1	2	0	0	2	0	0
18	17098562	.	T	A	1	4	5	0	0	5	0	0
18	17102046	.	C	T	0	5	5	0	7	12	0	0
18	17131006	.	A	G	0	2	2	0	0	2	0	0
18	17139446	.	G	A	2	2	4	0	0	4	0	0
18	17139461	.	T	C	0	2	2	0	2	4	0	0
18	17144909	.	T	A	5	4	9	0	0	9	0	0
18	17535748	.	A	T	0	7	7	0	4	11	0	0
18	18421826	.	T	G	2	6	8	0	0	8	0	0
18	19094993	.	A	T	3	2	5	0	1	6	0	0
18	19419200	.	A	T	6	6	12	0	0	12	0	0
18	19419307	.	C	T	9	7	16	0	1	17	0	0
18	19441492	.	C	G	18	17	35	0	3	38	0	0
18	19441561	.	T	C	11	7	18	0	1	19	0	0
18	19441585	.	C	A	2	4	6	0	0	6	0	0
18	19450486	.	T	C	16	12	28	0	1	29	0	0
18	19450563	.	A	T	25	28	53	0	5	58	0	0
18	19450642	.	A	T	25	20	45	0	1	46	0	0
18	19450692	.	A	G	16	15	31	0	0	31	0	0
18	19450755	.	A	G	43	19	62	0	1	63	0	0
18	19451023	.	C	T	19	18	37	0	1	38	0	0
18	19451117	.	C	T	12	10	22	0	1	23	0	0
18	19451427	.	G	A	25	13	38	0	2	40	0	0
18	19451430	.	T	C	24	4	28	0	14	42	0	0
18	19451477	.	G	A	21	27	48	0	2	50	0	0
18	19452126	.	T	A	12	11	23	0	0	23	0	0
18	19452594	.	G	A	17	19	36	0	6	42	0	0
18	19452639	.	A	G	15	17	32	0	2	34	0	0
18	19466832	.	A	G	0	0	0	0	1	1	0	0
18	19487779	.	G	A	17	13	30	0	0	30	0	0
18	19490515	.	C	T	10	9	19	0	2	21	0	0
18	19648878	.	T	C	1	3	4	0	0	4	0	0
18	19698539	.	C	T	2	1	3	0	0	3	0	0
18	19698833	.	T	C	1	5	6	0	0	6	0	0
18	19698854	.	G	A	1	6	7	0	2	9	0	0
18	19773113	.	G	A	0	3	3	0	0	3	0	0
18	19793720	.	G	A	0	1	1	0	0	1	0	0
18	19806135	.	T	G	1	2	3	0	0	3	0	0
18	19812874	.	T	C	5	6	11	0	1	12	0	0
18	19812943	.	A	T	10	7	17	0	0	17	0	0
18	19813002	.	A	G	11	8	19	0	1	20	0	0
18	19817682	.	G	A	5	8	13	0	0	13	0	0
18	19817717	.	G	A	4	5	9	0	0	9	0	0
18	19819719	.	C	A	6	3	9	0	0	9	0	0
18	19880206	.	T	A	1	2	3	0	0	3	0	0
18	19981553	.	G	A	2	4	6	0	0	6	0	0
18	19981584	.	C	T	2	2	4	0	2	6	0	0
18	20020108	.	A	T	1	2	3	0	0	3	0	0
18	20022806	.	T	C	1	3	4	0	0	4	0	0
18	20024856	.	T	C	2	5	7	0	1	8	0	0
18	20024889	.	G	A	6	4	10	0	1	11	0	0
18	20034058	.	T	A	5	5	10	0	0	10	0	0
18	20042088	.	C	T	11	16	27	0	2	29	0	0
18	20044847	.	T	C	9	12	21	0	1	22	0	0
18	20468514	.	G	T	1	7	8	0	2	10	0	0
18	20479008	.	A	G	4	7	11	0	0	11	0	0
18	20482876	.	C	A	2	2	4	0	0	4	0	0
18	20483240	.	G	A	1	2	3	0	0	3	0	0
18	20488843	.	A	G	1	3	4	0	0	4	0	0
18	20488849	.	G	A	0	3	3	0	1	4	0	0
18	20488879	.	G	A	1	3	4	0	0	4	0	0
18	20490370	.	A	C	1	2	3	0	0	3	0	0
18	20490672	.	G	A	3	3	6	0	0	6	0	0
18	20490690	.	A	T	2	2	4	0	0	4	0	0
18	20518915	.	C	G	1	3	4	0	0	4	0	0
18	20520982	.	G	T	0	2	2	0	0	2	0	0
18	20521053	.	T	G	3	3	6	0	0	6	0	0
18	20521344	.	A	G	2	3	5	0	0	5	0	0
18	20521431	.	A	T	4	2	6	0	0	6	0	0
18	20535074	.	T	A	8	12	20	0	0	20	0	0
18	20536533	.	A	G	1	0	1	0	2	3	0	0
18	20539548	.	G	A	0	11	11	0	8	19	0	0
18	20539703	.	T	A	2	5	7	0	0	7	0	0
18	20539844	.	T	A	6	6	12	1	0	13	0	0
18	20539979	.	T	A	6	6	12	0	0	12	0	0
18	20540144	.	G	A	5	2	7	0	2	9	0	0
18	20540313	.	G	T	3	5	8	0	0	8	0	0
18	20540581	.	G	T	3	5	8	0	1	9	0	0
18	20540606	.	A	T	3	4	7	0	0	7	0	0
18	20541575	.	A	C	7	8	15	0	1	16	0	0
18	20542214	.	A	T	6	4	10	0	0	10	0	0
18	20542503	.	G	A	16	4	20	0	1	21	0	0
18	20542647	.	C	T	10	12	22	0	0	22	0	0
18	20542899	.	T	A	12	8	20	0	1	21	0	0
18	20542929	.	T	C	11	8	19	0	0	19	0	0
18	20542988	.	T	G	7	5	12	0	0	12	0	0
18	20544883	.	G	A	4	1	5	0	0	5	0	0
18	20544901	.	G	C	1	5	6	0	0	6	0	0
18	20559571	.	G	A	8	6	14	0	1	15	0	0
18	20567681	.	G	A	2	2	4	0	0	4	0	0
18	20567688	.	G	A	0	2	2	0	2	4	0	0
18	20582413	.	T	A	2	3	5	0	0	5	0	0
18	20582629	.	T	C	6	8	14	0	1	15	0	0
18	20582694	.	G	A	2	4	6	0	1	7	0	0
18	20583154	.	G	T	4	3	7	0	0	7	0	0
18	20583639	.	A	G	3	2	5	0	0	5	0	0
18	20583763	.	A	G	6	12	18	0	0	18	0	0
18	20583820	.	A	T	5	5	10	0	1	11	0	0
18	20584098	.	T	A	3	3	6	0	0	6	0	0
18	20584327	.	C	A	0	3	3	0	0	3	0	0
18	20584336	.	T	G	1	2	3	0	1	4	0	0
18	20584797	.	G	A	2	2	4	0	0	4	0	0
18	20584801	.	C	T	2	3	5	0	0	5	0	0
18	20585314	.	C	T	7	6	13	0	0	13	0	0
18	20585435	.	T	C	3	0	3	0	5	8	0	0
18	20585495	.	C	T	2	4	6	0	0	6	0	0
18	20585532	.	T	C	1	2	3	0	1	4	0	0
18	20594104	.	G	A	2	3	5	0	0	5	0	0
18	20726232	.	T	C	25	0	25	0	28	53	0	0
18	20730583	.	G	A	14	12	26	0	2	28	0	0
18	20735371	.	C	T	14	11	25	0	0	25	0	0
18	20735413	.	C	T	0	10	10	0	11	21	0	0
18	20738244	.	T	A	2	2	4	0	1	5	0	0
18	20738262	.	A	G	5	5	10	0	0	10	0	0
18	20738298	.	G	A	12	6	18	0	0	18	0	0
18	20738383	.	G	A	2	4	6	0	0	6	0	0
18	20739298	.	C	T	5	3	8	1	1	10	0	0
18	20742025	.	G	A	7	3	10	0	0	10	0	0
18	20752879	.	C	T	0	3	3	0	3	6	0	0
18	20755854	.	T	A	7	6	13	0	2	15	0	0
18	20760425	.	C	T	4	7	11	0	3	14	0	0
18	20768686	.	C	T	2	9	11	0	0	11	0	0
18	20768818	.	T	A	8	10	18	0	0	18	0	0
18	20771078	.	T	C	4	0	4	0	10	14	0	0
18	20771085	.	A	G	10	3	13	0	0	13	0	0
18	20853301	.	C	T	1	2	3	0	0	3	0	0
18	20859790	.	A	G	4	4	8	0	0	8	0	0
18	20859802	.	A	G	3	5	8	0	0	8	0	0
18	20865498	.	T	C	0	1	1	0	0	1	0	0
18	20869033	.	T	A	2	3	5	0	0	5	0	0
18	20869089	.	C	T	0	2	2	0	2	4	0	0
18	20882098	.	C	T	1	1	2	0	1	3	0	0
18	20897925	.	C	A	1	1	2	0	0	2	0	0
18	20909723	.	C	T	2	2	4	0	0	4	0	0
18	20917407	.	T	C	2	2	4	0	0	4	0	0
18	21024524	.	C	T	2	2	4	0	0	4	0	0
18	21024530	.	C	T	2	2	4	0	1	5	0	0
18	21071085	.	A	G	3	1	4	0	3	7	0	0
18	21102019	.	A	C	5	5	10	0	0	10	0	0
18	21102023	.	C	T	0	4	4	0	5	9	0	0
18	21102764	.	C	T	1	4	5	0	2	7	0	0
18	21102914	.	G	A	1	4	5	0	0	5	0	0
18	21102994	.	G	A	3	2	5	0	0	5	0	0
18	21102995	.	A	T	3	2	5	0	0	5	0	0
18	21103043	.	G	A	1	3	4	0	1	5	0	0
18	21103334	.	A	C	3	2	5	0	0	5	0	0
18	21105927	.	A	G	5	4	9	0	0	9	0	0
18	21105945	.	G	A	4	3	7	0	0	7	0	0
18	21113533	.	G	A	0	2	2	0	0	2	0	0
18	21114475	.	T	C	3	5	8	0	2	10	0	0
18	21116381	.	C	A	5	4	9	0	0	9	0	0
18	21117801	.	C	T	7	9	16	0	0	16	0	0
18	21118232	.	C	G	4	8	12	0	0	12	0	0
18	21119654	.	G	A	11	6	17	0	1	18	0	0
18	21119751	.	C	T	7	11	18	0	2	20	0	0
18	21119845	.	C	A	3	6	9	0	1	10	0	0
18	21119854	.	T	C	5	3	8	0	0	8	0	0
18	21123001	.	A	G	4	0	4	0	9	13	0	0
18	21136948	.	C	T	5	4	9	0	1	10	0	0
18	21143473	.	A	T	14	20	34	0	0	34	0	0
18	21143787	.	C	A	10	14	24	0	2	26	0	0
18	21143938	.	C	G	13	15	28	0	1	29	0	0
18	21143998	.	C	T	18	11	29	0	0	29	0	0
18	21144005	.	C	A	21	9	30	0	0	30	0	0
18	21144060	.	G	A	1	17	18	0	20	38	0	0
18	21144656	.	C	T	4	5	9	0	0	9	0	0
18	21144748	.	T	C	3	5	8	0	0	8	0	0
18	21144758	.	C	A	2	6	8	0	0	8	0	0
18	21144800	.	A	T	1	6	7	0	0	7	0	0
18	21144823	.	C	A	6	2	8	0	0	8	0	0
18	21144852	.	A	G	6	7	13	0	0	13	0	0
18	21144880	.	G	T	10	5	15	0	1	16	0	0
18	21144985	.	C	T	5	6	11	0	2	13	0	0
18	21145142	.	A	G	8	7	15	0	2	17	0	0
18	21145290	.	G	T	6	10	16	0	0	16	0	0
18	21178836	.	C	T	2	5	7	0	0	7	0	0
18	21179063	.	C	T	3	2	5	0	0	5	0	0
18	21179064	.	A	T	4	1	5	0	0	5	0	0
18	21179135	.	T	C	7	3	10	0	0	10	0	0
18	21179158	.	G	C	10	4	14	0	0	14	0	0
18	21179181	.	A	T	5	5	10	0	0	10	0	0
18	21179228	.	G	C	4	4	8	0	1	9	0	0
18	21179369	.	T	C	13	16	29	0	1	30	0	0
18	21179484	.	G	A	10	11	21	0	1	22	0	0
18	21179566	.	T	C	11	10	21	0	1	22	0	0
18	21179730	.	A	G	1	7	8	0	0	8	0	0
18	21182879	.	A	G	2	1	3	0	0	3	0	0
18	21185167	.	A	G	1	2	3	0	0	3	0	0
18	21198961	.	G	T	19	14	33	0	0	33	0	0
18	21199165	.	G	T	15	6	21	0	1	22	0	0
18	21257600	.	A	T	13	3	16	0	1	17	0	0
18	21257623	.	A	G	3	11	14	0	0	14	0	0
18	21257757	.	G	A	9	3	12	0	0	12	0	0
18	21257786	.	G	A	7	9	16	0	1	17	0	0
18	21257816	.	G	T	7	10	17	0	1	18	0	0
18	21257946	.	C	T	14	8	22	0	1	23	0	0
18	21257951	.	T	A	7	14	21	0	2	23	0	0
18	21258083	.	G	A	5	4	9	0	0	9	0	0
18	21263268	.	C	T	0	0	0	0	1	1	0	0
18	21399913	.	T	A	0	1	1	0	0	1	0	0
18	21400455	.	C	A	3	2	5	0	0	5	0	0
18	21409113	.	A	T	3	2	5	0	0	5	0	0
18	21492325	.	T	C	11	10	21	0	0	21	0	0
18	21617864	.	G	A	0	30	30	0	16	46	0	0
18	21618343	.	C	T	19	19	38	0	0	38	0	0
18	21618379	.	A	G	19	21	40	0	0	40	0	0
18	21618496	.	G	A	20	15	35	0	1	36	0	0
18	21618659	.	C	A	12	13	25	0	1	26	0	0
18	21618731	.	G	T	22	19	41	0	3	45	1	0
18	21618910	.	G	T	19	25	44	0	3	47	0	0
18	21619011	.	C	T	17	18	35	0	3	38	0	0
18	21619018	.	A	T	15	23	38	0	2	40	0	0
18	21619055	.	G	T	14	20	34	0	1	35	0	0
18	21619260	.	C	T	15	20	35	0	0	35	0	0
18	21619284	.	G	T	11	18	29	0	2	31	0	0
18	21619672	.	A	G	11	8	19	0	0	19	0	0
18	21619686	.	G	A	9	7	16	0	3	19	0	0
18	21619777	.	A	G	18	11	29	0	0	29	0	0
18	21619799	.	T	G	20	19	39	0	0	39	0	0
18	21619948	.	C	T	19	17	36	1	4	41	0	0
18	21620082	.	A	T	19	9	28	0	1	29	0	0
18	21620376	.	A	C	14	27	41	0	1	42	0	0
18	21620426	.	G	A	2	20	22	0	21	43	0	0
18	21645492	.	G	A	6	9	15	0	4	19	0	0
18	21645902	.	G	C	13	0	13	0	12	25	0	0
18	21645965	.	G	A	2	6	8	0	4	12	0	0
18	21645989	.	T	G	2	3	5	0	0	5	0	0
18	21647419	.	T	C	1	2	3	0	0	3	0	0
18	21648522	.	C	T	1	0	1	0	0	1	0	0
18	21648582	.	A	G	6	3	9	0	1	10	0	0
18	21648627	.	C	T	3	1	4	0	0	4	0	0
18	21648633	.	A	T	3	1	4	0	0	4	0	0
18	21653937	.	C	T	4	12	16	0	1	17	0	0
18	21654124	.	A	C	3	0	3	0	3	6	0	0
18	21654145	.	C	T	5	5	10	0	0	10	0	0
18	21654375	.	C	A	2	0	2	0	0	2	0	0
18	21654432	.	T	C	7	8	15	0	1	16	0	0
18	21654489	.	C	T	4	2	6	0	0	6	0	0
18	21656271	.	C	A	4	4	8	0	1	9	0	0
18	21656274	.	G	A	4	4	8	0	0	8	0	0
18	21657642	.	T	G	3	3	6	0	0	6	0	0
18	21674320	.	G	T	0	5	5	0	0	5	0	0
18	21678723	.	G	A	3	3	6	0	1	7	0	0
18	21689043	.	G	C	1	4	5	0	0	5	0	0
18	21689052	.	A	G	1	5	6	0	2	8	0	0
18	21689079	.	G	A	10	3	13	0	0	13	0	0
18	21693120	.	A	G	3	2	5	0	0	5	0	0
18	21693213	.	G	A	4	4	8	0	0	8	0	0
18	21693441	.	G	A	3	3	6	0	0	6	0	0
18	21698855	.	G	T	2	4	6	0	0	6	0	0
18	21699581	.	A	T	0	2	2	0	0	2	0	0
18	21724407	.	C	T	2	3	5	0	0	5	0	0
18	21782362	.	T	G	3	3	6	0	0	6	0	0
18	21782445	.	T	G	2	3	5	0	1	6	0	0
18	21782577	.	G	A	3	3	6	0	0	6	0	0
18	21782596	.	T	A	2	5	7	0	0	7	0	0
18	21782908	.	G	A	1	6	7	0	0	7	0	0
18	21783049	.	G	C	3	2	5	0	0	5	0	0
18	21783077	.	C	T	3	1	4	0	1	5	0	0
18	21783087	.	G	A	2	2	4	0	0	4	0	0
18	21783257	.	G	T	2	2	4	0	0	4	0	0
18	21783279	.	G	A	2	2	4	0	1	5	0	0
18	21783325	.	A	T	3	7	10	0	2	12	0	0
18	21783368	.	G	A	6	8	14	0	0	14	0	0
18	21783494	.	A	C	3	3	6	0	0	6	0	0
18	21783502	.	A	G	0	4	4	0	0	4	0	0
18	21783533	.	T	C	1	2	3	0	0	3	0	0
18	21784127	.	T	C	0	3	3	0	0	3	0	0
18	21860755	.	C	T	7	5	12	0	0	12	0	0
18	21861134	.	T	A	12	10	22	0	1	23	0	0
18	21861225	.	T	A	9	16	25	0	1	26	0	0
18	21861381	.	G	T	5	8	13	0	1	14	0	0
18	21861497	.	A	T	7	6	13	0	1	14	0	0
18	21861688	.	C	A	4	6	10	0	0	10	0	0
18	21861934	.	C	T	4	4	8	0	0	8	0	0
18	21862076	.	C	T	0	6	6	0	6	12	0	0
18	21862141	.	T	C	9	0	9	0	5	14	0	0
18	21862175	.	C	T	0	5	5	0	7	12	0	0
18	21862237	.	G	T	6	5	11	0	1	12	0	0
18	21862346	.	T	A	7	3	10	0	0	10	0	0
18	21880098	.	T	C	7	0	7	0	8	15	0	0
18	21880191	.	T	C	2	0	2	0	2	4	0	0
18	21888256	.	C	T	1	2	3	0	0	3	0	0
18	21891024	.	G	T	4	2	6	0	0	6	0	0
18	21904846	.	T	A	1	0	1	0	0	1	0	0
18	21913799	.	A	T	7	11	18	0	2	21	1	0
18	21913907	.	G	C	11	10	21	0	1	22	0	0
18	21913988	.	C	A	14	12	26	0	0	26	0	0
18	21914018	.	C	A	10	18	28	0	0	28	0	0
18	21914225	.	C	T	1	16	17	0	8	25	0	0
18	21914281	.	G	A	12	14	26	0	0	26	0	0
18	21914283	.	C	A	11	14	25	0	1	26	0	0
18	21983530	.	G	C	1	2	3	0	0	3	0	0
18	22002476	.	G	A	7	4	11	0	0	11	0	0
18	22002508	.	C	T	6	4	10	0	0	10	0	0
18	22029828	.	A	C	9	0	9	0	5	14	0	0
18	22030435	.	C	T	2	2	4	0	0	4	0	0
18	22030624	.	T	C	1	3	4	0	0	4	0	0
18	22030967	.	G	A	1	4	5	0	0	5	0	0
18	22030995	.	A	C	1	5	6	0	0	6	0	0
18	22031018	.	T	G	1	4	5	0	0	5	0	0
18	22082366	.	T	C	6	3	9	0	0	9	0	0
18	22232712	.	G	T	0	1	1	0	1	2	0	0
18	22261064	.	C	A	2	4	6	0	0	7	1	0
18	22272969	.	C	A	5	3	8	0	1	9	0	0
18	22275051	.	T	C	5	4	9	0	2	11	0	0
18	22282766	.	A	T	11	5	16	0	1	17	0	0
18	22282809	.	A	T	13	10	23	0	0	23	0	0
18	22282923	.	G	T	10	9	19	0	3	22	0	0
18	22282960	.	C	T	10	14	24	0	2	26	0	0
18	22282961	.	A	G	11	14	25	0	1	26	0	0
18	22283087	.	C	A	7	2	9	0	1	10	0	0
18	22283116	.	T	A	5	2	7	0	1	8	0	0
18	22288650	.	T	C	12	6	18	0	0	18	0	0
18	22288659	.	C	T	12	6	18	0	0	18	0	0
18	22289075	.	T	C	5	6	11	0	0	11	0	0
18	22289314	.	C	T	3	3	6	0	0	6	0	0
18	22290900	.	G	A	11	3	14	0	0	14	0	0
18	22290933	.	C	T	14	6	20	0	1	21	0	0
18	22292215	.	A	T	14	15	29	0	0	29	0	0
18	22292286	.	G	A	11	11	22	0	3	25	0	0
18	22292339	.	A	T	12	13	25	0	3	28	0	0
18	22356816	.	A	C	5	3	8	0	0	8	0	0
18	22356989	.	C	T	7	23	30	0	0	30	0	0
18	22376947	.	A	C	4	1	5	0	12	17	0	0
18	22376948	.	T	G	4	0	4	0	13	17	0	0
18	22377096	.	A	T	17	24	41	0	0	41	0	0
18	22377372	.	G	A	2	28	30	0	20	50	0	0
18	22377471	.	C	T	19	17	36	0	1	37	0	0
18	22385900	.	G	A	26	20	46	0	5	51	0	0
18	22405895	.	A	T	4	7	11	0	0	11	0	0
18	22406162	.	C	T	1	2	3	0	2	5	0	0
18	22406187	.	T	A	2	3	5	0	0	5	0	0
18	22406375	.	T	A	4	4	8	0	0	8	0	0
18	22406379	.	G	A	5	3	8	0	0	9	1	0
18	22406591	.	A	C	2	5	7	0	0	7	0	0
18	22406728	.	A	T	1	3	4	0	0	4	0	0
18	22406797	.	A	T	1	3	4	0	0	4	0	0
18	22407365	.	C	T	0	1	1	0	1	2	0	0
18	22414504	.	A	C	2	4	6	0	0	6	0	0
18	22414542	.	T	G	3	3	6	0	0	6	0	0
18	22417058	.	C	T	3	6	9	0	0	9	0	0
18	22417082	.	G	A	0	7	7	0	5	12	0	0
18	22417103	.	C	A	4	6	10	0	0	10	0	0
18	22420551	.	A	T	5	4	9	0	0	9	0	0
18	22420558	.	C	A	5	4	9	0	0	9	0	0
18	22424532	.	T	C	4	1	5	0	0	5	0	0
18	22424536	.	A	G	4	0	4	0	3	7	0	0
18	22424601	.	A	G	4	0	4	0	11	15	0	0
18	22486579	.	A	T	3	4	7	0	0	7	0	0
18	22679275	.	C	T	0	5	5	0	0	5	0	0
18	22679339	.	C	T	3	4	7	0	0	7	0	0
18	22679786	.	C	T	3	3	6	0	1	7	0	0
18	22685266	.	G	A	0	6	6	0	7	13	0	0
18	22685278	.	C	T	9	4	13	0	0	13	0	0
18	22685329	.	T	C	2	12	14	0	0	14	0	0
18	22685380	.	A	T	5	7	12	0	0	12	0	0
18	22685608	.	C	A	10	7	17	0	0	17	0	0
18	22686269	.	A	T	7	10	17	0	0	17	0	0
18	22686320	.	G	A	5	4	9	0	0	9	0	0
18	22686358	.	G	A	2	2	4	0	1	5	0	0
18	22686588	.	C	A	2	5	7	0	0	7	0	0
18	22686723	.	C	T	9	3	12	0	1	13	0	0
18	22686789	.	G	A	6	12	18	0	2	20	0	0
18	22686795	.	C	G	5	17	22	0	1	23	0	0
18	22686927	.	G	A	0	6	6	0	0	6	0	0
18	22687116	.	T	C	20	5	25	0	0	25	0	0
18	22687312	.	G	A	14	9	23	0	1	24	0	0
18	22687527	.	G	C	9	23	32	0	1	33	0	0
18	22687575	.	T	A	11	22	33	0	1	34	0	0
18	22687599	.	A	T	22	11	33	0	0	33	0	0
18	22687666	.	C	T	18	21	39	0	0	39	0	0
18	22728794	.	A	G	0	1	1	0	0	1	0	0
18	22732391	.	A	G	2	1	3	0	0	3	0	0
18	22921942	.	C	T	18	20	38	0	2	40	0	0
18	22921950	.	T	C	16	18	34	0	6	40	0	0
18	22975090	.	T	C	31	25	56	0	2	58	0	0
18	22975297	.	A	C	31	22	53	0	2	55	0	0
18	23071243	.	G	A	2	2	4	0	0	4	0	0
18	23071744	.	C	A	2	3	5	0	1	6	0	0
18	23071769	.	G	C	1	3	4	0	0	4	0	0
18	23071884	.	A	C	2	3	5	0	0	5	0	0
18	23072164	.	G	A	3	4	7	0	0	7	0	0
18	23200303	.	G	A	0	1	1	0	1	2	0	0
18	23270093	.	C	T	0	2	2	0	0	2	0	0
18	23869134	.	C	T	12	18	30	0	2	32	0	0
18	23869784	.	T	A	22	19	41	0	0	41	0	0
18	23870092	.	G	A	16	19	35	0	2	37	0	0
18	23870837	.	C	T	12	9	21	0	1	22	0	0
18	24922149	.	G	A	4	1	5	0	1	6	0	0
18	24929460	.	G	A	0	10	10	0	11	21	0	0
18	24929465	.	T	C	12	11	23	0	0	23	0	0
18	24930189	.	G	A	12	4	16	0	2	18	0	0
18	24930530	.	T	C	11	14	25	0	1	26	0	0
18	24930758	.	T	C	17	18	35	0	1	36	0	0
18	24931044	.	T	A	14	20	34	0	1	35	0	0
18	24931634	.	A	G	14	25	39	0	4	43	0	0
18	24931660	.	G	T	16	18	34	0	2	36	0	0
18	24934333	.	A	T	5	3	8	0	0	8	0	0
18	24934456	.	G	A	18	12	30	0	0	30	0	0
18	24934692	.	C	A	3	6	9	0	0	9	0	0
18	24935099	.	A	G	15	13	28	0	0	28	0	0
18	24938712	.	A	G	3	7	10	0	0	10	0	0
18	24938805	.	A	G	9	10	19	0	1	20	0	0
18	24938871	.	T	C	9	7	16	0	0	16	0	0
18	24938919	.	C	T	2	1	3	0	0	3	0	0
18	24944039	.	A	T	3	4	7	0	0	7	0	0
18	24944045	.	T	C	2	2	4	0	1	5	0	0
18	24946727	.	T	A	1	2	3	0	1	4	0	0
18	24947618	.	G	A	2	2	4	0	0	4	0	0
18	24950214	.	C	T	0	1	1	0	0	1	0	0
18	24952245	.	T	G	7	5	12	0	0	12	0	0
18	24984682	.	T	A	1	2	3	0	1	4	0	0
18	24990332	.	A	G	4	2	6	0	0	6	0	0
18	25003359	.	A	T	10	6	16	0	0	16	0	0
18	25003448	.	G	C	8	7	15	0	0	15	0	0
18	25009326	.	C	A	11	7	18	0	1	19	0	0
18	25009352	.	G	A	8	15	23	0	0	23	0	0
18	25009487	.	A	G	4	7	11	0	0	11	0	0
18	25027675	.	T	A	0	3	3	0	0	3	0	0
18	25027750	.	C	G	2	4	6	0	0	6	0	0
18	25754580	.	G	T	3	3	6	0	0	6	0	0
18	25754770	.	G	A	0	2	2	0	1	3	0	0
18	25783752	.	G	A	6	2	8	0	0	8	0	0
18	25783851	.	C	G	1	3	4	0	0	4	0	0
18	25783992	.	C	T	1	5	6	0	0	6	0	0
18	25784146	.	C	A	0	4	4	0	2	6	0	0
18	25784196	.	A	T	2	0	2	0	0	2	0	0
18	26089004	.	G	C	5	6	11	0	0	11	0	0
18	26089254	.	A	T	1	3	4	0	0	4	0	0
18	26089657	.	C	T	1	2	3	0	0	3	0	0
18	26094421	.	C	T	4	5	9	0	0	9	0	0
18	26094491	.	A	C	6	5	11	0	0	11	0	0
18	26097091	.	G	T	31	35	66	0	0	66	0	0
18	26097428	.	G	A	11	6	17	0	2	19	0	0
18	26125983	.	A	G	1	3	4	0	0	4	0	0
18	26126046	.	C	T	0	3	3	0	0	3	0	0
18	26338420	.	C	T	9	7	16	0	0	16	0	0
18	26362401	.	A	G	2	2	4	0	0	4	0	0
18	26393716	.	C	A	2	9	11	0	2	13	0	0
18	26401680	.	T	C	17	17	34	0	4	38	0	0
18	26401719	.	T	C	20	14	34	0	1	35	0	0
18	26401743	.	C	T	15	16	31	0	4	35	0	0
18	26405271	.	G	A	10	20	30	0	1	31	0	0
18	26422751	.	G	C	0	1	1	0	0	1	0	0
18	26460822	.	G	C	1	4	5	0	3	8	0	0
18	26460846	.	C	A	3	5	8	0	1	9	0	0
18	26474249	.	A	G	2	1	3	0	1	4	0	0
18	26502584	.	A	G	1	2	3	0	0	3	0	0
18	26697777	.	G	A	0	1	1	0	0	1	0	0
18	26776182	.	A	G	6	3	9	0	0	9	0	0
18	26793948	.	G	A	2	0	2	0	0	2	0	0
18	26800167	.	C	G	3	4	7	0	1	8	0	0
18	26800198	.	T	C	5	4	9	0	0	9	0	0
18	26800280	.	G	A	5	8	13	0	0	13	0	0
18	26800418	.	T	C	11	12	23	0	0	23	0	0
18	26804233	.	T	A	0	2	2	0	0	2	0	0
18	26811801	.	T	G	1	2	3	0	0	3	0	0
18	26863594	.	G	T	1	5	6	0	0	6	0	0
18	26863602	.	A	T	1	5	6	0	0	6	0	0
18	26863666	.	T	C	2	0	2	0	2	4	0	0
18	26863681	.	T	C	1	0	1	0	3	4	0	0
18	26870137	.	G	A	2	1	3	0	0	3	0	0
18	26870191	.	G	A	3	2	5	0	0	5	0	0
18	26870194	.	G	A	3	2	5	0	0	5	0	0
18	26874553	.	G	A	0	1	1	0	0	1	0	0
18	26885718	.	C	T	0	0	0	0	1	1	0	0
18	26891630	.	C	T	1	3	4	0	0	4	0	0
18	26894677	.	G	A	2	4	6	0	0	6	0	0
18	26896277	.	T	C	11	7	18	0	0	18	0	0
18	26896571	.	C	T	4	6	10	0	2	12	0	0
18	26909470	.	G	A	1	9	10	0	22	32	0	0
18	26913949	.	C	T	24	17	41	0	1	42	0	0
18	26919226	.	C	T	7	14	21	0	2	23	0	0
18	26919989	.	T	A	18	25	43	0	1	44	0	0
18	26968799	.	G	A	4	3	7	0	0	7	0	0
18	26971868	.	T	C	1	0	1	0	0	1	0	0
18	26971899	.	C	G	1	0	1	0	0	1	0	0
18	27046330	.	C	T	1	3	4	0	0	4	0	0
18	27072144	.	A	C	6	3	9	0	0	9	0	0
18	27072226	.	C	A	7	3	10	0	0	10	0	0
18	27072690	.	C	T	4	5	9	0	0	9	0	0
18	27072697	.	G	A	4	5	9	0	0	9	0	0
18	27077908	.	T	C	3	4	7	0	0	7	0	0
18	27078005	.	T	A	1	2	3	0	0	3	0	0
18	27078019	.	C	T	2	3	5	0	0	5	0	0
18	27085408	.	G	A	2	2	4	0	1	5	0	0
18	27252712	.	G	A	2	3	5	0	0	5	0	0
18	27252728	.	G	T	2	2	4	0	0	4	0	0
18	27254538	.	G	A	0	1	1	0	0	1	0	0
18	27254726	.	T	C	2	4	6	0	0	6	0	0
18	27281673	.	T	G	2	5	7	0	0	7	0	0
18	27281679	.	A	G	3	0	3	0	5	8	0	0
18	27285337	.	C	T	0	1	1	0	0	1	0	0
18	27309517	.	A	G	4	6	10	0	0	10	0	0
18	27309555	.	G	A	4	6	10	0	1	11	0	0
18	27335597	.	G	A	2	13	15	0	2	17	0	0
18	27335740	.	T	A	15	6	21	0	0	21	0	0
18	27335780	.	A	T	5	4	9	0	1	10	0	0
18	27340993	.	C	T	5	3	8	0	0	8	0	0
18	27340996	.	A	T	3	5	8	0	0	8	0	0
18	27341170	.	C	T	6	2	8	0	1	9	0	0
18	27568352	.	A	G	10	6	16	0	0	16	0	0
18	27625903	.	T	G	2	1	3	0	0	3	0	0
18	27626271	.	C	T	1	3	4	0	0	4	0	0
18	27732389	.	T	C	11	10	21	0	0	21	0	0
18	27802795	.	C	T	8	6	14	0	0	14	0	0
18	27812400	.	T	G	12	0	12	0	17	29	0	0
18	27812429	.	T	C	16	21	37	0	0	37	0	0
18	27812618	.	T	A	15	8	23	0	1	24	0	0
18	27927639	.	A	G	3	2	5	0	0	5	0	0
18	27970182	.	A	T	5	5	10	0	0	10	0	0
18	27981137	.	A	C	0	0	0	0	1	1	0	0
18	27982320	.	A	G	1	1	2	0	0	2	0	0
18	27984021	.	A	G	4	0	4	0	5	9	0	0
18	27984026	.	C	T	4	4	8	0	0	8	0	0
18	27984080	.	C	T	1	4	5	0	0	5	0	0
18	27988481	.	G	C	3	2	5	0	1	6	0	0
18	27988509	.	T	C	2	3	5	0	0	5	0	0
18	27993392	.	T	G	9	5	14	0	0	14	0	0
18	27993625	.	C	A	3	4	7	0	1	8	0	0
18	28106305	.	T	A	2	1	3	0	0	3	0	0
18	28123612	.	T	C	1	2	3	0	0	3	0	0
18	28564674	.	T	A	2	4	6	0	0	6	0	0
18	28564737	.	T	C	2	2	4	0	1	5	0	0
18	28564777	.	G	A	2	3	5	0	0	5	0	0
18	28564785	.	A	G	3	2	5	0	0	5	0	0
18	28564856	.	G	T	1	4	5	0	0	5	0	0
18	28564858	.	G	A	1	3	4	0	1	5	0	0
18	28564923	.	G	A	0	3	3	0	1	4	0	0
18	28564947	.	A	G	1	3	4	0	0	4	0	0
18	28606134	.	C	A	1	1	2	0	0	2	0	0
18	28606191	.	A	G	0	0	0	0	1	1	0	0
18	28852198	.	A	T	1	3	4	0	0	4	0	0
18	28852204	.	A	G	2	2	4	0	1	5	0	0
18	28876524	.	C	G	8	15	23	0	0	23	0	0
18	28876569	.	A	G	8	0	8	0	12	20	0	0
18	28879736	.	G	T	0	5	5	0	6	11	0	0
18	28879758	.	C	G	7	4	11	0	1	12	0	0
18	28879847	.	G	T	4	8	12	0	0	12	0	0
18	29008407	.	C	T	9	18	27	0	2	29	0	0
18	29058989	.	C	T	4	8	12	0	0	13	1	0
18	29059194	.	A	G	9	7	16	0	0	16	0	0
18	29403241	.	G	T	1	3	4	0	0	4	0	0
18	29405136	.	C	A	2	2	4	0	0	4	0	0
18	29886272	.	G	A	1	2	3	0	0	3	0	0
18	29886275	.	C	T	1	2	3	0	0	3	0	0
18	29887226	.	T	C	1	2	3	0	0	3	0	0
18	29888576	.	A	G	4	2	6	0	0	6	0	0
18	29889194	.	C	T	4	2	6	0	0	6	0	0
18	29889484	.	T	A	6	6	12	0	0	12	0	0
18	29889548	.	A	G	1	3	4	0	0	4	0	0
18	29889571	.	G	A	4	1	5	0	0	5	0	0
18	29898341	.	A	G	2	1	3	0	0	3	0	0
18	29953082	.	G	A	0	0	0	0	1	1	0	0
18	29953405	.	T	C	1	2	3	0	0	3	0	0
18	29953867	.	G	A	2	4	6	0	1	7	0	0
18	29954824	.	C	A	3	9	12	0	0	12	0	0
18	29954918	.	C	T	4	2	6	0	0	6	0	0
18	29954929	.	T	C	3	2	5	0	0	5	0	0
18	29958943	.	G	A	3	3	6	0	0	6	0	0
18	29959241	.	T	C	2	2	4	0	0	4	0	0
18	29959268	.	A	C	2	2	4	0	0	4	0	0
18	29959517	.	A	G	1	3	4	0	1	5	0	0
18	29969920	.	A	T	5	8	13	0	0	13	0	0
18	29970458	.	C	G	9	10	19	0	1	20	0	0
18	29970559	.	T	G	12	9	21	0	1	22	0	0
18	29970809	.	A	T	3	2	5	0	0	5	0	0
18	29970817	.	G	A	2	2	4	0	1	5	0	0
18	29976560	.	C	A	0	2	2	0	0	2	0	0
18	29976561	.	A	T	0	2	2	0	0	2	0	0
18	29977423	.	C	T	4	4	8	0	0	8	0	0
18	29977753	.	C	T	5	8	13	0	0	13	0	0
18	29977784	.	T	A	7	6	13	0	2	15	0	0
18	29977789	.	C	T	7	6	13	0	0	13	0	0
18	29978794	.	A	T	3	2	5	0	0	5	0	0
18	29978848	.	A	G	4	6	10	0	0	10	0	0
18	29979860	.	A	G	1	2	3	0	0	3	0	0
18	29980462	.	A	G	4	5	9	0	0	9	0	0
18	29980474	.	A	G	3	7	10	0	1	11	0	0
18	30020802	.	C	T	0	2	2	0	0	2	0	0
18	30021313	.	C	A	1	3	4	0	0	4	0	0
18	30441825	.	G	A	0	4	4	0	7	11	0	0
18	30463346	.	C	T	3	4	7	0	0	7	0	0
18	30466712	.	A	T	5	14	19	0	1	20	0	0
18	30470471	.	A	G	2	4	6	0	0	6	0	0
18	30470929	.	T	C	14	10	24	0	2	26	0	0
18	30470930	.	G	A	13	10	23	0	3	26	0	0
18	30473566	.	C	G	3	0	3	0	6	9	0	0
18	30476837	.	G	A	11	9	20	0	0	20	0	0
18	30477289	.	G	T	5	5	10	0	0	10	0	0
18	30477469	.	C	T	10	7	17	0	0	17	0	0
18	30477495	.	T	G	10	4	14	0	1	15	0	0
18	30477616	.	A	G	3	12	15	0	1	16	0	0
18	30477625	.	C	T	3	11	14	0	1	15	0	0
18	30477889	.	C	T	16	26	42	0	2	44	0	0
18	30478113	.	A	G	16	0	16	1	5	22	0	0
18	30478156	.	C	T	20	16	36	0	2	38	0	0
18	30500738	.	T	A	2	3	5	0	0	5	0	0
18	30500912	.	G	T	6	2	8	0	1	9	0	0
18	30501194	.	T	C	6	5	11	0	0	11	0	0
18	30501298	.	C	A	9	13	22	0	0	22	0	0
18	30501393	.	G	A	8	7	15	0	2	17	0	0
18	30501639	.	A	G	10	13	23	0	0	23	0	0
18	30501701	.	T	C	9	11	20	0	2	22	0	0
18	30503562	.	T	C	1	0	1	0	7	8	0	0
18	30504366	.	C	T	9	7	16	0	0	16	0	0
18	30511260	.	C	A	3	2	5	0	1	6	0	0
18	30564142	.	T	A	4	5	9	0	0	9	0	0
18	30564240	.	A	T	3	5	8	0	0	8	0	0
18	30564301	.	C	A	4	6	10	0	1	11	0	0
18	30564334	.	T	G	5	6	11	0	0	11	0	0
18	30564342	.	G	T	7	5	12	0	2	14	0	0
18	30564385	.	T	G	6	5	11	0	0	11	0	0
18	30564443	.	A	T	3	3	6	0	0	6	0	0
18	30564451	.	G	C	0	2	2	0	3	5	0	0
18	30564510	.	C	T	2	3	5	0	1	6	0	0
18	30949449	.	C	T	4	2	6	0	0	6	0	0
18	31033267	.	C	T	0	5	5	0	3	8	0	0
18	31036721	.	A	T	2	4	6	0	0	6	0	0
18	31036722	.	C	A	2	4	6	0	0	6	0	0
18	31041640	.	G	A	7	4	11	0	0	11	0	0
18	31058577	.	A	G	1	2	3	0	0	3	0	0
18	31064706	.	A	G	1	0	1	0	4	5	0	0
18	31064734	.	G	A	2	2	4	0	0	4	0	0
18	31068392	.	A	C	3	1	4	0	0	4	0	0
18	31068463	.	A	G	0	1	1	0	0	1	0	0
18	31105257	.	G	A	15	7	22	0	0	22	0	0
18	31151851	.	G	A	1	1	2	0	0	2	0	0
18	31152920	.	A	G	3	2	5	0	0	5	0	0
18	31152946	.	C	A	4	2	6	0	0	6	0	0
18	31206392	.	C	A	4	6	10	0	0	10	0	0
18	31281034	.	G	C	0	10	10	0	10	20	0	0
18	31281161	.	T	A	9	11	20	0	1	21	0	0
18	31281186	.	T	C	8	10	18	0	1	19	0	0
18	31281254	.	G	A	4	3	7	0	0	7	0	0
18	31775711	.	G	A	0	3	3	0	0	3	0	0
18	33982078	.	G	T	8	4	12	0	0	12	0	0
18	33982224	.	G	A	5	2	7	0	1	8	0	0
18	33982331	.	G	T	4	4	8	0	0	8	0	0
18	33982340	.	G	A	4	4	8	0	0	8	0	0
18	33982591	.	T	C	16	13	29	0	0	29	0	0
18	33982811	.	C	T	1	16	17	0	10	27	0	0
18	33983154	.	G	A	17	20	37	0	0	37	0	0
18	33983165	.	T	C	12	18	30	0	3	33	0	0
18	33983300	.	A	C	7	0	7	0	13	20	0	0
18	33983564	.	T	A	11	9	20	0	0	20	0	0
18	33983641	.	T	C	12	9	21	3	3	27	0	0
18	33983771	.	A	C	8	16	24	0	2	26	0	0
18	33984191	.	C	A	12	5	17	0	1	18	0	0
18	33984215	.	G	T	9	7	16	0	0	16	0	0
18	33984235	.	T	A	5	7	12	0	1	13	0	0
18	33984596	.	G	A	8	7	15	0	0	15	0	0
18	33984801	.	A	C	8	10	18	0	0	18	0	0
18	33985249	.	T	C	9	11	20	0	2	22	0	0
18	33985414	.	T	C	10	0	10	0	12	22	0	0
18	33985953	.	C	T	8	19	27	0	0	27	0	0
18	33986027	.	A	G	6	14	20	0	1	21	0	0
18	33986199	.	C	T	9	22	31	0	2	33	0	0
18	33986391	.	C	T	1	10	11	0	2	13	0	0
18	33986395	.	A	G	3	9	12	0	0	12	0	0
18	33986470	.	T	C	4	5	9	0	1	10	0	0
18	33988590	.	C	T	0	1	1	0	1	2	0	0
18	33988743	.	A	C	6	0	6	0	7	13	0	0
18	33999714	.	C	G	1	1	2	0	0	2	0	0
18	33999923	.	G	A	2	2	4	0	0	4	0	0
18	34015365	.	T	C	1	2	3	0	0	3	0	0
18	34050813	.	A	G	1	0	1	0	0	1	0	0
18	34152190	.	A	G	2	2	4	0	0	4	0	0
18	34162053	.	T	C	4	3	7	0	0	7	0	0
18	34163687	.	A	G	1	2	3	0	0	3	0	0
18	34170913	.	G	A	2	1	3	0	0	3	0	0
18	34189117	.	A	G	1	0	1	0	2	3	0	0
18	34195318	.	C	A	2	2	4	0	0	4	0	0
18	34195336	.	A	T	1	0	1	0	0	1	0	0
18	34196270	.	G	C	1	0	1	0	0	1	0	0
18	34207700	.	G	A	2	7	9	0	1	10	0	0
18	34213351	.	C	T	4	7	11	0	0	11	0	0
18	34213378	.	A	T	2	7	9	0	2	11	0	0
18	34213414	.	T	C	1	6	7	0	0	7	0	0
18	34213426	.	T	C	2	3	5	0	0	5	0	0
18	34213530	.	G	A	0	5	5	0	3	8	0	0
18	34213995	.	A	T	7	10	17	0	0	17	0	0
18	34214054	.	C	T	4	7	11	0	2	13	0	0
18	34214141	.	T	G	6	4	10	0	0	10	0	0
18	34214280	.	A	T	11	2	13	0	0	13	0	0
18	34214288	.	G	T	10	6	16	0	1	17	0	0
18	34214754	.	C	G	17	10	27	0	2	29	0	0
18	34214894	.	T	C	17	9	26	0	0	26	0	0
18	34534807	.	G	T	4	2	6	0	1	7	0	0
18	34535184	.	A	G	3	2	5	0	0	6	1	0
18	34535302	.	A	C	1	2	3	0	0	3	0	0
18	34535423	.	A	G	0	5	5	0	0	5	0	0
18	34535518	.	T	C	1	2	3	0	0	3	0	0
18	34535769	.	T	C	1	4	5	0	0	5	0	0
18	34542620	.	C	A	8	10	18	0	1	19	0	0
18	34601008	.	C	A	5	12	17	0	0	17	0	0
18	34601042	.	A	C	6	6	12	0	1	13	0	0
18	34601323	.	T	G	8	8	16	0	0	16	0	0
18	34601468	.	G	T	3	8	11	0	0	11	0	0
18	34601471	.	A	T	3	8	11	0	0	11	0	0
18	34641352	.	A	C	16	9	25	0	3	28	0	0
18	34641439	.	T	C	13	16	29	0	1	30	0	0
18	34641442	.	T	C	15	16	31	0	0	31	0	0
18	34641622	.	C	G	16	9	25	0	0	25	0	0
18	34641633	.	T	C	16	12	28	0	0	28	0	0
18	35143242	.	G	T	1	3	4	0	1	5	0	0
18	35147233	.	T	C	1	2	3	0	0	3	0	0
18	35238163	.	A	T	1	2	3	0	1	4	0	0
18	35251214	.	A	C	1	3	4	0	0	4	0	0
18	35405389	.	T	C	3	0	3	0	5	8	0	0
18	35406987	.	G	A	5	6	11	0	0	11	0	0
18	35411535	.	C	G	1	2	3	0	0	3	0	0
18	35411572	.	C	A	1	2	3	0	0	3	0	0
18	35491518	.	A	T	11	9	20	0	1	21	0	0
18	35497031	.	A	C	3	2	5	0	1	6	0	0
18	35501357	.	G	A	4	9	13	0	0	13	0	0
18	35503636	.	A	G	1	1	2	0	0	2	0	0
18	35503654	.	C	T	6	5	11	0	0	11	0	0
18	35503705	.	A	G	7	5	12	0	1	13	0	0
18	35508139	.	C	A	0	3	3	0	1	4	0	0
18	35508151	.	A	T	1	2	3	0	0	3	0	0
18	35508304	.	C	T	1	1	2	0	0	2	0	0
18	35509705	.	G	A	6	6	12	0	1	13	0	0
18	35510290	.	G	T	6	3	9	0	0	9	0	0
18	35510590	.	C	A	2	4	6	0	0	6	0	0
18	35520248	.	G	A	1	1	2	0	0	2	0	0
18	35520281	.	T	C	1	0	1	0	2	3	0	0
18	35529482	.	T	G	1	0	1	0	0	1	0	0
18	35562303	.	C	T	1	3	4	0	0	4	0	0
18	35577995	.	T	C	0	2	2	0	0	2	0	0
18	35582682	.	C	T	1	1	2	0	0	2	0	0
18	35582718	.	C	T	2	3	5	0	0	5	0	0
18	35794289	.	T	C	1	2	3	0	0	3	0	0
18	35807902	.	A	T	3	8	11	0	0	11	0	0
18	35808137	.	C	T	6	8	14	0	1	15	0	0
18	35808223	.	G	A	7	9	16	0	0	16	0	0
18	35808320	.	A	G	18	18	36	0	1	37	0	0
18	35814745	.	T	G	4	2	6	0	0	6	0	0
18	35827185	.	C	T	5	7	12	0	2	14	0	0
18	35829794	.	T	C	2	3	5	0	0	5	0	0
18	35832858	.	G	T	6	5	11	0	0	11	0	0
18	35832896	.	G	A	7	12	19	0	0	19	0	0
18	35832911	.	G	A	6	8	14	0	0	14	0	0
18	35832931	.	C	T	3	8	11	0	0	11	0	0
18	35837643	.	A	G	6	5	11	0	1	12	0	0
18	35838817	.	A	G	4	5	9	0	0	9	0	0
18	35839054	.	G	A	3	3	6	0	1	7	0	0
18	35839461	.	T	C	4	3	7	0	1	8	0	0
18	35839512	.	A	G	7	6	13	0	2	15	0	0
18	35839543	.	A	T	8	8	16	0	1	17	0	0
18	35839658	.	T	C	5	8	13	0	1	14	0	0
18	35839673	.	A	G	3	6	9	0	3	12	0	0
18	35839832	.	G	A	4	2	6	0	0	6	0	0
18	35842419	.	T	C	3	5	8	0	0	8	0	0
18	35842440	.	C	T	1	8	9	0	4	13	0	0
18	35842476	.	C	T	3	15	18	0	1	19	0	0
18	35898736	.	G	A	0	0	0	0	1	1	0	0
18	35898765	.	G	A	1	1	2	0	0	2	0	0
18	36037258	.	T	C	0	3	3	0	0	3	0	0
18	36065768	.	T	G	2	3	5	0	0	5	0	0
18	36066048	.	T	C	2	4	6	0	0	6	0	0
18	36066054	.	C	G	1	3	4	0	1	5	0	0
18	36066450	.	G	C	6	3	9	0	0	9	0	0
18	36066480	.	A	T	6	1	7	0	0	7	0	0
18	36070870	.	T	C	1	0	1	0	0	1	0	0
18	36071039	.	G	T	0	1	1	0	0	1	0	0
18	36071217	.	C	G	1	0	1	0	3	4	0	0
18	36071223	.	G	A	1	3	4	0	0	4	0	0
18	36080616	.	G	T	10	14	24	0	0	24	0	0
18	36080688	.	A	G	19	11	30	0	1	31	0	0
18	36080931	.	T	G	4	7	11	0	0	11	0	0
18	36081009	.	A	C	10	6	16	0	0	16	0	0
18	36081018	.	G	A	12	8	20	0	0	20	0	0
18	36081513	.	C	T	14	6	20	0	1	21	0	0
18	36081792	.	T	C	2	6	8	0	0	8	0	0
18	36106031	.	T	C	4	15	19	0	1	20	0	0
18	36129218	.	G	A	5	9	14	0	0	14	0	0
18	36597757	.	A	G	0	1	1	0	0	1	0	0
18	36597952	.	C	T	7	5	12	0	0	12	0	0
18	36598075	.	G	A	0	2	2	0	2	4	0	0
18	36598076	.	T	A	2	2	4	0	0	4	0	0
18	36598439	.	A	G	5	3	8	0	1	9	0	0
18	36598476	.	G	A	5	3	8	0	1	9	0	0
18	36620186	.	C	T	5	6	11	0	0	11	0	0
18	36623275	.	C	T	6	6	12	0	0	12	0	0
18	36630867	.	C	T	11	13	24	0	1	25	0	0
18	36647855	.	C	T	2	4	6	0	0	6	0	0
18	36769901	.	G	A	1	3	4	0	0	4	0	0
18	36774767	.	T	C	3	3	6	0	0	6	0	0
18	36799090	.	C	T	5	3	8	0	0	8	0	0
18	36799167	.	A	C	3	4	7	0	0	7	0	0
18	36799219	.	T	C	3	2	5	0	0	5	0	0
18	36799229	.	T	G	4	3	7	0	0	7	0	0
18	36799312	.	A	G	3	2	5	0	0	5	0	0
18	36799477	.	C	T	3	2	5	0	0	5	0	0
18	36799767	.	T	C	2	2	4	0	1	5	0	0
18	36799780	.	G	A	2	2	4	0	0	4	0	0
18	36799922	.	T	C	1	2	3	0	0	3	0	0
18	36800002	.	C	T	2	4	6	0	0	6	0	0
18	36800035	.	T	G	5	3	8	0	1	9	0	0
18	36806632	.	A	T	13	7	20	0	0	20	0	0
18	36806657	.	T	A	11	5	16	0	5	21	0	0
18	36806681	.	T	C	5	3	8	0	3	11	0	0
18	36806707	.	C	T	5	4	9	0	0	9	0	0
18	36806727	.	C	T	4	6	10	0	0	10	0	0
18	36806749	.	A	G	4	8	12	0	1	13	0	0
18	36858200	.	T	C	0	1	1	0	1	2	0	0
18	36869052	.	A	G	6	6	12	0	0	12	0	0
18	36869120	.	T	G	6	6	12	0	0	12	0	0
18	36869131	.	G	A	0	5	5	0	7	12	0	0
18	36869180	.	T	C	10	11	21	0	0	21	0	0
18	36869427	.	T	A	4	4	8	0	1	9	0	0
18	36869530	.	C	G	8	12	20	0	0	20	0	0
18	36870068	.	G	A	14	9	23	0	2	25	0	0
18	36870174	.	G	A	9	9	18	0	1	19	0	0
18	36870278	.	G	A	16	5	21	0	2	23	0	0
18	36870378	.	A	G	8	0	8	0	7	15	0	0
18	36870448	.	C	G	6	7	13	0	0	13	0	0
18	36870460	.	T	C	7	9	16	0	0	16	0	0
18	36870702	.	A	T	12	19	31	0	1	32	0	0
18	36949014	.	G	A	2	6	8	0	0	8	0	0
18	36949178	.	A	G	5	9	14	0	0	14	0	0
18	36951823	.	G	A	5	4	9	0	0	9	0	0
18	36951829	.	T	C	6	3	9	0	0	9	0	0
18	36951888	.	A	G	6	3	9	0	1	10	0	0
18	36954186	.	A	G	2	7	9	0	0	9	0	0
18	36954230	.	C	T	3	6	9	0	0	9	0	0
18	36954250	.	A	G	2	4	6	0	0	6	0	0
18	36956672	.	G	A	1	3	4	0	0	4	0	0
18	36957310	.	T	C	4	5	9	0	0	9	0	0
18	36963204	.	A	G	1	1	2	0	0	2	0	0
18	37133566	.	G	A	1	0	1	0	0	1	0	0
18	37137271	.	A	G	1	0	1	0	5	6	0	0
18	37197464	.	T	C	2	2	4	0	0	4	0	0
18	37219646	.	T	C	1	3	4	0	0	4	0	0
18	37219987	.	T	A	1	1	2	0	0	2	0	0
18	37223511	.	T	C	4	2	6	0	0	6	0	0
18	37223515	.	G	A	3	2	5	0	1	6	0	0
18	37228547	.	A	G	1	0	1	0	3	4	0	0
18	37228562	.	C	G	2	3	5	0	0	5	0	0
18	37230433	.	A	G	1	1	2	0	0	2	0	0
18	37230456	.	C	G	1	4	5	0	0	5	0	0
18	37230629	.	T	C	2	4	6	0	1	7	0	0
18	37234081	.	T	C	6	8	14	0	0	14	0	0
18	37234289	.	A	G	2	7	9	0	0	9	0	0
18	37234574	.	T	A	1	3	4	0	0	4	0	0
18	37259911	.	A	G	15	17	32	0	5	37	0	0
18	37260192	.	A	G	8	0	8	0	14	22	0	0
18	37267398	.	C	A	11	3	14	0	1	15	0	0
18	37267464	.	G	A	16	10	26	0	4	30	0	0
18	37267529	.	G	A	9	6	15	0	0	15	0	0
18	37269904	.	A	G	4	3	7	0	0	7	0	0
18	37270225	.	A	G	15	19	34	0	1	35	0	0
18	37270498	.	C	T	13	10	23	0	2	25	0	0
18	37270598	.	T	G	10	8	18	0	0	19	1	0
18	37837371	.	C	T	0	17	17	0	16	33	0	0
18	37837511	.	A	G	16	11	27	0	2	29	0	0
18	37837536	.	T	C	16	12	28	0	2	30	0	0
18	37837655	.	A	G	15	20	35	0	1	36	0	0
18	37837706	.	A	C	9	11	20	0	5	25	0	0
18	37837708	.	T	A	10	14	24	0	1	25	0	0
18	37838160	.	G	T	15	22	37	0	2	40	1	0
18	37838250	.	G	C	13	9	22	0	1	23	0	0
18	37840290	.	A	G	1	0	1	0	0	1	0	0
18	37866417	.	C	T	0	1	1	0	0	1	0	0
18	38194336	.	C	A	0	1	1	0	0	1	0	0
18	38199482	.	A	G	1	5	6	0	0	6	0	0
18	38202827	.	T	C	0	1	1	0	0	1	0	0
18	38206907	.	A	G	0	0	0	0	1	1	0	0
18	38209562	.	T	G	6	3	9	0	0	9	0	0
18	38209776	.	A	G	4	4	8	0	1	9	0	0
18	38217181	.	A	G	1	2	3	0	0	3	0	0
18	38222514	.	A	G	3	6	9	0	0	9	0	0
18	38223448	.	A	G	1	1	2	0	0	2	0	0
18	38223735	.	A	G	4	2	6	0	1	7	0	0
18	38224672	.	G	T	0	1	1	0	0	1	0	0
18	38225491	.	A	G	3	2	5	0	0	5	0	0
18	38225547	.	G	A	3	4	7	0	1	8	0	0
18	38235716	.	T	G	1	2	3	0	0	3	0	0
18	38235726	.	A	T	1	1	2	0	0	2	0	0
18	38239034	.	A	G	0	2	2	0	0	2	0	0
18	38239040	.	A	G	0	3	3	0	0	3	0	0
18	38248121	.	T	C	12	9	21	0	0	21	0	0
18	38250924	.	A	G	5	11	16	0	2	18	0	0
18	38256265	.	T	C	6	0	6	0	5	11	0	0
18	38256668	.	A	G	8	12	20	0	1	21	0	0
18	38260330	.	A	G	12	5	17	0	1	18	0	0
18	38260352	.	C	A	11	4	15	0	0	15	0	0
18	38260377	.	C	T	7	2	9	0	1	10	0	0
18	38263910	.	G	C	2	0	2	0	0	2	0	0
18	38266979	.	C	T	7	7	14	0	1	15	0	0
18	38270559	.	T	C	5	6	11	0	1	12	0	0
18	38296046	.	C	G	6	10	16	0	0	16	0	0
18	38296089	.	G	T	4	5	9	0	0	9	0	0
18	39104846	.	T	C	6	4	10	0	0	10	0	0
18	39523000	.	G	T	2	1	3	0	0	3	0	0
18	39523002	.	T	C	1	2	3	0	0	3	0	0
18	40492204	.	C	T	5	4	9	0	0	9	0	0
18	40711312	.	G	A	10	4	14	0	2	16	0	0
18	41278299	.	G	A	2	2	4	0	1	5	0	0
18	41284700	.	C	T	2	1	3	0	0	3	0	0
18	41293901	.	A	T	1	4	5	0	0	5	0	0
18	41295246	.	C	T	2	5	7	0	0	7	0	0
18	41297082	.	C	T	1	1	2	0	0	2	0	0
18	41300063	.	A	G	0	0	0	0	3	3	0	0
18	41305867	.	C	T	5	7	12	0	1	13	0	0
18	41309305	.	G	A	5	11	16	0	1	17	0	0
18	41310464	.	G	A	0	10	10	0	14	24	0	0
18	41364527	.	C	G	2	3	5	0	0	5	0	0
18	41364932	.	A	G	2	1	3	0	0	3	0	0
18	41364937	.	T	A	2	1	3	0	0	3	0	0
18	41365051	.	A	T	0	3	3	0	0	3	0	0
18	41365125	.	G	A	1	5	6	0	1	7	0	0
18	41365236	.	C	A	1	4	5	0	0	5	0	0
18	41365308	.	C	T	2	4	6	0	0	6	0	0
18	41365434	.	G	A	2	2	4	0	0	4	0	0
18	41372437	.	C	T	0	2	2	0	1	3	0	0
18	41495859	.	A	G	17	12	29	0	0	29	0	0
18	41495865	.	A	T	15	10	25	0	1	26	0	0
18	41499679	.	A	G	11	6	17	0	2	19	0	0
18	41499683	.	T	C	11	5	16	0	2	18	0	0
18	41499789	.	C	T	10	3	13	0	0	13	0	0
18	41503578	.	C	A	21	20	41	0	0	41	0	0
18	41505624	.	A	G	21	1	22	0	18	40	0	0
18	41509564	.	C	G	21	13	34	0	0	34	0	0
18	41509716	.	G	T	17	5	22	0	1	23	0	0
18	41512217	.	C	T	10	14	24	0	0	24	0	0
18	41512370	.	G	A	5	3	8	0	0	8	0	0
18	41514977	.	C	A	2	3	5	0	1	6	0	0
18	41524354	.	G	A	7	10	17	0	1	18	0	0
18	41524364	.	C	A	7	11	18	0	0	18	0	0
18	41525864	.	T	C	18	16	34	0	1	35	0	0
18	41525880	.	G	A	1	15	16	0	21	37	0	0
18	41526014	.	C	G	18	1	19	0	18	37	0	0
18	41526026	.	A	G	16	15	31	0	2	33	0	0
18	41526247	.	T	A	15	15	30	0	6	36	0	0
18	41526299	.	T	A	9	15	24	0	2	26	0	0
18	41526318	.	A	G	7	13	20	0	0	20	0	0
18	41526380	.	C	T	2	8	10	0	2	12	0	0
18	41526381	.	T	C	4	7	11	0	1	12	0	0
18	41533072	.	C	T	4	4	8	0	0	8	0	0
18	41538770	.	G	A	6	16	22	0	1	23	0	0
18	41538795	.	A	G	3	11	14	0	1	15	0	0
18	41538856	.	G	A	3	4	7	0	0	7	0	0
18	41539058	.	A	C	1	2	3	0	0	3	0	0
18	41539064	.	C	T	1	2	3	0	0	3	0	0
18	41542632	.	A	G	2	4	6	0	0	6	0	0
18	41542661	.	A	T	2	2	4	0	0	4	0	0
18	41542669	.	T	A	2	2	4	0	0	4	0	0
18	41542790	.	T	G	3	2	5	0	0	5	0	0
18	41543076	.	C	T	4	12	16	0	0	16	0	0
18	41546938	.	C	G	1	4	5	0	0	5	0	0
18	41547273	.	T	G	1	3	4	0	1	5	0	0
18	41549817	.	T	A	4	7	11	0	0	11	0	0
18	41556239	.	G	A	0	0	0	0	1	1	0	0
18	41558711	.	C	T	3	2	5	0	0	5	0	0
18	41560923	.	C	T	1	3	4	0	0	4	0	0
18	41561127	.	T	C	2	2	4	0	0	4	0	0
18	41565692	.	T	C	1	2	3	0	0	3	0	0
18	41572423	.	A	C	2	2	4	0	0	4	0	0
18	41572445	.	T	C	3	4	7	0	0	7	0	0
18	41573681	.	T	C	1	2	3	0	1	4	0	0
18	41573696	.	A	G	1	2	3	0	0	3	0	0
18	41573813	.	A	G	2	0	2	0	3	5	0	0
18	41574155	.	A	G	4	2	6	0	1	7	0	0
18	41574340	.	C	T	2	4	6	0	0	6	0	0
18	41574608	.	T	C	6	4	10	0	0	10	0	0
18	41579975	.	T	A	2	4	6	0	1	7	0	0
18	41580151	.	A	T	6	5	11	0	0	11	0	0
18	41586440	.	T	C	2	5	7	0	0	7	0	0
18	41588148	.	A	G	2	0	2	0	5	7	0	0
18	41588166	.	C	T	2	3	5	0	0	5	0	0
18	41589613	.	A	C	3	2	5	0	1	6	0	0
18	41591256	.	G	T	4	2	6	0	0	6	0	0
18	41649061	.	C	T	6	4	10	0	1	11	0	0
18	41757350	.	C	A	8	14	22	0	1	23	0	0
18	41757449	.	G	A	21	23	44	0	2	46	0	0
18	41757454	.	G	A	22	22	44	0	2	46	0	0
18	41757669	.	C	T	2	7	9	0	0	9	0	0
18	41772745	.	C	T	1	2	3	0	0	3	0	0
18	42162369	.	G	A	5	5	10	0	0	10	0	0
18	42201031	.	C	G	5	3	8	0	0	8	0	0
18	42215403	.	C	T	5	3	8	0	0	8	0	0
18	42218721	.	G	A	1	2	3	0	1	4	0	0
18	42218741	.	G	A	1	1	2	0	0	2	0	0
18	42258933	.	T	A	1	3	4	0	0	4	0	0
18	42276336	.	T	C	1	5	6	0	0	6	0	0
18	42333382	.	C	T	2	2	4	0	0	4	0	0
18	43867265	.	A	C	6	6	12	0	1	13	0	0
18	43867416	.	A	G	11	10	21	0	0	21	0	0
18	43867495	.	C	A	1	1	2	0	0	2	0	0
18	43867500	.	A	C	1	2	3	0	0	3	0	0
18	43867775	.	T	C	3	7	10	0	0	10	0	0
18	43867892	.	C	T	2	5	7	0	0	7	0	0
18	43868073	.	A	C	6	9	15	0	3	18	0	0
18	43868229	.	A	T	10	7	17	0	1	18	0	0
18	43868234	.	T	A	11	8	19	0	0	19	0	0
18	43868682	.	T	G	4	11	15	0	1	16	0	0
18	43869326	.	A	G	6	6	12	0	0	12	0	0
18	43869424	.	G	A	7	2	9	0	0	9	0	0
18	43869475	.	A	G	2	3	5	0	1	6	0	0
18	43869520	.	T	G	1	2	3	0	0	3	0	0
18	43869522	.	T	C	1	1	2	0	1	3	0	0
18	43869976	.	T	C	3	8	11	0	2	13	0	0
18	43870180	.	C	T	0	2	2	0	7	9	0	0
18	43870501	.	T	C	1	4	5	0	1	6	0	0
18	43870525	.	G	A	3	5	8	0	1	9	0	0
18	43870541	.	A	G	4	7	11	0	0	11	0	0
18	43870592	.	C	A	7	6	13	0	0	13	0	0
18	43870655	.	G	T	8	2	10	0	0	11	1	0
18	43870660	.	A	G	8	4	12	0	0	12	0	0
18	43896892	.	A	G	14	15	29	0	1	30	0	0
18	43896919	.	C	T	0	15	15	0	22	37	0	0
18	43897048	.	C	T	2	22	24	0	11	35	0	0
18	43897405	.	C	G	9	12	21	0	1	22	0	0
18	43897522	.	C	T	2	9	11	0	0	11	0	0
18	43897816	.	G	A	11	11	22	0	1	23	0	0
18	43898211	.	G	T	7	5	12	0	2	14	0	0
18	43898223	.	A	T	6	6	12	0	0	12	0	0
18	43898526	.	C	T	9	7	16	0	1	17	0	0
18	43898928	.	A	G	6	4	10	0	0	10	0	0
18	43899558	.	T	C	3	3	6	0	0	6	0	0
18	43899825	.	G	A	6	3	9	0	1	10	0	0
18	43900299	.	G	A	1	5	6	0	0	6	0	0
18	44053421	.	T	A	2	2	4	0	0	4	0	0
18	44053584	.	T	C	3	1	4	0	0	4	0	0
18	44057052	.	G	A	4	2	6	0	0	6	0	0
18	44065238	.	T	C	2	2	4	0	0	4	0	0
18	44068132	.	A	G	1	2	3	0	0	3	0	0
18	44321063	.	A	G	2	2	4	0	0	4	0	0
18	44321260	.	T	A	8	8	16	0	0	16	0	0
18	44321323	.	C	T	7	1	8	0	0	8	0	0
18	44321731	.	T	C	1	3	4	0	1	5	0	0
18	44321743	.	A	T	2	3	5	0	0	5	0	0
18	44321909	.	G	A	3	4	7	0	0	7	0	0
18	44321949	.	T	C	3	5	8	0	0	8	0	0
18	44322481	.	C	T	0	9	9	0	13	22	0	0
18	44325470	.	A	G	0	2	2	0	0	2	0	0
18	44325526	.	A	T	2	4	6	0	1	7	0	0
18	44327944	.	A	G	5	5	10	0	0	10	0	0
18	44327953	.	G	A	4	3	7	0	0	7	0	0
18	44331117	.	G	C	2	2	4	0	0	4	0	0
18	44334889	.	C	T	2	2	4	0	0	4	0	0
18	44345920	.	T	C	1	0	1	0	2	3	0	0
18	44346102	.	C	T	0	1	1	0	0	1	0	0
18	44346150	.	C	A	0	0	0	0	2	2	0	0
18	44364647	.	C	A	25	20	45	0	1	46	0	0
18	44365064	.	C	A	26	27	53	0	4	57	0	0
18	44365114	.	T	A	40	25	65	0	1	66	0	0
18	44365650	.	T	C	21	16	37	0	0	37	0	0
18	44365714	.	C	A	23	24	47	0	2	49	0	0
18	44365717	.	A	G	20	26	46	0	2	48	0	0
18	44365977	.	T	C	8	16	24	0	2	26	0	0
18	44365987	.	T	A	11	17	28	0	1	29	0	0
18	44367241	.	A	T	16	20	36	0	0	36	0	0
18	44367426	.	C	T	23	20	43	0	1	44	0	0
18	44367488	.	G	A	14	11	25	0	1	26	0	0
18	44377404	.	C	A	3	2	5	0	0	5	0	0
18	44377417	.	C	T	3	2	5	0	0	5	0	0
18	44388421	.	C	T	19	14	33	0	0	33	0	0
18	44397330	.	G	A	2	4	6	0	0	6	0	0
18	44404609	.	C	T	5	5	10	0	2	12	0	0
18	44404872	.	C	T	1	1	2	0	0	2	0	0
18	44408841	.	G	A	5	6	11	0	1	12	0	0
18	44418164	.	C	T	7	14	21	0	1	22	0	0
18	44425093	.	A	G	6	5	11	0	0	11	0	0
18	44425105	.	C	T	6	8	14	0	0	14	0	0
18	44425150	.	A	C	5	16	21	0	1	22	0	0
18	44453365	.	G	A	4	3	7	0	1	8	0	0
18	44453377	.	G	C	2	0	2	0	1	3	0	0
18	44567334	.	G	T	0	1	1	0	0	1	0	0
18	44567352	.	C	A	1	1	2	0	0	2	0	0
18	44569847	.	A	G	3	2	5	0	0	5	0	0
18	44569895	.	C	T	3	2	5	0	0	5	0	0
18	44587777	.	C	A	0	1	1	0	0	1	0	0
18	44597308	.	C	A	19	20	39	0	4	43	0	0
18	44597850	.	A	G	7	15	22	0	1	23	0	0
18	44597884	.	G	A	12	11	23	0	0	23	0	0
18	44598234	.	C	T	0	12	12	0	11	23	0	0
18	44598371	.	C	T	9	9	18	0	3	21	0	0
18	44599837	.	G	A	10	9	19	0	1	20	0	0
18	44615685	.	G	A	6	9	15	0	0	15	0	0
18	44615770	.	G	A	9	10	19	0	0	19	0	0
18	44615819	.	T	C	7	10	17	0	0	17	0	0
18	44615861	.	A	T	3	3	6	0	0	6	0	0
18	44618795	.	G	T	4	7	11	0	0	11	0	0
18	44619049	.	T	G	10	6	16	0	1	17	0	0
18	44623527	.	G	A	3	8	11	0	1	12	0	0
18	44633195	.	C	T	4	3	7	0	0	7	0	0
18	44637835	.	A	T	4	7	11	0	3	14	0	0
18	44638087	.	G	T	1	3	4	0	1	5	0	0
18	44640464	.	C	T	1	4	5	0	0	5	0	0
18	44645008	.	A	T	7	7	14	0	1	16	1	0
18	44645617	.	G	A	0	6	6	0	6	12	0	0
18	44645782	.	G	C	10	10	20	0	0	20	0	0
18	44646048	.	C	T	1	3	4	0	0	4	0	0
18	44646215	.	C	T	7	4	11	0	3	14	0	0
18	44646467	.	A	C	6	12	18	0	1	19	0	0
18	44646504	.	C	T	7	9	16	0	1	17	0	0
18	44646587	.	G	A	0	7	7	0	12	19	0	0
18	44646678	.	C	T	8	5	13	0	3	16	0	0
18	44646781	.	A	G	5	7	12	0	0	12	0	0
18	44674019	.	A	T	0	2	2	0	1	3	0	0
18	44696319	.	A	C	3	4	7	0	0	7	0	0
18	44765491	.	A	G	4	0	4	0	3	7	0	0
18	44779171	.	T	C	0	1	1	0	0	1	0	0
18	44779174	.	A	G	0	1	1	0	0	1	0	0
18	44783399	.	G	C	2	2	4	0	0	4	0	0
18	44783771	.	C	T	0	2	2	0	0	2	0	0
18	44790506	.	T	C	0	2	2	0	0	2	0	0
18	44790635	.	A	G	2	3	5	0	0	5	0	0
18	44790722	.	G	A	2	3	5	0	0	5	0	0
18	44791318	.	C	A	1	2	3	0	0	3	0	0
18	44791774	.	A	G	1	2	3	0	0	3	0	0
18	44826427	.	C	T	0	14	14	0	11	25	0	0
18	44826554	.	T	G	12	6	18	0	1	19	0	0
18	44826910	.	C	T	3	7	10	0	0	10	0	0
18	44830217	.	C	T	3	6	9	0	0	9	0	0
18	44830247	.	G	A	7	9	16	0	2	18	0	0
18	44830283	.	G	A	8	6	14	0	2	16	0	0
18	44832693	.	C	A	1	8	9	0	0	9	0	0
18	44834165	.	T	C	2	0	2	0	3	5	0	0
18	44837085	.	T	C	3	2	5	0	1	6	0	0
18	44838285	.	G	A	4	4	8	0	0	8	0	0
18	44838342	.	G	A	9	9	18	0	1	19	0	0
18	44840994	.	C	T	18	6	24	0	1	25	0	0
18	44843407	.	G	A	0	2	2	0	0	2	0	0
18	44843531	.	C	A	7	2	9	0	0	9	0	0
18	44852404	.	C	T	3	1	4	0	0	4	0	0
18	44857803	.	C	A	0	1	1	0	0	1	0	0
18	44866841	.	C	T	2	1	3	0	0	3	0	0
18	44870505	.	G	A	0	8	8	0	5	13	0	0
18	44870526	.	G	A	0	7	7	0	12	19	0	0
18	44870541	.	G	A	0	8	8	0	11	19	0	0
18	44873083	.	C	T	3	0	3	0	0	3	0	0
18	44873993	.	G	T	4	9	13	0	0	13	0	0
18	44874249	.	T	G	10	0	10	0	11	21	0	0
18	44874252	.	C	T	10	11	21	0	0	21	0	0
18	44913653	.	G	T	7	5	12	0	0	12	0	0
18	44913760	.	A	G	5	4	9	0	0	9	0	0
18	44935070	.	C	G	2	2	4	0	0	4	0	0
18	45231137	.	G	A	0	4	4	0	0	4	0	0
18	45231238	.	C	T	1	2	3	0	0	3	0	0
18	45248042	.	T	G	1	2	3	0	0	3	0	0
18	45257475	.	C	T	1	5	6	0	0	6	0	0
18	45259886	.	T	C	4	4	8	0	0	8	0	0
18	45259930	.	C	T	3	3	6	0	1	7	0	0
18	45260228	.	T	C	6	6	12	0	0	12	0	0
18	45260316	.	A	C	2	6	8	0	0	8	0	0
18	45260321	.	G	T	0	2	2	0	7	9	0	0
18	45261369	.	G	T	8	5	13	0	0	13	0	0
18	45261438	.	G	A	2	6	8	0	0	8	0	0
18	45261501	.	G	C	0	3	3	0	0	3	0	0
18	45261845	.	T	A	6	2	8	0	0	8	0	0
18	45261882	.	T	C	3	7	10	0	0	10	0	0
18	45262227	.	C	T	8	3	11	0	0	11	0	0
18	45262351	.	C	T	4	6	10	0	0	10	0	0
18	45262687	.	G	T	6	8	14	0	1	15	0	0
18	45262855	.	A	C	4	12	16	0	0	16	0	0
18	45262865	.	T	C	3	13	16	0	1	17	0	0
18	45550831	.	G	C	0	12	12	0	9	21	0	0
18	45550839	.	A	C	10	12	22	0	0	22	0	0
18	45561677	.	G	T	2	1	3	0	0	3	0	0
18	45569037	.	G	A	0	6	6	0	11	17	0	0
18	45569075	.	C	A	14	9	23	0	0	23	0	0
18	45569092	.	A	G	11	0	11	0	8	19	0	0
18	45574140	.	A	G	12	19	31	0	1	32	0	0
18	45574275	.	A	T	3	7	10	0	0	10	0	0
18	45575079	.	G	A	0	13	13	0	12	25	0	0
18	45581704	.	C	A	6	9	15	0	1	16	0	0
18	45581784	.	C	T	2	0	2	0	0	2	0	0
18	45583038	.	A	C	4	7	11	0	1	12	0	0
18	45583042	.	G	A	1	5	6	0	4	10	0	0
18	45584036	.	C	T	8	11	19	0	1	20	0	0
18	45584368	.	T	C	15	13	28	0	0	28	0	0
18	45588336	.	C	T	14	6	20	0	2	22	0	0
18	45591836	.	A	T	9	14	23	0	2	25	0	0
18	45591929	.	G	A	12	13	25	0	2	27	0	0
18	45647838	.	G	A	0	2	2	0	0	2	0	0
18	45647940	.	C	T	8	4	12	0	0	12	0	0
18	45649613	.	C	T	5	7	12	0	0	12	0	0
18	45649658	.	G	T	11	14	25	0	0	25	0	0
18	45651032	.	C	T	4	3	7	0	1	8	0	0
18	45651559	.	T	A	5	3	8	0	1	9	0	0
18	45656062	.	T	C	8	6	14	0	0	14	0	0
18	45656089	.	T	C	3	2	5	0	0	5	0	0
18	45682041	.	C	T	1	2	3	0	1	4	0	0
18	45684425	.	G	A	0	2	2	0	2	4	0	0
18	45685625	.	G	A	3	3	6	0	0	6	0	0
18	45685805	.	A	C	3	2	5	0	0	5	0	0
18	45686500	.	A	G	1	3	4	0	0	4	0	0
18	45686840	.	T	C	6	5	11	0	0	11	0	0
18	45686882	.	G	A	0	3	3	0	4	7	0	0
18	45687258	.	G	C	2	4	6	0	1	7	0	0
18	45687882	.	C	T	3	6	9	0	1	10	0	0
18	45689081	.	C	T	1	1	2	0	0	2	0	0
18	45691123	.	G	A	4	3	7	0	0	7	0	0
18	45697623	.	A	G	2	4	6	0	1	7	0	0
18	45697833	.	A	T	6	3	9	0	0	9	0	0
18	45697909	.	C	T	2	2	4	0	0	4	0	0
18	45698032	.	A	G	3	0	3	0	5	8	0	0
18	45734477	.	T	C	3	5	8	0	0	8	0	0
18	45742051	.	C	A	8	15	23	0	0	23	0	0
18	45742059	.	G	A	8	15	23	0	0	23	0	0
18	45743518	.	G	A	1	3	4	0	0	4	0	0
18	45743522	.	G	A	1	3	4	0	0	4	0	0
18	45743555	.	C	A	1	3	4	0	1	5	0	0
18	45745504	.	A	T	3	3	6	0	0	6	0	0
18	45750912	.	A	C	6	0	6	0	6	12	0	0
18	45750915	.	A	G	6	5	11	0	0	11	0	0
18	45752094	.	C	T	0	3	3	0	0	3	0	0
18	45759309	.	G	T	8	5	13	0	0	13	0	0
18	45784225	.	A	G	26	34	60	0	8	68	0	0
18	45807903	.	C	G	3	0	3	0	6	9	0	0
18	45807942	.	G	C	0	6	6	0	9	15	0	0
18	45809872	.	A	G	3	0	3	0	6	9	0	0
18	45809892	.	T	C	1	0	1	0	1	2	0	0
18	45818602	.	C	T	10	7	17	0	0	17	0	0
18	45820588	.	A	G	7	7	14	0	0	14	0	0
18	45824315	.	C	T	8	8	16	0	1	17	0	0
18	45824467	.	G	A	0	5	5	0	7	12	0	0
18	45824607	.	G	A	0	1	1	0	0	1	0	0
18	45835115	.	C	T	1	1	2	0	1	3	0	0
18	45840471	.	T	A	9	17	26	0	1	27	0	0
18	45840504	.	C	T	7	19	26	0	0	26	0	0
18	45842491	.	T	C	2	4	6	0	0	6	0	0
18	45842679	.	G	A	0	5	5	0	9	14	0	0
18	45844458	.	C	T	20	12	32	0	1	33	0	0
18	45844473	.	A	T	18	15	33	0	2	35	0	0
18	45848355	.	C	T	2	1	3	0	0	3	0	0
18	45849283	.	C	T	10	11	21	0	0	21	0	0
18	45851540	.	G	A	0	5	5	0	7	12	0	0
18	45863426	.	T	A	1	2	3	0	0	3	0	0
18	45884464	.	T	C	1	3	4	0	0	4	0	0
18	45884473	.	C	T	1	3	4	0	0	4	0	0
18	45934646	.	G	A	0	1	1	0	2	3	0	0
18	45934691	.	G	T	1	2	3	0	1	4	0	0
18	45944546	.	C	T	2	2	4	0	1	5	0	0
18	45944903	.	G	T	0	3	3	0	0	3	0	0
18	45947835	.	C	T	2	3	5	0	0	5	0	0
18	45948213	.	G	A	5	3	8	0	0	8	0	0
18	45949157	.	G	T	1	2	3	0	0	3	0	0
18	45962500	.	A	G	9	10	19	0	0	19	0	0
18	45962581	.	T	C	9	10	19	0	0	19	0	0
18	45962593	.	G	C	11	10	21	0	0	21	0	0
18	45962668	.	C	T	16	21	37	0	2	39	0	0
18	45969252	.	C	A	5	2	7	0	0	7	0	0
18	45979887	.	C	T	6	6	12	0	1	13	0	0
18	45983268	.	A	C	23	17	40	0	3	43	0	0
18	46012631	.	C	T	2	1	3	0	1	4	0	0
18	46015830	.	G	A	1	0	1	0	0	1	0	0
18	46057023	.	G	T	1	4	5	0	0	5	0	0
18	46059425	.	A	C	2	1	3	0	0	3	0	0
18	46061242	.	G	A	5	4	9	0	0	9	0	0
18	46061326	.	C	A	11	3	14	0	0	14	0	0
18	46063648	.	C	T	5	5	10	0	0	10	0	0
18	46361861	.	C	G	4	8	12	0	2	14	0	0
18	46362772	.	G	T	12	9	21	0	5	26	0	0
18	46368300	.	C	T	0	4	4	0	5	9	0	0
18	46368771	.	C	T	0	6	6	0	3	9	0	0
18	46368924	.	C	A	2	4	6	0	0	6	0	0
18	46395965	.	G	C	21	16	37	0	3	40	0	0
18	46400979	.	A	G	2	1	3	0	1	4	0	0
18	46401137	.	T	C	3	2	5	0	1	6	0	0
18	46414299	.	C	T	0	4	4	0	2	6	0	0
18	46417624	.	T	C	14	6	20	0	2	22	0	0
18	46417681	.	G	T	6	7	13	0	0	13	0	0
18	46417775	.	T	C	13	0	13	0	9	22	0	0
18	46417807	.	A	G	16	12	28	0	1	29	0	0
18	46418281	.	T	C	9	1	10	0	7	17	0	0
18	46418458	.	C	T	0	5	5	0	12	17	0	0
18	46418497	.	G	A	10	7	17	0	0	17	0	0
18	46418521	.	C	T	11	7	18	0	0	18	0	0
18	46418776	.	C	T	0	7	7	0	7	14	0	0
18	46453240	.	C	T	0	3	3	0	1	4	0	0
18	46634497	.	A	G	2	5	7	0	0	7	0	0
18	46635257	.	G	A	1	6	7	0	0	7	0	0
18	46635390	.	G	C	2	5	7	0	0	7	0	0
18	46635876	.	G	A	5	4	9	0	1	10	0	0
18	46653253	.	T	G	5	4	9	0	0	9	0	0
18	46653284	.	A	G	9	7	16	0	0	16	0	0
18	46684230	.	A	T	4	6	10	0	0	10	0	0
18	46684258	.	G	T	3	4	7	0	0	7	0	0
18	46699773	.	G	A	27	23	50	0	0	50	0	0
18	46702492	.	G	A	22	22	44	0	1	45	0	0
18	46714896	.	A	G	6	8	14	0	1	15	0	0
18	46729044	.	A	G	7	9	16	0	1	17	0	0
18	46729321	.	A	G	4	4	8	0	1	9	0	0
18	46732406	.	C	G	3	2	5	0	0	5	0	0
18	46732417	.	T	A	3	1	4	0	0	4	0	0
18	46738796	.	T	G	1	1	2	0	11	13	0	0
18	46738862	.	C	A	0	14	14	0	5	19	0	0
18	46738955	.	A	C	17	10	27	0	1	28	0	0
18	46738990	.	A	T	17	7	24	0	2	26	0	0
18	47095659	.	G	A	2	2	4	0	0	4	0	0
18	47305388	.	T	A	1	4	5	0	0	5	0	0
18	47305433	.	A	G	1	2	3	0	0	3	0	0
18	47566919	.	A	T	3	1	4	0	0	4	0	0
18	47569514	.	T	A	1	2	3	0	0	3	0	0
18	48486342	.	C	T	1	2	3	0	0	3	0	0
18	48487073	.	T	A	3	3	6	0	0	6	0	0
18	48640143	.	G	C	0	5	5	0	3	8	0	0
18	48640155	.	G	C	0	5	5	0	3	8	0	0
18	48640323	.	G	A	0	4	4	0	4	8	0	0
18	48640348	.	A	G	3	0	3	0	6	9	0	0
18	48640417	.	G	T	4	6	10	0	0	10	0	0
18	48640687	.	T	C	1	2	3	0	0	3	0	0
18	48642742	.	C	A	4	3	7	0	0	7	0	0
18	48643030	.	C	A	6	5	11	0	0	11	0	0
18	48643334	.	T	C	2	2	4	0	0	4	0	0
18	48807521	.	T	C	1	3	4	0	0	4	0	0
18	48807623	.	C	T	2	3	5	0	0	5	0	0
18	48808043	.	A	G	2	2	4	0	1	5	0	0
18	48808099	.	A	G	1	6	7	0	0	7	0	0
18	48808185	.	C	T	2	2	4	0	0	4	0	0
18	48808659	.	G	A	0	3	3	0	2	5	0	0
18	48808708	.	T	A	4	3	7	0	0	7	0	0
18	48808985	.	T	A	1	5	6	0	0	6	0	0
18	48809189	.	G	A	11	9	20	0	0	20	0	0
18	48864453	.	C	A	4	8	12	0	0	12	0	0
18	48864702	.	T	C	4	2	6	0	0	6	0	0
18	48898641	.	C	T	0	1	1	0	0	1	0	0
18	48920871	.	A	G	4	0	4	0	8	12	0	0
18	48921166	.	C	G	13	4	17	0	2	19	0	0
18	48921175	.	A	C	9	4	13	0	2	15	0	0
18	48923068	.	C	T	1	2	3	0	0	3	0	0
18	48928342	.	A	G	16	1	17	0	14	31	0	0
18	48928387	.	T	A	11	14	25	0	0	25	0	0
18	48928552	.	C	T	12	13	25	0	0	25	0	0
18	48928843	.	C	T	6	22	28	0	1	29	0	0
18	48934524	.	T	C	7	7	14	0	1	15	0	0
18	48934593	.	T	C	1	6	7	0	0	7	0	0
18	48934805	.	A	G	6	13	19	0	3	22	0	0
18	48934833	.	T	C	11	15	26	0	2	28	0	0
18	48934951	.	A	G	16	0	16	0	11	27	0	0
18	48935279	.	T	G	20	20	40	0	2	42	0	0
18	48957768	.	C	T	1	1	2	0	0	2	0	0
18	48964731	.	A	G	1	1	2	0	0	2	0	0
18	48964734	.	C	T	1	1	2	0	0	2	0	0
18	48971165	.	T	C	1	4	5	0	0	5	0	0
18	48972490	.	A	T	8	6	14	0	0	14	0	0
18	49007191	.	A	G	1	3	4	0	0	4	0	0
18	49125038	.	C	G	4	4	8	0	0	8	0	0
18	49125315	.	C	T	4	5	9	0	1	10	0	0
18	49125347	.	G	A	3	4	7	0	0	7	0	0
18	49125760	.	T	A	0	2	2	0	1	3	0	0
18	49126363	.	A	C	7	6	13	0	0	13	0	0
18	49126732	.	G	A	2	3	5	0	0	5	0	0
18	49126745	.	A	G	2	4	6	0	0	6	0	0
18	49126845	.	C	G	5	3	8	0	0	8	0	0
18	49126958	.	C	T	9	4	13	0	0	13	0	0
18	49153651	.	T	C	10	5	15	0	1	16	0	0
18	49153710	.	A	C	1	4	5	0	1	6	0	0
18	49153735	.	G	A	0	3	3	0	4	7	0	0
18	49153900	.	C	T	12	10	22	0	2	24	0	0
18	49153977	.	G	C	0	9	9	0	6	15	0	0
18	49153984	.	G	T	0	9	9	0	6	15	0	0
18	49154079	.	A	G	8	3	11	0	1	12	0	0
18	49154106	.	T	G	9	0	9	0	7	16	0	0
18	49154130	.	A	G	9	8	17	0	0	17	0	0
18	49154243	.	T	C	10	4	14	0	0	14	0	0
18	49154251	.	C	T	9	4	13	0	1	14	0	0
18	49154328	.	G	A	6	11	17	0	0	17	0	0
18	49154458	.	G	T	8	14	22	0	0	22	0	0
18	49154483	.	G	T	0	17	17	0	6	23	0	0
18	49154525	.	C	T	8	22	30	0	1	31	0	0
18	49154527	.	T	C	8	20	28	0	3	31	0	0
18	49154722	.	A	G	11	12	23	0	0	23	0	0
18	49155045	.	A	G	5	0	5	0	11	16	0	0
18	49155190	.	C	G	13	6	19	0	0	19	0	0
18	49155211	.	C	A	6	10	16	0	0	16	0	0
18	49155278	.	G	T	4	2	6	0	0	6	0	0
18	49155303	.	G	A	0	4	4	0	1	5	0	0
18	49155491	.	T	C	10	3	13	0	2	15	0	0
18	49155941	.	C	T	10	10	20	0	1	21	0	0
18	49156370	.	A	G	2	3	5	0	0	5	0	0
18	49156437	.	T	A	0	6	6	0	0	6	0	0
18	49156444	.	G	A	3	4	7	0	0	7	0	0
18	49156481	.	T	C	6	5	11	0	0	11	0	0
18	49156567	.	T	C	8	10	18	0	1	19	0	0
18	49156773	.	G	T	10	6	16	0	0	16	0	0
18	49213627	.	C	T	1	2	3	0	0	3	0	0
18	49213639	.	G	C	1	2	3	0	0	3	0	0
18	49214198	.	T	C	1	2	3	0	0	3	0	0
18	49214231	.	G	A	1	3	4	0	0	4	0	0
18	49214441	.	C	T	3	2	5	0	0	5	0	0
18	49225608	.	T	C	3	2	5	0	0	5	0	0
18	49233301	.	G	T	2	2	4	0	0	4	0	0
18	49233304	.	A	G	2	0	2	0	2	4	0	0
18	49239450	.	T	A	2	2	4	0	0	4	0	0
18	49240072	.	T	C	0	1	1	0	0	1	0	0
18	49244821	.	C	A	10	3	13	0	0	13	0	0
18	49246672	.	T	A	5	4	9	0	0	9	0	0
18	49248524	.	G	T	3	6	9	0	1	10	0	0
18	49261736	.	C	T	1	1	2	0	0	2	0	0
18	49265220	.	G	C	0	6	6	0	4	10	0	0
18	49266575	.	G	A	4	12	16	0	2	18	0	0
18	49266589	.	A	G	10	8	18	0	2	20	0	0
18	49266798	.	C	A	4	2	6	0	0	6	0	0
18	49266998	.	A	G	4	7	11	0	0	11	0	0
18	49267041	.	G	A	12	5	17	0	0	17	0	0
18	49267115	.	A	G	5	0	5	0	11	16	0	0
18	49267322	.	A	G	2	3	5	0	2	7	0	0
18	49267334	.	A	G	3	1	4	0	1	5	0	0
18	49267701	.	A	T	5	4	9	0	2	11	0	0
18	49267832	.	A	G	2	3	5	0	0	5	0	0
18	49274639	.	T	G	0	1	1	0	1	2	0	0
18	49274688	.	A	T	1	2	3	0	0	3	0	0
18	49412259	.	T	C	2	3	5	0	0	5	0	0
18	49412514	.	T	C	1	6	7	0	0	7	0	0
18	49428280	.	G	A	2	3	5	0	0	5	0	0
18	49428793	.	T	C	6	6	12	0	1	13	0	0
18	49446185	.	A	T	5	2	7	0	0	7	0	0
18	49446190	.	G	T	1	6	7	0	0	7	0	0
18	49446254	.	T	G	3	6	9	0	0	9	0	0
18	49446293	.	C	G	2	4	6	0	0	6	0	0
18	49446312	.	G	A	4	5	9	0	0	9	0	0
18	49446398	.	G	A	5	2	7	0	1	8	0	0
18	49446719	.	A	G	3	0	3	0	2	5	0	0
18	49446796	.	C	A	2	5	7	0	0	7	0	0
18	49446803	.	T	A	2	4	6	0	0	6	0	0
18	49447008	.	C	A	5	9	14	0	0	14	0	0
18	49447041	.	G	A	0	7	7	0	7	14	0	0
18	50028566	.	C	T	1	1	2	0	1	3	0	0
18	50037401	.	C	T	9	4	13	0	3	16	0	0
18	50038534	.	C	A	2	3	5	0	0	5	0	0
18	50039852	.	G	T	8	9	17	0	0	17	0	0
18	50039939	.	C	T	4	6	10	0	0	10	0	0
18	50040021	.	G	T	0	2	2	0	0	2	0	0
18	50093398	.	C	A	3	3	6	0	0	6	0	0
18	50099441	.	A	G	3	2	5	0	0	5	0	0
18	50099487	.	A	G	3	3	6	0	0	6	0	0
18	50124802	.	G	A	10	6	16	0	0	16	0	0
18	50124803	.	T	A	8	6	14	0	2	16	0	0
18	50124843	.	A	T	4	3	7	0	1	9	1	0
18	50124847	.	T	C	5	3	8	0	0	8	0	0
18	50125048	.	G	T	2	3	5	0	0	5	0	0
18	50125099	.	T	G	2	5	7	0	0	7	0	0
18	50126036	.	T	A	2	3	5	0	0	5	0	0
18	50126875	.	T	A	1	2	3	0	0	3	0	0
18	50127479	.	T	C	1	2	3	0	0	3	0	0
18	50127483	.	T	C	1	2	3	0	0	3	0	0
18	50128902	.	G	A	0	2	2	0	0	2	0	0
18	50276476	.	C	G	3	4	7	0	1	8	0	0
18	50276681	.	T	G	5	3	8	0	2	10	0	0
18	50279044	.	T	C	14	23	37	0	1	38	0	0
18	50279182	.	G	A	0	21	21	0	13	34	0	0
18	50353568	.	A	C	19	24	43	0	1	44	0	0
18	50353598	.	C	T	21	26	47	0	1	48	0	0
18	50356632	.	T	C	20	21	41	0	3	44	0	0
18	50443786	.	T	C	2	2	4	0	0	4	0	0
18	50443787	.	G	T	2	2	4	0	0	4	0	0
18	50443851	.	G	A	2	2	4	0	0	4	0	0
18	50538289	.	T	C	11	10	21	0	1	22	0	0
18	50538340	.	T	C	6	9	15	0	2	17	0	0
18	50538442	.	T	C	5	5	10	0	0	10	0	0
18	50538449	.	T	C	7	0	7	0	4	11	0	0
18	50538598	.	T	C	4	2	6	0	0	6	0	0
18	50689577	.	T	C	0	4	4	0	0	4	0	0
18	50689583	.	G	A	5	0	5	0	0	5	0	0
18	50708755	.	T	A	0	4	4	0	0	4	0	0
18	50709147	.	C	A	3	0	3	0	19	22	0	0
18	50783657	.	A	G	1	0	1	0	3	4	0	0
18	50911943	.	C	G	8	0	8	0	0	8	0	0
18	50911951	.	T	C	0	7	7	0	0	7	0	0
19	372768	.	A	G	12	1	13	0	9	22	0	0
19	433149	.	A	G	3	2	5	0	0	5	0	0
19	1330743	.	T	A	4	2	6	0	0	6	0	0
19	1330780	.	C	G	6	3	9	0	0	9	0	0
19	1331012	.	A	C	6	5	11	0	0	11	0	0
19	1331172	.	T	C	8	4	12	0	0	12	0	0
19	1331296	.	C	T	0	5	5	0	6	11	0	0
19	1331344	.	C	A	3	7	10	0	1	11	0	0
19	1331394	.	T	G	6	7	13	0	1	14	0	0
19	1331443	.	T	C	3	0	3	0	0	3	0	0
19	1331446	.	C	T	3	0	3	0	0	3	0	0
19	1363614	.	T	A	1	2	3	0	0	3	0	0
19	1370714	.	A	G	7	5	12	0	0	12	0	0
19	1370725	.	A	C	5	4	9	0	1	10	0	0
19	1382119	.	T	C	1	0	1	0	0	1	0	0
19	1384408	.	A	T	0	3	3	0	0	3	0	0
19	1385881	.	A	G	0	1	1	0	0	1	0	0
19	1389886	.	C	T	0	1	1	0	0	1	0	0
19	1392177	.	A	C	8	12	20	0	0	20	0	0
19	1392178	.	C	T	8	12	20	0	0	20	0	0
19	1392544	.	T	A	7	6	13	0	2	15	0	0
19	1392565	.	A	G	5	12	17	0	2	19	0	0
19	1392579	.	T	G	7	14	21	0	0	21	0	0
19	1392657	.	T	C	9	5	14	0	1	15	0	0
19	1392713	.	A	G	9	6	15	0	0	15	0	0
19	1392718	.	A	T	10	6	16	0	1	17	0	0
19	1392800	.	G	A	3	3	6	1	0	7	0	0
19	1392969	.	T	C	4	4	8	0	0	8	0	0
19	1393029	.	A	G	8	8	16	0	0	16	0	0
19	1393212	.	A	G	8	0	8	0	5	13	0	0
19	1406549	.	A	C	2	3	5	0	2	7	0	0
19	1406593	.	T	G	1	2	3	0	0	3	0	0
19	1406694	.	G	T	4	3	7	0	0	7	0	0
19	1406751	.	C	T	2	7	9	0	1	10	0	0
19	1406760	.	A	T	4	5	9	0	1	10	0	0
19	1406795	.	A	C	5	6	11	0	0	11	0	0
19	1406895	.	T	G	4	2	6	0	0	6	0	0
19	1407396	.	A	G	1	5	6	0	1	7	0	0
19	1407795	.	A	G	6	4	10	0	0	10	0	0
19	1410794	.	C	A	1	2	3	0	1	4	0	0
19	1410896	.	A	G	3	3	6	0	1	7	0	0
19	1411107	.	T	C	1	2	3	0	0	3	0	0
19	1411160	.	G	T	1	2	3	0	0	3	0	0
19	1685639	.	C	T	1	2	3	0	0	3	0	0
19	1735595	.	A	T	1	2	3	0	0	3	0	0
19	1737060	.	T	C	4	3	7	0	0	7	0	0
19	1848021	.	T	C	3	3	6	0	0	6	0	0
19	1848143	.	C	G	1	5	6	0	0	6	0	0
19	1848249	.	T	G	4	9	13	0	0	13	0	0
19	1848298	.	A	G	3	5	8	0	0	8	0	0
19	1848301	.	G	A	0	5	5	0	3	8	0	0
19	1848334	.	T	C	4	5	9	0	0	9	0	0
19	1852303	.	T	C	6	16	22	0	1	23	0	0
19	1853802	.	A	G	3	2	5	0	0	5	0	0
19	1853826	.	T	C	3	5	8	0	0	8	0	0
19	1855354	.	A	G	1	3	4	0	1	5	0	0
19	1856335	.	G	A	3	2	5	0	0	5	0	0
19	1856338	.	A	C	3	2	5	0	0	5	0	0
19	1856458	.	T	G	7	6	13	0	0	13	0	0
19	1856716	.	A	T	4	2	6	0	0	6	0	0
19	1861691	.	A	G	1	3	4	0	0	4	0	0
19	1868327	.	A	G	3	4	7	0	0	7	0	0
19	1868460	.	C	T	0	1	1	0	2	3	0	0
19	1870977	.	T	C	2	0	2	0	3	5	0	0
19	1871178	.	A	G	7	3	10	0	0	10	0	0
19	1871181	.	G	A	7	4	11	0	0	11	0	0
19	1871355	.	T	C	2	2	4	0	1	5	0	0
19	1877255	.	A	G	17	0	17	0	10	27	0	0
19	1877288	.	T	C	14	13	27	0	1	28	0	0
19	1877662	.	C	G	4	4	8	0	1	9	0	0
19	1879854	.	C	T	3	1	4	0	0	4	0	0
19	1879923	.	G	C	1	2	3	0	0	3	0	0
19	1880595	.	C	G	2	2	4	0	0	4	0	0
19	1934745	.	A	G	1	2	3	0	0	3	0	0
19	1953543	.	A	T	20	15	35	0	2	38	1	0
19	1953569	.	A	G	28	12	40	0	0	40	0	0
19	1953742	.	C	T	13	12	25	0	0	25	0	0
19	1960997	.	T	C	10	16	26	0	1	27	0	0
19	1964016	.	G	A	0	1	1	0	5	6	0	0
19	1992998	.	C	G	4	3	7	0	0	7	0	0
19	1993796	.	A	G	1	0	1	0	0	1	0	0
19	1995133	.	A	T	3	2	5	0	1	6	0	0
19	1995229	.	G	A	0	5	5	0	5	10	0	0
19	1995343	.	C	T	2	6	8	0	0	8	0	0
19	1995367	.	A	G	2	0	2	0	5	7	0	0
19	1995404	.	G	A	2	4	6	0	1	7	0	0
19	1995425	.	A	G	3	2	5	0	1	6	0	0
19	1995499	.	G	T	4	11	15	0	3	18	0	0
19	1995982	.	G	C	5	5	10	0	0	10	0	0
19	1996019	.	T	C	5	6	11	0	0	11	0	0
19	1996098	.	C	T	1	3	4	0	0	4	0	0
19	1996323	.	T	A	2	2	4	0	2	6	0	0
19	1996366	.	A	G	5	5	10	0	0	10	0	0
19	1996409	.	T	A	4	4	8	0	1	9	0	0
19	1996445	.	G	A	0	3	3	0	2	5	0	0
19	1996577	.	C	T	2	2	4	0	1	5	0	0
19	1996639	.	T	G	1	3	4	0	0	4	0	0
19	1996656	.	G	A	1	3	4	0	0	4	0	0
19	1996685	.	T	A	2	2	4	0	1	5	0	0
19	1996695	.	T	C	2	2	4	0	0	4	0	0
19	1996725	.	A	T	3	3	6	0	1	7	0	0
19	1996755	.	C	T	2	2	4	0	0	4	0	0
19	1996776	.	G	A	3	2	5	0	1	6	0	0
19	1996934	.	T	G	5	0	5	0	0	5	0	0
19	1997066	.	C	T	4	2	6	0	0	6	0	0
19	1997074	.	T	G	4	2	6	0	0	6	0	0
19	1997447	.	A	G	1	2	3	0	0	3	0	0
19	1997658	.	A	T	3	4	7	0	0	7	0	0
19	1997676	.	T	C	4	4	8	0	0	8	0	0
19	1997781	.	A	T	3	5	8	0	0	8	0	0
19	1997849	.	T	A	7	3	10	0	0	10	0	0
19	1998153	.	C	A	4	7	11	0	0	11	0	0
19	1998160	.	A	T	5	7	12	0	0	12	0	0
19	2001557	.	T	C	1	1	2	0	0	2	0	0
19	2001572	.	C	T	2	3	5	0	0	5	0	0
19	2001618	.	A	C	3	2	5	0	1	6	0	0
19	2002992	.	A	G	2	0	2	0	2	4	0	0
19	2003767	.	C	T	10	4	14	0	0	14	0	0
19	2003962	.	G	T	1	9	10	0	7	17	0	0
19	2019480	.	C	T	0	3	3	0	5	8	0	0
19	2028069	.	A	G	2	3	5	0	0	5	0	0
19	2064762	.	G	C	1	3	4	0	0	4	0	0
19	2074361	.	G	A	0	2	2	0	0	2	0	0
19	2279086	.	T	G	0	0	0	0	1	1	0	0
19	2279284	.	C	T	3	0	3	0	0	3	0	0
19	2289519	.	G	A	0	4	4	0	0	4	0	0
19	2307248	.	C	A	10	9	19	0	0	19	0	0
19	2307268	.	C	T	7	7	14	0	0	14	0	0
19	2315511	.	C	T	0	5	5	0	5	10	0	0
19	2315721	.	A	G	2	3	5	0	0	5	0	0
19	2316215	.	G	A	1	4	5	0	0	5	0	0
19	2316354	.	A	T	3	3	6	0	0	6	0	0
19	2316510	.	T	C	5	4	9	0	0	9	0	0
19	2316894	.	T	C	2	4	6	0	2	8	0	0
19	2317089	.	A	G	1	6	7	0	0	7	0	0
19	2317263	.	G	C	2	0	2	0	2	4	0	0
19	2395806	.	A	G	3	2	5	0	0	5	0	0
19	2395817	.	C	G	1	3	4	0	0	4	0	0
19	2396022	.	C	T	2	3	5	0	0	5	0	0
19	2396037	.	G	A	1	3	4	0	2	6	0	0
19	2396273	.	T	A	3	4	7	0	0	7	0	0
19	2396421	.	T	C	1	0	1	0	4	5	0	0
19	2396643	.	G	A	5	3	8	0	0	8	0	0
19	2396647	.	C	T	3	5	8	0	0	8	0	0
19	2397161	.	A	C	1	2	3	0	0	3	0	0
19	2397408	.	G	A	4	2	6	0	0	6	0	0
19	2402609	.	T	A	1	5	6	0	0	6	0	0
19	2402611	.	T	A	1	4	5	0	1	6	0	0
19	2403906	.	T	C	2	0	2	0	3	5	0	0
19	2546847	.	C	A	1	2	3	0	0	3	0	0
19	2546871	.	T	A	2	2	4	0	0	4	0	0
19	2547191	.	T	G	2	3	5	0	0	5	0	0
19	2547637	.	C	A	0	1	1	0	0	1	0	0
19	2550676	.	G	A	2	3	5	0	1	6	0	0
19	2550839	.	C	T	4	7	11	0	1	12	0	0
19	2551178	.	A	G	6	7	13	0	0	13	0	0
19	2551214	.	C	T	10	5	15	0	0	15	0	0
19	2551727	.	C	T	5	4	9	0	0	9	0	0
19	2557750	.	A	G	0	2	2	0	0	2	0	0
19	2560883	.	T	G	2	3	5	0	0	5	0	0
19	2560950	.	A	G	5	8	13	0	0	13	0	0
19	2561583	.	A	T	6	6	12	0	0	12	0	0
19	2561596	.	T	A	6	7	13	0	2	15	0	0
19	2561637	.	G	T	0	12	12	1	11	24	0	0
19	2561739	.	G	A	1	7	8	0	13	21	0	0
19	2561811	.	A	G	3	16	19	0	2	21	0	0
19	2561833	.	A	G	11	10	21	0	1	22	0	0
19	2561857	.	T	G	8	7	15	0	1	16	0	0
19	2562472	.	A	G	2	8	10	0	1	11	0	0
19	2871511	.	A	G	8	5	13	0	0	13	0	0
19	2871553	.	C	T	3	4	7	0	0	7	0	0
19	2872162	.	G	A	6	3	9	0	0	9	0	0
19	2877359	.	C	T	1	5	6	0	0	6	0	0
19	2877371	.	C	T	1	6	7	0	0	7	0	0
19	2877563	.	C	T	3	4	7	0	0	7	0	0
19	2877569	.	G	C	4	4	8	0	0	8	0	0
19	2880160	.	C	T	0	3	3	0	0	3	0	0
19	2882754	.	A	C	2	0	2	0	0	2	0	0
19	2887046	.	G	C	0	3	3	0	2	5	0	0
19	2934321	.	A	G	2	2	4	0	0	4	0	0
19	2960590	.	G	A	0	1	1	0	1	2	0	0
19	2960599	.	T	C	0	0	0	0	2	2	0	0
19	3052828	.	A	G	0	1	1	0	0	1	0	0
19	3052836	.	A	T	0	1	1	0	0	1	0	0
19	3052970	.	A	G	2	2	4	0	1	5	0	0
19	3056629	.	C	T	9	3	12	0	0	12	0	0
19	3080712	.	T	A	3	5	8	0	0	8	0	0
19	3080863	.	A	T	6	4	10	0	0	10	0	0
19	3080907	.	A	T	5	4	9	0	0	9	0	0
19	3081037	.	A	G	3	7	10	0	1	11	0	0
19	3081096	.	A	T	3	2	5	0	0	5	0	0
19	3081154	.	G	C	2	2	4	0	0	4	0	0
19	3081206	.	G	T	1	4	5	0	0	5	0	0
19	3081394	.	A	G	3	7	10	0	0	10	0	0
19	3081554	.	A	G	3	0	3	0	1	4	0	0
19	3081628	.	T	C	0	2	2	2	0	4	0	0
19	3081927	.	G	A	11	2	13	0	0	13	0	0
19	3081933	.	G	A	0	4	4	0	11	15	0	0
19	3082102	.	C	T	7	6	13	0	0	13	0	0
19	3082204	.	A	G	9	2	11	0	1	12	0	0
19	3082220	.	A	G	6	2	8	0	1	9	0	0
19	3087180	.	C	A	1	2	3	0	0	3	0	0
19	3087196	.	T	C	0	2	2	0	1	3	0	0
19	3137727	.	C	T	1	31	32	0	20	52	0	0
19	3137761	.	C	A	18	24	42	0	0	45	3	0
19	3137803	.	A	T	21	21	42	0	4	46	0	0
19	3137888	.	T	C	20	0	20	0	22	42	0	0
19	3138166	.	G	T	10	5	15	0	0	15	0	0
19	3138325	.	A	C	16	10	26	0	0	26	0	0
19	3138355	.	T	G	16	12	28	0	1	29	0	0
19	3138638	.	T	C	8	0	8	0	7	15	0	0
19	3149296	.	A	C	1	5	6	0	0	6	0	0
19	3149320	.	T	G	2	4	6	0	0	6	0	0
19	3386141	.	C	T	1	2	3	0	0	3	0	0
19	3866165	.	T	C	11	12	23	0	0	23	0	0
19	4010146	.	A	G	9	9	18	0	1	19	0	0
19	4010175	.	C	A	11	12	23	0	1	24	0	0
19	4828379	.	T	G	1	3	4	0	0	4	0	0
19	4828395	.	T	C	1	2	3	0	0	3	0	0
19	4828428	.	A	T	3	3	6	0	0	6	0	0
19	4856678	.	A	G	4	6	10	0	1	11	0	0
19	4856691	.	G	A	3	6	9	0	0	9	0	0
19	4856825	.	C	A	1	6	7	0	2	9	0	0
19	4856852	.	A	T	2	5	7	0	0	7	0	0
19	4857526	.	C	T	7	6	13	0	0	13	0	0
19	4857746	.	G	A	5	2	7	0	0	7	0	0
19	4857802	.	C	T	3	2	5	0	0	5	0	0
19	4857967	.	T	C	8	4	12	0	0	12	0	0
19	4858000	.	C	T	7	6	13	0	0	13	0	0
19	4866919	.	T	C	17	8	25	0	1	26	0	0
19	4866936	.	C	T	17	7	24	0	0	24	0	0
19	4866986	.	A	G	8	3	11	0	2	13	0	0
19	4867168	.	G	C	18	14	32	0	1	34	1	0
19	4867232	.	C	A	7	7	14	0	1	15	0	0
19	4867274	.	G	A	0	7	7	0	10	17	0	0
19	4875529	.	C	T	5	5	10	0	1	11	0	0
19	4875583	.	A	G	3	3	6	0	0	6	0	0
19	4875595	.	A	G	3	2	5	0	0	5	0	0
19	4877141	.	T	C	4	6	10	0	0	10	0	0
19	4881414	.	T	C	4	7	11	0	0	11	0	0
19	4885398	.	A	G	1	0	1	0	0	1	0	0
19	4885431	.	A	G	1	0	1	0	0	1	0	0
19	4892292	.	A	C	5	4	9	0	14	23	0	0
19	4904193	.	A	G	5	2	7	0	4	11	0	0
19	5058188	.	C	T	0	3	3	0	3	6	0	0
19	5077114	.	C	T	2	1	3	0	0	3	0	0
19	5077173	.	C	T	13	6	19	0	1	20	0	0
19	5077356	.	C	T	1	0	1	0	0	1	0	0
19	5081796	.	C	T	28	11	39	0	0	39	0	0
19	5082161	.	C	T	13	19	32	0	4	36	0	0
19	5089755	.	C	G	7	13	20	0	2	22	0	0
19	5090070	.	A	T	26	31	57	0	2	59	0	0
19	5090071	.	G	T	25	31	56	0	3	59	0	0
19	5090368	.	T	C	27	27	54	0	1	55	0	0
19	5090583	.	C	T	11	10	21	0	0	21	0	0
19	5091483	.	T	C	37	25	62	0	3	65	0	0
19	5091503	.	C	T	36	23	59	0	3	62	0	0
19	5094288	.	G	T	7	7	14	0	0	14	0	0
19	5094417	.	A	T	8	15	23	0	0	23	0	0
19	5094504	.	A	G	6	12	18	0	3	21	0	0
19	5094564	.	T	A	10	10	20	0	2	22	0	0
19	5094591	.	C	T	14	10	24	0	1	25	0	0
19	5100191	.	G	A	12	8	20	0	0	20	0	0
19	5100240	.	G	A	2	3	5	0	0	5	0	0
19	5100249	.	C	T	2	3	5	0	0	5	0	0
19	5100458	.	G	A	3	4	7	0	0	7	0	0
19	5100665	.	C	T	11	4	15	0	0	15	0	0
19	5103213	.	A	G	3	3	6	0	0	6	0	0
19	5103228	.	T	C	2	0	2	0	2	4	0	0
19	5135247	.	T	G	7	5	12	0	0	12	0	0
19	5135258	.	C	G	6	5	11	0	1	12	0	0
19	5143975	.	A	T	6	3	9	0	0	9	0	0
19	5144395	.	T	C	5	5	10	0	0	10	0	0
19	5146708	.	C	T	8	7	15	0	1	16	0	0
19	5149133	.	T	C	14	21	35	0	0	35	0	0
19	5149867	.	C	T	8	13	21	0	1	22	0	0
19	5158572	.	G	A	34	31	65	0	6	71	0	0
19	5159083	.	A	T	28	30	58	0	1	59	0	0
19	5159157	.	C	A	20	49	69	0	5	74	0	0
19	5159425	.	C	T	29	28	57	0	3	60	0	0
19	5159534	.	G	A	20	22	42	1	6	49	0	0
19	5160048	.	C	G	32	21	53	0	6	59	0	0
19	5160121	.	T	C	33	1	34	0	25	59	0	0
19	5160201	.	A	G	23	31	54	0	2	56	0	0
19	5161750	.	A	G	20	20	40	0	1	41	0	0
19	5161782	.	C	T	20	21	41	0	2	43	0	0
19	5162252	.	A	T	29	30	59	0	2	61	0	0
19	5162253	.	T	C	29	0	29	0	32	61	0	0
19	5162300	.	T	G	28	25	53	0	2	55	0	0
19	5162544	.	A	G	12	29	41	0	0	41	0	0
19	5162685	.	T	A	21	27	48	0	0	48	0	0
19	5162827	.	C	T	19	16	35	0	2	37	0	0
19	5162839	.	T	C	17	0	17	0	22	39	0	0
19	5162923	.	C	T	18	10	28	0	1	29	0	0
19	5162960	.	A	T	13	14	27	0	4	31	0	0
19	5163031	.	C	T	19	19	38	0	1	39	0	0
19	5163127	.	A	T	20	26	46	0	0	46	0	0
19	5163434	.	A	G	20	33	53	0	2	55	0	0
19	5163635	.	C	T	25	15	40	0	2	47	5	0
19	5254510	.	A	G	28	15	43	0	2	45	0	0
19	5300042	.	A	G	1	3	4	0	1	5	0	0
19	5300120	.	T	C	5	6	11	0	0	11	0	0
19	5305418	.	A	G	4	4	8	0	2	10	0	0
19	5305870	.	G	C	2	4	6	0	0	7	1	0
19	5316279	.	T	A	2	2	4	0	0	4	0	0
19	5316439	.	T	C	4	5	9	0	0	9	0	0
19	5318355	.	G	A	0	5	5	0	5	10	0	0
19	5318356	.	T	A	4	5	9	0	1	10	0	0
19	5318806	.	A	C	5	7	12	0	1	13	0	0
19	5318979	.	G	A	6	10	16	0	4	20	0	0
19	5319096	.	C	G	8	10	18	0	2	20	0	0
19	5320139	.	G	A	5	6	11	0	2	13	0	0
19	5320234	.	T	C	3	6	9	0	0	9	0	0
19	5378640	.	G	A	7	4	11	0	0	11	0	0
19	5378808	.	T	A	3	5	8	0	0	8	0	0
19	5379587	.	T	C	1	6	7	0	0	7	0	0
19	5379727	.	C	T	1	0	1	0	0	1	0	0
19	5380014	.	G	T	2	0	2	0	0	2	0	0
19	5380530	.	G	A	2	3	5	0	0	5	0	0
19	5418116	.	T	A	20	13	33	0	0	33	0	0
19	5421086	.	T	A	30	28	58	0	4	62	0	0
19	5421277	.	T	G	24	4	28	0	32	60	0	0
19	5480485	.	T	C	1	7	8	0	1	9	0	0
19	5552442	.	G	A	1	4	5	0	0	5	0	0
19	5552550	.	C	T	6	9	15	0	0	15	0	0
19	5569981	.	C	T	1	2	3	0	0	3	0	0
19	5582376	.	A	G	8	9	17	0	1	18	0	0
19	5582418	.	T	C	5	5	10	0	1	11	0	0
19	5587716	.	C	T	4	7	11	0	0	11	0	0
19	5608628	.	C	G	3	9	12	0	0	12	0	0
19	5610860	.	T	A	6	7	13	0	0	13	0	0
19	5611439	.	G	A	1	18	19	0	20	39	0	0
19	5611586	.	T	C	23	15	38	0	0	38	0	0
19	5615570	.	C	A	4	0	4	0	1	5	0	0
19	5617832	.	T	C	3	11	14	0	1	15	0	0
19	5619685	.	G	A	0	7	7	0	6	13	0	0
19	5619735	.	G	A	20	22	42	0	0	42	0	0
19	5619931	.	A	G	13	6	19	0	1	20	0	0
19	5620011	.	G	A	0	9	9	0	7	16	0	0
19	5620380	.	G	A	8	17	25	0	1	26	0	0
19	5620498	.	T	A	15	12	27	0	0	27	0	0
19	5620525	.	C	T	18	12	30	0	1	31	0	0
19	5620631	.	C	T	17	6	23	0	0	23	0	0
19	5620772	.	G	A	12	18	30	0	0	30	0	0
19	5620810	.	T	C	13	16	29	0	0	29	0	0
19	5621124	.	G	T	25	13	38	0	1	39	0	0
19	5686916	.	C	T	2	2	4	0	0	4	0	0
19	5687067	.	A	T	2	2	4	0	0	4	0	0
19	5779170	.	C	T	2	2	4	0	0	4	0	0
19	5779601	.	T	C	18	8	26	0	2	28	0	0
19	5779897	.	T	C	15	11	26	0	1	27	0	0
19	5779946	.	G	C	9	6	15	0	0	15	0	0
19	5780032	.	C	G	0	6	6	0	7	13	0	0
19	5780301	.	T	A	1	8	9	0	0	9	0	0
19	5780342	.	A	C	5	0	5	0	7	12	0	0
19	5780418	.	C	T	6	5	11	0	1	12	0	0
19	5780989	.	G	A	3	9	12	0	0	12	0	0
19	5781316	.	G	T	5	4	9	0	0	9	0	0
19	5781367	.	T	C	4	3	7	0	0	7	0	0
19	5793484	.	C	G	1	2	3	0	0	3	0	0
19	5793532	.	T	C	1	2	3	0	0	3	0	0
19	5805773	.	T	G	2	0	2	0	1	3	0	0
19	5805833	.	G	A	5	4	9	0	0	9	0	0
19	5805839	.	G	A	6	3	9	0	1	10	0	0
19	5805869	.	A	G	2	4	6	0	0	6	0	0
19	6060309	.	A	T	11	10	21	0	3	24	0	0
19	6073362	.	T	C	3	1	4	0	1	5	0	0
19	6085987	.	A	G	3	8	11	0	0	11	0	0
19	6086441	.	C	G	15	10	25	0	2	27	0	0
19	6086577	.	C	T	0	20	20	0	13	33	0	0
19	6087130	.	T	A	5	10	15	0	1	16	0	0
19	6087146	.	C	T	0	12	12	0	4	16	0	0
19	6087186	.	A	T	11	13	24	0	0	24	0	0
19	6087619	.	T	C	5	0	5	0	10	15	0	0
19	6087656	.	C	T	1	2	3	0	0	3	0	0
19	6087894	.	G	A	12	11	23	0	0	23	0	0
19	6087948	.	A	T	5	7	12	0	0	12	0	0
19	6088000	.	C	T	0	12	12	0	17	29	0	0
19	6088166	.	T	C	11	12	23	0	0	23	0	0
19	6088259	.	A	C	6	16	22	0	1	23	0	0
19	6088419	.	A	T	5	6	11	0	0	11	0	0
19	6090702	.	T	C	4	7	11	0	1	12	0	0
19	6090732	.	T	A	1	3	4	0	0	4	0	0
19	6097416	.	A	G	16	8	24	0	1	25	0	0
19	6099984	.	G	A	5	7	12	0	0	12	0	0
19	6099992	.	G	A	5	7	12	0	1	13	0	0
19	6100027	.	G	A	7	9	16	0	1	17	0	0
19	6100037	.	C	T	8	9	17	0	1	18	0	0
19	6100073	.	T	G	10	11	21	0	3	24	0	0
19	6100139	.	G	C	11	0	11	0	15	26	0	0
19	6100198	.	C	A	7	4	11	0	1	12	0	0
19	6104838	.	C	T	0	9	9	0	7	16	0	0
19	6111085	.	G	A	7	3	10	0	1	11	0	0
19	6111088	.	G	A	11	2	13	0	0	13	0	0
19	6111214	.	A	G	12	11	23	0	2	25	0	0
19	6111223	.	A	G	11	11	22	0	2	24	0	0
19	6111268	.	G	A	8	10	18	0	0	18	0	0
19	6111366	.	C	T	0	7	7	0	10	17	0	0
19	6111460	.	C	G	7	8	15	0	0	15	0	0
19	6111496	.	G	A	7	8	15	0	1	16	0	0
19	6111730	.	C	A	4	3	7	0	0	7	0	0
19	6111793	.	G	A	1	3	4	0	0	4	0	0
19	6116638	.	A	G	1	1	2	0	0	2	0	0
19	6125926	.	G	A	4	9	13	0	0	13	0	0
19	6125941	.	C	T	4	10	14	0	0	14	0	0
19	6126001	.	G	A	3	8	11	0	3	14	0	0
19	6126046	.	A	T	1	9	10	0	5	15	0	0
19	6126277	.	G	A	5	7	12	0	0	12	0	0
19	6126403	.	C	G	3	6	9	0	0	9	0	0
19	6126544	.	A	G	4	2	6	0	0	6	0	0
19	6126645	.	T	C	2	3	5	0	1	6	0	0
19	6127696	.	T	C	3	3	6	0	0	6	0	0
19	6127764	.	A	G	5	4	9	0	0	9	0	0
19	6127768	.	A	G	5	3	8	0	0	8	0	0
19	6142187	.	C	A	0	5	5	0	7	12	0	0
19	6142433	.	T	A	5	3	8	0	4	12	0	0
19	6142714	.	A	T	9	11	20	0	0	20	0	0
19	6142803	.	A	G	6	3	9	0	0	9	0	0
19	6142951	.	A	G	2	4	6	0	0	6	0	0
19	6142970	.	C	T	3	3	6	0	0	6	0	0
19	6143373	.	T	C	5	4	9	0	0	9	0	0
19	6143583	.	C	G	10	4	14	0	0	14	0	0
19	6143610	.	T	A	7	8	15	0	0	15	0	0
19	6143919	.	T	C	3	5	8	0	0	8	0	0
19	6144101	.	T	A	1	2	3	0	0	3	0	0
19	6144342	.	A	G	2	5	7	0	0	7	0	0
19	6144722	.	C	T	5	2	7	0	0	7	0	0
19	6144822	.	C	G	4	3	7	0	1	8	0	0
19	6145568	.	T	C	5	0	5	0	4	9	0	0
19	6145610	.	A	G	4	6	10	0	1	11	0	0
19	6214772	.	G	A	8	3	11	0	1	12	0	0
19	6214835	.	G	T	4	6	10	0	1	11	0	0
19	6216392	.	A	G	3	2	5	0	1	6	0	0
19	6216471	.	A	C	2	3	5	0	0	5	0	0
19	6216606	.	G	A	2	7	9	0	0	9	0	0
19	6217133	.	T	A	5	4	9	0	0	9	0	0
19	6328442	.	T	C	36	9	45	0	43	88	0	0
19	6328514	.	A	C	39	40	79	0	4	84	1	0
19	6329154	.	C	T	3	28	31	0	33	64	0	0
19	6329236	.	A	G	24	13	37	0	2	39	0	0
19	6329237	.	G	A	26	12	38	0	1	39	0	0
19	6329301	.	A	C	24	37	61	0	3	64	0	0
19	6329329	.	G	A	32	34	66	0	2	68	0	0
19	6329533	.	C	T	5	29	34	0	36	70	0	0
19	6329660	.	C	T	5	15	20	0	49	74	5	0
19	6330050	.	T	C	28	31	59	0	7	66	0	0
19	6332902	.	C	A	0	13	13	0	8	21	0	0
19	6333448	.	G	A	31	17	48	0	6	54	0	0
19	6338207	.	A	G	6	4	10	0	2	12	0	0
19	6338261	.	A	G	22	16	38	0	0	38	0	0
19	6339131	.	A	G	7	9	16	0	1	17	0	0
19	6341941	.	A	G	6	4	10	0	0	10	0	0
19	6342076	.	C	G	4	8	12	0	0	12	0	0
19	6344573	.	G	T	26	30	56	0	0	56	0	0
19	6344621	.	C	T	18	33	51	0	3	54	0	0
19	6346506	.	C	G	24	26	50	0	2	52	0	0
19	6346587	.	C	T	0	17	17	0	29	46	0	0
19	6352379	.	A	G	6	8	14	0	5	19	0	0
19	6358232	.	A	G	9	3	12	0	0	12	0	0
19	6358244	.	C	A	6	0	6	0	0	6	0	0
19	6362636	.	A	G	1	4	5	0	1	6	0	0
19	6362804	.	T	A	4	9	13	0	0	13	0	0
19	6606673	.	T	A	2	3	5	0	0	5	0	0
19	6606725	.	T	C	3	3	6	0	0	6	0	0
19	6606764	.	A	T	0	1	1	0	0	1	0	0
19	6612432	.	T	C	1	1	2	0	0	2	0	0
19	6872539	.	T	C	2	7	9	0	1	10	0	0
19	6872595	.	C	T	1	4	5	0	0	5	0	0
19	6892939	.	C	T	2	1	3	0	0	3	0	0
19	6892963	.	C	T	3	3	6	0	0	6	0	0
19	6893008	.	A	G	3	2	5	0	0	5	0	0
19	6900897	.	G	A	2	2	4	0	0	4	0	0
19	6900903	.	T	C	2	2	4	0	0	4	0	0
19	6901116	.	A	T	1	2	3	0	0	3	0	0
19	6901174	.	G	T	0	3	3	0	0	3	0	0
19	6907740	.	T	C	0	2	2	1	0	3	0	0
19	6907848	.	G	A	1	0	1	0	0	1	0	0
19	6907857	.	C	T	2	0	2	0	0	2	0	0
19	6908495	.	A	T	1	2	3	0	0	3	0	0
19	6908520	.	T	C	1	1	2	0	0	2	0	0
19	6908566	.	A	G	1	0	1	0	1	2	0	0
19	6908574	.	T	A	1	1	2	0	0	2	0	0
19	6908650	.	T	C	1	2	3	0	0	3	0	0
19	6908651	.	T	C	1	2	3	0	0	3	0	0
19	6914280	.	A	T	3	2	5	0	0	5	0	0
19	6915030	.	T	C	3	6	9	0	1	10	0	0
19	6915114	.	C	T	3	5	8	0	0	8	0	0
19	6915175	.	A	C	1	2	3	0	0	3	0	0
19	6915177	.	A	G	1	1	2	0	1	3	0	0
19	6916019	.	T	C	3	3	6	0	1	7	0	0
19	6916029	.	G	A	2	2	4	0	3	7	0	0
19	6916158	.	C	A	2	5	7	0	0	7	0	0
19	6922820	.	G	A	0	3	3	0	2	5	0	0
19	6922963	.	T	C	3	2	5	0	0	5	0	0
19	6922966	.	T	A	3	2	5	0	0	5	0	0
19	6923014	.	A	G	3	2	5	0	0	5	0	0
19	6923033	.	A	C	3	2	5	0	0	5	0	0
19	6928466	.	C	A	2	2	4	0	0	4	0	0
19	6933716	.	T	A	1	2	3	0	0	3	0	0
19	6934166	.	C	T	2	3	5	0	0	5	0	0
19	6934188	.	G	T	1	2	3	0	0	3	0	0
19	6938364	.	A	T	3	6	9	0	0	9	0	0
19	6938377	.	A	T	3	4	7	0	0	7	0	0
19	6940213	.	C	T	1	0	1	0	0	1	0	0
19	6949256	.	G	A	0	15	15	0	14	29	0	0
19	6949316	.	C	A	11	8	19	0	1	20	0	0
19	6952600	.	T	C	19	12	31	0	1	32	0	0
19	6955061	.	C	T	20	19	39	0	1	40	0	0
19	6955130	.	C	T	13	9	22	0	1	23	0	0
19	6955131	.	C	T	14	8	22	0	1	23	0	0
19	6955198	.	C	A	13	16	29	0	0	29	0	0
19	6955411	.	C	T	5	10	15	0	1	16	0	0
19	6955475	.	T	C	8	10	18	0	0	18	0	0
19	6955609	.	C	G	10	6	16	0	1	17	0	0
19	6955620	.	G	A	0	7	7	0	11	18	0	0
19	6955920	.	G	A	9	11	20	0	1	21	0	0
19	6956058	.	T	C	14	13	27	0	0	27	0	0
19	6956060	.	G	A	14	13	27	0	0	27	0	0
19	6956301	.	A	G	3	2	5	0	0	5	0	0
19	6956553	.	A	C	6	8	14	0	0	14	0	0
19	6956555	.	A	T	6	8	14	0	0	14	0	0
19	6956665	.	C	A	13	15	28	0	1	29	0	0
19	6956728	.	T	A	11	19	30	0	1	31	0	0
19	6956829	.	T	A	15	5	20	0	1	21	0	0
19	6956835	.	C	G	14	4	18	0	0	18	0	0
19	6957127	.	A	T	26	14	40	0	0	40	0	0
19	6957131	.	C	A	23	13	36	0	2	38	0	0
19	6960653	.	C	A	12	6	18	0	1	19	0	0
19	6961211	.	T	C	0	3	3	0	0	3	0	0
19	6961377	.	G	T	5	2	7	0	0	7	0	0
19	6961421	.	T	A	8	5	13	0	0	13	0	0
19	6961610	.	G	A	5	7	12	0	0	12	0	0
19	6961674	.	A	G	3	9	12	0	1	13	0	0
19	6962786	.	T	C	5	6	11	0	0	11	0	0
19	6962787	.	T	C	7	4	11	0	0	11	0	0
19	6963020	.	C	T	5	4	9	0	0	9	0	0
19	6963966	.	G	A	3	3	6	0	0	6	0	0
19	6963996	.	G	A	0	2	2	0	1	3	0	0
19	6964249	.	C	G	5	1	6	0	0	6	0	0
19	6964273	.	C	A	4	4	8	0	0	8	0	0
19	6964417	.	A	G	4	6	10	0	0	10	0	0
19	6964483	.	A	T	2	2	4	0	1	5	0	0
19	6964486	.	C	T	3	2	5	0	0	5	0	0
19	6964530	.	C	T	0	3	3	0	3	6	0	0
19	6964636	.	C	T	1	3	4	0	0	4	0	0
19	6964641	.	T	C	1	0	1	0	3	4	0	0
19	6965235	.	A	G	3	1	4	0	0	4	0	0
19	6965250	.	G	A	3	2	5	0	0	5	0	0
19	6965315	.	G	T	2	2	4	0	0	4	0	0
19	6965319	.	A	C	2	2	4	0	0	4	0	0
19	6965382	.	A	T	1	2	3	0	0	3	0	0
19	6965721	.	T	C	4	2	6	0	0	6	0	0
19	6965894	.	C	A	0	2	2	0	6	8	0	0
19	6965897	.	C	T	6	2	8	0	0	8	0	0
19	6966003	.	C	A	3	7	10	0	0	10	0	0
19	6966022	.	A	G	2	7	9	0	2	11	0	0
19	6966208	.	G	A	9	5	14	0	1	15	0	0
19	6966271	.	T	G	3	2	5	0	3	8	0	0
19	6966781	.	A	T	5	6	11	0	1	12	0	0
19	6975261	.	A	C	1	0	1	0	5	6	0	0
19	6980493	.	C	T	3	3	6	0	0	6	0	0
19	6988778	.	T	C	4	3	7	0	1	8	0	0
19	6995721	.	T	G	1	4	5	0	0	5	0	0
19	6995760	.	C	G	1	0	1	0	4	5	0	0
19	6996152	.	T	C	1	3	4	0	0	4	0	0
19	7000068	.	C	T	1	4	5	0	0	5	0	0
19	7004841	.	G	A	0	2	2	0	1	3	0	0
19	7005030	.	C	T	1	3	4	0	0	4	0	0
19	7005032	.	G	C	1	3	4	0	0	4	0	0
19	7005462	.	G	A	0	2	2	0	1	3	0	0
19	7005881	.	C	T	2	2	4	0	0	4	0	0
19	7006215	.	C	T	1	2	3	0	0	3	0	0
19	7006709	.	G	T	0	2	2	0	2	4	0	0
19	7006928	.	C	T	3	6	9	0	0	9	0	0
19	7014743	.	G	A	6	3	9	0	0	9	0	0
19	7014778	.	T	A	8	4	12	0	0	12	0	0
19	7014815	.	C	T	4	2	6	0	0	6	0	0
19	7014863	.	T	G	2	2	4	0	0	4	0	0
19	7015034	.	T	A	3	2	5	0	0	5	0	0
19	7018202	.	G	A	6	2	8	0	0	8	0	0
19	7020179	.	G	A	2	4	6	0	0	6	0	0
19	7020224	.	G	A	2	2	4	0	0	4	0	0
19	7022107	.	G	A	6	2	8	0	0	8	0	0
19	7022128	.	G	A	5	1	6	0	0	6	0	0
19	7024591	.	T	G	4	5	9	0	0	9	0	0
19	7024593	.	C	T	4	4	8	0	1	9	0	0
19	7024627	.	T	C	2	4	6	0	0	6	0	0
19	7027810	.	A	T	5	2	7	0	1	8	0	0
19	7027927	.	G	A	2	3	5	0	0	5	0	0
19	7029883	.	C	A	2	3	5	0	0	5	0	0
19	7029915	.	A	G	1	3	4	0	0	4	0	0
19	7039308	.	G	A	0	3	3	0	0	3	0	0
19	7039335	.	T	C	0	0	0	0	2	2	0	0
19	7105994	.	G	A	0	1	1	0	0	1	0	0
19	7128162	.	G	A	3	3	6	0	0	6	0	0
19	7128225	.	T	C	0	4	4	0	0	4	0	0
19	7128229	.	A	C	0	4	4	0	0	4	0	0
19	7128598	.	T	C	0	1	1	0	0	1	0	0
19	7128605	.	G	T	0	1	1	0	0	1	0	0
19	7131154	.	G	C	0	1	1	0	4	5	0	0
19	7152971	.	G	T	0	4	4	0	7	11	0	0
19	7152974	.	G	A	6	4	10	0	1	11	0	0
19	7154729	.	A	G	16	19	35	0	1	36	0	0
19	7154770	.	A	C	14	22	36	0	0	36	0	0
19	7155001	.	A	T	11	10	21	0	0	21	0	0
19	7155034	.	A	G	13	13	26	0	1	27	0	0
19	7155065	.	T	C	6	16	22	0	0	22	0	0
19	7158546	.	A	G	2	0	2	0	3	5	0	0
19	7159062	.	G	A	0	0	0	0	2	2	0	0
19	7159107	.	T	C	5	4	9	0	0	9	0	0
19	7161452	.	G	A	2	3	5	0	0	5	0	0
19	7161527	.	A	G	5	0	5	0	5	10	0	0
19	7161539	.	G	T	2	1	3	0	1	4	0	0
19	7163872	.	C	T	4	7	11	0	0	11	0	0
19	7163908	.	A	G	7	7	14	0	1	15	0	0
19	7164022	.	G	A	4	4	8	0	0	8	0	0
19	7166211	.	C	T	7	13	20	0	3	23	0	0
19	7166454	.	C	A	3	0	3	0	0	3	0	0
19	7169204	.	A	C	9	2	11	0	1	12	0	0
19	7169228	.	C	T	14	5	19	0	1	20	0	0
19	7169587	.	A	G	2	2	4	0	0	4	0	0
19	7169588	.	G	A	2	2	4	0	0	4	0	0
19	7169770	.	A	C	5	8	13	0	0	14	1	0
19	7169809	.	C	T	5	9	14	0	1	15	0	0
19	7169880	.	T	C	8	4	12	0	0	12	0	0
19	7169886	.	G	A	8	4	12	0	0	12	0	0
19	7169929	.	G	A	9	4	13	0	0	13	0	0
19	7170014	.	A	C	9	4	13	0	1	14	0	0
19	7170015	.	T	C	9	4	13	0	1	14	0	0
19	7170128	.	A	G	4	4	8	0	0	8	0	0
19	7170191	.	A	C	4	8	12	0	1	13	0	0
19	7170228	.	A	T	2	4	6	0	2	8	0	0
19	7170642	.	C	T	1	2	3	0	0	3	0	0
19	7174486	.	G	T	3	2	5	0	0	5	0	0
19	7249800	.	A	G	12	7	19	0	0	19	0	0
19	7249811	.	T	C	10	8	18	0	2	20	0	0
19	7250372	.	T	C	2	2	4	0	0	4	0	0
19	7258085	.	A	G	2	6	8	0	0	8	0	0
19	7258118	.	C	T	3	2	5	0	0	5	0	0
19	7265377	.	T	C	2	0	2	0	1	3	0	0
19	7270156	.	C	A	0	3	3	0	9	12	0	0
19	7272224	.	C	A	1	1	2	0	0	2	0	0
19	7272935	.	G	A	5	4	9	0	0	9	0	0
19	7276106	.	G	A	17	9	26	0	3	29	0	0
19	7276149	.	A	G	24	21	45	0	3	48	0	0
19	7276194	.	T	A	23	30	53	0	2	55	0	0
19	7276559	.	G	A	31	37	68	0	1	69	0	0
19	7276610	.	G	A	24	27	51	0	6	57	0	0
19	7279235	.	A	G	15	13	28	0	0	28	0	0
19	7279721	.	A	G	7	5	12	0	0	12	0	0
19	7282541	.	C	T	4	8	12	0	0	12	0	0
19	7282554	.	G	A	9	13	22	0	1	23	0	0
19	7283427	.	C	A	17	14	31	0	3	34	0	0
19	7283499	.	A	G	20	14	34	0	1	35	0	0
19	7284840	.	C	T	1	16	17	0	16	33	0	0
19	7286301	.	A	G	9	8	17	0	0	17	0	0
19	7286355	.	A	G	25	19	44	0	1	45	0	0
19	7286421	.	T	A	12	9	21	0	1	22	0	0
19	7286742	.	A	G	14	5	19	0	0	19	0	0
19	7287600	.	T	C	16	19	35	0	3	38	0	0
19	7287603	.	G	A	18	18	36	0	0	36	0	0
19	7288195	.	A	G	7	9	16	0	1	17	0	0
19	7290175	.	A	G	3	1	4	0	0	4	0	0
19	7290214	.	A	G	17	11	28	0	3	31	0	0
19	7291642	.	A	T	2	0	2	0	0	2	0	0
19	7292621	.	G	A	0	2	2	0	0	2	0	0
19	7292636	.	A	T	0	2	2	0	0	2	0	0
19	7293138	.	A	G	2	2	4	0	0	4	0	0
19	7295279	.	G	A	4	11	15	0	0	15	0	0
19	7295572	.	G	C	4	4	8	0	1	9	0	0
19	7309154	.	G	A	12	11	23	0	0	23	0	0
19	7309391	.	C	A	26	19	45	0	2	47	0	0
19	7309522	.	G	C	28	18	46	0	1	47	0	0
19	7309556	.	T	A	19	13	32	0	1	33	0	0
19	7309557	.	T	A	19	12	31	0	2	33	0	0
19	7309754	.	T	G	12	6	18	0	5	23	0	0
19	7309929	.	A	T	15	13	28	0	3	31	0	0
19	7309968	.	G	T	13	13	26	0	1	27	0	0
19	7310117	.	T	C	17	0	17	0	8	25	0	0
19	7310131	.	C	T	14	7	21	0	1	22	0	0
19	7310154	.	A	T	11	10	21	0	1	22	0	0
19	7311678	.	T	G	4	1	5	0	0	5	0	0
19	7313933	.	C	G	7	12	19	0	0	19	0	0
19	7327462	.	A	G	6	8	14	0	0	14	0	0
19	7327519	.	C	T	3	7	10	0	1	11	0	0
19	7327564	.	G	T	2	3	5	0	0	5	0	0
19	7327570	.	T	C	2	2	4	0	0	4	0	0
19	7338033	.	C	T	0	11	11	0	10	21	0	0
19	7338125	.	C	T	10	5	15	0	1	16	0	0
19	7338150	.	G	A	8	3	11	0	0	11	0	0
19	7338309	.	C	T	1	5	6	0	13	19	0	0
19	7338402	.	C	T	0	3	3	0	11	14	0	0
19	7338425	.	T	C	7	4	11	0	0	11	0	0
19	7338444	.	T	C	4	0	4	0	5	9	0	0
19	7338969	.	C	T	7	8	15	0	0	15	0	0
19	7338978	.	T	C	8	0	8	0	10	18	0	0
19	7339008	.	T	G	7	8	15	0	1	16	0	0
19	7341300	.	G	A	10	4	14	0	2	16	0	0
19	7341385	.	A	G	0	2	2	0	0	2	0	0
19	7358131	.	A	G	2	3	5	0	2	7	0	0
19	7379601	.	C	T	4	3	7	0	1	8	0	0
19	7379637	.	T	C	4	0	4	0	3	7	0	0
19	7406810	.	G	T	0	1	1	0	0	1	0	0
19	7408360	.	T	G	5	7	12	0	1	13	0	0
19	7411975	.	T	C	4	6	10	0	0	10	0	0
19	7412062	.	T	C	1	2	3	0	0	3	0	0
19	7412320	.	C	T	3	10	13	0	1	14	0	0
19	7412358	.	A	T	2	11	13	0	0	13	0	0
19	7412490	.	T	C	2	4	6	0	0	6	0	0
19	7424794	.	G	A	1	1	2	0	0	2	0	0
19	7426637	.	C	T	3	3	6	0	0	6	0	0
19	7426814	.	C	T	6	3	9	0	1	10	0	0
19	7426832	.	G	A	5	2	7	0	0	7	0	0
19	7426967	.	T	C	17	6	23	0	0	23	0	0
19	7427099	.	C	A	2	2	4	0	0	4	0	0
19	7430160	.	T	C	9	10	19	0	2	21	0	0
19	7430607	.	G	A	0	9	9	0	8	17	0	0
19	7430652	.	C	T	5	8	13	0	1	14	0	0
19	7430700	.	A	G	5	0	5	0	8	13	0	0
19	7430715	.	C	A	6	5	11	0	1	12	0	0
19	7432922	.	G	A	3	3	6	0	0	6	0	0
19	7433068	.	T	A	1	5	6	0	0	6	0	0
19	7433598	.	C	T	0	1	1	0	0	1	0	0
19	7433601	.	T	C	0	2	2	0	0	2	0	0
19	7433637	.	C	A	1	4	5	0	0	5	0	0
19	7433746	.	A	C	2	2	4	0	0	4	0	0
19	7434161	.	G	T	3	4	7	0	0	7	0	0
19	7434555	.	C	T	5	3	8	0	0	8	0	0
19	7434611	.	G	C	3	7	10	0	0	10	0	0
19	7434716	.	G	T	4	2	6	0	0	6	0	0
19	7434731	.	G	C	3	1	4	0	0	4	0	0
19	7434813	.	G	A	2	2	4	0	0	4	0	0
19	7434866	.	C	T	1	2	3	0	0	3	0	0
19	7434881	.	C	T	0	2	2	0	2	4	0	0
19	7435605	.	T	C	0	2	2	0	0	2	0	0
19	7437053	.	A	G	1	1	2	0	0	2	0	0
19	7439799	.	C	T	0	1	1	0	0	1	0	0
19	7445648	.	G	T	2	6	8	0	2	10	0	0
19	7445676	.	G	A	12	6	18	1	1	20	0	0
19	7445897	.	C	T	24	26	50	0	3	53	0	0
19	7446050	.	T	C	34	19	53	0	1	54	0	0
19	7446137	.	G	T	25	25	50	0	2	52	0	0
19	7446286	.	G	T	23	26	49	0	0	49	0	0
19	7446495	.	G	T	30	30	60	0	4	64	0	0
19	7446621	.	C	A	32	25	57	0	5	62	0	0
19	7446702	.	T	C	4	2	6	0	0	6	0	0
19	7450572	.	G	A	23	18	41	0	1	42	0	0
19	7450658	.	T	C	12	13	25	0	0	25	0	0
19	7450750	.	A	G	6	6	12	0	0	12	0	0
19	7450783	.	C	T	0	4	4	0	5	9	0	0
19	7456371	.	A	C	0	8	8	0	0	8	0	0
19	7456722	.	C	G	3	5	8	0	0	8	0	0
19	7456793	.	A	G	6	6	12	0	0	12	0	0
19	7456816	.	C	G	5	6	11	0	0	11	0	0
19	7468556	.	G	T	2	4	6	0	1	7	0	0
19	7468580	.	C	T	2	8	10	0	0	10	0	0
19	7468746	.	T	A	1	0	1	0	0	1	0	0
19	7474242	.	T	C	6	10	16	0	1	17	0	0
19	7474245	.	T	G	6	0	6	0	10	16	0	0
19	7478159	.	A	G	9	12	21	0	0	21	0	0
19	7478283	.	C	T	4	4	8	0	0	8	0	0
19	7478356	.	G	A	3	6	9	0	0	9	0	0
19	7482931	.	C	T	5	8	13	0	0	13	0	0
19	7482993	.	G	A	1	5	6	0	0	6	0	0
19	7483059	.	A	T	2	5	7	0	0	7	0	0
19	7483469	.	T	G	5	2	7	0	0	7	0	0
19	7484213	.	A	T	1	2	3	0	0	3	0	0
19	7484313	.	T	A	2	2	4	0	0	4	0	0
19	7484354	.	A	T	1	5	6	0	0	6	0	0
19	7484357	.	G	A	1	5	6	0	0	6	0	0
19	7484668	.	A	T	2	2	4	0	1	5	0	0
19	7484856	.	C	G	0	2	2	0	2	4	0	0
19	7485117	.	C	T	1	3	4	0	0	4	0	0
19	7485298	.	A	C	4	3	7	0	0	7	0	0
19	7485366	.	C	A	1	2	3	0	1	4	0	0
19	7485503	.	G	A	3	2	5	0	0	5	0	0
19	7485839	.	G	T	4	4	8	0	0	8	0	0
19	7485890	.	G	A	1	4	5	0	0	5	0	0
19	7486087	.	G	A	1	4	5	0	0	5	0	0
19	7486791	.	T	C	3	2	5	0	0	5	0	0
19	7487163	.	A	G	5	4	9	0	0	9	0	0
19	7487321	.	C	T	5	8	13	0	0	13	0	0
19	7487592	.	T	A	2	3	5	0	0	5	0	0
19	7495867	.	A	T	4	5	9	0	0	9	0	0
19	7498046	.	T	C	11	12	23	0	1	24	0	0
19	7498079	.	A	G	9	14	23	0	0	23	0	0
19	7498103	.	A	G	8	9	17	0	0	17	0	0
19	7505591	.	A	G	3	4	7	0	1	8	0	0
19	7505907	.	A	G	5	0	5	0	3	8	0	0
19	7506036	.	A	G	4	0	4	0	9	13	0	0
19	7507833	.	A	T	7	12	19	0	0	19	0	0
19	7510223	.	T	C	9	5	14	0	1	15	0	0
19	7510348	.	T	C	9	10	19	0	0	19	0	0
19	7510501	.	G	A	0	5	5	0	11	16	0	0
19	7510567	.	C	T	6	2	8	0	0	8	0	0
19	7512406	.	C	G	12	7	19	0	0	19	0	0
19	7513085	.	C	T	11	7	18	0	1	19	0	0
19	7513291	.	A	C	4	13	17	0	1	18	0	0
19	7513406	.	A	T	5	7	12	0	0	12	0	0
19	7513631	.	A	G	4	8	12	0	2	14	0	0
19	7514697	.	A	G	4	0	4	0	5	9	0	0
19	7514852	.	A	G	1	8	9	0	0	9	0	0
19	7515293	.	A	G	9	8	17	0	1	18	0	0
19	7515336	.	A	T	14	10	24	0	1	25	0	0
19	7515356	.	G	A	16	11	27	0	1	28	0	0
19	7515458	.	A	G	7	1	8	0	0	8	0	0
19	7515468	.	T	G	5	2	7	0	0	7	0	0
19	7515787	.	A	T	12	5	17	0	2	19	0	0
19	7515829	.	C	T	6	8	14	0	1	15	0	0
19	7515845	.	A	T	8	13	21	0	0	21	0	0
19	7516035	.	A	G	14	7	21	0	0	21	0	0
19	7516063	.	A	C	11	5	16	0	1	17	0	0
19	7516169	.	C	A	14	10	24	0	0	24	0	0
19	7516183	.	T	G	12	9	21	0	0	21	0	0
19	7552736	.	C	A	3	4	7	0	0	7	0	0
19	7552737	.	G	T	0	4	4	0	3	7	0	0
19	7552887	.	A	G	2	3	5	0	1	6	0	0
19	7553368	.	T	C	1	2	3	0	0	3	0	0
19	7557538	.	T	C	11	21	32	0	0	32	0	0
19	7557735	.	T	C	20	17	37	0	1	38	0	0
19	7557793	.	G	C	12	20	32	0	0	32	0	0
19	7564073	.	A	G	7	10	17	0	1	18	0	0
19	7564176	.	C	T	9	8	17	0	1	18	0	0
19	7565462	.	T	A	11	19	30	0	1	31	0	0
19	7565463	.	T	C	10	19	29	0	2	31	0	0
19	7566770	.	A	G	13	18	31	0	1	32	0	0
19	7567011	.	T	C	14	16	30	0	4	34	0	0
19	7567021	.	T	A	14	16	30	0	2	32	0	0
19	7567196	.	A	C	3	3	6	0	1	7	0	0
19	7567768	.	C	T	1	0	1	0	0	1	0	0
19	7590695	.	A	T	2	2	4	0	0	4	0	0
19	7608704	.	T	C	1	2	3	0	0	3	0	0
19	7609200	.	T	G	1	2	3	0	0	3	0	0
19	7630689	.	A	T	3	3	6	0	1	7	0	0
19	7631386	.	C	T	10	15	25	0	0	25	0	0
19	7631700	.	G	A	0	15	15	0	9	24	0	0
19	7631860	.	T	C	11	10	21	0	2	23	0	0
19	7631968	.	T	C	10	8	18	0	0	18	0	0
19	7632056	.	C	T	5	4	9	0	0	9	0	0
19	7632470	.	C	T	2	6	8	0	0	8	0	0
19	7632526	.	T	C	8	4	12	0	0	12	0	0
19	7632837	.	C	T	4	12	16	0	0	16	0	0
19	7679110	.	A	G	1	4	5	0	0	5	0	0
19	7679528	.	T	C	1	2	3	0	0	3	0	0
19	7679551	.	C	T	1	2	3	0	0	3	0	0
19	7679566	.	A	T	1	2	3	0	0	3	0	0
19	7761855	.	C	T	0	1	1	0	0	1	0	0
19	7762934	.	G	A	2	4	6	0	0	6	0	0
19	7762958	.	G	A	0	1	1	0	2	3	0	0
19	7773391	.	C	G	1	2	3	0	0	3	0	0
19	7773457	.	A	G	4	0	4	0	2	6	0	0
19	7773459	.	A	C	4	2	6	0	0	6	0	0
19	7775547	.	A	T	10	17	27	0	4	31	0	0
19	7775552	.	T	C	11	16	27	0	2	29	0	0
19	7784681	.	T	A	4	5	9	0	1	10	0	0
19	7784684	.	T	A	5	5	10	0	0	10	0	0
19	7785138	.	C	T	2	3	5	0	0	5	0	0
19	7794830	.	G	C	1	16	17	0	14	31	0	0
19	7794872	.	A	G	13	3	16	0	24	40	0	0
19	7796398	.	C	T	22	22	44	0	3	47	0	0
19	7796975	.	T	C	10	9	19	0	2	21	0	0
19	7797539	.	T	G	15	12	27	0	1	28	0	0
19	7797645	.	C	T	12	4	16	0	0	16	0	0
19	7799137	.	T	C	4	6	10	0	1	11	0	0
19	7800812	.	A	G	1	1	2	0	0	2	0	0
19	7802622	.	G	A	8	10	18	0	1	19	0	0
19	7802700	.	G	A	0	6	6	0	0	6	0	0
19	7802704	.	T	C	0	6	6	0	0	6	0	0
19	7803480	.	G	A	0	2	2	0	0	2	0	0
19	7803685	.	C	A	7	11	18	0	0	18	0	0
19	7803730	.	G	A	2	5	7	0	1	8	0	0
19	7803745	.	T	A	2	3	5	0	0	5	0	0
19	7804785	.	A	C	2	5	7	0	0	7	0	0
19	7804841	.	G	A	4	15	19	0	2	21	0	0
19	7804843	.	G	A	5	15	20	0	1	21	0	0
19	7804892	.	C	T	2	13	15	0	0	15	0	0
19	7804937	.	C	T	4	8	12	0	0	12	0	0
19	7804967	.	A	C	2	4	6	0	1	7	0	0
19	7820018	.	C	G	8	5	13	0	1	14	0	0
19	7820767	.	C	T	0	5	5	0	4	9	0	0
19	7820992	.	C	A	1	11	12	0	7	19	0	0
19	7821055	.	C	T	8	6	14	0	0	14	0	0
19	7822581	.	T	C	3	0	3	0	1	4	0	0
19	7825025	.	T	G	4	8	12	0	0	12	0	0
19	7825127	.	T	C	5	5	10	0	0	10	0	0
19	7825181	.	G	C	4	7	11	0	0	11	0	0
19	7825259	.	G	A	6	7	13	0	0	13	0	0
19	7825300	.	A	G	1	1	2	0	0	2	0	0
19	7827666	.	A	G	8	4	12	0	0	12	0	0
19	7828600	.	T	C	3	2	5	0	0	5	0	0
19	7829333	.	C	A	2	4	6	0	0	6	0	0
19	7829998	.	A	G	2	2	4	0	0	4	0	0
19	7830064	.	A	G	2	2	4	0	1	5	0	0
19	9604114	.	A	G	1	4	5	0	0	5	0	0
19	9685695	.	A	G	24	26	50	0	0	50	0	0
19	9685714	.	A	C	21	29	50	0	1	51	0	0
19	9686078	.	C	A	13	7	20	0	1	21	0	0
19	9686099	.	G	T	12	8	20	0	1	21	0	0
19	9686160	.	T	C	18	14	32	0	1	33	0	0
19	9686199	.	G	T	16	17	33	0	2	35	0	0
19	9686474	.	G	A	11	10	21	0	1	22	0	0
19	9686503	.	A	G	15	10	25	0	0	25	0	0
19	9686548	.	T	A	10	9	19	0	0	19	0	0
19	9686575	.	T	A	12	12	24	0	1	25	0	0
19	9686616	.	A	T	19	8	27	0	1	28	0	0
19	9686646	.	C	T	17	3	20	0	1	21	0	0
19	9686678	.	T	A	14	10	24	0	0	24	0	0
19	9686806	.	T	C	7	3	10	0	0	10	0	0
19	9686905	.	T	C	2	0	2	0	9	11	0	0
19	9687033	.	C	T	13	11	24	0	3	27	0	0
19	9687073	.	G	A	16	15	31	0	1	32	0	0
19	9687146	.	T	C	18	17	35	0	2	37	0	0
19	9691780	.	A	G	9	5	14	0	0	14	0	0
19	9700886	.	T	C	2	0	2	0	2	4	0	0
19	9712444	.	G	A	4	11	15	0	0	15	0	0
19	9712514	.	C	T	5	3	8	0	1	9	0	0
19	10987940	.	G	A	1	3	4	0	0	4	0	0
19	10987959	.	A	T	1	3	4	0	0	4	0	0
19	10989189	.	A	C	13	4	17	1	1	19	0	0
19	10989343	.	T	A	12	19	31	0	3	34	0	0
19	10989457	.	T	C	11	15	26	0	6	32	0	0
19	10989511	.	A	G	12	11	23	0	2	25	0	0
19	10989653	.	C	A	12	21	33	0	1	34	0	0
19	10997288	.	A	G	1	2	3	0	0	3	0	0
19	11014636	.	G	A	11	16	27	0	0	27	0	0
19	11014675	.	A	G	9	9	18	0	2	20	0	0
19	11039829	.	G	C	6	12	18	0	2	20	0	0
19	11040493	.	A	T	13	9	22	0	1	23	0	0
19	11045311	.	C	A	0	13	13	0	16	29	0	0
19	11045323	.	C	T	15	11	26	0	2	28	0	0
19	11045864	.	A	C	9	10	19	0	1	20	0	0
19	11048822	.	C	T	0	1	1	0	4	5	0	0
19	11051581	.	T	C	7	4	11	0	0	11	0	0
19	11070738	.	A	G	2	4	6	0	1	7	0	0
19	11070794	.	G	A	3	2	5	0	0	5	0	0
19	11093564	.	T	C	2	2	4	0	1	5	0	0
19	11093567	.	A	G	2	2	4	0	1	5	0	0
19	11167903	.	T	C	2	0	2	0	1	3	0	0
19	11172188	.	G	A	1	0	1	0	0	1	0	0
19	11231386	.	C	A	2	10	12	0	1	13	0	0
19	11237043	.	A	G	3	8	11	0	0	11	0	0
19	11237049	.	T	C	3	9	12	0	1	13	0	0
19	11271224	.	C	T	2	2	4	0	1	5	0	0
19	11274926	.	T	C	2	1	3	0	3	6	0	0
19	11275304	.	T	A	1	0	1	0	0	1	0	0
19	11275607	.	G	C	0	2	2	0	0	2	0	0
19	11314625	.	C	T	3	3	6	0	0	6	0	0
19	11314858	.	A	T	2	2	4	0	1	5	0	0
19	11315067	.	G	A	3	2	5	0	0	5	0	0
19	11331967	.	G	T	8	8	16	0	2	18	0	0
19	11332050	.	G	T	16	16	32	0	0	32	0	0
19	11332071	.	T	C	12	15	27	0	1	28	0	0
19	11332574	.	T	A	16	13	29	0	0	29	0	0
19	11332576	.	C	T	16	12	28	0	1	29	0	0
19	11332670	.	T	C	11	1	12	0	8	20	0	0
19	11347910	.	C	T	0	1	1	0	2	3	0	0
19	11356692	.	G	A	8	7	15	0	1	16	0	0
19	11466341	.	G	T	1	2	3	0	0	3	0	0
19	11508991	.	G	C	6	4	10	0	0	10	0	0
19	11509029	.	T	C	8	0	8	0	6	14	0	0
19	11545803	.	T	G	4	7	11	0	0	11	0	0
19	11546105	.	G	A	3	3	6	0	0	6	0	0
19	11632927	.	A	C	3	2	5	0	2	7	0	0
19	11792756	.	A	T	1	3	4	0	0	4	0	0
19	11815024	.	T	C	4	1	5	0	1	6	0	0
19	11815030	.	T	A	4	3	7	0	0	7	0	0
19	11815087	.	G	A	2	2	4	0	0	4	0	0
19	11815448	.	T	A	6	3	9	0	0	9	0	0
19	11815576	.	T	A	1	4	5	0	0	5	0	0
19	11846718	.	A	C	1	1	2	0	1	3	0	0
19	11846911	.	A	T	1	3	4	0	0	4	0	0
19	11892419	.	A	T	2	10	12	0	0	12	0	0
19	11892422	.	A	G	2	10	12	0	0	12	0	0
19	11892515	.	A	G	2	13	15	0	0	15	0	0
19	11892636	.	T	A	4	15	19	0	0	19	0	0
19	11893087	.	A	G	11	13	24	0	2	26	0	0
19	11893309	.	G	T	0	4	4	2	6	12	0	0
19	11893313	.	G	A	4	6	10	2	0	12	0	0
19	11893445	.	A	G	3	7	10	0	2	12	0	0
19	11893624	.	T	C	2	6	8	0	0	8	0	0
19	11893650	.	T	A	2	4	6	0	0	6	0	0
19	11897774	.	T	C	1	5	6	0	0	6	0	0
19	11897841	.	G	T	4	2	6	0	1	7	0	0
19	11899324	.	A	G	5	10	15	0	0	15	0	0
19	11899384	.	T	C	2	2	4	0	0	4	0	0
19	11906178	.	G	A	1	0	1	0	0	1	0	0
19	11906238	.	T	G	5	7	12	0	1	13	0	0
19	11908436	.	A	G	1	1	2	0	0	2	0	0
19	11910538	.	T	C	4	0	4	0	5	9	0	0
19	11912635	.	T	A	2	2	4	0	0	4	0	0
19	11912838	.	T	G	2	0	2	0	0	2	0	0
19	11915066	.	T	G	4	2	6	0	0	6	0	0
19	11915272	.	A	G	2	2	4	0	0	4	0	0
19	11915320	.	G	A	4	2	6	0	0	6	0	0
19	11917609	.	T	A	2	1	3	0	0	3	0	0
19	11917805	.	T	C	0	1	1	0	0	1	0	0
19	11921047	.	C	T	5	2	7	0	0	7	0	0
19	11955713	.	A	G	6	4	10	0	1	11	0	0
19	11960343	.	C	T	1	2	3	0	0	3	0	0
19	11964016	.	A	G	3	3	6	0	1	7	0	0
19	11964313	.	A	G	2	2	4	0	0	4	0	0
19	11969337	.	G	A	1	2	3	0	0	3	0	0
19	11985848	.	C	T	5	6	11	0	2	13	0	0
19	11985858	.	T	C	6	9	15	0	0	15	0	0
19	11996249	.	T	A	0	5	5	0	0	5	0	0
19	11996360	.	A	C	0	3	3	0	2	5	0	0
19	12017902	.	G	A	1	7	8	0	12	20	0	0
19	12018036	.	C	G	3	4	7	0	1	8	0	0
19	12018291	.	A	G	4	0	4	0	7	11	0	0
19	12018367	.	G	T	0	3	3	0	6	9	0	0
19	12031138	.	G	T	4	2	6	0	0	6	0	0
19	12031202	.	C	T	0	6	6	0	4	10	0	0
19	12031466	.	T	A	5	7	12	0	1	13	0	0
19	12031515	.	T	G	2	4	6	0	0	6	0	0
19	12031920	.	G	A	6	2	8	0	0	8	0	0
19	12031925	.	G	T	6	2	8	0	0	8	0	0
19	12032622	.	C	T	1	4	5	0	0	5	0	0
19	12032649	.	G	A	2	5	7	0	0	7	0	0
19	12033428	.	T	C	3	3	6	0	0	6	0	0
19	12033494	.	T	C	3	0	3	0	4	7	0	0
19	12122035	.	A	G	27	17	44	0	6	50	0	0
19	12122039	.	G	A	28	19	47	0	2	49	0	0
19	12122124	.	C	A	45	19	64	0	2	66	0	0
19	12122489	.	G	T	14	17	31	0	1	32	0	0
19	12130089	.	G	A	11	11	22	0	3	25	0	0
19	12145548	.	A	T	23	23	46	0	0	46	0	0
19	12171712	.	C	T	17	6	23	0	2	25	0	0
19	12188083	.	G	T	20	19	39	0	2	41	0	0
19	12188207	.	A	G	28	29	57	0	3	60	0	0
19	12188243	.	A	G	25	31	56	0	4	60	0	0
19	12188249	.	A	G	23	33	56	0	3	59	0	0
19	12193578	.	G	C	5	3	8	0	0	8	0	0
19	12193604	.	A	G	4	6	10	0	0	10	0	0
19	12193617	.	T	A	4	6	10	0	0	10	0	0
19	12206504	.	T	G	8	11	19	0	0	19	0	0
19	12297178	.	C	T	2	5	7	0	0	7	0	0
19	12297375	.	A	G	6	3	9	0	0	9	0	0
19	12300840	.	G	A	2	4	6	0	0	6	0	0
19	12304095	.	C	T	9	7	16	0	2	18	0	0
19	12304137	.	A	G	12	7	19	0	0	19	0	0
19	12363275	.	C	T	8	10	18	1	0	19	0	0
19	12380004	.	A	T	3	3	6	0	1	7	0	0
19	12380029	.	A	T	2	3	5	0	1	6	0	0
19	12383623	.	G	A	3	2	5	0	0	5	0	0
19	12386124	.	T	C	1	3	4	0	0	4	0	0
19	12410252	.	A	G	2	5	7	0	0	7	0	0
19	12413422	.	C	A	6	1	7	0	0	7	0	0
19	12413479	.	C	T	7	3	10	0	0	10	0	0
19	12420188	.	G	A	0	6	6	0	3	9	0	0
19	12424420	.	A	T	0	1	1	0	0	1	0	0
19	12427675	.	G	A	5	7	12	0	0	12	0	0
19	12427973	.	A	G	1	2	3	0	0	3	0	0
19	12428228	.	A	G	4	3	7	0	0	7	0	0
19	12428413	.	C	G	2	8	10	0	0	10	0	0
19	12428634	.	A	G	6	11	17	0	0	17	0	0
19	12428646	.	A	G	7	10	17	0	0	17	0	0
19	12428741	.	T	C	3	12	15	0	0	15	0	0
19	12428754	.	A	G	4	9	13	0	0	13	0	0
19	12645583	.	G	T	11	11	22	0	1	23	0	0
19	12645661	.	C	T	1	1	2	0	0	2	0	0
19	12648372	.	T	C	10	3	13	0	0	13	0	0
19	12655554	.	G	A	1	3	4	0	1	5	0	0
19	12655606	.	G	C	1	3	4	0	0	4	0	0
19	12762981	.	G	C	6	3	9	0	0	9	0	0
19	12801983	.	T	C	9	4	13	0	1	15	1	0
19	12801987	.	T	C	10	4	14	0	1	15	0	0
19	12802035	.	C	A	11	4	15	0	0	15	0	0
19	12802125	.	A	C	6	5	11	0	0	11	0	0
19	12802137	.	C	T	7	3	10	0	0	10	0	0
19	12802173	.	G	A	2	3	5	0	1	6	0	0
19	12802326	.	A	G	4	3	7	1	0	8	0	0
19	12802485	.	G	A	0	3	3	0	6	9	0	0
19	12802554	.	T	C	9	3	12	0	2	14	0	0
19	12802662	.	T	C	6	6	12	0	0	12	0	0
19	12802665	.	T	C	6	7	13	0	0	13	0	0
19	12802986	.	T	C	7	5	12	0	1	13	0	0
19	12803053	.	T	C	7	8	15	0	0	15	0	0
19	12803218	.	A	G	8	6	14	0	0	14	0	0
19	12937143	.	A	G	2	3	5	0	0	5	0	0
19	12937176	.	G	C	1	2	3	0	0	3	0	0
19	12937249	.	A	G	18	14	32	0	0	32	0	0
19	12937364	.	G	A	11	15	26	0	0	26	0	0
19	12937444	.	T	C	17	0	17	0	12	29	0	0
19	12937542	.	C	T	10	6	16	0	2	18	0	0
19	12937574	.	A	G	13	8	21	0	2	23	0	0
19	12937785	.	G	A	5	8	13	0	0	13	0	0
19	12937852	.	G	A	2	2	4	0	1	5	0	0
19	12938160	.	G	T	2	2	4	0	1	5	0	0
19	12939190	.	T	C	3	2	5	0	1	6	0	0
19	12939201	.	T	C	3	2	5	0	1	6	0	0
19	12939471	.	A	T	13	5	18	0	1	19	0	0
19	12939482	.	C	A	13	6	19	0	0	19	0	0
19	12939628	.	G	A	11	3	14	0	0	14	0	0
19	12964728	.	C	T	6	4	10	0	2	12	0	0
19	13121476	.	C	T	10	6	16	0	0	16	0	0
19	13184781	.	A	T	3	1	4	0	0	4	0	0
19	13185127	.	G	A	3	8	11	0	0	11	0	0
19	13185378	.	C	A	18	19	37	0	1	38	0	0
19	13186340	.	C	T	23	22	45	0	1	46	0	0
19	13186357	.	A	G	13	20	33	0	8	41	0	0
19	13186673	.	A	G	13	10	23	0	1	24	0	0
19	13193382	.	T	A	0	2	2	0	0	2	0	0
19	13193894	.	G	A	2	4	6	0	0	6	0	0
19	13194073	.	T	A	4	7	11	0	0	11	0	0
19	13194133	.	C	T	7	7	14	0	0	14	0	0
19	13194246	.	A	G	4	7	11	0	1	12	0	0
19	13194309	.	T	G	3	8	11	0	1	12	0	0
19	13194522	.	T	C	4	0	4	0	7	11	0	0
19	13194812	.	T	A	4	6	10	0	4	14	0	0
19	13194902	.	G	T	4	3	7	0	1	8	0	0
19	13194930	.	T	C	8	3	11	0	1	12	0	0
19	13194974	.	C	G	10	4	14	0	1	15	0	0
19	13195023	.	A	T	12	5	17	0	0	17	0	0
19	13195224	.	G	C	3	0	3	0	3	6	0	0
19	13196073	.	A	G	1	4	5	0	2	7	0	0
19	13196586	.	A	G	3	4	7	0	0	7	0	0
19	13390921	.	G	C	2	6	8	0	0	8	0	0
19	13395156	.	T	A	1	0	1	0	0	1	0	0
19	13395347	.	G	A	0	10	10	0	10	20	0	0
19	13395737	.	A	G	9	6	15	0	1	16	0	0
19	13395819	.	T	C	13	5	18	0	0	18	0	0
19	13395959	.	G	T	8	12	20	0	3	23	0	0
19	13395962	.	T	G	8	12	20	0	1	21	0	0
19	13396252	.	C	T	7	3	10	0	0	10	0	0
19	13396481	.	T	C	16	14	30	0	0	30	0	0
19	13396486	.	G	C	15	11	26	0	1	27	0	0
19	13396619	.	C	A	7	10	17	0	1	18	0	0
19	13396702	.	C	G	8	11	19	0	0	19	0	0
19	13397219	.	A	G	5	3	8	0	1	9	0	0
19	13413068	.	A	T	6	4	10	0	0	10	0	0
19	13413387	.	T	C	4	3	7	0	0	7	0	0
19	13413432	.	C	A	5	5	10	0	2	12	0	0
19	13413445	.	A	G	4	6	10	0	0	10	0	0
19	13413683	.	A	G	1	6	7	0	0	7	0	0
19	13413776	.	G	C	2	2	4	0	1	5	0	0
19	13413844	.	C	T	1	2	3	0	0	3	0	0
19	13414896	.	C	T	4	5	9	0	0	9	0	0
19	13415169	.	C	T	9	17	26	0	1	27	0	0
19	13419582	.	T	C	12	22	34	0	3	37	0	0
19	13419696	.	A	G	22	0	22	0	17	39	0	0
19	13419948	.	A	C	6	8	14	0	7	21	0	0
19	13419986	.	C	G	7	14	21	0	0	21	0	0
19	13425618	.	T	C	4	9	13	0	1	14	0	0
19	13425707	.	A	G	4	4	8	0	1	9	0	0
19	13426090	.	A	T	2	3	5	0	0	5	0	0
19	13426863	.	T	G	3	0	3	0	7	10	0	0
19	13639492	.	T	A	5	8	13	0	0	13	0	0
19	13651691	.	G	T	3	1	4	0	0	4	0	0
19	13670103	.	C	T	0	7	7	0	18	25	0	0
19	13688974	.	G	A	14	15	29	0	0	29	0	0
19	13698141	.	G	A	1	0	1	0	0	1	0	0
19	13698643	.	G	A	2	4	6	0	0	6	0	0
19	13698685	.	T	C	2	5	7	0	0	7	0	0
19	13714963	.	A	G	10	9	19	0	0	19	0	0
19	13724014	.	T	C	9	11	20	0	2	22	0	0
19	13724320	.	T	G	9	12	21	0	1	22	0	0
19	13733583	.	C	G	16	13	29	0	1	30	0	0
19	13905442	.	T	A	4	12	16	0	2	18	0	0
19	13905469	.	T	G	6	10	16	0	1	17	0	0
19	13915686	.	G	T	0	1	1	0	0	1	0	0
19	13919292	.	A	T	4	3	7	0	0	7	0	0
19	13924477	.	T	A	0	4	4	0	0	4	0	0
19	13939827	.	T	C	7	7	14	0	0	14	0	0
19	13939839	.	G	C	11	8	19	0	1	20	0	0
19	13939883	.	C	G	19	14	33	0	0	33	0	0
19	13940106	.	A	G	11	23	34	0	1	35	0	0
19	13940123	.	A	T	9	19	28	0	1	29	0	0
19	13940168	.	G	A	15	20	35	0	0	35	0	0
19	13940227	.	G	T	16	21	37	0	2	39	0	0
19	13940423	.	G	T	19	11	30	0	4	34	0	0
19	13940500	.	C	T	8	19	27	0	0	27	0	0
19	13940614	.	T	C	12	19	31	0	2	33	0	0
19	13940728	.	A	G	5	3	8	0	0	8	0	0
19	13940936	.	C	A	12	11	23	0	0	23	0	0
19	13941161	.	C	T	18	18	36	0	2	38	0	0
19	13941285	.	T	C	16	15	31	0	3	34	0	0
19	13941311	.	C	T	15	18	33	0	1	34	0	0
19	13941403	.	T	A	7	15	22	0	0	22	0	0
19	13941442	.	T	C	9	18	27	0	3	30	0	0
19	13941448	.	A	G	12	17	29	0	3	32	0	0
19	13941505	.	G	C	15	11	26	0	4	30	0	0
19	13941526	.	G	T	15	5	20	0	2	22	0	0
19	13941667	.	T	A	20	23	43	0	1	44	0	0
19	13950183	.	T	C	7	9	16	0	1	17	0	0
19	14022823	.	G	A	1	2	3	0	0	3	0	0
19	14035650	.	T	C	0	5	5	0	0	5	0	0
19	14035672	.	G	A	1	4	5	0	1	6	0	0
19	14035815	.	A	T	5	2	7	0	0	7	0	0
19	14165408	.	G	A	0	1	1	0	5	6	0	0
19	14169238	.	T	A	4	6	10	0	0	10	0	0
19	14352629	.	C	A	9	3	12	0	0	12	0	0
19	14352661	.	C	T	7	6	13	0	0	13	0	0
19	14394930	.	A	T	2	7	9	0	1	10	0	0
19	14421115	.	C	G	2	2	4	0	0	4	0	0
19	14433417	.	A	G	3	5	8	0	1	9	0	0
19	14434077	.	A	G	10	8	18	0	0	18	0	0
19	14434078	.	G	A	10	8	18	0	0	18	0	0
19	14434441	.	A	T	8	6	14	0	0	14	0	0
19	14435968	.	T	C	6	13	19	0	1	20	0	0
19	14436033	.	A	T	5	4	9	0	0	9	0	0
19	14436060	.	C	T	6	5	11	0	0	11	0	0
19	14454521	.	G	A	3	6	9	0	0	9	0	0
19	14462446	.	G	A	0	1	1	0	1	2	0	0
19	14470399	.	A	C	2	2	4	0	0	4	0	0
19	14921238	.	T	C	3	2	5	0	0	5	0	0
19	14921241	.	C	T	3	2	5	0	0	5	0	0
19	14951474	.	T	C	7	2	9	0	0	9	0	0
19	15142850	.	C	T	1	2	3	0	0	3	0	0
19	15142926	.	C	T	1	5	6	0	0	6	0	0
19	15142936	.	G	A	1	5	6	0	0	6	0	0
19	15308389	.	G	T	9	10	19	0	3	22	0	0
19	15313034	.	A	C	7	7	14	0	0	14	0	0
19	15313115	.	G	A	7	5	12	0	1	13	0	0
19	15331663	.	T	C	8	15	23	0	0	23	0	0
19	15331686	.	T	C	9	10	19	0	1	20	0	0
19	15331699	.	C	T	0	3	3	0	16	19	0	0
19	15331805	.	C	A	5	7	12	0	0	12	0	0
19	15331970	.	T	C	6	0	6	0	8	14	0	0
19	15331978	.	G	A	7	7	14	0	0	14	0	0
19	15332115	.	G	T	7	5	12	0	0	13	1	0
19	15332116	.	A	G	8	5	13	0	0	13	0	0
19	15332911	.	T	C	3	7	10	0	0	10	0	0
19	15333709	.	T	A	6	6	12	0	0	12	0	0
19	15334602	.	G	A	2	2	4	0	2	6	0	0
19	15334621	.	T	C	2	4	6	0	0	6	0	0
19	15334851	.	C	G	2	2	4	0	0	4	0	0
19	15334858	.	G	A	2	2	4	0	0	4	0	0
19	15509458	.	A	C	0	2	2	0	0	2	0	0
19	15510584	.	G	A	0	4	4	0	1	5	0	0
19	15510618	.	C	A	1	3	4	0	0	4	0	0
19	15532081	.	C	T	1	4	5	0	1	6	0	0
19	15532082	.	G	A	0	5	5	0	1	6	0	0
19	15532386	.	G	C	3	2	5	0	0	5	0	0
19	15532391	.	C	T	4	2	6	0	0	6	0	0
19	15617983	.	A	C	4	2	6	0	0	6	0	0
19	15617998	.	A	C	4	2	6	0	0	6	0	0
19	15618501	.	G	A	2	3	5	0	0	5	0	0
19	15618813	.	C	T	10	9	19	0	0	19	0	0
19	15618951	.	G	A	8	12	20	0	0	20	0	0
19	15619503	.	C	T	7	5	12	0	1	13	0	0
19	15619584	.	A	G	5	6	11	0	1	12	0	0
19	15619675	.	A	G	5	0	5	0	8	13	0	0
19	15619842	.	C	T	4	6	10	0	0	10	0	0
19	15620715	.	G	A	1	5	6	0	0	6	0	0
19	15851707	.	C	A	5	13	18	0	2	20	0	0
19	15851777	.	G	A	12	12	24	0	1	25	0	0
19	15851890	.	C	T	6	7	13	0	0	13	0	0
19	15852389	.	T	A	7	5	12	0	1	13	0	0
19	15852965	.	C	T	0	7	7	0	6	13	0	0
19	15853008	.	C	T	0	6	6	0	7	13	0	0
19	15853153	.	C	T	10	13	23	0	0	23	0	0
19	15853275	.	A	G	13	8	21	0	0	21	0	0
19	15855335	.	A	T	5	9	14	0	0	14	0	0
19	16021307	.	G	A	3	1	4	0	1	5	0	0
19	16022671	.	G	A	2	3	5	0	0	5	0	0
19	16023901	.	C	T	1	1	2	0	0	2	0	0
19	16032397	.	C	A	6	2	8	0	0	8	0	0
19	16061860	.	G	A	1	2	3	0	0	3	0	0
19	16068517	.	T	C	1	2	3	0	0	3	0	0
19	16070475	.	A	G	1	2	3	0	0	3	0	0
19	16076887	.	C	T	2	2	4	0	0	4	0	0
19	16077033	.	C	T	2	2	4	0	0	4	0	0
19	16078744	.	C	A	4	3	7	0	1	8	0	0
19	16082394	.	G	A	0	1	1	0	1	2	0	0
19	16082756	.	G	A	2	1	3	0	0	3	0	0
19	16085862	.	A	T	1	0	1	0	0	1	0	0
19	16086025	.	T	A	8	11	19	0	2	21	0	0
19	16086937	.	G	A	5	10	15	0	1	16	0	0
19	16087201	.	T	C	1	3	4	0	0	4	0	0
19	16087503	.	T	A	6	4	10	0	0	10	0	0
19	16087527	.	C	T	3	5	8	0	0	8	0	0
19	16087538	.	G	A	5	5	10	0	1	11	0	0
19	16087615	.	T	A	2	2	4	0	0	4	0	0
19	16087875	.	A	T	3	2	5	0	0	5	0	0
19	16087895	.	T	A	3	2	5	0	1	6	0	0
19	16222703	.	C	G	3	4	7	0	0	7	0	0
19	16356349	.	C	G	1	2	3	0	0	3	0	0
19	16522130	.	G	A	0	3	3	0	3	6	0	0
19	16541333	.	C	T	5	3	8	0	0	8	0	0
19	16541375	.	A	T	2	3	5	0	1	6	0	0
19	16541378	.	G	A	3	3	6	0	0	6	0	0
19	16576532	.	G	A	2	6	8	0	0	8	0	0
19	16576574	.	A	T	3	6	9	0	1	10	0	0
19	16584121	.	G	A	0	6	6	0	11	17	0	0
19	16584205	.	C	T	2	1	3	0	0	3	0	0
19	16625154	.	G	T	5	3	8	0	0	8	0	0
19	16629317	.	A	G	8	10	18	0	0	18	0	0
19	16638661	.	C	T	0	2	2	0	0	2	0	0
19	16638786	.	C	T	6	21	27	0	1	28	0	0
19	16638906	.	C	G	5	6	11	0	0	11	0	0
19	16651469	.	T	C	1	3	4	0	0	4	0	0
19	16653867	.	T	C	13	6	19	0	0	19	0	0
19	16653977	.	T	C	6	11	17	0	0	17	0	0
19	16653998	.	T	C	6	10	16	0	1	17	0	0
19	16654012	.	T	C	9	8	17	0	1	18	0	0
19	16654277	.	G	A	1	11	12	0	10	22	0	0
19	16654640	.	A	G	19	13	32	0	0	32	0	0
19	17208304	.	C	T	3	1	4	0	0	4	0	0
19	17260250	.	C	G	2	3	5	0	1	6	0	0
19	17275632	.	C	A	5	6	11	0	1	12	0	0
19	17275765	.	A	G	8	4	12	0	2	14	0	0
19	17276921	.	A	T	11	8	19	0	1	20	0	0
19	17292566	.	T	C	2	2	4	0	0	4	0	0
19	17292587	.	G	A	1	2	3	0	0	3	0	0
19	17292621	.	A	T	2	2	4	0	1	5	0	0
19	17292795	.	T	A	0	3	3	0	1	4	0	0
19	17292831	.	A	T	1	3	4	0	0	4	0	0
19	17292847	.	T	C	4	2	6	0	0	6	0	0
19	17292898	.	T	A	7	5	12	0	0	12	0	0
19	17292905	.	G	A	5	5	10	0	2	12	0	0
19	17292936	.	C	T	5	11	16	0	1	17	0	0
19	17293153	.	T	G	2	3	5	0	0	5	0	0
19	17295656	.	G	A	3	3	6	0	0	6	0	0
19	17295674	.	C	T	0	1	1	0	0	1	0	0
19	17300130	.	G	A	3	6	9	0	0	9	0	0
19	17300536	.	C	T	6	3	9	0	1	10	0	0
19	17301033	.	T	C	1	0	1	0	0	1	0	0
19	17302363	.	T	A	1	1	2	0	0	2	0	0
19	17304888	.	A	G	8	10	18	0	1	19	0	0
19	17304891	.	T	C	9	8	17	0	0	17	0	0
19	17378142	.	G	A	6	5	11	0	2	13	0	0
19	17378361	.	C	T	1	3	4	0	0	4	0	0
19	17385412	.	T	A	0	9	9	0	0	9	0	0
19	17386556	.	G	T	9	5	14	0	3	17	0	0
19	17393069	.	T	C	22	32	54	0	1	55	0	0
19	17400470	.	C	T	10	7	17	0	1	18	0	0
19	17400653	.	G	C	9	7	16	0	0	16	0	0
19	17404237	.	C	T	23	16	39	0	1	40	0	0
19	17405304	.	C	T	10	9	19	0	0	19	0	0
19	17405364	.	C	T	21	30	51	0	0	51	0	0
19	17406014	.	A	T	19	22	41	0	3	44	0	0
19	17406081	.	A	C	18	16	34	0	2	36	0	0
19	17406082	.	G	A	18	16	34	0	2	36	0	0
19	17406271	.	T	G	12	11	23	0	0	23	0	0
19	17406656	.	C	G	23	3	26	0	22	48	0	0
19	17406770	.	T	G	16	25	41	0	5	46	0	0
19	17406918	.	T	C	19	9	28	0	1	29	0	0
19	17514860	.	T	A	11	6	17	0	3	20	0	0
19	17514897	.	T	C	15	0	15	0	11	26	0	0
19	17515048	.	T	C	3	4	7	0	1	8	0	0
19	17515142	.	T	A	5	3	8	0	0	8	0	0
19	17515753	.	T	A	6	4	10	0	1	11	0	0
19	17515919	.	C	T	1	5	6	0	0	6	0	0
19	17516103	.	G	C	5	0	5	0	5	10	0	0
19	17516130	.	T	C	7	11	18	0	1	19	0	0
19	17516162	.	A	T	8	16	24	0	0	24	0	0
19	17516195	.	T	C	10	1	11	0	14	25	0	0
19	17516211	.	G	T	8	12	20	1	0	21	0	0
19	17516330	.	A	G	15	11	26	0	0	26	0	0
19	17516390	.	A	G	13	6	19	0	0	19	0	0
19	17516482	.	A	C	15	7	22	0	3	25	0	0
19	17516489	.	T	A	6	12	18	0	1	19	0	0
19	17516585	.	C	A	8	2	10	0	0	10	0	0
19	17516608	.	A	C	4	2	6	0	1	7	0	0
19	17516920	.	A	G	5	8	13	0	0	13	0	0
19	17516922	.	A	G	4	8	12	0	1	13	0	0
19	17516962	.	T	C	6	3	9	0	0	9	0	0
19	17516997	.	A	G	4	4	8	0	1	9	0	0
19	17517669	.	C	G	5	2	7	0	0	7	0	0
19	17517768	.	T	G	8	4	12	0	0	12	0	0
19	17517816	.	T	C	9	7	16	0	0	16	0	0
19	17517821	.	A	G	7	7	14	0	1	15	0	0
19	17517912	.	T	G	3	3	6	0	0	6	0	0
19	17518179	.	A	T	6	6	12	0	3	15	0	0
19	17518231	.	T	C	3	8	11	0	0	11	0	0
19	17518276	.	G	C	7	8	15	0	0	15	0	0
19	17518330	.	T	C	2	9	11	0	0	11	0	0
19	17518351	.	C	A	0	7	7	0	4	11	0	0
19	17518366	.	A	T	5	4	9	0	2	11	0	0
19	17518489	.	T	A	7	8	15	0	0	15	0	0
19	17518531	.	T	G	6	5	11	0	0	11	0	0
19	17520859	.	A	G	8	2	10	0	0	10	0	0
19	17521027	.	A	T	2	3	5	0	1	6	0	0
19	17722355	.	T	C	2	1	3	0	0	3	0	0
19	17733001	.	G	A	9	3	12	0	1	13	0	0
19	18143837	.	C	T	5	3	8	0	1	9	0	0
19	18765612	.	C	T	1	3	4	0	0	4	0	0
19	18903694	.	C	T	2	5	7	0	0	7	0	0
19	18990243	.	G	A	7	7	14	0	0	14	0	0
19	18990267	.	G	A	5	2	7	0	0	7	0	0
19	19159615	.	T	A	1	2	3	0	0	3	0	0
19	19200483	.	A	G	2	0	2	0	0	2	0	0
19	19201301	.	T	G	0	1	1	0	0	1	0	0
19	19214295	.	T	G	0	1	1	0	0	1	0	0
19	19217233	.	T	C	1	5	6	0	0	6	0	0
19	19263510	.	G	T	1	1	2	0	1	3	0	0
19	19269659	.	T	C	2	4	6	0	0	6	0	0
19	19269931	.	G	A	4	4	8	0	0	8	0	0
19	19270468	.	C	T	8	5	13	0	0	13	0	0
19	19287981	.	G	A	25	17	42	0	1	43	0	0
19	19319164	.	T	C	16	18	34	0	0	34	0	0
19	19319229	.	C	T	22	15	37	0	1	38	0	0
19	19319315	.	G	A	10	24	34	0	2	36	0	0
19	19319337	.	A	G	23	11	34	0	3	37	0	0
19	19319556	.	T	C	11	0	11	0	13	24	0	0
19	19319626	.	A	C	10	10	20	0	0	20	0	0
19	19319692	.	C	T	0	11	11	0	16	27	0	0
19	19319724	.	A	G	13	9	22	0	1	23	0	0
19	19319814	.	T	A	17	11	28	0	1	29	0	0
19	19319852	.	T	A	7	7	14	0	4	18	0	0
19	19319864	.	T	A	7	10	17	0	2	19	0	0
19	19338885	.	T	A	8	10	18	0	0	18	0	0
19	19338923	.	T	A	5	12	17	0	0	17	0	0
19	19339071	.	C	G	8	8	16	0	2	18	0	0
19	19339232	.	C	A	1	5	6	0	12	18	0	0
19	19347856	.	T	C	1	0	1	0	1	2	0	0
19	19417985	.	C	T	2	6	8	0	0	8	0	0
19	19418066	.	G	A	2	0	2	0	1	3	0	0
19	19432598	.	C	T	5	8	13	0	1	14	0	0
19	19498814	.	C	T	0	3	3	0	0	3	0	0
19	19544615	.	C	T	3	5	8	0	0	8	0	0
19	19549131	.	A	G	2	2	4	0	0	4	0	0
19	19549921	.	T	C	7	10	17	0	0	17	0	0
19	19550184	.	G	T	9	8	17	0	0	17	0	0
19	19550381	.	T	G	13	10	23	0	2	25	0	0
19	19550601	.	C	A	7	13	20	0	2	22	0	0
19	19551819	.	G	A	4	7	11	0	2	13	0	0
19	19551828	.	A	G	6	8	14	0	0	14	0	0
19	19561923	.	C	T	0	7	7	0	6	13	0	0
19	19562669	.	A	G	2	1	3	0	0	3	0	0
19	19573913	.	C	T	0	1	1	0	0	1	0	0
19	19579200	.	C	T	7	5	12	0	1	13	0	0
19	19580971	.	C	T	0	10	10	0	10	20	0	0
19	19592010	.	C	T	0	7	7	0	5	12	0	0
19	19596944	.	G	A	0	0	0	0	1	1	0	0
19	19652494	.	G	A	0	1	1	0	2	3	0	0
19	19657032	.	G	A	0	3	3	0	1	4	0	0
19	19769016	.	C	A	4	4	8	0	0	8	0	0
19	19979049	.	C	T	3	4	7	0	0	7	0	0
19	20062114	.	C	A	0	3	3	0	2	5	0	0
19	20112056	.	G	C	21	27	48	0	2	50	0	0
19	20113526	.	G	A	8	8	16	0	0	16	0	0
19	20164058	.	G	A	0	5	5	0	4	9	0	0
19	20176665	.	G	T	4	7	11	0	0	11	0	0
19	20179257	.	G	A	8	6	14	0	0	14	0	0
19	20179291	.	G	A	6	9	15	0	2	17	0	0
19	20185030	.	C	T	17	10	27	0	0	27	0	0
19	20243833	.	G	A	0	2	2	0	0	2	0	0
19	20292279	.	A	T	1	2	3	0	0	3	0	0
19	20293053	.	G	T	0	2	2	0	0	2	0	0
19	20293083	.	T	G	2	2	4	0	0	4	0	0
19	20301691	.	A	C	4	1	5	0	2	7	0	0
19	20305514	.	A	G	2	0	2	0	0	2	0	0
19	20305592	.	T	G	0	1	1	0	0	1	0	0
19	20311348	.	C	T	2	2	4	0	0	4	0	0
19	20319064	.	G	A	0	2	2	0	0	2	0	0
19	20319071	.	G	T	1	0	1	0	1	2	0	0
19	20415143	.	T	A	8	8	16	0	3	19	0	0
19	20415146	.	T	C	7	0	7	0	12	19	0	0
19	20415242	.	G	A	6	6	12	0	0	12	0	0
19	20423199	.	C	T	0	1	1	0	1	2	0	0
19	20423507	.	A	G	1	1	2	0	0	2	0	0
19	20425879	.	T	C	0	0	0	0	1	1	0	0
19	20453881	.	A	G	2	5	7	0	1	8	0	0
19	20453933	.	C	T	0	2	2	0	4	6	0	0
19	20454087	.	G	A	6	3	9	0	1	10	0	0
19	20454123	.	A	G	3	3	6	0	1	7	0	0
19	20454393	.	G	A	2	6	8	0	0	8	0	0
19	20720782	.	T	C	26	20	46	0	1	47	0	0
19	20721025	.	C	T	21	24	45	0	2	47	0	0
19	20721135	.	G	A	29	20	49	0	2	51	0	0
19	20721215	.	C	T	17	24	41	0	15	56	0	0
19	20721761	.	A	C	1	14	15	0	8	23	0	0
19	20722093	.	C	A	8	21	29	0	2	31	0	0
19	20722144	.	C	T	13	8	21	0	1	22	0	0
19	20722330	.	C	G	2	7	9	0	0	9	0	0
19	20724504	.	A	G	3	0	3	0	2	5	0	0
19	20742041	.	T	C	0	1	1	0	0	1	0	0
19	20754233	.	C	T	4	2	6	0	0	6	0	0
19	20762228	.	T	C	7	3	10	0	0	10	0	0
19	20762239	.	G	A	2	5	7	0	0	7	0	0
19	20763798	.	G	A	1	1	2	0	0	2	0	0
19	20771290	.	G	A	7	3	10	0	0	10	0	0
19	20773965	.	C	A	2	3	5	0	0	5	0	0
19	20776804	.	C	T	2	1	3	0	0	3	0	0
19	20785859	.	T	A	3	0	3	0	0	3	0	0
19	20790572	.	T	C	11	4	15	0	1	16	0	0
19	20790809	.	C	T	15	9	24	0	2	26	0	0
19	20791295	.	T	C	10	9	19	0	2	21	0	0
19	20791525	.	T	G	3	6	9	0	2	11	0	0
19	20792049	.	T	A	3	5	8	0	0	8	0	0
19	20796566	.	C	T	2	2	4	0	0	4	0	0
19	20796605	.	C	T	7	6	13	0	1	14	0	0
19	20801926	.	A	G	0	1	1	0	0	1	0	0
19	20803718	.	G	A	0	3	3	0	3	6	0	0
19	20815229	.	T	A	1	1	2	0	0	2	0	0
19	20823003	.	T	G	2	3	5	0	0	5	0	0
19	20823024	.	C	T	1	4	5	0	0	5	0	0
19	21367862	.	C	T	3	1	4	0	0	4	0	0
19	21408969	.	C	T	4	5	9	0	0	9	0	0
19	21410404	.	G	A	8	6	14	0	1	15	0	0
19	21411022	.	C	T	11	5	16	0	0	16	0	0
19	21412041	.	C	T	15	9	24	0	1	25	0	0
19	21412293	.	A	G	5	5	10	0	0	10	0	0
19	21412755	.	T	C	7	13	20	0	0	20	0	0
19	21413152	.	G	A	0	9	9	0	17	26	0	0
19	21698413	.	G	A	6	6	12	0	1	13	0	0
19	21711187	.	G	C	2	0	2	0	5	7	0	0
19	21711267	.	G	C	7	3	10	0	1	11	0	0
19	21711681	.	A	G	5	7	12	0	0	12	0	0
19	21712031	.	A	T	1	2	3	0	0	3	0	0
19	21712032	.	C	G	1	2	3	0	0	3	0	0
19	21712285	.	T	A	4	4	8	0	0	8	0	0
19	21715367	.	C	T	1	6	7	0	0	7	0	0
19	21715385	.	T	C	2	7	9	0	1	10	0	0
19	21716775	.	C	A	0	2	2	0	0	2	0	0
19	21716791	.	C	T	1	0	1	0	0	1	0	0
19	21814362	.	A	C	36	39	75	0	2	77	0	0
19	21814372	.	T	A	40	38	78	0	1	79	0	0
19	21814408	.	T	C	28	32	60	0	5	65	0	0
19	21814457	.	C	T	42	64	106	0	4	110	0	0
19	21814515	.	C	T	59	44	103	0	2	105	0	0
19	21814644	.	T	G	36	40	76	0	5	81	0	0
19	21814852	.	T	C	46	37	83	0	4	87	0	0
19	21815151	.	C	T	12	36	48	0	30	78	0	0
19	22070526	.	C	A	1	2	3	0	0	3	0	0
19	22073191	.	A	T	3	3	6	0	0	6	0	0
19	22156048	.	G	A	0	0	0	0	2	2	0	0
19	22177104	.	G	A	0	2	2	0	4	6	0	0
19	22177122	.	G	A	0	5	5	0	3	8	0	0
19	22177164	.	T	C	4	7	11	0	0	11	0	0
19	22221595	.	G	A	0	3	3	0	1	4	0	0
19	22304059	.	T	C	1	2	3	0	0	3	0	0
19	22337801	.	A	G	2	2	4	0	0	4	0	0
19	22361962	.	A	C	7	8	15	0	0	15	0	0
19	22408563	.	C	G	4	5	9	0	0	9	0	0
19	22408746	.	T	C	4	9	13	0	0	13	0	0
19	22409431	.	G	T	8	3	11	0	0	11	0	0
19	22409533	.	G	A	9	5	14	0	0	14	0	0
19	22409994	.	G	C	3	8	11	0	0	11	0	0
19	22410578	.	C	G	0	8	8	0	11	19	0	0
19	22410665	.	G	A	8	7	15	0	0	15	0	0
19	22410707	.	C	T	0	4	4	0	4	8	0	0
19	22411136	.	G	A	3	8	11	0	1	12	0	0
19	22411187	.	A	G	4	11	15	0	0	15	0	0
19	22412240	.	G	A	1	4	5	0	0	5	0	0
19	22412822	.	C	T	2	5	7	0	0	7	0	0
19	22412827	.	G	A	2	4	6	0	0	6	0	0
19	22413110	.	C	T	4	2	6	0	0	6	0	0
19	22413296	.	C	T	5	2	7	0	0	7	0	0
19	22413508	.	T	C	1	2	3	0	1	4	0	0
19	22413713	.	A	G	4	4	8	0	0	8	0	0
19	22413733	.	A	G	2	4	6	0	0	6	0	0
19	22415548	.	G	A	2	3	5	0	1	6	0	0
19	22415990	.	G	A	1	3	4	0	0	4	0	0
19	22416218	.	T	A	3	3	6	0	0	6	0	0
19	22416257	.	G	A	2	5	7	0	0	7	0	0
19	22416659	.	T	C	0	3	3	0	0	3	0	0
19	22418174	.	T	A	2	3	5	0	0	5	0	0
19	22418578	.	G	A	3	5	8	0	1	9	0	0
19	22420414	.	A	T	1	3	4	0	1	5	0	0
19	22420633	.	A	T	1	2	3	0	0	3	0	0
19	22420723	.	C	T	2	3	5	0	0	5	0	0
19	22421131	.	C	T	1	3	4	0	0	4	0	0
19	22427461	.	C	T	1	2	3	0	0	3	0	0
19	22623724	.	G	T	3	2	5	0	0	5	0	0
19	22624484	.	T	A	5	2	7	0	0	7	0	0
19	22624554	.	G	A	5	3	8	0	0	8	0	0
19	22624557	.	G	A	5	3	8	0	0	8	0	0
19	22634093	.	G	A	3	2	5	0	0	5	0	0
19	22638187	.	T	C	0	2	2	0	0	2	0	0
19	22638250	.	C	A	0	5	5	0	0	5	0	0
19	22655190	.	A	G	3	5	8	0	0	8	0	0
19	22655690	.	T	C	5	3	8	0	2	10	0	0
19	22731573	.	T	G	1	0	1	0	2	3	0	0
19	22759523	.	C	A	0	6	6	0	2	8	0	0
19	22764168	.	T	G	3	4	7	0	0	7	0	0
19	22788372	.	G	C	2	0	2	0	0	2	0	0
19	22788813	.	C	T	0	1	1	0	1	2	0	0
19	22807233	.	A	T	1	2	3	0	0	3	0	0
19	23137063	.	G	A	0	2	2	0	0	2	0	0
19	23876247	.	G	A	1	2	3	0	0	3	0	0
19	23877497	.	C	T	1	6	7	0	0	7	0	0
19	23877558	.	G	A	5	2	7	0	0	7	0	0
19	23880661	.	C	T	0	2	2	0	0	2	0	0
19	23880677	.	C	A	0	2	2	0	0	2	0	0
19	23920598	.	G	T	0	8	8	0	7	15	0	0
19	23920826	.	T	G	9	6	15	0	2	17	0	0
19	23921147	.	C	G	12	0	12	0	5	17	0	0
19	23921282	.	T	A	10	13	23	0	1	24	0	0
19	23921381	.	G	A	13	10	23	0	1	24	0	0
19	23921617	.	A	G	12	13	25	0	0	25	0	0
19	23921662	.	A	G	7	0	7	0	17	24	0	0
19	23921669	.	G	A	2	16	18	0	10	28	0	0
19	23921858	.	A	G	5	3	8	0	0	8	0	0
19	23921898	.	T	C	3	2	5	0	0	5	0	0
19	23921905	.	T	C	1	2	3	0	0	3	0	0
19	23921996	.	T	A	2	3	5	0	0	5	0	0
19	23922030	.	T	C	1	4	5	0	0	5	0	0
19	23922103	.	G	T	2	2	4	0	0	4	0	0
19	23922237	.	T	G	10	1	11	0	19	30	0	0
19	23922260	.	A	T	9	18	27	0	1	28	0	0
19	23982575	.	T	G	9	8	17	0	1	18	0	0
19	24007465	.	G	A	13	16	29	0	1	30	0	0
19	24007471	.	C	T	17	13	30	0	0	30	0	0
19	24031592	.	C	T	27	16	43	0	3	46	0	0
19	24031761	.	T	A	22	26	48	0	0	49	1	0
19	24032122	.	T	A	20	21	41	0	0	41	0	0
19	24032386	.	G	A	1	14	15	0	11	26	0	0
19	24032407	.	C	A	13	9	22	0	2	24	0	0
19	24032502	.	T	G	11	12	23	0	2	25	0	0
19	24032528	.	C	T	10	18	28	0	3	31	0	0
19	24032766	.	A	T	20	30	50	0	1	51	0	0
19	24032867	.	T	A	19	22	41	0	0	41	0	0
19	24032907	.	T	C	9	29	38	0	1	39	0	0
19	24033226	.	A	C	25	20	45	0	9	55	1	0
19	24033288	.	A	G	27	24	51	0	2	53	0	0
19	24033494	.	G	A	1	26	27	0	35	62	0	0
19	24033686	.	C	T	26	29	55	0	5	60	0	0
19	24033804	.	C	T	39	22	61	0	1	62	0	0
19	24033856	.	A	C	26	27	53	0	2	55	0	0
19	24034115	.	C	T	34	14	48	0	6	54	0	0
19	24034148	.	T	C	30	14	44	0	7	51	0	0
19	24034169	.	T	C	24	24	48	0	5	53	0	0
19	24034276	.	T	G	29	32	61	0	2	63	0	0
19	24034410	.	G	A	25	33	58	0	2	60	0	0
19	24034437	.	G	A	2	40	42	0	22	64	0	0
19	24034525	.	C	T	32	31	63	0	2	65	0	0
19	24034573	.	T	A	28	27	55	0	3	58	0	0
19	24065240	.	G	T	0	2	2	0	3	5	0	0
19	24065367	.	T	G	2	2	4	0	0	4	0	0
19	24072602	.	C	T	2	3	5	0	1	6	0	0
19	24072644	.	T	G	2	1	3	0	1	4	0	0
19	24074564	.	G	A	2	2	4	0	0	4	0	0
19	24074617	.	G	A	0	6	6	0	4	10	0	0
19	24074632	.	C	A	2	6	8	0	0	8	0	0
19	24074716	.	A	G	4	1	5	0	5	10	0	0
19	24074773	.	C	A	9	4	13	0	0	13	0	0
19	24074794	.	A	G	8	4	12	0	0	12	0	0
19	24074812	.	G	A	6	4	10	0	1	11	0	0
19	24123917	.	G	C	3	2	5	0	0	5	0	0
19	24123919	.	A	T	3	2	5	0	0	5	0	0
19	24124577	.	C	A	3	1	4	0	0	4	0	0
19	24127564	.	T	A	1	2	3	0	0	3	0	0
19	24128693	.	T	C	2	2	4	0	0	4	0	0
19	24128743	.	A	T	4	2	6	0	0	6	0	0
19	24129199	.	A	T	1	5	6	0	0	6	0	0
19	24129244	.	C	T	4	2	6	0	0	6	0	0
19	24129343	.	C	T	1	5	6	0	0	6	0	0
19	24129347	.	T	C	1	0	1	0	5	6	0	0
19	24129559	.	A	T	5	2	7	0	0	7	0	0
19	24129574	.	A	C	5	2	7	0	0	7	0	0
19	24130139	.	G	A	4	2	6	0	1	7	0	0
19	24130179	.	G	T	3	4	7	0	0	7	0	0
19	24130685	.	C	G	2	5	7	0	0	7	0	0
19	24131162	.	C	G	2	1	3	0	0	3	0	0
19	24263944	.	A	G	2	3	5	0	0	5	0	0
19	24264105	.	G	A	1	3	4	0	0	4	0	0
19	24264106	.	C	G	0	3	3	0	1	4	0	0
19	24385036	.	T	C	0	1	1	0	0	1	0	0
19	24385063	.	A	C	1	0	1	0	0	1	0	0
19	24388639	.	T	C	2	2	4	0	1	5	0	0
19	24388927	.	C	A	3	3	6	0	0	6	0	0
19	24388987	.	A	G	1	0	1	0	4	5	0	0
19	24389280	.	G	A	3	1	4	0	1	5	0	0
19	24389282	.	A	G	3	2	5	0	0	5	0	0
19	24390282	.	T	C	1	5	6	0	0	6	0	0
19	24390379	.	A	C	1	3	4	0	0	4	0	0
19	24391232	.	A	G	1	0	1	0	2	3	0	0
19	24391234	.	A	T	1	2	3	0	0	3	0	0
19	24391280	.	T	G	4	4	8	0	0	8	0	0
19	24391289	.	G	A	5	4	9	0	0	9	0	0
19	24391373	.	T	C	1	7	8	0	0	8	0	0
19	24391726	.	G	A	2	3	5	0	1	6	0	0
19	24397019	.	G	A	1	2	3	0	0	3	0	0
19	24448940	.	T	C	5	3	8	0	0	8	0	0
19	24448985	.	T	C	1	0	1	0	7	8	0	0
19	24450912	.	G	A	1	4	5	0	0	5	0	0
19	24488728	.	A	T	4	2	6	0	0	6	0	0
19	24491086	.	A	T	4	1	5	0	0	5	0	0
19	24491140	.	G	T	0	6	6	0	0	6	0	0
19	24491224	.	C	T	6	3	9	0	1	10	0	0
19	24491230	.	A	T	7	3	10	0	0	10	0	0
19	24491268	.	C	T	4	3	7	0	0	7	0	0
19	24491982	.	G	C	7	11	18	0	1	19	0	0
19	24596426	.	C	T	5	4	9	0	0	9	0	0
19	24596635	.	G	A	1	6	7	0	0	7	0	0
19	24596665	.	C	T	2	3	5	0	1	6	0	0
19	24596839	.	C	T	4	6	10	0	0	10	0	0
19	24596989	.	G	C	3	4	7	0	1	8	0	0
19	24597055	.	C	A	4	3	7	0	1	8	0	0
19	24597082	.	T	G	7	0	7	0	4	11	0	0
19	24597091	.	C	T	5	4	9	0	0	9	0	0
19	24597217	.	T	A	7	2	9	0	0	9	0	0
19	24597268	.	A	G	7	3	10	0	0	10	0	0
19	24757063	.	T	C	1	1	2	0	0	2	0	0
19	24882961	.	G	A	8	5	13	0	0	13	0	0
19	24888024	.	A	G	9	13	22	0	1	23	0	0
19	24888090	.	A	T	15	22	37	0	0	37	0	0
19	24888187	.	C	T	16	17	33	0	3	36	0	0
19	24888195	.	A	T	18	12	30	0	2	32	0	0
19	24888398	.	G	A	0	16	16	0	21	37	0	0
19	24888748	.	T	C	15	20	35	0	2	38	1	0
19	24906427	.	G	A	0	4	4	0	3	7	0	0
19	24909651	.	T	C	0	1	1	0	1	2	0	0
19	24914462	.	C	T	2	5	7	0	0	7	0	0
19	24914632	.	T	C	1	2	3	0	0	3	0	0
19	24914799	.	T	G	2	3	5	0	0	5	0	0
19	24915229	.	T	G	4	2	6	0	0	6	0	0
19	24915403	.	G	A	0	3	3	0	4	7	0	0
19	24915742	.	T	A	2	1	3	0	2	5	0	0
19	24915782	.	G	A	0	2	2	0	3	5	0	0
19	24915796	.	A	G	3	3	6	0	0	6	0	0
19	24916007	.	T	G	4	4	8	0	0	8	0	0
19	24916427	.	C	T	5	6	11	0	1	12	0	0
19	24916445	.	A	T	3	7	10	0	0	10	0	0
19	24916766	.	T	G	5	4	9	0	0	9	0	0
19	25089839	.	A	G	8	8	16	0	1	17	0	0
19	25089979	.	A	G	6	8	14	0	0	14	0	0
19	25090032	.	T	G	7	9	16	0	0	16	0	0
19	25090079	.	A	G	9	5	14	0	0	14	0	0
19	25090231	.	T	C	1	2	3	0	0	3	0	0
19	25113207	.	C	A	11	8	19	0	0	19	0	0
19	25113524	.	T	C	6	7	13	0	0	13	0	0
19	25156378	.	T	A	5	4	9	0	1	10	0	0
19	25156453	.	A	G	5	11	16	0	0	16	0	0
19	25156458	.	A	T	5	11	16	0	0	16	0	0
19	25156572	.	C	T	8	10	18	0	0	18	0	0
19	25156639	.	T	C	9	1	10	0	14	24	0	0
19	25156669	.	T	C	10	10	20	0	0	20	0	0
19	25156717	.	A	C	10	4	14	0	0	14	0	0
19	25156774	.	T	A	11	7	18	0	0	18	0	0
19	25156959	.	A	T	7	15	22	0	0	22	0	0
19	25163587	.	G	A	16	19	35	0	5	40	0	0
19	25163633	.	G	T	17	13	30	0	2	32	0	0
19	25169531	.	A	C	0	0	0	0	1	1	0	0
19	25270949	.	A	G	7	5	12	0	1	13	0	0
19	25352327	.	T	C	2	7	9	0	0	9	0	0
19	25352503	.	G	A	9	6	15	0	2	17	0	0
19	25352702	.	A	C	7	5	12	0	0	12	0	0
19	25352789	.	T	C	6	14	20	0	0	20	0	0
19	25352901	.	A	T	8	9	17	0	0	17	0	0
19	25353088	.	A	G	9	11	20	0	0	20	0	0
19	25367246	.	G	A	1	3	4	0	1	5	0	0
19	25367270	.	T	C	7	0	7	0	7	14	0	0
19	25367291	.	C	T	0	9	9	0	8	17	0	0
19	25367414	.	A	C	3	0	3	0	2	5	0	0
19	25370392	.	G	A	3	12	15	0	1	16	0	0
19	25370730	.	C	T	2	4	6	0	0	6	0	0
19	25435364	.	G	A	3	2	5	0	0	5	0	0
19	25435501	.	T	G	0	1	1	0	0	1	0	0
19	25448120	.	G	A	0	1	1	0	0	1	0	0
19	25526483	.	G	A	0	5	5	0	4	9	0	0
19	25526529	.	T	C	7	5	12	0	0	12	0	0
19	25548114	.	C	G	9	8	17	0	2	19	0	0
19	25652962	.	C	T	8	10	18	0	7	25	0	0
19	25653042	.	C	T	12	27	39	0	4	43	0	0
19	25653147	.	C	T	6	13	19	0	3	22	0	0
19	25653170	.	G	T	1	10	11	0	10	21	0	0
19	25657306	.	C	A	2	3	5	0	1	6	0	0
19	25680169	.	A	T	3	6	9	0	0	9	0	0
19	25680170	.	C	T	3	6	9	0	0	9	0	0
19	25680248	.	A	T	4	2	6	0	0	6	0	0
19	25682029	.	G	A	4	2	6	0	1	7	0	0
19	25699903	.	G	A	1	0	1	0	0	1	0	0
19	25699929	.	G	A	1	0	1	0	0	1	0	0
19	26164906	.	G	A	5	3	8	0	0	8	0	0
19	26235083	.	G	A	4	9	13	0	2	15	0	0
19	26235089	.	C	T	4	9	13	0	3	16	0	0
19	26369614	.	C	T	4	3	7	0	0	7	0	0
19	26370720	.	A	T	5	2	7	0	0	7	0	0
19	26370726	.	C	T	2	5	7	0	0	7	0	0
19	26375471	.	C	T	2	1	3	0	0	3	0	0
19	26375643	.	T	G	7	9	16	0	1	17	0	0
19	26375699	.	G	T	8	7	15	0	0	15	0	0
19	26377775	.	A	T	2	2	4	0	0	4	0	0
19	26377946	.	T	A	3	3	6	0	0	6	0	0
19	26378250	.	T	C	4	3	7	0	1	8	0	0
19	26378265	.	G	A	2	4	6	0	0	6	0	0
19	26378447	.	T	A	6	5	11	0	2	13	0	0
19	26378451	.	G	A	6	4	10	0	2	12	0	0
19	26521070	.	G	A	0	1	1	0	1	2	0	0
19	26628037	.	A	G	2	2	4	0	0	4	0	0
19	26628173	.	T	A	1	5	6	0	0	6	0	0
19	26628244	.	C	T	3	3	6	0	0	6	0	0
19	26628279	.	C	T	4	3	7	0	0	7	0	0
19	26628287	.	G	A	3	3	6	0	0	6	0	0
19	26628825	.	G	A	0	4	4	0	4	8	0	0
19	26628907	.	G	C	2	3	5	0	0	5	0	0
19	26628980	.	C	A	3	2	5	0	0	5	0	0
19	26657193	.	T	C	2	0	2	0	0	2	0	0
19	26669225	.	G	A	3	2	5	0	1	6	0	0
19	26669228	.	T	C	4	2	6	0	0	6	0	0
19	26702403	.	A	G	1	0	1	0	1	2	0	0
19	26706935	.	G	A	1	2	3	0	0	3	0	0
19	26706947	.	C	T	3	2	5	0	0	5	0	0
19	26707150	.	T	C	1	0	1	0	0	1	0	0
19	26707167	.	A	G	1	0	1	0	0	1	0	0
19	26707185	.	C	T	1	0	1	0	0	1	0	0
19	26707384	.	T	C	3	2	5	0	0	5	0	0
19	26710828	.	C	T	1	1	2	0	0	2	0	0
19	26711085	.	C	T	1	1	2	0	2	4	0	0
19	26711151	.	A	T	4	3	7	0	0	7	0	0
19	26711447	.	G	A	2	2	4	0	0	4	0	0
19	26711534	.	A	G	1	3	4	0	0	4	0	0
19	26715006	.	A	G	3	0	3	0	2	5	0	0
19	26717511	.	G	T	1	3	4	0	1	5	0	0
19	26717549	.	T	C	1	2	3	0	0	3	0	0
19	26718204	.	C	T	0	2	2	0	0	2	0	0
19	26718261	.	G	C	0	2	2	0	0	2	0	0
19	26721300	.	C	T	1	2	3	0	0	3	0	0
19	26723474	.	G	C	0	1	1	0	0	1	0	0
19	26723498	.	A	G	1	2	3	0	0	3	0	0
19	26723690	.	G	A	5	6	11	0	1	12	0	0
19	26723705	.	A	T	7	8	15	0	0	15	0	0
19	26727535	.	G	A	0	2	2	0	3	5	0	0
19	26729597	.	A	T	4	7	11	0	1	12	0	0
19	26729651	.	T	C	7	8	15	0	0	15	0	0
19	26729811	.	A	C	4	9	13	0	0	13	0	0
19	26729867	.	C	T	3	5	8	0	1	9	0	0
19	26730073	.	A	T	3	6	9	0	0	9	0	0
19	26730077	.	G	T	7	4	11	0	0	11	0	0
19	26730108	.	A	G	4	0	4	0	9	13	0	0
19	26730545	.	C	T	16	16	32	0	1	33	0	0
19	26730642	.	T	C	22	0	22	0	23	45	0	0
19	26731183	.	C	T	1	13	14	0	5	19	0	0
19	26741296	.	C	G	18	23	41	0	2	43	0	0
19	26741378	.	T	C	23	0	23	0	17	41	1	0
19	26741427	.	G	A	21	20	41	0	4	45	0	0
19	26741831	.	C	T	1	18	19	0	14	33	0	0
19	26741918	.	G	T	13	19	32	0	0	32	0	0
19	26742224	.	T	C	8	13	21	0	0	21	0	0
19	26742321	.	G	A	22	7	29	0	0	29	0	0
19	26742379	.	A	C	10	0	10	0	19	29	0	0
19	26742598	.	A	T	20	13	33	0	2	35	0	0
19	26742716	.	T	A	15	22	37	0	4	41	0	0
19	26742732	.	A	G	18	18	36	0	0	36	0	0
19	26742751	.	C	T	23	25	48	0	0	48	0	0
19	26743295	.	A	T	11	18	29	0	1	30	0	0
19	26743446	.	T	A	24	19	43	0	3	46	0	0
19	26743781	.	G	A	11	20	31	0	1	32	0	0
19	26743808	.	C	T	6	28	34	0	1	35	0	0
19	26743900	.	T	A	14	15	29	0	1	30	0	0
19	26743943	.	C	T	10	13	23	0	2	25	0	0
19	26743984	.	A	G	13	10	23	0	0	23	0	0
19	26744235	.	G	T	10	14	24	0	1	25	0	0
19	26744840	.	C	T	16	14	30	0	2	32	0	0
19	26745392	.	T	A	12	10	22	0	3	25	0	0
19	26746246	.	C	T	0	0	0	0	1	1	0	0
19	26747192	.	C	T	7	6	13	0	1	14	0	0
19	26747682	.	G	A	8	11	19	0	2	21	0	0
19	26747979	.	C	T	6	8	14	0	0	14	0	0
19	26748003	.	T	G	3	4	7	0	1	8	0	0
19	26748499	.	G	C	8	0	8	0	6	14	0	0
19	26756636	.	G	A	8	3	11	0	0	11	0	0
19	26810460	.	C	T	3	5	8	0	2	10	0	0
19	26813901	.	G	A	1	5	6	0	0	6	0	0
19	26821825	.	C	T	0	2	2	0	1	3	0	0
19	26860799	.	T	C	7	0	7	0	5	12	0	0
19	26868876	.	C	T	10	8	18	0	2	20	0	0
19	26868899	.	G	A	12	14	26	0	3	29	0	0
19	26868963	.	A	G	11	3	14	0	0	14	0	0
19	26872742	.	C	A	2	2	4	0	0	4	0	0
19	26872898	.	C	T	0	12	12	0	0	12	0	0
19	26911189	.	T	C	1	2	3	0	0	3	0	0
19	26925526	.	G	A	3	5	8	0	1	9	0	0
19	26928320	.	C	T	10	14	24	0	2	26	0	0
19	26928356	.	A	G	14	12	26	0	3	29	0	0
19	26928399	.	A	C	9	3	12	0	0	12	0	0
19	26931520	.	G	A	11	12	23	0	0	23	0	0
19	26931680	.	T	A	7	7	14	0	0	14	0	0
19	26931730	.	T	A	5	8	13	0	0	13	0	0
19	26931732	.	A	T	8	5	13	0	0	13	0	0
19	26931765	.	G	A	0	9	9	0	1	10	0	0
19	26938030	.	G	A	3	2	5	0	0	5	0	0
19	26938379	.	A	G	1	2	3	0	1	4	0	0
19	26958349	.	G	A	4	5	9	0	1	10	0	0
19	26958687	.	T	G	2	8	10	0	0	10	0	0
19	26964306	.	T	A	1	2	3	0	0	3	0	0
19	26964308	.	G	A	1	2	3	0	0	3	0	0
19	26967634	.	G	T	10	9	19	0	0	19	0	0
19	26967780	.	C	T	3	3	6	0	0	6	0	0
19	26967783	.	T	G	3	3	6	0	0	6	0	0
19	27043887	.	A	G	16	10	26	0	3	29	0	0
19	27073262	.	A	G	5	0	5	0	0	5	0	0
19	27105078	.	G	A	8	8	16	0	0	16	0	0
19	27195604	.	A	G	0	2	2	0	0	2	0	0
19	27260458	.	A	C	7	0	7	0	4	11	0	0
19	27260494	.	C	A	0	2	2	0	10	12	0	0
19	27260495	.	G	A	10	2	12	0	0	12	0	0
19	27260629	.	C	T	0	5	5	0	3	8	0	0
19	27260906	.	T	C	1	0	1	0	3	4	0	0
19	27283342	.	C	G	9	3	12	0	1	13	0	0
19	27283472	.	A	T	9	2	11	0	1	12	0	0
19	27283557	.	C	A	6	5	11	0	0	11	0	0
19	27283612	.	A	G	9	4	13	0	1	14	0	0
19	27283783	.	G	C	4	7	11	0	1	12	0	0
19	27283940	.	C	T	4	7	11	0	0	11	0	0
19	27284178	.	G	A	6	6	12	0	0	12	0	0
19	27284195	.	T	G	9	5	14	0	0	14	0	0
19	27284387	.	A	G	5	7	12	0	0	12	0	0
19	27284741	.	C	T	3	4	7	0	0	7	0	0
19	27284744	.	C	T	3	4	7	0	0	7	0	0
19	27284817	.	A	C	4	6	10	0	1	11	0	0
19	27284860	.	C	T	1	6	7	0	0	7	0	0
19	27285935	.	T	C	1	2	3	0	0	3	0	0
19	27286084	.	A	C	2	2	4	0	0	4	0	0
19	27286354	.	C	T	4	2	6	0	1	7	0	0
19	27286444	.	C	T	5	2	7	0	1	8	0	0
19	27286590	.	G	C	3	0	3	0	4	7	0	0
19	27286940	.	C	T	3	3	6	0	0	6	0	0
19	27286966	.	A	T	1	4	5	0	2	7	0	0
19	27287204	.	T	C	8	8	16	0	0	16	0	0
19	27287294	.	T	G	11	4	15	0	0	15	0	0
19	27287492	.	T	A	4	5	9	0	1	10	0	0
19	27307583	.	G	A	5	4	9	0	0	9	0	0
19	27314273	.	T	C	7	2	9	0	0	9	0	0
19	27314393	.	C	G	7	6	13	0	0	13	0	0
19	27321573	.	C	G	6	7	13	0	0	13	0	0
19	27321615	.	A	G	3	1	4	0	0	4	0	0
19	27334273	.	A	T	4	6	10	0	0	10	0	0
19	27354331	.	C	A	8	2	10	0	0	10	0	0
19	27357250	.	C	A	6	5	11	0	0	11	0	0
19	27357485	.	A	T	8	7	15	0	0	15	0	0
19	27357567	.	T	A	5	7	12	0	0	12	0	0
19	27368719	.	T	C	3	6	9	0	0	9	0	0
19	27368800	.	T	C	2	1	3	0	4	7	0	0
19	27368806	.	T	A	0	5	5	0	0	5	0	0
19	27368870	.	A	G	1	4	5	0	0	5	0	0
19	27369147	.	G	A	1	4	5	0	0	5	0	0
19	27369553	.	T	C	1	4	5	0	0	5	0	0
19	27369659	.	A	T	6	5	11	0	0	11	0	0
19	27369795	.	T	C	3	1	4	0	1	5	0	0
19	27369853	.	T	A	5	4	9	0	0	9	0	0
19	27369890	.	T	C	2	0	2	0	4	6	0	0
19	27370197	.	C	A	2	5	7	0	0	7	0	0
19	27370232	.	C	A	4	2	6	0	0	6	0	0
19	27370774	.	A	T	1	5	6	0	1	7	0	0
19	27370805	.	C	T	0	5	5	0	2	7	0	0
19	27370827	.	C	T	0	2	2	0	3	5	0	0
19	27371290	.	A	T	1	5	6	0	0	6	0	0
19	27395471	.	A	T	2	7	9	0	0	9	0	0
19	27401515	.	C	T	1	0	1	0	0	1	0	0
19	27401680	.	G	A	4	6	10	0	0	10	0	0
19	27430422	.	G	T	1	1	2	0	0	2	0	0
19	27430455	.	G	A	1	1	2	0	0	2	0	0
19	27437074	.	C	T	0	2	2	0	0	2	0	0
19	27437746	.	C	G	1	2	3	0	0	3	0	0
19	27457166	.	T	C	5	0	5	0	13	18	0	0
19	27457213	.	T	C	8	7	15	0	1	16	0	0
19	27457505	.	G	T	5	7	12	0	0	12	0	0
19	27457516	.	T	G	4	6	10	0	2	12	0	0
19	27457607	.	C	T	8	5	13	0	1	14	0	0
19	27457621	.	T	A	4	9	13	0	1	14	0	0
19	27457749	.	C	T	8	11	19	0	0	19	0	0
19	27457892	.	T	C	11	8	19	0	0	19	0	0
19	27457989	.	T	A	3	4	7	0	0	7	0	0
19	27461139	.	C	T	0	6	6	0	11	17	0	0
19	27461183	.	C	T	8	11	19	0	1	20	0	0
19	27462092	.	A	T	2	2	4	0	1	5	0	0
19	27462620	.	C	A	3	3	6	0	0	6	0	0
19	27464344	.	A	T	2	1	3	0	0	3	0	0
19	27468983	.	A	C	9	4	13	0	2	15	0	0
19	27469060	.	C	G	0	4	4	0	12	16	0	0
19	27469130	.	A	G	5	3	8	0	0	8	0	0
19	27469178	.	A	C	1	3	4	0	3	7	0	0
19	27469184	.	G	A	4	2	6	0	1	7	0	0
19	27505122	.	G	A	1	6	7	0	3	10	0	0
19	27505191	.	G	A	0	5	5	0	12	17	0	0
19	27505211	.	G	A	9	7	16	0	1	17	0	0
19	27505962	.	G	T	4	4	8	0	1	9	0	0
19	27609998	.	C	T	13	9	22	0	0	22	0	0
19	27616055	.	C	T	6	6	12	0	0	12	0	0
19	27616337	.	G	A	10	8	18	0	1	19	0	0
19	27623285	.	C	T	9	7	16	0	0	16	0	0
19	27634823	.	C	T	3	6	9	0	0	9	0	0
19	27739549	.	C	T	1	3	4	0	0	4	0	0
19	28281242	.	T	A	2	2	4	0	0	4	0	0
19	28281343	.	G	A	8	3	11	0	1	12	0	0
19	28281351	.	T	G	3	2	5	0	1	6	0	0
19	28283749	.	C	T	1	14	15	0	13	28	0	0
19	28283786	.	C	T	28	20	48	0	2	50	0	0
19	28284146	.	T	A	4	5	9	0	0	9	0	0
19	28284203	.	A	T	10	7	17	0	1	18	0	0
19	28284220	.	T	A	7	4	11	0	0	11	0	0
19	28288148	.	C	T	0	3	3	0	0	3	0	0
19	28288480	.	G	A	14	8	22	0	0	22	0	0
19	28288489	.	C	T	13	7	20	0	0	20	0	0
19	28359920	.	G	A	11	9	20	0	2	22	0	0
19	28360028	.	T	G	1	2	3	0	0	3	0	0
19	28360029	.	C	T	1	2	3	0	0	3	0	0
19	28787154	.	C	T	17	10	27	0	2	29	0	0
19	28788220	.	A	G	11	14	25	0	1	26	0	0
19	28788430	.	T	A	14	19	33	0	1	34	0	0
19	28802039	.	A	G	3	6	9	0	0	9	0	0
19	28802469	.	G	A	3	4	7	0	2	9	0	0
19	28802487	.	G	T	4	2	6	0	1	7	0	0
19	28802954	.	C	A	24	15	39	0	3	42	0	0
19	28803173	.	G	A	24	27	51	0	2	53	0	0
19	28803267	.	G	A	2	13	15	0	14	29	0	0
19	28820643	.	C	T	12	22	34	0	1	35	0	0
19	28821230	.	G	A	8	11	19	0	0	19	0	0
19	28821333	.	G	A	0	18	18	0	9	27	0	0
19	28821334	.	G	T	9	17	26	0	1	27	0	0
19	28821383	.	A	C	7	6	13	0	0	13	0	0
19	28821666	.	G	C	9	21	30	0	0	30	0	0
19	28822057	.	T	C	11	14	25	0	0	25	0	0
19	28822187	.	C	T	18	15	33	0	0	33	0	0
19	28822521	.	A	G	7	5	12	0	0	12	0	0
19	28822624	.	G	A	3	8	11	0	1	12	0	0
19	28822794	.	A	T	2	3	5	0	1	6	0	0
19	28822877	.	C	T	5	8	13	0	0	13	0	0
19	28823124	.	C	T	0	6	6	0	1	7	0	0
19	28823162	.	T	C	0	4	4	0	0	4	0	0
19	28823385	.	A	T	4	4	8	0	1	9	0	0
19	28823987	.	C	G	2	2	4	0	0	4	0	0
19	29296514	.	T	A	1	2	3	0	0	3	0	0
19	29305506	.	C	T	1	1	2	0	0	2	0	0
19	29310226	.	G	A	0	1	1	0	4	5	0	0
19	29318861	.	A	C	6	2	8	0	1	9	0	0
19	29327825	.	A	G	2	0	2	0	3	5	0	0
19	29333382	.	C	T	4	8	12	0	0	12	0	0
19	29333565	.	G	A	1	3	4	0	0	4	0	0
19	29333597	.	A	C	1	2	3	0	0	3	0	0
19	29383644	.	C	T	0	14	14	0	9	23	0	0
19	29383675	.	G	C	10	11	21	0	0	21	0	0
19	29799885	.	C	T	42	30	72	0	11	83	0	0
19	29799900	.	T	C	45	27	72	0	5	77	0	0
19	29800229	.	A	G	31	38	69	0	0	69	0	0
19	29812799	.	G	T	0	2	2	0	0	2	0	0
19	29815096	.	T	C	19	25	44	0	4	48	0	0
19	29817914	.	C	G	22	6	28	0	3	31	0	0
19	29818142	.	C	T	27	23	50	0	5	55	0	0
19	29822615	.	C	T	0	9	9	0	12	21	0	0
19	29830215	.	G	A	16	19	35	0	1	36	0	0
19	29832781	.	G	A	3	12	15	1	0	16	0	0
19	29836645	.	T	C	5	1	6	0	10	16	0	0
19	29836779	.	A	G	4	3	7	0	0	7	0	0
19	29836821	.	T	G	6	3	9	0	0	9	0	0
19	29837705	.	C	T	0	2	2	0	1	3	0	0
19	29837964	.	C	T	8	10	18	0	1	19	0	0
19	29852666	.	C	T	1	1	2	0	1	3	0	0
19	29861961	.	C	A	0	6	6	0	3	9	0	0
19	29866559	.	G	A	2	13	15	0	0	15	0	0
19	29866630	.	C	T	1	6	7	0	6	13	0	0
19	29866882	.	G	A	2	7	9	0	1	10	0	0
19	29866918	.	G	A	0	2	2	0	0	2	0	0
19	29872768	.	C	T	0	1	1	0	1	2	0	0
19	29872783	.	C	T	0	1	1	0	1	2	0	0
19	29878311	.	T	C	1	0	1	0	0	1	0	0
19	29878997	.	C	T	2	1	3	0	0	3	0	0
19	29879060	.	G	A	2	3	5	0	0	5	0	0
19	29879063	.	G	A	3	2	5	0	0	5	0	0
19	30348804	.	G	A	15	11	26	0	1	27	0	0
19	30349310	.	A	T	15	8	23	0	2	25	0	0
19	30349553	.	C	G	1	8	9	0	11	20	0	0
19	30355383	.	T	C	9	13	22	0	2	24	0	0
19	30355907	.	A	T	3	6	9	0	0	9	0	0
19	30391968	.	G	T	0	1	1	0	0	1	0	0
19	30393919	.	C	A	2	0	2	0	0	2	0	0
19	30393967	.	T	C	2	0	2	0	0	2	0	0
19	30410192	.	G	A	3	2	5	0	0	5	0	0
19	30410406	.	A	G	13	13	26	0	2	28	0	0
19	30413354	.	G	A	4	4	8	0	0	8	0	0
19	30416170	.	T	C	4	0	4	0	0	4	0	0
19	30423199	.	A	T	2	2	4	0	0	4	0	0
19	30423209	.	A	G	1	1	2	0	1	3	0	0
19	30423366	.	A	G	0	1	1	0	0	1	0	0
19	30423368	.	G	A	0	1	1	0	0	1	0	0
19	30425616	.	G	T	2	2	4	0	2	6	0	0
19	30425622	.	T	C	3	3	6	0	0	6	0	0
19	30428688	.	A	C	9	10	19	0	0	19	0	0
19	30428726	.	A	G	9	0	9	0	8	17	0	0
19	30429063	.	G	A	10	3	13	0	2	15	0	0
19	30436629	.	G	A	0	2	2	0	0	2	0	0
19	30436891	.	G	A	3	3	6	0	0	6	0	0
19	30438518	.	A	G	2	1	3	0	0	3	0	0
19	30441396	.	A	G	0	1	1	0	0	1	0	0
19	30441399	.	A	G	0	1	1	0	0	1	0	0
19	30442717	.	C	A	1	0	1	0	0	1	0	0
19	30445915	.	C	A	1	2	3	0	0	3	0	0
19	30445927	.	A	G	1	3	4	0	0	4	0	0
19	30446181	.	T	A	1	1	2	0	0	2	0	0
19	30447533	.	C	T	4	5	9	0	0	9	0	0
19	30450234	.	T	C	3	4	7	0	0	7	0	0
19	30450375	.	C	T	0	1	1	0	0	1	0	0
19	30455640	.	T	C	4	2	6	0	0	6	0	0
19	30455650	.	T	C	5	2	7	0	0	7	0	0
19	30455675	.	T	C	7	2	9	0	0	9	0	0
19	30455697	.	A	G	6	4	10	0	0	10	0	0
19	30457770	.	A	T	6	5	11	0	3	14	0	0
19	30458039	.	C	A	15	9	24	0	0	24	0	0
19	30458103	.	G	A	0	10	10	0	7	17	0	0
19	30521443	.	C	A	5	3	8	0	1	9	0	0
19	30521782	.	T	A	3	3	6	0	0	6	0	0
19	31789533	.	C	G	0	2	2	0	4	6	0	0
19	32050593	.	A	T	0	15	15	0	0	15	0	0
19	32149988	.	A	C	10	8	18	0	2	20	0	0
19	32167216	.	T	C	3	1	4	0	0	4	0	0
19	32202227	.	T	C	1	3	4	0	0	4	0	0
19	32457264	.	C	G	4	2	6	0	1	7	0	0
19	32457390	.	T	C	2	6	8	0	0	8	0	0
19	32457564	.	T	C	1	6	7	0	1	8	0	0
19	32458152	.	C	T	6	4	10	0	1	11	0	0
19	32458158	.	T	C	4	4	8	0	3	11	0	0
19	32458422	.	G	A	0	3	3	0	0	3	0	0
19	32458431	.	G	A	0	5	5	0	0	5	0	0
19	32461473	.	C	T	1	3	4	0	0	4	0	0
19	32473399	.	A	G	2	3	5	0	0	5	0	0
19	32473451	.	G	A	1	2	3	0	0	3	0	0
19	32474355	.	T	A	6	3	9	0	0	9	0	0
19	32474723	.	G	T	1	1	2	0	2	4	0	0
19	32474885	.	A	G	2	3	5	0	0	5	0	0
19	32487242	.	T	C	1	2	3	0	0	3	0	0
19	32487373	.	T	C	1	2	3	0	0	3	0	0
19	32490113	.	A	G	1	2	3	0	1	4	0	0
19	32497388	.	C	T	1	1	2	0	1	3	0	0
19	32499736	.	G	A	2	1	3	0	0	3	0	0
19	32499932	.	G	A	3	5	8	0	0	8	0	0
19	32499983	.	G	A	3	3	6	0	0	6	0	0
19	32500236	.	T	C	2	4	6	0	1	7	0	0
19	32500269	.	G	A	3	2	5	0	0	5	0	0
19	32505825	.	C	T	3	2	5	0	0	5	0	0
19	32505846	.	C	A	4	4	8	0	0	8	0	0
19	32505875	.	C	T	0	7	7	0	5	12	0	0
19	32505927	.	G	T	4	9	13	0	1	14	0	0
19	32515377	.	T	A	4	10	14	0	0	14	0	0
19	32572647	.	T	C	4	7	11	0	1	12	0	0
19	32572999	.	A	T	6	4	10	0	0	10	0	0
19	32573001	.	T	A	6	4	10	0	0	10	0	0
19	32573057	.	G	A	8	5	13	0	0	13	0	0
19	32573064	.	C	T	7	5	12	0	0	12	0	0
19	32573100	.	C	A	6	7	13	0	0	13	0	0
19	32573173	.	T	C	9	0	9	0	4	13	0	0
19	32573193	.	A	G	9	3	12	0	1	13	0	0
19	32573229	.	A	G	11	5	16	0	3	19	0	0
19	32573269	.	T	C	7	9	16	0	1	17	0	0
19	32575190	.	G	A	2	3	5	0	0	5	0	0
19	32582654	.	A	G	1	2	3	0	0	3	0	0
19	32588706	.	C	T	4	3	7	0	0	7	0	0
19	32588775	.	G	A	3	4	7	0	0	7	0	0
19	32600644	.	C	T	0	0	0	0	1	1	0	0
19	32600720	.	A	C	4	3	7	0	0	7	0	0
19	32623687	.	G	A	27	27	54	0	2	56	0	0
19	32624048	.	A	C	18	28	46	0	3	49	0	0
19	32624138	.	G	A	26	16	42	0	4	46	0	0
19	32624247	.	A	G	24	23	47	0	1	48	0	0
19	32638212	.	G	A	21	25	46	0	4	50	0	0
19	32767889	.	A	G	3	2	5	0	0	5	0	0
19	32767891	.	T	A	2	2	4	0	1	5	0	0
19	32767965	.	C	T	2	6	8	0	0	8	0	0
19	32768397	.	C	G	3	4	7	0	1	8	0	0
19	32768434	.	T	C	2	5	7	0	0	7	0	0
19	32768551	.	C	T	2	3	5	0	0	5	0	0
19	32768668	.	T	C	4	3	7	0	0	7	0	0
19	32768763	.	T	C	2	2	4	0	0	4	0	0
19	32768771	.	G	A	2	1	3	0	0	3	0	0
19	32768935	.	T	G	2	4	6	0	0	6	0	0
19	32768954	.	A	C	2	4	6	0	0	6	0	0
19	32768985	.	G	A	1	4	5	0	0	5	0	0
19	32769296	.	T	C	1	4	5	0	0	5	0	0
19	32769385	.	G	T	2	3	5	0	0	5	0	0
19	32770917	.	G	A	1	2	3	0	0	3	0	0
19	32807915	.	A	G	1	3	4	0	0	4	0	0
19	32807933	.	A	C	0	2	2	0	0	2	0	0
19	32808140	.	C	T	0	2	2	0	0	2	0	0
19	32808332	.	G	T	0	3	3	0	0	3	0	0
19	32814334	.	G	T	5	1	6	0	1	7	0	0
19	32818503	.	G	T	0	7	7	0	3	10	0	0
19	32818824	.	A	G	7	11	18	0	1	19	0	0
19	32818825	.	G	A	8	11	19	0	0	19	0	0
19	32818910	.	G	A	1	4	5	0	1	6	0	0
19	32819234	.	G	A	11	9	20	0	1	21	0	0
19	32819303	.	T	C	13	15	28	0	0	28	0	0
19	32819347	.	C	T	13	13	26	0	1	27	0	0
19	32819640	.	A	G	5	8	13	0	0	13	0	0
19	32819760	.	A	T	3	3	6	0	0	6	0	0
19	32819798	.	C	T	3	5	8	0	0	8	0	0
19	32838396	.	T	A	7	4	11	0	3	14	0	0
19	32860668	.	G	T	14	7	21	0	2	23	0	0
19	32864963	.	T	G	10	7	17	0	1	18	0	0
19	32865113	.	G	A	29	13	42	0	2	44	0	0
19	32865276	.	A	T	13	12	25	0	0	25	0	0
19	32865337	.	C	A	11	14	25	0	2	27	0	0
19	32865347	.	C	T	11	15	26	0	0	26	0	0
19	32865504	.	G	T	14	1	15	0	0	15	0	0
19	32865562	.	C	A	12	0	12	0	0	12	0	0
19	32865569	.	A	G	11	1	12	0	0	12	0	0
19	32865832	.	A	G	2	3	5	0	0	5	0	0
19	32866126	.	A	C	12	6	18	0	1	19	0	0
19	32866234	.	T	G	13	4	17	0	0	17	0	0
19	32866264	.	G	C	17	0	17	0	7	24	0	0
19	32866322	.	A	G	9	8	17	0	2	19	0	0
19	32866362	.	T	A	9	10	19	0	0	19	0	0
19	32866372	.	C	T	7	9	16	0	1	17	0	0
19	32866475	.	T	A	12	15	27	0	0	27	0	0
19	32866570	.	T	A	21	10	31	0	1	32	0	0
19	32866571	.	A	G	22	10	32	0	0	32	0	0
19	32867218	.	G	A	11	10	21	0	2	23	0	0
19	32867274	.	A	T	18	8	26	0	1	27	0	0
19	32872674	.	A	G	8	7	15	0	0	15	0	0
19	32878103	.	G	A	1	1	2	0	0	2	0	0
19	32878370	.	A	G	5	6	11	0	0	11	0	0
19	32884181	.	A	G	0	1	1	0	0	1	0	0
19	32895622	.	C	A	3	6	9	0	0	9	0	0
19	32895748	.	G	T	15	14	29	0	1	30	0	0
19	32895873	.	T	A	2	14	16	0	3	19	0	0
19	32896001	.	G	A	8	10	18	0	0	18	0	0
19	32896336	.	G	T	5	5	10	0	0	10	0	0
19	32896427	.	C	A	1	12	13	0	7	20	0	0
19	32896499	.	T	G	11	10	21	0	0	21	0	0
19	32896519	.	T	C	9	8	17	0	1	18	0	0
19	32899313	.	T	A	2	1	3	0	0	3	0	0
19	32899328	.	T	A	1	1	2	0	0	2	0	0
19	32899452	.	A	G	2	0	2	0	0	2	0	0
19	32907732	.	A	C	2	1	3	0	0	3	0	0
19	32918241	.	T	A	27	4	31	0	1	32	0	0
19	32918807	.	T	C	5	3	8	0	1	9	0	0
19	32928367	.	A	T	1	0	1	0	1	2	0	0
19	32931100	.	A	T	21	20	41	0	1	42	0	0
19	32931101	.	C	T	0	20	20	0	22	42	0	0
19	32933891	.	C	A	28	21	49	0	1	50	0	0
19	32935480	.	G	C	4	11	15	0	0	15	0	0
19	32936989	.	T	C	7	5	12	0	0	12	0	0
19	32937663	.	C	A	7	2	9	0	1	10	0	0
19	32944034	.	A	G	10	14	24	0	0	24	0	0
19	32954310	.	A	G	3	0	3	0	0	3	0	0
19	32979329	.	T	G	3	3	6	0	0	6	0	0
19	32979625	.	A	G	7	9	16	0	0	16	0	0
19	33029392	.	C	T	1	1	2	0	0	2	0	0
19	33029423	.	C	T	2	1	3	0	1	4	0	0
19	33029452	.	A	G	3	3	6	0	0	6	0	0
19	33029587	.	T	C	3	0	3	0	0	3	0	0
19	33043458	.	A	G	0	1	1	0	0	1	0	0
19	33043749	.	T	C	1	4	5	0	1	6	0	0
19	33061247	.	C	T	1	0	1	0	0	1	0	0
19	33066783	.	C	G	12	0	12	0	18	30	0	0
19	33071055	.	C	G	13	10	23	0	0	23	0	0
19	33071126	.	G	T	18	11	29	0	0	29	0	0
19	33071172	.	G	T	13	9	22	0	0	22	0	0
19	33071249	.	G	C	13	8	21	0	0	21	0	0
19	33071635	.	A	T	3	4	7	0	0	7	0	0
19	33071795	.	A	T	11	15	26	0	0	27	1	0
19	33084204	.	A	G	1	2	3	0	0	3	0	0
19	33084213	.	A	G	1	2	3	0	0	3	0	0
19	33095789	.	T	C	1	0	1	0	0	1	0	0
19	33106333	.	G	A	0	5	5	0	3	8	0	0
19	33123179	.	A	G	4	2	6	0	0	6	0	0
19	33124700	.	A	T	2	0	2	0	0	2	0	0
19	33127718	.	T	C	7	8	15	0	2	17	0	0
19	33131666	.	C	T	1	1	2	0	3	5	0	0
19	33136410	.	A	G	17	0	17	0	30	47	0	0
19	33137436	.	A	G	21	1	22	0	13	35	0	0
19	33137667	.	C	T	5	2	7	0	0	7	0	0
19	33139701	.	C	A	2	2	4	0	0	4	0	0
19	33140052	.	T	G	3	2	5	0	0	5	0	0
19	33140259	.	A	C	4	3	7	0	1	8	0	0
19	33140322	.	T	C	1	2	3	0	0	3	0	0
19	33203048	.	A	T	2	4	6	0	0	6	0	0
19	33203744	.	G	A	9	3	12	0	0	12	0	0
19	33204332	.	T	C	2	3	5	0	0	5	0	0
19	33204574	.	T	C	2	3	5	0	0	5	0	0
19	33205130	.	G	A	2	2	4	0	0	4	0	0
19	33205223	.	T	A	4	3	7	0	0	7	0	0
19	33205255	.	C	G	0	3	3	0	4	7	0	0
19	33205316	.	G	A	2	2	4	0	0	4	0	0
19	33211420	.	C	T	3	3	6	0	0	6	0	0
19	33211741	.	T	C	2	3	5	0	0	5	0	0
19	33270936	.	T	C	1	0	1	0	0	1	0	0
19	33513293	.	A	T	1	4	5	0	0	5	0	0
19	33514118	.	C	T	2	4	6	0	0	6	0	0
19	33514481	.	C	T	4	2	6	0	0	6	0	0
19	33514655	.	G	A	1	3	4	0	2	6	0	0
19	33701679	.	C	T	4	5	9	0	0	9	0	0
19	33701722	.	A	T	1	4	5	0	0	5	0	0
19	33701887	.	T	A	10	4	14	0	0	14	0	0
19	33701923	.	T	A	8	5	13	0	2	15	0	0
19	33732393	.	C	T	1	6	7	0	0	7	0	0
19	33755973	.	G	A	0	10	10	0	8	18	0	0
19	33755985	.	A	G	6	1	7	0	8	15	0	0
19	33756009	.	G	T	6	12	18	0	2	20	0	0
19	33765636	.	C	T	13	13	26	0	0	26	0	0
19	33772226	.	T	A	10	16	26	0	3	29	0	0
19	33772280	.	T	C	12	14	26	0	2	28	0	0
19	33775750	.	C	T	7	7	14	0	1	15	0	0
19	33775810	.	T	C	1	3	4	0	0	4	0	0
19	33782757	.	A	G	12	1	13	0	11	24	0	0
19	33782914	.	A	G	7	3	10	0	0	10	0	0
19	33783332	.	A	T	11	9	20	0	1	21	0	0
19	33784221	.	T	A	3	8	11	0	0	11	0	0
19	33784896	.	T	C	11	19	30	0	2	32	0	0
19	33784897	.	C	T	12	20	32	0	0	32	0	0
19	33784966	.	C	T	14	14	28	0	1	29	0	0
19	33784986	.	T	C	15	14	29	0	1	30	0	0
19	33785094	.	C	T	11	17	28	0	2	30	0	0
19	33785109	.	C	T	9	18	27	0	0	27	0	0
19	33785175	.	G	A	6	9	15	0	2	17	0	0
19	33785197	.	G	A	0	11	11	0	11	22	0	0
19	33785234	.	A	G	16	1	17	0	11	28	0	0
19	33785240	.	T	C	15	11	26	0	0	26	0	0
19	33785357	.	C	A	16	12	28	0	1	29	0	0
19	33785379	.	G	A	16	14	30	0	0	30	0	0
19	33785512	.	T	C	18	16	34	0	0	34	0	0
19	33785704	.	G	T	22	23	45	0	0	45	0	0
19	33785735	.	T	G	20	0	20	0	19	39	0	0
19	34960061	.	A	T	4	4	8	0	2	10	0	0
19	34960099	.	A	G	2	7	9	0	0	9	0	0
19	34960143	.	A	G	3	7	10	0	0	10	0	0
19	34960147	.	G	A	2	7	9	0	0	9	0	0
19	34960190	.	C	G	1	12	13	0	11	24	0	0
19	34960198	.	T	C	12	13	25	0	2	27	0	0
19	34960315	.	T	A	10	6	16	0	0	16	0	0
19	34960574	.	A	G	3	0	3	0	0	3	0	0
19	34961152	.	C	T	4	7	11	0	0	11	0	0
19	34961269	.	A	G	1	2	3	0	0	3	0	0
19	35002450	.	G	A	4	2	6	0	0	6	0	0
19	35002714	.	A	C	3	2	5	0	0	5	0	0
19	35002723	.	T	C	2	1	3	0	0	3	0	0
19	35004117	.	A	C	5	7	12	0	0	12	0	0
19	35004135	.	C	T	4	6	10	0	0	10	0	0
19	35004868	.	C	A	1	1	2	0	0	2	0	0
19	35004869	.	C	A	1	1	2	0	0	2	0	0
19	35004920	.	G	A	2	2	4	0	0	4	0	0
19	35004941	.	T	C	5	2	7	0	0	7	0	0
19	35005136	.	A	C	4	5	9	0	0	9	0	0
19	35005137	.	A	T	4	5	9	0	0	9	0	0
19	35005318	.	G	A	6	14	20	0	9	29	0	0
19	35007021	.	G	A	0	2	2	0	3	5	0	0
19	35007220	.	G	A	2	3	5	0	0	5	0	0
19	35007235	.	G	A	1	3	4	0	0	4	0	0
19	35013806	.	C	T	18	23	41	0	2	43	0	0
19	35016477	.	C	T	0	1	1	0	0	1	0	0
19	35016553	.	T	G	20	11	31	0	1	32	0	0
19	35016646	.	A	T	17	11	28	0	1	29	0	0
19	35016696	.	T	G	8	11	19	0	0	19	0	0
19	35016835	.	C	T	12	8	20	0	1	21	0	0
19	35016962	.	T	A	6	3	9	0	0	9	0	0
19	35019560	.	A	G	1	6	7	0	0	7	0	0
19	35041158	.	T	A	24	23	47	0	2	49	0	0
19	35041308	.	A	G	27	21	48	0	1	49	0	0
19	35041458	.	T	C	4	0	4	0	14	18	0	0
19	35052411	.	G	T	12	10	22	0	0	22	0	0
19	35052435	.	T	C	12	0	12	0	10	22	0	0
19	35055889	.	A	G	11	10	21	0	0	21	0	0
19	35057860	.	G	T	0	1	1	0	0	1	0	0
19	35057869	.	C	T	2	2	4	0	1	5	0	0
19	35058232	.	T	C	5	8	13	0	0	13	0	0
19	35060217	.	A	C	13	13	26	0	3	29	0	0
19	35065906	.	A	T	3	7	10	0	0	10	0	0
19	35067367	.	G	A	8	10	18	0	1	19	0	0
19	35069299	.	G	T	1	3	4	0	0	4	0	0
19	35069755	.	C	A	3	2	5	0	0	5	0	0
19	35069934	.	T	G	1	2	3	0	1	4	0	0
19	35070015	.	C	T	0	7	7	0	1	8	0	0
19	35072613	.	A	C	18	9	27	0	1	28	0	0
19	35072712	.	G	C	4	0	4	0	5	9	0	0
19	35075637	.	C	T	0	4	4	0	11	15	0	0
19	35076301	.	C	T	0	6	6	0	10	16	0	0
19	35076773	.	G	A	8	10	18	0	0	18	0	0
19	35078584	.	T	C	11	0	11	0	14	25	0	0
19	35078632	.	T	C	8	0	8	0	6	14	0	0
19	35079259	.	C	T	4	9	13	0	0	13	0	0
19	35079515	.	A	T	1	0	1	0	0	1	0	0
19	35083010	.	G	A	1	3	4	0	0	4	0	0
19	35083019	.	C	T	0	1	1	0	1	2	0	0
19	35083182	.	C	T	2	2	4	0	0	4	0	0
19	35116228	.	A	G	9	6	15	0	1	16	0	0
19	35116297	.	T	C	4	7	11	0	1	12	0	0
19	35116405	.	A	G	9	9	18	0	0	18	0	0
19	35116438	.	G	A	7	7	14	0	0	14	0	0
19	35118813	.	G	C	5	3	8	0	0	8	0	0
19	35118842	.	T	C	5	4	9	0	0	9	0	0
19	35118860	.	G	T	4	4	8	0	0	8	0	0
19	35118911	.	C	A	3	5	8	0	1	9	0	0
19	35118983	.	A	T	5	5	10	0	0	10	0	0
19	35119039	.	T	C	2	2	4	0	0	4	0	0
19	35119082	.	T	C	2	0	2	0	2	4	0	0
19	35119169	.	G	A	2	4	6	0	0	6	0	0
19	35119205	.	G	A	3	5	8	0	0	8	0	0
19	35119436	.	C	T	11	11	22	0	0	22	0	0
19	35121381	.	T	C	3	2	5	0	0	5	0	0
19	35121459	.	T	C	3	5	8	0	0	8	0	0
19	35122875	.	G	A	1	2	3	0	0	3	0	0
19	35122876	.	C	A	1	2	3	0	0	3	0	0
19	35123452	.	A	T	4	1	5	0	0	5	0	0
19	35123508	.	T	C	5	0	5	0	7	12	0	0
19	35131332	.	G	A	0	1	1	0	0	1	0	0
19	35134092	.	G	T	3	1	4	0	0	4	0	0
19	35134181	.	G	A	2	5	7	0	0	7	0	0
19	35135406	.	C	A	0	2	2	0	1	3	0	0
19	35135466	.	G	A	0	1	1	0	0	1	0	0
19	35135600	.	A	G	1	2	3	0	0	3	0	0
19	35135626	.	T	G	3	2	5	0	0	5	0	0
19	35138260	.	A	G	0	1	1	0	0	1	0	0
19	35155676	.	C	T	2	1	3	0	0	3	0	0
19	35157472	.	A	G	0	1	1	0	0	1	0	0
19	35159665	.	G	T	0	3	3	0	0	3	0	0
19	35159668	.	G	A	0	2	2	0	1	3	0	0
19	35159721	.	A	G	3	6	9	0	0	9	0	0
19	35159826	.	G	T	3	0	3	0	0	3	0	0
19	35165047	.	T	C	1	0	1	0	0	1	0	0
19	35359341	.	C	T	18	27	45	0	2	47	0	0
19	35379917	.	A	G	3	2	5	0	1	6	0	0
19	35379923	.	G	A	4	2	6	0	0	6	0	0
19	35379998	.	A	G	1	4	5	0	1	6	0	0
19	35380031	.	G	A	5	3	8	0	1	9	0	0
19	35380070	.	G	A	6	2	8	0	1	9	0	0
19	35380168	.	T	C	2	0	2	0	4	6	0	0
19	35381625	.	T	A	1	3	4	0	0	4	0	0
19	35419202	.	A	G	3	3	6	0	1	7	0	0
19	35419215	.	T	A	3	4	7	0	0	7	0	0
19	35419292	.	T	A	2	2	4	0	0	4	0	0
19	35419300	.	A	T	2	2	4	0	0	4	0	0
19	35422354	.	T	C	3	2	5	0	0	5	0	0
19	35428735	.	G	A	4	4	8	0	1	9	0	0
19	35459414	.	A	G	20	9	29	0	4	33	0	0
19	35459737	.	G	A	21	25	46	0	1	47	0	0
19	35459801	.	A	T	25	22	47	0	0	47	0	0
19	35473080	.	C	A	0	5	5	0	5	10	0	0
19	35722947	.	T	C	2	6	8	0	0	8	0	0
19	35723040	.	G	T	10	13	23	0	2	25	0	0
19	35723087	.	G	T	16	19	35	0	2	37	0	0
19	35723113	.	G	T	14	23	37	0	2	39	0	0
19	35723153	.	G	T	7	13	20	0	1	21	0	0
19	35723170	.	T	G	2	9	11	0	0	11	0	0
19	35723189	.	G	T	0	4	4	0	2	6	0	0
19	35723214	.	T	C	5	1	6	0	12	18	0	0
19	35723237	.	C	A	10	19	29	0	1	30	0	0
19	35723268	.	A	T	12	20	32	0	0	32	0	0
19	35723289	.	C	A	11	13	24	0	0	24	0	0
19	35723422	.	C	T	13	13	26	0	0	26	0	0
19	35723552	.	C	T	0	5	5	0	4	9	0	0
19	35733351	.	T	C	9	9	18	0	1	19	0	0
19	35852378	.	C	T	0	3	3	0	0	3	0	0
19	35852381	.	A	G	1	3	4	0	0	4	0	0
19	36115044	.	G	A	4	5	9	0	0	9	0	0
19	36115084	.	C	T	2	10	12	0	2	14	0	0
19	36115100	.	C	T	0	10	10	0	3	13	0	0
19	36115170	.	G	C	5	5	10	0	1	11	0	0
19	36115210	.	G	A	6	2	8	0	1	9	0	0
19	36120265	.	C	T	0	6	6	0	4	10	0	0
19	36167703	.	C	T	0	4	4	0	3	7	0	0
19	36169872	.	A	G	0	1	1	0	1	2	0	0
19	36171682	.	T	C	4	0	4	0	1	5	0	0
19	36171778	.	G	A	1	3	4	0	0	4	0	0
19	36258165	.	C	T	0	0	0	0	1	1	0	0
19	36311813	.	G	A	0	1	1	0	0	1	0	0
19	36311879	.	G	A	3	3	6	0	0	6	0	0
19	36389712	.	G	C	1	1	2	0	0	2	0	0
19	37127483	.	A	T	6	6	12	0	0	12	0	0
19	37133533	.	C	A	11	5	16	0	0	16	0	0
19	37133719	.	G	T	7	4	11	0	0	11	0	0
19	37133872	.	T	C	5	3	8	0	0	8	0	0
19	37133931	.	A	T	5	6	11	0	0	11	0	0
19	37134005	.	A	G	1	3	4	0	0	4	0	0
19	37138743	.	C	T	7	6	13	0	2	15	0	0
19	37139266	.	T	C	8	5	13	0	0	13	0	0
19	37153442	.	G	T	1	3	4	0	0	4	0	0
19	37478230	.	C	A	2	0	2	0	0	2	0	0
19	37481658	.	C	T	3	4	7	0	0	7	0	0
19	37485121	.	C	T	1	1	2	0	0	2	0	0
19	37492351	.	G	A	2	6	8	0	0	8	0	0
19	37501738	.	T	C	7	0	7	0	13	20	0	0
19	37501802	.	C	T	9	13	22	0	1	23	0	0
19	37501935	.	A	G	22	16	38	0	5	43	0	0
19	37501959	.	C	T	15	24	39	0	1	40	0	0
19	37502235	.	G	A	10	8	18	0	1	19	0	0
19	37504201	.	G	A	3	0	3	0	0	3	0	0
19	37505790	.	G	A	0	2	2	0	0	2	0	0
19	37505808	.	G	A	4	0	4	0	0	4	0	0
19	37505880	.	C	G	0	3	3	0	0	3	0	0
19	37506405	.	G	A	2	0	2	0	0	2	0	0
19	37506414	.	T	C	2	0	2	0	0	2	0	0
19	37508533	.	G	A	3	3	6	0	0	6	0	0
19	37786292	.	C	A	0	2	2	0	0	2	0	0
19	37799569	.	T	C	0	0	0	0	1	1	0	0
19	37804440	.	T	C	2	3	5	0	1	6	0	0
19	37815718	.	C	A	4	6	10	0	0	10	0	0
19	37815733	.	A	G	5	5	10	0	1	11	0	0
19	37815763	.	G	A	4	5	9	0	0	9	0	0
19	37835502	.	A	G	0	1	1	0	0	1	0	0
19	37835508	.	T	C	0	1	1	0	0	1	0	0
19	37926003	.	C	T	16	14	30	0	2	32	0	0
19	37926066	.	C	A	19	11	30	0	1	31	0	0
19	37926261	.	C	T	18	24	42	0	1	43	0	0
19	37926267	.	C	A	20	19	39	0	3	42	0	0
19	37926447	.	C	T	17	15	32	0	1	33	0	0
19	37926493	.	C	T	16	7	23	0	1	24	0	0
19	37926637	.	A	G	3	0	3	0	10	14	1	0
19	37926816	.	T	G	20	18	38	0	1	39	0	0
19	38171067	.	G	A	1	3	4	0	0	4	0	0
19	38175219	.	C	T	5	2	7	0	0	7	0	0
19	38176911	.	A	G	1	0	1	0	0	1	0	0
19	38205299	.	T	C	1	4	5	0	0	5	0	0
19	38205350	.	T	C	3	2	5	0	0	5	0	0
19	38216302	.	A	C	4	3	7	0	0	7	0	0
19	38216310	.	C	G	3	0	3	0	4	7	0	0
19	38227086	.	T	G	1	2	3	0	0	3	0	0
19	38240844	.	C	T	3	3	6	0	0	6	0	0
19	38327186	.	T	C	2	2	4	0	0	4	0	0
19	38327305	.	G	A	3	3	6	0	0	6	0	0
19	38327593	.	C	T	1	2	3	0	0	3	0	0
19	38473901	.	G	T	3	2	5	0	0	5	0	0
19	38776962	.	A	G	4	7	11	0	1	12	0	0
19	38777235	.	T	C	8	6	14	0	0	14	0	0
19	38793349	.	G	A	1	3	4	0	0	4	0	0
19	40026627	.	A	G	16	18	34	0	2	36	0	0
19	40026661	.	T	C	13	20	33	0	1	34	0	0
19	40027585	.	A	G	3	0	3	0	0	3	0	0
19	40027652	.	C	A	17	13	30	0	3	33	0	0
19	40031164	.	G	A	17	15	32	0	1	33	0	0
19	40039603	.	G	A	12	9	21	0	0	21	0	0
19	40039606	.	T	A	12	11	23	0	0	23	0	0
19	40039651	.	A	T	7	10	17	0	0	17	0	0
19	40071539	.	T	G	2	1	3	0	0	3	0	0
19	40102040	.	A	C	0	1	1	0	0	1	0	0
19	40110897	.	G	A	11	8	19	0	1	20	0	0
19	40113305	.	G	A	0	1	1	0	0	1	0	0
19	40113526	.	G	A	0	2	2	0	6	8	0	0
19	40113549	.	T	G	1	5	6	0	0	6	0	0
19	40113618	.	T	C	4	7	11	0	0	11	0	0
19	40129258	.	A	C	2	3	5	0	1	6	0	0
19	40145888	.	G	A	4	5	9	0	0	9	0	0
19	40147782	.	T	C	7	6	13	0	0	14	1	0
19	40147821	.	G	A	0	5	5	0	6	11	0	0
19	40151351	.	C	T	3	3	6	0	0	6	0	0
19	40151970	.	G	A	3	4	7	0	0	7	0	0
19	40151983	.	C	T	3	2	5	0	0	5	0	0
19	40153024	.	A	T	0	1	1	0	1	2	0	0
19	40154957	.	C	T	5	3	8	0	1	9	0	0
19	40155144	.	C	A	2	4	6	0	0	6	0	0
19	40155327	.	C	T	8	6	14	0	0	14	0	0
19	40156805	.	G	A	0	6	6	0	1	7	0	0
19	40157041	.	T	A	7	1	8	0	0	8	0	0
19	40162945	.	C	A	9	10	19	0	5	24	0	0
19	40163077	.	C	T	3	8	11	0	0	11	0	0
19	40163184	.	C	T	1	2	3	0	0	3	0	0
19	40163223	.	G	A	5	6	11	0	1	12	0	0
19	40177726	.	G	C	1	4	5	0	0	5	0	0
19	40177762	.	T	C	2	1	3	0	0	3	0	0
19	40179916	.	G	C	0	5	5	0	10	15	0	0
19	40180011	.	C	T	6	7	13	0	0	13	0	0
19	40182574	.	C	T	1	2	3	0	0	3	0	0
19	40182904	.	C	A	0	3	3	0	1	4	0	0
19	40326950	.	C	T	1	3	4	0	2	6	0	0
19	40326972	.	T	C	2	2	4	0	1	5	0	0
19	40340319	.	A	G	2	6	8	0	0	8	0	0
19	40343087	.	C	T	3	3	6	0	0	6	0	0
19	40347600	.	T	G	1	0	1	0	2	3	0	0
19	40347702	.	T	A	19	19	38	0	4	42	0	0
19	40347760	.	T	A	17	13	30	0	2	32	0	0
19	40347785	.	A	T	16	10	26	0	1	27	0	0
19	40374134	.	T	A	1	2	3	0	0	3	0	0
19	40540324	.	C	T	0	1	1	0	0	1	0	0
19	40540943	.	T	C	2	1	3	0	0	3	0	0
19	40540947	.	G	T	1	2	3	0	0	3	0	0
19	40551982	.	T	G	1	0	1	0	2	3	0	0
19	40558221	.	C	T	1	3	4	0	0	4	0	0
19	40558281	.	A	G	2	3	5	0	0	5	0	0
19	40641379	.	A	G	2	0	2	0	0	2	0	0
19	40641439	.	C	T	3	2	5	0	1	6	0	0
19	40685424	.	C	T	6	6	12	0	1	13	0	0
19	40685447	.	A	G	5	0	5	0	9	14	0	0
19	40685875	.	G	A	4	7	11	0	1	12	0	0
19	40685923	.	T	C	3	7	10	0	1	11	0	0
19	40685935	.	A	G	5	4	9	0	0	9	0	0
19	40686599	.	T	C	6	3	9	0	0	9	0	0
19	40716977	.	T	C	3	2	5	0	0	5	0	0
19	40717649	.	C	A	8	8	16	0	0	16	0	0
19	40746252	.	T	C	1	0	1	0	3	4	0	0
19	40770455	.	G	A	1	2	3	0	0	3	0	0
19	40773573	.	G	A	3	2	5	0	0	5	0	0
19	40892312	.	T	C	3	2	5	0	1	6	0	0
19	40895763	.	G	A	4	5	9	0	0	9	0	0
19	40895826	.	T	C	3	1	4	0	0	4	0	0
19	40898334	.	A	C	4	8	12	0	0	12	0	0
19	40898352	.	T	G	5	1	6	0	8	14	0	0
19	40898500	.	G	A	4	1	5	0	0	5	0	0
19	40900059	.	T	A	8	3	11	0	0	11	0	0
19	40900075	.	A	T	12	3	15	0	0	15	0	0
19	40900205	.	T	C	11	0	11	0	5	16	0	0
19	40900334	.	C	T	2	1	3	0	0	3	0	0
19	40906097	.	A	C	10	16	26	0	0	26	0	0
19	40906118	.	T	A	8	11	19	0	0	19	0	0
19	41021048	.	T	C	2	1	3	0	0	3	0	0
19	41033811	.	G	A	0	19	19	0	14	33	0	0
19	41038855	.	C	T	7	33	40	0	2	42	0	0
19	42843845	.	A	G	9	9	18	0	0	18	0	0
19	42843859	.	A	G	9	9	18	0	1	19	0	0
19	42843894	.	A	G	19	7	26	0	0	26	0	0
19	42844126	.	A	G	11	4	15	0	0	15	0	0
19	42872386	.	A	C	5	0	5	0	7	12	0	0
19	43542701	.	T	C	5	2	7	0	0	7	0	0
19	45859824	.	C	T	6	11	17	0	1	18	0	0
19	45868237	.	A	C	0	2	2	0	2	4	0	0
19	45883536	.	C	T	5	2	7	0	0	7	0	0
19	45883563	.	G	A	10	11	21	0	1	22	0	0
19	45896193	.	C	T	9	14	23	0	0	23	0	0
19	45962080	.	T	G	1	4	5	0	1	6	0	0
19	45962214	.	G	A	5	8	13	0	0	13	0	0
19	45967297	.	C	G	5	0	5	0	8	13	0	0
19	45967406	.	G	A	7	13	20	0	0	20	0	0
19	45967516	.	A	G	3	0	3	0	7	10	0	0
19	45980323	.	C	T	5	4	9	0	0	9	0	0
19	45983790	.	T	C	1	3	4	0	0	4	0	0
19	45996230	.	G	A	0	1	1	0	0	1	0	0
19	46006267	.	G	A	2	5	7	0	0	7	0	0
19	46014993	.	A	T	1	1	2	0	0	2	0	0
19	46020177	.	A	C	8	0	8	0	8	16	0	0
19	46020462	.	G	A	15	12	27	0	2	29	0	0
19	46020544	.	G	C	6	0	6	0	4	10	0	0
19	46028151	.	T	A	11	17	28	0	0	28	0	0
19	46032947	.	A	G	2	4	6	0	0	6	0	0
19	46036046	.	T	A	0	1	1	0	0	1	0	0
19	46047223	.	T	A	2	2	4	0	0	4	0	0
19	47783491	.	C	T	1	0	1	0	0	1	0	0
19	47976325	.	C	T	22	30	52	0	2	54	0	0
19	47976449	.	A	T	17	3	20	0	0	20	0	0
19	47982897	.	A	G	25	22	47	0	2	49	0	0
19	47983014	.	C	G	9	4	13	0	1	14	0	0
19	47983859	.	G	A	4	1	5	0	1	6	0	0
19	47984483	.	C	T	1	4	5	0	0	5	0	0
19	47986324	.	C	T	1	18	19	0	16	35	0	0
19	47997422	.	C	G	1	3	4	0	1	5	0	0
19	48013142	.	G	A	3	6	9	0	0	9	0	0
19	48013172	.	A	G	10	10	20	0	0	20	0	0
19	48014266	.	A	G	5	5	10	0	0	10	0	0
19	48018336	.	T	C	6	0	6	0	4	10	0	0
19	48022989	.	T	G	13	13	26	0	2	28	0	0
19	48023309	.	A	G	25	3	28	0	21	49	0	0
19	48031094	.	T	C	6	3	9	0	0	9	0	0
19	48032167	.	G	A	0	6	6	0	4	10	0	0
19	48033631	.	A	G	8	6	14	0	1	15	0	0
19	48036809	.	T	G	18	1	19	0	18	37	0	0
19	48049279	.	T	G	17	12	29	0	0	29	0	0
19	48050029	.	G	A	0	7	7	0	4	11	0	0
19	48053315	.	A	C	10	13	23	0	1	24	0	0
19	48067046	.	C	T	3	5	8	0	0	8	0	0
19	48069366	.	T	C	6	5	11	0	0	11	0	0
19	48102625	.	A	G	3	0	3	0	5	8	0	0
19	48102652	.	C	T	1	4	5	0	0	5	0	0
19	48114344	.	T	A	3	6	9	0	0	9	0	0
19	48119203	.	T	C	4	9	13	2	0	15	0	0
19	48120238	.	A	G	18	0	18	0	8	26	0	0
19	48251971	.	A	T	3	3	6	0	0	6	0	0
19	48251992	.	A	G	3	2	5	0	0	5	0	0
19	48363216	.	G	T	1	2	3	0	0	3	0	0
19	48364835	.	T	A	3	14	17	0	0	17	0	0
19	48364848	.	C	T	0	15	15	0	3	18	0	0
19	48364870	.	T	C	9	13	22	0	1	23	0	0
19	48383625	.	C	T	1	3	4	0	0	4	0	0
19	48383628	.	G	T	1	3	4	0	0	4	0	0
2	281639	.	A	G	6	0	6	0	6	12	0	0
2	333596	.	A	T	4	2	6	0	0	6	0	0
2	374634	.	T	C	1	2	3	0	0	3	0	0
2	1220802	.	T	C	1	1	2	0	0	2	0	0
2	1453259	.	G	A	1	1	2	0	0	2	0	0
2	1464459	.	G	A	0	1	1	0	0	1	0	0
2	1465096	.	C	T	1	3	4	0	1	5	0	0
2	1466478	.	T	C	1	0	1	0	2	3	0	0
2	1466829	.	G	A	2	1	3	0	0	3	0	0
2	1500276	.	A	T	1	2	3	0	0	3	0	0
2	1500279	.	G	A	1	2	3	0	0	3	0	0
2	1527682	.	C	G	4	4	8	0	0	8	0	0
2	1527828	.	T	C	6	0	6	0	5	11	0	0
2	1529602	.	G	C	1	0	1	0	2	3	0	0
2	1540611	.	A	C	1	0	1	0	1	2	0	0
2	1543191	.	A	G	3	2	5	0	0	5	0	0
2	1548430	.	T	A	3	6	9	0	0	9	0	0
2	1548470	.	A	C	4	0	4	0	4	8	0	0
2	1569132	.	T	C	2	1	3	0	0	3	0	0
2	1595187	.	C	T	7	8	15	0	0	15	0	0
2	1595275	.	T	C	5	17	22	1	0	23	0	0
2	1595330	.	A	G	14	1	15	0	1	16	0	0
2	1595334	.	G	A	15	1	16	0	0	16	0	0
2	1595495	.	C	T	0	9	9	0	13	22	0	0
2	1595524	.	T	G	9	8	17	0	1	18	0	0
2	1595582	.	C	T	0	8	8	0	9	17	0	0
2	1595601	.	A	G	9	9	18	0	1	19	0	0
2	1595696	.	A	G	3	4	7	0	0	7	0	0
2	1595744	.	T	C	4	3	7	0	0	7	0	0
2	1595914	.	T	C	4	6	10	0	1	11	0	0
2	1595945	.	G	C	4	8	12	0	2	14	0	0
2	1596159	.	C	T	0	5	5	0	8	13	0	0
2	1596196	.	T	A	8	10	18	0	0	18	0	0
2	1596282	.	G	T	6	9	15	0	0	15	0	0
2	1596325	.	C	A	0	9	9	0	6	15	0	0
2	1596327	.	C	T	0	9	9	0	6	15	0	0
2	1596424	.	T	A	8	9	17	0	0	17	0	0
2	1596671	.	C	T	2	1	3	0	1	4	0	0
2	1596690	.	T	C	3	4	7	0	0	7	0	0
2	1596830	.	C	T	0	3	3	0	7	10	0	0
2	1596908	.	A	T	6	4	10	0	1	11	0	0
2	1597048	.	C	T	5	3	8	0	0	8	0	0
2	1597054	.	A	G	5	3	8	0	0	8	0	0
2	1597084	.	G	A	2	5	7	0	0	7	0	0
2	1597096	.	G	A	1	2	3	0	1	4	0	0
2	1597396	.	A	C	7	8	15	0	0	15	0	0
2	1597413	.	T	C	9	5	14	0	2	16	0	0
2	1597534	.	T	C	2	0	2	0	8	10	0	0
2	1597617	.	T	C	6	6	12	0	0	12	0	0
2	1597634	.	T	A	7	5	12	0	2	14	0	0
2	1597658	.	C	T	0	8	8	0	6	14	0	0
2	1598065	.	A	G	2	3	5	0	2	7	0	0
2	1598115	.	C	A	7	4	11	0	0	11	0	0
2	1598124	.	G	A	8	5	13	0	0	13	0	0
2	1598533	.	A	C	10	0	10	0	7	17	0	0
2	1714687	.	T	C	1	2	3	0	0	3	0	0
2	1750377	.	T	C	2	1	3	0	1	4	0	0
2	1771164	.	C	T	3	3	6	0	0	6	0	0
2	1846555	.	G	A	0	2	2	0	1	3	0	0
2	1846624	.	A	G	3	2	5	0	0	5	0	0
2	1941054	.	G	A	1	2	3	0	0	3	0	0
2	1942812	.	C	T	2	8	10	0	0	10	0	0
2	1943037	.	A	G	8	0	8	0	5	13	0	0
2	2001661	.	G	T	1	2	3	0	0	3	0	0
2	2005807	.	T	C	1	2	3	0	0	3	0	0
2	2005836	.	T	A	3	3	6	0	0	6	0	0
2	2005844	.	C	A	3	3	6	0	0	6	0	0
2	2008086	.	A	G	3	2	5	0	0	5	0	0
2	2010765	.	T	C	21	0	21	0	28	49	0	0
2	2010945	.	G	C	33	24	57	0	0	57	0	0
2	2011287	.	T	A	15	18	33	0	3	36	0	0
2	2013834	.	C	T	1	9	10	0	9	19	0	0
2	2017450	.	T	C	7	4	11	0	1	12	0	0
2	2024876	.	A	G	1	6	7	0	0	7	0	0
2	2025044	.	A	G	2	10	12	0	1	13	0	0
2	2025080	.	T	C	4	7	11	0	0	11	0	0
2	2025175	.	C	A	3	6	9	0	0	9	0	0
2	2025219	.	G	T	6	4	10	0	0	10	0	0
2	2025617	.	A	G	6	7	13	0	0	13	0	0
2	2026068	.	G	A	4	6	10	0	0	10	0	0
2	2026397	.	T	C	10	13	23	0	0	23	0	0
2	2026475	.	G	T	8	5	13	0	1	14	0	0
2	2039601	.	A	G	1	0	1	0	0	1	0	0
2	2161758	.	C	T	1	2	3	0	0	3	0	0
2	2168642	.	T	A	5	1	6	0	0	6	0	0
2	2169353	.	T	C	3	4	7	0	0	7	0	0
2	2172878	.	G	A	0	15	15	0	16	31	0	0
2	2172879	.	T	A	15	15	30	0	1	31	0	0
2	2173317	.	A	T	21	19	40	0	3	43	0	0
2	2248991	.	C	A	5	2	7	0	2	9	0	0
2	2248993	.	C	T	3	6	9	0	0	9	0	0
2	2251501	.	C	T	6	3	9	0	0	9	0	0
2	2256216	.	T	C	0	1	1	0	0	1	0	0
2	2256372	.	C	G	2	2	4	0	0	4	0	0
2	2256375	.	C	T	2	2	4	0	0	4	0	0
2	2630212	.	A	G	15	14	29	0	2	31	0	0
2	2633731	.	G	A	2	3	5	0	0	5	0	0
2	2638528	.	C	T	0	4	4	0	1	5	0	0
2	2774460	.	C	T	1	0	1	0	0	1	0	0
2	2785378	.	C	T	9	4	13	0	1	14	0	0
2	2786198	.	T	A	3	2	5	0	0	5	0	0
2	2791168	.	C	T	0	7	7	0	16	23	0	0
2	2792843	.	A	G	1	0	1	0	0	1	0	0
2	2795564	.	C	T	4	2	6	0	0	6	0	0
2	2805882	.	T	C	2	1	3	0	2	5	0	0
2	2849616	.	C	T	1	1	2	0	0	2	0	0
2	2851740	.	C	A	0	1	1	0	0	1	0	0
2	2851746	.	G	T	0	1	1	0	0	1	0	0
2	2869590	.	A	G	1	2	3	0	1	4	0	0
2	2871722	.	T	C	1	1	2	0	0	2	0	0
2	2872180	.	G	T	0	5	5	0	2	7	0	0
2	2872550	.	G	A	1	6	7	0	0	7	0	0
2	2872565	.	A	G	1	7	8	0	0	8	0	0
2	2873531	.	A	G	6	1	7	0	5	12	0	0
2	2873546	.	G	A	7	6	13	0	0	13	0	0
2	2873579	.	T	A	2	3	5	0	1	6	0	0
2	2892531	.	A	G	6	9	15	0	0	15	0	0
2	2894098	.	A	T	6	10	16	0	1	17	0	0
2	2900553	.	A	T	0	3	3	0	0	3	0	0
2	2905776	.	G	A	1	4	5	0	0	5	0	0
2	2905996	.	T	C	5	9	14	0	0	14	0	0
2	2908617	.	A	G	6	1	7	0	6	13	0	0
2	2911877	.	G	T	1	0	1	0	0	1	0	0
2	2911892	.	A	T	1	1	2	0	0	2	0	0
2	2913151	.	C	T	4	8	12	0	0	12	0	0
2	2913161	.	G	A	6	11	17	0	0	17	0	0
2	2916697	.	T	C	4	1	5	0	0	5	0	0
2	2917105	.	T	C	9	15	24	0	1	25	0	0
2	2973759	.	C	A	2	3	5	0	0	5	0	0
2	2975272	.	G	A	1	4	5	0	0	5	0	0
2	2977237	.	C	A	2	2	4	0	0	4	0	0
2	2987062	.	G	A	5	2	7	0	0	7	0	0
2	3015975	.	T	C	1	0	1	0	0	1	0	0
2	3020186	.	G	T	3	3	6	0	0	6	0	0
2	3022253	.	G	A	0	2	2	0	1	3	0	0
2	3022607	.	A	T	3	4	7	0	0	7	0	0
2	3026869	.	A	G	5	3	8	0	1	9	0	0
2	3026997	.	T	C	7	3	10	0	1	11	0	0
2	3027065	.	T	A	12	3	15	0	1	16	0	0
2	3027066	.	A	T	13	3	16	0	0	16	0	0
2	3027200	.	T	A	17	16	33	0	2	35	0	0
2	3027286	.	G	A	10	13	23	0	1	24	0	0
2	3027383	.	C	T	10	6	16	0	1	17	0	0
2	3027504	.	C	T	13	11	24	0	0	24	0	0
2	3027704	.	C	G	13	15	28	0	1	29	0	0
2	3027765	.	G	T	9	6	15	0	1	16	0	0
2	3027804	.	C	T	0	12	12	0	5	17	0	0
2	3027859	.	T	C	13	0	13	0	16	29	0	0
2	3027862	.	A	G	13	16	29	0	0	29	0	0
2	3027928	.	T	C	13	8	21	0	1	22	0	0
2	3028117	.	A	G	11	8	19	0	0	19	0	0
2	3028156	.	G	T	16	9	25	0	1	26	0	0
2	3028203	.	T	C	14	10	24	0	2	26	0	0
2	3028233	.	C	T	11	7	18	0	2	20	0	0
2	3028270	.	A	T	9	9	18	0	1	19	0	0
2	3028312	.	T	G	14	12	26	0	0	26	0	0
2	3028463	.	G	A	8	5	13	0	0	13	0	0
2	3028558	.	T	C	9	6	15	0	1	16	0	0
2	3028605	.	G	A	9	7	16	0	0	16	0	0
2	3028715	.	C	T	2	2	4	0	0	4	0	0
2	3028893	.	A	G	6	7	13	0	0	13	0	0
2	3028908	.	A	T	6	3	9	0	0	9	0	0
2	3029001	.	G	A	5	2	7	0	1	8	0	0
2	3029006	.	C	A	5	2	7	0	0	7	0	0
2	3029383	.	T	A	13	4	17	0	1	18	0	0
2	3029437	.	T	C	20	0	20	0	9	29	0	0
2	3032707	.	G	A	5	7	12	0	0	12	0	0
2	3032944	.	C	T	1	3	4	0	5	9	0	0
2	3034819	.	G	A	3	5	8	0	0	8	0	0
2	3056627	.	A	G	3	1	4	0	0	4	0	0
2	3056663	.	A	C	2	1	3	0	0	3	0	0
2	3061083	.	G	A	3	2	5	0	1	6	0	0
2	3062181	.	T	G	2	2	4	0	0	4	0	0
2	3062464	.	C	A	4	6	10	0	0	10	0	0
2	3064922	.	A	G	3	4	7	0	1	8	0	0
2	3064984	.	C	G	1	5	6	0	0	6	0	0
2	3064991	.	T	C	1	4	5	0	1	6	0	0
2	3065248	.	C	T	1	5	6	0	0	6	0	0
2	3065428	.	C	T	6	4	10	0	1	11	0	0
2	3065563	.	G	A	6	5	11	0	1	12	0	0
2	3065581	.	A	T	7	4	11	0	0	11	0	0
2	3065633	.	A	T	3	4	7	0	0	7	0	0
2	3065659	.	G	T	2	3	5	0	0	5	0	0
2	3065675	.	T	C	2	3	5	0	0	5	0	0
2	3066074	.	T	A	2	5	7	0	1	8	0	0
2	3066075	.	C	T	3	4	7	0	1	8	0	0
2	3066121	.	A	G	2	2	4	0	0	4	0	0
2	3066304	.	G	A	1	2	3	0	0	3	0	0
2	3066336	.	T	A	1	2	3	0	0	3	0	0
2	3066860	.	A	T	1	3	4	0	0	4	0	0
2	4045387	.	T	C	3	5	8	0	2	10	0	0
2	4045400	.	T	C	6	3	9	0	1	10	0	0
2	4729279	.	A	T	3	3	6	0	0	6	0	0
2	4729329	.	G	A	9	2	11	0	1	12	0	0
2	4729340	.	G	A	10	3	13	0	1	14	0	0
2	4729554	.	A	G	9	9	18	0	0	18	0	0
2	4729682	.	A	T	3	7	10	0	0	10	0	0
2	4729798	.	A	T	6	1	7	0	2	9	0	0
2	4729857	.	G	T	2	4	6	0	0	6	0	0
2	4730051	.	T	C	3	3	6	0	0	6	0	0
2	4735995	.	G	A	1	1	2	0	0	2	0	0
2	4736978	.	G	A	6	6	12	0	1	13	0	0
2	4737177	.	C	G	2	4	6	0	1	7	0	0
2	4737217	.	G	T	3	2	5	0	0	5	0	0
2	4737350	.	G	T	1	2	3	0	1	4	0	0
2	4737427	.	C	T	0	3	3	0	4	7	0	0
2	4737607	.	G	A	4	3	7	0	0	7	0	0
2	4754041	.	T	G	1	1	2	0	1	3	0	0
2	4900688	.	A	C	13	12	25	0	1	26	0	0
2	4900798	.	T	C	13	24	37	1	2	40	0	0
2	4901197	.	T	C	19	6	25	0	1	26	0	0
2	4903760	.	G	A	0	1	1	0	1	2	0	0
2	4907857	.	C	T	4	2	6	0	1	7	0	0
2	4930730	.	T	C	9	8	17	0	0	17	0	0
2	4948832	.	A	G	8	10	18	0	2	20	0	0
2	4948850	.	G	A	7	7	14	0	0	14	0	0
2	4950607	.	C	T	2	5	7	0	0	7	0	0
2	4995045	.	C	G	6	9	15	0	0	15	0	0
2	4995084	.	C	T	0	5	5	0	4	9	0	0
2	5014631	.	A	C	9	9	18	0	0	18	0	0
2	5407096	.	A	G	5	3	8	0	0	8	0	0
2	5407110	.	A	G	6	3	9	0	0	9	0	0
2	5749641	.	C	T	0	6	6	0	2	8	0	0
2	5843880	.	A	T	1	4	5	0	0	5	0	0
2	7150995	.	T	A	0	2	2	1	0	3	0	0
2	7150997	.	T	G	0	2	2	1	0	3	0	0
2	7154458	.	T	C	2	2	4	0	0	4	0	0
2	7422939	.	T	C	3	0	3	0	2	5	0	0
2	7423129	.	T	C	1	7	8	0	0	8	0	0
2	7423142	.	T	C	2	1	3	0	5	8	0	0
2	7766457	.	C	T	0	2	2	0	3	5	0	0
2	8114546	.	G	A	3	7	10	0	0	10	0	0
2	9561023	.	A	G	5	2	7	0	0	7	0	0
2	9747206	.	T	C	0	1	1	0	0	1	0	0
2	9954698	.	T	G	0	3	3	0	0	3	0	0
2	10149883	.	C	G	10	0	10	0	16	33	7	0
2	10685766	.	A	G	7	3	10	0	0	10	0	0
2	10685777	.	A	G	4	2	6	0	4	10	0	0
2	10685924	.	A	G	7	0	7	0	4	11	0	0
2	11854040	.	T	C	4	4	8	0	0	8	0	0
2	13020541	.	G	A	0	5	5	0	1	6	0	0
2	15028974	.	G	A	0	2	2	0	0	2	0	0
2	16548514	.	T	C	11	11	22	0	1	23	0	0
2	16646891	.	A	T	7	3	10	0	2	12	0	0
2	17267285	.	A	G	5	2	7	0	1	8	0	0
2	17450367	.	C	T	1	3	4	0	1	5	0	0
2	17450368	.	A	G	2	2	4	0	1	5	0	0
2	17450726	.	A	T	2	3	5	0	2	7	0	0
2	17450841	.	A	T	1	5	6	0	0	6	0	0
2	17450859	.	C	A	0	4	4	0	3	7	0	0
2	17451003	.	G	A	3	3	6	0	0	6	0	0
2	17451198	.	G	A	6	4	10	0	0	10	0	0
2	17451327	.	A	G	7	11	18	0	0	18	0	0
2	17451375	.	G	A	1	11	12	0	2	14	0	0
2	17468947	.	C	T	2	0	2	0	0	2	0	0
2	17578471	.	A	T	4	2	6	0	0	6	0	0
2	17578710	.	A	G	10	26	36	0	1	37	0	0
2	17579033	.	G	A	18	8	26	0	0	26	0	0
2	17579109	.	A	C	20	0	20	0	10	31	1	0
2	17579110	.	A	G	18	9	27	0	4	31	0	0
2	17579324	.	T	C	21	10	31	0	0	31	0	0
2	17579888	.	A	C	21	0	21	0	19	40	0	0
2	17579926	.	G	C	26	0	26	0	17	43	0	0
2	17596503	.	A	G	0	1	1	0	0	1	0	0
2	17604640	.	G	C	4	1	5	0	0	5	0	0
2	17617513	.	T	C	2	2	4	0	1	5	0	0
2	17644591	.	G	A	14	8	22	0	0	22	0	0
2	17644609	.	T	C	7	1	8	0	15	23	0	0
2	17646976	.	G	A	0	1	1	0	0	1	0	0
2	17651370	.	A	G	1	0	1	0	0	1	0	0
2	17651466	.	A	G	9	11	20	0	1	21	0	0
2	17651529	.	C	T	0	16	16	0	9	25	0	0
2	17651565	.	C	T	5	16	21	0	1	22	0	0
2	17651574	.	C	T	4	13	17	0	2	19	0	0
2	17702137	.	T	C	7	0	7	0	4	11	0	0
2	17702518	.	G	A	3	4	7	0	0	7	0	0
2	17704701	.	G	A	2	1	3	0	0	3	0	0
2	17717026	.	A	G	2	2	4	0	0	4	0	0
2	20262780	.	T	C	1	2	3	0	0	3	0	0
2	20332135	.	A	G	4	2	6	0	0	6	0	0
2	20367846	.	A	C	7	12	19	0	2	21	0	0
2	20367927	.	G	T	4	7	11	0	0	11	0	0
2	20368569	.	A	C	13	15	28	0	3	31	0	0
2	20368630	.	G	A	1	11	12	0	12	24	0	0
2	20368761	.	T	C	13	15	28	0	3	31	0	0
2	20368812	.	G	A	13	9	22	0	5	27	0	0
2	20368965	.	C	T	27	21	48	0	3	51	0	0
2	20369516	.	A	G	17	15	32	0	5	37	0	0
2	20369836	.	A	T	15	25	40	0	0	40	0	0
2	20369925	.	T	A	16	10	26	0	0	26	0	0
2	20369947	.	A	C	10	8	18	0	1	19	0	0
2	20370012	.	C	T	9	11	20	0	0	20	0	0
2	20370090	.	G	C	16	18	34	0	1	35	0	0
2	20370143	.	C	T	21	16	37	0	0	37	0	0
2	20370792	.	T	C	22	21	43	0	1	44	0	0
2	20370893	.	C	T	11	14	25	0	2	27	0	0
2	20370998	.	A	G	13	13	26	0	3	29	0	0
2	20371060	.	T	A	12	1	13	0	2	15	0	0
2	20371210	.	G	C	8	3	11	0	0	11	0	0
2	20437721	.	G	A	4	6	10	0	1	11	0	0
2	20437878	.	G	A	9	4	13	0	0	13	0	0
2	20438054	.	G	A	8	15	23	0	1	24	0	0
2	20438061	.	A	T	13	9	22	0	0	22	0	0
2	20439070	.	A	G	13	0	13	0	14	27	0	0
2	20439223	.	G	T	13	14	27	0	3	30	0	0
2	20439303	.	C	T	15	9	24	0	1	25	0	0
2	20440244	.	G	A	1	1	2	0	0	2	0	0
2	20473191	.	T	G	2	1	3	0	0	3	0	0
2	20475819	.	A	G	1	1	2	0	0	2	0	0
2	20477158	.	C	T	1	2	3	0	2	5	0	0
2	20487211	.	C	T	5	2	7	0	0	7	0	0
2	20501646	.	C	T	4	5	9	0	0	9	0	0
2	20503698	.	C	A	3	10	13	0	0	13	0	0
2	20503734	.	T	G	6	0	6	0	6	12	0	0
2	20503770	.	C	T	4	1	5	0	0	5	0	0
2	20505994	.	C	T	4	3	7	0	1	8	0	0
2	20505995	.	C	T	3	4	7	0	1	8	0	0
2	20514915	.	A	G	1	1	2	0	0	2	0	0
2	20515013	.	G	A	5	8	13	0	1	14	0	0
2	20515056	.	G	A	2	3	5	0	1	6	0	0
2	20515060	.	T	G	2	2	4	0	1	5	0	0
2	20515307	.	C	T	1	3	4	0	0	4	0	0
2	20515377	.	C	T	1	0	1	0	0	1	0	0
2	20518023	.	A	T	9	0	9	0	1	10	0	0
2	20523002	.	C	T	4	2	6	0	0	6	0	0
2	20523004	.	C	T	4	2	6	0	0	6	0	0
2	20523351	.	T	A	15	7	22	0	0	22	0	0
2	20523364	.	A	G	14	10	24	0	4	28	0	0
2	20526411	.	T	C	18	15	33	0	0	33	0	0
2	20526592	.	A	G	13	0	13	0	11	24	0	0
2	20526599	.	T	A	14	11	25	0	1	26	0	0
2	20526797	.	A	C	1	3	4	0	0	4	0	0
2	20612139	.	T	C	1	2	3	0	0	3	0	0
2	20614502	.	C	T	2	3	5	0	0	5	0	0
2	20614879	.	T	C	1	4	5	0	0	5	0	0
2	20615023	.	T	A	3	2	5	0	0	5	0	0
2	20666367	.	G	C	1	0	1	0	0	1	0	0
2	20811080	.	C	T	1	2	3	0	1	4	0	0
2	20814291	.	T	G	6	10	16	0	0	16	0	0
2	20814419	.	T	C	0	1	1	0	0	1	0	0
2	20814488	.	C	T	11	6	17	0	0	17	0	0
2	20814688	.	G	C	2	0	2	0	4	6	0	0
2	20817736	.	G	A	3	4	7	0	0	7	0	0
2	20818069	.	C	T	0	0	0	0	1	1	0	0
2	20818075	.	G	A	1	0	1	0	0	1	0	0
2	20820587	.	C	T	5	3	8	0	0	8	0	0
2	20822794	.	A	G	2	6	8	0	0	8	0	0
2	20826495	.	T	C	1	0	1	0	0	1	0	0
2	20828000	.	G	A	3	4	7	0	1	8	0	0
2	20828235	.	C	T	0	4	4	0	1	5	0	0
2	20830387	.	A	G	6	7	13	0	0	13	0	0
2	20830993	.	C	G	5	4	9	0	1	10	0	0
2	20836438	.	A	C	2	2	4	0	0	4	0	0
2	20836780	.	G	A	1	2	3	0	0	3	0	0
2	20840539	.	C	A	2	3	5	0	1	6	0	0
2	20840837	.	T	C	0	0	0	0	2	2	0	0
2	20843816	.	A	G	2	3	5	0	1	6	0	0
2	20848862	.	T	C	2	1	3	0	0	3	0	0
2	20865044	.	T	C	2	0	2	0	0	2	0	0
2	20868556	.	G	T	1	2	3	0	0	3	0	0
2	20871630	.	T	A	0	1	1	0	0	1	0	0
2	20873717	.	A	G	2	0	2	0	0	2	0	0
2	20875112	.	G	A	0	5	5	0	8	13	0	0
2	20875166	.	C	T	3	2	5	0	0	5	0	0
2	20875860	.	A	G	5	5	10	0	1	11	0	0
2	20875922	.	T	A	1	2	3	0	0	3	0	0
2	20917133	.	G	A	0	3	3	0	0	3	0	0
2	20967782	.	C	G	2	4	6	0	0	6	0	0
2	20967788	.	G	A	2	2	4	0	2	6	0	0
2	20972877	.	A	G	1	2	3	0	0	3	0	0
2	20973003	.	G	A	0	3	3	0	0	3	0	0
2	20973008	.	G	T	0	3	3	0	0	3	0	0
2	20973794	.	A	T	7	6	13	0	0	13	0	0
2	20973934	.	T	C	5	3	8	0	0	8	0	0
2	20974085	.	G	A	3	3	6	0	0	6	0	0
2	20974250	.	A	G	4	3	7	0	0	7	0	0
2	20975010	.	T	C	3	7	10	0	1	11	0	0
2	20975255	.	G	C	9	6	15	0	0	15	0	0
2	20975283	.	C	T	8	8	16	0	0	16	0	0
2	20975460	.	T	C	5	4	9	0	0	9	0	0
2	20980356	.	T	C	3	2	5	0	0	5	0	0
2	21071401	.	T	A	0	1	1	0	0	1	0	0
2	21073286	.	T	A	5	1	6	0	1	7	0	0
2	21073350	.	A	C	4	2	6	0	0	6	0	0
2	21076203	.	C	T	6	9	15	0	2	17	0	0
2	21076342	.	T	C	7	3	10	0	2	12	0	0
2	21076805	.	C	A	10	10	20	0	1	21	0	0
2	21076932	.	A	T	7	4	11	0	2	13	0	0
2	21077101	.	A	T	2	4	6	0	0	6	0	0
2	21077268	.	G	T	18	7	25	0	1	26	0	0
2	21077299	.	C	T	12	9	21	0	1	22	0	0
2	21077726	.	C	T	2	9	11	0	0	11	0	0
2	21082585	.	C	G	1	3	4	0	0	4	0	0
2	21156350	.	G	A	3	4	7	0	0	7	0	0
2	21156490	.	G	A	2	2	4	0	0	4	0	0
2	21165495	.	C	G	0	4	4	0	6	10	0	0
2	21177237	.	G	A	1	0	1	0	0	1	0	0
2	21182482	.	G	T	3	3	6	0	2	9	1	0
2	21298857	.	C	A	1	2	3	0	1	4	0	0
2	21299069	.	G	C	1	3	4	0	0	4	0	0
2	21312257	.	T	C	1	7	8	0	0	8	0	0
2	21312440	.	A	C	1	2	3	0	0	3	0	0
2	21312464	.	T	C	2	2	4	0	0	4	0	0
2	21312507	.	C	T	1	2	3	0	0	3	0	0
2	21312905	.	T	A	1	2	3	0	0	3	0	0
2	21315952	.	C	T	0	1	1	0	0	1	0	0
2	21320664	.	C	T	5	2	7	0	1	8	0	0
2	21338095	.	G	A	1	2	3	0	0	3	0	0
2	21351972	.	A	G	1	2	3	0	0	3	0	0
2	21356614	.	A	T	1	2	3	0	0	3	0	0
2	21367952	.	A	G	0	2	2	0	0	2	0	0
2	21376407	.	C	T	2	5	7	0	0	7	0	0
2	21381230	.	C	T	4	7	11	0	1	12	0	0
2	21455240	.	C	T	2	1	3	0	0	3	0	0
2	21456950	.	G	A	2	3	5	0	0	5	0	0
2	21459061	.	G	A	4	2	6	0	0	6	0	0
2	21459091	.	G	T	5	2	7	0	0	7	0	0
2	21459100	.	G	A	5	2	7	0	0	7	0	0
2	21459196	.	C	T	6	8	14	0	0	14	0	0
2	21459661	.	C	G	4	5	9	0	1	10	0	0
2	21459701	.	C	A	2	3	5	0	0	5	0	0
2	21462185	.	A	G	2	2	4	0	0	4	0	0
2	21462191	.	A	G	2	2	4	0	0	4	0	0
2	21466555	.	T	C	12	10	22	0	1	23	0	0
2	21466567	.	A	T	13	11	24	0	2	26	0	0
2	21468807	.	G	A	19	12	31	0	0	31	0	0
2	21468825	.	G	A	16	14	30	0	3	33	0	0
2	21469405	.	T	C	8	10	18	0	0	18	0	0
2	21469490	.	T	C	11	10	21	0	0	21	0	0
2	21469644	.	A	G	6	14	20	0	0	20	0	0
2	21469830	.	T	A	3	3	6	0	0	6	0	0
2	21487190	.	G	A	1	2	3	0	0	3	0	0
2	21501967	.	C	G	2	2	4	0	0	4	0	0
2	21502301	.	G	T	2	2	4	0	1	5	0	0
2	21502540	.	G	C	7	11	18	0	0	18	0	0
2	21502964	.	C	T	4	3	7	0	1	8	0	0
2	21605644	.	A	T	3	4	7	0	1	8	0	0
2	21605857	.	T	C	2	5	7	0	0	7	0	0
2	21605877	.	G	A	0	3	3	0	3	6	0	0
2	21605937	.	G	T	3	4	7	0	0	7	0	0
2	21607456	.	G	C	4	3	7	0	0	7	0	0
2	21608582	.	G	A	11	12	23	0	0	23	0	0
2	21608587	.	C	T	11	12	23	0	0	23	0	0
2	21608710	.	T	A	9	6	15	0	0	15	0	0
2	21608781	.	T	G	2	6	8	0	1	9	0	0
2	21609104	.	A	T	2	2	4	0	1	5	0	0
2	21609443	.	C	A	9	8	17	0	0	17	0	0
2	21609446	.	C	T	9	8	17	0	0	17	0	0
2	21609718	.	C	T	1	2	3	0	0	3	0	0
2	21609777	.	G	A	1	2	3	0	0	3	0	0
2	21609830	.	T	G	1	2	3	0	0	3	0	0
2	21610233	.	G	A	1	0	1	0	0	1	0	0
2	21612380	.	C	T	0	2	2	0	2	4	0	0
2	21620412	.	A	G	3	4	7	0	0	7	0	0
2	21620469	.	T	C	7	0	7	0	8	15	0	0
2	21620691	.	G	A	5	7	12	0	0	12	0	0
2	21620856	.	C	T	4	7	11	0	0	11	0	0
2	21621151	.	G	A	5	4	9	0	1	10	0	0
2	21621400	.	C	T	0	8	8	0	4	12	0	0
2	21621423	.	C	T	0	7	7	0	6	13	0	0
2	21621507	.	T	C	9	3	12	0	0	12	0	0
2	21621528	.	A	G	8	5	13	0	0	13	0	0
2	21621606	.	C	T	1	4	5	0	0	5	0	0
2	21621762	.	T	C	4	2	6	0	0	6	0	0
2	21765814	.	G	A	3	2	5	0	1	6	0	0
2	21766212	.	A	G	5	6	11	0	1	12	0	0
2	21766237	.	G	A	10	6	16	0	0	16	0	0
2	21766277	.	G	A	10	5	15	0	1	16	0	0
2	21766478	.	T	A	3	10	13	0	0	13	0	0
2	21766554	.	G	A	5	7	12	0	0	12	0	0
2	21766785	.	G	A	6	4	10	0	0	10	0	0
2	21767207	.	C	T	15	9	24	0	0	24	0	0
2	21767244	.	A	T	7	7	14	0	0	14	0	0
2	21767286	.	T	C	3	3	6	0	0	6	0	0
2	21768168	.	G	A	8	7	15	0	0	15	0	0
2	21768821	.	T	A	3	7	10	0	1	11	0	0
2	21771191	.	G	T	4	2	6	0	0	6	0	0
2	21774400	.	G	A	0	1	1	0	0	1	0	0
2	21777101	.	C	A	1	2	3	0	0	3	0	0
2	21777102	.	A	G	1	2	3	0	0	3	0	0
2	21780896	.	C	T	0	2	2	0	0	2	0	0
2	21806152	.	C	T	0	2	2	0	1	3	0	0
2	21807295	.	C	T	3	3	6	0	0	6	0	0
2	21807396	.	G	A	1	2	3	0	0	3	0	0
2	21822288	.	C	A	17	31	48	0	4	52	0	0
2	21822304	.	A	G	26	16	42	0	5	47	0	0
2	21822816	.	T	A	18	18	36	0	0	36	0	0
2	21827276	.	A	G	17	16	33	0	1	34	0	0
2	21855248	.	C	G	4	6	10	0	0	10	0	0
2	21855253	.	G	A	0	5	5	0	6	11	0	0
2	21862511	.	C	T	5	1	6	0	0	6	0	0
2	21865620	.	G	C	7	8	15	0	1	16	0	0
2	21877711	.	C	G	10	10	20	0	0	20	0	0
2	21877878	.	G	A	4	4	8	0	1	9	0	0
2	21878036	.	G	C	12	14	26	0	0	26	0	0
2	21878053	.	T	C	13	14	27	0	0	27	0	0
2	21878197	.	T	C	18	13	31	0	0	31	0	0
2	21878415	.	C	T	14	10	24	0	3	27	0	0
2	21878462	.	T	C	14	14	28	0	2	30	0	0
2	21983064	.	T	G	5	0	5	0	4	9	0	0
2	22058071	.	A	G	2	0	2	0	4	6	0	0
2	22058098	.	C	T	6	8	14	0	0	14	0	0
2	22058200	.	C	T	7	8	15	0	4	19	0	0
2	22058254	.	G	A	10	6	16	0	0	16	0	0
2	22058281	.	C	T	4	4	8	0	2	10	0	0
2	22073176	.	C	T	19	9	28	0	2	30	0	0
2	22101657	.	C	T	22	18	40	0	1	41	0	0
2	22101699	.	A	C	8	7	15	0	4	19	0	0
2	22104292	.	C	T	18	20	38	0	1	39	0	0
2	22104415	.	C	A	18	9	27	0	4	32	1	0
2	22104506	.	T	C	8	15	23	0	2	26	1	0
2	22104999	.	A	G	26	13	39	0	3	42	0	0
2	22208514	.	G	T	6	6	12	0	1	13	0	0
2	22208560	.	G	A	8	6	14	0	0	14	0	0
2	22208638	.	A	G	8	7	15	0	0	15	0	0
2	22209045	.	C	A	16	11	27	0	1	28	0	0
2	22209722	.	C	T	11	14	25	0	0	25	0	0
2	22210412	.	G	A	4	15	19	0	2	21	0	0
2	22353568	.	T	C	12	16	28	0	3	31	0	0
2	22353661	.	T	A	10	10	20	0	1	21	0	0
2	22362290	.	G	A	17	13	30	0	2	32	0	0
2	22362302	.	G	A	16	18	34	0	1	35	0	0
2	22363365	.	T	C	0	1	1	0	0	1	0	0
2	22363418	.	T	A	1	1	2	0	0	2	0	0
2	22390361	.	G	A	1	1	2	0	0	2	0	0
2	22409371	.	A	G	1	2	3	0	0	3	0	0
2	22480321	.	G	T	5	3	8	0	0	8	0	0
2	22480759	.	G	A	15	19	34	0	2	36	0	0
2	22483222	.	G	A	1	6	7	0	2	9	0	0
2	22483351	.	A	G	12	9	21	0	0	21	0	0
2	22483381	.	A	G	9	9	18	0	0	18	0	0
2	22483423	.	C	T	7	9	16	0	0	16	0	0
2	22483444	.	A	G	5	8	13	0	0	13	0	0
2	22513202	.	A	G	5	2	7	0	0	7	0	0
2	22521337	.	G	A	4	4	8	0	0	8	0	0
2	22521582	.	A	T	0	3	3	0	0	3	0	0
2	22522073	.	A	G	4	2	6	0	1	7	0	0
2	22523573	.	G	A	2	5	7	0	0	7	0	0
2	22599787	.	C	T	1	6	7	0	1	8	0	0
2	22602653	.	A	G	1	4	5	0	0	5	0	0
2	22602808	.	C	T	7	6	13	0	0	13	0	0
2	22602826	.	C	T	6	7	13	0	0	13	0	0
2	22607462	.	G	A	0	1	1	0	0	1	0	0
2	22608314	.	G	T	4	3	7	0	0	7	0	0
2	22614357	.	T	A	1	1	2	0	0	2	0	0
2	22614448	.	T	A	6	4	10	0	0	10	0	0
2	22614529	.	C	T	6	8	14	0	1	15	0	0
2	22614959	.	A	T	5	7	12	0	0	12	0	0
2	22617932	.	G	A	22	16	38	0	0	38	0	0
2	22626878	.	T	A	16	6	22	0	0	22	0	0
2	22627149	.	G	A	9	10	19	0	0	19	0	0
2	22629684	.	C	T	0	9	9	0	4	13	0	0
2	22633869	.	G	A	3	6	9	0	0	9	0	0
2	22634070	.	A	G	4	4	8	0	0	8	0	0
2	22653693	.	T	A	4	11	15	0	1	16	0	0
2	22656651	.	G	A	3	3	6	0	0	6	0	0
2	22656708	.	T	C	1	2	3	0	0	3	0	0
2	22656723	.	C	T	1	0	1	0	0	1	0	0
2	22656870	.	A	G	7	5	12	0	1	13	0	0
2	22659072	.	G	A	3	4	7	0	0	7	0	0
2	22702423	.	T	C	0	8	8	0	0	8	0	0
2	22707536	.	A	C	5	5	10	0	0	10	0	0
2	22710985	.	T	C	1	0	1	0	0	1	0	0
2	22711898	.	T	G	0	1	1	0	0	1	0	0
2	22714603	.	A	G	8	9	17	0	0	17	0	0
2	22714618	.	G	A	7	6	13	0	2	15	0	0
2	22716770	.	T	C	11	6	17	0	0	17	0	0
2	22718895	.	T	A	9	14	23	0	0	23	0	0
2	22719145	.	A	G	14	0	14	0	13	27	0	0
2	22724661	.	T	C	8	7	15	0	0	15	0	0
2	22731426	.	C	T	9	7	16	0	0	16	0	0
2	22731456	.	G	A	5	4	9	0	2	11	0	0
2	22733494	.	A	T	3	5	8	0	1	9	0	0
2	22733813	.	A	G	15	10	25	0	0	25	0	0
2	22735037	.	T	A	1	3	4	0	0	4	0	0
2	22735205	.	A	T	10	17	27	0	0	27	0	0
2	22735232	.	C	T	6	6	12	0	2	14	0	0
2	22742179	.	C	T	5	10	15	0	2	17	0	0
2	22745690	.	C	T	9	9	18	0	1	19	0	0
2	22747304	.	C	T	7	7	14	0	0	14	0	0
2	22750164	.	C	T	1	0	1	0	0	1	0	0
2	22750621	.	C	T	4	5	9	0	0	9	0	0
2	22750622	.	A	G	3	5	8	0	1	9	0	0
2	22756528	.	C	T	10	12	22	0	1	23	0	0
2	22795615	.	A	G	10	22	32	0	3	35	0	0
2	22799294	.	T	A	1	0	1	0	0	1	0	0
2	22801748	.	T	C	20	26	46	0	3	49	0	0
2	22801899	.	A	T	9	15	24	0	4	28	0	0
2	22802030	.	G	A	0	18	18	0	18	36	0	0
2	22802117	.	A	T	16	17	33	0	4	37	0	0
2	22802402	.	T	C	19	16	35	0	0	35	0	0
2	22802504	.	G	A	18	13	31	0	1	32	0	0
2	22802524	.	T	A	19	12	31	0	0	31	0	0
2	22803110	.	T	A	19	30	49	0	2	51	0	0
2	22803128	.	G	T	27	22	49	0	1	50	0	0
2	22803190	.	C	T	24	18	42	0	2	44	0	0
2	22860517	.	A	T	3	3	6	0	0	6	0	0
2	22860541	.	C	T	3	2	5	0	0	5	0	0
2	22932584	.	C	T	1	3	4	0	0	4	0	0
2	22933175	.	T	G	2	2	4	0	0	4	0	0
2	22933218	.	C	A	4	3	7	0	0	7	0	0
2	22933539	.	G	A	5	10	15	0	0	15	0	0
2	22933554	.	G	A	6	10	16	0	0	16	0	0
2	22944464	.	G	A	0	3	3	0	0	3	0	0
2	22953191	.	T	C	1	0	1	0	2	3	0	0
2	22957590	.	C	T	0	0	0	0	1	1	0	0
2	22965169	.	T	C	1	3	4	0	0	4	0	0
2	22970363	.	C	A	3	2	5	0	0	5	0	0
2	22970413	.	G	A	2	8	10	0	0	10	0	0
2	22970485	.	A	G	1	2	3	0	0	3	0	0
2	22970683	.	C	G	2	6	8	0	0	8	0	0
2	22970707	.	G	A	2	4	6	0	1	7	0	0
2	22970764	.	G	A	3	3	6	0	0	6	0	0
2	22971012	.	T	A	10	10	20	0	0	20	0	0
2	22979805	.	G	A	1	5	6	0	0	6	0	0
2	22979979	.	T	C	3	2	5	0	1	6	0	0
2	22994327	.	G	A	4	3	7	0	2	9	0	0
2	22996520	.	A	T	2	1	3	0	0	3	0	0
2	23001533	.	G	A	9	9	18	0	1	19	0	0
2	23001638	.	G	T	12	11	23	0	0	23	0	0
2	23007891	.	C	G	0	0	0	0	2	2	0	0
2	23023331	.	G	A	1	4	5	0	0	5	0	0
2	23023465	.	G	A	2	3	5	0	2	7	0	0
2	23023466	.	C	G	5	2	7	0	0	7	0	0
2	23023801	.	C	T	3	3	6	0	0	6	0	0
2	23024069	.	C	A	3	7	10	0	0	10	0	0
2	23024704	.	A	C	1	2	3	0	3	6	0	0
2	23066671	.	C	T	3	2	5	0	1	6	0	0
2	23078082	.	A	G	7	5	12	0	0	12	0	0
2	23085185	.	C	T	5	8	13	0	0	13	0	0
2	23085242	.	A	G	3	0	3	0	5	8	0	0
2	23090867	.	C	T	1	2	3	0	0	3	0	0
2	23094876	.	C	T	0	4	4	0	0	4	0	0
2	23094912	.	C	T	0	2	2	0	0	2	0	0
2	23098563	.	G	A	0	2	2	0	0	2	0	0
2	23098565	.	A	G	0	2	2	0	0	2	0	0
2	23098856	.	T	A	6	3	9	0	1	10	0	0
2	23223037	.	C	T	4	3	7	0	0	7	0	0
2	23226584	.	C	T	3	1	4	0	0	4	0	0
2	23238502	.	C	T	0	1	1	0	0	1	0	0
2	23263294	.	T	A	3	0	3	0	1	4	0	0
2	23292123	.	A	T	1	1	2	0	0	2	0	0
2	23292262	.	G	A	7	13	20	0	0	20	0	0
2	23292429	.	A	T	7	8	15	0	1	16	0	0
2	23292516	.	G	A	0	7	7	0	5	12	0	0
2	23292549	.	C	A	6	5	11	0	1	12	0	0
2	23292690	.	T	A	5	13	18	0	0	18	0	0
2	23292776	.	G	A	4	4	8	0	0	8	0	0
2	23292847	.	T	C	2	2	4	0	0	4	0	0
2	23293123	.	G	C	7	3	10	0	1	11	0	0
2	23293230	.	A	T	7	7	14	0	5	19	0	0
2	23361020	.	T	G	12	13	25	0	0	25	0	0
2	23361605	.	C	T	17	14	31	0	0	31	0	0
2	23379480	.	G	C	2	5	7	0	0	7	0	0
2	23379532	.	G	A	3	10	13	0	0	13	0	0
2	23379588	.	C	T	6	11	17	0	0	17	0	0
2	23379757	.	T	A	5	5	10	0	0	10	0	0
2	23380621	.	C	A	1	1	2	0	0	2	0	0
2	23623164	.	T	C	3	2	5	0	0	5	0	0
2	23644168	.	C	T	1	2	3	0	0	3	0	0
2	23701714	.	A	C	2	5	7	0	0	7	0	0
2	23701743	.	T	A	3	4	7	0	1	8	0	0
2	23707161	.	G	T	1	4	5	0	0	5	0	0
2	23714683	.	G	A	4	2	6	0	0	6	0	0
2	23714743	.	A	T	1	0	1	0	0	1	0	0
2	23716575	.	T	C	4	3	7	0	0	7	0	0
2	23716617	.	C	T	6	3	9	0	0	9	0	0
2	23722518	.	A	G	4	0	4	0	3	7	0	0
2	23722609	.	T	A	2	3	5	0	0	5	0	0
2	23722610	.	T	A	2	3	5	0	0	5	0	0
2	23722849	.	T	C	7	11	18	0	0	18	0	0
2	23723187	.	A	G	2	2	4	0	0	4	0	0
2	23723256	.	C	T	3	3	6	0	0	6	0	0
2	23723438	.	G	T	0	2	2	0	1	3	0	0
2	23723521	.	A	T	2	4	6	0	0	6	0	0
2	23723571	.	G	A	3	7	10	0	0	10	0	0
2	23723594	.	A	G	5	0	5	0	4	9	0	0
2	23723638	.	A	T	6	5	11	0	0	11	0	0
2	23723711	.	T	G	5	4	9	0	1	10	0	0
2	23724535	.	T	G	5	7	12	0	0	12	0	0
2	23725075	.	G	A	8	4	12	0	0	12	0	0
2	23725159	.	T	C	7	9	16	0	0	16	0	0
2	23725184	.	C	A	6	7	13	0	1	14	0	0
2	23725608	.	A	T	9	6	15	0	0	15	0	0
2	23725906	.	C	A	2	6	8	0	0	8	0	0
2	23726043	.	A	G	9	3	12	0	0	12	0	0
2	23726206	.	T	A	3	4	7	0	1	8	0	0
2	23726312	.	G	A	20	7	27	0	0	27	0	0
2	23804300	.	T	C	1	2	3	0	1	4	0	0
2	23804309	.	G	A	2	3	5	0	0	5	0	0
2	23804585	.	C	T	2	2	4	0	0	4	0	0
2	23813951	.	C	T	0	2	2	0	0	2	0	0
2	23816293	.	A	C	4	4	8	0	2	10	0	0
2	23816932	.	C	T	2	3	5	0	0	5	0	0
2	23817155	.	C	G	2	2	4	0	1	5	0	0
2	23817513	.	C	A	2	3	5	0	0	5	0	0
2	23818145	.	T	C	2	2	4	0	0	4	0	0
2	23818207	.	C	A	4	2	6	0	0	6	0	0
2	23818209	.	A	T	4	2	6	0	0	6	0	0
2	23818765	.	A	G	2	2	4	0	0	4	0	0
2	23819603	.	T	C	3	2	5	0	0	5	0	0
2	23819640	.	T	A	4	3	7	0	0	7	0	0
2	23819862	.	A	C	2	2	4	0	0	4	0	0
2	23819946	.	T	G	2	0	2	0	2	4	0	0
2	23823684	.	A	T	1	3	4	0	0	4	0	0
2	23823719	.	A	G	1	2	3	0	0	3	0	0
2	23937227	.	G	A	3	3	6	0	0	6	0	0
2	23937231	.	C	G	3	3	6	0	0	6	0	0
2	24167956	.	T	C	1	2	3	0	0	3	0	0
2	24188637	.	G	A	2	5	7	0	0	7	0	0
2	24199338	.	C	A	15	19	34	0	0	34	0	0
2	24202528	.	T	C	4	6	10	0	0	10	0	0
2	24218922	.	A	T	27	15	42	0	1	43	0	0
2	24218927	.	G	A	1	29	30	0	15	45	0	0
2	24222069	.	A	C	11	10	21	0	2	23	0	0
2	24223991	.	A	G	13	14	27	0	15	42	0	0
2	24238635	.	A	T	1	1	2	0	0	2	0	0
2	24248498	.	C	T	28	24	52	0	6	58	0	0
2	24249037	.	T	A	15	16	31	0	1	32	0	0
2	24249083	.	T	A	16	5	21	0	6	28	1	0
2	24249397	.	G	T	4	15	19	0	23	43	1	0
2	24249943	.	T	A	22	9	31	0	0	31	0	0
2	24249947	.	T	A	22	8	30	0	1	31	0	0
2	24250059	.	T	G	11	7	18	0	1	19	0	0
2	24250062	.	G	T	12	7	19	0	0	19	0	0
2	24250097	.	T	C	8	11	19	0	2	21	0	0
2	24250112	.	T	A	14	6	20	0	0	20	0	0
2	24250147	.	G	A	1	17	18	0	8	26	0	0
2	24250209	.	A	C	10	6	16	0	1	17	0	0
2	24250212	.	G	C	6	11	17	0	0	17	0	0
2	24250303	.	C	T	18	19	37	0	3	40	0	0
2	24250419	.	C	T	7	6	13	0	1	18	4	0
2	24250482	.	C	T	22	18	40	0	1	41	0	0
2	24250577	.	A	T	23	24	47	0	5	52	0	0
2	24250637	.	A	G	21	26	47	0	5	52	0	0
2	24250879	.	T	G	24	26	50	0	5	55	0	0
2	24250972	.	C	A	30	23	53	0	2	55	0	0
2	24251294	.	G	A	0	28	28	0	29	57	0	0
2	24251430	.	A	G	26	16	42	0	4	46	0	0
2	24251690	.	G	A	35	20	55	0	3	58	0	0
2	24251800	.	G	A	30	26	56	0	5	61	0	0
2	24251909	.	A	T	40	26	66	0	2	69	1	0
2	24252078	.	A	T	46	25	71	0	1	72	0	0
2	24252088	.	C	T	44	24	68	0	1	69	0	0
2	24252192	.	T	A	30	19	49	0	1	50	0	0
2	24252196	.	G	T	3	18	21	0	27	48	0	0
2	24258708	.	C	A	0	1	1	0	1	2	0	0
2	24310739	.	G	T	1	4	5	0	1	6	0	0
2	24310850	.	G	C	12	12	24	0	0	24	0	0
2	24310897	.	G	A	14	18	32	0	0	32	0	0
2	24311045	.	T	C	8	0	8	0	20	28	0	0
2	24311151	.	G	A	6	3	9	0	0	9	0	0
2	24311296	.	G	C	11	10	21	0	1	22	0	0
2	24311703	.	A	G	6	5	11	0	1	12	0	0
2	24311879	.	A	G	2	8	10	0	1	11	0	0
2	24313884	.	T	C	5	7	12	0	0	12	0	0
2	24313896	.	G	A	5	5	10	0	1	11	0	0
2	24314221	.	T	C	2	3	5	0	0	5	0	0
2	24316503	.	C	T	0	1	1	0	2	3	0	0
2	24317537	.	G	A	15	8	23	0	0	23	0	0
2	24319740	.	A	G	13	15	28	0	0	28	0	0
2	24319945	.	T	G	3	3	6	0	0	6	0	0
2	24320173	.	C	T	9	4	13	0	3	16	0	0
2	24321853	.	T	C	6	2	8	0	4	12	0	0
2	24322189	.	G	C	15	14	29	0	1	30	0	0
2	24326455	.	A	G	6	7	13	0	0	13	0	0
2	24326509	.	G	A	4	4	8	0	0	8	0	0
2	24331392	.	T	A	3	1	4	0	1	5	0	0
2	24331404	.	T	A	5	2	7	0	1	8	0	0
2	24335246	.	G	A	4	3	7	0	1	8	0	0
2	24385210	.	C	T	6	2	8	0	0	8	0	0
2	24385271	.	T	G	3	5	8	0	0	8	0	0
2	24385603	.	G	A	0	7	7	0	11	18	0	0
2	24385633	.	C	T	10	7	17	0	0	17	0	0
2	24385685	.	T	C	7	6	13	0	0	13	0	0
2	24385724	.	G	A	2	4	6	0	0	6	0	0
2	24385837	.	A	G	6	0	6	0	4	10	0	0
2	24410544	.	T	C	6	0	6	0	4	10	0	0
2	24410851	.	C	T	13	10	23	0	2	25	0	0
2	24410882	.	G	A	8	20	28	0	2	30	0	0
2	24411114	.	G	C	15	7	22	0	1	23	0	0
2	24411536	.	T	C	11	1	12	0	8	20	0	0
2	24411625	.	T	C	10	14	24	0	2	26	0	0
2	24411812	.	A	T	17	5	22	0	0	22	0	0
2	24412856	.	A	G	7	6	13	0	0	13	0	0
2	24412947	.	A	T	6	4	10	0	1	11	0	0
2	24413155	.	C	T	7	12	19	0	0	19	0	0
2	24414032	.	G	C	8	8	16	0	1	17	0	0
2	24414062	.	G	A	8	10	18	0	1	19	0	0
2	24421813	.	T	C	2	0	2	0	1	3	0	0
2	24421816	.	G	A	1	2	3	0	0	3	0	0
2	24432634	.	G	T	4	3	7	0	1	8	0	0
2	24432661	.	C	T	6	6	12	0	0	12	0	0
2	24549586	.	A	T	1	3	4	0	0	4	0	0
2	24558443	.	C	T	3	2	5	0	0	5	0	0
2	24558465	.	C	T	4	3	7	0	1	8	0	0
2	24558512	.	A	T	2	4	6	0	0	6	0	0
2	24558545	.	A	G	1	2	3	0	0	3	0	0
2	24558790	.	C	G	2	2	4	0	0	4	0	0
2	24560323	.	T	A	1	6	7	0	0	7	0	0
2	24560359	.	G	A	3	5	8	0	0	8	0	0
2	24560455	.	T	C	5	2	7	0	0	7	0	0
2	24560881	.	C	T	2	5	7	0	0	7	0	0
2	24565123	.	A	G	4	6	10	0	0	10	0	0
2	24578284	.	C	T	0	2	2	0	5	7	0	0
2	24578308	.	C	T	0	1	1	0	3	4	0	0
2	24594632	.	A	T	4	6	10	0	0	10	0	0
2	24650758	.	C	T	4	3	7	0	0	7	0	0
2	24650815	.	T	C	4	2	6	0	0	6	0	0
2	24650878	.	A	T	1	1	2	0	0	2	0	0
2	24672447	.	T	C	4	4	8	0	1	9	0	0
2	24676875	.	T	C	2	0	2	0	0	2	0	0
2	24677139	.	A	G	5	5	10	0	0	10	0	0
2	24683093	.	A	G	13	4	17	0	8	25	0	0
2	24683311	.	G	A	18	13	31	0	1	32	0	0
2	24722816	.	C	G	0	0	0	0	1	1	0	0
2	24737749	.	C	T	2	2	4	0	0	4	0	0
2	24737776	.	C	T	2	0	2	0	0	2	0	0
2	24743787	.	G	A	0	0	0	0	1	1	0	0
2	24743855	.	G	A	2	4	6	0	0	6	0	0
2	24748308	.	G	T	0	4	4	0	1	5	0	0
2	24749582	.	T	C	5	11	16	0	0	16	0	0
2	24750869	.	C	T	1	2	3	0	0	3	0	0
2	24750918	.	A	T	1	4	5	0	0	5	0	0
2	24750971	.	T	A	1	4	5	0	1	6	0	0
2	24751526	.	G	A	1	6	7	0	0	7	0	0
2	24751711	.	C	A	3	4	7	0	0	7	0	0
2	24751948	.	C	T	2	5	7	0	0	7	0	0
2	24751991	.	A	G	4	8	12	0	2	14	0	0
2	24752048	.	C	T	5	3	8	0	0	8	0	0
2	24752193	.	C	T	1	10	11	0	0	11	0	0
2	24752293	.	C	T	2	4	6	0	0	6	0	0
2	24752385	.	C	T	7	9	16	0	0	16	0	0
2	24753062	.	T	C	7	5	12	0	0	12	0	0
2	24754043	.	G	T	5	5	10	0	1	11	0	0
2	24754044	.	T	A	6	5	11	0	0	11	0	0
2	24754465	.	A	G	1	2	3	0	1	4	0	0
2	24754783	.	C	T	17	8	25	0	1	26	0	0
2	24754796	.	A	C	8	16	24	0	1	25	0	0
2	24755018	.	T	C	14	12	26	0	0	26	0	0
2	24766941	.	G	A	4	3	7	0	0	7	0	0
2	24767291	.	C	T	2	1	3	0	0	3	0	0
2	24773726	.	G	A	0	0	0	0	2	2	0	0
2	24863918	.	T	G	2	4	6	0	0	6	0	0
2	24864387	.	A	G	4	2	6	0	0	6	0	0
2	24864536	.	A	T	1	5	6	0	0	6	0	0
2	24864570	.	A	T	6	2	8	0	0	8	0	0
2	24865187	.	C	A	3	3	6	0	0	6	0	0
2	24865360	.	T	C	11	4	15	0	1	16	0	0
2	24866568	.	C	T	5	3	8	0	0	8	0	0
2	24876864	.	T	A	5	4	9	0	0	9	0	0
2	24877010	.	A	G	9	13	22	0	3	25	0	0
2	24877227	.	C	T	5	10	15	0	0	15	0	0
2	24877534	.	G	A	3	3	6	0	3	9	0	0
2	24877879	.	T	C	3	3	6	0	0	6	0	0
2	24877900	.	T	A	5	4	9	0	0	9	0	0
2	24878211	.	C	T	9	13	22	0	1	23	0	0
2	24878332	.	A	G	10	9	19	0	0	19	0	0
2	24936807	.	G	A	1	2	3	0	0	3	0	0
2	24943482	.	G	T	4	9	13	0	1	14	0	0
2	24943536	.	C	T	3	7	10	0	2	12	0	0
2	24943660	.	T	C	3	2	5	0	0	5	0	0
2	24943689	.	C	T	4	8	12	0	2	14	0	0
2	24943717	.	C	T	13	8	21	0	1	22	0	0
2	24943891	.	A	T	8	19	27	0	1	28	0	0
2	24943916	.	T	C	7	15	22	0	3	25	0	0
2	24943971	.	A	T	3	10	13	0	1	14	0	0
2	24944317	.	A	G	8	7	15	0	0	15	0	0
2	24944415	.	C	T	9	8	17	0	0	17	0	0
2	24944644	.	A	G	8	3	11	0	1	12	0	0
2	24947642	.	C	T	1	1	2	0	0	2	0	0
2	24952406	.	C	A	4	4	8	0	0	8	0	0
2	24957158	.	A	T	0	1	1	0	0	1	0	0
2	24958705	.	A	G	1	1	2	0	0	2	0	0
2	24958712	.	T	G	1	1	2	0	0	2	0	0
2	24970127	.	T	A	5	3	8	0	0	8	0	0
2	24991149	.	G	A	17	9	26	0	0	26	0	0
2	24991153	.	T	C	17	8	25	0	2	27	0	0
2	24991476	.	G	A	12	9	21	0	2	23	0	0
2	24991825	.	G	A	16	11	27	0	1	28	0	0
2	24992185	.	T	C	9	11	20	0	1	21	0	0
2	24992242	.	C	T	0	11	11	0	13	24	0	0
2	24992368	.	T	C	8	11	19	0	2	21	0	0
2	24992464	.	C	T	14	10	24	0	2	26	0	0
2	24992536	.	C	G	6	6	12	0	2	14	0	0
2	24992584	.	G	A	1	2	3	0	0	3	0	0
2	24996241	.	C	T	2	2	4	0	1	5	0	0
2	25081243	.	T	C	1	0	1	0	0	1	0	0
2	25102571	.	C	T	4	4	8	0	1	9	0	0
2	25105482	.	G	A	1	1	2	0	0	2	0	0
2	25105681	.	G	T	4	2	6	0	0	6	0	0
2	25105683	.	C	T	4	2	6	0	0	6	0	0
2	25106020	.	T	C	3	7	10	0	0	10	0	0
2	25106310	.	A	T	2	9	11	0	0	11	0	0
2	25106359	.	C	A	5	4	9	0	0	9	0	0
2	25106380	.	A	G	6	6	12	0	2	14	0	0
2	25106402	.	C	A	8	7	15	0	0	15	0	0
2	25106772	.	T	A	5	6	11	0	1	12	0	0
2	25106795	.	G	A	5	4	9	0	1	10	0	0
2	25106874	.	A	C	3	5	8	0	0	8	0	0
2	25106952	.	C	T	2	3	5	0	0	5	0	0
2	25106984	.	A	T	1	2	3	0	0	3	0	0
2	25107571	.	G	T	2	5	7	0	0	7	0	0
2	25107673	.	T	G	9	5	14	0	0	14	0	0
2	25107717	.	C	G	8	8	16	0	0	16	0	0
2	25107891	.	G	T	10	9	19	0	1	20	0	0
2	25107942	.	C	A	10	7	17	0	0	17	0	0
2	25108039	.	C	T	7	8	15	0	2	17	0	0
2	25108050	.	T	A	5	4	9	0	2	11	0	0
2	25108104	.	A	G	8	7	15	0	0	15	0	0
2	25108377	.	T	A	9	6	15	0	0	15	0	0
2	25108633	.	C	T	0	2	2	0	5	7	0	0
2	25108865	.	T	C	7	4	11	0	0	12	1	0
2	25125073	.	G	A	2	3	5	0	0	5	0	0
2	25127042	.	G	T	3	2	5	0	1	6	0	0
2	25127132	.	C	A	4	4	8	0	0	8	0	0
2	25128328	.	G	A	3	5	8	0	0	8	0	0
2	25128581	.	T	C	5	4	9	0	0	9	0	0
2	25128595	.	A	T	4	5	9	0	0	9	0	0
2	25128668	.	C	T	8	6	14	0	0	14	0	0
2	25129116	.	A	T	2	5	7	0	0	7	0	0
2	25129293	.	C	T	2	2	4	0	0	4	0	0
2	25247755	.	T	A	2	6	8	0	0	8	0	0
2	25247769	.	A	C	2	4	6	0	0	6	0	0
2	25280969	.	T	C	1	2	3	0	0	3	0	0
2	25289919	.	G	T	2	3	5	0	0	5	0	0
2	25289933	.	G	A	0	3	3	0	4	7	0	0
2	25291177	.	G	T	1	4	5	0	0	5	0	0
2	25540429	.	G	A	0	2	2	0	1	3	0	0
2	25540436	.	A	T	1	2	3	0	0	3	0	0
2	25540582	.	C	T	2	2	4	0	0	4	0	0
2	25551616	.	G	A	1	2	3	0	0	3	0	0
2	25631446	.	T	A	0	1	1	0	1	2	0	0
2	25631499	.	T	A	1	4	5	0	0	5	0	0
2	25759446	.	C	A	2	2	4	0	0	4	0	0
2	25772113	.	G	A	6	3	9	0	0	9	0	0
2	25781640	.	C	T	3	3	6	0	0	6	0	0
2	25787292	.	C	T	3	3	6	0	0	6	0	0
2	25787553	.	G	C	3	3	6	0	0	6	0	0
2	25794226	.	A	G	0	3	3	0	0	3	0	0
2	25794241	.	C	A	1	3	4	0	0	4	0	0
2	25797439	.	C	T	3	3	6	0	0	6	0	0
2	25797472	.	C	T	4	5	9	0	0	9	0	0
2	25798647	.	A	G	1	4	5	0	0	5	0	0
2	25809736	.	C	T	1	1	2	0	0	2	0	0
2	25814694	.	C	T	10	3	13	0	0	13	0	0
2	25815329	.	G	C	6	5	11	0	0	11	0	0
2	25815412	.	C	G	3	0	3	0	11	14	0	0
2	25815452	.	G	A	8	7	15	0	4	19	0	0
2	25815737	.	G	T	7	4	11	0	0	11	0	0
2	25815780	.	T	G	4	3	7	0	0	7	0	0
2	25816321	.	C	T	7	8	15	0	1	16	0	0
2	25816382	.	C	T	2	2	4	0	1	5	0	0
2	25816383	.	T	C	2	2	4	0	1	5	0	0
2	25843922	.	G	A	1	7	8	1	12	21	0	0
2	25844840	.	C	T	18	13	31	0	0	31	0	0
2	25844986	.	T	A	3	11	14	0	1	15	0	0
2	25947678	.	T	C	3	2	5	0	0	5	0	0
2	25947699	.	T	C	1	2	3	0	0	3	0	0
2	25952800	.	C	T	1	2	3	0	0	3	0	0
2	25952845	.	C	T	1	4	5	0	0	5	0	0
2	25952983	.	C	T	4	4	8	0	1	9	0	0
2	25984970	.	C	T	6	5	11	0	0	11	0	0
2	25985159	.	G	A	0	3	3	0	8	11	0	0
2	25985234	.	G	A	7	4	11	0	0	11	0	0
2	25985405	.	C	T	7	4	11	0	1	12	0	0
2	25985409	.	C	T	7	6	13	0	0	13	0	0
2	25988269	.	A	G	12	7	19	0	2	21	0	0
2	25988378	.	C	A	6	7	13	0	2	15	0	0
2	25988414	.	G	A	0	6	6	0	7	13	0	0
2	25988475	.	C	T	8	4	12	0	0	12	0	0
2	25988551	.	A	T	12	3	15	0	0	15	0	0
2	25988846	.	A	G	6	1	7	0	12	19	0	0
2	25989059	.	G	A	0	8	8	0	5	13	0	0
2	25989610	.	C	T	10	16	26	0	4	30	0	0
2	25989827	.	C	T	3	6	9	0	1	10	0	0
2	25989884	.	T	A	1	5	6	0	1	7	0	0
2	25989905	.	C	A	3	3	6	0	3	9	0	0
2	25989994	.	A	G	17	12	29	0	4	34	1	0
2	25990323	.	G	A	9	10	19	0	3	22	0	0
2	25990337	.	A	G	14	7	21	0	0	21	0	0
2	25990522	.	A	C	6	6	12	0	1	13	0	0
2	25990563	.	A	G	8	7	15	0	0	15	0	0
2	25990702	.	G	A	21	10	31	0	2	33	0	0
2	25990777	.	T	G	2	4	6	1	0	7	0	0
2	26103217	.	G	C	2	2	4	0	0	4	0	0
2	26155992	.	C	T	1	2	3	0	0	3	0	0
2	26156097	.	C	T	1	3	4	0	0	4	0	0
2	26207944	.	T	C	10	10	20	0	0	20	0	0
2	26207977	.	G	A	0	9	9	0	13	22	0	0
2	26208416	.	G	A	14	7	21	0	1	22	0	0
2	26208425	.	G	A	13	6	19	0	1	20	0	0
2	26208480	.	A	C	5	4	9	0	0	9	0	0
2	26208520	.	A	G	5	7	12	0	0	12	0	0
2	26208589	.	A	G	6	15	21	0	0	21	0	0
2	26208621	.	T	C	9	14	23	0	0	23	0	0
2	26208668	.	T	G	12	1	13	0	11	24	0	0
2	26208815	.	G	T	11	8	19	0	1	20	0	0
2	26208832	.	C	G	11	0	11	0	8	19	0	0
2	26208904	.	T	C	15	7	22	0	1	23	0	0
2	26208987	.	G	A	0	10	10	0	15	25	0	0
2	26209030	.	G	A	11	8	19	0	1	20	0	0
2	26209058	.	C	T	6	8	14	0	1	15	0	0
2	26209266	.	A	C	4	3	7	0	0	7	0	0
2	26240771	.	A	T	18	13	31	0	2	33	0	0
2	26240930	.	A	T	13	7	20	0	4	24	0	0
2	26282688	.	C	T	22	17	39	0	1	40	0	0
2	26283723	.	A	G	11	16	27	0	2	29	0	0
2	26300085	.	A	G	3	2	5	0	0	5	0	0
2	26300091	.	G	A	0	2	2	0	2	4	0	0
2	26303684	.	T	A	5	3	8	0	0	8	0	0
2	26303831	.	C	T	2	2	4	0	0	4	0	0
2	26303845	.	A	C	2	4	6	0	1	7	0	0
2	26303905	.	C	A	7	6	13	0	1	14	0	0
2	26304008	.	C	A	4	2	6	0	0	6	0	0
2	26304066	.	T	C	8	9	17	0	1	18	0	0
2	26304173	.	G	A	3	5	8	0	1	9	0	0
2	26443146	.	G	T	17	19	36	0	2	38	0	0
2	26443517	.	T	C	2	3	5	0	0	5	0	0
2	26443859	.	A	G	6	8	14	0	0	14	0	0
2	26463193	.	A	C	3	0	3	0	7	10	0	0
2	26463199	.	C	A	7	3	10	0	0	10	0	0
2	26463309	.	C	T	10	6	16	0	0	16	0	0
2	26463534	.	C	A	6	4	10	0	0	10	0	0
2	26463598	.	T	C	6	0	6	0	3	9	0	0
2	26467131	.	T	G	4	2	6	0	0	6	0	0
2	26467150	.	G	A	2	2	4	0	0	4	0	0
2	26470087	.	A	G	1	3	4	0	0	4	0	0
2	26470208	.	G	A	19	14	33	0	1	34	0	0
2	26470237	.	G	T	14	7	21	0	2	23	0	0
2	26470267	.	G	A	11	10	21	0	2	23	0	0
2	26470537	.	C	T	8	8	16	0	0	16	0	0
2	26470636	.	C	T	1	16	17	0	21	38	0	0
2	26470666	.	A	G	14	17	31	0	1	32	0	0
2	26473106	.	T	C	4	5	9	0	0	9	0	0
2	26473361	.	C	T	4	9	13	0	0	13	0	0
2	26476109	.	G	A	1	2	3	0	0	3	0	0
2	26481029	.	C	T	2	0	2	0	0	2	0	0
2	26481430	.	G	A	0	1	1	0	0	1	0	0
2	26483946	.	G	T	2	4	6	0	0	6	0	0
2	26491457	.	G	C	3	3	6	0	0	6	0	0
2	26491667	.	G	A	0	3	3	0	0	3	0	0
2	26491676	.	A	T	3	0	3	0	0	3	0	0
2	26494366	.	C	T	1	1	2	0	0	2	0	0
2	26494507	.	G	A	2	2	4	0	0	4	0	0
2	26500899	.	G	A	32	29	61	0	4	65	0	0
2	26577378	.	A	G	6	6	12	0	0	12	0	0
2	26588026	.	T	C	1	3	4	0	0	4	0	0
2	26607399	.	T	C	0	1	1	0	0	1	0	0
2	26612624	.	G	C	8	5	13	0	0	13	0	0
2	26612676	.	A	T	11	17	28	0	1	29	0	0
2	26613106	.	G	A	20	17	37	0	3	40	0	0
2	26619786	.	C	T	11	10	21	0	1	22	0	0
2	26620441	.	C	T	8	5	13	0	0	13	0	0
2	26623587	.	C	T	16	14	30	0	4	34	0	0
2	26623832	.	T	C	10	10	20	0	1	21	0	0
2	26627301	.	C	A	13	12	25	0	0	25	0	0
2	26627332	.	T	A	4	4	8	0	0	8	0	0
2	26630855	.	A	G	10	7	17	0	1	18	0	0
2	26656349	.	G	A	0	4	4	0	3	7	0	0
2	26662047	.	G	C	0	4	4	0	0	4	0	0
2	26665081	.	A	G	8	6	14	0	1	15	0	0
2	26665155	.	A	T	8	6	14	0	0	14	0	0
2	26665233	.	G	A	3	5	8	0	0	8	0	0
2	26665375	.	A	G	4	4	8	0	1	9	0	0
2	26665631	.	A	T	9	5	14	0	2	16	0	0
2	26672488	.	A	G	9	12	21	0	1	22	0	0
2	26672800	.	G	A	4	2	6	0	0	6	0	0
2	26676807	.	T	A	2	2	4	0	1	5	0	0
2	26677109	.	T	A	1	3	4	0	0	4	0	0
2	26677172	.	G	A	3	2	5	0	0	5	0	0
2	26677283	.	C	G	2	4	6	0	0	6	0	0
2	26677346	.	T	G	4	3	7	0	0	7	0	0
2	26677512	.	A	T	5	3	8	0	0	8	0	0
2	26677513	.	G	A	5	3	8	0	0	8	0	0
2	26680759	.	T	A	5	4	9	0	1	10	0	0
2	26680762	.	C	T	6	4	10	0	0	10	0	0
2	26680801	.	A	T	6	4	10	0	0	10	0	0
2	26680919	.	G	A	0	2	2	0	7	9	0	0
2	26681064	.	A	T	5	3	8	0	1	9	0	0
2	26681219	.	T	A	4	3	7	0	0	7	0	0
2	26682031	.	G	T	0	5	5	0	6	11	0	0
2	26684689	.	A	G	2	3	5	0	0	5	0	0
2	26686752	.	T	C	1	4	5	0	0	5	0	0
2	26697929	.	A	G	1	2	3	0	0	3	0	0
2	26704075	.	A	G	1	0	1	0	0	1	0	0
2	27000575	.	G	T	5	3	8	0	0	8	0	0
2	27048999	.	C	A	1	0	1	0	0	1	0	0
2	27049123	.	C	A	2	1	3	0	0	3	0	0
2	27064687	.	T	C	3	4	7	0	0	7	0	0
2	27075702	.	G	A	2	3	5	0	0	5	0	0
2	27075980	.	G	A	0	3	3	0	9	12	0	0
2	27075992	.	A	T	4	8	12	0	0	12	0	0
2	27094393	.	C	T	8	8	16	0	0	16	0	0
2	27378439	.	A	G	4	0	4	0	3	7	0	0
2	27380366	.	C	A	0	4	4	0	2	6	0	0
2	27382232	.	C	G	3	6	9	0	0	9	0	0
2	27382489	.	G	A	1	1	2	0	0	2	0	0
2	27382516	.	A	G	2	1	3	0	0	3	0	0
2	27385630	.	C	T	0	1	1	0	1	2	0	0
2	27532523	.	A	G	3	2	5	0	1	6	0	0
2	27538271	.	G	A	0	1	1	0	1	2	0	0
2	27538619	.	G	A	0	4	4	0	0	4	0	0
2	27540458	.	C	T	7	8	15	0	1	16	0	0
2	27541512	.	A	G	5	6	11	0	0	11	0	0
2	27541740	.	C	T	7	7	14	0	0	14	0	0
2	27541743	.	A	G	7	6	13	0	0	13	0	0
2	27541778	.	G	T	6	9	15	0	1	16	0	0
2	27542058	.	A	G	13	1	14	0	5	19	0	0
2	27542721	.	C	T	6	9	15	0	0	15	0	0
2	27542856	.	G	A	1	10	11	0	6	17	0	0
2	27543103	.	A	T	10	4	14	0	0	14	0	0
2	27543212	.	T	A	14	5	19	0	1	20	0	0
2	27543478	.	G	A	0	2	2	0	4	6	0	0
2	27543499	.	C	A	1	2	3	0	1	4	0	0
2	27614082	.	G	C	1	0	1	0	0	1	0	0
2	27636010	.	G	C	8	7	15	0	0	15	0	0
2	27641130	.	G	A	3	4	7	0	0	7	0	0
2	27641159	.	T	C	2	0	2	0	2	4	0	0
2	27642776	.	C	G	2	2	4	0	0	4	0	0
2	27646419	.	G	A	2	4	6	0	0	6	0	0
2	27646430	.	T	A	2	5	7	0	0	7	0	0
2	27651996	.	G	A	1	1	2	0	0	2	0	0
2	27658522	.	G	A	1	0	1	0	1	2	0	0
2	27658566	.	A	G	3	3	6	0	0	6	0	0
2	27658579	.	C	T	4	3	7	0	0	7	0	0
2	27658639	.	G	A	0	2	2	0	1	3	0	0
2	27658973	.	T	G	3	3	6	0	0	6	0	0
2	27659018	.	T	C	6	2	8	0	2	10	0	0
2	27662374	.	C	T	7	5	12	0	0	12	0	0
2	27662496	.	G	A	4	4	8	0	0	8	0	0
2	27662657	.	C	T	2	2	4	0	0	4	0	0
2	27662706	.	T	C	1	2	3	0	0	3	0	0
2	27663616	.	T	G	4	5	9	0	0	9	0	0
2	27663785	.	C	A	5	3	8	0	1	9	0	0
2	27664105	.	G	C	3	3	6	0	0	6	0	0
2	27664317	.	G	T	5	2	7	0	0	7	0	0
2	27670836	.	C	T	0	8	8	0	8	16	0	0
2	27670884	.	T	G	7	9	16	0	2	18	0	0
2	27671172	.	C	T	16	8	24	0	0	24	0	0
2	27671334	.	T	C	6	7	13	0	1	14	0	0
2	27671485	.	A	T	6	6	12	0	3	15	0	0
2	27671486	.	G	A	8	7	15	0	0	15	0	0
2	27671650	.	C	A	0	5	5	0	15	20	0	0
2	27671681	.	G	T	13	8	21	0	0	21	0	0
2	27672215	.	G	T	12	7	19	0	3	22	0	0
2	27672426	.	T	C	6	8	14	0	0	14	0	0
2	27672440	.	C	T	0	8	8	0	8	16	0	0
2	27672535	.	C	T	7	10	17	0	2	19	0	0
2	27672636	.	C	T	6	5	11	0	1	12	0	0
2	27673041	.	A	G	10	9	19	0	0	19	0	0
2	27673080	.	G	A	9	10	19	0	1	20	0	0
2	27673148	.	G	A	9	10	19	0	0	19	0	0
2	27673173	.	A	G	12	7	19	0	1	20	0	0
2	27774370	.	G	A	2	5	7	0	2	9	0	0
2	27843937	.	A	G	2	5	7	0	0	7	0	0
2	27846071	.	G	A	4	3	7	0	0	7	0	0
2	27851928	.	A	T	1	1	2	0	0	2	0	0
2	27933143	.	C	T	3	2	5	0	0	5	0	0
2	27933215	.	C	A	6	4	10	0	0	10	0	0
2	27933260	.	C	A	5	4	9	0	1	10	0	0
2	27933764	.	G	T	2	2	4	0	0	4	0	0
2	27963686	.	C	T	0	6	6	0	0	6	0	0
2	27966602	.	C	T	0	3	3	0	3	6	0	0
2	27966636	.	C	T	3	3	6	0	0	6	0	0
2	27975129	.	A	T	0	1	1	0	0	1	0	0
2	27975150	.	G	A	1	0	1	0	0	1	0	0
2	27975443	.	G	T	1	3	4	0	0	4	0	0
2	27975458	.	T	C	2	3	5	0	0	5	0	0
2	28049696	.	C	T	10	11	21	0	1	22	0	0
2	28049996	.	A	G	10	6	16	0	0	16	0	0
2	28050058	.	C	A	7	5	12	0	2	14	0	0
2	28050243	.	T	C	8	0	8	0	12	20	0	0
2	28050565	.	T	A	6	5	11	0	0	11	0	0
2	28050600	.	G	C	5	0	5	0	6	11	0	0
2	28050759	.	A	G	3	4	7	0	0	7	0	0
2	28050921	.	G	T	5	5	10	0	0	10	0	0
2	28051041	.	T	A	3	8	11	0	1	12	0	0
2	28051092	.	C	T	0	14	14	0	4	18	0	0
2	28051104	.	G	A	5	11	16	0	0	16	0	0
2	28057518	.	G	A	5	6	11	0	1	12	0	0
2	28650238	.	A	G	3	2	5	0	0	5	0	0
2	28650248	.	C	A	3	2	5	0	1	6	0	0
2	28650352	.	A	C	1	3	4	0	0	4	0	0
2	28650358	.	T	A	1	3	4	0	1	5	0	0
2	28650422	.	T	C	5	2	7	0	0	7	0	0
2	28650504	.	T	C	3	9	12	0	1	13	0	0
2	28650612	.	T	G	11	6	17	0	0	17	0	0
2	28650629	.	G	T	11	10	21	0	1	22	0	0
2	28651128	.	T	A	8	11	19	0	2	21	0	0
2	28651193	.	A	G	6	9	15	0	1	16	0	0
2	28651497	.	G	A	3	4	7	0	1	8	0	0
2	28653587	.	A	G	4	2	6	0	0	6	0	0
2	28657777	.	G	A	2	3	5	0	0	5	0	0
2	28902738	.	C	T	1	1	2	0	0	2	0	0
2	28910813	.	C	G	1	1	2	0	0	2	0	0
2	28929177	.	G	A	0	1	1	0	3	4	0	0
2	28930100	.	T	C	5	3	8	0	1	9	0	0
2	28933846	.	T	G	5	6	11	0	0	11	0	0
2	28934011	.	C	T	5	13	18	0	0	18	0	0
2	28934152	.	T	C	9	5	14	0	0	14	0	0
2	29289068	.	G	T	1	1	2	0	0	2	0	0
2	29317718	.	G	A	9	3	12	0	1	13	0	0
2	29352279	.	G	A	1	6	7	0	9	16	0	0
2	29352379	.	A	C	7	7	14	0	1	15	0	0
2	29352411	.	A	C	7	5	12	0	1	13	0	0
2	29352481	.	G	C	4	5	9	0	1	10	0	0
2	29352579	.	T	C	7	3	10	0	0	10	0	0
2	29352673	.	C	T	10	4	14	0	0	14	0	0
2	29352867	.	G	A	2	2	4	0	0	4	0	0
2	29477653	.	T	C	19	14	33	0	1	34	0	0
2	29477733	.	A	T	14	11	25	0	3	28	0	0
2	29477769	.	G	T	20	10	30	0	0	30	0	0
2	29482390	.	G	A	4	3	7	0	0	7	0	0
2	29482417	.	A	G	4	3	7	0	0	7	0	0
2	29485046	.	G	A	3	2	5	0	1	6	0	0
2	29485068	.	G	T	3	6	9	0	0	9	0	0
2	29915582	.	C	G	1	2	3	0	0	3	0	0
2	29979863	.	T	C	2	2	4	0	0	4	0	0
2	30568944	.	A	T	7	9	16	0	2	18	0	0
2	30568959	.	C	T	6	9	15	0	1	16	0	0
2	30574092	.	C	T	0	5	5	0	10	15	0	0
2	30586847	.	G	C	0	6	6	0	0	6	0	0
2	30611283	.	G	T	13	8	21	0	1	22	0	0
2	30613764	.	G	A	4	3	7	0	0	7	0	0
2	30614153	.	C	A	7	7	14	0	1	15	0	0
2	30614370	.	T	G	3	5	8	0	1	9	0	0
2	30618155	.	C	T	2	3	5	0	0	5	0	0
2	30618205	.	T	C	5	0	5	0	4	9	0	0
2	30741192	.	C	T	4	7	11	0	0	11	0	0
2	30743041	.	T	C	5	6	11	0	0	11	0	0
2	30743864	.	A	G	3	9	12	0	2	14	0	0
2	30743907	.	T	C	6	13	19	0	0	19	0	0
2	30743951	.	C	A	2	3	5	0	0	5	0	0
2	30752675	.	C	T	2	2	4	0	0	4	0	0
2	30752796	.	G	A	2	1	3	0	1	4	0	0
2	30753072	.	A	T	8	9	17	0	1	18	0	0
2	30753273	.	G	A	3	15	18	0	0	18	0	0
2	30753888	.	A	G	5	4	9	0	0	9	0	0
2	30753899	.	C	T	6	5	11	0	1	12	0	0
2	30753928	.	G	A	9	6	15	0	0	15	0	0
2	30753991	.	A	G	6	4	10	0	0	10	0	0
2	30754030	.	A	T	8	5	13	0	0	13	0	0
2	30754113	.	T	C	7	11	18	0	0	18	0	0
2	30754196	.	G	A	10	14	24	0	2	26	0	0
2	30754300	.	C	T	12	18	30	0	3	33	0	0
2	30754306	.	G	A	20	13	33	0	0	33	0	0
2	30754346	.	A	G	12	17	29	0	1	30	0	0
2	30754432	.	G	T	13	17	30	0	0	31	1	0
2	30754733	.	A	G	8	1	9	0	1	10	0	0
2	30754741	.	A	G	8	2	10	0	0	10	0	0
2	30754777	.	A	T	8	4	12	0	1	13	0	0
2	30754793	.	A	T	10	4	14	0	0	14	0	0
2	30754932	.	A	G	3	2	5	0	0	5	0	0
2	30755195	.	G	A	2	3	5	0	0	5	0	0
2	30755359	.	A	T	4	12	16	0	0	16	0	0
2	30755522	.	G	T	2	5	7	0	0	7	0	0
2	30762969	.	G	A	0	1	1	0	0	1	0	0
2	31299241	.	A	C	0	18	18	0	2	20	0	0
2	31891344	.	T	A	6	18	24	0	0	24	0	0
2	32392724	.	A	G	6	3	9	0	0	9	0	0
2	32392787	.	C	A	0	4	4	0	5	9	0	0
2	32392876	.	A	T	3	3	6	0	0	6	0	0
2	32393085	.	A	T	1	2	3	0	0	3	0	0
2	32393125	.	C	T	0	3	3	0	1	4	0	0
2	32393259	.	A	G	4	3	7	0	0	7	0	0
2	32393281	.	T	A	4	3	7	0	0	7	0	0
2	32393460	.	C	T	1	4	5	0	4	9	0	0
2	32393516	.	T	C	5	0	5	0	3	8	0	0
2	32393579	.	T	C	2	3	5	0	0	5	0	0
2	32393670	.	A	G	2	5	7	0	0	7	0	0
2	32393731	.	G	A	5	5	10	0	1	11	0	0
2	32393930	.	T	C	1	3	4	0	0	4	0	0
2	32393966	.	A	G	2	4	6	0	0	6	0	0
2	32393985	.	A	G	2	5	7	0	0	7	0	0
2	32394572	.	C	T	4	2	6	0	0	6	0	0
2	32396845	.	C	T	0	3	3	0	1	4	0	0
2	32412539	.	G	A	1	2	3	0	0	3	0	0
2	32475941	.	A	T	4	6	10	0	0	10	0	0
2	32477432	.	T	C	11	16	27	0	2	29	0	0
2	32483020	.	C	G	4	5	9	0	0	9	0	0
2	32485832	.	A	G	4	15	19	0	1	20	0	0
2	32485895	.	C	T	0	5	5	0	8	13	0	0
2	32485962	.	G	A	6	7	13	0	0	13	0	0
2	32485999	.	A	G	5	6	11	0	1	12	0	0
2	32494486	.	G	A	12	11	23	0	1	24	0	0
2	32501188	.	G	A	3	5	8	0	0	8	0	0
2	32505664	.	G	A	1	3	4	0	0	4	0	0
2	32507094	.	C	T	2	1	3	0	0	3	0	0
2	32507218	.	G	A	2	3	5	0	0	5	0	0
2	32508418	.	C	A	1	0	1	0	0	1	0	0
2	32509238	.	T	G	3	5	8	0	0	8	0	0
2	32509247	.	G	A	5	4	9	0	0	9	0	0
2	32509309	.	G	T	4	4	8	0	1	9	0	0
2	32509573	.	G	A	4	6	10	0	0	10	0	0
2	32509636	.	C	T	1	3	4	0	0	4	0	0
2	32515861	.	C	T	0	10	10	0	6	16	0	0
2	32516110	.	T	C	2	11	13	0	1	14	0	0
2	32516359	.	A	T	7	8	15	0	1	16	0	0
2	32516469	.	T	C	5	0	5	0	17	22	0	0
2	32519690	.	G	A	8	6	14	0	1	15	0	0
2	32531232	.	C	T	2	0	2	0	1	3	0	0
2	32558621	.	G	A	6	5	11	0	0	11	0	0
2	32561752	.	A	G	6	4	10	0	1	11	0	0
2	32561754	.	G	A	6	4	10	0	1	11	0	0
2	32562059	.	G	A	6	4	10	0	1	11	0	0
2	32569639	.	G	A	8	7	15	0	3	18	0	0
2	32569717	.	A	G	5	4	9	0	0	9	0	0
2	32569745	.	A	G	7	3	10	0	0	10	0	0
2	32569909	.	T	C	8	0	8	0	7	15	0	0
2	32569930	.	G	A	6	7	13	0	1	14	0	0
2	32577939	.	G	A	2	3	5	0	0	5	0	0
2	32578124	.	A	T	8	13	21	0	1	22	0	0
2	32578230	.	C	T	11	12	23	0	0	23	0	0
2	32578330	.	A	G	4	8	12	0	0	12	0	0
2	32578539	.	C	G	6	2	8	0	0	8	0	0
2	32578580	.	C	A	11	11	22	0	4	26	0	0
2	32578677	.	C	A	8	4	12	0	2	14	0	0
2	32583144	.	A	G	10	6	16	0	0	16	0	0
2	32583162	.	T	A	5	8	13	0	2	15	0	0
2	32583209	.	C	T	6	7	13	0	0	13	0	0
2	32583345	.	C	T	4	10	14	0	0	14	0	0
2	32583411	.	C	A	0	11	11	0	13	24	0	0
2	32583453	.	T	A	3	10	13	0	2	15	0	0
2	32583459	.	A	G	5	7	12	0	0	12	0	0
2	32583629	.	A	C	9	0	9	0	6	15	0	0
2	32583681	.	T	A	2	1	3	0	1	4	0	0
2	32583687	.	G	A	3	1	4	0	0	4	0	0
2	32584548	.	C	T	0	0	0	0	4	4	0	0
2	32590552	.	C	T	1	3	4	0	0	4	0	0
2	32591381	.	G	A	1	2	3	0	0	3	0	0
2	32591697	.	G	T	3	3	6	0	2	8	0	0
2	32594279	.	A	G	2	5	7	0	0	7	0	0
2	32594352	.	T	A	2	4	6	0	0	6	0	0
2	32594614	.	G	A	6	2	8	0	2	10	0	0
2	32594620	.	G	A	7	3	10	0	1	11	0	0
2	32594670	.	A	T	3	2	5	0	0	5	0	0
2	32594699	.	T	A	2	2	4	0	0	4	0	0
2	32594763	.	G	A	1	3	4	0	0	4	0	0
2	32637352	.	T	C	6	2	8	0	2	10	0	0
2	32637366	.	G	A	10	3	13	0	0	13	0	0
2	32665798	.	G	A	1	2	3	0	0	3	0	0
2	32667941	.	C	A	0	4	4	0	3	7	0	0
2	32676228	.	T	A	3	4	7	0	2	9	0	0
2	32676482	.	A	C	3	0	3	0	0	3	0	0
2	32680338	.	C	T	5	3	8	0	0	8	0	0
2	32680356	.	C	T	8	4	12	0	0	12	0	0
2	32682216	.	C	T	1	0	1	0	0	1	0	0
2	32686412	.	C	T	1	2	3	0	0	3	0	0
2	32686594	.	C	T	2	3	5	0	0	5	0	0
2	32756630	.	C	T	5	3	8	0	1	9	0	0
2	32814503	.	G	A	0	2	2	0	0	2	0	0
2	32814677	.	G	C	5	4	9	0	0	9	0	0
2	32814695	.	T	C	7	4	11	0	0	11	0	0
2	32817627	.	G	A	1	3	4	0	0	4	0	0
2	32817921	.	G	A	1	2	3	0	0	3	0	0
2	32820764	.	G	A	4	3	7	0	0	7	0	0
2	32821393	.	G	A	1	2	3	0	0	3	0	0
2	32821622	.	T	G	0	1	1	0	0	1	0	0
2	32823494	.	C	G	0	4	4	0	4	8	0	0
2	32824778	.	G	A	3	5	8	0	0	8	0	0
2	32824896	.	C	T	4	5	9	0	0	9	0	0
2	32825018	.	C	G	0	3	3	0	2	5	0	0
2	32825033	.	G	A	3	2	5	0	0	5	0	0
2	32825294	.	G	A	4	4	8	0	0	8	0	0
2	32825382	.	C	T	5	4	9	0	0	9	0	0
2	32825480	.	T	G	1	4	5	0	0	5	0	0
2	32827135	.	A	G	4	3	7	0	0	7	0	0
2	32828626	.	T	C	1	0	1	0	0	1	0	0
2	32829016	.	T	C	5	4	9	0	0	9	0	0
2	32833524	.	T	C	5	1	6	0	0	6	0	0
2	32849667	.	A	G	1	3	4	0	0	4	0	0
2	32850138	.	C	T	8	6	14	0	0	14	0	0
2	32850305	.	T	C	13	8	21	0	2	23	0	0
2	32850401	.	T	C	6	4	10	0	1	11	0	0
2	33209645	.	T	G	0	0	0	0	1	1	0	0
2	33216346	.	C	T	12	15	27	0	1	28	0	0
2	33216518	.	G	A	1	16	17	0	17	34	0	0
2	33216563	.	C	G	22	12	34	0	0	34	0	0
2	33405883	.	T	A	0	1	1	0	0	1	0	0
2	33418476	.	G	A	3	3	6	0	0	6	0	0
2	33418486	.	T	C	3	6	9	0	0	9	0	0
2	33418534	.	C	A	1	6	7	0	0	7	0	0
2	33418674	.	A	G	2	0	2	0	1	3	0	0
2	33418706	.	A	T	1	0	1	0	1	2	0	0
2	33419463	.	G	C	0	2	2	0	0	2	0	0
2	33419506	.	A	G	1	4	5	0	0	5	0	0
2	33419650	.	A	G	2	4	6	1	0	7	0	0
2	33419661	.	C	T	2	3	5	1	0	6	0	0
2	33420218	.	T	A	2	6	8	0	0	8	0	0
2	33420309	.	T	A	2	1	3	0	1	4	0	0
2	33420318	.	A	G	1	0	1	0	2	3	0	0
2	33420438	.	C	A	2	3	5	0	1	6	0	0
2	33420638	.	T	G	2	2	4	0	0	4	0	0
2	33420806	.	C	T	6	6	12	0	0	12	0	0
2	33420925	.	C	A	5	3	8	0	0	8	0	0
2	33421078	.	G	T	3	2	5	0	0	5	0	0
2	33421200	.	C	T	1	8	9	0	0	9	0	0
2	33421222	.	A	C	2	8	10	0	0	10	0	0
2	33421275	.	C	G	3	8	11	0	0	11	0	0
2	33421276	.	T	C	3	8	11	0	0	11	0	0
2	33421331	.	C	A	4	4	8	0	1	9	0	0
2	33421382	.	A	T	6	4	10	0	0	10	0	0
2	33421441	.	T	G	6	1	7	0	3	10	0	0
2	33421547	.	A	G	2	8	10	0	0	10	0	0
2	33421549	.	A	C	2	8	10	0	0	10	0	0
2	33421720	.	A	G	8	6	14	0	2	16	0	0
2	33421774	.	A	G	9	6	15	0	0	15	0	0
2	33421860	.	T	G	7	7	14	0	0	14	0	0
2	33421872	.	A	T	6	6	12	0	0	12	0	0
2	33421985	.	T	A	9	4	13	0	0	13	0	0
2	33422001	.	C	T	6	4	10	0	2	12	0	0
2	33422125	.	C	T	4	8	12	0	0	12	0	0
2	33422169	.	T	C	3	5	8	0	0	8	0	0
2	33422211	.	G	A	5	6	11	0	0	11	0	0
2	33422286	.	T	G	9	10	19	0	1	20	0	0
2	33422289	.	C	T	10	8	18	0	2	20	0	0
2	33422327	.	G	A	13	14	27	0	0	27	0	0
2	33422509	.	T	A	9	5	14	0	0	14	0	0
2	33477067	.	G	A	2	0	2	0	0	2	0	0
2	33477073	.	C	T	1	1	2	0	0	2	0	0
2	33477139	.	G	A	7	3	10	0	0	10	0	0
2	33492685	.	T	C	1	0	1	0	0	1	0	0
2	33522070	.	C	T	0	5	5	0	1	6	0	0
2	33522130	.	A	T	4	3	7	0	0	7	0	0
2	33645058	.	A	G	3	3	6	0	0	6	0	0
2	33645157	.	A	G	8	6	14	0	1	15	0	0
2	33645250	.	C	A	2	8	10	0	0	10	0	0
2	33645335	.	G	A	3	8	11	0	1	12	0	0
2	33645344	.	C	A	8	5	13	0	0	13	0	0
2	33676225	.	G	A	2	2	4	0	1	5	0	0
2	33676345	.	C	A	6	6	12	0	0	12	0	0
2	33681337	.	A	T	31	22	53	0	2	55	0	0
2	33687090	.	G	A	11	22	33	0	2	35	0	0
2	33687110	.	C	A	11	30	41	0	0	41	0	0
2	33969861	.	C	A	3	2	5	0	0	5	0	0
2	34009014	.	G	A	3	2	5	0	1	6	0	0
2	34022992	.	T	A	3	2	5	0	0	5	0	0
2	34024832	.	A	G	0	2	2	0	0	2	0	0
2	34025167	.	G	A	5	8	13	0	2	15	0	0
2	34029353	.	G	A	1	2	3	0	0	3	0	0
2	34071980	.	T	G	1	3	4	0	1	5	0	0
2	34119467	.	A	C	1	1	2	0	1	3	0	0
2	34119783	.	G	A	0	3	3	0	0	3	0	0
2	34122859	.	A	G	8	3	11	0	0	11	0	0
2	34122985	.	C	T	4	1	5	0	0	5	0	0
2	34126040	.	T	C	2	2	4	0	0	4	0	0
2	34126514	.	G	T	3	2	5	0	1	6	0	0
2	34173253	.	C	T	2	4	6	0	1	7	0	0
2	34173335	.	A	C	2	3	5	0	0	5	0	0
2	34173336	.	G	A	2	3	5	0	0	5	0	0
2	34381013	.	T	G	6	13	19	0	0	19	0	0
2	34381032	.	T	C	5	12	17	0	0	17	0	0
2	34381066	.	C	T	10	6	16	0	0	16	0	0
2	34555410	.	A	G	4	2	6	0	0	6	0	0
2	34573032	.	A	T	7	7	14	0	0	14	0	0
2	34573064	.	C	T	5	4	9	0	0	9	0	0
2	34698215	.	C	A	9	7	16	0	1	17	0	0
2	34714557	.	A	G	0	0	0	0	2	2	0	0
2	34725878	.	A	G	10	3	13	0	0	13	0	0
2	34924412	.	A	G	7	20	27	0	1	28	0	0
2	34962193	.	A	T	1	1	2	0	0	2	0	0
2	34962223	.	A	G	9	0	9	0	10	19	0	0
2	34970135	.	T	C	3	5	8	0	1	9	0	0
2	34970329	.	A	G	13	22	35	0	1	36	0	0
2	34981747	.	G	A	31	20	51	0	3	54	0	0
2	34981986	.	G	A	28	18	46	0	2	48	0	0
2	34982205	.	T	G	17	18	35	0	0	35	0	0
2	34982322	.	A	T	7	6	13	0	1	14	0	0
2	34986702	.	C	T	2	3	5	0	0	5	0	0
2	35012056	.	C	G	0	2	2	0	2	4	0	0
2	35021263	.	G	C	0	1	1	0	1	2	0	0
2	35042702	.	A	G	0	2	2	0	0	2	0	0
2	35117066	.	A	C	2	3	5	0	0	5	0	0
2	35118607	.	C	T	2	1	3	0	0	3	0	0
2	35128951	.	A	G	2	0	2	0	4	6	0	0
2	35395875	.	G	T	4	4	8	0	0	8	0	0
2	35407144	.	C	T	2	2	4	0	0	4	0	0
2	35419385	.	T	C	0	1	1	0	0	1	0	0
2	35421399	.	A	T	5	7	12	0	0	12	0	0
2	35424633	.	C	T	0	2	2	0	0	2	0	0
2	35430682	.	A	G	0	1	1	0	0	1	0	0
2	35434910	.	C	T	2	3	5	0	0	5	0	0
2	35437513	.	C	A	1	1	2	0	0	2	0	0
2	35457782	.	C	T	0	2	2	0	0	2	0	0
2	35473847	.	G	A	0	7	7	0	7	14	0	0
2	35473975	.	G	T	8	5	13	0	0	13	0	0
2	35474049	.	G	A	0	9	9	0	16	25	0	0
2	35474112	.	T	C	3	5	8	0	0	8	0	0
2	35593364	.	T	G	3	5	8	0	0	8	0	0
2	35594003	.	G	A	8	8	16	0	0	16	0	0
2	35595514	.	C	A	16	11	27	0	2	29	0	0
2	35595551	.	A	T	6	14	20	0	1	21	0	0
2	35598219	.	A	T	5	6	11	0	0	11	0	0
2	35598257	.	C	G	2	5	7	0	0	7	0	0
2	35601212	.	T	G	4	5	9	0	0	9	0	0
2	35605841	.	G	A	1	2	3	0	0	3	0	0
2	35607206	.	C	T	7	7	14	0	1	15	0	0
2	35608445	.	T	A	9	9	18	0	2	20	0	0
2	35610890	.	T	G	3	7	10	0	1	11	0	0
2	35611051	.	T	A	3	21	24	0	2	26	0	0
2	35611172	.	C	T	15	18	33	0	1	34	0	0
2	35611765	.	G	A	1	2	3	0	0	3	0	0
2	37566708	.	C	T	1	3	4	0	0	4	0	0
2	37826819	.	A	C	2	9	11	0	1	12	0	0
2	38065375	.	T	C	4	1	5	0	1	6	0	0
2	39553213	.	A	G	12	5	17	0	1	18	0	0
2	39553632	.	T	A	2	4	6	0	0	6	0	0
2	40831917	.	T	C	3	5	8	0	3	11	0	0
2	40831937	.	T	C	4	4	8	0	0	8	0	0
2	41542707	.	A	T	1	5	6	0	0	6	0	0
2	41578137	.	G	T	14	7	21	0	1	23	1	0
2	41581035	.	T	A	33	8	41	3	1	45	0	0
2	41582801	.	T	C	1	7	8	0	0	8	0	0
2	41582805	.	C	T	0	6	6	0	1	7	0	0
2	42420541	.	T	C	5	5	10	0	1	11	0	0
2	43290729	.	G	C	0	0	0	0	1	1	0	0
2	44965165	.	A	T	0	3	3	0	1	4	0	0
2	46140293	.	G	C	8	4	12	0	0	12	0	0
2	46140470	.	T	C	3	3	6	0	0	6	0	0
2	46140479	.	T	C	3	2	5	0	0	5	0	0
2	46175367	.	G	T	0	0	0	0	1	1	0	0
2	46175484	.	C	T	2	1	3	0	1	4	0	0
2	46176783	.	A	G	3	2	5	0	0	5	0	0
2	46176822	.	T	C	4	2	6	0	0	6	0	0
2	46181029	.	T	C	5	5	10	0	0	10	0	0
2	46183855	.	T	C	7	9	16	0	1	17	0	0
2	46183897	.	G	A	9	8	17	0	1	18	0	0
2	46183985	.	A	T	5	7	12	0	0	12	0	0
2	46184024	.	T	A	5	9	14	0	0	14	0	0
2	46184057	.	C	A	9	10	19	0	1	20	0	0
2	46184193	.	C	T	7	14	21	0	2	23	0	0
2	46184248	.	G	C	4	4	8	0	0	9	1	0
2	46184555	.	A	G	9	12	21	0	2	23	0	0
2	46590001	.	A	G	1	0	1	0	2	3	0	0
2	46694469	.	G	C	0	0	0	0	1	1	0	0
2	46715681	.	G	A	4	2	6	0	0	6	0	0
2	47472068	.	T	A	1	3	4	0	0	4	0	0
2	47500251	.	C	T	2	3	5	0	1	6	0	0
2	47506185	.	C	T	0	1	1	0	0	1	0	0
2	47506187	.	G	A	0	1	1	0	0	1	0	0
2	47511341	.	T	C	1	6	7	0	0	7	0	0
2	47512820	.	G	A	7	14	21	0	1	22	0	0
2	47513002	.	G	T	19	9	28	0	1	29	0	0
2	47513391	.	G	A	0	6	6	0	3	9	0	0
2	47513712	.	C	A	15	13	28	0	0	28	0	0
2	47513871	.	C	A	17	14	31	0	1	32	0	0
2	47514001	.	A	G	11	21	32	0	2	34	0	0
2	47514504	.	C	A	2	4	6	0	0	6	0	0
2	47514582	.	T	G	4	8	12	0	1	13	0	0
2	47514613	.	T	A	6	10	16	0	1	17	0	0
2	47514619	.	A	T	7	8	15	0	0	15	0	0
2	47514697	.	A	G	9	19	28	0	0	28	0	0
2	47514878	.	T	G	18	15	33	0	0	33	0	0
2	47515019	.	T	C	12	20	32	0	0	32	0	0
2	47515073	.	T	C	9	18	27	0	0	27	0	0
2	47515111	.	G	A	12	13	25	0	2	27	0	0
2	47515223	.	T	A	15	6	21	0	0	21	0	0
2	47582891	.	A	G	18	25	43	0	1	44	0	0
2	47583029	.	C	A	24	37	61	0	2	63	0	0
2	47583377	.	G	A	4	32	36	0	27	63	0	0
2	47583701	.	C	T	21	26	47	0	2	49	0	0
2	47583788	.	T	A	33	30	63	0	4	67	0	0
2	47584064	.	G	A	2	35	37	0	31	68	0	0
2	47584092	.	G	A	31	35	66	0	3	69	0	0
2	47584547	.	T	A	26	22	48	0	3	51	0	0
2	47584612	.	G	A	21	30	51	0	2	53	0	0
2	47584799	.	A	T	29	34	63	0	0	63	0	0
2	47587423	.	A	T	2	2	4	0	1	5	0	0
2	47587472	.	T	C	2	0	2	0	3	5	0	0
2	47587652	.	C	T	6	5	11	0	1	12	0	0
2	47587703	.	A	G	7	6	13	0	0	13	0	0
2	47644488	.	T	G	29	9	38	0	1	39	0	0
2	47648076	.	A	G	14	18	32	0	1	33	0	0
2	47648091	.	T	G	11	11	22	0	2	24	0	0
2	47651598	.	A	G	3	4	7	0	0	7	0	0
2	47652403	.	A	G	4	4	8	0	3	11	0	0
2	47652406	.	A	G	4	5	9	0	2	11	0	0
2	47658641	.	T	G	3	4	7	0	0	7	0	0
2	47658653	.	G	A	5	5	10	0	0	10	0	0
2	47658752	.	A	G	3	4	7	0	0	7	0	0
2	47661273	.	A	C	6	0	6	0	7	13	0	0
2	47662955	.	A	G	13	6	19	0	0	19	0	0
2	47754496	.	G	T	0	6	6	0	1	7	0	0
2	47754503	.	A	C	1	6	7	0	0	7	0	0
2	47805071	.	G	C	0	3	3	0	2	5	0	0
2	47827274	.	A	G	2	0	2	0	0	2	0	0
2	47829112	.	T	C	3	5	8	0	0	8	0	0
2	47829126	.	C	T	3	5	8	0	0	8	0	0
2	47911556	.	C	T	1	3	4	0	0	4	0	0
2	47911596	.	A	C	1	2	3	0	0	3	0	0
2	47911604	.	T	G	1	2	3	0	0	3	0	0
2	47916467	.	A	T	2	4	6	0	1	7	0	0
2	47916599	.	G	A	3	2	5	0	0	5	0	0
2	47918505	.	T	C	1	1	2	0	0	2	0	0
2	47955412	.	A	G	2	4	6	0	0	6	0	0
2	47955654	.	T	C	3	3	6	0	0	6	0	0
2	48092793	.	C	A	0	1	1	0	0	1	0	0
2	48099532	.	A	T	1	2	3	0	0	3	0	0
2	48099538	.	T	C	1	2	3	0	0	3	0	0
2	48105232	.	G	T	0	1	1	0	0	1	0	0
2	48107376	.	C	T	1	0	1	0	0	1	0	0
2	48108314	.	C	A	3	1	4	0	0	4	0	0
2	48113040	.	G	A	0	1	1	0	0	1	0	0
2	48114388	.	G	A	0	3	3	0	0	3	0	0
2	48114391	.	T	G	0	0	0	0	3	3	0	0
2	48115732	.	T	A	2	2	4	0	0	4	0	0
2	48115990	.	C	T	1	2	3	0	0	3	0	0
2	48118470	.	T	C	2	0	2	0	2	4	0	0
2	48118485	.	G	A	0	2	2	0	2	4	0	0
2	48119134	.	G	A	4	2	6	0	1	7	0	0
2	48119209	.	G	A	6	2	8	0	0	8	0	0
2	48119631	.	A	C	9	5	14	0	0	14	0	0
2	48119696	.	A	T	9	5	14	0	0	15	1	0
2	48119704	.	A	T	9	3	12	0	1	13	0	0
2	48119744	.	A	G	10	9	19	0	0	19	0	0
2	48119793	.	A	C	17	16	33	0	1	34	0	0
2	48119821	.	T	A	15	14	29	0	2	31	0	0
2	48120190	.	A	T	22	3	25	0	0	25	0	0
2	48120273	.	T	C	14	5	19	0	3	22	0	0
2	48120274	.	T	A	16	6	22	0	0	22	0	0
2	48120318	.	A	T	12	6	18	0	2	20	0	0
2	48120392	.	C	G	15	1	16	0	0	16	0	0
2	48120401	.	A	G	15	2	17	0	1	18	0	0
2	48120462	.	T	A	12	7	19	0	0	19	0	0
2	48120516	.	T	C	11	16	27	0	1	28	0	0
2	48120689	.	G	A	13	9	22	0	0	22	0	0
2	48120694	.	C	G	12	8	20	0	2	22	0	0
2	48120743	.	T	C	11	4	15	0	0	15	0	0
2	48120744	.	G	A	11	4	15	0	0	15	0	0
2	48120805	.	T	A	11	7	18	0	1	19	0	0
2	48120825	.	A	C	8	4	12	0	0	12	0	0
2	48120864	.	C	A	7	4	11	0	1	12	0	0
2	48120971	.	T	C	4	1	5	0	0	5	0	0
2	48121039	.	T	C	4	6	10	0	1	11	0	0
2	48121078	.	T	C	3	7	10	0	0	10	0	0
2	48121312	.	G	A	11	6	17	0	0	17	0	0
2	48121351	.	G	C	16	8	24	0	0	24	0	0
2	48121352	.	T	C	15	8	23	0	1	24	0	0
2	48121428	.	T	A	11	6	17	0	0	17	0	0
2	48121713	.	G	T	11	6	17	0	0	17	0	0
2	48121743	.	A	G	12	6	18	0	0	18	0	0
2	48127614	.	G	A	3	0	3	0	0	3	0	0
2	48130224	.	A	G	2	2	4	0	0	4	0	0
2	48145216	.	A	G	1	5	6	0	0	6	0	0
2	48145219	.	T	A	1	5	6	0	0	6	0	0
2	48163723	.	G	A	2	1	3	0	0	3	0	0
2	48203544	.	A	G	8	8	16	0	1	17	0	0
2	48203554	.	C	T	9	9	18	0	1	19	0	0
2	48203622	.	G	A	12	16	28	0	2	30	0	0
2	48203920	.	C	A	0	5	5	0	8	13	0	0
2	48207319	.	C	T	0	10	10	0	7	17	0	0
2	48212114	.	C	A	4	2	6	0	0	6	0	0
2	48217229	.	T	A	1	0	1	0	0	1	0	0
2	48221479	.	C	T	0	5	5	0	8	13	0	0
2	48224011	.	T	C	8	2	10	0	1	11	0	0
2	48232643	.	T	A	4	5	9	0	0	9	0	0
2	48284721	.	G	A	21	16	37	0	1	38	0	0
2	48285153	.	C	G	11	18	29	0	0	29	0	0
2	48285241	.	T	G	9	8	17	0	1	20	2	0
2	48285265	.	A	C	10	7	17	0	0	17	0	0
2	48290805	.	A	T	29	27	56	0	5	61	0	0
2	48290820	.	C	T	31	21	52	0	2	54	0	0
2	48304467	.	G	A	13	13	26	0	1	27	0	0
2	48309874	.	T	A	10	9	19	0	0	19	0	0
2	48309876	.	A	T	11	7	18	0	1	19	0	0
2	48309970	.	C	A	14	21	35	0	0	35	0	0
2	48310207	.	C	T	0	8	8	0	11	19	0	0
2	48310258	.	A	T	8	14	22	0	1	23	0	0
2	48310266	.	T	C	6	0	6	0	13	19	0	0
2	48310330	.	C	G	4	5	9	0	0	9	0	0
2	48310342	.	A	G	6	5	11	0	0	11	0	0
2	48310374	.	G	A	9	4	13	0	1	14	0	0
2	48313598	.	A	G	5	5	10	0	0	10	0	0
2	48317363	.	G	T	12	16	28	0	1	29	0	0
2	48317418	.	C	G	11	14	25	0	0	25	0	0
2	48317444	.	G	T	9	11	20	0	0	20	0	0
2	48323317	.	C	T	2	17	19	0	2	21	0	0
2	48323341	.	T	C	5	16	21	0	1	22	0	0
2	48323470	.	A	T	19	18	37	0	2	39	0	0
2	48323562	.	A	T	19	12	31	0	7	38	0	0
2	48323572	.	A	G	20	14	34	0	3	37	0	0
2	48323695	.	A	G	14	15	29	0	4	33	0	0
2	48323863	.	A	G	13	16	29	0	1	30	0	0
2	48326354	.	G	A	6	7	13	0	0	13	0	0
2	48326408	.	C	T	0	7	7	0	12	19	0	0
2	48332566	.	A	G	3	3	6	0	0	6	0	0
2	48335187	.	G	A	1	1	2	0	0	2	0	0
2	48343367	.	G	A	3	6	9	0	0	9	0	0
2	48344066	.	C	G	3	3	6	0	0	6	0	0
2	48344072	.	T	C	3	0	3	0	3	6	0	0
2	48345379	.	A	G	1	1	2	0	0	2	0	0
2	48478585	.	G	T	4	2	6	0	0	6	0	0
2	48478608	.	A	G	4	2	6	0	0	6	0	0
2	48539472	.	A	G	1	3	4	0	0	4	0	0
2	48546121	.	T	A	0	4	4	0	0	4	0	0
2	48552301	.	A	G	4	4	8	0	0	8	0	0
2	48552564	.	G	T	1	0	1	0	0	1	0	0
2	48552681	.	A	T	1	0	1	0	0	1	0	0
2	48552687	.	A	T	1	1	2	0	0	2	0	0
2	48753714	.	C	T	3	4	7	0	0	7	0	0
2	49007765	.	A	G	10	6	16	0	3	19	0	0
2	49007781	.	A	T	10	9	19	0	2	21	0	0
2	49007869	.	T	C	13	5	18	0	1	19	0	0
2	49008339	.	A	T	3	6	9	0	0	9	0	0
2	49008382	.	T	G	8	3	11	0	1	12	0	0
2	49017754	.	C	T	1	4	5	0	0	5	0	0
2	50892671	.	A	G	5	12	17	0	0	17	0	0
2	50892686	.	A	G	15	0	15	0	5	20	0	0
2	52052790	.	T	C	7	3	10	0	0	10	0	0
2	52057394	.	A	G	2	0	2	0	4	6	0	0
2	52060070	.	T	G	1	2	3	0	0	3	0	0
2	52060450	.	G	A	8	5	13	0	1	14	0	0
2	52060492	.	A	T	0	4	4	0	0	4	0	0
2	52062918	.	G	A	0	9	9	0	6	15	0	0
2	52062989	.	T	A	7	4	11	0	1	12	0	0
2	52063101	.	T	A	4	3	7	0	0	7	0	0
2	52063207	.	T	C	2	6	8	0	0	8	0	0
2	52063208	.	C	T	2	6	8	0	0	8	0	0
2	52063250	.	C	G	4	5	9	0	0	9	0	0
2	52138732	.	A	G	1	0	1	0	2	3	0	0
2	52810997	.	G	T	6	4	10	0	1	11	0	0
2	52814146	.	C	T	1	2	3	0	0	3	0	0
2	52815260	.	G	A	1	1	2	0	0	2	0	0
2	52815292	.	C	T	4	3	7	0	0	7	0	0
2	52826659	.	A	G	1	5	6	0	0	6	0	0
2	52827298	.	A	G	3	8	11	0	0	11	0	0
2	53720058	.	G	C	0	6	6	0	6	12	0	0
2	53720098	.	A	G	8	0	8	0	6	14	0	0
2	53720122	.	C	G	3	3	6	0	0	6	0	0
2	53721966	.	G	C	1	0	1	0	0	1	0	0
2	53721976	.	A	G	1	1	2	0	1	3	0	0
2	53724856	.	G	A	2	4	6	0	0	6	0	0
2	53750668	.	T	C	5	4	9	0	2	11	0	0
2	53750707	.	C	T	3	6	9	0	0	9	0	0
2	53750719	.	C	T	3	4	7	0	2	9	0	0
2	54018461	.	G	A	1	7	8	0	0	8	0	0
2	54832219	.	A	G	2	3	5	0	0	5	0	0
2	54832224	.	A	G	3	3	6	0	0	6	0	0
2	55200769	.	C	A	1	6	7	0	0	7	0	0
2	55200897	.	C	T	2	3	5	0	0	5	0	0
2	55210962	.	C	T	2	7	9	0	0	9	0	0
2	55211004	.	G	A	0	7	7	0	6	13	0	0
2	55211034	.	A	G	7	0	7	0	7	14	0	0
2	55211049	.	C	G	6	0	6	0	6	12	0	0
2	55273940	.	G	T	2	2	4	0	0	4	0	0
2	55430016	.	C	T	6	6	12	0	1	13	0	0
2	55430024	.	T	C	7	10	17	0	0	17	0	0
2	55430091	.	T	C	14	13	27	0	3	30	0	0
2	55430128	.	C	T	9	10	19	0	2	21	0	0
2	55430136	.	A	G	7	8	15	0	1	16	0	0
2	55433494	.	C	A	19	13	32	0	1	33	0	0
2	55444789	.	A	G	8	0	8	0	9	17	0	0
2	55444825	.	C	G	11	9	20	0	0	20	0	0
2	55444831	.	A	G	10	8	18	0	1	19	0	0
2	55488992	.	G	A	0	6	6	0	5	11	0	0
2	55489237	.	T	G	4	13	17	0	0	17	0	0
2	55489383	.	T	A	15	13	28	0	1	29	0	0
2	55490016	.	C	G	6	7	13	0	0	13	0	0
2	55490062	.	C	T	11	14	25	0	0	25	0	0
2	55490232	.	T	C	12	17	29	0	1	30	0	0
2	55490313	.	C	T	16	10	26	0	1	27	0	0
2	55490348	.	G	A	15	16	31	0	0	31	0	0
2	55490434	.	A	G	14	1	15	0	10	25	0	0
2	55490521	.	T	C	10	21	31	0	2	33	0	0
2	55490934	.	G	T	23	12	35	0	1	36	0	0
2	55491471	.	C	T	27	12	39	0	3	42	0	0
2	55491666	.	G	A	16	7	23	0	2	25	0	0
2	55491717	.	G	A	11	23	34	0	1	35	0	0
2	55491754	.	C	A	17	22	39	0	0	39	0	0
2	55491884	.	T	C	6	32	38	0	1	39	0	0
2	55491893	.	T	C	4	29	33	0	4	37	0	0
2	55491945	.	A	T	7	21	28	0	2	30	0	0
2	55492064	.	T	C	20	18	38	0	0	38	0	0
2	55492104	.	T	C	13	16	29	0	1	30	0	0
2	55492108	.	A	G	13	0	13	0	17	30	0	0
2	55670652	.	C	A	3	3	6	0	0	6	0	0
2	55791001	.	C	T	0	7	7	0	1	8	0	0
2	55915076	.	A	T	3	4	7	0	0	7	0	0
2	55915156	.	G	C	1	1	2	0	0	2	0	0
2	55933226	.	C	T	7	4	11	0	0	11	0	0
2	55944189	.	G	A	1	1	2	0	0	2	0	0
2	55944195	.	C	T	1	1	2	0	0	2	0	0
2	55962539	.	A	T	2	3	5	0	0	5	0	0
2	55962572	.	T	A	3	3	6	0	1	7	0	0
2	55962664	.	C	A	3	1	4	0	1	5	0	0
2	55962837	.	G	A	0	2	2	0	1	3	0	0
2	55962912	.	A	G	2	4	6	0	0	6	0	0
2	55962949	.	G	A	2	7	9	0	0	9	0	0
2	55963207	.	A	C	0	2	2	0	1	3	0	0
2	55963853	.	C	T	0	3	3	0	1	4	0	0
2	55964004	.	A	G	2	0	2	0	2	4	0	0
2	55964022	.	C	T	2	2	4	0	0	4	0	0
2	55964168	.	T	C	2	2	4	0	0	4	0	0
2	55964186	.	A	T	3	3	6	0	0	6	0	0
2	55964231	.	A	T	5	6	11	0	0	11	0	0
2	55964264	.	G	T	3	3	6	0	0	6	0	0
2	55964875	.	T	A	5	2	7	0	0	7	0	0
2	55964935	.	A	T	5	4	9	0	0	9	0	0
2	55964971	.	A	C	4	8	12	0	1	13	0	0
2	55965163	.	A	T	13	7	20	0	0	20	0	0
2	55965256	.	C	T	9	4	13	0	0	13	0	0
2	55965328	.	C	T	11	12	23	0	1	24	0	0
2	55965572	.	A	T	5	5	10	0	0	10	0	0
2	55965576	.	A	C	3	5	8	0	0	9	1	0
2	55965799	.	G	T	4	9	13	0	0	13	0	0
2	55965898	.	A	G	6	0	6	0	4	10	0	0
2	55965900	.	G	A	0	3	3	0	7	10	0	0
2	55966022	.	C	G	0	0	0	0	5	5	0	0
2	55966441	.	T	C	2	4	6	0	0	6	0	0
2	55966443	.	T	A	2	4	6	0	0	6	0	0
2	55966612	.	G	C	6	5	11	0	0	11	0	0
2	55966616	.	G	A	7	4	11	0	0	11	0	0
2	55966716	.	G	T	9	7	16	0	0	16	0	0
2	55966822	.	T	G	1	5	6	0	1	7	0	0
2	55966912	.	A	T	7	3	10	0	1	11	0	0
2	55967188	.	T	C	5	10	15	0	1	16	0	0
2	55967233	.	C	T	11	4	15	0	0	15	0	0
2	55967471	.	A	T	10	4	14	0	2	16	0	0
2	55967638	.	T	A	12	9	21	0	1	22	0	0
2	55967667	.	C	T	17	10	27	0	2	29	0	0
2	55967758	.	T	C	13	13	26	0	1	27	0	0
2	55967882	.	C	T	0	2	2	1	0	3	0	0
2	55967908	.	C	A	1	4	5	0	0	5	0	0
2	55967949	.	A	G	5	5	10	0	0	10	0	0
2	55967963	.	G	C	6	6	12	0	0	12	0	0
2	55967987	.	T	G	3	3	6	0	1	7	0	0
2	55968123	.	C	A	10	6	16	0	0	16	0	0
2	55968147	.	T	C	12	10	22	0	0	22	0	0
2	55968204	.	A	G	14	7	21	0	1	22	0	0
2	55968240	.	C	T	16	5	21	0	0	21	0	0
2	55968294	.	G	T	14	12	26	0	1	27	0	0
2	55968383	.	A	C	20	13	33	0	0	33	0	0
2	55968411	.	T	G	20	1	21	0	14	35	0	0
2	55968472	.	A	G	14	1	15	0	11	26	0	0
2	55968617	.	T	A	5	3	8	0	0	8	0	0
2	55968859	.	A	G	9	3	12	1	0	13	0	0
2	55968896	.	C	T	3	6	9	0	0	9	0	0
2	55968932	.	A	C	2	5	7	0	1	8	0	0
2	55969605	.	A	T	3	5	8	0	0	8	0	0
2	55969787	.	G	C	1	3	4	0	0	4	0	0
2	55970662	.	C	T	11	10	21	0	1	22	0	0
2	55970684	.	C	T	12	11	23	0	2	25	0	0
2	56125231	.	G	A	7	6	13	0	0	13	0	0
2	56125687	.	T	C	16	15	31	0	6	37	0	0
2	56125744	.	G	C	15	1	16	0	21	37	0	0
2	56125821	.	G	T	16	14	30	0	4	34	0	0
2	56125837	.	C	T	0	13	13	0	16	29	0	0
2	56125859	.	A	T	14	11	25	0	0	25	0	0
2	56126359	.	A	G	3	2	5	0	1	6	0	0
2	56126788	.	T	A	2	2	4	0	0	4	0	0
2	56126792	.	T	C	2	2	4	0	0	4	0	0
2	56127612	.	G	A	4	12	16	0	1	17	0	0
2	56127693	.	T	G	13	5	18	0	1	19	0	0
2	56127720	.	C	G	9	14	23	0	2	25	0	0
2	56127848	.	T	A	3	6	9	0	2	11	0	0
2	56127881	.	T	A	3	3	6	0	1	7	0	0
2	56127884	.	A	T	3	3	6	0	1	7	0	0
2	56127951	.	A	T	1	6	7	0	0	7	0	0
2	56127962	.	T	C	3	4	7	0	0	7	0	0
2	56128025	.	A	G	11	16	27	0	1	28	0	0
2	56128029	.	A	T	11	18	29	0	1	30	0	0
2	56128224	.	A	G	6	7	13	0	0	13	0	0
2	56128259	.	A	G	6	6	12	0	0	12	0	0
2	56128455	.	G	A	11	7	18	0	1	19	0	0
2	56128527	.	A	G	9	5	14	0	1	15	0	0
2	56128582	.	A	G	11	5	16	0	1	17	0	0
2	56128677	.	C	T	9	12	21	0	3	24	0	0
2	56128687	.	A	T	11	14	25	0	0	25	0	0
2	56128895	.	T	A	15	10	25	0	0	25	0	0
2	56129001	.	A	G	12	7	19	0	2	21	0	0
2	56129175	.	G	C	14	12	26	0	0	26	0	0
2	56129285	.	G	T	12	8	20	0	1	21	0	0
2	56129299	.	G	A	11	8	19	0	2	21	0	0
2	56129332	.	G	A	11	4	15	0	0	15	0	0
2	56129462	.	C	G	5	2	7	0	0	7	0	0
2	56129613	.	T	C	8	9	17	0	0	17	0	0
2	56129793	.	A	G	3	4	7	0	0	7	0	0
2	56130019	.	A	C	13	13	26	0	0	27	1	0
2	56130212	.	T	G	11	8	19	0	1	20	0	0
2	56130259	.	A	G	6	9	15	0	1	16	0	0
2	56130260	.	C	G	5	10	15	0	1	16	0	0
2	56130296	.	C	A	12	11	23	0	0	23	0	0
2	56131299	.	G	A	14	4	18	0	0	18	0	0
2	56157441	.	G	A	0	4	4	0	2	6	0	0
2	56162189	.	C	G	1	0	1	0	2	3	0	0
2	56162217	.	C	T	3	2	5	0	0	5	0	0
2	56162254	.	G	C	6	2	8	0	0	8	0	0
2	56162404	.	C	G	3	3	6	0	0	6	0	0
2	56169512	.	G	A	0	6	6	0	5	11	0	0
2	56181587	.	T	C	0	2	2	0	0	2	0	0
2	56181821	.	C	T	2	3	5	0	0	5	0	0
2	56196950	.	C	T	0	0	0	0	1	1	0	0
2	56200571	.	C	A	0	1	1	0	0	1	0	0
2	56205615	.	G	T	0	2	2	0	1	3	0	0
2	56205744	.	G	A	0	2	2	0	0	2	0	0
2	56213051	.	C	G	0	1	1	0	0	1	0	0
2	56213063	.	T	C	1	1	2	0	0	2	0	0
2	56216760	.	C	T	4	6	10	0	1	11	0	0
2	56219233	.	G	A	0	1	1	0	0	1	0	0
2	56226369	.	C	G	6	11	17	0	2	19	0	0
2	56226372	.	A	G	7	0	7	0	14	21	0	0
2	56226444	.	T	C	3	6	9	0	0	9	0	0
2	56233498	.	C	G	11	2	13	0	0	13	0	0
2	56233508	.	G	T	10	5	15	0	2	17	0	0
2	56234749	.	T	C	11	6	17	0	0	17	0	0
2	56268014	.	C	T	3	4	7	0	1	8	0	0
2	56278750	.	G	C	0	1	1	0	0	5	4	0
2	56339104	.	T	G	16	14	30	0	2	32	0	0
2	56344833	.	A	G	2	9	11	0	0	11	0	0
2	56356796	.	T	C	8	10	18	0	1	19	0	0
2	56356806	.	T	C	9	9	18	0	1	19	0	0
2	56359363	.	G	A	0	3	3	0	0	3	0	0
2	56359434	.	A	G	9	8	17	0	1	18	0	0
2	56361406	.	G	A	2	2	4	0	0	4	0	0
2	56361412	.	A	G	2	4	6	0	0	6	0	0
2	56374933	.	C	A	2	5	7	0	1	8	0	0
2	56472472	.	C	T	6	2	8	0	0	8	0	0
2	56472553	.	C	T	6	6	12	0	0	12	0	0
2	56476113	.	G	A	0	4	4	0	1	5	0	0
2	56476573	.	G	T	1	16	17	0	20	37	0	0
2	56476732	.	C	T	21	13	34	0	3	37	0	0
2	56476762	.	A	G	10	16	26	0	1	27	0	0
2	56476812	.	A	G	7	19	26	0	0	26	0	0
2	56476909	.	A	C	5	8	13	0	4	17	0	0
2	56508570	.	A	C	6	6	12	0	0	12	0	0
2	56508695	.	T	C	24	13	37	0	2	39	0	0
2	56508878	.	A	G	12	13	25	0	1	26	0	0
2	56508880	.	C	T	12	12	24	0	2	26	0	0
2	56509097	.	T	A	14	9	23	0	0	23	0	0
2	56509098	.	A	T	14	8	22	0	1	23	0	0
2	56510817	.	T	C	17	0	17	1	7	25	0	0
2	56511064	.	G	T	2	9	11	0	0	11	0	0
2	56511463	.	A	C	0	4	4	0	2	6	0	0
2	56511845	.	G	T	9	5	14	0	0	14	0	0
2	56511877	.	C	T	7	4	11	0	0	11	0	0
2	56511917	.	C	T	3	6	9	0	0	9	0	0
2	56512032	.	C	T	0	1	1	0	0	1	0	0
2	56512054	.	T	C	1	0	1	1	3	5	0	0
2	56512115	.	T	G	0	7	7	1	0	10	2	0
2	56512241	.	G	T	7	1	8	0	0	8	0	0
2	56512265	.	T	A	0	3	3	0	0	3	0	0
2	56513510	.	A	C	8	12	20	0	4	24	0	0
2	56513660	.	C	T	2	7	9	0	6	15	0	0
2	56513742	.	C	A	7	15	22	0	0	22	0	0
2	56513795	.	G	T	17	13	30	0	0	30	0	0
2	56541388	.	T	C	4	0	4	0	2	6	0	0
2	56541417	.	G	A	7	9	16	0	0	16	0	0
2	56557264	.	G	T	10	11	21	0	0	21	0	0
2	56572249	.	G	A	5	3	8	0	0	8	0	0
2	56574486	.	C	T	0	6	6	0	1	7	0	0
2	56574525	.	C	T	0	2	2	0	0	2	0	0
2	56645018	.	G	A	33	27	60	0	1	61	0	0
2	56649806	.	A	G	3	7	10	0	0	10	0	0
2	56811625	.	C	T	3	2	5	0	0	5	0	0
2	56811844	.	A	G	1	1	2	0	1	3	0	0
2	56812168	.	T	A	2	2	4	0	0	4	0	0
2	57076559	.	A	G	1	2	3	0	0	3	0	0
2	57097175	.	G	A	0	1	1	0	0	1	0	0
2	57097176	.	C	A	0	1	1	0	0	1	0	0
2	57121623	.	A	T	3	6	9	0	0	9	0	0
2	57121773	.	C	T	0	2	2	0	1	3	0	0
2	57121793	.	G	A	1	0	1	0	1	2	0	0
2	57130154	.	G	A	4	3	7	0	0	7	0	0
2	57135816	.	G	A	2	2	4	0	0	4	0	0
2	57135843	.	T	A	2	2	4	0	0	4	0	0
2	57143433	.	G	A	4	1	5	0	0	5	0	0
2	57143436	.	C	T	4	1	5	0	0	5	0	0
2	57151194	.	G	A	14	16	30	0	1	31	0	0
2	57151242	.	G	T	25	21	46	0	3	49	0	0
2	57151326	.	A	G	12	1	13	0	12	25	0	0
2	57152858	.	T	G	31	12	43	0	2	45	0	0
2	57156050	.	C	A	19	22	41	0	2	43	0	0
2	57156092	.	C	A	16	18	34	0	1	35	0	0
2	57157952	.	C	T	21	32	53	0	2	55	0	0
2	57159557	.	G	A	19	16	35	0	2	37	0	0
2	57159668	.	G	A	33	26	59	0	2	61	0	0
2	57160272	.	C	T	24	20	44	0	3	47	0	0
2	57164902	.	A	G	10	10	20	0	0	20	0	0
2	57165001	.	C	T	24	28	52	0	0	52	0	0
2	57165544	.	C	T	28	27	55	0	2	57	0	0
2	57165565	.	C	T	27	32	59	0	1	60	0	0
2	57212864	.	G	A	2	1	3	0	0	3	0	0
2	57212966	.	T	C	11	1	12	0	9	21	0	0
2	57225181	.	C	T	0	0	0	0	1	1	0	0
2	57225187	.	A	G	1	0	1	0	0	1	0	0
2	57227354	.	A	C	3	4	7	0	0	7	0	0
2	57240340	.	A	T	4	5	9	0	0	10	1	0
2	57240345	.	C	T	5	6	11	0	0	11	0	0
2	57240570	.	A	T	4	4	8	0	0	8	0	0
2	57240649	.	C	T	0	4	4	0	5	9	0	0
2	57240708	.	C	T	7	8	15	0	0	15	0	0
2	57240736	.	G	A	6	11	17	0	0	17	0	0
2	57247280	.	C	A	0	5	5	0	8	13	0	0
2	57251501	.	A	T	5	3	8	0	0	8	0	0
2	57268868	.	G	A	21	12	33	0	3	36	0	0
2	57268877	.	T	A	19	14	33	0	2	35	0	0
2	57269031	.	C	G	29	21	50	0	2	52	0	0
2	57269136	.	T	A	10	6	16	0	0	16	0	0
2	57284550	.	A	T	4	3	7	0	0	7	0	0
2	57325919	.	C	T	0	1	1	0	1	2	0	0
2	57416951	.	T	A	5	2	7	0	0	7	0	0
2	57417062	.	C	T	2	4	6	0	0	6	0	0
2	57417223	.	G	A	3	4	7	0	0	7	0	0
2	57417357	.	C	T	3	2	5	0	0	5	0	0
2	57417362	.	C	A	4	2	6	0	0	6	0	0
2	57870106	.	T	C	0	2	2	0	1	3	0	0
2	57893346	.	G	A	2	7	9	0	0	9	0	0
2	57898902	.	A	G	0	3	3	0	0	3	0	0
2	58013448	.	G	A	9	4	13	0	0	13	0	0
2	58412124	.	G	A	0	1	1	0	7	8	0	0
2	58516445	.	C	A	2	9	11	0	0	12	1	0
2	58523710	.	C	A	0	5	5	0	7	12	0	0
2	58541939	.	G	A	13	11	24	0	2	26	0	0
2	58541981	.	C	G	6	16	22	0	0	22	0	0
2	58546893	.	G	A	9	7	16	0	1	17	0	0
2	58560081	.	G	C	0	1	1	0	0	1	0	0
2	58581582	.	G	C	1	1	2	0	0	2	0	0
2	58739467	.	T	C	9	9	18	0	0	18	0	0
2	58742652	.	G	A	0	5	5	0	11	16	0	0
2	58778264	.	G	A	12	10	22	0	1	23	0	0
2	58785286	.	G	A	5	6	11	0	1	12	0	0
2	58789112	.	G	A	7	6	13	0	1	14	0	0
2	58793396	.	C	T	0	13	13	0	10	23	0	0
2	58793438	.	A	G	9	12	21	0	1	22	0	0
2	58793652	.	A	G	7	4	11	0	0	11	0	0
2	58793667	.	G	A	8	7	15	0	0	15	0	0
2	58845161	.	G	T	0	0	0	0	1	1	0	0
2	58848646	.	T	G	37	2	39	0	28	67	0	0
2	58848767	.	C	T	24	15	39	0	3	42	0	0
2	58868190	.	G	A	6	7	13	0	3	16	0	0
2	58868439	.	T	C	12	2	14	0	15	29	0	0
2	58868508	.	A	C	11	2	13	0	11	24	0	0
2	58868679	.	G	A	7	9	16	0	0	16	0	0
2	58869166	.	G	A	7	3	10	0	1	11	0	0
2	58869268	.	A	G	6	4	10	0	2	12	0	0
2	58869319	.	G	A	8	6	14	0	0	14	0	0
2	58878288	.	G	A	0	2	2	0	3	5	0	0
2	58878612	.	C	T	11	8	19	0	2	21	0	0
2	58887817	.	C	T	0	10	10	0	6	16	0	0
2	58888019	.	G	A	15	0	15	0	0	15	0	0
2	58888870	.	A	G	4	4	8	0	1	9	0	0
2	58888916	.	T	A	5	4	9	0	3	12	0	0
2	58892142	.	T	C	5	0	5	0	10	15	0	0
2	58898167	.	C	T	0	2	2	0	1	3	0	0
2	58898910	.	A	G	6	2	8	0	0	8	0	0
2	58899904	.	T	C	0	0	0	0	2	2	0	0
2	59004046	.	C	T	1	0	1	0	0	1	0	0
2	59023901	.	T	C	4	5	9	0	0	9	0	0
2	59045912	.	A	G	8	0	8	0	6	14	0	0
2	59056203	.	C	T	13	13	26	0	3	29	0	0
2	59056212	.	G	A	12	9	21	0	1	22	0	0
2	59057670	.	C	T	14	6	20	0	2	22	0	0
2	59063227	.	T	C	5	5	10	0	0	10	0	0
2	59136919	.	T	G	3	4	7	0	0	7	0	0
2	59137050	.	T	A	2	5	7	4	1	12	0	0
2	59137182	.	G	T	3	5	8	0	1	9	0	0
2	59137184	.	G	T	4	4	8	0	0	9	1	0
2	59143183	.	A	G	5	4	9	0	0	9	0	0
2	59144092	.	A	G	2	4	6	0	0	6	0	0
2	59539631	.	C	T	1	2	3	0	0	3	0	0
2	59550509	.	G	A	0	3	3	0	1	4	0	0
2	59556935	.	G	T	0	2	2	0	2	4	0	0
2	59556968	.	A	G	2	0	2	0	2	4	0	0
2	59557097	.	G	C	0	2	2	0	6	8	0	0
2	59557119	.	A	C	5	5	10	0	0	10	0	0
2	59557199	.	T	C	0	2	2	0	0	2	0	0
2	59557202	.	A	T	0	2	2	0	0	2	0	0
2	59565439	.	C	T	0	2	2	0	0	2	0	0
2	59565521	.	T	G	2	0	2	0	6	8	0	0
20	19366	.	A	G	1	0	1	0	0	1	0	0
20	66886	.	C	A	0	4	4	0	0	4	0	0
20	67321	.	C	T	2	4	6	0	1	7	0	0
20	67388	.	C	A	5	2	7	0	0	7	0	0
20	67755	.	C	T	5	5	10	0	0	10	0	0
20	67867	.	T	G	6	5	11	0	0	11	0	0
20	75079	.	C	A	10	6	16	0	1	17	0	0
20	75121	.	C	T	10	4	14	0	1	15	0	0
20	75148	.	T	C	10	9	19	0	1	20	0	0
20	75266	.	G	A	1	6	7	0	5	12	0	0
20	75330	.	T	A	8	6	14	0	0	14	0	0
20	75374	.	A	G	10	8	18	0	0	18	0	0
20	75376	.	G	T	1	8	9	0	9	18	0	0
20	75889	.	C	T	17	8	25	0	2	27	0	0
20	76193	.	G	A	0	7	7	0	6	13	0	0
20	76209	.	A	G	7	6	13	0	0	13	0	0
20	76285	.	C	T	15	10	25	0	2	27	0	0
20	87897	.	T	A	0	1	1	0	0	1	0	0
20	87948	.	G	A	1	2	3	0	0	3	0	0
20	89176	.	A	G	9	5	14	0	3	17	0	0
20	89188	.	G	T	1	5	6	0	10	16	0	0
20	89567	.	G	A	8	14	22	0	1	23	0	0
20	89607	.	G	T	0	9	9	0	11	20	0	0
20	89625	.	T	A	10	9	19	0	0	19	0	0
20	89720	.	G	A	8	12	20	0	0	20	0	0
20	90003	.	A	T	16	15	31	0	0	31	0	0
20	90167	.	C	T	15	17	32	0	1	33	0	0
20	90242	.	T	C	10	16	26	0	2	28	0	0
20	90246	.	T	C	11	14	25	0	2	27	0	0
20	114708	.	A	G	34	18	52	0	2	54	0	0
20	114776	.	A	G	15	14	29	0	0	29	0	0
20	116164	.	A	T	16	22	38	0	0	38	0	0
20	122227	.	A	T	3	3	6	0	0	6	0	0
20	122244	.	C	G	1	2	3	0	0	3	0	0
20	122702	.	C	T	0	4	4	0	3	7	0	0
20	125470	.	G	A	1	3	4	0	0	4	0	0
20	125488	.	A	G	1	3	4	0	0	4	0	0
20	133339	.	G	A	0	2	2	0	1	3	0	0
20	151548	.	C	T	0	7	7	0	10	17	0	0
20	151637	.	C	T	9	3	12	1	0	13	0	0
20	151846	.	C	T	16	14	30	0	1	31	0	0
20	152496	.	G	C	1	3	4	0	0	4	0	0
20	159486	.	T	C	3	2	5	0	0	5	0	0
20	160140	.	G	C	1	2	3	0	0	3	0	0
20	160141	.	G	A	1	2	3	0	0	3	0	0
20	186752	.	G	A	12	16	28	0	1	29	0	0
20	188449	.	A	G	10	11	21	0	1	22	0	0
20	188638	.	T	C	5	12	17	0	1	18	0	0
20	188687	.	C	G	3	2	5	0	0	5	0	0
20	196767	.	G	A	5	9	14	0	0	14	0	0
20	196773	.	T	A	5	9	14	0	0	14	0	0
20	196838	.	G	A	8	7	15	0	1	16	0	0
20	197274	.	T	C	12	11	23	0	2	25	0	0
20	197560	.	C	G	5	7	12	0	1	13	0	0
20	197842	.	T	C	10	10	20	0	2	22	0	0
20	198040	.	G	T	6	11	17	0	1	18	0	0
20	198049	.	C	T	6	13	19	0	0	19	0	0
20	198112	.	G	T	13	10	23	0	1	24	0	0
20	198127	.	A	T	11	13	24	0	3	27	0	0
20	198352	.	G	A	13	11	24	0	0	24	0	0
20	199168	.	C	T	0	7	7	0	10	17	0	0
20	199956	.	G	A	4	2	6	0	0	6	0	0
20	199962	.	T	C	1	3	4	0	0	4	0	0
20	200302	.	C	T	2	2	4	0	0	4	0	0
20	200544	.	C	T	0	2	2	0	6	8	0	0
20	200851	.	G	A	3	5	8	0	1	9	0	0
20	201524	.	G	C	3	5	8	0	1	9	0	0
20	201889	.	T	C	2	0	2	0	3	5	0	0
20	201957	.	C	G	0	5	5	0	1	6	0	0
20	202012	.	A	G	4	4	8	0	0	8	0	0
20	202340	.	T	A	7	6	13	0	0	13	0	0
20	202480	.	T	C	5	3	8	0	0	8	0	0
20	202891	.	G	A	1	4	5	0	0	5	0	0
20	203089	.	C	A	0	2	2	0	3	5	0	0
20	203122	.	G	A	2	4	6	0	0	6	0	0
20	204292	.	A	C	0	1	1	0	3	4	0	0
20	247639	.	G	A	1	0	1	0	0	1	0	0
20	247648	.	G	C	1	0	1	0	0	1	0	0
20	254130	.	G	A	1	2	3	0	0	3	0	0
20	255431	.	C	T	2	1	3	0	0	3	0	0
20	255433	.	C	G	2	1	3	0	0	3	0	0
20	258687	.	G	A	0	1	1	0	0	1	0	0
20	259602	.	T	C	3	6	9	0	1	10	0	0
20	259625	.	T	C	2	7	9	0	0	9	0	0
20	329072	.	A	C	6	4	10	0	1	11	0	0
20	329113	.	G	A	1	0	1	0	0	1	0	0
20	369583	.	A	G	5	0	5	0	3	8	0	0
20	379577	.	A	C	3	2	5	0	1	6	0	0
20	379595	.	C	T	2	3	5	0	0	5	0	0
20	384606	.	C	T	2	2	4	0	0	4	0	0
20	395704	.	C	T	3	8	11	0	1	12	0	0
20	396013	.	A	G	1	2	3	0	0	3	0	0
20	405867	.	G	A	2	6	8	0	0	8	0	0
20	406264	.	T	A	1	2	3	0	0	3	0	0
20	406278	.	T	A	0	3	3	0	0	3	0	0
20	409377	.	C	A	4	2	6	0	0	6	0	0
20	409524	.	C	T	2	7	9	0	0	9	0	0
20	409629	.	T	C	4	5	9	0	1	10	0	0
20	410832	.	A	T	6	10	16	1	0	17	0	0
20	410981	.	A	T	11	6	17	0	1	18	0	0
20	411063	.	T	A	1	6	7	0	0	7	0	0
20	423977	.	G	C	0	2	2	0	0	2	0	0
20	426390	.	T	C	0	2	2	0	0	2	0	0
20	426434	.	T	A	8	4	12	0	0	12	0	0
20	429984	.	G	A	4	0	4	0	1	5	0	0
20	430080	.	A	G	4	2	6	0	0	6	0	0
20	430703	.	A	C	1	1	2	0	0	2	0	0
20	431851	.	C	T	1	2	3	0	0	3	0	0
20	432898	.	T	A	2	2	4	0	0	4	0	0
20	438554	.	G	A	4	6	10	0	0	10	0	0
20	438613	.	G	A	0	2	2	0	1	3	0	0
20	474341	.	C	A	10	2	12	0	0	12	0	0
20	483866	.	C	T	1	1	2	0	0	2	0	0
20	528561	.	C	T	9	5	14	0	1	15	0	0
20	530335	.	C	T	3	4	7	0	0	7	0	0
20	530405	.	G	A	0	10	10	0	6	16	0	0
20	530408	.	C	T	6	11	17	0	0	17	0	0
20	530443	.	C	T	11	4	15	0	0	15	0	0
20	530445	.	T	G	11	4	15	0	0	15	0	0
20	530534	.	C	G	6	4	10	0	1	11	0	0
20	530536	.	C	T	4	7	11	0	0	11	0	0
20	530624	.	G	T	5	3	8	0	0	8	0	0
20	562186	.	G	A	2	2	4	0	0	4	0	0
20	565450	.	T	G	1	3	4	0	0	4	0	0
20	566083	.	G	A	2	2	4	0	0	4	0	0
20	592243	.	A	G	1	1	2	0	0	2	0	0
20	593880	.	C	T	1	2	3	0	0	3	0	0
20	603647	.	T	C	1	2	3	0	0	3	0	0
20	605171	.	A	T	1	1	2	0	0	2	0	0
20	605264	.	C	T	3	4	7	0	0	7	0	0
20	605291	.	C	T	4	4	8	0	0	8	0	0
20	605471	.	G	A	3	3	6	0	0	6	0	0
20	700683	.	C	T	3	2	5	0	0	5	0	0
20	700686	.	A	T	3	2	5	0	0	5	0	0
20	700899	.	C	A	4	4	8	0	0	8	0	0
20	707767	.	C	T	0	2	2	0	0	2	0	0
20	712497	.	A	G	5	4	9	0	2	11	0	0
20	742087	.	A	C	2	1	3	0	1	4	0	0
20	742126	.	T	C	1	0	1	0	0	1	0	0
20	752624	.	G	A	1	2	3	0	0	3	0	0
20	755725	.	G	A	2	0	2	0	0	2	0	0
20	761004	.	C	T	3	3	6	0	0	6	0	0
20	761006	.	G	C	3	3	6	0	0	6	0	0
20	764346	.	A	G	2	3	5	0	0	5	0	0
20	764355	.	G	A	4	3	7	0	0	7	0	0
20	764388	.	A	G	7	8	15	0	2	17	0	0
20	764436	.	T	C	2	4	6	0	1	7	0	0
20	764807	.	G	A	12	11	23	0	0	23	0	0
20	771986	.	C	G	6	7	13	0	0	13	0	0
20	772700	.	C	T	4	2	6	0	0	6	0	0
20	775412	.	G	A	0	4	4	0	5	9	0	0
20	775487	.	C	T	9	8	17	0	0	17	0	0
20	775538	.	G	A	0	11	11	0	16	27	0	0
20	775562	.	C	T	12	9	21	0	1	22	0	0
20	775583	.	T	A	9	4	13	0	0	13	0	0
20	776171	.	C	T	14	15	29	0	0	29	0	0
20	776261	.	A	T	14	20	34	0	10	45	1	0
20	776519	.	A	G	23	0	23	0	5	28	0	0
20	776630	.	G	T	11	11	22	0	1	23	0	0
20	776826	.	G	A	9	12	21	0	0	21	0	0
20	776961	.	G	T	9	4	13	0	4	17	0	0
20	844590	.	G	A	0	1	1	0	0	1	0	0
20	844592	.	C	G	0	1	1	0	0	1	0	0
20	847735	.	T	G	3	6	9	0	0	9	0	0
20	847758	.	T	A	5	5	10	0	0	10	0	0
20	847779	.	G	A	4	4	8	0	0	8	0	0
20	847820	.	G	A	0	5	5	0	3	8	0	0
20	847854	.	G	A	3	6	9	0	1	10	0	0
20	847887	.	T	A	2	5	7	0	0	7	0	0
20	851699	.	G	A	5	4	9	0	0	9	0	0
20	851746	.	G	A	10	9	19	0	0	19	0	0
20	851843	.	T	C	6	9	15	0	0	15	0	0
20	851876	.	C	T	9	9	18	0	0	18	0	0
20	852184	.	A	G	4	1	5	0	0	5	0	0
20	856170	.	G	A	9	3	12	0	0	12	0	0
20	856185	.	G	A	10	6	16	0	1	17	0	0
20	875008	.	C	G	4	2	6	0	0	6	0	0
20	875042	.	G	A	1	0	1	0	0	1	0	0
20	880430	.	G	A	8	5	13	0	0	13	0	0
20	880447	.	A	G	8	5	13	0	0	13	0	0
20	883163	.	C	T	0	1	1	0	2	3	0	0
20	884404	.	A	T	0	2	2	0	0	2	0	0
20	902671	.	G	A	4	11	15	0	1	16	0	0
20	902712	.	A	T	6	13	19	0	1	20	0	0
20	908195	.	A	G	3	2	5	0	1	6	0	0
20	908294	.	A	G	11	7	18	0	1	19	0	0
20	908641	.	C	T	0	3	3	0	2	5	0	0
20	908717	.	G	A	4	3	7	0	0	7	0	0
20	944314	.	A	C	2	4	6	0	0	6	0	0
20	946681	.	G	A	2	7	9	0	0	9	0	0
20	1079084	.	G	C	1	0	1	0	0	1	0	0
20	1081952	.	G	T	4	3	7	0	0	7	0	0
20	1081960	.	G	A	3	4	7	0	0	7	0	0
20	1125057	.	A	G	7	6	13	0	1	14	0	0
20	1125135	.	G	A	0	7	7	0	9	16	0	0
20	1132561	.	G	A	1	2	3	0	0	3	0	0
20	1132693	.	G	A	1	0	1	0	0	1	0	0
20	1141668	.	A	G	1	2	3	0	1	4	0	0
20	1151113	.	G	A	1	2	3	0	0	3	0	0
20	1151123	.	C	A	1	3	4	0	0	4	0	0
20	1176594	.	C	G	3	4	7	0	0	7	0	0
20	1177879	.	A	T	7	3	10	0	0	10	0	0
20	1178040	.	T	A	5	6	11	0	0	11	0	0
20	1178041	.	T	C	5	5	10	0	1	11	0	0
20	1178725	.	A	G	4	3	7	0	0	7	0	0
20	1178759	.	G	C	4	3	7	0	0	7	0	0
20	1178813	.	T	C	6	3	9	0	1	10	0	0
20	1179196	.	T	C	2	4	6	0	0	6	0	0
20	1179404	.	T	G	1	3	4	0	0	4	0	0
20	1179485	.	T	C	3	3	6	0	0	6	0	0
20	1179577	.	C	T	0	1	1	0	6	7	0	0
20	1179613	.	G	C	8	0	8	0	3	11	0	0
20	1179660	.	G	T	6	2	8	0	5	13	0	0
20	1179715	.	A	C	3	0	3	0	8	11	0	0
20	1185942	.	G	A	2	0	2	0	0	2	0	0
20	1198485	.	C	T	6	10	16	0	1	17	0	0
20	1198558	.	A	T	3	5	8	0	2	10	0	0
20	1198819	.	T	A	7	11	18	2	1	21	0	0
20	1201917	.	A	T	3	2	5	0	0	5	0	0
20	1202099	.	T	C	6	5	11	0	0	11	0	0
20	1202107	.	C	T	6	5	11	0	0	11	0	0
20	1202134	.	A	T	6	4	10	0	0	10	0	0
20	1204020	.	T	G	4	5	9	0	1	10	0	0
20	1204555	.	G	C	3	0	3	0	2	5	0	0
20	1205980	.	G	A	0	1	1	0	0	1	0	0
20	1240552	.	A	T	4	4	8	0	0	8	0	0
20	1241409	.	A	T	3	2	5	0	0	5	0	0
20	1241478	.	A	T	5	4	9	0	0	9	0	0
20	1241535	.	T	C	1	4	5	0	0	5	0	0
20	1242495	.	T	C	2	2	4	0	0	4	0	0
20	1243196	.	A	C	3	2	5	0	0	5	0	0
20	1257193	.	G	A	1	3	4	0	0	4	0	0
20	1265240	.	A	G	3	2	5	0	0	5	0	0
20	1278565	.	A	T	3	2	5	0	0	5	0	0
20	1278796	.	G	A	4	6	10	0	1	11	0	0
20	1279033	.	G	A	6	3	9	0	1	10	0	0
20	1281278	.	G	T	2	2	4	0	0	4	0	0
20	1294012	.	T	G	9	9	18	0	0	18	0	0
20	1294062	.	C	G	12	16	28	0	0	28	0	0
20	1294612	.	T	C	3	2	5	1	0	6	0	0
20	1294863	.	T	G	12	4	16	0	2	18	0	0
20	1294970	.	A	G	10	12	22	0	0	22	0	0
20	1295009	.	T	C	8	0	8	0	3	11	0	0
20	1295017	.	T	C	4	2	6	0	0	6	0	0
20	1295302	.	T	C	3	3	6	0	1	7	0	0
20	1295426	.	G	T	1	3	4	0	0	4	0	0
20	1295571	.	T	C	4	0	4	0	7	11	0	0
20	1295840	.	G	A	17	10	27	0	1	28	0	0
20	1296022	.	G	C	8	11	19	0	1	20	0	0
20	1296114	.	G	A	11	12	23	0	0	23	0	0
20	1296139	.	A	G	11	12	23	0	1	24	0	0
20	1314478	.	A	G	3	2	5	0	0	5	0	0
20	1316764	.	A	G	4	4	8	0	0	8	0	0
20	1316860	.	G	C	0	4	4	0	3	7	0	0
20	1324976	.	C	A	3	2	5	0	0	5	0	0
20	1327545	.	A	T	12	4	16	0	0	16	0	0
20	1336992	.	A	C	2	1	3	0	0	3	0	0
20	1339084	.	G	A	1	2	3	0	1	4	0	0
20	1339657	.	T	C	6	5	11	0	1	12	0	0
20	1339798	.	G	A	4	3	7	0	0	7	0	0
20	1339843	.	C	T	3	3	6	0	2	8	0	0
20	1339924	.	G	A	5	3	8	0	0	8	0	0
20	1340015	.	G	A	0	6	6	0	3	9	0	0
20	1346873	.	T	C	0	2	2	0	0	2	0	0
20	1349264	.	A	T	1	2	3	0	0	3	0	0
20	1349357	.	G	A	0	5	5	0	4	9	0	0
20	1350101	.	G	A	0	5	5	0	5	10	0	0
20	1441815	.	A	C	17	14	31	0	0	33	2	0
20	1441825	.	T	C	18	13	31	0	0	31	0	0
20	1442358	.	G	T	15	14	29	0	1	30	0	0
20	1442468	.	G	A	6	13	19	0	0	19	0	0
20	1442515	.	A	T	14	10	24	0	2	26	0	0
20	1442522	.	C	A	11	12	23	0	0	23	0	0
20	1442582	.	G	T	5	9	14	0	0	14	0	0
20	1442624	.	C	T	7	13	20	0	1	21	0	0
20	1454065	.	T	C	5	8	13	0	2	15	0	0
20	1455104	.	G	A	6	9	15	0	1	16	0	0
20	1460979	.	C	A	7	6	13	0	1	14	0	0
20	1476772	.	C	T	5	4	9	0	0	9	0	0
20	1513605	.	A	G	5	8	13	0	2	15	0	0
20	1513617	.	G	A	8	4	12	0	1	13	0	0
20	1518414	.	G	A	4	3	7	0	1	8	0	0
20	1519699	.	A	G	5	6	11	0	0	11	0	0
20	1560842	.	C	T	0	0	0	0	2	2	0	0
20	2703492	.	T	C	1	0	1	0	0	1	0	0
20	2716055	.	A	G	6	4	10	0	0	10	0	0
20	2716149	.	C	A	11	4	15	0	1	16	0	0
20	2716234	.	A	G	15	8	23	0	0	23	0	0
20	2716614	.	A	G	5	4	9	0	0	9	0	0
20	2718866	.	G	A	9	9	18	0	0	18	0	0
20	2721834	.	G	A	8	9	17	0	1	18	0	0
20	2725716	.	C	T	12	8	20	0	1	21	0	0
20	2737535	.	G	A	3	5	8	0	0	8	0	0
20	2738620	.	C	T	7	2	9	0	0	9	0	0
20	2739065	.	C	T	16	20	36	0	3	39	0	0
20	2739543	.	T	C	12	14	26	0	0	26	0	0
20	2739760	.	A	T	4	5	9	0	1	10	0	0
20	2741340	.	T	C	1	1	2	0	0	2	0	0
20	2744280	.	A	T	6	8	14	0	0	14	0	0
20	2744455	.	A	T	9	5	14	0	0	14	0	0
20	2744759	.	G	T	8	11	19	0	0	19	0	0
20	2744945	.	C	A	9	4	13	0	1	14	0	0
20	2745303	.	A	T	4	4	8	0	0	8	0	0
20	2882428	.	G	A	2	3	5	0	0	5	0	0
20	2970030	.	C	T	12	5	17	0	0	17	0	0
20	2971625	.	A	T	1	2	3	0	1	4	0	0
20	2971760	.	T	A	1	2	3	0	0	3	0	0
20	2972260	.	A	G	1	0	1	1	19	21	0	0
20	2975121	.	A	C	10	13	23	0	2	25	0	0
20	2975271	.	C	T	19	15	34	0	0	34	0	0
20	2976077	.	A	G	5	1	6	0	0	6	0	0
20	2976094	.	A	G	3	1	4	0	0	4	0	0
20	2976114	.	A	G	0	1	1	0	1	2	0	0
20	2976909	.	C	A	16	8	24	0	1	25	0	0
20	2977257	.	C	T	19	12	31	0	4	35	0	0
20	2977417	.	C	A	18	0	18	1	0	19	0	0
20	2977418	.	C	A	18	0	18	1	0	19	0	0
20	2982464	.	C	T	2	5	7	0	0	7	0	0
20	2982634	.	G	A	1	5	6	0	0	6	0	0
20	2982755	.	G	T	4	9	13	0	1	14	0	0
20	2982943	.	T	C	3	5	8	0	0	8	0	0
20	2983673	.	G	T	2	0	2	0	0	2	0	0
20	2986822	.	G	C	8	4	12	0	0	12	0	0
20	2986861	.	G	A	6	2	8	0	1	9	0	0
20	2996564	.	A	C	1	0	1	0	3	4	0	0
20	2996621	.	C	T	0	2	2	0	0	2	0	0
20	3017445	.	C	T	3	3	6	0	0	6	0	0
20	3017513	.	C	A	0	8	8	0	9	17	0	0
20	3018319	.	T	C	1	0	1	0	5	6	0	0
20	3020362	.	C	A	0	2	2	0	1	3	0	0
20	3020364	.	T	C	1	2	3	0	0	3	0	0
20	3020423	.	G	A	1	2	3	0	0	3	0	0
20	3028142	.	A	G	1	1	2	0	1	3	0	0
20	3029617	.	G	C	4	3	7	0	0	7	0	0
20	3029659	.	A	C	0	1	1	0	0	1	0	0
20	3029662	.	A	G	0	1	1	0	0	1	0	0
20	3039818	.	G	A	2	3	5	0	0	5	0	0
20	3046290	.	T	G	1	0	1	0	0	1	0	0
20	3046974	.	G	A	2	3	5	0	0	5	0	0
20	3050877	.	T	C	4	1	5	0	2	7	0	0
20	3086570	.	G	C	1	4	5	0	0	5	0	0
20	3087029	.	T	C	1	0	1	0	4	5	0	0
20	3115207	.	A	T	2	2	4	0	0	4	0	0
20	3115284	.	C	T	2	2	4	0	1	5	0	0
20	3115516	.	C	T	2	3	5	0	0	5	0	0
20	3118148	.	G	A	4	3	7	0	0	7	0	0
20	3118397	.	A	T	1	2	3	0	0	3	0	0
20	3118502	.	T	G	6	0	6	0	4	10	0	0
20	3118720	.	C	T	4	3	7	0	1	8	0	0
20	3120326	.	C	A	0	1	1	0	0	1	0	0
20	3121027	.	A	C	5	3	8	0	0	8	0	0
20	3121179	.	A	G	1	10	11	0	2	13	0	0
20	3121362	.	G	A	2	2	4	0	0	4	0	0
20	3121407	.	T	C	7	5	12	0	0	12	0	0
20	3121623	.	C	T	3	1	4	0	0	4	0	0
20	3121644	.	G	A	0	6	6	0	1	7	0	0
20	3121689	.	T	A	6	5	11	0	1	12	0	0
20	3121947	.	G	A	5	3	8	0	0	8	0	0
20	3122094	.	G	A	7	4	11	0	0	11	0	0
20	3122251	.	G	A	4	7	11	0	0	11	0	0
20	3129754	.	C	G	1	0	1	0	0	1	0	0
20	3130390	.	T	A	0	1	1	0	0	1	0	0
20	3130487	.	T	C	6	4	10	0	0	10	0	0
20	3130758	.	A	G	2	2	4	0	0	4	0	0
20	3239324	.	C	T	0	6	6	0	11	17	0	0
20	3239470	.	T	G	6	6	12	0	0	12	0	0
20	3242661	.	C	T	1	2	3	0	1	4	0	0
20	3242664	.	T	A	1	3	4	0	1	5	0	0
20	3242887	.	T	A	0	1	1	0	0	1	0	0
20	3242944	.	A	G	1	0	1	0	0	1	0	0
20	3246643	.	A	G	5	3	8	0	0	8	0	0
20	3249029	.	G	A	8	16	24	0	0	24	0	0
20	3249414	.	A	T	4	4	8	0	1	9	0	0
20	3249500	.	T	G	2	7	9	0	1	10	0	0
20	3249513	.	G	T	2	8	10	0	0	10	0	0
20	3249796	.	G	T	7	3	10	0	0	10	0	0
20	3266067	.	A	G	1	5	6	0	0	6	0	0
20	3279928	.	G	A	0	3	3	0	2	5	0	0
20	3283238	.	G	T	2	1	3	0	0	3	0	0
20	3283313	.	C	T	1	0	1	0	0	1	0	0
20	3284553	.	C	T	4	3	7	0	0	7	0	0
20	3288058	.	C	T	5	3	8	0	1	9	0	0
20	3290378	.	G	T	5	4	9	0	1	10	0	0
20	3290462	.	G	A	10	8	18	0	2	20	0	0
20	3290744	.	G	A	2	1	3	0	0	3	0	0
20	3292873	.	C	T	1	0	1	0	0	1	0	0
20	3294838	.	G	T	0	1	1	0	0	1	0	0
20	3298096	.	T	C	4	1	5	0	0	5	0	0
20	3298321	.	T	C	2	1	3	0	0	3	0	0
20	3309893	.	C	T	5	3	8	0	0	8	0	0
20	3309933	.	C	A	0	3	3	0	3	6	0	0
20	3312997	.	T	C	3	3	6	0	0	6	0	0
20	3313037	.	C	G	3	4	7	0	0	7	0	0
20	3313282	.	C	T	3	4	7	0	0	7	0	0
20	3316263	.	T	A	1	1	2	0	1	3	0	0
20	3316725	.	G	A	3	2	5	0	0	5	0	0
20	3316869	.	T	C	2	0	2	0	6	8	0	0
20	3343934	.	C	T	3	2	5	0	0	5	0	0
20	3344016	.	G	C	1	4	5	0	0	5	0	0
20	3344696	.	G	T	0	5	5	0	1	6	0	0
20	3344735	.	A	C	2	3	5	0	0	5	0	0
20	3344975	.	T	C	3	7	10	0	0	10	0	0
20	3346490	.	A	T	12	7	19	0	1	20	0	0
20	3346497	.	C	A	1	6	7	0	11	18	0	0
20	3346599	.	G	A	17	6	23	0	0	23	0	0
20	3346629	.	C	T	11	8	19	0	0	19	0	0
20	3346710	.	C	T	14	9	23	0	1	24	0	0
20	3346865	.	C	G	0	12	12	0	7	19	0	0
20	3346907	.	C	T	2	6	8	0	1	9	0	0
20	3349049	.	A	G	4	5	9	0	1	10	0	0
20	3349067	.	T	A	2	6	8	0	0	8	0	0
20	3351627	.	A	T	4	4	8	0	0	8	0	0
20	3351661	.	A	C	2	1	3	0	2	5	0	0
20	3353337	.	C	T	7	5	12	0	0	12	0	0
20	3357024	.	C	T	3	3	6	0	1	7	0	0
20	3359346	.	C	T	5	5	10	0	0	10	0	0
20	3361480	.	A	T	4	2	6	0	2	8	0	0
20	3365747	.	C	T	0	4	4	0	0	4	0	0
20	3365752	.	C	A	0	4	4	0	0	4	0	0
20	3365809	.	C	T	0	1	1	0	0	1	0	0
20	3365934	.	A	G	4	2	6	0	1	7	0	0
20	3369377	.	G	A	0	1	1	0	1	2	0	0
20	3369392	.	A	G	1	1	2	0	0	2	0	0
20	3372643	.	T	G	1	0	1	0	0	1	0	0
20	3376003	.	T	G	2	5	7	0	0	7	0	0
20	3376297	.	G	C	1	0	1	0	4	5	0	0
20	3376379	.	C	T	1	7	8	0	0	8	0	0
20	3377562	.	A	G	0	5	5	0	0	5	0	0
20	3377810	.	C	T	1	2	3	0	1	4	0	0
20	3379641	.	C	T	3	1	4	0	1	5	0	0
20	3379653	.	A	G	3	6	9	0	0	9	0	0
20	3916456	.	T	A	11	5	16	0	1	17	0	0
20	3916464	.	C	T	12	8	20	0	0	20	0	0
20	3916621	.	T	G	9	5	14	0	0	14	0	0
20	3920746	.	T	G	8	4	12	0	1	13	0	0
20	3920873	.	T	A	8	6	14	0	1	15	0	0
20	3920875	.	G	A	8	5	13	0	2	15	0	0
20	3920977	.	G	A	0	8	8	0	9	17	0	0
20	3921127	.	A	T	6	9	15	0	0	15	0	0
20	3921184	.	G	A	6	4	10	0	0	10	0	0
20	3921202	.	T	C	3	3	6	0	0	6	0	0
20	3923735	.	C	G	8	10	18	0	0	18	0	0
20	3923983	.	G	A	1	6	7	0	8	15	0	0
20	3924098	.	A	T	15	13	28	0	1	29	0	0
20	3924430	.	G	A	0	8	8	0	7	15	0	0
20	3924528	.	C	A	5	10	15	0	1	16	0	0
20	3924824	.	A	C	4	3	7	0	0	7	0	0
20	3924943	.	T	G	10	0	10	0	12	22	0	0
20	3925146	.	A	T	6	5	11	0	0	11	0	0
20	3925537	.	T	C	5	7	12	0	1	13	0	0
20	3925544	.	T	A	7	6	13	0	0	13	0	0
20	3926020	.	C	T	3	3	6	0	0	6	0	0
20	3926337	.	C	T	3	10	13	0	0	13	0	0
20	3926721	.	T	C	6	5	11	0	0	11	0	0
20	3926736	.	T	A	7	6	13	0	1	15	1	0
20	3926907	.	T	G	19	16	35	0	0	35	0	0
20	3926928	.	T	A	18	17	35	0	0	35	0	0
20	3926951	.	A	G	18	23	41	0	0	41	0	0
20	3927267	.	C	A	21	14	35	0	1	36	0	0
20	3927326	.	A	G	12	14	26	0	0	26	0	0
20	3927446	.	C	G	11	9	20	0	2	22	0	0
20	3947006	.	T	G	0	1	1	0	0	1	0	0
20	3947058	.	C	A	3	2	5	0	0	5	0	0
20	3953593	.	T	C	5	7	12	0	1	13	0	0
20	3954813	.	G	C	6	5	11	0	0	11	0	0
20	3954846	.	A	T	5	3	8	0	0	8	0	0
20	3954870	.	C	T	1	4	5	0	1	6	0	0
20	3971246	.	G	C	0	1	1	0	0	1	0	0
20	3981697	.	T	C	0	1	1	0	0	1	0	0
20	4000366	.	C	T	1	2	3	0	0	3	0	0
20	4009409	.	C	G	2	3	5	0	0	5	0	0
20	4010256	.	T	C	1	4	5	0	0	5	0	0
20	4010462	.	C	T	7	3	10	0	0	10	0	0
20	4035837	.	G	A	2	13	15	0	0	15	0	0
20	4035858	.	G	C	2	10	12	0	0	12	0	0
20	4036720	.	T	C	3	2	5	0	0	5	0	0
20	4036795	.	T	C	2	2	4	0	2	6	0	0
20	4037016	.	T	C	2	3	5	0	0	5	0	0
20	4037057	.	G	A	1	3	4	0	0	4	0	0
20	4037184	.	C	T	1	1	2	0	1	3	0	0
20	4037708	.	C	T	0	2	2	0	2	4	0	0
20	4037823	.	G	C	3	0	3	0	4	7	0	0
20	4037824	.	T	G	2	4	6	0	1	7	0	0
20	4037942	.	C	T	6	6	12	0	1	13	0	0
20	4043508	.	C	G	4	2	6	0	0	6	0	0
20	4051818	.	C	T	4	3	7	0	0	7	0	0
20	4052854	.	G	C	2	4	6	0	0	6	0	0
20	4053012	.	G	A	0	6	6	0	8	14	0	0
20	4091851	.	G	A	0	3	3	0	0	3	0	0
20	4124207	.	A	T	1	1	2	0	0	2	0	0
20	4157066	.	A	C	3	2	5	0	0	5	0	0
20	4176863	.	G	A	0	1	1	0	0	1	0	0
20	4248208	.	A	T	1	2	3	0	0	3	0	0
20	4250235	.	A	T	2	2	4	0	0	4	0	0
20	4453006	.	G	A	6	6	12	0	0	12	0	0
20	4453024	.	T	C	7	6	13	0	1	14	0	0
20	4453432	.	A	G	1	5	6	0	1	7	0	0
20	4453714	.	C	T	2	2	4	0	1	5	0	0
20	4712880	.	G	A	7	5	12	0	1	13	0	0
20	4712979	.	A	T	7	15	22	0	2	24	0	0
20	4713027	.	T	A	6	13	19	0	0	19	0	0
20	4713033	.	C	T	7	13	20	0	1	21	0	0
20	4713169	.	G	T	18	9	27	0	3	30	0	0
20	4713654	.	G	A	9	12	21	0	1	22	0	0
20	4713716	.	G	A	9	16	25	0	0	25	0	0
20	4713956	.	C	T	11	11	22	0	2	24	0	0
20	4716436	.	A	G	0	1	1	0	0	1	0	0
20	4717647	.	C	T	10	7	17	0	0	17	0	0
20	4726806	.	G	T	3	4	7	0	0	7	0	0
20	4726955	.	A	T	8	4	12	0	1	13	0	0
20	4726973	.	A	G	9	5	14	0	0	14	0	0
20	4728808	.	C	T	12	8	20	0	2	22	0	0
20	4734412	.	C	T	1	0	1	0	0	1	0	0
20	4738004	.	T	C	5	5	10	0	0	10	0	0
20	4745754	.	T	C	7	4	11	0	0	11	0	0
20	4745774	.	C	T	6	3	9	0	4	13	0	0
20	4747480	.	G	T	3	2	5	0	0	5	0	0
20	4753655	.	T	C	1	3	4	0	0	4	0	0
20	4753684	.	A	G	0	1	1	0	1	2	0	0
20	4756804	.	C	A	1	0	1	0	0	1	0	0
20	4813976	.	C	A	2	1	3	0	1	4	0	0
20	4813998	.	C	T	4	2	6	0	0	6	0	0
20	4827972	.	C	T	0	4	4	0	2	6	0	0
20	4828019	.	C	T	2	4	6	0	0	6	0	0
20	4828170	.	T	A	2	4	6	0	0	6	0	0
20	4828230	.	A	G	6	5	11	0	0	11	0	0
20	4841389	.	A	C	4	0	4	0	0	4	0	0
20	4887996	.	G	T	0	5	5	0	0	5	0	0
20	4888004	.	A	G	0	5	5	0	0	5	0	0
20	4895955	.	C	T	11	12	23	0	1	25	1	0
20	4896240	.	A	C	4	3	7	0	0	7	0	0
20	4898126	.	A	G	1	2	3	0	1	4	0	0
20	4898173	.	T	C	1	2	3	0	0	3	0	0
20	4898515	.	C	T	13	7	20	0	0	20	0	0
20	4898575	.	A	T	13	9	22	0	0	22	0	0
20	4898631	.	A	T	16	4	20	0	1	21	0	0
20	4898855	.	C	T	0	17	17	0	10	27	0	0
20	4899305	.	G	T	8	6	14	0	0	14	0	0
20	4899342	.	T	G	10	13	23	0	2	25	0	0
20	4899479	.	A	G	16	9	25	0	0	25	0	0
20	4899935	.	A	T	8	12	20	0	2	22	0	0
20	4899969	.	T	G	8	9	17	0	0	17	0	0
20	4900495	.	C	T	1	7	8	0	8	16	0	0
20	4900564	.	T	C	5	5	10	0	0	10	0	0
20	4900609	.	T	C	6	0	6	0	4	10	0	0
20	4900697	.	T	C	9	6	15	0	1	16	0	0
20	4900921	.	A	G	6	4	10	0	1	11	0	0
20	4901013	.	C	T	6	10	16	0	0	16	0	0
20	4901545	.	T	G	1	3	4	0	0	4	0	0
20	4902868	.	T	G	1	1	2	0	0	2	0	0
20	4902871	.	C	T	0	1	1	0	1	2	0	0
20	4902910	.	C	T	6	2	8	0	0	8	0	0
20	4902954	.	A	G	10	6	16	0	0	16	0	0
20	4903334	.	G	C	6	4	10	0	1	11	0	0
20	4903456	.	A	G	9	4	13	0	0	13	0	0
20	4903562	.	G	A	5	1	6	0	0	6	0	0
20	4911076	.	A	G	0	1	1	0	0	1	0	0
20	4911237	.	C	T	3	3	6	0	0	6	0	0
20	4911252	.	T	C	3	3	6	0	0	6	0	0
20	4921034	.	G	A	3	4	7	0	2	9	0	0
20	4933977	.	A	G	0	1	1	0	0	1	0	0
20	4934016	.	T	C	4	0	4	0	3	7	0	0
20	5065444	.	A	T	4	2	6	0	0	6	0	0
20	5065552	.	C	A	2	3	5	0	0	5	0	0
20	5065553	.	C	G	2	3	5	0	0	5	0	0
20	5065776	.	T	A	2	4	6	0	1	7	0	0
20	5067424	.	A	T	1	1	2	0	0	2	0	0
20	5069212	.	C	G	2	0	2	0	5	7	0	0
20	5069252	.	T	A	4	4	8	0	0	8	0	0
20	5069389	.	G	A	6	4	10	0	0	10	0	0
20	5090938	.	G	A	0	2	2	0	10	12	0	0
20	5093872	.	A	T	2	3	5	0	0	5	0	0
20	5093882	.	G	A	2	2	4	0	1	5	0	0
20	5094205	.	A	C	4	4	8	0	1	9	0	0
20	5158468	.	G	T	1	3	4	0	0	4	0	0
20	5158488	.	A	C	2	2	4	0	0	4	0	0
20	5158507	.	G	A	0	2	2	0	0	2	0	0
20	5158552	.	A	T	0	3	3	0	0	3	0	0
20	5158590	.	C	G	1	2	3	0	0	3	0	0
20	5158594	.	A	T	2	1	3	0	0	3	0	0
20	5158742	.	A	G	1	4	5	0	1	6	0	0
20	5159001	.	A	C	1	3	4	0	0	4	0	0
20	5228120	.	A	G	1	2	3	0	0	3	0	0
20	5228911	.	C	T	1	4	5	0	0	5	0	0
20	5228918	.	A	G	1	3	4	0	2	6	0	0
20	5330859	.	C	G	7	7	14	0	0	14	0	0
20	5330875	.	A	G	7	6	13	0	0	13	0	0
20	5330990	.	T	A	7	5	12	0	1	13	0	0
20	5331095	.	A	G	5	4	9	0	0	9	0	0
20	5331112	.	G	C	5	7	12	0	0	12	0	0
20	5331186	.	T	C	2	1	3	0	2	5	0	0
20	5331685	.	A	C	1	3	4	0	0	4	0	0
20	5332145	.	C	G	6	4	10	1	0	11	0	0
20	5332620	.	T	C	2	4	6	0	1	7	0	0
20	5332700	.	G	C	3	2	5	0	1	6	0	0
20	5332728	.	G	A	5	3	8	0	0	8	0	0
20	5332901	.	T	C	3	0	3	0	5	8	0	0
20	5333066	.	T	C	1	2	3	0	1	4	0	0
20	5333317	.	A	G	2	2	4	0	0	4	0	0
20	5333405	.	T	G	3	7	10	0	2	12	0	0
20	5348081	.	G	A	2	4	6	0	0	6	0	0
20	5358482	.	A	G	0	1	1	0	0	1	0	0
20	5369097	.	A	G	1	3	4	0	0	4	0	0
20	5369099	.	T	C	1	3	4	0	0	4	0	0
20	5390784	.	A	T	2	1	3	0	0	3	0	0
20	5391138	.	G	T	9	6	15	0	1	16	0	0
20	5394584	.	G	A	4	1	5	0	0	5	0	0
20	5563732	.	T	C	2	2	4	0	0	4	0	0
20	5563744	.	A	T	2	2	4	0	0	4	0	0
20	5563798	.	G	A	1	2	3	0	0	3	0	0
20	5563813	.	C	T	1	3	4	0	0	4	0	0
20	5563947	.	A	C	2	3	5	0	0	5	0	0
20	5564002	.	T	C	3	2	5	0	0	5	0	0
20	5564233	.	T	C	2	3	5	0	0	5	0	0
20	5564292	.	A	G	1	0	1	0	5	6	0	0
20	5673988	.	T	C	1	2	3	0	0	3	0	0
20	5679786	.	T	C	4	2	6	0	1	7	0	0
20	5696971	.	C	A	1	2	3	0	0	3	0	0
20	5700002	.	C	T	1	0	1	0	0	1	0	0
20	5742118	.	C	T	1	2	3	0	0	3	0	0
20	5742169	.	T	C	0	1	1	0	0	1	0	0
20	5744339	.	T	C	1	1	2	0	0	2	0	0
20	5921278	.	T	C	8	6	14	0	0	14	0	0
20	6308648	.	G	A	3	7	10	0	1	11	0	0
20	6666099	.	T	G	4	2	6	0	0	6	0	0
20	6666528	.	A	C	3	2	5	0	0	5	0	0
20	6666603	.	G	A	0	3	3	0	4	7	0	0
20	6791662	.	A	G	4	0	4	0	6	10	0	0
20	6802879	.	A	G	8	5	13	0	0	13	0	0
20	6803497	.	C	T	2	2	4	0	0	4	0	0
20	6809612	.	C	T	2	4	6	0	0	6	0	0
20	6810046	.	T	C	1	3	4	0	0	4	0	0
20	6894902	.	A	G	1	3	4	0	0	4	0	0
20	6894999	.	A	G	1	8	9	0	0	9	0	0
20	6898118	.	A	G	3	3	6	0	0	6	0	0
20	6918437	.	A	G	1	2	3	0	1	4	0	0
20	6936427	.	T	A	1	0	1	0	0	1	0	0
20	6944977	.	G	A	0	2	2	0	0	2	0	0
20	7449851	.	C	T	1	2	3	0	0	3	0	0
20	7464014	.	C	A	0	1	1	0	0	1	0	0
20	7464337	.	G	A	0	1	1	0	0	1	0	0
20	7480286	.	T	C	1	0	1	0	2	3	0	0
20	7583021	.	T	C	3	5	8	0	2	10	0	0
20	7588957	.	A	G	2	0	2	0	2	4	0	0
20	7965965	.	G	A	6	3	9	0	1	10	0	0
20	7966006	.	A	T	6	3	9	0	1	10	0	0
20	7966090	.	T	G	5	4	9	0	0	9	0	0
20	7966127	.	G	A	4	4	8	0	0	8	0	0
20	7966135	.	A	C	2	4	6	0	1	7	0	0
20	7966227	.	A	G	1	5	6	0	0	6	0	0
20	7966402	.	G	A	1	2	3	0	0	3	0	0
20	7966419	.	G	C	1	2	3	0	0	3	0	0
20	7966555	.	C	G	3	3	6	0	0	6	0	0
20	7966938	.	G	A	0	3	3	0	0	3	0	0
20	7967128	.	C	T	0	2	2	0	6	8	0	0
20	7967305	.	A	G	1	3	4	0	0	4	0	0
20	7986791	.	A	T	0	1	1	0	0	1	0	0
20	8067684	.	C	A	1	3	4	0	0	4	0	0
20	8122772	.	A	T	2	5	7	0	0	7	0	0
20	8154139	.	G	A	3	2	5	0	0	5	0	0
20	8154169	.	A	G	5	4	9	0	0	9	0	0
20	8154562	.	A	G	3	7	10	0	2	12	0	0
20	8163955	.	C	T	1	2	3	0	0	3	0	0
20	9097322	.	A	G	1	2	3	0	1	4	0	0
20	9097597	.	T	A	2	6	8	0	0	8	0	0
20	9097639	.	A	G	3	6	9	0	0	9	0	0
20	9097666	.	T	C	2	2	4	0	1	5	0	0
20	9102068	.	T	C	2	1	3	0	0	3	0	0
20	9105204	.	C	G	1	2	3	0	0	3	0	0
20	9111228	.	A	G	1	2	3	0	1	4	0	0
20	9113147	.	G	T	0	2	2	0	0	2	0	0
20	9113207	.	A	G	0	2	2	0	0	2	0	0
20	9113325	.	G	C	1	1	2	0	0	2	0	0
20	9115241	.	G	A	0	2	2	0	0	2	0	0
20	9124759	.	C	T	4	3	7	0	2	9	0	0
20	9124996	.	A	G	4	0	4	0	4	8	0	0
20	9131049	.	C	T	0	0	0	0	1	1	0	0
20	9148079	.	A	G	5	2	7	0	0	7	0	0
20	9148121	.	G	C	10	5	15	0	1	16	0	0
20	9148162	.	A	G	10	6	16	0	0	16	0	0
20	9148166	.	G	T	0	5	5	0	10	15	0	0
20	9172447	.	G	C	3	2	5	0	0	5	0	0
20	9174014	.	T	C	16	14	30	0	2	32	0	0
20	9183159	.	T	G	8	2	10	0	0	10	0	0
20	9185389	.	G	T	1	0	1	0	0	1	0	0
20	9185479	.	G	T	3	5	8	0	0	8	0	0
20	9185515	.	T	C	0	1	1	0	0	1	0	0
20	9186200	.	A	G	4	1	5	0	0	5	0	0
20	9186281	.	T	C	8	0	8	0	10	18	0	0
20	9190238	.	A	T	8	6	14	0	0	14	0	0
20	9190637	.	G	T	0	1	1	0	0	1	0	0
20	9190712	.	A	G	4	9	13	0	1	14	0	0
20	9190723	.	A	T	2	9	11	0	0	11	0	0
20	9190767	.	T	C	4	5	9	0	2	11	0	0
20	9190768	.	T	C	4	6	10	0	1	11	0	0
20	9190991	.	A	G	10	8	18	0	0	18	0	0
20	9191203	.	G	T	9	4	13	0	0	13	0	0
20	9191255	.	T	C	5	0	5	0	8	13	0	0
20	9191267	.	T	A	4	4	8	0	2	10	0	0
20	9191353	.	T	G	5	6	11	0	1	12	0	0
20	9191461	.	C	T	6	9	15	0	0	15	0	0
20	9191729	.	C	T	4	3	7	0	0	7	0	0
20	9192375	.	T	A	5	6	11	0	0	11	0	0
20	9193359	.	C	T	1	2	3	0	0	3	0	0
20	9193714	.	A	G	1	2	3	0	0	3	0	0
20	9199482	.	C	T	1	2	3	0	1	4	0	0
20	9199598	.	C	T	3	5	8	0	0	8	0	0
20	9211600	.	G	T	0	2	2	0	1	3	0	0
20	9242476	.	T	C	6	5	11	0	1	12	0	0
20	9246461	.	C	A	1	0	1	0	0	1	0	0
20	9248482	.	T	C	2	0	2	0	4	6	0	0
20	9248524	.	T	C	5	6	11	0	0	11	0	0
20	9249934	.	C	T	0	2	2	0	2	4	0	0
20	9355967	.	C	T	6	8	14	0	0	14	0	0
20	9420974	.	A	T	12	9	21	1	1	23	0	0
20	9420976	.	C	T	13	9	22	1	0	23	0	0
20	10099521	.	T	G	2	8	10	0	0	10	0	0
20	10099602	.	C	A	11	4	15	0	0	15	0	0
20	10099603	.	C	A	11	4	15	0	0	15	0	0
20	10099640	.	G	A	7	9	16	0	0	16	0	0
20	10099816	.	C	T	8	8	16	0	0	16	0	0
20	10099932	.	C	A	7	5	12	0	0	12	0	0
20	10102593	.	G	A	6	5	11	0	0	11	0	0
20	10118691	.	T	C	2	3	5	0	0	5	0	0
20	10210328	.	A	G	1	0	1	0	4	5	0	0
20	10210358	.	C	T	1	3	4	0	1	5	0	0
20	10215552	.	G	A	0	1	1	0	1	2	0	0
20	10218637	.	T	A	1	3	4	0	0	4	0	0
20	10218890	.	C	T	3	2	5	0	0	5	0	0
20	10218937	.	C	A	1	2	3	0	0	3	0	0
20	10219431	.	A	G	1	0	1	0	2	3	0	0
20	10219537	.	C	T	2	1	3	0	1	4	0	0
20	10219558	.	T	C	0	5	5	0	0	5	0	0
20	10219597	.	A	G	2	4	6	0	0	6	0	0
20	10219886	.	C	T	3	2	5	0	0	5	0	0
20	10220138	.	T	C	2	5	7	0	1	8	0	0
20	10220188	.	A	C	1	8	9	0	0	9	0	0
20	10220261	.	G	T	2	6	8	0	1	9	0	0
20	10353220	.	G	A	4	3	7	0	1	8	0	0
20	10353222	.	G	A	4	4	8	0	0	8	0	0
20	10353318	.	G	A	3	3	6	0	1	7	0	0
20	10353335	.	T	C	5	3	8	0	0	8	0	0
20	10353528	.	G	A	8	4	12	0	1	13	0	0
20	10353654	.	T	C	5	0	5	0	3	8	0	0
20	10353797	.	A	G	6	7	13	0	0	13	0	0
20	10353798	.	A	T	6	6	12	0	1	13	0	0
20	10353912	.	G	C	6	6	12	0	0	12	0	0
20	10354329	.	A	G	2	3	5	0	1	6	0	0
20	10422619	.	A	C	6	0	6	0	0	6	0	0
20	11098255	.	G	A	1	5	6	0	1	7	0	0
20	11098301	.	T	C	1	5	6	0	1	7	0	0
20	11098710	.	C	A	5	3	8	0	0	8	0	0
20	11098851	.	G	A	5	3	8	0	0	8	0	0
20	11098859	.	G	A	4	4	8	0	1	9	0	0
20	11098960	.	G	A	5	4	9	0	1	10	0	0
20	11099013	.	G	A	2	6	8	0	1	9	0	0
20	11099064	.	C	T	3	6	9	0	0	9	0	0
20	11099223	.	C	T	0	3	3	0	2	5	0	0
20	11099304	.	A	G	4	5	9	0	2	11	0	0
20	11099345	.	T	A	3	2	5	0	1	6	0	0
20	11099516	.	A	G	5	2	7	0	0	7	0	0
20	11101578	.	T	A	3	3	6	0	0	6	0	0
20	11101584	.	C	T	3	3	6	0	0	6	0	0
20	11102328	.	C	T	0	3	3	0	6	9	0	0
20	11102623	.	G	A	4	1	5	0	0	5	0	0
20	11102625	.	G	C	1	4	5	0	0	5	0	0
20	11102805	.	G	A	3	2	5	0	0	5	0	0
20	11102895	.	T	G	3	2	5	0	0	5	0	0
20	11103244	.	T	A	4	4	8	0	2	10	0	0
20	11103294	.	G	A	1	2	3	0	0	3	0	0
20	11105202	.	G	A	1	5	6	0	1	7	0	0
20	12206783	.	A	G	0	2	2	1	1	4	0	0
20	13567503	.	T	C	5	0	5	0	4	9	0	0
20	13567574	.	T	C	3	8	11	0	0	11	0	0
20	14863476	.	A	G	1	1	2	3	0	5	0	0
20	16173967	.	A	G	3	0	3	0	2	5	0	0
20	18249646	.	T	C	10	7	17	0	1	18	0	0
20	18255673	.	G	T	10	4	14	0	1	16	1	0
20	18255748	.	A	G	6	3	9	0	1	10	0	0
20	18255755	.	A	G	7	3	10	0	0	10	0	0
20	18255929	.	A	G	12	0	12	0	7	19	0	0
20	18255931	.	A	T	12	6	18	0	1	19	0	0
20	18256068	.	C	T	7	4	11	0	0	11	0	0
20	18256170	.	G	A	4	2	6	0	0	6	0	0
20	18312860	.	C	T	6	12	18	0	2	20	0	0
20	18354627	.	C	T	1	7	8	0	0	8	0	0
20	18363238	.	T	C	5	0	5	0	2	7	0	0
20	18373014	.	T	G	3	2	5	0	0	5	0	0
20	18376800	.	C	T	3	3	6	0	0	6	0	0
20	18392845	.	C	T	19	12	31	0	3	34	0	0
20	18393128	.	G	A	10	8	18	0	1	19	0	0
20	18393132	.	A	C	10	8	18	0	0	19	1	0
20	18393249	.	T	C	10	10	20	0	2	22	0	0
20	18393359	.	A	T	13	6	19	0	2	21	0	0
20	18393376	.	C	T	18	8	26	0	1	27	0	0
20	18396134	.	A	G	4	2	6	0	0	6	0	0
20	18413987	.	T	C	2	0	2	0	12	14	0	0
20	18417768	.	G	A	5	6	11	0	0	11	0	0
20	18417777	.	T	C	5	5	10	0	1	11	0	0
20	18419377	.	G	A	0	2	2	0	1	3	0	0
20	18419383	.	T	C	0	3	3	0	0	3	0	0
20	18431770	.	T	C	1	0	1	0	3	4	0	0
20	18432732	.	C	T	7	6	13	0	0	13	0	0
20	18443489	.	T	C	4	2	6	0	0	6	0	0
20	18443543	.	C	G	0	1	1	0	0	1	0	0
20	18443554	.	C	T	0	1	1	0	0	1	0	0
20	18456785	.	C	T	1	1	2	0	1	3	0	0
20	18456791	.	T	C	3	1	4	0	0	4	0	0
20	18535350	.	G	A	2	3	5	0	1	6	0	0
20	18551728	.	T	A	6	6	12	0	4	16	0	0
20	18591704	.	G	A	20	18	38	0	0	38	0	0
20	18591716	.	A	C	13	17	30	0	0	30	0	0
20	18591743	.	A	T	9	10	19	0	0	19	0	0
20	18594958	.	C	A	19	23	42	0	1	43	0	0
20	18672033	.	G	A	1	10	11	0	0	11	0	0
20	18672064	.	C	T	2	11	13	0	1	14	0	0
20	18672094	.	T	C	4	11	15	0	0	15	0	0
20	18672162	.	G	A	4	8	12	0	0	12	0	0
20	18672610	.	C	G	0	2	2	0	0	2	0	0
20	18672733	.	A	T	10	12	22	0	0	22	0	0
20	18672970	.	G	A	2	15	17	0	0	17	0	0
20	18673132	.	C	T	6	10	16	0	0	16	0	0
20	18677343	.	G	A	2	0	2	0	0	2	0	0
20	18683158	.	T	C	2	12	14	0	0	14	0	0
20	18683177	.	A	G	1	0	1	0	5	6	0	0
20	18684760	.	G	A	6	16	22	0	0	22	0	0
20	18684769	.	G	A	6	16	22	0	0	22	0	0
20	18685235	.	C	G	5	11	16	0	1	17	0	0
20	18685256	.	G	A	7	6	13	0	1	14	0	0
20	18685279	.	G	C	1	5	6	0	5	11	0	0
20	18708770	.	T	C	16	19	35	0	0	35	0	0
20	18713016	.	C	T	26	19	45	0	1	46	0	0
20	18713067	.	T	C	19	9	28	0	1	29	0	0
20	18714052	.	A	G	1	2	3	0	0	3	0	0
20	18714509	.	G	T	1	3	4	0	0	4	0	0
20	18721340	.	G	T	4	3	7	1	0	8	0	0
20	18721383	.	A	T	3	2	5	0	0	5	0	0
20	18721788	.	C	T	10	8	18	0	3	21	0	0
20	18721910	.	G	A	15	8	23	0	0	23	0	0
20	18722565	.	A	T	19	14	33	0	1	34	0	0
20	18723105	.	C	T	14	9	23	0	0	23	0	0
20	18723277	.	T	C	9	5	14	0	3	17	0	0
20	18723327	.	T	C	5	0	5	0	7	12	0	0
20	18723362	.	T	C	9	5	14	0	0	14	0	0
20	18723383	.	A	T	8	6	14	0	0	14	0	0
20	18723401	.	T	C	3	0	3	0	13	16	0	0
20	18727506	.	T	C	6	3	9	0	1	10	0	0
20	18730498	.	G	A	9	8	17	0	0	17	0	0
20	18730840	.	T	C	6	10	16	0	1	17	0	0
20	18731068	.	C	T	2	6	8	0	0	8	0	0
20	18801644	.	G	A	1	3	4	0	0	4	0	0
20	18801827	.	T	C	3	2	5	0	0	5	0	0
20	18802438	.	A	G	3	7	10	0	0	10	0	0
20	18802603	.	C	T	2	3	5	0	0	5	0	0
20	18802651	.	G	A	1	2	3	0	0	3	0	0
20	18915249	.	C	T	2	6	8	0	0	8	0	0
20	18947388	.	A	G	14	5	19	0	0	19	0	0
20	18958090	.	G	A	0	5	5	0	2	7	0	0
20	18958106	.	C	G	9	5	14	0	0	14	0	0
20	18958420	.	T	C	4	11	15	0	1	16	0	0
20	18958433	.	G	A	0	12	12	0	4	16	0	0
20	18958477	.	G	A	0	1	1	0	6	7	0	0
20	18961838	.	C	T	5	3	8	0	0	8	0	0
20	18968826	.	C	T	9	10	19	0	0	19	0	0
20	18983543	.	T	G	12	18	30	0	0	30	0	0
20	18983567	.	T	C	10	18	28	0	1	29	0	0
20	18983625	.	G	A	11	16	27	0	4	31	0	0
20	18983755	.	T	C	4	13	17	0	2	19	0	0
20	18983767	.	T	C	5	14	19	0	0	19	0	0
20	18996133	.	T	A	9	5	14	0	0	14	0	0
20	18997610	.	A	G	14	13	27	0	3	30	0	0
20	18997853	.	G	C	8	8	16	2	0	18	0	0
20	19007198	.	G	T	1	2	3	0	0	3	0	0
20	19007210	.	C	A	1	1	2	0	0	2	0	0
20	19058143	.	G	A	8	6	14	0	0	14	0	0
20	19058152	.	T	G	8	7	15	0	0	15	0	0
20	19058188	.	A	G	6	13	19	0	1	20	0	0
20	19058194	.	T	C	6	15	21	0	0	21	0	0
20	19058241	.	A	C	5	10	15	0	0	15	0	0
20	19058425	.	A	G	5	2	7	0	0	7	0	0
20	19058429	.	G	A	5	2	7	0	0	7	0	0
20	19058500	.	A	G	3	3	6	0	1	7	0	0
20	19075371	.	G	A	0	3	3	0	0	3	0	0
20	19078061	.	A	T	1	3	4	0	0	4	0	0
20	19213586	.	T	A	9	9	18	0	1	19	0	0
20	19213587	.	G	C	10	9	19	0	0	19	0	0
20	19277254	.	A	G	3	3	6	0	0	6	0	0
20	19277403	.	C	T	3	4	7	0	0	7	0	0
20	19277409	.	T	C	3	5	8	0	0	8	0	0
20	19277498	.	G	A	4	3	7	0	0	7	0	0
20	19277551	.	C	T	0	3	3	0	3	6	0	0
20	19277893	.	C	T	6	4	10	0	0	10	0	0
20	19277921	.	A	T	6	4	10	0	0	10	0	0
20	19290547	.	C	T	1	2	3	0	1	4	0	0
20	19290586	.	G	A	4	5	9	0	0	9	0	0
20	19290958	.	T	C	1	0	1	0	0	1	0	0
20	19373597	.	G	A	7	7	14	0	0	14	0	0
20	19373852	.	A	G	9	9	18	0	1	19	0	0
20	19373919	.	A	G	12	3	15	0	1	16	0	0
20	19373939	.	G	A	15	4	19	0	1	20	0	0
20	19374043	.	A	C	4	0	4	0	6	10	0	0
20	19374173	.	C	T	1	3	4	0	0	4	0	0
20	19374175	.	T	A	1	3	4	0	0	4	0	0
20	19374415	.	C	T	0	4	4	0	5	9	0	0
20	19374728	.	G	A	3	8	11	0	3	14	0	0
20	19406515	.	A	G	3	7	10	0	0	10	0	0
20	19406643	.	C	T	0	6	6	0	8	14	0	0
20	19406689	.	G	A	1	3	4	0	0	4	0	0
20	19415161	.	A	G	2	1	3	0	0	3	0	0
20	19415260	.	G	A	5	4	9	0	0	9	0	0
20	19415309	.	T	C	5	0	5	0	3	8	0	0
20	19423997	.	C	T	4	2	6	0	0	6	0	0
20	19430640	.	T	C	3	5	8	0	0	8	0	0
20	19430641	.	G	A	3	5	8	0	0	8	0	0
20	19430736	.	A	G	4	0	4	0	3	7	0	0
20	19431012	.	T	C	7	7	14	0	0	14	0	0
20	19431477	.	T	A	5	5	10	0	0	10	0	0
20	19431665	.	G	A	5	5	10	0	0	10	0	0
20	19431960	.	C	G	1	5	6	0	0	6	0	0
20	19432213	.	A	G	1	7	8	0	0	8	0	0
20	19436440	.	G	A	4	6	10	0	2	12	0	0
20	19436577	.	C	G	7	14	21	0	0	21	0	0
20	19437434	.	T	C	8	0	8	0	5	13	0	0
20	19437848	.	T	C	7	0	7	0	9	16	0	0
20	19437969	.	A	G	7	2	9	0	0	9	0	0
20	19438110	.	C	A	5	5	10	0	2	12	0	0
20	19438181	.	C	T	0	7	7	0	2	9	0	0
20	19438425	.	G	A	2	8	10	0	0	10	0	0
20	19442994	.	G	A	1	2	3	0	1	4	0	0
20	19443045	.	G	T	1	0	1	0	0	1	0	0
20	19447392	.	C	T	6	2	8	0	0	8	0	0
20	19447443	.	G	A	5	7	12	0	0	12	0	0
20	19469513	.	G	A	0	1	1	0	0	1	0	0
20	19510892	.	G	C	1	1	2	0	0	2	0	0
20	19510904	.	A	G	2	1	3	0	1	4	0	0
20	19510968	.	C	T	2	2	4	0	0	4	0	0
20	19511425	.	G	A	4	5	9	0	0	9	0	0
20	19513054	.	G	A	4	6	10	0	0	10	0	0
20	19513093	.	G	A	4	9	13	0	2	15	0	0
20	19516009	.	A	G	6	7	13	0	0	13	0	0
20	19516035	.	A	G	6	1	7	0	5	12	0	0
20	19516096	.	T	A	10	8	18	0	3	21	0	0
20	19516206	.	T	A	5	7	12	0	1	13	0	0
20	19516360	.	A	G	7	1	8	0	2	10	0	0
20	19516803	.	T	C	3	2	5	0	0	5	0	0
20	19516850	.	T	C	5	6	11	1	2	14	0	0
20	19519403	.	C	G	7	12	19	0	0	19	0	0
20	19519454	.	T	G	5	12	17	0	1	18	0	0
20	19521387	.	G	A	1	0	1	0	0	1	0	0
20	19530702	.	G	A	6	5	11	0	0	11	0	0
20	19562437	.	C	T	1	2	3	0	0	3	0	0
20	19562524	.	T	C	3	4	7	0	0	7	0	0
20	19562565	.	G	T	5	6	11	0	0	11	0	0
20	19562664	.	C	A	2	6	8	0	1	9	0	0
20	19562736	.	G	T	10	5	15	0	0	15	0	0
20	19562743	.	G	T	5	10	15	0	0	15	0	0
20	19573889	.	C	A	1	3	4	0	0	4	0	0
20	19579940	.	G	A	2	2	4	0	2	6	0	0
20	19580091	.	A	T	6	9	15	0	0	15	0	0
20	19580205	.	G	T	8	9	17	0	0	17	0	0
20	19580234	.	C	T	5	10	15	0	2	17	0	0
20	19580397	.	A	G	3	4	7	0	0	7	0	0
20	19580405	.	G	A	2	5	7	0	1	8	0	0
20	19580441	.	A	G	3	3	6	0	0	6	0	0
20	19580654	.	C	T	12	6	18	0	1	19	0	0
20	19582896	.	G	A	5	4	9	0	0	9	0	0
20	19582955	.	C	T	6	7	13	0	2	15	0	0
20	19583028	.	C	G	1	2	3	0	0	3	0	0
20	19588759	.	G	A	9	7	16	0	0	16	0	0
20	19590288	.	G	A	7	5	12	0	0	12	0	0
20	19793931	.	G	A	1	4	5	0	0	5	0	0
20	19822153	.	G	A	0	2	2	0	2	4	0	0
20	19822442	.	A	G	5	0	5	0	3	8	0	0
20	19823472	.	C	T	4	4	8	0	0	8	0	0
20	19823761	.	A	T	5	7	12	0	2	14	0	0
20	19823859	.	A	G	1	4	5	0	1	6	0	0
20	19823939	.	T	C	2	2	4	0	0	4	0	0
20	19965505	.	T	C	2	0	2	0	3	5	0	0
20	20231857	.	C	T	2	10	12	0	2	14	0	0
20	20231919	.	A	G	8	7	15	0	3	18	0	0
20	20232456	.	G	T	12	14	26	0	2	28	0	0
20	20244405	.	G	A	0	1	1	0	0	1	0	0
20	20245632	.	C	T	0	0	0	0	3	3	0	0
20	20269835	.	T	A	4	3	7	0	0	7	0	0
20	20269836	.	T	C	4	3	7	0	0	7	0	0
20	20270109	.	G	T	5	6	11	0	0	11	0	0
20	20275088	.	G	A	3	5	8	0	0	8	0	0
20	20275193	.	A	T	9	7	16	0	3	19	0	0
20	20275196	.	C	A	8	10	18	0	1	19	0	0
20	20275244	.	G	T	13	3	16	0	1	17	0	0
20	20275609	.	T	A	7	17	24	1	0	25	0	0
20	20275674	.	A	G	15	11	26	0	1	27	0	0
20	20276130	.	G	A	8	4	12	0	0	12	0	0
20	20276369	.	C	G	6	2	8	0	0	8	0	0
20	20276607	.	T	G	6	12	18	0	2	20	0	0
20	20276730	.	G	C	7	3	10	0	0	10	0	0
20	20277162	.	T	C	6	8	14	0	1	15	0	0
20	20277183	.	T	C	7	8	15	0	0	15	0	0
20	20277337	.	A	T	13	5	18	0	0	18	0	0
20	20277370	.	T	C	12	6	18	0	0	18	0	0
20	20277460	.	G	C	4	8	12	0	1	13	0	0
20	20277481	.	A	T	6	7	13	0	1	14	0	0
20	20277525	.	T	C	8	0	8	0	8	16	0	0
20	20277530	.	A	T	8	8	16	0	0	16	0	0
20	20277903	.	C	T	4	3	7	0	0	7	0	0
20	20278075	.	A	G	4	1	5	0	1	6	0	0
20	20278077	.	T	A	5	1	6	0	0	6	0	0
20	20278161	.	G	C	3	0	3	0	8	11	0	0
20	20278213	.	G	A	7	8	15	0	0	15	0	0
20	20278360	.	A	G	3	3	6	0	0	6	0	0
20	20278442	.	G	C	6	6	12	0	1	13	0	0
20	20278461	.	G	C	5	1	6	0	3	9	0	0
20	20278692	.	A	C	4	5	9	0	1	10	0	0
20	20278703	.	C	T	2	6	8	0	0	8	0	0
20	20278827	.	T	C	4	10	14	0	0	14	0	0
20	20278907	.	C	A	3	4	7	0	1	8	0	0
20	20279031	.	T	C	1	0	1	0	5	6	0	0
20	20279036	.	G	A	1	4	5	0	0	5	0	0
20	20279127	.	A	T	5	6	11	0	0	11	0	0
20	20279142	.	A	G	5	5	10	0	0	10	0	0
20	20279196	.	A	G	2	3	5	0	0	5	0	0
20	20312278	.	G	A	5	5	10	0	0	10	0	0
20	20601985	.	T	C	12	7	19	0	1	20	0	0
20	20605071	.	T	C	2	3	5	0	0	5	0	0
20	20605108	.	T	C	4	3	7	0	0	7	0	0
20	20605271	.	T	C	2	2	4	0	0	4	0	0
20	20729975	.	C	T	8	12	20	0	1	21	0	0
20	20730008	.	C	G	19	22	41	0	0	41	0	0
20	20730141	.	A	T	10	16	26	0	4	31	1	0
20	20730151	.	G	A	10	17	27	0	1	28	0	0
20	20730182	.	T	A	3	6	9	0	1	10	0	0
20	20731067	.	G	A	2	3	5	0	0	5	0	0
20	20761545	.	C	T	1	0	1	0	0	1	0	0
20	20793358	.	G	A	2	6	8	0	0	8	0	0
20	20795897	.	G	A	4	2	6	0	1	7	0	0
20	20795927	.	G	A	4	3	7	0	2	9	0	0
20	20808044	.	C	A	3	7	10	0	1	11	0	0
20	20809702	.	T	C	8	8	16	0	0	16	0	0
20	20812680	.	C	T	15	24	39	0	1	40	0	0
20	20812852	.	C	A	13	10	23	0	0	23	0	0
20	20812876	.	C	T	10	8	18	0	1	19	0	0
20	20813014	.	G	A	11	12	23	0	1	24	0	0
20	20813033	.	A	G	14	0	14	0	15	29	0	0
20	20813116	.	A	T	13	6	19	0	1	20	0	0
20	20813270	.	C	T	11	15	26	0	2	28	0	0
20	20813336	.	T	C	7	26	33	0	0	33	0	0
20	20813624	.	G	A	8	4	12	0	1	13	0	0
20	20813685	.	A	T	12	10	22	0	1	23	0	0
20	20813731	.	T	C	2	4	6	0	1	7	0	0
20	20813735	.	A	T	5	2	7	0	0	7	0	0
20	20816875	.	G	A	36	35	71	0	4	75	0	0
20	20817011	.	G	A	42	29	71	0	1	72	0	0
20	20817263	.	A	G	17	15	32	0	2	34	0	0
20	20818523	.	A	G	34	35	69	0	1	70	0	0
20	20927973	.	A	C	5	0	5	0	6	11	0	0
20	20928272	.	C	T	15	12	27	0	4	31	0	0
20	20928536	.	G	A	13	16	29	0	2	31	0	0
20	20928932	.	A	G	15	17	32	0	1	33	0	0
20	20929166	.	G	A	16	12	28	0	1	29	0	0
20	20930149	.	G	A	5	8	13	0	0	13	0	0
20	20980554	.	C	A	2	2	4	0	0	4	0	0
20	20980716	.	C	T	3	3	6	0	1	7	0	0
20	21008381	.	G	A	4	4	8	0	0	8	0	0
20	21015747	.	A	C	3	6	9	0	0	9	0	0
20	21015748	.	G	A	0	3	3	0	6	9	0	0
20	21016348	.	C	T	2	3	5	0	0	5	0	0
20	21016521	.	T	A	6	2	8	0	0	8	0	0
20	21016545	.	C	A	3	2	5	0	0	5	0	0
20	21330448	.	G	A	4	2	6	0	0	6	0	0
20	21392135	.	C	T	2	1	3	0	0	3	0	0
20	21465982	.	C	T	2	7	9	0	0	9	0	0
20	21467733	.	G	T	3	1	4	0	0	4	0	0
20	21473644	.	A	G	5	5	10	0	0	10	0	0
20	21473674	.	C	T	5	7	12	0	0	12	0	0
20	21474159	.	T	C	7	7	14	0	1	15	0	0
20	21474185	.	C	T	5	5	10	0	2	12	0	0
20	21474664	.	A	G	4	0	4	0	4	8	0	0
20	21475432	.	A	T	4	9	13	0	0	13	0	0
20	21635578	.	C	T	2	2	4	0	0	4	0	0
20	21638707	.	C	T	2	4	6	0	0	6	0	0
20	21638903	.	T	C	2	2	4	0	0	4	0	0
20	21639502	.	A	G	2	2	4	0	0	4	0	0
20	21815659	.	G	T	9	10	19	0	0	19	0	0
20	21815986	.	C	T	0	18	18	0	19	37	0	0
20	21816061	.	C	G	15	14	29	0	0	29	0	0
20	21819062	.	T	C	18	15	33	0	0	33	0	0
20	21839504	.	G	A	7	5	12	0	0	12	0	0
20	21841312	.	G	A	1	1	2	0	0	2	0	0
20	21841316	.	G	T	1	1	2	0	0	2	0	0
20	21855195	.	T	C	4	4	8	0	0	8	0	0
20	21862930	.	T	G	0	2	2	0	12	14	0	0
20	21862963	.	C	T	0	11	11	0	10	21	0	0
20	21862975	.	C	T	0	7	7	0	12	19	0	0
20	21872945	.	A	G	3	1	4	0	0	4	0	0
20	21872990	.	G	A	3	1	4	0	1	5	0	0
20	21875162	.	G	A	1	3	4	0	0	4	0	0
20	21875165	.	T	G	1	3	4	0	0	4	0	0
20	21875411	.	C	A	0	1	1	0	1	2	0	0
20	21910005	.	C	T	0	10	10	0	9	19	0	0
20	22053358	.	T	C	0	1	1	0	0	1	0	0
20	22709610	.	C	A	18	9	27	0	1	28	0	0
20	22720443	.	A	G	4	6	10	0	2	12	0	0
20	22722200	.	C	A	13	12	25	0	1	26	0	0
20	22722255	.	G	C	6	11	17	0	3	20	0	0
20	22734145	.	C	A	2	2	4	0	0	4	0	0
20	22736625	.	T	C	4	8	12	0	0	12	0	0
20	22736673	.	C	T	13	23	36	0	1	37	0	0
20	22738204	.	C	A	10	6	16	0	1	17	0	0
20	22739985	.	T	C	15	20	35	0	5	40	0	0
20	22740533	.	A	T	19	13	32	0	0	32	0	0
20	23007547	.	G	A	5	2	7	0	0	7	0	0
20	23026151	.	C	G	4	9	13	0	0	13	0	0
20	23026160	.	A	T	4	9	13	0	0	13	0	0
20	23175479	.	C	A	12	8	20	0	1	21	0	0
20	23175495	.	C	A	9	9	18	0	0	18	0	0
20	23177734	.	G	A	0	3	3	0	0	3	0	0
20	23178078	.	T	C	15	5	20	0	1	21	0	0
20	23179753	.	A	G	2	0	2	0	9	11	0	0
20	23204754	.	C	A	17	11	28	0	2	30	0	0
20	23205004	.	G	T	20	7	27	0	1	28	0	0
20	23205102	.	T	C	13	13	26	0	0	26	0	0
20	23215901	.	C	T	3	2	5	0	0	5	0	0
20	23215949	.	C	T	3	3	6	0	0	6	0	0
20	23245852	.	C	T	3	4	7	0	1	8	0	0
20	23245866	.	T	A	5	6	11	0	0	11	0	0
20	23248572	.	G	A	7	6	13	0	0	13	0	0
20	23248635	.	T	C	9	9	18	0	3	21	0	0
20	23250491	.	A	C	2	0	2	0	9	11	0	0
20	23250530	.	C	A	2	6	8	0	1	9	0	0
20	23254585	.	A	T	1	2	3	0	0	3	0	0
20	23360243	.	C	T	2	2	4	0	0	4	0	0
20	23360252	.	C	T	2	2	4	0	0	4	0	0
20	23360738	.	G	A	0	1	1	0	0	1	0	0
20	23376342	.	C	T	5	5	10	0	0	10	0	0
20	23377161	.	T	C	1	2	3	0	0	3	0	0
20	23378401	.	G	A	3	2	5	0	0	5	0	0
20	23378434	.	A	T	3	3	6	0	0	6	0	0
20	23378899	.	G	A	0	1	1	0	4	5	0	0
20	23383055	.	A	G	3	0	3	0	3	6	0	0
20	23385922	.	T	C	3	5	8	0	0	8	0	0
20	23386096	.	G	A	3	12	15	0	0	15	0	0
20	23386198	.	A	T	3	7	10	0	2	12	0	0
20	23387619	.	G	A	0	3	3	0	2	5	0	0
20	23387775	.	C	T	2	3	5	0	1	6	0	0
20	23390621	.	G	A	0	1	1	0	5	6	0	0
20	23395376	.	T	A	2	2	4	0	11	16	1	0
20	23402554	.	A	G	4	3	7	0	0	7	0	0
20	23421442	.	T	C	15	11	26	0	3	29	0	0
20	23446698	.	G	A	6	4	10	0	1	11	0	0
20	23446868	.	T	A	7	5	12	0	2	14	0	0
20	23447086	.	T	C	8	0	8	0	12	20	0	0
20	23447224	.	T	C	5	0	5	0	4	9	0	0
20	23447274	.	A	C	2	3	5	0	0	5	0	0
20	23447540	.	C	T	7	7	14	0	1	15	0	0
20	23447873	.	C	G	1	1	2	0	0	2	0	0
20	23453642	.	C	T	3	3	6	0	2	8	0	0
20	23453671	.	C	T	0	1	1	0	0	1	0	0
20	23453802	.	G	A	1	0	1	0	0	1	0	0
20	23471985	.	G	A	1	5	6	0	1	7	0	0
20	23475653	.	G	C	2	4	6	0	0	6	0	0
20	23477436	.	C	T	4	3	7	0	0	7	0	0
20	24819582	.	C	T	1	5	6	0	21	27	0	0
20	24819646	.	C	T	4	10	14	0	1	15	0	0
20	24819929	.	T	C	6	7	13	0	0	13	0	0
20	24820566	.	A	T	6	5	11	0	2	13	0	0
20	24820885	.	C	T	0	7	7	0	9	16	0	0
20	24821048	.	C	A	13	8	21	0	2	23	0	0
20	24821094	.	C	T	1	8	9	0	6	15	0	0
20	24841039	.	G	A	3	3	6	0	0	6	0	0
20	24915706	.	T	C	5	0	5	0	3	8	0	0
20	24915712	.	G	A	4	5	9	0	1	10	0	0
20	24959732	.	A	G	2	6	8	0	0	8	0	0
20	24962906	.	C	T	0	1	1	0	0	1	0	0
20	24962956	.	G	A	3	4	7	0	0	7	0	0
20	25342134	.	G	A	0	2	2	0	0	2	0	0
20	25354604	.	G	C	2	1	3	0	0	3	0	0
20	25368785	.	A	G	3	4	7	0	0	7	0	0
20	25368871	.	C	T	4	3	7	0	0	7	0	0
20	25371938	.	C	G	1	0	1	0	0	1	0	0
20	25374908	.	G	A	1	0	1	0	0	1	0	0
20	25374912	.	G	A	1	2	3	0	0	3	0	0
20	25374965	.	G	T	2	3	5	0	0	5	0	0
20	25378556	.	C	T	1	1	2	0	0	2	0	0
20	25378583	.	T	G	1	1	2	0	0	2	0	0
20	25379771	.	T	C	0	1	1	0	0	1	0	0
20	25384473	.	A	T	1	1	2	0	0	2	0	0
20	25385938	.	A	C	2	1	3	0	0	3	0	0
20	25387931	.	T	C	1	1	2	0	0	2	0	0
20	25436255	.	C	G	1	5	6	0	0	6	0	0
20	25440607	.	A	G	1	6	7	0	0	7	0	0
20	25440668	.	T	C	6	6	12	0	0	12	0	0
20	25440790	.	A	C	7	11	18	0	0	18	0	0
20	25445182	.	A	T	4	0	4	0	0	4	0	0
20	25445213	.	C	T	0	4	4	0	0	4	0	0
20	25466255	.	C	T	1	1	2	0	0	2	0	0
20	25494179	.	A	G	2	2	4	0	0	4	0	0
20	25494726	.	G	T	0	1	1	0	0	1	0	0
20	25496941	.	T	A	3	4	7	0	0	7	0	0
20	25499025	.	G	T	0	4	4	0	0	4	0	0
20	25499412	.	A	C	0	1	1	0	1	2	0	0
20	25500859	.	A	G	2	0	2	0	3	5	0	0
20	25500922	.	C	T	2	2	4	0	0	4	0	0
20	25509772	.	C	T	5	6	11	0	1	12	0	0
20	25509842	.	C	A	9	9	18	0	0	18	0	0
20	25509851	.	A	T	8	7	15	0	2	17	0	0
20	25509934	.	T	C	5	8	13	0	0	13	0	0
20	25510234	.	A	T	7	3	10	0	0	10	0	0
20	25510256	.	T	A	2	7	9	0	0	9	0	0
20	25510270	.	G	T	5	5	10	0	0	10	0	0
20	25510481	.	A	G	4	3	7	0	3	10	0	0
20	25510586	.	A	G	2	5	7	0	1	8	0	0
20	25510630	.	G	A	10	7	17	0	1	18	0	0
20	25510739	.	C	A	9	9	18	0	1	19	0	0
20	25510769	.	T	C	6	10	16	0	0	16	0	0
20	25510897	.	G	C	5	2	7	0	0	7	0	0
20	25511312	.	T	A	11	6	17	0	0	17	0	0
20	25511609	.	T	C	15	12	27	0	0	27	0	0
20	25511785	.	T	C	6	5	11	0	1	12	0	0
20	25511940	.	G	A	0	10	10	0	8	18	0	0
20	25511957	.	A	T	8	9	17	0	0	18	1	0
20	25516185	.	C	T	1	3	4	0	0	4	0	0
20	25528043	.	T	C	0	2	2	0	0	2	0	0
20	25548780	.	C	T	0	3	3	0	8	11	0	0
20	25557969	.	A	G	1	2	3	0	0	3	0	0
20	25557971	.	T	G	1	2	3	0	0	3	0	0
20	25618240	.	G	A	2	5	7	0	0	7	0	0
20	25618330	.	G	A	5	3	8	0	0	8	0	0
20	25618336	.	A	C	5	2	7	0	1	8	0	0
20	25618908	.	G	A	6	5	11	0	0	11	0	0
20	25619965	.	G	A	0	1	1	0	0	1	0	0
20	25623921	.	C	T	0	1	1	0	3	4	0	0
20	25629072	.	A	G	2	2	4	0	1	5	0	0
20	25630961	.	G	A	2	2	4	0	0	4	0	0
20	25630962	.	G	T	2	2	4	0	0	4	0	0
20	25660033	.	T	A	5	6	11	0	0	11	0	0
20	25660441	.	A	G	18	8	26	0	0	26	0	0
20	25661396	.	G	A	7	9	16	0	0	16	0	0
20	25661403	.	T	G	9	4	13	0	0	13	0	0
20	25663590	.	T	G	4	1	5	0	0	5	0	0
20	25665101	.	G	T	14	15	29	0	2	31	0	0
20	25665115	.	G	T	12	15	27	0	5	32	0	0
20	25665144	.	G	T	18	14	32	0	0	33	1	0
20	25665195	.	G	A	17	11	28	0	3	31	0	0
20	25665506	.	C	T	7	5	12	0	2	14	0	0
20	25665515	.	C	T	10	5	15	0	0	15	0	0
20	25665627	.	T	C	6	4	10	0	0	10	0	0
20	25665822	.	G	A	6	11	17	0	2	19	0	0
20	25665927	.	T	C	6	14	20	0	0	20	0	0
20	25666142	.	C	T	7	9	16	0	1	17	0	0
20	25666277	.	G	T	4	4	8	0	2	10	0	0
20	25666402	.	A	T	14	8	22	0	2	24	0	0
20	25666524	.	T	C	6	5	11	0	1	12	0	0
20	25666812	.	T	A	12	11	23	0	1	24	0	0
20	25666947	.	C	T	12	9	21	1	0	22	0	0
20	25669888	.	C	A	1	1	2	0	0	2	0	0
20	25709311	.	C	T	0	3	3	0	4	7	0	0
20	25735250	.	C	A	0	2	2	0	1	3	0	0
20	25853228	.	T	C	4	6	10	0	0	10	0	0
20	25853767	.	A	G	17	11	28	0	3	31	0	0
20	25855561	.	G	A	1	3	4	0	1	5	0	0
20	25859494	.	C	T	12	10	22	0	0	22	0	0
20	25875221	.	T	C	3	0	3	0	6	9	0	0
20	25877787	.	A	T	0	2	2	0	1	3	0	0
20	25906480	.	A	T	1	3	4	0	0	5	1	0
20	25909330	.	C	T	4	6	10	0	1	11	0	0
20	25909462	.	T	C	3	5	8	0	0	8	0	0
20	25909661	.	C	A	6	4	10	0	1	11	0	0
20	25909699	.	C	T	3	9	12	0	1	13	0	0
20	25909765	.	A	C	8	7	15	0	0	15	0	0
20	25910099	.	C	T	5	5	10	0	0	10	0	0
20	25910133	.	G	A	6	5	11	0	0	11	0	0
20	25910298	.	A	T	3	5	8	0	0	8	0	0
20	25910366	.	A	T	4	7	11	0	0	11	0	0
20	25910522	.	G	T	1	4	5	0	1	6	0	0
20	25919371	.	T	C	5	2	7	0	0	7	0	0
20	25923747	.	T	C	7	13	20	0	1	21	0	0
20	25923960	.	T	C	9	25	34	0	3	37	0	0
20	25926048	.	A	G	14	19	33	0	2	35	0	0
20	25926474	.	G	A	11	9	20	0	0	20	0	0
20	25926505	.	T	C	6	7	13	0	1	14	0	0
20	25926540	.	T	A	7	6	13	0	0	13	0	0
20	25926623	.	A	G	3	8	11	0	0	11	0	0
20	25926688	.	C	A	1	5	6	0	0	6	0	0
20	25926792	.	T	G	1	4	5	0	0	5	0	0
20	25926793	.	T	G	1	4	5	0	0	5	0	0
20	25927126	.	C	A	16	10	26	0	2	28	0	0
20	25927259	.	C	G	15	0	15	0	15	30	0	0
20	25927283	.	T	G	15	13	28	0	3	31	0	0
20	25927309	.	A	G	17	0	17	0	8	25	0	0
20	25928098	.	C	T	9	13	22	0	3	25	0	0
20	25929576	.	A	T	3	8	11	0	1	12	0	0
20	25929913	.	T	A	16	9	25	0	1	26	0	0
20	25930671	.	T	C	5	5	10	0	1	11	0	0
20	26002822	.	A	G	4	4	8	0	1	9	0	0
20	26002900	.	C	G	3	7	10	0	0	10	0	0
20	26002970	.	A	G	2	0	2	0	4	6	0	0
20	26004160	.	T	A	7	4	11	0	1	12	0	0
20	26004251	.	A	G	4	7	11	0	0	11	0	0
20	26024196	.	G	A	19	24	43	0	4	47	0	0
20	26024432	.	C	T	12	21	33	0	2	35	0	0
20	26024434	.	A	G	12	23	35	0	0	35	0	0
20	26024565	.	G	A	0	26	26	0	14	40	0	0
20	26027048	.	C	T	0	4	4	0	5	9	0	0
20	26027434	.	G	T	6	9	15	0	1	16	0	0
20	26030641	.	G	T	4	2	6	0	1	7	0	0
20	26035649	.	A	G	2	1	3	0	0	3	0	0
20	26037691	.	G	T	1	1	2	0	0	2	0	0
20	26047462	.	G	A	6	3	9	0	0	9	0	0
20	26048565	.	C	T	3	3	6	0	0	6	0	0
20	26048815	.	C	T	3	3	6	0	0	6	0	0
20	26049961	.	G	A	5	1	6	0	0	6	0	0
20	26050226	.	T	C	5	0	5	0	4	9	0	0
20	26054485	.	T	C	1	4	5	0	0	5	0	0
20	26054503	.	A	G	1	4	5	0	0	5	0	0
20	26055709	.	A	C	0	1	1	0	1	2	0	0
20	26059860	.	A	C	1	3	4	0	0	4	0	0
20	26059911	.	T	A	1	2	3	0	0	3	0	0
20	26216970	.	A	T	1	1	2	0	1	3	0	0
20	26272493	.	A	T	1	2	3	0	0	3	0	0
20	26272494	.	G	T	1	2	3	0	0	3	0	0
20	26282602	.	C	G	1	0	1	0	0	1	0	0
20	26283471	.	C	A	1	2	3	0	0	3	0	0
20	26285606	.	G	A	1	0	1	0	0	1	0	0
20	26290451	.	G	A	2	4	6	0	0	6	0	0
20	26290667	.	A	T	4	3	7	0	2	9	0	0
20	26290738	.	A	T	7	2	9	0	1	10	0	0
20	26290739	.	T	C	8	2	10	0	0	10	0	0
20	26290778	.	A	G	4	2	6	0	1	7	0	0
20	26290855	.	G	C	2	2	4	0	0	4	0	0
20	26291016	.	G	C	4	3	7	0	0	7	0	0
20	26291213	.	A	G	1	2	3	0	0	3	0	0
20	26291331	.	T	C	2	4	6	0	0	6	0	0
20	26298380	.	G	A	2	3	5	0	0	5	0	0
20	26300840	.	G	T	1	4	5	0	1	6	0	0
20	26301092	.	C	T	2	3	5	0	0	5	0	0
20	26304317	.	A	G	1	0	1	0	0	1	0	0
20	26304921	.	G	A	0	2	2	0	0	2	0	0
20	26315894	.	T	C	3	0	3	0	0	3	0	0
20	26320221	.	C	T	5	4	9	0	0	9	0	0
20	26320288	.	T	C	2	5	7	0	0	7	0	0
20	26323356	.	T	C	3	5	8	0	0	8	0	0
20	26323658	.	C	T	2	10	12	0	0	12	0	0
20	26323673	.	C	T	3	11	14	0	0	14	0	0
20	26324196	.	T	G	1	1	2	0	0	2	0	0
20	26324307	.	T	A	9	11	20	0	2	22	0	0
20	26325380	.	A	G	1	1	2	0	0	2	0	0
20	26325481	.	T	A	1	3	4	0	0	4	0	0
20	26325493	.	T	C	0	2	2	0	0	2	0	0
20	26325671	.	A	G	8	7	15	0	0	15	0	0
20	26326345	.	T	C	12	7	19	0	0	19	0	0
20	26327719	.	C	T	12	8	20	0	0	20	0	0
20	26328051	.	C	T	8	10	18	0	0	18	0	0
20	26331595	.	A	G	2	4	6	0	1	7	0	0
20	26331683	.	C	T	8	13	21	0	1	22	0	0
20	26334414	.	A	G	4	9	13	0	1	14	0	0
20	26336921	.	C	G	2	1	3	0	0	3	0	0
20	26337036	.	C	T	5	13	18	0	0	18	0	0
20	26337733	.	C	T	18	18	36	0	0	36	0	0
20	26337790	.	C	A	15	8	23	0	0	23	0	0
20	26344835	.	A	G	5	1	6	0	0	6	0	0
20	26345230	.	C	T	12	23	35	0	1	36	0	0
20	26348838	.	G	A	0	5	5	0	7	12	0	0
20	26351914	.	T	A	14	19	33	0	1	34	0	0
20	26353751	.	T	C	8	13	21	0	1	22	0	0
20	26353793	.	T	C	15	20	35	0	1	36	0	0
20	26358574	.	T	C	18	32	50	0	0	50	0	0
20	26358743	.	G	A	16	21	37	0	6	43	0	0
20	26358964	.	G	A	14	21	35	0	1	36	0	0
20	26360125	.	T	G	1	1	2	0	1	3	0	0
20	26360192	.	C	T	7	5	12	0	0	12	0	0
20	26360225	.	A	G	6	2	8	0	0	8	0	0
20	26360229	.	G	T	5	2	7	0	1	8	0	0
20	26360333	.	A	G	1	1	2	0	0	2	0	0
20	26360537	.	G	T	1	3	4	0	0	4	0	0
20	26360549	.	A	G	2	1	3	0	1	4	0	0
20	26361333	.	C	T	0	2	2	0	2	4	0	0
20	26387413	.	A	T	4	8	12	0	0	12	0	0
20	26387881	.	T	G	3	9	12	0	0	12	0	0
20	26402615	.	T	C	4	2	6	0	0	6	0	0
20	26404155	.	C	T	3	2	5	0	0	5	0	0
20	26404479	.	C	T	1	4	5	0	1	6	0	0
20	26404645	.	C	T	1	2	3	0	0	3	0	0
20	26404753	.	C	A	5	5	10	0	1	11	0	0
20	26405121	.	G	A	1	4	5	0	3	8	0	0
20	26405406	.	T	G	4	0	4	0	5	9	0	0
20	26405479	.	A	T	1	4	5	0	0	5	0	0
20	26405485	.	A	T	1	4	5	0	0	5	0	0
20	26406352	.	T	C	2	3	5	0	0	5	0	0
20	26406369	.	G	A	2	4	6	0	0	6	0	0
20	26406565	.	A	T	2	4	6	0	0	6	0	0
20	26409372	.	T	G	3	8	11	0	0	11	0	0
20	26409403	.	A	T	3	11	14	0	0	14	0	0
20	26409428	.	C	T	7	10	17	0	0	17	0	0
20	26409599	.	C	T	15	23	38	0	1	39	0	0
20	26409723	.	C	T	13	16	29	0	1	30	0	0
20	26409931	.	C	T	21	6	27	0	1	28	0	0
20	26409991	.	G	A	14	8	22	0	1	23	0	0
20	26412712	.	T	C	5	13	18	0	0	18	0	0
20	26412799	.	G	C	12	11	23	0	1	24	0	0
20	26413038	.	C	T	10	10	20	0	0	20	0	0
20	26413181	.	T	C	5	6	11	0	0	11	0	0
20	26413584	.	G	A	7	5	12	0	0	12	0	0
20	26413640	.	C	A	2	7	9	0	1	10	0	0
20	26416068	.	G	C	3	0	3	0	11	14	0	0
20	26416114	.	A	G	2	9	11	0	0	11	0	0
20	26416218	.	C	T	2	5	7	0	0	7	0	0
20	26416353	.	T	G	6	5	11	0	1	12	0	0
20	26467293	.	T	C	3	3	6	0	0	6	0	0
20	26467302	.	G	A	2	2	4	0	1	5	0	0
20	26572536	.	G	A	2	2	4	0	0	4	0	0
20	26775892	.	G	A	2	3	5	0	1	6	0	0
20	26807385	.	G	A	4	4	8	0	1	9	0	0
20	26886607	.	A	G	1	0	1	0	5	6	0	0
20	26907743	.	G	A	2	5	7	0	0	7	0	0
20	26907806	.	T	C	2	5	7	0	0	7	0	0
20	26907857	.	T	C	1	1	2	0	1	3	0	0
20	26913282	.	G	C	3	3	6	0	0	6	0	0
20	26915443	.	T	C	1	1	2	0	0	2	0	0
20	26915472	.	T	C	3	2	5	0	0	5	0	0
20	26943163	.	T	C	3	3	6	0	0	6	0	0
20	26944090	.	C	T	7	4	11	0	1	12	0	0
20	26944762	.	C	A	11	10	21	0	0	21	0	0
20	26945114	.	A	T	1	3	4	1	1	6	0	0
20	26945180	.	T	A	5	5	10	0	1	11	0	0
20	26945394	.	C	T	10	6	16	0	1	17	0	0
20	26945913	.	T	C	12	10	22	0	3	25	0	0
20	26948002	.	T	G	1	7	8	0	0	8	0	0
20	26948215	.	T	C	3	2	5	0	0	5	0	0
20	26948347	.	T	C	0	1	1	0	1	2	0	0
20	26958737	.	C	T	7	10	17	0	1	18	0	0
20	26959139	.	G	C	4	4	8	0	0	8	0	0
20	26959431	.	A	T	3	1	4	0	1	5	0	0
20	26959572	.	C	T	5	5	10	0	0	10	0	0
20	26960001	.	A	T	10	8	18	0	0	18	0	0
20	26960044	.	G	A	0	8	8	0	11	19	0	0
20	26960102	.	T	C	5	10	15	0	1	16	0	0
20	26960220	.	C	A	9	9	18	0	0	18	0	0
20	26960371	.	T	C	9	3	12	0	0	12	0	0
20	26960540	.	A	G	2	0	2	0	7	9	0	0
20	26960580	.	G	A	2	9	11	0	0	11	0	0
20	26960619	.	A	G	8	11	19	0	0	19	0	0
20	26960673	.	A	G	7	7	14	0	3	17	0	0
20	26960802	.	T	C	8	4	12	0	0	12	0	0
20	26960843	.	C	T	8	7	15	0	1	16	0	0
20	26961079	.	G	A	0	4	4	0	5	9	0	0
20	26961353	.	G	A	3	3	6	0	1	7	0	0
20	26961419	.	A	T	7	6	13	0	1	14	0	0
20	26961469	.	A	G	5	8	13	0	1	14	0	0
20	26961655	.	A	T	2	3	5	0	0	5	0	0
20	26961799	.	C	T	3	3	6	0	0	6	0	0
20	26961832	.	T	G	7	1	8	0	1	10	1	0
20	26961907	.	A	G	10	11	21	0	1	22	0	0
20	26962057	.	A	G	7	0	7	0	9	16	0	0
20	26962119	.	T	C	9	11	20	0	0	20	0	0
20	26962177	.	C	T	11	11	22	0	1	23	0	0
20	26962290	.	G	T	14	7	21	0	0	21	0	0
20	26962385	.	T	A	7	9	16	0	1	17	0	0
20	26962455	.	G	A	0	4	4	0	9	13	0	0
20	26989248	.	T	G	1	5	6	0	1	7	0	0
20	26989258	.	T	G	1	4	5	0	0	5	0	0
20	27002175	.	T	G	3	8	11	0	1	12	0	0
20	27002248	.	G	A	5	5	10	0	0	10	0	0
20	27002271	.	A	G	4	8	12	0	0	12	0	0
20	27002766	.	T	A	3	4	7	0	0	7	0	0
20	27002778	.	A	G	2	3	5	0	0	5	0	0
20	27003134	.	C	A	5	2	7	0	0	7	0	0
20	27003208	.	T	A	1	3	4	0	0	4	0	0
20	27020221	.	G	A	5	7	12	0	0	12	0	0
20	27020446	.	G	A	5	1	6	0	0	6	0	0
20	27693172	.	G	T	0	2	2	0	1	3	0	0
20	27693204	.	T	G	1	3	4	0	0	4	0	0
20	27708306	.	A	G	2	5	7	0	1	8	0	0
20	27716376	.	A	C	2	2	4	0	0	4	0	0
20	27716413	.	G	A	0	2	2	0	3	5	0	0
20	27717493	.	A	G	1	4	5	0	0	5	0	0
20	27718418	.	A	C	1	2	3	0	0	3	0	0
20	27719602	.	T	C	1	3	4	0	0	4	0	0
20	27719642	.	G	T	3	3	6	0	0	6	0	0
20	27719652	.	C	A	3	2	5	0	0	5	0	0
20	27719693	.	C	T	5	3	8	0	0	8	0	0
20	27719713	.	G	A	4	2	6	0	0	6	0	0
20	27719859	.	T	C	4	4	8	0	0	8	0	0
20	27719869	.	T	A	3	5	8	0	0	8	0	0
20	27732688	.	A	T	6	6	12	0	1	13	0	0
20	27733009	.	C	T	0	7	7	0	4	11	0	0
20	27733316	.	A	T	1	2	3	0	1	4	0	0
20	27733568	.	C	T	5	4	9	0	0	9	0	0
20	27733611	.	T	C	4	2	6	0	1	7	0	0
20	27733686	.	C	A	0	5	5	0	4	9	0	0
20	27822132	.	A	G	6	4	10	0	0	10	0	0
20	27864591	.	T	G	2	3	5	0	1	6	0	0
20	27864595	.	C	T	3	4	7	0	0	7	0	0
20	28252152	.	G	T	2	2	4	0	0	4	0	0
20	28252167	.	A	G	2	2	4	0	0	4	0	0
20	28253682	.	G	A	5	2	7	0	0	7	0	0
20	28254141	.	A	G	4	2	6	0	0	6	0	0
20	28267512	.	A	T	19	25	44	0	5	49	0	0
20	28268467	.	G	A	3	2	5	0	0	5	0	0
20	28268478	.	T	C	3	2	5	0	0	5	0	0
20	28268623	.	T	C	2	1	3	0	0	3	0	0
20	28268828	.	A	G	30	3	33	0	30	63	0	0
20	28268888	.	C	T	29	28	57	0	1	58	0	0
20	28269024	.	A	T	29	12	41	0	1	42	0	0
20	28269165	.	G	A	26	17	43	0	2	45	0	0
20	28269181	.	C	T	28	13	41	0	3	44	0	0
20	28269210	.	A	G	25	1	26	0	20	46	0	0
20	28269219	.	A	C	26	20	46	0	2	48	0	0
20	28269355	.	T	C	27	19	46	0	6	52	0	0
20	28269418	.	T	G	10	9	19	0	1	20	0	0
20	28270416	.	A	G	4	4	8	0	0	8	0	0
20	28270442	.	A	G	2	2	4	0	0	4	0	0
20	28270474	.	G	T	3	1	4	0	0	4	0	0
20	28270493	.	C	T	1	2	3	0	2	5	0	0
20	28273541	.	C	T	0	9	9	0	5	14	0	0
20	28273631	.	A	G	3	5	8	0	0	8	0	0
20	28281509	.	A	C	1	4	5	0	0	5	0	0
20	28281578	.	C	G	0	2	2	0	0	2	0	0
20	28294732	.	G	T	1	1	2	0	0	3	1	0
20	28310920	.	A	G	3	3	6	0	0	6	0	0
20	28310956	.	T	C	2	0	2	0	1	3	0	0
20	28316845	.	G	T	2	4	6	0	0	6	0	0
20	28326229	.	G	A	1	0	1	0	0	1	0	0
20	28337640	.	A	G	1	4	5	0	0	5	0	0
20	28354951	.	A	G	6	4	10	0	0	10	0	0
20	28355029	.	C	T	4	7	11	0	0	11	0	0
20	28356989	.	T	C	4	6	10	0	0	10	0	0
20	28356998	.	G	A	3	7	10	0	0	10	0	0
20	28357055	.	G	T	7	6	13	0	0	13	0	0
20	28357184	.	A	G	5	6	11	0	0	11	0	0
20	28357190	.	C	T	6	6	12	0	0	12	0	0
20	28357253	.	C	T	4	7	11	0	0	11	0	0
20	28357570	.	A	G	2	6	8	0	0	8	0	0
20	28357580	.	G	A	3	5	8	0	0	8	0	0
20	28357610	.	A	G	4	6	10	0	1	11	0	0
20	28361047	.	C	T	1	0	1	0	0	1	0	0
20	28361249	.	G	T	0	2	2	0	1	3	0	0
20	28361289	.	G	T	3	2	5	0	0	5	0	0
20	28399949	.	G	A	0	1	1	0	0	1	0	0
20	28399987	.	C	A	0	2	2	0	4	6	0	0
20	28400232	.	A	T	5	2	7	0	0	7	0	0
20	28400390	.	C	T	0	1	1	0	1	2	0	0
20	28400422	.	C	T	2	2	4	0	1	5	0	0
20	28400455	.	A	C	4	5	9	0	0	9	0	0
20	28400506	.	T	A	9	7	16	0	2	18	0	0
20	28400704	.	A	G	19	12	31	0	3	34	0	0
20	28400783	.	C	A	11	6	17	0	0	17	0	0
20	28400945	.	C	G	2	6	8	0	0	8	0	0
20	28401066	.	A	T	15	8	23	0	0	23	0	0
20	28401084	.	C	G	15	10	25	0	0	25	0	0
20	28401147	.	A	G	7	18	25	0	1	26	0	0
20	28401232	.	T	A	5	7	12	0	0	12	0	0
20	28401268	.	G	T	5	5	10	0	0	10	0	0
20	28402067	.	T	C	0	1	1	0	0	1	0	0
20	28414423	.	T	C	3	1	4	0	0	4	0	0
20	28417175	.	G	C	2	3	5	0	0	5	0	0
20	28417184	.	G	A	2	3	5	0	0	5	0	0
20	28418494	.	T	A	0	1	1	0	0	1	0	0
20	28418503	.	C	T	0	1	1	0	0	1	0	0
20	28418550	.	A	G	1	4	5	0	0	5	0	0
20	28418587	.	C	T	4	4	8	0	0	8	0	0
20	28418939	.	T	C	9	3	12	0	0	12	0	0
20	28418951	.	T	A	3	8	11	0	1	12	0	0
20	28419015	.	A	T	4	3	7	0	2	9	0	0
20	28419133	.	A	T	1	2	3	0	0	3	0	0
20	28419807	.	T	A	0	3	3	1	0	4	0	0
20	28419831	.	T	C	6	3	9	1	1	11	0	0
20	28420234	.	T	A	6	9	15	0	0	15	0	0
20	28420361	.	C	T	6	14	20	0	0	20	0	0
20	28420438	.	C	G	6	10	16	0	0	16	0	0
20	28420522	.	G	A	2	4	6	0	0	6	0	0
20	28422854	.	C	G	2	3	5	0	1	6	0	0
20	28422920	.	A	G	0	6	6	0	1	7	0	0
20	28422927	.	T	C	2	0	2	0	5	7	0	0
20	28423035	.	G	T	4	3	7	0	0	7	0	0
20	28456616	.	C	T	1	1	2	0	0	2	0	0
20	28469934	.	G	A	1	1	2	0	0	2	0	0
20	28469982	.	A	G	7	7	14	0	3	17	0	0
20	28470057	.	T	C	2	0	2	0	0	2	0	0
20	28476107	.	T	C	3	0	3	0	0	3	0	0
20	28487287	.	T	C	4	3	7	0	0	7	0	0
20	28514822	.	G	C	1	0	1	0	5	6	0	0
20	28514878	.	T	C	7	7	14	0	0	14	0	0
20	28541670	.	A	G	0	1	1	0	0	1	0	0
20	28541754	.	A	G	2	1	3	0	0	3	0	0
20	28650328	.	A	C	9	12	21	0	0	21	0	0
20	28650945	.	A	T	14	17	31	0	2	33	0	0
20	28650946	.	T	G	16	14	30	0	3	33	0	0
20	28650980	.	T	C	17	11	28	0	1	29	0	0
20	28651239	.	A	G	16	24	40	0	2	42	0	0
20	28651693	.	G	T	12	8	20	0	2	22	0	0
20	28651958	.	T	G	11	5	16	0	3	19	0	0
20	28652277	.	G	C	16	14	30	0	1	31	0	0
20	28652449	.	G	C	18	11	29	0	1	30	0	0
20	28652485	.	G	A	16	15	31	0	2	33	0	0
20	28652597	.	G	C	19	12	31	0	0	31	0	0
20	28658597	.	T	C	9	9	18	0	0	18	0	0
20	28658666	.	A	C	7	7	14	0	2	16	0	0
20	28659924	.	A	G	4	5	9	0	0	9	0	0
20	28660582	.	G	A	6	13	19	0	0	19	0	0
20	28660729	.	T	C	9	1	10	0	11	21	0	0
20	28660795	.	G	A	6	7	13	0	0	13	0	0
20	28660828	.	G	T	3	5	8	0	0	8	0	0
20	28660837	.	T	C	5	5	10	0	0	10	0	0
20	28690067	.	G	A	2	0	2	0	0	2	0	0
20	28692254	.	G	A	1	1	2	0	0	2	0	0
20	28695249	.	C	A	2	2	4	0	0	4	0	0
20	28698253	.	G	A	1	2	3	0	0	3	0	0
20	28870843	.	T	C	36	15	51	0	2	53	0	0
20	28886991	.	T	A	2	2	4	0	2	7	1	0
20	29268260	.	A	G	1	3	4	0	0	4	0	0
20	29269095	.	T	C	7	1	8	0	6	14	0	0
20	30894743	.	T	C	2	2	4	0	0	4	0	0
20	31238061	.	A	G	5	5	10	0	1	11	0	0
20	31429132	.	T	C	2	2	4	0	1	5	0	0
20	31429181	.	C	T	3	6	9	0	0	9	0	0
20	31429648	.	C	T	12	9	21	0	0	21	0	0
20	31429824	.	G	A	5	6	11	0	0	11	0	0
20	31430039	.	G	C	2	8	10	0	0	10	0	0
20	31430115	.	A	T	5	3	8	1	0	9	0	0
20	31430204	.	C	A	4	8	12	0	1	13	0	0
20	31430279	.	A	G	3	9	12	0	0	12	0	0
20	31430320	.	T	C	8	0	8	0	6	14	0	0
20	31430769	.	C	T	1	10	11	0	4	15	0	0
20	31430922	.	T	A	2	2	4	0	0	4	0	0
20	31430993	.	C	T	0	5	5	0	8	13	0	0
20	31431106	.	A	T	5	5	10	0	1	11	0	0
20	31431160	.	A	T	5	8	13	0	0	13	0	0
20	31431345	.	C	T	3	2	5	0	1	6	0	0
20	31431645	.	A	T	4	3	7	0	1	8	0	0
20	31431701	.	A	G	7	5	12	0	0	12	0	0
20	31431739	.	A	G	9	6	15	0	2	17	0	0
20	31431962	.	A	G	8	5	13	0	0	13	0	0
20	31436304	.	C	T	5	5	10	0	1	11	0	0
20	31436387	.	T	C	5	1	6	0	11	17	0	0
20	31436450	.	G	A	9	8	17	0	2	19	0	0
20	31436504	.	T	C	10	0	10	0	6	16	0	0
20	31436750	.	C	T	0	4	4	0	3	7	0	0
20	31436819	.	C	A	2	2	4	0	0	4	0	0
20	31441076	.	G	A	1	0	1	0	0	1	0	0
20	31442308	.	C	T	0	1	1	0	2	3	0	0
20	31447413	.	C	T	0	5	5	0	2	7	0	0
20	31451649	.	A	G	1	1	2	0	1	3	0	0
20	31746445	.	C	T	11	13	24	0	3	27	0	0
20	31747860	.	C	T	0	6	6	0	17	23	0	0
20	31747984	.	C	T	4	13	17	0	1	18	0	0
20	31747988	.	A	C	4	12	16	0	1	17	0	0
20	31748032	.	G	T	9	5	14	0	0	14	0	0
20	31748124	.	T	C	9	1	10	0	11	21	0	0
20	31748431	.	A	G	13	4	17	0	0	17	0	0
20	31748448	.	A	C	12	3	15	0	1	16	0	0
20	31748765	.	A	G	6	8	14	0	0	14	0	0
20	31748803	.	A	G	5	9	14	0	1	15	0	0
20	31749118	.	A	G	17	9	26	0	0	26	0	0
20	31749207	.	C	T	0	12	12	0	12	24	0	0
20	31769469	.	A	G	8	7	15	0	1	16	0	0
20	31769523	.	T	A	2	3	5	0	0	5	0	0
20	31786688	.	T	A	6	5	11	0	0	11	0	0
20	31790975	.	A	G	1	0	1	0	0	1	0	0
20	32047448	.	T	A	6	10	16	0	0	16	0	0
20	32047457	.	T	C	5	12	17	0	1	18	0	0
20	32047546	.	C	T	11	11	22	0	0	22	0	0
20	32047640	.	T	A	14	10	24	0	2	26	0	0
20	32048117	.	A	G	19	10	29	0	2	31	0	0
20	32048369	.	T	A	17	17	34	0	1	35	0	0
20	32049056	.	G	T	16	12	28	0	0	28	0	0
20	32049178	.	G	T	19	15	34	0	4	38	0	0
20	32052708	.	G	A	12	11	23	0	1	24	0	0
20	32052873	.	C	T	0	20	20	0	14	34	0	0
20	32071416	.	G	A	12	7	19	0	1	20	0	0
20	32098046	.	A	G	6	9	15	0	0	15	0	0
20	32110370	.	T	C	10	0	10	0	9	19	0	0
20	32110790	.	T	C	2	3	5	0	0	5	0	0
20	32110829	.	C	G	4	4	8	0	0	8	0	0
20	32110862	.	G	A	5	5	10	0	0	10	0	0
20	32110892	.	C	T	0	5	5	0	4	9	0	0
20	32110898	.	A	T	5	4	9	0	1	10	0	0
20	32118658	.	A	G	13	0	13	0	10	23	0	0
20	32121325	.	C	T	0	1	1	0	0	1	0	0
20	32135962	.	T	C	6	9	15	0	2	17	0	0
20	32136048	.	C	T	2	7	9	0	0	9	0	0
20	32136220	.	A	C	2	7	9	0	0	9	0	0
20	32136378	.	G	T	7	7	14	0	1	15	0	0
20	32136443	.	T	G	10	12	22	0	2	24	0	0
20	32136446	.	A	T	9	11	20	0	3	23	0	0
20	32136584	.	T	A	6	10	16	0	0	16	0	0
20	32136847	.	C	G	5	3	8	0	1	9	0	0
20	32137866	.	C	T	9	7	16	0	0	16	0	0
20	32137886	.	C	T	9	8	17	0	1	18	0	0
20	32137984	.	A	C	9	10	19	0	0	19	0	0
20	32138029	.	T	A	11	3	14	0	1	15	0	0
20	32138127	.	C	T	14	10	24	0	0	24	0	0
20	32138305	.	T	C	6	9	15	0	2	17	0	0
20	32138360	.	T	C	5	8	13	0	3	16	0	0
20	32138400	.	A	G	15	4	19	0	1	20	0	0
20	32138478	.	A	G	15	18	33	0	0	33	0	0
20	32138723	.	A	G	14	1	15	0	7	22	0	0
20	32225711	.	G	A	4	2	6	0	0	6	0	0
20	32226995	.	G	T	10	10	20	0	2	22	0	0
20	32227025	.	C	T	7	6	13	0	0	13	0	0
20	32229214	.	G	T	17	13	30	0	0	30	0	0
20	32229825	.	G	T	18	8	26	0	2	28	0	0
20	32229828	.	G	T	18	12	30	0	2	32	0	0
20	32230168	.	T	C	14	17	31	0	2	33	0	0
20	32230376	.	T	C	8	16	24	0	1	25	0	0
20	32230893	.	C	T	17	10	27	0	0	27	0	0
20	32230957	.	C	T	19	12	31	0	2	33	0	0
20	32286923	.	A	T	11	8	19	0	2	21	0	0
20	32287041	.	C	G	8	7	15	0	1	16	0	0
20	32287943	.	A	C	5	6	11	0	2	13	0	0
20	32288208	.	T	A	7	2	9	0	0	9	0	0
20	32288318	.	T	A	7	4	11	0	1	12	0	0
20	32288372	.	T	C	5	0	5	0	4	9	0	0
20	32290222	.	G	A	12	8	20	0	0	20	0	0
20	32290435	.	A	G	14	8	22	0	0	22	0	0
20	32290828	.	C	T	0	7	7	0	6	13	0	0
20	32291287	.	G	A	2	2	4	0	0	4	0	0
20	32330687	.	G	C	5	0	5	0	4	9	0	0
20	32330924	.	T	G	4	8	12	0	0	12	0	0
20	32331316	.	A	G	2	2	4	0	0	4	0	0
20	32331317	.	G	A	2	2	4	0	0	4	0	0
20	32332298	.	T	C	3	0	3	0	5	8	0	0
20	32332633	.	A	T	2	3	5	0	1	6	0	0
20	32337625	.	T	C	2	2	4	0	0	4	0	0
20	32337689	.	A	C	4	4	8	0	1	9	0	0
20	32337918	.	A	C	1	1	2	0	0	2	0	0
20	32337927	.	G	A	1	2	3	0	0	3	0	0
20	32339847	.	A	G	2	2	4	0	0	4	0	0
20	32351817	.	A	T	0	1	1	0	0	1	0	0
20	32432657	.	A	G	12	1	13	0	6	19	0	0
20	32437987	.	C	T	1	2	3	0	0	3	0	0
20	32437993	.	G	T	1	2	3	0	0	3	0	0
20	32438446	.	A	T	5	2	7	0	0	7	0	0
20	32484573	.	C	T	5	3	8	0	0	8	0	0
20	32484582	.	T	C	6	3	9	0	0	9	0	0
20	32490004	.	G	T	4	6	10	0	0	10	0	0
20	32490033	.	C	T	4	6	10	0	1	11	0	0
20	32490783	.	C	G	3	2	5	0	0	5	0	0
20	32490894	.	G	A	1	2	3	0	0	3	0	0
20	32498410	.	C	G	3	5	8	0	0	8	0	0
20	32498771	.	C	G	4	4	8	0	0	8	0	0
20	32498813	.	A	T	4	4	8	0	0	8	0	0
20	32499199	.	T	C	1	3	4	0	0	4	0	0
20	32499263	.	T	C	1	5	6	0	0	6	0	0
20	32499284	.	C	A	1	2	3	0	1	4	0	0
20	32501840	.	T	G	7	5	12	0	0	12	0	0
20	32510813	.	A	G	2	1	3	0	0	3	0	0
20	32520351	.	A	G	9	0	9	0	8	17	0	0
20	32520365	.	A	G	11	1	12	0	9	21	0	0
20	32520461	.	G	A	3	4	7	0	1	8	0	0
20	32520615	.	T	A	6	10	16	0	0	16	0	0
20	32520673	.	A	G	4	4	8	0	2	10	0	0
20	32520779	.	A	G	4	10	14	0	0	14	0	0
20	32520815	.	A	G	7	0	7	0	6	13	0	0
20	32520847	.	A	T	7	4	11	0	1	12	0	0
20	32520852	.	A	G	8	3	11	0	1	12	0	0
20	32520882	.	C	T	4	3	7	0	0	7	0	0
20	32521048	.	A	T	5	6	11	0	0	11	0	0
20	32521175	.	T	A	10	17	27	0	0	27	0	0
20	32521186	.	T	C	5	20	25	0	1	26	0	0
20	32521266	.	T	G	9	7	16	0	1	17	0	0
20	32521488	.	T	C	5	5	10	0	1	11	0	0
20	32521517	.	A	T	9	8	17	0	2	20	1	0
20	32521534	.	T	A	13	10	23	0	0	23	0	0
20	32521605	.	G	A	17	12	29	0	1	30	0	0
20	32521618	.	T	C	17	12	29	0	0	29	0	0
20	32521719	.	A	C	15	11	26	0	3	29	0	0
20	32521742	.	G	A	12	18	30	0	1	31	0	0
20	32557375	.	C	T	0	1	1	0	0	1	0	0
20	32567982	.	T	C	2	1	3	0	0	3	0	0
20	32571913	.	T	C	0	1	1	0	0	1	0	0
20	32838589	.	A	G	0	4	4	0	0	4	0	0
20	32838695	.	C	A	3	1	4	0	2	6	0	0
20	32863650	.	A	G	1	2	3	0	0	3	0	0
20	32863657	.	A	G	1	2	3	0	0	3	0	0
20	32872075	.	C	A	0	3	3	0	0	3	0	0
20	32872156	.	C	A	3	1	4	0	0	4	0	0
20	32948489	.	C	G	2	2	4	0	0	4	0	0
20	32948512	.	G	A	3	3	6	0	0	6	0	0
20	33007836	.	T	C	1	0	1	0	0	1	0	0
20	33127513	.	A	G	0	1	1	0	0	1	0	0
20	33177904	.	C	T	0	2	2	0	0	2	0	0
20	33180111	.	T	C	2	1	3	0	0	3	0	0
20	33189386	.	G	A	0	1	1	0	2	3	0	0
20	33294503	.	A	T	5	4	9	0	0	9	0	0
20	33297776	.	A	C	4	4	8	0	0	8	0	0
20	33298184	.	C	T	2	3	5	0	0	5	0	0
20	33298651	.	G	A	6	9	15	0	0	15	0	0
20	33467794	.	A	T	8	8	16	0	2	18	0	0
20	33471085	.	G	A	3	4	7	0	0	7	0	0
20	33471127	.	A	T	13	11	24	0	0	24	0	0
20	33471166	.	C	T	0	9	9	0	16	25	0	0
20	33471199	.	T	C	8	0	8	0	5	13	0	0
20	33494027	.	C	A	13	10	23	0	1	24	0	0
20	33494064	.	A	G	11	7	18	0	0	18	0	0
20	33494165	.	A	G	16	9	25	0	1	26	0	0
20	33494411	.	G	T	20	18	38	0	1	39	0	0
20	33494436	.	C	T	19	16	35	0	4	39	0	0
20	33497087	.	A	T	6	2	8	0	0	8	0	0
20	33748745	.	G	A	1	2	3	0	3	6	0	0
20	33759043	.	T	C	3	3	6	0	0	6	0	0
20	33759067	.	C	T	0	10	10	0	5	15	0	0
20	33759151	.	G	C	13	0	13	0	14	27	0	0
20	33759196	.	A	C	7	0	7	0	5	12	0	0
20	33763208	.	G	A	1	5	6	0	0	6	0	0
20	33810496	.	G	A	6	3	9	0	1	10	0	0
20	33811574	.	G	T	6	11	17	0	3	20	0	0
20	33811622	.	A	G	8	4	12	0	4	16	0	0
20	33839868	.	A	G	3	4	7	0	0	7	0	0
20	33856373	.	T	C	7	3	10	0	0	10	0	0
20	33860144	.	G	A	6	6	12	0	0	12	0	0
20	33860147	.	G	A	6	6	12	0	0	12	0	0
20	33982016	.	G	A	6	2	8	0	0	8	0	0
20	33985495	.	C	T	3	4	7	0	1	8	0	0
20	34009919	.	G	A	0	4	4	0	3	7	0	0
20	34009947	.	A	G	3	7	10	0	0	10	0	0
20	34010028	.	A	G	3	5	8	0	0	8	0	0
20	34012790	.	T	A	2	9	11	0	1	12	0	0
20	34012798	.	T	C	4	8	12	0	0	12	0	0
20	34012828	.	T	A	7	10	17	0	1	18	0	0
20	34012837	.	A	T	7	10	17	0	0	17	0	0
20	34012885	.	G	A	6	9	15	0	1	16	0	0
20	34015907	.	G	A	3	17	20	0	2	22	0	0
20	34015921	.	T	A	7	15	22	0	1	23	0	0
20	34015994	.	T	A	10	14	24	0	0	24	0	0
20	34020861	.	T	A	0	2	2	0	0	2	0	0
20	34020891	.	G	A	0	4	4	0	0	4	0	0
20	34023948	.	C	T	0	1	1	0	0	1	0	0
20	34039390	.	G	A	4	3	7	0	0	7	0	0
20	34042070	.	A	G	1	7	8	0	1	9	0	0
20	34042209	.	A	G	2	2	4	0	0	4	0	0
20	34044813	.	G	A	7	3	10	0	1	11	0	0
20	34056162	.	A	G	3	4	7	0	0	7	0	0
20	34057305	.	T	C	0	3	3	0	1	4	0	0
20	34059018	.	G	A	2	0	2	0	0	2	0	0
20	34061286	.	A	G	2	3	5	0	0	5	0	0
20	34061784	.	C	T	7	4	11	0	0	11	0	0
20	34063974	.	T	A	3	2	5	0	0	5	0	0
20	34064272	.	C	T	1	0	1	0	0	1	0	0
20	34066224	.	A	G	0	2	2	0	1	3	0	0
20	34154618	.	C	A	12	11	23	0	0	23	0	0
20	34154619	.	C	A	12	8	20	0	3	23	0	0
20	34154857	.	C	A	7	6	13	0	0	13	0	0
20	34154864	.	T	A	7	3	10	0	0	10	0	0
20	34155134	.	G	A	7	7	14	0	2	16	0	0
20	34155339	.	C	A	10	10	20	0	2	22	0	0
20	34155428	.	A	G	7	11	18	0	1	19	0	0
20	34337702	.	G	A	2	2	4	0	0	4	0	0
20	34338371	.	T	C	9	8	17	0	0	17	0	0
20	34338884	.	G	A	0	5	5	0	7	12	0	0
20	34339473	.	G	A	9	4	13	0	2	15	0	0
20	34339516	.	C	T	28	14	42	0	2	44	0	0
20	34339786	.	T	A	15	14	29	0	4	33	0	0
20	34340047	.	C	T	20	20	40	0	1	41	0	0
20	34340055	.	T	C	22	19	41	0	3	44	0	0
20	34340176	.	G	A	1	25	26	0	21	47	0	0
20	34340200	.	C	T	18	16	34	0	2	36	0	0
20	34340520	.	T	C	16	11	27	0	1	28	0	0
20	34340675	.	A	C	14	21	35	0	1	36	0	0
20	34341000	.	C	T	18	13	31	0	0	31	0	0
20	34343907	.	C	T	0	3	3	0	1	4	0	0
20	34364295	.	T	C	0	0	0	0	1	1	0	0
20	34364936	.	A	G	1	5	6	0	1	7	0	0
20	34365141	.	C	T	2	2	4	0	0	4	0	0
20	34365146	.	C	A	2	3	5	0	0	5	0	0
20	34368274	.	G	A	1	0	1	0	0	1	0	0
20	34398646	.	G	A	1	1	2	0	0	2	0	0
20	34420823	.	A	G	15	25	40	0	1	41	0	0
20	34421155	.	C	T	15	17	32	0	0	32	0	0
20	34421159	.	G	A	15	18	33	0	0	33	0	0
20	34421307	.	A	G	12	17	29	1	0	30	0	0
20	34421485	.	C	T	12	16	28	0	1	29	0	0
20	34421672	.	G	A	13	7	20	0	1	21	0	0
20	34421701	.	T	C	13	8	21	0	0	21	0	0
20	34421758	.	G	A	13	7	20	0	0	20	0	0
20	34421801	.	G	C	13	0	13	0	8	21	0	0
20	34421804	.	G	A	13	8	21	0	0	21	0	0
20	34426759	.	A	C	14	12	26	0	1	27	0	0
20	34430100	.	T	G	6	7	13	0	0	13	0	0
20	34431337	.	G	A	1	2	3	0	0	3	0	0
20	34431661	.	A	G	5	7	12	0	2	14	0	0
20	34444945	.	T	C	4	6	10	0	2	12	0	0
20	34445005	.	A	G	2	3	5	0	0	5	0	0
20	34446733	.	A	G	0	3	3	0	0	3	0	0
20	34447025	.	A	G	3	8	11	0	0	11	0	0
20	34447049	.	G	A	0	1	1	0	0	1	0	0
20	34450257	.	T	G	0	1	1	0	0	1	0	0
20	34501246	.	T	C	2	2	4	0	0	4	0	0
20	34501293	.	G	A	0	3	3	0	2	5	0	0
20	34537775	.	A	C	9	4	13	0	0	13	0	0
20	34537814	.	G	T	6	1	7	0	2	9	0	0
20	34582410	.	T	C	2	0	2	0	0	2	0	0
20	34592483	.	C	T	6	5	11	0	0	11	0	0
20	34596468	.	A	T	4	8	12	0	2	14	0	0
20	34596617	.	T	C	3	9	12	0	0	12	0	0
20	34596710	.	A	T	2	2	4	0	0	4	0	0
20	34596973	.	G	T	3	3	6	0	0	6	0	0
20	34596974	.	T	G	3	3	6	0	0	6	0	0
20	34597127	.	C	T	8	8	16	0	0	16	0	0
20	34597292	.	G	A	5	9	14	0	0	14	0	0
20	34597844	.	T	C	11	12	23	0	2	25	0	0
20	34601127	.	A	G	20	9	29	0	2	31	0	0
20	34602340	.	C	T	8	9	17	0	2	19	0	0
20	34602561	.	A	C	13	13	26	0	2	28	0	0
20	34603575	.	G	T	4	5	9	0	1	10	0	0
20	34603733	.	T	G	0	3	3	0	0	3	0	0
20	34604356	.	C	T	11	19	30	0	2	32	0	0
20	34604432	.	C	T	3	2	5	0	0	5	0	0
20	34607698	.	A	G	6	0	6	0	3	9	0	0
20	34607893	.	A	G	13	9	22	0	0	22	0	0
20	34608194	.	C	T	3	6	9	0	0	9	0	0
20	34608235	.	A	G	5	1	6	0	0	6	0	0
20	34608272	.	T	C	6	4	10	0	1	11	0	0
20	34608404	.	T	G	3	4	7	0	1	8	0	0
20	34608577	.	C	T	1	2	3	0	0	3	0	0
20	34613651	.	A	G	1	1	2	0	0	2	0	0
20	34627817	.	G	C	3	2	5	0	0	5	0	0
20	34630192	.	T	C	4	1	5	0	0	5	0	0
20	34630281	.	A	G	6	3	9	0	0	9	0	0
20	34630381	.	C	T	7	4	11	0	1	12	0	0
20	34630861	.	C	T	5	0	5	0	0	5	0	0
20	34643408	.	A	C	5	2	7	0	0	7	0	0
20	34643491	.	A	T	2	3	5	0	0	5	0	0
20	34643535	.	T	C	1	6	7	0	0	7	0	0
20	34655902	.	G	C	0	0	0	0	3	3	0	0
20	34661498	.	A	G	2	1	3	0	0	3	0	0
20	34661501	.	A	G	2	2	4	0	0	4	0	0
20	34695326	.	C	T	1	1	2	0	0	2	0	0
20	34696329	.	A	C	0	1	1	0	0	1	0	0
20	34696628	.	A	T	4	11	15	0	0	15	0	0
20	34700237	.	G	T	0	6	6	0	5	11	0	0
20	34700238	.	T	C	5	6	11	0	0	11	0	0
20	34727666	.	G	A	3	8	11	0	0	11	0	0
20	34733259	.	A	G	9	0	9	0	9	18	0	0
20	34733604	.	G	A	13	11	24	0	0	24	0	0
20	34733819	.	G	A	10	8	18	0	0	18	0	0
20	34737818	.	A	G	2	5	7	0	1	8	0	0
20	34738198	.	G	A	21	16	37	0	2	39	0	0
20	34738205	.	C	T	4	17	21	0	16	37	0	0
20	34738272	.	A	G	19	10	29	0	1	30	0	0
20	34738314	.	G	A	6	24	30	0	2	32	0	0
20	34738397	.	G	T	8	11	19	0	0	19	0	0
20	34738756	.	A	G	10	18	28	0	0	28	0	0
20	34742840	.	G	A	3	3	6	0	0	6	0	0
20	34746019	.	G	A	4	13	17	0	1	18	0	0
20	34749672	.	G	A	3	0	3	0	0	3	0	0
20	34749747	.	G	A	5	8	13	0	1	14	0	0
20	34749754	.	C	T	8	5	13	0	1	14	0	0
20	34749793	.	C	T	1	0	1	0	0	1	0	0
20	34749794	.	A	G	1	0	1	0	0	1	0	0
20	34750025	.	G	C	2	0	2	0	0	2	0	0
20	34779430	.	G	A	0	0	0	0	1	1	0	0
20	34780261	.	G	A	0	0	0	0	1	1	0	0
20	34793015	.	A	G	1	3	4	0	0	4	0	0
20	34794939	.	C	T	26	23	49	0	7	56	0	0
20	34794988	.	C	G	30	19	49	0	4	53	0	0
20	34795111	.	C	A	31	38	69	0	2	71	0	0
20	34795126	.	A	G	31	40	71	0	4	75	0	0
20	34795221	.	A	T	39	25	64	0	1	65	0	0
20	34795418	.	G	C	32	25	57	0	2	59	0	0
20	34795559	.	C	T	0	35	35	0	24	59	0	0
20	34795631	.	T	G	32	19	51	0	4	55	0	0
20	34795689	.	C	T	25	26	51	0	2	53	0	0
20	34797252	.	G	T	26	33	59	0	4	63	0	0
20	34797532	.	C	A	30	26	56	0	2	58	0	0
20	34801164	.	C	T	0	3	3	0	0	3	0	0
20	34933209	.	C	A	14	16	30	0	3	33	0	0
20	34955791	.	C	T	22	23	45	0	4	49	0	0
20	34955810	.	T	G	25	5	30	0	1	31	0	0
20	34956159	.	A	T	16	9	25	0	0	25	0	0
20	34956164	.	T	A	16	7	23	0	1	25	1	0
20	34991776	.	G	A	1	1	2	0	0	2	0	0
20	34991804	.	C	T	0	3	3	0	2	5	0	0
20	35000029	.	C	T	2	2	4	0	0	4	0	0
20	35000163	.	C	T	0	0	0	0	2	2	0	0
20	35001423	.	G	A	1	2	3	0	0	3	0	0
20	35019062	.	A	T	2	2	4	0	0	4	0	0
20	35058727	.	T	A	13	10	23	0	0	23	0	0
20	35059085	.	G	A	0	9	9	0	9	18	0	0
20	35064521	.	G	A	1	6	7	0	0	7	0	0
20	35065345	.	G	A	0	2	2	0	2	4	0	0
20	35065588	.	G	A	9	4	13	0	4	17	0	0
20	35066821	.	G	A	0	11	11	0	10	21	0	0
20	35068702	.	T	C	16	13	29	0	2	31	0	0
20	35068765	.	A	T	8	12	20	0	4	24	0	0
20	35069756	.	A	G	10	14	24	0	6	30	0	0
20	35069928	.	C	T	17	19	36	0	0	36	0	0
20	35069963	.	A	C	20	21	41	0	0	41	0	0
20	35070176	.	C	T	15	11	26	0	2	28	0	0
20	35070340	.	C	T	9	12	21	0	0	21	0	0
20	35142856	.	A	G	0	2	2	0	0	2	0	0
20	35157617	.	C	T	1	2	3	0	1	4	0	0
20	35159365	.	C	T	2	1	3	0	1	4	0	0
20	35162054	.	G	A	1	3	4	0	0	4	0	0
20	35171257	.	C	T	3	2	5	0	1	6	0	0
20	35177501	.	T	C	1	1	2	0	0	2	0	0
20	35195185	.	G	A	0	3	3	0	1	4	0	0
20	35198110	.	A	G	4	4	8	0	3	11	0	0
20	35198116	.	G	A	6	3	9	0	2	11	0	0
20	35198780	.	G	A	0	2	2	0	4	6	0	0
20	35204668	.	C	T	4	7	11	0	2	13	0	0
20	35204773	.	C	T	7	10	17	0	0	17	0	0
20	35205061	.	C	T	6	11	17	0	0	17	0	0
20	35205182	.	T	C	3	3	6	0	0	6	0	0
20	35205550	.	A	G	6	0	6	0	7	13	0	0
20	35205552	.	T	G	7	0	7	0	6	13	0	0
20	35205600	.	A	T	5	12	17	0	0	17	0	0
20	35205626	.	T	G	9	0	9	0	9	18	0	0
20	35205772	.	T	A	11	3	14	0	1	15	0	0
20	35206023	.	G	A	11	6	17	0	2	19	0	0
20	35206101	.	A	T	4	8	12	0	1	13	0	0
20	35206272	.	T	C	6	3	9	0	0	9	0	0
20	35208046	.	A	G	2	4	6	0	0	6	0	0
20	35209080	.	T	A	1	6	7	0	0	7	0	0
20	35209405	.	C	T	10	12	22	0	0	22	0	0
20	35209625	.	G	A	6	6	12	0	0	12	0	0
20	35209680	.	A	T	5	2	7	0	1	8	0	0
20	35209681	.	T	A	5	3	8	0	0	8	0	0
20	35210047	.	T	C	17	0	17	0	7	24	0	0
20	35210175	.	C	A	11	10	21	0	1	22	0	0
20	35210176	.	T	C	11	1	12	0	10	22	0	0
20	35210212	.	G	T	6	9	15	0	0	15	0	0
20	35210299	.	T	C	8	0	8	0	6	14	0	0
20	35210439	.	G	T	3	5	8	0	0	8	0	0
20	35210538	.	C	G	6	2	8	0	1	9	0	0
20	35210575	.	C	T	5	3	8	0	1	9	0	0
20	35210649	.	A	G	9	3	12	0	0	12	0	0
20	35210909	.	T	C	7	5	12	0	0	12	0	0
20	35211062	.	A	G	3	4	7	0	0	7	0	0
20	35211354	.	C	A	0	2	2	0	3	5	0	0
20	35211393	.	T	G	2	4	6	0	1	7	0	0
20	35211515	.	C	T	0	2	2	0	3	5	0	0
20	35211537	.	G	A	2	2	4	1	0	5	0	0
20	35211641	.	C	T	1	2	3	0	0	3	0	0
20	35212064	.	T	A	1	5	6	0	0	6	0	0
20	35212070	.	G	A	1	4	5	0	1	6	0	0
20	35212315	.	A	G	1	3	4	0	0	4	0	0
20	35212398	.	A	G	2	2	4	0	0	4	0	0
20	35212405	.	C	T	2	2	4	0	0	4	0	0
20	35212946	.	T	A	4	6	10	0	0	10	0	0
20	35215773	.	C	G	0	4	4	0	8	12	0	0
20	35215776	.	G	C	7	4	11	0	1	12	0	0
20	35226788	.	G	T	1	3	4	0	0	4	0	0
20	35226944	.	G	T	1	3	4	0	1	5	0	0
20	35227256	.	C	G	1	2	3	0	0	3	0	0
20	35295208	.	C	T	1	0	1	0	0	1	0	0
20	35297538	.	A	C	6	4	10	0	0	10	0	0
20	35297648	.	C	T	2	5	7	0	1	8	0	0
20	35297693	.	G	A	6	5	11	0	0	11	0	0
20	35297819	.	T	C	2	5	7	0	0	7	0	0
20	35297832	.	A	C	8	0	8	0	0	8	0	0
20	35297867	.	C	T	3	4	7	0	0	7	0	0
20	35297931	.	C	T	4	0	4	0	0	4	0	0
20	35297968	.	T	C	0	3	3	0	0	3	0	0
20	35428931	.	T	A	24	31	55	0	2	57	0	0
20	35429017	.	T	A	13	12	25	0	1	26	0	0
20	35429269	.	C	T	34	36	70	0	2	72	0	0
20	35429299	.	A	G	33	27	60	0	6	66	0	0
20	35429384	.	C	T	43	28	71	0	0	71	0	0
20	35429610	.	A	T	36	33	69	0	5	74	0	0
20	35433262	.	G	C	9	15	24	0	0	24	0	0
20	35433264	.	G	C	9	15	24	0	0	24	0	0
20	35437838	.	G	C	2	6	8	0	2	10	0	0
20	35464735	.	C	G	0	5	5	0	2	7	0	0
20	35464984	.	A	G	1	1	2	0	0	2	0	0
20	35798083	.	C	G	6	4	10	0	0	10	0	0
20	35798370	.	G	A	14	15	29	0	3	32	0	0
20	35798717	.	A	G	7	3	10	0	0	10	0	0
20	35798973	.	T	A	7	11	18	0	2	20	0	0
20	35800001	.	G	A	14	4	18	0	6	24	0	0
20	35800249	.	C	T	5	4	9	0	5	14	0	0
20	35800349	.	C	T	4	7	11	0	0	11	0	0
20	35800520	.	G	A	5	10	15	0	1	16	0	0
20	35800749	.	G	A	8	8	16	0	0	16	0	0
20	35816606	.	G	A	1	5	6	0	1	7	0	0
20	35816630	.	C	T	0	9	9	0	0	9	0	0
20	35827890	.	C	T	1	1	2	0	0	2	0	0
20	35827896	.	C	A	2	2	4	0	0	4	0	0
20	35827945	.	G	C	3	2	5	0	0	5	0	0
20	35831719	.	C	T	3	1	4	0	0	4	0	0
20	35832168	.	G	A	2	3	5	0	2	7	0	0
20	35941146	.	G	A	0	0	0	0	1	1	0	0
20	35963000	.	C	T	0	1	1	0	0	1	0	0
20	35979899	.	G	T	2	4	6	0	0	6	0	0
20	35979910	.	T	G	2	2	4	0	0	4	0	0
20	35980021	.	C	T	3	3	6	0	0	6	0	0
20	36069265	.	C	T	1	3	4	0	0	4	0	0
20	36107150	.	A	G	5	1	6	0	1	7	0	0
20	36234334	.	T	A	4	9	13	0	1	14	0	0
20	36290217	.	C	T	5	8	13	0	1	14	0	0
20	36297304	.	C	T	5	4	9	0	1	10	0	0
20	36297356	.	G	A	0	22	22	0	14	36	0	0
20	36297418	.	C	A	11	22	33	0	2	35	0	0
20	36297448	.	C	T	17	12	29	0	0	29	0	0
20	36297518	.	G	A	0	14	14	0	5	19	0	0
20	36297832	.	C	T	8	10	18	0	0	18	0	0
20	36380602	.	A	C	2	0	2	0	2	4	0	0
20	36395895	.	G	A	3	2	5	0	0	5	0	0
20	36396096	.	A	T	2	2	4	0	0	4	0	0
20	36396170	.	G	A	1	3	4	0	0	4	0	0
20	36396171	.	G	A	1	2	3	0	1	4	0	0
20	36396616	.	T	C	2	0	2	0	3	5	0	0
20	36399075	.	G	A	1	2	3	0	0	3	0	0
20	36402167	.	G	T	1	2	3	0	0	3	0	0
20	36402190	.	T	C	0	0	0	0	3	3	0	0
20	36420218	.	A	C	17	11	28	0	0	28	0	0
20	36420713	.	C	T	1	15	16	0	20	36	0	0
20	36420804	.	G	T	10	7	17	0	1	18	0	0
20	36420982	.	G	A	10	7	17	0	0	17	0	0
20	36421362	.	G	A	4	6	10	0	0	10	0	0
20	36421530	.	A	C	10	0	10	0	16	26	0	0
20	36421757	.	C	T	0	10	10	0	12	22	0	0
20	36422043	.	G	A	19	17	36	0	0	36	0	0
20	36422098	.	C	A	4	16	20	0	2	22	0	0
20	36422291	.	G	T	1	8	9	0	0	9	0	0
20	36437314	.	A	G	7	5	12	0	0	12	0	0
20	36440113	.	C	T	0	5	5	0	15	20	0	0
20	36449286	.	G	A	0	2	2	0	0	2	0	0
20	36449385	.	C	T	11	8	19	0	2	21	0	0
20	36449442	.	A	C	13	8	21	0	3	24	0	0
20	36449601	.	C	T	0	3	3	0	0	3	0	0
20	36626248	.	G	A	18	10	28	0	0	28	0	0
20	36626335	.	C	T	11	6	17	0	0	17	0	0
20	36629472	.	G	A	0	1	1	0	0	1	0	0
20	36633082	.	C	T	2	3	5	0	2	7	0	0
20	36637941	.	C	T	5	2	7	0	0	7	0	0
20	36637999	.	G	A	3	5	8	0	0	8	0	0
20	36638133	.	A	T	5	3	8	0	0	8	0	0
20	36638169	.	T	C	1	4	5	0	0	5	0	0
20	36646950	.	C	T	1	2	3	0	0	3	0	0
20	36648694	.	T	C	0	1	1	0	0	1	0	0
20	36677574	.	G	A	0	3	3	0	0	3	0	0
20	36769391	.	G	T	0	5	5	0	3	8	0	0
20	36773579	.	G	T	0	7	7	0	5	12	0	0
20	36773949	.	G	A	0	4	4	0	5	9	0	0
20	36777354	.	A	C	0	4	4	0	1	5	0	0
20	36783480	.	C	T	5	5	10	0	0	10	0	0
20	36785477	.	G	A	3	7	10	0	0	10	0	0
20	36788775	.	C	T	0	1	1	0	0	1	0	0
20	36798128	.	T	A	4	4	8	0	0	8	0	0
20	36798154	.	C	G	8	4	12	0	0	12	0	0
20	36799816	.	A	G	7	3	10	0	0	10	0	0
20	36799934	.	C	T	0	7	7	0	4	11	0	0
20	36816972	.	C	T	2	2	4	0	0	4	0	0
20	36817162	.	T	G	2	2	4	0	0	4	0	0
20	36817184	.	G	A	0	3	3	0	4	7	0	0
20	36828948	.	A	C	6	3	9	0	2	11	0	0
20	36829418	.	G	A	1	5	6	0	8	14	0	0
20	36829428	.	A	C	7	6	13	0	1	14	0	0
20	36838717	.	C	T	9	3	12	0	0	12	0	0
20	36838871	.	C	T	10	10	20	0	2	22	0	0
20	36838946	.	A	C	4	6	10	0	1	11	0	0
20	36915481	.	G	A	7	8	15	0	0	15	0	0
20	36915493	.	A	T	9	6	15	0	1	16	0	0
20	36915529	.	G	A	12	10	22	0	0	22	0	0
20	36915826	.	C	A	12	12	24	0	0	24	0	0
20	36916050	.	A	G	6	11	17	0	0	17	0	0
20	36916187	.	T	C	5	0	5	0	10	15	0	0
20	36916428	.	A	T	5	5	10	0	0	10	0	0
20	36916429	.	A	T	5	4	9	0	1	10	0	0
20	36917037	.	C	T	10	16	26	1	0	27	0	0
20	36917631	.	C	T	7	7	14	0	0	14	0	0
20	37300798	.	G	A	7	8	15	0	0	15	0	0
20	37300862	.	G	C	1	3	4	0	3	7	0	0
20	37332669	.	T	A	4	4	8	0	1	9	0	0
20	37376467	.	G	A	0	6	6	0	3	9	0	0
20	37533078	.	C	T	2	2	4	0	0	4	0	0
20	37533137	.	C	T	0	1	1	0	0	1	0	0
20	37735957	.	C	G	12	18	30	0	1	31	0	0
20	37735980	.	T	C	17	12	29	0	1	30	0	0
20	37736041	.	T	A	5	5	10	0	0	10	0	0
20	37736409	.	T	G	9	10	19	0	1	20	0	0
20	37751503	.	C	A	0	2	2	0	1	3	0	0
20	37761205	.	C	T	2	1	3	0	0	3	0	0
20	37768621	.	C	T	9	10	19	0	0	19	0	0
20	37768712	.	A	C	2	2	4	0	2	6	0	0
20	37768844	.	G	T	5	9	14	0	2	16	0	0
20	37768995	.	T	A	6	11	17	0	0	17	0	0
20	37768997	.	A	T	6	11	17	0	0	17	0	0
20	37769084	.	A	G	2	12	14	0	0	14	0	0
20	37769099	.	C	A	2	11	13	0	0	13	0	0
20	37796354	.	G	A	0	2	2	0	3	5	0	0
20	37796387	.	T	C	2	3	5	0	0	5	0	0
20	37796527	.	C	A	1	3	4	0	0	4	0	0
20	37798627	.	G	A	3	3	6	0	0	6	0	0
20	37799497	.	T	C	8	5	13	0	0	13	0	0
20	37799688	.	G	A	0	2	2	0	1	3	0	0
20	37826843	.	T	A	1	2	3	0	0	3	0	0
20	37844090	.	A	T	6	4	10	0	0	10	0	0
20	37844298	.	C	G	3	5	8	0	2	10	0	0
20	37845858	.	G	A	0	2	2	0	0	2	0	0
20	37852670	.	T	C	1	1	2	0	0	2	0	0
20	37866463	.	C	T	5	2	7	0	1	8	0	0
20	37899289	.	T	C	6	1	7	0	1	8	0	0
20	37912863	.	C	A	3	2	5	0	0	5	0	0
20	37913000	.	C	T	3	2	5	0	0	5	0	0
20	37913237	.	G	A	5	4	9	0	0	9	0	0
20	37913335	.	A	T	7	5	12	0	0	12	0	0
20	37913410	.	A	C	5	2	7	0	0	7	0	0
20	37913767	.	T	G	4	3	7	0	0	7	0	0
20	37913866	.	A	G	1	6	7	0	0	7	0	0
20	37914001	.	A	G	7	4	11	0	0	11	0	0
20	37914145	.	C	T	8	3	11	0	0	11	0	0
20	37914838	.	C	T	8	5	13	0	0	13	0	0
20	37914855	.	T	G	9	5	14	0	1	15	0	0
20	37915005	.	A	C	3	3	6	0	1	7	0	0
20	37915080	.	T	A	4	2	6	0	0	6	0	0
20	37915097	.	C	G	6	3	9	0	0	9	0	0
20	37915217	.	A	T	10	8	18	0	0	18	0	0
20	37915237	.	C	T	11	8	19	0	0	19	0	0
20	37915292	.	A	G	11	7	18	0	0	18	0	0
20	37915465	.	A	G	10	0	10	0	10	20	0	0
20	37915479	.	C	T	11	7	18	0	1	19	0	0
20	37915658	.	T	C	2	5	7	0	0	7	0	0
20	37915699	.	G	T	0	4	4	0	4	8	0	0
20	37915701	.	C	T	3	5	8	0	0	8	0	0
20	37916043	.	T	A	1	3	4	0	1	5	0	0
20	37916143	.	C	T	5	4	9	0	0	9	0	0
20	37916161	.	A	T	6	8	14	0	0	14	0	0
20	37920487	.	C	A	2	5	7	0	0	7	0	0
20	37920773	.	T	C	5	6	11	0	0	11	0	0
20	37920822	.	C	T	0	0	0	0	1	1	0	0
20	37924995	.	G	T	1	1	2	0	0	2	0	0
20	37930593	.	A	G	2	4	6	0	0	6	0	0
20	37930874	.	C	T	0	5	5	0	4	9	0	0
20	37934040	.	A	T	3	1	4	0	0	4	0	0
20	38032297	.	C	A	1	3	4	0	0	4	0	0
20	38032694	.	G	C	2	2	4	0	0	4	0	0
20	38104080	.	C	A	15	12	27	0	0	27	0	0
20	38201945	.	T	G	4	3	7	0	0	7	0	0
20	38202183	.	C	A	6	2	8	0	1	9	0	0
20	38241357	.	T	C	2	3	5	0	0	5	0	0
20	38241363	.	T	A	2	3	5	0	0	5	0	0
20	38241619	.	G	A	6	5	11	0	0	11	0	0
20	38241637	.	C	T	7	5	12	0	0	12	0	0
20	38241781	.	C	G	3	2	5	0	1	6	0	0
20	38358660	.	C	A	7	5	12	0	0	12	0	0
20	38473700	.	C	T	4	4	8	0	0	8	0	0
20	38473763	.	T	C	13	6	19	0	0	19	0	0
20	38517929	.	T	A	8	2	10	0	0	10	0	0
20	38517941	.	C	T	7	4	11	0	0	11	0	0
20	38518015	.	C	T	7	8	15	0	0	15	0	0
20	38518082	.	T	G	8	11	19	0	2	21	0	0
20	38518267	.	A	G	7	10	17	0	0	17	0	0
20	38518454	.	T	G	7	5	12	0	0	12	0	0
20	38538248	.	C	T	2	2	4	0	0	4	0	0
20	38584098	.	G	A	1	4	5	0	0	5	0	0
20	38657824	.	C	T	1	1	2	0	0	2	0	0
20	38657825	.	T	C	1	1	2	0	0	2	0	0
20	38669294	.	T	C	4	6	10	0	1	11	0	0
20	38669329	.	A	G	6	0	6	0	4	10	0	0
20	38669406	.	C	A	2	5	7	0	0	7	0	0
20	38669453	.	C	G	4	6	10	0	0	10	0	0
20	38669481	.	C	T	4	4	8	0	0	8	0	0
20	38669562	.	C	T	2	6	8	0	0	8	0	0
20	38669869	.	T	G	2	5	7	0	0	7	0	0
20	38669888	.	T	A	2	2	4	0	0	4	0	0
20	38670071	.	C	T	8	4	12	0	0	12	0	0
20	38670100	.	C	T	5	6	11	0	0	11	0	0
20	38670108	.	T	C	5	3	8	0	0	8	0	0
20	38670143	.	C	T	11	7	18	0	0	18	0	0
20	38670157	.	G	A	0	7	7	0	10	17	0	0
20	38726399	.	A	C	8	9	17	0	0	17	0	0
20	38726421	.	A	T	7	13	20	0	1	21	0	0
20	38726624	.	C	G	5	6	11	0	0	11	0	0
20	38764192	.	C	A	13	11	24	0	0	24	0	0
20	38764201	.	C	A	11	11	22	0	2	24	0	0
20	38764265	.	A	G	7	8	15	0	0	15	0	0
20	38764992	.	T	C	9	7	16	0	2	18	0	0
20	38765100	.	C	T	2	8	10	0	3	13	0	0
20	38765296	.	T	G	6	3	9	0	1	10	0	0
20	38765318	.	T	C	6	7	13	0	1	14	0	0
20	38765364	.	T	A	7	8	15	0	1	16	0	0
20	38765450	.	C	A	1	3	4	0	1	5	0	0
20	38765452	.	A	G	3	1	4	0	1	5	0	0
20	38765487	.	T	G	2	5	7	0	0	7	0	0
20	38765552	.	C	T	0	10	10	0	13	23	0	0
20	38778463	.	G	A	1	0	1	0	0	1	0	0
20	39256874	.	A	G	4	0	4	0	3	7	0	0
20	39257354	.	A	C	1	4	5	0	1	6	0	0
20	39579329	.	A	G	3	2	5	0	0	5	0	0
20	39596154	.	A	T	1	2	3	0	0	3	0	0
20	39689513	.	T	C	5	4	9	0	0	9	0	0
20	39806373	.	C	T	0	2	2	0	1	3	0	0
20	39806592	.	T	C	1	2	3	0	0	3	0	0
20	39807080	.	G	A	2	6	8	0	0	8	0	0
20	40119306	.	C	T	0	2	2	0	3	5	0	0
20	40119353	.	A	T	3	3	6	0	0	6	0	0
20	40269926	.	T	C	6	0	6	0	12	18	0	0
20	40319575	.	A	C	6	8	14	0	0	14	0	0
20	40319649	.	C	G	4	2	6	0	2	8	0	0
20	40369829	.	G	C	0	1	1	0	0	1	0	0
20	40372729	.	G	A	19	13	32	0	0	32	0	0
20	40372760	.	T	A	13	18	31	0	1	32	0	0
20	40372811	.	A	G	13	22	35	0	2	37	0	0
20	40457669	.	G	C	13	5	18	0	0	18	0	0
20	40461550	.	G	A	25	13	38	0	1	39	0	0
20	40464613	.	C	G	3	2	5	0	0	5	0	0
20	40466540	.	C	T	15	9	24	0	0	24	0	0
20	40466662	.	C	T	12	5	17	0	2	19	0	0
20	40467044	.	C	T	19	17	36	0	0	36	0	0
20	40471756	.	A	T	35	37	72	0	4	76	0	0
20	40471844	.	C	T	24	21	45	0	6	51	0	0
20	40471886	.	T	A	14	12	26	0	2	28	0	0
20	40472009	.	T	A	34	23	57	0	1	58	0	0
20	40472075	.	C	A	37	23	60	0	3	63	0	0
20	40472175	.	G	C	30	31	61	0	1	62	0	0
20	40475815	.	C	T	5	5	10	0	0	10	0	0
20	40475872	.	G	A	5	7	12	0	1	13	0	0
20	40476094	.	G	A	10	5	15	0	0	15	0	0
20	40476165	.	C	T	18	18	36	0	0	36	0	0
20	40476214	.	A	T	20	12	32	0	4	36	0	0
20	40478289	.	A	C	0	3	3	0	0	3	0	0
20	40480227	.	G	T	9	8	17	0	1	18	0	0
20	40480250	.	C	T	9	9	18	0	0	18	0	0
20	40485077	.	T	G	0	1	1	0	0	1	0	0
20	40715260	.	A	G	21	21	42	0	2	44	0	0
20	40716899	.	G	A	22	13	35	0	1	36	0	0
20	40716911	.	A	G	15	20	35	0	1	36	0	0
20	40717271	.	G	T	2	6	8	0	3	11	0	0
20	40717418	.	G	A	2	2	4	0	0	4	0	0
20	40761808	.	G	A	1	1	2	0	0	2	0	0
20	40761826	.	C	T	1	1	2	0	0	2	0	0
20	40761915	.	A	G	1	3	4	0	0	4	0	0
20	40762073	.	A	G	1	2	3	0	0	3	0	0
20	40762361	.	T	C	0	6	6	0	0	6	0	0
20	40762505	.	G	T	1	2	3	0	0	3	0	0
20	40763990	.	T	C	3	2	5	0	0	5	0	0
20	40764004	.	G	A	3	2	5	0	0	5	0	0
20	40835131	.	A	G	2	6	8	0	0	8	0	0
20	40840802	.	G	A	3	7	10	0	0	10	0	0
20	40840963	.	A	C	3	4	7	0	0	7	0	0
20	41236764	.	G	A	0	3	3	0	8	11	0	0
20	41237731	.	G	A	1	2	3	3	0	6	0	0
20	41238104	.	C	T	3	4	7	0	0	7	0	0
20	41238839	.	T	C	3	3	6	0	0	6	0	0
20	41238925	.	G	A	1	3	4	0	0	4	0	0
20	41239038	.	T	C	3	2	5	0	0	5	0	0
20	41239396	.	T	A	5	6	11	0	1	12	0	0
20	41239399	.	A	G	5	6	11	0	0	11	0	0
20	41239439	.	T	C	7	8	15	0	2	17	0	0
20	41239461	.	C	T	7	10	17	0	0	17	0	0
20	41239604	.	C	T	5	6	11	0	0	11	0	0
20	41239624	.	G	A	9	6	15	0	0	15	0	0
20	41239753	.	G	T	0	8	8	0	6	14	0	0
20	41239760	.	G	A	0	8	8	0	7	15	0	0
20	41239838	.	A	G	1	6	7	0	0	7	0	0
20	41239899	.	G	T	3	2	5	0	0	5	0	0
20	41239946	.	A	G	2	2	4	0	0	4	0	0
20	41239977	.	T	C	2	2	4	0	0	4	0	0
20	41240107	.	G	C	2	2	4	0	0	4	0	0
20	41240108	.	A	G	2	0	2	0	2	4	0	0
20	41240148	.	A	G	4	0	4	0	4	8	0	0
20	41240176	.	C	T	4	0	4	0	0	6	2	0
20	41240480	.	A	G	6	0	6	0	9	15	0	0
20	41240512	.	A	C	7	12	19	0	0	19	0	0
20	41240643	.	G	A	0	2	2	0	6	8	0	0
20	41240736	.	T	C	3	5	8	0	0	8	0	0
20	41240958	.	A	G	9	10	19	0	2	21	0	0
20	41240986	.	A	G	13	0	13	0	12	25	0	0
20	41241316	.	G	C	5	2	7	0	0	7	0	0
20	41241350	.	C	A	10	5	15	0	0	15	0	0
20	41241355	.	C	T	9	6	15	0	1	16	0	0
20	41242045	.	G	A	0	15	15	0	10	25	0	0
20	41640701	.	A	C	2	3	5	0	0	5	0	0
20	41640743	.	G	A	5	7	12	0	2	14	0	0
20	41640878	.	T	G	2	8	10	0	2	12	0	0
20	41641019	.	A	T	9	4	13	0	1	14	0	0
20	41643457	.	C	T	10	10	20	0	2	22	0	0
20	41651639	.	C	T	11	3	14	0	0	14	0	0
20	41655513	.	G	A	0	11	11	0	4	15	0	0
20	41674544	.	C	T	1	1	2	1	2	5	0	0
20	41689967	.	A	G	6	11	17	0	1	18	0	0
20	41689979	.	C	T	7	6	13	0	1	14	0	0
20	41734344	.	C	T	6	10	16	0	1	17	0	0
20	41757835	.	A	G	7	14	21	0	0	21	0	0
20	41765105	.	T	C	5	10	15	0	1	16	0	0
20	41859385	.	C	T	2	3	5	0	0	5	0	0
20	41946745	.	A	G	1	1	2	0	0	2	0	0
20	41949354	.	G	T	0	1	1	0	1	2	0	0
20	41949355	.	C	T	1	1	2	0	0	2	0	0
20	41949408	.	G	A	4	4	8	0	0	8	0	0
20	41949432	.	C	T	3	2	5	0	0	5	0	0
20	41960702	.	G	A	0	2	2	0	2	4	0	0
20	41960723	.	G	A	1	2	3	0	0	3	0	0
20	41961043	.	G	A	2	2	4	0	0	4	0	0
20	41961113	.	C	T	3	3	6	0	0	6	0	0
20	41961779	.	C	T	3	2	5	0	2	7	0	0
20	41961880	.	G	A	3	1	4	0	0	4	0	0
20	41961909	.	A	T	6	2	8	0	0	8	0	0
20	41962523	.	A	G	2	0	2	0	3	5	0	0
20	41962605	.	C	T	1	2	3	0	1	4	0	0
20	41962677	.	C	G	2	0	2	0	6	8	0	0
20	41962872	.	A	G	4	3	7	0	0	7	0	0
20	41962923	.	A	T	1	5	6	0	0	6	0	0
20	41963188	.	G	A	2	3	5	0	1	6	0	0
20	41963398	.	T	G	5	7	12	0	1	13	0	0
20	41963451	.	G	A	1	6	7	0	7	14	0	0
20	41963530	.	A	G	6	6	12	0	0	12	0	0
20	41963652	.	C	T	2	5	7	0	0	7	0	0
20	41963660	.	C	T	3	3	6	0	0	6	0	0
20	41998507	.	T	C	18	7	25	0	2	27	0	0
20	41998601	.	C	G	14	11	25	0	0	25	0	0
20	41999025	.	C	A	15	10	25	0	0	25	0	0
20	41999046	.	G	A	14	9	23	0	2	25	0	0
20	41999106	.	A	G	12	9	21	0	1	22	0	0
20	42047386	.	C	T	1	0	1	0	0	1	0	0
20	42049122	.	G	A	1	2	3	0	0	3	0	0
20	42049131	.	G	A	1	1	2	0	0	2	0	0
20	42221269	.	T	C	4	5	9	0	1	10	0	0
20	42221438	.	C	A	6	5	11	0	1	12	0	0
20	42221439	.	A	T	5	6	11	0	1	12	0	0
20	42221710	.	C	T	6	13	19	0	5	24	0	0
20	42221901	.	G	A	5	2	7	0	0	7	0	0
20	42221916	.	A	T	3	2	5	0	0	5	0	0
20	42222113	.	A	G	2	3	5	0	0	5	0	0
20	42222480	.	C	T	5	4	9	0	0	9	0	0
20	42222546	.	A	T	4	6	10	0	1	11	0	0
20	42222549	.	A	T	4	6	10	0	0	10	0	0
20	42222770	.	T	C	3	8	11	0	0	11	0	0
20	42222823	.	T	A	4	7	11	0	0	11	0	0
20	42222824	.	A	T	4	7	11	0	0	11	0	0
20	42222883	.	T	C	2	5	7	0	0	7	0	0
20	42223467	.	G	T	2	3	5	0	0	5	0	0
20	42223480	.	A	T	1	5	6	0	0	6	0	0
20	42232554	.	A	G	2	1	3	0	0	3	0	0
20	42241224	.	T	G	4	3	7	0	0	7	0	0
20	42241254	.	A	T	4	2	6	0	0	6	0	0
20	42241367	.	C	T	0	5	5	0	2	7	0	0
20	42246990	.	C	T	5	4	9	0	0	9	0	0
20	42247018	.	G	C	4	4	8	0	1	9	0	0
20	42275414	.	C	T	5	9	14	0	0	14	0	0
20	42278043	.	C	T	6	6	12	0	0	12	0	0
20	42281068	.	C	T	6	3	9	0	1	10	0	0
20	42296674	.	C	T	3	2	5	0	0	5	0	0
20	42299681	.	A	G	0	2	2	0	0	2	0	0
20	42299687	.	C	A	0	2	2	0	0	2	0	0
20	43120256	.	T	G	6	2	8	0	1	9	0	0
20	43121501	.	T	C	5	0	5	0	3	8	0	0
20	45644152	.	G	C	8	0	8	0	1	9	0	0
20	45644163	.	G	T	8	1	9	0	0	9	0	0
20	46733096	.	C	T	2	3	5	0	1	6	0	0
20	46994543	.	A	G	1	3	4	0	0	4	0	0
20	48483921	.	C	G	4	4	8	0	0	8	0	0
20	48483989	.	A	T	3	3	6	0	0	6	0	0
20	48484411	.	A	C	4	0	4	0	5	9	0	0
20	48598493	.	C	T	0	1	1	0	0	1	0	0
20	48806088	.	A	G	1	2	3	0	1	4	0	0
20	48844050	.	T	C	3	0	3	0	4	7	0	0
20	48844134	.	A	G	3	5	8	0	0	8	0	0
20	48860755	.	G	A	2	1	3	0	0	3	0	0
20	48869895	.	G	A	3	2	5	0	0	5	0	0
20	48877311	.	G	T	1	0	1	0	0	1	0	0
20	48886005	.	C	T	2	1	3	0	0	3	0	0
20	48895103	.	G	A	3	2	5	0	0	5	0	0
20	49082581	.	C	T	2	4	6	0	0	6	0	0
20	49087720	.	A	G	2	0	2	0	2	4	0	0
20	49087762	.	G	A	0	3	3	0	2	5	0	0
20	49087768	.	G	A	3	3	6	0	0	6	0	0
20	49087816	.	G	T	1	1	2	0	1	3	0	0
20	49089237	.	C	T	4	3	7	0	0	7	0	0
20	49099900	.	A	G	3	4	7	0	0	7	0	0
20	49100237	.	C	T	4	7	11	0	1	12	0	0
20	49103131	.	G	A	12	9	21	0	2	23	0	0
20	49103164	.	G	A	8	8	16	0	0	16	0	0
20	49103217	.	A	T	6	5	11	0	0	11	0	0
20	49105469	.	A	T	2	4	6	0	0	6	0	0
20	49787832	.	A	G	1	0	1	0	4	5	0	0
20	49795322	.	G	A	0	1	1	0	0	1	0	0
20	49895249	.	T	A	1	3	4	0	0	4	0	0
20	49905163	.	C	T	1	3	4	0	0	4	0	0
20	49928358	.	A	T	3	4	7	0	0	7	0	0
20	49940969	.	G	T	9	6	15	0	1	16	0	0
20	49952738	.	A	G	13	4	17	0	0	17	0	0
20	49960011	.	A	G	2	2	4	0	0	4	0	0
20	49960314	.	A	G	7	3	10	0	1	11	0	0
20	49960328	.	A	G	6	4	10	0	1	11	0	0
20	49961268	.	G	T	3	3	6	0	1	7	0	0
20	50041707	.	A	G	1	3	4	0	0	4	0	0
20	50049036	.	G	C	29	0	29	0	22	51	0	0
20	50049078	.	C	A	14	7	21	0	1	22	0	0
20	50074077	.	C	T	2	2	4	0	0	4	0	0
20	50074173	.	C	T	3	4	7	0	0	7	0	0
20	50074212	.	C	T	3	2	5	0	0	5	0	0
20	50076480	.	G	A	0	3	3	0	1	4	0	0
20	50079067	.	T	C	2	5	7	0	0	7	0	0
20	50079070	.	A	G	2	5	7	0	0	7	0	0
20	50079154	.	T	C	0	2	2	0	0	2	0	0
20	50082425	.	A	G	3	7	10	0	1	11	0	0
20	50082861	.	T	C	4	3	7	0	0	7	0	0
20	50085935	.	T	A	3	1	4	0	2	6	0	0
20	50238663	.	A	G	2	2	4	0	0	4	0	0
20	50650253	.	G	A	1	4	5	0	2	7	0	0
20	50725479	.	G	A	1	2	3	0	2	5	0	0
20	50740230	.	G	T	0	3	3	0	9	12	0	0
20	50898883	.	T	C	1	1	2	0	0	2	0	0
20	50917646	.	T	C	0	2	2	0	0	2	0	0
20	50923848	.	G	A	12	7	19	0	1	20	0	0
20	50926695	.	G	A	0	2	2	0	10	12	0	0
20	50989199	.	A	G	4	2	6	0	8	14	0	0
20	50999024	.	C	G	27	18	45	0	2	47	0	0
20	50999297	.	C	A	5	7	12	0	0	12	0	0
20	51069864	.	A	G	8	0	8	0	3	11	0	0
20	51069996	.	T	C	6	8	14	0	0	14	0	0
20	51073369	.	A	T	10	4	14	0	0	14	0	0
20	51073449	.	G	A	1	10	11	0	13	24	0	0
20	51073670	.	A	T	2	2	4	0	2	6	0	0
20	51073692	.	G	A	9	5	14	0	0	14	0	0
20	51073730	.	G	A	9	13	22	0	1	23	0	0
20	51074291	.	A	G	4	0	4	0	4	8	0	0
20	51074317	.	C	T	5	5	10	0	0	10	0	0
20	51074352	.	A	T	7	4	11	0	0	11	0	0
20	51088802	.	A	T	24	28	52	0	2	54	0	0
20	51089236	.	T	C	15	0	15	0	26	41	0	0
20	51089243	.	T	C	14	24	38	0	2	40	0	0
20	51089765	.	T	C	4	24	28	1	0	29	0	0
20	51100498	.	T	C	8	12	20	0	0	20	0	0
20	51100562	.	A	G	23	12	35	0	4	39	0	0
20	51112184	.	C	T	3	5	8	0	0	8	0	0
20	51112208	.	C	T	9	6	15	0	1	16	0	0
20	51117661	.	A	C	9	8	17	0	0	17	0	0
20	51117664	.	G	A	8	8	16	0	1	17	0	0
20	51118227	.	A	G	3	0	3	0	11	14	0	0
20	51118281	.	C	A	21	28	49	0	1	50	0	0
20	51118314	.	T	C	14	13	27	0	1	28	0	0
20	51122939	.	C	T	12	16	28	0	2	30	0	0
20	51123088	.	C	T	7	16	23	0	0	23	0	0
20	51123109	.	G	C	12	9	21	0	0	21	0	0
20	51132127	.	C	G	7	3	10	0	2	12	0	0
20	51132284	.	A	G	20	15	35	0	3	38	0	0
20	51141284	.	C	T	0	7	7	0	11	18	0	0
20	51146152	.	T	G	9	5	14	0	1	15	0	0
20	51146153	.	G	A	5	10	15	0	0	15	0	0
20	51146194	.	A	G	4	3	7	0	0	7	0	0
20	51150029	.	G	T	8	7	15	0	2	17	0	0
20	51151647	.	G	A	1	0	1	0	0	1	0	0
20	51157061	.	C	T	1	17	18	0	5	23	0	0
20	51157082	.	T	C	9	15	24	0	1	25	0	0
20	51157109	.	C	T	18	10	28	0	2	30	0	0
20	51157204	.	G	A	7	6	13	0	1	14	0	0
20	51168502	.	T	C	7	5	12	0	0	12	0	0
20	51200015	.	C	T	22	27	49	0	4	53	0	0
20	51204759	.	C	T	9	24	33	0	5	38	0	0
20	51205691	.	T	G	9	12	21	0	0	21	0	0
20	51205745	.	G	A	35	45	80	0	2	82	0	0
20	51206976	.	C	A	38	33	71	0	4	75	0	0
20	51207030	.	C	T	36	29	65	0	2	67	0	0
20	51207051	.	G	A	36	29	65	0	6	71	0	0
20	51207609	.	C	A	3	4	7	0	0	7	0	0
20	51207672	.	C	T	39	29	68	0	3	71	0	0
20	51207726	.	C	T	42	33	75	0	3	78	0	0
20	51211455	.	G	A	10	39	49	0	36	85	0	0
20	51240121	.	C	G	0	3	3	0	1	4	0	0
20	51240130	.	T	G	1	1	2	0	0	2	0	0
20	51274609	.	C	T	0	4	4	0	3	7	0	0
20	51274618	.	G	T	5	3	8	0	0	8	0	0
20	51274693	.	C	T	1	2	3	0	0	3	0	0
20	51276342	.	G	A	2	4	6	0	0	6	0	0
20	51313049	.	C	T	2	7	9	0	0	9	0	0
20	51332239	.	C	T	1	2	3	0	0	3	0	0
20	51332296	.	A	G	3	5	8	0	0	8	0	0
20	51332317	.	A	G	2	0	2	0	4	6	0	0
20	51332338	.	G	A	0	2	2	0	5	7	0	0
20	51332530	.	C	T	2	2	4	0	1	5	0	0
20	51332587	.	A	T	0	3	3	0	0	3	0	0
20	51333118	.	A	T	1	3	4	0	0	4	0	0
20	51333410	.	T	C	1	4	5	0	0	5	0	0
20	51333547	.	G	A	2	2	4	0	0	4	0	0
20	51334081	.	G	A	3	5	8	0	0	8	0	0
20	51334173	.	G	T	3	2	5	0	0	5	0	0
20	51334193	.	G	T	1	2	3	0	0	3	0	0
20	51334434	.	G	A	2	1	3	0	0	3	0	0
20	51363902	.	C	T	0	2	2	0	8	10	0	0
20	51363926	.	A	T	5	3	8	0	0	8	0	0
20	51370329	.	C	T	11	14	25	0	2	27	0	0
20	51377075	.	C	T	2	3	5	0	0	5	0	0
20	51383472	.	G	A	3	1	4	0	0	4	0	0
20	51383706	.	C	T	0	10	10	0	4	14	0	0
20	51383804	.	C	G	7	6	13	0	0	13	0	0
20	51384072	.	C	T	0	1	1	0	0	1	0	0
20	51475569	.	T	C	1	2	3	0	0	3	0	0
20	51489438	.	T	C	2	0	2	0	2	4	0	0
20	51489705	.	A	G	1	3	4	0	0	4	0	0
20	51647988	.	A	T	5	3	8	0	1	9	0	0
20	51648117	.	T	C	3	3	6	0	0	6	0	0
20	51649070	.	A	C	2	2	4	0	0	4	0	0
20	51649521	.	A	C	2	2	4	0	0	4	0	0
20	51649533	.	A	G	2	2	4	0	0	4	0	0
20	51649830	.	C	A	0	4	4	0	3	7	0	0
20	51649884	.	C	G	0	4	4	0	1	5	0	0
20	51649887	.	A	G	1	4	5	0	0	5	0	0
20	51649935	.	G	A	1	4	5	0	0	5	0	0
20	51703406	.	T	C	6	6	12	0	0	12	0	0
20	51703445	.	C	T	0	1	1	0	1	2	0	0
20	51703939	.	G	A	15	10	25	0	0	25	0	0
20	51704001	.	C	T	4	0	4	0	0	4	0	0
20	51720465	.	A	G	2	1	3	0	0	3	0	0
20	51721612	.	A	G	2	0	2	0	0	2	0	0
20	51723187	.	G	T	2	0	2	0	0	2	0	0
20	51730662	.	T	G	2	2	4	0	0	4	0	0
20	51743891	.	T	C	1	1	2	0	0	2	0	0
20	51753384	.	A	T	9	6	15	0	0	15	0	0
20	51753509	.	G	A	0	4	4	0	11	15	0	0
20	51753562	.	C	T	4	5	9	0	1	10	0	0
20	51753617	.	C	G	5	2	7	0	0	7	0	0
20	51753655	.	C	A	1	3	4	0	2	6	0	0
20	51753657	.	T	C	2	4	6	0	0	6	0	0
20	51758602	.	A	C	10	7	17	0	0	17	0	0
20	51758975	.	A	G	7	11	18	0	1	19	0	0
20	51759191	.	A	C	9	7	16	0	1	17	0	0
20	51759272	.	G	A	8	7	15	0	1	16	0	0
20	51759273	.	T	A	9	7	16	0	0	16	0	0
20	51787380	.	A	G	1	0	1	0	0	1	0	0
20	51794071	.	A	G	1	0	1	0	0	1	0	0
20	51798112	.	T	C	3	4	7	0	0	7	0	0
20	51799052	.	G	A	1	1	2	0	0	2	0	0
20	51803856	.	G	T	3	3	6	0	0	6	0	0
20	51807449	.	C	T	1	3	4	0	1	5	0	0
20	51810872	.	T	C	2	0	2	0	2	4	0	0
20	51810878	.	C	T	0	2	2	0	2	4	0	0
20	51819309	.	C	G	0	1	1	0	0	1	0	0
20	51821380	.	T	C	3	2	5	0	0	5	0	0
20	51822624	.	C	A	0	2	2	0	0	2	0	0
20	51873991	.	C	A	1	1	2	0	0	2	0	0
20	52333008	.	C	T	3	6	9	0	0	9	0	0
20	52333009	.	A	T	3	6	9	0	0	9	0	0
20	52333344	.	A	G	5	5	10	0	1	11	0	0
20	52333388	.	A	G	6	7	13	0	0	13	0	0
20	52390235	.	C	G	4	0	4	0	3	7	0	0
20	52404347	.	G	A	3	2	5	0	0	5	0	0
20	52404387	.	T	A	1	2	3	0	1	4	0	0
20	52404398	.	T	C	1	3	4	0	0	4	0	0
20	52404554	.	A	G	3	0	3	0	4	7	0	0
20	52404578	.	C	T	5	3	8	0	0	8	0	0
20	52404722	.	T	C	4	3	7	0	0	7	0	0
20	52404935	.	T	A	2	4	6	0	0	6	0	0
20	52415876	.	T	C	1	4	5	0	1	6	0	0
20	52415935	.	C	G	1	4	5	0	0	5	0	0
20	52416020	.	C	A	2	6	8	0	0	8	0	0
20	52416080	.	C	T	3	6	9	0	1	10	0	0
20	52416107	.	C	T	3	3	6	0	1	7	0	0
20	52420015	.	T	G	3	0	3	0	11	14	0	0
20	52458788	.	C	G	2	5	7	0	0	7	0	0
20	52458831	.	A	T	3	6	9	0	0	9	0	0
20	52458987	.	G	T	0	3	3	0	1	4	0	0
20	52473266	.	C	T	0	6	6	0	0	6	0	0
20	52482128	.	T	C	1	0	1	0	0	1	0	0
20	52482448	.	G	A	2	4	6	0	0	6	0	0
20	52482484	.	T	C	1	3	4	0	0	4	0	0
20	52488094	.	A	C	1	3	4	0	0	4	0	0
20	52488106	.	G	A	1	3	4	0	0	4	0	0
20	52488134	.	G	T	1	2	3	0	0	3	0	0
20	52488226	.	A	T	1	3	4	0	0	5	1	0
20	52540601	.	G	A	0	2	2	0	3	5	0	0
20	52540757	.	A	G	5	2	7	0	0	7	0	0
20	52541055	.	A	G	2	0	2	0	5	7	0	0
20	52541074	.	A	G	4	2	6	0	0	6	0	0
20	52544491	.	A	C	2	7	9	0	1	10	0	0
20	52544559	.	T	C	9	5	14	0	1	15	0	0
20	52554222	.	G	A	21	20	41	0	0	41	0	0
20	52554283	.	C	T	18	17	35	0	2	37	0	0
20	52574813	.	G	A	1	15	16	0	18	34	0	0
20	52574900	.	G	A	0	29	29	0	21	50	0	0
20	52575020	.	A	G	17	2	19	0	26	45	0	0
20	52575377	.	T	C	12	14	26	0	1	27	0	0
20	52582594	.	A	T	3	5	8	0	1	9	0	0
20	53279543	.	C	T	2	2	4	0	0	4	0	0
20	53312604	.	G	T	12	8	20	0	5	25	0	0
20	53318814	.	G	T	7	4	11	0	0	11	0	0
20	53318884	.	C	T	0	0	0	0	2	2	0	0
20	53365862	.	C	T	5	2	7	0	0	7	0	0
20	53366073	.	A	C	3	2	5	0	0	5	0	0
20	53377661	.	A	G	1	0	1	0	3	4	0	0
20	53377691	.	G	A	1	3	4	0	0	4	0	0
20	53378919	.	T	G	2	0	2	0	1	3	0	0
20	53393594	.	T	C	0	2	2	0	0	2	0	0
20	53393669	.	C	A	3	6	9	0	0	9	0	0
20	53398784	.	T	A	7	6	13	0	2	15	0	0
20	53401771	.	T	C	10	4	14	0	3	17	0	0
20	53401778	.	A	G	10	5	15	0	1	16	0	0
20	53408532	.	G	A	2	2	4	0	0	4	0	0
20	53601067	.	C	T	3	2	5	0	0	5	0	0
20	53601260	.	A	G	1	2	3	0	1	4	0	0
20	53632621	.	C	T	0	2	2	0	1	3	0	0
20	53639152	.	C	T	2	2	4	0	0	4	0	0
20	53639358	.	C	T	0	2	2	0	1	3	0	0
20	53639391	.	C	G	1	2	3	0	0	3	0	0
20	53639876	.	T	C	1	2	3	0	0	3	0	0
20	53639964	.	A	G	1	4	5	0	0	5	0	0
20	53803637	.	C	T	6	7	13	0	1	14	0	0
20	53803783	.	T	A	12	7	19	0	0	19	0	0
20	53804342	.	A	G	14	5	19	0	0	19	0	0
20	53804439	.	A	G	5	5	10	0	0	10	0	0
20	53804470	.	G	A	12	5	17	0	0	17	0	0
20	53804618	.	G	C	5	6	11	0	1	12	0	0
20	53810197	.	A	T	16	8	24	0	1	25	0	0
20	53898735	.	T	A	12	13	25	0	0	25	0	0
20	53898770	.	C	T	0	16	16	0	14	30	0	0
20	53898930	.	G	A	2	14	16	0	0	16	0	0
20	53899023	.	G	C	8	25	33	0	1	34	0	0
20	53899035	.	G	A	9	20	29	0	3	32	0	0
20	53900860	.	C	T	1	5	6	0	0	6	0	0
20	53901183	.	A	G	6	3	9	0	0	9	0	0
20	53902151	.	G	A	5	4	9	0	0	9	0	0
20	53902155	.	G	C	3	4	7	0	2	9	0	0
20	53912151	.	T	C	4	0	4	0	7	11	0	0
20	53912208	.	C	T	0	2	2	0	4	6	0	0
20	53921147	.	T	C	2	0	2	0	0	2	0	0
20	53928363	.	T	C	3	0	3	0	1	4	0	0
20	53930457	.	G	A	0	5	5	0	0	5	0	0
20	53930466	.	C	T	0	3	3	0	1	4	0	0
20	53968105	.	A	G	36	20	56	0	1	57	0	0
20	54050873	.	A	G	2	6	8	0	0	8	0	0
20	54050877	.	T	A	3	6	9	0	0	9	0	0
20	54050957	.	C	G	5	0	5	0	0	5	0	0
20	54051096	.	T	G	4	0	4	0	3	7	0	0
20	54067639	.	G	A	4	10	14	0	1	15	0	0
20	54067714	.	A	G	9	10	19	0	1	20	0	0
20	54175443	.	C	T	1	3	4	0	0	4	0	0
20	54180851	.	C	T	3	3	6	0	0	6	0	0
20	54197221	.	A	C	12	0	12	0	22	34	0	0
20	54197287	.	A	T	19	18	37	0	1	38	0	0
20	54197383	.	G	A	18	12	30	0	0	30	0	0
20	54197473	.	A	G	11	11	22	0	0	22	0	0
20	54197485	.	C	T	0	8	8	0	13	21	0	0
20	54197751	.	A	G	10	9	19	0	2	21	0	0
20	54197752	.	G	A	10	9	19	0	2	21	0	0
20	54205704	.	C	T	8	9	17	0	0	17	0	0
20	54215073	.	C	A	3	7	10	0	1	11	0	0
20	54215081	.	T	C	3	1	4	0	7	11	0	0
20	54215133	.	A	C	10	8	18	0	2	20	0	0
20	54219286	.	T	C	1	0	1	0	1	2	0	0
20	54228003	.	A	T	13	19	32	0	1	33	0	0
20	54235969	.	G	A	7	8	15	0	0	15	0	0
20	54236421	.	A	C	0	2	2	0	0	2	0	0
20	54236423	.	G	A	0	2	2	0	0	2	0	0
20	54249577	.	G	C	6	6	12	0	0	12	0	0
20	54251406	.	T	C	3	9	12	0	1	13	0	0
20	54274561	.	G	A	8	10	18	0	0	18	0	0
20	54277241	.	A	C	2	0	2	0	0	2	0	0
20	54278129	.	T	A	1	1	2	0	0	2	0	0
20	54283833	.	T	C	0	2	2	0	0	2	0	0
20	54284869	.	A	G	7	0	7	0	4	11	0	0
20	54284986	.	A	G	12	16	28	0	3	31	0	0
20	54285758	.	T	C	10	30	40	0	1	41	0	0
20	54285853	.	A	T	24	12	36	0	2	38	0	0
20	54286016	.	G	A	17	14	31	1	0	32	0	0
20	54286097	.	A	T	25	7	32	0	0	32	0	0
20	54286154	.	A	G	12	3	15	0	3	18	0	0
20	54286454	.	C	A	13	10	23	0	0	23	0	0
20	54286666	.	C	T	17	15	32	0	3	35	0	0
20	54286682	.	G	A	17	12	29	0	3	32	0	0
20	54286715	.	A	G	16	1	17	0	14	31	0	0
20	54286726	.	A	T	14	15	29	0	0	29	0	0
20	54286797	.	G	T	10	8	18	0	1	19	0	0
20	54286798	.	A	G	10	9	19	0	0	19	0	0
20	54286858	.	C	A	2	3	5	0	1	6	0	0
20	54334478	.	C	T	7	2	9	0	0	9	0	0
20	54340285	.	C	T	7	9	16	0	0	16	0	0
20	54340524	.	T	A	2	2	4	0	0	4	0	0
20	54340700	.	T	C	3	4	7	0	0	7	0	0
20	54340865	.	C	T	4	2	6	0	0	6	0	0
20	54341082	.	A	C	5	9	14	0	0	14	0	0
20	54341108	.	G	T	0	10	10	0	4	14	0	0
20	54341130	.	C	T	5	7	12	0	0	12	0	0
20	54341154	.	A	G	2	7	9	0	0	9	0	0
20	54341203	.	T	A	2	5	7	0	0	7	0	0
20	54342051	.	T	G	5	3	8	0	0	8	0	0
20	54342530	.	G	T	1	0	1	0	0	1	0	0
20	54342589	.	A	T	4	5	9	1	2	12	0	0
20	54342674	.	T	C	5	2	7	0	0	7	0	0
20	54343566	.	G	C	0	9	9	0	10	19	0	0
20	54343639	.	C	A	3	1	4	0	0	4	0	0
20	54343682	.	T	C	2	3	5	0	0	5	0	0
20	54343695	.	A	T	4	3	7	0	1	8	0	0
20	54343866	.	G	A	7	3	10	0	0	10	0	0
20	54343928	.	A	G	6	4	10	0	0	10	0	0
20	54344711	.	A	G	6	0	6	0	9	15	0	0
20	54344748	.	T	C	8	9	17	0	2	19	0	0
20	54344795	.	G	A	9	8	17	0	2	19	0	0
20	54344815	.	G	T	8	8	16	0	1	17	0	0
20	54344910	.	C	T	10	3	13	0	0	13	0	0
20	54345808	.	T	C	5	7	12	0	0	12	0	0
20	54345955	.	A	T	12	5	17	0	1	18	0	0
20	54345979	.	A	G	16	5	21	0	3	24	0	0
20	54346012	.	G	C	0	5	5	0	17	25	3	0
20	54346124	.	A	T	5	7	12	0	0	12	0	0
20	54346159	.	G	T	0	14	14	0	9	23	0	0
20	54346178	.	G	T	11	15	26	0	1	27	0	0
20	54346239	.	A	G	11	8	19	0	1	20	0	0
20	54354874	.	A	T	0	2	2	0	0	2	0	0
20	54356452	.	G	C	13	4	17	0	1	18	0	0
20	54357955	.	C	T	3	2	5	0	1	6	0	0
20	54358656	.	T	C	1	6	7	0	0	7	0	0
20	54360143	.	G	A	4	4	8	0	0	8	0	0
20	54360148	.	G	T	0	3	3	0	4	7	0	0
20	54397812	.	T	C	4	8	12	0	1	13	0	0
20	54397846	.	A	G	5	1	6	0	11	17	0	0
20	54397897	.	G	C	8	5	13	0	1	14	0	0
20	54398242	.	C	T	10	12	22	0	0	22	0	0
20	54398380	.	T	A	6	6	12	0	1	13	0	0
20	54398443	.	A	G	4	9	13	0	0	13	0	0
20	54402157	.	G	T	0	14	14	0	9	23	0	0
20	54402346	.	G	A	10	17	27	0	1	28	0	0
20	54402489	.	G	A	15	16	31	0	0	31	0	0
20	54406699	.	A	T	9	14	23	0	0	23	0	0
20	54406813	.	A	G	7	13	20	0	1	21	0	0
20	54407401	.	G	C	13	22	35	0	2	37	0	0
20	54407456	.	T	C	17	10	27	0	1	28	0	0
20	54407556	.	C	T	12	8	20	0	0	20	0	0
20	54422636	.	G	A	20	17	37	0	0	37	0	0
20	54422780	.	C	G	10	10	20	0	1	21	0	0
20	54422909	.	C	T	12	12	24	0	1	25	0	0
20	54422929	.	G	A	12	11	23	0	3	26	0	0
20	54423005	.	T	C	9	6	15	0	1	16	0	0
20	54423027	.	C	G	4	12	16	0	1	17	0	0
20	54428696	.	A	G	1	0	1	0	0	1	0	0
20	54432835	.	T	C	11	0	11	0	10	21	0	0
20	54432855	.	T	C	10	0	10	0	6	16	0	0
20	54434895	.	G	A	12	21	33	0	2	35	0	0
20	54434918	.	C	T	14	17	31	0	3	34	0	0
20	54446877	.	G	A	8	10	18	0	0	18	0	0
20	54462151	.	G	C	9	6	15	0	1	16	0	0
20	54525439	.	T	C	3	3	6	0	0	6	0	0
20	54563425	.	A	G	8	11	19	0	1	20	0	0
20	54670904	.	C	G	1	0	1	0	4	5	0	0
20	54670966	.	A	G	2	6	8	0	1	9	0	0
20	54670984	.	T	A	4	5	9	0	0	9	0	0
20	54671864	.	T	G	4	6	10	0	0	10	0	0
20	54671894	.	A	C	3	4	7	0	3	10	0	0
20	54672009	.	A	C	0	1	1	0	0	1	0	0
20	54672839	.	A	G	5	0	5	0	6	11	0	0
20	54672869	.	T	C	6	9	15	0	0	15	0	0
20	54672891	.	T	C	5	8	13	0	0	13	0	0
20	54675294	.	T	C	4	10	14	0	0	14	0	0
20	54675308	.	C	G	5	0	5	0	9	14	0	0
20	54675356	.	C	T	8	7	15	0	2	17	0	0
20	54676529	.	A	G	0	0	0	0	8	8	0	0
20	54676532	.	T	G	0	9	9	0	0	9	0	0
20	54681734	.	G	A	8	8	16	0	2	18	0	0
20	54681797	.	T	A	8	7	15	0	2	17	0	0
20	54681944	.	A	T	11	3	14	0	0	14	0	0
20	54698791	.	C	T	8	9	17	0	0	17	0	0
20	54699133	.	C	T	9	4	13	0	1	14	0	0
20	54708193	.	T	C	6	4	10	0	1	11	0	0
20	54708277	.	G	A	1	7	8	0	9	17	0	0
20	54711535	.	G	C	4	3	7	0	1	8	0	0
20	54738249	.	C	G	7	4	11	0	0	11	0	0
20	54740904	.	G	A	8	20	28	0	0	28	0	0
20	54740907	.	A	G	6	1	7	0	21	28	0	0
20	54740955	.	C	T	9	14	23	0	2	25	0	0
20	54740976	.	G	T	1	14	15	0	12	27	0	0
20	54741763	.	G	A	6	7	13	0	1	14	0	0
20	54742641	.	C	G	9	8	17	0	1	18	0	0
20	54742714	.	C	T	6	8	14	0	2	16	0	0
20	54742912	.	A	C	7	9	16	0	2	18	0	0
20	54743917	.	G	A	19	9	28	0	5	33	0	0
20	54743937	.	C	T	16	7	23	0	1	24	0	0
20	54743981	.	A	G	8	0	8	0	6	14	0	0
20	54744230	.	C	T	13	16	29	0	4	33	0	0
20	54744314	.	A	G	13	0	13	0	27	40	0	0
20	54744363	.	A	G	14	0	14	0	20	34	0	0
20	54744419	.	A	G	15	18	33	0	1	34	0	0
21	18055	.	A	T	8	1	9	0	5	14	0	0
21	18057	.	T	A	7	3	10	0	4	14	0	0
21	18176	.	G	A	8	10	18	0	0	18	0	0
21	36346	.	A	C	5	2	7	0	0	7	0	0
21	36595	.	C	T	3	3	6	0	0	6	0	0
21	36904	.	C	T	0	3	3	0	4	7	0	0
21	40609	.	T	C	12	12	24	0	0	24	0	0
21	41914	.	A	G	4	1	5	0	0	5	0	0
21	79799	.	A	G	2	0	2	0	2	4	0	0
21	103308	.	T	C	5	2	7	0	0	7	0	0
21	103962	.	C	T	8	5	13	0	1	14	0	0
21	104046	.	T	C	1	3	4	0	0	4	0	0
21	104316	.	A	T	0	2	2	0	0	2	0	0
21	112730	.	C	A	2	6	8	0	0	8	0	0
21	170052	.	C	A	0	1	1	0	1	2	0	0
21	170842	.	C	G	1	0	1	0	0	1	0	0
21	170896	.	A	C	3	3	6	0	0	6	0	0
21	170916	.	T	C	7	5	12	0	0	12	0	0
21	171853	.	A	G	10	0	10	0	5	15	0	0
21	173536	.	A	G	5	7	12	0	0	12	0	0
21	173545	.	T	C	6	10	16	0	1	17	0	0
21	178193	.	T	A	3	11	14	0	0	14	0	0
21	178227	.	G	A	0	8	8	0	6	14	0	0
21	178247	.	G	T	6	4	10	0	2	12	0	0
21	178559	.	T	C	4	7	11	0	1	12	0	0
21	217974	.	T	C	11	11	22	0	1	23	0	0
21	218795	.	A	G	6	2	8	0	0	8	0	0
21	219250	.	C	T	0	4	4	0	5	9	0	0
21	219259	.	T	C	4	0	4	0	4	8	0	0
21	233123	.	G	C	13	9	22	0	0	22	0	0
21	237246	.	G	C	1	2	3	0	0	3	0	0
21	238575	.	T	C	13	11	24	0	0	24	0	0
21	240046	.	A	G	2	1	3	0	3	6	0	0
21	243053	.	C	G	4	6	10	0	0	10	0	0
21	245641	.	G	A	0	0	0	0	2	2	0	0
21	247942	.	T	C	10	7	17	0	0	17	0	0
21	248156	.	C	G	7	14	21	0	1	22	0	0
21	248284	.	A	C	4	3	7	0	3	10	0	0
21	248286	.	A	C	6	3	9	0	1	10	0	0
21	248396	.	C	T	9	4	13	0	0	13	0	0
21	249992	.	T	G	2	2	4	0	0	4	0	0
21	259668	.	T	C	0	1	1	0	0	1	0	0
21	261182	.	A	G	3	0	3	0	5	8	0	0
21	261716	.	G	A	0	1	1	0	0	1	0	0
21	261752	.	C	T	2	5	7	0	0	7	0	0
21	266087	.	T	A	1	4	5	0	0	5	0	0
21	266195	.	A	G	4	0	4	0	2	6	0	0
21	267453	.	C	G	1	0	1	0	0	1	0	0
21	267717	.	T	C	1	2	3	0	0	3	0	0
21	269053	.	G	C	0	5	5	0	8	13	0	0
21	269057	.	G	A	8	6	14	0	0	14	0	0
21	269117	.	T	C	10	9	19	0	1	20	0	0
21	269328	.	G	A	0	4	4	0	9	13	0	0
21	269348	.	A	G	7	5	12	0	0	12	0	0
21	269391	.	G	A	2	2	4	0	0	4	0	0
21	269634	.	T	C	5	9	14	0	0	14	0	0
21	269676	.	C	T	4	3	7	0	0	7	0	0
21	269840	.	A	T	6	3	9	0	0	9	0	0
21	269858	.	G	A	5	3	8	0	0	8	0	0
21	301298	.	G	A	8	7	15	0	0	15	0	0
21	349384	.	A	G	2	0	2	0	2	4	0	0
21	349858	.	C	T	4	2	6	0	0	6	0	0
21	350020	.	C	T	2	4	6	0	0	6	0	0
21	350479	.	A	G	1	0	1	0	3	4	0	0
21	350902	.	G	A	6	4	10	0	0	10	0	0
21	352447	.	A	C	2	2	4	0	0	4	0	0
21	356956	.	T	C	3	5	8	0	0	8	0	0
21	356971	.	A	T	2	5	7	0	0	7	0	0
21	362534	.	A	T	0	1	1	0	0	1	0	0
21	363753	.	T	C	6	3	9	0	0	9	0	0
21	363795	.	T	C	4	5	9	0	1	10	0	0
21	367657	.	T	C	3	2	5	0	0	5	0	0
21	382570	.	T	G	8	0	8	0	9	17	0	0
21	409978	.	G	A	0	7	7	0	6	13	0	0
21	409986	.	G	A	6	7	13	0	0	13	0	0
21	410025	.	T	A	6	5	11	0	0	11	0	0
21	410048	.	T	C	7	3	10	0	3	13	0	0
21	410139	.	A	G	5	8	13	0	1	14	0	0
21	410268	.	A	G	10	6	16	0	0	16	0	0
21	410281	.	C	T	6	6	12	0	2	14	0	0
21	410320	.	T	G	1	7	8	0	0	8	0	0
21	419903	.	T	C	3	0	3	0	4	7	0	0
21	520628	.	G	A	3	2	5	0	0	5	0	0
21	522633	.	A	T	9	5	14	0	0	14	0	0
21	527570	.	A	T	0	4	4	0	1	5	0	0
21	734868	.	A	G	12	0	12	0	7	19	0	0
21	734962	.	A	G	5	0	5	0	20	25	0	0
21	735222	.	A	G	33	1	34	0	18	52	0	0
21	1576168	.	T	C	12	10	22	0	0	22	0	0
21	1593916	.	T	C	2	1	3	0	0	3	0	0
21	1594104	.	C	T	0	4	4	0	0	4	0	0
21	1594125	.	T	C	0	5	5	0	0	5	0	0
21	1594167	.	T	A	1	4	5	0	1	6	0	0
21	1594228	.	T	G	0	1	1	0	0	1	0	0
21	1599017	.	T	C	2	2	4	0	0	4	0	0
21	1599075	.	C	A	5	6	11	0	1	12	0	0
21	1604351	.	G	A	1	5	6	0	3	9	0	0
21	1610473	.	C	G	0	1	1	0	0	1	0	0
21	1610673	.	A	G	4	3	7	0	1	8	0	0
21	1610710	.	C	A	1	3	4	0	0	4	0	0
21	1610719	.	A	T	2	1	3	0	0	3	0	0
21	1907038	.	C	A	6	6	12	0	0	12	0	0
21	1907080	.	C	T	1	8	9	0	9	18	0	0
21	1930112	.	A	T	4	3	7	0	0	7	0	0
21	1934091	.	T	C	12	5	17	0	0	17	0	0
21	1934156	.	A	G	6	10	16	0	1	17	0	0
21	1944766	.	A	G	9	8	17	0	0	17	0	0
21	1948578	.	T	C	0	0	0	0	2	2	0	0
21	1960752	.	C	T	3	2	5	0	0	5	0	0
21	1963433	.	A	G	5	5	10	0	0	10	0	0
21	1991007	.	G	T	10	16	26	0	3	29	0	0
21	1991097	.	A	G	14	14	28	0	4	32	0	0
21	1991118	.	G	A	16	11	27	0	3	30	0	0
21	1991160	.	G	A	10	9	19	0	0	19	0	0
21	1996944	.	T	C	1	2	3	0	0	3	0	0
21	2014639	.	G	A	2	0	2	0	0	2	0	0
21	2025607	.	C	T	8	12	20	0	1	21	0	0
21	2030212	.	C	T	2	0	2	0	0	2	0	0
21	2031804	.	C	T	1	1	2	0	0	2	0	0
21	2031810	.	G	T	1	2	3	0	0	3	0	0
21	2031843	.	A	G	6	6	12	0	0	12	0	0
21	2031849	.	A	G	6	7	13	0	0	13	0	0
21	2031894	.	A	G	5	3	8	0	1	9	0	0
21	2033854	.	G	A	1	1	2	0	0	2	0	0
21	2033964	.	T	G	4	3	7	0	0	7	0	0
21	2035056	.	C	A	0	3	3	0	2	5	0	0
21	2035059	.	C	G	2	3	5	0	0	5	0	0
21	2035146	.	T	A	5	1	6	0	0	6	0	0
21	2036975	.	G	A	1	1	2	0	0	2	0	0
21	2042005	.	C	T	0	2	2	0	5	7	0	0
21	2111312	.	C	A	2	3	5	0	0	5	0	0
21	2112808	.	C	T	2	2	4	0	0	4	0	0
21	2119814	.	G	A	3	3	6	0	0	6	0	0
21	2120193	.	A	G	3	4	7	0	0	7	0	0
21	2120217	.	T	A	4	3	7	0	0	7	0	0
21	2120237	.	C	A	2	5	7	0	0	7	0	0
21	2124201	.	G	A	1	0	1	0	0	1	0	0
21	2124206	.	T	G	1	0	1	0	0	1	0	0
21	2189717	.	C	G	1	2	3	0	0	3	0	0
21	2189718	.	T	C	1	2	3	0	0	3	0	0
21	2202836	.	G	A	1	7	8	0	0	8	0	0
21	2202956	.	G	A	1	3	4	0	0	4	0	0
21	2208791	.	C	T	1	3	4	0	0	4	0	0
21	2213179	.	T	C	7	0	7	0	6	13	0	0
21	2213650	.	G	C	3	0	3	0	3	6	0	0
21	2216678	.	A	G	2	3	5	0	0	5	0	0
21	2217377	.	A	T	1	1	2	0	0	2	0	0
21	2217378	.	A	G	0	1	1	0	1	2	0	0
21	2220129	.	G	A	1	2	3	0	0	3	0	0
21	2220141	.	C	T	1	2	3	0	0	3	0	0
21	2220295	.	A	T	2	3	5	0	0	5	0	0
21	2220326	.	G	C	1	4	5	0	0	5	0	0
21	2220672	.	A	T	2	2	4	0	0	4	0	0
21	2221932	.	C	T	2	0	2	0	0	2	0	0
21	2236079	.	G	A	0	3	3	0	0	3	0	0
21	2237552	.	G	T	2	1	3	0	0	3	0	0
21	2237578	.	A	G	0	1	1	0	0	1	0	0
21	2238237	.	G	C	2	0	2	0	0	2	0	0
21	2281270	.	A	G	3	4	7	0	0	7	0	0
21	3716531	.	T	A	2	2	4	0	0	4	0	0
21	3716533	.	T	A	2	2	4	0	0	4	0	0
21	5368346	.	G	A	6	6	12	0	0	12	0	0
21	5368417	.	C	T	0	6	6	0	14	20	0	0
21	5368461	.	C	T	1	12	13	0	9	22	0	0
21	5368510	.	C	T	1	13	14	0	11	25	0	0
21	5370451	.	T	A	5	7	12	0	1	13	0	0
21	5372598	.	G	A	1	5	6	0	0	6	0	0
21	5372673	.	G	A	7	3	10	0	1	11	0	0
21	5374209	.	C	T	0	2	2	0	3	5	0	0
21	5374788	.	G	A	1	0	1	0	0	1	0	0
21	5376720	.	A	C	2	2	4	0	0	4	0	0
21	5392941	.	T	A	0	2	2	0	0	2	0	0
21	5392963	.	G	T	1	2	3	0	0	3	0	0
21	5601792	.	C	G	2	4	6	0	0	6	0	0
21	5601835	.	C	T	3	3	6	0	0	6	0	0
21	5781134	.	C	T	29	38	67	0	2	69	0	0
21	5782043	.	T	C	32	4	36	0	41	77	0	0
21	5789938	.	G	A	21	11	32	0	0	32	0	0
21	5796060	.	T	C	23	22	45	0	2	47	0	0
21	5798978	.	T	A	17	21	38	0	1	39	0	0
21	5802878	.	A	G	2	5	7	0	0	7	0	0
21	5803474	.	C	T	9	9	18	0	0	18	0	0
21	5803495	.	T	C	6	4	10	0	3	13	0	0
21	5807177	.	A	C	7	11	18	0	0	18	0	0
21	5816912	.	T	C	1	0	1	0	5	6	0	0
21	5816950	.	A	G	2	3	5	0	0	5	0	0
21	5829215	.	C	T	0	1	1	0	1	2	0	0
21	5884836	.	G	A	2	18	20	0	22	42	0	0
21	5884897	.	T	A	25	22	47	0	4	51	0	0
21	5884945	.	G	A	14	24	38	0	2	40	0	0
21	5885071	.	T	G	2	2	4	1	0	5	0	0
21	5905143	.	T	C	2	3	5	0	0	5	0	0
21	5915813	.	T	G	2	3	5	0	0	5	0	0
21	5920348	.	G	C	2	3	5	0	0	5	0	0
21	5929144	.	A	G	4	0	4	0	3	7	0	0
21	5932610	.	C	T	3	5	8	0	1	9	0	0
21	5938291	.	T	C	2	3	5	0	0	5	0	0
21	5938303	.	A	T	4	3	7	0	0	7	0	0
21	5938364	.	T	C	3	3	6	0	0	6	0	0
21	5938399	.	G	T	5	2	7	0	0	7	0	0
21	5938439	.	A	G	2	0	2	0	3	5	0	0
21	5942534	.	A	C	5	2	7	0	1	8	0	0
21	5942868	.	T	G	3	8	11	0	0	11	0	0
21	5942906	.	C	A	7	6	13	0	1	14	0	0
21	5942927	.	C	T	7	6	13	0	2	15	0	0
21	5966657	.	G	A	0	2	2	0	2	4	0	0
21	5971630	.	C	A	14	0	14	0	0	14	0	0
21	5971638	.	C	A	11	3	14	0	0	14	0	0
21	5971839	.	A	T	5	4	9	0	1	10	0	0
21	5971949	.	A	T	4	5	9	0	0	9	0	0
21	5971983	.	C	T	9	7	16	0	0	16	0	0
21	5972087	.	G	T	1	11	12	0	9	21	0	0
21	5972092	.	T	C	7	11	18	0	1	19	0	0
21	5972252	.	A	G	7	7	14	0	0	14	0	0
21	5972543	.	C	T	11	3	14	0	0	14	0	0
21	5972631	.	T	A	2	3	5	0	0	5	0	0
21	5979362	.	C	T	1	1	2	0	0	2	0	0
21	5979366	.	G	A	1	1	2	0	0	2	0	0
21	6114776	.	G	T	1	3	4	0	0	4	0	0
21	6123420	.	C	A	1	0	1	0	0	1	0	0
21	6133407	.	G	A	1	2	3	0	0	3	0	0
21	6133434	.	G	A	0	2	2	0	3	5	0	0
21	6137579	.	C	T	0	2	2	0	0	2	0	0
21	6145991	.	G	A	7	4	11	0	0	11	0	0
21	6147499	.	C	T	0	1	1	0	0	1	0	0
21	6148091	.	G	A	0	6	6	0	5	11	0	0
21	6149938	.	T	C	15	22	37	0	0	37	0	0
21	6150113	.	T	A	6	3	9	0	1	10	0	0
21	6150504	.	A	G	1	1	2	0	3	5	0	0
21	6212959	.	C	T	3	6	9	0	0	9	0	0
21	7222168	.	T	G	0	9	9	0	2	11	0	0
21	11493661	.	A	G	32	18	50	0	2	52	0	0
21	11494536	.	A	G	12	1	13	0	36	49	0	0
21	11501975	.	A	G	20	19	39	0	1	40	0	0
21	11502056	.	A	G	41	18	59	0	0	59	0	0
21	11502143	.	A	G	12	44	56	0	2	58	0	0
21	11883160	.	A	G	1	4	5	0	0	5	0	0
21	13611990	.	C	T	0	2	2	0	2	4	0	0
21	13612174	.	T	A	3	2	5	0	1	6	0	0
21	13612559	.	A	T	5	5	10	0	0	10	0	0
21	13612711	.	T	C	2	3	5	0	0	5	0	0
21	13613038	.	T	C	2	2	4	0	2	6	0	0
21	13613077	.	T	C	1	6	7	0	0	7	0	0
21	13613523	.	A	G	4	2	6	0	0	6	0	0
21	13702751	.	A	T	17	13	30	0	1	31	0	0
21	13714602	.	T	C	11	20	31	0	3	34	0	0
21	13714603	.	G	A	13	21	34	0	0	34	0	0
21	13715285	.	T	A	1	1	2	0	0	2	0	0
21	13715347	.	T	A	3	7	10	0	0	10	0	0
21	13715356	.	A	G	2	6	8	0	0	8	0	0
21	13751205	.	G	C	7	5	12	0	0	12	0	0
21	13762434	.	G	C	1	2	3	0	0	3	0	0
21	13765938	.	T	C	0	1	1	0	0	1	0	0
21	13765957	.	T	C	1	1	2	0	0	2	0	0
21	13766022	.	C	G	1	6	7	0	1	8	0	0
21	13794602	.	C	T	2	3	5	0	1	6	0	0
21	13794652	.	G	T	5	6	11	0	0	11	0	0
21	13796033	.	G	A	0	1	1	0	0	1	0	0
21	13796165	.	G	A	4	4	8	0	0	8	0	0
21	13796743	.	A	G	5	16	21	0	0	21	0	0
21	13796840	.	G	A	0	1	1	0	5	6	0	0
21	13796850	.	A	G	4	0	4	0	1	5	0	0
21	13799872	.	G	C	2	0	2	0	2	4	0	0
21	13799876	.	T	C	2	2	4	0	0	4	0	0
21	13800552	.	A	T	1	1	2	0	1	3	0	0
21	13895741	.	C	T	11	9	20	0	0	20	0	0
21	13895799	.	C	A	22	29	51	0	2	54	1	0
21	13895849	.	G	A	0	9	9	0	4	13	0	0
21	13895862	.	A	C	0	3	3	0	0	4	1	0
21	13909005	.	T	C	10	6	16	0	1	17	0	0
21	13919482	.	C	T	21	10	31	0	2	33	0	0
21	13919498	.	C	A	18	14	32	0	7	39	0	0
21	13920204	.	G	C	2	36	38	0	35	73	0	0
21	13920308	.	C	T	31	19	50	0	12	62	0	0
21	13920510	.	G	A	2	38	40	0	34	74	0	0
21	13920648	.	G	A	2	26	28	0	33	61	0	0
21	13924202	.	T	C	1	1	2	0	0	2	0	0
21	13924235	.	G	T	1	1	2	0	0	2	0	0
21	13980445	.	T	A	2	8	10	0	2	12	0	0
21	13980490	.	T	C	8	4	12	0	0	12	0	0
21	13980516	.	G	A	8	6	14	0	0	14	0	0
21	13980628	.	G	T	1	2	3	0	1	4	0	0
21	13980743	.	A	G	1	4	5	0	1	6	0	0
21	13981620	.	C	T	0	4	4	0	5	9	0	0
21	13981954	.	T	C	2	0	2	0	2	4	0	0
21	13982919	.	T	A	3	2	5	0	0	5	0	0
21	13983649	.	G	T	3	5	8	0	1	9	0	0
21	13995753	.	T	C	2	0	2	0	5	7	0	0
21	13995761	.	A	G	4	3	7	0	0	7	0	0
21	14041194	.	C	T	0	2	2	0	2	4	0	0
21	14083189	.	T	C	2	2	4	0	1	5	0	0
21	14217519	.	C	A	3	4	7	0	0	7	0	0
21	14217595	.	T	C	2	7	9	0	1	10	0	0
21	14217657	.	T	G	10	6	16	0	1	17	0	0
21	14217664	.	T	C	6	0	6	0	10	16	0	0
21	14217762	.	G	T	10	6	16	0	2	18	0	0
21	14224135	.	A	T	1	0	1	0	0	1	0	0
21	14224168	.	C	T	4	2	6	0	0	6	0	0
21	14226528	.	C	T	2	1	3	0	0	3	0	0
21	14226571	.	T	A	4	6	10	0	1	11	0	0
21	14226601	.	C	T	0	7	7	0	8	15	0	0
21	14226685	.	C	T	2	1	3	0	0	3	0	0
21	14228943	.	C	T	0	1	1	0	0	1	0	0
21	14232498	.	G	A	1	2	3	0	0	3	0	0
21	14235495	.	A	G	2	4	6	0	1	7	0	0
21	14241936	.	C	A	2	4	6	0	0	6	0	0
21	14381335	.	G	A	4	2	6	0	0	6	0	0
21	14381356	.	C	T	0	2	2	0	5	7	0	0
21	14381440	.	G	A	2	2	4	0	0	4	0	0
21	14399414	.	A	C	1	0	1	0	1	2	0	0
21	14399444	.	A	T	3	2	5	0	0	5	0	0
21	14399710	.	T	G	0	1	1	0	0	1	0	0
21	14399729	.	A	G	0	1	1	0	0	1	0	0
21	14469505	.	G	A	2	4	6	0	0	6	0	0
21	14644363	.	T	C	9	5	14	0	0	14	0	0
21	14644567	.	G	A	3	6	9	0	0	9	0	0
21	14644702	.	A	T	5	7	12	0	0	12	0	0
21	14644704	.	A	T	7	5	12	0	0	12	0	0
21	14644814	.	C	T	14	7	21	0	1	22	0	0
21	14644869	.	C	G	9	6	15	0	1	16	0	0
21	14644885	.	A	T	11	4	15	0	1	16	0	0
21	14644917	.	T	G	5	9	14	0	1	15	0	0
21	14644949	.	C	T	0	5	5	0	8	13	0	0
21	14644969	.	A	G	3	11	14	0	2	16	0	0
21	14645006	.	G	A	7	9	16	0	0	16	0	0
21	14645021	.	G	A	10	11	21	0	1	22	0	0
21	14645125	.	A	G	0	4	4	0	1	5	0	0
21	14645490	.	C	T	3	7	10	0	2	12	0	0
21	14645574	.	C	T	5	6	11	0	0	11	0	0
21	14645724	.	G	T	6	22	28	0	0	28	0	0
21	14645728	.	A	G	6	19	25	0	1	26	0	0
21	14645873	.	C	T	11	9	20	0	0	20	0	0
21	14657314	.	C	T	0	4	4	0	2	6	0	0
21	14659462	.	T	A	1	1	2	0	0	2	0	0
21	14659828	.	A	T	1	1	2	0	0	2	0	0
21	14659997	.	T	C	1	0	1	0	0	1	0	0
21	14660057	.	C	A	0	1	1	0	0	1	0	0
21	14663428	.	A	G	2	2	4	0	0	4	0	0
21	14663464	.	C	T	1	0	1	0	0	1	0	0
21	14663853	.	C	G	2	4	6	0	0	6	0	0
21	14664425	.	T	C	6	9	15	0	1	16	0	0
21	14664752	.	G	A	6	7	13	0	1	14	0	0
21	14664851	.	T	C	1	2	3	0	0	3	0	0
21	14665152	.	G	A	7	3	10	0	0	10	0	0
21	14665510	.	C	A	0	1	1	0	0	1	0	0
21	14701803	.	G	A	3	2	5	0	1	6	0	0
21	14701890	.	A	G	6	13	19	0	2	21	0	0
21	14701897	.	G	A	6	15	21	0	2	23	0	0
21	14701953	.	T	C	10	0	10	0	7	17	0	0
21	14702073	.	C	G	7	7	14	1	0	15	0	0
21	14702076	.	C	T	6	7	13	1	0	14	0	0
21	14702193	.	C	T	5	2	7	0	0	7	0	0
21	14702211	.	C	T	0	0	0	0	3	3	0	0
21	15806179	.	T	C	1	4	5	0	0	5	0	0
21	17029424	.	T	A	1	6	7	0	0	7	0	0
21	17192901	.	C	A	1	2	3	0	0	3	0	0
21	17241810	.	T	C	2	5	7	0	0	7	0	0
21	17242441	.	C	A	7	6	13	0	0	13	0	0
21	17243160	.	C	T	2	1	3	0	0	3	0	0
21	17246756	.	G	A	7	2	9	0	0	9	0	0
21	17255773	.	C	T	2	5	7	0	0	7	0	0
21	17256590	.	A	C	8	8	16	0	3	19	0	0
21	17256656	.	A	G	3	3	6	0	1	7	0	0
21	17258486	.	C	T	14	11	25	0	2	27	0	0
21	17258842	.	A	G	2	7	9	0	0	9	0	0
21	17258864	.	T	C	2	2	4	0	1	5	0	0
21	17259081	.	C	G	11	5	16	0	0	16	0	0
21	17259279	.	G	T	0	7	7	0	12	19	0	0
21	17259332	.	T	C	3	10	13	0	0	13	0	0
21	17259466	.	A	T	7	11	18	0	0	18	0	0
21	17307144	.	C	T	2	2	4	0	0	4	0	0
21	17310012	.	T	C	1	0	1	0	0	1	0	0
21	17314037	.	G	A	0	1	1	0	0	1	0	0
21	17314054	.	C	T	0	1	1	0	0	1	0	0
21	17322472	.	G	A	0	0	0	0	3	3	0	0
21	17322478	.	C	A	2	0	2	0	0	2	0	0
21	17322641	.	G	T	4	2	6	0	0	6	0	0
21	17325413	.	G	A	3	0	3	0	0	3	0	0
21	17325965	.	G	A	3	2	5	0	1	6	0	0
21	17327124	.	G	C	0	4	4	0	3	7	0	0
21	17327163	.	T	G	10	4	14	0	1	15	0	0
21	17327359	.	C	T	4	5	9	0	0	10	1	0
21	17327389	.	C	T	2	5	7	0	0	7	0	0
21	17327646	.	G	A	2	1	3	0	0	3	0	0
21	17335664	.	G	A	5	4	9	0	0	9	0	0
21	17335676	.	G	A	0	4	4	0	7	11	0	0
21	17335709	.	C	T	2	6	8	0	0	8	0	0
21	17337694	.	G	A	0	10	10	0	10	20	0	0
21	17337865	.	C	T	11	11	22	0	0	22	0	0
21	17337898	.	A	T	6	16	22	0	0	22	0	0
21	17338141	.	T	G	15	5	20	0	2	22	0	0
21	17338963	.	T	C	13	5	18	0	0	18	0	0
21	17339001	.	C	A	6	5	11	0	0	11	0	0
21	17339002	.	A	T	6	5	11	0	0	11	0	0
21	17339044	.	C	A	10	4	14	0	1	15	0	0
21	17339132	.	G	A	0	11	11	0	5	16	0	0
21	17339767	.	A	T	4	4	8	0	0	8	0	0
21	17413852	.	C	T	3	3	6	0	0	6	0	0
21	17419933	.	A	T	3	3	6	0	0	6	0	0
21	17420492	.	G	A	1	4	5	0	0	5	0	0
21	17420960	.	A	C	3	3	6	0	0	6	0	0
21	17478552	.	T	A	2	2	4	0	0	4	0	0
21	17478656	.	G	C	5	9	14	0	1	15	0	0
21	17480167	.	G	A	9	15	24	0	2	26	0	0
21	17480216	.	C	T	4	8	12	0	0	12	0	0
21	17482201	.	A	G	17	10	27	0	0	27	0	0
21	17482237	.	A	G	13	10	23	0	1	24	0	0
21	17568543	.	A	G	8	15	23	0	0	23	0	0
21	18031228	.	A	G	2	1	3	0	0	3	0	0
21	19008193	.	A	T	17	17	34	0	4	38	0	0
21	19008272	.	C	T	12	19	31	0	0	31	0	0
21	19008368	.	C	T	8	14	22	0	1	23	0	0
21	19008602	.	G	A	20	9	29	0	1	30	0	0
21	19008689	.	G	A	16	12	28	0	0	28	0	0
21	19008845	.	C	T	15	9	24	0	0	24	0	0
21	19009346	.	T	C	10	16	26	0	1	27	0	0
21	19009693	.	A	C	20	22	42	0	0	42	0	0
21	19010069	.	G	A	18	21	39	0	3	42	0	0
21	19010097	.	A	T	16	24	40	0	4	44	0	0
21	19010108	.	G	A	20	26	46	0	3	49	0	0
21	19013875	.	G	A	12	24	36	0	5	41	0	0
21	19014036	.	T	G	10	32	42	0	1	43	0	0
21	19014179	.	C	T	24	9	33	1	0	34	0	0
21	19014256	.	T	C	34	0	34	0	28	62	0	0
21	19014341	.	C	A	34	29	63	0	2	65	0	0
21	19014420	.	C	T	35	29	64	0	2	66	0	0
21	19014567	.	C	T	33	33	66	0	1	67	0	0
21	19014634	.	A	T	28	27	55	0	2	57	0	0
21	19014714	.	G	A	27	32	59	0	5	64	0	0
21	19014980	.	C	T	27	27	54	0	2	56	0	0
21	19015035	.	A	G	31	26	57	0	0	57	0	0
21	19015508	.	C	T	17	16	33	0	2	35	0	0
21	19017370	.	T	A	5	7	12	0	1	13	0	0
21	19018116	.	A	G	19	20	39	0	2	41	0	0
21	19018224	.	A	C	30	11	41	0	0	41	0	0
21	19018362	.	A	G	17	17	34	0	0	34	0	0
21	19018434	.	T	A	10	13	23	0	1	24	0	0
21	19063337	.	T	G	11	9	20	0	2	22	0	0
21	19066878	.	C	T	12	15	27	0	2	29	0	0
21	19067092	.	A	G	13	26	39	0	2	41	0	0
21	19073046	.	A	T	1	3	4	0	1	5	0	0
21	19073143	.	G	T	2	2	4	0	0	4	0	0
21	19073505	.	C	T	6	2	8	0	0	8	0	0
21	19073629	.	T	C	2	3	5	0	0	5	0	0
21	19328984	.	T	A	2	2	4	0	0	4	0	0
21	19329072	.	C	T	4	6	10	0	0	10	0	0
21	19329285	.	C	T	0	1	1	0	0	1	0	0
21	19329813	.	G	T	4	8	12	0	0	12	0	0
21	19345807	.	C	T	1	1	2	0	0	2	0	0
21	19763668	.	C	T	19	20	39	0	1	40	0	0
21	19763692	.	A	T	22	24	46	0	0	46	0	0
21	19763942	.	G	A	31	24	55	0	1	56	0	0
21	19764230	.	C	T	28	25	53	0	9	62	0	0
21	19764316	.	T	G	24	21	45	0	0	45	0	0
21	19764397	.	G	C	25	21	46	0	0	46	0	0
21	19764431	.	C	T	23	19	42	0	1	43	0	0
21	19764432	.	G	A	20	21	41	0	2	43	0	0
21	19764516	.	G	A	20	16	36	0	1	37	0	0
21	19764674	.	C	T	7	10	17	0	0	17	0	0
21	19764676	.	T	C	7	9	16	0	1	17	0	0
21	19764727	.	T	A	11	5	16	0	2	18	0	0
21	19765039	.	G	A	4	3	7	0	1	8	0	0
21	19785355	.	G	T	9	22	31	0	1	32	0	0
21	19785379	.	A	T	14	26	40	0	1	41	0	0
21	19792767	.	T	G	5	16	21	0	1	22	0	0
21	19795075	.	T	C	1	0	1	0	3	4	0	0
21	19804193	.	T	G	2	3	5	0	1	6	0	0
21	19805614	.	G	A	1	1	2	0	0	2	0	0
21	19807356	.	C	G	1	0	1	0	0	1	0	0
21	19872681	.	A	G	4	2	6	0	0	6	0	0
21	19904871	.	G	A	3	4	7	0	0	7	0	0
21	19905153	.	G	A	2	2	4	0	0	4	0	0
21	19905609	.	C	G	4	8	12	0	1	13	0	0
21	19911467	.	C	G	2	2	4	0	0	4	0	0
21	19926210	.	C	T	1	2	3	0	0	3	0	0
21	20035065	.	T	C	7	6	13	0	0	13	0	0
21	20039621	.	G	A	0	4	4	0	4	8	0	0
21	20039687	.	G	A	0	1	1	0	4	5	0	0
21	20064747	.	G	T	4	3	7	0	0	7	0	0
21	20080608	.	G	T	0	2	2	0	0	2	0	0
21	20089886	.	C	T	12	10	22	0	0	22	0	0
21	20101713	.	A	G	1	0	1	0	1	2	0	0
21	20103068	.	G	A	2	0	2	0	0	2	0	0
21	20103249	.	T	C	3	4	7	0	0	7	0	0
21	20106524	.	G	A	5	1	6	0	0	6	0	0
21	20106551	.	A	G	5	9	14	0	1	15	0	0
21	20108249	.	G	A	0	9	9	0	10	19	0	0
21	20108282	.	T	A	11	7	18	0	2	20	0	0
21	20108354	.	G	T	15	4	19	0	0	19	0	0
21	20108359	.	T	A	5	10	15	0	2	17	0	0
21	20108772	.	A	G	2	6	8	0	0	9	1	0
21	20108831	.	A	T	1	3	4	0	0	4	0	0
21	20113659	.	A	G	6	4	10	0	0	10	0	0
21	20113912	.	A	T	3	3	6	0	0	7	1	0
21	20114094	.	G	A	13	8	21	0	0	21	0	0
21	20114385	.	G	A	1	0	1	0	0	1	0	0
21	20118979	.	C	T	2	2	4	0	0	4	0	0
21	20305865	.	C	T	4	2	6	0	0	6	0	0
21	20394321	.	C	A	4	2	6	0	0	6	0	0
21	20394396	.	T	C	1	3	4	0	1	5	0	0
21	20394397	.	C	A	1	3	4	0	1	5	0	0
21	20394432	.	A	G	2	2	4	0	0	4	0	0
21	20394988	.	G	A	0	3	3	0	1	4	0	0
21	20395038	.	C	T	2	4	6	0	0	6	0	0
21	20395176	.	C	T	1	2	3	0	0	3	0	0
21	20395560	.	T	C	2	5	7	0	0	7	0	0
21	20615173	.	T	A	1	3	4	0	1	5	0	0
21	20633020	.	G	A	3	2	5	0	0	5	0	0
21	20633884	.	G	A	0	2	2	0	3	5	0	0
21	20634424	.	T	A	2	2	4	0	0	4	0	0
21	20634442	.	C	A	2	1	3	0	1	4	0	0
21	20635428	.	T	A	1	3	4	0	0	4	0	0
21	20635511	.	G	A	0	2	2	0	0	2	0	0
21	20636063	.	G	T	1	3	4	0	1	5	0	0
21	20636119	.	T	C	4	3	7	0	0	7	0	0
21	20636130	.	G	T	2	4	6	0	0	6	0	0
21	20636690	.	C	T	4	2	6	0	0	6	0	0
21	20909676	.	C	T	6	5	11	0	0	11	0	0
21	20914348	.	C	A	3	7	10	0	0	10	0	0
21	20915065	.	C	T	9	15	24	0	1	25	0	0
21	20915152	.	C	T	2	7	9	0	1	10	0	0
21	20915255	.	A	T	1	2	3	0	0	3	0	0
21	20915736	.	C	T	4	5	9	0	0	9	0	0
21	20933504	.	A	T	5	3	8	0	2	10	0	0
21	20933759	.	G	A	11	5	16	0	0	16	0	0
21	20933798	.	C	T	13	6	19	0	0	19	0	0
21	20938270	.	G	A	7	5	12	0	1	13	0	0
21	20938354	.	T	A	14	10	24	0	1	25	0	0
21	20938976	.	T	C	1	5	6	0	1	7	0	0
21	20938981	.	C	A	0	4	4	0	3	7	0	0
21	20950679	.	T	C	4	6	10	0	1	11	0	0
21	20950835	.	G	A	0	3	3	0	3	6	0	0
21	20951231	.	G	A	0	4	4	0	4	8	0	0
21	20951267	.	T	G	3	0	3	0	3	6	0	0
21	21017484	.	G	C	9	7	16	0	1	17	0	0
21	21017513	.	C	T	14	16	30	0	2	32	0	0
21	21017606	.	G	A	6	5	11	0	0	11	0	0
21	21020589	.	C	T	4	2	6	0	0	6	0	0
21	21028097	.	G	C	3	1	4	0	0	4	0	0
21	21049323	.	G	A	2	3	5	0	1	6	0	0
21	21051358	.	G	C	4	6	10	0	0	10	0	0
21	21051715	.	C	T	9	4	13	0	0	13	0	0
21	21069395	.	C	A	1	4	5	0	7	13	1	0
21	21069692	.	G	C	1	2	3	0	0	3	0	0
21	21072309	.	C	T	2	1	3	0	0	3	0	0
21	21075987	.	C	T	1	1	2	0	0	2	0	0
21	21076065	.	G	T	3	3	6	0	0	6	0	0
21	21079840	.	G	A	9	8	17	0	0	17	0	0
21	21079852	.	C	A	0	6	6	0	9	15	0	0
21	21082623	.	G	T	0	1	1	0	2	3	0	0
21	21147779	.	C	A	3	4	7	0	1	8	0	0
21	21170737	.	G	A	2	2	4	0	0	4	0	0
21	21228247	.	C	T	1	0	1	0	0	1	0	0
21	21233182	.	G	A	3	2	5	0	0	5	0	0
21	21233266	.	A	T	3	5	8	0	1	9	0	0
21	21233281	.	G	A	2	5	7	0	1	8	0	0
21	21233674	.	T	A	7	3	10	0	0	10	0	0
21	21235061	.	C	T	1	3	4	0	0	4	0	0
21	21236886	.	G	A	4	3	7	0	1	8	0	0
21	21236900	.	A	G	6	4	10	0	0	10	0	0
21	21238089	.	C	T	3	3	6	0	0	6	0	0
21	21238098	.	C	T	3	3	6	0	0	6	0	0
21	21239969	.	A	G	4	5	9	0	0	9	0	0
21	21240046	.	G	A	0	4	4	0	4	8	0	0
21	21240079	.	G	A	3	4	7	0	1	8	0	0
21	21240166	.	A	G	1	3	4	0	0	4	0	0
21	21240379	.	C	T	6	5	11	0	1	12	0	0
21	21240568	.	C	T	6	7	13	0	0	13	0	0
21	21240927	.	C	G	3	5	8	0	0	8	0	0
21	21241412	.	A	T	3	8	11	0	0	11	0	0
21	21241469	.	A	T	1	4	5	0	0	5	0	0
21	21241747	.	T	C	9	16	25	0	0	25	0	0
21	21269469	.	A	G	1	0	1	0	0	1	0	0
21	21269834	.	G	C	6	3	9	0	0	9	0	0
21	21272549	.	C	T	1	0	1	0	0	1	0	0
21	21277052	.	C	A	1	3	4	0	1	5	0	0
21	21277089	.	G	A	0	1	1	0	2	3	0	0
21	21279368	.	G	A	0	4	4	0	9	13	0	0
21	21279396	.	C	A	11	4	15	0	0	15	0	0
21	21279582	.	G	A	4	4	8	0	0	8	0	0
21	21294260	.	C	T	6	7	13	0	2	15	0	0
21	21294299	.	C	T	11	6	17	0	0	17	0	0
21	21294362	.	A	G	6	0	6	0	1	7	0	0
21	21295195	.	A	C	1	1	2	0	0	2	0	0
21	21297358	.	G	T	6	6	12	0	0	12	0	0
21	21297635	.	C	T	5	10	15	0	0	15	0	0
21	21297963	.	G	C	1	0	1	0	0	1	0	0
21	21297979	.	A	G	3	0	3	0	0	3	0	0
21	21298249	.	T	C	7	7	14	0	3	17	0	0
21	21298427	.	G	A	8	3	11	0	0	11	0	0
21	21298488	.	C	T	10	3	13	0	0	13	0	0
21	21298633	.	G	A	6	7	13	0	1	14	0	0
21	21298703	.	C	A	8	6	14	0	0	14	0	0
21	21298811	.	A	T	3	8	11	0	2	13	0	0
21	21298824	.	G	A	2	7	9	0	0	9	0	0
21	21314029	.	A	G	0	2	2	0	0	2	0	0
21	21343266	.	A	G	5	4	9	0	0	9	0	0
21	21450574	.	C	T	5	4	9	0	1	10	0	0
21	21451013	.	T	C	7	0	7	0	8	15	0	0
21	21451025	.	C	A	6	8	14	0	0	14	0	0
21	21525664	.	T	C	3	3	6	0	0	6	0	0
21	21527417	.	A	G	1	6	7	0	0	7	0	0
21	21633340	.	G	A	1	3	4	0	0	4	0	0
21	21633668	.	G	A	3	2	5	0	0	5	0	0
21	21744345	.	T	C	2	2	4	0	0	4	0	0
21	21745489	.	T	G	0	1	1	0	0	1	0	0
21	21745498	.	G	A	0	1	1	0	0	1	0	0
21	21745654	.	G	A	1	3	4	0	0	4	0	0
21	21746132	.	G	A	0	2	2	0	4	6	0	0
21	21746136	.	G	T	5	2	7	0	0	7	0	0
21	21750684	.	T	C	0	2	2	0	0	2	0	0
21	21750702	.	A	G	3	2	5	0	0	5	0	0
21	21751303	.	A	G	0	1	1	0	0	1	0	0
21	21754470	.	T	C	7	6	13	0	0	13	0	0
21	21754624	.	G	A	3	5	8	0	0	8	0	0
21	21792022	.	C	T	2	4	6	0	0	6	0	0
21	21794194	.	G	C	3	2	5	0	0	5	0	0
21	21794238	.	C	T	3	2	5	0	0	5	0	0
21	21794262	.	G	A	4	2	6	0	0	6	0	0
21	21794277	.	T	A	3	2	5	0	0	5	0	0
21	21799103	.	A	G	2	2	4	0	1	5	0	0
21	21820136	.	A	G	4	3	7	0	0	7	0	0
21	21820167	.	C	T	2	3	5	0	0	5	0	0
21	21821291	.	C	T	2	0	2	0	0	2	0	0
21	21821378	.	G	T	6	3	9	0	0	9	0	0
21	22014223	.	A	T	5	5	10	0	0	10	0	0
21	22038375	.	C	T	1	3	4	0	1	5	0	0
21	22082257	.	C	T	9	12	21	0	2	23	0	0
21	22099610	.	A	G	1	9	10	0	1	11	0	0
21	22100149	.	G	A	8	6	14	0	8	22	0	0
21	22101271	.	A	G	19	29	48	0	2	50	0	0
21	22101304	.	G	A	24	23	47	0	0	47	0	0
21	22101387	.	A	T	26	15	41	0	5	46	0	0
21	22101471	.	G	A	28	33	61	0	1	62	0	0
21	22101540	.	G	A	23	33	56	0	4	60	0	0
21	22101637	.	T	C	24	0	24	0	27	51	0	0
21	22101665	.	G	C	23	19	42	0	0	42	0	0
21	22101708	.	C	T	17	9	26	0	1	27	0	0
21	22101776	.	G	A	24	14	38	0	0	38	0	0
21	22101827	.	C	G	8	22	30	0	27	57	0	0
21	22101917	.	A	T	27	33	60	0	2	62	0	0
21	22102037	.	G	A	19	35	54	0	0	54	0	0
21	22102044	.	C	T	1	30	31	0	21	52	0	0
21	22102154	.	C	A	19	29	48	0	1	49	0	0
21	22102261	.	G	T	20	32	52	0	1	53	0	0
21	22102281	.	A	C	18	30	48	0	3	51	0	0
21	22102361	.	C	G	23	20	43	0	1	44	0	0
21	22102377	.	T	G	21	15	36	0	2	38	0	0
21	22102405	.	C	T	22	16	38	0	2	40	0	0
21	22102515	.	T	A	10	20	30	0	0	30	0	0
21	22102542	.	C	T	12	17	29	0	1	30	0	0
21	22102653	.	A	G	9	23	32	0	2	34	0	0
21	22102838	.	T	G	19	16	35	0	1	36	0	0
21	22102931	.	A	G	27	20	47	0	8	55	0	0
21	22110005	.	C	T	2	1	3	0	0	3	0	0
21	22110113	.	C	T	6	6	12	0	0	12	0	0
21	22116192	.	G	A	1	2	3	0	0	3	0	0
21	22116260	.	A	T	0	2	2	0	0	2	0	0
21	22116280	.	A	T	1	2	3	0	1	4	0	0
21	22116384	.	C	T	3	3	6	0	0	6	0	0
21	22116586	.	G	A	5	3	8	0	0	8	0	0
21	22116611	.	C	T	5	2	7	0	0	7	0	0
21	22116684	.	A	T	0	3	3	0	0	3	0	0
21	22127204	.	C	T	2	2	4	0	0	4	0	0
21	22138571	.	C	G	3	3	6	0	0	6	0	0
21	22140937	.	C	A	0	4	4	0	0	4	0	0
21	22142362	.	A	G	5	5	10	0	0	10	0	0
21	22142820	.	G	A	1	9	10	0	1	11	0	0
21	22158882	.	A	T	0	2	2	0	0	2	0	0
21	22309149	.	A	C	1	0	1	0	0	1	0	0
21	22330468	.	C	A	2	3	5	0	0	5	0	0
21	22330494	.	C	T	3	2	5	0	0	5	0	0
21	22346512	.	G	T	4	3	7	0	1	8	0	0
21	22347182	.	T	C	4	2	6	0	0	6	0	0
21	22347765	.	C	T	2	2	4	0	0	4	0	0
21	22386900	.	C	T	4	2	6	0	0	6	0	0
21	22386902	.	C	A	4	2	6	0	0	6	0	0
21	22404800	.	G	C	0	2	2	0	6	8	0	0
21	22404852	.	T	C	4	1	5	0	0	5	0	0
21	22404855	.	T	C	4	1	5	0	0	5	0	0
21	22405045	.	T	C	2	1	3	0	0	3	0	0
21	22405232	.	T	A	4	0	4	0	0	4	0	0
21	22406755	.	T	C	1	3	4	0	0	4	0	0
21	22407000	.	T	C	1	2	3	0	0	3	0	0
21	22410965	.	T	A	6	8	14	0	0	14	0	0
21	22412304	.	T	C	3	2	5	0	1	6	0	0
21	22412376	.	T	G	5	0	5	0	9	14	0	0
21	22421853	.	T	C	9	3	12	0	1	13	0	0
21	22422149	.	T	C	13	13	26	0	1	27	0	0
21	22422184	.	A	G	13	8	21	0	1	22	0	0
21	22422243	.	G	A	12	16	28	0	1	29	0	0
21	22422407	.	T	G	10	14	24	0	1	25	0	0
21	22448380	.	C	G	7	7	14	0	0	14	0	0
21	22448445	.	A	T	2	2	4	0	0	4	0	0
21	22448624	.	T	G	6	7	13	0	0	13	0	0
21	22448625	.	A	T	6	7	13	0	0	13	0	0
21	22448808	.	A	G	3	4	7	0	1	8	0	0
21	22448961	.	C	T	5	5	10	0	1	11	0	0
21	22460258	.	C	T	1	1	2	0	1	3	0	0
21	22479422	.	C	G	1	2	3	0	0	3	0	0
21	22479463	.	T	C	1	0	1	0	0	1	0	0
21	22552520	.	A	T	0	3	3	0	0	3	0	0
21	22630324	.	C	T	9	5	14	0	0	14	0	0
21	22633430	.	C	T	15	5	20	0	1	21	0	0
21	22633734	.	A	G	8	7	15	0	0	15	0	0
21	22633773	.	T	C	15	10	25	0	0	25	0	0
21	22634136	.	C	G	12	10	22	0	0	22	0	0
21	22634243	.	G	A	10	12	22	0	2	24	0	0
21	22634289	.	C	T	16	9	25	0	0	25	0	0
21	22697107	.	C	T	2	8	10	0	0	10	0	0
21	22697161	.	T	C	4	8	12	0	1	13	0	0
21	22699471	.	T	C	6	7	13	0	0	13	0	0
21	22699491	.	T	C	7	12	19	0	0	19	0	0
21	22699512	.	T	C	8	11	19	0	0	19	0	0
21	22699556	.	A	G	6	9	15	0	0	15	0	0
21	22699563	.	C	T	6	8	14	0	0	14	0	0
21	22699595	.	C	A	6	5	11	0	0	11	0	0
21	22699608	.	T	C	5	3	8	0	1	9	0	0
21	22699631	.	C	T	7	2	9	0	1	10	0	0
21	22699916	.	G	A	3	3	6	0	2	8	0	0
21	22699956	.	T	G	3	7	10	0	0	10	0	0
21	22702816	.	T	C	8	7	15	0	0	15	0	0
21	22704853	.	T	C	0	1	1	0	1	2	0	0
21	22704918	.	G	A	1	2	3	0	0	3	0	0
21	22704924	.	C	T	0	1	1	0	1	2	0	0
21	22706480	.	G	A	1	1	2	0	0	2	0	0
21	22709218	.	C	T	1	4	5	0	0	5	0	0
21	22785296	.	A	G	4	0	4	0	3	7	0	0
21	22785326	.	C	T	8	3	11	0	0	11	0	0
21	22789131	.	G	A	0	3	3	0	6	9	0	0
21	22789353	.	C	T	1	2	3	0	0	3	0	0
21	22791174	.	A	C	3	9	12	0	1	13	0	0
21	22793229	.	A	G	0	0	0	0	1	1	0	0
21	22793238	.	A	G	0	1	1	0	1	2	0	0
21	22795009	.	T	C	5	5	10	0	1	11	0	0
21	22795107	.	G	A	0	4	4	0	3	7	0	0
21	22795324	.	C	T	5	7	12	0	0	12	0	0
21	22795358	.	T	G	3	5	8	0	0	8	0	0
21	22795392	.	A	T	3	5	8	0	0	8	0	0
21	22795534	.	T	C	4	6	10	0	0	10	0	0
21	22846773	.	A	G	2	0	2	0	0	2	0	0
21	22846910	.	G	A	4	10	14	0	1	15	0	0
21	22846948	.	G	A	6	5	11	0	1	12	0	0
21	22846986	.	T	C	10	6	16	0	0	16	0	0
21	22847022	.	A	T	9	9	18	0	2	20	0	0
21	22847059	.	G	C	12	14	26	0	1	28	1	0
21	22847069	.	A	G	13	15	28	0	1	29	0	0
21	22847128	.	G	C	7	16	23	0	1	24	0	0
21	22847163	.	A	G	6	14	20	0	2	22	0	0
21	22847174	.	G	C	6	15	21	0	1	22	0	0
21	22847207	.	A	G	6	11	17	0	0	17	0	0
21	22847234	.	A	G	11	7	18	0	2	20	0	0
21	22847246	.	G	A	15	7	22	0	2	24	0	0
21	22847969	.	C	T	17	30	47	0	0	47	0	0
21	22847984	.	A	T	20	25	45	0	0	45	0	0
21	22848047	.	C	T	18	14	32	0	1	33	0	0
21	22848293	.	C	T	2	3	5	0	1	6	0	0
21	22848424	.	C	T	3	8	11	0	0	11	0	0
21	22850242	.	G	A	3	4	7	0	1	8	0	0
21	22850422	.	G	A	16	14	30	0	1	31	0	0
21	22872757	.	C	T	1	2	3	0	0	3	0	0
21	22872832	.	G	A	0	2	2	0	1	3	0	0
21	22876273	.	C	A	3	4	7	0	0	7	0	0
21	22876289	.	G	C	1	3	4	0	1	5	0	0
21	22878844	.	A	C	5	6	11	0	0	11	0	0
21	22878856	.	G	A	8	6	14	0	1	15	0	0
21	22878880	.	C	A	14	9	23	1	1	25	0	0
21	22878994	.	T	C	11	7	18	0	1	19	0	0
21	22879925	.	T	A	10	10	20	0	1	21	0	0
21	22882818	.	A	G	2	0	2	0	4	6	0	0
21	22883854	.	A	T	6	8	14	0	0	14	0	0
21	22886365	.	G	A	5	4	9	0	1	10	0	0
21	22887883	.	C	T	5	5	10	0	0	10	0	0
21	22887951	.	A	G	8	12	20	0	2	22	0	0
21	22888303	.	A	G	5	6	11	0	0	11	0	0
21	22888352	.	C	T	2	8	10	0	1	11	0	0
21	22888355	.	T	A	2	8	10	0	1	11	0	0
21	22889238	.	A	C	1	5	6	0	0	6	0	0
21	22961178	.	T	C	3	2	5	0	1	6	0	0
21	22961233	.	A	T	2	2	4	0	0	4	0	0
21	22965838	.	G	A	5	2	7	0	0	7	0	0
21	22965844	.	G	A	4	2	6	0	1	7	0	0
21	22965891	.	C	A	5	1	6	0	0	6	0	0
21	22969687	.	C	G	2	1	3	0	0	3	0	0
21	22997949	.	C	T	1	0	1	0	0	1	0	0
21	23019836	.	T	G	16	17	33	0	1	34	0	0
21	23019988	.	G	A	18	14	32	0	0	32	0	0
21	23020102	.	C	G	16	15	31	0	1	32	0	0
21	23024996	.	A	G	11	8	19	0	0	19	0	0
21	23025197	.	T	A	4	4	8	0	0	8	0	0
21	23027023	.	A	T	12	9	21	0	3	24	0	0
21	23028342	.	A	G	1	1	2	0	0	2	0	0
21	23028399	.	C	T	0	9	9	0	17	26	0	0
21	23028432	.	G	A	19	8	27	0	0	27	0	0
21	23029206	.	A	G	12	4	16	0	1	17	0	0
21	23029476	.	T	A	10	4	14	0	2	16	0	0
21	23034852	.	A	G	9	9	18	0	1	19	0	0
21	23036534	.	G	A	1	4	5	0	1	6	0	0
21	23037906	.	T	C	10	10	20	0	0	20	0	0
21	23040993	.	T	G	2	3	5	0	0	5	0	0
21	23041283	.	G	A	4	4	8	0	0	8	0	0
21	23041602	.	T	A	2	1	3	0	0	3	0	0
21	23042616	.	C	T	0	3	3	0	1	4	0	0
21	23046424	.	C	T	0	1	1	0	0	1	0	0
21	23160851	.	A	T	13	11	24	0	1	25	0	0
21	23161061	.	G	A	16	20	36	0	1	37	0	0
21	23162023	.	C	T	11	10	21	0	2	23	0	0
21	23162395	.	T	G	2	9	11	0	0	11	0	0
21	23163534	.	T	C	7	0	7	0	10	17	0	0
21	23163564	.	T	A	9	8	17	0	2	19	0	0
21	23163694	.	G	A	6	10	16	0	1	17	0	0
21	23163841	.	A	T	7	7	14	0	0	14	0	0
21	23163884	.	A	G	4	8	12	0	0	12	0	0
21	23163885	.	A	G	4	8	12	0	0	12	0	0
21	23163938	.	G	T	16	9	25	0	1	26	0	0
21	23163990	.	A	T	23	9	32	0	2	34	0	0
21	23169835	.	G	A	6	5	11	0	0	11	0	0
21	23175440	.	C	T	3	1	4	0	2	6	0	0
21	23305121	.	A	C	4	6	10	0	1	11	0	0
21	23307764	.	T	A	0	1	1	0	1	2	0	0
21	23338241	.	G	A	4	5	9	0	0	9	0	0
21	23350204	.	G	A	7	8	15	0	0	15	0	0
21	23352629	.	A	G	1	0	1	0	1	2	0	0
21	23352707	.	A	G	4	7	11	0	0	11	0	0
21	23352749	.	G	A	2	3	5	0	0	5	0	0
21	23352791	.	A	C	3	0	3	0	3	6	0	0
21	23367200	.	C	T	13	11	24	0	1	25	0	0
21	23367218	.	T	G	17	15	32	0	1	33	0	0
21	23467074	.	A	G	6	7	13	0	1	14	0	0
21	23475195	.	G	A	1	2	3	0	0	3	0	0
21	24531861	.	C	G	4	2	6	0	0	6	0	0
21	24532011	.	T	A	4	6	10	0	0	10	0	0
21	24532219	.	A	G	4	4	8	0	0	8	0	0
21	24532288	.	G	A	4	2	6	0	0	6	0	0
21	24532321	.	T	C	2	4	6	0	0	6	0	0
21	24536365	.	G	T	0	2	2	0	0	2	0	0
21	24536809	.	G	A	5	9	14	0	0	14	0	0
21	24536943	.	T	C	5	5	10	0	0	10	0	0
21	24539908	.	T	A	5	2	7	0	0	7	0	0
21	24539983	.	A	G	6	7	13	0	3	16	0	0
21	24540379	.	C	A	0	10	10	0	9	19	0	0
21	24540684	.	A	G	7	7	14	0	1	15	0	0
21	24540990	.	G	C	6	8	14	0	0	14	0	0
21	24541141	.	C	T	4	6	10	0	0	10	0	0
21	24541279	.	A	G	11	7	18	0	0	18	0	0
21	24545622	.	A	G	10	6	16	0	0	16	0	0
21	24548355	.	A	G	1	4	5	0	0	5	0	0
21	24548716	.	C	T	1	0	1	0	0	1	0	0
21	24548838	.	A	C	4	0	4	0	2	6	0	0
21	24572181	.	G	A	0	1	1	0	0	1	0	0
21	24572193	.	G	T	0	1	1	0	0	1	0	0
21	25037404	.	A	C	0	2	2	0	0	2	0	0
21	25037557	.	C	A	1	2	3	0	0	3	0	0
21	25044196	.	C	T	3	3	6	0	0	6	0	0
21	25044433	.	T	A	0	7	7	0	0	7	0	0
21	25044434	.	C	A	0	6	6	0	1	7	0	0
21	25044523	.	G	A	0	2	2	0	6	8	0	0
21	25044726	.	T	C	8	6	14	0	0	14	0	0
21	25044876	.	A	T	0	9	9	0	0	9	0	0
21	25046179	.	A	G	2	1	3	0	2	5	0	0
21	25046210	.	G	C	3	2	5	0	0	5	0	0
21	25046672	.	A	G	5	5	10	0	0	10	0	0
21	25046734	.	C	T	5	8	13	0	1	14	0	0
21	25046840	.	C	T	3	5	8	0	0	8	0	0
21	25057217	.	G	T	4	9	13	0	0	13	0	0
21	25092333	.	T	G	4	5	9	0	0	9	0	0
21	25092667	.	C	T	3	9	12	0	0	12	0	0
21	25103396	.	C	A	1	1	2	0	0	2	0	0
21	25103457	.	G	A	1	4	5	0	0	5	0	0
21	25103676	.	T	A	3	6	9	0	0	9	0	0
21	25117887	.	G	T	10	6	16	0	1	17	0	0
21	25117926	.	T	C	9	11	20	0	0	20	0	0
21	25117959	.	G	A	10	10	20	0	1	21	0	0
21	25118065	.	G	A	13	4	17	0	1	18	0	0
21	25123257	.	G	T	0	1	1	0	0	1	0	0
21	25125432	.	G	A	1	1	2	0	0	2	0	0
21	25135777	.	A	G	3	0	3	0	6	9	0	0
21	25142536	.	T	A	6	6	12	0	0	12	0	0
21	25156379	.	C	T	5	0	5	0	0	5	0	0
21	25181296	.	C	G	2	2	4	0	0	4	0	0
21	25181366	.	A	G	3	3	6	0	0	6	0	0
21	25181643	.	T	A	7	5	12	0	1	13	0	0
21	25182086	.	G	A	15	7	22	0	2	24	0	0
21	25182091	.	C	A	13	9	22	0	1	23	0	0
21	25182207	.	A	T	7	11	18	0	1	19	0	0
21	25182552	.	A	T	7	7	14	0	1	15	0	0
21	25182595	.	T	C	5	5	10	0	0	10	0	0
21	25182598	.	G	A	5	6	11	0	0	11	0	0
21	25182721	.	T	C	2	8	10	0	0	10	0	0
21	25182735	.	T	G	1	0	1	0	10	11	0	0
21	25182761	.	T	C	1	9	10	0	0	10	0	0
21	25182858	.	A	C	5	8	13	0	1	14	0	0
21	25183180	.	T	C	3	22	25	0	0	25	0	0
21	25183224	.	T	A	7	16	23	0	0	23	0	0
21	25183225	.	A	G	7	16	23	0	0	23	0	0
21	25207925	.	A	G	3	4	7	0	0	7	0	0
21	25207931	.	A	G	3	4	7	0	0	7	0	0
21	25210921	.	A	G	3	5	8	0	0	8	0	0
21	25210936	.	T	C	3	0	3	0	6	9	0	0
21	25247433	.	C	A	0	1	1	0	1	2	0	0
21	25250497	.	C	T	0	2	2	0	1	3	0	0
21	25250539	.	G	A	3	4	7	0	0	7	0	0
21	25250749	.	C	T	0	2	2	0	3	5	0	0
21	25250983	.	G	A	5	6	11	0	1	12	0	0
21	25251082	.	T	C	1	2	3	0	0	3	0	0
21	25254915	.	G	C	3	2	5	0	0	5	0	0
21	25256907	.	C	T	0	4	4	0	0	4	0	0
21	25257059	.	T	C	1	3	4	0	0	4	0	0
21	25261650	.	C	T	0	1	1	0	0	1	0	0
21	25380894	.	G	T	7	3	10	0	0	10	0	0
21	25384076	.	T	C	2	3	5	0	0	5	0	0
21	25386752	.	T	C	2	5	7	0	0	7	0	0
21	25399137	.	A	T	2	2	4	0	0	4	0	0
21	25399873	.	A	G	18	17	35	0	2	37	0	0
21	25407031	.	G	C	5	0	5	0	5	10	0	0
21	25407216	.	C	G	11	15	26	0	0	26	0	0
21	25425773	.	C	A	8	12	20	0	0	20	0	0
21	25425798	.	T	C	8	11	19	0	0	19	0	0
21	25425826	.	G	T	13	8	21	0	1	22	0	0
21	25425848	.	C	A	0	11	11	0	9	20	0	0
21	25425873	.	A	T	13	6	19	0	0	19	0	0
21	25440049	.	G	A	17	22	39	0	0	39	0	0
21	25440079	.	A	C	20	3	23	0	17	40	0	0
21	25440085	.	G	A	22	16	38	0	2	40	0	0
21	25449464	.	G	A	0	1	1	0	0	1	0	0
21	25452558	.	G	A	6	6	12	0	0	12	0	0
21	25458902	.	T	A	5	8	13	0	2	15	0	0
21	25460713	.	G	A	2	2	4	0	0	4	0	0
21	25460734	.	G	A	8	9	17	0	1	18	0	0
21	25476597	.	G	A	2	3	5	0	0	5	0	0
21	25492981	.	C	T	1	2	3	0	0	3	0	0
21	25522674	.	C	T	0	9	9	0	11	20	0	0
21	25533875	.	T	G	1	4	5	0	0	5	0	0
21	25533882	.	G	A	1	3	4	0	1	5	0	0
21	25534003	.	C	T	2	2	4	0	0	4	0	0
21	25536122	.	G	A	0	2	2	0	0	2	0	0
21	25536182	.	G	A	0	2	2	0	0	2	0	0
21	25540822	.	C	A	3	4	7	0	0	7	0	0
21	25540846	.	A	C	2	5	7	0	0	7	0	0
21	25541272	.	A	G	4	5	9	0	0	9	0	0
21	25541473	.	C	T	4	4	8	0	1	9	0	0
21	25541704	.	T	C	4	5	9	0	0	9	0	0
21	25541893	.	A	G	2	2	4	0	0	4	0	0
21	25541902	.	C	T	1	3	4	0	0	4	0	0
21	25542294	.	T	C	3	2	5	0	1	6	0	0
21	25542296	.	T	C	3	2	5	0	1	6	0	0
21	25542391	.	T	C	2	4	6	0	1	7	0	0
21	25543258	.	A	G	5	5	10	0	1	11	0	0
21	25561362	.	G	A	2	2	4	0	0	4	0	0
21	25561586	.	G	A	11	7	18	0	0	18	0	0
21	25561775	.	T	C	9	0	9	0	9	18	0	0
21	25570323	.	G	A	4	10	14	0	3	17	0	0
21	25570434	.	G	A	16	5	21	0	0	21	0	0
21	25571133	.	C	A	1	0	1	0	0	1	0	0
21	25571392	.	G	A	4	5	9	0	0	9	0	0
21	25571436	.	T	A	9	6	15	0	1	16	0	0
21	25571919	.	T	C	0	1	1	0	0	1	0	0
21	25572145	.	C	T	0	1	1	0	0	1	0	0
21	25572785	.	G	T	1	3	4	0	0	4	0	0
21	25573031	.	A	C	6	5	11	0	0	11	0	0
21	25605647	.	A	G	3	4	7	0	0	7	0	0
21	25606796	.	C	T	1	2	3	0	0	3	0	0
21	25606819	.	C	G	0	1	1	0	0	1	0	0
21	25606971	.	A	G	2	1	3	0	0	3	0	0
21	25610512	.	T	C	0	0	0	0	4	4	0	0
21	25611861	.	G	A	4	3	7	0	0	7	0	0
21	25611931	.	T	C	3	5	8	0	0	8	0	0
21	25617544	.	G	C	1	1	2	0	0	2	0	0
21	25620446	.	T	C	3	3	6	0	0	6	0	0
21	25620573	.	A	G	0	1	1	0	0	1	0	0
21	25622880	.	G	A	4	2	6	0	0	6	0	0
21	25645217	.	A	C	10	9	19	0	1	20	0	0
21	25645555	.	T	G	20	14	34	0	1	35	0	0
21	25645655	.	G	C	11	17	28	0	0	28	0	0
21	25663198	.	A	G	1	2	3	0	0	3	0	0
21	25663199	.	G	C	1	0	1	0	2	3	0	0
21	25670078	.	G	A	3	1	4	0	0	5	1	0
21	25671377	.	T	C	1	2	3	0	0	3	0	0
21	25671513	.	C	T	1	0	1	0	0	1	0	0
21	25676323	.	G	A	2	2	4	0	1	5	0	0
21	25676343	.	A	T	2	2	4	0	0	4	0	0
21	25677015	.	T	G	1	3	4	0	0	4	0	0
21	25693141	.	G	T	0	2	2	0	0	2	0	0
21	25722719	.	C	T	6	3	9	0	1	10	0	0
21	25794648	.	G	A	4	2	6	0	0	6	0	0
21	25817162	.	A	G	0	0	0	0	6	6	0	0
21	25817230	.	A	G	3	7	10	0	1	11	0	0
21	25817842	.	A	G	1	2	3	0	0	3	0	0
21	25817847	.	A	G	2	2	4	0	0	4	0	0
21	25818170	.	G	C	3	4	7	0	0	7	0	0
21	25818193	.	T	G	1	0	1	0	2	3	0	0
21	25819439	.	G	A	3	2	5	0	0	5	0	0
21	26014378	.	A	G	0	0	0	0	2	2	0	0
21	26021662	.	T	A	4	6	10	0	0	10	0	0
21	26022275	.	C	T	1	3	4	0	0	4	0	0
21	26022391	.	T	C	4	0	4	0	5	9	0	0
21	26023146	.	G	A	1	9	10	0	0	10	0	0
21	26023147	.	T	A	1	9	10	0	0	10	0	0
21	26023231	.	G	A	0	2	2	0	0	2	0	0
21	26026171	.	A	G	1	6	7	0	0	7	0	0
21	26030687	.	T	C	2	5	7	0	0	7	0	0
21	26033800	.	C	T	4	5	9	0	1	10	0	0
21	26041741	.	C	T	0	1	1	0	0	1	0	0
21	26043333	.	A	G	0	1	1	0	1	2	0	0
21	26050097	.	C	T	5	3	8	0	1	9	0	0
21	26050115	.	C	T	7	5	12	0	0	12	0	0
21	26050415	.	T	G	6	3	9	0	0	9	0	0
21	26053929	.	C	A	9	12	21	0	3	24	0	0
21	26054453	.	A	G	4	0	4	0	6	10	0	0
21	26057490	.	T	A	5	14	19	0	0	19	0	0
21	26057707	.	C	T	5	4	9	0	3	12	0	0
21	26057862	.	G	C	0	5	5	0	11	16	0	0
21	26057864	.	T	G	11	5	16	0	0	16	0	0
21	26058121	.	C	T	10	12	22	0	1	23	0	0
21	26058204	.	G	A	11	10	21	0	6	27	0	0
21	26058275	.	G	T	16	15	31	0	3	34	0	0
21	26058378	.	C	T	10	7	17	0	1	18	0	0
21	26058386	.	C	A	9	7	16	0	2	18	0	0
21	26073115	.	A	T	7	7	14	0	0	14	0	0
21	26080547	.	A	G	7	7	14	0	0	14	0	0
21	26153049	.	C	T	10	6	16	0	1	17	0	0
21	26153123	.	G	A	11	10	21	0	2	23	0	0
21	26161272	.	G	A	1	1	2	0	0	2	0	0
21	26184258	.	T	A	6	3	9	0	1	10	0	0
21	26184259	.	G	T	7	1	8	0	2	10	0	0
21	26389462	.	C	T	4	3	7	0	0	7	0	0
21	26390614	.	G	A	7	10	17	0	1	18	0	0
21	26390620	.	A	G	7	9	16	0	0	16	0	0
21	26415195	.	C	T	7	11	18	0	0	18	0	0
21	26417389	.	A	T	2	2	4	0	0	4	0	0
21	26417854	.	A	T	8	3	11	0	0	11	0	0
21	26438770	.	A	G	1	2	3	0	0	3	0	0
21	26438854	.	T	C	1	1	2	0	0	2	0	0
21	26441889	.	A	G	4	2	6	0	0	6	0	0
21	26441904	.	C	T	5	3	8	0	0	8	0	0
21	26482972	.	A	T	1	4	5	0	0	5	0	0
21	26522682	.	G	A	7	9	16	0	0	16	0	0
21	26523233	.	C	T	2	5	7	0	0	7	0	0
21	26523454	.	A	T	0	1	1	0	0	1	0	0
21	26527782	.	G	A	0	7	7	0	10	17	0	0
21	26530332	.	G	A	0	1	1	0	2	3	0	0
21	26530663	.	T	A	1	4	5	0	0	5	0	0
21	26530723	.	G	T	7	11	18	0	0	18	0	0
21	26530737	.	G	C	11	4	15	0	0	15	0	0
21	26530758	.	T	C	3	9	12	0	0	12	0	0
21	26531014	.	G	A	6	4	10	0	1	11	0	0
21	26531102	.	A	G	8	11	19	0	0	19	0	0
21	26537337	.	G	A	1	2	3	0	0	3	0	0
21	26545469	.	C	T	1	0	1	0	0	1	0	0
21	26545632	.	T	C	0	1	1	0	0	1	0	0
21	26549972	.	T	C	1	1	2	0	0	2	0	0
21	26553406	.	C	T	7	4	11	0	1	12	0	0
21	26553425	.	T	C	4	7	11	0	0	11	0	0
21	26553466	.	A	G	1	8	9	0	0	9	0	0
21	26553554	.	A	C	2	2	4	0	0	4	0	0
21	26553794	.	C	T	8	5	13	0	0	13	0	0
21	26553857	.	T	A	3	2	5	0	2	7	0	0
21	26553879	.	G	T	6	3	9	0	0	9	0	0
21	26553971	.	A	T	1	4	5	0	0	5	0	0
21	26554116	.	T	C	6	3	9	0	0	9	0	0
21	26554139	.	C	T	4	3	7	0	0	7	0	0
21	26607004	.	T	G	4	2	6	0	1	7	0	0
21	26620914	.	T	C	4	3	7	0	0	7	0	0
21	26621139	.	G	A	0	3	3	0	7	10	0	0
21	26634042	.	C	T	9	9	18	0	0	18	0	0
21	26662745	.	G	A	17	13	30	0	0	30	0	0
21	26663161	.	G	C	0	0	0	0	1	1	0	0
21	26664625	.	C	T	23	17	40	0	2	42	0	0
21	26664770	.	C	T	14	16	30	0	4	34	0	0
21	26665046	.	G	T	6	3	9	0	0	9	0	0
21	26665092	.	C	T	0	3	3	0	2	5	0	0
21	26665364	.	T	A	6	4	10	0	0	10	0	0
21	26665661	.	A	G	2	2	4	0	0	4	0	0
21	26665745	.	C	A	2	12	14	0	15	29	0	0
21	26665790	.	G	A	10	6	16	0	0	16	0	0
21	26665808	.	C	T	4	4	8	0	1	9	0	0
21	26668766	.	T	A	3	5	8	0	0	8	0	0
21	26668826	.	T	G	2	5	7	0	1	8	0	0
21	26669365	.	A	G	2	2	4	0	2	6	0	0
21	26669394	.	C	T	1	4	5	0	1	6	0	0
21	26669421	.	T	C	3	4	7	0	1	8	0	0
21	26669926	.	G	T	1	3	4	0	0	4	0	0
21	26670145	.	T	C	5	2	7	0	1	8	0	0
21	26670265	.	T	A	5	3	8	0	0	8	0	0
21	26671993	.	A	G	5	2	7	0	0	7	0	0
21	26671999	.	T	A	2	4	6	0	0	6	0	0
21	26672160	.	C	T	2	2	4	0	0	4	0	0
21	26672184	.	C	T	1	3	4	0	2	6	0	0
21	26672217	.	G	C	3	2	5	0	1	6	0	0
21	26672409	.	C	T	1	2	3	0	0	3	0	0
21	26672611	.	G	A	2	5	7	0	1	8	0	0
21	26673777	.	G	A	1	0	1	0	0	1	0	0
21	26677717	.	C	T	3	9	12	0	0	12	0	0
21	26678906	.	G	A	8	4	12	0	2	14	0	0
21	26678965	.	C	T	0	4	4	0	14	18	0	0
21	26679023	.	T	C	8	9	17	0	0	17	0	0
21	26684350	.	T	A	1	5	6	0	0	6	0	0
21	26685383	.	C	T	1	2	3	0	0	3	0	0
21	26689875	.	T	A	5	4	9	0	1	10	0	0
21	26691889	.	T	C	3	3	6	0	1	7	0	0
21	26691898	.	A	T	3	5	8	0	0	8	0	0
21	26691926	.	A	T	4	5	9	0	0	9	0	0
21	26697686	.	G	T	25	35	60	1	2	63	0	0
21	26706481	.	C	T	36	25	61	0	3	64	0	0
21	26706482	.	C	T	37	26	63	0	1	64	0	0
21	26706805	.	C	T	33	28	61	0	0	61	0	0
21	26706846	.	T	A	28	19	47	0	1	48	0	0
21	26710071	.	A	G	11	20	31	0	2	33	0	0
21	26710194	.	T	A	20	20	40	0	0	40	0	0
21	26710239	.	G	A	15	21	36	0	1	37	0	0
21	26710496	.	C	A	21	24	45	0	1	46	0	0
21	26714361	.	C	T	0	4	4	0	2	6	0	0
21	26714373	.	C	A	0	3	3	0	0	3	0	0
21	26722212	.	G	C	1	2	3	0	1	4	0	0
21	26722269	.	C	T	5	9	14	0	0	14	0	0
21	26722347	.	G	A	5	10	15	0	1	16	0	0
21	26722431	.	T	C	2	4	6	0	0	6	0	0
21	26722625	.	C	T	6	6	12	0	0	12	0	0
21	26724723	.	G	A	21	12	33	0	3	36	0	0
21	26724833	.	A	G	15	18	33	0	1	34	0	0
21	26725403	.	T	C	24	12	36	0	3	39	0	0
21	26726997	.	C	A	25	17	42	0	3	45	0	0
21	26731236	.	C	A	37	30	67	0	1	68	0	0
21	26731925	.	C	A	32	33	65	0	3	68	0	0
21	26733517	.	A	G	3	3	6	0	0	6	0	0
21	26748227	.	T	C	1	2	3	0	0	3	0	0
21	26760016	.	G	A	1	1	2	0	0	2	0	0
21	26760073	.	G	A	0	3	3	0	1	4	0	0
21	26908810	.	G	A	8	23	31	0	1	32	0	0
21	26909361	.	G	A	15	11	26	0	1	27	0	0
21	26909560	.	A	C	11	0	11	0	14	25	0	0
21	26914870	.	T	G	16	9	25	0	1	26	0	0
21	26914915	.	T	G	17	9	26	0	0	26	0	0
21	26915086	.	G	A	7	12	19	0	1	20	0	0
21	26915203	.	A	G	8	8	16	0	0	16	0	0
21	26915316	.	T	G	3	6	9	0	1	10	0	0
21	26915355	.	G	A	8	3	11	0	1	12	0	0
21	26915956	.	A	T	5	6	11	0	0	11	0	0
21	26916142	.	A	G	3	5	8	0	0	8	0	0
21	26916238	.	C	T	0	5	5	0	5	10	0	0
21	26917948	.	C	T	9	4	13	0	0	13	0	0
21	26917958	.	C	T	0	3	3	0	7	10	0	0
21	26918684	.	G	A	3	6	9	0	0	9	0	0
21	26961177	.	C	T	16	14	30	0	0	30	0	0
21	26961515	.	C	T	8	6	14	0	0	14	0	0
21	26961548	.	C	A	2	2	4	0	0	4	0	0
21	26965636	.	C	T	10	5	15	0	0	15	0	0
21	26965918	.	A	T	19	6	25	0	2	27	0	0
21	26966193	.	A	T	7	13	20	0	1	21	0	0
21	26966918	.	C	T	8	9	17	0	1	18	0	0
21	26967230	.	C	T	9	11	20	0	1	21	0	0
21	26967265	.	T	A	11	9	20	0	1	21	0	0
21	26967426	.	G	A	18	10	28	0	0	28	0	0
21	26967899	.	A	C	10	27	37	0	0	37	0	0
21	26968042	.	G	A	18	12	30	0	0	30	0	0
21	26968127	.	G	T	10	18	28	0	1	29	0	0
21	26968264	.	G	A	21	15	36	0	3	39	0	0
21	26968344	.	G	A	11	13	24	0	0	24	0	0
21	26968478	.	G	A	17	9	26	0	0	26	0	0
21	26995869	.	G	A	11	4	15	0	0	15	0	0
21	26996005	.	A	G	12	9	21	0	1	22	0	0
21	26996849	.	C	A	1	18	19	0	25	44	0	0
21	26996893	.	T	C	20	1	21	0	23	44	0	0
21	27047839	.	A	T	12	13	25	0	0	25	0	0
21	27047955	.	G	A	20	12	32	0	3	35	0	0
21	27053121	.	A	G	6	11	17	0	0	17	0	0
21	27055995	.	G	A	0	2	2	0	0	2	0	0
21	27055998	.	G	T	3	0	3	0	0	3	0	0
21	27058274	.	C	G	3	3	6	0	0	6	0	0
21	27061097	.	C	T	0	3	3	0	0	3	0	0
21	27061178	.	C	T	2	2	4	0	0	4	0	0
21	27119465	.	C	T	0	1	1	0	0	1	0	0
21	27119723	.	G	A	6	13	19	0	0	19	0	0
21	27119735	.	T	A	12	5	17	0	3	20	0	0
21	27119786	.	G	A	10	12	22	0	1	23	0	0
21	27119945	.	A	T	3	5	8	0	0	8	0	0
21	27121852	.	G	A	4	4	8	0	0	8	0	0
21	27122116	.	C	T	5	4	9	0	1	10	0	0
21	27122533	.	G	A	3	4	7	0	0	7	0	0
21	27122560	.	G	A	2	4	6	0	0	6	0	0
21	27122620	.	C	T	1	6	7	0	0	7	0	0
21	27122725	.	G	A	7	7	14	0	1	15	0	0
21	27122920	.	G	A	3	2	5	0	0	5	0	0
21	27122980	.	C	T	0	6	6	0	7	13	0	0
21	27123089	.	G	A	4	5	9	0	0	9	0	0
21	27189570	.	C	A	2	6	8	0	1	9	0	0
21	27190033	.	G	A	0	0	0	0	2	2	0	0
21	27198018	.	T	G	10	12	22	0	0	22	0	0
21	27198159	.	C	T	1	19	20	0	13	33	0	0
21	27198227	.	G	T	15	24	39	0	1	40	0	0
21	27198405	.	C	T	9	8	17	0	3	20	0	0
21	27198548	.	T	C	1	4	5	0	0	5	0	0
21	27198583	.	T	C	2	0	2	0	3	5	0	0
21	27198967	.	A	G	2	4	6	0	0	6	0	0
21	27199383	.	C	T	0	3	3	0	16	21	2	0
21	27199893	.	G	A	12	5	17	0	1	18	0	0
21	27205050	.	G	A	15	9	24	0	2	26	0	0
21	27213101	.	G	A	1	2	3	0	1	4	0	0
21	27213212	.	A	G	10	11	21	0	0	21	0	0
21	27272878	.	C	T	0	3	3	0	1	4	0	0
21	27286876	.	A	T	3	2	5	0	0	5	0	0
21	27286888	.	A	G	2	4	6	0	0	6	0	0
21	27305739	.	T	G	7	7	14	0	0	14	0	0
21	27305794	.	C	T	10	12	22	0	0	22	0	0
21	27312644	.	A	G	15	12	27	0	1	28	0	0
21	27312962	.	G	A	5	8	13	0	0	13	0	0
21	27318274	.	G	T	8	4	12	0	2	14	0	0
21	27343611	.	C	T	1	2	3	0	0	3	0	0
21	27343814	.	G	A	0	5	5	0	0	5	0	0
21	27344065	.	A	G	0	2	2	0	0	2	0	0
21	27351007	.	C	T	5	3	8	0	1	9	0	0
21	27351316	.	T	C	3	3	6	0	0	6	0	0
21	27353478	.	A	G	10	8	18	0	0	18	0	0
21	27354142	.	C	A	8	6	14	0	0	14	0	0
21	27354147	.	T	C	6	5	11	0	2	13	0	0
21	27354434	.	C	A	8	9	17	0	0	17	0	0
21	27354505	.	T	C	15	4	19	0	0	19	0	0
21	27354602	.	G	T	4	5	9	0	0	9	0	0
21	27356913	.	G	A	1	1	2	0	1	3	0	0
21	27371467	.	T	A	0	1	1	0	0	1	0	0
21	27374812	.	T	C	4	3	7	0	2	9	0	0
21	27375199	.	A	G	9	7	16	0	1	17	0	0
21	27375247	.	C	T	4	6	10	0	0	10	0	0
21	27377354	.	C	A	18	10	28	0	3	31	0	0
21	27377815	.	G	A	0	3	3	0	1	4	0	0
21	27378011	.	A	C	7	5	12	0	0	12	0	0
21	27378269	.	T	A	3	4	7	0	0	7	0	0
21	27378388	.	T	G	5	7	12	0	1	13	0	0
21	27378663	.	G	A	0	4	4	0	6	10	0	0
21	27480748	.	G	C	1	2	3	0	0	3	0	0
21	27480789	.	G	A	1	3	4	0	0	4	0	0
21	27482264	.	G	A	3	2	5	0	0	5	0	0
21	27483882	.	G	A	2	1	3	0	0	3	0	0
21	27514002	.	T	A	2	4	6	0	0	6	0	0
21	27514139	.	T	G	3	1	4	0	1	5	0	0
21	27523049	.	G	A	0	1	1	0	1	2	0	0
21	27526408	.	C	T	1	0	1	0	0	1	0	0
21	27530414	.	C	A	1	2	3	0	0	3	0	0
21	27536026	.	G	A	0	1	1	0	3	4	0	0
21	27536471	.	T	C	1	1	2	0	0	2	0	0
21	27543557	.	G	A	0	6	6	0	0	6	0	0
21	27549452	.	C	T	0	1	1	0	0	1	0	0
21	27549548	.	G	A	2	3	5	0	1	6	0	0
21	27549667	.	G	A	3	3	6	0	0	6	0	0
21	27552349	.	A	G	1	0	1	0	3	4	0	0
21	27552667	.	A	G	11	0	11	0	13	24	0	0
21	27553372	.	C	A	3	2	5	0	0	5	0	0
21	27554837	.	T	C	12	6	18	0	0	18	0	0
21	27554904	.	A	G	13	13	26	0	0	26	0	0
21	27554986	.	C	T	4	5	9	0	0	9	0	0
21	27555177	.	T	A	3	3	6	0	0	6	0	0
21	27555331	.	G	A	6	5	11	0	1	12	0	0
21	27575776	.	G	A	4	3	7	0	0	7	0	0
21	27578726	.	A	G	1	2	3	0	0	3	0	0
21	27578772	.	C	T	0	4	4	0	1	5	0	0
21	27578814	.	G	A	1	3	4	0	0	4	0	0
21	27586827	.	C	T	0	2	2	0	1	3	0	0
21	27586876	.	A	G	0	1	1	0	0	1	0	0
21	27610117	.	C	T	1	2	3	0	0	3	0	0
21	27636733	.	C	A	16	18	34	0	2	36	0	0
21	27636739	.	G	A	17	19	36	0	2	38	0	0
21	27637171	.	C	T	2	17	19	0	17	36	0	0
21	27637701	.	G	A	11	18	29	0	2	31	0	0
21	27637729	.	C	A	1	21	22	0	16	39	1	0
21	27637912	.	G	A	22	18	40	0	3	43	0	0
21	27637951	.	A	G	16	24	40	0	3	43	0	0
21	27637993	.	G	A	19	22	41	0	4	45	0	0
21	27638260	.	A	G	5	8	13	0	0	13	0	0
21	27657331	.	T	A	2	10	12	0	0	12	0	0
21	27657475	.	A	G	17	13	30	0	1	31	0	0
21	27669178	.	C	T	0	0	0	0	3	3	0	0
21	27880547	.	G	A	7	3	10	0	1	11	0	0
21	27880607	.	C	T	0	9	9	0	5	14	0	0
21	27881041	.	G	T	6	9	15	0	0	15	0	0
21	27881043	.	G	C	6	0	6	0	9	15	0	0
21	27881449	.	A	G	5	3	8	0	1	9	0	0
21	27881474	.	C	T	2	5	7	0	0	7	0	0
21	27881577	.	A	G	7	7	14	0	0	14	0	0
21	27881609	.	C	T	0	5	5	0	7	12	0	0
21	27881729	.	C	T	0	4	4	0	10	14	0	0
21	28051119	.	A	G	2	1	3	0	0	3	0	0
21	28076821	.	A	G	0	2	2	0	0	2	0	0
21	28082551	.	G	A	2	0	2	0	0	2	0	0
21	28089491	.	C	T	2	1	3	0	0	3	0	0
21	28089512	.	A	G	2	2	4	0	0	4	0	0
21	28235740	.	G	T	0	2	2	0	0	2	0	0
21	28496276	.	T	C	19	19	38	0	1	39	0	0
21	28500394	.	A	G	24	39	63	0	1	64	0	0
21	28500561	.	C	T	37	20	57	0	1	58	0	0
21	28512642	.	C	T	16	13	29	0	2	31	0	0
21	28512800	.	G	T	8	9	17	0	0	17	0	0
21	28555436	.	C	T	0	3	3	0	3	6	0	0
21	28555442	.	A	G	3	3	6	0	0	6	0	0
21	29075234	.	T	G	13	8	21	0	2	23	0	0
21	29075235	.	T	G	18	3	21	0	2	23	0	0
21	30270012	.	T	G	3	3	6	0	9	15	0	0
21	30270015	.	C	G	0	3	3	0	13	16	0	0
21	30692616	.	A	G	6	0	6	0	1	7	0	0
21	30692632	.	A	G	4	3	7	0	1	8	0	0
21	30692817	.	A	G	2	0	2	0	5	7	0	0
21	31151130	.	T	G	4	5	9	0	0	9	0	0
21	31151144	.	G	T	0	7	7	0	4	12	1	0
21	31160054	.	T	C	11	4	15	0	0	15	0	0
21	31167452	.	T	A	8	6	14	0	0	14	0	0
21	31167528	.	G	T	9	8	17	0	2	19	0	0
21	31176240	.	A	G	9	11	20	0	1	21	0	0
21	31183375	.	G	A	13	10	23	0	3	26	0	0
21	31183501	.	T	C	13	14	27	0	2	29	0	0
21	31183734	.	T	C	17	10	27	0	0	27	0	0
21	31183837	.	A	T	13	5	18	0	0	18	0	0
21	31233103	.	T	A	7	4	11	0	1	12	0	0
21	31233389	.	A	G	10	4	14	0	0	14	0	0
21	31233579	.	G	C	9	10	19	0	1	20	0	0
21	31233657	.	G	A	15	14	29	0	2	31	0	0
21	31237428	.	A	G	4	0	4	0	0	4	0	0
21	31237941	.	A	G	7	6	13	0	2	15	0	0
21	31238439	.	T	C	15	6	21	0	0	21	0	0
21	31241015	.	T	C	4	3	7	0	0	7	0	0
21	31241079	.	G	C	11	8	19	0	1	20	0	0
21	31271741	.	T	C	1	0	1	0	0	1	0	0
21	31271962	.	A	G	1	0	1	0	0	1	0	0
21	32281076	.	G	A	4	4	8	0	0	8	0	0
21	32281122	.	G	A	3	7	10	0	1	11	0	0
21	32281155	.	G	A	4	9	13	0	0	13	0	0
21	32281680	.	C	T	2	2	4	0	0	4	0	0
21	32283519	.	G	A	1	2	3	0	0	3	0	0
21	32284398	.	A	G	2	1	3	0	0	3	0	0
21	32343230	.	C	A	3	1	4	0	0	4	0	0
21	32343248	.	C	A	5	2	7	0	0	7	0	0
21	32343316	.	T	A	8	7	15	0	0	15	0	0
21	32343453	.	C	T	4	7	11	0	1	12	0	0
21	32343577	.	T	C	3	6	9	0	0	9	0	0
21	32343649	.	C	A	4	8	12	0	0	12	0	0
21	32343721	.	T	G	6	0	6	0	3	9	0	0
21	32345162	.	T	C	5	3	8	0	0	8	0	0
21	32345318	.	G	A	0	6	6	0	3	9	0	0
21	32345499	.	A	G	2	2	4	0	1	5	0	0
21	32345607	.	C	T	4	8	12	0	0	12	0	0
21	32345724	.	A	G	5	2	7	0	0	7	0	0
21	32345749	.	A	G	7	1	8	0	0	8	0	0
21	32345774	.	A	T	10	2	12	0	0	12	0	0
21	32345899	.	G	A	0	2	2	0	2	4	0	0
21	32346021	.	A	C	2	6	8	0	1	9	0	0
21	32346273	.	G	A	15	22	37	0	0	37	0	0
21	32346603	.	G	C	14	15	29	0	1	30	0	0
21	32346630	.	T	C	11	16	27	0	0	27	0	0
21	32346674	.	T	A	12	17	29	0	0	29	0	0
21	32346689	.	A	G	12	13	25	0	2	27	0	0
21	32346799	.	G	A	13	14	27	0	3	30	0	0
21	32346800	.	T	A	13	14	27	0	3	30	0	0
21	32346899	.	A	G	21	8	29	0	1	30	0	0
21	32346901	.	A	G	22	8	30	0	0	30	0	0
21	32347134	.	T	A	20	12	32	0	0	32	0	0
21	32347569	.	G	T	23	9	32	0	0	32	0	0
21	32347855	.	T	C	10	15	25	0	0	25	0	0
21	32347966	.	A	C	7	1	8	0	15	23	0	0
21	32348230	.	A	T	12	9	21	0	4	25	0	0
21	32348321	.	C	A	3	2	5	0	1	6	0	0
21	32348523	.	G	A	10	7	17	0	0	17	0	0
21	32348600	.	C	T	15	4	19	0	2	21	0	0
21	32348667	.	G	C	15	16	31	0	0	31	0	0
21	32348919	.	C	T	0	10	10	0	11	21	0	0
21	32349000	.	G	A	7	20	27	0	2	29	0	0
21	32349023	.	G	C	6	17	23	0	4	27	0	0
21	32349055	.	C	T	12	10	22	0	1	23	0	0
21	32353049	.	G	A	3	2	5	0	0	5	0	0
21	32354980	.	A	G	7	8	15	0	0	15	0	0
21	32374460	.	A	T	8	7	15	0	0	15	0	0
21	32457252	.	A	G	1	4	5	0	0	5	0	0
21	32457785	.	T	C	6	12	18	0	2	20	0	0
21	32457931	.	T	G	20	12	32	0	0	32	0	0
21	32457983	.	G	A	15	16	31	0	1	32	0	0
21	32458261	.	A	G	20	25	45	0	2	47	0	0
21	32458315	.	T	A	15	18	33	0	2	35	0	0
21	32460782	.	G	C	1	1	2	0	0	2	0	0
21	32460912	.	A	G	11	6	17	0	1	18	0	0
21	32466140	.	G	C	7	4	11	0	1	12	0	0
21	32467660	.	A	G	8	18	26	0	1	27	0	0
21	32467724	.	T	C	22	13	35	0	2	37	0	0
21	32476760	.	A	G	22	25	47	0	0	47	0	0
21	32477584	.	T	C	24	18	42	0	1	43	0	0
21	32477967	.	C	T	22	25	47	0	1	48	0	0
21	32477987	.	A	T	20	19	39	0	10	49	0	0
21	32478227	.	G	T	14	15	29	0	0	29	0	0
21	32482797	.	C	T	10	9	19	0	1	20	0	0
21	32482854	.	T	C	22	0	22	0	16	38	0	0
21	32486997	.	A	T	4	3	7	0	0	7	0	0
21	32758254	.	G	A	10	8	18	0	0	18	0	0
21	32758351	.	C	T	9	7	16	0	2	18	0	0
21	32758584	.	G	A	14	14	28	0	1	29	0	0
21	32759421	.	C	T	9	5	14	0	0	14	0	0
21	32766389	.	G	A	15	8	23	0	0	23	0	0
21	32772450	.	G	A	1	1	2	0	0	2	0	0
21	33058940	.	G	C	6	9	15	0	2	17	0	0
21	33066214	.	T	G	3	3	6	0	0	6	0	0
21	33069896	.	A	G	4	1	5	0	1	6	0	0
21	33211506	.	T	A	11	8	19	0	0	19	0	0
21	33211568	.	C	T	7	13	20	0	0	20	0	0
21	33211664	.	T	G	9	9	18	0	1	19	0	0
21	33211720	.	A	T	6	2	8	0	2	10	0	0
21	33211809	.	A	T	14	13	27	0	1	28	0	0
21	33213315	.	C	T	5	7	12	0	0	12	0	0
21	33213384	.	G	A	5	0	5	0	0	5	0	0
21	33218312	.	T	C	0	3	3	0	0	3	0	0
21	33218405	.	G	A	2	8	10	0	0	10	0	0
21	33249606	.	T	A	1	2	3	0	0	3	0	0
21	33447251	.	A	G	7	16	23	0	3	26	0	0
21	33463486	.	A	G	2	3	5	0	0	5	0	0
21	34001982	.	C	T	12	10	22	0	2	24	0	0
21	34002041	.	C	A	11	12	23	0	1	24	0	0
21	34002154	.	A	C	7	6	13	0	1	14	0	0
21	34002155	.	A	T	7	7	14	0	0	14	0	0
21	34002333	.	T	C	4	6	10	0	0	10	0	0
21	34002455	.	G	A	3	12	15	0	0	15	0	0
21	34002507	.	A	G	5	10	15	0	0	15	0	0
21	34026657	.	T	C	1	2	3	0	0	3	0	0
21	34031232	.	G	A	3	7	10	0	0	10	0	0
21	34057611	.	T	G	3	10	13	0	0	13	0	0
21	34074618	.	A	G	6	4	10	0	0	10	0	0
21	34074684	.	G	A	3	7	10	0	0	10	0	0
21	34074712	.	T	C	5	8	13	0	0	13	0	0
21	34119828	.	C	T	0	2	2	0	0	2	0	0
21	34128660	.	A	G	6	7	13	0	0	13	0	0
21	34129007	.	C	G	1	0	1	0	2	3	0	0
21	34129073	.	G	C	13	14	27	0	0	27	0	0
21	34129195	.	G	T	8	13	21	0	2	23	0	0
21	34129279	.	A	G	7	24	31	0	3	34	0	0
21	34129401	.	T	A	11	6	17	0	0	17	0	0
21	34129629	.	A	G	2	5	7	0	0	7	0	0
21	34199704	.	T	C	1	5	6	0	0	6	0	0
21	34211093	.	G	A	0	7	7	0	6	13	0	0
21	34364472	.	T	A	9	13	22	0	0	22	0	0
21	34364595	.	G	A	6	10	16	0	0	16	0	0
21	34365167	.	T	A	8	6	14	0	2	16	0	0
21	34391104	.	C	T	10	6	16	0	1	17	0	0
21	34391155	.	T	C	0	5	5	0	0	5	0	0
21	34392843	.	C	T	4	5	9	0	0	9	0	0
21	34424086	.	C	T	0	4	4	0	3	7	0	0
21	34424116	.	A	G	5	10	15	0	0	15	0	0
21	34428080	.	G	A	2	3	5	0	0	5	0	0
21	34430533	.	A	G	4	7	11	0	0	11	0	0
21	34430544	.	A	G	6	5	11	0	0	11	0	0
21	37107035	.	T	A	13	17	30	0	3	33	0	0
21	37107307	.	G	A	7	6	13	0	0	13	0	0
21	37107432	.	A	T	11	5	16	0	0	16	0	0
21	37107614	.	T	C	8	7	15	0	1	16	0	0
21	37107861	.	T	C	12	7	19	0	0	19	0	0
21	37108022	.	A	G	7	10	17	0	2	19	0	0
21	37108204	.	A	T	13	12	25	0	0	26	1	0
21	37384348	.	G	A	1	7	8	0	0	8	0	0
21	37397952	.	A	C	2	1	3	0	3	6	0	0
21	37690002	.	T	C	2	6	8	0	0	8	0	0
21	37690017	.	T	C	5	3	8	0	0	8	0	0
21	38587378	.	T	C	12	11	23	0	1	24	0	0
21	38789732	.	C	T	0	5	5	0	0	5	0	0
21	39509717	.	A	G	1	2	3	0	0	3	0	0
21	39511615	.	A	G	5	3	8	0	0	8	0	0
21	40045569	.	G	T	6	10	16	0	0	16	0	0
21	40045665	.	G	A	15	10	25	0	0	25	0	0
21	40045701	.	G	A	14	8	22	0	2	24	0	0
21	40045754	.	G	A	0	2	2	0	0	2	0	0
21	40048981	.	C	A	0	1	1	0	1	2	0	0
21	40049524	.	A	G	4	2	6	0	1	7	0	0
21	40049556	.	T	G	6	3	9	0	2	11	0	0
21	40049606	.	T	G	3	3	6	0	0	6	0	0
21	40355063	.	A	C	7	5	12	0	0	12	0	0
21	40355102	.	G	A	5	4	9	0	0	9	0	0
21	40355539	.	G	T	10	8	18	0	1	19	0	0
21	40355710	.	A	T	9	9	18	0	2	20	0	0
21	40355764	.	C	T	8	5	13	0	1	14	0	0
21	40355968	.	T	A	7	4	11	0	0	11	0	0
21	40364758	.	C	A	7	4	11	0	0	11	0	0
21	40365356	.	G	T	7	2	9	0	1	10	0	0
21	40368568	.	A	G	0	2	2	0	0	2	0	0
21	40368991	.	C	T	1	0	1	0	0	1	0	0
21	40369108	.	C	T	0	3	3	0	5	8	0	0
21	40373048	.	G	T	4	5	9	0	0	9	0	0
21	40373049	.	G	T	4	5	9	0	0	9	0	0
21	40373086	.	A	T	5	2	7	0	0	7	0	0
21	40373137	.	C	T	0	5	5	0	3	8	0	0
21	40377861	.	A	G	3	3	6	0	1	7	0	0
21	40377895	.	A	G	0	1	1	0	1	2	0	0
21	40377904	.	G	A	0	2	2	0	0	2	0	0
21	40381967	.	C	T	1	1	2	0	1	3	0	0
21	40382278	.	C	T	0	3	3	0	4	7	0	0
21	40386112	.	G	A	2	2	4	0	1	5	0	0
21	40391928	.	G	A	2	2	4	0	0	4	0	0
21	40391961	.	G	A	2	2	4	0	0	4	0	0
21	40402621	.	G	A	4	3	7	0	0	7	0	0
21	40402659	.	A	G	3	5	8	0	0	8	0	0
21	40402864	.	C	T	0	9	9	0	7	16	0	0
21	40403423	.	A	G	8	16	24	0	1	25	0	0
21	40403465	.	G	A	13	7	20	0	1	21	0	0
21	40403581	.	G	C	4	1	5	0	1	6	0	0
21	40406796	.	C	A	9	3	12	0	0	12	0	0
21	40410983	.	T	A	0	2	2	0	1	3	0	0
21	40411505	.	G	T	0	3	3	0	0	3	0	0
21	40464991	.	T	C	0	4	4	0	0	4	0	0
21	40466711	.	G	A	0	3	3	0	5	8	0	0
21	40466893	.	C	T	4	4	8	0	0	8	0	0
21	40467039	.	C	T	2	4	6	0	0	6	0	0
21	40467126	.	G	A	0	6	6	0	3	9	0	0
21	40474875	.	G	A	7	4	11	0	0	11	0	0
21	40475127	.	C	G	6	0	6	0	3	9	0	0
21	40475427	.	C	T	6	8	14	0	0	14	0	0
21	40475563	.	C	G	3	7	10	0	1	11	0	0
21	40528986	.	C	T	12	20	32	0	2	34	0	0
21	40531316	.	C	T	6	16	22	0	3	25	0	0
21	40531615	.	G	A	7	15	22	0	2	24	0	0
21	40531993	.	G	A	13	5	18	0	0	18	0	0
21	40532147	.	A	G	7	8	15	0	0	15	0	0
21	40532204	.	A	G	2	8	10	0	0	10	0	0
21	40532368	.	T	C	3	5	8	0	0	8	0	0
21	40532584	.	T	G	5	6	11	0	0	11	0	0
21	40532649	.	T	C	8	0	8	0	3	11	0	0
21	40532665	.	T	C	6	3	9	0	0	9	0	0
21	40532848	.	G	A	9	5	14	0	0	14	0	0
21	40532931	.	G	C	3	7	10	0	1	11	0	0
21	40533039	.	T	C	6	7	13	0	0	13	0	0
21	40533165	.	A	G	7	8	15	0	0	15	0	0
21	40537149	.	C	T	9	4	13	0	2	15	0	0
21	40537152	.	G	A	9	6	15	0	0	15	0	0
21	40537188	.	A	G	9	10	19	0	0	19	0	0
21	40546922	.	T	C	10	7	17	0	0	17	0	0
21	40547729	.	G	A	0	6	6	0	1	7	0	0
21	40553356	.	G	T	1	1	2	0	0	2	0	0
21	40553365	.	C	T	0	1	1	0	0	1	0	0
21	40553547	.	C	T	0	7	7	0	5	12	0	0
21	40562600	.	G	A	4	1	5	0	0	5	0	0
21	40579746	.	C	A	5	5	10	0	0	10	0	0
21	40685948	.	A	G	7	0	7	0	8	15	0	0
21	40685964	.	A	C	6	7	13	0	0	13	0	0
21	40686109	.	G	A	3	8	11	0	0	11	0	0
21	40709069	.	G	A	3	3	6	0	0	6	0	0
21	40709089	.	G	A	1	2	3	0	0	3	0	0
21	40709140	.	A	T	3	2	5	0	0	5	0	0
21	40714691	.	C	T	10	7	17	0	0	17	0	0
21	40715622	.	A	G	0	1	1	0	0	1	0	0
21	40715730	.	T	C	4	4	8	0	1	9	0	0
21	40715808	.	A	G	3	1	4	0	0	4	0	0
21	40731482	.	A	G	1	0	1	0	0	1	0	0
21	40936544	.	G	A	2	0	2	0	0	2	0	0
21	40944590	.	A	C	3	3	6	0	0	6	0	0
21	40944607	.	G	A	3	3	6	0	0	6	0	0
21	41029033	.	A	C	3	6	9	0	0	9	0	0
21	41029134	.	A	T	3	3	6	0	0	6	0	0
21	41029378	.	A	G	2	3	5	0	0	5	0	0
21	41034863	.	A	G	2	0	2	0	0	2	0	0
21	41046647	.	T	A	2	1	3	0	0	3	0	0
21	41046745	.	T	A	0	1	1	0	0	1	0	0
21	41046746	.	G	C	0	1	1	0	0	1	0	0
21	41049005	.	G	A	0	1	1	0	0	1	0	0
21	41598942	.	G	C	5	8	13	0	0	13	0	0
21	41598961	.	T	C	4	0	4	0	11	15	0	0
21	41599060	.	T	C	1	10	11	0	1	12	0	0
21	42046871	.	T	C	21	1	22	3	3	28	0	0
21	42046874	.	G	A	23	1	24	3	1	28	0	0
21	42046969	.	G	A	0	7	7	9	0	16	0	0
21	42051117	.	G	C	6	2	8	0	28	36	0	0
21	42777796	.	G	C	1	0	1	0	1	2	0	0
21	42971463	.	T	C	21	18	39	0	7	46	0	0
21	42971464	.	T	C	33	9	42	0	4	46	0	0
21	43461082	.	T	C	4	2	6	0	0	6	0	0
21	43477593	.	T	C	20	6	26	0	1	27	0	0
21	43477858	.	T	C	11	15	26	0	0	26	0	0
21	44553806	.	A	G	2	1	3	0	0	3	0	0
21	44556241	.	C	G	3	6	9	0	0	9	0	0
21	44558693	.	C	T	4	8	12	0	1	13	0	0
21	44558697	.	T	C	4	8	12	0	0	12	0	0
21	44558898	.	T	C	22	0	22	0	15	37	0	0
21	44559095	.	C	T	17	17	34	0	1	35	0	0
21	44561900	.	A	G	3	1	4	0	1	5	0	0
21	44563129	.	T	A	10	9	19	0	0	19	0	0
21	44581947	.	C	T	4	2	6	0	0	6	0	0
21	44581948	.	C	A	4	1	5	0	1	6	0	0
21	44618620	.	G	A	0	3	3	0	3	6	0	0
21	44777084	.	G	A	0	3	3	0	2	5	0	0
21	44777617	.	G	T	0	1	1	0	2	3	0	0
21	44777713	.	T	C	2	3	5	0	0	5	0	0
21	44781745	.	A	G	10	5	15	0	2	17	0	0
21	44784156	.	A	G	9	0	9	0	8	17	0	0
21	44784223	.	A	G	10	0	10	0	14	24	0	0
21	44784493	.	G	T	13	6	19	0	1	20	0	0
21	44784589	.	T	C	4	7	11	0	0	11	0	0
21	44784663	.	C	T	4	3	7	0	0	7	0	0
21	45039897	.	G	A	2	0	2	0	0	2	0	0
21	45114642	.	T	A	1	2	3	0	0	3	0	0
21	45114925	.	G	A	0	2	2	0	3	5	0	0
21	45117465	.	T	C	3	6	9	0	0	9	0	0
21	45117469	.	T	G	3	5	8	0	1	9	0	0
21	45182345	.	A	G	2	3	5	0	1	6	0	0
21	45182488	.	G	A	5	6	11	0	0	11	0	0
21	45182566	.	C	T	3	13	16	0	0	16	0	0
21	45185829	.	A	G	5	5	10	0	0	10	0	0
21	45186175	.	G	A	12	13	25	0	1	26	0	0
21	45187072	.	T	G	15	6	21	0	1	22	0	0
21	45187248	.	A	G	1	3	4	0	0	4	0	0
21	45187258	.	G	A	1	2	3	0	0	3	0	0
21	45190709	.	T	A	24	23	47	0	2	49	0	0
21	45190754	.	C	T	2	27	29	0	23	52	0	0
21	45190884	.	G	A	26	27	53	0	2	55	0	0
21	45190926	.	C	T	28	19	47	0	0	47	0	0
21	45190975	.	C	T	19	25	44	0	1	45	0	0
21	45190984	.	T	C	21	23	44	0	2	46	0	0
21	45191163	.	A	T	28	35	63	0	3	66	0	0
21	45193365	.	G	A	8	4	12	0	0	12	0	0
21	45198712	.	C	T	1	14	15	0	18	33	0	0
21	45341795	.	C	T	1	3	4	0	0	4	0	0
21	45352415	.	C	T	0	14	14	0	6	20	0	0
21	45356811	.	T	G	10	7	17	0	0	17	0	0
21	45359397	.	G	A	16	14	30	0	2	32	0	0
21	45363684	.	C	T	11	16	27	0	1	28	0	0
21	45363728	.	C	T	13	19	32	0	0	32	0	0
21	45363778	.	T	G	15	23	38	0	2	40	0	0
21	45366262	.	T	A	6	5	11	0	0	11	0	0
21	45366268	.	C	T	7	7	14	0	0	14	0	0
21	45366301	.	A	C	8	11	19	0	0	19	0	0
21	45374386	.	A	G	8	4	12	0	0	12	0	0
21	45374439	.	C	T	15	11	26	0	0	26	0	0
21	45374509	.	T	C	9	10	19	0	2	21	0	0
21	45375109	.	G	T	6	5	11	0	0	11	0	0
21	45377351	.	G	T	8	8	16	0	0	16	0	0
21	45377404	.	T	C	9	12	21	0	0	21	0	0
21	45377409	.	T	C	9	11	20	0	1	21	0	0
21	45377604	.	T	G	4	14	18	0	1	19	0	0
21	45382032	.	G	A	20	13	33	0	1	34	0	0
21	45382162	.	G	A	1	2	3	0	0	3	0	0
21	45386175	.	C	T	4	2	6	0	0	6	0	0
21	45393627	.	C	T	1	2	3	0	0	3	0	0
21	45398178	.	T	C	0	3	3	0	0	3	0	0
21	45410019	.	G	A	0	5	5	0	4	9	0	0
21	45410118	.	T	C	4	3	7	0	0	7	0	0
21	45410132	.	A	G	3	2	5	0	0	5	0	0
21	45410601	.	G	A	1	2	3	0	1	4	0	0
21	45521741	.	C	T	0	2	2	0	0	2	0	0
21	45544374	.	C	T	5	5	10	0	0	10	0	0
21	45544384	.	A	G	7	0	7	0	4	11	0	0
21	45544709	.	A	G	3	4	7	0	0	7	0	0
21	45673964	.	A	T	18	6	24	2	0	26	0	0
21	45688148	.	G	A	0	5	5	0	3	8	0	0
21	45768787	.	A	T	1	4	5	0	0	5	0	0
21	45918722	.	A	G	1	4	5	0	0	5	0	0
22	1392902	.	G	C	0	2	2	0	0	2	0	0
22	1432198	.	C	T	1	9	10	0	0	10	0	0
22	1899945	.	A	G	0	2	2	0	0	2	0	0
22	2348129	.	A	G	0	1	1	0	1	2	0	0
22	2348132	.	G	A	0	1	1	0	0	1	0	0
22	2374066	.	C	T	3	1	4	0	0	4	0	0
22	2374088	.	T	C	0	5	5	0	0	5	0	0
22	2411961	.	C	G	1	0	1	0	0	1	0	0
22	2411966	.	A	G	1	0	1	0	0	1	0	0
22	2627483	.	A	G	0	0	0	0	6	6	0	0
22	2627773	.	A	T	1	6	7	0	0	7	0	0
22	4962472	.	T	A	4	7	11	0	0	11	0	0
22	4962559	.	G	A	8	13	21	0	2	23	0	0
22	4962610	.	A	T	8	11	19	0	0	19	0	0
22	4962635	.	A	G	9	12	21	0	0	21	0	0
22	4962696	.	T	C	1	0	1	0	0	1	0	0
22	4962878	.	G	A	10	12	22	0	0	22	0	0
22	4968955	.	A	G	2	4	6	0	1	7	0	0
22	4969051	.	G	A	7	7	14	0	0	14	0	0
22	4970773	.	T	C	1	0	1	0	3	4	0	0
22	4970797	.	G	C	3	2	5	0	1	6	0	0
22	4972848	.	T	G	6	15	21	0	2	24	1	0
22	4972980	.	C	T	0	4	4	0	3	7	0	0
22	4975236	.	T	A	5	17	22	0	3	25	0	0
22	4977106	.	G	A	4	6	10	0	0	10	0	0
22	4979470	.	C	T	1	6	7	0	0	7	0	0
22	5056425	.	G	T	10	8	18	0	2	20	0	0
22	5056706	.	G	A	7	4	11	0	1	12	0	0
22	5056760	.	T	G	14	8	22	0	0	22	0	0
22	5056978	.	A	T	7	5	12	0	1	13	0	0
22	5057421	.	C	A	0	10	10	0	14	24	0	0
22	5057443	.	T	C	8	0	8	0	14	22	0	0
22	5057489	.	T	A	8	6	14	0	0	14	0	0
22	5057504	.	T	A	8	5	13	0	1	14	0	0
22	5059916	.	A	G	7	4	11	0	0	11	0	0
22	5060087	.	T	G	2	0	2	0	0	2	0	0
22	5060162	.	T	A	0	1	1	0	1	2	0	0
22	5062457	.	G	A	0	2	2	0	0	2	0	0
22	5075390	.	A	G	1	0	1	0	0	1	0	0
22	5075673	.	A	G	2	7	9	0	1	10	0	0
22	5075732	.	T	C	1	4	5	0	0	5	0	0
22	5087451	.	G	A	6	8	14	0	0	14	0	0
22	5087488	.	G	A	6	7	13	0	1	14	0	0
22	5090115	.	C	A	0	2	2	0	0	2	0	0
22	5098433	.	G	T	7	5	12	0	0	12	0	0
22	5112644	.	G	T	1	3	4	0	1	5	0	0
22	5112749	.	T	C	6	4	10	0	1	11	0	0
22	5112864	.	G	A	5	3	8	0	0	8	0	0
22	5112915	.	A	C	5	3	8	0	0	8	0	0
22	5114380	.	G	C	0	7	7	0	15	22	0	0
22	5116267	.	A	C	9	8	17	0	0	17	0	0
22	5118373	.	A	G	2	0	2	0	3	5	0	0
22	5118378	.	G	A	0	3	3	0	2	5	0	0
22	5118437	.	C	T	3	4	7	0	0	7	0	0
22	5121464	.	C	T	4	1	5	0	0	5	0	0
22	5121471	.	C	T	4	1	5	0	0	5	0	0
22	5121623	.	A	G	2	0	2	0	3	5	0	0
22	5140840	.	C	T	0	4	4	0	2	6	0	0
22	5140851	.	C	G	4	2	6	0	0	6	0	0
22	5144566	.	G	C	6	4	10	0	1	11	0	0
22	5144645	.	C	T	8	7	15	0	0	15	0	0
22	5144750	.	T	A	2	3	5	0	1	6	0	0
22	5144981	.	T	C	4	3	7	0	1	8	0	0
22	5145109	.	C	A	4	4	8	0	0	8	0	0
22	5228744	.	G	A	0	5	5	0	4	9	0	0
22	5229048	.	G	A	6	4	10	0	3	13	0	0
22	5229077	.	T	C	8	6	14	0	0	14	0	0
22	5229267	.	A	C	0	11	11	0	0	11	0	0
22	5230339	.	A	G	10	4	14	0	1	15	0	0
22	5230570	.	T	A	2	2	4	0	0	4	0	0
22	5230977	.	A	C	7	2	9	0	1	10	0	0
22	5413696	.	C	T	0	2	2	0	0	2	0	0
22	5756066	.	G	A	6	7	13	0	0	13	0	0
22	5756317	.	C	T	5	2	7	0	0	7	0	0
22	5758678	.	C	T	7	9	16	0	2	18	0	0
22	5758689	.	A	T	7	7	14	0	2	16	0	0
22	5761968	.	G	A	0	2	2	0	0	2	0	0
22	5762097	.	C	T	2	0	2	0	0	2	0	0
22	5763846	.	G	A	1	3	4	0	0	4	0	0
22	5763881	.	A	G	1	0	1	0	0	1	0	0
22	6074074	.	T	C	1	0	1	0	0	1	0	0
22	6074079	.	A	T	1	0	1	0	0	1	0	0
22	6075145	.	A	T	1	5	6	0	0	6	0	0
22	6075180	.	G	A	1	2	3	0	0	3	0	0
22	6075652	.	G	T	0	5	5	0	1	6	0	0
22	6075656	.	T	G	0	7	7	0	0	7	0	0
22	6077657	.	T	C	1	0	1	0	2	3	0	0
22	6078223	.	C	A	1	4	5	0	1	6	0	0
22	6078310	.	C	G	0	5	5	0	0	5	0	0
22	6300409	.	G	T	2	3	5	0	0	5	0	0
22	6300447	.	C	T	1	4	5	0	0	5	0	0
22	6300506	.	A	G	3	4	7	0	0	7	0	0
22	6300543	.	G	A	0	3	3	0	0	3	0	0
22	6302544	.	G	C	3	5	8	0	0	8	0	0
22	6302548	.	G	A	3	5	8	0	0	8	0	0
22	6302717	.	T	C	1	0	1	0	2	3	0	0
22	6314629	.	G	A	3	2	5	0	0	5	0	0
22	6487855	.	T	G	7	9	16	0	1	17	0	0
22	6487920	.	C	A	4	6	10	0	0	10	0	0
22	6487932	.	A	G	4	5	9	0	0	9	0	0
22	6488007	.	T	G	3	6	9	0	1	10	0	0
22	6488050	.	A	T	5	10	15	0	0	15	0	0
22	6488068	.	G	A	7	10	17	0	0	17	0	0
22	6488117	.	A	G	8	7	15	0	0	15	0	0
22	6488129	.	C	G	7	6	13	0	1	14	0	0
22	6488204	.	G	A	13	6	19	0	0	19	0	0
22	6488261	.	A	G	7	11	18	0	0	18	0	0
22	6488266	.	A	C	6	12	18	0	0	18	0	0
22	6488313	.	T	A	1	10	11	0	0	11	0	0
22	6488364	.	A	G	4	5	9	0	0	9	0	0
22	6488433	.	G	T	4	5	9	0	3	12	0	0
22	6488528	.	G	C	4	0	4	0	5	9	0	0
22	6488548	.	T	C	6	4	10	0	0	10	0	0
22	6488565	.	A	G	4	3	7	0	0	7	0	0
22	6488598	.	G	T	5	4	9	0	0	9	0	0
22	6527546	.	C	T	8	7	15	0	1	16	0	0
22	6527758	.	G	T	2	2	4	0	1	5	0	0
22	6528134	.	A	G	3	4	7	2	0	9	0	0
22	6528151	.	T	C	3	2	5	1	0	6	0	0
22	6528177	.	C	T	0	2	2	0	3	5	0	0
22	6528247	.	A	G	9	3	12	0	0	12	0	0
22	6528274	.	C	A	0	2	2	0	8	10	0	0
22	6528284	.	T	G	9	2	11	0	0	11	0	0
22	6528445	.	C	A	7	4	11	0	1	12	0	0
22	6528446	.	A	G	8	4	12	0	0	12	0	0
22	6528586	.	C	T	4	5	9	0	1	10	0	0
22	6529143	.	T	C	1	0	1	0	3	4	0	0
22	6529158	.	T	A	3	3	6	0	0	6	0	0
22	6548182	.	A	C	2	4	6	0	0	6	0	0
22	6766368	.	G	A	1	2	3	0	0	3	0	0
22	6996116	.	T	C	6	1	7	0	6	13	0	0
22	6996343	.	G	A	4	5	9	0	0	9	0	0
22	6998904	.	A	G	11	8	19	0	4	23	0	0
22	6998949	.	G	T	13	5	18	0	2	20	0	0
22	6998988	.	T	C	11	10	21	0	1	22	0	0
22	6999006	.	A	G	9	9	18	0	0	18	0	0
22	7001474	.	G	T	1	0	1	0	0	1	0	0
22	7001528	.	C	T	2	2	4	0	1	5	0	0
22	7003603	.	A	G	1	4	5	0	0	5	0	0
22	7009333	.	A	T	15	8	23	0	1	24	0	0
22	7009393	.	A	G	5	7	12	0	0	12	0	0
22	7009833	.	C	T	5	6	11	0	1	12	0	0
22	7009835	.	T	G	6	6	12	0	0	12	0	0
22	7009911	.	A	G	9	7	16	0	0	16	0	0
22	7009915	.	C	T	1	7	8	0	8	16	0	0
22	7010011	.	A	C	18	12	30	0	0	30	0	0
22	7010100	.	T	C	20	0	20	0	20	40	0	0
22	7010151	.	T	C	13	12	25	0	1	26	0	0
22	7012898	.	C	T	0	7	7	0	10	17	0	0
22	7012931	.	C	G	6	5	11	0	0	11	0	0
22	7016655	.	A	G	3	7	10	0	1	11	0	0
22	7018223	.	G	A	4	5	9	0	1	10	0	0
22	7019397	.	C	A	0	10	10	0	5	15	0	0
22	7044634	.	C	G	11	4	15	0	0	15	0	0
22	7044667	.	T	G	3	5	8	0	0	8	0	0
22	7044681	.	T	C	2	2	4	0	1	5	0	0
22	7045031	.	G	A	8	3	11	0	0	11	0	0
22	7045041	.	C	A	8	3	11	0	0	11	0	0
22	7045070	.	C	T	8	2	10	0	0	10	0	0
22	7045215	.	A	G	8	9	17	0	2	19	0	0
22	7056645	.	C	T	1	1	2	0	0	2	0	0
22	7128829	.	C	T	0	3	3	0	1	4	0	0
22	7128897	.	C	G	1	2	3	0	0	3	0	0
22	7129007	.	A	G	1	2	3	0	0	3	0	0
22	7129110	.	C	T	0	2	2	0	3	5	0	0
22	7129212	.	G	C	3	3	6	0	0	6	0	0
22	7359844	.	T	C	1	3	4	0	0	4	0	0
22	7400193	.	A	G	8	4	12	0	0	12	0	0
22	7523858	.	A	G	2	2	4	0	0	4	0	0
22	7523880	.	G	T	3	2	5	0	0	5	0	0
22	7523909	.	T	G	2	2	4	0	0	4	0	0
22	7676984	.	G	T	2	3	5	0	0	5	0	0
22	7682820	.	T	A	3	1	4	0	0	4	0	0
22	7682825	.	T	G	2	1	3	0	1	4	0	0
22	7683668	.	A	T	4	0	4	0	0	4	0	0
22	7683921	.	T	C	1	1	2	0	0	2	0	0
22	7693741	.	C	A	0	2	2	2	0	4	0	0
22	7972207	.	G	T	1	3	4	0	0	4	0	0
22	7972544	.	G	A	1	3	4	2	0	6	0	0
22	7972583	.	A	C	0	3	3	0	0	3	0	0
22	7972792	.	A	G	3	6	9	0	1	10	0	0
22	7972848	.	A	G	9	3	12	0	0	12	0	0
22	7972851	.	T	C	9	3	12	0	0	12	0	0
22	7974302	.	C	G	1	0	1	0	0	1	0	0
22	8074067	.	C	T	1	2	3	0	4	7	0	0
22	8074093	.	T	A	3	4	7	0	0	7	0	0
22	8161804	.	T	G	3	2	5	0	0	5	0	0
22	8161809	.	T	C	3	0	3	0	2	5	0	0
22	8162059	.	C	T	0	4	4	0	2	6	0	0
22	8163863	.	T	C	3	0	3	0	5	8	0	0
22	8163917	.	G	A	5	5	10	0	0	10	0	0
22	8164035	.	C	T	2	6	8	0	0	8	0	0
22	8240737	.	A	C	4	4	8	0	0	8	0	0
22	8241054	.	G	A	1	3	4	0	0	4	0	0
22	8243539	.	T	C	1	2	3	0	0	3	0	0
22	8243549	.	A	T	1	1	2	0	0	2	0	0
22	8296763	.	G	T	4	2	6	0	0	6	0	0
22	8339666	.	T	C	1	2	3	0	0	3	0	0
22	8583548	.	G	T	1	4	5	0	1	6	0	0
22	8583613	.	G	A	2	6	8	0	0	8	0	0
22	8583615	.	A	C	2	5	7	0	1	8	0	0
22	8715470	.	A	T	1	2	3	0	0	3	0	0
22	8769518	.	G	C	3	7	10	0	0	10	0	0
22	8769579	.	T	G	3	4	7	0	0	7	0	0
22	8769730	.	T	C	2	3	5	0	0	5	0	0
22	8769809	.	G	A	1	3	4	0	1	5	0	0
22	8769816	.	G	A	2	4	6	0	0	6	0	0
22	8769952	.	A	T	1	5	6	0	0	6	0	0
22	8769954	.	G	A	1	4	5	0	1	6	0	0
22	8785185	.	A	G	0	2	2	0	0	2	0	0
22	8785621	.	C	T	1	5	6	0	0	6	0	0
22	8785914	.	C	T	1	5	6	0	0	6	0	0
22	8786316	.	C	T	2	2	4	0	0	4	0	0
22	8786445	.	G	A	0	4	4	0	2	6	0	0
22	9057022	.	A	G	2	5	7	0	0	7	0	0
22	9057025	.	A	G	2	4	6	0	1	7	0	0
22	9472870	.	T	C	0	1	1	0	0	1	0	0
22	9472873	.	T	C	0	1	1	0	0	1	0	0
22	9481053	.	G	A	0	3	3	0	0	3	0	0
22	9490730	.	C	T	0	1	1	0	0	1	0	0
22	9503739	.	G	A	2	2	4	0	0	4	0	0
22	9504689	.	C	T	3	6	9	0	0	9	0	0
22	9504749	.	T	C	10	8	18	0	1	19	0	0
22	9508114	.	G	A	4	3	7	0	0	7	0	0
22	9509637	.	G	A	0	3	3	0	2	5	0	0
22	9512565	.	A	C	10	20	30	0	4	34	0	0
22	9512717	.	C	T	4	14	18	0	0	18	0	0
22	9512731	.	T	A	4	10	14	0	0	14	0	0
22	9512829	.	A	G	9	6	15	0	1	16	0	0
22	9512885	.	T	G	6	7	13	0	0	13	0	0
22	9513039	.	C	T	14	9	23	0	0	23	0	0
22	9523557	.	A	T	4	10	14	0	0	14	0	0
22	9525415	.	C	T	1	0	1	0	0	1	0	0
22	9526251	.	A	G	1	0	1	0	1	2	0	0
22	9530328	.	T	C	1	4	5	0	1	6	0	0
22	9530377	.	G	A	9	5	14	0	0	14	0	0
22	9530388	.	C	T	6	9	15	0	0	15	0	0
22	9530418	.	A	G	3	0	3	0	13	16	0	0
22	9532488	.	G	A	1	1	2	0	0	2	0	0
22	9534138	.	C	T	0	5	5	0	0	5	0	0
22	9535914	.	G	A	2	3	5	0	0	5	0	0
22	9535932	.	C	A	3	1	4	0	0	4	0	0
22	9536134	.	G	A	5	0	5	0	0	5	0	0
22	9537267	.	T	C	17	14	31	0	0	31	0	0
22	9537583	.	T	C	13	10	23	0	13	36	0	0
22	9537859	.	C	T	5	7	12	0	2	14	0	0
22	9591295	.	C	T	1	3	4	0	0	4	0	0
22	9826434	.	G	A	4	2	6	0	0	6	0	0
22	9828959	.	G	C	3	2	5	0	0	5	0	0
22	9828964	.	A	T	3	2	5	0	0	5	0	0
22	9835039	.	C	T	2	3	5	0	0	5	0	0
22	9835108	.	C	T	3	2	5	0	0	5	0	0
22	9835481	.	C	T	1	2	3	0	0	3	0	0
22	9835482	.	C	G	1	2	3	0	0	3	0	0
22	9835604	.	G	A	2	3	5	0	0	5	0	0
22	9836274	.	T	A	1	2	3	0	0	3	0	0
22	9858733	.	A	T	1	0	1	0	0	1	0	0
22	9858748	.	G	T	2	0	2	0	0	2	0	0
22	9858797	.	C	A	0	2	2	0	0	2	0	0
22	9877968	.	T	G	9	2	11	0	1	12	0	0
22	9877998	.	A	G	6	3	9	0	0	9	0	0
22	9878045	.	T	C	1	3	4	0	0	4	0	0
22	9878047	.	A	T	1	3	4	0	0	4	0	0
22	9886990	.	C	T	0	3	3	0	1	4	0	0
22	9887777	.	T	A	1	3	4	0	0	4	0	0
22	9887803	.	C	T	2	1	3	0	0	3	0	0
22	9893688	.	G	A	1	4	5	0	0	5	0	0
22	9894327	.	G	T	0	2	2	0	0	2	0	0
22	9894340	.	T	G	0	2	2	0	0	2	0	0
22	9898052	.	A	G	2	2	4	0	0	4	0	0
22	9898190	.	A	C	1	5	6	0	0	6	0	0
22	9898733	.	T	A	5	2	7	0	0	7	0	0
22	9899279	.	A	G	1	4	5	1	0	6	0	0
22	9899453	.	T	C	4	2	6	0	0	6	0	0
22	9899657	.	T	C	1	2	3	0	0	3	0	0
22	9899741	.	A	G	1	2	3	0	0	3	0	0
22	9926204	.	A	G	2	2	4	0	0	4	0	0
22	9926532	.	C	G	1	4	5	1	0	6	0	0
22	9932947	.	C	G	3	3	6	0	0	6	0	0
22	9933972	.	C	T	0	1	1	0	0	1	0	0
22	10019376	.	G	A	2	2	4	0	0	4	0	0
22	10019568	.	C	T	3	4	7	0	0	7	0	0
22	10019712	.	A	G	1	3	4	0	0	4	0	0
22	10038999	.	C	T	1	2	3	0	0	3	0	0
22	10039392	.	G	T	2	3	5	0	1	6	0	0
22	10039497	.	G	A	1	3	4	0	0	4	0	0
22	10040000	.	G	A	4	2	6	0	0	6	0	0
22	10040015	.	C	T	0	5	5	0	2	7	0	0
22	10040099	.	C	T	0	2	2	0	1	3	0	0
22	10040468	.	G	T	1	2	3	0	0	3	0	0
22	10048779	.	T	C	3	2	5	0	0	5	0	0
22	10049596	.	C	T	0	2	2	0	0	2	0	0
22	10069934	.	A	G	0	1	1	0	0	1	0	0
22	10071117	.	G	A	0	2	2	0	0	2	0	0
22	10123787	.	A	G	2	5	7	0	0	7	0	0
22	10123789	.	A	C	2	5	7	0	0	7	0	0
22	10123910	.	G	C	2	3	5	0	1	6	0	0
22	10123962	.	T	C	5	0	5	0	11	16	0	0
22	10123998	.	C	T	0	4	4	0	8	12	0	0
22	10129878	.	A	G	10	3	13	0	0	13	0	0
22	10162958	.	A	T	3	0	3	0	0	3	0	0
22	10178520	.	G	A	3	2	5	0	0	5	0	0
22	10184079	.	T	A	4	3	7	0	0	7	0	0
22	10189781	.	G	A	0	2	2	0	0	2	0	0
22	10196055	.	A	T	4	0	4	0	0	4	0	0
22	10196058	.	T	A	4	0	4	0	0	4	0	0
22	10196291	.	T	C	10	8	18	0	1	19	0	0
22	10196297	.	A	T	8	9	17	0	0	17	0	0
22	10196330	.	C	T	3	4	7	0	0	7	0	0
22	10196468	.	A	T	11	7	18	0	0	18	0	0
22	10196483	.	A	G	8	6	14	0	2	16	0	0
22	10196508	.	T	A	5	7	12	0	2	14	0	0
22	10196634	.	C	T	12	11	23	0	1	24	0	0
22	10196813	.	A	G	8	0	8	0	20	28	0	0
22	10196821	.	C	T	16	7	23	0	3	26	0	0
22	10196962	.	A	G	13	0	13	0	1	14	0	0
22	10197180	.	T	A	20	2	22	0	2	24	0	0
22	10197195	.	T	C	11	7	18	0	1	19	0	0
22	10197215	.	A	G	9	3	12	0	0	12	0	0
22	10197395	.	G	T	0	9	9	0	4	13	0	0
22	10197404	.	T	G	0	13	13	0	0	13	0	0
22	10197433	.	T	A	8	7	15	0	2	17	0	0
22	10197957	.	C	A	9	14	23	0	3	26	0	0
22	10197966	.	C	T	15	9	24	0	1	25	0	0
22	10198018	.	A	C	12	13	25	0	0	25	0	0
22	10198075	.	T	G	6	2	8	0	8	16	0	0
22	10198120	.	A	T	7	2	9	0	0	9	0	0
22	10198167	.	G	A	6	11	17	0	0	17	0	0
22	10198211	.	T	C	6	9	15	0	0	15	0	0
22	10198232	.	T	A	7	8	15	0	1	16	0	0
22	10198335	.	A	C	17	14	31	0	2	33	0	0
22	10198359	.	G	A	16	20	36	0	3	39	0	0
22	10198399	.	T	A	21	28	49	0	1	50	0	0
22	10205736	.	C	T	6	7	13	0	2	15	0	0
22	10208212	.	C	T	19	12	31	0	4	35	0	0
22	10210467	.	T	C	5	7	12	0	0	12	0	0
22	10212089	.	C	T	7	8	15	0	0	15	0	0
22	10212161	.	A	C	24	31	55	0	2	57	0	0
22	10212307	.	C	T	20	22	42	0	3	45	0	0
22	10212416	.	T	A	7	12	19	0	0	19	0	0
22	10218656	.	A	T	4	6	10	0	2	12	0	0
22	10218682	.	A	T	4	7	11	0	0	11	0	0
22	10218916	.	T	A	2	2	4	0	0	4	0	0
22	10218973	.	T	C	3	3	6	0	0	6	0	0
22	10219030	.	T	C	6	5	11	0	1	12	0	0
22	10260468	.	A	G	2	0	2	0	3	5	0	0
22	10261037	.	C	T	3	4	7	0	0	7	0	0
22	10261723	.	A	G	4	5	9	0	2	11	0	0
22	10261792	.	T	A	8	6	14	0	0	14	0	0
22	10261853	.	G	A	9	5	14	0	1	15	0	0
22	10261905	.	T	C	12	15	27	0	1	28	0	0
22	10262236	.	T	G	7	7	14	0	0	14	0	0
22	10361385	.	C	G	11	4	15	0	1	16	0	0
22	10361391	.	T	C	5	10	15	0	0	15	0	0
22	10361435	.	C	G	4	5	9	0	3	12	0	0
22	10361577	.	G	C	8	1	9	0	11	20	0	0
22	10361937	.	C	T	1	5	6	0	10	16	0	0
22	10362072	.	G	A	1	9	10	0	1	11	0	0
22	10362239	.	G	A	6	4	10	0	1	11	0	0
22	10368054	.	A	T	2	1	3	0	0	3	0	0
22	10372950	.	A	C	4	0	4	0	13	17	0	0
22	10373099	.	C	T	0	4	4	0	9	13	0	0
22	10373118	.	A	T	6	3	9	0	0	9	0	0
22	10373263	.	G	T	3	5	8	0	1	9	0	0
22	10373795	.	A	T	2	3	5	0	0	5	0	0
22	10373931	.	T	A	1	4	5	0	0	5	0	0
22	10374012	.	G	A	3	4	7	0	0	7	0	0
22	10374042	.	A	C	5	4	9	0	0	9	0	0
22	10383159	.	A	G	3	2	5	0	1	6	0	0
22	10390824	.	G	C	0	1	1	0	0	1	0	0
22	10391347	.	C	T	1	2	3	0	1	4	0	0
22	10430292	.	G	C	1	3	4	0	0	4	0	0
22	10430369	.	A	T	2	3	5	0	0	5	0	0
22	10513731	.	G	A	0	2	2	0	1	3	0	0
22	10513750	.	G	A	1	1	2	0	1	3	0	0
22	10513783	.	T	C	1	3	4	0	0	4	0	0
22	10514288	.	G	T	5	7	12	0	1	13	0	0
22	10514302	.	C	T	0	5	5	0	7	12	0	0
22	10522461	.	G	A	2	2	4	0	0	4	0	0
22	10540812	.	G	T	6	3	9	0	1	10	0	0
22	10545180	.	C	G	1	0	1	0	0	1	0	0
22	10545267	.	C	T	1	4	5	0	0	5	0	0
22	10545308	.	A	G	2	0	2	0	4	6	0	0
22	10545408	.	G	A	1	4	5	0	1	6	0	0
22	10547986	.	C	T	2	4	6	0	0	6	0	0
22	10548171	.	G	A	2	0	2	0	0	2	0	0
22	10550310	.	C	G	1	0	1	0	0	1	0	0
22	10553526	.	G	A	2	3	5	0	0	5	0	0
22	10553532	.	C	T	2	3	5	0	0	5	0	0
22	10553620	.	G	T	1	6	7	0	1	8	0	0
22	10553626	.	G	A	1	6	7	0	0	7	0	0
22	10557870	.	T	G	1	0	1	0	1	2	0	0
22	10557898	.	C	T	1	1	2	0	0	2	0	0
22	10561255	.	A	T	7	10	17	0	2	19	0	0
22	10561514	.	A	G	9	10	19	0	1	20	0	0
22	10561758	.	A	G	11	12	23	0	0	23	0	0
22	10564220	.	T	C	6	0	6	0	10	16	0	0
22	10564247	.	A	C	9	9	18	0	2	20	0	0
22	10567550	.	T	A	4	3	7	0	2	9	0	0
22	10570575	.	T	C	5	4	9	0	0	9	0	0
22	10580117	.	G	A	1	1	2	0	0	2	0	0
22	10592426	.	C	A	7	4	11	0	0	11	0	0
22	10592719	.	T	C	11	12	23	0	2	25	0	0
22	10593310	.	A	G	2	3	5	0	0	5	0	0
22	10593527	.	A	G	9	8	17	0	2	19	0	0
22	10593531	.	G	A	9	9	18	0	1	19	0	0
22	10593831	.	T	C	3	6	9	0	0	9	0	0
22	10593990	.	A	G	9	8	17	0	1	18	0	0
22	10594008	.	G	T	10	4	14	0	1	15	0	0
22	10594074	.	C	T	7	4	11	0	1	12	0	0
22	10594098	.	G	A	10	4	14	0	1	15	0	0
22	10594170	.	A	G	5	5	10	0	1	11	0	0
22	10597470	.	A	T	5	1	6	0	3	9	0	0
22	10597715	.	T	C	5	0	5	0	9	14	0	0
22	10599510	.	A	G	6	4	10	0	1	11	0	0
22	10600175	.	T	C	3	1	4	0	2	6	0	0
22	10600265	.	C	T	0	1	1	0	2	3	0	0
22	10604423	.	C	T	5	6	11	0	2	13	0	0
22	10615559	.	A	G	3	2	5	0	0	5	0	0
22	10622000	.	G	T	0	3	3	0	2	5	0	0
22	10626747	.	T	C	2	8	10	0	1	11	0	0
22	10626861	.	T	C	2	2	4	0	0	4	0	0
22	10626873	.	C	T	2	1	3	0	0	3	0	0
22	10629133	.	T	C	3	8	11	0	0	11	0	0
22	10631759	.	T	A	0	1	1	0	0	1	0	0
22	10632503	.	C	T	0	3	3	0	0	3	0	0
22	10634437	.	G	A	3	12	15	0	1	16	0	0
22	10636581	.	T	C	1	2	3	0	0	3	0	0
22	10636974	.	G	C	5	10	15	0	1	16	0	0
22	10637232	.	A	G	13	14	27	0	2	29	0	0
22	10637253	.	T	C	19	10	29	0	1	31	1	0
22	10637298	.	C	A	16	12	28	0	1	29	0	0
22	10637729	.	T	C	6	8	14	0	0	14	0	0
22	10638536	.	A	T	10	4	14	0	1	15	0	0
22	10638887	.	T	C	6	6	12	0	1	13	0	0
22	10638932	.	G	A	0	3	3	0	3	6	0	0
22	10638974	.	G	A	2	4	6	0	0	6	0	0
22	10651808	.	A	C	1	2	3	0	0	3	0	0
22	10651827	.	C	G	2	2	4	0	0	4	0	0
22	10654549	.	C	T	2	2	4	0	0	4	0	0
22	10654777	.	T	C	2	1	3	0	0	3	0	0
22	10654783	.	T	C	2	1	3	0	0	3	0	0
22	10657980	.	A	G	1	3	4	0	0	4	0	0
22	10658007	.	T	A	3	4	7	0	0	7	0	0
22	10658042	.	A	C	6	3	9	0	0	9	0	0
22	10660261	.	A	T	10	7	17	0	0	18	1	0
22	10662886	.	C	T	5	3	8	0	0	8	0	0
22	10662952	.	C	T	1	2	3	0	0	3	0	0
22	10663090	.	G	T	0	3	3	0	5	8	0	0
22	10663390	.	T	G	8	6	14	0	0	14	0	0
22	10663433	.	A	T	4	9	13	0	2	15	0	0
22	10663469	.	T	A	3	14	17	0	2	19	0	0
22	10663504	.	T	A	8	13	21	0	1	22	0	0
22	10663567	.	A	T	14	13	27	0	0	27	0	0
22	10678954	.	A	G	2	5	7	0	0	7	0	0
22	10689667	.	T	A	1	1	2	0	1	3	0	0
22	10699012	.	T	C	2	2	4	0	0	4	0	0
22	10699054	.	C	G	5	8	13	0	0	13	0	0
22	10704081	.	T	G	3	0	3	0	5	8	0	0
22	10704255	.	A	C	5	8	13	0	1	14	0	0
22	10704279	.	T	C	3	2	5	0	0	5	0	0
22	10706462	.	G	A	0	14	14	0	4	18	0	0
22	10706586	.	T	G	11	6	17	0	1	18	0	0
22	10706603	.	G	A	0	9	9	0	16	25	0	0
22	10706726	.	A	T	5	4	9	0	0	9	0	0
22	10706732	.	A	G	5	4	9	0	0	9	0	0
22	10706855	.	T	A	5	6	11	0	0	11	0	0
22	10713819	.	C	T	1	12	13	0	0	13	0	0
22	10713858	.	T	C	4	6	10	0	1	11	0	0
22	10713880	.	C	A	5	4	9	0	2	11	0	0
22	10726968	.	T	C	4	4	8	0	1	9	0	0
22	10729626	.	C	T	6	10	16	0	0	16	0	0
22	10729675	.	C	A	2	2	4	0	0	4	0	0
22	10733284	.	C	G	5	0	5	0	8	13	0	0
22	10733360	.	A	G	10	0	10	0	11	21	0	0
22	10733512	.	C	T	7	7	14	0	1	15	0	0
22	10733554	.	G	A	7	8	15	0	0	15	0	0
22	10733946	.	T	C	1	2	3	0	0	3	0	0
22	10734916	.	G	A	10	8	18	0	0	19	1	0
22	10734967	.	A	T	8	12	20	0	2	23	1	0
22	10735015	.	C	A	6	7	13	0	2	15	0	0
22	10755600	.	A	G	11	13	24	0	0	24	0	0
22	10755652	.	T	A	13	6	19	0	0	19	0	0
22	10755746	.	G	T	17	12	29	0	2	31	0	0
22	10755888	.	T	C	15	12	27	0	1	28	0	0
22	10770409	.	T	C	2	2	4	0	0	4	0	0
22	10771195	.	C	T	0	5	5	0	7	12	0	0
22	10771284	.	T	C	7	13	20	0	0	20	0	0
22	10771369	.	G	A	8	10	18	0	0	18	0	0
22	10771415	.	A	T	5	8	13	0	1	14	0	0
22	10771628	.	T	C	11	8	19	0	0	19	0	0
22	10771743	.	C	G	3	6	9	0	0	9	0	0
22	10771752	.	G	A	4	5	9	0	0	9	0	0
22	10771919	.	T	C	5	0	5	0	6	11	0	0
22	10774628	.	G	A	9	7	16	0	1	17	0	0
22	10774632	.	T	C	10	5	15	0	1	16	0	0
22	10794802	.	A	C	1	4	5	0	0	5	0	0
22	10795290	.	A	C	2	2	4	0	0	4	0	0
22	10816880	.	T	C	3	0	3	0	3	6	0	0
22	10844935	.	C	T	0	1	1	0	0	1	0	0
22	10844938	.	A	T	0	1	1	0	0	1	0	0
22	10928084	.	A	G	4	2	6	0	2	8	0	0
22	10932048	.	G	A	2	4	6	0	0	6	0	0
22	10932261	.	G	A	0	1	1	0	0	1	0	0
22	10942312	.	A	G	1	4	5	0	0	5	0	0
22	11004566	.	A	G	1	2	3	0	0	3	0	0
22	11071011	.	G	C	3	0	3	0	4	7	0	0
22	11071416	.	G	C	1	3	4	0	0	4	0	0
22	11071568	.	C	A	6	0	6	0	0	6	0	0
22	11071698	.	T	G	4	7	11	0	2	13	0	0
22	11075978	.	A	G	1	6	7	0	0	7	0	0
22	11078902	.	T	C	1	1	2	0	0	2	0	0
22	11078944	.	C	A	0	6	6	0	7	13	0	0
22	11123770	.	C	T	24	19	43	0	1	44	0	0
22	11123889	.	T	C	20	11	31	0	6	37	0	0
22	11124524	.	T	C	3	0	3	0	0	3	0	0
22	11126857	.	A	G	15	5	20	0	0	20	0	0
22	11126866	.	G	A	19	7	26	0	0	26	0	0
22	11129995	.	G	A	13	14	27	0	1	28	0	0
22	11130058	.	T	C	9	0	9	0	9	18	0	0
22	11135408	.	G	A	2	1	3	0	0	3	0	0
22	11135446	.	G	A	13	11	24	0	2	26	0	0
22	11136606	.	G	A	3	12	15	0	1	16	0	0
22	11154616	.	T	C	1	2	3	0	0	3	0	0
22	11156275	.	C	T	2	4	6	0	2	8	0	0
22	11156578	.	A	G	2	0	2	0	4	6	0	0
22	11156977	.	C	A	2	2	4	0	0	4	0	0
22	11161201	.	T	C	5	6	11	0	0	11	0	0
22	11170855	.	T	C	7	2	9	0	0	9	0	0
22	11170954	.	T	C	15	9	24	0	1	25	0	0
22	11170966	.	T	G	17	0	17	0	6	23	0	0
22	11171086	.	G	A	10	7	17	0	2	19	0	0
22	11188598	.	C	T	5	6	11	0	1	12	0	0
22	11199942	.	T	A	16	15	31	0	0	31	0	0
22	11200160	.	C	T	1	2	3	0	0	3	0	0
22	11200242	.	T	G	5	6	11	0	0	11	0	0
22	11200401	.	G	A	3	10	13	0	12	25	0	0
22	12160449	.	T	C	1	0	1	0	2	3	0	0
22	12160459	.	G	C	0	0	0	0	2	2	0	0
22	12171293	.	G	A	1	1	2	0	0	2	0	0
22	12174573	.	T	G	14	9	23	0	2	25	0	0
22	12174740	.	A	G	8	8	16	0	0	16	0	0
22	12175021	.	T	G	12	0	12	0	16	28	0	0
22	12175181	.	T	C	5	3	8	0	1	9	0	0
22	12175556	.	A	G	4	0	4	0	8	12	0	0
22	12175583	.	A	T	7	8	15	0	1	16	0	0
22	12176043	.	G	T	15	9	24	0	0	24	0	0
22	12230054	.	G	A	1	2	3	0	0	3	0	0
22	12243335	.	G	A	0	2	2	0	0	2	0	0
22	12243380	.	G	A	0	2	2	0	0	2	0	0
22	12247703	.	T	G	1	3	4	0	0	4	0	0
22	12247715	.	T	C	1	0	1	0	5	6	0	0
22	12247778	.	G	A	2	4	6	0	1	7	0	0
22	12259405	.	C	T	3	3	6	0	1	7	0	0
22	13459294	.	A	G	7	12	19	0	0	19	0	0
22	13459472	.	T	A	6	5	11	0	1	12	0	0
22	13459596	.	T	C	6	0	6	0	6	12	0	0
22	13459611	.	A	G	5	6	11	0	2	13	0	0
22	13459636	.	G	T	9	7	16	0	1	17	0	0
22	13459718	.	A	G	3	12	15	0	0	15	0	0
22	13459865	.	G	C	2	0	2	0	7	9	0	0
22	13460244	.	G	C	10	5	15	0	1	16	0	0
22	13460406	.	T	C	8	10	18	0	0	18	0	0
22	13460441	.	C	T	0	8	8	0	4	12	0	0
22	13460483	.	A	G	3	6	9	0	0	9	0	0
22	13460509	.	T	G	4	7	11	0	0	11	0	0
22	13461012	.	A	G	6	3	9	0	0	9	0	0
22	13461073	.	C	G	2	3	5	0	1	6	0	0
22	13461084	.	C	T	3	2	5	0	1	6	0	0
22	13461622	.	T	C	3	2	5	0	0	5	0	0
22	13461993	.	A	G	2	4	6	0	0	6	0	0
22	13461996	.	A	G	2	4	6	0	0	6	0	0
22	13462863	.	T	C	4	5	9	0	0	9	0	0
22	13463071	.	A	G	6	14	20	0	0	20	0	0
22	13472514	.	G	A	8	4	12	0	0	12	0	0
22	13481352	.	A	G	2	4	6	0	0	6	0	0
22	13481363	.	A	C	2	5	7	0	0	7	0	0
22	13511222	.	A	G	0	1	1	0	1	2	0	0
22	13526458	.	G	A	3	2	5	0	0	5	0	0
22	13526489	.	A	T	2	0	2	0	0	2	0	0
22	13526497	.	A	G	2	0	2	0	0	2	0	0
22	13846395	.	T	A	4	7	11	0	0	11	0	0
22	13846788	.	C	A	12	4	16	0	0	16	0	0
22	13847783	.	A	G	32	21	53	0	3	56	0	0
22	13847797	.	C	G	29	25	54	0	4	58	0	0
22	13847940	.	G	A	16	17	33	0	0	33	0	0
22	13848006	.	A	C	18	1	19	0	22	41	0	0
22	13848031	.	G	A	21	19	40	0	0	40	0	0
22	13848085	.	G	A	13	13	26	0	0	26	0	0
22	13848106	.	A	G	7	9	16	0	0	17	1	0
22	13850865	.	A	G	16	10	26	0	0	26	0	0
22	13940036	.	T	C	1	5	6	0	0	6	0	0
22	13979234	.	C	T	2	2	4	0	1	5	0	0
22	14366222	.	G	A	3	6	9	0	0	9	0	0
22	14366267	.	C	T	2	1	3	0	0	3	0	0
22	14381812	.	G	T	2	2	4	0	0	4	0	0
22	14390142	.	C	T	2	3	5	0	0	5	0	0
22	14404788	.	C	A	1	0	1	0	0	1	0	0
22	14408161	.	T	G	3	1	4	0	0	4	0	0
22	14408192	.	A	G	3	0	3	0	0	3	0	0
22	14458857	.	T	A	1	0	1	0	0	1	0	0
22	14461508	.	G	A	1	2	3	0	0	3	0	0
22	14508266	.	G	A	0	1	1	0	0	1	0	0
22	14851158	.	A	C	1	2	3	0	0	3	0	0
22	15900812	.	T	C	1	6	7	0	0	7	0	0
22	16342535	.	T	A	1	1	2	0	0	2	0	0
22	16345485	.	A	G	0	1	1	0	0	1	0	0
22	16348504	.	A	T	4	3	7	0	0	7	0	0
22	16348506	.	C	T	4	3	7	0	0	7	0	0
22	16350682	.	G	A	14	18	32	0	0	32	0	0
22	16350792	.	T	A	25	14	39	0	3	42	0	0
22	16350811	.	T	G	24	10	34	0	5	39	0	0
22	16350862	.	C	T	20	5	25	0	0	25	0	0
22	16350877	.	T	A	19	6	25	0	1	26	0	0
22	16351141	.	G	A	16	10	26	0	0	26	0	0
22	16351199	.	C	G	21	14	35	0	0	35	0	0
22	16351345	.	A	T	6	3	9	0	1	10	0	0
22	16351353	.	G	A	7	3	10	0	1	11	0	0
22	16351439	.	C	T	7	3	10	0	0	10	0	0
22	16351490	.	T	G	9	11	20	0	0	20	0	0
22	16351552	.	A	T	9	11	20	0	0	20	0	0
22	16352146	.	G	T	2	4	6	0	0	6	0	0
22	16352215	.	A	G	9	5	14	0	2	16	0	0
22	16352249	.	T	C	9	8	17	0	0	17	0	0
22	16352269	.	T	G	9	6	15	0	2	17	0	0
22	16352668	.	T	C	19	0	19	0	15	34	0	0
22	16352768	.	A	G	11	14	25	0	1	26	0	0
22	16357818	.	A	G	1	1	2	0	0	2	0	0
22	16357831	.	A	G	1	4	5	0	0	5	0	0
22	16357867	.	G	A	3	8	11	0	0	11	0	0
22	16357909	.	C	T	1	2	3	0	0	3	0	0
22	16367007	.	T	C	11	0	11	0	5	16	0	0
22	16367055	.	A	G	9	8	17	0	0	17	0	0
22	16407136	.	C	T	1	3	4	0	0	4	0	0
22	16412091	.	A	G	1	3	4	0	0	4	0	0
22	16423042	.	G	A	0	3	3	0	2	5	0	0
22	16424576	.	T	C	3	2	5	0	0	5	0	0
22	16427969	.	A	G	5	0	5	0	2	7	0	0
22	16428005	.	C	A	4	3	7	0	2	9	0	0
22	16430623	.	G	A	8	10	18	0	0	18	0	0
22	16430782	.	T	A	11	12	23	0	0	23	0	0
22	16430913	.	T	C	4	2	6	0	0	6	0	0
22	16433009	.	G	A	4	3	7	0	0	7	0	0
22	16433054	.	T	A	8	6	14	0	1	15	0	0
22	16433078	.	G	A	13	9	22	0	1	23	0	0
22	16433096	.	A	G	12	16	28	0	2	30	0	0
22	16433337	.	T	C	4	2	6	0	0	6	0	0
22	16433895	.	T	C	6	4	10	0	0	10	0	0
22	16433912	.	T	A	5	10	15	0	0	15	0	0
22	16433940	.	C	T	6	12	18	0	0	18	0	0
22	16434056	.	G	A	18	8	26	0	0	26	0	0
22	16440072	.	G	A	2	4	6	0	0	6	0	0
22	16440086	.	T	C	1	0	1	0	1	2	0	0
22	16477702	.	T	A	1	3	4	0	0	4	0	0
22	16484167	.	A	T	4	3	7	0	0	7	0	0
22	16484489	.	G	C	17	0	17	0	10	27	0	0
22	16484712	.	C	T	4	3	7	0	0	7	0	0
22	16484938	.	A	G	10	13	23	0	2	25	0	0
22	16484944	.	T	C	11	11	22	0	2	24	0	0
22	16485238	.	A	C	7	14	21	0	0	21	0	0
22	16485379	.	A	T	6	9	15	0	1	16	0	0
22	16485563	.	A	T	7	0	7	0	1	8	0	0
22	16485768	.	G	A	6	6	12	0	0	12	0	0
22	16485790	.	C	T	6	4	10	0	0	10	0	0
22	16485920	.	G	A	6	4	10	0	0	10	0	0
22	16486008	.	A	C	7	3	10	0	2	12	0	0
22	16486027	.	G	A	5	3	8	0	0	8	0	0
22	16486102	.	G	A	9	8	17	0	0	17	0	0
22	16486112	.	T	C	8	10	18	0	0	18	0	0
22	16491711	.	C	A	4	3	7	0	0	7	0	0
22	16491942	.	G	A	18	9	27	0	0	27	0	0
22	16498232	.	T	C	10	10	20	0	0	20	0	0
22	16498333	.	A	C	17	11	28	0	4	32	0	0
22	16498661	.	A	G	8	1	9	0	14	23	0	0
22	16537854	.	C	T	7	5	12	0	0	12	0	0
22	16537878	.	C	A	11	8	19	0	0	19	0	0
22	16544186	.	A	G	5	9	14	0	0	14	0	0
22	16544197	.	A	G	8	4	12	0	0	12	0	0
22	16544243	.	C	T	5	5	10	0	1	11	0	0
22	16544308	.	A	G	0	2	2	1	0	3	0	0
22	16544384	.	G	A	10	12	22	0	0	22	0	0
22	16544400	.	T	G	11	13	24	0	0	24	0	0
22	16544599	.	A	G	9	1	10	0	18	28	0	0
22	16544674	.	T	G	19	16	35	0	2	37	0	0
22	16544780	.	A	T	15	15	30	0	2	32	0	0
22	16544800	.	G	A	12	13	25	0	1	26	0	0
22	16569403	.	T	C	4	4	8	0	1	9	0	0
22	16584198	.	T	G	4	0	4	0	17	21	0	0
22	16594852	.	G	A	0	2	2	0	0	2	0	0
22	16594870	.	T	A	3	1	4	0	1	5	0	0
22	16597623	.	G	A	1	0	1	0	0	1	0	0
22	16601400	.	C	T	5	0	5	0	1	6	0	0
22	16601422	.	C	T	1	1	2	0	0	2	0	0
22	16606938	.	G	A	2	0	2	0	0	2	0	0
22	16775197	.	G	A	1	9	10	0	13	24	1	0
22	16775284	.	T	G	15	9	24	0	1	25	0	0
22	16775306	.	C	T	7	16	23	0	0	23	0	0
22	16862842	.	A	G	2	2	4	0	0	4	0	0
22	16893867	.	C	T	0	0	0	0	1	1	0	0
22	17200635	.	G	A	11	2	13	0	0	13	0	0
22	17200890	.	G	A	8	11	19	0	1	20	0	0
22	17200985	.	A	C	6	19	25	0	0	25	0	0
22	17201015	.	C	G	8	17	25	0	1	26	0	0
22	17201102	.	C	G	10	8	18	0	0	18	0	0
22	17201135	.	G	A	9	6	15	0	1	16	0	0
22	17201172	.	C	T	5	2	7	0	0	7	0	0
22	17208770	.	T	C	13	10	23	0	1	24	0	0
22	17208913	.	A	C	10	7	17	0	0	17	0	0
22	17208973	.	G	A	11	6	17	0	0	17	0	0
22	17208983	.	T	C	13	6	19	0	0	19	0	0
22	17209036	.	A	T	11	10	21	0	0	21	0	0
22	17209384	.	A	C	14	13	27	0	1	28	0	0
22	17209413	.	T	A	10	16	26	0	1	27	0	0
22	17209484	.	T	A	11	19	30	0	0	30	0	0
22	17209492	.	T	A	11	15	26	0	1	27	0	0
22	17209523	.	A	T	10	10	20	0	1	21	0	0
22	17209737	.	T	C	17	21	38	0	1	39	0	0
22	17209762	.	T	C	11	24	35	0	2	37	0	0
22	17209986	.	A	T	16	15	31	0	0	31	0	0
22	17209993	.	A	T	16	13	29	0	2	31	0	0
22	17210053	.	C	G	14	5	19	0	0	19	0	0
22	17210157	.	T	A	25	15	40	0	0	40	0	0
22	17210196	.	C	G	19	0	19	0	15	34	0	0
22	17210217	.	C	A	18	10	28	0	1	29	0	0
22	17210820	.	A	C	34	21	55	0	4	59	0	0
22	17210825	.	G	A	1	19	20	0	36	56	0	0
22	17211295	.	T	C	11	5	16	0	0	16	0	0
22	17211343	.	C	T	12	11	23	0	1	24	0	0
22	17211361	.	A	G	15	14	29	0	1	30	0	0
22	17211431	.	C	T	23	9	32	0	3	35	0	0
22	17211438	.	T	C	22	11	33	0	1	34	0	0
22	17211601	.	A	T	21	6	27	0	7	34	0	0
22	17211875	.	G	C	26	16	42	0	0	42	0	0
22	17211990	.	A	G	14	12	26	0	2	28	0	0
22	17212235	.	T	A	14	13	27	0	2	29	0	0
22	17212236	.	T	C	15	14	29	0	0	29	0	0
22	17218901	.	C	T	0	1	1	0	0	1	0	0
22	17219045	.	G	A	0	0	0	0	1	1	0	0
22	17234620	.	G	A	0	3	3	0	4	7	0	0
22	17235449	.	A	C	1	1	2	0	0	2	0	0
22	17315288	.	G	A	0	1	1	0	0	1	0	0
22	17315296	.	C	G	0	1	1	0	0	1	0	0
22	17318172	.	C	T	2	2	4	0	0	4	0	0
22	17318635	.	G	T	0	2	2	0	4	6	0	0
22	17343530	.	A	G	1	2	3	0	0	3	0	0
22	17359735	.	A	G	4	0	4	0	4	8	0	0
22	17359816	.	G	C	0	7	7	0	4	11	0	0
22	17360107	.	C	A	12	6	18	0	0	18	0	0
22	17360428	.	G	A	1	5	6	0	7	13	0	0
22	17405361	.	C	T	3	4	7	0	0	7	0	0
22	17446858	.	T	C	1	3	4	0	0	4	0	0
22	17448778	.	G	A	2	3	5	0	0	5	0	0
22	17448781	.	C	T	2	3	5	0	0	5	0	0
22	17450115	.	G	A	0	11	11	0	16	27	0	0
22	17452798	.	C	T	13	18	31	0	1	32	0	0
22	17453286	.	T	G	14	19	33	0	1	34	0	0
22	17453336	.	A	G	15	0	15	0	19	34	0	0
22	17453419	.	G	A	14	13	27	0	2	29	0	0
22	17453478	.	T	A	20	10	30	0	1	31	0	0
22	17453552	.	T	C	19	7	26	0	0	26	0	0
22	17453680	.	C	T	15	7	22	0	2	24	0	0
22	17453688	.	A	G	13	10	23	0	0	23	0	0
22	17453742	.	A	G	15	10	25	0	1	26	0	0
22	17453836	.	A	G	7	11	18	0	2	20	0	0
22	17453883	.	A	T	11	18	29	0	0	29	0	0
22	17453884	.	T	C	11	18	29	0	0	29	0	0
22	17454015	.	T	C	11	19	30	0	0	30	0	0
22	17454038	.	G	T	14	15	29	0	1	30	0	0
22	17454120	.	C	T	6	12	18	0	3	21	0	0
22	17454178	.	A	G	9	0	9	0	11	20	0	0
22	17454179	.	T	G	9	11	20	0	0	20	0	0
22	17454320	.	T	C	10	10	20	0	2	22	0	0
22	17454382	.	C	T	5	12	17	0	0	17	0	0
22	17454424	.	C	T	1	2	3	0	0	3	0	0
22	17501623	.	G	C	3	3	6	0	0	6	0	0
22	17505820	.	A	C	26	24	50	0	8	58	0	0
22	17506016	.	C	T	6	4	10	0	15	25	0	0
22	17506536	.	A	T	23	15	38	0	2	40	0	0
22	17506537	.	T	G	25	15	40	0	0	40	0	0
22	17509449	.	A	T	1	3	4	0	1	5	0	0
22	17509494	.	T	A	9	3	12	0	3	15	0	0
22	17509533	.	T	A	7	2	9	0	0	9	0	0
22	17517881	.	G	A	1	1	2	0	0	2	0	0
22	17520792	.	A	G	1	0	1	0	3	4	0	0
22	17531044	.	G	A	1	7	8	0	5	13	0	0
22	17531188	.	A	G	8	15	23	0	0	23	0	0
22	17533907	.	C	T	3	5	8	0	0	8	0	0
22	17539297	.	C	T	22	20	42	0	3	45	0	0
22	17539633	.	G	A	6	7	13	0	0	13	0	0
22	17541191	.	T	G	6	5	11	0	0	11	0	0
22	17541450	.	C	A	9	12	21	0	1	22	0	0
22	17541593	.	G	A	10	17	27	0	2	29	0	0
22	17542016	.	C	T	16	17	33	0	0	33	0	0
22	17542057	.	C	T	9	14	23	0	0	23	0	0
22	17542117	.	T	C	16	9	25	0	2	27	0	0
22	17542136	.	G	A	15	10	25	0	0	25	0	0
22	17542199	.	A	T	8	5	13	0	0	13	0	0
22	17542702	.	G	A	12	7	19	0	0	19	0	0
22	17543079	.	C	G	2	2	4	0	0	4	0	0
22	17543408	.	A	G	4	4	8	0	0	8	0	0
22	17543421	.	G	A	6	4	10	0	0	10	0	0
22	17543552	.	G	A	8	4	12	0	0	12	0	0
22	17543634	.	A	C	3	16	19	0	1	20	0	0
22	17543668	.	A	T	3	11	14	0	1	15	0	0
22	17543903	.	A	G	5	10	15	0	1	16	0	0
22	17550643	.	T	C	7	0	7	0	5	12	0	0
22	17550664	.	G	A	9	9	18	0	1	19	0	0
22	17550684	.	C	T	1	9	10	0	6	16	0	0
22	17550724	.	T	G	2	4	6	0	0	6	0	0
22	17552526	.	A	G	1	3	4	0	0	4	0	0
22	17554785	.	G	A	9	9	18	0	0	18	0	0
22	17560376	.	A	C	1	0	1	0	0	1	0	0
22	17564009	.	T	C	6	10	16	0	0	16	0	0
22	17565735	.	C	T	11	6	17	0	1	18	0	0
22	17565837	.	A	G	1	1	2	0	0	2	0	0
22	17571428	.	G	A	1	0	1	0	0	1	0	0
22	17571533	.	C	A	0	3	3	0	0	3	0	0
22	17590019	.	G	A	0	3	3	0	0	3	0	0
22	17590037	.	C	T	0	3	3	0	0	3	0	0
22	17591712	.	G	A	4	16	20	0	0	20	0	0
22	17596874	.	G	A	4	2	6	0	0	6	0	0
22	17596903	.	C	G	8	15	23	0	1	24	0	0
22	17596943	.	A	T	10	24	34	0	0	34	0	0
22	17606908	.	A	C	3	9	12	0	0	12	0	0
22	17607226	.	G	A	8	3	11	0	0	11	0	0
22	17609589	.	C	G	0	1	1	0	1	2	0	0
22	17819385	.	C	T	2	2	4	0	0	4	0	0
22	17828741	.	C	T	4	3	7	0	0	7	0	0
22	17829069	.	A	C	5	4	9	0	1	10	0	0
22	17830360	.	A	G	14	11	25	0	0	25	0	0
22	17830632	.	A	G	4	12	16	0	1	17	0	0
22	17830640	.	A	G	4	12	16	0	0	16	0	0
22	17865043	.	A	G	5	9	14	0	1	15	0	0
22	17865106	.	G	A	1	7	8	0	0	8	0	0
22	17867570	.	C	T	3	8	11	0	0	11	0	0
22	17878868	.	G	A	0	2	2	0	0	2	0	0
22	17881737	.	A	G	0	3	3	0	0	3	0	0
22	17881743	.	T	C	0	3	3	0	0	3	0	0
22	17991690	.	G	A	2	6	8	0	1	9	0	0
22	17998481	.	G	A	5	2	7	0	1	8	0	0
22	18022282	.	A	G	2	2	4	0	0	4	0	0
22	18160090	.	T	G	1	2	3	0	0	3	0	0
22	18160149	.	A	T	2	2	4	0	0	4	0	0
22	18174270	.	T	G	0	2	2	0	1	3	0	0
22	18211058	.	G	A	2	3	5	0	0	5	0	0
22	18213480	.	A	C	2	3	5	0	0	5	0	0
22	18213979	.	A	G	1	1	2	0	0	2	0	0
22	18213981	.	A	T	1	1	2	0	0	2	0	0
22	18231370	.	A	G	10	5	15	0	0	15	0	0
22	18231462	.	T	C	6	3	9	0	0	9	0	0
22	18231471	.	T	C	3	3	6	0	1	7	0	0
22	18231673	.	T	A	3	8	11	0	1	12	0	0
22	18231770	.	C	G	5	10	15	0	0	15	0	0
22	18231831	.	T	A	4	3	7	0	0	7	0	0
22	18231942	.	A	G	2	3	5	0	0	5	0	0
22	18232503	.	G	C	1	2	3	0	0	3	0	0
22	18232527	.	C	T	2	4	6	0	0	6	0	0
22	18232640	.	G	A	5	1	6	0	1	7	0	0
22	18232711	.	A	G	5	2	7	0	0	7	0	0
22	18232754	.	T	C	5	6	11	0	1	12	0	0
22	18232868	.	G	T	4	5	9	0	0	9	0	0
22	18232935	.	T	G	4	5	9	0	0	9	0	0
22	18233053	.	C	A	4	4	8	0	0	8	0	0
22	18233284	.	T	A	2	3	5	0	0	5	0	0
22	18233367	.	T	A	3	6	9	0	0	9	0	0
22	18233403	.	G	A	2	6	8	0	1	9	0	0
22	18233747	.	T	C	3	5	8	0	0	8	0	0
22	18234340	.	A	C	0	1	1	0	1	2	0	0
22	18247883	.	T	C	3	4	7	0	0	7	0	0
22	18376359	.	C	A	3	6	9	0	2	11	0	0
22	18376467	.	A	C	3	2	5	0	0	5	0	0
22	18384306	.	G	T	4	1	5	0	0	5	0	0
22	18384330	.	T	G	3	1	4	0	0	4	0	0
22	18384352	.	G	C	5	3	8	0	0	8	0	0
22	18459182	.	C	T	7	2	9	0	0	9	0	0
22	18461964	.	C	T	3	8	11	0	0	11	0	0
22	18462018	.	A	G	5	8	13	0	2	15	0	0
22	18462239	.	C	T	5	11	16	0	0	16	0	0
22	18464455	.	T	C	1	3	4	0	1	5	0	0
22	18488823	.	T	C	4	4	8	0	1	9	0	0
22	18488952	.	C	A	4	5	9	0	1	10	0	0
22	18489191	.	A	G	2	1	3	0	0	3	0	0
22	18542090	.	C	T	26	13	39	0	1	40	0	0
22	18542393	.	C	T	12	12	24	0	1	25	0	0
22	18542508	.	A	G	23	11	34	0	1	35	0	0
22	18542720	.	A	T	16	19	35	0	2	37	0	0
22	18543819	.	C	G	28	24	52	0	2	54	0	0
22	18543847	.	T	G	29	24	53	0	0	53	0	0
22	18544465	.	C	T	0	1	1	0	6	7	0	0
22	18544992	.	T	C	10	4	14	0	3	17	0	0
22	18725485	.	T	A	5	9	14	0	2	16	0	0
22	18726040	.	A	T	18	9	27	0	0	27	0	0
22	18726470	.	A	T	18	22	40	0	5	45	0	0
22	18726505	.	T	A	17	28	45	0	0	45	0	0
22	18726668	.	C	A	11	16	27	0	1	28	0	0
22	18727787	.	C	A	0	11	11	0	7	18	0	0
22	18727890	.	G	A	16	5	21	0	1	22	0	0
22	18736155	.	T	C	22	1	23	0	21	44	0	0
22	18736182	.	C	T	19	16	35	0	1	36	0	0
22	18736859	.	A	G	23	16	39	0	1	40	0	0
22	18746486	.	A	G	4	11	15	0	0	15	0	0
22	18778872	.	C	T	26	26	52	0	1	53	0	0
22	18778895	.	A	C	24	26	50	0	1	51	0	0
22	18799110	.	T	G	1	2	3	0	0	3	0	0
22	18799190	.	C	T	6	5	11	0	1	12	0	0
22	18971667	.	T	C	6	7	13	0	0	13	0	0
22	18971697	.	T	C	8	7	15	1	0	16	0	0
22	19004989	.	A	T	0	1	1	0	0	1	0	0
22	19006676	.	A	G	4	6	10	0	0	10	0	0
22	19006763	.	T	C	7	3	10	0	0	10	0	0
22	19006994	.	T	C	15	11	26	0	0	26	0	0
22	19007574	.	A	G	6	11	17	0	0	17	0	0
22	19007677	.	C	A	14	10	24	0	0	24	0	0
22	19007764	.	A	G	3	7	10	0	0	10	0	0
22	19067829	.	C	T	0	2	2	0	1	3	0	0
22	19547501	.	A	T	9	10	19	0	1	21	1	0
22	19547573	.	C	G	0	8	8	0	8	16	0	0
22	19547575	.	A	C	6	0	6	0	10	16	0	0
22	19547796	.	C	T	8	18	26	0	2	28	0	0
22	19552745	.	C	T	9	7	16	0	0	16	0	0
22	19645155	.	G	A	1	3	4	0	0	4	0	0
22	19645170	.	G	A	1	3	4	0	0	4	0	0
22	19645233	.	T	C	2	2	4	0	0	4	0	0
22	19645464	.	A	G	1	0	1	0	4	5	0	0
22	19665618	.	C	T	5	6	11	0	0	11	0	0
22	19671776	.	A	G	12	13	25	0	2	27	0	0
22	20011558	.	T	C	0	3	3	0	1	4	0	0
22	20105123	.	C	G	2	3	5	0	1	6	0	0
22	20105242	.	A	G	2	5	7	0	0	7	0	0
22	20105353	.	G	A	2	2	4	0	2	6	0	0
22	20105500	.	G	A	5	3	8	0	0	8	0	0
22	20140780	.	A	G	0	1	1	0	0	1	0	0
22	20140913	.	G	A	0	2	2	0	1	3	0	0
22	20141816	.	G	A	0	2	2	0	1	3	0	0
22	20141818	.	C	T	1	1	2	0	1	3	0	0
22	20142226	.	C	G	3	2	5	0	0	5	0	0
22	20142315	.	A	T	2	3	5	0	0	5	0	0
22	20142496	.	A	C	3	2	5	0	0	5	0	0
22	20142516	.	A	G	2	2	4	0	0	4	0	0
22	20142713	.	C	T	3	3	6	0	0	6	0	0
22	20142723	.	A	T	3	5	8	0	0	8	0	0
22	20142753	.	T	A	4	4	8	0	0	8	0	0
22	20142772	.	T	G	2	4	6	0	0	6	0	0
22	20142832	.	A	G	1	0	1	0	3	4	0	0
22	20143002	.	G	T	2	3	5	0	1	6	0	0
22	20159200	.	A	C	13	7	20	0	2	22	0	0
22	20159576	.	A	T	11	22	33	0	1	34	0	0
22	20159771	.	C	A	14	18	32	0	0	32	0	0
22	20164449	.	T	C	1	2	3	0	0	3	0	0
22	20172105	.	A	G	2	0	2	0	0	2	0	0
22	20172642	.	A	G	4	4	8	0	0	8	0	0
22	20175295	.	G	A	10	7	17	0	0	17	0	0
22	20177970	.	G	A	0	8	8	0	5	13	0	0
22	20177981	.	G	A	4	10	14	0	0	14	0	0
22	20178045	.	C	T	3	6	9	0	1	10	0	0
22	20178065	.	T	C	3	6	9	0	0	9	0	0
22	20202641	.	G	A	4	5	9	0	0	9	0	0
22	20211187	.	T	C	5	4	9	0	0	9	0	0
22	20211289	.	G	T	0	4	4	0	2	6	0	0
22	20212794	.	G	T	0	4	4	0	3	7	0	0
22	20214649	.	G	A	0	5	5	0	2	7	0	0
22	20215089	.	T	A	4	2	6	0	0	6	0	0
22	20215351	.	C	T	1	1	2	0	0	2	0	0
22	20220161	.	A	G	3	0	3	0	4	7	0	0
22	20220197	.	C	T	9	11	20	0	0	20	0	0
22	20222950	.	G	C	1	0	1	0	0	1	0	0
22	20240483	.	T	C	12	16	28	0	0	28	0	0
22	20240835	.	A	G	10	15	25	0	1	26	0	0
22	20292595	.	A	T	11	9	20	0	1	21	0	0
22	20292789	.	T	C	18	19	37	0	5	42	0	0
22	20293049	.	T	A	9	4	13	0	1	14	0	0
22	20293440	.	G	A	13	8	21	0	4	25	0	0
22	20296615	.	A	T	23	12	35	0	1	36	0	0
22	20296669	.	T	C	11	7	18	0	3	21	0	0
22	20299280	.	A	G	2	10	12	0	1	13	0	0
22	20299283	.	G	A	2	11	13	0	1	14	0	0
22	20299349	.	T	C	12	25	37	0	2	39	0	0
22	20303406	.	A	G	14	9	23	0	0	23	0	0
22	20303412	.	G	T	14	9	23	0	2	25	0	0
22	20303487	.	A	G	3	1	4	0	0	4	0	0
22	20305443	.	G	T	18	17	35	0	0	35	0	0
22	20313722	.	C	A	8	10	18	0	4	22	0	0
22	20313791	.	A	G	17	9	26	0	0	27	1	0
22	20313887	.	C	G	18	12	30	0	0	30	0	0
22	20313926	.	C	A	0	15	15	0	9	24	0	0
22	20315851	.	T	C	9	0	9	0	6	15	0	0
22	20315883	.	C	T	8	9	17	0	3	20	0	0
22	20315896	.	G	A	8	16	24	0	0	24	0	0
22	20318937	.	C	T	0	9	9	0	6	15	0	0
22	20319149	.	A	G	3	2	5	0	0	5	0	0
22	20388735	.	T	A	1	3	4	0	0	4	0	0
22	20388853	.	G	A	13	8	21	0	0	21	0	0
22	20389198	.	C	A	14	9	23	0	0	23	0	0
22	20389286	.	A	G	7	6	13	0	2	15	0	0
22	20389392	.	A	G	10	7	17	0	0	17	0	0
22	20389538	.	A	T	10	16	26	0	0	26	0	0
22	20389545	.	G	A	12	15	27	0	0	27	0	0
22	20389580	.	T	G	11	8	19	0	3	22	0	0
22	20389620	.	T	A	14	6	20	0	3	23	0	0
22	20390002	.	C	A	6	10	16	0	1	17	0	0
22	20390041	.	C	T	17	9	26	0	1	27	0	0
22	20402889	.	T	C	6	5	11	0	0	11	0	0
22	20407002	.	C	T	0	5	5	0	5	10	0	0
22	20408502	.	C	T	5	2	7	0	2	9	0	0
22	20408865	.	T	C	8	0	8	0	12	20	0	0
22	20409099	.	C	T	3	6	9	0	0	9	0	0
22	20475073	.	G	A	1	2	3	0	0	3	0	0
22	20478503	.	T	C	3	5	8	0	0	8	0	0
22	20478519	.	T	G	2	5	7	0	0	7	0	0
22	20574066	.	T	C	5	16	21	0	0	21	0	0
22	20574402	.	A	G	6	9	15	0	0	15	0	0
22	20574585	.	A	G	7	4	11	0	1	12	0	0
22	20792042	.	G	A	2	3	5	0	0	5	0	0
22	20792054	.	T	C	0	3	3	0	0	3	0	0
22	20797490	.	C	T	0	3	3	0	2	5	0	0
22	20797556	.	G	A	1	2	3	0	0	3	0	0
22	20848297	.	G	A	3	5	8	0	0	8	0	0
22	20848326	.	C	T	4	6	10	0	0	10	0	0
22	20848488	.	G	A	7	5	12	0	0	12	0	0
22	20848501	.	A	G	6	5	11	0	0	11	0	0
22	20849615	.	T	C	1	0	1	0	2	3	0	0
22	20877036	.	T	C	2	0	2	0	3	5	0	0
22	20926412	.	C	T	7	8	15	0	0	15	0	0
22	20926466	.	G	A	7	7	14	0	0	14	0	0
22	20926511	.	G	A	7	8	15	0	0	15	0	0
22	20935383	.	T	C	3	4	7	0	0	7	0	0
22	20940039	.	C	T	0	1	1	0	3	4	0	0
22	20940048	.	G	A	2	2	4	0	0	4	0	0
22	20944679	.	A	G	3	10	13	0	1	14	0	0
22	20951387	.	T	C	6	0	6	0	12	18	0	0
22	20951514	.	C	T	0	17	17	0	9	26	0	0
22	20951788	.	G	A	17	11	28	0	1	29	0	0
22	20951861	.	C	T	8	12	20	0	2	22	0	0
22	20951866	.	G	T	7	13	20	0	0	20	0	0
22	20952257	.	A	G	18	17	35	0	1	36	0	0
22	20952292	.	A	T	13	18	31	0	0	31	0	0
22	20952688	.	T	C	4	2	6	0	0	6	0	0
22	20953053	.	T	A	5	10	15	0	0	15	0	0
22	20953127	.	A	T	9	3	12	0	0	12	0	0
22	20953141	.	C	A	7	3	10	0	1	11	0	0
22	20953418	.	G	A	12	8	20	0	1	21	0	0
22	20953555	.	C	A	12	6	18	0	1	19	0	0
22	20953578	.	A	G	9	8	17	0	0	17	0	0
22	20954386	.	C	T	4	5	9	0	0	9	0	0
22	20954391	.	C	T	4	6	10	0	0	10	0	0
22	20954557	.	T	A	11	4	15	0	1	17	1	0
22	20954717	.	A	T	12	8	20	0	2	22	0	0
22	20954810	.	C	T	0	11	11	0	14	25	0	0
22	20954953	.	C	T	14	22	36	0	2	38	0	0
22	20955427	.	C	T	0	4	4	0	3	7	0	0
22	20955469	.	C	T	0	8	8	0	3	11	0	0
22	21032184	.	A	G	1	0	1	0	0	1	0	0
22	21128200	.	A	G	20	14	34	0	5	39	0	0
22	21129075	.	G	A	28	31	59	0	4	63	0	0
22	21129101	.	G	A	30	32	62	0	4	66	0	0
22	21129407	.	A	G	31	28	59	0	4	63	0	0
22	21129558	.	T	G	30	32	62	0	1	63	0	0
22	21129575	.	T	C	28	31	59	0	2	61	0	0
22	21676215	.	A	G	0	4	4	1	0	5	0	0
22	21676233	.	G	A	0	12	12	0	0	12	0	0
22	21676296	.	G	A	5	12	17	0	0	17	0	0
22	22129568	.	T	A	4	5	9	0	0	9	0	0
22	22129586	.	T	C	5	4	9	0	0	9	0	0
22	22129754	.	A	G	4	4	8	0	0	8	0	0
22	22141533	.	T	C	3	2	5	0	1	6	0	0
22	22179714	.	A	G	3	5	8	0	0	8	0	0
22	22187939	.	T	A	4	4	8	0	2	10	0	0
22	22188715	.	T	C	13	16	29	0	0	29	0	0
22	22188717	.	C	T	13	16	29	0	0	29	0	0
22	22196339	.	G	A	5	2	7	0	1	8	0	0
22	22199227	.	G	A	4	8	12	0	0	12	0	0
22	22204002	.	C	T	4	7	11	0	1	12	0	0
22	22204395	.	G	A	8	5	13	0	0	13	0	0
22	22214640	.	G	A	6	3	9	0	0	9	0	0
22	22215458	.	G	T	2	3	5	0	1	6	0	0
22	22234750	.	G	A	5	13	18	0	0	18	0	0
22	22241769	.	A	G	6	3	9	0	0	9	0	0
22	22241772	.	A	T	5	4	9	0	2	11	0	0
22	22242861	.	C	T	0	0	0	0	1	1	0	0
22	22245400	.	T	C	4	2	6	0	0	6	0	0
22	22245435	.	C	T	9	3	12	0	0	12	0	0
22	22245617	.	A	G	2	8	10	0	0	10	0	0
22	22245812	.	C	T	5	11	16	0	0	16	0	0
22	22251493	.	A	C	2	0	2	0	3	5	0	0
22	22260456	.	G	A	0	3	3	0	0	3	0	0
22	22267524	.	G	C	0	2	2	0	1	3	0	0
22	22273465	.	G	A	5	4	9	0	1	10	0	0
22	22273871	.	A	C	4	6	10	0	2	12	0	0
22	22274000	.	A	T	1	5	6	0	0	6	0	0
22	22274137	.	C	T	4	2	6	0	0	6	0	0
22	22274157	.	G	T	1	2	3	0	0	3	0	0
22	22276418	.	C	T	1	3	4	0	0	4	0	0
22	22276897	.	C	T	1	3	4	0	0	4	0	0
22	22276957	.	G	T	3	2	5	0	0	5	0	0
22	22313260	.	A	T	4	4	8	0	0	8	0	0
22	22313376	.	T	C	5	5	10	0	0	10	0	0
22	22313686	.	G	A	0	5	5	0	4	9	0	0
22	22313710	.	C	A	5	5	10	0	1	11	0	0
22	22313794	.	G	A	7	3	10	0	1	11	0	0
22	22313959	.	C	T	2	3	5	0	0	5	0	0
22	22314427	.	G	T	3	8	11	0	1	12	0	0
22	22314430	.	A	C	3	9	12	0	0	12	0	0
22	22314721	.	A	G	11	11	22	0	0	22	0	0
22	22314861	.	C	G	2	2	4	0	0	4	0	0
22	22314870	.	G	C	3	2	5	0	0	5	0	0
22	22315048	.	T	C	2	7	9	0	0	9	0	0
22	22345136	.	C	T	2	8	10	0	11	21	0	0
22	22345179	.	A	C	12	12	24	0	0	24	0	0
22	22345197	.	C	T	15	12	27	0	1	28	0	0
22	22345255	.	G	A	20	8	28	0	0	28	0	0
22	22345367	.	C	T	0	12	12	0	8	20	0	0
22	22345403	.	G	A	12	9	21	0	0	21	0	0
22	22345418	.	G	A	14	12	26	0	0	26	0	0
22	22348234	.	A	G	10	1	11	0	0	11	0	0
22	22350963	.	C	T	7	3	10	0	0	10	0	0
22	22351103	.	A	T	3	5	8	0	0	8	0	0
22	22352249	.	C	T	8	5	13	0	2	15	0	0
22	22352312	.	T	C	8	7	15	0	1	16	0	0
22	22353128	.	G	A	6	8	14	0	0	14	0	0
22	22353222	.	G	A	7	13	20	0	0	20	0	0
22	22353416	.	A	G	5	7	12	0	0	12	0	0
22	22353470	.	G	A	4	7	11	0	0	11	0	0
22	22353803	.	C	T	0	3	3	0	2	5	0	0
22	22353822	.	G	A	4	2	6	0	0	6	0	0
22	22353887	.	G	A	7	7	14	0	0	14	0	0
22	22353902	.	G	A	6	6	12	0	0	12	0	0
22	22354698	.	C	T	0	1	1	0	2	3	0	0
22	22354867	.	C	T	0	3	3	0	0	3	0	0
22	22376174	.	C	T	0	5	5	0	6	11	0	0
22	22397336	.	G	A	2	3	5	0	0	5	0	0
22	22397402	.	A	C	7	0	7	0	5	12	0	0
22	22418446	.	A	G	2	0	2	0	2	4	0	0
22	22420456	.	G	A	0	4	4	0	0	4	0	0
22	22422264	.	C	T	2	0	2	0	0	2	0	0
22	22422270	.	G	T	2	0	2	0	0	2	0	0
22	22424058	.	C	T	6	2	8	0	0	8	0	0
22	22424085	.	A	T	3	5	8	0	0	8	0	0
22	22424106	.	G	A	0	2	2	0	6	8	0	0
22	22427415	.	T	C	2	6	8	0	0	8	0	0
22	22427612	.	C	T	9	6	15	0	0	15	0	0
22	22428076	.	A	G	1	0	1	0	3	4	0	0
22	22428125	.	T	C	1	2	3	0	0	3	0	0
22	22636434	.	T	C	2	0	2	0	3	5	0	0
22	24358504	.	A	T	3	2	5	0	0	5	0	0
22	24359592	.	T	C	1	7	8	0	0	8	0	0
22	24361095	.	A	G	13	6	19	0	1	20	0	0
22	24621582	.	T	A	1	0	1	0	0	1	0	0
22	24621873	.	A	G	6	4	10	0	0	10	0	0
22	25942829	.	A	C	4	7	11	0	0	11	0	0
22	26180205	.	A	T	1	2	3	0	0	3	0	0
22	26180335	.	A	G	5	2	7	0	0	7	0	0
22	28848920	.	A	G	0	4	4	0	1	5	0	0
22	29585244	.	G	A	1	2	3	0	0	3	0	0
22	29585247	.	G	C	1	2	3	0	0	3	0	0
22	29585304	.	T	C	3	2	5	0	0	5	0	0
22	29585358	.	A	G	1	3	4	0	0	4	0	0
22	29612096	.	A	G	2	2	4	0	0	4	0	0
22	29615056	.	A	G	2	1	3	0	0	3	0	0
22	29617050	.	G	A	0	1	1	0	1	2	0	0
22	29620306	.	A	G	2	2	4	0	1	5	0	0
22	29620488	.	T	G	6	4	10	0	0	10	0	0
22	29640098	.	T	C	6	2	8	0	0	8	0	0
22	29651938	.	C	T	17	4	21	0	1	22	0	0
22	29652161	.	T	A	14	9	23	0	0	23	0	0
22	29652201	.	A	G	10	0	10	0	11	21	0	0
22	29659031	.	T	A	5	1	6	0	1	7	0	0
22	29659637	.	G	A	14	10	24	0	1	25	0	0
22	29666501	.	G	A	17	14	31	0	1	32	0	0
22	29666505	.	C	T	1	19	20	0	16	36	0	0
22	29666746	.	G	A	6	5	11	0	1	12	0	0
22	29668796	.	C	T	4	4	8	0	0	8	0	0
22	29668799	.	C	T	4	3	7	0	0	7	0	0
22	29670324	.	G	A	8	4	12	0	2	14	0	0
22	29671553	.	A	G	2	3	5	0	0	5	0	0
22	29689458	.	T	C	6	0	6	0	1	7	0	0
22	30359955	.	G	T	14	2	16	0	1	17	0	0
22	31440806	.	C	T	1	1	2	0	0	2	0	0
22	32237688	.	C	T	5	2	7	0	0	7	0	0
22	32237693	.	A	G	4	2	6	0	1	7	0	0
22	32290333	.	G	A	13	13	26	1	2	29	0	0
22	33190241	.	C	T	3	2	5	0	0	5	0	0
22	33190835	.	C	T	7	16	23	0	2	25	0	0
22	33190874	.	T	G	7	0	7	0	17	24	0	0
22	33190994	.	C	T	9	8	17	0	0	17	0	0
22	33191033	.	C	A	12	9	21	0	1	22	0	0
22	33191039	.	C	T	9	9	18	0	1	19	0	0
22	33191097	.	A	G	13	12	25	0	0	25	0	0
22	33191312	.	C	G	3	0	3	0	4	7	0	0
22	33191426	.	G	T	0	5	5	0	6	11	0	0
22	33191831	.	C	A	4	14	18	0	0	18	0	0
22	33191852	.	G	T	0	9	9	0	5	14	0	0
22	33192392	.	T	G	6	2	8	0	17	25	0	0
22	33192496	.	G	A	9	4	13	0	2	15	0	0
22	33193261	.	C	T	2	5	7	0	0	7	0	0
22	33194419	.	T	A	7	6	13	0	0	13	0	0
22	33194475	.	C	T	4	6	10	0	1	11	0	0
22	33194507	.	G	A	0	3	3	0	8	11	0	0
22	33364271	.	A	T	1	1	2	0	0	2	0	0
22	33364558	.	G	A	0	3	3	0	1	4	0	0
22	33371364	.	G	A	0	1	1	0	0	1	0	0
22	33378098	.	G	A	0	7	7	0	5	12	0	0
22	33378289	.	T	A	7	3	10	0	0	10	0	0
22	33378321	.	A	G	4	3	7	0	0	7	0	0
22	33378363	.	T	C	2	1	3	0	0	3	0	0
22	33378432	.	A	T	3	2	5	0	1	6	0	0
22	33378445	.	G	T	3	2	5	0	0	5	0	0
22	33378479	.	G	A	0	4	4	0	5	9	0	0
22	33535881	.	C	T	0	8	8	0	1	9	0	0
22	33535884	.	C	T	0	6	6	0	1	7	0	0
22	33591895	.	C	T	0	3	3	0	4	7	0	0
22	33592530	.	G	T	9	6	15	0	1	17	1	0
22	33592708	.	T	C	19	0	19	0	12	31	0	0
22	33639382	.	C	T	0	2	2	0	0	2	0	0
22	33639388	.	G	A	2	1	3	0	0	3	0	0
22	33639418	.	G	A	5	4	9	0	0	9	0	0
22	33791076	.	G	T	1	1	2	0	0	2	0	0
22	33915644	.	A	T	0	6	6	0	1	7	0	0
22	33915896	.	T	G	6	8	14	0	0	14	0	0
22	34431166	.	T	C	6	3	9	0	0	9	0	0
22	34431702	.	C	T	2	5	7	0	1	8	0	0
22	34701851	.	G	A	1	2	3	0	0	3	0	0
22	34701901	.	G	C	18	22	40	0	2	42	0	0
22	34706938	.	T	C	12	15	27	0	2	29	0	0
22	34707041	.	A	G	16	1	17	0	11	28	0	0
22	34707062	.	T	G	15	7	22	0	0	22	0	0
22	34707084	.	C	T	11	16	27	0	1	28	0	0
22	34707119	.	G	T	11	24	35	0	1	36	0	0
22	34707272	.	T	A	15	17	32	0	5	37	0	0
22	34707295	.	C	T	13	10	23	0	2	25	0	0
22	34806074	.	A	C	0	0	0	0	1	1	0	0
22	34817506	.	G	C	1	2	3	0	0	3	0	0
22	34843480	.	G	A	1	3	4	0	0	4	0	0
22	34843507	.	G	A	1	4	5	0	0	5	0	0
22	34843910	.	T	C	2	2	4	0	0	4	0	0
22	34843964	.	C	A	0	1	1	0	0	1	0	0
22	34847690	.	A	G	1	2	3	0	0	3	0	0
22	34851302	.	T	C	1	0	1	0	2	3	0	0
22	35013549	.	A	T	4	4	8	0	0	8	0	0
22	35013675	.	C	T	0	8	8	0	6	14	0	0
22	35013679	.	C	T	6	8	14	0	0	14	0	0
22	35013855	.	A	T	2	1	3	0	2	5	0	0
22	35013856	.	T	G	3	1	4	0	1	5	0	0
22	35014014	.	G	A	0	5	5	0	0	5	0	0
22	35015872	.	G	A	5	2	7	0	0	7	0	0
22	35015876	.	T	A	4	2	6	0	0	6	0	0
22	35016177	.	G	A	8	7	15	0	0	15	0	0
22	35016185	.	A	G	9	6	15	0	0	15	0	0
22	35041537	.	T	C	1	2	3	0	0	3	0	0
22	35049063	.	A	G	1	1	2	0	0	2	0	0
22	35473126	.	G	A	5	3	8	0	0	8	0	0
22	35520343	.	C	T	1	3	4	0	0	4	0	0
22	35527620	.	A	T	1	2	3	0	0	3	0	0
22	35527626	.	T	C	1	2	3	0	0	3	0	0
22	35531002	.	C	T	1	4	5	0	0	5	0	0
22	35531122	.	G	A	1	2	3	0	0	3	0	0
22	36899742	.	A	C	0	3	3	0	0	3	0	0
22	36899743	.	C	T	0	3	3	0	0	3	0	0
22	37542836	.	C	A	9	2	11	0	0	11	0	0
22	37543070	.	A	T	8	4	12	0	1	13	0	0
22	37543656	.	A	G	1	5	6	0	0	6	0	0
22	37550984	.	A	G	7	9	16	0	2	18	0	0
22	37551029	.	A	G	3	3	6	0	0	6	0	0
22	37551369	.	G	T	5	6	11	0	1	12	0	0
22	37551481	.	G	C	5	0	5	0	2	7	0	0
22	37552783	.	A	C	9	1	10	0	12	22	0	0
22	37555120	.	T	C	0	1	1	0	0	1	0	0
22	37555126	.	A	G	0	1	1	0	0	1	0	0
22	37557308	.	A	C	3	0	3	0	0	3	0	0
22	37557531	.	G	A	12	9	21	0	1	22	0	0
22	37559603	.	G	A	3	1	4	0	0	4	0	0
22	37561642	.	C	G	0	3	3	0	0	3	0	0
22	37588622	.	T	C	6	0	6	0	6	12	0	0
22	37588667	.	A	C	7	14	21	0	1	22	0	0
22	37588715	.	T	C	11	11	22	0	2	24	0	0
22	37589420	.	T	C	12	2	14	0	0	14	0	0
22	37589430	.	T	C	12	2	14	0	0	14	0	0
22	37589634	.	C	T	8	10	18	0	1	19	0	0
22	37589779	.	T	G	9	8	17	0	1	18	0	0
22	37589782	.	T	G	9	8	17	0	1	18	0	0
22	37589818	.	C	T	0	8	8	0	5	13	0	0
22	37589848	.	T	G	5	10	15	0	0	15	0	0
22	37590171	.	C	T	2	3	5	0	0	5	0	0
22	37590230	.	A	G	2	4	6	0	0	6	0	0
22	37590260	.	A	G	2	7	9	0	0	9	0	0
22	37590470	.	A	T	5	5	10	0	0	10	0	0
22	37590486	.	C	T	6	6	12	0	0	12	0	0
22	37590611	.	T	G	2	2	4	0	0	4	0	0
22	37590710	.	T	G	0	5	5	0	0	5	0	0
22	37590711	.	C	T	0	4	4	0	1	5	0	0
22	37590925	.	T	C	6	10	16	0	0	16	0	0
22	37591023	.	A	C	1	3	4	0	0	4	0	0
22	37591457	.	T	C	1	3	4	0	1	5	0	0
22	37599007	.	C	A	1	0	1	0	0	1	0	0
22	37608435	.	T	C	3	0	3	0	3	6	0	0
22	37608465	.	G	A	2	2	4	0	0	4	0	0
22	37639239	.	C	T	2	4	6	0	0	6	0	0
22	37644009	.	C	A	9	9	18	0	0	18	0	0
22	37644021	.	C	G	9	7	16	0	0	16	0	0
22	37646124	.	C	T	1	3	4	0	0	4	0	0
22	37650110	.	T	G	1	0	1	0	4	5	0	0
22	37650246	.	C	T	0	1	1	0	0	1	0	0
22	37652191	.	C	T	8	5	13	0	0	13	0	0
22	37652850	.	C	T	12	12	24	0	0	24	0	0
22	37691852	.	C	T	8	3	11	0	0	11	0	0
22	37697408	.	C	T	7	7	14	0	0	14	0	0
22	37699569	.	T	C	0	2	2	0	0	2	0	0
22	37708199	.	T	A	18	11	29	0	1	30	0	0
22	37710223	.	A	G	5	9	14	0	1	15	0	0
22	37710241	.	A	G	6	8	14	0	0	14	0	0
22	37712558	.	A	G	10	14	24	0	0	24	0	0
22	37737696	.	A	G	1	3	4	0	0	4	0	0
22	37738195	.	C	T	0	1	1	0	0	1	0	0
22	37746900	.	G	C	0	1	1	0	0	1	0	0
22	37746901	.	G	A	0	1	1	0	0	1	0	0
22	37805329	.	C	T	13	20	33	0	1	34	0	0
22	37834045	.	G	T	9	7	16	0	1	17	0	0
22	37834164	.	G	C	14	11	25	0	0	25	0	0
22	37881090	.	A	G	1	3	4	0	0	4	0	0
22	37951877	.	G	A	1	2	3	0	0	3	0	0
22	37952411	.	A	T	2	3	5	0	0	5	0	0
22	37952448	.	G	C	2	2	4	0	0	4	0	0
22	38014843	.	A	G	1	4	5	0	0	5	0	0
22	38041959	.	C	T	4	2	6	0	0	6	0	0
22	38044902	.	G	C	0	15	15	0	6	21	0	0
22	38045009	.	T	A	7	10	17	0	1	18	0	0
22	38174040	.	C	T	2	2	4	0	0	4	0	0
22	38183600	.	A	G	2	0	2	0	1	3	0	0
22	38186409	.	A	G	0	0	0	0	1	1	0	0
22	38191136	.	G	A	1	4	5	0	0	5	0	0
22	38191715	.	A	G	11	9	20	0	1	21	0	0
22	38191778	.	T	G	3	9	12	0	0	12	0	0
22	38192440	.	A	G	6	1	7	0	0	7	0	0
22	38194415	.	A	G	4	2	6	0	0	6	0	0
22	38194419	.	G	C	3	2	5	0	0	5	0	0
22	38199709	.	A	C	6	6	12	0	0	12	0	0
22	38199716	.	C	T	6	6	12	0	0	12	0	0
22	38199864	.	C	A	3	5	8	0	0	8	0	0
22	38199902	.	G	T	4	4	8	0	0	8	0	0
22	38199908	.	A	C	3	2	5	0	0	5	0	0
22	38205072	.	A	G	4	10	14	0	0	14	0	0
22	38205099	.	C	T	0	5	5	0	4	9	0	0
22	38207454	.	A	G	3	4	7	0	0	7	0	0
22	38207495	.	G	T	1	1	2	0	0	2	0	0
22	38217308	.	G	C	1	0	1	0	0	1	0	0
22	38219195	.	G	C	2	2	4	0	0	4	0	0
22	38224197	.	A	T	3	4	7	0	0	7	0	0
22	38276083	.	T	A	1	3	4	0	0	4	0	0
22	38280834	.	T	G	3	0	3	0	2	5	0	0
22	38283993	.	A	G	2	1	3	0	0	3	0	0
22	38284047	.	G	A	1	1	2	0	0	2	0	0
22	38293836	.	G	A	0	7	7	0	3	10	0	0
22	38293866	.	A	T	6	6	12	0	4	16	0	0
22	38337414	.	T	C	5	2	7	0	1	8	0	0
22	38337417	.	A	C	6	0	6	0	3	9	0	0
22	38343178	.	G	A	1	1	2	0	0	2	0	0
22	38468163	.	A	G	6	7	13	0	1	14	0	0
22	38468562	.	C	T	0	25	25	0	17	42	0	0
22	38469848	.	C	A	0	18	18	0	24	42	0	0
22	38469856	.	G	A	24	15	39	0	0	39	0	0
22	38469884	.	G	A	11	16	27	0	2	29	0	0
22	38469926	.	G	A	2	5	7	0	0	7	0	0
22	38471854	.	T	A	23	15	38	0	3	41	0	0
22	38474186	.	G	A	5	3	8	0	1	9	0	0
22	38475506	.	C	A	4	0	4	0	0	4	0	0
22	38475593	.	A	G	23	19	42	0	3	45	0	0
22	38492116	.	G	A	13	14	27	0	1	28	0	0
22	38499700	.	C	T	2	7	9	0	0	9	0	0
22	38499727	.	C	T	0	0	0	0	1	1	0	0
22	38501788	.	A	G	9	4	13	0	0	13	0	0
22	38501815	.	G	C	12	14	26	0	1	27	0	0
22	38508006	.	C	A	11	8	19	0	2	21	0	0
22	38508018	.	C	A	12	5	17	0	3	20	0	0
22	38508100	.	C	T	2	1	3	0	0	3	0	0
22	38508102	.	C	T	2	1	3	0	0	3	0	0
22	38516814	.	A	T	8	6	14	0	1	15	0	0
22	38516816	.	C	T	8	6	14	0	1	15	0	0
22	38516893	.	C	T	8	5	13	0	1	14	0	0
22	38516899	.	G	A	5	6	11	0	0	11	0	0
22	38520336	.	A	C	12	1	13	0	8	21	0	0
22	38520360	.	A	C	7	10	17	0	1	18	0	0
22	38521095	.	T	C	17	14	31	0	1	32	0	0
22	38521154	.	G	C	10	12	22	0	0	22	0	0
22	38521454	.	C	A	6	9	15	0	0	15	0	0
22	38521596	.	C	G	9	5	14	0	0	14	0	0
22	38521630	.	A	G	8	14	22	0	0	22	0	0
22	38521743	.	C	T	5	6	11	0	0	11	0	0
22	38521949	.	T	A	14	9	23	0	0	23	0	0
22	38522431	.	T	A	6	4	10	0	0	10	0	0
22	38522436	.	T	C	5	0	5	0	6	11	0	0
22	38522622	.	G	C	11	10	21	0	1	22	0	0
22	38522711	.	G	A	11	21	32	0	0	32	0	0
22	38523376	.	A	C	3	0	3	0	8	11	0	0
22	38523616	.	C	G	8	8	16	0	1	17	0	0
22	38523658	.	A	T	5	8	13	0	0	13	0	0
22	38523917	.	C	A	0	8	8	0	5	13	0	0
22	38524033	.	T	C	4	6	10	0	0	10	0	0
22	38524107	.	C	T	3	5	8	0	0	8	0	0
22	38524465	.	G	T	0	4	4	0	0	4	0	0
22	38524494	.	C	T	0	3	3	0	5	8	0	0
22	38524536	.	T	G	9	6	15	0	0	15	0	0
22	38524539	.	C	T	1	6	7	0	9	16	0	0
22	38524616	.	A	T	5	6	11	0	0	11	0	0
22	38524621	.	G	C	7	4	11	0	0	11	0	0
22	38524701	.	T	G	8	4	12	0	0	12	0	0
22	38524721	.	T	C	5	0	5	0	8	13	0	0
22	38524740	.	A	C	8	4	12	0	1	13	0	0
22	38524771	.	G	A	7	2	9	0	1	10	0	0
22	38525082	.	G	A	5	1	6	0	0	6	0	0
22	38525146	.	A	G	5	7	12	0	0	12	0	0
22	38525155	.	A	T	4	6	10	0	0	10	0	0
22	38525326	.	T	G	6	5	11	0	0	11	0	0
22	38525789	.	A	C	3	5	8	0	1	9	0	0
22	38525996	.	G	T	5	5	10	0	1	11	0	0
22	38530277	.	T	C	4	4	8	0	0	8	0	0
22	38545882	.	A	C	4	0	4	0	1	5	0	0
22	38545921	.	C	T	0	6	6	0	1	7	0	0
22	38549990	.	A	G	1	2	3	0	0	3	0	0
22	38550922	.	T	C	2	1	3	0	0	3	0	0
22	38566147	.	T	C	1	1	2	0	1	3	0	0
22	38567348	.	C	T	0	0	0	0	3	3	0	0
22	38567431	.	G	A	1	3	4	0	0	4	0	0
22	38615295	.	T	C	8	0	8	0	6	14	0	0
22	38796440	.	G	A	0	3	3	0	0	3	0	0
22	38796464	.	G	T	3	2	5	0	0	5	0	0
22	38796689	.	G	A	4	4	8	0	0	8	0	0
22	38796813	.	A	T	2	0	2	0	0	2	0	0
22	38798816	.	T	C	4	0	4	0	3	7	0	0
22	38800183	.	T	C	1	0	1	0	1	2	0	0
22	38911467	.	G	A	0	2	2	0	0	2	0	0
22	38911514	.	C	T	2	3	5	0	0	5	0	0
22	38911553	.	T	G	2	0	2	0	2	4	0	0
22	38911575	.	C	T	2	2	4	0	0	4	0	0
22	38911762	.	T	G	2	0	2	0	4	6	0	0
22	38912360	.	A	G	4	4	8	0	1	9	0	0
22	38912445	.	A	G	3	2	5	0	0	5	0	0
22	38913661	.	G	A	2	2	4	0	0	4	0	0
22	38915088	.	C	T	2	4	6	0	0	6	0	0
22	38919079	.	T	C	1	2	3	0	0	3	0	0
22	38925404	.	A	G	0	0	0	0	1	1	0	0
22	38928275	.	T	A	4	3	7	0	0	7	0	0
22	38928367	.	G	C	0	4	4	0	4	8	0	0
22	38928475	.	C	T	2	3	5	0	0	5	0	0
22	38928677	.	C	G	0	3	3	0	0	3	0	0
22	38932288	.	G	A	2	8	10	0	1	11	0	0
22	38932327	.	G	A	14	6	20	0	1	21	0	0
22	38935074	.	A	G	0	2	2	0	2	4	0	0
22	38935083	.	C	T	1	6	7	0	0	7	0	0
22	38943059	.	T	C	3	5	8	0	0	8	0	0
22	38943113	.	T	C	1	4	5	0	0	5	0	0
22	38943838	.	C	G	1	4	5	0	1	6	0	0
22	38945312	.	C	T	1	0	1	0	0	1	0	0
22	38946251	.	C	T	6	2	8	0	0	8	0	0
22	38947013	.	G	A	15	11	26	0	0	26	0	0
22	38947040	.	G	A	10	11	21	0	0	21	0	0
22	38951084	.	T	C	3	7	10	0	0	10	0	0
22	38951186	.	G	T	2	2	4	0	0	4	0	0
22	39014557	.	A	G	1	2	3	0	0	3	0	0
22	39014569	.	G	A	0	2	2	0	1	3	0	0
22	39023330	.	A	G	1	0	1	0	3	4	0	0
22	39023444	.	A	G	2	0	2	0	3	5	0	0
22	39023680	.	C	A	8	4	12	0	0	12	0	0
22	39023804	.	T	G	7	0	7	0	6	13	0	0
22	39023863	.	G	C	0	10	10	0	5	15	0	0
22	39023877	.	T	A	6	8	14	0	0	14	0	0
22	39024002	.	T	A	2	4	6	0	0	6	0	0
22	39024005	.	C	A	2	4	6	0	0	6	0	0
22	39026706	.	T	C	4	5	9	0	0	9	0	0
22	39028350	.	G	A	0	3	3	0	3	6	0	0
22	39032915	.	C	T	4	3	7	0	1	8	0	0
22	39033036	.	C	G	2	4	6	0	1	7	0	0
22	39033053	.	C	T	6	3	9	0	0	9	0	0
22	39033644	.	T	C	6	7	13	0	0	13	0	0
22	39054436	.	G	T	1	3	4	0	0	5	1	0
22	39054503	.	T	C	5	2	7	0	0	7	0	0
22	39054683	.	T	C	4	4	8	0	0	8	0	0
22	39068386	.	A	G	2	0	2	0	1	3	0	0
22	39079231	.	T	C	13	12	25	0	1	26	0	0
22	39079335	.	G	A	0	12	12	0	7	19	0	0
22	39079528	.	T	A	3	8	11	0	1	12	0	0
22	39079950	.	C	A	11	11	22	0	3	25	0	0
22	39079997	.	A	G	13	12	25	0	0	25	0	0
22	39080290	.	C	T	6	8	14	0	0	14	0	0
22	39080300	.	A	T	6	8	14	0	0	14	0	0
22	39080402	.	A	C	16	11	27	0	1	28	0	0
22	39080547	.	A	C	11	13	24	0	1	25	0	0
22	39080679	.	C	G	11	8	19	0	1	20	0	0
22	39080701	.	C	A	12	10	22	0	0	22	0	0
22	39080774	.	C	G	11	8	19	0	1	20	0	0
22	39081126	.	A	T	17	8	25	0	0	25	0	0
22	39081169	.	A	G	9	0	9	0	14	23	0	0
22	39081177	.	C	T	14	10	24	0	1	25	0	0
22	39081259	.	T	A	10	9	19	0	0	19	0	0
22	39084943	.	G	A	4	7	11	0	1	12	0	0
22	39093984	.	T	C	2	5	7	0	0	7	0	0
22	39095748	.	G	A	9	7	16	0	0	16	0	0
22	39096090	.	C	A	3	6	9	0	0	9	0	0
22	39100979	.	G	A	0	2	2	0	6	8	0	0
22	39100984	.	C	T	5	3	8	0	0	8	0	0
22	39103941	.	T	C	4	2	6	0	0	6	0	0
22	39104849	.	G	A	0	2	2	0	0	2	0	0
23	252280	.	T	C	6	0	6	0	4	10	0	0
23	252305	.	T	C	4	4	8	0	1	9	0	0
23	458254	.	T	C	7	8	15	0	1	16	0	0
23	585458	.	A	G	5	0	5	0	4	9	0	0
23	585461	.	C	T	9	0	9	0	0	9	0	0
23	585624	.	A	G	5	5	10	0	2	12	0	0
23	587114	.	A	G	2	0	2	0	4	6	0	0
23	587161	.	A	G	7	3	10	0	1	11	0	0
23	587398	.	A	G	12	0	12	0	5	17	0	0
23	587412	.	A	G	12	7	19	0	0	19	0	0
23	588086	.	A	C	6	1	7	0	14	21	0	0
23	863395	.	T	C	5	4	9	0	0	9	0	0
23	863659	.	T	C	7	4	11	0	1	12	0	0
23	864363	.	T	C	4	3	7	0	0	7	0	0
23	864376	.	T	C	0	4	4	0	1	5	0	0
23	1719384	.	A	G	1	1	2	0	0	2	0	0
23	1723720	.	A	G	1	0	1	0	3	4	0	0
23	1723992	.	C	T	2	5	7	0	0	7	0	0
23	1725456	.	T	C	8	4	12	0	0	12	0	0
23	1725664	.	G	A	6	4	10	0	0	10	0	0
23	1725785	.	G	C	4	3	7	0	1	8	0	0
23	1725803	.	G	C	5	2	7	0	0	7	0	0
23	1725959	.	C	T	16	3	19	0	3	22	0	0
23	1725974	.	T	A	19	5	24	0	0	24	0	0
23	1726080	.	T	C	10	9	19	0	2	21	0	0
23	1726106	.	G	T	11	6	17	0	1	18	0	0
23	2053414	.	A	G	6	3	9	0	0	9	0	0
23	2053418	.	C	A	6	5	11	0	0	11	0	0
23	2054010	.	C	T	6	12	18	0	3	21	0	0
23	2054175	.	G	A	3	4	7	0	0	7	0	0
23	2054316	.	C	G	3	6	9	0	2	11	0	0
23	2054505	.	G	A	2	3	5	0	0	5	0	0
23	2054584	.	G	C	2	4	6	0	0	6	0	0
23	2054613	.	A	G	2	3	5	0	0	5	0	0
23	2054622	.	T	C	2	0	2	0	4	6	0	0
23	2054760	.	G	A	3	4	7	0	0	7	0	0
23	2054838	.	C	T	0	7	7	0	3	10	0	0
23	2054952	.	T	G	3	6	9	0	1	10	0	0
23	2055162	.	G	A	1	2	3	0	0	3	0	0
23	2055219	.	T	C	1	0	1	0	0	1	0	0
23	2055240	.	T	A	1	0	1	0	0	1	0	0
23	2065051	.	T	C	2	1	3	0	0	3	0	0
23	2081004	.	T	G	4	2	6	0	0	6	0	0
23	2099158	.	A	G	1	4	5	0	0	5	0	0
23	2136417	.	T	C	9	8	17	0	0	17	0	0
23	2155134	.	T	C	1	0	1	0	0	1	0	0
23	2158054	.	T	C	2	3	5	0	0	5	0	0
23	2160242	.	T	C	3	3	6	0	0	6	0	0
23	2242494	.	T	C	2	2	4	0	0	4	0	0
23	2246915	.	G	A	0	0	0	0	1	1	0	0
23	2249589	.	G	A	0	2	2	0	2	4	0	0
23	2249633	.	T	C	1	2	3	0	0	3	0	0
23	2252812	.	G	A	3	2	5	0	0	5	0	0
23	2256142	.	G	C	0	3	3	0	0	3	0	0
23	2435776	.	G	A	2	0	2	0	0	2	0	0
23	2438388	.	G	A	12	14	26	0	1	27	0	0
23	2438463	.	G	T	0	9	9	0	8	17	0	0
23	2438641	.	A	T	16	9	25	0	0	25	0	0
23	2440698	.	G	A	6	3	9	0	0	9	0	0
23	2443160	.	C	T	13	16	29	0	1	30	0	0
23	2443613	.	C	T	8	24	32	0	2	34	0	0
23	2443772	.	T	C	5	4	9	2	0	11	0	0
23	2443782	.	T	C	4	2	6	2	3	11	0	0
23	2547556	.	A	C	2	6	8	0	0	8	0	0
23	2564339	.	T	A	10	7	17	0	1	18	0	0
23	2564420	.	T	C	11	6	17	0	1	18	0	0
23	2679634	.	G	A	0	4	4	0	4	8	0	0
23	2689807	.	T	C	7	4	11	0	1	12	0	0
23	2690659	.	C	T	8	2	10	0	0	10	0	0
23	2709931	.	T	C	0	1	1	0	0	1	0	0
23	2717852	.	A	C	13	12	25	0	4	29	0	0
23	2717867	.	T	G	15	10	25	0	2	27	0	0
23	2718009	.	C	G	18	11	29	0	0	29	0	0
23	2721539	.	A	G	13	16	29	0	2	31	0	0
23	2725095	.	A	C	5	12	17	0	1	18	0	0
23	2757841	.	C	T	1	1	2	0	0	2	0	0
23	2757876	.	T	A	1	1	2	0	0	2	0	0
23	2762007	.	A	G	1	4	5	0	0	5	0	0
23	2762855	.	G	A	2	1	3	0	0	3	0	0
23	2767194	.	G	A	0	3	3	0	4	7	0	0
23	2767227	.	C	T	5	4	9	0	0	9	0	0
23	2770169	.	G	A	1	0	1	0	0	1	0	0
23	2770171	.	A	C	1	0	1	0	0	1	0	0
23	2774812	.	G	A	3	1	4	0	0	4	0	0
23	2775033	.	G	A	0	3	3	0	0	3	0	0
23	2777534	.	G	A	1	1	2	0	1	3	0	0
23	2837155	.	T	C	3	2	5	0	0	5	0	0
23	2839156	.	G	T	0	2	2	0	2	4	0	0
23	2842292	.	G	T	0	1	1	0	1	2	0	0
23	2849307	.	G	A	0	7	7	0	7	14	0	0
23	2860937	.	T	G	1	0	1	0	0	1	0	0
23	2861990	.	C	T	5	10	15	0	1	16	0	0
23	2864186	.	A	T	2	1	3	0	0	3	0	0
23	2870732	.	T	A	5	7	12	0	0	12	0	0
23	2871264	.	C	T	5	7	12	0	0	12	0	0
23	2871699	.	G	A	9	5	14	0	2	16	0	0
23	2871908	.	A	G	5	3	8	0	1	9	0	0
23	2871994	.	T	C	10	10	20	0	0	20	0	0
23	2872206	.	T	C	8	15	23	0	1	24	0	0
23	2872517	.	G	T	20	17	37	0	6	43	0	0
23	2872924	.	A	C	3	3	6	0	0	6	0	0
23	2873327	.	A	T	6	5	11	0	0	11	0	0
23	2877144	.	C	T	0	7	7	0	8	15	0	0
23	2877519	.	T	C	4	0	4	0	3	7	0	0
23	2877603	.	A	C	6	4	10	0	0	10	0	0
23	2877792	.	C	A	0	4	4	0	4	8	0	0
23	2877930	.	T	C	3	4	7	0	0	7	0	0
23	2878041	.	C	A	0	8	8	0	4	12	0	0
23	2878401	.	A	G	5	7	12	0	0	12	0	0
23	2878629	.	T	G	3	2	5	0	0	5	0	0
23	2878630	.	A	C	3	2	5	0	0	5	0	0
23	2879040	.	A	G	4	3	7	0	0	7	0	0
23	2879235	.	A	G	2	4	6	0	0	6	0	0
23	2879618	.	A	G	3	6	9	0	0	9	0	0
23	2880143	.	T	C	1	3	4	0	0	4	0	0
23	2900767	.	A	G	4	2	6	0	0	6	0	0
23	2906312	.	A	G	4	5	9	0	3	12	0	0
23	2917463	.	T	C	3	2	5	0	0	5	0	0
23	2925086	.	T	C	3	1	4	0	0	4	0	0
23	2925137	.	C	T	3	8	11	0	0	11	0	0
23	2925238	.	A	T	0	1	1	0	0	1	0	0
23	2925357	.	T	C	1	1	2	0	0	2	0	0
23	2927117	.	A	G	3	2	5	0	0	5	0	0
23	2927144	.	A	G	2	3	5	0	1	6	0	0
23	2927175	.	C	T	1	0	1	0	0	1	0	0
23	2931288	.	T	A	7	7	14	0	0	14	0	0
23	2931321	.	G	A	7	6	13	0	0	13	0	0
23	2931329	.	C	A	5	8	13	0	0	13	0	0
23	2931358	.	C	T	9	2	11	0	1	12	0	0
23	2931409	.	C	T	8	8	16	0	1	17	0	0
23	2931461	.	A	G	8	1	9	0	7	16	0	0
23	2931732	.	C	A	3	9	12	0	1	13	0	0
23	2932241	.	A	T	9	6	15	0	0	15	0	0
23	3406094	.	C	A	5	7	12	0	0	12	0	0
23	3406708	.	T	C	9	6	15	0	5	20	0	0
23	3406729	.	A	G	15	11	26	0	0	26	0	0
23	3406811	.	T	C	14	14	28	0	3	31	0	0
23	3406950	.	T	G	5	4	9	0	0	9	0	0
23	3407285	.	T	A	6	17	23	0	3	26	0	0
23	3407305	.	C	A	9	14	23	0	1	24	0	0
23	3503614	.	C	A	1	6	7	0	0	8	1	0
23	3503622	.	A	G	2	9	11	0	0	11	0	0
23	3511204	.	C	A	1	3	4	0	0	4	0	0
23	3511291	.	T	C	2	4	6	0	1	7	0	0
23	3517621	.	T	G	4	2	6	0	0	6	0	0
23	3517734	.	T	G	4	0	4	0	3	7	0	0
23	3520120	.	C	T	9	7	16	0	0	16	0	0
23	3653478	.	G	T	13	21	34	0	0	34	0	0
23	3653846	.	T	C	20	7	27	0	0	27	0	0
23	3653859	.	G	A	18	8	26	0	1	27	0	0
23	3653953	.	T	A	9	9	18	0	3	21	0	0
23	3654034	.	A	G	8	10	18	0	1	19	0	0
23	3654106	.	C	T	7	6	13	0	1	14	0	0
23	3654134	.	A	G	5	10	15	0	0	15	0	0
23	3654356	.	C	T	6	9	15	0	0	15	0	0
23	3654490	.	A	C	16	9	25	0	2	27	0	0
23	3654747	.	C	T	1	15	16	0	24	40	0	0
23	3654774	.	G	A	14	17	31	0	2	33	0	0
23	3654989	.	A	G	17	25	42	0	1	43	0	0
23	3655082	.	C	T	2	14	16	0	18	35	1	0
23	3655139	.	T	A	16	20	36	0	2	38	0	0
23	3655207	.	T	G	24	14	38	0	0	38	0	0
23	3655220	.	A	G	23	17	40	0	1	41	0	0
23	3657557	.	T	C	22	16	38	0	3	41	0	0
23	3657602	.	T	C	27	0	27	0	26	53	0	0
23	3660060	.	C	A	0	15	15	0	12	27	0	0
23	3660674	.	A	G	17	6	23	0	0	23	0	0
23	3660713	.	G	A	3	0	3	0	0	3	0	0
23	3662210	.	G	A	26	17	43	0	1	44	0	0
23	3662246	.	C	T	0	7	7	0	19	26	0	0
23	3664306	.	A	G	8	10	18	0	0	18	0	0
23	3667257	.	T	C	12	10	22	0	2	24	0	0
23	3711308	.	C	A	5	2	7	0	0	7	0	0
23	3711949	.	T	G	7	4	11	0	0	11	0	0
23	3712002	.	G	A	6	3	9	0	1	10	0	0
23	3712062	.	C	T	6	3	9	2	1	12	0	0
23	3712973	.	A	C	2	1	3	0	0	3	0	0
23	3713045	.	T	G	1	4	5	0	0	5	0	0
23	3713321	.	A	G	9	7	16	0	0	16	0	0
23	3713363	.	A	G	4	11	15	0	2	17	0	0
23	3713388	.	C	T	5	10	15	0	0	15	0	0
23	3713400	.	A	C	3	11	14	0	1	15	0	0
23	3713452	.	T	C	5	5	10	0	1	11	0	0
23	3713453	.	G	A	5	6	11	0	0	11	0	0
23	3713491	.	G	A	8	5	13	0	0	13	0	0
23	3713622	.	A	G	6	5	11	0	0	11	0	0
23	3713643	.	G	A	3	3	6	0	0	6	0	0
23	3713692	.	T	A	2	4	6	0	0	6	0	0
23	3713928	.	A	G	1	3	4	0	2	6	0	0
23	3713968	.	C	T	0	1	1	0	0	1	0	0
23	3721131	.	T	C	10	11	21	0	2	23	0	0
23	3740379	.	T	A	4	6	10	0	0	10	0	0
23	3744621	.	C	T	0	2	2	0	0	2	0	0
23	3744654	.	A	C	2	5	7	0	0	7	0	0
23	3751965	.	A	G	20	20	40	0	1	41	0	0
23	3751990	.	A	G	18	20	38	0	3	41	0	0
23	3752305	.	C	G	14	16	30	0	0	30	0	0
23	3752394	.	C	T	0	14	14	0	19	33	0	0
23	3752992	.	T	A	16	9	25	0	1	26	0	0
23	3758524	.	T	A	2	2	4	0	0	4	0	0
23	3951804	.	T	C	7	8	15	0	1	16	0	0
23	3962692	.	A	G	1	3	4	0	2	6	0	0
23	3982480	.	G	A	0	1	1	0	0	1	0	0
23	4086772	.	G	A	1	2	3	0	0	3	0	0
23	4086817	.	T	G	4	2	6	0	0	6	0	0
23	4086829	.	C	G	3	2	5	0	0	5	0	0
23	4216221	.	G	A	1	2	3	0	0	3	0	0
23	4216241	.	C	T	2	3	5	0	0	5	0	0
23	4216363	.	T	C	2	0	2	0	2	4	0	0
23	4216472	.	C	T	4	5	9	0	0	9	0	0
23	4222119	.	A	G	1	5	6	0	0	6	0	0
23	4222149	.	G	A	3	4	7	0	1	8	0	0
23	4222164	.	G	T	4	4	8	0	0	8	0	0
23	4254105	.	G	T	0	27	27	0	26	53	0	0
23	4254192	.	A	C	14	7	21	0	0	21	0	0
23	4255566	.	C	G	32	0	32	0	19	51	0	0
23	4259194	.	A	G	23	19	42	0	0	42	0	0
23	4259369	.	T	G	18	24	42	0	0	42	0	0
23	4259626	.	G	A	13	21	34	0	0	34	0	0
23	4259635	.	G	C	3	19	22	0	9	31	0	0
23	4259674	.	G	T	5	10	15	0	3	18	0	0
23	4260629	.	G	A	0	1	1	0	0	1	0	0
23	4269780	.	C	G	3	2	5	0	0	5	0	0
23	4270928	.	T	C	3	3	6	0	0	6	0	0
23	4271333	.	A	G	17	29	46	0	0	47	1	0
23	4271730	.	G	C	12	12	24	0	0	24	0	0
23	4274411	.	G	T	2	3	5	0	1	6	0	0
23	4274423	.	C	T	2	6	8	0	0	8	0	0
23	4280198	.	A	C	0	1	1	0	0	1	0	0
23	4280602	.	A	G	2	0	2	0	3	5	0	0
23	4280719	.	C	T	1	2	3	0	0	3	0	0
23	4280747	.	C	T	2	2	4	0	0	4	0	0
23	4280818	.	G	C	0	2	2	0	1	3	0	0
23	4280821	.	C	T	1	2	3	0	0	3	0	0
23	4280877	.	A	C	3	2	5	0	0	5	0	0
23	4280888	.	G	A	3	2	5	0	0	5	0	0
23	4289066	.	C	G	3	5	8	0	2	10	0	0
23	4292251	.	C	T	1	0	1	0	0	1	0	0
23	4307737	.	C	T	2	2	4	0	0	4	0	0
23	4307740	.	T	C	2	2	4	0	0	4	0	0
23	4312033	.	T	G	2	6	8	0	0	9	1	0
23	4314691	.	G	A	12	5	17	0	0	17	0	0
23	4355923	.	C	T	1	0	1	0	0	1	0	0
23	4356128	.	C	A	1	2	3	0	0	3	0	0
23	4356999	.	C	T	2	2	4	0	0	4	0	0
23	4362847	.	C	G	1	2	3	0	0	3	0	0
23	4362874	.	T	C	1	3	4	0	0	4	0	0
23	4364914	.	C	T	2	5	7	0	0	7	0	0
23	4367390	.	T	A	2	1	3	0	0	3	0	0
23	4392598	.	T	G	2	2	4	0	0	4	0	0
23	4542695	.	A	T	1	2	3	0	0	3	0	0
23	4545422	.	C	T	0	2	2	0	0	2	0	0
23	4545451	.	A	G	0	0	0	0	1	1	0	0
23	4553255	.	T	C	0	2	2	0	0	2	0	0
23	4557759	.	A	T	1	2	3	0	0	3	0	0
23	4677468	.	T	G	4	0	4	0	10	14	0	0
23	5010250	.	T	A	2	3	5	0	0	5	0	0
23	5010722	.	C	T	7	6	13	0	1	14	0	0
23	5011064	.	T	A	5	6	11	0	0	11	0	0
23	5011968	.	A	G	1	2	3	0	0	3	0	0
23	5012763	.	A	G	1	4	5	0	0	5	0	0
23	5565897	.	A	G	2	3	5	0	1	6	0	0
23	5583113	.	C	T	1	1	2	0	1	3	0	0
23	5585483	.	T	C	1	5	6	0	0	6	0	0
23	5585528	.	G	T	2	2	4	0	0	4	0	0
23	5585555	.	T	C	2	0	2	0	0	2	0	0
23	5587625	.	T	C	3	2	5	0	2	7	0	0
23	5587626	.	C	A	5	2	7	0	0	7	0	0
23	5587860	.	G	A	1	2	3	0	0	3	0	0
23	5757193	.	G	T	0	2	2	0	0	2	0	0
23	5757202	.	C	T	0	2	2	0	0	2	0	0
23	5759014	.	A	T	3	2	5	0	1	6	0	0
23	5759102	.	C	T	0	2	2	0	4	6	0	0
23	5759124	.	A	G	3	6	9	0	0	9	0	0
23	6011958	.	A	G	1	2	3	0	0	3	0	0
23	6027415	.	T	G	1	3	4	0	0	4	0	0
23	6027439	.	G	A	1	3	4	0	0	4	0	0
23	6028015	.	C	T	1	3	4	0	0	4	0	0
23	6028051	.	G	A	1	3	4	0	0	4	0	0
23	6046867	.	T	C	0	1	1	0	0	1	0	0
23	6058704	.	C	T	1	4	5	0	0	5	0	0
23	6064579	.	T	C	4	2	6	0	1	7	0	0
23	6272793	.	C	T	4	4	8	0	0	8	0	0
23	6301287	.	T	A	3	3	6	0	0	6	0	0
23	6301332	.	T	C	7	10	17	0	0	17	0	0
23	6301413	.	A	G	0	2	2	0	0	2	0	0
23	6301416	.	T	C	0	1	1	0	1	2	0	0
23	6304243	.	A	G	9	1	10	0	10	20	0	0
23	6304249	.	T	C	9	7	16	0	2	18	0	0
23	6421776	.	T	C	3	4	7	0	1	8	0	0
23	6421954	.	G	A	1	0	1	0	0	1	0	0
23	6600899	.	C	T	4	1	5	0	0	5	0	0
23	6783757	.	A	C	3	0	3	0	14	17	0	0
23	6938373	.	G	A	1	1	2	0	2	4	0	0
23	6951157	.	C	T	0	3	3	0	3	6	0	0
23	6955860	.	G	A	5	3	8	0	0	8	0	0
23	6982389	.	T	C	1	0	1	0	1	2	0	0
23	7003744	.	C	T	4	1	5	0	0	5	0	0
23	7007480	.	C	T	4	6	10	0	1	11	0	0
23	7027534	.	C	T	0	5	5	0	3	8	0	0
23	7029600	.	G	A	4	2	6	0	0	6	0	0
23	7029777	.	A	T	1	1	2	0	0	2	0	0
23	7029916	.	A	T	5	5	10	0	0	10	0	0
23	7029964	.	A	C	4	0	4	0	1	5	0	0
23	7032435	.	C	A	6	5	11	0	1	12	0	0
23	7040708	.	T	A	2	3	5	0	0	5	0	0
23	7067257	.	T	C	4	4	8	0	1	9	0	0
23	7557383	.	G	A	0	2	2	0	2	4	0	0
23	7567446	.	C	T	0	2	2	0	0	2	0	0
23	7572445	.	A	G	5	0	5	0	5	10	0	0
23	7578710	.	T	C	8	11	19	0	1	20	0	0
23	7709095	.	A	C	1	2	3	0	1	4	0	0
23	7715651	.	C	T	1	5	6	0	0	6	0	0
23	7715747	.	A	G	2	9	11	0	0	11	0	0
23	7715801	.	G	A	0	4	4	0	2	6	0	0
23	7715873	.	G	A	1	4	5	0	1	6	0	0
23	7715909	.	T	C	2	7	9	0	0	9	0	0
23	7715945	.	G	C	0	4	4	0	4	8	0	0
23	7716281	.	T	C	6	4	10	0	1	11	0	0
23	7718380	.	G	A	3	2	5	0	0	5	0	0
23	7718972	.	G	A	0	3	3	0	3	6	0	0
23	7721342	.	A	G	1	1	2	0	1	3	0	0
23	7732578	.	T	C	4	5	9	0	1	10	0	0
23	7732760	.	C	G	2	3	5	0	1	6	0	0
23	7733088	.	C	G	3	4	7	0	0	7	0	0
23	7733603	.	T	C	6	4	10	0	0	10	0	0
23	7733614	.	G	T	8	5	13	0	0	13	0	0
23	7733732	.	T	C	1	3	4	0	0	4	0	0
23	7733826	.	T	A	2	2	4	0	0	4	0	0
23	7733836	.	T	C	2	2	4	0	0	4	0	0
23	7734213	.	A	T	3	3	6	0	0	6	0	0
23	7734321	.	C	T	1	3	4	0	1	5	0	0
23	7734801	.	C	A	1	1	2	0	0	2	0	0
23	7734994	.	G	A	1	3	4	0	0	4	0	0
23	7735423	.	G	A	2	4	6	0	0	6	0	0
23	7735497	.	T	C	4	5	9	0	0	9	0	0
23	7735649	.	C	T	6	9	15	0	0	15	0	0
23	7735809	.	A	T	2	2	4	0	0	4	0	0
23	7736024	.	A	G	4	2	6	0	1	7	0	0
23	7736089	.	T	G	4	0	4	0	8	12	0	0
23	7743670	.	T	C	1	4	5	0	0	5	0	0
23	7743691	.	T	C	2	7	9	0	0	9	0	0
23	7746618	.	T	C	0	0	0	0	2	2	0	0
23	7750693	.	A	C	1	5	6	0	0	6	0	0
23	7755088	.	T	C	1	0	1	0	2	3	0	0
23	7755112	.	A	C	1	1	2	0	1	3	0	0
23	7755189	.	T	G	1	5	6	0	0	6	0	0
23	7762045	.	A	G	2	10	12	0	3	15	0	0
23	7765955	.	G	A	2	0	2	0	0	2	0	0
23	7765961	.	C	T	1	0	1	0	0	1	0	0
23	7768416	.	T	C	2	0	2	0	5	7	0	0
23	7771305	.	T	C	2	0	2	0	0	2	0	0
23	7778670	.	G	A	7	11	18	0	0	18	0	0
23	7778715	.	A	G	5	6	11	0	1	12	0	0
23	7789553	.	T	A	8	2	10	0	0	10	0	0
23	7789556	.	T	A	8	2	10	0	0	10	0	0
23	7789635	.	G	A	5	5	10	0	1	11	0	0
23	7789802	.	C	T	1	4	5	0	2	7	0	0
23	7789930	.	C	T	0	9	9	0	6	15	0	0
23	8284779	.	C	T	2	1	3	0	0	3	0	0
23	8284791	.	C	T	2	1	3	0	0	3	0	0
23	8285094	.	G	T	7	5	12	0	2	14	0	0
23	8285236	.	G	T	10	17	27	0	2	29	0	0
23	8285297	.	C	T	0	24	24	0	11	35	0	0
23	8285365	.	G	A	15	12	27	0	1	28	0	0
23	8285468	.	T	C	4	4	8	0	1	9	0	0
23	8285585	.	A	T	11	11	22	0	0	22	0	0
23	8285640	.	C	T	10	6	16	0	2	18	0	0
23	8286192	.	T	C	5	0	5	0	8	13	0	0
23	8286237	.	G	A	6	10	16	0	0	16	0	0
23	8286342	.	C	T	0	9	9	0	3	12	0	0
23	8286384	.	G	T	3	9	12	0	2	14	0	0
23	8286483	.	G	A	5	6	11	0	1	12	0	0
23	8372159	.	T	C	3	0	3	0	0	3	0	0
23	8373535	.	T	G	6	6	12	0	0	12	0	0
23	8373641	.	A	G	3	7	10	0	0	10	0	0
23	8719074	.	T	C	6	12	18	0	0	18	0	0
23	8719491	.	G	C	2	3	5	0	3	8	0	0
23	8721202	.	G	A	1	0	1	0	0	1	0	0
23	8724467	.	G	A	4	8	12	0	0	12	0	0
23	8993280	.	G	A	5	3	8	0	1	9	0	0
23	9013456	.	C	G	4	0	4	0	7	11	0	0
23	9013597	.	T	C	6	5	11	0	0	11	0	0
23	9013843	.	G	A	4	9	13	0	1	14	0	0
23	9013876	.	T	A	7	4	11	0	1	13	1	0
23	9014122	.	G	A	0	14	14	0	8	22	0	0
23	9014259	.	G	A	10	10	20	0	0	20	0	0
23	9014844	.	T	G	0	5	5	0	0	5	0	0
23	9049360	.	G	T	1	2	3	0	0	3	0	0
23	9067121	.	G	A	0	2	2	0	1	3	0	0
23	9081490	.	T	G	1	5	6	0	1	7	0	0
23	9131416	.	A	G	1	0	1	0	1	2	0	0
23	9137400	.	A	C	1	2	3	0	0	3	0	0
23	9137410	.	A	G	2	0	2	0	3	5	0	0
23	9228562	.	T	A	1	0	1	0	0	1	0	0
23	9268466	.	T	C	3	5	8	0	3	11	0	0
23	9272674	.	C	T	3	5	8	0	0	8	0	0
23	9272984	.	T	C	5	6	11	0	0	11	0	0
23	9288200	.	G	T	5	8	13	0	1	14	0	0
23	9288294	.	T	C	3	2	5	0	0	5	0	0
23	9288395	.	C	A	1	4	5	0	1	6	0	0
23	9400848	.	G	C	3	3	6	0	1	7	0	0
23	9400902	.	G	A	2	3	5	0	0	5	0	0
23	9401107	.	C	T	2	4	6	0	0	6	0	0
23	9401210	.	T	C	4	0	4	0	7	11	0	0
23	9401344	.	G	A	2	4	6	0	1	7	0	0
23	9401439	.	T	C	6	7	13	0	0	13	0	0
23	9401470	.	C	T	2	6	8	0	1	9	0	0
23	9401918	.	A	G	2	5	7	0	0	7	0	0
23	9401954	.	G	A	1	3	4	0	0	4	0	0
23	9402734	.	A	G	4	2	6	0	0	6	0	0
23	9402971	.	T	G	1	2	3	0	0	3	0	0
23	9405633	.	C	A	0	3	3	0	2	5	0	0
23	9405713	.	G	T	1	3	4	0	0	4	0	0
23	9413456	.	C	T	1	1	2	0	0	2	0	0
23	9422205	.	C	A	2	3	5	0	0	5	0	0
23	9422427	.	G	A	1	2	3	0	1	4	0	0
23	9794959	.	T	A	13	11	24	0	2	26	0	0
23	9795057	.	A	G	14	23	37	0	1	38	0	0
23	9795097	.	C	T	2	30	32	0	16	48	0	0
23	9795663	.	A	C	11	11	22	0	0	22	0	0
23	9795908	.	C	T	16	10	26	0	4	30	0	0
23	9800761	.	T	G	4	9	13	0	1	14	0	0
23	9800872	.	T	C	0	1	1	0	0	1	0	0
23	9800993	.	G	T	4	6	10	0	2	12	0	0
23	9809863	.	A	G	11	18	29	0	2	31	0	0
23	9809977	.	C	T	0	5	5	0	9	14	0	0
23	9810491	.	C	G	6	9	15	0	1	16	0	0
23	9818153	.	C	T	3	4	7	0	0	7	0	0
23	9828802	.	T	C	7	0	7	0	5	12	0	0
23	9837018	.	G	A	2	6	8	0	0	8	0	0
23	9842935	.	G	A	1	1	2	0	0	2	0	0
23	9842980	.	C	T	1	1	2	0	0	2	0	0
23	9843221	.	T	C	1	2	3	0	0	3	0	0
23	10639037	.	A	G	6	3	9	0	0	9	0	0
23	10669371	.	A	G	1	1	2	0	0	2	0	0
23	10724336	.	A	G	6	10	16	0	0	16	0	0
23	10724695	.	A	C	4	0	4	0	4	8	0	0
23	10725012	.	T	C	8	4	12	0	1	13	0	0
23	10725013	.	G	A	8	5	13	0	0	13	0	0
23	10725491	.	T	G	11	9	20	0	0	20	0	0
23	10725753	.	A	C	3	5	8	0	0	8	0	0
23	10745058	.	G	T	7	5	12	0	0	12	0	0
23	10745139	.	T	G	5	5	10	0	0	10	0	0
23	10762922	.	G	A	9	5	14	0	2	16	0	0
23	10763070	.	G	A	8	3	11	0	0	11	0	0
23	10763301	.	T	C	8	1	9	0	1	11	1	0
23	10763303	.	T	C	9	2	11	0	0	11	0	0
23	10771991	.	C	A	0	12	12	0	17	29	0	0
23	10805275	.	A	G	1	4	5	0	0	5	0	0
23	10805322	.	A	G	0	2	2	0	0	2	0	0
23	10817176	.	C	G	4	2	6	0	0	6	0	0
23	10817292	.	T	G	2	2	4	0	0	4	0	0
23	10825541	.	T	A	3	7	10	0	0	10	0	0
23	10825569	.	A	G	3	1	4	0	6	10	0	0
23	10825591	.	C	T	3	7	10	0	3	13	0	0
23	10825996	.	G	A	3	4	7	0	0	7	0	0
23	10826120	.	C	T	3	5	8	0	1	9	0	0
23	10826194	.	C	A	2	6	8	0	3	11	0	0
23	10826618	.	T	C	12	11	23	0	0	23	0	0
23	10829164	.	A	G	1	2	3	0	0	3	0	0
23	11843358	.	C	T	0	1	1	0	0	1	0	0
23	11851459	.	C	A	1	2	3	0	0	3	0	0
23	11851467	.	C	T	1	2	3	0	0	3	0	0
23	11851545	.	T	C	5	3	8	0	0	8	0	0
23	11861321	.	T	C	1	3	4	0	0	4	0	0
23	11861367	.	C	T	1	9	10	0	0	10	0	0
23	11864948	.	T	C	17	13	30	0	2	32	0	0
23	11865055	.	T	A	16	7	23	0	2	25	0	0
23	11865274	.	A	C	9	9	18	0	1	19	0	0
23	11865510	.	T	C	11	16	27	0	0	27	0	0
23	11865545	.	A	G	9	15	24	0	2	26	0	0
23	11866086	.	G	A	12	16	28	0	2	30	0	0
23	11866259	.	T	C	19	14	33	0	2	35	0	0
23	11870063	.	T	C	0	0	0	0	4	4	0	0
23	11871807	.	G	A	10	14	24	0	0	24	0	0
23	11872533	.	A	G	0	1	1	0	0	1	0	0
23	11878173	.	A	G	4	3	7	0	1	8	0	0
23	11920705	.	G	A	3	4	7	0	0	7	0	0
23	12014796	.	C	T	4	6	10	0	2	12	0	0
23	12014872	.	T	C	7	2	9	0	11	20	0	0
23	12015075	.	A	G	1	0	1	0	2	3	0	0
23	12150658	.	G	A	5	4	9	0	0	9	0	0
23	12155166	.	G	A	5	4	9	0	0	9	0	0
23	12155298	.	G	A	10	5	15	0	1	16	0	0
23	12155364	.	A	G	9	3	12	0	0	12	0	0
23	12155638	.	A	C	1	0	1	0	0	1	0	0
23	12158399	.	G	A	7	3	10	0	0	10	0	0
23	12161851	.	T	A	2	2	4	0	1	5	0	0
23	12232873	.	G	A	9	5	14	0	1	15	0	0
23	12233117	.	G	A	14	9	23	0	0	23	0	0
23	12260903	.	T	C	1	0	1	0	0	1	0	0
23	12278655	.	A	C	1	0	1	0	0	1	0	0
23	12487331	.	C	T	2	2	4	0	0	4	0	0
23	12612350	.	A	G	1	5	6	0	1	7	0	0
23	13502684	.	T	G	1	1	2	0	1	3	0	0
23	13566948	.	T	C	1	0	1	0	0	1	0	0
23	13567257	.	G	T	0	1	1	0	0	1	0	0
23	13598632	.	T	C	7	9	16	0	1	17	0	0
23	13598679	.	C	T	5	7	12	0	0	12	0	0
23	13598766	.	A	C	10	8	18	0	0	18	0	0
23	13599079	.	G	A	0	2	2	0	3	5	0	0
23	13722335	.	T	G	4	0	4	0	7	11	0	0
23	13722416	.	C	A	8	4	12	0	2	14	0	0
23	13806444	.	T	C	11	16	27	0	3	30	0	0
23	13832393	.	A	G	4	2	6	0	0	6	0	0
23	13832412	.	T	C	4	4	8	0	0	8	0	0
23	13833376	.	T	A	2	3	5	0	0	5	0	0
23	13840362	.	C	T	0	5	5	0	9	14	0	0
23	13845114	.	A	C	2	4	6	0	0	6	0	0
23	13845149	.	T	G	5	7	12	0	1	13	0	0
23	13845201	.	A	G	7	7	14	0	0	14	0	0
23	13845247	.	G	T	1	6	7	0	0	7	0	0
23	13845411	.	G	T	3	4	7	0	1	8	0	0
23	13845447	.	T	C	11	4	15	0	0	15	0	0
23	13845493	.	T	C	11	0	11	0	2	13	0	0
23	13845502	.	T	A	9	2	11	0	0	11	0	0
23	13845544	.	C	T	5	8	13	0	0	13	0	0
23	13845558	.	C	T	0	10	10	0	4	14	0	0
23	13846121	.	T	A	2	3	5	0	0	5	0	0
23	13846631	.	C	T	4	4	8	0	0	8	0	0
23	13846664	.	T	C	1	3	4	0	0	4	0	0
23	13846917	.	T	G	4	4	8	1	0	9	0	0
23	13847142	.	G	A	1	1	2	0	1	3	0	0
23	13847220	.	T	C	4	3	7	0	0	7	0	0
23	13850343	.	A	G	7	4	11	0	1	12	0	0
23	13851386	.	A	C	3	1	4	0	0	4	0	0
23	13851392	.	A	G	3	3	6	0	0	6	0	0
23	13851458	.	T	C	0	2	2	0	0	2	0	0
23	13941275	.	C	T	5	6	11	0	1	12	0	0
23	13944394	.	A	G	2	2	4	0	0	4	0	0
23	13948990	.	A	G	2	9	11	0	1	12	0	0
23	13948993	.	G	A	3	9	12	0	1	13	0	0
23	13949074	.	T	C	6	9	15	0	0	15	0	0
23	13949089	.	T	C	4	8	12	0	0	12	0	0
23	13949110	.	C	T	0	4	4	0	12	16	0	0
23	13962739	.	A	G	0	2	2	0	0	2	0	0
23	13963821	.	A	T	2	3	5	0	0	5	0	0
23	13986276	.	G	A	0	2	2	0	1	3	0	0
23	14056595	.	A	G	2	2	4	0	1	5	0	0
23	14056679	.	G	A	5	4	9	0	0	9	0	0
23	14059063	.	G	A	0	1	1	0	0	1	0	0
23	14193640	.	T	C	4	5	9	0	2	11	0	0
23	14193649	.	G	T	5	6	11	0	2	13	0	0
23	14193777	.	C	T	11	10	21	0	0	21	0	0
23	14193851	.	A	G	13	12	25	0	0	25	0	0
23	14193991	.	T	A	7	11	18	0	1	19	0	0
23	14193996	.	C	A	5	13	18	0	1	19	0	0
23	14194101	.	T	A	10	11	21	0	1	22	0	0
23	14194125	.	A	G	11	9	20	0	1	21	0	0
23	14198137	.	G	A	2	9	11	0	0	11	0	0
23	14201512	.	T	C	8	9	17	0	0	17	0	0
23	14201521	.	T	C	8	8	16	0	0	16	0	0
23	14203829	.	T	G	11	4	15	0	2	17	0	0
23	14208718	.	A	G	3	5	8	0	0	8	0	0
23	14208817	.	A	T	6	3	9	0	0	9	0	0
23	14209024	.	T	G	4	3	7	0	0	7	0	0
23	14211707	.	C	T	10	5	15	0	0	16	1	0
23	14217769	.	G	A	0	4	4	0	3	7	0	0
23	14217799	.	G	A	2	3	5	0	0	5	0	0
23	14218018	.	A	G	1	2	3	0	0	3	0	0
23	14218065	.	C	T	0	1	1	0	0	1	0	0
23	14230459	.	G	T	1	2	3	0	0	3	0	0
23	14265182	.	C	T	7	1	8	0	0	8	0	0
23	14265220	.	A	T	9	3	12	0	0	12	0	0
23	14320390	.	T	C	3	2	5	0	0	5	0	0
23	14541342	.	T	C	0	0	0	0	1	1	0	0
23	14743497	.	A	G	2	2	4	0	0	4	0	0
23	14743562	.	T	C	0	1	1	0	0	1	0	0
23	14769407	.	G	A	1	2	3	0	0	3	0	0
23	14772079	.	G	A	1	4	5	0	0	5	0	0
23	14777039	.	A	C	1	5	6	0	0	6	0	0
23	14782566	.	A	G	2	2	4	0	0	4	0	0
23	14782599	.	C	T	1	2	3	0	0	3	0	0
23	14784123	.	T	C	2	0	2	0	0	2	0	0
23	14784237	.	A	C	1	2	3	0	0	3	0	0
23	14786347	.	T	C	3	2	5	0	0	5	0	0
23	14786429	.	A	T	1	3	4	0	0	4	0	0
23	14787336	.	A	G	3	0	3	0	0	3	0	0
23	14787426	.	G	A	2	1	3	0	0	3	0	0
23	14790827	.	G	A	1	2	3	0	0	3	0	0
23	14790881	.	A	T	1	0	1	0	0	1	0	0
23	14799653	.	T	C	1	4	5	0	0	5	0	0
23	14808399	.	G	A	1	2	3	0	0	3	0	0
23	14808537	.	G	T	3	3	6	0	0	6	0	0
23	14809613	.	C	A	2	3	5	0	1	6	0	0
23	14832585	.	T	G	5	9	14	0	0	14	0	0
23	14832733	.	G	A	16	27	43	0	3	46	0	0
23	14832740	.	A	C	18	29	47	0	3	50	0	0
23	14832866	.	C	T	26	25	51	0	3	54	0	0
23	14832941	.	C	A	4	27	31	0	27	58	0	0
23	14833142	.	A	T	19	31	50	0	0	50	0	0
23	14833143	.	A	T	18	27	45	0	5	50	0	0
23	14833389	.	A	C	29	12	41	0	3	44	0	0
23	14990819	.	G	T	9	8	17	0	1	18	0	0
23	14993089	.	G	A	12	14	26	0	0	26	0	0
23	14993302	.	A	C	14	13	27	0	0	27	0	0
23	14993393	.	C	A	8	14	22	0	2	24	0	0
23	14993421	.	G	A	9	12	21	0	1	22	0	0
23	14993438	.	A	G	9	10	19	0	1	20	0	0
23	14993493	.	A	T	9	9	18	0	1	19	0	0
23	14993525	.	A	T	9	15	24	0	0	24	0	0
23	14993563	.	C	G	11	18	29	0	0	29	0	0
23	14997341	.	A	G	9	5	14	0	0	14	0	0
23	14999053	.	C	T	15	10	25	0	0	25	0	0
23	14999095	.	C	T	0	11	11	0	13	24	0	0
23	15003551	.	T	C	4	0	4	0	4	8	0	0
23	15022206	.	T	C	7	0	7	0	10	17	0	0
23	15022511	.	C	T	1	2	3	0	0	3	0	0
23	15022526	.	C	T	1	2	3	0	0	3	0	0
23	15025084	.	G	C	2	0	2	0	4	6	0	0
23	15036698	.	G	A	0	3	3	0	1	4	0	0
23	15046644	.	T	C	1	0	1	0	2	3	0	0
23	15047157	.	C	T	1	2	3	0	1	4	0	0
23	15047446	.	T	C	1	0	1	0	3	4	0	0
23	15047468	.	A	G	1	3	4	0	0	4	0	0
23	15047674	.	A	G	0	5	5	0	1	6	0	0
23	15047745	.	C	T	0	3	3	0	1	4	0	0
23	15076070	.	T	C	1	2	3	0	0	3	0	0
23	15087187	.	G	C	1	2	3	0	0	3	0	0
23	15204028	.	C	T	21	6	27	0	1	28	0	0
23	15204038	.	T	G	19	3	22	0	1	23	0	0
23	15204222	.	C	T	1	18	19	0	16	35	0	0
23	15204321	.	T	A	11	10	21	0	1	22	0	0
23	15204324	.	T	A	13	8	21	0	2	23	0	0
23	15204417	.	A	G	18	16	34	0	1	35	0	0
23	15204926	.	C	A	13	11	24	0	0	24	0	0
23	15204936	.	G	T	10	9	19	0	2	21	0	0
23	15205100	.	T	G	20	16	36	0	0	36	0	0
23	15205428	.	A	T	12	14	26	0	2	28	0	0
23	15205487	.	C	G	21	15	36	0	0	36	0	0
23	15211253	.	G	C	7	20	27	0	0	27	0	0
23	15215709	.	G	A	14	10	24	0	1	25	0	0
23	15216664	.	G	T	6	3	9	0	0	9	0	0
23	15222509	.	G	A	4	2	6	0	0	6	0	0
23	15222521	.	C	T	3	6	9	0	2	11	0	0
23	15259821	.	G	A	4	3	7	0	0	7	0	0
23	15284602	.	G	T	1	2	3	0	2	5	0	0
23	15284668	.	A	G	4	2	6	0	0	6	0	0
23	15284671	.	G	A	4	3	7	0	0	7	0	0
23	15851064	.	A	G	13	6	19	0	0	19	0	0
23	15851506	.	C	G	9	16	25	0	1	26	0	0
23	15854004	.	T	C	12	13	25	0	1	26	0	0
23	15854102	.	A	C	7	7	14	0	0	14	0	0
23	15861092	.	C	T	0	8	8	0	9	17	0	0
23	15861536	.	T	C	3	0	3	0	1	4	0	0
23	15872605	.	T	A	2	0	2	0	0	2	0	0
23	15900255	.	C	T	7	7	14	0	1	15	0	0
23	15900330	.	G	A	17	9	26	0	0	26	0	0
23	15900387	.	G	A	16	15	31	0	2	33	0	0
23	15916232	.	A	T	13	10	23	0	2	25	0	0
23	16640925	.	A	G	6	11	17	0	9	26	0	0
23	16641017	.	A	G	11	6	17	0	0	17	0	0
23	16649012	.	C	T	6	9	15	0	4	19	0	0
23	16649021	.	C	G	9	0	9	0	1	15	5	0
23	16660094	.	G	T	0	3	3	0	0	3	0	0
23	16696509	.	A	G	1	2	3	0	0	3	0	0
23	16753735	.	T	C	2	2	4	0	0	4	0	0
23	16757414	.	T	G	0	0	0	0	1	1	0	0
23	16762022	.	A	T	1	6	7	0	0	7	0	0
23	16769385	.	T	A	1	4	5	0	0	5	0	0
23	16769700	.	A	G	2	7	9	0	0	9	0	0
23	16769949	.	T	C	0	4	4	0	0	4	0	0
23	16769991	.	T	G	2	0	2	0	8	10	0	0
23	16770008	.	G	A	0	6	6	0	2	8	0	0
23	16770091	.	A	G	3	0	3	2	6	11	0	0
23	16770121	.	G	A	0	3	3	1	3	7	0	0
23	16770340	.	G	C	0	3	3	0	0	3	0	0
23	16810343	.	A	G	0	1	1	0	0	1	0	0
23	16817055	.	T	C	0	4	4	2	0	6	0	0
23	16821940	.	T	C	3	7	10	0	1	11	0	0
23	16831207	.	A	T	2	2	4	0	0	4	0	0
23	16831386	.	G	A	1	2	3	0	0	3	0	0
23	16831507	.	A	T	0	1	1	0	1	2	0	0
23	16831822	.	G	A	0	4	4	0	4	8	0	0
23	16898149	.	A	G	1	1	2	0	0	2	0	0
23	16910381	.	G	A	1	0	1	0	0	1	0	0
23	16961626	.	T	C	3	2	5	0	0	5	0	0
23	16964518	.	T	G	0	1	1	0	0	1	0	0
23	17113842	.	A	G	2	0	2	0	0	2	0	0
23	17113923	.	T	C	2	4	6	0	1	7	0	0
23	17113938	.	A	G	0	2	2	0	3	5	0	0
23	17221056	.	G	A	1	1	2	0	0	2	0	0
23	17340346	.	G	A	1	6	7	0	8	15	0	0
23	17342788	.	T	C	1	1	2	0	0	2	0	0
23	17355498	.	G	T	4	4	8	0	0	8	0	0
23	17782647	.	G	T	0	3	3	0	2	5	0	0
23	17782767	.	G	A	3	3	6	0	0	6	0	0
23	17812711	.	C	T	33	17	50	0	1	51	0	0
23	17812720	.	T	A	19	31	50	0	1	51	0	0
23	17812755	.	G	T	18	24	42	0	2	44	0	0
23	17813057	.	G	A	22	13	35	0	0	35	0	0
23	17813161	.	T	A	12	18	30	0	4	34	0	0
23	17813717	.	G	A	26	22	48	0	1	49	0	0
23	17813952	.	G	T	10	8	18	0	0	18	0	0
23	17814056	.	G	A	22	18	40	0	1	41	0	0
23	17814223	.	C	T	17	24	41	0	9	50	0	0
23	17814281	.	G	T	24	20	44	0	4	48	0	0
23	17814299	.	A	C	21	20	41	0	1	42	0	0
23	17814408	.	A	C	19	17	36	0	1	37	0	0
23	17849275	.	T	G	7	9	16	0	1	17	0	0
23	17849296	.	C	G	0	11	11	0	12	23	0	0
23	17849627	.	C	T	9	10	19	0	0	19	0	0
23	17849699	.	C	G	1	2	3	0	0	3	0	0
23	17851768	.	C	T	1	8	9	0	6	15	0	0
23	17853145	.	T	G	3	2	5	0	1	6	0	0
23	17853396	.	A	T	1	2	3	0	0	3	0	0
23	17855427	.	C	A	4	5	9	0	0	9	0	0
23	17857831	.	G	A	3	1	4	0	0	4	0	0
23	17865973	.	T	C	0	0	0	0	1	1	0	0
23	17872172	.	G	T	2	2	4	0	0	4	0	0
23	17872320	.	C	A	2	3	5	0	0	5	0	0
23	17874632	.	T	A	0	2	2	0	0	2	0	0
23	17879107	.	C	T	1	3	4	0	1	5	0	0
23	17880800	.	C	T	4	5	9	0	0	9	0	0
23	17903519	.	G	A	0	0	0	0	1	1	0	0
23	17994101	.	T	A	3	5	8	0	0	8	0	0
23	17994148	.	A	T	4	3	7	0	1	8	0	0
23	17994274	.	C	G	6	5	11	0	0	11	0	0
23	17994354	.	T	C	1	12	13	0	0	13	0	0
23	17994615	.	T	C	5	3	8	0	1	9	0	0
23	17995521	.	C	A	0	5	5	0	0	5	0	0
23	17995542	.	A	T	0	5	5	0	0	5	0	0
23	17997033	.	A	G	0	0	0	0	1	1	0	0
23	17997043	.	T	C	1	0	1	0	0	1	0	0
23	18004297	.	A	G	3	3	6	0	0	6	0	0
23	18032772	.	G	A	3	7	10	0	0	10	0	0
23	18032912	.	A	C	1	2	3	0	0	3	0	0
23	18118653	.	A	T	6	4	10	0	0	10	0	0
23	18118922	.	G	A	21	19	40	0	3	43	0	0
23	18119166	.	C	T	24	15	39	0	2	41	0	0
23	18119192	.	T	C	17	1	18	0	17	35	0	0
23	18119399	.	A	G	11	23	34	0	1	35	0	0
23	18286781	.	G	A	5	7	12	0	1	13	0	0
23	18286782	.	C	T	5	8	13	0	0	13	0	0
23	18375847	.	G	A	0	1	1	0	1	2	0	0
23	18375853	.	T	C	6	0	6	0	0	6	0	0
23	18387709	.	T	A	24	21	45	0	5	50	0	0
23	18388004	.	G	A	11	17	28	0	2	30	0	0
23	18388166	.	T	A	6	16	22	0	0	22	0	0
23	18388476	.	G	A	13	7	20	0	0	20	0	0
23	18388555	.	A	G	13	7	20	0	0	20	0	0
23	18388620	.	A	C	7	9	16	0	0	16	0	0
23	18388764	.	G	A	7	9	16	0	1	17	0	0
23	18388954	.	G	A	4	8	12	0	0	12	0	0
23	18389594	.	G	T	14	9	23	0	1	24	0	0
23	18390402	.	G	A	9	10	19	0	3	22	0	0
23	18390635	.	G	A	6	10	16	0	1	17	0	0
23	18390758	.	T	C	11	0	11	0	8	19	0	0
23	18390780	.	C	T	8	8	16	0	1	17	0	0
23	18391490	.	G	A	3	3	6	0	0	6	0	0
23	18394401	.	T	G	8	10	18	0	1	19	0	0
23	18405812	.	C	T	3	6	9	0	0	9	0	0
23	18406479	.	G	A	2	7	9	0	0	9	0	0
23	18406573	.	C	A	3	6	9	0	2	11	0	0
23	18409242	.	C	T	4	6	10	0	2	12	0	0
23	18415329	.	G	C	7	3	10	0	1	11	0	0
23	18415427	.	T	A	2	3	5	0	0	5	0	0
23	18415493	.	C	A	0	2	2	0	2	4	0	0
23	18561051	.	T	C	7	4	11	0	1	12	0	0
23	18561289	.	T	A	14	18	32	0	1	33	0	0
23	18561434	.	C	T	0	13	13	0	17	30	0	0
23	18562299	.	A	T	2	3	5	0	0	5	0	0
23	18562358	.	T	G	4	4	8	0	0	8	0	0
23	18562427	.	C	T	6	4	10	0	0	10	0	0
23	18562484	.	G	A	6	7	13	0	0	13	0	0
23	18562623	.	C	T	14	6	20	0	1	21	0	0
23	18562911	.	C	A	1	17	18	0	13	31	0	0
23	18563951	.	G	T	13	9	22	0	0	22	0	0
23	18563952	.	T	C	13	0	13	0	9	22	0	0
23	18568144	.	G	A	2	3	5	0	0	5	0	0
23	18568206	.	G	A	3	9	12	0	0	12	0	0
23	18569380	.	T	A	5	6	11	0	1	12	0	0
23	18569399	.	C	A	0	6	6	0	6	12	0	0
23	18569455	.	T	G	7	5	12	0	2	14	0	0
23	18569462	.	T	A	7	7	14	0	0	14	0	0
23	18569543	.	T	C	13	13	26	0	1	27	0	0
23	18569625	.	A	G	11	21	32	0	1	33	0	0
23	18572547	.	T	A	2	12	14	0	0	14	0	0
23	18572605	.	T	A	3	12	15	0	0	15	0	0
23	18574353	.	G	A	19	8	27	0	1	28	0	0
23	18574720	.	T	C	17	15	32	0	1	33	0	0
23	18574800	.	C	T	1	12	13	0	15	28	0	0
23	18580933	.	C	A	0	4	4	0	0	4	0	0
23	18580939	.	C	A	0	0	0	0	7	7	0	0
23	18581065	.	A	G	2	1	3	0	1	4	0	0
23	18581835	.	G	A	3	6	9	0	0	9	0	0
23	18581933	.	T	G	6	12	18	0	0	18	0	0
23	18584225	.	G	A	11	8	19	0	1	20	0	0
23	18588969	.	C	T	9	9	18	0	0	18	0	0
23	18597667	.	G	A	8	9	17	0	3	20	0	0
23	18616517	.	A	T	8	2	10	0	0	10	0	0
23	18616661	.	T	C	17	5	22	0	2	24	0	0
23	18616880	.	T	A	9	8	17	0	3	20	0	0
23	18616980	.	C	G	5	6	11	0	1	12	0	0
23	18617300	.	G	A	7	15	22	0	0	22	0	0
23	18619766	.	C	T	1	2	3	0	2	5	0	0
23	18622541	.	T	G	9	7	16	0	1	17	0	0
23	18628746	.	C	T	10	6	16	0	1	17	0	0
23	18629024	.	T	C	2	1	3	0	1	4	0	0
23	18651789	.	G	A	2	3	5	0	0	5	0	0
23	18651918	.	C	A	5	2	7	0	1	8	0	0
23	18652067	.	T	C	2	4	6	0	0	6	0	0
23	18668440	.	T	C	1	4	5	0	0	5	0	0
23	18703204	.	T	A	1	2	3	0	0	3	0	0
23	18759802	.	C	A	7	7	14	0	0	14	0	0
23	18759827	.	T	C	5	6	11	0	0	11	0	0
23	18760004	.	G	C	5	1	6	0	4	10	0	0
23	18760049	.	T	A	7	6	13	0	1	14	0	0
23	18760199	.	A	T	1	6	7	0	0	7	0	0
23	18760223	.	T	A	2	4	6	0	0	6	0	0
23	18760256	.	C	T	2	5	7	0	0	7	0	0
23	18760519	.	T	A	0	5	5	0	0	5	0	0
23	18769161	.	T	C	0	0	0	0	3	3	0	0
23	18770469	.	C	T	1	0	1	0	0	1	0	0
23	18774122	.	T	C	4	2	6	0	0	6	0	0
23	18795055	.	T	C	4	6	10	0	0	10	0	0
23	18795620	.	A	G	15	14	29	0	1	30	0	0
23	18795721	.	C	T	12	2	14	0	0	14	0	0
23	18801275	.	G	A	7	9	16	0	1	17	0	0
23	18869550	.	C	A	0	4	4	0	3	7	0	0
23	18870235	.	A	T	6	3	9	0	0	9	0	0
23	18870245	.	T	C	3	0	3	0	7	10	0	0
23	18870716	.	G	T	3	3	6	0	0	6	0	0
23	18944489	.	A	G	5	6	11	0	0	11	0	0
23	18944543	.	G	A	0	6	6	0	5	11	0	0
23	18947344	.	C	A	11	11	22	0	1	23	0	0
23	18947385	.	G	C	16	7	23	0	1	25	1	0
23	18950968	.	T	C	11	14	25	0	0	25	0	0
23	18950970	.	T	A	10	14	24	0	1	25	0	0
23	18951010	.	G	A	7	8	15	0	2	17	0	0
23	18954023	.	A	G	5	3	8	0	0	8	0	0
23	18954100	.	A	G	6	5	11	0	1	12	0	0
23	18954151	.	G	A	5	7	12	0	2	14	0	0
23	18954759	.	T	G	11	21	32	0	0	32	0	0
23	18979342	.	C	T	14	14	28	0	1	29	0	0
23	18979561	.	G	A	14	23	37	0	0	37	0	0
23	18979756	.	T	C	7	7	14	0	4	18	0	0
23	18982375	.	G	A	8	5	13	0	0	13	0	0
23	18986338	.	G	A	10	12	22	0	1	23	0	0
23	18986344	.	G	A	12	9	21	0	0	21	0	0
23	18990914	.	C	T	0	12	12	0	4	16	0	0
23	18993525	.	T	C	8	12	20	0	0	20	0	0
23	18993827	.	C	T	0	4	4	0	2	6	0	0
23	18996030	.	C	T	1	2	3	0	0	3	0	0
23	19003263	.	A	G	3	3	6	0	0	6	0	0
23	19005426	.	G	T	0	1	1	0	0	1	0	0
23	19005486	.	T	C	4	4	8	0	0	8	0	0
23	19005758	.	C	T	0	1	1	0	0	1	0	0
23	19007389	.	G	T	3	3	6	0	0	6	0	0
23	19008149	.	C	T	4	2	6	0	0	6	0	0
23	19012845	.	C	G	2	1	3	0	0	3	0	0
23	19017421	.	C	A	1	1	2	0	0	2	0	0
23	19017466	.	G	T	1	2	3	0	0	3	0	0
23	19022254	.	A	G	1	0	1	0	0	1	0	0
23	19022534	.	G	A	2	3	5	0	1	6	0	0
23	19027408	.	G	A	2	1	3	0	2	5	0	0
23	19027510	.	A	C	1	0	1	0	1	2	0	0
23	19036052	.	C	G	2	5	7	0	0	7	0	0
23	19051645	.	C	T	2	3	5	0	0	5	0	0
23	19051737	.	C	T	1	1	2	0	1	3	0	0
23	19051739	.	G	A	1	2	3	0	0	3	0	0
23	19067116	.	G	A	1	2	3	0	1	4	0	0
23	19098900	.	G	A	0	0	0	0	1	1	0	0
23	19118372	.	G	T	0	2	2	0	1	3	0	0
23	19198348	.	A	T	0	5	5	0	1	6	0	0
23	19198588	.	A	T	2	6	8	0	0	8	0	0
23	19200168	.	G	A	7	7	14	0	0	14	0	0
23	19201103	.	C	A	7	15	22	0	0	22	0	0
23	19201148	.	G	T	8	3	11	0	0	11	0	0
23	19203952	.	C	T	4	5	9	0	0	9	0	0
23	19204738	.	C	T	2	3	5	0	0	5	0	0
23	19206388	.	G	T	1	2	3	0	0	3	0	0
23	19222218	.	C	A	1	2	3	0	0	3	0	0
23	19222257	.	G	A	0	3	3	0	0	3	0	0
23	19222299	.	G	T	1	3	4	0	0	4	0	0
23	19250029	.	T	A	1	2	3	0	0	3	0	0
23	19474823	.	G	T	11	14	25	0	0	25	0	0
23	19480784	.	T	C	0	1	1	0	0	1	0	0
23	19483010	.	C	T	0	3	3	0	0	3	0	0
23	19483260	.	A	G	2	4	6	0	0	6	0	0
23	19484584	.	C	T	0	1	1	0	2	3	0	0
23	19575044	.	G	A	0	9	9	0	9	18	0	0
23	19575134	.	C	T	9	12	21	0	0	21	0	0
23	19577464	.	G	A	1	15	16	0	20	36	0	0
23	19582481	.	T	C	14	14	28	0	1	29	0	0
23	19582559	.	G	T	11	11	22	0	0	22	0	0
23	19582668	.	T	C	10	13	23	0	1	24	0	0
23	19582678	.	C	T	12	12	24	0	1	25	0	0
23	19583208	.	G	A	0	10	10	0	10	20	0	0
23	19583252	.	C	T	14	6	20	0	0	20	0	0
23	19603630	.	T	C	12	8	20	0	0	20	0	0
23	19603753	.	T	C	28	22	50	0	3	53	0	0
23	19603803	.	T	C	25	18	43	0	0	43	0	0
23	19603880	.	A	T	15	22	37	0	2	39	0	0
23	19603994	.	G	A	18	27	45	0	2	47	0	0
23	19604263	.	A	G	17	0	17	0	11	28	0	0
23	19604351	.	G	T	13	7	20	0	2	22	0	0
23	19670139	.	G	C	8	3	11	0	0	11	0	0
23	19670185	.	A	T	6	5	11	0	2	13	0	0
23	19672720	.	T	C	3	5	8	0	0	8	0	0
23	19673170	.	C	T	13	13	26	0	5	31	0	0
23	19673376	.	C	T	4	9	13	0	0	13	0	0
23	19712898	.	G	A	22	20	42	0	2	44	0	0
23	19713291	.	A	G	20	13	33	0	0	33	0	0
23	19713324	.	A	G	29	27	56	0	5	61	0	0
23	19798174	.	A	G	0	1	1	0	0	1	0	0
23	19800228	.	T	C	0	1	1	0	0	1	0	0
23	19805577	.	A	T	0	4	4	0	0	4	0	0
23	19808022	.	C	T	6	6	12	0	0	12	0	0
23	19808078	.	T	C	3	4	7	0	0	7	0	0
23	19808691	.	G	A	0	11	11	0	8	19	0	0
23	19808895	.	A	G	2	0	2	0	6	8	0	0
23	19815467	.	G	A	0	1	1	0	0	1	0	0
23	19821136	.	A	G	7	0	7	0	6	13	0	0
23	19821150	.	C	T	8	10	18	0	0	18	0	0
23	19821277	.	A	C	6	9	15	0	0	15	0	0
23	19821408	.	C	T	4	9	13	0	0	13	0	0
23	19821447	.	G	C	3	4	7	0	0	7	0	0
23	19821470	.	G	A	0	3	3	0	2	5	0	0
23	19821489	.	A	T	3	2	5	0	2	7	0	0
23	19821549	.	C	A	0	4	4	0	0	4	0	0
23	19825629	.	C	T	0	5	5	0	4	9	0	0
23	19825653	.	G	C	4	4	8	0	0	8	0	0
23	19835308	.	T	C	33	20	53	0	0	54	1	0
23	19836260	.	C	T	25	24	49	0	2	51	0	0
23	19837080	.	T	C	35	17	52	0	3	55	0	0
23	19837503	.	G	A	26	15	41	0	3	44	0	0
23	19837939	.	A	G	9	17	26	0	0	26	0	0
23	19837974	.	G	A	12	13	25	0	2	27	0	0
23	19838100	.	C	A	22	23	45	0	3	48	0	0
23	19838295	.	T	G	9	6	15	0	1	16	0	0
23	19838312	.	A	T	11	4	15	0	1	16	0	0
23	19838387	.	A	T	7	13	20	0	1	21	0	0
23	19838388	.	T	A	6	13	19	0	2	21	0	0
23	19838458	.	A	T	13	15	28	0	0	28	0	0
23	19838459	.	A	C	12	14	26	0	2	28	0	0
23	19869132	.	G	A	13	13	26	0	0	26	0	0
23	19871615	.	A	G	28	19	47	0	1	48	0	0
23	19879576	.	C	T	0	2	2	0	5	7	0	0
23	19883318	.	T	C	1	2	3	0	0	3	0	0
23	19893409	.	A	T	12	9	21	0	1	22	0	0
23	19933742	.	G	A	11	8	19	0	1	20	0	0
23	19933850	.	A	G	8	9	17	0	0	17	0	0
23	19933896	.	A	G	11	6	17	0	0	18	1	0
23	19933952	.	A	G	14	7	21	0	3	24	0	0
23	19952743	.	C	T	1	15	16	0	16	32	0	0
23	19952869	.	T	A	14	9	23	0	1	25	1	0
23	19969710	.	G	A	2	3	5	0	2	7	0	0
23	19974092	.	G	A	5	2	7	0	0	7	0	0
23	19980707	.	A	T	0	1	1	0	0	1	0	0
23	19980896	.	A	C	2	2	4	0	0	4	0	0
23	19981510	.	G	T	4	4	8	0	0	8	0	0
23	19981554	.	T	C	3	6	9	0	0	9	0	0
23	19981608	.	A	T	7	5	12	0	0	12	0	0
23	19985054	.	A	G	5	5	10	0	1	11	0	0
23	19985201	.	A	G	2	4	6	0	0	6	0	0
23	19985210	.	G	T	1	4	5	0	0	5	0	0
23	19985307	.	G	T	2	4	6	0	0	6	0	0
23	19985403	.	T	C	4	2	6	0	0	6	0	0
23	20000716	.	A	G	3	5	8	0	2	10	0	0
23	20002339	.	G	C	5	3	8	0	0	8	0	0
23	20002373	.	T	A	1	4	5	0	0	5	0	0
23	20002439	.	G	C	2	0	2	0	2	4	0	0
23	20002524	.	A	G	3	2	5	0	1	6	0	0
23	20014285	.	A	T	2	2	4	0	0	4	0	0
23	20113599	.	T	C	17	6	23	0	0	23	0	0
23	20113848	.	G	T	18	17	35	0	2	37	0	0
23	20114327	.	C	A	6	8	14	0	1	15	0	0
23	20117625	.	C	G	0	10	10	0	13	23	0	0
23	20117830	.	A	G	2	1	3	0	0	3	0	0
23	20117938	.	A	C	4	0	4	0	14	18	0	0
23	20118597	.	T	G	5	2	7	0	0	7	0	0
23	20118730	.	T	A	2	6	8	0	0	8	0	0
23	20120646	.	T	C	8	1	9	0	5	14	0	0
23	20121265	.	T	A	1	2	3	0	0	3	0	0
23	20121270	.	G	T	2	3	5	0	0	5	0	0
23	20121326	.	G	A	17	9	26	0	1	27	0	0
23	20122190	.	A	G	4	3	7	0	0	7	0	0
23	20123375	.	G	A	4	5	9	0	0	9	0	0
23	20123386	.	G	T	3	5	8	0	1	9	0	0
23	20123629	.	A	G	8	1	9	0	0	9	0	0
23	20139320	.	T	C	1	1	2	0	0	2	0	0
23	20142968	.	C	A	0	2	2	0	1	3	0	0
23	20143177	.	G	A	1	2	3	0	0	3	0	0
23	20145420	.	T	A	16	8	24	0	0	24	0	0
23	20145823	.	T	C	5	13	18	0	1	19	0	0
23	20146080	.	A	G	9	16	25	0	0	25	0	0
23	20152477	.	T	C	1	4	5	0	0	5	0	0
23	20152640	.	G	A	3	5	8	0	0	8	0	0
23	20154486	.	A	G	0	10	10	0	0	10	0	0
23	20157790	.	G	A	4	7	11	0	0	11	0	0
23	20157923	.	G	C	5	0	5	0	4	9	0	0
23	20157930	.	T	C	5	0	5	0	5	10	0	0
23	20159225	.	C	T	0	3	3	0	2	5	0	0
23	20159234	.	G	T	0	4	4	0	0	4	0	0
23	20167944	.	T	C	6	4	10	0	0	10	0	0
23	20167966	.	G	A	8	3	11	0	1	12	0	0
23	20168111	.	T	A	3	6	9	0	0	9	0	0
23	20168127	.	C	T	0	6	6	0	2	8	0	0
23	20168404	.	C	G	4	5	9	0	0	9	0	0
23	20168568	.	T	C	3	3	6	0	1	7	0	0
23	20168573	.	A	G	3	4	7	0	1	8	0	0
23	20168642	.	G	A	3	4	7	0	0	7	0	0
23	20168739	.	T	C	1	2	3	0	0	3	0	0
23	20169105	.	C	G	0	2	2	0	2	4	0	0
23	20170945	.	T	A	0	1	1	0	0	1	0	0
23	20183551	.	A	G	2	0	2	0	0	2	0	0
23	20902390	.	T	A	5	7	12	0	1	13	0	0
23	20931095	.	C	A	16	7	23	0	0	23	0	0
23	20931119	.	C	T	14	9	23	0	1	24	0	0
23	20936226	.	G	A	0	4	4	0	8	12	0	0
23	20936395	.	T	A	6	10	16	0	1	18	1	0
23	20936467	.	T	C	8	3	11	0	1	12	0	0
23	21067579	.	G	A	0	2	2	0	0	2	0	0
23	21067580	.	C	G	0	2	2	0	0	2	0	0
23	21089840	.	C	A	1	1	2	0	0	2	0	0
23	21113750	.	T	C	1	0	1	0	0	1	0	0
23	21113770	.	C	T	1	0	1	0	0	1	0	0
23	21114732	.	A	C	5	4	9	0	0	9	0	0
23	21264226	.	A	G	2	1	3	0	0	3	0	0
23	21265351	.	T	C	1	1	2	0	0	2	0	0
23	21265446	.	C	T	5	3	8	0	0	8	0	0
23	21267105	.	G	C	0	1	1	0	0	1	0	0
23	21267124	.	G	T	0	0	0	0	1	1	0	0
23	21268808	.	T	C	2	4	6	0	0	6	0	0
23	21269620	.	A	G	0	4	4	0	0	4	0	0
23	21269626	.	T	G	0	1	1	0	0	1	0	0
23	21269792	.	T	G	3	3	6	0	0	6	0	0
23	21276362	.	T	C	5	7	12	0	0	12	0	0
23	21277208	.	G	A	2	4	6	0	0	6	0	0
23	21277247	.	T	A	7	3	10	0	0	10	0	0
23	21295506	.	T	C	1	2	3	0	0	3	0	0
23	21313858	.	G	T	1	2	3	0	0	3	0	0
23	21315209	.	A	T	0	1	1	0	0	1	0	0
23	21325956	.	C	A	1	2	3	0	1	4	0	0
23	21330786	.	T	C	5	1	6	0	0	6	0	0
23	21330864	.	T	C	4	3	7	0	0	7	0	0
23	21338789	.	A	G	1	3	4	0	0	4	0	0
23	21338888	.	C	T	1	2	3	0	0	3	0	0
23	21339130	.	G	C	0	2	2	0	1	3	0	0
23	21339136	.	C	T	0	2	2	0	0	2	0	0
23	21341304	.	G	A	2	2	4	0	0	4	0	0
23	21343903	.	T	C	0	1	1	0	0	1	0	0
23	21350008	.	T	C	0	2	2	0	0	2	0	0
23	21353604	.	C	A	2	5	7	0	0	7	0	0
23	21353625	.	G	A	0	2	2	0	0	2	0	0
23	21353643	.	A	T	0	1	1	0	0	1	0	0
23	21353837	.	C	T	4	2	6	0	0	6	0	0
23	21356056	.	C	T	5	3	8	0	0	8	0	0
23	21361570	.	G	A	2	3	5	0	0	5	0	0
23	21362178	.	G	A	0	2	2	0	4	6	0	0
23	21362735	.	G	A	2	2	4	0	1	5	0	0
23	21362822	.	C	T	2	3	5	0	0	5	0	0
23	21363039	.	C	A	5	4	9	0	0	9	0	0
23	21364431	.	G	A	5	1	6	0	1	7	0	0
23	21364449	.	G	A	0	5	5	0	7	12	0	0
23	21364632	.	T	C	1	2	3	0	0	3	0	0
23	21364725	.	C	T	2	1	3	0	0	3	0	0
23	21366588	.	C	T	1	0	1	0	0	1	0	0
23	21366743	.	A	C	5	1	6	0	0	6	0	0
23	21366764	.	C	T	2	0	2	0	0	2	0	0
23	21367861	.	A	G	2	4	6	0	1	7	0	0
23	21367994	.	A	T	1	2	3	0	0	3	0	0
23	21368078	.	C	T	14	15	29	0	0	29	0	0
23	21368090	.	G	A	10	16	26	0	1	27	0	0
23	21368156	.	A	G	7	6	13	0	0	13	0	0
23	21368183	.	G	A	2	1	3	0	0	3	0	0
23	21369126	.	G	C	0	4	4	0	4	8	0	0
23	21369678	.	T	C	10	24	34	0	1	35	0	0
23	21369703	.	C	A	10	14	24	0	2	26	0	0
23	21369750	.	C	T	2	3	5	0	0	5	0	0
23	21376413	.	T	A	21	12	33	0	0	34	1	0
23	21376570	.	C	T	21	17	38	0	0	38	0	0
23	21376617	.	A	G	17	2	19	0	9	28	0	0
23	21376678	.	G	T	14	6	20	0	1	21	0	0
23	21376689	.	C	T	13	7	20	0	0	20	0	0
23	21376787	.	C	G	11	12	23	0	1	24	0	0
23	21380288	.	C	T	1	2	3	0	0	3	0	0
23	21380370	.	C	A	1	3	4	0	0	4	0	0
23	21452700	.	C	T	1	3	4	0	1	5	0	0
23	21483803	.	G	A	5	2	7	0	0	7	0	0
23	21484652	.	G	C	1	1	2	0	0	2	0	0
23	21488054	.	T	C	4	4	8	0	0	8	0	0
23	21488208	.	A	G	2	3	5	0	0	5	0	0
23	21488221	.	A	T	2	2	4	0	0	4	0	0
23	21488872	.	G	A	8	3	11	0	3	14	0	0
23	21489121	.	C	T	13	4	17	0	0	17	0	0
23	21489233	.	T	C	5	4	9	0	1	10	0	0
23	21489567	.	T	C	5	9	14	0	0	14	0	0
23	21490211	.	G	A	0	2	2	0	5	7	0	0
23	21492284	.	A	G	5	3	8	0	0	8	0	0
23	21492756	.	A	T	1	1	2	0	0	2	0	0
23	21492777	.	C	T	1	2	3	0	0	3	0	0
23	21497808	.	C	T	5	4	9	0	0	9	0	0
23	21498165	.	T	C	1	2	3	0	2	5	0	0
23	21498291	.	T	C	1	4	5	0	0	5	0	0
23	21498326	.	C	T	5	3	8	0	0	8	0	0
23	21498449	.	T	C	4	3	7	0	1	8	0	0
23	21498478	.	T	C	4	4	8	0	0	8	0	0
23	21526618	.	A	G	3	0	3	0	1	4	0	0
23	21569490	.	G	A	1	4	5	0	0	5	0	0
23	21575986	.	C	T	5	2	7	0	0	7	0	0
23	21626211	.	C	T	6	3	9	0	0	9	0	0
23	21630363	.	T	G	4	8	12	0	1	13	0	0
23	21630393	.	G	A	5	6	11	0	0	11	0	0
23	21630676	.	G	A	7	15	22	0	1	23	0	0
23	21630973	.	C	T	8	6	14	0	0	14	0	0
23	21638300	.	C	T	5	5	10	0	0	10	0	0
23	21647187	.	C	T	3	2	5	0	0	5	0	0
23	21647196	.	G	A	0	3	3	0	2	5	0	0
23	21661227	.	C	T	7	7	14	0	1	15	0	0
23	21661483	.	G	A	0	7	7	0	7	14	0	0
23	21721568	.	T	C	3	4	7	0	1	8	0	0
23	21721667	.	C	T	1	0	1	0	1	2	0	0
23	21721868	.	G	A	2	8	10	0	0	10	0	0
23	21734738	.	A	G	3	3	6	0	1	7	0	0
23	21735090	.	C	T	3	4	7	0	1	8	0	0
23	21744789	.	A	G	6	2	8	0	0	8	0	0
23	21744819	.	G	A	4	2	6	0	0	6	0	0
23	21803494	.	T	G	1	2	3	0	0	3	0	0
23	21803685	.	G	A	3	2	5	0	0	5	0	0
23	21803918	.	A	C	0	2	2	0	0	2	0	0
23	21803925	.	T	A	1	1	2	0	0	2	0	0
23	21805899	.	A	T	1	2	3	0	0	3	0	0
23	21806273	.	C	A	2	4	6	0	0	6	0	0
23	21806281	.	G	A	2	4	6	0	0	6	0	0
23	21810048	.	A	G	4	6	10	0	0	10	0	0
23	21840570	.	C	G	2	2	4	0	0	4	0	0
23	21904808	.	C	T	1	2	3	0	0	3	0	0
23	21978933	.	C	A	2	0	2	0	0	2	0	0
23	22018738	.	G	T	2	2	4	0	0	4	0	0
23	22030235	.	T	C	6	6	12	0	0	12	0	0
23	22030791	.	C	T	0	1	1	0	0	1	0	0
23	22033653	.	C	T	1	0	1	0	0	1	0	0
23	22033661	.	G	A	1	1	2	0	0	2	0	0
23	22034461	.	C	T	0	3	3	0	1	4	0	0
23	22051380	.	C	T	4	0	4	0	0	4	0	0
23	22054542	.	C	A	1	0	1	0	0	1	0	0
23	22060088	.	T	A	9	3	12	0	2	14	0	0
23	22064493	.	A	G	2	6	8	0	0	8	0	0
23	22067865	.	G	T	1	3	4	0	0	4	0	0
23	22379008	.	T	C	2	3	5	0	0	5	0	0
23	22384741	.	C	T	2	2	4	0	0	4	0	0
23	22394219	.	G	A	1	5	6	0	0	6	0	0
23	22424506	.	T	A	0	2	2	0	0	2	0	0
23	22424524	.	C	T	2	1	3	0	0	3	0	0
23	22424562	.	A	G	3	2	5	0	0	5	0	0
23	22424574	.	G	A	0	2	2	0	3	5	0	0
23	22424764	.	C	T	6	3	9	0	0	9	0	0
23	22425126	.	G	C	4	5	9	0	0	9	0	0
23	22496525	.	C	A	4	5	9	0	1	10	0	0
23	22496589	.	A	G	5	7	12	0	1	13	0	0
23	22496785	.	A	G	5	3	8	0	1	9	0	0
23	22497049	.	A	T	3	10	13	0	1	14	0	0
23	22497550	.	A	G	5	4	9	0	1	10	0	0
23	22590932	.	C	T	1	2	3	0	0	3	0	0
23	22591168	.	C	T	3	2	5	0	0	5	0	0
23	22635036	.	T	A	2	2	4	0	0	4	0	0
23	22635284	.	G	A	9	4	13	0	0	13	0	0
23	22635466	.	T	C	5	3	8	0	0	8	0	0
23	22635490	.	C	G	3	4	7	0	0	7	0	0
23	22635720	.	T	A	1	7	8	0	0	8	0	0
23	22635732	.	C	A	0	6	6	0	3	9	0	0
23	22667247	.	C	T	24	18	42	0	2	44	0	0
23	22674704	.	C	T	5	3	8	0	0	8	0	0
23	22677394	.	A	C	8	11	19	0	3	22	0	0
23	22677496	.	C	T	37	37	74	0	2	76	0	0
23	22677638	.	C	T	38	20	58	0	3	61	0	0
23	22895465	.	G	A	2	2	4	0	0	4	0	0
23	22922775	.	A	C	8	8	16	0	1	17	0	0
23	22922795	.	G	T	5	6	11	0	1	12	0	0
23	22923021	.	A	C	8	16	24	0	0	24	0	0
23	22923033	.	C	T	9	17	26	0	0	26	0	0
23	22923198	.	C	T	15	8	23	0	0	23	0	0
23	22923339	.	C	T	14	14	28	0	2	30	0	0
23	22923537	.	C	T	9	19	28	0	1	29	0	0
23	22923603	.	T	C	4	12	16	0	3	19	0	0
23	22925490	.	C	A	1	3	4	0	0	4	0	0
23	23118653	.	A	T	2	3	5	0	1	6	0	0
23	23118815	.	C	T	1	4	5	0	0	5	0	0
23	23122381	.	C	T	11	7	18	0	1	19	0	0
23	23122955	.	G	T	3	2	5	2	0	7	0	0
23	23123146	.	G	T	4	11	15	0	0	15	0	0
23	23126589	.	A	C	4	2	6	0	0	6	0	0
23	23126621	.	T	C	4	4	8	0	0	8	0	0
23	23154388	.	T	A	2	0	2	0	0	2	0	0
23	23170963	.	T	G	5	3	8	0	1	9	0	0
23	23174035	.	A	G	1	1	2	0	0	2	0	0
23	23174059	.	G	A	1	1	2	0	0	2	0	0
23	23174799	.	C	A	0	1	1	0	0	1	0	0
23	23174808	.	A	C	0	1	1	0	0	1	0	0
23	23190151	.	T	A	7	2	9	0	0	9	0	0
23	23192478	.	G	A	9	4	13	0	1	14	0	0
23	23192514	.	A	T	1	2	3	0	1	4	0	0
23	23194228	.	C	T	4	6	10	0	0	10	0	0
23	23205469	.	A	G	11	0	11	0	11	22	0	0
23	23205511	.	T	C	5	5	10	0	0	10	0	0
23	23210288	.	A	G	10	8	18	0	0	18	0	0
23	23210303	.	A	G	11	10	21	0	2	23	0	0
23	23210339	.	C	T	9	12	21	0	0	21	0	0
23	23212257	.	C	T	6	4	10	0	0	10	0	0
23	23212567	.	C	T	15	8	23	0	0	23	0	0
23	23213219	.	T	C	18	16	34	0	2	36	0	0
23	23213417	.	C	T	12	5	17	0	2	19	0	0
23	23213437	.	G	A	0	10	10	0	11	21	0	0
23	23213582	.	C	A	18	14	32	0	3	35	0	0
23	23213613	.	T	A	17	20	37	0	1	38	0	0
23	23213657	.	G	A	19	17	36	0	1	37	0	0
23	23213757	.	G	A	19	15	34	0	1	35	0	0
23	23213800	.	G	A	0	11	11	0	11	22	0	0
23	23213917	.	T	A	14	20	34	0	1	35	0	0
23	23213939	.	T	A	15	21	36	0	1	37	0	0
23	23214070	.	C	T	11	9	20	0	0	20	0	0
23	23214531	.	G	A	2	2	4	0	0	4	0	0
23	23399987	.	T	C	4	2	6	0	0	6	0	0
23	23400332	.	G	C	3	1	4	0	1	5	0	0
23	23658600	.	A	G	1	4	5	0	0	5	0	0
23	23741687	.	G	A	0	2	2	0	2	4	0	0
23	23754415	.	C	T	1	4	5	0	0	5	0	0
23	23816509	.	A	C	4	2	6	0	0	6	0	0
23	23860113	.	T	A	2	0	2	0	0	2	0	0
23	23860117	.	G	A	2	0	2	0	0	2	0	0
23	23877088	.	A	G	5	0	5	0	5	10	0	0
23	23888136	.	G	A	0	7	7	0	10	17	0	0
23	23891551	.	G	A	0	2	2	0	5	7	0	0
23	23903278	.	G	A	0	9	9	0	8	17	0	0
23	23903432	.	C	T	8	2	10	0	0	10	0	0
23	23912720	.	G	T	18	11	29	0	0	29	0	0
23	23912723	.	C	A	19	8	27	0	1	28	0	0
23	23912900	.	C	G	11	13	24	0	1	25	0	0
23	23913240	.	G	T	14	20	34	0	0	34	0	0
23	23913818	.	A	T	13	22	35	0	1	36	0	0
23	23913858	.	A	C	17	24	41	0	4	45	0	0
23	23914017	.	G	A	1	13	14	0	19	33	0	0
23	23914176	.	A	T	12	13	25	0	2	27	0	0
23	23973724	.	T	A	4	7	11	0	1	12	0	0
23	23994537	.	T	C	1	0	1	0	0	1	0	0
23	23994595	.	C	T	6	7	13	0	0	13	0	0
23	23995382	.	G	T	11	4	15	0	1	16	0	0
23	24112906	.	A	G	1	0	1	0	2	3	0	0
23	24143464	.	T	A	0	1	1	0	0	1	0	0
23	24143471	.	G	A	0	1	1	0	0	1	0	0
23	24144860	.	A	G	2	2	4	0	0	4	0	0
23	24145904	.	A	T	2	5	7	0	0	7	0	0
23	24170870	.	G	A	10	14	24	0	1	25	0	0
23	24195469	.	C	T	4	6	10	0	2	12	0	0
23	24195611	.	T	C	5	0	5	0	3	8	0	0
23	24202760	.	C	T	1	3	4	0	0	4	0	0
23	24202858	.	C	T	5	6	11	0	0	11	0	0
23	24202985	.	T	C	4	5	9	0	0	9	0	0
23	24208176	.	G	A	6	5	11	0	0	11	0	0
23	24208208	.	G	C	5	3	8	0	0	8	0	0
23	24214381	.	G	A	4	4	8	0	0	8	0	0
23	24216127	.	C	G	1	1	2	0	0	2	0	0
23	24216192	.	G	A	4	2	6	0	0	6	0	0
23	24227352	.	A	T	5	8	13	0	0	13	0	0
23	24227380	.	A	G	6	6	12	0	1	13	0	0
23	24227458	.	T	C	7	8	15	0	1	16	0	0
23	24227673	.	C	A	9	24	33	0	1	34	0	0
23	24228767	.	G	A	8	13	21	0	1	22	0	0
23	24229110	.	G	A	7	10	17	0	1	18	0	0
23	24231222	.	A	G	5	7	12	0	1	13	0	0
23	24233458	.	A	G	2	6	8	0	0	8	0	0
23	24233831	.	A	G	2	3	5	0	0	5	0	0
23	24238551	.	G	A	1	2	3	0	0	3	0	0
23	24238659	.	C	T	0	3	3	0	1	4	0	0
23	24238676	.	A	T	1	3	4	0	0	4	0	0
23	24240979	.	G	T	11	6	17	0	0	17	0	0
23	24243168	.	G	A	1	2	3	0	0	3	0	0
23	24244694	.	C	T	0	3	3	0	1	4	0	0
23	24247719	.	A	T	2	3	5	0	0	5	0	0
23	24301213	.	G	A	3	3	6	0	0	6	0	0
23	24301288	.	G	A	1	3	4	0	0	4	0	0
23	24439480	.	G	T	15	17	32	0	5	37	0	0
23	24439780	.	G	A	12	10	22	0	0	22	0	0
23	24440031	.	C	T	0	2	2	0	0	2	0	0
23	24440397	.	C	T	7	7	14	0	4	18	0	0
23	24442787	.	T	G	2	0	2	0	0	2	0	0
23	24443161	.	G	T	10	7	17	0	1	18	0	0
23	24443576	.	A	G	10	11	21	0	3	24	0	0
23	24443609	.	C	T	0	16	16	0	7	23	0	0
23	24444291	.	A	G	12	9	21	0	2	23	0	0
23	24444344	.	C	G	6	11	17	0	2	19	0	0
23	24444543	.	C	T	0	7	7	0	11	18	0	0
23	24444803	.	T	G	13	12	25	0	0	25	0	0
23	24444861	.	G	A	8	13	21	0	0	21	0	0
23	24445112	.	G	T	11	9	20	0	0	20	0	0
23	24445338	.	A	G	13	7	20	0	0	20	0	0
23	24445584	.	A	G	10	5	15	0	0	15	0	0
23	24445876	.	A	G	3	11	14	0	0	14	0	0
23	24445906	.	G	C	8	7	15	0	4	19	0	0
23	24446411	.	C	T	9	5	14	0	1	15	0	0
23	24447113	.	C	T	4	7	11	0	0	11	0	0
23	24447297	.	C	T	3	4	7	0	2	9	0	0
23	24447794	.	G	A	5	6	11	0	0	11	0	0
23	24448071	.	T	A	3	5	8	0	0	8	0	0
23	24448146	.	T	C	6	6	12	0	0	12	0	0
23	24448273	.	G	C	7	5	12	0	0	12	0	0
23	24449052	.	A	T	2	2	4	0	0	4	0	0
23	24449058	.	G	A	1	1	2	0	1	3	0	0
23	24449429	.	G	A	2	2	4	0	0	4	0	0
23	24450327	.	T	C	1	2	3	0	1	4	0	0
23	24451083	.	A	G	4	4	8	0	1	9	0	0
23	24475726	.	T	C	2	4	6	0	0	6	0	0
23	24504389	.	A	G	3	0	3	0	5	8	0	0
23	24590317	.	G	A	2	2	4	0	0	4	0	0
23	24590361	.	C	A	1	4	5	0	0	5	0	0
23	24591447	.	G	C	0	2	2	0	2	4	0	0
23	24591466	.	A	G	3	2	5	0	0	5	0	0
23	24600513	.	C	T	2	4	6	0	0	6	0	0
23	24600947	.	T	C	6	5	11	0	0	11	0	0
23	24604042	.	C	T	4	15	19	0	1	20	0	0
23	24604323	.	C	T	0	1	1	0	0	1	0	0
23	24604461	.	A	G	4	0	4	0	1	5	0	0
23	24605243	.	T	A	0	3	3	0	0	3	0	0
23	24608805	.	G	A	4	6	10	0	0	10	0	0
23	24608847	.	G	A	1	10	11	0	15	26	0	0
23	24653058	.	C	T	2	3	5	0	0	5	0	0
23	24655227	.	T	C	2	4	6	0	1	7	0	0
23	24655761	.	T	G	1	0	1	0	4	5	0	0
23	24655833	.	A	G	1	7	8	0	1	9	0	0
23	24659777	.	C	T	0	4	4	0	0	4	0	0
23	24661851	.	C	T	10	8	18	0	0	18	0	0
23	24669381	.	C	T	0	8	8	0	6	14	0	0
23	24669633	.	T	C	11	0	11	0	15	26	0	0
23	24672365	.	C	T	4	2	6	0	0	6	0	0
23	24676192	.	G	C	2	4	6	0	0	6	0	0
23	24694242	.	C	A	18	14	32	0	1	33	0	0
23	24694756	.	C	T	1	1	2	0	0	2	0	0
23	24694763	.	T	A	1	3	4	0	0	4	0	0
23	24697036	.	G	A	9	17	26	0	0	26	0	0
23	24699281	.	T	A	13	20	33	0	1	34	0	0
23	24750010	.	C	T	1	2	3	0	0	3	0	0
23	24750339	.	C	A	2	2	4	0	0	4	0	0
23	24803130	.	C	T	12	12	24	0	4	28	0	0
23	24803221	.	T	C	4	0	4	0	5	9	0	0
23	24819831	.	C	G	5	6	11	0	1	12	0	0
23	24855864	.	G	T	1	0	1	0	0	1	0	0
23	24926470	.	G	A	6	7	13	0	1	14	0	0
23	24932493	.	G	T	5	4	9	0	0	9	0	0
23	24932979	.	G	A	3	6	9	0	0	9	0	0
23	24933121	.	C	T	3	3	6	0	2	8	0	0
23	24934567	.	T	C	5	8	13	0	2	15	0	0
23	24934597	.	C	G	3	5	8	0	0	8	0	0
23	24956985	.	A	T	0	2	2	0	0	2	0	0
23	24957061	.	T	G	2	3	5	0	0	5	0	0
23	24959374	.	G	C	4	5	9	0	0	9	0	0
23	24959406	.	T	C	2	7	9	0	0	9	0	0
23	24960393	.	T	A	1	1	2	0	0	2	0	0
23	24960701	.	C	T	2	1	3	0	0	3	0	0
23	24960702	.	C	T	2	1	3	0	0	3	0	0
23	24965393	.	C	T	4	4	8	0	0	8	0	0
23	24965396	.	G	A	5	4	9	0	0	9	0	0
23	24965432	.	G	T	3	4	7	0	0	7	0	0
23	24965767	.	C	G	0	3	3	0	0	3	0	0
23	24968676	.	C	A	5	8	13	0	1	14	0	0
23	24970331	.	A	G	0	0	0	0	2	2	0	0
23	24970372	.	G	A	0	3	3	0	0	3	0	0
23	24970451	.	T	C	1	2	3	0	1	4	0	0
23	24970589	.	A	G	3	1	4	0	0	4	0	0
23	24970593	.	G	A	3	2	5	0	0	5	0	0
23	24970710	.	G	A	3	6	9	0	0	9	0	0
23	24970732	.	C	T	3	3	6	0	0	6	0	0
23	24973871	.	T	C	5	4	9	0	0	9	0	0
23	24973928	.	A	G	3	2	5	0	0	5	0	0
23	24973931	.	A	G	3	0	3	0	2	5	0	0
23	24977048	.	G	T	2	5	7	0	0	7	0	0
23	24977060	.	C	T	1	3	4	0	1	5	0	0
23	24983469	.	C	G	2	1	3	0	0	3	0	0
23	24983536	.	A	G	1	0	1	0	4	5	0	0
23	25525287	.	T	G	0	2	2	0	0	2	0	0
23	25551282	.	G	A	1	2	3	0	0	3	0	0
23	25756641	.	A	G	2	3	5	0	0	5	0	0
23	25757012	.	G	A	0	2	2	0	0	2	0	0
23	25757378	.	G	A	0	1	1	0	2	3	0	0
23	25767757	.	G	A	0	1	1	0	3	4	0	0
23	25768133	.	C	G	2	6	8	0	0	8	0	0
23	25768384	.	C	T	1	2	3	0	0	3	0	0
23	25770414	.	G	A	1	2	3	0	0	3	0	0
23	25770804	.	T	A	1	2	3	0	0	3	0	0
23	25773460	.	G	A	2	3	5	0	0	5	0	0
23	25773469	.	G	A	3	2	5	0	0	5	0	0
23	25776824	.	C	T	1	1	2	0	0	2	0	0
23	25779888	.	G	A	1	2	3	0	0	3	0	0
23	25779893	.	A	G	1	2	3	0	0	3	0	0
23	25796410	.	T	A	5	6	11	0	1	12	0	0
23	25796484	.	G	C	4	0	4	0	3	7	0	0
23	25796563	.	C	A	3	3	6	0	1	7	0	0
23	25796670	.	T	G	4	4	8	0	0	8	0	0
23	25797011	.	T	A	7	6	13	0	0	13	0	0
23	25797022	.	T	A	6	6	12	0	0	12	0	0
23	25797143	.	G	C	9	3	12	0	0	12	0	0
23	25797216	.	G	A	4	6	10	0	0	10	0	0
23	25869424	.	A	G	7	0	7	0	6	13	0	0
23	25869571	.	G	A	7	3	10	0	1	11	0	0
23	25869596	.	C	A	7	3	10	0	1	11	0	0
23	25869658	.	C	T	5	6	11	0	0	11	0	0
23	25869706	.	A	G	10	4	14	0	0	14	0	0
23	25871764	.	C	A	3	6	9	0	0	9	0	0
23	25872703	.	G	A	0	2	2	0	0	2	0	0
23	25873444	.	C	A	5	5	10	0	2	12	0	0
23	25873967	.	T	A	2	2	4	0	0	4	0	0
23	25873976	.	T	A	5	1	6	0	0	6	0	0
23	25874249	.	A	G	13	0	13	0	10	23	0	0
23	25874261	.	T	A	12	8	20	0	2	22	0	0
23	25874334	.	C	G	8	7	15	0	1	16	0	0
23	25874355	.	A	T	8	6	14	0	1	15	0	0
23	25874459	.	A	T	5	8	13	0	1	14	0	0
23	25874498	.	G	A	5	5	10	0	2	12	0	0
23	25874615	.	G	A	1	4	5	0	0	5	0	0
23	25879786	.	A	G	12	6	18	0	0	18	0	0
23	25879930	.	A	C	1	3	4	0	1	5	0	0
23	25930689	.	C	T	2	2	4	0	1	5	0	0
23	25942399	.	T	G	11	0	11	0	11	22	0	0
23	25942559	.	T	A	7	2	9	0	0	9	0	0
23	25942708	.	G	A	1	3	4	0	6	10	0	0
23	25946530	.	A	G	2	3	5	0	0	5	0	0
23	25946766	.	C	T	1	5	6	0	0	6	0	0
23	25948000	.	G	A	1	2	3	0	0	3	0	0
23	26063560	.	A	T	30	23	53	0	2	56	1	0
23	26063614	.	A	C	26	26	52	0	1	53	0	0
23	26063734	.	G	A	17	30	47	0	1	48	0	0
23	26063843	.	G	A	21	32	53	0	0	53	0	0
23	26063985	.	A	T	28	22	50	0	2	52	0	0
23	26064050	.	T	A	24	26	50	0	3	54	1	0
23	26064122	.	T	A	4	22	26	0	0	26	0	0
23	26064124	.	T	A	24	1	25	0	1	26	0	0
23	26064266	.	T	A	25	12	37	0	1	38	0	0
23	26064923	.	T	C	34	1	35	0	29	64	0	0
23	26064948	.	T	G	31	21	52	0	1	53	0	0
23	26064989	.	A	G	31	22	53	0	3	56	0	0
23	26065079	.	T	C	23	34	57	0	4	61	0	0
23	26074123	.	G	A	8	12	20	0	1	21	0	0
23	26074252	.	T	A	3	0	3	0	0	3	0	0
23	26088791	.	G	C	4	3	7	0	1	8	0	0
23	26088845	.	A	G	4	2	6	0	0	6	0	0
23	26093095	.	C	T	3	6	9	0	0	9	0	0
23	26093597	.	A	G	5	5	10	0	0	10	0	0
23	26093868	.	T	C	2	2	4	0	0	4	0	0
23	26093933	.	A	T	6	2	8	0	1	9	0	0
23	26094533	.	A	G	4	6	10	0	0	10	0	0
23	26094589	.	G	C	7	13	20	0	1	21	0	0
23	26094617	.	T	C	8	20	28	0	1	29	0	0
23	26094626	.	T	C	8	0	8	0	20	28	0	0
23	26094694	.	A	C	7	9	16	0	1	17	0	0
23	26094877	.	A	G	13	9	22	0	1	23	0	0
23	26094932	.	G	A	12	3	15	0	0	15	0	0
23	26094938	.	C	A	12	3	15	0	0	15	0	0
23	26095081	.	G	A	8	10	18	0	2	20	0	0
23	26095096	.	C	T	13	13	26	0	0	26	0	0
23	26095153	.	G	A	14	9	23	0	1	24	0	0
23	26095285	.	T	A	7	12	19	0	0	20	1	0
23	26095400	.	C	T	10	8	18	0	0	18	0	0
23	26095416	.	T	G	6	8	14	0	0	14	0	0
23	26110735	.	G	A	8	13	21	0	0	21	0	0
23	26120198	.	C	A	0	2	2	0	3	5	0	0
23	26187735	.	C	T	2	2	4	0	0	4	0	0
23	26225907	.	A	T	6	3	9	0	1	10	0	0
23	26226066	.	G	T	0	2	2	0	0	2	0	0
23	26227697	.	C	T	0	6	6	0	4	10	0	0
23	26232509	.	C	A	12	6	18	0	1	19	0	0
23	26240860	.	G	A	7	4	11	0	1	12	0	0
23	26251940	.	G	A	2	4	6	0	0	6	0	0
23	26251946	.	A	G	2	5	7	0	0	7	0	0
23	26299011	.	T	C	1	0	1	0	2	3	0	0
23	26311056	.	T	C	1	4	5	0	0	5	0	0
23	26498568	.	T	C	1	3	4	0	0	4	0	0
23	26499285	.	T	A	1	2	3	0	0	3	0	0
23	26504151	.	A	C	19	1	20	0	24	44	0	0
23	26504254	.	G	A	30	9	39	0	2	41	0	0
23	26504264	.	C	T	27	12	39	0	0	39	0	0
23	26507741	.	G	A	23	22	45	0	0	45	0	0
23	26509764	.	G	A	16	19	35	0	3	38	0	0
23	26517183	.	G	A	17	14	31	0	0	31	0	0
23	26522647	.	A	G	5	11	16	0	1	17	0	0
23	26522892	.	G	A	8	12	20	0	1	21	0	0
23	26523020	.	A	G	5	2	7	0	1	8	0	0
23	26763798	.	A	T	12	6	18	0	2	20	0	0
23	26763994	.	C	A	5	7	12	0	0	12	0	0
23	26764351	.	A	C	2	3	5	0	0	5	0	0
23	26766668	.	A	G	3	4	7	0	1	8	0	0
23	26774334	.	G	A	0	0	0	0	1	1	0	0
23	26775784	.	C	T	0	0	0	0	1	1	0	0
23	26797108	.	T	A	4	3	7	0	0	7	0	0
23	26946805	.	A	G	2	3	5	0	0	5	0	0
23	26951926	.	G	A	0	1	1	0	0	1	0	0
23	26958483	.	A	G	5	0	5	0	0	5	0	0
23	26979223	.	C	A	11	14	25	0	1	26	0	0
23	27003630	.	T	A	8	13	21	0	1	22	0	0
23	27003720	.	G	A	21	24	45	0	2	47	0	0
23	27003801	.	T	C	24	28	52	0	0	52	0	0
23	27004310	.	C	T	17	17	34	0	2	36	0	0
23	27004339	.	C	T	18	18	36	0	0	36	0	0
23	27004347	.	G	A	18	15	33	0	2	35	0	0
23	27004383	.	C	T	15	14	29	0	3	32	0	0
23	27004397	.	T	C	11	13	24	0	1	25	0	0
23	27004665	.	T	C	18	16	34	0	2	36	0	0
23	27005195	.	G	A	20	14	34	0	4	38	0	0
23	27005514	.	A	G	14	0	14	0	12	26	0	0
23	27005973	.	G	T	3	9	12	0	0	12	0	0
23	27041461	.	A	T	3	2	5	0	0	5	0	0
23	27041503	.	C	G	5	4	9	0	0	9	0	0
23	27041778	.	A	T	5	3	8	0	1	9	0	0
23	27041786	.	A	C	3	2	5	0	0	5	0	0
23	27042132	.	A	G	3	5	8	0	0	8	0	0
23	27044241	.	C	T	3	4	7	0	1	8	0	0
23	27044526	.	A	G	4	2	6	0	0	6	0	0
23	27044946	.	C	G	3	3	6	0	0	6	0	0
23	27044947	.	T	C	3	0	3	0	3	6	0	0
23	27052123	.	C	A	8	5	13	0	0	13	0	0
23	27052125	.	C	T	8	4	12	0	1	13	0	0
23	27054361	.	C	T	8	7	15	0	0	15	0	0
23	27059120	.	G	A	0	16	16	0	14	30	0	0
23	27059376	.	T	A	9	10	19	0	2	21	0	0
23	27059422	.	C	T	14	12	26	0	0	26	0	0
23	27059459	.	A	G	12	0	12	0	14	26	0	0
23	27059526	.	G	A	2	17	19	0	12	31	0	0
23	27135734	.	G	A	2	2	4	0	0	4	0	0
23	27136385	.	T	G	1	3	4	0	0	4	0	0
23	27251789	.	G	C	20	14	34	0	1	35	0	0
23	27251859	.	G	A	23	19	42	0	0	42	0	0
23	27251872	.	C	T	1	20	21	0	21	42	0	0
23	27252425	.	G	A	24	18	42	0	2	44	0	0
23	27252587	.	A	G	20	17	37	0	2	39	0	0
23	27252833	.	A	G	19	8	27	0	1	28	0	0
23	27254226	.	T	C	4	4	8	0	0	8	0	0
23	27254586	.	C	T	0	9	9	0	18	27	0	0
23	27274266	.	G	A	1	0	1	0	0	1	0	0
23	27279281	.	A	G	9	7	16	0	0	16	0	0
23	27279320	.	A	G	13	12	25	0	2	27	0	0
23	27279476	.	G	A	15	6	21	0	0	21	0	0
23	27279533	.	C	T	13	8	21	0	1	22	0	0
23	27294611	.	G	A	4	11	15	0	0	15	0	0
23	27296964	.	G	C	2	1	3	0	10	13	0	0
23	27305186	.	C	T	9	8	17	0	0	17	0	0
23	27305195	.	G	A	7	8	15	0	1	16	0	0
23	27358990	.	A	T	4	6	10	0	0	10	0	0
23	27359203	.	A	G	6	7	13	0	1	14	0	0
23	27359410	.	G	A	6	2	8	0	0	8	0	0
23	27359526	.	T	C	6	8	14	0	0	15	1	0
23	27359755	.	C	T	0	3	3	0	7	10	0	0
23	27359825	.	C	A	7	5	12	0	0	12	0	0
23	27359867	.	A	C	4	4	8	0	0	8	0	0
23	27360007	.	G	A	2	6	8	0	0	8	0	0
23	27361210	.	A	T	4	5	9	0	0	9	0	0
23	27361216	.	G	A	4	6	10	0	0	10	0	0
23	27364018	.	C	T	3	4	7	0	0	7	0	0
23	27366669	.	C	T	2	0	2	0	0	2	0	0
23	27373181	.	C	T	0	1	1	0	0	1	0	0
23	27373186	.	G	T	0	1	1	0	0	1	0	0
23	27383518	.	A	G	1	3	4	0	0	4	0	0
23	27383533	.	G	C	3	1	4	0	0	4	0	0
23	27497811	.	T	A	4	2	6	0	0	6	0	0
23	27497960	.	A	T	11	12	23	0	3	27	1	0
23	27498027	.	A	T	5	10	15	0	2	17	0	0
23	27498040	.	C	G	10	6	16	0	1	17	0	0
23	27498195	.	A	T	16	11	27	0	0	27	0	0
23	27498441	.	A	T	5	2	7	0	0	7	0	0
23	27498798	.	C	T	2	17	19	0	15	34	0	0
23	27499096	.	G	A	14	10	24	0	0	24	0	0
23	27499195	.	A	T	7	21	28	0	0	28	0	0
23	27499246	.	G	A	6	18	24	0	1	25	0	0
23	27499306	.	C	T	10	6	16	0	0	16	0	0
23	27501872	.	A	G	11	12	23	0	0	23	0	0
23	27513952	.	A	G	4	2	6	0	1	7	0	0
23	27515931	.	G	A	4	6	10	0	0	10	0	0
23	27516268	.	T	C	1	0	1	0	0	1	0	0
23	27518434	.	G	A	8	7	15	0	2	17	0	0
23	27521608	.	A	T	2	1	3	0	0	3	0	0
23	27521815	.	G	A	1	2	3	0	0	3	0	0
23	27521863	.	A	G	6	5	11	0	0	11	0	0
23	27547467	.	C	T	0	1	1	0	3	4	0	0
23	27591834	.	C	T	5	8	13	0	1	14	0	0
23	27591859	.	C	T	5	7	12	0	3	15	0	0
23	27591939	.	A	G	1	5	6	0	0	6	0	0
23	27592411	.	A	C	6	4	10	0	1	11	0	0
23	27592615	.	T	C	4	2	6	0	0	6	0	0
23	27592796	.	T	C	10	1	11	0	9	20	0	0
23	27593230	.	C	T	10	6	16	0	2	18	0	0
23	27597141	.	C	A	0	0	0	0	2	2	0	0
23	27597808	.	G	A	7	6	13	0	1	14	0	0
23	27597980	.	G	A	0	1	1	0	0	1	0	0
23	27597981	.	C	A	0	0	0	0	1	1	0	0
23	27599110	.	A	C	2	1	3	0	0	3	0	0
23	27599365	.	G	A	2	4	6	0	0	6	0	0
23	27601803	.	C	T	5	3	8	0	0	8	0	0
23	27603302	.	G	A	1	4	5	0	0	5	0	0
23	27622036	.	T	A	21	22	43	0	0	43	0	0
23	27622212	.	C	A	16	13	29	0	1	30	0	0
23	27622258	.	T	C	10	19	29	0	0	29	0	0
23	27622324	.	T	C	5	11	16	0	0	16	0	0
23	27622386	.	T	G	4	2	6	0	0	6	0	0
23	27629923	.	A	T	1	1	2	0	0	2	0	0
23	27677263	.	G	A	21	22	43	0	2	45	0	0
23	27677278	.	G	A	17	19	36	0	2	38	0	0
23	27683248	.	C	A	0	5	5	0	2	7	0	0
23	27683371	.	C	T	0	4	4	0	5	9	0	0
23	27683497	.	C	T	5	6	11	0	1	12	0	0
23	27683710	.	G	A	2	2	4	0	0	4	0	0
23	27781082	.	T	C	1	3	4	0	0	4	0	0
23	27785026	.	A	C	3	3	6	0	0	6	0	0
23	27785460	.	A	T	1	3	4	0	0	4	0	0
23	27787598	.	T	C	3	6	9	0	0	9	0	0
23	27787851	.	T	C	0	2	2	0	0	2	0	0
23	27788665	.	C	T	2	10	12	0	1	13	0	0
23	27788768	.	G	A	6	2	8	0	1	9	0	0
23	27789577	.	T	C	5	3	8	0	0	8	0	0
23	27793510	.	T	C	6	5	11	0	0	11	0	0
23	27800954	.	A	C	5	9	14	0	1	15	0	0
23	27800977	.	C	T	9	10	19	0	0	19	0	0
23	27801237	.	T	C	7	11	18	0	2	20	0	0
23	27801268	.	C	A	11	13	24	0	3	27	0	0
23	27801629	.	C	T	10	4	14	0	0	14	0	0
23	27801849	.	G	A	6	2	8	0	1	9	0	0
23	27801880	.	G	T	4	2	6	0	0	6	0	0
23	27805414	.	A	G	8	4	12	0	0	12	0	0
23	27807294	.	A	G	4	3	7	0	0	7	0	0
23	27807523	.	A	G	0	1	1	0	0	1	0	0
23	27807664	.	G	A	0	11	11	0	1	12	0	0
23	27835898	.	G	A	3	2	5	0	2	7	0	0
23	27836235	.	C	T	0	7	7	0	3	10	0	0
23	27836245	.	G	A	3	7	10	0	0	10	0	0
23	27839682	.	A	G	2	1	3	0	1	4	0	0
23	27912136	.	T	C	0	1	1	0	0	1	0	0
23	27967014	.	T	G	6	3	9	0	0	9	0	0
23	28005087	.	C	T	2	4	6	0	0	6	0	0
23	28005338	.	A	G	3	5	8	0	0	8	0	0
23	28023784	.	T	C	4	8	12	0	0	12	0	0
23	28025586	.	G	A	10	8	18	0	0	18	0	0
23	28025664	.	A	G	1	8	9	0	0	9	0	0
23	28125796	.	C	T	1	2	3	0	1	4	0	0
23	28125841	.	C	T	2	4	6	0	0	6	0	0
23	28125932	.	T	A	3	5	8	0	0	8	0	0
23	28128445	.	T	C	2	0	2	0	0	2	0	0
23	28130983	.	G	A	2	4	6	0	0	6	0	0
23	28130999	.	A	G	3	4	7	0	0	7	0	0
23	28131083	.	A	G	1	2	3	0	1	4	0	0
23	28131248	.	C	T	3	1	4	0	2	6	0	0
23	28131251	.	C	T	2	1	3	0	2	5	0	0
23	28131285	.	C	T	5	3	8	0	1	9	0	0
23	28131320	.	G	A	6	5	11	0	0	11	0	0
23	28136167	.	G	T	1	6	7	0	0	7	0	0
23	28139564	.	A	G	1	6	7	0	2	9	0	0
23	28139633	.	T	C	5	2	7	0	0	7	0	0
23	28139812	.	A	G	0	1	1	0	0	1	0	0
23	28141324	.	G	C	1	3	4	0	0	4	0	0
23	28186060	.	T	A	14	14	28	0	3	31	0	0
23	28186688	.	T	G	1	5	6	0	1	7	0	0
23	28186995	.	T	C	5	1	6	0	5	11	0	0
23	28190648	.	A	G	14	4	18	0	0	18	0	0
23	28200967	.	A	G	12	12	24	0	0	24	0	0
23	28231248	.	G	A	2	4	6	0	0	6	0	0
23	28294259	.	T	A	1	1	2	0	0	2	0	0
23	28294709	.	A	G	2	3	5	0	0	5	0	0
23	28344853	.	C	T	0	2	2	0	1	3	0	0
23	28344855	.	G	A	1	2	3	0	0	3	0	0
23	28374570	.	G	A	20	22	42	0	2	44	0	0
23	28374711	.	C	A	16	18	34	0	1	35	0	0
23	28374756	.	A	G	11	18	29	0	2	31	0	0
23	28377424	.	T	C	3	2	5	0	0	5	0	0
23	28382953	.	C	T	9	7	16	0	1	17	0	0
23	28388013	.	C	A	14	15	29	0	0	29	0	0
23	28388318	.	C	T	16	18	34	0	1	35	0	0
23	28388325	.	T	C	16	17	33	0	2	35	0	0
23	28486050	.	C	A	2	1	3	0	0	3	0	0
23	28486843	.	T	C	1	0	1	0	0	1	0	0
23	28515768	.	C	T	3	2	5	0	0	5	0	0
23	28525270	.	T	C	0	1	1	0	1	2	0	0
23	28525828	.	G	T	0	1	1	0	0	1	0	0
23	28525831	.	A	G	0	1	1	0	0	1	0	0
23	28527739	.	A	C	3	2	5	0	0	5	0	0
23	28537575	.	G	A	0	4	4	0	2	6	0	0
23	28538590	.	T	A	0	0	0	0	1	1	0	0
23	28539279	.	G	A	0	3	3	0	1	4	0	0
23	28541413	.	A	G	3	4	7	0	0	7	0	0
23	28541416	.	T	C	3	4	7	0	0	7	0	0
23	28541593	.	T	C	3	8	11	0	1	12	0	0
23	28541633	.	A	G	4	8	12	0	0	12	0	0
23	28541638	.	C	T	3	7	10	0	1	11	0	0
23	28541683	.	G	T	3	6	9	0	0	9	0	0
23	28546798	.	T	C	7	7	14	0	0	14	0	0
23	28551764	.	A	G	9	0	9	0	8	17	0	0
23	28561502	.	C	A	18	13	31	0	1	32	0	0
23	28561836	.	C	T	8	3	11	0	0	11	0	0
23	28564191	.	C	A	19	13	32	0	1	33	0	0
23	28667294	.	T	C	3	6	9	0	0	9	0	0
23	28672063	.	G	A	0	2	2	0	0	2	0	0
23	28674046	.	C	T	1	1	2	0	0	2	0	0
23	28674252	.	G	A	1	0	1	0	0	1	0	0
23	28674634	.	T	A	0	1	1	0	0	1	0	0
23	28674890	.	A	C	7	11	18	0	0	18	0	0
23	28679693	.	A	G	5	3	8	0	0	8	0	0
23	28679696	.	C	T	5	3	8	0	0	8	0	0
23	28679753	.	C	T	8	7	15	0	1	16	0	0
23	28680239	.	A	G	0	1	1	0	0	1	0	0
23	28681558	.	G	C	23	22	45	0	0	45	0	0
23	28681559	.	C	A	23	22	45	0	0	45	0	0
23	28681723	.	T	A	19	15	34	0	5	39	0	0
23	28687561	.	C	T	3	2	5	0	0	5	0	0
23	28687637	.	G	T	8	3	11	0	0	11	0	0
23	28687766	.	C	T	2	2	4	0	0	4	0	0
23	28695772	.	A	G	1	1	2	0	0	2	0	0
23	28698340	.	T	C	9	6	15	0	1	16	0	0
23	28704611	.	G	A	9	8	17	0	0	17	0	0
23	28704683	.	G	A	1	0	1	0	0	1	0	0
23	28705908	.	C	T	5	6	11	0	0	11	0	0
23	28707195	.	T	A	4	3	7	0	0	7	0	0
23	28710429	.	T	C	8	10	18	0	0	18	0	0
23	28712193	.	T	G	6	1	7	0	0	7	0	0
23	28722887	.	G	A	0	1	1	0	1	2	0	0
23	28722917	.	C	T	3	2	5	0	0	5	0	0
23	28723338	.	C	A	1	1	2	0	0	2	0	0
23	28724964	.	A	G	5	2	7	0	0	7	0	0
23	28725174	.	G	A	0	4	4	0	0	4	0	0
23	28725644	.	G	A	4	4	8	0	1	9	0	0
23	28725743	.	A	G	2	1	3	0	2	5	0	0
23	28725804	.	G	A	4	3	7	0	0	7	0	0
23	28725822	.	G	C	5	2	7	0	0	7	0	0
23	28725847	.	A	G	3	2	5	0	0	5	0	0
23	28726060	.	G	A	2	2	4	0	0	4	0	0
23	28726258	.	A	T	2	2	4	0	0	4	0	0
23	28726521	.	A	G	8	4	12	0	1	13	0	0
23	28726634	.	A	C	4	4	8	0	1	9	0	0
23	28726985	.	A	T	5	3	8	0	0	8	0	0
23	28731489	.	A	C	22	26	48	0	1	49	0	0
23	28731499	.	C	T	22	22	44	0	1	45	0	0
23	28731834	.	C	T	24	28	52	0	4	56	0	0
23	28731914	.	T	C	25	28	53	0	0	53	0	0
23	28732305	.	A	T	0	6	6	0	0	6	0	0
23	28803209	.	T	C	3	2	5	0	0	5	0	0
23	28803213	.	C	T	3	2	5	0	0	5	0	0
23	28856977	.	A	G	1	1	2	0	0	2	0	0
23	28923717	.	T	A	4	5	9	0	1	10	0	0
23	28923760	.	T	A	3	8	11	0	0	11	0	0
23	28923962	.	A	G	4	5	9	0	2	11	0	0
23	28924117	.	G	C	5	3	8	1	0	9	0	0
23	28924399	.	C	G	3	4	7	0	1	8	0	0
23	28924806	.	A	G	1	3	4	0	0	4	0	0
23	28925275	.	T	C	6	5	11	0	2	13	0	0
23	28925354	.	T	C	5	5	10	0	0	10	0	0
23	28925441	.	G	A	2	7	9	0	0	9	0	0
23	28925451	.	A	T	1	7	8	0	0	8	0	0
23	28925620	.	A	G	1	2	3	0	0	3	0	0
23	28967458	.	T	G	2	2	4	0	0	4	0	0
23	28970042	.	A	G	1	1	2	0	0	2	0	0
23	28970219	.	A	G	3	4	7	0	0	7	0	0
23	28979087	.	T	C	1	2	3	0	0	3	0	0
23	29358241	.	G	A	1	17	18	0	23	41	0	0
23	29358253	.	C	T	22	19	41	0	0	41	0	0
23	29359664	.	T	A	5	7	12	0	1	14	1	0
23	29360407	.	G	T	1	7	8	0	11	19	0	0
23	29360687	.	G	T	5	5	10	0	1	11	0	0
23	29360707	.	G	T	4	3	7	0	2	9	0	0
23	29361357	.	C	A	16	13	29	0	0	30	1	0
23	29361365	.	A	C	16	13	29	0	1	30	0	0
23	29361557	.	A	T	5	5	10	0	1	11	0	0
23	29376410	.	C	T	4	6	10	0	0	10	0	0
23	29381612	.	C	A	9	12	21	0	0	21	0	0
23	29386735	.	C	T	3	2	5	0	0	5	0	0
23	29393787	.	A	G	3	6	9	0	2	11	0	0
23	29393817	.	T	C	5	5	10	0	0	10	0	0
23	29396452	.	C	T	0	30	30	0	21	51	0	0
23	29397116	.	C	G	22	11	33	0	1	34	0	0
23	29397230	.	T	A	25	23	48	0	1	49	0	0
23	29397501	.	C	T	20	24	44	0	4	48	0	0
23	29397506	.	T	G	21	28	49	0	1	50	0	0
23	29397563	.	C	T	0	20	20	0	22	42	0	0
23	29397665	.	T	G	20	18	38	0	1	39	0	0
23	29397816	.	G	A	27	17	44	0	6	50	0	0
23	29397907	.	T	C	32	20	52	0	4	56	0	0
23	29398065	.	T	C	19	29	48	0	2	50	0	0
23	29398544	.	C	A	1	22	23	0	22	45	0	0
23	29398548	.	A	G	21	24	45	0	1	46	0	0
23	29399085	.	T	C	9	1	10	0	3	13	0	0
23	29403306	.	T	G	7	7	14	0	1	15	0	0
23	29403437	.	G	A	5	10	15	0	1	16	0	0
23	29403491	.	C	A	9	8	17	0	0	17	0	0
23	29403515	.	A	C	1	0	1	0	0	1	0	0
23	29405829	.	A	G	22	18	40	0	1	41	0	0
23	29408773	.	A	G	25	21	46	0	2	48	0	0
23	29412411	.	A	G	16	6	22	0	2	24	0	0
23	29415484	.	A	G	12	9	21	0	2	23	0	0
23	29421959	.	C	G	12	17	29	0	1	30	0	0
23	29431995	.	T	C	14	15	29	0	2	31	0	0
23	29432040	.	A	G	10	11	21	0	0	21	0	0
23	29432055	.	G	A	12	12	24	0	2	26	0	0
23	29432867	.	T	G	6	4	10	0	0	10	0	0
23	29433715	.	C	A	12	9	21	0	0	21	0	0
23	29435044	.	T	C	3	1	4	0	0	4	0	0
23	29457909	.	G	A	4	1	5	0	0	5	0	0
23	29457942	.	T	C	10	0	10	0	5	15	0	0
23	29463158	.	A	G	0	1	1	0	0	1	0	0
23	29468959	.	A	G	14	14	28	0	0	28	0	0
23	29468980	.	G	A	13	11	24	0	1	25	0	0
23	29469261	.	A	G	1	1	2	0	0	2	0	0
23	29502227	.	C	T	0	5	5	0	9	14	0	0
23	29502302	.	C	T	0	2	2	0	8	10	0	0
23	29502311	.	C	T	5	2	7	0	0	7	0	0
23	29505482	.	C	T	0	5	5	0	3	8	0	0
23	29507723	.	A	T	14	18	32	0	0	32	0	0
23	29507825	.	T	C	7	1	8	0	13	21	0	0
23	29507859	.	T	G	8	13	21	0	1	22	0	0
23	29507883	.	G	A	7	10	17	0	1	18	0	0
23	29508247	.	G	C	3	0	3	0	3	6	0	0
23	29516726	.	T	C	13	6	19	0	0	19	0	0
23	29519565	.	G	A	2	3	5	0	0	5	0	0
23	29519769	.	G	C	4	4	8	0	0	8	0	0
23	29520070	.	A	C	0	2	2	0	0	2	0	0
23	29523602	.	G	A	3	2	5	0	1	6	0	0
23	29541251	.	C	T	4	4	8	0	0	8	0	0
23	29570627	.	C	G	6	4	10	0	0	10	0	0
23	29574430	.	G	C	1	3	4	0	0	4	0	0
23	29574435	.	C	T	0	3	3	0	0	3	0	0
23	29580587	.	A	T	3	1	4	0	2	6	0	0
23	29582416	.	T	C	16	40	56	0	4	60	0	0
23	29582420	.	T	C	14	43	57	0	3	60	0	0
23	29582496	.	T	C	25	23	48	0	2	50	0	0
23	29582634	.	C	A	35	28	63	0	1	64	0	0
23	29582673	.	A	G	32	23	55	0	1	56	0	0
23	29583417	.	T	A	33	30	63	0	2	65	0	0
23	29583708	.	G	A	40	25	65	0	3	68	0	0
23	29583814	.	T	A	36	45	81	0	0	81	0	0
23	29583882	.	A	G	28	40	68	0	3	72	1	0
23	29583960	.	G	A	27	28	55	0	8	63	0	0
23	29586380	.	G	A	18	12	30	0	1	31	0	0
23	29589392	.	A	G	20	20	40	0	2	42	0	0
23	29592588	.	T	C	20	0	20	0	17	37	0	0
23	29592708	.	G	A	27	26	53	0	2	55	0	0
23	29592741	.	C	T	22	19	41	0	1	42	0	0
23	29592927	.	T	C	12	1	13	0	15	28	0	0
23	29594441	.	A	G	10	10	20	0	0	20	0	0
23	29601269	.	C	T	12	8	20	0	0	20	0	0
23	29603174	.	T	C	2	2	4	0	0	4	0	0
23	29607011	.	A	G	13	21	34	0	2	36	0	0
23	29607029	.	A	G	17	17	34	1	0	35	0	0
23	29608769	.	A	G	5	10	15	0	2	17	0	0
23	29617571	.	A	C	12	0	12	0	9	21	0	0
23	29667473	.	A	C	1	3	4	0	0	4	0	0
23	29667480	.	G	A	2	6	8	0	0	8	0	0
23	29667614	.	C	G	11	20	31	0	1	32	0	0
23	29667784	.	G	A	2	2	4	0	0	4	0	0
23	29667812	.	T	C	1	0	1	0	2	3	0	0
23	29711788	.	G	A	8	9	17	0	0	17	0	0
23	29711911	.	C	T	15	20	35	0	1	36	0	0
23	29711998	.	G	A	14	11	25	0	1	26	0	0
23	29712140	.	G	A	8	8	16	0	1	17	0	0
23	29712465	.	G	A	11	13	24	0	0	24	0	0
23	29712493	.	C	T	0	8	8	0	10	18	0	0
23	29712922	.	C	A	20	9	29	0	0	29	0	0
23	29756865	.	A	T	14	8	22	0	0	22	0	0
23	29757038	.	G	A	3	9	12	0	0	12	0	0
23	29757099	.	A	T	8	3	11	0	0	11	0	0
23	29757980	.	T	C	6	0	6	0	9	15	0	0
23	29758030	.	C	T	0	8	8	0	5	13	0	0
23	29758088	.	A	G	3	14	17	0	0	17	0	0
23	29764120	.	T	C	3	3	6	0	1	7	0	0
23	29810779	.	G	A	3	1	4	0	1	5	0	0
23	29812595	.	G	C	5	7	12	0	0	12	0	0
23	29812663	.	A	T	8	4	12	0	0	12	0	0
23	29827748	.	G	A	3	3	6	0	0	6	0	0
23	29829160	.	A	T	2	2	4	0	0	4	0	0
23	29829186	.	A	C	1	2	3	0	0	3	0	0
23	29840171	.	T	C	0	0	0	0	1	1	0	0
23	29840274	.	C	A	7	6	13	0	0	13	0	0
23	29842402	.	T	A	2	2	4	0	0	4	0	0
23	29842966	.	C	T	1	4	5	0	0	5	0	0
23	29842967	.	T	G	1	4	5	0	0	5	0	0
23	29843067	.	A	T	1	1	2	0	1	3	0	0
23	29843104	.	T	C	3	2	5	0	0	5	0	0
23	29844239	.	C	T	0	2	2	0	1	3	0	0
23	29844250	.	T	A	2	2	4	0	0	4	0	0
23	29844310	.	C	A	0	3	3	0	1	4	0	0
23	29854359	.	G	A	2	0	2	0	0	2	0	0
23	29854362	.	C	T	0	1	1	0	2	3	0	0
23	29854443	.	G	A	2	2	4	0	0	4	0	0
23	29854491	.	C	T	1	2	3	0	1	4	0	0
23	29857967	.	T	A	5	2	7	0	0	7	0	0
23	29858023	.	C	A	2	3	5	0	0	5	0	0
23	29861645	.	A	T	5	12	17	0	1	18	0	0
23	29861973	.	A	G	17	17	34	0	1	35	0	0
23	29861976	.	T	C	16	0	16	0	19	35	0	0
23	29867576	.	G	A	0	3	3	0	0	3	0	0
23	29872254	.	A	G	4	6	10	0	0	10	0	0
23	29886897	.	G	C	17	12	29	0	1	30	0	0
23	29886937	.	T	A	16	19	35	0	1	36	0	0
23	29938154	.	C	T	1	2	3	0	1	4	0	0
23	29966518	.	A	T	1	3	4	0	0	4	0	0
23	29971049	.	A	G	1	0	1	0	0	1	0	0
23	29978089	.	T	C	1	0	1	0	0	1	0	0
23	29980935	.	C	T	1	2	3	0	0	3	0	0
23	29992023	.	G	C	2	5	7	0	0	7	0	0
23	30008500	.	G	A	0	1	1	0	0	1	0	0
23	30014160	.	T	A	3	0	3	0	0	3	0	0
23	30014162	.	C	A	0	0	0	0	3	3	0	0
23	30061605	.	A	C	23	5	28	0	3	31	0	0
23	30061763	.	C	T	0	18	18	0	23	41	0	0
23	30061804	.	A	C	20	12	32	0	3	35	0	0
23	30061960	.	T	C	28	1	29	0	14	43	0	0
23	30062364	.	T	A	15	8	23	0	5	28	0	0
23	30062792	.	C	T	11	12	23	0	1	24	0	0
23	30062888	.	C	T	0	11	11	0	14	25	0	0
23	30063216	.	T	C	22	0	22	0	10	32	0	0
23	30063217	.	T	G	22	10	32	0	0	32	0	0
23	30063527	.	G	A	7	9	16	0	1	17	0	0
23	30063578	.	A	G	5	12	17	0	1	18	0	0
23	30063643	.	C	T	13	11	24	0	0	24	0	0
23	30063722	.	G	A	9	9	18	0	0	18	0	0
23	30064289	.	T	C	4	9	13	0	8	21	0	0
23	30064579	.	A	G	9	12	21	0	0	21	0	0
23	30064743	.	C	A	16	10	26	0	1	27	0	0
23	30064804	.	A	G	5	12	17	0	2	19	0	0
23	30064853	.	A	G	4	18	22	0	1	23	0	0
23	30065144	.	G	A	6	7	13	0	0	13	0	0
23	30065641	.	T	G	8	3	11	0	1	12	0	0
23	30071637	.	G	A	0	1	1	0	0	1	0	0
23	30075201	.	G	A	6	9	15	0	1	16	0	0
23	30075367	.	A	T	3	2	5	0	0	5	0	0
23	30077023	.	T	C	12	0	12	0	9	21	0	0
23	30085812	.	A	T	1	0	1	0	0	1	0	0
23	30124048	.	A	C	4	0	4	0	3	7	0	0
23	30124303	.	C	T	0	9	9	0	6	15	0	0
23	30124430	.	C	G	3	9	12	0	1	13	0	0
23	30124651	.	A	G	6	13	19	0	1	20	0	0
23	30124818	.	C	T	5	6	11	0	1	12	0	0
23	30124960	.	G	A	4	5	9	0	0	9	0	0
23	30124998	.	T	C	3	3	6	0	2	8	0	0
23	30125004	.	G	A	5	2	7	0	0	7	0	0
23	30125206	.	A	G	5	6	11	0	0	11	0	0
23	30125443	.	G	A	4	1	5	0	1	6	0	0
23	30125599	.	G	A	4	5	9	0	0	9	0	0
23	30125698	.	A	G	3	2	5	0	1	6	0	0
23	30715397	.	G	A	0	0	0	0	2	2	0	0
23	30716096	.	C	T	5	4	9	0	1	10	0	0
23	30718514	.	T	A	0	4	4	0	0	4	0	0
23	30718554	.	A	G	0	0	0	0	4	4	0	0
23	30724230	.	C	A	1	6	7	0	1	8	0	0
23	30724698	.	T	A	2	4	6	0	0	6	0	0
23	30724828	.	G	C	3	2	5	0	1	6	0	0
23	30750183	.	G	A	0	6	6	0	11	17	0	0
23	30750402	.	C	A	4	8	12	0	1	13	0	0
23	30752095	.	C	A	12	6	18	0	0	18	0	0
23	30752233	.	T	G	2	4	6	0	0	6	0	0
23	30752352	.	A	T	9	5	14	0	0	14	0	0
23	30761144	.	G	A	5	3	8	0	0	8	0	0
23	30764212	.	T	C	6	11	17	0	0	17	0	0
23	30770193	.	A	G	3	5	8	0	0	8	0	0
23	30772902	.	C	T	3	1	4	0	0	4	0	0
23	30775273	.	T	C	1	5	6	0	0	6	0	0
23	30778358	.	T	C	2	5	7	0	0	7	0	0
23	30778499	.	G	A	8	5	13	0	2	15	0	0
23	30859543	.	C	A	2	5	7	0	2	9	0	0
23	30898297	.	T	C	3	3	6	0	0	6	0	0
23	30898355	.	A	C	4	3	7	0	0	7	0	0
23	30898387	.	C	T	2	2	4	0	0	4	0	0
23	30898467	.	G	C	0	8	8	0	2	10	0	0
23	30898503	.	A	T	2	3	5	0	0	5	0	0
23	30918933	.	T	C	1	2	3	0	1	4	0	0
23	30918961	.	G	T	4	2	6	0	1	7	0	0
23	30919027	.	T	G	2	3	5	0	0	5	0	0
23	31245593	.	A	T	1	3	4	0	0	4	0	0
23	31248605	.	A	T	3	4	7	0	0	7	0	0
23	31248779	.	T	C	2	3	5	0	0	5	0	0
23	31276396	.	T	A	6	6	12	0	0	12	0	0
23	31276453	.	G	A	1	7	8	0	1	9	0	0
23	31276509	.	C	T	2	6	8	0	0	8	0	0
23	31276657	.	T	C	4	2	6	0	1	7	0	0
23	31278183	.	G	T	3	3	6	0	0	6	0	0
23	31278237	.	C	T	0	4	4	0	1	5	0	0
23	31278322	.	A	G	5	8	13	0	0	13	0	0
23	31278375	.	A	G	12	5	17	0	1	18	0	0
23	31278417	.	G	T	11	4	15	0	0	15	0	0
23	31278450	.	T	A	5	5	10	0	2	12	0	0
23	31279122	.	G	T	3	1	4	0	0	4	0	0
23	31358342	.	A	T	15	21	36	0	0	36	0	0
23	31358344	.	A	T	15	21	36	0	0	36	0	0
23	31358489	.	T	G	21	20	41	0	3	44	0	0
23	31358631	.	G	A	26	31	57	0	0	57	0	0
23	31381068	.	C	T	1	2	3	0	0	3	0	0
23	31381356	.	G	A	1	5	6	0	0	6	0	0
23	31381389	.	T	C	3	2	5	0	0	5	0	0
23	31381392	.	C	T	3	2	5	0	0	5	0	0
23	31381425	.	C	T	3	3	6	0	0	6	0	0
23	31396169	.	C	T	3	3	6	0	1	7	0	0
23	31405519	.	C	T	6	4	10	0	0	10	0	0
23	31405570	.	A	C	6	11	17	0	1	18	0	0
23	31419064	.	C	T	4	1	5	0	0	5	0	0
23	31419172	.	A	T	4	6	10	0	0	10	0	0
23	31422369	.	A	T	8	3	11	0	0	11	0	0
23	31422429	.	C	T	5	2	7	0	0	7	0	0
23	31422768	.	A	G	3	9	12	0	1	13	0	0
23	31423091	.	T	C	6	3	9	0	0	9	0	0
23	31423145	.	G	A	0	6	6	0	5	11	0	0
23	31423392	.	C	A	17	9	26	0	4	30	0	0
23	31423427	.	A	G	17	0	17	0	12	29	0	0
23	31423432	.	C	A	15	11	26	0	1	27	0	0
23	31432102	.	A	G	5	0	5	0	9	14	0	0
23	31596584	.	T	G	3	0	3	0	5	8	0	0
23	31604900	.	C	T	3	6	9	0	0	9	0	0
23	31604912	.	G	T	4	4	8	0	0	8	0	0
23	31640363	.	A	G	4	9	13	0	0	13	0	0
23	31641153	.	C	A	25	18	43	0	3	46	0	0
23	31641197	.	A	G	24	20	44	0	1	45	0	0
23	31641270	.	G	A	14	26	40	0	2	42	0	0
23	31643818	.	A	G	10	13	23	0	1	24	0	0
23	31644368	.	A	G	4	7	11	0	1	12	0	0
23	31644419	.	A	G	1	6	7	0	0	7	0	0
23	31644602	.	T	G	8	9	17	0	2	19	0	0
23	31684244	.	A	G	1	2	3	0	1	4	0	0
23	31684352	.	G	A	16	14	30	0	0	30	0	0
23	31752909	.	A	G	1	2	3	0	1	4	0	0
23	31756210	.	G	A	2	3	5	0	0	5	0	0
23	31756216	.	C	T	0	2	2	0	3	5	0	0
23	31768596	.	T	C	6	7	13	0	2	15	0	0
23	31771282	.	T	C	0	1	1	0	0	1	0	0
23	31774194	.	G	A	4	2	6	0	1	7	0	0
23	31782969	.	T	C	2	0	2	0	0	2	0	0
23	31785175	.	G	A	7	4	11	0	1	12	0	0
23	31785183	.	T	G	5	6	11	0	1	12	0	0
23	31804162	.	A	G	2	2	4	0	1	5	0	0
23	31933739	.	T	G	3	2	5	0	0	5	0	0
23	31940681	.	C	A	4	2	6	0	0	6	0	0
23	31940818	.	C	T	1	2	3	0	0	3	0	0
23	31953501	.	A	G	3	2	5	0	1	6	0	0
23	31953518	.	C	T	0	2	2	0	1	3	0	0
23	31953537	.	A	C	1	3	4	0	0	4	0	0
23	31962648	.	A	T	6	2	8	0	1	9	0	0
23	31962650	.	T	C	6	3	9	0	0	9	0	0
23	31962971	.	T	C	10	7	17	0	0	17	0	0
23	31963226	.	C	T	6	5	11	0	0	11	0	0
23	31964680	.	C	T	3	3	6	0	1	7	0	0
23	31981951	.	A	C	3	2	5	0	0	5	0	0
23	31981972	.	A	G	3	2	5	0	0	5	0	0
23	31982041	.	T	C	1	3	4	0	0	4	0	0
23	31982042	.	C	T	1	3	4	0	0	4	0	0
23	31992522	.	T	C	2	5	7	0	0	7	0	0
23	31992537	.	C	T	2	4	6	0	0	6	0	0
23	31993590	.	C	T	1	1	2	0	0	2	0	0
23	31995113	.	G	A	2	3	5	0	0	5	0	0
23	31997582	.	G	A	1	5	6	0	0	6	0	0
23	31998741	.	A	G	1	1	2	0	1	3	0	0
23	32000336	.	G	C	1	1	2	0	0	2	0	0
23	32003354	.	T	A	7	5	12	0	1	13	0	0
23	32003808	.	T	C	7	3	10	0	0	10	0	0
23	32003820	.	G	T	6	3	9	0	0	9	0	0
23	32007376	.	T	G	4	3	7	0	0	7	0	0
23	32007445	.	T	A	6	3	9	0	1	10	0	0
23	32007520	.	T	C	2	5	7	0	0	7	0	0
23	32007526	.	C	G	2	7	9	0	0	9	0	0
23	32026927	.	T	C	1	2	3	0	1	4	0	0
23	32026978	.	C	T	3	6	9	0	0	9	0	0
23	32026996	.	G	A	0	3	3	0	2	5	0	0
23	32081708	.	C	T	4	6	10	0	1	11	0	0
23	32081717	.	T	C	5	6	11	0	0	11	0	0
23	32085908	.	G	T	0	2	2	0	0	2	0	0
23	32088077	.	T	G	5	4	9	0	0	9	0	0
23	32128893	.	T	C	2	4	6	0	0	6	0	0
23	32129326	.	C	A	2	3	5	0	0	5	0	0
23	32129476	.	G	T	5	3	8	0	0	8	0	0
23	32129514	.	G	T	4	5	9	0	0	9	0	0
23	32151669	.	A	C	10	11	21	0	1	22	0	0
23	32152022	.	C	T	9	16	25	0	0	25	0	0
23	32154021	.	G	T	0	2	2	0	0	2	0	0
23	32155325	.	A	G	1	3	4	0	0	4	0	0
23	32155719	.	C	T	3	5	8	0	0	8	0	0
23	32155720	.	C	T	0	4	4	0	4	8	0	0
23	32155864	.	A	C	3	0	3	0	3	6	0	0
23	32155975	.	C	T	1	3	4	0	0	4	0	0
23	32157787	.	G	T	1	2	3	0	0	3	0	0
23	32200071	.	A	G	6	4	10	0	1	11	0	0
23	32200076	.	T	G	7	4	11	0	0	11	0	0
23	32200114	.	A	C	4	3	7	0	0	7	0	0
23	32200410	.	A	G	1	3	4	0	0	4	0	0
23	32200583	.	C	T	0	3	3	0	2	5	0	0
23	32200979	.	A	G	2	3	5	0	0	5	0	0
23	32201087	.	G	T	4	3	7	0	0	7	0	0
23	32239672	.	G	A	11	2	13	0	0	13	0	0
23	32239688	.	C	A	10	5	15	0	0	15	0	0
23	32239708	.	G	A	9	9	18	0	0	18	0	0
23	32239824	.	G	A	10	12	22	0	0	22	0	0
23	32240258	.	C	T	6	4	10	0	1	11	0	0
23	32240290	.	A	G	3	4	7	0	1	8	0	0
23	32242086	.	C	A	1	2	3	0	0	3	0	0
23	32242251	.	T	C	8	8	16	0	0	16	0	0
23	32248595	.	C	G	0	1	1	0	0	1	0	0
23	32250286	.	C	T	3	2	5	0	0	5	0	0
23	32252805	.	A	G	0	1	1	0	0	1	0	0
23	32309187	.	T	C	10	10	20	0	3	23	0	0
23	32309193	.	G	A	12	9	21	0	0	21	0	0
23	32309323	.	G	A	10	18	28	0	0	28	0	0
23	32309533	.	A	G	10	11	21	0	1	22	0	0
23	32309659	.	C	A	0	8	8	0	14	22	0	0
23	32309709	.	G	A	14	6	20	0	2	22	0	0
23	32309787	.	A	C	7	6	13	0	2	15	0	0
23	32309943	.	A	G	4	2	6	0	1	7	0	0
23	32310148	.	G	T	1	3	4	0	0	4	0	0
23	32310151	.	G	A	1	5	6	0	0	6	0	0
23	32310209	.	C	T	8	7	15	0	0	15	0	0
23	32310349	.	A	G	3	4	7	0	0	7	0	0
23	32310359	.	C	T	0	3	3	0	3	6	0	0
23	32310782	.	T	G	1	3	4	0	0	4	0	0
23	32310808	.	C	T	2	5	7	0	0	7	0	0
23	32310864	.	G	A	5	5	10	0	0	10	0	0
23	32310937	.	C	A	1	2	3	0	6	9	0	0
23	32310943	.	T	C	7	2	9	0	0	9	0	0
23	32311418	.	T	C	9	7	16	0	0	16	0	0
23	32311555	.	G	C	12	14	26	0	0	26	0	0
23	32311612	.	G	A	19	15	34	0	0	34	0	0
23	32318047	.	A	G	12	13	25	0	0	25	0	0
23	32326532	.	A	G	4	7	11	0	0	11	0	0
23	32362317	.	A	G	6	5	11	0	0	11	0	0
23	32589398	.	C	T	3	0	3	0	0	3	0	0
23	32592593	.	C	T	0	3	3	0	1	4	0	0
23	32599214	.	G	T	6	3	9	0	0	9	0	0
23	32621780	.	C	T	0	2	2	0	1	3	0	0
23	32621792	.	G	A	1	1	2	0	0	2	0	0
23	32636209	.	T	C	2	2	4	0	0	4	0	0
23	32636251	.	G	A	5	2	7	0	0	7	0	0
23	32641956	.	C	T	0	1	1	0	0	1	0	0
23	32641959	.	G	A	0	1	1	0	0	1	0	0
23	33357953	.	T	A	8	5	13	0	1	14	0	0
23	33361256	.	C	T	0	2	2	0	5	7	0	0
23	33361310	.	C	T	10	7	17	0	0	17	0	0
23	33447740	.	A	T	1	3	4	0	0	4	0	0
23	33447741	.	T	G	0	2	2	0	2	4	0	0
23	33449656	.	G	T	1	2	3	0	0	3	0	0
23	33633620	.	G	A	2	4	6	0	0	6	0	0
23	33636203	.	C	T	0	1	1	0	0	1	0	0
23	33657205	.	A	G	12	15	27	0	2	29	0	0
23	33657451	.	A	G	11	9	20	0	1	22	1	0
23	33658013	.	T	G	4	7	11	0	2	13	0	0
23	33658031	.	A	C	5	8	13	0	0	13	0	0
23	33658052	.	G	A	7	5	12	0	0	12	0	0
23	33663285	.	C	T	2	3	5	0	1	6	0	0
23	33664546	.	C	T	3	2	5	0	0	5	0	0
23	33678530	.	G	A	3	3	6	0	0	6	0	0
23	34384939	.	C	T	0	1	1	0	0	1	0	0
23	34385149	.	G	T	3	3	6	0	0	6	0	0
23	34427379	.	T	C	1	2	3	0	0	3	0	0
23	34559897	.	C	T	2	1	3	0	0	3	0	0
23	34559971	.	C	T	1	3	4	0	0	4	0	0
23	34641484	.	C	T	1	2	3	0	0	3	0	0
23	34655172	.	G	A	0	1	1	0	1	2	0	0
23	34659533	.	C	T	1	1	2	0	0	2	0	0
23	34678957	.	G	T	1	3	4	0	0	4	0	0
23	34679008	.	A	G	3	6	9	0	0	9	0	0
23	34696631	.	C	T	1	2	3	0	0	3	0	0
23	34726384	.	A	G	2	0	2	0	1	3	0	0
23	34726387	.	A	G	2	3	5	0	0	5	0	0
23	34726438	.	T	C	5	4	9	0	1	10	0	0
23	34726444	.	G	T	5	3	8	0	2	10	0	0
23	34732871	.	A	G	2	0	2	0	3	5	0	0
23	34748833	.	G	A	0	7	7	0	6	13	0	0
23	34753803	.	A	G	5	14	19	0	5	24	0	0
23	35027189	.	T	C	2	3	5	0	0	5	0	0
23	35027386	.	T	G	3	5	8	0	0	8	0	0
23	35027480	.	T	G	6	4	10	0	0	10	0	0
23	35027518	.	T	A	3	8	11	0	0	11	0	0
23	35027541	.	A	G	4	6	10	0	0	10	0	0
23	35027736	.	C	G	2	7	9	0	1	10	0	0
23	35039803	.	C	T	0	5	5	0	0	5	0	0
23	35064271	.	T	G	2	2	4	0	0	4	0	0
23	35188009	.	G	C	2	0	2	0	2	4	0	0
23	35188012	.	T	C	2	2	4	0	0	4	0	0
23	35188562	.	G	A	0	3	3	0	0	3	0	0
23	35192697	.	G	T	1	2	3	0	0	3	0	0
23	35256186	.	G	A	2	6	8	0	0	8	0	0
23	35310779	.	G	A	2	6	8	0	0	8	0	0
23	35362951	.	C	T	3	7	10	0	2	12	0	0
23	35362973	.	G	T	2	5	7	0	2	9	0	0
23	35363024	.	A	T	2	8	10	0	0	10	0	0
23	35363067	.	A	T	5	4	9	0	4	13	0	0
23	35363106	.	G	A	12	12	24	0	1	25	0	0
23	35363111	.	C	G	13	12	25	0	1	26	0	0
23	35363226	.	T	C	13	0	13	0	25	38	0	0
23	35363341	.	A	G	16	11	27	0	1	28	0	0
23	35369733	.	G	A	3	3	6	0	0	6	0	0
23	35389118	.	C	T	1	1	2	0	0	2	0	0
23	35393459	.	A	G	1	3	4	0	0	4	0	0
23	35393473	.	G	T	1	2	3	0	0	3	0	0
23	35396735	.	C	A	3	2	5	0	0	5	0	0
23	35396791	.	C	A	4	2	6	0	0	6	0	0
23	35469006	.	T	A	2	3	5	0	0	5	0	0
23	35469135	.	T	C	3	3	6	0	0	6	0	0
23	35469136	.	G	A	3	3	6	0	0	6	0	0
23	35469479	.	A	G	8	6	14	0	0	14	0	0
23	35469668	.	G	T	10	6	16	0	0	16	0	0
23	35473640	.	A	G	1	1	2	0	1	3	0	0
23	35479987	.	G	A	1	0	1	0	0	1	0	0
23	35537599	.	G	A	11	7	18	0	0	18	0	0
23	35537617	.	G	A	8	8	16	0	0	16	0	0
23	35537693	.	A	C	3	4	7	0	0	7	0	0
23	35642327	.	T	G	6	4	10	0	0	10	0	0
23	35644234	.	C	T	1	0	1	0	0	1	0	0
23	35661380	.	C	T	4	4	8	0	2	10	0	0
23	35661530	.	T	C	4	4	8	0	0	8	0	0
23	35661549	.	A	C	3	4	7	0	0	7	0	0
23	35661572	.	A	C	2	4	6	0	0	6	0	0
23	35661660	.	T	G	2	0	2	0	5	7	0	0
23	35661692	.	C	A	0	3	3	0	0	3	0	0
23	35661723	.	A	C	0	1	1	0	0	1	0	0
23	35663421	.	T	G	5	6	11	0	0	11	0	0
23	35664298	.	A	G	3	4	7	0	0	7	0	0
23	35709839	.	T	C	18	18	36	1	0	37	0	0
23	35710179	.	A	C	20	12	32	0	3	35	0	0
23	35710620	.	A	C	21	22	43	1	2	46	0	0
23	35714883	.	T	C	1	2	3	0	0	3	0	0
23	35727353	.	G	A	1	5	6	0	0	6	0	0
23	35727411	.	C	T	1	4	5	0	0	5	0	0
23	35746290	.	A	G	1	3	4	0	1	5	0	0
23	35771483	.	T	C	4	8	12	0	0	12	0	0
23	35771486	.	T	C	3	9	12	0	0	12	0	0
23	35782311	.	T	C	7	4	11	0	2	13	0	0
23	35787299	.	A	C	1	2	3	0	0	3	0	0
23	35787331	.	T	G	1	2	3	0	0	3	0	0
23	35787449	.	A	G	5	3	8	0	0	8	0	0
23	35787573	.	A	G	2	4	6	0	0	6	0	0
23	35788256	.	G	A	0	3	3	0	0	3	0	0
23	35788328	.	G	A	9	9	18	0	0	18	0	0
23	35788505	.	C	T	1	2	3	0	1	4	0	0
23	35788513	.	G	A	2	3	5	0	0	5	0	0
23	35788775	.	G	A	4	5	9	0	0	9	0	0
23	35798545	.	G	A	6	3	9	0	0	9	0	0
23	35800378	.	T	C	2	0	2	0	7	9	0	0
23	35800550	.	C	T	0	8	8	0	12	20	0	0
23	35800591	.	C	T	11	5	16	0	0	16	0	0
23	35821401	.	C	T	2	3	5	0	0	5	0	0
23	35821403	.	C	T	0	3	3	0	2	5	0	0
23	35821442	.	T	A	1	3	4	0	1	5	0	0
23	35918697	.	A	T	6	4	10	0	1	11	0	0
23	35960683	.	G	A	3	3	6	0	0	6	0	0
23	35963076	.	G	T	0	1	1	0	0	1	0	0
23	35963176	.	T	G	9	9	18	0	2	20	0	0
23	35963316	.	C	T	3	7	10	0	0	10	0	0
23	35963322	.	T	G	3	7	10	0	0	10	0	0
23	35982441	.	A	G	5	9	14	0	0	14	0	0
23	35982533	.	G	A	10	7	17	0	2	19	0	0
23	35982637	.	G	A	9	4	13	0	0	13	0	0
23	35982726	.	C	G	2	4	6	0	0	6	0	0
23	35982755	.	T	C	5	8	13	0	0	13	0	0
23	35983029	.	A	G	10	10	20	0	0	20	0	0
23	35993540	.	T	A	4	3	7	0	0	7	0	0
23	36000704	.	T	C	0	0	0	0	1	1	0	0
23	36132338	.	C	A	3	5	8	0	2	10	0	0
23	36190623	.	A	T	2	4	6	0	0	6	0	0
23	36297367	.	C	T	0	4	4	0	4	8	0	0
23	36297471	.	C	T	9	7	16	0	0	16	0	0
23	36297916	.	C	T	4	6	10	0	1	11	0	0
23	36298320	.	T	A	12	16	28	0	4	32	0	0
23	36298327	.	A	T	17	16	33	0	2	35	0	0
23	36298375	.	T	C	12	21	33	0	1	34	0	0
23	36298719	.	G	A	13	16	29	0	2	31	0	0
23	36301544	.	G	A	15	7	22	0	2	24	0	0
23	36301679	.	A	G	16	10	26	0	0	26	0	0
23	36303266	.	G	C	3	5	8	0	1	9	0	0
23	36306566	.	G	T	0	0	0	0	1	1	0	0
23	36307656	.	A	T	7	24	31	0	5	36	0	0
23	36307779	.	C	T	6	2	8	0	0	8	0	0
23	36307906	.	C	G	3	0	3	0	0	3	0	0
23	36310375	.	C	T	0	2	2	0	0	2	0	0
23	36343467	.	T	C	4	3	7	0	0	7	0	0
23	36353698	.	A	G	13	11	24	0	3	27	0	0
23	36353869	.	C	G	11	12	23	0	0	23	0	0
23	36353876	.	G	T	0	11	11	0	11	22	0	0
23	36353979	.	G	T	0	3	3	0	12	15	0	0
23	36401844	.	A	G	2	4	6	0	0	6	0	0
23	36401986	.	G	C	4	4	8	0	1	9	0	0
23	36402184	.	A	G	3	3	6	0	1	7	0	0
23	36402256	.	A	C	1	2	3	0	1	4	0	0
23	36402274	.	T	C	2	2	4	0	0	4	0	0
23	36404898	.	C	G	1	0	1	0	0	1	0	0
23	36404967	.	A	G	2	1	3	0	0	3	0	0
23	36405429	.	A	G	1	2	3	0	0	3	0	0
23	36443511	.	A	T	3	7	10	0	0	10	0	0
23	36443813	.	C	T	2	2	4	0	0	4	0	0
23	36443865	.	C	A	3	10	13	0	0	13	0	0
23	36444201	.	G	C	9	0	9	0	7	16	0	0
23	36445967	.	C	G	1	4	5	0	0	5	0	0
23	36446023	.	G	A	4	10	14	0	1	15	0	0
23	36446132	.	A	G	2	3	5	0	0	5	0	0
23	36446190	.	A	T	0	4	4	0	2	6	0	0
23	36446258	.	T	C	0	0	0	0	6	6	0	0
23	36487865	.	C	T	5	2	7	0	0	7	0	0
23	36488378	.	G	C	2	4	6	0	0	6	0	0
23	36491169	.	C	G	0	6	6	0	4	10	0	0
23	36497530	.	A	T	4	4	8	0	0	8	0	0
23	36500252	.	G	T	1	2	3	0	0	3	0	0
23	36500273	.	G	A	2	4	6	0	0	6	0	0
23	36604488	.	G	A	2	2	4	0	0	4	0	0
23	36616998	.	C	T	2	2	4	0	1	5	0	0
23	36627793	.	C	T	10	13	23	0	0	23	0	0
23	36627859	.	G	C	3	1	4	0	0	4	0	0
23	36638542	.	G	A	10	7	17	0	1	18	0	0
23	36644423	.	T	G	22	18	40	0	1	41	0	0
23	36644907	.	C	T	18	12	30	0	2	32	0	0
23	36661216	.	T	C	2	2	4	0	0	4	0	0
23	36662174	.	T	G	2	2	4	0	0	4	0	0
23	36662175	.	T	G	2	2	4	0	0	4	0	0
23	36662400	.	A	G	6	3	9	0	0	9	0	0
23	36662449	.	A	C	6	5	11	0	1	12	0	0
23	36662714	.	G	A	1	2	3	0	0	3	0	0
23	36663205	.	A	G	0	5	5	0	0	5	0	0
23	36663346	.	G	A	2	4	6	0	1	7	0	0
23	36663407	.	G	A	4	5	9	0	0	9	0	0
23	36663506	.	C	A	1	5	6	0	4	10	0	0
23	36663512	.	C	T	0	3	3	0	5	8	0	0
23	36679751	.	C	T	18	15	33	0	2	35	0	0
23	36679829	.	G	C	18	0	18	0	16	34	0	0
23	36679874	.	T	C	8	0	8	0	12	20	0	0
23	36681545	.	C	T	0	1	1	0	2	3	0	0
23	36681557	.	A	G	4	2	6	0	0	7	1	0
23	36681927	.	T	C	1	2	3	0	0	3	0	0
23	36683801	.	G	A	12	3	15	0	0	15	0	0
23	36688236	.	T	C	12	0	12	0	13	25	0	0
23	36689677	.	C	T	4	5	9	0	1	10	0	0
23	36690595	.	G	A	6	11	17	0	4	21	0	0
23	36690641	.	T	A	15	16	31	0	4	35	0	0
23	36700836	.	T	G	2	1	3	0	0	3	0	0
23	36700891	.	G	A	12	8	20	0	0	20	0	0
23	36700896	.	T	A	11	7	18	0	2	20	0	0
23	36730854	.	A	T	3	0	3	0	0	3	0	0
23	36738776	.	C	T	0	1	1	0	0	1	0	0
23	36749380	.	G	A	0	26	26	0	25	51	0	0
23	36750005	.	C	G	9	22	31	0	2	33	0	0
23	36753191	.	A	G	1	0	1	0	4	5	0	0
23	36772018	.	G	A	1	11	12	0	10	22	0	0
23	36798184	.	C	T	12	14	26	0	1	27	0	0
23	36798220	.	G	A	16	14	30	0	0	30	0	0
23	36798612	.	G	A	0	15	15	0	11	26	0	0
23	36816573	.	A	G	1	4	5	0	0	5	0	0
23	36816698	.	G	T	5	8	13	0	0	13	0	0
23	36907624	.	G	A	4	4	8	0	0	8	0	0
23	36907690	.	A	G	4	0	4	0	0	4	0	0
23	36910155	.	G	A	1	1	2	0	0	2	0	0
23	36914223	.	A	G	1	1	2	0	0	2	0	0
23	36920076	.	C	G	0	2	2	0	0	2	0	0
23	37075407	.	C	T	1	1	2	0	0	2	0	0
23	37077689	.	A	C	3	1	4	0	0	4	0	0
23	37083054	.	G	T	0	1	1	0	0	1	0	0
23	37086288	.	A	C	6	6	12	0	0	12	0	0
23	37086317	.	G	T	3	2	5	0	1	6	0	0
23	37086368	.	G	A	5	2	7	0	0	7	0	0
23	37089042	.	G	A	4	2	6	0	0	6	0	0
23	37089102	.	G	A	9	7	16	0	0	16	0	0
23	37089162	.	C	T	7	9	16	0	0	16	0	0
23	37089192	.	C	T	8	9	17	0	1	18	0	0
23	37089333	.	C	T	8	4	12	0	1	13	0	0
23	37089568	.	C	T	6	4	10	0	0	10	0	0
23	37089609	.	T	G	5	11	16	0	0	16	0	0
23	37089753	.	A	G	0	3	3	0	0	3	0	0
23	37089852	.	A	T	14	6	20	0	0	20	0	0
23	37090003	.	T	C	5	10	15	0	1	16	0	0
23	37277157	.	A	G	14	6	20	0	2	22	0	0
23	37277289	.	G	A	4	1	5	0	0	5	0	0
23	37280658	.	C	T	5	4	9	0	0	9	0	0
23	37287851	.	T	C	2	3	5	0	1	6	0	0
23	37287919	.	T	A	1	2	3	0	0	3	0	0
23	37288130	.	T	C	1	0	1	0	2	3	0	0
23	37288351	.	G	C	1	3	4	0	0	4	0	0
23	37288362	.	G	C	1	3	4	0	0	4	0	0
23	37324009	.	A	G	8	1	9	0	7	16	0	0
23	37324638	.	A	C	22	14	36	0	1	37	0	0
23	37324848	.	G	A	17	13	30	0	1	31	0	0
23	37324868	.	G	C	15	11	26	0	0	26	0	0
23	37324990	.	A	G	17	16	33	0	3	36	0	0
23	37325026	.	C	T	20	20	40	0	1	41	0	0
23	37325138	.	T	G	16	0	16	0	19	35	0	0
23	37325570	.	A	C	21	18	39	0	1	40	0	0
23	37325817	.	T	G	10	12	22	0	0	22	0	0
23	37458748	.	G	A	5	6	11	0	0	11	0	0
23	37458791	.	A	T	2	0	2	0	0	2	0	0
23	37464452	.	A	G	5	6	11	0	2	13	0	0
23	37464621	.	A	G	3	1	4	0	0	4	0	0
23	37464661	.	T	A	2	1	3	0	0	4	1	0
23	37464760	.	G	C	1	5	6	0	5	11	0	0
23	37464804	.	C	A	4	3	7	0	1	8	0	0
23	37465007	.	T	C	5	6	11	0	0	11	0	0
23	37465257	.	A	G	3	0	3	0	3	6	0	0
23	37465276	.	A	T	6	3	9	0	0	9	0	0
23	37465414	.	G	A	13	7	20	0	0	20	0	0
23	37465479	.	G	C	10	7	17	0	0	17	0	0
23	37465505	.	A	G	8	8	16	0	4	20	0	0
23	37465527	.	A	G	9	9	18	0	0	18	0	0
23	37465584	.	T	C	4	4	8	0	1	9	0	0
23	37467056	.	A	G	5	0	5	0	4	9	0	0
23	37467073	.	A	G	5	3	8	0	1	9	0	0
23	37467109	.	A	G	5	0	5	0	5	10	0	0
23	37467115	.	A	G	4	0	4	0	7	11	0	0
23	37468225	.	T	C	1	2	3	0	0	3	0	0
23	37468267	.	C	T	1	7	8	0	0	8	0	0
23	37476675	.	G	A	0	2	2	0	3	5	0	0
23	37478227	.	G	T	3	0	3	0	0	3	0	0
23	37478506	.	C	G	7	4	11	0	0	11	0	0
23	37479992	.	G	T	26	7	33	0	0	33	0	0
23	37497367	.	A	T	5	3	8	0	0	8	0	0
23	37504803	.	A	G	1	1	2	0	0	2	0	0
23	37505129	.	G	A	1	1	2	0	0	2	0	0
23	37761023	.	C	T	0	1	1	0	0	1	0	0
23	37823782	.	T	C	2	2	4	0	1	5	0	0
23	37823795	.	T	C	3	3	6	0	0	6	0	0
23	37955662	.	G	C	0	3	3	0	3	6	0	0
23	38151520	.	C	T	6	11	17	0	0	17	0	0
23	38262647	.	G	A	2	2	4	0	1	5	0	0
23	38379786	.	C	T	0	13	13	0	12	25	0	0
23	38380005	.	C	T	18	15	33	0	1	34	0	0
23	38380047	.	G	A	15	13	28	0	1	29	0	0
23	38381217	.	C	T	0	8	8	0	11	19	0	0
23	38381281	.	T	C	4	5	9	0	0	9	0	0
23	38381316	.	T	C	4	0	4	0	8	12	0	0
23	38381490	.	G	A	5	5	10	0	0	10	0	0
23	38807624	.	C	T	3	1	4	0	0	4	0	0
23	38810913	.	A	G	1	2	3	0	0	3	0	0
23	38814154	.	T	C	1	1	2	0	0	2	0	0
23	38817350	.	T	G	4	2	6	0	0	6	0	0
23	38817745	.	G	A	2	3	5	0	0	5	0	0
23	38817922	.	T	A	1	3	4	0	0	4	0	0
23	38818001	.	G	A	1	3	4	0	1	5	0	0
23	38818004	.	G	A	1	3	4	0	1	5	0	0
23	38818234	.	A	G	1	0	1	0	8	9	0	0
23	38818351	.	A	G	1	3	4	0	0	4	0	0
23	38818395	.	G	A	0	2	2	0	2	4	0	0
23	38998433	.	G	C	0	1	1	0	0	1	0	0
23	39322043	.	T	C	2	2	4	0	0	4	0	0
23	39332006	.	T	C	1	2	3	0	0	3	0	0
23	39332007	.	G	A	1	2	3	0	0	3	0	0
23	39333284	.	C	T	1	3	4	0	0	4	0	0
23	39333291	.	T	C	1	3	4	0	0	4	0	0
23	39413176	.	C	T	2	1	3	0	0	3	0	0
23	39413341	.	A	C	4	2	6	0	0	6	0	0
23	39440432	.	A	C	2	2	4	0	1	5	0	0
23	39448012	.	A	G	1	0	1	0	1	2	0	0
23	39449770	.	C	G	2	1	3	0	0	3	0	0
23	39450022	.	A	G	4	3	7	0	0	7	0	0
23	39516525	.	T	C	2	3	5	0	0	5	0	0
23	39516528	.	T	C	3	3	6	0	0	6	0	0
23	39516572	.	C	A	3	4	7	0	0	7	0	0
23	39516810	.	T	A	5	3	8	0	1	9	0	0
23	39587272	.	T	C	0	2	2	0	0	2	0	0
23	39587284	.	G	C	2	1	3	0	0	3	0	0
23	39587323	.	A	G	1	1	2	0	1	3	0	0
23	39587347	.	G	T	0	2	2	0	0	2	0	0
23	39591674	.	C	T	3	3	6	0	0	6	0	0
23	39594141	.	C	T	1	3	4	0	0	4	0	0
23	39594211	.	A	G	2	0	2	0	6	8	0	0
23	39594962	.	C	T	1	3	4	0	0	4	0	0
23	39594993	.	A	G	4	0	4	0	5	9	0	0
23	39595026	.	A	G	5	4	9	0	1	10	0	0
23	39595044	.	C	T	3	2	5	0	1	6	0	0
23	39595159	.	G	A	0	2	2	0	4	6	0	0
23	39595248	.	T	G	3	2	5	0	0	5	0	0
23	39595297	.	G	T	4	6	10	0	0	10	0	0
23	39595974	.	C	T	5	11	16	0	0	16	0	0
23	39596776	.	T	C	3	3	6	0	0	6	0	0
23	39596919	.	G	A	0	3	3	0	4	7	0	0
23	39597119	.	G	T	7	8	15	0	0	15	0	0
23	39597309	.	G	A	1	7	8	0	10	18	0	0
23	39597566	.	T	C	6	2	8	0	0	8	0	0
23	39597657	.	A	T	2	8	10	0	0	10	0	0
23	39615660	.	C	T	1	0	1	0	0	1	0	0
23	39615689	.	G	C	2	4	6	0	0	6	0	0
23	39615706	.	C	A	2	3	5	0	1	6	0	0
23	39623042	.	G	A	0	4	4	0	7	11	0	0
23	39626230	.	G	C	6	5	11	0	0	11	0	0
23	39626311	.	C	T	5	10	15	0	0	15	0	0
23	39626525	.	G	A	7	5	12	0	0	12	0	0
23	39632901	.	A	G	3	5	8	0	0	8	0	0
23	39633114	.	C	T	0	3	3	0	6	9	0	0
23	39633412	.	C	G	1	2	3	0	0	3	0	0
23	39635959	.	C	T	0	0	0	0	1	1	0	0
23	39636079	.	G	T	12	3	15	0	0	15	0	0
23	39636181	.	C	T	0	2	2	0	1	3	0	0
23	39638480	.	A	G	3	2	5	0	0	5	0	0
23	39641840	.	G	A	0	0	0	0	1	1	0	0
23	39641909	.	C	T	4	2	6	0	0	6	0	0
23	39642002	.	C	T	0	2	2	0	2	4	0	0
23	39649499	.	C	A	2	3	5	0	0	5	0	0
23	39649607	.	C	T	2	2	4	0	0	4	0	0
23	39666375	.	A	T	1	2	3	0	0	3	0	0
23	39737147	.	G	C	0	1	1	0	0	1	0	0
23	39744501	.	A	G	8	4	12	0	0	12	0	0
23	39744788	.	T	A	11	0	11	0	0	11	0	0
23	39744943	.	A	T	15	9	24	0	0	24	0	0
23	39756650	.	G	A	1	1	2	0	0	2	0	0
23	39756666	.	A	G	4	3	7	0	0	7	0	0
23	39756775	.	T	G	7	8	15	0	3	19	1	0
23	39756864	.	T	C	9	14	23	2	0	25	0	0
23	39756893	.	T	A	6	10	16	2	0	18	0	0
23	39756917	.	C	A	6	9	15	1	2	18	0	0
23	39756958	.	A	G	9	7	16	0	0	16	0	0
23	39757017	.	A	G	8	2	10	0	0	10	0	0
23	39757562	.	T	C	1	3	4	0	0	4	0	0
23	39758587	.	G	A	9	4	13	0	0	13	0	0
23	39758678	.	G	A	1	2	3	0	1	4	0	0
23	39758689	.	T	C	1	3	4	0	0	4	0	0
23	39759088	.	C	A	0	3	3	0	2	5	0	0
23	39759290	.	A	C	2	5	7	0	0	7	0	0
23	39759344	.	A	C	3	0	3	0	5	8	0	0
23	39759355	.	T	C	2	0	2	0	7	9	0	0
23	39759400	.	T	C	5	0	5	0	7	12	0	0
23	39764804	.	G	A	0	1	1	0	0	1	0	0
23	39765105	.	G	A	2	1	3	0	0	3	0	0
23	39767894	.	A	G	7	16	23	0	1	24	0	0
23	39768001	.	T	G	5	5	10	0	0	10	0	0
23	39771935	.	C	T	2	4	6	0	0	6	0	0
23	39771972	.	A	T	5	8	13	0	1	14	0	0
23	39772002	.	C	T	6	8	14	0	0	14	0	0
23	39772035	.	G	A	4	3	7	0	0	7	0	0
23	39808332	.	G	A	14	6	20	0	0	20	0	0
23	39808337	.	G	C	13	8	21	1	0	22	0	0
23	39808439	.	A	G	23	21	44	0	1	45	0	0
23	39808644	.	A	C	16	13	29	0	1	30	0	0
23	39808705	.	A	G	12	11	23	0	2	25	0	0
23	39809437	.	A	G	4	7	11	0	0	11	0	0
23	39809454	.	T	G	1	3	4	0	0	4	0	0
23	39809876	.	C	T	0	2	2	1	9	12	0	0
23	39810625	.	T	A	12	7	19	6	1	26	0	0
23	39811187	.	C	T	0	6	6	0	13	19	0	0
23	39811191	.	C	A	11	6	17	0	0	18	1	0
23	39811242	.	T	C	11	8	19	0	0	19	0	0
23	39811324	.	A	G	6	10	16	0	1	17	0	0
23	39811401	.	T	C	6	7	13	0	0	13	0	0
23	39811548	.	A	G	4	6	10	0	0	10	0	0
23	39811587	.	G	A	2	2	4	0	0	4	0	0
23	39811647	.	C	G	5	4	9	0	0	9	0	0
23	39811741	.	G	A	7	10	17	0	0	17	0	0
23	39811956	.	T	A	5	4	9	0	2	11	0	0
23	39812003	.	A	G	6	6	12	0	0	12	0	0
23	39812131	.	T	C	11	10	21	0	1	22	0	0
23	39812142	.	C	G	6	10	16	0	2	18	0	0
23	39812482	.	G	A	5	6	11	0	1	12	0	0
23	39812535	.	T	C	12	9	21	0	1	22	0	0
23	39812608	.	C	T	1	14	15	0	11	26	0	0
23	39812633	.	A	T	8	16	24	0	4	28	0	0
23	39812643	.	C	T	1	16	17	0	14	31	0	0
23	39901454	.	T	C	3	2	5	0	1	6	0	0
23	39924005	.	G	C	9	3	12	0	0	12	0	0
23	39926437	.	T	C	2	4	6	0	0	6	0	0
23	39929955	.	G	A	4	4	8	0	0	8	0	0
23	39936352	.	A	G	1	0	1	0	2	3	0	0
23	39940362	.	A	G	3	2	5	0	1	6	0	0
23	39940371	.	T	C	2	5	7	0	0	7	0	0
23	39940421	.	G	T	1	3	4	0	0	4	0	0
23	39940575	.	G	C	1	5	6	0	0	6	0	0
23	39940577	.	G	A	1	4	5	0	1	6	0	0
23	40285845	.	A	T	2	3	5	0	0	5	0	0
23	40526760	.	G	A	3	8	11	0	0	11	0	0
23	40526953	.	T	C	2	3	5	0	0	5	0	0
23	40527608	.	T	C	6	2	8	0	0	8	0	0
23	40527632	.	G	A	1	6	7	0	0	7	0	0
23	42275411	.	A	T	1	4	5	0	1	6	0	0
23	42289260	.	C	A	1	1	2	0	0	2	0	0
23	42330090	.	C	G	4	2	6	0	0	6	0	0
23	42330330	.	T	A	3	1	4	0	1	5	0	0
23	42330334	.	G	T	3	2	5	0	0	5	0	0
23	42639730	.	G	T	1	2	3	0	0	3	0	0
23	42640138	.	T	G	4	2	6	0	0	6	0	0
23	42641879	.	T	C	6	6	12	0	0	12	0	0
23	42641921	.	T	C	7	6	13	0	0	13	0	0
23	42642044	.	G	A	12	6	18	0	0	18	0	0
23	42642253	.	C	T	11	5	16	0	1	17	0	0
23	42642361	.	G	A	7	3	10	0	4	14	0	0
23	42642435	.	A	G	12	0	12	4	9	25	0	0
23	42642593	.	T	G	5	3	8	0	0	8	0	0
23	42642623	.	C	A	3	5	8	0	1	9	0	0
23	42642629	.	T	G	3	5	8	0	0	8	0	0
23	42642672	.	T	C	4	3	7	0	2	9	0	0
23	42642673	.	G	A	5	3	8	0	1	9	0	0
23	42642780	.	G	T	5	2	7	0	0	7	0	0
23	42766607	.	G	A	3	2	5	0	0	5	0	0
23	42766609	.	A	T	3	2	5	0	0	5	0	0
23	42766656	.	A	G	2	2	4	0	0	4	0	0
23	42766672	.	C	T	0	2	2	0	2	4	0	0
23	43499036	.	C	G	1	2	3	0	0	3	0	0
23	43508198	.	A	G	2	0	2	0	2	4	0	0
23	43517458	.	A	G	0	3	3	0	0	3	0	0
23	43519409	.	G	A	3	1	4	0	0	4	0	0
23	43519414	.	G	A	3	2	5	0	0	5	0	0
23	43535874	.	G	A	1	1	2	0	0	2	0	0
23	43540359	.	G	C	2	2	4	0	0	4	0	0
23	43649431	.	T	C	2	2	4	0	0	4	0	0
23	43652261	.	A	G	5	3	8	0	0	8	0	0
23	43652819	.	T	C	3	2	5	0	0	5	0	0
23	43652912	.	G	T	1	5	6	0	0	6	0	0
23	43688361	.	A	T	0	2	2	0	1	3	0	0
23	43688364	.	A	T	1	2	3	0	0	3	0	0
23	43689026	.	A	T	1	2	3	0	2	5	0	0
23	43689034	.	C	G	0	4	4	0	0	4	0	0
23	43689202	.	T	C	1	2	3	0	0	3	0	0
23	43689675	.	T	C	1	2	3	0	0	3	0	0
23	43690394	.	A	G	2	2	4	0	0	4	0	0
23	43690715	.	T	C	3	4	7	0	0	7	0	0
23	43690762	.	C	A	3	2	5	0	0	5	0	0
23	43691117	.	T	G	2	4	6	0	0	6	0	0
23	43691595	.	A	G	2	4	6	0	0	6	0	0
23	43691992	.	T	C	2	4	6	0	0	6	0	0
23	43695927	.	C	A	0	5	5	0	9	14	0	0
23	43696095	.	G	A	11	21	32	0	1	33	0	0
23	43696211	.	G	T	24	18	42	0	3	45	0	0
23	43696355	.	G	A	7	23	30	0	1	31	0	0
23	43699846	.	A	G	12	10	22	0	1	23	0	0
23	43700064	.	T	C	6	0	6	0	14	20	0	0
23	43700114	.	G	A	6	8	14	0	0	14	0	0
23	43700121	.	G	A	6	6	12	0	0	12	0	0
23	43705961	.	G	T	7	11	18	0	0	18	0	0
23	43706003	.	A	G	14	18	32	0	1	33	0	0
23	43706102	.	T	G	9	9	18	0	0	18	0	0
23	43713602	.	A	G	1	3	4	0	0	4	0	0
23	43713692	.	T	A	5	4	9	0	0	9	0	0
23	43718169	.	T	A	7	4	11	0	0	11	0	0
23	43718185	.	T	A	7	4	11	0	0	11	0	0
23	43718225	.	G	A	0	5	5	0	1	6	0	0
23	43718257	.	G	T	0	2	2	0	0	2	0	0
23	43718947	.	A	G	3	2	5	0	0	5	0	0
23	43723615	.	G	A	0	1	1	0	0	1	0	0
23	43723633	.	C	T	0	4	4	0	0	4	0	0
23	43723765	.	C	T	2	5	7	0	1	8	0	0
23	43770210	.	C	T	2	10	12	0	0	12	0	0
23	43770240	.	A	C	2	11	13	0	1	14	0	0
23	43770279	.	A	T	4	4	8	0	0	8	0	0
23	43770360	.	A	T	3	3	6	0	1	7	0	0
23	43770414	.	T	C	8	7	15	0	0	15	0	0
23	43770433	.	T	C	7	6	13	0	0	13	0	0
23	43770467	.	T	C	6	7	13	0	0	13	0	0
23	43770583	.	C	A	10	11	21	0	0	21	0	0
23	43770634	.	G	C	11	10	21	0	2	23	0	0
23	43770832	.	T	C	5	3	8	0	0	8	0	0
23	43780214	.	C	T	1	5	6	0	1	7	0	0
23	43781781	.	C	T	2	5	7	0	0	7	0	0
23	43799463	.	T	C	2	3	5	0	0	5	0	0
23	43799542	.	G	C	1	3	4	0	0	4	0	0
23	43799598	.	G	C	0	5	5	0	1	6	0	0
23	43800723	.	G	A	0	3	3	0	2	5	0	0
23	43800747	.	A	C	1	4	5	0	0	5	0	0
23	43800912	.	C	T	1	2	3	0	0	3	0	0
23	43800983	.	G	A	2	2	4	0	0	4	0	0
23	43801018	.	A	G	1	0	1	0	3	4	0	0
23	43801090	.	A	C	3	3	6	0	0	6	0	0
23	43802049	.	C	T	1	4	5	0	0	5	0	0
23	43802158	.	A	T	2	3	5	0	0	5	0	0
23	43802301	.	A	C	3	3	6	0	0	6	0	0
23	43829043	.	G	A	1	2	3	0	0	3	0	0
23	43830324	.	A	G	2	3	5	0	0	5	0	0
23	43876103	.	C	A	4	2	6	0	2	8	0	0
23	43876109	.	T	A	4	3	7	0	1	8	0	0
23	43898075	.	C	T	0	1	1	0	0	1	0	0
23	43898097	.	A	C	1	3	4	0	0	4	0	0
23	44521330	.	A	G	4	9	13	0	0	13	0	0
23	44603807	.	A	C	9	1	10	0	19	29	0	0
23	45423324	.	G	T	6	5	11	0	2	13	0	0
23	45515555	.	C	G	3	5	8	0	1	9	0	0
23	45515570	.	C	G	2	1	3	0	3	6	0	0
23	45516336	.	C	T	3	7	10	0	0	10	0	0
23	45516804	.	T	A	2	1	3	0	0	3	0	0
23	45516867	.	C	G	2	1	3	0	0	3	0	0
23	45521246	.	G	C	6	4	10	0	2	12	0	0
23	45521285	.	G	C	6	4	10	0	0	10	0	0
23	45521293	.	C	A	5	3	8	0	0	8	0	0
23	45521328	.	G	A	2	4	6	0	0	6	0	0
23	45521331	.	A	T	3	3	6	0	0	6	0	0
23	45521385	.	T	G	9	3	12	0	0	12	0	0
23	45521492	.	G	A	7	3	10	0	0	10	0	0
23	45521557	.	A	G	4	4	8	0	0	8	0	0
23	45521775	.	C	T	6	6	12	0	0	12	0	0
23	45521811	.	A	G	11	7	18	0	0	18	0	0
23	45521816	.	T	A	11	8	19	0	0	19	0	0
23	45521853	.	G	A	6	11	17	0	4	21	0	0
23	45521857	.	G	A	8	12	20	0	1	21	0	0
23	45521942	.	A	G	12	10	22	0	0	22	0	0
23	45521995	.	G	A	9	3	12	0	0	12	0	0
23	45522046	.	G	A	7	7	14	0	2	16	0	0
23	45522080	.	G	T	8	6	14	0	1	15	0	0
23	45522102	.	A	G	8	3	11	0	0	11	0	0
23	45522166	.	T	G	6	13	19	0	0	19	0	0
23	45522170	.	T	G	5	15	20	0	0	20	0	0
23	45522238	.	A	G	10	21	31	0	0	31	0	0
23	45522434	.	G	A	8	10	18	0	1	19	0	0
23	45523295	.	C	T	10	4	14	0	0	14	0	0
23	45523409	.	T	C	13	15	28	0	1	29	0	0
23	45523562	.	A	G	3	0	3	0	11	14	0	0
23	45523619	.	C	T	5	10	15	0	0	15	0	0
23	45523669	.	A	T	5	8	13	0	0	13	0	0
23	45547600	.	A	C	4	11	15	0	0	15	0	0
23	45547807	.	A	G	3	0	3	0	8	11	0	0
23	45547902	.	C	T	11	8	19	0	1	20	0	0
23	45548034	.	G	C	4	3	7	0	0	7	0	0
23	45548140	.	G	A	8	10	18	0	0	18	0	0
23	45548325	.	A	G	7	2	9	0	0	9	0	0
23	45548355	.	A	G	3	6	9	0	3	12	0	0
23	45548641	.	A	C	6	4	10	0	0	10	0	0
23	45579547	.	A	G	11	14	25	0	2	27	0	0
23	45579629	.	A	C	12	17	29	0	1	30	0	0
23	45580052	.	C	T	10	13	23	0	1	24	0	0
23	45580442	.	C	T	16	15	31	0	1	32	0	0
23	45580508	.	C	T	24	15	39	0	2	41	0	0
23	45580562	.	C	T	19	24	43	0	0	43	0	0
23	45581181	.	C	T	16	9	25	0	1	26	0	0
23	45586744	.	C	A	2	2	4	0	0	4	0	0
23	45586979	.	G	A	4	5	9	0	0	9	0	0
23	45587030	.	G	C	2	3	5	0	0	5	0	0
23	45587246	.	T	C	1	2	3	0	0	3	0	0
23	45587389	.	A	G	3	2	5	0	0	5	0	0
23	45587537	.	T	A	4	2	6	0	0	6	0	0
23	45587552	.	A	G	3	2	5	0	0	5	0	0
23	45587732	.	T	C	2	3	5	0	0	5	0	0
23	45588412	.	G	A	0	2	2	0	4	6	0	0
23	45588595	.	T	C	5	5	10	0	0	10	0	0
23	45591606	.	A	G	6	0	6	0	2	8	0	0
23	45591639	.	A	G	10	5	15	0	0	15	0	0
23	45595151	.	C	T	1	3	4	0	0	4	0	0
23	45595178	.	C	T	3	3	6	0	0	6	0	0
23	45622106	.	G	A	4	2	6	0	0	6	0	0
23	46208578	.	T	G	15	15	30	0	1	32	1	0
23	46208611	.	T	G	19	17	36	0	1	38	1	0
23	46208718	.	G	A	26	17	43	0	4	47	0	0
23	46217045	.	C	A	2	3	5	0	1	6	0	0
24	24470	.	T	C	2	3	5	0	0	5	0	0
24	24473	.	C	T	2	3	5	0	0	5	0	0
24	44306	.	C	T	5	2	7	0	0	7	0	0
24	91430	.	A	G	2	0	2	0	4	6	0	0
24	139014	.	A	G	2	0	2	0	2	4	0	0
24	166969	.	T	G	3	7	10	0	0	10	0	0
24	167149	.	A	T	5	9	14	0	2	16	0	0
24	167177	.	A	G	1	2	3	0	0	3	0	0
24	174353	.	A	G	5	0	5	0	8	13	0	0
24	178693	.	G	A	4	9	13	0	0	13	0	0
24	184800	.	A	G	15	0	15	0	11	26	0	0
24	184818	.	C	T	13	5	18	0	1	19	0	0
24	187371	.	T	A	9	13	22	0	1	23	0	0
24	187414	.	T	A	9	7	16	0	0	16	0	0
24	187497	.	G	T	2	10	12	0	0	12	0	0
24	187686	.	T	A	7	14	21	0	1	22	0	0
24	187757	.	A	G	13	4	17	0	0	17	0	0
24	187787	.	C	T	9	7	16	0	1	17	0	0
24	187811	.	A	T	9	6	15	0	0	15	0	0
24	187960	.	A	G	8	5	13	0	0	13	0	0
24	188155	.	C	G	9	6	15	0	0	15	0	0
24	188363	.	G	A	10	14	24	0	2	26	0	0
24	188382	.	G	A	1	17	18	0	11	29	0	0
24	188423	.	T	C	8	14	22	0	0	22	0	0
24	188425	.	A	T	8	14	22	0	0	22	0	0
24	188464	.	T	C	12	25	37	0	0	37	0	0
24	196679	.	G	A	1	7	8	0	1	9	0	0
24	197062	.	C	T	2	0	2	0	0	2	0	0
24	197072	.	C	T	0	0	0	0	1	1	0	0
24	787348	.	A	G	1	2	3	0	0	3	0	0
24	787354	.	A	G	1	2	3	0	0	3	0	0
24	788327	.	A	G	1	7	8	0	0	8	0	0
24	788343	.	A	G	7	3	10	0	0	10	0	0
24	945478	.	C	T	0	1	1	0	3	4	0	0
24	945706	.	T	C	14	12	26	0	1	27	0	0
24	947503	.	G	C	5	4	9	0	0	9	0	0
24	947518	.	C	T	1	7	8	0	2	10	0	0
24	947611	.	C	T	0	7	7	0	3	10	0	0
24	947680	.	T	C	7	1	8	0	10	18	0	0
24	947850	.	A	T	6	2	8	0	0	8	0	0
24	947957	.	C	A	6	7	13	0	4	17	0	0
24	947984	.	G	C	10	12	22	0	1	23	0	0
24	948080	.	A	G	9	2	11	0	0	11	0	0
24	948313	.	C	A	2	4	6	0	1	7	0	0
24	948360	.	A	G	5	5	10	0	4	14	0	0
24	948438	.	T	C	6	4	10	0	5	15	0	0
24	948466	.	C	G	3	8	11	0	2	13	0	0
24	948503	.	C	T	4	5	9	0	3	12	0	0
24	948565	.	T	C	8	4	12	0	3	15	0	0
24	948571	.	G	A	8	5	13	0	1	14	0	0
24	948806	.	G	A	9	9	18	0	2	20	0	0
24	948848	.	C	T	0	8	8	0	7	15	0	0
24	948868	.	T	C	7	9	16	0	0	16	0	0
24	985094	.	A	T	9	6	15	0	3	18	0	0
24	985740	.	C	G	6	10	16	0	0	16	0	0
24	988373	.	A	C	8	0	8	0	5	13	0	0
24	1000112	.	G	A	5	10	15	0	1	16	0	0
24	1002664	.	T	C	4	5	9	0	1	10	0	0
24	1002757	.	T	C	0	2	2	0	0	2	0	0
24	1003494	.	C	T	0	9	9	0	9	18	0	0
24	1003551	.	C	A	0	8	8	0	9	17	0	0
24	1009078	.	A	G	4	5	9	0	0	9	0	0
24	1009381	.	C	A	0	2	2	0	3	5	0	0
24	1009978	.	A	C	2	0	2	0	4	6	0	0
24	1011439	.	T	C	2	4	6	0	0	6	0	0
24	1012101	.	A	T	1	2	3	0	0	3	0	0
24	1012613	.	C	G	4	3	7	1	0	8	0	0
24	1013105	.	T	G	6	3	9	0	0	9	0	0
24	1013106	.	G	T	6	3	9	0	0	9	0	0
24	1013290	.	G	C	5	3	8	0	0	8	0	0
24	1013303	.	G	A	4	3	7	0	1	8	0	0
24	1013359	.	G	C	3	4	7	0	0	7	0	0
24	1013375	.	A	T	4	3	7	0	0	7	0	0
24	1013531	.	G	A	1	2	3	0	0	3	0	0
24	1014681	.	T	A	0	3	3	0	0	3	0	0
24	1015029	.	C	T	1	2	3	0	6	9	0	0
24	1015292	.	T	C	19	1	20	0	13	33	0	0
24	1018672	.	T	C	7	0	7	0	8	15	0	0
24	1110150	.	T	C	2	6	8	0	1	9	0	0
24	1110152	.	T	A	2	7	9	0	0	9	0	0
24	1110227	.	G	A	5	3	8	0	1	9	0	0
24	1110325	.	C	A	7	5	12	0	0	12	0	0
24	1110492	.	C	T	2	3	5	0	0	5	0	0
24	1110512	.	C	T	1	2	3	0	2	5	0	0
24	1110527	.	C	T	3	1	4	0	0	4	0	0
24	1110595	.	G	C	3	3	6	0	0	6	0	0
24	1110601	.	G	A	3	3	6	0	1	7	0	0
24	1110748	.	T	C	1	2	3	0	0	3	0	0
24	1110951	.	A	T	1	1	2	0	0	2	0	0
24	1110958	.	T	C	1	1	2	0	2	4	0	0
24	1111076	.	G	A	4	3	7	0	0	7	0	0
24	1111453	.	T	A	1	4	5	0	0	5	0	0
24	1111469	.	C	T	0	5	5	0	3	8	0	0
24	1111571	.	T	A	2	4	6	0	0	6	0	0
24	1111572	.	G	T	2	4	6	0	0	6	0	0
24	1111818	.	G	A	1	2	3	0	0	3	0	0
24	1111857	.	C	T	1	2	3	0	1	4	0	0
24	1111905	.	C	A	2	3	5	0	0	5	0	0
24	1111910	.	T	C	2	3	5	0	0	5	0	0
24	1112087	.	T	G	2	3	5	0	0	5	0	0
24	1112337	.	A	G	1	1	2	0	1	3	0	0
24	1112433	.	A	G	1	1	2	0	0	2	0	0
24	1112452	.	T	G	1	4	5	0	0	5	0	0
24	1112547	.	C	G	0	4	4	0	1	5	0	0
24	1112909	.	C	G	1	3	4	0	0	4	0	0
24	1163061	.	G	A	15	15	30	0	2	32	0	0
24	1166957	.	G	A	2	5	7	0	0	7	0	0
24	1166975	.	T	C	0	1	1	0	0	1	0	0
24	1167496	.	G	A	4	6	10	0	0	10	0	0
24	1167506	.	G	A	3	5	8	0	0	8	0	0
24	1169291	.	C	T	0	7	7	0	14	22	1	0
24	1177074	.	T	A	5	4	9	0	0	9	0	0
24	1185142	.	G	A	1	2	3	0	0	3	0	0
24	1185271	.	G	A	13	5	18	0	1	19	0	0
24	1203471	.	A	T	5	2	7	0	0	7	0	0
24	1203573	.	A	G	3	1	4	0	0	4	0	0
24	1221280	.	C	T	0	9	9	0	0	9	0	0
24	1229646	.	G	C	8	0	8	0	10	18	0	0
24	1229683	.	G	C	5	4	9	0	1	10	0	0
24	1236358	.	A	G	13	6	19	0	0	19	0	0
24	1301258	.	C	T	0	1	1	0	0	1	0	0
24	1303892	.	A	G	9	7	16	0	0	16	0	0
24	1627938	.	A	G	1	2	3	0	0	3	0	0
24	2284456	.	A	T	13	12	25	0	3	28	0	0
24	2284526	.	T	C	10	0	10	0	10	20	0	0
24	2284647	.	C	T	0	11	11	0	6	17	0	0
24	2290232	.	T	C	2	0	2	0	4	6	0	0
24	2297093	.	T	A	3	1	4	0	0	4	0	0
24	2297117	.	A	G	4	3	7	0	0	7	0	0
24	2303784	.	C	T	0	3	3	0	0	3	0	0
24	2307342	.	C	T	3	2	5	0	0	5	0	0
24	2322475	.	T	C	1	0	1	0	0	1	0	0
24	2327295	.	T	C	1	1	2	0	0	2	0	0
24	2327935	.	T	C	4	3	7	0	0	7	0	0
24	2333841	.	T	C	4	2	6	0	0	6	0	0
24	2340671	.	A	T	7	3	10	0	0	10	0	0
24	2346758	.	A	G	2	2	4	0	0	4	0	0
24	2346825	.	A	T	4	3	7	0	0	7	0	0
24	2346826	.	A	T	4	2	6	0	1	7	0	0
24	2346976	.	A	G	1	2	3	0	0	3	0	0
24	2346989	.	G	T	1	2	3	0	0	3	0	0
24	2349409	.	C	G	0	2	2	0	1	3	0	0
24	3470169	.	T	C	5	4	9	0	2	11	0	0
24	3470195	.	T	C	11	2	13	0	0	13	0	0
24	3470405	.	T	C	5	4	9	0	0	9	0	0
24	3470415	.	T	C	5	3	8	0	1	9	0	0
24	3470608	.	T	C	2	3	5	0	0	5	0	0
24	3471276	.	T	C	6	3	9	0	1	10	0	0
24	3471477	.	T	C	3	2	5	0	1	6	0	0
24	5653468	.	C	T	3	4	7	0	0	7	0	0
24	7516089	.	A	G	1	0	1	0	2	3	0	0
24	7942865	.	T	C	7	0	7	0	2	9	0	0
24	8906130	.	A	T	0	1	1	0	0	1	0	0
24	8979615	.	C	G	5	5	10	0	0	10	0	0
24	8979618	.	G	A	5	5	10	0	1	11	0	0
24	8979708	.	C	T	0	7	7	0	11	18	0	0
24	8979917	.	G	A	12	6	18	0	0	18	0	0
24	8979937	.	G	A	10	4	14	0	0	14	0	0
24	8980122	.	G	A	1	4	5	0	0	5	0	0
24	8988945	.	G	C	0	0	0	0	1	1	0	0
24	8999699	.	T	A	1	0	1	0	0	1	0	0
24	9001888	.	T	C	3	0	3	0	4	7	0	0
24	9162589	.	T	C	2	2	4	0	0	4	0	0
24	9260530	.	A	G	1	1	2	0	3	5	0	0
24	9267967	.	A	T	2	4	6	0	0	6	0	0
24	9288889	.	G	T	17	6	23	0	2	25	0	0
24	9293831	.	A	G	9	11	20	0	0	20	0	0
24	9298592	.	G	A	0	2	2	0	2	4	0	0
24	9298623	.	C	T	1	3	4	0	0	4	0	0
24	9299542	.	G	A	1	2	3	0	0	3	0	0
24	9518441	.	A	G	1	0	1	0	2	3	0	0
24	9518447	.	T	C	1	2	3	0	0	3	0	0
24	9518522	.	T	C	2	2	4	0	0	4	0	0
24	9525632	.	C	T	1	0	1	0	0	1	0	0
24	9543304	.	A	C	1	3	4	0	0	4	0	0
24	9543447	.	C	T	3	4	7	0	0	7	0	0
24	9555554	.	G	A	1	0	1	0	0	1	0	0
24	9566928	.	A	G	2	4	6	0	1	7	0	0
24	9573220	.	G	A	1	2	3	0	0	3	0	0
24	9576154	.	A	T	3	2	5	0	0	5	0	0
24	9594999	.	T	C	7	8	15	0	2	17	0	0
24	9596241	.	C	T	5	2	7	0	0	7	0	0
24	9596366	.	T	A	5	2	7	0	0	7	0	0
24	9676147	.	T	A	8	8	16	0	0	16	0	0
24	9676204	.	C	A	5	3	8	0	0	8	0	0
24	9678514	.	A	T	7	11	18	0	3	22	1	0
24	9683072	.	G	A	11	3	14	0	0	14	0	0
24	9689613	.	G	T	3	2	5	0	0	5	0	0
24	9689709	.	G	T	6	5	11	0	0	11	0	0
24	9689758	.	T	C	3	0	3	0	4	7	0	0
24	9708555	.	G	A	0	1	1	0	1	2	0	0
24	9708580	.	C	T	1	3	4	0	0	4	0	0
24	9714043	.	A	C	1	2	3	0	0	3	0	0
24	9714049	.	G	T	1	2	3	0	0	3	0	0
24	9714423	.	T	C	1	2	3	0	0	3	0	0
24	9714585	.	G	A	0	0	0	0	1	1	0	0
24	9721103	.	A	C	1	2	3	0	0	3	0	0
24	9723276	.	C	G	1	0	1	0	1	2	0	0
24	9725084	.	C	G	6	5	11	0	0	11	0	0
24	9726828	.	C	G	1	4	5	0	0	5	0	0
24	9729966	.	A	T	1	1	2	0	0	2	0	0
24	9730134	.	G	A	2	3	5	0	0	5	0	0
24	9746370	.	T	A	4	2	6	0	0	6	0	0
24	9865836	.	G	A	1	8	9	0	5	14	0	0
24	9866192	.	A	T	8	7	15	0	0	15	0	0
24	9866270	.	G	A	9	4	13	0	0	13	0	0
24	9866562	.	A	T	7	4	11	0	0	11	0	0
24	9866623	.	G	T	14	6	20	0	1	21	0	0
24	9866721	.	C	T	4	5	9	0	0	9	0	0
24	9867105	.	T	A	6	11	17	0	2	19	0	0
24	10303168	.	C	T	6	3	9	0	0	9	0	0
24	10309119	.	G	C	0	4	4	0	5	9	0	0
24	10309244	.	G	A	7	2	9	0	0	9	0	0
24	10309382	.	T	C	4	2	6	0	0	6	0	0
24	10309611	.	G	T	2	2	4	0	0	4	0	0
24	10309719	.	A	T	1	3	4	0	0	4	0	0
24	10319400	.	T	C	1	2	3	0	0	3	0	0
24	10323570	.	T	C	0	1	1	0	0	1	0	0
24	10344333	.	C	G	3	1	4	0	0	4	0	0
24	10349671	.	C	T	2	4	6	0	0	6	0	0
24	10349783	.	G	T	4	2	6	0	0	6	0	0
24	10349818	.	G	A	4	8	12	0	1	13	0	0
24	10349865	.	T	G	3	8	11	0	0	11	0	0
24	10349898	.	T	C	4	8	12	0	0	12	0	0
24	10350135	.	A	T	2	6	8	0	1	9	0	0
24	10356563	.	G	A	4	2	6	0	0	6	0	0
24	10356592	.	T	C	3	2	5	0	0	5	0	0
24	10393951	.	C	G	1	2	3	0	0	3	0	0
24	10393979	.	G	T	6	3	9	0	0	9	0	0
24	10393995	.	A	C	5	2	7	0	2	9	0	0
24	10394079	.	A	C	3	2	5	0	0	5	0	0
24	10413706	.	T	C	3	0	3	0	0	3	0	0
24	10414439	.	G	T	0	5	5	0	2	7	0	0
24	10415193	.	A	G	3	12	15	0	1	16	0	0
24	10415324	.	G	A	9	4	13	1	0	14	0	0
24	10415424	.	A	C	6	8	14	0	2	17	1	0
24	10415487	.	G	A	1	11	12	0	5	17	0	0
24	10415827	.	T	G	1	2	3	0	0	3	0	0
24	10828512	.	A	G	2	2	4	0	0	4	0	0
24	10897254	.	G	A	0	3	3	0	1	4	0	0
24	10901467	.	A	C	5	3	8	0	0	8	0	0
24	10901696	.	C	G	28	26	54	0	1	55	0	0
24	10901759	.	G	T	19	21	40	0	2	42	0	0
24	10901946	.	C	T	11	10	21	0	3	24	0	0
24	10902065	.	T	G	9	12	21	0	2	23	0	0
24	10902192	.	T	A	9	5	14	0	2	16	0	0
24	10902268	.	G	A	8	9	17	0	1	18	0	0
24	10902688	.	G	A	22	12	34	0	0	34	0	0
24	10907000	.	T	C	0	4	4	0	0	4	0	0
24	10907473	.	C	T	17	17	34	0	3	37	0	0
24	10907587	.	G	T	4	3	7	0	1	8	0	0
24	10917040	.	C	T	2	5	7	0	0	7	0	0
24	10917046	.	C	T	0	4	4	0	4	8	0	0
24	10917238	.	C	T	4	0	4	0	0	4	0	0
24	10919519	.	A	G	7	7	14	0	0	14	0	0
24	10919563	.	G	T	6	2	8	0	0	8	0	0
24	10924880	.	C	T	4	16	20	0	1	21	0	0
24	10924912	.	C	T	4	9	13	0	0	13	0	0
24	10924930	.	T	A	3	7	10	0	0	10	0	0
24	10944579	.	T	A	2	2	4	0	0	4	0	0
24	10961510	.	T	C	1	0	1	0	0	1	0	0
24	10971160	.	G	A	0	3	3	0	0	3	0	0
24	11049421	.	G	A	7	7	14	0	0	14	0	0
24	11049627	.	T	G	4	6	10	0	0	10	0	0
24	11049670	.	C	T	4	8	12	0	0	12	0	0
24	11049678	.	C	T	4	8	12	0	0	12	0	0
24	11084035	.	G	A	2	0	2	0	0	2	0	0
24	11086752	.	A	G	3	2	5	0	0	5	0	0
24	11087015	.	G	A	3	3	6	0	1	7	0	0
24	11113281	.	T	C	1	7	8	0	0	8	0	0
24	11113493	.	T	C	3	0	3	0	3	6	0	0
24	11114040	.	A	C	1	5	6	0	0	6	0	0
24	11114048	.	C	A	2	3	5	0	0	5	0	0
24	11114236	.	A	T	11	3	14	0	0	14	0	0
24	11114288	.	T	C	0	6	6	0	1	7	0	0
24	11114290	.	A	G	0	6	6	0	1	7	0	0
24	11114343	.	G	A	5	2	7	0	0	7	0	0
24	11114356	.	C	T	3	2	5	0	0	5	0	0
24	11114560	.	T	C	3	1	4	0	7	11	0	0
24	11114583	.	A	T	5	7	12	0	2	14	0	0
24	11114670	.	C	T	0	8	8	0	7	15	0	0
24	11114688	.	T	G	5	9	14	0	0	14	0	0
24	11114709	.	T	A	7	6	13	0	0	13	0	0
24	11114953	.	A	T	3	2	5	0	0	5	0	0
24	11115078	.	A	G	2	1	3	0	0	3	0	0
24	11115114	.	G	A	0	3	3	0	1	4	0	0
24	11115269	.	C	A	6	4	10	0	1	11	0	0
24	11115280	.	C	G	4	7	11	0	0	11	0	0
24	11115338	.	A	T	0	3	3	0	0	3	0	0
24	11115339	.	C	T	0	3	3	0	0	3	0	0
24	11115373	.	C	T	2	3	5	0	0	5	0	0
24	11115428	.	C	T	0	2	2	0	4	6	0	0
24	11115513	.	G	A	5	2	7	0	2	9	0	0
24	11115532	.	G	A	7	6	13	0	0	13	0	0
24	11115719	.	T	A	3	7	10	0	0	10	0	0
24	11115720	.	A	G	3	7	10	0	0	10	0	0
24	11115894	.	A	G	4	4	8	0	0	8	0	0
24	11116025	.	G	C	4	0	4	0	9	13	0	0
24	11116032	.	C	T	3	10	13	0	0	13	0	0
24	11127483	.	G	A	1	1	2	0	0	2	0	0
24	11141253	.	A	C	1	6	7	0	1	8	0	0
24	11141654	.	A	G	4	6	10	0	1	11	0	0
24	11141757	.	T	C	4	5	9	0	0	9	0	0
24	11141849	.	G	A	6	4	10	0	0	10	0	0
24	11145148	.	C	T	1	5	6	0	1	7	0	0
24	11145232	.	G	A	5	8	13	0	0	13	0	0
24	11145445	.	G	A	3	3	6	0	1	7	0	0
24	11145460	.	A	G	3	3	6	0	0	6	0	0
24	11150790	.	G	A	1	0	1	0	0	1	0	0
24	11150791	.	A	T	1	0	1	0	0	1	0	0
24	11388615	.	C	T	1	2	3	0	0	3	0	0
24	11388628	.	A	C	1	2	3	0	0	3	0	0
24	11452184	.	T	A	2	1	3	0	1	4	0	0
24	11470792	.	T	A	1	1	2	0	0	2	0	0
24	11473351	.	G	T	5	2	7	0	1	8	0	0
24	11473857	.	C	A	5	6	11	0	0	11	0	0
24	11473891	.	G	A	4	5	9	0	1	10	0	0
24	11474103	.	C	G	12	11	23	0	0	23	0	0
24	11474110	.	G	A	9	11	20	0	2	22	0	0
24	11474167	.	T	C	5	10	15	0	2	17	0	0
24	11474730	.	A	G	6	4	10	0	0	10	0	0
24	11483833	.	C	T	0	1	1	0	0	1	0	0
24	11487067	.	G	C	4	4	8	0	0	8	0	0
24	11490280	.	A	C	3	3	6	0	0	6	0	0
24	11530529	.	G	A	2	2	4	0	0	4	0	0
24	11530850	.	G	T	1	2	3	0	0	3	0	0
24	11531307	.	A	G	0	4	4	0	0	4	0	0
24	11532686	.	T	C	4	4	8	0	0	8	0	0
24	11888694	.	G	A	4	4	8	0	1	9	0	0
24	11888788	.	G	A	6	9	15	0	0	15	0	0
24	11888799	.	T	C	5	8	13	0	1	14	0	0
24	11888854	.	T	C	5	11	16	0	1	17	0	0
24	11889107	.	T	C	5	2	7	0	0	7	0	0
24	11889579	.	T	C	2	2	4	0	0	4	0	0
24	11889623	.	T	C	3	3	6	0	0	6	0	0
24	11893428	.	G	A	3	4	7	0	0	7	0	0
24	11894908	.	A	G	5	2	7	0	0	7	0	0
24	11894968	.	C	T	0	5	5	0	6	11	0	0
24	11895910	.	C	A	1	0	1	0	0	1	0	0
24	11900151	.	A	G	3	1	4	0	0	4	0	0
24	11900166	.	G	A	1	2	3	0	0	3	0	0
24	11900230	.	A	C	4	3	7	0	0	7	0	0
24	11905834	.	G	A	1	3	4	0	0	4	0	0
24	11918846	.	G	A	2	2	4	0	0	4	0	0
24	11919170	.	A	G	3	3	6	0	0	6	0	0
24	12133963	.	C	A	8	7	15	0	1	16	0	0
24	12133998	.	A	C	6	4	10	0	0	10	0	0
24	12252675	.	G	T	9	10	19	0	0	19	0	0
24	12253067	.	G	A	6	4	10	0	0	10	0	0
24	12630352	.	A	G	7	2	9	0	1	10	0	0
24	12634439	.	C	T	8	7	15	0	0	15	0	0
24	12686316	.	A	T	0	0	0	0	1	1	0	0
24	12743657	.	C	T	0	3	3	0	2	5	0	0
24	12744274	.	A	G	2	4	6	0	0	6	0	0
24	12746597	.	A	G	6	2	8	0	0	8	0	0
24	12749046	.	G	A	10	5	15	0	1	16	0	0
24	12754181	.	C	A	0	2	2	0	3	5	0	0
24	12768339	.	G	A	1	2	3	0	0	3	0	0
24	12963161	.	T	A	7	6	13	0	1	14	0	0
24	12966730	.	C	T	11	4	15	0	1	16	0	0
24	12966981	.	G	A	8	12	20	0	0	20	0	0
24	12967041	.	C	T	0	2	2	0	0	2	0	0
24	12967214	.	T	C	13	0	13	0	7	20	0	0
24	12970814	.	A	T	2	0	2	0	0	2	0	0
24	12975210	.	A	G	11	6	17	0	1	18	0	0
24	12983478	.	A	T	1	1	2	0	0	2	0	0
24	12988694	.	A	T	3	5	8	0	0	8	0	0
24	12988745	.	T	G	1	2	3	0	0	3	0	0
24	12988764	.	T	C	1	2	3	0	0	3	0	0
24	12998907	.	G	A	1	0	1	0	0	1	0	0
24	13013596	.	T	C	1	2	3	0	0	3	0	0
24	13014423	.	A	T	0	3	3	0	0	3	0	0
24	13015293	.	A	T	4	2	6	0	1	7	0	0
24	13015582	.	A	T	4	9	13	0	1	14	0	0
24	13023054	.	C	T	34	15	49	0	1	50	0	0
24	13026060	.	G	A	14	17	31	0	3	34	0	0
24	13026449	.	T	C	3	1	4	0	1	5	0	0
24	13101128	.	A	G	28	17	45	0	1	46	0	0
24	13101143	.	C	A	32	26	58	0	3	61	0	0
24	13101185	.	A	G	36	1	37	0	28	65	0	0
24	13138165	.	T	C	2	4	6	0	0	6	0	0
24	13239045	.	A	T	10	11	21	0	3	24	0	0
24	13239124	.	T	A	15	18	33	1	6	41	1	0
24	13239248	.	A	G	15	15	30	0	12	42	0	0
24	13239985	.	G	C	15	17	32	0	5	37	0	0
24	13251801	.	A	C	10	6	16	0	0	16	0	0
24	13252065	.	G	A	2	7	9	0	0	9	0	0
24	13252122	.	A	C	6	0	6	0	3	9	0	0
24	13252448	.	A	G	5	3	8	0	0	8	0	0
24	13255400	.	C	T	2	7	9	0	0	9	0	0
24	13271566	.	T	C	4	3	7	0	0	7	0	0
24	13271628	.	A	G	2	2	4	0	0	4	0	0
24	13362125	.	C	A	0	3	3	0	1	4	0	0
24	14233798	.	G	C	2	3	5	0	1	6	0	0
24	14234355	.	A	G	2	2	4	0	0	4	0	0
24	14385405	.	G	A	0	5	5	0	3	8	0	0
24	14385520	.	A	G	3	4	7	0	0	7	0	0
24	14385526	.	C	A	3	4	7	0	0	7	0	0
24	14385630	.	C	G	8	5	13	0	0	13	0	0
24	14385969	.	C	T	4	3	7	0	0	7	0	0
24	14385999	.	T	C	4	3	7	0	0	7	0	0
24	14386024	.	C	T	4	3	7	0	0	7	0	0
24	14386050	.	C	T	3	3	6	0	0	6	0	0
24	14415965	.	G	A	6	8	14	0	1	15	0	0
24	14416018	.	G	C	0	1	1	0	0	1	0	0
24	14420990	.	T	G	1	0	1	0	1	2	0	0
24	14432194	.	T	C	2	0	2	0	0	2	0	0
24	14442409	.	A	T	3	2	5	0	0	5	0	0
24	14442861	.	G	A	4	6	10	0	0	10	0	0
24	14443212	.	G	T	5	5	10	0	2	12	0	0
24	14443291	.	C	T	1	6	7	0	1	8	0	0
24	14443578	.	A	G	5	10	15	0	3	18	0	0
24	14550545	.	C	T	7	7	14	0	0	14	0	0
24	14550554	.	G	A	5	7	12	0	0	12	0	0
24	14550596	.	T	C	3	1	4	0	0	4	0	0
24	14559391	.	A	G	13	5	18	0	0	18	0	0
24	14559778	.	A	T	35	22	57	0	2	61	2	0
24	14559828	.	T	A	36	27	63	0	4	67	0	0
24	14568300	.	G	T	22	21	43	0	3	46	0	0
24	14575607	.	G	A	4	9	13	0	0	13	0	0
24	14576693	.	A	G	6	7	13	0	0	13	0	0
24	14576782	.	A	G	7	7	14	0	0	14	0	0
24	14706845	.	A	G	0	2	2	0	0	2	0	0
24	14711624	.	A	G	2	2	4	0	1	5	0	0
24	14713789	.	G	A	0	3	3	0	0	3	0	0
24	14713796	.	T	C	1	3	4	0	0	4	0	0
24	14713927	.	T	C	8	9	17	0	0	17	0	0
24	14718163	.	T	C	12	16	28	0	2	30	0	0
24	14725164	.	A	G	18	17	35	0	4	39	0	0
24	14725551	.	G	A	9	12	21	0	2	23	0	0
24	14725699	.	T	C	1	2	3	0	0	3	0	0
24	15061397	.	T	C	7	4	11	0	0	11	0	0
24	15061434	.	T	C	3	3	6	0	0	6	0	0
24	15061866	.	G	A	2	1	3	0	0	3	0	0
24	15124785	.	A	T	5	6	11	0	1	12	0	0
24	15124880	.	T	C	5	0	5	0	7	12	0	0
24	15124890	.	A	G	3	7	10	0	1	11	0	0
24	15127639	.	T	C	6	7	13	0	0	13	0	0
24	15277264	.	G	T	3	2	5	0	0	5	0	0
24	15278043	.	C	T	4	2	6	0	1	7	0	0
24	15278187	.	A	G	2	3	5	0	0	5	0	0
24	15278217	.	C	T	0	3	3	0	1	4	0	0
24	15278238	.	G	T	1	2	3	0	0	3	0	0
24	15645212	.	T	C	2	1	3	0	2	5	0	0
24	15645280	.	A	C	5	11	16	0	0	16	0	0
24	15645617	.	G	T	7	4	11	0	14	25	0	0
24	15645669	.	G	T	7	12	19	0	2	22	1	0
24	15648158	.	A	G	2	2	4	0	0	4	0	0
24	15648504	.	T	C	2	4	6	0	0	6	0	0
24	15898196	.	T	G	2	2	4	0	0	4	0	0
24	15898505	.	C	G	4	2	6	0	0	6	0	0
24	16111914	.	T	C	2	1	3	0	0	3	0	0
24	16121362	.	G	A	1	7	8	0	8	16	0	0
24	16121462	.	G	A	7	9	16	0	0	16	0	0
24	16162107	.	T	G	4	3	7	0	0	7	0	0
24	16162185	.	T	G	1	2	3	0	1	4	0	0
24	16162344	.	A	T	6	4	10	0	1	11	0	0
24	16162422	.	A	T	7	4	11	0	0	11	0	0
24	16471603	.	C	A	6	2	8	0	2	10	0	0
24	16572266	.	G	A	1	3	4	0	0	4	0	0
24	16596414	.	A	G	6	0	6	0	7	13	0	0
24	16693526	.	T	C	3	12	15	0	0	15	0	0
24	16696713	.	G	C	11	20	31	0	0	31	0	0
24	16702886	.	G	T	0	11	11	0	11	22	0	0
24	16705878	.	C	T	10	12	22	0	0	22	0	0
24	16705948	.	C	T	22	14	36	0	0	36	0	0
24	16705949	.	A	G	21	13	34	0	2	36	0	0
24	16706108	.	A	G	13	16	29	0	1	30	0	0
24	16706709	.	A	C	1	2	3	0	0	3	0	0
24	16706834	.	A	G	3	7	10	0	1	11	0	0
24	16855489	.	G	A	1	2	3	0	0	3	0	0
24	16855491	.	A	C	1	2	3	0	0	3	0	0
24	16855976	.	C	T	0	3	3	0	3	6	0	0
24	16870644	.	C	T	3	2	5	0	1	6	0	0
24	16896769	.	T	C	1	2	3	0	0	3	0	0
24	16908827	.	G	A	13	16	29	0	0	29	0	0
24	16908908	.	C	T	6	15	21	0	1	22	0	0
24	16909052	.	T	C	8	5	13	0	0	13	0	0
24	16911600	.	A	C	12	8	20	0	0	20	0	0
24	16911898	.	C	T	11	9	20	0	2	22	0	0
24	16912191	.	G	A	21	26	47	0	3	50	0	0
24	16964452	.	G	A	2	7	9	0	1	10	0	0
24	16964500	.	C	T	5	5	10	0	0	10	0	0
24	16964787	.	T	A	2	3	5	0	0	5	0	0
24	16964881	.	G	C	2	10	12	0	0	12	0	0
24	16964889	.	A	G	1	11	12	0	0	12	0	0
24	16964943	.	A	T	3	3	6	0	1	7	0	0
24	16965020	.	C	T	5	3	8	0	0	8	0	0
24	16965032	.	G	A	4	3	7	0	1	8	0	0
24	16965648	.	C	G	4	4	8	0	1	9	0	0
24	16965729	.	A	C	4	7	11	0	0	11	0	0
24	16965765	.	T	C	4	9	13	0	0	13	0	0
24	16965770	.	T	C	4	9	13	0	0	13	0	0
24	16965900	.	A	C	6	0	6	0	3	9	0	0
24	16965972	.	A	G	3	5	8	0	1	9	0	0
24	16966176	.	G	A	1	7	8	0	2	10	0	0
24	16966185	.	T	C	4	0	4	0	6	10	0	0
24	16966389	.	A	G	5	3	8	0	0	8	0	0
24	16966479	.	T	C	6	4	10	0	0	10	0	0
24	16969033	.	A	G	3	2	5	0	0	5	0	0
24	16969132	.	A	C	1	0	1	0	3	4	0	0
24	16969220	.	T	C	4	2	6	0	1	7	0	0
24	16979653	.	C	A	0	4	4	0	5	9	0	0
24	16979678	.	A	T	5	3	8	0	1	9	0	0
24	16985547	.	C	T	2	3	5	0	0	5	0	0
24	16992605	.	G	A	0	0	0	0	2	2	0	0
24	16992915	.	C	T	14	10	24	0	0	24	0	0
24	16998976	.	A	T	18	8	26	0	3	29	0	0
24	17002611	.	C	T	5	5	10	0	0	10	0	0
24	17002666	.	A	T	18	25	43	1	1	45	0	0
24	17010932	.	G	T	2	3	5	0	0	5	0	0
24	17010995	.	C	A	3	2	5	0	0	5	0	0
24	17011082	.	C	A	3	2	5	0	0	5	0	0
24	17016658	.	T	C	1	4	5	0	2	7	0	0
24	17017060	.	T	C	1	0	1	0	0	1	0	0
24	17019252	.	A	G	0	0	0	0	2	2	0	0
24	17019483	.	T	G	1	0	1	0	5	6	0	0
24	17019504	.	G	A	3	4	7	0	0	7	0	0
24	17019669	.	A	G	2	4	6	0	1	7	0	0
24	17019843	.	A	G	3	0	3	0	2	5	0	0
24	17020128	.	C	T	4	4	8	0	0	8	0	0
24	17021848	.	G	A	29	15	44	0	2	46	0	0
24	17021894	.	T	C	26	0	26	0	15	41	0	0
24	17022028	.	A	G	18	10	28	0	2	30	0	0
24	17022029	.	T	A	16	12	28	0	2	30	0	0
24	17023063	.	G	A	11	7	18	0	0	18	0	0
24	17028690	.	T	A	4	6	10	0	0	10	0	0
24	17041159	.	G	C	6	4	10	0	0	10	0	0
24	17041267	.	T	A	3	3	6	0	0	6	0	0
24	17041354	.	A	G	3	4	7	0	0	7	0	0
24	17042598	.	C	A	1	3	4	0	0	4	0	0
24	17042763	.	C	T	10	8	18	0	1	19	0	0
24	17068942	.	C	T	7	6	13	0	0	13	0	0
24	17068949	.	A	G	6	0	6	0	7	13	0	0
24	17069249	.	C	A	3	3	6	0	0	6	0	0
24	17069297	.	A	G	2	5	7	0	0	7	0	0
24	17124124	.	C	T	4	9	13	0	0	13	0	0
24	17124476	.	G	A	0	12	12	0	7	19	0	0
24	17124567	.	T	C	15	13	28	0	2	30	0	0
24	17124591	.	T	A	15	12	27	0	2	29	0	0
24	17126069	.	G	A	17	14	31	0	0	31	0	0
24	17126341	.	C	T	12	19	31	0	2	33	0	0
24	17177262	.	G	A	0	9	9	0	4	13	0	0
24	17181443	.	A	G	5	0	5	0	4	9	0	0
24	17189815	.	T	A	3	2	5	0	0	5	0	0
24	17200202	.	G	T	1	2	3	0	0	3	0	0
24	17211821	.	C	A	2	1	3	0	0	3	0	0
24	17214493	.	A	T	7	15	22	0	1	23	0	0
24	17214629	.	T	C	20	10	30	0	2	32	0	0
24	17215186	.	T	C	10	7	17	0	1	18	0	0
24	17215894	.	A	G	4	4	8	0	0	8	0	0
24	17215972	.	A	C	2	3	5	0	0	5	0	0
24	17215975	.	G	A	2	2	4	0	0	4	0	0
24	17257693	.	C	A	7	4	11	0	1	12	0	0
24	17257866	.	T	C	0	1	1	0	0	1	0	0
24	17258451	.	G	T	1	0	1	0	0	1	0	0
24	17259535	.	G	T	7	1	8	0	1	9	0	0
24	17260568	.	C	A	4	6	10	0	0	10	0	0
24	17266382	.	G	A	4	6	10	0	2	12	0	0
24	17266564	.	G	T	6	4	10	0	0	10	0	0
24	17266886	.	T	A	4	4	8	0	2	10	0	0
24	17266909	.	T	A	6	3	9	0	1	10	0	0
24	17276447	.	T	C	0	0	0	0	1	1	0	0
24	17345618	.	C	A	1	1	2	0	1	3	0	0
24	17345634	.	T	C	1	3	4	0	0	4	0	0
24	17345708	.	T	C	1	2	3	0	0	3	0	0
24	17364010	.	G	A	0	2	2	0	3	5	0	0
24	17364076	.	A	T	1	2	3	0	0	3	0	0
24	17364985	.	G	A	17	12	29	0	0	29	0	0
24	17365081	.	A	G	14	9	23	0	1	24	0	0
24	17366374	.	G	A	5	3	8	0	0	8	0	0
24	17367882	.	G	A	5	9	14	0	2	16	0	0
24	17368343	.	T	A	3	1	4	0	0	4	0	0
24	17368816	.	G	A	3	1	4	0	0	4	0	0
24	17372074	.	G	A	2	2	4	0	0	4	0	0
24	17374611	.	T	C	4	2	6	0	0	6	0	0
24	17377871	.	G	A	2	4	6	0	0	6	0	0
24	17377874	.	G	A	2	5	7	0	0	7	0	0
24	17378123	.	T	C	1	0	1	0	2	3	0	0
24	17378475	.	A	G	1	2	3	0	0	3	0	0
24	17404219	.	G	A	4	7	11	0	0	11	0	0
24	17417535	.	T	G	12	16	28	0	1	29	0	0
24	17417855	.	G	C	8	13	21	0	1	22	0	0
24	17417899	.	G	C	9	12	21	0	0	21	0	0
24	17417947	.	A	G	6	12	18	0	0	18	0	0
24	17418024	.	C	A	12	9	21	0	2	23	0	0
24	17418180	.	G	T	9	8	17	0	0	17	0	0
24	17418588	.	T	C	7	3	10	0	0	10	0	0
24	17418752	.	T	A	8	6	14	0	0	14	0	0
24	17419118	.	T	G	6	11	17	0	0	17	0	0
24	17419140	.	A	G	6	13	19	0	0	19	0	0
24	17419185	.	C	T	3	3	6	0	0	6	0	0
24	17419563	.	A	T	4	3	7	0	0	7	0	0
24	17419604	.	C	A	7	5	12	0	0	12	0	0
24	17419607	.	A	T	7	5	12	0	0	12	0	0
24	17420516	.	G	A	11	12	23	0	0	23	0	0
24	17420519	.	T	C	11	1	12	0	10	22	0	0
24	17420595	.	T	A	7	9	16	0	1	17	0	0
24	17420761	.	G	T	8	3	11	0	0	11	0	0
24	17421216	.	G	T	9	16	25	0	0	25	0	0
24	17421270	.	C	T	1	8	9	0	8	17	0	0
24	17421311	.	G	C	13	7	20	0	0	20	0	0
24	17421338	.	A	T	14	11	25	0	1	26	0	0
24	17421396	.	C	A	14	15	29	0	0	29	0	0
24	17421655	.	G	A	12	14	26	0	2	28	0	0
24	17465715	.	C	T	1	1	2	0	1	3	0	0
24	17465722	.	A	T	2	1	3	0	0	3	0	0
24	17505209	.	G	A	1	1	2	0	0	2	0	0
24	17731754	.	T	A	1	1	2	0	1	3	0	0
24	17754557	.	G	A	3	3	6	0	1	7	0	0
24	18376848	.	A	C	1	1	2	0	0	2	0	0
24	18444097	.	A	T	5	3	8	0	0	8	0	0
24	18444153	.	G	C	5	2	7	0	0	7	0	0
24	18444267	.	T	C	17	3	20	0	17	37	0	0
24	18444334	.	G	T	10	5	15	0	1	16	0	0
24	18444373	.	C	T	7	2	9	0	0	9	0	0
24	18445784	.	A	G	16	11	27	0	4	31	0	0
24	18446545	.	G	A	12	8	20	0	0	20	0	0
24	18448348	.	G	A	7	4	11	0	0	11	0	0
24	18486030	.	A	G	0	3	3	0	0	3	0	0
24	18486840	.	T	C	1	0	1	0	2	3	0	0
24	18521467	.	C	A	4	5	9	0	1	10	0	0
24	18549400	.	G	A	2	0	2	0	0	2	0	0
24	18553898	.	C	T	5	1	6	0	0	6	0	0
24	18563714	.	A	G	3	1	4	0	0	4	0	0
24	18565564	.	A	G	1	2	3	0	0	3	0	0
24	18565591	.	C	T	1	3	4	0	0	4	0	0
24	18625641	.	C	G	2	0	2	0	0	2	0	0
24	18625971	.	C	T	2	2	4	0	0	4	0	0
24	18684818	.	C	T	3	4	7	0	0	7	0	0
24	18737472	.	G	T	5	6	11	0	0	11	0	0
24	18737876	.	C	T	6	4	10	0	1	11	0	0
24	18746161	.	C	T	2	3	5	0	0	5	0	0
24	18749985	.	A	G	10	4	14	0	2	16	0	0
24	18750012	.	G	C	8	10	18	0	1	19	0	0
24	18751734	.	T	A	1	0	1	0	0	1	0	0
24	18751740	.	C	T	0	1	1	0	1	2	0	0
24	18751833	.	A	G	6	6	12	0	1	13	0	0
24	18754752	.	G	A	3	2	5	0	1	6	0	0
24	18757399	.	G	A	0	1	1	0	0	1	0	0
24	18769652	.	A	G	1	4	5	0	0	5	0	0
24	18783090	.	A	G	4	4	8	0	0	8	0	0
24	18783404	.	C	T	1	0	1	0	2	3	0	0
24	18783638	.	G	A	5	3	8	0	0	8	0	0
24	18784241	.	C	T	5	2	7	0	0	7	0	0
24	18784259	.	C	T	0	3	3	0	6	9	0	0
24	18784288	.	G	A	3	5	8	0	0	8	0	0
24	18794371	.	G	A	2	3	5	0	0	5	0	0
24	18797129	.	G	T	1	0	1	0	1	2	0	0
24	18797142	.	G	A	1	1	2	0	0	2	0	0
24	18827372	.	A	G	2	4	6	0	0	6	0	0
24	19061248	.	G	A	0	1	1	0	0	1	0	0
24	19095175	.	C	T	0	0	0	0	1	1	0	0
24	19115072	.	C	A	0	2	2	0	0	2	0	0
24	19206473	.	C	A	1	3	4	0	0	4	0	0
24	19258854	.	A	T	0	1	1	0	0	1	0	0
24	19260876	.	G	A	0	3	3	0	1	4	0	0
24	19342704	.	C	G	1	1	2	0	0	2	0	0
24	19342705	.	A	T	1	1	2	0	0	2	0	0
24	19373816	.	A	T	0	1	1	0	0	1	0	0
24	19402505	.	G	T	4	3	7	0	0	7	0	0
24	19586439	.	G	C	0	2	2	0	1	3	0	0
24	19692718	.	T	G	3	3	6	0	1	7	0	0
24	19692822	.	C	A	1	1	2	0	0	2	0	0
24	19696060	.	T	C	3	5	8	0	1	9	0	0
24	19696151	.	A	C	7	5	12	0	1	13	0	0
24	19697387	.	A	G	2	7	9	0	0	9	0	0
24	19708085	.	A	G	13	12	25	0	1	26	0	0
24	19708448	.	G	T	11	12	23	0	0	23	0	0
24	19708846	.	T	C	5	3	8	0	0	8	0	0
24	19711576	.	G	T	11	6	17	0	0	17	0	0
24	19719132	.	C	A	0	10	10	0	12	22	0	0
24	20064128	.	C	T	3	7	10	0	0	10	0	0
24	20064130	.	G	T	3	7	10	0	0	10	0	0
24	20064232	.	G	A	7	9	16	0	0	16	0	0
24	20064844	.	A	G	7	0	7	0	1	8	0	0
24	20064924	.	A	G	4	7	11	0	2	13	0	0
24	20064988	.	A	C	5	4	9	0	1	10	0	0
24	20065115	.	C	T	0	3	3	0	4	7	0	0
24	20065366	.	T	G	3	7	10	0	0	10	0	0
24	20065375	.	T	A	1	5	6	0	0	6	0	0
24	20194372	.	T	C	4	2	6	0	0	6	0	0
24	20197755	.	C	A	0	3	3	0	0	3	0	0
24	20200722	.	G	A	0	1	1	0	0	1	0	0
24	20202041	.	C	T	2	4	6	0	0	6	0	0
24	20325589	.	G	A	0	2	2	0	0	2	0	0
24	20325754	.	G	A	2	2	4	0	0	4	0	0
24	20328349	.	A	G	0	1	1	0	0	1	0	0
24	20328370	.	G	T	0	4	4	0	0	4	0	0
24	20328567	.	G	C	0	1	1	0	0	1	0	0
24	20328609	.	G	A	0	1	1	0	0	1	0	0
24	20328821	.	C	A	5	5	10	0	0	10	0	0
24	20328999	.	T	A	0	4	4	0	0	4	0	0
24	20329493	.	G	A	1	5	6	0	0	6	0	0
24	20329589	.	G	C	1	2	3	0	0	3	0	0
24	20332145	.	A	G	1	2	3	0	0	3	0	0
24	20332265	.	A	G	4	2	6	0	0	6	0	0
24	20332268	.	T	A	4	2	6	0	0	6	0	0
24	20333251	.	T	C	1	1	2	0	0	2	0	0
24	20450191	.	A	G	8	6	14	0	0	14	0	0
24	20450475	.	G	A	5	4	9	0	1	10	0	0
24	20450536	.	C	T	3	6	9	0	4	13	0	0
24	20450672	.	C	G	10	11	21	0	0	21	0	0
24	20450766	.	G	A	11	14	25	0	0	25	0	0
24	20470788	.	A	G	2	4	6	0	0	6	0	0
24	20501116	.	A	G	2	0	2	0	0	2	0	0
24	20536188	.	C	A	9	5	14	0	3	17	0	0
24	20536235	.	G	A	0	4	4	0	7	11	0	0
24	20537515	.	A	T	3	1	4	0	0	4	0	0
24	20539454	.	G	A	6	3	9	0	0	9	0	0
24	20552578	.	A	C	2	6	8	0	2	10	0	0
24	20554732	.	A	G	15	9	24	0	1	25	0	0
24	20554812	.	T	A	13	15	28	0	0	28	0	0
24	20589592	.	C	T	0	3	3	0	5	8	0	0
24	20591775	.	G	A	2	4	6	0	0	6	0	0
24	20600401	.	T	C	1	2	3	0	0	3	0	0
24	20600431	.	T	C	2	4	6	0	0	6	0	0
24	20600444	.	G	C	1	4	5	0	0	5	0	0
24	20600788	.	A	T	1	4	5	0	0	5	0	0
24	20600794	.	G	A	0	4	4	0	0	4	0	0
24	20645101	.	T	C	11	13	24	0	0	24	0	0
24	20645273	.	T	C	13	7	20	0	2	22	0	0
24	20645858	.	A	T	10	10	20	0	1	21	0	0
24	20646289	.	T	A	4	6	10	0	1	11	0	0
24	20646694	.	G	A	4	6	10	0	0	10	0	0
24	20648945	.	T	C	0	2	2	0	0	2	0	0
24	20649013	.	T	C	4	7	11	0	0	11	0	0
24	20649039	.	T	G	3	4	7	0	1	8	0	0
24	20664650	.	C	G	1	0	1	0	1	2	0	0
24	20708288	.	C	T	1	2	3	0	0	3	0	0
24	20708388	.	A	G	2	2	4	0	0	4	0	0
24	20895293	.	T	A	2	2	4	0	0	4	0	0
24	20895308	.	A	G	3	3	6	0	0	6	0	0
24	20897954	.	G	A	5	2	7	0	0	7	0	0
24	20898485	.	G	A	0	3	3	0	0	3	0	0
24	20900032	.	G	T	1	3	4	0	0	4	0	0
24	20900142	.	A	G	3	3	6	0	0	6	0	0
24	20902081	.	G	A	1	2	3	0	0	3	0	0
24	20913315	.	G	A	1	4	5	0	1	6	0	0
24	20913316	.	G	A	1	5	6	0	0	6	0	0
24	20913403	.	C	T	0	4	4	0	0	4	0	0
24	20916788	.	A	G	3	3	6	0	0	6	0	0
24	20916841	.	C	A	3	8	11	0	0	11	0	0
24	20916874	.	A	T	0	3	3	0	1	4	0	0
24	20917017	.	T	C	0	2	2	0	0	2	0	0
24	20920648	.	G	C	0	15	15	0	13	28	0	0
24	20920910	.	C	G	8	0	8	0	0	8	0	0
24	20921431	.	C	T	10	8	18	0	0	18	0	0
24	20921530	.	A	G	4	10	14	0	0	14	0	0
24	20921537	.	G	T	3	12	15	0	0	15	0	0
24	20921565	.	C	A	3	10	13	0	0	13	0	0
24	20921594	.	C	T	4	8	12	0	1	13	0	0
24	20921615	.	A	G	5	3	8	0	1	9	0	0
24	20921645	.	A	G	3	2	5	0	0	5	0	0
24	20922708	.	T	G	4	6	10	0	0	10	0	0
24	20922721	.	G	A	3	5	8	0	1	9	0	0
24	20922783	.	G	A	0	3	3	0	0	3	0	0
24	20924996	.	C	T	3	1	4	0	0	4	0	0
24	20931626	.	G	A	2	2	4	0	1	5	0	0
24	20934223	.	C	T	6	4	10	0	1	11	0	0
24	20934528	.	G	A	7	11	18	0	1	19	0	0
24	20941540	.	G	A	8	7	15	0	0	15	0	0
24	20946263	.	G	A	4	1	5	0	0	5	0	0
24	20948122	.	C	T	9	9	18	0	2	20	0	0
24	20949494	.	A	G	13	7	20	0	0	20	0	0
24	20952215	.	T	A	3	1	4	0	1	5	0	0
24	20953415	.	C	T	4	5	9	0	0	9	0	0
24	20954109	.	G	A	4	4	8	0	0	8	0	0
24	20954151	.	C	A	2	1	3	0	1	4	0	0
24	20954154	.	T	C	2	1	3	0	1	4	0	0
24	20969449	.	C	T	1	2	3	0	0	3	0	0
24	20980141	.	A	G	6	4	10	0	0	10	0	0
24	20987798	.	T	C	3	1	4	0	1	5	0	0
24	20987834	.	G	A	3	3	6	0	0	6	0	0
24	20987865	.	A	G	3	7	10	0	0	10	0	0
24	21005908	.	A	T	3	6	9	0	0	9	0	0
24	21006053	.	A	G	5	10	15	0	0	15	0	0
24	21006082	.	G	A	4	5	9	0	0	9	0	0
24	21006188	.	T	G	5	8	13	0	0	13	0	0
24	21154165	.	G	A	8	7	15	0	1	16	0	0
24	21154203	.	C	T	19	8	27	0	0	27	0	0
24	21154421	.	A	T	19	11	30	0	1	31	0	0
24	21154496	.	C	A	4	15	19	0	22	41	0	0
24	21154707	.	A	G	23	20	43	0	1	44	0	0
24	21157712	.	G	A	20	17	37	0	1	38	0	0
24	21159814	.	A	G	17	18	35	0	1	36	0	0
24	21161459	.	C	T	0	8	8	0	7	15	0	0
24	21182156	.	A	G	2	2	4	0	3	7	0	0
24	21182444	.	A	G	6	4	10	0	0	10	0	0
24	21182783	.	C	T	9	11	20	0	1	21	0	0
24	21182834	.	G	A	0	14	14	0	12	26	0	0
24	21182911	.	G	A	2	5	7	0	10	17	0	0
24	21183181	.	C	T	13	9	22	0	0	22	0	0
24	21183228	.	C	G	14	10	24	0	1	25	0	0
24	21183467	.	T	C	8	3	11	0	0	11	0	0
24	21196136	.	G	A	0	2	2	0	3	5	0	0
24	21196166	.	T	C	4	4	8	0	1	9	0	0
24	21196211	.	C	A	2	4	6	0	0	6	0	0
24	21196410	.	A	G	1	4	5	0	1	6	0	0
24	21196446	.	T	G	2	2	4	0	0	4	0	0
24	21196637	.	T	A	3	3	6	0	0	6	0	0
24	21202488	.	G	A	0	2	2	0	1	3	0	0
24	21206401	.	T	C	1	5	6	0	0	6	0	0
24	21206903	.	T	A	4	4	8	0	0	8	0	0
24	21210608	.	T	G	3	4	7	0	1	8	0	0
24	21210704	.	A	G	2	1	3	0	0	3	0	0
24	21214898	.	G	A	1	2	3	0	0	3	0	0
24	21371282	.	A	C	3	3	6	0	0	6	0	0
24	21371801	.	T	G	26	28	54	0	1	56	1	0
24	21371919	.	G	A	19	18	37	0	1	38	0	0
24	21372389	.	T	A	16	20	36	0	4	40	0	0
24	21372417	.	A	G	18	19	37	0	0	37	0	0
24	21392168	.	T	C	0	2	2	0	2	4	0	0
24	21392258	.	T	C	1	2	3	0	0	3	0	0
24	21442815	.	A	G	2	6	8	0	0	8	0	0
24	21447610	.	T	G	6	4	10	0	0	10	0	0
24	21447668	.	C	T	0	2	2	0	3	5	0	0
24	21450383	.	G	A	8	1	9	0	1	10	0	0
24	21462810	.	A	G	0	1	1	0	1	2	0	0
24	21469067	.	T	G	4	4	8	0	0	8	0	0
24	21469157	.	T	C	2	0	2	0	3	5	0	0
24	21502007	.	A	G	4	3	7	0	0	7	0	0
24	21502069	.	G	A	4	9	13	0	0	13	0	0
24	21502133	.	T	C	9	0	9	0	12	21	0	0
24	21502305	.	A	G	8	5	13	0	0	13	0	0
24	21502762	.	T	A	4	5	9	0	0	9	0	0
24	21502817	.	C	A	7	5	12	0	0	12	0	0
24	21502999	.	G	A	2	12	14	0	1	15	0	0
24	21503748	.	T	C	7	3	10	0	0	10	0	0
24	21504169	.	T	G	5	2	7	0	0	7	0	0
24	21504467	.	A	G	6	8	14	0	0	14	0	0
24	21504725	.	C	T	0	7	7	0	9	16	0	0
24	21504785	.	A	G	3	4	7	0	0	7	0	0
24	21504860	.	G	T	4	3	7	0	0	7	0	0
24	21505255	.	T	G	5	5	10	0	1	11	0	0
24	21505895	.	A	G	3	5	8	0	0	8	0	0
24	21538430	.	C	T	7	18	25	0	1	26	0	0
24	21538441	.	T	G	4	1	5	0	17	22	0	0
24	21538568	.	A	C	8	8	16	0	0	16	0	0
24	21538628	.	C	T	2	7	9	0	0	9	0	0
24	21561074	.	C	T	0	4	4	0	0	4	0	0
24	21575273	.	T	A	2	0	2	0	0	2	0	0
24	21575311	.	G	C	12	4	16	0	0	16	0	0
24	21577239	.	G	A	1	0	1	0	0	1	0	0
24	21577488	.	T	C	8	9	17	0	1	18	0	0
24	21577620	.	T	G	3	10	13	0	0	13	0	0
24	21577898	.	C	A	5	3	8	0	0	8	0	0
24	21578174	.	C	G	3	2	5	0	0	5	0	0
24	21584115	.	T	C	7	3	10	0	1	11	0	0
24	21584116	.	A	C	7	3	10	0	1	11	0	0
24	21584189	.	G	A	7	4	11	0	0	11	0	0
24	21584673	.	T	G	3	3	6	0	0	6	0	0
24	21584731	.	G	A	4	6	10	0	1	11	0	0
24	21584756	.	A	C	6	3	9	0	0	9	0	0
24	21584794	.	G	A	2	5	7	0	0	7	0	0
24	21584904	.	T	C	2	2	4	0	0	4	0	0
24	21585396	.	C	T	0	4	4	0	4	8	0	0
24	21585719	.	C	T	0	6	6	0	5	11	0	0
24	21585802	.	G	A	5	3	8	0	0	8	0	0
24	21585806	.	A	G	4	3	7	0	0	7	0	0
24	21586135	.	T	A	3	3	6	0	0	6	0	0
24	21586190	.	C	G	3	2	5	0	0	5	0	0
24	21587309	.	T	G	1	1	2	0	0	2	0	0
24	21600984	.	C	A	12	23	35	0	0	35	0	0
24	21606035	.	G	A	11	14	25	0	1	26	0	0
24	21606325	.	C	T	0	3	3	0	0	3	0	0
24	21610064	.	G	A	1	0	1	0	0	1	0	0
24	21646375	.	G	A	4	10	14	0	0	14	0	0
24	21646704	.	G	T	22	23	45	0	1	46	0	0
24	21646847	.	A	C	5	7	12	0	0	12	0	0
24	21650034	.	T	A	8	10	18	0	0	18	0	0
24	21657567	.	C	G	12	13	25	0	1	26	0	0
24	21657606	.	T	C	11	11	22	0	1	23	0	0
24	21657639	.	G	A	7	12	19	0	1	20	0	0
24	21657642	.	G	A	7	13	20	0	1	21	0	0
24	21657738	.	T	C	9	0	9	0	12	21	0	0
24	21659864	.	A	T	4	3	7	0	0	7	0	0
24	21659873	.	A	G	2	1	3	0	0	3	0	0
24	21662298	.	T	G	2	3	5	0	1	6	0	0
24	21671114	.	G	A	9	5	14	0	0	14	0	0
24	21679971	.	G	A	7	6	13	0	0	13	0	0
24	21680010	.	G	A	0	12	12	0	7	19	0	0
24	21680143	.	T	C	4	7	11	0	1	12	0	0
24	21680610	.	G	T	2	2	4	0	0	4	0	0
24	21680612	.	C	T	2	2	4	0	0	4	0	0
24	21680747	.	C	G	5	8	13	0	1	14	0	0
24	21680811	.	C	G	4	3	7	0	1	8	0	0
24	21681162	.	C	T	4	2	6	0	1	7	0	0
24	21744266	.	A	G	0	2	2	0	0	2	0	0
24	21747705	.	T	C	3	6	9	0	0	9	0	0
24	21748175	.	A	G	10	5	15	0	1	16	0	0
24	21748249	.	T	C	20	14	34	0	2	36	0	0
24	21748279	.	C	T	10	16	26	0	1	27	0	0
24	21748374	.	T	C	1	7	8	0	1	9	0	0
24	21750987	.	C	A	1	3	4	0	0	4	0	0
24	21751022	.	T	G	1	2	3	0	1	4	0	0
24	21781451	.	T	G	2	2	4	0	1	5	0	0
24	21781452	.	T	A	2	3	5	0	0	5	0	0
24	21865043	.	G	T	1	2	3	0	0	3	0	0
24	21917502	.	T	C	1	4	5	0	0	5	0	0
24	21917518	.	G	A	2	4	6	0	0	6	0	0
24	21917654	.	C	G	0	2	2	0	2	4	0	0
24	21917745	.	T	G	6	3	9	0	0	9	0	0
24	21917777	.	C	A	6	3	9	0	0	9	0	0
24	21927438	.	G	A	2	7	9	0	0	9	0	0
24	21927456	.	C	T	2	6	8	0	0	8	0	0
24	21927506	.	A	G	3	3	6	0	0	6	0	0
24	22650131	.	T	C	1	0	1	0	0	1	0	0
24	22740552	.	T	C	2	3	5	0	0	5	0	0
24	22740589	.	T	C	3	7	10	0	0	10	0	0
24	22740897	.	A	T	5	17	22	0	1	24	1	0
24	22740949	.	A	G	10	11	21	0	0	21	0	0
24	22740996	.	C	T	9	8	17	0	0	17	0	0
24	22741051	.	G	A	12	6	18	0	2	20	0	0
24	22741088	.	C	T	6	12	18	0	4	22	0	0
24	22741403	.	T	A	10	8	18	0	1	19	0	0
24	22741453	.	C	T	7	13	20	0	0	20	0	0
24	22744502	.	A	G	4	1	5	0	0	5	0	0
24	22746843	.	T	G	5	5	10	0	0	10	0	0
24	22748633	.	C	T	6	6	12	0	1	13	0	0
24	22769225	.	A	T	11	12	23	0	2	25	0	0
24	22769333	.	A	G	4	1	5	0	9	14	0	0
24	22769447	.	G	A	12	5	17	0	0	17	0	0
24	22769484	.	C	T	12	4	16	0	1	17	0	0
24	22769593	.	C	A	7	7	14	0	1	15	0	0
24	22769595	.	T	A	7	7	14	0	1	15	0	0
24	23214125	.	G	A	0	2	2	0	1	3	0	0
24	23243257	.	A	G	0	5	5	0	0	5	0	0
24	23244265	.	G	A	0	6	6	0	1	7	0	0
24	23244267	.	A	G	3	2	5	0	2	7	0	0
24	23302371	.	A	G	2	2	4	0	0	4	0	0
24	23302707	.	T	G	4	2	6	0	0	6	0	0
24	23303003	.	G	A	1	2	3	0	0	3	0	0
24	23716987	.	T	A	3	5	8	0	0	8	0	0
24	23716991	.	A	G	3	5	8	0	0	8	0	0
24	23717079	.	T	G	6	8	14	0	1	15	0	0
24	23760291	.	A	G	0	1	1	0	0	1	0	0
24	23784647	.	G	A	2	2	4	0	0	4	0	0
24	23838823	.	C	T	4	4	8	0	1	9	0	0
24	23839024	.	T	C	7	3	10	0	2	12	0	0
24	23839303	.	A	G	5	4	9	0	1	10	0	0
24	23839342	.	T	C	4	3	7	0	0	7	0	0
24	23937877	.	T	G	1	2	3	0	6	9	0	0
24	23941618	.	G	T	2	7	9	0	0	9	0	0
24	24017837	.	C	T	4	5	9	0	0	9	0	0
24	24020314	.	C	T	1	0	1	0	0	1	0	0
24	24027914	.	T	A	3	4	7	0	1	8	0	0
24	24027939	.	A	G	6	5	11	0	0	11	0	0
24	24028016	.	C	T	11	10	21	0	0	21	0	0
24	24028032	.	G	C	11	8	19	0	0	19	0	0
24	24028059	.	T	A	14	9	23	0	1	24	0	0
24	24102091	.	T	C	9	0	9	0	18	27	0	0
24	24110935	.	C	T	7	10	17	0	0	17	0	0
24	24111470	.	G	A	6	10	16	0	0	16	0	0
24	24114272	.	G	C	5	7	12	1	0	13	0	0
24	24114321	.	C	T	5	9	14	0	1	15	0	0
24	24114417	.	C	T	8	6	14	0	2	16	0	0
24	24114744	.	G	A	9	11	20	0	0	20	0	0
24	24114810	.	A	C	5	3	8	0	2	10	0	0
24	24118213	.	A	C	1	1	2	0	0	2	0	0
24	24118272	.	A	G	3	4	7	0	1	8	0	0
24	24118362	.	C	T	6	6	12	0	0	12	0	0
24	24118366	.	A	T	6	5	11	0	1	12	0	0
24	24121130	.	C	T	17	20	37	0	4	41	0	0
24	24121282	.	C	G	1	18	19	0	22	41	0	0
24	24121366	.	A	G	17	20	37	0	3	40	0	0
24	24121375	.	G	C	14	0	14	0	26	40	0	0
24	24121502	.	T	A	7	7	14	0	0	14	0	0
24	24121826	.	G	T	20	25	45	0	1	46	0	0
24	24121851	.	A	T	23	20	43	0	2	45	0	0
24	24124517	.	G	A	16	16	32	0	2	34	0	0
24	24130794	.	A	G	28	32	60	0	3	63	0	0
24	24130824	.	T	C	30	27	57	0	3	60	0	0
24	24135906	.	G	A	1	1	2	0	0	2	0	0
24	24136047	.	T	G	22	23	45	0	0	45	0	0
24	24146669	.	T	C	16	0	16	0	19	35	0	0
24	24155586	.	T	C	3	3	6	0	0	6	0	0
24	24155607	.	G	A	6	5	11	0	0	11	0	0
24	24155655	.	A	G	17	10	27	0	0	27	0	0
24	24155664	.	C	A	16	9	25	0	0	25	0	0
24	24155718	.	A	T	2	2	4	0	0	4	0	0
24	24163114	.	C	T	4	8	12	0	0	12	0	0
24	24164812	.	A	T	13	19	32	0	3	35	0	0
24	24164935	.	A	C	9	15	24	0	1	25	0	0
24	24168359	.	G	C	16	14	30	0	0	30	0	0
24	24171017	.	G	A	1	2	3	0	0	3	0	0
24	24174791	.	C	T	1	2	3	0	0	3	0	0
24	24174889	.	T	C	1	4	5	0	0	5	0	0
24	24177137	.	A	G	4	7	11	0	0	11	0	0
24	24177158	.	T	C	3	4	7	0	1	8	0	0
24	24177213	.	G	C	6	4	10	0	0	10	0	0
24	24183959	.	T	G	2	5	7	0	0	7	0	0
24	24184394	.	T	C	3	0	3	0	5	8	0	0
24	24184677	.	T	A	5	6	11	0	0	11	0	0
24	24187454	.	T	G	2	1	3	0	0	3	0	0
24	24189516	.	C	T	0	0	0	0	3	3	0	0
24	24210479	.	C	T	0	2	2	0	0	2	0	0
24	24210485	.	G	A	0	2	2	0	0	2	0	0
24	24276197	.	A	G	1	3	4	0	0	4	0	0
24	24461710	.	T	A	9	12	21	0	1	22	0	0
24	24462021	.	C	T	19	6	25	0	0	25	0	0
24	24463030	.	T	A	14	9	23	0	0	23	0	0
24	24463060	.	A	G	17	5	22	0	2	24	0	0
24	24701885	.	C	G	6	15	21	0	1	22	0	0
24	24701938	.	T	C	5	7	12	0	0	12	0	0
24	24702119	.	A	C	4	0	4	0	11	15	0	0
24	24702674	.	C	T	16	11	27	0	1	28	0	0
24	24702930	.	C	T	0	1	1	0	5	6	0	0
24	24702936	.	T	C	2	1	3	0	0	3	0	0
24	24720991	.	G	A	2	3	5	0	0	5	0	0
24	24732383	.	T	G	2	0	2	0	1	3	0	0
24	24745966	.	T	C	1	0	1	0	0	1	0	0
24	24796567	.	C	G	0	3	3	0	3	6	0	0
24	24796901	.	T	C	2	5	7	0	0	7	0	0
24	24848118	.	C	T	1	25	26	0	13	39	0	0
24	24931465	.	T	C	5	2	7	0	1	8	0	0
24	24934236	.	A	G	3	4	7	0	0	7	0	0
24	24934347	.	T	C	3	4	7	0	0	7	0	0
24	24935527	.	G	A	1	0	1	0	0	1	0	0
24	24935791	.	G	C	8	3	11	0	0	11	0	0
24	24935810	.	T	C	8	4	12	0	2	14	0	0
24	24948089	.	T	A	3	3	6	0	2	8	0	0
24	24948101	.	T	A	1	3	4	0	0	4	0	0
24	24950569	.	T	C	0	1	1	0	0	1	0	0
24	24989293	.	T	G	4	4	8	0	2	10	0	0
24	24989368	.	C	T	0	10	10	0	11	21	0	0
24	24992522	.	G	A	1	3	4	0	0	4	0	0
24	25008378	.	G	C	2	0	2	0	2	4	0	0
24	25008884	.	G	A	4	2	6	0	2	8	0	0
24	25008887	.	G	A	5	2	7	0	1	8	0	0
24	25020054	.	T	G	2	1	3	0	0	3	0	0
24	25026344	.	C	T	1	2	3	0	1	4	0	0
24	25029860	.	T	A	3	0	3	0	0	3	0	0
24	25032485	.	G	A	0	4	4	0	1	5	0	0
24	25041054	.	T	C	1	4	5	0	0	5	0	0
24	25047572	.	C	G	1	0	1	0	2	3	0	0
24	25049209	.	C	T	6	4	10	0	0	10	0	0
24	25049436	.	T	C	6	4	10	0	0	10	0	0
24	25049484	.	T	G	3	2	5	0	1	6	0	0
24	25052078	.	C	T	4	2	6	0	0	6	0	0
24	25052723	.	T	A	8	5	13	0	0	13	0	0
24	25052774	.	C	T	6	7	13	0	0	13	0	0
24	25053032	.	C	A	2	5	7	0	1	8	0	0
24	25059127	.	C	T	3	4	7	0	0	7	0	0
24	25059129	.	T	C	3	4	7	0	0	7	0	0
24	25059162	.	A	C	5	3	8	0	0	8	0	0
24	25069670	.	G	A	7	8	15	0	0	15	0	0
24	25069926	.	A	G	7	0	7	0	8	15	0	0
24	25069928	.	T	A	7	6	13	0	2	15	0	0
24	25070289	.	C	T	4	5	9	0	0	9	0	0
24	25070515	.	C	T	4	2	6	0	0	6	0	0
24	25070745	.	G	A	1	7	8	0	7	15	0	0
24	25070921	.	C	T	9	7	16	0	0	16	0	0
24	25070922	.	T	G	9	7	16	0	0	16	0	0
24	25071270	.	T	A	7	10	17	0	0	17	0	0
24	25071474	.	T	C	11	21	32	0	2	34	0	0
24	25071486	.	A	T	21	11	32	0	1	33	0	0
24	25071726	.	G	A	3	11	14	0	0	14	0	0
24	25071742	.	T	C	3	8	11	0	0	11	0	0
24	25071939	.	G	A	3	2	5	0	0	5	0	0
24	25072088	.	T	C	3	6	9	0	0	9	0	0
24	25072102	.	T	C	6	4	10	0	0	10	0	0
24	25072311	.	C	T	6	4	10	0	0	10	0	0
24	25072358	.	C	A	3	5	8	0	1	9	0	0
24	25072487	.	A	G	10	17	27	0	1	28	0	0
24	25072511	.	T	G	6	14	20	0	0	20	0	0
24	25072711	.	G	A	12	10	22	0	1	23	0	0
24	25093794	.	G	T	3	2	5	0	0	5	0	0
24	25347794	.	G	T	4	4	8	0	1	9	0	0
24	25348354	.	C	T	4	5	9	0	1	10	0	0
24	25350710	.	G	A	4	2	6	0	1	7	0	0
24	25350712	.	G	A	4	3	7	0	0	7	0	0
24	25351368	.	A	T	4	6	10	0	0	10	0	0
24	25351563	.	T	C	1	2	3	0	0	3	0	0
24	25351588	.	T	G	1	2	3	0	1	4	0	0
24	25351911	.	C	T	0	4	4	0	2	6	0	0
24	25351955	.	C	T	4	6	10	0	0	10	0	0
24	25352325	.	G	A	1	3	4	0	0	4	0	0
24	25352630	.	T	C	2	0	2	0	3	5	0	0
24	25359629	.	G	A	1	3	4	0	0	4	0	0
24	25359803	.	A	G	0	2	2	0	2	4	0	0
24	25448155	.	G	A	1	7	8	0	0	8	0	0
24	25448185	.	C	A	0	8	8	0	2	10	0	0
24	25448752	.	T	C	2	13	15	0	0	15	0	0
24	25449319	.	G	A	1	2	3	0	0	3	0	0
24	25456649	.	G	A	1	0	1	0	0	1	0	0
24	25496133	.	T	C	4	5	9	0	0	9	0	0
24	25496194	.	A	C	0	1	1	0	1	2	0	0
24	25496215	.	T	G	1	3	4	0	0	4	0	0
24	25496271	.	C	T	0	6	6	0	1	7	0	0
24	25496318	.	A	G	1	0	1	0	3	4	0	0
24	25496435	.	T	C	6	9	15	0	0	15	0	0
24	25496590	.	T	C	5	7	12	0	0	12	0	0
24	25496789	.	T	C	5	7	12	0	0	12	0	0
24	25497102	.	C	G	2	5	7	0	0	7	0	0
24	25497273	.	A	T	3	3	6	0	0	7	1	0
24	25497327	.	T	C	3	5	8	0	0	8	0	0
24	25497353	.	G	A	0	5	5	0	3	8	0	0
24	25497677	.	G	A	5	7	12	0	0	12	0	0
24	25497979	.	T	A	2	2	4	0	0	4	0	0
24	25526192	.	C	A	5	10	15	0	0	15	0	0
24	25565407	.	T	C	2	0	2	0	2	4	0	0
24	25565556	.	T	C	1	1	2	0	0	2	0	0
24	25575049	.	A	G	1	2	3	0	0	3	0	0
24	25602136	.	G	T	0	0	0	0	1	1	0	0
24	25693003	.	G	A	19	16	35	0	2	37	0	0
24	25693026	.	C	T	22	15	37	0	2	39	0	0
24	25693948	.	A	G	20	25	45	0	0	45	0	0
24	25693992	.	T	A	14	24	38	0	9	47	0	0
24	25694537	.	A	C	9	26	35	0	2	37	0	0
24	25694858	.	G	A	0	3	3	0	3	6	0	0
24	25761637	.	T	C	1	2	3	0	0	3	0	0
24	25762272	.	G	A	4	7	11	0	0	11	0	0
24	25762491	.	A	G	3	2	5	0	1	6	0	0
24	25762506	.	C	T	4	3	7	0	0	7	0	0
24	25762884	.	C	T	4	4	8	0	0	8	0	0
24	25762930	.	C	A	1	3	4	0	0	4	0	0
24	25762968	.	G	A	3	3	6	0	0	6	0	0
24	25764207	.	A	T	0	2	2	0	0	2	0	0
24	25794522	.	C	A	7	3	10	0	1	11	0	0
24	25794530	.	G	A	8	2	10	0	0	10	0	0
24	25872390	.	C	T	6	7	13	0	1	14	0	0
24	25988246	.	A	C	1	3	4	0	0	4	0	0
24	26017175	.	T	A	4	3	7	0	0	7	0	0
24	26017188	.	A	G	3	3	6	0	0	6	0	0
24	26021810	.	T	C	0	2	2	0	0	2	0	0
24	26021871	.	G	A	3	3	6	0	1	7	0	0
24	26025151	.	T	C	1	0	1	0	0	1	0	0
24	26025384	.	T	A	1	1	2	0	0	2	0	0
24	26026179	.	A	T	2	2	4	0	1	5	0	0
24	26030571	.	C	T	7	19	26	0	1	27	0	0
24	26030663	.	T	C	6	8	14	0	0	14	0	0
24	26030827	.	A	C	10	18	28	0	0	28	0	0
24	26030849	.	T	A	10	17	27	0	0	27	0	0
24	26030893	.	G	A	12	9	21	0	3	24	0	0
24	26030985	.	A	T	9	6	15	0	2	17	0	0
24	26041227	.	T	C	3	1	4	0	0	4	0	0
24	26045132	.	C	T	1	2	3	0	0	3	0	0
24	26045916	.	T	C	0	1	1	0	0	1	0	0
24	26046588	.	A	G	1	0	1	0	3	4	0	0
24	26046618	.	G	A	0	2	2	0	0	2	0	0
24	26046820	.	A	G	3	0	3	0	3	6	0	0
24	26046822	.	T	C	4	2	6	0	0	6	0	0
24	26048017	.	G	A	1	3	4	0	0	4	0	0
24	26049166	.	G	T	6	5	11	0	0	11	0	0
24	26049825	.	T	C	6	9	15	0	1	16	0	0
24	26049946	.	A	C	5	4	9	0	0	9	0	0
24	26050066	.	A	T	7	5	12	0	0	12	0	0
24	26052082	.	T	C	1	0	1	0	1	2	0	0
24	26142739	.	C	T	1	2	3	0	0	3	0	0
24	26196594	.	A	G	1	4	5	0	0	5	0	0
24	26197205	.	G	A	0	3	3	0	2	5	0	0
24	26197291	.	A	G	2	5	7	0	0	7	0	0
24	26197313	.	G	T	2	2	4	0	0	4	0	0
24	26280058	.	G	A	5	2	7	0	0	7	0	0
24	26280163	.	A	G	2	5	7	0	2	9	0	0
24	26280505	.	G	A	3	5	8	0	0	8	0	0
24	26284612	.	G	T	5	10	15	0	0	15	0	0
24	26331279	.	G	A	0	2	2	0	0	2	0	0
24	26331307	.	C	T	1	3	4	0	0	4	0	0
24	26333366	.	G	A	1	2	3	0	0	3	0	0
24	26333597	.	C	T	2	1	3	0	1	4	0	0
24	26333801	.	C	T	3	2	5	0	0	5	0	0
24	26334257	.	G	A	3	3	6	0	0	6	0	0
24	26334299	.	A	G	3	0	3	0	2	5	0	0
24	26342519	.	G	C	0	0	0	0	1	1	0	0
24	26373354	.	G	A	1	1	2	0	1	3	0	0
24	26373473	.	G	A	5	8	13	0	0	13	0	0
24	26373498	.	G	A	9	4	13	0	0	13	0	0
24	26376380	.	A	G	10	10	20	0	1	21	0	0
24	26383430	.	A	G	4	5	9	0	0	9	0	0
24	26383700	.	C	T	0	7	7	0	2	9	0	0
24	26383829	.	C	T	0	5	5	0	7	12	0	0
24	26383840	.	C	T	5	7	12	0	0	12	0	0
24	26383907	.	T	C	8	3	11	0	0	11	0	0
24	26383971	.	A	C	1	0	1	0	7	8	0	0
24	26406895	.	C	A	9	4	13	0	0	13	0	0
24	26406898	.	A	G	8	0	8	0	6	14	0	0
24	26415190	.	T	C	0	1	1	0	0	1	0	0
24	26420141	.	T	C	5	7	12	0	0	12	0	0
24	26429443	.	T	C	11	8	19	0	1	20	0	0
24	26429456	.	C	T	11	12	23	0	0	23	0	0
24	26475434	.	C	T	3	0	3	0	0	3	0	0
24	26478889	.	C	T	0	4	4	0	6	10	0	0
24	26482337	.	T	C	39	32	71	0	2	73	0	0
24	26492113	.	C	T	0	8	8	0	15	23	0	0
24	26492505	.	G	T	11	3	14	0	1	15	0	0
24	26492905	.	G	T	6	5	11	0	0	11	0	0
24	26493029	.	T	G	1	5	6	0	0	6	0	0
24	26493158	.	A	C	9	0	9	0	7	16	0	0
24	26493542	.	C	A	14	7	21	0	1	22	0	0
24	26493691	.	T	A	3	9	12	0	0	12	0	0
24	26494077	.	C	A	6	11	17	0	0	17	0	0
24	26494477	.	C	T	0	2	2	0	1	3	0	0
24	26508886	.	C	T	0	1	1	0	2	3	0	0
24	26511001	.	C	T	1	2	3	0	0	3	0	0
24	26513205	.	T	C	1	0	1	0	0	1	0	0
24	26518811	.	A	G	0	2	2	0	0	2	0	0
24	26527472	.	G	A	4	8	12	0	0	12	0	0
24	26529715	.	G	A	0	1	1	0	0	1	0	0
24	26530814	.	T	A	2	4	6	0	0	6	0	0
24	26558029	.	A	G	5	5	10	0	0	10	0	0
24	26662895	.	A	G	5	5	10	0	1	11	0	0
24	26666778	.	G	A	1	5	6	0	1	7	0	0
24	26687731	.	G	A	0	4	4	0	0	4	0	0
24	26887490	.	C	A	1	2	3	0	0	3	0	0
24	26891042	.	G	A	0	2	2	0	1	3	0	0
24	26936744	.	C	T	3	1	4	1	0	5	0	0
24	26936794	.	G	A	2	6	8	0	0	8	0	0
24	26936809	.	T	C	1	4	5	0	0	5	0	0
24	26936839	.	T	C	1	3	4	0	0	4	0	0
24	26936846	.	G	A	1	3	4	0	0	4	0	0
24	26941493	.	T	G	7	4	11	0	0	11	0	0
24	26941713	.	C	T	12	10	22	0	1	23	0	0
24	26941996	.	A	G	7	6	13	0	0	13	0	0
24	26942242	.	C	G	9	7	16	0	1	17	0	0
24	26942711	.	T	C	5	11	16	0	1	17	0	0
24	26942880	.	A	T	9	10	19	0	1	20	0	0
24	26942989	.	G	A	2	4	6	0	0	6	0	0
24	26943103	.	C	G	6	5	11	0	0	11	0	0
24	26943148	.	C	T	6	5	11	0	1	12	0	0
24	26945274	.	T	A	1	9	10	0	1	11	0	0
24	26948820	.	G	A	3	4	7	0	0	7	0	0
24	26948823	.	A	C	2	4	6	0	1	7	0	0
24	26948933	.	A	T	3	2	5	0	1	6	0	0
24	26949164	.	T	A	1	3	4	0	1	5	0	0
24	26949426	.	A	C	6	2	8	0	1	9	0	0
24	26949555	.	T	G	3	3	6	0	0	6	0	0
24	26959891	.	T	C	1	0	1	0	0	1	0	0
24	26962277	.	C	T	2	2	4	0	0	4	0	0
24	26968308	.	G	A	3	2	5	0	0	5	0	0
24	26970404	.	G	A	1	1	2	0	0	2	0	0
24	26970407	.	C	T	1	1	2	0	0	2	0	0
24	26970936	.	T	C	1	0	1	0	1	2	0	0
24	26980842	.	A	G	1	0	1	0	0	1	0	0
24	26997920	.	G	A	2	3	5	0	0	5	0	0
24	27009231	.	C	A	3	0	3	0	0	3	0	0
24	27023403	.	C	T	3	3	6	0	0	6	0	0
24	27153245	.	C	T	1	1	2	0	0	2	0	0
24	27168681	.	T	C	0	1	1	0	0	1	0	0
24	27185574	.	A	G	9	12	21	0	0	21	0	0
24	27207238	.	G	T	5	6	11	0	0	11	0	0
24	27222574	.	G	A	12	4	16	0	1	17	0	0
24	27222662	.	C	T	13	4	17	0	1	18	0	0
24	27222937	.	G	A	1	10	11	0	11	22	0	0
24	27223018	.	C	T	5	4	9	0	0	9	0	0
24	27224064	.	T	A	19	13	32	0	1	33	0	0
24	27224598	.	G	A	5	6	11	0	1	12	0	0
24	27224863	.	C	A	12	9	21	0	0	21	0	0
24	27225096	.	T	C	10	14	24	0	1	25	0	0
24	27225423	.	C	A	14	8	22	0	2	24	0	0
24	27226057	.	C	T	9	4	13	0	2	15	0	0
24	27238808	.	C	T	0	1	1	0	0	1	0	0
24	27251249	.	C	T	7	4	11	0	0	11	0	0
24	27399969	.	T	C	2	7	9	0	0	9	0	0
24	28137270	.	G	T	1	2	3	0	0	3	0	0
24	28137679	.	C	T	0	1	1	0	1	2	0	0
24	28228495	.	G	A	3	5	8	0	0	8	0	0
24	28228572	.	G	A	3	5	8	0	2	10	0	0
24	28228587	.	T	C	5	2	7	0	0	7	0	0
24	28252608	.	C	T	4	7	11	0	1	12	0	0
24	28252699	.	G	A	5	6	11	0	1	12	0	0
24	28252898	.	C	A	15	9	24	0	0	24	0	0
24	28253740	.	A	T	14	11	25	0	1	26	0	0
24	28253802	.	T	C	17	0	17	0	19	36	0	0
24	28259134	.	T	C	2	5	7	0	0	7	0	0
24	28263856	.	G	C	1	2	3	0	0	3	0	0
24	28263964	.	G	A	3	5	8	0	0	8	0	0
24	28354675	.	T	G	2	3	5	0	0	5	0	0
24	28365152	.	G	A	0	1	1	0	0	1	0	0
24	28381130	.	T	C	1	2	3	0	1	4	0	0
24	28381298	.	C	A	0	2	2	0	1	3	0	0
24	28394482	.	C	T	2	2	4	0	0	4	0	0
24	28426082	.	T	A	15	7	22	0	1	23	0	0
24	28426244	.	G	C	16	8	24	0	0	24	0	0
24	28426597	.	G	A	15	17	32	0	2	34	0	0
24	28432465	.	C	T	7	3	10	0	0	10	0	0
24	28437375	.	A	G	12	7	19	0	1	20	0	0
24	28437562	.	G	C	11	3	14	0	0	14	0	0
24	28687424	.	C	T	1	8	9	0	9	18	0	0
24	28687576	.	A	G	5	10	15	0	0	15	0	0
24	28688104	.	G	A	11	7	18	0	1	19	0	0
24	28688137	.	G	A	5	6	11	0	0	11	0	0
24	28688416	.	G	A	6	5	11	0	0	11	0	0
24	28691389	.	C	T	1	5	6	0	0	6	0	0
24	28691457	.	C	T	1	6	7	0	6	13	0	0
24	28710825	.	A	G	0	1	1	0	0	1	0	0
24	28711103	.	T	C	1	4	5	0	0	5	0	0
24	28953040	.	C	A	7	4	11	0	0	11	0	0
24	28960786	.	T	G	0	1	1	0	0	1	0	0
24	28960808	.	A	C	2	4	6	0	2	8	0	0
24	28966873	.	C	A	5	3	8	0	0	8	0	0
24	28966892	.	T	C	3	3	6	0	0	6	0	0
24	29353048	.	C	T	2	3	5	0	1	6	0	0
24	29353340	.	T	A	2	9	11	0	1	12	0	0
24	29382153	.	T	A	6	5	11	0	0	11	0	0
24	29449847	.	C	T	4	6	10	0	0	10	0	0
24	29450222	.	C	T	7	8	15	0	0	15	0	0
24	29525169	.	T	A	10	16	26	0	7	33	0	0
24	29525262	.	T	C	14	12	26	0	1	27	0	0
24	29965446	.	T	C	1	0	1	0	2	3	0	0
24	30054122	.	G	A	2	6	8	0	1	9	0	0
24	30054147	.	A	C	4	2	6	0	1	7	0	0
24	30054257	.	A	G	3	2	5	0	0	5	0	0
24	30054404	.	G	A	3	6	9	0	1	10	0	0
24	30054812	.	G	C	4	8	12	0	0	12	0	0
24	30054835	.	A	T	6	6	12	0	1	13	0	0
24	30054857	.	A	G	4	6	10	0	0	10	0	0
24	30054898	.	G	A	4	5	9	0	0	9	0	0
24	30054947	.	C	T	6	10	16	0	0	16	0	0
24	30054980	.	T	G	7	7	14	0	0	14	0	0
24	30055046	.	G	A	3	1	4	0	1	5	0	0
24	30067126	.	C	T	5	4	9	0	0	9	0	0
24	30082868	.	A	G	2	3	5	0	0	5	0	0
24	30082884	.	A	G	0	2	2	0	0	2	0	0
24	30228717	.	C	T	0	2	2	0	1	3	0	0
24	30350077	.	T	G	7	3	10	0	0	10	0	0
24	30352234	.	C	T	3	2	5	0	0	5	0	0
24	30352276	.	T	C	3	3	6	0	1	7	0	0
24	30352907	.	T	C	14	13	27	0	0	27	0	0
24	30352940	.	T	A	11	9	20	0	3	23	0	0
24	30353036	.	T	A	14	15	29	0	3	32	0	0
24	30353065	.	G	A	15	10	25	0	3	28	0	0
24	30353083	.	G	A	11	9	20	0	0	20	0	0
24	30353298	.	A	G	9	12	21	0	0	21	0	0
24	30353447	.	T	C	9	7	16	0	0	16	0	0
24	30353683	.	A	G	10	8	18	0	0	18	0	0
24	30353825	.	A	G	7	0	7	0	8	15	0	0
24	30353893	.	C	A	11	13	24	0	0	24	0	0
24	30353918	.	C	T	12	13	25	0	1	26	0	0
24	30835992	.	G	T	7	3	10	0	1	11	0	0
24	30836132	.	A	G	8	6	14	0	0	14	0	0
24	30845845	.	G	A	1	2	3	0	0	3	0	0
24	30845875	.	G	C	1	0	1	0	3	4	0	0
24	30845893	.	C	T	1	3	4	0	0	4	0	0
24	31082078	.	A	G	1	6	7	0	0	7	0	0
24	31082432	.	G	T	11	8	19	0	0	19	0	0
24	31082758	.	A	T	2	3	5	0	1	6	0	0
24	31082774	.	C	A	2	3	5	0	0	5	0	0
24	31092530	.	T	G	2	0	2	0	0	2	0	0
24	31098564	.	A	C	7	8	15	0	1	16	0	0
24	31098655	.	C	A	10	14	24	0	2	26	0	0
24	31098820	.	A	G	4	7	11	0	0	11	0	0
24	31170701	.	C	T	0	3	3	0	2	5	0	0
24	31170921	.	A	G	0	4	4	0	1	5	0	0
24	31176087	.	A	G	2	2	4	0	0	4	0	0
24	31311080	.	A	C	15	6	21	0	0	21	0	0
24	31311323	.	C	G	0	5	5	0	8	13	0	0
24	31311334	.	G	C	6	5	11	0	0	11	0	0
24	31319592	.	C	T	0	2	2	0	2	4	0	0
24	31322911	.	G	C	1	1	2	0	4	6	0	0
24	31322950	.	T	G	3	5	8	0	0	8	0	0
24	31325202	.	T	C	3	1	4	0	0	4	0	0
24	31334313	.	A	G	15	9	24	0	1	25	0	0
24	31340673	.	T	C	13	7	20	0	1	21	0	0
24	31340819	.	A	T	13	9	22	0	1	23	0	0
24	31342807	.	T	C	3	2	5	0	0	5	0	0
24	31342846	.	G	C	3	2	5	0	0	5	0	0
24	31342855	.	G	A	1	2	3	0	1	4	0	0
24	31342883	.	T	A	2	2	4	0	0	4	0	0
24	31346647	.	G	T	18	17	35	0	1	36	0	0
24	31364567	.	G	A	0	1	1	0	0	1	0	0
24	31364622	.	C	T	3	3	6	0	1	7	0	0
24	31367491	.	A	G	3	3	6	0	0	6	0	0
24	31367841	.	C	A	4	5	9	0	1	10	0	0
24	31367851	.	G	A	5	4	9	0	0	9	0	0
24	31367891	.	C	T	3	5	8	0	0	8	0	0
24	31367999	.	A	G	5	4	9	0	0	9	0	0
24	31374494	.	T	C	1	3	4	0	0	4	0	0
24	31393945	.	T	C	1	3	4	0	0	4	0	0
24	31393957	.	A	T	1	3	4	0	1	5	0	0
24	31397840	.	G	A	5	3	8	0	1	9	0	0
24	31832549	.	G	A	7	13	20	0	0	20	0	0
24	31832657	.	G	A	7	11	18	0	1	19	0	0
24	31832761	.	G	A	2	3	5	0	0	5	0	0
24	31832833	.	T	G	2	3	5	0	1	6	0	0
24	31832970	.	C	T	2	5	7	0	0	7	0	0
24	31833114	.	A	T	10	6	16	0	0	16	0	0
24	31833208	.	G	A	3	14	17	0	1	18	0	0
24	31833991	.	G	A	9	3	12	0	0	12	0	0
24	31834286	.	A	G	1	7	8	0	0	8	0	0
24	31834396	.	G	A	5	8	13	0	1	14	0	0
24	31834681	.	A	T	10	5	15	0	1	16	0	0
24	31836483	.	A	T	9	7	16	0	2	18	0	0
24	31838995	.	C	A	2	4	6	0	1	7	0	0
24	31839067	.	G	A	5	3	8	0	0	8	0	0
24	31842739	.	C	T	1	4	5	0	0	5	0	0
24	31846257	.	C	T	0	1	1	0	0	1	0	0
24	31846270	.	C	T	1	0	1	0	0	1	0	0
24	31952384	.	G	T	0	4	4	0	0	4	0	0
24	32152862	.	A	G	1	4	5	0	0	5	0	0
24	32173200	.	A	T	2	2	4	0	0	4	0	0
24	32173251	.	A	G	0	1	1	0	0	1	0	0
24	32173646	.	A	G	1	3	4	0	0	4	0	0
24	32176448	.	C	T	8	11	19	0	0	19	0	0
24	32176716	.	G	C	17	7	24	0	1	25	0	0
24	32184363	.	C	T	17	5	22	0	2	24	0	0
24	32184379	.	C	A	18	6	24	0	1	25	0	0
24	32187534	.	G	A	19	17	36	0	2	38	0	0
24	32192622	.	T	C	14	9	23	0	0	23	0	0
24	32406971	.	C	T	4	2	6	0	0	6	0	0
24	32472919	.	T	C	9	3	12	0	0	12	0	0
24	32473291	.	C	T	10	15	25	0	0	25	0	0
24	32473326	.	C	G	6	0	6	0	15	21	0	0
24	32473386	.	C	T	16	10	26	0	0	26	0	0
24	32473464	.	T	C	7	6	13	0	0	13	0	0
24	32473597	.	G	A	0	8	8	0	11	19	0	0
24	32473829	.	A	G	11	5	16	0	1	17	0	0
24	32474070	.	G	C	4	3	7	0	2	9	0	0
24	32474198	.	T	G	5	8	13	0	0	13	0	0
24	32474229	.	T	A	1	4	5	1	1	7	0	0
24	32474309	.	A	T	3	6	9	0	0	9	0	0
24	32474360	.	A	G	10	8	18	0	0	18	0	0
24	32474546	.	A	C	6	10	16	0	1	17	0	0
24	32517984	.	G	A	7	16	23	0	1	24	0	0
24	32519471	.	G	A	6	4	10	0	0	10	0	0
24	32519528	.	C	T	1	21	22	0	25	47	0	0
24	32522462	.	T	A	13	16	29	0	0	29	0	0
24	32522577	.	A	T	9	10	19	0	0	19	0	0
24	32534789	.	C	T	2	2	4	0	0	4	0	0
24	32534867	.	C	T	0	2	2	0	0	2	0	0
24	32547959	.	A	T	5	5	10	0	0	10	0	0
24	32650263	.	T	G	8	6	14	0	0	14	0	0
24	32658577	.	C	T	1	0	1	0	0	1	0	0
24	32664790	.	A	T	12	3	15	0	1	16	0	0
24	32664823	.	T	G	10	6	16	0	1	17	0	0
24	32668834	.	G	A	6	7	13	0	0	13	0	0
24	32668880	.	T	A	6	3	9	0	1	10	0	0
24	32674708	.	C	T	9	5	14	0	0	14	0	0
24	33234934	.	T	C	3	0	3	0	5	8	0	0
24	33283197	.	G	A	1	3	4	0	0	4	0	0
24	33290278	.	G	A	2	0	2	0	0	2	0	0
24	33290618	.	T	G	5	0	5	0	0	5	0	0
24	33291528	.	T	C	2	1	3	0	0	3	0	0
24	33291549	.	A	G	3	1	4	0	0	4	0	0
24	33400863	.	C	T	0	2	2	0	1	3	0	0
24	33403196	.	A	G	1	0	1	0	7	8	0	0
24	33836732	.	A	G	1	3	4	0	0	4	0	0
24	33836733	.	A	G	0	4	4	0	0	4	0	0
24	33836839	.	A	G	1	3	4	0	0	4	0	0
24	33836840	.	A	G	1	3	4	0	0	4	0	0
24	33837790	.	A	G	6	10	16	0	1	17	0	0
24	33837845	.	A	G	3	3	6	0	0	6	0	0
24	33837847	.	A	G	4	2	6	0	0	6	0	0
24	33837932	.	A	G	3	0	3	0	3	6	0	0
24	33838482	.	A	G	8	3	11	0	1	12	0	0
24	33838549	.	A	G	6	2	8	0	0	8	0	0
24	34974022	.	C	A	0	4	4	0	0	4	0	0
24	34974536	.	C	T	2	4	6	0	0	6	0	0
24	34976187	.	A	G	5	0	5	0	3	8	0	0
24	34976349	.	T	C	1	4	5	0	1	6	0	0
24	34976465	.	G	A	0	1	1	0	0	1	0	0
24	34979444	.	T	C	2	1	3	0	0	3	0	0
24	34991185	.	A	G	7	12	19	0	0	19	0	0
24	34993400	.	A	G	3	3	6	0	0	6	0	0
24	34993406	.	T	C	3	2	5	0	0	5	0	0
24	34996173	.	C	T	8	10	18	0	1	19	0	0
24	35000961	.	G	T	0	0	0	0	2	2	0	0
24	35002871	.	G	A	0	1	1	0	0	1	0	0
24	35196166	.	C	T	9	10	19	0	0	19	0	0
24	35196205	.	C	G	5	7	12	0	0	12	0	0
24	35213755	.	T	C	4	1	5	0	1	6	0	0
24	35213764	.	G	A	0	6	6	0	6	12	0	0
24	35216439	.	A	T	11	6	17	0	4	21	0	0
24	35216541	.	C	T	21	21	42	0	0	42	0	0
24	35216835	.	A	G	7	12	19	1	1	21	0	0
24	35217255	.	G	A	7	13	20	0	1	21	0	0
24	35217258	.	C	G	8	11	19	0	1	20	0	0
24	35217302	.	T	G	10	3	13	0	0	13	0	0
24	35217311	.	T	A	5	5	10	0	0	10	0	0
24	35218367	.	A	T	1	2	3	0	0	3	0	0
24	35219022	.	C	A	0	3	3	0	0	3	0	0
24	35219031	.	G	A	0	1	1	0	2	3	0	0
24	35720364	.	G	A	1	0	1	0	0	1	0	0
24	35726377	.	A	G	2	1	3	0	0	3	0	0
24	37623247	.	A	C	2	4	6	0	0	6	0	0
24	37636887	.	G	A	1	0	1	0	0	1	0	0
24	37649810	.	T	C	1	3	4	0	0	4	0	0
24	37650077	.	C	T	1	2	3	0	0	3	0	0
24	37653261	.	C	T	1	2	3	0	0	3	0	0
24	37655196	.	A	T	2	3	5	0	0	5	0	0
24	37655213	.	C	T	3	2	5	0	0	5	0	0
24	37685925	.	C	T	3	3	6	0	0	6	0	0
24	37685942	.	C	T	0	3	3	0	3	6	0	0
24	37686132	.	C	T	0	2	2	0	0	2	0	0
24	37689919	.	T	C	27	25	52	0	3	55	0	0
24	37692529	.	G	A	18	15	33	1	0	34	0	0
24	37695870	.	C	T	0	2	2	0	2	4	0	0
24	37696508	.	T	C	9	4	13	0	0	13	0	0
24	37704287	.	G	C	1	1	2	0	0	2	0	0
24	37705648	.	C	A	0	1	1	0	0	1	0	0
24	37708017	.	T	C	0	1	1	0	0	1	0	0
24	37708207	.	T	A	1	5	6	0	0	6	0	0
24	37718769	.	T	C	3	2	5	0	0	5	0	0
24	37721298	.	T	G	1	2	3	0	0	3	0	0
24	37722162	.	T	C	1	3	4	0	0	4	0	0
24	37723056	.	G	A	2	2	4	0	0	4	0	0
24	37723096	.	G	A	1	4	5	0	0	5	0	0
24	37723133	.	G	A	1	5	6	0	0	6	0	0
24	37723173	.	A	T	1	2	3	0	0	3	0	0
24	37723415	.	A	G	2	2	4	0	0	4	0	0
24	37723444	.	C	A	0	2	2	0	1	3	0	0
24	37724045	.	A	T	6	3	9	0	0	9	0	0
24	37724175	.	A	G	1	2	3	0	2	5	0	0
24	37724206	.	T	C	2	3	5	0	0	5	0	0
24	37724523	.	G	A	2	2	4	0	0	4	0	0
24	37724526	.	A	G	2	0	2	0	2	4	0	0
24	37724700	.	A	C	1	2	3	0	1	4	0	0
24	37725117	.	T	C	1	5	6	0	0	6	0	0
24	37725179	.	T	A	3	2	5	0	0	5	0	0
24	37725360	.	G	A	0	1	1	0	1	2	0	0
24	37725817	.	G	A	1	2	3	0	0	3	0	0
24	37725837	.	G	A	7	0	7	0	0	7	0	0
24	37725860	.	T	G	3	4	7	0	0	7	0	0
24	37726004	.	G	A	3	4	7	0	0	7	0	0
24	37726147	.	T	A	1	2	3	0	1	4	0	0
24	37726196	.	C	T	3	2	5	0	0	5	0	0
24	37726198	.	T	C	3	2	5	0	0	5	0	0
24	37726377	.	A	G	1	4	5	0	0	5	0	0
24	37726529	.	T	C	5	2	7	0	0	7	0	0
24	37726649	.	G	A	0	5	5	0	3	8	0	0
24	37726867	.	C	G	3	2	5	0	0	5	0	0
24	37726991	.	C	T	3	5	8	0	1	9	0	0
24	37726997	.	G	A	4	2	6	0	0	6	0	0
24	37781428	.	G	A	6	3	9	0	0	9	0	0
24	37781446	.	C	T	3	4	7	0	1	8	0	0
24	37791099	.	C	T	6	2	8	0	0	8	0	0
24	37793276	.	C	A	2	4	6	0	1	7	0	0
24	37793282	.	C	T	3	4	7	0	1	8	0	0
24	37793315	.	C	T	4	9	13	0	1	14	0	0
24	37793725	.	C	T	4	5	9	0	1	10	0	0
24	37818511	.	G	A	0	1	1	0	0	1	0	0
24	37823329	.	T	C	1	5	6	0	0	6	0	0
24	37888518	.	C	T	2	2	4	0	0	4	0	0
24	37895022	.	C	T	1	3	4	0	0	4	0	0
24	37896875	.	C	T	2	2	4	0	0	4	0	0
24	37897208	.	G	C	4	2	6	0	0	6	0	0
24	37899479	.	A	T	3	2	5	0	0	5	0	0
24	37900945	.	G	A	0	2	2	0	0	2	0	0
24	37901178	.	C	T	5	5	10	0	1	11	0	0
24	37941922	.	A	C	8	5	13	0	0	13	0	0
24	37942032	.	C	T	3	4	7	0	0	7	0	0
24	37942183	.	A	T	4	5	9	0	2	11	0	0
24	37942242	.	A	G	3	2	5	0	1	6	0	0
24	37942559	.	C	T	4	4	8	0	0	8	0	0
24	38073247	.	A	G	3	20	23	0	1	24	0	0
24	38073271	.	G	A	6	20	26	0	0	26	0	0
24	38073625	.	A	G	10	15	25	0	0	25	0	0
24	38073712	.	C	T	9	17	26	0	1	27	0	0
24	38073754	.	A	C	11	16	27	0	1	28	0	0
24	38180213	.	G	A	0	3	3	0	2	5	0	0
24	38189702	.	A	C	2	4	6	0	0	6	0	0
24	38190387	.	T	C	1	1	2	0	0	2	0	0
24	38190396	.	A	C	1	3	4	0	0	4	0	0
24	38190460	.	G	C	2	6	8	0	0	8	0	0
24	38190594	.	G	T	0	3	3	0	1	4	0	0
24	38190606	.	A	T	1	4	5	0	0	5	0	0
24	38190768	.	G	A	3	5	8	0	0	8	0	0
24	38190894	.	G	A	6	3	9	0	0	9	0	0
24	38190968	.	A	T	2	4	6	0	1	7	0	0
24	38191015	.	T	C	1	2	3	0	0	3	0	0
24	38191590	.	T	C	1	5	6	0	0	6	0	0
24	38191643	.	A	G	2	3	5	0	0	5	0	0
24	38191652	.	A	T	2	2	4	0	0	4	0	0
24	38191841	.	C	T	1	6	7	0	0	7	0	0
24	38369559	.	T	A	21	13	34	0	0	34	0	0
24	38369873	.	G	A	18	18	36	0	2	38	0	0
24	38370188	.	A	G	9	14	23	0	1	24	0	0
24	38370245	.	C	G	0	11	11	0	17	28	0	0
24	38370443	.	C	T	0	17	17	0	9	26	0	0
24	38370998	.	A	G	13	11	24	0	0	24	0	0
24	38371178	.	A	G	4	5	9	0	0	9	0	0
24	38384245	.	A	T	6	5	11	0	0	11	0	0
24	38815105	.	T	A	1	2	3	0	1	4	0	0
24	38815524	.	G	A	6	3	9	0	0	9	0	0
24	38816340	.	T	G	5	4	9	0	0	9	0	0
24	39051803	.	A	C	4	10	14	0	1	15	0	0
24	39051981	.	G	A	0	5	5	0	8	13	0	0
24	39052200	.	C	T	3	5	8	0	0	8	0	0
24	39052236	.	G	T	0	8	8	0	8	16	0	0
24	39052302	.	G	A	5	12	17	0	0	17	0	0
24	39052311	.	C	T	10	6	16	0	2	18	0	0
24	39052410	.	C	T	0	1	1	0	0	1	0	0
24	39073885	.	G	A	0	1	1	0	1	2	0	0
24	39078597	.	A	G	3	0	3	0	5	8	0	0
24	39137015	.	C	T	3	5	8	0	0	8	0	0
24	39137027	.	G	C	2	7	9	0	0	9	0	0
24	39137777	.	G	A	0	7	7	0	7	14	0	0
24	39137785	.	G	T	6	9	15	0	1	16	0	0
24	39153010	.	C	G	3	0	3	0	0	3	0	0
24	39268891	.	A	G	7	7	14	0	0	14	0	0
24	39272041	.	A	G	2	2	4	0	0	4	0	0
24	39274821	.	A	G	3	1	4	0	1	5	0	0
24	39277575	.	C	G	3	5	8	0	0	8	0	0
24	39287210	.	A	G	2	1	3	0	1	4	0	0
24	39298214	.	C	T	2	1	3	0	0	3	0	0
24	39309684	.	A	G	6	0	6	0	8	14	0	0
24	39309889	.	A	T	12	11	23	0	2	25	0	0
24	39310129	.	G	A	4	9	13	0	1	14	0	0
24	39310163	.	G	T	12	3	15	0	1	16	0	0
24	39310253	.	C	T	2	8	10	0	0	10	0	0
24	39321017	.	T	C	8	17	25	0	2	27	0	0
24	39322945	.	G	T	0	8	8	0	10	18	0	0
24	39323791	.	C	T	7	7	14	0	1	15	0	0
24	39333916	.	C	T	3	6	9	0	0	9	0	0
24	39334153	.	T	G	15	19	34	0	0	34	0	0
24	39334388	.	A	G	13	25	38	0	2	40	0	0
24	39334681	.	G	T	14	31	45	0	5	51	1	0
24	39334796	.	G	A	0	11	11	0	21	32	0	0
24	39353469	.	T	C	1	3	4	0	0	4	0	0
24	39510891	.	T	C	7	4	11	0	0	11	0	0
24	39511016	.	T	C	3	2	5	0	0	5	0	0
24	39511034	.	G	A	3	3	6	0	0	6	0	0
24	39514296	.	C	G	5	2	7	0	0	7	0	0
24	39518841	.	T	C	4	10	14	0	1	15	0	0
24	39530034	.	G	A	0	5	5	0	4	9	0	0
24	39533337	.	A	G	1	1	2	0	0	2	0	0
24	39533836	.	C	T	0	8	8	0	0	8	0	0
24	39533987	.	T	A	3	5	8	0	1	9	0	0
24	39537605	.	C	T	0	1	1	0	0	1	0	0
24	39544398	.	G	A	2	2	4	0	0	4	0	0
24	39549343	.	G	A	1	3	4	0	1	5	0	0
24	39556324	.	G	A	1	1	2	0	0	2	0	0
24	39559356	.	C	T	0	2	2	0	0	2	0	0
24	39576071	.	A	T	3	3	6	0	0	6	0	0
24	39576166	.	G	A	0	2	2	0	4	6	0	0
24	39576247	.	C	T	2	3	5	0	0	5	0	0
24	39579569	.	G	A	2	2	4	0	0	4	0	0
24	39579730	.	A	G	2	4	6	0	1	7	0	0
24	39579989	.	G	A	0	11	11	0	3	14	0	0
24	39586778	.	A	T	4	3	7	0	0	7	0	0
24	39587369	.	C	G	5	4	9	0	1	10	0	0
24	39593009	.	T	C	1	1	2	0	0	2	0	0
24	39593038	.	G	A	0	3	3	0	1	4	0	0
24	39595866	.	A	C	2	1	3	0	0	3	0	0
24	39606237	.	G	A	20	18	38	0	3	41	0	0
24	39610535	.	G	T	12	10	22	0	1	23	0	0
24	39615224	.	T	G	0	3	3	0	1	5	1	0
24	39616009	.	A	T	2	2	4	0	2	6	0	0
24	39616010	.	A	G	2	2	4	0	2	6	0	0
24	39616170	.	C	A	6	5	11	0	0	11	0	0
24	39616348	.	A	T	2	2	4	0	0	4	0	0
24	39632991	.	G	T	0	1	1	0	0	1	0	0
24	39633018	.	C	T	0	1	1	0	1	2	0	0
24	39638642	.	G	A	15	20	35	0	1	36	0	0
24	39642072	.	A	T	7	3	10	0	1	11	0	0
24	39642336	.	C	A	7	4	11	0	0	11	0	0
24	39642361	.	G	T	7	2	9	0	0	9	0	0
24	39644259	.	T	C	5	8	13	0	0	13	0	0
24	39646762	.	C	T	7	10	17	0	0	17	0	0
24	39647021	.	C	T	4	3	7	0	0	7	0	0
24	39647042	.	G	C	7	11	18	0	0	18	0	0
24	39648806	.	C	T	11	6	17	0	2	19	0	0
24	39651567	.	T	G	19	28	47	0	1	48	0	0
24	39651612	.	A	T	10	10	20	0	4	24	0	0
24	39653626	.	G	A	18	14	32	11	4	47	0	0
24	39660219	.	C	T	4	3	7	0	0	7	0	0
24	39661890	.	T	A	1	1	2	0	0	2	0	0
24	39661905	.	C	T	0	2	2	0	0	2	0	0
24	39662074	.	T	C	5	5	10	0	0	10	0	0
24	39663197	.	A	G	2	5	7	0	0	7	0	0
24	39667154	.	A	T	11	18	29	1	2	32	0	0
24	39667348	.	T	C	8	8	16	0	1	17	0	0
24	39742273	.	G	A	9	6	15	0	0	15	0	0
24	39742396	.	G	A	4	2	6	0	0	6	0	0
24	39742786	.	T	A	4	7	11	0	0	12	1	0
24	39742869	.	G	T	3	0	3	0	0	3	0	0
24	39771659	.	G	T	2	8	10	0	0	10	0	0
24	39771864	.	T	C	2	2	4	0	0	4	0	0
24	39771976	.	G	A	3	4	7	0	0	7	0	0
24	39771983	.	A	G	4	4	8	0	1	9	0	0
24	39778970	.	C	T	1	2	3	0	0	3	0	0
24	39778982	.	C	G	1	2	3	0	0	3	0	0
24	40001569	.	T	C	2	2	4	0	1	5	0	0
24	40001698	.	C	T	3	2	5	0	1	6	0	0
24	41473618	.	G	A	1	0	1	0	0	1	0	0
24	41473627	.	G	A	2	0	2	0	0	2	0	0
24	41742267	.	C	T	0	2	2	0	0	2	0	0
24	41994610	.	G	T	4	3	7	0	0	7	0	0
25	14095	.	C	T	6	5	11	0	0	11	0	0
25	15467	.	C	T	1	3	4	0	0	4	0	0
25	15542	.	T	C	8	5	13	0	1	14	0	0
25	127683	.	T	G	1	0	1	0	0	1	0	0
25	127770	.	G	T	0	3	3	0	2	5	0	0
25	127786	.	A	G	4	0	4	0	4	8	0	0
25	136788	.	T	C	10	14	24	0	1	25	0	0
25	136857	.	C	T	14	10	24	0	1	25	0	0
25	136986	.	C	T	20	12	32	0	2	34	0	0
25	137043	.	C	A	2	1	3	0	6	9	0	0
25	137492	.	C	A	6	6	12	1	1	14	0	0
25	146159	.	G	A	0	16	16	0	10	26	0	0
25	146282	.	C	T	7	10	17	0	1	18	0	0
25	146735	.	C	G	14	18	32	0	0	32	0	0
25	154440	.	C	T	5	4	9	0	1	10	0	0
25	156522	.	C	T	3	5	8	0	1	9	0	0
25	157151	.	T	C	4	1	5	0	0	5	0	0
25	157157	.	C	T	2	1	3	0	0	3	0	0
25	157996	.	C	A	1	4	5	0	1	6	0	0
25	158770	.	C	T	2	2	4	0	1	5	0	0
25	159543	.	T	C	11	6	17	0	0	17	0	0
25	187241	.	T	G	1	5	6	0	1	7	0	0
25	203396	.	T	C	8	9	17	0	1	18	0	0
25	237012	.	G	A	1	3	4	0	0	4	0	0
25	238295	.	G	C	0	0	0	0	3	3	0	0
25	238588	.	A	G	4	2	6	0	0	6	0	0
25	241694	.	C	T	3	3	6	0	0	6	0	0
25	241695	.	A	G	3	3	6	0	0	6	0	0
25	244180	.	C	T	3	2	5	0	1	6	0	0
25	265570	.	A	G	2	2	4	0	1	5	0	0
25	267138	.	T	C	1	0	1	0	4	5	0	0
25	315584	.	C	T	1	2	3	0	0	3	0	0
25	315590	.	T	A	1	2	3	0	0	3	0	0
25	398433	.	T	C	2	3	5	0	0	5	0	0
25	399984	.	G	T	3	2	5	0	0	5	0	0
25	400361	.	G	A	0	3	3	0	4	7	0	0
25	401039	.	C	T	1	3	4	0	0	4	0	0
25	401363	.	T	C	6	3	9	0	0	9	0	0
25	401558	.	C	A	10	3	13	0	0	13	0	0
25	401810	.	T	C	7	5	12	0	0	12	0	0
25	402152	.	T	C	3	2	5	0	1	6	0	0
25	402348	.	G	A	0	4	4	0	4	8	0	0
25	402359	.	T	G	3	0	3	0	3	6	0	0
25	403761	.	C	T	3	4	7	0	1	8	0	0
25	403935	.	T	G	1	8	9	0	0	9	0	0
25	404795	.	T	A	5	4	9	0	0	9	0	0
25	405253	.	G	A	6	6	12	0	2	14	0	0
25	450354	.	C	T	15	8	23	0	0	23	0	0
25	474938	.	T	A	15	19	34	0	3	37	0	0
25	485437	.	C	T	13	8	21	0	0	21	0	0
25	485612	.	C	T	1	13	14	0	13	27	0	0
25	485772	.	C	A	14	17	31	0	2	33	0	0
25	485802	.	T	C	21	12	33	0	1	34	0	0
25	485847	.	T	C	16	19	35	0	1	36	0	0
25	485863	.	A	T	17	15	32	0	1	33	0	0
25	486284	.	G	A	8	11	19	0	0	19	0	0
25	486472	.	A	T	6	7	13	0	1	14	0	0
25	486712	.	G	A	6	6	12	0	0	12	0	0
25	486895	.	C	T	8	16	24	0	0	24	0	0
25	487039	.	C	A	11	18	29	0	1	30	0	0
25	487045	.	C	T	18	12	30	0	0	30	0	0
25	487078	.	T	G	9	17	26	0	0	27	1	0
25	487931	.	A	C	1	2	3	0	1	4	0	0
25	487966	.	C	T	0	6	6	0	8	14	0	0
25	487975	.	A	T	8	4	12	0	2	14	0	0
25	488701	.	G	C	7	2	9	0	9	18	0	0
25	488817	.	G	T	7	7	14	0	2	16	0	0
25	489874	.	C	T	0	12	12	0	7	19	0	0
25	495366	.	G	A	0	2	2	0	1	3	0	0
25	498814	.	T	C	8	3	11	0	0	11	0	0
25	502608	.	G	A	4	3	7	0	1	8	0	0
25	504837	.	G	A	1	1	2	0	0	2	0	0
25	505214	.	C	T	8	4	12	0	0	12	0	0
25	509223	.	G	T	3	2	5	0	0	5	0	0
25	509625	.	G	A	5	8	13	0	1	14	0	0
25	509744	.	A	T	2	6	8	0	0	8	0	0
25	509899	.	C	T	6	9	15	0	0	15	0	0
25	509917	.	T	A	5	11	16	0	3	19	0	0
25	510000	.	T	G	3	3	6	0	0	6	0	0
25	510505	.	T	C	3	0	3	0	4	7	0	0
25	510514	.	T	A	4	4	8	0	1	9	0	0
25	510645	.	G	A	1	6	7	0	1	8	0	0
25	552560	.	G	A	3	4	7	0	0	7	0	0
25	663178	.	C	T	1	5	6	0	0	7	1	0
25	663284	.	G	A	0	2	2	0	3	5	0	0
25	664590	.	A	C	1	1	2	0	0	2	0	0
25	763774	.	T	C	2	3	5	0	0	5	0	0
25	771140	.	T	G	0	1	1	0	0	1	0	0
25	824627	.	C	T	0	2	2	0	1	3	0	0
25	824774	.	C	T	1	4	5	0	0	5	0	0
25	824807	.	G	A	6	2	8	0	0	8	0	0
25	824881	.	G	T	6	4	10	0	0	10	0	0
25	824909	.	G	A	6	4	10	0	0	10	0	0
25	825902	.	G	T	2	2	4	0	0	4	0	0
25	825968	.	A	C	5	4	9	0	0	9	0	0
25	826445	.	G	T	3	3	6	0	0	6	0	0
25	826722	.	C	T	2	3	5	0	0	5	0	0
25	826745	.	G	A	2	2	4	0	2	6	0	0
25	827246	.	A	G	1	3	4	0	0	4	0	0
25	827255	.	G	A	1	2	3	0	1	4	0	0
25	1048226	.	G	T	1	2	3	0	0	3	0	0
25	1048504	.	A	G	3	2	5	0	0	5	0	0
25	1048512	.	T	A	2	2	4	0	0	4	0	0
25	1048759	.	C	T	1	2	3	0	0	3	0	0
25	1049940	.	C	T	0	2	2	0	1	3	0	0
25	1089010	.	G	A	8	9	17	0	2	19	0	0
25	1089026	.	G	A	8	6	14	0	2	16	0	0
25	1091806	.	G	A	1	1	2	0	0	2	0	0
25	1092442	.	C	A	0	7	7	0	4	11	0	0
25	1092451	.	C	T	7	2	9	0	0	9	0	0
25	1093567	.	G	A	1	0	1	0	0	1	0	0
25	1101659	.	A	G	4	4	8	0	0	8	0	0
25	1101704	.	C	G	3	3	6	0	0	6	0	0
25	1101707	.	G	A	3	3	6	0	0	6	0	0
25	1102731	.	C	T	0	1	1	0	0	1	0	0
25	1103980	.	G	A	0	3	3	0	0	3	0	0
25	1106187	.	G	A	1	5	6	0	1	7	0	0
25	1106247	.	C	G	4	3	7	0	1	8	0	0
25	1107992	.	G	A	1	5	6	0	1	7	0	0
25	1108057	.	T	C	0	0	0	0	3	3	0	0
25	1108210	.	G	A	0	3	3	0	0	3	0	0
25	1124405	.	C	T	0	1	1	0	0	1	0	0
25	1124488	.	C	G	1	3	4	0	0	4	0	0
25	1132509	.	G	A	6	12	18	0	1	19	0	0
25	1132543	.	G	A	7	14	21	0	0	21	0	0
25	1132628	.	G	A	9	3	12	0	1	13	0	0
25	1132630	.	A	C	4	9	13	0	0	13	0	0
25	1220400	.	G	T	3	1	4	0	0	4	0	0
25	1304556	.	G	A	2	4	6	0	0	6	0	0
25	1335681	.	G	A	1	4	5	0	0	5	0	0
25	1335847	.	A	G	1	2	3	0	0	3	0	0
25	1338263	.	C	T	2	3	5	0	0	5	0	0
25	1338272	.	G	T	2	2	4	0	1	5	0	0
25	1338860	.	T	A	2	2	4	0	0	4	0	0
25	1339403	.	C	T	6	7	13	0	0	13	0	0
25	1339760	.	C	T	3	3	6	0	0	6	0	0
25	1339991	.	A	G	2	2	4	0	0	4	0	0
25	1340088	.	T	C	3	2	5	0	1	6	0	0
25	1340215	.	G	A	5	2	7	1	0	8	0	0
25	1355081	.	G	T	1	0	1	0	0	1	0	0
25	1355120	.	C	T	0	0	0	0	1	1	0	0
25	2253135	.	T	C	1	3	4	0	0	4	0	0
25	2264091	.	C	A	3	5	8	0	0	8	0	0
25	2264112	.	T	C	5	3	8	0	0	8	0	0
25	2264830	.	A	G	2	2	4	0	0	4	0	0
25	2264875	.	C	A	1	2	3	0	0	3	0	0
25	2264953	.	A	G	0	3	3	0	0	3	0	0
25	2273945	.	C	T	0	4	4	0	2	6	0	0
25	2276704	.	C	T	1	2	3	0	2	5	0	0
25	2276770	.	T	C	2	2	4	0	0	4	0	0
25	2276781	.	A	G	4	3	7	0	0	7	0	0
25	2276828	.	T	A	4	5	9	0	0	9	0	0
25	2276869	.	C	T	3	2	5	0	0	5	0	0
25	2282566	.	A	G	16	0	16	0	11	27	0	0
25	2282846	.	A	C	15	17	32	0	2	34	0	0
25	2286066	.	C	T	4	2	6	0	1	7	0	0
25	2286120	.	G	A	8	6	14	0	0	14	0	0
25	2286328	.	T	G	7	1	8	0	0	8	0	0
25	2286376	.	T	C	1	4	5	0	0	5	0	0
25	2286502	.	T	C	12	8	20	0	1	21	0	0
25	2286600	.	A	T	13	8	21	0	1	22	0	0
25	2286762	.	A	C	10	8	18	0	2	20	0	0
25	2286798	.	A	C	10	11	21	0	3	24	0	0
25	2286837	.	C	T	13	7	20	0	1	21	0	0
25	2286841	.	C	A	14	5	19	0	0	19	0	0
25	2702718	.	A	G	10	0	10	0	7	17	0	0
25	2702722	.	A	G	11	6	17	0	0	17	0	0
25	3245895	.	A	G	10	8	18	0	0	18	0	0
25	3391885	.	G	A	1	6	7	0	0	7	0	0
25	3743547	.	T	A	2	2	4	0	0	4	0	0
25	3881306	.	A	G	2	4	6	0	0	6	0	0
25	4689688	.	A	G	2	2	4	0	0	4	0	0
25	4977289	.	C	T	1	1	2	0	1	3	0	0
25	5676227	.	C	T	2	0	2	0	0	2	0	0
25	5676235	.	C	T	4	0	4	0	0	4	0	0
25	6206264	.	G	T	2	2	4	0	0	4	0	0
25	6206292	.	A	T	4	2	6	0	0	6	0	0
25	7229255	.	T	A	4	4	8	0	1	9	0	0
25	7229462	.	A	C	4	4	8	0	0	8	0	0
25	7230239	.	T	C	7	7	14	0	0	14	0	0
25	7324580	.	C	T	1	1	2	0	0	2	0	0
25	7327718	.	C	T	11	12	23	0	0	23	0	0
25	7333751	.	G	A	15	10	25	0	0	25	0	0
25	7333841	.	C	T	12	11	23	0	3	26	0	0
25	7334900	.	A	G	4	0	4	0	5	9	0	0
25	7334951	.	T	C	14	9	23	0	3	26	0	0
25	7334987	.	G	C	6	8	14	0	0	14	0	0
25	7336096	.	T	A	12	6	18	0	3	21	0	0
25	7336269	.	A	G	2	2	4	0	1	5	0	0
25	7399297	.	G	A	0	2	2	0	1	3	0	0
25	7401054	.	C	T	4	4	8	1	0	9	0	0
25	7401580	.	A	G	3	2	5	0	0	5	0	0
25	7410558	.	C	A	3	3	6	0	0	6	0	0
25	7410645	.	G	A	3	4	7	0	1	8	0	0
25	7412640	.	T	G	3	6	9	0	0	9	0	0
25	7412985	.	C	T	3	8	11	0	0	11	0	0
25	7413288	.	T	A	4	3	7	0	0	7	0	0
25	7413501	.	C	T	2	2	4	0	0	4	0	0
25	7428932	.	A	C	1	4	5	0	0	5	0	0
25	7428944	.	T	C	1	4	5	0	0	5	0	0
25	7431310	.	A	C	3	2	5	0	0	5	0	0
25	7431334	.	G	A	4	4	8	0	0	8	0	0
25	7431611	.	G	A	1	2	3	0	0	3	0	0
25	7431626	.	T	C	2	1	3	0	0	3	0	0
25	7445927	.	G	C	1	2	3	0	0	3	0	0
25	7454578	.	T	C	5	1	6	0	0	6	0	0
25	7454599	.	T	C	4	2	6	0	0	6	0	0
25	7456843	.	G	A	0	4	4	0	2	6	0	0
25	7456860	.	G	A	0	1	1	0	2	3	0	0
25	7458748	.	G	C	1	2	3	0	0	3	0	0
25	7477641	.	C	T	8	4	12	0	0	12	0	0
25	7487835	.	G	C	30	17	47	0	1	48	0	0
25	7488407	.	T	C	17	22	39	0	3	42	0	0
25	7488599	.	G	T	31	6	37	0	2	39	0	0
25	7488660	.	C	T	25	11	36	0	0	36	0	0
25	7488812	.	G	A	28	24	52	0	3	55	0	0
25	7488813	.	G	T	28	25	53	0	2	55	0	0
25	7489011	.	A	T	28	26	54	0	2	56	0	0
25	7489034	.	G	A	3	30	33	0	22	55	0	0
25	7489197	.	G	T	16	16	32	0	0	32	0	0
25	7492888	.	C	T	6	7	13	0	0	13	0	0
25	7492927	.	T	A	6	7	13	0	1	14	0	0
25	7494243	.	G	A	0	3	3	0	5	8	0	0
25	7496992	.	G	C	0	4	4	0	10	14	0	0
25	7500473	.	T	C	7	5	12	0	0	12	0	0
25	7501997	.	G	A	11	11	22	0	1	23	0	0
25	7502022	.	G	C	13	11	24	0	1	25	0	0
25	7502119	.	T	C	14	9	23	0	1	24	0	0
25	7502241	.	G	A	0	2	2	0	0	2	0	0
25	7502271	.	T	G	6	0	6	0	6	12	0	0
25	7891836	.	T	C	1	2	3	0	0	3	0	0
25	8478634	.	G	A	0	6	6	0	0	6	0	0
25	9678666	.	G	A	10	7	17	0	0	17	0	0
25	9679242	.	G	A	16	14	30	0	1	31	0	0
25	9679389	.	G	A	3	8	11	0	1	12	0	0
25	9679413	.	C	T	0	8	8	0	6	14	0	0
25	9679539	.	T	C	6	3	9	0	1	10	0	0
25	9680022	.	T	C	4	4	8	0	0	8	0	0
25	9680196	.	T	A	3	4	7	0	0	7	0	0
25	9805253	.	G	C	3	7	10	0	0	10	0	0
25	9805257	.	G	C	3	7	10	0	0	10	0	0
25	11894540	.	G	A	3	4	7	0	0	7	0	0
25	12401527	.	A	G	4	3	7	0	1	8	0	0
25	12406607	.	G	C	5	6	11	0	0	11	0	0
25	12406706	.	A	G	3	3	6	0	1	7	0	0
25	12409479	.	G	T	2	1	3	0	0	3	0	0
25	12412696	.	G	T	2	2	4	0	0	4	0	0
25	12494253	.	A	C	19	19	38	0	2	40	0	0
25	12504795	.	G	A	25	25	50	0	1	51	0	0
25	12504863	.	C	T	19	25	44	0	3	47	0	0
25	12504913	.	A	T	27	19	46	0	3	49	0	0
25	12504926	.	T	G	28	21	49	0	1	50	0	0
25	12505103	.	C	T	22	17	39	0	2	41	0	0
25	12505121	.	A	G	17	0	17	0	24	41	0	0
25	12505185	.	T	C	32	13	45	0	0	45	0	0
25	12505222	.	T	C	35	17	52	0	3	55	0	0
25	12505299	.	C	T	22	17	39	0	3	42	0	0
25	12505327	.	T	C	24	15	39	0	0	39	0	0
25	12505356	.	T	G	25	12	37	0	1	39	1	0
25	12505542	.	A	G	22	3	25	0	21	47	1	0
25	12657103	.	C	T	9	10	19	0	0	19	0	0
25	12689250	.	G	A	5	7	12	0	2	14	0	0
25	12689537	.	T	C	12	10	22	0	0	22	0	0
25	12689546	.	A	G	11	0	11	0	9	20	0	0
25	12689649	.	C	T	9	7	16	0	0	16	0	0
25	12695051	.	T	C	3	4	7	0	0	7	0	0
25	12695205	.	C	G	10	0	10	0	16	26	0	0
25	12695452	.	C	T	14	9	23	0	0	23	0	0
25	12695460	.	C	T	16	7	23	0	1	24	0	0
25	12695750	.	T	A	7	11	18	0	0	18	0	0
25	12695779	.	T	C	14	8	22	0	2	24	0	0
25	12695810	.	T	A	17	9	26	0	0	26	0	0
25	12707716	.	C	T	3	7	10	0	3	13	0	0
25	12707730	.	A	G	4	8	12	0	2	14	0	0
25	12707849	.	T	C	1	0	1	0	5	6	0	0
25	12719939	.	T	A	5	3	8	0	0	8	0	0
25	12719946	.	G	T	4	3	7	0	0	7	0	0
25	12725201	.	G	A	0	1	1	0	0	1	0	0
25	12730102	.	C	T	0	1	1	0	0	1	0	0
25	12730124	.	T	C	3	3	6	0	0	6	0	0
25	12730164	.	A	G	4	4	8	0	0	8	0	0
25	12730170	.	A	G	4	4	8	0	0	8	0	0
25	12765463	.	G	A	1	0	1	0	0	1	0	0
25	12798321	.	C	T	1	2	3	0	0	3	0	0
25	12798328	.	T	C	1	2	3	0	0	3	0	0
25	12798560	.	G	A	2	10	12	0	0	12	0	0
25	12804458	.	T	C	3	5	8	0	1	9	0	0
25	12804512	.	A	T	6	4	10	0	0	10	0	0
25	12808851	.	A	G	3	1	4	0	0	4	0	0
25	12811755	.	A	G	6	4	10	0	1	11	0	0
25	12811901	.	G	A	9	11	20	0	2	23	1	0
25	12816557	.	G	A	1	3	4	0	1	5	0	0
25	12816683	.	G	A	1	0	1	0	0	1	0	0
25	12816888	.	G	A	7	3	10	0	1	11	0	0
25	12816913	.	G	A	4	6	10	0	1	11	0	0
25	12819014	.	C	A	3	1	4	0	0	4	0	0
25	12819197	.	A	C	1	1	2	0	1	3	0	0
25	12819353	.	A	G	0	1	1	0	0	1	0	0
25	12822691	.	C	T	2	3	5	0	0	5	0	0
25	12823185	.	G	A	1	1	2	0	0	2	0	0
25	12853318	.	C	A	15	12	27	0	1	28	0	0
25	12853377	.	T	C	24	0	24	0	22	46	0	0
25	12853498	.	A	C	6	7	13	0	2	15	0	0
25	12853519	.	A	G	8	11	19	0	2	21	0	0
25	12853691	.	C	T	23	25	48	0	2	50	0	0
25	12853971	.	T	A	29	18	47	0	1	48	0	0
25	12854230	.	T	G	14	11	25	0	3	28	0	0
25	12856663	.	G	A	7	5	12	0	0	12	0	0
25	12858013	.	C	T	4	4	8	0	1	9	0	0
25	12858025	.	G	T	2	2	4	0	0	4	0	0
25	12859464	.	T	C	0	0	0	0	1	1	0	0
25	12866625	.	C	T	1	3	4	0	1	5	0	0
25	12871405	.	G	A	5	5	10	0	0	10	0	0
25	12901551	.	G	A	2	4	6	0	1	7	0	0
25	12906738	.	A	G	10	10	20	0	0	20	0	0
25	12906775	.	G	T	11	14	25	0	1	26	0	0
25	12906777	.	C	A	11	14	25	0	1	26	0	0
25	12934990	.	T	A	1	2	3	0	0	3	0	0
25	13069954	.	C	T	6	8	14	0	0	14	0	0
25	13069960	.	T	G	6	8	14	0	0	14	0	0
25	13105029	.	A	G	2	4	6	0	0	6	0	0
25	13105061	.	A	G	3	5	8	0	0	8	0	0
25	13332531	.	C	T	31	25	56	1	4	61	0	0
25	13332693	.	G	A	34	33	67	0	2	69	0	0
25	13332737	.	A	G	34	32	66	0	7	73	0	0
25	13333027	.	A	G	39	23	62	0	2	64	0	0
25	13333287	.	A	G	37	35	72	0	3	75	0	0
25	13333809	.	G	A	40	31	71	0	0	71	0	0
25	13333986	.	T	A	53	22	75	0	1	76	0	0
25	13333994	.	C	T	52	25	77	0	4	81	0	0
25	13334023	.	T	A	45	27	72	0	1	73	0	0
25	13334049	.	A	T	43	24	67	0	1	68	0	0
25	13334061	.	A	G	43	23	66	0	0	66	0	0
25	13334258	.	G	T	40	21	61	0	2	63	0	0
25	13334334	.	A	T	41	25	66	0	3	69	0	0
25	13334371	.	T	C	31	32	63	0	1	64	0	0
25	13334429	.	T	C	27	31	58	0	1	59	0	0
25	13334526	.	A	G	38	21	59	0	0	59	0	0
25	13334537	.	T	C	43	0	43	0	15	58	0	0
25	13334729	.	C	T	35	38	73	0	2	75	0	0
25	13334744	.	C	T	32	41	73	0	1	74	0	0
25	13334990	.	A	T	38	30	68	0	1	69	0	0
25	13335012	.	A	G	31	31	62	0	1	63	0	0
25	13335040	.	T	C	34	0	34	0	32	66	0	0
25	13335279	.	A	G	30	26	56	0	4	60	0	0
25	13335331	.	T	C	27	32	59	0	1	60	0	0
25	13335359	.	C	T	1	35	36	0	22	58	0	0
25	13335378	.	T	C	16	38	54	0	2	56	0	0
25	13335421	.	G	T	17	40	57	0	2	59	0	0
25	13335469	.	T	G	32	22	54	0	2	56	0	0
25	13335607	.	G	T	25	36	61	0	0	61	0	0
25	13335674	.	A	T	16	26	42	0	2	44	0	0
25	13335892	.	A	G	25	24	49	0	1	50	0	0
25	13336129	.	C	A	29	26	55	0	3	58	0	0
25	13336236	.	G	T	36	21	57	0	1	58	0	0
25	13336391	.	G	A	28	42	70	0	4	74	0	0
25	13336409	.	A	C	30	39	69	0	4	73	0	0
25	13336755	.	G	T	34	28	62	0	3	65	0	0
25	13336846	.	T	C	24	28	52	0	11	63	0	0
25	13336926	.	C	T	28	26	54	0	3	57	0	0
25	13336930	.	C	T	27	20	47	0	7	54	0	0
25	13337044	.	G	A	29	21	50	0	6	56	0	0
25	13337047	.	A	G	34	19	53	0	2	55	0	0
25	13337196	.	A	G	31	20	51	0	4	55	0	0
25	13351894	.	T	A	12	5	17	0	1	18	0	0
25	13351957	.	T	C	24	21	45	0	1	46	0	0
25	13352008	.	G	A	6	1	7	0	0	7	0	0
25	13353747	.	G	A	14	8	22	0	2	24	0	0
25	13406138	.	G	C	11	7	18	0	0	18	0	0
25	13469858	.	T	C	3	11	14	0	2	16	0	0
25	13470336	.	G	T	1	11	12	0	6	18	0	0
25	13470544	.	A	T	13	4	17	0	1	18	0	0
25	13471127	.	A	G	16	1	17	0	14	31	0	0
25	13479710	.	G	A	1	2	3	0	0	3	0	0
25	13485301	.	G	A	2	6	8	0	0	8	0	0
25	13490637	.	T	C	5	0	5	0	5	10	0	0
25	13510356	.	A	G	3	3	6	0	0	6	0	0
25	13510467	.	G	C	0	4	4	0	7	11	0	0
25	13525164	.	A	T	1	2	3	0	1	4	0	0
25	13525295	.	C	G	6	12	18	0	0	18	0	0
25	13525407	.	G	A	7	9	16	0	1	17	0	0
25	13525453	.	C	T	10	11	21	0	1	22	0	0
25	13525521	.	A	C	6	4	10	0	0	10	0	0
25	13525633	.	A	C	10	5	15	0	1	16	0	0
25	13525848	.	A	T	10	12	22	0	0	22	0	0
25	13525864	.	G	A	10	13	23	0	0	23	0	0
25	13525890	.	A	C	8	16	24	0	0	24	0	0
25	13526171	.	A	C	12	12	24	0	1	25	0	0
25	13528361	.	G	A	2	3	5	0	0	5	0	0
25	13529243	.	A	T	0	0	0	0	1	1	0	0
25	13529294	.	A	G	1	3	4	0	0	4	0	0
25	13559168	.	T	G	3	3	6	0	0	6	0	0
25	13559194	.	G	A	5	7	12	0	0	12	0	0
25	13559220	.	G	A	5	9	14	0	3	17	0	0
25	13559446	.	T	A	12	8	20	0	4	24	0	0
25	13559500	.	T	C	6	7	13	0	1	14	0	0
25	13559723	.	T	A	1	5	6	0	2	8	0	0
25	13559740	.	A	G	2	8	10	0	0	10	0	0
25	13559760	.	T	C	1	0	1	0	6	7	0	0
25	13559953	.	A	T	10	3	13	0	1	14	0	0
25	13560080	.	C	T	2	3	5	0	2	7	0	0
25	13560136	.	C	T	1	3	4	0	0	4	0	0
25	13560149	.	C	T	1	3	4	0	0	4	0	0
25	13560186	.	A	G	7	3	10	0	0	10	0	0
25	13560207	.	T	C	8	4	12	0	0	12	0	0
25	13560547	.	C	T	0	4	4	0	10	14	0	0
25	13560576	.	C	T	5	4	9	0	1	10	0	0
25	13560598	.	T	G	3	4	7	0	0	7	0	0
25	13560638	.	C	A	1	3	4	0	1	5	0	0
25	13560762	.	T	C	1	2	3	0	0	3	0	0
25	13561133	.	T	C	1	5	6	0	0	6	0	0
25	13561149	.	T	C	1	4	5	0	0	5	0	0
25	13561296	.	A	G	4	7	11	0	0	11	0	0
25	13562742	.	T	C	1	0	1	0	2	3	0	0
25	13643476	.	G	A	7	7	14	0	2	16	0	0
25	13651394	.	A	T	2	5	7	0	0	7	0	0
25	13658316	.	C	T	1	4	5	0	10	15	0	0
25	13658380	.	A	C	10	8	18	0	0	18	0	0
25	13658450	.	G	A	6	5	11	0	1	12	0	0
25	13658468	.	C	T	0	1	1	0	9	10	0	0
25	13658681	.	G	A	5	5	10	0	4	14	0	0
25	13658976	.	T	C	3	0	3	0	12	15	0	0
25	13659075	.	T	A	10	10	20	0	2	22	0	0
25	13672106	.	T	A	3	3	6	0	1	7	0	0
25	13672296	.	T	G	2	3	5	0	0	5	0	0
25	13672398	.	T	G	2	3	5	0	0	5	0	0
25	13672522	.	T	A	5	1	6	0	2	8	0	0
25	13672523	.	T	A	5	3	8	0	0	8	0	0
25	13672592	.	A	G	1	2	3	0	0	3	0	0
25	13673119	.	A	G	2	3	5	0	0	5	0	0
25	13673377	.	A	G	4	6	10	0	0	10	0	0
25	13673455	.	C	T	4	6	10	0	0	10	0	0
25	13673680	.	T	C	4	1	5	0	2	7	0	0
25	13673884	.	C	T	0	4	4	0	2	6	0	0
25	13674073	.	C	T	5	2	7	0	0	7	0	0
25	13674214	.	A	G	1	3	4	0	2	6	0	0
25	13674304	.	T	C	1	2	3	0	0	3	0	0
25	13676438	.	C	T	0	5	5	0	6	11	0	0
25	13677533	.	G	A	1	2	3	0	0	3	0	0
25	13685714	.	G	A	0	2	2	0	0	2	0	0
25	13689166	.	G	A	4	4	8	0	0	8	0	0
25	13689341	.	T	C	3	5	8	0	1	9	0	0
25	13689359	.	C	A	3	7	10	0	1	11	0	0
25	13689440	.	G	A	3	2	5	0	1	6	0	0
25	13689486	.	T	C	3	0	3	0	3	6	0	0
25	13689972	.	G	A	4	2	6	0	0	6	0	0
25	13698985	.	T	C	1	2	3	0	0	3	0	0
25	13699003	.	C	T	1	1	2	0	0	2	0	0
25	13741678	.	C	T	1	1	2	0	0	2	0	0
25	13744537	.	A	G	1	2	3	0	0	3	0	0
25	13744547	.	G	T	4	2	6	0	0	6	0	0
25	13744587	.	T	C	2	2	4	0	0	4	0	0
25	13745659	.	A	G	31	31	62	0	5	67	0	0
25	13745788	.	A	C	2	0	2	0	1	3	0	0
25	13747722	.	G	C	24	1	25	0	15	40	0	0
25	13747948	.	T	C	19	0	19	0	27	46	0	0
25	13750695	.	G	A	1	1	2	0	0	2	0	0
25	13754015	.	A	G	1	2	3	0	0	3	0	0
25	13754094	.	T	A	24	14	38	0	2	40	0	0
25	13754338	.	T	G	0	0	0	0	1	1	0	0
25	13754359	.	A	G	3	2	5	0	1	6	0	0
25	13759547	.	G	A	5	3	8	0	0	8	0	0
25	13762759	.	G	C	13	9	22	0	1	23	0	0
25	13763241	.	C	T	0	0	0	0	3	3	0	0
25	13763626	.	A	G	2	3	5	0	0	5	0	0
25	13766021	.	G	T	2	4	6	0	0	6	0	0
25	13766062	.	G	A	2	6	8	0	0	8	0	0
25	13767726	.	G	A	1	2	3	0	0	3	0	0
25	13773970	.	G	A	6	3	9	0	0	9	0	0
25	13774421	.	C	A	0	4	4	0	0	4	0	0
25	13776771	.	T	A	1	1	2	0	0	2	0	0
25	13776794	.	T	C	2	2	4	0	0	4	0	0
25	13776838	.	C	T	3	3	6	0	0	6	0	0
25	13778018	.	A	G	1	4	5	0	0	5	0	0
25	13782146	.	T	C	3	9	12	0	0	12	0	0
25	13787514	.	A	T	1	0	1	0	0	1	0	0
25	13790004	.	T	A	0	1	1	0	0	1	0	0
25	13791853	.	A	C	4	8	12	0	0	12	0	0
25	13795332	.	G	A	0	1	1	0	1	2	0	0
25	13795440	.	T	C	14	15	29	0	1	30	0	0
25	13795441	.	G	A	13	16	29	0	1	30	0	0
25	13795494	.	A	G	5	5	10	0	0	10	0	0
25	13796379	.	T	C	1	2	3	0	0	3	0	0
25	13799158	.	A	C	1	2	3	0	0	3	0	0
25	13799359	.	A	C	3	3	6	0	0	6	0	0
25	13799434	.	T	C	12	18	30	0	2	32	0	0
25	13799458	.	T	C	11	20	31	0	2	33	0	0
25	13799537	.	G	C	10	5	15	0	0	15	0	0
25	13799620	.	T	A	11	14	25	0	0	25	0	0
25	13799625	.	T	G	9	15	24	0	1	25	0	0
25	13799786	.	C	T	13	3	16	0	1	17	0	0
25	13799792	.	C	T	14	4	18	0	1	19	0	0
25	13799830	.	A	G	19	13	32	0	0	32	0	0
25	13801768	.	C	A	5	9	14	0	1	15	0	0
25	13802235	.	T	A	8	14	22	0	3	25	0	0
25	13802451	.	A	G	11	13	24	0	1	25	0	0
25	13803193	.	C	G	8	6	14	0	0	14	0	0
25	13803903	.	C	T	10	22	32	0	1	33	0	0
25	13804000	.	A	C	13	0	13	0	10	23	0	0
25	13804093	.	A	G	14	28	42	0	1	43	0	0
25	13804097	.	T	A	15	25	40	0	0	40	0	0
25	13804169	.	G	T	11	17	28	0	3	31	0	0
25	13808756	.	A	G	8	1	9	0	4	13	0	0
25	13813656	.	A	G	4	9	13	0	0	13	0	0
25	13813659	.	G	A	3	8	11	0	1	12	0	0
25	13813824	.	G	T	4	6	10	0	0	10	0	0
25	13813827	.	A	G	4	2	6	0	4	10	0	0
25	13815361	.	A	G	10	12	22	0	1	23	0	0
25	13816589	.	A	G	5	10	15	0	0	15	0	0
25	13817168	.	T	A	6	11	17	0	0	17	0	0
25	13846990	.	A	G	4	6	10	0	0	10	0	0
25	13847301	.	C	T	0	9	9	0	13	22	0	0
25	13848801	.	G	A	12	10	22	0	4	26	0	0
25	13848930	.	A	G	5	3	8	0	1	9	0	0
25	13856023	.	C	A	1	3	4	0	4	8	0	0
25	13862188	.	G	A	6	12	18	0	0	18	0	0
25	13862233	.	T	G	3	6	9	0	0	9	0	0
25	13869025	.	T	C	1	2	3	0	0	3	0	0
25	13871070	.	C	T	10	6	16	0	0	16	0	0
25	13871100	.	A	G	3	2	5	0	2	7	0	0
25	14017737	.	A	C	2	1	3	0	1	4	0	0
25	14017834	.	G	A	0	3	3	0	8	11	0	0
25	14017938	.	G	A	1	6	7	0	0	7	0	0
25	14018006	.	A	G	3	2	5	0	0	5	0	0
25	14018007	.	T	C	3	2	5	0	0	5	0	0
25	14018043	.	T	C	3	1	4	0	0	4	0	0
25	14019501	.	G	T	9	5	14	0	0	14	0	0
25	14019879	.	A	T	7	12	19	0	0	20	1	0
25	14020279	.	G	A	10	13	23	0	0	23	0	0
25	14033013	.	G	C	5	7	12	0	0	12	0	0
25	14033657	.	T	C	10	8	18	0	0	18	0	0
25	14033670	.	T	G	7	9	16	0	1	17	0	0
25	14033711	.	T	A	5	7	12	0	1	13	0	0
25	14033719	.	T	C	7	0	7	0	6	13	0	0
25	14033984	.	G	T	6	6	12	0	3	15	0	0
25	14034065	.	T	C	6	5	11	0	0	11	0	0
25	14034354	.	T	G	12	15	27	0	1	28	0	0
25	14034422	.	C	T	13	12	25	0	1	26	0	0
25	14034667	.	C	T	7	10	17	0	0	17	0	0
25	14034725	.	T	A	11	5	16	0	0	16	0	0
25	14034805	.	C	G	0	7	7	0	5	12	0	0
25	14034824	.	C	T	7	6	13	0	0	13	0	0
25	14034911	.	C	G	14	5	19	0	1	20	0	0
25	14034929	.	G	A	11	7	18	0	0	18	0	0
25	14035012	.	T	G	4	11	15	0	0	15	0	0
25	14035035	.	A	T	5	6	11	0	1	12	0	0
25	14035292	.	C	T	10	5	15	0	0	15	0	0
25	14035306	.	G	A	7	7	14	0	0	14	0	0
25	14035990	.	T	C	5	0	5	0	7	12	0	0
25	14036172	.	C	A	3	9	12	0	0	12	0	0
25	14036187	.	A	T	4	7	11	0	0	11	0	0
25	14036535	.	G	T	5	6	11	0	1	12	0	0
25	14086393	.	A	T	2	2	4	0	2	6	0	0
25	14361815	.	T	C	12	6	18	0	0	18	0	0
25	14362292	.	T	A	7	12	19	0	1	20	0	0
25	14362340	.	C	T	8	10	18	0	0	18	0	0
25	14362355	.	A	G	6	6	12	0	0	12	0	0
25	14363216	.	C	T	3	14	17	0	1	18	0	0
25	14363291	.	T	A	11	8	19	0	2	21	0	0
25	14363572	.	G	T	3	9	12	0	2	14	0	0
25	14365546	.	G	A	1	2	3	0	0	3	0	0
25	14365618	.	C	T	16	20	36	0	1	37	0	0
25	14365781	.	C	T	7	14	21	0	2	23	0	0
25	14365834	.	C	T	9	10	19	0	0	19	0	0
25	14366056	.	T	A	10	13	23	0	2	25	0	0
25	14369506	.	A	G	3	4	7	0	0	7	0	0
25	14369631	.	C	T	9	13	22	0	1	23	0	0
25	14369712	.	G	A	5	13	18	0	5	23	0	0
25	14369869	.	T	A	3	6	9	0	0	9	0	0
25	14381497	.	T	G	2	2	4	0	1	5	0	0
25	14381513	.	G	T	3	2	5	0	0	5	0	0
25	14381564	.	A	G	15	10	25	0	0	26	1	0
25	14381763	.	G	A	12	13	25	0	0	25	0	0
25	14384028	.	G	T	18	9	27	0	0	27	0	0
25	14387391	.	G	A	2	7	9	0	0	9	0	0
25	14387616	.	C	T	3	0	3	0	0	3	0	0
25	14392808	.	C	G	6	6	12	0	1	13	0	0
25	14392871	.	T	C	0	0	0	0	1	1	0	0
25	14393438	.	T	C	14	0	14	0	9	23	0	0
25	14393509	.	A	G	8	15	23	0	1	24	0	0
25	14393511	.	G	A	14	8	22	0	2	24	0	0
25	14398193	.	A	T	0	0	0	0	1	1	0	0
25	14398703	.	A	C	0	3	3	0	0	3	0	0
25	14398741	.	T	C	2	0	2	0	0	2	0	0
25	14401432	.	G	A	0	0	0	0	2	2	0	0
25	14403297	.	C	T	10	3	13	0	0	13	0	0
25	14403351	.	G	T	8	10	18	0	1	19	0	0
25	14403354	.	G	T	0	9	9	0	10	19	0	0
25	14403404	.	C	T	3	2	5	0	0	5	0	0
25	14406621	.	T	C	9	7	16	0	0	16	0	0
25	14511493	.	G	T	2	2	4	0	0	4	0	0
25	14518722	.	C	T	0	2	2	0	1	3	0	0
25	14694979	.	T	C	2	6	8	0	1	9	0	0
25	14695065	.	T	C	6	3	9	0	1	10	0	0
25	14695122	.	A	G	0	0	0	0	1	1	0	0
25	14700609	.	T	C	1	4	5	0	0	5	0	0
25	14702794	.	G	C	4	5	9	0	0	9	0	0
25	14734122	.	A	G	0	2	2	0	0	2	0	0
25	14738132	.	C	T	3	2	5	0	0	5	0	0
25	14738499	.	T	G	2	5	7	0	0	7	0	0
25	14738716	.	T	C	3	5	8	0	0	8	0	0
25	14738868	.	T	C	8	3	11	0	0	11	0	0
25	14897695	.	C	T	1	1	2	0	0	2	0	0
25	15029225	.	C	T	4	7	11	0	0	11	0	0
25	15029575	.	C	T	6	9	15	0	1	16	0	0
25	15031773	.	G	A	6	5	11	0	0	11	0	0
25	15031851	.	A	G	0	3	3	0	0	3	0	0
25	15032087	.	A	G	5	2	7	0	1	8	0	0
25	15038561	.	C	T	2	4	6	0	1	7	0	0
25	15278014	.	G	A	0	5	5	0	1	6	0	0
25	15284440	.	T	C	2	8	10	0	0	10	0	0
25	15284485	.	T	C	6	6	12	0	0	12	0	0
25	15284611	.	T	C	10	6	16	0	1	17	0	0
25	15284644	.	C	G	11	0	11	0	5	16	0	0
25	15284959	.	T	C	10	16	26	0	0	26	0	0
25	15284979	.	T	A	8	12	20	0	0	20	0	0
25	15285004	.	A	C	7	11	18	0	1	19	0	0
25	15285202	.	A	C	9	8	17	0	1	18	0	0
25	15285255	.	C	A	15	11	26	0	0	27	1	0
25	15285374	.	A	G	14	12	26	0	0	26	0	0
25	15285384	.	G	A	12	11	23	0	2	25	0	0
25	15342700	.	G	A	1	2	3	0	1	4	0	0
25	15347613	.	A	G	4	0	4	0	8	12	0	0
25	15347852	.	G	A	1	2	3	0	2	5	0	0
25	15348359	.	A	G	3	2	5	0	0	5	0	0
25	15349021	.	T	C	4	3	7	0	0	7	0	0
25	15349502	.	G	T	5	2	7	0	0	7	0	0
25	15350016	.	G	A	4	6	10	0	0	10	0	0
25	15350402	.	T	G	9	6	15	0	1	16	0	0
25	15350467	.	T	C	6	6	12	0	0	12	0	0
25	15354222	.	T	C	7	4	11	0	0	11	0	0
25	15408816	.	G	A	0	13	13	0	25	38	0	0
25	15408883	.	G	A	18	15	33	0	0	33	0	0
25	15408918	.	C	T	17	17	34	0	2	36	0	0
25	15408939	.	C	T	16	25	41	0	1	42	0	0
25	15408987	.	G	T	0	21	21	0	14	35	0	0
25	15409013	.	T	C	8	13	21	0	2	23	0	0
25	15430310	.	T	C	17	8	25	0	0	25	0	0
25	15430334	.	T	C	10	4	14	0	0	14	0	0
25	15434479	.	T	A	11	8	19	0	2	21	0	0
25	15434566	.	T	C	11	8	19	0	0	19	0	0
25	15438723	.	G	A	0	16	16	0	24	40	0	0
25	15450807	.	C	G	21	17	38	0	0	38	0	0
25	15465167	.	T	C	2	10	12	0	0	12	0	0
25	15472103	.	C	T	19	23	42	0	0	42	0	0
25	15478474	.	T	C	4	4	8	0	0	8	0	0
25	15480711	.	T	C	26	18	44	0	4	48	0	0
25	15480712	.	T	C	27	17	44	0	4	48	0	0
25	15481240	.	A	G	22	26	48	0	7	55	0	0
25	15481759	.	G	A	25	21	46	0	1	47	0	0
25	15482014	.	A	T	22	14	36	0	0	36	0	0
25	15482138	.	A	G	16	1	17	0	18	35	0	0
25	15482251	.	T	C	6	5	11	0	0	11	0	0
25	15482335	.	G	A	4	7	11	0	0	11	0	0
25	15648092	.	A	G	1	6	7	0	0	7	0	0
25	15694794	.	T	G	6	4	10	0	0	10	0	0
25	15694823	.	G	A	3	2	5	0	0	5	0	0
25	15769320	.	C	G	2	2	4	0	0	4	0	0
25	15792621	.	C	T	16	8	24	0	3	27	0	0
25	15792625	.	A	G	18	7	25	0	1	26	0	0
25	15799767	.	C	A	16	15	31	0	0	31	0	0
25	15800559	.	A	G	5	1	6	0	11	17	0	0
25	15800590	.	A	G	3	7	10	0	0	10	0	0
25	15800651	.	C	A	3	5	8	0	0	8	0	0
25	15841757	.	T	C	5	4	9	0	0	9	0	0
25	15841767	.	T	C	4	3	7	0	1	8	0	0
25	15857126	.	C	G	4	1	5	0	0	5	0	0
25	15857129	.	C	T	4	1	5	0	0	5	0	0
25	15888282	.	G	T	5	3	8	0	0	8	0	0
25	15893140	.	C	T	20	5	25	0	0	25	0	0
25	15905378	.	A	G	9	0	9	0	1	10	0	0
25	15905654	.	G	A	1	4	5	0	9	14	0	0
25	15998175	.	C	T	1	1	2	0	0	2	0	0
25	15998184	.	A	C	1	1	2	0	0	2	0	0
25	16027795	.	G	A	1	1	2	0	0	2	0	0
25	16032614	.	C	A	1	0	1	0	0	1	0	0
25	16035983	.	G	T	0	1	1	0	1	2	0	0
25	16036013	.	G	A	0	3	3	0	4	7	0	0
25	16036064	.	G	A	3	8	11	0	0	11	0	0
25	16042428	.	C	A	1	1	2	0	1	3	0	0
25	16044986	.	T	A	0	0	0	0	2	2	0	0
25	16045078	.	C	T	6	6	12	0	0	12	0	0
25	16045418	.	C	G	4	8	12	0	0	12	0	0
25	16045427	.	C	G	4	9	13	0	0	13	0	0
25	16045517	.	T	C	1	6	7	0	0	7	0	0
25	16045574	.	T	C	2	2	4	0	0	4	0	0
25	16045786	.	T	C	1	0	1	0	0	5	4	0
25	16045789	.	T	G	1	0	1	0	0	5	4	0
25	16046004	.	C	T	1	4	5	0	0	5	0	0
25	16046407	.	A	G	2	4	6	0	0	6	0	0
25	16046419	.	G	T	2	4	6	0	0	6	0	0
25	16046473	.	T	G	1	3	4	0	0	4	0	0
25	16046492	.	T	G	1	4	5	0	0	5	0	0
25	16963906	.	T	C	3	2	5	0	0	5	0	0
25	17479430	.	A	G	4	2	6	0	0	6	0	0
25	17479760	.	G	A	3	2	5	0	1	6	0	0
25	17485825	.	A	T	3	2	5	0	0	5	0	0
25	17490629	.	A	G	2	2	4	0	0	4	0	0
25	17495836	.	A	C	1	0	1	0	6	7	0	0
25	17495845	.	C	T	1	6	7	0	0	7	0	0
25	17503102	.	A	C	3	4	7	0	0	7	0	0
25	17503276	.	A	G	3	3	6	0	0	6	0	0
25	17511303	.	T	C	1	4	5	0	0	5	0	0
25	17590330	.	C	G	2	2	4	0	0	4	0	0
25	17590481	.	T	G	2	3	5	0	0	5	0	0
25	17590492	.	G	C	3	3	6	0	0	6	0	0
25	17596788	.	C	T	2	2	4	0	0	4	0	0
25	17605418	.	A	C	3	2	5	0	0	5	0	0
25	17605433	.	A	G	6	0	6	0	2	8	0	0
25	17606587	.	C	T	6	11	17	1	1	19	0	0
25	17610834	.	T	C	7	11	18	0	2	20	0	0
25	17610867	.	A	G	12	0	12	0	9	21	0	0
25	17611017	.	C	T	6	7	13	0	0	13	0	0
25	17611157	.	T	A	3	4	7	0	1	8	0	0
25	17611217	.	C	A	3	5	8	0	0	8	0	0
25	17749316	.	T	C	0	1	1	0	0	1	0	0
25	17807652	.	G	A	1	1	2	0	0	2	0	0
25	17825186	.	G	A	0	3	3	0	3	6	0	0
25	17847117	.	C	T	6	7	13	0	1	14	0	0
25	17847242	.	T	C	14	13	27	0	0	27	0	0
25	17847251	.	G	T	15	14	29	0	1	30	0	0
25	17847328	.	A	G	0	0	0	0	2	2	0	0
25	17849049	.	G	A	0	1	1	0	2	3	0	0
25	17849306	.	G	C	8	6	14	0	0	14	0	0
25	17849737	.	C	G	1	2	3	0	0	3	0	0
25	17850108	.	C	T	1	3	4	0	0	4	0	0
25	17850219	.	A	G	1	0	1	0	3	4	0	0
25	17862464	.	C	A	2	4	6	0	0	6	0	0
25	17864945	.	A	G	2	1	3	0	0	3	0	0
25	17870843	.	C	T	2	3	5	0	0	5	0	0
25	17870916	.	A	G	1	3	4	0	0	4	0	0
25	17887154	.	A	G	1	5	6	0	1	7	0	0
25	17891011	.	G	A	22	13	35	0	0	35	0	0
25	17891616	.	A	T	14	6	20	0	0	20	0	0
25	17891654	.	G	A	8	8	16	0	0	16	0	0
25	17892338	.	C	T	3	3	6	0	0	6	0	0
25	17892352	.	A	T	0	4	4	0	0	4	0	0
25	17892405	.	A	T	4	8	12	0	1	13	0	0
25	17892517	.	T	G	5	10	15	0	1	16	0	0
25	17892643	.	G	A	1	10	11	0	0	11	0	0
25	17901093	.	C	T	3	8	11	0	8	19	0	0
25	17904020	.	G	A	14	6	20	0	0	20	0	0
25	17904131	.	G	A	4	2	6	0	1	7	0	0
25	17905153	.	C	T	0	3	3	0	0	3	0	0
25	17905297	.	T	C	4	6	10	0	0	10	0	0
25	17905486	.	A	G	2	3	5	0	0	5	0	0
25	17907138	.	G	A	5	3	8	0	1	9	0	0
25	17918735	.	T	C	3	0	3	0	0	3	0	0
25	17920805	.	G	A	2	2	4	0	0	4	0	0
25	17920837	.	T	C	1	3	4	0	0	4	0	0
25	17921450	.	G	A	0	8	8	0	6	14	0	0
25	17924018	.	C	T	1	2	3	0	0	3	0	0
25	17924680	.	C	T	4	5	9	0	0	9	0	0
25	17924953	.	T	G	2	2	4	0	0	4	0	0
25	17925482	.	T	A	2	3	5	0	0	5	0	0
25	17932234	.	T	C	5	1	6	0	0	6	0	0
25	17932249	.	G	A	5	1	6	0	0	6	0	0
25	17932486	.	G	A	6	9	15	0	0	15	0	0
25	17934417	.	G	A	6	9	15	0	3	18	0	0
25	17934452	.	G	A	8	9	17	0	1	18	0	0
25	17934604	.	C	A	8	4	12	0	1	13	0	0
25	17934711	.	C	T	5	5	10	0	1	11	0	0
25	17934813	.	A	G	9	8	17	0	6	23	0	0
25	17938365	.	G	A	1	1	2	0	0	2	0	0
25	17953432	.	T	G	2	2	4	0	0	4	0	0
25	17954003	.	C	T	1	2	3	0	0	3	0	0
25	17955906	.	C	T	0	3	3	0	4	7	0	0
25	17955987	.	C	T	3	5	8	0	0	8	0	0
25	17956071	.	C	T	0	2	2	0	1	3	0	0
25	17967473	.	T	C	1	1	2	0	0	2	0	0
25	17967494	.	A	T	1	1	2	0	0	2	0	0
25	17977709	.	A	G	1	1	2	0	0	2	0	0
25	17990393	.	T	A	2	1	3	0	0	3	0	0
25	17998404	.	A	C	0	2	2	0	0	2	0	0
25	18031372	.	G	A	3	3	6	0	0	6	0	0
25	18039060	.	C	T	0	2	2	0	0	2	0	0
25	18039078	.	T	A	1	2	3	0	0	3	0	0
25	18048667	.	G	A	2	5	7	0	1	8	0	0
25	18052468	.	C	A	1	2	3	0	0	3	0	0
25	18052663	.	T	C	3	3	6	0	0	6	0	0
25	18052840	.	T	C	4	5	9	0	0	9	0	0
25	18052864	.	C	T	6	4	10	0	0	10	0	0
25	18053440	.	T	A	4	2	6	0	0	6	0	0
25	18053680	.	A	C	4	2	6	0	1	7	0	0
25	18054030	.	G	C	4	8	12	0	1	13	0	0
25	18054317	.	T	C	5	4	9	0	0	9	0	0
25	18054503	.	G	C	5	3	8	0	0	8	0	0
25	18054573	.	C	A	7	5	12	0	0	12	0	0
25	18054723	.	T	C	12	6	18	0	1	19	0	0
25	18054965	.	G	T	0	6	6	0	4	10	0	0
25	18326988	.	T	G	22	12	34	0	0	34	0	0
25	18327559	.	G	A	10	13	23	0	1	24	0	0
25	18328884	.	G	C	16	0	16	0	15	31	0	0
25	18440345	.	T	G	1	0	1	0	2	3	0	0
25	18443485	.	A	C	3	2	5	0	0	5	0	0
25	18575547	.	G	A	0	3	3	0	1	4	0	0
25	18576321	.	T	G	1	3	4	0	0	4	0	0
25	18576336	.	C	A	1	4	5	0	0	5	0	0
25	18577142	.	A	G	5	2	7	0	0	7	0	0
25	18587535	.	C	G	1	0	1	0	2	3	0	0
25	18672539	.	T	A	1	1	2	0	0	2	0	0
25	18715376	.	C	T	3	1	4	0	0	4	0	0
25	18720143	.	T	A	3	2	5	0	1	6	0	0
25	18720166	.	G	A	4	5	9	0	0	9	0	0
25	18720205	.	T	A	4	4	8	0	0	8	0	0
25	18720216	.	T	C	3	1	4	0	0	4	0	0
25	18885964	.	G	A	1	3	4	0	1	5	0	0
25	18886804	.	G	T	5	3	8	0	0	8	0	0
25	18886899	.	C	A	4	3	7	0	0	7	0	0
25	18887600	.	T	G	3	3	6	0	1	7	0	0
25	18887738	.	G	T	5	3	8	0	0	8	0	0
25	18887774	.	A	G	7	5	12	0	0	12	0	0
25	18890561	.	G	A	0	0	0	0	1	1	0	0
25	18890580	.	C	T	2	1	3	0	0	3	0	0
25	18890608	.	G	A	2	3	5	0	0	5	0	0
25	18895884	.	G	T	1	1	2	0	0	2	0	0
25	18899616	.	T	A	2	3	5	0	0	5	0	0
25	18899637	.	G	A	0	2	2	0	3	5	0	0
25	18902365	.	T	C	3	2	5	0	0	5	0	0
25	18903419	.	T	C	0	1	1	0	0	1	0	0
25	18903422	.	A	G	0	1	1	0	0	1	0	0
25	18906741	.	A	G	3	2	5	0	0	5	0	0
25	18906760	.	G	T	2	3	5	0	0	5	0	0
25	18906917	.	A	G	4	4	8	0	1	9	0	0
25	18907043	.	A	T	7	5	12	1	1	14	0	0
25	18907074	.	C	T	5	3	8	0	0	8	0	0
25	18907889	.	A	G	1	4	5	0	0	5	0	0
25	18908313	.	G	A	2	3	5	0	0	5	0	0
25	18908452	.	T	G	4	5	9	0	0	9	0	0
25	18908476	.	C	T	3	3	6	0	0	6	0	0
25	18908630	.	G	A	4	5	9	0	0	9	0	0
25	18908651	.	A	G	6	5	11	0	0	11	0	0
25	18908774	.	T	C	2	3	5	0	0	5	0	0
25	18908794	.	T	A	2	1	3	0	0	3	0	0
25	18908810	.	G	A	1	1	2	0	0	2	0	0
25	18909088	.	C	T	1	3	4	0	0	4	0	0
25	18909104	.	T	A	2	2	4	0	0	4	0	0
25	18948541	.	T	A	1	3	4	0	1	5	0	0
25	18948578	.	T	C	2	4	6	0	0	6	0	0
25	18951829	.	G	A	2	7	9	0	0	9	0	0
25	18952238	.	G	A	7	10	17	0	0	17	0	0
25	18953285	.	T	C	1	3	4	0	0	4	0	0
25	18953830	.	G	T	2	3	5	0	0	5	0	0
25	18959251	.	G	A	5	4	9	0	1	10	0	0
25	18962235	.	A	G	2	4	6	0	1	7	0	0
25	18963607	.	A	G	8	3	11	0	0	11	0	0
25	18970837	.	C	T	6	2	8	0	0	8	0	0
25	18976522	.	A	G	4	0	4	0	1	5	0	0
25	18976555	.	C	T	6	5	11	0	0	11	0	0
25	18977092	.	A	G	2	6	8	0	0	8	0	0
25	18977347	.	A	G	1	4	5	0	0	5	0	0
25	18977422	.	A	G	3	8	11	0	0	11	0	0
25	19013611	.	C	T	1	5	6	0	0	6	0	0
25	19016690	.	T	C	2	2	4	0	0	4	0	0
25	19016736	.	C	T	2	2	4	0	0	4	0	0
25	19018845	.	T	C	0	1	1	0	0	1	0	0
25	19019003	.	A	T	18	11	29	0	1	30	0	0
25	19020981	.	G	A	0	13	13	0	6	19	0	0
25	19021062	.	T	C	1	4	5	0	0	5	0	0
25	19021618	.	C	A	6	7	13	0	0	13	0	0
25	19021647	.	T	G	12	1	13	0	5	18	0	0
25	19021680	.	A	G	10	9	19	0	0	19	0	0
25	19026877	.	A	C	1	2	3	0	1	4	0	0
25	19026941	.	G	A	0	1	1	0	0	1	0	0
25	19028610	.	G	A	2	3	5	0	1	6	0	0
25	19028637	.	C	T	0	2	2	0	2	4	0	0
25	19030154	.	C	T	0	1	1	0	0	1	0	0
25	19051746	.	T	C	0	0	0	0	1	1	0	0
25	19051761	.	A	G	0	1	1	0	0	1	0	0
25	19060434	.	G	A	1	1	2	0	0	2	0	0
25	19063190	.	A	G	1	2	3	0	0	3	0	0
25	19097035	.	A	T	3	5	8	0	0	8	0	0
25	19097082	.	A	T	7	6	13	0	0	13	0	0
25	19097172	.	A	G	4	9	13	0	0	13	0	0
25	19097214	.	A	C	7	4	11	0	0	11	0	0
25	19097314	.	A	C	2	1	3	0	0	3	0	0
25	19098388	.	C	T	1	3	4	0	0	4	0	0
25	19100030	.	T	A	6	12	18	0	2	20	0	0
25	19100239	.	G	A	0	3	3	0	1	4	0	0
25	19100353	.	G	T	0	2	2	0	1	3	0	0
25	19100358	.	T	C	0	2	2	0	1	3	0	0
25	19107718	.	G	A	0	3	3	0	1	4	0	0
25	19111806	.	C	T	3	3	6	0	0	6	0	0
25	19111878	.	A	G	1	0	1	0	0	1	0	0
25	19112824	.	T	C	1	1	2	0	0	2	0	0
25	19112875	.	G	A	0	0	0	0	1	1	0	0
25	19117743	.	A	G	1	0	1	0	2	3	0	0
25	19117965	.	A	G	2	3	5	0	0	5	0	0
25	19118062	.	T	A	1	2	3	0	0	3	0	0
25	19120764	.	A	G	5	3	8	0	0	8	0	0
25	19120800	.	C	T	6	4	10	0	1	11	0	0
25	19121092	.	T	C	4	5	9	0	1	10	0	0
25	19121126	.	T	C	10	0	10	0	6	16	0	0
25	19121147	.	A	G	13	8	21	0	0	21	0	0
25	19178206	.	T	C	1	2	3	0	0	3	0	0
25	19179081	.	C	A	0	2	2	0	0	2	0	0
25	19179124	.	A	C	1	1	2	0	0	2	0	0
25	19180222	.	G	T	0	1	1	0	1	2	0	0
25	19181396	.	T	C	7	6	13	0	0	13	0	0
25	19181471	.	A	T	2	1	3	0	0	3	0	0
25	19184051	.	T	C	4	4	8	0	0	8	0	0
25	19184105	.	T	G	7	1	8	0	9	17	0	0
25	19184159	.	A	C	3	2	5	0	0	5	0	0
25	19188454	.	C	T	10	18	28	0	2	30	0	0
25	19189113	.	T	G	1	3	4	0	0	4	0	0
25	19189144	.	T	C	2	3	5	0	0	5	0	0
25	19189194	.	A	G	2	0	2	0	3	5	0	0
25	19189217	.	G	A	1	3	4	0	0	4	0	0
25	19189238	.	C	A	2	3	5	0	0	5	0	0
25	19189461	.	C	A	1	4	5	0	0	5	0	0
25	19189502	.	T	G	3	4	7	0	0	7	0	0
25	19190111	.	T	C	6	2	8	0	2	10	0	0
25	19190183	.	G	A	5	7	12	0	0	12	0	0
25	19190244	.	C	A	3	3	6	0	1	7	0	0
25	19190282	.	A	C	1	2	3	0	0	3	0	0
25	19190376	.	G	T	11	6	17	0	0	17	0	0
25	19190408	.	C	T	6	4	10	0	2	12	0	0
25	19190541	.	A	C	9	5	14	0	1	15	0	0
25	19190731	.	C	T	2	4	6	1	0	7	0	0
25	19190802	.	A	G	1	5	6	0	1	7	0	0
25	19191575	.	C	T	3	13	16	0	1	17	0	0
25	19191652	.	T	G	14	2	16	0	21	37	0	0
25	19191797	.	A	C	4	14	18	0	5	23	0	0
25	19191959	.	A	T	2	8	10	0	0	11	1	0
25	19357346	.	A	C	31	31	62	0	3	65	0	0
25	19357359	.	T	G	31	28	59	0	2	61	0	0
25	19357782	.	G	C	27	20	47	0	1	48	0	0
25	19357800	.	T	C	20	21	41	0	1	42	0	0
25	19357934	.	G	A	29	17	46	0	3	49	0	0
25	19358924	.	T	A	12	18	30	0	0	30	0	0
25	19359191	.	T	C	9	16	25	0	0	25	0	0
25	19359205	.	G	A	7	13	20	0	0	20	0	0
25	19361012	.	C	T	18	14	32	0	2	34	0	0
25	19363616	.	G	A	6	21	27	0	2	29	0	0
25	19363994	.	G	C	7	0	7	0	21	28	0	0
25	19364155	.	G	A	26	17	43	0	4	47	0	0
25	19364184	.	T	A	22	18	40	0	2	42	0	0
25	19364210	.	T	G	19	16	35	0	1	36	0	0
25	19364279	.	T	A	18	19	37	0	11	48	0	0
25	19364519	.	T	A	25	20	45	0	1	46	0	0
25	19364598	.	T	G	18	19	37	0	2	39	0	0
25	19364642	.	C	T	20	19	39	0	2	41	0	0
25	19364717	.	A	G	14	15	29	0	2	31	0	0
25	19365053	.	G	A	14	13	27	0	1	28	0	0
25	19365559	.	G	A	17	11	28	0	0	28	0	0
25	19365647	.	A	G	14	10	24	0	0	24	0	0
25	19366124	.	A	G	15	15	30	0	1	31	0	0
25	19366175	.	A	T	15	17	32	0	1	33	0	0
25	19366363	.	T	C	10	18	28	0	0	28	0	0
25	19366432	.	A	T	14	20	34	0	2	36	0	0
25	19366741	.	A	C	17	16	33	0	1	34	0	0
25	19367304	.	T	A	14	12	26	0	1	27	0	0
25	19367531	.	A	G	9	7	16	0	0	16	0	0
25	19368016	.	A	T	8	9	17	0	1	18	0	0
25	19368105	.	A	G	11	6	17	0	1	18	0	0
25	19368429	.	G	A	11	9	20	0	0	20	0	0
25	19368548	.	G	T	14	13	27	0	0	27	0	0
25	19368620	.	T	A	15	7	22	0	0	22	0	0
25	19368803	.	T	C	7	11	18	0	0	18	0	0
25	19369326	.	A	G	5	8	13	0	0	13	0	0
25	19369331	.	G	A	4	7	11	0	0	11	0	0
25	19369400	.	A	C	8	8	16	0	0	16	0	0
25	19369420	.	C	T	9	8	17	0	1	18	0	0
25	19369448	.	G	T	12	6	18	0	0	18	0	0
25	19369701	.	T	A	4	11	15	0	3	18	0	0
25	19369822	.	C	T	2	8	10	0	0	10	0	0
25	19369911	.	G	A	6	5	11	0	2	13	0	0
25	19369913	.	A	T	7	5	12	0	1	13	0	0
25	19370082	.	G	A	9	5	14	0	2	16	0	0
25	19370308	.	G	C	9	4	13	0	1	14	0	0
25	19370464	.	T	C	10	10	20	0	0	20	0	0
25	19370507	.	T	C	12	10	22	0	0	22	0	0
25	19370623	.	A	C	10	0	10	0	5	15	0	0
25	19370670	.	A	T	11	9	20	0	0	20	0	0
25	19371055	.	A	T	5	2	7	0	0	7	0	0
25	19371087	.	G	A	4	3	7	0	0	7	0	0
25	19372175	.	C	T	9	8	17	0	2	19	0	0
25	19372297	.	A	G	11	7	18	0	1	19	0	0
25	19372490	.	A	T	5	4	9	0	0	9	0	0
25	19372491	.	T	G	5	4	9	0	0	9	0	0
25	19372943	.	T	G	11	6	17	0	1	18	0	0
25	19373330	.	G	A	5	4	9	0	0	9	0	0
25	19373597	.	C	T	7	6	13	0	0	13	0	0
25	19374332	.	A	G	0	1	1	0	0	1	0	0
25	19374649	.	G	T	1	1	2	0	0	2	0	0
25	19374697	.	C	T	1	1	2	0	0	2	0	0
25	19433024	.	A	G	7	6	13	0	0	13	0	0
25	19433039	.	T	A	5	5	10	0	1	11	0	0
25	19433171	.	G	C	0	2	2	0	1	3	0	0
25	19442049	.	T	C	4	5	9	0	1	10	0	0
25	19443192	.	T	C	7	7	14	0	1	15	0	0
25	19485884	.	C	T	0	2	2	0	0	2	0	0
25	19486270	.	C	T	0	6	6	0	9	15	0	0
25	19486287	.	G	T	9	5	14	0	0	14	0	0
25	19486356	.	A	C	8	0	8	0	9	17	0	0
25	19512338	.	T	C	1	2	3	0	0	3	0	0
25	19528542	.	A	G	1	2	3	0	1	4	0	0
25	19531854	.	G	A	0	3	3	0	0	3	0	0
25	19531931	.	C	A	0	1	1	0	1	2	0	0
25	19535304	.	A	G	3	0	3	0	2	5	0	0
25	19560468	.	A	G	2	3	5	0	0	5	0	0
25	19560556	.	T	C	3	2	5	0	0	5	0	0
25	19560890	.	T	C	1	6	7	0	0	7	0	0
25	19586000	.	G	C	6	2	8	0	0	8	0	0
25	19586249	.	A	T	2	1	3	0	0	3	0	0
25	19588294	.	A	G	1	2	3	0	0	3	0	0
25	19591549	.	C	T	2	1	3	0	0	3	0	0
25	19593941	.	G	A	3	4	7	0	1	8	0	0
25	19593960	.	G	A	5	3	8	0	0	8	0	0
25	19610376	.	C	T	1	4	5	0	0	5	0	0
25	19610467	.	T	C	1	2	3	0	0	3	0	0
25	19610569	.	C	T	2	5	7	0	4	11	0	0
25	19610645	.	G	A	4	4	8	0	1	9	0	0
25	19667602	.	G	C	0	5	5	0	7	12	0	0
25	19667653	.	T	C	2	3	5	0	0	5	0	0
25	19667669	.	C	T	1	2	3	0	0	3	0	0
25	19675922	.	T	C	2	2	4	0	1	5	0	0
25	19675945	.	T	A	1	1	2	0	4	6	0	0
25	19730643	.	G	T	1	3	4	0	0	4	0	0
25	19730645	.	G	T	1	3	4	0	0	4	0	0
25	19741229	.	A	G	1	0	1	0	0	1	0	0
25	19741340	.	C	A	0	2	2	0	0	2	0	0
25	19743506	.	T	A	1	1	2	0	0	2	0	0
25	19743751	.	A	G	3	0	3	0	0	3	0	0
25	19746661	.	A	G	1	0	1	0	5	6	0	0
25	19747150	.	T	C	10	12	22	0	1	23	0	0
25	19747630	.	G	A	1	2	3	0	0	3	0	0
25	19865986	.	G	C	3	4	7	0	0	7	0	0
25	19866902	.	T	C	2	3	5	0	0	5	0	0
25	19867103	.	C	T	3	3	6	0	0	6	0	0
25	19867180	.	C	T	2	4	6	0	0	6	0	0
25	19867208	.	T	C	2	5	7	0	0	7	0	0
25	19867383	.	T	C	3	3	6	0	0	6	0	0
25	19867436	.	A	T	3	5	8	0	0	8	0	0
25	19867442	.	G	A	1	5	6	0	2	8	0	0
25	19867483	.	A	C	1	3	4	0	0	4	0	0
25	19867848	.	A	G	1	0	1	0	2	3	0	0
25	19924211	.	C	T	1	0	1	0	0	1	0	0
25	19931496	.	T	C	5	2	7	0	0	7	0	0
25	19931796	.	A	G	2	0	2	0	2	4	0	0
25	19931803	.	C	T	2	2	4	0	0	4	0	0
25	19932011	.	C	T	3	2	5	0	0	5	0	0
25	19932096	.	C	T	1	3	4	0	0	4	0	0
25	19932261	.	C	T	4	2	6	0	1	7	0	0
25	19932911	.	T	C	2	2	4	0	1	5	0	0
25	19933622	.	G	T	2	2	4	0	0	4	0	0
25	19934181	.	A	G	5	5	10	0	0	10	0	0
25	19934455	.	G	A	2	9	11	0	0	11	0	0
25	19934482	.	G	C	3	5	8	0	0	8	0	0
25	19934727	.	T	G	1	0	1	0	3	4	0	0
25	19934831	.	C	T	6	2	8	0	0	8	0	0
25	19934942	.	A	G	5	0	5	0	7	12	0	0
25	19934966	.	A	G	6	0	6	0	3	9	0	0
25	19935213	.	A	C	8	8	16	0	0	16	0	0
25	19935222	.	T	A	8	7	15	0	0	15	0	0
25	19935269	.	C	T	7	5	12	0	0	12	0	0
25	19935313	.	G	A	0	5	5	0	3	8	0	0
25	19935330	.	G	A	2	7	9	0	0	9	0	0
25	19935402	.	A	T	5	4	9	0	0	9	0	0
25	19935437	.	G	A	1	10	11	0	12	23	0	0
25	19935446	.	C	G	4	1	5	0	19	24	0	0
25	19935538	.	T	C	8	3	11	1	0	12	0	0
25	19935556	.	G	A	8	3	11	1	0	12	0	0
25	19935700	.	A	G	7	10	17	0	0	17	0	0
25	19936101	.	G	A	8	4	12	0	0	12	0	0
25	19936123	.	A	G	10	4	14	0	1	15	0	0
25	19936304	.	A	T	16	6	22	0	1	23	0	0
25	19936445	.	T	G	1	0	1	0	4	5	0	0
25	19955458	.	A	G	5	8	13	0	2	15	0	0
25	19955855	.	T	C	7	8	15	0	3	18	0	0
25	19955984	.	G	A	2	5	7	0	0	7	0	0
25	19956833	.	T	C	9	9	18	0	1	19	0	0
25	19957759	.	A	C	4	5	9	0	2	11	0	0
25	20003413	.	G	C	1	11	12	0	20	32	0	0
25	20016318	.	A	G	3	3	6	0	0	6	0	0
25	20121387	.	T	C	12	10	22	0	1	23	0	0
25	20121447	.	A	G	21	0	21	0	9	30	0	0
25	20121462	.	G	A	24	11	35	0	1	36	0	0
25	20125827	.	C	T	15	15	30	0	1	31	0	0
25	20125879	.	T	A	16	11	27	0	1	28	0	0
25	20125897	.	T	C	17	13	30	0	0	30	0	0
25	20125934	.	G	T	14	11	25	0	2	27	0	0
25	20125949	.	C	T	13	15	28	0	0	28	0	0
25	20126004	.	T	A	7	12	19	0	3	22	0	0
25	20126152	.	T	C	8	5	13	0	0	13	0	0
25	20126204	.	G	T	9	7	16	0	0	16	0	0
25	20126261	.	A	G	10	7	17	0	1	18	0	0
25	20126273	.	A	G	12	7	19	0	1	20	0	0
25	20126305	.	T	A	11	4	15	0	1	16	0	0
25	20126433	.	G	A	0	2	2	0	6	8	0	0
25	20126688	.	A	T	3	5	8	0	0	8	0	0
25	20126702	.	A	G	5	5	10	0	0	10	0	0
25	20126750	.	T	A	4	8	12	0	2	14	0	0
25	20126870	.	T	G	6	8	14	0	0	14	0	0
25	20126915	.	A	G	4	4	8	0	0	8	0	0
25	20225966	.	T	C	1	1	2	0	0	2	0	0
25	20229802	.	C	T	1	18	19	0	22	41	0	0
25	20229843	.	T	C	14	0	14	0	21	35	0	0
25	20229887	.	C	A	5	7	12	0	1	13	0	0
25	20231657	.	G	A	12	21	33	0	1	35	1	0
25	20241699	.	T	A	10	3	13	0	0	13	0	0
25	20241705	.	T	G	11	3	14	0	0	14	0	0
25	20241759	.	A	G	5	1	6	0	0	6	0	0
25	20241884	.	C	T	0	0	0	0	1	1	0	0
25	20244861	.	T	C	2	0	2	0	3	5	0	0
25	20245022	.	C	T	1	2	3	0	2	5	0	0
25	20245332	.	C	T	4	1	5	0	0	5	0	0
25	20247968	.	T	C	1	1	2	0	1	3	0	0
25	20252987	.	T	C	4	3	7	0	0	7	0	0
25	20253053	.	C	T	0	11	11	0	11	22	0	0
25	20253092	.	C	T	4	6	10	0	0	10	0	0
25	20290255	.	G	A	3	2	5	0	0	5	0	0
25	20290315	.	G	A	2	2	4	0	0	4	0	0
25	20358708	.	A	T	3	21	24	0	2	26	0	0
25	20358999	.	G	A	20	11	31	0	0	31	0	0
25	20359005	.	C	A	0	9	9	0	19	28	0	0
25	20359639	.	G	A	5	6	11	0	0	11	0	0
25	20366747	.	C	T	0	1	1	0	0	1	0	0
25	20378086	.	G	A	5	5	10	0	0	10	0	0
25	20378095	.	T	C	6	6	12	0	0	12	0	0
25	20381198	.	C	T	2	3	5	0	0	5	0	0
25	20388721	.	C	T	2	3	5	0	0	5	0	0
25	20388899	.	G	A	5	2	7	0	0	7	0	0
25	20389064	.	T	C	3	3	6	0	0	6	0	0
25	20389277	.	G	A	2	5	7	0	1	8	0	0
25	20389337	.	G	A	0	6	6	0	0	6	0	0
25	20389529	.	G	A	1	4	5	0	0	5	0	0
25	20389664	.	C	T	1	3	4	0	2	6	0	0
25	20389682	.	C	T	2	3	5	0	0	5	0	0
25	20390144	.	G	C	1	4	5	0	0	5	0	0
25	20482425	.	A	G	2	2	4	0	0	4	0	0
25	20602316	.	T	A	14	15	29	0	0	29	0	0
25	20602347	.	C	T	9	14	23	0	2	25	0	0
25	20602373	.	C	T	13	18	31	0	1	32	0	0
25	20602716	.	A	G	18	11	29	0	1	30	0	0
25	20668936	.	C	T	2	1	3	0	2	5	0	0
25	20669130	.	G	T	7	6	13	0	1	14	0	0
25	20669176	.	G	A	5	2	7	0	2	9	0	0
25	20669177	.	T	C	5	4	9	0	0	9	0	0
25	20669323	.	C	T	9	3	12	0	1	13	0	0
25	20669332	.	G	A	2	10	12	0	0	12	0	0
25	20669565	.	T	C	4	5	9	0	0	9	0	0
25	20669585	.	A	C	4	6	10	0	0	10	0	0
25	20669657	.	A	G	8	9	17	0	3	20	0	0
25	20669777	.	G	T	4	6	10	0	1	11	0	0
25	20669885	.	C	T	3	2	5	0	0	5	0	0
25	20669939	.	A	C	2	4	6	0	0	6	0	0
25	20670029	.	A	G	4	2	6	0	0	6	0	0
25	20670036	.	T	C	2	4	6	0	0	6	0	0
25	20670127	.	G	A	9	3	12	0	0	12	0	0
25	20670203	.	G	C	3	6	9	0	0	9	0	0
25	20670288	.	A	G	4	2	6	0	0	6	0	0
25	20670370	.	C	T	1	7	8	0	0	8	0	0
25	20670669	.	G	A	0	1	1	0	0	1	0	0
25	20671769	.	T	C	1	2	3	0	0	3	0	0
25	20671974	.	G	A	1	4	5	0	0	5	0	0
25	20672005	.	G	T	1	4	5	0	0	5	0	0
25	20672197	.	C	T	1	2	3	0	0	3	0	0
25	20672281	.	A	G	1	4	5	0	0	5	0	0
25	20672810	.	T	C	0	1	1	0	0	1	0	0
25	20701369	.	G	A	1	4	5	0	0	5	0	0
25	20701408	.	T	C	3	10	13	0	0	13	0	0
25	20701409	.	G	A	3	10	13	0	0	13	0	0
25	20701594	.	C	A	4	9	13	0	1	14	0	0
25	20716627	.	G	A	3	2	5	0	0	5	0	0
25	20723017	.	A	C	7	3	10	0	0	10	0	0
25	20726609	.	C	T	0	2	2	0	0	2	0	0
25	20726884	.	G	T	3	9	12	0	1	13	0	0
25	20726981	.	A	G	3	0	3	0	5	8	0	0
25	20730169	.	G	A	3	6	9	0	0	9	0	0
25	20730661	.	T	C	3	3	6	0	1	7	0	0
25	20730707	.	T	A	6	5	11	0	1	12	0	0
25	20775036	.	C	T	0	1	1	0	0	1	0	0
25	20997950	.	T	C	3	0	3	0	6	9	0	0
25	20998004	.	G	A	2	3	5	0	0	5	0	0
25	20998926	.	T	C	1	1	2	0	0	2	0	0
25	20998945	.	G	A	1	2	3	0	0	3	0	0
25	20999203	.	A	G	3	2	5	0	0	5	0	0
25	21064154	.	C	T	1	2	3	0	0	3	0	0
25	21064519	.	T	A	6	4	10	0	0	10	0	0
25	21065024	.	T	C	5	6	11	0	1	12	0	0
25	21065071	.	G	A	5	5	10	0	0	10	0	0
25	21065345	.	A	G	7	3	10	0	0	10	0	0
25	21066091	.	T	C	3	0	3	0	2	5	0	0
25	21075383	.	C	T	0	3	3	0	6	9	0	0
25	21075710	.	C	T	0	3	3	0	0	3	0	0
25	21085569	.	A	G	1	3	4	0	0	4	0	0
25	21085659	.	C	T	0	2	2	0	0	2	0	0
25	21115672	.	T	C	11	10	21	0	0	21	0	0
25	21115761	.	A	G	15	13	28	0	0	28	0	0
25	21117001	.	A	T	3	0	3	0	0	3	0	0
25	21119697	.	T	C	10	0	10	0	12	22	0	0
25	21121788	.	A	G	9	11	20	0	0	20	0	0
25	21122011	.	A	G	8	11	19	0	1	20	0	0
25	21122138	.	C	G	13	11	24	0	1	25	0	0
25	21122140	.	A	G	13	12	25	0	0	25	0	0
25	21122194	.	T	C	9	11	20	0	1	21	0	0
25	21122490	.	C	T	3	5	8	0	1	9	0	0
25	21122535	.	A	T	1	2	3	0	0	3	0	0
25	21122540	.	C	A	0	1	1	0	0	1	0	0
25	21124889	.	A	T	13	7	20	0	1	21	0	0
25	21125075	.	G	A	10	7	17	0	0	17	0	0
25	21125289	.	C	G	10	20	30	0	0	30	0	0
25	21125391	.	T	C	11	10	21	0	0	21	0	0
25	21125583	.	C	T	0	2	2	0	0	2	0	0
25	21125676	.	T	A	4	3	7	0	0	7	0	0
25	21126004	.	C	T	3	2	5	0	1	6	0	0
25	21129695	.	A	G	2	2	4	0	0	4	0	0
25	21133118	.	T	C	3	0	3	0	14	17	0	0
25	21134398	.	A	T	1	2	3	0	0	3	0	0
25	21134399	.	C	T	0	2	2	0	1	3	0	0
25	21134472	.	C	T	1	3	4	0	0	4	0	0
25	21134490	.	T	C	0	3	3	0	1	4	0	0
25	21153474	.	C	T	0	5	5	0	4	9	0	0
25	21153614	.	C	T	5	7	12	0	0	12	0	0
25	21153664	.	T	A	6	4	10	0	0	10	0	0
25	21153735	.	T	C	2	2	4	0	0	4	0	0
25	21156379	.	C	T	2	2	4	0	0	4	0	0
25	21194387	.	C	T	3	3	6	0	0	6	0	0
25	21194663	.	A	T	14	12	26	0	0	26	0	0
25	21194672	.	T	C	12	10	22	0	0	22	0	0
25	21206481	.	G	A	16	9	25	0	0	25	0	0
25	21208597	.	G	A	3	2	5	0	0	5	0	0
25	21222077	.	T	C	15	10	25	0	1	26	0	0
25	21222128	.	G	A	0	1	1	0	0	1	0	0
25	21229653	.	G	A	14	10	24	0	1	26	1	0
25	21239861	.	A	G	6	8	14	0	0	14	0	0
25	21239870	.	G	A	4	7	11	0	0	11	0	0
25	21240198	.	G	A	0	9	9	0	4	13	0	0
25	21240258	.	G	A	0	7	7	0	1	8	0	0
25	21253053	.	T	C	18	14	32	0	1	33	0	0
25	21253106	.	C	T	12	17	29	0	0	29	0	0
25	21277721	.	A	G	3	4	7	0	0	7	0	0
25	21277739	.	C	T	0	5	5	0	2	7	0	0
25	21277765	.	T	C	5	2	7	0	0	7	0	0
25	21277783	.	A	G	3	2	5	0	0	5	0	0
25	21277811	.	C	T	2	4	6	0	1	7	0	0
25	21277856	.	A	G	0	3	3	0	1	4	0	0
25	21277858	.	T	C	3	0	3	0	1	4	0	0
25	21277892	.	C	A	0	4	4	0	4	8	0	0
25	21277927	.	G	T	9	12	21	0	0	21	0	0
25	21278053	.	T	A	6	2	8	0	1	9	0	0
25	21278055	.	A	G	6	2	8	0	1	9	0	0
25	21278193	.	G	A	8	6	14	0	2	16	0	0
25	21298540	.	C	T	0	1	1	0	0	1	0	0
25	21324661	.	C	T	6	3	9	0	1	10	0	0
25	21324726	.	C	A	2	4	6	0	0	6	0	0
25	21324735	.	A	G	4	2	6	0	0	6	0	0
25	21342512	.	C	T	12	7	19	0	2	21	0	0
25	21343301	.	C	T	12	6	18	0	0	18	0	0
25	21343408	.	T	C	9	8	17	0	0	17	0	0
25	21343420	.	A	T	7	10	17	0	0	17	0	0
25	21343487	.	C	T	3	11	14	0	0	14	0	0
25	21343631	.	T	A	11	14	25	0	0	25	0	0
25	21343643	.	A	G	13	0	13	0	15	28	0	0
25	21343843	.	C	T	17	14	31	0	0	31	0	0
25	21343901	.	T	C	12	20	32	0	0	32	0	0
25	21344201	.	T	G	14	13	27	0	1	28	0	0
25	21344290	.	G	T	12	10	22	0	1	23	0	0
25	21344417	.	A	G	8	8	16	0	0	16	0	0
25	21492520	.	T	C	0	0	0	0	1	1	0	0
25	21492544	.	G	A	2	1	3	0	0	3	0	0
25	21518033	.	G	T	2	3	5	0	0	5	0	0
25	21518382	.	G	A	2	3	5	0	0	5	0	0
25	21518393	.	T	C	2	0	2	0	5	7	0	0
25	21518679	.	T	A	2	3	5	0	0	5	0	0
25	21523742	.	C	A	1	2	3	0	0	3	0	0
25	21532512	.	G	A	0	2	2	0	0	2	0	0
25	21565575	.	G	A	0	1	1	0	0	1	0	0
25	21726776	.	C	T	0	1	1	0	0	1	0	0
25	21738460	.	G	A	0	2	2	0	0	2	0	0
25	21739116	.	T	C	1	0	1	0	0	1	0	0
25	21743694	.	A	G	1	0	1	0	5	6	0	0
25	21743838	.	T	G	1	1	2	0	0	2	0	0
25	21743843	.	T	G	1	0	1	0	0	1	0	0
25	21782389	.	G	A	11	13	24	0	1	25	0	0
25	21832972	.	C	T	4	5	9	0	0	9	0	0
25	21835081	.	T	C	30	23	53	0	0	53	0	0
25	21835268	.	T	C	7	5	12	0	0	12	0	0
25	21838627	.	A	T	7	4	11	0	0	11	0	0
25	21838951	.	G	A	5	3	8	0	1	9	0	0
25	21838963	.	A	G	5	3	8	0	1	9	0	0
25	21838987	.	C	T	5	3	8	0	1	9	0	0
25	21843369	.	G	T	28	16	44	0	0	44	0	0
25	21860811	.	T	A	1	4	5	0	1	6	0	0
25	21860969	.	G	T	8	5	13	0	0	13	0	0
25	21860999	.	C	A	9	5	14	0	0	14	0	0
25	21861041	.	G	A	6	6	12	0	0	12	0	0
25	21861070	.	C	T	0	5	5	0	4	9	0	0
25	21861098	.	T	C	1	0	1	0	2	3	0	0
25	21863540	.	C	T	0	4	4	0	1	5	0	0
25	21863600	.	G	T	4	2	6	0	0	6	0	0
25	21863630	.	C	T	1	4	5	0	0	5	0	0
25	21863636	.	G	A	1	3	4	0	0	4	0	0
25	21866431	.	C	T	0	0	0	0	1	1	0	0
25	21893897	.	G	C	3	5	8	0	0	8	0	0
25	21893988	.	G	C	5	3	8	0	0	8	0	0
25	22079373	.	C	G	1	1	2	0	0	2	0	0
25	22085001	.	C	G	2	6	8	0	0	8	0	0
25	22085092	.	T	C	1	3	4	0	1	5	0	0
25	22086896	.	T	C	0	4	4	0	0	4	0	0
25	22087140	.	T	C	0	2	2	0	0	2	0	0
25	22095022	.	C	T	3	4	7	0	0	7	0	0
25	22095054	.	G	A	2	4	6	0	0	6	0	0
25	22095118	.	A	G	1	4	5	0	0	5	0	0
25	22095370	.	T	C	2	2	4	0	0	4	0	0
25	22232767	.	A	T	4	3	7	0	0	7	0	0
25	22232831	.	C	A	7	2	9	0	1	10	0	0
25	22232873	.	C	A	4	0	4	0	0	4	0	0
25	22288473	.	G	C	2	3	5	0	0	5	0	0
25	22291766	.	T	C	3	5	8	0	0	8	0	0
25	22291805	.	G	A	5	7	12	0	0	12	0	0
25	22292147	.	A	T	1	2	3	0	0	3	0	0
25	22292640	.	T	A	1	2	3	0	0	3	0	0
25	22292647	.	A	G	1	0	1	0	1	2	0	0
25	22361665	.	A	C	1	2	3	0	0	3	0	0
25	22635999	.	C	A	25	16	41	0	0	41	0	0
25	22636020	.	T	A	17	15	32	0	0	32	0	0
25	22636075	.	C	A	12	9	21	0	3	24	0	0
25	22636565	.	A	T	21	27	48	1	4	53	0	0
25	22637012	.	C	T	17	23	40	0	1	41	0	0
25	22637101	.	T	C	20	16	36	0	1	37	0	0
25	22637273	.	A	G	18	27	45	0	0	45	0	0
25	22637873	.	C	A	10	16	26	0	3	29	0	0
25	22638017	.	C	T	3	8	11	0	3	15	1	0
25	22638023	.	A	T	5	9	14	0	2	16	0	0
25	22638101	.	G	A	8	4	12	0	0	12	0	0
25	22730409	.	T	C	1	3	4	0	0	4	0	0
25	22737094	.	G	A	0	1	1	0	5	6	0	0
25	22737119	.	C	T	5	2	7	0	0	7	0	0
25	22743865	.	T	C	1	3	4	0	0	4	0	0
25	22743983	.	A	G	2	0	2	0	0	2	0	0
25	22748533	.	G	T	1	1	2	0	0	2	0	0
25	22748535	.	A	C	1	1	2	0	0	2	0	0
25	22748589	.	T	C	2	3	5	0	1	6	0	0
25	22748739	.	T	C	1	0	1	0	0	1	0	0
25	22754907	.	A	G	2	0	2	0	2	4	0	0
25	22754943	.	A	T	4	4	8	0	0	8	0	0
25	22763599	.	G	A	1	1	2	0	0	2	0	0
25	22779492	.	G	A	0	3	3	0	0	3	0	0
25	22784956	.	G	A	4	2	6	0	0	6	0	0
25	22807977	.	T	C	6	2	8	0	0	8	0	0
25	22808076	.	A	G	2	2	4	0	1	5	0	0
25	22821577	.	A	G	2	0	2	0	5	7	0	0
25	22829714	.	T	C	10	2	12	0	1	13	0	0
25	22829738	.	C	T	8	1	9	0	0	9	0	0
25	22834487	.	G	A	0	4	4	0	0	4	0	0
25	22853810	.	G	A	1	2	3	0	1	4	0	0
25	22854008	.	C	T	2	2	4	0	1	5	0	0
25	22854194	.	A	T	2	6	8	0	1	9	0	0
25	22854251	.	G	A	3	5	8	0	0	8	0	0
25	22854378	.	A	C	2	3	5	0	1	6	0	0
25	22854563	.	G	A	2	4	6	0	0	6	0	0
25	22854653	.	T	C	3	6	9	0	0	9	0	0
25	22979939	.	A	G	4	6	10	0	1	11	0	0
25	22979996	.	C	G	2	2	4	0	0	4	0	0
25	22980436	.	G	T	8	7	15	0	0	15	0	0
25	22981075	.	A	C	6	5	11	0	1	12	0	0
25	22981493	.	A	G	5	8	13	0	0	13	0	0
25	22981550	.	G	A	6	9	15	0	0	15	0	0
25	22981774	.	T	C	4	12	16	0	1	17	0	0
25	22982469	.	A	G	2	0	2	0	0	2	0	0
25	22982478	.	G	T	2	2	4	0	0	4	0	0
25	22982698	.	A	G	1	1	2	0	0	2	0	0
25	22982752	.	A	G	1	11	12	0	0	12	0	0
25	23015692	.	T	C	5	0	5	0	5	10	0	0
25	23359109	.	A	G	3	2	5	0	0	5	0	0
25	23359188	.	A	T	3	2	5	0	0	5	0	0
25	23403835	.	G	C	0	3	3	0	4	7	0	0
25	23419896	.	G	A	2	2	4	0	0	4	0	0
25	23419974	.	C	T	0	1	1	0	0	1	0	0
25	23448513	.	T	C	9	10	19	0	0	19	0	0
25	23448584	.	A	G	5	0	5	0	6	11	0	0
25	23449787	.	A	G	5	3	8	0	0	8	0	0
25	23449814	.	A	G	3	0	3	0	5	8	0	0
25	23450319	.	T	A	4	4	8	0	3	11	0	0
25	23450388	.	A	G	5	4	9	0	0	9	0	0
25	23450390	.	C	A	5	4	9	0	0	9	0	0
25	23450424	.	A	G	6	6	12	0	0	12	0	0
25	23525518	.	G	T	0	0	0	0	1	1	0	0
25	23525524	.	A	T	0	0	0	0	1	1	0	0
25	23525983	.	A	C	2	0	2	0	5	7	0	0
25	23555998	.	A	T	4	3	7	0	0	7	0	0
25	23556378	.	C	G	8	6	14	0	0	14	0	0
25	23556452	.	T	C	5	8	13	0	3	16	0	0
25	23562487	.	C	T	0	4	4	0	8	12	0	0
25	23571614	.	A	G	1	6	7	0	0	7	0	0
25	23630701	.	C	T	2	2	4	0	0	4	0	0
25	23636329	.	C	T	4	1	5	0	0	5	0	0
25	23636336	.	T	C	4	1	5	0	0	5	0	0
25	23643111	.	A	C	1	4	5	0	0	5	0	0
25	23643122	.	A	T	2	4	6	0	0	6	0	0
25	23643477	.	C	T	2	2	4	0	2	6	0	0
25	23643840	.	A	C	2	6	8	0	0	8	0	0
25	23777510	.	C	A	7	8	15	0	0	15	0	0
25	23777545	.	G	A	8	11	19	0	1	20	0	0
25	23815540	.	C	T	10	13	23	0	2	25	0	0
25	24039661	.	T	C	1	0	1	0	2	3	0	0
25	24040312	.	T	C	3	2	5	0	0	5	0	0
25	24041252	.	T	G	2	2	4	0	0	4	0	0
25	24055419	.	T	C	3	0	3	0	3	6	0	0
25	24179540	.	A	T	0	1	1	0	1	2	0	0
25	24237313	.	G	C	1	2	3	0	1	4	0	0
25	24237636	.	G	A	5	10	15	1	1	17	0	0
25	24238066	.	T	G	5	3	8	0	0	8	0	0
25	24238134	.	A	C	1	0	1	0	0	1	0	0
25	24238243	.	T	C	2	4	6	0	0	6	0	0
25	24240918	.	C	T	2	5	7	0	0	7	0	0
25	24241338	.	T	G	10	7	17	0	3	20	0	0
25	24241350	.	G	A	11	8	19	0	1	20	0	0
25	24242001	.	A	G	7	5	12	0	0	12	0	0
25	24242103	.	A	G	3	3	6	0	0	6	0	0
25	24242115	.	T	C	2	2	4	0	0	4	0	0
25	24247267	.	C	G	2	5	7	0	1	8	0	0
25	24247282	.	A	C	3	5	8	0	0	8	0	0
25	24247758	.	A	C	5	0	5	0	5	10	0	0
25	24247765	.	T	C	4	5	9	0	0	9	0	0
25	24247852	.	A	G	4	3	7	0	0	7	0	0
25	24247985	.	G	A	1	4	5	0	0	5	0	0
25	24593493	.	G	A	0	2	2	0	0	2	0	0
25	24593686	.	C	G	2	2	4	0	0	4	0	0
25	24593689	.	G	A	2	2	4	0	0	4	0	0
25	24593766	.	A	G	5	3	8	0	1	9	0	0
25	24593833	.	A	T	5	5	10	0	0	10	0	0
25	24594339	.	C	T	1	3	4	0	0	4	0	0
25	24596961	.	T	C	3	1	4	0	0	4	0	0
25	24596976	.	T	A	3	1	4	0	0	4	0	0
25	24605595	.	G	T	1	3	4	0	0	4	0	0
25	24605598	.	A	C	1	3	4	0	0	4	0	0
25	24607933	.	A	G	3	0	3	0	1	4	0	0
25	24609348	.	C	T	0	2	2	0	0	2	0	0
25	24609418	.	A	T	2	2	4	0	0	4	0	0
25	24609463	.	T	A	2	3	5	0	0	5	0	0
25	24609515	.	A	G	4	4	8	0	0	8	0	0
25	24610020	.	G	A	3	1	4	0	0	4	0	0
25	24610030	.	T	C	4	2	6	0	0	6	0	0
25	24610543	.	A	T	6	3	9	0	0	9	0	0
25	24610544	.	A	G	6	2	8	0	1	9	0	0
25	24736579	.	A	T	10	12	22	0	0	22	0	0
25	24736828	.	A	T	8	5	13	0	2	15	0	0
25	24736875	.	T	G	3	12	15	0	0	15	0	0
25	24736921	.	G	A	3	9	12	0	0	12	0	0
25	24737026	.	C	T	2	6	8	0	1	9	0	0
25	24737154	.	C	T	0	6	6	0	1	7	0	0
25	24737215	.	C	T	8	9	17	0	0	17	0	0
25	24737244	.	A	C	9	11	20	0	0	20	0	0
25	24737335	.	C	A	0	3	3	0	4	7	0	0
25	24737664	.	C	A	8	6	14	0	0	14	0	0
25	24737740	.	A	C	4	3	7	0	0	7	0	0
25	24737961	.	C	T	1	3	4	0	0	4	0	0
25	24738023	.	T	C	1	0	1	0	5	6	0	0
25	24738084	.	T	C	7	0	7	0	13	20	0	0
25	24738114	.	C	G	8	11	19	0	1	20	0	0
25	24738754	.	T	C	2	4	6	0	0	6	0	0
25	24738826	.	G	A	4	12	16	0	0	16	0	0
25	24739029	.	A	G	3	12	15	0	0	15	0	0
25	24752181	.	A	G	7	14	21	0	1	22	0	0
25	24763746	.	A	G	1	1	2	0	0	2	0	0
25	24763755	.	G	T	1	4	5	0	0	5	0	0
25	24770089	.	G	A	0	1	1	0	0	1	0	0
25	24792647	.	C	A	3	3	6	0	0	6	0	0
25	24805912	.	T	A	1	6	7	0	0	7	0	0
25	24826237	.	G	T	2	3	5	0	1	6	0	0
25	24826240	.	T	C	2	0	2	0	4	6	0	0
25	24826290	.	A	G	2	0	2	0	0	2	0	0
25	24847561	.	A	T	1	0	1	0	0	1	0	0
25	25058302	.	C	T	5	3	8	0	1	9	0	0
25	25123445	.	T	C	3	3	6	0	0	6	0	0
25	25124779	.	A	T	7	8	15	0	0	15	0	0
25	25127090	.	C	T	2	6	8	0	0	8	0	0
25	25127250	.	A	G	11	10	21	0	0	21	0	0
25	25130648	.	C	T	23	24	47	0	0	47	0	0
25	25130693	.	C	T	22	26	48	0	0	48	0	0
25	25130747	.	C	T	21	23	44	0	0	44	0	0
25	25130782	.	G	A	20	24	44	0	1	45	0	0
25	25130908	.	C	T	27	16	43	0	3	46	0	0
25	25130924	.	T	C	30	21	51	0	1	52	0	0
25	25130968	.	C	T	17	28	45	0	1	46	0	0
25	25131274	.	A	G	10	17	27	0	0	27	0	0
25	25131298	.	A	T	16	18	34	0	3	37	0	0
25	25131389	.	A	T	30	18	48	0	2	50	0	0
25	25131464	.	G	A	24	14	38	0	0	38	0	0
25	25131631	.	C	T	21	17	38	0	3	43	2	0
25	25131710	.	A	G	18	21	39	0	0	39	0	0
25	25132985	.	C	T	8	7	15	0	0	15	0	0
25	25133030	.	G	A	6	12	18	0	1	19	0	0
25	25133123	.	T	G	14	15	29	0	2	31	0	0
25	25133171	.	A	G	16	6	22	0	0	22	0	0
25	25133353	.	G	A	13	7	20	0	0	20	0	0
25	25133365	.	T	A	18	6	24	0	3	27	0	0
25	25133509	.	A	G	3	7	10	0	0	10	0	0
25	25142127	.	G	A	4	3	7	0	2	10	1	0
25	25142171	.	T	C	9	5	14	0	1	15	0	0
25	25396237	.	T	C	4	13	17	0	0	17	0	0
25	25396295	.	T	C	0	1	1	0	0	1	0	0
25	25488555	.	G	C	2	3	5	0	0	5	0	0
25	25488588	.	A	C	1	2	3	0	0	3	0	0
25	25536394	.	C	A	3	1	4	0	0	4	0	0
25	25538143	.	A	C	1	3	4	0	0	4	0	0
25	25538151	.	C	T	1	4	5	0	0	5	0	0
25	25538206	.	G	T	4	5	9	0	0	9	0	0
25	25538354	.	T	A	1	4	5	0	0	5	0	0
25	25538624	.	C	A	1	3	4	0	1	5	0	0
25	25538786	.	T	G	4	0	4	0	4	8	0	0
25	25538834	.	C	A	1	3	4	0	0	4	0	0
25	25539270	.	C	A	3	4	7	0	0	7	0	0
25	25539398	.	G	A	4	3	7	0	0	7	0	0
25	25539434	.	G	A	0	4	4	0	3	7	0	0
25	25539518	.	A	G	4	5	9	0	0	9	0	0
25	25539569	.	A	G	1	0	1	0	7	8	0	0
25	25539723	.	C	A	9	6	15	0	1	16	0	0
25	25539800	.	A	G	11	3	14	0	0	14	0	0
25	25539834	.	A	T	6	7	13	0	0	13	0	0
25	25539928	.	A	G	2	0	2	0	6	8	0	0
25	25540058	.	T	A	6	3	9	0	0	9	0	0
25	25540060	.	G	A	6	3	9	0	0	9	0	0
25	25540181	.	A	T	1	4	5	0	1	6	0	0
25	25540245	.	A	G	5	10	15	0	0	15	0	0
25	25540444	.	T	C	5	3	8	0	1	9	0	0
25	25540490	.	C	T	3	5	8	0	0	8	0	0
25	25540954	.	G	A	10	5	15	0	0	15	0	0
25	25545131	.	T	C	2	3	5	0	0	5	0	0
25	25545149	.	G	C	2	4	6	0	0	7	1	0
25	25545365	.	G	C	5	5	10	0	0	10	0	0
25	25545420	.	G	A	0	5	5	0	2	7	0	0
25	25545654	.	T	C	1	4	5	0	0	5	0	0
25	25545665	.	T	C	5	2	7	0	0	7	0	0
25	25545700	.	A	T	4	5	9	0	1	10	0	0
25	25545810	.	A	C	3	4	7	0	0	7	0	0
25	25545989	.	G	C	3	3	6	0	0	6	0	0
25	25546053	.	G	A	2	2	4	0	0	4	0	0
25	25547043	.	C	A	5	2	7	0	0	7	0	0
25	25547137	.	C	A	5	2	7	0	2	9	0	0
25	25565351	.	C	T	1	3	4	0	0	4	0	0
25	25565819	.	A	G	2	3	5	0	0	5	0	0
25	25592238	.	A	G	5	2	7	0	0	7	0	0
25	25736865	.	T	C	6	0	6	0	12	18	0	0
25	25736923	.	C	G	14	15	29	0	1	30	0	0
25	25736949	.	C	T	10	10	20	0	1	21	0	0
25	25737674	.	C	A	2	3	5	0	0	5	0	0
25	25737676	.	G	A	2	3	5	0	0	5	0	0
25	25737716	.	T	A	2	2	4	0	0	4	0	0
25	25766157	.	G	A	1	0	1	0	0	1	0	0
25	26738746	.	T	C	3	3	6	0	0	6	0	0
25	26738838	.	T	A	3	6	9	0	0	9	0	0
25	26738868	.	A	T	2	4	6	0	0	6	0	0
25	26743379	.	G	C	2	1	3	0	0	3	0	0
25	26744995	.	G	T	4	0	4	0	0	4	0	0
25	26752970	.	A	G	3	2	5	0	1	6	0	0
25	26823927	.	T	C	1	6	7	0	0	7	0	0
25	26824236	.	T	C	4	2	6	0	0	6	0	0
25	26824254	.	A	G	3	3	6	0	0	6	0	0
25	26829261	.	C	T	2	6	8	0	0	8	0	0
25	26830555	.	G	A	4	3	7	0	1	8	0	0
25	26831730	.	G	C	0	1	1	0	0	1	0	0
25	26831784	.	A	G	1	5	6	0	1	7	0	0
25	26831874	.	G	A	3	4	7	0	0	7	0	0
25	26831958	.	G	A	2	2	4	0	1	5	0	0
25	26853906	.	C	T	1	1	2	0	0	2	0	0
25	26853918	.	T	A	1	1	2	0	0	2	0	0
25	26867237	.	C	A	3	2	5	0	1	6	0	0
25	26867709	.	C	T	2	2	4	0	0	4	0	0
25	26867731	.	C	T	1	3	4	0	0	4	0	0
25	26867765	.	C	A	1	2	3	0	0	3	0	0
25	26879592	.	T	C	5	8	13	0	0	13	0	0
25	26884407	.	C	T	2	5	7	1	0	8	0	0
25	26888024	.	A	G	3	5	8	0	0	8	0	0
25	26888170	.	A	G	3	5	8	0	0	8	0	0
25	26908052	.	A	C	2	1	3	0	0	3	0	0
25	26909197	.	G	A	5	6	11	0	0	11	0	0
25	26909269	.	A	G	7	6	13	0	1	14	0	0
25	26909392	.	A	T	7	11	18	0	0	18	0	0
25	26909560	.	T	C	3	8	11	0	0	11	0	0
25	26909572	.	A	G	4	0	4	0	9	13	0	0
25	26911236	.	A	C	7	3	10	0	1	11	0	0
25	26911350	.	T	A	4	4	8	0	0	8	0	0
25	26911554	.	T	A	7	5	12	0	1	13	0	0
25	26911605	.	C	A	11	5	16	0	0	16	0	0
25	26911768	.	A	G	1	4	5	0	2	7	0	0
25	26911883	.	A	G	10	4	14	0	0	14	0	0
25	26912037	.	C	T	12	4	16	0	0	16	0	0
25	26923004	.	A	G	2	0	2	0	3	5	0	0
25	26923108	.	A	G	1	0	1	0	2	3	0	0
25	26923116	.	C	T	1	2	3	0	0	3	0	0
25	26923378	.	T	A	1	2	3	0	0	3	0	0
25	26923426	.	T	C	2	6	8	0	0	8	0	0
25	26923438	.	T	C	2	6	8	0	3	11	0	0
25	27010243	.	G	A	0	3	3	0	2	5	0	0
25	27174500	.	G	A	5	10	15	0	0	15	0	0
25	27174512	.	A	G	7	0	7	0	10	17	0	0
25	27237022	.	A	G	6	5	11	0	1	12	0	0
25	27493723	.	A	T	1	2	3	0	0	3	0	0
25	27500038	.	C	A	1	2	3	0	0	3	0	0
25	27543077	.	T	C	3	1	4	0	1	5	0	0
25	27543087	.	T	C	3	2	5	0	0	5	0	0
25	27544025	.	C	A	1	2	3	0	0	3	0	0
25	27715234	.	A	G	5	6	11	0	0	11	0	0
25	27715335	.	T	G	3	4	7	0	0	7	0	0
25	27715499	.	T	A	1	3	4	0	0	4	0	0
25	27716160	.	C	T	0	3	3	0	3	6	0	0
25	27716204	.	C	A	6	7	13	0	1	14	0	0
25	27716265	.	T	C	7	6	13	0	0	13	0	0
25	27716270	.	A	T	5	7	12	0	0	12	0	0
25	27716374	.	G	A	1	1	2	0	0	2	0	0
25	27718481	.	C	T	0	3	3	0	0	3	0	0
25	27718698	.	A	G	0	1	1	0	1	2	0	0
25	27718709	.	T	C	0	1	1	0	1	2	0	0
25	27718739	.	G	A	1	0	1	0	0	1	0	0
25	29110052	.	A	G	0	1	1	0	0	1	0	0
25	29212008	.	G	A	1	7	8	0	0	8	0	0
25	29212167	.	G	T	7	6	13	0	0	13	0	0
25	29212302	.	C	T	0	4	4	0	4	8	0	0
25	29212476	.	T	C	2	3	5	0	0	5	0	0
25	29212780	.	A	T	1	9	10	0	0	11	1	0
25	29212781	.	C	G	1	9	10	0	1	11	0	0
25	29212835	.	A	T	4	8	12	0	1	13	0	0
25	29212851	.	G	T	5	5	10	0	1	11	0	0
25	29212986	.	A	G	3	4	7	0	1	8	0	0
25	29213001	.	G	C	3	3	6	0	0	6	0	0
25	29318927	.	C	G	1	2	3	0	1	4	0	0
25	29319097	.	A	G	28	30	58	0	2	60	0	0
25	29319239	.	A	T	23	20	43	0	1	44	0	0
25	29319706	.	T	C	39	0	39	0	27	66	0	0
25	29319712	.	A	G	34	27	61	0	2	63	0	0
25	29319831	.	A	G	28	20	48	0	7	55	0	0
25	29319849	.	G	A	19	17	36	0	1	37	0	0
25	29329949	.	A	G	25	20	45	0	5	50	0	0
25	29427951	.	A	C	12	6	18	0	1	19	0	0
25	29427955	.	A	C	12	5	17	0	1	18	0	0
25	29428094	.	A	G	15	12	27	0	0	27	0	0
25	29428300	.	C	A	12	14	26	0	3	29	0	0
25	29428638	.	A	G	17	13	30	0	1	31	0	0
25	29428806	.	T	A	5	14	19	0	1	20	0	0
25	29428963	.	G	A	22	19	41	0	0	41	0	0
25	29429187	.	A	G	8	12	20	0	2	22	0	0
25	29429420	.	G	A	13	20	33	0	2	35	0	0
25	29429569	.	T	C	12	0	12	0	12	24	0	0
25	29429589	.	G	T	8	12	20	0	0	20	0	0
25	29429732	.	A	T	6	4	10	0	1	11	0	0
25	29429984	.	T	C	7	1	8	0	12	20	0	0
25	29444782	.	A	G	2	1	3	0	0	3	0	0
25	29662436	.	C	A	3	3	6	0	0	6	0	0
25	29662642	.	T	C	2	4	6	0	0	6	0	0
25	29662739	.	C	T	6	4	10	0	0	10	0	0
25	29664955	.	T	C	7	1	8	0	0	8	0	0
25	29665705	.	G	A	0	9	9	0	10	19	0	0
25	29666170	.	T	G	6	0	6	0	12	18	0	0
25	29666299	.	A	G	18	12	30	0	0	30	0	0
25	29666640	.	T	A	5	6	11	0	1	12	0	0
25	29666797	.	T	A	8	3	11	0	0	11	0	0
25	29694824	.	A	C	2	3	5	0	0	5	0	0
25	29697015	.	G	A	1	2	3	0	0	3	0	0
25	29697064	.	C	T	1	3	4	0	0	4	0	0
25	29697575	.	C	A	2	0	2	0	0	2	0	0
25	29698922	.	A	T	2	3	5	0	1	6	0	0
25	29699018	.	G	A	2	0	2	0	0	2	0	0
25	29699227	.	T	C	1	4	5	0	0	5	0	0
25	29699236	.	A	T	1	2	3	0	1	4	0	0
25	29701710	.	G	A	0	1	1	0	0	1	0	0
25	29711597	.	A	T	4	8	12	0	0	12	0	0
25	29711754	.	C	A	6	4	10	0	2	12	0	0
25	32216389	.	A	G	3	0	3	0	3	6	0	0
25	33239364	.	T	A	0	2	2	0	1	3	0	0
25	34421753	.	C	T	2	6	8	0	0	8	0	0
25	34426532	.	G	A	0	1	1	0	0	1	0	0
25	34455242	.	A	T	0	2	2	0	0	2	0	0
25	34456976	.	A	G	6	3	9	0	0	9	0	0
25	34457251	.	G	C	8	6	14	0	0	14	0	0
25	34457558	.	T	C	2	2	4	0	0	4	0	0
25	34457564	.	G	A	1	2	3	0	0	3	0	0
25	34457663	.	C	T	6	4	10	0	0	10	0	0
25	34457841	.	A	T	7	10	17	0	2	19	0	0
25	34458131	.	A	C	1	7	8	0	0	8	0	0
25	34458206	.	C	T	3	3	6	0	0	6	0	0
25	34487733	.	T	C	2	0	2	0	2	4	0	0
25	34487775	.	G	A	6	3	9	0	0	9	0	0
25	34487895	.	C	G	0	4	4	0	5	9	0	0
25	34488650	.	T	C	3	2	5	0	0	5	0	0
25	34489315	.	G	T	4	6	10	0	0	10	0	0
25	34511600	.	A	G	0	4	4	0	5	9	0	0
25	34511604	.	T	C	1	7	8	0	1	9	0	0
25	34511741	.	T	C	4	2	6	0	0	6	0	0
25	34511852	.	C	A	1	5	6	0	3	9	0	0
25	34511927	.	T	C	3	6	9	0	0	9	0	0
25	34647825	.	A	G	0	3	3	0	0	3	0	0
25	34649896	.	T	C	1	2	3	0	0	3	0	0
25	34649907	.	A	C	2	2	4	0	0	4	0	0
25	34662400	.	C	A	5	4	9	0	0	9	0	0
25	34662430	.	A	G	7	6	13	0	0	13	0	0
25	34667931	.	C	T	1	2	3	0	0	3	0	0
25	34670411	.	C	A	0	1	1	0	0	1	0	0
25	34697157	.	G	A	1	8	9	0	0	9	0	0
25	34703720	.	A	G	0	1	1	0	0	1	0	0
25	34706860	.	T	C	0	1	1	0	0	1	0	0
25	34714287	.	T	C	1	0	1	0	2	3	0	0
25	34718638	.	A	G	0	2	2	0	0	2	0	0
25	34718896	.	A	G	0	2	2	0	0	2	0	0
25	34728253	.	C	T	0	7	7	0	4	11	0	0
25	34728762	.	T	G	6	12	18	0	0	18	0	0
25	34728921	.	G	C	16	6	22	0	0	22	0	0
25	34728924	.	T	C	15	0	15	0	8	23	0	0
25	34752389	.	T	C	2	1	3	0	0	3	0	0
25	34762343	.	A	G	4	0	4	0	6	10	0	0
25	34762403	.	A	G	1	0	1	0	11	12	0	0
25	34763022	.	T	A	4	5	9	0	0	9	0	0
25	34763065	.	A	G	7	10	17	0	0	17	0	0
25	34763121	.	T	A	0	5	5	0	1	6	0	0
25	34763473	.	G	A	2	1	3	0	1	4	0	0
25	34765654	.	A	C	4	5	9	0	0	9	0	0
25	34765717	.	A	G	5	0	5	0	9	14	0	0
25	34794357	.	T	C	1	0	1	0	0	1	0	0
25	34797387	.	G	A	0	1	1	0	0	1	0	0
25	34798189	.	C	T	3	7	10	0	1	11	0	0
25	34798237	.	T	C	4	12	16	0	1	17	0	0
25	34798246	.	A	G	3	10	13	0	0	13	0	0
25	34799413	.	T	C	1	5	6	0	0	6	0	0
25	34799446	.	T	C	3	6	9	0	0	9	0	0
25	34801664	.	T	C	5	11	16	0	1	17	0	0
25	34801945	.	A	G	4	0	4	0	7	11	0	0
25	34801977	.	C	T	4	9	13	0	0	13	0	0
25	34802054	.	T	C	2	6	8	0	3	11	0	0
25	34802119	.	G	A	7	7	14	0	0	14	0	0
25	34802164	.	A	C	8	3	11	0	2	19	6	0
25	34802235	.	C	T	9	5	14	0	1	15	0	0
25	34802236	.	G	A	0	5	5	0	10	15	0	0
25	34802308	.	G	A	0	4	4	0	4	8	0	0
25	34802310	.	G	T	4	4	8	0	0	8	0	0
25	34802343	.	C	T	7	1	8	0	0	8	0	0
25	34802426	.	C	T	5	10	15	0	1	16	0	0
25	34802897	.	C	T	10	12	22	0	2	24	0	0
25	34802995	.	A	C	8	15	23	0	0	23	0	0
25	34803010	.	C	A	9	17	26	0	0	26	0	0
25	34803128	.	C	T	14	14	28	0	3	31	0	0
25	34803153	.	A	G	11	20	31	0	4	35	0	0
25	34803254	.	T	C	20	14	34	0	2	36	0	0
25	34803496	.	T	A	16	13	29	0	0	29	0	0
25	34803524	.	C	T	16	15	31	0	0	31	0	0
25	34803744	.	G	A	20	13	33	0	2	35	0	0
25	34803871	.	T	C	6	11	17	0	3	20	0	0
25	34803908	.	G	A	0	11	11	0	7	18	0	0
25	34803954	.	T	C	7	9	16	0	1	17	0	0
25	34833425	.	G	C	1	1	2	0	0	2	0	0
25	34835772	.	A	G	21	36	57	0	1	58	0	0
25	34841329	.	C	T	0	26	26	0	20	46	0	0
25	34844995	.	C	T	1	28	29	0	17	46	0	0
25	34845042	.	T	C	16	0	16	0	20	36	0	0
25	34845741	.	A	G	3	0	3	0	0	3	0	0
25	34845749	.	A	G	3	0	3	0	1	4	0	0
25	34851815	.	A	G	1	0	1	0	1	2	0	0
25	34859364	.	G	A	0	1	1	0	2	3	0	0
25	34859413	.	C	T	6	5	11	0	0	11	0	0
25	34859416	.	C	T	6	4	10	0	1	11	0	0
25	34889487	.	A	G	3	1	4	0	3	7	0	0
25	34889563	.	C	T	2	1	3	0	0	3	0	0
25	34911316	.	A	G	0	3	3	0	0	3	0	0
25	34911317	.	A	G	0	3	3	0	0	3	0	0
25	34911352	.	A	G	4	2	6	0	0	6	0	0
25	34956661	.	T	C	2	1	3	0	0	3	0	0
25	35574538	.	T	C	0	4	4	0	0	4	0	0
25	35574539	.	T	C	0	4	4	0	0	4	0	0
25	35713260	.	G	A	8	3	11	0	0	11	0	0
25	35713263	.	G	C	8	3	11	0	0	11	0	0
25	35763433	.	A	G	20	7	27	0	2	29	0	0
25	37336710	.	A	G	6	3	9	0	0	9	0	0
25	37470603	.	A	C	6	4	10	0	0	10	0	0
3	13937	.	C	T	0	2	2	0	0	2	0	0
3	13952	.	T	C	1	2	3	0	0	3	0	0
3	40604	.	A	G	2	4	6	0	0	6	0	0
3	40793	.	T	A	2	3	5	0	1	6	0	0
3	40948	.	G	A	3	2	5	0	0	5	0	0
3	41014	.	T	C	2	2	4	0	1	5	0	0
3	197661	.	T	C	1	2	3	0	0	3	0	0
3	198123	.	T	C	1	0	1	0	2	3	0	0
3	198129	.	A	G	1	2	3	0	0	3	0	0
3	214163	.	T	G	0	2	2	0	0	2	0	0
3	248989	.	C	T	1	3	4	0	1	5	0	0
3	311895	.	C	G	2	0	2	0	3	5	0	0
3	1096863	.	A	G	1	0	1	0	1	2	0	0
3	1101705	.	T	C	2	0	2	0	0	2	0	0
3	1101709	.	C	A	2	0	2	0	0	2	0	0
3	1101781	.	A	G	3	5	8	0	0	8	0	0
3	1101847	.	A	G	2	2	4	0	0	4	0	0
3	1101910	.	G	A	6	5	11	0	0	11	0	0
3	1101925	.	C	T	7	9	16	0	1	17	0	0
3	1102252	.	G	A	0	1	1	0	4	5	0	0
3	1104917	.	A	G	1	0	1	0	0	1	0	0
3	1105108	.	G	A	0	10	10	0	7	17	0	0
3	1105133	.	T	C	6	10	16	0	1	17	0	0
3	1105175	.	T	C	2	11	13	0	1	14	0	0
3	1105241	.	T	G	3	0	3	0	7	10	0	0
3	1105286	.	T	A	4	5	9	0	0	9	0	0
3	1105290	.	G	A	0	4	4	0	4	8	0	0
3	1105331	.	T	G	3	1	4	0	7	11	0	0
3	1105385	.	A	C	3	5	8	0	0	8	0	0
3	1105427	.	G	A	0	7	7	0	3	10	0	0
3	1105436	.	T	A	3	12	15	0	0	15	0	0
3	1105566	.	C	T	6	4	10	0	0	10	0	0
3	1105760	.	G	A	14	8	22	0	0	22	0	0
3	1105856	.	A	T	5	1	6	0	0	6	0	0
3	1105865	.	T	C	5	3	8	0	0	8	0	0
3	1105983	.	G	A	3	8	11	0	0	11	0	0
3	1105991	.	C	T	3	6	9	0	0	9	0	0
3	1106083	.	A	G	6	9	15	0	1	16	0	0
3	1106160	.	A	C	7	8	15	0	0	15	0	0
3	1106261	.	T	C	3	4	7	0	0	7	0	0
3	1107273	.	G	C	10	6	16	0	0	16	0	0
3	1113879	.	A	G	4	1	5	0	0	5	0	0
3	1116936	.	G	A	1	9	10	0	11	21	0	0
3	1117574	.	G	A	5	4	9	0	0	9	0	0
3	1118431	.	C	T	5	5	10	0	1	11	0	0
3	1122833	.	T	G	10	0	10	0	9	19	0	0
3	1122908	.	A	G	12	7	19	0	2	21	0	0
3	1123280	.	T	C	3	6	9	0	0	9	0	0
3	1123335	.	G	A	0	18	18	0	9	27	0	0
3	1123598	.	C	T	7	10	17	0	0	17	0	0
3	1123848	.	G	A	0	4	4	0	5	9	0	0
3	1123860	.	A	T	4	3	7	0	1	8	0	0
3	1126605	.	A	G	7	0	7	0	4	11	0	0
3	1126632	.	A	G	0	0	0	0	2	2	0	0
3	1129313	.	C	T	22	13	35	0	0	35	0	0
3	1129325	.	C	T	21	12	33	0	1	34	0	0
3	1129364	.	G	A	13	12	25	0	3	28	0	0
3	1129768	.	T	A	19	17	36	0	0	36	0	0
3	1129840	.	G	A	0	9	9	0	32	41	0	0
3	1130299	.	C	A	8	8	16	0	0	16	0	0
3	1130481	.	T	C	17	18	35	0	7	42	0	0
3	1130501	.	T	C	22	10	32	0	3	35	0	0
3	1130528	.	C	T	16	6	22	0	6	28	0	0
3	1130620	.	G	A	10	8	18	0	1	20	1	0
3	1130623	.	G	A	9	10	19	0	1	20	0	0
3	1130716	.	A	T	17	5	22	0	1	23	0	0
3	1133305	.	T	C	7	0	7	0	12	19	0	0
3	1133480	.	T	A	8	11	19	0	0	19	0	0
3	1133573	.	A	G	8	5	13	0	0	13	0	0
3	1133780	.	T	C	5	6	11	0	0	11	0	0
3	1133805	.	T	C	5	5	10	0	0	10	0	0
3	1133815	.	T	A	5	4	9	0	1	10	0	0
3	1133861	.	G	C	4	7	11	0	0	11	0	0
3	1133894	.	G	C	3	8	11	0	1	12	0	0
3	1133909	.	A	C	3	8	11	0	0	11	0	0
3	1135321	.	A	G	2	2	4	0	0	4	0	0
3	1135550	.	T	C	10	0	10	0	12	22	0	0
3	1135598	.	C	T	11	11	22	0	0	22	0	0
3	1141878	.	A	G	5	5	10	0	0	10	0	0
3	1141894	.	T	C	5	0	5	0	5	10	0	0
3	1142074	.	T	C	2	1	3	0	8	11	0	0
3	1142089	.	T	C	4	8	12	0	0	12	0	0
3	1146457	.	T	A	5	2	7	0	0	7	0	0
3	1150419	.	G	A	0	3	3	0	4	7	0	0
3	1150462	.	G	T	9	4	13	0	0	13	0	0
3	1150463	.	G	T	8	3	11	0	2	13	0	0
3	1155326	.	A	G	3	0	3	0	3	6	0	0
3	1175788	.	A	G	4	4	8	0	0	8	0	0
3	1178562	.	G	A	0	6	6	0	5	11	0	0
3	1178605	.	A	G	0	0	0	0	1	1	0	0
3	1179097	.	T	C	9	5	14	0	0	14	0	0
3	1179609	.	G	C	2	0	2	0	0	2	0	0
3	1187069	.	C	T	0	3	3	0	9	12	0	0
3	1187075	.	A	G	10	4	14	0	1	15	0	0
3	1187174	.	A	G	7	1	8	0	0	8	0	0
3	1187177	.	T	C	7	0	7	0	1	8	0	0
3	1191482	.	C	T	17	8	25	0	0	25	0	0
3	1191573	.	A	C	11	12	23	0	0	23	0	0
3	1191685	.	A	G	24	4	28	0	1	29	0	0
3	1191965	.	T	C	19	0	19	3	14	36	0	0
3	1191972	.	G	A	18	14	32	1	1	34	0	0
3	1192158	.	T	C	8	4	12	0	1	13	0	0
3	1192582	.	G	A	17	10	27	1	2	30	0	0
3	1192757	.	T	C	17	13	30	0	2	32	0	0
3	1195669	.	A	G	0	4	4	0	0	4	0	0
3	1196650	.	A	C	13	0	13	0	7	20	0	0
3	1196926	.	C	T	0	8	8	0	5	13	0	0
3	1196938	.	A	G	3	5	8	0	1	9	0	0
3	1197157	.	A	G	13	6	19	0	0	19	0	0
3	1197161	.	T	C	11	0	11	0	6	17	0	0
3	1200012	.	C	A	0	9	9	0	14	23	0	0
3	1200019	.	G	C	13	10	23	0	0	23	0	0
3	1209085	.	C	G	3	0	3	0	3	6	0	0
3	1211342	.	T	C	4	6	10	0	1	11	0	0
3	1211489	.	T	C	9	11	20	0	2	22	0	0
3	1211586	.	T	C	4	7	11	0	0	11	0	0
3	1211753	.	G	A	6	6	12	0	0	12	0	0
3	1211804	.	A	G	1	2	3	0	0	3	0	0
3	1211810	.	C	T	1	2	3	0	0	3	0	0
3	1212141	.	T	A	3	6	9	0	0	9	0	0
3	1215082	.	C	T	4	4	8	0	1	9	0	0
3	1215233	.	A	G	4	1	5	0	10	15	0	0
3	1218176	.	T	C	18	5	23	0	1	24	0	0
3	1220373	.	C	T	4	2	6	0	0	6	0	0
3	1220420	.	C	T	1	0	1	0	0	1	0	0
3	1220423	.	C	A	1	0	1	0	0	1	0	0
3	1220548	.	A	G	2	1	3	0	0	3	0	0
3	1220612	.	T	C	9	4	13	0	0	13	0	0
3	1220621	.	A	G	8	0	8	0	4	12	0	0
3	1223892	.	G	A	0	28	28	0	24	52	0	0
3	1226959	.	T	C	15	16	31	0	2	33	0	0
3	1227040	.	G	C	0	15	15	0	6	21	0	0
3	1227230	.	T	C	3	4	7	0	0	7	0	0
3	1230094	.	A	G	17	12	29	0	2	31	0	0
3	1260566	.	T	C	10	9	19	0	1	20	0	0
3	1260572	.	C	T	0	10	10	0	10	20	0	0
3	1261214	.	A	G	2	7	9	0	1	10	0	0
3	1262641	.	A	G	16	18	34	0	0	34	0	0
3	1263068	.	C	T	12	12	24	0	0	24	0	0
3	1263376	.	T	C	10	0	10	0	14	24	0	0
3	1263420	.	G	A	14	15	29	0	2	31	0	0
3	1263584	.	G	T	15	4	19	0	0	19	0	0
3	1263606	.	G	T	8	4	12	0	1	13	0	0
3	1263690	.	T	A	7	4	11	0	0	11	0	0
3	1264045	.	C	G	3	7	10	0	1	11	0	0
3	1264312	.	A	G	11	7	18	0	1	19	0	0
3	1264342	.	T	C	8	7	15	0	0	15	0	0
3	1264361	.	G	A	7	12	19	0	1	20	0	0
3	1264448	.	C	G	8	8	16	0	0	16	0	0
3	1264749	.	G	A	6	8	14	0	0	14	0	0
3	1264822	.	C	T	5	6	11	0	0	11	0	0
3	1264853	.	A	G	4	2	6	0	0	6	0	0
3	1265019	.	T	A	9	8	17	0	1	18	0	0
3	1265064	.	G	A	6	5	11	0	0	11	0	0
3	1265140	.	G	T	8	10	18	0	0	18	0	0
3	1265965	.	C	T	1	2	3	0	0	3	0	0
3	1266110	.	T	C	2	3	5	0	0	5	0	0
3	1266229	.	G	A	5	12	17	0	0	17	0	0
3	1266344	.	T	C	2	7	9	0	0	9	0	0
3	1266871	.	C	T	8	4	12	0	0	12	0	0
3	1267132	.	T	A	2	6	8	0	0	8	0	0
3	1267162	.	C	T	3	5	8	0	0	8	0	0
3	1267201	.	C	T	4	3	7	0	0	7	0	0
3	1267369	.	T	A	4	5	9	0	0	9	0	0
3	1267499	.	G	A	3	2	5	0	0	5	0	0
3	1267500	.	T	C	3	0	3	0	2	5	0	0
3	1267678	.	T	C	5	3	8	0	0	8	0	0
3	1267684	.	T	A	3	3	6	0	2	8	0	0
3	1267993	.	A	T	8	10	18	0	2	20	0	0
3	1268906	.	G	A	7	4	11	0	0	11	0	0
3	1269250	.	T	A	1	4	5	0	0	5	0	0
3	1269303	.	C	G	2	2	4	0	0	4	0	0
3	1269307	.	T	A	1	2	3	0	1	4	0	0
3	1269418	.	A	C	2	5	7	0	0	7	0	0
3	1269476	.	T	C	2	2	4	0	0	4	0	0
3	1269563	.	A	G	2	5	7	0	1	8	0	0
3	1304528	.	C	T	9	14	23	0	3	26	0	0
3	1304633	.	G	A	6	14	20	0	0	20	0	0
3	1304772	.	C	T	5	14	19	0	0	20	1	0
3	1323879	.	T	A	3	11	14	0	1	15	0	0
3	1323895	.	C	A	6	10	16	0	1	17	0	0
3	1324045	.	C	A	10	8	18	0	0	18	0	0
3	1324064	.	C	A	13	5	18	0	1	19	0	0
3	1324281	.	G	T	7	2	9	0	0	9	0	0
3	1324300	.	T	C	5	2	7	0	2	9	0	0
3	1324509	.	C	A	6	4	10	0	1	11	0	0
3	1324515	.	C	T	7	5	12	0	1	13	0	0
3	1337593	.	A	G	4	3	7	0	0	7	0	0
3	1337674	.	T	C	3	0	3	0	10	13	0	0
3	1386456	.	G	A	9	9	18	0	0	18	0	0
3	1388780	.	T	A	3	4	7	0	0	7	0	0
3	1388867	.	A	G	21	12	33	1	13	47	0	0
3	1395198	.	A	G	5	4	9	0	0	9	0	0
3	1395202	.	A	G	6	3	9	0	0	9	0	0
3	1395837	.	A	G	24	14	38	0	2	40	0	0
3	1395861	.	C	T	2	16	18	0	19	37	0	0
3	1395918	.	C	T	0	9	9	0	5	14	0	0
3	1492276	.	C	T	1	0	1	0	0	1	0	0
3	1494431	.	T	C	0	1	1	0	0	1	0	0
3	1494533	.	G	A	2	0	2	0	1	3	0	0
3	1494536	.	G	A	3	0	3	0	0	3	0	0
3	1494570	.	A	T	3	1	4	0	1	5	0	0
3	1494588	.	G	A	5	2	7	0	0	7	0	0
3	1494612	.	G	A	3	3	6	0	0	6	0	0
3	1494643	.	G	T	0	5	5	0	3	8	0	0
3	1497102	.	T	C	4	4	8	0	0	8	0	0
3	1499548	.	G	A	10	9	19	0	0	19	0	0
3	1499581	.	T	C	14	7	21	0	2	23	0	0
3	1499677	.	A	G	11	17	28	0	0	28	0	0
3	1499908	.	T	G	12	1	13	0	7	20	0	0
3	1499909	.	A	G	10	8	18	0	2	20	0	0
3	1500004	.	A	T	12	10	22	0	1	23	0	0
3	1500232	.	T	A	9	9	18	0	0	18	0	0
3	1500648	.	G	A	8	7	15	0	0	15	0	0
3	1500816	.	C	G	3	5	8	0	0	8	0	0
3	1501131	.	C	T	5	3	8	0	0	8	0	0
3	1511271	.	G	A	1	3	4	0	0	4	0	0
3	1515168	.	G	A	1	0	1	0	0	1	0	0
3	1520510	.	A	C	7	22	29	0	0	29	0	0
3	3361724	.	A	G	1	2	3	0	0	3	0	0
3	3361781	.	C	T	2	6	8	0	0	8	0	0
3	3361817	.	A	G	2	6	8	0	1	9	0	0
3	3362248	.	T	A	1	3	4	0	0	4	0	0
3	3610185	.	C	A	4	3	7	0	1	8	0	0
3	3610202	.	A	T	4	4	8	0	1	9	0	0
3	3610255	.	C	T	2	4	6	0	0	6	0	0
3	3628238	.	G	A	0	11	11	0	8	19	0	0
3	3628248	.	A	C	7	9	16	0	1	17	0	0
3	3630587	.	T	C	2	0	2	0	0	2	0	0
3	3631389	.	T	G	9	9	18	0	2	20	0	0
3	3634393	.	G	C	7	8	15	0	0	15	0	0
3	3634580	.	C	T	1	4	5	0	1	6	0	0
3	3634593	.	C	T	1	2	3	0	0	3	0	0
3	3634616	.	G	A	1	2	3	0	0	3	0	0
3	3813847	.	T	C	3	1	4	0	0	4	0	0
3	4502158	.	C	A	1	1	2	0	0	2	0	0
3	4502161	.	T	C	1	1	2	0	0	2	0	0
3	4504739	.	A	G	2	2	4	0	0	4	0	0
3	4504808	.	A	G	9	2	11	0	0	11	0	0
3	4506897	.	A	G	2	7	9	0	0	9	0	0
3	4506961	.	G	A	0	1	1	0	1	2	0	0
3	4508042	.	A	C	11	9	20	0	0	20	0	0
3	4508093	.	C	A	5	8	13	0	0	13	0	0
3	4508120	.	C	T	2	4	6	0	0	6	0	0
3	4511052	.	T	C	3	6	9	0	0	9	0	0
3	4511163	.	A	G	0	0	0	0	1	1	0	0
3	4514030	.	G	A	2	0	2	0	0	2	0	0
3	4530061	.	G	A	2	1	3	0	0	3	0	0
3	4530118	.	T	A	3	3	6	0	0	6	0	0
3	4644469	.	A	C	1	4	5	0	0	5	0	0
3	5010664	.	A	T	0	2	2	0	0	2	0	0
3	5012736	.	T	C	2	0	2	0	5	7	0	0
3	5012832	.	C	G	0	4	4	0	7	11	0	0
3	5019643	.	C	T	2	2	4	0	0	4	0	0
3	5019660	.	T	C	1	3	4	0	0	4	0	0
3	5019701	.	C	A	1	3	4	0	0	4	0	0
3	5019801	.	A	G	7	4	11	0	0	11	0	0
3	5019839	.	A	T	7	7	14	0	1	15	0	0
3	5021453	.	C	T	1	8	9	0	8	17	0	0
3	5021516	.	T	C	7	11	18	0	0	18	0	0
3	5027635	.	A	G	6	6	12	0	0	12	0	0
3	5029924	.	A	C	10	15	25	0	0	25	0	0
3	5029982	.	A	T	15	13	28	0	1	29	0	0
3	5035201	.	A	C	0	3	3	0	0	3	0	0
3	5040591	.	A	G	5	3	8	0	0	8	0	0
3	5040757	.	A	G	3	7	10	0	0	10	0	0
3	5040777	.	G	A	3	5	8	0	0	8	0	0
3	5040798	.	A	C	2	4	6	0	0	6	0	0
3	5053060	.	C	T	0	17	17	0	16	33	0	0
3	5053084	.	C	T	1	18	19	0	16	35	0	0
3	5053108	.	A	C	10	16	26	0	0	26	0	0
3	5053246	.	G	A	9	15	24	0	2	26	0	0
3	5053260	.	C	T	10	10	20	0	4	24	0	0
3	5053409	.	C	T	0	17	17	0	13	30	0	0
3	5053465	.	T	C	12	0	12	0	17	29	0	0
3	5053586	.	C	T	2	18	20	0	18	38	0	0
3	5053934	.	G	A	19	18	37	0	0	37	0	0
3	5054018	.	A	G	6	11	17	0	0	17	0	0
3	5056247	.	G	A	17	17	34	0	0	34	0	0
3	5056390	.	A	T	0	4	4	0	0	4	0	0
3	5062927	.	G	A	10	14	24	0	1	25	0	0
3	5062980	.	C	A	16	14	30	0	0	30	0	0
3	5063011	.	T	C	13	0	13	0	13	26	0	0
3	5063176	.	G	A	5	5	10	0	0	10	0	0
3	5130791	.	C	A	5	8	13	0	1	14	0	0
3	5130851	.	T	C	1	1	2	0	1	3	0	0
3	5134113	.	G	A	2	5	7	0	0	7	0	0
3	5134122	.	G	A	7	4	11	0	0	11	0	0
3	5134669	.	T	C	6	4	10	0	1	11	0	0
3	5136617	.	G	A	1	2	3	0	0	3	0	0
3	5140851	.	A	G	1	1	2	0	0	2	0	0
3	5141035	.	C	T	8	1	9	0	0	9	0	0
3	5143119	.	C	T	4	4	8	0	0	8	0	0
3	5145139	.	C	A	0	3	3	0	3	6	0	0
3	5145797	.	C	T	0	0	0	0	3	3	0	0
3	5147544	.	G	A	3	5	8	0	0	8	0	0
3	5163352	.	C	T	0	1	1	0	0	1	0	0
3	5163418	.	C	G	3	3	6	0	0	6	0	0
3	5163442	.	G	T	2	2	4	0	0	4	0	0
3	5163826	.	C	T	0	2	2	0	3	5	0	0
3	5265679	.	A	G	2	10	12	0	0	12	0	0
3	5267221	.	G	A	5	4	9	0	0	9	0	0
3	5267251	.	C	T	9	7	16	0	1	17	0	0
3	5270274	.	C	T	2	6	8	0	17	25	0	0
3	5353371	.	C	A	0	2	2	0	0	2	0	0
3	5623807	.	C	T	1	8	9	0	9	18	0	0
3	5624487	.	C	T	0	4	4	0	1	5	0	0
3	5624604	.	C	A	2	4	6	0	1	7	0	0
3	5627917	.	G	A	9	12	21	0	0	21	0	0
3	5633089	.	G	A	10	12	22	0	0	22	0	0
3	5778981	.	G	A	10	12	22	0	0	22	0	0
3	5779044	.	T	A	6	18	24	0	0	24	0	0
3	5779093	.	G	T	9	13	22	0	0	22	0	0
3	5782501	.	A	G	3	1	4	0	0	4	0	0
3	5782715	.	A	G	1	4	5	0	0	5	0	0
3	5812205	.	C	T	0	2	2	0	0	2	0	0
3	5812802	.	C	T	0	4	4	0	2	6	0	0
3	5812813	.	G	A	2	1	3	0	0	3	0	0
3	5814475	.	C	T	3	3	6	0	0	6	0	0
3	5814478	.	C	T	3	2	5	0	1	6	0	0
3	5824826	.	T	C	3	0	3	0	0	3	0	0
3	5824858	.	C	T	4	2	6	0	0	6	0	0
3	5824870	.	C	T	4	5	9	0	0	9	0	0
3	5829415	.	A	G	7	7	14	0	0	14	0	0
3	5882661	.	T	C	1	2	3	0	0	3	0	0
3	5886917	.	C	T	0	21	21	0	32	53	0	0
3	5887223	.	T	C	19	9	28	0	1	29	0	0
3	5887463	.	T	G	16	16	32	0	0	32	0	0
3	5887661	.	A	T	15	16	31	0	2	33	0	0
3	5887673	.	G	C	15	1	16	0	18	34	0	0
3	5887715	.	T	C	8	20	28	0	0	28	0	0
3	5887841	.	T	A	18	14	32	0	8	40	0	0
3	5887931	.	A	T	17	18	35	0	7	42	0	0
3	5888245	.	C	T	17	17	34	0	1	35	0	0
3	5888664	.	G	A	14	10	24	0	1	25	0	0
3	5888868	.	G	A	9	13	22	0	2	24	0	0
3	5889077	.	G	T	11	6	17	0	0	17	0	0
3	5889302	.	T	C	4	7	11	0	2	13	0	0
3	5889642	.	A	T	11	5	16	0	2	18	0	0
3	5889983	.	A	G	3	4	7	0	0	7	0	0
3	5890274	.	T	A	9	4	13	0	0	13	0	0
3	5890287	.	A	G	10	4	14	0	0	14	0	0
3	5890698	.	C	T	0	12	12	0	7	19	0	0
3	5908262	.	C	T	6	8	14	0	1	15	0	0
3	5908302	.	T	C	5	0	5	0	8	13	0	0
3	5908452	.	T	C	6	0	6	0	10	16	0	0
3	5908569	.	C	A	1	10	11	0	4	15	0	0
3	5964113	.	G	A	3	4	7	0	0	7	0	0
3	5991822	.	G	A	1	4	5	0	0	5	0	0
3	5995038	.	A	G	4	0	4	0	0	4	0	0
3	5995071	.	A	G	1	0	1	0	0	1	0	0
3	6018622	.	G	A	1	2	3	0	0	3	0	0
3	6380368	.	T	C	6	20	26	0	2	28	0	0
3	6417172	.	G	A	15	20	35	0	1	36	0	0
3	6444075	.	C	A	1	4	5	0	0	5	0	0
3	6474593	.	A	G	1	3	4	0	0	4	0	0
3	6477596	.	G	C	1	1	2	0	0	2	0	0
3	6491117	.	C	A	0	4	4	0	2	6	0	0
3	6491540	.	C	T	4	8	12	0	0	12	0	0
3	6491542	.	G	T	4	8	12	0	0	12	0	0
3	6491670	.	C	T	4	2	6	0	0	6	0	0
3	6491820	.	A	T	2	5	7	0	2	9	0	0
3	6491833	.	A	G	1	7	8	0	0	8	0	0
3	6491881	.	G	T	3	11	14	0	0	14	0	0
3	6491906	.	T	C	3	9	12	0	0	12	0	0
3	6492062	.	T	A	1	4	5	0	1	6	0	0
3	6492076	.	A	T	3	2	5	0	0	5	0	0
3	6495017	.	G	A	0	2	2	0	0	2	0	0
3	6498049	.	C	G	0	11	11	0	4	15	0	0
3	6499636	.	A	G	2	2	4	0	0	4	0	0
3	6502039	.	G	A	6	2	8	0	1	9	0	0
3	6504814	.	T	A	2	2	4	0	0	4	0	0
3	6516457	.	C	T	0	1	1	0	0	1	0	0
3	6608189	.	G	C	5	0	5	0	3	8	0	0
3	6659702	.	G	A	0	4	4	0	1	5	0	0
3	6659843	.	C	T	1	1	2	0	0	2	0	0
3	6663606	.	G	A	1	3	4	0	0	4	0	0
3	6664498	.	A	G	4	4	8	0	0	8	0	0
3	6664513	.	A	G	3	1	4	0	3	7	0	0
3	6664890	.	A	G	2	3	5	0	0	5	0	0
3	6664915	.	A	G	4	1	5	0	1	6	0	0
3	6664943	.	A	G	1	2	3	1	1	5	0	0
3	6665874	.	C	G	3	0	3	0	3	6	0	0
3	6665902	.	G	T	4	6	10	0	0	10	0	0
3	6665951	.	C	A	5	3	8	0	0	8	0	0
3	6665985	.	A	T	4	2	6	0	0	6	0	0
3	6666027	.	C	T	3	7	10	0	1	11	0	0
3	6666080	.	A	G	2	5	7	0	2	9	0	0
3	6666092	.	T	C	8	4	12	0	0	12	0	0
3	6666194	.	G	C	5	10	15	0	1	16	0	0
3	6666283	.	A	T	6	10	16	0	0	16	0	0
3	6666342	.	A	G	8	3	11	0	0	11	0	0
3	6666362	.	G	A	5	7	12	0	0	12	0	0
3	6666689	.	T	C	1	5	6	0	0	6	0	0
3	6666730	.	C	T	1	3	4	0	1	5	0	0
3	6666788	.	T	G	2	2	4	0	0	4	0	0
3	6666846	.	T	C	2	2	4	0	0	4	0	0
3	6667060	.	G	C	16	10	26	0	0	26	0	0
3	6667209	.	C	T	6	14	20	0	0	20	0	0
3	6667383	.	T	C	2	3	5	2	0	7	0	0
3	6669025	.	T	G	3	2	5	0	0	5	0	0
3	6669511	.	C	T	0	1	1	0	0	1	0	0
3	6721286	.	G	C	3	4	7	0	2	9	0	0
3	6721421	.	T	G	6	15	21	0	1	22	0	0
3	6721430	.	T	C	14	0	14	0	1	15	0	0
3	6721456	.	A	T	2	9	11	0	2	13	0	0
3	6721579	.	G	A	6	3	9	0	0	9	0	0
3	6721763	.	T	C	3	3	6	0	1	7	0	0
3	6721851	.	C	T	4	4	8	0	0	8	0	0
3	6721971	.	A	T	12	5	17	0	0	17	0	0
3	6722438	.	C	T	2	4	6	0	0	6	0	0
3	6722981	.	G	A	6	16	22	0	0	22	0	0
3	6722986	.	A	T	6	14	20	0	0	20	0	0
3	6723078	.	A	C	3	3	6	1	0	7	0	0
3	6723257	.	A	G	5	0	5	0	0	5	0	0
3	6725332	.	T	G	4	2	6	0	0	6	0	0
3	6725432	.	T	A	4	5	9	0	0	9	0	0
3	6725468	.	C	T	3	2	5	0	0	5	0	0
3	6725523	.	C	T	0	2	2	1	0	3	0	0
3	6725554	.	T	C	0	1	1	0	0	1	0	0
3	6726020	.	C	T	4	5	9	0	0	9	0	0
3	6726284	.	A	T	5	5	10	0	1	11	0	0
3	6726317	.	A	G	7	6	13	0	0	13	0	0
3	6726359	.	G	A	6	6	12	0	0	12	0	0
3	6726455	.	A	T	8	4	12	0	1	13	0	0
3	6727154	.	C	T	0	8	8	0	6	14	0	0
3	6732696	.	G	A	0	1	1	0	0	1	0	0
3	6732697	.	C	T	0	1	1	0	0	1	0	0
3	6737099	.	G	T	2	0	2	0	1	3	0	0
3	6744653	.	A	G	0	2	2	0	0	2	0	0
3	6746560	.	G	A	1	0	1	0	0	1	0	0
3	6749311	.	T	C	0	2	2	0	0	2	0	0
3	7007381	.	G	C	2	2	4	0	0	4	0	0
3	7007929	.	T	C	2	2	4	0	0	4	0	0
3	7008220	.	G	T	2	3	5	0	0	5	0	0
3	7008234	.	G	A	1	3	4	0	0	4	0	0
3	7008690	.	C	A	2	6	8	0	1	9	0	0
3	7008750	.	C	T	3	2	5	0	0	5	0	0
3	7056934	.	T	C	0	0	0	0	2	2	0	0
3	7081625	.	C	T	0	3	3	0	0	3	0	0
3	7081838	.	T	A	4	2	6	0	0	6	0	0
3	7099049	.	C	T	2	6	8	0	0	8	0	0
3	7099210	.	T	C	2	3	5	1	0	6	0	0
3	7099344	.	A	G	2	6	8	0	0	8	0	0
3	7099380	.	C	T	3	5	8	0	0	8	0	0
3	7099888	.	T	C	1	1	2	0	0	2	0	0
3	7113025	.	C	T	0	4	4	0	3	7	0	0
3	7113330	.	T	C	5	7	12	0	1	13	0	0
3	7113669	.	C	T	0	2	2	0	0	2	0	0
3	7113720	.	G	A	2	5	7	0	0	7	0	0
3	7113742	.	G	A	5	2	7	2	0	9	0	0
3	7124140	.	G	A	2	2	4	0	0	4	0	0
3	7124157	.	C	G	3	2	5	0	0	5	0	0
3	7124437	.	A	G	3	7	10	0	0	10	0	0
3	7141527	.	G	T	2	5	7	0	1	8	0	0
3	7141651	.	T	C	5	2	7	0	1	8	0	0
3	7155403	.	A	G	6	7	13	0	2	15	0	0
3	7155428	.	G	A	8	10	18	0	0	18	0	0
3	7155462	.	C	T	0	10	10	0	7	17	0	0
3	7155771	.	G	A	2	3	5	0	1	6	0	0
3	7155846	.	T	C	4	7	11	0	1	12	0	0
3	7155960	.	T	G	3	3	6	5	1	12	0	0
3	7156058	.	C	T	0	6	6	4	2	12	0	0
3	7156066	.	G	A	2	6	8	3	0	11	0	0
3	7276854	.	C	T	0	3	3	0	2	5	0	0
3	7277008	.	A	T	2	5	7	0	0	7	0	0
3	7509668	.	G	A	5	2	7	0	0	7	0	0
3	7557932	.	C	T	1	2	3	0	1	4	0	0
3	7557948	.	T	G	2	1	3	0	0	3	0	0
3	7558391	.	C	T	1	3	4	0	0	4	0	0
3	7558394	.	T	A	1	3	4	0	0	4	0	0
3	7570230	.	G	A	1	2	3	0	0	3	0	0
3	7570241	.	C	T	1	2	3	0	0	3	0	0
3	7617385	.	G	A	0	4	4	0	1	5	0	0
3	7617429	.	C	G	1	6	7	0	0	7	0	0
3	7618805	.	C	T	1	2	3	0	0	3	0	0
3	7618823	.	A	C	1	4	5	0	0	5	0	0
3	7618880	.	A	G	1	0	1	0	4	5	0	0
3	7623208	.	G	A	1	0	1	0	0	1	0	0
3	7638510	.	A	G	2	5	7	0	0	7	0	0
3	7638520	.	T	G	4	4	8	0	0	8	0	0
3	7638616	.	A	C	9	3	12	0	0	12	0	0
3	7638675	.	C	A	5	3	8	0	0	8	0	0
3	7638946	.	T	A	12	12	24	0	1	25	0	0
3	7638947	.	T	C	12	13	25	0	0	25	0	0
3	7654833	.	C	G	0	17	17	0	29	46	0	0
3	7654835	.	T	C	25	18	43	0	3	46	0	0
3	7655186	.	A	G	27	22	49	0	3	52	0	0
3	7655588	.	T	C	19	4	23	0	23	46	0	0
3	7655660	.	C	T	21	16	37	0	3	40	0	0
3	7655780	.	T	G	19	21	40	0	2	42	0	0
3	7655817	.	A	T	14	14	28	0	0	28	0	0
3	7655819	.	C	T	2	14	16	0	12	28	0	0
3	7655908	.	A	G	17	21	38	0	0	38	0	0
3	7792316	.	A	G	0	1	1	0	0	1	0	0
3	7795302	.	A	G	2	0	2	0	2	4	0	0
3	7818839	.	A	T	2	7	9	0	2	11	0	0
3	7818905	.	C	G	2	3	5	0	3	8	0	0
3	7818929	.	G	A	0	5	5	0	3	8	0	0
3	7819660	.	A	G	1	2	3	0	0	3	0	0
3	7819686	.	A	G	1	2	3	0	0	3	0	0
3	7823333	.	G	A	13	16	29	0	2	31	0	0
3	7833801	.	T	C	1	2	3	0	1	4	0	0
3	7833897	.	T	C	6	15	21	0	0	21	0	0
3	7833928	.	C	G	6	21	27	0	0	27	0	0
3	7833995	.	T	C	6	7	13	0	1	14	0	0
3	7839984	.	T	G	1	4	5	0	0	5	0	0
3	7840106	.	A	G	2	2	4	0	0	4	0	0
3	7853231	.	A	T	3	3	6	0	0	6	0	0
3	7853248	.	A	G	3	2	5	0	0	5	0	0
3	7853274	.	A	C	0	4	4	0	0	4	0	0
3	7853755	.	T	A	6	7	13	0	0	13	0	0
3	7853805	.	T	C	2	0	2	0	8	10	0	0
3	7853827	.	A	C	2	9	11	0	0	11	0	0
3	7853886	.	G	T	2	6	8	0	2	10	0	0
3	7853899	.	T	C	0	0	0	0	9	9	0	0
3	7853950	.	T	C	1	0	1	0	12	13	0	0
3	7853965	.	T	C	4	6	10	0	1	11	0	0
3	7854082	.	G	A	6	3	9	0	1	10	0	0
3	7854178	.	G	A	2	4	6	0	0	6	0	0
3	7862533	.	C	T	1	0	1	0	0	1	0	0
3	7870547	.	T	C	4	3	7	0	0	7	0	0
3	7870712	.	A	G	3	2	5	0	0	5	0	0
3	7870868	.	T	C	3	1	4	0	0	4	0	0
3	8334392	.	C	T	0	1	1	0	0	1	0	0
3	10152166	.	G	T	0	3	3	0	0	3	0	0
3	10163116	.	G	A	0	3	3	0	1	4	0	0
3	10163153	.	C	A	1	2	3	0	0	3	0	0
3	10163287	.	C	G	2	0	2	0	4	6	0	0
3	10163302	.	T	C	3	3	6	0	0	6	0	0
3	10410994	.	C	A	1	2	3	0	0	3	0	0
3	10411002	.	T	A	1	3	4	0	0	4	0	0
3	10411054	.	T	C	0	2	2	0	0	2	0	0
3	11554135	.	A	G	1	0	1	0	4	5	0	0
3	11554141	.	T	C	1	4	5	0	0	5	0	0
3	11558287	.	G	A	1	1	2	0	0	2	0	0
3	11575354	.	G	A	0	3	3	0	3	6	0	0
3	11575471	.	T	C	10	7	17	0	1	18	0	0
3	11575591	.	C	A	6	6	12	0	1	13	0	0
3	11575675	.	C	G	2	9	11	0	1	12	0	0
3	11575679	.	C	G	2	8	10	0	2	12	0	0
3	11575946	.	C	T	1	2	3	0	0	3	0	0
3	11575960	.	G	A	0	3	3	0	1	4	0	0
3	11576127	.	C	T	2	4	6	0	0	6	0	0
3	11585488	.	T	A	20	8	28	0	1	29	0	0
3	11585492	.	G	A	18	6	24	0	4	28	0	0
3	11585815	.	A	G	12	3	15	0	0	15	0	0
3	11585852	.	T	A	7	6	13	0	3	16	0	0
3	11585937	.	G	A	8	12	20	0	3	23	0	0
3	11586028	.	T	A	6	3	9	0	1	10	0	0
3	11586051	.	T	C	10	0	10	0	4	14	0	0
3	11586331	.	C	T	1	16	17	0	19	36	0	0
3	11586346	.	C	T	15	19	34	0	0	34	0	0
3	11586382	.	G	A	19	23	42	0	2	44	0	0
3	11586679	.	C	T	19	8	27	0	0	27	0	0
3	11586695	.	C	T	0	4	4	0	15	19	0	0
3	11590280	.	A	G	8	10	18	0	1	19	0	0
3	11614970	.	T	C	7	1	8	0	0	8	0	0
3	11615007	.	A	T	19	5	24	0	4	28	0	0
3	11615041	.	T	C	23	0	23	0	15	38	0	0
3	11615109	.	G	A	23	10	33	0	1	34	0	0
3	11615133	.	A	G	21	12	33	0	3	36	0	0
3	11615224	.	A	G	18	23	41	0	3	44	0	0
3	11624298	.	A	G	24	11	35	0	0	35	0	0
3	11781003	.	A	C	12	8	20	0	2	22	0	0
3	11781079	.	T	C	18	6	24	0	0	24	0	0
3	11781113	.	G	A	15	13	28	0	7	35	0	0
3	11784743	.	G	A	13	19	32	0	4	36	0	0
3	11797076	.	C	T	0	6	6	0	6	12	0	0
3	12656257	.	A	G	0	2	2	0	1	3	0	0
3	13424069	.	C	A	6	4	10	0	1	11	0	0
3	13424467	.	C	A	3	3	6	0	1	7	0	0
3	13424531	.	C	A	1	1	2	0	1	3	0	0
3	13424538	.	T	G	2	1	3	0	0	3	0	0
3	13424595	.	A	T	2	7	9	0	0	9	0	0
3	13424601	.	T	G	2	9	11	0	0	11	0	0
3	13424635	.	G	A	2	6	8	0	0	8	0	0
3	13424738	.	A	T	2	2	4	0	1	5	0	0
3	13424739	.	A	T	2	2	4	0	1	5	0	0
3	13424847	.	G	T	9	14	23	0	2	25	0	0
3	13424877	.	T	C	6	10	16	0	3	19	0	0
3	13424950	.	A	T	4	8	12	0	2	14	0	0
3	13424968	.	C	T	4	6	10	0	0	10	0	0
3	13424989	.	C	A	0	3	3	0	4	7	0	0
3	13426691	.	G	A	0	2	2	0	0	2	0	0
3	13426754	.	C	A	0	9	9	0	3	12	0	0
3	13430606	.	A	G	2	0	2	0	0	2	0	0
3	13431327	.	G	A	2	5	7	0	0	7	0	0
3	13432609	.	C	T	2	1	3	0	0	3	0	0
3	13434860	.	C	T	1	11	12	0	8	20	0	0
3	13434888	.	A	G	11	16	27	0	1	28	0	0
3	13434920	.	C	G	5	8	13	0	0	13	0	0
3	13434930	.	A	T	5	7	12	0	0	12	0	0
3	13435998	.	T	C	5	0	5	0	12	17	0	0
3	13437767	.	G	A	5	8	13	0	0	13	0	0
3	13445758	.	G	A	0	5	5	0	4	9	0	0
3	13445819	.	T	C	4	6	10	0	0	10	0	0
3	13445884	.	T	G	4	5	9	0	0	9	0	0
3	13446019	.	C	T	4	6	10	0	0	10	0	0
3	13447870	.	C	T	2	2	4	0	0	4	0	0
3	13453494	.	C	T	4	6	10	0	0	10	0	0
3	13453500	.	A	G	5	7	12	0	0	12	0	0
3	13455893	.	T	C	1	0	1	0	2	3	0	0
3	13456064	.	C	T	0	2	2	0	3	5	0	0
3	13456214	.	A	G	1	4	5	0	0	5	0	0
3	13456303	.	G	A	3	2	5	0	0	5	0	0
3	13456431	.	C	A	5	1	6	0	0	6	0	0
3	13456436	.	A	G	5	2	7	0	0	7	0	0
3	13456472	.	C	T	0	5	5	0	4	9	0	0
3	13456492	.	T	C	3	4	7	0	0	7	0	0
3	13459669	.	A	G	1	1	2	0	0	2	0	0
3	13459678	.	G	C	1	0	1	0	1	2	0	0
3	13488321	.	G	A	3	3	6	0	0	6	0	0
3	13488486	.	T	A	5	2	7	0	0	7	0	0
3	13488518	.	G	C	3	2	5	0	0	5	0	0
3	13502218	.	T	G	2	1	3	0	0	3	0	0
3	13502219	.	A	T	2	1	3	0	0	3	0	0
3	13525461	.	T	C	0	2	2	0	1	3	0	0
3	13525471	.	T	C	1	2	3	0	0	3	0	0
3	13525775	.	T	A	1	2	3	0	0	3	0	0
3	13525976	.	C	G	6	4	10	0	1	11	0	0
3	13534291	.	C	T	0	4	4	0	3	7	0	0
3	13534311	.	G	C	2	4	6	0	0	6	0	0
3	13534339	.	C	T	0	2	2	0	1	3	0	0
3	13535827	.	C	T	0	1	1	0	1	2	0	0
3	13541879	.	C	T	0	4	4	0	4	8	0	0
3	13582156	.	T	C	9	9	18	0	0	18	0	0
3	13582181	.	G	A	8	7	15	0	5	20	0	0
3	13582217	.	G	T	15	3	18	0	1	19	0	0
3	13582220	.	A	T	16	2	18	0	0	18	0	0
3	13582288	.	A	T	11	13	24	0	0	25	1	0
3	13582295	.	T	A	10	13	23	0	3	26	0	0
3	13582547	.	C	G	0	10	10	0	15	25	0	0
3	13589391	.	G	T	2	1	3	0	0	3	0	0
3	13589412	.	G	A	2	8	10	0	1	11	0	0
3	13589469	.	A	G	12	18	30	0	1	31	0	0
3	13590995	.	G	A	6	8	14	0	0	14	0	0
3	13593605	.	C	T	9	6	15	0	0	15	0	0
3	13595100	.	A	G	5	6	11	0	2	13	0	0
3	13595245	.	G	A	5	1	6	0	0	6	0	0
3	13595686	.	C	T	10	5	15	0	2	17	0	0
3	13603365	.	T	G	2	0	2	0	0	2	0	0
3	13607036	.	G	A	0	1	1	0	1	2	0	0
3	13609168	.	T	A	1	2	3	0	0	3	0	0
3	13617738	.	T	A	1	4	5	0	0	5	0	0
3	13618203	.	A	T	1	8	9	0	1	10	0	0
3	14367006	.	T	C	4	1	5	0	0	5	0	0
3	14497015	.	T	C	27	10	37	0	1	38	0	0
3	14507564	.	A	G	2	2	4	0	0	4	0	0
3	14859756	.	C	T	7	3	10	0	0	10	0	0
3	14860158	.	C	T	12	5	17	0	0	17	0	0
3	15057191	.	A	T	12	11	23	0	1	24	0	0
3	15057214	.	G	T	14	12	26	0	1	27	0	0
3	15057321	.	T	C	16	8	24	0	0	24	0	0
3	15057549	.	T	G	15	14	29	0	1	30	0	0
3	15057656	.	G	A	0	6	6	0	11	17	0	0
3	15057696	.	T	C	10	7	17	0	2	19	0	0
3	15057928	.	G	A	7	6	13	0	1	14	0	0
3	15058259	.	G	T	9	7	16	0	0	16	0	0
3	15058323	.	A	G	12	9	21	0	0	21	0	0
3	15085403	.	A	T	7	2	9	1	0	10	0	0
3	15085528	.	C	T	4	6	10	0	0	10	0	0
3	15085530	.	G	T	4	6	10	0	0	10	0	0
3	15085784	.	G	C	11	10	21	0	1	22	0	0
3	15085821	.	C	T	7	8	15	0	2	17	0	0
3	15091183	.	C	T	0	1	1	0	1	2	0	0
3	15098847	.	A	G	1	1	2	0	0	2	0	0
3	15408033	.	G	C	0	1	1	0	12	13	0	0
3	15442640	.	T	C	2	0	2	0	2	4	0	0
3	15629022	.	T	C	6	4	10	0	0	10	0	0
3	15988337	.	A	G	18	14	32	0	2	34	0	0
3	15988435	.	A	G	16	4	20	2	1	23	0	0
3	16019113	.	C	T	6	0	6	0	0	6	0	0
3	16389180	.	G	T	10	5	15	0	3	18	0	0
3	16389230	.	C	T	11	8	19	0	3	22	0	0
3	16389517	.	C	T	2	2	4	0	0	4	0	0
3	16391695	.	G	A	1	5	6	0	0	6	0	0
3	16391719	.	T	C	2	0	2	0	0	2	0	0
3	16395548	.	A	G	4	1	5	0	0	5	0	0
3	16397627	.	A	T	0	0	0	0	1	1	0	0
3	16404204	.	T	C	3	4	7	0	0	7	0	0
3	16404370	.	G	A	1	1	2	0	0	2	0	0
3	16404382	.	G	A	1	1	2	0	1	3	0	0
3	16404406	.	G	C	2	3	5	0	1	6	0	0
3	16409551	.	A	G	0	2	2	0	1	3	0	0
3	16457280	.	G	T	5	2	7	0	0	7	0	0
3	16644872	.	C	T	3	6	9	0	0	9	0	0
3	16648459	.	G	T	7	3	10	0	1	11	0	0
3	16650129	.	G	A	5	5	10	0	0	10	0	0
3	16664476	.	T	C	5	4	9	0	1	10	0	0
3	16668614	.	G	A	0	0	0	0	1	1	0	0
3	16668671	.	C	T	1	3	4	0	0	4	0	0
3	16671903	.	G	A	0	1	1	0	1	2	0	0
3	16679136	.	C	T	7	7	14	0	1	15	0	0
3	16679248	.	C	T	3	6	9	0	0	9	0	0
3	16679331	.	T	C	4	11	15	0	0	15	0	0
3	16679349	.	G	A	2	7	9	0	0	9	0	0
3	16679387	.	G	A	3	5	8	0	0	8	0	0
3	16679520	.	G	A	4	6	10	0	1	11	0	0
3	16679556	.	G	A	0	5	5	0	4	9	0	0
3	16679561	.	A	G	4	0	4	0	5	9	0	0
3	16692232	.	A	G	1	1	2	0	0	2	0	0
3	16729101	.	G	A	1	4	5	0	0	5	0	0
3	16731938	.	A	G	0	0	0	0	4	4	0	0
3	16733790	.	C	T	4	10	14	0	0	14	0	0
3	16735507	.	C	T	1	0	1	0	0	1	0	0
3	16741179	.	A	C	3	8	11	0	0	11	0	0
3	16741830	.	A	G	8	4	12	0	1	13	0	0
3	16741851	.	T	C	8	5	13	0	1	14	0	0
3	16746659	.	A	T	3	2	5	0	0	5	0	0
3	16746666	.	T	C	3	4	7	0	0	7	0	0
3	16746796	.	G	A	3	2	5	0	1	6	0	0
3	16746947	.	A	T	10	9	19	0	4	23	0	0
3	16747229	.	A	G	4	0	4	0	7	11	0	0
3	16747233	.	G	T	0	7	7	0	3	10	0	0
3	16842168	.	A	G	1	2	3	0	0	3	0	0
3	16842343	.	G	A	1	1	2	0	0	2	0	0
3	16972991	.	T	C	5	4	9	0	1	10	0	0
3	17074268	.	A	G	1	0	1	0	0	1	0	0
3	17074430	.	A	C	1	0	1	0	0	1	0	0
3	17090941	.	G	A	3	2	5	0	0	5	0	0
3	17093097	.	T	C	1	2	3	0	0	3	0	0
3	17107026	.	A	T	2	2	4	0	0	4	0	0
3	17289476	.	G	A	1	0	1	0	1	2	0	0
3	17318089	.	T	C	1	1	2	0	0	2	0	0
3	17458054	.	C	T	1	2	3	0	1	4	0	0
3	17458888	.	A	G	4	0	4	0	4	8	0	0
3	17488995	.	A	G	2	0	2	0	1	3	0	0
3	17489004	.	A	T	1	1	2	0	1	3	0	0
3	17600108	.	G	T	0	4	4	0	1	5	0	0
3	17600190	.	C	T	2	8	10	0	0	10	0	0
3	17600201	.	C	T	2	7	9	0	0	9	0	0
3	17600702	.	C	T	3	7	10	0	0	10	0	0
3	17600870	.	A	T	3	3	6	0	0	6	0	0
3	17601055	.	C	T	1	2	3	0	0	3	0	0
3	17603512	.	T	C	1	4	5	0	0	5	0	0
3	17603558	.	G	A	2	2	4	0	1	5	0	0
3	17603926	.	T	C	1	2	3	0	0	3	0	0
3	17650983	.	G	A	17	23	40	0	2	42	0	0
3	17651208	.	C	A	22	10	32	0	9	41	0	0
3	17651508	.	G	A	13	15	28	0	1	29	0	0
3	17651718	.	C	T	22	16	38	0	0	38	0	0
3	17651837	.	C	T	9	12	21	0	0	21	0	0
3	17651847	.	C	A	10	5	15	0	1	16	0	0
3	17653813	.	A	T	4	4	8	0	0	8	0	0
3	17653924	.	T	C	4	4	8	0	0	8	0	0
3	17660156	.	C	T	1	3	4	0	2	6	0	0
3	17668976	.	A	T	2	2	4	0	0	4	0	0
3	17669427	.	A	G	1	4	5	0	0	5	0	0
3	17669502	.	T	A	1	1	2	0	0	2	0	0
3	17671567	.	C	T	2	4	6	0	0	6	0	0
3	17671843	.	G	A	1	0	1	0	0	1	0	0
3	17671888	.	G	A	3	1	4	0	0	4	0	0
3	17671897	.	T	C	3	1	4	0	0	4	0	0
3	17673386	.	C	T	5	1	6	0	0	6	0	0
3	17678335	.	T	C	1	0	1	0	0	1	0	0
3	17744438	.	T	A	3	2	5	0	1	6	0	0
3	17744491	.	C	T	2	2	4	0	0	4	0	0
3	17867319	.	A	G	2	7	9	0	0	9	0	0
3	17867334	.	A	G	2	8	10	0	0	10	0	0
3	17867440	.	T	C	7	8	15	0	0	15	0	0
3	17867564	.	T	C	18	7	25	0	2	27	0	0
3	17867716	.	C	A	1	2	3	0	0	3	0	0
3	17868174	.	T	G	4	4	8	0	0	8	0	0
3	17868669	.	C	A	7	2	9	0	0	9	0	0
3	17868673	.	A	G	6	4	10	0	0	10	0	0
3	17868710	.	T	C	8	6	14	0	0	14	0	0
3	17868949	.	G	C	7	13	20	0	0	20	0	0
3	17869030	.	G	C	6	3	9	0	0	9	0	0
3	17869300	.	G	A	3	5	8	0	1	9	0	0
3	17871801	.	G	T	0	1	1	0	0	1	0	0
3	17878505	.	A	G	3	1	4	0	0	4	0	0
3	17886528	.	G	A	4	3	7	0	0	7	0	0
3	17886996	.	C	T	5	4	9	0	0	9	0	0
3	17943332	.	A	G	5	3	8	0	0	8	0	0
3	18473078	.	A	G	0	0	0	0	4	4	0	0
3	18686781	.	T	C	10	0	10	0	19	29	0	0
3	18837238	.	A	G	0	3	3	0	0	3	0	0
3	18838547	.	C	T	6	2	8	0	0	8	0	0
3	18838559	.	T	A	2	4	6	0	0	6	0	0
3	18838595	.	T	A	1	2	3	0	1	4	0	0
3	18838878	.	C	T	1	10	11	0	1	12	0	0
3	18922819	.	C	T	1	3	4	0	0	4	0	0
3	18923209	.	C	A	3	4	7	0	0	7	0	0
3	18923246	.	A	G	3	2	5	0	0	5	0	0
3	18923586	.	C	G	3	0	3	0	3	6	0	0
3	18923601	.	T	C	4	2	6	0	0	6	0	0
3	19006010	.	G	A	2	9	11	0	1	12	0	0
3	19006388	.	G	A	9	16	25	0	0	25	0	0
3	19019232	.	A	G	0	2	2	0	0	2	0	0
3	19042691	.	A	C	1	1	2	0	0	2	0	0
3	19068868	.	G	A	6	5	11	0	1	12	0	0
3	19090884	.	A	G	1	5	6	0	1	7	0	0
3	19162582	.	A	G	1	1	2	0	0	2	0	0
3	19162654	.	A	G	4	2	6	0	0	6	0	0
3	19162663	.	A	G	4	3	7	0	0	7	0	0
3	19172284	.	G	T	1	5	6	0	0	6	0	0
3	19180634	.	G	A	3	4	7	0	0	7	0	0
3	19180650	.	C	G	4	5	9	0	0	9	0	0
3	19180775	.	C	A	2	5	7	0	0	7	0	0
3	19180778	.	A	G	2	3	5	0	1	6	0	0
3	19180811	.	C	T	3	4	7	0	0	7	0	0
3	19194126	.	C	T	0	3	3	0	1	4	0	0
3	19194135	.	A	T	1	2	3	0	1	4	0	0
3	19200437	.	C	T	0	3	3	0	1	4	0	0
3	19207219	.	A	G	3	0	3	0	5	8	0	0
3	19210238	.	T	C	2	2	4	0	2	6	0	0
3	19210287	.	A	G	9	0	9	0	6	15	0	0
3	19210352	.	A	G	5	5	10	0	0	10	0	0
3	19210364	.	A	G	3	2	5	0	0	5	0	0
3	19264751	.	A	G	5	4	9	0	3	12	0	0
3	19264760	.	T	A	6	1	7	0	4	11	0	0
3	19264787	.	G	T	10	6	16	0	0	16	0	0
3	19264874	.	T	C	0	1	1	0	0	1	0	0
3	19267552	.	C	T	4	3	7	0	0	7	0	0
3	19267564	.	T	C	4	2	6	0	1	7	0	0
3	19267906	.	A	G	5	0	5	0	8	14	1	0
3	19270732	.	C	T	3	2	5	0	0	5	0	0
3	19271549	.	A	G	10	11	21	0	1	22	0	0
3	19273907	.	A	G	18	11	29	0	0	29	0	0
3	19274532	.	C	G	8	16	24	0	0	24	0	0
3	19274544	.	A	C	8	20	28	0	1	29	0	0
3	19274688	.	T	C	12	9	21	0	0	21	0	0
3	19277027	.	A	G	9	7	16	0	0	16	0	0
3	19277084	.	T	A	1	2	3	0	0	3	0	0
3	19278247	.	T	C	7	4	11	0	0	11	0	0
3	19278796	.	C	T	2	1	3	0	0	3	0	0
3	19281259	.	G	A	0	8	8	0	13	21	0	0
3	19281295	.	A	G	18	17	35	0	1	36	0	0
3	19281310	.	T	A	16	18	34	0	3	37	0	0
3	19336553	.	T	A	1	2	3	0	0	3	0	0
3	19338599	.	C	T	0	1	1	0	0	1	0	0
3	19339594	.	T	C	1	0	1	0	0	1	0	0
3	19346162	.	C	G	3	1	4	0	0	4	0	0
3	19346376	.	C	T	0	1	1	0	0	1	0	0
3	19354657	.	G	C	9	7	16	0	0	16	0	0
3	19354768	.	A	C	7	7	14	0	0	14	0	0
3	19354902	.	T	C	7	5	12	0	0	12	0	0
3	19609716	.	G	A	6	12	18	0	1	19	0	0
3	19609747	.	G	A	5	11	16	0	0	16	0	0
3	19609897	.	A	C	10	16	26	0	0	26	0	0
3	19610495	.	T	A	3	4	7	0	2	9	0	0
3	19610648	.	A	T	8	11	19	0	1	20	0	0
3	19610655	.	G	T	9	11	20	0	1	21	0	0
3	19610865	.	A	C	19	29	48	0	0	49	1	0
3	19610933	.	A	G	5	10	15	0	0	15	0	0
3	19665429	.	G	A	3	3	6	0	0	6	0	0
3	19678301	.	A	G	1	0	1	0	0	1	0	0
3	19678310	.	C	T	1	0	1	0	0	1	0	0
3	19685977	.	T	G	2	2	4	0	1	5	0	0
3	19686149	.	C	T	3	6	9	0	0	9	0	0
3	19686332	.	G	T	6	5	11	0	1	12	0	0
3	19687393	.	T	C	0	1	1	0	0	1	0	0
3	19702196	.	G	A	0	1	1	0	0	1	0	0
3	19702224	.	T	C	0	3	3	0	1	4	0	0
3	19702551	.	T	C	3	1	4	0	0	4	0	0
3	19706564	.	A	G	7	5	12	0	0	12	0	0
3	19707181	.	G	A	1	0	1	0	1	2	0	0
3	19710389	.	T	C	8	4	12	0	0	12	0	0
3	19716761	.	C	T	7	4	11	0	0	11	0	0
3	19717079	.	T	C	8	4	12	0	0	12	0	0
3	19717171	.	T	A	5	6	11	0	0	11	0	0
3	19717459	.	C	T	12	13	25	0	1	26	0	0
3	19717536	.	T	C	19	7	26	1	2	29	0	0
3	19717541	.	G	T	6	18	24	1	5	30	0	0
3	19717656	.	T	C	9	11	20	0	3	23	0	0
3	19717669	.	G	A	8	13	21	0	1	22	0	0
3	19851120	.	G	C	7	5	12	0	0	12	0	0
3	19851289	.	G	T	13	12	25	0	4	29	0	0
3	19851325	.	T	C	11	17	28	0	1	29	0	0
3	19914453	.	A	G	16	13	29	0	3	32	0	0
3	19914619	.	C	T	15	15	30	0	3	33	0	0
3	19914781	.	G	A	1	16	17	0	8	25	0	0
3	19969409	.	C	T	22	16	38	0	0	38	0	0
3	19969416	.	G	C	21	15	36	0	1	37	0	0
3	19969530	.	G	C	19	19	38	0	1	39	0	0
3	19969560	.	C	T	20	17	37	0	4	41	0	0
3	19969909	.	C	T	31	21	52	0	1	53	0	0
3	19970397	.	C	A	22	14	36	0	2	38	0	0
3	19970589	.	G	A	1	21	22	0	18	40	0	0
3	19971063	.	T	G	22	28	50	0	3	53	0	0
3	19971316	.	A	G	25	12	37	0	1	38	0	0
3	19971719	.	A	C	12	13	25	0	10	35	0	0
3	20015458	.	G	T	13	11	24	0	1	25	0	0
3	20015752	.	T	C	2	6	8	0	1	9	0	0
3	20015785	.	G	C	0	1	1	0	0	1	0	0
3	20021477	.	C	T	4	3	7	0	1	8	0	0
3	20021593	.	C	T	4	3	7	0	1	8	0	0
3	20026042	.	G	T	9	10	19	0	1	20	0	0
3	20026106	.	G	A	16	14	30	0	2	32	0	0
3	20026148	.	G	A	15	16	31	0	1	32	0	0
3	20036309	.	A	G	1	1	2	0	0	2	0	0
3	20040557	.	C	G	0	6	6	0	14	20	0	0
3	20042325	.	A	T	16	14	30	0	4	34	0	0
3	20042453	.	G	C	18	18	36	0	1	37	0	0
3	20042476	.	C	T	18	17	35	0	1	36	0	0
3	20042679	.	A	G	4	7	11	0	0	11	0	0
3	20042681	.	A	G	4	7	11	0	0	11	0	0
3	20042824	.	A	G	17	19	36	0	1	37	0	0
3	20042965	.	T	C	13	21	34	0	2	36	0	0
3	20043024	.	A	G	18	13	31	0	1	32	0	0
3	20043069	.	C	A	13	8	21	0	1	22	0	0
3	20043121	.	A	T	13	9	22	0	0	22	0	0
3	20043279	.	A	T	11	9	20	0	1	22	1	0
3	20043556	.	C	T	10	13	23	0	1	24	0	0
3	20045679	.	A	G	8	15	23	0	0	23	0	0
3	20049714	.	G	A	11	8	19	0	0	19	0	0
3	20051185	.	G	A	7	7	14	0	1	15	0	0
3	20051290	.	G	A	6	0	6	0	1	7	0	0
3	20062718	.	A	G	3	3	6	0	0	6	0	0
3	20063757	.	A	G	4	16	20	0	3	23	0	0
3	20063917	.	G	A	7	8	15	0	0	15	0	0
3	20063978	.	T	C	3	4	7	0	0	7	0	0
3	20064002	.	C	T	3	4	7	0	0	7	0	0
3	20108424	.	A	T	23	21	44	0	0	44	0	0
3	20108636	.	A	T	17	23	40	0	2	42	0	0
3	20108643	.	G	T	15	24	39	0	3	42	0	0
3	20108790	.	T	C	11	13	24	0	0	24	0	0
3	20109247	.	T	C	15	0	15	0	14	29	0	0
3	20109421	.	T	C	11	14	25	0	0	25	0	0
3	20109583	.	A	G	6	14	20	0	0	20	0	0
3	20109861	.	G	A	18	17	35	0	2	37	0	0
3	20109951	.	C	A	10	30	40	0	0	40	0	0
3	20110346	.	A	G	13	16	29	0	2	31	0	0
3	20110359	.	T	A	10	15	25	0	1	26	0	0
3	20110444	.	C	A	11	16	27	0	0	27	0	0
3	20110557	.	A	G	16	32	48	0	1	49	0	0
3	20118281	.	C	G	3	0	3	0	0	3	0	0
3	20224548	.	C	A	2	3	5	0	0	5	0	0
3	20224569	.	A	T	3	3	6	0	0	6	0	0
3	20224612	.	G	A	0	3	3	0	4	7	0	0
3	20224700	.	A	C	1	1	2	0	0	2	0	0
3	20224704	.	G	T	0	1	1	0	1	2	0	0
3	20226236	.	G	A	3	4	7	0	0	7	0	0
3	20226274	.	T	C	3	3	6	0	0	6	0	0
3	20226515	.	T	C	2	3	5	0	0	5	0	0
3	20226855	.	C	G	2	0	2	0	0	3	1	0
3	20226889	.	G	T	2	4	6	0	1	7	0	0
3	20226924	.	T	C	4	6	10	0	0	10	0	0
3	20226937	.	A	C	3	6	9	0	1	10	0	0
3	20227420	.	A	T	5	4	9	0	1	10	0	0
3	20227443	.	A	G	5	4	9	0	0	9	0	0
3	20227555	.	G	A	5	3	8	0	1	9	0	0
3	20227781	.	T	A	1	5	6	0	0	6	0	0
3	20227805	.	T	C	3	5	8	0	1	9	0	0
3	20227848	.	A	C	3	3	6	0	1	7	0	0
3	20227883	.	A	G	3	2	5	0	0	5	0	0
3	20227916	.	G	T	4	3	7	0	0	7	0	0
3	20228052	.	C	T	2	7	9	0	0	9	0	0
3	20228168	.	A	T	1	5	6	0	0	6	0	0
3	20228303	.	C	T	1	7	8	0	0	8	0	0
3	20228335	.	T	C	4	5	9	0	0	9	0	0
3	20228686	.	T	G	4	4	8	0	1	9	0	0
3	20228736	.	T	A	3	1	4	0	0	4	0	0
3	20228874	.	C	T	3	3	6	0	0	6	0	0
3	20229033	.	C	G	7	0	7	0	8	15	0	0
3	20229057	.	A	T	9	7	16	0	1	17	0	0
3	20229235	.	A	G	8	7	15	0	0	15	0	0
3	20229260	.	G	A	7	8	15	0	0	15	0	0
3	20229479	.	A	G	4	3	7	0	1	8	0	0
3	20229503	.	T	A	3	4	7	0	0	7	0	0
3	20229697	.	T	A	4	2	6	0	0	6	0	0
3	20229712	.	T	A	3	3	6	0	0	6	0	0
3	20231025	.	T	G	6	3	9	0	1	10	0	0
3	20231060	.	C	T	9	3	12	0	0	12	0	0
3	20231080	.	G	A	0	4	4	0	8	12	0	0
3	20231288	.	G	A	5	8	13	0	0	13	0	0
3	20231289	.	C	T	5	8	13	0	0	13	0	0
3	20231385	.	C	T	11	5	16	0	0	16	0	0
3	20231483	.	T	A	7	3	10	0	1	11	0	0
3	20231510	.	G	A	7	3	10	0	0	10	0	0
3	20231539	.	C	G	5	7	12	0	1	13	0	0
3	20404926	.	A	C	4	2	6	0	1	7	0	0
3	20658235	.	C	T	9	6	15	0	2	17	0	0
3	20658333	.	G	T	19	17	36	0	1	37	0	0
3	20658653	.	C	G	11	8	19	0	0	19	0	0
3	20658809	.	C	T	13	11	24	0	0	24	0	0
3	20658899	.	T	A	5	13	18	0	2	20	0	0
3	20659051	.	T	G	16	15	31	0	1	32	0	0
3	20666937	.	A	G	6	5	11	0	0	11	0	0
3	20666970	.	A	T	0	2	2	0	1	3	0	0
3	20677240	.	A	G	2	6	8	0	1	9	0	0
3	20677261	.	C	A	7	10	17	0	0	17	0	0
3	20720843	.	G	A	5	2	7	0	0	7	0	0
3	20721042	.	C	A	2	1	3	0	0	3	0	0
3	20721049	.	T	A	2	0	2	0	0	2	0	0
3	20752904	.	A	T	6	3	9	0	0	9	0	0
3	20752928	.	A	T	4	2	6	0	0	6	0	0
3	20793587	.	G	A	1	1	2	0	0	2	0	0
3	20950366	.	C	T	20	6	26	0	1	27	0	0
3	20950529	.	T	C	25	29	54	0	0	54	0	0
3	20956926	.	C	A	21	17	38	0	6	44	0	0
3	20956957	.	G	A	10	21	31	0	5	36	0	0
3	20973017	.	C	T	2	1	3	0	0	3	0	0
3	20982056	.	G	A	4	4	8	0	0	8	0	0
3	20982061	.	T	C	4	5	9	0	0	9	0	0
3	20982156	.	C	T	4	3	7	0	1	8	0	0
3	20982159	.	C	T	3	5	8	0	0	8	0	0
3	21020188	.	A	G	2	3	5	0	0	5	0	0
3	21022558	.	C	A	1	6	7	0	0	7	0	0
3	21022993	.	A	G	0	0	0	0	1	1	0	0
3	21022996	.	T	C	1	0	1	0	0	1	0	0
3	21025709	.	A	T	22	30	52	0	0	52	0	0
3	21025986	.	A	T	15	18	33	0	2	35	0	0
3	21026079	.	A	G	19	18	37	0	0	37	0	0
3	21026293	.	A	G	13	20	33	0	1	34	0	0
3	21026370	.	T	C	12	15	27	0	0	27	0	0
3	21026573	.	G	A	2	2	4	0	0	4	0	0
3	21026576	.	C	T	2	2	4	0	0	4	0	0
3	21026729	.	A	G	2	2	4	0	0	4	0	0
3	21026894	.	A	T	5	3	8	0	0	8	0	0
3	21027101	.	A	T	18	15	33	0	0	33	0	0
3	21027504	.	C	T	10	8	18	0	2	20	0	0
3	21027715	.	C	T	10	10	20	0	4	24	0	0
3	21027749	.	A	T	18	10	28	1	1	30	0	0
3	21029813	.	C	A	18	20	38	0	0	39	1	0
3	21029902	.	T	G	14	21	35	0	1	36	0	0
3	21030101	.	G	A	25	12	37	0	3	40	0	0
3	21030293	.	C	T	32	20	52	0	1	53	0	0
3	21030318	.	A	C	20	33	53	0	1	54	0	0
3	21030730	.	T	C	20	11	31	0	1	32	0	0
3	21044189	.	G	A	15	16	31	0	1	32	0	0
3	21062703	.	T	C	1	0	1	0	1	2	0	0
3	21062721	.	T	A	1	1	2	0	0	2	0	0
3	21066745	.	A	T	9	11	20	0	0	20	0	0
3	21067384	.	A	G	8	9	17	0	2	19	0	0
3	21067565	.	A	G	2	4	6	0	1	7	0	0
3	21067606	.	A	T	6	4	10	0	0	11	1	0
3	21067718	.	T	A	7	8	15	0	2	17	0	0
3	21067911	.	G	T	7	10	17	0	0	17	0	0
3	21068176	.	G	A	8	4	12	0	1	13	0	0
3	21068205	.	G	T	9	3	12	0	1	13	0	0
3	21068378	.	T	G	3	2	5	0	1	6	0	0
3	21074598	.	G	A	7	5	12	0	0	12	0	0
3	21074667	.	G	A	1	7	8	0	0	8	0	0
3	21087743	.	G	T	4	2	6	0	0	6	0	0
3	21094398	.	C	A	1	3	4	0	0	4	0	0
3	21094462	.	G	A	4	6	10	0	0	10	0	0
3	21096056	.	A	T	2	2	4	0	0	4	0	0
3	21096057	.	T	C	2	2	4	0	0	4	0	0
3	21096176	.	C	T	8	4	12	0	0	12	0	0
3	21096487	.	G	A	19	13	32	0	0	32	0	0
3	21096693	.	T	A	10	10	20	0	0	20	0	0
3	21104470	.	A	G	2	12	14	0	0	14	0	0
3	21111671	.	C	T	0	0	0	0	1	1	0	0
3	21111680	.	T	C	2	3	5	0	0	5	0	0
3	21111916	.	G	C	11	10	21	0	2	23	0	0
3	21111940	.	A	G	9	13	22	0	4	26	0	0
3	21113913	.	C	A	15	14	29	0	0	29	0	0
3	21125687	.	G	T	22	17	39	0	2	41	0	0
3	21126015	.	C	T	28	23	51	0	3	54	0	0
3	21139754	.	T	C	7	7	14	0	0	14	0	0
3	21140824	.	T	C	1	5	6	0	0	6	0	0
3	21140858	.	G	C	1	6	7	0	0	7	0	0
3	21140872	.	T	C	1	5	6	0	0	6	0	0
3	21141184	.	C	T	9	12	21	0	1	22	0	0
3	21142429	.	A	T	5	6	11	0	3	14	0	0
3	21240878	.	A	T	1	4	5	0	1	6	0	0
3	21240971	.	C	G	3	8	11	0	0	11	0	0
3	21241269	.	A	G	2	10	12	0	0	12	0	0
3	21241413	.	C	A	0	9	9	0	1	10	0	0
3	21241416	.	A	G	1	7	8	0	1	9	0	0
3	21241461	.	G	A	2	8	10	0	1	11	0	0
3	21251642	.	A	T	8	8	16	0	1	17	0	0
3	21251732	.	G	C	7	8	15	0	2	17	0	0
3	21251873	.	A	G	10	7	17	0	2	19	0	0
3	21251924	.	G	A	10	10	20	0	1	21	0	0
3	21252172	.	C	G	24	13	37	0	0	37	0	0
3	21281483	.	G	C	6	8	14	0	0	14	0	0
3	21281677	.	C	T	1	14	15	0	15	30	0	0
3	21282192	.	T	C	8	8	16	0	0	16	0	0
3	21282299	.	T	A	9	5	14	0	0	14	0	0
3	21282340	.	A	G	13	7	20	0	2	22	0	0
3	21282546	.	G	A	6	7	13	0	0	13	0	0
3	21282981	.	A	G	5	5	10	0	1	11	0	0
3	21283365	.	T	C	13	0	13	0	11	24	0	0
3	21283509	.	C	A	7	9	16	0	0	16	0	0
3	21283741	.	T	C	8	5	13	0	1	14	0	0
3	21283759	.	T	C	6	4	10	0	0	10	0	0
3	21284429	.	A	G	1	2	3	0	0	3	0	0
3	21284430	.	A	G	0	2	2	0	1	3	0	0
3	21284514	.	A	T	2	3	5	0	0	5	0	0
3	21284752	.	G	A	3	5	8	0	0	8	0	0
3	21284794	.	G	T	6	7	13	0	0	13	0	0
3	21287697	.	A	G	1	2	3	0	0	3	0	0
3	21287981	.	C	T	3	4	7	0	1	8	0	0
3	21288007	.	T	C	1	2	3	0	0	3	0	0
3	21348283	.	T	G	5	2	7	0	3	10	0	0
3	21669924	.	T	A	1	2	3	0	0	3	0	0
3	21882991	.	A	T	1	2	3	0	0	3	0	0
3	21886626	.	G	C	3	2	5	0	0	5	0	0
3	21887641	.	G	A	3	3	6	0	0	6	0	0
3	21887815	.	C	T	3	3	6	0	1	7	0	0
3	21889028	.	T	A	2	4	6	0	0	6	0	0
3	21889036	.	T	C	2	4	6	0	1	7	0	0
3	21889213	.	A	T	4	3	7	0	1	9	1	0
3	21889268	.	A	G	5	6	11	0	0	11	0	0
3	21889326	.	G	T	3	5	8	0	0	8	0	0
3	21889339	.	C	G	3	4	7	0	0	7	0	0
3	22039893	.	C	T	1	0	1	0	0	1	0	0
3	22050000	.	C	A	0	3	3	0	0	3	0	0
3	22050026	.	G	A	1	5	6	0	0	6	0	0
3	22050263	.	G	A	5	4	9	0	0	9	0	0
3	22054324	.	G	A	10	11	21	0	2	23	0	0
3	22054356	.	C	T	7	8	15	0	1	16	0	0
3	22054491	.	C	T	6	6	12	0	4	16	0	0
3	22054724	.	T	C	8	1	9	0	1	10	0	0
3	22054793	.	A	C	8	12	20	0	1	21	0	0
3	22055128	.	A	G	8	1	9	0	5	14	0	0
3	22079623	.	T	C	4	2	6	0	1	7	0	0
3	22080117	.	A	G	9	3	12	0	1	13	0	0
3	22080356	.	T	G	4	2	6	0	0	6	0	0
3	22127948	.	G	A	0	1	1	0	2	3	0	0
3	22146900	.	G	C	0	4	4	0	6	10	0	0
3	22146945	.	T	C	1	2	3	0	0	3	0	0
3	22153178	.	C	T	5	5	10	0	2	12	0	0
3	22153372	.	A	G	4	1	5	0	5	10	0	0
3	22153412	.	A	C	8	9	17	0	1	18	0	0
3	22153849	.	A	G	1	6	7	0	0	7	0	0
3	22153857	.	A	G	4	3	7	0	0	7	0	0
3	22153944	.	T	G	6	0	6	0	4	10	0	0
3	22154008	.	A	G	3	0	3	0	3	6	0	0
3	22154051	.	A	G	3	5	8	0	1	9	0	0
3	22154274	.	C	G	9	7	16	0	1	17	0	0
3	22154306	.	G	T	0	6	6	0	8	14	0	0
3	22154382	.	T	C	6	5	11	0	0	11	0	0
3	22154431	.	A	G	8	6	14	0	0	14	0	0
3	22154610	.	A	C	16	12	28	0	0	28	0	0
3	22158373	.	G	T	29	15	44	0	6	50	0	0
3	22158416	.	G	C	19	22	41	0	2	43	0	0
3	22158551	.	T	C	28	33	61	0	2	63	0	0
3	22158768	.	T	G	18	33	51	0	2	53	0	0
3	22158904	.	A	T	32	12	44	0	1	45	0	0
3	22159569	.	A	G	23	9	32	0	3	35	0	0
3	22159584	.	C	A	0	4	4	0	23	27	0	0
3	22159697	.	A	G	10	26	36	0	1	37	0	0
3	22159797	.	G	A	12	13	25	0	2	27	0	0
3	22159886	.	C	T	2	3	5	0	0	5	0	0
3	22159892	.	G	T	2	3	5	0	0	5	0	0
3	22160042	.	T	G	9	19	28	0	1	29	0	0
3	22160131	.	C	G	9	9	18	0	0	18	0	0
3	22160421	.	C	T	14	18	32	0	5	37	0	0
3	22160436	.	A	C	18	20	38	0	2	40	0	0
3	22160706	.	T	A	15	15	30	0	1	31	0	0
3	22160767	.	G	T	13	7	20	0	2	28	6	0
3	22160779	.	C	T	15	10	25	0	0	25	0	0
3	22160888	.	A	T	9	7	16	0	2	18	0	0
3	22160947	.	C	A	7	5	12	0	0	12	0	0
3	22161153	.	A	G	8	15	23	0	0	23	0	0
3	22161176	.	G	T	8	18	26	0	0	26	0	0
3	22161317	.	C	T	1	13	14	0	12	26	0	0
3	22161366	.	G	A	11	6	17	0	0	17	0	0
3	22161389	.	T	A	9	2	11	0	3	14	0	0
3	22161588	.	C	T	7	7	14	0	2	16	0	0
3	22168615	.	C	T	1	2	3	0	0	3	0	0
3	22172765	.	A	G	12	17	29	0	1	30	0	0
3	22172837	.	G	A	9	19	28	0	2	30	0	0
3	22179899	.	A	C	3	2	5	0	0	5	0	0
3	22180139	.	T	G	3	4	7	0	0	7	0	0
3	22180600	.	C	T	0	2	2	0	3	5	0	0
3	22180666	.	T	C	2	2	4	0	1	5	0	0
3	22191042	.	T	C	15	16	31	0	2	33	0	0
3	22191044	.	C	A	13	17	30	0	3	33	0	0
3	22213993	.	T	A	2	1	3	0	0	3	0	0
3	22216212	.	T	C	1	0	1	0	3	4	0	0
3	22216265	.	G	A	1	7	8	0	0	8	0	0
3	22216296	.	A	T	1	7	8	0	0	8	0	0
3	22216358	.	G	A	8	13	21	0	0	21	0	0
3	22432213	.	G	T	3	19	22	0	0	22	0	0
3	22542258	.	C	T	2	4	6	0	0	6	0	0
3	22547182	.	A	G	9	6	15	0	2	17	0	0
3	22547227	.	C	T	2	3	5	0	0	5	0	0
3	22548052	.	G	A	4	1	5	0	0	5	0	0
3	22548094	.	A	G	4	10	14	0	0	14	0	0
3	22548095	.	G	T	4	10	14	0	0	14	0	0
3	22548177	.	G	T	2	1	3	0	0	3	0	0
3	22548231	.	C	T	1	1	2	0	0	2	0	0
3	22548263	.	T	A	4	5	9	0	0	9	0	0
3	22548388	.	G	A	4	8	12	0	1	13	0	0
3	22548903	.	A	C	12	9	21	0	0	21	0	0
3	22548928	.	T	A	11	8	19	0	0	19	0	0
3	22636743	.	T	A	2	1	3	0	0	3	0	0
3	22760872	.	C	A	2	6	8	0	0	8	0	0
3	22783277	.	A	G	1	3	4	0	0	4	0	0
3	22783298	.	G	A	1	3	4	0	2	6	0	0
3	22788163	.	T	C	1	6	7	0	0	7	0	0
3	22788430	.	G	T	0	3	3	0	0	3	0	0
3	22788457	.	T	C	0	3	3	0	0	3	0	0
3	22789725	.	G	T	2	4	6	0	0	6	0	0
3	22790117	.	A	G	5	4	9	0	0	9	0	0
3	22792033	.	T	C	5	3	8	0	0	8	0	0
3	22794477	.	A	G	1	2	3	0	0	3	0	0
3	22794705	.	T	C	3	0	3	0	0	3	0	0
3	22811835	.	G	A	0	12	12	0	14	26	0	0
3	22812753	.	A	G	9	0	9	0	11	20	0	0
3	22812759	.	C	A	9	9	18	0	3	21	0	0
3	22813052	.	G	A	0	14	14	0	12	26	0	0
3	22813515	.	T	A	10	9	19	0	0	19	0	0
3	22813563	.	G	T	12	7	19	0	0	19	0	0
3	22813569	.	T	G	12	6	18	0	0	18	0	0
3	22813628	.	C	A	13	9	22	0	2	24	0	0
3	22813629	.	T	A	14	10	24	0	0	24	0	0
3	22813778	.	C	T	5	10	15	0	0	15	0	0
3	22813998	.	T	G	8	7	15	0	0	15	0	0
3	22814109	.	G	A	13	11	24	0	0	24	0	0
3	22814147	.	G	A	0	11	11	0	15	26	0	0
3	22814209	.	T	C	13	15	28	0	2	30	0	0
3	22814230	.	A	G	12	0	12	0	15	27	0	0
3	22814453	.	A	G	7	15	22	0	3	25	0	0
3	22814478	.	A	G	8	15	23	0	1	24	0	0
3	22814546	.	G	A	13	15	28	0	0	28	0	0
3	22815296	.	C	A	3	2	5	0	0	5	0	0
3	22815994	.	C	T	0	9	9	0	10	19	0	0
3	22816030	.	A	G	11	6	17	0	0	17	0	0
3	22816166	.	T	C	5	3	8	0	0	8	0	0
3	22816167	.	G	A	5	3	8	0	0	8	0	0
3	22816203	.	T	C	4	0	4	0	3	7	0	0
3	22816204	.	A	G	4	3	7	0	0	7	0	0
3	22816616	.	T	A	10	5	15	0	1	16	0	0
3	22816652	.	A	G	13	6	19	0	0	19	0	0
3	22816676	.	T	C	15	5	20	0	1	21	0	0
3	22816783	.	A	C	15	0	15	0	5	20	0	0
3	22816793	.	T	C	18	3	21	0	0	21	0	0
3	22816989	.	C	T	10	5	15	0	2	17	0	0
3	22817004	.	G	T	10	5	15	0	1	16	0	0
3	22817300	.	T	C	13	0	13	0	9	22	0	0
3	22821125	.	A	G	1	3	4	0	0	4	0	0
3	22823823	.	A	C	2	0	2	0	0	2	0	0
3	22828257	.	A	G	2	1	3	0	0	3	0	0
3	22829682	.	G	T	4	1	5	0	0	5	0	0
3	22947802	.	A	G	3	0	3	0	2	5	0	0
3	22947820	.	T	C	2	2	4	0	0	4	0	0
3	22953826	.	G	A	0	4	4	0	3	7	0	0
3	22953926	.	T	C	1	4	5	0	0	5	0	0
3	22993279	.	A	C	4	5	9	0	0	9	0	0
3	22993542	.	G	A	3	5	8	0	0	8	0	0
3	22994078	.	G	T	0	9	9	0	8	17	0	0
3	22994318	.	A	G	4	0	4	0	4	8	0	0
3	22994344	.	G	T	0	3	3	0	3	6	0	0
3	23019920	.	G	A	0	2	2	0	1	3	0	0
3	23248840	.	A	G	1	2	3	0	0	3	0	0
3	23250652	.	G	A	0	6	6	0	3	9	0	0
3	23251018	.	A	G	5	5	10	0	0	10	0	0
3	23251258	.	A	C	4	10	14	0	0	14	0	0
3	23251299	.	C	G	8	8	16	0	0	16	0	0
3	23251744	.	G	A	0	4	4	0	9	13	0	0
3	23251822	.	A	G	9	6	15	0	0	15	0	0
3	23302371	.	A	G	5	4	9	0	0	9	0	0
3	23307870	.	G	T	0	4	4	0	9	13	0	0
3	23309155	.	C	A	0	2	2	0	1	3	0	0
3	23309214	.	A	G	5	10	15	0	1	16	0	0
3	23318362	.	G	A	2	1	3	0	0	3	0	0
3	23318368	.	C	T	2	2	4	0	0	4	0	0
3	23323560	.	T	A	13	8	21	0	1	22	0	0
3	23323719	.	T	C	3	3	6	0	1	7	0	0
3	23323788	.	G	A	4	2	6	0	0	6	0	0
3	23323829	.	T	C	4	5	9	0	0	9	0	0
3	23324159	.	T	A	5	6	11	0	0	11	0	0
3	23324235	.	G	A	11	4	15	0	2	17	0	0
3	23324420	.	T	C	1	9	10	0	0	10	0	0
3	23324421	.	T	C	1	9	10	0	0	10	0	0
3	23324456	.	T	G	3	6	9	0	0	9	0	0
3	23324746	.	T	A	8	10	18	0	2	20	0	0
3	23324815	.	T	A	11	4	15	0	1	16	0	0
3	23324829	.	C	T	13	5	18	0	0	18	0	0
3	23325207	.	A	C	3	7	10	0	0	10	0	0
3	23325559	.	C	T	3	3	6	0	0	6	0	0
3	23326418	.	C	G	6	0	6	0	6	12	0	0
3	23326478	.	G	A	8	6	14	0	0	14	0	0
3	23326711	.	G	A	8	8	16	0	0	16	0	0
3	23327282	.	C	T	17	17	34	0	1	35	0	0
3	23334465	.	A	T	13	10	23	0	0	23	0	0
3	23335024	.	G	A	13	10	23	0	2	25	0	0
3	23351944	.	G	A	2	9	11	0	4	15	0	0
3	23363193	.	G	A	1	3	4	0	0	4	0	0
3	23406614	.	G	A	2	2	4	0	0	4	0	0
3	23406637	.	G	C	3	0	3	0	6	9	0	0
3	23406701	.	C	T	7	6	13	0	1	14	0	0
3	23407085	.	G	T	4	8	12	0	1	13	0	0
3	23429169	.	A	C	10	16	26	0	1	27	0	0
3	23429262	.	A	T	6	10	16	0	0	16	0	0
3	23429263	.	T	C	6	10	16	0	0	16	0	0
3	23429433	.	A	G	4	4	8	0	1	9	0	0
3	23429696	.	A	G	9	6	15	0	2	17	0	0
3	23429763	.	A	C	12	0	12	0	15	27	0	0
3	23430011	.	G	A	3	9	12	0	1	13	0	0
3	23430067	.	A	G	11	8	19	0	0	19	0	0
3	23430116	.	T	A	15	4	19	0	1	20	0	0
3	23430119	.	C	T	0	5	5	0	15	20	0	0
3	23436305	.	T	A	12	9	21	0	1	22	0	0
3	23442923	.	A	G	5	9	14	0	1	15	0	0
3	23443487	.	G	A	9	10	19	0	1	20	0	0
3	23444539	.	A	T	3	2	5	0	1	7	1	0
3	23444551	.	T	G	6	6	12	0	0	12	0	0
3	23456344	.	T	C	5	0	5	0	3	8	0	0
3	23464894	.	G	A	4	3	7	0	1	8	0	0
3	23464911	.	C	T	3	3	6	0	0	6	0	0
3	23465292	.	T	C	1	4	5	0	0	5	0	0
3	23466160	.	A	G	5	2	7	0	0	7	0	0
3	23469391	.	C	T	5	8	13	0	0	13	0	0
3	23469438	.	A	G	6	10	16	0	2	18	0	0
3	23469472	.	T	C	3	9	12	0	0	12	0	0
3	23469848	.	T	A	7	6	13	0	1	14	0	0
3	23470037	.	A	C	8	0	8	0	10	18	0	0
3	23470044	.	T	A	11	10	21	0	0	21	0	0
3	23470172	.	G	A	8	4	12	0	1	13	0	0
3	23470173	.	T	A	8	5	13	0	0	13	0	0
3	23488794	.	T	A	8	9	17	0	1	18	0	0
3	23493694	.	T	C	14	13	27	0	1	28	0	0
3	23495767	.	T	C	14	17	31	0	2	33	0	0
3	23495872	.	T	C	10	14	24	0	0	24	0	0
3	23495905	.	G	T	7	10	17	0	0	17	0	0
3	23495908	.	A	G	7	10	17	0	0	17	0	0
3	23584128	.	G	A	7	6	13	0	0	13	0	0
3	23584577	.	A	C	7	11	18	0	0	18	0	0
3	23584703	.	A	T	7	6	13	0	0	13	0	0
3	23584704	.	T	A	7	6	13	0	0	13	0	0
3	23584748	.	C	A	8	6	14	0	0	14	0	0
3	23591620	.	T	C	3	0	3	0	3	6	0	0
3	23591662	.	G	C	8	0	8	0	7	15	0	0
3	23599844	.	A	C	13	18	31	0	1	32	0	0
3	23705327	.	T	G	4	0	4	0	4	8	0	0
3	23748084	.	T	A	0	2	2	0	0	2	0	0
3	23748628	.	T	A	2	3	5	0	0	5	0	0
3	24071108	.	T	C	11	12	23	0	0	23	0	0
3	24100770	.	C	T	1	5	6	0	0	6	0	0
3	24109865	.	T	A	5	2	7	0	0	7	0	0
3	24110260	.	A	C	1	6	7	0	0	7	0	0
3	24111146	.	T	C	1	4	5	0	1	6	0	0
3	24134600	.	C	T	5	3	8	0	0	8	0	0
3	24134607	.	T	G	4	0	4	0	4	8	0	0
3	24142965	.	C	T	8	5	13	0	1	14	0	0
3	24143559	.	G	A	3	4	7	0	1	8	0	0
3	24144037	.	A	G	7	6	13	0	0	13	0	0
3	24145191	.	G	A	0	2	2	0	4	6	0	0
3	24196204	.	T	C	1	7	8	0	0	8	0	0
3	24196365	.	T	G	1	4	5	0	0	5	0	0
3	24198970	.	G	A	19	23	42	0	1	43	0	0
3	24200563	.	T	A	10	15	25	0	6	31	0	0
3	24203310	.	A	G	6	9	15	0	0	15	0	0
3	24203504	.	A	G	10	10	20	0	0	20	0	0
3	24203588	.	T	C	2	5	7	0	1	8	0	0
3	24203654	.	G	A	4	4	8	0	1	9	0	0
3	24203676	.	G	T	4	5	9	0	0	9	0	0
3	24203767	.	A	G	1	3	4	0	0	4	0	0
3	24207390	.	G	A	6	8	14	0	0	14	0	0
3	24209715	.	T	A	2	2	4	0	0	4	0	0
3	24209852	.	T	C	0	3	3	0	0	3	0	0
3	24216029	.	A	G	4	2	6	0	0	6	0	0
3	24216161	.	T	C	3	1	4	0	0	4	0	0
3	24218282	.	C	T	7	6	13	0	0	13	0	0
3	24218564	.	A	C	4	4	8	0	0	8	0	0
3	24292535	.	C	T	2	1	3	0	0	3	0	0
3	24295149	.	A	G	1	2	3	0	2	5	0	0
3	24361257	.	T	C	26	27	53	0	0	53	0	0
3	24434494	.	T	A	40	27	67	0	4	71	0	0
3	24434512	.	C	G	37	27	64	0	5	69	0	0
3	24434601	.	C	T	25	26	51	0	6	57	0	0
3	24483164	.	A	T	12	12	24	0	1	25	0	0
3	24483259	.	G	A	4	11	15	0	11	26	0	0
3	24487821	.	A	G	18	17	35	0	1	36	0	0
3	24487905	.	A	G	10	15	25	0	2	27	0	0
3	24489662	.	T	C	2	2	4	0	0	4	0	0
3	24489838	.	A	G	8	10	18	0	1	19	0	0
3	24501686	.	G	C	13	20	33	0	2	35	0	0
3	24501757	.	G	A	2	17	19	0	15	34	0	0
3	24501772	.	G	A	15	16	31	0	3	34	0	0
3	24517950	.	G	A	1	2	3	0	0	3	0	0
3	24690027	.	A	G	5	2	7	0	0	7	0	0
3	24690061	.	T	A	4	5	9	0	0	9	0	0
3	24690077	.	A	C	2	4	6	0	0	6	0	0
3	24690115	.	G	T	1	2	3	0	0	3	0	0
3	24690486	.	T	G	2	4	6	0	0	6	0	0
3	24690526	.	T	C	2	5	7	0	0	7	0	0
3	24692005	.	G	T	0	3	3	0	1	4	0	0
3	24692014	.	T	C	4	4	8	0	0	8	0	0
3	24692117	.	T	C	4	3	7	0	0	7	0	0
3	24763903	.	A	C	1	2	3	0	0	3	0	0
3	24765063	.	G	T	2	2	4	0	0	4	0	0
3	24765117	.	C	G	2	5	7	0	1	8	0	0
3	24973667	.	T	A	14	18	32	0	1	33	0	0
3	24973867	.	T	A	6	22	28	0	2	30	0	0
3	24973912	.	T	C	9	0	9	0	15	24	0	0
3	24974298	.	G	A	16	14	30	0	1	31	0	0
3	24990641	.	G	A	1	19	20	0	18	38	0	0
3	24990746	.	A	C	11	26	37	0	0	37	0	0
3	24993657	.	G	C	15	26	41	0	3	44	0	0
3	24993682	.	A	G	17	22	39	0	1	40	0	0
3	24994253	.	T	C	19	20	39	0	3	42	0	0
3	24997055	.	A	T	11	13	24	0	4	28	0	0
3	24997955	.	A	T	7	10	17	0	0	17	0	0
3	24998204	.	C	G	6	7	13	0	1	14	0	0
3	24998533	.	A	G	17	18	35	0	2	37	0	0
3	24998536	.	A	G	16	19	35	0	2	37	0	0
3	24998797	.	C	T	7	7	14	0	0	14	0	0
3	24998833	.	C	T	8	9	17	0	0	17	0	0
3	24998860	.	C	T	6	7	13	0	0	13	0	0
3	24999049	.	T	C	4	4	8	0	2	10	0	0
3	24999601	.	C	T	1	7	8	0	5	13	0	0
3	24999636	.	A	C	6	16	22	0	1	23	0	0
3	24999916	.	A	G	9	11	20	0	0	20	0	0
3	24999955	.	T	G	8	7	15	0	0	15	0	0
3	24999967	.	A	G	9	6	15	0	1	16	0	0
3	25000051	.	G	T	5	4	9	0	0	9	0	0
3	25000114	.	G	A	7	10	17	0	0	17	0	0
3	25000417	.	C	A	0	10	10	0	9	19	0	0
3	25002169	.	A	G	4	4	8	0	0	8	0	0
3	25005814	.	A	C	4	5	9	0	1	10	0	0
3	25027734	.	G	A	3	3	6	0	0	6	0	0
3	25036604	.	C	T	1	0	1	0	0	1	0	0
3	25039367	.	C	G	1	0	1	0	0	1	0	0
3	25039555	.	C	T	1	0	1	0	0	1	0	0
3	25040475	.	T	C	1	1	2	0	0	2	0	0
3	25059771	.	A	G	2	4	6	0	0	6	0	0
3	25060009	.	C	T	1	2	3	0	0	3	0	0
3	25066348	.	A	G	5	5	10	0	0	10	0	0
3	25072445	.	G	C	3	0	3	0	0	3	0	0
3	25085122	.	G	A	0	1	1	0	0	1	0	0
3	25097047	.	C	A	13	21	34	0	4	38	0	0
3	25097218	.	T	A	1	2	3	0	0	3	0	0
3	25097257	.	T	C	1	1	2	0	1	3	0	0
3	25099018	.	A	G	2	1	3	0	1	4	0	0
3	25099883	.	T	C	12	7	19	0	1	20	0	0
3	25099988	.	T	A	17	19	36	0	3	39	0	0
3	25100004	.	A	G	20	17	37	0	0	37	0	0
3	25100182	.	A	T	17	22	39	0	4	44	1	0
3	25100222	.	G	A	1	27	28	0	19	47	0	0
3	25100311	.	C	G	25	15	40	0	0	40	0	0
3	25100379	.	A	T	28	14	42	0	4	46	0	0
3	25100535	.	G	T	8	18	26	0	1	27	0	0
3	25100565	.	T	G	10	0	10	0	13	23	0	0
3	25102030	.	A	T	13	17	30	0	3	33	0	0
3	25102095	.	A	G	17	9	26	0	0	26	0	0
3	25105097	.	A	C	2	0	2	0	0	2	0	0
3	25107705	.	T	C	1	5	6	0	0	6	0	0
3	25107729	.	A	T	1	5	6	0	0	6	0	0
3	25136479	.	C	T	1	8	9	0	7	16	0	0
3	25136571	.	G	A	6	9	15	0	0	15	0	0
3	25136655	.	T	A	5	7	12	0	0	12	0	0
3	25136706	.	C	G	6	4	10	0	2	12	0	0
3	25136819	.	T	G	6	8	14	0	0	14	0	0
3	25136855	.	G	T	7	8	15	0	1	16	0	0
3	25136868	.	A	G	6	8	14	0	1	15	0	0
3	25137144	.	G	T	10	4	14	0	0	14	0	0
3	25137706	.	A	G	2	2	4	0	0	4	0	0
3	25138011	.	G	A	3	5	8	0	0	8	0	0
3	25138264	.	G	T	5	6	11	0	0	11	0	0
3	25138306	.	C	T	7	6	13	0	0	13	0	0
3	25138543	.	C	T	0	8	8	0	5	13	0	0
3	25144108	.	A	C	3	2	5	0	0	5	0	0
3	25144109	.	T	C	3	2	5	0	0	5	0	0
3	25144211	.	A	G	2	4	6	0	0	6	0	0
3	25147989	.	G	A	3	0	3	0	0	3	0	0
3	25147990	.	C	G	0	0	0	0	3	3	0	0
3	25167162	.	A	G	7	6	13	0	0	13	0	0
3	25167238	.	C	A	4	6	10	0	0	10	0	0
3	25167332	.	A	C	2	11	13	0	1	14	0	0
3	25167351	.	A	C	3	12	15	0	0	15	0	0
3	25168907	.	A	T	4	6	10	0	0	10	0	0
3	25168994	.	C	T	7	11	18	0	1	19	0	0
3	25169181	.	C	T	4	2	6	0	0	6	0	0
3	25169483	.	C	T	5	4	9	0	0	9	0	0
3	25269936	.	A	C	8	14	22	0	1	23	0	0
3	25269960	.	A	G	10	21	31	0	0	31	0	0
3	25270023	.	A	G	9	17	26	0	1	27	0	0
3	25270048	.	G	T	9	19	28	0	1	29	0	0
3	25270058	.	A	C	9	22	31	0	0	31	0	0
3	25270311	.	A	G	25	22	47	0	14	61	0	0
3	25270320	.	A	G	27	21	48	0	16	64	0	0
3	25270602	.	C	G	29	35	64	0	2	66	0	0
3	25270680	.	C	T	38	30	68	0	3	71	0	0
3	25270710	.	A	C	41	25	66	0	4	70	0	0
3	25270752	.	A	G	27	23	50	0	4	54	0	0
3	25271209	.	T	A	27	23	50	0	3	53	0	0
3	25271579	.	C	T	11	10	21	0	1	22	0	0
3	25271653	.	T	C	12	25	37	0	0	37	0	0
3	25272051	.	T	A	1	2	3	0	0	3	0	0
3	25272623	.	C	T	21	30	51	0	7	58	0	0
3	25272859	.	T	A	19	31	50	0	1	51	0	0
3	25273463	.	G	A	18	25	43	0	3	46	0	0
3	25273524	.	G	C	6	4	10	0	2	12	0	0
3	25273648	.	A	G	3	6	9	0	0	9	0	0
3	25286050	.	G	A	4	9	13	0	0	13	0	0
3	25379483	.	C	A	2	15	17	0	8	25	0	0
3	25379546	.	A	G	19	19	38	0	5	43	0	0
3	25381494	.	G	A	17	21	38	0	0	38	0	0
3	25393308	.	A	G	14	17	31	0	0	31	0	0
3	25396677	.	G	T	14	20	34	0	4	38	0	0
3	25403654	.	G	A	2	5	7	0	0	7	0	0
3	25403812	.	G	C	5	5	10	0	0	10	0	0
3	25403865	.	G	T	3	4	7	0	0	7	0	0
3	25404038	.	G	A	4	6	10	0	0	10	0	0
3	25404045	.	A	G	3	6	9	0	1	10	0	0
3	25404444	.	G	T	3	2	5	0	0	5	0	0
3	25404591	.	G	A	5	2	7	0	0	7	0	0
3	25404618	.	T	C	2	3	5	0	0	5	0	0
3	25404626	.	G	T	1	3	4	0	0	4	0	0
3	25404699	.	G	A	1	1	2	0	0	2	0	0
3	25405033	.	C	T	3	3	6	0	0	6	0	0
3	25409641	.	C	T	0	3	3	0	3	6	0	0
3	25409655	.	C	T	2	3	5	0	1	6	0	0
3	25417006	.	G	A	1	3	4	0	0	4	0	0
3	25417042	.	A	G	1	3	4	0	0	4	0	0
3	25417279	.	G	A	3	2	5	0	0	5	0	0
3	25417345	.	C	T	2	3	5	0	0	5	0	0
3	25420845	.	T	C	1	3	4	0	0	4	0	0
3	25436830	.	T	C	7	6	13	0	0	13	0	0
3	25436893	.	T	G	3	9	12	0	0	12	0	0
3	25436914	.	T	G	3	5	8	0	0	8	0	0
3	25437284	.	G	T	17	12	29	0	3	32	0	0
3	25491134	.	A	G	8	9	17	0	0	17	0	0
3	26032381	.	A	G	8	4	12	0	0	12	0	0
3	27695410	.	A	G	5	4	9	0	0	9	0	0
3	27767288	.	A	G	10	10	20	0	0	20	0	0
3	27831388	.	A	G	4	2	6	0	1	7	0	0
3	27831400	.	A	G	3	3	6	0	2	8	0	0
3	27831725	.	A	G	4	0	4	0	4	8	0	0
3	27833093	.	T	C	18	6	24	0	1	25	0	0
3	27834305	.	T	C	18	10	28	0	3	31	0	0
3	27834412	.	T	C	11	23	34	0	0	34	0	0
3	27834552	.	T	C	10	9	19	0	2	21	0	0
3	27834563	.	T	C	13	8	21	0	2	23	0	0
3	27836036	.	T	C	3	8	11	0	0	11	0	0
3	28068221	.	T	G	6	3	9	0	40	49	0	0
3	28626340	.	A	C	1	5	6	0	0	6	0	0
3	28627044	.	T	A	2	3	5	0	0	5	0	0
3	28634485	.	T	A	5	6	11	0	1	12	0	0
3	28634549	.	A	G	12	6	18	0	1	19	0	0
3	28634883	.	C	A	15	7	22	0	2	24	0	0
3	28634884	.	A	C	13	8	21	0	3	24	0	0
3	28635106	.	G	A	16	11	27	0	1	28	0	0
3	28640608	.	C	T	0	3	3	0	5	8	0	0
3	28640734	.	G	A	10	11	21	0	0	21	0	0
3	28650721	.	T	C	1	0	1	0	3	4	0	0
3	28665218	.	T	C	8	7	15	0	0	15	0	0
3	28665239	.	G	A	7	8	15	0	0	15	0	0
3	28719103	.	G	A	4	5	9	0	1	10	0	0
3	28719160	.	C	A	5	3	8	0	0	8	0	0
3	28719506	.	C	G	2	7	9	0	0	9	0	0
3	28719592	.	T	G	10	5	15	0	1	16	0	0
3	28719636	.	T	A	4	9	13	0	0	13	0	0
3	28719649	.	C	T	3	9	12	0	0	12	0	0
3	28719730	.	G	T	8	6	14	0	0	14	0	0
3	28719776	.	G	A	5	6	11	0	1	12	0	0
3	28719852	.	T	C	3	9	12	0	0	12	0	0
3	28719878	.	G	A	3	11	14	0	0	14	0	0
3	28719905	.	C	A	0	11	11	0	2	13	0	0
3	28719971	.	C	A	0	5	5	0	7	12	0	0
3	28720010	.	G	A	6	6	12	0	1	13	0	0
3	28750223	.	G	T	3	6	9	0	0	9	0	0
3	28750376	.	A	C	4	2	6	0	0	6	0	0
3	28750377	.	G	C	4	2	6	0	0	6	0	0
3	29950927	.	T	C	10	5	15	0	1	16	0	0
3	29951245	.	T	C	18	10	28	0	0	28	0	0
3	29951246	.	T	C	12	13	25	0	3	28	0	0
3	29951384	.	T	C	13	3	16	0	0	16	0	0
3	30749508	.	T	C	1	0	1	0	8	9	0	0
3	30749541	.	G	A	1	6	7	0	0	7	0	0
3	30801282	.	G	A	7	8	15	0	0	15	0	0
3	30801297	.	G	T	4	8	12	0	1	13	0	0
3	30868430	.	A	G	4	2	6	0	0	6	0	0
3	30868853	.	T	G	11	6	17	0	0	17	0	0
3	30868855	.	T	C	9	6	15	0	2	17	0	0
3	30869662	.	C	T	1	5	6	0	0	6	0	0
3	30869728	.	C	T	0	5	5	0	4	9	0	0
3	30869938	.	A	G	4	5	9	0	0	9	0	0
3	30870382	.	T	G	3	10	13	0	0	13	0	0
3	30870409	.	G	A	1	6	7	0	3	10	0	0
3	30870508	.	G	A	9	6	15	0	0	15	0	0
3	30870838	.	T	A	4	2	6	0	0	6	0	0
3	30870974	.	A	C	4	5	9	0	1	10	0	0
3	30871021	.	G	T	3	4	7	0	0	7	0	0
3	30871478	.	A	T	1	6	7	0	0	7	0	0
3	30871873	.	C	G	0	0	0	0	3	3	0	0
3	30872004	.	C	T	3	2	5	0	0	5	0	0
3	30872264	.	T	G	10	6	16	0	0	16	0	0
3	30872655	.	T	C	1	2	3	0	0	3	0	0
3	30873029	.	G	A	1	4	5	0	0	5	0	0
3	30873048	.	G	A	1	4	5	0	0	5	0	0
3	30888824	.	T	C	28	11	39	0	0	39	0	0
3	30890630	.	T	A	9	9	18	0	0	18	0	0
3	30890869	.	G	A	17	25	42	0	3	45	0	0
3	30891201	.	A	G	22	23	45	0	2	47	0	0
3	30894281	.	A	G	5	13	18	0	1	19	0	0
3	30926689	.	A	G	1	0	1	0	0	1	0	0
3	30948173	.	G	A	6	3	9	0	0	9	0	0
3	30962456	.	C	G	1	5	6	0	0	6	0	0
3	31043733	.	A	C	1	3	4	0	0	4	0	0
3	31044205	.	A	G	2	6	8	0	0	8	0	0
3	31044649	.	T	C	2	3	5	0	0	5	0	0
3	31044850	.	T	C	1	3	4	0	0	4	0	0
3	31044986	.	G	T	1	4	5	0	0	5	0	0
3	31045098	.	G	A	2	5	7	0	0	7	0	0
3	31045271	.	T	G	3	4	7	0	0	7	0	0
3	31050554	.	T	C	3	2	5	0	0	5	0	0
3	31053268	.	A	C	1	0	1	0	0	1	0	0
3	31060219	.	A	G	1	0	1	0	6	7	0	0
3	31060366	.	C	T	1	2	3	0	0	3	0	0
3	31069634	.	T	C	12	18	30	0	4	34	0	0
3	31070892	.	A	G	1	4	5	0	0	5	0	0
3	31080994	.	G	A	1	0	1	0	0	1	0	0
3	31081017	.	T	C	1	0	1	0	0	1	0	0
3	31086366	.	A	G	1	2	3	0	1	4	0	0
3	31090353	.	C	G	2	2	4	0	0	4	0	0
3	31090424	.	T	C	1	2	3	0	0	3	0	0
3	31102468	.	C	T	1	2	3	0	0	3	0	0
3	31104104	.	G	C	3	3	6	0	1	7	0	0
3	31104127	.	A	T	3	2	5	0	1	6	0	0
3	31104209	.	A	T	1	3	4	0	1	5	0	0
3	31104333	.	A	G	6	3	9	0	0	9	0	0
3	31104969	.	G	A	17	7	24	0	0	24	0	0
3	31105259	.	A	C	24	24	48	0	1	49	0	0
3	31120249	.	C	T	9	5	14	0	0	14	0	0
3	31122581	.	T	G	12	10	22	0	4	26	0	0
3	31135832	.	T	C	1	0	1	0	7	8	0	0
3	31135898	.	T	C	1	0	1	0	2	3	0	0
3	31137926	.	T	C	1	1	2	0	0	2	0	0
3	31137957	.	G	A	2	2	4	0	0	4	0	0
3	31138225	.	A	G	3	0	3	0	0	3	0	0
3	31138247	.	C	T	5	4	9	0	0	9	0	0
3	31150018	.	C	T	1	2	3	0	0	3	0	0
3	31150064	.	A	G	1	2	3	0	0	3	0	0
3	31152443	.	G	A	1	1	2	0	0	2	0	0
3	31184034	.	C	T	1	1	2	0	0	2	0	0
3	31187564	.	C	G	5	6	11	0	0	11	0	0
3	31187608	.	C	T	2	6	8	0	0	8	0	0
3	31187810	.	T	G	1	0	1	0	1	2	0	0
3	31214520	.	G	A	1	2	3	0	0	3	0	0
3	31218153	.	C	T	0	0	0	0	2	2	0	0
3	31218230	.	G	A	1	2	3	0	0	3	0	0
3	31218240	.	T	A	2	1	3	0	0	3	0	0
3	31396212	.	A	G	4	0	4	0	4	8	0	0
3	31396679	.	A	G	3	7	10	0	0	10	0	0
3	31396760	.	A	C	6	3	9	0	3	12	0	0
3	31396781	.	C	G	6	0	6	0	6	12	0	0
3	31396826	.	T	C	3	3	6	0	0	6	0	0
3	31430327	.	T	C	3	2	5	0	0	5	0	0
3	31601308	.	G	A	0	1	1	0	1	2	0	0
3	31603976	.	G	A	2	3	5	0	0	5	0	0
3	31604133	.	T	C	4	3	7	0	0	7	0	0
3	31604834	.	A	T	9	3	12	0	1	13	0	0
3	31605033	.	A	G	2	2	4	0	0	4	0	0
3	31605039	.	C	T	2	1	3	0	0	3	0	0
3	31706607	.	C	A	7	7	14	0	2	16	0	0
3	31706966	.	T	C	8	8	16	0	0	16	0	0
3	31709010	.	C	T	10	15	25	0	0	25	0	0
3	31709079	.	G	A	7	4	11	0	0	11	0	0
3	31711526	.	T	C	5	4	9	0	1	10	0	0
3	31712328	.	G	T	1	3	4	0	1	5	0	0
3	31717595	.	C	T	13	13	26	0	3	29	0	0
3	31722101	.	A	T	15	16	31	0	2	33	0	0
3	31722342	.	A	G	3	7	10	0	0	10	0	0
3	31725824	.	C	T	15	20	35	0	2	37	0	0
3	31726066	.	T	C	19	17	36	0	1	37	0	0
3	31726395	.	G	A	1	10	11	0	14	25	0	0
3	31726541	.	A	T	5	18	23	0	1	24	0	0
3	31726829	.	C	T	10	11	21	0	0	21	0	0
3	31729160	.	T	A	2	2	4	0	0	4	0	0
3	31729177	.	G	C	0	2	2	0	0	2	0	0
3	31729328	.	A	G	3	2	5	0	2	7	0	0
3	31729707	.	C	T	0	6	6	0	1	7	0	0
3	31734188	.	C	T	0	5	5	0	2	7	0	0
3	31792683	.	G	T	13	7	20	0	3	23	0	0
3	31792856	.	G	A	16	5	21	0	2	23	0	0
3	31793080	.	C	T	9	11	20	0	0	20	0	0
3	31793515	.	T	G	10	5	15	0	1	16	0	0
3	31793518	.	G	A	5	11	16	0	0	16	0	0
3	31793557	.	A	G	7	5	12	0	1	13	0	0
3	31793715	.	G	C	4	6	10	0	0	10	0	0
3	31793739	.	C	T	4	2	6	0	0	6	0	0
3	31797508	.	C	G	5	6	11	0	0	11	0	0
3	31816315	.	T	A	0	2	2	0	0	2	0	0
3	31874969	.	G	T	2	5	7	0	0	7	0	0
3	31879513	.	T	A	4	4	8	0	0	8	0	0
3	31879626	.	G	A	6	6	12	0	1	13	0	0
3	31879725	.	T	A	7	7	14	0	0	14	0	0
3	31879726	.	C	A	6	7	13	0	1	14	0	0
3	31879880	.	G	T	9	9	18	0	2	20	0	0
3	31879911	.	T	C	11	8	19	0	0	19	0	0
3	31880184	.	C	G	0	8	8	0	9	17	0	0
3	31880641	.	C	T	1	13	14	0	14	28	0	0
3	31881082	.	G	T	6	6	12	0	0	12	0	0
3	31884321	.	C	T	0	1	1	0	3	4	0	0
3	31884477	.	C	T	9	5	14	0	0	14	0	0
3	31886783	.	C	T	1	5	6	0	1	7	0	0
3	31897070	.	A	G	2	3	5	0	0	5	0	0
3	31897120	.	T	A	2	3	5	0	0	5	0	0
3	31897138	.	T	C	0	2	2	0	0	2	0	0
3	31916624	.	T	G	5	1	6	0	10	16	0	0
3	31916701	.	A	T	9	4	13	0	0	13	0	0
3	31916724	.	A	G	12	5	17	0	1	18	0	0
3	31916787	.	G	T	17	8	25	0	0	25	0	0
3	31916863	.	T	C	9	17	26	0	0	26	0	0
3	31917075	.	T	G	7	0	7	0	7	14	0	0
3	31917279	.	G	T	5	9	14	0	0	14	0	0
3	31922838	.	G	C	1	0	1	0	0	1	0	0
3	31926052	.	C	A	1	0	1	0	0	1	0	0
3	31939473	.	G	T	0	16	16	0	8	24	0	0
3	31939566	.	C	A	15	12	27	0	1	28	0	0
3	31941152	.	C	T	11	4	15	0	1	16	0	0
3	31944357	.	A	T	13	7	20	0	0	20	0	0
3	31961992	.	G	A	1	8	9	0	10	19	0	0
3	32021628	.	G	A	10	8	18	0	0	18	0	0
3	32049740	.	C	T	7	6	13	0	4	17	0	0
3	32087455	.	T	G	0	1	1	0	0	1	0	0
3	32098194	.	C	T	3	3	6	0	0	6	0	0
3	32098379	.	A	G	2	4	6	0	0	6	0	0
3	32099841	.	A	G	25	2	27	0	19	46	0	0
3	32100183	.	G	T	8	3	11	0	0	11	0	0
3	32100206	.	T	C	8	2	10	0	1	11	0	0
3	32100755	.	T	C	13	13	26	0	2	28	0	0
3	32105746	.	C	A	4	4	8	0	1	9	0	0
3	32139671	.	G	A	2	2	4	0	1	5	0	0
3	32139701	.	C	G	2	3	5	0	0	5	0	0
3	32160490	.	G	A	0	1	1	0	0	1	0	0
3	32294745	.	G	A	26	14	40	0	0	40	0	0
3	32294869	.	C	G	0	16	16	0	22	38	0	0
3	32295151	.	C	T	18	14	32	0	1	33	0	0
3	32295294	.	G	A	19	7	26	0	2	28	0	0
3	32295519	.	A	C	14	10	24	0	0	24	0	0
3	32295635	.	T	A	8	8	16	0	1	17	0	0
3	32296122	.	C	T	12	12	24	0	3	27	0	0
3	32296202	.	G	A	12	6	18	0	1	19	0	0
3	32296253	.	T	A	9	8	17	0	1	18	0	0
3	32296283	.	G	A	9	6	15	0	1	16	0	0
3	32296306	.	G	A	4	7	11	0	1	12	0	0
3	32296379	.	A	G	11	15	26	0	0	26	0	0
3	32296559	.	G	A	11	11	22	0	0	22	0	0
3	32296560	.	C	T	0	11	11	0	11	22	0	0
3	32296673	.	A	G	18	11	29	0	2	31	0	0
3	32296873	.	G	A	15	12	27	0	4	31	0	0
3	32303045	.	G	A	8	8	16	0	0	16	0	0
3	32303698	.	A	G	1	0	1	0	0	1	0	0
3	32325218	.	A	G	3	8	11	0	1	12	0	0
3	32329167	.	A	T	12	13	25	0	0	25	0	0
3	32357596	.	C	T	15	18	33	0	6	39	0	0
3	32357799	.	A	C	25	29	54	0	3	57	0	0
3	32360978	.	G	A	4	6	10	0	0	10	0	0
3	32361669	.	G	A	19	11	30	0	0	30	0	0
3	32361865	.	A	G	4	5	9	0	0	9	0	0
3	32366131	.	T	C	10	8	18	0	1	19	0	0
3	32366279	.	T	C	11	3	14	0	0	14	0	0
3	32366332	.	G	A	9	6	15	0	0	15	0	0
3	32366403	.	C	T	11	7	18	0	0	18	0	0
3	32400967	.	C	T	24	33	57	0	6	63	0	0
3	32401159	.	C	A	24	32	56	0	4	61	1	0
3	32401252	.	C	T	24	24	48	0	4	52	0	0
3	32403959	.	T	G	6	0	6	0	10	16	0	0
3	32405571	.	C	T	3	4	7	0	0	7	0	0
3	32405865	.	G	C	12	17	29	0	1	30	0	0
3	32405910	.	C	T	20	14	34	0	0	34	0	0
3	32406447	.	T	C	19	39	58	0	2	60	0	0
3	32406547	.	T	C	21	25	46	0	0	46	0	0
3	32406618	.	G	A	20	24	44	0	7	51	0	0
3	32406631	.	C	G	23	24	47	0	2	49	0	0
3	32414109	.	T	C	0	2	2	0	0	2	0	0
3	32414873	.	T	C	1	1	2	0	0	2	0	0
3	32414882	.	G	C	1	2	3	0	0	3	0	0
3	32415781	.	A	C	2	3	5	0	0	5	0	0
3	32433953	.	T	C	3	2	5	0	0	5	0	0
3	32434974	.	G	A	0	9	9	0	13	22	0	0
3	32435034	.	G	T	2	14	16	0	13	29	0	0
3	32435757	.	G	A	0	2	2	0	4	6	0	0
3	32435874	.	G	A	0	3	3	0	6	9	0	0
3	32436024	.	C	A	2	9	11	0	0	11	0	0
3	32436109	.	T	A	4	3	7	0	1	8	0	0
3	32436156	.	T	C	6	3	9	0	0	9	0	0
3	32436426	.	C	T	9	8	17	0	1	18	0	0
3	32436736	.	G	C	5	10	15	0	0	15	0	0
3	32436774	.	G	A	9	6	15	0	0	15	0	0
3	32438425	.	A	C	11	13	24	0	0	24	0	0
3	32440805	.	A	G	8	1	9	0	0	9	0	0
3	32441156	.	T	G	15	1	16	0	16	32	0	0
3	32441297	.	C	A	11	12	23	0	0	23	0	0
3	32441385	.	G	C	19	22	41	0	2	43	0	0
3	32441532	.	G	A	3	14	17	0	1	18	0	0
3	32441779	.	C	T	24	19	43	0	1	44	0	0
3	32447505	.	G	T	24	12	36	1	2	39	0	0
3	32447674	.	C	G	19	13	32	0	0	32	0	0
3	32447800	.	T	C	5	5	10	0	0	10	0	0
3	32450399	.	T	C	10	6	16	0	0	16	0	0
3	32453727	.	G	A	6	4	10	0	0	10	0	0
3	32457325	.	G	A	0	4	4	0	7	11	0	0
3	32457620	.	T	C	7	22	29	0	1	30	0	0
3	32457686	.	T	C	16	12	28	0	2	30	0	0
3	32458627	.	C	T	7	10	17	0	1	18	0	0
3	32465042	.	C	G	1	1	2	0	2	4	0	0
3	32477891	.	T	C	8	8	16	0	0	16	0	0
3	32477950	.	T	A	0	1	1	0	0	1	0	0
3	32482222	.	A	T	9	9	18	0	1	19	0	0
3	32482231	.	A	G	10	0	10	0	9	19	0	0
3	32482495	.	G	T	2	7	9	0	8	17	0	0
3	32483557	.	T	G	10	11	21	0	1	22	0	0
3	32483956	.	T	C	14	5	19	0	0	19	0	0
3	32484034	.	A	G	19	1	20	0	12	32	0	0
3	32484039	.	A	G	22	0	22	0	11	33	0	0
3	32484204	.	T	C	14	7	21	0	0	21	0	0
3	32484472	.	T	C	9	14	23	0	1	24	0	0
3	32484676	.	T	G	16	11	27	0	0	27	0	0
3	32484892	.	A	G	7	15	22	0	1	23	0	0
3	32485306	.	A	G	19	20	39	0	3	42	0	0
3	32485324	.	C	T	23	14	37	0	3	40	0	0
3	32485366	.	A	G	21	17	38	0	1	39	0	0
3	32485519	.	A	C	13	14	27	0	4	31	0	0
3	32485967	.	C	A	26	15	41	0	3	44	0	0
3	32486049	.	A	T	12	16	28	0	2	30	0	0
3	32486069	.	C	G	11	1	12	0	10	22	0	0
3	32489613	.	C	T	21	25	46	0	1	47	0	0
3	32490098	.	C	T	20	10	30	0	0	30	0	0
3	32490251	.	G	T	13	15	28	0	1	29	0	0
3	32490264	.	G	A	10	12	22	0	2	24	0	0
3	32490487	.	G	T	8	9	17	0	0	17	0	0
3	32534263	.	A	G	2	2	4	0	0	4	0	0
3	32534353	.	C	T	4	5	9	0	1	10	0	0
3	32534365	.	T	A	4	4	8	0	0	8	0	0
3	32587304	.	C	T	6	4	10	0	0	10	0	0
3	32589250	.	G	C	1	0	1	0	3	4	0	0
3	32641716	.	T	G	3	6	9	0	0	9	0	0
3	32647124	.	T	C	17	15	32	0	2	34	0	0
3	32647194	.	C	T	10	7	17	0	3	20	0	0
3	32647252	.	G	A	13	9	22	0	1	23	0	0
3	32647308	.	G	C	8	12	20	0	0	20	0	0
3	32647414	.	A	G	2	3	5	0	0	5	0	0
3	32647558	.	A	G	9	0	9	0	7	16	0	0
3	32649846	.	C	T	8	10	18	0	0	18	0	0
3	32649960	.	G	A	13	17	30	0	0	30	0	0
3	32650004	.	A	G	8	15	23	0	3	27	1	0
3	32650199	.	C	A	3	6	9	0	0	9	0	0
3	32662034	.	A	C	2	4	6	0	0	6	0	0
3	32663485	.	T	C	2	6	8	0	0	8	0	0
3	32667118	.	A	C	3	2	5	0	1	6	0	0
3	32668818	.	A	G	5	3	8	0	0	8	0	0
3	32675236	.	G	A	7	10	17	0	1	18	0	0
3	32679267	.	T	A	1	11	12	0	0	12	0	0
3	32679289	.	T	A	6	16	22	0	1	23	0	0
3	32679332	.	C	T	11	16	27	0	0	27	0	0
3	32679528	.	C	A	11	7	18	0	1	19	0	0
3	32685708	.	A	G	3	0	3	0	5	8	0	0
3	32686230	.	A	G	5	0	5	0	3	8	0	0
3	32686245	.	T	C	2	0	2	0	0	2	0	0
3	32698458	.	T	C	3	2	5	0	0	5	0	0
3	32698500	.	A	G	9	14	23	0	0	23	0	0
3	32700697	.	A	G	5	3	8	0	0	8	0	0
3	32700758	.	A	G	9	15	24	0	1	25	0	0
3	32700988	.	C	T	10	19	29	0	0	29	0	0
3	32701031	.	T	G	7	0	7	0	13	21	1	0
3	32702596	.	T	A	14	12	26	0	0	26	0	0
3	32707219	.	G	A	3	4	7	0	0	7	0	0
3	32707267	.	T	C	3	6	9	0	0	9	0	0
3	32707272	.	C	A	1	7	8	0	0	8	0	0
3	32707480	.	C	T	7	5	12	0	1	13	0	0
3	32707621	.	C	G	8	10	18	0	0	18	0	0
3	32707813	.	C	G	9	8	17	0	4	21	0	0
3	32708077	.	T	C	9	12	21	0	0	21	0	0
3	32709139	.	G	A	1	2	3	0	0	3	0	0
3	32710705	.	A	G	10	8	18	0	1	19	0	0
3	32710812	.	G	A	0	0	0	0	1	1	0	0
3	32710999	.	C	A	7	9	16	0	0	16	0	0
3	32711117	.	T	C	2	4	6	0	2	8	0	0
3	32711147	.	T	A	4	9	13	0	1	14	0	0
3	32715571	.	G	A	3	2	5	0	0	5	0	0
3	32717529	.	C	T	0	1	1	0	0	1	0	0
3	32718605	.	A	G	2	2	4	0	0	4	0	0
3	32719715	.	T	C	2	5	7	0	0	7	0	0
3	32720342	.	T	C	0	4	4	0	1	5	0	0
3	32722973	.	C	T	4	5	9	0	1	10	0	0
3	32723033	.	A	G	8	1	9	0	2	11	0	0
3	32723497	.	A	G	3	1	4	0	6	10	0	0
3	32723698	.	C	T	4	4	8	0	0	8	0	0
3	32724010	.	G	A	0	4	4	0	4	8	0	0
3	32724100	.	G	A	1	2	3	0	0	3	0	0
3	32726271	.	A	G	4	2	6	0	1	7	0	0
3	32726357	.	A	G	1	1	2	0	0	2	0	0
3	32728304	.	T	C	5	4	9	0	1	10	0	0
3	32729150	.	T	C	11	6	17	0	0	17	0	0
3	32729232	.	T	C	9	6	15	0	2	17	0	0
3	32729591	.	C	T	6	4	10	0	2	12	0	0
3	32729663	.	C	T	5	4	9	0	0	9	0	0
3	32729723	.	A	G	3	3	6	0	1	7	0	0
3	32729732	.	T	C	3	5	8	0	0	8	0	0
3	32729759	.	C	A	5	6	11	0	1	12	0	0
3	32729827	.	A	T	7	6	13	0	0	13	0	0
3	32729845	.	G	A	8	3	11	0	0	11	0	0
3	32730011	.	A	G	3	0	3	0	6	9	0	0
3	32730071	.	T	A	5	7	12	0	0	12	0	0
3	32730131	.	A	G	4	3	7	0	0	7	0	0
3	32731255	.	A	G	8	1	9	0	10	19	0	0
3	32731418	.	C	T	5	9	14	0	1	15	0	0
3	32731750	.	A	G	0	0	0	0	2	2	0	0
3	32731804	.	T	C	2	6	8	0	1	9	0	0
3	32731840	.	T	C	5	6	11	0	0	11	0	0
3	32731855	.	T	C	5	2	7	0	0	7	0	0
3	32731879	.	A	G	4	0	4	0	1	5	0	0
3	32734926	.	G	A	1	3	4	0	2	6	0	0
3	32737727	.	C	T	4	2	6	0	0	6	0	0
3	32741137	.	G	A	0	10	10	0	8	18	0	0
3	32741385	.	G	A	0	3	3	0	9	12	0	0
3	32741809	.	A	G	5	0	5	0	13	18	0	0
3	32777481	.	A	C	10	10	20	0	1	21	0	0
3	32777733	.	G	T	6	19	25	0	0	25	0	0
3	32789654	.	G	T	4	5	9	0	6	15	0	0
3	32789985	.	T	C	0	2	2	0	0	2	0	0
3	32794931	.	C	A	6	5	11	0	1	12	0	0
3	32795068	.	C	T	4	12	16	0	1	17	0	0
3	32795461	.	A	T	5	5	10	0	0	10	0	0
3	32795614	.	C	T	0	3	3	0	0	3	0	0
3	32807667	.	G	A	5	5	10	0	0	10	0	0
3	32808023	.	T	A	10	8	18	0	2	20	0	0
3	32808185	.	T	C	16	12	28	0	2	30	0	0
3	32808214	.	G	A	16	15	31	0	2	33	0	0
3	32808338	.	A	C	20	23	43	0	3	46	0	0
3	32808554	.	T	G	5	17	22	0	2	24	0	0
3	32808771	.	G	A	6	12	18	0	1	19	0	0
3	32808772	.	G	C	5	13	18	0	1	19	0	0
3	32808979	.	T	G	11	10	21	0	2	23	0	0
3	32809154	.	A	T	3	9	12	0	0	12	0	0
3	32809368	.	G	A	8	10	18	0	2	20	0	0
3	32809410	.	G	A	8	9	17	0	1	18	0	0
3	32809432	.	T	A	9	6	15	0	2	17	0	0
3	32809548	.	T	C	5	12	17	0	0	17	0	0
3	32809561	.	G	A	6	12	18	0	0	18	0	0
3	32809836	.	A	G	11	0	11	0	8	19	0	0
3	32809927	.	T	C	3	16	19	0	3	22	0	0
3	32810011	.	T	A	9	4	13	0	0	13	0	0
3	32810580	.	C	T	13	14	27	0	2	29	0	0
3	32810715	.	A	G	6	23	29	0	0	29	0	0
3	32811094	.	A	T	8	8	16	0	0	16	0	0
3	32824612	.	T	C	1	2	3	0	0	3	0	0
3	32824848	.	T	C	1	2	3	0	0	3	0	0
3	32825427	.	C	T	1	2	3	0	0	3	0	0
3	32831417	.	T	C	1	1	2	0	0	2	0	0
3	32837514	.	G	A	6	4	10	0	1	11	0	0
3	32837643	.	G	A	20	12	32	0	3	35	0	0
3	32837904	.	A	G	27	0	27	0	15	42	0	0
3	32838033	.	G	A	0	7	7	0	8	15	0	0
3	32838039	.	A	G	7	7	14	0	0	14	0	0
3	32842163	.	C	T	8	6	14	0	2	16	0	0
3	32842235	.	G	T	8	12	20	0	0	20	0	0
3	32842318	.	C	T	6	4	10	0	0	10	0	0
3	32847839	.	C	A	3	2	5	0	0	5	0	0
3	32847887	.	C	G	3	3	6	0	0	6	0	0
3	32847923	.	C	A	3	3	6	0	0	6	0	0
3	32847942	.	A	G	4	1	5	0	4	9	0	0
3	32848175	.	T	G	1	5	6	0	0	6	0	0
3	32848418	.	C	T	4	7	11	0	0	11	0	0
3	32848714	.	A	G	7	3	10	0	1	11	0	0
3	32849079	.	C	T	4	9	13	0	0	13	0	0
3	32849679	.	T	A	7	18	25	0	0	25	0	0
3	32850029	.	A	T	5	3	8	0	0	8	0	0
3	32850265	.	A	G	0	0	0	0	2	2	0	0
3	32854276	.	T	C	5	6	11	0	0	11	0	0
3	32854533	.	T	C	6	6	12	0	1	13	0	0
3	32854743	.	C	G	5	0	5	0	12	17	0	0
3	32854744	.	A	G	5	11	16	0	1	17	0	0
3	32855066	.	G	A	4	7	11	0	0	11	0	0
3	32855359	.	C	T	1	2	3	0	0	3	0	0
3	32855362	.	G	A	1	2	3	0	0	3	0	0
3	32863016	.	A	G	2	2	4	0	1	5	0	0
3	32868114	.	G	T	1	2	3	0	0	3	0	0
3	32868143	.	C	T	1	2	3	0	0	3	0	0
3	32868519	.	G	T	2	8	10	0	0	10	0	0
3	32869770	.	C	T	5	4	9	0	0	9	0	0
3	32869773	.	G	A	5	3	8	0	1	9	0	0
3	32869930	.	C	T	2	3	5	0	0	5	0	0
3	32870488	.	C	G	1	2	3	0	0	3	0	0
3	32870497	.	T	C	1	1	2	0	2	4	0	0
3	32870756	.	A	G	2	0	2	0	4	6	0	0
3	32870766	.	G	A	2	4	6	0	0	6	0	0
3	32870947	.	A	G	3	4	7	0	0	7	0	0
3	32871023	.	G	C	2	5	7	0	0	7	0	0
3	32871350	.	T	C	2	0	2	0	5	7	0	0
3	32871413	.	G	A	1	3	4	0	0	4	0	0
3	32871414	.	A	C	1	1	2	0	2	4	0	0
3	32889849	.	T	C	11	1	12	0	12	24	0	0
3	32890002	.	G	T	12	19	31	0	2	33	0	0
3	32890058	.	A	G	17	15	32	0	0	32	0	0
3	32892061	.	G	A	4	12	16	0	0	16	0	0
3	32892422	.	A	G	4	5	9	0	0	9	0	0
3	32900428	.	A	G	8	2	10	0	0	10	0	0
3	32924643	.	G	A	2	6	8	0	1	9	0	0
3	32924836	.	T	A	7	7	14	0	1	15	0	0
3	32925066	.	G	A	6	2	8	0	0	8	0	0
3	32925248	.	C	T	5	2	7	0	0	7	0	0
3	32925264	.	G	T	5	2	7	0	0	7	0	0
3	32925400	.	C	T	3	5	8	0	0	8	0	0
3	32926016	.	C	T	0	3	3	0	1	4	0	0
3	32926025	.	G	A	1	4	5	0	0	5	0	0
3	32926058	.	A	G	1	2	3	0	0	3	0	0
3	32933849	.	A	T	3	11	14	0	0	14	0	0
3	32935936	.	A	G	5	0	5	0	4	9	0	0
3	32937628	.	A	G	11	13	24	0	0	24	0	0
3	32941242	.	G	A	6	7	13	0	0	13	0	0
3	32941661	.	A	G	5	2	7	0	1	8	0	0
3	32944203	.	C	A	7	5	12	0	0	12	0	0
3	32944569	.	C	T	3	5	8	0	0	8	0	0
3	32944668	.	C	A	13	11	24	0	1	25	0	0
3	32944854	.	C	T	15	12	27	0	2	29	0	0
3	32947971	.	T	C	2	4	6	0	0	6	0	0
3	32950959	.	G	A	9	18	27	0	0	27	0	0
3	32950977	.	G	A	0	17	17	0	8	25	0	0
3	32951001	.	G	T	0	16	16	0	9	25	0	0
3	32951394	.	G	A	23	24	47	0	2	49	0	0
3	32951564	.	A	C	8	9	17	0	0	17	0	0
3	32951637	.	G	A	11	7	18	0	2	20	0	0
3	32951778	.	C	T	10	19	29	0	2	31	0	0
3	32951891	.	T	C	17	16	33	0	0	33	0	0
3	33065643	.	T	A	7	3	10	0	0	10	0	0
3	33065950	.	T	C	1	2	3	0	0	3	0	0
3	33065985	.	A	G	5	2	7	0	0	7	0	0
3	33066155	.	C	T	0	11	11	0	3	14	0	0
3	33066629	.	C	T	0	3	3	0	3	6	0	0
3	33066714	.	A	T	3	4	7	0	0	7	0	0
3	33066804	.	T	C	6	0	6	0	6	12	0	0
3	33066809	.	C	G	8	4	12	0	0	12	0	0
3	33066969	.	T	C	9	0	9	0	3	12	0	0
3	33066976	.	T	C	8	3	11	0	1	12	0	0
3	33067092	.	A	T	1	1	2	0	0	2	0	0
3	33067337	.	A	G	1	6	7	0	0	7	0	0
3	33067340	.	A	G	1	6	7	0	0	7	0	0
3	33067376	.	G	A	2	9	11	0	0	11	0	0
3	33067438	.	G	A	2	2	4	0	0	4	0	0
3	33069274	.	A	C	5	8	13	0	0	13	0	0
3	33069596	.	G	A	7	5	12	0	0	12	0	0
3	33075167	.	C	T	1	1	2	0	0	2	0	0
3	33341072	.	T	A	4	5	9	0	0	9	0	0
3	33344470	.	T	A	7	9	16	0	1	17	0	0
3	33344636	.	A	T	3	4	7	0	0	7	0	0
3	33368134	.	T	C	0	8	8	0	1	9	0	0
3	33372555	.	G	C	0	2	2	0	6	8	0	0
3	33373540	.	A	C	7	6	13	0	0	13	0	0
3	33375645	.	C	A	0	5	5	0	0	5	0	0
3	33379072	.	C	T	3	4	7	0	0	7	0	0
3	33396615	.	C	G	1	2	3	0	0	3	0	0
3	33420614	.	A	T	1	2	3	0	0	3	0	0
3	33424010	.	C	T	1	11	12	0	6	18	0	0
3	33424420	.	G	A	20	12	32	0	6	38	0	0
3	33426513	.	G	A	8	6	14	0	2	16	0	0
3	33433319	.	T	C	1	0	1	0	3	4	0	0
3	33433338	.	T	C	1	2	3	0	0	3	0	0
3	33433621	.	G	A	3	4	7	0	0	7	0	0
3	33437399	.	T	C	1	0	1	0	0	1	0	0
3	33440693	.	C	T	6	4	10	0	0	10	0	0
3	33445039	.	A	T	6	4	10	0	1	11	0	0
3	33445090	.	G	C	0	10	10	0	7	17	0	0
3	33449405	.	C	T	5	4	9	0	0	9	0	0
3	33449554	.	G	A	0	7	7	0	4	11	0	0
3	33452168	.	C	T	15	20	35	0	0	35	0	0
3	33455809	.	G	A	1	5	6	0	10	16	0	0
3	33458803	.	C	T	15	18	33	0	0	33	0	0
3	33458911	.	A	T	7	12	19	0	0	19	0	0
3	33459394	.	T	A	3	14	17	0	2	19	0	0
3	33459489	.	C	T	4	7	11	0	1	12	0	0
3	33459517	.	C	T	4	8	12	0	0	12	0	0
3	33459532	.	G	A	4	9	13	0	1	14	0	0
3	33461366	.	C	T	0	8	8	0	19	27	0	0
3	33461646	.	C	T	1	4	5	0	9	14	0	0
3	33461796	.	A	T	9	10	19	0	1	20	0	0
3	33469614	.	T	A	1	5	6	0	0	6	0	0
3	33473131	.	C	T	0	6	6	0	14	20	0	0
3	33476589	.	T	C	4	7	11	0	0	11	0	0
3	33478690	.	G	A	6	4	10	0	1	11	0	0
3	33494089	.	A	T	10	13	23	0	0	23	0	0
3	33494091	.	G	C	10	13	23	0	0	23	0	0
3	33570763	.	G	A	2	5	7	0	0	7	0	0
3	33571294	.	C	T	3	2	5	0	0	5	0	0
3	33572206	.	G	C	3	0	3	0	7	10	0	0
3	33572404	.	C	T	0	5	5	0	3	8	0	0
3	33572512	.	C	A	3	2	5	0	0	5	0	0
3	33572553	.	T	G	3	2	5	0	0	5	0	0
3	33747527	.	A	G	1	0	1	0	0	1	0	0
3	33747563	.	A	G	4	0	4	0	4	8	0	0
3	33761597	.	C	T	10	9	19	0	0	19	0	0
3	33761705	.	G	A	0	10	10	0	12	22	0	0
3	33761834	.	G	A	12	7	19	0	1	20	0	0
3	33761835	.	A	T	13	7	20	0	0	20	0	0
3	33762068	.	A	G	5	9	14	0	0	14	0	0
3	33762278	.	A	G	8	9	17	0	1	18	0	0
3	33762310	.	C	A	6	7	13	0	3	16	0	0
3	33762408	.	T	A	5	12	17	0	1	18	0	0
3	33762480	.	C	T	4	5	9	0	0	9	0	0
3	33773294	.	A	G	16	12	28	0	6	34	0	0
3	33777317	.	T	G	6	9	15	0	0	15	0	0
3	33777425	.	A	G	15	11	26	0	1	27	0	0
3	33777807	.	A	G	5	0	5	0	0	5	0	0
3	33820568	.	C	T	1	1	2	0	0	2	0	0
3	33820580	.	A	G	1	1	2	0	0	2	0	0
3	33821929	.	C	T	2	1	3	0	0	3	0	0
3	33834678	.	T	C	2	1	3	0	2	5	0	0
3	33847104	.	A	G	1	3	4	0	1	5	0	0
3	33847131	.	C	T	4	4	8	0	0	8	0	0
3	33847191	.	T	C	3	3	6	0	1	7	0	0
3	33854879	.	T	C	3	1	4	0	0	4	0	0
3	33854927	.	G	A	1	2	3	0	0	3	0	0
3	33918537	.	T	A	2	4	6	0	0	6	0	0
3	33918611	.	A	G	3	3	6	0	1	7	0	0
3	33918675	.	T	G	5	5	10	0	0	10	0	0
3	33918775	.	A	G	7	7	14	0	1	15	0	0
3	33921663	.	A	C	3	6	9	0	0	9	0	0
3	33922112	.	T	G	1	3	4	0	0	4	0	0
3	33922168	.	T	A	3	4	7	0	0	7	0	0
3	33922269	.	A	G	1	2	3	0	0	3	0	0
3	33922359	.	G	A	4	9	13	0	0	13	0	0
3	33922413	.	T	A	2	8	10	0	0	10	0	0
3	33922415	.	G	A	2	8	10	0	0	10	0	0
3	33922471	.	T	C	4	6	10	0	1	11	0	0
3	33932170	.	C	T	0	4	4	0	0	4	0	0
3	33932628	.	G	A	3	7	10	0	0	10	0	0
3	33934848	.	T	C	5	4	9	0	1	10	0	0
3	33934849	.	G	C	5	5	10	0	0	10	0	0
3	33936783	.	G	C	2	3	5	0	0	5	0	0
3	34123144	.	G	T	1	2	3	0	0	3	0	0
3	34129941	.	C	T	0	9	9	0	17	26	0	0
3	34135868	.	C	T	5	1	6	0	0	6	0	0
3	34144807	.	C	G	5	3	8	0	0	8	0	0
3	34144808	.	G	A	0	2	2	0	6	8	0	0
3	34145131	.	T	G	3	2	5	0	0	5	0	0
3	34146338	.	C	T	3	3	6	0	0	6	0	0
3	34146882	.	G	T	2	7	9	0	1	10	0	0
3	34166288	.	C	A	5	4	9	0	0	9	0	0
3	34170913	.	G	A	10	16	26	0	1	27	0	0
3	34180096	.	G	T	0	1	1	0	0	1	0	0
3	34182164	.	C	T	6	6	12	0	0	12	0	0
3	34182306	.	G	C	11	6	17	0	0	17	0	0
3	34182376	.	A	C	6	11	17	0	0	17	0	0
3	34182386	.	G	A	0	9	9	0	7	16	0	0
3	34220359	.	A	T	3	2	5	0	0	5	0	0
3	34244901	.	G	C	4	11	15	0	0	15	0	0
3	34258965	.	G	A	11	10	21	0	1	22	0	0
3	34259013	.	C	G	16	11	27	0	0	27	0	0
3	34259060	.	C	T	25	14	39	0	0	39	0	0
3	34259869	.	T	G	13	0	13	0	3	16	0	0
3	34260325	.	T	C	7	9	16	0	1	17	0	0
3	34260808	.	T	C	3	6	9	0	0	9	0	0
3	34261204	.	T	C	5	12	17	0	2	20	1	0
3	34261354	.	A	G	18	16	34	0	1	35	0	0
3	34261795	.	G	A	6	11	17	0	0	17	0	0
3	34262290	.	C	T	12	12	24	0	1	25	0	0
3	34262421	.	C	A	8	7	15	0	0	15	0	0
3	34262639	.	G	A	5	17	22	0	0	22	0	0
3	34262823	.	A	T	11	12	23	0	0	23	0	0
3	34263007	.	C	T	0	9	9	0	8	17	0	0
3	34264140	.	A	T	4	2	6	0	1	7	0	0
3	34264634	.	T	A	6	3	9	0	0	9	0	0
3	34264657	.	A	T	6	3	9	0	0	9	0	0
3	34327103	.	G	A	0	1	1	0	0	1	0	0
3	34337582	.	A	G	2	2	4	0	0	4	0	0
3	34455822	.	T	C	1	0	1	0	3	4	0	0
3	34456538	.	A	G	3	3	6	0	0	6	0	0
3	34470645	.	A	T	3	2	5	0	0	5	0	0
3	34588493	.	A	G	1	2	3	0	0	3	0	0
3	34588788	.	G	A	5	3	8	0	0	8	0	0
3	34599655	.	T	G	1	2	3	0	0	3	0	0
3	34604202	.	A	G	1	2	3	0	0	3	0	0
3	34697461	.	G	A	3	2	5	0	0	5	0	0
3	34697514	.	T	C	6	0	6	0	6	12	0	0
3	34703722	.	T	G	2	3	5	0	0	5	0	0
3	34703731	.	G	C	2	3	5	0	0	5	0	0
3	34766992	.	T	C	1	1	2	0	3	6	1	0
3	34767112	.	G	T	28	23	51	0	4	55	0	0
3	34767662	.	T	G	21	34	55	0	2	57	0	0
3	34767669	.	G	A	21	34	55	0	2	57	0	0
3	34772941	.	T	G	18	22	40	0	1	41	0	0
3	34775942	.	G	A	17	17	34	0	4	38	0	0
3	34776115	.	T	G	1	1	2	0	1	3	0	0
3	34776133	.	G	C	2	4	6	0	0	6	0	0
3	34776151	.	C	A	2	4	6	0	0	6	0	0
3	34781074	.	A	G	18	31	49	0	2	51	0	0
3	34781095	.	C	T	16	34	50	0	4	54	0	0
3	34781448	.	T	C	13	12	25	0	0	25	0	0
3	34781586	.	T	C	1	0	1	0	1	2	0	0
3	34783970	.	G	A	7	3	10	0	1	11	0	0
3	34783982	.	A	G	9	3	12	0	2	14	0	0
3	34801034	.	T	C	7	8	15	0	1	16	0	0
3	34804427	.	A	G	9	7	16	0	4	20	0	0
3	34814839	.	A	G	2	1	3	0	0	3	0	0
3	34822049	.	C	T	9	11	20	0	1	21	0	0
3	34822169	.	C	T	15	11	26	0	0	26	0	0
3	34822214	.	T	C	7	11	18	0	0	18	0	0
3	34919853	.	A	G	3	0	3	0	3	6	0	0
3	34919892	.	C	T	8	7	15	0	2	17	0	0
3	34977497	.	A	G	4	0	4	0	2	6	0	0
3	34977508	.	A	G	1	0	1	0	1	2	0	0
3	34981394	.	T	C	4	4	8	0	0	8	0	0
3	34994140	.	C	T	33	25	58	0	2	60	0	0
3	34994750	.	A	G	15	16	31	0	1	32	0	0
3	35170112	.	T	C	5	5	10	0	1	11	0	0
3	35225160	.	A	G	11	0	11	0	19	30	0	0
3	35225202	.	C	T	15	17	32	0	1	33	0	0
3	35248387	.	T	C	18	6	24	0	4	28	0	0
3	35248470	.	T	C	14	10	24	0	0	24	0	0
3	35248492	.	T	A	14	11	25	0	0	25	0	0
3	35249369	.	T	C	12	19	31	0	0	31	0	0
3	35249535	.	T	C	16	15	31	0	0	31	0	0
3	35250145	.	A	T	18	20	38	0	0	38	0	0
3	35250188	.	A	G	16	23	39	0	1	40	0	0
3	35264406	.	T	G	27	16	43	0	1	44	0	0
3	35264460	.	C	T	41	15	56	0	1	57	0	0
3	35264744	.	T	A	14	19	33	0	2	35	0	0
3	35264951	.	G	A	17	6	23	0	0	23	0	0
3	35265350	.	T	C	17	12	29	0	1	30	0	0
3	35265419	.	T	G	23	7	30	0	0	30	0	0
3	35265654	.	G	A	1	23	24	0	32	56	0	0
3	35266006	.	G	A	1	4	5	0	0	5	0	0
3	35298725	.	T	A	10	5	15	0	0	15	0	0
3	35374514	.	C	T	2	2	4	0	0	4	0	0
3	35374719	.	C	T	13	13	26	0	1	27	0	0
3	35375112	.	G	A	12	13	25	0	4	29	0	0
3	35375162	.	T	A	18	15	33	0	0	33	0	0
3	35375279	.	A	T	13	13	26	0	0	26	0	0
3	35375306	.	T	C	13	7	20	0	0	20	0	0
3	35375448	.	T	G	15	1	16	0	17	34	1	0
3	35375638	.	T	A	13	10	23	0	2	25	0	0
3	35418047	.	A	G	3	5	8	0	0	8	0	0
3	35419683	.	A	T	9	7	16	0	1	17	0	0
3	35420588	.	A	G	5	5	10	0	0	10	0	0
3	35420604	.	C	T	4	3	7	0	1	8	0	0
3	35514786	.	C	T	5	10	15	0	1	16	0	0
3	35514849	.	C	A	2	7	9	0	4	13	0	0
3	35515053	.	G	T	6	5	11	0	0	11	0	0
3	35515074	.	C	T	5	5	10	0	1	11	0	0
3	35515103	.	G	A	1	4	5	0	0	5	0	0
3	35515179	.	T	C	2	7	9	0	0	9	0	0
3	35515206	.	G	A	3	3	6	0	0	6	0	0
3	35515304	.	T	G	4	4	8	0	1	9	0	0
3	35515866	.	A	T	6	6	12	0	0	12	0	0
3	35517999	.	A	C	7	3	10	0	1	11	0	0
3	35518036	.	C	G	11	5	16	0	0	16	0	0
3	35523824	.	C	G	7	6	13	0	1	14	0	0
3	35527024	.	T	C	4	3	7	0	1	8	0	0
3	35529040	.	T	C	7	14	21	0	0	21	0	0
3	35530655	.	C	T	8	3	11	0	4	15	0	0
3	35530787	.	C	T	4	3	7	0	1	8	0	0
3	35531018	.	T	C	6	12	18	0	3	21	0	0
3	35531028	.	T	C	8	11	19	0	3	22	0	0
3	35531328	.	G	A	0	10	10	0	8	18	0	0
3	35531329	.	A	T	7	9	16	0	2	18	0	0
3	35531671	.	A	T	11	8	19	0	0	19	0	0
3	35531791	.	A	G	14	0	14	0	14	28	0	0
3	35531866	.	T	A	18	19	37	0	1	38	0	0
3	35531985	.	G	A	21	22	43	0	2	45	0	0
3	35532074	.	A	T	10	15	25	0	2	27	0	0
3	35532452	.	A	T	17	20	37	0	0	37	0	0
3	35532634	.	A	G	11	0	11	0	13	24	0	0
3	35532665	.	C	T	14	12	26	0	0	26	0	0
3	35532736	.	A	C	11	13	24	0	0	24	0	0
3	35535484	.	G	A	2	2	4	0	0	4	0	0
3	35536115	.	C	G	6	13	19	0	1	20	0	0
3	35536269	.	G	A	1	4	5	0	0	5	0	0
3	35541273	.	A	G	24	28	52	0	3	55	0	0
3	35549002	.	G	A	1	2	3	0	0	3	0	0
3	35551047	.	A	T	14	13	27	0	2	29	0	0
3	35551190	.	C	T	1	10	11	0	8	19	0	0
3	35589548	.	C	T	18	26	44	0	0	44	0	0
3	35589881	.	T	C	17	8	25	0	11	36	0	0
3	35589908	.	A	G	22	16	38	0	0	38	0	0
3	35589918	.	G	A	20	17	37	0	1	38	0	0
3	35590270	.	T	C	28	3	31	0	22	53	0	0
3	35602007	.	A	C	17	0	17	0	20	37	0	0
3	35602047	.	A	G	19	20	39	0	5	44	0	0
3	35602153	.	A	G	14	16	30	0	0	30	0	0
3	35602154	.	T	A	13	16	29	0	0	30	1	0
3	35608511	.	C	T	1	0	1	0	0	1	0	0
3	35617940	.	A	C	1	2	3	0	0	3	0	0
3	35617943	.	A	C	1	2	3	0	0	3	0	0
3	35621515	.	T	G	1	0	1	0	4	5	0	0
3	35623614	.	A	G	2	1	3	0	0	3	0	0
3	35634953	.	A	G	3	4	7	0	1	8	0	0
3	35635039	.	C	T	7	5	12	0	0	12	0	0
3	35635273	.	A	G	2	0	2	0	3	5	0	0
3	35636081	.	A	G	3	1	4	0	2	6	0	0
3	35636095	.	A	G	5	2	7	0	1	8	0	0
3	35636157	.	A	G	4	2	6	0	0	6	0	0
3	35636392	.	A	G	3	3	6	0	0	6	0	0
3	35638008	.	T	A	10	8	18	0	0	18	0	0
3	35638119	.	A	C	15	15	30	0	1	31	0	0
3	35638201	.	A	G	9	17	26	0	1	27	0	0
3	35638240	.	C	T	11	16	27	0	0	27	0	0
3	35638366	.	T	C	9	6	15	0	0	15	0	0
3	35638450	.	T	A	3	6	9	0	1	10	0	0
3	35638513	.	G	A	10	7	17	0	0	17	0	0
3	35638908	.	C	T	0	23	23	0	17	40	0	0
3	35638986	.	C	A	18	15	33	0	1	34	0	0
3	35639020	.	A	G	14	20	34	0	1	35	0	0
3	35639021	.	G	A	15	20	35	0	0	35	0	0
3	35639194	.	T	C	9	20	29	0	0	29	0	0
3	35639621	.	A	C	18	12	30	0	1	31	0	0
3	35639817	.	T	A	7	10	17	0	1	18	0	0
3	35639862	.	G	T	7	9	16	0	0	16	0	0
3	35639884	.	T	C	10	0	10	0	6	16	0	0
3	35639958	.	T	C	9	1	10	0	0	10	0	0
3	35640042	.	A	G	14	9	23	0	2	25	0	0
3	35640122	.	G	T	9	7	16	0	1	17	0	0
3	35640313	.	A	G	5	6	11	0	0	11	0	0
3	35640441	.	C	A	11	7	18	0	0	18	0	0
3	35640588	.	A	G	8	4	12	0	1	13	0	0
3	35640625	.	C	T	13	8	21	0	1	22	0	0
3	35640784	.	T	C	10	14	24	0	2	26	0	0
3	35641173	.	C	T	4	2	6	0	0	6	0	0
3	35641371	.	C	T	0	16	16	0	10	26	0	0
3	35641382	.	G	A	10	19	29	0	0	29	0	0
3	35641595	.	A	T	13	11	24	0	0	24	0	0
3	35641785	.	C	T	0	8	8	0	7	15	0	0
3	35642012	.	A	T	7	7	14	0	1	15	0	0
3	35642072	.	A	G	12	10	22	0	0	22	0	0
3	35642462	.	T	C	6	0	6	0	7	13	0	0
3	35643320	.	G	A	4	5	9	0	0	9	0	0
3	35643378	.	T	C	0	0	0	0	10	10	0	0
3	35643540	.	G	A	6	3	9	0	1	10	0	0
3	35643546	.	A	T	4	4	8	0	1	9	0	0
3	35645380	.	T	C	14	0	14	0	15	29	0	0
3	35645411	.	G	A	6	9	15	0	0	15	0	0
3	35645661	.	T	G	10	14	24	0	1	25	0	0
3	35646025	.	G	T	7	13	20	0	1	21	0	0
3	35646160	.	G	T	5	4	9	0	0	10	1	0
3	35646611	.	T	G	4	4	8	0	0	8	0	0
3	35647181	.	A	G	11	7	18	0	1	19	0	0
3	35647321	.	G	A	5	11	16	0	0	16	0	0
3	35647975	.	A	G	1	3	4	0	0	4	0	0
3	35652750	.	G	A	0	1	1	0	0	1	0	0
3	35652765	.	G	A	0	1	1	0	0	1	0	0
3	35800614	.	C	G	2	5	7	0	1	8	0	0
3	35800738	.	T	C	5	7	12	0	0	12	0	0
3	35800758	.	T	G	3	3	6	0	1	7	0	0
3	35831029	.	T	C	2	0	2	0	0	2	0	0
3	35831095	.	G	T	4	5	9	0	0	9	0	0
3	35831167	.	T	C	2	1	3	0	0	3	0	0
3	35840264	.	A	G	2	0	2	0	3	5	0	0
3	35840267	.	T	A	3	2	5	0	0	5	0	0
3	35845774	.	T	C	1	2	3	0	0	3	0	0
3	35845805	.	A	G	2	2	4	0	0	4	0	0
3	35846120	.	C	G	5	9	14	0	1	15	0	0
3	35846343	.	C	G	4	4	8	0	0	8	0	0
3	35846410	.	A	T	4	5	9	0	0	10	1	0
3	35846440	.	G	A	2	5	7	0	1	8	0	0
3	35846823	.	A	G	8	5	13	0	0	13	0	0
3	35850254	.	G	A	1	2	3	0	0	3	0	0
3	35850364	.	A	G	2	3	5	0	1	6	0	0
3	35850380	.	C	T	3	3	6	0	1	7	0	0
3	35850785	.	C	T	1	3	4	0	0	4	0	0
3	35864853	.	A	C	1	2	3	0	0	3	0	0
3	36023342	.	T	G	16	12	28	0	2	30	0	0
3	36023455	.	A	G	11	13	24	0	1	25	0	0
3	36023465	.	A	G	12	12	24	0	1	25	0	0
3	36026294	.	C	G	1	8	9	0	13	22	0	0
3	36032241	.	G	A	3	1	4	0	1	5	0	0
3	36038631	.	G	A	12	15	27	0	2	29	0	0
3	36040863	.	A	G	1	5	6	0	0	6	0	0
3	36041017	.	A	C	9	13	22	0	0	22	0	0
3	36123546	.	G	A	1	1	2	0	0	2	0	0
3	36125256	.	C	G	0	3	3	0	10	13	0	0
3	36127040	.	A	G	0	2	2	0	2	4	0	0
3	36127055	.	T	A	1	3	4	0	0	4	0	0
3	36127108	.	G	A	2	2	4	0	0	4	0	0
3	36131883	.	T	A	2	5	7	0	0	7	0	0
3	36132099	.	C	T	3	4	7	0	0	7	0	0
3	36132740	.	T	C	7	4	11	0	0	11	0	0
3	36135481	.	A	G	1	2	3	0	0	3	0	0
3	36135641	.	T	A	3	4	7	0	0	7	0	0
3	36135867	.	A	C	1	2	3	0	0	3	0	0
3	36136242	.	T	G	3	2	5	0	0	5	0	0
3	36136533	.	T	A	3	2	5	0	1	6	0	0
3	36136537	.	T	A	4	2	6	0	0	6	0	0
3	36173633	.	T	C	10	15	25	0	0	25	0	0
3	36174175	.	C	A	18	10	28	0	3	31	0	0
3	36174248	.	C	G	12	10	22	0	0	22	0	0
3	36174276	.	T	C	7	0	7	0	11	18	0	0
3	36184806	.	A	G	2	7	9	0	0	9	0	0
3	36188400	.	A	G	3	3	6	0	0	6	0	0
3	36210030	.	G	A	4	3	7	0	0	7	0	0
3	36210074	.	C	T	5	4	9	0	1	10	0	0
3	36210307	.	T	A	4	3	7	0	0	7	0	0
3	36228295	.	G	A	4	3	7	0	0	7	0	0
3	36228319	.	T	G	0	2	2	0	0	2	0	0
3	36229823	.	G	A	7	3	10	0	0	10	0	0
3	36229886	.	A	T	1	2	3	0	0	3	0	0
3	36232218	.	A	G	3	2	5	0	0	5	0	0
3	36232331	.	C	T	8	4	12	0	0	12	0	0
3	36232368	.	A	C	4	4	8	0	0	8	0	0
3	36241839	.	T	C	5	1	6	0	0	6	0	0
3	36241938	.	T	C	2	0	2	0	4	6	0	0
3	36242239	.	C	T	0	4	4	0	2	6	0	0
3	36248869	.	T	C	3	20	23	0	0	23	0	0
3	36249172	.	C	T	10	4	14	0	1	15	0	0
3	36249419	.	G	A	19	6	25	0	0	25	0	0
3	36249476	.	T	A	20	16	36	0	1	37	0	0
3	36249516	.	T	A	17	7	24	0	3	27	0	0
3	36249518	.	A	C	20	6	26	0	1	27	0	0
3	36253186	.	G	A	1	0	1	0	0	1	0	0
3	36255436	.	A	G	2	3	5	0	1	6	0	0
3	36259855	.	T	C	10	21	31	0	3	34	0	0
3	36262799	.	A	C	18	0	18	0	16	34	0	0
3	36263099	.	T	C	15	0	15	0	17	32	0	0
3	36263151	.	A	G	15	20	35	0	2	37	0	0
3	36263163	.	C	T	13	18	31	0	3	34	0	0
3	36263464	.	C	A	15	20	35	0	0	35	0	0
3	36263557	.	A	G	14	16	30	0	2	32	0	0
3	36263563	.	T	A	17	14	31	0	0	31	0	0
3	36263596	.	T	C	12	0	12	0	8	20	0	0
3	36263666	.	T	C	6	0	6	0	10	16	0	0
3	36263824	.	T	C	13	19	32	0	2	34	0	0
3	36263895	.	A	T	11	21	32	0	0	33	1	0
3	36264028	.	T	C	14	0	14	0	14	28	0	0
3	36264204	.	T	G	10	15	25	0	0	25	0	0
3	36264217	.	A	C	10	14	24	0	1	25	0	0
3	36264248	.	T	C	18	10	28	0	0	28	0	0
3	36264498	.	G	A	13	15	28	0	1	29	0	0
3	36264582	.	C	G	6	14	20	0	2	22	0	0
3	36265895	.	C	T	0	4	4	0	2	6	0	0
3	36266137	.	T	A	0	1	1	0	0	1	0	0
3	36266173	.	A	G	1	8	9	0	1	10	0	0
3	36268616	.	A	G	11	15	26	0	0	26	0	0
3	36285177	.	C	A	5	3	8	0	0	8	0	0
3	36291213	.	A	G	4	1	5	0	1	6	0	0
3	36292657	.	T	C	5	5	10	0	0	10	0	0
3	36293950	.	C	T	6	4	10	0	1	11	0	0
3	36293964	.	C	T	8	4	12	0	0	12	0	0
3	36305854	.	A	G	18	20	38	0	3	41	0	0
3	36305860	.	A	G	21	1	22	0	22	44	0	0
3	36305971	.	T	A	10	10	20	0	0	20	0	0
3	36322947	.	C	T	2	2	4	0	0	4	0	0
3	36323001	.	T	C	1	5	6	0	0	6	0	0
3	36323397	.	C	A	2	3	5	0	0	5	0	0
3	36323598	.	A	C	1	3	4	0	0	4	0	0
3	36323604	.	C	T	1	3	4	0	0	4	0	0
3	36325648	.	A	T	4	9	13	0	2	15	0	0
3	36325726	.	C	T	4	7	11	0	0	11	0	0
3	36325802	.	A	G	5	0	5	0	6	11	0	0
3	36326003	.	T	C	1	2	3	0	0	3	0	0
3	36326031	.	C	T	1	2	3	0	0	3	0	0
3	36326091	.	A	C	4	2	6	0	0	6	0	0
3	36326108	.	A	T	3	4	7	0	0	7	0	0
3	36326139	.	T	G	3	4	7	0	2	9	0	0
3	36326370	.	A	G	7	5	12	0	0	12	0	0
3	36326681	.	T	C	4	4	8	0	0	8	0	0
3	36326685	.	T	A	5	4	9	0	0	9	0	0
3	36326839	.	T	A	1	5	6	0	0	6	0	0
3	36327060	.	G	A	0	3	3	0	6	9	0	0
3	36327061	.	A	C	5	3	8	0	1	9	0	0
3	36327097	.	C	T	9	2	11	0	1	12	0	0
3	36327129	.	G	A	14	4	18	0	0	18	0	0
3	36327218	.	T	C	6	2	8	0	3	11	0	0
3	36327228	.	T	A	10	2	12	0	0	12	0	0
3	36327260	.	T	C	4	2	6	0	1	7	0	0
3	36327306	.	A	T	3	3	6	0	0	6	0	0
3	36327414	.	T	A	6	3	9	0	0	9	0	0
3	36327872	.	G	A	5	5	10	0	1	11	0	0
3	36327906	.	G	T	7	4	11	0	1	12	0	0
3	36327909	.	G	T	0	3	3	0	9	12	0	0
3	36328204	.	C	A	7	11	18	0	0	18	0	0
3	36328218	.	G	A	6	13	19	0	2	21	0	0
3	36328390	.	A	T	2	2	4	0	0	4	0	0
3	36402930	.	T	C	3	0	3	0	3	6	0	0
3	36407283	.	C	A	0	4	4	0	0	4	0	0
3	36407604	.	A	G	3	5	8	0	1	9	0	0
3	36409656	.	C	T	2	2	4	0	0	4	0	0
3	36409721	.	G	A	1	2	3	0	0	3	0	0
3	36409877	.	C	T	3	2	5	0	0	5	0	0
3	36409995	.	T	C	3	0	3	0	3	6	0	0
3	36410038	.	T	A	2	3	5	0	0	5	0	0
3	36414501	.	A	G	1	2	3	0	0	3	0	0
3	36416984	.	C	A	1	1	2	0	0	2	0	0
3	36428612	.	T	A	19	18	37	0	3	40	0	0
3	36428620	.	T	A	18	18	36	0	4	40	0	0
3	36431380	.	T	C	14	8	22	0	0	22	0	0
3	36441465	.	G	A	1	2	3	0	1	4	0	0
3	36441484	.	T	C	3	6	9	0	0	9	0	0
3	36442021	.	T	C	3	9	12	0	1	13	0	0
3	36442029	.	A	G	3	7	10	0	0	10	0	0
3	36442071	.	A	G	3	5	8	0	0	8	0	0
3	36442551	.	C	T	1	10	11	0	14	25	0	0
3	36442661	.	T	G	9	11	20	0	0	20	0	0
3	36442726	.	A	G	7	14	21	0	2	23	0	0
3	36443189	.	G	A	1	0	1	0	1	2	0	0
3	36446613	.	A	G	3	6	9	0	1	10	0	0
3	37107093	.	C	T	11	3	14	0	0	14	0	0
3	37234561	.	C	A	6	3	9	0	0	9	0	0
3	37559334	.	A	T	33	20	53	0	3	56	0	0
3	37559905	.	A	C	14	20	34	0	1	35	0	0
3	37560271	.	A	G	12	2	14	0	1	15	0	0
3	37560289	.	G	A	10	2	12	0	2	14	0	0
3	37564769	.	G	A	16	16	32	0	0	32	0	0
3	37571596	.	C	A	1	0	1	0	0	1	0	0
3	37649598	.	G	C	3	0	3	0	0	3	0	0
3	37660307	.	G	A	7	7	14	0	0	14	0	0
3	37664117	.	A	T	8	8	16	0	0	16	0	0
3	37664635	.	A	G	7	8	15	0	1	16	0	0
3	37665855	.	G	A	21	15	36	0	0	36	0	0
3	37666774	.	C	T	0	5	5	0	8	13	0	0
3	37667562	.	C	T	0	16	16	0	14	30	0	0
3	37667608	.	G	C	10	15	25	0	0	25	0	0
3	37667646	.	C	T	10	11	21	0	1	22	0	0
3	37667952	.	C	T	0	6	6	0	12	18	0	0
3	37668319	.	A	G	4	2	6	0	0	6	0	0
3	37668370	.	T	C	2	2	4	0	0	4	0	0
3	37726111	.	C	T	4	2	6	0	1	7	0	0
3	37727784	.	T	C	4	3	7	0	0	7	0	0
3	37727926	.	C	G	2	2	4	0	0	4	0	0
3	37730412	.	T	C	1	3	4	0	0	4	0	0
3	37737680	.	C	A	4	4	8	0	2	10	0	0
3	37737735	.	T	G	2	0	2	0	2	4	0	0
3	37737736	.	C	T	2	2	4	0	0	4	0	0
3	37737852	.	A	G	1	1	2	0	0	2	0	0
3	37738024	.	A	G	4	9	13	0	0	13	0	0
3	37738050	.	C	G	2	9	11	0	1	12	0	0
3	37738089	.	G	A	2	8	10	0	1	11	0	0
3	37742116	.	A	C	0	1	1	0	0	1	0	0
3	37742152	.	T	C	0	3	3	0	1	4	0	0
3	37742245	.	C	T	6	3	9	0	1	10	0	0
3	37742247	.	A	G	7	3	10	0	0	10	0	0
3	37742284	.	T	G	5	4	9	0	0	9	0	0
3	37742338	.	C	G	3	4	7	0	0	7	0	0
3	37742363	.	C	T	1	2	3	0	0	3	0	0
3	37776713	.	T	C	3	9	12	0	0	12	0	0
3	37777309	.	A	T	5	5	10	0	0	10	0	0
3	37777417	.	G	C	1	3	4	0	1	5	0	0
3	37777590	.	C	T	6	5	11	0	2	13	0	0
3	37777811	.	C	T	0	7	7	0	8	15	0	0
3	37781162	.	A	G	3	2	5	0	0	5	0	0
3	37788401	.	T	C	1	2	3	0	0	3	0	0
3	37789216	.	G	T	4	6	10	0	2	12	0	0
3	37827364	.	G	A	1	0	1	0	0	1	0	0
3	37827822	.	C	T	2	2	4	0	0	4	0	0
3	37827948	.	C	T	3	3	6	0	0	6	0	0
3	38505629	.	A	G	6	6	12	0	0	12	0	0
3	38614366	.	C	T	3	1	4	0	0	4	0	0
3	38614426	.	A	G	4	0	4	0	2	6	0	0
3	38614562	.	C	T	1	2	3	0	1	4	0	0
3	38624737	.	A	G	2	0	2	0	4	6	0	0
3	38624823	.	G	A	10	15	25	0	1	26	0	0
3	38625098	.	A	C	7	13	20	0	0	20	0	0
3	38625497	.	G	T	6	10	16	0	0	17	1	0
3	38625559	.	T	C	9	5	14	0	0	14	0	0
3	38625605	.	G	A	6	12	18	0	1	19	0	0
3	38625901	.	T	G	10	9	19	0	1	20	0	0
3	38649991	.	A	T	7	10	17	0	0	17	0	0
3	38650440	.	T	C	7	5	12	0	1	13	0	0
3	38763153	.	T	A	7	11	18	0	2	20	0	0
3	38763391	.	A	G	5	6	11	0	1	12	0	0
3	38763449	.	C	T	5	2	7	0	0	7	0	0
3	38763505	.	G	A	3	3	6	0	0	6	0	0
3	38763527	.	C	T	0	3	3	0	5	8	0	0
3	38763564	.	C	A	7	2	9	0	0	9	0	0
3	38763700	.	G	A	9	4	13	0	0	13	0	0
3	38764227	.	C	T	2	1	3	0	1	4	0	0
3	38764229	.	G	A	2	2	4	0	0	4	0	0
3	38765149	.	A	T	3	2	5	0	0	5	0	0
3	38766207	.	C	T	0	7	7	0	6	13	0	0
3	38766759	.	G	A	2	3	5	0	0	5	0	0
3	38766779	.	C	T	1	2	3	0	0	3	0	0
3	38766813	.	A	G	1	2	3	0	0	3	0	0
3	38793674	.	A	G	3	2	5	0	1	6	0	0
3	38793729	.	G	T	0	2	2	0	2	4	0	0
3	38793808	.	G	A	2	3	5	0	0	5	0	0
3	38794422	.	G	C	1	3	4	0	0	4	0	0
3	38858514	.	T	G	0	0	0	0	2	2	0	0
3	38858649	.	A	G	2	5	7	0	0	7	0	0
3	38858673	.	C	A	3	4	7	0	0	7	0	0
3	38858908	.	G	A	1	3	4	0	7	11	0	0
3	38858949	.	G	C	5	8	13	0	0	13	0	0
3	38859066	.	G	A	1	4	5	0	1	6	0	0
3	39181628	.	C	A	5	3	8	0	0	8	0	0
3	39181793	.	A	G	1	4	5	0	0	5	0	0
3	39181823	.	A	G	3	4	7	0	0	7	0	0
3	39181849	.	A	G	3	5	8	0	0	8	0	0
3	39184156	.	A	G	5	4	9	0	1	10	0	0
3	39184180	.	C	T	4	5	9	0	0	9	0	0
3	39184710	.	A	G	1	7	8	0	0	8	0	0
3	39189208	.	G	T	1	2	3	0	0	3	0	0
3	39189212	.	A	G	1	1	2	0	0	2	0	0
3	39238579	.	C	A	5	5	10	0	1	11	0	0
3	39238580	.	C	A	5	6	11	0	0	11	0	0
3	39239380	.	A	G	7	5	12	0	0	12	0	0
3	39241350	.	G	T	1	5	6	0	0	6	0	0
3	39248863	.	A	G	10	7	17	0	0	17	0	0
3	39251020	.	G	T	1	2	3	0	0	3	0	0
3	39251341	.	T	C	0	1	1	0	0	1	0	0
3	39259624	.	T	C	8	0	8	0	7	15	0	0
3	39260767	.	A	T	2	3	5	0	0	5	0	0
3	39313310	.	A	G	6	8	14	0	1	15	0	0
3	39313625	.	T	C	5	7	12	0	0	12	0	0
3	39314028	.	C	T	18	7	25	0	0	25	0	0
3	39314101	.	T	C	17	7	24	0	2	26	0	0
3	39314146	.	C	G	11	11	22	0	0	22	0	0
3	39314260	.	A	G	4	5	9	0	0	9	0	0
3	39314502	.	G	C	8	11	19	0	0	19	0	0
3	39314631	.	C	T	0	4	4	0	12	16	0	0
3	39314677	.	C	T	10	8	18	0	0	18	0	0
3	39314857	.	G	T	3	1	4	0	1	5	0	0
3	39315154	.	C	A	3	4	7	0	0	7	0	0
3	39315169	.	C	G	3	7	10	0	1	11	0	0
3	39315191	.	C	G	3	6	9	0	1	10	0	0
3	39315229	.	A	T	2	2	4	0	0	4	0	0
3	39315816	.	A	G	1	3	4	0	1	5	0	0
3	39315874	.	C	A	5	4	9	0	4	13	0	0
3	39315876	.	C	T	6	7	13	0	0	13	0	0
3	39315937	.	A	C	1	0	1	0	2	3	0	0
3	39316037	.	T	C	3	4	7	0	1	8	0	0
3	39316062	.	G	A	6	7	13	0	1	14	0	0
3	39316167	.	A	G	4	8	12	0	0	12	0	0
3	39316570	.	G	A	9	6	15	0	0	15	0	0
3	39316846	.	T	C	5	10	15	0	0	15	0	0
3	39316906	.	C	A	11	16	27	0	1	28	0	0
3	39316912	.	G	A	10	16	26	0	1	27	0	0
3	39316996	.	A	G	11	16	27	0	1	28	0	0
3	39317215	.	C	G	4	6	10	0	1	11	0	0
3	39317279	.	C	T	2	4	6	0	2	8	0	0
3	39317370	.	C	T	3	5	8	0	0	8	0	0
3	39328095	.	G	C	3	4	7	0	0	7	0	0
3	39330407	.	T	C	6	0	6	0	5	11	0	0
3	39348533	.	G	A	4	6	10	0	2	12	0	0
3	39348914	.	G	A	3	4	7	0	0	7	0	0
3	39560664	.	T	C	2	0	2	0	0	2	0	0
3	39568368	.	T	G	10	2	12	0	0	12	0	0
3	39568856	.	A	G	15	17	32	0	0	32	0	0
3	39574883	.	C	A	17	18	35	0	4	39	0	0
3	39574961	.	G	A	30	33	63	0	2	65	0	0
3	39576621	.	T	G	21	0	21	0	33	54	0	0
3	39576663	.	A	G	23	48	71	0	0	71	0	0
3	39576866	.	T	C	23	16	39	0	1	40	0	0
3	39579562	.	T	C	1	2	3	0	0	3	0	0
3	39580908	.	T	C	1	2	3	0	0	3	0	0
3	39586473	.	A	T	2	3	5	0	0	5	0	0
3	39592797	.	C	T	5	0	5	0	0	5	0	0
3	39592800	.	G	C	0	1	1	0	5	6	0	0
3	39606220	.	C	T	6	4	10	0	0	10	0	0
3	39612261	.	T	A	13	12	25	0	0	25	0	0
3	39612430	.	T	C	8	14	22	0	0	22	0	0
3	39612579	.	G	C	8	13	21	0	2	23	0	0
3	39612715	.	A	T	8	5	13	0	1	14	0	0
3	39613024	.	T	C	8	12	20	0	0	20	0	0
3	39631505	.	T	C	2	5	7	0	1	8	0	0
3	39663915	.	C	T	1	0	1	0	0	1	0	0
3	39663929	.	T	C	1	1	2	0	0	2	0	0
3	39686807	.	A	T	3	1	4	0	1	5	0	0
3	39687418	.	C	T	2	2	4	0	0	4	0	0
3	39688558	.	T	G	4	2	6	0	0	6	0	0
3	39688892	.	T	C	1	3	4	0	1	5	0	0
3	39689216	.	T	C	6	4	10	0	0	10	0	0
3	39689234	.	G	T	6	5	11	0	0	11	0	0
3	39689277	.	A	G	4	3	7	0	0	7	0	0
3	39691676	.	A	G	2	4	6	0	0	6	0	0
3	39691978	.	C	G	2	3	5	0	0	5	0	0
3	39692008	.	G	T	5	3	8	0	0	8	0	0
3	39692165	.	A	T	2	5	7	0	1	8	0	0
3	39692196	.	C	T	0	7	7	0	5	12	0	0
3	39692206	.	C	T	5	5	10	0	2	12	0	0
3	39692235	.	C	A	9	5	14	0	0	14	0	0
3	39692265	.	G	A	10	2	12	0	0	12	0	0
3	39695744	.	T	C	1	1	2	0	0	2	0	0
3	39919127	.	G	A	2	3	5	0	0	5	0	0
3	39925087	.	T	C	1	0	1	0	0	1	0	0
3	39940210	.	T	C	1	0	1	0	1	2	0	0
3	39949389	.	G	A	4	3	7	0	0	7	0	0
3	39949650	.	G	A	0	0	0	0	3	3	0	0
3	39950276	.	A	C	9	15	24	0	2	26	0	0
3	39950340	.	C	T	4	9	13	0	2	15	0	0
3	39950414	.	T	C	11	6	17	0	4	21	0	0
3	39950954	.	T	C	10	5	15	0	1	16	0	0
3	39951124	.	C	T	7	4	11	0	0	11	0	0
3	39951216	.	T	C	1	4	5	0	0	5	0	0
3	39951703	.	A	T	2	6	8	0	0	8	0	0
3	39952025	.	T	C	8	6	14	0	0	14	0	0
3	39952272	.	A	G	5	12	17	0	1	18	0	0
3	39952273	.	A	T	5	13	18	0	0	18	0	0
3	39958680	.	C	T	5	4	9	0	0	9	0	0
3	39958729	.	T	A	2	8	10	0	1	11	0	0
3	39959679	.	A	C	2	9	11	0	0	11	0	0
3	39960535	.	G	C	0	0	0	0	2	2	0	0
3	39962981	.	T	C	8	9	17	0	0	17	0	0
3	39963053	.	T	C	10	6	16	0	1	17	0	0
3	39963089	.	A	G	6	4	10	0	0	10	0	0
3	39970492	.	G	A	1	2	3	0	0	3	0	0
3	39970555	.	G	A	10	6	16	0	0	16	0	0
3	39970641	.	T	G	6	12	18	0	1	19	0	0
3	39971335	.	T	A	1	3	4	0	0	4	0	0
3	39971447	.	T	C	12	4	16	0	0	16	0	0
3	39971470	.	T	C	7	6	13	0	0	13	0	0
3	39971499	.	T	C	4	7	11	0	0	11	0	0
3	39971592	.	T	C	1	6	7	0	2	9	0	0
3	39971604	.	T	C	7	3	10	0	1	11	0	0
3	39971894	.	T	C	6	8	14	0	2	16	0	0
3	39971943	.	T	C	5	5	10	0	0	10	0	0
3	39972055	.	T	C	4	3	7	0	0	7	0	0
3	39972073	.	G	A	3	3	6	0	1	7	0	0
3	39972127	.	T	C	5	2	7	0	0	7	0	0
3	39975467	.	T	C	5	0	5	0	6	11	0	0
3	39982019	.	C	T	6	1	7	0	3	10	0	0
3	39982198	.	A	T	1	2	3	0	0	3	0	0
3	39982423	.	T	C	0	0	0	0	1	1	0	0
3	39984581	.	G	A	4	2	6	0	0	6	0	0
3	39990027	.	A	C	2	2	4	0	0	4	0	0
3	40015244	.	T	G	1	2	3	0	0	3	0	0
3	40054647	.	C	T	0	3	3	0	2	5	0	0
3	40207086	.	T	C	15	16	31	0	2	33	0	0
3	40256199	.	A	T	2	5	7	0	1	8	0	0
3	40256334	.	T	C	1	3	4	0	0	4	0	0
3	40256418	.	C	T	4	5	9	0	1	10	0	0
3	40256734	.	G	A	2	2	4	0	0	4	0	0
3	40256735	.	C	A	2	2	4	0	0	4	0	0
3	40278023	.	C	T	1	13	14	0	14	28	0	0
3	40278180	.	T	C	5	0	5	0	7	12	0	0
3	40280034	.	T	C	1	3	4	0	0	4	0	0
3	40284375	.	T	C	8	0	8	0	8	16	0	0
3	40284447	.	T	A	5	4	9	0	2	11	0	0
3	40284860	.	G	T	17	6	23	0	1	24	0	0
3	40284982	.	T	C	6	5	11	0	0	11	0	0
3	40287185	.	G	C	0	6	6	0	11	17	0	0
3	40287188	.	G	A	10	6	16	0	1	17	0	0
3	40287227	.	C	T	4	2	6	0	0	6	0	0
3	40287538	.	C	T	2	2	4	0	0	4	0	0
3	40287691	.	T	C	3	4	7	0	1	8	0	0
3	40287712	.	T	A	3	5	8	0	0	8	0	0
3	40290123	.	T	C	2	3	5	0	0	5	0	0
3	40290138	.	A	G	2	5	7	0	0	7	0	0
3	40294179	.	G	A	2	3	5	0	0	5	0	0
3	40294260	.	A	T	8	11	19	0	2	21	0	0
3	40294511	.	G	C	9	7	16	0	0	16	0	0
3	40294937	.	A	G	7	3	10	0	0	10	0	0
3	40297428	.	G	A	19	26	45	0	0	45	0	0
3	40297479	.	C	T	3	8	11	0	0	11	0	0
3	40299995	.	G	A	7	6	13	0	1	14	0	0
3	40301233	.	A	G	1	4	5	0	0	5	0	0
3	40318555	.	C	G	2	0	2	0	0	2	0	0
3	40318556	.	C	G	2	0	2	0	0	2	0	0
3	40318613	.	A	G	3	2	5	0	0	5	0	0
3	40329683	.	T	C	4	2	6	0	0	6	0	0
3	40333592	.	C	T	2	3	5	0	0	5	0	0
3	40333700	.	A	G	4	0	4	0	4	8	0	0
3	40346035	.	C	T	8	8	16	0	1	17	0	0
3	40346059	.	T	C	6	3	9	0	1	10	0	0
3	40348839	.	T	C	18	11	29	0	1	30	0	0
3	40349310	.	A	G	10	4	14	0	0	14	0	0
3	40349354	.	T	G	8	5	13	0	0	13	0	0
3	40404508	.	T	A	2	2	4	0	0	4	0	0
3	40404688	.	A	T	2	1	3	0	1	4	0	0
3	40430922	.	G	A	0	1	1	0	2	3	0	0
3	40443096	.	C	G	3	2	5	0	0	5	0	0
3	40444539	.	T	C	2	4	6	0	0	6	0	0
3	40448097	.	A	C	5	5	10	0	0	10	0	0
3	40448130	.	A	G	5	0	5	0	4	9	0	0
3	40448220	.	T	C	0	1	1	0	0	1	0	0
3	40449595	.	C	A	4	6	10	0	0	10	0	0
3	40449603	.	T	C	4	6	10	0	0	10	0	0
3	40449696	.	C	T	7	9	16	0	0	16	0	0
3	40450743	.	C	T	7	5	12	0	0	12	0	0
3	40450961	.	T	G	8	0	8	0	10	19	1	0
3	40451268	.	C	T	6	9	15	0	0	15	0	0
3	40451319	.	T	C	7	11	18	0	0	18	0	0
3	40451352	.	A	T	4	5	9	0	0	9	0	0
3	40451407	.	A	G	2	0	2	0	4	6	0	0
3	40451574	.	A	C	1	1	2	0	0	2	0	0
3	40452119	.	G	C	3	10	13	0	0	13	0	0
3	40452134	.	A	G	3	0	3	0	9	12	0	0
3	40458531	.	C	A	0	1	1	0	0	1	0	0
3	40458594	.	G	A	0	11	11	0	5	16	0	0
3	40467464	.	C	T	0	1	1	0	0	1	0	0
3	40467486	.	G	A	0	4	4	0	1	5	0	0
3	40467693	.	A	G	5	0	5	0	7	12	0	0
3	40467739	.	A	C	4	0	4	0	13	17	0	0
3	40467756	.	C	T	12	4	16	0	3	19	0	0
3	40469891	.	T	C	6	4	10	0	0	10	0	0
3	40480877	.	G	A	0	2	2	0	0	2	0	0
3	40480986	.	G	T	9	12	21	0	1	22	0	0
3	40481346	.	G	A	0	3	3	0	2	5	0	0
3	40481459	.	C	T	13	12	25	0	0	25	0	0
3	40481513	.	A	G	9	8	17	0	0	17	0	0
3	40481930	.	T	A	11	13	24	0	0	24	0	0
3	40482007	.	T	C	17	8	25	0	1	26	0	0
3	40482027	.	A	G	13	0	13	0	9	22	0	0
3	40482289	.	C	A	14	19	33	1	1	35	0	0
3	40482446	.	A	G	18	11	29	0	0	29	0	0
3	40484376	.	A	T	5	7	12	0	1	13	0	0
3	40485360	.	C	A	14	8	22	0	0	22	0	0
3	40485378	.	T	G	10	6	16	0	2	18	0	0
3	40485422	.	G	T	0	15	15	0	8	23	0	0
3	40485499	.	G	A	11	14	25	0	0	25	0	0
3	40485965	.	G	C	9	5	14	0	0	15	1	0
3	40487095	.	G	T	6	12	18	0	0	18	0	0
3	40487162	.	A	C	10	4	14	1	1	16	0	0
3	40487385	.	T	A	9	13	22	0	0	22	0	0
3	40487704	.	T	C	25	10	35	1	2	38	0	0
3	40487820	.	A	G	11	24	35	0	5	40	0	0
3	40487821	.	G	C	14	26	40	0	0	40	0	0
3	40488212	.	C	T	19	16	35	0	0	35	0	0
3	40488264	.	C	T	5	20	25	0	8	33	0	0
3	40488630	.	T	C	5	8	13	0	0	13	0	0
3	40488640	.	T	C	5	5	10	0	1	11	0	0
3	40527028	.	G	A	19	17	36	0	2	38	0	0
3	40527512	.	G	A	32	33	65	0	3	68	0	0
3	40527575	.	G	A	6	8	14	0	1	15	0	0
3	40527665	.	A	G	1	3	4	0	0	4	0	0
3	40527727	.	G	A	4	3	7	0	0	7	0	0
3	40528241	.	A	T	20	16	36	0	0	36	0	0
3	40576600	.	C	T	23	19	42	0	0	42	0	0
3	40576736	.	C	T	19	16	35	0	0	35	0	0
3	40576972	.	A	G	26	0	26	0	22	48	0	0
3	40577032	.	C	T	17	19	36	0	0	36	0	0
3	40583989	.	C	G	5	10	15	0	2	17	0	0
3	40584318	.	T	A	6	16	22	0	1	23	0	0
3	40587967	.	C	T	27	26	53	0	2	55	0	0
3	40588109	.	A	T	23	26	49	0	2	51	0	0
3	40588195	.	T	C	25	23	48	0	4	52	0	0
3	40588363	.	C	T	17	21	38	0	0	38	0	0
3	40588410	.	C	A	16	22	38	0	0	38	0	0
3	40588467	.	T	C	14	17	31	0	2	33	0	0
3	40588595	.	A	C	17	21	38	0	0	38	0	0
3	40588746	.	C	G	19	19	38	0	2	40	0	0
3	40588845	.	A	G	16	23	39	0	0	39	0	0
3	40589147	.	T	C	32	21	53	0	1	54	0	0
3	40589179	.	C	A	30	21	51	0	2	53	0	0
3	40589191	.	T	G	31	19	50	0	1	51	0	0
3	40589214	.	C	A	24	24	48	0	1	49	0	0
3	40589232	.	A	G	23	23	46	0	3	49	0	0
3	40589266	.	C	T	21	23	44	0	1	45	0	0
3	40589348	.	A	G	19	20	39	0	1	40	0	0
3	40589356	.	A	G	21	16	37	0	2	39	0	0
3	40656338	.	A	G	1	1	2	0	0	2	0	0
3	40656368	.	T	C	1	2	3	0	0	3	0	0
3	40690704	.	T	C	11	1	12	0	10	22	0	0
3	40690901	.	G	A	2	5	7	0	0	7	0	0
3	40690937	.	T	A	1	1	2	0	0	2	0	0
3	40691448	.	A	G	7	5	12	0	1	13	0	0
3	40691473	.	A	T	8	4	12	0	1	13	0	0
3	40691643	.	A	T	7	3	10	0	0	10	0	0
3	40691969	.	C	T	11	6	17	0	1	18	0	0
3	40692064	.	A	T	5	6	11	0	0	11	0	0
3	40698424	.	C	A	4	3	7	0	0	7	0	0
3	40698481	.	A	G	7	7	14	0	0	14	0	0
3	40712935	.	G	A	0	3	3	0	0	3	0	0
3	40713085	.	G	T	4	3	7	0	1	8	0	0
3	40768371	.	A	T	3	1	4	0	2	6	0	0
3	40804286	.	T	G	24	1	25	0	4	29	0	0
3	40819959	.	A	C	0	1	1	0	0	1	0	0
3	40820007	.	A	G	0	2	2	0	0	2	0	0
3	40820367	.	A	T	3	2	5	0	1	6	0	0
3	40821838	.	C	A	10	14	24	0	1	25	0	0
3	40821871	.	A	T	18	13	31	0	0	31	0	0
3	40821953	.	C	A	0	22	22	0	11	33	0	0
3	40870851	.	A	T	1	2	3	1	0	4	0	0
3	40876757	.	G	A	6	3	9	0	0	9	0	0
3	40885997	.	C	A	2	2	4	0	0	4	0	0
3	40902163	.	C	T	0	3	3	0	5	8	0	0
3	40907953	.	T	C	0	0	0	0	5	5	0	0
3	40913730	.	G	A	1	2	3	0	0	3	0	0
3	40927653	.	C	T	9	5	14	0	1	15	0	0
3	40979791	.	G	C	6	7	13	0	1	14	0	0
3	40980024	.	G	A	4	7	11	0	0	11	0	0
3	40980166	.	T	A	9	5	14	0	0	14	0	0
3	40983062	.	A	G	9	6	15	0	0	15	0	0
3	40983077	.	G	A	8	3	11	0	1	12	0	0
3	40985992	.	T	C	0	1	1	0	0	1	0	0
3	41000159	.	T	C	2	0	2	0	1	3	0	0
3	41003413	.	G	A	2	0	2	0	2	4	0	0
3	41023331	.	G	A	0	0	0	0	1	1	0	0
3	41030861	.	T	G	5	5	10	0	1	11	0	0
3	41037795	.	A	C	4	0	4	0	5	9	0	0
3	41069430	.	G	A	2	0	2	0	0	2	0	0
3	41086781	.	T	C	1	3	4	0	0	4	0	0
3	41088977	.	A	G	0	1	1	0	0	1	0	0
3	41088983	.	G	A	1	1	2	0	0	2	0	0
3	41092137	.	A	T	2	2	4	0	0	4	0	0
3	41705468	.	A	T	4	2	6	0	0	6	0	0
3	41705476	.	C	T	4	2	6	0	0	6	0	0
3	41705560	.	A	G	1	3	4	0	0	4	0	0
3	41719049	.	G	A	2	3	5	0	0	6	1	0
3	41721916	.	G	A	1	1	2	0	0	2	0	0
3	41723437	.	G	A	11	8	19	0	0	19	0	0
3	41724806	.	G	A	13	13	26	0	1	27	0	0
3	41917830	.	T	C	3	5	8	0	0	8	0	0
3	41922766	.	A	G	1	0	1	0	3	4	0	0
3	41922799	.	C	T	1	5	6	0	0	6	0	0
3	41923195	.	T	C	0	2	2	0	0	2	0	0
3	41925508	.	A	G	2	4	6	0	0	6	0	0
3	41925541	.	C	G	1	3	4	0	0	4	0	0
3	41925663	.	C	T	4	4	8	0	0	8	0	0
3	41925823	.	C	T	2	2	4	0	1	5	0	0
3	41925889	.	T	C	3	3	6	0	0	6	0	0
3	41926020	.	T	A	3	5	8	0	0	8	0	0
3	41926557	.	G	A	1	5	6	0	0	6	0	0
3	41926695	.	T	C	1	4	5	0	1	6	0	0
3	41955449	.	A	G	5	2	7	0	0	7	0	0
3	41955526	.	C	T	6	3	9	0	0	9	0	0
3	41955613	.	G	T	17	13	30	0	0	30	0	0
3	41955911	.	C	G	8	19	27	0	0	27	0	0
3	41956040	.	G	T	13	13	26	0	1	27	0	0
3	41956299	.	T	C	10	7	17	0	1	18	0	0
3	41956353	.	T	A	7	14	21	0	1	22	0	0
3	41956467	.	T	A	2	3	5	0	1	6	0	0
3	41956504	.	C	T	2	2	4	0	0	4	0	0
3	41956792	.	A	T	2	14	16	0	1	17	0	0
3	41956818	.	T	C	2	11	13	0	0	13	0	0
3	41956837	.	T	G	4	8	12	0	0	12	0	0
3	41956855	.	C	T	4	9	13	0	0	13	0	0
3	41956921	.	T	A	4	8	12	0	0	12	0	0
3	41956941	.	T	C	5	8	13	0	0	13	0	0
3	41956978	.	G	A	3	9	12	0	1	13	0	0
3	41957303	.	A	T	4	2	6	0	1	7	0	0
3	41957580	.	G	T	5	3	8	0	0	8	0	0
3	41957660	.	A	T	8	5	13	0	0	13	0	0
3	41957681	.	A	G	5	2	7	0	0	7	0	0
3	41958291	.	T	G	2	6	8	0	0	8	0	0
3	41959370	.	G	T	7	15	22	0	0	22	0	0
3	41959658	.	G	T	3	8	11	0	1	12	0	0
3	41959772	.	A	G	4	9	13	0	0	13	0	0
3	41959906	.	T	A	3	3	6	0	1	7	0	0
3	41959943	.	T	C	2	8	10	0	0	10	0	0
3	41959958	.	A	G	4	7	11	0	0	11	0	0
3	41960005	.	C	A	6	6	12	0	1	13	0	0
3	41960069	.	G	T	5	4	9	0	0	9	0	0
3	41960346	.	A	G	4	4	8	0	0	8	0	0
3	41961314	.	G	A	4	2	6	0	1	7	0	0
3	41961341	.	T	G	4	4	8	0	0	9	1	0
3	41961469	.	A	G	3	6	9	0	0	9	0	0
3	41961558	.	A	T	4	8	12	0	1	13	0	0
3	41961587	.	T	G	5	5	10	0	0	10	0	0
3	41961651	.	G	A	6	6	12	0	0	12	0	0
3	41961688	.	T	C	7	0	7	0	8	15	0	0
3	41962098	.	T	C	3	4	7	0	0	7	0	0
3	41962463	.	G	A	3	6	9	0	0	9	0	0
3	41985866	.	G	A	0	1	1	0	0	1	0	0
3	41985953	.	C	T	2	3	5	0	0	5	0	0
3	41985959	.	G	A	2	2	4	0	0	4	0	0
3	42121428	.	A	G	1	3	4	0	0	4	0	0
3	42121833	.	C	A	2	2	4	0	1	5	0	0
3	42126551	.	A	G	1	2	3	0	0	3	0	0
3	42126594	.	A	T	0	2	2	0	0	2	0	0
3	42126621	.	A	G	0	2	2	0	0	2	0	0
3	42918924	.	C	A	9	5	14	0	1	15	0	0
3	42919474	.	C	T	10	9	19	0	1	20	0	0
3	42919510	.	C	T	8	4	12	0	1	13	0	0
3	42919664	.	C	T	1	2	3	0	0	3	0	0
3	42919846	.	T	G	5	3	8	0	0	8	0	0
3	42919849	.	C	T	4	3	7	0	1	8	0	0
3	42919881	.	C	T	4	4	8	0	0	8	0	0
3	42919895	.	A	G	4	4	8	0	0	8	0	0
3	42919943	.	G	C	2	2	4	0	0	4	0	0
3	42919959	.	A	T	1	1	2	0	0	2	0	0
3	42957196	.	G	A	1	2	3	0	0	3	0	0
3	43000600	.	A	G	0	0	0	0	1	1	0	0
3	43024872	.	T	C	1	1	2	0	0	2	0	0
3	43039306	.	A	G	1	3	4	0	0	4	0	0
3	43039479	.	C	T	0	4	4	0	1	5	0	0
3	43052230	.	T	C	2	3	5	0	1	6	0	0
3	43059090	.	A	G	0	1	1	0	0	1	0	0
3	43059153	.	A	G	2	4	6	0	1	7	0	0
3	43060866	.	T	C	1	3	4	0	2	6	0	0
3	43376543	.	A	G	2	1	3	0	0	3	0	0
3	43380283	.	C	T	4	7	11	0	1	12	0	0
3	43392755	.	T	A	5	4	9	0	0	9	0	0
3	43392795	.	C	A	7	3	10	0	1	11	0	0
3	43467654	.	T	C	1	3	4	0	0	4	0	0
3	43474920	.	A	T	4	5	9	0	0	9	0	0
3	43475265	.	G	A	2	8	10	0	0	10	0	0
3	43475325	.	A	G	5	10	15	0	1	16	0	0
3	43475376	.	T	C	7	7	14	0	0	14	0	0
3	43475397	.	C	T	6	5	11	0	0	11	0	0
3	43475592	.	A	C	2	2	4	0	0	4	0	0
3	43475654	.	C	T	6	4	10	0	1	11	0	0
3	43475772	.	A	G	5	3	8	0	0	8	0	0
3	43476017	.	A	G	1	4	5	0	0	5	0	0
3	43476394	.	T	C	2	1	3	0	1	4	0	0
3	43476402	.	C	T	3	0	3	0	0	3	0	0
3	43476435	.	G	T	7	4	11	0	0	11	0	0
3	43476514	.	A	C	6	7	13	0	1	14	0	0
3	43476698	.	A	G	6	2	8	0	0	8	0	0
3	43476880	.	C	T	7	3	10	0	0	10	0	0
3	43476887	.	T	G	7	3	10	0	0	10	0	0
3	43477255	.	T	A	4	5	9	0	0	9	0	0
3	43477705	.	T	A	3	4	7	0	2	9	0	0
3	43477749	.	G	C	3	2	5	0	0	5	0	0
3	43477975	.	T	G	3	3	6	0	0	6	0	0
3	43478137	.	T	C	10	11	21	0	0	21	0	0
3	43478238	.	C	T	10	4	14	0	1	15	0	0
3	43478310	.	T	G	5	4	9	0	0	9	0	0
3	43478321	.	A	G	5	0	5	0	3	8	0	0
3	43478586	.	C	T	4	3	7	0	1	8	0	0
3	43579820	.	C	T	0	11	11	0	11	22	0	0
3	43580055	.	A	G	15	10	25	0	1	26	0	0
3	43580195	.	A	T	9	8	17	0	0	17	0	0
3	43580583	.	T	C	9	9	18	0	0	18	0	0
3	43581272	.	A	C	4	5	9	0	1	10	0	0
3	43584423	.	T	C	10	1	11	0	11	22	0	0
3	43584453	.	T	C	7	6	13	0	2	15	0	0
3	43594256	.	A	G	4	0	4	0	1	5	0	0
3	43594358	.	C	T	5	6	11	0	2	13	0	0
3	43594376	.	C	T	0	9	9	0	4	13	0	0
3	43594577	.	G	A	8	8	16	0	0	16	0	0
3	43594655	.	C	T	0	5	5	0	6	11	0	0
3	43594658	.	G	A	6	5	11	0	0	11	0	0
3	43594735	.	T	C	3	5	8	0	1	9	0	0
3	43600999	.	C	T	0	2	2	0	5	7	0	0
3	43645900	.	G	C	3	11	14	0	0	14	0	0
3	43646161	.	A	G	3	6	9	0	0	9	0	0
3	43754860	.	T	A	6	2	8	0	0	8	0	0
3	43774440	.	C	A	1	0	1	0	0	1	0	0
3	43776859	.	T	C	0	1	1	0	0	1	0	0
3	43791284	.	T	C	5	6	11	0	1	12	0	0
3	43791317	.	G	A	5	6	11	0	0	11	0	0
3	43793273	.	G	A	1	2	3	0	0	3	0	0
3	43797073	.	C	T	2	0	2	0	0	2	0	0
3	43801338	.	C	T	2	0	2	0	0	2	0	0
3	43807512	.	T	C	6	7	13	0	0	13	0	0
3	43807921	.	C	A	6	15	21	0	0	21	0	0
3	43807945	.	T	A	5	8	13	0	0	15	2	0
3	43814607	.	C	T	9	4	13	0	0	13	0	0
3	43821273	.	G	T	5	3	8	0	0	8	0	0
3	43821328	.	A	G	2	2	4	0	1	5	0	0
3	43825892	.	T	A	1	2	3	0	1	4	0	0
3	43829154	.	G	C	1	3	4	0	0	4	0	0
3	43829179	.	G	C	1	3	4	0	0	4	0	0
3	43829370	.	A	C	2	3	5	0	0	5	0	0
3	43829411	.	C	T	2	3	5	0	0	5	0	0
3	43829413	.	C	T	2	2	4	0	1	5	0	0
3	43829712	.	G	A	0	4	4	0	4	8	0	0
3	43944611	.	A	G	0	1	1	0	0	1	0	0
3	43953805	.	C	T	2	4	6	0	0	6	0	0
3	43953883	.	T	C	7	1	8	0	6	14	0	0
3	43986252	.	T	A	1	2	3	0	0	3	0	0
3	43986937	.	G	A	0	2	2	0	1	3	0	0
3	43987032	.	T	C	1	2	3	0	0	3	0	0
3	44077285	.	T	C	1	1	2	0	0	2	0	0
3	44077295	.	A	T	1	2	3	0	0	3	0	0
3	44077508	.	C	T	4	3	7	0	0	7	0	0
3	44077592	.	G	A	1	2	3	0	1	4	0	0
3	44077594	.	C	A	0	2	2	0	2	4	0	0
3	44081692	.	T	G	1	3	4	0	0	4	0	0
3	44082200	.	A	G	1	2	3	0	0	3	0	0
3	44082239	.	T	G	1	2	3	0	0	3	0	0
3	44089576	.	A	G	1	7	8	0	0	8	0	0
3	44093661	.	T	C	1	0	1	0	4	5	0	0
3	44541766	.	C	T	0	2	2	0	2	4	0	0
3	44541955	.	C	A	1	0	1	0	0	1	0	0
3	45605514	.	A	G	3	0	3	0	3	6	0	0
3	45714552	.	C	T	1	2	3	0	0	3	0	0
3	45714678	.	C	T	1	2	3	0	0	3	0	0
3	45714945	.	T	C	1	2	3	0	0	3	0	0
3	45715655	.	A	G	1	4	5	0	2	7	0	0
3	45715776	.	T	C	3	3	6	0	1	7	0	0
3	45716156	.	A	T	3	2	5	0	0	5	0	0
3	45716561	.	A	G	4	2	6	0	0	6	0	0
3	45716562	.	A	G	2	4	6	0	0	6	0	0
3	45716705	.	A	G	5	3	8	0	0	8	0	0
3	45716706	.	A	G	6	2	8	0	0	8	0	0
3	45717180	.	C	T	6	5	11	0	1	12	0	0
3	45776520	.	T	C	19	1	20	0	27	47	0	0
3	45776721	.	T	C	13	10	23	0	1	24	0	0
3	45814631	.	A	T	2	6	8	0	0	8	0	0
3	45815894	.	A	C	2	9	11	0	0	11	0	0
3	45815997	.	G	A	0	3	3	0	4	7	0	0
3	45816004	.	C	T	4	3	7	0	0	7	0	0
3	45816549	.	A	G	2	12	14	0	2	16	0	0
3	45816618	.	T	C	6	7	13	0	1	14	0	0
3	46043483	.	G	A	3	3	6	0	0	6	0	0
3	46043528	.	T	A	0	2	2	0	1	3	0	0
3	46043617	.	G	A	2	5	7	0	0	7	0	0
3	46044097	.	C	T	2	3	5	0	0	5	0	0
3	46044190	.	G	T	5	3	8	0	0	8	0	0
3	46114398	.	A	G	0	1	1	0	0	1	0	0
3	46114458	.	C	T	0	3	3	0	1	4	0	0
3	46338286	.	A	G	1	1	2	0	0	2	0	0
3	46338289	.	G	A	0	1	1	0	1	2	0	0
3	46353747	.	C	A	1	2	3	0	1	4	0	0
3	46354031	.	C	T	2	0	2	0	0	2	0	0
3	46354217	.	A	G	0	3	3	0	0	3	0	0
3	46358537	.	A	G	3	0	3	0	1	4	0	0
3	46361536	.	C	A	1	3	4	0	0	4	0	0
3	46362640	.	C	T	2	1	3	0	0	3	0	0
3	46362753	.	C	A	2	4	6	0	1	7	0	0
3	46362830	.	G	A	0	3	3	0	8	11	0	0
3	46362844	.	C	G	2	0	2	0	8	10	0	0
3	46364011	.	G	A	2	1	3	0	0	3	0	0
3	46364053	.	A	C	0	5	5	0	0	5	0	0
3	46364162	.	T	A	0	2	2	0	1	3	0	0
3	46364583	.	T	C	4	3	7	0	0	7	0	0
3	46364654	.	G	A	0	4	4	0	1	5	0	0
3	46364788	.	T	A	4	2	6	0	0	6	0	0
3	46364840	.	G	T	3	1	4	0	0	4	0	0
3	46364847	.	T	G	1	0	1	0	2	3	0	0
3	46377497	.	A	T	8	5	13	0	0	13	0	0
3	46377528	.	C	A	4	6	10	0	0	10	0	0
3	46379849	.	C	G	7	2	9	0	0	9	0	0
3	46380144	.	A	C	5	3	8	0	1	9	0	0
3	46380189	.	A	G	9	8	17	0	0	17	0	0
3	46380194	.	T	A	8	8	16	0	0	16	0	0
3	46388058	.	C	T	9	6	15	0	3	18	0	0
3	46388285	.	G	A	6	3	9	0	0	9	0	0
3	46388439	.	A	T	7	4	11	0	0	11	0	0
3	46388487	.	A	C	8	3	11	0	0	11	0	0
3	46388490	.	T	A	8	4	12	0	0	12	0	0
3	46388854	.	T	C	5	12	17	0	0	17	0	0
3	46388905	.	G	A	12	4	16	0	0	16	0	0
3	46388954	.	A	C	13	6	19	0	1	20	0	0
3	46388968	.	G	C	5	15	20	0	0	20	0	0
3	46389009	.	C	T	4	19	23	0	1	24	0	0
3	46391844	.	C	T	0	6	6	0	5	11	0	0
3	46398380	.	G	A	5	7	12	0	0	12	0	0
3	46403743	.	C	T	0	3	3	0	5	8	0	0
3	46410288	.	T	C	2	0	2	0	0	2	0	0
3	46463113	.	T	C	2	3	5	0	0	5	0	0
3	46463156	.	C	T	3	3	6	0	0	6	0	0
3	46463240	.	C	T	1	0	1	0	0	1	0	0
3	46473247	.	G	C	0	0	0	0	2	2	0	0
3	46505751	.	T	C	0	1	1	0	1	2	0	0
3	46550242	.	T	C	2	2	4	0	1	5	0	0
3	46551285	.	T	A	4	4	8	0	0	8	0	0
3	46552712	.	G	C	3	2	5	0	0	5	0	0
3	46552775	.	G	A	3	4	7	0	0	7	0	0
3	46552832	.	A	C	4	5	9	0	0	9	0	0
3	46552993	.	A	G	4	6	10	0	0	10	0	0
3	46553206	.	T	G	3	4	7	0	0	7	0	0
3	46553292	.	G	C	3	2	5	0	0	5	0	0
3	46553299	.	A	T	3	1	4	0	0	4	0	0
3	46553470	.	A	G	3	0	3	0	2	5	0	0
3	46553480	.	C	A	6	2	8	0	0	8	0	0
3	46553534	.	C	T	9	3	12	0	1	13	0	0
3	46553540	.	C	A	9	2	11	0	1	12	0	0
3	46553720	.	C	A	2	7	9	0	0	9	0	0
3	46553850	.	A	C	8	6	14	0	0	14	0	0
3	46553893	.	T	C	8	7	15	0	0	15	0	0
3	46553986	.	A	T	4	3	7	0	0	8	1	0
3	46554085	.	G	T	6	5	11	0	0	11	0	0
3	46554177	.	C	A	7	1	8	0	1	9	0	0
3	46554181	.	C	A	2	6	8	0	0	8	0	0
3	46554458	.	G	T	4	3	7	0	2	9	0	0
3	46554564	.	A	G	7	7	14	0	1	15	0	0
3	46554648	.	T	A	5	3	8	0	0	8	0	0
3	46554711	.	G	A	6	10	16	0	0	16	0	0
3	46750272	.	C	T	1	6	7	0	1	8	0	0
3	46750752	.	G	A	6	10	16	0	0	16	0	0
3	46750996	.	C	T	11	5	16	0	0	16	0	0
3	46751630	.	G	A	9	6	15	0	2	17	0	0
3	46752522	.	T	G	8	5	13	0	0	13	0	0
3	46753340	.	T	G	8	0	8	0	0	10	2	0
3	46753613	.	T	C	7	9	16	0	0	16	0	0
3	46753619	.	G	A	5	9	14	0	2	16	0	0
3	46753742	.	A	G	15	0	15	0	10	25	0	0
3	46754078	.	T	A	23	18	41	0	2	43	0	0
3	46754296	.	A	T	7	12	19	0	0	19	0	0
3	46764351	.	A	T	0	1	1	0	0	1	0	0
3	46764485	.	A	T	1	3	4	0	0	4	0	0
3	46764572	.	A	T	1	3	4	0	0	4	0	0
3	46767646	.	T	C	1	2	3	0	0	3	0	0
3	46778789	.	G	T	5	3	8	0	1	9	0	0
3	46795013	.	G	T	5	2	7	0	0	7	0	0
3	46795113	.	G	T	1	2	3	0	0	3	0	0
3	46795118	.	G	T	2	3	5	0	0	5	0	0
3	46800490	.	A	T	26	30	56	0	4	61	1	0
3	46800692	.	G	A	21	30	51	0	6	57	0	0
3	46800741	.	T	C	10	0	10	0	15	25	0	0
3	46800743	.	T	C	10	0	10	0	15	25	0	0
3	46800940	.	C	T	26	31	57	0	2	59	0	0
3	46800946	.	T	G	26	32	58	0	1	59	0	0
3	46802227	.	T	C	22	2	24	0	26	50	0	0
3	46802864	.	G	A	6	3	9	0	23	32	0	0
3	46923471	.	T	C	4	2	6	0	0	6	0	0
3	46925227	.	A	G	3	3	6	0	0	6	0	0
3	46928958	.	A	G	0	3	3	0	0	3	0	0
3	46928982	.	G	T	0	3	3	0	0	3	0	0
3	46932545	.	A	G	2	2	4	0	0	4	0	0
3	46932602	.	C	A	0	2	2	0	6	8	0	0
3	47114734	.	A	G	1	0	1	0	0	1	0	0
3	47114746	.	G	A	0	0	0	0	1	1	0	0
3	47119900	.	G	A	3	2	5	0	0	5	0	0
3	47119964	.	C	T	0	1	1	0	1	2	0	0
3	47125636	.	T	A	0	2	2	0	1	3	0	0
3	47125693	.	G	A	1	4	5	0	0	5	0	0
3	47128073	.	A	G	2	2	4	0	0	4	0	0
3	47198805	.	G	A	1	1	2	0	0	2	0	0
3	47201440	.	A	G	4	2	6	0	0	6	0	0
3	47201479	.	T	C	7	6	13	0	1	14	0	0
3	47201482	.	T	C	8	6	14	0	0	14	0	0
3	47201518	.	C	T	4	4	8	0	0	8	0	0
3	47205534	.	A	G	5	0	5	0	4	9	0	0
3	47205543	.	C	T	4	6	10	0	0	10	0	0
3	47205585	.	A	T	7	2	9	0	1	10	0	0
3	47205597	.	C	T	1	6	7	0	0	7	0	0
3	47209433	.	T	C	2	7	9	0	2	11	0	0
3	47209445	.	A	T	1	5	6	0	1	7	0	0
3	47212662	.	A	G	2	5	7	0	1	8	0	0
3	47212774	.	T	C	3	2	5	0	0	5	0	0
3	47212790	.	A	G	3	0	3	0	2	5	0	0
3	47212896	.	A	T	3	2	5	0	0	5	0	0
3	47212914	.	T	C	3	2	5	0	0	5	0	0
3	47384568	.	C	T	1	2	3	0	0	3	0	0
3	47498493	.	C	T	0	2	2	0	5	7	0	0
3	47498565	.	A	T	1	2	3	0	0	3	0	0
3	47498625	.	C	A	3	3	6	0	1	7	0	0
3	47498633	.	G	A	3	2	5	0	0	5	0	0
3	47529469	.	T	G	1	1	2	0	0	2	0	0
3	47529490	.	G	A	1	0	1	0	0	1	0	0
3	47548264	.	A	G	1	2	3	0	0	3	0	0
3	47548304	.	C	T	0	1	1	0	1	2	0	0
3	47548307	.	G	A	0	1	1	0	0	1	0	0
3	47557276	.	A	G	1	1	2	0	0	2	0	0
3	47571522	.	C	T	0	2	2	0	2	4	0	0
3	48241645	.	G	T	0	1	1	0	0	1	0	0
3	48244963	.	G	A	0	0	0	0	1	1	0	0
3	48247601	.	A	G	1	1	2	0	1	3	0	0
3	48253673	.	C	T	0	2	2	0	0	2	0	0
3	48301180	.	A	G	1	3	4	0	0	4	0	0
3	48305837	.	C	G	2	0	2	0	0	2	0	0
3	48305841	.	G	A	0	2	2	0	0	2	0	0
3	48305898	.	C	G	0	1	1	0	1	2	0	0
3	48320968	.	A	G	2	1	3	0	0	3	0	0
3	48326568	.	G	A	3	0	3	0	0	3	0	0
3	48326631	.	C	T	1	1	2	0	0	2	0	0
3	48327002	.	G	A	2	3	5	0	0	5	0	0
3	48473546	.	C	A	1	2	3	0	1	4	0	0
3	48473565	.	A	G	3	5	8	0	0	8	0	0
3	48473641	.	A	G	5	4	9	0	1	10	0	0
3	48479982	.	C	T	1	4	5	0	0	5	0	0
3	48480156	.	T	G	3	5	8	0	2	10	0	0
3	48480333	.	T	C	2	0	2	0	1	3	0	0
3	48488909	.	G	T	3	6	9	0	0	10	1	0
3	48488993	.	T	C	6	5	11	0	0	11	0	0
3	48489101	.	C	G	4	0	4	0	5	9	0	0
3	48489154	.	A	G	3	0	3	0	5	8	0	0
3	48550676	.	G	A	17	18	35	0	2	37	0	0
3	48557707	.	T	C	0	0	0	0	3	3	0	0
3	48584800	.	A	T	7	7	14	0	0	14	0	0
3	48585222	.	C	T	0	16	16	0	13	29	0	0
3	48585236	.	C	A	18	11	29	0	1	30	0	0
3	48585271	.	A	C	23	7	30	0	1	31	0	0
3	48585331	.	A	G	16	7	23	0	3	26	0	0
3	48585377	.	G	T	14	14	28	0	4	32	0	0
3	48585411	.	G	T	17	13	30	0	4	34	0	0
3	48586985	.	A	G	14	14	28	0	0	28	0	0
3	48587176	.	C	A	14	11	25	0	1	26	0	0
3	48587191	.	C	T	12	11	23	0	0	23	0	0
3	48588830	.	A	G	6	4	10	0	2	12	0	0
3	48588884	.	A	G	9	7	16	0	0	16	0	0
3	48589156	.	A	G	1	0	1	0	0	1	0	0
3	48591769	.	A	G	8	7	15	0	0	15	0	0
3	48591825	.	G	T	2	2	4	0	0	4	0	0
3	48593781	.	T	C	9	16	25	0	2	27	0	0
3	48593811	.	G	A	11	5	16	0	1	17	0	0
3	48594098	.	T	C	9	0	9	0	17	26	0	0
3	48596834	.	T	C	3	6	9	0	0	9	0	0
3	48612027	.	T	C	0	0	0	0	3	3	0	0
3	48612038	.	A	G	1	1	2	0	1	3	0	0
3	48612075	.	T	C	1	0	1	0	2	3	0	0
3	48645801	.	G	T	1	0	1	0	0	1	0	0
3	48661500	.	A	G	5	6	11	0	0	11	0	0
3	48661700	.	G	A	2	2	4	0	1	5	0	0
3	48665832	.	T	A	8	2	10	0	0	10	0	0
3	48665841	.	T	G	7	3	10	0	2	12	0	0
3	48687134	.	C	T	0	0	0	0	2	2	0	0
3	48700453	.	G	A	3	1	4	0	0	4	0	0
3	49130387	.	A	C	2	0	2	0	5	7	0	0
3	49130480	.	G	A	3	3	6	0	0	6	0	0
3	49134236	.	A	C	4	2	6	0	0	6	0	0
3	49134373	.	A	G	2	5	7	0	0	7	0	0
3	49134385	.	A	G	5	2	7	0	0	7	0	0
3	49134412	.	A	G	1	5	6	0	0	6	0	0
3	49137821	.	C	A	0	2	2	0	6	8	0	0
3	49150883	.	T	G	2	2	4	0	0	4	0	0
3	49154025	.	G	A	1	2	3	0	0	3	0	0
3	49163528	.	G	T	4	5	9	0	0	9	0	0
3	49163558	.	T	C	1	3	4	0	0	4	0	0
3	49426063	.	G	A	7	7	14	0	0	14	0	0
3	49426184	.	G	A	10	9	19	0	1	20	0	0
3	49439587	.	A	G	2	2	4	0	0	4	0	0
3	49440129	.	G	T	1	3	4	0	0	4	0	0
3	49447514	.	C	A	0	8	8	0	6	14	0	0
3	49478380	.	T	C	1	2	3	0	0	3	0	0
3	49503880	.	A	G	13	11	24	0	1	25	0	0
3	49559444	.	C	T	34	28	62	0	3	65	0	0
3	49559523	.	C	T	30	31	61	0	5	66	0	0
3	49559527	.	G	T	28	29	57	0	5	62	0	0
3	49559637	.	G	T	39	29	68	0	4	72	0	0
3	49559703	.	G	A	25	44	69	0	0	69	0	0
3	49559904	.	G	A	39	21	60	0	4	64	0	0
3	49559979	.	A	G	35	29	64	0	0	64	0	0
3	49559988	.	T	A	29	29	58	0	4	62	0	0
3	49560084	.	A	G	25	37	62	0	0	62	0	0
3	49560204	.	G	C	33	27	60	0	2	62	0	0
3	49560276	.	T	G	32	28	60	0	3	63	0	0
3	49560420	.	C	T	27	31	58	0	0	58	0	0
3	49560507	.	G	A	25	27	52	0	2	54	0	0
3	49758429	.	A	G	1	3	4	0	0	4	0	0
3	49760173	.	T	C	1	0	1	0	3	4	0	0
3	50054508	.	G	A	8	3	11	0	0	11	0	0
3	50054578	.	C	G	7	6	13	0	2	15	0	0
3	50054619	.	A	T	9	4	13	0	0	13	0	0
3	50054766	.	G	A	2	12	14	0	1	15	0	0
3	50059143	.	A	T	6	12	18	0	1	19	0	0
3	50063458	.	C	T	8	7	15	0	1	16	0	0
3	50063491	.	C	T	0	13	13	0	4	17	0	0
3	50066373	.	A	G	12	14	26	0	3	29	0	0
3	50066402	.	G	A	13	16	29	0	1	30	0	0
3	50077050	.	G	A	2	4	6	0	0	6	0	0
3	50077077	.	G	A	6	10	16	0	1	17	0	0
3	50077311	.	A	G	13	16	29	0	1	30	0	0
3	50077364	.	T	A	13	6	19	0	1	21	1	0
3	50077371	.	G	A	8	12	20	0	0	20	0	0
3	50077428	.	G	C	0	3	3	0	0	3	0	0
3	50081696	.	G	A	5	3	8	0	0	8	0	0
3	50083980	.	C	A	3	1	4	0	1	5	0	0
3	50084011	.	A	G	11	6	17	0	2	19	0	0
3	50087361	.	C	A	0	7	7	0	3	10	0	0
3	50087370	.	G	A	5	7	12	0	0	12	0	0
3	50087433	.	C	A	0	6	6	0	13	19	0	0
3	50089113	.	G	A	2	3	5	0	0	5	0	0
3	50089470	.	T	C	3	3	6	0	0	6	0	0
3	50091985	.	A	G	8	12	20	0	4	24	0	0
3	50095869	.	A	T	4	3	7	0	0	7	0	0
3	50104084	.	C	T	1	0	1	0	0	1	0	0
3	50110202	.	T	C	1	0	1	0	2	3	0	0
3	50110205	.	C	A	1	2	3	0	0	3	0	0
3	50110369	.	T	C	3	0	3	0	0	3	0	0
3	50110399	.	A	G	0	3	3	0	0	3	0	0
3	50123650	.	C	A	0	11	11	0	19	30	0	0
3	50123709	.	A	G	9	23	32	0	2	34	0	0
3	50123758	.	A	G	12	30	42	0	3	45	0	0
3	50123760	.	C	A	31	14	45	0	0	45	0	0
3	50123936	.	G	A	9	23	32	0	3	35	0	0
3	50124107	.	A	G	11	8	19	0	1	20	0	0
3	50124108	.	C	G	11	9	20	0	0	20	0	0
3	50155405	.	T	A	1	2	3	0	0	3	0	0
3	50155406	.	A	T	1	2	3	0	0	3	0	0
3	50166550	.	T	C	1	0	1	0	0	1	0	0
3	50170236	.	A	G	1	0	1	0	3	4	0	0
3	50170338	.	T	A	0	4	4	0	0	4	0	0
3	50170354	.	C	T	0	1	1	0	0	1	0	0
3	50172725	.	G	C	2	4	6	0	0	6	0	0
3	50172735	.	T	A	4	1	5	0	0	5	0	0
3	50172788	.	C	T	1	2	3	0	0	3	0	0
3	50175411	.	T	C	1	2	3	0	0	3	0	0
3	50175940	.	G	T	7	4	11	0	0	11	0	0
3	50176620	.	G	T	5	6	11	0	0	11	0	0
3	50253969	.	G	A	2	5	7	0	0	7	0	0
3	50256938	.	A	C	4	6	10	0	1	11	0	0
3	50265852	.	C	T	2	7	9	0	0	9	0	0
3	50265903	.	A	C	5	9	14	0	0	14	0	0
3	50265906	.	T	C	5	10	15	0	0	15	0	0
3	50265994	.	C	T	4	4	8	0	1	9	0	0
3	50266043	.	C	A	4	4	8	0	0	8	0	0
3	50266063	.	A	G	4	5	9	0	0	9	0	0
3	50266330	.	T	A	3	7	10	0	0	10	0	0
3	50266945	.	A	G	1	9	10	0	0	10	0	0
3	50267171	.	T	G	3	3	6	0	0	6	0	0
3	50267256	.	T	A	2	4	6	0	0	6	0	0
3	50267460	.	G	A	3	2	5	0	1	6	0	0
3	50267686	.	T	C	6	6	12	0	0	12	0	0
3	50267860	.	A	T	5	10	15	0	1	16	0	0
3	50267981	.	G	C	6	7	13	0	0	13	0	0
3	50267992	.	T	A	5	5	10	0	0	11	1	0
3	50268016	.	T	C	4	5	9	0	0	9	0	0
3	50268052	.	A	T	4	5	9	0	0	9	0	0
3	50268073	.	A	G	5	3	8	0	0	8	0	0
3	50268106	.	G	T	4	3	7	0	0	7	0	0
3	50268220	.	C	T	4	5	9	0	0	9	0	0
3	50268422	.	G	A	5	3	8	0	0	8	0	0
3	50268535	.	A	C	9	7	16	0	0	16	0	0
3	50268715	.	C	T	10	6	16	0	1	17	0	0
3	50268744	.	G	A	12	9	21	0	0	21	0	0
3	50272168	.	C	T	0	2	2	0	3	5	0	0
3	50272273	.	G	A	1	3	4	0	0	4	0	0
3	50272435	.	T	G	10	5	15	0	3	18	0	0
3	50272438	.	T	G	13	4	17	0	0	17	0	0
3	50273026	.	G	A	7	10	17	0	0	17	0	0
3	50273031	.	C	T	7	8	15	0	2	17	0	0
3	50273469	.	C	T	0	2	2	0	3	5	0	0
3	50276336	.	A	T	0	1	1	0	0	1	0	0
3	50418826	.	G	C	6	7	13	0	1	14	0	0
3	50419046	.	C	T	7	3	10	0	1	11	0	0
3	50419155	.	C	T	9	3	12	0	0	13	1	0
3	50419329	.	G	A	3	1	4	0	0	4	0	0
3	50419344	.	T	A	2	3	5	0	0	5	0	0
3	50419658	.	T	A	3	3	6	0	0	6	0	0
3	50419686	.	A	T	4	4	8	0	0	8	0	0
3	50419722	.	G	C	3	4	7	0	1	9	1	0
3	50419723	.	C	A	4	5	9	0	0	9	0	0
3	50419759	.	C	T	5	2	7	0	0	7	0	0
3	50419827	.	T	C	2	9	11	0	0	11	0	0
3	50419866	.	T	A	3	2	5	0	0	6	1	0
3	50419867	.	A	C	2	4	6	0	0	6	0	0
3	50420001	.	A	C	4	6	10	0	1	11	0	0
3	50420087	.	A	G	1	7	8	0	0	8	0	0
3	50420139	.	A	T	7	6	13	0	0	13	0	0
3	50420152	.	G	T	5	8	13	0	0	13	0	0
3	50420191	.	A	T	2	6	8	0	3	11	0	0
3	50420194	.	T	A	5	5	10	0	0	10	0	0
3	50951299	.	C	A	1	6	7	0	0	7	0	0
3	50951644	.	C	G	6	2	8	0	1	9	0	0
3	50951862	.	A	G	4	4	8	0	0	8	0	0
3	50952163	.	G	A	6	2	8	0	0	8	0	0
3	50952404	.	G	T	3	3	6	0	0	6	0	0
3	51034995	.	G	T	3	2	5	0	0	5	0	0
3	51039012	.	C	T	0	0	0	0	1	1	0	0
3	51043176	.	G	A	2	3	5	0	0	5	0	0
3	51043976	.	G	A	4	3	7	0	0	7	0	0
3	51043994	.	G	A	4	3	7	0	1	8	0	0
3	51063396	.	C	T	1	0	1	0	0	1	0	0
3	51063398	.	C	T	1	0	1	0	0	1	0	0
3	51065802	.	A	G	1	3	4	0	0	4	0	0
3	51563824	.	T	C	0	2	2	0	1	3	0	0
3	51619684	.	A	G	0	1	1	0	0	1	0	0
3	51619708	.	G	A	2	2	4	0	0	4	0	0
3	51619762	.	C	T	2	3	5	0	0	5	0	0
3	51619789	.	A	C	2	3	5	0	0	5	0	0
3	51619801	.	T	A	2	2	4	0	0	4	0	0
3	51619846	.	T	C	1	2	3	0	0	3	0	0
3	51642491	.	G	A	3	4	7	0	0	7	0	0
3	51642536	.	A	C	1	1	2	0	0	2	0	0
3	51653411	.	G	A	4	3	7	0	0	7	0	0
3	51653435	.	C	T	5	5	10	0	0	10	0	0
3	51656720	.	G	A	7	5	12	0	0	12	0	0
3	51656726	.	C	A	8	4	12	0	0	12	0	0
3	51656762	.	G	A	7	8	15	0	0	15	0	0
3	51656849	.	T	A	7	3	10	0	0	10	0	0
3	51656921	.	T	C	5	3	8	0	0	8	0	0
3	51656931	.	G	A	4	2	6	0	1	7	0	0
3	51656973	.	C	A	4	6	10	0	0	10	0	0
3	51657033	.	T	A	12	9	21	0	0	21	0	0
3	51657082	.	C	T	11	4	15	0	1	16	0	0
3	51657158	.	A	G	6	0	6	0	5	11	0	0
3	51657291	.	G	A	16	5	21	0	1	22	0	0
3	51657314	.	G	A	13	6	19	0	0	19	0	0
3	51657339	.	C	T	7	4	11	0	1	12	0	0
3	51657382	.	G	C	7	3	10	0	0	10	0	0
3	51657439	.	A	G	8	5	13	0	0	13	0	0
3	51657456	.	C	T	9	7	16	0	0	16	0	0
3	51861767	.	G	A	1	3	4	0	1	5	0	0
3	51871663	.	A	T	3	7	10	0	1	11	0	0
3	51871671	.	C	T	3	8	11	0	0	11	0	0
3	51871704	.	G	C	2	5	7	0	1	8	0	0
3	51871788	.	G	A	2	1	3	0	0	3	0	0
3	51874119	.	C	A	1	0	1	0	0	1	0	0
3	51874163	.	G	A	4	2	6	0	0	6	0	0
3	51874274	.	G	A	7	6	13	0	2	15	0	0
3	51879297	.	G	T	7	5	12	0	0	12	0	0
3	51891785	.	A	G	10	0	10	0	11	21	0	0
3	51891787	.	C	T	11	10	21	0	0	21	0	0
3	51892095	.	T	A	2	5	7	0	0	7	0	0
3	51892107	.	A	G	5	2	7	0	0	7	0	0
3	51892136	.	A	T	3	3	6	0	0	6	0	0
3	51892162	.	A	G	3	6	9	0	0	9	0	0
3	51892176	.	T	A	2	10	12	0	1	13	0	0
3	51892212	.	A	G	4	9	13	0	0	13	0	0
3	51892225	.	T	A	4	9	13	0	0	13	0	0
3	51892502	.	G	A	8	3	11	0	0	11	0	0
3	51892527	.	G	A	4	2	6	0	1	8	1	0
3	51892573	.	T	C	6	7	13	0	0	13	0	0
3	51899772	.	T	A	12	3	15	0	0	15	0	0
3	51899802	.	C	T	0	3	3	0	12	15	0	0
3	51899872	.	C	T	1	7	8	0	3	11	0	0
3	51900357	.	C	A	4	13	17	0	0	17	0	0
3	51900400	.	A	G	8	2	10	0	0	10	0	0
3	51900415	.	T	C	5	6	11	0	0	11	0	0
3	51900487	.	A	C	7	18	25	0	1	26	0	0
3	51900552	.	A	G	3	5	8	0	1	9	0	0
3	51900587	.	C	T	3	9	12	0	0	12	0	0
3	51900589	.	A	C	3	9	12	0	0	12	0	0
3	51900693	.	C	G	12	8	20	0	1	21	0	0
3	51900702	.	C	A	0	9	9	0	8	17	0	0
3	51900768	.	T	A	4	1	5	0	1	6	0	0
3	51900784	.	T	C	6	0	6	0	1	7	0	0
3	51901018	.	C	T	0	1	1	0	0	1	0	0
3	51901092	.	A	T	11	9	20	0	1	21	0	0
3	51901127	.	A	G	15	12	27	0	1	28	0	0
3	51901178	.	T	A	7	7	14	0	1	15	0	0
3	51901199	.	G	T	3	1	4	0	0	4	0	0
3	51901309	.	G	A	6	5	11	0	1	12	0	0
3	51901344	.	T	C	7	8	15	0	4	19	0	0
3	51901413	.	A	G	1	7	8	0	0	8	0	0
3	51901670	.	C	T	6	9	15	0	0	15	0	0
3	51901799	.	T	C	12	14	26	0	1	27	0	0
3	51901835	.	G	A	9	17	26	0	2	28	0	0
3	51901873	.	A	G	11	14	25	0	0	25	0	0
3	51901885	.	T	C	10	12	22	0	1	23	0	0
3	51902099	.	C	T	11	10	21	0	1	22	0	0
3	51902171	.	T	A	7	8	15	0	0	15	0	0
3	51902454	.	T	A	7	8	15	0	1	16	0	0
3	51902471	.	C	T	7	10	17	0	1	18	0	0
3	51902591	.	T	A	5	8	13	0	1	14	0	0
3	51902834	.	A	G	10	7	17	0	1	18	0	0
3	51902883	.	G	A	7	11	18	0	0	18	0	0
3	51902987	.	A	G	9	5	14	0	0	14	0	0
3	51903048	.	A	C	3	7	10	0	0	10	0	0
3	51903080	.	A	G	4	7	11	0	0	11	0	0
3	51903168	.	C	T	8	5	13	0	0	13	0	0
3	51903198	.	A	C	6	0	6	0	11	17	0	0
3	51903211	.	T	G	8	14	22	0	1	23	0	0
3	51903233	.	A	G	8	11	19	0	3	22	0	0
3	51903286	.	G	T	9	8	17	0	1	18	0	0
3	51903495	.	A	G	11	3	14	0	0	14	0	0
3	51903591	.	C	T	6	9	15	0	0	15	0	0
3	51903605	.	G	A	5	10	15	0	0	15	0	0
3	51903742	.	C	G	4	5	9	0	0	9	0	0
3	51903810	.	T	G	6	4	10	0	0	10	0	0
3	51903815	.	T	A	6	5	11	0	0	11	0	0
3	51903979	.	T	C	2	4	6	0	0	6	0	0
3	51904019	.	G	T	3	6	9	0	0	9	0	0
3	51904043	.	G	T	3	4	7	0	0	7	0	0
3	51904226	.	A	G	2	4	6	0	0	6	0	0
3	51904359	.	T	A	6	5	11	0	0	11	0	0
3	51907077	.	G	T	4	3	7	0	0	7	0	0
3	52558270	.	A	G	3	0	3	0	2	5	0	0
3	52558309	.	G	A	0	2	2	0	3	5	0	0
3	52563568	.	C	T	0	5	5	0	0	5	0	0
3	52584332	.	C	T	5	3	8	0	0	8	0	0
3	52584428	.	C	T	2	4	6	0	1	7	0	0
3	52588941	.	C	T	2	3	5	0	0	5	0	0
3	52594760	.	G	A	6	7	13	0	2	15	0	0
3	52594966	.	T	C	7	10	17	0	0	17	0	0
3	52603216	.	A	C	10	12	22	0	1	23	0	0
3	52641819	.	T	C	2	0	2	0	4	6	0	0
3	52641831	.	C	T	0	1	1	0	5	6	0	0
3	52642132	.	T	A	3	3	6	0	0	6	0	0
3	52642614	.	T	C	0	0	0	0	3	3	0	0
3	52647870	.	C	T	1	6	7	0	0	7	0	0
3	52668542	.	G	A	6	6	12	0	0	12	0	0
3	52668679	.	C	T	0	2	2	0	2	4	0	0
3	52669995	.	G	A	2	3	5	0	0	5	0	0
3	52673834	.	T	A	2	5	7	0	0	7	0	0
3	52673854	.	A	T	5	2	7	0	0	7	0	0
3	52674017	.	T	A	3	3	6	0	0	6	0	0
3	52674018	.	A	C	3	3	6	0	0	6	0	0
3	52674105	.	A	C	2	2	4	0	1	5	0	0
3	52677279	.	G	A	5	2	7	0	0	7	0	0
3	52677281	.	C	T	5	2	7	0	0	7	0	0
3	52677492	.	C	G	3	2	5	0	0	5	0	0
3	52677501	.	T	C	3	2	5	0	0	5	0	0
3	52689511	.	C	T	1	2	3	0	0	3	0	0
3	52697145	.	C	T	2	2	4	0	0	4	0	0
3	52697167	.	A	C	2	2	4	0	0	4	0	0
3	52697304	.	G	C	0	2	2	0	0	2	0	0
3	52697312	.	A	C	0	2	2	0	0	2	0	0
3	52697371	.	T	A	1	0	1	0	1	2	0	0
3	52699405	.	G	A	4	4	8	0	0	8	0	0
3	52699441	.	G	A	5	2	7	0	0	7	0	0
3	52699494	.	A	G	4	2	6	0	0	6	0	0
3	52699503	.	T	C	5	2	7	0	0	7	0	0
3	52699775	.	C	T	8	3	11	0	1	12	0	0
3	52699995	.	T	C	6	6	12	0	0	12	0	0
3	52895631	.	G	A	1	2	3	0	0	3	0	0
3	52895667	.	G	A	2	7	9	0	0	9	0	0
3	52895688	.	C	T	2	6	8	0	0	8	0	0
3	52895725	.	C	G	2	2	4	0	0	4	0	0
3	52902344	.	G	A	0	2	2	0	1	3	0	0
3	52902356	.	T	C	1	2	3	0	0	3	0	0
3	52913391	.	T	C	1	3	4	0	0	4	0	0
3	52913508	.	C	T	1	0	1	0	0	1	0	0
3	52913529	.	A	G	3	1	4	0	0	4	0	0
3	52913559	.	T	A	4	2	6	0	1	7	0	0
3	52921735	.	C	T	1	1	2	0	0	2	0	0
3	52925915	.	G	A	0	3	3	0	5	8	0	0
3	52932770	.	C	T	4	2	6	0	0	6	0	0
3	52932793	.	A	C	1	3	4	0	0	4	0	0
3	52935355	.	C	A	1	2	3	0	1	4	0	0
3	52937419	.	T	C	4	2	6	0	0	6	0	0
3	52937723	.	G	T	6	6	12	0	0	12	0	0
3	52937747	.	G	A	1	3	4	0	4	8	0	0
3	52945346	.	G	A	1	0	1	0	0	1	0	0
3	53000280	.	G	A	0	4	4	0	5	9	0	0
3	53000517	.	T	C	6	4	10	0	0	10	0	0
3	53000558	.	A	G	7	0	7	0	4	11	0	0
3	53000673	.	G	T	0	3	3	0	4	7	0	0
3	53001045	.	C	A	2	3	5	0	0	5	0	0
3	53047981	.	A	G	6	0	6	0	9	15	0	0
3	53048032	.	C	T	4	3	7	0	1	8	0	0
3	53074317	.	C	T	12	22	34	1	4	39	0	0
3	53074581	.	C	T	13	11	24	0	0	24	0	0
3	53075050	.	C	A	7	5	12	0	1	13	0	0
3	53075475	.	T	G	11	10	21	0	2	23	0	0
3	53076037	.	A	T	17	13	30	0	1	31	0	0
3	53076160	.	G	T	0	20	20	2	18	40	0	0
3	53140883	.	A	G	1	1	2	0	0	2	0	0
3	53192505	.	C	T	2	5	7	0	0	7	0	0
3	53198571	.	A	C	2	4	6	0	3	9	0	0
3	53198736	.	T	C	8	6	14	0	0	14	0	0
3	53198987	.	T	G	4	5	9	0	1	10	0	0
3	53199113	.	G	A	0	3	3	0	5	8	0	0
3	53199182	.	C	T	3	3	6	0	0	6	0	0
3	53199433	.	A	T	1	2	3	0	0	3	0	0
3	53201554	.	A	G	1	0	1	0	0	1	0	0
3	53201662	.	G	T	0	2	2	0	3	5	0	0
3	53201674	.	C	T	2	2	4	0	0	4	0	0
3	53203455	.	A	G	4	2	6	0	0	6	0	0
3	53203566	.	C	T	3	1	4	0	0	4	0	0
3	53203782	.	A	G	0	1	1	0	1	2	0	0
3	53203823	.	T	G	3	0	3	0	4	7	0	0
3	53204009	.	C	T	3	7	10	0	0	10	0	0
3	53204135	.	A	G	0	0	0	0	1	1	0	0
3	53206055	.	A	G	5	0	5	0	3	8	0	0
3	53206260	.	A	G	3	3	6	0	0	6	0	0
3	53206418	.	G	A	7	10	17	0	3	20	0	0
3	53206427	.	C	T	7	6	13	0	2	15	0	0
3	53206469	.	A	T	4	11	15	0	0	15	0	0
3	53206472	.	C	T	2	10	12	0	1	13	0	0
3	53211032	.	A	G	4	1	5	0	0	5	0	0
3	53211168	.	G	C	9	6	15	0	4	19	0	0
3	53211170	.	T	C	8	9	17	0	2	19	0	0
3	53211206	.	A	T	8	7	15	0	2	17	0	0
3	53211239	.	A	G	14	5	19	0	4	23	0	0
3	53211248	.	T	G	17	0	17	0	6	23	0	0
3	53211356	.	A	T	3	11	14	0	1	15	0	0
3	53211366	.	C	A	4	10	14	0	1	15	0	0
3	53211604	.	C	G	12	9	21	0	0	21	0	0
3	53211605	.	C	T	10	9	19	0	2	21	0	0
3	53214615	.	T	C	5	3	8	0	1	9	0	0
3	53215644	.	C	T	0	2	2	0	0	2	0	0
3	53215711	.	T	A	6	9	15	0	0	15	0	0
3	53215729	.	G	A	5	7	12	0	0	12	0	0
3	53218471	.	C	T	9	3	12	0	1	13	0	0
3	53222943	.	G	T	1	6	7	0	10	17	0	0
3	53223032	.	C	A	11	11	22	0	0	22	0	0
3	53223110	.	T	C	5	8	13	0	1	14	0	0
3	53223290	.	G	A	8	12	20	0	1	21	0	0
3	53223415	.	C	T	8	5	13	0	3	16	0	0
3	53223783	.	C	T	8	9	17	0	2	19	0	0
3	53223973	.	A	C	9	8	17	0	0	17	0	0
3	53224029	.	G	A	11	8	19	0	1	20	0	0
3	53224181	.	A	G	12	12	24	0	0	24	0	0
3	53224231	.	C	G	9	7	16	1	0	17	0	0
3	53228771	.	T	A	0	1	1	0	0	1	0	0
3	53229021	.	G	A	0	7	7	0	0	7	0	0
3	53229036	.	T	A	0	7	7	0	0	7	0	0
3	53230980	.	T	C	6	2	8	0	1	9	0	0
3	53231102	.	A	T	10	4	14	0	0	14	0	0
3	53231133	.	T	G	8	3	11	0	0	11	0	0
3	53231144	.	G	A	10	3	13	0	0	13	0	0
3	53253900	.	C	T	0	2	2	0	0	2	0	0
3	53271759	.	A	G	1	0	1	0	1	2	0	0
3	53273484	.	G	A	0	0	0	0	1	1	0	0
3	53329518	.	C	T	0	2	2	0	0	2	0	0
3	53330005	.	A	G	0	2	2	0	0	2	0	0
3	53342694	.	G	A	0	8	8	0	1	9	0	0
3	53342706	.	C	A	0	9	9	0	1	10	0	0
3	53343415	.	C	T	2	1	3	0	0	3	0	0
3	53343418	.	C	T	2	0	2	0	1	3	0	0
3	53344694	.	T	C	1	3	4	0	0	4	0	0
3	53344842	.	C	T	0	1	1	0	0	1	0	0
3	53344968	.	C	T	1	1	2	0	0	2	0	0
3	53350410	.	T	C	2	4	6	0	0	6	0	0
3	53350411	.	G	A	2	4	6	0	0	6	0	0
3	53398058	.	T	A	1	3	4	0	0	4	0	0
3	53445378	.	A	T	5	6	11	0	0	11	0	0
3	53445979	.	C	T	8	3	11	0	0	11	0	0
3	53446039	.	A	C	4	2	6	0	0	6	0	0
3	53446429	.	A	G	1	1	2	0	0	2	0	0
3	53446569	.	C	T	3	3	6	0	0	6	0	0
3	53447714	.	C	T	4	4	8	0	1	9	0	0
3	53447717	.	C	T	4	4	8	0	1	9	0	0
3	53448188	.	T	C	2	1	3	0	0	3	0	0
3	53449227	.	C	A	7	10	17	0	0	17	0	0
3	53449263	.	A	G	9	6	15	0	2	17	0	0
3	53527681	.	T	C	4	4	8	0	0	8	0	0
3	53528017	.	T	C	4	9	13	0	1	14	0	0
3	53528039	.	G	A	4	10	14	0	0	14	0	0
3	53528190	.	T	C	4	3	7	0	0	7	0	0
3	53528251	.	C	A	0	9	9	0	3	12	0	0
3	53528750	.	T	A	1	2	3	0	0	3	0	0
3	53528814	.	T	C	6	3	9	0	1	10	0	0
3	53528893	.	A	T	4	2	6	0	0	6	0	0
3	53530423	.	C	T	1	3	4	0	1	5	0	0
3	53530656	.	C	T	1	2	3	0	0	3	0	0
3	53687791	.	A	T	3	4	7	0	0	7	0	0
3	53688047	.	A	T	2	2	4	0	0	4	0	0
3	53688381	.	G	A	1	4	5	0	1	6	0	0
3	53698009	.	C	T	1	0	1	0	0	1	0	0
3	54047599	.	T	G	6	6	12	0	1	13	0	0
3	54047881	.	T	C	0	2	2	0	1	3	0	0
3	54168046	.	C	T	14	10	24	0	0	24	0	0
3	54168127	.	C	T	9	6	15	0	0	15	0	0
3	54168174	.	T	C	10	7	17	0	0	17	0	0
3	54168192	.	T	C	7	10	17	0	1	18	0	0
3	54168318	.	T	C	4	4	8	0	0	8	0	0
3	54207610	.	C	T	19	24	43	0	0	43	0	0
3	54223504	.	G	A	3	4	7	0	0	7	0	0
3	54236612	.	A	G	2	0	2	0	3	5	0	0
3	54236621	.	T	G	6	5	11	0	1	12	0	0
3	54236657	.	C	A	11	19	30	0	1	31	0	0
3	54236750	.	A	G	20	27	47	0	2	49	0	0
3	54236996	.	G	A	0	25	25	0	28	53	0	0
3	54237443	.	G	C	11	16	27	0	0	27	0	0
3	54237472	.	T	C	10	16	26	0	1	27	0	0
3	54434398	.	C	T	0	2	2	0	2	4	0	0
3	54434468	.	C	T	3	1	4	0	2	6	0	0
3	54434710	.	C	T	0	3	3	0	4	7	0	0
3	54434720	.	G	A	0	5	5	0	2	7	0	0
3	54435002	.	A	G	2	3	5	0	0	5	0	0
3	54435018	.	A	G	3	2	5	0	0	5	0	0
3	54435085	.	G	T	0	1	1	0	1	2	0	0
3	54435088	.	G	A	1	1	2	0	0	2	0	0
3	54435273	.	G	A	3	2	5	0	1	6	0	0
3	54435336	.	C	G	0	3	3	0	7	10	0	0
3	54435453	.	G	A	1	1	2	0	0	2	0	0
3	54438753	.	G	A	5	2	7	0	0	7	0	0
3	54455057	.	T	C	3	6	9	0	0	9	0	0
3	54455120	.	T	C	5	0	5	0	5	10	0	0
3	54455168	.	C	T	0	0	0	0	3	3	0	0
3	54455616	.	G	T	2	3	5	0	1	6	0	0
3	54455827	.	G	A	2	1	3	0	0	3	0	0
3	54474860	.	G	A	1	3	4	0	0	4	0	0
3	54500103	.	T	C	2	2	4	0	0	4	0	0
3	54500111	.	C	G	1	2	3	0	0	3	0	0
3	54561375	.	A	G	3	4	7	0	0	7	0	0
3	54567303	.	T	A	5	8	13	0	0	13	0	0
3	54567463	.	T	A	5	4	9	0	1	10	0	0
3	54567502	.	G	A	8	6	14	0	0	14	0	0
3	54567715	.	A	C	1	3	4	0	0	4	0	0
3	54567777	.	A	G	3	0	3	0	4	7	0	0
3	54583742	.	C	T	1	4	5	0	0	5	0	0
3	54585281	.	A	G	6	3	9	0	0	9	0	0
3	54585359	.	C	T	8	3	11	0	1	12	0	0
3	54585637	.	T	C	23	15	38	0	1	39	0	0
3	54585685	.	C	T	7	8	15	0	0	15	0	0
3	54586125	.	T	C	2	0	2	0	0	2	0	0
3	54589582	.	T	C	4	12	16	0	1	17	0	0
3	54591385	.	G	A	3	3	6	0	0	6	0	0
3	54591432	.	A	C	3	8	11	0	0	11	0	0
3	54591677	.	G	A	8	7	15	0	0	15	0	0
3	54591701	.	A	G	4	4	8	0	0	8	0	0
3	54591849	.	G	A	8	6	14	0	1	15	0	0
3	54592322	.	G	A	5	4	9	0	2	11	0	0
3	54592376	.	A	T	10	9	19	0	2	21	0	0
3	54592986	.	T	C	2	0	2	0	2	4	0	0
3	54593034	.	A	T	3	8	11	0	0	11	0	0
3	54593046	.	C	T	4	7	11	0	0	11	0	0
3	54594823	.	C	T	3	2	5	0	0	5	0	0
3	54594865	.	T	A	2	4	6	0	1	8	1	0
3	54594880	.	T	C	1	3	4	0	1	5	0	0
3	54595071	.	G	A	2	5	7	0	0	7	0	0
3	54595233	.	C	T	2	8	10	0	0	10	0	0
3	54595257	.	G	A	1	5	6	0	0	6	0	0
3	54596362	.	A	G	2	9	11	0	1	12	0	0
3	54596385	.	C	T	2	7	9	0	0	9	0	0
3	54596892	.	T	C	7	0	7	0	4	11	0	0
3	54596935	.	A	G	2	3	5	0	0	5	0	0
3	54597183	.	G	A	6	6	12	0	1	13	0	0
3	54597712	.	A	C	2	3	5	0	0	5	0	0
3	54598196	.	T	G	3	2	5	0	0	5	0	0
3	54601991	.	C	T	1	3	4	0	0	4	0	0
3	54604010	.	C	T	0	2	2	0	2	4	0	0
3	54771720	.	C	A	2	2	4	0	0	4	0	0
3	54810164	.	G	A	0	2	2	0	0	2	0	0
3	54810588	.	A	G	3	0	3	0	4	7	0	0
3	54834906	.	T	C	2	2	4	0	0	4	0	0
3	54834989	.	T	C	0	0	0	0	3	3	0	0
3	54835016	.	G	A	2	3	5	0	0	5	0	0
3	54835295	.	T	A	2	2	4	0	0	4	0	0
3	54837862	.	T	C	1	1	2	0	0	2	0	0
3	54837876	.	C	T	1	1	2	0	0	2	0	0
3	54849375	.	A	G	1	0	1	0	4	5	0	0
3	54849576	.	T	A	3	1	4	0	0	4	0	0
3	54856591	.	T	C	3	4	7	0	0	7	0	0
3	54856592	.	C	T	3	4	7	0	0	7	0	0
3	54856645	.	T	C	3	4	7	0	0	7	0	0
3	54859127	.	T	C	9	5	14	0	0	14	0	0
3	54866207	.	A	G	2	2	4	0	1	5	0	0
3	54868514	.	C	T	5	4	9	0	0	9	0	0
3	54871515	.	C	A	20	12	32	0	1	33	0	0
3	54871745	.	C	T	7	6	13	0	3	16	0	0
3	54871909	.	A	G	8	3	11	0	0	11	0	0
3	54872003	.	C	G	6	8	14	0	0	14	0	0
3	54872172	.	T	A	21	6	27	0	1	28	0	0
3	54872494	.	A	G	1	4	5	0	1	6	0	0
3	54872520	.	C	G	8	4	12	0	0	12	0	0
3	54873055	.	C	A	12	16	28	0	0	28	0	0
3	54873844	.	T	C	11	15	26	0	1	27	0	0
3	54874245	.	C	T	4	18	22	0	0	22	0	0
3	54874371	.	C	T	20	12	32	0	0	32	0	0
3	54874477	.	A	G	12	13	25	0	0	25	0	0
3	54874631	.	G	A	20	10	30	0	0	30	0	0
3	54874660	.	C	T	17	13	30	0	0	30	0	0
3	54874711	.	G	A	15	8	23	0	0	23	0	0
3	54874757	.	C	T	8	5	13	0	0	13	0	0
3	54896748	.	A	C	1	0	1	0	3	4	0	0
3	54896985	.	A	G	2	4	6	0	0	6	0	0
3	54897039	.	G	A	2	2	4	0	0	4	0	0
3	54897099	.	G	T	4	5	9	0	0	9	0	0
3	54902365	.	C	T	0	1	1	0	1	2	0	0
3	54907937	.	C	T	0	0	0	0	2	2	0	0
3	54914258	.	A	G	3	3	6	0	1	7	0	0
3	55039143	.	C	T	1	1	2	0	0	2	0	0
3	55043049	.	C	T	2	2	4	0	0	4	0	0
3	55045602	.	T	A	7	5	12	0	0	12	0	0
3	55045709	.	G	T	4	4	8	0	0	8	0	0
3	55046165	.	A	G	6	3	9	0	1	10	0	0
3	55050175	.	A	G	5	5	10	0	1	11	0	0
3	55050191	.	T	A	3	3	6	0	1	7	0	0
3	55079251	.	C	T	4	3	7	0	0	7	0	0
3	55091710	.	A	G	1	4	5	0	0	5	0	0
3	55091734	.	A	T	0	0	0	0	1	1	0	0
3	55093668	.	G	C	3	2	5	0	0	5	0	0
3	55093923	.	T	C	3	5	8	0	0	8	0	0
3	55093980	.	T	C	2	4	6	0	1	7	0	0
3	55094004	.	C	T	3	1	4	0	0	4	0	0
3	55094016	.	A	G	2	1	3	0	0	3	0	0
3	55100228	.	T	C	12	0	12	0	0	12	0	0
3	55100522	.	A	G	5	15	20	0	0	20	0	0
3	55100590	.	T	G	10	9	19	0	1	20	0	0
3	55100795	.	A	G	26	11	37	0	0	37	0	0
3	55103678	.	A	G	0	12	12	4	0	16	0	0
3	55104129	.	T	C	11	6	17	0	1	18	0	0
3	55105254	.	T	C	9	6	15	0	0	15	0	0
3	55105886	.	A	G	9	13	22	0	0	22	0	0
3	55161753	.	C	T	4	2	6	0	0	6	0	0
3	55161763	.	G	T	6	1	7	0	1	8	0	0
3	55168904	.	C	G	1	0	1	0	0	1	0	0
3	55174830	.	G	A	1	2	3	0	0	3	0	0
3	55174832	.	C	A	1	2	3	0	0	3	0	0
3	55175054	.	G	A	3	2	5	0	0	5	0	0
3	55218724	.	C	T	0	4	4	0	1	5	0	0
3	55233840	.	G	T	0	1	1	0	0	1	0	0
3	55256537	.	T	C	1	0	1	0	2	3	0	0
3	55422011	.	G	A	2	3	5	0	0	5	0	0
3	55422831	.	G	A	3	5	8	0	0	8	0	0
3	55422850	.	G	T	5	3	8	0	0	8	0	0
3	55422926	.	C	A	0	4	4	0	5	9	0	0
3	55422980	.	T	C	1	2	3	0	0	3	0	0
3	55423385	.	T	C	4	3	7	0	0	7	0	0
3	55423611	.	G	A	2	3	5	0	0	5	0	0
3	55423861	.	T	C	3	0	3	0	2	5	0	0
3	55438733	.	C	T	3	1	4	0	0	4	0	0
3	56883665	.	T	C	2	0	2	0	4	6	0	0
3	56884802	.	T	C	4	3	7	0	0	7	0	0
3	57462285	.	G	A	1	6	7	0	0	7	0	0
3	57463903	.	G	A	7	1	8	0	2	10	0	0
3	57463907	.	A	G	1	6	7	0	3	10	0	0
3	58154464	.	A	G	5	3	8	0	0	8	0	0
3	58211317	.	T	C	0	1	1	0	0	1	0	0
3	58608380	.	G	A	1	1	2	0	0	2	0	0
3	58615428	.	T	G	2	3	5	0	0	5	0	0
3	58615543	.	G	C	4	5	9	0	0	9	0	0
3	59868371	.	A	G	2	0	2	0	0	2	0	0
3	59868391	.	T	C	4	0	4	0	0	4	0	0
3	59868427	.	G	A	0	4	4	0	0	4	0	0
3	59870578	.	C	T	4	4	8	0	0	8	0	0
3	59876195	.	C	T	17	9	26	0	1	27	0	0
3	59876233	.	T	C	17	2	19	0	1	20	0	0
3	59876405	.	C	A	8	9	17	0	1	18	0	0
3	59876772	.	G	A	1	4	5	0	1	6	0	0
3	59880349	.	C	T	18	11	29	0	2	31	0	0
3	59880544	.	C	T	8	10	18	0	1	19	0	0
3	59883465	.	T	A	14	3	17	0	0	17	0	0
3	59883489	.	C	A	11	7	18	0	0	18	0	0
3	59887325	.	G	A	0	0	0	0	2	2	0	0
3	59887331	.	A	G	2	0	2	0	0	2	0	0
3	59889663	.	C	A	25	17	42	0	1	43	0	0
3	59941534	.	C	T	2	4	6	0	0	6	0	0
3	59941542	.	C	T	4	2	6	0	0	6	0	0
3	59941572	.	C	T	2	1	3	0	0	3	0	0
3	59942142	.	G	A	1	1	2	0	0	2	0	0
3	59945851	.	T	C	15	27	42	0	3	45	0	0
3	59945922	.	C	G	2	2	4	0	16	20	0	0
3	59946094	.	A	T	2	11	13	0	1	14	0	0
3	59946432	.	C	T	18	8	26	0	1	27	0	0
3	59946642	.	G	T	2	10	12	0	24	36	0	0
3	59946828	.	T	C	19	8	27	0	1	28	0	0
3	59946877	.	C	T	8	11	19	0	0	19	0	0
3	59946901	.	C	T	13	11	24	0	0	24	0	0
3	59947092	.	A	T	13	5	18	0	3	21	0	0
3	59951426	.	C	A	9	9	18	0	2	20	0	0
3	59951767	.	T	C	16	0	16	0	12	28	0	0
3	59951800	.	G	A	17	12	29	0	3	32	0	0
3	59952046	.	T	C	13	1	14	0	18	32	0	0
3	59952268	.	C	G	13	9	22	0	0	22	0	0
3	59952400	.	C	A	0	1	1	0	0	1	0	0
3	59961399	.	G	A	6	5	11	0	0	11	0	0
3	59995019	.	T	G	5	11	16	0	0	16	0	0
3	59995028	.	C	T	5	11	16	0	0	16	0	0
3	59995122	.	G	T	2	3	5	0	0	5	0	0
3	59997180	.	C	T	0	3	3	0	3	6	0	0
3	60002951	.	T	C	1	7	8	0	0	8	0	0
3	60025650	.	T	C	1	0	1	0	4	5	0	0
3	60055408	.	G	A	3	2	5	0	0	5	0	0
3	60073481	.	A	G	0	1	1	0	0	1	0	0
3	60073484	.	T	A	0	0	0	0	1	1	0	0
3	60074497	.	C	G	1	2	3	0	0	3	0	0
3	60177849	.	G	A	3	2	5	0	0	5	0	0
3	60526316	.	C	T	0	2	2	0	3	5	0	0
3	60526385	.	G	C	2	6	8	0	0	8	0	0
3	60526426	.	A	G	4	6	10	0	0	10	0	0
3	60526504	.	T	A	1	2	3	0	0	3	0	0
3	60526620	.	C	A	3	2	5	0	0	5	0	0
3	60526647	.	A	G	1	2	3	0	0	3	0	0
3	60575823	.	T	A	2	2	4	0	0	4	0	0
3	60575963	.	T	C	1	7	8	0	0	8	0	0
3	60575990	.	T	C	1	2	3	0	0	3	0	0
3	60576371	.	G	A	3	2	5	0	0	5	0	0
3	60576415	.	C	A	5	1	6	0	0	6	0	0
3	60576453	.	G	A	3	2	5	0	0	5	0	0
3	60577319	.	T	C	2	3	5	0	1	6	0	0
3	60578394	.	C	T	0	3	3	0	1	4	0	0
3	60582361	.	A	G	1	1	2	0	0	2	0	0
3	60584162	.	G	A	3	3	6	0	0	6	0	0
3	60589244	.	G	T	0	5	5	0	1	6	0	0
3	60589503	.	G	A	3	3	6	0	0	6	0	0
3	60589725	.	A	G	3	2	5	0	0	5	0	0
3	60594169	.	A	G	2	2	4	0	0	4	0	0
3	60595659	.	G	T	3	1	4	0	0	4	0	0
3	60595708	.	A	T	1	2	3	0	0	3	0	0
3	60595709	.	C	T	1	2	3	0	0	3	0	0
3	60596647	.	A	G	4	3	7	0	0	7	0	0
3	60596808	.	A	C	2	3	5	0	0	5	0	0
3	60601958	.	G	A	3	3	6	0	0	6	0	0
3	60685042	.	G	A	3	2	5	0	0	5	0	0
3	60710969	.	C	T	2	2	4	0	0	4	0	0
3	60732214	.	C	G	3	2	5	0	0	5	0	0
3	60733051	.	G	A	0	2	2	0	2	4	0	0
3	60733056	.	G	A	2	3	5	0	0	5	0	0
3	60789730	.	C	A	2	5	7	0	0	7	0	0
3	60817859	.	C	T	1	2	3	0	0	3	0	0
3	60834600	.	C	T	1	2	3	0	0	3	0	0
3	60839133	.	G	A	0	2	2	0	2	4	0	0
3	60839303	.	C	T	0	2	2	0	0	2	0	0
3	60854011	.	C	T	2	1	3	0	0	3	0	0
3	60855800	.	C	T	4	3	7	0	0	7	0	0
3	60862519	.	G	A	13	15	28	0	1	29	0	0
3	60875101	.	C	T	0	1	1	0	0	1	0	0
3	60875169	.	T	G	2	2	4	0	0	4	0	0
3	60962589	.	T	C	1	1	2	0	0	2	0	0
3	60976921	.	C	T	8	6	14	0	1	15	0	0
3	60976985	.	G	A	0	3	3	0	9	12	0	0
3	60977060	.	A	G	8	0	8	0	10	18	0	0
3	60978344	.	G	A	0	3	3	0	0	3	0	0
3	60982492	.	A	C	10	8	18	0	0	18	0	0
3	60985862	.	C	T	2	2	4	0	0	4	0	0
3	60992134	.	A	G	2	0	2	0	1	3	0	0
3	60994781	.	G	C	8	11	19	0	1	21	1	0
3	60997781	.	C	G	3	2	5	0	0	5	0	0
3	61004295	.	G	A	0	5	5	0	4	9	0	0
3	61004397	.	C	T	7	9	16	0	1	17	0	0
3	61004442	.	G	T	2	10	12	0	1	13	0	0
3	61013397	.	C	T	4	2	6	0	0	6	0	0
3	61026883	.	G	T	12	13	25	0	0	25	0	0
3	61030127	.	G	A	16	10	26	0	1	27	0	0
3	61030220	.	C	T	7	16	23	0	1	24	0	0
3	61030699	.	G	C	9	18	27	0	4	31	0	0
3	61030800	.	G	A	8	8	16	0	4	20	0	0
3	61030829	.	G	A	3	0	3	0	0	3	0	0
3	61033183	.	C	T	23	18	41	0	7	48	0	0
3	61033859	.	C	A	2	4	6	0	9	15	0	0
3	61033979	.	C	A	14	9	23	0	1	24	0	0
3	61034060	.	T	G	29	0	29	0	27	56	0	0
3	61034096	.	T	C	19	24	43	0	4	47	0	0
3	61043871	.	G	A	4	5	9	0	2	11	0	0
3	61043925	.	G	T	5	6	11	0	0	11	0	0
3	61078757	.	G	A	2	2	4	0	0	4	0	0
3	61079390	.	A	G	0	2	2	0	0	2	0	0
3	61098695	.	C	T	2	2	4	0	0	4	0	0
3	61108600	.	G	T	11	8	19	0	3	22	0	0
3	61108732	.	A	G	16	17	33	0	1	34	0	0
3	61108734	.	T	C	16	1	17	0	17	34	0	0
3	61108830	.	C	A	0	16	16	0	14	30	0	0
3	61111826	.	G	T	7	4	11	0	2	13	0	0
3	61116160	.	C	T	4	9	13	0	0	13	0	0
3	61264122	.	G	A	1	4	5	0	0	5	0	0
3	61277028	.	C	G	2	1	3	0	0	3	0	0
3	61278584	.	C	T	3	5	8	0	1	9	0	0
3	61278866	.	C	T	2	3	5	0	0	5	0	0
3	61279124	.	T	C	4	5	9	0	1	10	0	0
3	61279427	.	A	C	3	5	8	0	0	8	0	0
3	61279585	.	G	A	0	3	3	0	7	10	0	0
3	61279588	.	T	A	2	7	9	0	1	10	0	0
3	61279643	.	T	C	8	10	18	0	0	18	0	0
3	61279781	.	C	T	4	2	6	0	0	6	0	0
3	61280198	.	G	T	4	6	10	0	0	10	0	0
3	61280495	.	T	C	11	7	18	0	1	19	0	0
3	61280579	.	T	G	7	0	7	0	10	17	0	0
3	61280717	.	A	G	5	0	5	0	11	16	0	0
3	61285784	.	C	T	8	8	16	0	0	16	0	0
3	61285947	.	A	G	1	0	1	0	6	7	0	0
3	61286007	.	T	G	6	3	9	0	1	10	0	0
3	61286325	.	C	G	6	0	6	0	7	13	0	0
3	61286468	.	C	T	4	5	9	0	2	11	0	0
3	61286528	.	A	T	0	8	8	0	0	8	0	0
3	61286564	.	T	C	0	11	11	0	2	13	0	0
3	61286576	.	C	T	8	8	16	0	0	16	0	0
3	61286889	.	T	C	7	14	21	0	4	25	0	0
3	61286998	.	G	A	0	15	15	0	9	24	0	0
3	61287010	.	A	G	11	13	24	0	0	24	0	0
3	61287094	.	A	G	3	0	3	0	8	11	0	0
3	61287214	.	A	T	8	13	21	0	1	22	0	0
3	61287260	.	G	T	9	10	19	0	0	19	0	0
3	61287289	.	C	T	11	6	17	0	0	17	0	0
3	61287343	.	G	T	10	14	24	0	0	24	0	0
3	61287491	.	T	A	10	13	23	0	0	23	0	0
3	61287627	.	C	G	14	13	27	0	0	27	0	0
3	61287893	.	T	G	11	0	11	0	18	29	0	0
3	61288028	.	T	C	11	12	23	0	2	25	0	0
3	61288238	.	A	C	9	14	23	0	0	23	0	0
3	61292963	.	C	A	6	3	9	0	0	9	0	0
3	61342032	.	C	T	0	3	3	0	1	4	0	0
3	61342341	.	G	T	4	3	7	0	0	7	0	0
3	61342770	.	G	A	4	8	12	0	3	15	0	0
3	61343014	.	T	A	8	5	13	0	0	13	0	0
3	61343019	.	T	A	7	5	12	0	0	12	0	0
3	61343076	.	C	T	0	4	4	0	3	7	0	0
3	61343589	.	T	C	3	2	5	0	0	5	0	0
3	61349602	.	G	A	3	4	7	0	1	8	0	0
3	61349654	.	C	T	3	7	10	0	1	11	0	0
3	61349820	.	A	G	5	3	8	0	0	8	0	0
3	61349887	.	A	T	4	2	6	0	0	6	0	0
3	61350120	.	C	T	2	2	4	0	0	4	0	0
3	61350667	.	C	T	1	6	7	0	0	7	0	0
3	61351109	.	C	T	1	2	3	0	0	3	0	0
3	61351135	.	T	C	1	0	1	0	2	3	0	0
3	61351294	.	A	G	3	3	6	0	0	6	0	0
3	61351458	.	C	G	0	3	3	0	0	3	0	0
3	61351465	.	C	T	0	3	3	0	0	3	0	0
3	61354125	.	T	A	1	1	2	0	0	2	0	0
3	61358195	.	T	C	5	3	8	0	1	9	0	0
3	61358196	.	T	C	4	4	8	0	1	9	0	0
3	61358265	.	C	T	2	4	6	0	0	6	0	0
3	61358269	.	G	A	4	2	6	0	0	6	0	0
3	61358547	.	C	T	2	3	5	0	0	5	0	0
3	61358570	.	G	A	3	4	7	0	0	7	0	0
3	61359266	.	G	T	0	1	1	0	2	3	0	0
3	61359807	.	A	C	0	2	2	0	1	3	0	0
3	61360127	.	C	T	1	3	4	0	0	4	0	0
3	61365788	.	G	A	3	3	6	0	0	6	0	0
3	61367471	.	G	T	1	2	3	0	0	3	0	0
3	61372060	.	T	G	3	0	3	0	0	3	0	0
3	61372070	.	C	A	0	2	2	0	0	2	0	0
3	61372138	.	G	A	0	2	2	0	0	2	0	0
3	61372259	.	G	A	1	3	4	0	0	4	0	0
3	61372724	.	A	G	1	3	4	0	0	4	0	0
3	61375539	.	A	T	1	3	4	0	0	4	0	0
3	61375586	.	G	A	2	3	5	0	0	5	0	0
3	61383062	.	A	T	0	2	2	0	1	3	0	0
3	61383072	.	C	T	0	4	4	0	0	4	0	0
3	61383492	.	T	C	1	0	1	0	2	3	0	0
3	61383656	.	A	T	2	3	5	0	0	5	0	0
3	61391687	.	T	C	3	5	8	0	2	10	0	0
3	61391797	.	G	A	0	8	8	0	7	15	0	0
3	61392048	.	A	G	3	0	3	0	2	5	0	0
3	61396523	.	C	T	3	4	7	0	0	7	0	0
3	61397093	.	C	T	9	3	12	0	0	12	0	0
3	61397231	.	C	A	5	5	10	0	1	11	0	0
3	61397294	.	C	T	7	5	12	0	0	12	0	0
3	61398728	.	A	G	9	7	16	0	1	17	0	0
3	61398809	.	T	C	10	8	18	0	0	18	0	0
3	61542889	.	C	A	2	3	5	0	0	5	0	0
3	61542910	.	C	T	3	3	6	0	0	6	0	0
3	61542973	.	T	C	2	4	6	0	0	6	0	0
3	61543130	.	G	A	1	2	3	0	0	3	0	0
3	61566380	.	T	C	2	0	2	0	3	5	0	0
3	61566559	.	G	A	3	1	4	0	0	4	0	0
3	62034943	.	G	A	3	2	5	0	0	5	0	0
3	62035030	.	G	A	0	4	4	0	4	8	0	0
3	62036320	.	A	G	2	2	4	0	0	4	0	0
3	62036323	.	A	G	3	2	5	0	0	5	0	0
3	62036426	.	G	A	1	2	3	0	0	3	0	0
3	62037105	.	T	C	4	8	12	0	4	16	0	0
3	62037343	.	G	C	3	5	8	0	0	8	0	0
3	62037430	.	A	G	7	0	7	0	5	12	0	0
3	62038739	.	G	C	14	5	19	0	0	19	0	0
3	62038993	.	G	A	1	15	16	0	10	26	0	0
3	62039278	.	A	G	10	0	10	0	11	21	0	0
3	62039657	.	G	A	0	6	6	0	7	14	1	0
3	62039689	.	C	A	5	10	15	0	0	15	0	0
3	62039718	.	G	A	5	6	11	0	1	12	0	0
3	62039813	.	T	A	12	9	21	0	1	22	0	0
3	62040555	.	G	A	3	5	8	0	1	9	0	0
3	62051107	.	C	T	14	5	19	0	1	20	0	0
3	62051125	.	C	T	10	4	14	0	0	14	0	0
3	62051395	.	A	G	0	5	5	0	1	6	0	0
3	62051660	.	T	A	7	4	11	0	2	13	0	0
3	62069739	.	G	T	1	0	1	0	0	1	0	0
3	62069815	.	G	A	5	3	8	0	1	9	0	0
3	62069821	.	G	A	4	4	8	0	0	8	0	0
3	62070890	.	G	A	2	2	4	0	0	4	0	0
3	62073967	.	T	A	0	1	1	0	0	1	0	0
3	62074030	.	T	C	7	3	10	0	0	10	0	0
3	62080117	.	G	C	10	2	12	0	0	12	0	0
3	62080172	.	G	A	2	10	12	0	1	13	0	0
3	62091398	.	A	G	2	3	5	0	1	6	0	0
3	62091632	.	T	A	11	10	21	0	2	23	0	0
3	62091660	.	T	A	10	9	19	0	1	20	0	0
3	62091880	.	C	T	10	13	23	0	2	25	0	0
3	62091975	.	C	A	18	12	30	0	0	30	0	0
3	62091995	.	G	T	17	8	25	0	1	26	0	0
3	62092025	.	C	T	0	9	9	0	14	23	0	0
3	62092262	.	T	A	7	6	13	0	1	14	0	0
3	62092279	.	A	T	8	5	13	0	0	13	0	0
3	62092666	.	G	A	12	8	20	0	1	21	0	0
3	62092715	.	A	C	5	14	19	0	1	20	0	0
3	62092749	.	G	C	8	11	19	0	0	19	0	0
3	62092801	.	C	T	5	9	14	0	1	15	0	0
3	62092902	.	A	T	8	3	11	0	0	11	0	0
3	62093241	.	T	A	6	11	17	0	0	18	1	0
3	62094327	.	C	T	5	3	8	0	1	9	0	0
3	62094645	.	A	G	1	5	6	0	1	7	0	0
3	62095051	.	G	A	2	7	9	0	0	9	0	0
3	62095644	.	G	C	4	2	6	0	1	7	0	0
3	62095646	.	T	A	5	2	7	0	0	7	0	0
3	62095734	.	G	A	3	2	5	0	0	5	0	0
3	62095827	.	G	C	1	3	4	0	1	5	0	0
3	62095887	.	T	C	1	0	1	0	4	5	0	0
3	62095940	.	G	C	2	2	4	0	1	5	0	0
3	62095980	.	A	C	3	3	6	0	0	6	0	0
3	62096288	.	A	T	1	2	3	0	0	3	0	0
3	62097272	.	T	C	3	2	5	0	0	5	0	0
3	62097300	.	A	T	2	3	5	0	0	5	0	0
3	62097490	.	A	T	4	6	10	0	0	10	0	0
3	62097548	.	A	T	0	4	4	0	0	4	0	0
3	62114663	.	C	T	0	2	2	0	0	2	0	0
3	62117187	.	C	T	7	2	9	0	1	10	0	0
3	62126992	.	T	A	2	1	3	0	0	3	0	0
3	62149774	.	C	T	0	1	1	0	0	1	0	0
3	62167559	.	G	A	0	2	2	0	4	6	0	0
3	62173503	.	G	T	10	7	17	0	1	18	0	0
3	62173546	.	C	T	5	8	13	0	0	13	0	0
3	62173593	.	T	C	3	4	7	0	0	7	0	0
3	62173628	.	T	C	3	2	5	0	0	5	0	0
3	62188877	.	A	G	2	1	3	0	0	3	0	0
3	62188883	.	G	A	1	1	2	0	1	3	0	0
3	62203509	.	G	A	2	5	7	0	0	7	0	0
3	62203702	.	G	C	2	3	5	0	0	5	0	0
3	62209024	.	A	G	2	3	5	0	0	5	0	0
3	62209033	.	A	G	1	3	4	0	0	4	0	0
3	62209325	.	A	G	1	6	7	0	0	7	0	0
3	62238692	.	G	A	2	4	6	0	0	6	0	0
3	62238721	.	C	T	3	4	7	0	1	8	0	0
3	62275507	.	T	A	5	2	7	0	0	7	0	0
3	62275598	.	G	A	2	5	7	0	0	7	0	0
3	62276009	.	A	T	3	3	6	0	0	6	0	0
3	62276101	.	G	A	2	6	8	0	0	8	0	0
3	62276104	.	A	G	2	6	8	0	0	8	0	0
3	62323384	.	G	A	6	2	8	0	0	8	0	0
3	62323510	.	C	G	3	5	8	0	0	8	0	0
3	62323564	.	C	T	3	4	7	0	1	8	0	0
3	62324118	.	G	A	2	6	8	0	0	8	0	0
3	62324421	.	G	C	3	2	5	0	0	5	0	0
3	62324427	.	T	C	2	2	4	0	0	4	0	0
3	62328846	.	G	C	0	1	1	0	0	1	0	0
3	62328970	.	A	G	3	3	6	0	0	6	0	0
3	62329097	.	G	C	3	4	7	0	0	7	0	0
3	62329545	.	G	T	3	4	7	0	0	7	0	0
3	62345588	.	T	A	4	3	7	0	1	8	0	0
3	62345686	.	T	A	2	1	3	0	0	3	0	0
3	62345708	.	G	A	1	3	4	0	0	4	0	0
3	62345770	.	A	T	3	5	8	0	1	9	0	0
3	62359440	.	G	T	2	2	4	0	1	5	0	0
3	62360484	.	C	T	7	5	12	0	0	12	0	0
3	62360736	.	C	A	2	4	6	0	0	6	0	0
3	62369864	.	G	A	14	12	26	0	1	27	0	0
3	62370068	.	A	G	8	10	18	0	0	18	0	0
3	62370381	.	A	G	4	13	17	0	1	18	0	0
3	62370476	.	G	A	5	8	13	0	0	13	0	0
3	62379739	.	C	T	10	4	14	0	0	14	0	0
3	62379797	.	A	T	1	1	2	0	0	2	0	0
3	62382863	.	A	G	40	21	61	0	5	66	0	0
3	62383314	.	T	G	42	6	48	1	1	50	0	0
3	62383315	.	G	T	42	6	48	1	1	50	0	0
3	62383438	.	G	A	26	31	57	0	0	57	0	0
3	62383439	.	A	G	26	28	54	0	3	57	0	0
3	62383565	.	T	A	17	25	42	0	3	45	0	0
3	62383589	.	A	C	14	25	39	0	0	39	0	0
3	62383610	.	G	C	11	1	12	0	24	36	0	0
3	62383706	.	C	T	25	23	48	0	2	50	0	0
3	62383992	.	C	G	4	8	12	0	0	12	0	0
3	62384055	.	G	A	12	8	20	1	1	22	0	0
3	62384112	.	T	A	5	7	12	1	0	13	0	0
3	62384208	.	C	T	1	38	39	0	15	54	0	0
3	62384219	.	G	A	41	8	49	0	4	53	0	0
3	62384423	.	C	G	18	41	59	0	3	62	0	0
3	62384428	.	T	A	40	16	56	0	6	62	0	0
3	62384565	.	C	G	20	24	44	0	3	47	0	0
3	62386420	.	T	C	23	2	25	0	20	45	0	0
3	62386955	.	G	T	4	2	6	0	0	6	0	0
3	62387141	.	C	T	0	10	10	0	12	22	0	0
3	62387144	.	C	T	9	10	19	0	3	22	0	0
3	62390349	.	A	G	1	2	3	0	0	3	0	0
3	62393337	.	C	T	17	7	24	0	1	25	0	0
3	62398790	.	G	A	1	2	3	0	0	3	0	0
3	62398836	.	G	C	1	3	4	0	0	4	0	0
3	62433064	.	C	T	10	6	16	0	0	16	0	0
3	62433138	.	T	G	0	1	1	0	0	1	0	0
3	62521137	.	G	A	5	5	10	0	0	10	0	0
3	62521142	.	T	C	5	0	5	0	4	9	0	0
3	62521263	.	T	A	11	8	19	0	3	22	0	0
3	62521956	.	G	A	7	12	19	0	0	19	0	0
3	62522063	.	A	T	13	8	21	0	0	21	0	0
3	62522065	.	G	T	13	8	21	0	0	21	0	0
3	62522238	.	A	G	5	8	13	0	1	14	0	0
3	62522564	.	T	A	4	6	10	0	1	11	0	0
3	62522742	.	C	A	4	2	6	0	0	6	0	0
3	62522750	.	G	C	2	5	7	0	0	7	0	0
3	62522804	.	C	T	0	4	4	0	5	9	0	0
3	62522808	.	C	T	0	5	5	0	4	9	0	0
3	62522899	.	C	G	9	10	19	0	1	20	0	0
3	62523031	.	A	G	0	11	11	0	2	13	0	0
3	62523032	.	A	T	12	0	12	0	1	13	0	0
3	62523325	.	G	T	7	9	16	0	0	16	0	0
3	62523502	.	G	A	3	3	6	0	0	6	0	0
3	62523520	.	A	G	0	5	5	0	0	5	0	0
3	62523550	.	C	T	1	5	6	0	0	6	0	0
3	62527397	.	G	T	3	4	7	0	3	10	0	0
4	308804	.	T	A	5	2	7	0	1	8	0	0
4	317091	.	A	G	9	23	32	0	1	33	0	0
4	317275	.	G	T	9	9	18	0	2	20	0	0
4	317658	.	C	T	3	2	5	0	0	5	0	0
4	325073	.	C	T	1	2	3	0	0	3	0	0
4	325126	.	G	A	6	6	12	0	0	12	0	0
4	325136	.	G	A	8	8	16	0	0	16	0	0
4	325161	.	A	C	8	0	8	0	11	20	1	0
4	348201	.	G	A	0	1	1	0	2	3	0	0
4	348216	.	C	T	2	2	4	0	0	4	0	0
4	348297	.	T	C	1	3	4	0	0	4	0	0
4	349298	.	T	C	1	2	3	0	0	3	0	0
4	349304	.	A	G	1	2	3	0	0	3	0	0
4	349490	.	A	C	3	4	7	0	0	7	0	0
4	349514	.	T	C	2	3	5	0	1	6	0	0
4	349886	.	T	C	1	0	1	0	0	1	0	0
4	350652	.	C	T	2	4	6	0	0	6	0	0
4	351840	.	G	C	3	2	5	0	2	7	0	0
4	351845	.	A	C	3	4	7	0	0	7	0	0
4	352031	.	C	G	1	6	7	0	0	7	0	0
4	352284	.	A	G	9	0	9	0	4	13	0	0
4	352289	.	T	C	9	4	13	0	1	14	0	0
4	352504	.	T	C	7	13	20	0	0	20	0	0
4	353049	.	A	T	7	2	9	0	0	9	0	0
4	353064	.	C	G	7	2	9	0	0	9	0	0
4	353238	.	T	G	2	0	2	0	7	9	0	0
4	353247	.	T	C	3	5	8	0	0	8	0	0
4	353379	.	A	T	9	7	16	0	1	17	0	0
4	353481	.	A	G	3	0	3	0	5	8	0	0
4	353638	.	C	T	3	2	5	0	0	5	0	0
4	353778	.	T	A	2	3	5	0	0	5	0	0
4	357887	.	T	G	4	4	8	0	0	8	0	0
4	357954	.	G	A	5	2	7	0	0	7	0	0
4	362282	.	C	T	1	1	2	0	0	2	0	0
4	385092	.	C	T	14	12	26	0	5	31	0	0
4	385576	.	T	A	2	3	5	0	0	5	0	0
4	385625	.	A	T	3	3	6	0	1	7	0	0
4	385668	.	G	A	6	6	12	0	0	12	0	0
4	385710	.	T	C	11	12	23	0	2	25	0	0
4	386014	.	A	C	19	9	28	0	1	29	0	0
4	386037	.	T	G	17	10	27	0	0	27	0	0
4	386085	.	G	A	10	7	17	0	0	17	0	0
4	386124	.	C	A	1	3	4	0	6	10	0	0
4	386537	.	T	A	13	18	31	0	2	33	0	0
4	386538	.	T	A	17	17	34	0	2	36	0	0
4	386839	.	A	G	25	1	26	0	6	32	0	0
4	386950	.	T	C	31	7	38	0	5	43	0	0
4	394020	.	T	C	19	13	32	0	3	35	0	0
4	397913	.	A	G	4	4	8	0	4	12	0	0
4	659276	.	C	T	7	8	15	0	0	15	0	0
4	659345	.	T	C	1	1	2	0	0	2	0	0
4	660571	.	G	A	1	8	9	0	0	9	0	0
4	660649	.	T	A	7	8	15	0	0	15	0	0
4	660655	.	G	A	0	9	9	0	6	15	0	0
4	660715	.	T	C	4	7	11	0	2	13	0	0
4	667358	.	T	C	5	7	12	0	0	12	0	0
4	667382	.	A	G	9	0	9	0	9	18	0	0
4	674838	.	T	C	9	6	15	0	0	15	0	0
4	675080	.	T	C	7	3	10	0	2	12	0	0
4	676885	.	A	G	8	7	15	0	1	16	0	0
4	676942	.	A	G	1	1	2	0	0	2	0	0
4	678853	.	C	T	3	5	8	0	0	8	0	0
4	679441	.	C	G	0	7	7	0	10	17	0	0
4	680314	.	G	T	8	9	17	0	0	17	0	0
4	680320	.	C	T	9	10	19	0	0	19	0	0
4	680359	.	C	T	8	4	12	0	0	12	0	0
4	680395	.	T	C	3	0	3	0	0	3	0	0
4	680404	.	G	A	1	0	1	0	0	1	0	0
4	686987	.	G	A	0	4	4	0	3	7	0	0
4	686999	.	C	G	3	7	10	0	0	10	0	0
4	694373	.	C	T	3	5	8	0	2	10	0	0
4	694680	.	A	C	5	4	9	0	0	9	0	0
4	694718	.	G	A	3	3	6	0	0	6	0	0
4	694741	.	T	G	0	1	1	0	1	2	0	0
4	695219	.	T	C	1	3	4	0	0	4	0	0
4	700281	.	A	C	7	4	11	0	1	12	0	0
4	700284	.	G	T	0	3	3	0	9	12	0	0
4	700598	.	A	T	2	4	6	0	1	7	0	0
4	700606	.	T	C	3	4	7	0	0	7	0	0
4	700634	.	A	C	1	3	4	0	0	4	0	0
4	701802	.	T	G	1	4	5	0	0	5	0	0
4	710577	.	T	G	0	1	1	0	0	1	0	0
4	736442	.	A	G	1	4	5	0	1	6	0	0
4	737636	.	A	T	6	5	11	0	0	11	0	0
4	737811	.	A	G	10	3	13	0	0	13	0	0
4	737883	.	T	A	3	2	5	0	1	6	0	0
4	740435	.	A	T	2	0	2	0	0	2	0	0
4	740921	.	T	C	6	3	9	0	0	9	0	0
4	740965	.	T	G	6	4	10	0	0	10	0	0
4	749803	.	G	A	14	9	23	0	1	24	0	0
4	749989	.	G	T	12	6	18	0	0	18	0	0
4	750016	.	T	C	4	0	4	0	2	6	0	0
4	750526	.	C	G	3	1	4	0	0	4	0	0
4	750531	.	C	T	3	2	5	0	0	5	0	0
4	750661	.	C	T	0	2	2	0	3	5	0	0
4	751275	.	A	G	2	3	5	0	0	5	0	0
4	751546	.	G	A	7	7	14	0	0	14	0	0
4	751553	.	C	T	6	6	12	0	0	12	0	0
4	751640	.	T	G	8	7	15	0	1	16	0	0
4	753723	.	T	C	2	0	2	0	6	8	0	0
4	755539	.	C	T	3	4	7	0	0	7	0	0
4	765112	.	A	G	5	9	14	0	0	14	0	0
4	766575	.	G	A	6	8	14	0	0	14	0	0
4	766588	.	G	A	5	9	14	0	0	14	0	0
4	766613	.	A	C	5	2	7	0	1	8	0	0
4	769533	.	A	T	0	2	2	0	0	2	0	0
4	772363	.	C	T	5	6	11	0	0	11	0	0
4	777976	.	A	G	1	4	5	0	1	6	0	0
4	778111	.	G	A	3	2	5	0	0	5	0	0
4	779310	.	G	A	1	1	2	0	0	2	0	0
4	779363	.	T	C	8	0	8	0	6	14	0	0
4	779429	.	A	G	7	3	10	0	1	11	0	0
4	779442	.	G	A	7	4	11	0	1	12	0	0
4	783816	.	G	T	24	19	43	0	0	43	0	0
4	783835	.	A	G	21	21	42	0	0	42	0	0
4	784002	.	T	A	31	15	46	1	2	49	0	0
4	784177	.	T	C	20	26	46	0	3	49	0	0
4	784325	.	A	T	8	11	19	0	0	19	0	0
4	784373	.	T	A	3	10	13	0	1	14	0	0
4	784435	.	G	T	3	2	5	0	0	5	0	0
4	784543	.	A	C	1	2	3	0	1	4	0	0
4	784558	.	G	A	4	2	6	0	0	6	0	0
4	784733	.	T	A	7	3	10	0	0	10	0	0
4	784854	.	C	A	10	5	15	0	0	15	0	0
4	784990	.	T	A	10	19	29	0	5	34	0	0
4	785011	.	T	C	9	9	18	0	8	26	0	0
4	785132	.	G	A	25	25	50	0	0	50	0	0
4	788970	.	G	C	7	1	8	0	12	20	0	0
4	789589	.	A	G	10	6	16	0	1	17	0	0
4	798743	.	G	C	3	4	7	0	1	8	0	0
4	798804	.	G	A	10	12	22	0	1	23	0	0
4	798850	.	A	C	14	11	25	0	1	26	0	0
4	798861	.	G	T	17	8	25	0	3	28	0	0
4	799006	.	G	T	22	14	36	0	2	38	0	0
4	799090	.	T	C	13	12	25	0	1	26	0	0
4	799127	.	T	G	12	9	21	0	1	22	0	0
4	799245	.	G	A	11	11	22	0	3	25	0	0
4	799385	.	C	G	8	5	13	0	0	13	0	0
4	799475	.	A	G	14	9	23	0	2	25	0	0
4	799513	.	G	A	21	14	35	0	0	35	0	0
4	799620	.	C	T	29	10	39	0	1	40	0	0
4	799643	.	T	A	29	11	40	0	2	42	0	0
4	799933	.	C	T	23	16	39	0	1	40	0	0
4	800027	.	C	T	16	11	27	0	0	27	0	0
4	800094	.	A	G	21	8	29	0	1	30	0	0
4	800113	.	A	G	21	11	32	0	0	32	0	0
4	800363	.	C	T	0	15	15	0	19	34	0	0
4	800520	.	T	C	7	12	19	0	0	19	0	0
4	802909	.	T	A	12	7	19	0	0	19	0	0
4	803862	.	T	C	3	0	3	0	6	9	0	0
4	806319	.	G	A	6	4	10	0	0	10	0	0
4	806322	.	T	C	6	4	10	0	0	10	0	0
4	807895	.	C	G	3	4	7	0	2	9	0	0
4	807898	.	A	G	4	6	10	0	0	10	0	0
4	808031	.	C	T	0	1	1	0	0	1	0	0
4	809456	.	A	G	6	14	20	0	2	22	0	0
4	809512	.	T	C	12	0	12	0	14	26	0	0
4	809549	.	A	G	8	6	14	0	0	14	0	0
4	813157	.	G	A	4	4	8	0	0	8	0	0
4	813226	.	A	G	10	9	19	0	1	20	0	0
4	823866	.	T	G	0	2	2	0	0	2	0	0
4	861804	.	A	G	5	2	7	0	0	7	0	0
4	861856	.	T	A	1	3	4	0	0	4	0	0
4	862009	.	A	G	1	3	4	0	0	4	0	0
4	864712	.	C	T	8	3	11	0	0	11	0	0
4	873763	.	C	G	3	2	5	0	0	5	0	0
4	880033	.	A	G	4	3	7	0	0	7	0	0
4	880201	.	A	C	2	2	4	0	1	5	0	0
4	881980	.	T	A	2	5	7	0	1	8	0	0
4	881997	.	A	C	2	4	6	0	0	6	0	0
4	882856	.	T	C	3	0	3	0	0	3	0	0
4	882862	.	C	T	1	0	1	0	1	2	0	0
4	905612	.	G	A	4	3	7	0	1	8	0	0
4	905657	.	A	G	4	4	8	0	0	8	0	0
4	958978	.	A	T	4	3	7	0	0	7	0	0
4	959015	.	T	C	2	4	6	0	0	6	0	0
4	961542	.	G	A	1	4	5	0	1	6	0	0
4	963452	.	A	G	1	0	1	0	0	1	0	0
4	967974	.	C	T	3	4	7	0	0	7	0	0
4	968001	.	G	A	0	8	8	0	4	13	1	0
4	968121	.	T	C	0	1	1	0	0	1	0	0
4	970689	.	A	G	3	0	3	0	4	7	0	0
4	974482	.	C	T	6	15	21	0	0	21	0	0
4	975735	.	G	C	0	1	1	0	2	3	0	0
4	975758	.	C	T	3	4	7	0	1	8	0	0
4	975792	.	G	C	1	7	8	0	4	12	0	0
4	975938	.	T	C	1	0	1	0	0	1	0	0
4	982892	.	G	A	1	3	4	0	0	4	0	0
4	982893	.	T	C	3	1	4	0	0	4	0	0
4	982938	.	C	G	4	2	6	0	0	6	0	0
4	986350	.	C	A	0	4	4	0	3	7	0	0
4	1054775	.	G	A	15	15	30	0	2	32	0	0
4	1054866	.	G	T	32	1	33	0	1	34	0	0
4	1054868	.	G	A	32	1	33	0	1	34	0	0
4	1055081	.	C	T	23	12	35	0	3	38	0	0
4	1055095	.	T	A	25	13	38	0	0	38	0	0
4	1055149	.	A	G	11	14	25	0	1	26	0	0
4	1055200	.	A	G	12	9	21	0	0	21	0	0
4	1055454	.	T	G	29	27	56	0	4	60	0	0
4	1055526	.	T	C	16	23	39	0	2	41	0	0
4	1055671	.	G	A	20	23	43	0	1	44	0	0
4	1055724	.	C	T	23	20	43	0	1	44	0	0
4	1055770	.	A	G	26	13	39	0	1	40	0	0
4	1055807	.	G	C	17	16	33	0	3	36	0	0
4	1055831	.	T	A	18	11	29	0	0	29	0	0
4	1055863	.	A	T	18	11	29	0	1	30	0	0
4	1055868	.	G	A	21	8	29	0	3	32	0	0
4	1302556	.	T	A	5	3	8	0	0	8	0	0
4	1303044	.	C	T	1	4	5	0	0	5	0	0
4	1389028	.	A	G	2	4	6	0	0	6	0	0
4	1392957	.	G	A	11	7	18	0	0	18	0	0
4	1393004	.	T	A	5	3	8	0	1	9	0	0
4	1470689	.	T	C	1	0	1	0	3	4	0	0
4	1652192	.	C	T	0	0	0	0	4	4	0	0
4	1988643	.	C	T	2	2	4	0	0	4	0	0
4	1988645	.	A	C	2	2	4	0	0	4	0	0
4	1988778	.	T	A	1	4	5	0	1	6	0	0
4	1988983	.	C	A	1	4	5	0	0	5	0	0
4	1988988	.	A	C	1	0	1	0	2	3	0	0
4	2014198	.	T	C	0	1	1	0	0	1	0	0
4	2044222	.	T	C	4	0	4	0	11	15	0	0
4	2044359	.	A	C	12	19	31	0	0	31	0	0
4	2044379	.	T	A	12	24	36	0	0	36	0	0
4	2044409	.	A	G	27	15	42	0	0	42	0	0
4	2044432	.	G	T	25	8	33	0	1	34	0	0
4	2044541	.	T	C	15	0	15	0	24	39	0	0
4	2044721	.	A	C	4	4	8	0	0	8	0	0
4	2044904	.	T	G	3	3	6	0	1	7	0	0
4	2045000	.	T	A	7	5	12	0	1	13	0	0
4	2045008	.	T	A	6	3	9	0	0	9	0	0
4	2051355	.	G	A	3	5	8	0	0	8	0	0
4	2051372	.	T	C	3	4	7	0	0	7	0	0
4	2051929	.	T	G	18	11	29	0	1	30	0	0
4	2055019	.	G	A	13	13	26	0	2	28	0	0
4	2055067	.	C	A	2	5	7	0	3	10	0	0
4	2055103	.	G	T	2	3	5	0	0	5	0	0
4	2055265	.	G	A	16	10	26	0	5	31	0	0
4	2056028	.	G	A	16	17	33	0	1	34	0	0
4	2056055	.	A	C	17	0	17	0	14	31	0	0
4	2056607	.	G	A	16	6	22	0	0	22	0	0
4	2061217	.	G	A	6	1	7	0	0	7	0	0
4	2062088	.	G	A	7	6	13	0	0	13	0	0
4	2062133	.	G	A	11	8	19	0	0	19	0	0
4	2062187	.	C	T	10	4	14	0	0	14	0	0
4	2151664	.	T	A	8	8	16	0	1	17	0	0
4	2162639	.	G	A	0	3	3	0	0	3	0	0
4	2162664	.	T	G	3	4	7	0	1	8	0	0
4	2163521	.	A	G	3	2	5	0	0	5	0	0
4	2210437	.	T	G	6	10	16	0	1	17	0	0
4	2210459	.	C	T	7	10	17	0	0	17	0	0
4	2210499	.	T	C	9	0	9	0	6	15	0	0
4	2210517	.	C	T	12	7	19	0	0	19	0	0
4	2210553	.	A	G	9	6	15	0	0	15	0	0
4	2210583	.	A	G	2	3	5	0	0	5	0	0
4	2259067	.	G	A	4	4	8	0	0	8	0	0
4	2259071	.	T	C	5	0	5	0	4	9	0	0
4	2361733	.	G	A	3	4	7	0	0	7	0	0
4	2361835	.	T	C	1	0	1	0	8	9	0	0
4	2362945	.	C	A	0	12	12	0	15	27	0	0
4	2368016	.	A	G	9	6	15	0	0	15	0	0
4	2497044	.	T	C	3	0	3	0	1	4	0	0
4	2506611	.	C	T	3	5	8	0	0	8	0	0
4	2508427	.	A	C	14	6	20	0	1	21	0	0
4	2511830	.	C	T	21	11	32	1	1	34	0	0
4	2511921	.	T	C	19	18	37	0	2	39	0	0
4	2511991	.	A	T	11	14	25	1	3	29	0	0
4	2514580	.	G	A	3	2	5	0	0	5	0	0
4	2514596	.	C	A	3	2	5	0	0	5	0	0
4	2532009	.	G	C	1	3	4	0	0	4	0	0
4	2548836	.	C	T	1	2	3	0	1	4	0	0
4	2548838	.	T	C	1	3	4	0	0	4	0	0
4	2549060	.	G	A	7	3	10	0	1	11	0	0
4	2550932	.	T	C	2	2	4	0	0	4	0	0
4	2550934	.	C	T	0	2	2	0	2	4	0	0
4	2556364	.	A	C	1	0	1	0	1	2	0	0
4	2559498	.	A	G	1	1	2	0	0	2	0	0
4	2571695	.	T	A	1	2	3	0	0	3	0	0
4	2571701	.	A	G	1	1	2	0	0	2	0	0
4	2620973	.	C	A	12	10	22	0	0	22	0	0
4	2621086	.	G	A	9	14	23	0	2	25	0	0
4	2621186	.	G	A	3	19	22	0	2	24	0	0
4	2621761	.	T	C	9	5	14	0	0	14	0	0
4	2622344	.	G	C	17	9	26	0	2	28	0	0
4	2622496	.	T	C	9	11	20	0	2	22	0	0
4	2622529	.	C	A	9	12	21	0	5	26	0	0
4	2629869	.	G	A	1	2	3	0	0	3	0	0
4	2642254	.	T	A	1	2	3	0	0	3	0	0
4	2642466	.	A	G	2	4	6	0	0	6	0	0
4	2642473	.	T	C	1	4	5	0	0	5	0	0
4	2662696	.	A	G	1	1	2	0	0	2	0	0
4	2666037	.	T	C	2	0	2	0	3	5	0	0
4	2666190	.	A	G	3	0	3	0	2	5	0	0
4	2666219	.	T	C	3	2	5	0	0	5	0	0
4	2675061	.	T	C	4	2	6	0	0	6	0	0
4	2675148	.	C	T	6	4	10	0	0	10	0	0
4	2675235	.	C	T	7	8	15	0	1	16	0	0
4	2688785	.	T	G	1	1	2	0	0	2	0	0
4	2695357	.	G	A	2	2	4	0	0	4	0	0
4	2702154	.	G	A	2	3	5	0	0	5	0	0
4	2702166	.	T	C	2	3	5	0	0	5	0	0
4	2705726	.	G	A	2	0	2	0	0	2	0	0
4	2752987	.	C	T	5	6	11	0	0	11	0	0
4	2753455	.	C	T	0	2	2	0	7	9	0	0
4	2773997	.	G	A	2	0	2	0	1	3	0	0
4	2866721	.	C	A	0	2	2	0	0	2	0	0
4	2866748	.	T	C	1	3	4	0	1	5	0	0
4	2867690	.	A	C	5	2	7	0	1	8	0	0
4	2867741	.	C	T	4	3	7	0	1	8	0	0
4	2867795	.	C	T	6	4	10	0	0	10	0	0
4	3338195	.	A	G	1	2	3	0	0	3	0	0
4	3474738	.	A	G	1	4	5	0	0	5	0	0
4	4111260	.	G	T	3	0	3	0	10	13	0	0
4	4118184	.	C	T	0	2	2	0	0	2	0	0
4	4228648	.	G	A	1	0	1	0	0	1	0	0
4	4228654	.	G	A	1	0	1	0	0	1	0	0
4	4356766	.	A	T	2	2	4	0	0	4	0	0
4	4358535	.	A	G	8	4	12	0	0	12	0	0
4	4358580	.	A	G	7	6	13	0	3	16	0	0
4	5352573	.	G	A	0	2	2	0	0	2	0	0
4	5365307	.	C	T	2	2	4	0	0	4	0	0
4	5365325	.	C	T	3	2	5	0	0	5	0	0
4	5665523	.	C	G	3	2	5	0	0	5	0	0
4	5849768	.	A	G	8	0	8	0	8	16	0	0
4	8027183	.	A	T	0	3	3	0	0	3	0	0
4	8046099	.	C	T	15	5	20	0	1	21	0	0
4	9297846	.	T	C	4	2	6	0	0	6	0	0
4	9498868	.	T	C	4	2	6	0	0	6	0	0
4	9618867	.	A	C	2	3	5	0	0	5	0	0
4	9624781	.	C	A	2	1	3	0	0	3	0	0
4	9697763	.	A	C	0	12	12	0	0	12	0	0
4	9966229	.	C	T	1	2	3	0	0	3	0	0
4	10044556	.	G	A	6	3	9	0	1	10	0	0
4	10044605	.	C	T	22	11	33	0	5	38	0	0
4	10044777	.	A	G	9	11	20	0	1	21	0	0
4	10045599	.	C	T	2	4	6	0	1	7	0	0
4	10045605	.	A	G	1	4	5	0	1	6	0	0
4	10128770	.	G	A	0	3	3	0	0	3	0	0
4	10128773	.	T	C	0	3	3	0	0	3	0	0
4	10366557	.	A	T	2	1	3	0	0	3	0	0
4	10366710	.	G	A	4	6	10	0	0	10	0	0
4	10366884	.	G	A	3	3	6	0	1	7	0	0
4	10367151	.	C	T	3	4	7	0	0	7	0	0
4	10553452	.	C	T	6	8	14	0	1	15	0	0
4	10553515	.	C	A	3	6	9	0	1	10	0	0
4	10553528	.	G	A	6	4	10	0	0	10	0	0
4	10558403	.	G	A	0	4	4	0	7	11	0	0
4	10558510	.	T	C	7	2	9	0	1	10	0	0
4	10559042	.	A	T	3	7	10	0	0	10	0	0
4	10559088	.	C	A	5	3	8	0	0	8	0	0
4	10559558	.	A	G	0	0	0	0	3	3	0	0
4	10559621	.	C	A	4	3	7	0	1	8	0	0
4	10559768	.	T	C	1	4	5	0	0	5	0	0
4	10560246	.	G	A	12	9	21	0	0	21	0	0
4	10560253	.	A	T	11	12	23	0	1	24	0	0
4	10560284	.	C	T	9	16	25	0	2	27	0	0
4	10560437	.	A	C	14	11	25	0	0	25	0	0
4	10560507	.	C	T	10	8	18	0	1	19	0	0
4	10560607	.	A	G	8	8	16	0	2	18	0	0
4	10560820	.	T	G	5	4	9	0	0	9	0	0
4	10560916	.	C	T	9	9	18	0	2	20	0	0
4	10561101	.	T	A	7	25	32	0	5	37	0	0
4	10561655	.	T	G	1	10	11	0	2	13	0	0
4	10614856	.	T	C	4	6	10	0	0	10	0	0
4	10614862	.	T	C	5	6	11	0	0	11	0	0
4	10712899	.	C	T	1	2	3	0	0	3	0	0
4	10712928	.	C	T	2	2	4	0	0	4	0	0
4	10712992	.	A	T	5	2	7	0	0	7	0	0
4	10757075	.	A	G	1	2	3	0	0	3	0	0
4	10757096	.	A	G	2	1	3	0	0	3	0	0
4	10814684	.	A	T	1	1	2	0	0	2	0	0
4	10888842	.	G	C	0	3	3	0	2	5	0	0
4	10888890	.	T	A	1	2	3	0	1	4	0	0
4	10888935	.	C	A	2	2	4	0	0	4	0	0
4	10890822	.	G	A	4	5	9	0	1	10	0	0
4	10896354	.	G	C	5	2	7	0	0	7	0	0
4	10896570	.	G	A	3	5	8	0	0	8	0	0
4	10896582	.	G	T	3	5	8	0	0	8	0	0
4	10896618	.	C	T	3	2	5	0	0	5	0	0
4	10896620	.	A	T	2	2	4	0	1	5	0	0
4	10904784	.	C	T	2	0	2	0	0	2	0	0
4	10905246	.	C	T	4	3	7	0	0	7	0	0
4	10906254	.	C	T	6	9	15	0	1	16	0	0
4	10907182	.	C	A	8	2	10	0	1	11	0	0
4	10908001	.	C	T	16	10	26	0	0	26	0	0
4	10908182	.	T	C	6	5	11	0	0	11	0	0
4	10908294	.	C	T	8	8	16	0	0	16	0	0
4	10974722	.	G	A	6	2	8	0	0	8	0	0
4	10974747	.	A	T	4	3	7	0	0	7	0	0
4	10976944	.	G	A	3	2	5	0	0	5	0	0
4	10987895	.	T	A	5	2	7	0	0	7	0	0
4	10988581	.	C	T	0	1	1	0	1	2	0	0
4	10994841	.	G	A	2	3	5	0	0	5	0	0
4	10994967	.	A	G	3	2	5	0	0	5	0	0
4	10995138	.	G	A	1	2	3	0	0	3	0	0
4	11053521	.	C	T	1	2	3	0	0	3	0	0
4	11053851	.	G	A	0	5	5	0	6	11	0	0
4	11054484	.	A	C	6	6	12	0	0	12	0	0
4	11054509	.	G	C	4	8	12	0	0	12	0	0
4	11344781	.	G	T	2	1	3	0	0	3	0	0
4	11344964	.	G	A	1	1	2	0	0	2	0	0
4	11356462	.	C	T	1	2	3	0	0	3	0	0
4	11366316	.	G	A	0	5	5	0	5	10	0	0
4	11366360	.	T	C	8	4	12	0	0	12	0	0
4	11366481	.	G	A	6	5	11	0	1	12	0	0
4	11366848	.	A	G	18	13	31	0	0	31	0	0
4	11366868	.	T	A	12	13	25	0	2	27	0	0
4	11366984	.	T	A	11	10	21	0	1	23	1	0
4	11367668	.	T	A	7	5	12	0	0	12	0	0
4	11367884	.	C	T	5	7	12	0	0	12	0	0
4	11367896	.	A	G	3	6	9	0	2	11	0	0
4	11368076	.	G	T	15	20	35	0	0	35	0	0
4	11368143	.	C	T	18	16	34	0	0	34	0	0
4	11368171	.	G	A	0	24	24	0	16	40	0	0
4	11368432	.	A	T	2	3	5	0	0	5	0	0
4	11387698	.	A	T	0	1	1	0	0	1	0	0
4	11389061	.	T	C	2	3	5	0	1	6	0	0
4	11389070	.	A	C	1	5	6	0	2	8	0	0
4	11389372	.	G	C	0	4	4	0	3	7	0	0
4	11414937	.	A	G	3	2	5	0	0	5	0	0
4	11415150	.	G	A	0	3	3	0	5	8	0	0
4	11415471	.	G	A	2	4	6	0	0	6	0	0
4	11415483	.	G	A	2	3	5	0	0	5	0	0
4	11416701	.	C	T	1	9	10	0	1	11	0	0
4	11416758	.	T	A	5	2	7	0	3	10	0	0
4	11416854	.	G	A	6	6	12	0	2	14	0	0
4	11417829	.	C	A	7	2	9	0	0	9	0	0
4	11418261	.	G	T	3	3	6	0	0	6	0	0
4	11418969	.	C	T	5	4	9	0	0	9	0	0
4	11419163	.	C	G	1	2	3	0	0	3	0	0
4	11419836	.	A	T	6	4	10	0	2	12	0	0
4	11420136	.	C	T	6	5	11	0	0	11	0	0
4	11422664	.	T	C	10	14	24	0	1	25	0	0
4	11427820	.	A	C	11	11	22	0	0	22	0	0
4	11431768	.	A	C	0	1	1	0	0	1	0	0
4	11439544	.	C	A	3	4	7	0	1	8	0	0
4	11441789	.	T	A	5	3	8	0	1	9	0	0
4	11442085	.	C	T	0	1	1	0	0	1	0	0
4	11444080	.	C	T	1	0	1	0	0	1	0	0
4	11444209	.	C	A	6	2	8	0	0	8	0	0
4	11445978	.	T	C	12	18	30	0	0	30	0	0
4	11446365	.	A	T	13	16	29	0	7	36	0	0
4	11446703	.	C	T	15	8	23	0	0	23	0	0
4	11446774	.	A	G	7	4	11	0	1	12	0	0
4	11446844	.	A	G	7	9	16	0	0	16	0	0
4	11447037	.	T	G	21	7	28	0	2	30	0	0
4	11447144	.	G	A	19	14	33	0	1	34	0	0
4	11447226	.	T	G	12	1	13	0	20	33	0	0
4	11447251	.	T	C	14	11	25	0	1	26	0	0
4	11447599	.	C	T	17	22	39	0	1	40	0	0
4	11447632	.	C	G	16	21	37	0	0	37	0	0
4	11448403	.	G	A	0	17	17	0	23	40	0	0
4	11448680	.	A	G	15	18	33	0	1	34	0	0
4	11458318	.	T	G	4	4	8	0	1	9	0	0
4	11461461	.	T	C	2	2	4	0	0	4	0	0
4	11461479	.	C	T	2	2	4	0	1	5	0	0
4	11461865	.	T	A	8	4	12	0	0	12	0	0
4	11461914	.	A	G	3	9	12	0	1	13	0	0
4	11470854	.	A	G	3	0	3	0	0	3	0	0
4	11470920	.	C	T	3	6	9	0	2	11	0	0
4	11471203	.	T	C	10	5	15	0	1	16	0	0
4	11472674	.	T	C	15	3	18	0	1	19	0	0
4	11476406	.	T	C	11	8	19	0	0	19	0	0
4	11476472	.	G	A	0	29	29	0	33	62	0	0
4	11476487	.	C	T	29	31	60	0	1	61	0	0
4	11476740	.	C	T	22	28	50	0	1	51	0	0
4	11477566	.	G	A	13	12	25	0	2	27	0	0
4	11482235	.	G	A	0	5	5	0	2	7	0	0
4	11482259	.	G	A	3	6	9	0	1	10	0	0
4	11482943	.	C	A	2	2	4	0	0	4	0	0
4	11483439	.	A	G	4	5	9	0	0	9	0	0
4	11483469	.	C	A	4	3	7	0	0	7	0	0
4	11483483	.	T	A	1	3	4	0	0	4	0	0
4	11484854	.	A	G	3	2	5	0	0	5	0	0
4	11487176	.	C	T	0	2	2	0	0	2	0	0
4	11709544	.	C	T	0	0	0	0	2	2	0	0
4	11712653	.	C	T	1	0	1	0	0	1	0	0
4	11712704	.	G	T	0	3	3	0	2	5	0	0
4	11712794	.	T	C	0	1	1	0	0	1	0	0
4	11713012	.	G	A	0	1	1	0	1	2	0	0
4	11713065	.	C	T	3	2	5	0	0	5	0	0
4	11721731	.	C	T	6	5	11	0	0	11	0	0
4	11721770	.	T	C	2	2	4	0	0	4	0	0
4	11726366	.	T	A	3	2	5	0	1	6	0	0
4	11728959	.	G	A	0	2	2	0	4	6	0	0
4	11729471	.	A	T	7	5	12	0	0	12	0	0
4	11729719	.	G	A	5	6	11	0	2	13	0	0
4	11729792	.	G	A	8	9	17	0	1	18	0	0
4	11730033	.	G	A	0	9	9	0	5	14	0	0
4	11730088	.	A	T	2	7	9	0	0	9	0	0
4	11730199	.	C	T	5	9	14	0	0	14	0	0
4	11730317	.	T	G	5	5	10	0	2	12	0	0
4	11730515	.	C	A	9	3	12	0	0	12	0	0
4	11732456	.	G	A	0	5	5	0	0	5	0	0
4	11732956	.	A	G	3	2	5	0	0	5	0	0
4	11732975	.	G	A	2	3	5	0	0	5	0	0
4	11733140	.	T	C	3	0	3	0	2	5	0	0
4	11733201	.	T	A	4	3	7	0	0	8	1	0
4	11734150	.	A	G	2	2	4	0	0	4	0	0
4	11734196	.	A	T	1	3	4	0	0	4	0	0
4	11765902	.	C	T	0	3	3	0	0	3	0	0
4	11804769	.	T	A	2	3	5	0	1	6	0	0
4	11804932	.	G	A	3	4	7	0	0	7	0	0
4	11805095	.	G	T	6	9	15	0	0	15	0	0
4	11805149	.	C	A	7	9	16	0	1	17	0	0
4	11805557	.	G	A	11	5	16	0	1	17	0	0
4	11806965	.	G	C	0	3	3	0	0	3	0	0
4	11814055	.	C	T	2	28	30	0	13	43	0	0
4	11814074	.	T	A	16	31	47	0	1	48	0	0
4	11814264	.	A	C	3	14	17	0	0	17	0	0
4	11814407	.	G	A	7	10	17	0	1	18	0	0
4	11814429	.	A	T	9	9	18	0	0	18	0	0
4	11814471	.	G	A	9	8	17	0	0	17	0	0
4	11814494	.	C	T	5	10	15	0	1	16	0	0
4	11814641	.	T	A	5	13	18	0	2	20	0	0
4	11814723	.	A	C	16	15	31	0	1	32	0	0
4	11814997	.	G	A	17	13	30	0	0	30	0	0
4	11815137	.	G	T	7	17	24	0	0	24	0	0
4	11815143	.	C	G	8	15	23	0	0	23	0	0
4	11815324	.	A	C	17	7	24	0	1	25	0	0
4	11815413	.	A	G	14	11	25	0	0	25	0	0
4	11815417	.	T	A	15	9	24	0	2	26	0	0
4	11815772	.	C	A	2	6	8	0	0	8	0	0
4	11816346	.	C	A	5	5	10	0	1	11	0	0
4	11816347	.	C	A	0	6	6	0	5	11	0	0
4	11816420	.	G	A	8	13	21	0	0	21	0	0
4	11816687	.	C	T	16	15	31	0	1	32	0	0
4	11818347	.	G	A	2	1	3	0	0	3	0	0
4	11827171	.	C	T	2	2	4	0	0	4	0	0
4	11829423	.	A	G	1	2	3	0	1	4	0	0
4	12006542	.	G	A	9	7	16	0	0	16	0	0
4	12006761	.	C	T	0	2	2	0	5	7	0	0
4	12007149	.	T	A	6	5	11	0	0	11	0	0
4	12013583	.	T	A	7	3	10	0	0	10	0	0
4	12020263	.	C	T	4	1	5	0	0	5	0	0
4	12021748	.	G	T	0	15	15	0	14	29	0	0
4	12021754	.	C	T	15	15	30	0	1	31	0	0
4	12022108	.	A	G	8	0	8	0	17	25	0	0
4	12023382	.	C	T	1	2	3	0	0	3	0	0
4	12025771	.	G	A	3	16	19	0	1	20	0	0
4	12026098	.	G	A	4	7	11	0	0	11	0	0
4	12026305	.	T	C	14	17	31	0	3	34	0	0
4	12026363	.	G	A	11	8	19	0	1	20	0	0
4	12026369	.	G	T	8	9	17	0	0	17	0	0
4	12026429	.	C	A	14	8	22	0	0	22	0	0
4	12026488	.	T	C	3	4	7	0	1	8	0	0
4	12026500	.	C	T	3	2	5	0	0	5	0	0
4	12075100	.	G	A	8	8	16	0	0	16	0	0
4	12076395	.	T	C	7	9	16	0	0	16	0	0
4	12086701	.	C	T	0	10	10	0	9	19	0	0
4	12087077	.	G	A	1	3	4	0	0	4	0	0
4	12087262	.	G	C	3	0	3	0	4	7	0	0
4	12089200	.	T	C	1	3	4	0	0	4	0	0
4	12089269	.	C	T	0	2	2	0	0	2	0	0
4	12101955	.	G	A	8	16	24	0	2	26	0	0
4	12103602	.	G	A	1	2	3	0	0	3	0	0
4	12103675	.	G	T	13	6	19	0	2	21	0	0
4	12103846	.	A	T	2	5	7	0	0	7	0	0
4	12103911	.	A	T	5	10	15	0	0	15	0	0
4	12104100	.	T	C	3	4	7	0	0	7	0	0
4	12113128	.	C	T	3	4	7	0	0	7	0	0
4	12113199	.	G	T	5	4	9	0	0	9	0	0
4	12229942	.	C	T	8	9	17	0	0	17	0	0
4	12230029	.	C	T	8	10	18	0	1	19	0	0
4	12230443	.	T	C	6	9	15	0	0	15	0	0
4	12230698	.	C	T	3	5	8	0	0	8	0	0
4	12230833	.	G	T	2	2	4	0	0	4	0	0
4	12230869	.	G	T	1	2	3	0	0	3	0	0
4	12230890	.	T	A	1	1	2	0	0	2	0	0
4	12231008	.	G	A	0	3	3	0	1	4	0	0
4	12231019	.	G	A	5	2	7	0	0	7	0	0
4	12231101	.	A	G	5	3	8	0	1	9	0	0
4	12231235	.	A	T	4	3	7	0	3	10	0	0
4	12231252	.	A	C	5	3	8	0	1	9	0	0
4	12231398	.	T	C	3	9	12	0	0	12	0	0
4	12231423	.	A	G	4	1	5	0	10	15	0	0
4	12231625	.	T	C	2	3	5	0	0	5	0	0
4	12231732	.	A	G	12	4	16	0	0	16	0	0
4	12231828	.	A	G	2	3	5	1	0	6	0	0
4	12231835	.	A	G	3	0	3	1	3	7	0	0
4	12232254	.	C	T	8	8	16	0	1	17	0	0
4	12232323	.	A	T	9	6	15	0	0	15	0	0
4	12232415	.	G	T	7	4	11	0	0	11	0	0
4	12232435	.	T	G	4	0	4	0	4	8	0	0
4	12232480	.	G	T	3	3	6	0	1	7	0	0
4	12232509	.	C	T	1	5	6	0	0	6	0	0
4	12232644	.	A	T	3	12	15	0	0	15	0	0
4	12232737	.	G	A	3	4	7	0	0	7	0	0
4	12232746	.	T	C	3	3	6	0	0	6	0	0
4	12233220	.	C	T	4	10	14	0	1	15	0	0
4	12233252	.	A	T	3	9	12	0	1	13	0	0
4	12233595	.	C	T	2	3	5	1	0	6	0	0
4	12233651	.	A	T	5	3	8	2	0	10	0	0
4	12234458	.	C	T	5	7	12	0	1	13	0	0
4	12234670	.	A	G	5	0	5	0	11	16	0	0
4	12234955	.	C	T	8	14	22	0	1	23	0	0
4	12235123	.	G	A	17	11	28	0	1	29	0	0
4	12235414	.	A	C	0	8	8	0	0	9	1	0
4	12235416	.	A	C	0	8	8	0	1	9	0	0
4	12235838	.	T	A	9	13	22	0	2	24	0	0
4	12236171	.	G	A	14	8	22	1	0	23	0	0
4	12236471	.	G	T	8	14	22	0	0	22	0	0
4	12236667	.	C	A	7	6	13	0	0	13	0	0
4	12237508	.	A	G	14	7	21	0	0	21	0	0
4	12238064	.	G	T	24	12	36	0	0	36	0	0
4	12238065	.	C	A	23	11	34	0	2	36	0	0
4	12238418	.	C	T	19	21	40	0	0	40	0	0
4	12238711	.	G	A	12	9	21	1	1	23	0	0
4	12238956	.	G	A	14	18	32	0	9	41	0	0
4	12244153	.	T	A	7	14	21	0	0	21	0	0
4	12244258	.	T	C	4	7	11	0	3	14	0	0
4	12244322	.	C	T	12	8	20	0	0	20	0	0
4	12244373	.	G	A	9	15	24	0	1	25	0	0
4	12245058	.	G	A	9	5	14	0	0	14	0	0
4	12245324	.	T	A	4	3	7	0	0	7	0	0
4	12245470	.	G	A	7	6	13	0	1	14	0	0
4	12265268	.	T	A	13	5	18	0	0	18	0	0
4	12265355	.	T	C	1	0	1	0	0	1	0	0
4	12270202	.	A	T	3	0	3	0	0	3	0	0
4	12275400	.	T	C	3	3	6	0	0	6	0	0
4	12298513	.	A	T	10	10	20	0	1	21	0	0
4	12304561	.	C	T	12	13	25	0	3	28	0	0
4	12306880	.	G	A	4	19	23	0	2	25	0	0
4	12311632	.	G	A	2	2	4	0	1	5	0	0
4	12312670	.	C	A	3	2	5	0	0	5	0	0
4	12312899	.	G	A	4	2	6	0	0	6	0	0
4	12317764	.	G	A	0	2	2	0	1	3	0	0
4	12381781	.	G	A	2	2	4	0	0	4	0	0
4	12381900	.	T	C	7	9	16	0	0	16	0	0
4	12381930	.	G	A	6	6	12	0	0	12	0	0
4	12382076	.	A	G	11	10	21	0	1	22	0	0
4	12382190	.	C	T	8	2	10	0	0	10	0	0
4	12382336	.	T	G	13	6	19	0	0	19	0	0
4	12382673	.	A	T	9	6	15	0	0	15	0	0
4	12382712	.	G	A	10	10	20	0	0	20	0	0
4	12382871	.	G	A	14	8	22	0	1	23	0	0
4	12382921	.	G	A	11	14	25	0	0	25	0	0
4	12383081	.	C	T	3	6	9	0	2	11	0	0
4	12384840	.	G	A	5	10	15	0	0	15	0	0
4	12384873	.	C	G	0	5	5	0	1	6	0	0
4	12612715	.	T	A	7	2	9	0	0	9	0	0
4	12620983	.	G	A	3	3	6	0	0	6	0	0
4	12657838	.	G	A	0	10	10	0	5	15	0	0
4	12657905	.	G	C	5	10	15	0	1	16	0	0
4	12678204	.	C	G	19	20	39	0	2	41	0	0
4	12678676	.	C	A	26	13	39	0	3	42	0	0
4	12678885	.	T	C	24	21	45	0	5	50	0	0
4	12679190	.	C	T	2	2	4	0	0	4	0	0
4	12715800	.	C	T	6	5	11	0	1	12	0	0
4	12715830	.	C	T	4	5	9	0	0	9	0	0
4	12715837	.	G	A	4	5	9	0	0	9	0	0
4	12715871	.	C	T	1	4	5	0	0	5	0	0
4	12716265	.	A	G	2	3	5	0	0	5	0	0
4	12719343	.	G	T	1	3	4	0	0	4	0	0
4	12755207	.	C	A	5	5	10	0	0	10	0	0
4	12755275	.	G	T	5	4	9	0	0	9	0	0
4	12771892	.	A	C	4	0	4	0	2	6	0	0
4	12793632	.	G	A	4	8	12	0	0	12	0	0
4	12793806	.	G	A	4	4	8	0	1	9	0	0
4	12793893	.	G	A	5	4	9	0	1	10	0	0
4	12793914	.	T	A	4	6	10	0	1	11	0	0
4	12793943	.	C	G	6	6	12	0	0	12	0	0
4	12795394	.	G	A	10	17	27	0	0	27	0	0
4	12892442	.	T	C	1	0	1	0	2	3	0	0
4	12893073	.	T	C	3	2	5	0	1	6	0	0
4	12893880	.	A	G	1	2	3	0	0	3	0	0
4	12900856	.	G	T	1	1	2	0	1	3	0	0
4	12902609	.	G	A	0	1	1	0	0	1	0	0
4	12917237	.	G	T	11	4	15	0	0	16	1	0
4	12917348	.	A	G	7	3	10	0	1	11	0	0
4	12917534	.	C	T	0	9	9	0	11	20	0	0
4	12929147	.	C	T	0	7	7	0	3	10	0	0
4	12971495	.	C	A	26	13	39	0	0	39	0	0
4	12971935	.	A	T	18	8	26	0	3	29	0	0
4	12972000	.	T	A	10	11	21	0	1	23	1	0
4	12972215	.	C	T	0	27	27	0	21	48	0	0
4	12976735	.	G	A	6	9	15	0	2	17	0	0
4	12976983	.	T	C	13	0	13	0	15	28	0	0
4	12978779	.	G	A	14	11	25	0	1	26	0	0
4	12978843	.	A	C	14	15	29	0	2	31	0	0
4	13035881	.	A	G	18	5	23	0	0	23	0	0
4	13035962	.	T	C	15	16	31	0	0	31	0	0
4	13036046	.	G	A	10	21	31	0	2	33	0	0
4	13036572	.	G	A	5	9	14	0	0	14	0	0
4	13041589	.	C	T	0	5	5	0	1	6	0	0
4	13054610	.	G	A	2	2	4	0	0	4	0	0
4	13056441	.	G	A	7	3	10	0	1	11	0	0
4	13138021	.	T	C	6	3	9	0	1	10	0	0
4	13421182	.	T	A	2	3	5	0	2	7	0	0
4	13422116	.	G	A	0	2	2	0	5	7	0	0
4	13453413	.	G	A	3	2	5	0	0	5	0	0
4	13457770	.	G	C	5	2	7	0	0	7	0	0
4	13457965	.	A	G	4	5	9	0	0	9	0	0
4	13458010	.	T	C	4	4	8	0	0	8	0	0
4	13458052	.	G	T	0	4	4	0	2	6	0	0
4	13458469	.	C	T	5	5	10	0	1	11	0	0
4	13458703	.	C	G	6	5	11	0	1	12	0	0
4	13458800	.	C	T	3	5	8	0	0	8	0	0
4	13458888	.	G	A	0	3	3	0	2	5	0	0
4	13459453	.	A	G	3	2	5	0	0	5	0	0
4	13459602	.	T	G	3	10	13	0	1	14	0	0
4	13459670	.	A	G	6	8	14	0	0	14	0	0
4	13459917	.	G	A	8	8	16	0	0	16	0	0
4	13459964	.	A	T	3	8	11	0	0	11	0	0
4	13460125	.	G	A	6	6	12	0	2	14	0	0
4	13460244	.	A	G	5	3	8	0	3	11	0	0
4	13460289	.	G	A	7	3	10	0	0	10	0	0
4	13460653	.	G	A	6	10	16	0	0	16	0	0
4	13460937	.	T	C	11	6	17	0	0	17	0	0
4	13461216	.	T	A	7	7	14	0	0	14	0	0
4	13461302	.	T	C	2	6	8	0	1	9	0	0
4	13570609	.	G	A	2	6	8	0	0	8	0	0
4	13570899	.	T	C	1	2	3	0	0	3	0	0
4	13571711	.	T	C	8	7	15	0	0	15	0	0
4	13572951	.	G	A	0	3	3	0	1	4	0	0
4	13575570	.	A	G	1	0	1	0	4	5	0	0
4	13575618	.	G	A	0	7	7	0	6	14	1	0
4	13575623	.	A	G	5	7	12	0	0	12	0	0
4	13575672	.	A	G	2	1	3	0	6	9	0	0
4	13575701	.	C	T	0	3	3	0	0	3	0	0
4	13575853	.	C	T	13	4	17	0	0	17	0	0
4	13575996	.	C	T	12	11	23	0	1	24	0	0
4	13576105	.	G	T	4	2	6	0	0	6	0	0
4	13576139	.	G	A	0	3	3	0	4	7	0	0
4	13591793	.	A	G	2	3	5	0	0	5	0	0
4	13592863	.	G	A	1	3	4	0	0	4	0	0
4	13593078	.	T	C	6	6	12	0	0	12	0	0
4	13593097	.	T	C	5	2	7	0	0	7	0	0
4	13595838	.	G	A	0	6	6	0	6	12	0	0
4	13597646	.	A	G	2	2	4	0	0	4	0	0
4	13597782	.	C	G	4	0	4	0	2	6	0	0
4	13597849	.	C	T	0	2	2	0	0	2	0	0
4	13604574	.	T	C	16	12	28	0	1	29	0	0
4	13628281	.	C	T	7	6	13	0	0	13	0	0
4	13628328	.	G	T	7	8	15	0	1	16	0	0
4	13628583	.	G	A	9	5	14	0	0	14	0	0
4	13628724	.	G	A	3	4	7	0	0	7	0	0
4	13629927	.	T	G	4	6	10	0	0	10	0	0
4	13631269	.	G	A	5	9	14	0	0	14	0	0
4	13640812	.	C	T	1	3	4	0	0	4	0	0
4	13642486	.	C	T	15	15	30	0	0	30	0	0
4	13642676	.	T	G	6	0	6	0	18	24	0	0
4	13642897	.	A	G	2	3	5	0	0	5	0	0
4	13643251	.	G	T	0	10	10	0	1	11	0	0
4	13643349	.	A	T	10	5	15	0	0	15	0	0
4	13643461	.	G	A	0	4	4	0	4	8	0	0
4	13643547	.	C	T	3	5	8	0	1	9	0	0
4	13702400	.	C	T	3	5	8	0	0	8	0	0
4	13702409	.	C	T	3	5	8	0	0	8	0	0
4	13706180	.	A	C	0	2	2	0	0	2	0	0
4	13706184	.	A	T	0	2	2	0	0	2	0	0
4	13706810	.	C	T	1	4	5	0	0	5	0	0
4	13708840	.	C	A	2	0	2	0	0	2	0	0
4	13710585	.	G	T	0	1	1	0	2	3	0	0
4	13712997	.	C	G	1	2	3	0	0	3	0	0
4	13713042	.	A	G	3	6	9	0	1	10	0	0
4	13714209	.	G	A	3	5	8	0	1	9	0	0
4	13723362	.	C	T	1	0	1	0	0	1	0	0
4	13723446	.	C	T	8	4	12	0	0	12	0	0
4	13723458	.	C	T	6	3	9	0	0	9	0	0
4	13724578	.	G	A	1	1	2	0	0	2	0	0
4	13724581	.	T	C	1	1	2	0	0	2	0	0
4	13744441	.	T	C	8	5	13	0	0	13	0	0
4	13744451	.	C	A	10	6	16	0	0	16	0	0
4	13744525	.	C	A	6	6	12	0	3	15	0	0
4	13744591	.	T	A	2	1	3	0	0	3	0	0
4	13747503	.	C	T	2	4	6	0	0	6	0	0
4	13747566	.	A	C	5	6	11	0	1	12	0	0
4	13747793	.	C	A	1	3	4	0	0	4	0	0
4	13747799	.	C	T	1	3	4	0	0	4	0	0
4	13748645	.	G	T	0	1	1	0	0	1	0	0
4	13750453	.	T	A	11	7	18	0	1	19	0	0
4	13753404	.	G	A	11	9	20	0	2	22	0	0
4	13755213	.	G	A	10	6	16	0	0	16	0	0
4	13755254	.	T	G	22	12	34	0	1	35	0	0
4	13755392	.	G	A	1	8	9	0	18	27	0	0
4	13755521	.	T	A	9	5	14	0	0	14	0	0
4	13755551	.	C	T	9	3	12	0	0	12	0	0
4	13756124	.	A	G	5	1	6	0	10	16	0	0
4	13756269	.	A	T	10	17	27	0	0	27	0	0
4	13756273	.	C	A	9	16	25	0	0	25	0	0
4	13756508	.	T	G	9	0	9	0	6	15	0	0
4	13810875	.	C	T	2	1	3	0	0	3	0	0
4	13810885	.	A	C	2	2	4	0	0	4	0	0
4	13859969	.	A	T	0	3	3	0	0	3	0	0
4	13859984	.	G	A	1	3	4	0	0	4	0	0
4	13860345	.	A	C	1	2	3	0	1	4	0	0
4	13905730	.	T	C	6	0	6	0	4	10	0	0
4	13905846	.	A	G	7	8	15	0	0	15	0	0
4	13905926	.	T	A	4	12	16	0	1	17	0	0
4	13906051	.	T	C	3	0	3	0	8	11	0	0
4	13906120	.	A	G	1	2	3	0	0	3	0	0
4	13906567	.	A	G	9	9	18	0	0	18	0	0
4	13920902	.	A	G	5	3	8	0	0	8	0	0
4	13925621	.	A	G	6	5	11	0	0	11	0	0
4	13925714	.	C	T	1	2	3	0	0	3	0	0
4	13929511	.	A	G	3	0	3	0	1	4	0	0
4	13931460	.	T	A	2	3	5	0	0	5	0	0
4	13931827	.	G	A	0	3	3	0	4	7	0	0
4	13931831	.	T	A	3	1	4	0	2	6	0	0
4	13943890	.	A	T	1	1	2	0	0	2	0	0
4	13943911	.	T	A	1	4	5	0	1	6	0	0
4	13944129	.	T	A	5	5	10	0	0	10	0	0
4	13963048	.	T	A	8	7	15	0	1	17	1	0
4	13963202	.	T	A	8	4	12	0	0	12	0	0
4	13963702	.	A	G	3	3	6	0	1	7	0	0
4	13964679	.	C	G	2	4	6	0	0	6	0	0
4	13965149	.	A	G	0	1	1	0	0	1	0	0
4	13965185	.	C	T	2	4	6	0	0	6	0	0
4	13965558	.	G	A	2	2	4	0	0	4	0	0
4	14193462	.	G	T	12	8	20	0	2	22	0	0
4	14193473	.	C	A	12	8	20	0	1	21	0	0
4	14193962	.	C	T	3	2	5	0	1	6	0	0
4	14194650	.	G	A	0	2	2	0	0	2	0	0
4	14205253	.	A	T	7	4	11	0	0	11	0	0
4	14247890	.	G	C	14	21	35	0	4	39	0	0
4	14248043	.	A	G	29	33	62	0	0	63	1	0
4	14248157	.	G	A	41	21	62	0	2	64	0	0
4	14248277	.	A	T	25	19	44	0	0	44	0	0
4	14248279	.	G	A	25	18	43	0	1	44	0	0
4	14248332	.	C	A	4	25	29	0	24	54	1	0
4	14248419	.	T	C	28	2	30	2	13	45	0	0
4	14248433	.	A	T	26	16	42	2	2	46	0	0
4	14248643	.	A	G	30	26	56	0	3	59	0	0
4	14248715	.	G	A	24	22	46	0	1	47	0	0
4	14248716	.	A	T	22	21	43	0	4	47	0	0
4	14248750	.	T	G	38	6	44	0	2	46	0	0
4	14248751	.	A	G	37	6	43	0	3	46	0	0
4	14248804	.	G	A	24	19	43	0	3	46	0	0
4	14248848	.	G	A	24	20	44	0	3	47	0	0
4	14248856	.	C	T	26	19	45	0	1	46	0	0
4	14248948	.	A	G	27	10	37	0	1	38	0	0
4	14248969	.	T	G	18	10	28	0	3	31	0	0
4	14249043	.	C	T	25	12	37	0	5	42	0	0
4	14249151	.	T	C	21	17	38	0	2	40	0	0
4	14249159	.	T	G	23	15	38	0	2	40	0	0
4	14249247	.	A	T	21	18	39	0	0	39	0	0
4	14249269	.	T	C	16	18	34	0	3	37	0	0
4	14249329	.	C	T	13	19	32	0	1	33	0	0
4	14249358	.	T	A	10	19	29	0	2	31	0	0
4	14249374	.	G	T	6	16	22	0	2	24	0	0
4	14249402	.	T	A	2	9	11	0	4	15	0	0
4	14249544	.	G	T	27	19	46	0	0	46	0	0
4	14249549	.	C	A	25	19	44	0	3	47	0	0
4	14249583	.	A	T	19	17	36	0	0	36	0	0
4	14249588	.	A	T	19	14	33	0	0	33	0	0
4	14249710	.	T	A	12	4	16	0	3	19	0	0
4	14249725	.	T	G	14	4	18	0	2	20	0	0
4	14249799	.	T	C	11	14	25	0	2	27	0	0
4	14249984	.	T	G	29	21	50	0	7	57	0	0
4	14250053	.	G	A	35	7	42	0	1	43	0	0
4	14250678	.	G	A	11	15	26	0	1	27	0	0
4	14250840	.	T	C	16	0	16	0	14	30	0	0
4	14282192	.	G	T	2	1	3	0	0	3	0	0
4	14282244	.	A	G	18	16	34	0	0	34	0	0
4	14282301	.	C	T	3	5	8	0	0	8	0	0
4	14303321	.	A	G	16	18	34	0	0	34	0	0
4	14311380	.	G	A	2	3	5	0	0	5	0	0
4	14896037	.	T	C	2	2	4	0	0	4	0	0
4	14896040	.	T	C	2	2	4	1	0	5	0	0
4	14896374	.	C	T	2	4	6	0	0	6	0	0
4	14896440	.	T	C	3	4	7	0	0	7	0	0
4	14896509	.	G	A	2	3	5	0	0	5	0	0
4	14904061	.	G	A	0	2	2	0	1	3	0	0
4	14909287	.	G	C	4	1	5	0	0	5	0	0
4	14909532	.	T	C	4	6	10	0	0	10	0	0
4	14917563	.	A	C	1	1	2	0	0	2	0	0
4	14917585	.	A	T	1	2	3	0	0	3	0	0
4	14917895	.	G	A	7	4	11	0	0	11	0	0
4	14918473	.	G	A	1	1	2	0	0	2	0	0
4	14918476	.	A	G	1	1	2	0	0	2	0	0
4	14918590	.	C	A	1	1	2	0	0	2	0	0
4	14919678	.	C	T	1	6	7	0	4	11	0	0
4	14919877	.	T	C	1	3	4	0	0	4	0	0
4	14923218	.	A	G	1	3	4	0	0	4	0	0
4	14925742	.	A	G	2	2	4	0	0	4	0	0
4	14926096	.	G	A	1	0	1	0	0	1	0	0
4	14926967	.	C	T	7	14	21	0	1	22	0	0
4	14929107	.	T	G	5	1	6	0	0	6	0	0
4	14932200	.	T	C	13	7	20	0	3	23	0	0
4	14932577	.	T	C	1	2	3	0	1	4	0	0
4	14932676	.	A	T	4	2	6	0	1	7	0	0
4	14932915	.	C	G	4	3	7	0	0	7	0	0
4	14933337	.	A	G	3	4	7	0	0	7	0	0
4	14933513	.	G	T	1	4	5	0	1	6	0	0
4	14945653	.	G	C	1	2	3	0	0	3	0	0
4	14948750	.	T	A	1	0	1	0	0	1	0	0
4	14951465	.	A	G	1	2	3	0	0	3	0	0
4	14992080	.	A	G	2	4	6	0	0	6	0	0
4	14992081	.	T	C	2	4	6	0	0	6	0	0
4	14992142	.	G	C	4	3	7	0	0	7	0	0
4	14992353	.	T	C	7	3	10	0	0	10	0	0
4	14992410	.	T	C	6	0	6	0	4	10	0	0
4	14992529	.	T	C	10	4	14	0	0	14	0	0
4	14993076	.	T	C	6	7	13	0	0	13	0	0
4	14993263	.	A	C	9	6	15	0	0	15	0	0
4	14995395	.	G	T	3	3	6	0	0	6	0	0
4	15003761	.	G	A	3	4	7	0	0	7	0	0
4	15006334	.	T	C	0	4	4	0	0	4	0	0
4	15009243	.	C	T	5	2	7	0	0	7	0	0
4	15009874	.	T	C	0	1	1	0	0	1	0	0
4	15009947	.	G	A	3	4	7	0	0	7	0	0
4	15009971	.	A	T	9	4	13	0	0	13	0	0
4	15010557	.	A	G	4	0	4	0	10	14	0	0
4	15010680	.	A	G	2	4	6	0	1	7	0	0
4	15010789	.	T	A	3	4	7	0	1	8	0	0
4	15058352	.	A	G	22	16	38	0	1	39	0	0
4	15058663	.	A	C	11	9	20	0	2	22	0	0
4	15058968	.	T	G	13	1	14	0	9	23	0	0
4	15059028	.	G	A	0	10	10	0	8	18	0	0
4	15059070	.	A	T	15	8	23	0	0	23	0	0
4	15059147	.	A	G	9	11	20	0	2	22	0	0
4	15059367	.	A	G	16	2	18	0	0	18	0	0
4	15059498	.	T	A	13	23	36	0	1	37	0	0
4	15059823	.	A	T	21	15	36	0	0	37	1	0
4	15081490	.	C	T	1	5	6	0	0	6	0	0
4	15081703	.	G	A	9	13	22	0	0	22	0	0
4	15081829	.	T	C	12	6	18	0	0	18	0	0
4	15081871	.	C	T	7	15	22	0	2	24	0	0
4	15081985	.	T	C	12	9	21	0	3	24	0	0
4	15082573	.	C	G	4	2	6	0	0	7	1	0
4	15096627	.	A	G	7	8	15	0	0	15	0	0
4	15218134	.	T	C	13	0	13	0	12	25	0	0
4	15218258	.	A	G	17	15	32	0	3	35	0	0
4	15218342	.	T	A	19	24	43	0	3	46	0	0
4	15218389	.	C	T	15	22	37	0	2	39	0	0
4	15218505	.	C	T	17	16	33	0	0	33	0	0
4	15218595	.	T	C	2	11	13	0	0	13	0	0
4	15218656	.	G	A	7	9	16	0	0	16	0	0
4	15218772	.	C	A	17	11	28	0	2	30	0	0
4	15218886	.	A	C	13	13	26	0	0	26	0	0
4	15219291	.	G	A	16	10	26	0	1	27	0	0
4	15219368	.	C	T	0	14	14	0	13	27	0	0
4	15219533	.	T	A	12	9	21	0	1	22	0	0
4	15219787	.	T	C	14	16	30	0	0	30	0	0
4	15219840	.	G	T	11	18	29	0	0	29	0	0
4	15219955	.	G	A	20	12	32	0	0	32	0	0
4	15220001	.	A	T	24	13	37	0	1	38	0	0
4	15220022	.	A	G	19	9	28	0	1	29	0	0
4	15220467	.	T	G	12	7	19	0	1	20	0	0
4	15238347	.	G	A	6	7	13	0	0	13	0	0
4	15247902	.	A	T	0	4	4	0	1	5	0	0
4	15272169	.	T	C	1	3	4	0	0	4	0	0
4	15272170	.	T	C	1	0	1	0	3	4	0	0
4	15294169	.	C	T	1	2	3	0	0	3	0	0
4	15500617	.	G	T	1	1	2	0	0	2	0	0
4	15500663	.	T	C	6	0	6	0	8	14	0	0
4	15585852	.	G	T	1	0	1	0	0	1	0	0
4	15603487	.	G	C	8	5	13	0	0	13	0	0
4	15630128	.	A	G	2	2	4	0	0	4	0	0
4	15630131	.	G	A	2	1	3	0	1	4	0	0
4	15636947	.	A	G	0	3	3	0	0	3	0	0
4	15775430	.	G	A	5	6	11	0	0	11	0	0
4	15795098	.	G	A	3	4	7	0	0	7	0	0
4	15799320	.	T	C	1	0	1	0	0	1	0	0
4	15799413	.	G	A	6	5	11	0	2	13	0	0
4	15799452	.	G	T	5	3	8	0	0	8	0	0
4	15799488	.	T	C	1	1	2	0	0	2	0	0
4	15816414	.	G	A	0	9	9	0	15	24	0	0
4	15981260	.	A	G	9	14	23	1	0	24	0	0
4	15981266	.	C	T	10	15	25	1	0	26	0	0
4	15981362	.	T	C	10	16	26	0	2	28	0	0
4	15981428	.	C	T	5	12	17	0	2	19	0	0
4	15984753	.	C	T	1	1	2	0	0	2	0	0
4	15989142	.	G	A	0	0	0	0	1	1	0	0
4	15989313	.	A	C	2	1	3	0	0	3	0	0
4	15989643	.	T	C	3	2	5	0	0	5	0	0
4	15989661	.	A	G	2	1	3	0	0	3	0	0
4	15989988	.	C	T	9	6	15	0	0	15	0	0
4	15991026	.	C	T	4	9	13	0	1	14	0	0
4	15992146	.	G	A	21	17	38	0	0	38	0	0
4	15992206	.	T	C	14	8	22	0	1	23	0	0
4	15993801	.	C	T	5	1	6	0	0	6	0	0
4	15993917	.	G	C	2	3	5	0	0	5	0	0
4	15993959	.	C	T	9	15	24	0	1	25	0	0
4	15995876	.	A	G	10	15	25	0	1	26	0	0
4	15996044	.	T	C	11	10	21	0	2	23	0	0
4	15996066	.	C	G	10	7	17	0	0	17	0	0
4	16001060	.	T	A	5	2	7	0	0	7	0	0
4	16077260	.	T	C	22	12	34	0	2	36	0	0
4	16078080	.	A	T	12	13	25	0	2	27	0	0
4	16078203	.	C	T	22	18	40	0	0	40	0	0
4	16078531	.	G	A	5	6	11	0	14	25	0	0
4	16078979	.	A	G	16	20	36	0	2	38	0	0
4	16081306	.	G	T	18	16	34	0	1	35	0	0
4	16085420	.	T	G	15	18	33	0	0	33	0	0
4	16086969	.	A	G	3	1	4	0	0	4	0	0
4	16086987	.	C	G	3	2	5	0	0	5	0	0
4	16087595	.	T	G	6	6	12	0	1	13	0	0
4	16088528	.	C	T	14	5	19	0	0	19	0	0
4	16088622	.	T	C	8	0	8	0	8	16	0	0
4	16088673	.	C	T	3	1	4	0	1	5	0	0
4	16090262	.	A	G	6	8	14	0	0	14	0	0
4	16098903	.	A	C	11	16	27	0	1	28	0	0
4	16098930	.	C	T	2	12	14	0	1	15	0	0
4	16111890	.	A	T	7	7	14	0	0	14	0	0
4	16112013	.	C	T	11	8	19	0	0	19	0	0
4	16318963	.	G	A	0	0	0	0	1	1	0	0
4	16319377	.	C	T	1	5	6	0	1	7	0	0
4	16319839	.	T	A	4	3	7	0	0	7	0	0
4	16368805	.	T	C	11	0	11	0	6	17	0	0
4	16368977	.	G	A	7	5	12	0	0	12	0	0
4	16369033	.	T	A	11	6	17	0	1	18	0	0
4	16369440	.	C	T	6	2	8	0	0	8	0	0
4	16380491	.	G	C	0	0	0	0	1	1	0	0
4	16382917	.	A	G	4	2	6	0	0	6	0	0
4	16536946	.	C	A	21	15	36	0	1	37	0	0
4	16537045	.	T	C	19	12	31	0	1	32	0	0
4	16537099	.	A	T	21	23	44	0	4	48	0	0
4	16537575	.	T	G	30	21	51	0	1	52	0	0
4	16537770	.	G	A	25	26	51	0	2	53	0	0
4	16538055	.	T	A	12	11	23	0	4	27	0	0
4	16539253	.	A	G	17	21	38	0	4	42	0	0
4	16615212	.	A	C	1	0	1	0	2	3	0	0
4	16615258	.	C	T	1	2	3	0	0	3	0	0
4	16632415	.	G	A	4	6	10	0	0	10	0	0
4	16632650	.	A	T	15	6	21	0	0	21	0	0
4	16632762	.	A	T	7	6	13	0	0	13	0	0
4	16632907	.	T	A	3	3	6	0	1	7	0	0
4	16633208	.	C	T	6	4	10	0	0	10	0	0
4	16633481	.	C	T	0	4	4	0	7	11	0	0
4	16634733	.	A	T	0	3	3	0	1	4	0	0
4	16634738	.	T	C	1	3	4	0	0	4	0	0
4	16634916	.	A	G	7	8	15	0	1	16	0	0
4	16634929	.	A	T	7	6	13	0	1	14	0	0
4	16635162	.	G	A	6	4	10	0	0	10	0	0
4	16635208	.	G	A	6	5	11	0	1	12	0	0
4	16635326	.	T	C	10	0	10	0	3	13	0	0
4	16635710	.	T	C	9	7	16	0	1	17	0	0
4	16638015	.	T	C	2	2	4	0	0	4	0	0
4	16638021	.	T	G	1	3	4	0	1	5	0	0
4	16641677	.	T	C	5	5	10	0	0	10	0	0
4	16650102	.	T	C	8	8	16	0	0	16	0	0
4	16650142	.	A	T	10	12	22	0	1	23	0	0
4	16650433	.	A	C	15	16	31	0	1	32	0	0
4	16650482	.	T	C	18	14	32	0	0	32	0	0
4	16650611	.	T	G	7	6	13	0	0	13	0	0
4	16650618	.	A	G	6	6	12	0	0	12	0	0
4	16651010	.	G	C	12	0	12	0	7	19	0	0
4	16651046	.	G	C	8	4	12	0	1	13	0	0
4	16651121	.	A	G	10	6	16	0	0	16	0	0
4	16651414	.	G	A	12	6	18	0	2	20	0	0
4	16652890	.	A	G	1	3	4	0	0	4	0	0
4	16654337	.	G	C	9	3	12	0	1	13	0	0
4	16654349	.	C	T	0	4	4	0	12	16	0	0
4	16659679	.	G	A	0	2	2	0	0	2	0	0
4	16666267	.	C	T	4	2	6	0	0	6	0	0
4	16671133	.	T	C	1	3	4	0	1	5	0	0
4	16671232	.	C	T	0	1	1	0	3	4	0	0
4	16672481	.	G	T	5	4	9	0	0	9	0	0
4	16672771	.	C	T	10	5	15	0	3	18	0	0
4	16680671	.	T	G	3	5	8	0	0	8	0	0
4	16680674	.	T	G	3	6	9	0	0	9	0	0
4	16706889	.	A	T	5	1	6	0	1	7	0	0
4	16733585	.	G	A	1	0	1	0	0	1	0	0
4	16733984	.	C	T	2	4	6	0	0	6	0	0
4	16741979	.	T	G	3	5	8	0	1	9	0	0
4	16742444	.	G	C	15	15	30	0	0	30	0	0
4	16784840	.	G	T	12	9	21	0	0	21	0	0
4	16784876	.	C	T	1	0	1	0	0	1	0	0
4	16785393	.	A	G	21	15	36	0	1	37	0	0
4	16785664	.	A	T	20	13	33	0	1	34	0	0
4	16785766	.	T	C	10	2	12	0	0	12	0	0
4	16785840	.	C	T	1	1	2	0	1	3	0	0
4	16786002	.	C	A	2	5	7	0	2	9	0	0
4	16786077	.	G	A	2	8	10	0	1	11	0	0
4	16786208	.	C	T	3	9	12	0	1	13	0	0
4	16791616	.	G	A	0	3	3	0	0	3	0	0
4	16791673	.	C	A	5	4	9	0	0	9	0	0
4	16791780	.	A	G	5	0	5	0	8	13	0	0
4	16791781	.	G	C	5	7	12	0	1	13	0	0
4	16791883	.	T	A	3	4	7	0	0	7	0	0
4	16797045	.	A	G	0	1	1	0	0	1	0	0
4	16829355	.	T	C	32	34	66	0	1	67	0	0
4	16829387	.	T	G	26	35	61	0	3	64	0	0
4	16829651	.	G	A	21	39	60	0	5	65	0	0
4	16831399	.	A	T	11	15	26	0	0	26	0	0
4	16832124	.	C	A	1	17	18	0	13	31	0	0
4	16832894	.	G	A	9	6	15	0	0	15	0	0
4	16858074	.	A	T	4	2	6	0	0	6	0	0
4	16858075	.	A	G	4	2	6	0	0	6	0	0
4	16858289	.	G	C	4	0	4	0	4	8	0	0
4	16858442	.	C	G	0	5	5	0	4	9	0	0
4	16876881	.	A	T	2	2	4	0	1	5	0	0
4	16877387	.	C	T	0	12	12	0	15	27	0	0
4	16879505	.	T	C	11	0	11	0	12	23	0	0
4	16881865	.	T	G	1	2	3	0	0	3	0	0
4	16885898	.	A	T	3	6	9	0	2	11	0	0
4	16889709	.	C	T	2	4	6	0	2	8	0	0
4	16889745	.	G	A	0	1	1	0	0	1	0	0
4	16893050	.	A	G	1	1	2	0	0	2	0	0
4	16893062	.	T	C	1	2	3	0	1	4	0	0
4	16898904	.	A	T	3	9	12	0	0	12	0	0
4	16899273	.	T	C	5	4	9	0	1	10	0	0
4	16904521	.	C	G	15	13	28	0	2	30	0	0
4	16904527	.	A	G	14	1	15	0	12	27	0	0
4	16905090	.	T	C	12	10	22	0	1	23	0	0
4	16905119	.	T	C	15	7	22	0	1	23	0	0
4	16905184	.	T	C	13	12	25	0	2	27	0	0
4	16905224	.	A	G	9	9	18	0	2	20	0	0
4	16905318	.	G	A	11	11	22	0	0	22	0	0
4	16905370	.	G	A	10	4	14	0	0	14	0	0
4	16905410	.	C	A	5	3	8	0	0	8	0	0
4	16905511	.	C	T	7	6	13	0	1	14	0	0
4	16905684	.	T	G	9	18	27	0	1	28	0	0
4	16905708	.	T	A	13	20	33	0	1	34	0	0
4	16905723	.	C	A	11	19	30	0	3	33	0	0
4	16905853	.	T	A	16	12	28	0	2	30	0	0
4	16906173	.	C	A	12	17	29	0	2	31	0	0
4	16906198	.	C	A	11	16	27	0	3	30	0	0
4	16906244	.	A	T	15	16	31	0	0	31	0	0
4	16906562	.	G	A	11	27	38	0	1	39	0	0
4	16982269	.	G	A	15	15	30	0	1	31	0	0
4	16982682	.	C	A	4	11	15	0	0	15	0	0
4	16983131	.	A	G	6	4	10	0	0	10	0	0
4	16983183	.	G	A	7	4	11	0	0	11	0	0
4	16983434	.	T	C	18	0	18	0	18	36	0	0
4	16984252	.	C	G	9	6	15	0	0	15	0	0
4	16984542	.	A	G	9	3	12	0	1	13	0	0
4	16985045	.	C	T	4	7	11	0	1	12	0	0
4	16988139	.	A	G	7	11	18	0	1	19	0	0
4	17008995	.	A	G	2	1	3	0	0	3	0	0
4	17251623	.	T	C	2	3	5	0	1	6	0	0
4	17253737	.	A	G	10	4	14	0	0	14	0	0
4	17253758	.	C	T	7	7	14	0	1	15	0	0
4	17253813	.	A	C	7	5	12	0	0	12	0	0
4	17253818	.	A	G	6	3	9	0	1	10	0	0
4	17253925	.	T	A	11	6	17	0	0	17	0	0
4	17253927	.	T	A	11	5	16	0	1	17	0	0
4	17254046	.	A	G	9	9	18	0	0	18	0	0
4	17256855	.	C	T	0	2	2	0	0	2	0	0
4	17257386	.	G	A	1	1	2	0	0	2	0	0
4	17257458	.	C	T	1	5	6	0	0	6	0	0
4	17287446	.	T	G	5	4	9	0	0	9	0	0
4	17288964	.	T	C	5	20	25	0	0	25	0	0
4	17291024	.	A	G	11	19	30	0	1	31	0	0
4	17292575	.	C	A	5	3	8	0	2	10	0	0
4	17292770	.	G	A	10	1	11	0	2	13	0	0
4	17292789	.	A	C	14	7	21	0	1	22	0	0
4	17292837	.	A	G	19	19	38	0	1	39	0	0
4	17294947	.	T	C	1	0	1	0	0	1	0	0
4	17296974	.	A	G	5	17	22	0	0	22	0	0
4	17297086	.	C	A	13	19	32	0	0	32	0	0
4	17297338	.	T	G	8	10	18	0	0	18	0	0
4	17326234	.	C	T	2	2	4	0	0	4	0	0
4	17326465	.	A	C	1	3	4	0	0	4	0	0
4	17338664	.	T	C	8	4	12	0	1	13	0	0
4	17353770	.	G	C	1	2	3	0	0	3	0	0
4	17353776	.	A	C	1	2	3	0	0	3	0	0
4	17359889	.	T	C	1	1	2	0	0	2	0	0
4	17359901	.	G	A	1	1	2	0	0	2	0	0
4	17369451	.	T	C	4	2	6	0	0	6	0	0
4	17382830	.	T	C	2	0	2	0	1	3	0	0
4	17382833	.	A	G	2	1	3	0	0	3	0	0
4	17384624	.	A	T	0	3	3	0	0	3	0	0
4	17418109	.	G	A	1	4	5	0	0	5	0	0
4	17533769	.	C	T	2	2	4	0	0	4	0	0
4	17536140	.	T	G	1	0	1	0	1	2	0	0
4	17537639	.	A	G	5	3	8	0	1	9	0	0
4	17539261	.	T	G	3	2	5	0	0	5	0	0
4	17541666	.	A	G	0	4	4	0	0	4	0	0
4	17545083	.	A	G	0	1	1	0	0	1	0	0
4	17572583	.	C	T	11	18	29	0	3	32	0	0
4	17572589	.	C	A	10	14	24	0	2	26	0	0
4	17572898	.	T	C	14	12	26	0	1	27	0	0
4	17572901	.	A	C	13	13	26	0	1	28	1	0
4	17573071	.	A	T	7	6	13	0	1	14	0	0
4	17573081	.	G	C	8	7	15	0	0	15	0	0
4	17573464	.	A	G	9	13	22	0	0	22	0	0
4	17573465	.	A	G	9	13	22	0	0	22	0	0
4	17573594	.	T	A	8	7	15	0	1	16	0	0
4	17573616	.	A	G	9	4	13	0	0	13	0	0
4	17573802	.	T	C	12	13	25	0	2	27	0	0
4	17573841	.	A	G	14	13	27	0	5	32	0	0
4	17573865	.	T	A	11	18	29	0	6	35	0	0
4	17573959	.	T	A	13	7	20	0	2	22	0	0
4	17573982	.	A	T	10	8	18	0	2	20	0	0
4	17574093	.	A	G	11	16	27	0	0	27	0	0
4	17574390	.	C	T	7	16	23	0	3	26	0	0
4	17574608	.	A	C	9	10	19	0	0	19	0	0
4	17574706	.	T	C	6	4	10	0	0	10	0	0
4	17580468	.	A	T	2	0	2	0	0	2	0	0
4	17596433	.	T	C	6	1	7	0	20	27	0	0
4	17596490	.	T	C	9	7	16	0	0	16	0	0
4	17629138	.	C	T	0	7	7	0	13	20	0	0
4	17629266	.	C	A	9	3	12	0	0	12	0	0
4	17635891	.	A	G	2	1	3	0	0	3	0	0
4	17635900	.	G	T	2	1	3	0	0	3	0	0
4	17641651	.	T	C	2	3	5	0	0	5	0	0
4	17643448	.	T	C	1	2	3	0	0	3	0	0
4	17644600	.	T	C	2	4	6	0	0	6	0	0
4	17644913	.	A	G	3	3	6	0	0	6	0	0
4	17644964	.	G	A	0	1	1	0	0	1	0	0
4	17645408	.	T	C	3	3	6	0	0	6	0	0
4	17645890	.	A	C	3	1	4	0	0	4	0	0
4	17645962	.	C	T	2	2	4	0	0	4	0	0
4	17653340	.	T	C	5	2	7	0	0	7	0	0
4	17657549	.	A	G	3	0	3	0	3	6	0	0
4	17660859	.	G	A	2	5	7	0	0	7	0	0
4	17660871	.	A	G	2	2	4	0	0	4	0	0
4	17661191	.	T	C	6	2	8	0	0	8	0	0
4	17661200	.	C	T	5	2	7	0	0	7	0	0
4	17661265	.	A	G	2	2	4	0	0	4	0	0
4	17661349	.	C	T	4	4	8	0	0	8	0	0
4	17661354	.	T	G	4	3	7	0	0	7	0	0
4	17684505	.	C	T	1	1	2	0	0	2	0	0
4	17688726	.	G	A	1	2	3	0	0	3	0	0
4	17688795	.	T	C	3	3	6	0	1	7	0	0
4	17688849	.	T	C	4	5	9	0	0	9	0	0
4	17688874	.	T	C	6	9	15	0	0	15	0	0
4	17688897	.	C	T	6	6	12	0	1	13	0	0
4	17689128	.	C	T	1	2	3	0	0	3	0	0
4	17689133	.	A	T	1	2	3	0	0	3	0	0
4	17693223	.	C	T	1	2	3	0	0	3	0	0
4	17693232	.	C	T	1	2	3	0	1	4	0	0
4	17693286	.	T	C	7	5	12	0	0	12	0	0
4	17693400	.	A	G	2	1	3	0	0	3	0	0
4	17696341	.	A	G	3	0	3	0	5	8	0	0
4	17704067	.	G	A	1	1	2	0	0	2	0	0
4	17704123	.	T	C	5	3	8	0	2	10	0	0
4	17704279	.	T	A	4	3	7	0	0	7	0	0
4	17704345	.	C	T	5	5	10	0	0	10	0	0
4	17704560	.	A	G	3	3	6	0	0	6	0	0
4	17704842	.	A	G	4	2	6	0	0	6	0	0
4	17704885	.	T	C	5	3	8	0	1	9	0	0
4	17704915	.	A	T	6	4	10	0	0	10	0	0
4	17708230	.	T	C	6	2	8	0	1	9	0	0
4	17708346	.	G	A	5	2	7	0	0	7	0	0
4	17712719	.	A	G	1	1	2	0	0	2	0	0
4	17822279	.	G	A	3	3	6	0	0	6	0	0
4	17853738	.	T	C	2	1	3	0	0	3	0	0
4	17873351	.	A	G	4	5	9	0	0	9	0	0
4	17873530	.	T	G	5	6	11	0	0	11	0	0
4	17873711	.	A	T	5	3	8	0	1	9	0	0
4	17873743	.	C	T	3	5	8	0	0	8	0	0
4	17873787	.	G	A	0	5	5	0	2	7	0	0
4	17873808	.	G	C	3	2	5	0	0	5	0	0
4	17874009	.	T	A	2	4	6	0	1	7	0	0
4	17874010	.	G	A	2	5	7	0	0	7	0	0
4	17886974	.	G	A	16	23	39	0	2	41	0	0
4	17887059	.	T	C	16	7	23	0	2	25	0	0
4	17887388	.	A	T	17	16	33	0	0	34	1	0
4	17887826	.	C	T	22	19	41	0	3	44	0	0
4	17887885	.	A	C	15	14	29	0	6	35	0	0
4	17902098	.	A	G	10	19	29	0	1	30	0	0
4	17904325	.	A	C	11	1	12	0	8	20	0	0
4	17915070	.	G	A	3	6	9	0	0	9	0	0
4	17949261	.	C	T	13	7	20	0	0	20	0	0
4	17999310	.	C	A	0	3	3	0	2	5	0	0
4	18067311	.	C	T	0	2	2	0	1	3	0	0
4	18208068	.	A	G	8	8	16	0	1	17	0	0
4	18208347	.	C	G	2	3	5	0	0	5	0	0
4	18208519	.	A	G	3	4	7	0	0	7	0	0
4	18208557	.	C	A	4	2	6	0	0	6	0	0
4	18208569	.	T	C	4	2	6	0	0	6	0	0
4	18208635	.	T	A	2	3	5	0	0	5	0	0
4	18208760	.	G	A	6	2	8	0	0	8	0	0
4	18208769	.	A	G	4	3	7	0	0	7	0	0
4	18208939	.	C	T	4	3	7	0	1	8	0	0
4	18209107	.	G	C	5	6	11	0	1	12	0	0
4	18209185	.	A	T	10	1	11	0	2	13	0	0
4	18213267	.	C	T	2	11	13	0	0	13	0	0
4	18216182	.	A	G	5	4	9	0	3	12	0	0
4	18216251	.	T	C	7	8	15	0	0	15	0	0
4	18216332	.	A	G	10	6	16	0	1	17	0	0
4	18235106	.	T	C	1	5	6	0	0	6	0	0
4	18235397	.	A	T	6	3	9	0	0	9	0	0
4	18237355	.	A	G	6	3	9	0	1	10	0	0
4	18240356	.	A	G	2	4	6	0	0	6	0	0
4	18240451	.	G	A	3	2	5	0	0	5	0	0
4	18240536	.	G	T	5	3	8	0	0	8	0	0
4	18240546	.	C	T	0	3	3	0	3	6	0	0
4	18240640	.	C	G	4	2	6	0	0	6	0	0
4	18240658	.	T	C	3	3	6	0	0	6	0	0
4	18240690	.	A	T	1	3	4	0	0	4	0	0
4	18240811	.	G	A	6	3	9	0	1	10	0	0
4	18240822	.	G	A	5	4	9	0	0	9	0	0
4	18241255	.	C	G	5	5	10	0	0	10	0	0
4	18241297	.	C	T	2	5	7	0	0	7	0	0
4	18242936	.	G	T	2	3	5	0	0	5	0	0
4	18244632	.	T	A	2	1	3	0	2	5	0	0
4	18244669	.	G	A	2	3	5	0	0	5	0	0
4	18244670	.	G	C	2	0	2	0	3	5	0	0
4	18248692	.	C	T	0	2	2	0	3	5	0	0
4	18249414	.	T	C	1	1	2	0	0	2	0	0
4	18249423	.	G	T	1	1	2	0	1	3	0	0
4	18250996	.	G	A	1	2	3	0	0	3	0	0
4	18287263	.	T	C	1	2	3	0	0	3	0	0
4	18287410	.	T	C	0	0	0	0	1	1	0	0
4	18416429	.	A	G	2	3	5	0	0	5	0	0
4	18416462	.	T	G	2	2	4	0	0	4	0	0
4	18449062	.	G	A	2	0	2	0	0	2	0	0
4	18449080	.	T	C	2	0	2	0	0	2	0	0
4	18454352	.	A	G	3	10	13	0	1	14	0	0
4	18454363	.	T	A	3	10	13	0	1	14	0	0
4	18454400	.	C	T	0	7	7	0	4	11	0	0
4	18454423	.	G	A	3	4	7	0	1	8	0	0
4	18502437	.	A	G	3	2	5	0	0	5	0	0
4	18505827	.	G	A	1	2	3	0	0	3	0	0
4	18592863	.	A	C	9	6	15	0	1	16	0	0
4	18592916	.	T	A	1	4	5	0	0	5	0	0
4	18593839	.	G	A	15	7	22	0	5	27	0	0
4	18593989	.	T	A	8	7	15	0	5	20	0	0
4	18594789	.	T	G	3	3	6	0	0	6	0	0
4	18594871	.	T	C	4	3	7	0	2	9	0	0
4	18594920	.	G	A	8	9	17	0	2	19	0	0
4	18597841	.	C	G	13	11	24	0	2	26	0	0
4	18606501	.	G	T	1	5	6	0	1	7	0	0
4	18606512	.	C	T	3	7	10	0	0	10	0	0
4	18609613	.	T	G	2	2	4	0	0	4	0	0
4	18609759	.	C	G	4	3	7	0	0	7	0	0
4	18609769	.	A	G	3	3	6	0	0	6	0	0
4	18609812	.	A	C	3	2	5	0	0	5	0	0
4	18609855	.	G	C	2	4	6	0	0	6	0	0
4	18614367	.	A	G	4	2	6	0	0	6	0	0
4	18614484	.	G	A	0	1	1	0	0	1	0	0
4	18632270	.	A	C	0	0	0	0	1	1	0	0
4	18632276	.	A	G	0	1	1	0	0	1	0	0
4	18713577	.	A	C	2	2	4	0	0	4	0	0
4	18720871	.	C	T	2	2	4	0	0	4	0	0
4	18720942	.	C	T	1	2	3	0	1	4	0	0
4	18737966	.	T	G	0	1	1	0	0	1	0	0
4	18741886	.	T	C	1	4	5	0	0	5	0	0
4	18837898	.	A	T	6	3	9	0	3	12	0	0
4	18853153	.	C	T	2	7	9	0	0	9	0	0
4	18853972	.	C	G	10	12	22	0	2	24	0	0
4	18854250	.	A	C	9	1	10	0	14	24	0	0
4	18963897	.	G	A	0	3	3	0	14	17	0	0
4	18963908	.	C	A	11	4	15	0	0	15	0	0
4	18963960	.	G	C	6	3	9	0	0	9	0	0
4	18976182	.	A	G	3	1	4	0	1	5	0	0
4	18976574	.	C	T	1	1	2	0	0	2	0	0
4	18979820	.	T	A	3	3	6	0	0	6	0	0
4	18985807	.	T	A	15	17	32	0	0	32	0	0
4	18985846	.	A	G	12	20	32	0	1	33	0	0
4	18985995	.	G	A	10	9	19	0	0	19	0	0
4	18986107	.	C	T	2	2	4	0	2	6	0	0
4	18986282	.	T	C	6	1	7	0	7	14	0	0
4	18986293	.	T	G	6	6	12	0	1	13	0	0
4	18986413	.	G	A	6	17	23	0	1	24	0	0
4	18986497	.	C	T	0	13	13	0	14	27	0	0
4	18986771	.	A	T	8	7	15	0	0	15	0	0
4	18986805	.	G	T	8	6	14	0	0	14	0	0
4	18986893	.	C	G	4	5	9	0	1	10	0	0
4	18986897	.	T	A	4	6	10	0	0	10	0	0
4	18987202	.	C	A	6	5	11	0	0	11	0	0
4	18987216	.	T	C	6	6	12	0	0	12	0	0
4	18987250	.	G	A	6	7	13	0	1	14	0	0
4	18987275	.	A	G	9	7	16	0	1	17	0	0
4	18987391	.	G	A	9	8	17	0	0	17	0	0
4	18987523	.	T	C	10	8	18	0	1	19	0	0
4	18987835	.	G	C	7	0	7	0	19	26	0	0
4	18988068	.	T	C	6	0	6	0	10	16	0	0
4	18988084	.	G	A	8	9	17	0	0	17	0	0
4	18988150	.	T	G	9	9	18	0	0	18	0	0
4	18988270	.	T	A	6	3	9	0	0	9	0	0
4	18988426	.	G	C	6	11	17	0	0	17	0	0
4	18988912	.	G	A	8	9	17	0	0	17	0	0
4	18989185	.	T	C	3	0	3	0	7	10	0	0
4	18999680	.	C	T	0	1	1	0	3	4	0	0
4	19007158	.	C	T	0	0	0	0	1	1	0	0
4	19007377	.	T	A	6	3	9	0	1	10	0	0
4	19007486	.	A	C	7	4	11	0	0	11	0	0
4	19007711	.	T	C	4	0	4	0	8	12	0	0
4	19007811	.	T	C	4	9	13	0	0	13	0	0
4	19007823	.	A	G	3	10	13	0	0	13	0	0
4	19008090	.	C	T	0	6	6	0	1	7	0	0
4	19397640	.	A	T	15	7	22	0	0	22	0	0
4	19414905	.	G	A	4	2	6	0	1	7	0	0
4	19493773	.	G	T	7	7	14	0	0	14	0	0
4	19493808	.	G	A	8	11	19	0	0	19	0	0
4	19535841	.	T	G	11	11	22	0	1	23	0	0
4	19536422	.	T	C	17	15	32	0	0	32	0	0
4	19536917	.	C	T	21	14	35	0	1	36	0	0
4	19537703	.	A	G	34	23	57	0	0	57	0	0
4	19537937	.	A	G	22	0	22	0	26	48	0	0
4	19539017	.	C	T	8	9	17	0	0	17	0	0
4	19567605	.	A	G	12	5	17	0	0	17	0	0
4	19611694	.	G	A	2	4	6	0	0	6	0	0
4	19611739	.	T	G	2	5	7	0	0	7	0	0
4	19630280	.	A	G	2	1	3	0	0	3	0	0
4	19651917	.	G	A	1	1	2	0	0	2	0	0
4	19690484	.	C	A	0	0	0	0	1	1	0	0
4	19947781	.	G	T	1	2	3	0	1	4	0	0
4	19948131	.	G	A	4	3	7	0	0	7	0	0
4	19948312	.	A	G	6	4	10	0	0	10	0	0
4	19948313	.	A	G	6	4	10	0	0	10	0	0
4	19948467	.	T	C	3	3	6	0	0	6	0	0
4	19948746	.	T	C	1	3	4	0	1	5	0	0
4	19949148	.	T	C	3	5	8	0	1	9	0	0
4	19949178	.	A	T	2	7	9	0	0	9	0	0
4	19949730	.	T	C	3	4	7	0	0	7	0	0
4	19949985	.	T	C	4	5	9	0	0	9	0	0
4	19950212	.	A	C	2	2	4	0	0	4	0	0
4	19950657	.	A	C	2	3	5	0	0	5	0	0
4	19954907	.	G	C	3	0	3	0	3	6	0	0
4	20049349	.	G	T	3	2	5	0	1	6	0	0
4	20049543	.	C	T	31	22	53	0	0	53	0	0
4	20051021	.	A	G	16	31	47	0	1	48	0	0
4	20051092	.	C	T	0	18	18	0	15	33	0	0
4	20053199	.	T	C	10	12	22	0	0	22	0	0
4	20053211	.	A	G	9	10	19	0	1	20	0	0
4	20053901	.	C	T	15	11	26	0	1	27	0	0
4	20054036	.	C	T	14	14	28	0	0	28	0	0
4	20054135	.	A	G	2	6	8	0	0	8	0	0
4	20054190	.	T	G	4	2	6	0	0	6	0	0
4	20054243	.	A	G	7	3	10	0	1	11	0	0
4	20054516	.	C	T	5	3	8	0	0	8	0	0
4	20060589	.	A	G	2	0	2	0	2	4	0	0
4	20066194	.	T	G	2	3	5	0	0	5	0	0
4	20066208	.	G	A	1	4	5	0	0	5	0	0
4	20066263	.	T	C	4	4	8	0	1	9	0	0
4	20068149	.	T	G	4	4	8	0	0	9	1	0
4	20068185	.	A	G	3	5	8	0	0	8	0	0
4	20068266	.	A	G	5	8	13	0	1	14	0	0
4	20068446	.	G	A	6	9	15	0	0	15	0	0
4	20068470	.	C	G	7	7	14	0	0	14	0	0
4	20068890	.	G	A	3	10	13	0	0	13	0	0
4	20068903	.	T	C	4	10	14	0	0	14	0	0
4	20069091	.	T	C	8	6	14	0	0	14	0	0
4	20069343	.	C	A	7	11	18	0	0	18	0	0
4	20071877	.	C	T	0	3	3	0	4	7	0	0
4	20072394	.	C	G	4	5	9	0	1	10	0	0
4	20072429	.	T	G	4	10	14	0	0	14	0	0
4	20081451	.	A	G	2	1	3	0	0	3	0	0
4	20081520	.	C	A	0	3	3	0	2	5	0	0
4	20089075	.	C	A	1	4	5	0	0	5	0	0
4	20091055	.	G	C	1	4	5	0	4	9	0	0
4	20098793	.	C	G	2	4	6	0	0	6	0	0
4	20099022	.	G	A	1	5	6	0	0	6	0	0
4	20099261	.	C	T	4	4	8	0	0	8	0	0
4	20099516	.	G	A	0	4	4	0	6	10	0	0
4	20099564	.	C	T	2	3	5	0	0	5	0	0
4	20101105	.	G	T	4	9	13	0	0	13	0	0
4	20103813	.	T	A	1	2	3	0	0	3	0	0
4	20103864	.	G	A	1	2	3	0	0	3	0	0
4	20103873	.	T	C	1	1	2	0	0	2	0	0
4	20105455	.	T	A	0	3	3	0	1	4	0	0
4	20130216	.	T	C	1	2	3	0	0	3	0	0
4	20142829	.	A	G	2	2	4	0	1	5	0	0
4	20150138	.	G	T	1	2	3	0	0	3	0	0
4	20226677	.	A	G	3	1	4	0	0	4	0	0
4	20226826	.	T	C	3	2	5	0	0	5	0	0
4	20226916	.	A	C	0	2	2	0	0	2	0	0
4	20229626	.	C	T	1	7	8	0	0	8	0	0
4	20229920	.	C	A	0	11	11	0	7	18	0	0
4	20230213	.	G	A	7	3	10	0	0	10	0	0
4	20232838	.	A	G	1	2	3	0	0	3	0	0
4	20235766	.	G	A	8	8	16	0	2	18	0	0
4	20265275	.	A	T	1	2	3	0	0	3	0	0
4	20265309	.	C	T	5	5	10	0	0	10	0	0
4	20303381	.	C	T	0	0	0	0	1	1	0	0
4	20303423	.	T	C	2	1	3	0	0	3	0	0
4	20303604	.	T	C	1	1	2	0	0	2	0	0
4	20305520	.	G	T	1	3	4	0	0	4	0	0
4	20305777	.	T	G	2	4	6	0	1	7	0	0
4	20447754	.	A	G	4	2	6	0	0	6	0	0
4	20464937	.	C	T	1	0	1	0	0	1	0	0
4	20465711	.	T	C	2	1	3	0	0	3	0	0
4	20465899	.	C	T	3	1	4	0	0	4	0	0
4	20467610	.	T	C	1	3	4	0	0	4	0	0
4	20470061	.	G	A	7	9	16	0	0	16	0	0
4	20470205	.	C	T	8	12	20	0	0	20	0	0
4	20470316	.	C	T	5	3	8	0	0	8	0	0
4	20473032	.	G	A	15	8	23	0	1	24	0	0
4	20473127	.	G	A	0	5	5	0	9	14	0	0
4	20473142	.	C	T	9	4	13	0	0	13	0	0
4	20473175	.	C	T	9	8	17	0	0	17	0	0
4	20474728	.	A	T	3	5	8	0	2	10	0	0
4	20474969	.	A	G	7	1	8	0	5	13	0	0
4	20480734	.	G	A	4	2	6	0	0	6	0	0
4	20482150	.	T	C	3	0	3	0	2	5	0	0
4	20482425	.	A	G	8	5	13	0	1	14	0	0
4	20482506	.	C	T	8	4	12	0	0	12	0	0
4	20482615	.	G	T	5	7	12	0	0	12	0	0
4	20482726	.	A	G	5	3	8	0	0	8	0	0
4	20483846	.	T	G	4	4	8	0	0	8	0	0
4	20483881	.	C	T	3	5	8	0	0	8	0	0
4	20483901	.	G	A	3	3	6	0	0	6	0	0
4	20483918	.	A	G	2	3	5	0	0	5	0	0
4	20486087	.	T	A	1	3	4	0	0	4	0	0
4	20494332	.	C	T	9	3	12	0	0	12	0	0
4	20496653	.	A	G	4	2	6	0	0	6	0	0
4	20496655	.	C	T	4	2	6	0	0	6	0	0
4	20499421	.	G	C	2	2	4	0	0	4	0	0
4	20499440	.	A	G	2	4	6	0	0	6	0	0
4	20499493	.	T	G	1	5	6	0	0	6	0	0
4	20499516	.	G	T	2	4	6	0	0	6	0	0
4	20507121	.	T	A	9	7	16	0	2	18	0	0
4	20507155	.	A	C	14	13	27	0	0	27	0	0
4	20507546	.	T	A	4	7	11	0	1	12	0	0
4	20508691	.	G	A	0	2	2	0	0	2	0	0
4	20508913	.	A	G	4	14	18	0	3	21	0	0
4	20508928	.	A	G	6	13	19	0	0	19	0	0
4	20508992	.	C	T	10	12	22	0	0	22	0	0
4	20949623	.	G	C	1	1	2	0	0	2	0	0
4	20951390	.	C	T	2	3	5	0	0	5	0	0
4	20952889	.	C	T	2	1	3	0	0	3	0	0
4	20953265	.	C	A	1	2	3	0	0	3	0	0
4	20965426	.	A	T	1	2	3	0	0	3	0	0
4	20965483	.	T	C	0	1	1	0	0	1	0	0
4	20971490	.	C	T	2	3	5	0	1	6	0	0
4	20974250	.	C	T	4	2	6	0	0	6	0	0
4	20974343	.	C	A	4	2	6	0	1	7	0	0
4	20979435	.	C	A	4	2	6	0	0	6	0	0
4	20981198	.	G	A	2	9	11	0	11	22	0	0
4	20981273	.	A	C	0	2	2	0	0	2	0	0
4	21290798	.	G	A	16	16	32	0	1	33	0	0
4	21295949	.	T	C	12	17	29	0	2	31	0	0
4	21297417	.	A	C	11	14	25	0	4	29	0	0
4	21312642	.	T	C	19	20	39	0	2	41	0	0
4	21312981	.	C	T	21	29	50	0	8	58	0	0
4	21313120	.	A	G	22	4	26	0	34	60	0	0
4	21313136	.	T	C	25	29	54	0	6	60	0	0
4	21313779	.	T	G	34	17	51	0	2	54	1	0
4	21313805	.	G	A	2	23	25	0	44	69	0	0
4	21314120	.	T	C	21	23	44	0	1	45	0	0
4	21314204	.	G	T	20	14	34	0	2	36	0	0
4	21314338	.	G	T	33	32	65	0	1	66	0	0
4	21314583	.	T	C	28	26	54	0	1	55	0	0
4	21323174	.	T	A	3	3	6	0	0	6	0	0
4	21323339	.	T	C	3	3	6	0	0	6	0	0
4	21323363	.	G	C	1	1	2	0	1	3	0	0
4	21323454	.	A	G	1	2	3	0	1	4	0	0
4	21323467	.	G	C	1	4	5	0	0	5	0	0
4	21323532	.	C	T	0	3	3	0	4	7	0	0
4	21323536	.	T	C	4	4	8	0	1	9	0	0
4	21369434	.	G	A	4	1	5	0	0	5	0	0
4	21489629	.	G	T	10	12	22	0	2	24	0	0
4	21490320	.	T	C	8	14	22	0	0	22	0	0
4	21490344	.	A	G	10	11	21	0	1	22	0	0
4	21499521	.	G	A	5	1	6	0	0	6	0	0
4	21507026	.	G	A	5	3	8	0	1	9	0	0
4	21508353	.	C	T	7	10	17	0	1	18	0	0
4	21512191	.	C	T	7	4	11	0	1	12	0	0
4	21517970	.	A	G	3	0	3	0	0	3	0	0
4	21523541	.	A	T	10	2	12	0	0	12	0	0
4	21523789	.	T	G	9	10	19	0	0	19	0	0
4	21525430	.	G	T	0	1	1	0	0	1	0	0
4	21526300	.	A	G	1	1	2	0	1	3	0	0
4	21649505	.	G	A	12	12	24	0	2	26	0	0
4	21651486	.	G	A	17	16	33	0	0	33	0	0
4	21752284	.	G	A	13	6	19	0	1	20	0	0
4	21752291	.	C	T	14	3	17	0	3	20	0	0
4	21752372	.	T	A	10	7	17	0	0	17	0	0
4	21752493	.	T	C	4	10	14	0	0	14	0	0
4	21752495	.	C	G	4	10	14	0	0	14	0	0
4	21752688	.	G	C	11	1	12	0	12	24	0	0
4	21752736	.	T	C	9	12	21	0	0	21	0	0
4	21752941	.	T	A	12	7	19	0	0	19	0	0
4	21752969	.	C	T	11	6	17	0	0	17	0	0
4	21752984	.	C	A	11	8	19	0	0	19	0	0
4	21753139	.	C	T	15	10	25	0	0	25	0	0
4	21753185	.	T	C	16	8	24	0	1	25	0	0
4	21753316	.	T	C	14	6	20	0	3	23	0	0
4	21753344	.	G	A	18	9	27	0	0	27	0	0
4	21761688	.	A	T	9	7	16	0	0	16	0	0
4	21957629	.	A	G	1	2	3	0	0	3	0	0
4	21958043	.	A	G	8	15	23	0	1	24	0	0
4	21958150	.	C	T	14	5	19	0	1	20	0	0
4	21958226	.	T	G	12	9	21	0	2	23	0	0
4	21958276	.	C	T	0	13	13	0	15	28	0	0
4	21973713	.	T	C	2	5	7	0	0	7	0	0
4	21975248	.	G	A	6	14	20	0	1	21	0	0
4	21975489	.	G	T	2	3	5	0	0	5	0	0
4	21981022	.	G	A	2	3	5	0	0	5	0	0
4	21981118	.	T	C	6	9	15	0	0	15	0	0
4	21988402	.	G	A	7	7	14	0	1	15	0	0
4	21988481	.	G	A	2	1	3	0	0	3	0	0
4	21998265	.	G	A	0	1	1	0	0	1	0	0
4	22006507	.	C	A	0	1	1	0	0	1	0	0
4	22016509	.	G	A	2	1	3	0	0	3	0	0
4	22016531	.	C	T	0	1	1	0	2	3	0	0
4	22033404	.	G	A	2	1	3	0	0	3	0	0
4	22299747	.	G	A	1	1	2	0	0	2	0	0
4	22299954	.	C	T	2	8	10	0	0	10	0	0
4	22300045	.	G	C	6	6	12	0	0	12	0	0
4	22300125	.	A	C	3	3	6	0	2	8	0	0
4	22300153	.	T	A	4	1	5	0	2	7	0	0
4	22300178	.	C	T	3	0	3	0	3	6	0	0
4	22313107	.	A	T	5	2	7	0	1	8	0	0
4	22313195	.	G	C	7	8	15	0	3	18	0	0
4	22313216	.	T	G	5	10	15	0	1	16	0	0
4	22313244	.	G	A	7	10	17	0	2	19	0	0
4	22313351	.	G	A	10	8	18	0	0	18	0	0
4	22313398	.	T	A	6	4	10	0	3	13	0	0
4	22313582	.	T	C	2	0	2	0	5	7	0	0
4	22313722	.	A	C	5	5	10	0	0	10	0	0
4	22314001	.	A	T	4	11	15	0	0	15	0	0
4	22314085	.	G	A	3	11	14	0	0	14	0	0
4	22316148	.	T	C	0	3	3	0	1	4	0	0
4	22316321	.	C	T	11	7	18	0	0	18	0	0
4	22316624	.	A	T	13	11	24	0	2	26	0	0
4	22317702	.	T	A	2	4	6	0	0	6	0	0
4	22318415	.	G	A	2	3	5	0	2	7	0	0
4	22318828	.	G	A	7	6	13	0	0	13	0	0
4	22319033	.	G	A	5	2	7	0	0	7	0	0
4	22319101	.	G	T	2	3	5	0	0	5	0	0
4	22319133	.	G	A	2	3	5	0	1	6	0	0
4	22319205	.	G	C	5	2	7	0	0	7	0	0
4	22319428	.	G	C	4	2	6	0	0	6	0	0
4	22319434	.	T	C	4	1	5	0	0	5	0	0
4	22319558	.	G	A	3	5	8	0	0	8	0	0
4	22319562	.	G	A	3	5	8	0	0	8	0	0
4	22320043	.	C	T	4	7	11	0	0	11	0	0
4	22321391	.	C	A	0	2	2	0	0	2	0	0
4	22321803	.	A	G	1	2	3	0	0	3	0	0
4	22322003	.	C	A	1	1	2	0	1	3	0	0
4	22327675	.	T	A	2	2	4	0	0	4	0	0
4	22329327	.	T	C	1	3	4	0	0	4	0	0
4	22353656	.	G	A	3	2	5	0	0	5	0	0
4	22363259	.	T	A	3	2	5	0	0	5	0	0
4	22363264	.	A	T	3	2	5	0	0	5	0	0
4	22365114	.	C	T	8	10	18	0	0	18	0	0
4	22365152	.	C	T	9	14	23	0	1	24	0	0
4	22365163	.	G	C	8	14	22	0	0	22	0	0
4	22365251	.	G	A	13	6	19	0	0	19	0	0
4	22365747	.	C	T	20	19	39	0	1	40	0	0
4	22419473	.	C	A	22	25	47	0	2	49	0	0
4	22419483	.	G	T	19	23	42	0	3	45	0	0
4	22419663	.	T	G	9	7	16	0	3	19	0	0
4	22424854	.	G	A	19	14	33	0	2	35	0	0
4	22424891	.	A	G	18	15	33	0	0	33	0	0
4	22425115	.	G	A	13	9	22	0	0	22	0	0
4	22428110	.	G	A	4	7	11	0	1	12	0	0
4	22428619	.	T	C	4	5	9	0	0	9	0	0
4	22428745	.	C	T	0	8	8	0	12	20	0	0
4	22428871	.	C	T	0	3	3	0	9	12	0	0
4	22430827	.	C	T	0	3	3	0	0	3	0	0
4	22432794	.	T	A	5	1	6	0	0	6	0	0
4	22432825	.	G	T	8	8	16	0	0	16	0	0
4	22433307	.	A	G	18	12	30	0	1	31	0	0
4	22433366	.	A	T	12	8	20	0	0	20	0	0
4	22433474	.	T	C	2	0	2	0	0	2	0	0
4	22438644	.	C	T	4	9	13	0	0	13	0	0
4	22440324	.	C	T	4	7	11	0	1	12	0	0
4	22445415	.	C	T	0	5	5	0	6	11	0	0
4	22472526	.	C	T	0	3	3	0	6	9	0	0
4	22472603	.	A	T	12	5	17	0	0	17	0	0
4	22756239	.	T	C	7	5	12	0	1	13	0	0
4	23636947	.	A	G	4	4	8	0	0	8	0	0
4	23636987	.	C	A	5	3	8	0	1	9	0	0
4	23740850	.	C	G	1	2	3	0	0	3	0	0
4	23741265	.	A	T	2	3	5	0	0	5	0	0
4	23741271	.	T	C	1	2	3	0	0	3	0	0
4	23773192	.	A	T	5	4	9	0	0	9	0	0
4	23773210	.	T	A	4	4	8	0	0	8	0	0
4	23773977	.	A	G	7	7	14	0	0	14	0	0
4	23773982	.	T	G	7	7	14	0	0	14	0	0
4	23774038	.	C	A	1	4	5	0	0	5	0	0
4	23775252	.	C	A	8	5	13	0	0	13	0	0
4	23775435	.	T	G	3	0	3	0	11	14	0	0
4	23775630	.	G	C	7	0	7	0	9	16	0	0
4	23775759	.	C	T	1	6	7	0	7	14	0	0
4	23775827	.	T	C	3	0	3	0	3	6	0	0
4	23887175	.	G	A	4	2	6	0	6	12	0	0
4	23887318	.	C	T	1	13	14	0	19	33	0	0
4	23887847	.	T	A	7	6	13	0	1	14	0	0
4	23888406	.	A	T	10	14	24	0	0	24	0	0
4	23892938	.	C	T	0	2	2	0	3	5	0	0
4	23892998	.	G	A	12	13	25	0	0	25	0	0
4	23893052	.	C	A	7	11	18	0	0	18	0	0
4	23913316	.	C	T	4	2	6	0	0	6	0	0
4	25054826	.	G	A	12	12	24	0	4	28	0	0
4	25055230	.	G	A	15	24	39	0	3	42	0	0
4	25055479	.	C	G	1	11	12	0	9	21	0	0
4	25055602	.	A	G	32	19	51	0	6	57	0	0
4	25084487	.	T	G	5	5	10	0	2	12	0	0
4	25084744	.	A	G	8	9	17	0	2	19	0	0
4	25105502	.	G	T	10	11	21	0	1	22	0	0
4	25105662	.	A	G	6	6	12	0	1	13	0	0
4	25168280	.	T	C	5	5	10	0	1	11	0	0
4	25168417	.	A	G	2	5	7	0	0	7	0	0
4	25168418	.	A	G	2	5	7	0	0	7	0	0
4	25173387	.	T	C	14	15	29	0	1	30	0	0
4	25173396	.	A	G	14	12	26	0	2	28	0	0
4	25176093	.	A	G	9	12	21	0	0	21	0	0
4	25176420	.	C	T	18	23	41	0	1	42	0	0
4	25178069	.	G	T	2	4	6	0	0	6	0	0
4	25178402	.	G	C	2	4	6	0	2	8	0	0
4	25179897	.	A	G	2	5	7	0	1	8	0	0
4	25179948	.	C	T	2	22	24	0	14	38	0	0
4	25179996	.	A	G	7	8	15	0	0	15	0	0
4	25184718	.	G	A	2	1	3	0	1	4	0	0
4	25184757	.	C	T	3	1	4	0	0	4	0	0
4	25184760	.	C	T	2	1	3	0	1	4	0	0
4	25185797	.	T	C	3	2	5	0	0	5	0	0
4	25252405	.	T	C	1	3	4	0	0	4	0	0
4	25438283	.	C	T	3	2	5	0	0	5	0	0
4	25440948	.	T	A	9	2	11	0	2	13	0	0
4	25473316	.	T	G	2	3	5	0	0	5	0	0
4	25473934	.	T	G	6	12	18	0	0	18	0	0
4	25474177	.	T	C	9	14	23	0	3	26	0	0
4	25474301	.	T	C	18	13	31	0	1	32	0	0
4	25474305	.	A	T	17	13	30	0	1	32	1	0
4	25474417	.	G	A	14	16	30	0	0	30	0	0
4	25474419	.	C	T	0	15	15	0	15	30	0	0
4	25476524	.	A	T	7	4	11	0	2	13	0	0
4	25479114	.	G	A	4	5	9	0	1	10	0	0
4	25480983	.	T	C	2	0	2	0	5	7	0	0
4	25480989	.	G	A	2	3	5	0	1	6	0	0
4	25482595	.	C	A	0	1	1	0	0	1	0	0
4	25485302	.	C	T	4	2	6	0	0	6	0	0
4	25497398	.	G	A	3	2	5	0	0	5	0	0
4	25506417	.	G	A	3	2	5	0	0	5	0	0
4	25506896	.	A	G	5	2	7	0	0	7	0	0
4	25506944	.	T	C	5	0	5	0	4	9	0	0
4	25511562	.	T	C	2	0	2	0	0	2	0	0
4	25515157	.	C	T	2	0	2	0	0	2	0	0
4	25694866	.	G	T	0	0	0	0	3	3	0	0
4	25700800	.	A	T	5	5	10	0	2	12	0	0
4	25702919	.	C	T	0	1	1	0	0	1	0	0
4	25703527	.	C	A	3	3	6	0	0	6	0	0
4	25750850	.	G	A	2	2	4	0	0	4	0	0
4	25755137	.	C	T	3	4	7	0	0	7	0	0
4	25755191	.	T	A	5	2	7	0	0	7	0	0
4	25755194	.	A	G	5	2	7	0	0	7	0	0
4	25755269	.	C	T	10	3	13	0	0	13	0	0
4	25755341	.	T	A	3	5	8	0	1	9	0	0
4	25755359	.	G	T	7	5	12	0	0	12	0	0
4	25756387	.	T	G	3	3	6	0	0	6	0	0
4	25756432	.	A	G	4	5	9	0	0	9	0	0
4	25756453	.	G	T	4	3	7	0	0	7	0	0
4	25759088	.	T	A	7	6	13	0	0	13	0	0
4	25759183	.	T	C	3	5	8	0	1	9	0	0
4	25759327	.	G	A	2	5	7	0	0	7	0	0
4	25759518	.	C	A	0	2	2	0	5	7	0	0
4	25759690	.	A	G	7	3	10	0	1	11	0	0
4	25759816	.	T	C	1	2	3	0	0	3	0	0
4	25796742	.	T	C	8	0	8	0	2	10	0	0
4	25796765	.	G	A	6	2	8	0	0	8	0	0
4	25829939	.	G	A	9	13	22	0	0	22	0	0
4	25833146	.	A	G	4	1	5	0	0	5	0	0
4	25833221	.	G	A	3	3	6	0	0	6	0	0
4	25839832	.	A	G	7	3	10	0	0	10	0	0
4	25839911	.	G	C	1	4	5	0	1	6	0	0
4	25839931	.	C	T	0	6	6	0	2	8	0	0
4	25842788	.	C	T	1	2	3	0	1	4	0	0
4	25846927	.	G	A	1	1	2	0	0	2	0	0
4	25853058	.	C	T	1	0	1	0	0	1	0	0
4	25860634	.	C	T	1	1	2	0	1	3	0	0
4	25862179	.	T	A	0	2	2	0	0	2	0	0
4	25862187	.	G	A	0	2	2	0	0	2	0	0
4	25864326	.	T	C	1	2	3	0	0	3	0	0
4	25932628	.	A	G	4	0	4	0	2	6	0	0
4	25932664	.	A	T	3	0	3	0	0	3	0	0
4	25934667	.	G	A	2	1	3	0	0	3	0	0
4	25936437	.	A	G	5	3	8	0	1	9	0	0
4	25939158	.	A	G	1	1	2	0	0	2	0	0
4	26016340	.	A	C	0	2	2	0	0	2	0	0
4	26021910	.	A	G	4	2	6	0	0	6	0	0
4	26021970	.	C	A	4	6	10	0	0	10	0	0
4	26022076	.	T	C	1	0	1	0	7	8	0	0
4	26022351	.	C	G	5	2	7	0	0	7	0	0
4	26022637	.	T	C	2	4	6	0	0	6	0	0
4	26022640	.	C	T	0	3	3	0	3	6	0	0
4	26026411	.	C	G	2	1	3	0	0	3	0	0
4	26026444	.	T	C	2	2	4	0	0	4	0	0
4	26027022	.	A	G	5	4	9	0	2	11	0	0
4	26028947	.	C	T	0	3	3	0	2	5	0	0
4	26029119	.	A	G	0	3	3	0	0	3	0	0
4	26029362	.	T	A	3	6	9	0	0	9	0	0
4	26029413	.	T	C	2	0	2	0	2	4	0	0
4	26056580	.	C	T	2	3	5	0	0	5	0	0
4	26056589	.	A	G	2	3	5	0	0	5	0	0
4	26056643	.	C	T	1	3	4	0	0	4	0	0
4	26075640	.	G	C	2	0	2	0	0	2	0	0
4	26075673	.	G	A	0	0	0	0	2	2	0	0
4	26075856	.	G	A	1	8	9	0	0	9	0	0
4	26075882	.	A	G	0	0	0	0	3	3	0	0
4	26077483	.	T	C	5	7	12	0	0	12	0	0
4	26077671	.	A	T	8	6	14	0	0	14	0	0
4	26078008	.	T	C	3	5	8	0	1	9	0	0
4	26078205	.	G	A	0	3	3	0	4	7	0	0
4	26078675	.	A	T	4	2	6	0	0	6	0	0
4	26078847	.	A	G	4	3	7	0	0	7	0	0
4	26078911	.	A	G	3	4	7	0	1	8	0	0
4	26079096	.	A	C	10	5	15	0	1	16	0	0
4	26079116	.	T	C	11	3	14	0	0	14	0	0
4	26079174	.	A	C	7	4	11	0	0	11	0	0
4	26079267	.	T	G	1	0	1	0	3	4	0	0
4	26079472	.	G	T	4	2	6	0	0	6	0	0
4	26079721	.	T	A	1	2	3	0	0	3	0	0
4	26080036	.	T	A	4	3	7	0	0	7	0	0
4	26080071	.	T	C	6	4	10	0	0	10	0	0
4	26080217	.	A	T	6	8	14	0	0	14	0	0
4	26080249	.	G	A	4	5	9	0	0	9	0	0
4	26080294	.	A	G	8	5	13	0	1	14	0	0
4	26080321	.	A	G	8	5	13	0	0	13	0	0
4	26080375	.	A	C	6	4	10	0	3	13	0	0
4	26080387	.	T	A	6	8	14	0	2	16	0	0
4	26080441	.	C	T	6	8	14	0	0	14	0	0
4	26080593	.	T	C	4	4	8	0	0	8	0	0
4	26304240	.	T	G	9	17	26	0	0	26	0	0
4	26304451	.	T	C	10	14	24	0	2	26	0	0
4	26304730	.	G	T	10	5	15	0	0	15	0	0
4	26305191	.	T	C	4	7	11	0	1	12	0	0
4	26305286	.	C	A	9	14	23	0	1	24	0	0
4	26305309	.	T	A	13	11	24	0	1	25	0	0
4	26305324	.	C	T	12	10	22	0	0	22	0	0
4	26305413	.	A	C	4	10	14	0	2	16	0	0
4	26305468	.	A	T	4	8	12	0	0	12	0	0
4	26305516	.	A	T	3	5	8	0	0	9	1	0
4	26305578	.	A	T	5	4	9	0	2	11	0	0
4	26306209	.	A	G	12	10	22	0	0	22	0	0
4	26321216	.	A	G	7	5	12	0	0	12	0	0
4	26322655	.	C	A	0	11	11	0	13	24	0	0
4	26322721	.	C	T	0	7	7	0	8	15	0	0
4	26496683	.	G	A	12	7	19	0	4	23	0	0
4	26496730	.	G	A	15	8	23	0	0	23	0	0
4	26629094	.	T	A	3	2	5	0	0	5	0	0
4	26762518	.	G	T	3	2	5	0	0	5	0	0
4	26762524	.	G	T	7	3	10	0	0	10	0	0
4	26763314	.	A	T	6	5	11	0	0	11	0	0
4	26763482	.	G	T	2	2	4	0	0	4	0	0
4	26764217	.	C	T	3	5	8	0	0	8	0	0
4	26765056	.	T	C	2	4	6	0	0	6	0	0
4	26765057	.	A	T	2	4	6	0	0	6	0	0
4	26765359	.	A	T	0	4	4	0	1	5	0	0
4	27113093	.	A	G	2	2	4	0	0	4	0	0
4	27113986	.	G	A	2	3	5	0	0	5	0	0
4	27114157	.	T	C	4	4	8	0	0	8	0	0
4	27114894	.	A	G	5	4	9	0	0	9	0	0
4	27115765	.	A	G	3	2	5	0	0	5	0	0
4	27132077	.	A	T	1	3	4	0	0	4	0	0
4	27132314	.	A	C	3	2	5	0	0	5	0	0
4	27133498	.	G	A	1	0	1	0	0	1	0	0
4	27137991	.	T	G	0	2	2	0	0	2	0	0
4	27139955	.	T	A	3	4	7	0	0	7	0	0
4	27140658	.	A	G	1	2	3	0	0	3	0	0
4	27143244	.	C	T	0	1	1	0	0	1	0	0
4	27147440	.	T	G	1	2	3	0	1	4	0	0
4	27147712	.	C	T	10	7	17	0	2	19	0	0
4	27148417	.	T	C	3	4	7	0	0	7	0	0
4	27148425	.	A	T	4	6	10	0	0	10	0	0
4	27148545	.	A	C	3	5	8	0	0	8	0	0
4	27148943	.	A	C	6	6	12	0	0	12	0	0
4	27149017	.	G	A	0	5	5	0	5	10	0	0
4	27149676	.	G	T	3	3	6	0	0	6	0	0
4	27149680	.	G	T	4	4	8	0	1	9	0	0
4	27252027	.	T	C	6	6	12	0	0	12	0	0
4	27252096	.	C	T	7	4	11	0	0	11	0	0
4	27252178	.	C	T	0	10	10	0	10	20	0	0
4	27252581	.	G	A	13	12	25	0	1	26	0	0
4	27350432	.	G	T	6	7	13	0	1	14	0	0
4	27350666	.	G	A	8	5	13	0	1	14	0	0
4	27350674	.	C	G	0	6	6	0	8	14	0	0
4	27628373	.	G	A	2	6	8	0	0	8	0	0
4	27628540	.	G	A	2	2	4	0	0	4	0	0
4	27628563	.	G	A	2	2	4	0	0	4	0	0
4	27628643	.	C	G	0	2	2	0	1	3	0	0
4	27628697	.	A	C	1	3	4	0	0	4	0	0
4	27628788	.	T	A	3	2	5	0	0	5	0	0
4	27890354	.	T	C	2	2	4	0	0	4	0	0
4	27890395	.	G	C	1	3	4	0	1	5	0	0
4	27890564	.	A	G	1	3	4	0	0	4	0	0
4	27921925	.	A	G	3	4	7	0	0	7	0	0
4	27921962	.	G	C	0	2	2	0	1	3	0	0
4	27945941	.	T	C	3	2	5	0	0	5	0	0
4	28062562	.	G	C	2	7	9	0	0	9	0	0
4	28062581	.	A	G	2	7	9	0	0	9	0	0
4	28062603	.	G	A	5	2	7	0	0	7	0	0
4	28062649	.	C	A	7	6	13	0	0	13	0	0
4	28062652	.	A	G	7	6	13	0	0	13	0	0
4	28062846	.	T	A	1	5	6	0	1	7	0	0
4	28062956	.	T	C	4	1	5	0	1	6	0	0
4	28062959	.	T	C	4	2	6	0	0	6	0	0
4	28063086	.	G	A	8	6	14	0	0	14	0	0
4	28063385	.	G	A	3	4	7	0	0	7	0	0
4	28063635	.	A	G	5	7	12	0	1	13	0	0
4	28063653	.	G	T	7	8	15	0	0	15	0	0
4	28063715	.	A	G	9	4	13	0	1	14	0	0
4	28063873	.	T	C	2	5	7	0	0	7	0	0
4	28063876	.	T	C	2	5	7	0	0	7	0	0
4	28063911	.	C	G	0	3	3	0	2	5	0	0
4	28064028	.	T	C	2	6	8	0	1	9	0	0
4	28066394	.	G	A	1	4	5	0	1	6	0	0
4	28066425	.	C	T	1	4	5	0	1	6	0	0
4	28068908	.	G	A	3	1	4	0	0	4	0	0
4	28078078	.	A	T	0	1	1	0	0	1	0	0
4	28084928	.	T	C	4	1	5	0	0	5	0	0
4	28084993	.	A	G	3	1	4	0	0	4	0	0
4	28093323	.	A	G	1	4	5	0	0	5	0	0
4	28194359	.	G	A	1	2	3	0	0	3	0	0
4	28195380	.	A	C	0	1	1	0	0	1	0	0
4	28195396	.	T	C	1	1	2	0	1	3	0	0
4	28197964	.	T	G	1	0	1	0	0	1	0	0
4	28198334	.	T	C	2	0	2	0	0	2	0	0
4	28209922	.	G	A	1	3	4	0	1	5	0	0
4	28343865	.	G	C	1	0	1	0	0	1	0	0
4	28343976	.	A	G	1	0	1	0	1	2	0	0
4	28344009	.	G	A	2	1	3	0	0	3	0	0
4	28344012	.	A	G	2	1	3	0	0	3	0	0
4	28373791	.	T	G	7	8	15	0	0	15	0	0
4	28374785	.	G	C	2	2	4	0	0	4	0	0
4	28379899	.	A	T	1	2	3	0	1	4	0	0
4	28419637	.	G	A	1	2	3	0	0	3	0	0
4	28423134	.	A	G	4	5	9	0	0	9	0	0
4	28423180	.	T	A	3	3	6	0	0	6	0	0
4	28423483	.	T	C	1	3	4	0	0	4	0	0
4	28423499	.	A	T	1	3	4	0	0	4	0	0
4	28423528	.	C	G	0	0	0	0	2	2	0	0
4	28423547	.	C	T	0	3	3	0	0	3	0	0
4	28423595	.	A	G	2	4	6	0	0	6	0	0
4	28423735	.	C	T	5	4	9	0	0	9	0	0
4	28423775	.	T	G	3	1	4	0	6	10	0	0
4	28423786	.	A	T	1	6	7	0	0	7	0	0
4	28821416	.	G	A	0	1	1	0	2	4	1	0
4	28821417	.	A	T	2	2	4	0	0	4	0	0
4	28821606	.	G	A	0	3	3	0	1	4	0	0
4	28975412	.	A	G	2	2	4	0	0	4	0	0
4	29040677	.	G	A	0	3	3	0	0	3	0	0
4	29041592	.	G	A	2	2	4	0	0	4	0	0
4	29050168	.	T	A	3	3	6	0	0	6	0	0
4	29284521	.	A	C	0	2	2	0	0	2	0	0
4	29287306	.	C	G	1	3	4	0	0	4	0	0
4	29287803	.	C	A	4	2	6	0	1	7	0	0
4	31022126	.	G	C	1	0	1	0	0	1	0	0
4	31022127	.	G	A	1	0	1	0	0	1	0	0
4	31412388	.	G	A	0	3	3	1	1	5	0	0
4	40959639	.	T	G	0	2	2	0	0	2	0	0
4	42038973	.	G	A	0	2	2	0	0	2	0	0
4	44600012	.	T	C	1	2	3	0	0	3	0	0
4	46872732	.	C	T	2	3	5	0	0	5	0	0
4	50755658	.	C	A	0	2	2	0	1	3	0	0
4	60062950	.	A	T	1	2	3	0	1	4	0	0
4	60938288	.	C	G	1	2	3	0	0	3	0	0
4	61706201	.	T	G	0	2	2	0	0	2	0	0
4	61706230	.	A	T	0	1	1	0	1	2	0	0
4	64350357	.	C	T	1	2	3	0	0	3	0	0
4	70843283	.	G	A	2	2	4	0	0	4	0	0
4	70843302	.	G	T	1	2	3	0	0	3	0	0
4	70850712	.	T	C	2	2	4	0	0	4	0	0
4	70850966	.	G	T	10	4	14	0	0	14	0	0
4	70851017	.	C	T	0	2	2	0	6	8	0	0
4	70851051	.	A	G	1	0	1	0	0	1	0	0
4	70851069	.	G	A	1	3	4	0	0	4	0	0
4	70851105	.	A	G	6	6	12	0	0	12	0	0
4	70860034	.	A	C	2	0	2	0	0	2	0	0
4	70860166	.	A	G	7	4	11	0	1	12	0	0
4	70864457	.	C	T	0	0	0	0	1	1	0	0
4	70867005	.	G	C	2	2	4	0	0	4	0	0
4	72216932	.	A	C	2	1	3	0	0	3	0	0
4	72217285	.	T	C	2	3	5	0	0	5	0	0
4	72217405	.	C	T	1	2	3	0	0	3	0	0
4	72217438	.	A	C	1	3	4	0	0	4	0	0
4	72217495	.	C	A	0	4	4	0	1	5	0	0
4	72217508	.	C	T	1	3	4	0	0	4	0	0
4	72217647	.	T	C	1	5	6	0	0	6	0	0
4	72217933	.	C	T	1	2	3	0	0	3	0	0
4	72217937	.	T	C	1	2	3	0	0	3	0	0
4	72272239	.	G	A	5	4	9	0	0	9	0	0
4	72272461	.	C	T	4	2	6	0	0	6	0	0
4	72272491	.	A	G	4	2	6	0	1	7	0	0
4	72272617	.	G	A	5	4	9	0	0	9	0	0
4	72272779	.	T	C	3	4	7	0	0	7	0	0
4	72348855	.	A	C	1	0	1	0	2	3	0	0
4	72348990	.	C	G	2	2	4	0	1	5	0	0
4	72356870	.	G	A	1	1	2	0	0	2	0	0
4	72559045	.	A	C	3	0	3	0	2	5	0	0
4	72559558	.	A	G	5	4	9	0	0	9	0	0
4	72559585	.	A	G	6	4	10	0	0	10	0	0
4	72559612	.	A	G	5	2	7	0	0	7	0	0
4	72603620	.	G	A	2	3	5	0	0	5	0	0
4	72628932	.	G	A	1	2	3	0	0	3	0	0
4	72629058	.	C	T	0	2	2	0	1	3	0	0
4	72629601	.	G	A	3	2	5	0	0	5	0	0
4	72629622	.	G	A	3	2	5	0	0	5	0	0
4	72629739	.	G	A	2	3	5	0	0	5	0	0
4	72629787	.	G	A	3	3	6	0	0	6	0	0
4	72630231	.	G	A	1	4	5	0	0	5	0	0
4	72630351	.	C	A	1	3	4	0	0	4	0	0
4	72630360	.	C	G	1	3	4	0	0	4	0	0
4	72638407	.	T	A	1	1	2	0	0	2	0	0
4	72678484	.	C	T	1	2	3	0	3	6	0	0
4	72678517	.	C	T	2	2	4	0	0	4	0	0
4	72754244	.	C	T	12	19	31	0	0	31	0	0
4	72772769	.	T	C	13	6	19	0	2	21	0	0
4	72774085	.	C	T	6	8	14	0	0	14	0	0
4	72775687	.	C	A	1	4	5	0	1	6	0	0
4	72784939	.	T	G	2	0	2	0	6	8	0	0
4	72784940	.	A	C	2	5	7	0	1	8	0	0
4	72785055	.	T	C	1	4	5	0	0	5	0	0
4	72785056	.	T	C	1	4	5	0	0	5	0	0
4	72785129	.	C	G	1	4	5	0	0	5	0	0
4	72785147	.	T	C	1	4	5	0	0	5	0	0
4	72785425	.	C	T	2	2	4	0	0	4	0	0
4	72785692	.	C	G	1	2	3	0	0	3	0	0
4	72785903	.	G	A	1	3	4	0	0	4	0	0
4	72785914	.	T	C	1	3	4	0	0	4	0	0
4	73059245	.	C	T	2	5	7	0	0	7	0	0
4	73059299	.	T	A	1	2	3	0	0	3	0	0
4	73059543	.	C	T	0	1	1	0	0	1	0	0
4	73063417	.	T	G	3	3	6	0	0	6	0	0
4	73063427	.	A	C	4	2	6	0	0	6	0	0
4	73063511	.	C	T	1	2	3	0	0	3	0	0
4	73063534	.	C	A	2	2	4	0	0	4	0	0
4	73064955	.	A	C	1	4	5	0	0	5	0	0
4	73064975	.	A	T	1	4	5	0	0	5	0	0
4	73064991	.	T	C	1	1	2	0	1	3	0	0
4	73186138	.	T	C	1	3	4	0	0	4	0	0
4	73186143	.	C	A	1	2	3	0	0	3	0	0
4	73187999	.	G	A	1	3	4	0	0	4	0	0
4	73228154	.	C	T	0	2	2	0	0	2	0	0
4	73274151	.	T	C	3	2	5	0	0	5	0	0
4	73276927	.	C	T	1	3	4	0	0	4	0	0
4	73288085	.	C	A	0	2	2	0	0	2	0	0
4	73335956	.	G	A	2	2	4	0	0	4	0	0
4	73335990	.	T	A	1	2	3	0	1	4	0	0
4	73336618	.	C	T	4	4	8	0	0	8	0	0
4	73336629	.	C	T	5	2	7	0	0	7	0	0
4	73336727	.	T	C	2	0	2	0	2	4	0	0
4	73336748	.	C	T	0	2	2	0	3	5	0	0
4	73337601	.	G	A	1	2	3	0	0	3	0	0
4	73337911	.	T	A	3	2	5	1	0	6	0	0
4	73338060	.	C	A	2	4	6	0	0	6	0	0
4	73338062	.	T	C	2	4	6	0	0	6	0	0
4	73338166	.	G	A	3	0	3	0	0	3	0	0
4	73347263	.	G	C	1	3	4	0	0	4	0	0
4	73383217	.	G	A	1	3	4	0	0	4	0	0
4	73383878	.	G	A	2	2	4	0	0	4	0	0
4	73383895	.	G	C	1	2	3	0	1	4	0	0
4	73398893	.	A	G	2	2	4	0	0	4	0	0
4	73418744	.	A	T	2	7	9	0	0	9	0	0
4	73418823	.	T	C	2	8	10	0	0	10	0	0
4	73418974	.	T	C	1	0	1	0	3	4	0	0
4	73419160	.	C	T	1	2	3	0	0	3	0	0
4	73419550	.	G	A	1	3	4	0	1	5	0	0
4	73473074	.	C	T	1	5	6	0	0	6	0	0
4	73491352	.	C	A	2	5	7	0	0	7	0	0
4	73491361	.	G	A	2	4	6	0	0	6	0	0
4	73499279	.	T	C	3	2	5	0	0	5	0	0
4	73499823	.	T	C	3	0	3	0	2	5	0	0
4	73501963	.	G	A	3	2	5	0	0	5	0	0
4	73536986	.	T	C	1	3	4	0	0	4	0	0
4	73536989	.	A	T	1	2	3	0	1	4	0	0
4	73542536	.	G	A	5	3	8	0	0	8	0	0
4	73542707	.	T	G	4	2	6	0	1	7	0	0
4	73542757	.	C	A	2	3	5	0	1	6	0	0
4	73542775	.	C	T	0	4	4	0	3	7	0	0
4	73542830	.	C	T	3	3	6	0	0	6	0	0
4	73542845	.	G	A	2	3	5	0	0	5	0	0
4	73542913	.	A	G	4	4	8	0	0	8	0	0
4	73550570	.	A	T	3	2	5	0	0	5	0	0
4	73550610	.	A	T	1	3	4	0	0	4	0	0
4	73551208	.	G	C	1	0	1	0	3	4	0	0
4	73551456	.	T	C	2	3	5	0	0	5	0	0
4	73551581	.	T	A	0	2	2	0	0	2	0	0
4	73551600	.	T	C	0	2	2	0	0	2	0	0
4	73573799	.	T	A	4	3	7	0	0	7	0	0
4	73573870	.	T	G	4	2	6	0	1	7	0	0
4	73573887	.	A	C	3	1	4	0	1	5	0	0
4	73574235	.	A	G	2	4	6	0	0	6	0	0
4	73574374	.	G	A	4	4	8	0	0	8	0	0
4	73574386	.	T	A	4	4	8	0	0	8	0	0
4	73575576	.	G	T	6	3	9	0	0	9	0	0
4	73575746	.	T	A	2	4	6	0	0	6	0	0
4	73575834	.	G	A	2	2	4	0	0	4	0	0
4	73677549	.	A	G	2	1	3	0	1	4	0	0
4	73701906	.	C	A	0	4	4	0	1	5	0	0
4	73701909	.	T	C	1	4	5	0	0	5	0	0
4	73702473	.	G	A	1	2	3	0	0	3	0	0
4	73702490	.	T	G	1	2	3	0	0	3	0	0
4	73712748	.	G	T	2	1	3	0	1	4	0	0
4	73713998	.	G	C	4	2	6	0	0	6	0	0
4	73714966	.	T	C	3	0	3	0	0	3	0	0
4	73729780	.	C	A	2	2	4	0	0	4	0	0
4	73740301	.	G	A	8	8	16	0	0	16	0	0
4	73740391	.	C	G	8	5	13	0	0	13	0	0
4	73740409	.	C	A	5	5	10	0	0	10	0	0
4	73740487	.	C	G	5	5	10	0	0	10	0	0
4	73740651	.	G	C	2	4	6	0	0	6	0	0
4	73740691	.	T	A	2	2	4	0	0	4	0	0
4	73740879	.	A	C	2	6	8	0	1	9	0	0
4	73741749	.	G	T	2	4	6	0	0	6	0	0
4	73741764	.	G	A	2	4	6	0	0	6	0	0
4	73758321	.	T	C	1	4	5	0	0	5	0	0
4	73758375	.	T	C	2	3	5	0	0	5	0	0
4	73780903	.	G	T	1	3	4	0	0	4	0	0
4	73796397	.	G	A	3	2	5	0	0	5	0	0
4	73796424	.	C	T	2	3	5	0	0	5	0	0
4	73796484	.	A	G	1	4	5	0	0	5	0	0
4	73796694	.	C	T	1	5	6	0	0	6	0	0
4	73814853	.	T	C	2	3	5	0	0	5	0	0
4	73814873	.	C	T	3	3	6	0	0	6	0	0
4	73815897	.	T	A	2	2	4	0	0	4	0	0
4	73816163	.	T	C	1	0	1	0	2	3	0	0
4	73816175	.	T	C	1	0	1	0	2	3	0	0
4	73897683	.	G	A	1	2	3	0	0	3	0	0
4	73897713	.	T	C	0	2	2	0	1	3	0	0
4	73897923	.	T	C	1	2	3	0	0	3	0	0
4	73898831	.	A	T	1	2	3	0	0	3	0	0
4	73898847	.	T	C	1	2	3	0	0	3	0	0
4	73899370	.	G	A	2	3	5	0	0	5	0	0
4	73981397	.	C	T	1	3	4	0	1	5	0	0
4	73981489	.	G	T	2	1	3	0	0	3	0	0
4	73981496	.	G	A	2	1	3	0	0	3	0	0
4	73981558	.	G	A	2	3	5	0	1	6	0	0
4	74008362	.	A	G	2	3	5	0	0	5	0	0
4	74008378	.	T	A	2	3	5	0	0	5	0	0
4	74008621	.	A	G	1	0	1	0	5	6	0	0
4	74008704	.	C	T	1	4	5	0	1	6	0	0
4	74008708	.	A	G	1	5	6	0	0	6	0	0
4	74087781	.	G	A	8	11	19	0	1	20	0	0
4	74087785	.	G	C	8	11	19	0	1	20	0	0
4	74088060	.	T	G	17	8	25	0	1	26	0	0
4	74092153	.	T	C	1	1	2	0	0	2	0	0
4	74109763	.	A	T	4	11	15	0	0	15	0	0
4	74131583	.	T	G	3	0	3	0	4	7	0	0
4	74131652	.	T	C	10	9	19	0	0	19	0	0
4	74131717	.	G	A	0	4	4	0	8	12	0	0
4	74135244	.	G	T	0	2	2	0	0	2	0	0
4	74135295	.	A	G	2	7	9	0	1	10	0	0
4	74135415	.	C	T	15	7	22	0	0	22	0	0
4	74141580	.	C	A	3	3	6	0	0	6	0	0
4	74141797	.	A	G	3	5	8	0	0	8	0	0
4	74141819	.	T	C	3	5	8	0	0	8	0	0
4	74176550	.	G	A	1	1	2	0	0	2	0	0
4	74180716	.	G	A	0	8	8	0	13	21	0	0
4	74180788	.	T	C	3	1	4	0	0	4	0	0
4	74182382	.	G	C	4	4	8	0	1	9	0	0
4	74182389	.	G	T	4	4	8	0	0	8	0	0
4	74193480	.	C	G	0	3	3	0	1	4	0	0
4	74196686	.	T	C	1	3	4	0	0	4	0	0
4	74196704	.	T	C	2	5	7	0	0	7	0	0
4	74196764	.	G	T	2	2	4	0	0	4	0	0
4	74200391	.	C	T	5	2	7	0	0	7	0	0
4	74204177	.	T	C	14	9	23	0	2	25	0	0
4	74204236	.	G	T	0	4	4	0	10	14	0	0
4	74204387	.	G	T	4	6	10	0	0	10	0	0
4	74204842	.	A	G	10	5	15	0	0	15	0	0
4	74205295	.	T	C	2	4	6	0	0	6	0	0
4	74267225	.	A	G	6	7	13	0	2	15	0	0
4	74267348	.	C	T	4	7	11	0	0	11	0	0
4	74267519	.	A	G	19	7	26	0	2	28	0	0
4	74267540	.	G	A	0	15	15	0	10	25	0	0
4	74267582	.	T	G	10	15	25	0	0	25	0	0
4	74267639	.	T	A	14	6	20	0	1	22	1	0
4	74267733	.	A	T	16	15	31	0	1	32	0	0
4	74267748	.	C	T	16	15	31	0	1	32	0	0
4	74267865	.	A	C	8	11	19	0	0	19	0	0
4	74268175	.	A	G	5	3	8	0	1	9	0	0
4	74268182	.	C	T	4	5	9	0	1	10	0	0
4	74271251	.	G	A	4	4	8	0	1	9	0	0
4	74278079	.	T	G	3	7	10	0	0	10	0	0
4	74278093	.	C	T	0	6	6	0	2	8	0	0
4	74282709	.	C	T	2	0	2	0	0	2	0	0
4	74282917	.	G	A	3	2	5	0	1	6	0	0
4	74287776	.	T	A	1	0	1	0	0	1	0	0
4	74943202	.	A	T	6	9	15	0	1	16	0	0
4	74952477	.	G	A	8	14	22	0	2	24	0	0
4	74952525	.	A	G	11	1	12	0	11	23	0	0
4	74952660	.	G	T	3	15	18	0	15	33	0	0
4	74960826	.	C	T	13	15	28	0	1	29	0	0
4	74961011	.	C	T	12	11	23	0	4	27	0	0
4	74961075	.	G	A	16	14	30	0	1	31	0	0
4	74961520	.	T	A	6	6	12	0	0	12	0	0
4	75138707	.	G	A	2	5	7	0	0	7	0	0
4	75138750	.	A	G	2	4	6	0	1	7	0	0
4	75138987	.	C	T	2	13	15	0	2	17	0	0
4	75139002	.	A	T	3	6	9	0	0	9	0	0
4	75139194	.	C	T	8	11	19	0	1	20	0	0
4	75139264	.	T	C	9	11	20	0	0	20	0	0
4	75142269	.	G	A	4	6	10	0	0	10	0	0
4	75149056	.	C	T	14	8	22	0	0	22	0	0
4	75149071	.	T	A	15	9	24	0	0	24	0	0
4	75149125	.	C	A	0	3	3	0	4	7	0	0
4	75149149	.	C	T	0	0	0	0	2	2	0	0
4	75150806	.	T	G	5	5	10	0	1	11	0	0
4	75153925	.	C	T	1	0	1	0	0	1	0	0
4	75153930	.	G	A	1	0	1	0	0	1	0	0
4	75270438	.	G	C	3	4	7	0	1	8	0	0
4	75416605	.	C	T	4	6	10	0	0	10	0	0
4	75416647	.	G	A	4	3	7	0	0	7	0	0
4	75416760	.	G	A	0	2	2	0	4	6	0	0
4	75416980	.	C	T	1	2	3	0	0	3	0	0
4	75417916	.	C	A	5	2	7	0	0	7	0	0
4	75417925	.	G	A	5	1	6	0	0	6	0	0
4	75419342	.	A	T	5	2	7	0	0	7	0	0
4	75419353	.	C	T	3	2	5	0	0	5	0	0
4	75419421	.	G	T	5	1	6	0	1	7	0	0
4	75419428	.	C	T	4	2	6	0	1	7	0	0
4	75419528	.	G	C	0	2	2	0	3	5	0	0
4	75419551	.	G	C	3	3	6	0	0	6	0	0
4	75419653	.	G	A	5	2	7	0	0	7	0	0
4	75419819	.	C	G	5	5	10	0	1	11	0	0
4	75419822	.	A	C	4	5	9	0	1	10	0	0
4	75419916	.	G	T	10	7	17	0	0	17	0	0
4	75419928	.	T	G	10	1	11	0	6	17	0	0
4	75419961	.	A	C	11	10	21	0	4	25	0	0
4	75419970	.	G	A	0	10	10	0	16	26	0	0
4	75420159	.	T	C	9	6	15	0	0	15	0	0
4	75420186	.	A	G	4	0	4	0	4	8	0	0
4	75420203	.	T	G	3	1	4	0	0	6	2	0
4	75420270	.	A	G	6	4	10	0	0	10	0	0
4	75420318	.	T	A	6	7	13	0	0	13	0	0
4	75420873	.	A	C	2	3	5	0	0	5	0	0
4	76322771	.	T	C	4	3	7	0	0	7	0	0
4	76334633	.	A	G	2	1	3	0	2	5	0	0
4	76345176	.	A	G	2	1	3	0	1	4	0	0
4	76345427	.	C	T	1	2	3	0	0	3	0	0
4	76345433	.	T	C	1	2	3	0	0	3	0	0
4	76345974	.	A	G	4	8	12	0	0	12	0	0
4	76346004	.	T	C	4	5	9	0	0	9	0	0
4	76346011	.	T	C	4	4	8	0	1	9	0	0
4	76346153	.	G	C	4	2	6	0	0	6	0	0
4	76346188	.	T	A	2	5	7	0	0	7	0	0
4	76346238	.	C	A	5	6	11	0	0	11	0	0
4	76347126	.	T	C	3	2	5	0	0	5	0	0
4	76347163	.	A	G	3	4	7	0	0	7	0	0
4	76347508	.	T	G	6	4	10	0	1	11	0	0
4	76347761	.	A	T	1	3	4	0	1	5	0	0
4	76347977	.	A	T	5	2	7	0	0	7	0	0
4	76348088	.	T	A	4	4	8	0	0	8	0	0
4	76360241	.	T	A	0	2	2	0	0	2	0	0
4	76360368	.	C	T	2	2	4	0	0	4	0	0
4	76362977	.	T	G	1	2	3	0	0	3	0	0
4	76381891	.	T	A	1	2	3	0	0	3	0	0
4	76381893	.	A	T	1	2	3	0	0	3	0	0
4	76408988	.	G	A	1	4	5	0	0	5	0	0
4	76409461	.	A	G	1	0	1	0	2	3	0	0
4	76409494	.	A	C	1	2	3	0	0	3	0	0
4	76410071	.	C	T	1	2	3	0	0	3	0	0
4	76411252	.	G	A	7	3	10	0	0	10	0	0
4	76411255	.	A	C	7	3	10	0	0	10	0	0
4	76411990	.	A	G	1	0	1	0	7	8	0	0
4	76412187	.	A	G	2	2	4	0	0	4	0	0
4	76412432	.	G	T	3	8	11	0	0	11	0	0
4	76412464	.	G	T	4	6	10	0	0	10	0	0
4	76412531	.	A	T	1	3	4	0	0	4	0	0
4	76412533	.	T	G	0	4	4	0	0	4	0	0
4	76412751	.	A	T	1	4	5	0	1	6	0	0
4	76412937	.	C	T	9	2	11	0	0	11	0	0
4	76412938	.	A	C	8	2	10	0	1	11	0	0
4	76420809	.	A	G	1	4	5	0	1	6	0	0
4	76420875	.	C	T	2	3	5	0	0	5	0	0
4	76420883	.	G	A	2	4	6	0	0	6	0	0
4	76421602	.	A	C	1	3	4	0	0	4	0	0
4	76421898	.	A	G	1	2	3	0	0	3	0	0
4	76421958	.	C	T	2	4	6	0	0	6	0	0
4	76421987	.	G	T	1	4	5	0	1	6	0	0
4	76422231	.	G	A	0	6	6	0	3	9	0	0
4	76422500	.	T	C	2	3	5	0	0	5	0	0
4	76423418	.	A	G	3	2	5	0	1	6	0	0
4	76423462	.	A	G	6	0	6	0	2	8	0	0
4	76427137	.	G	C	0	2	2	0	0	2	0	0
4	76427145	.	A	G	0	2	2	0	0	2	0	0
4	76429102	.	A	G	2	0	2	0	0	2	0	0
4	76429202	.	A	C	1	3	4	0	0	4	0	0
4	76429270	.	C	T	3	2	5	0	0	5	0	0
4	76429545	.	C	A	1	3	4	0	0	4	0	0
4	76429584	.	A	G	1	2	3	0	0	3	0	0
4	76429719	.	G	T	1	4	5	0	0	5	0	0
4	76429742	.	A	T	6	2	8	0	0	8	0	0
4	76429787	.	T	C	3	2	5	0	0	5	0	0
4	76429944	.	G	C	4	2	6	0	1	7	0	0
4	76429969	.	G	A	2	2	4	0	1	5	0	0
4	76430256	.	G	A	0	4	4	0	0	4	0	0
4	76430257	.	A	G	0	4	4	0	0	4	0	0
4	76437848	.	A	T	3	2	5	0	0	5	0	0
4	76437869	.	A	G	2	4	6	0	0	6	0	0
4	76437999	.	A	T	2	3	5	0	2	7	0	0
4	76439744	.	G	A	1	2	3	0	0	3	0	0
4	76462977	.	T	C	2	2	4	0	1	5	0	0
4	76464859	.	G	C	4	2	6	0	0	6	0	0
4	76465329	.	T	C	0	9	9	0	0	9	0	0
4	76465346	.	C	T	1	5	6	0	0	6	0	0
4	76473451	.	A	T	0	1	1	0	0	1	0	0
4	76473911	.	A	G	1	2	3	0	0	3	0	0
4	76480806	.	G	A	1	2	3	0	0	3	0	0
4	76480834	.	C	G	1	2	3	0	0	3	0	0
4	76481177	.	T	C	5	0	5	0	1	6	0	0
4	76481216	.	G	C	1	0	1	0	2	3	0	0
4	76481403	.	T	A	7	10	17	0	2	19	0	0
4	76481572	.	G	A	8	6	14	0	0	14	0	0
4	76481665	.	A	T	3	4	7	0	2	9	0	0
4	76481692	.	T	C	2	0	2	0	3	5	0	0
4	76482075	.	G	T	1	2	3	0	0	3	0	0
4	76482249	.	C	T	3	2	5	0	0	5	0	0
4	76482673	.	T	C	0	1	1	0	0	1	0	0
4	76488514	.	T	A	2	2	4	0	0	4	0	0
4	76866993	.	A	G	15	4	19	0	1	20	0	0
4	77108095	.	C	T	1	3	4	0	0	4	0	0
4	77250925	.	T	C	4	3	7	0	0	7	0	0
4	77349372	.	A	G	1	2	3	0	0	3	0	0
4	77349374	.	G	A	1	2	3	0	0	3	0	0
4	77389712	.	G	A	1	3	4	0	0	4	0	0
4	77389832	.	G	C	1	8	9	0	0	9	0	0
4	77389877	.	C	T	5	8	13	0	0	13	0	0
4	77389929	.	G	C	15	3	18	0	4	22	0	0
4	77389932	.	C	A	17	3	20	0	1	21	0	0
4	77390006	.	G	A	16	12	28	0	1	29	0	0
4	77390083	.	A	T	9	6	15	0	0	15	0	0
4	77390164	.	G	T	6	4	10	0	0	10	0	0
4	77390174	.	C	T	7	5	12	0	0	12	0	0
4	77390254	.	T	G	6	8	14	0	2	16	0	0
4	77390288	.	A	C	10	9	19	0	0	19	0	0
4	77390314	.	A	G	13	7	20	0	0	20	0	0
4	77400439	.	G	T	3	2	5	0	1	6	0	0
4	77400454	.	A	T	3	3	6	0	0	6	0	0
5	318077	.	G	A	2	2	4	0	0	4	0	0
5	318125	.	C	T	2	2	4	0	0	4	0	0
5	320383	.	T	C	1	0	1	0	4	5	0	0
5	340614	.	A	G	1	3	4	0	0	4	0	0
5	340667	.	T	C	7	5	12	0	1	13	0	0
5	341288	.	T	C	8	9	17	0	0	17	0	0
5	341331	.	C	T	10	7	17	0	0	17	0	0
5	341687	.	C	T	0	13	13	0	8	21	0	0
5	341740	.	A	C	22	8	30	0	4	34	0	0
5	341980	.	G	A	7	4	11	0	0	11	0	0
5	342001	.	T	C	8	5	13	0	4	17	0	0
5	342134	.	A	G	2	2	4	0	1	5	0	0
5	342179	.	A	G	1	5	6	0	0	6	0	0
5	342228	.	C	T	4	4	8	0	0	8	0	0
5	393858	.	G	A	4	12	16	0	0	16	0	0
5	393979	.	T	C	3	8	11	0	1	12	0	0
5	394181	.	G	A	13	13	26	0	2	28	0	0
5	394184	.	T	C	14	14	28	0	1	29	0	0
5	394238	.	A	G	21	15	36	0	2	38	0	0
5	394239	.	T	G	22	15	37	0	1	38	0	0
5	394360	.	C	G	5	9	14	0	3	17	0	0
5	394417	.	G	A	1	6	7	0	9	16	0	0
5	394484	.	A	G	5	0	5	0	10	15	0	0
5	440032	.	A	G	6	1	7	0	6	13	0	0
5	440033	.	A	C	5	7	12	0	1	13	0	0
5	440106	.	T	C	4	3	7	0	0	7	0	0
5	457736	.	C	G	5	0	5	0	0	5	0	0
5	486649	.	T	G	1	0	1	0	0	1	0	0
5	491982	.	T	C	0	1	1	0	1	2	0	0
5	496604	.	G	T	0	2	2	0	3	5	0	0
5	896908	.	C	A	3	4	7	0	0	7	0	0
5	899952	.	C	T	3	4	7	0	0	7	0	0
5	905263	.	C	A	3	5	8	0	1	9	0	0
5	917336	.	C	T	2	2	4	0	0	4	0	0
5	1055103	.	C	T	1	2	3	0	0	3	0	0
5	1059697	.	T	C	4	1	5	0	0	5	0	0
5	1068116	.	T	A	6	6	12	0	0	12	0	0
5	1073609	.	G	A	4	3	7	0	0	7	0	0
5	1073877	.	A	C	1	0	1	0	3	4	0	0
5	1079480	.	C	T	12	6	18	0	1	19	0	0
5	1079558	.	G	T	1	1	2	0	0	2	0	0
5	1083014	.	C	T	2	2	4	0	0	4	0	0
5	1083203	.	G	C	6	8	14	0	0	14	0	0
5	1083237	.	T	A	2	4	6	0	0	6	0	0
5	1083242	.	T	C	2	4	6	0	0	6	0	0
5	1083679	.	G	A	0	6	6	0	2	8	0	0
5	1155594	.	G	A	2	4	6	0	0	6	0	0
5	1159612	.	G	A	0	2	2	0	2	4	0	0
5	1187950	.	G	A	1	1	2	0	0	2	0	0
5	1205869	.	C	G	0	1	1	0	0	1	0	0
5	1207835	.	C	T	2	4	6	0	0	6	0	0
5	1216494	.	A	G	4	5	9	0	1	10	0	0
5	1216536	.	C	T	0	5	5	0	6	11	0	0
5	1216575	.	G	A	2	2	4	0	0	4	0	0
5	1218781	.	G	A	4	4	8	0	0	8	0	0
5	1219263	.	C	T	14	15	29	0	2	31	0	0
5	1219381	.	G	A	9	7	16	0	1	17	0	0
5	1223368	.	A	T	12	13	25	0	0	25	0	0
5	1223369	.	C	T	11	12	23	0	2	25	0	0
5	1223460	.	G	A	12	8	20	0	0	20	0	0
5	1223487	.	G	T	14	7	21	0	0	21	0	0
5	1240403	.	C	A	0	3	3	0	2	5	0	0
5	1240517	.	T	C	2	3	5	0	0	5	0	0
5	1240534	.	G	A	2	1	3	0	0	3	0	0
5	1240589	.	C	T	0	0	0	0	1	1	0	0
5	1244945	.	A	G	1	0	1	0	0	1	0	0
5	1244952	.	C	T	0	0	0	0	1	1	0	0
5	1311041	.	G	A	3	5	8	0	0	8	0	0
5	1317871	.	T	C	6	4	10	0	0	10	0	0
5	1317883	.	G	A	4	1	5	0	1	6	0	0
5	1420729	.	A	G	13	10	23	0	0	23	0	0
5	1421052	.	T	A	4	4	8	0	0	8	0	0
5	1421833	.	A	G	5	3	8	0	0	8	0	0
5	1438628	.	G	A	3	1	4	0	0	4	0	0
5	1445964	.	G	A	5	5	10	0	0	10	0	0
5	1451666	.	T	C	1	0	1	0	0	1	0	0
5	1456393	.	G	A	0	3	3	0	0	3	0	0
5	1456411	.	T	C	0	3	3	0	0	3	0	0
5	1519571	.	G	C	1	7	8	0	0	8	0	0
5	1519574	.	T	A	1	6	7	0	0	7	0	0
5	1624525	.	G	A	14	9	23	0	2	25	0	0
5	1653920	.	C	T	23	15	38	0	1	39	0	0
5	1653989	.	T	C	8	4	12	0	0	12	0	0
5	1673291	.	G	C	1	2	3	0	0	3	0	0
5	1706404	.	T	C	1	0	1	0	3	4	0	0
5	1709098	.	G	C	0	1	1	0	0	1	0	0
5	1950783	.	G	A	34	34	68	0	1	69	0	0
5	1952857	.	T	C	5	3	8	0	1	9	0	0
5	1952872	.	A	G	11	8	19	0	3	22	0	0
5	1952940	.	A	G	45	23	68	0	0	68	0	0
5	1953019	.	C	A	10	4	14	0	2	16	0	0
5	1955757	.	G	A	28	19	47	0	1	48	0	0
5	1957996	.	G	A	17	23	40	0	1	41	0	0
5	1958120	.	T	A	9	9	18	0	0	18	0	0
5	1962010	.	G	A	11	5	16	0	1	17	0	0
5	1990040	.	A	C	4	4	8	0	1	9	0	0
5	1997902	.	A	G	10	7	17	0	0	17	0	0
5	1997957	.	A	G	17	12	29	0	0	29	0	0
5	1997958	.	G	A	16	12	28	0	1	29	0	0
5	1998019	.	A	C	21	2	23	0	17	40	0	0
5	1999118	.	C	A	1	2	3	0	0	4	1	0
5	1999123	.	A	C	1	1	2	0	2	4	0	0
5	1999199	.	G	A	15	15	30	0	0	30	0	0
5	1999289	.	C	T	16	21	37	0	1	38	0	0
5	1999419	.	T	C	3	3	6	0	0	6	0	0
5	2047372	.	G	T	0	5	5	0	6	11	0	0
5	2066324	.	C	A	1	3	4	0	0	4	0	0
5	2067220	.	G	A	2	2	4	0	0	4	0	0
5	2067597	.	T	G	3	3	6	0	0	6	0	0
5	2067621	.	G	A	5	3	8	0	0	8	0	0
5	2067781	.	G	A	3	6	9	0	0	9	0	0
5	2067832	.	C	T	4	8	12	0	0	12	0	0
5	2067842	.	T	A	8	4	12	0	0	12	0	0
5	2068482	.	G	T	2	2	4	0	0	4	0	0
5	2068515	.	T	A	2	4	6	0	0	6	0	0
5	2074369	.	C	T	3	4	7	0	0	7	0	0
5	2099320	.	G	C	1	1	2	0	1	3	0	0
5	2242346	.	G	A	2	2	4	0	1	5	0	0
5	2242390	.	T	C	0	2	2	0	0	2	0	0
5	2242499	.	C	T	2	2	4	0	1	5	0	0
5	2242549	.	G	A	1	3	4	0	1	5	0	0
5	2242550	.	G	T	2	1	3	0	2	5	0	0
5	2242708	.	A	G	1	2	3	0	0	3	0	0
5	2242762	.	C	G	3	3	6	0	0	6	0	0
5	2242795	.	G	A	5	2	7	0	0	7	0	0
5	2243005	.	G	T	4	6	10	0	1	11	0	0
5	2410373	.	T	C	33	0	33	0	16	49	0	0
5	2410610	.	G	A	6	3	9	0	0	9	0	0
5	2413134	.	G	A	16	14	30	0	1	31	0	0
5	2413303	.	A	G	1	3	4	0	0	4	0	0
5	2413327	.	G	A	3	1	4	0	0	4	0	0
5	2419100	.	G	A	10	6	16	0	2	18	0	0
5	2426103	.	C	T	0	4	4	0	0	4	0	0
5	2434335	.	C	A	7	9	16	0	0	16	0	0
5	2434362	.	G	A	9	7	16	0	0	16	0	0
5	2434401	.	C	T	0	0	0	0	3	3	0	0
5	2434504	.	C	T	3	2	5	0	0	5	0	0
5	2434507	.	T	A	3	3	6	0	0	6	0	0
5	2435940	.	G	A	6	3	9	0	0	9	0	0
5	2451222	.	G	A	9	8	17	0	5	22	0	0
5	2451276	.	C	T	0	5	5	0	13	18	0	0
5	2451294	.	A	C	7	0	7	0	5	12	0	0
5	2454780	.	C	G	6	6	12	0	1	13	0	0
5	2454791	.	C	T	8	4	12	0	1	13	0	0
5	2457599	.	C	T	0	1	1	0	1	2	0	0
5	2460563	.	C	G	6	4	10	0	0	10	0	0
5	2463679	.	T	C	3	0	3	0	2	5	0	0
5	2464885	.	G	A	1	0	1	0	0	1	0	0
5	2467870	.	G	A	3	5	8	0	0	8	0	0
5	2495522	.	T	C	0	1	1	0	2	3	0	0
5	2509488	.	A	T	8	13	21	0	3	24	0	0
5	2509521	.	G	A	3	9	12	0	0	12	0	0
5	2521496	.	G	A	7	6	13	0	0	13	0	0
5	2686225	.	G	C	4	1	5	0	3	8	0	0
5	2689283	.	G	A	0	1	1	0	0	1	0	0
5	2689347	.	G	A	3	2	5	0	0	5	0	0
5	2689361	.	C	G	3	2	5	0	0	5	0	0
5	2696477	.	A	G	2	3	5	0	0	5	0	0
5	2709533	.	A	G	2	2	4	0	0	4	0	0
5	2713967	.	A	G	16	20	36	0	4	40	0	0
5	2714042	.	C	T	19	24	43	0	2	45	0	0
5	2714135	.	C	T	31	20	51	0	4	55	0	0
5	2714237	.	G	A	21	25	46	0	4	50	0	0
5	2714495	.	G	A	21	23	44	0	1	45	0	0
5	2714507	.	A	G	22	23	45	0	0	45	0	0
5	2714531	.	T	C	17	0	17	0	13	30	0	0
5	2716930	.	G	A	12	10	22	0	1	23	0	0
5	2716963	.	G	A	9	10	19	0	0	19	0	0
5	2717014	.	G	A	9	14	23	0	0	23	0	0
5	2717022	.	G	A	9	14	23	0	0	23	0	0
5	2717260	.	T	C	0	4	4	0	0	4	0	0
5	2717350	.	G	C	10	0	10	0	10	20	0	0
5	2717611	.	C	T	3	2	5	0	0	5	0	0
5	2717623	.	A	G	1	1	2	0	0	2	0	0
5	2717960	.	A	G	2	3	5	0	0	5	0	0
5	2718696	.	A	G	11	5	16	0	0	16	0	0
5	2718834	.	G	A	1	1	2	0	0	2	0	0
5	2720119	.	A	G	2	3	5	0	0	5	0	0
5	2721588	.	C	T	2	3	5	0	0	5	0	0
5	2742556	.	T	C	4	4	8	0	1	9	0	0
5	2742571	.	T	C	5	4	9	0	0	9	0	0
5	2742784	.	A	G	11	7	18	0	0	18	0	0
5	2744938	.	C	T	5	3	8	0	1	9	0	0
5	2744962	.	C	G	5	3	8	0	0	8	0	0
5	2744998	.	C	T	2	4	6	0	0	6	0	0
5	2745220	.	G	T	1	1	2	0	1	3	0	0
5	2750087	.	G	A	5	7	12	0	0	12	0	0
5	2750127	.	G	A	7	10	17	0	1	18	0	0
5	2750244	.	G	A	5	4	9	0	0	9	0	0
5	2750256	.	G	A	3	5	8	0	0	8	0	0
5	2751319	.	G	A	1	3	4	0	0	4	0	0
5	2751511	.	G	A	5	7	12	0	2	14	0	0
5	3118842	.	A	G	17	14	31	0	2	33	0	0
5	3127488	.	T	A	7	4	11	0	0	11	0	0
5	3185195	.	A	T	0	3	3	0	0	3	0	0
5	3502001	.	A	G	19	14	33	0	3	36	0	0
5	3544098	.	C	T	11	2	13	0	0	13	0	0
5	3544380	.	C	T	18	27	45	0	3	48	0	0
5	3544955	.	T	C	20	17	37	0	0	37	0	0
5	3545011	.	T	A	24	22	46	0	3	49	0	0
5	3545205	.	A	T	26	0	26	0	2	28	0	0
5	3568494	.	C	T	4	7	11	0	1	12	0	0
5	3568518	.	G	T	4	6	10	0	0	10	0	0
5	3611613	.	T	C	3	0	3	1	4	8	0	0
5	3611638	.	T	A	2	3	5	0	1	6	0	0
5	3612118	.	G	A	3	0	3	0	2	5	0	0
5	3612122	.	T	G	0	4	4	0	1	5	0	0
5	3612254	.	A	G	3	5	8	0	0	8	0	0
5	3618043	.	A	G	6	5	11	0	0	11	0	0
5	3891528	.	C	A	4	7	11	0	0	11	0	0
5	3891666	.	G	C	1	0	1	0	0	1	0	0
5	3892688	.	G	T	4	3	7	0	1	8	0	0
5	3914668	.	C	T	18	8	26	0	0	26	0	0
5	3914701	.	G	A	10	7	17	0	0	17	0	0
5	3927700	.	C	T	4	5	9	0	1	10	0	0
5	4024797	.	G	T	5	4	9	0	0	9	0	0
5	4037394	.	T	C	1	1	2	0	0	2	0	0
5	4037469	.	C	T	10	5	15	0	0	15	0	0
5	4040153	.	G	A	11	7	18	0	1	19	0	0
5	4041064	.	C	T	1	4	5	0	0	5	0	0
5	4041181	.	T	C	4	0	4	0	0	4	0	0
5	4041671	.	C	A	6	5	11	0	0	11	0	0
5	4048760	.	A	G	12	13	25	0	0	25	0	0
5	4048820	.	C	T	5	5	10	0	0	10	0	0
5	4051551	.	C	T	1	3	4	0	0	4	0	0
5	4051594	.	A	G	8	0	8	0	15	23	0	0
5	4055082	.	G	T	5	6	11	0	0	11	0	0
5	4132049	.	C	A	2	3	5	0	0	5	0	0
5	4142284	.	T	G	2	1	3	0	1	4	0	0
5	4254061	.	C	T	0	6	6	0	6	12	0	0
5	4260424	.	T	C	1	0	1	0	0	1	0	0
5	4260672	.	G	A	4	13	17	0	0	17	0	0
5	4263154	.	G	C	3	5	8	0	0	8	0	0
5	4263241	.	G	T	10	15	25	0	0	25	0	0
5	4263297	.	G	T	9	9	18	0	2	20	0	0
5	4263322	.	C	T	4	4	8	0	0	8	0	0
5	4265468	.	C	T	0	6	6	0	1	7	0	0
5	4269325	.	G	T	4	2	6	0	0	6	0	0
5	4273144	.	T	C	7	3	10	0	0	10	0	0
5	4273159	.	T	C	7	5	12	0	1	13	0	0
5	4273216	.	G	A	11	11	22	0	1	23	0	0
5	4278433	.	G	A	7	9	16	0	1	17	0	0
5	4292578	.	A	G	2	0	2	0	0	2	0	0
5	4296556	.	C	G	6	4	10	0	0	10	0	0
5	4308861	.	G	A	2	0	2	0	0	2	0	0
5	4373684	.	C	T	13	8	21	0	1	22	0	0
5	4373701	.	G	T	1	5	6	0	9	15	0	0
5	4382543	.	A	G	5	3	8	0	0	8	0	0
5	4387137	.	T	G	1	0	1	0	0	1	0	0
5	4444829	.	G	A	1	2	3	0	0	3	0	0
5	4469479	.	A	T	0	2	2	0	2	4	0	0
5	4469658	.	G	A	0	2	2	0	2	4	0	0
5	4469754	.	G	A	0	2	2	0	1	3	0	0
5	4482647	.	A	G	1	2	3	0	0	3	0	0
5	4482992	.	G	A	4	1	5	0	0	5	0	0
5	4493427	.	C	G	1	3	4	0	6	10	0	0
5	4523677	.	T	C	6	0	6	0	4	10	0	0
5	4532499	.	A	G	2	3	5	0	0	5	0	0
5	4533367	.	C	G	1	2	3	0	1	4	0	0
5	4545106	.	G	A	1	0	1	0	0	1	0	0
5	4545115	.	A	G	2	0	2	0	0	2	0	0
5	4729334	.	G	A	2	5	7	0	0	7	0	0
5	4733927	.	C	T	0	3	3	0	4	7	0	0
5	5171358	.	T	A	0	2	2	0	0	2	0	0
5	5217028	.	G	A	2	2	4	0	0	4	0	0
5	5308502	.	A	G	1	4	5	0	0	5	0	0
5	5394379	.	A	G	1	3	4	0	0	4	0	0
5	5394383	.	G	A	1	3	4	0	0	4	0	0
5	5399006	.	G	A	3	2	5	0	0	5	0	0
5	5399019	.	C	T	2	3	5	0	0	5	0	0
5	5406529	.	T	C	1	3	4	0	0	4	0	0
5	5406568	.	C	T	1	3	4	0	0	4	0	0
5	5498155	.	C	T	2	2	4	0	0	4	0	0
5	5619609	.	G	C	0	1	1	0	0	1	0	0
5	5619670	.	G	T	5	2	7	0	0	7	0	0
5	5619677	.	C	G	0	2	2	0	5	7	0	0
5	5622094	.	C	G	1	2	3	0	0	3	0	0
5	5669820	.	G	A	1	2	3	0	0	3	0	0
5	5708595	.	C	G	3	4	7	0	1	8	0	0
5	5720021	.	G	A	2	4	6	0	0	6	0	0
5	5721935	.	T	C	0	0	0	1	0	1	0	0
5	5733227	.	C	G	1	0	1	0	0	1	0	0
5	5736673	.	A	G	2	0	2	0	0	2	0	0
5	5736683	.	C	T	0	1	1	0	2	3	0	0
5	6828721	.	G	A	0	3	3	0	0	3	0	0
5	6858380	.	C	A	1	7	8	0	0	9	1	0
5	6858540	.	T	A	15	7	22	0	1	23	0	0
5	6858779	.	G	T	0	5	5	0	16	21	0	0
5	6863577	.	C	T	9	1	10	0	2	12	0	0
5	6863647	.	C	T	11	16	27	0	1	28	0	0
5	6863768	.	G	C	10	15	25	0	1	26	0	0
5	6863793	.	G	A	15	11	26	0	2	28	0	0
5	6863834	.	A	G	6	0	6	0	9	15	0	0
5	6863855	.	G	A	6	5	11	0	2	13	0	0
5	6863912	.	A	C	8	4	12	0	1	13	0	0
5	6864010	.	C	T	3	3	6	0	0	6	0	0
5	8006212	.	T	A	2	2	4	0	3	7	0	0
5	8237498	.	A	G	5	4	9	0	0	9	0	0
5	9068657	.	T	C	4	2	6	0	0	6	0	0
5	10056131	.	G	A	1	1	2	0	0	2	0	0
5	10084232	.	T	G	3	2	5	0	0	5	0	0
5	10084310	.	C	T	4	3	7	0	0	7	0	0
5	10766286	.	G	A	10	4	14	0	0	14	0	0
5	10766505	.	A	G	9	20	29	0	1	30	0	0
5	10766529	.	G	A	21	8	29	0	1	30	0	0
5	10766879	.	A	G	18	9	27	0	1	28	0	0
5	10767113	.	C	T	10	12	22	0	1	23	0	0
5	10767259	.	A	G	22	17	39	0	1	40	0	0
5	10767456	.	G	A	2	7	9	0	0	9	0	0
5	10768089	.	G	A	10	12	22	0	0	22	0	0
5	10768182	.	G	A	10	9	19	0	0	19	0	0
5	10768215	.	T	C	4	0	4	0	6	10	0	0
5	10946038	.	G	A	5	3	8	0	0	8	0	0
5	10946085	.	G	T	5	5	10	0	1	11	0	0
5	11244675	.	A	G	2	2	4	0	0	4	0	0
5	11244741	.	G	A	1	1	2	0	0	2	0	0
5	11507602	.	A	G	1	1	2	0	0	2	0	0
5	11573461	.	C	T	6	3	9	0	2	11	0	0
5	11727757	.	T	C	1	3	4	0	0	4	0	0
5	11812278	.	C	T	2	5	7	0	1	8	0	0
5	11816599	.	G	A	2	2	4	0	0	4	0	0
5	11824059	.	G	A	0	2	2	0	1	3	0	0
5	11824188	.	T	C	1	1	2	0	0	2	0	0
5	11826347	.	T	C	2	1	3	0	1	4	0	0
5	11836437	.	T	C	7	6	13	0	0	13	0	0
5	11863501	.	G	A	1	3	4	0	0	4	0	0
5	11864521	.	T	A	3	1	4	0	1	5	0	0
5	11864522	.	A	C	3	2	5	0	0	5	0	0
5	11864774	.	T	G	11	4	15	0	0	15	0	0
5	11905661	.	T	C	3	0	3	0	2	5	0	0
5	11905725	.	C	T	3	3	6	0	1	7	0	0
5	11905890	.	A	G	7	9	16	0	1	17	0	0
5	11905903	.	T	G	8	5	13	0	0	13	0	0
5	11917125	.	C	T	10	4	14	0	0	14	0	0
5	11917405	.	G	A	6	5	11	0	1	12	0	0
5	11917436	.	G	A	5	5	10	0	1	11	0	0
5	11917485	.	G	A	5	9	14	0	0	14	0	0
5	11917596	.	C	A	1	11	12	0	8	21	1	0
5	11933155	.	A	G	4	8	12	0	2	14	0	0
5	11935444	.	G	A	1	3	4	0	0	4	0	0
5	11937486	.	G	A	0	3	3	0	0	3	0	0
5	11937564	.	A	T	2	1	3	0	0	3	0	0
5	11943868	.	G	A	5	8	13	0	1	14	0	0
5	11943934	.	C	A	5	3	8	0	1	9	0	0
5	11943948	.	T	A	4	5	9	0	2	11	0	0
5	11943989	.	G	A	2	5	7	0	0	7	0	0
5	11944060	.	T	G	4	2	6	0	0	6	0	0
5	11949244	.	G	T	5	10	15	0	0	15	0	0
5	11959776	.	G	T	0	12	12	0	16	28	0	0
5	11959777	.	C	T	12	16	28	0	0	28	0	0
5	11959818	.	C	T	17	15	32	0	1	33	0	0
5	11959966	.	C	G	9	7	16	0	1	17	0	0
5	11959988	.	G	A	0	9	9	0	13	22	0	0
5	11982950	.	C	A	4	3	7	0	0	7	0	0
5	11983017	.	T	C	4	2	6	0	0	6	0	0
5	11983548	.	C	G	6	6	12	0	0	12	0	0
5	11984020	.	G	A	2	4	6	0	0	6	0	0
5	11984027	.	A	G	2	5	7	0	0	7	0	0
5	11984086	.	T	C	3	7	10	0	1	11	0	0
5	11984133	.	C	T	0	5	5	0	0	5	0	0
5	11984354	.	C	T	2	4	6	0	0	6	0	0
5	11984419	.	C	A	3	3	6	0	0	6	0	0
5	11985546	.	A	T	5	3	8	0	0	8	0	0
5	12100335	.	G	A	4	3	7	0	0	7	0	0
5	12219483	.	A	T	1	2	3	0	0	3	0	0
5	12284075	.	C	T	9	19	28	0	4	32	0	0
5	12285172	.	T	C	7	1	8	0	14	22	0	0
5	12285504	.	C	A	1	3	4	0	0	4	0	0
5	12285575	.	T	C	4	0	4	0	3	7	0	0
5	12285601	.	C	G	5	4	9	0	0	9	0	0
5	12288511	.	T	C	5	2	7	0	1	8	0	0
5	12288541	.	A	G	6	1	7	0	0	7	0	0
5	12297084	.	C	T	0	1	1	0	0	1	0	0
5	12322321	.	G	A	1	2	3	0	1	4	0	0
5	12357538	.	G	A	0	1	1	0	0	1	0	0
5	12357554	.	C	T	3	1	4	0	0	4	0	0
5	12454563	.	T	C	7	0	7	0	11	18	0	0
5	12503554	.	G	A	3	8	11	0	1	12	0	0
5	12524938	.	A	G	1	4	5	0	0	5	0	0
5	12533070	.	G	A	1	0	1	0	0	1	0	0
5	12549258	.	C	T	13	4	17	0	0	17	0	0
5	12549807	.	A	G	3	3	6	0	0	6	0	0
5	12549981	.	G	T	2	4	6	0	0	6	0	0
5	12553935	.	C	T	0	1	1	0	1	2	0	0
5	12554073	.	G	A	0	3	3	0	0	3	0	0
5	12554119	.	A	G	5	3	8	0	0	8	0	0
5	12664330	.	T	C	2	2	4	0	0	4	0	0
5	12701122	.	A	G	1	3	4	0	0	4	0	0
5	12724121	.	C	T	9	8	17	0	0	17	0	0
5	12724224	.	G	A	7	11	18	0	2	20	0	0
5	12724249	.	A	C	9	2	11	0	1	12	0	0
5	12724292	.	C	A	6	0	6	0	1	7	0	0
5	12724307	.	A	G	4	7	11	0	0	11	0	0
5	12724412	.	A	G	6	0	6	0	1	7	0	0
5	12724450	.	C	T	0	11	11	0	3	14	0	0
5	12724505	.	C	A	5	18	23	0	0	23	0	0
5	12724518	.	G	C	6	2	8	0	16	24	0	0
5	12724567	.	A	G	16	8	24	0	0	24	0	0
5	12724694	.	C	T	1	6	7	0	13	20	0	0
5	12725930	.	G	A	2	3	5	0	0	5	0	0
5	12726842	.	A	G	3	2	5	0	1	6	0	0
5	12729397	.	C	T	2	4	6	0	1	7	0	0
5	12732247	.	C	T	2	2	4	0	0	4	0	0
5	12734883	.	G	T	4	4	8	0	0	8	0	0
5	12734910	.	T	C	5	5	10	0	0	10	0	0
5	12743088	.	T	A	1	1	2	0	1	3	0	0
5	12837064	.	G	A	8	5	13	0	0	13	0	0
5	12859258	.	T	C	8	9	17	0	1	18	0	0
5	12905911	.	A	C	1	5	6	0	0	6	0	0
5	12906014	.	C	T	2	4	6	0	0	6	0	0
5	12906273	.	C	T	2	2	4	0	0	4	0	0
5	12906343	.	A	G	1	0	1	0	2	3	0	0
5	12908828	.	C	A	4	5	9	0	1	10	0	0
5	12926507	.	C	A	0	0	0	0	1	1	0	0
5	12935223	.	A	G	0	1	1	0	0	1	0	0
5	12956960	.	C	T	0	1	1	0	0	1	0	0
5	12975532	.	C	T	1	0	1	0	0	1	0	0
5	12979889	.	C	T	6	2	8	0	0	8	0	0
5	13037199	.	C	T	0	3	3	0	4	7	0	0
5	13037203	.	C	T	0	4	4	0	3	8	1	0
5	13037723	.	A	G	3	2	5	0	0	5	0	0
5	13037939	.	T	G	7	6	13	0	0	13	0	0
5	13037967	.	G	A	7	5	12	0	1	13	0	0
5	13037998	.	A	G	4	6	10	0	0	10	0	0
5	13105020	.	C	T	15	21	36	0	4	40	0	0
5	13105070	.	C	A	1	26	27	0	17	44	0	0
5	13112979	.	G	A	1	1	2	0	0	2	0	0
5	13167048	.	A	T	11	5	16	0	1	17	0	0
5	13213082	.	T	C	1	2	3	0	0	3	0	0
5	13214102	.	T	C	0	3	3	0	1	4	0	0
5	13214110	.	T	C	1	2	3	0	1	4	0	0
5	13214637	.	C	G	2	3	5	0	1	6	0	0
5	13214802	.	C	G	3	4	7	0	2	9	0	0
5	13227057	.	C	T	0	0	0	0	1	1	0	0
5	13229024	.	C	A	1	0	1	0	0	1	0	0
5	13239412	.	A	G	1	3	4	0	0	4	0	0
5	13308738	.	G	A	2	2	4	0	0	4	0	0
5	13308959	.	G	A	0	3	3	0	0	3	0	0
5	13308985	.	T	C	0	4	4	0	0	4	0	0
5	13308997	.	G	T	0	4	4	0	0	4	0	0
5	13309174	.	T	C	11	0	11	0	12	23	0	0
5	13309215	.	C	T	9	9	18	0	0	18	0	0
5	13309273	.	C	T	14	12	26	0	0	26	0	0
5	13309309	.	G	A	14	15	29	0	2	31	0	0
5	13309402	.	A	G	10	13	23	0	2	25	0	0
5	13309435	.	A	T	13	14	27	0	2	29	0	0
5	13309522	.	G	A	12	9	21	0	0	21	0	0
5	13312671	.	A	T	2	2	4	0	0	4	0	0
5	13312746	.	G	A	15	17	32	0	1	33	0	0
5	13315490	.	G	C	4	13	17	0	0	17	0	0
5	13315526	.	T	C	3	17	20	0	2	22	0	0
5	13315603	.	A	C	14	8	22	0	1	23	0	0
5	13326851	.	C	T	2	3	5	0	1	6	0	0
5	13326911	.	G	A	0	1	1	0	1	2	0	0
5	13332930	.	A	G	4	2	6	0	0	6	0	0
5	13335291	.	C	T	2	0	2	0	2	4	0	0
5	13335333	.	G	A	2	2	4	0	1	5	0	0
5	13335373	.	G	T	0	3	3	0	1	4	0	0
5	13335423	.	C	T	3	3	6	0	0	6	0	0
5	13337803	.	C	T	13	11	24	0	0	24	0	0
5	13337883	.	T	A	17	10	27	0	2	29	0	0
5	13338441	.	C	T	0	15	15	0	14	29	0	0
5	13338762	.	A	T	9	8	17	0	1	18	0	0
5	13339038	.	G	C	16	11	27	0	15	42	0	0
5	13385888	.	A	G	1	0	1	0	3	4	0	0
5	13385916	.	T	A	3	1	4	0	0	4	0	0
5	13419418	.	T	C	0	2	2	0	0	2	0	0
5	13465095	.	T	C	1	2	3	0	0	3	0	0
5	13468108	.	G	T	0	2	2	0	1	3	0	0
5	13468172	.	C	T	2	5	7	0	0	7	0	0
5	13468190	.	T	C	0	7	7	0	0	7	0	0
5	13468574	.	G	A	2	3	5	0	2	7	0	0
5	13469105	.	T	A	1	4	5	0	0	5	0	0
5	13472279	.	C	T	3	6	9	0	1	10	0	0
5	13472743	.	A	T	1	3	4	0	0	4	0	0
5	13473418	.	C	T	1	4	5	0	0	5	0	0
5	13473436	.	T	C	1	3	4	0	0	4	0	0
5	13539403	.	A	G	3	0	3	0	1	4	0	0
5	13539493	.	A	G	4	0	4	0	4	8	0	0
5	13540689	.	C	T	7	10	17	0	1	18	0	0
5	13540738	.	C	T	4	3	7	0	1	8	0	0
5	13556425	.	G	A	0	2	2	0	2	4	0	0
5	13557614	.	T	C	0	2	2	0	0	2	0	0
5	13643325	.	G	A	12	13	25	0	2	27	0	0
5	13643411	.	C	T	1	21	22	0	15	37	0	0
5	13643824	.	G	A	11	11	22	0	3	25	0	0
5	13644126	.	A	T	21	15	36	0	0	36	0	0
5	13644185	.	T	G	18	12	30	0	1	31	0	0
5	13644189	.	T	G	18	11	29	0	2	31	0	0
5	13644227	.	A	G	12	18	30	0	0	30	0	0
5	13644256	.	A	T	10	10	20	0	1	21	0	0
5	13644581	.	T	G	13	12	25	0	2	27	0	0
5	13644602	.	T	A	16	13	29	0	0	29	0	0
5	13644781	.	C	T	12	7	19	0	2	21	0	0
5	13644797	.	A	G	8	11	19	0	0	19	0	0
5	13645047	.	C	G	11	14	25	0	1	26	0	0
5	13645746	.	A	G	19	12	31	0	1	32	0	0
5	13645885	.	T	C	12	11	23	0	2	25	0	0
5	13649518	.	C	T	9	10	19	0	0	19	0	0
5	13652410	.	T	C	10	20	30	0	0	30	0	0
5	13671624	.	G	T	7	5	12	0	2	14	0	0
5	13671631	.	A	C	6	7	13	0	0	13	0	0
5	13671899	.	C	G	16	12	28	0	3	31	0	0
5	13672004	.	C	T	0	14	14	0	17	31	0	0
5	13672211	.	C	T	17	20	37	0	1	38	0	0
5	13672232	.	C	T	20	19	39	0	1	40	0	0
5	13673016	.	C	G	0	7	7	0	2	9	0	0
5	13684132	.	A	G	20	14	34	0	1	35	0	0
5	13684502	.	C	A	3	15	18	0	20	38	0	0
5	15356919	.	A	G	5	0	5	0	24	29	0	0
5	15356934	.	A	G	12	20	32	0	1	33	0	0
5	15808230	.	G	A	2	2	4	0	0	4	0	0
5	17753733	.	A	G	3	2	5	0	1	6	0	0
5	18917589	.	T	A	0	1	1	0	0	1	0	0
5	19008333	.	A	G	25	0	25	0	7	32	0	0
5	19008334	.	A	G	21	1	22	0	10	32	0	0
5	19040446	.	G	A	3	0	3	0	0	3	0	0
5	19438227	.	T	C	1	4	5	0	0	5	0	0
5	19438230	.	T	C	1	2	3	0	0	3	0	0
5	20419373	.	G	C	13	7	20	0	1	21	0	0
5	20787190	.	T	C	3	5	8	0	1	9	0	0
5	20787273	.	T	C	4	2	6	0	0	6	0	0
5	22012345	.	T	C	4	2	6	0	2	8	0	0
5	22012459	.	T	C	8	3	11	0	1	12	0	0
5	22012823	.	T	C	8	3	11	0	1	12	0	0
5	22115579	.	A	G	1	3	4	0	0	4	0	0
5	22172569	.	C	T	1	4	5	0	3	8	0	0
5	23370824	.	T	C	3	6	9	0	0	9	0	0
5	23397221	.	T	C	3	0	3	0	0	3	0	0
5	23575646	.	T	C	3	5	8	0	1	9	0	0
5	23575683	.	T	C	3	4	7	0	0	7	0	0
5	24131374	.	A	C	2	1	3	0	12	15	0	0
5	24163098	.	A	G	2	2	4	0	0	4	0	0
5	24163099	.	A	G	1	3	4	0	0	4	0	0
5	24163289	.	A	G	3	3	6	1	0	7	0	0
5	24227532	.	A	G	1	8	9	0	0	9	0	0
5	24330493	.	A	G	7	5	12	0	1	13	0	0
5	24818488	.	T	C	7	8	15	0	0	15	0	0
5	24818512	.	T	C	10	0	10	0	10	20	0	0
5	24818523	.	T	C	8	8	16	0	1	17	0	0
5	25088966	.	T	G	3	9	12	0	0	12	0	0
5	25121051	.	T	C	1	2	3	0	0	3	0	0
5	26062582	.	A	G	5	7	12	0	1	13	0	0
5	26789628	.	T	C	1	0	1	0	0	1	0	0
5	26866310	.	A	G	0	2	2	0	1	3	0	0
5	28999828	.	A	G	4	2	6	0	0	6	0	0
5	28999854	.	A	G	5	2	7	0	0	7	0	0
5	29001096	.	A	G	1	7	8	0	2	10	0	0
5	29598984	.	T	C	26	0	26	0	20	46	0	0
5	30054731	.	T	A	3	1	4	0	1	5	0	0
5	30993841	.	C	A	2	0	2	0	8	10	0	0
5	31109695	.	A	T	1	2	3	0	0	3	0	0
5	31432286	.	A	G	1	1	2	0	1	3	0	0
5	31432289	.	A	G	2	2	4	0	0	4	0	0
5	31432387	.	A	G	1	2	3	0	0	3	0	0
5	32796644	.	T	C	2	4	6	0	1	7	0	0
5	32796665	.	T	C	4	2	6	0	0	6	0	0
5	33329786	.	A	G	5	8	13	0	0	13	0	0
5	34589180	.	T	C	1	0	1	0	0	1	0	0
5	35124435	.	T	C	9	0	9	0	7	16	0	0
5	35124479	.	C	T	0	1	1	0	3	4	0	0
5	35124859	.	C	T	5	11	16	0	0	16	0	0
5	35124939	.	G	A	2	3	5	0	0	5	0	0
5	35125414	.	C	T	0	5	5	0	6	11	0	0
5	35125423	.	C	T	5	5	10	0	0	10	0	0
5	35129861	.	C	A	1	4	5	0	0	5	0	0
5	35135687	.	G	A	1	2	3	0	0	3	0	0
5	35137621	.	C	T	0	1	1	0	7	8	0	0
5	35200648	.	T	G	6	2	8	0	0	8	0	0
5	35202876	.	A	T	8	5	13	0	1	14	0	0
5	35202958	.	G	A	10	1	11	0	0	11	0	0
5	35202959	.	A	T	10	1	11	0	0	11	0	0
5	35203092	.	G	A	6	6	12	0	0	12	0	0
5	35203486	.	C	A	8	6	14	0	0	14	0	0
5	35204077	.	T	G	3	3	6	0	0	6	0	0
5	35204159	.	C	T	5	11	16	0	1	17	0	0
5	35204280	.	A	T	6	6	12	0	0	12	0	0
5	35204322	.	A	G	3	6	9	0	0	9	0	0
5	35204353	.	C	T	0	6	6	0	0	6	0	0
5	35204390	.	G	A	0	6	6	0	1	7	0	0
5	35204681	.	A	C	2	2	4	0	0	4	0	0
5	35204689	.	A	C	2	0	2	0	2	4	0	0
5	35204754	.	C	T	2	5	7	0	0	7	0	0
5	35205005	.	G	A	5	5	10	0	0	10	0	0
5	35207914	.	T	G	5	2	7	0	1	8	0	0
5	35220402	.	T	A	3	4	7	0	0	7	0	0
5	35271001	.	C	T	22	16	38	0	2	40	0	0
5	35271154	.	A	T	19	19	38	0	1	39	0	0
5	35271181	.	A	G	26	15	41	0	2	43	0	0
5	35271194	.	G	A	27	17	44	0	1	45	0	0
5	35271309	.	T	A	30	32	62	0	0	62	0	0
5	35271465	.	T	C	31	14	45	0	3	48	0	0
5	35271824	.	C	A	16	21	37	0	2	39	0	0
5	35272032	.	G	A	15	11	26	0	1	27	0	0
5	35272438	.	C	T	2	19	21	0	26	47	0	0
5	35272497	.	G	A	7	20	27	0	1	28	0	0
5	35272560	.	T	G	8	18	26	0	1	27	0	0
5	35273062	.	G	A	20	17	37	0	2	39	0	0
5	35273225	.	T	C	13	17	30	0	0	30	0	0
5	35273447	.	A	G	18	8	26	0	1	27	0	0
5	35273509	.	A	T	15	10	25	0	0	25	0	0
5	35273546	.	A	T	15	7	22	0	0	22	0	0
5	35273564	.	G	A	11	9	20	0	0	20	0	0
5	35273708	.	T	C	14	4	18	0	1	19	0	0
5	35273793	.	A	T	14	23	37	0	2	39	0	0
5	35273838	.	A	C	15	14	29	0	3	32	0	0
5	35273992	.	A	G	12	21	33	0	0	33	0	0
5	35274398	.	G	A	18	10	28	0	1	29	0	0
5	35275103	.	C	T	19	13	32	0	3	35	0	0
5	35275859	.	G	T	13	11	24	0	0	24	0	0
5	35276154	.	A	G	9	11	20	0	3	23	0	0
5	35276303	.	G	C	17	18	35	0	2	37	0	0
5	35276386	.	G	A	11	9	20	0	0	20	0	0
5	35276580	.	A	G	15	7	22	0	1	23	0	0
5	35276811	.	C	G	4	10	14	0	1	15	0	0
5	35276911	.	C	T	0	7	7	0	6	13	0	0
5	35277184	.	T	A	6	11	17	0	0	17	0	0
5	35277256	.	T	A	3	8	11	0	1	12	0	0
5	35277280	.	T	C	3	11	14	0	0	14	0	0
5	35277459	.	T	C	10	8	18	0	1	19	0	0
5	35277509	.	A	T	1	11	12	0	2	14	0	0
5	35278237	.	A	T	3	10	13	0	0	13	0	0
5	35278597	.	C	T	4	6	10	0	0	10	0	0
5	35278863	.	C	T	7	10	17	0	0	17	0	0
5	35278933	.	T	C	2	0	2	0	5	7	0	0
5	35278977	.	T	G	3	5	8	0	0	8	0	0
5	35279007	.	C	T	0	5	5	0	2	7	0	0
5	35279065	.	A	G	3	5	8	0	0	8	0	0
5	35279230	.	T	G	5	6	11	0	0	11	0	0
5	35279275	.	T	G	4	9	13	0	2	15	0	0
5	35279831	.	C	T	4	3	7	0	0	7	0	0
5	35279884	.	G	A	1	2	3	0	0	3	0	0
5	35297280	.	T	C	1	0	1	0	1	2	0	0
5	35301563	.	A	G	3	1	4	0	0	4	0	0
5	35421824	.	C	T	5	3	8	0	0	8	0	0
5	35421840	.	A	G	4	3	7	0	0	7	0	0
5	35422324	.	T	C	3	5	8	0	0	8	0	0
5	35422402	.	A	G	4	5	9	0	0	9	0	0
5	35422530	.	C	T	5	3	8	0	0	8	0	0
5	35431641	.	A	G	7	9	16	0	3	19	0	0
5	35431703	.	T	G	1	4	5	0	0	5	0	0
5	35454464	.	C	T	9	3	12	0	0	12	0	0
5	35473544	.	T	C	1	2	3	0	0	3	0	0
5	35478593	.	G	C	0	1	1	0	0	1	0	0
5	35486822	.	C	T	1	2	3	0	0	3	0	0
5	35486827	.	G	A	1	3	4	0	0	4	0	0
5	35486917	.	C	A	3	3	6	0	0	6	0	0
5	35486955	.	T	C	2	3	5	0	1	6	0	0
5	35487030	.	A	G	5	5	10	0	0	10	0	0
5	35487407	.	A	T	4	5	9	0	0	9	0	0
5	35487416	.	G	C	4	5	9	0	0	9	0	0
5	35487459	.	A	T	4	2	6	0	0	6	0	0
5	35682874	.	A	G	2	2	4	0	0	4	0	0
5	35682967	.	C	A	1	2	3	0	0	3	0	0
5	35683225	.	C	A	0	3	3	0	1	4	0	0
5	35683950	.	T	A	1	4	5	0	0	5	0	0
5	35683965	.	C	T	0	2	2	0	1	3	0	0
5	35683991	.	A	G	1	1	2	0	0	2	0	0
5	35748938	.	T	C	0	1	1	0	0	1	0	0
5	35749470	.	A	G	1	1	2	0	0	2	0	0
5	35751883	.	G	T	2	2	4	0	0	4	0	0
5	35751977	.	A	G	2	7	9	0	0	9	0	0
5	35754284	.	A	G	16	1	17	0	12	29	0	0
5	35754424	.	T	C	13	19	32	0	1	34	1	0
5	35754431	.	A	G	11	1	12	0	20	32	0	0
5	35754503	.	A	C	14	14	28	0	1	29	0	0
5	35754599	.	T	A	17	13	30	0	1	31	0	0
5	35754663	.	A	G	9	12	21	0	2	23	0	0
5	35864882	.	A	T	3	2	5	0	0	5	0	0
5	35955514	.	T	C	11	13	24	0	0	24	0	0
5	35967234	.	C	T	5	5	10	0	0	10	0	0
5	35967270	.	T	A	7	5	12	0	0	12	0	0
5	35967438	.	A	T	1	4	5	0	0	5	0	0
5	35967500	.	A	G	2	0	2	0	9	11	0	0
5	36271160	.	T	G	7	5	12	0	0	12	0	0
5	36274750	.	C	A	0	5	5	0	1	6	0	0
5	36296066	.	G	A	1	2	3	0	0	3	0	0
5	36416204	.	A	G	13	9	22	0	1	23	0	0
5	36416307	.	C	G	4	0	4	0	12	16	0	0
5	36416367	.	G	A	0	9	9	0	7	16	0	0
5	36416478	.	G	T	7	10	17	0	0	17	0	0
5	36416583	.	C	T	17	8	25	0	0	25	0	0
5	36421991	.	G	A	0	7	7	0	6	13	0	0
5	36530959	.	A	T	8	8	16	0	1	17	0	0
5	36536665	.	T	C	2	9	11	0	1	12	0	0
5	36536742	.	C	T	13	12	25	0	0	25	0	0
5	36536859	.	A	G	11	0	11	0	6	17	0	0
5	36536910	.	G	A	9	3	12	0	1	13	0	0
5	36537020	.	A	G	7	9	16	0	0	16	0	0
5	36537021	.	T	A	7	9	16	0	0	16	0	0
5	36537057	.	G	A	11	5	16	0	0	16	0	0
5	36537073	.	A	C	10	6	16	0	0	16	0	0
5	36537124	.	A	G	13	4	17	0	1	18	0	0
5	36537126	.	G	A	9	8	17	0	1	18	0	0
5	36537231	.	A	T	11	14	25	0	0	25	0	0
5	36537246	.	A	G	13	1	14	0	12	26	0	0
5	36537334	.	A	T	10	3	13	0	0	13	0	0
5	36537352	.	G	A	13	2	15	0	0	15	0	0
5	36537611	.	C	A	8	11	19	0	1	20	0	0
5	36537672	.	C	A	5	8	13	0	1	14	0	0
5	36537927	.	T	C	3	4	7	0	0	7	0	0
5	36558059	.	G	A	7	6	13	0	0	13	0	0
5	36558348	.	A	G	9	11	20	0	2	22	0	0
5	36558369	.	G	A	9	9	18	0	2	20	0	0
5	36558441	.	C	T	11	6	17	0	0	17	0	0
5	36563257	.	T	C	2	2	4	0	0	4	0	0
5	36567750	.	C	A	0	4	4	0	5	9	0	0
5	36570280	.	G	A	1	1	2	0	1	3	0	0
5	36583271	.	A	G	1	1	2	0	0	2	0	0
5	36584779	.	G	T	0	2	2	0	0	2	0	0
5	36585662	.	G	A	3	1	4	0	0	4	0	0
5	36585933	.	C	T	5	4	9	0	0	9	0	0
5	36586190	.	G	A	1	1	2	1	0	3	0	0
5	36586192	.	C	G	1	1	2	1	0	3	0	0
5	36586867	.	A	G	1	3	4	0	0	4	0	0
5	36586906	.	C	G	0	4	4	0	1	5	0	0
5	36595772	.	A	T	4	5	9	0	0	9	0	0
5	36595912	.	G	A	5	5	10	0	0	10	0	0
5	36596278	.	G	A	3	4	7	0	0	7	0	0
5	36596294	.	G	A	4	4	8	0	0	8	0	0
5	36596378	.	G	A	4	4	8	0	0	8	0	0
5	36596397	.	T	A	4	4	8	0	1	9	0	0
5	36596517	.	C	A	0	3	3	0	5	8	0	0
5	36608661	.	A	G	2	1	3	0	0	3	0	0
5	36609442	.	G	A	0	2	2	0	1	3	0	0
5	36609469	.	T	C	3	3	6	0	0	6	0	0
5	36624620	.	G	A	0	8	8	0	2	10	0	0
5	36653522	.	G	A	3	5	8	0	0	8	0	0
5	36653876	.	T	G	0	0	0	0	1	1	0	0
5	36654147	.	G	A	0	6	6	0	6	12	0	0
5	36654334	.	A	T	3	2	5	0	0	5	0	0
5	36654344	.	G	A	2	2	4	0	1	5	0	0
5	36665351	.	C	T	7	10	17	0	0	17	0	0
5	36668321	.	C	T	5	3	8	0	0	8	0	0
5	36673347	.	C	T	3	3	6	0	1	7	0	0
5	36673609	.	A	G	4	4	8	0	1	9	0	0
5	36674005	.	A	T	7	4	11	0	0	11	0	0
5	36674796	.	G	C	5	4	9	0	1	10	0	0
5	36674831	.	C	T	6	4	10	0	0	10	0	0
5	36674911	.	C	T	2	3	5	0	1	6	0	0
5	36674925	.	T	C	1	2	3	0	3	6	0	0
5	36730732	.	C	T	1	2	3	0	0	3	0	0
5	36732199	.	G	C	4	4	8	0	0	8	0	0
5	36732217	.	A	G	4	4	8	0	0	8	0	0
5	36739134	.	T	C	8	17	25	0	1	26	0	0
5	36739310	.	T	A	12	16	28	0	1	29	0	0
5	36739316	.	T	C	14	15	29	0	0	29	0	0
5	36739352	.	T	A	13	10	23	0	2	25	0	0
5	36739361	.	T	C	12	7	19	0	1	20	0	0
5	36802395	.	A	C	5	6	11	0	0	11	0	0
5	36802407	.	T	C	5	6	11	0	1	12	0	0
5	36851191	.	C	T	5	3	8	0	0	8	0	0
5	36852564	.	A	G	1	0	1	0	1	2	0	0
5	36852848	.	G	A	0	3	3	0	1	4	0	0
5	36853849	.	C	G	3	5	8	0	0	8	0	0
5	36898476	.	C	T	4	7	11	0	0	11	0	0
5	36898668	.	A	G	13	1	14	0	6	20	0	0
5	36901003	.	T	G	5	2	7	0	0	7	0	0
5	36902610	.	A	G	4	0	4	0	8	12	0	0
5	36902628	.	T	C	5	7	12	0	0	12	0	0
5	36907182	.	G	T	3	2	5	0	0	5	0	0
5	36908034	.	T	C	19	19	38	0	1	39	0	0
5	36913570	.	A	G	3	2	5	0	1	6	0	0
5	36914002	.	C	T	2	6	8	0	1	9	0	0
5	36914018	.	A	C	2	0	2	0	9	11	0	0
5	36916370	.	A	T	2	3	5	0	0	5	0	0
5	36924122	.	G	C	1	1	2	0	0	2	0	0
5	36945378	.	T	A	20	14	34	0	1	35	0	0
5	36945383	.	A	T	18	13	31	0	3	34	0	0
5	36945463	.	T	A	18	19	37	0	2	39	0	0
5	36945518	.	T	G	22	15	37	0	3	40	0	0
5	36945719	.	G	T	28	29	57	0	12	69	0	0
5	36945747	.	T	A	21	26	47	0	13	60	0	0
5	36945927	.	A	C	29	30	59	0	3	62	0	0
5	36945937	.	C	T	30	29	59	0	0	59	0	0
5	36946244	.	A	G	24	35	59	0	7	66	0	0
5	36946261	.	T	C	27	4	31	0	34	65	0	0
5	36946341	.	C	T	2	33	35	0	30	65	0	0
5	36996458	.	A	G	11	8	19	0	2	21	0	0
5	36996638	.	A	G	25	0	25	0	17	42	0	0
5	36997133	.	A	G	16	10	26	0	1	27	0	0
5	37032095	.	A	G	11	11	22	0	0	22	0	0
5	37032191	.	T	C	13	7	20	0	2	22	0	0
5	37032280	.	C	G	10	6	16	0	3	19	0	0
5	37032339	.	A	G	6	0	6	0	13	19	0	0
5	37032611	.	T	C	6	9	15	0	2	17	0	0
5	37032782	.	G	A	14	7	21	0	0	21	0	0
5	37032799	.	A	T	12	4	16	0	0	16	0	0
5	37032959	.	A	G	2	7	9	0	1	10	0	0
5	37034111	.	T	C	1	4	5	0	0	5	0	0
5	37036404	.	T	C	8	6	14	0	2	16	0	0
5	37036856	.	T	C	8	5	13	0	1	14	0	0
5	37036975	.	A	T	3	6	9	0	1	10	0	0
5	37037079	.	C	T	11	11	22	0	0	22	0	0
5	37037152	.	T	C	11	23	34	0	1	35	0	0
5	37037308	.	C	A	10	5	15	0	0	15	0	0
5	37037436	.	G	T	0	5	5	0	8	13	0	0
5	37037583	.	T	C	12	5	17	0	0	17	0	0
5	37037617	.	A	T	13	12	25	0	1	26	0	0
5	37037669	.	T	G	11	18	29	0	4	33	0	0
5	37037742	.	A	T	10	21	31	0	1	32	0	0
5	37038017	.	T	C	9	5	14	0	0	14	0	0
5	37061485	.	G	A	5	5	10	0	1	11	0	0
5	37061487	.	C	T	5	5	10	0	1	11	0	0
5	37065416	.	T	C	19	13	32	0	3	35	0	0
5	37065729	.	C	T	25	9	34	0	0	37	3	0
5	37095076	.	A	T	4	3	7	0	1	8	0	0
5	37277534	.	A	G	1	4	5	0	0	5	0	0
5	37280125	.	A	G	2	2	4	0	0	4	0	0
5	37280343	.	T	G	0	1	1	0	0	1	0	0
5	37280856	.	C	T	1	3	4	0	0	4	0	0
5	37286325	.	A	G	2	0	2	0	1	3	0	0
5	37293768	.	G	A	2	1	3	0	0	3	0	0
5	37293815	.	T	C	4	2	6	0	0	6	0	0
5	37293841	.	G	A	2	1	3	0	0	3	0	0
5	37296298	.	C	T	0	5	5	0	1	6	0	0
5	37301236	.	G	A	2	3	5	0	1	6	0	0
5	37301249	.	C	T	2	4	6	0	1	7	0	0
5	37301282	.	C	T	2	10	12	0	1	13	0	0
5	37301505	.	A	G	1	1	2	0	0	2	0	0
5	37301783	.	A	G	1	2	3	0	0	3	0	0
5	37304028	.	T	C	6	3	9	0	1	10	0	0
5	37307921	.	C	G	2	3	5	0	0	5	0	0
5	37309734	.	A	G	6	8	14	0	0	14	0	0
5	37309881	.	C	T	2	7	9	0	0	10	1	0
5	37331854	.	C	T	3	0	3	0	0	3	0	0
5	37333870	.	G	A	8	12	20	0	1	21	0	0
5	37334264	.	T	A	0	3	3	0	0	3	0	0
5	37380533	.	T	C	6	4	10	0	0	10	0	0
5	37413762	.	G	A	2	4	6	0	0	6	0	0
5	37422999	.	A	T	1	1	2	0	0	2	0	0
5	37423193	.	G	A	7	7	14	0	1	15	0	0
5	37439388	.	C	T	6	3	9	0	0	9	0	0
5	37439418	.	C	T	8	3	11	0	0	11	0	0
5	37439505	.	T	C	8	8	16	0	1	17	0	0
5	37439517	.	A	C	8	9	17	0	2	19	0	0
5	37439891	.	T	C	15	17	32	0	0	32	0	0
5	37505245	.	G	A	4	3	7	0	0	7	0	0
5	37507823	.	T	C	2	3	5	0	0	5	0	0
5	37507901	.	C	T	6	6	12	0	0	12	0	0
5	37508893	.	A	T	2	1	3	0	1	4	0	0
5	37508979	.	A	C	1	2	3	0	0	3	0	0
5	37509156	.	G	A	1	6	7	0	0	7	0	0
5	37509296	.	G	C	9	7	16	0	0	16	0	0
5	37509703	.	C	T	9	13	22	0	0	22	0	0
5	37509766	.	G	A	0	11	11	0	8	19	0	0
5	37509857	.	A	G	4	8	12	0	0	12	0	0
5	37509916	.	A	G	6	5	11	0	0	11	0	0
5	37510292	.	C	T	4	5	9	0	0	9	0	0
5	37510293	.	T	C	4	5	9	0	0	9	0	0
5	37510574	.	C	G	3	5	8	0	0	8	0	0
5	37578979	.	G	A	0	2	2	0	1	3	0	0
5	37580857	.	C	T	0	1	1	0	0	1	0	0
5	37581111	.	G	A	1	1	2	0	0	2	0	0
5	37584160	.	A	G	2	2	4	0	0	4	0	0
5	37584380	.	G	A	0	2	2	0	2	4	0	0
5	37584401	.	C	T	0	2	2	0	1	3	0	0
5	37677229	.	C	T	2	6	8	0	0	8	0	0
5	37678256	.	T	C	6	6	12	0	0	12	0	0
5	37680403	.	G	A	0	1	1	0	3	4	0	0
5	37686590	.	C	T	4	0	4	0	0	4	0	0
5	37688077	.	C	T	0	2	2	0	0	2	0	0
5	37688422	.	A	G	5	5	10	0	0	10	0	0
5	37688878	.	A	C	10	10	20	0	0	20	0	0
5	37691223	.	A	G	2	0	2	0	1	3	0	0
5	37692171	.	A	G	0	1	1	0	0	1	0	0
5	37692620	.	T	C	6	8	14	0	0	14	0	0
5	37694283	.	G	A	3	1	4	0	1	5	0	0
5	37694568	.	A	C	11	9	20	0	0	20	0	0
5	37695528	.	A	G	1	2	3	0	1	4	0	0
5	37696582	.	G	A	6	7	13	0	0	13	0	0
5	37697134	.	C	T	14	6	20	0	2	22	0	0
5	37699115	.	A	G	7	4	11	0	0	11	0	0
5	37700687	.	C	A	2	0	2	0	0	2	0	0
5	37700908	.	T	C	16	15	31	0	2	33	0	0
5	37701262	.	T	A	10	11	21	0	1	22	0	0
5	37702934	.	C	T	17	10	27	0	2	29	0	0
5	37703176	.	G	A	0	3	3	0	4	7	0	0
5	37706798	.	C	T	7	5	12	0	1	13	0	0
5	37707190	.	G	A	10	7	17	0	1	18	0	0
5	37708995	.	A	T	21	24	45	0	0	45	0	0
5	37709057	.	T	A	16	21	37	0	1	38	0	0
5	37757505	.	C	T	2	3	5	0	0	5	0	0
5	37757677	.	C	T	3	5	8	0	0	8	0	0
5	37757690	.	T	C	3	6	9	0	0	9	0	0
5	37812103	.	C	T	1	2	3	0	0	3	0	0
5	37838415	.	T	C	3	5	8	0	1	9	0	0
5	37839029	.	G	T	29	21	50	0	4	54	0	0
5	37851082	.	T	A	4	2	6	0	0	6	0	0
5	37851166	.	C	A	1	2	3	0	0	3	0	0
5	37851171	.	A	G	1	2	3	0	0	3	0	0
5	37851201	.	C	T	1	3	4	0	0	4	0	0
5	37851438	.	T	A	1	4	5	0	0	5	0	0
5	37851528	.	T	C	3	4	7	0	0	7	0	0
5	37851542	.	G	A	3	4	7	0	0	7	0	0
5	37851579	.	C	T	1	2	3	0	0	3	0	0
5	37851588	.	A	C	1	2	3	0	1	4	0	0
5	37851742	.	G	A	1	3	4	0	0	4	0	0
5	37851758	.	T	A	1	3	4	0	0	4	0	0
5	37851876	.	C	T	6	5	11	0	0	11	0	0
5	37864845	.	A	G	11	5	16	0	1	17	0	0
5	37865090	.	G	C	6	3	9	0	0	9	0	0
5	37865142	.	C	T	6	7	13	0	0	13	0	0
5	37865628	.	T	C	7	4	11	0	0	11	0	0
5	37865677	.	G	T	4	4	8	0	0	8	0	0
5	37865744	.	C	G	3	5	8	0	0	8	0	0
5	37867491	.	C	T	0	2	2	0	0	2	0	0
5	37880896	.	C	T	0	2	2	0	3	5	0	0
5	37880922	.	G	A	2	3	5	0	0	5	0	0
5	37912292	.	T	A	20	11	31	0	3	34	0	0
5	37912442	.	A	G	8	8	16	0	0	16	0	0
5	37912489	.	T	A	10	11	21	0	0	21	0	0
5	37912748	.	A	T	9	11	20	0	2	22	0	0
5	37912859	.	A	C	9	13	22	0	1	23	0	0
5	37912970	.	A	C	9	10	19	0	1	20	0	0
5	37913041	.	C	G	14	9	23	0	1	24	0	0
5	37913064	.	T	C	15	11	26	0	1	27	0	0
5	37918894	.	A	T	5	9	14	0	1	15	0	0
5	37918932	.	A	T	5	6	11	0	0	11	0	0
5	37918994	.	C	T	5	5	10	0	0	10	0	0
5	37933914	.	A	G	0	1	1	0	0	1	0	0
5	37934005	.	C	T	4	4	8	0	0	8	0	0
5	37934206	.	T	C	2	2	4	0	1	5	0	0
5	37963259	.	C	T	7	9	16	0	2	18	0	0
5	37963262	.	G	T	10	7	17	0	1	18	0	0
5	37963326	.	C	A	8	11	19	0	2	21	0	0
5	37968912	.	T	G	2	6	8	0	0	8	0	0
5	37968951	.	G	A	6	2	8	0	1	9	0	0
5	37968966	.	T	C	5	1	6	0	0	6	0	0
5	37970764	.	C	T	10	9	19	0	1	20	0	0
5	37970773	.	A	T	7	7	14	0	1	15	0	0
5	37970818	.	T	G	8	1	9	0	9	19	1	0
5	37981906	.	T	G	5	4	9	0	0	9	0	0
5	37982156	.	G	C	0	0	0	0	2	2	0	0
5	37987325	.	C	T	0	2	2	0	5	7	0	0
5	37987369	.	G	A	1	1	2	0	0	2	0	0
5	37988969	.	G	T	7	5	12	0	0	12	0	0
5	37989090	.	G	A	4	4	8	0	1	9	0	0
5	37989135	.	A	G	8	4	12	0	2	14	0	0
5	37989325	.	G	A	9	11	20	0	0	20	0	0
5	37989379	.	G	T	6	6	12	0	0	12	0	0
5	37989443	.	A	C	3	5	8	0	1	9	0	0
5	37989447	.	A	G	3	6	9	0	0	9	0	0
5	37991350	.	T	A	1	2	3	0	0	3	0	0
5	37991535	.	T	G	2	0	2	0	0	2	0	0
5	37991566	.	C	A	0	0	0	0	2	2	0	0
5	37992120	.	T	C	1	0	1	0	0	1	0	0
5	38089247	.	G	T	6	2	8	0	0	8	0	0
5	38089537	.	T	C	2	3	5	0	0	5	0	0
5	38089578	.	T	G	1	2	3	0	0	3	0	0
5	38089651	.	G	A	5	5	10	0	0	10	0	0
5	38089834	.	A	G	2	3	5	0	0	5	0	0
5	38089930	.	G	T	2	4	6	0	2	8	0	0
5	38090230	.	A	C	5	2	7	0	0	7	0	0
5	38090659	.	G	C	3	0	3	0	5	8	0	0
5	38090677	.	A	G	6	3	9	0	0	9	0	0
5	38090707	.	G	A	2	2	4	0	0	4	0	0
5	38091247	.	A	G	2	3	5	0	0	5	0	0
5	38097190	.	G	T	1	2	3	0	0	3	0	0
5	38107054	.	T	C	2	2	4	0	0	4	0	0
5	38110826	.	G	T	2	3	5	0	1	6	0	0
5	38110908	.	A	T	10	4	14	0	1	15	0	0
5	38111060	.	T	C	8	0	8	0	6	14	0	0
5	38115349	.	T	C	3	5	8	0	0	8	0	0
5	38115361	.	T	C	3	5	8	0	0	8	0	0
5	38115502	.	C	T	4	7	11	0	1	12	0	0
5	38115582	.	C	T	11	4	15	0	0	15	0	0
5	38115685	.	A	T	6	5	11	0	0	11	0	0
5	38120116	.	A	G	1	0	1	0	0	1	0	0
5	38120117	.	C	A	1	0	1	0	0	1	0	0
5	38121914	.	T	A	4	4	8	0	0	8	0	0
5	38121942	.	A	G	7	5	12	0	0	12	0	0
5	38121991	.	A	T	9	2	11	0	1	12	0	0
5	38121993	.	T	C	9	3	12	0	0	12	0	0
5	38122100	.	C	A	7	5	12	0	0	12	0	0
5	38122112	.	T	A	6	5	11	0	0	11	0	0
5	38214567	.	T	G	1	3	4	0	0	4	0	0
5	38216175	.	T	G	1	2	3	0	0	3	0	0
5	38216204	.	G	A	2	3	5	0	0	5	0	0
5	38217224	.	G	A	7	4	11	0	0	11	0	0
5	38217376	.	T	C	2	3	5	0	0	5	0	0
5	38217422	.	G	T	5	2	7	0	0	7	0	0
5	38218004	.	G	A	2	2	4	0	0	4	0	0
5	38251120	.	A	C	2	5	7	0	0	7	0	0
5	38251347	.	T	C	3	0	3	0	2	5	0	0
5	38251360	.	T	C	2	2	4	0	0	4	0	0
5	38251506	.	C	T	0	3	3	0	4	7	0	0
5	38251968	.	T	G	4	8	12	0	0	12	0	0
5	38252113	.	G	C	1	2	3	0	0	3	0	0
5	38254734	.	A	G	3	7	10	0	0	10	0	0
5	38254919	.	A	G	2	5	7	0	0	7	0	0
5	38254958	.	C	T	0	6	6	0	4	10	0	0
5	38255108	.	G	T	3	3	6	0	1	7	0	0
5	38255132	.	G	A	4	4	8	0	0	8	0	0
5	38255219	.	A	C	5	0	5	0	6	11	0	0
5	38263384	.	G	A	10	16	26	0	0	26	0	0
5	38263611	.	G	A	12	14	26	0	0	26	0	0
5	38263870	.	C	T	2	1	3	0	0	3	0	0
5	38281540	.	G	C	1	5	6	0	4	10	0	0
5	38287103	.	C	T	15	12	27	0	1	28	0	0
5	38289358	.	A	C	14	16	30	0	4	34	0	0
5	38296192	.	C	T	18	28	46	0	1	47	0	0
5	38296193	.	A	G	19	28	47	0	0	47	0	0
5	38296475	.	G	A	17	18	35	0	1	36	0	0
5	38296765	.	A	C	13	22	35	0	2	37	0	0
5	38296799	.	A	C	21	21	42	0	4	46	0	0
5	38297305	.	A	G	18	0	18	0	22	40	0	0
5	38302085	.	G	A	15	16	31	0	0	31	0	0
5	38302158	.	C	A	13	18	31	0	2	33	0	0
5	38302159	.	A	C	23	10	33	0	0	33	0	0
5	38302490	.	A	G	22	21	43	0	1	44	0	0
5	38302589	.	T	A	18	15	33	0	0	33	0	0
5	38302753	.	G	T	18	22	40	0	10	50	0	0
5	38302859	.	C	T	17	20	37	0	4	41	0	0
5	38302911	.	A	T	13	12	25	0	3	28	0	0
5	38303028	.	G	T	11	21	32	0	1	33	0	0
5	38303301	.	T	C	12	0	12	0	20	32	0	0
5	38303895	.	A	T	16	21	37	0	0	37	0	0
5	38303896	.	G	A	16	21	37	0	0	37	0	0
5	38304578	.	C	T	7	28	35	0	2	37	0	0
5	38304633	.	T	G	18	17	35	0	3	38	0	0
5	38304768	.	G	A	16	17	33	0	1	34	0	0
5	38305068	.	G	A	24	19	43	0	0	43	0	0
5	38305127	.	T	C	15	10	25	0	2	29	2	0
5	38305493	.	C	T	6	9	15	0	2	17	0	0
5	38305698	.	G	A	7	11	18	0	2	20	0	0
5	38308378	.	C	A	1	4	5	0	2	7	0	0
5	38314069	.	C	T	3	6	9	0	0	9	0	0
5	38320825	.	A	G	4	2	6	0	0	6	0	0
5	38324453	.	C	T	2	0	2	0	0	2	0	0
5	38349956	.	A	G	1	1	2	0	0	2	0	0
5	38363132	.	T	C	1	0	1	0	5	6	0	0
5	38388741	.	C	A	2	3	5	0	0	5	0	0
5	38388786	.	G	A	3	2	5	0	1	6	0	0
5	38388875	.	C	G	0	4	4	0	2	6	0	0
5	38389087	.	C	G	4	5	9	0	0	9	0	0
5	38389089	.	G	A	4	5	9	0	0	9	0	0
5	38389147	.	T	C	2	2	4	0	0	4	0	0
5	38389441	.	A	T	1	0	1	0	0	1	0	0
5	38389538	.	G	A	3	3	6	0	0	6	0	0
5	38389641	.	G	A	5	2	7	0	0	7	0	0
5	38389642	.	G	T	5	2	7	0	0	7	0	0
5	38390323	.	C	A	3	3	6	0	0	6	0	0
5	38390352	.	A	G	2	2	4	0	0	4	0	0
5	38399358	.	C	A	1	2	3	0	0	3	0	0
5	38476185	.	C	T	1	5	6	0	0	6	0	0
5	38476750	.	C	A	4	6	10	0	1	11	0	0
5	38506785	.	T	G	6	2	8	0	0	8	0	0
5	38531848	.	T	A	8	9	17	0	0	17	0	0
5	38532216	.	A	T	8	7	15	0	0	15	0	0
5	38532462	.	T	C	7	0	7	0	10	17	0	0
5	38532535	.	A	G	5	5	10	0	0	10	0	0
5	38533170	.	A	G	3	11	14	0	0	14	0	0
5	38533248	.	G	A	4	9	13	0	0	13	0	0
5	38533296	.	T	G	7	13	20	0	0	20	0	0
5	38533392	.	G	T	7	10	17	0	1	18	0	0
5	38533404	.	C	T	0	8	8	0	7	15	0	0
5	38533464	.	A	G	5	8	13	0	0	13	0	0
5	38533551	.	A	G	6	8	14	0	0	14	0	0
5	38604332	.	C	T	1	0	1	0	0	1	0	0
5	38604977	.	T	C	1	2	3	0	0	3	0	0
5	38605094	.	C	T	2	8	10	0	1	11	0	0
5	38605106	.	A	T	2	8	10	0	1	11	0	0
5	38605164	.	C	T	6	4	10	0	0	10	0	0
5	38605201	.	A	C	6	5	11	0	1	12	0	0
5	38605291	.	G	C	11	10	21	0	0	21	0	0
5	38605347	.	G	T	11	8	19	0	1	20	0	0
5	38611096	.	G	T	4	3	7	0	0	7	0	0
5	38611108	.	T	C	2	1	3	0	2	5	0	0
5	38749938	.	A	G	2	2	4	0	0	4	0	0
5	38786922	.	T	C	8	5	13	0	0	13	0	0
5	38826047	.	A	C	1	2	3	0	0	3	0	0
5	38831573	.	A	G	3	3	6	0	1	7	0	0
5	38834457	.	G	A	0	2	2	0	0	2	0	0
5	39084712	.	T	G	1	2	3	0	0	3	0	0
5	39085067	.	G	T	0	2	2	0	1	3	0	0
5	39085112	.	C	G	2	2	4	0	0	4	0	0
5	39085467	.	A	G	1	0	1	0	2	3	0	0
5	39085475	.	T	C	0	3	3	0	1	4	0	0
5	39085976	.	C	T	5	6	11	0	0	11	0	0
5	39136032	.	G	A	7	3	10	0	1	11	0	0
5	39142657	.	A	G	0	0	0	0	1	1	0	0
5	39143310	.	C	T	5	3	8	0	0	8	0	0
5	39143447	.	C	T	6	7	13	0	0	13	0	0
5	39150608	.	C	A	2	3	5	0	1	6	0	0
5	39150623	.	C	T	2	3	5	0	0	5	0	0
5	39151045	.	A	T	1	2	3	0	0	3	0	0
5	39151610	.	T	A	2	2	4	0	0	4	0	0
5	39152411	.	C	T	2	4	6	0	0	6	0	0
5	39152582	.	A	G	2	2	4	0	0	4	0	0
5	39152613	.	T	A	1	2	3	0	1	4	0	0
5	39154714	.	A	C	1	0	1	0	3	4	0	0
5	39154819	.	C	G	13	6	19	0	2	21	0	0
5	39154829	.	G	T	15	8	23	0	0	23	0	0
5	39154919	.	A	G	11	10	21	0	0	21	0	0
5	39154958	.	C	G	9	10	19	0	2	21	0	0
5	39154979	.	C	T	0	10	10	0	9	19	0	0
5	39155006	.	T	A	7	11	18	0	0	18	0	0
5	39155044	.	A	G	6	10	16	0	0	16	0	0
5	39155146	.	T	A	6	2	8	0	0	8	0	0
5	39155473	.	T	A	6	3	9	0	2	11	0	0
5	39155474	.	G	T	8	3	11	0	0	11	0	0
5	39155511	.	A	G	7	4	11	0	0	11	0	0
5	39160584	.	G	A	5	6	11	0	0	11	0	0
5	39169387	.	T	C	3	0	3	0	1	4	0	0
5	39386667	.	A	G	4	2	6	0	0	6	0	0
5	39386685	.	A	G	4	2	6	0	0	6	0	0
5	39504271	.	G	C	4	5	9	0	0	9	0	0
5	39504307	.	C	A	1	0	1	0	0	1	0	0
5	39508009	.	C	T	20	14	34	0	0	34	0	0
5	39508059	.	T	A	20	7	27	0	1	28	0	0
5	39508540	.	G	A	1	6	7	0	14	21	0	0
5	39707758	.	A	C	3	3	6	0	3	9	0	0
5	39707825	.	G	A	11	10	21	0	0	21	0	0
5	39708046	.	A	G	12	13	25	0	0	25	0	0
5	39712557	.	T	C	0	1	1	0	0	1	0	0
5	39714917	.	T	C	3	0	3	0	0	3	0	0
5	39715249	.	G	A	6	2	8	0	0	8	0	0
5	39730511	.	A	G	8	4	12	0	1	13	0	0
5	39730575	.	C	T	0	1	1	0	0	1	0	0
5	39730785	.	A	G	0	1	1	0	0	1	0	0
5	39731805	.	T	C	2	9	11	0	0	11	0	0
5	39805398	.	T	C	1	0	1	0	2	3	0	0
5	40003053	.	G	A	0	2	2	0	0	2	0	0
5	40012989	.	G	A	1	0	1	0	0	1	0	0
5	40024831	.	C	T	0	4	4	0	5	9	0	0
5	40052933	.	A	G	11	26	37	0	1	38	0	0
5	40054407	.	C	G	4	2	6	0	0	6	0	0
5	40059722	.	C	G	16	17	33	0	0	33	0	0
5	40059761	.	T	C	12	14	26	0	1	27	0	0
5	40062351	.	A	G	11	14	25	0	3	28	0	0
5	40062390	.	G	A	9	8	17	0	0	17	0	0
5	40071745	.	C	T	4	1	5	0	1	6	0	0
5	40078717	.	C	A	0	3	3	0	0	3	0	0
5	40080885	.	G	A	1	1	2	0	0	2	0	0
5	40093858	.	G	A	0	0	0	0	1	1	0	0
5	40097502	.	A	G	3	3	6	0	0	6	0	0
5	40097505	.	A	G	3	3	6	0	0	6	0	0
5	40097831	.	A	G	2	2	4	0	0	4	0	0
5	40111613	.	G	T	0	1	1	0	0	1	0	0
5	40203540	.	G	A	2	5	7	0	0	7	0	0
5	40206117	.	G	A	3	4	7	0	0	7	0	0
5	40206358	.	A	C	2	5	7	0	1	8	0	0
5	40210379	.	A	C	5	4	9	0	1	10	0	0
5	40273166	.	C	A	3	5	8	0	0	8	0	0
5	40273188	.	A	G	5	2	7	0	0	7	0	0
5	40273510	.	G	T	2	4	6	0	0	6	0	0
5	40273606	.	C	T	0	2	2	0	1	3	0	0
5	40273727	.	T	A	5	4	9	0	0	9	0	0
5	40505124	.	C	T	0	4	4	0	1	5	0	0
5	40506670	.	G	A	4	2	6	0	0	6	0	0
5	40507577	.	C	A	1	3	4	0	0	4	0	0
5	40508436	.	T	C	1	0	1	0	1	2	0	0
5	40729081	.	A	C	4	4	8	0	0	8	0	0
5	40729147	.	T	C	3	4	7	0	0	7	0	0
5	40729270	.	G	C	3	6	9	0	0	9	0	0
5	40729408	.	G	A	7	5	12	0	0	12	0	0
5	40729618	.	A	G	8	7	15	0	1	16	0	0
5	40732293	.	A	G	2	4	6	0	0	6	0	0
5	40732341	.	T	A	1	1	2	0	0	2	0	0
5	40845312	.	A	G	7	8	15	0	0	15	0	0
5	40845344	.	G	C	5	5	10	0	0	10	0	0
5	40845387	.	A	G	2	9	11	0	0	11	0	0
5	40845389	.	A	T	2	8	10	0	1	11	0	0
5	40845433	.	A	G	7	6	13	0	0	13	0	0
5	40845434	.	G	A	7	5	12	0	1	13	0	0
5	40845505	.	G	C	4	0	4	0	4	8	0	0
5	40845556	.	C	A	7	1	8	0	0	8	0	0
5	40845893	.	A	G	8	8	16	0	0	16	0	0
5	40846122	.	G	A	6	8	14	0	1	15	0	0
5	40877058	.	T	C	1	0	1	0	0	1	0	0
5	40910770	.	A	G	1	2	3	0	1	4	0	0
5	40935003	.	C	T	2	2	4	0	0	4	0	0
5	40956111	.	G	A	1	1	2	0	0	2	0	0
5	41082921	.	C	G	10	9	19	0	0	19	0	0
5	41082951	.	A	C	7	0	7	0	7	14	0	0
5	41083000	.	C	A	11	6	17	0	0	17	0	0
5	41083001	.	T	C	11	0	11	0	6	17	0	0
5	41083118	.	C	T	0	2	2	0	6	8	0	0
5	41083227	.	A	G	8	4	12	0	1	13	0	0
5	41083763	.	A	G	6	6	12	0	0	12	0	0
5	41084063	.	G	C	7	10	17	0	1	18	0	0
5	41084274	.	A	G	11	10	21	0	1	22	0	0
5	41084367	.	C	A	0	7	7	0	10	17	0	0
5	41085049	.	A	C	3	3	6	0	0	6	0	0
5	41085414	.	T	A	4	4	8	0	0	8	0	0
5	41085511	.	C	T	0	4	4	0	4	8	0	0
5	41085571	.	T	C	7	0	7	0	4	11	0	0
5	41085582	.	C	T	7	3	10	0	0	10	0	0
5	41086082	.	T	G	2	9	11	0	0	11	0	0
5	41086195	.	A	T	5	4	9	0	0	9	0	0
5	41103286	.	T	C	8	7	15	0	1	16	0	0
5	41103462	.	A	G	12	8	20	0	0	20	0	0
5	41103469	.	G	A	12	8	20	0	1	21	0	0
5	41124760	.	T	C	4	0	4	0	4	8	0	0
5	41125097	.	C	T	3	5	8	0	0	8	0	0
5	41125173	.	A	G	2	1	3	0	0	3	0	0
5	41125229	.	G	T	10	7	17	0	1	18	0	0
5	41125310	.	A	C	17	23	40	0	0	40	0	0
5	41125311	.	A	C	16	22	38	0	2	40	0	0
5	41125354	.	C	A	25	15	40	0	0	40	0	0
5	41125996	.	T	C	22	13	35	0	2	37	0	0
5	41126059	.	G	A	18	20	38	0	0	38	0	0
5	41127078	.	A	G	1	5	6	0	0	6	0	0
5	41127111	.	T	C	3	11	14	0	0	14	0	0
5	41127132	.	C	T	3	11	14	0	0	14	0	0
5	41128808	.	T	G	8	5	13	0	0	13	0	0
5	41133401	.	A	T	15	4	19	0	0	19	0	0
5	41134921	.	A	T	8	6	14	0	1	15	0	0
5	41134942	.	A	G	13	8	21	0	1	22	0	0
5	41135002	.	A	G	17	15	32	0	1	33	0	0
5	41137311	.	G	A	13	13	26	0	3	29	0	0
5	41137341	.	G	A	16	13	29	0	4	33	0	0
5	41138377	.	C	T	19	10	29	0	3	32	0	0
5	41138720	.	T	C	13	9	22	0	0	23	1	0
5	41138738	.	A	G	17	5	22	0	3	25	0	0
5	41138756	.	C	A	20	11	31	0	2	33	0	0
5	41138807	.	T	C	22	0	22	0	15	37	0	0
5	41150615	.	C	T	10	11	21	0	0	21	0	0
5	41150898	.	T	A	24	13	37	0	0	37	0	0
5	41150979	.	A	C	25	19	44	0	1	45	0	0
5	41151265	.	G	A	11	5	16	0	1	17	0	0
5	41260937	.	C	T	4	10	14	0	0	14	0	0
5	41261032	.	A	G	6	5	11	0	0	11	0	0
5	41261680	.	A	G	3	3	6	0	1	7	0	0
5	41261684	.	G	A	3	5	8	0	0	8	0	0
5	41261901	.	G	C	2	2	4	0	0	4	0	0
5	41261907	.	G	A	3	2	5	0	0	5	0	0
5	41286892	.	G	A	0	1	1	0	0	1	0	0
5	41306624	.	G	A	1	2	3	0	0	3	0	0
5	41478237	.	G	A	1	2	3	0	0	3	0	0
5	41478349	.	C	T	1	5	6	0	0	6	0	0
5	41478382	.	T	C	1	3	4	0	0	4	0	0
5	41481405	.	A	G	5	3	8	0	0	8	0	0
5	41484391	.	A	C	4	4	8	0	0	8	0	0
5	41484460	.	T	C	9	8	17	0	0	17	0	0
5	41484496	.	T	C	6	8	14	0	0	14	0	0
5	41484680	.	C	T	7	8	15	0	1	16	0	0
5	41484797	.	C	A	5	8	13	0	4	17	0	0
5	41485363	.	C	G	16	14	30	0	3	33	0	0
5	41485365	.	A	G	17	15	32	0	1	33	0	0
5	41485497	.	C	G	22	22	44	0	2	46	0	0
5	41485533	.	C	T	3	25	28	0	28	56	0	0
5	41485709	.	A	T	21	34	55	0	3	58	0	0
5	41485814	.	A	T	24	28	52	0	0	52	0	0
5	41486025	.	A	G	31	30	61	0	5	66	0	0
5	41486031	.	T	G	32	31	63	0	1	64	0	0
5	41486803	.	G	A	3	4	7	0	0	7	0	0
5	41486890	.	C	T	22	23	45	0	2	47	0	0
5	41488903	.	A	G	20	20	40	0	1	41	0	0
5	41489487	.	G	T	9	25	34	0	3	37	0	0
5	41489493	.	C	T	12	26	38	0	1	39	0	0
5	41489748	.	T	C	7	12	19	0	1	20	0	0
5	41492135	.	C	T	2	2	4	0	0	4	0	0
5	41492183	.	C	T	0	12	12	0	15	27	0	0
5	41492234	.	G	A	23	16	39	0	1	40	0	0
5	41492279	.	G	A	12	7	19	0	2	21	0	0
5	41492901	.	G	A	20	20	40	0	0	40	0	0
5	41492934	.	A	G	21	21	42	0	2	44	0	0
5	41513013	.	T	C	6	6	12	0	0	12	0	0
5	41514127	.	A	G	1	2	3	0	0	3	0	0
5	41516322	.	A	C	2	4	6	0	0	6	0	0
5	41516521	.	G	A	6	3	9	0	0	9	0	0
5	41518836	.	T	C	17	22	39	0	2	41	0	0
5	41519423	.	A	C	21	21	42	0	2	44	0	0
5	41519459	.	T	C	11	13	24	0	1	25	0	0
5	41520822	.	A	T	13	21	34	0	0	34	0	0
5	41520823	.	T	C	13	20	33	0	1	34	0	0
5	41523389	.	G	C	2	0	2	0	2	4	0	0
5	41582736	.	G	A	2	4	6	0	0	6	0	0
5	41585126	.	C	T	3	6	9	0	0	9	0	0
5	41585186	.	G	A	4	7	11	0	1	12	0	0
5	41595242	.	C	T	0	2	2	0	0	2	0	0
5	41595243	.	T	C	0	2	2	0	0	2	0	0
5	41626474	.	C	T	0	3	3	0	0	3	0	0
5	41626492	.	C	T	0	2	2	0	0	2	0	0
5	41634467	.	T	C	1	2	3	0	0	3	0	0
5	41639814	.	A	G	5	2	7	0	0	7	0	0
5	41639874	.	G	T	1	6	7	0	0	7	0	0
5	41641750	.	G	A	8	14	22	0	0	22	0	0
5	41641835	.	G	C	7	15	22	0	0	22	0	0
5	41641887	.	A	G	12	7	19	0	3	22	0	0
5	41642167	.	A	G	1	2	3	0	0	3	0	0
5	41642348	.	G	A	1	2	3	0	0	3	0	0
5	41643084	.	A	G	2	2	4	0	0	4	0	0
5	41643095	.	A	G	2	3	5	0	0	5	0	0
5	41643359	.	G	A	1	0	1	0	0	1	0	0
5	41645652	.	A	G	14	16	30	0	1	31	0	0
5	41645815	.	C	G	10	6	16	0	0	16	0	0
5	41645827	.	T	A	14	7	21	0	0	21	0	0
5	41645982	.	A	G	9	8	17	0	4	21	0	0
5	41650451	.	T	C	17	0	17	0	12	29	0	0
5	41655155	.	T	A	4	6	10	0	0	10	0	0
5	41670193	.	G	A	7	5	12	0	0	12	0	0
5	41676855	.	T	C	3	6	9	0	0	9	0	0
5	41689439	.	T	G	1	0	1	0	0	1	0	0
5	41691606	.	A	G	2	0	2	0	0	2	0	0
5	41878612	.	A	C	10	11	21	0	0	21	0	0
5	41878660	.	A	G	11	12	23	0	1	24	0	0
5	41878711	.	C	T	0	13	13	0	14	27	0	0
5	41878965	.	G	C	5	8	13	0	0	13	0	0
5	41879465	.	C	G	8	8	16	0	2	18	0	0
5	41879497	.	T	C	10	7	17	0	0	17	0	0
5	41879848	.	C	A	5	3	8	0	0	8	0	0
5	41880240	.	T	C	6	0	6	0	15	21	0	0
5	41880243	.	T	C	5	0	5	0	14	19	0	0
5	41880280	.	C	G	9	20	29	0	1	30	0	0
5	41880288	.	G	A	8	16	24	0	1	25	0	0
5	41882364	.	T	C	0	2	2	0	2	4	0	0
5	41888132	.	T	C	10	0	10	0	12	22	0	0
5	41890054	.	G	A	8	13	21	0	1	22	0	0
5	41890092	.	A	G	8	7	15	0	0	15	0	0
5	41890277	.	T	G	0	0	0	0	1	1	0	0
5	41891324	.	T	C	1	0	1	0	0	1	0	0
5	41898424	.	A	G	0	2	2	0	0	2	0	0
5	41900012	.	A	C	0	1	1	0	0	1	0	0
5	41900020	.	A	G	1	1	2	0	0	2	0	0
5	41900126	.	G	T	4	7	11	0	0	11	0	0
5	41900153	.	T	C	3	0	3	0	8	11	0	0
5	41900604	.	C	T	1	3	4	0	0	4	0	0
5	41901093	.	T	C	1	3	4	0	0	4	0	0
5	41914647	.	A	G	0	2	2	0	0	2	0	0
5	41914679	.	G	T	1	3	4	0	0	4	0	0
5	41914692	.	T	C	1	3	4	0	0	4	0	0
5	41917426	.	C	T	2	2	4	0	1	5	0	0
5	41917678	.	T	A	2	1	3	0	0	3	0	0
5	41932185	.	C	T	0	2	2	0	1	3	0	0
5	41974556	.	C	A	0	1	1	0	0	1	0	0
5	41975971	.	T	A	1	1	2	0	0	2	0	0
5	41984305	.	A	G	2	2	4	0	0	4	0	0
5	41997144	.	G	A	3	2	5	0	0	5	0	0
5	41997146	.	A	T	3	2	5	0	0	5	0	0
5	42053985	.	C	A	1	2	3	0	1	4	0	0
5	42064204	.	T	G	1	1	2	0	0	2	0	0
5	42066958	.	C	T	1	0	1	0	0	1	0	0
5	42067588	.	G	A	0	2	2	0	0	2	0	0
5	42092244	.	G	A	1	2	3	0	0	3	0	0
5	42122907	.	C	T	7	6	13	0	3	16	0	0
5	42122914	.	C	T	9	7	16	0	3	19	0	0
5	42123023	.	C	T	16	7	23	0	0	23	0	0
5	42123125	.	C	T	24	18	42	0	0	42	0	0
5	42123375	.	C	A	18	14	32	0	0	32	0	0
5	42123664	.	A	G	12	9	21	0	0	21	0	0
5	42123697	.	G	C	16	14	30	0	1	31	0	0
5	42123766	.	G	T	7	11	18	0	1	19	0	0
5	43073005	.	A	T	7	7	14	0	1	15	0	0
5	43073019	.	T	C	7	8	15	0	1	16	0	0
5	43073116	.	T	C	3	4	7	0	0	7	0	0
5	43082997	.	A	G	10	0	10	0	13	23	0	0
5	43083084	.	A	C	3	6	9	0	0	9	0	0
5	43617277	.	C	G	5	9	14	0	0	14	0	0
5	43617295	.	C	G	4	9	13	0	1	14	0	0
5	43617692	.	T	C	8	0	8	0	12	20	0	0
5	43626060	.	C	T	0	2	2	0	1	3	0	0
5	43638710	.	C	T	0	2	2	0	0	2	0	0
5	43798423	.	G	T	0	1	1	0	0	1	0	0
5	43801223	.	T	C	1	0	1	0	1	2	0	0
5	43804235	.	T	C	5	0	5	0	4	9	0	0
5	43804251	.	G	A	9	6	15	0	0	15	0	0
5	43804475	.	T	C	4	0	4	0	2	6	0	0
5	43807016	.	C	T	1	2	3	0	0	3	0	0
5	43807070	.	G	A	0	3	3	0	6	9	0	0
5	43807340	.	T	C	2	7	9	0	0	9	0	0
5	43808965	.	T	C	11	10	21	0	0	21	0	0
5	43810302	.	G	A	5	1	6	0	1	7	0	0
5	43813003	.	G	A	1	3	4	0	0	4	0	0
5	43819422	.	T	A	11	11	22	0	0	22	0	0
5	43861561	.	A	T	3	4	7	0	2	9	0	0
5	43861922	.	A	T	5	2	7	0	0	7	0	0
5	43862069	.	C	T	0	10	10	0	8	18	0	0
5	43862318	.	T	C	5	0	5	0	4	9	0	0
5	43862449	.	G	A	2	5	7	0	1	8	0	0
5	43862725	.	T	A	10	3	13	0	0	13	0	0
5	43862924	.	A	G	10	10	20	0	1	21	0	0
5	43862954	.	A	T	8	9	17	0	0	17	0	0
5	43863052	.	C	T	8	3	11	1	0	12	0	0
5	43863222	.	A	T	5	3	8	0	0	8	0	0
5	43863241	.	G	A	5	5	10	0	0	10	0	0
5	43863304	.	T	C	6	3	9	0	0	9	0	0
5	43864122	.	T	A	2	3	5	0	0	5	0	0
5	43864127	.	C	T	3	3	6	0	0	6	0	0
5	43864907	.	G	A	1	2	3	0	0	3	0	0
5	43866804	.	T	G	5	9	14	0	0	14	0	0
5	43867013	.	A	C	1	3	4	0	0	4	0	0
5	43893543	.	C	T	3	2	5	0	0	5	0	0
5	43894951	.	A	G	2	1	3	0	0	3	0	0
5	44235994	.	A	T	4	2	6	0	0	6	0	0
5	44236045	.	T	C	2	3	5	0	0	5	0	0
5	44238706	.	G	A	1	0	1	0	0	1	0	0
5	44262496	.	C	T	16	13	29	0	0	29	0	0
5	44262756	.	C	G	3	5	8	0	0	8	0	0
5	44262935	.	A	G	0	3	3	0	1	4	0	0
5	44263024	.	T	A	6	9	15	0	0	15	0	0
5	44263078	.	A	T	10	5	15	0	0	15	0	0
5	44263204	.	C	A	8	10	18	0	0	18	0	0
5	44263851	.	T	A	4	6	10	0	4	14	0	0
5	44352300	.	T	C	1	6	7	0	1	8	0	0
5	44354265	.	C	A	1	0	1	0	0	1	0	0
5	44365957	.	T	A	0	1	1	0	1	2	0	0
5	44366090	.	G	A	2	3	5	0	0	5	0	0
5	44366621	.	T	C	1	0	1	0	0	1	0	0
5	44370681	.	A	G	6	0	6	0	4	10	0	0
5	44370828	.	C	T	10	9	19	0	0	19	0	0
5	44370910	.	C	T	7	7	14	0	0	14	0	0
5	44370943	.	G	A	8	5	13	0	1	14	0	0
5	44370998	.	G	A	5	8	13	0	0	13	0	0
5	44371043	.	C	T	5	6	11	0	0	11	0	0
5	44494998	.	T	A	3	3	6	0	0	6	0	0
5	44495224	.	A	T	1	4	5	0	0	5	0	0
5	44495275	.	A	T	3	3	6	0	0	6	0	0
5	44495777	.	T	A	1	2	3	0	0	3	0	0
5	44718442	.	A	T	2	1	3	0	0	3	0	0
5	44718481	.	C	T	5	2	7	0	0	7	0	0
5	44754973	.	A	C	6	4	10	0	1	11	0	0
5	44757992	.	C	T	0	2	2	0	0	2	0	0
5	44778273	.	T	C	2	2	4	0	0	4	0	0
5	44778279	.	G	C	2	3	5	0	0	5	0	0
5	44778893	.	A	G	1	2	3	0	0	3	0	0
5	44794455	.	G	A	6	5	11	0	1	12	0	0
5	44794459	.	T	G	6	0	6	0	6	12	0	0
5	44794606	.	C	G	10	11	21	0	0	21	0	0
5	44794613	.	G	T	0	12	12	0	10	22	0	0
5	44794816	.	C	T	10	7	17	0	0	17	0	0
5	44794955	.	A	C	3	6	9	0	1	10	0	0
5	44794969	.	A	G	3	6	9	0	0	9	0	0
5	44795297	.	A	G	9	0	9	0	11	20	0	0
5	44795467	.	T	G	18	10	28	0	0	28	0	0
5	44795468	.	A	T	16	10	26	0	2	28	0	0
5	44795598	.	G	A	0	9	9	0	9	18	0	0
5	44806446	.	G	A	10	11	21	0	1	22	0	0
5	44808520	.	T	G	2	0	2	0	0	2	0	0
5	44808553	.	C	T	11	4	15	0	0	15	0	0
5	44934252	.	G	A	1	2	3	0	0	3	0	0
5	44934330	.	C	G	1	2	3	0	0	3	0	0
5	44935147	.	T	C	2	0	2	0	0	2	0	0
5	44935156	.	T	C	2	0	2	0	0	2	0	0
5	44935952	.	C	T	2	2	4	0	0	4	0	0
5	45183345	.	C	T	4	2	6	0	1	7	0	0
5	45204118	.	C	T	6	9	15	0	0	15	0	0
5	45204175	.	G	A	3	2	5	0	0	5	0	0
5	45204971	.	A	G	1	1	2	0	0	2	0	0
5	45220330	.	A	G	3	7	10	0	1	11	0	0
5	45230659	.	C	A	3	4	7	0	0	7	0	0
5	45261926	.	C	T	1	7	8	0	0	8	0	0
5	45268941	.	C	T	1	2	3	0	0	3	0	0
5	45271966	.	C	A	3	2	5	0	1	6	0	0
5	45274429	.	G	A	10	4	14	0	0	14	0	0
5	45274486	.	C	T	7	11	18	0	0	18	0	0
5	45282910	.	G	A	2	4	6	0	0	6	0	0
5	45283046	.	G	T	3	8	11	0	0	11	0	0
5	45283446	.	A	G	9	13	22	0	0	22	0	0
5	45283654	.	T	C	5	9	14	0	0	14	0	0
5	45613465	.	G	T	1	2	3	0	0	3	0	0
5	45613585	.	T	C	2	5	7	0	0	7	0	0
5	45632949	.	G	C	1	2	3	0	0	3	0	0
5	45634431	.	G	A	1	2	3	0	0	3	0	0
5	45748025	.	A	C	3	5	8	0	0	8	0	0
5	45748313	.	G	A	2	5	7	0	0	7	0	0
5	45748528	.	T	C	6	3	9	0	1	10	0	0
5	45748545	.	T	A	3	7	10	0	0	10	0	0
5	45748563	.	C	T	1	4	5	0	0	5	0	0
5	45748593	.	T	C	7	4	11	0	0	11	0	0
5	45748627	.	A	C	5	0	5	0	8	13	0	0
5	45748672	.	G	T	5	2	7	0	1	8	0	0
5	45748726	.	A	C	0	0	0	0	10	10	0	0
5	45751208	.	C	T	0	0	0	0	3	3	0	0
5	45754818	.	C	T	5	5	10	0	0	10	0	0
5	45754851	.	A	G	7	10	17	0	0	17	0	0
5	45757617	.	A	G	1	2	3	0	2	5	0	0
5	45757644	.	A	G	2	5	7	0	2	9	0	0
5	45771568	.	T	C	1	0	1	0	1	2	0	0
5	45890074	.	C	T	0	15	15	0	4	19	0	0
5	45890086	.	A	T	4	13	17	0	0	17	0	0
5	45890195	.	A	G	5	6	11	0	0	11	0	0
5	45890219	.	A	T	5	7	12	0	0	12	0	0
5	45890663	.	T	A	19	9	28	0	1	29	0	0
5	45891090	.	A	G	7	7	14	0	1	15	0	0
5	45891226	.	T	A	12	8	20	0	1	21	0	0
5	45891327	.	G	T	10	7	17	0	2	19	0	0
5	45891431	.	C	T	3	3	6	0	0	6	0	0
5	45894547	.	G	A	5	5	10	0	1	11	0	0
5	45894560	.	G	C	4	5	9	0	0	9	0	0
5	45894619	.	A	G	5	7	12	0	0	12	0	0
5	45894699	.	C	T	12	9	21	0	0	21	0	0
5	45894720	.	T	C	15	7	22	0	0	22	0	0
5	45894737	.	T	C	15	4	19	0	0	19	0	0
5	45895817	.	A	G	1	2	3	0	0	3	0	0
5	45910811	.	G	A	0	2	2	0	3	5	0	0
5	45990116	.	A	G	4	3	7	0	1	8	0	0
5	45990237	.	C	A	4	6	10	0	0	10	0	0
5	45990465	.	C	T	2	4	6	0	1	7	0	0
5	46064330	.	G	T	1	5	6	0	0	6	0	0
5	46146877	.	G	A	1	2	3	0	0	3	0	0
5	46184398	.	C	T	1	2	3	0	0	3	0	0
5	46197389	.	G	A	0	2	2	0	2	4	0	0
5	46328215	.	C	T	2	4	6	0	0	6	0	0
5	46328218	.	A	T	2	4	6	0	0	6	0	0
5	46328314	.	C	T	2	8	10	0	0	10	0	0
5	46328476	.	T	C	4	0	4	0	10	14	0	0
5	46328611	.	C	T	4	3	7	0	4	11	0	0
5	46328758	.	C	T	4	5	9	0	1	10	0	0
5	46328797	.	G	A	5	6	11	0	0	11	0	0
5	46491059	.	C	G	1	2	3	0	0	3	0	0
5	46491253	.	T	A	0	1	1	0	0	1	0	0
5	46491263	.	G	A	0	2	2	0	0	2	0	0
5	46659401	.	A	G	16	21	37	0	0	37	0	0
5	46659666	.	T	A	29	13	42	0	2	44	0	0
5	46659707	.	C	A	30	22	52	0	2	54	0	0
5	46659861	.	G	A	26	17	43	0	1	44	0	0
5	46659984	.	A	G	18	22	40	0	2	42	0	0
5	46659985	.	A	G	17	23	40	0	2	42	0	0
5	46660068	.	C	T	9	16	25	0	2	27	0	0
5	46660120	.	A	G	10	26	36	0	0	36	0	0
5	46660201	.	A	G	12	18	30	0	1	31	0	0
5	46660259	.	T	C	13	19	32	0	2	34	0	0
5	46660541	.	T	C	22	6	28	0	1	29	0	0
5	46660577	.	T	C	14	5	19	2	1	22	0	0
5	46660600	.	T	A	18	11	29	2	0	31	0	0
5	46660672	.	G	A	18	15	33	0	1	34	0	0
5	46660681	.	A	G	16	13	29	0	1	30	0	0
5	46660727	.	T	C	13	8	21	0	0	21	0	0
5	46660735	.	G	C	15	9	24	0	1	25	0	0
5	46660780	.	A	G	17	25	42	0	1	43	0	0
5	46660819	.	A	G	17	28	45	0	0	45	0	0
5	46660906	.	A	G	16	19	35	0	2	37	0	0
5	46660941	.	A	T	15	17	32	0	1	33	0	0
5	46661006	.	A	T	8	11	19	0	1	20	0	0
5	46661240	.	A	G	5	10	15	0	0	15	0	0
5	46661348	.	G	C	18	17	35	0	2	37	0	0
5	46661349	.	G	A	18	18	36	0	1	37	0	0
5	46661418	.	T	C	27	23	50	0	1	51	0	0
5	46661423	.	T	C	29	0	29	0	23	52	0	0
5	46661519	.	C	T	22	15	37	0	1	38	0	0
5	46661678	.	T	A	15	6	21	0	0	21	0	0
5	46724854	.	G	A	14	20	34	0	0	34	0	0
5	46808477	.	A	G	2	2	4	0	0	4	0	0
5	46808567	.	G	A	3	1	4	0	0	4	0	0
5	46868923	.	A	G	8	8	16	0	0	16	0	0
5	47949989	.	A	G	1	0	1	0	2	3	0	0
5	47950862	.	C	T	2	1	3	0	0	3	0	0
5	47955833	.	C	A	0	1	1	0	0	1	0	0
5	47972770	.	T	C	2	0	2	0	4	6	0	0
5	47973386	.	T	G	2	0	2	0	0	2	0	0
5	47975340	.	A	T	6	3	9	0	0	9	0	0
5	47976728	.	C	G	5	6	11	0	0	11	0	0
5	47976747	.	C	A	7	6	13	0	0	13	0	0
5	47977042	.	T	G	3	4	7	0	0	7	0	0
5	48028112	.	G	A	2	3	5	0	0	5	0	0
5	48028338	.	C	A	4	2	6	0	0	6	0	0
5	48028406	.	A	C	11	10	21	0	1	22	0	0
5	48028435	.	G	T	13	8	21	0	0	21	0	0
5	48028508	.	T	C	3	3	6	0	0	6	0	0
5	48028696	.	C	A	1	2	3	0	0	3	0	0
5	48028720	.	G	A	2	1	3	0	1	4	0	0
5	48050510	.	C	A	1	1	2	0	0	2	0	0
5	48110331	.	G	A	6	11	17	0	0	17	0	0
5	48172446	.	C	A	0	5	5	0	3	8	0	0
5	48182021	.	A	G	7	8	15	0	0	15	0	0
5	48182030	.	T	C	6	0	6	0	10	16	0	0
5	48182066	.	C	G	8	6	14	0	2	16	0	0
5	48182216	.	A	G	5	3	8	0	1	9	0	0
5	48182550	.	A	T	4	7	11	0	1	12	0	0
5	48183414	.	T	C	6	0	6	0	12	18	0	0
5	48183577	.	C	T	1	9	10	0	9	19	0	0
5	48183579	.	A	G	8	11	19	0	1	20	0	0
5	48183628	.	T	C	13	2	15	0	10	25	0	0
5	48188963	.	A	G	9	3	12	0	0	12	0	0
5	48208539	.	G	A	4	7	11	0	0	11	0	0
5	48242529	.	T	G	0	1	1	0	0	1	0	0
5	48242610	.	G	A	4	7	11	0	0	11	0	0
5	48285619	.	C	T	3	3	6	0	0	6	0	0
5	48659834	.	G	A	4	2	6	0	0	6	0	0
5	48664229	.	T	C	1	2	3	0	1	4	0	0
5	48672740	.	G	A	5	2	7	0	0	7	0	0
5	48672752	.	C	T	0	6	6	0	2	8	0	0
5	48672925	.	A	T	4	5	9	0	0	9	0	0
5	48672970	.	G	A	2	5	7	0	0	7	0	0
5	48673501	.	A	G	8	7	15	0	1	16	0	0
5	48673639	.	C	A	0	4	4	0	4	8	0	0
5	48679428	.	A	T	1	4	5	0	2	7	0	0
5	48899790	.	G	A	0	1	1	0	0	1	0	0
5	48986593	.	A	G	8	35	43	0	1	44	0	0
5	48986937	.	T	C	0	8	8	0	25	33	0	0
5	48987199	.	C	T	25	13	38	0	0	38	0	0
5	48987772	.	G	A	32	8	40	1	1	42	0	0
5	48987920	.	T	C	22	8	30	0	1	31	0	0
5	48988084	.	A	G	1	1	2	0	0	2	0	0
5	48992401	.	T	C	12	0	12	0	10	22	0	0
5	48992972	.	C	T	0	1	1	0	0	1	0	0
5	48993345	.	T	C	2	2	4	0	0	4	0	0
5	48995559	.	A	T	5	11	16	0	1	17	0	0
5	48995613	.	A	G	12	7	19	0	1	20	0	0
5	48995637	.	A	T	8	10	18	0	2	20	0	0
5	48995884	.	G	A	7	16	23	0	2	25	0	0
5	48995945	.	G	A	4	9	13	0	1	14	0	0
5	49019370	.	T	C	2	0	2	0	2	4	0	0
5	49019812	.	C	T	1	2	3	0	0	3	0	0
5	49020200	.	T	A	5	3	8	0	1	9	0	0
5	49020221	.	G	C	6	0	6	0	3	9	0	0
5	49028583	.	C	T	1	1	2	0	0	2	0	0
5	49028707	.	G	T	2	3	5	0	0	5	0	0
5	49028912	.	T	C	1	2	3	0	0	3	0	0
5	49734682	.	C	A	6	4	10	0	0	10	0	0
5	49734751	.	T	G	1	2	3	0	8	11	0	0
5	49735022	.	G	T	4	2	6	0	0	6	0	0
5	49735169	.	A	T	4	2	6	0	0	6	0	0
5	49735721	.	T	A	4	2	6	0	0	6	0	0
5	49735722	.	C	T	4	2	6	0	0	6	0	0
5	49735942	.	T	G	4	3	7	0	0	7	0	0
5	49745130	.	T	A	3	6	9	0	0	9	0	0
5	49747271	.	G	T	0	12	12	0	8	20	0	0
5	49750796	.	A	C	14	11	25	0	1	26	0	0
5	49750834	.	A	C	11	9	20	0	2	22	0	0
5	49755368	.	G	C	2	2	4	0	0	4	0	0
5	49768324	.	G	T	3	4	7	0	0	7	0	0
5	49768341	.	T	C	1	5	6	0	0	6	0	0
5	49768429	.	A	T	2	3	5	0	0	5	0	0
5	49768707	.	G	T	2	3	5	0	2	7	0	0
5	49768774	.	C	G	1	3	4	0	0	4	0	0
5	49768977	.	A	G	2	2	4	0	0	4	0	0
5	49769217	.	A	G	3	3	6	0	0	6	0	0
5	49769277	.	G	T	6	2	8	0	0	8	0	0
5	49769485	.	A	G	2	4	6	0	1	7	0	0
5	49769665	.	T	A	3	7	10	0	1	11	0	0
5	49769812	.	A	T	2	4	6	0	0	6	0	0
5	49773772	.	G	A	0	2	2	0	4	6	0	0
5	49919762	.	G	A	0	0	0	0	1	1	0	0
5	49919774	.	T	A	0	2	2	0	0	2	0	0
5	49951020	.	C	A	0	5	5	0	4	9	0	0
5	50035819	.	A	C	3	0	3	0	3	6	0	0
5	50081761	.	T	C	0	0	0	0	1	1	0	0
5	50081791	.	T	C	2	1	3	0	0	3	0	0
5	50081865	.	T	A	1	1	2	0	0	2	0	0
5	50407324	.	T	C	2	1	3	0	0	3	0	0
5	50436015	.	C	G	5	3	8	0	1	9	0	0
5	50436038	.	C	A	3	3	6	0	2	8	0	0
5	50436069	.	C	T	5	4	9	0	0	9	0	0
5	50443077	.	T	C	13	16	29	0	2	31	0	0
5	50443184	.	A	G	14	15	29	0	2	31	0	0
5	50443211	.	C	A	13	10	23	0	2	25	0	0
5	50443399	.	G	C	21	9	30	0	1	31	0	0
5	50443418	.	T	A	15	20	35	0	3	38	0	0
5	50443466	.	A	G	12	19	31	0	0	31	0	0
5	50520009	.	G	A	6	3	9	0	3	12	0	0
5	50543929	.	C	T	0	1	1	0	0	1	0	0
5	50544281	.	T	C	4	3	7	0	0	7	0	0
5	50576705	.	A	G	6	4	10	0	1	11	0	0
5	50582271	.	G	A	3	2	5	0	0	5	0	0
5	50582482	.	T	G	1	1	2	0	0	2	0	0
5	50594268	.	C	T	0	2	2	0	2	4	0	0
5	50636003	.	G	A	0	1	1	0	0	1	0	0
5	50636066	.	C	T	0	2	2	1	1	4	0	0
5	50781069	.	G	A	1	4	5	0	1	6	0	0
5	50781273	.	A	G	1	3	4	0	0	4	0	0
5	50817403	.	C	T	2	3	5	0	2	7	0	0
5	50817414	.	C	T	0	5	5	0	0	5	0	0
5	50819775	.	C	T	1	1	2	0	0	2	0	0
5	50819811	.	G	A	2	2	4	0	0	4	0	0
5	50819861	.	A	G	1	3	4	0	0	4	0	0
5	50821027	.	G	A	0	4	4	0	1	5	0	0
5	50821075	.	A	T	2	3	5	0	0	5	0	0
5	50848985	.	G	C	1	0	1	0	0	1	0	0
5	50859169	.	G	A	0	1	1	0	0	1	0	0
5	50872460	.	A	G	2	2	4	0	0	4	0	0
5	50872471	.	G	A	1	2	3	0	0	3	0	0
5	50874827	.	A	G	0	1	1	0	0	1	0	0
5	50874881	.	G	T	1	3	4	0	0	4	0	0
5	50876172	.	A	T	1	1	2	0	1	3	0	0
5	50876199	.	A	C	1	1	2	0	0	2	0	0
5	50893082	.	A	G	1	0	1	0	0	1	0	0
5	50895544	.	C	T	1	2	3	0	0	3	0	0
5	50896056	.	C	T	2	2	4	0	0	4	0	0
5	50897509	.	C	T	2	3	5	0	0	5	0	0
5	50963250	.	C	G	1	1	2	0	0	2	0	0
5	50969288	.	C	T	2	3	5	0	1	6	0	0
5	50973014	.	C	T	3	2	5	0	0	5	0	0
5	50973039	.	C	T	3	4	7	0	0	7	0	0
5	50973471	.	C	G	1	4	5	0	0	5	0	0
5	50973518	.	A	C	5	7	12	0	1	13	0	0
5	50973625	.	A	T	0	3	3	0	0	3	0	0
5	50973748	.	C	T	3	7	10	0	0	10	0	0
5	50981123	.	C	T	0	2	2	0	2	4	0	0
5	50981198	.	G	A	1	1	2	0	0	2	0	0
5	50985543	.	C	A	0	2	2	0	0	2	0	0
5	50990077	.	G	A	1	2	3	0	0	3	0	0
5	51095838	.	T	A	3	2	5	0	0	5	0	0
5	51095853	.	G	C	2	3	5	0	0	5	0	0
5	51096280	.	A	G	3	3	6	0	0	6	0	0
5	51096285	.	G	C	3	4	7	0	0	7	0	0
5	51096377	.	T	A	0	2	2	0	0	2	0	0
5	51102044	.	T	C	4	3	7	0	0	7	0	0
5	51102828	.	G	A	2	2	4	0	0	4	0	0
5	51103043	.	T	C	3	2	5	0	0	5	0	0
5	51103239	.	G	A	1	4	5	0	0	5	0	0
5	51103411	.	G	A	3	6	9	0	0	9	0	0
5	51103550	.	G	A	4	2	6	0	0	6	0	0
5	51103904	.	A	T	1	2	3	0	1	4	0	0
5	51104010	.	G	A	1	5	6	0	0	6	0	0
5	51104031	.	G	A	0	2	2	0	1	3	0	0
5	51114049	.	C	T	1	0	1	0	0	1	0	0
5	51121295	.	G	A	1	2	3	0	0	3	0	0
5	51124803	.	A	G	2	0	2	0	0	2	0	0
5	51125695	.	C	A	1	1	2	0	0	2	0	0
5	51127305	.	A	T	6	4	10	0	1	11	0	0
5	51127335	.	C	T	1	7	8	0	0	8	0	0
5	51127348	.	C	T	5	1	6	0	1	7	0	0
5	51127396	.	C	G	2	2	4	0	0	4	0	0
5	51127467	.	C	A	5	5	10	0	0	10	0	0
5	51127538	.	C	G	2	0	2	0	9	11	0	0
5	51127718	.	T	A	3	2	5	0	0	5	0	0
5	51169022	.	G	T	1	4	5	0	0	5	0	0
5	51169354	.	A	T	3	2	5	0	0	5	0	0
5	51169376	.	T	C	5	0	5	0	4	9	0	0
5	51169545	.	C	T	4	3	7	0	0	7	0	0
5	51169732	.	G	A	1	3	4	0	0	4	0	0
5	51169749	.	C	T	2	3	5	0	0	5	0	0
5	51170113	.	G	A	3	4	7	0	0	7	0	0
5	51170171	.	T	C	1	6	7	0	1	8	0	0
5	51170375	.	C	T	1	2	3	0	0	3	0	0
5	51170694	.	G	A	2	3	5	0	0	5	0	0
5	51200697	.	G	A	1	4	5	0	0	5	0	0
5	51202938	.	G	A	6	2	8	0	0	8	0	0
5	51205439	.	G	T	4	2	6	0	0	6	0	0
5	51205473	.	T	A	3	3	6	0	0	6	0	0
5	51205593	.	G	A	3	2	5	0	0	5	0	0
5	51208586	.	C	A	0	1	1	0	0	1	0	0
5	51227011	.	T	A	3	5	8	0	0	8	0	0
5	51227197	.	C	T	3	5	8	0	0	8	0	0
5	51228496	.	C	A	2	5	7	0	0	7	0	0
5	51230901	.	T	C	1	3	4	0	0	4	0	0
5	51232024	.	G	A	2	1	3	0	0	3	0	0
5	51240588	.	T	C	3	3	6	0	0	6	0	0
5	51240679	.	A	G	4	7	11	0	1	12	0	0
5	51240711	.	C	T	3	3	6	0	0	6	0	0
5	51240830	.	T	C	4	3	7	0	0	7	0	0
5	51241023	.	A	G	5	3	8	0	1	9	0	0
5	51241046	.	T	C	4	4	8	0	0	8	0	0
5	51241095	.	C	T	2	3	5	0	0	5	0	0
5	51242489	.	A	G	6	0	6	0	4	10	0	0
5	51242882	.	A	G	8	6	14	0	1	15	0	0
5	51243106	.	A	G	7	8	15	0	0	15	0	0
5	51243287	.	G	A	5	3	8	0	0	8	0	0
5	51243302	.	A	C	5	3	8	0	0	8	0	0
5	51243341	.	G	A	7	7	14	0	0	14	0	0
5	51334555	.	C	T	1	3	4	0	0	4	0	0
5	51360591	.	C	T	2	0	2	0	0	2	0	0
5	51443247	.	A	G	2	3	5	0	0	5	0	0
5	51548092	.	C	T	5	4	9	0	0	9	0	0
5	51548398	.	A	T	2	2	4	0	0	4	0	0
5	51548408	.	A	C	2	2	4	0	0	4	0	0
5	51579076	.	C	T	1	0	1	0	0	1	0	0
5	51616474	.	A	T	5	2	7	0	0	7	0	0
5	51617022	.	T	C	6	9	15	0	2	17	0	0
5	51775052	.	A	G	3	7	10	0	0	10	0	0
5	51775291	.	A	T	13	12	25	0	1	26	0	0
5	51775391	.	A	G	13	10	23	0	1	24	0	0
5	51775458	.	A	C	13	17	30	0	0	30	0	0
5	51775501	.	T	G	14	15	29	0	2	31	0	0
5	51775805	.	A	G	14	16	30	0	3	33	0	0
5	51775837	.	G	C	15	13	28	0	3	31	0	0
5	51775962	.	G	T	9	13	22	0	0	22	0	0
5	51775997	.	A	T	10	11	21	0	2	23	0	0
5	51776150	.	C	A	9	9	18	0	0	18	0	0
5	51779513	.	C	T	6	0	6	0	0	6	0	0
5	51789180	.	C	T	0	4	4	0	5	9	0	0
5	51789264	.	T	G	7	4	11	0	0	11	0	0
5	51789286	.	A	T	6	2	8	0	1	9	0	0
5	51789428	.	A	G	2	10	12	0	0	12	0	0
5	51789453	.	T	C	1	4	5	0	1	6	0	0
5	51846285	.	C	A	0	2	2	0	0	2	0	0
5	51847675	.	C	G	3	2	5	0	0	5	0	0
5	51894040	.	T	C	3	3	6	0	0	6	0	0
5	51898796	.	C	T	0	1	1	0	2	3	0	0
5	51902253	.	A	G	1	0	1	0	0	1	0	0
5	51947370	.	G	T	8	7	15	0	0	15	0	0
5	51947497	.	C	T	16	8	24	0	1	25	0	0
5	51947551	.	T	C	8	12	20	0	0	20	0	0
5	51947650	.	T	C	7	10	17	0	1	18	0	0
5	51947696	.	A	T	10	9	19	0	0	19	0	0
5	51947770	.	T	G	6	9	15	0	0	15	0	0
5	51947976	.	C	G	2	0	2	0	1	3	0	0
5	51948017	.	G	T	6	3	9	0	0	9	0	0
5	51948076	.	G	A	2	3	5	0	0	5	0	0
5	51948389	.	A	T	8	6	14	0	2	16	0	0
5	51948708	.	A	T	4	3	7	0	2	9	0	0
5	51948737	.	C	T	0	4	4	0	5	9	0	0
5	51948755	.	C	A	4	7	11	0	0	11	0	0
5	51948919	.	G	A	4	11	15	0	0	15	0	0
5	51948946	.	T	C	11	0	11	0	7	18	0	0
5	51949069	.	T	A	7	13	20	0	0	20	0	0
5	51949071	.	T	A	6	13	19	0	1	20	0	0
5	51949896	.	G	A	2	3	5	0	2	7	0	0
5	51950032	.	G	C	5	9	14	0	1	15	0	0
5	51958596	.	G	A	0	1	1	0	0	1	0	0
5	51985355	.	G	A	1	2	3	0	0	3	0	0
5	52002660	.	T	G	2	4	6	0	0	6	0	0
5	52002708	.	T	C	2	10	12	0	0	12	0	0
5	52002743	.	T	G	1	3	4	0	0	4	0	0
5	52008556	.	T	A	0	3	3	0	0	3	0	0
5	52008999	.	A	G	0	1	1	0	0	1	0	0
5	52039112	.	G	A	3	2	5	0	0	5	0	0
5	52039493	.	A	G	1	1	2	0	0	2	0	0
5	52039496	.	A	T	1	1	2	0	0	2	0	0
5	52068001	.	T	C	0	3	3	0	0	3	0	0
5	52068422	.	C	T	2	3	5	0	0	5	0	0
5	52068452	.	G	A	1	2	3	0	0	3	0	0
5	52121488	.	C	T	2	1	3	0	0	3	0	0
5	52121517	.	T	C	3	1	4	0	0	4	0	0
5	52121629	.	G	A	0	4	4	0	0	4	0	0
5	52121725	.	C	T	2	2	4	0	0	4	0	0
5	52121801	.	G	C	3	3	6	0	0	6	0	0
5	52122189	.	C	G	3	2	5	0	1	6	0	0
5	52122711	.	C	T	1	3	4	0	0	4	0	0
5	52123640	.	G	T	7	8	15	0	1	16	0	0
5	52123903	.	A	G	3	6	9	0	1	10	0	0
5	52124259	.	G	A	5	4	9	0	1	10	0	0
5	52124734	.	A	G	6	8	14	0	0	14	0	0
5	52132498	.	A	T	0	3	3	0	0	3	0	0
5	52132561	.	C	T	4	3	7	0	0	7	0	0
5	52132966	.	A	G	4	5	9	0	1	10	0	0
5	52190877	.	A	C	3	5	8	0	0	8	0	0
5	52191039	.	C	T	0	1	1	0	2	3	0	0
5	52191185	.	G	T	6	4	10	0	0	10	0	0
5	52191212	.	A	G	0	6	6	0	2	8	0	0
5	52191263	.	T	C	6	6	12	0	1	13	0	0
5	52191288	.	C	A	6	6	12	0	0	12	0	0
5	52191593	.	C	T	5	5	10	0	0	10	0	0
5	52191758	.	C	T	3	2	5	0	0	5	0	0
5	52191987	.	A	G	2	4	6	0	0	6	0	0
5	52192557	.	C	T	4	3	7	0	1	8	0	0
5	52192572	.	T	C	2	4	6	0	0	6	0	0
5	52192704	.	T	C	2	0	2	0	4	6	0	0
5	52192708	.	G	C	0	5	5	0	1	6	0	0
5	52193240	.	A	T	2	3	5	0	1	6	0	0
5	52193817	.	A	G	1	0	1	0	0	1	0	0
5	52197793	.	C	T	1	3	4	0	0	4	0	0
5	52198066	.	G	A	5	4	9	0	0	9	0	0
5	52201458	.	T	C	0	1	1	0	2	3	0	0
5	52212199	.	G	T	4	2	6	0	0	6	0	0
5	52227393	.	T	C	1	0	1	0	0	1	0	0
5	52227660	.	T	A	1	2	3	0	1	4	0	0
5	52234708	.	A	G	2	2	4	0	0	4	0	0
5	52234729	.	G	A	2	3	5	0	0	5	0	0
5	52235385	.	C	T	1	2	3	0	0	3	0	0
5	52237001	.	T	G	0	5	5	0	0	5	0	0
5	52237028	.	C	T	0	4	4	0	0	4	0	0
5	52237449	.	G	C	1	0	1	0	1	2	0	0
5	52240449	.	C	A	2	3	5	0	0	5	0	0
5	52242924	.	C	G	0	3	3	0	2	5	0	0
5	52257106	.	A	C	7	0	7	0	7	14	0	0
5	52257299	.	G	A	9	11	20	0	0	20	0	0
5	52257463	.	T	C	12	6	18	0	2	20	0	0
5	52257530	.	A	G	15	10	25	0	1	26	0	0
5	52257976	.	G	T	16	8	24	0	0	24	0	0
5	52258036	.	G	A	11	6	17	0	1	18	0	0
5	52258234	.	G	A	9	17	26	0	0	26	0	0
5	52258464	.	T	C	9	0	9	0	4	13	0	0
5	52258653	.	C	G	7	4	11	0	0	11	0	0
5	52258701	.	A	T	5	7	12	0	0	12	0	0
5	52258703	.	G	A	5	7	12	0	0	12	0	0
5	52258921	.	T	G	6	8	14	0	1	15	0	0
5	52259221	.	T	A	6	8	14	0	0	14	0	0
5	52259289	.	A	G	10	5	15	0	0	15	0	0
5	52259542	.	G	C	4	0	4	0	7	11	0	0
5	52259579	.	A	T	8	3	11	0	2	13	0	0
5	52259887	.	G	A	10	9	19	0	3	22	0	0
5	52264354	.	C	T	0	5	5	0	4	9	0	0
5	52264456	.	C	G	0	4	4	0	9	13	0	0
5	52264512	.	G	A	6	7	13	0	0	13	0	0
5	52264549	.	C	T	7	7	14	0	1	15	0	0
5	52264654	.	C	G	0	6	6	0	7	13	0	0
5	52277390	.	G	A	6	8	14	0	1	15	0	0
5	52277487	.	T	A	5	3	8	0	0	8	0	0
5	52277574	.	G	A	1	8	9	0	1	10	0	0
5	52598377	.	C	T	0	2	2	0	0	2	0	0
5	52621663	.	A	C	3	4	7	0	0	7	0	0
5	52621885	.	T	C	2	7	9	0	0	9	0	0
5	52696879	.	C	T	7	5	12	0	0	12	0	0
5	52697519	.	A	C	7	5	12	0	2	14	0	0
5	52697644	.	T	C	1	4	5	0	0	5	0	0
5	52710951	.	A	G	2	0	2	0	0	2	0	0
5	52710957	.	G	A	2	0	2	0	0	2	0	0
5	52730540	.	C	T	6	6	12	0	0	12	0	0
5	52730645	.	C	T	3	2	5	0	0	5	0	0
5	52730704	.	C	T	4	3	7	0	0	7	0	0
5	52730742	.	G	C	6	5	11	0	1	12	0	0
5	52730793	.	G	A	5	2	7	0	1	8	0	0
5	52730988	.	C	G	2	0	2	0	3	5	0	0
5	52731647	.	G	A	0	14	14	0	5	19	0	0
5	52731664	.	C	T	6	14	20	0	0	20	0	0
5	52731787	.	G	A	8	8	16	0	1	17	0	0
5	52731845	.	T	C	7	6	13	0	2	15	0	0
5	52732146	.	C	T	5	10	15	0	0	15	0	0
5	52732147	.	G	A	10	4	14	0	1	15	0	0
5	52732727	.	G	A	3	12	15	0	0	15	0	0
5	52732818	.	G	T	8	10	18	0	2	20	0	0
5	52732931	.	C	T	7	14	21	0	0	22	1	0
5	52733022	.	G	T	15	9	24	0	0	24	0	0
5	52733201	.	C	T	10	7	17	0	1	18	0	0
5	52733230	.	G	A	15	10	25	0	0	25	0	0
5	52733259	.	T	G	21	10	31	0	0	31	0	0
5	52733266	.	T	G	20	11	31	0	0	31	0	0
5	52733370	.	A	T	16	13	29	0	0	29	0	0
5	52733411	.	G	A	10	8	18	0	1	19	0	0
5	52745571	.	T	G	6	3	9	0	1	10	0	0
5	52745637	.	T	C	2	2	4	0	0	4	0	0
5	52748724	.	T	C	2	1	3	0	0	3	0	0
5	52751568	.	C	T	0	1	1	0	0	1	0	0
5	52761212	.	A	T	0	3	3	0	0	3	0	0
5	52858847	.	C	T	1	1	2	0	0	2	0	0
5	52858898	.	A	G	2	0	2	0	2	4	0	0
5	52859912	.	G	A	2	3	5	0	0	5	0	0
5	52860243	.	T	A	4	2	6	0	0	6	0	0
5	52860310	.	T	A	3	2	5	0	0	5	0	0
5	52860413	.	G	A	1	3	4	0	3	7	0	0
5	52860863	.	G	T	7	6	13	0	1	14	0	0
5	52860933	.	T	A	2	3	5	0	0	5	0	0
5	52861213	.	T	C	2	4	6	0	1	7	0	0
5	52861334	.	T	A	7	6	13	0	0	13	0	0
5	52861396	.	C	G	5	0	5	0	5	10	0	0
5	52861410	.	A	T	4	4	8	0	0	8	0	0
5	52937849	.	A	T	3	4	7	0	0	7	0	0
5	52937901	.	C	A	3	9	12	0	0	12	0	0
5	52937956	.	A	T	8	6	14	0	0	14	0	0
5	52938787	.	C	A	4	6	10	0	3	13	0	0
5	52962667	.	T	C	8	0	8	0	2	10	0	0
5	52972260	.	A	G	3	6	9	0	0	9	0	0
5	52972323	.	C	A	0	1	1	0	0	1	0	0
5	52988108	.	C	T	5	3	8	0	3	11	0	0
5	52988147	.	C	T	1	2	3	0	0	3	0	0
5	53003455	.	A	C	1	0	1	0	1	2	0	0
5	53003463	.	C	G	0	1	1	0	1	2	0	0
5	53003640	.	C	G	3	6	9	0	0	9	0	0
5	53003896	.	G	A	6	6	12	0	1	13	0	0
5	53003988	.	A	C	2	0	2	0	3	5	0	0
5	53009239	.	T	A	1	1	2	0	0	2	0	0
5	53759491	.	A	T	4	11	15	0	1	16	0	0
5	53761461	.	C	T	11	2	13	0	0	13	0	0
5	53761541	.	A	T	11	9	20	0	0	20	0	0
5	53761875	.	A	T	0	2	2	0	1	3	0	0
5	53762044	.	G	C	1	3	4	0	0	4	0	0
5	53825047	.	G	A	8	3	11	0	1	12	0	0
5	53825054	.	T	A	9	1	10	0	1	11	0	0
5	53865040	.	A	C	6	3	9	0	0	9	0	0
5	53865402	.	A	C	3	2	5	0	0	5	0	0
5	53899573	.	T	C	8	12	20	0	0	20	0	0
5	53908333	.	C	T	9	14	23	0	1	24	0	0
5	53908613	.	T	A	4	4	8	0	0	8	0	0
5	53908892	.	A	G	8	5	13	0	0	13	0	0
5	53908893	.	G	A	6	5	11	0	2	13	0	0
5	53909000	.	G	C	3	8	11	0	2	13	0	0
5	53909031	.	T	A	7	7	14	0	0	14	0	0
5	53909118	.	A	G	3	3	6	0	0	6	0	0
5	53909659	.	T	C	6	2	8	0	0	8	0	0
5	53909914	.	C	T	7	3	10	0	0	10	0	0
5	53910324	.	C	T	2	5	7	0	0	7	0	0
5	53913496	.	G	A	1	1	2	0	2	4	0	0
5	54111208	.	T	A	1	2	3	0	1	4	0	0
5	54280350	.	C	G	2	5	7	0	0	7	0	0
5	54280615	.	G	A	1	1	2	0	4	6	0	0
5	54280672	.	C	T	2	0	2	0	0	2	0	0
5	54280801	.	G	A	3	1	4	0	0	4	0	0
5	54280889	.	G	A	1	1	2	0	0	2	0	0
5	54297668	.	C	T	0	2	2	0	1	3	0	0
5	54304666	.	C	G	1	3	4	0	0	4	0	0
5	54304731	.	T	A	0	2	2	0	1	3	0	0
5	54304736	.	G	T	1	0	1	0	0	1	0	0
5	54305209	.	G	A	2	2	4	0	0	4	0	0
5	54309459	.	T	A	9	2	11	0	0	11	0	0
5	54337296	.	A	C	3	0	3	0	6	9	0	0
5	54337485	.	A	G	4	3	7	0	0	7	0	0
5	54337517	.	A	T	4	5	9	0	0	9	0	0
5	54337524	.	G	T	3	4	7	0	1	8	0	0
5	54337831	.	T	A	7	5	12	0	0	12	0	0
5	54337880	.	T	C	12	0	12	0	11	23	0	0
5	54337933	.	G	T	9	8	17	0	1	18	0	0
5	54337934	.	C	A	8	9	17	0	1	18	0	0
5	54338040	.	C	A	6	5	11	0	1	12	0	0
5	54339734	.	A	G	0	1	1	0	1	2	0	0
5	54340047	.	G	A	4	4	8	0	0	8	0	0
5	54419992	.	T	C	2	4	6	0	0	6	0	0
5	54420465	.	T	A	1	1	2	0	0	2	0	0
5	54457983	.	G	A	6	7	13	0	0	13	0	0
5	54458053	.	A	C	9	4	13	0	0	13	0	0
5	54458125	.	T	C	6	5	11	0	0	11	0	0
5	54458127	.	A	G	6	5	11	0	0	11	0	0
5	54458326	.	G	A	11	5	16	0	2	18	0	0
5	54458345	.	T	A	6	7	13	0	0	13	0	0
5	54458437	.	C	T	7	7	14	0	0	14	0	0
5	54458668	.	C	A	7	3	10	0	0	10	0	0
5	54458774	.	A	C	9	0	9	0	10	19	0	0
5	54458791	.	C	G	0	9	9	0	9	18	0	0
5	54458974	.	C	G	6	7	13	0	0	13	0	0
5	54459073	.	T	G	9	6	15	0	0	15	0	0
5	54459086	.	G	T	7	6	13	0	0	13	0	0
5	54459682	.	C	T	2	6	8	0	3	11	0	0
5	54459695	.	T	C	6	3	9	0	0	9	0	0
5	54460218	.	A	C	1	5	6	0	0	6	0	0
5	54460274	.	T	A	4	3	7	0	1	8	0	0
5	54460322	.	T	A	4	3	7	0	0	7	0	0
5	54460371	.	T	A	2	5	7	0	0	7	0	0
5	54460555	.	G	A	5	11	16	0	4	20	0	0
5	54460558	.	A	T	4	8	12	0	9	21	0	0
5	54465149	.	T	C	1	0	1	0	3	4	0	0
5	54467999	.	G	T	2	1	3	0	1	4	0	0
5	54468032	.	A	G	1	3	4	0	0	4	0	0
5	54468506	.	G	A	5	3	8	0	0	8	0	0
5	54470845	.	C	G	0	4	4	0	2	6	0	0
5	54470912	.	C	G	3	3	6	1	1	8	0	0
5	54471091	.	T	C	2	1	3	0	0	3	0	0
5	54482806	.	C	T	1	3	4	0	0	4	0	0
5	54483295	.	G	A	2	2	4	0	0	4	0	0
5	54497620	.	C	T	3	1	4	0	0	4	0	0
5	54497628	.	C	T	1	3	4	0	0	4	0	0
5	54498363	.	C	T	4	6	10	0	1	11	0	0
5	54498375	.	T	G	7	5	12	0	0	12	0	0
5	54498452	.	C	T	6	8	14	0	0	14	0	0
5	54501993	.	A	G	5	0	5	0	4	9	0	0
5	54502264	.	G	A	7	5	12	0	2	14	0	0
5	54502307	.	G	A	0	6	6	0	7	13	0	0
5	54502414	.	G	C	7	6	13	0	2	15	0	0
5	54502697	.	A	G	7	1	8	0	3	11	0	0
5	54541975	.	C	A	2	3	5	0	0	5	0	0
5	54565223	.	T	G	1	0	1	0	0	1	0	0
5	54572859	.	T	A	2	3	5	0	0	5	0	0
5	54576142	.	C	T	2	1	3	0	0	3	0	0
5	54576223	.	C	T	5	4	9	0	1	10	0	0
5	54576238	.	G	A	4	4	8	0	0	8	0	0
5	54580125	.	G	A	1	0	1	0	0	1	0	0
5	54585600	.	C	T	1	5	6	0	0	6	0	0
5	54586011	.	A	G	2	2	4	0	0	4	0	0
5	54612354	.	C	T	0	1	1	0	0	1	0	0
5	54618488	.	T	G	1	0	1	0	0	1	0	0
5	54628542	.	C	T	2	2	4	0	0	4	0	0
5	54632954	.	A	C	1	1	2	0	0	2	0	0
5	54633277	.	C	T	3	2	5	0	0	5	0	0
5	54633313	.	C	T	1	1	2	0	0	2	0	0
5	54643746	.	T	A	3	5	8	0	0	8	0	0
5	54652941	.	T	A	6	12	18	0	0	18	0	0
5	54652947	.	C	A	11	4	15	0	1	16	0	0
5	54656583	.	A	G	2	0	2	0	1	3	0	0
5	54656613	.	T	C	2	1	3	0	0	3	0	0
5	54685235	.	T	C	5	6	11	0	0	11	0	0
5	54685349	.	A	G	7	6	13	0	0	13	0	0
5	54685371	.	A	T	5	5	10	0	0	10	0	0
5	54685445	.	C	A	3	6	9	0	0	9	0	0
5	54716828	.	T	C	1	0	1	0	6	7	0	0
5	54719503	.	A	G	3	3	6	0	1	7	0	0
5	54719844	.	G	A	9	15	24	0	0	24	0	0
5	54767734	.	T	A	11	13	24	0	0	24	0	0
5	54769091	.	A	G	12	10	22	0	0	22	0	0
5	54769896	.	A	G	16	13	29	0	1	30	0	0
5	54769914	.	C	T	14	14	28	0	0	28	0	0
5	54770121	.	T	C	2	1	3	0	0	3	0	0
5	54770370	.	G	A	12	12	24	0	1	25	0	0
5	54770889	.	C	T	5	4	9	0	1	10	0	0
5	54772955	.	T	C	5	3	8	0	0	8	0	0
5	54773182	.	C	A	0	7	7	0	11	18	0	0
5	54773250	.	A	G	15	10	25	0	0	25	0	0
5	54776408	.	T	C	1	2	3	0	0	3	0	0
5	54777482	.	G	A	1	0	1	0	0	1	0	0
5	54778115	.	G	C	0	0	0	0	1	1	0	0
5	54778236	.	G	C	1	1	2	0	1	3	0	0
5	54790426	.	A	C	3	3	6	0	0	6	0	0
5	54790751	.	A	C	6	3	9	0	0	9	0	0
5	54790808	.	T	G	1	5	6	0	0	6	0	0
5	54945035	.	T	G	13	9	22	0	0	22	0	0
5	54945048	.	A	G	13	8	21	0	1	22	0	0
5	54955892	.	G	A	2	0	2	0	0	2	0	0
5	54961109	.	A	G	1	1	2	0	0	2	0	0
5	54964633	.	G	A	5	3	8	0	0	8	0	0
5	54965203	.	G	A	6	3	9	0	0	9	0	0
5	54966120	.	C	T	4	4	8	0	0	8	0	0
5	54967094	.	C	T	1	2	3	0	0	3	0	0
5	54971774	.	G	C	1	2	3	0	0	3	0	0
5	54974350	.	A	G	0	2	2	0	0	2	0	0
5	55160470	.	A	G	2	7	9	0	1	10	0	0
5	55160572	.	G	A	2	7	9	0	1	10	0	0
5	55168177	.	G	T	13	12	25	0	0	25	0	0
5	55168436	.	T	A	0	3	3	0	0	3	0	0
5	55171359	.	G	A	2	0	2	0	0	2	0	0
5	55201111	.	A	G	2	7	9	0	0	9	0	0
5	55371356	.	C	T	6	2	8	0	6	14	0	0
5	55372218	.	A	G	17	11	28	0	1	29	0	0
5	55372425	.	A	C	19	10	29	0	0	29	0	0
5	55372773	.	A	T	11	13	24	0	2	26	0	0
5	55373299	.	G	A	21	9	30	0	1	31	0	0
5	55373869	.	G	T	8	5	13	0	0	13	0	0
5	55374343	.	T	A	5	7	12	0	1	13	0	0
5	55588449	.	G	A	8	4	12	0	1	13	0	0
5	55588458	.	T	C	6	5	11	0	1	12	0	0
5	55588562	.	T	C	3	4	7	0	1	8	0	0
5	55592805	.	A	G	2	3	5	0	0	5	0	0
5	55598383	.	T	C	6	5	11	0	0	11	0	0
5	55599950	.	G	C	5	6	11	0	0	11	0	0
5	55600108	.	A	C	7	5	12	0	0	12	0	0
5	55600149	.	T	C	4	4	8	0	1	9	0	0
5	55600154	.	A	G	5	4	9	0	0	9	0	0
5	55600657	.	C	T	1	5	6	0	0	6	0	0
5	55600679	.	A	T	0	2	2	0	1	3	0	0
5	55604162	.	G	C	9	6	15	0	1	16	0	0
5	55604211	.	A	T	6	3	9	0	0	9	0	0
5	55604228	.	G	T	6	6	12	0	1	13	0	0
5	55604302	.	A	T	15	0	15	1	0	16	0	0
5	55604392	.	T	A	9	10	19	0	8	27	0	0
5	55604438	.	A	G	17	13	30	0	2	32	0	0
5	55609426	.	T	G	23	12	35	0	5	40	0	0
5	55613789	.	G	A	13	14	27	0	1	28	0	0
5	55613813	.	A	C	12	12	24	0	1	25	0	0
5	55613864	.	A	G	10	11	21	0	1	22	0	0
5	55670269	.	T	C	0	2	2	0	0	2	0	0
5	55674606	.	A	G	0	1	1	0	0	1	0	0
5	55689628	.	C	T	5	8	13	0	0	13	0	0
5	55720177	.	A	G	10	1	11	0	2	13	0	0
5	55720486	.	C	T	1	4	5	0	4	9	0	0
5	55723534	.	A	G	5	4	9	0	1	10	0	0
5	55763752	.	G	T	19	28	47	0	1	48	0	0
5	55764509	.	G	A	21	22	43	0	3	46	0	0
5	55773856	.	A	G	3	4	7	0	0	7	0	0
5	55801489	.	G	A	3	2	5	0	0	5	0	0
5	55848084	.	C	T	5	3	8	0	1	9	0	0
5	55876508	.	C	G	3	1	4	0	0	4	0	0
5	55920930	.	A	C	2	4	6	0	0	6	0	0
5	55920943	.	A	T	3	5	8	0	0	8	0	0
5	55921076	.	A	T	7	6	13	0	2	15	0	0
5	55921335	.	G	A	13	17	30	0	1	31	0	0
5	55933055	.	G	A	9	9	18	0	1	19	0	0
5	55936421	.	A	T	3	3	6	0	1	7	0	0
5	55936430	.	C	A	4	4	8	0	0	8	0	0
5	55951602	.	G	A	3	4	7	0	0	7	0	0
5	55951639	.	A	T	2	4	6	0	0	6	0	0
5	56100260	.	T	A	3	1	4	0	0	4	0	0
5	56102276	.	G	A	2	4	6	0	0	6	0	0
5	56120187	.	G	T	1	2	3	0	0	3	0	0
5	56289800	.	G	A	0	5	5	0	2	7	0	0
5	56289818	.	C	A	3	6	9	0	0	9	0	0
5	56289884	.	A	G	3	2	5	0	1	6	0	0
5	56289904	.	T	C	2	1	3	0	0	3	0	0
5	56289925	.	G	A	0	1	1	0	2	3	0	0
5	56305525	.	C	T	4	4	8	0	1	9	0	0
5	56305526	.	T	C	4	4	8	0	1	9	0	0
5	56305814	.	C	T	2	2	4	0	0	4	0	0
5	56308698	.	T	C	7	1	8	0	8	16	0	0
5	56308816	.	C	T	0	10	10	0	13	23	0	0
5	56309013	.	G	C	11	4	15	0	1	16	0	0
5	56309109	.	C	T	0	27	27	0	7	34	0	0
5	56309115	.	A	T	7	28	35	0	1	36	0	0
5	56309445	.	C	T	8	20	28	0	0	28	0	0
5	56309454	.	A	G	19	9	28	0	1	29	0	0
5	56309506	.	G	A	11	11	22	0	2	24	0	0
5	56309517	.	T	C	11	11	22	0	2	24	0	0
5	56309672	.	C	A	0	6	6	0	10	16	0	0
5	56309677	.	C	A	12	6	18	0	1	19	0	0
5	56313207	.	G	A	16	10	26	0	2	28	0	0
5	56313246	.	C	T	11	11	22	0	0	22	0	0
5	56317153	.	T	A	11	1	12	0	0	12	0	0
5	56317170	.	C	T	4	1	5	0	0	5	0	0
5	56317377	.	G	A	10	11	21	0	1	22	0	0
5	56317470	.	C	T	0	3	3	0	0	3	0	0
5	56317473	.	T	G	0	2	2	0	0	2	0	0
5	56322205	.	C	T	13	14	27	0	0	27	0	0
5	56322404	.	A	G	4	3	7	0	0	7	0	0
5	56322449	.	T	C	5	4	9	0	0	9	0	0
5	56322467	.	G	A	3	2	5	0	0	5	0	0
5	56322680	.	A	G	2	0	2	0	0	2	0	0
5	56326485	.	C	T	2	0	2	0	0	2	0	0
5	56340613	.	A	G	5	3	8	0	0	8	0	0
5	56343032	.	C	T	0	1	1	0	5	6	0	0
5	56343053	.	G	A	2	6	8	0	0	8	0	0
5	56343095	.	C	T	2	1	3	0	0	3	0	0
5	56345036	.	G	C	2	1	3	0	0	3	0	0
5	56355129	.	C	T	3	3	6	0	0	6	0	0
5	56355296	.	C	A	1	2	3	0	0	3	0	0
5	56355467	.	T	C	0	1	1	0	0	1	0	0
5	56364862	.	A	G	0	2	2	0	1	3	0	0
5	56364946	.	G	A	3	4	7	0	0	7	0	0
5	56364979	.	A	G	0	2	2	0	0	2	0	0
5	56364982	.	G	T	0	2	2	0	0	2	0	0
5	56412062	.	G	A	1	1	2	0	0	2	0	0
5	56412197	.	G	A	1	4	5	0	0	5	0	0
5	56915190	.	C	T	6	9	15	0	2	17	0	0
5	56915250	.	T	A	3	5	8	0	9	17	0	0
5	56915422	.	G	A	2	7	9	0	0	9	0	0
5	56918932	.	G	A	9	6	15	0	0	15	0	0
5	56918974	.	A	G	7	4	11	0	0	11	0	0
5	56924356	.	C	T	1	3	4	0	0	4	0	0
5	56924686	.	C	T	2	4	6	0	0	6	0	0
5	56927772	.	C	T	1	3	4	0	0	4	0	0
5	56927784	.	G	A	1	5	6	0	0	6	0	0
5	56934960	.	A	G	2	4	6	0	1	7	0	0
5	56935031	.	G	T	2	1	3	0	0	3	0	0
5	56951034	.	G	A	9	6	15	0	0	15	0	0
5	56951156	.	C	T	11	11	22	0	1	23	0	0
5	56951229	.	C	T	15	5	20	0	6	26	0	0
5	56951258	.	A	C	5	6	11	0	0	11	0	0
5	56951686	.	G	A	6	6	12	0	0	12	0	0
5	56951713	.	T	C	5	1	6	0	0	6	0	0
5	56951769	.	A	G	5	6	11	0	0	11	0	0
5	56952295	.	G	A	17	9	26	0	1	27	0	0
5	56952316	.	A	G	10	4	14	0	0	14	0	0
5	56956359	.	G	A	5	9	14	0	0	14	0	0
5	56958513	.	C	T	4	3	7	0	0	7	0	0
5	56961194	.	A	G	1	1	2	0	0	2	0	0
5	56962827	.	T	C	4	0	4	0	2	6	0	0
5	56964475	.	G	A	4	5	9	0	0	9	0	0
5	57217343	.	T	G	2	3	5	0	0	5	0	0
5	57217391	.	C	G	0	1	1	0	0	1	0	0
5	57219429	.	T	C	2	4	6	0	0	6	0	0
5	57219430	.	T	A	1	4	5	0	1	6	0	0
5	57219496	.	G	A	4	3	7	0	1	8	0	0
5	57219736	.	T	C	1	2	3	0	1	4	0	0
5	57219789	.	C	T	1	4	5	0	0	5	0	0
5	57219938	.	G	C	0	6	6	0	9	15	0	0
5	57220033	.	T	C	5	4	9	0	0	9	0	0
5	57220108	.	G	A	0	7	7	0	5	12	0	0
5	57220190	.	A	G	6	1	7	0	7	14	0	0
5	57220324	.	T	C	2	3	5	0	0	5	0	0
5	57225343	.	C	T	2	3	5	0	0	5	0	0
5	57225496	.	C	G	2	0	2	0	1	3	0	0
5	57234053	.	A	C	3	3	6	0	1	7	0	0
5	57234074	.	C	T	2	1	3	0	0	3	0	0
5	57244143	.	T	A	1	2	3	0	0	3	0	0
5	57244147	.	A	T	1	2	3	0	0	3	0	0
5	57244390	.	C	G	2	2	4	0	0	4	0	0
5	57286268	.	A	G	2	1	3	0	0	3	0	0
5	57320235	.	C	T	29	26	55	0	1	56	0	0
5	57320274	.	G	A	30	22	52	0	4	56	0	0
5	57324956	.	A	C	30	26	56	0	5	61	0	0
5	57325158	.	T	G	28	31	59	0	3	62	0	0
5	57325204	.	T	G	26	1	27	0	32	59	0	0
5	57325210	.	G	A	26	28	54	0	4	58	0	0
5	57325359	.	G	A	32	26	58	0	4	62	0	0
5	57325537	.	C	T	5	5	10	0	2	12	0	0
5	57340438	.	A	G	1	0	1	0	3	4	0	0
5	57340478	.	T	A	1	1	2	0	0	2	0	0
5	57351036	.	A	G	1	0	1	0	2	3	0	0
5	57351189	.	C	T	0	3	3	0	1	4	0	0
5	57351403	.	G	A	4	2	6	0	0	6	0	0
5	57352064	.	G	A	1	2	3	0	0	3	0	0
5	57352193	.	T	C	1	2	3	0	0	3	0	0
5	57352200	.	T	A	1	2	3	0	0	3	0	0
5	57352421	.	G	C	0	2	2	0	4	6	0	0
5	57353387	.	T	C	1	6	7	0	0	7	0	0
5	57353959	.	C	A	1	5	6	0	3	9	0	0
5	57353981	.	C	T	2	9	11	0	2	13	0	0
5	57354046	.	G	A	6	6	12	0	0	12	0	0
5	57354096	.	A	G	3	3	6	0	0	6	0	0
5	57354166	.	T	C	8	4	12	0	0	12	0	0
5	57354552	.	C	T	1	7	8	0	0	8	0	0
5	57354596	.	C	T	3	6	9	0	0	9	0	0
5	57354656	.	A	G	2	2	4	0	0	4	0	0
5	57354680	.	G	A	0	7	7	0	4	11	0	0
5	57354719	.	T	G	3	10	13	0	0	14	1	0
5	57354786	.	G	T	4	7	11	0	1	12	0	0
5	57354839	.	A	G	3	1	4	0	3	7	0	0
5	57359740	.	G	A	6	9	15	0	0	15	0	0
5	57359811	.	A	G	5	11	16	0	0	16	0	0
5	57446925	.	G	A	0	1	1	0	0	1	0	0
5	57450440	.	C	A	2	1	3	0	0	3	0	0
5	57453587	.	T	C	1	2	3	0	0	3	0	0
5	57453635	.	T	C	2	5	7	0	1	8	0	0
5	57482894	.	T	G	1	0	1	0	3	4	0	0
5	57489777	.	T	C	9	0	9	0	15	24	0	0
5	57490081	.	C	A	7	3	10	0	0	10	0	0
5	57490099	.	G	A	9	6	15	0	1	16	0	0
5	57490153	.	T	C	14	15	29	0	0	29	0	0
5	57500086	.	T	C	4	8	12	0	1	13	0	0
5	57506568	.	A	C	2	5	7	0	1	8	0	0
5	57506622	.	A	G	7	8	15	0	0	16	1	0
5	57506646	.	C	T	0	4	4	0	4	8	0	0
5	57514332	.	G	A	8	10	18	0	1	19	0	0
5	57514428	.	G	A	4	4	8	0	1	9	0	0
5	57641711	.	A	T	4	4	8	0	0	8	0	0
5	57641751	.	C	T	4	5	9	0	0	9	0	0
5	57641808	.	T	C	3	6	9	0	0	9	0	0
5	57643949	.	T	C	2	7	9	0	0	9	0	0
5	57644184	.	T	G	1	4	5	0	0	5	0	0
5	57644256	.	G	A	4	16	20	0	1	21	0	0
5	57644388	.	G	T	0	2	2	0	2	4	0	0
5	57644401	.	C	G	1	1	2	0	1	3	0	0
5	57644495	.	A	T	1	2	3	0	0	3	0	0
5	57644519	.	A	T	1	3	4	0	0	4	0	0
5	57644555	.	C	T	1	5	6	0	0	6	0	0
5	57644563	.	A	G	1	4	5	0	1	6	0	0
5	57647686	.	T	C	2	3	5	0	0	5	0	0
5	57650592	.	G	T	0	2	2	0	3	5	0	0
5	57650777	.	C	T	5	1	6	0	1	7	0	0
5	57650782	.	C	T	5	2	7	0	0	7	0	0
5	57708608	.	G	A	0	1	1	0	0	1	0	0
5	57715136	.	G	T	1	1	2	0	0	2	0	0
5	57715904	.	T	C	9	11	20	0	0	20	0	0
5	57718488	.	A	C	8	7	15	0	0	15	0	0
5	57718554	.	T	G	7	4	11	1	1	13	0	0
5	57718558	.	G	T	7	2	9	1	1	11	0	0
5	57718614	.	C	A	7	5	12	0	0	12	0	0
5	57718649	.	A	G	17	0	17	0	0	17	0	0
5	57718659	.	C	T	9	13	22	0	0	22	0	0
5	57718716	.	T	C	11	12	23	0	0	23	0	0
5	57718739	.	T	C	7	8	15	0	0	15	0	0
5	57726573	.	T	A	1	3	4	0	0	4	0	0
5	57734692	.	A	T	4	3	7	0	0	7	0	0
5	57735420	.	A	G	4	4	8	0	1	9	0	0
5	57737337	.	A	G	4	2	6	0	0	6	0	0
5	57737389	.	C	T	3	3	6	0	0	6	0	0
5	57737395	.	T	C	4	3	7	0	0	7	0	0
5	57737504	.	C	A	2	4	6	0	0	6	0	0
5	57737587	.	G	A	4	2	6	0	0	6	0	0
5	57737589	.	T	C	3	2	5	0	1	6	0	0
5	57737628	.	A	T	3	1	4	0	0	4	0	0
5	57737862	.	T	A	3	3	6	0	1	7	0	0
5	57737863	.	A	C	3	3	6	0	1	7	0	0
5	57738078	.	C	T	5	7	12	0	0	12	0	0
5	57738321	.	G	A	1	4	5	0	0	5	0	0
5	57743868	.	G	A	8	9	17	0	0	17	0	0
5	57743907	.	A	G	5	10	15	0	3	18	0	0
5	57744681	.	C	T	0	4	4	0	0	4	0	0
5	57747691	.	A	G	0	3	3	0	0	3	0	0
5	57750341	.	T	G	0	1	1	0	0	1	0	0
5	57751167	.	A	G	1	1	2	0	0	2	0	0
5	57751676	.	T	A	3	6	9	0	0	9	0	0
5	57753821	.	C	T	7	2	9	0	0	9	0	0
5	57753827	.	A	G	5	0	5	0	2	7	0	0
5	57755422	.	T	C	2	4	6	0	1	7	0	0
5	57755844	.	C	T	5	1	6	0	0	6	0	0
5	57762423	.	A	T	2	12	14	0	3	17	0	0
5	57762468	.	G	T	12	27	39	0	1	40	0	0
5	57762479	.	A	T	15	20	35	0	1	36	0	0
5	57762656	.	T	G	11	18	29	0	2	31	0	0
5	57762849	.	A	T	10	13	23	0	2	25	0	0
5	57762868	.	A	G	8	11	19	0	1	20	0	0
5	57762900	.	T	C	8	12	20	0	1	21	0	0
5	57762938	.	A	T	12	14	26	0	0	26	0	0
5	57762986	.	C	G	11	8	19	0	3	22	0	0
5	57777906	.	C	G	8	0	8	0	5	13	0	0
5	57787630	.	C	T	14	7	21	0	1	22	0	0
5	57790313	.	G	A	0	1	1	0	0	1	0	0
5	57790583	.	G	A	20	16	36	0	1	37	0	0
5	57797085	.	A	C	12	14	26	0	6	32	0	0
5	57797152	.	G	A	0	34	34	0	21	55	0	0
5	57797844	.	C	T	19	30	49	0	1	50	0	0
5	57797887	.	A	T	20	26	46	0	2	48	0	0
5	57797914	.	A	G	19	2	21	0	20	41	0	0
5	57797954	.	T	C	14	21	35	0	1	36	0	0
5	57814360	.	G	A	1	3	4	0	0	4	0	0
5	57814454	.	C	A	5	3	8	0	2	10	0	0
5	57814523	.	A	G	3	4	7	0	1	8	0	0
5	57814627	.	G	A	8	5	13	0	2	15	0	0
5	57815018	.	G	A	3	2	5	0	0	5	0	0
5	57819091	.	A	T	1	3	4	0	1	5	0	0
5	57820683	.	A	G	2	3	5	0	0	5	0	0
5	57838329	.	G	A	1	1	2	0	0	2	0	0
5	57902067	.	T	C	1	1	2	0	0	2	0	0
5	58075815	.	T	G	2	5	7	0	2	9	0	0
5	58081110	.	C	T	1	0	1	0	1	2	0	0
5	58081173	.	T	A	2	2	4	0	1	5	0	0
5	58086215	.	G	C	6	0	6	0	3	9	0	0
5	58173573	.	T	A	4	3	7	0	0	7	0	0
5	58372268	.	T	C	16	22	38	0	4	43	1	0
5	58382159	.	A	G	18	4	22	0	28	50	0	0
5	58382358	.	C	T	25	28	53	0	0	53	0	0
5	58382440	.	T	A	34	5	39	0	7	59	13	0
5	58382457	.	C	G	39	5	44	0	12	56	0	0
5	58412403	.	T	C	4	3	7	0	0	7	0	0
5	58444059	.	G	A	1	1	2	0	0	2	0	0
5	58444064	.	A	T	1	1	2	0	0	2	0	0
5	58455514	.	T	A	2	2	4	0	0	4	0	0
5	58457014	.	T	C	1	2	3	0	0	3	0	0
5	58459476	.	A	C	0	1	1	0	0	1	0	0
5	58462891	.	A	G	10	0	10	0	10	20	0	0
5	58468137	.	T	C	1	0	1	0	0	1	0	0
5	58470952	.	C	G	1	1	2	0	0	2	0	0
5	58477449	.	A	T	2	0	2	0	0	2	0	0
5	58478136	.	T	C	3	6	9	0	0	9	0	0
5	58478188	.	C	T	0	2	2	0	0	2	0	0
5	58481826	.	T	C	2	10	12	0	1	13	0	0
5	58504447	.	G	T	0	1	1	0	0	1	0	0
5	58511523	.	C	G	13	1	14	0	0	14	0	0
5	58687623	.	A	T	0	6	6	0	0	6	0	0
5	58687673	.	T	C	3	8	11	0	1	12	0	0
5	58687690	.	T	A	3	10	13	0	1	14	0	0
5	58687739	.	G	A	0	3	3	0	1	4	0	0
5	58688621	.	T	A	0	3	3	0	0	3	0	0
5	58688687	.	G	A	0	8	8	0	3	11	0	0
5	58691748	.	A	G	8	8	16	0	0	16	0	0
5	58691763	.	T	G	7	6	13	0	0	13	0	0
5	58695746	.	A	T	2	6	8	0	0	8	0	0
5	58695764	.	G	A	0	4	4	0	2	6	0	0
5	58695783	.	A	C	1	2	3	0	0	3	0	0
5	58696412	.	A	C	6	12	18	0	0	18	0	0
5	58696670	.	T	C	9	0	9	0	7	16	0	0
5	58696840	.	G	A	6	7	13	0	2	15	0	0
5	58696997	.	T	G	7	5	12	0	3	15	0	0
5	58697007	.	A	C	8	8	16	0	1	17	0	0
5	58697050	.	C	T	5	6	11	0	1	12	0	0
5	58699888	.	C	T	1	0	1	0	0	1	0	0
5	58704284	.	G	C	4	2	6	0	1	7	0	0
5	58707265	.	A	G	1	2	3	0	1	4	0	0
5	58708812	.	T	G	0	5	5	0	0	5	0	0
5	58708832	.	T	G	0	5	5	0	0	5	0	0
5	58708996	.	G	T	0	1	1	0	0	1	0	0
5	58711159	.	G	T	1	0	1	0	1	2	0	0
5	58717535	.	C	G	0	1	1	0	0	1	0	0
5	58719797	.	C	T	1	3	4	0	0	4	0	0
5	58721406	.	C	T	0	2	2	0	6	8	0	0
5	58722507	.	T	C	2	4	6	0	1	7	0	0
5	58730739	.	G	A	3	2	5	0	0	5	0	0
5	58742862	.	C	T	0	2	2	0	0	2	0	0
5	58742895	.	A	G	0	2	2	0	0	2	0	0
5	58751855	.	T	A	1	0	1	0	0	1	0	0
5	58850883	.	A	T	12	23	35	0	2	37	0	0
5	58850923	.	A	C	16	18	34	0	1	35	0	0
5	58850958	.	T	C	17	2	19	0	8	27	0	0
5	58850981	.	A	T	15	12	27	0	0	27	0	0
5	58851041	.	G	T	15	17	32	0	3	35	0	0
5	58852256	.	G	A	12	9	21	0	2	23	0	0
5	58852582	.	G	A	4	6	10	0	1	11	0	0
5	58852687	.	A	G	10	19	29	0	1	30	0	0
5	58852758	.	C	A	6	7	13	0	1	14	0	0
5	58852784	.	A	G	10	8	18	0	1	19	0	0
5	58852825	.	A	C	15	10	25	0	0	25	0	0
5	58852873	.	T	A	6	9	15	0	2	17	0	0
5	58853407	.	C	T	5	5	10	0	0	10	0	0
5	59060620	.	C	T	1	4	5	0	0	5	0	0
5	59060824	.	C	T	2	0	2	0	0	2	0	0
5	59063090	.	C	A	1	1	2	0	0	2	0	0
5	59063102	.	C	T	1	1	2	0	0	2	0	0
5	59079594	.	A	G	1	2	3	0	0	3	0	0
5	59079726	.	C	A	16	8	24	0	1	25	0	0
5	59079732	.	A	C	15	12	27	0	1	28	0	0
5	59079806	.	C	A	15	11	26	0	0	26	0	0
5	59079919	.	G	A	1	6	7	0	3	10	0	0
5	59080392	.	C	A	5	5	10	0	2	12	0	0
5	59080682	.	A	T	2	2	4	0	0	4	0	0
5	59080874	.	A	G	4	3	7	0	0	7	0	0
5	59080924	.	A	T	1	3	4	0	0	4	0	0
5	59080979	.	G	T	1	0	1	0	0	1	0	0
5	59081730	.	C	T	2	2	4	0	0	4	0	0
5	59082497	.	A	T	12	7	19	0	0	19	0	0
5	59082540	.	C	T	9	5	14	0	2	16	0	0
5	59082581	.	T	A	5	7	12	0	0	12	0	0
5	59082685	.	G	A	14	9	23	0	0	23	0	0
5	59082703	.	T	C	10	11	21	0	1	22	0	0
5	59082882	.	C	T	12	8	20	0	0	20	0	0
5	59083136	.	T	G	6	10	16	0	2	18	0	0
5	59083180	.	G	T	0	8	8	0	10	18	0	0
5	59083201	.	T	A	5	10	15	0	3	18	0	0
5	59092513	.	A	G	0	3	3	0	0	3	0	0
5	59092644	.	G	A	1	1	2	0	0	2	0	0
5	59100577	.	G	A	3	3	6	0	0	6	0	0
5	59101602	.	A	G	2	1	3	0	0	3	0	0
5	59103052	.	A	G	0	2	2	0	0	2	0	0
5	59107979	.	T	A	0	1	1	0	0	1	0	0
5	59147690	.	C	T	4	2	6	0	0	6	0	0
5	59198679	.	C	T	7	5	12	0	1	13	0	0
5	59200206	.	G	T	1	4	5	0	0	5	0	0
5	59200523	.	C	G	4	3	7	0	0	7	0	0
5	59201199	.	C	T	1	4	5	0	0	5	0	0
5	59201364	.	C	T	3	2	5	0	0	5	0	0
5	59201474	.	C	T	5	4	9	0	0	9	0	0
5	59201609	.	A	T	3	5	8	0	0	8	0	0
5	59201624	.	C	T	4	5	9	0	0	9	0	0
5	59201883	.	T	G	9	4	13	0	0	13	0	0
5	59239773	.	C	G	2	3	5	0	0	5	0	0
5	59278463	.	T	C	2	2	4	0	0	4	0	0
5	59278508	.	T	G	1	4	5	0	0	5	0	0
5	59278520	.	T	G	1	4	5	0	0	5	0	0
5	59367819	.	C	G	1	4	5	0	0	5	0	0
5	59368490	.	T	C	0	2	2	0	0	2	0	0
5	59368510	.	C	T	2	5	7	0	0	7	0	0
5	59380488	.	C	T	5	4	9	0	0	9	0	0
5	59386337	.	G	T	0	4	4	0	3	7	0	0
5	59386456	.	T	C	5	6	11	0	0	11	0	0
5	59386512	.	C	G	5	6	11	0	0	11	0	0
5	59386964	.	G	T	4	4	8	0	1	9	0	0
5	59387184	.	A	T	2	5	7	0	0	7	0	0
5	59387237	.	T	G	5	6	11	0	0	11	0	0
5	59387476	.	C	A	5	3	8	0	0	8	0	0
5	59387478	.	C	A	5	3	8	0	0	8	0	0
5	59388343	.	T	C	6	3	9	0	0	9	0	0
5	59388586	.	T	A	5	6	11	0	0	11	0	0
5	59388604	.	T	C	9	7	16	0	0	16	0	0
5	59388951	.	T	A	9	5	14	0	0	14	0	0
5	59389243	.	G	A	1	3	4	0	0	4	0	0
5	59389440	.	T	A	3	4	7	0	2	9	0	0
5	59389444	.	T	A	3	6	9	0	0	9	0	0
5	59389688	.	G	A	8	3	11	0	2	13	0	0
5	59389786	.	T	G	3	6	9	0	0	9	0	0
5	59398522	.	A	G	4	3	7	0	0	7	0	0
5	59419988	.	T	C	1	1	2	0	1	3	0	0
5	59420096	.	T	C	4	4	8	0	1	9	0	0
5	59420111	.	G	A	4	4	8	0	0	8	0	0
5	59420138	.	G	A	0	3	3	0	3	6	0	0
5	59420291	.	A	G	3	0	3	0	4	7	0	0
5	59420414	.	G	T	0	2	2	0	3	5	0	0
5	59444562	.	C	A	5	1	6	0	0	6	0	0
5	59449692	.	G	A	1	2	3	0	3	6	0	0
5	59449713	.	G	A	1	3	4	0	6	10	0	0
5	59449767	.	C	T	9	5	14	0	1	15	0	0
5	59462424	.	G	T	2	0	2	0	0	2	0	0
5	59462457	.	G	A	3	1	4	0	0	4	0	0
5	59462595	.	C	T	3	5	8	0	0	8	0	0
5	59462679	.	C	T	7	3	10	0	0	10	0	0
5	59462881	.	G	A	3	8	11	0	1	12	0	0
5	59462991	.	T	C	8	5	13	0	0	13	0	0
5	59462994	.	A	T	8	5	13	0	0	13	0	0
5	59463183	.	G	T	6	5	11	0	0	11	0	0
5	59463261	.	C	A	3	7	10	0	0	10	0	0
5	59463327	.	A	C	2	4	6	0	0	6	0	0
5	59466882	.	G	A	0	1	1	0	0	1	0	0
5	59466930	.	A	G	1	1	2	0	0	2	0	0
5	59472724	.	T	C	3	1	4	0	0	4	0	0
5	59473728	.	T	C	2	1	3	0	0	3	0	0
5	59479973	.	C	T	11	6	17	0	0	17	0	0
5	59515419	.	A	T	2	2	4	0	1	5	0	0
5	59515509	.	A	G	3	5	8	0	0	8	0	0
5	59515629	.	G	C	3	3	6	0	0	6	0	0
5	59525071	.	A	G	1	0	1	0	3	4	0	0
5	59544225	.	A	G	0	0	0	0	1	1	0	0
5	59544327	.	C	T	3	3	6	0	0	6	0	0
5	59544645	.	G	T	2	1	3	0	0	3	0	0
5	59548976	.	C	G	5	5	10	0	0	10	0	0
5	59549006	.	G	A	0	5	5	0	4	9	0	0
5	59549038	.	A	C	4	5	9	0	0	9	0	0
5	59549143	.	A	G	4	0	4	0	3	7	0	0
5	59549148	.	G	A	4	3	7	0	0	7	0	0
5	59549182	.	G	A	3	3	6	0	0	6	0	0
5	59550260	.	A	T	3	3	6	0	0	6	0	0
5	59550529	.	T	G	3	2	5	0	0	5	0	0
5	59550581	.	T	C	4	5	9	0	0	9	0	0
5	59550636	.	A	T	3	5	8	0	1	9	0	0
5	59550762	.	A	C	2	3	5	0	0	5	0	0
5	59553797	.	A	G	4	0	4	0	5	9	0	0
5	59559950	.	T	C	7	9	16	0	0	16	0	0
5	59560110	.	T	C	11	6	17	0	1	18	0	0
5	59593297	.	G	C	0	6	6	0	16	22	0	0
5	59593408	.	G	T	5	10	15	0	2	17	0	0
5	59593523	.	C	T	4	4	8	0	0	8	0	0
5	59593685	.	A	T	4	5	9	0	0	9	0	0
5	59593773	.	G	C	7	5	12	0	0	12	0	0
5	59593822	.	G	T	2	5	7	0	0	7	0	0
5	59593884	.	T	G	3	5	8	0	0	8	0	0
5	59594199	.	T	C	2	4	6	0	0	6	0	0
5	59594328	.	T	C	6	7	13	0	0	13	0	0
5	59594485	.	G	T	12	11	23	0	0	23	0	0
5	59594551	.	A	G	15	0	15	0	6	21	0	0
5	59594648	.	A	T	3	9	12	0	1	13	0	0
5	59595127	.	T	C	3	2	5	0	1	6	0	0
5	59595241	.	T	C	9	10	19	0	0	19	0	0
5	59595252	.	C	T	8	10	18	0	0	18	0	0
5	59595502	.	T	C	3	7	10	0	0	10	0	0
5	59595503	.	G	C	3	7	10	0	0	10	0	0
5	60665225	.	A	C	3	2	5	0	0	5	0	0
5	60684257	.	C	T	3	4	7	0	0	7	0	0
5	60684494	.	T	C	1	5	6	0	0	6	0	0
5	60684603	.	A	G	8	0	8	0	11	19	0	0
5	60684866	.	C	T	3	3	6	0	0	6	0	0
5	60685209	.	A	T	4	7	11	0	0	11	0	0
5	60685481	.	G	A	8	10	18	0	1	19	0	0
5	60685513	.	A	G	10	7	17	0	0	17	0	0
5	60685758	.	T	C	3	7	10	0	1	11	0	0
5	60685773	.	C	T	2	7	9	0	1	10	0	0
5	60685822	.	C	T	3	7	10	0	1	11	0	0
5	60685851	.	G	A	5	10	15	0	0	15	0	0
5	60685952	.	A	C	3	6	9	0	0	9	0	0
5	60686374	.	A	T	3	8	11	0	1	12	0	0
5	60686380	.	C	A	3	9	12	0	2	14	0	0
5	60686686	.	C	G	6	2	8	0	2	10	0	0
5	60686910	.	G	T	10	9	19	0	0	19	0	0
5	60687327	.	T	C	3	7	10	0	1	11	0	0
5	60687344	.	A	T	7	4	11	0	1	12	0	0
5	60687537	.	T	C	6	2	8	0	1	9	0	0
5	60854846	.	C	T	1	3	4	0	0	4	0	0
5	60866063	.	G	T	1	0	1	0	0	1	0	0
5	60868009	.	A	G	2	0	2	0	2	4	0	0
5	60868216	.	G	A	1	1	2	0	0	2	0	0
5	60871999	.	A	T	4	5	9	0	0	9	0	0
5	60872258	.	C	T	2	2	4	0	0	4	0	0
5	60872320	.	T	C	3	2	5	0	1	6	0	0
5	60872472	.	G	A	4	12	16	0	0	16	0	0
5	60872708	.	T	C	4	2	6	0	0	6	0	0
5	60893399	.	C	T	0	3	3	0	0	3	0	0
5	60894651	.	T	A	2	1	3	0	0	3	0	0
5	60894675	.	G	A	1	2	3	0	0	3	0	0
5	60894738	.	G	T	0	4	4	0	1	5	0	0
5	60906313	.	G	A	0	5	5	0	0	5	0	0
5	61270901	.	G	A	5	6	11	0	1	12	0	0
5	61270905	.	C	T	5	7	12	0	0	12	0	0
5	61329486	.	G	A	13	8	21	0	0	21	0	0
5	61329604	.	C	T	5	6	11	0	0	11	0	0
5	61351851	.	C	T	0	0	0	0	1	1	0	0
5	61353710	.	G	C	1	0	1	0	5	6	0	0
5	61354112	.	G	T	7	4	11	0	1	12	0	0
5	61380103	.	T	A	6	6	12	0	1	13	0	0
5	61380130	.	C	T	8	13	21	0	0	21	0	0
5	61392719	.	C	T	12	11	23	0	0	23	0	0
5	61396054	.	G	A	1	3	4	0	0	4	0	0
5	61402030	.	G	A	10	7	17	0	1	18	0	0
5	61402455	.	A	T	12	6	18	0	1	19	0	0
5	61402479	.	G	A	9	13	22	0	2	24	0	0
5	61402570	.	T	C	13	15	28	0	1	29	0	0
5	61402584	.	A	G	15	0	15	0	12	27	0	0
5	61402761	.	T	A	27	17	44	0	1	45	0	0
5	61402999	.	T	A	16	13	29	0	2	31	0	0
5	61404563	.	C	T	2	2	4	0	0	4	0	0
5	61404702	.	A	T	0	3	3	0	0	3	0	0
5	61405203	.	C	T	0	4	4	0	0	4	0	0
5	61405245	.	C	A	0	2	2	0	0	2	0	0
5	61405885	.	A	G	0	0	0	0	1	1	0	0
5	61405954	.	A	G	3	6	9	0	1	10	0	0
5	61414619	.	C	T	6	3	9	0	0	9	0	0
5	61416963	.	C	A	0	1	1	0	0	1	0	0
5	61425708	.	C	T	0	0	0	0	2	2	0	0
5	61425723	.	C	T	1	1	2	0	0	2	0	0
5	61425795	.	G	C	0	3	3	0	0	3	0	0
5	61425800	.	A	G	0	2	2	0	0	2	0	0
5	61428915	.	C	G	2	3	5	0	0	5	0	0
5	61428984	.	C	T	8	8	16	0	0	16	0	0
5	61429013	.	C	A	7	9	16	0	0	16	0	0
5	61429058	.	G	T	5	4	9	0	0	9	0	0
5	61429149	.	C	T	0	1	1	0	1	2	0	0
5	61431675	.	G	A	4	2	6	0	0	6	0	0
5	61433329	.	A	G	3	5	8	0	1	9	0	0
5	61459502	.	T	C	2	4	6	0	1	7	0	0
5	61464874	.	G	T	7	5	12	0	1	13	0	0
5	61464900	.	G	T	9	4	13	0	1	14	0	0
5	61472429	.	G	A	4	4	8	0	0	8	0	0
5	61472457	.	C	T	3	5	8	0	0	8	0	0
5	61472598	.	C	G	2	2	4	0	0	4	0	0
5	61504489	.	G	T	1	2	3	0	0	3	0	0
5	61508451	.	A	G	7	9	16	0	0	16	0	0
5	61508648	.	G	T	15	12	27	0	0	27	0	0
5	61548819	.	T	G	10	0	10	0	13	23	0	0
5	61552787	.	T	A	6	11	17	0	1	18	0	0
5	61552831	.	C	T	5	11	16	0	0	16	0	0
5	61552836	.	T	A	9	6	15	0	1	16	0	0
5	61553022	.	G	A	12	10	22	0	0	22	0	0
5	61553119	.	A	G	4	4	8	0	1	9	0	0
5	61553207	.	C	T	2	10	12	0	1	13	0	0
5	61553309	.	A	G	8	0	8	0	6	14	0	0
5	61553418	.	G	A	5	12	17	0	0	17	0	0
5	61553452	.	C	T	10	9	19	0	0	19	0	0
5	61553556	.	A	T	11	9	20	0	0	20	0	0
5	61553699	.	G	T	18	7	25	0	1	26	0	0
5	61566678	.	G	C	2	3	5	0	0	5	0	0
5	61566819	.	T	C	4	4	8	0	0	8	0	0
5	61584144	.	G	C	4	7	11	0	0	11	0	0
5	61584178	.	T	C	3	2	5	0	0	5	0	0
5	61586142	.	C	A	1	1	2	0	0	2	0	0
5	61660310	.	C	T	2	3	5	0	0	5	0	0
5	61660526	.	C	T	6	2	8	0	0	8	0	0
5	61665215	.	G	A	1	1	2	0	0	2	0	0
5	61668302	.	G	A	0	2	2	0	4	6	0	0
5	61676676	.	T	G	10	1	11	0	12	23	0	0
5	61676700	.	T	G	16	12	28	0	1	29	0	0
5	61676739	.	A	C	10	4	14	0	2	16	0	0
5	61682577	.	C	T	9	7	16	0	0	16	0	0
5	61682715	.	A	C	19	12	31	0	1	32	0	0
5	61682721	.	C	T	23	12	35	0	0	35	0	0
5	61698770	.	C	T	5	6	11	0	0	11	0	0
5	61701969	.	C	A	6	3	9	0	1	10	0	0
5	61706220	.	T	C	2	6	8	0	0	8	0	0
5	61723061	.	G	A	26	20	46	0	6	52	0	0
5	61723481	.	G	T	2	31	33	0	17	50	0	0
5	61723584	.	A	T	15	23	38	0	1	39	0	0
5	61723637	.	A	G	21	15	36	0	0	36	0	0
5	61723674	.	G	A	22	18	40	0	1	41	0	0
5	61723694	.	T	G	18	22	40	0	1	41	0	0
5	61723914	.	T	C	28	15	43	0	5	48	0	0
5	61790154	.	C	T	3	7	10	0	0	10	0	0
5	61790157	.	T	C	3	7	10	0	0	10	0	0
5	61793978	.	C	T	1	2	3	0	0	3	0	0
5	61921824	.	C	T	1	4	5	0	0	5	0	0
5	61951038	.	A	G	7	5	12	0	1	13	0	0
5	62290448	.	A	T	0	5	5	0	0	5	0	0
5	62639596	.	G	A	20	21	41	0	2	43	0	0
5	62642989	.	A	G	14	7	21	2	1	24	0	0
5	62806599	.	T	A	3	5	8	0	0	8	0	0
5	62806675	.	A	G	4	4	8	0	0	8	0	0
5	62806701	.	A	G	4	6	10	0	0	10	0	0
5	62806786	.	C	A	5	3	8	0	0	8	0	0
5	62806867	.	C	T	0	6	6	0	8	14	0	0
5	62806951	.	A	G	1	4	5	0	0	5	0	0
5	62807294	.	G	A	3	4	7	0	0	7	0	0
5	62807357	.	G	A	3	4	7	0	0	7	0	0
5	62860901	.	A	G	4	1	5	0	0	5	0	0
5	62860902	.	G	T	4	1	5	0	0	5	0	0
5	62860943	.	T	C	6	3	9	0	0	9	0	0
5	62860969	.	T	A	3	2	5	0	1	6	0	0
5	62865289	.	G	A	4	1	5	0	0	5	0	0
5	62889651	.	C	T	8	8	16	0	1	17	0	0
5	62889957	.	G	A	5	2	7	0	0	7	0	0
5	62889966	.	C	G	4	2	6	0	0	6	0	0
5	62890011	.	T	G	2	3	5	0	1	6	0	0
5	62890026	.	G	A	3	2	5	0	0	5	0	0
5	62890161	.	A	G	1	5	6	0	0	6	0	0
5	62890405	.	C	T	4	4	8	0	0	8	0	0
5	62890642	.	G	A	4	5	9	0	0	9	0	0
5	62890846	.	A	G	2	4	6	0	0	6	0	0
5	62937410	.	C	A	2	0	2	0	0	2	0	0
5	62989260	.	C	T	7	6	13	0	1	14	0	0
5	62994131	.	G	T	0	1	1	0	0	1	0	0
5	63003145	.	G	A	0	1	1	0	0	1	0	0
5	63065768	.	A	C	1	0	1	0	2	3	0	0
5	63198185	.	A	G	1	1	2	0	0	2	0	0
5	63200970	.	C	T	1	2	3	0	0	3	0	0
5	63200982	.	G	A	1	2	3	0	0	3	0	0
5	63248320	.	G	T	3	4	7	0	0	7	0	0
5	63248335	.	A	G	3	4	7	0	0	7	0	0
5	63248486	.	G	A	1	5	6	0	0	6	0	0
5	63248665	.	A	C	2	8	10	0	1	11	0	0
5	63248668	.	T	C	3	8	11	0	0	11	0	0
5	63267269	.	A	G	1	1	2	0	0	2	0	0
5	63268902	.	T	C	2	4	6	0	0	6	0	0
5	63268917	.	G	A	2	6	8	0	0	8	0	0
5	63285995	.	T	G	0	1	1	0	0	1	0	0
5	63329526	.	G	A	2	2	4	0	0	4	0	0
5	63331691	.	A	G	3	3	6	0	0	6	0	0
5	63335216	.	C	A	1	2	3	0	0	3	0	0
5	63338518	.	A	T	2	2	4	0	0	4	0	0
5	63359863	.	T	A	1	3	4	0	0	4	0	0
5	63360135	.	C	T	0	3	3	0	0	3	0	0
5	63360161	.	T	G	1	0	1	0	3	4	0	0
5	63360290	.	A	G	1	3	4	0	0	4	0	0
5	63360311	.	A	G	1	3	4	0	1	5	0	0
5	63360344	.	T	C	2	2	4	0	0	4	0	0
5	63363058	.	C	T	1	2	3	0	0	3	0	0
5	63375725	.	C	G	1	3	4	0	0	4	0	0
5	63375765	.	A	G	1	1	2	0	0	2	0	0
5	63375780	.	C	A	2	1	3	0	0	3	0	0
5	63375809	.	G	C	2	2	4	0	0	4	0	0
5	63375818	.	A	G	2	0	2	0	2	4	0	0
5	63387007	.	T	C	3	2	5	0	0	5	0	0
5	63387031	.	C	T	3	2	5	0	0	5	0	0
5	63394174	.	C	A	10	10	20	0	1	21	0	0
5	63395057	.	A	T	6	6	12	0	0	12	0	0
5	63398847	.	T	C	4	23	27	0	2	29	0	0
5	63398973	.	G	A	18	8	26	0	8	34	0	0
5	63399066	.	G	C	21	19	40	0	0	40	0	0
5	63399111	.	T	A	30	18	48	0	2	50	0	0
5	63399683	.	T	A	16	17	33	0	1	34	0	0
5	63400624	.	A	T	4	3	7	0	0	7	0	0
5	63400643	.	T	C	4	2	6	0	0	6	0	0
5	63510908	.	G	T	6	12	18	0	0	18	0	0
5	63511045	.	A	G	2	8	10	0	0	10	0	0
5	63511110	.	T	C	4	0	4	0	4	8	0	0
5	63511264	.	A	G	5	3	8	0	0	8	0	0
5	63511788	.	A	T	4	6	10	0	0	10	0	0
5	63511791	.	A	G	4	6	10	0	0	10	0	0
5	63629299	.	A	T	9	5	14	0	1	15	0	0
5	63644801	.	T	C	1	0	1	0	5	6	0	0
5	63648811	.	A	G	3	2	5	0	0	5	0	0
5	63655829	.	T	C	0	1	1	0	0	1	0	0
5	63657628	.	A	G	1	1	2	0	0	2	0	0
5	63680655	.	A	G	5	0	5	0	7	12	0	0
5	63680661	.	C	G	4	6	10	0	0	10	0	0
5	63680709	.	T	G	1	2	3	0	0	3	0	0
5	63680718	.	A	G	1	0	1	0	1	2	0	0
5	63681123	.	A	G	5	2	7	0	0	7	0	0
5	63695760	.	C	T	3	1	4	0	1	5	0	0
5	63698549	.	T	C	3	4	7	0	0	7	0	0
5	63699468	.	T	C	0	1	1	0	0	1	0	0
5	63707603	.	C	G	10	0	10	0	1	11	0	0
5	63720639	.	A	G	6	11	17	0	0	17	0	0
5	63723807	.	G	A	0	6	6	0	6	12	0	0
5	63730115	.	G	A	1	12	13	0	18	31	0	0
5	63740093	.	C	T	17	14	31	0	1	32	0	0
5	63740097	.	T	A	17	13	30	0	0	30	0	0
5	63740149	.	T	C	11	11	22	0	0	22	0	0
5	63740167	.	A	G	6	16	22	0	0	23	1	0
5	63740280	.	A	G	12	4	16	0	0	16	0	0
5	63740465	.	C	A	4	6	10	1	2	14	1	0
5	63740815	.	A	C	16	28	44	0	0	44	0	0
5	63740874	.	A	C	23	20	43	0	1	44	0	0
5	63740895	.	A	C	27	18	45	0	0	45	0	0
5	63740910	.	A	G	25	19	44	0	0	44	0	0
5	63741023	.	T	A	12	10	22	0	0	22	0	0
5	63741077	.	A	T	10	10	20	0	1	21	0	0
5	63848261	.	T	C	5	2	7	0	0	7	0	0
5	63857154	.	A	C	0	3	3	0	0	3	0	0
5	63857156	.	G	A	0	3	3	0	0	3	0	0
5	63858846	.	G	A	0	1	1	0	1	2	0	0
5	63858951	.	C	A	4	4	8	0	0	8	0	0
5	63860815	.	C	T	2	2	4	0	0	4	0	0
5	63862709	.	G	A	0	2	2	0	0	2	0	0
5	63863945	.	G	C	4	2	6	0	0	6	0	0
5	63864117	.	C	T	10	3	13	0	0	13	0	0
5	63864150	.	T	C	8	4	12	0	0	12	0	0
5	64205784	.	T	C	5	2	7	0	0	7	0	0
5	64848834	.	T	C	1	0	1	0	0	1	0	0
5	66236573	.	A	G	1	3	4	0	0	4	0	0
5	66236585	.	A	T	1	3	4	0	0	4	0	0
5	66250917	.	C	T	1	3	4	0	0	4	0	0
5	66252127	.	A	T	1	0	1	0	0	1	0	0
5	66263544	.	A	T	3	2	5	0	0	5	0	0
5	66266997	.	A	G	1	2	3	0	0	3	0	0
5	66268964	.	A	G	1	0	1	0	3	4	0	0
5	66271446	.	A	T	1	5	6	0	0	6	0	0
5	66389676	.	C	T	2	2	4	0	0	4	0	0
5	66676766	.	C	G	3	5	8	0	0	8	0	0
5	66676768	.	G	A	3	5	8	0	0	8	0	0
5	66699135	.	G	T	13	8	21	0	1	22	0	0
5	66699138	.	C	G	14	8	22	0	0	22	0	0
5	66699564	.	G	T	7	5	12	0	1	13	0	0
5	66700388	.	C	T	4	3	7	0	1	8	0	0
5	66700602	.	T	A	2	4	6	0	0	6	0	0
5	66700608	.	T	C	2	3	5	0	1	6	0	0
5	66700734	.	C	A	1	2	3	0	3	6	0	0
5	66700833	.	T	C	6	0	6	0	4	10	0	0
5	66700974	.	T	A	5	6	11	0	0	11	0	0
5	66701493	.	T	C	5	4	9	0	0	9	0	0
5	66702411	.	G	A	2	3	5	0	0	5	0	0
5	66733572	.	C	T	0	7	7	0	2	9	0	0
5	66733682	.	T	C	12	5	17	0	3	20	0	0
5	66733694	.	T	C	12	0	12	0	6	18	0	0
5	66733891	.	G	C	11	4	15	0	0	15	0	0
5	66736211	.	T	C	1	1	2	0	1	3	0	0
5	66736280	.	A	G	5	5	10	0	0	10	0	0
5	66740183	.	A	T	7	6	13	0	5	18	0	0
5	66740239	.	T	G	5	5	10	0	0	10	0	0
5	66740273	.	A	T	3	4	7	0	0	7	0	0
5	66807482	.	C	T	19	11	30	0	3	33	0	0
5	66807543	.	C	T	1	20	21	0	16	37	0	0
5	66807735	.	A	G	6	7	13	0	2	15	0	0
5	66807771	.	T	G	10	10	20	0	0	20	0	0
5	66807788	.	C	T	3	8	11	0	8	19	0	0
5	66807830	.	G	A	11	8	19	0	1	20	0	0
5	66807831	.	A	G	12	8	20	0	0	20	0	0
5	66807881	.	A	G	15	6	21	0	1	22	0	0
5	66807916	.	T	C	17	13	30	0	0	30	0	0
5	66813647	.	T	C	5	0	5	0	5	10	0	0
5	66813674	.	G	A	4	6	10	0	1	11	0	0
5	66813722	.	A	G	0	1	1	0	0	1	0	0
5	66814504	.	T	C	7	3	10	0	0	10	0	0
5	66814522	.	A	G	9	5	14	0	2	16	0	0
5	66818699	.	C	T	11	10	21	0	2	23	0	0
5	66819515	.	T	C	10	4	14	0	0	14	0	0
5	66820859	.	A	T	8	9	17	0	0	17	0	0
5	68766704	.	C	T	4	3	7	0	1	8	0	0
5	68767050	.	C	T	0	13	13	0	11	24	0	0
5	68767342	.	T	C	4	3	7	0	0	7	0	0
5	68767439	.	G	T	6	5	11	0	0	11	0	0
5	68767712	.	A	C	3	3	6	0	0	6	0	0
5	68767727	.	A	C	2	4	6	0	0	6	0	0
5	68767802	.	G	A	0	1	1	0	0	1	0	0
5	68778040	.	G	T	3	4	7	0	0	7	0	0
5	68778455	.	T	A	6	5	11	0	0	11	0	0
5	68778524	.	C	A	0	6	6	0	3	9	0	0
5	68778746	.	C	G	0	5	5	0	7	12	0	0
5	68778937	.	A	G	7	4	11	0	0	11	0	0
5	68778957	.	G	T	7	6	13	0	0	13	0	0
5	68779049	.	A	G	1	8	9	0	0	9	0	0
5	68779214	.	A	G	5	3	8	0	0	8	0	0
5	68779472	.	G	T	4	6	10	0	0	10	0	0
5	68779595	.	G	T	8	3	11	0	0	11	0	0
5	68782433	.	T	G	2	2	4	0	0	4	0	0
5	68782584	.	C	T	3	2	5	0	0	5	0	0
5	68831382	.	C	T	4	0	4	0	0	4	0	0
5	68832435	.	A	G	0	1	1	0	0	1	0	0
5	68840928	.	T	C	0	4	4	0	0	4	0	0
5	68845808	.	G	T	1	5	6	0	0	6	0	0
5	68846542	.	G	T	1	0	1	0	0	1	0	0
5	68848116	.	G	A	1	5	6	0	0	6	0	0
5	68850856	.	C	T	0	0	0	0	3	3	0	0
5	68850967	.	C	G	0	3	3	0	5	9	1	0
5	68860776	.	A	C	1	0	1	0	0	1	0	0
5	68863784	.	C	T	0	2	2	0	5	7	0	0
5	68863806	.	T	C	4	0	4	0	4	8	0	0
5	68892801	.	G	A	2	8	10	0	1	11	0	0
5	68899505	.	C	T	2	5	7	0	0	7	0	0
5	68900820	.	C	G	4	9	13	0	0	13	0	0
5	68900825	.	G	A	4	8	12	0	0	12	0	0
5	68927539	.	G	A	6	4	10	0	0	10	0	0
5	68927557	.	G	A	6	4	10	0	0	10	0	0
5	68927591	.	G	A	2	2	4	0	1	5	0	0
5	68982205	.	G	T	0	1	1	0	0	1	0	0
5	68982340	.	G	A	4	2	6	0	0	6	0	0
5	69002293	.	C	T	1	5	6	0	1	7	0	0
5	69008453	.	A	C	5	1	6	0	5	11	0	0
5	69014276	.	T	C	1	2	3	0	0	3	0	0
5	69140658	.	T	C	0	4	4	0	0	4	0	0
5	69140680	.	T	A	2	2	4	0	0	4	0	0
5	69141016	.	T	A	1	2	3	0	0	3	0	0
5	69141440	.	G	T	10	8	18	0	1	19	0	0
5	69144428	.	C	T	0	6	6	0	2	8	0	0
5	69205254	.	G	A	1	2	3	0	0	3	0	0
5	69207275	.	A	G	1	2	3	0	0	3	0	0
5	69207284	.	T	C	1	2	3	0	0	3	0	0
5	69234725	.	C	T	0	2	2	0	0	2	0	0
5	69234768	.	A	G	4	4	8	0	0	8	0	0
5	69235583	.	G	A	4	3	7	0	0	7	0	0
5	69235589	.	A	C	4	3	7	0	0	7	0	0
5	69246853	.	G	C	1	1	2	0	0	2	0	0
5	69259068	.	C	T	0	1	1	0	0	1	0	0
5	69259347	.	G	A	1	3	4	0	1	5	0	0
5	69271104	.	G	T	2	1	3	0	2	5	0	0
5	69278192	.	A	G	6	0	6	0	19	25	0	0
5	69287061	.	C	T	12	5	17	0	1	18	0	0
5	69287180	.	A	T	12	19	31	0	0	31	0	0
5	69287264	.	C	G	9	11	20	0	0	20	0	0
5	69287498	.	C	T	3	7	10	0	0	10	0	0
5	69290962	.	A	G	1	1	2	0	0	2	0	0
5	69290980	.	C	T	1	2	3	0	0	3	0	0
5	69427984	.	A	G	12	19	31	0	3	34	0	0
5	69428056	.	A	T	7	7	14	0	1	15	0	0
5	69428148	.	T	C	6	4	10	0	2	12	0	0
5	69428240	.	A	C	1	3	4	0	0	4	0	0
5	69428243	.	A	T	1	3	4	0	0	4	0	0
5	69429132	.	G	A	4	1	5	0	0	5	0	0
5	69429544	.	G	A	16	15	31	0	2	33	0	0
5	69431287	.	G	C	7	11	18	0	0	18	0	0
5	69462882	.	G	A	2	0	2	0	0	2	0	0
5	69463008	.	C	A	0	1	1	0	0	1	0	0
5	69464731	.	G	A	2	3	5	0	0	5	0	0
5	69464773	.	G	A	6	5	11	0	0	11	0	0
5	69464811	.	C	T	0	5	5	0	5	10	0	0
5	69466375	.	G	T	1	0	1	0	0	1	0	0
5	69469336	.	G	A	4	3	7	0	0	7	0	0
5	69482658	.	G	A	1	2	3	0	0	3	0	0
5	69486618	.	T	C	8	6	14	0	1	15	0	0
5	69486698	.	G	A	5	5	10	0	0	10	0	0
5	69486749	.	A	T	7	3	10	0	0	10	0	0
5	69486756	.	G	A	7	3	10	0	0	10	0	0
5	69486844	.	G	T	0	1	1	0	1	2	0	0
5	69491754	.	G	A	3	4	7	0	0	7	0	0
5	69491766	.	T	C	4	0	4	0	4	8	0	0
5	69492126	.	G	C	2	0	2	0	7	9	0	0
5	69505287	.	T	A	1	2	3	0	0	3	0	0
5	69536449	.	C	G	1	2	3	0	0	3	0	0
5	69557764	.	A	G	1	1	2	0	0	2	0	0
5	69557776	.	G	T	1	2	3	0	0	3	0	0
5	69574845	.	T	G	1	2	3	0	0	3	0	0
5	69574886	.	A	G	7	3	10	0	0	10	0	0
5	69574972	.	G	T	11	12	23	0	1	24	0	0
5	69579118	.	T	C	4	0	4	0	5	9	0	0
5	69579378	.	G	A	4	0	4	0	0	4	0	0
5	69579435	.	A	C	0	1	1	0	0	1	0	0
5	69588720	.	A	T	0	6	6	0	0	6	0	0
5	69595361	.	G	A	1	3	4	0	0	4	0	0
5	69599798	.	G	T	0	1	1	0	0	1	0	0
5	69607398	.	T	C	0	5	5	0	0	5	0	0
5	69607411	.	A	G	0	3	3	0	0	3	0	0
5	69616625	.	A	T	1	0	1	0	0	1	0	0
5	69686414	.	T	C	1	3	4	0	0	4	0	0
5	69907555	.	T	C	2	9	11	0	0	11	0	0
5	70183091	.	T	C	13	18	31	1	2	34	0	0
5	71748357	.	T	C	5	5	10	0	0	10	0	0
5	71765768	.	C	T	8	10	18	0	1	19	0	0
5	71927440	.	G	A	1	2	3	0	0	3	0	0
5	71931476	.	G	T	0	1	1	0	1	2	0	0
5	71934514	.	C	G	2	4	6	0	1	7	0	0
5	71934612	.	A	C	0	2	2	0	2	4	0	0
5	71934616	.	C	T	2	2	4	0	0	4	0	0
5	71944137	.	G	A	0	1	1	0	1	2	0	0
5	71944140	.	G	A	1	0	1	0	1	2	0	0
5	71946074	.	T	C	0	1	1	0	0	1	0	0
5	72002655	.	A	C	1	2	3	0	0	3	0	0
5	72002712	.	G	A	1	4	5	0	0	5	0	0
5	72002790	.	G	T	4	3	7	0	1	8	0	0
5	72002796	.	G	A	4	4	8	0	0	8	0	0
5	72023857	.	C	T	26	21	47	0	12	59	0	0
5	72024336	.	C	T	0	4	4	0	2	6	0	0
5	72027464	.	C	T	0	0	0	0	1	1	0	0
5	72028042	.	G	C	3	0	3	0	1	4	0	0
5	72031809	.	G	A	16	13	29	0	1	30	0	0
5	72031846	.	A	G	11	14	25	0	1	26	0	0
5	72033527	.	C	T	1	5	6	0	7	13	0	0
5	72034108	.	C	T	2	5	7	0	6	13	0	0
5	72034177	.	A	G	2	0	2	0	0	2	0	0
5	72038586	.	C	T	9	12	21	0	0	21	0	0
5	72038727	.	G	A	4	13	17	0	1	18	0	0
5	72038909	.	C	T	0	13	13	0	11	24	0	0
5	72039105	.	G	A	9	8	17	0	1	19	1	0
5	72043751	.	A	G	8	8	16	0	1	17	0	0
5	72043778	.	G	A	11	9	20	0	0	20	0	0
5	72043791	.	G	T	9	12	21	0	3	24	0	0
5	72044324	.	G	A	4	7	11	0	0	11	0	0
5	72044342	.	A	G	7	7	14	0	1	15	0	0
5	72045010	.	C	T	0	2	2	0	1	3	0	0
5	72046888	.	C	T	6	6	12	0	0	12	0	0
5	72047047	.	C	G	0	7	7	0	13	20	0	0
5	72047127	.	T	A	3	1	4	0	0	4	0	0
5	72047136	.	T	C	1	0	1	0	1	2	0	0
5	72049688	.	C	A	1	2	3	0	6	9	0	0
5	72050192	.	A	G	13	17	30	0	1	31	0	0
5	72050257	.	C	T	0	9	9	0	13	22	0	0
5	72050314	.	T	C	7	0	7	0	18	25	0	0
5	72053139	.	C	T	0	8	8	0	2	10	0	0
5	72058489	.	T	C	1	0	1	0	0	1	0	0
5	72066904	.	C	T	8	6	14	0	1	15	0	0
5	72066993	.	G	A	2	1	3	0	0	3	0	0
5	72068820	.	C	T	0	2	2	0	1	3	0	0
5	72068908	.	C	A	0	1	1	0	0	1	0	0
5	72071914	.	A	G	1	0	1	0	0	1	0	0
5	72072329	.	C	A	1	3	4	0	0	4	0	0
5	72092483	.	C	T	33	29	62	0	3	65	0	0
5	72092958	.	G	A	0	13	13	0	10	23	0	0
5	72104054	.	G	A	1	1	2	0	0	2	0	0
5	72130139	.	C	A	4	4	8	0	0	8	0	0
5	72130561	.	A	T	2	4	6	0	0	6	0	0
5	72130732	.	C	T	2	3	5	0	0	5	0	0
5	72131482	.	C	T	0	7	7	0	3	10	0	0
5	72131531	.	C	T	5	9	14	0	0	14	0	0
5	72131618	.	C	T	3	7	10	0	0	10	0	0
5	72155379	.	C	T	0	1	1	0	0	1	0	0
5	72155430	.	G	A	0	4	4	0	1	5	0	0
5	72166708	.	A	G	0	1	1	0	0	1	0	0
5	72167379	.	C	T	1	2	3	0	0	3	0	0
5	72168237	.	T	C	1	2	3	0	0	3	0	0
5	72168552	.	C	T	5	6	11	0	0	11	0	0
5	72172350	.	T	A	24	18	42	0	0	42	0	0
5	72172446	.	G	T	15	21	36	0	1	37	0	0
5	72172456	.	G	T	24	15	39	0	0	39	0	0
5	72172600	.	T	C	14	8	22	0	1	23	0	0
5	72172752	.	G	A	13	30	43	0	2	45	0	0
5	72173169	.	C	A	10	5	15	0	0	15	0	0
5	72173476	.	T	C	14	16	30	0	0	30	0	0
5	72173483	.	T	G	14	11	25	0	3	28	0	0
5	72173894	.	G	A	16	9	25	0	0	25	0	0
5	72173943	.	C	T	11	6	17	0	1	18	0	0
5	72196949	.	G	A	2	2	4	0	0	4	0	0
5	72201999	.	C	T	0	1	1	0	1	2	0	0
5	72202402	.	G	A	0	5	5	0	5	10	0	0
5	72203313	.	G	A	1	2	3	0	0	3	0	0
5	72205483	.	A	C	4	8	12	0	2	14	0	0
5	72205583	.	T	G	7	0	7	0	11	18	0	0
5	72205701	.	G	A	4	5	9	0	0	9	0	0
5	72205867	.	T	G	2	6	8	0	0	8	0	0
5	72205905	.	T	C	5	3	8	0	2	10	0	0
5	72206090	.	T	C	3	8	11	0	0	11	0	0
5	72206155	.	G	T	4	6	10	0	0	10	0	0
5	72206235	.	T	G	3	0	3	0	5	8	0	0
5	72317189	.	A	T	2	4	6	0	0	6	0	0
5	72317534	.	T	C	1	2	3	0	0	3	0	0
5	72376119	.	C	G	15	29	44	0	0	44	0	0
5	72376227	.	A	G	17	11	28	0	1	29	0	0
5	72376959	.	A	G	7	11	18	0	1	20	1	0
5	72382995	.	C	T	3	7	10	0	0	10	0	0
5	72383263	.	C	T	12	13	25	0	1	26	0	0
5	72383964	.	A	G	3	4	7	0	0	7	0	0
5	72384395	.	C	T	17	2	19	0	1	20	0	0
5	72384396	.	A	G	17	3	20	0	0	20	0	0
5	72384544	.	A	G	5	5	10	0	3	13	0	0
5	72384546	.	A	G	4	7	11	0	2	13	0	0
5	72384642	.	T	C	7	7	14	0	2	16	0	0
5	72384807	.	T	C	7	0	7	0	13	20	0	0
5	72384978	.	G	A	8	9	17	0	1	18	0	0
5	72386870	.	T	C	12	14	26	0	2	28	0	0
5	72389156	.	C	A	1	2	3	0	6	9	0	0
5	72390189	.	G	A	11	15	26	0	1	27	0	0
6	40944	.	T	G	0	4	4	0	0	4	0	0
6	267568	.	A	G	9	4	13	0	1	14	0	0
6	267634	.	A	G	7	6	13	0	0	13	0	0
6	267717	.	A	G	4	2	6	0	1	7	0	0
6	272194	.	A	G	34	1	35	0	10	45	0	0
6	842581	.	T	C	11	0	11	0	7	18	0	0
6	844282	.	T	C	5	2	7	0	0	7	0	0
6	1799154	.	T	C	4	1	5	0	0	5	0	0
6	2112891	.	A	T	0	3	3	0	0	3	0	0
6	2112893	.	A	G	0	0	0	0	3	3	0	0
6	2171391	.	A	G	4	2	6	0	0	6	0	0
6	2207716	.	T	C	1	1	2	0	0	2	0	0
6	3005179	.	G	T	2	2	4	0	0	4	0	0
6	3047971	.	A	T	1	0	1	0	0	1	0	0
6	3143292	.	T	A	6	6	12	0	0	12	0	0
6	3143609	.	G	A	4	2	6	0	0	6	0	0
6	3197028	.	C	T	5	10	15	0	0	15	0	0
6	3223245	.	C	T	1	5	6	0	0	6	0	0
6	3223341	.	C	G	2	0	2	0	0	2	0	0
6	3249490	.	C	T	4	2	6	0	0	6	0	0
6	3256066	.	C	A	5	0	5	0	0	5	0	0
6	3268327	.	T	C	2	2	4	0	0	4	0	0
6	3269864	.	A	G	6	1	7	0	6	13	0	0
6	3270011	.	G	A	8	4	12	0	0	12	0	0
6	3273272	.	A	T	10	12	22	0	3	25	0	0
6	3273341	.	T	A	10	9	19	0	3	22	0	0
6	3273379	.	A	G	10	7	17	0	1	18	0	0
6	3273901	.	T	G	16	0	16	0	16	32	0	0
6	3274114	.	G	C	2	16	18	0	14	32	0	0
6	3274191	.	G	C	19	11	30	0	1	31	0	0
6	3294037	.	C	A	1	3	4	0	0	4	0	0
6	3294048	.	G	A	0	3	3	0	2	5	0	0
6	3294251	.	T	C	2	6	8	0	0	8	0	0
6	3294306	.	G	T	0	2	2	0	1	3	0	0
6	3294621	.	G	A	0	2	2	0	4	6	0	0
6	3294755	.	C	T	3	3	6	0	0	6	0	0
6	3295262	.	C	T	0	3	3	0	2	5	0	0
6	3298796	.	G	A	1	0	1	0	0	1	0	0
6	3298816	.	G	C	1	1	2	0	0	2	0	0
6	3298844	.	C	T	1	2	3	0	0	3	0	0
6	3302644	.	T	C	1	2	3	0	0	3	0	0
6	3302645	.	A	G	1	0	1	0	2	3	0	0
6	3318673	.	T	C	2	4	6	0	0	6	0	0
6	3318721	.	G	A	0	7	7	0	3	10	0	0
6	3395649	.	C	T	1	2	3	0	0	3	0	0
6	3398906	.	A	G	0	2	2	0	1	3	0	0
6	3404956	.	G	A	0	4	4	0	2	6	0	0
6	3404974	.	C	T	1	5	6	0	0	6	0	0
6	3405052	.	G	A	1	2	3	0	1	4	0	0
6	3405060	.	G	A	0	2	2	0	4	6	0	0
6	3405143	.	T	C	2	7	9	0	1	10	0	0
6	3405191	.	G	C	3	9	12	0	0	12	0	0
6	3405244	.	A	G	5	8	13	0	2	15	0	0
6	3405245	.	C	A	7	8	15	0	0	15	0	0
6	3500212	.	G	A	0	1	1	0	1	2	0	0
6	3514481	.	A	C	16	22	38	0	3	42	1	0
6	3568124	.	G	A	1	2	3	0	0	3	0	0
6	3573650	.	T	G	2	2	4	0	1	5	0	0
6	3698558	.	C	T	0	1	1	0	0	1	0	0
6	3704391	.	G	A	0	1	1	0	1	2	0	0
6	3707095	.	A	G	4	5	9	0	0	9	0	0
6	3707116	.	G	A	5	6	11	0	0	11	0	0
6	3707371	.	G	A	0	9	9	0	9	18	0	0
6	3707372	.	A	G	8	9	17	0	1	18	0	0
6	3707407	.	T	C	13	9	22	0	0	22	0	0
6	3708061	.	A	G	6	8	14	0	2	16	0	0
6	3708149	.	T	C	5	8	13	0	1	14	0	0
6	3711200	.	T	A	2	9	11	0	2	13	0	0
6	3711221	.	A	G	2	11	13	0	1	14	0	0
6	3711282	.	T	G	10	0	10	0	11	21	0	0
6	3711338	.	A	G	8	5	13	0	0	13	0	0
6	3711386	.	T	C	4	4	8	0	0	8	0	0
6	3711419	.	A	G	2	2	4	0	0	4	0	0
6	3711616	.	G	A	3	1	4	0	1	5	0	0
6	3711665	.	A	T	2	2	4	0	0	4	0	0
6	3711703	.	G	A	0	2	2	0	4	6	0	0
6	3711971	.	G	A	3	3	6	0	0	6	0	0
6	3712045	.	T	A	3	4	7	0	0	7	0	0
6	3712069	.	A	T	1	2	3	0	1	4	0	0
6	3712136	.	G	A	3	7	10	0	0	10	0	0
6	3712198	.	G	T	2	3	5	0	0	5	0	0
6	3712199	.	A	C	2	3	5	0	0	5	0	0
6	3712238	.	A	T	6	7	13	0	0	13	0	0
6	3712264	.	A	C	6	7	13	0	1	14	0	0
6	3712335	.	T	G	7	0	7	0	7	14	0	0
6	3712389	.	C	T	5	4	9	0	0	9	0	0
6	3712433	.	A	T	3	2	5	0	1	6	0	0
6	3717060	.	T	A	1	3	4	0	0	4	0	0
6	3717110	.	A	T	1	1	2	0	1	3	0	0
6	3717843	.	C	T	1	2	3	0	0	3	0	0
6	3724870	.	A	C	10	6	16	0	1	17	0	0
6	3725767	.	C	A	11	12	23	0	1	24	0	0
6	3727891	.	C	T	12	7	19	0	1	20	0	0
6	3728295	.	A	T	4	8	12	0	0	12	0	0
6	3728559	.	G	C	2	4	6	0	0	6	0	0
6	3827894	.	C	A	17	10	27	0	2	29	0	0
6	3834630	.	G	C	20	28	48	0	0	48	0	0
6	3853120	.	T	G	13	0	13	0	19	32	0	0
6	3853165	.	T	C	16	17	33	0	2	35	0	0
6	3862018	.	A	G	8	19	27	0	2	29	0	0
6	3867542	.	A	T	2	7	9	0	0	9	0	0
6	3869454	.	G	A	0	7	7	0	4	11	0	0
6	3869891	.	C	T	12	7	19	0	1	20	0	0
6	3871982	.	T	A	6	7	13	0	1	14	0	0
6	3874504	.	G	A	0	18	18	0	24	42	0	0
6	3874533	.	C	T	21	17	38	0	0	38	0	0
6	3874686	.	A	G	8	14	22	0	0	22	0	0
6	3878513	.	T	A	1	7	8	0	0	8	0	0
6	3878593	.	A	G	5	5	10	0	0	10	0	0
6	3878831	.	G	C	4	4	8	0	0	8	0	0
6	3878983	.	A	T	8	7	15	0	4	19	0	0
6	3879158	.	A	G	10	9	19	0	0	19	0	0
6	3879247	.	C	A	0	13	13	0	13	26	0	0
6	3879314	.	C	G	0	13	13	0	3	16	0	0
6	3879335	.	C	T	2	11	13	0	0	13	0	0
6	3879367	.	G	A	1	5	6	0	0	6	0	0
6	3881078	.	G	A	3	1	4	0	0	4	0	0
6	3885451	.	C	T	8	8	16	0	0	16	0	0
6	3895442	.	A	T	2	3	5	0	2	7	0	0
6	3895460	.	C	T	0	8	8	0	6	14	0	0
6	3901120	.	C	T	0	1	1	0	3	4	0	0
6	3907796	.	A	T	4	8	12	0	0	12	0	0
6	3945773	.	C	A	1	5	6	0	0	6	0	0
6	3945792	.	C	A	1	4	5	0	0	5	0	0
6	3950267	.	C	T	1	1	2	0	0	2	0	0
6	3950270	.	C	T	1	0	1	0	1	2	0	0
6	3950309	.	C	T	2	1	3	0	0	3	0	0
6	3953280	.	T	C	5	4	9	0	0	9	0	0
6	3953302	.	A	C	5	3	8	0	1	9	0	0
6	3961387	.	G	A	5	9	14	0	0	14	0	0
6	3962132	.	G	A	24	20	44	0	4	48	0	0
6	3962192	.	A	T	13	8	21	0	2	23	0	0
6	3965389	.	G	T	2	0	2	0	0	2	0	0
6	3965461	.	A	G	6	6	12	0	0	12	0	0
6	3973572	.	G	A	0	2	2	0	0	2	0	0
6	3973638	.	T	G	0	2	2	0	0	2	0	0
6	3974047	.	G	A	9	6	15	0	1	16	0	0
6	3984909	.	T	A	1	2	3	0	0	3	0	0
6	3985083	.	G	A	8	8	16	0	0	16	0	0
6	3985137	.	G	A	9	12	21	0	1	22	0	0
6	3987145	.	T	C	0	5	5	0	0	5	0	0
6	3989704	.	C	A	0	2	2	0	0	2	0	0
6	4144415	.	C	T	2	3	5	0	0	5	0	0
6	4144448	.	C	T	0	1	1	0	0	1	0	0
6	4185678	.	G	A	8	16	24	0	1	25	0	0
6	4191449	.	C	T	5	4	9	0	0	9	0	0
6	4191554	.	A	T	2	6	8	0	1	9	0	0
6	4192031	.	A	G	0	1	1	0	0	1	0	0
6	4204072	.	G	T	1	2	3	0	0	3	0	0
6	4219856	.	G	A	4	4	8	0	0	8	0	0
6	4246466	.	T	C	3	1	4	0	0	4	0	0
6	4246496	.	G	A	0	2	2	0	5	7	0	0
6	4246638	.	A	C	3	3	6	0	0	6	0	0
6	4247442	.	C	G	2	4	6	0	0	6	0	0
6	4248160	.	A	G	2	1	3	0	0	3	0	0
6	4248195	.	G	C	4	4	8	0	0	8	0	0
6	4248231	.	A	G	3	0	3	0	2	5	0	0
6	4248307	.	G	A	0	4	4	0	3	7	0	0
6	4248399	.	A	T	1	4	5	0	0	5	0	0
6	4248412	.	T	A	1	3	4	0	0	4	0	0
6	4248527	.	T	A	3	5	8	0	0	8	0	0
6	4248562	.	C	T	1	2	3	0	0	3	0	0
6	4248563	.	T	A	1	2	3	0	0	3	0	0
6	4249684	.	A	G	5	2	7	0	2	9	0	0
6	4249821	.	G	A	2	3	5	0	0	5	0	0
6	4250046	.	A	T	3	2	5	0	1	6	0	0
6	4314446	.	C	T	1	0	1	0	0	1	0	0
6	4314593	.	C	A	1	2	3	0	0	3	0	0
6	4347541	.	T	C	1	1	2	0	0	2	0	0
6	4352140	.	G	T	1	3	4	0	0	4	0	0
6	4359857	.	C	G	3	0	3	0	0	3	0	0
6	4360110	.	C	T	2	4	6	0	0	6	0	0
6	4365096	.	C	A	7	2	9	0	1	10	0	0
6	4365163	.	C	T	7	7	14	0	0	14	0	0
6	4365295	.	G	C	8	12	20	0	0	20	0	0
6	4376849	.	G	A	0	2	2	0	1	3	0	0
6	4376894	.	G	A	0	1	1	0	0	1	0	0
6	4379760	.	G	A	0	4	4	0	4	8	0	0
6	4389434	.	G	A	1	1	2	0	0	2	0	0
6	4389436	.	T	C	1	1	2	0	0	2	0	0
6	4389506	.	A	C	0	1	1	0	12	13	0	0
6	4389511	.	T	G	0	0	0	0	13	13	0	0
6	4392639	.	C	T	8	3	11	0	0	11	0	0
6	4397173	.	G	A	8	11	19	0	0	19	0	0
6	4397181	.	C	A	9	11	20	0	0	20	0	0
6	4397262	.	C	T	1	0	1	0	0	1	0	0
6	4398906	.	C	T	4	6	10	0	0	10	0	0
6	4398939	.	A	C	1	2	3	0	0	3	0	0
6	4400803	.	T	A	4	4	8	0	1	9	0	0
6	4400999	.	C	T	6	3	9	0	0	9	0	0
6	4401087	.	T	A	4	5	9	0	1	10	0	0
6	4401088	.	A	T	4	5	9	0	1	10	0	0
6	4416859	.	G	A	4	2	6	0	0	6	0	0
6	4540422	.	A	G	1	1	2	0	0	2	0	0
6	4541178	.	T	C	4	4	8	0	0	9	1	0
6	4542492	.	A	G	1	0	1	0	3	4	0	0
6	4542573	.	A	C	2	4	6	0	0	6	0	0
6	4873028	.	T	A	2	4	6	0	1	7	0	0
6	4873119	.	G	A	2	4	6	0	0	6	0	0
6	4874434	.	T	C	3	5	8	0	0	8	0	0
6	4875031	.	G	A	1	4	5	0	1	6	0	0
6	4875292	.	C	T	1	2	3	0	0	3	0	0
6	4876522	.	G	C	0	5	5	0	4	9	0	0
6	4876738	.	G	A	10	9	19	0	0	19	0	0
6	4876946	.	C	A	3	5	8	0	2	10	0	0
6	4877023	.	C	T	3	3	6	0	0	6	0	0
6	6231117	.	T	C	3	4	7	0	0	7	0	0
6	6231186	.	C	A	4	2	6	0	0	6	0	0
6	6231321	.	C	A	2	4	6	0	0	6	0	0
6	6231337	.	A	C	2	3	5	0	0	5	0	0
6	6232301	.	A	C	29	18	47	0	3	50	0	0
6	6232315	.	T	C	30	0	30	0	20	50	0	0
6	6258045	.	G	C	4	0	4	0	5	9	0	0
6	6258130	.	C	T	3	8	11	0	0	11	0	0
6	6258240	.	A	G	2	7	9	0	0	9	0	0
6	6270882	.	G	C	0	1	1	0	0	1	0	0
6	6273345	.	C	T	24	39	63	0	1	64	0	0
6	6273396	.	C	T	28	27	55	0	0	55	0	0
6	6275667	.	C	T	6	13	19	0	0	19	0	0
6	6275668	.	A	G	6	12	18	0	1	19	0	0
6	6284114	.	A	G	2	1	3	0	0	3	0	0
6	6320934	.	G	A	0	2	2	0	0	2	0	0
6	6395035	.	T	G	1	6	7	0	1	8	0	0
6	6395096	.	C	T	0	3	3	0	3	6	0	0
6	6395099	.	C	T	3	3	6	0	0	6	0	0
6	6395211	.	T	A	4	2	6	0	0	6	0	0
6	6395222	.	T	A	4	2	6	0	0	6	0	0
6	6395367	.	C	T	0	2	2	0	4	6	0	0
6	6395405	.	C	T	2	2	4	0	0	4	0	0
6	6459235	.	T	C	9	4	13	0	1	14	0	0
6	6459315	.	G	A	2	1	3	0	0	3	0	0
6	6466502	.	C	T	2	2	4	0	0	4	0	0
6	6467931	.	C	T	0	3	3	0	4	7	0	0
6	6470529	.	G	A	4	8	12	0	1	13	0	0
6	6471174	.	C	G	6	5	11	0	0	11	0	0
6	6471391	.	G	A	3	2	5	0	0	5	0	0
6	6471399	.	A	C	0	3	3	0	0	3	0	0
6	6471486	.	G	A	4	3	7	0	0	7	0	0
6	6471726	.	T	C	3	5	8	0	0	8	0	0
6	6471843	.	T	G	3	7	10	0	0	10	0	0
6	6471875	.	C	G	2	7	9	0	0	9	0	0
6	6472040	.	T	G	0	2	2	0	0	2	0	0
6	6472059	.	T	A	0	1	1	0	0	1	0	0
6	6472461	.	G	A	1	1	2	0	0	2	0	0
6	6475515	.	C	T	1	3	4	0	2	6	0	0
6	6475576	.	G	T	2	3	5	0	0	5	0	0
6	6475740	.	T	A	2	2	4	0	0	4	0	0
6	6477785	.	G	A	1	1	2	0	0	2	0	0
6	6491108	.	C	T	3	2	5	0	0	5	0	0
6	6491152	.	T	C	3	3	6	0	0	6	0	0
6	6498866	.	G	A	0	0	0	0	1	1	0	0
6	6539842	.	T	G	2	0	2	0	3	5	0	0
6	6539848	.	T	A	2	3	5	0	0	5	0	0
6	6540903	.	A	G	1	2	3	0	0	3	0	0
6	6540964	.	T	A	3	2	5	0	0	5	0	0
6	6541039	.	C	T	2	4	6	0	0	6	0	0
6	6541369	.	A	G	1	0	1	0	4	5	0	0
6	6666079	.	C	T	2	3	5	0	0	5	0	0
6	6666313	.	T	C	1	2	3	0	0	3	0	0
6	6669502	.	C	G	2	2	4	0	0	4	0	0
6	6669743	.	G	A	3	4	7	0	0	7	0	0
6	6671769	.	T	A	2	2	4	0	2	6	0	0
6	6673527	.	C	A	4	9	13	0	0	13	0	0
6	6737158	.	A	C	1	3	4	0	0	4	0	0
6	6737176	.	A	G	1	3	4	0	1	5	0	0
6	6737391	.	C	T	16	18	34	0	0	34	0	0
6	6737401	.	G	T	15	13	28	0	1	29	0	0
6	6737982	.	T	A	14	21	35	0	2	37	0	0
6	6737998	.	C	T	1	19	20	0	15	35	0	0
6	6769345	.	T	A	13	5	18	0	1	19	0	0
6	6769716	.	C	T	11	6	17	0	0	17	0	0
6	6769719	.	T	C	11	5	16	0	0	16	0	0
6	6769782	.	A	G	3	3	6	0	1	7	0	0
6	6775689	.	G	T	8	4	12	0	0	12	0	0
6	6784095	.	G	A	6	4	10	0	0	10	0	0
6	6785788	.	G	A	3	4	7	0	0	7	0	0
6	6788714	.	A	G	1	0	1	0	3	4	0	0
6	6793164	.	C	T	11	9	20	0	2	22	0	0
6	6793224	.	G	A	0	4	4	0	0	4	0	0
6	6795520	.	T	A	4	7	11	0	0	11	0	0
6	6795526	.	C	T	6	4	10	0	1	11	0	0
6	6795664	.	T	C	8	8	16	0	1	17	0	0
6	6796229	.	G	A	1	3	4	0	0	4	0	0
6	6797583	.	A	G	3	8	11	0	0	11	0	0
6	6797598	.	T	C	8	3	11	0	1	12	0	0
6	6797694	.	T	A	9	5	14	0	0	14	0	0
6	6800031	.	G	T	6	2	8	0	0	8	0	0
6	6800091	.	A	G	4	2	6	0	0	6	0	0
6	6803534	.	T	A	1	3	4	0	0	4	0	0
6	6803726	.	T	A	4	4	8	0	2	10	0	0
6	6805275	.	G	A	4	6	10	0	0	10	0	0
6	6805477	.	T	C	1	4	5	0	0	5	0	0
6	6805572	.	G	T	17	10	27	0	0	27	0	0
6	6807004	.	C	T	1	2	3	0	0	3	0	0
6	6807008	.	T	C	0	2	2	0	0	2	0	0
6	6808431	.	C	G	6	5	11	0	0	11	0	0
6	6905848	.	G	A	0	2	2	0	2	4	0	0
6	6908955	.	A	G	1	0	1	0	0	1	0	0
6	6909792	.	G	A	1	2	3	0	0	3	0	0
6	6919866	.	G	T	0	11	11	0	3	14	0	0
6	6920171	.	C	T	3	3	6	0	0	6	0	0
6	6920673	.	A	T	3	7	10	0	1	11	0	0
6	6921577	.	C	T	8	16	24	0	1	25	0	0
6	6921581	.	T	C	9	14	23	0	1	24	0	0
6	6921802	.	G	A	20	24	44	1	1	46	0	0
6	6921889	.	T	A	7	16	23	0	3	26	0	0
6	6922072	.	G	T	8	9	17	0	1	18	0	0
6	6922187	.	T	C	14	8	22	0	1	23	0	0
6	6973009	.	A	T	12	9	21	0	0	21	0	0
6	6973383	.	G	T	3	5	8	0	6	14	0	0
6	7107034	.	A	G	1	1	2	0	0	2	0	0
6	7110148	.	C	T	8	7	15	0	0	15	0	0
6	7110434	.	C	T	9	10	19	0	0	19	0	0
6	7110435	.	T	G	9	10	19	0	0	19	0	0
6	7110551	.	C	T	25	11	36	0	3	39	0	0
6	7113001	.	T	G	3	4	7	0	1	8	0	0
6	7114482	.	C	T	4	4	8	0	0	8	0	0
6	7115967	.	T	C	2	0	2	0	0	2	0	0
6	7157570	.	G	A	4	3	7	0	0	7	0	0
6	7157615	.	C	T	4	5	9	0	0	9	0	0
6	7207934	.	G	A	3	3	6	0	0	6	0	0
6	7251362	.	A	T	3	2	5	0	2	7	0	0
6	7251564	.	G	A	8	3	11	0	0	11	0	0
6	7251627	.	A	G	4	2	6	0	0	6	0	0
6	7251694	.	G	A	4	2	6	0	0	6	0	0
6	7270355	.	T	C	4	2	6	0	0	6	0	0
6	7273005	.	A	G	1	0	1	0	0	1	0	0
6	7273512	.	T	A	1	0	1	0	1	2	0	0
6	7273518	.	G	A	0	0	0	0	2	2	0	0
6	7276139	.	T	C	2	4	6	0	0	6	0	0
6	7276178	.	T	A	2	7	9	0	0	9	0	0
6	7276212	.	C	T	3	13	16	0	0	16	0	0
6	7276263	.	G	A	0	10	10	0	8	18	0	0
6	7276776	.	A	C	2	4	6	0	0	6	0	0
6	7435565	.	C	T	1	2	3	0	0	3	0	0
6	7438474	.	C	T	3	6	9	0	0	9	0	0
6	7444930	.	T	C	7	11	18	0	2	20	0	0
6	7451563	.	T	G	5	9	14	0	2	16	0	0
6	7452519	.	T	C	11	8	19	0	1	20	0	0
6	7453379	.	T	G	12	0	12	1	19	32	0	0
6	7453649	.	C	G	9	9	18	0	0	18	0	0
6	7453660	.	C	T	3	8	11	0	1	12	0	0
6	7529888	.	C	T	3	2	5	0	0	5	0	0
6	7529889	.	G	T	0	2	2	0	3	5	0	0
6	7530494	.	T	A	2	2	4	0	0	4	0	0
6	7530934	.	C	G	1	0	1	0	2	3	0	0
6	7542491	.	G	T	1	2	3	0	3	6	0	0
6	7545794	.	C	T	8	6	14	0	1	15	0	0
6	7545824	.	T	C	5	11	16	0	2	18	0	0
6	7547451	.	C	T	1	4	5	0	0	5	0	0
6	7549967	.	G	A	5	7	12	0	2	14	0	0
6	7550210	.	A	C	6	6	12	0	1	13	0	0
6	7550405	.	C	T	10	10	20	0	0	20	0	0
6	7551087	.	C	A	2	6	8	0	0	8	0	0
6	7555618	.	C	T	0	2	2	0	0	2	0	0
6	7555634	.	G	T	3	1	4	0	0	4	0	0
6	7555871	.	G	A	5	5	10	0	1	11	0	0
6	7591018	.	G	A	1	2	3	0	0	3	0	0
6	7624322	.	C	T	1	2	3	0	0	3	0	0
6	7626457	.	C	T	3	1	4	0	1	5	0	0
6	7633452	.	G	C	0	6	6	0	6	12	0	0
6	7636811	.	A	T	7	6	13	0	0	13	0	0
6	7637195	.	C	T	1	6	7	0	0	7	0	0
6	7638717	.	G	A	5	10	15	0	2	17	0	0
6	7645319	.	T	C	1	1	2	0	0	2	0	0
6	7646039	.	A	G	1	3	4	0	0	4	0	0
6	7646102	.	G	A	12	15	27	0	0	27	0	0
6	7646111	.	G	C	11	15	26	0	0	26	0	0
6	7648224	.	A	G	9	0	9	0	8	17	0	0
6	7652458	.	C	T	11	11	22	0	4	26	0	0
6	7652470	.	A	C	10	11	21	0	0	21	0	0
6	7652896	.	G	A	0	23	23	0	11	34	0	0
6	7652959	.	C	T	10	12	22	0	3	25	0	0
6	7656920	.	A	G	11	0	11	0	12	23	0	0
6	7656932	.	A	G	11	21	32	0	3	35	0	0
6	7657177	.	C	T	20	10	30	0	0	30	0	0
6	7657793	.	A	C	14	16	30	0	0	30	0	0
6	7657886	.	T	A	21	10	31	0	1	32	0	0
6	7657887	.	G	T	22	10	32	0	0	32	0	0
6	7657972	.	T	G	15	8	23	0	1	24	0	0
6	7658076	.	G	A	13	14	27	0	2	29	0	0
6	7659915	.	G	A	5	2	7	0	1	8	0	0
6	7660119	.	A	G	4	11	15	0	1	16	0	0
6	7660300	.	T	C	1	0	1	0	3	4	0	0
6	7660369	.	T	C	1	3	4	0	0	4	0	0
6	7660458	.	A	C	8	0	8	0	5	13	0	0
6	7660594	.	C	T	6	4	10	0	0	10	0	0
6	7660659	.	C	A	0	3	3	0	2	5	0	0
6	7660707	.	C	T	0	4	4	0	2	6	0	0
6	7682793	.	C	A	0	0	0	0	1	1	0	0
6	7686080	.	G	A	1	2	3	0	0	3	0	0
6	7688757	.	A	C	2	0	2	0	8	10	0	0
6	7697573	.	G	A	1	2	3	0	0	3	0	0
6	7699948	.	C	T	1	0	1	0	0	1	0	0
6	7702770	.	G	T	2	2	4	0	0	4	0	0
6	7705984	.	G	A	1	4	5	0	1	6	0	0
6	7711166	.	T	C	0	2	2	0	1	3	0	0
6	7713433	.	G	A	31	14	45	0	4	49	0	0
6	7721530	.	T	A	6	7	13	0	0	13	0	0
6	7721860	.	G	A	7	6	13	0	0	13	0	0
6	7721906	.	G	A	9	17	26	0	1	27	0	0
6	7721958	.	C	A	8	16	24	1	2	27	0	0
6	7722143	.	G	T	9	10	19	0	1	20	0	0
6	7722159	.	A	T	9	9	18	0	1	19	0	0
6	7722195	.	G	T	8	7	15	0	3	18	0	0
6	7722205	.	G	A	10	7	17	0	3	20	0	0
6	7722333	.	G	A	7	6	13	0	0	13	0	0
6	7722387	.	T	C	7	6	13	0	3	16	0	0
6	7722402	.	T	C	4	12	16	0	0	16	0	0
6	7722577	.	C	T	0	9	9	0	15	24	0	0
6	7722921	.	A	T	1	4	5	0	0	5	0	0
6	7723008	.	G	T	7	7	14	0	0	14	0	0
6	7723155	.	A	C	10	9	19	0	1	20	0	0
6	7723232	.	A	T	6	4	10	0	3	13	0	0
6	7723850	.	C	T	0	3	3	0	8	11	0	0
6	7723961	.	G	A	6	8	14	0	0	14	0	0
6	7726824	.	G	A	9	13	22	0	1	23	0	0
6	7734250	.	A	C	2	2	4	0	1	5	0	0
6	7734271	.	C	A	0	1	1	0	0	1	0	0
6	7795698	.	C	T	13	11	24	0	7	31	0	0
6	7842013	.	C	T	0	4	4	0	4	8	0	0
6	7842034	.	C	A	5	5	10	0	0	10	0	0
6	8176101	.	A	G	8	6	14	0	0	14	0	0
6	8176575	.	C	T	9	7	16	0	0	16	0	0
6	8177030	.	T	C	14	11	25	0	0	25	0	0
6	8177399	.	T	C	6	13	19	0	2	21	0	0
6	8177600	.	T	C	10	11	21	0	1	22	0	0
6	8177678	.	C	T	11	12	23	0	0	23	0	0
6	8178002	.	T	C	7	19	26	0	1	27	0	0
6	8178053	.	G	A	0	7	7	0	18	25	0	0
6	8178113	.	T	C	18	7	25	0	1	26	0	0
6	8178351	.	G	A	7	9	16	0	2	18	0	0
6	8179022	.	G	T	0	14	14	0	19	33	0	0
6	8179205	.	A	T	21	16	37	0	2	39	0	0
6	8179373	.	G	A	18	13	31	0	1	32	0	0
6	8179683	.	A	T	4	7	11	0	1	12	0	0
6	8211075	.	C	T	3	5	8	0	1	9	0	0
6	8211106	.	T	C	3	4	7	0	0	7	0	0
6	8211253	.	G	A	1	5	6	0	0	6	0	0
6	8214118	.	T	C	4	2	6	0	0	6	0	0
6	8265214	.	G	A	7	2	9	0	0	9	0	0
6	8265282	.	G	A	4	5	9	0	0	9	0	0
6	8267111	.	C	T	14	15	29	0	1	30	0	0
6	8267266	.	A	G	14	20	34	0	0	34	0	0
6	8267284	.	G	A	10	17	27	0	0	27	0	0
6	8267307	.	G	C	9	14	23	0	0	23	0	0
6	8267352	.	A	T	9	18	27	0	1	28	0	0
6	8267519	.	G	A	20	18	38	0	3	41	0	0
6	8267563	.	G	T	19	24	43	0	0	43	0	0
6	8267635	.	T	C	13	20	33	0	2	35	0	0
6	8267795	.	T	A	8	4	12	0	0	12	0	0
6	8267880	.	G	A	8	6	14	0	2	16	0	0
6	8268529	.	A	G	12	6	18	0	1	19	0	0
6	8273066	.	G	A	0	1	1	0	0	1	0	0
6	8277141	.	C	A	0	1	1	0	0	1	0	0
6	8282275	.	A	G	1	1	2	0	0	2	0	0
6	8310840	.	C	T	2	2	4	0	0	4	0	0
6	8315076	.	A	G	7	5	12	0	0	12	0	0
6	8315078	.	A	G	7	5	12	0	0	12	0	0
6	8318001	.	T	C	5	5	10	0	0	10	0	0
6	8318037	.	G	A	0	8	8	0	11	19	0	0
6	8328181	.	G	T	5	13	18	0	2	20	0	0
6	8366006	.	A	T	9	7	16	0	2	18	0	0
6	8366167	.	C	T	12	9	21	0	3	24	0	0
6	8370489	.	T	C	2	8	10	0	0	10	0	0
6	8374716	.	G	A	4	5	9	0	1	10	0	0
6	8375089	.	C	T	10	11	21	0	1	22	0	0
6	8380345	.	G	A	2	2	4	0	0	4	0	0
6	8380433	.	G	C	2	2	4	0	1	5	0	0
6	8380485	.	G	T	2	2	4	0	0	4	0	0
6	8392005	.	G	A	0	3	3	0	0	3	0	0
6	8453550	.	A	G	3	2	5	0	0	5	0	0
6	8454024	.	G	A	3	2	5	0	0	5	0	0
6	8460793	.	T	C	1	1	2	0	0	2	0	0
6	8460808	.	A	T	1	1	2	0	0	2	0	0
6	9130510	.	A	G	1	4	5	0	0	5	0	0
6	9130575	.	A	G	4	12	16	0	0	16	0	0
6	9860829	.	A	G	6	2	8	0	0	8	0	0
6	10000929	.	G	C	1	1	2	0	3	5	0	0
6	10000936	.	A	C	1	3	4	0	1	5	0	0
6	10008329	.	G	A	0	10	10	0	18	28	0	0
6	10008398	.	A	G	19	12	31	0	3	34	0	0
6	10008407	.	C	T	19	9	28	0	2	30	0	0
6	10009850	.	C	T	15	15	30	0	1	31	0	0
6	10009903	.	A	T	17	12	29	0	0	29	0	0
6	10015551	.	T	C	3	6	9	0	1	10	0	0
6	10015602	.	T	C	28	15	43	0	2	45	0	0
6	10015794	.	A	T	29	21	50	1	7	58	0	0
6	10015902	.	A	T	26	32	58	0	3	61	0	0
6	10015952	.	C	A	19	36	55	0	2	57	0	0
6	10015992	.	A	C	28	30	58	0	1	59	0	0
6	10015993	.	G	A	26	29	55	0	4	59	0	0
6	10016114	.	C	T	27	28	55	0	2	57	0	0
6	10016116	.	C	A	27	25	52	0	5	57	0	0
6	10016174	.	T	G	28	12	40	0	6	46	0	0
6	10016363	.	T	G	29	21	50	1	4	62	7	0
6	10020055	.	G	A	22	22	44	0	2	46	0	0
6	10026677	.	C	T	11	10	21	0	1	22	0	0
6	10026818	.	G	A	6	5	11	0	2	13	0	0
6	10045449	.	G	T	4	3	7	0	0	7	0	0
6	10047204	.	T	C	4	16	20	0	1	22	1	0
6	10047805	.	G	A	2	6	8	0	0	8	0	0
6	10047814	.	T	C	1	3	4	0	0	4	0	0
6	10050050	.	G	A	16	16	32	0	1	33	0	0
6	10056466	.	G	T	9	19	28	0	4	32	0	0
6	10087986	.	A	C	1	2	3	0	0	3	0	0
6	10087995	.	G	A	1	2	3	0	0	3	0	0
6	10248476	.	T	A	10	12	22	0	1	23	0	0
6	10248530	.	A	G	5	12	17	0	2	19	0	0
6	10248546	.	T	C	7	0	7	0	13	20	0	0
6	10248596	.	T	C	11	16	27	0	1	28	0	0
6	10248980	.	A	G	10	7	17	0	1	18	0	0
6	10249451	.	A	G	4	9	13	0	0	14	1	0
6	10251188	.	C	A	10	5	15	0	0	15	0	0
6	10264656	.	T	C	2	1	3	0	0	3	0	0
6	10283462	.	A	G	2	4	6	0	0	6	0	0
6	10288771	.	G	A	1	2	3	0	0	3	0	0
6	10288855	.	A	G	0	2	2	0	0	2	0	0
6	10305813	.	T	G	4	2	6	0	0	6	0	0
6	10305922	.	G	A	0	2	2	0	0	2	0	0
6	10342632	.	G	A	0	1	1	0	2	3	0	0
6	10342653	.	C	T	1	2	3	0	0	3	0	0
6	10342668	.	T	C	1	2	3	0	0	3	0	0
6	10354469	.	T	C	1	1	2	0	1	3	0	0
6	10512903	.	C	G	2	2	4	0	0	4	0	0
6	10513182	.	C	G	0	4	4	0	0	4	0	0
6	10522332	.	C	T	6	3	9	0	0	9	0	0
6	10540138	.	C	T	0	2	2	0	0	2	0	0
6	10547409	.	C	T	3	5	8	0	0	8	0	0
6	10547502	.	T	G	1	0	1	0	3	4	0	0
6	10547556	.	T	C	0	3	3	0	0	3	0	0
6	10564408	.	C	T	2	0	2	0	0	2	0	0
6	10564426	.	T	C	2	0	2	0	1	3	0	0
6	10567861	.	C	T	4	3	7	0	0	7	0	0
6	10570843	.	C	T	1	0	1	0	0	1	0	0
6	10576573	.	A	G	4	0	4	0	5	9	0	0
6	10702203	.	T	C	2	0	2	0	2	4	0	0
6	10702244	.	T	C	4	0	4	0	4	8	0	0
6	10702269	.	T	A	1	4	5	0	1	6	0	0
6	10705814	.	C	T	0	3	3	0	1	4	0	0
6	10705815	.	G	T	1	3	4	0	0	4	0	0
6	10709686	.	T	C	0	0	0	0	1	1	0	0
6	10709697	.	A	G	0	0	0	0	1	1	0	0
6	10713784	.	G	A	0	0	0	0	1	1	0	0
6	10713810	.	G	T	1	3	4	0	0	4	0	0
6	10721767	.	C	T	10	0	10	0	0	10	0	0
6	10721971	.	T	G	6	7	13	0	2	15	0	0
6	10722541	.	G	A	2	1	3	0	0	3	0	0
6	10724275	.	G	A	4	3	7	0	0	7	0	0
6	10724336	.	C	T	0	7	7	0	6	13	0	0
6	10724591	.	G	T	12	5	17	0	3	20	0	0
6	10724645	.	A	T	7	9	16	0	0	16	0	0
6	10724665	.	G	A	8	4	12	0	0	12	0	0
6	10724765	.	G	A	7	8	15	0	0	15	0	0
6	10736798	.	T	A	1	2	3	0	0	3	0	0
6	10736978	.	G	C	1	1	2	0	0	2	0	0
6	10737000	.	C	A	0	1	1	0	1	2	0	0
6	10741616	.	A	G	1	3	4	0	1	5	0	0
6	10741853	.	T	G	2	2	4	0	0	4	0	0
6	10741916	.	G	C	10	10	20	0	1	21	0	0
6	10742120	.	T	C	12	15	27	0	1	28	0	0
6	10742121	.	G	A	11	16	27	0	1	28	0	0
6	10742306	.	A	G	16	17	33	0	1	34	0	0
6	10742318	.	G	A	14	13	27	0	1	28	0	0
6	10742497	.	T	C	6	0	6	0	10	16	0	0
6	10758866	.	A	T	4	2	6	0	0	6	0	0
6	10758890	.	A	C	3	0	3	0	4	7	0	0
6	10763899	.	A	T	1	4	5	0	0	5	0	0
6	10763977	.	A	G	2	3	5	0	0	5	0	0
6	10764001	.	A	G	4	4	8	0	0	8	0	0
6	10831093	.	G	A	28	23	51	0	1	52	0	0
6	10833078	.	T	C	14	1	15	0	25	40	0	0
6	10834821	.	G	C	3	6	9	0	0	9	0	0
6	10835676	.	G	A	4	2	6	0	2	8	0	0
6	10835700	.	T	A	4	4	8	0	0	8	0	0
6	10835721	.	A	G	4	3	7	0	0	7	0	0
6	10835788	.	G	A	3	3	6	0	1	7	0	0
6	10838690	.	C	T	0	2	2	0	1	3	0	0
6	10838716	.	A	C	2	4	6	0	1	7	0	0
6	10838741	.	G	A	1	3	4	0	0	4	0	0
6	10838753	.	T	C	3	3	6	0	0	6	0	0
6	10839332	.	A	G	1	3	4	0	1	5	0	0
6	10839370	.	A	C	1	2	3	0	0	3	0	0
6	10839829	.	T	G	10	5	15	0	0	15	0	0
6	10839832	.	C	T	0	5	5	0	10	15	0	0
6	10839885	.	C	A	0	11	11	0	8	19	0	0
6	10846001	.	G	A	0	1	1	0	0	1	0	0
6	10859011	.	G	A	4	3	7	0	0	7	0	0
6	10863530	.	G	A	1	1	2	0	0	2	0	0
6	10863561	.	G	C	0	0	0	0	1	1	0	0
6	10877269	.	A	G	0	1	1	0	0	1	0	0
6	10879525	.	T	C	6	4	10	0	0	10	0	0
6	10879633	.	T	C	10	17	27	0	2	29	0	0
6	10879679	.	G	A	6	21	27	0	0	27	0	0
6	10879816	.	A	T	4	13	17	0	0	17	0	0
6	10879833	.	A	G	5	2	7	0	15	22	0	0
6	10910684	.	G	A	6	7	13	0	0	13	0	0
6	10910784	.	C	A	19	9	28	0	3	31	0	0
6	10911066	.	T	C	28	20	48	0	2	50	0	0
6	10911198	.	A	G	14	21	35	0	0	35	0	0
6	10912341	.	G	A	17	20	37	0	0	37	0	0
6	10982902	.	A	G	2	2	4	0	1	5	0	0
6	11071222	.	A	G	22	26	48	0	3	51	0	0
6	11101781	.	T	C	6	7	13	0	0	13	0	0
6	11101790	.	C	T	0	7	7	0	6	13	0	0
6	11101852	.	G	A	5	4	9	0	0	9	0	0
6	11106924	.	C	G	2	2	4	0	0	4	0	0
6	11107167	.	G	C	3	0	3	0	7	10	0	0
6	11107233	.	C	A	4	2	6	0	0	6	0	0
6	11107326	.	T	C	2	0	2	0	2	4	0	0
6	11113091	.	A	G	1	0	1	0	0	1	0	0
6	11122754	.	G	A	1	1	2	0	0	2	0	0
6	11129105	.	C	T	1	2	3	0	0	3	0	0
6	11129282	.	C	T	0	3	3	0	0	3	0	0
6	11250309	.	A	C	1	2	3	0	0	3	0	0
6	11250427	.	A	T	7	3	10	0	0	10	0	0
6	11250462	.	C	T	5	3	8	0	0	8	0	0
6	11253881	.	T	C	0	1	1	0	0	1	0	0
6	11253890	.	C	T	1	1	2	0	0	2	0	0
6	11254142	.	T	G	7	1	8	0	7	15	0	0
6	11254358	.	A	G	4	0	4	0	4	8	0	0
6	11254526	.	C	T	3	7	10	0	1	11	0	0
6	11257827	.	G	A	0	9	9	0	11	20	0	0
6	11257866	.	G	C	0	14	14	0	7	21	0	0
6	11257917	.	T	A	12	10	22	0	1	23	0	0
6	11259970	.	C	A	17	11	28	0	1	29	0	0
6	11265612	.	G	T	1	11	12	0	15	27	0	0
6	11265681	.	T	A	16	12	28	0	1	29	0	0
6	11265717	.	T	C	24	10	34	0	0	34	0	0
6	11266104	.	A	G	6	18	24	0	2	26	0	0
6	11266111	.	A	G	14	0	14	0	14	28	0	0
6	11266255	.	C	T	10	18	28	0	2	30	0	0
6	11266490	.	A	T	6	3	9	0	0	9	0	0
6	11266496	.	T	C	5	3	8	0	0	8	0	0
6	11276912	.	A	G	0	1	1	0	0	1	0	0
6	11281923	.	A	G	1	3	4	0	0	4	0	0
6	11282371	.	A	T	0	1	1	0	0	1	0	0
6	11285362	.	T	C	4	0	4	0	3	7	0	0
6	11285374	.	C	T	3	4	7	0	0	7	0	0
6	11285453	.	T	C	6	2	8	0	1	9	0	0
6	11285583	.	C	T	9	5	14	0	1	15	0	0
6	11285662	.	C	T	0	4	4	0	4	8	0	0
6	11285716	.	G	A	3	5	8	0	0	8	0	0
6	11285772	.	C	T	2	5	7	0	1	8	0	0
6	11287918	.	C	G	0	1	1	0	0	1	0	0
6	11288179	.	T	A	2	3	5	0	0	5	0	0
6	11288460	.	G	T	1	0	1	0	1	2	0	0
6	11288558	.	T	C	2	0	2	0	4	6	0	0
6	11295376	.	G	C	2	0	2	0	2	4	0	0
6	11295430	.	G	T	2	2	4	0	0	4	0	0
6	11298557	.	G	A	1	0	1	0	0	1	0	0
6	11334517	.	T	A	2	2	4	0	0	4	0	0
6	11334951	.	C	A	0	3	3	0	0	3	0	0
6	11348510	.	C	T	1	1	2	0	1	3	0	0
6	11397818	.	G	C	0	1	1	0	0	1	0	0
6	11403359	.	C	A	0	2	2	0	0	2	0	0
6	11407918	.	G	A	1	1	2	0	0	2	0	0
6	11407944	.	A	G	1	1	2	0	0	2	0	0
6	11407954	.	A	G	1	1	2	0	0	2	0	0
6	11410523	.	C	T	5	2	7	0	0	7	0	0
6	11414715	.	C	T	9	3	12	0	1	13	0	0
6	11414748	.	G	A	7	11	18	0	1	19	0	0
6	11414777	.	A	T	6	8	14	0	0	14	0	0
6	11414822	.	T	G	7	0	7	0	7	14	0	0
6	11415220	.	A	C	18	13	31	0	0	31	0	0
6	11415460	.	G	A	1	8	9	0	9	18	0	0
6	11765364	.	A	G	24	17	41	0	0	41	0	0
6	11765506	.	A	G	28	22	50	0	0	50	0	0
6	11765913	.	G	A	21	21	42	0	1	43	0	0
6	11766267	.	G	A	17	19	36	0	0	36	0	0
6	11766276	.	A	G	19	21	40	0	1	41	0	0
6	11766765	.	T	C	4	3	7	0	0	7	0	0
6	11767623	.	T	C	5	2	7	0	0	7	0	0
6	11768196	.	G	C	0	2	2	0	0	2	0	0
6	11771118	.	G	A	4	8	12	0	1	13	0	0
6	11773266	.	C	T	24	22	46	0	0	46	0	0
6	11779940	.	C	A	7	23	30	0	0	30	0	0
6	11780001	.	A	C	6	9	15	0	0	15	0	0
6	11780004	.	A	T	6	7	13	0	1	14	0	0
6	11781567	.	A	C	3	0	3	0	5	8	0	0
6	11791106	.	T	C	3	0	3	0	5	8	0	0
6	11791225	.	T	C	3	0	3	0	7	10	0	0
6	11791258	.	G	A	5	5	10	0	1	11	0	0
6	11791371	.	A	G	3	7	10	0	0	10	0	0
6	11791572	.	A	G	5	6	11	0	0	11	0	0
6	11791644	.	A	G	9	3	12	0	0	12	0	0
6	11791646	.	T	C	9	2	11	0	1	12	0	0
6	11791686	.	A	C	6	0	6	0	3	9	0	0
6	11791770	.	G	A	7	7	14	0	0	14	0	0
6	11791806	.	T	G	7	8	15	0	1	16	0	0
6	11791947	.	A	G	13	10	23	0	1	24	0	0
6	11796238	.	A	T	2	3	5	0	0	5	0	0
6	11816438	.	T	C	3	0	3	0	2	5	0	0
6	11816451	.	G	A	3	3	6	0	0	6	0	0
6	11816779	.	C	T	3	3	6	0	0	6	0	0
6	11816784	.	A	T	3	3	6	0	0	6	0	0
6	11817185	.	C	T	7	3	10	0	1	11	0	0
6	11817192	.	A	G	7	3	10	0	0	10	0	0
6	11817278	.	A	T	3	5	8	0	1	9	0	0
6	11817482	.	C	T	0	2	2	0	6	8	0	0
6	11820185	.	A	T	2	2	4	0	0	4	0	0
6	11943997	.	G	A	0	4	4	0	3	7	0	0
6	11944003	.	T	G	2	3	5	0	1	6	0	0
6	11944146	.	G	C	6	5	11	0	1	13	1	0
6	11950504	.	A	C	2	6	8	0	0	8	0	0
6	11950543	.	T	A	2	4	6	0	0	6	0	0
6	11950582	.	C	A	5	6	11	0	0	11	0	0
6	11950583	.	A	G	4	6	10	0	1	11	0	0
6	11952477	.	A	C	2	4	6	0	0	6	0	0
6	11960667	.	C	T	3	6	9	0	2	11	0	0
6	11975763	.	G	A	0	1	1	0	0	1	0	0
6	11976566	.	A	T	3	2	5	0	1	6	0	0
6	11976614	.	A	G	2	4	6	0	0	6	0	0
6	11976617	.	G	A	0	5	5	0	2	7	0	0
6	11978862	.	G	C	2	2	4	0	0	4	0	0
6	11978886	.	T	G	3	2	5	0	0	5	0	0
6	11981831	.	C	G	4	0	4	0	12	16	0	0
6	11982213	.	A	C	11	11	22	0	1	23	0	0
6	11982319	.	A	T	2	7	9	0	0	9	0	0
6	11986615	.	C	T	1	6	7	0	0	7	0	0
6	11986656	.	C	G	4	4	8	0	0	8	0	0
6	11994733	.	C	T	7	11	18	0	0	18	0	0
6	11994790	.	T	C	3	3	6	0	0	6	0	0
6	12001212	.	T	C	14	16	30	0	1	31	0	0
6	12002933	.	C	T	3	6	9	0	0	9	0	0
6	12006823	.	G	A	8	5	13	0	0	13	0	0
6	12006904	.	C	T	3	3	6	0	0	6	0	0
6	12006923	.	T	C	2	1	3	0	0	3	0	0
6	12016450	.	G	A	7	3	10	0	3	13	0	0
6	12036984	.	C	T	5	16	21	0	3	24	0	0
6	12037141	.	G	A	12	9	21	0	1	22	0	0
6	12037196	.	C	T	16	8	24	0	1	25	0	0
6	12037197	.	T	G	14	7	21	0	4	25	0	0
6	12037293	.	G	T	11	8	19	0	0	19	0	0
6	12037401	.	G	A	8	6	14	0	0	14	0	0
6	12044204	.	C	T	2	3	5	0	0	5	0	0
6	12044225	.	A	G	2	1	3	0	0	3	0	0
6	12052869	.	T	C	8	8	16	0	0	16	0	0
6	12053036	.	A	T	4	3	7	0	1	8	0	0
6	12053093	.	G	C	6	1	7	0	0	7	0	0
6	12059524	.	T	C	2	0	2	0	2	4	0	0
6	12073008	.	T	C	9	7	16	0	1	17	0	0
6	12089953	.	G	A	3	4	7	0	0	7	0	0
6	12199902	.	C	T	2	3	5	0	0	5	0	0
6	12200472	.	G	T	12	14	26	0	0	26	0	0
6	12200654	.	T	A	5	2	7	0	1	8	0	0
6	12200808	.	T	A	5	6	11	0	0	11	0	0
6	12200972	.	G	T	13	9	22	0	0	23	1	0
6	12201030	.	G	A	13	15	28	0	1	29	0	0
6	12201132	.	G	A	7	20	27	0	0	27	0	0
6	12212817	.	C	T	0	10	10	0	16	26	0	0
6	12213162	.	A	G	1	1	2	0	0	2	0	0
6	12214149	.	T	C	7	10	17	0	1	18	0	0
6	12217851	.	A	G	2	3	5	0	1	6	0	0
6	12220638	.	A	G	8	7	15	0	0	15	0	0
6	12224262	.	T	A	6	7	13	0	1	14	0	0
6	12224325	.	G	C	3	2	5	0	1	6	0	0
6	12275783	.	C	T	0	2	2	0	2	4	0	0
6	12299421	.	A	G	31	14	45	0	3	48	0	0
6	12299422	.	T	C	30	15	45	0	3	48	0	0
6	12299751	.	A	G	18	37	55	0	3	58	0	0
6	12303882	.	A	G	1	4	5	0	0	5	0	0
6	12303897	.	A	G	3	5	8	0	0	8	0	0
6	12313925	.	A	T	4	4	8	0	0	8	0	0
6	12428619	.	G	A	1	2	3	0	0	3	0	0
6	12428631	.	G	T	1	2	3	0	0	3	0	0
6	12466172	.	T	C	4	4	8	0	0	8	0	0
6	12504230	.	T	C	4	4	8	0	0	8	0	0
6	12504362	.	C	T	5	6	11	0	0	11	0	0
6	12504392	.	G	C	3	3	6	0	0	6	0	0
6	12516517	.	T	C	4	4	8	0	1	9	0	0
6	12595255	.	T	C	6	3	9	0	0	9	0	0
6	12595340	.	C	G	4	5	9	0	0	9	0	0
6	12595518	.	A	G	2	7	9	0	0	9	0	0
6	12600430	.	A	T	2	2	4	0	0	4	0	0
6	12606904	.	C	A	6	2	8	0	1	9	0	0
6	12617334	.	G	A	0	1	1	0	0	1	0	0
6	12620093	.	T	A	0	2	2	0	1	3	0	0
6	12797677	.	C	T	7	8	15	0	0	15	0	0
6	12797755	.	G	A	7	9	16	0	0	16	0	0
6	12797815	.	A	G	14	9	23	0	0	23	0	0
6	12798083	.	G	T	7	3	10	0	0	10	0	0
6	12798124	.	T	C	5	3	8	0	0	8	0	0
6	12798345	.	T	C	3	2	5	0	0	5	0	0
6	12803257	.	C	A	1	2	3	0	1	4	0	0
6	12803325	.	A	G	1	2	3	0	0	3	0	0
6	12804024	.	A	T	4	9	13	0	0	13	0	0
6	12804132	.	G	A	4	3	7	0	0	7	0	0
6	12810249	.	C	G	0	3	3	0	7	10	0	0
6	12853748	.	G	A	8	10	18	0	0	18	0	0
6	13869343	.	A	C	0	11	11	0	3	14	0	0
6	14950538	.	T	A	3	6	9	0	0	9	0	0
6	14950567	.	T	C	2	7	9	0	0	9	0	0
6	14950759	.	T	C	6	11	17	0	0	17	0	0
6	14951854	.	C	T	10	8	18	0	2	20	0	0
6	14952579	.	T	C	10	8	18	0	1	19	0	0
6	15023688	.	G	A	2	7	9	0	2	11	0	0
6	15023713	.	A	G	2	1	3	0	1	4	0	0
6	15037025	.	A	G	4	3	7	0	0	7	0	0
6	15037258	.	A	G	0	2	2	0	0	2	0	0
6	15043636	.	T	A	2	4	6	0	0	6	0	0
6	15044577	.	A	G	0	1	1	0	0	1	0	0
6	15051753	.	G	A	1	1	2	0	0	2	0	0
6	15051782	.	T	C	2	3	5	0	0	5	0	0
6	15059283	.	T	C	1	2	3	0	0	3	0	0
6	15062132	.	C	T	1	2	3	0	0	3	0	0
6	15062264	.	T	C	1	2	3	0	0	3	0	0
6	15127591	.	G	A	0	3	3	0	2	5	0	0
6	15130982	.	G	A	0	2	2	0	3	5	0	0
6	15131047	.	G	A	1	2	3	0	0	3	0	0
6	15236344	.	G	A	0	2	2	0	0	2	0	0
6	15242641	.	C	T	4	7	11	0	0	11	0	0
6	15426024	.	G	C	0	2	2	0	2	4	0	0
6	15434544	.	T	A	5	13	18	0	1	19	0	0
6	15447086	.	C	T	2	2	4	0	0	4	0	0
6	15447143	.	T	C	3	3	6	0	0	6	0	0
6	15447165	.	A	G	1	0	1	0	3	4	0	0
6	15447305	.	G	A	1	3	4	0	0	4	0	0
6	15455804	.	C	A	0	2	2	0	3	5	0	0
6	15470261	.	A	G	0	2	2	0	0	2	0	0
6	15470271	.	T	A	1	2	3	0	0	3	0	0
6	15527202	.	T	C	3	3	6	0	0	6	0	0
6	15527356	.	T	C	4	5	9	0	1	10	0	0
6	15531697	.	G	A	3	2	5	0	0	5	0	0
6	15538138	.	G	A	3	1	4	0	0	4	0	0
6	15543412	.	C	A	0	3	3	0	0	3	0	0
6	15603784	.	G	A	5	3	8	0	0	8	0	0
6	15603866	.	T	C	2	5	7	0	1	8	0	0
6	15604071	.	G	A	4	3	7	0	0	7	0	0
6	15604079	.	A	G	5	5	10	0	0	10	0	0
6	15604142	.	A	G	4	4	8	0	0	8	0	0
6	15752348	.	A	G	6	7	13	0	0	13	0	0
6	15752417	.	A	C	6	4	10	0	0	10	0	0
6	15752641	.	C	T	1	2	3	0	0	3	0	0
6	15824597	.	T	A	0	2	2	0	0	2	0	0
6	16033239	.	A	G	2	4	6	0	0	6	0	0
6	16043999	.	T	C	17	15	32	0	1	33	0	0
6	16044282	.	A	G	13	11	24	0	4	28	0	0
6	16044664	.	T	C	16	8	24	0	1	25	0	0
6	16045046	.	G	C	4	4	8	0	1	9	0	0
6	16045511	.	G	A	10	8	18	0	0	18	0	0
6	16045516	.	G	C	11	6	17	0	0	17	0	0
6	16045650	.	G	A	7	8	15	0	0	15	0	0
6	16045798	.	T	C	8	6	14	0	3	17	0	0
6	16045900	.	T	C	13	6	19	0	3	22	0	0
6	16045912	.	T	C	5	0	5	0	20	25	0	0
6	16046025	.	T	A	17	14	31	0	2	33	0	0
6	16046547	.	A	T	7	8	15	0	0	18	3	0
6	16046554	.	G	C	6	11	17	0	1	18	0	0
6	16046664	.	A	G	3	8	11	0	0	11	0	0
6	16046761	.	A	C	5	6	11	0	0	11	0	0
6	16046934	.	A	C	9	12	21	0	2	23	0	0
6	16047197	.	C	T	1	17	18	0	9	27	0	0
6	16084168	.	T	C	3	0	3	0	0	3	0	0
6	16104463	.	T	C	6	7	13	0	1	14	0	0
6	16129824	.	G	T	0	1	1	0	0	1	0	0
6	16194568	.	G	A	1	0	1	0	1	2	0	0
6	16196326	.	G	A	0	2	2	0	0	2	0	0
6	16393570	.	G	T	6	4	10	0	0	10	0	0
6	16474381	.	T	C	4	14	18	0	0	18	0	0
6	16475185	.	C	T	7	7	14	0	0	14	0	0
6	16475269	.	C	G	8	6	14	0	0	14	0	0
6	16475468	.	G	A	0	10	10	0	9	19	0	0
6	16485073	.	A	T	3	6	9	0	0	9	0	0
6	16491056	.	G	A	11	11	22	0	0	22	0	0
6	16493415	.	T	C	19	14	33	0	2	35	0	0
6	16499206	.	G	A	8	7	15	0	0	15	0	0
6	16499311	.	C	T	10	4	14	0	0	14	0	0
6	16499312	.	A	G	9	4	13	0	1	14	0	0
6	16499422	.	A	G	6	11	17	0	0	17	0	0
6	16499428	.	G	A	6	11	17	0	0	17	0	0
6	16499473	.	G	C	7	5	12	0	0	12	0	0
6	16509980	.	G	A	8	10	18	0	3	21	0	0
6	16521166	.	C	A	2	7	9	0	0	9	0	0
6	16523647	.	A	G	1	0	1	0	0	1	0	0
6	16523662	.	C	T	0	1	1	0	2	3	0	0
6	16524468	.	G	T	3	3	6	0	0	6	0	0
6	16524653	.	G	A	4	2	6	0	0	6	0	0
6	16524663	.	T	C	4	2	6	0	0	6	0	0
6	16535731	.	G	C	1	8	9	0	0	9	0	0
6	16544879	.	G	A	4	1	5	0	0	5	0	0
6	16551826	.	G	A	1	2	3	0	0	3	0	0
6	16552235	.	T	G	2	4	6	0	0	6	0	0
6	16683421	.	A	G	6	5	11	0	1	12	0	0
6	16689083	.	G	A	0	0	0	0	1	1	0	0
6	16699616	.	G	A	3	1	4	0	0	4	0	0
6	16699626	.	C	G	1	3	4	0	0	4	0	0
6	16704876	.	G	A	2	1	3	0	0	3	0	0
6	16717184	.	C	G	0	1	1	0	0	1	0	0
6	16717795	.	A	C	6	3	9	0	0	9	0	0
6	16717807	.	C	A	0	3	3	0	6	9	0	0
6	17726078	.	G	A	2	3	5	0	1	6	0	0
6	17727452	.	A	G	2	5	7	0	1	8	0	0
6	17837240	.	A	T	2	2	4	0	0	4	0	0
6	18077210	.	G	A	0	2	2	0	0	2	0	0
6	18203782	.	C	A	22	11	33	0	1	34	0	0
6	18203812	.	C	A	0	10	10	0	17	27	0	0
6	18203974	.	A	T	1	7	8	0	1	9	0	0
6	18204420	.	A	G	9	12	21	0	0	21	0	0
6	18226653	.	T	G	5	2	7	0	2	9	0	0
6	18244987	.	C	T	3	2	5	0	0	5	0	0
6	18274076	.	G	A	0	1	1	0	0	1	0	0
6	18359376	.	C	T	4	5	9	0	0	9	0	0
6	18359389	.	G	A	4	4	8	0	3	11	0	0
6	18361444	.	C	G	10	11	21	0	1	22	0	0
6	18361729	.	G	C	4	5	9	0	1	10	0	0
6	18364090	.	T	C	5	2	7	0	1	8	0	0
6	18364543	.	A	T	4	3	7	0	0	7	0	0
6	18381278	.	G	A	0	5	5	0	3	8	0	0
6	18388835	.	C	A	4	3	7	0	0	7	0	0
6	18388975	.	G	A	6	8	14	0	0	14	0	0
6	18389324	.	T	C	10	1	11	0	9	20	0	0
6	18389655	.	G	A	5	7	12	0	1	13	0	0
6	18390031	.	T	A	1	1	2	0	0	2	0	0
6	18418714	.	T	G	2	2	4	0	1	5	0	0
6	18418861	.	C	A	1	1	2	0	0	2	0	0
6	18436500	.	C	T	1	1	2	0	0	2	0	0
6	18436880	.	C	A	2	2	4	0	0	4	0	0
6	18436966	.	G	A	5	5	10	0	1	11	0	0
6	18436969	.	T	C	5	4	9	0	1	10	0	0
6	18437514	.	T	G	8	1	9	0	6	15	0	0
6	18438459	.	A	G	0	1	1	0	0	1	0	0
6	18439222	.	C	T	8	8	16	0	0	16	0	0
6	18439481	.	A	T	4	4	8	0	0	8	0	0
6	18439540	.	G	A	9	4	13	0	1	14	0	0
6	18439576	.	A	G	5	9	14	0	1	15	0	0
6	18439683	.	C	T	2	2	4	0	0	4	0	0
6	18439774	.	G	A	0	8	8	0	5	13	0	0
6	18524466	.	G	A	1	1	2	0	0	2	0	0
6	18526754	.	G	T	1	0	1	0	0	1	0	0
6	18529457	.	G	A	1	1	2	0	0	2	0	0
6	18536748	.	C	T	0	0	0	0	1	1	0	0
6	18540815	.	G	T	0	3	3	0	0	3	0	0
6	18540911	.	T	C	12	9	21	0	0	21	0	0
6	18540932	.	C	T	16	12	28	0	0	28	0	0
6	18541159	.	A	T	1	3	4	0	0	4	0	0
6	18542933	.	T	C	3	5	8	0	0	8	0	0
6	18543253	.	G	A	0	3	3	0	4	7	0	0
6	18543385	.	C	T	5	12	17	0	1	18	0	0
6	18543735	.	A	G	1	8	9	0	1	10	0	0
6	18544301	.	T	A	9	5	14	0	2	16	0	0
6	18554192	.	G	C	4	3	7	0	1	8	0	0
6	18554208	.	G	A	6	3	9	0	0	9	0	0
6	18554580	.	C	T	2	3	5	0	0	5	0	0
6	18554702	.	C	G	2	4	6	0	0	6	0	0
6	18554836	.	T	G	3	2	5	0	0	5	0	0
6	18585091	.	G	A	2	1	3	0	1	4	0	0
6	18585103	.	C	T	1	1	2	0	0	2	0	0
6	18588570	.	G	A	1	1	2	0	0	2	0	0
6	18589067	.	C	T	6	1	7	0	0	7	0	0
6	18589090	.	T	C	3	8	11	0	0	11	0	0
6	18592209	.	G	A	3	3	6	0	0	6	0	0
6	18594539	.	A	C	3	2	5	0	0	5	0	0
6	18595059	.	G	A	2	2	4	0	0	4	0	0
6	18595391	.	C	A	2	3	5	0	0	5	0	0
6	18600358	.	T	C	1	2	3	0	0	3	0	0
6	18606135	.	T	G	7	9	16	0	0	16	0	0
6	18606230	.	G	T	10	11	21	0	0	21	0	0
6	18607151	.	G	A	12	8	20	0	0	20	0	0
6	18607557	.	C	T	10	10	20	0	1	21	0	0
6	18607590	.	G	A	15	13	28	0	0	28	0	0
6	18612230	.	C	T	0	1	1	0	0	1	0	0
6	18617255	.	A	T	10	3	13	0	0	13	0	0
6	18618051	.	C	T	7	9	16	0	0	16	0	0
6	18623673	.	C	G	5	2	7	0	0	7	0	0
6	18624162	.	T	A	1	5	6	0	1	7	0	0
6	18624371	.	A	G	4	5	9	0	0	9	0	0
6	18624426	.	C	T	4	11	15	0	1	16	0	0
6	18624464	.	T	A	7	10	17	0	1	18	0	0
6	18625021	.	G	A	14	8	22	0	0	22	0	0
6	18625062	.	G	A	13	8	21	0	0	21	0	0
6	18654314	.	T	A	5	4	9	0	2	11	0	0
6	18659298	.	G	A	4	3	7	0	0	7	0	0
6	18663450	.	C	A	4	5	9	0	0	9	0	0
6	18697796	.	T	C	3	0	3	0	7	10	0	0
6	18714358	.	A	G	4	2	6	0	0	6	0	0
6	18714592	.	T	G	3	4	7	0	1	8	0	0
6	18714845	.	A	C	4	4	8	0	2	10	0	0
6	18714890	.	T	A	7	3	10	0	0	10	0	0
6	18714910	.	T	C	2	5	7	0	1	8	0	0
6	18714937	.	A	G	3	12	15	0	1	16	0	0
6	18715090	.	A	G	11	5	16	0	0	16	0	0
6	18715309	.	T	C	3	0	3	0	6	9	0	0
6	18715540	.	A	G	2	5	7	0	0	7	0	0
6	18715544	.	C	T	5	2	7	0	0	7	0	0
6	18715712	.	A	G	2	3	5	0	0	5	0	0
6	18715879	.	A	C	4	6	10	0	2	12	0	0
6	18716054	.	G	A	4	4	8	0	1	9	0	0
6	18716330	.	C	T	6	4	10	0	0	10	0	0
6	18716551	.	T	C	6	6	12	0	0	12	0	0
6	18716611	.	T	C	6	0	6	0	5	11	0	0
6	18717238	.	T	A	3	3	6	0	0	6	0	0
6	18717315	.	T	C	4	4	8	0	1	9	0	0
6	18717319	.	A	T	4	4	8	0	1	9	0	0
6	18717449	.	C	A	0	6	6	0	1	7	0	0
6	18718126	.	G	A	3	4	7	0	0	7	0	0
6	18718205	.	A	C	4	3	7	0	0	7	0	0
6	18718473	.	C	T	1	5	6	0	0	6	0	0
6	18718485	.	C	T	0	1	1	0	5	6	0	0
6	18718662	.	G	A	2	2	4	0	0	4	0	0
6	18718663	.	C	T	2	2	4	0	0	4	0	0
6	18725881	.	T	A	4	3	7	0	1	8	0	0
6	18731328	.	G	C	2	3	5	0	1	6	0	0
6	18936455	.	T	C	3	0	3	0	11	14	0	0
6	18936959	.	A	G	2	3	5	0	0	5	0	0
6	18953406	.	G	C	2	1	3	0	0	3	0	0
6	18958920	.	C	T	2	2	4	0	0	4	0	0
6	19263882	.	T	A	3	2	5	0	0	5	0	0
6	19295015	.	T	A	10	17	27	0	1	28	0	0
6	19295044	.	A	T	13	8	21	0	1	22	0	0
6	19295087	.	A	T	18	9	27	0	0	27	0	0
6	19295169	.	C	T	0	9	9	0	13	22	0	0
6	19295454	.	C	T	21	22	43	0	2	45	0	0
6	19295625	.	T	A	11	12	23	0	1	24	0	0
6	19334899	.	A	G	3	2	5	0	0	5	0	0
6	19339426	.	C	T	2	2	4	0	0	4	0	0
6	19344862	.	T	C	4	10	14	0	2	16	0	0
6	19344950	.	C	T	9	4	13	0	1	14	0	0
6	19378992	.	G	A	6	2	8	0	0	8	0	0
6	19381640	.	G	T	4	4	8	0	0	8	0	0
6	19381679	.	C	G	6	3	9	0	0	9	0	0
6	19715507	.	A	C	0	1	1	0	0	1	0	0
6	19715552	.	G	A	0	6	6	0	3	9	0	0
6	19802145	.	G	T	0	11	11	0	10	21	0	0
6	19802148	.	C	A	10	10	20	0	0	20	0	0
6	19802414	.	C	G	5	0	5	0	4	9	0	0
6	19804213	.	A	C	3	3	6	0	0	6	0	0
6	19804743	.	A	T	3	4	7	0	1	8	0	0
6	19804875	.	A	G	2	4	6	0	0	6	0	0
6	19804882	.	C	T	2	3	5	0	0	5	0	0
6	19805353	.	G	T	1	3	4	0	0	4	0	0
6	19806990	.	C	T	2	2	4	0	0	4	0	0
6	20766299	.	G	A	20	10	30	0	1	31	0	0
6	20766352	.	C	T	14	7	21	0	0	21	0	0
6	20766449	.	G	A	7	7	14	0	1	15	0	0
6	20766565	.	C	G	0	7	7	0	8	15	0	0
6	20767167	.	C	A	12	9	21	0	0	21	0	0
6	20767502	.	A	G	11	24	35	0	0	35	0	0
6	20767537	.	A	G	12	26	38	0	0	38	0	0
6	20767575	.	G	C	16	0	16	0	23	39	0	0
6	20767994	.	T	C	8	15	23	0	1	24	0	0
6	20768061	.	A	G	3	11	14	0	1	15	0	0
6	20768239	.	A	G	18	4	22	0	0	22	0	0
6	20768407	.	A	T	5	3	8	0	0	8	0	0
6	20774752	.	G	A	13	6	19	0	1	20	0	0
6	20785089	.	A	G	7	8	15	0	1	16	0	0
6	20785105	.	C	T	0	8	8	0	10	18	0	0
6	20785144	.	G	A	12	9	21	0	1	22	0	0
6	20789072	.	A	G	11	9	20	0	1	21	0	0
6	20789162	.	G	A	11	7	18	0	1	19	0	0
6	20789195	.	C	T	10	8	18	0	1	19	0	0
6	20789351	.	T	C	6	7	13	0	0	13	0	0
6	20789369	.	T	A	7	8	15	0	0	15	0	0
6	20789489	.	T	C	4	8	12	0	0	12	0	0
6	20815058	.	A	T	0	1	1	0	0	1	0	0
6	20910625	.	C	T	3	5	8	0	0	8	0	0
6	20918237	.	A	G	2	6	8	0	1	9	0	0
6	20918418	.	G	T	2	5	7	0	0	7	0	0
6	20918431	.	C	A	3	5	8	0	0	8	0	0
6	20918457	.	G	A	0	6	6	0	3	9	0	0
6	20918615	.	C	T	8	18	26	0	0	26	0	0
6	20918673	.	T	C	4	14	18	0	1	19	0	0
6	20921724	.	T	G	10	8	18	0	2	20	0	0
6	20921888	.	T	C	7	6	13	0	0	13	0	0
6	20921919	.	G	A	10	6	16	0	1	17	0	0
6	20921974	.	A	G	8	9	17	0	0	17	0	0
6	20922057	.	A	T	10	5	15	0	0	16	1	0
6	20922271	.	G	T	6	3	9	0	1	10	0	0
6	20956724	.	G	A	0	1	1	0	0	1	0	0
6	20956869	.	C	T	0	1	1	0	0	1	0	0
6	20956881	.	C	T	0	1	1	0	0	1	0	0
6	20961760	.	T	A	0	4	4	0	0	4	0	0
6	20965723	.	G	A	0	4	4	0	0	4	0	0
6	20965745	.	T	A	0	2	2	0	1	3	0	0
6	20965780	.	A	G	0	0	0	0	4	4	0	0
6	20965855	.	A	G	8	6	14	0	0	14	0	0
6	20965873	.	T	A	7	5	12	0	1	13	0	0
6	20976263	.	A	G	1	0	1	0	0	1	0	0
6	20979015	.	C	T	3	2	5	0	1	6	0	0
6	20986906	.	C	G	3	0	3	0	3	6	0	0
6	20996733	.	A	C	4	4	8	0	4	12	0	0
6	20997166	.	C	T	5	8	13	0	0	13	0	0
6	20997713	.	G	T	1	2	3	0	0	3	0	0
6	21009270	.	T	A	2	3	5	0	0	5	0	0
6	21119574	.	C	T	6	4	10	0	0	10	0	0
6	21119776	.	A	C	1	3	4	0	0	4	0	0
6	21119786	.	G	A	1	5	6	0	0	6	0	0
6	21119847	.	G	A	1	3	4	0	0	4	0	0
6	21119860	.	T	C	1	2	3	0	0	3	0	0
6	21119910	.	G	A	1	5	6	0	1	7	0	0
6	21119914	.	A	G	1	5	6	0	0	6	0	0
6	21119949	.	T	C	1	4	5	0	0	5	0	0
6	21120146	.	G	C	1	4	5	0	1	6	0	0
6	21120201	.	T	C	4	4	8	0	0	8	0	0
6	21130593	.	G	A	2	3	5	0	0	6	1	0
6	21130623	.	C	T	3	3	6	0	0	6	0	0
6	21131142	.	A	T	4	1	5	0	0	5	0	0
6	21131504	.	G	A	4	6	10	0	0	10	0	0
6	21131549	.	A	G	2	0	2	0	6	8	0	0
6	21135702	.	G	A	1	2	3	0	1	4	0	0
6	21143041	.	C	A	1	1	2	0	0	2	0	0
6	21146252	.	C	T	5	3	8	0	0	8	0	0
6	21146501	.	C	T	7	3	10	0	0	10	0	0
6	21146505	.	C	A	7	3	10	0	0	10	0	0
6	21146633	.	G	A	5	6	11	0	0	11	0	0
6	21146648	.	G	A	7	6	13	0	0	13	0	0
6	21147368	.	G	T	0	4	4	0	4	8	0	0
6	21148019	.	A	G	3	3	6	0	1	7	0	0
6	21148022	.	G	A	4	4	8	0	0	8	0	0
6	21148367	.	G	A	2	4	6	0	0	6	0	0
6	21148393	.	T	A	1	2	3	0	0	3	0	0
6	21149383	.	A	T	4	0	4	0	0	4	0	0
6	21150661	.	T	C	8	4	12	0	1	13	0	0
6	21150772	.	A	T	15	15	30	0	1	31	0	0
6	21150958	.	A	G	8	10	18	0	0	18	0	0
6	21151027	.	A	G	5	6	11	0	0	11	0	0
6	21151078	.	T	C	7	7	14	0	0	14	0	0
6	21151379	.	A	C	4	4	8	0	0	8	0	0
6	21151415	.	T	C	2	2	4	0	0	4	0	0
6	21151459	.	T	C	2	3	5	0	1	6	0	0
6	21151474	.	C	T	3	2	5	0	1	6	0	0
6	21151664	.	T	G	3	7	10	0	0	10	0	0
6	21151751	.	C	T	12	8	20	0	0	20	0	0
6	21153285	.	G	A	0	5	5	0	9	14	0	0
6	21154996	.	T	A	6	4	10	0	0	10	0	0
6	21376635	.	T	G	1	0	1	0	0	1	0	0
6	21390316	.	G	A	0	3	3	0	2	5	0	0
6	21391439	.	G	A	2	2	4	0	0	4	0	0
6	21391444	.	C	T	3	2	5	0	0	5	0	0
6	21392049	.	A	T	1	5	6	0	1	7	0	0
6	21392057	.	C	A	2	1	3	0	3	6	0	0
6	21392472	.	G	A	1	2	3	0	0	3	0	0
6	21392545	.	C	T	4	2	6	0	0	6	0	0
6	21392584	.	C	A	7	5	12	0	0	12	0	0
6	21392722	.	T	C	4	2	6	0	1	7	0	0
6	21393635	.	G	A	1	5	6	0	4	10	0	0
6	21513885	.	G	T	2	4	6	0	0	6	0	0
6	21514148	.	T	C	0	1	1	0	0	1	0	0
6	21514622	.	T	G	1	3	4	0	0	4	0	0
6	21514681	.	A	C	5	6	11	0	1	12	0	0
6	21516593	.	A	G	1	2	3	0	0	3	0	0
6	21521320	.	G	A	2	2	4	0	0	4	0	0
6	21525887	.	C	A	3	11	14	0	1	15	0	0
6	21525916	.	A	G	7	13	20	0	0	20	0	0
6	21525943	.	T	A	14	10	24	0	3	27	0	0
6	21526047	.	C	A	4	6	10	1	0	11	0	0
6	21526069	.	T	C	4	0	4	1	8	13	0	0
6	21526109	.	A	G	5	11	16	0	0	16	0	0
6	21526322	.	A	G	9	25	34	0	1	35	0	0
6	21526364	.	T	C	5	22	27	0	0	27	0	0
6	21526395	.	A	G	7	17	24	0	0	24	0	0
6	21526783	.	G	A	2	1	3	0	0	3	0	0
6	21529253	.	C	A	9	9	18	0	0	18	0	0
6	21529767	.	A	T	6	4	10	0	0	10	0	0
6	21532427	.	T	C	1	0	1	0	5	6	0	0
6	21578732	.	A	T	0	2	2	0	0	2	0	0
6	21578760	.	C	T	2	1	3	0	1	4	0	0
6	21588285	.	C	T	10	7	17	0	0	17	0	0
6	21588594	.	C	A	0	10	10	0	7	17	0	0
6	21588597	.	T	G	7	9	16	0	1	17	0	0
6	21588727	.	T	A	6	7	13	0	0	13	0	0
6	21589111	.	G	T	5	5	10	0	0	10	0	0
6	21589280	.	A	G	2	3	5	0	0	5	0	0
6	21598085	.	C	T	4	2	6	0	0	6	0	0
6	21601054	.	T	G	1	0	1	0	0	1	0	0
6	21615529	.	C	T	3	3	6	0	0	6	0	0
6	21615621	.	T	A	1	1	2	0	0	2	0	0
6	21693589	.	G	T	0	0	0	0	1	1	0	0
6	21693969	.	C	T	5	4	9	0	1	10	0	0
6	21694369	.	T	A	5	8	13	0	1	15	1	0
6	21694401	.	C	A	9	10	19	0	0	19	0	0
6	21694486	.	C	A	7	8	15	0	0	15	0	0
6	21694591	.	C	A	3	8	11	0	1	12	0	0
6	21694652	.	T	A	4	15	19	0	1	20	0	0
6	21694917	.	C	A	7	6	13	0	0	13	0	0
6	21695033	.	C	A	5	4	9	0	0	9	0	0
6	21695034	.	C	T	5	4	9	0	0	9	0	0
6	21699390	.	A	T	1	2	3	0	0	3	0	0
6	21700062	.	T	C	1	3	4	0	0	4	0	0
6	21700138	.	G	A	6	3	9	0	1	10	0	0
6	21700212	.	A	G	3	6	9	0	0	9	0	0
6	21700263	.	A	G	4	6	10	0	0	10	0	0
6	21726584	.	C	T	3	3	6	0	0	6	0	0
6	21811593	.	A	G	4	2	6	0	1	7	0	0
6	21861526	.	T	G	17	14	31	0	1	32	0	0
6	21861590	.	G	T	7	4	11	0	0	11	0	0
6	21861725	.	A	T	1	13	14	0	1	15	0	0
6	21861771	.	G	A	16	9	25	0	1	26	0	0
6	21861949	.	G	A	20	17	37	0	0	37	0	0
6	21862158	.	G	C	18	18	36	0	2	38	0	0
6	21862288	.	G	A	21	20	41	0	3	44	0	0
6	21862460	.	A	G	17	17	34	1	0	35	0	0
6	21862486	.	G	A	22	14	36	1	0	37	0	0
6	21871928	.	T	C	2	2	4	0	0	4	0	0
6	21871931	.	G	T	2	1	3	0	1	4	0	0
6	21875373	.	C	G	0	5	5	0	1	6	0	0
6	21875469	.	G	A	4	2	6	0	0	6	0	0
6	21875691	.	T	C	3	0	3	0	5	8	0	0
6	21875741	.	G	T	2	5	7	0	1	8	0	0
6	21875930	.	T	A	2	2	4	0	1	5	0	0
6	21876006	.	G	A	3	3	6	0	0	6	0	0
6	21876060	.	G	A	5	2	7	0	1	8	0	0
6	21876131	.	T	A	2	5	7	0	1	9	1	0
6	21993967	.	A	C	1	5	6	0	0	6	0	0
6	21996194	.	A	C	3	5	8	0	0	8	0	0
6	21996281	.	C	A	2	3	5	0	0	5	0	0
6	21996320	.	A	G	2	4	6	0	0	6	0	0
6	21996452	.	C	A	2	2	4	0	0	4	0	0
6	21996458	.	G	A	2	2	4	0	0	4	0	0
6	21999860	.	A	T	3	2	5	0	0	5	0	0
6	22007420	.	G	A	4	2	6	0	0	6	0	0
6	22026249	.	G	T	4	4	8	0	1	9	0	0
6	22030296	.	G	A	1	6	7	0	0	7	0	0
6	22034985	.	A	C	6	6	12	0	1	13	0	0
6	22035222	.	G	A	0	7	7	0	11	18	0	0
6	22035352	.	A	G	7	6	13	0	0	13	0	0
6	22037517	.	A	G	2	0	2	0	6	8	0	0
6	22037553	.	G	A	3	6	9	0	0	9	0	0
6	22037565	.	A	G	3	2	5	0	7	12	0	0
6	22037625	.	C	T	3	8	11	0	1	12	0	0
6	22037715	.	A	T	3	5	8	0	0	8	0	0
6	22093722	.	A	G	0	2	2	0	0	2	0	0
6	22102095	.	C	T	1	3	4	0	0	4	0	0
6	22105289	.	T	G	0	2	2	0	0	2	0	0
6	22105554	.	A	G	6	4	10	0	1	11	0	0
6	22107277	.	C	T	4	4	8	0	0	8	0	0
6	22107813	.	T	G	3	0	3	0	7	10	0	0
6	22107858	.	C	T	2	1	3	0	0	3	0	0
6	22108307	.	C	A	2	1	3	0	0	3	0	0
6	22109552	.	T	G	3	0	3	0	3	6	0	0
6	22109678	.	A	T	2	2	4	0	0	4	0	0
6	22111594	.	A	G	12	14	26	0	0	26	0	0
6	22112395	.	A	G	2	0	2	0	1	3	0	0
6	22118165	.	T	C	18	19	37	0	2	39	0	0
6	22118216	.	G	A	22	26	48	0	3	51	0	0
6	22118497	.	G	C	11	17	28	0	1	29	0	0
6	22118590	.	A	G	27	18	45	0	2	47	0	0
6	22118690	.	C	T	11	16	27	0	0	27	0	0
6	22118885	.	T	G	25	1	26	0	18	44	0	0
6	22119056	.	C	T	24	28	52	0	2	54	0	0
6	22119376	.	A	C	24	15	39	0	2	41	0	0
6	22119516	.	T	C	8	19	27	0	0	27	0	0
6	22119668	.	T	C	5	3	8	0	1	9	0	0
6	22120074	.	C	T	8	13	21	0	3	24	0	0
6	22120445	.	A	G	12	8	20	0	1	21	0	0
6	22120877	.	A	G	4	2	6	0	0	6	0	0
6	22127197	.	A	G	4	2	6	0	0	6	0	0
6	22127270	.	C	T	3	3	6	0	0	6	0	0
6	22128520	.	G	A	5	3	8	0	0	8	0	0
6	22128603	.	G	A	6	1	7	0	0	7	0	0
6	22134174	.	G	A	2	2	4	0	0	4	0	0
6	22137403	.	C	T	2	2	4	0	1	5	0	0
6	22327331	.	T	C	1	2	3	0	0	3	0	0
6	22328821	.	A	G	4	0	4	0	4	8	0	0
6	22330400	.	A	T	6	1	7	0	0	7	0	0
6	22338938	.	A	G	5	2	7	0	0	7	0	0
6	22344003	.	A	T	1	5	6	0	2	8	0	0
6	22347259	.	G	A	10	11	21	0	3	24	0	0
6	22348271	.	T	A	11	15	26	0	1	27	0	0
6	22348274	.	G	C	11	16	27	0	0	27	0	0
6	22351692	.	T	C	17	31	48	0	0	48	0	0
6	22351727	.	T	C	23	26	49	0	1	50	0	0
6	22351780	.	T	A	22	20	42	0	1	43	0	0
6	22352341	.	A	G	2	4	6	0	0	6	0	0
6	22352539	.	C	T	8	21	29	0	1	30	0	0
6	22354738	.	C	A	0	1	1	0	0	1	0	0
6	22354759	.	A	G	2	2	4	0	0	4	0	0
6	22597503	.	G	A	8	8	16	0	3	19	0	0
6	22615546	.	G	A	20	15	35	0	0	35	0	0
6	22628073	.	T	G	10	12	22	0	1	23	0	0
6	22628112	.	A	G	10	12	22	0	1	23	0	0
6	22628483	.	G	A	0	18	18	0	18	36	0	0
6	22628779	.	T	C	15	20	35	0	0	35	0	0
6	22629099	.	A	T	7	10	17	0	0	17	0	0
6	22629182	.	A	G	6	7	13	0	1	14	0	0
6	22683362	.	A	G	6	4	10	0	0	10	0	0
6	22980251	.	T	C	2	2	4	0	0	4	0	0
6	22986191	.	A	C	3	1	4	0	0	4	0	0
6	22988839	.	T	C	3	2	5	0	0	5	0	0
6	22998590	.	C	T	0	2	2	0	0	2	0	0
6	22998625	.	A	G	0	2	2	0	0	2	0	0
6	23001656	.	G	T	1	2	3	0	0	3	0	0
6	23053129	.	C	T	6	4	10	0	0	10	0	0
6	23053374	.	G	A	0	4	4	0	13	17	0	0
6	23053393	.	C	A	11	5	16	0	0	16	0	0
6	23053575	.	A	T	9	5	14	0	1	15	0	0
6	23053714	.	A	G	9	14	23	0	0	23	0	0
6	23053824	.	T	C	4	12	16	0	2	18	0	0
6	23053968	.	A	G	4	8	12	0	2	14	0	0
6	23054267	.	A	G	20	0	20	0	12	32	0	0
6	23054334	.	A	T	14	12	26	0	1	27	0	0
6	23054361	.	A	G	14	8	22	0	1	23	0	0
6	23107785	.	A	C	4	2	6	0	0	6	0	0
6	23125548	.	G	A	0	8	8	0	4	12	0	0
6	23137335	.	T	A	3	4	7	0	0	7	0	0
6	23137844	.	A	T	3	2	5	0	0	5	0	0
6	23137856	.	C	T	2	2	4	0	0	4	0	0
6	23620940	.	C	A	4	2	6	0	1	7	0	0
6	23752775	.	G	A	0	4	4	0	4	8	0	0
6	23812768	.	T	A	5	4	9	0	0	9	0	0
6	23812771	.	C	G	5	3	8	0	0	8	0	0
6	23813361	.	G	A	0	17	17	0	19	36	0	0
6	23813767	.	C	A	13	13	26	0	0	26	0	0
6	23938829	.	G	A	8	7	15	0	0	15	0	0
6	24055743	.	T	A	8	7	15	0	1	16	0	0
6	24055784	.	G	A	11	13	24	0	1	25	0	0
6	24066253	.	T	C	6	1	7	0	6	13	0	0
6	24066296	.	G	A	5	9	14	0	0	14	0	0
6	24066345	.	A	G	7	5	12	0	2	14	0	0
6	24066547	.	C	T	1	6	7	0	3	10	0	0
6	24066575	.	T	C	4	9	13	0	0	13	0	0
6	24066611	.	G	A	11	6	17	0	0	17	0	0
6	24066662	.	A	T	1	1	2	0	2	4	0	0
6	24153075	.	G	A	24	22	46	0	0	46	0	0
6	24153114	.	A	G	19	22	41	0	1	42	0	0
6	24153297	.	T	C	17	23	40	0	2	42	0	0
6	24155357	.	C	T	23	19	42	0	3	45	0	0
6	24155459	.	T	G	13	14	27	0	0	27	0	0
6	24155766	.	T	C	12	16	28	0	0	28	0	0
6	24155886	.	A	C	8	0	8	0	16	24	0	0
6	24155898	.	C	T	7	14	21	0	3	24	0	0
6	24156219	.	T	C	7	1	8	0	12	20	0	0
6	24156486	.	A	C	8	8	16	0	0	16	0	0
6	24161409	.	G	A	4	10	14	0	1	15	0	0
6	24163535	.	A	C	1	1	2	0	0	2	0	0
6	24163543	.	T	C	1	1	2	0	0	2	0	0
6	24329685	.	C	T	4	5	9	0	1	10	0	0
6	24330029	.	C	T	12	12	24	0	0	24	0	0
6	24330196	.	G	A	24	14	38	0	5	43	0	0
6	24330229	.	G	A	17	12	29	0	2	31	0	0
6	24340631	.	G	A	3	5	8	0	0	8	0	0
6	24340688	.	G	T	8	9	17	0	1	18	0	0
6	24349237	.	T	C	5	6	11	0	0	11	0	0
6	24358323	.	A	T	5	6	11	0	3	14	0	0
6	24358326	.	G	A	7	6	13	0	2	15	0	0
6	24358608	.	T	A	5	6	11	0	0	11	0	0
6	24364878	.	G	T	2	7	9	0	1	10	0	0
6	24365102	.	C	G	6	4	10	0	0	10	0	0
6	24365205	.	T	A	4	7	11	0	1	12	0	0
6	24365276	.	C	A	9	2	11	0	0	11	0	0
6	24365453	.	G	A	9	4	13	0	0	13	0	0
6	24365838	.	G	A	12	5	17	0	0	17	0	0
6	24370637	.	C	T	6	6	12	0	0	12	0	0
6	24370646	.	T	C	9	5	14	0	1	15	0	0
6	24379745	.	T	C	1	2	3	0	0	3	0	0
6	24379760	.	T	C	1	2	3	0	0	3	0	0
6	24379865	.	G	A	15	13	28	0	3	31	0	0
6	24380335	.	C	A	9	6	15	0	0	15	0	0
6	24382063	.	A	T	4	3	7	0	0	7	0	0
6	24387752	.	C	T	2	7	9	0	0	9	0	0
6	24392498	.	G	A	1	2	3	0	0	3	0	0
6	24681047	.	C	T	1	2	3	0	0	3	0	0
6	24681563	.	G	A	4	6	10	0	0	10	0	0
6	24681812	.	T	A	1	2	3	0	1	4	0	0
6	24682165	.	G	C	2	3	5	0	1	6	0	0
6	24682720	.	T	A	6	3	9	0	1	10	0	0
6	24682721	.	C	T	4	6	10	0	0	10	0	0
6	24682759	.	G	T	3	11	14	0	1	15	0	0
6	24682913	.	A	T	9	5	14	0	0	14	0	0
6	24682925	.	T	C	4	9	13	0	0	13	0	0
6	24682950	.	G	A	4	3	7	0	1	8	0	0
6	24683354	.	C	T	8	4	12	0	1	13	0	0
6	24683854	.	A	G	3	0	3	0	9	12	0	0
6	24691366	.	C	T	6	5	11	0	0	11	0	0
6	24691791	.	A	T	4	5	9	0	0	9	0	0
6	24691845	.	A	T	5	5	10	0	0	10	0	0
6	24692075	.	G	A	0	3	3	0	0	3	0	0
6	24692168	.	G	A	6	4	10	0	0	10	0	0
6	24692307	.	A	G	6	8	14	0	2	16	0	0
6	24697940	.	G	C	7	3	10	0	0	10	0	0
6	24818240	.	C	A	12	9	21	0	3	24	0	0
6	24818312	.	C	G	14	15	29	0	0	29	0	0
6	24821631	.	G	A	1	2	3	0	0	3	0	0
6	25169385	.	T	A	2	2	4	0	0	4	0	0
6	25933917	.	T	C	17	2	19	0	15	34	0	0
6	25934214	.	A	G	18	11	29	0	2	33	2	0
6	25934313	.	A	T	17	17	34	0	0	34	0	0
6	26065499	.	A	C	5	4	9	0	1	10	0	0
6	26065508	.	C	A	0	4	4	0	6	10	0	0
6	26066097	.	A	T	1	0	1	0	0	1	0	0
6	26080187	.	A	G	4	2	6	0	0	6	0	0
6	26080352	.	C	T	3	4	7	0	0	7	0	0
6	26225456	.	G	A	2	3	5	0	0	5	0	0
6	26225479	.	T	G	3	3	6	0	1	7	0	0
6	26225657	.	G	C	6	2	8	0	0	8	0	0
6	26225700	.	A	G	1	3	4	0	0	4	0	0
6	26558837	.	C	T	1	12	13	0	14	27	0	0
6	26558927	.	C	T	0	17	17	0	10	27	0	0
6	26559179	.	T	C	17	1	18	0	21	39	0	0
6	26559780	.	A	G	13	7	20	0	1	21	0	0
6	26559807	.	A	G	9	12	21	0	1	22	0	0
6	26875804	.	C	A	6	17	23	0	0	23	0	0
6	26875944	.	T	A	18	16	34	0	0	34	0	0
6	26878802	.	G	A	2	3	5	0	0	5	0	0
6	26879486	.	G	T	5	3	8	0	0	8	0	0
6	26883895	.	T	G	2	3	5	0	0	5	0	0
6	26891891	.	A	G	5	6	11	0	0	11	0	0
6	27041886	.	T	C	8	3	11	0	0	11	0	0
6	27041988	.	C	T	3	1	4	0	0	4	0	0
6	27045205	.	G	A	12	7	19	0	0	19	0	0
6	27045238	.	A	G	5	4	9	0	0	9	0	0
6	27048800	.	T	A	4	5	9	0	2	11	0	0
6	27048976	.	A	G	4	4	8	0	0	8	0	0
6	27051710	.	G	A	1	1	2	0	0	2	0	0
6	27051749	.	C	T	5	3	8	0	0	8	0	0
6	27051836	.	G	A	2	1	3	0	0	3	0	0
6	27055569	.	T	C	2	2	4	0	0	4	0	0
6	27057561	.	A	G	7	8	15	0	0	15	0	0
6	27057586	.	T	C	9	2	11	0	0	11	0	0
6	27057598	.	A	T	9	3	12	0	1	13	0	0
6	27063155	.	T	A	1	0	1	0	0	1	0	0
6	27063158	.	G	A	1	0	1	0	0	1	0	0
6	27087515	.	T	A	1	4	5	0	0	5	0	0
6	27087788	.	C	T	3	3	6	0	0	6	0	0
6	27087827	.	A	T	0	4	4	0	0	4	0	0
6	27087843	.	A	G	1	3	4	0	1	5	0	0
6	27087875	.	G	A	1	2	3	0	1	4	0	0
6	27087884	.	C	T	3	2	5	0	0	5	0	0
6	27087929	.	T	C	3	3	6	0	0	6	0	0
6	27088076	.	G	C	6	5	11	0	0	11	0	0
6	27088260	.	A	G	8	5	13	0	3	16	0	0
6	27088476	.	C	T	3	2	5	0	0	5	0	0
6	27088519	.	T	A	1	2	3	0	1	4	0	0
6	27092370	.	G	A	0	1	1	0	0	1	0	0
6	27099004	.	T	C	1	0	1	0	0	1	0	0
6	27099061	.	G	A	3	2	5	0	0	5	0	0
6	27101393	.	A	G	6	0	6	0	6	12	0	0
6	27104584	.	T	C	9	10	19	0	1	20	0	0
6	27104898	.	A	T	10	4	14	0	0	14	0	0
6	27104906	.	C	G	7	3	10	0	1	11	0	0
6	27108716	.	T	A	1	2	3	0	0	3	0	0
6	27146872	.	C	T	4	7	11	0	1	12	0	0
6	27146902	.	C	T	5	4	9	0	0	9	0	0
6	27146933	.	C	T	4	4	8	0	0	8	0	0
6	27146992	.	T	C	1	3	4	0	0	4	0	0
6	27216458	.	T	A	0	1	1	0	0	1	0	0
6	27220245	.	C	T	8	5	13	0	1	14	0	0
6	27220344	.	G	A	5	6	11	0	0	11	0	0
6	27220347	.	T	C	5	6	11	0	0	11	0	0
6	27221029	.	T	C	4	2	6	0	0	6	0	0
6	27232880	.	T	C	3	2	5	0	0	5	0	0
6	27233775	.	G	A	0	6	6	0	3	9	0	0
6	27259107	.	T	A	3	3	6	0	0	6	0	0
6	27265350	.	T	C	10	10	20	0	0	20	0	0
6	27269268	.	G	A	13	16	29	0	0	29	0	0
6	27269425	.	G	A	0	11	11	0	13	24	0	0
6	27269612	.	T	A	14	9	23	0	0	23	0	0
6	27269664	.	T	C	20	18	38	0	0	38	0	0
6	27269873	.	C	T	16	13	29	0	3	32	0	0
6	27270147	.	G	A	6	8	14	0	0	14	0	0
6	27270288	.	A	C	7	16	23	0	1	24	0	0
6	27270346	.	T	C	11	9	20	0	2	22	0	0
6	27270389	.	C	A	18	9	27	0	0	27	0	0
6	27270429	.	C	T	13	4	17	0	1	18	0	0
6	27270449	.	G	A	11	5	16	0	1	17	0	0
6	27270653	.	G	A	18	18	36	0	0	36	0	0
6	27270664	.	T	A	16	16	32	0	4	36	0	0
6	27271114	.	A	G	26	1	27	0	21	48	0	0
6	27271115	.	A	T	25	22	47	0	1	48	0	0
6	27271208	.	A	G	21	1	22	0	30	52	0	0
6	27271214	.	A	G	35	16	51	0	2	53	0	0
6	27271312	.	A	G	6	23	29	0	1	30	0	0
6	27271390	.	T	A	14	23	37	0	0	38	1	0
6	27271498	.	C	T	9	29	38	0	2	40	0	0
6	27271530	.	A	G	28	10	38	0	2	40	0	0
6	27272081	.	T	G	33	23	56	1	3	60	0	0
6	27272487	.	A	T	13	20	33	0	2	35	0	0
6	27272488	.	T	C	15	17	32	0	3	35	0	0
6	27272555	.	T	C	22	21	43	0	1	44	0	0
6	27449452	.	G	A	1	2	3	0	0	3	0	0
6	27614446	.	T	C	4	2	6	0	0	6	0	0
6	27667378	.	C	A	10	14	24	0	1	25	0	0
6	27667415	.	A	C	16	23	39	0	4	43	0	0
6	28207852	.	A	G	2	1	3	0	2	5	0	0
6	28207853	.	A	G	1	4	5	0	0	5	0	0
6	29156507	.	A	G	1	1	2	0	0	2	0	0
6	30711407	.	T	C	8	4	12	0	1	13	0	0
6	30714240	.	T	C	6	11	17	0	0	17	0	0
6	31185457	.	C	T	3	0	3	0	0	3	0	0
6	31432391	.	T	A	4	3	7	0	3	10	0	0
6	31432453	.	C	A	3	2	5	0	0	5	0	0
6	33554620	.	A	G	1	0	1	0	9	10	0	0
6	33555555	.	A	G	9	4	13	0	1	14	0	0
6	33558204	.	G	A	8	5	13	0	0	13	0	0
6	33663690	.	T	C	7	12	19	0	1	20	0	0
6	33663701	.	T	C	5	14	19	0	1	20	0	0
6	34811130	.	A	T	5	5	10	0	1	11	0	0
6	34826634	.	C	T	0	2	2	0	1	3	0	0
6	35366544	.	A	G	7	6	13	0	1	14	0	0
6	36129075	.	T	A	3	2	5	0	0	5	0	0
6	36129202	.	G	A	1	4	5	0	0	5	0	0
6	37445357	.	T	C	0	5	5	0	0	5	0	0
6	38859938	.	A	G	16	4	20	0	4	24	0	0
6	39187295	.	T	A	1	0	1	0	0	1	0	0
6	39994107	.	A	T	0	11	11	4	0	15	0	0
6	41435866	.	A	G	13	5	18	0	0	18	0	0
6	41445564	.	A	T	0	3	3	0	1	4	0	0
6	41445566	.	T	C	0	4	4	0	0	4	0	0
6	41460563	.	A	T	1	6	7	0	0	7	0	0
6	44922563	.	A	C	2	3	5	0	0	5	0	0
6	44924866	.	A	C	0	1	1	0	0	1	0	0
6	44942314	.	G	A	0	2	2	0	1	3	0	0
6	44945233	.	A	G	1	2	3	0	0	3	0	0
6	44945279	.	C	A	5	3	8	0	0	8	0	0
6	44945301	.	C	T	5	3	8	0	1	9	0	0
6	44945585	.	C	T	0	1	1	0	0	1	0	0
6	44950364	.	C	T	6	2	8	0	0	8	0	0
6	44950644	.	C	T	3	6	9	0	0	9	0	0
6	44950701	.	T	G	4	7	11	0	1	13	1	0
6	44961519	.	A	G	3	7	10	0	0	10	0	0
6	44970154	.	A	G	2	0	2	0	0	2	0	0
6	44977406	.	G	A	9	10	19	0	1	20	0	0
6	46346865	.	A	C	1	2	3	0	0	3	0	0
6	46357708	.	C	A	0	3	3	0	1	4	0	0
6	46422955	.	G	A	5	6	11	0	0	11	0	0
6	46423470	.	C	A	1	4	5	0	0	5	0	0
6	46423593	.	G	T	7	7	14	0	0	14	0	0
6	46428718	.	A	C	0	1	1	0	0	1	0	0
6	46431113	.	G	A	0	5	5	0	5	10	0	0
6	46431950	.	A	G	29	22	51	0	2	53	0	0
6	46432016	.	G	A	4	6	10	0	2	12	0	0
6	46450487	.	C	G	33	23	56	0	0	56	0	0
6	46450547	.	T	C	23	20	43	0	3	46	0	0
6	46450804	.	C	T	10	14	24	0	5	29	0	0
6	46452997	.	C	T	1	4	5	0	0	5	0	0
6	46454103	.	C	A	20	14	34	0	0	34	0	0
6	46454148	.	G	A	19	8	27	0	0	27	0	0
6	46454173	.	T	G	15	15	30	0	1	31	0	0
6	46454396	.	T	A	20	30	50	0	0	50	0	0
6	46697930	.	T	C	7	3	10	0	1	11	0	0
6	46701953	.	C	T	2	1	3	0	0	3	0	0
6	46715399	.	A	G	2	2	4	0	0	4	0	0
6	46715454	.	T	A	3	3	6	0	0	6	0	0
6	46716897	.	T	C	4	6	10	0	0	10	0	0
6	46716915	.	C	T	3	5	8	0	1	9	0	0
6	46716954	.	T	C	1	7	8	0	0	8	0	0
6	46717535	.	T	C	3	5	8	0	0	8	0	0
6	46717731	.	A	G	4	0	4	0	7	11	0	0
6	46717772	.	T	C	3	5	8	0	0	8	0	0
6	46718103	.	T	G	7	8	15	0	1	16	0	0
6	46718193	.	G	T	6	7	13	0	0	13	0	0
6	46718237	.	G	A	2	2	4	0	0	4	0	0
6	46718243	.	G	A	2	2	4	0	0	4	0	0
6	46721369	.	C	T	4	3	7	0	1	8	0	0
6	46722670	.	G	A	13	5	18	0	0	18	0	0
6	46722671	.	G	T	13	5	18	0	0	18	0	0
6	46722783	.	G	T	1	6	7	0	2	9	0	0
6	46722786	.	C	G	2	7	9	0	0	9	0	0
6	46722883	.	T	G	5	7	12	0	0	12	0	0
6	46725949	.	T	C	4	5	9	0	0	9	0	0
6	46725966	.	T	A	4	5	9	0	0	9	0	0
6	46726234	.	T	G	4	5	9	0	0	9	0	0
6	46726901	.	C	T	3	2	5	0	0	5	0	0
6	47006599	.	G	A	2	1	3	0	0	3	0	0
6	47006611	.	A	G	4	4	8	0	0	8	0	0
6	47032679	.	C	T	6	11	17	0	0	17	0	0
6	47032772	.	A	G	3	8	11	0	0	11	0	0
6	47054448	.	A	G	2	1	3	0	1	4	0	0
6	47246513	.	C	T	5	5	10	0	0	10	0	0
6	47530049	.	A	G	4	2	6	0	0	6	0	0
6	47530112	.	C	G	2	6	8	0	1	9	0	0
6	47530428	.	T	C	3	2	5	0	1	6	0	0
6	47530562	.	G	T	6	5	11	0	0	11	0	0
6	47530563	.	T	A	4	4	8	0	3	11	0	0
6	47530828	.	C	T	0	4	4	0	5	9	0	0
6	47531110	.	C	A	5	7	12	0	0	12	0	0
6	47540060	.	C	T	0	3	3	0	2	5	0	0
6	47540093	.	C	T	0	4	4	0	1	5	0	0
6	47540279	.	C	T	2	0	2	0	0	2	0	0
6	47558827	.	C	T	0	3	3	0	4	7	0	0
6	47571152	.	C	T	1	1	2	0	0	2	0	0
6	47796642	.	C	T	2	2	4	0	0	4	0	0
6	47809905	.	T	G	3	2	5	0	0	5	0	0
6	47810323	.	A	G	3	3	6	0	0	6	0	0
6	47810671	.	T	A	10	5	15	0	1	16	0	0
6	47810688	.	T	C	8	0	8	0	6	14	0	0
6	47810804	.	A	T	2	6	8	0	0	8	0	0
6	47810941	.	C	T	0	5	5	0	7	12	0	0
6	47811024	.	G	A	5	8	13	0	0	13	0	0
6	47811399	.	A	G	4	2	6	0	0	6	0	0
6	47812280	.	G	C	4	0	4	0	4	8	0	0
6	47812843	.	C	T	0	3	3	0	4	7	0	0
6	47812880	.	C	G	5	2	7	0	1	8	0	0
6	47812893	.	G	A	6	3	9	0	0	9	0	0
6	47813366	.	G	A	2	2	4	0	0	4	0	0
6	47813407	.	T	A	3	3	6	0	1	7	0	0
6	47813548	.	T	C	1	2	3	0	0	3	0	0
6	47813877	.	G	A	3	3	6	0	0	6	0	0
6	47816406	.	G	C	1	2	3	0	0	3	0	0
6	47820011	.	C	A	0	3	3	0	3	6	0	0
6	47825288	.	G	A	2	2	4	0	2	6	0	0
6	47825488	.	G	A	6	5	11	0	0	11	0	0
6	47825537	.	G	A	1	3	4	0	0	4	0	0
6	47846543	.	A	G	1	4	5	0	0	5	0	0
6	47865287	.	C	A	2	10	12	0	0	12	0	0
6	47865322	.	C	T	4	10	14	0	1	15	0	0
6	47865391	.	C	T	8	8	16	0	0	16	0	0
6	47865588	.	T	C	1	8	9	0	0	9	0	0
6	47865626	.	G	T	4	4	8	0	0	8	0	0
6	47865661	.	A	T	5	6	11	0	1	12	0	0
6	47869802	.	C	A	2	1	3	0	2	5	0	0
6	47869982	.	G	A	5	5	10	0	0	10	0	0
6	47870185	.	T	C	3	0	3	0	4	7	0	0
6	47870463	.	G	A	1	0	1	0	0	1	0	0
6	47872510	.	G	A	1	1	2	0	0	2	0	0
6	47879230	.	C	T	0	5	5	0	0	5	0	0
6	48047026	.	G	A	0	1	1	0	0	1	0	0
6	48051766	.	G	A	0	1	1	0	0	1	0	0
6	48052310	.	C	T	2	3	5	0	1	6	0	0
6	48054766	.	C	T	2	2	4	0	0	4	0	0
6	48057928	.	C	T	7	14	21	0	0	21	0	0
6	48058088	.	T	A	4	5	9	0	0	9	0	0
6	48058628	.	A	G	8	6	14	0	2	16	0	0
6	48058719	.	A	G	6	0	6	0	6	12	0	0
6	48058720	.	C	T	6	6	12	0	0	12	0	0
6	48294637	.	A	G	4	2	6	0	0	6	0	0
6	48323184	.	A	C	2	3	5	0	0	5	0	0
6	48323373	.	A	T	11	11	22	0	3	25	0	0
6	48323476	.	A	G	13	2	15	0	5	20	0	0
6	48325997	.	C	G	9	17	26	0	1	27	0	0
6	48333375	.	C	T	0	3	3	0	2	5	0	0
6	48333480	.	C	T	0	5	5	0	4	9	0	0
6	48333483	.	C	T	4	4	8	0	0	8	0	0
6	48360849	.	A	G	0	0	0	0	1	1	0	0
6	48366412	.	A	G	0	0	0	0	3	3	0	0
6	48366570	.	A	C	0	3	3	0	0	3	0	0
6	48369069	.	A	T	2	4	6	0	0	6	0	0
6	48370800	.	T	C	1	2	3	0	0	3	0	0
6	48382970	.	A	C	1	1	2	0	0	2	0	0
6	48383002	.	G	A	2	5	7	0	1	8	0	0
6	48383029	.	C	T	3	5	8	0	0	8	0	0
6	48383068	.	T	C	3	2	5	0	0	5	0	0
6	48383105	.	G	C	2	6	8	1	0	9	0	0
6	48383142	.	C	A	2	5	7	1	1	9	0	0
6	48383149	.	A	T	3	4	7	1	0	8	0	0
6	48383239	.	G	A	5	3	8	0	0	8	0	0
6	48383353	.	A	G	3	3	6	0	2	8	0	0
6	48383371	.	A	C	4	4	8	0	0	8	0	0
6	48383573	.	G	A	7	8	15	0	0	15	0	0
6	48383653	.	A	C	4	3	7	0	0	7	0	0
6	48383713	.	T	A	3	1	4	0	0	4	0	0
6	48394224	.	T	C	2	0	2	0	4	6	0	0
6	48417892	.	A	T	0	2	2	0	1	3	0	0
6	48425552	.	A	T	3	4	7	0	2	9	0	0
6	48425652	.	T	G	1	2	3	0	0	3	0	0
6	48425714	.	A	G	1	2	3	0	1	4	0	0
6	48425744	.	T	A	1	2	3	0	1	4	0	0
6	48425967	.	A	C	2	2	4	0	1	5	0	0
6	48425975	.	C	T	1	3	4	0	1	5	0	0
6	48426052	.	A	G	3	4	7	0	0	7	0	0
6	48426088	.	T	C	1	5	6	0	0	6	0	0
6	48426171	.	C	T	7	3	10	0	1	11	0	0
6	48426381	.	C	T	6	13	19	0	0	19	0	0
6	48426400	.	G	A	6	7	13	0	0	13	0	0
6	48426429	.	A	T	9	5	14	0	0	14	0	0
6	48426535	.	G	A	10	3	13	0	0	13	0	0
6	48426754	.	A	G	3	2	5	0	1	6	0	0
6	48431429	.	T	C	6	5	11	0	0	11	0	0
6	48437957	.	G	A	1	3	4	0	1	5	0	0
6	48439949	.	G	A	4	2	6	0	0	6	0	0
6	48473168	.	C	T	2	3	5	0	0	5	0	0
6	48473183	.	G	A	2	6	8	0	0	8	0	0
6	48473318	.	T	C	4	4	8	0	1	9	0	0
6	48689312	.	T	G	18	14	32	0	0	32	0	0
6	48689484	.	G	A	8	4	12	0	0	12	0	0
6	49048698	.	A	C	2	2	4	0	0	4	0	0
6	49100132	.	G	A	2	1	3	0	0	3	0	0
6	49103203	.	G	A	0	1	1	0	0	1	0	0
6	49106450	.	C	T	4	12	16	0	0	16	0	0
6	49106605	.	C	T	7	20	27	0	0	27	0	0
6	49106744	.	C	T	3	11	14	0	0	14	0	0
6	49107156	.	A	C	18	30	48	0	1	49	0	0
6	49107390	.	G	A	29	20	49	0	2	51	0	0
6	49107477	.	T	G	18	13	31	0	12	43	0	0
6	49107668	.	T	C	41	15	56	0	5	61	0	0
6	49108077	.	T	C	25	6	31	0	2	33	0	0
6	49108078	.	T	C	26	7	33	0	0	33	0	0
6	49108157	.	T	C	16	9	25	0	0	25	0	0
6	49108244	.	T	A	17	15	32	0	1	33	0	0
6	49108313	.	T	C	11	15	26	0	2	28	0	0
6	49108352	.	A	T	20	16	36	0	1	37	0	0
6	49108355	.	T	G	20	17	37	0	1	38	0	0
6	49108604	.	T	C	20	17	37	0	0	37	0	0
6	49108739	.	T	C	20	19	39	0	0	39	0	0
6	49108838	.	A	T	15	29	44	0	0	44	0	0
6	49108954	.	C	G	23	14	37	1	0	38	0	0
6	49108970	.	T	C	19	9	28	1	0	29	0	0
6	49109347	.	T	C	19	26	45	0	3	48	0	0
6	49109366	.	G	A	20	28	48	0	1	49	0	0
6	49115141	.	T	C	5	5	10	0	0	10	0	0
6	49115259	.	A	G	0	1	1	0	0	1	0	0
6	49115292	.	A	G	0	1	1	0	0	1	0	0
6	49139928	.	G	A	5	5	10	0	2	12	0	0
6	49159082	.	G	A	3	4	7	0	0	7	0	0
6	49413281	.	A	T	8	5	13	0	0	13	0	0
6	49413653	.	T	C	1	3	4	0	0	4	0	0
6	49413728	.	G	A	2	2	4	0	1	5	0	0
6	49414007	.	G	C	3	3	6	0	0	6	0	0
6	49414010	.	A	G	3	3	6	0	0	6	0	0
6	49520723	.	C	T	5	6	11	0	3	14	0	0
6	49534301	.	T	G	0	3	3	0	0	3	0	0
6	49551892	.	C	T	4	2	6	0	0	6	0	0
6	49556795	.	T	C	1	1	2	0	0	2	0	0
6	49556822	.	T	C	1	1	2	0	0	2	0	0
6	49573883	.	T	C	2	2	4	0	0	4	0	0
6	49575605	.	T	C	4	4	8	0	0	8	0	0
6	49575715	.	A	C	1	7	8	0	0	8	0	0
6	49575745	.	T	C	2	7	9	0	3	12	0	0
6	49575792	.	A	C	4	8	12	0	0	12	0	0
6	49575795	.	C	T	4	6	10	0	1	11	0	0
6	49576099	.	A	G	2	2	4	0	0	4	0	0
6	49576371	.	T	G	1	3	4	0	0	4	0	0
6	49576372	.	A	G	1	2	3	0	1	4	0	0
6	49576666	.	T	A	3	4	7	0	0	7	0	0
6	49576723	.	T	C	1	3	4	0	0	4	0	0
6	49576770	.	T	C	4	6	10	0	1	11	0	0
6	49577047	.	C	T	5	5	10	0	0	10	0	0
6	49577363	.	G	T	0	5	5	0	0	5	0	0
6	49577546	.	A	C	2	4	6	0	0	6	0	0
6	49577549	.	A	G	2	4	6	0	0	6	0	0
6	49577873	.	C	T	10	4	14	0	0	14	0	0
6	49578236	.	A	G	4	2	6	0	0	6	0	0
6	49579458	.	G	T	0	4	4	0	9	13	0	0
6	49580020	.	G	A	0	5	5	0	3	8	0	0
6	49583348	.	C	T	12	5	17	0	2	19	0	0
6	49605308	.	G	A	0	12	12	0	12	24	0	0
6	49628476	.	T	C	5	3	8	0	1	9	0	0
6	49635461	.	G	A	21	29	50	0	1	51	0	0
6	49636372	.	T	C	18	20	38	0	0	38	0	0
6	49723071	.	G	A	4	4	8	0	0	8	0	0
6	49730334	.	G	A	0	5	5	0	8	13	0	0
6	49732244	.	C	T	0	0	0	0	1	1	0	0
6	49734513	.	G	A	0	1	1	0	5	6	0	0
6	49737251	.	A	T	3	5	8	0	0	8	0	0
6	49737331	.	A	C	5	7	12	0	0	12	0	0
6	49737337	.	C	A	4	7	11	0	1	12	0	0
6	49737477	.	T	A	4	4	8	0	0	8	0	0
6	49737524	.	T	G	3	3	6	0	1	7	0	0
6	49737584	.	A	G	4	0	4	0	3	7	0	0
6	49737590	.	A	G	3	2	5	0	1	6	0	0
6	49737914	.	A	G	4	2	6	0	1	7	0	0
6	49738333	.	A	G	4	3	7	0	0	7	0	0
6	49738348	.	A	G	4	0	4	0	3	7	0	0
6	49738479	.	A	G	9	9	18	0	1	19	0	0
6	49738534	.	A	G	8	0	8	0	8	16	0	0
6	49738787	.	G	A	7	6	13	0	0	13	0	0
6	49738823	.	A	G	2	10	12	0	1	13	0	0
6	49738863	.	A	G	6	0	6	0	13	19	0	0
6	49738903	.	A	G	6	1	7	0	9	16	0	0
6	49738962	.	T	A	12	7	19	0	1	20	0	0
6	49738977	.	T	C	10	11	21	0	2	23	0	0
6	49739084	.	G	A	4	9	13	0	2	15	0	0
6	49739151	.	A	G	8	3	11	0	0	11	0	0
6	49739246	.	C	T	5	2	7	0	0	7	0	0
6	49739503	.	G	A	7	3	10	0	0	10	0	0
6	49739698	.	A	T	8	7	15	0	0	15	0	0
6	49739845	.	T	C	6	9	15	0	1	16	0	0
6	49739868	.	A	G	4	7	11	0	1	12	0	0
6	49740059	.	A	G	10	9	19	0	2	21	0	0
6	49740067	.	C	A	10	8	18	0	1	19	0	0
6	49740247	.	G	A	7	7	14	0	0	14	0	0
6	49744383	.	T	C	9	8	17	0	0	17	0	0
6	49744443	.	C	T	2	1	3	0	0	3	0	0
6	49749689	.	G	A	0	2	2	0	4	6	0	0
6	49751721	.	T	C	13	10	23	0	2	25	0	0
6	49757650	.	T	C	10	18	28	0	1	29	0	0
6	49760016	.	T	C	1	2	3	0	1	4	0	0
6	49760278	.	G	C	16	17	33	0	2	35	0	0
6	49760581	.	A	T	5	12	17	0	0	17	0	0
6	49760609	.	A	G	8	12	20	0	1	21	0	0
6	49760740	.	A	G	6	7	13	0	2	15	0	0
6	49777475	.	C	T	1	1	2	0	0	2	0	0
6	49777598	.	C	T	2	2	4	0	0	4	0	0
6	49777640	.	A	C	3	2	5	0	0	5	0	0
6	49780905	.	T	A	2	3	5	0	0	5	0	0
6	49782450	.	A	C	1	3	4	0	0	4	0	0
6	49789216	.	C	T	0	4	4	0	1	5	0	0
6	49793870	.	T	G	0	1	1	0	0	1	0	0
6	49796925	.	A	T	0	2	2	0	0	2	0	0
6	49811940	.	C	T	0	8	8	0	11	19	0	0
6	49812476	.	G	A	13	8	21	0	0	21	0	0
6	49815667	.	T	G	0	1	1	0	0	1	0	0
6	49816372	.	A	G	6	12	18	0	1	19	0	0
6	49901591	.	C	T	13	16	29	0	0	29	0	0
6	49914387	.	T	C	8	16	24	0	5	29	0	0
6	49919063	.	A	G	0	1	1	0	0	1	0	0
6	49919211	.	C	T	17	10	27	0	0	27	0	0
6	49919232	.	A	T	19	9	28	0	2	30	0	0
6	49919326	.	T	A	13	12	25	0	2	27	0	0
6	49919358	.	C	T	12	18	30	0	2	32	0	0
6	49919908	.	A	G	20	0	20	0	14	34	0	0
6	49920119	.	C	A	13	5	18	0	0	18	0	0
6	49920218	.	A	T	10	16	26	0	1	27	0	0
6	49920253	.	A	G	10	1	11	0	15	26	0	0
6	49920392	.	C	T	3	4	7	0	0	7	0	0
6	49920405	.	A	C	2	4	6	0	0	6	0	0
6	49920433	.	A	G	3	0	3	0	8	11	0	0
6	49920442	.	C	T	3	7	10	0	0	10	0	0
6	49920468	.	G	A	4	16	20	0	0	20	0	0
6	49920498	.	T	A	5	13	18	0	1	19	0	0
6	49920514	.	T	C	4	14	18	0	0	18	0	0
6	49921770	.	G	A	0	2	2	0	9	11	0	0
6	49921853	.	T	A	5	4	9	2	1	12	0	0
6	49930806	.	G	C	1	0	1	0	0	1	0	0
6	49930809	.	T	C	1	0	1	0	0	1	0	0
6	52224090	.	A	G	28	13	41	0	3	44	0	0
6	52224406	.	A	G	38	19	57	0	1	58	0	0
6	52254103	.	A	G	1	2	3	0	0	3	0	0
6	52663438	.	T	A	7	3	10	0	1	11	0	0
6	54806566	.	T	C	5	6	11	0	1	12	0	0
6	55217903	.	A	G	1	2	3	0	0	3	0	0
6	55217907	.	A	G	2	2	4	0	0	4	0	0
6	55218017	.	A	G	1	3	4	0	0	4	0	0
6	55218127	.	A	G	5	6	11	0	2	13	0	0
6	55218137	.	A	G	2	9	11	0	0	12	1	0
6	57436358	.	G	T	3	2	5	0	0	5	0	0
6	57436359	.	G	T	3	2	5	0	0	5	0	0
6	57439021	.	T	C	2	3	5	0	2	7	0	0
6	57439429	.	C	T	1	1	2	0	0	2	0	0
6	57455557	.	T	C	0	2	2	0	0	2	0	0
6	57459817	.	C	T	3	4	7	0	1	8	0	0
6	57459823	.	T	G	3	4	7	0	0	7	0	0
6	57465261	.	T	C	1	0	1	0	0	1	0	0
6	57478900	.	C	T	0	4	4	0	5	9	0	0
6	57481377	.	A	G	6	2	8	0	1	9	0	0
6	57492086	.	G	A	6	11	17	0	1	18	0	0
6	57492208	.	G	A	6	6	12	0	2	14	0	0
6	57492209	.	A	G	7	7	14	0	0	14	0	0
6	57498040	.	G	A	2	3	5	0	0	5	0	0
6	57498088	.	T	C	2	3	5	0	0	5	0	0
6	57498253	.	A	G	4	5	9	0	1	10	0	0
6	57498255	.	A	T	3	3	6	0	3	10	1	0
6	57500563	.	G	A	3	1	4	0	0	4	0	0
6	57500608	.	C	T	4	3	7	0	0	7	0	0
6	57500617	.	G	C	3	0	3	0	4	7	0	0
6	57503925	.	C	T	0	2	2	0	2	4	0	0
6	57504571	.	G	T	2	3	5	0	2	7	0	0
6	57504592	.	C	T	3	6	9	0	0	9	0	0
6	57504646	.	G	A	0	2	2	0	0	2	0	0
6	57508317	.	G	A	0	1	1	0	0	1	0	0
6	57510245	.	T	A	1	0	1	0	1	2	0	0
6	57510254	.	T	A	2	0	2	0	0	2	0	0
6	57516039	.	A	C	1	2	3	0	0	3	0	0
6	57519053	.	T	C	3	1	4	0	2	6	0	0
6	57519534	.	G	A	3	3	6	0	0	6	0	0
6	57519597	.	G	C	5	4	9	0	0	9	0	0
6	57523366	.	C	A	0	1	1	0	3	4	0	0
6	57538896	.	G	C	2	1	3	0	0	3	0	0
6	57541942	.	T	A	11	6	17	0	0	17	0	0
6	57583996	.	T	C	3	1	4	0	0	4	0	0
6	57595160	.	T	C	4	4	8	0	0	8	0	0
6	57618934	.	C	T	5	3	8	0	1	9	0	0
6	57620177	.	T	C	19	14	33	0	5	38	0	0
6	57620315	.	A	C	20	16	36	0	2	38	0	0
6	57630819	.	A	G	8	6	14	0	1	15	0	0
6	57630879	.	C	A	1	6	7	0	0	7	0	0
6	57630961	.	T	C	9	6	15	0	4	19	0	0
6	57634880	.	T	G	10	6	16	0	1	17	0	0
6	57634922	.	G	A	7	10	17	0	1	18	0	0
6	57634949	.	G	A	3	5	8	0	0	8	0	0
6	57644779	.	C	T	1	0	1	0	0	1	0	0
6	57900462	.	C	T	0	7	7	0	0	7	0	0
6	57901172	.	C	T	10	11	21	0	0	21	0	0
6	57909090	.	T	C	9	0	9	0	14	23	0	0
6	57930218	.	A	G	2	0	2	0	0	2	0	0
6	57984041	.	C	T	2	1	3	0	0	3	0	0
6	58359460	.	T	C	1	0	1	0	0	1	0	0
6	58364435	.	C	T	0	2	2	0	0	2	0	0
6	58364534	.	A	T	0	2	2	0	0	2	0	0
6	58369530	.	T	C	0	1	1	0	0	1	0	0
6	58370814	.	A	G	3	1	4	0	3	7	0	0
6	58370817	.	C	T	3	4	7	0	0	7	0	0
6	58374023	.	C	T	1	1	2	0	0	2	0	0
6	58374026	.	C	A	1	1	2	0	0	2	0	0
6	58374508	.	T	C	2	2	4	0	0	4	0	0
6	58376845	.	T	C	3	1	4	0	0	4	0	0
6	58381405	.	T	G	1	0	1	0	2	3	0	0
6	58381417	.	T	C	1	3	4	0	0	4	0	0
6	58382846	.	A	G	2	0	2	0	1	3	0	0
6	58384067	.	A	G	4	0	4	0	1	5	0	0
6	58389115	.	A	C	0	7	7	0	0	7	0	0
6	58393919	.	A	T	5	2	7	0	1	8	0	0
6	58395372	.	G	A	3	3	6	0	1	7	0	0
6	58395444	.	G	A	0	9	9	0	13	22	0	0
6	58395451	.	C	A	13	8	21	0	0	21	0	0
6	58459557	.	G	C	2	2	4	0	0	4	0	0
6	58463718	.	C	T	3	4	7	0	0	7	0	0
6	58495301	.	G	A	7	4	11	0	1	12	0	0
6	58495315	.	A	C	5	3	8	0	2	10	0	0
6	58495573	.	G	T	5	3	8	0	0	8	0	0
6	58496002	.	A	G	4	0	4	1	5	10	0	0
6	58496148	.	T	C	3	3	6	0	0	6	0	0
6	58496280	.	C	A	4	3	7	0	0	7	0	0
6	58496633	.	T	C	1	2	3	0	1	4	0	0
6	58497660	.	T	G	2	0	2	0	3	5	0	0
6	58497864	.	A	T	3	4	7	0	0	7	0	0
6	58497993	.	C	T	3	2	5	0	0	5	0	0
6	58498087	.	G	A	4	2	6	0	0	6	0	0
6	58498101	.	T	G	3	2	5	0	0	5	0	0
6	58498600	.	G	T	3	4	7	0	0	7	0	0
6	58498996	.	G	A	4	2	6	0	0	6	0	0
6	58499168	.	T	G	1	0	1	0	5	6	0	0
6	58499600	.	A	C	4	2	6	0	0	6	0	0
6	58499657	.	T	C	2	5	7	0	0	7	0	0
6	58522771	.	A	G	5	11	16	0	2	18	0	0
6	58524509	.	C	A	1	3	4	0	0	4	0	0
6	58549100	.	A	G	0	0	0	0	1	1	0	0
6	58553387	.	G	A	5	4	9	0	0	9	0	0
6	58553424	.	T	C	16	14	30	0	0	30	0	0
6	58560682	.	G	A	18	25	43	0	1	44	0	0
6	58560718	.	G	A	13	27	40	0	7	47	0	0
6	58561057	.	T	C	19	13	32	0	1	33	0	0
6	58561081	.	A	C	17	17	34	0	2	36	0	0
6	58561190	.	C	G	12	16	28	0	0	28	0	0
6	58561494	.	G	T	22	1	23	0	1	24	0	0
6	58561673	.	A	G	17	4	21	0	4	25	0	0
6	58562407	.	T	A	11	6	17	0	5	22	0	0
6	58563093	.	T	A	15	25	40	0	1	41	0	0
6	58563157	.	T	C	14	29	43	0	2	45	0	0
6	58563159	.	G	A	15	29	44	0	1	45	0	0
6	58563229	.	A	C	22	9	31	0	0	31	0	0
6	58563374	.	C	T	13	14	27	0	1	28	0	0
6	58563415	.	A	T	12	7	19	0	0	19	0	0
6	58698673	.	A	G	2	6	8	0	0	8	0	0
6	58698737	.	C	T	4	9	13	0	0	13	0	0
6	58698875	.	C	A	3	2	5	0	0	5	0	0
6	58698910	.	T	G	3	1	4	0	2	6	0	0
6	58698960	.	C	T	2	3	5	0	0	5	0	0
6	58708185	.	A	G	5	4	9	0	0	9	0	0
6	58708194	.	T	C	6	5	11	0	0	11	0	0
6	58712458	.	G	C	5	9	14	0	0	14	0	0
6	58712477	.	C	G	4	5	9	0	1	10	0	0
6	58712540	.	G	A	0	6	6	0	5	11	0	0
6	58723254	.	C	G	4	3	7	0	0	7	0	0
6	58723383	.	T	G	11	6	17	0	0	17	0	0
6	58725930	.	T	C	7	12	19	0	2	21	0	0
6	58726154	.	A	G	6	3	9	0	3	12	0	0
6	58728706	.	G	A	0	5	5	0	6	11	0	0
6	58728825	.	A	G	9	11	20	0	0	20	0	0
6	58728858	.	G	A	0	12	12	0	9	21	0	0
6	58729053	.	T	A	3	3	6	0	0	6	0	0
6	58729059	.	T	G	3	0	3	0	3	6	0	0
6	58729100	.	C	G	4	1	5	0	2	7	0	0
6	58729120	.	T	C	5	8	13	0	1	14	0	0
6	58729145	.	G	A	11	8	19	0	0	19	0	0
6	58730208	.	A	T	3	9	12	0	0	12	0	0
6	58730393	.	T	C	3	8	11	0	0	11	0	0
6	58730410	.	A	T	3	8	11	0	1	12	0	0
6	58730474	.	A	T	6	5	11	0	0	11	0	0
6	58730493	.	G	C	5	4	9	0	0	9	0	0
6	58730603	.	A	G	2	2	4	0	1	5	0	0
6	58730657	.	T	C	6	4	10	0	4	14	0	0
6	58732475	.	C	G	20	15	35	0	2	37	0	0
6	58773647	.	T	G	2	1	3	0	0	3	0	0
6	58773785	.	C	T	0	11	11	0	13	24	0	0
6	58773788	.	A	G	12	13	25	0	1	26	0	0
6	58784810	.	A	G	8	6	14	0	1	15	0	0
6	58789896	.	A	G	2	2	4	0	0	4	0	0
6	58808298	.	G	A	2	1	3	0	0	3	0	0
6	58808328	.	C	T	1	1	2	0	0	2	0	0
6	58828036	.	A	G	3	6	9	0	0	9	0	0
6	58855648	.	C	T	1	2	3	0	0	3	0	0
6	58859737	.	G	A	0	0	0	0	7	7	0	0
6	58862341	.	G	A	0	8	8	0	7	15	0	0
6	58867018	.	A	G	24	0	24	0	19	43	0	0
6	58867362	.	A	G	19	7	26	0	1	27	0	0
6	58867470	.	C	A	19	22	41	0	1	42	0	0
6	58875665	.	T	C	6	0	6	0	2	8	0	0
6	58878077	.	T	C	0	1	1	0	0	1	0	0
6	58886232	.	A	C	1	3	4	0	0	4	0	0
6	58889105	.	G	A	3	3	6	0	0	6	0	0
6	58889713	.	T	C	1	4	5	0	0	5	0	0
6	58891765	.	T	A	3	5	8	0	1	9	0	0
6	58892365	.	C	T	0	2	2	0	3	5	0	0
6	58892935	.	G	A	2	3	5	0	0	5	0	0
6	58918095	.	T	C	1	0	1	0	0	1	0	0
6	58918506	.	A	G	12	0	12	0	21	33	0	0
6	58918676	.	T	G	18	16	34	0	1	35	0	0
6	58918693	.	T	C	18	19	37	0	0	37	0	0
6	58921434	.	C	A	2	5	7	0	0	7	0	0
6	58921506	.	G	T	5	6	11	0	0	11	0	0
6	58923246	.	T	C	4	2	6	0	2	8	0	0
6	58939261	.	T	C	1	4	5	0	0	5	0	0
6	58948931	.	C	T	2	5	7	0	0	7	0	0
6	58949325	.	C	T	0	1	1	0	1	2	0	0
6	58949337	.	G	A	1	1	2	0	0	2	0	0
6	58949364	.	C	A	0	1	1	0	1	2	0	0
6	58953302	.	G	T	1	3	4	0	0	4	0	0
6	58962056	.	C	A	1	2	3	0	0	3	0	0
6	59671954	.	A	G	8	0	8	0	6	14	0	0
6	59679633	.	G	A	0	8	8	0	6	14	0	0
6	59679636	.	C	A	4	8	12	0	1	13	0	0
6	59681450	.	A	T	4	2	6	0	2	8	0	0
6	59681464	.	G	A	4	2	6	0	0	6	0	0
6	59691533	.	C	T	8	12	20	0	2	22	0	0
6	59813578	.	G	A	0	4	4	0	2	6	0	0
6	59813608	.	A	G	5	11	16	0	1	17	0	0
6	59813857	.	G	A	0	2	2	0	3	5	0	0
6	59813905	.	A	G	13	0	13	0	13	26	0	0
6	59819362	.	C	T	17	6	23	0	1	24	0	0
6	59824482	.	C	T	18	20	38	0	2	40	0	0
6	59824496	.	C	T	17	20	37	0	2	39	0	0
6	59824672	.	C	T	15	15	30	0	11	41	0	0
6	59824736	.	C	T	14	15	29	0	2	31	0	0
6	59832922	.	T	C	6	14	20	0	1	21	0	0
6	59833006	.	T	A	10	10	20	0	2	22	0	0
6	59833007	.	A	G	10	9	19	0	3	22	0	0
6	59837587	.	C	G	5	6	11	0	0	11	0	0
6	59837747	.	G	A	0	9	9	0	4	13	0	0
6	59839033	.	G	A	0	8	8	0	6	14	0	0
6	59839048	.	G	A	6	6	12	0	0	12	0	0
6	59841394	.	G	A	0	9	9	0	12	21	0	0
6	59847692	.	C	T	1	2	3	0	0	3	0	0
6	59848119	.	C	T	15	13	28	0	1	29	0	0
6	59848345	.	T	C	23	16	39	0	3	42	0	0
6	59848894	.	T	C	18	12	30	1	2	33	0	0
6	59850253	.	C	T	17	17	34	0	1	35	0	0
6	59850308	.	T	C	19	22	41	0	1	42	0	0
6	59874147	.	G	A	0	2	2	0	3	5	0	0
6	59882680	.	T	C	11	11	22	0	2	24	0	0
6	59882704	.	T	C	10	7	17	0	1	18	0	0
6	59883154	.	G	A	6	7	13	0	0	13	0	0
6	59889640	.	G	T	0	2	2	0	3	5	0	0
6	59891289	.	T	C	7	7	14	0	0	14	0	0
6	59894548	.	T	C	10	13	23	0	2	25	0	0
6	59894580	.	T	A	11	9	20	0	2	22	0	0
6	59894719	.	T	C	8	6	14	0	1	15	0	0
6	59915599	.	T	C	1	1	2	0	0	2	0	0
6	59915608	.	T	C	1	0	1	0	0	1	0	0
6	59921661	.	T	G	10	9	19	0	1	20	0	0
6	59921685	.	T	C	11	9	20	0	0	20	0	0
6	59921788	.	A	C	6	4	10	0	1	11	0	0
6	59939277	.	G	A	10	10	20	0	2	22	0	0
6	59945088	.	A	G	1	2	3	1	0	4	0	0
6	59947097	.	C	A	1	1	2	0	0	2	0	0
6	59949374	.	C	A	2	4	6	0	0	6	0	0
6	59949585	.	A	G	1	1	2	0	0	2	0	0
6	59949591	.	G	A	1	1	2	0	0	2	0	0
6	59951038	.	C	T	7	4	11	0	1	12	0	0
6	59951324	.	C	G	1	2	3	0	0	3	0	0
6	59971416	.	C	T	19	21	40	0	0	40	0	0
6	59971598	.	A	G	34	14	48	0	2	50	0	0
6	59971711	.	G	A	15	20	35	0	0	35	0	0
6	59971718	.	C	A	14	20	34	0	0	34	0	0
6	59971897	.	G	A	2	2	4	1	0	5	0	0
6	59972259	.	T	A	8	19	27	1	0	28	0	0
6	60031520	.	G	A	9	7	16	0	0	16	0	0
6	60031641	.	C	T	0	1	1	0	7	8	0	0
6	60043150	.	A	G	4	8	12	0	1	13	0	0
6	60043179	.	T	C	6	5	11	0	0	11	0	0
6	60043229	.	A	T	2	2	4	0	0	4	0	0
6	60043297	.	T	A	5	1	6	0	0	6	0	0
6	60043413	.	G	A	10	3	13	0	0	13	0	0
6	60043580	.	G	C	1	2	3	0	0	3	0	0
6	60044319	.	T	A	4	3	7	0	1	8	0	0
6	60044320	.	A	T	4	4	8	0	0	8	0	0
7	837955	.	T	G	3	3	6	0	1	7	0	0
7	841689	.	G	A	2	2	4	0	0	4	0	0
7	846972	.	T	C	5	3	8	0	0	8	0	0
7	847189	.	A	T	5	7	12	0	0	12	0	0
7	861057	.	G	C	2	4	6	0	0	6	0	0
7	1416647	.	C	A	4	4	8	0	0	8	0	0
7	1418299	.	A	G	1	5	6	0	1	7	0	0
7	1418310	.	T	C	1	5	6	0	0	6	0	0
7	1418631	.	T	C	0	2	2	0	0	2	0	0
7	3931029	.	A	G	33	11	44	0	1	45	0	0
7	3931264	.	C	T	21	27	48	0	3	51	0	0
7	3931396	.	A	T	25	27	52	0	2	54	0	0
7	3931543	.	A	T	20	12	32	0	1	33	0	0
7	3931598	.	G	T	25	20	45	0	1	46	0	0
7	3932044	.	T	C	17	7	24	0	1	25	0	0
7	3932209	.	A	T	11	19	30	0	1	32	1	0
7	3932402	.	T	C	14	17	31	0	3	34	0	0
7	3932405	.	A	T	14	19	33	0	1	34	0	0
7	3932463	.	T	G	14	5	19	0	2	21	0	0
7	3932523	.	T	C	8	2	10	0	0	10	0	0
7	3932546	.	C	A	2	2	4	0	0	4	0	0
7	3932694	.	G	A	24	8	32	0	2	34	0	0
7	3932698	.	T	C	28	8	36	0	0	36	0	0
7	3932935	.	C	A	19	10	29	0	3	32	0	0
7	3932998	.	A	G	14	23	37	0	0	37	0	0
7	3933121	.	G	A	26	25	51	0	1	52	0	0
7	3933243	.	C	A	22	8	30	0	1	32	1	0
7	3933271	.	C	T	25	7	32	0	3	35	0	0
7	3933383	.	A	C	12	1	13	0	19	32	0	0
7	3933481	.	T	C	13	0	13	0	13	26	0	0
7	3933483	.	C	T	0	12	12	0	14	26	0	0
7	3933998	.	C	T	14	10	24	0	2	26	0	0
7	3934038	.	A	T	12	12	24	0	1	25	0	0
7	3934208	.	T	C	19	3	22	0	1	23	0	0
7	3934387	.	C	T	18	11	29	0	2	31	0	0
7	3934428	.	G	T	16	17	33	0	3	36	0	0
7	3934551	.	A	T	9	7	16	1	0	17	0	0
7	3934645	.	A	C	2	10	12	0	0	12	0	0
7	3934818	.	G	A	11	7	18	0	3	21	0	0
7	3934840	.	T	A	14	5	19	0	1	20	0	0
7	3934970	.	A	G	5	10	15	0	3	18	0	0
7	3935055	.	T	C	10	12	22	0	0	22	0	0
7	3935123	.	A	G	6	18	24	0	2	26	0	0
7	3935171	.	G	C	16	9	25	0	0	25	0	0
7	3935283	.	G	A	11	12	23	0	0	23	0	0
7	3935737	.	C	T	0	13	13	0	18	31	0	0
7	3935788	.	C	A	2	10	12	0	0	12	0	0
7	3935824	.	C	T	0	11	11	1	0	12	0	0
7	3936127	.	C	T	0	10	10	0	14	24	0	0
7	3936702	.	A	G	2	4	6	0	2	8	0	0
7	3936764	.	G	A	5	8	13	0	0	13	0	0
7	3936946	.	C	T	0	3	3	0	5	8	0	0
7	3951115	.	G	A	2	1	3	0	1	4	0	0
7	3955628	.	G	A	3	1	4	0	0	4	0	0
7	4088334	.	C	T	18	13	31	0	1	32	0	0
7	4088545	.	C	T	0	15	15	0	14	29	0	0
7	4088680	.	G	A	8	16	24	0	2	26	0	0
7	4088727	.	A	T	26	17	43	0	1	44	0	0
7	4088832	.	A	G	16	21	37	0	2	39	0	0
7	4089042	.	A	G	15	16	31	0	3	34	0	0
7	4089090	.	G	A	12	8	20	0	0	20	0	0
7	4095265	.	C	T	1	10	11	0	17	28	0	0
7	4100931	.	C	T	8	9	17	0	2	19	0	0
7	4100967	.	G	A	16	16	32	0	1	33	0	0
7	4110441	.	T	C	0	0	0	0	1	1	0	0
7	4174962	.	G	A	0	5	5	0	3	8	0	0
7	4175054	.	G	A	2	4	6	0	0	6	0	0
7	4175078	.	G	A	2	3	5	0	0	5	0	0
7	4177088	.	T	C	1	1	2	0	0	2	0	0
7	4180419	.	G	A	1	2	3	0	0	3	0	0
7	4180742	.	C	T	1	4	5	0	0	5	0	0
7	4180984	.	G	A	0	3	3	0	0	3	0	0
7	4180988	.	C	T	0	3	3	0	0	3	0	0
7	4181167	.	C	T	1	2	3	0	1	4	0	0
7	4181728	.	G	A	3	5	8	1	0	9	0	0
7	4182432	.	T	A	1	3	4	0	0	4	0	0
7	4183345	.	C	T	1	2	3	0	0	3	0	0
7	4183996	.	C	T	1	3	4	0	0	4	0	0
7	4184141	.	A	G	3	2	5	0	0	5	0	0
7	4184971	.	A	T	1	4	5	0	1	6	0	0
7	4185066	.	T	C	4	2	6	0	0	6	0	0
7	4185069	.	T	C	4	2	6	0	0	6	0	0
7	4185126	.	G	T	9	5	14	0	0	14	0	0
7	4185160	.	A	T	7	8	15	0	0	16	1	0
7	4185569	.	A	G	1	5	6	0	0	6	0	0
7	4186499	.	A	G	4	4	8	0	1	9	0	0
7	5180761	.	T	C	2	0	2	0	2	4	0	0
7	7039313	.	A	G	0	1	1	0	0	1	0	0
7	7248193	.	C	T	9	15	24	1	4	29	0	0
7	7248212	.	A	T	6	12	18	1	9	28	0	0
7	7371790	.	T	A	3	2	5	0	0	5	0	0
7	7372404	.	A	G	8	9	17	0	2	19	0	0
7	7478281	.	T	C	3	5	8	0	0	8	0	0
7	7478285	.	T	C	5	3	8	0	0	8	0	0
7	7478533	.	T	C	8	11	19	0	0	19	0	0
7	7478546	.	T	C	9	11	20	0	0	20	0	0
7	7552113	.	G	A	7	9	16	0	0	16	0	0
7	7597059	.	A	G	3	0	3	0	2	5	0	0
7	7608920	.	G	A	0	7	7	0	7	14	0	0
7	7608944	.	T	G	9	0	9	0	8	17	0	0
7	7608965	.	C	T	8	8	16	0	0	16	0	0
7	7611758	.	C	T	16	11	27	0	0	27	0	0
7	7611803	.	C	A	9	5	14	0	9	23	0	0
7	7611866	.	T	C	16	11	27	0	1	28	0	0
7	7617855	.	T	C	20	14	34	0	0	34	0	0
7	7617963	.	C	G	14	17	31	0	1	32	0	0
7	7624082	.	A	G	23	21	44	0	3	47	0	0
7	7624090	.	T	C	26	19	45	0	3	48	0	0
7	7641230	.	A	T	19	20	39	0	3	42	0	0
7	7641351	.	G	A	19	15	34	0	1	35	0	0
7	7641353	.	G	A	19	15	34	0	1	35	0	0
7	7641559	.	C	T	22	21	43	0	1	44	0	0
7	7641567	.	C	T	20	22	42	0	0	42	0	0
7	7641608	.	A	G	15	18	33	0	1	34	0	0
7	7641678	.	T	A	22	9	31	0	0	31	0	0
7	7641976	.	T	C	20	5	25	0	1	26	0	0
7	7641984	.	G	T	19	5	24	0	2	26	0	0
7	7642730	.	C	T	22	11	33	0	0	33	0	0
7	7642819	.	G	A	18	18	36	0	1	37	0	0
7	7642840	.	T	A	13	15	28	0	2	30	0	0
7	7642856	.	C	T	14	15	29	0	2	31	0	0
7	7642944	.	C	T	9	6	15	0	0	15	0	0
7	7642991	.	T	A	5	3	8	0	0	9	1	0
7	7643184	.	A	G	14	0	14	0	17	31	0	0
7	7643348	.	G	A	20	19	39	0	1	40	0	0
7	7643362	.	T	A	21	20	41	0	1	42	0	0
7	7643488	.	A	G	24	22	46	0	6	52	0	0
7	7643629	.	A	G	28	28	56	0	4	60	0	0
7	7662467	.	C	G	6	14	20	0	2	22	0	0
7	7662475	.	T	C	7	0	7	0	14	21	0	0
7	7662527	.	A	C	6	7	13	0	1	15	1	0
7	7662580	.	G	A	6	20	26	0	0	26	0	0
7	7662872	.	A	C	11	14	25	0	0	25	0	0
7	7662978	.	A	C	9	10	19	0	0	19	0	0
7	7663017	.	T	A	9	14	23	0	2	25	0	0
7	7663048	.	A	G	15	13	28	0	2	30	0	0
7	7663132	.	A	G	14	11	25	0	0	25	0	0
7	7663152	.	A	T	12	9	21	0	1	22	0	0
7	7663236	.	T	C	13	0	13	0	0	14	1	0
7	7663254	.	G	A	11	6	17	0	0	17	0	0
7	7663320	.	C	G	17	7	24	0	1	25	0	0
7	7663449	.	A	C	8	0	8	0	15	23	0	0
7	7663453	.	A	T	8	16	24	0	0	24	0	0
7	7663682	.	C	T	1	4	5	0	9	14	0	0
7	7663902	.	G	T	8	4	12	0	0	12	0	0
7	7664011	.	A	G	3	2	5	0	0	5	0	0
7	7664026	.	G	A	2	3	5	0	0	5	0	0
7	7664503	.	G	A	0	1	1	0	1	2	0	0
7	7664558	.	G	T	1	8	9	1	2	12	0	0
7	7664838	.	G	T	10	2	12	0	1	13	0	0
7	7664870	.	G	T	4	5	9	0	0	9	0	0
7	7664882	.	G	C	4	4	8	0	1	9	0	0
7	7664912	.	A	C	3	5	8	0	1	9	0	0
7	7665338	.	G	T	9	5	14	0	0	14	0	0
7	7665353	.	T	A	10	5	15	0	1	16	0	0
7	7665480	.	A	C	10	8	18	0	0	18	0	0
7	7665952	.	T	A	2	4	6	0	0	6	0	0
7	7665961	.	T	C	2	4	6	0	0	6	0	0
7	7666388	.	G	A	5	14	19	0	2	21	0	0
7	7674378	.	T	C	7	0	7	0	10	17	0	0
7	7674462	.	C	G	5	3	8	0	0	8	0	0
7	7674474	.	T	A	1	1	2	0	0	2	0	0
7	7676086	.	C	T	2	2	4	0	0	4	0	0
7	7676112	.	C	T	2	5	7	0	2	9	0	0
7	7696726	.	G	C	5	8	13	0	1	14	0	0
7	7696742	.	A	G	5	11	16	0	0	16	0	0
7	7696785	.	T	A	2	5	7	0	1	8	0	0
7	7696794	.	G	T	0	6	6	0	3	9	0	0
7	7700867	.	G	A	0	1	1	0	0	1	0	0
7	7700965	.	T	G	7	0	7	0	5	12	0	0
7	7700987	.	T	C	7	10	17	0	0	17	0	0
7	7701016	.	G	C	3	8	11	0	1	12	0	0
7	7705993	.	C	G	4	0	4	0	5	9	0	0
7	7706005	.	C	T	6	5	11	0	1	12	0	0
7	7706702	.	G	A	0	10	10	0	6	16	0	0
7	7706869	.	A	G	2	6	8	0	0	8	0	0
7	7706997	.	C	A	6	13	19	0	0	19	0	0
7	7707029	.	T	G	8	9	17	0	1	18	0	0
7	7707191	.	A	C	5	3	8	0	0	8	0	0
7	7708572	.	T	C	1	3	4	0	0	4	0	0
7	7708714	.	T	C	5	6	11	0	0	11	0	0
7	7708826	.	T	G	2	4	6	0	0	6	0	0
7	7708840	.	C	A	1	2	3	0	1	4	0	0
7	7709061	.	A	G	2	3	5	0	0	5	0	0
7	7709233	.	C	T	1	2	3	0	0	3	0	0
7	7709252	.	A	G	3	3	6	0	0	6	0	0
7	7709282	.	T	A	3	2	5	0	0	5	0	0
7	7720139	.	A	G	0	1	1	0	0	1	0	0
7	7779047	.	A	T	1	6	7	0	1	8	0	0
7	7779091	.	A	G	1	5	6	0	0	6	0	0
7	7796019	.	T	C	1	1	2	0	0	2	0	0
7	7797397	.	T	G	3	3	6	0	0	6	0	0
7	8694999	.	T	A	2	2	4	0	0	4	0	0
7	8695001	.	C	A	2	2	4	0	0	4	0	0
7	8695107	.	A	G	4	2	6	0	0	6	0	0
7	8890495	.	C	T	1	11	12	0	4	16	0	0
7	8890515	.	G	C	6	0	6	0	15	21	0	0
7	8891399	.	T	C	6	0	6	0	2	8	0	0
7	8891402	.	T	C	5	0	5	0	3	8	0	0
7	8891755	.	T	G	8	11	19	0	1	20	0	0
7	8909417	.	A	G	0	1	1	0	0	1	0	0
7	8909438	.	C	T	1	2	3	0	0	3	0	0
7	9229327	.	A	C	3	4	7	0	0	7	0	0
7	9232615	.	C	T	1	3	4	0	0	4	0	0
7	9232621	.	C	G	1	3	4	0	0	4	0	0
7	9238631	.	A	G	1	0	1	0	1	2	0	0
7	9261589	.	T	C	1	8	9	0	0	9	0	0
7	9291049	.	C	A	16	6	22	0	1	23	0	0
7	9302654	.	G	A	0	2	2	0	6	8	0	0
7	9302664	.	T	C	6	2	8	0	0	8	0	0
7	9302841	.	A	G	10	3	13	0	0	13	0	0
7	9302990	.	T	A	13	2	15	0	0	15	0	0
7	9303000	.	T	A	14	3	17	0	1	18	0	0
7	9308683	.	A	G	14	22	36	0	0	36	0	0
7	9308715	.	C	T	15	21	36	0	0	36	0	0
7	9308817	.	A	G	3	2	5	0	0	5	0	0
7	9312770	.	G	A	0	7	7	0	9	16	0	0
7	9319626	.	T	C	13	16	29	0	3	32	0	0
7	9320085	.	A	G	3	2	5	0	0	5	0	0
7	9320123	.	A	T	4	2	6	0	0	6	0	0
7	9320431	.	A	T	8	12	20	0	0	20	0	0
7	9320489	.	A	G	12	9	21	0	0	21	0	0
7	9320719	.	C	T	12	17	29	0	1	30	0	0
7	9321188	.	G	A	8	7	15	0	0	15	0	0
7	9321374	.	C	T	4	2	6	0	0	6	0	0
7	9321375	.	T	A	4	2	6	0	0	6	0	0
7	9321528	.	A	C	7	5	12	0	2	14	0	0
7	9321529	.	C	G	8	1	9	0	5	14	0	0
7	9321800	.	G	A	0	12	12	0	8	20	0	0
7	9321981	.	G	T	21	18	39	0	1	40	0	0
7	9322176	.	C	A	22	4	26	0	2	28	0	0
7	9322178	.	T	C	24	4	28	0	0	28	0	0
7	9322216	.	A	G	16	5	21	0	1	22	0	0
7	9322271	.	G	C	13	11	24	0	0	24	0	0
7	9322441	.	C	T	6	12	18	0	0	18	0	0
7	9509429	.	C	T	1	4	5	0	0	5	0	0
7	9509450	.	C	T	2	4	6	0	0	6	0	0
7	9509567	.	G	T	0	2	2	0	2	4	0	0
7	9509583	.	A	C	2	3	5	0	0	5	0	0
7	9511184	.	C	T	3	3	6	0	3	9	0	0
7	9739812	.	T	C	1	0	1	0	0	1	0	0
7	10873886	.	A	G	4	6	10	0	0	10	0	0
7	10873921	.	A	G	14	0	14	0	4	18	0	0
7	10875101	.	A	G	7	25	32	1	4	37	0	0
7	10875110	.	A	G	26	0	26	1	13	40	0	0
7	10875187	.	A	G	18	8	26	0	1	27	0	0
7	10875552	.	A	G	18	8	26	0	1	27	0	0
7	10875930	.	A	G	19	8	27	0	1	28	0	0
7	10875937	.	A	G	16	11	27	0	3	30	0	0
7	11005758	.	T	C	6	2	8	0	0	8	0	0
7	11340660	.	A	G	6	0	6	0	5	11	0	0
7	11340964	.	A	G	3	0	3	0	4	7	0	0
7	12843975	.	T	C	1	0	1	0	4	5	0	0
7	12844513	.	T	C	1	4	5	0	0	5	0	0
7	12844537	.	T	C	6	4	10	0	1	11	0	0
7	13334255	.	A	G	1	2	3	0	0	3	0	0
7	13334263	.	A	G	1	2	3	0	0	3	0	0
7	13334754	.	G	A	1	7	8	0	0	8	0	0
7	13618289	.	A	G	2	2	4	0	0	4	0	0
7	13618290	.	A	G	1	3	4	0	0	4	0	0
7	14206383	.	C	T	2	2	4	0	0	4	0	0
7	15604643	.	A	G	2	0	2	0	2	4	0	0
7	15605276	.	A	T	4	0	4	0	2	6	0	0
7	15607809	.	A	G	4	3	7	0	1	8	0	0
7	17104092	.	T	A	0	2	2	0	0	2	0	0
7	17755699	.	C	T	0	3	3	0	2	5	0	0
7	17757261	.	T	G	4	49	53	0	4	57	0	0
7	17765959	.	T	C	2	2	4	0	0	4	0	0
7	17765961	.	T	C	2	2	4	0	0	4	0	0
7	17942481	.	A	G	2	5	7	0	0	7	0	0
7	17969792	.	A	G	2	2	4	0	2	6	0	0
7	18187356	.	A	G	1	7	8	0	0	8	0	0
7	18464665	.	A	G	1	7	8	0	1	9	0	0
7	18594353	.	T	G	3	1	4	0	8	12	0	0
7	19072665	.	T	C	6	4	10	0	0	10	0	0
7	19072767	.	T	A	0	10	10	0	1	11	0	0
7	19073708	.	T	C	9	9	18	0	0	18	0	0
7	19073716	.	T	C	5	9	14	0	1	15	0	0
7	19073788	.	T	C	2	14	16	0	1	17	0	0
7	19073818	.	T	C	6	3	9	0	0	9	0	0
7	20601586	.	T	C	5	2	7	0	0	7	0	0
7	20780758	.	T	C	6	6	12	0	2	14	0	0
7	20780797	.	T	C	12	5	17	0	0	17	0	0
7	21089396	.	C	A	6	0	6	0	3	9	0	0
7	22295624	.	G	A	0	1	1	0	2	3	0	0
7	22295636	.	T	G	2	0	2	0	1	3	0	0
7	22322492	.	T	C	2	2	4	0	1	5	0	0
7	22323373	.	A	G	1	0	1	0	2	3	0	0
7	22323821	.	A	G	8	2	10	0	0	10	0	0
7	22323884	.	T	G	7	3	10	0	0	10	0	0
7	22323934	.	C	T	4	2	6	0	0	6	0	0
7	22323970	.	C	T	7	2	9	0	0	9	0	0
7	22323976	.	C	T	4	2	6	0	2	8	0	0
7	22324029	.	G	A	0	2	2	0	10	12	0	0
7	22324261	.	C	T	3	3	6	0	0	6	0	0
7	22324880	.	C	T	3	2	5	0	0	5	0	0
7	22324900	.	A	T	2	2	4	0	2	6	0	0
7	22626223	.	T	A	8	5	13	0	0	13	0	0
7	22626525	.	A	T	1	2	3	0	0	3	0	0
7	22626669	.	A	G	1	3	4	0	1	5	0	0
7	22630003	.	T	A	17	21	38	0	0	38	0	0
7	22630087	.	A	G	15	17	32	0	1	33	0	0
7	22630096	.	T	C	14	0	14	0	12	26	0	0
7	22630189	.	C	T	20	14	34	0	0	34	0	0
7	22630297	.	A	G	16	14	30	0	1	31	0	0
7	22630581	.	C	T	2	22	24	0	24	48	0	0
7	22630655	.	T	C	17	0	17	0	19	36	0	0
7	22630670	.	A	G	10	12	22	0	1	23	0	0
7	22632253	.	T	A	10	17	27	0	2	29	0	0
7	22632850	.	C	A	0	2	2	0	3	5	0	0
7	22632873	.	G	A	3	3	6	0	0	6	0	0
7	22718516	.	C	T	3	10	13	0	0	13	0	0
7	22718686	.	C	G	5	3	8	0	0	8	0	0
7	22723701	.	G	A	0	0	0	0	3	3	0	0
7	22726604	.	A	G	0	1	1	0	0	1	0	0
7	22732755	.	T	C	0	2	2	0	0	2	0	0
7	22735394	.	C	A	8	9	17	0	1	18	0	0
7	22735421	.	A	T	3	3	6	0	1	7	0	0
7	22751600	.	G	A	9	9	18	0	0	18	0	0
7	22760761	.	G	T	8	16	24	0	0	24	0	0
7	22806668	.	G	A	1	8	9	0	11	20	0	0
7	22809956	.	G	A	6	9	15	0	0	15	0	0
7	22810208	.	C	T	11	8	19	0	2	21	0	0
7	22816078	.	G	A	0	12	12	0	10	22	0	0
7	22816487	.	T	C	7	5	12	0	0	12	0	0
7	22819933	.	T	A	17	12	29	0	5	34	0	0
7	22819975	.	A	T	10	8	18	0	19	38	1	0
7	22820704	.	C	G	3	0	3	0	6	9	0	0
7	22824278	.	A	G	2	3	5	0	0	5	0	0
7	22830405	.	G	A	2	2	4	0	0	4	0	0
7	22830423	.	G	A	2	2	4	0	0	4	0	0
7	22833512	.	T	C	3	3	6	0	0	6	0	0
7	22833739	.	C	T	2	2	4	0	0	4	0	0
7	22834021	.	G	A	2	4	6	0	0	6	0	0
7	22838359	.	T	C	12	6	18	0	0	18	0	0
7	22843256	.	A	G	1	6	7	0	1	8	0	0
7	22843310	.	A	T	19	20	39	0	1	40	0	0
7	22849948	.	A	T	22	12	34	0	1	35	0	0
7	22849949	.	C	T	22	13	35	0	0	35	0	0
7	22850098	.	T	C	21	20	41	0	1	42	0	0
7	22850137	.	T	A	18	18	36	0	1	37	0	0
7	22850231	.	T	G	20	12	32	0	1	33	0	0
7	22850234	.	C	T	19	11	30	0	3	33	0	0
7	22850277	.	A	T	12	16	28	0	2	30	0	0
7	22850340	.	T	A	11	13	24	0	2	26	0	0
7	22850365	.	C	T	14	13	27	0	0	27	0	0
7	22850446	.	C	A	12	14	26	0	5	31	0	0
7	22851036	.	C	T	12	19	31	0	1	32	0	0
7	22851133	.	C	T	24	25	49	0	5	54	0	0
7	22851739	.	A	C	29	22	51	0	0	51	0	0
7	22911938	.	T	C	3	6	9	0	1	10	0	0
7	22911984	.	G	T	1	5	6	0	0	6	0	0
7	22912419	.	G	T	3	3	6	0	0	6	0	0
7	22912642	.	A	G	2	6	8	0	1	9	0	0
7	23492044	.	C	A	3	2	5	0	0	5	0	0
7	23492644	.	T	C	3	4	7	0	0	7	0	0
7	23492695	.	T	C	3	2	5	0	0	5	0	0
7	23492704	.	C	T	3	1	4	0	0	4	0	0
7	23493168	.	T	C	2	2	4	0	0	4	0	0
7	23493485	.	T	G	2	2	4	0	0	4	0	0
7	23493841	.	T	C	3	4	7	0	0	7	0	0
7	23494107	.	A	T	4	2	6	0	0	6	0	0
7	23496152	.	G	A	6	4	10	0	1	11	0	0
7	23533440	.	G	T	0	7	7	0	9	16	0	0
7	23533464	.	A	G	5	0	5	0	4	9	0	0
7	23536981	.	T	A	8	10	18	0	1	19	0	0
7	23539695	.	C	A	22	11	33	0	0	33	0	0
7	23539824	.	G	A	9	4	13	0	2	15	0	0
7	23539951	.	G	A	0	11	11	0	16	27	0	0
7	23540270	.	T	A	5	7	12	0	1	13	0	0
7	23540323	.	G	A	8	2	10	0	0	10	0	0
7	23540328	.	C	T	9	1	10	0	1	11	0	0
7	23540414	.	T	C	9	12	21	0	1	22	0	0
7	23540505	.	A	C	11	14	25	0	1	26	0	0
7	23540540	.	A	G	16	0	16	0	14	30	0	0
7	23540629	.	T	C	7	12	19	0	2	21	0	0
7	23540643	.	A	G	9	14	23	0	1	24	0	0
7	23540887	.	G	A	16	14	30	0	1	31	0	0
7	23541083	.	C	T	14	4	18	0	0	18	0	0
7	23541230	.	A	C	14	9	23	0	0	23	0	0
7	23541508	.	T	G	10	8	18	0	0	18	0	0
7	23541696	.	G	T	14	10	24	0	1	25	0	0
7	23541847	.	G	C	16	20	36	0	0	36	0	0
7	23541852	.	T	C	14	23	37	0	0	37	0	0
7	23542151	.	T	G	14	11	25	0	0	25	0	0
7	23542543	.	C	T	16	21	37	0	2	39	0	0
7	23542586	.	G	T	18	12	30	0	1	31	0	0
7	23542678	.	C	A	17	14	31	0	0	31	0	0
7	23542785	.	T	G	20	0	20	0	18	38	0	0
7	23542794	.	T	C	17	19	36	0	1	37	0	0
7	23561158	.	C	T	0	4	4	0	3	7	0	0
7	23561431	.	G	A	7	8	15	0	0	15	0	0
7	23561605	.	A	G	6	5	11	0	0	11	0	0
7	23563034	.	C	T	7	4	11	0	0	11	0	0
7	23691846	.	G	A	4	5	9	0	1	10	0	0
7	23696140	.	C	T	2	2	4	0	0	4	0	0
7	23704869	.	G	A	1	0	1	1	0	2	0	0
7	23707079	.	G	A	6	2	8	0	0	8	0	0
7	23710275	.	T	A	7	10	17	0	1	18	0	0
7	23710311	.	C	T	12	19	31	0	0	31	0	0
7	23713828	.	G	T	3	2	5	0	0	5	0	0
7	23713855	.	T	G	2	0	2	0	3	5	0	0
7	23718778	.	C	G	1	3	4	0	0	4	0	0
7	23718924	.	A	G	3	11	14	0	1	15	0	0
7	23724311	.	T	A	12	12	24	0	0	24	0	0
7	23724418	.	C	T	14	19	33	0	2	35	0	0
7	23724556	.	C	A	4	17	21	0	0	21	0	0
7	23724607	.	C	T	15	10	25	0	1	26	0	0
7	23725087	.	A	G	9	9	18	0	0	19	1	0
7	23725239	.	C	T	14	10	24	0	0	24	0	0
7	23725276	.	T	C	8	14	22	0	0	22	0	0
7	23725285	.	A	T	10	14	24	0	0	24	0	0
7	23725366	.	T	A	10	12	22	0	3	25	0	0
7	23725426	.	C	A	20	5	25	0	2	27	0	0
7	23731275	.	A	C	0	2	2	0	0	2	0	0
7	23731278	.	A	G	0	2	2	0	0	2	0	0
7	23749277	.	G	A	15	12	27	0	1	28	0	0
7	23749490	.	G	A	15	14	29	0	0	29	0	0
7	23749513	.	A	T	17	12	29	0	2	31	0	0
7	23749679	.	A	G	12	6	18	0	0	18	0	0
7	23749831	.	C	A	7	11	18	0	0	18	0	0
7	23749954	.	A	T	12	25	37	0	0	37	0	0
7	23750080	.	T	C	10	11	21	0	1	22	0	0
7	23750665	.	C	T	7	3	10	0	1	11	0	0
7	23750955	.	C	T	12	9	21	0	0	21	0	0
7	23750962	.	A	T	11	7	18	0	1	19	0	0
7	23751043	.	C	T	10	8	18	0	0	18	0	0
7	23751106	.	A	C	11	2	13	0	16	29	0	0
7	23751188	.	T	G	5	7	12	0	0	12	0	0
7	23751197	.	A	T	5	6	11	0	0	11	0	0
7	23751348	.	A	C	6	3	9	0	1	10	0	0
7	23751363	.	A	T	8	5	13	0	0	13	0	0
7	23751420	.	T	C	9	2	11	0	0	11	0	0
7	23751866	.	C	G	11	13	24	0	1	25	0	0
7	23752180	.	A	G	2	7	9	0	0	9	0	0
7	23752519	.	C	T	8	2	10	0	0	10	0	0
7	23753061	.	A	G	2	6	8	0	0	8	0	0
7	23753070	.	T	C	2	7	9	0	0	9	0	0
7	23753154	.	C	T	4	3	7	0	0	7	0	0
7	23753341	.	T	A	8	3	11	0	0	11	0	0
7	23753713	.	T	C	5	0	5	0	4	9	0	0
7	23753873	.	T	C	2	2	4	0	1	5	0	0
7	23753999	.	A	G	5	3	8	0	0	8	0	0
7	23754338	.	C	T	4	2	6	0	0	6	0	0
7	23754467	.	T	A	4	7	11	0	2	13	0	0
7	23754498	.	G	A	5	6	11	0	0	11	0	0
7	23754927	.	T	C	5	5	10	0	0	10	0	0
7	23755082	.	C	G	1	5	6	0	0	6	0	0
7	23755668	.	G	C	3	3	6	0	1	7	0	0
7	23755734	.	C	T	2	3	5	0	0	5	0	0
7	23756208	.	T	C	7	4	11	0	1	12	0	0
7	23756475	.	A	G	6	3	9	0	0	9	0	0
7	23756545	.	C	T	6	9	15	0	0	15	0	0
7	23756645	.	A	C	3	2	5	0	0	5	0	0
7	23768138	.	G	A	1	3	4	0	0	4	0	0
7	23768153	.	G	A	1	3	4	0	0	4	0	0
7	23768222	.	C	A	2	0	2	0	0	2	0	0
7	23857939	.	C	A	3	2	5	0	0	5	0	0
7	23883399	.	G	A	9	13	22	0	1	23	0	0
7	23883548	.	A	C	20	15	35	0	6	41	0	0
7	23883970	.	C	T	11	16	27	0	0	27	0	0
7	23884004	.	G	A	14	12	26	0	2	28	0	0
7	23884058	.	T	C	17	10	27	0	1	28	0	0
7	23884061	.	C	G	16	10	26	0	2	28	0	0
7	23884445	.	C	T	19	29	48	0	2	50	0	0
7	23884641	.	A	G	21	0	21	0	19	40	0	0
7	23884667	.	C	A	17	19	36	0	0	36	0	0
7	23887738	.	T	G	6	5	11	0	2	13	0	0
7	23887784	.	C	T	10	7	17	0	0	17	0	0
7	23888099	.	A	G	8	8	16	0	0	16	0	0
7	23888155	.	T	G	8	9	17	0	3	20	0	0
7	23889947	.	C	T	12	8	20	0	2	22	0	0
7	23892884	.	G	A	4	2	6	0	0	6	0	0
7	23894605	.	G	A	4	4	8	0	0	8	0	0
7	23907785	.	C	A	17	14	31	0	2	33	0	0
7	23909369	.	A	C	21	21	42	0	2	44	0	0
7	23909456	.	T	G	20	18	38	0	1	39	0	0
7	23909699	.	C	G	20	0	20	0	18	38	0	0
7	23909735	.	T	C	20	16	36	0	0	36	0	0
7	23909757	.	C	T	16	15	31	0	0	31	0	0
7	23909975	.	A	G	20	24	44	0	0	44	0	0
7	23915104	.	G	A	1	18	19	0	22	41	0	0
7	23915203	.	C	T	28	30	58	0	2	60	0	0
7	23915296	.	C	T	26	31	57	0	1	58	0	0
7	23915379	.	T	A	26	27	53	0	1	54	0	0
7	23915485	.	A	T	25	33	58	0	2	60	0	0
7	23915731	.	G	T	26	19	45	0	0	46	1	0
7	23915916	.	T	A	31	25	56	0	2	58	0	0
7	23915926	.	C	T	30	24	54	0	2	56	0	0
7	23915963	.	A	G	20	1	21	0	26	47	0	0
7	23915964	.	A	T	20	24	44	0	3	47	0	0
7	23967515	.	A	C	9	0	9	0	16	25	0	0
7	23967522	.	G	A	9	16	25	0	0	25	0	0
7	23967591	.	G	A	7	7	14	0	0	14	0	0
7	23967596	.	G	A	7	9	16	0	0	16	0	0
7	23967705	.	G	A	7	4	11	0	0	11	0	0
7	23967772	.	A	G	9	17	26	0	2	28	0	0
7	23967861	.	C	T	0	18	18	0	10	28	0	0
7	23967930	.	A	G	19	22	41	0	0	41	0	0
7	23968009	.	T	C	19	0	19	0	16	35	0	0
7	23968108	.	G	A	17	11	28	0	1	29	0	0
7	23968152	.	T	A	10	10	20	0	1	21	0	0
7	23968330	.	C	G	9	4	13	0	1	14	0	0
7	23968344	.	C	T	10	4	14	0	1	15	0	0
7	23969033	.	T	C	0	1	1	0	6	7	0	0
7	23969056	.	T	C	4	5	9	0	0	9	0	0
7	23969163	.	G	A	7	4	11	0	0	11	0	0
7	23969361	.	G	A	7	7	14	0	0	14	0	0
7	23969446	.	C	T	6	10	16	0	0	16	0	0
7	23969535	.	G	A	15	6	21	0	2	23	0	0
7	23970130	.	A	G	0	7	7	0	0	7	0	0
7	23970428	.	T	C	10	10	20	0	0	20	0	0
7	23971418	.	T	C	9	3	12	0	0	12	0	0
7	23971714	.	G	C	1	1	2	0	0	2	0	0
7	23971728	.	T	G	0	1	1	0	0	1	0	0
7	23974326	.	T	A	1	3	4	0	0	4	0	0
7	24006992	.	A	T	1	2	3	0	0	3	0	0
7	24007176	.	G	T	1	2	3	0	0	3	0	0
7	24011926	.	T	C	7	5	12	0	0	12	0	0
7	24013274	.	A	C	2	5	7	0	1	8	0	0
7	24013560	.	T	C	6	4	10	0	0	10	0	0
7	24013662	.	C	A	12	4	16	0	0	16	0	0
7	24031838	.	G	A	0	2	2	0	0	2	0	0
7	24033572	.	T	A	2	1	3	0	2	5	0	0
7	24033639	.	C	G	5	3	8	0	0	8	0	0
7	24039773	.	T	C	3	3	6	0	1	7	0	0
7	24039800	.	C	A	2	3	5	0	0	5	0	0
7	24039819	.	T	G	1	2	3	0	0	3	0	0
7	24041627	.	T	C	1	0	1	0	2	3	0	0
7	24043391	.	G	A	0	2	2	0	0	2	0	0
7	24053451	.	G	A	2	2	4	0	1	5	0	0
7	24053526	.	T	C	0	3	3	0	0	3	0	0
7	24053689	.	C	T	3	6	9	0	0	9	0	0
7	24053850	.	C	T	3	4	7	0	0	7	0	0
7	24059570	.	C	T	8	8	16	0	0	16	0	0
7	24059773	.	C	T	4	5	9	0	1	10	0	0
7	24059861	.	C	G	6	4	10	0	0	10	0	0
7	24059873	.	C	T	5	3	8	0	0	8	0	0
7	24060071	.	A	C	3	4	7	0	1	8	0	0
7	24066825	.	C	T	7	3	10	0	0	10	0	0
7	24067359	.	C	T	4	4	8	0	1	9	0	0
7	24067403	.	A	T	4	8	12	0	1	13	0	0
7	24067571	.	C	T	7	3	10	0	0	10	0	0
7	24067611	.	C	T	3	8	11	0	0	11	0	0
7	24067906	.	C	A	6	12	18	0	0	18	0	0
7	24067907	.	T	A	6	12	18	0	0	18	0	0
7	24068078	.	T	G	1	4	5	0	0	5	0	0
7	24068230	.	C	T	10	3	13	0	1	14	0	0
7	24068491	.	C	T	8	6	14	0	1	15	0	0
7	24068523	.	C	A	9	7	16	0	0	16	0	0
7	24068669	.	T	G	2	3	5	0	0	5	0	0
7	24068722	.	T	C	4	6	10	0	0	10	0	0
7	24068868	.	G	A	0	2	2	0	2	4	0	0
7	24069484	.	T	C	4	2	6	0	0	6	0	0
7	24072217	.	C	T	0	2	2	0	0	2	0	0
7	24075776	.	C	T	5	9	14	0	0	14	0	0
7	24075842	.	A	C	7	6	13	0	2	16	1	0
7	24075911	.	G	A	9	5	14	0	0	14	0	0
7	24076044	.	A	C	4	4	8	0	0	8	0	0
7	24076086	.	C	A	7	5	12	0	0	12	0	0
7	24076088	.	A	G	5	4	9	0	3	12	0	0
7	24076192	.	C	T	0	8	8	0	0	8	0	0
7	24076198	.	C	T	6	4	10	0	1	11	0	0
7	24076269	.	C	T	7	7	14	0	0	14	0	0
7	24076329	.	C	T	13	9	22	0	0	22	0	0
7	24076373	.	C	T	8	8	16	0	0	16	0	0
7	24084783	.	C	T	2	2	4	0	0	4	0	0
7	24084887	.	G	A	0	0	0	0	3	3	0	0
7	24087362	.	A	T	5	5	10	0	0	10	0	0
7	24087365	.	T	C	4	5	9	0	1	10	0	0
7	24087453	.	C	G	5	2	7	0	0	7	0	0
7	24090128	.	A	G	0	0	0	0	1	1	0	0
7	24090182	.	G	A	6	9	15	0	0	15	0	0
7	24091249	.	A	G	8	7	15	0	0	15	0	0
7	24091269	.	G	A	1	7	8	0	8	16	0	0
7	24092626	.	C	T	1	1	2	0	0	2	0	0
7	24093102	.	C	T	16	12	28	0	1	29	0	0
7	24093105	.	C	T	16	14	30	0	0	30	0	0
7	24095717	.	G	A	0	18	18	0	10	28	0	0
7	24095788	.	A	G	10	10	20	0	1	21	0	0
7	24095836	.	C	T	10	10	20	0	0	20	0	0
7	24095848	.	G	A	9	13	22	0	2	24	0	0
7	24095883	.	T	A	15	6	21	0	0	21	0	0
7	24095978	.	T	A	10	15	25	0	3	28	0	0
7	24096015	.	C	T	10	13	23	0	2	25	0	0
7	24096165	.	T	C	15	12	27	0	2	29	0	0
7	24096195	.	C	G	17	11	28	0	1	29	0	0
7	24096447	.	T	G	19	22	41	0	2	43	0	0
7	24096541	.	C	T	8	10	18	2	1	21	0	0
7	24158843	.	A	G	6	1	7	0	7	14	0	0
7	24161552	.	A	T	7	11	18	0	4	22	0	0
7	24161561	.	A	C	2	0	2	0	16	18	0	0
7	24161591	.	C	A	12	7	19	0	1	20	0	0
7	24161776	.	C	G	6	6	12	0	1	13	0	0
7	24161786	.	G	C	8	6	14	0	0	14	0	0
7	24162267	.	G	T	6	7	13	0	1	14	0	0
7	24162368	.	A	T	6	7	13	0	0	13	0	0
7	24162369	.	A	C	6	7	13	0	0	13	0	0
7	24162457	.	T	C	12	8	20	0	0	20	0	0
7	24162567	.	T	C	7	6	13	0	0	13	0	0
7	24162782	.	G	A	3	2	5	0	0	5	0	0
7	24197607	.	A	T	5	1	6	0	1	7	0	0
7	24197622	.	G	T	2	3	5	0	0	5	0	0
7	24197656	.	C	A	2	5	7	0	0	7	0	0
7	24197660	.	T	A	2	5	7	0	0	7	0	0
7	24197780	.	A	T	2	3	5	0	0	5	0	0
7	24197916	.	A	G	1	5	6	0	0	6	0	0
7	24197962	.	T	C	5	0	5	0	4	9	0	0
7	24198282	.	T	C	2	2	4	0	1	5	0	0
7	24200052	.	C	T	2	3	5	0	6	11	0	0
7	24200112	.	A	G	7	7	14	0	0	14	0	0
7	24201447	.	A	T	2	3	5	0	0	5	0	0
7	24201453	.	G	A	2	3	5	0	0	5	0	0
7	24201686	.	A	G	1	1	2	0	0	2	0	0
7	24204166	.	T	A	5	2	7	0	0	7	0	0
7	24205077	.	C	A	10	14	24	0	1	25	0	0
7	24210656	.	A	C	20	15	35	0	3	38	0	0
7	24210913	.	T	C	17	1	18	0	13	31	0	0
7	24211027	.	G	T	10	4	14	0	0	14	0	0
7	24211104	.	C	T	0	12	12	0	9	21	0	0
7	24211342	.	C	T	0	15	15	0	9	24	0	0
7	24211443	.	C	T	0	8	8	0	12	20	0	0
7	24211560	.	A	T	3	6	9	0	0	9	0	0
7	24211672	.	A	T	4	5	9	0	2	11	0	0
7	24211911	.	A	T	2	3	5	0	0	5	0	0
7	24212093	.	C	G	9	13	22	0	0	22	0	0
7	24212122	.	T	C	7	9	16	0	0	16	0	0
7	24212383	.	G	A	11	11	22	0	2	24	0	0
7	24213387	.	A	T	4	5	9	0	0	9	0	0
7	24213401	.	G	A	6	4	10	0	0	10	0	0
7	24213426	.	G	A	5	1	6	0	1	7	0	0
7	24214673	.	C	A	1	1	2	0	0	2	0	0
7	24219052	.	A	G	1	3	4	0	0	4	0	0
7	24227149	.	T	G	3	1	4	0	0	4	0	0
7	24235722	.	G	T	3	4	7	0	0	7	0	0
7	24235936	.	A	C	2	5	7	0	0	7	0	0
7	24236177	.	C	G	6	5	11	0	1	12	0	0
7	24357396	.	C	T	0	2	2	0	3	5	0	0
7	24357403	.	C	T	2	4	6	0	0	6	0	0
7	24377040	.	G	A	1	5	6	0	0	6	0	0
7	24377237	.	A	G	2	3	5	0	0	5	0	0
7	24378422	.	C	A	7	2	9	0	1	10	0	0
7	24380652	.	C	A	6	2	8	0	0	8	0	0
7	24380715	.	T	G	1	0	1	0	0	1	0	0
7	24457647	.	A	T	25	35	60	0	1	62	1	0
7	24457691	.	C	A	20	36	56	0	1	57	0	0
7	24457788	.	C	A	8	10	18	0	0	18	0	0
7	24457803	.	A	C	3	7	10	0	0	10	0	0
7	24457845	.	T	C	29	5	34	0	1	35	0	0
7	24458103	.	C	A	27	15	42	0	3	45	0	0
7	24458205	.	G	A	31	23	54	0	1	55	0	0
7	24458513	.	T	C	14	22	36	0	2	38	0	0
7	24458713	.	T	C	7	0	7	0	22	29	0	0
7	24458717	.	G	A	9	20	29	0	0	29	0	0
7	24459452	.	G	A	10	21	31	0	1	32	0	0
7	24459667	.	T	A	23	18	41	0	2	43	0	0
7	24460025	.	G	A	12	18	30	0	2	32	0	0
7	24460026	.	C	T	12	18	30	0	2	32	0	0
7	24460189	.	T	C	16	14	30	0	2	32	0	0
7	24470812	.	A	G	8	14	22	0	3	25	0	0
7	24485558	.	G	T	2	2	4	0	0	4	0	0
7	24486036	.	C	T	1	1	2	0	0	2	0	0
7	24486546	.	G	C	31	32	63	0	0	65	2	0
7	24486822	.	G	A	32	23	55	0	3	58	0	0
7	24489888	.	A	G	5	5	10	0	0	10	0	0
7	24491382	.	G	A	6	3	9	0	0	9	0	0
7	24497012	.	G	A	1	0	1	0	0	1	0	0
7	24501168	.	T	C	0	0	0	0	2	2	0	0
7	24502016	.	C	T	3	4	7	0	0	7	0	0
7	24502858	.	G	A	1	12	13	0	10	23	0	0
7	24502867	.	C	T	12	9	21	0	2	23	0	0
7	24502948	.	C	T	3	0	3	0	0	3	0	0
7	24505321	.	T	C	5	7	12	0	0	12	0	0
7	24528976	.	G	T	0	2	2	0	0	2	0	0
7	24551057	.	G	C	0	1	1	0	0	1	0	0
7	24569961	.	T	C	7	4	11	0	2	13	0	0
7	24569990	.	T	G	13	5	18	0	1	19	0	0
7	24570012	.	A	T	9	6	15	0	2	17	0	0
7	24570714	.	G	A	0	6	6	0	8	14	0	0
7	24571056	.	C	T	3	4	7	0	0	7	0	0
7	24581226	.	A	T	1	2	3	0	0	3	0	0
7	24593439	.	T	C	4	3	7	0	0	7	0	0
7	24593452	.	T	A	1	3	4	0	1	5	0	0
7	24594860	.	T	A	2	4	6	0	1	7	0	0
7	24598728	.	G	T	0	4	4	0	0	4	0	0
7	24603028	.	G	T	1	2	3	0	0	3	0	0
7	24603231	.	C	T	0	1	1	0	3	4	0	0
7	24612524	.	G	A	0	1	1	0	0	1	0	0
7	24612623	.	C	T	2	1	3	0	0	3	0	0
7	24616240	.	G	A	1	3	4	0	0	4	0	0
7	24621385	.	C	T	2	7	9	0	0	9	0	0
7	24621564	.	A	C	2	2	4	0	0	4	0	0
7	24631757	.	C	A	4	2	6	0	0	6	0	0
7	24632080	.	C	T	0	2	2	0	0	2	0	0
7	24637765	.	C	A	1	0	1	0	0	1	0	0
7	24637934	.	T	C	3	3	6	0	0	6	0	0
7	24644434	.	G	C	3	1	4	0	0	4	0	0
7	24645292	.	A	G	4	2	6	0	0	6	0	0
7	24646602	.	T	C	0	1	1	0	0	1	0	0
7	24649694	.	T	C	1	0	1	0	0	1	0	0
7	24652951	.	A	G	2	0	2	0	4	6	0	0
7	24653020	.	G	A	2	4	6	0	0	6	0	0
7	24653068	.	C	T	3	3	6	0	1	7	0	0
7	24653079	.	G	A	2	3	5	0	0	5	0	0
7	24655086	.	T	A	3	4	7	0	0	7	0	0
7	24655094	.	T	C	3	4	7	0	0	7	0	0
7	24655261	.	A	G	4	1	5	0	0	5	0	0
7	24658938	.	G	A	0	1	1	0	3	4	0	0
7	24662235	.	G	A	2	1	3	0	0	3	0	0
7	24663995	.	T	C	4	4	8	0	0	8	0	0
7	24672147	.	A	G	7	0	7	0	6	13	0	0
7	24672257	.	G	C	13	13	26	0	0	26	0	0
7	24672721	.	G	T	0	3	3	0	1	4	0	0
7	24681673	.	A	G	23	17	40	0	7	47	0	0
7	24681731	.	T	C	20	28	48	0	2	50	0	0
7	24681755	.	A	G	18	21	39	0	0	39	0	0
7	24681806	.	A	G	2	3	5	0	0	5	0	0
7	24699881	.	G	T	9	5	14	0	1	15	0	0
7	24715058	.	T	C	1	2	3	0	0	3	0	0
7	24716056	.	G	T	1	4	5	0	0	5	0	0
7	24716169	.	G	A	4	3	7	0	0	7	0	0
7	24716172	.	G	A	4	3	7	0	0	7	0	0
7	24716373	.	G	A	1	4	5	0	0	5	0	0
7	24716393	.	G	T	1	3	4	0	0	4	0	0
7	24716538	.	G	A	1	4	5	0	0	5	0	0
7	24717234	.	A	T	0	3	3	0	0	3	0	0
7	24717322	.	T	G	1	5	6	0	0	6	0	0
7	24717327	.	T	G	1	4	5	0	0	5	0	0
7	24807919	.	A	G	1	3	4	0	0	4	0	0
7	24812538	.	G	C	3	5	8	0	0	8	0	0
7	24812587	.	C	T	5	3	8	0	1	9	0	0
7	24812662	.	G	T	1	4	5	0	0	5	0	0
7	24812829	.	A	G	3	2	5	0	0	5	0	0
7	24815992	.	C	T	7	7	14	0	1	15	0	0
7	24819788	.	G	A	3	0	3	0	0	3	0	0
7	24819812	.	G	A	12	4	16	0	0	16	0	0
7	24822914	.	G	A	4	9	13	0	0	13	0	0
7	24830776	.	A	G	1	0	1	0	2	3	0	0
7	24888438	.	C	T	1	2	3	0	0	3	0	0
7	24888986	.	T	C	6	4	10	0	1	11	0	0
7	24889051	.	G	C	0	2	2	0	4	6	0	0
7	24889808	.	C	G	1	2	3	0	0	3	0	0
7	24923112	.	G	A	0	4	4	0	8	12	0	0
7	24944724	.	C	T	2	1	3	0	2	5	0	0
7	24946895	.	C	T	4	5	9	0	1	10	0	0
7	24946913	.	T	C	6	7	13	0	0	13	0	0
7	24947440	.	T	C	3	4	7	0	0	7	0	0
7	24974916	.	T	C	4	3	7	0	0	7	0	0
7	24974937	.	T	C	5	4	9	0	0	9	0	0
7	24975264	.	T	C	13	13	26	0	0	26	0	0
7	24975646	.	C	T	12	9	21	0	0	21	0	0
7	24975678	.	G	A	9	9	18	0	1	19	0	0
7	24976245	.	T	A	15	9	24	0	1	25	0	0
7	24976539	.	T	C	14	13	27	0	1	28	0	0
7	24979979	.	A	G	3	5	8	0	0	8	0	0
7	24980107	.	T	G	6	6	12	0	1	13	0	0
7	24980185	.	T	G	5	2	7	0	0	7	0	0
7	24980469	.	C	T	5	11	16	0	1	17	0	0
7	24984869	.	G	T	1	3	4	0	0	4	0	0
7	24985300	.	A	C	2	0	2	0	4	6	0	0
7	24985318	.	C	G	0	3	3	0	2	5	0	0
7	25010745	.	C	T	19	23	42	0	0	42	0	0
7	25011238	.	A	G	8	10	18	0	1	19	0	0
7	25011375	.	T	C	5	4	9	0	0	9	0	0
7	25011585	.	T	G	7	4	11	0	0	11	0	0
7	25015154	.	C	T	5	5	10	0	0	10	0	0
7	25015239	.	C	T	2	7	9	0	0	9	0	0
7	25015419	.	T	C	0	3	3	0	1	4	0	0
7	25015424	.	G	A	0	3	3	0	1	4	0	0
7	25017967	.	G	C	5	5	10	0	1	11	0	0
7	25021647	.	T	G	2	4	6	0	0	6	0	0
7	25021697	.	T	C	7	6	13	0	0	13	0	0
7	25021718	.	C	T	6	5	11	0	0	11	0	0
7	25024266	.	T	C	4	10	14	0	2	16	0	0
7	25024277	.	A	T	4	9	13	0	2	15	0	0
7	25024346	.	G	C	0	7	7	0	2	9	0	0
7	25026873	.	C	T	4	13	17	0	0	17	0	0
7	25026960	.	C	T	9	5	14	0	0	14	0	0
7	25027022	.	T	C	9	9	18	0	3	21	0	0
7	25027034	.	A	G	9	10	19	0	1	20	0	0
7	25027208	.	G	A	3	2	5	0	0	5	0	0
7	25027211	.	G	T	0	1	1	0	4	5	0	0
7	25027266	.	T	C	3	8	11	0	0	11	0	0
7	25027397	.	T	C	3	2	5	0	0	5	0	0
7	25027399	.	T	G	3	2	5	0	0	5	0	0
7	25027466	.	C	A	2	5	7	0	1	8	0	0
7	25027561	.	C	T	5	8	13	0	0	13	0	0
7	25027571	.	A	G	4	8	12	0	2	14	0	0
7	25027756	.	T	C	6	4	10	0	1	11	0	0
7	25028034	.	C	T	12	5	17	0	0	17	0	0
7	25028081	.	A	G	13	9	22	0	0	22	0	0
7	25028085	.	G	C	12	10	22	0	1	23	0	0
7	25028205	.	T	A	10	8	18	0	1	19	0	0
7	25028598	.	A	G	4	5	9	0	0	9	0	0
7	25028627	.	T	A	4	2	6	0	1	7	0	0
7	25029003	.	T	C	7	2	9	0	0	9	0	0
7	25045777	.	A	G	2	0	2	0	0	2	0	0
7	25046538	.	G	A	5	1	6	0	1	7	0	0
7	25047307	.	G	C	9	5	14	0	0	14	0	0
7	25047318	.	A	C	10	5	15	0	1	16	0	0
7	25047604	.	T	A	12	10	22	0	0	22	0	0
7	25047954	.	G	A	2	4	6	0	2	8	0	0
7	25049262	.	A	G	14	15	29	0	0	29	0	0
7	25059856	.	C	T	15	5	20	0	0	20	0	0
7	25096889	.	T	C	5	8	13	0	1	14	0	0
7	25098910	.	G	A	33	23	56	0	1	57	0	0
7	25099133	.	A	G	27	4	31	0	16	47	0	0
7	25099302	.	T	C	10	7	17	0	0	17	0	0
7	25099594	.	T	G	19	14	33	0	1	34	0	0
7	25099704	.	T	C	10	13	23	0	3	26	0	0
7	25129868	.	T	C	2	3	5	0	0	5	0	0
7	25129889	.	A	G	2	3	5	0	0	5	0	0
7	25214274	.	T	G	0	1	1	0	0	1	0	0
7	25214287	.	C	T	0	1	1	0	0	1	0	0
7	25292455	.	T	C	2	1	3	0	0	3	0	0
7	25292978	.	G	A	0	3	3	0	5	8	0	0
7	25293261	.	T	C	5	6	11	0	0	11	0	0
7	25293666	.	A	G	4	4	8	0	0	8	0	0
7	25341280	.	G	A	0	1	1	0	0	1	0	0
7	25347024	.	C	T	5	5	10	0	1	11	0	0
7	25347459	.	T	G	5	13	18	0	0	18	0	0
7	25558837	.	T	A	0	2	2	0	1	3	0	0
7	25559093	.	A	G	4	6	10	0	1	11	0	0
7	25559763	.	A	T	2	3	5	0	0	5	0	0
7	25559814	.	C	T	3	2	5	0	1	6	0	0
7	25854239	.	T	C	10	4	14	0	0	14	0	0
7	25854245	.	C	G	10	3	13	0	0	13	0	0
7	25854290	.	A	G	1	8	9	0	0	9	0	0
7	25863631	.	C	T	2	0	2	0	1	3	0	0
7	25867412	.	C	T	5	9	14	0	0	14	0	0
7	25869960	.	C	T	2	0	2	0	0	2	0	0
7	25870003	.	C	T	14	4	18	0	0	18	0	0
7	25872580	.	C	T	6	4	10	0	0	10	0	0
7	25872691	.	G	A	1	0	1	0	0	1	0	0
7	25873009	.	C	T	2	5	7	0	0	7	0	0
7	25873601	.	A	T	2	0	2	0	0	2	0	0
7	25873728	.	T	G	5	0	5	0	5	10	0	0
7	25873743	.	C	A	9	10	19	0	0	19	0	0
7	25873857	.	T	C	6	4	10	0	0	10	0	0
7	25877033	.	A	T	12	10	22	0	1	23	0	0
7	25877038	.	G	A	11	10	21	0	3	24	0	0
7	25877215	.	C	A	6	5	11	0	0	11	0	0
7	25877420	.	T	C	13	18	31	0	1	32	0	0
7	25877445	.	G	C	10	14	24	0	2	26	0	0
7	25877541	.	T	A	6	5	11	0	0	11	0	0
7	25877553	.	G	A	1	5	6	0	5	11	0	0
7	25877984	.	A	C	3	3	6	0	0	6	0	0
7	25878282	.	G	A	11	16	27	0	0	27	0	0
7	25878417	.	T	G	11	10	21	0	0	21	0	0
7	25878432	.	C	T	8	6	14	0	0	14	0	0
7	25878642	.	G	T	18	13	31	0	1	32	0	0
7	25878723	.	A	C	27	14	41	0	1	42	0	0
7	25878786	.	C	T	1	19	20	0	29	49	0	0
7	25878849	.	T	C	25	9	34	0	3	37	0	0
7	25878901	.	G	A	16	22	38	0	0	38	0	0
7	25879514	.	T	A	14	27	41	0	0	41	0	0
7	25879534	.	C	T	14	26	40	0	0	40	0	0
7	25879637	.	A	G	21	11	32	0	2	34	0	0
7	25879787	.	C	G	10	18	28	0	2	30	0	0
7	25879887	.	A	G	15	15	30	0	3	33	0	0
7	25879920	.	G	T	10	18	28	0	0	28	0	0
7	25879936	.	G	A	7	20	27	0	0	27	0	0
7	25880033	.	A	T	15	14	29	0	2	31	0	0
7	25880226	.	G	A	9	8	17	0	0	17	0	0
7	25880340	.	C	T	0	20	20	0	17	37	0	0
7	25880413	.	G	A	17	19	36	0	1	37	0	0
7	25880843	.	G	A	9	11	20	0	0	20	0	0
7	25880979	.	C	G	18	13	31	0	1	32	0	0
7	25881103	.	T	G	12	11	23	0	1	24	0	0
7	25881303	.	C	T	16	11	27	0	2	29	0	0
7	25881583	.	G	A	11	6	17	0	0	18	1	0
7	25881589	.	C	T	5	5	10	0	6	18	2	0
7	25884007	.	G	T	2	2	4	0	0	4	0	0
7	25884282	.	G	A	0	0	0	0	1	1	0	0
7	25884285	.	T	A	1	0	1	0	0	1	0	0
7	25895150	.	A	G	6	11	17	0	1	18	0	0
7	25895154	.	G	T	6	11	17	0	1	18	0	0
7	25918056	.	C	T	27	29	56	0	10	66	0	0
7	25918112	.	A	T	25	25	50	0	2	52	0	0
7	25918252	.	G	A	4	2	6	0	0	6	0	0
7	25979372	.	C	T	5	6	11	0	0	11	0	0
7	25979510	.	T	C	6	6	12	0	0	12	0	0
7	25986186	.	A	G	2	0	2	0	4	6	0	0
7	25998602	.	C	T	5	1	6	0	0	6	0	0
7	26002674	.	C	T	10	19	29	0	2	32	1	0
7	26002812	.	T	C	12	19	31	0	0	32	1	0
7	26002915	.	T	A	10	12	22	0	2	24	0	0
7	26003424	.	G	A	14	22	36	0	2	38	0	0
7	26004391	.	C	A	10	11	21	0	0	21	0	0
7	26004519	.	G	A	4	14	18	0	1	19	0	0
7	26004616	.	A	G	5	5	10	0	1	11	0	0
7	26004876	.	T	A	6	5	11	0	2	13	0	0
7	26004907	.	A	G	2	0	2	0	3	5	0	0
7	26004951	.	A	G	3	3	6	0	0	6	0	0
7	26005033	.	A	G	4	7	11	0	0	11	0	0
7	26008444	.	A	G	0	1	1	0	0	1	0	0
7	26011665	.	A	T	0	1	1	0	0	1	0	0
7	26015595	.	C	A	5	12	17	0	0	17	0	0
7	26015628	.	T	C	7	7	14	0	0	14	0	0
7	26015663	.	T	C	6	4	10	0	0	10	0	0
7	26015693	.	C	A	2	2	4	0	0	4	0	0
7	26020174	.	A	T	8	12	20	0	0	20	0	0
7	26020192	.	C	T	11	6	17	0	1	18	0	0
7	26020659	.	C	T	16	5	21	0	0	21	0	0
7	26020779	.	C	T	12	14	26	0	0	26	0	0
7	26021146	.	A	G	18	18	36	0	0	36	0	0
7	26026114	.	A	G	14	0	14	0	11	25	0	0
7	26026176	.	C	T	8	11	19	0	2	21	0	0
7	26026188	.	C	A	7	14	21	0	2	23	0	0
7	26026220	.	A	T	9	10	19	0	1	20	0	0
7	26048364	.	T	A	1	2	3	0	0	3	0	0
7	26048541	.	G	A	1	1	2	0	0	2	0	0
7	26073519	.	A	T	4	5	9	0	0	9	0	0
7	26076531	.	G	C	2	3	5	0	0	5	0	0
7	26077845	.	G	T	22	21	43	0	0	43	0	0
7	26077947	.	T	A	11	36	47	0	1	48	0	0
7	26077949	.	C	T	11	35	46	0	2	48	0	0
7	26078061	.	T	C	10	20	30	0	3	33	0	0
7	26078345	.	T	A	33	13	46	0	1	47	0	0
7	26078897	.	G	A	23	16	39	0	3	42	0	0
7	26078947	.	G	A	36	9	45	0	0	45	0	0
7	26078967	.	A	G	17	29	46	0	3	49	0	0
7	26078983	.	G	A	16	19	35	0	1	36	0	0
7	26079667	.	C	G	2	22	24	0	22	46	0	0
7	26081252	.	A	G	5	7	12	0	0	12	0	0
7	26081546	.	T	G	17	11	28	0	6	34	0	0
7	26081744	.	T	C	16	19	35	0	2	37	0	0
7	26081951	.	T	C	10	11	21	0	0	21	0	0
7	26082371	.	G	A	8	6	14	0	0	14	0	0
7	26082428	.	A	G	7	4	11	0	0	11	0	0
7	26110292	.	C	G	1	2	3	0	0	3	0	0
7	26110302	.	A	G	1	0	1	0	2	3	0	0
7	26116445	.	A	G	1	2	3	0	0	3	0	0
7	26122110	.	C	T	0	2	2	0	0	2	0	0
7	26132724	.	C	T	4	8	12	0	0	12	0	0
7	26132743	.	C	T	1	3	4	0	1	5	0	0
7	26141022	.	C	T	23	7	30	0	1	31	0	0
7	26141310	.	C	T	11	22	33	0	3	36	0	0
7	26141394	.	G	C	5	19	24	0	1	25	0	0
7	26141568	.	T	A	19	16	35	0	4	39	0	0
7	26141853	.	C	T	18	13	31	0	1	32	0	0
7	26142315	.	T	A	2	10	12	0	3	15	0	0
7	26142489	.	G	A	15	16	31	0	0	31	0	0
7	26142702	.	A	G	16	18	34	0	2	36	0	0
7	26142736	.	A	T	10	20	30	0	0	30	0	0
7	26143022	.	G	A	13	13	26	0	1	27	0	0
7	26143343	.	A	G	16	10	26	0	0	26	0	0
7	26143668	.	G	T	1	13	14	0	16	30	0	0
7	26144271	.	A	G	11	0	11	0	20	31	0	0
7	26144305	.	T	A	20	18	38	0	0	38	0	0
7	26144440	.	C	T	8	4	12	0	0	12	0	0
7	26144882	.	A	G	19	3	22	0	19	41	0	0
7	26144944	.	A	G	22	1	23	0	11	34	0	0
7	26145252	.	A	C	14	20	34	0	0	34	0	0
7	26145267	.	T	A	14	14	28	0	2	30	0	0
7	26145329	.	T	A	28	19	47	0	2	49	0	0
7	26145441	.	C	G	18	15	33	0	2	35	0	0
7	26145451	.	A	G	16	17	33	0	2	35	0	0
7	26145491	.	G	A	14	17	31	0	0	31	0	0
7	26145492	.	G	A	14	17	31	0	0	31	0	0
7	26145703	.	C	T	5	7	12	0	0	12	0	0
7	26145873	.	C	T	6	7	13	0	0	13	0	0
7	26145910	.	T	C	11	9	20	0	0	20	0	0
7	26146411	.	T	C	25	32	57	0	2	59	0	0
7	26146796	.	A	G	20	2	22	0	23	45	0	0
7	26146952	.	A	G	32	29	61	0	3	64	0	0
7	26146993	.	C	T	29	29	58	0	3	61	0	0
7	26146998	.	G	A	0	28	28	0	32	60	0	0
7	26147167	.	T	C	24	28	52	0	0	52	0	0
7	26147756	.	C	T	32	31	63	0	3	66	0	0
7	26148169	.	C	T	22	34	56	0	1	57	0	0
7	26148260	.	A	G	39	2	41	0	14	55	0	0
7	26148263	.	A	G	41	12	53	0	2	55	0	0
7	26148567	.	T	C	30	25	55	0	3	58	0	0
7	26148773	.	G	A	6	9	15	0	1	16	0	0
7	26148796	.	C	T	12	4	16	0	1	17	0	0
7	26149067	.	C	T	25	15	40	0	1	41	0	0
7	26149069	.	A	T	25	15	40	0	1	41	0	0
7	26149252	.	G	A	27	30	57	0	2	59	0	0
7	26149690	.	C	T	23	25	48	0	4	52	0	0
7	26150096	.	T	A	15	28	43	0	0	43	0	0
7	26226977	.	C	T	12	16	28	0	2	30	0	0
7	26227119	.	C	T	13	20	33	0	0	33	0	0
7	26227242	.	T	C	18	13	31	0	0	31	0	0
7	26228290	.	C	T	24	21	45	0	0	45	0	0
7	26229529	.	C	T	19	19	38	0	0	38	0	0
7	26229584	.	G	A	1	24	25	0	22	47	0	0
7	26245318	.	T	A	14	11	25	0	1	26	0	0
7	26246528	.	T	C	7	0	7	0	7	14	0	0
7	26263153	.	C	T	6	9	15	0	0	15	0	0
7	26265961	.	G	A	2	7	9	0	0	9	0	0
7	26266096	.	A	G	2	2	4	0	0	4	0	0
7	26266295	.	C	T	0	3	3	0	3	6	0	0
7	26300263	.	A	G	3	3	6	0	0	6	0	0
7	26300506	.	C	T	4	3	7	0	0	7	0	0
7	26300955	.	T	C	1	0	1	0	1	2	0	0
7	26366620	.	T	C	4	5	9	0	0	9	0	0
7	26366684	.	C	T	8	5	13	0	0	13	0	0
7	26366846	.	C	T	0	5	5	0	10	15	0	0
7	26366991	.	C	T	1	9	10	0	13	23	0	0
7	26367111	.	T	C	5	9	14	0	0	14	0	0
7	26367280	.	C	T	0	5	5	0	6	11	0	0
7	26367470	.	C	G	1	7	8	0	0	8	0	0
7	26367595	.	A	C	5	0	5	0	5	10	0	0
7	26367764	.	C	T	3	3	6	0	0	6	0	0
7	26368080	.	T	A	6	7	13	0	0	13	0	0
7	26368087	.	G	C	5	6	11	0	0	11	0	0
7	26368333	.	A	T	5	3	8	0	1	9	0	0
7	26368531	.	C	T	4	3	7	0	0	7	0	0
7	26368549	.	A	G	5	4	9	0	1	10	0	0
7	26368955	.	G	T	6	6	12	0	0	12	0	0
7	26369394	.	T	C	8	6	14	0	0	14	0	0
7	26371711	.	G	A	4	3	7	0	1	8	0	0
7	26378224	.	G	A	5	5	10	0	0	10	0	0
7	26380290	.	T	C	2	0	2	0	0	2	0	0
7	26380335	.	G	A	1	2	3	0	0	3	0	0
7	26389429	.	C	T	5	6	11	0	0	11	0	0
7	26389486	.	G	A	5	5	10	0	0	10	0	0
7	26393903	.	T	C	3	0	3	0	3	6	0	0
7	26394791	.	A	G	20	21	41	0	3	44	0	0
7	26394951	.	T	A	10	8	18	0	0	18	0	0
7	26395816	.	T	C	5	7	12	0	1	13	0	0
7	26396013	.	T	A	16	10	26	0	1	27	0	0
7	26396170	.	G	A	9	10	19	0	0	19	0	0
7	26396418	.	A	T	12	8	20	0	0	20	0	0
7	26396506	.	T	A	5	7	12	0	0	12	0	0
7	26396768	.	G	A	11	14	25	0	0	25	0	0
7	26396783	.	C	G	0	11	11	0	9	20	0	0
7	26396886	.	G	A	5	3	8	0	1	9	0	0
7	26397129	.	A	G	2	5	7	0	0	7	0	0
7	26397243	.	G	A	11	7	18	0	0	18	0	0
7	26397289	.	G	A	5	6	11	0	0	11	0	0
7	26397336	.	C	T	0	7	7	0	11	18	0	0
7	26397365	.	A	T	11	7	18	0	1	19	0	0
7	26397541	.	G	A	16	11	27	0	1	28	0	0
7	26398159	.	A	T	9	9	18	0	0	18	0	0
7	26398189	.	C	T	8	9	17	0	1	18	0	0
7	26398351	.	A	G	13	3	16	0	1	17	0	0
7	26398360	.	G	A	3	10	13	0	2	15	0	0
7	26408340	.	C	T	3	3	6	0	1	7	0	0
7	26457085	.	A	G	2	2	4	0	2	6	0	0
7	26457103	.	C	T	0	2	2	0	4	6	0	0
7	26459917	.	C	T	0	3	3	0	1	4	0	0
7	26460001	.	T	G	5	1	6	0	0	6	0	0
7	26460821	.	G	T	3	2	5	0	0	5	0	0
7	26462724	.	A	G	1	2	3	0	1	4	0	0
7	26469820	.	G	A	0	1	1	0	2	3	0	0
7	26472244	.	G	A	7	8	15	0	2	17	0	0
7	26472258	.	A	G	8	0	8	0	9	17	0	0
7	26472290	.	C	T	5	5	10	0	0	10	0	0
7	26472512	.	G	T	2	5	7	0	0	7	0	0
7	26511884	.	C	A	1	11	12	0	0	12	0	0
7	27702028	.	T	A	3	2	5	0	0	5	0	0
7	28042060	.	G	A	0	7	7	0	0	7	0	0
7	28042070	.	A	C	2	5	7	0	0	8	1	0
7	28044303	.	A	G	9	5	14	0	1	15	0	0
7	28044339	.	A	G	4	5	9	0	0	9	0	0
7	28625027	.	C	T	1	4	5	0	0	5	0	0
7	29051855	.	A	G	7	2	9	0	0	9	0	0
7	29189503	.	C	G	14	11	25	0	0	25	0	0
7	29189508	.	G	C	13	9	22	0	2	24	0	0
7	29189652	.	C	T	12	10	22	0	0	22	0	0
7	29189694	.	G	A	3	6	9	0	0	9	0	0
7	29192331	.	C	T	0	16	16	0	11	27	0	0
7	29199642	.	C	T	6	3	9	0	3	12	0	0
7	29200013	.	G	A	1	0	1	0	0	1	0	0
7	29210943	.	T	C	1	0	1	0	0	1	0	0
7	29211102	.	C	T	2	1	3	0	2	5	0	0
7	29214910	.	G	A	3	2	5	0	0	5	0	0
7	29215945	.	T	A	4	6	10	0	0	10	0	0
7	29217704	.	C	T	0	3	3	0	2	5	0	0
7	29220089	.	G	A	2	6	8	0	0	8	0	0
7	29224517	.	G	A	1	3	4	0	0	4	0	0
7	29227361	.	A	G	2	0	2	0	0	2	0	0
7	29227602	.	G	A	1	1	2	0	0	2	0	0
7	29229594	.	T	G	3	4	7	0	0	7	0	0
7	29231558	.	A	G	1	3	4	0	0	4	0	0
7	29239268	.	T	A	1	2	3	0	0	3	0	0
7	29308739	.	T	A	1	1	2	0	0	2	0	0
7	29308745	.	A	G	1	0	1	0	1	2	0	0
7	29309027	.	A	G	4	4	8	0	0	8	0	0
7	29309225	.	A	C	5	2	7	0	0	8	1	0
7	29309271	.	A	T	3	7	10	0	1	11	0	0
7	29309315	.	A	C	7	3	10	0	0	10	0	0
7	29309726	.	G	A	4	3	7	0	0	7	0	0
7	29309851	.	T	C	8	8	16	0	0	16	0	0
7	29309897	.	T	C	6	5	11	0	0	11	0	0
7	29309998	.	C	T	1	2	3	0	1	4	0	0
7	29310006	.	T	C	3	5	8	0	0	8	0	0
7	29310355	.	A	C	6	16	22	0	1	23	0	0
7	29310409	.	T	C	10	7	17	0	1	18	0	0
7	29310537	.	C	T	8	12	20	0	1	21	0	0
7	29310543	.	G	A	0	13	13	0	10	23	0	0
7	29539523	.	T	A	8	7	15	0	0	15	0	0
7	29540207	.	A	G	3	5	8	0	0	8	0	0
7	29540311	.	A	C	11	10	21	0	0	21	0	0
7	29540412	.	G	A	22	11	33	0	2	35	0	0
7	29540536	.	A	T	16	12	28	0	1	29	0	0
7	29540537	.	C	T	0	13	13	0	16	29	0	0
7	29540693	.	A	G	9	7	16	0	0	16	0	0
7	29553317	.	A	T	9	8	17	0	0	17	0	0
7	29553338	.	G	A	10	8	18	0	2	20	0	0
7	29553446	.	G	A	5	12	17	0	0	17	0	0
7	29553473	.	G	A	2	6	8	0	1	9	0	0
7	29625326	.	C	T	9	7	16	0	1	17	0	0
7	29625427	.	G	A	10	4	14	0	0	14	0	0
7	29633743	.	G	A	7	6	13	0	0	13	0	0
7	29649401	.	C	G	2	1	3	0	0	3	0	0
7	29653004	.	A	G	4	6	10	0	0	10	0	0
7	29653500	.	C	T	0	4	4	0	0	4	0	0
7	29653521	.	C	T	0	3	3	0	0	3	0	0
7	29655006	.	A	G	1	3	4	0	0	4	0	0
7	29657144	.	T	C	5	0	5	0	4	9	0	0
7	29657186	.	A	G	2	2	4	0	0	4	0	0
7	29657231	.	A	G	0	1	1	0	0	1	0	0
7	29660377	.	G	A	0	2	2	0	0	2	0	0
7	29660410	.	G	A	2	2	4	0	0	4	0	0
7	29661260	.	C	T	1	4	5	0	0	5	0	0
7	29663064	.	T	A	2	4	6	0	0	6	0	0
7	29664300	.	G	T	3	2	5	0	0	5	0	0
7	29664372	.	C	T	2	3	5	0	0	5	0	0
7	29664373	.	A	G	2	3	5	0	0	5	0	0
7	29670934	.	C	T	1	2	3	0	1	4	0	0
7	29674931	.	T	C	1	1	2	0	0	2	0	0
7	29674985	.	C	T	0	1	1	0	1	2	0	0
7	29675798	.	C	G	3	3	6	0	0	6	0	0
7	29681302	.	G	A	4	2	6	0	0	6	0	0
7	29681317	.	A	G	4	2	6	0	0	6	0	0
7	29690289	.	G	T	1	2	3	0	0	3	0	0
7	29890356	.	C	T	0	2	2	0	1	3	0	0
7	29923340	.	A	G	2	2	4	0	0	4	0	0
7	29927700	.	T	C	1	1	2	0	0	2	0	0
7	29927724	.	A	G	2	0	2	0	2	4	0	0
7	29928703	.	C	A	1	2	3	0	0	3	0	0
7	29930445	.	C	T	1	2	3	0	0	3	0	0
7	29932743	.	C	G	0	2	2	0	0	2	0	0
7	29935803	.	C	T	1	2	3	0	0	3	0	0
7	29936168	.	C	T	1	1	2	0	0	2	0	0
7	29939655	.	G	A	0	2	2	0	2	4	0	0
7	29939673	.	T	C	1	2	3	0	0	3	0	0
7	29939694	.	G	C	2	1	3	0	0	3	0	0
7	29941709	.	G	A	0	1	1	0	6	7	0	0
7	29944366	.	G	C	0	13	13	0	3	16	0	0
7	29945564	.	C	A	8	13	21	0	0	21	0	0
7	29945607	.	T	C	2	10	12	0	0	12	0	0
7	29945609	.	C	A	10	2	12	0	0	12	0	0
7	29945642	.	C	T	5	3	8	0	1	9	0	0
7	29945837	.	G	A	12	12	24	0	1	25	0	0
7	29961207	.	A	C	12	5	17	0	0	17	0	0
7	29961296	.	A	G	9	15	24	0	2	26	0	0
7	29961513	.	T	A	3	13	16	0	1	17	0	0
7	29961567	.	C	T	22	9	31	0	1	32	0	0
7	29961592	.	G	A	12	18	30	0	3	33	0	0
7	29961649	.	G	A	4	4	8	0	0	8	0	0
7	29961658	.	T	A	4	2	6	0	0	6	0	0
7	29964713	.	G	A	1	2	3	0	0	3	0	0
7	29966892	.	A	G	2	2	4	0	0	4	0	0
7	29967989	.	C	T	1	4	5	0	0	5	0	0
7	29968099	.	C	T	3	6	9	0	0	9	0	0
7	29968298	.	G	A	2	2	4	0	2	6	0	0
7	29968454	.	T	A	5	4	9	0	0	9	0	0
7	29968534	.	A	G	5	8	13	0	0	13	0	0
7	29968855	.	C	A	3	2	5	0	0	5	0	0
7	29969008	.	A	G	1	8	9	0	0	9	0	0
7	29969280	.	A	G	5	2	7	0	0	7	0	0
7	29969303	.	T	G	2	4	6	0	0	6	0	0
7	29969704	.	A	G	3	2	5	0	1	6	0	0
7	29969996	.	A	T	4	4	8	0	0	8	0	0
7	29970015	.	T	G	3	3	6	0	2	8	0	0
7	30075289	.	T	G	1	3	4	0	1	5	0	0
7	30075430	.	G	A	8	5	13	0	1	14	0	0
7	30075631	.	C	A	4	16	20	0	0	20	0	0
7	30075823	.	C	T	7	9	16	0	5	21	0	0
7	30075845	.	T	C	7	19	26	0	1	27	0	0
7	30075974	.	A	G	10	28	38	0	3	41	0	0
7	30075983	.	G	A	9	26	35	0	3	38	0	0
7	30076036	.	A	C	8	14	22	0	0	22	0	0
7	30076083	.	A	T	7	11	18	0	0	18	0	0
7	30076141	.	T	G	9	10	19	0	1	20	0	0
7	30076179	.	C	T	3	4	7	0	1	8	0	0
7	30076185	.	C	A	4	5	9	0	0	9	0	0
7	30076217	.	T	C	5	5	10	0	0	10	0	0
7	30076241	.	G	T	8	4	12	0	0	12	0	0
7	30076591	.	G	A	19	10	29	0	0	29	0	0
7	30076608	.	T	G	20	6	26	0	1	27	0	0
7	30076653	.	C	A	19	7	26	0	0	26	0	0
7	30076692	.	C	T	19	18	37	0	1	38	0	0
7	30076744	.	G	A	12	28	40	0	0	40	0	0
7	30076962	.	A	T	6	12	18	0	0	18	0	0
7	30077288	.	C	T	11	3	14	0	0	14	0	0
7	30077347	.	A	G	4	7	11	2	0	13	0	0
7	30077402	.	A	C	1	5	6	0	1	7	0	0
7	30077479	.	G	C	3	14	17	0	0	17	0	0
7	30077495	.	C	T	5	11	16	0	0	16	0	0
7	30077581	.	T	G	9	8	17	0	2	19	0	0
7	30176506	.	G	A	2	3	5	0	0	5	0	0
7	30187318	.	C	T	1	2	3	0	1	4	0	0
7	30187381	.	A	G	1	0	1	0	0	1	0	0
7	30210250	.	A	C	2	4	6	0	0	6	0	0
7	30210282	.	T	G	8	3	11	0	1	12	0	0
7	30210359	.	C	T	6	9	15	0	0	15	0	0
7	30210364	.	G	T	6	7	13	0	0	13	0	0
7	30210579	.	G	T	7	6	13	0	0	13	0	0
7	30210772	.	G	A	3	10	13	0	0	13	0	0
7	30210785	.	A	G	9	4	13	0	1	14	0	0
7	30210833	.	C	T	4	2	6	0	2	8	0	0
7	30213672	.	A	G	7	7	14	0	1	15	0	0
7	30213948	.	A	G	5	7	12	0	1	13	0	0
7	30214023	.	A	T	7	10	17	0	1	18	0	0
7	30214047	.	G	C	7	1	8	0	10	18	0	0
7	30270984	.	G	A	0	4	4	0	0	4	0	0
7	30272459	.	T	C	0	0	0	0	2	2	0	0
7	30275676	.	A	T	6	4	10	0	0	10	0	0
7	30275834	.	G	A	2	4	6	0	0	6	0	0
7	30275935	.	G	A	2	3	5	0	0	5	0	0
7	30276365	.	C	T	24	18	42	0	2	44	0	0
7	30276528	.	T	A	20	19	39	0	0	39	0	0
7	30282486	.	T	A	2	3	5	0	0	5	0	0
7	30286489	.	T	C	7	5	12	0	0	12	0	0
7	30409234	.	G	A	2	4	6	0	0	6	0	0
7	30409322	.	T	C	5	9	14	0	0	14	0	0
7	30409539	.	T	A	12	11	23	0	2	25	0	0
7	30409580	.	A	T	11	8	19	0	0	19	0	0
7	30409585	.	G	A	10	7	17	0	1	18	0	0
7	30409661	.	G	A	7	8	15	0	0	15	0	0
7	30410035	.	T	A	7	9	16	0	0	16	0	0
7	30410089	.	C	T	0	5	5	0	2	7	0	0
7	30410739	.	T	C	1	3	4	0	0	4	0	0
7	30411187	.	T	C	5	6	11	0	0	11	0	0
7	30412857	.	C	T	2	2	4	0	0	4	0	0
7	30416824	.	A	T	5	2	7	0	1	8	0	0
7	30421505	.	G	A	2	0	2	0	0	2	0	0
7	30425287	.	A	G	0	2	2	0	0	2	0	0
7	30533152	.	A	T	1	1	2	0	0	2	0	0
7	30534397	.	G	A	2	2	4	0	0	4	0	0
7	30534404	.	G	A	2	1	3	0	1	4	0	0
7	30534499	.	C	G	4	2	6	0	0	6	0	0
7	30534556	.	C	T	2	2	4	0	0	4	0	0
7	30534824	.	G	C	2	2	4	0	0	4	0	0
7	30535829	.	T	A	0	4	4	0	1	5	0	0
7	30535874	.	T	A	1	3	4	0	0	4	0	0
7	30536480	.	G	A	5	4	9	0	1	10	0	0
7	30536566	.	A	G	6	0	6	0	5	11	0	0
7	30536829	.	A	T	2	6	8	0	0	8	0	0
7	30536932	.	T	C	4	8	12	0	0	12	0	0
7	30537080	.	A	C	6	4	10	0	1	11	0	0
7	30537365	.	G	T	7	3	10	0	1	11	0	0
7	30537370	.	T	A	3	7	10	0	0	10	0	0
7	30537445	.	A	T	4	5	9	0	0	9	0	0
7	30537448	.	T	G	6	3	9	0	1	10	0	0
7	30537630	.	G	A	6	4	10	0	0	10	0	0
7	30537783	.	A	T	5	6	11	0	1	12	0	0
7	30537848	.	A	C	10	13	23	0	1	24	0	0
7	30537955	.	G	A	11	13	24	0	0	24	0	0
7	30538022	.	C	A	8	5	13	0	1	14	0	0
7	30538074	.	G	A	14	5	19	0	0	19	0	0
7	30538081	.	G	A	5	14	19	0	0	19	0	0
7	30538280	.	G	A	9	4	13	0	2	15	0	0
7	30538439	.	C	T	0	3	3	0	3	6	0	0
7	30538995	.	G	A	9	16	25	0	2	27	0	0
7	30541693	.	G	A	13	14	27	0	1	28	0	0
7	30542295	.	C	T	3	8	11	0	1	12	0	0
7	30543452	.	G	A	16	15	31	0	2	33	0	0
7	30543682	.	T	C	16	20	36	0	1	37	0	0
7	30543754	.	A	G	15	12	27	0	0	27	0	0
7	30543882	.	C	T	1	0	1	0	0	1	0	0
7	30544903	.	A	G	10	5	15	0	0	15	0	0
7	30552603	.	G	A	4	5	9	0	0	9	0	0
7	30552610	.	G	A	4	5	9	0	0	9	0	0
7	30553495	.	T	C	7	10	17	0	3	20	0	0
7	30560354	.	C	T	0	13	13	0	6	19	0	0
7	30562400	.	T	C	3	7	10	0	2	12	0	0
7	30562552	.	T	A	7	3	10	0	0	10	0	0
7	30563080	.	T	C	5	5	10	0	0	10	0	0
7	30563160	.	G	T	11	9	20	0	0	20	0	0
7	30571228	.	T	A	12	12	24	0	1	25	0	0
7	30624214	.	G	A	2	2	4	0	0	4	0	0
7	30632797	.	T	G	4	3	7	0	1	8	0	0
7	30633038	.	A	G	3	7	10	0	0	10	0	0
7	30641118	.	T	C	1	2	3	0	0	3	0	0
7	30769847	.	A	C	7	6	13	0	0	13	0	0
7	30769978	.	T	A	6	3	9	0	0	9	0	0
7	30770041	.	A	G	1	5	6	0	0	6	0	0
7	30770103	.	T	A	3	3	6	0	0	6	0	0
7	30770107	.	T	A	3	3	6	0	0	6	0	0
7	30770204	.	G	A	6	7	13	0	1	14	0	0
7	30770366	.	G	T	0	2	2	0	4	6	0	0
7	30770549	.	T	C	2	5	7	0	0	7	0	0
7	30770971	.	T	A	1	4	5	0	1	6	0	0
7	30775306	.	C	T	2	0	2	0	1	3	0	0
7	30775882	.	C	T	3	0	3	0	0	3	0	0
7	30777592	.	C	A	8	5	13	0	1	14	0	0
7	30778486	.	C	T	1	3	4	0	0	4	0	0
7	30778657	.	T	C	2	2	4	0	0	4	0	0
7	30778840	.	A	T	1	3	4	0	0	4	0	0
7	30778859	.	G	A	1	5	6	0	0	6	0	0
7	30778906	.	C	T	1	7	8	0	0	8	0	0
7	30780272	.	G	A	11	4	15	0	2	17	0	0
7	30782478	.	A	G	8	5	13	0	1	14	0	0
7	30782559	.	G	A	6	7	13	0	0	13	0	0
7	30782802	.	G	A	0	3	3	0	9	12	0	0
7	30782837	.	G	T	1	6	7	0	0	7	0	0
7	30782929	.	A	T	4	7	11	0	0	11	0	0
7	30867286	.	T	C	20	20	40	0	1	41	0	0
7	30867550	.	G	T	13	20	33	0	2	35	0	0
7	30867670	.	A	G	19	0	19	0	16	35	0	0
7	30867702	.	T	C	15	16	31	0	3	34	0	0
7	30867731	.	A	G	14	15	29	0	2	31	0	0
7	30867740	.	A	G	15	15	30	0	3	33	0	0
7	30867817	.	G	A	0	17	17	0	12	29	0	0
7	30867855	.	G	A	0	16	16	0	12	28	0	0
7	30875277	.	G	A	2	1	3	0	1	4	0	0
7	30879211	.	G	A	15	14	29	0	1	30	0	0
7	31140634	.	A	C	0	16	16	0	2	19	1	0
7	31501349	.	T	A	1	2	3	0	0	3	0	0
7	32746213	.	A	G	10	9	19	0	0	19	0	0
7	32747956	.	A	G	8	1	9	0	11	20	0	0
7	32747973	.	A	G	11	15	26	0	0	26	0	0
7	32748203	.	A	G	11	11	22	0	2	24	0	0
7	32815268	.	T	C	11	0	11	0	10	21	0	0
7	32815289	.	T	C	9	17	26	0	0	26	0	0
7	32835573	.	T	A	5	3	8	0	0	8	0	0
7	33892115	.	G	A	3	1	4	0	0	4	0	0
7	34105793	.	T	C	3	4	7	0	1	8	0	0
7	34236350	.	T	C	1	1	2	0	0	2	0	0
7	34236359	.	T	C	1	0	1	0	0	1	0	0
7	34242358	.	C	T	0	2	2	0	4	6	0	0
7	34242478	.	T	C	1	2	3	0	0	3	0	0
7	34290102	.	A	C	3	2	5	0	1	6	0	0
7	34292306	.	T	C	2	2	4	0	0	4	0	0
7	34292434	.	C	A	3	4	7	0	0	7	0	0
7	34292617	.	G	A	9	6	15	0	0	15	0	0
7	34292848	.	G	A	1	2	3	0	0	3	0	0
7	34314341	.	G	T	0	3	3	0	0	3	0	0
7	34314343	.	T	A	0	3	3	0	0	3	0	0
7	34317746	.	C	T	0	22	22	0	15	37	0	0
7	34318079	.	T	C	25	18	43	0	0	43	0	0
7	34318485	.	G	A	18	24	42	0	2	44	0	0
7	34321735	.	G	A	0	2	2	0	1	3	0	0
7	34321887	.	T	G	10	3	13	0	1	14	0	0
7	34324215	.	T	C	0	1	1	0	1	2	0	0
7	34329845	.	A	G	7	4	11	0	0	11	0	0
7	34341457	.	A	G	18	16	34	0	2	36	0	0
7	34341538	.	A	G	1	1	2	0	0	2	0	0
7	34342185	.	T	C	15	21	36	0	1	37	0	0
7	34342251	.	C	T	6	11	17	0	1	18	0	0
7	34342266	.	G	C	6	7	13	0	0	13	0	0
7	34352928	.	G	A	13	12	25	0	0	25	0	0
7	34353161	.	C	T	0	13	13	0	9	22	0	0
7	35734279	.	G	T	0	2	2	0	0	2	0	0
7	37585016	.	T	A	5	3	8	0	2	10	0	0
7	37861725	.	T	A	7	3	10	0	1	11	0	0
7	38392031	.	C	T	6	2	8	0	1	9	0	0
7	38392422	.	A	C	2	2	4	0	0	4	0	0
7	38392424	.	C	T	2	2	4	0	0	4	0	0
7	38456578	.	T	C	4	10	14	0	0	14	0	0
7	38456592	.	A	T	2	10	12	0	1	13	0	0
7	38456699	.	T	C	4	2	6	0	0	6	0	0
7	38456944	.	T	C	3	0	3	0	3	6	0	0
7	38476911	.	T	A	5	8	13	0	0	13	0	0
7	38476976	.	C	T	3	4	7	0	2	9	0	0
7	38477026	.	C	T	0	3	3	0	6	9	0	0
7	38477075	.	G	A	1	5	6	0	1	7	0	0
7	38477196	.	C	T	8	3	11	0	0	11	0	0
7	38500104	.	T	C	1	2	3	0	0	3	0	0
7	38529350	.	C	T	1	3	4	0	0	4	0	0
7	38529680	.	G	A	1	2	3	0	0	3	0	0
7	38529689	.	C	G	1	0	1	0	2	3	0	0
7	38529867	.	A	T	4	2	6	0	0	6	0	0
7	38529899	.	C	T	2	2	4	0	0	4	0	0
7	38532382	.	A	C	2	1	3	0	1	4	0	0
7	38532541	.	G	C	2	3	5	0	0	5	0	0
7	38532832	.	C	T	3	2	5	0	0	5	0	0
7	38532833	.	C	T	2	2	4	0	1	5	0	0
7	38533225	.	G	T	5	7	12	0	0	12	0	0
7	38533250	.	C	G	4	9	13	0	0	13	0	0
7	38536370	.	C	T	18	13	31	0	1	32	0	0
7	38536416	.	C	T	17	16	33	0	0	33	0	0
7	38536697	.	A	G	19	9	28	0	1	29	0	0
7	38536703	.	A	T	18	8	26	0	1	27	0	0
7	38536889	.	G	T	14	10	24	0	2	26	0	0
7	38537085	.	T	A	11	9	20	0	3	23	0	0
7	38537345	.	C	T	16	11	27	0	0	27	0	0
7	38537657	.	C	T	9	11	20	0	0	20	0	0
7	38539320	.	T	A	3	11	14	0	1	15	0	0
7	38539554	.	A	G	6	7	13	0	0	13	0	0
7	38539577	.	A	G	8	10	18	0	0	18	0	0
7	38539643	.	C	A	4	9	13	0	0	13	0	0
7	38539730	.	G	A	6	9	15	0	0	15	0	0
7	38539768	.	T	A	8	8	16	0	4	20	0	0
7	38539992	.	G	A	10	10	20	0	1	21	0	0
7	38540134	.	G	A	9	12	21	0	0	21	0	0
7	38544706	.	A	G	11	6	17	0	1	18	0	0
7	38552294	.	T	C	4	4	8	0	0	8	0	0
7	38578128	.	T	C	1	4	5	0	0	5	0	0
7	38578140	.	T	C	1	2	3	0	0	3	0	0
7	38594474	.	A	C	13	15	28	0	1	29	0	0
7	38594510	.	G	C	9	10	19	0	0	19	0	0
7	38600226	.	A	G	20	17	37	0	3	40	0	0
7	38600265	.	T	C	21	21	42	0	0	42	0	0
7	38600483	.	A	G	23	11	34	0	2	36	0	0
7	38600585	.	C	T	0	31	31	0	18	49	0	0
7	38600892	.	G	A	16	19	35	0	1	36	0	0
7	38600982	.	G	A	28	25	53	0	2	55	0	0
7	38601025	.	G	T	39	14	53	0	3	56	0	0
7	38601067	.	G	T	39	19	58	0	1	59	0	0
7	38601156	.	G	T	20	21	41	0	5	46	0	0
7	38601374	.	C	T	24	25	49	0	3	52	0	0
7	38601391	.	T	A	21	35	56	0	1	57	0	0
7	38601417	.	A	C	18	39	57	0	4	61	0	0
7	38601625	.	C	A	33	6	39	0	1	40	0	0
7	38601646	.	G	A	21	16	37	0	2	39	0	0
7	38601751	.	T	C	29	16	45	0	2	47	0	0
7	38601759	.	C	G	30	17	47	0	5	52	0	0
7	38601823	.	C	A	1	11	12	0	32	44	0	0
7	38601909	.	C	T	2	18	20	0	23	43	0	0
7	38602123	.	C	T	29	21	50	0	4	54	0	0
7	38602160	.	A	T	23	30	53	0	2	55	0	0
7	38602623	.	T	C	31	25	56	0	2	58	0	0
7	38602656	.	G	A	29	23	52	0	2	54	0	0
7	38602917	.	A	T	41	18	59	0	1	60	0	0
7	38612100	.	A	G	1	2	3	0	0	3	0	0
7	38612109	.	G	A	3	5	8	0	0	8	0	0
7	38674189	.	T	C	2	0	2	0	0	2	0	0
7	38677497	.	T	C	18	16	34	0	3	37	0	0
7	38677880	.	G	T	12	12	24	0	0	24	0	0
7	38677999	.	A	T	9	13	22	0	0	22	0	0
7	38681322	.	C	T	3	2	5	0	0	5	0	0
7	38683834	.	T	C	5	8	13	0	0	13	0	0
7	38684830	.	C	T	18	11	29	0	0	29	0	0
7	38684970	.	C	T	11	13	24	0	1	25	0	0
7	38687152	.	G	A	1	2	3	0	0	3	0	0
7	38689531	.	G	T	0	3	3	0	1	4	0	0
7	38689592	.	A	T	1	6	7	0	0	7	0	0
7	38689954	.	G	C	2	3	5	0	0	5	0	0
7	38696163	.	A	G	34	35	69	0	3	72	0	0
7	38703509	.	C	T	0	3	3	0	3	6	0	0
7	38703598	.	C	T	7	5	12	0	1	13	0	0
7	38704006	.	G	A	6	3	9	0	0	9	0	0
7	38704009	.	G	A	6	3	9	0	0	9	0	0
7	38704082	.	T	C	10	2	12	0	1	13	0	0
7	38704622	.	C	A	2	6	8	0	2	10	0	0
7	38704623	.	T	C	2	0	2	0	8	10	0	0
7	38704754	.	C	T	3	6	9	0	0	9	0	0
7	38704832	.	G	A	5	4	9	0	1	10	0	0
7	38704834	.	A	G	6	4	10	0	0	10	0	0
7	38705012	.	A	T	6	8	14	0	0	14	0	0
7	38705097	.	A	C	3	0	3	0	2	5	0	0
7	38705367	.	C	G	1	5	6	0	3	9	0	0
7	38705643	.	A	G	4	4	8	0	0	8	0	0
7	38709326	.	G	T	3	2	5	0	0	5	0	0
7	38709701	.	G	A	0	1	1	0	0	1	0	0
7	38714503	.	A	T	2	5	7	0	0	7	0	0
7	38717795	.	G	A	2	2	4	0	3	7	0	0
7	38717819	.	A	C	10	3	13	0	0	13	0	0
7	38726646	.	A	G	10	9	19	0	1	20	0	0
7	38734152	.	G	A	1	6	7	0	10	17	0	0
7	38734431	.	C	A	14	8	22	0	0	22	0	0
7	38734475	.	A	C	15	18	33	0	1	34	0	0
7	38734527	.	T	C	15	13	28	0	0	28	0	0
7	38734573	.	A	G	13	11	24	0	2	26	0	0
7	38734626	.	G	T	15	19	34	0	1	36	1	0
7	38735363	.	A	G	11	16	27	0	3	30	0	0
7	38735406	.	C	T	11	17	28	0	3	31	0	0
7	38735460	.	G	T	19	21	40	0	3	43	0	0
7	38735465	.	A	C	21	19	40	0	2	42	0	0
7	38735501	.	T	C	13	17	30	0	0	30	0	0
7	38735552	.	T	A	2	4	6	0	3	9	0	0
7	38735580	.	G	T	1	6	7	0	1	8	0	0
7	38735711	.	G	A	17	8	25	0	1	26	0	0
7	38735727	.	A	T	16	9	25	0	2	27	0	0
7	38735827	.	A	C	8	6	14	0	3	17	0	0
7	38736320	.	G	C	25	18	43	0	2	45	0	0
7	38736526	.	C	T	10	13	23	0	0	23	0	0
7	38736616	.	T	A	3	6	9	0	0	9	0	0
7	38736761	.	T	C	1	3	4	0	0	4	0	0
7	38736818	.	C	A	4	3	7	0	0	7	0	0
7	38736819	.	A	G	4	3	7	0	0	7	0	0
7	38736912	.	T	C	4	5	9	0	0	9	0	0
7	38737020	.	T	C	9	12	21	0	0	21	0	0
7	38737224	.	C	T	12	9	21	0	0	21	0	0
7	38737286	.	C	T	8	8	16	0	3	19	0	0
7	38749962	.	T	C	1	2	3	0	0	3	0	0
7	38749964	.	A	G	1	2	3	0	0	3	0	0
7	38773039	.	C	T	2	3	5	0	0	5	0	0
7	38775075	.	A	G	3	3	6	0	0	6	0	0
7	38775078	.	C	T	3	4	7	0	0	7	0	0
7	38777082	.	C	T	8	2	10	0	1	11	0	0
7	38779759	.	A	G	7	0	7	0	11	18	0	0
7	38783439	.	C	T	18	18	36	0	1	37	0	0
7	38783644	.	A	G	12	18	30	0	1	31	0	0
7	38783742	.	G	A	28	10	38	0	1	39	0	0
7	38783972	.	T	C	12	10	22	0	1	23	0	0
7	38784327	.	G	A	13	13	26	0	1	27	0	0
7	38784766	.	C	A	24	25	49	0	3	52	0	0
7	38784786	.	T	A	28	27	55	0	1	57	1	0
7	38784818	.	G	A	29	27	56	0	2	58	0	0
7	38784976	.	T	A	21	28	49	0	1	50	0	0
7	38785069	.	C	T	15	11	26	0	2	28	0	0
7	38785182	.	G	C	1	17	18	0	19	37	0	0
7	38785224	.	G	A	0	23	23	0	17	40	0	0
7	38794090	.	T	G	18	15	33	0	0	33	0	0
7	38794235	.	C	T	16	10	26	0	0	26	0	0
7	38798630	.	A	G	0	3	3	0	1	4	0	0
7	38805508	.	T	G	0	3	3	0	0	3	0	0
7	38807677	.	T	G	9	4	13	0	2	15	0	0
7	38807714	.	G	A	11	13	24	0	0	24	0	0
7	38807723	.	A	T	12	13	25	0	0	26	1	0
7	38807797	.	G	A	2	6	8	0	0	8	0	0
7	38809865	.	G	T	0	5	5	0	5	10	0	0
7	38810084	.	A	C	2	4	6	0	0	6	0	0
7	38822327	.	C	T	8	6	14	0	1	15	0	0
7	38822368	.	A	T	4	7	11	0	0	11	0	0
7	38822528	.	C	A	0	2	2	0	5	7	0	0
7	38822559	.	C	T	0	2	2	0	4	6	0	0
7	38824259	.	G	A	3	2	5	0	0	5	0	0
7	38824387	.	C	G	5	2	7	0	0	7	0	0
7	38824972	.	G	A	1	0	1	0	0	1	0	0
7	38827635	.	T	A	1	0	1	0	0	1	0	0
7	38842502	.	C	T	0	5	5	0	5	10	0	0
7	39089696	.	C	A	1	1	2	0	0	2	0	0
7	39100137	.	C	A	0	1	1	0	0	1	0	0
7	39123095	.	G	A	0	3	3	0	3	6	0	0
7	39153769	.	C	A	8	7	15	0	1	16	0	0
7	39153849	.	G	A	0	4	4	0	7	11	0	0
7	39153975	.	G	A	2	3	5	0	1	6	0	0
7	39154119	.	C	T	9	5	14	0	0	14	0	0
7	39154181	.	A	T	2	5	7	0	2	9	0	0
7	39154272	.	A	T	4	4	8	0	2	10	0	0
7	39154733	.	G	T	2	2	4	0	0	4	0	0
7	39154971	.	C	T	12	3	15	0	0	15	0	0
7	39155099	.	C	T	3	3	6	0	0	6	0	0
7	39155115	.	T	C	3	3	6	0	2	8	0	0
7	39155157	.	A	G	5	4	9	0	1	10	0	0
7	39155163	.	C	A	5	3	8	0	0	9	1	0
7	39155344	.	G	A	2	5	7	0	1	8	0	0
7	39155758	.	T	G	1	2	3	0	0	3	0	0
7	39155940	.	T	A	8	6	14	0	0	14	0	0
7	39156140	.	T	C	14	9	23	0	1	24	0	0
7	39156161	.	C	T	6	12	18	0	1	19	0	0
7	39156207	.	T	C	8	6	14	0	1	15	0	0
7	39156474	.	T	C	12	8	20	0	1	21	0	0
7	39156673	.	A	T	3	2	5	0	0	5	0	0
7	39156760	.	A	G	10	9	19	0	1	20	0	0
7	39157175	.	A	T	6	12	18	0	1	19	0	0
7	39157219	.	G	A	0	6	6	0	8	14	0	0
7	39157239	.	C	A	8	10	18	0	1	19	0	0
7	39174052	.	T	C	2	3	5	0	0	5	0	0
7	39174452	.	G	A	0	11	11	0	12	23	0	0
7	39176261	.	G	A	0	8	8	0	7	15	0	0
7	39176444	.	G	A	0	16	16	0	23	39	0	0
7	39176447	.	A	C	21	15	36	0	0	38	2	0
7	39176739	.	A	T	11	10	21	0	1	22	0	0
7	39176863	.	G	A	14	17	31	0	1	32	0	0
7	39176881	.	G	A	15	10	25	0	4	29	0	0
7	39176940	.	A	G	2	7	9	0	0	9	0	0
7	39176957	.	A	G	1	4	5	0	1	6	0	0
7	39176983	.	T	C	2	6	8	0	1	9	0	0
7	39177729	.	A	G	12	8	20	0	2	23	1	0
7	39177871	.	C	A	5	7	12	0	0	12	0	0
7	39178065	.	A	G	2	7	9	0	1	10	0	0
7	39181275	.	A	G	8	8	16	0	2	18	0	0
7	39181318	.	C	T	15	9	24	0	2	26	0	0
7	39181597	.	C	A	15	13	28	0	1	29	0	0
7	39181853	.	C	A	4	7	11	0	0	11	0	0
7	39182265	.	T	C	11	9	20	0	0	20	0	0
7	39182433	.	T	C	9	22	31	0	1	32	0	0
7	39182910	.	G	A	10	12	22	0	0	22	0	0
7	39183045	.	A	G	2	15	17	0	0	17	0	0
7	39537921	.	A	T	2	2	4	0	0	4	0	0
7	39537983	.	C	G	2	6	8	0	0	8	0	0
7	39538001	.	T	C	6	3	9	0	1	10	0	0
7	39538153	.	T	C	4	3	7	0	0	7	0	0
7	39541293	.	T	G	0	1	1	0	0	1	0	0
7	39541452	.	A	C	0	1	1	0	0	1	0	0
7	39551834	.	G	T	3	0	3	0	0	3	0	0
7	39551880	.	C	T	0	0	0	0	1	1	0	0
7	39642671	.	G	A	0	1	1	0	3	4	0	0
7	39643001	.	G	A	2	2	4	0	0	4	0	0
7	39643046	.	A	G	1	2	3	0	0	3	0	0
7	39648980	.	A	G	1	0	1	0	0	1	0	0
7	39649070	.	C	T	1	1	2	0	0	2	0	0
7	39654722	.	C	T	4	2	6	0	0	6	0	0
7	39655392	.	T	G	1	2	3	0	0	3	0	0
7	39656394	.	T	A	1	5	6	0	0	6	0	0
7	39656620	.	G	A	9	4	13	0	0	13	0	0
7	39656916	.	C	T	5	3	8	0	1	9	0	0
7	39656950	.	G	T	4	5	9	0	0	9	0	0
7	39657301	.	C	T	3	1	4	0	0	4	0	0
7	39657797	.	G	T	3	3	6	0	0	6	0	0
7	39658224	.	A	C	7	11	18	0	2	20	0	0
7	39658293	.	C	A	7	6	13	0	1	14	0	0
7	39658356	.	T	C	5	6	11	0	0	11	0	0
7	39658445	.	C	A	8	7	15	0	0	15	0	0
7	39658730	.	G	T	0	7	7	0	13	20	0	0
7	39658831	.	T	G	9	12	21	0	0	21	0	0
7	39659275	.	A	C	5	5	10	0	0	10	0	0
7	39659400	.	T	A	0	5	5	1	0	6	0	0
7	39659607	.	A	C	4	3	7	0	0	7	0	0
7	39659608	.	A	T	4	3	7	0	0	7	0	0
7	39659711	.	A	C	5	2	7	0	0	7	0	0
7	39659758	.	C	A	2	2	4	1	1	6	0	0
7	39659806	.	G	A	5	3	8	0	0	8	0	0
7	39659973	.	A	G	9	7	16	0	0	16	0	0
7	39660054	.	A	C	8	6	14	0	3	17	0	0
7	39660201	.	G	A	14	10	24	0	4	28	0	0
7	39660240	.	A	T	8	22	30	0	1	31	0	0
7	39660249	.	A	C	15	21	36	0	2	38	0	0
7	39670892	.	G	C	7	3	10	0	0	10	0	0
7	39671118	.	T	A	5	4	9	0	0	9	0	0
7	39671281	.	G	A	7	15	22	0	0	22	0	0
7	39671647	.	C	T	3	9	12	0	0	12	0	0
7	39671715	.	A	C	2	3	5	0	0	5	0	0
7	39672054	.	A	T	3	8	11	0	1	12	0	0
7	39672165	.	G	A	6	2	8	0	2	10	0	0
7	39672741	.	A	G	8	12	20	0	0	20	0	0
7	39673095	.	A	G	10	0	10	0	6	16	0	0
7	39673773	.	G	C	1	5	6	0	7	13	0	0
7	39675838	.	A	G	5	9	14	0	0	14	0	0
7	39675961	.	T	A	4	4	8	0	0	8	0	0
7	39676027	.	A	G	3	2	5	0	0	5	0	0
7	39676183	.	T	A	7	6	13	0	0	13	0	0
7	39676364	.	T	G	5	2	7	0	0	7	0	0
7	39676365	.	C	T	5	2	7	0	0	7	0	0
7	39676446	.	A	T	4	6	10	0	0	10	0	0
7	39676518	.	A	G	5	5	10	0	0	10	0	0
7	39676833	.	T	C	8	8	16	0	0	16	0	0
7	39676947	.	T	G	9	8	17	0	3	20	0	0
7	39676948	.	T	G	13	6	19	0	1	20	0	0
7	39677347	.	G	A	12	5	17	0	0	17	0	0
7	39677948	.	G	T	4	11	15	0	0	16	1	0
7	39691357	.	G	A	2	3	5	0	0	5	0	0
7	39693686	.	T	C	1	0	1	0	0	1	0	0
7	39701913	.	A	C	0	5	5	0	0	5	0	0
7	39702105	.	A	T	3	4	7	0	0	7	0	0
7	39702117	.	G	T	2	2	4	1	0	5	0	0
7	39703139	.	G	A	0	3	3	0	2	5	0	0
7	39703720	.	G	T	1	1	2	0	1	3	0	0
7	39703734	.	T	C	1	2	3	0	0	3	0	0
7	39704063	.	T	A	8	3	11	0	0	11	0	0
7	39704085	.	A	G	7	5	12	0	1	13	0	0
7	39704166	.	A	T	7	1	8	0	0	8	0	0
7	39704229	.	C	T	2	9	11	0	0	11	0	0
7	39705013	.	T	A	9	5	14	0	0	14	0	0
7	39705055	.	G	A	12	5	17	0	0	17	0	0
7	39705601	.	A	G	4	4	8	0	0	8	0	0
7	39742574	.	G	T	1	2	3	0	0	3	0	0
7	39742729	.	T	A	2	2	4	0	1	5	0	0
7	39742730	.	A	T	3	2	5	0	0	5	0	0
7	39742820	.	T	G	4	2	6	0	0	6	0	0
7	39742841	.	A	T	3	5	8	0	1	9	0	0
7	39743014	.	A	G	2	0	2	0	3	5	0	0
7	39743126	.	G	A	8	3	11	0	0	11	0	0
7	39743332	.	G	A	1	2	3	0	0	3	0	0
7	39743358	.	G	A	1	2	3	0	0	3	0	0
7	39743439	.	A	G	3	2	5	0	0	5	0	0
7	39744543	.	G	A	4	6	10	0	0	10	0	0
7	39745091	.	T	C	5	3	8	0	1	9	0	0
7	39745110	.	A	T	3	8	11	0	0	11	0	0
7	39748847	.	T	C	2	3	5	0	0	5	0	0
7	39748934	.	A	C	8	9	17	0	0	17	0	0
7	39758749	.	G	A	2	4	6	0	0	6	0	0
7	39919589	.	T	C	1	2	3	0	0	3	0	0
7	39983885	.	G	A	0	0	0	0	1	1	0	0
7	40050962	.	C	T	2	3	5	0	0	5	0	0
7	40050986	.	G	C	0	3	3	0	1	4	0	0
7	40053306	.	G	A	1	1	2	0	0	2	0	0
7	40053490	.	T	C	8	3	11	0	0	11	0	0
7	40053537	.	C	T	7	7	14	0	0	14	0	0
7	40053717	.	T	A	5	4	9	0	0	9	0	0
7	40053720	.	G	A	4	5	9	0	0	9	0	0
7	40053978	.	C	T	6	5	11	0	0	11	0	0
7	40054234	.	G	A	4	6	10	0	0	10	0	0
7	40054464	.	A	C	2	5	7	0	0	7	0	0
7	40054814	.	C	T	2	3	5	0	0	5	0	0
7	40054901	.	G	T	8	4	12	0	1	13	0	0
7	40054925	.	G	T	0	5	5	0	9	14	0	0
7	40055080	.	T	C	7	9	16	0	0	16	0	0
7	40055099	.	C	T	8	5	13	0	1	14	0	0
7	40055117	.	T	A	7	5	12	0	0	12	0	0
7	40055178	.	C	G	5	9	14	0	1	15	0	0
7	40055219	.	A	T	8	2	10	0	0	10	0	0
7	40055612	.	C	T	4	2	6	0	0	6	0	0
7	40055628	.	G	A	5	2	7	0	0	7	0	0
7	40055672	.	G	A	3	3	6	0	0	6	0	0
7	40055711	.	A	T	1	3	4	0	0	4	0	0
7	40055844	.	C	T	7	3	10	0	0	10	0	0
7	40055928	.	T	C	4	5	9	0	0	9	0	0
7	40055945	.	C	T	3	5	8	0	0	8	0	0
7	40056060	.	C	T	8	5	13	0	1	14	0	0
7	40056112	.	T	G	14	6	20	0	0	20	0	0
7	40056243	.	C	A	4	5	9	0	1	10	0	0
7	40056307	.	C	T	8	6	14	0	0	14	0	0
7	40056353	.	G	A	5	5	10	0	2	12	0	0
7	40056417	.	C	A	4	9	13	0	1	14	0	0
7	40056542	.	A	T	7	9	16	0	0	16	0	0
7	40056587	.	C	T	7	12	19	0	0	19	0	0
7	40056589	.	T	C	7	12	19	0	0	19	0	0
7	40056851	.	T	C	4	6	10	0	0	10	0	0
7	40056854	.	C	T	5	3	8	0	1	9	0	0
7	40056982	.	C	T	1	2	3	0	0	3	0	0
7	40057140	.	G	A	5	6	11	0	0	11	0	0
7	40057393	.	C	T	6	5	11	0	0	11	0	0
7	40057581	.	T	G	7	10	17	0	1	18	0	0
7	40057674	.	A	G	3	4	7	0	0	7	0	0
7	40059207	.	G	A	9	3	12	0	0	12	0	0
7	40059248	.	T	C	12	5	17	0	0	17	0	0
7	40063669	.	G	T	5	2	7	0	0	7	0	0
7	40070301	.	G	A	3	4	7	0	0	7	0	0
7	40070461	.	T	C	4	0	4	0	0	4	0	0
7	40070464	.	T	C	4	0	4	0	0	4	0	0
7	40071050	.	G	C	1	2	3	0	0	3	0	0
7	40071776	.	G	A	3	2	5	0	0	5	0	0
7	40072184	.	T	C	3	3	6	0	0	6	0	0
7	40072371	.	T	G	3	6	9	0	1	11	1	0
7	40074825	.	A	G	0	2	2	0	0	2	0	0
7	40076634	.	T	C	7	0	7	0	6	13	0	0
7	40079824	.	A	C	1	0	1	0	2	3	0	0
7	40081813	.	C	T	3	2	5	0	2	7	0	0
7	40083683	.	T	A	4	11	15	0	1	16	0	0
7	40083762	.	C	G	3	6	9	0	0	9	0	0
7	40083786	.	A	T	2	6	8	0	0	8	0	0
7	40090547	.	T	A	6	4	10	0	1	11	0	0
7	40090602	.	T	C	17	11	28	0	0	28	0	0
7	40090908	.	A	T	14	4	18	0	0	18	0	0
7	40091190	.	C	T	1	2	3	0	0	3	0	0
7	40091332	.	C	A	8	3	11	0	0	11	0	0
7	40091460	.	C	T	2	4	6	0	0	6	0	0
7	40091543	.	T	C	6	2	8	0	0	8	0	0
7	40091622	.	C	G	8	2	10	0	0	10	0	0
7	40091718	.	G	A	8	10	18	0	0	18	0	0
7	40091749	.	T	C	8	11	19	0	0	19	0	0
7	40091818	.	T	G	11	6	17	0	0	17	0	0
7	40091951	.	A	T	10	4	14	0	1	15	0	0
7	40094104	.	G	T	1	1	2	0	0	2	0	0
7	40094225	.	G	A	3	2	5	0	0	5	0	0
7	40094359	.	C	A	1	0	1	0	0	1	0	0
7	40097105	.	A	C	1	3	4	0	1	5	0	0
7	40097345	.	A	G	5	5	10	0	0	10	0	0
7	40097395	.	A	G	5	3	8	0	0	8	0	0
7	40097396	.	T	C	5	3	8	0	0	8	0	0
7	40097602	.	A	G	1	0	1	0	4	5	0	0
7	40100168	.	A	C	5	7	12	0	0	12	0	0
7	40100357	.	C	T	2	2	4	0	0	4	0	0
7	40100976	.	C	T	3	4	7	0	0	7	0	0
7	40102418	.	T	G	1	2	3	0	0	3	0	0
7	40102457	.	C	A	3	2	5	0	0	5	0	0
7	40123989	.	T	C	5	0	5	0	3	8	0	0
7	40138268	.	C	T	0	2	2	0	0	2	0	0
7	40138794	.	C	T	0	1	1	0	0	1	0	0
7	40138808	.	C	T	0	1	1	0	0	1	0	0
7	40144428	.	T	A	3	4	7	0	1	8	0	0
7	40188991	.	C	T	5	3	8	0	0	8	0	0
7	40197623	.	C	A	2	2	4	0	0	4	0	0
7	40200740	.	G	A	3	4	7	0	0	7	0	0
7	40201016	.	C	T	0	2	2	0	0	2	0	0
7	40201108	.	G	T	3	6	9	0	1	10	0	0
7	40201200	.	G	A	3	2	5	0	0	5	0	0
7	40201975	.	A	G	8	4	12	0	0	12	0	0
7	40228499	.	A	T	19	9	28	0	0	28	0	0
7	40292834	.	T	C	5	1	6	0	0	6	0	0
7	40318309	.	T	A	9	9	18	0	0	18	0	0
7	40318486	.	A	G	13	1	14	0	18	32	0	0
7	40318580	.	G	T	10	7	17	0	0	17	0	0
7	40318593	.	G	A	9	6	15	0	0	15	0	0
7	40321174	.	C	T	11	15	26	0	1	27	0	0
7	40321224	.	A	G	14	12	26	0	0	26	0	0
7	40321273	.	G	T	16	17	33	0	0	33	0	0
7	40321443	.	C	T	10	6	16	0	2	18	0	0
7	40460256	.	T	C	5	6	11	0	0	11	0	0
7	40460371	.	C	T	11	13	24	0	0	24	0	0
7	40466026	.	A	G	16	11	27	0	3	30	0	0
7	40471301	.	A	G	8	6	14	0	0	14	0	0
7	40492740	.	T	A	2	5	7	0	0	7	0	0
7	40492764	.	G	C	0	6	6	0	1	7	0	0
7	40492789	.	T	C	0	4	4	0	2	6	0	0
7	40492800	.	G	T	0	3	3	0	3	6	0	0
7	40498598	.	G	A	15	28	43	0	1	44	0	0
7	40498934	.	C	A	31	20	51	0	3	54	0	0
7	40499177	.	A	C	11	12	23	0	1	24	0	0
7	40499182	.	A	G	11	11	22	0	2	24	0	0
7	40560290	.	G	T	1	1	2	0	1	3	0	0
7	40560303	.	A	C	2	2	4	0	1	5	0	0
7	40560398	.	C	T	4	3	7	0	0	7	0	0
7	40560934	.	G	A	9	14	23	0	0	23	0	0
7	40562743	.	G	A	3	2	5	0	1	6	0	0
7	40562757	.	T	G	2	1	3	0	0	3	0	0
7	40567075	.	T	C	0	1	1	0	1	2	0	0
7	40569966	.	G	A	0	3	3	0	0	3	0	0
7	40578658	.	C	G	7	8	15	0	0	15	0	0
7	40584065	.	A	C	6	6	12	0	0	12	0	0
7	40584121	.	A	C	11	16	27	0	0	27	0	0
7	40584148	.	T	C	11	0	11	0	14	25	0	0
7	40584395	.	G	C	12	4	16	0	0	16	0	0
7	40584415	.	G	C	12	7	19	0	0	20	1	0
7	40584469	.	C	T	7	8	15	0	0	15	0	0
7	40584988	.	A	C	9	5	14	0	0	14	0	0
7	40585112	.	A	G	5	5	10	0	2	12	0	0
7	40585217	.	T	C	6	4	10	0	0	10	0	0
7	40585546	.	A	T	1	4	5	0	0	5	0	0
7	40602439	.	G	A	3	3	6	0	0	6	0	0
7	40607911	.	T	A	0	1	1	0	0	1	0	0
7	40615603	.	T	C	1	2	3	0	0	3	0	0
7	40615648	.	T	C	1	0	1	0	3	4	0	0
7	40616896	.	A	G	3	4	7	0	1	8	0	0
7	40624281	.	A	T	1	0	1	0	0	1	0	0
7	40650862	.	G	T	3	2	5	0	0	5	0	0
7	40650869	.	G	A	3	2	5	0	0	5	0	0
7	40676025	.	G	A	0	2	2	0	0	2	0	0
7	40707966	.	G	A	0	2	2	0	0	2	0	0
7	40708059	.	A	G	5	2	7	0	0	7	0	0
7	40884570	.	T	C	1	2	3	0	0	3	0	0
7	40889981	.	C	T	4	4	8	0	0	8	0	0
7	40890410	.	A	G	7	4	11	0	0	11	0	0
7	40890678	.	G	A	3	4	7	0	0	7	0	0
7	40900772	.	G	A	11	4	15	0	0	15	0	0
7	40900785	.	C	A	0	7	7	0	5	12	0	0
7	40901425	.	T	A	1	5	6	0	0	6	0	0
7	40901436	.	G	A	1	7	8	0	0	8	0	0
7	40901779	.	C	G	3	5	8	0	0	8	0	0
7	40901945	.	T	C	3	2	5	0	0	5	0	0
7	40903292	.	G	A	1	6	7	0	0	7	0	0
7	40903491	.	T	A	4	5	9	0	0	9	0	0
7	40904949	.	G	T	1	2	3	0	0	3	0	0
7	40905695	.	A	T	8	11	19	0	0	19	0	0
7	40905774	.	C	T	0	10	10	0	18	28	0	0
7	40906286	.	T	C	8	6	14	0	0	14	0	0
7	40906377	.	T	C	2	6	8	0	0	8	0	0
7	40906415	.	T	A	1	3	4	0	0	4	0	0
7	40931873	.	T	A	8	3	11	0	0	11	0	0
7	40931874	.	C	T	0	3	3	0	8	11	0	0
7	40942588	.	G	C	4	5	9	0	1	10	0	0
7	40989156	.	A	G	3	3	6	0	0	6	0	0
7	40990473	.	G	C	4	3	7	0	0	7	0	0
7	40993298	.	G	A	6	5	11	0	0	11	0	0
7	40993422	.	G	A	5	4	9	0	0	9	0	0
7	40993442	.	T	G	5	3	8	0	0	8	0	0
7	41008618	.	T	C	6	14	20	0	0	20	0	0
7	41009217	.	C	T	0	11	11	0	17	28	0	0
7	41009797	.	T	A	17	15	32	0	1	33	0	0
7	41012081	.	A	T	3	3	6	0	2	8	0	0
7	41012505	.	C	T	0	3	3	0	3	6	0	0
7	41014175	.	C	T	7	6	13	0	0	13	0	0
7	41147792	.	A	G	3	0	3	0	1	4	0	0
7	41157531	.	G	C	12	18	30	0	3	33	0	0
7	41157735	.	T	C	20	16	36	0	1	37	0	0
7	41157805	.	C	A	23	16	39	0	1	40	0	0
7	41157997	.	G	A	13	10	23	0	0	23	0	0
7	41158057	.	C	T	11	9	20	0	0	20	0	0
7	41238313	.	C	T	0	2	2	0	0	2	0	0
7	41238671	.	T	C	1	2	3	0	1	4	0	0
7	41249613	.	A	G	2	0	2	0	4	6	0	0
7	41250813	.	T	C	0	1	1	0	0	1	0	0
7	41255443	.	A	T	1	0	1	0	0	1	0	0
7	41258015	.	T	C	5	6	11	0	0	11	0	0
7	41261343	.	C	A	2	3	5	0	0	5	0	0
7	41262058	.	T	G	1	1	2	0	0	2	0	0
7	41262277	.	A	G	7	10	17	0	0	17	0	0
7	41262361	.	G	A	4	3	7	0	0	7	0	0
7	41263277	.	G	A	0	5	5	0	7	12	0	0
7	41267424	.	C	T	1	1	2	0	0	2	0	0
7	41269653	.	C	G	0	1	1	0	0	1	0	0
7	41273527	.	T	C	4	9	13	0	0	13	0	0
7	41273889	.	T	C	5	5	10	0	0	10	0	0
7	41274080	.	T	G	5	12	17	0	1	18	0	0
7	41274258	.	T	C	5	7	12	0	0	12	0	0
7	41274261	.	A	G	5	0	5	0	7	12	0	0
7	41274802	.	C	A	11	9	20	0	4	24	0	0
7	41274896	.	A	C	13	8	21	0	3	24	0	0
7	41274916	.	A	C	12	10	22	0	1	23	0	0
7	41274943	.	T	A	11	13	24	0	1	25	0	0
7	41313894	.	G	C	3	6	9	0	0	9	0	0
7	41313920	.	C	A	1	6	7	0	0	7	0	0
7	41314900	.	G	T	1	2	3	0	0	3	0	0
7	41318020	.	A	G	2	2	4	0	1	5	0	0
7	41318023	.	A	T	2	2	4	0	1	5	0	0
7	41318087	.	A	T	2	2	4	0	0	4	0	0
7	41326482	.	A	G	1	2	3	0	0	3	0	0
7	41329674	.	T	G	3	2	5	0	0	5	0	0
7	41329683	.	A	G	3	2	5	0	1	6	0	0
7	41330059	.	T	A	1	2	3	0	0	3	0	0
7	41340562	.	C	T	1	2	3	0	0	3	0	0
7	41340641	.	T	C	5	2	7	0	0	7	0	0
7	41345059	.	G	A	2	2	4	0	0	4	0	0
7	41345105	.	C	T	1	2	3	0	0	3	0	0
7	41345123	.	C	T	2	2	4	0	0	4	0	0
7	41345282	.	A	C	2	4	6	0	0	6	0	0
7	41345375	.	T	C	3	2	5	0	0	5	0	0
7	41345393	.	A	T	2	2	4	0	0	4	0	0
7	41345463	.	T	G	2	6	8	0	0	8	0	0
7	41345720	.	G	A	1	2	3	0	0	3	0	0
7	41345723	.	T	C	1	1	2	0	0	2	0	0
7	41347123	.	A	G	3	0	3	0	2	5	0	0
7	41347138	.	C	T	3	2	5	0	0	5	0	0
7	41347642	.	T	C	3	4	7	0	2	9	0	0
7	41347813	.	C	T	7	3	10	0	0	10	0	0
7	41347897	.	C	T	3	4	7	0	0	7	0	0
7	41349128	.	C	T	0	6	6	0	4	10	0	0
7	41349454	.	G	T	2	7	9	0	0	9	0	0
7	41350424	.	A	G	1	0	1	0	0	1	0	0
7	41353258	.	G	A	2	4	6	0	1	7	0	0
7	41355308	.	T	C	1	4	5	0	1	6	0	0
7	41356547	.	C	T	0	2	2	0	0	2	0	0
7	41357602	.	G	A	4	2	6	0	0	6	0	0
7	41357623	.	G	C	3	2	5	0	0	5	0	0
7	41401851	.	C	T	2	2	4	0	0	4	0	0
7	41402943	.	C	G	0	3	3	0	0	3	0	0
7	41402988	.	G	C	3	6	9	0	0	9	0	0
7	41403970	.	T	A	3	4	7	0	0	7	0	0
7	41403991	.	A	T	5	6	11	0	2	13	0	0
7	41404012	.	A	G	6	7	13	0	1	14	0	0
7	41404081	.	C	T	10	3	13	0	1	14	0	0
7	41404090	.	T	C	9	3	12	0	1	13	0	0
7	41404434	.	T	C	4	0	4	0	5	9	0	0
7	41404552	.	G	A	4	5	9	0	0	9	0	0
7	41404564	.	A	G	7	6	13	0	0	13	0	0
7	41406005	.	G	A	1	2	3	0	0	3	0	0
7	41413530	.	G	A	3	2	5	0	0	5	0	0
7	41413760	.	C	T	0	1	1	0	0	1	0	0
7	41413781	.	A	T	1	2	3	0	0	3	0	0
7	41419132	.	G	A	5	2	7	0	0	7	0	0
7	41419183	.	G	T	2	0	2	0	0	2	0	0
7	41422123	.	C	A	2	3	5	0	0	5	0	0
7	41422318	.	C	G	3	2	5	0	1	6	0	0
7	41427737	.	G	T	6	4	10	0	0	10	0	0
7	41430417	.	T	C	4	6	10	0	0	10	0	0
7	41431901	.	A	T	1	3	4	0	0	4	0	0
7	41431916	.	T	C	2	3	5	0	0	5	0	0
7	41432220	.	G	A	0	7	7	0	4	11	0	0
7	41432324	.	T	A	4	2	6	0	0	6	0	0
7	41432676	.	T	C	10	9	19	0	1	20	0	0
7	41432732	.	A	T	3	14	17	0	0	17	0	0
7	41432906	.	T	C	7	12	19	0	1	20	0	0
7	41433390	.	T	A	5	3	8	0	0	8	0	0
7	41436575	.	T	C	3	0	3	0	7	10	0	0
7	41436811	.	T	A	5	3	8	0	0	8	0	0
7	41436845	.	G	A	6	5	11	0	1	12	0	0
7	41436902	.	A	G	3	6	9	0	1	10	0	0
7	41436907	.	G	A	4	7	11	0	0	11	0	0
7	41437342	.	A	C	8	10	18	0	1	19	0	0
7	41437363	.	A	G	9	9	18	0	0	18	0	0
7	41437623	.	C	A	5	13	18	0	1	19	0	0
7	41437715	.	T	G	7	11	18	0	0	18	0	0
7	41437827	.	C	A	0	5	5	0	16	21	0	0
7	41437948	.	G	A	8	6	14	0	1	15	0	0
7	41438036	.	A	C	3	7	10	0	0	10	0	0
7	41438502	.	C	T	0	4	4	0	5	9	0	0
7	41438676	.	G	T	6	7	13	0	1	14	0	0
7	41438677	.	T	C	7	6	13	0	1	14	0	0
7	41438826	.	C	T	1	6	7	0	13	20	0	0
7	41438871	.	C	T	1	4	5	0	11	16	0	0
7	41438970	.	G	A	11	11	22	0	1	23	0	0
7	41439411	.	C	T	0	2	2	0	5	7	0	0
7	41443125	.	G	A	3	2	5	0	0	5	0	0
7	41443186	.	C	T	0	1	1	0	3	4	0	0
7	41452225	.	T	C	6	0	6	0	3	9	0	0
7	41491635	.	T	G	5	5	10	0	0	10	0	0
7	41491652	.	C	T	4	4	8	0	0	8	0	0
7	41491701	.	A	T	6	3	9	0	1	10	0	0
7	41491744	.	A	G	9	2	11	0	0	11	0	0
7	41491745	.	G	T	9	2	11	0	0	11	0	0
7	41491785	.	A	G	8	4	12	0	0	12	0	0
7	41491841	.	T	C	5	6	11	0	1	12	0	0
7	41498075	.	T	C	1	3	4	0	0	4	0	0
7	41500538	.	A	G	7	4	11	0	1	12	0	0
7	41500676	.	G	A	1	0	1	0	0	1	0	0
7	41501061	.	A	G	3	3	6	0	0	6	0	0
7	41501124	.	A	G	1	0	1	0	0	1	0	0
7	41503775	.	G	A	0	1	1	0	0	1	0	0
7	41506677	.	A	G	0	4	4	0	0	4	0	0
7	41506683	.	T	C	0	4	4	0	0	4	0	0
7	41511626	.	C	T	5	3	8	0	0	8	0	0
7	41512833	.	T	A	0	4	4	0	0	4	0	0
7	41517442	.	C	G	2	7	9	0	0	9	0	0
7	41517467	.	A	G	3	6	9	0	0	9	0	0
7	41517593	.	G	T	5	3	8	0	0	8	0	0
7	41517607	.	T	A	3	2	5	0	1	6	0	0
7	41517777	.	T	A	0	4	4	0	0	4	0	0
7	41517796	.	T	C	1	4	5	0	0	5	0	0
7	41517909	.	T	A	4	3	7	0	0	7	0	0
7	41517978	.	A	G	4	4	8	0	0	8	0	0
7	41518033	.	G	A	5	5	10	0	1	11	0	0
7	41518217	.	C	A	0	7	7	0	8	15	0	0
7	41518328	.	T	G	10	4	14	0	0	14	0	0
7	41518420	.	G	C	5	7	12	0	0	12	0	0
7	41518721	.	G	T	7	6	13	0	2	15	0	0
7	41518727	.	C	T	8	7	15	0	1	16	0	0
7	41518871	.	T	G	5	5	10	0	0	10	0	0
7	41518875	.	G	A	3	5	8	0	2	10	0	0
7	41519283	.	A	C	3	2	5	0	1	6	0	0
7	41519284	.	G	A	4	2	6	0	0	6	0	0
7	41519390	.	A	G	1	2	3	0	0	3	0	0
7	41627849	.	G	C	2	4	6	0	0	7	1	0
7	41627885	.	T	G	3	2	5	0	0	5	0	0
7	41645970	.	T	C	1	0	1	0	3	4	0	0
7	41713997	.	G	A	1	2	3	0	0	3	0	0
7	41714059	.	C	T	0	3	3	0	3	6	0	0
7	41714076	.	A	T	2	4	6	0	0	6	0	0
7	41714140	.	C	T	0	8	8	0	2	10	0	0
7	41714196	.	T	A	7	3	10	0	0	10	0	0
7	41714205	.	C	T	6	3	9	0	0	9	0	0
7	41714244	.	A	G	4	5	9	0	0	9	0	0
7	41714481	.	C	T	3	7	10	0	1	11	0	0
7	41714923	.	G	A	10	7	17	0	0	17	0	0
7	41715446	.	G	A	6	5	11	0	0	11	0	0
7	41715594	.	T	A	3	7	10	0	2	12	0	0
7	41715721	.	T	A	6	5	11	0	0	11	0	0
7	41715794	.	C	T	0	4	4	0	7	11	0	0
7	41726186	.	C	T	0	5	5	0	0	5	0	0
7	41726339	.	C	T	0	6	6	0	4	10	0	0
7	41726355	.	G	T	4	7	11	0	0	11	0	0
7	41726535	.	G	T	1	3	4	0	0	4	0	0
7	41726580	.	A	C	3	6	9	0	0	9	0	0
7	41748916	.	G	T	8	6	14	0	2	16	0	0
7	41749093	.	A	T	5	5	10	0	0	10	0	0
7	41749150	.	A	G	1	4	5	0	0	5	0	0
7	41749382	.	C	T	4	5	9	0	0	9	0	0
7	41751146	.	C	T	4	4	8	0	0	8	0	0
7	41751510	.	T	C	9	6	15	0	0	15	0	0
7	41751671	.	C	T	6	7	13	0	0	13	0	0
7	41752422	.	G	T	6	2	8	0	1	9	0	0
7	41752440	.	A	C	5	5	10	0	0	10	0	0
7	41752463	.	A	G	9	0	9	0	7	16	0	0
7	41752497	.	C	A	10	4	14	1	0	15	0	0
7	41752507	.	C	G	10	2	12	1	0	13	0	0
7	41752631	.	A	G	11	11	22	0	0	22	0	0
7	41752662	.	G	A	9	15	24	0	0	24	0	0
7	41752974	.	T	G	8	0	8	0	10	18	0	0
7	41753107	.	T	A	9	2	11	0	0	11	0	0
7	41753195	.	A	T	7	5	12	0	0	12	0	0
7	41757730	.	G	A	21	26	47	0	0	47	0	0
7	41773951	.	T	G	13	14	27	0	2	29	0	0
7	41774020	.	A	G	13	12	25	0	1	26	0	0
7	41774035	.	G	A	13	14	27	0	0	27	0	0
7	41774125	.	A	G	0	3	3	0	0	3	0	0
7	41780925	.	A	T	11	15	26	0	3	29	0	0
7	41791391	.	A	G	6	3	9	0	0	9	0	0
7	41791469	.	T	C	15	9	24	0	3	27	0	0
7	41791538	.	G	A	3	0	3	0	0	3	0	0
7	41791857	.	C	T	8	9	17	0	0	17	0	0
7	41791920	.	C	T	9	11	20	0	0	20	0	0
7	41805215	.	G	T	0	1	1	0	0	1	0	0
7	41805518	.	C	T	5	0	5	0	0	5	0	0
7	41805881	.	G	A	0	1	1	0	0	1	0	0
7	41873177	.	C	T	4	2	6	0	0	6	0	0
7	41873215	.	A	T	7	5	12	0	0	12	0	0
7	41873256	.	C	T	10	8	18	0	1	19	0	0
7	41873257	.	T	G	9	9	18	0	1	19	0	0
7	41873368	.	T	A	17	13	30	0	0	30	0	0
7	41873426	.	T	C	9	8	17	0	0	17	0	0
7	41873503	.	A	G	10	21	31	0	0	31	0	0
7	41873554	.	A	T	19	21	40	0	0	40	0	0
7	41873691	.	T	C	18	14	32	0	0	32	0	0
7	41875951	.	T	C	9	9	18	0	0	18	0	0
7	41896315	.	A	C	2	4	6	0	0	6	0	0
7	41896385	.	A	G	0	1	1	0	0	1	0	0
7	41899051	.	A	C	3	5	8	0	0	8	0	0
7	41899183	.	T	G	0	0	0	0	3	3	0	0
7	41899187	.	C	T	1	3	4	0	0	4	0	0
7	41899352	.	C	T	6	6	12	0	0	12	0	0
7	41899426	.	C	A	7	4	11	0	0	11	0	0
7	41899674	.	T	C	1	5	6	0	4	10	0	0
7	41900402	.	G	C	0	5	5	0	0	5	0	0
7	41901355	.	A	G	9	6	15	0	3	18	0	0
7	41903633	.	T	A	11	9	20	0	2	22	0	0
7	41903681	.	C	T	17	18	35	0	1	36	0	0
7	41903907	.	A	G	6	11	17	0	2	19	0	0
7	41904152	.	A	G	27	25	52	0	2	54	0	0
7	41904520	.	G	A	11	11	22	0	1	23	0	0
7	41911604	.	C	T	0	5	5	0	10	15	0	0
7	41912618	.	T	C	10	3	13	0	1	14	0	0
7	41957814	.	G	A	1	1	2	0	0	2	0	0
7	41995046	.	T	C	4	2	6	0	0	6	0	0
7	42068201	.	C	T	3	3	6	0	1	7	0	0
7	42096376	.	C	A	4	6	10	0	0	10	0	0
7	42096378	.	A	G	4	6	10	0	0	10	0	0
7	42096413	.	C	T	0	7	7	0	9	16	0	0
7	42125466	.	G	A	3	4	7	0	0	7	0	0
7	42125480	.	C	G	3	4	7	0	0	7	0	0
7	42229877	.	C	T	0	1	1	0	0	1	0	0
7	42267249	.	C	T	3	1	4	0	0	4	0	0
7	42267339	.	T	C	4	3	7	0	0	7	0	0
7	42323699	.	G	C	0	4	4	0	4	8	0	0
7	42338816	.	A	G	12	12	24	0	0	24	0	0
7	42345361	.	G	T	11	9	20	0	0	20	0	0
7	42345681	.	T	A	15	10	25	0	3	28	0	0
7	42345782	.	G	A	5	8	13	0	1	14	0	0
7	43174642	.	G	A	2	3	5	0	0	5	0	0
7	43309851	.	T	G	7	4	11	0	0	11	0	0
7	43760755	.	T	C	21	8	29	0	2	31	0	0
7	43760822	.	G	A	11	15	26	0	2	28	0	0
7	43760875	.	T	A	17	10	27	0	2	29	0	0
7	43760881	.	G	A	5	18	23	0	1	24	0	0
7	43761810	.	T	A	7	11	18	0	0	18	0	0
7	43765189	.	A	G	8	8	16	0	0	16	0	0
7	43765197	.	A	G	10	8	18	0	0	18	0	0
7	43765348	.	G	A	3	7	10	0	0	10	0	0
7	43775054	.	G	A	5	2	7	0	0	7	0	0
7	43778690	.	C	G	15	6	21	0	1	22	0	0
7	43781554	.	G	T	0	1	1	0	1	2	0	0
7	43787480	.	C	G	5	4	9	0	0	9	0	0
7	43840624	.	C	T	4	4	8	0	1	9	0	0
7	43840669	.	G	C	3	4	7	0	1	8	0	0
7	44588458	.	A	G	8	5	13	0	0	13	0	0
7	45400790	.	C	T	8	5	13	0	1	14	0	0
7	45402452	.	C	T	12	9	21	0	0	21	0	0
7	45402887	.	C	A	14	16	30	0	0	30	0	0
7	45402989	.	C	T	17	16	33	0	0	34	1	0
7	45403244	.	C	T	18	11	29	0	1	30	0	0
7	45403292	.	G	A	12	15	27	0	1	28	0	0
7	45403294	.	A	T	12	15	27	0	1	28	0	0
7	45403360	.	T	G	11	7	18	0	0	18	0	0
7	45403370	.	A	T	11	10	21	0	0	21	0	0
7	45403416	.	C	T	11	4	15	0	2	17	0	0
7	45403650	.	T	A	2	3	5	0	0	6	1	0
7	45403735	.	G	A	0	4	4	0	5	9	0	0
7	45403793	.	G	A	4	6	10	0	1	11	0	0
7	45403831	.	A	C	5	2	7	0	0	7	0	0
7	45403844	.	A	G	5	2	7	0	0	7	0	0
7	45403868	.	C	T	2	3	5	0	0	5	0	0
7	45404312	.	G	A	1	2	3	0	1	4	0	0
7	45404323	.	C	T	4	0	4	0	1	5	0	0
7	45404358	.	T	A	3	1	4	0	1	5	0	0
7	45404490	.	C	T	1	6	7	0	0	7	0	0
7	45405558	.	T	C	4	1	5	0	0	5	0	0
7	45405839	.	G	T	2	5	7	0	1	8	0	0
7	45405871	.	A	C	1	4	5	0	0	5	0	0
7	45405992	.	C	T	3	3	6	0	0	6	0	0
7	45971454	.	A	T	4	7	11	0	0	11	0	0
7	46004948	.	T	G	7	3	10	0	1	11	0	0
7	46004971	.	C	G	8	8	16	0	0	16	0	0
7	46004991	.	C	G	8	1	9	0	6	15	0	0
7	46374390	.	A	G	3	5	8	0	1	9	0	0
7	46430098	.	C	T	4	4	8	0	0	8	0	0
7	46430530	.	G	A	4	4	8	0	0	8	0	0
7	46430696	.	T	A	6	9	15	0	0	15	0	0
7	46430847	.	C	G	9	5	14	0	0	14	0	0
7	46431108	.	T	A	10	4	14	0	0	14	0	0
7	46431256	.	C	A	10	10	20	0	1	21	0	0
7	46431273	.	C	G	11	8	19	0	0	19	0	0
7	46431319	.	A	G	7	7	14	0	0	14	0	0
7	46431577	.	G	A	15	14	29	0	2	31	0	0
7	46486048	.	C	T	3	11	14	0	0	14	0	0
7	46486244	.	A	C	6	11	17	0	3	20	0	0
7	46486629	.	G	A	0	16	16	0	13	29	0	0
7	46486719	.	G	T	14	11	25	0	0	25	0	0
7	46487322	.	C	T	8	14	22	0	2	24	0	0
7	46728687	.	G	A	4	6	10	0	0	10	0	0
7	46728721	.	A	C	5	0	5	0	6	11	0	0
7	46728791	.	A	C	6	5	11	0	2	13	0	0
7	46728964	.	A	C	2	5	7	0	0	7	0	0
7	46729053	.	C	T	6	4	10	0	0	10	0	0
7	46729545	.	C	T	0	5	5	0	7	12	0	0
7	46730076	.	A	G	3	6	9	0	1	10	0	0
7	46730178	.	A	T	4	3	7	0	1	8	0	0
7	46730469	.	C	T	6	9	15	0	1	16	0	0
7	46730705	.	C	T	11	4	15	0	0	15	0	0
7	46730754	.	G	A	5	3	8	0	1	9	0	0
7	46730820	.	T	C	3	0	3	0	7	10	0	0
7	46731141	.	C	T	1	5	6	0	1	7	0	0
7	46732134	.	G	A	3	8	11	0	0	11	0	0
7	46732680	.	G	A	2	2	4	0	0	4	0	0
7	46782483	.	G	A	1	4	5	0	0	5	0	0
7	47265729	.	T	C	9	3	12	0	2	14	0	0
7	47265859	.	A	T	5	3	8	0	0	8	0	0
7	47265898	.	G	A	1	2	3	0	2	5	0	0
7	47410829	.	C	T	3	3	6	0	0	6	0	0
7	47411071	.	G	A	0	2	2	0	3	5	0	0
7	47411358	.	C	A	4	4	8	0	0	8	0	0
7	47411434	.	C	T	0	2	2	0	0	2	0	0
7	47411765	.	G	T	1	2	3	0	0	3	0	0
7	47411791	.	C	G	1	7	8	0	0	8	0	0
7	47411962	.	C	A	5	7	12	0	0	12	0	0
7	47412000	.	T	A	12	6	18	0	4	22	0	0
7	47412040	.	C	T	17	6	23	0	0	23	0	0
7	47412173	.	T	C	10	2	12	0	1	13	0	0
7	47412203	.	A	C	9	7	16	0	3	19	0	0
7	47412215	.	C	T	10	7	17	0	0	17	0	0
7	47412366	.	C	T	1	3	4	0	0	4	0	0
7	47412418	.	C	T	2	2	4	0	0	4	0	0
7	47412447	.	T	A	2	5	7	0	0	7	0	0
7	47412495	.	A	G	5	0	5	0	3	8	0	0
7	47412525	.	C	T	1	2	3	0	0	3	0	0
7	47412600	.	G	A	1	5	6	0	0	6	0	0
7	47413517	.	C	A	5	3	8	0	3	11	0	0
7	47413691	.	A	T	2	4	6	0	0	6	0	0
7	47413794	.	G	A	3	2	5	0	0	5	0	0
7	47413948	.	A	T	4	7	11	0	0	11	0	0
7	47414174	.	C	T	3	4	7	0	1	8	0	0
7	47414233	.	T	A	1	8	9	1	0	10	0	0
7	47414348	.	C	T	8	12	20	0	1	21	0	0
7	47416473	.	G	A	2	5	7	0	0	7	0	0
7	47416496	.	T	A	4	2	6	0	1	7	0	0
7	47416790	.	T	A	13	3	16	0	0	16	0	0
7	47416807	.	A	T	12	1	13	0	0	13	0	0
7	47416825	.	A	G	1	0	1	0	11	12	0	0
7	47417002	.	C	A	7	9	16	0	0	16	0	0
7	47417080	.	T	C	7	5	12	0	0	12	0	0
7	47417810	.	C	T	8	14	22	0	1	23	0	0
7	47417934	.	T	A	13	11	24	0	0	24	0	0
7	47418575	.	G	T	14	12	26	0	0	26	0	0
7	47418697	.	C	A	13	15	28	0	0	28	0	0
7	47418847	.	T	A	8	7	15	0	1	16	0	0
7	47419114	.	A	C	8	5	13	0	0	13	0	0
7	47419177	.	A	C	11	0	11	0	15	26	0	0
7	47419653	.	G	A	14	12	26	0	2	28	0	0
7	47419842	.	G	A	11	14	25	0	0	25	0	0
7	47420019	.	A	G	10	9	19	0	1	20	0	0
7	47421313	.	C	T	9	8	17	0	1	18	0	0
7	47448218	.	G	A	3	5	8	0	1	9	0	0
7	47488246	.	C	T	3	4	7	0	0	7	0	0
7	47488312	.	G	A	0	1	1	0	0	1	0	0
7	47507136	.	G	A	9	10	19	0	0	19	0	0
7	47563359	.	C	T	0	10	10	0	2	12	0	0
7	47563714	.	A	G	1	3	4	0	0	4	0	0
7	47563853	.	G	A	1	3	4	0	0	4	0	0
7	47596707	.	T	A	0	2	2	0	0	2	0	0
7	48041940	.	G	A	3	2	5	0	0	5	0	0
7	48041967	.	G	A	4	5	9	0	0	9	0	0
7	48042456	.	A	G	5	4	9	0	0	9	0	0
7	48042483	.	G	T	4	3	7	0	0	7	0	0
7	48054942	.	T	A	0	1	1	0	1	2	0	0
7	48054990	.	G	A	1	4	5	0	0	5	0	0
7	48063519	.	A	G	3	6	9	0	0	9	0	0
7	48063546	.	A	G	3	5	8	0	0	8	0	0
7	48071605	.	T	C	0	3	3	0	0	3	0	0
7	48240935	.	T	C	2	2	4	0	0	4	0	0
7	48252774	.	A	T	6	2	8	0	1	9	0	0
7	48253537	.	G	A	2	3	5	0	0	5	0	0
7	48288848	.	A	G	3	5	8	0	0	8	0	0
7	48291844	.	A	G	6	7	13	0	0	13	0	0
7	48291864	.	G	A	8	11	19	0	1	20	0	0
7	48295902	.	G	T	20	11	31	0	1	32	0	0
7	48295910	.	C	T	24	9	33	0	0	33	0	0
7	48296075	.	A	G	5	9	14	0	1	15	0	0
7	48296181	.	T	G	2	3	5	0	0	5	0	0
7	48300621	.	T	C	6	6	12	0	0	12	0	0
7	48300648	.	G	C	2	6	8	0	1	9	0	0
7	48300795	.	C	T	4	2	6	0	0	6	0	0
7	48302925	.	A	G	3	0	3	0	1	4	0	0
7	48304240	.	A	G	2	2	4	0	2	6	0	0
7	48304247	.	A	G	2	0	2	0	1	3	0	0
7	48304348	.	C	T	4	2	6	0	1	7	0	0
7	48304350	.	A	T	3	3	6	0	1	7	0	0
7	48304548	.	A	T	3	4	7	0	0	7	0	0
7	48304589	.	A	T	4	4	8	0	0	8	0	0
7	48327801	.	A	G	1	5	6	0	0	6	0	0
7	48327867	.	C	A	3	1	4	0	0	4	0	0
7	48342519	.	A	T	1	2	3	0	2	5	0	0
7	48342526	.	T	C	3	2	5	0	0	5	0	0
7	48347478	.	T	G	8	8	16	0	0	16	0	0
7	48347680	.	A	C	9	8	17	0	0	17	0	0
7	48348003	.	G	A	10	14	24	0	0	24	0	0
7	48348006	.	A	G	10	14	24	0	0	24	0	0
7	48348062	.	C	T	10	11	21	0	0	21	0	0
7	48348485	.	A	G	6	9	15	0	0	15	0	0
7	48348519	.	C	T	6	5	11	0	0	11	0	0
7	48348554	.	G	A	7	5	12	0	0	12	0	0
7	48353844	.	G	A	1	2	3	0	0	3	0	0
7	48358792	.	A	T	2	1	3	0	0	3	0	0
7	48369043	.	C	G	0	5	5	0	3	8	0	0
7	48369306	.	G	A	0	1	1	0	0	1	0	0
7	48369999	.	C	T	6	5	11	0	0	11	0	0
7	48370014	.	T	G	8	7	15	0	2	17	0	0
7	48375704	.	A	G	1	1	2	0	0	2	0	0
7	48383527	.	A	G	0	1	1	0	0	1	0	0
7	48383811	.	C	T	2	4	6	0	0	6	0	0
7	48391400	.	T	C	0	0	0	0	4	4	0	0
7	48391532	.	C	T	0	1	1	0	0	1	0	0
7	48460315	.	C	T	11	12	23	0	0	23	0	0
7	48482286	.	C	A	8	10	18	0	0	18	0	0
7	48482370	.	C	T	5	9	14	0	0	14	0	0
7	48482616	.	T	C	4	3	7	0	0	7	0	0
7	48483513	.	T	A	17	16	33	0	1	34	0	0
7	48484269	.	T	C	11	15	26	0	1	27	0	0
7	48484307	.	G	A	0	9	9	0	6	15	0	0
7	48484416	.	G	A	8	5	13	0	0	13	0	0
7	48484621	.	C	T	17	8	25	0	1	26	0	0
7	48664032	.	A	G	2	2	4	0	0	4	0	0
7	48720930	.	G	C	1	0	1	0	2	3	0	0
7	48721692	.	C	T	0	2	2	0	1	3	0	0
7	48788256	.	G	A	1	4	5	0	0	5	0	0
7	48788265	.	A	T	2	6	8	0	0	8	0	0
7	48788369	.	T	C	8	11	19	0	0	19	0	0
7	48788389	.	G	C	7	0	7	0	6	13	0	0
7	48788622	.	G	A	4	4	8	0	1	9	0	0
7	48788790	.	A	T	1	3	4	0	1	5	0	0
7	48788791	.	T	A	1	4	5	0	0	5	0	0
7	48788910	.	C	T	1	6	7	0	0	7	0	0
7	48804734	.	A	G	2	0	2	0	0	2	0	0
7	48805629	.	C	T	2	6	8	0	0	8	0	0
7	48806542	.	G	A	0	3	3	0	0	3	0	0
7	48809031	.	T	C	3	2	5	0	0	5	0	0
7	48811446	.	C	T	2	3	5	0	0	5	0	0
7	48818563	.	T	C	4	1	5	0	0	5	0	0
7	48819684	.	A	G	2	0	2	0	0	2	0	0
7	48820740	.	T	A	0	1	1	0	0	1	0	0
7	48820773	.	C	T	7	8	15	0	0	15	0	0
7	48821065	.	T	C	6	3	9	0	0	9	0	0
7	48821331	.	T	C	4	3	7	0	0	7	0	0
7	48821362	.	C	T	0	1	1	0	0	1	0	0
7	48823809	.	A	T	0	1	1	0	0	1	0	0
7	48829569	.	G	C	15	17	32	0	0	32	0	0
7	48829728	.	A	G	5	4	9	0	0	9	0	0
7	48829926	.	A	T	9	4	13	0	1	14	0	0
7	48830107	.	A	T	3	2	5	0	0	6	1	0
7	49036296	.	T	C	1	2	3	0	0	3	0	0
7	49036549	.	A	G	0	0	0	0	1	1	0	0
7	49046764	.	C	T	4	2	6	0	0	6	0	0
7	49049686	.	G	C	4	5	9	0	0	9	0	0
7	49051660	.	C	T	10	7	17	0	0	17	0	0
7	49052044	.	T	A	7	7	14	0	1	15	0	0
7	49052097	.	T	G	6	11	17	0	0	17	0	0
7	49052112	.	C	T	9	12	21	0	0	21	0	0
7	49052138	.	G	A	13	7	20	0	1	21	0	0
7	49052333	.	C	T	5	9	14	0	0	14	0	0
7	49052359	.	A	G	3	10	13	0	3	16	0	0
7	49052476	.	G	A	7	8	15	0	0	15	0	0
7	49052575	.	G	A	2	7	9	0	0	9	0	0
7	49052625	.	C	T	2	7	9	0	0	9	0	0
7	49052840	.	T	G	5	0	5	0	13	18	0	0
7	49053143	.	T	C	2	6	8	0	0	8	0	0
7	49053314	.	T	A	2	13	15	0	1	16	0	0
7	49053445	.	A	G	8	9	17	0	0	17	0	0
7	49053454	.	T	A	5	9	14	0	2	16	0	0
7	49053483	.	A	C	7	10	17	0	1	19	1	0
7	49053491	.	T	A	9	10	19	0	1	20	0	0
7	49053785	.	G	C	14	7	21	0	0	21	0	0
7	49053828	.	G	A	13	3	16	0	0	16	0	0
7	49053977	.	C	T	5	5	10	0	0	10	0	0
7	49053991	.	A	G	5	0	5	0	5	10	0	0
7	49054161	.	G	A	5	6	11	0	0	11	0	0
7	49054475	.	T	C	10	7	17	0	0	17	0	0
7	49054739	.	A	G	12	13	25	0	0	25	0	0
7	49054808	.	A	G	12	4	16	0	1	17	0	0
7	49054885	.	C	T	10	4	14	0	0	14	0	0
7	49054899	.	C	T	9	4	13	0	2	15	0	0
7	49054981	.	T	A	4	4	8	0	1	9	0	0
7	49054985	.	T	C	4	4	8	0	1	9	0	0
7	49055227	.	G	A	0	5	5	0	5	10	0	0
7	49055256	.	T	C	6	5	11	0	1	12	0	0
7	49079010	.	A	T	2	2	4	0	0	4	0	0
7	49079029	.	T	G	3	2	5	0	0	5	0	0
7	49079102	.	C	T	1	2	3	0	0	3	0	0
7	49079163	.	C	A	1	1	2	0	1	3	0	0
7	49079167	.	T	C	1	2	3	0	0	3	0	0
7	49079824	.	T	G	1	1	2	0	0	2	0	0
7	49257220	.	C	T	11	4	15	0	1	16	0	0
7	49257384	.	T	C	4	3	7	0	1	8	0	0
7	49257686	.	G	T	9	3	12	0	0	12	0	0
7	49257774	.	C	T	8	7	15	0	0	15	0	0
7	49257979	.	A	G	5	6	11	0	0	11	0	0
7	49258012	.	G	A	5	7	12	0	1	13	0	0
7	49258279	.	C	T	4	5	9	0	0	9	0	0
7	49269896	.	A	G	5	0	5	0	7	12	0	0
7	49269913	.	A	G	3	0	3	0	4	7	0	0
7	49271069	.	C	T	5	9	14	0	0	14	0	0
7	49271121	.	G	T	7	10	17	0	0	17	0	0
7	49271147	.	A	C	10	8	18	0	0	18	0	0
7	49271208	.	C	T	7	8	15	0	2	17	0	0
7	49320253	.	G	A	4	5	9	0	0	9	0	0
7	49320342	.	A	T	3	4	7	0	0	7	0	0
7	49325125	.	G	A	6	11	17	0	0	17	0	0
7	49325319	.	T	C	4	9	13	0	0	13	0	0
7	49325346	.	A	G	10	9	19	0	1	20	0	0
7	49338336	.	G	A	9	14	23	0	1	24	0	0
7	49355496	.	T	C	11	0	11	0	6	17	0	0
7	49357357	.	G	A	8	5	13	0	0	13	0	0
7	49358228	.	A	C	4	5	9	0	1	10	0	0
7	49620059	.	T	C	0	4	4	0	0	4	0	0
7	49620089	.	T	G	0	4	4	0	0	4	0	0
7	49620241	.	T	C	2	0	2	0	4	6	0	0
7	49620536	.	C	A	1	4	5	0	0	5	0	0
7	49621331	.	A	G	1	2	3	0	0	3	0	0
7	49624379	.	T	C	1	0	1	0	2	3	0	0
7	49638880	.	T	G	8	3	11	0	0	11	0	0
7	49639272	.	G	T	11	5	16	0	0	16	0	0
7	49639370	.	A	G	3	2	5	0	0	5	0	0
7	49639520	.	C	A	2	4	6	0	1	7	0	0
7	49639583	.	T	A	1	1	2	0	3	5	0	0
7	49639876	.	A	T	6	13	19	0	0	19	0	0
7	49639926	.	A	C	6	7	13	0	0	13	0	0
7	49640040	.	G	A	12	18	30	0	1	31	0	0
7	49799470	.	A	T	4	5	9	0	0	9	0	0
7	49799526	.	T	A	7	5	12	0	0	12	0	0
7	49799584	.	G	A	6	5	11	0	0	11	0	0
7	49799890	.	T	C	2	2	4	0	0	4	0	0
7	49800039	.	T	C	2	0	2	0	4	6	0	0
7	49908446	.	C	G	2	0	2	0	1	3	0	0
7	50109317	.	T	C	2	5	7	0	0	7	0	0
7	50110585	.	C	T	3	8	11	0	0	11	0	0
7	50111330	.	C	T	5	13	18	0	0	18	0	0
7	50112025	.	C	T	6	8	14	0	2	16	0	0
7	50112039	.	T	G	10	9	19	0	0	19	0	0
7	50112063	.	G	A	7	9	16	0	1	17	0	0
7	50112196	.	A	G	4	0	4	0	1	10	5	0
7	50112286	.	T	C	4	6	10	0	0	10	0	0
7	50112383	.	G	A	8	10	18	0	3	21	0	0
7	50112460	.	C	T	12	13	25	0	1	26	0	0
7	50112825	.	A	T	17	15	32	0	0	32	0	0
7	50112922	.	C	A	6	8	14	0	2	16	0	0
7	50228314	.	C	A	10	13	23	0	1	24	0	0
7	50228326	.	T	C	11	0	11	0	12	23	0	0
7	50228355	.	C	T	10	11	21	0	2	23	0	0
7	50228548	.	T	C	6	8	14	0	0	14	0	0
7	50228660	.	T	C	4	3	7	0	0	7	0	0
7	50228785	.	C	G	9	3	12	0	0	12	0	0
7	50228872	.	A	C	4	7	11	0	1	12	0	0
7	50229223	.	T	C	10	8	18	0	1	19	0	0
7	50272707	.	G	A	6	5	11	0	0	12	1	0
7	50272779	.	A	G	3	7	10	0	0	10	0	0
7	50277869	.	T	A	2	4	6	0	0	6	0	0
7	50277915	.	C	T	1	4	5	0	0	5	0	0
7	50295823	.	G	A	6	6	12	0	0	12	0	0
7	50295974	.	G	T	7	8	15	0	0	15	0	0
7	50295997	.	T	A	4	8	12	0	0	12	0	0
7	50296016	.	A	G	1	7	8	0	0	8	0	0
7	50296545	.	T	G	6	3	9	0	0	9	0	0
7	50296981	.	A	G	9	8	17	0	0	17	0	0
7	50323793	.	A	G	3	1	4	0	1	5	0	0
7	50333629	.	T	C	1	2	3	0	0	3	0	0
7	50338221	.	A	T	2	4	6	0	1	7	0	0
7	50348175	.	A	G	2	3	5	0	0	5	0	0
7	50349225	.	T	C	4	12	16	0	1	17	0	0
7	50376101	.	T	A	2	4	6	0	0	6	0	0
7	50376255	.	A	G	2	1	3	0	2	5	0	0
7	50376285	.	A	G	1	2	3	0	1	4	0	0
7	50376395	.	G	A	7	6	13	0	0	13	0	0
7	50376518	.	C	A	2	3	5	0	0	5	0	0
7	50376608	.	T	C	2	2	4	0	0	4	0	0
7	50376720	.	A	T	2	2	4	0	0	4	0	0
7	50376751	.	G	A	4	4	8	0	0	8	0	0
7	50377025	.	A	G	2	9	11	0	0	11	0	0
7	50377045	.	C	T	0	8	8	0	3	11	0	0
7	50383553	.	C	T	1	3	4	0	0	4	0	0
7	50388889	.	G	A	2	0	2	0	0	2	0	0
7	50396019	.	C	T	2	3	5	0	0	5	0	0
7	50399759	.	A	G	4	1	5	0	8	13	0	0
7	50399782	.	T	C	6	5	11	0	1	12	0	0
7	50400267	.	A	G	3	1	4	0	0	4	0	0
7	50407469	.	A	G	9	12	21	0	0	21	0	0
7	50407532	.	T	C	9	4	13	0	5	18	0	0
7	50407587	.	T	C	9	8	17	0	1	18	0	0
7	50407588	.	C	A	9	8	17	0	1	18	0	0
7	50407724	.	C	T	15	11	26	0	1	27	0	0
7	50410394	.	T	A	21	19	40	0	3	43	0	0
7	50410475	.	T	C	11	9	20	0	0	20	0	0
7	50476004	.	A	G	2	2	4	0	0	4	0	0
7	50477387	.	C	T	1	2	3	0	1	4	0	0
7	50477402	.	A	G	2	3	5	0	0	5	0	0
7	50548086	.	A	G	4	5	9	0	0	9	0	0
7	50766151	.	T	C	1	2	3	0	0	3	0	0
7	50828894	.	T	A	4	2	6	0	0	6	0	0
7	50829201	.	A	C	5	2	7	0	0	7	0	0
7	50829360	.	G	C	6	3	9	0	0	9	0	0
7	50829393	.	G	A	5	4	9	0	0	9	0	0
7	50830997	.	C	T	1	1	2	0	0	2	0	0
7	50831901	.	G	A	3	3	6	0	0	6	0	0
7	50833143	.	T	C	0	2	2	0	1	3	0	0
7	50833262	.	C	T	6	4	10	0	0	10	0	0
7	50833928	.	C	G	3	0	3	0	1	4	0	0
7	50833943	.	C	A	1	4	5	0	0	5	0	0
7	50833979	.	C	T	2	5	7	0	0	7	0	0
7	50834821	.	A	G	0	3	3	0	1	4	0	0
7	50836382	.	C	T	5	4	9	0	0	9	0	0
7	50836424	.	C	T	8	4	12	0	1	13	0	0
7	50837949	.	G	A	3	4	7	0	1	8	0	0
7	50838135	.	G	C	0	0	0	0	1	1	0	0
7	50838194	.	C	A	5	4	9	0	0	9	0	0
7	50838210	.	G	T	0	4	4	0	6	10	0	0
7	50838251	.	C	T	1	2	3	0	0	3	0	0
7	50840008	.	C	T	7	8	15	0	0	15	0	0
7	50840428	.	G	A	6	10	16	0	0	16	0	0
7	50840512	.	C	T	2	3	5	0	0	5	0	0
7	50841072	.	G	A	14	10	24	0	1	25	0	0
7	50841237	.	C	T	11	19	30	0	1	31	0	0
7	50841690	.	G	A	0	10	10	0	14	24	0	0
7	50841693	.	A	T	14	10	24	0	0	24	0	0
7	50843813	.	C	A	3	9	12	0	1	13	0	0
7	50843827	.	A	G	3	14	17	0	2	19	0	0
7	50844117	.	G	A	0	10	10	0	17	27	0	0
7	50844142	.	G	A	17	9	26	0	0	26	0	0
7	50844165	.	C	T	10	11	21	0	2	23	0	0
7	50844830	.	G	T	10	10	20	0	0	20	0	0
7	50844834	.	G	A	0	10	10	0	10	20	0	0
7	50844895	.	A	T	15	13	28	0	0	28	0	0
7	50844936	.	A	T	5	11	16	0	1	17	0	0
7	50845000	.	G	A	11	14	25	0	0	25	0	0
7	50845105	.	A	T	16	20	36	0	0	36	0	0
7	50845158	.	A	G	7	15	22	0	1	23	0	0
7	50845210	.	A	G	14	13	27	0	2	29	0	0
7	50845331	.	G	A	1	4	5	0	7	12	0	0
7	50845486	.	A	T	6	6	12	0	0	12	0	0
7	50845646	.	C	T	10	6	16	0	0	16	0	0
7	50845892	.	C	A	13	16	29	0	0	29	0	0
7	50846055	.	T	C	14	19	33	0	0	33	0	0
7	50846081	.	T	A	15	13	28	0	2	30	0	0
7	50877064	.	T	C	1	5	6	0	0	6	0	0
7	50877099	.	T	C	4	2	6	0	1	7	0	0
7	50878473	.	A	C	6	4	10	0	0	10	0	0
7	50879166	.	C	T	2	2	4	0	0	4	0	0
7	50879168	.	C	G	2	2	4	0	0	4	0	0
7	50879591	.	T	C	5	5	10	0	0	10	0	0
7	50879595	.	C	T	4	4	8	0	1	9	0	0
7	50880436	.	A	G	1	4	5	2	0	7	0	0
7	50880467	.	C	G	1	2	3	2	0	5	0	0
7	50880471	.	G	A	1	2	3	1	0	4	0	0
7	50880624	.	T	G	1	3	4	0	0	4	0	0
7	50880703	.	G	A	3	6	9	0	0	9	0	0
7	50880749	.	T	A	1	2	3	0	0	3	0	0
7	50880885	.	C	A	1	3	4	0	0	4	0	0
7	50881252	.	G	A	2	2	4	0	0	4	0	0
7	50881363	.	C	T	3	2	5	0	0	5	0	0
7	50881465	.	A	G	5	3	8	0	0	8	0	0
7	50882104	.	G	A	1	2	3	0	0	3	0	0
7	50911223	.	T	A	7	12	19	0	1	20	0	0
7	50911278	.	C	T	21	18	39	0	4	43	0	0
7	50912212	.	C	T	11	7	18	0	0	18	0	0
7	50912227	.	C	G	5	6	11	0	0	11	0	0
7	50917219	.	C	T	4	5	9	0	1	10	0	0
7	51219420	.	C	G	2	3	5	0	2	7	0	0
7	51219436	.	A	C	5	1	6	0	0	6	0	0
7	51220278	.	T	C	9	9	18	0	0	18	0	0
7	51220739	.	A	G	6	14	20	0	0	20	0	0
7	51220740	.	C	A	0	14	14	0	6	20	0	0
7	51221418	.	T	A	3	6	9	0	0	9	0	0
7	51221475	.	C	T	6	2	8	0	0	8	0	0
7	51221784	.	A	G	5	2	7	0	1	8	0	0
7	51222115	.	G	A	3	5	8	0	0	8	0	0
7	51222297	.	G	A	1	2	3	0	0	3	0	0
7	51246426	.	G	A	4	4	8	0	0	8	0	0
7	51246457	.	G	T	9	3	12	0	1	13	0	0
7	51246573	.	T	C	9	9	18	0	0	18	0	0
7	51247467	.	C	T	0	3	3	0	2	5	0	0
7	51248010	.	C	A	4	5	9	0	0	9	0	0
7	51248756	.	C	A	0	4	4	0	1	5	0	0
7	51353191	.	G	A	4	1	5	0	2	7	0	0
7	51353421	.	C	T	2	3	5	0	0	5	0	0
7	51353447	.	G	T	1	3	4	0	0	4	0	0
7	51354593	.	T	C	4	1	5	0	0	5	0	0
7	51354641	.	C	A	2	5	7	0	0	7	0	0
7	51355437	.	A	G	1	2	3	0	1	4	0	0
7	51355515	.	A	T	3	2	5	0	0	5	0	0
7	51356044	.	A	G	4	2	6	0	1	7	0	0
7	51356303	.	G	A	1	3	4	0	0	4	0	0
7	51356319	.	G	A	0	3	3	0	1	4	0	0
7	51356542	.	C	G	14	6	20	0	1	21	0	0
7	51356625	.	C	A	15	6	21	0	1	22	0	0
7	51356733	.	G	T	6	9	15	0	1	16	0	0
7	51356767	.	C	A	3	2	5	0	1	6	0	0
7	51368654	.	T	G	2	3	5	0	1	6	0	0
7	51468119	.	C	T	15	20	35	0	0	35	0	0
7	51468241	.	C	T	12	20	32	0	2	34	0	0
7	51468389	.	C	T	1	15	16	0	13	29	0	0
7	51468411	.	A	T	13	9	22	0	0	22	0	0
7	51468577	.	C	A	19	15	34	0	0	34	0	0
7	51469048	.	T	G	14	17	31	0	0	31	0	0
7	51469166	.	A	T	15	14	29	0	2	31	0	0
7	51469267	.	G	C	14	9	23	0	1	25	1	0
7	51469304	.	T	A	10	9	19	0	1	20	0	0
7	51469518	.	T	A	13	9	22	0	0	22	0	0
7	51469578	.	T	G	10	9	19	0	0	19	0	0
7	51469814	.	C	T	0	7	7	0	10	17	0	0
7	51469897	.	A	G	8	9	17	0	1	18	0	0
7	51470070	.	T	C	5	0	5	0	6	11	0	0
7	51470230	.	T	A	4	7	11	0	0	11	0	0
7	51470569	.	G	T	8	7	15	0	0	15	0	0
7	51471195	.	T	C	11	5	16	0	1	17	0	0
7	51471201	.	G	A	9	7	16	0	0	16	0	0
7	51471379	.	G	A	6	4	10	0	0	10	0	0
7	51471554	.	T	C	2	0	2	0	7	9	0	0
7	51471591	.	T	C	4	2	6	0	2	8	0	0
7	51471714	.	A	G	6	5	11	0	0	11	0	0
7	51472456	.	C	T	6	5	11	0	1	12	0	0
7	51472534	.	T	A	2	6	8	0	0	8	0	0
7	51472536	.	T	A	1	6	7	0	1	8	0	0
7	51472793	.	A	C	4	0	4	0	4	8	0	0
7	51472853	.	G	A	5	12	17	0	2	19	0	0
7	51473585	.	T	C	1	0	1	0	2	3	0	0
7	51473814	.	C	T	2	6	8	0	1	9	0	0
7	51473831	.	T	G	6	4	10	0	1	11	0	0
7	51474238	.	G	A	2	3	5	0	0	5	0	0
7	51474279	.	C	A	5	4	9	0	0	9	0	0
7	51474300	.	G	T	4	3	7	0	0	7	0	0
7	51474832	.	T	G	6	9	15	0	0	15	0	0
7	51475180	.	A	G	1	4	5	0	0	5	0	0
7	51475288	.	G	A	4	4	8	0	0	8	0	0
7	51475578	.	A	G	3	5	8	0	0	8	0	0
7	51475795	.	T	A	2	2	4	0	0	4	0	0
7	51634285	.	C	T	17	9	26	0	0	26	0	0
7	51634480	.	G	A	36	30	66	0	1	67	0	0
7	51635615	.	A	G	16	14	30	0	0	30	0	0
7	51643163	.	A	G	7	3	10	0	0	10	0	0
7	51643212	.	G	A	6	5	11	0	0	11	0	0
7	51643409	.	C	A	2	2	4	0	1	5	0	0
7	51643639	.	A	C	3	2	5	0	1	6	0	0
7	51656560	.	A	T	4	4	8	0	0	8	0	0
7	51656576	.	A	G	4	2	6	0	1	7	0	0
7	51698403	.	T	A	0	1	1	0	0	1	0	0
7	51713257	.	G	A	0	8	8	0	0	8	0	0
7	51713267	.	G	A	1	7	8	0	0	8	0	0
7	51779628	.	G	A	7	5	12	0	0	12	0	0
7	51779636	.	T	C	7	4	11	0	0	11	0	0
7	51785901	.	T	C	1	0	1	0	0	1	0	0
7	51788227	.	T	G	11	11	22	0	0	22	0	0
7	51788756	.	A	C	2	11	13	0	2	15	0	0
7	51795788	.	T	C	3	3	6	0	0	6	0	0
7	51795791	.	G	T	3	3	6	0	0	6	0	0
7	51795827	.	C	T	1	1	2	0	0	2	0	0
7	51813946	.	T	G	3	4	7	0	0	7	0	0
7	51814287	.	C	G	3	9	12	0	1	13	0	0
7	51814445	.	T	A	2	5	7	0	0	7	0	0
7	51814512	.	C	T	4	3	7	0	1	8	0	0
7	52150811	.	A	C	2	2	4	0	0	4	0	0
7	52152016	.	C	T	0	2	2	0	0	2	0	0
7	52152053	.	A	T	0	4	4	0	0	4	0	0
7	52152063	.	C	T	0	4	4	0	0	4	0	0
7	52152101	.	C	T	2	3	5	0	0	5	0	0
7	52156095	.	G	A	0	1	1	0	2	3	0	0
7	52156113	.	G	A	0	2	2	0	2	4	0	0
7	52156137	.	T	A	2	2	4	0	0	4	0	0
7	52157845	.	A	T	3	5	8	0	0	8	0	0
7	52161646	.	G	T	1	1	2	0	0	2	0	0
7	52161931	.	C	G	2	4	6	0	0	6	0	0
7	52165631	.	C	T	1	1	2	0	0	2	0	0
7	52173207	.	G	A	4	3	7	0	0	7	0	0
7	52173228	.	A	G	2	1	3	0	0	3	0	0
7	52285113	.	C	G	5	9	14	0	2	16	0	0
7	52285257	.	T	G	3	2	5	0	0	5	0	0
7	52291425	.	C	T	1	2	3	0	0	3	0	0
7	52292106	.	C	T	1	3	4	0	0	4	0	0
7	52293935	.	C	T	5	8	13	0	0	13	0	0
7	52294009	.	G	T	14	5	19	0	0	19	0	0
7	52294540	.	A	T	13	10	23	0	0	23	0	0
7	52294579	.	C	T	10	13	23	0	0	23	0	0
7	52294756	.	A	T	9	4	13	0	1	14	0	0
7	52295016	.	C	T	1	12	13	0	13	26	0	0
7	52295183	.	G	A	17	21	38	0	0	38	0	0
7	52295795	.	C	T	1	12	13	0	9	22	0	0
7	52295935	.	T	C	18	4	22	0	1	23	0	0
7	52296064	.	A	C	11	0	11	0	13	24	0	0
7	52296221	.	G	A	13	12	25	0	0	25	0	0
7	52296320	.	G	A	4	6	10	0	0	10	0	0
7	52296352	.	G	T	4	6	10	0	0	10	0	0
7	52296791	.	G	A	14	12	26	0	0	26	0	0
7	52309924	.	G	A	1	2	3	0	0	3	0	0
7	52315434	.	C	G	0	3	3	0	3	6	0	0
7	52328569	.	C	T	8	4	12	0	1	13	0	0
7	52517325	.	G	A	3	4	7	0	0	7	0	0
7	52518017	.	T	A	2	3	5	0	0	5	0	0
7	52518018	.	T	A	2	3	5	0	0	5	0	0
7	52518813	.	C	T	4	4	8	0	0	8	0	0
7	52519015	.	T	C	7	7	14	0	0	14	0	0
7	52521352	.	G	A	4	5	9	0	1	10	0	0
7	52522182	.	T	C	4	10	14	0	0	14	0	0
7	52531152	.	C	T	0	4	4	0	2	6	0	0
7	52540962	.	G	A	5	2	7	0	0	7	0	0
7	52716777	.	T	A	3	3	6	0	0	6	0	0
7	52716875	.	C	A	1	0	1	0	0	1	0	0
7	52717095	.	T	C	1	9	10	0	2	12	0	0
7	52750565	.	C	T	10	11	21	0	1	22	0	0
7	52750656	.	G	A	5	6	11	0	1	12	0	0
7	52750847	.	C	T	5	13	18	0	0	18	0	0
7	52751016	.	C	T	12	7	19	0	0	19	0	0
7	52765884	.	C	A	1	1	2	0	0	2	0	0
7	52793313	.	C	T	2	2	4	0	0	4	0	0
7	52820221	.	G	A	0	4	4	0	8	12	0	0
7	52820320	.	C	T	8	10	18	0	1	19	0	0
7	52821561	.	T	A	6	2	8	0	0	8	0	0
7	52822136	.	G	A	6	12	18	0	0	18	0	0
7	52822217	.	T	A	13	9	22	0	1	23	0	0
7	52822351	.	A	T	10	6	16	0	1	17	0	0
7	52822493	.	A	C	13	4	17	0	0	17	0	0
7	52822773	.	C	T	6	3	9	0	1	10	0	0
7	52822791	.	T	G	6	0	6	0	3	9	0	0
7	52822860	.	A	G	2	7	9	0	1	10	0	0
7	52822981	.	T	A	2	3	5	0	0	5	0	0
7	52823161	.	G	A	7	8	15	0	0	15	0	0
7	52823210	.	C	G	7	11	18	0	0	18	0	0
7	52823377	.	T	A	3	3	6	0	1	7	0	0
7	52823388	.	C	T	2	5	7	0	2	9	0	0
7	52823429	.	A	T	5	8	13	0	2	15	0	0
7	52830447	.	G	T	7	13	20	0	1	21	0	0
7	52830591	.	A	T	20	14	34	0	0	34	0	0
7	52830601	.	T	G	14	20	34	0	3	37	0	0
7	52830639	.	C	T	23	21	44	0	1	45	0	0
7	52831053	.	G	T	17	22	39	0	2	41	0	0
7	52831198	.	T	A	15	14	29	0	0	29	0	0
7	52831236	.	A	G	10	17	27	0	1	28	0	0
7	52831430	.	C	T	10	10	20	0	0	20	0	0
7	52833126	.	C	G	4	8	12	0	0	12	0	0
7	52833248	.	A	T	11	14	25	0	1	26	0	0
7	52833329	.	G	T	7	17	24	0	1	25	0	0
7	52833682	.	T	A	11	8	19	0	1	20	0	0
7	52833792	.	G	A	14	17	31	0	1	32	0	0
7	52834334	.	T	G	7	4	11	0	2	13	0	0
7	52836325	.	C	T	23	17	40	0	3	43	0	0
7	52836403	.	A	G	16	19	35	0	1	36	0	0
7	52836451	.	C	T	15	21	36	0	1	37	0	0
7	52837644	.	G	A	10	9	19	0	0	19	0	0
7	52837686	.	C	A	7	13	20	0	1	21	0	0
7	52837687	.	T	A	7	13	20	0	1	21	0	0
7	52839062	.	C	T	11	6	17	0	0	17	0	0
7	52840871	.	T	A	14	12	26	0	3	29	0	0
7	52841033	.	T	C	3	0	3	0	13	16	0	0
7	52841276	.	A	G	7	6	13	0	0	13	0	0
7	52842329	.	C	T	4	4	8	0	1	9	0	0
7	52900987	.	C	T	5	11	16	0	1	17	0	0
7	52921521	.	C	A	8	11	19	0	2	21	0	0
7	52924873	.	T	A	4	10	14	0	1	15	0	0
7	52929182	.	G	A	8	8	16	0	0	16	0	0
7	52933088	.	C	A	20	15	35	0	1	36	0	0
7	52933191	.	C	T	3	4	7	0	0	7	0	0
7	52937334	.	G	A	6	6	12	0	2	14	0	0
7	52942312	.	G	T	5	8	13	0	1	14	0	0
7	52942472	.	C	T	0	2	2	0	0	2	0	0
7	52944199	.	G	A	2	5	7	0	0	7	0	0
7	52958387	.	A	T	1	2	3	0	0	3	0	0
7	52962765	.	T	C	4	0	4	0	11	15	0	0
7	54323986	.	T	C	10	0	10	0	11	21	0	0
7	54356092	.	A	T	5	2	7	0	0	7	0	0
7	54366517	.	A	G	1	0	1	0	0	1	0	0
7	54407619	.	C	T	4	6	10	0	1	11	0	0
7	54420390	.	C	T	0	1	1	0	2	3	0	0
7	54430450	.	T	C	2	2	4	0	0	4	0	0
7	54655025	.	A	T	4	6	10	0	1	11	0	0
7	55261074	.	C	T	2	4	6	0	0	6	0	0
7	55536487	.	G	A	2	3	5	0	0	5	0	0
7	55635202	.	T	C	0	1	1	0	0	1	0	0
7	55635355	.	G	A	0	1	1	0	2	3	0	0
7	55660269	.	G	A	11	13	24	0	0	24	0	0
7	55671547	.	T	C	4	5	9	0	2	11	0	0
7	55675544	.	T	C	7	0	7	0	11	18	0	0
7	55675577	.	G	A	5	6	11	0	0	11	0	0
7	56037659	.	C	G	2	2	4	0	0	4	0	0
7	56152686	.	G	C	10	6	16	0	0	16	0	0
7	56158111	.	G	A	2	4	6	0	1	7	0	0
7	56158197	.	G	A	8	7	15	0	0	15	0	0
7	56158874	.	C	T	2	0	2	0	0	2	0	0
7	56174222	.	T	C	4	3	7	0	0	7	0	0
7	56177177	.	C	T	1	3	4	0	1	5	0	0
7	56177188	.	T	G	2	5	7	0	0	7	0	0
7	56180258	.	C	T	1	3	4	0	1	5	0	0
7	56180482	.	G	A	1	3	4	0	0	4	0	0
7	56180555	.	G	A	3	1	4	0	1	5	0	0
7	56180589	.	C	A	0	5	5	0	3	8	0	0
7	56397859	.	G	A	4	3	7	0	0	7	0	0
7	56398522	.	A	T	4	6	10	0	2	12	0	0
7	56398651	.	C	T	6	3	9	0	0	9	0	0
7	56405508	.	T	C	7	10	17	0	0	17	0	0
7	56484426	.	G	A	19	10	29	0	1	30	0	0
7	56523233	.	A	G	2	1	3	0	0	3	0	0
7	56528494	.	C	T	0	5	5	0	0	5	0	0
7	56528922	.	G	A	1	0	1	0	0	1	0	0
7	56721933	.	A	G	1	0	1	0	4	5	0	0
7	56737268	.	C	G	4	0	4	0	6	10	0	0
7	56743879	.	A	G	1	1	2	0	0	2	0	0
7	56746311	.	C	T	7	5	12	0	0	12	0	0
7	56751971	.	A	G	14	18	32	0	0	32	0	0
7	56752243	.	G	A	3	1	4	0	1	5	0	0
7	56766115	.	C	T	0	8	8	0	7	15	0	0
7	56766282	.	A	C	10	0	10	0	4	14	0	0
7	56766455	.	A	T	1	3	4	0	0	4	0	0
7	56766754	.	A	T	3	3	6	0	2	8	0	0
7	56766828	.	C	G	3	4	7	0	0	7	0	0
7	56766845	.	T	C	1	3	4	0	0	4	0	0
7	56777813	.	T	C	9	0	9	0	8	17	0	0
7	56778235	.	T	A	17	13	30	0	2	32	0	0
7	56778251	.	T	C	17	13	30	0	1	31	0	0
7	56778282	.	C	T	0	14	14	0	12	26	0	0
7	56778305	.	G	A	16	13	29	0	0	29	0	0
7	56778672	.	G	T	19	13	32	0	3	35	0	0
7	56778721	.	G	T	25	11	36	0	3	39	0	0
7	56778822	.	A	T	12	12	24	0	1	25	0	0
7	56778895	.	A	G	11	8	19	0	0	19	0	0
7	56784070	.	A	T	7	5	12	0	0	12	0	0
7	56785006	.	T	C	8	11	19	0	1	20	0	0
7	56785308	.	C	T	12	7	19	0	1	20	0	0
7	56785315	.	G	A	5	12	17	0	1	18	0	0
7	56787414	.	A	T	17	12	29	0	4	33	0	0
7	56787483	.	T	A	12	15	27	0	0	27	0	0
7	56787527	.	C	T	9	15	24	0	0	24	0	0
7	56793362	.	G	A	1	1	2	0	0	2	0	0
7	57047942	.	G	A	2	2	4	0	0	4	0	0
7	57047947	.	G	A	0	2	2	0	2	4	0	0
7	57048022	.	C	T	3	0	3	0	0	3	0	0
7	57049308	.	T	C	7	3	10	0	0	10	0	0
7	57049638	.	A	G	3	2	5	0	0	5	0	0
7	57049911	.	C	T	5	4	9	0	0	9	0	0
7	57049958	.	C	T	3	2	5	0	0	5	0	0
7	57071707	.	C	T	4	3	7	0	0	7	0	0
7	57081143	.	C	T	3	2	5	0	0	5	0	0
7	57083043	.	C	T	1	1	2	0	0	2	0	0
7	57083088	.	G	A	3	7	10	0	0	10	0	0
7	57083094	.	A	G	4	0	4	0	7	11	0	0
7	57086153	.	C	T	2	5	7	0	0	7	0	0
7	57086216	.	G	A	0	5	5	0	6	11	0	0
7	57086277	.	G	A	0	8	8	0	4	12	0	0
7	57086383	.	C	A	3	5	8	0	1	9	0	0
7	57123513	.	T	G	1	0	1	0	2	3	0	0
7	57129518	.	C	T	2	2	4	0	0	4	0	0
7	57129520	.	A	T	2	2	4	0	0	4	0	0
7	57129553	.	C	A	8	3	11	0	1	12	0	0
7	57129729	.	G	T	2	6	8	0	0	8	0	0
7	57129766	.	A	T	2	9	11	0	0	11	0	0
7	57485710	.	T	C	6	7	13	0	0	13	0	0
7	57485736	.	A	G	7	5	12	0	0	12	0	0
7	57485766	.	A	G	5	7	12	0	0	12	0	0
7	57485847	.	G	A	0	1	1	0	0	1	0	0
7	57497353	.	T	C	4	3	7	0	1	8	0	0
7	57497455	.	C	G	2	1	3	0	0	3	0	0
7	57504905	.	C	G	9	8	17	0	0	17	0	0
7	57874026	.	G	A	1	0	1	0	0	1	0	0
7	57874038	.	A	C	1	0	1	0	0	1	0	0
7	57874083	.	G	A	0	0	0	0	1	1	0	0
7	57876512	.	T	C	11	4	15	0	0	15	0	0
7	57878712	.	T	C	5	8	13	0	0	13	0	0
7	57878726	.	A	T	5	6	11	0	0	11	0	0
7	57878885	.	C	T	1	6	7	0	0	7	0	0
7	57878973	.	A	T	7	4	11	0	0	11	0	0
7	57878974	.	C	T	6	4	10	0	1	11	0	0
7	57879076	.	A	G	7	1	8	0	6	14	0	0
7	57879205	.	C	T	11	3	14	0	1	15	0	0
7	57879245	.	C	T	11	7	18	0	1	19	0	0
7	57879396	.	T	A	20	12	32	0	4	36	0	0
7	57879431	.	G	T	0	16	16	0	23	39	0	0
7	57879436	.	C	A	22	15	37	0	0	37	0	0
7	57879576	.	C	A	15	13	28	0	1	29	0	0
7	57879601	.	T	C	21	7	28	0	0	28	0	0
7	57879959	.	C	A	5	12	17	0	0	17	0	0
7	57879992	.	G	A	11	9	20	0	0	20	0	0
7	57880073	.	G	C	2	2	4	0	1	5	0	0
7	57880099	.	T	C	1	2	3	0	2	5	0	0
7	57886154	.	C	A	4	0	4	0	6	10	0	0
7	57886347	.	C	A	20	22	42	0	1	43	0	0
7	57886392	.	T	A	17	26	43	0	0	43	0	0
7	57886964	.	T	G	23	25	48	0	1	49	0	0
7	57887480	.	C	T	15	22	37	0	2	39	0	0
7	57898605	.	G	A	5	9	14	0	2	16	0	0
7	57898623	.	C	T	16	15	31	0	0	31	0	0
7	57898650	.	T	C	16	21	37	0	3	40	0	0
7	57898658	.	C	G	19	24	43	0	1	44	0	0
7	57900948	.	T	A	2	0	2	0	0	2	0	0
7	57913558	.	C	A	17	14	31	0	2	33	0	0
7	57914155	.	T	G	18	17	35	0	0	35	0	0
7	57918590	.	A	G	8	9	17	0	1	18	0	0
7	57918799	.	G	A	22	24	46	0	3	49	0	0
7	57919087	.	T	G	18	20	38	0	7	45	0	0
7	57919241	.	G	A	21	16	37	0	2	39	0	0
7	57919249	.	T	C	18	0	18	0	17	35	0	0
7	57919567	.	T	C	14	9	23	0	1	24	0	0
7	57920608	.	A	T	6	12	18	0	1	19	0	0
7	57920908	.	A	G	6	12	18	0	0	18	0	0
7	57921094	.	A	G	16	24	40	0	0	40	0	0
7	57921335	.	A	G	10	8	18	0	0	18	0	0
7	57921914	.	G	A	9	7	16	0	0	16	0	0
7	57922018	.	T	G	9	5	14	0	0	14	0	0
7	57922480	.	G	A	10	6	16	0	1	17	0	0
7	57922555	.	G	T	9	8	17	0	1	18	0	0
7	57922793	.	G	T	9	8	17	0	0	17	0	0
7	57922827	.	C	T	5	10	15	0	1	16	0	0
7	57922828	.	A	G	4	10	14	0	2	16	0	0
7	57928407	.	A	T	5	6	11	0	3	14	0	0
7	57934036	.	A	T	4	6	10	0	0	10	0	0
7	57934051	.	T	C	4	6	10	0	0	10	0	0
7	57936171	.	G	A	7	7	14	0	0	14	0	0
7	57954099	.	G	A	1	1	2	0	0	2	0	0
7	57954123	.	A	C	1	2	3	0	0	3	0	0
7	57956503	.	C	T	3	2	5	0	1	6	0	0
7	57961917	.	C	A	5	2	7	0	0	7	0	0
7	57967373	.	A	G	8	3	11	0	0	11	0	0
7	57972616	.	T	C	0	1	1	0	0	1	0	0
7	57994952	.	T	A	2	1	3	0	0	3	0	0
7	58007916	.	G	T	1	2	3	0	0	3	0	0
7	58143104	.	A	G	1	4	5	0	0	5	0	0
7	58143123	.	G	C	1	4	5	0	0	5	0	0
7	58144285	.	T	C	3	0	3	0	3	6	0	0
7	58150120	.	A	T	1	1	2	0	0	2	0	0
7	58153549	.	A	G	0	2	2	0	0	2	0	0
7	58158456	.	C	T	0	5	5	0	3	8	0	0
7	58158484	.	T	C	5	6	11	0	1	12	0	0
7	58158847	.	T	C	1	0	1	0	0	1	0	0
7	58188252	.	A	G	5	4	9	0	1	10	0	0
7	58188253	.	A	C	6	4	10	0	0	10	0	0
7	58193141	.	T	C	2	2	4	0	0	4	0	0
7	58193195	.	A	G	2	5	7	0	0	7	0	0
7	58207453	.	A	G	0	2	2	0	0	2	0	0
7	58259472	.	C	T	8	6	14	0	0	14	0	0
7	58259494	.	T	A	6	5	11	0	0	11	0	0
7	58259561	.	A	G	14	5	19	0	0	19	0	0
7	58262100	.	G	A	6	3	9	0	0	9	0	0
7	58265533	.	G	A	4	1	5	0	0	5	0	0
7	58687138	.	G	A	11	8	19	0	0	19	0	0
7	58695379	.	A	C	5	7	12	0	0	12	0	0
7	58695441	.	C	A	25	13	38	0	1	39	0	0
7	58695599	.	G	T	8	16	24	0	0	24	0	0
7	58720696	.	T	A	3	5	8	0	0	8	0	0
7	58720718	.	T	C	2	1	3	0	5	8	0	0
7	58748871	.	A	C	10	14	24	0	0	24	0	0
7	58748891	.	T	C	6	13	19	0	1	20	0	0
7	58750327	.	A	C	19	20	39	0	2	41	0	0
7	58841391	.	T	C	4	0	4	0	9	13	0	0
7	58841552	.	T	G	1	4	5	0	0	5	0	0
7	58843134	.	T	C	8	11	19	0	0	19	0	0
7	59037972	.	C	T	4	6	10	0	0	10	0	0
7	59041471	.	A	G	1	2	3	0	0	3	0	0
7	59041504	.	A	G	0	2	2	0	0	2	0	0
7	59041531	.	A	G	0	0	0	0	1	1	0	0
7	59043246	.	C	A	0	5	5	0	1	6	0	0
7	59043421	.	T	C	0	0	0	0	1	1	0	0
7	59046711	.	T	A	3	3	6	0	0	6	0	0
7	59046795	.	G	A	1	2	3	0	1	4	0	0
7	59046966	.	T	A	7	4	11	0	0	11	0	0
7	59048307	.	C	T	1	11	12	0	7	19	0	0
7	59048907	.	G	A	3	2	5	0	0	5	0	0
7	59069079	.	G	A	8	6	14	0	1	15	0	0
7	59069080	.	T	G	7	6	13	0	2	15	0	0
7	59202989	.	A	T	2	5	7	0	2	9	0	0
7	59203097	.	A	G	3	3	6	0	0	6	0	0
7	59203289	.	G	A	1	3	4	0	0	4	0	0
7	59210423	.	T	A	1	2	3	0	0	3	0	0
7	59245594	.	G	T	3	3	6	0	1	7	0	0
7	59245612	.	G	T	4	3	7	0	0	7	0	0
7	59245926	.	T	A	1	1	2	0	1	3	0	0
7	59335135	.	A	C	1	0	1	0	0	1	0	0
7	59469015	.	G	A	3	3	6	0	0	6	0	0
7	59574175	.	A	G	2	2	4	0	0	4	0	0
7	59574234	.	C	A	2	3	5	0	0	5	0	0
7	59589259	.	A	G	1	0	1	0	0	1	0	0
7	60149599	.	C	T	3	4	7	0	0	7	0	0
7	60240748	.	T	C	2	2	4	0	0	4	0	0
7	60241377	.	G	T	2	2	4	0	0	4	0	0
7	60241387	.	C	T	2	2	4	0	1	5	0	0
7	60242851	.	C	A	5	6	11	0	0	11	0	0
7	60243042	.	A	G	10	5	15	0	0	15	0	0
7	60244637	.	A	G	1	7	8	0	0	8	0	0
7	60244868	.	C	T	2	3	5	0	0	5	0	0
7	60245033	.	G	A	2	2	4	0	0	5	1	0
7	60245149	.	T	A	1	1	2	0	1	3	0	0
7	60245180	.	G	T	2	1	3	0	1	4	0	0
7	60258390	.	G	T	1	2	3	0	0	3	0	0
7	60359574	.	G	A	1	3	4	0	1	5	0	0
7	60359584	.	C	T	2	3	5	0	0	5	0	0
7	60409230	.	T	C	0	3	3	0	0	3	0	0
7	60415928	.	T	C	5	10	15	0	0	15	0	0
7	60415945	.	A	T	6	6	12	0	0	12	0	0
7	60416010	.	T	C	3	5	8	0	0	8	0	0
7	60416016	.	A	G	2	5	7	0	1	8	0	0
7	60416074	.	T	A	1	1	2	0	1	3	0	0
7	60416096	.	C	A	2	3	5	0	0	5	0	0
7	60416175	.	C	T	2	9	11	0	0	11	0	0
7	60416317	.	A	G	5	0	5	0	6	11	0	0
7	60416327	.	C	T	6	6	12	0	0	12	0	0
7	60416379	.	G	A	4	10	14	0	1	15	0	0
7	60416383	.	C	T	3	12	15	0	2	17	0	0
7	60416439	.	A	G	8	13	21	0	1	22	0	0
7	60416724	.	A	G	4	7	11	0	0	11	0	0
7	60416764	.	T	G	6	5	11	0	0	12	1	0
7	60417176	.	T	A	5	3	8	0	2	10	0	0
7	60551171	.	A	C	14	14	28	0	1	29	0	0
7	60551471	.	A	G	8	8	16	0	3	19	0	0
7	60585523	.	A	G	23	1	24	0	12	36	0	0
7	60585599	.	G	A	11	14	25	0	1	26	0	0
7	60585702	.	G	A	7	6	13	0	0	13	0	0
7	60585748	.	G	T	5	8	13	0	0	13	0	0
7	60585818	.	G	C	4	9	13	0	0	13	0	0
7	60586187	.	T	C	11	26	37	0	0	37	0	0
7	60586364	.	A	C	13	7	20	0	0	20	0	0
7	60586771	.	C	T	8	6	14	0	0	14	0	0
7	60586784	.	A	T	9	9	18	0	0	18	0	0
7	60586835	.	C	T	12	8	20	0	0	20	0	0
7	60586874	.	G	A	0	9	9	0	11	20	0	0
7	60586976	.	C	T	12	17	29	0	1	30	0	0
7	60597482	.	G	A	12	17	29	0	1	30	0	0
7	60597500	.	T	G	12	13	25	0	2	28	1	0
7	60597863	.	C	T	16	22	38	0	1	39	0	0
7	60598265	.	T	A	16	18	34	0	1	35	0	0
7	61586641	.	C	G	4	2	6	0	1	7	0	0
7	61586719	.	C	T	0	3	3	0	4	7	0	0
7	61766585	.	T	C	0	1	1	0	0	1	0	0
7	61771497	.	C	T	1	1	2	0	0	2	0	0
7	61775813	.	A	C	1	2	3	0	0	3	0	0
7	61777825	.	A	G	1	3	4	0	0	4	0	0
7	61777828	.	T	C	1	3	4	0	0	4	0	0
7	61804557	.	A	T	1	3	4	0	0	4	0	0
7	61804880	.	A	T	6	4	10	0	1	11	0	0
7	61804909	.	C	A	5	7	12	0	0	12	0	0
7	61805102	.	G	A	7	4	11	0	1	12	0	0
7	61805104	.	T	A	7	4	11	0	0	12	1	0
7	61921320	.	G	A	2	2	4	0	0	4	0	0
7	61921463	.	C	T	4	1	5	0	0	5	0	0
7	61921465	.	T	A	4	1	5	0	0	5	0	0
7	61931851	.	A	C	1	3	4	0	1	5	0	0
7	61934189	.	T	A	2	4	6	0	1	7	0	0
7	61934278	.	C	T	2	6	8	0	1	9	0	0
7	61934306	.	A	G	3	0	3	0	4	7	0	0
7	61934330	.	A	G	1	0	1	0	4	5	0	0
7	61959031	.	G	A	1	2	3	0	0	3	0	0
7	61961063	.	G	A	1	0	1	0	0	1	0	0
7	61961229	.	T	C	4	6	10	0	0	10	0	0
7	61962040	.	T	C	3	6	9	0	1	10	0	0
7	61977170	.	G	C	5	3	8	0	1	9	0	0
7	61977499	.	T	C	9	11	20	0	0	20	0	0
7	61977514	.	G	A	11	9	20	0	1	21	0	0
7	61981518	.	A	G	3	6	9	0	0	9	0	0
7	62004146	.	C	T	19	16	35	0	1	36	0	0
7	62009630	.	T	A	4	3	7	0	0	7	0	0
7	62009677	.	G	A	0	7	7	0	5	12	0	0
7	62248670	.	T	A	3	4	7	0	0	7	0	0
7	62261581	.	C	T	0	2	2	0	0	2	0	0
7	64740893	.	T	C	2	1	3	0	6	9	0	0
7	64741726	.	G	C	1	0	1	0	3	4	0	0
7	64963482	.	T	C	2	4	6	0	0	6	0	0
7	64978891	.	A	C	8	3	11	0	0	11	0	0
7	64980793	.	A	G	1	1	2	0	0	2	0	0
7	64980820	.	A	G	7	3	10	0	0	10	0	0
7	64988061	.	A	G	7	3	10	0	0	10	0	0
7	64996666	.	A	G	1	1	2	0	0	2	0	0
7	65019731	.	T	C	1	0	1	0	0	1	0	0
7	65024082	.	C	T	0	2	2	0	2	4	0	0
7	65035275	.	A	G	7	7	14	0	0	14	0	0
7	65035416	.	G	T	4	5	9	0	0	9	0	0
7	65035437	.	C	T	3	7	10	0	0	10	0	0
7	65039374	.	T	A	6	6	12	0	0	12	0	0
7	65039436	.	A	C	7	0	7	0	13	20	0	0
7	65049706	.	C	T	0	1	1	0	3	4	0	0
7	65050312	.	A	T	3	1	4	0	0	4	0	0
7	65092935	.	G	A	1	4	5	0	1	6	0	0
7	65093097	.	G	A	5	6	11	0	0	11	0	0
7	65104080	.	A	G	5	3	8	0	1	9	0	0
7	65104840	.	C	A	2	4	6	0	0	6	0	0
7	65105011	.	G	C	1	2	3	0	0	3	0	0
7	65105160	.	C	A	3	5	8	0	1	9	0	0
7	65121982	.	C	T	6	4	10	0	0	10	0	0
7	65132884	.	C	T	0	2	2	0	0	2	0	0
7	65138868	.	A	G	0	1	1	0	0	1	0	0
7	65140532	.	C	A	4	3	7	0	0	7	0	0
7	65140738	.	T	A	1	0	1	0	0	1	0	0
7	65140786	.	G	A	1	1	2	0	0	2	0	0
7	65144861	.	G	T	0	1	1	0	0	1	0	0
7	65152036	.	C	A	1	0	1	0	0	1	0	0
7	65157397	.	A	C	11	5	16	0	2	18	0	0
7	65162339	.	G	A	0	4	4	0	4	8	0	0
7	65173289	.	A	T	10	18	28	0	1	29	0	0
7	65173534	.	C	T	10	5	15	0	1	16	0	0
7	65173768	.	G	A	1	2	3	0	0	3	0	0
7	65173829	.	A	T	3	3	6	0	0	6	0	0
7	65177923	.	C	G	1	0	1	0	2	3	0	0
7	65178270	.	C	T	2	3	5	0	0	5	0	0
7	65297041	.	A	T	3	3	6	0	0	6	0	0
7	65297313	.	G	T	4	2	6	0	1	7	0	0
7	65306067	.	T	C	4	6	10	0	0	10	0	0
7	65306229	.	G	A	5	5	10	0	1	11	0	0
7	65333843	.	T	C	4	0	4	0	0	4	0	0
7	65333874	.	C	T	5	2	7	0	0	7	0	0
7	65333930	.	T	A	2	6	8	0	0	8	0	0
7	65433092	.	T	C	2	3	5	0	0	5	0	0
7	65433343	.	G	T	0	1	1	0	0	1	0	0
7	65433352	.	C	A	0	1	1	0	0	1	0	0
7	65434589	.	C	T	0	1	1	0	0	1	0	0
7	65434610	.	C	T	1	0	1	0	0	1	0	0
7	65440308	.	T	A	2	3	5	0	0	5	0	0
7	65440361	.	G	A	0	1	1	0	1	2	0	0
7	65440493	.	C	T	0	2	2	0	0	2	0	0
7	65440505	.	G	A	3	0	3	0	0	3	0	0
7	65443348	.	T	C	2	1	3	0	0	3	0	0
7	65443396	.	G	A	2	2	4	0	1	5	0	0
7	65445483	.	G	A	0	1	1	0	0	1	0	0
7	65451324	.	T	A	6	5	11	0	0	11	0	0
7	65451369	.	C	T	9	6	15	0	0	15	0	0
7	65452005	.	G	A	1	5	6	0	2	8	0	0
7	65452017	.	G	A	2	5	7	0	0	7	0	0
7	65453057	.	G	A	0	3	3	0	4	7	0	0
7	65457103	.	A	G	2	0	2	0	3	5	0	0
7	65461040	.	G	A	0	5	5	0	3	8	0	0
7	65463165	.	C	A	10	10	20	0	0	20	0	0
7	65463297	.	G	T	0	7	7	0	10	17	0	0
7	65463511	.	G	A	1	17	18	0	16	34	0	0
7	65463586	.	C	T	5	13	18	0	0	18	0	0
7	65463906	.	T	C	6	12	18	0	0	18	0	0
7	65464120	.	T	G	7	6	13	1	0	15	1	0
7	65464132	.	T	G	5	1	6	1	5	12	0	0
7	65473137	.	G	T	12	18	30	0	1	31	0	0
7	65473421	.	G	C	28	21	49	0	3	52	0	0
7	65473775	.	G	T	15	25	40	0	3	43	0	0
7	65473814	.	T	C	31	11	42	0	1	43	0	0
7	65473972	.	T	C	15	25	40	0	1	41	0	0
7	65475422	.	T	G	4	9	13	0	0	13	0	0
7	65475708	.	T	G	17	8	25	0	0	25	0	0
7	65491835	.	G	A	27	18	45	0	2	47	0	0
7	65491910	.	T	A	3	0	3	0	1	4	0	0
7	65491911	.	A	G	0	3	3	0	1	4	0	0
7	65917099	.	G	T	3	2	5	0	1	6	0	0
7	65918357	.	C	T	1	2	3	0	1	4	0	0
7	65919940	.	T	G	1	0	1	0	2	3	0	0
7	65919942	.	T	A	1	2	3	0	0	3	0	0
7	65920720	.	A	G	4	0	4	0	3	7	0	0
7	65922732	.	G	C	1	2	3	0	0	3	0	0
7	65922868	.	T	C	2	4	6	0	0	6	0	0
7	65923921	.	T	C	3	2	5	0	0	5	0	0
7	65924277	.	T	C	2	2	4	0	0	4	0	0
7	65924554	.	A	G	2	5	7	0	0	7	0	0
7	65924558	.	C	T	2	3	5	0	1	6	0	0
7	65924621	.	T	C	5	2	7	0	2	9	0	0
7	65924634	.	A	G	6	0	6	0	0	6	0	0
7	66080231	.	G	A	1	2	3	0	0	3	0	0
7	66085915	.	A	C	0	1	1	0	0	1	0	0
7	66090927	.	C	T	1	1	2	0	0	2	0	0
7	66093051	.	T	A	3	2	5	0	0	5	0	0
7	66093216	.	C	T	1	1	2	0	0	2	0	0
7	66105663	.	A	G	3	0	3	0	5	8	0	0
7	66105752	.	C	T	6	3	9	0	0	9	0	0
7	66105804	.	G	A	0	4	4	0	4	8	0	0
7	66112702	.	T	C	5	6	11	0	0	11	0	0
7	66126466	.	T	C	3	2	5	0	1	6	0	0
7	66133626	.	A	T	4	2	6	0	1	7	0	0
7	66259574	.	A	T	6	8	14	0	0	14	0	0
7	66276243	.	G	A	4	9	13	0	0	13	0	0
7	66314765	.	G	A	6	2	8	0	0	8	0	0
7	66361984	.	A	G	8	5	13	0	0	13	0	0
7	66368605	.	G	C	1	1	2	0	4	6	0	0
7	66368653	.	T	C	1	0	1	0	1	2	0	0
7	67434693	.	A	C	1	2	3	0	0	3	0	0
7	67434807	.	T	C	7	2	9	0	3	12	0	0
7	67435587	.	T	C	2	2	4	0	1	5	0	0
7	67436273	.	C	T	10	9	19	0	0	19	0	0
7	67439428	.	A	C	3	2	5	0	0	5	0	0
7	67439496	.	T	A	2	10	12	0	0	12	0	0
7	67439520	.	T	A	0	4	4	0	0	4	0	0
7	67439742	.	T	C	9	8	17	0	0	17	0	0
7	67439743	.	C	T	9	8	17	0	0	17	0	0
7	67439781	.	T	C	2	2	4	0	0	4	0	0
7	67443766	.	T	C	2	2	4	0	0	4	0	0
7	67444837	.	G	A	2	2	4	0	0	4	0	0
7	67446295	.	C	T	15	10	25	0	2	27	0	0
7	67448338	.	T	C	20	18	38	0	0	38	0	0
7	67448363	.	A	T	16	15	31	0	1	32	0	0
7	67448373	.	T	A	15	12	27	0	0	27	0	0
7	67476376	.	T	C	30	25	55	0	1	56	0	0
7	67493909	.	C	T	0	2	2	0	0	2	0	0
7	67584796	.	C	T	5	5	10	0	1	11	0	0
7	67594248	.	C	T	1	2	3	0	0	3	0	0
7	67594292	.	A	T	4	4	8	0	0	8	0	0
7	67594380	.	C	G	4	0	4	0	4	8	0	0
7	67594506	.	G	A	0	5	5	0	1	6	0	0
7	67743603	.	T	A	2	5	7	0	0	7	0	0
7	67743604	.	G	T	2	5	7	0	0	7	0	0
7	67743646	.	A	G	2	4	6	0	0	6	0	0
7	67743878	.	T	C	2	3	5	0	0	5	0	0
7	67747819	.	T	C	10	6	16	0	1	17	0	0
7	67747826	.	T	G	8	4	12	0	2	14	0	0
7	67747869	.	G	C	6	6	12	0	1	13	0	0
7	67749397	.	A	G	0	0	0	0	1	1	0	0
7	67751286	.	A	G	1	0	1	0	6	7	0	0
7	67759739	.	C	T	1	0	1	0	0	1	0	0
7	67760488	.	C	G	2	1	3	0	0	3	0	0
7	67760491	.	C	T	1	1	2	0	0	2	0	0
7	67765772	.	T	C	4	2	6	0	0	6	0	0
7	67767943	.	G	A	1	2	3	0	0	3	0	0
7	67770477	.	T	G	1	4	5	0	0	5	0	0
7	67776588	.	C	T	2	2	4	0	0	4	0	0
7	67795001	.	T	A	3	2	5	0	1	6	0	0
7	67795002	.	C	A	3	2	5	0	1	6	0	0
7	67795210	.	T	G	2	3	5	0	0	5	0	0
7	67795367	.	T	C	4	3	7	0	0	7	0	0
7	67795386	.	A	G	8	4	12	0	0	12	0	0
7	67795429	.	G	A	11	9	20	0	0	20	0	0
7	67796075	.	G	T	4	5	9	0	0	9	0	0
7	67796413	.	C	A	1	1	2	0	2	4	0	0
7	67796437	.	G	T	2	5	7	0	1	8	0	0
7	67796494	.	G	A	0	4	4	0	10	14	0	0
7	67797037	.	C	G	8	5	13	0	0	13	0	0
7	67797087	.	G	T	13	5	18	0	0	18	0	0
7	67797097	.	C	T	12	4	16	0	0	16	0	0
7	67817399	.	C	T	2	2	4	0	0	4	0	0
7	67830051	.	C	T	0	1	1	0	1	2	0	0
7	67833051	.	G	A	2	3	5	0	1	6	0	0
7	67835264	.	A	G	0	1	1	0	0	1	0	0
7	67835269	.	A	C	0	1	1	0	0	1	0	0
7	67842641	.	G	T	4	3	7	0	0	7	0	0
7	67846087	.	T	C	2	0	2	0	0	2	0	0
7	67861868	.	T	G	1	4	5	0	0	5	0	0
7	67861872	.	G	C	1	0	1	0	4	5	0	0
7	67865220	.	G	C	1	0	1	0	0	1	0	0
7	67876880	.	T	A	0	1	1	0	0	1	0	0
7	67876881	.	G	A	0	1	1	0	0	1	0	0
7	67893985	.	G	C	2	3	5	0	0	5	0	0
7	67916337	.	G	A	0	1	1	0	0	1	0	0
7	67916385	.	A	G	1	2	3	0	1	4	0	0
7	68215451	.	A	T	14	16	30	0	2	32	0	0
7	68215990	.	T	G	14	14	28	0	3	31	0	0
7	68216504	.	C	A	1	6	7	1	9	17	0	0
7	68216781	.	G	C	4	4	8	0	0	8	0	0
7	68217387	.	G	A	10	11	21	0	0	21	0	0
7	68218940	.	T	C	0	1	1	0	2	3	0	0
7	68219332	.	A	G	3	8	11	0	1	12	0	0
7	68219340	.	A	T	2	8	10	0	1	11	0	0
7	68219412	.	T	A	6	11	17	0	1	18	0	0
7	68220824	.	A	C	2	9	11	0	0	11	0	0
7	68224841	.	G	A	3	4	7	0	0	7	0	0
7	68371530	.	C	T	0	3	3	0	2	5	0	0
7	68372794	.	C	A	1	2	3	0	0	3	0	0
7	68540716	.	T	A	2	8	10	0	0	10	0	0
7	68542234	.	G	A	1	1	2	0	0	2	0	0
7	68542517	.	C	T	4	2	6	0	0	6	0	0
7	68542538	.	C	T	3	2	5	0	0	5	0	0
7	69437495	.	C	A	1	0	1	0	0	1	0	0
7	69439094	.	T	A	0	1	1	0	0	1	0	0
7	69439436	.	T	C	0	1	1	0	0	1	0	0
7	69439580	.	A	G	0	6	6	0	1	7	0	0
7	69439587	.	A	G	0	0	0	0	5	5	0	0
7	69447324	.	G	A	9	1	10	0	0	10	0	0
7	69447469	.	C	G	2	6	8	0	0	8	0	0
7	69447516	.	A	G	1	5	6	0	0	6	0	0
7	69447520	.	G	A	1	6	7	0	0	7	0	0
7	69447699	.	G	T	4	2	6	0	1	7	0	0
7	69450044	.	A	G	2	2	4	0	0	4	0	0
7	69467145	.	A	G	3	5	8	0	0	8	0	0
7	69467228	.	G	A	3	0	3	0	0	3	0	0
7	69467267	.	A	G	4	3	7	0	1	8	0	0
7	69467383	.	T	G	2	1	3	0	5	8	0	0
7	69477283	.	T	G	23	17	40	1	2	44	1	0
7	69477303	.	A	G	16	2	18	0	31	49	0	0
7	69477361	.	T	C	20	32	52	0	2	54	0	0
7	69477437	.	A	G	28	25	53	0	1	54	0	0
7	69477464	.	T	C	22	22	44	0	3	47	0	0
7	69496521	.	C	A	7	16	23	0	0	23	0	0
7	69496537	.	A	T	6	15	21	0	1	22	0	0
7	69496572	.	A	G	6	18	24	0	1	25	0	0
7	69497048	.	A	T	13	7	20	0	0	21	1	0
7	69497493	.	G	T	24	17	41	0	0	41	0	0
7	69497637	.	G	A	7	4	11	0	0	11	0	0
7	69501040	.	A	G	5	5	10	0	0	10	0	0
7	69501148	.	A	G	1	0	1	0	0	1	0	0
7	69501300	.	A	G	3	9	12	0	1	13	0	0
7	69501345	.	G	T	8	12	20	0	1	21	0	0
7	69566119	.	A	G	4	6	10	0	0	10	0	0
7	69566179	.	A	T	2	1	3	0	0	3	0	0
7	69566848	.	G	A	2	1	3	0	0	3	0	0
7	69576019	.	C	A	3	2	5	0	0	5	0	0
7	69583133	.	A	T	5	4	9	0	0	9	0	0
7	69583139	.	C	T	5	5	10	0	0	10	0	0
7	69615021	.	G	A	1	2	3	0	1	4	0	0
7	69946805	.	C	T	0	3	3	0	0	3	0	0
7	69950322	.	G	A	3	2	5	0	0	5	0	0
7	69950644	.	G	T	1	4	5	0	0	5	0	0
7	69950666	.	T	C	2	3	5	0	0	5	0	0
7	69959980	.	G	A	2	2	4	0	0	4	0	0
7	71794062	.	T	C	9	4	13	0	0	13	0	0
7	71996026	.	A	G	1	2	3	0	3	6	0	0
7	72028326	.	A	G	39	11	50	0	3	53	0	0
7	72028742	.	A	G	26	10	36	0	2	38	0	0
7	72034590	.	T	C	9	3	12	0	1	13	0	0
7	73004934	.	C	T	1	2	3	0	1	4	0	0
7	73617589	.	A	G	4	4	8	0	0	8	0	0
7	73617600	.	A	G	4	4	8	0	0	9	1	0
7	73617817	.	A	G	8	6	14	0	0	14	0	0
7	73618264	.	A	G	3	4	7	0	2	9	0	0
7	73618288	.	A	G	4	5	9	0	0	9	0	0
7	73618367	.	A	G	4	2	6	0	0	6	0	0
7	73618368	.	A	G	3	3	6	0	0	6	0	0
7	73618565	.	A	G	8	1	9	0	3	12	0	0
7	73618821	.	A	G	3	2	5	0	0	5	0	0
7	73618841	.	A	G	0	1	1	0	1	2	0	0
7	73618866	.	A	G	2	0	2	0	4	6	0	0
8	391712	.	T	C	7	1	8	0	3	11	0	0
8	391715	.	T	C	8	2	10	0	1	11	0	0
8	471390	.	A	C	1	0	1	0	0	1	0	0
8	489120	.	C	T	1	3	4	0	0	4	0	0
8	489135	.	C	T	1	2	3	0	0	3	0	0
8	489169	.	C	T	2	3	5	0	2	7	0	0
8	489194	.	T	A	3	4	7	0	0	7	0	0
8	532308	.	T	A	3	3	6	0	1	7	0	0
8	532895	.	T	A	4	5	9	0	0	9	0	0
8	532923	.	C	T	3	5	8	0	1	9	0	0
8	534387	.	G	C	1	0	1	0	0	1	0	0
8	534418	.	C	T	0	4	4	0	1	5	0	0
8	534513	.	A	T	2	6	8	0	1	9	0	0
8	534603	.	A	C	2	3	5	0	0	5	0	0
8	543846	.	C	T	1	3	4	0	0	4	0	0
8	595166	.	C	T	1	2	3	0	6	9	0	0
8	600882	.	G	A	0	1	1	0	0	1	0	0
8	657645	.	A	G	0	1	1	0	0	1	0	0
8	701277	.	G	T	1	0	1	0	0	1	0	0
8	927337	.	G	A	14	13	27	0	0	27	0	0
8	928341	.	G	A	10	10	20	0	0	20	0	0
8	943953	.	G	C	0	2	2	0	0	2	0	0
8	1012018	.	A	G	3	2	5	0	0	5	0	0
8	1094388	.	G	A	3	8	11	0	0	11	0	0
8	1094542	.	T	C	7	15	22	0	0	22	0	0
8	1094566	.	C	T	13	7	20	0	0	20	0	0
8	1094590	.	G	A	1	5	6	0	8	14	0	0
8	1102533	.	G	T	17	10	27	0	0	27	0	0
8	1102551	.	C	T	9	11	20	0	1	21	0	0
8	1104980	.	A	G	1	0	1	0	1	2	0	0
8	1106149	.	C	T	11	20	31	0	0	31	0	0
8	1130526	.	C	A	1	3	4	0	0	4	0	0
8	1130574	.	G	A	4	4	8	0	0	8	0	0
8	1130590	.	A	T	4	4	8	0	2	10	0	0
8	1133689	.	A	G	1	2	3	0	0	3	0	0
8	1133743	.	A	G	4	0	4	0	3	7	0	0
8	1222558	.	A	G	14	16	30	0	1	31	0	0
8	1253651	.	G	A	8	14	22	0	1	23	0	0
8	1254337	.	C	T	5	11	16	0	0	16	0	0
8	1265705	.	T	G	1	4	5	0	0	5	0	0
8	1267074	.	T	A	8	10	18	0	1	19	0	0
8	1267153	.	G	A	12	8	20	0	0	20	0	0
8	1267157	.	G	A	9	8	17	0	3	20	0	0
8	1291857	.	T	G	1	0	1	0	4	5	0	0
8	1291986	.	C	T	2	3	5	0	0	5	0	0
8	1291993	.	G	A	0	3	3	0	3	6	0	0
8	1292079	.	T	C	4	2	6	0	0	6	0	0
8	1298889	.	A	G	2	0	2	0	4	6	0	0
8	1852185	.	A	G	1	4	5	0	1	6	0	0
8	1852196	.	A	G	1	3	4	0	0	4	0	0
8	1852599	.	A	G	3	6	9	0	2	11	0	0
8	1853424	.	A	G	5	2	7	0	0	7	0	0
8	1855256	.	A	G	4	3	7	0	0	7	0	0
8	1855312	.	A	G	9	6	15	0	0	15	0	0
8	1856161	.	A	G	7	3	10	0	0	10	0	0
8	1856174	.	A	G	2	10	12	0	0	12	0	0
8	2215965	.	T	A	5	2	7	0	0	7	0	0
8	2222522	.	T	C	3	2	5	0	0	5	0	0
8	2229821	.	G	A	1	3	4	0	0	4	0	0
8	2261052	.	T	C	2	6	8	0	0	8	0	0
8	2262694	.	G	C	2	2	4	0	0	4	0	0
8	2412911	.	G	A	18	31	49	0	3	52	0	0
8	2413133	.	T	G	43	26	69	0	2	72	1	0
8	2413160	.	G	C	39	1	40	0	25	65	0	0
8	2416886	.	G	A	22	20	42	0	0	42	0	0
8	2416931	.	C	T	0	7	7	0	2	9	0	0
8	2421318	.	T	C	12	19	31	0	1	32	0	0
8	2421342	.	C	A	10	15	25	0	1	26	0	0
8	2426500	.	A	G	1	3	4	0	0	4	0	0
8	2438671	.	T	C	0	1	1	0	0	1	0	0
8	2446957	.	C	T	3	1	4	0	0	4	0	0
8	2456933	.	C	T	1	3	4	0	0	4	0	0
8	2456953	.	C	G	2	6	8	0	0	8	0	0
8	2467230	.	A	G	5	0	5	0	4	9	0	0
8	2467233	.	A	G	5	4	9	0	0	9	0	0
8	2469292	.	G	A	9	10	19	0	1	20	0	0
8	2469377	.	G	C	6	8	14	0	0	14	0	0
8	2469401	.	C	T	6	4	10	0	1	11	0	0
8	2469528	.	G	T	3	4	7	0	0	7	0	0
8	2469559	.	C	T	2	4	6	0	0	6	0	0
8	2469693	.	C	T	1	2	3	0	0	3	0	0
8	2469720	.	T	G	1	2	3	0	0	3	0	0
8	2487329	.	T	C	1	4	5	0	0	5	0	0
8	2490968	.	C	T	25	23	48	0	3	51	0	0
8	2491338	.	G	A	12	8	20	0	0	20	0	0
8	2502037	.	G	A	19	24	43	0	1	44	0	0
8	2502067	.	C	T	32	35	67	0	2	69	0	0
8	2502088	.	A	G	25	21	46	0	3	49	0	0
8	2502112	.	A	G	14	12	26	0	2	28	0	0
8	2525435	.	A	G	1	2	3	0	0	3	0	0
8	2525450	.	T	C	1	2	3	0	0	3	0	0
8	2525492	.	A	T	1	3	4	0	0	4	0	0
8	2530118	.	G	A	11	7	18	0	0	18	0	0
8	2535588	.	T	A	13	12	25	0	1	26	0	0
8	2535642	.	T	C	8	4	12	0	3	15	0	0
8	2536560	.	A	G	2	3	5	0	0	5	0	0
8	2536673	.	A	G	3	2	5	0	0	5	0	0
8	2549579	.	T	C	1	1	2	0	0	2	0	0
8	2549582	.	A	G	0	1	1	0	0	1	0	0
8	2555046	.	C	G	3	5	8	0	0	8	0	0
8	2560848	.	A	G	2	2	4	0	0	4	0	0
8	2566882	.	G	T	2	1	3	0	0	3	0	0
8	2567788	.	T	C	3	5	8	0	0	8	0	0
8	2567818	.	C	T	4	6	10	0	0	10	0	0
8	2571478	.	T	C	0	3	3	0	0	3	0	0
8	2574514	.	A	C	2	5	7	0	1	8	0	0
8	2574524	.	A	C	2	4	6	0	2	8	0	0
8	2576136	.	C	T	1	2	3	0	1	4	0	0
8	2585329	.	G	C	7	11	18	0	0	18	0	0
8	2585681	.	C	A	15	16	31	0	1	32	0	0
8	2588348	.	A	G	24	25	49	0	2	51	0	0
8	2588354	.	C	A	0	26	26	0	27	53	0	0
8	2591624	.	A	C	6	0	6	0	8	14	0	0
8	2595746	.	C	T	0	1	1	0	3	4	0	0
8	2598510	.	C	T	0	1	1	0	0	1	0	0
8	2600595	.	T	C	1	2	3	0	0	3	0	0
8	2607133	.	C	T	0	2	2	0	0	2	0	0
8	2614836	.	A	T	2	0	2	0	0	2	0	0
8	2738662	.	T	C	2	2	4	0	0	4	0	0
8	2757867	.	A	T	1	3	4	0	0	4	0	0
8	2757956	.	C	T	1	0	1	0	0	1	0	0
8	2770202	.	A	G	0	3	3	0	0	3	0	0
8	2787035	.	C	T	2	3	5	0	0	5	0	0
8	2787141	.	T	C	2	3	5	0	0	5	0	0
8	2789535	.	T	C	4	4	8	0	0	8	0	0
8	2789536	.	C	A	4	4	8	0	0	8	0	0
8	2789592	.	T	C	3	5	8	0	0	8	0	0
8	2789655	.	C	A	4	2	6	0	1	7	0	0
8	2789697	.	G	A	3	3	6	0	0	6	0	0
8	2789748	.	T	A	2	3	5	0	0	5	0	0
8	2789757	.	G	T	1	2	3	0	0	3	0	0
8	3099585	.	G	A	0	7	7	0	6	13	0	0
8	3101081	.	T	A	2	4	6	0	1	7	0	0
8	3101086	.	C	A	2	5	7	0	0	7	0	0
8	3101241	.	G	T	2	6	8	0	0	8	0	0
8	3101277	.	T	C	2	8	10	0	0	10	0	0
8	3434368	.	G	A	1	3	4	0	0	4	0	0
8	3434449	.	C	T	2	3	5	0	0	5	0	0
8	3439283	.	G	C	1	4	5	0	0	5	0	0
8	3439309	.	C	T	1	3	4	0	0	4	0	0
8	3537152	.	G	A	0	1	1	0	0	1	0	0
8	3545327	.	C	T	1	3	4	0	0	4	0	0
8	3545328	.	G	A	0	2	2	0	2	4	0	0
8	3561501	.	T	C	0	1	1	0	1	2	0	0
8	3561515	.	G	A	1	1	2	0	0	2	0	0
8	3566190	.	C	T	0	3	3	0	0	3	0	0
8	3566853	.	G	A	1	1	2	0	0	2	0	0
8	3569907	.	C	T	1	3	4	0	0	4	0	0
8	3571727	.	T	A	0	3	3	0	0	3	0	0
8	3591211	.	C	A	2	6	8	0	0	8	0	0
8	3595161	.	G	A	0	0	0	0	2	2	0	0
8	3595359	.	C	T	5	7	12	0	0	12	0	0
8	3597233	.	T	C	5	3	8	0	0	8	0	0
8	3602715	.	T	A	3	2	5	0	0	5	0	0
8	3605050	.	A	G	2	0	2	0	4	6	0	0
8	3612263	.	T	A	1	1	2	0	0	2	0	0
8	3612308	.	A	T	8	6	14	0	1	15	0	0
8	3624208	.	G	C	3	2	5	0	1	6	0	0
8	3628683	.	C	T	1	2	3	0	0	3	0	0
8	3628747	.	C	A	7	6	13	0	0	13	0	0
8	3628758	.	T	A	6	6	12	0	1	13	0	0
8	3628782	.	G	A	0	8	8	0	9	17	0	0
8	3631371	.	T	C	0	1	1	0	0	1	0	0
8	3631932	.	C	T	2	3	5	0	1	6	0	0
8	3641218	.	G	C	5	6	11	0	2	13	0	0
8	3643299	.	T	C	17	13	30	0	1	31	0	0
8	3659979	.	T	C	3	2	5	0	0	5	0	0
8	3660034	.	C	T	5	5	10	0	0	10	0	0
8	3674701	.	T	C	1	2	3	0	1	4	0	0
8	3691097	.	C	T	2	3	5	0	0	5	0	0
8	3691113	.	T	C	3	0	3	0	3	6	0	0
8	3859383	.	T	A	5	3	8	0	0	8	0	0
8	3865233	.	T	C	8	4	12	0	1	13	0	0
8	3883831	.	C	G	2	5	7	0	1	8	0	0
8	3886220	.	T	C	1	4	5	0	0	5	0	0
8	3889662	.	G	A	1	2	3	0	2	5	0	0
8	3890837	.	T	C	1	0	1	0	0	1	0	0
8	3904963	.	C	T	2	8	10	0	1	11	0	0
8	3915909	.	G	A	1	1	2	0	0	2	0	0
8	3932889	.	A	T	5	4	9	0	0	9	0	0
8	3932974	.	A	G	4	5	9	0	1	10	0	0
8	3932990	.	A	G	7	9	16	0	0	16	0	0
8	3933498	.	T	A	6	9	15	0	0	15	0	0
8	3949558	.	G	T	2	4	6	0	0	6	0	0
8	3950039	.	C	G	8	5	13	0	0	13	0	0
8	3950317	.	G	A	4	5	9	0	0	9	0	0
8	3950655	.	C	T	3	2	5	0	1	6	0	0
8	3956898	.	G	A	2	2	4	0	0	4	0	0
8	3960992	.	G	A	2	2	4	0	0	4	0	0
8	3963040	.	C	A	0	3	3	0	1	4	0	0
8	4044642	.	T	A	2	3	5	0	0	5	0	0
8	4044846	.	G	A	1	8	9	0	0	9	0	0
8	4048709	.	A	T	1	3	4	0	0	4	0	0
8	4368586	.	T	G	2	4	6	0	0	6	0	0
8	4368714	.	C	G	3	4	7	0	0	7	0	0
8	4368847	.	T	A	2	2	4	0	0	4	0	0
8	4368848	.	C	G	2	2	4	0	0	4	0	0
8	4369021	.	A	C	4	2	6	0	1	7	0	0
8	4381510	.	A	G	1	0	1	0	2	3	0	0
8	4381624	.	G	A	1	1	2	0	0	2	0	0
8	4386198	.	A	G	4	5	9	0	0	9	0	0
8	4398425	.	A	T	2	2	4	0	0	4	0	0
8	4398531	.	T	C	2	4	6	0	0	6	0	0
8	4398737	.	C	T	9	7	16	0	0	16	0	0
8	4398762	.	A	G	7	7	14	0	2	16	0	0
8	4398981	.	G	A	0	8	8	0	3	11	0	0
8	4399093	.	A	G	4	3	7	0	0	7	0	0
8	4399624	.	A	G	2	3	5	0	0	5	0	0
8	4399625	.	A	G	2	3	5	0	0	5	0	0
8	4399754	.	T	A	4	3	7	0	1	8	0	0
8	4400337	.	A	G	2	4	6	0	1	7	0	0
8	4400357	.	T	G	0	2	2	0	0	2	0	0
8	4400699	.	C	A	3	10	13	0	2	15	0	0
8	4400861	.	T	C	7	6	13	0	0	13	0	0
8	4400872	.	G	A	0	2	2	0	7	9	0	0
8	4401053	.	T	G	6	14	20	0	0	20	0	0
8	4401068	.	C	T	7	13	20	0	0	20	0	0
8	4401374	.	G	A	0	7	7	0	5	12	0	0
8	4401514	.	A	T	7	4	11	0	0	11	0	0
8	4401687	.	G	A	14	16	30	0	0	30	0	0
8	4401708	.	C	T	14	25	39	0	1	40	0	0
8	4401813	.	G	T	16	15	31	0	3	34	0	0
8	4401913	.	T	G	7	12	19	0	3	22	0	0
8	4401931	.	T	C	8	11	19	0	3	22	0	0
8	4440705	.	A	C	1	2	3	0	0	3	0	0
8	4440720	.	T	C	1	2	3	0	0	3	0	0
8	4442655	.	G	A	0	0	0	0	1	1	0	0
8	4446389	.	C	T	2	2	4	0	0	4	0	0
8	4446407	.	T	C	2	0	2	0	2	4	0	0
8	4516962	.	G	A	2	4	6	0	0	6	0	0
8	4519161	.	C	T	0	1	1	0	1	2	0	0
8	4522035	.	T	A	3	2	5	0	0	5	0	0
8	4525072	.	G	A	2	3	5	0	0	5	0	0
8	4529598	.	A	G	1	1	2	0	0	2	0	0
8	4566793	.	C	A	1	1	2	0	0	2	0	0
8	4589148	.	A	G	18	19	37	0	4	41	0	0
8	4589169	.	T	G	19	23	42	0	4	46	0	0
8	4589216	.	A	T	19	18	37	0	2	39	0	0
8	4589402	.	C	T	28	30	58	0	1	59	0	0
8	4596649	.	T	A	5	9	14	0	1	15	0	0
8	4609822	.	T	C	10	0	10	0	17	27	0	0
8	4618536	.	G	A	7	10	17	0	0	17	0	0
8	4618562	.	C	T	0	8	8	0	7	15	0	0
8	4621454	.	A	G	3	4	7	0	0	7	0	0
8	4621544	.	G	A	3	3	6	0	0	6	0	0
8	4621614	.	A	T	0	3	3	0	0	3	0	0
8	4621672	.	G	T	1	4	5	0	0	5	0	0
8	4621742	.	A	G	3	2	5	0	0	5	0	0
8	4621744	.	C	T	3	2	5	0	0	5	0	0
8	4621817	.	G	T	5	5	10	0	1	11	0	0
8	4762881	.	G	A	0	3	3	0	0	3	0	0
8	4771987	.	C	T	2	3	5	0	0	5	0	0
8	4776243	.	A	T	13	15	28	0	0	28	0	0
8	4780110	.	A	C	7	3	10	0	0	10	0	0
8	4780127	.	A	T	5	3	8	0	0	8	0	0
8	4780368	.	T	A	5	7	12	0	0	12	0	0
8	4780552	.	C	T	1	9	10	0	8	18	0	0
8	4780586	.	G	A	8	10	18	0	1	19	0	0
8	4788763	.	A	G	1	3	4	0	0	4	0	0
8	4788942	.	T	C	10	0	10	0	12	22	0	0
8	4800185	.	C	T	3	5	8	0	0	8	0	0
8	4800683	.	G	A	0	2	2	0	7	9	0	0
8	4964521	.	G	A	6	7	13	0	1	14	0	0
8	5844982	.	T	C	1	3	4	0	0	4	0	0
8	5845014	.	C	G	2	2	4	0	1	5	0	0
8	5845042	.	C	T	4	3	7	0	0	7	0	0
8	5845060	.	T	G	3	2	5	0	0	5	0	0
8	5845210	.	T	A	4	3	7	0	0	7	0	0
8	5845222	.	C	T	3	3	6	0	0	6	0	0
8	5845957	.	T	C	0	4	4	0	0	4	0	0
8	6415959	.	T	C	3	2	5	0	0	5	0	0
8	6863678	.	A	G	8	1	9	0	8	17	0	0
8	6863822	.	G	A	7	9	16	0	0	16	0	0
8	6864062	.	C	G	6	4	10	0	0	10	0	0
8	6864077	.	T	C	6	6	12	0	0	12	0	0
8	6864416	.	C	A	4	9	13	0	0	13	0	0
8	6865247	.	T	A	1	3	4	0	1	5	0	0
8	6865357	.	C	T	9	6	15	0	1	16	0	0
8	6865542	.	C	T	17	13	30	0	0	30	0	0
8	6865834	.	A	G	20	12	32	0	1	33	0	0
8	6866083	.	G	A	16	15	31	0	0	31	0	0
8	6866592	.	G	T	15	22	37	0	1	38	0	0
8	6866835	.	T	G	6	7	13	0	1	14	0	0
8	6874937	.	C	T	11	8	19	0	2	21	0	0
8	6874968	.	A	G	14	9	23	0	0	23	0	0
8	6875061	.	G	T	7	10	17	0	0	17	0	0
8	6875300	.	C	T	13	12	25	0	2	27	0	0
8	6875354	.	T	C	2	3	5	0	0	5	0	0
8	6875562	.	C	T	4	5	9	0	0	9	0	0
8	6875563	.	C	T	4	4	8	0	1	9	0	0
8	6875722	.	A	G	14	7	21	0	2	23	0	0
8	6876297	.	T	C	2	2	4	0	0	4	0	0
8	6876381	.	A	G	5	10	15	0	0	15	0	0
8	6876705	.	A	C	10	10	20	0	1	21	0	0
8	6876999	.	T	C	7	6	13	0	0	13	0	0
8	6877130	.	T	G	5	5	10	0	0	10	0	0
8	6877248	.	T	C	5	0	5	0	8	13	0	0
8	6877268	.	T	C	6	10	16	0	0	16	0	0
8	6903650	.	A	G	4	2	6	0	1	7	0	0
8	6903778	.	A	T	4	3	7	0	0	7	0	0
8	6913809	.	T	C	2	0	2	0	1	3	0	0
8	6920909	.	A	G	6	3	9	0	0	9	0	0
8	6921117	.	C	G	1	31	32	0	16	48	0	0
8	6921344	.	A	C	17	12	29	0	1	30	0	0
8	6921421	.	T	A	10	17	27	0	1	28	0	0
8	6921581	.	A	C	19	28	47	0	2	49	0	0
8	6921671	.	G	A	12	11	23	0	1	24	0	0
8	6927428	.	T	C	5	10	15	0	0	15	0	0
8	6935642	.	A	T	8	13	21	0	3	24	0	0
8	6943167	.	A	T	0	1	1	0	0	1	0	0
8	6970040	.	G	A	6	2	8	0	0	8	0	0
8	6985008	.	A	G	3	0	3	0	0	3	0	0
8	7014341	.	A	G	2	0	2	0	0	2	0	0
8	7018017	.	G	A	5	7	12	0	0	12	0	0
8	7022216	.	T	A	8	8	16	0	2	18	0	0
8	7022227	.	A	G	8	7	15	0	4	19	0	0
8	7022305	.	C	T	9	8	17	0	1	18	0	0
8	7114497	.	T	C	3	1	4	0	0	4	0	0
8	7118497	.	T	C	5	9	14	0	1	15	0	0
8	7118520	.	T	G	7	1	8	0	9	17	0	0
8	7118809	.	G	A	2	3	5	0	0	5	0	0
8	7119013	.	G	A	1	5	6	0	6	12	0	0
8	7119128	.	A	G	3	4	7	0	1	8	0	0
8	7119239	.	T	G	3	2	5	0	0	5	0	0
8	7119253	.	T	A	3	2	5	0	0	5	0	0
8	7119718	.	C	G	7	0	7	0	7	14	0	0
8	7120014	.	C	A	3	4	7	0	1	8	0	0
8	7120479	.	A	T	3	3	6	0	0	6	0	0
8	7120498	.	A	G	2	3	5	0	0	5	0	0
8	7120546	.	A	G	5	5	10	0	0	10	0	0
8	7120572	.	C	G	7	7	14	0	1	15	0	0
8	7120604	.	T	C	5	6	11	0	3	14	0	0
8	7120805	.	T	C	4	3	7	0	0	7	0	0
8	7120822	.	C	T	3	3	6	0	1	7	0	0
8	7120873	.	G	A	6	3	9	0	0	9	0	0
8	7120876	.	A	G	2	7	9	0	0	9	0	0
8	7121011	.	T	A	12	3	15	0	1	16	0	0
8	7121067	.	G	A	3	2	5	0	0	5	0	0
8	7121347	.	A	T	4	2	6	0	0	6	0	0
8	7121593	.	T	A	4	2	6	0	0	6	0	0
8	7121868	.	C	T	9	1	10	0	0	10	0	0
8	7121877	.	A	G	9	1	10	0	0	10	0	0
8	7122010	.	T	G	3	2	5	0	0	5	0	0
8	7122171	.	A	T	3	6	9	0	1	10	0	0
8	7122186	.	T	C	1	7	8	0	1	9	0	0
8	7122221	.	T	A	4	6	10	0	0	10	0	0
8	7122248	.	C	A	5	4	9	0	1	10	0	0
8	7122369	.	T	C	8	5	13	0	0	13	0	0
8	7122396	.	C	A	5	4	9	0	3	12	0	0
8	7122459	.	A	G	7	2	9	0	1	10	0	0
8	7122460	.	A	T	8	2	10	0	0	10	0	0
8	7122931	.	G	A	0	6	6	0	7	13	0	0
8	7122961	.	T	A	12	3	15	0	1	19	3	0
8	7123171	.	G	C	0	8	8	0	13	21	0	0
8	7123233	.	A	T	14	9	23	0	2	25	0	0
8	7123257	.	T	C	8	13	21	0	3	24	0	0
8	7123323	.	C	A	15	5	20	0	2	22	0	0
8	7123326	.	A	G	14	4	18	0	3	21	0	0
8	7123360	.	A	T	8	8	16	0	1	17	0	0
8	7123414	.	G	A	0	7	7	0	6	13	0	0
8	7123415	.	G	C	5	7	12	0	1	13	0	0
8	7123452	.	G	A	7	8	15	0	2	17	0	0
8	7123472	.	A	G	8	9	17	0	1	18	0	0
8	7123491	.	T	C	10	10	20	0	0	20	0	0
8	7123538	.	G	A	12	8	20	0	0	20	0	0
8	7378464	.	A	G	33	13	46	0	6	52	0	0
8	7742196	.	C	T	2	6	8	0	1	9	0	0
8	7745898	.	G	A	5	5	10	0	1	11	0	0
8	7745907	.	T	C	7	5	12	0	1	13	0	0
8	7746030	.	C	T	11	7	18	0	0	18	0	0
8	7747613	.	A	G	2	0	2	0	1	3	0	0
8	7747616	.	C	T	2	1	3	0	0	3	0	0
8	7765230	.	G	A	1	10	11	0	9	20	0	0
8	7772097	.	C	T	6	8	14	0	0	14	0	0
8	7855697	.	G	T	0	3	3	0	0	3	0	0
8	7855888	.	G	A	0	3	3	0	5	8	0	0
8	7857369	.	A	G	3	0	3	0	3	6	0	0
8	7857378	.	T	C	2	2	4	0	2	6	0	0
8	7863747	.	T	C	4	3	7	0	0	7	0	0
8	7872053	.	A	T	5	5	10	0	0	10	0	0
8	7872056	.	C	T	5	5	10	0	0	10	0	0
8	7872510	.	A	G	1	2	3	0	0	3	0	0
8	7872521	.	A	C	1	1	2	0	0	2	0	0
8	7872971	.	A	G	8	0	8	0	6	14	0	0
8	7880956	.	A	G	2	4	6	0	0	6	0	0
8	7889397	.	T	A	2	0	2	0	0	2	0	0
8	7892241	.	C	T	1	0	1	0	0	1	0	0
8	7902138	.	C	T	3	4	7	0	0	7	0	0
8	7907837	.	G	C	3	2	5	0	0	5	0	0
8	7908417	.	C	A	1	6	7	0	1	8	0	0
8	7908520	.	A	G	2	3	5	0	0	5	0	0
8	7910145	.	A	G	1	0	1	0	3	4	0	0
8	7911746	.	A	C	2	4	6	0	0	6	0	0
8	7911749	.	C	T	2	4	6	0	0	6	0	0
8	7912216	.	A	C	4	9	13	0	0	13	0	0
8	7912267	.	C	G	3	0	3	0	8	11	0	0
8	7912394	.	G	A	8	5	13	0	0	13	0	0
8	8032918	.	T	C	2	2	4	0	1	6	1	0
8	8033116	.	G	A	1	4	5	0	0	5	0	0
8	8033275	.	G	A	0	1	1	0	2	3	0	0
8	8033290	.	A	G	1	1	2	0	0	2	0	0
8	8034876	.	A	G	0	0	0	0	1	1	0	0
8	8034912	.	A	G	2	0	2	0	5	7	0	0
8	8034933	.	A	C	2	5	7	0	0	7	0	0
8	8196158	.	C	T	2	3	5	0	0	5	0	0
8	8196690	.	G	T	2	2	4	0	0	4	0	0
8	8250814	.	T	G	1	0	1	0	0	1	0	0
8	8298291	.	A	G	0	1	1	0	0	1	0	0
8	8298472	.	C	T	16	6	22	0	2	24	0	0
8	8301910	.	A	G	2	1	3	0	0	3	0	0
8	8301913	.	T	A	2	1	3	0	0	3	0	0
8	8325553	.	T	A	2	1	3	0	0	3	0	0
8	8331823	.	A	T	10	9	19	0	1	20	0	0
8	8334428	.	C	T	4	3	7	0	0	7	0	0
8	8338969	.	C	T	14	6	20	0	2	22	0	0
8	8341155	.	G	A	2	2	4	0	0	4	0	0
8	8341170	.	G	A	1	2	3	0	1	4	0	0
8	8341313	.	T	C	6	11	17	0	2	19	0	0
8	8341340	.	A	C	7	12	19	0	2	21	0	0
8	8341383	.	T	C	4	8	12	0	2	14	0	0
8	8341486	.	A	C	4	8	12	0	2	14	0	0
8	8341617	.	A	C	3	1	4	0	0	4	0	0
8	8341619	.	T	C	2	0	2	0	2	4	0	0
8	8343217	.	T	G	7	10	17	0	0	17	0	0
8	8362684	.	G	A	7	9	16	0	0	16	0	0
8	8363058	.	C	T	0	3	3	0	6	9	0	0
8	8389011	.	A	G	1	4	5	0	0	5	0	0
8	8390797	.	A	G	3	6	9	0	0	9	0	0
8	8390821	.	A	G	1	3	4	0	0	4	0	0
8	8391508	.	A	G	2	4	6	0	2	8	0	0
8	8446197	.	C	T	0	4	4	0	2	6	0	0
8	8446343	.	T	A	7	10	17	0	0	17	0	0
8	8468256	.	A	G	3	1	4	0	0	4	0	0
8	8475010	.	T	C	2	2	4	0	1	5	0	0
8	8478746	.	G	A	0	3	3	0	4	7	0	0
8	8478751	.	C	A	2	4	6	0	1	7	0	0
8	8478819	.	A	G	2	1	3	0	1	4	0	0
8	8478861	.	C	T	4	4	8	0	0	8	0	0
8	8478862	.	T	C	4	4	8	0	0	8	0	0
8	8484269	.	A	G	8	2	10	0	1	11	0	0
8	8486783	.	G	A	0	1	1	0	1	2	0	0
8	8486882	.	G	A	0	1	1	0	0	1	0	0
8	8489175	.	G	A	0	3	3	0	0	3	0	0
8	8489342	.	C	G	1	3	4	0	0	4	0	0
8	8579618	.	A	C	1	2	3	0	1	4	0	0
8	8605950	.	T	C	4	5	9	0	0	9	0	0
8	8606067	.	C	T	6	4	10	0	0	10	0	0
8	8606070	.	C	T	5	4	9	0	0	9	0	0
8	8606286	.	C	T	1	3	4	0	0	4	0	0
8	8661657	.	C	G	1	3	4	0	0	4	0	0
8	8661663	.	A	G	1	3	4	0	1	5	0	0
8	8846877	.	C	T	2	5	7	0	2	9	0	0
8	8847341	.	T	A	1	12	13	0	0	13	0	0
8	8847410	.	A	G	8	4	12	0	0	12	0	0
8	8847461	.	A	G	7	0	7	0	4	11	0	0
8	8847476	.	C	T	5	4	9	0	0	9	0	0
8	8847593	.	T	C	8	10	18	0	0	18	0	0
8	8847648	.	T	A	11	10	21	0	0	21	0	0
8	8847676	.	G	C	10	15	25	0	2	27	0	0
8	8847788	.	A	C	11	13	24	0	2	26	0	0
8	8847857	.	T	C	6	7	13	0	1	14	0	0
8	8847860	.	T	C	5	8	13	0	2	15	0	0
8	8848122	.	C	A	7	6	13	0	1	14	0	0
8	8905416	.	T	C	13	10	23	0	0	23	0	0
8	8914899	.	T	C	9	4	13	0	1	14	0	0
8	8914911	.	C	T	8	5	13	0	0	13	0	0
8	8919045	.	G	A	0	10	10	0	12	22	0	0
8	8922367	.	T	A	12	19	31	0	3	34	0	0
8	8975926	.	T	C	4	2	6	0	0	6	0	0
8	8977919	.	G	A	6	5	11	0	0	11	0	0
8	9011843	.	G	A	2	3	5	0	0	5	0	0
8	9029047	.	C	A	9	3	12	0	0	12	0	0
8	9052123	.	C	T	5	9	14	0	2	16	0	0
8	9052184	.	A	T	8	13	21	0	1	22	0	0
8	9059491	.	C	T	7	1	8	0	0	8	0	0
8	9092466	.	A	G	3	5	8	0	0	8	0	0
8	9093623	.	A	T	0	1	1	0	0	1	0	0
8	9222862	.	C	T	0	5	5	0	14	19	0	0
8	9222867	.	T	A	10	8	18	0	2	20	0	0
8	9222988	.	G	C	14	8	22	0	0	22	0	0
8	9223044	.	A	G	17	19	36	0	1	38	1	0
8	9231039	.	T	C	4	2	6	0	3	9	0	0
8	9231054	.	C	T	2	2	4	0	0	4	0	0
8	9232930	.	C	T	2	1	3	0	0	3	0	0
8	9262024	.	G	A	7	5	12	0	0	12	0	0
8	9270373	.	G	A	2	1	3	0	1	4	0	0
8	9275102	.	G	A	2	1	3	0	0	3	0	0
8	9275165	.	C	T	0	1	1	0	2	3	0	0
8	9275180	.	G	A	1	1	2	0	0	2	0	0
8	9369304	.	A	G	1	2	3	0	0	3	0	0
8	9369382	.	A	G	1	1	2	0	0	2	0	0
8	9369390	.	A	G	1	0	1	0	1	2	0	0
8	9390769	.	G	A	2	1	3	0	0	3	0	0
8	9394977	.	C	T	3	7	10	0	0	10	0	0
8	9395005	.	G	A	3	4	7	0	0	7	0	0
8	9429697	.	G	A	2	3	5	0	0	5	0	0
8	9532683	.	A	G	3	4	7	0	0	7	0	0
8	9570464	.	T	A	3	2	5	0	0	5	0	0
8	9699182	.	G	C	2	2	4	0	0	4	0	0
8	9709591	.	T	C	0	1	1	0	0	1	0	0
8	9728650	.	G	A	0	1	1	0	0	1	0	0
8	9731233	.	A	G	5	2	7	0	0	7	0	0
8	9733153	.	G	A	0	2	2	0	0	2	0	0
8	9733174	.	G	A	0	2	2	0	1	3	0	0
8	9743078	.	T	C	0	1	1	0	0	1	0	0
8	9743081	.	A	T	0	1	1	0	0	1	0	0
8	9748783	.	A	G	2	2	4	0	1	5	0	0
8	9761116	.	A	C	0	2	2	0	0	2	0	0
8	9791976	.	T	C	11	5	16	0	1	17	0	0
8	9791977	.	G	A	12	5	17	0	0	17	0	0
8	9867301	.	C	G	1	0	1	0	1	2	0	0
8	9867382	.	A	G	3	2	5	0	0	5	0	0
8	9867391	.	T	C	2	2	4	0	0	4	0	0
8	9867459	.	T	C	2	3	5	0	0	5	0	0
8	9867477	.	T	C	2	3	5	0	0	5	0	0
8	9867843	.	G	C	0	3	3	0	1	4	0	0
8	9868310	.	A	G	5	4	9	0	0	9	0	0
8	9961673	.	T	C	6	4	10	0	0	10	0	0
8	9985326	.	C	T	3	8	11	0	0	11	0	0
8	9985458	.	T	C	3	0	3	0	0	3	0	0
8	10306283	.	T	C	4	1	5	0	0	5	0	0
8	10307170	.	C	T	18	12	30	0	2	32	0	0
8	10307686	.	G	T	14	13	27	0	1	28	0	0
8	10307730	.	C	G	15	0	15	0	16	31	0	0
8	10308684	.	T	G	5	0	5	0	8	13	0	0
8	10562400	.	A	C	8	6	14	0	0	14	0	0
8	10823100	.	G	C	2	4	6	0	0	6	0	0
8	10835439	.	A	G	1	0	1	0	0	1	0	0
8	10852169	.	T	A	0	1	1	0	0	1	0	0
8	10856107	.	A	G	6	5	11	0	0	11	0	0
8	10856883	.	A	C	7	3	10	0	2	12	0	0
8	10856915	.	T	C	8	4	12	0	0	12	0	0
8	10869851	.	T	C	1	2	3	0	0	3	0	0
8	10870625	.	C	T	2	1	3	0	0	3	0	0
8	10873945	.	A	G	1	4	5	0	1	6	0	0
8	10882708	.	T	C	7	5	12	0	0	12	0	0
8	10882877	.	A	C	3	2	5	0	0	5	0	0
8	10884489	.	T	C	5	5	10	0	0	10	0	0
8	10890013	.	C	T	6	8	14	0	0	14	0	0
8	10890318	.	T	C	4	6	10	0	0	10	0	0
8	10890325	.	C	G	5	0	5	0	5	10	0	0
8	10894887	.	C	T	2	2	4	0	0	4	0	0
8	10937661	.	A	G	1	3	4	0	0	4	0	0
8	10937990	.	T	A	3	2	5	0	0	5	0	0
8	10938191	.	A	G	1	3	4	0	0	4	0	0
8	10938225	.	T	C	1	2	3	0	1	4	0	0
8	10938418	.	T	C	2	0	2	0	2	4	0	0
8	10956747	.	G	A	4	4	8	0	0	8	0	0
8	10956824	.	A	G	9	4	13	0	1	14	0	0
8	10957045	.	G	T	9	10	19	0	0	19	0	0
8	10957168	.	A	C	4	0	4	0	6	10	0	0
8	10967342	.	T	C	10	0	10	0	14	24	0	0
8	10969651	.	T	A	6	5	11	0	1	12	0	0
8	10972414	.	G	A	1	3	4	0	1	5	0	0
8	10978101	.	A	G	11	9	20	0	3	23	0	0
8	10980909	.	A	G	2	4	6	0	0	6	0	0
8	10981277	.	A	T	0	2	2	0	2	4	0	0
8	10987348	.	A	G	1	1	2	0	0	2	0	0
8	10988903	.	C	T	1	4	5	0	0	5	0	0
8	10988963	.	A	G	3	1	4	0	0	4	0	0
8	11004226	.	A	G	3	3	6	0	0	6	0	0
8	11004246	.	G	A	4	4	8	0	0	8	0	0
8	11004625	.	A	G	7	2	9	0	3	12	0	0
8	11004652	.	T	A	4	6	10	0	1	11	0	0
8	11009117	.	T	C	9	6	15	0	1	16	0	0
8	11016720	.	A	C	6	6	12	0	0	12	0	0
8	11019273	.	A	T	1	3	4	0	0	4	0	0
8	11039011	.	T	A	0	1	1	0	0	1	0	0
8	11114825	.	A	G	2	2	4	0	0	4	0	0
8	11115117	.	A	T	2	6	8	0	0	8	0	0
8	11115818	.	A	T	1	2	3	0	0	3	0	0
8	11115873	.	G	A	1	2	3	0	0	3	0	0
8	11146883	.	T	G	5	4	9	0	0	9	0	0
8	11179228	.	T	A	3	2	5	0	0	5	0	0
8	11180061	.	C	T	3	2	5	0	0	5	0	0
8	11180063	.	T	G	2	2	4	0	1	5	0	0
8	11180115	.	G	C	2	1	3	0	0	3	0	0
8	11182825	.	G	A	6	4	10	0	1	11	0	0
8	11183555	.	G	T	3	3	6	0	0	6	0	0
8	11183576	.	A	T	4	3	7	0	0	7	0	0
8	11183670	.	G	T	4	3	7	0	0	7	0	0
8	11183690	.	T	C	3	4	7	0	0	7	0	0
8	11183708	.	G	A	3	3	6	0	0	6	0	0
8	11183733	.	C	T	0	4	4	0	0	4	0	0
8	11183787	.	G	A	1	3	4	0	0	4	0	0
8	11184030	.	C	A	2	4	6	0	0	6	0	0
8	11184192	.	T	G	0	2	2	0	1	3	0	0
8	11184222	.	A	G	3	3	6	0	1	7	0	0
8	11184413	.	C	A	3	4	7	0	0	7	0	0
8	11184623	.	T	C	3	2	5	0	0	5	0	0
8	11185560	.	T	A	2	2	4	0	0	4	0	0
8	11191221	.	C	A	1	0	1	0	1	2	0	0
8	14441524	.	A	G	6	6	12	0	1	13	0	0
8	14441596	.	A	G	12	9	21	0	1	22	0	0
8	14441810	.	A	T	1	2	3	0	0	3	0	0
8	14792860	.	A	G	1	2	3	0	0	3	0	0
8	14981814	.	G	T	1	2	3	0	0	3	0	0
8	14983093	.	A	G	2	4	6	0	0	6	0	0
8	16411832	.	G	A	1	3	4	0	0	4	0	0
8	17035106	.	T	C	4	2	6	0	0	6	0	0
8	17086043	.	C	T	8	9	17	0	2	19	0	0
8	17396815	.	T	A	3	5	8	1	1	10	0	0
8	17398070	.	T	C	3	13	16	0	2	18	0	0
8	17407150	.	G	A	1	9	10	0	0	10	0	0
8	17801129	.	T	G	0	5	5	0	0	5	0	0
8	18562570	.	C	T	12	7	19	0	1	20	0	0
8	18562576	.	G	A	13	6	19	0	1	20	0	0
8	18853291	.	T	A	1	1	2	0	1	3	0	0
8	19284504	.	T	C	1	2	3	0	0	3	0	0
8	19998254	.	G	T	0	1	1	1	4	6	0	0
8	19998258	.	A	C	4	1	5	0	0	5	0	0
8	21251604	.	A	G	8	4	12	0	1	13	0	0
8	21674317	.	A	G	10	3	13	0	0	13	0	0
8	22612258	.	G	A	1	5	6	0	0	6	0	0
8	25043066	.	T	C	6	0	6	0	7	13	0	0
8	25043069	.	T	C	8	3	11	0	2	13	0	0
8	25103887	.	G	A	1	6	7	0	2	9	0	0
8	25291597	.	A	G	9	3	12	0	0	12	0	0
8	25293008	.	A	G	16	24	40	0	0	40	0	0
8	25293025	.	A	G	25	13	38	0	2	40	0	0
8	25306762	.	T	G	1	2	3	0	1	4	0	0
8	25425453	.	G	A	1	5	6	0	0	6	0	0
8	25708312	.	A	G	6	2	8	0	0	8	0	0
8	25709259	.	G	A	9	3	12	0	0	12	0	0
8	25817058	.	A	G	1	4	5	0	0	5	0	0
8	25821105	.	T	A	0	5	5	0	1	6	0	0
8	25970772	.	A	G	11	7	18	0	2	20	0	0
8	26210949	.	G	C	0	1	1	0	6	8	1	0
8	26210955	.	T	C	1	0	1	0	6	7	0	0
8	26702982	.	A	G	0	2	2	0	0	2	0	0
8	27623973	.	A	G	7	4	11	0	18	29	0	0
8	28231974	.	A	C	8	0	8	0	11	19	0	0
8	28243905	.	A	G	6	2	8	0	0	8	0	0
8	29718974	.	G	T	3	3	6	0	0	6	0	0
8	29719073	.	G	T	2	3	5	0	1	6	0	0
8	29719074	.	C	T	0	4	4	0	2	6	0	0
8	29734395	.	G	A	2	1	3	0	1	4	0	0
8	29734401	.	T	C	2	2	4	0	0	4	0	0
8	29734525	.	T	A	0	3	3	0	0	3	0	0
8	29734615	.	T	A	3	2	5	0	0	5	0	0
8	29749265	.	G	A	3	2	5	0	0	5	0	0
8	29760924	.	C	A	1	0	1	0	1	2	0	0
8	29763383	.	A	G	2	0	2	0	2	4	0	0
8	29763390	.	G	C	2	2	4	0	0	4	0	0
8	29763621	.	G	T	6	9	15	0	1	16	0	0
8	29763822	.	A	G	9	1	10	0	5	15	0	0
8	29763954	.	A	G	3	4	7	0	0	7	0	0
8	29764103	.	G	A	6	2	8	0	0	8	0	0
8	29764150	.	A	T	7	5	12	0	0	12	0	0
8	29764843	.	A	G	5	2	7	0	0	7	0	0
8	29764926	.	T	C	3	7	10	0	1	11	0	0
8	29765010	.	G	C	0	6	6	0	2	8	0	0
8	29765016	.	C	T	1	7	8	0	0	8	0	0
8	29765219	.	G	C	1	2	3	0	1	4	0	0
8	29765235	.	G	T	0	2	2	0	1	3	0	0
8	29765447	.	A	G	3	3	6	0	0	6	0	0
8	29765802	.	G	T	2	3	5	0	0	5	0	0
8	29766296	.	T	A	1	3	4	0	0	4	0	0
8	29767240	.	G	T	0	2	2	0	1	3	0	0
8	29767245	.	T	A	2	2	4	0	0	4	0	0
8	29770511	.	C	T	35	24	59	0	0	59	0	0
8	29770644	.	T	A	26	21	47	0	6	53	0	0
8	29770650	.	T	A	29	22	51	0	4	55	0	0
8	29770734	.	T	A	29	18	47	0	0	47	0	0
8	29770771	.	A	C	25	22	47	0	2	49	0	0
8	29771032	.	T	A	18	18	36	0	3	40	1	0
8	29771053	.	A	G	23	17	40	0	1	41	0	0
8	29771516	.	C	A	3	4	7	0	0	7	0	0
8	29771718	.	T	C	1	0	1	0	3	4	0	0
8	29771774	.	G	A	4	3	7	0	0	7	0	0
8	29772076	.	T	A	3	5	8	0	1	9	0	0
8	29772253	.	G	A	15	15	30	0	0	30	0	0
8	29772268	.	T	C	14	17	31	0	2	33	0	0
8	29772309	.	A	G	10	16	26	0	1	27	0	0
8	29772420	.	A	G	0	13	13	0	2	15	0	0
8	29772423	.	A	G	6	4	10	0	5	15	0	0
8	29772489	.	T	A	3	3	6	0	0	6	0	0
8	29772910	.	G	T	4	7	11	0	0	11	0	0
8	29773164	.	G	A	10	17	27	0	0	27	0	0
8	29773263	.	G	A	17	11	28	0	1	29	0	0
8	29773444	.	A	G	16	17	33	0	0	33	0	0
8	29774268	.	C	T	21	7	28	0	4	32	0	0
8	29774387	.	T	A	11	6	17	0	0	17	0	0
8	29774528	.	C	T	0	11	11	0	9	20	0	0
8	29774570	.	C	T	12	7	19	0	1	20	0	0
8	29787265	.	C	T	0	1	1	0	1	2	0	0
8	29787292	.	C	T	0	1	1	0	1	2	0	0
8	29793782	.	A	G	4	8	12	0	0	12	0	0
8	29799045	.	C	T	1	2	3	0	0	3	0	0
8	29799192	.	T	C	8	1	9	0	14	23	0	0
8	29801150	.	C	G	5	2	7	0	0	7	0	0
8	29819419	.	T	C	7	0	7	0	4	11	0	0
8	29819581	.	A	G	3	5	8	0	1	9	0	0
8	29819729	.	G	T	7	4	11	0	1	12	0	0
8	29875593	.	C	G	5	2	7	0	0	7	0	0
8	29898947	.	T	C	3	2	5	0	1	6	0	0
8	29899027	.	G	A	7	3	10	0	0	10	0	0
8	29899082	.	C	T	0	10	10	0	6	16	0	0
8	29899209	.	T	C	1	8	9	0	0	9	0	0
8	29899373	.	G	A	9	3	12	0	0	12	0	0
8	29899477	.	C	G	4	11	15	0	0	15	0	0
8	29899543	.	A	G	2	7	9	0	0	9	0	0
8	29904949	.	G	A	0	2	2	0	0	2	0	0
8	29904952	.	C	A	0	2	2	0	0	2	0	0
8	29925713	.	G	A	0	2	2	0	0	2	0	0
8	29926972	.	A	T	3	4	7	0	0	7	0	0
8	29926989	.	A	G	2	2	4	0	0	4	0	0
8	30021416	.	A	G	3	0	3	0	1	4	0	0
8	30065903	.	G	A	2	2	4	0	0	4	0	0
8	30159560	.	A	C	2	0	2	0	1	3	0	0
8	30338857	.	G	A	2	3	5	0	0	5	0	0
8	30338875	.	C	G	2	2	4	0	0	4	0	0
8	30338926	.	C	T	3	4	7	0	0	7	0	0
8	30358354	.	G	A	1	2	3	0	0	3	0	0
8	30425723	.	T	A	4	2	6	0	1	7	0	0
8	30425782	.	G	T	2	3	5	0	0	5	0	0
8	30570483	.	T	C	0	3	3	0	1	4	0	0
8	30570496	.	G	A	2	3	5	0	0	5	0	0
8	30572080	.	T	C	0	1	1	0	0	1	0	0
8	30572092	.	C	T	0	1	1	0	0	1	0	0
8	30585283	.	C	T	1	0	1	0	0	1	0	0
8	30591955	.	T	C	0	4	4	0	0	4	0	0
8	30591991	.	G	T	0	5	5	0	0	5	0	0
8	30593538	.	A	G	7	0	7	0	4	11	0	0
8	30600565	.	C	T	1	7	8	0	0	8	0	0
8	30600606	.	T	A	2	7	9	0	0	9	0	0
8	30600668	.	G	C	0	1	1	0	0	1	0	0
8	30652064	.	T	G	0	0	0	0	1	1	0	0
8	30657865	.	T	C	1	0	1	0	0	1	0	0
8	30661568	.	G	A	0	9	9	0	6	15	0	0
8	30661645	.	G	A	6	8	14	0	1	15	0	0
8	30662417	.	C	T	3	5	8	0	0	8	0	0
8	30681170	.	A	C	2	3	5	0	0	5	0	0
8	30730974	.	A	G	4	1	5	0	0	5	0	0
8	30730983	.	A	C	4	4	8	0	0	8	0	0
8	30731362	.	C	T	3	2	5	0	1	6	0	0
8	30734941	.	A	G	3	2	5	0	0	5	0	0
8	30735085	.	A	G	7	5	12	0	0	12	0	0
8	30741991	.	C	G	6	5	11	0	0	11	0	0
8	30742075	.	C	T	1	4	5	0	1	6	0	0
8	30743321	.	T	C	3	7	10	0	0	10	0	0
8	30758590	.	G	A	1	2	3	0	0	3	0	0
8	30925834	.	C	T	0	1	1	0	0	1	0	0
8	30928862	.	T	C	2	4	6	0	1	7	0	0
8	30928987	.	C	T	4	11	15	0	1	16	0	0
8	30929006	.	T	A	4	10	14	0	1	15	0	0
8	30929143	.	T	A	2	5	7	0	0	7	0	0
8	30929261	.	C	T	7	2	9	0	0	9	0	0
8	30929313	.	C	T	8	6	14	0	0	14	0	0
8	30929886	.	A	G	8	9	17	0	2	19	0	0
8	30929958	.	T	A	19	9	28	0	0	28	0	0
8	30930764	.	C	A	4	6	10	0	1	11	0	0
8	30938396	.	T	C	1	5	6	0	0	6	0	0
8	30938408	.	T	A	2	9	11	0	0	11	0	0
8	30940027	.	T	A	1	2	3	0	1	4	0	0
8	30950057	.	G	A	7	6	13	0	0	13	0	0
8	30951562	.	G	A	0	0	0	0	1	1	0	0
8	30951623	.	G	A	5	2	7	0	0	7	0	0
8	30963942	.	G	A	1	3	4	0	0	4	0	0
8	31008514	.	G	C	4	4	8	0	1	9	0	0
8	31008525	.	A	T	4	4	8	0	0	8	0	0
8	31010623	.	A	C	1	1	2	0	0	2	0	0
8	31010648	.	T	C	3	5	8	0	0	8	0	0
8	31010988	.	T	A	5	10	15	0	0	15	0	0
8	31012993	.	C	T	17	13	30	0	0	30	0	0
8	31013027	.	C	T	13	15	28	0	1	29	0	0
8	31013318	.	C	T	4	7	11	0	0	11	0	0
8	31013319	.	G	A	0	7	7	0	4	11	0	0
8	31013493	.	A	C	0	1	1	0	1	2	0	0
8	31013525	.	A	T	1	2	3	0	0	3	0	0
8	31013547	.	A	G	1	3	4	0	0	4	0	0
8	31030717	.	A	C	4	3	7	0	0	7	0	0
8	31030838	.	G	C	6	7	13	0	1	14	0	0
8	31030914	.	A	T	20	18	38	0	0	38	0	0
8	31031180	.	T	G	10	10	20	0	0	20	0	0
8	31031269	.	T	G	14	4	18	0	0	18	0	0
8	31031272	.	T	C	13	4	17	0	1	18	0	0
8	31031535	.	G	A	9	6	15	0	0	15	0	0
8	31031603	.	A	T	9	8	17	0	1	18	0	0
8	31031639	.	C	T	2	6	8	0	8	16	0	0
8	31031993	.	G	A	3	4	7	0	0	7	0	0
8	31032379	.	C	T	4	1	5	0	0	5	0	0
8	31032510	.	G	A	4	3	7	0	2	9	0	0
8	31036126	.	G	A	14	13	27	0	1	28	0	0
8	31037403	.	C	T	3	3	6	0	0	6	0	0
8	31037626	.	T	C	3	0	3	0	5	8	0	0
8	31037647	.	A	G	4	4	8	0	0	8	0	0
8	31040157	.	G	A	7	4	11	0	1	12	0	0
8	31040973	.	T	C	4	0	4	0	1	5	0	0
8	31040988	.	C	A	1	4	5	0	1	6	0	0
8	31041221	.	A	G	3	3	6	0	0	6	0	0
8	31041287	.	C	T	0	2	2	0	1	3	0	0
8	31042318	.	G	A	1	1	2	0	0	2	0	0
8	31045790	.	A	G	1	1	2	0	0	2	0	0
8	31046698	.	A	G	1	2	3	0	1	4	0	0
8	31051207	.	G	A	1	1	2	0	0	2	0	0
8	31100384	.	A	G	0	1	1	0	0	1	0	0
8	31119730	.	A	G	3	3	6	0	0	6	0	0
8	31119865	.	T	C	5	1	6	0	0	6	0	0
8	31119909	.	T	G	12	1	13	0	3	16	0	0
8	31131277	.	A	G	1	3	4	0	0	4	0	0
8	31131394	.	A	C	3	2	5	0	0	5	0	0
8	31135892	.	A	G	20	10	30	0	0	30	0	0
8	31135934	.	C	T	5	2	7	0	0	7	0	0
8	31139439	.	C	T	2	0	2	0	0	2	0	0
8	31142311	.	C	T	31	17	48	0	2	50	0	0
8	31145897	.	C	T	23	31	54	0	1	56	1	0
8	31145940	.	G	C	27	31	58	0	3	61	0	0
8	31145948	.	G	A	27	28	55	0	7	62	0	0
8	31146748	.	G	A	19	28	47	0	2	49	0	0
8	31146805	.	T	C	13	35	48	0	1	49	0	0
8	31146862	.	T	A	24	27	51	0	0	51	0	0
8	31146913	.	G	A	26	21	47	0	2	49	0	0
8	31147159	.	C	T	17	43	60	0	2	62	0	0
8	31147208	.	C	A	24	35	59	0	1	60	0	0
8	31147241	.	A	T	23	26	49	0	0	49	0	0
8	31147315	.	C	T	15	21	36	0	1	37	0	0
8	31147380	.	T	G	11	24	35	0	3	38	0	0
8	31147651	.	C	T	34	19	53	0	0	54	1	0
8	31147898	.	G	A	21	22	43	0	0	43	0	0
8	31249080	.	A	C	4	5	9	0	1	10	0	0
8	31249365	.	G	A	8	6	14	0	2	16	0	0
8	31250032	.	A	G	10	0	10	0	7	17	0	0
8	31250823	.	G	A	9	15	24	0	3	27	0	0
8	31251091	.	A	G	8	15	23	0	1	24	0	0
8	31251222	.	T	C	20	15	35	0	0	35	0	0
8	31251282	.	A	C	15	22	37	0	0	37	0	0
8	31251873	.	T	C	12	13	25	0	2	27	0	0
8	31367705	.	C	A	2	3	5	0	0	5	0	0
8	31367747	.	T	C	8	6	14	0	1	15	0	0
8	31368279	.	T	G	10	17	27	0	0	27	0	0
8	31368368	.	G	T	3	2	5	0	0	5	0	0
8	31368865	.	T	A	5	3	8	0	2	10	0	0
8	31375195	.	A	G	2	6	8	0	1	9	0	0
8	31375434	.	T	A	7	7	14	0	1	15	0	0
8	31375457	.	A	G	7	7	14	0	1	15	0	0
8	31376117	.	T	G	8	7	15	0	1	16	0	0
8	31376125	.	A	T	12	5	17	0	2	19	0	0
8	31387695	.	A	G	6	6	12	0	0	12	0	0
8	31387833	.	C	T	0	5	5	0	5	10	0	0
8	31388280	.	C	T	2	1	3	0	0	3	0	0
8	31393220	.	G	A	5	5	10	0	0	10	0	0
8	31393235	.	G	A	6	4	10	0	0	10	0	0
8	31393451	.	G	T	4	0	4	0	0	4	0	0
8	31395485	.	T	C	2	2	4	0	1	5	0	0
8	31395532	.	T	G	1	3	4	0	0	4	0	0
8	31395713	.	C	A	4	2	6	0	0	6	0	0
8	31395749	.	C	G	3	3	6	0	0	6	0	0
8	31395884	.	A	G	1	1	2	0	0	2	0	0
8	31406764	.	A	T	1	1	2	0	0	2	0	0
8	31407126	.	A	T	14	10	24	0	0	24	0	0
8	31407168	.	C	A	10	9	19	0	1	20	0	0
8	31410872	.	C	T	6	3	9	0	1	10	0	0
8	31410887	.	G	A	3	3	6	0	0	6	0	0
8	31411089	.	C	T	0	5	5	0	5	10	0	0
8	31411176	.	T	G	6	4	10	0	0	10	0	0
8	31411638	.	G	T	2	3	5	0	1	6	0	0
8	31411858	.	A	G	3	4	7	0	0	7	0	0
8	31437497	.	G	C	8	7	15	0	1	16	0	0
8	31437626	.	C	T	13	8	21	0	1	22	0	0
8	31437671	.	T	C	2	2	4	0	0	4	0	0
8	31441870	.	T	C	29	20	49	0	0	49	0	0
8	31442523	.	C	G	16	6	22	0	2	24	0	0
8	31442595	.	G	A	14	16	30	0	0	30	0	0
8	31442794	.	G	T	19	12	31	0	2	33	0	0
8	31442835	.	T	A	0	35	35	0	2	37	0	0
8	31443239	.	T	A	2	2	4	0	0	4	0	0
8	31711411	.	T	C	9	0	9	0	8	17	0	0
8	31716001	.	G	T	5	2	7	0	0	7	0	0
8	31719059	.	C	T	6	5	11	0	0	11	0	0
8	31719077	.	T	C	2	3	5	0	0	5	0	0
8	31730419	.	G	T	6	9	15	0	0	15	0	0
8	31733870	.	C	T	5	1	6	0	0	6	0	0
8	31756865	.	T	C	1	1	2	0	0	2	0	0
8	31756940	.	T	C	5	8	13	0	0	13	0	0
8	31756946	.	T	C	5	6	11	0	0	11	0	0
8	31818022	.	G	A	0	15	15	0	20	35	0	0
8	31818083	.	A	T	16	17	33	0	2	35	0	0
8	31818371	.	A	G	20	6	26	0	3	29	0	0
8	31818425	.	A	C	7	14	21	0	0	21	0	0
8	31818456	.	A	G	7	8	15	0	1	16	0	0
8	31818745	.	C	T	10	16	26	0	0	26	0	0
8	31850955	.	A	T	11	14	25	0	1	26	0	0
8	31851150	.	A	C	6	7	13	0	1	14	0	0
8	31851594	.	T	C	2	2	4	0	0	4	0	0
8	31861425	.	A	G	9	11	20	0	1	21	0	0
8	31861479	.	C	T	15	13	28	0	0	28	0	0
8	31861580	.	G	C	9	25	34	0	1	35	0	0
8	31861615	.	A	C	15	12	27	0	1	28	0	0
8	31861742	.	G	A	14	14	28	0	0	28	0	0
8	31862165	.	C	T	27	11	38	0	3	41	0	0
8	31862384	.	A	G	19	22	41	0	1	42	0	0
8	31862407	.	G	A	19	21	40	0	1	41	0	0
8	31862584	.	G	T	13	6	19	0	1	20	0	0
8	31862670	.	T	A	18	8	26	0	1	27	0	0
8	31898706	.	C	T	2	2	4	0	0	4	0	0
8	31901659	.	A	G	14	6	20	0	3	23	0	0
8	31914427	.	A	T	5	2	7	0	0	7	0	0
8	31919101	.	G	C	2	4	6	0	0	6	0	0
8	31919451	.	G	T	13	10	23	0	2	25	0	0
8	31919548	.	C	T	11	11	22	0	1	23	0	0
8	31942099	.	C	T	3	9	12	0	0	12	0	0
8	31942174	.	G	A	0	12	12	0	15	27	0	0
8	31942723	.	G	A	8	6	14	0	0	14	0	0
8	32028856	.	G	T	3	3	6	0	0	6	0	0
8	32028921	.	T	A	4	3	7	0	0	7	0	0
8	32029663	.	C	T	3	3	6	0	0	6	0	0
8	32030012	.	A	T	1	3	4	0	0	4	0	0
8	32030144	.	A	G	3	2	5	0	0	5	0	0
8	32030177	.	T	C	3	5	8	0	0	8	0	0
8	32030771	.	T	G	6	5	11	0	0	11	0	0
8	32030837	.	T	A	5	3	8	0	0	8	0	0
8	32191744	.	G	A	2	0	2	0	0	2	0	0
8	32403079	.	G	A	2	2	4	0	0	4	0	0
8	32403444	.	T	C	3	2	5	0	0	5	0	0
8	32482851	.	C	T	13	15	28	1	0	29	0	0
8	32483536	.	C	T	2	3	5	0	0	5	0	0
8	32483905	.	G	C	1	0	1	0	0	1	0	0
8	32486956	.	C	T	0	8	8	0	8	16	0	0
8	32497629	.	G	T	8	10	18	0	0	18	0	0
8	32501429	.	T	G	2	3	5	0	1	6	0	0
8	32599363	.	T	C	7	5	12	0	1	13	0	0
8	32599421	.	T	C	11	11	22	0	0	22	0	0
8	32599432	.	T	G	12	12	24	0	0	24	0	0
8	32599556	.	C	G	9	5	14	0	0	14	0	0
8	32599743	.	A	G	8	4	12	0	0	12	0	0
8	32914694	.	C	T	12	10	22	0	1	23	0	0
8	32914748	.	G	T	13	15	28	0	0	29	1	0
8	32914782	.	T	A	11	14	25	0	0	25	0	0
8	32914813	.	A	T	6	8	14	0	2	16	0	0
8	32916957	.	T	A	0	1	1	0	0	1	0	0
8	32925670	.	T	G	4	8	12	0	0	12	0	0
8	32925721	.	A	G	2	2	4	0	0	4	0	0
8	32930789	.	A	G	1	5	6	0	0	6	0	0
8	32930837	.	C	T	8	11	19	0	0	19	0	0
8	33084515	.	A	G	4	0	4	0	0	4	0	0
8	33896326	.	A	T	16	13	29	1	2	32	0	0
8	33896698	.	A	G	11	19	30	0	0	30	0	0
8	33896922	.	G	A	21	16	37	0	2	39	0	0
8	33897274	.	C	T	1	19	20	0	24	44	0	0
8	33918631	.	C	T	10	8	18	0	2	20	0	0
8	33924432	.	C	T	0	23	23	0	14	37	0	0
8	34051719	.	G	A	17	13	30	0	0	30	0	0
8	34051795	.	T	C	11	14	25	0	0	25	0	0
8	34051930	.	T	G	13	10	23	0	2	25	0	0
8	34342123	.	G	C	7	2	9	0	12	21	0	0
8	34342376	.	G	A	6	13	19	0	2	21	0	0
8	34342409	.	A	G	13	9	22	0	0	22	0	0
8	34345285	.	G	A	6	3	9	0	1	10	0	0
8	34345556	.	A	G	1	0	1	0	0	1	0	0
8	34348958	.	A	C	1	4	5	0	0	5	0	0
8	34396859	.	T	A	0	1	1	0	0	1	0	0
8	34402691	.	G	A	4	3	7	0	1	8	0	0
8	35759276	.	G	A	0	5	5	0	2	7	0	0
8	35759444	.	C	T	2	3	5	0	0	5	0	0
8	35759524	.	A	G	4	3	7	0	1	8	0	0
8	35759726	.	C	T	3	2	5	0	0	5	0	0
8	36059070	.	T	C	3	2	5	0	0	5	0	0
8	36061577	.	T	C	1	1	2	0	1	3	0	0
8	36061579	.	A	G	1	1	2	0	1	3	0	0
8	36466904	.	T	A	11	3	14	0	0	14	0	0
8	36473183	.	G	A	3	3	6	0	0	6	0	0
8	36473189	.	G	A	3	3	6	0	0	6	0	0
8	36507260	.	T	G	2	2	4	0	0	4	0	0
8	36507567	.	C	A	3	2	5	0	0	5	0	0
8	36507764	.	G	A	2	3	5	0	0	5	0	0
8	36507770	.	G	A	0	2	2	0	2	4	0	0
8	36515721	.	A	G	2	2	4	0	0	4	0	0
8	36562262	.	T	C	17	4	21	0	1	22	0	0
8	36562451	.	A	G	1	0	1	0	0	1	0	0
8	36563192	.	G	A	2	0	2	0	0	2	0	0
8	36566182	.	T	C	25	12	37	0	2	39	0	0
8	36566353	.	T	C	7	2	9	0	1	10	0	0
8	36567193	.	T	A	10	9	19	0	3	22	0	0
8	36567208	.	A	T	19	10	29	0	1	30	0	0
8	36567316	.	T	C	20	10	30	0	1	31	0	0
8	36567349	.	A	C	4	3	7	0	5	12	0	0
8	36568304	.	C	T	14	10	24	0	0	24	0	0
8	36568492	.	T	C	1	1	2	0	0	2	0	0
8	36568561	.	A	G	7	5	12	0	2	14	0	0
8	36573796	.	C	T	2	1	3	0	1	4	0	0
8	36573808	.	A	T	2	1	3	0	1	4	0	0
8	36577187	.	G	T	1	0	1	0	1	2	0	0
8	36583834	.	T	C	1	5	6	0	1	7	0	0
8	36583877	.	C	A	1	6	7	0	0	7	0	0
8	36587934	.	A	G	5	9	14	0	2	16	0	0
8	36587936	.	A	G	7	0	7	0	9	16	0	0
8	36587970	.	C	A	13	15	28	0	0	28	0	0
8	36587981	.	G	T	10	14	24	0	2	26	0	0
8	36588600	.	G	T	0	5	5	0	2	7	0	0
8	36589226	.	T	C	8	6	14	0	1	15	0	0
8	36592011	.	A	G	8	6	14	0	1	15	0	0
8	36592018	.	A	G	9	7	16	0	0	16	0	0
8	36592101	.	T	C	9	0	9	0	6	15	0	0
8	36592237	.	T	C	2	11	13	0	0	13	0	0
8	36592374	.	A	G	4	6	10	0	0	10	0	0
8	36600801	.	C	G	6	6	12	0	0	12	0	0
8	36600803	.	T	G	6	6	12	0	0	12	0	0
8	36600840	.	T	C	11	0	11	0	11	22	0	0
8	36602459	.	C	T	1	1	2	0	0	2	0	0
8	36613882	.	G	T	5	6	11	0	0	12	1	0
8	36617635	.	C	G	4	2	6	0	0	6	0	0
8	36617669	.	A	G	9	4	13	0	0	13	0	0
8	36746770	.	T	A	1	2	3	0	1	4	0	0
8	36750336	.	A	G	1	0	1	0	2	3	0	0
8	36781596	.	A	G	1	0	1	0	4	5	0	0
8	36781722	.	C	T	3	0	3	0	0	3	0	0
8	36785572	.	A	C	2	3	5	0	1	6	0	0
8	36785599	.	T	C	0	2	2	0	0	2	0	0
8	36803574	.	C	A	8	4	12	0	1	13	0	0
8	36951346	.	C	T	13	12	25	0	0	25	0	0
8	36951481	.	C	T	11	10	21	0	3	24	0	0
8	36951610	.	T	C	10	5	15	0	1	16	0	0
8	36952015	.	A	G	21	0	21	0	13	34	0	0
8	36953884	.	A	G	4	4	8	0	0	8	0	0
8	36953947	.	C	T	11	4	15	0	0	15	0	0
8	36953950	.	G	C	10	3	13	0	2	15	0	0
8	36956254	.	C	T	11	16	27	0	1	28	0	0
8	36956269	.	T	C	11	15	26	0	0	26	0	0
8	36956516	.	G	A	3	3	6	0	0	6	0	0
8	36956540	.	C	A	4	7	11	0	1	12	0	0
8	36964126	.	G	A	6	11	17	0	0	17	0	0
8	36974076	.	C	A	13	15	28	0	2	30	0	0
8	36976089	.	T	C	16	12	28	0	2	30	0	0
8	36976200	.	A	G	2	0	2	0	5	7	0	0
8	36976255	.	T	A	4	7	11	0	0	11	0	0
8	36976288	.	T	A	5	5	10	0	4	14	0	0
8	36976557	.	G	A	14	17	31	0	1	32	0	0
8	36976966	.	C	T	25	17	42	0	2	45	1	0
8	36977170	.	C	T	21	19	40	0	4	44	0	0
8	37001591	.	T	A	2	2	4	0	1	5	0	0
8	37007527	.	T	C	2	0	2	0	0	2	0	0
8	37010662	.	T	C	5	8	13	0	0	13	0	0
8	37010668	.	C	T	4	8	12	0	0	12	0	0
8	37012762	.	T	A	7	5	12	0	0	12	0	0
8	37012825	.	C	T	5	6	11	0	0	11	0	0
8	37012872	.	C	G	1	0	1	0	0	1	0	0
8	37013093	.	A	G	9	6	15	0	2	17	0	0
8	37013210	.	G	A	5	7	12	0	0	12	0	0
8	37013255	.	T	C	5	7	12	0	0	12	0	0
8	37013282	.	T	C	4	5	9	0	0	9	0	0
8	37013833	.	C	T	10	7	17	0	0	17	0	0
8	37013877	.	A	T	0	1	1	0	0	1	0	0
8	37014535	.	G	C	1	0	1	0	0	1	0	0
8	37016584	.	G	T	0	17	17	0	11	28	0	0
8	37016658	.	C	A	11	11	22	0	3	25	0	0
8	37016752	.	A	G	10	11	21	0	0	21	0	0
8	37016790	.	T	C	4	12	16	0	0	16	0	0
8	37017149	.	G	A	3	8	11	0	0	11	0	0
8	37017159	.	C	T	3	5	8	0	0	8	0	0
8	37019059	.	G	A	9	9	18	0	1	19	0	0
8	37019113	.	G	A	8	15	23	0	0	23	0	0
8	37025566	.	C	T	8	19	27	0	3	30	0	0
8	37025576	.	A	T	8	18	26	0	0	26	0	0
8	37025614	.	T	A	3	6	9	0	1	10	0	0
8	37025896	.	T	C	8	9	17	0	2	19	0	0
8	37037669	.	A	T	1	2	3	0	0	3	0	0
8	37059952	.	A	G	1	4	5	0	0	5	0	0
8	37060234	.	T	A	2	9	11	0	0	11	0	0
8	37060305	.	C	T	0	5	5	0	2	7	0	0
8	37060580	.	G	A	4	12	16	0	3	19	0	0
8	37060595	.	A	T	6	16	22	0	1	23	0	0
8	37060702	.	C	T	3	6	9	0	1	10	0	0
8	37075293	.	C	T	0	2	2	0	3	5	0	0
8	37086959	.	C	T	0	1	1	0	0	1	0	0
8	37101346	.	T	C	1	4	5	0	1	6	0	0
8	37101370	.	G	C	3	3	6	0	0	6	0	0
8	37230154	.	A	C	3	0	3	0	2	5	0	0
8	37232135	.	G	C	5	0	5	0	6	11	0	0
8	37232289	.	T	A	9	10	19	0	1	20	0	0
8	37232312	.	G	C	8	10	18	0	1	19	0	0
8	37232419	.	G	A	12	14	26	0	0	26	0	0
8	37232487	.	A	C	19	17	36	0	1	38	1	0
8	37238801	.	C	G	1	2	3	0	1	4	0	0
8	37242374	.	A	T	1	3	4	0	0	4	0	0
8	37280748	.	T	C	8	11	19	0	1	20	0	0
8	37280752	.	C	T	9	8	17	0	1	18	0	0
8	37280809	.	G	T	10	10	20	0	1	21	0	0
8	37280845	.	G	A	8	9	17	0	2	19	0	0
8	37280865	.	C	T	6	9	15	0	1	16	0	0
8	37280923	.	T	A	5	13	18	0	5	23	0	0
8	37281109	.	T	C	14	12	26	0	1	27	0	0
8	37281440	.	T	A	11	8	19	0	0	19	0	0
8	37281444	.	T	A	11	9	20	0	1	21	0	0
8	37281547	.	G	A	13	16	29	0	1	30	0	0
8	37282088	.	C	T	11	6	17	0	2	19	0	0
8	37282110	.	A	T	10	7	17	0	1	18	0	0
8	37282126	.	G	T	6	9	15	0	0	15	0	0
8	37282407	.	G	A	17	8	25	0	2	27	0	0
8	37282848	.	C	T	14	18	32	0	0	32	0	0
8	37282888	.	G	A	11	18	29	0	0	29	0	0
8	37282986	.	G	A	5	10	15	0	1	16	0	0
8	37283016	.	T	A	6	13	19	0	0	19	0	0
8	37283395	.	C	T	3	4	7	0	0	7	0	0
8	37283398	.	C	T	3	2	5	0	2	7	0	0
8	37283435	.	C	T	0	5	5	0	5	10	0	0
8	37283452	.	C	T	4	6	10	0	0	10	0	0
8	37283486	.	A	G	5	5	10	0	1	11	0	0
8	37283487	.	A	C	5	5	10	0	1	11	0	0
8	37283663	.	C	T	13	9	22	0	0	22	0	0
8	37283743	.	A	G	5	12	17	0	1	18	0	0
8	37283748	.	G	T	6	11	17	0	1	18	0	0
8	37284018	.	A	T	4	2	6	0	0	6	0	0
8	37284386	.	A	G	18	22	40	0	1	41	0	0
8	37284428	.	T	G	13	24	37	0	5	42	0	0
8	37284478	.	A	G	10	19	29	0	0	29	0	0
8	37294894	.	A	T	12	11	23	0	3	26	0	0
8	37294930	.	A	G	11	3	14	0	6	20	0	0
8	37295395	.	C	T	0	5	5	0	12	17	0	0
8	37303244	.	G	A	0	1	1	0	0	1	0	0
8	37303271	.	A	C	3	0	3	0	4	7	0	0
8	37303673	.	T	C	3	1	4	0	1	5	0	0
8	37303891	.	G	A	3	4	7	0	0	7	0	0
8	37305515	.	G	C	2	1	3	0	0	3	0	0
8	37306114	.	A	G	3	1	4	0	0	4	0	0
8	37316284	.	G	A	0	2	2	0	0	2	0	0
8	37390950	.	T	A	7	6	13	0	0	13	0	0
8	37453430	.	T	A	0	2	2	0	0	2	0	0
8	37456801	.	T	A	4	4	8	0	0	8	0	0
8	37460616	.	A	T	3	1	4	0	0	5	1	0
8	37460919	.	G	A	2	1	3	0	0	3	0	0
8	37460942	.	G	A	1	2	3	0	0	3	0	0
8	37460985	.	T	C	0	3	3	0	1	4	0	0
8	37460998	.	T	C	3	1	4	0	0	4	0	0
8	37461780	.	A	G	2	4	6	0	0	6	0	0
8	37949209	.	G	A	2	3	5	0	0	5	0	0
8	37949220	.	A	C	1	3	4	0	1	5	0	0
8	37949311	.	C	T	1	4	5	0	0	5	0	0
8	37998527	.	G	T	1	2	3	0	0	3	0	0
8	38190640	.	G	A	6	3	9	0	0	9	0	0
8	38191659	.	T	G	2	2	4	0	0	4	0	0
8	38319615	.	T	C	1	2	3	0	0	3	0	0
8	38319906	.	A	T	1	2	3	0	0	3	0	0
8	38319999	.	T	G	1	3	4	0	0	4	0	0
8	38320072	.	A	G	2	4	6	0	0	6	0	0
8	38418643	.	G	A	1	2	3	0	0	3	0	0
8	38421515	.	C	A	2	4	6	0	0	6	0	0
8	38421627	.	T	A	5	5	10	0	0	10	0	0
8	38421640	.	A	T	4	4	8	0	0	8	0	0
8	38421820	.	C	T	11	7	18	0	1	19	0	0
8	38422058	.	G	A	9	6	15	0	0	15	0	0
8	38422439	.	G	A	6	5	11	0	0	11	0	0
8	38422615	.	C	A	6	3	9	0	0	9	0	0
8	38422624	.	C	T	6	3	9	0	0	9	0	0
8	38422748	.	C	G	4	3	7	0	0	7	0	0
8	38423170	.	T	C	3	0	3	0	5	8	0	0
8	38423210	.	A	G	1	10	11	0	0	11	0	0
8	38423250	.	G	A	3	8	11	0	0	11	0	0
8	38423297	.	A	G	4	6	10	0	0	10	0	0
8	38423373	.	A	T	7	4	11	0	0	11	0	0
8	38423462	.	A	G	6	17	23	0	0	23	0	0
8	38423529	.	C	G	0	9	9	0	8	17	0	0
8	38423617	.	C	T	4	4	8	0	0	8	0	0
8	38423641	.	A	G	2	0	2	0	0	2	0	0
8	38430297	.	G	A	3	1	4	0	0	4	0	0
8	38436657	.	G	A	0	1	1	0	0	1	0	0
8	38565008	.	A	G	3	4	7	0	0	7	0	0
8	38565040	.	C	T	5	7	12	0	1	13	0	0
8	38571116	.	A	T	2	2	4	0	0	4	0	0
8	38572620	.	C	T	1	3	4	0	0	4	0	0
8	38651053	.	A	C	2	1	3	0	0	3	0	0
8	39575223	.	G	A	3	2	5	0	1	6	0	0
8	39646768	.	G	A	8	6	14	0	3	17	0	0
8	39646781	.	T	C	7	7	14	0	2	16	0	0
8	39647008	.	A	C	1	4	5	0	0	5	0	0
8	39703277	.	T	C	7	5	12	0	0	12	0	0
8	39703321	.	G	A	1	2	3	0	0	3	0	0
8	39760860	.	C	T	22	28	50	0	1	51	0	0
8	39765798	.	A	G	33	28	61	0	1	62	0	0
8	39781318	.	T	C	1	3	4	0	0	4	0	0
8	39781340	.	T	A	0	2	2	0	1	3	0	0
8	39781479	.	C	G	3	2	5	0	0	5	0	0
8	39781500	.	A	C	4	2	6	0	0	6	0	0
8	39781517	.	G	C	5	3	8	0	0	8	0	0
8	39786378	.	T	G	1	2	3	0	0	3	0	0
8	39816621	.	T	G	2	2	4	0	0	4	0	0
8	39816800	.	C	T	0	2	2	0	0	2	0	0
8	39816809	.	C	T	1	1	2	0	0	2	0	0
8	39816893	.	G	A	2	5	7	0	0	7	0	0
8	39817011	.	A	G	6	2	8	0	0	8	0	0
8	39817031	.	T	G	3	2	5	0	0	5	0	0
8	39817054	.	A	T	3	1	4	0	0	4	0	0
8	39848745	.	G	C	9	3	12	0	0	12	0	0
8	39848967	.	A	T	3	3	6	0	0	6	0	0
8	39849354	.	C	T	1	5	6	0	0	6	0	0
8	39849373	.	A	T	1	4	5	0	0	5	0	0
8	39849394	.	C	G	3	4	7	0	0	7	0	0
8	39849422	.	T	G	2	5	7	0	1	8	0	0
8	39849439	.	G	T	3	3	6	0	0	6	0	0
8	39849466	.	A	C	3	1	4	0	1	5	0	0
8	39849524	.	C	T	7	5	12	0	0	12	0	0
8	39849617	.	A	G	3	10	13	0	1	14	0	0
8	39849688	.	T	C	2	6	8	0	1	9	0	0
8	39849728	.	A	T	4	4	8	0	1	9	0	0
8	39849767	.	A	T	4	7	11	0	0	11	0	0
8	39849791	.	A	G	2	6	8	0	0	8	0	0
8	39849847	.	C	A	7	4	11	0	0	11	0	0
8	39850149	.	C	T	2	8	10	0	1	11	0	0
8	39850157	.	A	G	2	7	9	0	1	10	0	0
8	39850251	.	C	T	3	6	9	0	1	10	0	0
8	39850455	.	G	A	8	6	14	0	0	14	0	0
8	39850475	.	C	T	7	6	13	0	0	14	1	0
8	39850500	.	C	G	4	7	11	0	0	11	0	0
8	39850625	.	T	A	4	4	8	0	0	8	0	0
8	39850759	.	C	T	3	1	4	0	0	4	0	0
8	39850776	.	A	T	2	1	3	0	0	3	0	0
8	39851514	.	A	G	7	3	10	0	0	10	0	0
8	39851699	.	T	G	2	3	5	0	0	5	0	0
8	39851709	.	G	T	3	3	6	0	0	6	0	0
8	39852514	.	C	T	3	2	5	0	1	6	0	0
8	39870752	.	G	T	1	3	4	0	1	5	0	0
8	39876339	.	G	A	1	2	3	0	1	4	0	0
8	39876378	.	G	A	1	2	3	0	1	4	0	0
8	39884352	.	G	A	1	5	6	0	0	6	0	0
8	39890197	.	T	C	9	1	10	0	0	10	0	0
8	39951571	.	G	A	7	7	14	0	0	14	0	0
8	39976817	.	C	T	12	10	22	0	2	24	0	0
8	39976850	.	G	C	14	0	14	0	12	26	0	0
8	39977153	.	C	G	11	18	29	0	1	30	0	0
8	39977333	.	G	A	9	7	16	0	0	16	0	0
8	39978559	.	A	G	0	1	1	0	0	1	0	0
8	40025733	.	C	T	1	2	3	0	0	3	0	0
8	40163223	.	C	T	13	14	27	0	0	27	0	0
8	40186747	.	A	G	1	4	5	0	0	5	0	0
8	40186982	.	A	T	3	5	8	0	0	8	0	0
8	40189693	.	T	C	1	0	1	0	1	2	0	0
8	40196570	.	G	A	3	1	4	0	0	4	0	0
8	40201496	.	G	A	1	3	4	0	0	4	0	0
8	40217948	.	G	A	3	4	7	0	0	7	0	0
8	40226297	.	T	C	2	2	4	0	0	4	0	0
8	40234640	.	C	T	5	4	9	0	1	10	0	0
8	40234764	.	C	T	2	2	4	1	1	6	0	0
8	40234830	.	A	G	11	5	16	0	0	16	0	0
8	40234831	.	T	A	11	5	16	0	0	16	0	0
8	40235244	.	C	T	1	3	4	0	0	4	0	0
8	40235281	.	G	A	3	2	5	0	0	5	0	0
8	40235348	.	G	C	2	5	7	0	0	7	0	0
8	40236215	.	A	G	2	4	6	0	0	6	0	0
8	40237074	.	A	G	4	0	4	0	3	7	0	0
8	40240922	.	C	G	6	10	16	0	0	16	0	0
8	40241161	.	A	G	20	16	36	0	2	38	0	0
8	40241304	.	C	T	1	19	20	0	15	35	0	0
8	40241364	.	T	G	15	24	39	0	1	40	0	0
8	40241441	.	A	G	10	15	25	2	1	28	0	0
8	40241446	.	A	G	12	14	26	2	1	29	0	0
8	40241640	.	A	T	11	9	20	0	2	22	0	0
8	40241681	.	A	G	15	10	25	0	1	26	0	0
8	40241695	.	T	A	11	8	19	0	0	20	1	0
8	40241718	.	T	C	9	5	14	0	2	16	0	0
8	40241748	.	G	A	8	7	15	1	0	16	0	0
8	40241976	.	C	A	15	24	39	0	0	39	0	0
8	40242005	.	T	G	20	20	40	0	2	42	0	0
8	40242107	.	A	T	13	14	27	0	1	28	0	0
8	40242131	.	A	C	13	15	28	0	0	28	0	0
8	40242243	.	A	C	14	16	30	0	1	32	1	0
8	40242424	.	T	A	13	9	22	0	5	27	0	0
8	40242453	.	G	A	11	12	23	0	0	23	0	0
8	40242613	.	T	A	5	2	7	0	0	7	0	0
8	40242653	.	C	T	5	7	12	0	2	14	0	0
8	40242683	.	A	C	6	10	16	0	0	16	0	0
8	40243052	.	G	C	19	12	31	0	0	31	0	0
8	40243148	.	T	C	9	15	24	0	2	26	0	0
8	40248373	.	T	G	2	8	10	0	1	11	0	0
8	40248673	.	T	C	0	2	2	0	0	2	0	0
8	40248976	.	G	T	1	4	5	0	0	5	0	0
8	40250747	.	C	A	0	15	15	0	12	27	0	0
8	40250798	.	G	A	11	16	27	0	2	29	0	0
8	40251045	.	A	T	8	12	20	0	2	22	0	0
8	40251380	.	G	T	14	13	27	0	0	27	0	0
8	40251700	.	C	G	3	3	6	0	0	6	0	0
8	40270856	.	G	A	4	3	7	0	0	7	0	0
8	40270905	.	A	G	6	12	18	0	0	18	0	0
8	40325709	.	G	T	11	3	14	0	0	14	0	0
8	40325798	.	C	T	13	4	17	0	0	17	0	0
8	40325945	.	T	G	12	10	22	0	1	23	0	0
8	40326072	.	A	T	10	15	25	0	1	26	0	0
8	40326087	.	A	T	10	11	21	0	1	22	0	0
8	40326128	.	C	T	16	12	28	0	1	29	0	0
8	40326736	.	A	G	3	6	9	0	1	10	0	0
8	40327126	.	C	G	1	4	5	0	0	5	0	0
8	40327227	.	A	G	3	2	5	0	0	5	0	0
8	40426980	.	G	A	2	2	4	0	0	4	0	0
8	40427065	.	G	A	1	2	3	0	0	3	0	0
8	40427344	.	T	G	1	3	4	0	0	4	0	0
8	40427384	.	A	T	4	3	7	0	0	7	0	0
8	40429151	.	C	A	0	2	2	0	1	3	0	0
8	40430141	.	G	A	3	2	5	0	0	5	0	0
8	40629350	.	C	T	2	3	5	0	0	5	0	0
8	40632305	.	C	T	4	4	8	0	0	8	0	0
8	40632509	.	C	A	9	4	13	0	0	13	0	0
8	40632545	.	C	T	8	8	16	0	0	16	0	0
8	40632758	.	A	C	11	5	16	0	0	16	0	0
8	40632793	.	A	T	6	3	9	0	0	9	0	0
8	40644840	.	C	T	6	6	12	0	0	12	0	0
8	40645084	.	T	C	4	5	9	0	1	10	0	0
8	40645113	.	C	T	3	4	7	0	0	7	0	0
8	40645602	.	A	G	14	10	24	0	0	24	0	0
8	40645723	.	G	A	6	9	15	0	1	16	0	0
8	40645890	.	A	G	1	6	7	0	2	9	0	0
8	40646283	.	C	T	6	6	12	0	0	12	0	0
8	41186455	.	A	C	1	2	3	0	0	3	0	0
8	41186524	.	C	T	0	3	3	0	5	8	0	0
8	41197077	.	A	T	1	0	1	0	0	1	0	0
8	41201716	.	G	A	1	1	2	0	0	2	0	0
8	41201863	.	C	T	0	1	1	0	1	2	0	0
8	41239494	.	G	A	0	1	1	0	0	1	0	0
8	41239500	.	T	C	0	1	1	0	0	1	0	0
8	41240949	.	T	C	4	1	5	0	0	5	0	0
8	41243315	.	A	G	1	0	1	0	0	1	0	0
8	41243772	.	T	C	1	0	1	0	0	1	0	0
8	41255573	.	T	C	11	10	21	0	1	22	0	0
8	41255793	.	G	C	1	2	3	0	0	3	0	0
8	41261002	.	A	G	18	15	33	0	1	34	0	0
8	41261092	.	T	A	22	19	41	0	0	41	0	0
8	41273680	.	C	T	13	10	23	0	1	24	0	0
8	41274394	.	T	C	1	2	3	0	0	3	0	0
8	41274561	.	T	C	4	2	6	0	0	6	0	0
8	41274617	.	G	A	1	4	5	0	0	5	0	0
8	41462515	.	A	G	15	10	25	0	1	26	0	0
8	41462594	.	A	G	6	10	16	0	0	16	0	0
8	41462606	.	A	G	4	11	15	0	1	16	0	0
8	41468868	.	C	T	4	5	9	0	0	9	0	0
8	41474547	.	T	C	5	5	10	0	0	10	0	0
8	41474556	.	G	A	5	7	12	0	1	13	0	0
8	41484219	.	G	A	1	1	2	0	0	2	0	0
8	41485132	.	A	G	0	1	1	0	0	1	0	0
8	41485204	.	T	A	2	3	5	0	0	5	0	0
8	41485993	.	A	G	1	0	1	0	0	1	0	0
8	41488641	.	C	G	0	0	0	0	1	1	0	0
8	41533605	.	T	C	9	8	17	0	0	17	0	0
8	41533738	.	A	T	5	3	8	0	0	8	0	0
8	42642120	.	C	A	0	3	3	0	8	11	0	0
8	42642199	.	T	G	7	17	24	0	3	27	0	0
8	42642247	.	G	C	13	11	24	0	0	24	0	0
8	42642434	.	C	T	7	6	13	0	2	15	0	0
8	42642641	.	A	T	6	3	9	0	1	10	0	0
8	42642683	.	G	A	1	4	5	0	1	6	0	0
8	42642879	.	G	A	2	6	8	0	0	8	0	0
8	42642941	.	G	T	1	4	5	0	0	5	0	0
8	42643153	.	G	T	3	3	6	0	0	6	0	0
8	42649431	.	G	C	3	3	6	0	0	6	0	0
8	42649485	.	G	A	5	8	13	0	0	13	0	0
8	42653344	.	A	T	0	0	0	0	1	1	0	0
8	42653389	.	A	G	6	3	9	0	1	10	0	0
8	42655774	.	G	T	2	3	5	0	0	5	0	0
8	42689252	.	G	A	1	3	4	0	0	4	0	0
8	42689483	.	A	T	2	1	3	0	1	4	0	0
8	42689492	.	G	A	2	2	4	0	0	4	0	0
8	42689764	.	G	T	1	2	3	0	0	3	0	0
8	42689992	.	G	T	2	2	4	0	0	4	0	0
8	42691252	.	T	C	3	2	5	0	0	5	0	0
8	42834091	.	C	G	1	5	6	0	0	6	0	0
8	42834146	.	T	C	7	3	10	0	0	10	0	0
8	43455875	.	G	A	1	1	2	0	0	2	0	0
8	44211831	.	G	A	1	3	4	0	0	4	0	0
8	44213470	.	T	G	3	1	4	0	0	4	0	0
8	44213729	.	C	T	0	4	4	0	1	5	0	0
8	44296292	.	C	T	1	5	6	0	3	9	0	0
8	44296595	.	A	C	5	0	5	0	5	10	0	0
8	44296672	.	G	A	6	6	12	0	3	15	0	0
8	44297555	.	A	G	3	2	5	0	0	5	0	0
8	44298787	.	C	T	0	2	2	0	4	6	0	0
8	44298814	.	G	T	4	4	8	0	0	8	0	0
8	44567184	.	G	A	0	1	1	0	0	1	0	0
8	44599938	.	C	T	6	5	11	0	0	11	0	0
8	44602132	.	G	A	3	2	5	0	0	5	0	0
8	44602264	.	A	G	4	9	13	0	0	13	0	0
8	44602353	.	G	C	1	0	1	0	0	1	0	0
8	44602357	.	T	C	1	0	1	0	0	1	0	0
8	44604588	.	C	T	0	5	5	0	4	9	0	0
8	44618024	.	C	T	5	2	7	0	0	7	0	0
8	44618065	.	G	A	0	3	3	0	3	6	0	0
8	44669550	.	T	C	1	0	1	0	0	1	0	0
8	44677544	.	C	T	1	7	8	0	0	8	0	0
8	44677613	.	T	C	2	4	6	0	0	6	0	0
8	44695043	.	A	C	3	8	11	0	0	11	0	0
8	44695140	.	A	C	5	2	7	0	1	8	0	0
8	44695230	.	A	T	16	11	27	0	0	27	0	0
8	44730536	.	G	A	0	0	0	0	1	1	0	0
8	44737646	.	C	A	0	2	2	0	0	2	0	0
8	44894575	.	T	A	1	7	8	0	1	9	0	0
8	44894604	.	C	T	2	10	12	0	0	12	0	0
8	44894631	.	G	C	3	13	16	0	1	17	0	0
8	44897853	.	C	A	0	2	2	0	0	2	0	0
8	44921346	.	G	A	3	2	5	0	0	5	0	0
8	44921394	.	A	T	2	2	4	0	1	5	0	0
8	44921395	.	A	T	2	3	5	0	0	5	0	0
8	44923267	.	G	A	2	1	3	0	0	3	0	0
8	44923622	.	T	G	1	2	3	0	0	3	0	0
8	44923700	.	T	C	0	0	0	0	1	1	0	0
8	44976047	.	G	T	1	2	3	0	0	3	0	0
8	45036752	.	C	T	1	1	2	0	0	2	0	0
8	45298603	.	G	A	0	1	1	0	0	1	0	0
8	45298943	.	G	C	5	7	12	0	0	12	0	0
8	45308963	.	A	C	14	8	22	0	1	23	0	0
8	45311761	.	T	G	10	17	27	0	0	27	0	0
8	45312231	.	G	C	1	9	10	0	7	17	0	0
8	45312285	.	C	A	0	2	2	0	1	3	0	0
8	45313023	.	A	C	7	7	14	0	1	15	0	0
8	45315444	.	T	C	6	9	15	0	3	18	0	0
8	45317898	.	A	T	2	7	9	0	0	9	0	0
8	45317976	.	G	A	3	8	11	0	9	20	0	0
8	45319659	.	A	G	1	0	1	0	0	1	0	0
8	45325269	.	G	C	12	10	22	0	1	23	0	0
8	45328278	.	T	A	8	8	16	0	0	16	0	0
8	45361816	.	A	G	14	8	22	0	1	23	0	0
8	45365789	.	T	C	11	8	19	0	3	22	0	0
8	45374151	.	A	T	14	9	23	0	2	25	0	0
8	45374477	.	A	G	5	11	16	1	0	17	0	0
8	45374665	.	T	A	21	11	32	0	2	34	0	0
8	45374828	.	A	C	10	5	15	0	1	16	0	0
8	45374884	.	T	G	17	8	25	0	1	26	0	0
8	45374966	.	G	T	4	9	13	0	0	13	0	0
8	45374970	.	A	G	4	9	13	0	0	13	0	0
8	45381427	.	T	A	4	2	6	0	1	7	0	0
8	45381555	.	T	C	3	3	6	0	0	6	0	0
8	45381570	.	C	T	4	3	7	0	0	7	0	0
8	45381596	.	G	T	0	2	2	0	2	4	0	0
8	45381862	.	G	A	0	4	4	0	4	8	0	0
8	45395002	.	C	A	0	1	1	0	2	3	0	0
8	45395024	.	C	A	2	1	3	0	0	3	0	0
8	45395114	.	T	A	5	3	8	0	1	9	0	0
8	45395127	.	C	T	4	4	8	0	0	8	0	0
8	45395234	.	T	G	1	2	3	0	0	3	0	0
8	45395245	.	C	T	1	2	3	0	0	3	0	0
8	45395463	.	A	C	0	2	2	0	0	2	0	0
8	45396028	.	T	C	2	1	3	0	4	7	0	0
8	45427189	.	C	A	2	5	7	0	0	7	0	0
8	45428039	.	C	T	13	20	33	0	0	33	0	0
8	45430757	.	G	A	6	2	8	0	2	10	0	0
8	45754937	.	G	T	3	2	5	0	0	5	0	0
8	45755117	.	G	A	5	2	7	0	0	7	0	0
8	45755185	.	T	C	2	8	10	0	1	11	0	0
8	45755513	.	G	A	1	3	4	0	0	4	0	0
8	45755577	.	G	A	3	3	6	0	0	6	0	0
8	45755816	.	T	C	31	25	56	0	6	62	0	0
8	45755973	.	C	G	16	18	34	0	0	35	1	0
8	45756191	.	A	G	30	37	67	0	2	69	0	0
8	45756206	.	G	A	22	31	53	0	3	56	0	0
8	45760071	.	A	C	8	0	8	0	8	16	0	0
8	45763562	.	G	A	17	11	28	0	2	30	0	0
8	45763991	.	A	G	14	17	31	0	0	31	0	0
8	45764006	.	G	C	20	16	36	0	1	37	0	0
8	45764118	.	C	T	1	12	13	0	25	38	0	0
8	45764569	.	T	C	4	3	7	0	0	7	0	0
8	45764697	.	T	C	8	5	13	0	0	13	0	0
8	45764873	.	T	C	4	13	17	0	0	17	0	0
8	45764893	.	T	C	8	14	22	0	3	25	0	0
8	45764939	.	G	A	20	18	38	0	2	40	0	0
8	45764988	.	A	T	13	23	36	0	0	36	0	0
8	45765023	.	T	A	15	16	31	0	6	37	0	0
8	45765024	.	T	A	19	18	37	0	0	37	0	0
8	45765305	.	G	A	5	11	16	0	1	17	0	0
8	45772915	.	C	A	10	8	18	0	2	20	0	0
8	45774471	.	C	T	0	1	1	0	1	2	0	0
8	45775047	.	C	T	9	6	15	0	1	16	0	0
8	45775068	.	A	T	7	8	15	0	0	15	0	0
8	45775304	.	G	A	7	8	15	0	0	15	0	0
8	45775319	.	G	T	9	9	18	0	0	18	0	0
8	45779729	.	A	C	2	8	10	0	0	10	0	0
8	45786186	.	C	T	0	2	2	0	2	4	0	0
8	45786528	.	A	G	3	0	3	0	0	3	0	0
8	45786615	.	A	G	10	7	17	0	0	17	0	0
8	45787137	.	A	G	7	7	14	0	0	14	0	0
8	45788941	.	T	G	6	10	16	0	0	16	0	0
8	45789163	.	C	A	2	1	3	0	0	3	0	0
8	45797305	.	G	A	1	1	2	0	0	2	0	0
8	45834940	.	G	A	4	6	10	0	0	10	0	0
8	45838228	.	C	T	2	0	2	0	0	2	0	0
8	45852779	.	T	C	3	2	5	0	0	5	0	0
8	45853288	.	A	C	0	3	3	0	0	3	0	0
8	45853626	.	G	A	4	4	8	0	0	8	0	0
8	45870914	.	C	A	0	0	0	0	1	1	0	0
8	45871782	.	A	G	5	3	8	0	0	8	0	0
8	45875627	.	A	G	0	3	3	0	0	3	0	0
8	45879493	.	T	C	1	0	1	0	0	1	0	0
8	45896997	.	T	C	0	0	0	0	1	1	0	0
8	45907117	.	C	T	0	1	1	0	0	1	0	0
8	45939494	.	C	T	2	2	4	0	0	4	0	0
8	45944896	.	T	A	2	4	6	0	0	6	0	0
8	45944983	.	G	A	5	3	8	0	0	8	0	0
8	45945024	.	C	T	1	1	2	0	0	2	0	0
8	45951974	.	G	A	0	5	5	0	9	14	0	0
8	45952152	.	A	T	8	5	13	0	0	13	0	0
8	45952281	.	C	T	13	5	18	0	0	18	0	0
8	45952352	.	G	C	8	6	14	0	0	14	0	0
8	45952437	.	G	A	0	5	5	0	5	10	0	0
8	45952461	.	G	A	0	5	5	0	4	9	0	0
8	45952547	.	G	T	2	3	5	0	0	5	0	0
8	45965528	.	G	T	1	3	4	0	1	5	0	0
8	45965749	.	G	A	2	2	4	0	0	4	0	0
8	46011055	.	T	A	2	2	4	0	0	4	0	0
8	46014147	.	T	C	1	4	5	0	0	5	0	0
8	46077850	.	T	A	2	4	6	0	0	6	0	0
8	46077879	.	C	A	5	3	8	0	0	8	0	0
8	46078114	.	T	A	1	2	3	0	0	3	0	0
8	46078168	.	C	A	4	3	7	0	0	7	0	0
8	46078241	.	A	T	7	4	11	0	2	13	0	0
8	46078264	.	A	T	8	7	15	0	0	15	0	0
8	46078287	.	A	G	8	10	18	0	0	18	0	0
8	46078342	.	C	G	7	10	17	0	0	17	0	0
8	46089052	.	T	C	4	0	4	0	0	4	0	0
8	46094790	.	G	A	0	1	1	0	0	1	0	0
8	46123717	.	G	A	1	0	1	0	0	1	0	0
8	46123731	.	G	A	2	3	5	0	0	5	0	0
8	46160929	.	A	G	3	2	5	0	0	5	0	0
8	46233638	.	G	T	0	3	3	0	0	3	0	0
8	46258216	.	A	G	3	3	6	0	0	6	0	0
8	46265180	.	C	A	0	3	3	0	1	4	0	0
8	46310717	.	G	A	2	2	4	0	0	4	0	0
8	46317199	.	G	A	1	2	3	0	0	3	0	0
8	46327404	.	A	G	6	3	9	0	0	9	0	0
8	46328214	.	T	C	2	3	5	0	0	5	0	0
8	46328217	.	T	C	1	3	4	0	1	5	0	0
8	46337310	.	A	G	1	2	3	0	0	3	0	0
8	46346949	.	G	T	0	3	3	0	3	6	0	0
8	46347099	.	A	T	4	2	6	0	0	6	0	0
8	46347147	.	C	T	1	3	4	0	0	4	0	0
8	46348145	.	G	T	2	6	8	0	0	8	0	0
8	46353395	.	G	A	2	2	4	0	0	4	0	0
8	46356282	.	G	A	0	1	1	0	0	1	0	0
8	46362293	.	G	A	2	1	3	0	0	3	0	0
8	46370250	.	G	A	1	2	3	0	0	3	0	0
8	46395923	.	A	G	1	2	3	0	0	3	0	0
8	46402449	.	G	A	1	3	4	0	0	4	0	0
8	46431134	.	A	G	9	3	12	0	1	13	0	0
8	46431240	.	A	C	4	7	11	0	0	11	0	0
8	46431247	.	A	T	4	7	11	0	0	11	0	0
8	46431298	.	A	G	4	8	12	0	0	12	0	0
8	46431329	.	T	A	2	5	7	0	0	7	0	0
8	46431403	.	T	G	3	5	8	0	0	8	0	0
8	46431408	.	G	A	3	5	8	0	0	8	0	0
8	46431453	.	A	T	2	11	13	0	0	13	0	0
8	46431620	.	C	T	6	7	13	0	0	13	0	0
8	46431631	.	G	C	5	3	8	0	1	9	0	0
8	46431680	.	G	C	1	0	1	0	0	1	0	0
8	46433538	.	T	C	3	3	6	0	0	6	0	0
8	46433554	.	G	C	4	3	7	0	0	7	0	0
8	46433693	.	T	C	2	2	4	0	1	5	0	0
8	46433712	.	T	A	0	3	3	0	1	4	0	0
8	46853005	.	A	T	2	3	5	0	0	5	0	0
8	46853015	.	A	T	2	2	4	0	0	4	0	0
8	46855313	.	G	A	3	4	7	0	0	7	0	0
8	46881326	.	G	T	2	4	6	0	0	6	0	0
8	46883677	.	T	A	1	2	3	0	0	3	0	0
8	47145008	.	A	G	8	6	14	0	1	15	0	0
8	47147333	.	A	T	28	32	60	0	2	62	0	0
8	47159514	.	G	A	6	3	9	0	0	9	0	0
8	47159557	.	C	A	3	3	6	0	0	6	0	0
8	47178393	.	T	A	2	0	2	0	0	2	0	0
8	47834998	.	G	A	3	2	5	0	1	6	0	0
8	47835307	.	A	T	1	2	3	0	0	3	0	0
8	47844022	.	A	G	3	3	6	0	0	6	0	0
8	47911031	.	C	G	3	0	3	0	1	4	0	0
8	47917304	.	C	T	0	5	5	0	0	5	0	0
8	47927814	.	C	T	1	2	3	0	0	3	0	0
8	47932409	.	C	T	5	2	7	0	0	7	0	0
8	47932442	.	G	A	2	2	4	0	1	5	0	0
8	47937152	.	T	C	1	4	5	0	0	5	0	0
8	47937156	.	A	G	1	0	1	0	4	5	0	0
8	47937263	.	T	C	15	14	29	0	0	29	0	0
8	47946517	.	T	C	11	13	24	0	4	28	0	0
8	47946674	.	G	A	5	7	12	0	0	12	0	0
8	47946753	.	C	T	7	15	22	0	0	22	0	0
8	47946776	.	T	C	8	13	21	0	1	22	0	0
8	47946833	.	A	G	17	7	24	0	2	26	0	0
8	47946846	.	A	G	14	10	24	0	0	24	0	0
8	47947052	.	A	C	5	6	11	0	0	11	0	0
8	47947297	.	C	T	11	15	26	0	0	26	0	0
8	47947341	.	C	A	9	8	17	0	1	18	0	0
8	47947391	.	A	G	10	9	19	0	1	20	0	0
8	47947649	.	T	A	15	13	28	1	0	29	0	0
8	47947772	.	A	G	13	1	14	0	10	24	0	0
8	47947996	.	T	G	17	12	29	0	0	29	0	0
8	47948102	.	T	A	15	10	25	0	0	25	0	0
8	47948254	.	A	G	15	7	22	0	0	22	0	0
8	47948602	.	G	A	0	15	15	0	13	28	0	0
8	47948755	.	C	T	9	19	28	0	2	30	0	0
8	47948820	.	A	C	5	13	18	0	0	18	0	0
8	47948866	.	C	A	3	8	11	0	0	11	0	0
8	48093139	.	T	C	2	2	4	0	0	4	0	0
8	48603788	.	G	C	0	5	5	0	2	7	0	0
8	48603978	.	T	A	2	5	7	0	0	7	0	0
8	48604114	.	T	A	5	5	10	0	0	10	0	0
8	48629640	.	T	A	1	6	7	0	0	7	0	0
8	48629682	.	A	C	6	2	8	0	0	8	0	0
8	48629797	.	C	A	9	3	12	0	2	14	0	0
8	48629946	.	A	T	9	7	16	0	2	18	0	0
8	48629969	.	T	C	8	0	8	0	7	15	0	0
8	48630017	.	A	G	1	2	3	0	0	3	0	0
8	48642433	.	G	A	3	6	9	0	0	9	0	0
8	48642496	.	A	G	5	4	9	0	0	9	0	0
8	48646053	.	A	G	1	0	1	0	0	1	0	0
8	48801480	.	G	A	0	4	4	0	6	10	0	0
8	48801508	.	C	T	5	8	13	0	0	13	0	0
8	48801553	.	C	T	10	4	14	0	0	14	0	0
8	48801678	.	C	T	8	1	9	0	0	9	0	0
8	48809570	.	G	A	0	6	6	0	0	6	0	0
8	48809587	.	T	G	1	4	5	0	0	5	0	0
8	48809678	.	A	C	3	3	6	0	0	6	0	0
8	48816147	.	C	T	1	3	4	0	0	4	0	0
8	48958459	.	T	A	8	3	11	0	0	11	0	0
8	48958637	.	A	G	5	9	14	0	3	17	0	0
8	48958822	.	C	T	15	8	23	0	1	24	0	0
8	48959047	.	G	A	5	5	10	0	3	13	0	0
8	48966140	.	C	G	2	3	5	0	2	7	0	0
8	48991948	.	C	T	3	1	4	0	1	5	0	0
8	49002116	.	A	G	3	1	4	0	1	5	0	0
8	49003785	.	A	G	0	0	0	0	1	1	0	0
8	49009822	.	C	A	1	0	1	0	0	1	0	0
8	49009829	.	C	T	0	1	1	0	0	1	0	0
8	49073021	.	G	A	1	1	2	0	0	2	0	0
8	49078792	.	G	A	1	5	6	0	7	13	0	0
8	49078817	.	C	T	4	1	5	0	1	6	0	0
8	49078827	.	A	C	3	1	4	0	1	5	0	0
8	49086105	.	G	T	3	2	5	0	0	5	0	0
8	49092063	.	T	A	5	3	8	0	1	9	0	0
8	49092108	.	C	T	5	3	8	0	2	10	0	0
8	49092129	.	C	T	2	1	3	0	0	3	0	0
8	49096541	.	G	T	3	5	8	0	0	8	0	0
8	49108347	.	A	T	5	10	15	0	1	16	0	0
8	49170190	.	T	A	4	3	7	0	2	9	0	0
8	49170366	.	T	A	8	9	17	0	0	17	0	0
8	49172338	.	A	G	5	2	7	0	0	7	0	0
8	49310830	.	C	T	7	7	14	0	0	14	0	0
8	49310928	.	T	C	2	6	8	0	0	8	0	0
8	49311090	.	C	T	9	5	14	0	0	14	0	0
8	49311355	.	T	C	21	15	36	0	2	38	0	0
8	49311396	.	C	A	15	9	24	0	1	25	0	0
8	49311398	.	G	C	16	9	25	0	0	25	0	0
8	49345116	.	C	T	7	5	12	0	1	13	0	0
8	49345191	.	T	C	4	15	19	0	2	21	0	0
8	49345212	.	G	T	12	9	21	0	0	21	0	0
8	49345272	.	A	G	10	10	20	0	0	20	0	0
8	49404152	.	G	T	16	21	37	0	5	42	0	0
8	49404262	.	C	T	24	25	49	0	5	54	0	0
8	49404502	.	C	T	33	28	61	0	4	65	0	0
8	49404928	.	C	T	31	36	67	0	3	70	0	0
8	49413417	.	G	T	31	31	62	0	1	63	0	0
8	49413444	.	G	A	28	26	54	0	5	59	0	0
8	49413459	.	G	A	33	23	56	0	2	58	0	0
8	49415718	.	G	C	6	3	9	0	1	10	0	0
8	49435964	.	C	G	2	1	3	0	1	4	0	0
8	49443191	.	A	G	3	0	3	0	3	6	0	0
8	49447458	.	A	T	2	1	3	0	0	3	0	0
8	49447519	.	G	A	2	4	6	0	0	6	0	0
8	49447657	.	C	A	3	4	7	0	0	8	1	0
8	49706428	.	T	C	1	3	4	0	1	5	0	0
8	49722313	.	T	C	5	3	8	0	0	8	0	0
8	49745727	.	T	G	3	3	6	0	0	6	0	0
8	49746224	.	T	C	4	13	17	0	0	17	0	0
8	49746256	.	G	A	7	11	18	0	0	18	0	0
8	49746440	.	T	C	20	23	43	0	3	46	0	0
8	49746456	.	T	G	20	15	35	0	1	36	0	0
8	49755801	.	A	C	14	18	32	0	1	33	0	0
8	49755867	.	A	T	16	14	30	0	0	30	0	0
8	49756121	.	A	T	9	6	15	0	0	15	0	0
8	49759453	.	A	G	2	0	2	0	0	2	0	0
8	49769496	.	G	A	5	4	9	0	0	9	0	0
8	49778672	.	T	G	3	5	8	0	1	9	0	0
8	49845392	.	A	G	9	4	13	0	1	14	0	0
8	49851155	.	C	G	5	6	11	0	0	11	0	0
8	49860718	.	C	T	10	4	14	0	0	14	0	0
8	49864103	.	T	C	5	3	8	0	0	8	0	0
8	49864124	.	G	A	7	6	13	0	0	13	0	0
8	49864212	.	C	T	10	11	21	0	0	21	0	0
8	49864232	.	G	A	7	13	20	0	0	20	0	0
8	49864301	.	G	T	4	4	8	0	0	8	0	0
8	49864402	.	C	T	6	7	13	0	1	14	0	0
8	49864655	.	G	T	3	10	13	0	1	14	0	0
8	49899474	.	G	A	1	2	3	0	0	3	0	0
8	49899528	.	G	A	7	4	11	0	0	11	0	0
8	49899621	.	G	A	1	1	2	0	0	2	0	0
8	49901127	.	T	C	2	0	2	0	3	5	0	0
8	49908789	.	G	T	2	3	5	0	0	5	0	0
8	49908792	.	G	A	3	2	5	0	0	5	0	0
8	49911143	.	G	A	1	0	1	0	1	2	0	0
8	49912682	.	G	A	1	2	3	0	0	3	0	0
8	49941098	.	A	T	0	2	2	0	0	2	0	0
8	49947483	.	C	T	3	4	7	0	0	7	0	0
8	49949798	.	C	T	2	1	3	0	0	3	0	0
8	49952260	.	C	T	0	5	5	0	0	5	0	0
8	49969135	.	G	C	0	2	2	0	0	2	0	0
8	49989214	.	A	C	1	2	3	0	0	3	0	0
8	49996176	.	T	C	1	1	2	0	0	2	0	0
8	50012607	.	G	A	1	2	3	0	0	3	0	0
8	50156805	.	G	A	4	4	8	0	0	8	0	0
8	50159305	.	C	T	3	3	6	0	0	6	0	0
8	50159515	.	A	G	1	1	2	0	0	2	0	0
8	50163398	.	A	G	6	0	6	0	4	10	0	0
8	50170889	.	T	C	3	9	12	0	2	14	0	0
8	50179868	.	T	A	7	5	12	0	1	13	0	0
8	50179944	.	T	G	4	6	10	0	0	10	0	0
8	50493190	.	T	C	1	6	7	0	0	7	0	0
8	50501462	.	C	T	3	4	7	0	0	7	0	0
8	50812321	.	G	A	5	3	8	0	0	8	0	0
8	50818102	.	G	T	3	1	4	0	0	4	0	0
8	50837731	.	A	G	2	4	6	0	0	6	0	0
8	50845104	.	T	C	3	1	4	0	0	4	0	0
8	50849973	.	C	T	0	1	1	0	0	1	0	0
8	50889992	.	C	T	2	3	5	0	0	5	0	0
8	50890422	.	A	T	2	0	2	0	0	2	0	0
8	50942296	.	T	G	11	7	18	0	0	18	0	0
8	50947386	.	G	C	0	5	5	0	0	5	0	0
8	50947648	.	T	A	14	18	32	0	1	34	1	0
8	50948620	.	A	G	17	0	17	0	18	35	0	0
8	50948623	.	T	C	17	20	37	0	1	38	0	0
8	50949040	.	T	A	16	13	29	0	1	30	0	0
8	50949086	.	T	A	5	13	18	0	0	18	0	0
8	50949128	.	T	C	2	7	9	0	1	10	0	0
8	50949160	.	A	T	17	6	23	0	0	23	0	0
8	50949188	.	C	T	17	18	35	0	0	35	0	0
8	50949430	.	T	A	31	11	42	0	1	43	0	0
8	50949479	.	A	G	14	32	46	0	2	48	0	0
8	50949501	.	A	T	35	17	52	0	2	54	0	0
8	50949570	.	G	A	20	21	41	0	3	44	0	0
8	50949573	.	G	A	23	18	41	0	2	43	0	0
8	50949639	.	C	T	20	16	36	0	4	40	0	0
8	50949766	.	C	T	9	5	14	0	1	15	0	0
8	50949903	.	A	G	21	0	21	0	20	41	0	0
8	50960443	.	C	A	11	14	25	0	0	25	0	0
8	50960542	.	T	C	8	7	15	0	1	16	0	0
8	50962536	.	T	C	2	2	4	0	0	4	0	0
8	50962623	.	T	G	17	0	17	0	14	31	0	0
8	50967774	.	C	G	3	5	8	0	2	10	0	0
8	50969141	.	T	C	4	3	7	0	2	9	0	0
8	50969150	.	A	G	5	3	8	0	2	10	0	0
8	50969367	.	G	A	5	2	7	0	0	7	0	0
8	50969493	.	T	A	4	7	11	0	1	12	0	0
8	50971524	.	G	A	6	4	10	0	0	10	0	0
8	50972267	.	C	T	4	3	7	0	0	7	0	0
8	50981034	.	A	G	3	1	4	0	0	4	0	0
8	51008365	.	T	C	1	0	1	0	0	1	0	0
8	51027069	.	C	T	2	3	5	0	0	5	0	0
8	51027111	.	T	G	1	3	4	0	1	5	0	0
8	51027123	.	C	A	2	2	4	0	0	4	0	0
8	51109346	.	T	G	1	1	2	0	1	3	0	0
8	51134917	.	A	T	1	2	3	0	0	3	0	0
8	51144662	.	T	C	3	0	3	0	0	3	0	0
8	51147570	.	A	G	2	3	5	0	1	6	0	0
8	51165572	.	T	C	5	6	11	0	1	12	0	0
8	51165786	.	C	A	1	6	7	0	8	15	0	0
8	51165961	.	T	A	2	2	4	0	0	4	0	0
8	51173843	.	A	G	7	5	12	0	0	12	0	0
8	51195100	.	G	A	2	0	2	0	0	2	0	0
8	51309145	.	T	G	9	9	18	0	0	18	0	0
8	51309311	.	A	G	2	3	5	0	1	6	0	0
8	51314087	.	G	A	8	7	15	0	0	15	0	0
8	51320547	.	C	T	5	2	7	0	1	8	0	0
8	51320652	.	C	T	3	2	5	0	1	6	0	0
8	51325510	.	T	G	2	4	6	0	0	6	0	0
8	51330776	.	T	C	0	1	1	0	0	1	0	0
8	51330836	.	A	T	2	2	4	0	0	4	0	0
8	51351121	.	C	T	10	7	17	0	1	18	0	0
8	51351155	.	T	A	6	6	12	0	1	13	0	0
8	51351200	.	A	T	8	9	17	0	1	18	0	0
8	51352480	.	A	G	13	7	20	0	0	20	0	0
8	51352525	.	A	T	2	2	4	0	0	4	0	0
8	51358769	.	G	A	2	0	2	0	0	2	0	0
8	51364515	.	T	C	5	6	11	0	0	11	0	0
8	51364644	.	C	A	0	14	14	0	9	23	0	0
8	51364665	.	T	C	6	16	22	0	0	22	0	0
8	51364696	.	C	G	1	9	10	0	0	10	0	0
8	51364713	.	C	A	0	4	4	0	1	5	0	0
8	51367178	.	A	T	1	0	1	0	0	1	0	0
8	51367206	.	C	T	5	4	9	0	0	9	0	0
8	51367217	.	C	T	8	7	15	0	0	15	0	0
8	51367267	.	A	T	8	12	20	0	0	20	0	0
8	51375405	.	T	G	12	8	20	0	1	21	0	0
8	51379609	.	G	A	1	5	6	0	0	6	0	0
8	51379699	.	G	A	7	4	11	0	0	11	0	0
8	51431396	.	C	T	1	8	9	0	4	13	0	0
8	51431477	.	G	A	4	1	5	0	0	5	0	0
8	51431526	.	A	T	3	7	10	0	0	10	0	0
8	51431561	.	A	G	3	4	7	0	0	7	0	0
8	51431573	.	A	T	3	4	7	0	0	7	0	0
8	51431805	.	T	A	4	4	8	0	0	8	0	0
8	51432009	.	T	C	4	9	13	0	0	13	0	0
8	51432017	.	T	C	3	8	11	0	1	12	0	0
8	51434081	.	A	G	4	3	7	0	0	7	0	0
8	51434330	.	C	A	0	1	1	0	1	2	0	0
8	51434357	.	C	G	1	1	2	0	0	2	0	0
8	51437323	.	A	G	2	2	4	0	0	4	0	0
8	51573138	.	T	A	1	4	5	0	0	5	0	0
8	51573385	.	C	T	1	2	3	0	0	3	0	0
8	51573406	.	A	T	2	2	4	0	0	4	0	0
8	51573439	.	T	C	2	1	3	0	0	3	0	0
8	51573441	.	T	C	1	1	2	0	1	3	0	0
8	51576887	.	C	T	0	2	2	0	1	3	0	0
8	51576925	.	C	T	0	4	4	0	3	7	0	0
8	51634824	.	C	T	1	2	3	0	0	3	0	0
8	51721731	.	G	T	2	4	6	0	0	6	0	0
8	51723164	.	C	T	4	2	6	0	0	6	0	0
8	51723249	.	A	G	1	3	4	2	1	7	0	0
8	51723285	.	G	A	0	17	17	3	0	20	0	0
8	51723320	.	A	G	0	13	13	1	0	14	0	0
8	51723984	.	A	T	5	5	10	0	0	10	0	0
8	51724029	.	T	G	2	7	9	0	0	9	0	0
8	51724067	.	C	T	1	5	6	0	0	6	0	0
8	51724288	.	G	A	2	2	4	0	0	4	0	0
8	51724371	.	A	T	0	3	3	0	0	3	0	0
8	51724389	.	T	A	0	2	2	0	0	2	0	0
8	51724748	.	G	T	0	1	1	0	3	5	1	0
8	51724928	.	G	T	1	2	3	0	0	3	0	0
8	51725237	.	C	G	4	3	7	0	0	7	0	0
8	51725241	.	G	T	4	4	8	0	0	8	0	0
8	51726166	.	C	T	4	4	8	0	1	9	0	0
8	51726260	.	C	G	2	4	6	0	0	6	0	0
8	52108329	.	T	C	3	3	6	0	5	11	0	0
8	52109451	.	T	C	1	2	3	0	0	3	0	0
8	52109459	.	T	C	3	2	5	0	0	5	0	0
8	52229606	.	G	A	1	3	4	0	0	4	0	0
8	52292515	.	T	C	0	3	3	0	0	3	0	0
8	52336870	.	T	C	0	2	2	0	0	2	0	0
8	52342586	.	A	C	4	3	7	0	1	8	0	0
8	52345733	.	T	C	2	4	6	0	0	6	0	0
8	52345751	.	T	C	6	8	14	0	0	14	0	0
8	52345915	.	T	C	6	9	15	0	1	16	0	0
8	52346035	.	T	C	2	4	6	0	1	7	0	0
8	52346072	.	A	T	2	2	4	0	0	4	0	0
8	52346111	.	A	C	1	2	3	0	0	3	0	0
8	52347460	.	C	T	6	7	13	0	1	14	0	0
8	52348102	.	A	G	10	4	14	0	0	14	0	0
8	52348685	.	T	C	6	5	11	0	2	13	0	0
8	52349080	.	T	G	6	7	13	0	1	14	0	0
8	52350101	.	A	G	9	0	9	0	9	23	5	0
8	52350146	.	A	G	15	0	15	0	15	30	0	0
8	52350251	.	A	G	5	13	18	0	1	19	0	0
8	52350322	.	T	G	5	4	9	0	1	10	0	0
8	52408619	.	G	A	30	18	48	0	3	52	1	0
8	52411451	.	T	C	6	3	9	0	0	9	0	0
8	52412982	.	A	G	14	11	25	0	1	26	0	0
8	52412985	.	C	G	15	11	26	0	0	26	0	0
8	52453432	.	A	C	2	5	7	0	0	7	0	0
8	52455588	.	A	G	0	3	3	0	0	3	0	0
8	52455610	.	A	G	1	6	7	0	0	7	0	0
8	52455638	.	C	G	1	6	7	0	0	7	0	0
8	52472930	.	C	G	4	2	6	0	1	7	0	0
8	52472955	.	C	T	0	3	3	0	5	8	0	0
8	52491586	.	G	A	6	5	11	0	0	11	0	0
8	52509624	.	G	A	3	3	6	0	1	7	0	0
8	52509762	.	A	T	3	8	11	0	0	11	0	0
8	52510020	.	G	T	1	4	5	0	0	5	0	0
8	52510088	.	C	T	3	2	5	0	0	5	0	0
8	52510222	.	C	T	3	2	5	0	1	6	0	0
8	52521261	.	T	C	3	2	5	0	1	6	0	0
8	52521648	.	T	C	7	7	14	0	0	14	0	0
8	52521802	.	A	T	3	5	8	0	0	8	0	0
8	52521832	.	T	G	4	0	4	0	3	7	0	0
8	52524436	.	A	T	1	0	1	0	0	1	0	0
8	52527359	.	C	G	3	3	6	0	0	6	0	0
8	52527391	.	A	T	2	5	7	0	0	7	0	0
8	52527452	.	T	C	0	3	3	0	0	3	0	0
8	52527547	.	A	C	3	7	10	0	0	10	0	0
8	52528602	.	A	G	3	7	10	0	0	10	0	0
8	52528607	.	A	G	2	0	2	0	9	11	0	0
8	52528665	.	A	G	9	6	15	0	0	15	0	0
8	52528717	.	A	G	5	11	16	0	1	17	0	0
8	52528856	.	C	G	5	3	8	0	0	8	0	0
8	52528964	.	T	A	1	2	3	0	0	3	0	0
8	52529169	.	A	G	6	6	12	0	0	12	0	0
8	52529206	.	T	C	6	6	12	0	1	13	0	0
8	52529397	.	A	G	7	6	13	0	1	14	0	0
8	52533968	.	C	G	0	1	1	0	0	1	0	0
8	52537984	.	A	G	8	0	8	0	7	15	0	0
8	52538042	.	A	T	2	2	4	0	0	4	0	0
8	52543717	.	C	A	1	2	3	0	0	3	0	0
8	52547038	.	T	G	8	7	15	0	1	16	0	0
8	52547091	.	T	C	3	7	10	0	1	11	0	0
8	52547356	.	A	G	11	6	17	0	1	18	0	0
8	52547522	.	C	T	2	6	8	0	0	8	0	0
8	52547523	.	G	A	0	3	3	0	5	8	0	0
8	52547569	.	T	A	5	6	11	0	0	11	0	0
8	52547664	.	A	C	0	2	2	0	2	4	0	0
8	52547677	.	C	T	0	4	4	0	0	4	0	0
8	52547727	.	G	C	1	3	4	0	1	5	0	0
8	52547787	.	T	A	3	0	3	0	0	3	0	0
8	52547829	.	T	G	2	4	6	0	0	6	0	0
8	52547902	.	T	A	1	3	4	0	0	4	0	0
8	52550373	.	T	C	5	0	5	0	5	10	0	0
8	52550462	.	A	G	6	5	11	0	0	11	0	0
8	52550502	.	T	A	4	6	10	0	0	10	0	0
8	52553193	.	A	T	6	2	8	0	1	9	0	0
8	52553197	.	A	G	6	3	9	0	0	9	0	0
8	52554679	.	T	C	2	0	2	0	2	4	0	0
8	52554906	.	C	T	4	4	8	0	0	8	0	0
8	52554937	.	T	G	3	5	8	0	0	8	0	0
8	52554983	.	C	T	7	4	11	0	1	12	0	0
8	52555018	.	T	G	7	8	15	0	1	16	0	0
8	52555050	.	G	A	5	7	12	0	1	13	0	0
8	52555077	.	C	G	3	12	15	0	1	16	0	0
8	52555112	.	G	T	8	9	17	0	0	17	0	0
8	52555137	.	G	A	9	9	18	0	0	18	0	0
8	52557454	.	G	T	2	2	4	0	1	5	0	0
8	52562746	.	C	T	2	2	4	0	1	5	0	0
8	52564816	.	T	C	1	2	3	0	1	4	0	0
8	52565319	.	T	C	1	3	4	0	0	4	0	0
8	52580094	.	A	G	0	1	1	0	0	1	0	0
8	52580169	.	A	G	4	3	7	0	0	7	0	0
8	52580196	.	A	T	2	2	4	0	0	4	0	0
8	52588519	.	G	A	3	2	5	0	0	5	0	0
8	52824680	.	T	C	0	1	1	0	0	1	0	0
8	53067433	.	C	T	0	1	1	0	0	1	0	0
8	53082186	.	G	C	1	2	3	0	0	3	0	0
8	53087090	.	C	T	1	4	5	0	0	5	0	0
8	53095146	.	G	A	5	9	14	0	0	14	0	0
8	53095179	.	A	G	0	3	3	0	1	4	0	0
8	53148976	.	T	C	3	5	8	0	1	9	0	0
8	53148977	.	T	C	5	4	9	0	0	9	0	0
8	53150355	.	T	C	5	2	7	0	0	7	0	0
8	53150356	.	T	C	5	2	7	0	0	7	0	0
8	53150630	.	T	C	6	4	10	0	0	10	0	0
8	53152039	.	C	G	1	5	6	0	0	6	0	0
8	53398532	.	A	G	6	3	9	0	0	9	0	0
8	53398564	.	A	G	6	3	9	0	1	10	0	0
8	53398671	.	A	G	1	8	9	0	0	9	0	0
8	53399003	.	A	G	6	3	9	0	0	9	0	0
8	53752762	.	C	T	0	0	0	0	3	3	0	0
8	53767767	.	G	A	1	0	1	0	0	1	0	0
8	53794163	.	T	A	7	8	15	0	0	15	0	0
8	53794250	.	T	C	6	6	12	0	0	12	0	0
8	53794943	.	T	G	7	9	16	0	1	17	0	0
8	53795162	.	A	G	8	4	12	0	0	13	1	0
8	53795249	.	G	A	6	4	10	0	0	10	0	0
8	53795411	.	T	C	3	7	10	0	0	10	0	0
8	53795602	.	T	A	8	6	14	0	0	14	0	0
8	53795636	.	A	T	7	5	12	0	0	12	0	0
8	53795640	.	A	G	7	6	13	0	0	13	0	0
8	53795684	.	T	C	2	0	2	0	8	10	0	0
8	53795692	.	G	A	2	5	7	0	2	9	0	0
8	53795892	.	G	T	7	12	19	0	0	19	0	0
8	53796657	.	C	T	4	2	6	0	0	6	0	0
8	53796833	.	T	C	2	4	6	0	0	6	0	0
8	53797040	.	A	G	4	4	8	0	0	8	0	0
8	53797118	.	G	T	6	6	12	0	0	12	0	0
8	53797265	.	C	T	4	3	7	0	1	8	0	0
8	53797451	.	C	T	0	6	6	0	2	8	0	0
8	53797741	.	T	G	6	5	11	0	0	11	0	0
8	53797802	.	A	C	4	8	12	0	0	12	0	0
8	53798130	.	A	G	1	4	5	0	0	5	0	0
8	53798168	.	A	G	1	6	7	0	0	7	0	0
8	53798321	.	T	A	1	2	3	0	1	4	0	0
8	53798450	.	T	G	6	6	12	0	0	13	1	0
8	53798864	.	A	G	7	5	12	0	2	14	0	0
8	53798981	.	C	T	0	3	3	0	3	6	0	0
8	53799491	.	T	A	3	3	6	0	0	6	0	0
8	53799521	.	G	A	3	3	6	0	1	7	0	0
8	53800064	.	A	G	4	3	7	0	1	8	0	0
8	53803121	.	G	T	1	3	4	0	0	4	0	0
8	53803139	.	A	T	1	3	4	0	0	4	0	0
8	53803376	.	T	C	7	9	16	0	2	18	0	0
8	53867228	.	A	G	3	2	5	0	0	5	0	0
8	53918323	.	A	T	6	4	10	0	0	10	0	0
8	53918472	.	T	C	5	13	18	0	1	19	0	0
8	53918600	.	T	A	3	6	9	0	0	9	0	0
8	53918664	.	C	T	7	7	14	0	1	15	0	0
8	53918790	.	G	T	8	6	14	0	0	14	0	0
8	53919124	.	C	A	11	5	16	0	0	16	0	0
8	53921797	.	A	G	3	13	16	0	1	17	0	0
8	53921815	.	A	G	4	15	19	0	0	19	0	0
8	53922034	.	A	G	4	7	11	0	0	11	0	0
8	53940977	.	T	C	1	1	2	0	0	2	0	0
8	53942440	.	T	C	0	2	2	0	0	2	0	0
8	53948426	.	C	T	9	2	11	0	1	12	0	0
8	53948434	.	G	A	6	3	9	0	2	11	0	0
8	53948501	.	T	C	5	11	16	0	0	16	0	0
8	53948781	.	T	C	8	7	15	0	1	16	0	0
8	53949706	.	G	A	3	4	7	0	0	7	0	0
8	53950181	.	T	C	6	1	7	0	8	15	0	0
8	53953420	.	C	G	8	7	15	0	0	15	0	0
8	53956476	.	T	G	9	7	16	0	0	16	0	0
8	53956530	.	T	G	1	0	1	0	1	2	0	0
8	53959378	.	T	C	7	3	10	0	2	12	0	0
8	54013347	.	A	T	8	4	12	0	2	14	0	0
8	54013594	.	G	T	4	4	8	0	1	9	0	0
8	54128964	.	A	G	2	0	2	0	4	6	0	0
8	54129735	.	G	A	0	9	9	0	17	26	0	0
8	54129767	.	G	A	14	10	24	0	3	27	0	0
8	54129774	.	T	C	16	10	26	0	0	26	0	0
8	54129867	.	A	C	9	10	19	0	1	20	0	0
8	54130103	.	T	G	4	3	7	0	0	7	0	0
8	54130203	.	T	G	9	7	16	0	1	17	0	0
8	54131889	.	T	G	5	4	9	0	2	11	0	0
8	54132024	.	C	G	3	10	13	0	1	14	0	0
8	54132044	.	C	T	4	11	15	0	1	16	0	0
8	54132084	.	C	G	4	7	11	0	1	12	0	0
8	54132248	.	T	A	4	2	6	0	0	6	0	0
8	54132477	.	G	T	2	2	4	0	0	4	0	0
8	54133376	.	A	G	16	10	26	0	1	27	0	0
8	54133403	.	A	T	14	7	21	0	1	22	0	0
8	54133450	.	G	A	16	11	27	0	0	27	0	0
8	54133522	.	G	A	6	11	17	0	0	17	0	0
8	54137658	.	T	C	3	3	6	0	0	6	0	0
8	54137805	.	T	G	6	7	13	0	0	13	0	0
8	54142752	.	C	T	2	2	4	0	0	4	0	0
8	54142959	.	A	G	1	4	5	0	1	6	0	0
8	54145198	.	A	G	2	0	2	0	0	2	0	0
8	54155012	.	C	A	10	6	16	0	1	17	0	0
8	54202655	.	C	T	1	2	3	0	0	3	0	0
8	54203198	.	A	G	0	2	2	0	0	2	0	0
8	54208282	.	C	T	3	1	4	0	0	4	0	0
8	54208572	.	C	T	5	3	8	0	0	8	0	0
8	54210066	.	G	A	1	2	3	0	0	3	0	0
8	54210081	.	C	T	8	4	12	0	0	12	0	0
8	54211989	.	G	A	3	3	6	0	0	6	0	0
8	54211991	.	G	A	2	3	5	0	1	6	0	0
8	54220876	.	T	A	21	10	31	0	1	32	0	0
8	54221065	.	A	T	20	20	40	0	1	42	1	0
8	54221067	.	T	C	23	16	39	0	3	42	0	0
8	54221243	.	T	C	17	0	17	0	22	39	0	0
8	54221390	.	T	C	23	11	34	0	3	37	0	0
8	54221573	.	T	C	24	2	26	0	18	44	0	0
8	54221812	.	G	C	25	18	43	0	1	44	0	0
8	54221927	.	C	T	24	21	45	0	1	46	0	0
8	54221966	.	G	A	28	17	45	0	1	46	0	0
9	83785	.	T	C	1	3	4	0	0	4	0	0
9	462959	.	T	G	12	2	14	0	2	17	1	0
9	531700	.	A	G	4	2	6	0	1	7	0	0
9	963851	.	C	G	1	3	4	0	0	4	0	0
9	1372996	.	A	G	3	6	9	0	0	9	0	0
9	1373416	.	G	T	11	4	15	0	1	16	0	0
9	2483623	.	A	G	2	11	13	0	0	13	0	0
9	2564111	.	G	A	10	8	18	0	1	19	0	0
9	2564178	.	C	A	18	13	31	0	2	33	0	0
9	2564656	.	G	T	3	2	5	0	1	6	0	0
9	2564699	.	A	G	11	11	22	0	0	22	0	0
9	2564790	.	A	T	1	2	3	0	0	3	0	0
9	2567323	.	G	A	7	7	14	0	0	14	0	0
9	2568670	.	T	A	8	13	21	0	4	25	0	0
9	2568768	.	G	T	10	8	18	0	0	18	0	0
9	2572316	.	G	A	12	4	16	0	0	16	0	0
9	2572756	.	A	T	2	2	4	0	1	5	0	0
9	2574225	.	T	C	7	5	12	0	0	12	0	0
9	2574227	.	A	G	7	5	12	0	0	12	0	0
9	2579867	.	C	T	1	1	2	0	0	2	0	0
9	2582003	.	G	A	1	1	2	0	0	2	0	0
9	2586206	.	A	G	9	0	9	0	12	21	0	0
9	2586259	.	A	G	6	8	14	0	1	15	0	0
9	2592518	.	A	T	10	7	17	0	1	18	0	0
9	2592519	.	T	A	8	9	17	0	1	18	0	0
9	2592675	.	G	A	10	15	25	0	1	26	0	0
9	2592960	.	A	G	7	4	11	0	0	11	0	0
9	2593059	.	C	T	0	6	6	0	8	14	0	0
9	2593518	.	G	A	2	3	5	0	0	5	0	0
9	2593533	.	G	A	3	2	5	0	0	5	0	0
9	2896708	.	C	T	4	2	6	0	2	8	0	0
9	2896749	.	G	A	1	3	4	0	1	5	0	0
9	2897200	.	A	T	1	2	3	0	0	3	0	0
9	2949291	.	C	A	0	4	4	0	2	6	0	0
9	3135171	.	T	C	7	0	7	0	4	11	0	0
9	3135794	.	A	G	2	0	2	0	1	3	0	0
9	3135809	.	A	G	4	4	8	0	0	8	0	0
9	3136107	.	C	T	0	4	4	0	1	5	0	0
9	3149541	.	T	C	8	6	14	0	1	15	0	0
9	3149661	.	C	T	10	4	14	0	0	14	0	0
9	3228214	.	C	T	1	0	1	0	0	1	0	0
9	3231242	.	C	T	2	4	6	0	0	6	0	0
9	3231378	.	C	A	0	10	10	0	0	10	0	0
9	3231396	.	C	G	5	5	10	0	1	11	0	0
9	3231675	.	C	T	1	5	6	0	0	6	0	0
9	3231746	.	C	A	2	2	4	0	0	4	0	0
9	3231778	.	G	T	0	4	4	0	2	6	0	0
9	3231795	.	T	C	2	4	6	0	0	6	0	0
9	3232180	.	T	A	4	3	7	0	0	7	0	0
9	3232198	.	C	T	8	3	11	0	0	11	0	0
9	3232523	.	T	G	8	6	14	0	0	14	0	0
9	3232607	.	T	A	4	6	10	0	0	10	0	0
9	3232763	.	T	C	8	3	11	0	0	11	0	0
9	3232808	.	A	T	4	4	8	0	0	8	0	0
9	3232818	.	T	G	2	0	2	0	3	5	0	0
9	3232949	.	A	G	2	3	5	0	0	5	0	0
9	3286386	.	G	A	2	3	5	0	0	5	0	0
9	3313920	.	G	T	12	14	26	0	1	27	0	0
9	3388974	.	C	T	2	4	6	0	0	6	0	0
9	3389545	.	G	A	0	1	1	0	1	2	0	0
9	3389921	.	A	G	11	0	11	0	10	21	0	0
9	3390035	.	G	A	11	10	21	0	2	24	1	0
9	3397526	.	G	A	2	3	5	0	0	5	0	0
9	3397558	.	G	A	4	6	10	0	0	10	0	0
9	3397648	.	A	C	3	8	11	0	0	11	0	0
9	3398243	.	T	A	2	4	6	0	4	10	0	0
9	3398247	.	G	A	6	5	11	0	0	11	0	0
9	3398328	.	C	A	0	4	4	0	10	14	0	0
9	3398354	.	T	C	9	0	9	0	6	15	0	0
9	3448810	.	G	C	2	2	4	0	0	4	0	0
9	3457410	.	G	A	0	3	3	0	2	5	0	0
9	3463198	.	T	C	1	1	2	0	0	2	0	0
9	3463212	.	G	A	0	1	1	0	1	2	0	0
9	3465279	.	G	A	0	0	0	0	2	2	0	0
9	3465285	.	T	C	0	2	2	0	0	2	0	0
9	3471076	.	C	T	2	2	4	0	0	4	0	0
9	3471077	.	A	G	2	2	4	0	0	4	0	0
9	3473361	.	T	A	0	1	1	0	0	1	0	0
9	3477113	.	T	G	1	1	2	0	0	2	0	0
9	3480057	.	A	G	1	3	4	0	0	4	0	0
9	3480076	.	C	T	1	1	2	0	0	2	0	0
9	3483164	.	T	C	2	6	8	0	1	9	0	0
9	3485822	.	G	A	0	6	6	0	8	14	0	0
9	3485867	.	A	T	3	3	6	0	0	6	0	0
9	3485868	.	T	C	3	3	6	0	0	6	0	0
9	3486134	.	T	G	3	3	6	0	0	6	0	0
9	3486220	.	C	T	4	3	7	0	0	7	0	0
9	3486223	.	C	T	4	3	7	0	0	7	0	0
9	3490869	.	C	A	2	2	4	0	0	4	0	0
9	3524431	.	G	C	2	2	4	0	0	4	0	0
9	3534748	.	G	A	0	1	1	0	0	1	0	0
9	3605652	.	C	T	8	6	14	0	0	14	0	0
9	3605682	.	A	G	9	0	9	0	6	15	0	0
9	3608867	.	T	A	10	12	22	0	2	24	0	0
9	3621980	.	T	C	9	9	18	0	0	18	0	0
9	3627189	.	T	C	2	1	3	0	0	3	0	0
9	3630017	.	T	C	1	0	1	0	0	1	0	0
9	3646864	.	A	G	10	7	17	0	0	17	0	0
9	3666458	.	G	A	3	2	5	0	0	5	0	0
9	3666469	.	C	T	5	2	7	0	0	7	0	0
9	3666494	.	C	T	11	5	16	0	1	17	0	0
9	3666511	.	A	G	11	8	19	0	1	20	0	0
9	3666541	.	A	C	12	10	22	0	0	22	0	0
9	3666601	.	A	T	8	4	12	0	1	13	0	0
9	3666666	.	T	C	10	5	15	0	4	19	0	0
9	3666947	.	G	A	5	3	8	0	2	10	0	0
9	3666948	.	T	C	3	0	3	0	7	10	0	0
9	3667136	.	G	A	4	7	11	0	0	11	0	0
9	3667338	.	T	A	9	6	15	0	1	16	0	0
9	3667377	.	C	A	8	7	15	0	0	15	0	0
9	3667398	.	C	A	8	5	13	0	0	13	0	0
9	3667459	.	C	T	5	3	8	0	0	8	0	0
9	3668198	.	A	C	7	1	8	0	0	8	0	0
9	3668199	.	G	C	5	1	6	0	2	8	0	0
9	3898275	.	T	C	3	5	8	0	0	8	0	0
9	3898276	.	T	C	3	0	3	0	5	8	0	0
9	3900878	.	T	A	4	4	8	0	2	10	0	0
9	3901007	.	A	T	5	5	10	0	0	10	0	0
9	3901081	.	C	T	3	2	5	0	0	5	0	0
9	3901118	.	A	C	5	4	9	0	0	9	0	0
9	3901187	.	T	A	6	3	9	0	0	9	0	0
9	3907834	.	C	G	1	1	2	0	0	2	0	0
9	3927929	.	G	A	0	1	1	0	0	1	0	0
9	3932238	.	T	G	2	6	8	0	0	8	0	0
9	4254304	.	T	C	2	0	2	0	0	2	0	0
9	4266854	.	C	G	1	6	7	0	0	7	0	0
9	4267062	.	T	C	3	2	5	0	0	5	0	0
9	4267072	.	T	C	4	4	8	0	1	9	0	0
9	4267101	.	C	G	2	4	6	0	1	7	0	0
9	4282581	.	G	A	0	1	1	0	0	1	0	0
9	4310069	.	C	T	1	2	3	0	0	3	0	0
9	4310096	.	G	A	1	3	4	0	0	4	0	0
9	4323147	.	C	T	2	5	7	0	0	7	0	0
9	4323249	.	C	T	3	2	5	0	0	5	0	0
9	4332223	.	C	T	2	1	3	0	0	3	0	0
9	4336543	.	A	G	5	4	9	0	1	10	0	0
9	4336585	.	T	C	1	3	4	0	0	4	0	0
9	5041842	.	A	T	4	4	8	0	2	10	0	0
9	5042724	.	G	T	2	6	8	0	0	8	0	0
9	5042772	.	C	T	3	4	7	0	1	8	0	0
9	5345827	.	C	T	0	2	2	0	2	4	0	0
9	7092457	.	T	C	12	5	17	0	0	17	0	0
9	7094898	.	T	C	14	9	23	0	0	23	0	0
9	7228348	.	C	A	18	12	30	0	0	30	0	0
9	7228487	.	C	A	8	8	16	0	0	16	0	0
9	7228544	.	C	T	5	4	9	0	1	10	0	0
9	7228753	.	T	G	4	9	13	0	0	13	0	0
9	7228805	.	T	A	10	2	12	0	0	12	0	0
9	7229069	.	G	A	9	9	18	1	0	19	0	0
9	7229210	.	C	T	18	20	38	0	3	41	0	0
9	7229218	.	G	A	20	22	42	0	0	42	0	0
9	7229248	.	G	A	19	18	37	0	1	38	0	0
9	7229262	.	C	G	21	21	42	0	0	42	0	0
9	7229512	.	C	T	15	16	31	0	0	31	0	0
9	7234618	.	A	C	5	0	5	0	15	20	0	0
9	7234642	.	G	A	8	17	25	0	1	26	0	0
9	7238498	.	C	T	12	12	24	0	1	25	0	0
9	7238502	.	C	A	12	12	24	0	0	24	0	0
9	7241118	.	G	A	2	4	6	0	0	6	0	0
9	7241409	.	G	T	4	4	8	0	0	8	0	0
9	7241494	.	T	C	0	1	1	0	0	1	0	0
9	7241809	.	C	T	0	3	3	0	2	5	0	0
9	7242534	.	C	A	1	2	3	0	0	3	0	0
9	7244743	.	T	C	1	2	3	0	1	4	0	0
9	7244962	.	T	C	1	0	1	0	2	3	0	0
9	7245004	.	C	T	7	1	8	0	0	8	0	0
9	7245218	.	C	T	2	3	5	0	0	5	0	0
9	7245226	.	A	G	3	2	5	0	0	5	0	0
9	7245307	.	A	T	2	4	6	0	0	6	0	0
9	7245327	.	C	T	2	3	5	0	1	6	0	0
9	7245445	.	C	A	0	3	3	0	0	3	0	0
9	7245472	.	A	G	0	2	2	0	0	2	0	0
9	7245483	.	C	T	0	2	2	0	0	2	0	0
9	7245868	.	C	T	0	4	4	0	3	7	0	0
9	7249016	.	C	T	2	2	4	0	0	4	0	0
9	7249063	.	G	C	1	6	7	0	0	7	0	0
9	7249079	.	C	T	0	8	8	0	1	9	0	0
9	7249241	.	T	G	6	6	12	0	0	12	0	0
9	7249401	.	A	G	1	5	6	0	0	6	0	0
9	7253052	.	T	C	1	1	2	0	1	3	0	0
9	7253307	.	G	A	1	2	3	0	0	3	0	0
9	7253515	.	A	G	2	2	4	0	0	4	0	0
9	7287131	.	T	A	0	2	2	0	0	2	0	0
9	7410825	.	G	A	3	2	5	0	0	5	0	0
9	7410831	.	G	T	2	3	5	0	0	5	0	0
9	7410995	.	G	A	2	1	3	0	0	4	1	0
9	7433080	.	A	T	2	1	3	0	0	3	0	0
9	7488486	.	C	T	2	2	4	0	0	4	0	0
9	7488576	.	T	C	1	3	4	0	0	4	0	0
9	7499322	.	G	A	0	4	4	0	3	7	0	0
9	7516095	.	G	T	3	2	5	0	0	5	0	0
9	7548591	.	A	G	2	10	12	0	0	12	0	0
9	7548600	.	T	A	4	13	17	0	1	18	0	0
9	7570857	.	A	G	10	1	11	0	28	39	0	0
9	7570891	.	T	A	14	17	31	0	1	32	0	0
9	7574042	.	T	A	7	5	12	0	2	14	0	0
9	7574126	.	C	T	4	3	7	0	1	8	0	0
9	7574135	.	A	T	1	1	2	0	0	2	0	0
9	7575309	.	G	A	4	6	10	0	0	10	0	0
9	7575545	.	A	C	1	1	2	0	1	3	0	0
9	7578595	.	G	C	4	3	7	0	1	8	0	0
9	7604524	.	G	A	8	8	16	0	5	21	0	0
9	7618903	.	A	C	11	8	19	0	0	19	0	0
9	7618906	.	T	C	11	10	21	0	0	21	0	0
9	7621780	.	T	A	2	2	4	0	0	4	0	0
9	7635730	.	C	T	0	2	2	0	1	3	0	0
9	7635925	.	G	A	5	7	12	0	0	12	0	0
9	7655123	.	T	C	1	0	1	0	2	3	0	0
9	7655124	.	T	G	1	2	3	0	0	3	0	0
9	7671165	.	G	A	10	8	18	0	1	19	0	0
9	7678848	.	A	G	0	9	9	1	0	10	0	0
9	8114242	.	T	C	1	3	4	0	0	4	0	0
9	8120971	.	C	T	1	2	3	0	1	4	0	0
9	8121041	.	C	T	7	6	13	0	0	13	0	0
9	8121128	.	C	T	5	8	13	0	1	14	0	0
9	8121855	.	G	T	10	5	15	0	1	16	0	0
9	8121939	.	G	T	4	11	15	0	0	15	0	0
9	8122095	.	A	T	10	11	21	0	0	21	0	0
9	8429331	.	A	G	3	7	10	0	1	11	0	0
9	8429899	.	A	G	12	14	26	0	7	33	0	0
9	8430558	.	A	C	11	4	15	0	0	15	0	0
9	8430739	.	T	C	1	5	6	0	0	6	0	0
9	8430787	.	A	G	3	8	11	0	0	11	0	0
9	8430831	.	C	T	0	10	10	0	6	16	0	0
9	8431031	.	A	G	20	9	29	0	0	29	0	0
9	8431214	.	C	T	0	11	11	0	11	22	0	0
9	8431256	.	G	A	14	11	25	0	1	26	0	0
9	8431345	.	A	C	9	0	9	0	12	21	0	0
9	8431450	.	A	G	12	6	18	0	1	19	0	0
9	8431541	.	A	T	13	10	23	0	1	24	0	0
9	8431714	.	G	T	7	5	12	0	0	12	0	0
9	8431772	.	C	T	15	6	21	0	0	21	0	0
9	8431814	.	A	G	9	11	20	0	0	20	0	0
9	8431837	.	T	C	9	10	19	0	0	19	0	0
9	8431854	.	T	C	6	9	15	0	0	15	0	0
9	8431894	.	A	G	3	5	8	0	0	8	0	0
9	8432695	.	C	T	10	10	20	0	0	20	0	0
9	8432768	.	A	T	16	10	26	0	1	27	0	0
9	8432802	.	T	C	15	0	15	0	8	23	0	0
9	8432996	.	G	A	17	10	27	0	0	27	0	0
9	8433189	.	C	T	14	8	22	0	1	23	0	0
9	8450740	.	G	A	5	11	16	0	0	16	0	0
9	8450788	.	G	A	5	8	13	0	0	13	0	0
9	8451386	.	C	T	0	4	4	0	7	11	0	0
9	8451540	.	C	T	9	4	13	0	2	15	0	0
9	8452339	.	C	T	6	4	10	0	0	10	0	0
9	8452627	.	G	A	4	5	9	0	0	9	0	0
9	8452695	.	C	T	4	2	6	0	2	8	0	0
9	8452705	.	G	A	4	4	8	0	0	8	0	0
9	8453035	.	G	A	2	4	6	0	0	6	0	0
9	8898196	.	G	A	0	3	3	0	3	6	0	0
9	8898403	.	T	C	2	2	4	0	2	6	0	0
9	8898903	.	C	A	2	4	6	0	0	6	0	0
9	8899665	.	C	T	7	6	13	0	1	14	0	0
9	8899704	.	C	T	9	6	15	0	0	15	0	0
9	8914657	.	G	C	2	1	3	0	0	3	0	0
9	8923188	.	A	T	9	5	14	0	1	15	0	0
9	8929848	.	G	T	3	9	12	0	0	12	0	0
9	8929905	.	G	A	0	3	3	0	6	9	0	0
9	8967442	.	G	A	10	8	18	0	1	19	0	0
9	8967459	.	C	T	12	11	23	0	0	23	0	0
9	8971713	.	G	A	15	17	32	0	1	33	0	0
9	8971984	.	T	G	10	2	12	0	10	22	0	0
9	8971995	.	A	C	8	9	17	0	2	19	0	0
9	8972429	.	T	A	12	20	32	0	0	32	0	0
9	8973080	.	G	A	2	2	4	0	0	4	0	0
9	8973093	.	C	T	3	2	5	0	0	5	0	0
9	8973379	.	T	G	8	3	11	0	0	11	0	0
9	8973581	.	G	A	2	2	4	0	0	4	0	0
9	8973627	.	C	A	2	5	7	0	0	7	0	0
9	8973629	.	G	A	2	5	7	0	0	7	0	0
9	8974152	.	G	A	6	4	10	0	0	10	0	0
9	9113008	.	A	G	3	5	8	0	0	8	0	0
9	9116101	.	C	T	2	0	2	0	0	2	0	0
9	9116890	.	C	T	4	5	9	0	0	9	0	0
9	9118363	.	A	C	3	7	10	0	0	10	0	0
9	9118602	.	G	A	3	4	7	0	0	7	0	0
9	9118695	.	C	T	2	1	3	0	0	3	0	0
9	9118991	.	C	T	11	12	23	0	1	24	0	0
9	9118994	.	C	T	11	11	22	0	1	23	0	0
9	9119671	.	G	C	5	5	10	0	0	10	0	0
9	9119755	.	G	T	8	6	14	0	0	14	0	0
9	9119771	.	T	A	7	7	14	0	0	14	0	0
9	9119830	.	A	T	5	4	9	0	0	9	0	0
9	9119877	.	G	A	4	4	8	0	0	8	0	0
9	9119937	.	G	A	3	5	8	0	0	8	0	0
9	9119987	.	T	C	1	5	6	0	0	6	0	0
9	9120271	.	T	C	10	4	14	0	2	16	0	0
9	9120517	.	A	T	9	3	12	0	0	12	0	0
9	9120847	.	G	A	6	6	12	0	2	14	0	0
9	9121242	.	T	C	4	10	14	0	0	14	0	0
9	9121382	.	G	A	4	11	15	0	0	15	0	0
9	9183874	.	C	T	13	6	19	0	1	20	0	0
9	9183969	.	T	A	19	14	33	0	1	34	0	0
9	9184092	.	G	A	17	17	34	0	1	35	0	0
9	9184177	.	G	A	20	18	38	0	2	40	0	0
9	9184397	.	G	A	8	24	32	0	0	32	0	0
9	9184536	.	T	C	14	14	28	0	1	29	0	0
9	9184566	.	G	A	15	10	25	0	3	28	0	0
9	9184593	.	T	C	8	14	22	0	2	24	0	0
9	9193044	.	A	C	1	3	4	0	0	4	0	0
9	9195964	.	C	T	7	7	14	0	0	14	0	0
9	9198139	.	A	G	1	1	2	0	0	2	0	0
9	9198202	.	A	C	9	15	24	0	0	24	0	0
9	9198208	.	G	A	8	13	21	0	1	22	0	0
9	9206612	.	C	G	2	7	9	0	0	9	0	0
9	9208714	.	C	A	3	5	8	0	0	8	0	0
9	9208759	.	A	T	11	5	16	0	0	16	0	0
9	9225717	.	C	T	7	9	16	0	0	16	0	0
9	9238577	.	G	A	7	3	10	0	1	11	0	0
9	9238583	.	G	A	8	3	11	0	0	11	0	0
9	9322733	.	G	A	8	3	11	0	1	12	0	0
9	9322782	.	C	G	0	3	3	0	4	7	0	0
9	9322795	.	A	G	3	3	6	0	0	6	0	0
9	9327588	.	G	A	3	4	7	0	0	7	0	0
9	9327705	.	C	T	4	3	7	0	2	9	0	0
9	9342835	.	T	A	6	7	13	0	2	15	0	0
9	9342892	.	C	T	5	8	13	0	0	13	0	0
9	9342994	.	A	G	1	1	2	0	0	2	0	0
9	9345134	.	G	A	3	7	10	0	1	11	0	0
9	9345748	.	G	T	0	1	1	0	0	1	0	0
9	9345751	.	C	T	0	1	1	0	0	1	0	0
9	9578598	.	G	T	19	20	39	0	0	39	0	0
9	9578936	.	T	G	13	17	30	0	6	36	0	0
9	9579027	.	C	A	22	22	44	0	1	45	0	0
9	9579033	.	T	C	22	0	22	0	22	44	0	0
9	9579076	.	G	C	15	18	33	0	0	33	0	0
9	9579165	.	C	T	21	14	35	0	1	36	0	0
9	9579297	.	G	C	10	13	23	0	1	24	0	0
9	9580103	.	G	A	15	14	29	0	0	29	0	0
9	9592779	.	C	A	3	5	8	0	0	8	0	0
9	9671134	.	G	T	5	8	13	0	0	13	0	0
9	9671208	.	G	A	11	9	20	0	0	20	0	0
9	9719349	.	G	A	0	2	2	0	1	3	0	0
9	9736317	.	G	T	9	6	15	0	0	15	0	0
9	9736406	.	C	A	10	11	21	0	2	23	0	0
9	9736436	.	G	T	11	6	17	0	1	18	0	0
9	9736493	.	T	C	4	16	20	0	0	20	0	0
9	9736647	.	A	C	3	0	3	0	0	3	0	0
9	9736653	.	C	G	3	0	3	0	1	4	0	0
9	9736684	.	C	T	0	2	2	0	6	8	0	0
9	9736689	.	A	C	6	2	8	0	0	8	0	0
9	9736727	.	A	G	7	3	10	0	0	10	0	0
9	9736815	.	T	A	4	8	12	0	0	12	0	0
9	9736870	.	T	G	4	7	11	0	1	12	0	0
9	9736918	.	G	C	6	8	14	0	0	14	0	0
9	9737060	.	T	G	6	6	12	0	1	13	0	0
9	9737219	.	C	G	6	5	11	0	0	11	0	0
9	9737248	.	G	A	6	2	8	0	1	9	0	0
9	9737432	.	A	T	6	5	11	0	0	11	0	0
9	9737437	.	T	C	5	0	5	0	6	11	0	0
9	9738304	.	C	T	0	4	4	0	7	11	0	0
9	9738325	.	A	T	6	4	10	0	0	10	0	0
9	9738449	.	C	T	1	6	7	0	0	7	0	0
9	9738450	.	T	A	1	6	7	0	0	7	0	0
9	9738629	.	C	T	0	3	3	0	0	3	0	0
9	9738671	.	C	A	4	6	10	0	1	11	0	0
9	9738707	.	G	A	4	9	13	0	0	14	1	0
9	9738739	.	A	G	2	5	7	0	1	8	0	0
9	9738758	.	T	A	2	2	4	0	1	5	0	0
9	9739135	.	T	C	4	3	7	0	0	7	0	0
9	9743579	.	T	A	0	1	1	0	0	1	0	0
9	9937808	.	T	C	1	0	1	0	0	1	0	0
9	9948145	.	C	T	3	2	5	0	0	5	0	0
9	9950070	.	A	T	3	2	5	0	0	5	0	0
9	9953683	.	T	A	1	2	3	0	0	3	0	0
9	10043130	.	T	C	1	1	2	0	0	2	0	0
9	10043201	.	C	G	5	3	8	0	0	8	0	0
9	10043217	.	T	A	4	7	11	0	0	11	0	0
9	10043343	.	C	G	1	1	2	0	5	7	0	0
9	10051935	.	T	A	6	8	14	0	3	17	0	0
9	10138486	.	G	A	9	3	12	0	0	12	0	0
9	10153091	.	C	T	7	4	11	0	0	11	0	0
9	10153342	.	T	A	11	4	15	0	0	15	0	0
9	10153590	.	A	C	8	8	16	0	0	16	0	0
9	10153606	.	A	G	7	8	15	0	1	16	0	0
9	10153689	.	G	C	12	7	19	0	0	19	0	0
9	10153705	.	A	T	6	15	21	0	0	21	0	0
9	10154013	.	G	T	12	9	21	0	0	21	0	0
9	10154014	.	C	T	12	9	21	0	0	21	0	0
9	10154138	.	T	C	8	6	14	0	0	14	0	0
9	10154195	.	A	T	3	5	8	0	0	9	1	0
9	10154344	.	T	A	6	4	10	0	0	10	0	0
9	10154461	.	C	T	4	5	9	0	0	9	0	0
9	10154565	.	G	A	3	3	6	0	0	6	0	0
9	10156145	.	C	A	3	11	14	0	2	16	0	0
9	10157193	.	C	G	4	3	7	0	0	7	0	0
9	10157397	.	G	A	4	3	7	0	0	7	0	0
9	10168945	.	C	T	0	1	1	0	4	5	0	0
9	10175770	.	C	G	0	0	0	0	1	1	0	0
9	10175785	.	A	G	0	3	3	0	0	3	0	0
9	10175812	.	G	A	0	4	4	0	1	5	0	0
9	10183289	.	C	T	0	1	1	0	0	1	0	0
9	10195092	.	C	T	0	1	1	0	0	1	0	0
9	10195488	.	T	A	1	1	2	0	0	2	0	0
9	10199946	.	G	A	1	3	4	0	0	4	0	0
9	10199954	.	G	A	1	3	4	0	0	4	0	0
9	11532306	.	A	G	8	4	12	0	1	13	0	0
9	11532307	.	C	A	9	3	12	0	1	13	0	0
9	11532589	.	T	C	6	7	13	0	2	15	0	0
9	11532775	.	A	G	5	3	8	0	0	8	0	0
9	11532826	.	T	C	7	7	14	0	0	14	0	0
9	11906956	.	A	G	12	13	25	0	1	26	0	0
9	11907424	.	C	T	0	7	7	0	11	18	0	0
9	11907445	.	C	T	9	7	16	0	0	16	0	0
9	11907469	.	T	A	6	8	14	0	2	16	0	0
9	11907497	.	G	A	8	6	14	0	0	14	0	0
9	11907603	.	T	C	8	0	8	0	6	14	0	0
9	11908453	.	T	C	7	5	12	0	0	12	0	0
9	11908548	.	A	C	6	5	11	0	0	11	0	0
9	11908900	.	T	C	6	4	10	0	1	11	0	0
9	11909097	.	C	T	2	5	7	0	1	8	0	0
9	11909176	.	T	A	3	3	6	0	0	6	0	0
9	11909275	.	C	T	1	3	4	0	5	9	0	0
9	11909318	.	A	C	4	3	7	0	0	7	0	0
9	11909575	.	A	G	5	7	12	0	0	12	0	0
9	12268029	.	C	T	3	1	4	0	0	4	0	0
9	12655656	.	A	C	0	4	4	0	0	4	0	0
9	12655704	.	T	C	0	3	3	0	0	3	0	0
9	12664466	.	T	G	0	1	1	0	0	1	0	0
9	12664727	.	G	A	0	4	4	0	1	5	0	0
9	12664760	.	A	G	1	4	5	0	1	6	0	0
9	12667694	.	A	G	3	2	5	0	0	5	0	0
9	12667695	.	A	G	3	2	5	0	0	5	0	0
9	12667758	.	C	T	6	3	9	0	1	10	0	0
9	12671929	.	G	A	4	1	5	0	0	5	0	0
9	12671942	.	A	G	3	2	5	0	1	6	0	0
9	12676846	.	C	T	0	3	3	0	1	4	0	0
9	12682810	.	G	A	1	1	2	0	0	2	0	0
9	12682816	.	G	A	1	1	2	0	0	2	0	0
9	12693123	.	C	T	1	2	3	0	0	3	0	0
9	12864652	.	T	C	0	4	4	0	0	4	0	0
9	12864702	.	T	A	1	2	3	0	0	3	0	0
9	12864711	.	G	A	1	2	3	0	0	3	0	0
9	12865859	.	C	T	1	2	3	0	0	3	0	0
9	12868364	.	G	A	4	4	8	0	0	8	0	0
9	12868386	.	T	C	6	0	6	0	7	13	0	0
9	12868421	.	T	C	2	0	2	0	5	7	0	0
9	12871640	.	G	A	3	2	5	0	1	6	0	0
9	12874167	.	T	C	1	2	3	0	0	3	0	0
9	12874441	.	C	A	2	3	5	0	0	5	0	0
9	12943941	.	G	C	2	2	4	0	0	4	0	0
9	12944058	.	G	A	4	4	8	0	1	9	0	0
9	12944511	.	T	G	2	3	5	0	1	6	0	0
9	12944546	.	G	C	2	3	5	0	0	5	0	0
9	12944994	.	A	G	2	2	4	0	0	4	0	0
9	12945253	.	A	G	2	2	4	0	0	4	0	0
9	12945273	.	G	A	3	2	5	0	0	5	0	0
9	12945298	.	G	C	3	2	5	0	0	5	0	0
9	12945474	.	A	G	2	4	6	0	0	6	0	0
9	12945720	.	T	G	3	2	5	0	0	5	0	0
9	12945764	.	G	A	3	4	7	0	0	7	0	0
9	12946435	.	G	A	1	2	3	0	0	3	0	0
9	12946468	.	T	A	1	3	4	0	2	6	0	0
9	12946914	.	G	A	2	3	5	0	0	5	0	0
9	12947217	.	A	G	4	6	10	0	1	11	0	0
9	12947414	.	G	A	4	3	7	0	0	7	0	0
9	12947529	.	A	G	4	3	7	0	0	7	0	0
9	12947902	.	G	C	0	2	2	0	4	6	0	0
9	12948021	.	G	A	8	5	13	0	1	14	0	0
9	12948133	.	G	A	4	4	8	0	1	9	0	0
9	12948144	.	A	G	4	4	8	0	0	8	0	0
9	12948410	.	G	C	3	4	7	0	1	8	0	0
9	12948656	.	A	G	1	5	6	0	0	6	0	0
9	12948753	.	G	C	4	3	7	0	2	9	0	0
9	12948859	.	A	C	1	2	3	0	3	6	0	0
9	12951293	.	G	A	0	5	5	0	3	8	0	0
9	12953638	.	G	A	1	2	3	0	0	3	0	0
9	12953810	.	T	C	1	2	3	0	0	3	0	0
9	13106452	.	A	C	5	1	6	0	0	6	0	0
9	13106802	.	T	C	6	2	8	0	0	8	0	0
9	13107003	.	T	C	4	2	6	0	0	6	0	0
9	13107399	.	G	T	6	6	12	0	0	12	0	0
9	13107423	.	A	G	6	4	10	0	0	10	0	0
9	13107633	.	A	G	2	4	6	0	0	6	0	0
9	13110916	.	T	A	3	6	9	0	1	10	0	0
9	13111014	.	T	C	4	2	6	0	0	6	0	0
9	13820234	.	C	T	0	5	5	0	6	11	0	0
9	13839737	.	C	T	0	2	2	0	1	3	0	0
9	14023457	.	C	G	7	5	12	0	0	12	0	0
9	14023493	.	T	A	8	3	11	0	2	13	0	0
9	14023856	.	A	G	3	2	5	0	0	5	0	0
9	14027792	.	G	C	0	0	0	0	2	2	0	0
9	14027874	.	T	A	3	11	14	0	0	14	0	0
9	14027889	.	A	G	3	10	13	0	0	13	0	0
9	14028057	.	A	T	7	8	15	0	0	15	0	0
9	14028114	.	T	C	9	8	17	0	0	17	0	0
9	14037508	.	C	G	9	6	15	0	0	15	0	0
9	14037569	.	T	C	6	1	7	0	0	7	0	0
9	14040972	.	T	C	2	3	5	0	0	5	0	0
9	14112784	.	T	A	1	7	8	0	1	9	0	0
9	14136290	.	G	T	1	2	3	0	0	3	0	0
9	14136298	.	T	C	1	0	1	0	3	4	0	0
9	14136362	.	A	T	4	2	6	0	0	6	0	0
9	14136851	.	T	C	4	2	6	0	0	6	0	0
9	14136979	.	C	T	1	2	3	0	0	3	0	0
9	14195210	.	G	A	0	1	1	0	5	6	0	0
9	14195262	.	G	A	0	1	1	0	4	5	0	0
9	14196513	.	G	A	2	2	4	0	0	4	0	0
9	14196563	.	A	G	1	3	4	0	0	4	0	0
9	14196763	.	A	C	4	4	8	0	0	8	0	0
9	14196866	.	G	A	3	2	5	0	0	5	0	0
9	14196978	.	A	T	1	3	4	0	0	4	0	0
9	14197063	.	A	G	3	12	15	0	0	15	0	0
9	14367775	.	C	T	3	3	6	0	0	6	0	0
9	14367837	.	T	G	9	13	22	0	1	23	0	0
9	14367878	.	C	T	9	17	26	0	1	27	0	0
9	14368350	.	T	C	5	6	11	0	0	11	0	0
9	14368378	.	A	T	6	6	12	0	0	12	0	0
9	14368432	.	T	C	4	0	4	0	5	9	0	0
9	14368676	.	A	G	7	5	12	0	0	12	0	0
9	14368788	.	T	C	12	8	20	0	0	20	0	0
9	14368892	.	C	T	8	5	13	0	0	13	0	0
9	14368988	.	G	A	9	9	18	0	0	18	0	0
9	14369084	.	G	A	12	8	20	0	0	20	0	0
9	14369150	.	T	A	5	10	15	0	2	17	0	0
9	14381060	.	G	A	3	2	5	0	0	5	0	0
9	14381116	.	G	A	8	7	15	0	1	16	0	0
9	14381240	.	A	C	3	5	8	0	0	8	0	0
9	14411677	.	C	A	4	4	8	0	0	8	0	0
9	14433931	.	A	T	4	4	8	0	0	8	0	0
9	14442341	.	A	G	2	8	10	0	0	10	0	0
9	14446405	.	A	T	3	3	6	0	0	6	0	0
9	14469989	.	C	T	0	1	1	0	1	2	0	0
9	16247916	.	C	T	3	2	5	0	0	5	0	0
9	19407614	.	G	T	3	2	5	0	0	5	0	0
9	19539800	.	T	C	0	6	6	0	0	6	0	0
9	20174954	.	T	C	3	0	3	0	6	9	0	0
9	21271685	.	A	G	4	2	6	0	0	6	0	0
9	22939435	.	A	G	2	2	4	0	0	4	0	0
9	24189198	.	A	G	3	7	10	0	0	10	0	0
9	24190767	.	A	G	9	0	9	0	15	24	0	0
9	24190792	.	A	G	15	10	25	0	2	27	0	0
9	25837206	.	A	T	3	3	6	0	0	6	0	0
9	25871200	.	T	C	5	1	6	0	0	6	0	0
9	28343681	.	T	G	3	6	9	0	0	9	0	0
9	28343684	.	G	C	3	5	8	0	0	8	0	0
9	29496599	.	G	A	0	1	1	0	0	1	0	0
9	30106131	.	T	G	1	2	3	0	0	3	0	0
9	30780786	.	G	A	0	4	4	0	2	6	0	0
9	30780813	.	A	G	4	5	9	0	0	9	0	0
9	30783376	.	A	T	1	2	3	0	0	3	0	0
9	30783533	.	A	C	2	2	4	0	0	4	0	0
9	30783828	.	A	T	5	2	7	0	0	7	0	0
9	30800990	.	C	T	7	3	10	0	0	10	0	0
9	30806101	.	C	T	0	4	4	0	3	7	0	0
9	30806428	.	G	A	6	4	10	0	0	10	0	0
9	31042584	.	T	C	3	4	7	0	0	7	0	0
9	31062301	.	A	G	5	3	8	0	1	9	0	0
9	31214307	.	T	G	1	4	5	0	0	5	0	0
9	31214442	.	A	C	2	2	4	0	1	5	0	0
9	31248923	.	C	T	5	9	14	0	1	15	0	0
9	31258832	.	G	A	9	4	13	0	0	13	0	0
9	31274993	.	T	C	8	0	8	0	14	22	0	0
9	31276912	.	C	T	15	12	27	0	2	29	0	0
9	31510724	.	T	A	2	2	4	0	0	4	0	0
9	31524405	.	G	A	2	2	4	0	1	5	0	0
9	31524406	.	T	C	3	2	5	0	0	5	0	0
9	31595634	.	C	T	16	10	26	0	0	26	0	0
9	31604943	.	G	A	3	2	5	0	0	5	0	0
9	31605235	.	A	G	0	2	2	0	0	2	0	0
9	31605260	.	T	C	0	0	0	0	2	2	0	0
9	31605281	.	C	A	0	2	2	0	0	2	0	0
9	31606333	.	C	T	5	1	6	0	1	7	0	0
9	31612184	.	C	T	3	0	3	0	0	3	0	0
9	31617687	.	A	G	2	2	4	0	0	4	0	0
9	31619998	.	A	G	6	6	12	0	0	12	0	0
9	31639107	.	C	T	1	6	7	0	7	14	0	0
9	31716932	.	G	A	0	1	1	0	0	1	0	0
9	31735673	.	A	G	3	4	7	0	1	8	0	0
9	31735676	.	A	C	3	5	8	0	0	8	0	0
9	31736102	.	G	A	0	2	2	0	0	2	0	0
9	32909664	.	T	C	3	2	5	0	0	5	0	0
9	33411227	.	C	A	4	0	4	0	0	4	0	0
9	33411228	.	A	G	4	0	4	0	0	4	0	0
9	34112981	.	T	C	1	2	3	0	0	3	0	0
9	34113008	.	A	T	2	4	6	0	0	6	0	0
9	34116933	.	A	G	3	1	4	0	0	4	0	0
9	34117293	.	A	C	8	7	15	0	0	15	0	0
9	34120783	.	C	T	3	2	5	0	0	5	0	0
9	34120863	.	C	A	0	2	2	0	0	2	0	0
9	34154515	.	T	C	1	2	3	0	0	3	0	0
9	34161749	.	G	A	5	2	7	0	0	7	0	0
9	34161833	.	C	T	4	2	6	0	1	7	0	0
9	34162264	.	A	T	1	2	3	0	0	3	0	0
9	34162356	.	A	T	1	2	3	0	0	3	0	0
9	34174561	.	C	T	4	6	10	0	1	11	0	0
9	34174682	.	G	A	6	7	13	0	2	15	0	0
9	34179700	.	G	T	2	2	4	0	0	4	0	0
9	34179782	.	C	T	1	7	8	0	6	14	0	0
9	34189378	.	C	T	7	12	19	0	0	19	0	0
9	34189435	.	C	A	5	7	12	0	1	13	0	0
9	34189571	.	C	A	7	9	16	0	0	16	0	0
9	34191603	.	G	A	3	1	4	0	1	5	0	0
9	34200253	.	T	C	3	5	8	0	1	9	0	0
9	34201249	.	C	T	1	0	1	0	0	1	0	0
9	34204487	.	G	A	1	5	6	0	0	6	0	0
9	34204490	.	A	G	1	5	6	0	0	6	0	0
9	34218953	.	A	G	1	3	4	0	0	4	0	0
9	34225055	.	A	G	4	4	8	0	0	8	0	0
9	34225250	.	T	C	9	14	23	0	0	23	0	0
9	34225316	.	G	C	3	6	9	0	0	9	0	0
9	34226955	.	C	A	21	16	37	0	1	38	0	0
9	34226960	.	A	C	21	15	36	0	1	37	0	0
9	34227195	.	G	T	11	8	19	0	3	22	0	0
9	34227405	.	G	A	1	2	3	0	1	4	0	0
9	34227409	.	G	T	0	2	2	0	2	4	0	0
9	34232672	.	T	C	1	7	8	0	0	8	0	0
9	34232718	.	G	T	0	5	5	0	2	7	0	0
9	34238825	.	T	A	5	5	10	0	0	10	0	0
9	34239119	.	T	C	1	4	5	0	0	5	0	0
9	34239227	.	G	A	0	4	4	0	1	5	0	0
9	34242433	.	T	C	2	0	2	0	0	2	0	0
9	34242935	.	T	G	2	0	2	0	3	5	0	0
9	34242953	.	G	T	3	6	9	0	0	9	0	0
9	34243122	.	G	C	2	4	6	0	0	6	0	0
9	34243310	.	A	G	5	6	11	0	0	11	0	0
9	34243352	.	C	T	4	7	11	0	1	12	0	0
9	34243549	.	A	G	7	0	7	0	4	11	0	0
9	34243681	.	C	T	8	11	19	0	0	19	0	0
9	34243701	.	C	G	8	11	19	0	0	19	0	0
9	34243775	.	T	C	5	2	7	0	0	7	0	0
9	34246564	.	A	G	9	10	19	0	1	20	0	0
9	34246762	.	G	A	8	7	15	0	1	16	0	0
9	34247035	.	A	T	21	0	21	0	2	30	7	0
9	34247042	.	G	A	23	6	29	0	2	31	0	0
9	34247145	.	A	T	18	10	28	0	1	29	0	0
9	34247356	.	G	A	3	3	6	0	0	6	0	0
9	34251632	.	G	A	8	4	12	0	1	13	0	0
9	34251635	.	C	A	1	3	4	0	9	13	0	0
9	34251707	.	C	G	12	5	17	0	1	18	0	0
9	34254325	.	C	T	3	3	6	0	1	7	0	0
9	34254678	.	A	G	3	1	4	0	0	4	0	0
9	34254685	.	G	A	2	1	3	0	0	3	0	0
9	34254851	.	A	G	2	3	5	0	0	5	0	0
9	34254875	.	T	C	2	3	5	0	0	5	0	0
9	34257954	.	T	A	2	1	3	0	0	3	0	0
9	34258565	.	T	G	1	0	1	0	0	1	0	0
9	34258580	.	C	T	0	0	0	0	1	1	0	0
9	34258642	.	G	A	2	2	4	0	0	4	0	0
9	34259343	.	G	A	2	1	3	0	0	3	0	0
9	34259406	.	T	A	5	3	8	0	0	8	0	0
9	34259418	.	T	A	5	4	9	0	0	9	0	0
9	34260164	.	C	T	5	2	7	0	1	8	0	0
9	34274897	.	G	C	1	1	2	0	1	3	0	0
9	34277333	.	A	G	3	1	4	0	0	4	0	0
9	34334173	.	T	G	2	0	2	0	2	4	0	0
9	34335327	.	G	T	0	2	2	0	2	4	0	0
9	34338325	.	G	A	3	0	3	0	0	3	0	0
9	34343912	.	T	C	9	3	12	0	1	13	0	0
9	34343983	.	A	G	2	10	12	0	0	12	0	0
9	34344039	.	C	T	0	1	1	0	1	2	0	0
9	34346443	.	T	C	4	3	7	0	0	7	0	0
9	34349889	.	G	A	2	5	7	0	0	7	0	0
9	34349967	.	C	T	2	4	6	0	0	6	0	0
9	34350372	.	A	T	3	3	6	0	0	6	0	0
9	34351171	.	G	A	4	5	9	0	0	9	0	0
9	34351273	.	T	G	4	0	4	0	1	5	0	0
9	34351277	.	T	C	4	1	5	0	0	5	0	0
9	34351416	.	A	C	5	4	9	0	0	9	0	0
9	34351811	.	A	G	2	4	6	0	0	6	0	0
9	34351845	.	T	A	2	3	5	0	1	6	0	0
9	34351916	.	C	T	3	2	5	0	0	5	0	0
9	34380320	.	C	T	2	0	2	0	0	2	0	0
9	34380457	.	A	G	9	10	19	0	1	20	0	0
9	34382946	.	A	C	11	10	21	0	0	21	0	0
9	34382994	.	G	A	0	7	7	0	2	9	0	0
9	34385012	.	C	T	6	6	12	0	0	12	0	0
9	34385364	.	G	T	3	13	16	0	0	16	0	0
9	34385421	.	A	C	6	21	27	0	0	27	0	0
9	34388784	.	T	G	26	11	37	0	1	38	0	0
9	34388798	.	T	G	24	0	24	0	10	34	0	0
9	34388882	.	G	A	12	19	31	0	0	31	0	0
9	34388969	.	A	G	3	2	5	0	3	8	0	0
9	34389317	.	T	A	22	8	30	0	1	31	0	0
9	34389379	.	C	T	17	12	29	0	0	29	0	0
9	34389457	.	C	A	14	17	31	0	1	32	0	0
9	34389602	.	A	G	20	0	20	0	16	36	0	0
9	34389734	.	G	C	0	14	14	0	15	29	0	0
9	34397935	.	C	T	3	2	5	0	1	6	0	0
9	34397972	.	T	G	3	2	5	0	0	5	0	0
9	34405155	.	A	G	0	1	1	0	0	1	0	0
9	34410237	.	T	C	1	1	2	0	0	2	0	0
9	34415308	.	T	C	5	3	8	0	0	8	0	0
9	34419094	.	T	C	7	5	12	0	0	12	0	0
9	34425996	.	G	A	1	0	1	0	0	1	0	0
9	34427407	.	A	G	1	0	1	0	2	3	0	0
9	34435063	.	A	T	1	0	1	0	0	1	0	0
9	34438861	.	T	G	1	0	1	0	1	2	0	0
9	34451141	.	G	A	0	1	1	0	0	1	0	0
9	34452052	.	C	A	2	2	4	0	1	5	0	0
9	34452057	.	G	A	0	2	2	0	3	5	0	0
9	34461340	.	A	G	7	0	7	0	2	9	0	0
9	34466229	.	G	A	0	3	3	0	6	9	0	0
9	34470776	.	T	C	2	4	6	0	0	6	0	0
9	34472180	.	C	T	3	4	7	0	0	7	0	0
9	34474434	.	G	T	2	4	6	0	1	7	0	0
9	34474529	.	A	G	4	1	5	0	9	14	0	0
9	34484859	.	T	A	7	4	11	0	1	12	0	0
9	34484949	.	T	C	6	11	17	0	1	18	0	0
9	34484959	.	T	C	6	10	16	0	1	17	0	0
9	34484997	.	A	T	5	7	12	0	1	13	0	0
9	34485105	.	G	T	8	5	13	0	0	13	0	0
9	34485123	.	T	C	8	5	13	0	0	13	0	0
9	34485168	.	C	T	0	2	2	0	1	3	0	0
9	34488459	.	T	C	1	0	1	0	2	3	0	0
9	34647415	.	A	G	9	0	9	0	9	18	0	0
9	34647427	.	A	C	13	5	18	0	2	20	0	0
9	34866579	.	T	G	13	11	24	0	1	25	0	0
9	34866684	.	T	A	8	4	12	0	1	13	0	0
9	34866888	.	C	T	12	13	25	0	0	25	0	0
9	34867007	.	C	A	0	17	17	0	8	25	0	0
9	34867015	.	T	C	7	0	7	0	15	22	0	0
9	34869699	.	A	G	14	15	29	0	1	30	0	0
9	34869813	.	G	A	8	11	19	0	1	20	0	0
9	34869945	.	G	A	2	5	7	0	0	7	0	0
9	34871796	.	G	C	0	1	1	0	0	1	0	0
9	34877042	.	G	A	1	0	1	0	0	1	0	0
9	34877285	.	G	A	3	3	6	0	0	6	0	0
9	34877315	.	G	A	3	3	6	0	0	6	0	0
9	34878209	.	C	T	0	1	1	0	0	1	0	0
9	34903218	.	T	G	23	25	48	0	1	49	0	0
9	34906337	.	C	G	22	28	50	0	2	52	0	0
9	34912626	.	A	T	6	7	13	0	0	13	0	0
9	34912695	.	T	C	5	0	5	0	4	9	0	0
9	34912895	.	T	A	6	10	16	0	2	18	0	0
9	34920395	.	G	A	2	6	8	0	1	9	0	0
9	34922670	.	C	T	0	1	1	0	1	2	0	0
9	34922898	.	A	G	4	1	5	0	0	5	0	0
9	34937154	.	A	T	1	2	3	0	0	3	0	0
9	34938795	.	C	T	8	7	15	0	2	17	0	0
9	34939336	.	A	G	3	7	10	0	0	10	0	0
9	34939800	.	T	C	6	7	13	0	0	13	0	0
9	34967565	.	A	G	8	6	14	0	0	14	0	0
9	34967647	.	C	T	10	4	14	0	0	14	0	0
9	34967649	.	C	T	9	4	13	0	1	14	0	0
9	34967733	.	A	G	5	2	7	0	0	7	0	0
9	34967743	.	A	C	4	2	6	0	0	6	0	0
9	34968005	.	A	G	5	6	11	0	1	12	0	0
9	35014847	.	C	G	2	0	2	0	0	2	0	0
9	35022050	.	A	G	5	4	9	0	0	9	0	0
9	35025183	.	C	T	3	3	6	0	1	7	0	0
9	35025243	.	A	T	7	4	11	0	1	12	0	0
9	35026736	.	T	A	24	29	53	0	4	58	1	0
9	35026941	.	T	C	29	28	57	0	3	60	0	0
9	35027262	.	A	G	31	30	61	0	1	62	0	0
9	35027309	.	T	C	25	0	25	0	29	54	0	0
9	35027333	.	A	G	30	21	51	0	2	53	0	0
9	35027365	.	G	T	33	19	52	0	5	57	0	0
9	35027371	.	G	T	32	25	57	0	4	62	1	0
9	35027402	.	G	A	31	27	58	0	4	62	0	0
9	35027549	.	T	G	33	27	60	0	0	60	0	0
9	35027705	.	G	A	27	3	30	0	0	30	0	0
9	35028086	.	T	C	32	3	35	0	38	73	0	0
9	35028282	.	T	C	35	5	40	0	38	78	0	0
9	35030977	.	G	A	27	31	58	0	0	58	0	0
9	35032640	.	A	G	4	2	6	0	0	6	0	0
9	35032643	.	A	G	4	4	8	0	0	8	0	0
9	35033347	.	C	T	21	19	40	0	1	41	0	0
9	35039175	.	T	C	18	15	33	0	2	35	0	0
9	35048839	.	G	C	22	31	53	0	1	54	0	0
9	35048840	.	A	C	23	31	54	0	0	54	0	0
9	35170671	.	G	A	9	15	24	0	1	25	0	0
9	35176030	.	A	G	13	13	26	0	2	28	0	0
9	35228165	.	G	A	4	5	9	0	0	9	0	0
9	35230740	.	G	A	0	2	2	0	0	2	0	0
9	35266330	.	C	T	0	2	2	0	1	3	0	0
9	35836674	.	T	G	5	4	9	0	0	9	0	0
9	35836721	.	T	A	4	3	7	0	0	7	0	0
9	35837194	.	C	G	5	0	5	0	3	8	0	0
9	35837404	.	C	A	3	6	9	0	0	9	0	0
9	35838477	.	T	A	14	13	27	0	1	28	0	0
9	35840713	.	G	A	6	7	13	0	0	13	0	0
9	35840782	.	T	C	8	10	18	0	0	18	0	0
9	35841279	.	G	T	6	7	13	0	0	13	0	0
9	35841282	.	A	G	6	9	15	0	0	15	0	0
9	35841663	.	G	T	6	7	13	0	0	13	0	0
9	35841994	.	A	G	10	9	19	0	1	20	0	0
9	35842164	.	T	A	4	8	12	0	0	12	0	0
9	35842209	.	G	T	6	6	12	0	0	12	0	0
9	35860982	.	G	A	9	4	13	0	0	13	0	0
9	35860983	.	A	T	9	4	13	0	0	13	0	0
9	35862299	.	G	A	10	15	25	0	1	26	0	0
9	35863132	.	C	T	11	13	24	0	0	24	0	0
9	35863555	.	T	C	14	12	26	0	0	26	0	0
9	35863603	.	T	C	8	12	20	0	0	20	0	0
9	35863798	.	C	T	15	17	32	0	1	33	0	0
9	35863968	.	A	T	18	7	25	0	2	27	0	0
9	35864155	.	A	T	11	8	19	0	0	19	0	0
9	35864210	.	C	T	9	9	18	0	0	18	0	0
9	35864266	.	C	A	6	2	8	0	1	9	0	0
9	35864277	.	C	T	6	5	11	0	1	12	0	0
9	35864356	.	A	G	2	7	9	0	0	9	0	0
9	35864416	.	A	C	4	5	9	0	0	9	0	0
9	35864486	.	C	T	5	5	10	0	0	10	0	0
9	35864565	.	A	G	6	1	7	0	0	7	0	0
9	35864598	.	C	T	7	3	10	0	1	11	0	0
9	35865073	.	C	T	15	23	38	0	2	40	0	0
9	35865162	.	G	T	10	7	17	0	0	17	0	0
9	35865270	.	C	G	17	12	29	0	1	30	0	0
9	35872927	.	G	A	6	2	8	0	0	8	0	0
9	35872942	.	G	A	3	5	8	0	0	8	0	0
9	35872993	.	A	T	6	8	14	0	2	16	0	0
9	35901654	.	T	A	1	1	2	0	0	2	0	0
9	35909794	.	T	C	1	2	3	0	0	3	0	0
9	35909842	.	A	G	1	2	3	0	0	3	0	0
9	35910390	.	C	G	1	0	1	0	1	2	0	0
9	35915548	.	C	T	4	7	11	0	1	12	0	0
9	35915557	.	G	A	0	8	8	0	4	12	0	0
9	35916518	.	T	G	1	1	2	0	0	2	0	0
9	35916786	.	G	A	2	3	5	0	0	5	0	0
9	35922046	.	T	G	14	20	34	0	3	37	0	0
9	35922115	.	T	C	8	14	22	0	1	23	0	0
9	36468508	.	G	C	0	1	1	0	0	1	0	0
9	36540309	.	C	T	1	1	2	0	1	3	0	0
9	36585992	.	G	A	0	2	2	0	2	4	0	0
9	36595278	.	G	A	1	2	3	0	0	3	0	0
9	36610121	.	A	G	3	0	3	0	2	5	0	0
9	36610139	.	C	T	4	2	6	0	0	6	0	0
9	36610163	.	T	C	5	2	7	0	0	7	0	0
9	36613178	.	C	T	2	2	4	0	0	4	0	0
9	36613202	.	C	T	2	3	5	0	0	5	0	0
9	36656011	.	A	G	1	0	1	0	0	1	0	0
9	36659702	.	T	G	4	4	8	0	1	9	0	0
9	36896761	.	C	A	0	8	8	0	4	12	0	0
9	36896791	.	C	T	4	4	8	0	2	10	0	0
9	36898724	.	C	T	9	2	11	0	0	11	0	0
9	36899065	.	C	T	0	10	10	0	9	19	0	0
9	36973751	.	T	C	2	2	4	0	0	4	0	0
9	36974233	.	A	T	3	3	6	0	0	6	0	0
9	36974460	.	C	T	3	2	5	0	0	5	0	0
9	37371515	.	A	T	1	1	2	0	0	2	0	0
9	37390314	.	C	T	0	2	2	0	0	2	0	0
9	37431935	.	G	A	0	1	1	0	0	1	0	0
9	37451609	.	T	G	4	5	9	0	0	9	0	0
9	37451809	.	A	G	10	7	17	0	1	18	0	0
9	37452012	.	A	T	6	8	14	0	0	14	0	0
9	37452223	.	C	T	7	3	10	0	1	11	0	0
9	37452432	.	G	A	9	4	13	0	0	13	0	0
9	37452499	.	T	G	13	3	16	0	0	16	0	0
9	37452515	.	G	T	14	5	19	0	0	19	0	0
9	37452616	.	T	G	17	11	28	0	2	30	0	0
9	37452862	.	T	C	11	7	18	0	1	19	0	0
9	37452924	.	C	G	8	5	13	0	1	14	0	0
9	37492798	.	G	A	4	1	5	0	1	6	0	0
9	37492807	.	A	G	3	0	3	0	3	6	0	0
9	37508255	.	T	C	0	1	1	0	0	1	0	0
9	37815520	.	A	T	4	6	10	0	1	11	0	0
9	37815548	.	A	G	3	0	3	0	5	8	0	0
9	37839796	.	G	A	3	2	5	0	0	5	0	0
9	37839802	.	A	G	3	2	5	0	0	5	0	0
9	37853970	.	A	C	4	0	4	0	1	5	0	0
9	37856541	.	C	T	10	11	21	0	0	21	0	0
9	37856895	.	T	A	5	3	8	0	1	9	0	0
9	37859881	.	T	G	13	16	29	0	0	29	0	0
9	37860116	.	T	C	6	5	11	0	0	11	0	0
9	37861560	.	A	G	2	0	2	0	3	5	0	0
9	37862065	.	T	G	5	0	5	0	6	11	0	0
9	37862333	.	C	A	3	4	7	0	1	8	0	0
9	37862376	.	T	C	0	2	2	0	1	3	0	0
9	38021226	.	T	C	0	1	1	0	1	2	0	0
9	38021291	.	A	T	0	4	4	0	0	4	0	0
9	38030131	.	A	T	18	15	33	0	0	33	0	0
9	38030366	.	A	T	8	7	15	0	0	15	0	0
9	38030485	.	A	T	11	5	16	0	3	19	0	0
9	38030503	.	C	T	0	4	4	0	16	20	0	0
9	38030574	.	G	A	10	10	20	0	0	20	0	0
9	38033363	.	T	C	11	0	11	0	8	19	0	0
9	38033578	.	A	G	3	1	4	0	1	5	0	0
9	38042752	.	G	A	0	3	3	0	0	3	0	0
9	38043476	.	T	C	2	1	3	0	0	3	0	0
9	38057075	.	A	G	0	2	2	0	0	2	0	0
9	38058608	.	T	C	1	0	1	0	0	1	0	0
9	38059042	.	C	T	1	1	2	0	0	2	0	0
9	38061525	.	G	T	0	3	3	0	5	8	0	0
9	38061699	.	T	C	6	2	8	0	0	8	0	0
9	38061788	.	T	C	4	6	10	0	0	10	0	0
9	38063688	.	C	A	3	6	9	0	1	10	0	0
9	38063689	.	C	A	4	6	10	0	0	10	0	0
9	38064268	.	T	C	7	4	11	0	0	11	0	0
9	38064420	.	T	G	5	6	11	0	0	11	0	0
9	38064421	.	C	A	5	6	11	0	0	11	0	0
9	38064672	.	A	C	6	3	9	0	2	11	0	0
9	38129312	.	C	G	2	4	6	0	0	6	0	0
9	38129632	.	A	G	1	0	1	0	3	4	0	0
9	38161842	.	C	T	7	4	11	0	0	11	0	0
9	38207964	.	G	A	2	0	2	0	0	2	0	0
9	38238917	.	G	A	0	2	2	0	3	5	0	0
9	38251409	.	T	C	3	3	6	0	0	6	0	0
9	38266131	.	T	C	1	1	2	0	0	2	0	0
9	38269630	.	A	G	2	3	5	0	0	5	0	0
9	38273171	.	G	A	6	6	12	0	0	12	0	0
9	38273264	.	T	A	1	6	7	0	0	7	0	0
9	38276558	.	T	G	0	0	0	0	2	2	0	0
9	38277513	.	A	G	2	2	4	0	0	4	0	0
9	38278121	.	A	G	2	0	2	0	0	2	0	0
9	38278289	.	C	T	15	9	24	0	1	25	0	0
9	38278301	.	T	C	13	8	21	0	1	22	0	0
9	38278337	.	T	C	5	0	5	0	0	5	0	0
9	38283647	.	G	A	11	10	21	0	0	21	0	0
9	38283659	.	C	T	10	9	19	0	0	19	0	0
9	38284317	.	A	G	13	0	13	0	10	23	0	0
9	38285598	.	A	G	7	8	15	0	0	15	0	0
9	38286823	.	G	A	7	3	10	0	3	13	0	0
9	38290165	.	C	T	10	10	20	0	0	20	0	0
9	38290210	.	A	G	11	9	20	0	1	21	0	0
9	38290220	.	T	G	14	0	14	0	6	20	0	0
9	38290245	.	C	T	15	9	24	0	1	25	0	0
9	38290414	.	A	G	11	12	23	0	0	23	0	0
9	38290517	.	A	C	12	6	18	0	1	19	0	0
9	38290530	.	A	T	13	7	20	0	0	20	0	0
9	38290561	.	C	T	9	5	14	0	1	15	0	0
9	38290777	.	G	T	0	14	14	0	16	30	0	0
9	38290959	.	A	C	19	16	35	0	4	39	0	0
9	38291439	.	G	T	21	16	37	0	0	37	0	0
9	38291616	.	C	T	16	11	27	0	1	28	0	0
9	38291737	.	C	A	10	9	19	0	4	23	0	0
9	38315128	.	T	G	4	3	7	0	0	7	0	0
9	38348252	.	G	A	3	2	5	0	0	5	0	0
9	38348458	.	G	A	2	2	4	0	0	4	0	0
9	38351016	.	T	C	7	4	11	0	0	11	0	0
9	38353794	.	T	C	7	9	16	0	0	16	0	0
9	38354000	.	T	C	4	4	8	0	2	10	0	0
9	38354224	.	A	G	2	2	4	0	0	4	0	0
9	38354689	.	G	A	1	1	2	0	0	2	0	0
9	38359027	.	A	C	0	0	0	0	2	2	0	0
9	38360102	.	C	T	0	3	3	0	5	8	0	0
9	38362354	.	G	A	6	2	8	0	0	8	0	0
9	38362380	.	C	T	5	2	7	0	0	7	0	0
9	38366653	.	T	C	1	2	3	0	0	3	0	0
9	38366656	.	C	A	0	2	2	0	1	3	0	0
9	38366826	.	A	G	1	1	2	0	1	3	0	0
9	38366883	.	C	G	1	0	1	0	0	1	0	0
9	38368055	.	A	G	1	2	3	0	0	3	0	0
9	38376231	.	T	C	0	1	1	0	0	1	0	0
9	38385734	.	G	A	0	1	1	0	0	1	0	0
9	38386615	.	C	A	2	1	3	0	0	3	0	0
9	38388492	.	C	T	5	10	15	0	0	15	0	0
9	38388493	.	C	T	2	10	12	0	3	15	0	0
9	38388703	.	T	C	4	6	10	0	2	12	0	0
9	38389194	.	C	T	6	8	14	0	0	14	0	0
9	38389263	.	T	A	5	2	7	0	2	9	0	0
9	38389426	.	G	A	10	8	18	0	0	18	0	0
9	38389603	.	A	G	9	2	11	0	8	19	0	0
9	38389616	.	C	T	12	9	21	0	0	21	0	0
9	38389644	.	A	T	10	10	20	0	0	20	0	0
9	38389722	.	G	T	4	3	7	0	1	8	0	0
9	38389746	.	T	C	6	5	11	0	0	11	0	0
9	38389886	.	C	T	5	8	13	0	0	13	0	0
9	38391991	.	T	C	2	3	5	0	0	5	0	0
9	38392045	.	T	G	3	3	6	0	0	6	0	0
9	38392097	.	T	C	1	3	4	0	0	4	0	0
9	38392326	.	C	A	3	2	5	0	0	5	0	0
9	38400169	.	A	C	1	2	3	0	0	3	0	0
9	38405238	.	A	G	5	3	8	0	0	8	0	0
9	38413298	.	C	T	1	1	2	0	0	2	0	0
9	38418623	.	C	T	3	2	5	0	0	5	0	0
9	38429624	.	G	T	3	1	4	0	0	4	0	0
9	38433354	.	C	A	2	2	4	0	0	4	0	0
9	38466332	.	T	G	0	2	2	0	0	2	0	0
9	38476780	.	G	C	2	5	7	0	0	7	0	0
9	38476810	.	T	G	2	3	5	0	0	5	0	0
9	38478424	.	T	C	2	2	4	0	0	4	0	0
9	38478643	.	A	T	3	4	7	0	0	7	0	0
9	38479579	.	A	G	2	1	3	0	3	6	0	0
9	38494774	.	G	A	0	1	1	0	0	1	0	0
9	38502640	.	A	G	4	2	6	0	0	6	0	0
9	38502683	.	A	T	0	2	2	0	0	2	0	0
9	38526390	.	T	C	1	0	1	0	0	1	0	0
9	38537286	.	G	A	0	2	2	0	1	3	0	0
9	38542252	.	C	T	2	2	4	0	0	4	0	0
9	38550889	.	T	C	4	4	8	0	1	9	0	0
9	38550910	.	T	C	2	3	5	0	0	5	0	0
9	38600006	.	G	A	0	1	1	0	0	1	0	0
9	38620058	.	C	T	9	7	16	0	1	17	0	0
9	38620308	.	C	A	10	3	13	0	0	13	0	0
9	38620673	.	A	G	13	14	27	0	1	28	0	0
9	38621173	.	T	G	1	2	3	0	0	3	0	0
9	38635435	.	G	A	1	1	2	0	0	2	0	0
9	38636413	.	G	T	1	6	7	0	5	12	0	0
9	38636722	.	T	C	4	4	8	0	0	8	0	0
9	38636797	.	T	C	1	4	5	0	0	5	0	0
9	38637872	.	T	C	3	3	6	0	1	7	0	0
9	38638197	.	C	T	5	4	9	0	0	9	0	0
9	38638452	.	A	T	6	7	13	0	0	13	0	0
9	38638461	.	C	G	6	7	13	0	1	14	0	0
9	38638492	.	A	G	7	0	7	0	8	15	0	0
9	38638518	.	T	C	9	8	17	0	0	17	0	0
9	38638743	.	T	C	6	5	11	0	1	12	0	0
9	38638862	.	C	T	2	4	6	0	0	6	0	0
9	38638863	.	C	A	1	4	5	0	1	6	0	0
9	38639799	.	T	C	2	3	5	0	0	5	0	0
9	38639846	.	C	T	5	5	10	0	1	11	0	0
9	38639907	.	A	C	4	7	11	0	0	11	0	0
9	38639999	.	C	T	5	6	11	0	1	12	0	0
9	38640114	.	T	A	4	8	12	0	0	12	0	0
9	38640186	.	T	C	2	7	9	0	0	9	0	0
9	38640193	.	T	C	1	6	7	0	1	8	0	0
9	38640598	.	A	G	1	0	1	0	5	6	0	0
9	38640773	.	A	T	2	6	8	0	0	8	0	0
9	38948420	.	C	T	0	1	1	0	0	1	0	0
9	38962017	.	A	C	16	16	32	0	0	32	0	0
9	38962081	.	T	G	11	11	22	0	0	22	0	0
9	40928245	.	T	C	9	6	15	0	2	17	0	0
9	40928284	.	T	C	10	0	10	0	6	16	0	0
9	40928706	.	T	C	3	4	7	0	0	7	0	0
9	40930316	.	T	C	5	3	8	0	0	8	0	0
9	40930319	.	T	C	5	3	8	0	0	8	0	0
9	41479980	.	A	G	4	4	8	0	0	8	0	0
9	41480010	.	A	G	6	0	6	0	3	9	0	0
9	41481147	.	A	G	3	3	6	0	0	6	0	0
9	42360743	.	C	G	4	6	10	0	1	11	0	0
9	42360893	.	C	T	0	4	4	0	3	7	0	0
9	42360899	.	G	A	3	4	7	0	0	7	0	0
9	42372354	.	T	A	1	3	4	0	0	4	0	0
9	42421044	.	G	T	3	3	6	0	1	7	0	0
9	42644892	.	A	G	4	0	4	0	4	8	0	0
9	42649583	.	A	G	4	3	7	0	0	7	0	0
9	42649636	.	T	A	4	5	9	0	0	9	0	0
9	42649653	.	T	C	6	4	10	0	0	10	0	0
9	42649739	.	C	T	8	8	16	0	0	16	0	0
9	42649743	.	A	G	8	8	16	0	0	16	0	0
9	42649923	.	A	G	3	5	8	0	3	11	0	0
9	42653737	.	T	C	4	3	7	0	0	7	0	0
9	42658401	.	G	C	0	2	2	0	0	2	0	0
9	42728866	.	C	A	0	1	1	0	0	1	0	0
9	42730514	.	G	A	1	4	5	0	0	5	0	0
9	43082373	.	A	T	1	3	4	0	0	4	0	0
9	43082398	.	A	G	3	3	6	0	0	6	0	0
9	43082519	.	C	A	0	1	1	0	4	5	0	0
9	43082541	.	A	C	5	0	5	0	0	5	0	0
9	43082717	.	T	G	1	2	3	0	0	3	0	0
9	43085471	.	G	C	6	5	11	0	0	12	1	0
9	43085527	.	A	T	6	4	10	0	0	10	0	0
9	43085728	.	A	C	5	3	8	0	0	8	0	0
9	43085879	.	C	T	3	3	6	0	0	6	0	0
9	43085949	.	A	C	2	1	3	0	0	3	0	0
9	43088870	.	T	A	0	2	2	0	1	3	0	0
9	43088884	.	G	A	0	1	1	0	2	3	0	0
9	43088910	.	A	T	1	3	4	0	0	4	0	0
9	43088984	.	A	G	3	3	6	0	0	6	0	0
9	43089038	.	C	G	3	2	5	0	0	5	0	0
9	43116652	.	T	C	2	2	4	0	0	4	0	0
9	43118424	.	C	G	1	0	1	0	0	1	0	0
9	43150018	.	T	A	9	7	16	0	2	18	0	0
9	43150278	.	T	G	9	6	15	0	0	15	0	0
9	43150604	.	A	G	16	9	25	0	0	25	0	0
9	43150817	.	C	T	0	15	15	0	9	24	0	0
9	43153287	.	C	T	4	4	8	0	1	9	0	0
9	43154841	.	C	T	2	1	3	0	1	4	0	0
9	43202097	.	T	C	1	0	1	0	2	3	0	0
9	43243224	.	T	G	1	3	4	0	3	7	0	0
9	43261951	.	T	A	5	7	12	0	0	12	0	0
9	43287748	.	G	A	0	3	3	0	0	3	0	0
9	43375122	.	G	A	5	5	10	0	0	10	0	0
9	43552604	.	C	A	3	5	8	0	1	9	0	0
9	43553036	.	G	T	8	13	21	0	2	23	0	0
9	43559501	.	A	C	8	5	13	0	2	15	0	0
9	43612482	.	T	G	1	1	2	0	0	2	0	0
9	43617899	.	A	G	4	1	5	0	0	5	0	0
9	43617962	.	A	G	7	6	13	0	2	15	0	0
9	44097854	.	C	T	0	1	1	0	1	2	0	0
9	44109589	.	T	C	2	0	2	0	2	4	0	0
9	44109595	.	T	C	2	0	2	0	2	4	0	0
9	44292285	.	A	C	21	1	22	0	33	55	0	0
9	44292737	.	T	C	25	27	52	0	1	53	0	0
9	44292909	.	C	T	1	26	27	0	33	60	0	0
9	44293488	.	C	T	25	23	48	0	3	51	0	0
9	44294792	.	A	G	4	2	6	0	1	7	0	0
9	44400580	.	G	A	5	6	11	0	1	12	0	0
9	44400706	.	C	A	2	4	6	0	0	6	0	0
9	44411647	.	A	G	2	6	8	0	0	8	0	0
9	44411652	.	C	A	2	6	8	0	0	8	0	0
9	44419652	.	T	A	5	7	12	0	1	13	0	0
9	44419793	.	C	A	5	5	10	0	2	12	0	0
9	44431117	.	G	A	6	3	9	0	0	9	0	0
9	44431159	.	G	C	1	2	3	0	0	3	0	0
9	44486011	.	A	G	4	5	9	0	2	11	0	0
9	44488578	.	T	A	6	3	9	0	0	9	0	0
9	44488620	.	G	A	3	2	5	0	0	5	0	0
9	44489843	.	G	A	0	5	5	0	8	13	0	0
9	44489844	.	T	A	7	4	11	0	2	13	0	0
9	44498332	.	T	C	2	11	13	0	2	15	0	0
9	44509181	.	G	A	0	2	2	0	0	2	0	0
9	44511218	.	C	T	0	2	2	0	0	2	0	0
9	44515937	.	G	A	2	5	7	0	0	7	0	0
9	44526546	.	G	A	1	2	3	0	0	3	0	0
9	44641974	.	A	T	4	2	6	0	0	6	0	0
9	44642017	.	G	A	4	4	8	0	0	8	0	0
9	44961166	.	A	G	3	3	6	0	0	6	0	0
9	44965663	.	T	C	1	2	3	0	0	3	0	0
9	45504357	.	A	C	2	3	5	0	0	5	0	0
9	45504888	.	G	A	0	0	0	0	2	2	0	0
9	45523190	.	G	A	4	1	5	0	0	5	0	0
9	45541036	.	C	A	3	4	7	0	0	7	0	0
9	45541239	.	G	A	3	2	5	0	0	5	0	0
9	45551273	.	T	C	6	5	11	0	5	16	0	0
9	45552338	.	T	G	6	10	16	0	1	17	0	0
9	45552364	.	G	A	0	9	9	0	3	12	0	0
9	45552386	.	C	G	5	9	14	0	0	14	0	0
9	45552567	.	G	A	0	17	17	0	13	30	0	0
9	45552715	.	C	T	16	16	32	0	0	32	0	0
9	45552806	.	G	A	0	10	10	0	16	26	0	0
9	45552881	.	T	C	11	15	26	0	3	29	0	0
9	45552924	.	C	A	12	15	27	0	2	29	0	0
9	45552957	.	C	T	15	14	29	0	1	30	0	0
9	45623346	.	C	T	1	3	4	0	0	4	0	0
9	45623446	.	A	G	4	5	9	0	0	9	0	0
9	45633108	.	C	G	1	1	2	0	0	2	0	0
9	45637090	.	G	A	3	0	3	0	0	3	0	0
9	45666600	.	G	A	2	2	4	0	0	4	0	0
9	45667103	.	C	T	0	3	3	0	0	3	0	0
9	45884426	.	C	T	0	3	3	0	1	4	0	0
9	45884711	.	G	A	3	2	5	0	1	6	0	0
9	45884768	.	T	G	6	3	9	0	0	9	0	0
9	45934065	.	A	G	1	4	5	0	0	5	0	0
9	45969254	.	C	T	0	1	1	0	0	1	0	0
9	45975846	.	C	T	0	4	4	0	5	9	0	0
9	45997103	.	G	A	0	3	3	0	0	3	0	0
9	46525634	.	G	A	0	2	2	0	0	2	0	0
9	46525673	.	A	G	2	5	7	0	0	7	0	0
9	46598134	.	T	C	1	1	2	0	0	2	0	0
9	46603999	.	A	G	1	0	1	0	3	4	0	0
9	46604056	.	T	C	0	2	2	0	0	2	0	0
9	46604068	.	A	G	0	0	0	0	1	1	0	0
9	46604930	.	C	T	0	1	1	0	0	1	0	0
9	46671108	.	G	A	0	2	2	0	0	2	0	0
9	46676385	.	C	T	1	2	3	0	0	3	0	0
9	46676393	.	C	G	2	2	4	0	0	4	0	0
9	46678159	.	A	C	2	5	7	0	0	7	0	0
9	46678196	.	C	T	4	4	8	0	0	8	0	0
9	46678255	.	T	C	1	2	3	0	0	3	0	0
9	46678279	.	A	T	0	2	2	0	0	2	0	0
9	46683760	.	C	A	3	3	6	0	0	6	0	0
9	46683861	.	A	C	2	8	10	0	0	10	0	0
9	46692261	.	T	G	14	14	28	0	2	30	0	0
9	46745653	.	A	G	1	3	4	0	0	4	0	0
9	46784333	.	G	A	1	2	3	0	0	3	0	0
9	46799102	.	T	C	4	3	7	0	0	7	0	0
9	46821464	.	C	T	7	11	18	0	0	18	0	0
9	46821685	.	A	G	4	6	10	0	0	10	0	0
9	46821810	.	C	G	0	7	7	0	0	7	0	0
9	46821853	.	G	A	2	6	8	0	1	9	0	0
9	46821855	.	G	T	2	7	9	0	0	9	0	0
9	46821905	.	A	G	7	6	13	0	0	13	0	0
9	46821916	.	A	T	7	4	11	0	2	13	0	0
9	46822002	.	T	C	3	2	5	0	1	6	0	0
9	46822079	.	C	T	8	6	14	0	0	14	0	0
9	46822120	.	C	T	0	8	8	0	7	15	0	0
9	46822144	.	T	C	5	9	14	0	2	16	0	0
9	46822417	.	C	T	0	7	7	0	4	11	0	0
9	46823198	.	C	T	12	12	24	0	0	24	0	0
9	46823325	.	G	A	17	6	23	0	0	23	0	0
9	46823366	.	T	C	11	13	24	0	0	24	0	0
9	46823524	.	A	G	10	13	23	0	2	25	0	0
9	46824110	.	A	G	10	14	24	0	0	24	0	0
9	46824160	.	T	A	12	12	24	0	1	25	0	0
9	46825094	.	A	T	4	6	10	0	2	12	0	0
9	46841787	.	C	G	1	3	4	0	1	5	0	0
9	47502293	.	A	T	1	2	3	0	0	3	0	0
9	47502415	.	G	A	2	2	4	0	0	4	0	0
9	47502446	.	G	C	1	2	3	0	0	3	0	0
9	47502512	.	C	A	2	2	4	0	0	4	0	0
9	48054753	.	G	A	15	11	26	0	1	27	0	0
9	48060592	.	G	C	18	9	27	0	1	28	0	0
9	48076973	.	C	T	12	19	31	0	1	32	0	0
9	48123109	.	C	G	3	2	5	0	0	5	0	0
9	48123142	.	G	A	6	5	11	0	0	11	0	0
9	48123222	.	G	C	3	4	7	0	0	7	0	0
9	48127200	.	G	A	1	3	4	0	0	4	0	0
9	48128027	.	G	T	0	5	5	0	4	9	0	0
9	48131637	.	T	A	2	3	5	0	0	5	0	0
9	48131814	.	A	T	7	4	11	0	0	11	0	0
9	48131956	.	G	A	1	5	6	1	0	7	0	0
9	48131997	.	C	T	1	6	7	0	2	9	0	0
9	48132029	.	T	C	3	2	5	0	8	13	0	0
9	48132037	.	T	A	3	10	13	0	0	13	0	0
9	48132095	.	A	C	5	10	15	0	0	15	0	0
9	48132194	.	G	T	3	5	8	0	0	8	0	0
9	48132439	.	G	A	6	2	8	0	1	9	0	0
9	48132441	.	A	G	6	2	8	0	1	9	0	0
9	48132531	.	G	A	2	5	7	0	0	7	0	0
9	48132592	.	G	T	5	2	7	0	0	7	0	0
9	48132865	.	A	C	2	3	5	0	0	5	0	0
9	48133013	.	T	C	1	0	1	0	2	3	0	0
9	48133105	.	G	T	5	4	9	0	0	9	0	0
9	48133412	.	T	C	3	3	6	0	1	7	0	0
9	48133541	.	T	C	3	3	6	0	0	6	0	0
9	48133687	.	A	G	5	3	8	0	0	8	0	0
9	48133900	.	G	T	4	2	6	0	0	6	0	0
9	48134012	.	T	A	3	2	5	0	0	5	0	0
9	48134201	.	A	T	5	2	7	0	0	7	0	0
9	48134351	.	G	A	4	9	13	0	0	13	0	0
9	48134568	.	G	A	3	2	5	0	5	10	0	0
9	48134678	.	A	T	3	3	6	0	0	6	0	0
9	48178975	.	A	G	2	3	5	0	0	5	0	0
9	48178990	.	C	T	0	3	3	0	1	4	0	0
9	48186519	.	C	A	4	4	8	0	0	8	0	0
9	48201122	.	A	G	1	2	3	0	0	3	0	0
9	48201127	.	G	A	1	2	3	0	0	3	0	0
9	48219274	.	C	T	1	2	3	0	0	3	0	0
9	48219649	.	T	G	2	0	2	0	2	4	0	0
9	48225779	.	T	C	2	2	4	0	0	4	0	0
9	48227847	.	T	A	1	3	4	0	0	4	0	0
9	48227885	.	T	G	2	3	5	0	0	5	0	0
9	48227953	.	T	C	0	1	1	0	1	2	0	0
9	48229074	.	T	C	0	1	1	0	0	1	0	0
9	48252167	.	C	T	0	2	2	0	0	2	0	0
9	48252171	.	G	C	0	2	2	0	0	2	0	0
9	48266716	.	T	C	2	2	4	0	0	4	0	0
9	48266750	.	T	A	1	2	3	0	0	3	0	0
9	48266752	.	C	T	1	2	3	0	0	3	0	0
9	48267159	.	C	T	1	4	5	0	0	5	0	0
9	48284901	.	T	C	8	10	18	0	1	19	0	0
9	48284917	.	C	A	0	10	10	0	9	19	0	0
9	48284972	.	T	C	6	6	12	0	0	12	0	0
9	48285019	.	G	A	1	0	1	0	0	1	0	0
9	48286702	.	G	A	1	2	3	0	0	3	0	0
9	48287441	.	G	A	5	4	9	0	0	9	0	0
9	48289758	.	G	A	3	0	3	0	0	3	0	0
9	48390858	.	G	T	3	3	6	0	0	6	0	0
9	48407342	.	C	T	3	2	5	0	0	5	0	0
9	48665419	.	A	T	1	2	3	0	0	3	0	0
9	48665654	.	G	A	0	1	1	0	0	1	0	0
9	48670632	.	G	A	0	2	2	0	1	3	0	0
9	48670634	.	G	C	1	1	2	0	1	3	0	0
9	48670747	.	T	G	2	0	2	0	2	4	0	0
9	48670748	.	T	C	2	2	4	0	0	4	0	0
9	48671167	.	A	C	1	2	3	0	1	4	0	0
9	48671665	.	A	G	1	2	3	0	0	3	0	0
9	48671671	.	T	A	1	2	3	0	0	3	0	0
9	48706302	.	C	T	0	3	3	0	0	3	0	0
9	48706305	.	C	T	0	2	2	0	1	3	0	0
9	48718225	.	C	A	0	2	2	0	2	4	0	0
9	48718229	.	C	G	2	2	4	0	0	4	0	0
9	48721088	.	C	T	2	5	7	0	0	7	0	0
9	48815862	.	A	T	2	2	4	0	0	4	0	0
9	48816846	.	T	C	1	2	3	0	0	3	0	0
9	48870578	.	T	C	8	2	10	0	14	24	0	0
9	48870593	.	A	T	14	10	24	0	1	25	0	0
9	48870627	.	T	A	8	8	16	0	1	17	0	0
9	48870680	.	A	G	5	2	7	0	1	8	0	0
9	48870886	.	C	T	7	5	12	0	1	13	0	0
9	48871610	.	A	T	2	2	4	0	0	4	0	0
9	48871973	.	A	C	4	7	11	0	0	11	0	0
9	48872039	.	C	G	0	5	5	1	0	6	0	0
9	48872050	.	C	T	1	3	4	1	0	5	0	0
9	48872615	.	A	G	8	3	11	0	0	11	0	0
9	48872620	.	C	T	5	3	8	0	1	9	0	0
9	48872688	.	A	T	4	2	6	0	0	6	0	0
9	48872694	.	A	G	6	2	8	0	0	8	0	0
9	48872890	.	C	A	6	8	14	0	0	14	0	0
9	48872924	.	A	G	4	8	12	0	0	12	0	0
9	48872926	.	C	T	0	8	8	0	4	12	0	0
9	48873371	.	A	G	2	4	6	0	0	6	0	0
9	48873522	.	C	G	3	3	6	0	0	6	0	0
9	48874493	.	G	C	0	2	2	0	4	6	0	0
9	48874498	.	C	A	0	4	4	0	3	7	0	0
9	48874562	.	G	A	7	4	11	0	0	11	0	0
9	48874577	.	G	A	6	3	9	0	1	10	0	0
9	48874728	.	T	C	2	2	4	0	0	4	0	0
9	48875171	.	C	T	3	3	6	0	0	6	0	0
9	48875208	.	C	G	1	3	4	0	0	4	0	0
9	48875510	.	T	C	2	4	6	0	0	6	0	0
9	48875516	.	G	A	4	2	6	0	0	6	0	0
9	48875595	.	A	C	3	2	5	0	0	5	0	0
9	48875598	.	T	A	2	2	4	0	0	4	0	0
9	48875674	.	A	G	1	3	4	0	0	4	0	0
9	48875889	.	G	A	1	3	4	1	1	6	0	0
9	48875895	.	A	C	0	0	0	1	5	6	0	0
9	48876199	.	T	C	1	3	4	0	0	4	0	0
9	48876544	.	C	T	8	9	17	0	0	17	0	0
9	48876587	.	A	G	6	3	9	0	0	9	0	0
9	48876798	.	C	T	0	3	3	0	3	6	0	0
9	48877129	.	T	C	1	0	1	0	3	4	0	0
9	48937081	.	G	C	2	3	5	0	0	5	0	0
9	49847413	.	T	C	1	2	3	0	0	3	0	0
9	50196047	.	A	C	1	4	5	0	0	5	0	0
9	50196064	.	C	T	1	2	3	0	0	3	0	0
9	51302422	.	A	G	3	4	7	0	1	8	0	0
9	51307387	.	G	T	1	2	3	0	0	3	0	0
9	51345386	.	C	A	1	2	3	0	0	3	0	0
9	51430737	.	C	T	0	2	2	0	2	4	0	0
9	51430767	.	T	A	1	3	4	0	1	5	0	0
9	51431179	.	C	G	15	14	29	0	0	29	0	0
9	51431642	.	A	C	7	0	7	0	7	14	0	0
9	51431791	.	G	A	2	2	4	0	0	4	0	0
9	51432279	.	T	G	3	9	12	0	0	12	0	0
9	51432381	.	C	T	0	4	4	0	4	8	0	0
9	51996246	.	C	T	0	4	4	0	8	12	0	0
9	51996280	.	T	A	8	5	13	0	1	14	0	0
9	51996281	.	G	A	8	5	13	0	1	14	0	0
9	51996444	.	T	G	11	6	17	0	0	17	0	0
9	51996469	.	C	T	0	10	10	0	12	22	0	0
9	51996788	.	A	G	4	3	7	0	0	7	0	0
9	51996876	.	A	G	4	3	7	0	0	7	0	0
9	51997231	.	T	A	2	2	4	0	0	4	0	0
9	51997232	.	C	A	0	2	2	0	2	4	0	0
9	51997286	.	C	A	1	2	3	0	0	3	0	0
9	51998330	.	T	C	5	4	9	0	0	9	0	0
9	51998648	.	C	T	7	4	11	0	0	11	0	0
9	51998761	.	C	G	4	6	10	0	0	10	0	0
9	51998784	.	T	G	9	4	13	0	0	13	0	0
9	51998841	.	G	T	9	3	12	0	0	12	0	0
9	51998887	.	T	G	3	4	7	0	0	7	0	0
9	51999842	.	C	G	5	3	8	0	0	8	0	0
9	51999855	.	T	G	5	3	8	0	0	8	0	0
9	51999893	.	C	T	0	1	1	0	5	6	0	0
9	51999991	.	A	G	2	1	3	0	0	3	0	0
9	52000032	.	C	T	0	4	4	0	1	5	0	0
9	52000088	.	G	A	4	2	6	0	0	6	0	0
9	52000335	.	A	T	6	2	8	0	0	8	0	0
9	52000623	.	C	T	1	2	3	0	2	5	0	0
9	52000665	.	A	G	4	2	6	0	0	6	0	0
9	52000869	.	G	C	1	0	1	0	2	3	0	0
9	52001016	.	C	T	0	3	3	0	4	7	0	0
9	52003427	.	T	C	1	0	1	0	0	1	0	0
9	52040746	.	A	G	0	3	3	0	0	3	0	0
9	52057288	.	A	C	1	0	1	0	3	4	0	0
9	52057356	.	T	C	2	0	2	0	4	6	0	0
9	52057378	.	C	A	0	3	3	0	4	7	0	0
9	52057708	.	C	T	1	1	2	0	0	2	0	0
9	52378682	.	C	T	18	11	29	0	1	30	0	0
9	52378697	.	A	G	14	20	34	0	1	35	0	0
9	52378832	.	T	A	11	13	24	1	0	25	0	0
9	52435100	.	G	A	1	1	2	0	0	2	0	0
9	52435112	.	C	T	1	1	2	0	0	2	0	0
9	52479199	.	T	C	1	4	5	0	0	5	0	0
9	52479739	.	T	C	2	0	2	0	0	2	0	0
9	52489899	.	T	C	1	0	1	0	2	3	0	0
9	52492641	.	A	C	2	4	6	0	0	6	0	0
9	52492705	.	A	G	5	10	15	0	3	18	0	0
9	52493059	.	A	T	9	1	10	0	1	11	0	0
9	52493231	.	A	T	4	8	12	0	2	14	0	0
9	52493406	.	C	T	10	3	13	0	0	13	0	0
9	52539290	.	G	A	0	1	1	0	3	4	0	0
9	52539453	.	C	T	13	9	22	0	2	24	0	0
9	52539629	.	C	T	16	9	25	0	0	25	0	0
9	52564622	.	T	C	2	0	2	0	0	2	0	0
9	52572555	.	C	T	2	3	5	0	1	6	0	0
9	52572609	.	C	G	6	2	8	0	0	8	0	0
9	52574737	.	C	G	4	2	6	0	0	6	0	0
9	52577701	.	A	G	0	1	1	0	0	1	0	0
9	52629113	.	C	T	2	8	10	0	0	10	0	0
9	52629119	.	C	T	8	2	10	0	0	10	0	0
9	52629155	.	T	C	1	0	1	0	0	1	0	0
9	52633151	.	C	T	3	2	5	0	0	5	0	0
9	52635541	.	C	T	0	1	1	0	0	1	0	0
9	52635547	.	T	C	0	0	0	0	1	1	0	0
9	52642012	.	G	A	0	1	1	0	0	1	0	0
9	52645687	.	C	T	0	3	3	0	1	4	0	0
9	52649704	.	C	T	0	1	1	0	1	2	0	0
9	52649740	.	C	A	0	3	3	0	1	4	0	0
9	52649758	.	T	A	1	3	4	0	0	4	0	0
9	52649941	.	G	A	1	3	4	0	0	4	0	0
9	52651985	.	T	C	1	0	1	0	0	1	0	0
9	53276550	.	A	C	1	5	6	0	1	7	0	0
9	53276681	.	G	A	0	4	4	0	7	11	0	0
9	53276976	.	C	T	5	8	13	0	0	13	0	0
9	53276978	.	A	G	8	5	13	0	0	13	0	0
9	53277068	.	C	G	3	0	3	0	4	7	0	0
9	53277131	.	A	T	8	6	14	0	0	14	0	0
9	53277453	.	G	A	0	7	7	0	6	13	0	0
9	53277493	.	A	T	7	5	12	0	0	12	0	0
9	54245010	.	T	A	2	1	3	0	0	3	0	0
9	54247334	.	A	G	3	4	7	0	0	7	0	0
9	54247336	.	T	C	3	4	7	0	0	7	0	0
9	54256221	.	C	G	5	1	6	0	0	6	0	0
9	54256286	.	C	A	7	3	10	0	0	10	0	0
9	54260901	.	C	T	4	2	6	0	0	6	0	0
9	54261104	.	G	A	0	3	3	0	0	3	0	0
9	54263996	.	C	T	3	1	4	0	0	4	0	0
9	54264236	.	T	C	3	7	10	0	0	10	0	0
9	54264245	.	T	C	3	7	10	0	0	10	0	0
9	54264272	.	C	T	6	4	10	0	0	10	0	0
9	54264299	.	C	A	5	3	8	0	0	8	0	0
9	54270324	.	C	T	5	1	6	0	1	7	0	0
9	54270348	.	T	A	5	2	7	0	0	7	0	0
9	54273514	.	G	T	2	5	7	0	0	7	0	0
9	54273797	.	C	T	0	2	2	0	0	2	0	0
9	54315617	.	T	G	3	2	5	0	0	5	0	0
9	54329537	.	T	C	2	2	4	0	0	4	0	0
9	54335139	.	A	G	2	1	3	0	1	4	0	0
9	54335197	.	C	T	1	2	3	0	0	3	0	0
9	54340140	.	C	T	2	1	3	0	1	4	0	0
9	54340248	.	G	A	2	3	5	0	0	5	0	0
9	54340284	.	C	T	0	1	1	0	1	2	0	0
9	54340317	.	T	A	1	0	1	0	0	1	0	0
9	54345372	.	G	A	2	2	4	0	0	4	0	0
9	54347521	.	T	C	3	2	5	0	0	5	0	0
9	54417949	.	A	T	4	5	9	0	1	10	0	0
9	54418577	.	G	T	0	7	7	0	1	8	0	0
9	54418687	.	T	C	2	2	4	0	0	4	0	0
9	54418906	.	T	A	3	3	6	0	0	6	0	0
9	54711802	.	A	G	5	3	8	0	0	8	0	0
9	54712645	.	T	C	10	6	16	0	2	18	0	0
9	54712650	.	T	C	6	9	15	0	1	16	0	0
9	56225849	.	A	G	4	6	10	0	0	10	0	0
9	56225850	.	A	G	5	5	10	0	0	10	0	0
