contig	position	variantID	refAllele	altAllele	refCount	altCount	totalCount	lowMAPQDepth	lowBaseQDepth	rawDepth	otherBases	improperPairs
1	208564	.	T	C	10	5	15	0	1	16	0	0
1	209113	.	T	C	3	9	12	0	1	13	0	0
1	209147	.	T	C	9	8	17	0	0	17	0	0
1	443155	.	G	T	1	2	3	0	0	3	0	0
1	484434	.	C	T	1	8	9	0	0	9	0	0
1	504696	.	A	G	6	0	6	0	15	21	0	0
1	504977	.	A	G	10	6	16	0	1	17	0	0
1	524697	.	C	G	0	2	2	0	0	2	0	0
1	524700	.	A	G	1	1	2	0	0	2	0	0
1	961662	.	G	A	0	2	2	0	0	2	0	0
1	970339	.	A	G	3	0	3	0	2	5	0	0
1	970637	.	C	T	7	5	12	0	0	12	0	0
1	970638	.	G	T	0	5	5	0	7	12	0	0
1	973476	.	C	T	5	2	7	0	0	7	0	0
1	980726	.	G	A	2	2	4	0	0	4	0	0
1	1606907	.	C	T	1	1	2	0	0	2	0	0
1	1606973	.	A	T	6	9	15	0	0	15	0	0
1	1607131	.	A	G	10	7	17	0	0	17	0	0
1	1609386	.	G	A	0	4	4	0	3	7	0	0
1	1609479	.	G	T	0	3	3	0	2	5	0	0
1	1627461	.	G	A	3	1	4	0	0	4	0	0
1	1718234	.	C	T	7	8	15	0	1	16	0	0
1	1718707	.	C	G	9	0	9	0	14	23	0	0
1	1718875	.	T	C	3	0	3	0	0	3	0	0
1	1721251	.	G	C	1	12	13	0	25	38	0	0
1	1721533	.	C	T	11	10	21	0	0	21	0	0
1	1721574	.	G	C	20	15	35	0	1	36	0	0
1	1721650	.	C	T	7	3	10	0	0	10	0	0
1	1721902	.	G	C	3	8	11	0	1	12	0	0
1	1723403	.	C	T	15	9	24	0	3	27	0	0
1	1723442	.	C	T	24	14	38	0	1	39	0	0
1	1724080	.	G	A	5	12	17	0	1	18	0	0
1	1724149	.	G	A	21	10	31	0	1	32	0	0
1	1724527	.	C	T	7	15	22	0	2	24	0	0
1	1732314	.	G	A	1	14	15	0	20	35	0	0
1	1732325	.	G	A	25	14	39	0	2	41	0	0
1	1884402	.	G	T	5	8	13	0	0	13	0	0
1	1884412	.	T	C	5	0	5	0	7	12	0	0
1	1890351	.	T	C	16	14	30	0	0	30	0	0
1	1890437	.	C	T	0	1	1	0	1	2	0	0
1	1893120	.	G	A	1	1	2	0	0	2	0	0
1	1893253	.	G	A	9	14	23	0	0	23	0	0
1	1893363	.	T	C	11	9	20	0	0	20	0	0
1	1893978	.	A	C	8	8	16	0	0	16	0	0
1	2101612	.	C	G	8	8	16	0	0	16	0	0
1	2129358	.	G	A	9	7	16	0	6	22	0	0
1	2186261	.	C	T	8	7	15	0	0	15	0	0
1	2190734	.	G	A	0	8	8	0	4	12	0	0
1	2214937	.	G	C	12	12	24	0	1	26	1	0
1	2215093	.	T	C	15	12	27	0	0	27	0	0
1	2215744	.	T	A	11	12	23	0	0	23	0	0
1	2216744	.	G	A	0	5	5	0	4	9	0	0
1	2217267	.	A	T	14	21	35	0	1	36	0	0
1	2270746	.	T	C	6	4	10	0	0	10	0	0
1	2270833	.	C	T	2	6	8	0	0	8	0	0
1	2279045	.	T	C	4	2	6	0	1	7	0	0
1	2279182	.	C	T	0	4	4	0	0	4	0	0
1	2279245	.	G	T	6	7	13	0	0	13	0	0
1	2279447	.	C	T	2	0	2	0	0	2	0	0
1	2285262	.	G	A	8	2	10	0	0	10	0	0
1	2285313	.	A	G	0	3	3	0	0	3	0	0
1	2288740	.	C	T	2	4	6	0	0	6	0	0
1	2294576	.	T	C	9	13	22	0	1	23	0	0
1	2294582	.	T	C	11	8	19	0	1	20	0	0
1	2296791	.	A	C	14	17	31	0	1	32	0	0
1	2296806	.	C	T	13	11	24	0	1	25	0	0
1	2298752	.	T	A	12	16	28	0	4	32	0	0
1	2298889	.	T	A	10	2	12	0	0	12	0	0
1	2299051	.	C	G	14	7	21	0	1	22	0	0
1	2299188	.	T	A	15	12	27	0	1	28	0	0
1	2299486	.	G	A	6	7	13	0	3	16	0	0
1	2423695	.	T	C	0	3	3	0	0	3	0	0
1	2426379	.	T	C	0	2	2	0	0	2	0	0
1	2430484	.	G	C	3	11	14	0	0	14	0	0
1	2431695	.	C	T	0	1	1	0	0	1	0	0
1	2443778	.	A	G	8	9	17	0	0	17	0	0
1	2443783	.	G	A	0	8	8	0	9	17	0	0
1	2443832	.	G	A	11	7	18	0	0	18	0	0
1	2443868	.	T	C	8	4	12	0	0	12	0	0
1	2443936	.	C	T	6	5	11	0	0	11	0	0
1	2444057	.	A	T	3	8	11	0	1	12	0	0
1	2444134	.	C	T	4	4	8	0	0	8	0	0
1	3104876	.	A	G	2	2	4	0	0	4	0	0
1	5357189	.	T	C	21	1	22	0	10	32	0	0
1	5357405	.	T	C	17	17	34	0	0	34	0	0
1	6166479	.	G	T	0	5	5	0	6	11	0	0
1	6210567	.	C	T	4	2	6	0	1	7	0	0
1	6226084	.	A	G	3	0	3	0	0	3	0	0
1	6226388	.	A	G	3	0	3	0	6	9	0	0
1	6234090	.	C	T	1	1	2	0	0	2	0	0
1	6238639	.	C	T	5	3	8	0	1	9	0	0
1	6241379	.	G	T	0	5	5	0	2	7	0	0
1	6241427	.	T	G	2	0	2	0	0	2	0	0
1	6243620	.	T	C	6	6	12	0	1	13	0	0
1	6243626	.	A	C	5	9	14	0	0	14	0	0
1	6243962	.	C	T	5	3	8	0	1	9	0	0
1	6243975	.	T	G	5	5	10	0	0	10	0	0
1	6244044	.	C	T	1	1	2	0	0	2	0	0
1	6244279	.	A	T	1	2	3	0	0	3	0	0
1	6244281	.	G	C	1	2	3	0	0	3	0	0
1	6247104	.	C	T	2	5	7	0	0	7	0	0
1	6247156	.	G	T	3	1	4	0	0	4	0	0
1	6248059	.	C	T	2	1	3	0	0	3	0	0
1	6252869	.	A	G	2	0	2	0	2	4	0	0
1	6252887	.	T	C	1	0	1	0	0	1	0	0
1	6262918	.	C	T	1	1	2	0	0	2	0	0
1	6359952	.	G	A	2	1	3	0	0	3	0	0
1	6365673	.	A	G	3	4	7	0	0	7	0	0
1	6365711	.	T	G	8	3	11	0	0	11	0	0
1	6366000	.	T	A	3	3	6	0	0	6	0	0
1	6366024	.	A	C	1	2	3	0	0	3	0	0
1	6403557	.	G	T	1	2	3	0	0	3	0	0
1	6404205	.	A	T	4	4	8	0	0	8	0	0
1	6404250	.	G	A	2	5	7	0	1	8	0	0
1	6404659	.	G	A	3	2	5	0	0	5	0	0
1	6494215	.	T	G	4	3	7	0	0	7	0	0
1	6918862	.	C	T	2	3	5	0	0	5	0	0
1	6918865	.	G	A	3	1	4	0	1	5	0	0
1	6924578	.	C	T	6	3	9	0	0	9	0	0
1	6924858	.	G	C	2	4	6	0	0	6	0	0
1	7447427	.	C	A	1	3	4	0	0	4	0	0
1	7447436	.	T	C	1	3	4	0	0	4	0	0
1	7447751	.	T	G	0	2	2	0	0	2	0	0
1	7518644	.	C	T	7	10	17	0	0	17	0	0
1	7523258	.	A	C	1	1	2	0	0	2	0	0
1	7523264	.	C	T	2	1	3	0	0	3	0	0
1	7526839	.	G	A	2	7	9	0	0	9	0	0
1	7528289	.	G	C	1	20	21	0	25	46	0	0
1	7530123	.	C	T	1	0	1	0	0	1	0	0
1	7538822	.	C	T	11	13	24	0	0	24	0	0
1	7538971	.	T	C	24	22	46	0	1	47	0	0
1	7539000	.	C	A	16	24	40	0	3	43	0	0
1	7539053	.	G	C	9	17	26	0	0	26	0	0
1	7539074	.	A	C	9	15	24	0	0	24	0	0
1	7539531	.	G	A	5	7	12	0	1	13	0	0
1	7557132	.	C	T	5	2	7	0	0	7	0	0
1	7560705	.	T	A	12	16	28	0	0	28	0	0
1	7659738	.	C	A	3	3	6	0	0	6	0	0
1	7659748	.	A	G	3	3	6	0	0	6	0	0
1	7662275	.	T	C	14	24	38	0	1	39	0	0
1	7662628	.	G	A	18	22	40	0	1	41	0	0
1	7662880	.	A	T	24	17	41	0	0	41	0	0
1	7662949	.	C	T	19	30	49	0	2	51	0	0
1	7668211	.	A	G	13	23	36	0	0	36	0	0
1	7668298	.	C	T	14	11	25	0	1	26	0	0
1	7673070	.	C	T	18	14	32	0	5	37	0	0
1	7673129	.	C	A	10	17	27	0	1	28	0	0
1	7682912	.	A	C	3	8	11	0	1	12	0	0
1	7682923	.	A	G	6	6	12	0	0	12	0	0
1	7682949	.	G	A	2	7	9	0	0	9	0	0
1	7853375	.	T	G	6	3	9	0	1	10	0	0
1	7853399	.	G	A	7	6	13	0	0	13	0	0
1	7859852	.	G	A	1	1	2	0	0	2	0	0
1	7859874	.	G	A	1	1	2	0	0	2	0	0
1	7875073	.	C	T	0	3	3	0	3	6	0	0
1	7894186	.	C	T	2	3	5	0	0	5	0	0
1	8022503	.	T	A	11	11	22	0	0	22	0	0
1	8022505	.	T	C	11	11	22	0	0	22	0	0
1	8022817	.	T	A	13	17	30	0	3	33	0	0
1	8023471	.	A	T	6	13	19	0	1	20	0	0
1	8023490	.	A	C	5	9	14	0	1	15	0	0
1	8023559	.	A	T	13	16	29	0	0	29	0	0
1	8023587	.	A	G	15	13	28	0	0	28	0	0
1	8023639	.	C	A	18	13	31	0	2	33	0	0
1	8023658	.	A	T	14	13	27	0	1	29	1	0
1	8023730	.	C	T	13	16	29	0	2	31	0	0
1	8026148	.	T	G	9	19	28	0	2	30	0	0
1	8026404	.	T	A	18	14	32	0	1	34	1	0
1	8026415	.	C	T	0	18	18	0	15	33	0	0
1	8026478	.	T	C	24	0	24	0	10	34	0	0
1	8026975	.	T	C	10	4	14	0	0	14	0	0
1	8028177	.	T	A	2	9	11	0	1	12	0	0
1	8028696	.	G	T	12	14	26	0	1	27	0	0
1	8028912	.	G	C	12	9	21	0	0	21	0	0
1	8028925	.	C	A	10	9	19	0	0	19	0	0
1	8028979	.	G	A	13	6	19	0	0	19	0	0
1	8029002	.	T	A	2	15	17	0	2	19	0	0
1	8032956	.	G	C	5	6	11	0	0	11	0	0
1	8049495	.	C	T	0	6	6	0	2	8	0	0
1	8051513	.	G	A	5	3	8	0	0	8	0	0
1	8051528	.	C	T	0	5	5	0	4	9	0	0
1	8055927	.	T	C	2	0	2	0	3	5	0	0
1	8162990	.	G	A	1	1	2	0	0	2	0	0
1	8165609	.	C	T	10	11	21	0	0	21	0	0
1	8165667	.	T	C	5	4	9	0	0	9	0	0
1	8165769	.	T	A	2	4	6	0	0	6	0	0
1	8165802	.	C	T	2	6	8	0	0	8	0	0
1	8165937	.	G	A	6	4	10	0	0	10	0	0
1	8165947	.	C	T	5	4	9	0	0	9	0	0
1	8166066	.	G	T	2	2	4	0	0	4	0	0
1	8166788	.	A	T	3	10	13	0	0	13	0	0
1	8167152	.	T	C	1	3	4	0	0	4	0	0
1	8167319	.	A	G	3	4	7	0	0	7	0	0
1	8167383	.	G	A	6	7	13	0	2	15	0	0
1	8167526	.	C	T	8	6	14	0	1	15	0	0
1	8167668	.	G	A	7	9	16	0	0	16	0	0
1	8169262	.	C	T	0	1	1	0	0	1	0	0
1	8169268	.	C	T	1	1	2	0	0	2	0	0
1	8169361	.	G	A	4	9	13	0	1	14	0	0
1	8192102	.	G	A	1	1	2	0	1	3	0	0
1	8367289	.	C	A	2	2	4	0	0	4	0	0
1	8403299	.	G	A	0	2	2	0	1	3	0	0
1	8403331	.	C	T	2	2	4	0	0	4	0	0
1	8403438	.	A	C	1	2	3	0	0	3	0	0
1	8417896	.	T	C	13	33	46	0	1	47	0	0
1	8418058	.	T	A	8	12	20	0	0	20	0	0
1	8422521	.	A	G	14	18	32	0	2	34	0	0
1	8424735	.	G	A	18	17	35	0	1	36	0	0
1	8527007	.	G	A	4	5	9	0	0	9	0	0
1	8527205	.	G	T	0	2	2	0	0	2	0	0
1	8529868	.	G	A	4	2	6	0	0	6	0	0
1	8529888	.	G	A	0	5	5	0	2	7	0	0
1	8531249	.	G	T	0	5	5	0	0	5	0	0
1	8531505	.	T	C	2	6	8	0	0	8	0	0
1	8550062	.	A	G	1	2	3	0	0	3	0	0
1	8550143	.	T	C	1	0	1	0	1	2	0	0
1	8550146	.	T	C	1	1	2	0	0	2	0	0
1	8557075	.	G	A	4	7	11	0	0	11	0	0
1	8557159	.	T	A	1	0	1	0	0	1	0	0
1	8560072	.	A	G	4	2	6	0	0	6	0	0
1	8560237	.	C	T	6	1	7	0	0	7	0	0
1	8560266	.	C	T	6	3	9	0	0	9	0	0
1	8560289	.	C	T	4	3	7	0	1	8	0	0
1	8562005	.	G	C	2	1	3	0	1	4	0	0
1	8563792	.	G	A	3	2	5	0	0	5	0	0
1	8566188	.	T	G	4	3	7	0	0	7	0	0
1	8566467	.	G	A	2	2	4	0	0	4	0	0
1	8566485	.	T	C	3	2	5	0	1	6	0	0
1	8601971	.	A	T	8	11	19	0	1	20	0	0
1	8601990	.	A	T	8	12	20	0	1	21	0	0
1	8606561	.	C	T	2	4	6	0	0	6	0	0
1	8606632	.	C	T	4	11	15	0	0	15	0	0
1	8606767	.	G	A	2	5	7	0	1	8	0	0
1	8607547	.	C	T	4	6	10	0	0	10	0	0
1	8607556	.	T	C	3	5	8	0	0	8	0	0
1	8608300	.	C	T	4	6	10	0	1	11	0	0
1	8610548	.	C	A	11	5	16	0	1	17	0	0
1	8638537	.	T	G	2	5	7	0	1	8	0	0
1	8639877	.	G	A	2	3	5	0	0	5	0	0
1	8639883	.	G	A	3	2	5	0	0	5	0	0
1	8642680	.	G	A	0	1	1	0	1	2	0	0
1	8642800	.	C	T	6	3	9	0	1	10	0	0
1	8642824	.	A	T	3	2	5	0	0	5	0	0
1	8642938	.	A	G	3	6	9	0	0	9	0	0
1	8642953	.	C	T	2	8	10	0	1	11	0	0
1	8643112	.	G	C	1	2	3	0	1	4	0	0
1	8649726	.	A	G	11	14	25	0	0	25	0	0
1	8649865	.	C	T	16	21	37	0	2	39	0	0
1	8649988	.	A	G	10	13	23	0	3	26	0	0
1	8649994	.	A	T	10	9	19	0	2	21	0	0
1	8650317	.	G	A	26	33	59	0	4	63	0	0
1	8650371	.	C	T	31	28	59	0	8	67	0	0
1	8650830	.	T	G	6	2	8	0	0	8	0	0
1	8651036	.	G	A	19	25	44	0	0	44	0	0
1	8651060	.	T	C	15	13	28	0	0	28	0	0
1	8651576	.	G	A	18	18	36	0	0	36	0	0
1	8662553	.	G	A	12	24	36	0	1	37	0	0
1	8663048	.	G	A	3	20	23	0	13	36	0	0
1	8663195	.	T	G	21	15	36	0	2	38	0	0
1	8663295	.	T	C	16	23	39	0	2	41	0	0
1	8667377	.	G	A	10	9	19	0	0	19	0	0
1	8667606	.	C	T	12	19	31	0	0	31	0	0
1	8668166	.	T	C	17	30	47	0	2	49	0	0
1	8668238	.	G	T	24	18	42	0	1	43	0	0
1	8668866	.	T	C	1	2	3	0	0	3	0	0
1	8668886	.	T	C	0	2	2	0	0	7	5	0
1	8668930	.	A	T	3	7	10	0	0	10	0	0
1	8669533	.	G	T	12	0	12	0	0	12	0	0
1	8669543	.	A	G	3	8	11	0	0	11	0	0
1	8669669	.	A	G	11	14	25	0	0	25	0	0
1	8669717	.	T	G	17	13	30	0	1	31	0	0
1	8669718	.	T	C	17	13	30	0	1	31	0	0
1	8669753	.	T	A	14	12	26	0	1	27	0	0
1	8669847	.	G	T	28	13	41	0	4	45	0	0
1	8670031	.	T	C	25	30	55	0	4	59	0	0
1	8670032	.	G	T	5	23	28	0	31	59	0	0
1	8670402	.	G	A	16	15	31	0	1	32	0	0
1	8670478	.	T	C	1	2	3	0	0	3	0	0
1	8694404	.	G	A	15	15	30	0	3	33	0	0
1	8698765	.	T	C	18	20	38	0	3	41	0	0
1	8698799	.	C	T	20	18	38	0	2	40	0	0
1	8698834	.	T	A	11	14	25	0	2	27	0	0
1	8701548	.	A	G	15	1	16	0	22	38	0	0
1	8701623	.	C	T	26	18	44	0	3	47	0	0
1	8701747	.	G	A	14	13	27	1	2	30	0	0
1	8702158	.	G	A	17	7	24	0	1	25	0	0
1	8702325	.	G	T	19	17	36	0	1	37	0	0
1	8763824	.	A	G	0	4	4	0	1	5	0	0
1	8764123	.	C	T	2	2	4	0	1	5	0	0
1	8764612	.	T	C	6	0	6	0	10	16	0	0
1	8764661	.	T	A	10	13	23	0	1	24	0	0
1	8764729	.	C	T	17	9	26	0	1	27	0	0
1	8764760	.	G	A	19	9	28	0	1	29	0	0
1	8764811	.	C	T	0	7	7	0	9	16	0	0
1	8764812	.	G	A	9	7	16	0	0	16	0	0
1	8765315	.	A	G	19	18	37	0	3	41	1	0
1	8765422	.	G	A	10	22	32	0	0	33	1	0
1	8765713	.	A	C	17	20	37	0	3	40	0	0
1	8765724	.	A	G	19	23	42	0	1	43	0	0
1	8766267	.	T	C	16	0	16	0	12	28	0	0
1	8766453	.	C	T	14	13	27	0	0	27	0	0
1	8766471	.	C	T	1	11	12	0	11	23	0	0
1	8766501	.	C	T	8	15	23	0	0	23	0	0
1	8766693	.	G	A	12	12	24	0	0	24	0	0
1	8767002	.	C	T	13	10	23	0	3	26	0	0
1	8767080	.	G	A	11	16	27	0	0	27	0	0
1	8767155	.	C	T	10	8	18	0	3	21	0	0
1	8767185	.	T	C	7	10	17	0	0	17	0	0
1	8767260	.	T	C	11	7	18	0	0	18	0	0
1	8767395	.	A	G	7	9	16	0	1	17	0	0
1	8767536	.	T	C	6	1	7	0	7	14	0	0
1	8767629	.	G	A	11	7	18	0	0	18	0	0
1	8767725	.	T	C	5	6	11	0	0	11	0	0
1	8768307	.	A	G	7	4	11	0	0	11	0	0
1	8770773	.	G	A	2	2	4	0	1	5	0	0
1	8771020	.	T	G	7	1	8	0	0	8	0	0
1	8773269	.	T	C	3	5	8	0	1	9	0	0
1	8773320	.	G	A	8	3	11	0	0	11	0	0
1	8776497	.	A	G	8	5	13	0	0	13	0	0
1	8810701	.	T	G	6	4	10	0	2	12	0	0
1	8810986	.	T	C	2	0	2	0	4	6	0	0
1	8917623	.	C	T	7	6	13	0	0	13	0	0
1	8974695	.	A	T	3	8	11	0	1	12	0	0
1	8975415	.	T	C	1	3	4	0	0	4	0	0
1	9004942	.	T	C	13	16	29	0	0	29	0	0
1	9044745	.	C	T	6	6	12	0	1	13	0	0
1	9051092	.	T	C	4	6	10	0	0	10	0	0
1	9056045	.	T	G	2	2	4	0	0	5	1	0
1	9056886	.	T	C	15	12	27	0	0	27	0	0
1	9064611	.	T	C	4	4	8	0	1	9	0	0
1	9064791	.	C	A	4	3	7	0	1	8	0	0
1	9064864	.	T	C	5	3	8	0	0	8	0	0
1	9064885	.	C	A	2	2	4	0	0	4	0	0
1	9074440	.	T	C	16	18	34	0	1	35	0	0
1	9118497	.	T	A	8	9	17	0	1	18	0	0
1	9123262	.	A	G	9	3	12	0	0	12	0	0
1	9161423	.	G	A	0	2	2	0	1	3	0	0
1	9262077	.	A	G	9	12	21	0	1	22	0	0
1	9262080	.	A	G	8	12	20	0	1	21	0	0
1	9265578	.	T	C	5	5	10	0	0	10	0	0
1	9270198	.	T	C	2	0	2	0	0	2	0	0
1	9273347	.	A	G	4	1	5	0	0	5	0	0
1	9273947	.	G	C	2	2	4	0	0	4	0	0
1	9276360	.	T	C	2	0	2	0	3	5	0	0
1	9276420	.	C	T	3	4	7	0	0	7	0	0
1	9277858	.	T	C	11	9	20	0	1	21	0	0
1	9278150	.	G	A	4	6	10	0	0	10	0	0
1	9290432	.	T	A	1	5	6	0	2	8	0	0
1	9290500	.	G	T	3	0	3	0	0	3	0	0
1	9293041	.	C	T	9	6	15	0	2	17	0	0
1	9293117	.	G	A	2	8	10	0	7	17	0	0
1	9293156	.	G	A	7	12	19	0	3	22	0	0
1	9293185	.	T	C	6	11	17	0	2	19	0	0
1	9293215	.	G	A	10	10	20	0	0	20	0	0
1	9293495	.	A	G	10	8	18	0	3	21	0	0
1	9293580	.	C	T	13	11	24	0	2	26	0	0
1	9293740	.	T	C	8	3	11	0	0	11	0	0
1	9293889	.	C	A	3	3	6	0	0	6	0	0
1	9474416	.	C	G	1	2	3	0	0	3	0	0
1	9474418	.	C	A	1	2	3	0	0	3	0	0
1	9475473	.	T	C	1	2	3	0	1	4	0	0
1	9499764	.	C	T	8	9	17	0	1	18	0	0
1	9500332	.	T	C	2	8	10	0	0	10	0	0
1	9500361	.	T	C	3	2	5	0	0	5	0	0
1	9500502	.	G	T	3	3	6	0	0	6	0	0
1	9500508	.	C	A	3	3	6	0	0	6	0	0
1	9500585	.	T	G	2	6	8	0	0	9	1	0
1	9500598	.	T	G	2	3	5	0	0	7	2	0
1	9500757	.	A	T	5	4	9	0	1	10	0	0
1	9500835	.	A	G	6	7	13	0	1	14	0	0
1	9500947	.	G	T	4	11	15	0	1	16	0	0
1	9500984	.	A	T	1	8	9	0	0	9	0	0
1	9501229	.	C	T	9	15	24	0	3	27	0	0
1	9501231	.	G	A	17	9	26	0	1	27	0	0
1	9501365	.	T	C	14	0	14	0	11	25	0	0
1	9501394	.	T	A	7	10	17	0	0	17	0	0
1	9508752	.	T	A	12	12	24	0	1	25	0	0
1	9510571	.	A	G	2	2	4	0	0	4	0	0
1	9510574	.	G	A	2	2	4	0	0	4	0	0
1	9512342	.	C	T	1	2	3	0	0	3	0	0
1	9516905	.	A	C	1	4	5	0	0	5	0	0
1	9517048	.	A	G	2	2	4	0	0	4	0	0
1	9517102	.	G	A	2	1	3	0	0	3	0	0
1	9520435	.	G	A	2	2	4	0	0	4	0	0
1	9523283	.	C	T	0	4	4	0	8	12	0	0
1	9527076	.	T	A	3	6	9	0	1	10	0	0
1	9557242	.	G	T	0	3	3	0	4	7	0	0
1	9618241	.	A	G	1	0	1	0	0	1	0	0
1	9708694	.	T	C	3	2	5	0	0	5	0	0
1	9708707	.	T	C	2	2	4	0	0	4	0	0
1	9708747	.	C	A	1	5	6	0	1	7	0	0
1	9708818	.	G	T	1	3	4	0	0	4	0	0
1	9709280	.	G	A	4	5	9	0	0	9	0	0
1	9709340	.	C	T	5	5	10	0	0	10	0	0
1	9710759	.	C	T	6	5	11	0	0	11	0	0
1	9711158	.	G	A	4	2	6	0	0	6	0	0
1	9711161	.	G	A	4	2	6	0	0	6	0	0
1	9711405	.	T	A	1	3	4	0	0	4	0	0
1	9711593	.	A	C	6	6	12	0	1	13	0	0
1	9711740	.	G	C	3	4	7	0	1	8	0	0
1	9711956	.	A	G	4	6	10	0	1	11	0	0
1	9712111	.	G	A	1	3	4	0	6	10	0	0
1	9712253	.	T	A	1	4	5	0	0	5	0	0
1	9712266	.	G	T	0	2	2	0	0	2	0	0
1	9740567	.	A	T	0	2	2	0	0	2	0	0
1	9740960	.	A	T	2	4	6	0	0	6	0	0
1	9740989	.	T	A	3	5	8	0	1	9	0	0
1	9793286	.	C	T	3	4	7	0	1	8	0	0
1	9793336	.	T	C	1	0	1	0	0	1	0	0
1	9808324	.	A	G	3	1	4	0	0	4	0	0
1	9808345	.	T	A	3	1	4	0	0	4	0	0
1	9863320	.	G	A	0	1	1	0	0	1	0	0
1	9866554	.	A	C	2	2	4	0	0	4	0	0
1	9873485	.	G	A	1	5	6	0	1	7	0	0
1	9873509	.	G	A	1	6	7	0	0	7	0	0
1	9873538	.	G	A	3	6	9	0	0	9	0	0
1	9873607	.	A	T	6	2	8	0	3	11	0	0
1	9873616	.	T	C	6	0	6	0	6	12	0	0
1	9873787	.	G	A	1	4	5	0	0	5	0	0
1	9880387	.	A	G	5	2	7	0	1	8	0	0
1	9909867	.	C	A	1	1	2	0	0	2	0	0
1	9914164	.	C	T	3	3	6	0	0	6	0	0
1	9914200	.	A	G	2	0	2	0	0	2	0	0
1	10738177	.	A	G	20	14	34	1	1	36	0	0
1	11695068	.	C	A	2	0	2	0	0	2	0	0
1	11783388	.	T	C	10	26	36	0	1	37	0	0
1	11783504	.	T	C	20	15	35	0	0	35	0	0
1	11783650	.	T	C	21	26	47	0	1	48	0	0
1	15138708	.	A	C	10	9	19	0	0	19	0	0
1	15139336	.	T	C	6	6	12	0	0	12	0	0
1	15139576	.	G	A	6	4	10	0	0	10	0	0
1	15140407	.	C	T	5	4	9	0	1	10	0	0
1	15142631	.	T	C	7	11	18	0	0	18	0	0
1	15200277	.	T	C	4	6	10	0	1	11	0	0
1	15200440	.	A	G	17	1	18	0	21	39	0	0
1	15200517	.	A	T	14	13	27	0	3	30	0	0
1	15200595	.	A	G	14	19	33	0	1	34	0	0
1	15200730	.	G	C	2	16	18	0	12	30	0	0
1	15200777	.	T	C	18	16	34	0	1	35	0	0
1	15201264	.	A	C	13	12	25	0	0	25	0	0
1	15201491	.	A	G	20	12	32	0	0	32	0	0
1	15201603	.	C	T	8	13	21	0	1	22	0	0
1	15201732	.	T	G	12	13	25	0	0	25	0	0
1	15201889	.	G	T	0	17	17	0	16	33	0	0
1	15201931	.	A	T	15	14	29	0	1	30	0	0
1	15202287	.	G	A	20	18	38	0	0	38	0	0
1	15202716	.	G	T	12	21	33	0	3	36	0	0
1	15203038	.	T	C	9	15	24	0	2	26	0	0
1	15203056	.	T	C	10	16	26	0	1	27	0	0
1	15230428	.	C	G	4	2	6	0	0	6	0	0
1	15240166	.	C	T	1	0	1	0	0	1	0	0
1	15242916	.	C	T	0	2	2	0	0	2	0	0
1	15253337	.	T	A	0	2	2	0	1	3	0	0
1	15253705	.	A	G	5	6	11	0	2	13	0	0
1	15253732	.	T	G	10	4	14	0	3	17	0	0
1	15254077	.	A	G	3	4	7	0	0	7	0	0
1	15254084	.	A	G	3	3	6	0	0	6	0	0
1	15254249	.	A	G	8	0	8	0	9	17	0	0
1	15254351	.	T	G	9	11	20	0	1	21	0	0
1	15254468	.	T	C	2	8	10	0	1	11	0	0
1	15254866	.	G	A	0	9	9	0	7	16	0	0
1	15255411	.	T	C	4	8	12	0	0	12	0	0
1	15255424	.	A	G	4	0	4	0	6	10	0	0
1	15255468	.	G	A	3	3	6	0	1	7	0	0
1	15255597	.	A	T	9	9	18	0	0	19	1	0
1	15255699	.	T	A	7	5	12	0	1	13	0	0
1	15255703	.	T	C	7	6	13	0	0	13	0	0
1	15255799	.	G	A	1	2	3	0	0	3	0	0
1	15255877	.	A	C	5	5	10	0	0	10	0	0
1	15256204	.	A	G	2	2	4	0	0	4	0	0
1	15259036	.	G	A	6	7	13	0	1	14	0	0
1	15259178	.	C	A	2	3	5	0	1	6	0	0
1	15269519	.	C	A	4	4	8	0	0	8	0	0
1	15284984	.	T	C	4	4	8	0	1	9	0	0
1	15293547	.	G	T	8	7	15	0	1	16	0	0
1	15294701	.	C	T	0	1	1	0	4	5	0	0
1	15297504	.	C	T	0	5	5	0	4	9	0	0
1	15306320	.	T	C	2	0	2	0	0	2	0	0
1	15312766	.	C	G	6	3	9	0	0	9	0	0
1	15312813	.	A	G	4	4	8	0	0	8	0	0
1	15313302	.	G	A	0	3	3	0	0	3	0	0
1	15491592	.	T	A	1	2	3	0	0	3	0	0
1	15712356	.	G	T	1	2	3	0	0	3	0	0
1	15764411	.	C	A	0	1	1	0	1	2	0	0
1	16127926	.	C	T	15	20	35	0	0	35	0	0
1	16127962	.	G	A	7	11	18	0	1	19	0	0
1	16152840	.	G	A	1	17	18	0	4	22	0	0
1	16153607	.	G	A	6	7	13	0	0	13	0	0
1	16548908	.	C	T	3	3	6	0	1	7	0	0
1	16559907	.	T	C	6	11	17	0	0	17	0	0
1	16565049	.	C	A	1	3	4	0	1	5	0	0
1	16574059	.	G	T	0	9	9	0	4	13	0	0
1	16574149	.	C	T	1	4	5	0	0	5	0	0
1	16574154	.	T	C	1	4	5	0	0	5	0	0
1	16574214	.	G	T	2	7	9	0	0	9	0	0
1	16574417	.	G	A	2	4	6	0	0	6	0	0
1	16609231	.	C	T	12	10	22	0	0	22	0	0
1	16614590	.	T	C	8	6	14	0	1	15	0	0
1	16616881	.	A	T	18	21	39	0	1	40	0	0
1	16617296	.	T	C	4	6	10	0	0	10	0	0
1	16626561	.	A	G	1	2	3	0	0	3	0	0
1	16629853	.	T	C	1	2	3	0	0	3	0	0
1	16633611	.	T	A	2	7	9	0	0	9	0	0
1	16633629	.	C	T	8	2	10	0	0	10	0	0
1	16633665	.	T	C	0	5	5	0	0	5	0	0
1	16634129	.	C	T	4	9	13	0	0	13	0	0
1	16634654	.	A	G	3	4	7	0	0	7	0	0
1	16635013	.	C	T	5	5	10	0	0	10	0	0
1	16635039	.	G	A	0	4	4	0	4	8	0	0
1	16635055	.	T	C	5	2	7	0	0	7	0	0
1	16635341	.	T	C	2	4	6	0	1	7	0	0
1	16635596	.	C	T	3	6	9	0	1	10	0	0
1	16637955	.	T	C	10	6	16	0	0	16	0	0
1	16638189	.	G	A	2	12	14	0	0	14	0	0
1	16638464	.	T	C	3	9	12	0	0	12	0	0
1	16638575	.	C	T	0	2	2	0	0	2	0	0
1	16639396	.	A	G	0	1	1	0	0	1	0	0
1	16639501	.	T	C	8	9	17	0	2	19	0	0
1	16639732	.	C	T	8	6	14	0	0	14	0	0
1	16640081	.	G	T	7	12	19	0	1	20	0	0
1	16640138	.	A	G	10	0	10	0	10	20	0	0
1	16640277	.	T	C	6	4	10	0	3	13	0	0
1	16642684	.	T	C	11	10	21	0	0	21	0	0
1	16642770	.	G	A	3	3	6	0	0	6	0	0
1	16646372	.	G	A	0	1	1	0	0	1	0	0
1	16646405	.	C	T	2	2	4	0	1	5	0	0
1	16646833	.	C	G	7	1	8	0	5	13	0	0
1	16646848	.	T	A	4	4	8	0	0	8	0	0
1	16647928	.	G	T	6	7	13	0	0	13	0	0
1	16649950	.	C	A	3	1	4	0	0	4	0	0
1	16650067	.	T	A	2	3	5	0	1	6	0	0
1	16650350	.	T	A	0	3	3	0	0	3	0	0
1	16650433	.	G	A	8	10	18	0	0	18	0	0
1	16650463	.	C	T	16	11	27	0	1	28	0	0
1	16653552	.	A	T	5	8	13	0	0	13	0	0
1	16653655	.	C	T	10	16	26	0	1	27	0	0
1	16653923	.	T	C	8	13	21	0	2	23	0	0
1	16653991	.	G	C	12	7	19	0	0	19	0	0
1	16654387	.	A	C	0	2	2	0	0	2	0	0
1	16654487	.	T	A	4	4	8	0	0	8	0	0
1	16654572	.	A	G	7	5	12	0	1	13	0	0
1	16654657	.	T	G	5	7	12	0	0	12	0	0
1	16655077	.	C	T	5	4	9	0	0	9	0	0
1	16655134	.	G	A	0	1	1	0	0	1	0	0
1	16656828	.	C	T	2	2	4	0	0	4	0	0
1	16657862	.	T	C	5	0	5	0	4	9	0	0
1	16675255	.	G	T	6	5	11	0	1	12	0	0
1	16675263	.	A	T	7	4	11	0	0	11	0	0
1	16675293	.	A	G	4	4	8	0	1	9	0	0
1	16675380	.	A	T	8	8	16	0	0	16	0	0
1	16675564	.	T	A	7	12	19	0	0	19	0	0
1	16675615	.	T	C	5	0	5	0	8	13	0	0
1	16679950	.	G	T	8	6	14	0	3	17	0	0
1	16679956	.	A	T	9	7	16	0	1	17	0	0
1	16688911	.	G	T	8	9	17	0	0	17	0	0
1	17481349	.	A	T	3	5	8	0	0	8	0	0
1	17481676	.	T	C	1	2	3	0	0	3	0	0
1	17482898	.	T	A	4	2	6	0	0	6	0	0
1	17482970	.	C	T	2	3	5	0	0	5	0	0
1	17483809	.	C	A	3	3	6	0	0	6	0	0
1	17484724	.	A	G	3	6	9	0	1	10	0	0
1	17487170	.	A	G	3	0	3	0	0	3	0	0
1	17491536	.	C	T	5	4	9	0	0	9	0	0
1	17496233	.	C	A	1	0	1	0	0	1	0	0
1	17496245	.	T	C	1	2	3	0	0	3	0	0
1	17496394	.	C	T	11	6	17	0	0	17	0	0
1	17496506	.	A	G	10	11	21	0	1	22	0	0
1	17497479	.	C	T	5	2	7	0	0	7	0	0
1	17500257	.	T	C	5	8	13	0	0	13	0	0
1	17500275	.	A	G	3	0	3	0	5	8	0	0
1	17505138	.	T	C	13	12	25	0	1	26	0	0
1	17505676	.	A	G	8	12	20	0	0	20	0	0
1	17505759	.	T	C	3	10	13	0	0	13	0	0
1	17509715	.	C	T	5	13	18	0	0	18	0	0
1	17509754	.	T	C	5	18	23	0	1	24	0	0
1	17509861	.	A	G	3	5	8	0	0	8	0	0
1	17510038	.	T	C	4	1	5	0	0	5	0	0
1	17513463	.	C	T	17	16	33	0	2	35	0	0
1	17513496	.	T	C	17	18	35	0	2	38	1	0
1	17513562	.	A	G	12	1	13	0	16	29	0	0
1	17513574	.	T	A	10	18	28	0	1	29	0	0
1	17515145	.	G	C	6	6	12	0	0	12	0	0
1	17522001	.	C	A	12	24	36	0	7	43	0	0
1	17522031	.	T	C	13	24	37	0	6	43	0	0
1	17522098	.	T	A	25	19	44	0	4	48	0	0
1	17522107	.	T	C	22	26	48	0	3	51	0	0
1	17522249	.	G	T	16	11	27	0	11	38	0	0
1	17522313	.	C	T	17	12	29	0	2	31	0	0
1	17522647	.	C	T	9	10	19	0	3	22	0	0
1	17522755	.	C	T	15	6	21	0	2	23	0	0
1	17522801	.	A	G	19	8	27	0	2	29	0	0
1	17522868	.	A	G	22	0	22	0	15	37	0	0
1	17522923	.	C	T	16	18	34	0	0	34	0	0
1	17523030	.	A	G	11	2	13	0	10	23	0	0
1	17523054	.	T	C	13	17	30	0	1	31	0	0
1	17523080	.	T	C	9	27	36	0	2	38	0	0
1	17523119	.	T	A	12	25	37	0	1	38	0	0
1	17523170	.	A	G	15	12	27	0	2	29	0	0
1	17523350	.	T	C	11	14	25	0	2	27	0	0
1	17523562	.	T	C	4	3	7	0	1	8	0	0
1	17523891	.	G	A	16	13	29	0	1	30	0	0
1	17523934	.	A	G	18	0	18	0	7	25	0	0
1	17524150	.	A	T	15	9	24	0	2	26	0	0
1	17524385	.	A	T	6	2	8	0	0	8	0	0
1	17524452	.	G	A	0	1	1	0	9	10	0	0
1	17524508	.	G	C	9	8	17	0	1	18	0	0
1	17524562	.	T	C	16	15	31	0	1	32	0	0
1	17531731	.	C	A	4	2	6	0	0	6	0	0
1	17531762	.	T	A	5	2	7	0	0	7	0	0
1	17534599	.	G	A	4	4	8	0	0	8	0	0
1	17534734	.	C	T	2	5	7	0	0	7	0	0
1	17534764	.	T	C	5	6	11	0	0	11	0	0
1	17534870	.	G	A	0	7	7	0	8	15	0	0
1	17534892	.	A	T	8	7	15	0	1	16	0	0
1	17534952	.	T	G	3	6	9	0	0	9	0	0
1	17534962	.	G	A	3	7	10	0	0	10	0	0
1	17535015	.	G	A	1	7	8	0	1	9	0	0
1	17535021	.	G	A	1	8	9	0	0	9	0	0
1	17535150	.	G	T	1	3	4	0	0	4	0	0
1	17535214	.	C	T	2	6	8	0	1	9	0	0
1	17535245	.	T	C	4	7	11	0	0	11	0	0
1	17535281	.	A	G	1	3	4	0	2	6	0	0
1	17535295	.	A	G	4	1	5	0	1	6	0	0
1	17535334	.	G	A	0	4	4	0	2	6	0	0
1	17535349	.	C	T	2	6	8	0	0	8	0	0
1	17535442	.	G	A	6	7	13	0	1	14	0	0
1	17535461	.	T	G	7	6	13	0	0	13	0	0
1	17535493	.	G	A	0	7	7	0	5	12	0	0
1	17537709	.	A	G	7	16	23	0	0	23	0	0
1	17537731	.	T	C	11	17	28	0	1	29	0	0
1	17538164	.	A	G	7	3	10	0	0	10	0	0
1	17538198	.	T	C	12	3	15	0	0	15	0	0
1	17538751	.	T	C	8	0	8	0	6	14	0	0
1	17538823	.	A	G	8	6	14	0	1	15	0	0
1	17538852	.	A	G	7	9	16	0	0	16	0	0
1	17539011	.	T	G	7	10	17	0	1	18	0	0
1	17539171	.	T	A	3	3	6	0	0	6	0	0
1	17539212	.	G	A	3	2	5	0	1	6	0	0
1	17542951	.	A	G	4	3	7	0	0	7	0	0
1	17546586	.	A	T	2	3	5	0	0	5	0	0
1	17546655	.	A	C	0	3	3	1	0	4	0	0
1	17546827	.	C	T	2	0	2	0	0	2	0	0
1	17554050	.	A	G	3	1	4	0	0	4	0	0
1	17555209	.	T	C	3	2	5	0	0	5	0	0
1	17555218	.	C	T	3	2	5	0	0	5	0	0
1	17565727	.	G	A	3	6	9	0	0	9	0	0
1	17565736	.	A	G	2	6	8	0	1	9	0	0
1	17565893	.	G	A	1	0	1	0	0	1	0	0
1	17663086	.	G	A	1	1	2	0	0	2	0	0
1	17681203	.	G	A	2	2	4	0	0	4	0	0
1	17683203	.	A	T	4	6	10	0	0	10	0	0
1	17688762	.	A	G	8	9	17	0	1	18	0	0
1	17688868	.	A	C	3	7	10	0	2	12	0	0
1	17689173	.	T	C	2	10	12	0	0	12	0	0
1	17689182	.	T	C	3	0	3	0	9	12	0	0
1	17693082	.	G	C	3	0	3	0	0	3	0	0
1	17693156	.	A	T	2	5	7	0	0	7	0	0
1	17693218	.	C	T	1	5	6	0	0	6	0	0
1	17698434	.	A	G	1	2	3	0	0	3	0	0
1	17698646	.	A	T	1	4	5	0	0	5	0	0
1	17699529	.	T	A	1	2	3	0	0	3	0	0
1	17699534	.	A	G	1	3	4	0	1	5	0	0
1	17699650	.	A	G	9	3	12	0	0	12	0	0
1	17701890	.	T	G	1	0	1	0	0	1	0	0
1	17702512	.	T	A	10	6	16	0	0	16	0	0
1	17704125	.	C	T	0	1	1	0	0	1	0	0
1	17704155	.	A	G	2	5	7	0	0	7	0	0
1	17708635	.	G	A	13	5	18	0	0	18	0	0
1	17711097	.	G	T	2	3	5	0	1	6	0	0
1	17711346	.	G	A	1	2	3	0	0	3	0	0
1	17711596	.	T	A	0	1	1	0	0	1	0	0
1	17711623	.	C	T	0	1	1	0	0	1	0	0
1	17747841	.	G	C	4	2	6	0	0	6	0	0
1	17747849	.	T	A	5	2	7	0	0	7	0	0
1	17761911	.	A	G	2	3	5	0	0	5	0	0
1	17762133	.	T	C	1	3	4	0	0	4	0	0
1	17784124	.	G	A	0	1	1	0	0	1	0	0
1	17789577	.	C	T	0	1	1	0	0	1	0	0
1	18363861	.	C	T	1	3	4	0	0	4	0	0
1	18363880	.	A	C	1	0	1	0	2	3	0	0
1	18373398	.	G	T	2	3	5	0	1	6	0	0
1	18375662	.	T	A	1	2	3	0	0	3	0	0
1	18377690	.	G	C	5	0	5	0	3	8	0	0
1	18399323	.	G	A	0	1	1	0	0	1	0	0
1	18445766	.	G	T	1	3	4	0	0	4	0	0
1	18445792	.	G	T	1	2	3	0	0	3	0	0
1	18446152	.	G	A	5	2	7	0	0	7	0	0
1	18581402	.	G	A	0	1	1	0	0	1	0	0
1	18585076	.	C	T	0	0	0	0	1	1	0	0
1	18587333	.	A	T	2	2	4	0	0	4	0	0
1	18595123	.	T	C	2	2	4	0	0	4	0	0
1	18595227	.	T	A	1	2	3	0	0	3	0	0
1	18595236	.	T	C	1	0	1	0	2	3	0	0
1	18780360	.	T	A	2	2	4	0	0	4	0	0
1	18921637	.	A	C	0	1	1	0	6	7	0	0
1	19872320	.	G	A	0	4	4	0	0	4	0	0
1	19874549	.	A	G	0	1	1	0	0	1	0	0
1	19874550	.	G	A	0	1	1	0	0	1	0	0
1	19882538	.	C	A	1	0	1	0	0	1	0	0
1	19936191	.	A	G	2	0	2	0	1	3	0	0
1	19936211	.	A	C	3	3	6	0	0	6	0	0
1	19936625	.	T	C	4	6	10	0	0	10	0	0
1	19936790	.	T	G	10	6	16	0	1	17	0	0
1	19950478	.	A	T	7	8	15	0	1	16	0	0
1	19950737	.	C	A	16	10	26	0	3	29	0	0
1	19955706	.	C	T	4	0	4	0	0	4	0	0
1	19966416	.	C	T	6	8	14	0	1	15	0	0
1	19978049	.	A	G	4	0	4	0	4	8	0	0
1	19978118	.	T	C	7	3	10	0	0	10	0	0
1	19978445	.	A	C	0	3	3	0	0	3	0	0
1	19984448	.	C	T	5	4	9	0	1	10	0	0
1	19989354	.	C	T	7	2	9	0	3	12	0	0
1	19989404	.	G	A	4	3	7	0	2	9	0	0
1	20063843	.	C	A	0	3	3	0	4	7	0	0
1	20068075	.	A	C	7	4	11	0	0	11	0	0
1	20068092	.	T	A	6	4	10	0	0	10	0	0
1	20069667	.	T	G	6	0	6	0	4	10	0	0
1	20084537	.	A	G	4	2	6	0	1	7	0	0
1	20092616	.	T	A	2	8	10	0	0	10	0	0
1	20094234	.	G	A	1	2	3	0	0	3	0	0
1	20094327	.	G	T	2	3	5	0	0	5	0	0
1	20095274	.	A	G	1	3	4	0	0	4	0	0
1	20117596	.	T	C	0	4	4	0	0	4	0	0
1	20129516	.	G	A	10	7	17	0	0	17	0	0
1	20129652	.	T	C	4	4	8	0	0	8	0	0
1	20138983	.	C	G	2	2	4	0	0	4	0	0
1	20138993	.	C	T	3	3	6	0	0	6	0	0
1	20141572	.	G	A	0	8	8	0	14	22	0	0
1	20141661	.	A	C	13	6	19	0	0	19	0	0
1	20147248	.	T	A	10	6	16	0	0	16	0	0
1	20160882	.	T	A	4	8	12	0	0	12	0	0
1	20166536	.	C	A	13	10	23	0	0	23	0	0
1	20194118	.	C	T	6	6	12	0	1	13	0	0
1	20212284	.	C	T	5	8	13	0	0	13	0	0
1	20270779	.	G	T	6	14	20	0	0	20	0	0
1	20272915	.	T	A	1	5	6	0	0	6	0	0
1	20273071	.	T	C	1	4	5	0	0	5	0	0
1	20273088	.	G	A	3	3	6	0	0	6	0	0
1	20556179	.	G	A	8	0	8	0	1	9	0	0
1	20556916	.	G	T	7	7	14	0	0	14	0	0
1	20557447	.	G	A	12	8	20	0	0	20	0	0
1	20557467	.	G	A	10	12	22	0	0	22	0	0
1	20557625	.	A	C	5	0	5	0	9	14	0	0
1	20557650	.	C	T	8	7	15	0	0	15	0	0
1	20557662	.	G	T	6	9	15	0	0	15	0	0
1	20557788	.	A	C	4	0	4	0	2	6	0	0
1	20557831	.	A	T	0	4	4	0	0	4	0	0
1	20557850	.	T	A	4	2	6	0	0	6	0	0
1	20557960	.	A	T	2	4	6	0	1	7	0	0
1	20558311	.	G	C	2	5	7	0	0	7	0	0
1	20558902	.	A	G	2	5	7	0	0	7	0	0
1	20559010	.	A	G	4	3	7	0	0	7	0	0
1	20559427	.	C	T	5	4	9	0	0	9	0	0
1	20559442	.	C	T	4	4	8	0	1	9	0	0
1	20559538	.	G	A	5	6	11	0	0	11	0	0
1	20564770	.	T	G	6	5	11	0	0	11	0	0
1	20581311	.	C	T	0	3	3	0	2	5	0	0
1	20581764	.	G	A	3	3	6	0	0	6	0	0
1	20635419	.	C	T	9	16	25	0	0	25	0	0
1	20694955	.	A	G	20	25	45	0	2	47	0	0
1	20698009	.	C	T	0	1	1	0	0	1	0	0
1	20705237	.	C	T	27	18	45	0	2	47	0	0
1	20733253	.	G	A	2	5	7	0	0	7	0	0
1	20733263	.	G	T	2	4	6	0	0	6	0	0
1	20866958	.	A	G	25	28	53	0	2	55	0	0
1	20867057	.	A	T	36	26	62	0	0	62	0	0
1	20867321	.	C	T	2	19	21	0	26	47	0	0
1	20867345	.	C	T	25	18	43	0	1	44	0	0
1	20867359	.	C	T	22	17	39	0	5	44	0	0
1	20867478	.	T	C	18	43	61	0	2	63	0	0
1	20867611	.	T	C	31	33	64	0	2	66	0	0
1	20867623	.	T	C	31	33	64	0	2	66	0	0
1	20867650	.	G	A	24	34	58	0	4	62	0	0
1	20867887	.	T	C	14	42	56	0	2	58	0	0
1	20867901	.	C	G	1	13	14	0	46	60	0	0
1	20867933	.	T	C	31	0	31	1	22	54	0	0
1	20868301	.	A	G	31	24	55	0	0	55	0	0
1	20868338	.	G	T	44	26	70	0	2	72	0	0
1	20868467	.	C	T	25	23	48	0	0	48	0	0
1	20868525	.	G	C	34	27	61	0	1	62	0	0
1	20868762	.	C	A	7	19	26	0	0	26	0	0
1	20868765	.	C	G	0	16	16	0	9	25	0	0
1	20868997	.	C	T	2	27	29	0	26	55	0	0
1	20870219	.	T	G	19	19	38	0	1	39	0	0
1	20870601	.	A	G	19	13	32	6	0	38	0	0
1	20870774	.	G	A	24	33	57	0	3	60	0	0
1	20870808	.	C	T	1	27	28	0	30	58	0	0
1	20870846	.	C	T	11	36	47	0	0	47	0	0
1	20870876	.	C	T	33	11	44	0	3	47	0	0
1	20871210	.	G	A	6	7	13	0	0	13	0	0
1	20878946	.	C	T	33	20	53	0	1	54	0	0
1	20878994	.	G	A	22	20	42	0	3	45	0	0
1	20886924	.	G	A	16	9	25	0	0	25	0	0
1	20886936	.	G	A	20	13	33	0	1	34	0	0
1	20910967	.	A	G	32	26	58	0	8	66	0	0
1	20911156	.	T	G	30	32	62	0	4	66	0	0
1	20916898	.	G	A	1	3	4	0	0	4	0	0
1	20917091	.	G	C	5	4	9	0	0	9	0	0
1	20917114	.	T	A	6	6	12	0	0	12	0	0
1	20925532	.	G	A	1	2	3	0	0	3	0	0
1	20925544	.	G	T	1	2	3	0	0	3	0	0
1	20941806	.	T	A	1	1	2	0	0	2	0	0
1	20946897	.	A	G	0	2	2	0	0	2	0	0
1	20966059	.	T	C	4	5	9	0	2	11	0	0
1	20970109	.	G	T	3	3	6	0	0	6	0	0
1	21138623	.	T	C	2	2	4	0	1	5	0	0
1	21139108	.	A	G	5	4	9	0	2	11	0	0
1	21139355	.	G	A	3	4	7	0	1	8	0	0
1	21139367	.	G	A	4	5	9	0	0	9	0	0
1	21139456	.	G	C	3	1	4	0	0	4	0	0
1	21141701	.	A	G	4	8	12	0	0	12	0	0
1	21141869	.	T	G	4	10	14	0	1	15	0	0
1	21141894	.	C	T	0	10	10	0	6	16	0	0
1	21141999	.	G	A	4	7	11	0	2	13	0	0
1	21142029	.	A	G	6	6	12	0	0	12	0	0
1	21148609	.	A	T	3	3	6	0	1	8	1	0
1	21161487	.	T	C	1	2	3	0	0	3	0	0
1	21309423	.	G	A	2	6	8	0	0	8	0	0
1	21312085	.	G	A	6	3	9	0	0	9	0	0
1	21312112	.	C	T	9	10	19	0	0	19	0	0
1	21312145	.	A	G	9	9	18	0	0	18	0	0
1	21333205	.	C	G	0	26	26	0	22	48	0	0
1	21341577	.	T	C	0	9	9	0	0	9	0	0
1	21352529	.	A	G	1	1	2	0	0	2	0	0
1	21368014	.	C	A	9	9	18	0	2	20	0	0
1	21368074	.	C	A	17	20	37	0	1	38	0	0
1	21409358	.	G	T	12	5	17	0	0	17	0	0
1	21423093	.	A	T	2	5	7	0	0	7	0	0
1	21423756	.	A	G	6	7	13	0	1	14	0	0
1	21439453	.	G	A	3	4	7	0	0	7	0	0
1	21447843	.	C	T	12	12	24	0	1	25	0	0
1	21473134	.	G	A	6	4	10	0	0	10	0	0
1	21473155	.	G	A	7	5	12	0	0	12	0	0
1	21473248	.	T	C	6	0	6	0	7	13	0	0
1	21500209	.	T	A	5	2	7	0	0	7	0	0
1	21505670	.	G	A	3	4	7	0	1	8	0	0
1	21505702	.	G	T	0	2	2	0	0	2	0	0
1	21513826	.	G	A	3	4	7	0	0	7	0	0
1	21515880	.	G	A	4	0	4	0	0	4	0	0
1	21515903	.	G	T	0	5	5	0	0	5	0	0
1	21518503	.	G	A	1	2	3	0	0	3	0	0
1	21522253	.	G	A	2	5	7	0	0	7	0	0
1	21525823	.	C	T	0	3	3	0	0	3	0	0
1	21529367	.	G	A	0	1	1	0	0	1	0	0
1	21536486	.	G	A	1	2	3	0	0	3	0	0
1	21537356	.	G	A	2	1	3	0	2	5	0	0
1	21537379	.	A	G	1	4	5	0	0	5	0	0
1	21582035	.	C	T	2	2	4	0	0	4	0	0
1	21593731	.	C	T	1	2	3	0	0	3	0	0
1	21610651	.	A	G	1	3	4	0	0	4	0	0
1	21611043	.	T	C	3	3	6	0	1	7	0	0
1	21612127	.	C	T	2	3	5	0	2	7	0	0
1	21612400	.	G	A	4	6	10	0	0	10	0	0
1	21612418	.	G	C	3	5	8	0	0	8	0	0
1	21944731	.	C	T	1	1	2	0	0	2	0	0
1	21947233	.	A	T	2	5	7	0	0	7	0	0
1	21949907	.	A	C	4	3	7	0	0	7	0	0
1	21949910	.	G	A	4	3	7	0	0	7	0	0
1	21949996	.	C	T	7	6	13	0	0	13	0	0
1	21950179	.	C	T	2	6	8	0	0	8	0	0
1	21950621	.	G	A	1	4	5	0	4	9	0	0
1	21950650	.	T	C	5	7	12	0	0	12	0	0
1	21950824	.	C	A	5	3	8	0	1	9	0	0
1	21950841	.	G	A	1	4	5	0	7	12	0	0
1	21950896	.	G	A	0	4	4	0	7	11	0	0
1	21951309	.	T	G	7	6	13	0	1	14	0	0
1	21951411	.	G	A	5	5	10	0	0	10	0	0
1	21951431	.	T	C	6	5	11	0	0	11	0	0
1	21954946	.	G	A	0	6	6	0	5	11	0	0
1	21954974	.	C	T	2	4	6	0	0	6	0	0
1	21957122	.	T	G	0	2	2	0	0	2	0	0
1	21957124	.	T	C	0	2	2	0	0	2	0	0
1	21961364	.	G	T	0	5	5	0	4	9	0	0
1	21961430	.	T	C	6	10	16	0	0	16	0	0
1	22236891	.	A	T	7	2	9	0	0	9	0	0
1	22236990	.	G	A	1	2	3	0	0	3	0	0
1	22389122	.	C	T	4	2	6	0	0	6	0	0
1	22389246	.	C	T	0	10	10	0	11	21	0	0
1	22389264	.	T	A	13	11	24	0	0	24	0	0
1	22389395	.	T	C	4	0	4	0	0	4	0	0
1	22401851	.	A	G	2	0	2	0	0	2	0	0
1	22411760	.	A	G	2	2	4	0	0	4	0	0
1	22482490	.	C	T	3	10	13	0	0	13	0	0
1	22482494	.	A	T	8	5	13	0	0	13	0	0
1	22482560	.	G	T	3	5	8	0	0	8	0	0
1	22482575	.	A	G	2	5	7	0	0	7	0	0
1	22483076	.	T	C	1	2	3	0	0	3	0	0
1	22483098	.	G	T	4	1	5	0	0	5	0	0
1	22483543	.	T	A	1	3	4	0	0	4	0	0
1	22483747	.	C	T	3	1	4	0	0	4	0	0
1	22483750	.	T	C	3	1	4	0	1	5	0	0
1	22483821	.	C	G	4	8	12	0	0	12	0	0
1	22483955	.	A	G	6	3	9	0	0	9	0	0
1	22484015	.	A	T	6	3	9	0	0	9	0	0
1	22484152	.	A	T	2	5	7	0	0	7	0	0
1	22484156	.	T	G	2	5	7	0	0	7	0	0
1	22484199	.	T	C	0	2	2	0	0	2	0	0
1	22484544	.	C	A	5	12	17	0	0	18	1	0
1	22490234	.	C	A	6	7	13	0	0	13	0	0
1	22490402	.	C	T	4	8	12	0	0	12	0	0
1	22490444	.	G	T	2	2	4	0	0	4	0	0
1	22490555	.	A	G	0	8	8	0	0	8	0	0
1	22490565	.	C	T	0	8	8	0	2	10	0	0
1	22490660	.	G	A	8	5	13	0	0	13	0	0
1	22490795	.	C	T	0	3	3	0	7	10	0	0
1	22490897	.	G	A	3	4	7	0	1	8	0	0
1	22511863	.	C	T	2	0	2	0	0	2	0	0
1	22512020	.	C	A	2	2	4	0	0	4	0	0
1	22543373	.	T	C	2	2	4	0	0	4	0	0
1	22546188	.	T	C	0	0	0	0	1	1	0	0
1	22546198	.	G	T	0	2	2	0	0	2	0	0
1	22647772	.	T	C	6	4	10	0	2	12	0	0
1	22647844	.	C	A	25	11	36	0	2	38	0	0
1	22647852	.	T	A	28	17	45	0	0	45	0	0
1	22664852	.	T	G	3	2	5	0	0	5	0	0
1	22805989	.	T	C	14	5	19	0	1	20	0	0
1	22806009	.	T	C	20	6	26	0	0	26	0	0
1	22806156	.	T	C	5	20	25	0	1	26	0	0
1	23283065	.	G	C	1	0	1	0	0	1	0	0
1	23283287	.	A	T	3	2	5	0	0	5	0	0
1	23283295	.	G	A	3	2	5	0	0	5	0	0
1	23297789	.	T	C	2	0	2	0	7	9	0	0
1	23298081	.	G	A	2	3	5	0	0	5	0	0
1	23298494	.	T	C	6	6	12	0	0	12	0	0
1	23301687	.	A	T	1	5	6	0	0	6	0	0
1	23311756	.	T	A	5	4	9	0	0	9	0	0
1	23311959	.	A	G	2	0	2	0	6	8	0	0
1	23312029	.	G	A	9	12	21	0	1	22	0	0
1	23321770	.	G	T	11	11	22	0	1	23	0	0
1	23322072	.	T	G	13	2	15	0	0	15	0	0
1	23322076	.	T	C	2	11	13	0	1	14	0	0
1	23322442	.	C	T	18	20	38	0	2	40	0	0
1	23322473	.	T	C	16	18	34	0	1	35	0	0
1	23322501	.	C	T	14	16	30	0	0	30	0	0
1	23322602	.	T	A	8	13	21	0	1	22	0	0
1	23322659	.	T	A	18	14	32	0	0	32	0	0
1	23322937	.	G	A	0	9	9	0	5	14	0	0
1	23330118	.	A	G	11	14	25	0	0	25	0	0
1	23332456	.	T	C	3	5	8	0	0	8	0	0
1	23332462	.	C	T	3	4	7	0	1	8	0	0
1	23337716	.	A	G	1	1	2	0	0	2	0	0
1	23343744	.	C	T	0	0	0	0	1	1	0	0
1	23374143	.	C	T	1	4	5	0	0	5	0	0
1	23376721	.	G	T	0	2	2	0	0	2	0	0
1	23377676	.	C	T	2	2	4	0	0	4	0	0
1	23388325	.	C	T	1	2	3	0	0	3	0	0
1	23506660	.	C	A	6	12	18	0	0	18	0	0
1	23506674	.	C	T	10	7	17	0	0	17	0	0
1	23506711	.	A	T	8	4	12	0	2	14	0	0
1	23506865	.	C	A	14	18	32	0	3	35	0	0
1	23515748	.	T	G	13	13	26	0	2	28	0	0
1	23521634	.	G	T	0	2	2	0	0	2	0	0
1	23522528	.	C	T	12	9	21	0	3	24	0	0
1	23573760	.	C	T	6	5	11	0	0	11	0	0
1	23573814	.	A	C	4	5	9	0	1	10	0	0
1	23573823	.	A	T	5	6	11	0	0	11	0	0
1	23573921	.	G	A	4	3	7	0	0	7	0	0
1	23574003	.	C	A	3	2	5	0	0	5	0	0
1	23574567	.	G	C	2	3	5	0	0	5	0	0
1	23578157	.	C	T	1	4	5	0	0	5	0	0
1	23578196	.	A	T	6	3	9	0	0	9	0	0
1	23578368	.	T	G	2	6	8	0	0	8	0	0
1	23578514	.	C	T	1	2	3	0	0	3	0	0
1	23578651	.	C	T	2	4	6	0	0	6	0	0
1	23579438	.	T	C	4	6	10	0	0	10	0	0
1	23579714	.	C	T	0	2	2	0	1	3	0	0
1	23580087	.	C	T	2	2	4	0	0	4	0	0
1	23580644	.	C	T	1	2	3	0	0	3	0	0
1	23580700	.	G	A	2	4	6	0	0	6	0	0
1	23581198	.	C	T	2	6	8	0	0	8	0	0
1	23581960	.	T	G	3	6	9	0	0	9	0	0
1	23582052	.	A	G	1	2	3	0	0	3	0	0
1	23585190	.	C	A	4	6	10	0	0	10	0	0
1	23585338	.	G	A	1	5	6	0	0	6	0	0
1	23585411	.	C	T	3	5	8	0	0	8	0	0
1	23585802	.	C	A	0	5	5	0	5	10	0	0
1	23586133	.	A	G	4	5	9	0	0	9	0	0
1	23586581	.	G	A	5	5	10	0	1	11	0	0
1	23586780	.	C	T	1	4	5	0	6	11	0	0
1	23589080	.	G	T	2	4	6	0	1	7	0	0
1	23889642	.	T	A	1	1	2	0	0	2	0	0
1	23889648	.	A	G	0	1	1	0	0	1	0	0
1	23909090	.	A	G	13	12	25	0	0	25	0	0
1	23909289	.	A	T	1	6	7	0	3	10	0	0
1	23909522	.	A	C	6	2	8	0	2	10	0	0
1	23920833	.	A	G	2	3	5	0	0	5	0	0
1	23921071	.	A	T	10	11	21	0	0	21	0	0
1	23921166	.	C	A	6	10	16	0	0	16	0	0
1	23921171	.	G	A	5	9	14	0	2	16	0	0
1	23921284	.	T	C	8	5	13	0	0	13	0	0
1	23921427	.	T	C	4	0	4	0	10	14	0	0
1	23921564	.	T	A	2	2	4	0	1	5	0	0
1	23936154	.	C	T	2	3	5	0	1	6	0	0
1	23975453	.	A	G	1	1	2	0	0	2	0	0
1	24045920	.	G	T	0	1	1	0	0	1	0	0
1	24045977	.	T	G	0	3	3	0	0	3	0	0
1	24076445	.	T	C	5	8	13	0	0	13	0	0
1	24076890	.	A	G	6	12	18	0	1	19	0	0
1	24077274	.	A	G	10	1	11	0	10	21	0	0
1	24077517	.	C	T	11	14	25	0	2	27	0	0
1	24077791	.	G	A	0	10	10	0	12	22	0	0
1	24081190	.	G	C	1	3	4	0	0	4	0	0
1	24197364	.	G	A	2	4	6	0	0	6	0	0
1	24228248	.	C	T	1	2	3	0	0	3	0	0
1	24356734	.	T	C	14	9	23	0	1	24	0	0
1	24357931	.	C	T	8	6	14	0	1	15	0	0
1	24520859	.	G	A	2	2	4	0	0	4	0	0
1	24520863	.	A	T	2	1	3	0	0	3	0	0
1	24523410	.	C	T	0	1	1	0	0	1	0	0
1	24552293	.	A	G	2	3	5	0	0	5	0	0
1	24557201	.	A	G	4	4	8	0	1	9	0	0
1	24557213	.	C	T	5	4	9	0	0	9	0	0
1	24557605	.	A	G	7	3	10	0	0	10	0	0
1	24558187	.	C	T	2	4	6	0	0	6	0	0
1	24558210	.	A	G	3	4	7	0	0	7	0	0
1	24558368	.	G	A	1	2	3	0	0	3	0	0
1	24558375	.	G	A	1	1	2	0	0	2	0	0
1	24558410	.	T	A	1	3	4	0	0	4	0	0
1	24902778	.	T	C	5	0	5	0	1	6	0	0
1	25024060	.	T	C	2	0	2	0	4	6	0	0
1	25024435	.	G	A	2	3	5	0	0	5	0	0
1	25272691	.	G	C	1	0	1	0	0	1	0	0
1	25296797	.	C	T	9	8	17	0	0	17	0	0
1	25296831	.	C	T	3	5	8	0	1	9	0	0
1	25305290	.	A	T	5	10	15	0	0	15	0	0
1	25305446	.	T	G	5	1	6	0	7	13	0	0
1	25310899	.	C	A	8	6	14	0	0	14	0	0
1	25310912	.	T	A	5	6	11	0	0	11	0	0
1	25313056	.	C	T	8	5	13	0	0	13	0	0
1	25313261	.	T	C	2	1	3	0	0	3	0	0
1	25313300	.	G	A	0	1	1	0	2	3	0	0
1	25313482	.	T	A	12	15	27	0	1	28	0	0
1	25322572	.	T	A	2	4	6	0	1	7	0	0
1	25322633	.	A	T	3	2	5	0	0	5	0	0
1	25327267	.	A	C	0	0	0	0	2	3	1	0
1	25327834	.	A	T	1	0	1	0	0	1	0	0
1	25331494	.	C	T	2	1	3	0	0	3	0	0
1	25336466	.	A	G	2	5	7	0	0	7	0	0
1	25336507	.	C	A	1	2	3	0	0	3	0	0
1	25340311	.	G	A	4	3	7	0	0	7	0	0
1	25340353	.	C	T	0	3	3	0	2	5	0	0
1	25399528	.	A	C	2	2	4	0	0	4	0	0
1	25399556	.	G	A	2	4	6	0	0	6	0	0
1	25400017	.	A	G	6	3	9	0	1	10	0	0
1	25400032	.	C	T	1	5	6	0	3	9	0	0
1	25401181	.	G	A	5	5	10	0	0	10	0	0
1	25401635	.	G	A	4	2	6	0	0	6	0	0
1	25401638	.	T	A	2	4	6	0	0	6	0	0
1	25401756	.	A	G	10	5	15	0	0	15	0	0
1	25401819	.	A	G	5	9	14	0	0	14	0	0
1	25401984	.	T	C	6	6	12	0	0	12	0	0
1	25402044	.	T	A	0	11	11	0	0	11	0	0
1	25402229	.	T	C	3	6	9	0	1	10	0	0
1	25402260	.	A	G	2	6	8	0	0	8	0	0
1	25402560	.	C	T	4	3	7	0	0	7	0	0
1	25402695	.	C	T	1	2	3	0	0	3	0	0
1	25402957	.	G	C	1	4	5	0	0	5	0	0
1	25403140	.	A	G	2	4	6	0	0	6	0	0
1	25403289	.	T	C	2	6	8	0	0	8	0	0
1	25419911	.	T	G	2	2	4	0	1	5	0	0
1	25654976	.	C	T	1	0	1	0	0	1	0	0
1	25660719	.	C	T	2	2	4	0	0	4	0	0
1	25666368	.	T	C	2	3	5	0	0	5	0	0
1	25798792	.	T	A	6	7	13	0	0	13	0	0
1	25798863	.	G	C	4	9	13	0	0	13	0	0
1	25798983	.	A	C	2	4	6	0	0	6	0	0
1	25803617	.	C	T	5	1	6	0	0	6	0	0
1	25811411	.	T	C	9	6	15	0	1	16	0	0
1	25812658	.	C	T	4	4	8	0	0	8	0	0
1	25863530	.	G	A	4	12	16	0	1	17	0	0
1	25863638	.	A	T	7	7	14	0	1	15	0	0
1	25911654	.	T	A	3	4	7	0	0	7	0	0
1	26012748	.	G	T	1	4	5	0	0	5	0	0
1	26012755	.	G	A	1	3	4	0	0	4	0	0
1	26026639	.	G	T	2	4	6	0	1	7	0	0
1	26046950	.	T	A	10	8	18	0	1	19	0	0
1	26094424	.	G	T	1	3	4	0	0	4	0	0
1	26095879	.	T	G	4	4	8	0	0	8	0	0
1	26096130	.	A	T	5	2	7	0	0	7	0	0
1	26096488	.	G	C	6	6	12	0	0	12	0	0
1	26108222	.	G	A	2	3	5	0	0	5	0	0
1	26127856	.	A	T	12	12	24	0	0	24	0	0
1	26252153	.	A	T	2	4	6	0	1	7	0	0
1	26252215	.	T	C	3	3	6	0	1	7	0	0
1	26252371	.	G	A	3	2	5	0	1	6	0	0
1	26252477	.	G	A	4	3	7	0	0	7	0	0
1	26252877	.	G	A	4	6	10	0	1	11	0	0
1	26252931	.	A	T	2	2	4	0	0	4	0	0
1	26293231	.	T	A	2	6	8	0	0	8	0	0
1	26294661	.	A	G	6	2	8	0	0	8	0	0
1	26374612	.	A	T	3	3	6	0	0	6	0	0
1	26374638	.	A	G	2	0	2	0	5	7	0	0
1	26375733	.	G	A	0	9	9	0	7	16	0	0
1	26377682	.	C	T	1	1	2	0	0	2	0	0
1	26377694	.	C	T	0	1	1	0	0	1	0	0
1	26382852	.	C	T	15	9	24	0	0	24	0	0
1	26382853	.	C	T	15	8	23	0	1	24	0	0
1	26383281	.	G	T	0	9	9	0	3	12	0	0
1	26384721	.	A	G	2	6	8	0	0	8	0	0
1	26384779	.	C	A	5	3	8	0	2	10	0	0
1	26385222	.	C	G	9	5	14	0	0	14	0	0
1	26385939	.	A	G	9	5	14	0	0	14	0	0
1	26386147	.	G	T	1	2	3	0	0	3	0	0
1	26391984	.	C	T	1	2	3	0	0	3	0	0
1	26394436	.	A	C	0	1	1	0	0	1	0	0
1	26438749	.	G	T	3	2	5	0	0	5	0	0
1	26438894	.	C	T	0	10	10	0	3	13	0	0
1	26438909	.	A	G	5	8	13	0	1	14	0	0
1	26439131	.	T	C	12	0	12	0	8	20	0	0
1	26439176	.	T	C	9	3	12	0	1	13	0	0
1	26443115	.	T	C	2	0	2	0	2	4	0	0
1	26453698	.	C	G	6	7	13	0	0	13	0	0
1	26454080	.	T	A	4	0	4	0	0	4	0	0
1	26456433	.	G	A	3	2	5	0	0	5	0	0
1	26463208	.	C	G	12	8	20	0	0	20	0	0
1	26463263	.	G	A	0	7	7	0	12	19	0	0
1	26463488	.	T	G	6	0	6	0	3	9	0	0
1	26463692	.	C	T	5	10	15	0	0	15	0	0
1	26463878	.	C	A	5	5	10	0	0	10	0	0
1	26464003	.	C	T	6	11	17	0	1	18	0	0
1	26464175	.	G	A	3	3	6	0	1	7	0	0
1	26464259	.	C	T	9	4	13	0	0	13	0	0
1	26464446	.	G	A	10	9	19	0	0	19	0	0
1	26465047	.	A	C	9	7	16	0	0	16	0	0
1	26465218	.	G	T	0	6	6	0	15	21	0	0
1	26467125	.	T	A	5	5	10	0	0	10	0	0
1	26467243	.	G	A	0	4	4	0	1	5	0	0
1	26467953	.	A	C	1	2	3	0	0	3	0	0
1	26476305	.	C	T	1	0	1	0	0	1	0	0
1	26480970	.	G	C	0	3	3	0	1	4	0	0
1	26489854	.	G	A	5	11	16	0	0	16	0	0
1	26498400	.	C	T	4	4	8	0	0	8	0	0
1	26498657	.	G	A	0	6	6	0	3	9	0	0
1	26507270	.	A	C	12	9	21	0	0	21	0	0
1	26507356	.	G	A	8	12	20	0	0	20	0	0
1	26507582	.	G	A	10	9	19	0	1	20	0	0
1	26649095	.	A	T	2	2	4	0	1	5	0	0
1	26654154	.	A	T	2	2	4	0	1	5	0	0
1	26654167	.	T	A	1	2	3	0	0	3	0	0
1	26660660	.	C	T	0	15	15	0	15	30	0	0
1	26661084	.	G	A	1	1	2	0	0	2	0	0
1	26661516	.	G	A	19	16	35	0	0	35	0	0
1	26663278	.	C	T	3	5	8	0	0	8	0	0
1	26676347	.	A	G	1	2	3	0	0	3	0	0
1	26740966	.	T	C	27	30	57	0	4	61	0	0
1	26741410	.	C	T	31	18	49	0	2	51	0	0
1	26837202	.	G	A	1	1	2	0	0	2	0	0
1	27207986	.	A	G	6	0	6	0	6	12	0	0
1	27208553	.	T	A	5	3	8	0	0	8	0	0
1	27209628	.	A	C	4	5	9	0	1	10	0	0
1	27209904	.	T	G	7	6	13	0	0	13	0	0
1	27210057	.	T	C	2	8	10	0	0	10	0	0
1	27210073	.	T	C	6	3	9	0	0	9	0	0
1	27210578	.	G	A	4	6	10	0	1	11	0	0
1	27210929	.	C	T	11	11	22	0	1	23	0	0
1	27809162	.	T	C	7	7	14	0	1	15	0	0
1	27809198	.	T	A	10	6	16	0	0	16	0	0
1	27809381	.	C	T	1	0	1	0	0	1	0	0
1	27842373	.	G	A	0	5	5	0	1	6	0	0
1	27860743	.	T	A	7	3	10	0	1	11	0	0
1	27893097	.	T	C	0	1	1	0	1	2	0	0
1	27893139	.	C	A	7	2	9	0	0	9	0	0
1	27893237	.	C	A	5	2	7	0	0	7	0	0
1	27893550	.	T	A	5	2	7	0	0	7	0	0
1	27995605	.	C	T	1	2	3	0	0	3	0	0
1	28018806	.	C	T	12	11	23	0	2	25	0	0
1	28018988	.	T	A	4	11	15	0	0	15	0	0
1	28035590	.	T	C	3	1	4	0	0	4	0	0
1	28035719	.	G	A	2	2	4	0	2	6	0	0
1	28035786	.	C	T	2	3	5	0	0	5	0	0
1	28046218	.	T	C	10	15	25	0	1	26	0	0
1	28046224	.	A	G	13	3	16	0	10	26	0	0
1	28046574	.	G	T	2	0	2	0	0	2	0	0
1	28046645	.	T	A	0	4	4	0	1	5	0	0
1	28046717	.	T	A	0	2	2	0	0	2	0	0
1	28081318	.	C	T	3	3	6	0	0	6	0	0
1	28089545	.	G	A	7	8	15	0	2	17	0	0
1	28391882	.	C	G	6	5	11	0	0	11	0	0
1	28391914	.	C	T	1	4	5	0	7	12	0	0
1	28422549	.	G	T	5	4	9	0	0	9	0	0
1	28422569	.	C	T	2	3	5	0	0	5	0	0
1	28428603	.	A	G	5	11	16	0	0	16	0	0
1	28724010	.	G	T	4	10	14	0	0	14	0	0
1	28834598	.	A	T	2	2	4	0	0	4	0	0
1	28835669	.	T	C	6	2	8	0	1	9	0	0
1	28847677	.	C	T	0	2	2	0	2	4	0	0
1	28860619	.	G	A	10	6	16	0	0	16	0	0
1	28861096	.	T	G	1	0	1	0	0	1	0	0
1	28874819	.	C	T	3	4	7	0	0	7	0	0
1	28899350	.	G	A	4	2	6	0	0	6	0	0
1	28900661	.	A	G	1	2	3	0	0	3	0	0
1	28962350	.	A	C	5	3	8	0	1	9	0	0
1	28962501	.	C	T	0	25	25	0	28	53	0	0
1	28962545	.	A	G	26	16	42	0	0	42	0	0
1	28962556	.	A	C	24	7	31	0	3	34	0	0
1	28962598	.	C	T	20	17	37	0	2	39	0	0
1	28962966	.	G	A	3	12	15	0	1	16	0	0
1	28986486	.	C	T	17	11	28	0	1	29	0	0
1	28986532	.	G	A	14	15	29	0	0	29	0	0
1	29045226	.	G	A	20	17	37	0	2	39	0	0
1	29141285	.	C	T	1	1	2	0	0	2	0	0
1	29162589	.	A	G	9	3	12	0	0	12	0	0
1	29163687	.	G	A	4	7	11	0	0	11	0	0
1	29163737	.	C	T	4	5	9	0	0	9	0	0
1	29183991	.	C	T	1	2	3	0	0	3	0	0
1	29183997	.	A	T	1	2	3	0	0	3	0	0
1	29201933	.	G	C	4	9	13	0	1	14	0	0
1	29202110	.	T	C	2	2	4	0	0	4	0	0
1	29202379	.	A	G	0	0	0	0	1	1	0	0
1	29212341	.	G	A	6	9	15	0	0	15	0	0
1	29213227	.	G	A	0	10	10	0	5	15	0	0
1	29213902	.	C	T	7	7	14	0	0	14	0	0
1	29227642	.	T	A	6	8	14	0	0	14	0	0
1	29228390	.	A	T	0	3	3	0	1	4	0	0
1	29281974	.	C	G	2	3	5	0	0	5	0	0
1	29282145	.	C	T	3	4	7	0	1	8	0	0
1	29282175	.	A	C	3	6	9	0	0	9	0	0
1	29282836	.	C	T	5	4	9	0	2	11	0	0
1	29389975	.	T	C	3	2	5	0	0	5	0	0
1	29390049	.	G	A	6	2	8	0	1	9	0	0
1	29390461	.	C	A	2	2	4	0	0	4	0	0
1	29608207	.	G	A	2	2	4	0	0	4	0	0
1	29618331	.	A	G	2	2	4	0	0	4	0	0
1	29731965	.	T	G	2	2	4	0	1	5	0	0
1	29737972	.	A	C	0	3	3	0	0	3	0	0
1	29738496	.	T	C	6	4	10	0	1	11	0	0
1	29739670	.	T	A	4	7	11	0	0	11	0	0
1	29740905	.	A	C	2	2	4	0	8	12	0	0
1	29740908	.	A	C	0	3	3	0	8	11	0	0
1	29741054	.	C	T	11	10	21	0	0	21	0	0
1	29741193	.	T	A	8	9	17	0	1	18	0	0
1	29741447	.	C	T	12	4	16	0	1	17	0	0
1	29741952	.	C	T	9	10	19	0	1	20	0	0
1	29741967	.	A	G	9	10	19	0	4	23	0	0
1	29742036	.	C	T	11	10	21	0	1	22	0	0
1	29742368	.	T	C	5	3	8	0	0	8	0	0
1	29742487	.	T	C	2	2	4	0	0	4	0	0
1	29742697	.	T	C	7	3	10	0	0	10	0	0
1	29742791	.	A	T	10	9	19	0	0	19	0	0
1	29742796	.	A	G	10	0	10	0	10	20	0	0
1	29743087	.	G	A	13	5	18	0	0	18	0	0
1	29743165	.	A	G	5	8	13	0	0	13	0	0
1	29743178	.	T	C	5	7	12	0	0	12	0	0
1	29743281	.	T	C	6	8	14	0	1	15	0	0
1	29743423	.	T	G	17	6	23	0	0	23	0	0
1	29743505	.	A	G	6	9	15	0	0	15	0	0
1	29751529	.	T	G	0	2	2	0	3	5	0	0
1	29751594	.	T	G	1	4	5	0	0	5	0	0
1	29751638	.	G	T	2	2	4	0	1	5	0	0
1	29752319	.	T	C	8	4	12	0	1	13	0	0
1	29754673	.	A	G	6	7	13	0	0	13	0	0
1	29758042	.	G	A	4	7	11	0	0	11	0	0
1	29770360	.	T	A	0	3	3	0	0	3	0	0
1	29770748	.	A	C	2	1	3	0	0	3	0	0
1	29772379	.	G	A	10	2	12	0	1	13	0	0
1	29772751	.	G	T	2	2	4	0	0	4	0	0
1	29775664	.	C	A	4	7	11	0	2	13	0	0
1	29779300	.	G	C	10	4	14	0	0	14	0	0
1	29779402	.	G	A	0	7	7	0	7	14	0	0
1	29781462	.	G	A	1	5	6	0	0	6	0	0
1	29786407	.	G	C	0	10	10	0	4	14	0	0
1	29787262	.	T	C	12	6	18	0	2	20	0	0
1	29790030	.	A	T	6	7	13	0	1	14	0	0
1	29795692	.	G	A	10	8	18	0	1	19	0	0
1	29797191	.	T	C	0	4	4	0	0	4	0	0
1	29797387	.	A	C	9	7	16	0	2	18	0	0
1	29798203	.	A	G	12	7	19	0	1	20	0	0
1	29804658	.	A	T	1	3	4	0	1	5	0	0
1	29804682	.	A	G	2	3	5	0	0	5	0	0
1	29813246	.	C	A	3	1	4	0	0	4	0	0
1	29813276	.	C	T	7	11	18	0	1	19	0	0
1	29817451	.	C	A	7	5	12	0	1	13	0	0
1	29820831	.	C	T	20	19	39	0	0	39	0	0
1	29823603	.	T	C	14	13	27	0	0	27	0	0
1	29823604	.	G	A	14	13	27	0	0	27	0	0
1	29823701	.	A	G	15	24	39	0	3	42	0	0
1	29858127	.	G	T	2	4	6	0	0	6	0	0
1	29858258	.	A	T	1	4	5	0	0	5	0	0
1	29858300	.	A	T	1	2	3	0	0	3	0	0
1	29860506	.	A	G	3	7	10	0	0	10	0	0
1	29862116	.	C	T	0	1	1	0	0	1	0	0
1	29862155	.	A	C	0	1	1	0	0	1	0	0
1	33548282	.	A	T	1	9	10	0	2	12	0	0
1	34233301	.	A	G	4	0	4	0	9	13	0	0
1	34233312	.	A	G	5	8	13	0	1	14	0	0
1	35949933	.	A	C	4	2	6	0	1	7	0	0
1	35949934	.	T	A	4	2	6	0	1	7	0	0
1	36018708	.	A	C	7	6	13	0	1	14	0	0
1	36739579	.	A	G	1	2	3	0	0	3	0	0
1	36740252	.	A	G	1	3	4	0	0	4	0	0
1	37195941	.	T	A	4	2	6	0	0	6	0	0
1	37195950	.	G	A	4	2	6	0	0	6	0	0
1	37212301	.	T	A	8	5	13	0	0	13	0	0
1	37212331	.	C	T	3	3	6	0	0	6	0	0
1	37287291	.	A	T	1	1	2	0	0	2	0	0
1	37287294	.	G	A	1	2	3	0	0	3	0	0
1	37291884	.	A	C	3	4	7	0	0	7	0	0
1	37304354	.	C	A	12	13	25	0	0	25	0	0
1	37304439	.	C	T	12	5	17	0	0	17	0	0
1	37304494	.	T	A	16	8	24	0	2	26	0	0
1	37304536	.	G	A	13	5	18	0	1	19	0	0
1	37304873	.	A	T	2	2	4	0	0	4	0	0
1	37304929	.	G	A	7	6	13	0	2	15	0	0
1	37305148	.	C	T	6	4	10	0	0	10	0	0
1	37306726	.	G	T	0	12	12	0	12	25	1	0
1	37306913	.	T	A	10	12	22	0	3	25	0	0
1	37306942	.	A	C	15	12	27	0	1	28	0	0
1	37339689	.	T	C	1	3	4	0	0	4	0	0
1	37339817	.	G	T	1	2	3	0	0	3	0	0
1	37344832	.	T	C	2	3	5	0	0	5	0	0
1	37353355	.	C	T	4	2	6	0	0	6	0	0
1	37355591	.	G	A	3	6	9	0	0	9	0	0
1	37355606	.	C	T	5	3	8	0	1	9	0	0
1	37359071	.	C	T	6	4	10	0	2	12	0	0
1	37359221	.	G	C	8	3	11	0	0	11	0	0
1	37359352	.	A	G	7	3	10	0	0	10	0	0
1	37361554	.	A	G	5	4	9	0	2	11	0	0
1	37361759	.	C	T	4	8	12	0	0	12	0	0
1	37361879	.	T	A	9	3	12	0	0	12	0	0
1	37361919	.	T	C	3	3	6	0	0	6	0	0
1	37417961	.	G	A	2	2	4	0	1	5	0	0
1	37752326	.	T	C	1	2	3	0	0	3	0	0
1	37752392	.	A	G	2	0	2	0	5	7	0	0
1	37752478	.	G	C	5	5	10	0	0	10	0	0
1	37752563	.	G	T	6	2	8	0	0	8	0	0
1	37752569	.	A	G	5	2	7	0	1	8	0	0
1	38125431	.	C	A	12	4	16	0	2	18	0	0
1	38125684	.	T	C	4	4	8	0	2	10	0	0
1	38131058	.	C	T	13	18	31	0	2	33	0	0
1	38131073	.	T	C	14	13	27	0	0	27	0	0
1	38131094	.	G	A	11	14	25	0	0	25	0	0
1	38131288	.	G	A	20	6	26	0	3	29	0	0
1	38131360	.	G	A	17	31	48	0	0	48	0	0
1	38131486	.	G	A	19	10	29	0	0	29	0	0
1	38131873	.	C	T	2	2	4	0	0	4	0	0
1	38142998	.	G	T	2	2	4	0	0	4	0	0
1	38146192	.	G	T	1	2	3	0	0	3	0	0
1	38150605	.	A	C	3	3	6	0	1	7	0	0
1	38163017	.	C	T	4	1	5	0	1	6	0	0
1	38163132	.	G	A	1	4	5	0	1	6	0	0
1	38166009	.	G	C	7	7	14	0	1	15	0	0
1	38166268	.	A	C	12	17	29	0	0	29	0	0
1	38166429	.	T	C	20	22	42	0	1	43	0	0
1	38166431	.	T	G	21	21	42	0	1	43	0	0
1	38166520	.	A	G	17	12	29	0	1	30	0	0
1	38169771	.	T	A	16	8	24	0	1	25	0	0
1	38169972	.	T	G	18	11	29	0	1	30	0	0
1	38170553	.	G	A	2	3	5	0	1	6	0	0
1	38346162	.	C	T	0	6	6	0	4	10	0	0
1	38346578	.	G	T	6	3	9	0	0	9	0	0
1	38346649	.	C	T	0	4	4	0	5	9	0	0
1	38346739	.	G	A	6	8	14	0	1	15	0	0
1	38354049	.	G	A	2	0	2	0	0	2	0	0
1	38416477	.	G	A	2	2	4	0	0	4	0	0
1	38416536	.	A	G	3	3	6	0	1	7	0	0
1	38417116	.	A	T	3	2	5	0	0	5	0	0
1	38417229	.	G	A	3	4	7	0	0	7	0	0
1	38417268	.	A	T	6	4	10	0	0	10	0	0
1	38417332	.	A	G	3	11	14	0	0	14	0	0
1	38417370	.	G	A	10	5	15	0	0	15	0	0
1	38417531	.	G	T	4	2	6	0	0	6	0	0
1	38417571	.	G	T	4	4	8	0	0	8	0	0
1	38417680	.	T	A	5	5	10	0	0	10	0	0
1	38418087	.	C	T	2	11	13	0	0	13	0	0
1	38418243	.	A	G	6	4	10	0	0	10	0	0
1	38418294	.	G	T	6	3	9	0	0	9	0	0
1	38466714	.	G	A	3	3	6	0	1	7	0	0
1	38649340	.	A	G	38	29	67	0	3	70	0	0
1	38649947	.	G	A	28	41	69	0	7	76	0	0
1	38650132	.	G	T	35	26	61	0	3	64	0	0
1	38650298	.	G	A	33	23	56	0	1	57	0	0
1	38650382	.	G	C	30	33	63	0	2	65	0	0
1	38650467	.	A	G	27	28	55	0	7	62	0	0
1	38650510	.	G	C	31	27	58	0	5	63	0	0
1	38650516	.	T	C	35	29	64	0	6	70	0	0
1	38650545	.	T	C	36	37	73	0	3	76	0	0
1	38651063	.	G	T	48	10	58	0	0	58	0	0
1	38651065	.	T	A	47	10	57	0	1	58	0	0
1	38651361	.	C	T	14	18	32	0	0	32	0	0
1	38651370	.	G	A	12	16	28	0	2	30	0	0
1	38651469	.	C	A	20	19	39	0	2	41	0	0
1	38651822	.	G	A	8	7	15	0	0	15	0	0
1	38657689	.	G	A	4	3	7	0	0	7	0	0
1	38660240	.	T	C	17	1	18	0	15	33	0	0
1	38660252	.	A	G	21	18	39	0	1	40	0	0
1	38660369	.	G	A	2	2	4	0	0	4	0	0
1	38709351	.	A	C	15	0	15	0	17	32	0	0
1	38709381	.	G	C	10	10	20	0	0	20	0	0
1	38709480	.	G	A	11	9	20	0	1	21	0	0
1	38709535	.	T	A	12	12	24	0	1	25	0	0
1	38775210	.	T	G	1	4	5	0	1	6	0	0
1	38784551	.	A	T	5	4	9	0	0	9	0	0
1	38787039	.	C	T	5	11	16	0	0	16	0	0
1	38791569	.	C	T	1	4	5	0	0	5	0	0
1	38793983	.	G	A	1	3	4	0	0	4	0	0
1	38797663	.	A	C	7	11	18	0	0	18	0	0
1	38799513	.	G	A	0	3	3	0	0	3	0	0
1	38799585	.	A	G	3	2	5	0	0	5	0	0
1	38799588	.	T	A	2	3	5	0	0	5	0	0
1	38802537	.	G	A	10	12	22	0	2	24	0	0
1	38802703	.	A	G	12	11	23	0	1	24	0	0
1	38802718	.	G	A	12	13	25	0	2	27	0	0
1	38802747	.	A	G	10	1	11	0	11	22	0	0
1	38802855	.	C	A	8	12	20	0	1	21	0	0
1	38803033	.	T	C	6	3	9	0	0	9	0	0
1	38803042	.	A	C	6	2	8	0	0	8	0	0
1	38803092	.	C	T	3	5	8	0	0	8	0	0
1	38803127	.	C	T	9	8	17	0	0	17	0	0
1	38803154	.	T	A	9	12	21	0	2	23	0	0
1	38803205	.	A	T	8	12	20	0	2	22	0	0
1	38803404	.	A	G	12	15	27	0	4	31	0	0
1	38805128	.	G	T	9	10	19	0	1	20	0	0
1	38805135	.	C	T	9	10	19	0	0	19	0	0
1	38805439	.	G	A	14	19	33	0	1	34	0	0
1	38805450	.	A	G	14	18	32	0	1	33	0	0
1	38805506	.	G	A	18	19	37	0	2	39	0	0
1	38807255	.	G	C	3	4	7	0	0	7	0	0
1	38808259	.	C	A	1	1	2	0	0	2	0	0
1	38808379	.	C	T	0	2	2	0	0	2	0	0
1	38808723	.	T	A	11	5	16	0	1	17	0	0
1	38810061	.	T	G	2	0	2	0	0	2	0	0
1	38820219	.	G	A	0	5	5	0	7	12	0	0
1	38822092	.	A	T	7	2	9	0	0	9	0	0
1	39388092	.	C	T	1	2	3	0	0	3	0	0
1	39639723	.	C	T	0	2	2	0	0	2	0	0
1	39680758	.	G	A	0	0	0	0	1	1	0	0
1	39680794	.	C	A	1	4	5	0	0	5	0	0
1	39700498	.	T	C	0	7	7	0	1	8	0	0
1	39732544	.	C	T	2	3	5	0	0	5	0	0
1	39735491	.	T	C	3	2	5	0	0	5	0	0
1	39770416	.	C	T	8	4	12	0	0	12	0	0
1	39771429	.	T	A	8	13	21	0	1	22	0	0
1	39772010	.	T	C	5	9	14	0	0	14	0	0
1	39772042	.	A	G	17	8	25	0	0	25	0	0
1	39772135	.	C	A	8	10	18	0	0	18	0	0
1	39772225	.	C	T	10	9	19	0	0	19	0	0
1	39774096	.	C	T	3	12	15	0	0	15	0	0
1	39774225	.	C	T	9	18	27	0	2	29	0	0
1	39774363	.	G	A	12	6	18	0	1	19	0	0
1	39774618	.	A	G	8	16	24	0	2	26	0	0
1	39774690	.	A	G	12	8	20	0	3	23	0	0
1	39774727	.	C	A	11	10	21	0	1	22	0	0
1	39774891	.	C	T	19	12	31	0	1	32	0	0
1	39774915	.	G	A	13	20	33	0	0	33	0	0
1	39775089	.	C	T	12	7	19	0	0	19	0	0
1	39775131	.	C	T	11	10	21	0	0	21	0	0
1	39775227	.	C	T	12	10	22	0	1	23	0	0
1	39776356	.	A	C	18	15	33	0	4	37	0	0
1	39777089	.	G	A	9	10	19	1	1	21	0	0
1	39777836	.	G	A	0	11	11	0	10	21	0	0
1	39777975	.	A	T	11	13	24	0	1	25	0	0
1	39778075	.	T	G	15	7	22	0	1	23	0	0
1	39778332	.	G	C	23	24	47	0	2	49	0	0
1	39778661	.	G	A	8	10	18	0	0	18	0	0
1	39778663	.	G	A	8	10	18	0	0	18	0	0
1	39778949	.	G	C	14	19	33	0	0	33	0	0
1	39779225	.	G	C	13	11	24	0	0	24	0	0
1	39779468	.	A	T	4	4	8	0	0	8	0	0
1	39779518	.	T	G	9	4	13	0	0	13	0	0
1	39865792	.	A	G	1	4	5	0	0	5	0	0
1	39869860	.	T	A	2	3	5	0	0	5	0	0
1	39869917	.	T	A	4	2	6	0	0	6	0	0
1	39869974	.	G	A	5	4	9	0	0	9	0	0
1	39870008	.	T	C	5	4	9	0	0	9	0	0
1	39879560	.	T	C	2	2	4	0	1	5	0	0
1	39879863	.	A	T	1	3	4	0	0	4	0	0
1	39880126	.	T	A	1	2	3	0	1	4	0	0
1	39880133	.	T	G	0	2	2	0	0	2	0	0
1	39882272	.	A	G	1	2	3	0	0	3	0	0
1	39882764	.	A	T	3	7	10	0	1	11	0	0
1	39882899	.	A	G	5	5	10	0	1	11	0	0
1	39882906	.	T	A	5	6	11	0	0	11	0	0
1	39883259	.	C	G	2	2	4	0	0	4	0	0
1	39899477	.	G	C	17	19	36	0	2	38	0	0
1	39899494	.	A	G	17	19	36	0	1	37	0	0
1	39899663	.	G	A	20	25	45	0	3	48	0	0
1	39900056	.	G	A	26	24	50	0	0	50	0	0
1	39900129	.	G	A	20	28	48	0	3	51	0	0
1	39900137	.	G	T	22	24	46	0	1	47	0	0
1	39900360	.	G	A	13	10	23	0	0	23	0	0
1	39900432	.	C	T	0	14	14	0	13	27	0	0
1	39900750	.	C	T	0	14	14	0	9	23	0	0
1	39901269	.	G	A	5	8	13	0	0	13	0	0
1	39901378	.	T	A	9	7	16	0	1	17	0	0
1	39901500	.	T	C	6	8	14	0	1	15	0	0
1	39901501	.	G	A	5	8	13	0	2	15	0	0
1	39901729	.	T	C	17	0	17	0	18	35	0	0
1	39907492	.	T	C	17	2	19	0	15	34	0	0
1	39907611	.	C	T	0	4	4	0	8	12	0	0
1	39908047	.	G	A	8	16	24	0	0	24	0	0
1	39908680	.	C	T	9	4	13	0	0	13	0	0
1	39908854	.	A	G	6	12	18	0	0	18	0	0
1	39908881	.	C	T	3	13	16	0	1	17	0	0
1	39908926	.	A	G	6	18	24	0	1	25	0	0
1	39909003	.	A	T	11	8	19	0	0	19	0	0
1	39909247	.	A	T	17	14	31	0	1	32	0	0
1	39909274	.	A	T	17	11	28	0	1	29	0	0
1	39981794	.	A	G	3	5	8	0	0	8	0	0
1	39995100	.	C	T	7	11	18	0	0	18	0	0
1	39998875	.	G	A	17	11	28	0	1	29	0	0
1	40001853	.	A	T	8	6	14	0	1	15	0	0
1	40002113	.	G	A	11	5	16	0	1	17	0	0
1	40002148	.	C	G	8	5	13	0	1	14	0	0
1	40008905	.	T	C	15	23	38	0	2	40	0	0
1	40008906	.	G	A	15	23	38	0	2	40	0	0
1	40009227	.	T	A	8	21	29	0	1	30	0	0
1	40009258	.	C	T	20	10	30	0	0	30	0	0
1	40009291	.	A	G	15	13	28	0	1	29	0	0
1	40009382	.	G	A	19	15	34	0	2	36	0	0
1	40009625	.	T	C	4	8	12	0	0	12	0	0
1	40009671	.	C	A	7	10	17	0	0	17	0	0
1	40009697	.	C	T	5	9	14	0	1	15	0	0
1	40015189	.	A	G	8	7	15	0	2	17	0	0
1	40015219	.	C	T	7	10	17	0	0	17	0	0
1	40015265	.	C	T	0	2	2	0	1	3	0	0
1	40015553	.	A	G	2	0	2	0	0	2	0	0
1	40015697	.	A	G	4	9	13	0	0	13	0	0
1	40027564	.	C	A	3	4	7	0	0	7	0	0
1	40028424	.	C	T	9	6	15	0	0	15	0	0
1	40028508	.	C	T	7	10	17	0	0	17	0	0
1	40028568	.	G	T	11	6	17	0	0	17	0	0
1	40028613	.	G	A	9	7	16	0	0	16	0	0
1	40028637	.	C	T	7	4	11	0	0	11	0	0
1	40028680	.	G	A	5	4	9	0	0	9	0	0
1	40041528	.	C	T	1	1	2	0	0	2	0	0
1	40042241	.	G	A	1	1	2	0	1	3	0	0
1	40044175	.	G	C	0	1	1	0	0	1	0	0
1	40044562	.	G	A	5	7	12	0	0	12	0	0
1	40044578	.	C	T	6	5	11	0	0	11	0	0
1	40051918	.	T	C	9	6	15	0	0	15	0	0
1	40051923	.	G	C	7	6	13	0	1	14	0	0
1	40051988	.	G	C	0	10	10	0	7	17	0	0
1	40052033	.	A	G	7	14	21	0	1	22	0	0
1	40052066	.	G	C	11	3	14	0	0	14	0	0
1	40052083	.	G	A	9	6	15	1	0	16	0	0
1	40052481	.	A	C	4	12	16	0	0	16	0	0
1	40052550	.	A	C	6	15	21	0	0	21	0	0
1	40052562	.	A	G	6	9	15	0	2	17	0	0
1	40052638	.	T	A	1	3	4	0	0	4	0	0
1	40052965	.	T	A	4	3	7	0	0	7	0	0
1	40057604	.	A	G	2	4	6	0	4	10	0	0
1	40057805	.	C	T	8	5	13	0	1	14	0	0
1	40060968	.	A	C	4	5	9	0	0	9	0	0
1	40060992	.	C	T	0	5	5	0	3	8	0	0
1	40061061	.	C	T	0	4	4	0	5	9	0	0
1	40061169	.	G	A	10	3	13	0	1	14	0	0
1	40061285	.	C	T	9	5	14	0	1	15	0	0
1	40107874	.	T	G	5	7	12	0	1	13	0	0
1	40107961	.	C	T	1	0	1	0	0	1	0	0
1	40111679	.	C	G	8	13	21	0	1	22	0	0
1	40111702	.	T	G	12	14	26	0	0	26	0	0
1	40111737	.	A	C	12	11	23	0	0	24	1	0
1	40111738	.	G	A	13	11	24	0	0	24	0	0
1	40111776	.	C	T	13	9	22	0	2	24	0	0
1	40111918	.	C	T	14	11	25	0	1	26	0	0
1	40112206	.	T	C	10	4	14	0	6	20	0	0
1	40112347	.	C	T	3	6	9	0	1	10	0	0
1	40112367	.	A	T	5	3	8	0	0	8	0	0
1	40112410	.	C	T	5	5	10	0	0	10	0	0
1	40112713	.	A	G	1	0	1	0	3	4	0	0
1	40112760	.	T	A	7	5	12	0	0	12	0	0
1	40112822	.	A	T	12	6	18	0	1	19	0	0
1	40112837	.	C	T	8	10	18	0	1	19	0	0
1	40112869	.	C	T	10	6	16	0	2	18	0	0
1	40112879	.	A	G	8	7	15	0	2	17	0	0
1	40112938	.	G	C	6	9	15	0	1	16	0	0
1	40113314	.	A	G	4	2	6	0	3	9	0	0
1	40113374	.	T	A	9	5	14	0	0	14	0	0
1	40113833	.	T	C	2	2	4	0	0	4	0	0
1	40114326	.	C	T	1	3	4	0	0	4	0	0
1	40114462	.	A	G	1	1	2	0	1	3	0	0
1	40114527	.	T	A	2	3	5	0	1	6	0	0
1	40115018	.	A	T	1	3	4	0	0	4	0	0
1	40115065	.	T	C	3	3	6	0	0	6	0	0
1	40116747	.	G	A	13	4	17	0	0	17	0	0
1	40116889	.	G	A	1	1	2	0	1	3	0	0
1	40116915	.	T	G	3	2	5	0	0	5	0	0
1	40116946	.	C	T	0	4	4	0	7	11	0	0
1	40117345	.	G	A	8	14	22	0	2	24	0	0
1	40123964	.	C	T	0	0	0	0	1	1	0	0
1	40210865	.	G	T	17	16	33	0	0	33	0	0
1	40211048	.	C	T	0	10	10	0	8	18	0	0
1	40211065	.	T	C	10	7	17	0	0	17	0	0
1	40211217	.	A	C	7	12	19	0	2	21	0	0
1	40211465	.	T	C	8	0	8	0	12	20	0	0
1	40211645	.	C	G	0	10	10	0	13	23	0	0
1	40212065	.	C	T	12	15	27	0	1	28	0	0
1	40212084	.	C	A	1	13	14	0	12	26	0	0
1	40212305	.	C	T	10	17	27	0	2	29	0	0
1	40219257	.	T	C	3	0	3	0	0	3	0	0
1	40219259	.	T	G	3	0	3	0	0	3	0	0
1	40221458	.	A	T	2	1	3	0	0	3	0	0
1	40226289	.	G	A	10	11	21	0	0	21	0	0
1	40226292	.	G	C	9	10	19	0	2	21	0	0
1	40227029	.	T	G	6	8	14	0	1	15	0	0
1	40242922	.	C	A	2	1	3	0	0	3	0	0
1	40248173	.	C	T	1	1	2	0	0	2	0	0
1	40248383	.	C	T	6	7	13	0	0	13	0	0
1	40252219	.	T	A	0	2	2	0	0	2	0	0
1	40257631	.	C	T	11	7	18	0	1	19	0	0
1	40257751	.	C	T	11	5	16	0	2	18	0	0
1	40257834	.	T	G	7	0	7	0	6	13	0	0
1	40263675	.	C	A	3	4	7	0	0	7	0	0
1	40266618	.	C	T	5	4	9	0	0	9	0	0
1	40270028	.	G	T	5	2	7	0	0	7	0	0
1	40270054	.	C	T	3	4	7	0	0	7	0	0
1	40270094	.	G	A	0	2	2	0	1	3	0	0
1	40270095	.	G	A	1	2	3	0	0	3	0	0
1	40336234	.	C	G	3	3	6	0	1	7	0	0
1	40336372	.	T	A	7	3	10	0	1	11	0	0
1	40336396	.	A	C	5	0	5	0	5	10	0	0
1	40336789	.	G	A	3	3	6	0	0	6	0	0
1	40337314	.	C	T	4	9	13	0	0	13	0	0
1	40337464	.	C	A	0	8	8	0	9	17	0	0
1	40340571	.	C	T	7	7	14	0	1	15	0	0
1	40340598	.	C	T	8	5	13	0	0	13	0	0
1	40410839	.	A	T	8	9	17	0	1	18	0	0
1	40410908	.	C	T	5	5	10	0	1	11	0	0
1	40411091	.	T	A	4	3	7	0	0	7	0	0
1	40411928	.	T	C	1	0	1	0	0	1	0	0
1	40567094	.	G	A	10	5	15	0	1	16	0	0
1	40568601	.	G	A	9	8	17	0	0	17	0	0
1	40568707	.	A	G	16	0	16	0	7	23	0	0
1	40568883	.	G	A	1	14	15	0	15	30	0	0
1	40568990	.	A	G	14	17	31	0	2	33	0	0
1	40569153	.	C	T	13	5	18	0	0	18	0	0
1	40569168	.	C	T	12	2	14	0	1	15	0	0
1	40569231	.	G	A	9	14	23	0	0	23	0	0
1	40569295	.	A	T	8	9	17	0	3	20	0	0
1	40569386	.	T	A	16	5	21	0	0	21	0	0
1	40569466	.	A	T	15	10	25	0	1	26	0	0
1	40569538	.	G	A	13	8	21	0	2	23	0	0
1	40569548	.	T	C	11	8	19	0	2	21	0	0
1	40573703	.	G	T	7	9	16	0	2	18	0	0
1	40590967	.	T	G	4	4	8	0	0	8	0	0
1	40591262	.	T	C	21	24	45	0	0	45	0	0
1	40591272	.	T	C	19	19	38	0	0	38	0	0
1	40594373	.	C	T	1	4	5	0	0	5	0	0
1	40594415	.	C	T	1	13	14	0	6	20	0	0
1	40594517	.	T	C	14	0	14	0	15	29	0	0
1	40594526	.	G	A	14	10	24	0	0	24	0	0
1	40597332	.	A	C	8	0	8	0	18	26	0	0
1	40600992	.	A	T	4	6	10	0	0	10	0	0
1	40601547	.	G	A	13	11	24	0	0	24	0	0
1	40601595	.	G	C	5	0	5	0	6	11	0	0
1	40618861	.	C	T	1	2	3	0	0	3	0	0
1	40638246	.	A	T	1	7	8	0	0	8	0	0
1	40795231	.	A	T	2	3	5	0	0	5	0	0
1	40796779	.	G	T	2	0	2	0	0	2	0	0
1	40796791	.	G	A	1	2	3	0	0	3	0	0
1	40796942	.	C	T	2	3	5	0	0	5	0	0
1	40796977	.	C	T	2	2	4	0	0	4	0	0
1	40796985	.	A	T	2	3	5	0	0	5	0	0
1	40992716	.	T	A	3	7	10	0	0	10	0	0
1	40992823	.	A	G	5	6	11	0	1	12	0	0
1	40992878	.	C	G	5	6	11	0	0	11	0	0
1	40993349	.	C	T	0	7	7	0	11	18	0	0
1	40993714	.	G	A	7	4	11	0	0	11	0	0
1	41131608	.	C	T	15	13	28	0	0	28	0	0
1	41133944	.	G	A	6	9	15	0	1	16	0	0
1	41136245	.	T	C	1	0	1	0	0	1	0	0
1	41138638	.	A	G	0	1	1	0	0	1	0	0
1	41138641	.	C	T	2	0	2	0	0	2	0	0
1	41140465	.	T	C	1	3	4	0	1	5	0	0
1	41140640	.	C	T	12	17	29	0	1	30	0	0
1	41140787	.	T	A	11	10	21	0	1	22	0	0
1	41215289	.	T	A	6	7	13	0	0	13	0	0
1	41215312	.	T	G	9	11	20	0	0	20	0	0
1	41215547	.	G	A	8	11	19	0	1	20	0	0
1	41215746	.	T	A	6	14	20	0	0	20	0	0
1	41215868	.	T	G	10	12	22	0	1	23	0	0
1	41215869	.	G	T	12	11	23	0	0	23	0	0
1	41215949	.	T	C	8	4	12	0	4	16	0	0
1	41215998	.	T	C	8	4	12	0	0	12	0	0
1	41222341	.	T	C	1	2	3	0	0	3	0	0
1	41230927	.	C	T	1	0	1	0	0	1	0	0
1	41294719	.	A	G	9	7	16	0	0	16	0	0
1	41294760	.	T	C	13	6	19	0	0	19	0	0
1	41294790	.	G	T	8	6	14	0	0	14	0	0
1	41297453	.	C	T	1	4	5	0	3	8	0	0
1	41297495	.	G	A	11	9	20	0	0	20	0	0
1	41297561	.	C	T	2	3	5	0	0	5	0	0
1	41297564	.	A	T	3	2	5	0	0	5	0	0
1	41300133	.	C	T	10	4	14	0	3	17	0	0
1	41309208	.	C	G	5	3	8	0	0	8	0	0
1	41310074	.	A	G	8	5	13	0	0	13	0	0
1	41312210	.	G	A	2	2	4	0	0	4	0	0
1	41320781	.	A	G	0	1	1	0	0	1	0	0
1	41324327	.	C	T	0	1	1	0	2	3	0	0
1	41324444	.	C	T	0	3	3	0	4	7	0	0
1	41327484	.	A	T	0	2	2	0	0	2	0	0
1	41330394	.	G	A	3	4	7	0	0	7	0	0
1	41330594	.	G	C	0	4	4	0	0	4	0	0
1	41331692	.	G	A	2	2	4	0	1	5	0	0
1	41332989	.	T	C	1	0	1	0	1	2	0	0
1	41333034	.	G	A	1	3	4	0	0	4	0	0
1	41335270	.	G	A	0	2	2	0	0	2	0	0
1	41337314	.	G	A	0	1	1	0	0	1	0	0
1	41339963	.	C	T	0	1	1	0	2	3	0	0
1	41361505	.	C	T	0	2	2	0	0	2	0	0
1	41362635	.	C	A	0	1	1	0	0	1	0	0
1	41364819	.	G	A	0	2	2	0	1	3	0	0
1	41364828	.	G	A	0	2	2	0	1	3	0	0
1	41374028	.	G	T	0	1	1	0	0	1	0	0
1	41470524	.	T	C	18	28	46	0	2	48	0	0
1	41471129	.	A	T	9	3	12	0	0	12	0	0
1	41471529	.	T	C	24	18	42	0	1	43	0	0
1	41487459	.	C	A	5	2	7	0	1	8	0	0
1	41487474	.	C	T	1	5	6	0	0	6	0	0
1	41487811	.	C	T	1	3	4	0	0	4	0	0
1	41487973	.	T	C	2	2	4	0	0	4	0	0
1	41488030	.	T	C	2	2	4	0	0	4	0	0
1	41488643	.	A	C	3	2	5	0	0	5	0	0
1	41489274	.	G	C	2	2	4	0	0	4	0	0
1	41489343	.	G	A	2	5	7	0	0	7	0	0
1	41489433	.	C	T	1	2	3	0	0	3	0	0
1	41498219	.	A	G	5	3	8	0	1	9	0	0
1	41512895	.	C	T	1	3	4	0	0	4	0	0
1	41513332	.	G	A	5	3	8	0	0	8	0	0
1	41513497	.	G	A	3	7	10	0	4	14	0	0
1	41530370	.	C	T	1	7	8	0	0	8	0	0
1	41596182	.	A	G	2	6	8	0	1	9	0	0
1	41596199	.	A	G	2	7	9	0	0	9	0	0
1	41596420	.	A	C	2	0	2	0	0	2	0	0
1	41600339	.	T	C	1	0	1	0	0	1	0	0
1	41604931	.	C	G	3	0	3	0	5	8	0	0
1	41604934	.	C	G	3	0	3	0	5	8	0	0
1	41604985	.	G	A	1	5	6	0	6	12	0	0
1	41605011	.	T	C	5	4	9	0	0	9	0	0
1	41605065	.	C	A	3	3	6	0	0	6	0	0
1	41605149	.	T	C	0	5	5	0	1	6	0	0
1	41605203	.	C	T	1	4	5	0	0	5	0	0
1	41609925	.	C	T	1	2	3	0	0	3	0	0
1	41609961	.	C	A	3	2	5	0	1	6	0	0
1	41615949	.	T	C	2	3	5	0	0	5	0	0
1	41616081	.	T	G	1	5	6	0	0	6	0	0
1	41616186	.	A	C	6	2	8	0	1	9	0	0
1	41690506	.	C	T	7	7	14	0	0	14	0	0
1	41730609	.	C	T	16	17	33	0	1	34	0	0
1	41730669	.	G	A	11	11	22	0	2	24	0	0
1	41744103	.	C	T	2	5	7	0	0	7	0	0
1	41755157	.	C	T	10	13	23	0	0	23	0	0
1	41755158	.	A	T	10	12	22	0	1	23	0	0
1	41755195	.	C	T	14	11	25	0	1	26	0	0
1	41770847	.	T	A	9	12	21	0	1	22	0	0
1	41770872	.	T	C	10	7	17	0	2	19	0	0
1	41770930	.	T	C	9	4	13	0	1	14	0	0
1	41770959	.	T	C	9	6	15	0	0	15	0	0
1	41817556	.	G	A	5	2	7	0	0	7	0	0
1	41817574	.	T	C	3	2	5	0	0	5	0	0
1	41817678	.	C	T	4	4	8	0	0	8	0	0
1	41849293	.	A	G	6	9	15	0	2	17	0	0
1	41849310	.	A	G	4	9	13	0	1	14	0	0
1	41865471	.	C	T	4	3	7	0	0	7	0	0
1	42375005	.	C	A	14	9	23	0	0	23	0	0
1	42375071	.	C	T	2	4	6	0	1	7	0	0
1	42386349	.	T	C	5	10	15	0	0	15	0	0
1	42386364	.	C	A	5	8	13	0	1	14	0	0
1	42386430	.	T	C	1	0	1	0	1	2	0	0
1	42388351	.	T	C	2	3	5	0	0	5	0	0
1	42391172	.	T	C	9	3	12	0	0	12	0	0
1	42391194	.	T	C	6	2	8	0	0	8	0	0
1	42391214	.	G	A	1	1	2	0	0	2	0	0
1	42776652	.	T	C	11	20	31	0	0	31	0	0
1	42776787	.	C	T	5	10	15	0	19	34	0	0
1	42776806	.	A	T	25	9	34	0	4	38	0	0
1	42776853	.	T	C	23	14	37	0	1	38	0	0
1	42776906	.	A	G	18	15	33	0	2	35	0	0
1	42777116	.	G	A	17	14	31	0	3	34	0	0
1	42777146	.	C	G	0	14	14	0	14	28	0	0
1	42777383	.	A	G	10	14	24	0	2	26	0	0
1	42777593	.	T	G	13	12	25	0	0	25	0	0
1	42777674	.	G	A	16	9	25	0	0	25	0	0
1	42882955	.	C	T	10	6	16	0	0	16	0	0
1	43023630	.	G	A	7	5	12	0	1	13	0	0
1	43034947	.	C	T	21	18	39	0	2	41	0	0
1	43035178	.	T	C	13	15	28	0	1	29	0	0
1	43035546	.	T	A	9	8	17	0	1	18	0	0
1	43659248	.	C	T	0	8	8	0	5	13	0	0
1	43670083	.	A	G	3	2	5	0	0	5	0	0
1	43670378	.	C	T	0	3	3	0	3	6	0	0
1	43682472	.	C	A	3	7	10	0	1	11	0	0
1	43684513	.	A	G	0	3	3	0	1	4	0	0
1	43699581	.	C	T	1	1	2	0	1	3	0	0
1	43699582	.	C	T	1	2	3	0	0	3	0	0
1	43706277	.	A	G	0	2	2	0	0	2	0	0
1	43720168	.	A	G	4	3	7	0	0	7	0	0
1	43974433	.	A	T	1	2	3	0	2	5	0	0
1	43974456	.	G	A	1	3	4	0	1	5	0	0
1	43974472	.	T	A	4	1	5	0	2	7	0	0
1	43976971	.	T	C	1	0	1	0	2	3	0	0
1	43976972	.	T	G	1	2	3	0	0	3	0	0
1	43988974	.	G	A	5	4	9	0	0	9	0	0
1	43994103	.	A	G	4	10	14	0	0	14	0	0
1	43994129	.	A	G	5	6	11	0	0	11	0	0
1	43994191	.	T	C	3	2	5	0	0	5	0	0
1	43994382	.	G	C	2	4	6	0	0	6	0	0
1	43994447	.	A	C	3	5	8	0	0	8	0	0
1	43994567	.	G	A	4	3	7	0	1	8	0	0
1	43994796	.	T	G	6	2	8	0	0	8	0	0
1	43994840	.	T	A	6	3	9	0	0	9	0	0
1	43994948	.	C	A	1	0	1	0	0	1	0	0
1	43997679	.	C	T	0	0	0	0	1	1	0	0
1	43998272	.	C	T	2	5	7	0	0	7	0	0
1	43998275	.	G	A	5	2	7	0	0	7	0	0
1	44000786	.	C	T	1	0	1	0	0	1	0	0
1	44011563	.	A	G	2	1	3	0	0	3	0	0
1	44021800	.	G	T	3	3	6	0	2	8	0	0
1	44021837	.	A	C	4	0	4	0	3	7	0	0
1	44022017	.	C	G	5	7	12	0	0	12	0	0
1	44032460	.	G	T	1	3	4	0	0	4	0	0
1	44040513	.	A	T	5	5	10	0	0	10	0	0
1	44040606	.	G	A	4	4	8	0	0	8	0	0
1	44040854	.	T	C	4	4	8	0	0	8	0	0
1	44041350	.	G	A	4	4	8	0	0	8	0	0
1	44048263	.	C	T	3	6	9	0	0	9	0	0
1	44048446	.	C	A	0	2	2	0	4	6	0	0
1	44205523	.	C	A	2	2	4	0	0	4	0	0
1	44205679	.	G	A	0	9	9	0	3	12	0	0
1	44216738	.	A	C	4	6	10	0	1	11	0	0
1	44227346	.	C	T	7	5	12	0	1	13	0	0
1	44227764	.	G	T	5	6	11	0	1	12	0	0
1	44228020	.	T	A	5	8	13	0	0	13	0	0
1	44228033	.	G	A	0	7	7	0	8	15	0	0
1	44228081	.	A	G	3	9	12	0	0	12	0	0
1	44228243	.	T	G	6	7	13	0	0	13	0	0
1	44228705	.	C	T	6	4	10	0	2	12	0	0
1	44390558	.	A	G	22	18	40	0	2	42	0	0
1	44393977	.	T	C	23	12	35	0	1	36	0	0
1	44394276	.	A	T	7	2	9	0	2	11	0	0
1	44394329	.	T	G	2	3	5	0	0	5	0	0
1	44417715	.	C	T	1	1	2	0	1	3	0	0
1	44422062	.	C	A	1	2	3	0	0	3	0	0
1	44422071	.	T	G	1	2	3	0	0	3	0	0
1	44422113	.	G	A	1	2	3	0	0	3	0	0
1	44491134	.	A	T	13	9	22	0	1	23	0	0
1	44492030	.	C	A	24	15	39	0	1	40	0	0
1	44492413	.	C	T	7	11	18	0	1	19	0	0
1	44492476	.	C	T	16	15	31	0	1	32	0	0
1	44492626	.	A	C	21	22	43	0	1	44	0	0
1	44492791	.	C	T	28	16	44	0	2	46	0	0
1	44492842	.	G	T	24	20	44	0	0	44	0	0
1	44492875	.	A	T	23	19	42	0	1	43	0	0
1	44492908	.	G	A	1	26	27	0	22	49	0	0
1	44493085	.	C	T	32	22	54	0	1	55	0	0
1	44493498	.	A	T	33	14	47	0	1	48	0	0
1	44493575	.	C	A	22	13	35	0	0	35	0	0
1	44493952	.	G	A	2	25	27	0	21	48	0	0
1	44493971	.	G	A	24	25	49	0	0	49	0	0
1	44494090	.	G	A	1	27	28	0	35	63	0	0
1	44494371	.	G	T	0	21	21	0	20	41	0	0
1	44494506	.	G	T	18	12	30	0	3	33	0	0
1	44494654	.	A	G	3	1	4	0	0	4	0	0
1	44495258	.	C	T	22	32	54	0	1	55	0	0
1	44540607	.	G	A	0	8	8	0	0	8	0	0
1	44548800	.	T	C	1	4	5	0	0	5	0	0
1	44564983	.	C	T	7	10	17	0	0	17	0	0
1	44565022	.	T	C	5	8	13	0	3	16	0	0
1	44565025	.	C	T	7	7	14	0	1	15	0	0
1	44565084	.	C	T	7	7	14	0	5	19	0	0
1	44565138	.	T	C	7	11	18	0	0	18	0	0
1	44565188	.	C	A	9	6	15	0	1	16	0	0
1	44565288	.	A	T	12	6	18	0	3	21	0	0
1	44566038	.	A	C	6	9	15	0	2	17	0	0
1	44566084	.	C	T	9	11	20	0	1	21	0	0
1	44566133	.	C	A	16	10	26	0	1	27	0	0
1	44566193	.	G	T	0	14	14	0	14	28	0	0
1	44566355	.	C	T	1	4	5	0	0	5	0	0
1	44569458	.	G	A	10	11	21	0	2	23	0	0
1	44569717	.	C	T	0	10	10	0	17	27	0	0
1	44569822	.	G	A	17	10	27	0	2	29	0	0
1	44569907	.	A	C	7	9	16	0	1	17	0	0
1	44570740	.	C	T	19	16	35	0	1	36	0	0
1	44571077	.	A	G	5	6	11	0	0	11	0	0
1	44571114	.	T	A	2	3	5	0	0	5	0	0
1	44571305	.	T	C	11	0	11	0	6	17	0	0
1	44571370	.	C	T	0	4	4	0	11	15	0	0
1	44571420	.	G	T	5	12	17	0	0	17	0	0
1	44571480	.	G	T	8	19	27	0	0	27	0	0
1	44571672	.	C	T	0	10	10	0	9	19	0	0
1	44581710	.	C	T	0	9	9	0	5	14	0	0
1	44582513	.	C	T	10	10	20	0	0	20	0	0
1	44582576	.	G	A	1	11	12	0	11	23	0	0
1	44582657	.	G	A	1	1	2	0	1	3	0	0
1	44591232	.	C	A	4	8	12	0	1	13	0	0
1	44651929	.	G	C	4	5	9	0	14	23	0	0
1	44652498	.	A	G	20	24	44	0	1	45	0	0
1	44652511	.	A	C	20	18	38	0	2	40	0	0
1	44652599	.	T	C	15	1	16	0	20	36	0	0
1	44652916	.	T	A	20	20	40	0	0	40	0	0
1	44653014	.	C	T	27	20	47	0	6	53	0	0
1	44653076	.	A	T	24	24	48	0	0	48	0	0
1	44653135	.	T	A	25	9	34	0	2	36	0	0
1	44653150	.	T	A	24	10	34	0	1	35	0	0
1	44653171	.	A	G	21	12	33	0	2	35	0	0
1	44658849	.	T	C	15	0	15	0	15	30	0	0
1	44664964	.	T	A	3	3	6	0	1	7	0	0
1	44669970	.	G	T	13	6	19	0	1	20	0	0
1	44672271	.	G	A	3	4	7	0	0	7	0	0
1	44672571	.	G	A	7	9	16	0	0	16	0	0
1	44678037	.	A	G	4	8	12	0	1	13	0	0
1	44683393	.	G	A	5	8	13	0	0	13	0	0
1	44696138	.	G	A	5	5	10	0	1	11	0	0
1	44703761	.	G	T	9	8	17	0	2	19	0	0
1	44729413	.	C	T	1	8	9	0	0	9	0	0
1	44729449	.	G	C	5	14	19	0	1	20	0	0
1	44729479	.	C	G	4	10	14	0	0	14	0	0
1	44737473	.	G	A	0	3	3	0	1	4	0	0
1	44737588	.	A	T	11	3	14	0	0	14	0	0
1	44737653	.	A	T	8	8	16	0	2	18	0	0
1	44737750	.	T	A	7	3	10	0	0	10	0	0
1	44800397	.	C	A	1	2	3	0	0	3	0	0
1	44818992	.	A	G	17	2	19	0	16	35	0	0
1	44846997	.	G	A	6	5	11	0	0	11	0	0
1	44849126	.	C	T	2	4	6	0	0	6	0	0
1	44852503	.	T	C	8	5	13	0	0	13	0	0
1	44852737	.	G	C	5	6	11	0	0	11	0	0
1	44852817	.	G	A	8	4	12	0	0	12	0	0
1	44855409	.	T	C	1	3	4	0	0	4	0	0
1	44861744	.	C	T	9	7	16	0	1	17	0	0
1	44861954	.	A	T	11	14	25	0	0	25	0	0
1	44862092	.	C	G	12	20	32	0	4	36	0	0
1	44862707	.	C	T	8	13	21	0	1	22	0	0
1	44862725	.	G	A	11	14	25	0	0	25	0	0
1	44869068	.	G	A	14	6	20	0	1	21	0	0
1	44869115	.	C	T	18	7	25	0	1	26	0	0
1	44869173	.	A	T	11	12	23	0	2	25	0	0
1	44869174	.	C	T	13	11	24	0	1	25	0	0
1	44869216	.	G	A	12	10	22	0	2	24	0	0
1	44869621	.	G	A	9	9	18	0	0	18	0	0
1	44869638	.	A	G	11	7	18	0	0	18	0	0
1	44869666	.	C	A	11	7	18	0	0	18	0	0
1	44869810	.	T	C	3	7	10	0	0	10	0	0
1	44872586	.	A	G	6	6	12	0	0	12	0	0
1	44872817	.	A	G	1	3	4	0	0	4	0	0
1	44897218	.	G	C	0	0	0	0	2	2	0	0
1	44897259	.	C	A	0	2	2	0	1	3	0	0
1	44919737	.	C	T	1	1	2	0	0	2	0	0
1	44922211	.	T	G	1	1	2	0	0	2	0	0
1	44922230	.	G	T	1	2	3	0	0	3	0	0
1	44922300	.	C	T	2	2	4	0	0	4	0	0
1	44922512	.	G	A	3	2	5	0	0	5	0	0
1	44923148	.	C	T	3	2	5	0	0	5	0	0
1	44923565	.	C	T	3	3	6	0	0	6	0	0
1	44923830	.	T	C	1	4	5	0	0	5	0	0
1	44925468	.	C	T	0	2	2	0	1	3	0	0
1	44925945	.	C	T	3	3	6	0	0	6	0	0
1	44925956	.	C	T	1	3	4	0	0	4	0	0
1	44926113	.	G	A	1	6	7	0	0	7	0	0
1	44928834	.	A	T	1	2	3	0	0	3	0	0
1	44950079	.	G	T	2	4	6	0	0	6	0	0
1	44950178	.	T	G	2	4	6	0	0	6	0	0
1	44959343	.	C	G	9	10	19	0	0	19	0	0
1	44959347	.	C	A	10	10	20	0	1	21	0	0
1	44959408	.	C	A	12	12	24	0	1	25	0	0
1	44959538	.	C	T	5	10	15	0	1	16	0	0
1	44960204	.	T	A	4	3	7	0	0	7	0	0
1	44960252	.	A	G	3	12	15	0	0	15	0	0
1	44960386	.	A	G	3	2	5	0	1	6	0	0
1	44960898	.	G	A	3	13	16	0	0	16	0	0
1	44961055	.	A	C	1	5	6	0	0	6	0	0
1	44961092	.	T	A	2	7	9	0	1	10	0	0
1	44961143	.	A	C	3	7	10	0	0	10	0	0
1	44961245	.	C	A	3	6	9	0	0	9	0	0
1	44961285	.	C	T	6	3	9	0	2	11	0	0
1	44961347	.	T	A	5	4	9	0	0	9	0	0
1	44961387	.	G	A	0	2	2	0	4	6	0	0
1	44961406	.	A	G	1	0	1	0	7	8	0	0
1	44961612	.	A	T	10	8	18	0	0	18	0	0
1	44961698	.	A	G	14	0	14	0	13	27	0	0
1	44962036	.	T	A	11	13	24	0	0	24	0	0
1	45003075	.	G	T	2	0	2	0	0	2	0	0
1	45011637	.	A	G	2	7	9	0	0	9	0	0
1	45013571	.	G	A	7	8	15	0	2	17	0	0
1	45013760	.	A	G	5	0	5	0	6	11	0	0
1	45013775	.	T	C	5	6	11	0	0	11	0	0
1	45013904	.	G	A	1	8	9	0	0	9	0	0
1	45014176	.	G	A	7	10	17	0	0	17	0	0
1	45014263	.	A	G	4	15	19	0	0	19	0	0
1	45014361	.	C	A	4	5	9	0	0	9	0	0
1	45014976	.	C	G	6	9	15	0	0	17	2	0
1	45015095	.	A	T	15	6	21	0	1	22	0	0
1	45015310	.	T	C	4	3	7	0	0	7	0	0
1	45015586	.	G	A	8	4	12	0	0	12	0	0
1	45015654	.	T	C	4	4	8	0	7	15	0	0
1	45015687	.	T	C	8	8	16	0	0	16	0	0
1	45015693	.	C	T	8	7	15	0	2	17	0	0
1	45015809	.	A	G	2	6	8	0	1	9	0	0
1	45016070	.	C	T	7	8	15	0	1	16	0	0
1	45016502	.	T	A	15	11	26	0	0	26	0	0
1	45019745	.	C	T	5	5	10	0	0	10	0	0
1	45022069	.	C	T	2	8	10	0	2	12	0	0
1	45022114	.	G	A	8	21	29	0	3	32	0	0
1	45022156	.	C	T	3	14	17	0	0	17	0	0
1	45038781	.	G	A	1	0	1	0	0	1	0	0
1	45038894	.	G	A	2	0	2	0	0	2	0	0
1	45038963	.	A	C	11	5	16	0	1	17	0	0
1	45038966	.	T	C	5	11	16	0	1	17	0	0
1	45039608	.	T	C	10	11	21	0	0	21	0	0
1	45041107	.	T	C	4	10	14	0	1	15	0	0
1	45041116	.	A	C	4	11	15	0	0	15	0	0
1	45041152	.	C	T	2	8	10	0	8	18	0	0
1	45041257	.	G	A	2	5	7	0	0	7	0	0
1	45044236	.	A	G	16	10	26	0	0	26	0	0
1	45045401	.	A	G	10	14	24	0	2	26	0	0
1	45085242	.	T	C	13	11	24	0	0	24	0	0
1	45085261	.	C	G	13	0	13	0	11	24	0	0
1	45086369	.	T	C	8	20	28	0	1	29	0	0
1	45086405	.	G	A	2	1	3	0	0	3	0	0
1	45087729	.	G	A	24	22	46	0	0	46	0	0
1	45087810	.	A	T	2	2	4	0	1	5	0	0
1	45093732	.	A	C	22	21	43	0	1	44	0	0
1	45093762	.	A	G	25	25	50	0	1	51	0	0
1	45093769	.	A	T	23	25	48	0	2	50	0	0
1	45094157	.	C	T	25	22	47	0	1	48	0	0
1	45094226	.	T	G	19	22	41	0	0	41	0	0
1	45094235	.	G	A	17	22	39	0	0	39	0	0
1	45094264	.	C	G	10	26	36	0	0	36	0	0
1	45094317	.	A	T	5	40	45	0	0	45	0	0
1	45095150	.	C	A	3	10	13	0	2	15	0	0
1	45095157	.	G	A	0	11	11	0	3	14	0	0
1	45096592	.	A	C	1	4	5	0	0	5	0	0
1	45096593	.	A	C	1	3	4	0	1	5	0	0
1	45206076	.	G	A	19	7	26	0	1	27	0	0
1	45208096	.	G	A	4	11	15	0	0	15	0	0
1	45208396	.	C	T	0	6	6	0	8	14	0	0
1	45208771	.	C	A	7	8	15	0	0	15	0	0
1	45211431	.	G	A	8	12	20	0	0	20	0	0
1	45211599	.	C	T	6	3	9	0	2	11	0	0
1	45211602	.	G	A	5	4	9	0	0	9	0	0
1	45213290	.	G	A	0	2	2	0	0	2	0	0
1	45236368	.	C	T	0	1	1	0	0	1	0	0
1	45236375	.	C	T	0	1	1	0	0	1	0	0
1	45246614	.	T	C	2	1	3	0	0	3	0	0
1	45261353	.	C	T	2	3	5	0	0	5	0	0
1	45261383	.	G	A	0	1	1	0	1	2	0	0
1	45262384	.	A	T	1	2	3	0	0	3	0	0
1	45282540	.	G	T	1	2	3	0	0	3	0	0
1	45282543	.	C	T	1	2	3	0	0	3	0	0
1	45282591	.	T	C	1	2	3	0	1	4	0	0
1	45282594	.	A	G	2	1	3	0	2	5	0	0
1	45330064	.	G	A	7	5	12	0	1	13	0	0
1	45330165	.	A	C	15	26	41	0	2	43	0	0
1	45330174	.	C	T	15	25	40	0	2	42	0	0
1	45330207	.	C	T	24	18	42	0	0	42	0	0
1	45330386	.	T	G	12	3	15	0	15	31	1	0
1	45332801	.	T	G	6	4	10	0	0	10	0	0
1	45335160	.	G	A	0	2	2	0	0	2	0	0
1	45335187	.	G	A	3	0	3	0	0	3	0	0
1	45337115	.	G	A	2	5	7	0	0	7	0	0
1	45340851	.	G	A	2	0	2	0	0	2	0	0
1	45355709	.	C	T	5	4	9	0	0	9	0	0
1	45366004	.	A	G	5	3	8	0	0	8	0	0
1	45366096	.	G	A	0	5	5	0	5	10	0	0
1	45366137	.	A	T	1	3	4	0	0	4	0	0
1	45366338	.	C	T	2	0	2	0	1	3	0	0
1	45366386	.	C	A	1	1	2	0	0	2	0	0
1	45373247	.	A	G	9	20	29	0	1	30	0	0
1	45373517	.	C	A	13	17	30	0	0	30	0	0
1	45373665	.	G	A	14	16	30	0	0	30	0	0
1	45373666	.	T	C	12	16	28	0	2	30	0	0
1	45373795	.	A	G	20	18	38	0	1	39	0	0
1	45374657	.	T	A	7	10	17	0	0	17	0	0
1	45375065	.	G	A	3	12	15	0	0	15	0	0
1	45375573	.	A	T	11	7	18	0	0	18	0	0
1	45375666	.	G	A	7	6	13	0	0	13	0	0
1	45375790	.	C	A	7	8	15	0	0	15	0	0
1	45376352	.	T	C	10	12	22	0	1	23	0	0
1	45376413	.	G	A	15	15	30	0	0	30	0	0
1	45378546	.	G	A	4	7	11	0	0	11	0	0
1	45383598	.	C	T	3	4	7	0	0	7	0	0
1	45383646	.	G	A	1	1	2	0	0	2	0	0
1	45393491	.	C	T	0	7	7	0	6	13	0	0
1	45526241	.	G	A	5	2	7	0	0	7	0	0
1	45526247	.	C	G	0	3	3	0	5	8	0	0
1	45526337	.	C	A	0	8	8	0	6	14	0	0
1	45526418	.	T	G	7	9	16	0	0	16	0	0
1	45526439	.	G	A	11	10	21	0	0	21	0	0
1	45570224	.	T	A	5	6	11	0	1	12	0	0
1	45570225	.	T	A	3	8	11	0	1	12	0	0
1	45570384	.	T	A	17	16	33	0	1	34	0	0
1	45570876	.	G	A	25	16	41	0	3	44	0	0
1	45570909	.	C	A	1	23	24	0	25	49	0	0
1	45574320	.	C	T	0	17	17	0	15	32	0	0
1	45574347	.	T	C	9	0	9	0	16	25	0	0
1	45574478	.	T	A	11	13	24	0	3	27	0	0
1	45574560	.	T	C	10	8	18	0	0	18	0	0
1	45577570	.	A	G	7	8	15	0	2	17	0	0
1	45577899	.	A	G	15	14	29	0	1	30	0	0
1	45616925	.	G	A	16	24	40	0	0	40	0	0
1	45617163	.	G	A	20	18	38	0	2	40	0	0
1	45617226	.	C	A	18	14	32	0	1	33	0	0
1	45617239	.	A	G	19	11	30	0	0	30	0	0
1	45617300	.	G	A	15	12	27	0	0	27	0	0
1	45617436	.	C	T	21	23	44	0	0	44	0	0
1	45617457	.	C	G	25	18	43	0	2	45	0	0
1	45617478	.	T	A	13	25	38	0	6	44	0	0
1	45617577	.	T	A	22	28	50	0	1	51	0	0
1	45617657	.	A	T	20	25	45	0	0	45	0	0
1	45617743	.	C	T	16	27	43	0	4	47	0	0
1	45619758	.	T	C	0	1	1	0	0	1	0	0
1	45631275	.	T	C	7	0	7	0	10	17	0	0
1	45631469	.	G	A	17	16	33	0	0	33	0	0
1	45650749	.	G	A	1	1	2	0	0	2	0	0
1	45650752	.	T	A	1	1	2	0	1	3	0	0
1	45663834	.	T	C	11	7	18	0	0	18	0	0
1	45663869	.	C	T	6	6	12	0	0	12	0	0
1	45663883	.	T	G	5	6	11	0	0	11	0	0
1	45663949	.	A	G	2	0	2	0	0	2	0	0
1	45664224	.	C	T	19	22	41	0	1	42	0	0
1	45664260	.	G	A	27	14	41	0	1	42	0	0
1	45668754	.	C	T	9	16	25	0	1	26	0	0
1	45669078	.	A	C	6	7	13	0	1	14	0	0
1	45669273	.	A	C	4	3	7	0	1	8	0	0
1	45697283	.	C	A	3	1	4	0	2	6	0	0
1	45697339	.	G	T	1	6	7	0	0	7	0	0
1	45697652	.	C	T	4	2	6	0	1	7	0	0
1	45697813	.	C	T	1	4	5	0	1	6	0	0
1	45697838	.	T	A	1	3	4	0	1	5	0	0
1	45699993	.	C	T	3	5	8	0	0	8	0	0
1	45700116	.	T	C	2	2	4	0	0	4	0	0
1	45700509	.	G	A	0	2	2	0	1	3	0	0
1	45700511	.	G	A	1	2	3	0	0	3	0	0
1	45700572	.	T	A	1	3	4	0	0	4	0	0
1	45727918	.	A	G	3	0	3	0	4	7	0	0
1	45727928	.	A	G	3	1	4	0	2	6	0	0
1	45730896	.	A	T	1	1	2	0	0	2	0	0
1	45730905	.	T	C	2	1	3	0	0	3	0	0
1	45735695	.	T	C	2	1	3	0	0	3	0	0
1	45735704	.	A	G	1	2	3	0	0	3	0	0
1	45735817	.	G	A	1	1	2	0	0	2	0	0
1	45735990	.	G	A	1	1	2	0	6	8	0	0
1	45736045	.	T	A	6	6	12	0	0	12	0	0
1	45736171	.	A	G	2	0	2	0	7	9	0	0
1	45736412	.	A	C	2	6	8	0	0	8	0	0
1	45736517	.	A	C	3	3	6	0	0	6	0	0
1	45736528	.	G	A	3	3	6	0	0	6	0	0
1	45737067	.	T	G	3	7	10	0	1	11	0	0
1	45737202	.	G	A	8	7	15	0	1	16	0	0
1	45737271	.	G	A	7	3	10	0	0	10	0	0
1	45737442	.	C	T	6	9	15	0	2	17	0	0
1	45737590	.	C	A	6	6	12	0	2	15	1	0
1	45741134	.	C	A	3	3	6	0	0	6	0	0
1	45741220	.	A	G	1	0	1	0	3	4	0	0
1	45741347	.	C	A	1	2	3	0	0	3	0	0
1	45742382	.	C	T	1	3	4	0	1	5	0	0
1	45742481	.	A	T	1	3	4	0	0	4	0	0
1	45742555	.	T	C	4	2	6	0	0	6	0	0
1	45742715	.	T	G	4	3	7	0	0	7	0	0
1	45815037	.	C	T	0	2	2	0	0	2	0	0
1	45822935	.	A	G	0	1	1	0	0	1	0	0
1	45828280	.	G	A	1	0	1	0	0	1	0	0
1	45833127	.	T	C	2	4	6	0	0	6	0	0
1	45833155	.	A	C	5	2	7	0	0	7	0	0
1	45833165	.	A	T	3	5	8	0	1	9	0	0
1	45833715	.	G	C	1	3	4	0	0	4	0	0
1	45833734	.	A	T	1	3	4	0	0	4	0	0
1	45834146	.	C	G	3	3	6	0	0	6	0	0
1	45834156	.	A	T	3	2	5	0	0	5	0	0
1	45834432	.	C	A	1	2	3	1	0	5	1	0
1	45834495	.	A	G	2	0	2	0	8	10	0	0
1	45834504	.	C	T	2	9	11	0	0	11	0	0
1	45834543	.	C	T	1	10	11	0	1	12	0	0
1	45834549	.	C	T	1	11	12	0	0	12	0	0
1	45835214	.	A	G	2	0	2	0	2	4	0	0
1	45835246	.	A	T	4	2	6	0	1	7	0	0
1	45835269	.	G	A	0	4	4	0	6	10	0	0
1	45835298	.	C	T	6	3	9	0	0	9	0	0
1	45835455	.	A	T	1	6	7	0	0	7	0	0
1	45835486	.	G	A	10	3	13	0	0	13	0	0
1	45835499	.	C	G	3	7	10	0	0	10	0	0
1	45835521	.	T	C	3	6	9	0	0	9	0	0
1	45835542	.	A	C	2	2	4	0	0	4	0	0
1	45835815	.	G	A	4	4	8	0	0	8	0	0
1	45835870	.	T	G	3	4	7	0	0	7	0	0
1	45840013	.	T	C	10	4	14	0	0	14	0	0
1	45848680	.	G	T	0	0	0	0	1	1	0	0
1	45848713	.	G	A	0	2	2	0	2	4	0	0
1	45853934	.	A	G	1	0	1	0	2	3	0	0
1	45867414	.	G	T	14	8	22	0	3	25	0	0
1	45867759	.	C	T	18	13	31	0	0	31	0	0
1	45867830	.	A	G	18	17	35	0	4	39	0	0
1	45867834	.	C	T	19	19	38	0	3	41	0	0
1	45868007	.	C	T	2	14	16	0	28	44	0	0
1	45868178	.	C	T	19	11	30	0	1	31	0	0
1	45869326	.	C	T	5	16	21	0	0	21	0	0
1	45869447	.	C	A	15	11	26	0	0	26	0	0
1	45869588	.	A	C	13	14	27	0	0	27	0	0
1	45869923	.	T	C	7	11	18	0	1	19	0	0
1	45870044	.	G	A	8	9	17	0	2	19	0	0
1	45870046	.	G	T	9	8	17	0	2	19	0	0
1	45870223	.	A	G	8	5	13	0	0	13	0	0
1	45870253	.	A	G	1	4	5	0	1	6	0	0
1	45870438	.	C	T	12	7	19	0	0	19	0	0
1	45870644	.	A	G	4	5	9	0	0	9	0	0
1	45871331	.	T	C	5	9	14	0	0	14	0	0
1	45879827	.	G	A	6	3	9	0	0	9	0	0
1	45889009	.	T	C	1	1	2	0	1	3	0	0
1	45892097	.	G	A	4	5	9	0	0	9	0	0
1	45892469	.	C	G	6	6	12	0	0	12	0	0
1	45892556	.	G	A	3	2	5	0	0	5	0	0
1	45892706	.	A	G	0	3	3	0	0	3	0	0
1	45894103	.	C	T	0	5	5	0	4	9	0	0
1	45894674	.	G	T	0	1	1	0	0	1	0	0
1	45894827	.	G	T	1	3	4	0	0	4	0	0
1	45897988	.	C	T	0	4	4	0	0	4	0	0
1	45898011	.	G	A	0	3	3	0	0	3	0	0
1	45901870	.	A	G	5	4	9	0	1	10	0	0
1	45902230	.	A	G	5	4	9	0	0	9	0	0
1	45902233	.	G	T	4	4	8	0	1	9	0	0
1	45905957	.	G	T	0	1	1	0	0	1	0	0
1	45906234	.	C	T	1	3	4	0	0	4	0	0
1	45923628	.	C	T	2	2	4	0	0	4	0	0
1	45923630	.	C	A	2	2	4	0	0	4	0	0
1	45935510	.	G	A	13	4	17	0	1	18	0	0
1	45935642	.	T	C	6	13	19	0	1	20	0	0
1	45935753	.	A	G	12	8	20	0	0	20	0	0
1	45935849	.	G	A	3	10	13	0	1	14	0	0
1	45937639	.	A	G	0	1	1	0	0	1	0	0
1	45937693	.	A	G	8	0	8	0	6	14	0	0
1	45939811	.	A	G	4	0	4	0	3	7	0	0
1	45941557	.	G	A	7	13	20	0	2	22	0	0
1	45944033	.	C	T	4	4	8	0	0	8	0	0
1	45946667	.	C	T	1	2	3	0	0	3	0	0
1	45946739	.	C	T	3	4	7	0	0	7	0	0
1	45947875	.	G	T	2	4	6	0	0	6	0	0
1	45948157	.	G	A	5	5	10	0	0	10	0	0
1	45952994	.	T	C	11	5	16	0	0	16	0	0
1	45953009	.	C	T	10	3	13	0	0	13	0	0
1	45953066	.	G	A	0	2	2	0	1	3	0	0
1	45953087	.	C	T	0	2	2	0	0	2	0	0
1	45955771	.	A	C	8	9	17	0	3	20	0	0
1	45956046	.	G	A	9	10	19	0	1	20	0	0
1	45956166	.	G	T	7	9	16	0	0	16	0	0
1	45956231	.	A	G	7	5	12	0	0	12	0	0
1	45956332	.	A	G	7	4	11	0	0	11	0	0
1	46265542	.	G	A	6	2	8	0	0	8	0	0
1	46619444	.	T	G	0	3	3	0	1	4	0	0
1	46831357	.	G	A	4	6	10	0	0	10	0	0
1	47120514	.	A	T	0	1	1	0	0	1	0	0
1	47141486	.	A	G	0	2	2	0	0	2	0	0
1	47686101	.	T	A	0	3	3	0	0	3	0	0
1	48487555	.	C	T	1	2	3	0	0	3	0	0
1	48487556	.	T	G	1	2	3	0	0	3	0	0
1	48487729	.	T	A	2	2	4	0	0	4	0	0
1	48488243	.	T	G	3	3	6	0	2	8	0	0
1	48488362	.	T	A	1	3	4	0	0	4	0	0
1	48488436	.	C	T	3	4	7	0	3	10	0	0
1	48488619	.	A	C	3	2	5	0	0	5	0	0
1	48488637	.	A	G	0	2	2	0	1	3	0	0
1	48581662	.	T	C	1	3	4	0	1	5	0	0
1	48581919	.	C	T	8	3	11	0	0	11	0	0
1	48582091	.	T	C	5	2	7	0	0	7	0	0
1	48582102	.	T	C	4	2	6	0	0	6	0	0
1	48582400	.	C	T	2	2	4	0	0	4	0	0
1	48583000	.	T	C	4	10	14	0	0	14	0	0
1	48583521	.	A	C	4	5	9	0	0	9	0	0
1	48583528	.	C	T	4	6	10	0	0	10	0	0
1	48583844	.	G	C	0	3	3	0	0	3	0	0
1	48587725	.	T	A	5	1	6	0	1	7	0	0
1	48607301	.	T	C	1	3	4	0	1	5	0	0
1	48607361	.	A	G	1	0	1	0	0	1	0	0
1	48922123	.	C	T	0	2	2	0	1	3	0	0
1	48922154	.	A	G	3	2	5	0	0	5	0	0
1	48922158	.	T	G	3	2	5	0	0	5	0	0
1	49289663	.	G	A	0	11	11	0	12	23	0	0
1	49289729	.	C	G	6	1	7	0	10	17	0	0
1	49293733	.	C	T	27	26	53	0	4	57	0	0
1	49293891	.	G	A	22	13	35	0	0	35	0	0
1	49294003	.	G	A	17	7	24	0	1	25	0	0
1	49294654	.	G	A	12	10	22	0	0	22	0	0
1	49294727	.	G	C	11	17	28	0	1	29	0	0
1	49294765	.	T	C	17	21	38	0	3	41	0	0
1	49420026	.	T	C	4	7	11	0	0	11	0	0
1	49420044	.	G	A	5	7	12	0	0	12	0	0
1	49420637	.	G	A	2	8	10	0	0	10	0	0
1	49420658	.	A	G	3	10	13	0	0	13	0	0
1	49423200	.	G	A	3	0	3	0	0	3	0	0
1	49425668	.	C	T	1	1	2	0	0	2	0	0
1	49425737	.	C	T	2	7	9	0	0	9	0	0
1	49427972	.	G	C	0	2	2	0	1	3	0	0
1	49429878	.	G	A	0	2	2	0	3	5	0	0
1	49429917	.	C	A	4	3	7	0	2	9	0	0
1	49429944	.	T	A	5	6	11	0	0	11	0	0
1	49435086	.	A	G	2	4	6	0	0	6	0	0
1	49442872	.	T	C	0	1	1	0	0	1	0	0
1	49447611	.	A	G	1	0	1	0	0	1	0	0
1	49453465	.	C	G	1	1	2	0	0	2	0	0
1	49461225	.	A	G	1	2	3	0	0	3	0	0
1	49466161	.	T	A	2	1	3	0	0	3	0	0
1	49466190	.	G	A	1	2	3	0	0	3	0	0
1	49473716	.	G	T	3	6	9	0	0	9	0	0
1	49473970	.	G	C	9	6	15	0	0	15	0	0
1	49474079	.	G	A	1	0	1	0	2	3	0	0
1	49474993	.	T	C	3	5	8	0	0	8	0	0
1	49474995	.	C	T	3	5	8	0	0	8	0	0
1	49475769	.	A	C	4	3	7	0	1	8	0	0
1	49480825	.	T	G	4	6	10	0	0	10	0	0
1	49481546	.	T	A	7	12	19	0	0	19	0	0
1	49481567	.	T	G	7	13	20	0	1	21	0	0
1	49481649	.	T	C	9	11	20	0	1	21	0	0
1	49481787	.	A	G	13	18	31	0	1	32	0	0
1	49481866	.	T	G	9	23	32	0	2	35	1	0
1	49481886	.	A	T	10	18	28	0	0	28	0	0
1	49482717	.	T	A	7	4	11	0	1	12	0	0
1	49482742	.	C	T	9	11	20	0	1	21	0	0
1	49482755	.	C	T	15	12	27	0	0	27	0	0
1	49482984	.	T	A	7	11	18	0	1	19	0	0
1	49483136	.	A	G	2	2	4	0	0	4	0	0
1	49483217	.	C	G	3	2	5	0	0	5	0	0
1	49483242	.	T	C	6	2	8	0	0	8	0	0
1	49483270	.	C	T	6	5	11	0	1	12	0	0
1	49483300	.	A	G	7	6	13	0	1	14	0	0
1	49483679	.	G	A	12	14	26	0	0	26	0	0
1	49483721	.	T	G	14	7	21	0	0	21	0	0
1	49483901	.	T	A	20	11	31	0	0	32	1	0
1	49484002	.	A	T	22	20	42	0	1	43	0	0
1	49484096	.	G	T	19	9	28	0	6	34	0	0
1	49484146	.	G	A	21	13	34	0	3	37	0	0
1	49492396	.	G	A	7	13	20	0	1	21	0	0
1	49497590	.	T	G	7	5	12	0	1	13	0	0
1	49606724	.	A	G	5	5	10	0	0	10	0	0
1	49606801	.	A	G	3	4	7	0	0	7	0	0
1	49607102	.	A	T	3	5	8	0	0	8	0	0
1	49607156	.	T	G	5	5	10	0	0	10	0	0
1	49607223	.	T	A	4	2	6	0	0	6	0	0
1	49607251	.	T	C	5	3	8	0	0	8	0	0
1	49607370	.	G	A	7	5	12	0	1	13	0	0
1	49607490	.	A	C	1	2	3	0	1	4	0	0
1	49607650	.	T	C	1	4	5	0	0	5	0	0
1	49607675	.	T	G	0	5	5	0	1	6	0	0
1	49607706	.	C	T	0	2	2	0	2	4	0	0
1	49607746	.	C	G	1	7	8	0	0	8	0	0
1	49607835	.	A	T	1	8	9	0	0	9	0	0
1	49607861	.	A	G	4	10	14	0	0	14	0	0
1	49607940	.	G	T	1	2	3	0	0	3	0	0
1	49608014	.	T	C	5	7	12	0	0	12	0	0
1	49608027	.	T	C	5	0	5	0	3	8	0	0
1	49608312	.	G	A	2	2	4	0	0	4	0	0
1	49608684	.	G	A	4	1	5	0	0	5	0	0
1	49608691	.	G	C	4	1	5	0	0	5	0	0
1	49609048	.	A	G	1	2	3	0	0	3	0	0
1	49609065	.	A	G	0	2	2	0	0	2	0	0
1	49609113	.	G	C	2	0	2	0	2	4	0	0
1	49609191	.	G	A	4	5	9	0	2	11	0	0
1	49609247	.	G	A	1	0	1	0	0	1	0	0
1	49613880	.	C	T	3	3	6	0	0	6	0	0
1	49625706	.	A	G	1	3	4	0	0	4	0	0
1	49627769	.	C	A	2	4	6	0	0	6	0	0
1	49648996	.	A	T	1	2	3	0	1	4	0	0
1	49649030	.	C	T	0	2	2	0	2	4	0	0
1	49694765	.	T	A	1	0	1	0	1	2	0	0
1	49694773	.	T	C	0	1	1	0	0	1	0	0
1	49696076	.	G	A	4	3	7	0	0	7	0	0
1	49814674	.	T	C	12	19	31	0	1	32	0	0
1	49902787	.	C	T	5	2	7	0	0	7	0	0
1	49909911	.	A	C	2	11	13	0	0	13	0	0
1	49912665	.	C	T	0	1	1	0	0	1	0	0
1	49912827	.	A	G	4	1	5	0	0	5	0	0
1	49912841	.	C	A	0	1	1	0	4	5	0	0
1	49912866	.	C	T	0	1	1	0	3	4	0	0
1	49912990	.	T	C	0	2	2	0	0	2	0	0
1	49913101	.	T	G	3	7	10	0	1	11	0	0
1	49915208	.	G	A	2	14	16	0	0	16	0	0
1	49915231	.	C	T	3	11	14	0	1	15	0	0
1	49915598	.	C	T	1	6	7	0	1	8	0	0
1	49918779	.	T	C	1	4	5	0	0	5	0	0
1	49929579	.	G	A	2	4	6	0	0	6	0	0
1	49929784	.	C	T	3	2	5	0	0	5	0	0
1	49929798	.	T	C	2	0	2	0	3	5	0	0
1	49930146	.	G	A	1	6	7	0	0	7	0	0
1	49931697	.	A	C	1	2	3	0	0	3	0	0
1	50111654	.	C	T	0	1	1	0	0	1	0	0
1	50171219	.	T	C	0	1	1	0	0	1	0	0
1	50172815	.	A	G	7	5	12	0	0	12	0	0
1	50178753	.	T	C	17	6	23	0	1	24	0	0
1	50178829	.	C	A	9	11	20	0	3	23	0	0
1	50178988	.	A	G	5	0	5	0	6	11	0	0
1	50183822	.	C	A	0	2	2	0	0	2	0	0
1	50185244	.	G	A	0	7	7	0	1	8	0	0
1	50187688	.	A	G	11	3	14	0	0	14	0	0
1	50187836	.	T	G	2	4	6	0	0	6	0	0
1	50187866	.	A	G	2	0	2	0	5	7	0	0
1	50198792	.	T	C	6	6	12	0	0	12	0	0
1	50198815	.	C	T	0	5	5	0	7	12	0	0
1	50199365	.	A	T	1	1	2	0	0	2	0	0
1	50199368	.	G	A	1	1	2	0	0	2	0	0
1	50221045	.	G	A	1	3	4	0	0	4	0	0
1	50266704	.	C	G	1	0	1	0	0	1	0	0
1	50301833	.	A	G	1	1	2	0	0	2	0	0
1	50303989	.	G	A	0	7	7	0	8	15	0	0
1	50319584	.	A	G	3	4	7	0	0	7	0	0
1	50393232	.	G	T	1	2	3	0	0	3	0	0
1	50487649	.	G	T	6	13	19	0	0	19	0	0
1	50487837	.	C	A	10	6	16	0	0	16	0	0
1	50487844	.	G	A	10	6	16	0	0	16	0	0
1	50487895	.	T	C	4	0	4	0	7	11	0	0
1	50487938	.	A	C	4	5	9	0	0	9	0	0
1	50488002	.	A	G	9	3	12	0	0	12	0	0
1	50496598	.	A	G	10	7	17	0	1	18	0	0
1	50502852	.	C	T	0	0	0	0	2	2	0	0
1	50519961	.	T	C	3	2	5	0	0	5	0	0
1	50520003	.	A	G	2	2	4	0	0	4	0	0
1	50521790	.	T	C	1	0	1	0	0	1	0	0
1	50521871	.	G	T	1	1	2	0	1	3	0	0
1	50554335	.	T	G	1	2	3	0	0	3	0	0
1	50554362	.	A	C	1	2	3	0	0	3	0	0
1	50594217	.	T	C	13	19	32	0	1	33	0	0
1	50594318	.	T	G	11	11	22	0	1	23	0	0
1	50594346	.	A	G	12	7	19	0	0	19	0	0
1	50594421	.	G	A	7	1	8	0	0	8	0	0
1	50594424	.	C	T	7	1	8	0	0	8	0	0
1	50594647	.	G	A	6	7	13	0	3	16	0	0
1	50594670	.	A	T	7	9	16	0	2	18	0	0
1	50594986	.	T	C	4	0	4	0	9	13	0	0
1	50595288	.	T	C	19	14	33	0	0	33	0	0
1	50595289	.	G	A	18	14	32	0	1	33	0	0
1	50595476	.	G	A	10	7	17	0	0	17	0	0
1	50595608	.	G	C	3	14	17	0	0	17	0	0
1	50595748	.	T	C	10	16	26	0	3	29	0	0
1	50595805	.	G	A	10	13	23	0	0	23	0	0
1	50595809	.	T	A	10	14	24	0	0	24	0	0
1	50596694	.	A	G	9	3	12	0	1	13	0	0
1	50598848	.	G	A	12	16	28	0	0	28	0	0
1	50598872	.	A	G	10	12	22	0	2	24	0	0
1	50602955	.	G	A	1	1	2	0	0	2	0	0
1	50608232	.	T	C	9	14	23	0	2	25	0	0
1	50608373	.	G	A	11	19	30	0	1	31	0	0
1	50608691	.	A	T	2	2	4	0	0	4	0	0
1	50608692	.	T	C	2	2	4	0	0	4	0	0
1	50611013	.	G	A	1	3	4	0	0	4	0	0
1	50646922	.	G	A	0	3	3	0	2	5	0	0
1	50651760	.	C	T	1	0	1	0	0	1	0	0
1	50652102	.	G	A	0	2	2	0	0	2	0	0
1	50656594	.	T	C	1	6	7	0	0	7	0	0
1	50657063	.	T	G	3	0	3	0	0	3	0	0
1	50657093	.	T	C	5	2	7	0	0	7	0	0
1	50657117	.	C	A	6	3	9	0	0	9	0	0
1	50666916	.	C	T	1	2	3	0	0	3	0	0
1	50666985	.	T	A	1	0	1	0	0	1	0	0
1	50668883	.	C	T	2	7	9	0	0	9	0	0
1	50668915	.	C	T	0	3	3	0	1	4	0	0
1	50670799	.	T	C	1	5	6	0	0	6	0	0
1	50673407	.	T	C	1	0	1	0	0	1	0	0
1	50673749	.	G	A	0	1	1	0	2	3	0	0
1	50688646	.	A	G	1	0	1	0	1	2	0	0
1	50688682	.	A	T	2	5	7	0	0	7	0	0
1	50702736	.	C	T	2	5	7	0	0	7	0	0
1	50703007	.	A	G	7	6	13	0	0	13	0	0
1	50847905	.	T	C	7	3	10	0	1	11	0	0
1	50848106	.	A	G	13	6	19	0	0	19	0	0
1	50848115	.	A	G	15	5	20	0	0	20	0	0
1	50848206	.	A	C	7	14	21	0	1	22	0	0
1	50848504	.	C	T	10	17	27	0	2	29	0	0
1	50848532	.	G	A	9	15	24	0	5	29	0	0
1	50848555	.	A	G	12	20	32	0	1	33	0	0
1	50848595	.	T	C	10	22	32	0	3	35	0	0
1	50848609	.	A	C	10	19	29	0	3	32	0	0
1	50848647	.	C	T	1	14	15	0	12	27	0	0
1	50848659	.	A	G	14	12	26	0	0	26	0	0
1	50848815	.	A	G	15	13	28	0	4	32	0	0
1	50848911	.	A	G	7	10	17	0	1	18	0	0
1	50848961	.	C	T	17	12	29	0	2	31	0	0
1	50849055	.	T	C	11	2	13	0	20	33	0	0
1	50849125	.	T	C	15	23	38	0	0	38	0	0
1	50849157	.	C	T	0	21	21	0	12	33	0	0
1	50849199	.	T	C	11	0	11	0	14	25	0	0
1	50849282	.	A	G	8	9	17	0	0	17	0	0
1	50849331	.	G	A	9	11	20	0	2	22	0	0
1	50849456	.	G	A	11	13	24	0	1	25	0	0
1	50849670	.	A	C	10	1	11	0	5	16	0	0
1	50849697	.	T	C	12	0	12	0	7	19	0	0
1	50849705	.	C	G	11	10	21	0	1	22	0	0
1	50850041	.	T	A	12	11	23	0	2	25	0	0
1	50850170	.	C	T	11	17	28	0	0	28	0	0
1	50858891	.	A	T	5	2	7	0	0	7	0	0
1	50969207	.	G	A	0	20	20	0	16	36	0	0
1	50977089	.	C	T	4	9	13	0	0	13	0	0
1	50977569	.	A	C	4	7	11	0	0	11	0	0
1	50977607	.	G	A	4	6	10	0	0	10	0	0
1	50977640	.	G	T	4	3	7	0	0	7	0	0
1	50977669	.	G	A	5	2	7	0	0	7	0	0
1	50977707	.	G	A	0	9	9	1	6	16	0	0
1	50979925	.	T	C	13	13	26	0	0	26	0	0
1	50985169	.	C	T	14	19	33	0	1	34	0	0
1	50986092	.	T	C	8	10	18	0	0	18	0	0
1	50986110	.	A	G	14	20	34	0	0	35	1	0
1	50986197	.	C	T	19	36	55	0	6	61	0	0
1	50987507	.	A	C	11	38	49	0	2	51	0	0
1	50990593	.	A	G	24	3	27	0	35	62	0	0
1	50990698	.	A	T	24	24	48	0	4	53	1	0
1	50990815	.	G	A	18	22	40	0	1	41	0	0
1	51021490	.	T	A	1	1	2	0	0	2	0	0
1	51021497	.	T	G	1	2	3	0	0	3	0	0
1	51021701	.	A	G	3	3	6	0	0	6	0	0
1	51021731	.	G	A	5	2	7	0	1	8	0	0
1	51024992	.	A	G	1	2	3	0	0	3	0	0
1	51031234	.	G	A	3	0	3	0	0	3	0	0
1	51038819	.	A	G	5	3	8	0	0	8	0	0
1	51041255	.	T	G	5	1	6	0	6	12	0	0
1	51041363	.	G	A	0	3	3	0	5	8	0	0
1	51042228	.	G	A	1	11	12	0	8	20	0	0
1	51052276	.	C	T	0	1	1	0	0	1	0	0
1	51053333	.	G	C	1	5	6	0	0	6	0	0
1	51053971	.	A	G	3	1	4	0	0	4	0	0
1	51055896	.	G	C	2	0	2	0	0	2	0	0
1	51056766	.	C	A	0	4	4	0	4	8	0	0
1	51058146	.	A	C	6	0	6	0	4	10	0	0
1	51073083	.	A	C	2	7	9	0	1	10	0	0
1	51073118	.	T	C	3	6	9	0	1	10	0	0
1	51230090	.	T	C	7	6	13	0	0	13	0	0
1	51230098	.	T	C	8	5	13	0	0	13	0	0
1	51230136	.	T	C	1	8	9	0	0	9	0	0
1	51360980	.	C	T	1	1	2	0	0	2	0	0
1	51366000	.	A	C	0	1	1	0	0	1	0	0
1	51368758	.	T	G	1	2	3	0	0	3	0	0
1	51371165	.	T	C	4	6	10	0	0	10	0	0
1	51371166	.	A	C	4	6	10	0	0	10	0	0
1	51372625	.	C	T	2	2	4	0	0	4	0	0
1	51372688	.	C	T	4	2	6	0	0	6	0	0
1	51372742	.	C	T	2	4	6	0	1	7	0	0
1	51373730	.	A	C	3	1	4	0	1	5	0	0
1	51373808	.	C	T	5	4	9	0	0	9	0	0
1	51373904	.	A	G	2	6	8	0	1	9	0	0
1	51374009	.	T	C	3	2	5	0	0	5	0	0
1	51375006	.	C	G	2	9	11	0	0	11	0	0
1	51375301	.	A	G	2	5	7	0	0	7	0	0
1	51377708	.	C	A	3	8	11	0	0	11	0	0
1	51377757	.	C	T	6	8	14	0	0	14	0	0
1	51377781	.	A	C	7	6	13	0	1	14	0	0
1	51377798	.	G	A	1	4	5	0	5	10	0	0
1	51386764	.	C	G	4	5	9	0	0	9	0	0
1	51395384	.	A	G	1	3	4	0	0	4	0	0
1	51397646	.	C	T	4	2	6	0	0	6	0	0
1	51398373	.	T	C	3	6	9	0	0	9	0	0
1	51403088	.	C	T	3	3	6	0	1	7	0	0
1	51403599	.	T	A	9	8	17	0	0	17	0	0
1	51403756	.	T	A	5	4	9	0	0	9	0	0
1	51403785	.	C	T	3	6	9	0	0	9	0	0
1	51403872	.	T	C	2	4	6	0	0	6	0	0
1	51403926	.	T	G	0	3	3	0	0	3	0	0
1	51404733	.	A	G	2	3	5	0	0	5	0	0
1	51405087	.	C	T	10	4	14	0	0	14	0	0
1	51405119	.	C	A	8	2	10	0	1	11	0	0
1	51405323	.	C	A	3	11	14	0	0	14	0	0
1	51405986	.	G	T	8	13	21	0	0	21	0	0
1	51406191	.	G	A	0	12	12	0	8	20	0	0
1	51406341	.	T	A	7	16	23	0	1	24	0	0
1	51406346	.	G	A	7	14	21	0	0	21	0	0
1	51406425	.	A	C	2	3	5	0	0	5	0	0
1	51406450	.	G	A	2	3	5	0	0	5	0	0
1	51406523	.	G	T	1	2	3	0	0	3	0	0
1	51413315	.	T	C	3	5	8	0	0	8	0	0
1	51417125	.	C	G	1	1	2	0	4	6	0	0
1	51425476	.	T	A	5	5	10	0	0	10	0	0
1	51425772	.	C	G	2	2	4	0	0	4	0	0
1	51425774	.	T	C	2	2	4	0	0	4	0	0
1	51425932	.	T	A	1	6	7	0	0	7	0	0
1	51426350	.	C	T	3	4	7	0	0	7	0	0
1	51426386	.	A	T	1	3	4	0	0	4	0	0
1	51426508	.	G	A	1	2	3	0	0	3	0	0
1	51427170	.	T	C	8	7	15	0	4	19	0	0
1	51427779	.	T	C	10	17	27	0	1	28	0	0
1	51427837	.	A	C	8	13	21	0	2	23	0	0
1	51444718	.	G	A	7	8	15	0	0	15	0	0
1	51445120	.	A	T	10	15	25	0	1	26	0	0
1	51445140	.	T	G	8	16	24	0	1	25	0	0
1	51445217	.	A	T	4	12	16	0	1	17	0	0
1	51445325	.	T	C	5	7	12	0	1	13	0	0
1	51445673	.	T	G	6	8	14	0	2	16	0	0
1	51445697	.	T	C	11	0	11	0	10	21	0	0
1	51445732	.	A	G	12	6	18	0	1	19	0	0
1	51445777	.	T	A	7	15	22	0	0	22	0	0
1	51446004	.	G	A	10	4	14	0	0	14	0	0
1	51446195	.	T	C	6	0	6	0	9	15	0	0
1	51446287	.	C	T	3	3	6	0	0	6	0	0
1	51446366	.	T	C	3	2	5	0	0	5	0	0
1	51446462	.	C	T	1	3	4	0	0	4	0	0
1	51446511	.	G	A	4	5	9	0	0	9	0	0
1	51446597	.	A	T	5	3	8	0	0	8	0	0
1	51446962	.	C	T	5	3	8	0	0	8	0	0
1	51446969	.	A	C	5	2	7	0	0	7	0	0
1	51447506	.	T	C	3	4	7	0	0	7	0	0
1	51447543	.	T	G	5	3	8	0	0	8	0	0
1	51447573	.	C	T	6	7	13	0	0	13	0	0
1	51447680	.	T	A	5	3	8	0	0	8	0	0
1	51447693	.	G	T	5	2	7	0	1	8	0	0
1	51447807	.	A	G	4	3	7	0	0	7	0	0
1	51447914	.	G	T	0	5	5	0	0	5	0	0
1	51448105	.	A	G	3	5	8	0	0	8	0	0
1	51448249	.	C	A	7	9	16	0	0	16	0	0
1	51448517	.	C	T	7	9	16	0	2	18	0	0
1	51448696	.	C	A	4	2	6	0	0	6	0	0
1	51448781	.	A	G	3	2	5	0	0	5	0	0
1	51448807	.	C	T	2	2	4	0	0	4	0	0
1	51448829	.	T	G	1	4	5	0	0	5	0	0
1	51449298	.	T	C	7	3	10	0	1	11	0	0
1	51449895	.	T	C	5	5	10	0	0	10	0	0
1	51450180	.	C	T	0	4	4	0	3	7	0	0
1	51450752	.	G	A	10	4	14	0	0	14	0	0
1	51557903	.	C	T	2	18	20	0	16	36	0	0
1	51558008	.	T	C	16	17	33	0	1	34	0	0
1	51558036	.	G	A	13	17	30	0	2	32	0	0
1	51558133	.	G	T	14	9	23	0	5	28	0	0
1	51558150	.	A	T	9	15	24	0	1	25	0	0
1	51558604	.	C	T	22	23	45	0	3	48	0	0
1	51558897	.	T	A	22	22	44	0	3	47	0	0
1	51559060	.	C	G	22	26	48	0	2	51	1	0
1	51559269	.	G	C	22	24	46	0	1	47	0	0
1	51559815	.	C	T	15	15	30	0	1	31	0	0
1	51562800	.	A	G	10	11	21	0	0	21	0	0
1	51562803	.	T	C	10	9	19	0	0	19	0	0
1	51567367	.	A	G	4	11	15	0	1	16	0	0
1	51591352	.	A	G	25	14	39	0	5	44	0	0
1	51591427	.	G	A	1	4	5	0	0	5	0	0
1	51593925	.	A	C	7	5	12	0	1	13	0	0
1	51593926	.	C	T	0	5	5	0	8	13	0	0
1	51594058	.	A	T	13	11	24	0	1	25	0	0
1	51594447	.	A	G	19	21	40	0	2	42	0	0
1	51594485	.	A	C	15	22	37	0	1	38	0	0
1	51594690	.	C	G	0	23	23	0	17	40	0	0
1	51594701	.	C	T	0	27	27	0	14	41	0	0
1	51606302	.	C	G	4	8	12	0	0	12	0	0
1	51608801	.	A	T	2	5	7	0	0	7	0	0
1	51608856	.	C	A	3	8	11	0	1	12	0	0
1	51609002	.	A	T	11	18	29	0	2	31	0	0
1	51615436	.	G	T	1	0	1	0	0	1	0	0
1	51702154	.	A	G	2	2	4	0	0	4	0	0
1	51702188	.	T	A	3	2	5	0	0	5	0	0
1	51702204	.	A	T	2	1	3	0	2	5	0	0
1	51702374	.	C	T	0	3	3	0	4	7	0	0
1	51703863	.	T	C	3	0	3	0	9	12	0	0
1	51709481	.	G	A	3	3	6	0	0	6	0	0
1	51710007	.	C	T	3	3	6	0	1	7	0	0
1	51719037	.	A	C	5	0	5	0	7	12	0	0
1	51723440	.	T	C	18	19	37	0	1	38	0	0
1	51723461	.	A	T	20	20	40	0	2	42	0	0
1	51729506	.	C	T	13	9	22	0	1	23	0	0
1	51729572	.	A	G	16	2	18	0	11	29	0	0
1	51729645	.	A	C	19	15	34	0	1	35	0	0
1	51729687	.	C	T	20	12	32	0	1	33	0	0
1	51729697	.	C	A	15	13	28	0	4	32	0	0
1	51729735	.	C	A	13	16	29	0	1	30	0	0
1	51729750	.	C	A	15	13	28	0	0	28	0	0
1	51729798	.	A	C	12	9	21	0	1	22	0	0
1	51734087	.	T	C	10	12	22	0	2	24	0	0
1	51734449	.	C	T	0	13	13	0	7	20	0	0
1	51876733	.	G	T	1	2	3	0	0	3	0	0
1	51960615	.	T	C	4	4	8	0	0	8	0	0
1	51961020	.	T	C	7	2	9	0	0	9	0	0
1	52054116	.	A	G	2	0	2	0	1	3	0	0
1	52111494	.	C	T	8	9	17	0	3	20	0	0
1	52115814	.	G	A	1	2	3	0	0	3	0	0
1	52115862	.	C	T	0	7	7	0	6	13	0	0
1	52117112	.	C	G	1	3	4	0	0	4	0	0
1	52121404	.	C	T	6	4	10	0	0	10	0	0
1	52121405	.	T	G	6	4	10	0	0	10	0	0
1	52124240	.	C	T	0	4	4	0	12	16	0	0
1	52128305	.	T	G	7	10	17	0	0	17	0	0
1	52130225	.	A	T	14	10	24	0	0	24	0	0
1	52130431	.	G	A	12	18	30	0	2	32	0	0
1	52135185	.	T	C	13	19	32	0	1	33	0	0
1	52135384	.	T	C	13	6	19	0	0	19	0	0
1	52135513	.	G	A	2	7	9	1	1	11	0	0
1	52135840	.	C	A	8	7	15	0	0	15	0	0
1	52135862	.	A	G	4	8	12	0	2	14	0	0
1	52135928	.	G	C	12	15	27	0	1	28	0	0
1	52136027	.	T	C	12	9	21	0	0	21	0	0
1	52136117	.	A	C	15	14	29	0	0	30	1	0
1	52136190	.	G	A	12	6	18	0	0	18	0	0
1	52136294	.	T	C	1	6	7	0	0	7	0	0
1	52136323	.	G	A	10	6	16	0	0	16	0	0
1	52136379	.	T	A	14	7	21	0	1	22	0	0
1	52136641	.	A	G	5	1	6	0	0	6	0	0
1	52136759	.	A	T	14	11	25	0	3	28	0	0
1	52136868	.	A	G	4	13	17	0	0	17	0	0
1	52136894	.	T	C	8	13	21	0	0	21	0	0
1	52136974	.	T	A	9	15	24	0	2	27	1	0
1	52139909	.	T	A	1	1	2	0	0	2	0	0
1	52149554	.	A	T	13	21	34	0	4	38	0	0
1	52149619	.	A	C	16	18	34	0	0	34	0	0
1	52149794	.	A	G	15	11	26	0	2	28	0	0
1	52149977	.	T	A	13	9	22	0	0	22	0	0
1	52150152	.	G	A	11	19	30	0	0	30	0	0
1	52150182	.	G	T	1	19	20	0	14	34	0	0
1	52150231	.	C	T	16	18	34	0	0	34	0	0
1	52150400	.	A	G	15	8	23	0	0	23	0	0
1	52150900	.	G	T	9	8	17	0	0	17	0	0
1	52150974	.	A	G	10	4	14	0	0	14	0	0
1	52151341	.	A	G	1	3	4	0	0	4	0	0
1	52151387	.	A	G	3	2	5	0	0	5	0	0
1	52151943	.	G	A	5	3	8	0	0	8	0	0
1	52152188	.	G	A	0	9	9	0	9	18	0	0
1	52152202	.	A	G	9	7	16	0	0	16	0	0
1	52152300	.	A	T	17	11	28	0	1	29	0	0
1	52152488	.	A	G	16	12	28	0	0	28	0	0
1	52152617	.	C	T	25	17	42	0	1	43	0	0
1	52179039	.	G	T	4	10	14	0	0	14	0	0
1	52179066	.	C	T	0	4	4	0	8	12	0	0
1	52198416	.	T	C	2	0	2	0	2	4	0	0
1	52201248	.	G	C	1	2	3	0	1	4	0	0
1	52452068	.	C	A	1	2	3	0	2	5	0	0
1	52452116	.	C	G	1	2	3	0	1	4	0	0
1	52452197	.	G	A	3	8	11	0	1	12	0	0
1	52452275	.	G	T	3	9	12	0	0	12	0	0
1	52455885	.	C	G	1	1	2	0	1	3	0	0
1	52455908	.	G	A	8	1	9	0	1	10	0	0
1	52455960	.	C	T	1	9	10	0	0	10	0	0
1	52456002	.	G	A	1	1	2	0	0	2	0	0
1	52460737	.	C	T	7	9	16	0	1	17	0	0
1	52460739	.	T	C	8	9	17	0	0	17	0	0
1	52460906	.	T	C	2	2	4	0	0	4	0	0
1	52460944	.	G	T	7	9	16	0	0	16	0	0
1	52461114	.	A	G	4	3	7	0	0	7	0	0
1	52461183	.	C	T	2	10	12	0	0	12	0	0
1	52461195	.	G	A	9	5	14	0	0	14	0	0
1	52467767	.	C	T	1	0	1	0	0	1	0	0
1	52475840	.	A	G	2	0	2	0	1	3	0	0
1	52486008	.	G	A	0	2	2	0	0	2	0	0
1	52486439	.	A	G	5	4	9	0	0	9	0	0
1	52489974	.	G	A	0	5	5	0	5	10	0	0
1	52492346	.	A	T	1	0	1	0	0	1	0	0
1	52495004	.	T	A	4	2	6	1	0	7	0	0
1	52495045	.	C	T	0	2	2	0	4	6	0	0
1	52495082	.	C	G	1	2	3	0	0	3	0	0
1	52495088	.	G	A	1	2	3	0	0	3	0	0
1	52497885	.	C	T	0	1	1	0	0	1	0	0
1	52499807	.	A	G	3	3	6	0	0	6	0	0
1	52501213	.	A	C	2	0	2	0	4	6	0	0
1	52560612	.	G	A	4	5	9	0	0	9	0	0
1	52577703	.	C	A	3	2	5	0	0	5	0	0
1	52591973	.	C	T	0	2	2	0	0	2	0	0
1	52591985	.	T	C	0	2	2	0	0	2	0	0
1	52592126	.	A	G	1	3	4	0	0	4	0	0
1	52592129	.	C	T	1	3	4	0	0	4	0	0
1	52599102	.	A	G	2	0	2	0	6	8	0	0
1	52600378	.	T	C	3	2	5	0	0	5	0	0
1	52606865	.	C	T	1	0	1	0	0	1	0	0
1	52607826	.	T	C	9	4	13	0	0	13	0	0
1	52609392	.	C	T	1	2	3	0	0	3	0	0
1	52610788	.	G	A	4	2	6	0	0	6	0	0
1	52611963	.	A	G	1	5	6	0	0	6	0	0
1	52612987	.	T	C	1	2	3	0	0	3	0	0
1	52613051	.	T	A	0	1	1	0	0	1	0	0
1	52613216	.	G	T	0	2	2	0	0	2	0	0
1	52614377	.	C	T	2	3	5	0	0	5	0	0
1	52614926	.	T	A	4	3	7	0	1	8	0	0
1	52615824	.	C	T	3	3	6	0	0	6	0	0
1	52618405	.	C	T	7	12	19	0	1	20	0	0
1	52625747	.	C	G	9	1	10	0	8	18	0	0
1	52625804	.	T	C	4	3	7	0	1	8	0	0
1	52626360	.	T	A	13	5	18	0	1	20	1	0
1	52626826	.	T	A	10	3	13	0	0	13	0	0
1	52627290	.	C	T	8	15	23	0	2	25	0	0
1	52627572	.	G	A	0	15	15	0	22	37	0	0
1	52627609	.	A	T	22	16	38	0	1	39	0	0
1	52627678	.	A	T	20	15	35	0	1	36	0	0
1	52627679	.	C	T	19	15	34	0	2	36	0	0
1	52628253	.	G	T	11	11	22	0	0	22	0	0
1	52628305	.	T	C	5	14	19	0	1	21	1	0
1	52649141	.	T	C	1	2	3	0	0	3	0	0
1	52656201	.	C	A	0	1	1	0	1	2	0	0
1	52656219	.	T	C	1	2	3	0	0	3	0	0
1	52659459	.	T	C	0	3	3	0	0	3	0	0
1	52663429	.	C	T	2	3	5	0	0	5	0	0
1	52676495	.	G	A	3	4	7	0	0	7	0	0
1	52681185	.	G	A	6	3	9	0	0	9	0	0
1	52681296	.	C	A	2	2	4	0	0	4	0	0
1	52682847	.	C	T	8	1	9	0	0	9	0	0
1	52682850	.	T	C	8	2	10	0	0	10	0	0
1	52682910	.	C	T	1	2	3	0	0	3	0	0
1	52685099	.	G	A	0	1	1	0	2	3	0	0
1	52688151	.	C	T	0	1	1	0	0	1	0	0
1	52688274	.	G	A	6	6	12	0	0	12	0	0
1	52688286	.	T	C	4	2	6	0	0	6	0	0
1	52698944	.	G	T	1	4	5	0	0	5	0	0
1	52698955	.	C	T	1	8	9	0	0	9	0	0
1	52764824	.	A	T	5	5	10	0	2	12	0	0
1	52764914	.	C	T	19	4	23	0	1	24	0	0
1	52773239	.	G	A	2	4	6	0	0	6	0	0
1	52773311	.	A	G	6	3	9	0	0	9	0	0
1	52775619	.	A	C	5	12	17	0	0	17	0	0
1	52779785	.	G	A	10	4	14	0	1	15	0	0
1	52782161	.	G	A	10	13	23	0	0	23	0	0
1	52782220	.	G	T	14	6	20	0	0	20	0	0
1	52784549	.	A	T	4	4	8	0	2	10	0	0
1	52784624	.	T	A	6	4	10	0	0	10	0	0
1	52792476	.	C	A	5	7	12	0	0	12	0	0
1	53394847	.	T	C	3	2	5	0	0	5	0	0
1	53865803	.	C	T	0	2	2	0	3	5	0	0
1	53865815	.	T	G	2	4	6	0	0	6	0	0
1	53865858	.	A	T	2	3	5	0	1	6	0	0
1	53865870	.	C	A	2	2	4	0	0	4	0	0
1	53866020	.	T	C	2	4	6	0	0	6	0	0
1	53866041	.	T	C	6	8	14	0	0	14	0	0
1	53866075	.	C	T	8	12	20	0	0	20	0	0
1	53866120	.	A	T	4	8	12	0	1	13	0	0
1	53866128	.	T	C	5	8	13	0	0	13	0	0
1	53866319	.	C	T	0	2	2	0	4	6	0	0
1	53871326	.	T	A	5	5	10	0	1	11	0	0
1	53871416	.	C	A	2	2	4	0	0	4	0	0
1	53872031	.	C	A	8	7	15	0	0	15	0	0
1	53872061	.	C	T	8	6	14	0	1	15	0	0
1	53872067	.	T	C	7	0	7	0	6	13	0	0
1	53873112	.	T	C	8	0	8	0	7	15	0	0
1	53873173	.	C	T	0	10	10	0	9	19	0	0
1	53873177	.	T	C	9	0	9	0	8	17	0	0
1	53879353	.	C	T	0	4	4	0	1	5	0	0
1	53879397	.	C	T	1	5	6	0	0	6	0	0
1	53879731	.	T	C	1	0	1	0	3	4	0	0
1	53879767	.	G	A	1	2	3	0	0	3	0	0
1	53912019	.	G	A	4	2	6	0	0	6	0	0
1	53912148	.	A	G	5	5	10	0	0	10	0	0
1	53912307	.	A	G	3	4	7	0	0	7	0	0
1	53912670	.	A	G	3	3	6	0	0	6	0	0
1	53912691	.	A	G	2	1	3	0	0	3	0	0
1	53916931	.	T	A	1	0	1	0	0	1	0	0
1	53921783	.	T	C	1	0	1	0	0	1	0	0
1	53929298	.	A	G	0	2	2	0	0	2	0	0
1	53932271	.	A	G	7	5	12	0	0	12	0	0
1	53934495	.	C	A	2	1	3	0	1	4	0	0
1	53935236	.	G	A	10	4	14	0	0	14	0	0
1	53935248	.	G	T	0	5	5	0	8	13	0	0
1	53935287	.	A	G	2	0	2	0	8	10	0	0
1	53935314	.	T	C	1	3	4	0	0	4	0	0
1	53937423	.	C	T	1	0	1	0	0	1	0	0
1	53937922	.	T	C	0	1	1	0	1	2	0	0
1	53939430	.	A	G	5	4	9	0	0	9	0	0
1	53939604	.	C	T	1	1	2	0	0	2	0	0
1	53953276	.	G	T	2	2	4	0	0	4	0	0
1	53954314	.	G	A	0	10	10	0	10	20	0	0
1	53954361	.	C	A	9	11	20	0	0	20	0	0
1	53954385	.	A	C	6	4	10	0	0	11	1	0
1	53955055	.	G	A	8	11	19	0	1	20	0	0
1	53958136	.	G	A	0	6	6	0	19	25	0	0
1	53958263	.	C	T	12	10	22	0	0	22	0	0
1	53962227	.	A	T	6	5	11	0	0	11	0	0
1	53962264	.	T	C	16	11	27	0	1	28	0	0
1	53962490	.	T	G	12	5	17	0	0	17	0	0
1	53962860	.	G	A	0	5	5	0	3	8	0	0
1	53962863	.	C	T	3	6	9	0	0	9	0	0
1	53962900	.	T	A	5	4	9	0	1	10	0	0
1	53962961	.	C	T	5	2	7	0	1	8	0	0
1	53963108	.	C	A	19	6	25	0	0	25	0	0
1	53963159	.	C	T	18	8	26	0	0	26	0	0
1	53963782	.	A	G	8	5	13	0	0	13	0	0
1	53987578	.	T	G	1	2	3	0	0	3	0	0
1	53987605	.	G	A	1	2	3	0	0	3	0	0
1	53987735	.	T	C	0	2	2	0	0	2	0	0
1	54025424	.	C	T	3	4	7	0	0	7	0	0
1	54025468	.	T	A	2	3	5	0	0	5	0	0
1	54048786	.	G	A	2	4	6	0	0	6	0	0
1	54061812	.	C	T	2	3	5	0	0	5	0	0
1	54061824	.	C	T	3	4	7	0	0	7	0	0
1	54062551	.	T	A	4	6	10	0	0	10	0	0
1	54062754	.	G	A	3	4	7	0	0	7	0	0
1	54062858	.	A	G	3	5	8	0	0	8	0	0
1	54063478	.	C	T	1	2	3	0	0	3	0	0
1	54069513	.	G	T	3	3	6	0	0	6	0	0
1	54069515	.	C	A	3	3	6	0	0	6	0	0
1	54075326	.	A	G	1	1	2	0	0	2	0	0
1	54077472	.	T	C	2	0	2	0	0	2	0	0
1	54080189	.	T	G	5	0	5	0	5	10	0	0
1	54084473	.	G	C	1	3	4	0	0	4	0	0
1	54084613	.	G	A	0	0	0	0	4	4	0	0
1	54084616	.	C	T	2	2	4	0	0	4	0	0
1	54089032	.	C	T	0	3	3	0	0	3	0	0
1	54095147	.	G	A	2	0	2	0	0	2	0	0
1	54100717	.	C	T	1	2	3	0	0	3	0	0
1	54100720	.	A	G	1	2	3	0	0	3	0	0
1	54107009	.	C	T	0	1	1	0	0	1	0	0
1	54115865	.	T	G	1	2	3	0	0	3	0	0
1	54115888	.	T	A	1	2	3	0	0	3	0	0
1	54117714	.	G	C	3	1	4	0	1	5	0	0
1	54117720	.	A	T	3	2	5	0	0	5	0	0
1	54137238	.	A	G	5	6	11	0	0	11	0	0
1	54140472	.	A	T	1	2	3	0	0	3	0	0
1	54142097	.	T	C	4	5	9	0	0	9	0	0
1	54142130	.	G	T	0	8	8	0	4	12	0	0
1	54144024	.	T	G	2	2	4	0	0	4	0	0
1	54146383	.	C	T	4	1	5	0	2	7	0	0
1	54146416	.	T	C	10	7	17	0	1	18	0	0
1	54154371	.	T	C	1	0	1	0	4	5	0	0
1	54154383	.	T	G	1	4	5	0	0	5	0	0
1	54158479	.	A	G	0	2	2	0	0	2	0	0
1	54161774	.	A	G	1	2	3	0	0	3	0	0
1	54167496	.	A	C	3	3	6	0	1	7	0	0
1	54178755	.	G	C	3	4	7	0	0	7	0	0
1	54189017	.	T	C	2	0	2	0	2	4	0	0
1	54189094	.	T	C	0	1	1	0	0	1	0	0
1	54194875	.	G	A	1	5	6	0	2	8	0	0
1	54194890	.	T	A	2	2	4	0	0	4	0	0
1	54197443	.	G	A	1	1	2	0	0	2	0	0
1	54199009	.	G	A	3	3	6	0	0	6	0	0
1	54202319	.	A	G	0	0	0	1	0	1	0	0
1	54209472	.	C	A	0	1	1	0	1	2	0	0
1	54210220	.	A	G	2	2	4	0	0	4	0	0
1	54219462	.	A	G	2	0	2	0	3	5	0	0
1	54244041	.	T	C	3	4	7	0	0	7	0	0
1	54244432	.	T	C	3	4	7	0	1	8	0	0
1	54245914	.	G	A	1	3	4	0	0	4	0	0
1	54248366	.	A	C	0	3	3	0	0	3	0	0
1	54253768	.	G	A	0	5	5	0	3	8	0	0
1	54255651	.	C	T	8	10	18	0	1	19	0	0
1	54262843	.	G	A	1	2	3	0	0	3	0	0
1	54615161	.	C	T	1	2	3	0	0	3	0	0
1	54674388	.	A	G	4	5	9	0	0	9	0	0
1	54674430	.	A	G	9	0	9	0	5	14	0	0
1	54683743	.	C	T	3	0	3	0	0	3	0	0
1	54685529	.	G	A	10	7	17	0	0	17	0	0
1	54685559	.	C	G	9	7	16	0	0	16	0	0
1	54685590	.	A	G	6	4	10	0	0	10	0	0
1	54685610	.	T	C	5	4	9	0	0	9	0	0
1	54685799	.	G	A	4	4	8	0	0	8	0	0
1	54685814	.	G	A	3	3	6	0	0	6	0	0
1	54687580	.	C	T	4	6	10	0	0	10	0	0
1	54687649	.	G	T	4	5	9	0	1	11	1	0
1	54687715	.	C	A	10	6	16	0	0	16	0	0
1	54687756	.	A	C	10	4	14	0	0	14	0	0
1	54687766	.	A	C	10	7	17	0	0	17	0	0
1	54687798	.	A	C	9	11	20	0	0	20	0	0
1	54687852	.	A	G	11	5	16	1	0	17	0	0
1	54687981	.	A	G	5	4	9	0	0	9	0	0
1	54693953	.	C	A	4	6	10	0	1	11	0	0
1	54701201	.	C	G	0	0	0	0	2	2	0	0
1	54701231	.	G	A	1	2	3	0	1	4	0	0
1	54703424	.	A	C	0	1	1	0	0	1	0	0
1	54707977	.	G	A	31	30	61	0	4	65	0	0
1	54708098	.	G	T	35	23	58	0	2	60	0	0
1	54708191	.	C	A	22	35	57	0	1	58	0	0
1	54708253	.	G	A	23	30	53	0	1	54	0	0
1	54708281	.	A	T	23	25	48	0	1	49	0	0
1	54708301	.	A	C	26	24	50	0	1	51	0	0
1	54708317	.	C	T	26	21	47	0	1	48	0	0
1	54708359	.	C	T	30	19	49	0	0	49	0	0
1	54709110	.	T	A	8	3	11	0	1	12	0	0
1	54709112	.	A	G	8	3	11	0	1	12	0	0
1	54709334	.	G	A	30	24	54	0	0	54	0	0
1	54737506	.	C	A	7	3	10	0	2	12	0	0
1	54747720	.	T	C	4	2	6	0	0	6	0	0
1	54747729	.	A	G	3	0	3	0	2	5	0	0
1	54750104	.	A	G	0	0	0	0	1	1	0	0
1	54750254	.	A	G	1	0	1	0	6	7	0	0
1	54753095	.	T	G	5	0	5	0	6	11	0	0
1	54753101	.	T	C	4	5	9	0	1	10	0	0
1	54753167	.	A	G	3	4	7	0	0	7	0	0
1	54753173	.	G	C	0	4	4	0	3	7	0	0
1	54753615	.	G	A	3	5	8	0	0	8	0	0
1	54753623	.	T	G	3	5	8	0	0	8	0	0
1	54753654	.	A	C	2	4	6	0	0	6	0	0
1	54753687	.	A	T	1	2	3	0	0	3	0	0
1	54754356	.	C	T	6	5	11	0	1	12	0	0
1	54754482	.	T	G	6	15	21	0	0	21	0	0
1	54754503	.	G	A	4	10	14	0	2	16	0	0
1	54754550	.	C	A	2	6	8	0	1	9	0	0
1	54754565	.	C	T	2	5	7	0	0	7	0	0
1	54754623	.	A	T	6	6	12	0	0	12	0	0
1	54754626	.	T	A	6	4	10	0	1	11	0	0
1	54754744	.	C	T	6	8	14	0	1	15	0	0
1	54754754	.	T	C	5	7	12	0	1	13	0	0
1	54755054	.	C	T	1	3	4	0	1	5	0	0
1	54758624	.	A	T	8	3	11	0	0	11	0	0
1	54758634	.	T	C	8	3	11	0	0	11	0	0
1	54758725	.	C	T	0	18	18	0	13	31	0	0
1	54758810	.	C	T	17	16	33	0	1	34	0	0
1	54758975	.	T	C	21	15	36	0	2	38	0	0
1	54759065	.	G	A	3	9	12	0	1	13	0	0
1	54762947	.	G	A	3	4	7	0	0	7	0	0
1	54762997	.	G	T	15	13	28	0	5	33	0	0
1	54763022	.	G	C	16	16	32	0	0	32	0	0
1	54763106	.	A	G	3	11	14	0	0	14	0	0
1	54763133	.	T	C	3	8	11	0	1	12	0	0
1	54763182	.	A	G	8	11	19	0	2	21	0	0
1	54763187	.	G	A	9	15	24	0	1	25	0	0
1	54763298	.	G	A	3	9	12	0	1	13	0	0
1	54765216	.	A	C	22	0	22	0	18	40	0	0
1	54765218	.	C	T	0	17	17	0	23	40	0	0
1	54777359	.	C	A	2	0	2	0	0	2	0	0
1	54893126	.	C	G	2	1	3	0	0	3	0	0
1	54893140	.	G	A	0	1	1	0	4	5	0	0
1	54893198	.	G	A	0	3	3	0	5	8	0	0
1	54893265	.	G	C	0	4	4	0	0	4	0	0
1	54897256	.	C	T	3	6	9	0	0	9	0	0
1	54897288	.	C	T	0	3	3	0	0	3	0	0
1	54898178	.	G	A	0	1	1	0	1	2	0	0
1	54898489	.	A	T	5	4	9	0	0	9	0	0
1	54906069	.	T	C	2	2	4	0	0	4	0	0
1	54906162	.	G	A	0	4	4	0	3	7	0	0
1	54906192	.	T	C	0	2	2	0	0	2	0	0
1	54906476	.	G	C	0	1	1	0	1	2	0	0
1	54906619	.	T	A	5	2	7	0	0	7	0	0
1	54907021	.	G	A	7	6	13	0	0	13	0	0
1	54907074	.	G	A	2	2	4	0	0	4	0	0
1	54907077	.	T	A	2	2	4	0	0	4	0	0
1	54907367	.	T	G	5	5	10	0	0	10	0	0
1	54907502	.	A	G	3	3	6	0	0	6	0	0
1	54907549	.	T	C	9	7	16	0	0	16	0	0
1	54907585	.	G	C	10	8	18	0	0	18	0	0
1	54907600	.	A	T	10	10	20	0	1	21	0	0
1	54907622	.	T	C	12	11	23	0	0	23	0	0
1	54907698	.	G	T	8	7	15	0	0	15	0	0
1	54907707	.	C	T	10	6	16	0	0	16	0	0
1	54927198	.	T	C	2	2	4	0	1	5	0	0
1	54929168	.	G	A	13	16	29	0	1	30	0	0
1	54929256	.	T	C	7	11	18	0	1	19	0	0
1	54929281	.	G	A	2	11	13	0	8	21	0	0
1	54929293	.	C	T	10	7	17	0	3	20	0	0
1	54930026	.	G	A	13	3	16	0	0	16	0	0
1	54930316	.	G	A	3	3	6	0	0	6	0	0
1	54930349	.	G	C	4	0	4	0	0	4	0	0
1	54930428	.	T	A	6	9	15	0	2	17	0	0
1	54930598	.	A	G	2	14	16	0	0	16	0	0
1	54930626	.	A	C	1	11	12	0	0	12	0	0
1	54930693	.	T	C	6	7	13	0	2	15	0	0
1	54930711	.	G	A	6	9	15	0	0	15	0	0
1	54930776	.	A	G	10	8	18	0	0	18	0	0
1	54930868	.	C	A	14	4	18	0	0	18	0	0
1	54931111	.	T	C	5	8	13	0	0	13	0	0
1	54931122	.	G	A	0	7	7	0	5	12	0	0
1	54931211	.	A	T	15	7	22	0	0	22	0	0
1	54931230	.	T	A	12	10	22	0	0	22	0	0
1	54931791	.	G	C	0	15	15	0	8	23	0	0
1	54931862	.	A	G	4	4	8	0	1	9	0	0
1	54934658	.	T	G	1	2	3	0	0	3	0	0
1	54934690	.	T	C	2	3	5	0	0	5	0	0
1	54934694	.	G	T	2	3	5	0	0	5	0	0
1	54936471	.	T	C	9	0	9	0	23	32	0	0
1	54938274	.	T	C	2	5	7	0	0	7	0	0
1	54939536	.	A	T	2	2	4	0	1	5	0	0
1	54941036	.	G	A	5	6	11	0	1	12	0	0
1	54943139	.	G	A	5	5	10	0	0	10	0	0
1	54943160	.	A	G	2	3	5	0	0	5	0	0
1	54943178	.	G	A	1	0	1	0	0	1	0	0
1	54945039	.	A	G	0	2	2	0	0	2	0	0
1	54950534	.	T	C	11	12	23	0	0	23	0	0
1	54950572	.	G	A	13	10	23	0	3	26	0	0
1	54950661	.	G	A	8	9	17	0	0	17	0	0
1	54950745	.	G	T	12	7	19	0	0	19	0	0
1	54950801	.	A	G	3	3	6	0	0	6	0	0
1	54955207	.	G	A	3	1	4	0	0	4	0	0
1	54955234	.	A	G	6	3	9	0	0	9	0	0
1	54958123	.	A	G	3	4	7	0	0	8	1	0
1	54958146	.	T	A	5	4	9	0	1	10	0	0
1	54960328	.	A	G	8	12	20	0	1	21	0	0
1	54960368	.	T	G	11	15	26	0	1	27	0	0
1	54960416	.	A	C	10	18	28	0	1	29	0	0
1	54960563	.	T	A	13	23	36	1	1	38	0	0
1	54960620	.	G	C	4	6	10	0	0	10	0	0
1	54960639	.	C	T	0	10	10	0	5	15	0	0
1	54960881	.	A	G	18	17	35	0	3	38	0	0
1	54962466	.	A	G	11	6	17	0	0	17	0	0
1	54963314	.	A	G	13	18	31	0	0	31	0	0
1	54964724	.	A	G	16	19	35	0	0	35	0	0
1	54974437	.	C	A	8	11	19	0	0	19	0	0
1	54974438	.	A	G	8	11	19	0	0	19	0	0
1	54974477	.	G	A	13	6	19	0	0	19	0	0
1	54974500	.	T	A	11	1	12	0	0	12	0	0
1	54974660	.	T	C	15	5	20	0	0	20	0	0
1	54974774	.	G	A	10	8	18	0	0	18	0	0
1	54974810	.	G	T	13	2	15	0	0	15	0	0
1	54975136	.	A	T	14	4	18	0	2	20	0	0
1	54975484	.	G	T	15	7	22	0	0	22	0	0
1	54975519	.	C	T	13	8	21	0	1	22	0	0
1	54975636	.	C	T	11	5	16	0	1	17	0	0
1	54975685	.	C	T	0	2	2	0	11	13	0	0
1	54975693	.	A	G	10	2	12	0	0	12	0	0
1	54975884	.	A	G	8	7	15	0	0	15	0	0
1	54975911	.	G	A	6	6	12	0	0	12	0	0
1	54976026	.	T	A	3	12	15	0	1	16	0	0
1	54976035	.	T	A	4	14	18	0	0	18	0	0
1	54976104	.	G	A	7	3	10	0	0	10	0	0
1	54976178	.	T	C	11	0	11	0	7	18	0	0
1	54976213	.	T	C	16	3	19	0	1	20	0	0
1	54976249	.	T	A	14	9	23	0	0	23	0	0
1	54976256	.	C	T	16	9	25	0	1	26	0	0
1	54976637	.	T	C	13	2	15	0	0	15	0	0
1	54976639	.	C	T	13	2	15	0	0	15	0	0
1	54976731	.	C	T	7	4	11	0	1	12	0	0
1	54976732	.	A	G	8	4	12	0	0	12	0	0
1	54976784	.	T	A	2	2	4	0	1	5	0	0
1	54976798	.	C	A	4	2	6	0	0	6	0	0
1	54976827	.	T	C	3	2	5	0	0	5	0	0
1	54976835	.	C	T	2	2	4	0	0	4	0	0
1	54977572	.	G	A	7	5	12	0	1	13	0	0
1	54977618	.	G	A	10	6	16	0	1	17	0	0
1	54977697	.	G	A	13	4	17	0	0	17	0	0
1	54977719	.	T	A	11	4	15	0	0	15	0	0
1	54978478	.	T	C	8	3	11	0	0	11	0	0
1	54981628	.	G	A	7	6	13	0	1	14	0	0
1	54981706	.	C	T	2	0	2	0	0	2	0	0
1	54984587	.	C	T	3	2	5	0	0	5	0	0
1	54985320	.	C	T	6	8	14	0	0	15	1	0
1	54987539	.	A	G	6	1	7	0	0	7	0	0
1	54988190	.	T	G	1	1	2	0	0	2	0	0
1	54988259	.	G	A	9	6	15	0	2	17	0	0
1	54997327	.	T	C	8	4	12	0	0	12	0	0
1	55008322	.	A	G	10	5	15	0	0	15	0	0
1	55008382	.	C	T	15	8	23	0	0	23	0	0
1	55008405	.	G	A	9	9	18	0	0	18	0	0
1	55008772	.	T	C	6	9	15	0	0	15	0	0
1	55009618	.	A	G	3	4	7	0	1	8	0	0
1	55010713	.	T	C	3	0	3	0	2	5	0	0
1	55010914	.	A	C	6	6	12	0	0	12	0	0
1	55011101	.	T	A	2	4	6	0	0	6	0	0
1	55011117	.	T	C	3	4	7	0	1	8	0	0
1	55011353	.	G	C	2	7	9	0	0	9	0	0
1	55011514	.	C	T	4	9	13	0	0	13	0	0
1	55011539	.	A	T	7	7	14	0	0	14	0	0
1	55011550	.	G	A	7	6	13	0	1	14	0	0
1	55011692	.	C	T	0	3	3	0	4	7	0	0
1	55021862	.	A	T	2	0	2	0	0	2	0	0
1	55021886	.	G	A	2	1	3	0	0	3	0	0
1	55021952	.	G	A	3	5	8	0	0	8	0	0
1	55022075	.	T	C	4	0	4	0	4	8	0	0
1	55022162	.	T	A	2	4	6	0	0	6	0	0
1	55032657	.	A	G	1	2	3	0	1	4	0	0
1	55037612	.	C	T	4	2	6	0	1	7	0	0
1	55037627	.	T	G	3	3	6	0	0	6	0	0
1	55038186	.	G	A	0	1	1	0	0	1	0	0
1	55047540	.	C	T	0	3	3	0	1	4	0	0
1	55049345	.	T	G	0	3	3	0	0	3	0	0
1	55049348	.	C	T	0	2	2	0	0	2	0	0
1	55080832	.	A	G	1	4	5	0	0	5	0	0
1	55080840	.	A	G	1	0	1	0	4	5	0	0
1	55080893	.	G	C	1	2	3	0	0	3	0	0
1	55080905	.	A	G	1	1	2	0	0	2	0	0
1	55084673	.	A	G	0	1	1	0	0	1	0	0
1	55085782	.	A	G	0	0	0	0	1	1	0	0
1	55085830	.	A	T	0	5	5	0	0	5	0	0
1	55087742	.	T	C	3	2	5	0	0	5	0	0
1	55087823	.	G	C	1	2	3	0	0	3	0	0
1	55088467	.	T	A	4	2	6	0	1	7	0	0
1	55088490	.	C	A	3	2	5	0	0	5	0	0
1	55088871	.	A	G	2	0	2	0	2	4	0	0
1	55089078	.	T	A	3	4	7	1	0	8	0	0
1	55089152	.	C	G	2	2	4	0	0	4	0	0
1	55089316	.	G	A	0	3	3	0	4	7	0	0
1	55089328	.	G	A	3	4	7	0	0	7	0	0
1	55089396	.	C	T	8	4	12	0	2	14	0	0
1	55099214	.	A	C	8	5	13	0	0	13	0	0
1	55099472	.	T	C	11	8	19	0	0	19	0	0
1	55099772	.	C	T	6	10	16	0	0	16	0	0
1	55099880	.	C	G	7	4	11	0	0	11	0	0
1	55099952	.	C	T	8	5	13	0	2	15	0	0
1	55100018	.	T	C	7	10	17	0	0	17	0	0
1	55100378	.	G	A	0	13	13	0	14	27	0	0
1	55100422	.	T	A	10	9	19	0	0	19	0	0
1	55100456	.	T	C	5	4	9	0	0	9	0	0
1	55101322	.	G	T	1	3	4	0	0	4	0	0
1	55101358	.	C	T	4	12	16	0	1	17	0	0
1	55101439	.	C	A	3	4	7	0	1	8	0	0
1	55101445	.	C	G	3	2	5	0	0	5	0	0
1	55103160	.	A	G	7	9	16	0	0	16	0	0
1	55108059	.	A	T	5	2	7	0	1	8	0	0
1	55108065	.	T	C	6	2	8	0	0	8	0	0
1	55109717	.	A	T	12	11	23	0	0	23	0	0
1	55113465	.	A	G	2	2	4	0	0	4	0	0
1	55126626	.	A	C	10	0	10	0	3	13	0	0
1	55144296	.	G	A	1	2	3	0	0	3	0	0
1	55161208	.	A	G	2	3	5	0	0	5	0	0
1	55161252	.	T	C	3	0	3	0	4	7	0	0
1	55161257	.	A	T	3	4	7	0	0	7	0	0
1	55161431	.	A	G	1	1	2	0	1	3	0	0
1	55161440	.	A	G	1	2	3	0	0	3	0	0
1	55166477	.	G	A	2	1	3	0	1	4	0	0
1	55169244	.	G	C	6	5	11	0	1	12	0	0
1	55169349	.	G	C	8	9	17	0	1	18	0	0
1	55169658	.	T	A	6	8	14	0	0	14	0	0
1	55169662	.	A	G	7	5	12	0	0	12	0	0
1	55169699	.	T	A	12	6	18	0	0	18	0	0
1	55169713	.	A	T	10	6	16	0	0	16	0	0
1	55169756	.	A	G	10	10	20	0	2	22	0	0
1	55169839	.	G	C	8	3	11	0	1	12	0	0
1	55169961	.	T	C	8	1	9	0	8	17	0	0
1	55169980	.	A	G	8	10	18	0	0	18	0	0
1	55169999	.	C	T	11	10	21	0	0	21	0	0
1	55170056	.	G	T	12	8	20	0	1	21	0	0
1	55170856	.	T	C	4	0	4	0	8	12	0	0
1	55170866	.	T	C	6	0	6	0	6	12	0	0
1	55171249	.	G	A	5	9	14	0	0	14	0	0
1	55176698	.	A	G	3	4	7	0	0	7	0	0
1	55178808	.	A	G	3	3	6	0	0	6	0	0
1	55179434	.	C	T	1	3	4	0	0	4	0	0
1	55179470	.	C	T	1	3	4	0	0	4	0	0
1	55180229	.	A	G	2	1	3	0	0	3	0	0
1	55180278	.	G	C	1	0	1	0	1	2	0	0
1	55182626	.	G	T	3	3	6	0	0	6	0	0
1	55182685	.	T	C	4	2	6	0	0	6	0	0
1	55182720	.	T	C	1	5	6	0	0	6	0	0
1	55182743	.	C	T	3	5	8	0	0	8	0	0
1	55182811	.	A	G	3	6	9	0	2	11	0	0
1	55182876	.	A	T	7	5	12	0	0	12	0	0
1	55183074	.	G	A	9	6	15	0	0	15	0	0
1	55191201	.	G	T	3	4	7	0	0	7	0	0
1	55191219	.	T	A	2	4	6	0	0	6	0	0
1	55191467	.	C	T	1	9	10	0	21	31	0	0
1	55191471	.	T	C	21	0	21	0	8	29	0	0
1	55191675	.	A	G	13	8	21	0	0	21	0	0
1	55195309	.	T	C	11	0	11	0	9	20	0	0
1	55195384	.	G	T	8	5	13	0	2	15	0	0
1	55195414	.	G	A	1	2	3	0	0	3	0	0
1	55195952	.	T	G	3	3	6	0	0	6	0	0
1	55196024	.	G	T	6	7	13	0	2	15	0	0
1	55196045	.	T	C	6	0	6	0	6	12	0	0
1	55197805	.	T	C	2	3	5	0	0	5	0	0
1	55226931	.	T	C	1	0	1	0	0	1	0	0
1	55229531	.	T	A	5	2	7	0	0	7	0	0
1	55229767	.	T	C	0	1	1	0	0	1	0	0
1	55233436	.	C	T	1	0	1	0	0	1	0	0
1	55234161	.	A	G	2	3	5	0	0	5	0	0
1	55264135	.	T	C	4	2	6	0	2	8	0	0
1	55264187	.	G	C	5	4	9	0	0	9	0	0
1	55264191	.	A	C	5	3	8	0	1	9	0	0
1	55264225	.	C	T	4	2	6	0	0	6	0	0
1	55264366	.	C	T	6	6	12	0	0	12	0	0
1	55264575	.	T	A	13	16	29	0	2	31	0	0
1	55745816	.	C	T	2	3	5	0	0	5	0	0
1	55762664	.	C	A	7	6	13	0	0	13	0	0
1	55772026	.	C	T	0	1	1	0	0	1	0	0
1	55776813	.	G	A	1	18	19	0	21	40	0	0
1	55776858	.	G	A	1	22	23	0	13	36	0	0
1	55776909	.	A	C	21	9	30	0	1	36	5	0
1	55776962	.	T	A	19	16	35	0	1	36	0	0
1	55777008	.	A	T	17	8	25	0	1	26	0	0
1	55783978	.	T	C	2	1	3	0	0	3	0	0
1	55785527	.	C	A	3	30	33	0	18	51	0	0
1	55785577	.	A	G	18	22	40	0	2	42	0	0
1	55785596	.	T	C	15	25	40	0	2	42	0	0
1	55785654	.	C	T	12	19	31	0	0	31	0	0
1	55785697	.	C	T	2	4	6	0	0	6	0	0
1	55787173	.	A	G	1	2	3	0	0	3	0	0
1	55787219	.	A	C	1	2	3	0	0	3	0	0
1	55787236	.	C	T	4	2	6	0	0	6	0	0
1	55787276	.	G	A	5	2	7	0	0	7	0	0
1	55787300	.	C	T	0	1	1	0	4	5	0	0
1	55789456	.	C	T	4	2	6	0	0	6	0	0
1	55789504	.	A	C	5	0	5	0	2	7	0	0
1	55789549	.	C	A	1	1	2	0	0	2	0	0
1	55793116	.	G	T	2	1	3	0	0	3	0	0
1	55817728	.	C	T	5	3	8	0	0	8	0	0
1	55817753	.	G	A	6	3	9	0	1	10	0	0
1	55833139	.	G	C	4	3	7	0	1	8	0	0
1	55833276	.	C	T	5	3	8	0	0	8	0	0
1	55833281	.	C	T	5	3	8	0	0	8	0	0
1	55843902	.	C	T	11	26	37	0	4	41	0	0
1	55843968	.	G	A	19	22	41	0	2	43	0	0
1	55844044	.	T	A	21	11	32	0	1	33	0	0
1	55844143	.	T	G	16	16	32	0	6	38	0	0
1	55851968	.	T	C	5	0	5	0	9	14	0	0
1	55853320	.	G	A	10	4	14	0	0	14	0	0
1	55872892	.	C	G	17	11	28	0	0	28	0	0
1	55873073	.	C	T	6	15	21	0	2	23	0	0
1	55878257	.	T	A	1	4	5	0	0	5	0	0
1	55878342	.	T	A	6	2	8	0	0	8	0	0
1	55878431	.	T	A	8	6	14	0	1	15	0	0
1	55878457	.	C	T	8	10	18	0	0	18	0	0
1	55878496	.	T	C	12	2	14	0	11	25	0	0
1	55878558	.	G	A	9	12	21	0	0	21	0	0
1	55878624	.	T	A	8	2	10	0	1	11	0	0
1	55878626	.	A	C	9	2	11	0	0	11	0	0
1	55878755	.	T	G	7	2	9	0	14	23	0	0
1	55878761	.	T	G	5	1	6	0	15	21	0	0
1	55888442	.	A	G	0	4	4	0	0	4	0	0
1	55888632	.	T	C	1	0	1	0	6	7	0	0
1	55888654	.	C	T	1	3	4	0	0	4	0	0
1	55888690	.	A	G	2	2	4	0	1	5	0	0
1	55888693	.	T	A	2	2	4	0	1	5	0	0
1	55888810	.	A	C	4	2	6	0	0	6	0	0
1	55888816	.	G	A	4	2	6	0	0	6	0	0
1	55888852	.	A	C	3	4	7	0	0	7	0	0
1	55888857	.	A	C	3	0	3	0	6	9	0	0
1	55888892	.	A	G	4	5	9	0	0	9	0	0
1	56217457	.	G	A	4	8	12	0	0	12	0	0
1	56217510	.	A	G	19	26	45	0	2	47	0	0
1	56217925	.	G	A	21	40	61	0	5	67	1	0
1	56218189	.	C	T	2	33	35	0	39	74	0	0
1	56218258	.	A	C	28	42	70	0	4	74	0	0
1	56220668	.	A	G	13	18	31	0	1	32	0	0
1	56223902	.	T	G	4	3	7	0	0	7	0	0
1	56422751	.	G	A	7	3	10	0	0	10	0	0
1	56422781	.	T	A	5	3	8	0	0	8	0	0
1	56422962	.	A	T	4	8	12	0	0	12	0	0
1	56422967	.	T	C	3	9	12	0	1	13	0	0
1	56423002	.	T	G	1	8	9	0	1	10	0	0
1	56423427	.	T	C	1	0	1	0	4	5	0	0
1	56423641	.	T	A	6	2	8	0	1	9	0	0
1	56423664	.	T	C	6	0	6	0	4	10	0	0
1	56423678	.	T	A	8	1	9	0	1	10	0	0
1	56425228	.	G	C	3	0	3	0	2	5	0	0
1	56425243	.	A	G	3	2	5	0	2	7	0	0
1	56428320	.	G	A	1	0	1	0	0	1	0	0
1	57170399	.	T	C	2	2	4	0	0	4	0	0
1	57170406	.	T	C	1	2	3	0	0	3	0	0
1	57170997	.	G	A	1	2	3	0	0	3	0	0
1	57171006	.	A	T	1	1	2	0	0	2	0	0
1	57278215	.	G	C	3	4	7	0	0	7	0	0
1	57278405	.	A	T	2	4	6	0	0	6	0	0
1	57278452	.	C	T	2	2	4	0	0	4	0	0
1	57278610	.	T	G	4	4	8	0	0	8	0	0
1	57278669	.	A	G	3	4	7	0	0	7	0	0
1	57278690	.	G	A	3	4	7	0	0	7	0	0
1	57278753	.	T	C	1	4	5	0	0	5	0	0
1	57278783	.	T	C	2	2	4	0	1	5	0	0
1	57278915	.	G	A	5	5	10	0	0	10	0	0
1	57278979	.	G	A	3	7	10	0	0	10	0	0
1	57279073	.	T	C	1	0	1	0	6	7	0	0
1	57280108	.	G	A	6	3	9	0	1	10	0	0
1	57280184	.	G	T	3	3	6	0	0	6	0	0
1	57280292	.	T	C	4	5	9	0	0	9	0	0
1	57280502	.	T	C	9	4	13	0	0	13	0	0
1	57306744	.	G	T	2	3	5	0	0	5	0	0
1	57332495	.	A	T	2	3	5	0	0	5	0	0
1	57332657	.	G	A	0	2	2	0	2	4	0	0
1	57332699	.	G	A	0	2	2	0	2	4	0	0
1	57334741	.	T	C	1	1	2	0	0	2	0	0
1	57334747	.	A	G	1	1	2	0	0	2	0	0
1	57338143	.	C	T	4	2	6	0	0	6	0	0
1	57338226	.	G	A	0	5	5	0	5	10	0	0
1	57340049	.	T	C	8	3	11	0	0	11	0	0
1	57340108	.	C	T	11	3	14	0	0	14	0	0
1	57340164	.	T	A	7	6	13	0	1	14	0	0
1	58013096	.	A	G	9	3	12	0	0	12	0	0
1	58013102	.	A	T	7	4	11	0	0	11	0	0
1	58013308	.	C	A	2	3	5	0	1	6	0	0
1	58013309	.	A	G	3	3	6	0	0	6	0	0
1	58013423	.	C	T	0	3	3	0	9	12	0	0
1	58013474	.	T	C	0	0	0	0	3	3	0	0
1	58013554	.	G	A	6	2	8	0	0	8	0	0
1	58014867	.	T	C	6	4	10	0	0	10	0	0
1	58015053	.	A	G	0	1	1	0	0	1	0	0
1	58015511	.	A	G	3	3	6	0	0	6	0	0
1	58015532	.	T	G	4	2	6	0	0	6	0	0
1	58017188	.	C	T	1	1	2	0	0	2	0	0
1	58018790	.	C	T	1	1	2	0	0	2	0	0
1	58019888	.	A	T	3	6	9	0	0	9	0	0
1	58020842	.	A	G	2	0	2	0	0	2	0	0
1	58036300	.	G	T	2	2	4	0	0	4	0	0
1	58036348	.	A	C	3	2	5	0	0	5	0	0
1	58036351	.	A	G	3	2	5	0	0	5	0	0
1	58036450	.	G	A	1	4	5	0	0	5	0	0
1	58545734	.	C	G	6	5	11	0	0	11	0	0
1	58547783	.	T	C	4	6	10	0	0	10	0	0
1	58548428	.	T	C	3	1	4	0	0	4	0	0
1	58548491	.	T	C	5	4	9	0	0	9	0	0
1	58550545	.	A	G	1	0	1	0	0	1	0	0
1	58559598	.	A	G	0	1	1	0	0	1	0	0
1	58568895	.	T	G	0	1	1	0	0	1	0	0
1	58593731	.	G	A	4	2	6	0	0	6	0	0
1	58593768	.	T	G	2	2	4	0	0	4	0	0
1	58593833	.	C	A	4	7	11	0	0	11	0	0
1	58593835	.	T	C	4	7	11	0	0	11	0	0
1	58593912	.	C	T	5	4	9	0	0	9	0	0
1	58593989	.	G	A	4	3	7	0	0	7	0	0
1	58594007	.	C	T	3	4	7	0	0	7	0	0
1	58594066	.	T	C	4	0	4	0	4	8	0	0
1	58594143	.	A	C	3	4	7	0	0	7	0	0
1	58594144	.	G	A	3	4	7	0	0	7	0	0
1	58594269	.	T	C	5	6	11	0	0	11	0	0
1	58594292	.	T	C	2	3	5	0	0	5	0	0
1	58594611	.	T	G	2	5	7	0	1	8	0	0
1	58595018	.	C	T	11	5	16	0	0	16	0	0
1	58595198	.	A	G	6	3	9	0	0	9	0	0
1	58595386	.	G	A	5	4	9	0	1	10	0	0
1	58595455	.	G	A	7	5	12	0	2	14	0	0
1	58595545	.	T	C	4	5	9	0	0	9	0	0
1	58598802	.	T	C	1	0	1	0	4	5	0	0
1	58598830	.	A	T	0	3	3	0	0	3	0	0
1	58605969	.	C	G	2	2	4	0	0	4	0	0
1	58605997	.	A	G	2	2	4	0	0	4	0	0
1	58610294	.	A	G	5	2	7	0	0	7	0	0
1	58610309	.	G	T	5	2	7	0	0	7	0	0
1	58612354	.	G	A	2	2	4	0	0	4	0	0
1	58612519	.	T	C	6	4	10	0	0	10	0	0
1	58612762	.	A	G	2	2	4	0	1	5	0	0
1	58613008	.	T	C	1	0	1	0	0	1	0	0
1	58613027	.	A	G	1	3	4	0	0	4	0	0
1	58617410	.	T	C	1	0	1	0	0	1	0	0
1	58617987	.	T	C	3	2	5	0	0	5	0	0
1	58677839	.	T	C	5	12	17	0	0	17	0	0
1	58677856	.	C	T	6	9	15	0	0	15	0	0
1	58678077	.	T	A	1	1	2	0	0	2	0	0
1	58680432	.	T	A	2	2	4	0	1	5	0	0
1	58680499	.	C	A	5	12	17	0	0	17	0	0
1	58680570	.	T	C	6	9	15	0	0	15	0	0
1	58680708	.	T	C	8	13	21	0	1	22	0	0
1	58680718	.	C	G	7	13	20	0	1	21	0	0
1	58680792	.	T	C	9	11	20	0	0	20	0	0
1	58680836	.	A	C	15	7	22	2	2	26	0	0
1	58680913	.	T	C	4	14	18	0	2	22	2	0
1	58681068	.	C	T	9	11	20	0	1	21	0	0
1	58681419	.	A	T	5	8	13	0	0	15	2	0
1	58681491	.	T	C	8	5	13	0	0	13	0	0
1	58762985	.	T	G	7	7	14	0	0	14	0	0
1	58766341	.	G	A	6	9	15	0	0	15	0	0
1	58846670	.	C	A	1	1	2	0	0	2	0	0
1	58846938	.	A	G	3	4	7	0	0	7	0	0
1	58850562	.	C	T	1	8	9	0	0	9	0	0
1	58850622	.	T	C	1	7	8	0	1	9	0	0
1	58868253	.	G	A	0	2	2	0	0	2	0	0
1	58978749	.	C	A	3	1	4	0	1	5	0	0
1	58982147	.	G	A	0	7	7	0	7	14	0	0
1	58982195	.	C	G	3	10	13	0	0	13	0	0
1	58984239	.	G	T	3	2	5	0	0	5	0	0
1	58984368	.	G	A	0	2	2	0	1	3	0	0
1	58984478	.	T	C	1	0	1	0	0	1	0	0
1	58984640	.	C	T	4	3	7	0	0	7	0	0
1	58985530	.	G	A	8	8	16	0	1	17	0	0
1	58985579	.	T	G	8	9	17	0	2	19	0	0
1	58985730	.	C	A	4	6	10	0	0	10	0	0
1	58992846	.	C	T	1	1	2	0	0	2	0	0
1	58993039	.	T	G	0	1	1	0	0	1	0	0
1	58998156	.	C	G	1	1	2	0	0	2	0	0
1	58998157	.	T	G	1	1	2	0	0	2	0	0
1	58999960	.	T	A	2	3	5	0	1	6	0	0
1	59009732	.	A	G	20	1	21	0	17	38	0	0
1	59010618	.	G	A	1	0	1	0	1	2	0	0
1	59018886	.	C	T	0	6	6	0	6	12	0	0
1	59019006	.	C	G	3	4	7	0	0	7	0	0
1	59019084	.	T	A	2	5	7	0	0	7	0	0
1	59019093	.	A	G	4	5	9	0	0	9	0	0
1	59062665	.	T	C	29	23	52	0	1	53	0	0
1	59065889	.	G	A	0	10	10	0	24	34	0	0
1	59141550	.	T	C	1	1	2	0	0	2	0	0
1	59141556	.	G	C	1	1	2	0	0	2	0	0
1	59142891	.	A	G	4	0	4	0	6	10	0	0
1	59143004	.	T	C	0	1	1	0	0	1	0	0
1	59148260	.	T	C	2	3	5	0	0	5	0	0
1	59148341	.	T	C	1	5	6	0	0	6	0	0
1	59149117	.	C	T	11	7	18	0	0	18	0	0
1	59149968	.	T	C	14	15	29	0	0	29	0	0
1	59150450	.	A	G	6	5	11	0	0	12	1	0
1	59150482	.	G	T	8	4	12	0	0	12	0	0
1	59150489	.	G	T	7	1	8	0	0	8	0	0
1	59150518	.	T	C	8	16	24	0	0	24	0	0
1	59150559	.	T	G	11	13	24	0	1	25	0	0
1	59150583	.	T	A	7	14	21	0	0	21	0	0
1	59150683	.	T	C	6	15	21	0	0	21	0	0
1	59150737	.	T	C	4	6	10	0	0	10	0	0
1	59150762	.	G	T	9	6	15	0	0	15	0	0
1	59150781	.	T	C	9	10	19	0	0	19	0	0
1	59154592	.	T	C	0	5	5	0	0	5	0	0
1	59156827	.	T	G	7	3	10	0	1	11	0	0
1	59157536	.	T	C	5	7	12	0	0	12	0	0
1	59157856	.	T	A	5	2	7	0	0	7	0	0
1	59157888	.	T	C	10	10	20	0	1	21	0	0
1	59157977	.	A	C	13	13	26	0	0	26	0	0
1	59158035	.	C	A	10	18	28	0	0	28	0	0
1	59158062	.	A	T	9	17	26	0	1	27	0	0
1	59158070	.	G	A	9	15	24	0	1	25	0	0
1	59172876	.	A	G	15	7	22	0	0	22	0	0
1	59172900	.	A	G	15	10	25	0	0	25	0	0
1	59172969	.	G	A	13	15	28	0	0	28	0	0
1	59173358	.	G	T	8	10	18	0	1	19	0	0
1	59173701	.	G	T	1	2	3	0	0	3	0	0
1	59173758	.	A	G	5	9	14	0	1	15	0	0
1	59173866	.	T	G	18	4	22	0	8	30	0	0
1	59173896	.	T	C	18	1	19	0	14	33	0	0
1	59174387	.	A	G	11	10	21	0	0	21	0	0
1	59174408	.	G	A	10	7	17	0	2	19	0	0
1	59174492	.	T	G	10	5	15	0	1	16	0	0
1	59174525	.	A	C	9	5	14	0	0	14	0	0
1	59174576	.	C	T	4	10	14	0	1	15	0	0
1	59174645	.	G	A	11	7	18	0	0	18	0	0
1	59174797	.	A	C	19	11	30	0	2	32	0	0
1	59174962	.	T	C	14	18	32	0	0	32	0	0
1	59175511	.	T	C	8	10	18	0	0	18	0	0
1	59175572	.	A	G	8	11	19	0	0	19	0	0
1	59175626	.	G	A	6	11	17	0	0	17	0	0
1	59175635	.	G	A	6	10	16	0	0	16	0	0
1	59175740	.	G	T	9	6	15	0	1	16	0	0
1	59175983	.	T	C	8	9	17	0	0	17	0	0
1	59175989	.	A	G	7	8	15	0	1	16	0	0
1	59176887	.	G	T	2	5	7	0	0	7	0	0
1	59176935	.	A	C	2	0	2	0	6	8	0	0
1	59218477	.	C	G	0	3	3	0	7	10	0	0
1	59218594	.	A	G	9	11	20	0	0	20	0	0
1	59226049	.	T	C	7	8	15	0	2	17	0	0
1	59226052	.	A	G	9	9	18	0	1	19	0	0
1	59226374	.	A	G	2	3	5	0	0	5	0	0
1	59228569	.	A	C	7	2	9	0	8	17	0	0
1	59229211	.	G	A	5	3	8	0	0	8	0	0
1	59232206	.	A	G	9	21	30	0	1	31	0	0
1	59232358	.	T	G	1	4	5	0	0	5	0	0
1	59232509	.	G	A	7	13	20	0	0	20	0	0
1	59235016	.	T	G	2	4	6	0	0	6	0	0
1	59238037	.	T	C	1	3	4	0	0	4	0	0
1	59238038	.	A	C	0	2	2	0	2	4	0	0
1	59244312	.	A	G	12	5	17	0	0	17	0	0
1	59244635	.	A	T	12	22	34	0	2	36	0	0
1	59244768	.	G	T	25	7	32	0	0	32	0	0
1	59244916	.	T	A	34	17	51	0	2	53	0	0
1	59244928	.	C	T	35	18	53	0	1	54	0	0
1	59245142	.	C	G	29	22	51	0	1	52	0	0
1	59245658	.	G	A	10	5	15	0	0	15	0	0
1	59245873	.	T	C	3	2	5	0	3	8	0	0
1	59245900	.	C	T	8	6	14	0	2	16	0	0
1	59246189	.	T	C	12	0	12	0	26	38	0	0
1	59246318	.	A	G	1	3	4	0	0	4	0	0
1	59246320	.	G	A	1	3	4	0	0	4	0	0
1	59246363	.	A	T	2	4	6	0	0	6	0	0
1	59247893	.	T	G	18	7	25	0	0	25	0	0
1	59247944	.	C	T	10	5	15	0	1	16	0	0
1	59248138	.	T	A	12	13	25	0	1	26	0	0
1	59251658	.	C	G	10	5	15	0	1	16	0	0
1	59251839	.	T	C	11	0	11	0	11	22	0	0
1	59293966	.	A	G	3	4	7	0	0	7	0	0
1	59297464	.	T	G	3	1	4	0	0	4	0	0
1	59297557	.	T	G	1	1	2	0	1	3	0	0
1	59298207	.	C	T	0	2	2	0	0	2	0	0
1	59298261	.	T	G	0	1	1	0	0	1	0	0
1	59302210	.	G	A	0	2	2	0	2	4	0	0
1	59302276	.	C	T	3	13	16	0	1	17	0	0
1	59302372	.	T	G	4	10	14	0	0	14	0	0
1	59302813	.	C	A	1	3	4	0	0	4	0	0
1	59303024	.	C	A	6	10	16	0	0	16	0	0
1	59303294	.	C	G	1	0	1	0	3	4	0	0
1	59303334	.	A	G	1	2	3	0	0	3	0	0
1	59304609	.	T	A	5	3	8	0	0	8	0	0
1	59304719	.	G	C	4	2	6	0	0	6	0	0
1	59304746	.	A	T	3	2	5	0	0	5	0	0
1	59309451	.	C	T	1	2	3	0	2	5	0	0
1	59309452	.	G	T	1	3	4	0	1	5	0	0
1	59310354	.	C	T	1	0	1	0	0	1	0	0
1	59310630	.	C	G	0	3	3	0	2	5	0	0
1	59313365	.	T	C	1	3	4	0	0	4	0	0
1	59313443	.	A	G	2	2	4	0	0	4	0	0
1	59314966	.	A	G	3	1	4	0	0	4	0	0
1	59321447	.	A	G	19	0	19	0	8	27	0	0
1	59324067	.	T	C	9	7	16	0	1	17	0	0
1	59328287	.	C	T	2	5	7	0	2	9	0	0
1	59328486	.	C	T	5	3	8	0	0	8	0	0
1	59329950	.	A	G	5	7	12	0	0	12	0	0
1	59329957	.	T	C	7	7	14	0	0	14	0	0
1	59330135	.	T	C	3	4	7	0	0	7	0	0
1	59330169	.	C	T	3	4	7	0	0	7	0	0
1	59406389	.	A	T	1	11	12	0	1	13	0	0
1	59407198	.	G	A	1	4	5	0	0	5	0	0
1	59409266	.	G	A	1	7	8	0	0	8	0	0
1	59409455	.	A	G	1	2	3	0	0	3	0	0
1	59555962	.	C	G	3	13	16	0	0	16	0	0
1	59555999	.	G	A	0	15	15	0	0	15	0	0
10	22672	.	A	T	1	3	4	0	1	5	0	0
10	23959	.	C	T	1	1	2	0	0	2	0	0
10	27705	.	A	G	3	5	8	0	0	8	0	0
10	32998	.	G	T	2	5	7	0	0	7	0	0
10	33427	.	G	A	5	8	13	0	0	13	0	0
10	33634	.	G	T	7	7	14	0	0	14	0	0
10	33689	.	G	C	3	5	8	0	0	8	0	0
10	34028	.	C	T	4	4	8	0	0	8	0	0
10	34233	.	G	A	4	5	9	0	0	9	0	0
10	34325	.	C	T	0	4	4	0	3	7	0	0
10	34799	.	G	C	6	0	6	0	7	13	0	0
10	53815	.	T	C	8	5	13	0	0	13	0	0
10	53816	.	G	A	8	5	13	0	0	13	0	0
10	53930	.	T	G	7	10	17	0	0	17	0	0
10	55594	.	G	A	9	10	19	0	0	19	0	0
10	55627	.	C	T	0	11	11	0	10	21	0	0
10	55665	.	A	C	5	5	10	0	0	10	0	0
10	55666	.	G	C	5	0	5	0	5	10	0	0
10	62468	.	C	G	17	14	31	0	0	31	0	0
10	66886	.	A	G	9	9	18	0	1	19	0	0
10	66967	.	A	G	10	13	23	0	0	23	0	0
10	81276	.	C	T	9	5	14	0	1	15	0	0
10	81285	.	C	T	8	10	18	0	0	18	0	0
10	81348	.	C	T	22	13	35	0	0	35	0	0
10	81444	.	C	T	13	7	20	0	0	20	0	0
10	81508	.	A	G	18	0	18	0	5	23	0	0
10	81579	.	G	T	0	7	7	0	4	11	0	0
10	82336	.	A	G	19	6	25	0	0	25	0	0
10	85404	.	G	A	2	0	2	0	0	2	0	0
10	85419	.	C	T	0	0	0	0	2	2	0	0
10	85571	.	G	C	6	3	9	0	0	9	0	0
10	85585	.	C	T	5	3	8	0	1	9	0	0
10	85927	.	A	G	4	0	4	0	0	4	0	0
10	85948	.	G	C	4	0	4	0	0	4	0	0
10	87353	.	G	A	0	3	3	0	1	4	0	0
10	90320	.	A	C	2	3	5	0	0	5	0	0
10	93610	.	G	A	2	2	4	0	0	4	0	0
10	115088	.	G	A	11	14	25	0	0	25	0	0
10	115493	.	G	T	15	6	21	0	0	21	0	0
10	115506	.	T	G	12	6	18	0	0	18	0	0
10	115615	.	T	C	9	9	18	0	2	20	0	0
10	115626	.	C	A	8	9	17	0	1	18	0	0
10	115679	.	A	T	8	7	15	0	1	16	0	0
10	115773	.	A	G	6	8	14	0	0	14	0	0
10	115820	.	T	C	10	10	20	0	0	20	0	0
10	116231	.	C	G	0	2	2	0	0	2	0	0
10	134661	.	C	T	0	9	9	0	22	31	0	0
10	134749	.	C	T	0	18	18	0	18	36	0	0
10	187823	.	C	T	10	8	18	0	0	18	0	0
10	190039	.	G	A	9	3	12	0	0	12	0	0
10	190917	.	C	T	10	11	21	0	0	21	0	0
10	193853	.	G	A	9	5	14	0	6	20	0	0
10	196307	.	C	T	10	7	17	0	1	18	0	0
10	196426	.	T	A	15	9	24	0	0	24	0	0
10	196429	.	A	T	15	8	23	0	0	23	0	0
10	196524	.	A	G	3	0	3	0	12	15	0	0
10	196563	.	C	G	2	7	9	0	1	10	0	0
10	196670	.	G	A	12	15	27	0	1	28	0	0
10	207128	.	G	A	2	7	9	0	1	10	0	0
10	207783	.	G	A	0	1	1	0	0	1	0	0
10	208034	.	A	T	11	14	25	0	0	25	0	0
10	208104	.	G	A	8	5	13	0	1	14	0	0
10	208674	.	G	A	3	6	9	0	2	11	0	0
10	208714	.	C	T	0	9	9	0	6	15	0	0
10	210568	.	A	G	9	6	15	0	0	15	0	0
10	210598	.	T	C	11	7	18	0	1	19	0	0
10	214013	.	T	A	4	5	9	0	0	9	0	0
10	286788	.	T	C	3	2	5	0	13	18	0	0
10	292655	.	C	T	0	4	4	0	2	6	0	0
10	292667	.	A	G	2	1	3	0	0	3	0	0
10	294113	.	G	A	6	7	13	0	0	13	0	0
10	294653	.	A	G	7	5	12	0	0	12	0	0
10	295070	.	A	G	0	1	1	0	0	1	0	0
10	295202	.	T	C	0	2	2	0	0	2	0	0
10	296617	.	C	T	0	5	5	0	2	7	0	0
10	297823	.	C	T	0	1	1	0	0	1	0	0
10	307976	.	G	T	13	7	20	0	1	21	0	0
10	307985	.	T	C	15	0	15	0	6	21	0	0
10	308288	.	T	C	9	8	17	0	0	17	0	0
10	320142	.	C	A	0	2	2	0	0	2	0	0
10	416421	.	A	T	2	6	8	0	1	9	0	0
10	416789	.	G	T	0	4	4	0	1	5	0	0
10	428621	.	G	A	1	2	3	0	1	4	0	0
10	474834	.	T	C	4	3	7	0	1	8	0	0
10	474896	.	T	C	4	6	10	0	0	10	0	0
10	478304	.	T	G	14	10	24	0	0	24	0	0
10	478388	.	G	A	0	21	21	0	14	35	0	0
10	478508	.	T	C	14	24	38	0	1	39	0	0
10	478661	.	C	T	15	18	33	0	4	37	0	0
10	478724	.	G	A	23	17	40	0	0	40	0	0
10	478742	.	C	T	23	17	40	0	0	40	0	0
10	479063	.	A	G	5	7	12	0	0	12	0	0
10	482335	.	G	A	10	11	21	0	0	21	0	0
10	482371	.	T	G	18	23	41	0	0	41	0	0
10	486146	.	G	A	12	22	34	0	1	35	0	0
10	486153	.	T	C	13	19	32	0	4	36	0	0
10	500114	.	A	G	9	0	9	0	8	17	0	0
10	500168	.	G	A	2	18	20	0	25	45	0	0
10	500423	.	A	G	24	0	24	0	27	51	0	0
10	500473	.	T	C	12	13	25	0	1	26	0	0
10	501833	.	C	T	7	3	10	0	1	11	0	0
10	501899	.	G	C	9	18	27	0	2	29	0	0
10	505282	.	A	G	16	20	36	0	1	37	0	0
10	505316	.	G	A	0	25	25	0	14	39	0	0
10	573770	.	A	G	6	0	6	0	4	10	0	0
10	573789	.	T	A	4	4	8	0	0	8	0	0
10	573806	.	G	A	3	3	6	0	0	6	0	0
10	576060	.	A	G	7	5	12	0	1	13	0	0
10	577791	.	G	C	3	3	6	0	1	7	0	0
10	579989	.	A	G	6	0	6	0	5	11	0	0
10	580088	.	G	T	0	13	13	0	5	18	0	0
10	580092	.	G	A	5	12	17	0	0	17	0	0
10	586563	.	C	A	1	5	6	0	0	6	0	0
10	589487	.	G	A	10	6	16	0	0	16	0	0
10	589655	.	T	C	4	4	8	0	0	8	0	0
10	589789	.	G	A	0	5	5	0	3	8	0	0
10	589810	.	A	T	5	6	11	0	0	11	0	0
10	589875	.	T	C	6	4	10	0	0	10	0	0
10	590067	.	A	C	3	4	7	0	0	7	0	0
10	590087	.	A	G	5	5	10	0	0	10	0	0
10	590362	.	A	G	1	1	2	0	0	2	0	0
10	590956	.	A	T	6	7	13	0	0	13	0	0
10	590957	.	A	G	6	7	13	0	0	13	0	0
10	591017	.	T	C	11	7	18	0	0	19	1	0
10	591219	.	T	G	2	0	2	0	7	9	0	0
10	591220	.	C	T	2	7	9	0	0	9	0	0
10	591434	.	G	A	5	3	8	0	0	8	0	0
10	591476	.	A	G	3	1	4	0	7	11	0	0
10	591567	.	T	A	7	6	13	0	2	15	0	0
10	591634	.	T	G	13	5	18	0	0	18	0	0
10	600584	.	G	A	6	7	13	0	0	13	0	0
10	609654	.	C	T	0	0	0	0	1	1	0	0
10	617784	.	G	A	2	2	4	0	0	4	0	0
10	1052728	.	C	T	3	3	6	0	0	6	0	0
10	1056460	.	T	C	4	9	13	0	1	14	0	0
10	1073456	.	T	C	3	4	7	0	0	7	0	0
10	1073519	.	G	C	0	4	4	0	7	11	0	0
10	1075972	.	G	A	0	4	4	0	2	6	0	0
10	1076044	.	C	T	8	6	14	0	0	14	0	0
10	1076116	.	C	T	9	4	13	0	1	14	0	0
10	1091694	.	A	G	0	1	1	0	0	1	0	0
10	1107441	.	G	A	0	8	8	0	6	14	0	0
10	1107460	.	C	T	12	7	19	0	1	20	0	0
10	1107540	.	C	A	11	10	21	0	0	21	0	0
10	1436596	.	C	G	0	1	1	0	0	1	0	0
10	1479456	.	G	A	7	4	11	0	0	11	0	0
10	1541357	.	G	C	3	0	3	0	5	8	0	0
10	1541359	.	T	C	3	0	3	0	5	8	0	0
10	1543848	.	G	C	4	1	5	0	0	5	0	0
10	1546089	.	A	C	7	0	7	0	3	10	0	0
10	1549013	.	C	A	1	3	4	0	2	6	0	0
10	1549088	.	C	T	0	6	6	0	9	15	0	0
10	1549409	.	T	C	9	0	9	0	3	12	0	0
10	1549494	.	G	A	11	10	21	0	1	22	0	0
10	1549532	.	A	G	5	4	9	0	1	10	0	0
10	1549714	.	G	A	14	8	22	0	0	22	0	0
10	1549769	.	A	G	9	5	14	0	0	14	0	0
10	1711599	.	T	C	2	0	2	0	16	18	0	0
10	1712100	.	T	A	1	12	13	0	1	14	0	0
10	2832181	.	A	G	1	1	2	0	2	4	0	0
10	2832282	.	A	G	1	0	1	0	2	3	0	0
10	2836235	.	T	A	2	3	5	0	0	5	0	0
10	2843022	.	G	A	3	1	4	0	1	5	0	0
10	2846887	.	C	T	4	1	5	0	0	5	0	0
10	2848976	.	A	G	1	1	2	0	0	2	0	0
10	2850332	.	A	G	7	1	8	0	1	9	0	0
10	2850416	.	G	A	3	3	6	0	0	6	0	0
10	2856558	.	G	A	0	2	2	0	1	3	0	0
10	2856584	.	G	T	1	4	5	0	0	5	0	0
10	2860806	.	G	A	1	2	3	0	0	3	0	0
10	2861679	.	T	C	4	0	4	0	2	6	0	0
10	2862538	.	T	A	1	1	2	0	0	2	0	0
10	2869202	.	G	A	4	2	6	0	0	6	0	0
10	2869760	.	G	A	3	2	5	0	0	5	0	0
10	2878104	.	G	C	1	0	1	0	0	1	0	0
10	2880537	.	A	G	1	2	3	0	0	3	0	0
10	2882230	.	C	T	1	4	5	0	0	5	0	0
10	2882422	.	T	G	1	1	2	0	0	2	0	0
10	2884136	.	G	C	0	1	1	0	0	1	0	0
10	2885852	.	C	T	2	2	4	0	0	4	0	0
10	2891893	.	C	T	7	8	15	0	0	15	0	0
10	2891905	.	G	A	7	8	15	0	0	15	0	0
10	2891981	.	A	T	3	4	7	0	1	8	0	0
10	2894193	.	T	G	0	0	0	0	3	3	0	0
10	2894451	.	G	A	0	5	5	0	4	9	0	0
10	2897110	.	A	C	10	7	17	0	0	17	0	0
10	2897720	.	T	A	3	2	5	0	1	6	0	0
10	2897817	.	T	G	12	0	12	0	10	22	0	0
10	2897897	.	A	G	5	5	10	0	0	10	0	0
10	2897911	.	G	T	5	7	12	0	0	12	0	0
10	2898087	.	T	C	2	3	5	0	0	5	0	0
10	2898212	.	T	G	5	5	10	0	1	11	0	0
10	2898213	.	C	G	5	5	10	0	1	11	0	0
10	2898346	.	T	A	5	2	7	0	0	8	1	0
10	2898390	.	A	T	5	2	7	0	0	7	0	0
10	2899345	.	A	G	1	3	4	0	0	4	0	0
10	2899496	.	T	A	1	2	3	0	0	3	0	0
10	2904581	.	T	C	1	2	3	0	0	3	0	0
10	2904609	.	C	G	1	0	1	0	5	6	0	0
10	2904794	.	C	T	0	2	2	0	0	2	0	0
10	2908907	.	G	A	0	0	0	0	1	1	0	0
10	2914955	.	G	A	0	2	2	0	3	5	0	0
10	2915412	.	A	G	7	4	11	0	0	11	0	0
10	2915426	.	C	T	7	3	10	0	3	13	0	0
10	2921031	.	T	A	1	0	1	0	0	1	0	0
10	2921163	.	A	G	2	2	4	0	0	4	0	0
10	2925089	.	A	G	4	2	6	0	1	7	0	0
10	2925379	.	G	T	1	7	8	0	0	8	0	0
10	2927466	.	C	G	1	0	1	0	0	1	0	0
10	2927480	.	T	G	3	1	4	0	0	4	0	0
10	2930577	.	C	A	3	5	8	0	0	8	0	0
10	2983370	.	T	C	1	3	4	0	0	4	0	0
10	2983864	.	C	A	3	2	5	0	0	5	0	0
10	2984311	.	C	T	1	2	3	0	0	3	0	0
10	2984557	.	T	C	2	3	5	0	0	5	0	0
10	2987020	.	A	G	0	0	0	0	2	2	0	0
10	3010820	.	C	G	3	0	3	0	0	3	0	0
10	3012802	.	T	C	0	1	1	0	0	1	0	0
10	3016329	.	C	T	1	3	4	0	1	5	0	0
10	3022076	.	G	T	2	3	5	0	0	5	0	0
10	3024706	.	C	T	8	7	15	0	2	17	0	0
10	3026264	.	A	C	10	8	18	0	2	20	0	0
10	3026484	.	G	A	1	3	4	0	4	8	0	0
10	3031670	.	T	C	5	0	5	0	4	9	0	0
10	3032353	.	T	A	4	4	8	0	0	8	0	0
10	3032458	.	C	T	0	4	4	0	5	9	0	0
10	3032512	.	T	A	2	6	8	0	0	8	0	0
10	3032731	.	G	C	6	5	11	0	0	11	0	0
10	3032743	.	T	C	7	4	11	0	1	12	0	0
10	3032806	.	T	C	3	6	9	0	0	9	0	0
10	3033160	.	G	A	2	3	5	0	0	5	0	0
10	3133204	.	T	A	3	5	8	0	0	8	0	0
10	3133598	.	A	C	10	7	17	0	1	18	0	0
10	3154576	.	C	T	3	4	7	0	1	8	0	0
10	3154684	.	A	G	5	2	7	0	0	7	0	0
10	3154825	.	C	G	2	3	5	0	0	5	0	0
10	3155314	.	T	C	4	5	9	0	1	10	0	0
10	3189081	.	G	A	3	2	5	0	1	6	0	0
10	3191133	.	A	C	4	1	5	0	3	8	0	0
10	3192786	.	G	A	3	2	5	0	0	5	0	0
10	3194054	.	T	C	2	2	4	0	0	4	0	0
10	3197593	.	A	G	0	2	2	0	0	2	0	0
10	3201871	.	G	A	9	4	13	0	0	13	0	0
10	3204658	.	A	G	4	2	6	0	0	6	0	0
10	3207591	.	A	G	0	2	2	0	0	2	0	0
10	3207612	.	A	G	3	2	5	0	1	6	0	0
10	3207646	.	C	T	6	6	12	0	1	13	0	0
10	3212906	.	A	G	0	1	1	0	0	1	0	0
10	3228531	.	A	G	2	1	3	0	0	3	0	0
10	3247444	.	A	G	4	3	7	0	0	7	0	0
10	3255584	.	T	A	1	2	3	0	0	3	0	0
10	3255586	.	T	C	1	2	3	0	0	3	0	0
10	3311737	.	T	G	7	6	13	0	1	14	0	0
10	3311845	.	G	A	5	2	7	0	0	7	0	0
10	3317675	.	C	T	11	5	16	0	1	17	0	0
10	3317800	.	C	A	11	11	22	0	0	22	0	0
10	3317823	.	G	T	12	9	21	0	2	23	0	0
10	3318112	.	G	C	4	15	19	0	0	19	0	0
10	3318215	.	A	T	4	5	9	0	0	9	0	0
10	3318224	.	T	A	3	4	7	0	0	7	0	0
10	3318358	.	G	T	4	3	7	0	0	7	0	0
10	3318424	.	T	C	8	7	15	0	1	16	0	0
10	3318490	.	G	A	0	6	6	0	12	18	0	0
10	3318502	.	A	G	11	5	16	0	1	17	0	0
10	3318825	.	T	G	3	3	6	0	0	6	0	0
10	3319970	.	G	A	8	9	17	0	1	18	0	0
10	3319981	.	A	T	10	9	19	0	0	19	0	0
10	3320072	.	T	G	7	12	19	0	1	20	0	0
10	3320229	.	G	A	10	12	22	0	0	22	0	0
10	3320287	.	T	G	17	10	27	0	0	27	0	0
10	3320355	.	A	T	10	11	21	0	2	23	0	0
10	3320487	.	A	G	17	1	18	0	14	32	0	0
10	3320561	.	A	T	16	14	30	0	1	31	0	0
10	3320705	.	G	A	17	12	29	0	1	30	0	0
10	3320834	.	A	C	10	15	25	0	2	27	0	0
10	3320850	.	C	T	9	16	25	0	1	26	0	0
10	3321262	.	A	G	11	28	39	0	0	39	0	0
10	3322004	.	C	G	12	16	28	0	0	28	0	0
10	3322012	.	C	T	13	18	31	0	0	31	0	0
10	3341412	.	C	T	0	4	4	0	0	4	0	0
10	3342716	.	G	T	1	1	2	0	0	2	0	0
10	3345554	.	C	T	5	3	8	0	2	10	0	0
10	3355651	.	T	C	2	1	3	0	0	3	0	0
10	3365312	.	T	C	7	6	13	0	0	13	0	0
10	3366199	.	C	T	0	5	5	0	3	8	0	0
10	3371866	.	G	A	1	1	2	0	0	2	0	0
10	3375418	.	T	C	1	4	5	0	0	5	0	0
10	3377087	.	G	A	3	5	8	0	0	8	0	0
10	3377195	.	G	A	4	3	7	0	0	7	0	0
10	3377222	.	T	C	2	0	2	0	2	4	0	0
10	3381744	.	A	G	4	1	5	0	0	5	0	0
10	3386121	.	A	G	1	1	2	0	0	2	0	0
10	3398215	.	G	T	1	3	4	0	0	4	0	0
10	3400093	.	T	C	1	1	2	0	0	2	0	0
10	3400126	.	A	T	4	6	10	0	0	10	0	0
10	3400216	.	C	T	5	5	10	0	0	10	0	0
10	3400225	.	T	C	5	5	10	0	0	10	0	0
10	3400360	.	G	A	1	1	2	0	0	2	0	0
10	3403764	.	C	T	0	3	3	0	3	6	0	0
10	3403878	.	C	G	0	0	0	0	1	1	0	0
10	3408257	.	G	A	2	1	3	0	0	3	0	0
10	3420148	.	G	A	22	15	37	0	1	38	0	0
10	3420358	.	T	C	8	8	16	0	1	17	0	0
10	3420480	.	C	G	20	16	36	0	1	37	0	0
10	3420487	.	T	C	19	1	20	0	19	39	0	0
10	3428230	.	G	C	5	5	10	0	0	10	0	0
10	3436313	.	C	T	5	5	10	0	0	10	0	0
10	3436334	.	C	T	5	5	10	0	0	10	0	0
10	3436370	.	C	T	0	1	1	0	0	1	0	0
10	3441753	.	T	A	7	4	11	0	0	11	0	0
10	3441973	.	T	C	3	5	8	0	1	9	0	0
10	3441980	.	T	C	4	5	9	0	0	9	0	0
10	3445818	.	C	T	4	9	13	0	0	13	0	0
10	3450861	.	A	G	6	3	9	0	0	9	0	0
10	3450863	.	A	T	6	3	9	0	0	9	0	0
10	3451349	.	T	A	8	10	18	0	0	18	0	0
10	3451429	.	G	A	0	10	10	0	8	18	0	0
10	3452007	.	A	T	4	8	12	0	0	12	0	0
10	3452045	.	G	A	10	5	15	0	1	16	0	0
10	3452073	.	A	G	10	8	18	0	0	18	0	0
10	3452183	.	G	A	2	7	9	0	0	9	0	0
10	3452185	.	T	A	2	7	9	0	0	9	0	0
10	3452314	.	T	C	7	9	16	0	0	16	0	0
10	3884831	.	G	A	0	1	1	0	0	1	0	0
10	3942996	.	T	A	4	6	10	0	0	10	0	0
10	3943026	.	A	G	3	0	3	0	2	5	0	0
10	3943248	.	G	A	2	6	8	0	4	12	0	0
10	3969326	.	G	A	3	2	5	0	0	5	0	0
10	3969786	.	C	T	3	2	5	1	1	7	0	0
10	3979870	.	G	A	3	9	12	0	0	12	0	0
10	3979876	.	C	A	1	9	10	0	0	10	0	0
10	3980002	.	C	T	5	2	7	0	0	7	0	0
10	3987526	.	A	G	1	3	4	0	0	4	0	0
10	3999676	.	C	T	1	2	3	0	0	3	0	0
10	4010297	.	G	A	4	8	12	0	0	12	0	0
10	4010300	.	A	G	8	3	11	0	1	12	0	0
10	4010345	.	G	T	0	5	5	0	8	13	0	0
10	4026443	.	T	G	4	0	4	0	4	8	0	0
10	4029350	.	G	T	2	1	3	0	0	3	0	0
10	4029455	.	C	T	5	6	11	0	0	11	0	0
10	4029813	.	C	T	1	2	3	0	0	3	0	0
10	4030349	.	C	T	2	3	5	0	0	5	0	0
10	4030352	.	C	A	2	3	5	0	0	5	0	0
10	4034098	.	T	C	9	9	18	0	0	18	0	0
10	4037794	.	T	C	5	5	10	0	1	11	0	0
10	4038334	.	G	A	8	7	15	0	0	15	0	0
10	4038697	.	C	T	10	5	15	0	0	15	0	0
10	4038721	.	G	A	0	7	7	0	8	15	0	0
10	4038772	.	G	A	14	4	18	0	0	18	0	0
10	4039094	.	G	A	17	12	29	0	2	31	0	0
10	4039123	.	C	T	16	16	32	0	3	35	0	0
10	4039129	.	C	T	17	17	34	0	0	34	0	0
10	4039315	.	A	T	10	14	24	0	2	26	0	0
10	4039636	.	T	C	9	11	20	0	0	20	0	0
10	4039714	.	T	C	10	11	21	0	0	21	0	0
10	4073792	.	C	T	3	0	3	0	0	3	0	0
10	4096039	.	T	C	1	7	8	0	1	9	0	0
10	4096159	.	A	G	3	0	3	0	5	8	0	0
10	4096198	.	C	G	2	3	5	0	0	5	0	0
10	4096417	.	T	C	2	3	5	0	0	5	0	0
10	4096744	.	C	G	2	5	7	0	0	7	0	0
10	4096840	.	T	C	3	6	9	0	1	10	0	0
10	4096885	.	T	C	7	5	12	0	0	12	0	0
10	4097053	.	T	A	4	8	12	0	0	12	0	0
10	4097279	.	C	A	1	2	3	1	0	4	0	0
10	4098235	.	C	T	3	10	13	0	0	13	0	0
10	4098355	.	A	T	5	7	12	0	1	13	0	0
10	4240887	.	T	C	21	11	32	0	1	33	0	0
10	4240899	.	C	T	19	12	31	0	0	31	0	0
10	4253636	.	C	T	11	19	30	0	2	32	0	0
10	4279587	.	C	T	1	2	3	0	0	3	0	0
10	4279716	.	C	T	3	3	6	0	1	7	0	0
10	4279800	.	A	G	2	4	6	0	0	6	0	0
10	4314971	.	G	T	1	0	1	0	0	1	0	0
10	4369955	.	T	C	4	2	6	0	0	6	0	0
10	4369993	.	G	A	4	2	6	0	0	6	0	0
10	4500050	.	G	A	12	8	20	0	0	20	0	0
10	4500134	.	G	A	0	1	1	0	0	1	0	0
10	4501817	.	A	G	2	0	2	0	1	3	0	0
10	4502929	.	C	T	2	3	5	0	0	5	0	0
10	4503291	.	G	T	7	4	11	0	1	12	0	0
10	4503606	.	A	T	2	1	3	0	0	3	0	0
10	4508518	.	G	T	1	10	11	0	18	29	0	0
10	4808105	.	A	G	2	5	7	0	0	7	0	0
10	4950854	.	G	A	4	7	11	0	1	12	0	0
10	4950857	.	T	C	6	8	14	0	0	14	0	0
10	4950914	.	T	C	11	0	11	0	7	18	0	0
10	4953443	.	C	T	3	6	9	0	0	9	0	0
10	4953461	.	C	A	5	6	11	0	0	11	0	0
10	4953987	.	A	C	2	0	2	0	0	2	0	0
10	4956942	.	C	T	0	6	6	0	4	10	0	0
10	4956987	.	C	T	0	7	7	0	4	11	0	0
10	4968900	.	G	C	4	1	5	0	0	5	0	0
10	4969014	.	T	A	12	8	20	0	0	20	0	0
10	4969036	.	T	G	8	0	8	0	7	15	0	0
10	4969069	.	C	A	3	14	17	0	0	17	0	0
10	5000719	.	C	T	1	11	12	0	9	21	0	0
10	5000753	.	C	T	0	11	11	0	17	28	0	0
10	5004215	.	C	T	7	5	12	0	0	12	0	0
10	5010287	.	G	A	16	11	27	0	1	28	0	0
10	5010344	.	T	G	22	21	43	0	1	44	0	0
10	5010407	.	G	A	1	4	5	0	0	5	0	0
10	5016797	.	G	A	29	22	51	0	1	52	0	0
10	5016917	.	C	G	27	24	51	0	2	53	0	0
10	5016922	.	A	G	28	24	52	0	1	53	0	0
10	5020320	.	G	A	20	28	48	0	1	49	0	0
10	5020326	.	T	C	26	16	42	0	2	44	0	0
10	5024410	.	C	T	26	28	54	0	2	56	0	0
10	5025848	.	C	A	13	9	22	0	0	22	0	0
10	5026058	.	C	T	3	1	4	0	0	4	0	0
10	5028877	.	A	G	4	5	9	0	0	9	0	0
10	5031869	.	T	C	1	3	4	0	0	4	0	0
10	5036521	.	G	A	0	8	8	0	9	17	0	0
10	5036522	.	A	G	9	6	15	0	2	17	0	0
10	5036729	.	C	T	3	7	10	0	0	10	0	0
10	5036881	.	A	G	3	1	4	0	1	5	0	0
10	5037119	.	T	A	11	4	15	0	1	16	0	0
10	5037147	.	C	T	4	15	19	0	0	19	0	0
10	5037181	.	T	G	9	3	12	0	2	14	0	0
10	5037354	.	C	A	12	3	15	0	0	15	0	0
10	5037372	.	A	T	12	6	18	0	1	19	0	0
10	5042034	.	A	C	3	3	6	0	0	6	0	0
10	5042113	.	C	T	7	12	19	0	2	21	0	0
10	5042217	.	A	G	5	4	9	0	0	9	0	0
10	5042239	.	G	A	3	3	6	0	2	8	0	0
10	5042469	.	G	A	1	1	2	0	0	2	0	0
10	5047452	.	A	G	8	7	15	0	1	16	0	0
10	5053518	.	C	G	0	0	0	0	1	1	0	0
10	5053556	.	T	C	2	1	3	0	0	3	0	0
10	5058715	.	C	T	0	5	5	0	10	15	0	0
10	5092764	.	T	C	3	5	8	0	2	10	0	0
10	5092772	.	A	G	2	4	6	0	2	8	0	0
10	5093121	.	C	G	0	3	3	0	3	6	0	0
10	5093157	.	T	C	6	14	20	0	0	20	0	0
10	5093222	.	A	G	11	9	20	0	1	21	0	0
10	5093240	.	C	A	8	8	16	0	0	16	0	0
10	5093274	.	A	G	4	4	8	0	1	9	0	0
10	5093295	.	T	A	3	2	5	0	0	5	0	0
10	5094649	.	C	A	1	4	5	0	0	5	0	0
10	5094778	.	G	T	2	3	5	0	0	5	0	0
10	5097478	.	G	A	3	11	14	0	0	14	0	0
10	5097520	.	A	G	4	6	10	0	2	12	0	0
10	5110656	.	T	C	2	0	2	0	0	2	0	0
10	5110761	.	A	G	5	2	7	0	0	7	0	0
10	5110777	.	G	A	5	2	7	0	0	7	0	0
10	5113791	.	G	T	1	3	4	0	1	5	0	0
10	5113812	.	C	A	0	3	3	0	1	4	0	0
10	5125912	.	C	T	0	0	0	0	1	1	0	0
10	5135655	.	A	T	1	2	3	0	0	3	0	0
10	5140388	.	G	A	1	5	6	0	0	6	0	0
10	5140392	.	T	G	1	5	6	0	0	6	0	0
10	5203569	.	G	A	4	2	6	0	0	6	0	0
10	5216204	.	T	C	6	4	10	0	1	11	0	0
10	5216249	.	A	G	5	3	8	0	0	8	0	0
10	5220608	.	C	T	9	12	21	0	1	22	0	0
10	5220835	.	G	A	0	8	8	0	5	13	0	0
10	5220940	.	T	A	12	12	24	0	0	24	0	0
10	5220992	.	C	T	14	12	26	0	0	26	0	0
10	5220997	.	C	A	11	13	24	0	1	25	0	0
10	5221039	.	G	A	10	9	19	0	0	19	0	0
10	5221199	.	T	A	11	5	16	0	0	16	0	0
10	5221238	.	C	A	4	11	15	0	0	15	0	0
10	5221292	.	C	A	15	9	24	0	0	24	0	0
10	5221297	.	T	G	14	8	22	0	0	22	0	0
10	5221336	.	G	C	5	13	18	0	1	19	0	0
10	5237199	.	C	A	0	1	1	0	0	1	0	0
10	5237213	.	C	T	0	1	1	0	0	1	0	0
10	5239838	.	G	A	0	1	1	0	0	1	0	0
10	5245143	.	G	A	0	3	3	0	1	4	0	0
10	5248247	.	T	C	3	0	3	0	2	5	0	0
10	5258914	.	T	A	5	7	12	0	1	13	0	0
10	5264458	.	G	A	7	5	12	0	0	12	0	0
10	5264534	.	C	A	6	6	12	0	0	12	0	0
10	5417480	.	A	G	0	2	2	0	0	2	0	0
10	5417669	.	T	A	5	4	9	0	0	9	0	0
10	5417841	.	A	C	2	3	5	0	1	6	0	0
10	5418509	.	A	G	9	7	16	0	0	16	0	0
10	5418569	.	C	T	7	4	11	0	0	11	0	0
10	5432576	.	T	C	2	0	2	0	0	2	0	0
10	5461988	.	C	A	6	4	10	0	0	10	0	0
10	5461994	.	T	A	6	4	10	0	1	11	0	0
10	5475406	.	A	T	4	3	7	0	0	7	0	0
10	5475436	.	A	G	9	4	13	0	1	14	0	0
10	5475526	.	T	C	3	3	6	0	0	6	0	0
10	5534369	.	T	A	6	4	10	0	0	10	0	0
10	5534483	.	T	C	5	3	8	0	0	8	0	0
10	5534487	.	C	T	0	3	3	0	5	8	0	0
10	5534527	.	G	T	7	5	12	0	0	12	0	0
10	5534539	.	G	A	6	5	11	0	1	12	0	0
10	5534611	.	C	T	3	8	11	0	0	11	0	0
10	5534612	.	A	G	3	8	11	0	0	11	0	0
10	5534646	.	A	G	6	5	11	0	0	11	0	0
10	5534878	.	C	T	9	11	20	0	1	21	0	0
10	5534946	.	A	G	9	8	17	0	0	17	0	0
10	5534950	.	A	T	8	7	15	0	2	17	0	0
10	5535359	.	A	T	6	8	14	0	0	14	0	0
10	5535368	.	T	A	6	9	15	0	0	15	0	0
10	5535436	.	C	T	5	5	10	0	0	10	0	0
10	5535445	.	T	C	6	6	12	0	1	13	0	0
10	5535483	.	A	T	9	12	21	0	0	21	0	0
10	5535540	.	T	G	7	12	19	0	1	20	0	0
10	5535561	.	T	A	8	5	13	0	0	13	0	0
10	5536240	.	T	C	1	4	5	0	1	6	0	0
10	5536256	.	G	A	2	5	7	0	0	7	0	0
10	5536294	.	A	C	1	2	3	0	1	4	0	0
10	5536534	.	T	A	3	4	7	0	1	8	0	0
10	5536831	.	G	T	1	3	4	0	0	4	0	0
10	5537048	.	G	T	6	3	9	0	0	9	0	0
10	5538302	.	T	G	4	7	11	0	1	12	0	0
10	5542152	.	T	C	2	5	7	0	1	8	0	0
10	5545438	.	C	T	2	4	6	0	0	6	0	0
10	5545465	.	T	C	4	7	11	0	1	12	0	0
10	5568128	.	G	T	7	5	12	0	0	12	0	0
10	5568155	.	T	G	10	2	12	0	1	13	0	0
10	5568212	.	G	A	6	2	8	0	0	8	0	0
10	5568319	.	A	C	7	5	12	0	0	12	0	0
10	5568329	.	A	G	6	3	9	0	1	10	0	0
10	5667439	.	A	T	1	3	4	0	0	4	0	0
10	5667467	.	T	A	0	4	4	0	0	4	0	0
10	5667504	.	G	A	1	2	3	0	0	3	0	0
10	5667813	.	T	A	3	2	5	0	0	5	0	0
10	5668103	.	C	T	2	9	11	0	1	12	0	0
10	5668135	.	G	A	3	8	11	0	0	11	0	0
10	5668218	.	G	C	6	7	13	0	1	14	0	0
10	5676520	.	T	A	2	4	6	0	0	6	0	0
10	5724020	.	T	C	1	0	1	0	0	1	0	0
10	5724095	.	T	C	2	4	6	0	0	6	0	0
10	5737757	.	G	A	9	0	9	0	1	10	0	0
10	5744934	.	C	T	3	2	5	0	0	5	0	0
10	5745015	.	C	A	22	12	34	0	0	34	0	0
10	5760455	.	T	C	15	14	29	0	0	29	0	0
10	5760461	.	A	G	16	13	29	0	0	29	0	0
10	5766958	.	A	G	6	8	14	0	0	14	0	0
10	5769541	.	G	T	3	3	6	0	0	6	0	0
10	5772568	.	A	G	4	10	14	0	0	14	0	0
10	5782337	.	C	T	1	0	1	0	0	1	0	0
10	5788755	.	A	C	2	11	13	0	2	15	0	0
10	5788806	.	G	A	3	12	15	0	0	15	0	0
10	5788877	.	G	A	4	3	7	0	0	7	0	0
10	5789415	.	A	G	3	3	6	0	2	8	0	0
10	5789417	.	G	C	4	4	8	0	0	8	0	0
10	5789905	.	T	A	3	4	7	0	2	9	0	0
10	5790080	.	A	G	5	9	14	0	0	14	0	0
10	5790097	.	G	A	5	4	9	0	0	9	0	0
10	5790210	.	C	T	4	12	16	2	0	18	0	0
10	5790278	.	G	T	7	10	17	0	0	17	0	0
10	5790570	.	A	C	8	3	11	0	0	11	0	0
10	5790640	.	T	G	4	5	9	0	0	9	0	0
10	5790866	.	A	C	7	8	15	0	0	15	0	0
10	5790913	.	A	C	5	4	9	0	0	9	0	0
10	5790922	.	C	A	5	6	11	0	0	11	0	0
10	5790956	.	C	G	0	8	8	0	11	19	0	0
10	5791030	.	A	G	11	5	16	0	1	17	0	0
10	5791044	.	C	T	0	4	4	0	12	16	0	0
10	5791184	.	G	A	4	8	12	0	0	12	0	0
10	5791224	.	C	G	7	6	13	0	0	13	0	0
10	5791238	.	A	G	5	5	10	0	0	10	0	0
10	5791377	.	A	T	9	7	16	0	0	16	0	0
10	5791387	.	G	A	9	6	15	0	0	15	0	0
10	5791417	.	C	T	0	8	8	0	9	17	0	0
10	5791454	.	T	A	16	3	19	0	0	19	0	0
10	5791459	.	C	A	14	3	17	0	1	18	0	0
10	5791743	.	A	T	4	4	8	0	0	8	0	0
10	5792007	.	A	G	15	5	20	0	0	20	0	0
10	5792512	.	A	T	5	11	16	0	0	16	0	0
10	5792533	.	A	T	5	4	9	0	0	9	0	0
10	5792573	.	G	A	3	2	5	0	0	5	0	0
10	5792584	.	A	G	4	2	6	0	0	6	0	0
10	5792667	.	G	A	2	6	8	0	0	8	0	0
10	5792722	.	T	C	5	1	6	0	6	12	0	0
10	5792757	.	A	G	6	10	16	0	0	16	0	0
10	5793197	.	G	A	3	3	6	0	0	6	0	0
10	5793568	.	T	A	2	2	4	0	0	4	0	0
10	5793827	.	A	C	1	4	5	0	0	5	0	0
10	5793863	.	A	G	2	2	4	0	1	5	0	0
10	5794423	.	C	G	4	10	14	0	0	14	0	0
10	5796929	.	C	T	0	1	1	0	1	2	0	0
10	5810895	.	A	G	1	0	1	0	0	1	0	0
10	5813696	.	A	G	1	4	5	0	0	5	0	0
10	5828639	.	C	T	5	9	14	0	0	14	0	0
10	5828645	.	A	G	5	8	13	0	1	14	0	0
10	5828704	.	C	A	1	7	8	0	11	19	0	0
10	5828840	.	A	G	3	8	11	0	0	11	0	0
10	5829041	.	A	G	5	12	17	0	1	18	0	0
10	5837337	.	G	A	0	1	1	0	0	1	0	0
10	6016242	.	G	A	3	3	6	0	0	6	0	0
10	6016545	.	G	T	3	4	7	0	0	7	0	0
10	6023750	.	A	G	1	1	2	0	0	2	0	0
10	6023946	.	T	C	2	2	4	0	2	6	0	0
10	6023958	.	G	A	0	3	3	0	1	4	0	0
10	6024248	.	G	C	0	1	1	0	0	1	0	0
10	6032880	.	A	G	2	0	2	0	7	9	0	0
10	6032886	.	G	A	2	7	9	0	0	9	0	0
10	6033469	.	A	C	2	2	4	0	0	4	0	0
10	6033612	.	G	A	0	8	8	0	5	13	0	0
10	6033627	.	A	T	4	9	13	0	0	13	0	0
10	6034194	.	A	T	5	3	8	0	0	8	0	0
10	6034362	.	G	A	0	2	2	0	1	3	0	0
10	6265475	.	A	G	1	3	4	0	0	4	0	0
10	6275517	.	G	A	1	2	3	0	1	4	0	0
10	6275577	.	C	T	4	5	9	0	0	9	0	0
10	6278202	.	A	G	2	1	3	0	0	3	0	0
10	6280939	.	G	A	0	3	3	0	2	5	0	0
10	6280948	.	G	A	0	3	3	0	3	6	0	0
10	6281946	.	A	G	3	0	3	0	2	5	0	0
10	6301930	.	C	T	3	5	8	0	0	8	0	0
10	6312954	.	A	T	6	8	14	0	0	14	0	0
10	6348571	.	C	A	6	4	10	0	0	10	0	0
10	6372501	.	C	T	9	9	18	0	1	19	0	0
10	6372915	.	G	A	6	5	11	0	0	11	0	0
10	6372964	.	T	C	6	9	15	0	1	16	0	0
10	6373003	.	T	C	5	5	10	0	0	10	0	0
10	6373079	.	C	G	3	5	8	0	0	8	0	0
10	6373332	.	A	T	8	4	12	0	0	12	0	0
10	6373336	.	C	G	8	4	12	0	0	12	0	0
10	6373378	.	A	C	4	5	9	0	0	9	0	0
10	6373472	.	T	A	6	4	10	0	0	10	0	0
10	6373758	.	A	C	14	4	18	0	0	18	0	0
10	6373794	.	A	G	8	6	14	0	0	14	0	0
10	6374017	.	A	G	5	13	18	0	0	18	0	0
10	6374041	.	A	T	4	14	18	0	2	21	1	0
10	6374068	.	G	T	11	10	21	0	1	22	0	0
10	6374235	.	T	C	10	10	20	0	0	20	0	0
10	6374279	.	G	A	0	18	18	0	11	29	0	0
10	6374352	.	C	T	22	10	32	0	0	32	0	0
10	6374372	.	A	G	16	16	32	0	2	34	0	0
10	6374501	.	A	G	7	8	15	0	1	16	0	0
10	6374557	.	A	G	11	10	21	0	0	21	0	0
10	6374573	.	A	T	12	10	22	0	0	23	1	0
10	6374597	.	A	G	12	11	23	0	1	24	0	0
10	6374615	.	T	C	15	8	23	0	0	23	0	0
10	6401765	.	T	C	1	2	3	0	0	3	0	0
10	6401834	.	G	A	2	2	4	0	0	4	0	0
10	6401884	.	T	A	2	2	4	0	0	4	0	0
10	6402213	.	T	A	3	3	6	0	0	6	0	0
10	6402694	.	T	A	2	3	5	0	1	6	0	0
10	6402742	.	C	G	2	2	4	0	0	4	0	0
10	6402882	.	C	A	0	3	3	0	0	3	0	0
10	6402993	.	A	G	1	0	1	0	0	1	0	0
10	6403019	.	A	T	1	1	2	0	0	2	0	0
10	6404031	.	C	T	3	2	5	0	0	5	0	0
10	6404035	.	A	T	3	2	5	0	0	5	0	0
10	6404764	.	G	C	1	2	3	0	1	4	0	0
10	6406142	.	T	A	2	3	5	0	0	5	0	0
10	6406635	.	C	T	3	2	5	0	0	5	0	0
10	6406677	.	A	G	2	4	6	0	0	6	0	0
10	6407346	.	A	G	1	4	5	0	0	5	0	0
10	6407408	.	T	C	1	4	5	0	0	5	0	0
10	6407449	.	C	T	2	3	5	0	0	5	0	0
10	6407475	.	G	A	0	4	4	0	3	7	0	0
10	6407559	.	A	T	2	9	11	0	0	11	0	0
10	6407833	.	T	C	10	5	15	0	1	16	0	0
10	6408986	.	A	G	9	4	13	0	0	13	0	0
10	6409095	.	G	A	0	5	5	0	3	8	0	0
10	6409120	.	G	A	5	4	9	0	0	9	0	0
10	6409145	.	G	C	5	2	7	0	1	8	0	0
10	6409379	.	A	G	7	6	13	0	0	13	0	0
10	6409448	.	C	T	8	5	13	0	0	13	0	0
10	6409455	.	T	A	5	7	12	0	0	12	0	0
10	6409506	.	A	G	8	5	13	0	0	13	0	0
10	6409583	.	C	T	3	3	6	0	1	7	0	0
10	6473544	.	T	C	14	8	22	0	0	22	0	0
10	6473685	.	T	C	9	10	19	0	0	19	0	0
10	6473704	.	C	G	10	10	20	0	0	20	0	0
10	6473851	.	A	G	10	11	21	0	0	21	0	0
10	6473862	.	C	T	0	9	9	0	14	23	0	0
10	6473908	.	A	G	14	5	19	0	1	20	0	0
10	6473996	.	T	C	10	8	18	0	0	18	0	0
10	6474057	.	T	A	3	4	7	0	0	7	0	0
10	6479444	.	T	C	8	1	9	0	11	20	0	0
10	6479471	.	C	T	0	6	6	0	5	11	0	0
10	6510756	.	T	C	10	13	23	0	1	24	0	0
10	6510786	.	T	G	24	21	45	0	1	46	0	0
10	6510825	.	T	C	14	9	23	0	2	25	0	0
10	6517593	.	T	A	30	27	57	0	1	58	0	0
10	6517663	.	A	G	24	0	24	0	20	44	0	0
10	6517726	.	C	T	18	17	35	0	0	35	0	0
10	6517959	.	A	G	23	14	37	0	1	38	0	0
10	6522267	.	A	T	4	6	10	0	0	10	0	0
10	6531002	.	A	G	1	2	3	0	0	3	0	0
10	6531297	.	T	C	3	4	7	0	0	7	0	0
10	6533850	.	T	A	2	7	9	0	1	10	0	0
10	6546851	.	A	G	0	1	1	0	0	1	0	0
10	6546929	.	C	A	0	3	3	0	3	6	0	0
10	6549360	.	C	T	3	5	8	0	0	8	0	0
10	6566670	.	C	T	0	2	2	0	1	3	0	0
10	6781278	.	T	A	7	8	15	0	0	15	0	0
10	6781286	.	G	T	8	7	15	0	0	15	0	0
10	6781362	.	G	A	8	7	15	0	1	16	0	0
10	6781372	.	T	A	10	10	20	0	2	22	0	0
10	6781450	.	T	C	12	10	22	0	4	26	0	0
10	6781506	.	A	T	9	10	19	0	1	20	0	0
10	6781664	.	A	T	8	14	22	0	0	22	0	0
10	6781742	.	G	T	3	14	17	0	0	17	0	0
10	6781786	.	A	T	9	3	12	0	0	12	0	0
10	6781867	.	C	A	4	8	12	0	1	14	1	0
10	6781903	.	T	G	7	10	17	0	0	17	0	0
10	6781918	.	A	T	5	11	16	0	1	17	0	0
10	6782020	.	G	C	10	9	19	0	0	19	0	0
10	6782036	.	T	C	11	0	11	0	6	17	0	0
10	6782163	.	T	C	12	5	17	0	0	17	0	0
10	6782220	.	A	G	3	2	5	0	0	5	0	0
10	6782267	.	T	A	2	6	8	3	0	11	0	0
10	6782279	.	A	C	2	7	9	3	0	13	1	0
10	6782454	.	C	G	8	15	23	0	1	24	0	0
10	6782489	.	T	G	6	16	22	0	1	23	0	0
10	6782636	.	T	A	11	32	43	0	1	44	0	0
10	6782664	.	A	G	13	32	45	0	0	45	0	0
10	6786326	.	C	T	1	2	3	0	1	4	0	0
10	6786564	.	A	G	14	14	28	0	0	28	0	0
10	6804756	.	T	C	6	0	6	0	8	14	0	0
10	6824761	.	A	C	3	3	6	0	1	7	0	0
10	6824845	.	A	T	7	7	14	0	1	15	0	0
10	6824877	.	T	G	4	4	8	0	0	8	0	0
10	6831446	.	T	C	4	2	6	0	0	6	0	0
10	6834065	.	A	T	3	3	6	0	0	6	0	0
10	6834341	.	G	A	7	11	18	0	0	18	0	0
10	6834380	.	C	A	0	11	11	0	4	15	0	0
10	6846904	.	A	G	2	0	2	0	0	2	0	0
10	6851184	.	C	A	4	2	6	0	0	6	0	0
10	6928025	.	T	C	2	0	2	0	0	2	0	0
10	6936471	.	G	A	0	3	3	0	0	3	0	0
10	7210001	.	G	A	0	14	14	0	10	24	0	0
10	7221810	.	A	G	9	7	16	0	0	16	0	0
10	7222213	.	T	C	11	9	20	0	0	20	0	0
10	7224964	.	A	G	3	3	6	0	0	6	0	0
10	7231728	.	T	C	26	19	45	0	1	46	0	0
10	7231821	.	T	A	23	22	45	0	0	45	0	0
10	7231964	.	G	C	26	15	41	0	2	43	0	0
10	7232043	.	T	A	20	16	36	0	0	36	0	0
10	7232058	.	G	T	1	16	17	0	21	38	0	0
10	7232104	.	A	T	25	12	37	0	1	38	0	0
10	7232309	.	C	T	9	8	17	0	0	17	0	0
10	7232416	.	T	C	19	13	32	0	3	35	0	0
10	7232420	.	T	C	19	12	31	0	1	32	0	0
10	7233038	.	T	C	28	16	44	0	3	47	0	0
10	7233218	.	A	G	36	15	51	0	4	55	0	0
10	7233440	.	A	T	33	28	61	0	2	63	0	0
10	7233457	.	C	G	28	29	57	0	3	60	0	0
10	7233518	.	T	C	22	27	49	0	2	51	0	0
10	7233854	.	A	T	14	24	38	0	3	41	0	0
10	7233939	.	C	T	4	2	6	0	0	6	0	0
10	7284182	.	T	A	7	9	16	0	0	16	0	0
10	7284403	.	C	T	5	7	12	0	0	12	0	0
10	7284520	.	A	G	7	3	10	0	1	11	0	0
10	7284556	.	T	A	8	5	13	1	0	14	0	0
10	7284629	.	T	C	11	4	15	0	0	15	0	0
10	7311997	.	T	G	2	0	2	0	0	2	0	0
10	7312057	.	A	G	7	5	12	0	0	12	0	0
10	7483649	.	G	C	3	0	3	0	2	5	0	0
10	7483671	.	A	G	3	3	6	0	0	6	0	0
10	7483708	.	T	A	5	2	7	0	0	7	0	0
10	7564294	.	C	T	5	8	13	0	6	19	0	0
10	7593246	.	A	T	8	13	21	0	1	22	0	0
10	7593349	.	C	A	8	21	29	0	0	29	0	0
10	7617113	.	A	T	29	30	59	0	2	61	0	0
10	7617126	.	T	C	27	31	58	0	2	60	0	0
10	7617242	.	G	A	30	29	59	0	2	61	0	0
10	7617327	.	A	C	19	22	41	0	10	51	0	0
10	7617350	.	A	T	20	30	50	0	12	62	0	0
10	7617636	.	A	G	23	1	24	0	19	43	0	0
10	7624140	.	T	C	7	0	7	0	3	10	0	0
10	7624174	.	T	C	5	0	5	0	3	8	0	0
10	7635245	.	C	T	1	1	2	0	0	2	0	0
10	7640501	.	C	T	2	1	3	0	0	3	0	0
10	7640676	.	G	A	17	19	36	0	0	36	0	0
10	7653581	.	C	G	0	2	2	0	1	3	0	0
10	7653750	.	T	C	0	0	0	0	2	2	0	0
10	7671368	.	T	C	7	8	15	0	0	15	0	0
10	7671425	.	G	A	9	7	16	0	0	16	0	0
10	7672832	.	A	C	3	1	4	0	2	6	0	0
10	7672853	.	G	A	9	4	13	0	0	13	0	0
10	7673819	.	C	G	9	7	16	0	0	16	0	0
10	7673849	.	A	G	6	4	10	0	0	10	0	0
10	7674079	.	T	G	5	4	9	0	0	9	0	0
10	7674136	.	C	T	4	3	7	0	2	9	0	0
10	7674393	.	C	T	0	3	3	0	0	3	0	0
10	7674429	.	C	T	1	3	4	0	0	4	0	0
10	7674471	.	A	G	2	2	4	0	0	4	0	0
10	7674506	.	A	G	9	5	14	0	0	14	0	0
10	7678121	.	T	C	2	0	2	0	0	2	0	0
10	7678154	.	C	T	0	2	2	0	6	8	0	0
10	7696900	.	G	A	0	1	1	0	0	1	0	0
10	7700564	.	T	G	6	4	10	0	0	10	0	0
10	7700615	.	A	G	8	5	13	0	1	14	0	0
10	7700676	.	G	A	1	2	3	0	0	3	0	0
10	7701852	.	A	C	1	0	1	0	1	2	0	0
10	7704413	.	A	G	0	3	3	0	0	3	0	0
10	7704436	.	G	A	0	5	5	0	0	5	0	0
10	7704484	.	C	A	1	3	4	0	0	4	0	0
10	7704490	.	G	A	1	3	4	0	0	4	0	0
10	7704548	.	C	T	0	2	2	0	0	2	0	0
10	7705560	.	G	A	0	5	5	0	5	10	0	0
10	7709761	.	T	C	2	7	9	0	0	9	0	0
10	7709975	.	A	G	2	8	10	0	1	11	0	0
10	7709978	.	T	C	2	7	9	0	2	11	0	0
10	7712206	.	G	A	1	8	9	0	0	9	0	0
10	7712228	.	C	T	1	3	4	0	0	4	0	0
10	7713924	.	A	G	1	0	1	0	2	3	0	0
10	7721459	.	A	G	8	5	13	0	3	16	0	0
10	7721746	.	G	A	3	8	11	0	0	11	0	0
10	7722595	.	A	G	2	10	12	0	0	12	0	0
10	7722936	.	C	T	2	3	5	0	1	6	0	0
10	7723004	.	T	C	6	7	13	0	0	13	0	0
10	7723061	.	C	A	4	7	11	0	0	11	0	0
10	7723157	.	A	G	7	17	24	0	0	24	0	0
10	7723218	.	T	C	5	15	20	0	0	20	0	0
10	7723275	.	C	A	12	10	22	0	1	23	0	0
10	7723337	.	C	G	6	9	15	0	0	15	0	0
10	7727505	.	T	A	0	2	2	0	0	2	0	0
10	7727598	.	A	T	5	4	9	0	0	9	0	0
10	7727704	.	T	A	3	0	3	0	0	3	0	0
10	7734316	.	T	G	0	1	1	0	0	1	0	0
10	7734401	.	G	A	4	5	9	0	0	9	0	0
10	7734465	.	C	T	5	5	10	0	1	11	0	0
10	7739208	.	G	A	1	2	3	0	0	3	0	0
10	7771039	.	G	A	4	2	6	0	0	6	0	0
10	7771735	.	A	C	3	4	7	0	0	7	0	0
10	7771769	.	C	T	3	2	5	0	2	7	0	0
10	7771778	.	G	A	4	3	7	0	0	7	0	0
10	7772012	.	T	G	5	4	9	0	0	9	0	0
10	7772272	.	C	T	5	4	9	0	0	9	0	0
10	7810461	.	A	T	20	26	46	0	2	48	0	0
10	7810565	.	G	A	19	16	35	0	0	35	0	0
10	7811062	.	T	A	4	12	16	0	0	16	0	0
10	7811075	.	T	C	4	9	13	0	1	14	0	0
10	7811935	.	A	G	12	18	30	0	0	30	0	0
10	7815118	.	G	A	9	11	20	0	0	20	0	0
10	7815187	.	G	A	3	3	6	0	0	6	0	0
10	7831879	.	C	T	2	3	5	0	0	5	0	0
10	7843465	.	A	G	0	1	1	0	0	1	0	0
10	7901065	.	T	G	2	6	8	0	0	8	0	0
10	7901261	.	G	C	3	3	6	0	2	8	0	0
10	7901271	.	G	A	5	3	8	0	0	8	0	0
10	7901666	.	A	T	4	2	6	0	0	6	0	0
10	7909269	.	C	A	1	6	7	0	0	7	0	0
10	7916836	.	A	C	8	10	18	0	0	18	0	0
10	7916930	.	C	A	13	7	20	0	0	20	0	0
10	7917036	.	A	T	7	12	19	0	1	20	0	0
10	7917114	.	T	C	15	8	23	0	0	23	0	0
10	7917411	.	C	A	1	12	13	0	10	23	0	0
10	7917483	.	C	A	12	6	18	0	1	19	0	0
10	7917551	.	A	G	16	7	23	0	0	23	0	0
10	7917592	.	T	C	17	13	30	0	2	32	0	0
10	7917686	.	T	C	14	21	35	0	2	37	0	0
10	7917690	.	A	T	16	19	35	0	1	36	0	0
10	7920910	.	T	G	17	16	33	0	2	35	0	0
10	7920913	.	C	T	17	15	32	0	2	34	0	0
10	7922210	.	G	T	5	9	14	0	0	14	0	0
10	7922294	.	C	A	8	10	18	0	0	18	0	0
10	7926899	.	A	G	1	3	4	0	0	4	0	0
10	7929647	.	T	C	7	0	7	0	5	12	0	0
10	7936283	.	T	G	13	14	27	0	1	28	0	0
10	7938629	.	C	T	6	5	11	0	2	13	0	0
10	7938659	.	A	G	7	11	18	0	1	19	0	0
10	7938683	.	T	C	9	10	19	0	0	19	0	0
10	7959655	.	T	A	0	2	2	0	0	2	0	0
10	7968160	.	G	T	2	1	3	0	0	3	0	0
10	7968274	.	G	T	7	6	13	0	0	13	0	0
10	7984677	.	A	T	2	1	3	0	0	3	0	0
10	7986217	.	T	C	10	14	24	0	1	25	0	0
10	7986307	.	C	T	0	1	1	0	0	1	0	0
10	7989000	.	C	T	1	4	5	0	1	6	0	0
10	7989162	.	T	G	3	7	10	0	0	10	0	0
10	7989237	.	G	A	5	8	13	0	0	13	0	0
10	7989287	.	G	A	8	13	21	0	0	21	0	0
10	7989348	.	C	T	9	9	18	0	1	19	0	0
10	7989576	.	C	T	4	5	9	0	0	9	0	0
10	7992197	.	T	C	10	11	21	0	1	22	0	0
10	7996021	.	G	A	0	1	1	0	0	1	0	0
10	8001365	.	A	G	4	2	6	0	0	6	0	0
10	8005785	.	T	A	3	6	9	0	0	9	0	0
10	8009996	.	A	C	3	4	7	0	0	7	0	0
10	8010064	.	A	G	0	1	1	0	0	1	0	0
10	8033234	.	T	C	1	3	4	0	0	4	0	0
10	8033259	.	C	T	1	5	6	0	0	6	0	0
10	8034846	.	A	G	4	2	6	0	0	6	0	0
10	8036799	.	T	C	2	0	2	0	3	5	0	0
10	8037156	.	A	G	1	2	3	0	0	3	0	0
10	8037519	.	G	T	4	2	6	0	0	6	0	0
10	8040536	.	T	C	0	1	1	0	0	1	0	0
10	8041837	.	C	A	2	3	5	0	0	5	0	0
10	8041863	.	C	G	2	4	6	0	0	6	0	0
10	8091212	.	G	A	4	8	12	0	1	13	0	0
10	8097929	.	C	G	15	11	26	0	0	26	0	0
10	8160813	.	T	G	4	3	7	0	0	7	0	0
10	8160888	.	G	A	4	4	8	0	1	9	0	0
10	8160891	.	T	C	4	0	4	0	5	9	0	0
10	8161027	.	A	G	3	3	6	0	0	6	0	0
10	8161028	.	G	A	3	3	6	0	0	6	0	0
10	8174712	.	A	C	1	0	1	0	2	3	0	0
10	8175123	.	T	C	3	4	7	0	0	7	0	0
10	8177559	.	C	T	0	2	2	0	3	5	0	0
10	8177748	.	A	G	1	2	3	0	0	3	0	0
10	8188503	.	G	A	1	1	2	0	0	2	0	0
10	8190589	.	T	C	1	1	2	0	0	2	0	0
10	8194893	.	G	A	3	1	4	0	0	4	0	0
10	8202517	.	C	T	3	2	5	0	0	5	0	0
10	8202523	.	C	T	4	2	6	0	0	6	0	0
10	8208610	.	G	A	1	2	3	0	0	3	0	0
10	8228235	.	T	C	1	2	3	0	0	3	0	0
10	8233255	.	C	T	1	1	2	0	1	3	0	0
10	8233267	.	C	T	1	2	3	0	0	3	0	0
10	8235946	.	A	G	0	0	0	0	1	1	0	0
10	8236048	.	T	C	4	1	5	0	0	5	0	0
10	8265917	.	A	T	4	6	10	0	0	10	0	0
10	8265922	.	T	C	4	6	10	0	1	11	0	0
10	8265968	.	C	T	4	4	8	0	0	8	0	0
10	8265970	.	G	A	3	4	7	0	1	8	0	0
10	8266248	.	C	T	1	19	20	0	15	35	0	0
10	8266383	.	A	G	12	19	31	0	2	33	0	0
10	8269224	.	G	A	6	10	16	0	0	16	0	0
10	8269377	.	G	A	4	2	6	0	0	6	0	0
10	8269515	.	T	C	0	3	3	0	1	4	0	0
10	8278160	.	T	C	7	9	16	0	2	18	0	0
10	8278214	.	A	G	5	12	17	0	1	18	0	0
10	8282705	.	T	A	4	1	5	0	1	6	0	0
10	8295026	.	C	T	0	4	4	0	9	13	0	0
10	8295196	.	T	G	6	6	12	0	0	12	0	0
10	8295295	.	C	A	0	6	6	0	8	14	0	0
10	8335312	.	C	T	2	1	3	0	0	3	0	0
10	8335315	.	T	C	2	1	3	0	0	3	0	0
10	8335402	.	A	G	3	5	8	0	0	8	0	0
10	8358022	.	C	T	1	3	4	0	0	4	0	0
10	8427869	.	C	T	0	0	0	0	1	1	0	0
10	8434448	.	G	T	0	0	0	0	1	1	0	0
10	8450742	.	G	T	0	2	2	0	1	3	0	0
10	8466538	.	T	C	1	1	2	0	0	2	0	0
10	8466562	.	G	A	3	1	4	0	0	4	0	0
10	8629373	.	T	C	5	3	8	0	0	8	0	0
10	8629496	.	T	C	5	3	8	0	0	8	0	0
10	8630102	.	C	T	9	11	20	0	1	21	0	0
10	8630428	.	A	G	11	15	26	0	2	28	0	0
10	8630527	.	G	A	6	15	21	0	0	21	0	0
10	8630585	.	A	G	5	0	5	0	6	11	0	0
10	8630631	.	T	C	4	8	12	0	0	12	0	0
10	8630690	.	G	A	7	5	12	0	0	12	0	0
10	8630702	.	T	C	8	4	12	0	1	13	0	0
10	8630808	.	G	A	6	6	12	0	1	13	0	0
10	8631103	.	G	A	0	5	5	0	6	11	0	0
10	8631135	.	A	G	9	7	16	0	0	16	0	0
10	8631201	.	A	G	10	4	14	0	1	15	0	0
10	8670121	.	A	C	6	9	15	0	2	17	0	0
10	8670139	.	G	A	4	5	9	0	0	9	0	0
10	8672510	.	A	G	12	10	22	0	0	22	0	0
10	8672519	.	T	C	11	10	21	0	1	22	0	0
10	8672672	.	C	G	14	12	26	0	0	26	0	0
10	8672707	.	A	T	16	15	31	0	1	32	0	0
10	8684874	.	T	C	3	2	5	0	0	5	0	0
10	8684875	.	G	A	3	1	4	0	1	5	0	0
10	8686965	.	T	A	2	2	4	0	0	4	0	0
10	8829791	.	T	C	1	0	1	0	0	1	0	0
10	8840343	.	A	G	0	1	1	0	0	1	0	0
10	8950022	.	T	C	1	0	1	0	2	3	0	0
10	8952018	.	T	C	2	0	2	0	5	7	0	0
10	8952019	.	A	G	2	5	7	0	0	7	0	0
10	8952601	.	A	G	2	4	6	0	0	6	0	0
10	8968250	.	G	C	2	2	4	0	0	4	0	0
10	8969130	.	T	C	1	2	3	0	1	4	0	0
10	8970802	.	T	C	0	1	1	0	0	1	0	0
10	8974771	.	C	T	4	2	6	0	0	6	0	0
10	8976450	.	T	C	0	3	3	0	0	3	0	0
10	9006634	.	T	C	8	8	16	0	1	17	0	0
10	9159424	.	T	A	3	2	5	0	0	5	0	0
10	9169479	.	C	T	6	6	12	0	0	12	0	0
10	9169613	.	C	T	1	1	2	0	0	2	0	0
10	9184326	.	T	A	6	6	12	0	0	12	0	0
10	9184327	.	A	C	6	6	12	0	0	12	0	0
10	9184533	.	C	T	6	6	12	0	0	12	0	0
10	9222601	.	A	T	1	0	1	0	0	1	0	0
10	9229570	.	C	T	1	2	3	0	0	3	0	0
10	9234032	.	G	A	2	5	7	0	0	7	0	0
10	9234056	.	T	A	2	5	7	0	1	8	0	0
10	9234145	.	C	T	1	4	5	0	0	5	0	0
10	9234153	.	T	G	1	4	5	0	0	5	0	0
10	9234279	.	G	C	2	2	4	0	0	4	0	0
10	9234529	.	G	A	1	5	6	0	0	6	0	0
10	9234626	.	T	G	3	5	8	0	0	8	0	0
10	9234742	.	G	A	0	5	5	0	8	13	0	0
10	9248052	.	G	A	6	2	8	0	0	8	0	0
10	9305305	.	C	T	5	5	10	0	0	10	0	0
10	9305433	.	A	G	12	6	18	0	0	18	0	0
10	9305465	.	T	C	9	0	9	0	6	15	0	0
10	9308133	.	G	A	3	0	3	0	0	3	0	0
10	9347928	.	C	G	2	0	2	0	4	6	0	0
10	9361037	.	C	T	2	4	6	0	2	8	0	0
10	9361891	.	G	A	2	1	3	0	0	3	0	0
10	9361924	.	G	C	1	1	2	0	0	2	0	0
10	9370210	.	T	A	8	4	12	0	0	12	0	0
10	9390746	.	T	C	4	5	9	0	0	9	0	0
10	9390767	.	T	C	5	4	9	0	0	9	0	0
10	9394247	.	A	C	2	2	4	0	1	5	0	0
10	9394918	.	G	C	4	4	8	0	0	8	0	0
10	9395012	.	C	T	3	4	7	0	0	7	0	0
10	9601542	.	T	C	0	1	1	0	0	1	0	0
10	9601620	.	T	C	2	2	4	0	0	4	0	0
10	9610388	.	A	C	2	1	3	0	1	4	0	0
10	9618313	.	T	G	3	2	5	0	0	5	0	0
10	9618348	.	A	C	1	1	2	0	0	2	0	0
10	9626934	.	A	T	3	2	5	0	0	5	0	0
10	9628988	.	A	G	2	1	3	0	0	3	0	0
10	9629193	.	G	A	0	3	3	0	6	9	0	0
10	9629268	.	G	T	0	3	3	0	2	5	0	0
10	9629301	.	A	G	1	0	1	0	1	2	0	0
10	9629314	.	A	G	1	1	2	0	0	2	0	0
10	9632265	.	G	A	0	0	0	0	7	7	0	0
10	9632336	.	A	G	2	0	2	0	4	6	0	0
10	9642674	.	T	A	1	1	2	0	0	2	0	0
10	9642717	.	T	C	3	3	6	0	0	6	0	0
10	9644669	.	T	C	3	3	6	0	0	6	0	0
10	9701905	.	C	T	7	5	12	0	0	12	0	0
10	9704514	.	A	T	4	2	6	0	0	6	0	0
10	9714771	.	T	C	7	2	9	0	0	9	0	0
10	9714819	.	A	G	7	8	15	0	0	15	0	0
10	9771749	.	G	T	0	1	1	0	0	1	0	0
10	9781509	.	G	A	5	5	10	0	1	11	0	0
10	9784087	.	C	T	7	6	13	0	0	13	0	0
10	9802771	.	T	C	16	12	28	0	1	29	0	0
10	9806731	.	A	G	16	1	17	0	16	33	0	0
10	9807014	.	T	G	11	20	31	0	0	31	0	0
10	9807203	.	G	A	19	18	37	0	1	38	0	0
10	9836809	.	G	T	1	2	3	0	0	3	0	0
10	9837024	.	G	T	2	2	4	0	1	5	0	0
10	9837027	.	T	C	3	2	5	0	0	5	0	0
10	9837100	.	T	C	6	3	9	0	0	9	0	0
10	9846240	.	A	G	5	4	9	0	0	9	0	0
10	9846261	.	G	A	8	6	14	0	0	14	0	0
10	9856390	.	T	C	4	0	4	0	8	13	1	0
10	9856416	.	A	G	3	2	5	0	1	6	0	0
10	9895348	.	G	A	5	9	14	0	0	14	0	0
10	9899302	.	G	A	3	3	6	0	0	6	0	0
10	10210583	.	C	T	3	6	9	0	0	9	0	0
10	10254606	.	C	T	4	2	6	0	0	6	0	0
10	10254730	.	C	T	12	7	19	0	0	19	0	0
10	10254751	.	A	C	8	8	16	0	0	16	0	0
10	10254787	.	A	G	6	1	7	0	10	17	0	0
10	10254922	.	A	G	1	6	7	0	1	8	0	0
10	10261887	.	G	C	8	3	11	0	0	11	0	0
10	10261893	.	C	A	8	3	11	0	0	11	0	0
10	10262013	.	T	C	7	7	14	0	1	15	0	0
10	10262157	.	A	G	3	5	8	0	0	8	0	0
10	10269930	.	T	C	4	3	7	0	1	8	0	0
10	10325451	.	T	C	7	5	12	0	0	12	0	0
10	10325493	.	G	A	0	4	4	0	10	14	0	0
10	10561657	.	G	T	2	2	4	0	0	4	0	0
10	10567262	.	A	G	2	0	2	0	0	2	0	0
10	10636896	.	G	A	0	10	10	0	6	16	0	0
10	10636946	.	A	G	9	9	18	0	0	18	0	0
10	10729097	.	C	A	1	2	3	0	0	3	0	0
10	10747735	.	C	G	1	2	3	0	0	3	0	0
10	10758410	.	G	A	0	1	1	0	0	1	0	0
10	10764601	.	T	C	1	4	5	0	0	5	0	0
10	10775374	.	A	T	1	2	3	0	0	3	0	0
10	10780483	.	T	C	1	1	2	0	0	2	0	0
10	10782513	.	G	A	11	11	22	0	1	23	0	0
10	10861011	.	A	G	2	2	4	0	1	5	0	0
10	10861504	.	G	A	5	3	8	0	0	8	0	0
10	10862232	.	C	G	3	4	7	0	0	7	0	0
10	10880215	.	A	T	1	2	3	0	0	3	0	0
10	10880611	.	A	T	0	2	2	0	0	2	0	0
10	10880628	.	G	A	0	1	1	0	2	3	0	0
10	10880791	.	T	A	1	3	4	0	0	4	0	0
10	10880815	.	A	G	1	4	5	0	0	5	0	0
10	10880847	.	C	G	1	3	4	0	1	5	0	0
10	10930143	.	G	A	6	2	8	0	0	8	0	0
10	10930188	.	G	A	1	2	3	0	0	3	0	0
10	10935396	.	C	T	1	1	2	0	0	2	0	0
10	10935432	.	C	T	4	2	6	0	0	6	0	0
10	10935661	.	G	A	2	2	4	0	0	4	0	0
10	10935974	.	C	T	0	2	2	0	1	3	0	0
10	10938668	.	C	A	1	1	2	0	0	2	0	0
10	10987263	.	T	C	3	2	5	0	0	5	0	0
10	10997286	.	A	G	5	5	10	0	1	11	0	0
10	10997618	.	C	T	5	3	8	0	0	8	0	0
10	10997671	.	T	G	7	1	8	0	3	11	0	0
10	10997711	.	T	C	7	4	11	0	1	12	0	0
10	11001202	.	C	T	1	3	4	0	0	4	0	0
10	11001608	.	T	C	2	3	5	0	0	5	0	0
10	11001867	.	A	G	2	5	7	0	0	7	0	0
10	11001883	.	T	A	1	7	8	0	0	8	0	0
10	11001967	.	T	G	3	5	8	0	0	8	0	0
10	11001968	.	A	G	3	5	8	0	0	8	0	0
10	11002005	.	T	A	1	5	6	0	1	7	0	0
10	11003904	.	G	T	0	2	2	0	1	3	0	0
10	11003911	.	G	A	0	3	3	0	0	3	0	0
10	11009969	.	C	T	3	0	3	0	1	4	0	0
10	11009975	.	A	G	4	0	4	0	0	4	0	0
10	11146361	.	A	T	3	5	8	0	0	8	0	0
10	11146445	.	A	G	4	5	9	0	0	9	0	0
10	11146585	.	A	T	5	2	7	0	1	8	0	0
10	11166798	.	G	A	2	2	4	0	0	4	0	0
10	11174413	.	G	A	3	3	6	0	0	6	0	0
10	11183242	.	A	G	5	5	10	0	0	10	0	0
10	11265395	.	G	C	0	4	4	0	0	4	0	0
10	11267530	.	C	A	1	2	3	0	0	3	0	0
10	11282119	.	A	G	2	3	5	0	0	5	0	0
10	11282194	.	A	G	4	3	7	0	0	7	0	0
10	11282460	.	G	A	2	2	4	0	0	4	0	0
10	11286830	.	C	T	9	7	16	0	1	17	0	0
10	11287343	.	A	G	6	1	7	0	5	12	0	0
10	11298852	.	G	A	2	6	8	0	0	8	0	0
10	11298864	.	A	G	2	6	8	0	1	9	0	0
10	11298955	.	T	C	2	10	12	0	0	12	0	0
10	11309859	.	C	G	3	0	3	0	2	5	0	0
10	11310041	.	G	A	1	5	6	0	0	6	0	0
10	11310500	.	G	A	6	3	9	0	0	9	0	0
10	11310501	.	C	A	6	3	9	0	0	9	0	0
10	11310618	.	A	C	2	4	6	0	1	7	0	0
10	11310648	.	G	A	4	3	7	0	0	7	0	0
10	11310682	.	G	A	3	4	7	0	0	7	0	0
10	11311832	.	C	T	2	2	4	0	0	4	0	0
10	11322985	.	T	C	3	2	5	0	0	5	0	0
10	11323032	.	G	A	4	8	12	0	0	12	0	0
10	11325145	.	A	G	3	3	6	0	0	6	0	0
10	11327406	.	T	A	2	2	4	0	0	4	0	0
10	11327444	.	G	T	2	5	7	0	1	8	0	0
10	11327449	.	A	T	2	4	6	0	1	7	0	0
10	11327604	.	T	C	7	5	12	0	0	12	0	0
10	11327657	.	C	T	5	5	10	0	0	10	0	0
10	11327674	.	G	A	3	6	9	0	1	10	0	0
10	11331922	.	C	T	0	4	4	0	9	13	0	0
10	11334547	.	A	G	1	3	4	0	0	4	0	0
10	11339235	.	G	A	7	6	13	0	1	14	0	0
10	11339319	.	C	T	0	1	1	0	5	6	0	0
10	11347906	.	G	T	6	6	12	0	1	13	0	0
10	11347909	.	A	G	5	7	12	0	1	13	0	0
10	11347961	.	G	T	4	6	10	0	0	10	0	0
10	11348147	.	C	T	0	1	1	0	1	2	0	0
10	11362275	.	C	T	18	19	37	0	1	38	0	0
10	11398168	.	T	G	7	0	7	0	4	11	0	0
10	11399574	.	C	T	1	2	3	0	0	3	0	0
10	11403954	.	T	C	3	1	4	0	3	7	0	0
10	11501181	.	C	A	5	4	9	0	1	10	0	0
10	11773751	.	T	C	2	9	11	0	0	11	0	0
10	11779259	.	G	A	2	2	4	0	0	4	0	0
10	11790947	.	T	C	13	7	20	0	0	20	0	0
10	11805601	.	T	C	3	8	11	0	0	11	0	0
10	11809444	.	A	G	5	5	10	0	2	12	0	0
10	11838927	.	C	T	0	6	6	0	1	7	0	0
10	12556390	.	C	T	2	3	5	0	0	5	0	0
10	12616330	.	T	G	1	5	6	0	0	6	0	0
10	12720969	.	C	T	1	0	1	0	0	1	0	0
10	13038022	.	T	C	1	3	4	0	0	4	0	0
10	13038025	.	A	C	1	3	4	0	0	4	0	0
10	13063476	.	T	G	1	1	2	0	0	2	0	0
10	13063542	.	G	T	5	2	7	0	0	7	0	0
10	13063611	.	A	T	2	4	6	0	0	6	0	0
10	13063921	.	C	T	1	8	9	0	0	9	0	0
10	13238028	.	A	G	5	10	15	0	0	15	0	0
10	13238055	.	G	T	4	11	15	0	0	15	0	0
10	13283594	.	C	T	6	5	11	0	0	11	0	0
10	13283729	.	C	T	6	2	8	0	0	8	0	0
10	13283741	.	G	A	0	3	3	0	5	8	0	0
10	13283792	.	T	C	2	5	7	0	0	7	0	0
10	13283891	.	G	A	0	5	5	0	3	8	0	0
10	13286430	.	C	T	7	9	16	0	0	16	0	0
10	13286472	.	T	C	9	8	17	0	0	17	0	0
10	13286677	.	A	G	4	6	10	0	2	12	0	0
10	13286951	.	C	G	3	2	5	0	0	5	0	0
10	13287133	.	C	T	1	6	7	0	0	7	0	0
10	13460494	.	A	C	8	4	12	0	0	12	0	0
10	13460671	.	G	A	11	12	23	0	1	24	0	0
10	13460745	.	C	A	0	15	15	0	14	29	0	0
10	13460940	.	A	T	15	20	35	0	2	37	0	0
10	13461080	.	T	C	22	0	22	0	16	38	0	0
10	13461150	.	G	A	7	15	22	0	1	23	0	0
10	13476010	.	A	G	7	14	21	0	0	21	0	0
10	13529270	.	T	C	19	11	30	0	3	33	0	0
10	13536790	.	T	C	6	0	6	0	6	12	0	0
10	14470434	.	C	T	0	2	2	0	0	2	0	0
10	14478899	.	A	G	0	2	2	0	0	2	0	0
10	14488177	.	C	A	3	3	6	0	0	6	0	0
10	14488213	.	T	C	3	4	7	0	0	7	0	0
10	14491139	.	C	T	2	5	7	0	1	8	0	0
10	14493798	.	T	C	7	17	24	0	0	24	0	0
10	14493819	.	A	T	5	8	13	0	0	13	0	0
10	14493878	.	G	T	0	10	10	0	10	21	1	0
10	14493967	.	G	C	1	7	8	0	20	28	0	0
10	14533337	.	G	A	6	7	13	0	1	14	0	0
10	14533352	.	A	G	7	8	15	0	0	15	0	0
10	14542886	.	A	G	9	9	18	0	2	20	0	0
10	14542962	.	G	A	5	7	12	0	0	12	0	0
10	14543044	.	A	T	13	8	21	0	2	23	0	0
10	14543256	.	A	C	9	8	17	0	0	17	0	0
10	14543259	.	G	T	9	7	16	0	1	17	0	0
10	14543307	.	C	T	14	11	25	0	1	26	0	0
10	14545572	.	A	G	13	14	27	0	0	27	0	0
10	14556379	.	G	A	2	4	6	0	0	6	0	0
10	14556592	.	A	G	2	2	4	0	0	4	0	0
10	14871409	.	T	A	9	12	21	2	0	23	0	0
10	14871412	.	T	A	9	10	19	2	0	21	0	0
10	14871768	.	A	G	18	16	34	0	1	35	0	0
10	14871801	.	A	C	18	16	34	0	0	34	0	0
10	14872258	.	T	G	1	6	7	0	0	7	0	0
10	14872703	.	G	A	9	12	21	1	0	22	0	0
10	14920777	.	G	A	2	2	4	0	2	6	0	0
10	14921086	.	A	C	16	0	16	0	17	33	0	0
10	14929560	.	G	A	13	14	27	0	1	28	0	0
10	16061731	.	T	C	6	0	6	0	3	9	0	0
10	16061755	.	T	C	6	2	8	0	0	8	0	0
10	16476487	.	T	C	2	4	6	0	1	7	0	0
10	16476520	.	T	C	2	3	5	0	0	5	0	0
10	17013282	.	C	T	1	1	2	0	0	2	0	0
10	17553004	.	C	T	7	2	9	0	0	9	0	0
10	17876862	.	A	G	12	0	12	0	17	29	0	0
10	17890850	.	G	A	2	3	5	0	0	5	0	0
10	17911220	.	C	T	1	1	2	0	0	2	0	0
10	17913424	.	A	C	8	8	16	0	1	17	0	0
10	17922444	.	A	G	16	15	31	0	0	31	0	0
10	17922540	.	A	T	15	13	28	0	4	32	0	0
10	17922582	.	C	T	17	12	29	0	1	30	0	0
10	17922651	.	G	C	9	15	24	0	0	24	0	0
10	17922718	.	C	T	18	7	25	0	1	26	0	0
10	17922807	.	A	G	14	0	14	0	16	30	0	0
10	17922894	.	T	G	11	10	21	0	0	21	0	0
10	17922955	.	A	T	8	5	13	0	0	13	0	0
10	17922973	.	T	C	11	3	14	0	0	14	0	0
10	17923490	.	A	T	10	8	18	0	1	19	0	0
10	17923867	.	A	C	0	4	4	0	0	4	0	0
10	17923912	.	T	A	0	3	3	0	0	3	0	0
10	17924341	.	A	G	1	4	5	0	0	5	0	0
10	17924740	.	T	G	18	15	33	0	0	33	0	0
10	17924779	.	G	A	13	14	27	0	3	30	0	0
10	17924836	.	T	A	9	11	20	0	3	23	0	0
10	17925146	.	T	C	16	14	30	0	1	31	0	0
10	17925301	.	T	A	4	13	17	0	0	17	0	0
10	17925302	.	G	T	4	13	17	0	0	17	0	0
10	17940303	.	G	A	0	2	2	0	15	17	0	0
10	17940352	.	G	A	31	10	41	0	1	42	0	0
10	17940356	.	A	G	31	11	42	0	2	44	0	0
10	17943696	.	G	A	4	1	5	0	0	5	0	0
10	17943714	.	T	C	8	9	17	0	1	18	0	0
10	17944017	.	C	T	7	5	12	0	0	12	0	0
10	17945447	.	A	G	24	19	43	0	2	45	0	0
10	17945522	.	C	T	17	15	32	1	0	33	0	0
10	17945581	.	G	T	24	20	44	0	1	45	0	0
10	17945629	.	T	C	31	22	53	0	2	55	0	0
10	17945725	.	A	G	22	22	44	0	0	44	0	0
10	17945738	.	T	A	21	16	37	0	0	37	0	0
10	17945779	.	T	A	16	4	20	0	0	20	0	0
10	17946030	.	A	T	7	4	11	0	0	11	0	0
10	18877441	.	C	A	1	2	3	0	0	3	0	0
10	18877465	.	A	T	2	2	4	0	0	4	0	0
10	18887816	.	C	T	1	2	3	0	0	3	0	0
10	18896228	.	A	C	8	9	17	0	0	17	0	0
10	18911166	.	A	G	4	2	6	0	1	7	0	0
10	18924407	.	C	G	5	14	19	0	1	20	0	0
10	18930403	.	T	C	5	2	7	0	1	8	0	0
10	18934119	.	A	T	8	6	14	0	2	16	0	0
10	18934291	.	T	C	5	6	11	0	1	12	0	0
10	18934393	.	T	G	9	0	9	0	9	18	0	0
10	18934409	.	T	A	6	9	15	0	0	15	0	0
10	18934590	.	A	C	14	11	25	0	0	25	0	0
10	18934683	.	T	C	11	13	24	0	1	25	0	0
10	18934963	.	G	A	0	6	6	0	3	9	0	0
10	18935271	.	C	T	13	15	28	0	1	29	0	0
10	18935874	.	T	A	3	2	5	0	0	6	1	0
10	18973124	.	A	G	9	0	9	0	9	18	0	0
10	18983512	.	C	A	13	11	24	0	0	24	0	0
10	18989018	.	C	G	8	12	20	0	2	22	0	0
10	18989047	.	T	C	12	19	31	0	3	34	0	0
10	19020475	.	A	G	5	9	14	0	1	15	0	0
10	19021032	.	C	A	8	8	16	0	0	16	0	0
10	19021102	.	C	G	10	12	22	0	0	22	0	0
10	19021192	.	A	G	4	5	9	0	0	9	0	0
10	19021456	.	A	G	1	4	5	0	0	5	0	0
10	19310775	.	C	G	5	5	10	0	0	10	0	0
10	19338576	.	G	A	0	3	3	0	6	9	0	0
10	19338735	.	G	C	1	2	3	0	0	3	0	0
10	19338827	.	C	T	6	3	9	0	0	9	0	0
10	19338839	.	T	C	4	2	6	0	0	6	0	0
10	19339280	.	C	G	4	4	8	0	1	9	0	0
10	19339364	.	G	A	1	3	4	0	5	9	0	0
10	19339367	.	T	C	6	2	8	0	0	8	0	0
10	19339538	.	G	C	0	13	13	0	11	24	0	0
10	19339647	.	C	T	4	11	15	0	1	16	0	0
10	19339859	.	C	G	8	10	18	0	1	19	0	0
10	19428743	.	T	A	1	2	3	0	0	3	0	0
10	19428789	.	C	T	1	2	3	0	0	3	0	0
10	19428791	.	G	T	1	2	3	0	0	3	0	0
10	19428830	.	A	C	1	4	5	0	0	5	0	0
10	19428835	.	C	A	0	4	4	0	1	5	0	0
10	19430560	.	T	C	1	2	3	0	0	3	0	0
10	19554673	.	A	T	16	18	34	0	1	35	0	0
10	19558489	.	C	A	9	6	15	0	0	15	0	0
10	19558558	.	T	A	1	5	6	0	0	6	0	0
10	19559235	.	A	G	9	7	16	0	0	16	0	0
10	19562006	.	T	G	14	10	24	0	0	24	0	0
10	19562015	.	A	T	17	10	27	0	2	29	0	0
10	19562945	.	C	T	2	11	13	0	0	13	0	0
10	19565704	.	A	T	20	28	48	3	0	51	0	0
10	19565771	.	T	C	20	29	49	0	0	49	0	0
10	19565782	.	A	C	17	30	47	0	0	48	1	0
10	19566400	.	T	A	12	18	30	0	0	30	0	0
10	19566445	.	T	C	9	10	19	0	1	20	0	0
10	19801737	.	C	A	5	6	11	0	0	11	0	0
10	19801759	.	A	C	5	4	9	0	1	10	0	0
10	19801779	.	C	T	6	5	11	0	0	11	0	0
10	19801808	.	A	G	3	6	9	0	0	9	0	0
10	20082011	.	T	G	4	4	8	0	0	8	0	0
10	20087260	.	A	G	1	0	1	0	0	1	0	0
10	20087263	.	C	T	1	0	1	0	0	1	0	0
10	20087388	.	T	C	0	2	2	0	0	2	0	0
10	20093368	.	C	T	2	6	8	0	1	9	0	0
10	20093914	.	C	T	5	2	7	0	0	7	0	0
10	20093959	.	A	G	5	2	7	0	1	8	0	0
10	20099649	.	C	T	1	1	2	0	2	4	0	0
10	20103429	.	A	T	5	2	7	0	0	7	0	0
10	20103448	.	A	G	4	2	6	0	0	6	0	0
10	20103601	.	G	T	3	6	9	0	2	11	0	0
10	20103639	.	A	G	5	7	12	0	1	13	0	0
10	20103662	.	C	T	6	4	10	0	0	10	0	0
10	20103731	.	C	T	8	11	19	0	0	19	0	0
10	20105347	.	A	G	0	1	1	0	0	1	0	0
10	20108575	.	T	A	14	18	32	0	1	33	0	0
10	20113962	.	T	C	1	0	1	0	0	1	0	0
10	20137862	.	A	G	3	1	4	0	0	4	0	0
10	20140930	.	T	A	2	3	5	0	0	5	0	0
10	20140951	.	T	C	2	2	4	0	0	4	0	0
10	20141059	.	A	G	1	0	1	0	3	4	0	0
10	20143850	.	T	A	1	6	7	0	0	7	0	0
10	20147452	.	A	G	9	0	9	0	11	20	0	0
10	20159059	.	G	T	1	2	3	0	0	3	0	0
10	20159558	.	A	G	2	1	3	0	0	3	0	0
10	20218342	.	C	G	10	7	17	0	0	17	0	0
10	20221281	.	C	T	2	2	4	0	0	4	0	0
10	20270867	.	T	C	3	6	9	0	0	9	0	0
10	20270919	.	C	T	0	4	4	0	1	5	0	0
10	20287188	.	A	G	3	3	6	0	1	7	0	0
10	20287251	.	C	A	0	3	3	0	2	5	0	0
10	20339024	.	C	T	4	1	5	0	0	5	0	0
10	20351756	.	C	T	0	2	2	0	3	5	0	0
10	20351785	.	C	G	3	3	6	0	0	6	0	0
10	20351824	.	C	T	2	2	4	0	1	5	0	0
10	20351846	.	T	A	2	2	4	0	1	5	0	0
10	20351930	.	T	C	2	5	7	0	0	7	0	0
10	20351978	.	A	G	5	5	10	0	0	10	0	0
10	20356700	.	C	T	3	2	5	0	1	6	0	0
10	20368883	.	C	T	5	8	13	0	1	15	1	0
10	20371675	.	A	T	11	16	27	0	2	29	0	0
10	20371715	.	T	C	9	9	18	0	3	21	0	0
10	20371723	.	A	C	10	9	19	0	2	21	0	0
10	20371827	.	C	T	14	10	24	0	1	25	0	0
10	20372029	.	G	A	0	3	3	0	2	5	0	0
10	20392798	.	T	C	2	2	4	0	0	4	0	0
10	20393164	.	C	T	2	4	6	0	0	6	0	0
10	20395629	.	T	C	4	8	12	0	0	12	0	0
10	20462884	.	G	A	4	7	11	0	3	14	0	0
10	20463890	.	G	A	2	3	5	0	0	5	0	0
10	20464238	.	A	G	4	6	10	0	1	11	0	0
10	20464245	.	A	G	4	5	9	0	0	9	0	0
10	20468868	.	T	C	4	0	4	0	8	12	0	0
10	20468952	.	G	A	5	4	9	0	0	9	0	0
10	20472600	.	G	T	0	2	2	0	0	2	0	0
10	20473517	.	G	T	9	9	18	0	1	19	0	0
10	20481740	.	T	C	9	13	22	0	1	23	0	0
10	20505261	.	G	A	3	1	4	0	0	4	0	0
10	20506482	.	T	A	0	1	1	0	0	1	0	0
10	20517889	.	A	G	2	1	3	0	0	3	0	0
10	20519543	.	T	C	1	1	2	0	1	3	0	0
10	20519549	.	T	C	2	0	2	0	1	3	0	0
10	20521939	.	C	T	3	1	4	0	1	5	0	0
10	20527653	.	C	T	8	3	11	0	0	11	0	0
10	20529384	.	G	A	10	4	14	0	0	14	0	0
10	20529389	.	G	T	10	4	14	0	1	15	0	0
10	20529450	.	T	C	6	0	6	0	12	18	0	0
10	20532762	.	C	T	0	2	2	0	0	2	0	0
10	20543294	.	T	C	2	0	2	0	7	9	0	0
10	20543336	.	G	A	6	7	13	0	0	13	0	0
10	20546548	.	C	T	2	5	7	0	0	7	0	0
10	20563086	.	T	C	7	10	17	0	1	18	0	0
10	20565260	.	C	T	0	8	8	0	4	12	0	0
10	20583799	.	C	T	2	4	6	0	0	6	0	0
10	20586463	.	A	T	5	3	8	0	0	8	0	0
10	20596178	.	C	G	6	2	8	0	0	8	0	0
10	20604555	.	T	C	10	20	30	0	0	30	0	0
10	20605150	.	C	T	14	11	25	0	1	26	0	0
10	20636027	.	C	T	8	15	23	0	2	25	0	0
10	20636072	.	A	C	16	15	31	0	1	32	0	0
10	20636082	.	C	T	13	16	29	0	3	32	0	0
10	20636168	.	A	T	4	17	21	0	0	21	0	0
10	20636177	.	G	T	2	15	17	0	2	19	0	0
10	20636211	.	G	A	6	13	19	0	1	20	0	0
10	20636262	.	T	A	12	14	26	0	2	28	0	0
10	20636273	.	T	C	12	0	12	0	14	26	0	0
10	20636346	.	T	C	7	8	15	1	0	16	0	0
10	20636479	.	T	C	4	9	13	1	0	14	0	0
10	20637069	.	C	T	0	1	1	0	0	1	0	0
10	20660387	.	G	A	2	2	4	0	0	4	0	0
10	20661288	.	A	G	2	3	5	0	0	5	0	0
10	20696449	.	A	G	2	5	7	0	0	7	0	0
10	20920664	.	A	G	13	18	31	0	1	32	0	0
10	20971685	.	A	G	9	4	13	0	1	14	0	0
10	21043461	.	G	A	13	18	31	0	0	31	0	0
10	21043902	.	G	A	5	8	13	0	0	13	0	0
10	21043934	.	A	G	8	7	15	0	0	15	0	0
10	21043944	.	A	G	8	7	15	0	0	15	0	0
10	21044037	.	G	A	5	14	19	0	2	21	0	0
10	21044094	.	T	A	6	12	18	0	2	20	0	0
10	21044136	.	G	A	4	15	19	0	0	19	0	0
10	21044193	.	A	G	3	7	10	0	1	11	0	0
10	21044235	.	A	C	5	6	11	0	0	11	0	0
10	21044316	.	A	G	4	12	16	0	0	16	0	0
10	21044645	.	G	A	6	3	9	0	0	9	0	0
10	21044964	.	T	A	8	3	11	0	3	14	0	0
10	21045126	.	T	C	6	0	6	0	7	13	0	0
10	21053520	.	G	C	2	3	5	0	0	5	0	0
10	21436810	.	T	C	3	5	8	0	0	8	0	0
10	21437255	.	A	G	5	0	5	0	10	15	0	0
10	21440173	.	T	C	2	1	3	0	0	3	0	0
10	21440486	.	T	A	5	15	20	0	1	21	0	0
10	21440786	.	A	G	3	4	7	0	0	7	0	0
10	21442229	.	T	C	0	0	0	0	1	1	0	0
10	21442994	.	T	A	30	14	44	0	1	45	0	0
10	21443476	.	T	C	16	19	35	0	2	37	0	0
10	21451996	.	C	T	9	11	20	0	2	22	0	0
10	21452340	.	T	C	5	4	9	0	0	9	0	0
10	21456498	.	T	C	1	3	4	0	0	4	0	0
10	21459403	.	G	A	1	14	15	0	15	30	0	0
10	21459439	.	G	A	17	8	25	0	2	27	0	0
10	21462585	.	A	G	9	7	16	0	1	17	0	0
10	21469977	.	G	A	1	12	13	0	18	31	0	0
10	21469997	.	A	C	21	15	36	0	2	38	0	0
10	21514191	.	T	C	2	2	4	0	1	5	0	0
10	21523014	.	C	T	5	5	10	0	1	11	0	0
10	21523624	.	A	C	4	4	8	0	0	8	0	0
10	21523639	.	C	T	4	4	8	0	1	9	0	0
10	21523720	.	T	C	4	3	7	0	1	8	0	0
10	21523827	.	A	G	4	2	6	0	1	7	0	0
10	21524121	.	A	T	8	5	13	0	0	13	0	0
10	21524244	.	C	A	7	5	12	0	1	13	0	0
10	21524319	.	G	T	11	5	16	0	0	16	0	0
10	21524337	.	C	T	14	5	19	0	1	20	0	0
10	21524472	.	C	T	10	8	18	0	0	18	0	0
10	21524682	.	G	A	10	10	20	0	0	20	0	0
10	21524805	.	T	C	8	4	12	0	0	12	0	0
10	21524811	.	A	C	8	4	12	0	0	12	0	0
10	21564251	.	C	A	0	3	3	0	0	3	0	0
10	21622317	.	G	A	1	0	1	0	0	1	0	0
10	21645994	.	G	A	9	6	15	0	2	17	0	0
10	21646033	.	C	T	22	22	44	0	2	46	0	0
10	21646216	.	T	C	26	8	34	0	4	38	0	0
10	21646225	.	G	A	25	15	40	0	3	43	0	0
10	21646400	.	C	G	24	28	52	0	1	53	0	0
10	21646844	.	A	G	31	15	46	0	2	48	0	0
10	21646848	.	A	G	27	17	44	0	3	47	0	0
10	21646908	.	C	A	28	19	47	0	0	47	0	0
10	21647008	.	A	C	20	24	44	0	2	47	1	0
10	21647200	.	C	T	25	26	51	0	1	52	0	0
10	21647241	.	T	G	24	26	50	0	1	51	0	0
10	21647291	.	G	A	1	28	29	0	27	56	0	0
10	21647539	.	T	C	36	27	63	0	3	67	1	0
10	21647582	.	C	A	31	27	58	0	4	62	0	0
10	21647614	.	A	C	35	25	60	0	1	61	0	0
10	21647898	.	C	T	38	20	58	0	2	61	1	0
10	21651602	.	T	C	2	2	4	0	0	4	0	0
10	21651889	.	G	T	2	4	6	0	0	6	0	0
10	21652038	.	G	A	0	5	5	0	2	7	0	0
10	21652585	.	A	T	0	4	4	0	0	4	0	0
10	21653046	.	A	C	1	2	3	0	0	3	0	0
10	21658567	.	G	A	5	3	8	0	1	9	0	0
10	21662853	.	A	C	3	4	7	0	0	7	0	0
10	21662865	.	G	C	4	5	9	0	0	9	0	0
10	21702953	.	G	T	2	2	4	0	0	4	0	0
10	21702955	.	A	T	2	2	4	0	0	4	0	0
10	21703011	.	C	T	1	2	3	0	0	3	0	0
10	21703056	.	C	A	2	2	4	0	0	4	0	0
10	21719343	.	T	C	1	2	3	0	0	3	0	0
10	21720833	.	A	G	2	4	6	0	0	6	0	0
10	21720867	.	G	A	0	1	1	0	1	2	0	0
10	21723083	.	G	A	2	3	5	0	0	5	0	0
10	21723660	.	C	A	2	4	6	0	1	7	0	0
10	21723810	.	A	G	1	0	1	0	2	3	0	0
10	21724194	.	T	A	1	2	3	0	0	3	0	0
10	21738068	.	C	T	3	3	6	0	0	6	0	0
10	21739919	.	T	A	1	2	3	0	0	3	0	0
10	21778980	.	C	T	4	4	8	4	0	12	0	0
10	21780258	.	T	C	6	17	23	0	2	25	0	0
10	21780288	.	G	T	7	15	22	0	0	22	0	0
10	21780571	.	A	G	9	7	16	0	0	16	0	0
10	21780579	.	C	T	8	7	15	0	0	15	0	0
10	21781313	.	C	T	4	3	7	0	0	7	0	0
10	21781665	.	G	A	0	6	6	0	8	14	0	0
10	21781677	.	G	A	1	5	6	0	9	15	0	0
10	21781722	.	G	T	12	7	19	0	3	24	2	0
10	21783560	.	C	A	7	6	13	0	1	14	0	0
10	21790076	.	A	C	9	11	20	0	2	22	0	0
10	21790295	.	A	T	4	5	9	0	0	9	0	0
10	21790323	.	G	A	5	3	8	0	0	8	0	0
10	21790648	.	T	C	11	9	20	0	0	20	0	0
10	21790769	.	A	G	7	0	7	0	9	16	0	0
10	21790775	.	A	C	7	12	19	0	0	19	0	0
10	21790934	.	T	C	11	10	21	0	1	22	0	0
10	21791090	.	G	A	14	11	25	0	0	25	0	0
10	21791690	.	G	A	0	4	4	0	3	7	0	0
10	21791699	.	T	C	3	4	7	0	0	7	0	0
10	21791927	.	A	T	5	6	11	1	0	12	0	0
10	21794285	.	G	A	3	6	9	0	1	10	0	0
10	21795867	.	A	T	10	3	13	0	2	15	0	0
10	21795887	.	C	T	6	2	8	0	0	8	0	0
10	21797266	.	C	T	4	7	11	0	0	11	0	0
10	21797382	.	A	T	7	2	9	0	0	9	0	0
10	21797665	.	C	T	5	2	7	0	0	7	0	0
10	21797669	.	A	T	5	0	5	0	1	6	0	0
10	21797769	.	T	G	5	4	9	0	1	10	0	0
10	21798102	.	A	G	3	3	6	0	0	6	0	0
10	21798215	.	C	A	4	6	10	0	1	11	0	0
10	21798348	.	A	T	6	2	8	0	0	8	0	0
10	21798372	.	G	A	6	4	10	0	0	10	0	0
10	21798571	.	C	A	5	3	8	0	0	8	0	0
10	21798828	.	C	A	6	5	11	0	1	12	0	0
10	21799320	.	A	C	5	3	8	0	1	9	0	0
10	21799343	.	T	A	8	6	14	0	0	14	0	0
10	21799374	.	T	A	10	3	13	1	2	16	0	0
10	21799575	.	G	T	4	7	11	0	0	11	0	0
10	21801256	.	C	G	3	9	12	0	0	12	0	0
10	21801267	.	C	T	5	9	14	0	0	14	0	0
10	21801339	.	T	G	10	0	10	0	7	17	0	0
10	21801352	.	T	C	13	6	19	0	0	19	0	0
10	21801573	.	C	T	9	6	15	0	1	16	0	0
10	21801590	.	A	C	6	5	11	0	1	12	0	0
10	21801611	.	G	T	10	4	14	0	0	14	0	0
10	21801718	.	G	A	0	7	7	0	11	18	0	0
10	21802057	.	A	G	2	6	8	0	1	9	0	0
10	21802086	.	A	G	4	9	13	0	1	14	0	0
10	21802291	.	C	T	7	12	19	0	0	19	0	0
10	21802326	.	C	A	10	11	21	0	2	23	0	0
10	21802355	.	C	A	6	13	19	0	1	20	0	0
10	21802380	.	G	A	0	12	12	0	6	18	0	0
10	21802530	.	A	T	2	7	9	0	1	10	0	0
10	21802539	.	C	T	2	11	13	0	0	13	0	0
10	21802566	.	T	C	3	10	13	0	1	14	0	0
10	21802661	.	C	T	4	12	16	0	0	16	0	0
10	21802701	.	A	T	9	3	12	0	0	12	0	0
10	21802964	.	G	A	12	3	15	0	0	15	0	0
10	21803031	.	G	A	7	7	14	1	1	16	0	0
10	21804785	.	G	T	0	5	5	0	3	8	0	0
10	21804786	.	G	T	2	5	7	0	1	8	0	0
10	21805019	.	A	T	1	2	3	0	0	3	0	0
10	21805020	.	A	C	1	2	3	0	0	3	0	0
10	21805085	.	A	C	4	3	7	0	0	7	0	0
10	21805090	.	G	A	4	3	7	0	0	7	0	0
10	21805251	.	T	G	2	4	6	0	0	6	0	0
10	21805447	.	G	A	6	9	15	0	0	15	0	0
10	21805762	.	C	T	2	4	6	0	1	7	0	0
10	21805870	.	A	G	3	0	3	0	3	6	0	0
10	21805942	.	G	T	0	4	4	0	2	6	0	0
10	21806060	.	G	A	4	6	10	0	0	10	0	0
10	21806984	.	T	A	2	5	7	0	0	7	0	0
10	21818522	.	C	T	48	34	82	0	2	84	0	0
10	21818595	.	T	G	34	34	68	0	3	71	0	0
10	21818762	.	A	C	27	25	52	0	3	55	0	0
10	21818978	.	G	T	33	29	62	0	2	64	0	0
10	21819506	.	G	A	30	7	37	0	2	39	0	0
10	21819523	.	T	A	24	11	35	0	2	39	2	0
10	21819577	.	C	T	31	29	60	0	6	66	0	0
10	21819772	.	T	C	29	33	62	0	1	63	0	0
10	21872639	.	A	G	1	2	3	0	0	3	0	0
10	21944941	.	C	T	3	3	6	1	0	7	0	0
10	22003847	.	T	C	21	25	46	0	1	47	0	0
10	22003874	.	A	G	16	21	37	0	2	39	0	0
10	22030827	.	G	A	18	16	34	0	2	36	0	0
10	22030881	.	A	T	20	20	40	0	1	41	0	0
10	22030887	.	T	G	19	24	43	0	0	43	0	0
10	22030985	.	T	C	22	22	44	0	1	45	0	0
10	22030986	.	C	T	22	22	44	0	1	45	0	0
10	22031034	.	C	T	23	20	43	0	0	43	0	0
10	22031493	.	G	A	20	22	42	0	3	45	0	0
10	22031572	.	A	G	20	20	40	0	3	43	0	0
10	22031635	.	A	G	16	23	39	0	1	40	0	0
10	22031666	.	A	G	15	19	34	0	2	36	0	0
10	22031755	.	T	C	12	12	24	0	0	24	0	0
10	22031759	.	T	C	12	11	23	0	1	24	0	0
10	22031805	.	G	C	7	13	20	0	1	21	0	0
10	22031806	.	G	A	7	13	20	0	1	21	0	0
10	22036033	.	A	G	2	0	2	0	4	6	0	0
10	22036169	.	A	G	7	3	10	0	0	11	1	0
10	22041529	.	G	A	1	2	3	0	0	3	0	0
10	22041546	.	C	T	1	3	4	0	0	4	0	0
10	22044921	.	T	G	6	3	9	0	2	11	0	0
10	22051436	.	A	G	4	2	6	0	0	6	0	0
10	22051465	.	G	C	3	2	5	0	0	5	0	0
10	22051548	.	C	T	0	4	4	0	2	6	0	0
10	22052133	.	T	C	5	6	11	0	0	11	0	0
10	22052361	.	C	T	0	3	3	0	1	4	0	0
10	22054149	.	T	C	2	2	4	0	0	4	0	0
10	22054158	.	A	G	2	1	3	0	1	4	0	0
10	22054240	.	T	C	1	1	2	0	0	2	0	0
10	22134695	.	G	A	5	4	9	0	0	9	0	0
10	22137372	.	C	A	0	2	2	0	0	2	0	0
10	22137374	.	C	A	0	2	2	0	0	2	0	0
10	22162187	.	T	C	10	0	10	0	18	28	0	0
10	22162576	.	A	G	9	3	12	0	0	12	0	0
10	22162673	.	T	G	4	5	9	0	0	9	0	0
10	22163144	.	A	T	11	8	19	0	0	19	0	0
10	22163165	.	A	G	11	4	15	0	0	15	0	0
10	22163235	.	C	T	0	8	8	0	7	15	0	0
10	22163244	.	C	G	6	8	14	0	0	14	0	0
10	22163660	.	C	T	6	11	17	0	1	18	0	0
10	22163801	.	A	T	7	7	14	0	2	16	0	0
10	22163867	.	T	C	10	8	18	0	0	18	0	0
10	22163928	.	C	A	8	8	16	0	2	18	0	0
10	22164144	.	A	T	5	11	16	0	0	16	0	0
10	22164276	.	T	C	3	5	8	0	0	8	0	0
10	22164421	.	T	A	6	4	10	0	0	10	0	0
10	22164518	.	T	A	8	5	13	0	0	13	0	0
10	22164621	.	T	G	6	2	8	0	0	8	0	0
10	22164622	.	G	A	6	2	8	0	0	8	0	0
10	22164672	.	G	A	5	3	8	0	0	8	0	0
10	22164686	.	A	T	7	2	9	0	0	9	0	0
10	22164756	.	T	C	8	7	15	0	1	16	0	0
10	22165383	.	C	G	9	4	13	0	0	13	0	0
10	22165607	.	T	G	4	4	8	0	0	8	0	0
10	22165644	.	T	C	2	4	6	0	0	6	0	0
10	22165768	.	T	A	11	5	16	0	0	16	0	0
10	22165879	.	T	A	4	5	9	0	0	9	0	0
10	22165880	.	T	C	4	5	9	0	0	9	0	0
10	22165953	.	C	T	5	11	16	0	2	18	0	0
10	22166010	.	T	A	3	7	10	0	0	10	0	0
10	22166128	.	C	T	5	5	10	0	0	10	0	0
10	22166182	.	A	C	4	0	4	0	3	7	0	0
10	22166184	.	G	A	4	2	6	0	1	7	0	0
10	22166504	.	C	T	5	2	7	0	1	8	0	0
10	22205038	.	G	A	0	2	2	0	1	3	0	0
10	22248334	.	C	T	0	6	6	0	4	10	0	0
10	22249237	.	G	A	3	5	8	0	0	8	0	0
10	22381847	.	A	G	1	5	6	0	1	7	0	0
10	22381897	.	C	G	8	5	13	0	1	14	0	0
10	22381984	.	A	T	7	4	11	0	0	11	0	0
10	22475736	.	G	A	8	9	17	0	1	18	0	0
10	22475799	.	G	A	0	13	13	0	9	22	0	0
10	22476535	.	C	T	3	1	4	0	1	5	0	0
10	22477229	.	A	G	4	3	7	0	0	7	0	0
10	22477580	.	C	T	9	6	15	0	0	15	0	0
10	22477610	.	A	G	10	0	10	0	6	16	0	0
10	22477661	.	C	T	9	9	18	0	0	18	0	0
10	22510550	.	C	A	2	4	6	0	0	6	0	0
10	22516643	.	C	G	6	7	13	0	0	13	0	0
10	22516903	.	A	G	2	3	5	0	1	6	0	0
10	22516957	.	T	C	1	2	3	0	1	4	0	0
10	22518293	.	C	T	4	6	10	0	1	11	0	0
10	22518294	.	C	T	5	6	11	0	0	11	0	0
10	22519465	.	A	G	2	7	9	0	0	9	0	0
10	22519668	.	A	T	5	12	17	0	0	17	0	0
10	22519737	.	C	T	6	7	13	0	0	13	0	0
10	22519749	.	G	C	5	4	9	0	1	10	0	0
10	22519931	.	C	T	1	5	6	0	0	6	0	0
10	22530058	.	A	C	4	5	9	0	0	9	0	0
10	22530136	.	A	G	3	0	3	0	7	10	0	0
10	22530731	.	T	G	9	4	13	0	0	13	0	0
10	22531906	.	A	C	11	19	30	0	0	30	0	0
10	22531946	.	T	G	9	8	17	0	0	17	0	0
10	22532139	.	C	T	9	5	14	0	3	17	0	0
10	22532211	.	G	A	9	5	14	0	1	15	0	0
10	22532547	.	T	A	18	11	29	0	0	29	0	0
10	22532817	.	C	G	12	21	33	0	0	33	0	0
10	24326236	.	C	T	5	3	8	0	0	8	0	0
10	24334810	.	G	A	3	5	8	0	1	9	0	0
10	24335002	.	C	T	3	6	9	0	0	9	0	0
10	24335402	.	C	T	4	1	5	0	0	5	0	0
10	24373125	.	C	T	2	3	5	0	0	5	0	0
10	24373137	.	C	T	3	2	5	0	0	5	0	0
10	24373429	.	T	A	3	3	6	0	1	7	0	0
10	24373647	.	C	T	2	3	5	0	0	5	0	0
10	24373657	.	A	C	2	3	5	0	0	5	0	0
10	24373963	.	C	T	1	4	5	0	0	5	0	0
10	24422052	.	C	T	18	13	31	0	1	32	0	0
10	24422205	.	G	A	13	10	23	0	1	24	0	0
10	24422236	.	C	T	13	11	24	0	1	25	0	0
10	24422311	.	G	A	7	9	16	0	0	16	0	0
10	24424363	.	G	C	0	4	4	0	3	7	0	0
10	24425653	.	A	G	1	4	5	0	1	6	0	0
10	24426038	.	A	T	12	8	20	0	1	21	0	0
10	24429357	.	T	C	3	8	11	0	2	13	0	0
10	24431762	.	C	T	6	6	12	0	0	12	0	0
10	24435656	.	G	T	11	8	19	0	0	19	0	0
10	24435662	.	A	G	11	2	13	0	7	20	0	0
10	24442466	.	C	T	8	6	14	0	0	14	0	0
10	24442490	.	A	G	7	0	7	0	3	10	0	0
10	24563892	.	T	G	6	7	13	0	0	13	0	0
10	24564904	.	G	A	0	7	7	0	9	16	0	0
10	24564935	.	C	A	10	5	15	0	0	15	0	0
10	24565366	.	A	T	9	9	18	0	1	19	0	0
10	24565424	.	G	A	9	13	22	0	1	23	0	0
10	24565435	.	G	T	0	12	12	0	9	21	0	0
10	24565587	.	C	A	9	4	13	0	0	13	0	0
10	24566124	.	T	C	6	7	13	0	0	13	0	0
10	24573740	.	G	A	0	2	2	0	1	3	0	0
10	24600128	.	A	G	8	10	18	0	1	19	0	0
10	24605406	.	A	C	2	4	6	0	2	8	0	0
10	24609362	.	C	A	5	6	11	0	2	13	0	0
10	24614636	.	A	G	1	0	1	0	3	4	0	0
10	24621354	.	A	G	15	13	28	0	4	32	0	0
10	24621543	.	G	A	12	12	24	0	0	24	0	0
10	24621687	.	G	A	4	6	10	0	0	10	0	0
10	24621730	.	A	T	4	7	11	0	0	11	0	0
10	24621757	.	T	A	4	5	9	0	1	10	0	0
10	24649813	.	T	G	2	3	5	0	0	5	0	0
10	24650192	.	A	G	4	3	7	0	0	7	0	0
10	24650668	.	A	G	1	4	5	0	0	5	0	0
10	24650696	.	C	A	2	3	5	0	0	5	0	0
10	24650769	.	T	C	2	0	2	0	5	7	0	0
10	24650889	.	T	A	1	2	3	0	1	5	1	0
10	24654501	.	C	T	0	5	5	0	10	15	0	0
10	24654607	.	A	T	5	7	12	0	0	12	0	0
10	24654765	.	C	T	6	7	13	0	0	13	0	0
10	24654906	.	T	C	5	0	5	0	6	11	0	0
10	24655146	.	A	T	8	5	13	0	0	13	0	0
10	24655984	.	C	T	2	0	2	0	1	3	0	0
10	24656449	.	T	A	2	2	4	0	1	5	0	0
10	24659337	.	T	C	1	0	1	0	0	1	0	0
10	24659461	.	C	T	2	2	4	0	0	4	0	0
10	24659492	.	T	A	2	3	5	0	0	5	0	0
10	24659507	.	C	T	2	2	4	0	0	4	0	0
10	24659661	.	A	C	3	2	5	0	0	5	0	0
10	24659732	.	A	G	5	2	7	0	1	8	0	0
10	24660215	.	T	G	5	6	11	0	0	11	0	0
10	24666069	.	A	C	0	2	2	0	0	2	0	0
10	24677091	.	T	G	7	0	7	0	6	13	0	0
10	24677253	.	T	A	6	2	8	0	0	8	0	0
10	24684010	.	T	C	1	3	4	0	0	4	0	0
10	24685624	.	T	A	2	2	4	0	0	4	0	0
10	24710220	.	A	C	2	3	5	0	0	5	0	0
10	24710313	.	G	T	2	2	4	0	0	4	0	0
10	24710725	.	G	C	1	2	3	0	0	3	0	0
10	24710938	.	T	G	1	4	5	0	0	5	0	0
10	24710981	.	T	G	3	8	11	0	0	11	0	0
10	24720868	.	G	A	1	2	3	0	0	3	0	0
10	24721468	.	G	C	3	0	3	0	4	7	0	0
10	24725357	.	G	A	4	5	9	0	0	9	0	0
10	24725358	.	A	C	4	5	9	0	0	9	0	0
10	24725441	.	C	T	4	3	7	0	0	7	0	0
10	24726302	.	A	G	1	6	7	0	0	7	0	0
10	24726712	.	T	G	4	4	8	0	0	8	0	0
10	24726809	.	A	G	5	9	14	0	0	14	0	0
10	24727127	.	A	G	1	1	2	0	0	2	0	0
10	24762377	.	G	A	3	2	5	0	0	5	0	0
10	24762462	.	T	C	4	0	4	0	6	10	0	0
10	24762510	.	A	G	2	4	6	0	0	6	0	0
10	24762723	.	A	G	4	10	14	0	0	14	0	0
10	24765589	.	A	C	1	1	2	0	0	2	0	0
10	24765893	.	A	G	8	3	11	0	0	11	0	0
10	25068718	.	G	A	3	2	5	0	0	5	0	0
10	25068973	.	C	T	1	5	6	0	1	7	0	0
10	25109225	.	A	C	6	6	12	0	0	12	0	0
10	25109492	.	C	T	2	3	5	0	0	5	0	0
10	25121929	.	A	T	1	2	3	0	0	3	0	0
10	25136897	.	C	G	0	1	1	0	0	1	0	0
10	25212215	.	C	G	12	0	12	0	11	24	1	0
10	25222392	.	G	T	6	4	10	0	1	11	0	0
10	25222426	.	T	C	6	7	13	0	0	13	0	0
10	25232341	.	G	A	0	1	1	0	2	3	0	0
10	25250373	.	C	T	0	1	1	0	0	1	0	0
10	25250493	.	T	A	6	4	10	0	0	10	0	0
10	25252426	.	G	A	3	3	6	0	0	6	0	0
10	25252474	.	C	T	8	9	17	0	0	17	0	0
10	25252591	.	A	G	5	5	10	0	0	10	0	0
10	25252899	.	T	C	5	4	9	0	0	9	0	0
10	25261968	.	A	C	12	8	20	0	0	20	0	0
10	25262150	.	T	A	11	10	21	0	1	22	0	0
10	25262336	.	C	T	1	3	4	0	0	4	0	0
10	25267829	.	A	T	11	23	34	0	5	39	0	0
10	25267863	.	C	T	10	23	33	0	1	34	0	0
10	25267952	.	T	C	19	15	34	0	1	35	0	0
10	25268389	.	T	C	8	13	21	0	0	21	0	0
10	25268827	.	C	T	4	4	8	0	0	8	0	0
10	25268998	.	T	C	2	1	3	0	1	4	0	0
10	25269148	.	G	A	3	6	9	0	0	9	0	0
10	25269170	.	C	A	5	6	11	0	0	11	0	0
10	25269245	.	C	T	20	15	35	0	0	35	0	0
10	25269413	.	A	G	23	12	35	0	1	36	0	0
10	25269747	.	T	A	19	3	22	0	5	27	0	0
10	25270044	.	C	A	18	20	38	0	1	40	1	0
10	25270432	.	A	G	9	18	27	0	0	27	0	0
10	25270618	.	C	G	19	16	35	0	2	37	0	0
10	25270942	.	G	C	19	15	34	0	1	35	0	0
10	25270958	.	C	T	18	15	33	0	3	36	0	0
10	25271051	.	T	A	17	9	26	0	1	27	0	0
10	25271338	.	T	C	12	15	27	0	1	28	0	0
10	25312733	.	T	G	8	4	12	0	2	14	0	0
10	25312889	.	T	A	5	7	12	0	0	12	0	0
10	25313204	.	G	A	6	11	17	0	0	17	0	0
10	25317306	.	A	G	3	2	5	0	0	5	0	0
10	25321269	.	T	C	5	0	5	0	9	14	0	0
10	25321344	.	C	T	1	0	1	0	0	1	0	0
10	25329811	.	C	A	0	11	11	0	6	17	0	0
10	25330408	.	A	G	1	3	4	0	0	4	0	0
10	25333961	.	C	T	0	1	1	0	0	1	0	0
10	25334178	.	T	C	10	11	21	0	3	24	0	0
10	25342889	.	A	G	22	11	33	0	0	33	0	0
10	25368477	.	T	G	2	2	4	0	0	4	0	0
10	25368481	.	G	A	0	1	1	0	3	4	0	0
10	25374544	.	G	C	1	3	4	0	0	4	0	0
10	25381265	.	C	G	2	4	6	0	0	6	0	0
10	25381304	.	G	A	1	2	3	0	0	3	0	0
10	25381721	.	T	C	1	2	3	0	0	3	0	0
10	25381742	.	G	T	0	2	2	0	1	3	0	0
10	25382099	.	A	G	1	2	3	0	0	3	0	0
10	25383998	.	C	A	2	2	4	0	0	4	0	0
10	25384182	.	A	G	2	2	4	0	0	4	0	0
10	25384185	.	G	T	2	2	4	0	0	4	0	0
10	25403139	.	G	A	2	3	5	0	0	5	0	0
10	25403153	.	C	T	0	4	4	0	3	7	0	0
10	25410276	.	T	C	6	0	6	0	8	14	0	0
10	25410288	.	A	G	6	9	15	0	0	15	0	0
10	25426586	.	C	T	0	3	3	0	0	3	0	0
10	25435194	.	A	G	1	6	7	0	0	7	0	0
10	25435335	.	G	C	2	0	2	0	3	5	0	0
10	25436518	.	C	A	1	1	2	0	0	2	0	0
10	25462325	.	A	T	1	4	5	0	0	5	0	0
10	25573333	.	G	A	10	9	19	0	0	19	0	0
10	25573393	.	T	C	5	0	5	0	8	13	0	0
10	25573410	.	T	C	5	7	12	0	0	12	0	0
10	25573436	.	C	G	6	9	15	0	1	16	0	0
10	25574092	.	T	C	6	0	6	0	5	11	0	0
10	25574127	.	T	A	6	5	11	0	1	12	0	0
10	25574159	.	T	C	7	6	13	0	0	13	0	0
10	25574171	.	A	G	7	7	14	0	0	14	0	0
10	25581999	.	G	A	7	5	12	0	0	12	0	0
10	25582029	.	A	G	9	5	14	0	0	14	0	0
10	25582101	.	G	A	3	2	5	0	0	5	0	0
10	25582920	.	T	C	5	3	8	0	0	8	0	0
10	25601711	.	A	G	3	4	7	0	0	7	0	0
10	25601799	.	T	C	4	3	7	0	2	9	0	0
10	25601838	.	G	A	1	1	2	0	0	2	0	0
10	25694637	.	G	A	22	22	44	0	1	45	0	0
10	25694844	.	G	A	16	18	34	0	1	35	0	0
10	25694848	.	C	T	22	17	39	0	1	40	0	0
10	25700984	.	G	A	2	3	5	0	0	5	0	0
10	25701036	.	G	A	4	2	6	0	0	6	0	0
10	25701659	.	G	C	7	15	22	0	1	23	0	0
10	25701781	.	T	C	1	1	2	0	1	3	0	0
10	25701928	.	T	C	5	0	5	0	3	8	0	0
10	25704345	.	C	T	2	3	5	0	1	6	0	0
10	25706228	.	G	A	2	2	4	0	0	4	0	0
10	25709764	.	T	A	2	1	3	0	0	3	0	0
10	25834684	.	A	G	1	4	5	0	1	6	0	0
10	25837574	.	T	G	6	5	11	0	2	13	0	0
10	25859735	.	T	A	3	2	5	0	1	6	0	0
10	25961273	.	A	G	1	3	4	0	0	4	0	0
10	26225398	.	T	C	5	0	5	0	4	9	0	0
10	26225479	.	T	C	3	0	3	0	4	7	0	0
10	26269728	.	G	A	2	2	4	0	0	4	0	0
10	26269842	.	T	C	4	5	9	0	0	9	0	0
10	26270064	.	C	A	5	3	8	0	1	9	0	0
10	26270847	.	T	C	10	0	10	0	7	17	0	0
10	26271018	.	G	C	3	0	3	0	7	10	0	0
10	26271357	.	C	A	1	3	4	0	0	4	0	0
10	26271522	.	T	C	4	3	7	0	0	7	0	0
10	26272062	.	G	T	2	2	4	0	0	5	1	0
10	26272756	.	T	C	3	0	3	0	4	7	0	0
10	26272842	.	G	A	2	2	4	0	0	4	0	0
10	26275967	.	A	G	0	1	1	0	0	1	0	0
10	26276019	.	C	T	0	2	2	0	2	4	0	0
10	26279001	.	G	A	3	5	8	0	1	9	0	0
10	26282195	.	C	A	0	1	1	0	2	3	0	0
10	26282196	.	G	A	2	1	3	0	0	3	0	0
10	26285271	.	G	T	1	0	1	0	0	1	0	0
10	26285280	.	C	T	1	0	1	0	0	1	0	0
10	26508150	.	A	C	2	3	5	0	0	5	0	0
10	26517214	.	C	T	2	0	2	0	0	2	0	0
10	26517569	.	G	A	0	1	1	0	1	2	0	0
10	26540432	.	A	G	7	7	14	0	1	15	0	0
10	26541145	.	G	A	3	5	8	0	2	10	0	0
10	26551191	.	T	A	8	19	27	0	1	28	0	0
10	26551492	.	A	G	11	15	26	0	7	33	0	0
10	26558704	.	C	T	1	0	1	0	0	1	0	0
10	26560166	.	T	C	2	4	6	0	1	7	0	0
10	26560366	.	G	A	3	11	14	0	32	46	0	0
10	26560392	.	C	A	20	24	44	0	3	47	0	0
10	26565704	.	T	C	34	22	56	0	2	58	0	0
10	26565760	.	G	A	2	30	32	0	29	61	0	0
10	26566054	.	G	C	1	23	24	0	15	39	0	0
10	26566267	.	T	C	25	13	38	0	5	43	0	0
10	26566354	.	A	T	14	13	27	0	1	28	0	0
10	26566369	.	A	T	15	13	28	0	0	28	0	0
10	26566715	.	T	A	14	11	25	0	1	26	0	0
10	26566749	.	G	A	12	11	23	0	0	23	0	0
10	26566785	.	T	A	18	11	29	0	0	29	0	0
10	26566787	.	A	T	18	11	29	0	0	29	0	0
10	26566855	.	A	G	20	0	20	0	9	29	0	0
10	26566970	.	T	G	15	2	17	0	23	40	0	0
10	26567127	.	G	A	0	18	18	0	12	30	0	0
10	26567238	.	A	G	17	16	33	0	3	36	0	0
10	26567337	.	C	T	9	37	46	0	0	46	0	0
10	26567376	.	C	G	10	29	39	0	1	40	0	0
10	26567500	.	C	T	17	14	31	0	4	35	0	0
10	26567656	.	G	C	22	12	34	0	0	34	0	0
10	26567889	.	T	A	14	7	21	0	1	22	0	0
10	26567958	.	T	A	11	11	22	0	1	23	0	0
10	26568154	.	A	T	11	15	26	0	1	27	0	0
10	26568166	.	C	T	7	14	21	0	1	22	0	0
10	26568201	.	A	G	10	9	19	0	1	20	0	0
10	26568239	.	C	T	11	11	22	0	2	24	0	0
10	26568429	.	A	C	19	23	42	0	1	43	0	0
10	26568498	.	T	C	20	25	45	0	1	46	0	0
10	26568523	.	G	T	17	30	47	0	2	49	0	0
10	26568726	.	A	G	19	24	43	0	2	45	0	0
10	26569098	.	A	G	19	0	19	0	18	37	0	0
10	26569099	.	A	C	18	17	35	0	2	37	0	0
10	26569248	.	C	A	8	11	19	0	2	21	0	0
10	26574004	.	T	C	3	1	4	0	0	4	0	0
10	26583978	.	C	G	3	4	7	0	1	8	0	0
10	26596020	.	T	A	24	20	44	0	1	45	0	0
10	26596075	.	C	T	26	17	43	0	1	44	0	0
10	26596080	.	T	C	23	16	39	0	2	41	0	0
10	26656135	.	A	C	2	1	3	0	0	3	0	0
10	26656240	.	C	T	5	4	9	0	0	9	0	0
10	26656500	.	G	A	15	11	26	0	1	27	0	0
10	26656527	.	A	G	10	16	26	0	0	26	0	0
10	26659245	.	C	T	7	7	14	0	0	14	0	0
10	26661469	.	T	C	2	5	7	0	0	7	0	0
10	26662046	.	G	A	5	3	8	0	3	11	0	0
10	26666823	.	C	T	15	9	24	0	0	24	0	0
10	26666839	.	T	C	16	13	29	0	1	30	0	0
10	26717156	.	T	A	13	9	22	0	3	25	0	0
10	26717246	.	G	A	12	9	21	0	0	21	0	0
10	26717740	.	A	G	10	15	25	0	4	29	0	0
10	26717963	.	G	A	3	8	11	0	0	11	0	0
10	26729687	.	T	C	4	3	7	0	0	7	0	0
10	26744012	.	A	G	5	8	13	0	0	13	0	0
10	26756911	.	G	C	1	2	3	0	0	3	0	0
10	26762841	.	C	A	5	9	14	0	1	15	0	0
10	26765526	.	T	C	7	4	11	0	0	11	0	0
10	26766154	.	C	T	0	4	4	0	1	5	0	0
10	26774709	.	T	G	5	5	10	0	0	10	0	0
10	26774943	.	G	A	2	7	9	0	1	10	0	0
10	26777572	.	A	G	2	2	4	0	0	4	0	0
10	26780983	.	T	C	1	1	2	0	0	2	0	0
10	26781140	.	T	C	2	2	4	0	0	4	0	0
10	26783968	.	C	T	7	4	11	0	1	12	0	0
10	26785456	.	G	T	3	2	5	0	0	5	0	0
10	26785477	.	A	G	3	2	5	0	0	5	0	0
10	26788593	.	C	A	3	5	8	0	0	8	0	0
10	26790603	.	G	A	4	3	7	0	0	7	0	0
10	26790668	.	T	C	0	2	2	0	0	2	0	0
10	26810892	.	T	C	0	2	2	0	0	2	0	0
10	26811229	.	C	T	1	2	3	0	0	3	0	0
10	26831923	.	G	A	3	2	5	0	0	5	0	0
10	26831965	.	G	T	0	7	7	0	1	8	0	0
10	26832002	.	T	C	2	5	7	0	0	7	0	0
10	26832007	.	A	C	2	5	7	0	0	7	0	0
10	26835004	.	G	A	3	16	19	0	1	20	0	0
10	26835024	.	T	C	3	14	17	0	0	17	0	0
10	26835066	.	A	C	4	7	11	0	0	11	0	0
10	26835081	.	T	A	4	3	7	0	0	7	0	0
10	26835172	.	T	C	1	3	4	0	0	4	0	0
10	26835299	.	G	A	6	6	12	0	1	13	0	0
10	26835595	.	G	A	5	11	16	0	3	19	0	0
10	26836990	.	G	A	8	25	33	0	3	36	0	0
10	26925040	.	G	A	0	3	3	0	3	6	0	0
10	26929291	.	A	T	1	1	2	0	0	2	0	0
10	26929459	.	C	T	5	6	11	0	0	11	0	0
10	26930061	.	C	A	2	1	3	0	0	3	0	0
10	26932632	.	C	T	15	14	29	0	2	31	0	0
10	26958093	.	A	G	2	8	10	0	0	10	0	0
10	26958150	.	G	C	5	6	11	0	1	12	0	0
10	26958321	.	T	G	3	0	3	0	3	6	0	0
10	26958457	.	A	G	2	10	12	0	0	12	0	0
10	26958470	.	G	C	3	8	11	0	0	11	0	0
10	26959424	.	T	C	2	4	6	0	0	6	0	0
10	26959523	.	T	G	1	2	3	0	0	3	0	0
10	26959528	.	T	C	1	2	3	0	0	3	0	0
10	26959662	.	T	G	4	4	8	0	0	8	0	0
10	26959744	.	G	A	4	6	10	0	0	10	0	0
10	26959811	.	A	G	4	2	6	0	0	6	0	0
10	26959894	.	C	A	2	4	6	0	0	6	0	0
10	26959992	.	G	T	8	3	11	0	0	11	0	0
10	26960015	.	C	T	6	3	9	0	0	9	0	0
10	26960212	.	A	T	7	5	12	0	1	13	0	0
10	26960281	.	A	G	6	4	10	0	0	10	0	0
10	26960333	.	T	A	2	4	6	0	0	6	0	0
10	26960358	.	G	A	1	3	4	0	0	4	0	0
10	26960370	.	T	A	1	2	3	0	0	3	0	0
10	26960397	.	A	G	1	2	3	0	0	3	0	0
10	26960458	.	C	T	0	4	4	0	0	4	0	0
10	26960480	.	A	G	2	3	5	0	0	5	0	0
10	26962406	.	T	C	0	2	2	0	0	2	0	0
10	26963839	.	T	A	1	0	1	0	0	1	0	0
10	26966316	.	A	G	3	3	6	0	0	6	0	0
10	26971782	.	C	T	2	0	2	0	0	2	0	0
10	26972064	.	T	C	7	6	13	0	0	13	0	0
10	26972152	.	T	C	10	8	18	0	2	20	0	0
10	26972349	.	T	C	4	3	7	0	0	7	0	0
10	26972364	.	T	C	5	4	9	0	0	9	0	0
10	26972409	.	G	A	6	3	9	0	1	10	0	0
10	26972429	.	A	T	4	4	8	0	0	8	0	0
10	26973454	.	T	G	3	0	3	0	5	8	0	0
10	26974414	.	T	C	1	1	2	0	0	2	0	0
10	26976990	.	G	A	1	3	4	0	2	6	0	0
10	26978271	.	C	T	1	2	3	0	0	3	0	0
10	26982532	.	G	T	1	5	6	0	0	6	0	0
10	26982572	.	C	G	1	5	6	0	0	6	0	0
10	26983539	.	G	A	2	5	7	0	1	8	0	0
10	26983612	.	G	T	2	4	6	0	0	6	0	0
10	26983619	.	T	A	1	4	5	0	0	5	0	0
10	26987399	.	T	C	10	1	11	0	7	18	0	0
10	26989818	.	A	T	14	9	23	0	1	24	0	0
10	26989843	.	A	T	13	7	20	0	0	20	0	0
10	26990173	.	C	T	1	1	2	0	0	2	0	0
10	26990287	.	C	T	1	1	2	0	0	2	0	0
10	26990333	.	G	C	2	1	3	0	0	3	0	0
10	26991487	.	T	C	1	4	5	0	0	5	0	0
10	26991514	.	C	T	5	6	11	0	0	11	0	0
10	26991556	.	C	T	10	6	16	0	1	17	0	0
10	26991674	.	A	G	8	3	11	0	0	11	0	0
10	26991785	.	C	G	4	3	7	0	0	7	0	0
10	26991811	.	G	A	2	2	4	0	0	4	0	0
10	26991835	.	G	T	3	2	5	0	0	5	0	0
10	26997147	.	C	A	9	11	20	0	1	21	0	0
10	26997218	.	G	A	14	6	20	0	1	21	0	0
10	26997222	.	A	T	13	7	20	0	1	21	0	0
10	26997294	.	T	A	6	4	10	0	0	10	0	0
10	26999165	.	T	C	12	0	12	0	17	29	0	0
10	27006367	.	A	G	14	10	24	0	2	26	0	0
10	27006386	.	G	A	13	10	23	0	1	24	0	0
10	27006413	.	A	C	9	16	25	0	0	25	0	0
10	27006447	.	T	C	6	16	22	0	0	22	0	0
10	27006490	.	A	G	13	12	25	0	0	25	0	0
10	27006721	.	T	C	4	7	11	0	1	12	0	0
10	27182735	.	T	C	3	2	5	0	1	6	0	0
10	28483542	.	A	G	2	2	4	0	1	5	0	0
10	28483561	.	G	A	3	3	6	0	0	6	0	0
10	28483585	.	T	C	1	3	4	0	0	4	0	0
10	28483869	.	T	C	2	3	5	0	0	5	0	0
10	28587609	.	G	C	2	2	4	0	0	4	0	0
10	28679049	.	G	A	0	0	0	0	1	1	0	0
10	28690862	.	T	G	2	0	2	0	1	3	0	0
10	28691024	.	C	T	1	0	1	0	0	1	0	0
10	28696000	.	A	G	0	0	0	0	1	1	0	0
10	28696336	.	C	A	0	2	2	0	1	3	0	0
10	28724220	.	G	A	4	2	6	0	0	6	0	0
10	28727265	.	C	T	6	1	7	0	0	7	0	0
10	28727461	.	C	T	5	1	6	0	0	6	0	0
10	28729808	.	G	C	5	5	10	0	0	10	0	0
10	28730216	.	C	T	7	6	13	0	0	13	0	0
10	28730249	.	C	T	4	4	8	0	0	8	0	0
10	28730345	.	T	A	3	6	9	0	0	9	0	0
10	28730446	.	A	C	7	7	14	0	0	14	0	0
10	28730647	.	T	G	1	6	7	0	0	7	0	0
10	28730880	.	T	A	10	7	17	0	0	17	0	0
10	28730913	.	G	A	13	10	23	0	3	26	0	0
10	28731001	.	C	T	8	9	17	0	1	18	0	0
10	28731072	.	C	T	12	7	19	0	0	19	0	0
10	28731155	.	A	T	7	12	19	0	0	19	0	0
10	28731289	.	T	C	15	5	20	0	2	22	0	0
10	28731333	.	C	T	4	9	13	0	0	13	0	0
10	28731372	.	G	A	1	6	7	0	6	13	0	0
10	28732003	.	C	A	18	15	33	0	0	33	0	0
10	28732104	.	T	C	12	13	25	0	0	25	0	0
10	28732601	.	C	T	1	12	13	0	15	28	0	0
10	28732785	.	T	C	17	12	29	0	3	32	0	0
10	28733067	.	G	T	18	18	36	0	0	37	1	0
10	28743800	.	T	A	6	10	16	0	0	16	0	0
10	28748741	.	C	T	0	2	2	0	1	3	0	0
10	28749053	.	A	G	3	3	6	0	0	6	0	0
10	28761022	.	C	T	5	4	9	0	0	9	0	0
10	28761049	.	C	T	6	5	11	0	0	11	0	0
10	28761094	.	G	A	8	12	20	0	1	21	0	0
10	28761100	.	G	A	12	8	20	0	1	21	0	0
10	28835635	.	C	G	3	4	7	0	0	7	0	0
10	28835655	.	G	A	4	4	8	0	0	8	0	0
10	28835701	.	A	T	6	9	15	0	2	17	0	0
10	29166445	.	A	G	2	0	2	0	0	2	0	0
10	29185800	.	C	G	19	0	19	0	20	39	0	0
10	29185863	.	T	A	4	3	7	0	0	7	0	0
10	29187908	.	C	T	4	7	11	0	0	11	0	0
10	29201671	.	C	T	7	2	9	0	0	9	0	0
10	29205655	.	A	T	2	6	8	0	0	8	0	0
10	29205679	.	G	T	0	6	6	0	1	7	0	0
10	29223795	.	T	C	1	2	3	0	0	3	0	0
10	29224364	.	C	T	2	6	8	0	3	11	0	0
10	29224484	.	G	A	8	19	27	0	0	27	0	0
10	29224598	.	A	T	19	17	36	0	3	39	0	0
10	29224651	.	C	A	8	8	16	0	2	18	0	0
10	29225032	.	A	G	7	0	7	0	12	19	0	0
10	29266376	.	C	T	23	17	40	0	2	42	0	0
10	29270092	.	A	C	4	2	6	0	0	6	0	0
10	29270225	.	C	T	6	3	9	0	1	10	0	0
10	29270291	.	T	C	5	5	10	0	0	10	0	0
10	29271915	.	C	T	5	2	7	0	1	8	0	0
10	29271980	.	A	C	2	0	2	0	1	3	0	0
10	29272693	.	C	T	2	7	9	0	0	9	0	0
10	29575542	.	C	T	4	0	4	0	1	5	0	0
10	29578478	.	C	T	10	4	14	0	1	15	0	0
10	29578738	.	C	T	4	11	15	0	0	15	0	0
10	29678313	.	G	A	3	1	4	0	0	4	0	0
10	29701347	.	C	T	7	15	22	0	1	23	0	0
10	29701405	.	G	A	0	4	4	0	6	10	0	0
10	29702103	.	G	A	2	2	4	0	0	4	0	0
10	29708080	.	C	T	7	20	27	0	1	28	0	0
10	29708095	.	T	A	9	20	29	0	1	30	0	0
10	29708154	.	A	G	13	0	13	0	14	27	0	0
10	29736255	.	G	C	1	2	3	0	0	3	0	0
10	29736314	.	C	T	0	5	5	0	3	8	0	0
10	29736736	.	T	C	3	0	3	0	4	7	0	0
10	29736895	.	T	A	1	0	1	0	0	1	0	0
10	29742656	.	C	T	1	0	1	0	0	1	0	0
10	29742795	.	T	C	2	4	6	0	0	6	0	0
10	29751221	.	T	C	4	1	5	0	5	10	0	0
10	29751638	.	G	T	11	3	14	0	0	14	0	0
10	29754464	.	G	T	3	5	8	0	0	8	0	0
10	29759186	.	A	G	2	8	10	0	1	11	0	0
10	29761405	.	C	T	4	4	8	0	0	8	0	0
10	29763146	.	A	G	7	7	14	0	0	14	0	0
10	29766766	.	C	T	1	1	2	0	0	2	0	0
10	29766795	.	T	C	4	2	6	0	0	6	0	0
10	29767470	.	G	A	4	0	4	0	1	5	0	0
10	29768405	.	G	T	3	3	6	0	0	6	0	0
10	29770277	.	C	T	2	4	6	0	0	6	0	0
10	29778375	.	A	G	4	0	4	0	3	7	0	0
10	29778396	.	C	T	5	4	9	0	0	9	0	0
10	29785682	.	C	A	9	5	14	0	0	14	0	0
10	29820495	.	G	A	5	5	10	0	0	10	0	0
10	29823484	.	G	A	3	4	7	0	0	7	0	0
10	29828696	.	T	G	0	1	1	0	1	2	0	0
10	29831556	.	G	A	5	0	5	0	0	5	0	0
10	29853684	.	A	G	12	5	17	0	21	38	0	0
10	29892283	.	C	T	0	3	3	0	4	7	0	0
10	30540800	.	C	T	6	3	9	0	0	9	0	0
10	30576004	.	T	C	5	9	14	0	0	14	0	0
10	30618121	.	C	T	1	3	4	0	0	4	0	0
10	30623408	.	G	A	5	9	14	0	0	14	0	0
10	30627092	.	A	T	5	6	11	0	1	12	0	0
10	30785055	.	T	G	2	7	9	0	0	9	0	0
10	30785463	.	G	A	4	2	6	0	0	6	0	0
10	31020810	.	A	G	0	5	5	0	2	7	0	0
10	31020866	.	T	G	1	5	6	0	0	6	0	0
10	31021450	.	C	T	4	3	7	0	1	8	0	0
10	31021553	.	G	A	9	13	22	0	2	24	0	0
10	31021611	.	C	T	8	11	19	0	0	19	0	0
10	31021676	.	G	A	14	6	20	0	0	20	0	0
10	31021811	.	C	T	0	9	9	0	16	25	0	0
10	31023824	.	C	T	1	1	2	0	0	2	0	0
10	31031543	.	C	T	0	1	1	0	2	3	0	0
10	31034999	.	C	T	1	2	3	0	0	3	0	0
10	31035030	.	G	A	5	5	10	0	0	10	0	0
10	31035129	.	C	T	4	6	10	0	0	10	0	0
10	31040834	.	G	A	1	2	3	0	0	3	0	0
10	31276696	.	G	A	0	2	2	0	0	2	0	0
10	31280159	.	C	G	2	0	2	0	4	6	0	0
10	31280293	.	G	A	2	2	4	0	0	4	0	0
10	31306727	.	C	T	0	11	11	0	14	25	0	0
10	31306956	.	C	G	0	2	2	0	7	9	0	0
10	31315631	.	C	T	0	8	8	0	6	14	0	0
10	31317976	.	T	C	9	19	28	0	2	30	0	0
10	31317978	.	A	G	10	18	28	0	1	30	1	0
10	31325248	.	C	A	7	11	18	0	0	18	0	0
10	31326235	.	T	C	0	0	0	0	5	5	0	0
10	31328373	.	A	T	3	7	10	0	1	11	0	0
10	31328609	.	G	A	0	3	3	0	0	3	0	0
10	31328612	.	A	C	3	0	3	0	0	3	0	0
10	31337822	.	G	A	7	7	14	0	3	17	0	0
10	31354096	.	A	G	1	4	5	0	0	5	0	0
10	31628325	.	A	C	4	6	10	0	0	10	0	0
10	31628397	.	C	T	1	4	5	0	0	5	0	0
10	31628406	.	C	T	2	4	6	0	0	6	0	0
10	31632313	.	G	C	3	6	9	0	0	9	0	0
10	31632691	.	G	A	3	4	7	0	0	7	0	0
10	31632758	.	A	T	3	3	6	0	0	6	0	0
10	31632829	.	A	G	4	4	8	0	0	8	0	0
10	31632838	.	C	T	5	3	8	0	0	8	0	0
10	31632945	.	C	T	3	7	10	0	0	10	0	0
10	31633036	.	T	C	1	6	7	0	0	7	0	0
10	31633424	.	A	G	1	2	3	0	0	3	0	0
10	31633438	.	T	A	2	2	4	0	0	4	0	0
10	31633640	.	G	A	1	3	4	0	0	4	0	0
10	31725473	.	G	A	0	3	3	0	1	4	0	0
10	31725697	.	C	T	3	5	8	0	0	8	0	0
10	31725736	.	T	C	6	3	9	0	0	9	0	0
10	31725851	.	A	C	2	0	2	0	9	11	0	0
10	31738616	.	A	G	4	8	12	0	2	14	0	0
10	31739346	.	G	T	19	25	44	0	4	48	0	0
10	31757307	.	C	T	29	24	53	0	2	55	0	0
10	31772112	.	A	G	9	4	13	0	0	13	0	0
10	31800313	.	A	G	8	5	13	0	0	13	0	0
10	31803651	.	G	A	9	8	17	0	0	17	0	0
10	31805648	.	C	T	5	6	11	0	0	11	0	0
10	31805736	.	G	A	1	5	6	0	0	6	0	0
10	31951383	.	G	A	3	5	8	0	0	8	0	0
10	31951431	.	G	A	4	3	7	0	0	7	0	0
10	31951489	.	G	T	1	2	3	0	0	3	0	0
10	31953565	.	A	G	5	4	9	0	0	9	0	0
10	31953744	.	C	A	4	4	8	0	0	8	0	0
10	32036978	.	G	A	3	1	4	0	0	4	0	0
10	32037355	.	C	T	1	3	4	0	0	4	0	0
10	32037373	.	T	C	1	3	4	0	0	4	0	0
10	32037418	.	C	T	1	4	5	0	0	5	0	0
10	32037428	.	T	C	1	4	5	0	0	5	0	0
10	32058797	.	T	G	5	0	5	0	1	6	0	0
10	32062434	.	G	A	1	2	3	0	0	3	0	0
10	32063266	.	T	A	1	4	5	0	0	5	0	0
10	32063275	.	A	G	1	0	1	0	3	4	0	0
10	32063809	.	A	G	3	3	6	0	0	6	0	0
10	32106223	.	G	A	0	2	2	0	1	3	0	0
10	32107479	.	C	A	0	2	2	0	0	2	0	0
10	32122465	.	A	T	1	2	3	0	0	3	0	0
10	32122662	.	C	T	2	1	3	0	0	3	0	0
10	32122727	.	T	C	0	3	3	0	0	3	0	0
10	32123090	.	C	T	1	2	3	0	0	3	0	0
10	32561338	.	G	A	4	12	16	0	0	16	0	0
10	32561392	.	A	T	5	16	21	0	0	21	0	0
10	32561398	.	G	A	0	14	14	0	6	20	0	0
10	32561427	.	A	C	10	15	25	0	0	25	0	0
10	32561437	.	T	A	11	11	22	0	0	22	0	0
10	32561615	.	C	G	8	8	16	0	0	16	0	0
10	32562267	.	C	T	7	8	15	0	1	16	0	0
10	32577621	.	G	A	8	9	17	0	0	17	0	0
10	32581221	.	G	A	11	6	17	0	1	18	0	0
10	32600809	.	A	G	4	0	4	0	9	13	0	0
10	32600810	.	T	C	3	9	12	0	1	13	0	0
10	32600927	.	C	T	34	12	46	0	1	47	0	0
10	32648649	.	C	T	2	2	4	0	0	4	0	0
10	32648799	.	C	T	2	9	11	0	0	11	0	0
10	32657586	.	A	G	4	5	9	0	0	9	0	0
10	32657591	.	C	A	5	5	10	0	0	10	0	0
10	32657893	.	G	A	15	17	32	0	1	33	0	0
10	32657980	.	A	G	7	16	23	0	1	24	0	0
10	32660658	.	A	C	1	4	5	0	0	5	0	0
10	32780271	.	A	C	13	11	24	0	0	24	0	0
10	32783974	.	A	C	3	5	8	0	1	9	0	0
10	32787910	.	C	T	9	7	16	0	0	16	0	0
10	32788457	.	A	T	9	5	14	0	1	15	0	0
10	32788504	.	A	T	5	8	13	0	0	13	0	0
10	32788633	.	T	C	6	18	24	0	2	26	0	0
10	32788663	.	T	C	11	15	26	0	1	27	0	0
10	32809986	.	G	C	13	11	24	0	0	24	0	0
10	32810279	.	T	A	17	9	26	0	2	28	0	0
10	32810340	.	A	T	14	9	23	0	1	24	0	0
10	32810579	.	T	C	14	0	14	0	7	21	0	0
10	32810593	.	A	T	5	12	17	0	0	17	0	0
10	32811010	.	C	T	0	6	6	0	6	12	0	0
10	32811102	.	T	A	9	9	18	0	1	19	0	0
10	32817924	.	C	A	0	6	6	0	6	12	0	0
10	32820412	.	A	G	7	5	12	0	2	14	0	0
10	32820426	.	T	A	7	9	16	0	1	17	0	0
10	32820451	.	G	T	6	12	18	0	1	19	0	0
10	32820577	.	T	C	9	0	9	0	10	19	0	0
10	32823131	.	C	T	1	0	1	0	0	1	0	0
10	32823146	.	G	A	0	1	1	0	0	1	0	0
10	32831269	.	G	A	9	6	15	0	3	18	0	0
10	32831671	.	T	C	2	0	2	0	3	5	0	0
10	32831683	.	C	G	1	1	2	0	0	2	0	0
10	32840835	.	C	T	0	9	9	0	3	12	0	0
10	32843827	.	C	G	2	2	4	0	0	4	0	0
10	32856993	.	C	A	5	4	9	0	0	9	0	0
10	32856999	.	T	A	5	5	10	0	0	10	0	0
10	32857034	.	C	G	8	6	14	0	0	14	0	0
10	32857329	.	T	C	15	0	15	0	7	22	0	0
10	32857382	.	T	C	21	0	21	0	6	27	0	0
10	32857386	.	C	T	3	25	28	0	0	28	0	0
10	32857557	.	T	C	10	10	20	0	1	21	0	0
10	32857738	.	A	G	7	10	17	0	0	17	0	0
10	32857746	.	A	T	10	6	16	0	1	17	0	0
10	32857898	.	C	T	15	9	24	0	0	24	0	0
10	32857948	.	T	G	12	9	21	0	0	22	1	0
10	32858107	.	A	G	8	9	17	0	0	17	0	0
10	32858132	.	T	C	12	0	12	0	12	24	0	0
10	32858158	.	C	G	6	15	21	0	0	21	0	0
10	32858215	.	T	A	12	12	24	0	1	25	0	0
10	32858361	.	T	C	18	17	35	0	2	37	0	0
10	32858425	.	G	C	12	17	29	0	2	31	0	0
10	32858607	.	C	T	12	8	20	0	0	20	0	0
10	32858612	.	T	A	7	11	18	0	1	19	0	0
10	32858642	.	G	C	9	16	25	0	0	25	0	0
10	32861106	.	G	A	13	9	22	0	1	23	0	0
10	32861118	.	T	G	16	14	30	0	0	30	0	0
10	32874849	.	G	A	19	12	31	0	0	31	0	0
10	32881787	.	C	T	1	8	9	0	14	23	0	0
10	32881823	.	G	A	12	13	25	0	0	25	0	0
10	32881884	.	C	T	13	9	22	0	0	22	0	0
10	32881904	.	A	G	14	6	20	0	0	20	0	0
10	32882022	.	A	G	4	8	12	0	1	13	0	0
10	32882056	.	G	A	7	9	16	0	0	16	0	0
10	32882080	.	A	T	7	11	18	0	0	18	0	0
10	32882156	.	T	G	14	19	33	0	1	34	0	0
10	32882495	.	T	C	0	8	8	0	0	8	0	0
10	32882515	.	C	T	0	6	6	0	0	6	0	0
10	32882683	.	G	T	3	13	16	0	2	18	0	0
10	32882686	.	A	T	3	13	16	0	1	17	0	0
10	32882732	.	C	A	6	12	18	0	1	19	0	0
10	32882977	.	C	A	0	13	13	0	12	25	0	0
10	32890201	.	C	T	0	1	1	0	5	6	0	0
10	32899276	.	T	A	7	12	19	0	0	19	0	0
10	32899807	.	T	C	7	5	12	0	1	13	0	0
10	32899986	.	T	G	8	10	18	0	1	19	0	0
10	32899988	.	T	C	7	0	7	0	12	19	0	0
10	32900021	.	T	C	11	2	13	0	0	13	0	0
10	32900469	.	T	G	5	8	13	0	1	14	0	0
10	32900642	.	A	T	9	5	14	0	0	14	0	0
10	32901915	.	A	T	5	3	8	0	0	8	0	0
10	32902159	.	T	C	3	0	3	0	5	8	0	0
10	32902481	.	G	C	3	4	7	0	0	7	0	0
10	32903589	.	C	T	0	8	8	0	4	12	0	0
10	32912847	.	T	G	4	1	5	0	0	5	0	0
10	32912883	.	C	G	1	1	2	0	0	2	0	0
10	32920415	.	A	G	1	3	4	0	0	4	0	0
10	32920574	.	G	T	1	5	6	0	0	6	0	0
10	32920649	.	A	G	3	2	5	0	0	5	0	0
10	32939399	.	C	T	0	3	3	0	2	5	0	0
10	32950508	.	C	T	0	1	1	0	4	5	0	0
10	32963546	.	A	G	2	2	4	0	1	5	0	0
10	32963555	.	T	C	2	3	5	0	1	6	0	0
10	32963924	.	G	A	5	2	7	0	0	7	0	0
10	32963960	.	C	G	6	4	10	0	1	11	0	0
10	32964089	.	C	T	0	4	4	0	2	6	0	0
10	33254930	.	G	A	5	3	8	0	0	8	0	0
10	33255113	.	G	A	4	8	12	0	0	12	0	0
10	33260487	.	G	T	5	5	10	0	0	10	0	0
10	33260681	.	G	T	1	2	3	0	0	3	0	0
10	33260682	.	G	A	2	1	3	0	0	3	0	0
10	33265240	.	T	C	1	0	1	0	1	2	0	0
10	33314237	.	T	A	1	1	2	0	0	2	0	0
10	33325241	.	T	C	1	1	2	0	0	2	0	0
10	33340591	.	C	T	2	2	4	0	0	4	0	0
10	33342292	.	T	C	2	2	4	0	0	4	0	0
10	33369860	.	T	A	8	4	12	0	1	13	0	0
10	33369973	.	C	A	6	16	22	0	1	23	0	0
10	33373568	.	C	G	0	5	5	0	4	9	0	0
10	33375478	.	C	T	4	4	8	0	1	9	0	0
10	33385363	.	G	A	21	33	54	0	3	57	0	0
10	33389469	.	A	G	12	0	12	0	9	21	0	0
10	33391844	.	G	A	33	21	54	0	2	56	0	0
10	33391930	.	G	A	22	13	35	0	9	44	0	0
10	33392071	.	T	C	17	19	36	0	3	39	0	0
10	33392103	.	G	A	15	18	33	0	1	34	0	0
10	33392199	.	A	G	9	21	30	0	0	30	0	0
10	33392263	.	A	G	8	11	19	0	0	19	0	0
10	33392264	.	C	T	11	8	19	0	0	19	0	0
10	33392370	.	T	C	18	11	29	0	2	31	0	0
10	33392805	.	C	A	2	4	6	0	0	6	0	0
10	33392815	.	C	T	3	4	7	0	0	7	0	0
10	33393021	.	C	A	2	3	5	0	0	5	0	0
10	33393054	.	T	A	3	2	5	0	0	5	0	0
10	33393129	.	A	T	1	2	3	0	0	3	0	0
10	33573861	.	A	T	1	0	1	0	0	1	0	0
10	33573866	.	A	T	1	0	1	0	0	1	0	0
10	33574138	.	A	C	1	2	3	0	0	3	0	0
10	33574332	.	A	T	1	0	1	0	0	1	0	0
10	33576423	.	T	C	1	1	2	0	0	2	0	0
10	33576509	.	T	C	4	3	7	0	0	7	0	0
10	33576518	.	T	C	3	3	6	0	0	6	0	0
10	33578719	.	A	T	1	3	4	0	0	4	0	0
10	33578816	.	T	A	5	7	12	0	0	12	0	0
10	33579037	.	C	T	2	3	5	0	0	5	0	0
10	33614545	.	G	A	2	3	5	0	0	5	0	0
10	33626400	.	C	T	1	2	3	0	0	3	0	0
10	33626437	.	A	C	1	1	2	0	1	3	0	0
10	33626475	.	A	G	1	0	1	0	0	1	0	0
10	33646917	.	G	T	0	2	2	0	4	6	0	0
10	33646957	.	G	A	2	0	2	0	0	2	0	0
10	33698487	.	G	C	3	2	5	0	0	5	0	0
10	33863568	.	G	A	3	2	5	0	0	5	0	0
10	33866987	.	T	A	7	12	19	0	3	22	0	0
10	33867032	.	G	A	4	7	11	0	1	12	0	0
10	33867365	.	C	T	6	8	14	0	0	14	0	0
10	33867394	.	G	A	8	5	13	0	2	15	0	0
10	33902212	.	A	G	0	0	0	0	4	4	0	0
10	33902326	.	C	A	2	2	4	0	0	4	0	0
10	33908183	.	C	A	1	2	3	0	0	3	0	0
10	33908291	.	C	T	0	1	1	0	0	1	0	0
10	33909979	.	G	A	0	2	2	0	0	2	0	0
10	33917015	.	G	A	0	1	1	0	0	1	0	0
10	33921928	.	A	G	0	2	2	0	0	2	0	0
10	33921934	.	T	C	0	2	2	0	0	2	0	0
10	33924255	.	G	A	0	5	5	0	4	9	0	0
10	33930351	.	T	C	1	2	3	0	0	3	0	0
10	33930780	.	T	G	2	1	3	0	0	3	0	0
10	33932844	.	G	A	4	4	8	0	1	9	0	0
10	33932859	.	C	T	4	4	8	0	0	8	0	0
10	33942126	.	C	T	1	1	2	0	0	2	0	0
10	33942210	.	C	T	0	2	2	0	0	3	1	0
10	33956690	.	G	A	0	7	7	0	11	18	0	0
10	33957780	.	C	T	5	7	12	0	0	12	0	0
10	33958750	.	T	C	8	8	16	0	0	16	0	0
10	33958813	.	T	C	8	8	16	0	0	16	0	0
10	33960943	.	C	T	10	13	23	0	1	24	0	0
10	33961048	.	G	A	2	12	14	0	10	24	0	0
10	33961093	.	A	T	9	7	16	0	0	16	0	0
10	33982165	.	G	A	8	16	24	0	0	24	0	0
10	33983870	.	A	G	3	3	6	0	0	6	0	0
10	33989820	.	G	A	4	0	4	1	0	5	0	0
10	33994424	.	A	G	10	10	20	0	1	21	0	0
10	33994445	.	A	G	13	14	27	0	1	28	0	0
10	33994475	.	C	T	14	20	34	0	1	35	0	0
10	34025077	.	T	C	3	5	8	0	0	8	0	0
10	34025104	.	C	T	2	4	6	0	0	6	0	0
10	34378110	.	T	G	7	0	7	0	5	12	0	0
10	34383783	.	A	T	5	9	14	0	1	15	0	0
10	34383843	.	G	A	1	3	4	0	1	5	0	0
10	34383858	.	A	G	0	1	1	0	0	1	0	0
10	34388882	.	T	G	8	11	19	0	1	20	0	0
10	34388888	.	G	A	9	10	19	0	0	19	0	0
10	34394653	.	G	A	7	9	16	0	0	16	0	0
10	34396026	.	G	A	8	5	13	0	0	13	0	0
10	34403615	.	A	G	10	10	20	0	0	20	0	0
10	34403668	.	A	T	11	12	23	0	0	23	0	0
10	34403965	.	A	T	13	4	17	0	1	18	0	0
10	34403980	.	A	G	13	0	13	0	7	20	0	0
10	34404015	.	G	A	10	4	14	0	1	15	0	0
10	34404028	.	T	G	9	6	15	0	1	16	0	0
10	34404154	.	T	C	5	2	7	0	0	7	0	0
10	34404593	.	T	C	5	4	9	0	1	10	0	0
10	34426656	.	C	T	3	3	6	0	0	6	0	0
10	34572353	.	T	C	1	3	4	0	0	4	0	0
10	34588818	.	G	T	0	4	4	0	0	4	0	0
10	34588872	.	C	T	3	4	7	0	0	7	0	0
10	34588881	.	C	T	3	3	6	0	0	6	0	0
10	34606549	.	T	C	4	2	6	0	0	6	0	0
10	34657676	.	C	T	2	3	5	0	0	5	0	0
10	34661857	.	A	G	8	5	13	0	1	14	0	0
10	34662184	.	C	T	3	7	10	0	0	10	0	0
10	34662223	.	C	A	7	9	16	0	1	17	0	0
10	34662334	.	T	C	5	4	9	0	0	9	0	0
10	34662349	.	C	T	4	4	8	0	1	9	0	0
10	34662437	.	C	T	5	5	10	0	0	10	0	0
10	34662481	.	A	T	4	6	10	0	0	10	0	0
10	34664906	.	G	A	5	4	9	0	0	9	0	0
10	34665053	.	G	A	1	3	4	0	6	10	0	0
10	34673597	.	C	T	2	3	5	0	0	5	0	0
10	34676338	.	C	T	9	6	15	0	0	15	0	0
10	34699238	.	C	T	1	2	3	0	0	3	0	0
10	34703742	.	G	A	3	2	5	0	0	5	0	0
10	34709708	.	G	C	1	1	2	0	0	2	0	0
10	34709940	.	C	T	3	8	11	0	1	12	0	0
10	34714789	.	C	T	5	9	14	0	1	15	0	0
10	34724906	.	C	T	3	6	9	0	0	9	0	0
10	34729552	.	G	A	12	14	26	0	1	27	0	0
10	34729693	.	C	T	0	3	3	0	0	3	0	0
10	34733566	.	A	G	31	17	48	0	1	49	0	0
10	34733661	.	C	T	14	15	29	0	12	41	0	0
10	34733883	.	A	T	17	20	37	0	2	39	0	0
10	34734714	.	A	T	19	21	40	0	1	41	0	0
10	34734743	.	T	G	14	18	32	0	0	32	0	0
10	34734785	.	G	T	20	9	29	0	1	30	0	0
10	34737919	.	T	C	22	18	40	0	3	43	0	0
10	34738213	.	C	T	3	13	16	0	37	54	1	0
10	34754660	.	C	T	14	24	38	0	2	40	0	0
10	34813299	.	T	C	7	3	10	0	0	10	0	0
10	34867466	.	C	T	1	2	3	0	0	3	0	0
10	34870579	.	C	T	3	6	9	0	1	10	0	0
10	34913407	.	G	A	1	4	5	0	0	5	0	0
10	34961244	.	G	T	11	3	14	0	0	14	0	0
10	34961309	.	A	G	10	10	20	0	2	22	0	0
10	34961311	.	T	C	10	11	21	0	1	22	0	0
10	34961403	.	T	C	10	9	19	0	0	19	0	0
10	34961405	.	C	T	10	9	19	0	0	19	0	0
10	34961480	.	C	A	7	5	12	0	0	12	0	0
10	34961520	.	T	C	11	5	16	0	0	16	0	0
10	34961669	.	A	G	8	4	12	0	0	12	0	0
10	34969984	.	A	G	1	3	4	0	0	4	0	0
10	34989149	.	T	C	10	0	10	0	11	21	0	0
10	34992565	.	A	G	0	1	1	0	0	1	0	0
10	34998281	.	G	C	7	5	12	0	0	12	0	0
10	35002653	.	C	A	7	3	10	0	0	10	0	0
10	35002655	.	T	A	7	3	10	0	0	10	0	0
10	35008963	.	C	T	1	2	3	0	0	3	0	0
10	35011337	.	A	G	2	4	6	0	1	7	0	0
10	35029067	.	T	C	4	1	5	0	2	7	0	0
10	35029172	.	G	A	3	5	8	0	1	9	0	0
10	35032792	.	A	G	2	2	4	0	0	4	0	0
10	35046093	.	C	T	1	1	2	0	0	2	0	0
10	35063944	.	C	T	7	5	12	0	0	12	0	0
10	35064268	.	T	G	3	2	5	0	0	5	0	0
10	35108561	.	A	G	1	1	2	0	0	2	0	0
10	35108590	.	G	T	2	2	4	0	0	4	0	0
10	35153051	.	G	T	5	4	9	0	0	9	0	0
10	35156473	.	C	T	3	1	4	0	0	4	0	0
10	35156485	.	A	C	3	1	4	0	0	4	0	0
10	35160454	.	T	G	4	0	4	0	4	8	0	0
10	35163358	.	T	A	2	1	3	0	0	3	0	0
10	35163406	.	G	A	5	3	8	0	0	8	0	0
10	35170265	.	A	G	3	2	5	0	1	6	0	0
10	35177270	.	A	T	2	2	4	0	0	4	0	0
10	35177324	.	A	G	5	3	8	0	1	9	0	0
10	35177357	.	G	A	6	5	11	0	1	12	0	0
10	35177375	.	G	C	7	0	7	0	6	13	0	0
10	35177537	.	G	A	6	8	14	0	1	15	0	0
10	35178440	.	A	T	8	5	13	0	3	16	0	0
10	35178518	.	A	T	0	4	4	0	1	5	0	0
10	35180253	.	G	C	3	4	7	0	0	7	0	0
10	35180273	.	C	T	3	4	7	0	0	7	0	0
10	35182580	.	A	T	1	2	3	0	0	3	0	0
10	35185979	.	G	C	1	3	4	0	0	4	0	0
10	35220214	.	C	T	1	1	2	0	0	2	0	0
10	35220292	.	A	G	1	2	3	0	0	3	0	0
10	35236801	.	T	G	2	2	4	0	0	4	0	0
10	35241646	.	A	T	7	5	12	0	0	12	0	0
10	35242113	.	C	G	6	7	13	0	0	13	0	0
10	35245939	.	T	A	3	3	6	0	0	6	0	0
10	35245951	.	C	T	2	3	5	0	0	5	0	0
10	35247387	.	T	C	8	3	11	0	3	14	0	0
10	35247818	.	A	G	3	3	6	0	0	6	0	0
10	35247905	.	G	A	4	4	8	0	0	8	0	0
10	35247980	.	G	C	1	0	1	0	4	5	0	0
10	35248280	.	T	C	3	0	3	0	5	8	0	0
10	35248433	.	G	A	1	8	9	0	0	9	0	0
10	35265206	.	T	A	2	4	6	0	0	6	0	0
10	35281335	.	C	T	7	3	10	0	0	10	0	0
10	35292112	.	G	A	0	0	0	0	1	1	0	0
10	35298732	.	A	G	4	5	9	0	1	10	0	0
10	35307579	.	C	T	3	2	5	0	0	5	0	0
10	35311926	.	C	G	18	18	36	0	0	36	0	0
10	35312253	.	C	T	5	10	15	0	0	15	0	0
10	35312682	.	C	G	3	3	6	0	1	7	0	0
10	35541245	.	T	C	0	8	8	0	1	9	0	0
10	35590076	.	T	A	4	0	4	0	0	4	0	0
10	35592817	.	A	G	5	5	10	0	1	11	0	0
10	35592830	.	G	A	4	8	12	0	1	13	0	0
10	35595669	.	T	A	4	4	8	0	0	8	0	0
10	35600397	.	T	C	1	3	4	0	0	4	0	0
10	35600529	.	G	T	3	0	3	0	0	3	0	0
10	35602535	.	G	T	4	2	6	0	0	6	0	0
10	35602756	.	T	C	2	3	5	0	0	5	0	0
10	35606506	.	C	A	4	2	6	0	0	6	0	0
10	35610852	.	C	A	0	4	4	0	0	4	0	0
10	35610899	.	T	C	2	4	6	0	0	6	0	0
10	35610961	.	T	G	3	2	5	0	1	6	0	0
10	35611227	.	G	T	3	4	7	0	0	7	0	0
10	35611367	.	G	A	2	2	4	0	0	4	0	0
10	35611436	.	C	T	2	4	6	0	0	6	0	0
10	35611800	.	C	A	1	0	1	0	1	2	0	0
10	35611843	.	C	A	1	1	2	0	0	2	0	0
10	35664503	.	G	A	4	2	6	0	0	6	0	0
10	35664509	.	C	T	2	2	4	0	2	6	0	0
10	35664575	.	C	A	2	2	4	0	1	5	0	0
10	35953370	.	G	A	1	2	3	0	0	3	0	0
10	35953491	.	T	C	3	1	4	0	0	4	0	0
10	35959133	.	C	A	4	3	7	0	0	7	0	0
10	35959163	.	T	C	6	5	11	0	0	11	0	0
10	35959223	.	T	C	5	7	12	0	0	12	0	0
10	35959400	.	T	C	3	4	7	0	0	7	0	0
10	36029893	.	T	C	13	10	23	0	0	23	0	0
10	36040404	.	T	C	2	2	4	0	0	4	0	0
10	36049738	.	G	A	1	3	4	0	0	4	0	0
10	36054226	.	C	T	2	4	6	0	0	6	0	0
10	36092663	.	T	A	2	2	4	0	0	4	0	0
10	36092696	.	C	T	2	2	4	0	0	4	0	0
10	36095614	.	T	C	3	6	9	0	0	9	0	0
10	36095869	.	T	C	0	2	2	0	0	2	0	0
10	36098253	.	A	C	1	2	3	0	0	3	0	0
10	36101022	.	A	G	1	0	1	0	2	3	0	0
10	36156629	.	G	A	1	2	3	0	0	3	0	0
10	36159159	.	A	T	2	3	5	0	0	5	0	0
10	36159166	.	G	A	2	4	6	0	0	6	0	0
10	36159219	.	G	A	3	2	5	0	0	5	0	0
10	36159432	.	G	C	1	4	5	0	0	5	0	0
10	36160027	.	C	T	1	2	3	0	0	3	0	0
10	36160041	.	G	A	1	1	2	0	1	3	0	0
10	36363557	.	A	G	8	12	20	0	0	20	0	0
10	36363611	.	C	T	15	14	29	0	1	30	0	0
10	36363818	.	G	T	1	13	14	0	1	15	0	0
10	36363937	.	G	A	18	19	37	0	2	39	0	0
10	36363971	.	C	T	0	19	19	0	12	31	0	0
10	36364172	.	A	G	22	14	36	0	0	36	0	0
10	36405921	.	C	T	25	11	36	0	3	39	0	0
10	36406039	.	G	T	7	14	21	0	3	24	0	0
10	36406106	.	T	A	4	10	14	0	0	14	0	0
10	36406210	.	G	A	11	15	26	0	0	26	0	0
10	36441553	.	T	C	5	2	7	0	0	7	0	0
10	36443018	.	T	C	8	9	17	0	4	21	0	0
10	36443541	.	T	C	16	14	30	0	2	32	0	0
10	36443676	.	G	A	0	14	14	0	4	18	0	0
10	36443714	.	G	A	4	12	16	0	0	16	0	0
10	36443818	.	T	G	3	0	3	0	5	8	0	0
10	36446799	.	A	T	3	2	5	0	0	5	0	0
10	36451615	.	T	C	5	1	6	0	0	6	0	0
10	36451661	.	G	A	21	11	32	0	2	34	0	0
10	36454567	.	C	A	15	13	28	0	0	28	0	0
10	36454649	.	A	G	14	0	14	0	25	39	0	0
10	36454650	.	C	A	18	20	38	0	1	39	0	0
10	36454902	.	G	T	18	16	34	0	2	36	0	0
10	36455146	.	C	T	19	15	34	0	1	36	1	0
10	36455215	.	T	C	11	13	24	0	1	25	0	0
10	36455229	.	C	G	13	14	27	0	1	28	0	0
10	36455344	.	A	G	15	21	36	0	0	36	0	0
10	36455847	.	G	A	0	6	6	0	6	12	0	0
10	36476481	.	C	T	0	14	14	0	13	27	0	0
10	36476529	.	C	T	12	9	21	0	0	21	0	0
10	36476639	.	C	T	0	13	13	0	10	23	0	0
10	36476717	.	A	G	17	13	30	0	0	30	0	0
10	36476834	.	G	A	19	10	29	0	1	30	0	0
10	36476852	.	A	G	15	12	27	0	1	28	0	0
10	36476922	.	C	T	1	3	4	0	0	4	0	0
10	36481915	.	A	C	10	9	19	0	2	21	0	0
10	36482588	.	G	A	10	11	21	0	1	22	0	0
10	36487530	.	G	A	7	6	13	0	0	13	0	0
10	36489882	.	A	G	4	2	6	0	0	6	0	0
10	36489893	.	A	G	5	2	7	0	0	7	0	0
10	36492091	.	C	T	3	0	3	0	0	3	0	0
10	36494336	.	G	A	2	3	5	0	0	5	0	0
10	36494590	.	C	G	3	2	5	0	0	5	0	0
10	36495580	.	T	G	1	0	1	0	0	1	0	0
10	36496544	.	A	G	3	8	11	0	0	11	0	0
10	36496595	.	G	A	1	4	5	0	0	5	0	0
10	36498379	.	C	T	0	7	7	0	2	9	0	0
10	36498397	.	G	A	2	7	9	0	0	9	0	0
10	36500581	.	C	T	5	1	6	0	0	6	0	0
10	36500674	.	G	A	1	2	3	0	0	3	0	0
10	36504163	.	C	T	0	0	0	0	1	1	0	0
10	36506103	.	G	A	2	2	4	0	0	4	0	0
10	36506290	.	C	T	0	3	3	0	5	8	0	0
10	36506630	.	T	A	3	2	5	0	0	5	0	0
10	36518643	.	C	T	1	0	1	0	0	1	0	0
10	36519788	.	T	C	2	1	3	0	0	3	0	0
10	36520003	.	C	T	0	1	1	0	0	1	0	0
10	36520711	.	G	A	3	8	11	0	1	12	0	0
10	36520945	.	A	G	2	3	5	0	3	8	0	0
10	36521605	.	C	T	0	2	2	0	1	3	0	0
10	36522602	.	A	C	2	0	2	0	3	5	0	0
10	36523826	.	G	A	2	2	4	0	0	4	0	0
10	36528549	.	A	G	1	2	3	0	0	3	0	0
10	36558839	.	A	G	5	10	15	0	0	15	0	0
10	36558895	.	G	A	14	14	28	0	2	30	0	0
10	36570469	.	A	G	12	8	20	0	0	20	0	0
10	36572622	.	G	A	3	3	6	0	0	6	0	0
10	36572640	.	C	A	0	6	6	0	4	10	0	0
10	36572814	.	A	T	1	4	5	0	0	5	0	0
10	36575980	.	G	A	3	2	5	0	0	5	0	0
10	36575992	.	C	T	1	1	2	0	0	2	0	0
10	36584462	.	T	C	4	2	6	0	0	6	0	0
10	36613095	.	T	C	12	4	16	0	0	16	0	0
10	36613145	.	G	T	12	5	17	0	0	17	0	0
10	36613164	.	C	T	0	4	4	0	11	15	0	0
10	36613276	.	C	T	9	9	18	0	1	19	0	0
10	36615367	.	G	A	0	2	2	0	0	2	0	0
10	36615907	.	C	A	9	4	13	0	0	13	0	0
10	36618435	.	C	T	1	7	8	0	11	19	0	0
10	36618787	.	C	T	0	3	3	0	1	4	0	0
10	36625258	.	C	A	0	5	5	0	11	16	0	0
10	36625534	.	G	A	4	5	9	0	1	10	0	0
10	36625602	.	C	G	9	9	18	0	0	18	0	0
10	36625761	.	T	A	9	8	17	0	0	17	0	0
10	36626201	.	C	T	2	2	4	0	0	4	0	0
10	36627009	.	G	C	8	5	13	0	0	13	0	0
10	36627390	.	A	G	2	8	10	0	1	11	0	0
10	36627414	.	C	A	8	4	12	0	0	12	0	0
10	36627820	.	C	T	4	7	11	0	0	11	0	0
10	36628009	.	C	A	2	5	7	0	1	8	0	0
10	36628012	.	G	A	2	5	7	0	0	7	0	0
10	36628569	.	C	T	0	2	2	0	2	4	0	0
10	36628626	.	G	A	3	3	6	0	0	6	0	0
10	36665829	.	C	T	1	2	3	0	0	3	0	0
10	36670106	.	T	C	2	3	5	0	0	5	0	0
10	36688455	.	C	T	4	3	7	0	0	7	0	0
10	36689850	.	G	T	1	0	1	0	0	1	0	0
10	36689893	.	A	G	1	0	1	0	0	1	0	0
10	36695781	.	G	C	13	11	24	0	1	25	0	0
10	36695785	.	C	T	12	11	23	0	2	25	0	0
10	36704842	.	A	G	12	11	23	0	0	23	0	0
10	36708401	.	A	G	6	0	6	0	7	13	0	0
10	36708453	.	C	T	8	5	13	0	0	13	0	0
10	36710559	.	A	C	10	14	24	0	2	26	0	0
10	36710599	.	C	T	21	7	28	0	0	28	0	0
10	36710871	.	G	A	2	15	17	0	19	36	0	0
10	36710893	.	G	T	1	21	22	0	17	39	0	0
10	36711260	.	T	A	2	9	11	0	1	12	0	0
10	36711329	.	T	A	8	8	16	0	2	18	0	0
10	36711613	.	C	T	10	7	17	0	2	19	0	0
10	36774339	.	A	C	3	2	5	0	0	5	0	0
10	36778469	.	A	G	0	1	1	0	0	1	0	0
10	36784948	.	G	A	1	4	5	0	0	5	0	0
10	36796083	.	A	G	2	4	6	0	0	6	0	0
10	36796131	.	T	A	4	5	9	0	1	10	0	0
10	36800465	.	G	A	11	6	17	0	0	17	0	0
10	36800518	.	C	T	8	11	19	0	0	19	0	0
10	36800600	.	G	A	5	4	9	0	0	9	0	0
10	36800642	.	A	G	4	9	13	0	0	13	0	0
10	36807986	.	G	A	5	3	8	0	0	8	0	0
10	36808032	.	G	A	8	7	15	0	0	15	0	0
10	36808096	.	A	G	1	4	5	0	0	5	0	0
10	36811815	.	A	G	9	9	18	0	0	18	0	0
10	36812214	.	A	C	4	4	8	0	0	8	0	0
10	36814912	.	G	A	3	3	6	0	0	6	0	0
10	36815330	.	T	C	6	0	6	0	1	7	0	0
10	36817197	.	A	C	3	1	4	0	0	4	0	0
10	36817355	.	C	T	0	2	2	0	6	8	0	0
10	36817530	.	C	T	6	6	12	0	1	13	0	0
10	36817940	.	T	C	4	5	9	0	0	9	0	0
10	36817979	.	T	G	1	1	2	0	0	2	0	0
10	36819664	.	G	T	3	7	10	0	0	10	0	0
10	36819671	.	C	T	8	3	11	0	0	11	0	0
10	36820601	.	C	T	0	5	5	0	7	12	0	0
10	36820611	.	A	G	6	8	14	0	0	14	0	0
10	36820664	.	C	T	5	6	11	0	0	11	0	0
10	36820688	.	C	G	0	5	5	0	7	12	0	0
10	36820736	.	G	A	7	8	15	0	0	15	0	0
10	36820769	.	T	A	4	9	13	0	2	15	0	0
10	36820892	.	G	A	1	6	7	0	0	7	0	0
10	36825119	.	G	A	0	1	1	0	0	1	0	0
10	36825192	.	C	T	1	2	3	0	4	7	0	0
10	36825650	.	C	T	0	3	3	0	1	4	0	0
10	36825818	.	T	C	1	2	3	0	0	3	0	0
10	36825880	.	G	A	5	2	7	0	0	7	0	0
10	36828227	.	T	C	7	7	14	0	0	14	0	0
10	36828265	.	G	A	7	7	14	0	0	14	0	0
10	36828295	.	G	T	8	3	11	0	1	12	0	0
10	36828469	.	T	C	3	0	3	0	6	9	0	0
10	36828475	.	C	T	6	3	9	0	0	9	0	0
10	36835641	.	A	T	0	3	3	0	1	4	0	0
10	36835740	.	G	A	2	2	4	0	0	4	0	0
10	36838768	.	C	T	1	2	3	0	0	3	0	0
10	36841230	.	G	T	3	4	7	0	0	7	0	0
10	36843114	.	C	G	1	1	2	0	0	2	0	0
10	36848872	.	G	A	2	1	3	0	0	3	0	0
10	36850674	.	C	T	0	0	0	0	2	2	0	0
10	36850752	.	A	G	8	3	11	0	0	11	0	0
10	36878340	.	G	T	0	2	2	0	0	2	0	0
10	36878362	.	C	A	1	4	5	0	0	5	0	0
10	36878568	.	C	T	3	5	8	0	0	8	0	0
10	36878638	.	T	C	9	0	9	0	4	13	0	0
10	36927345	.	A	T	1	2	3	0	0	3	0	0
10	36927349	.	C	T	0	3	3	0	1	4	0	0
10	36950935	.	A	T	6	4	10	0	0	10	0	0
10	36951044	.	A	T	5	7	12	0	0	12	0	0
10	36951076	.	G	C	7	4	11	0	0	11	0	0
10	36951223	.	A	C	6	14	20	0	1	21	0	0
10	36951378	.	A	G	2	5	7	0	0	7	0	0
10	36951582	.	C	G	11	12	23	0	0	23	0	0
10	36951660	.	T	A	8	8	16	0	1	17	0	0
10	36963456	.	G	A	2	7	9	0	0	9	0	0
10	36967206	.	T	C	6	1	7	0	2	9	0	0
10	36969510	.	T	C	1	0	1	0	0	1	0	0
10	36969519	.	A	G	1	0	1	0	0	1	0	0
10	36974901	.	G	A	4	6	10	0	0	10	0	0
10	36976271	.	C	T	0	1	1	0	3	4	0	0
10	36976318	.	G	A	11	6	17	0	0	17	0	0
10	36987831	.	T	G	4	4	8	0	1	9	0	0
10	37007508	.	G	C	2	4	6	0	0	6	0	0
10	37011570	.	G	T	2	2	4	0	0	4	0	0
10	37014392	.	C	T	1	2	3	0	0	3	0	0
10	37016252	.	T	G	3	2	5	0	0	5	0	0
10	37022463	.	G	A	3	5	8	0	0	8	0	0
10	37028670	.	A	G	5	4	9	0	0	9	0	0
10	37145178	.	G	A	6	10	16	0	0	16	0	0
10	37152081	.	G	A	1	2	3	0	0	3	0	0
10	37152105	.	A	G	7	0	7	0	8	15	0	0
10	37155072	.	G	A	0	4	4	0	8	12	0	0
10	37163252	.	C	A	1	0	1	0	0	1	0	0
10	37167151	.	G	C	8	12	20	0	0	20	0	0
10	37227524	.	C	T	6	4	10	0	0	10	0	0
10	37234093	.	A	G	3	1	4	0	1	5	0	0
10	37236857	.	A	G	0	0	0	0	3	3	0	0
10	37239229	.	G	A	3	5	8	0	0	8	0	0
10	37252054	.	G	A	0	2	2	0	1	3	0	0
10	37253986	.	A	G	1	3	4	0	2	6	0	0
10	37296515	.	G	A	0	4	4	0	2	6	0	0
10	37304379	.	G	T	0	2	2	0	2	4	0	0
10	37304382	.	C	T	2	2	4	0	0	4	0	0
10	37334291	.	G	T	3	2	5	0	0	5	0	0
10	37337473	.	G	A	1	0	1	0	0	1	0	0
10	37367451	.	T	C	4	5	9	0	0	9	0	0
10	37367481	.	C	T	4	4	8	0	0	8	0	0
10	37373858	.	C	T	1	1	2	0	0	2	0	0
10	37373873	.	G	A	0	1	1	0	2	3	0	0
10	37378252	.	A	T	0	1	1	0	0	1	0	0
10	37384943	.	G	A	0	1	1	0	0	1	0	0
10	37385317	.	T	C	1	2	3	0	1	4	0	0
10	37389654	.	G	A	0	3	3	0	2	5	0	0
10	37394478	.	G	A	0	1	1	0	0	1	0	0
10	37394486	.	G	A	0	2	2	0	0	2	0	0
10	37394535	.	C	T	1	3	4	0	0	4	0	0
10	37764473	.	C	T	14	12	26	0	1	27	0	0
10	37779765	.	A	C	0	1	1	0	0	1	0	0
10	37779778	.	T	A	0	1	1	0	0	1	0	0
10	37783114	.	A	G	8	11	19	0	0	19	0	0
10	37783179	.	A	G	14	0	14	0	14	28	0	0
10	37783323	.	A	G	11	8	19	0	2	21	0	0
10	37783558	.	T	C	6	3	9	0	0	9	0	0
10	37783669	.	C	A	6	7	13	0	0	13	0	0
10	37992653	.	C	T	6	4	10	0	0	10	0	0
10	37992679	.	G	A	0	7	7	0	7	14	0	0
10	37992839	.	A	T	6	3	9	0	1	10	0	0
10	37994630	.	C	T	5	4	9	0	0	9	0	0
10	37997567	.	C	G	0	6	6	0	0	6	0	0
10	38000082	.	C	G	5	2	7	0	0	7	0	0
10	38000084	.	G	T	0	5	5	0	2	7	0	0
10	38003011	.	A	G	4	4	8	0	0	8	0	0
10	38006002	.	T	C	1	2	3	0	0	3	0	0
10	38040372	.	A	G	0	1	1	0	0	1	0	0
10	38040378	.	A	G	1	0	1	0	0	1	0	0
10	38149713	.	C	A	0	2	2	0	0	2	0	0
10	38149715	.	A	G	0	2	2	0	0	2	0	0
10	38170573	.	G	A	1	5	6	0	1	7	0	0
10	38170737	.	G	A	9	9	18	0	0	18	0	0
10	38171149	.	G	C	10	0	10	0	7	17	0	0
10	38171196	.	G	A	5	2	7	0	3	10	0	0
10	38171207	.	C	A	2	8	10	0	1	11	0	0
10	38171356	.	A	T	11	20	31	0	0	31	0	0
10	38171490	.	T	A	10	9	19	0	0	19	0	0
10	38173383	.	C	A	0	3	3	0	8	11	0	0
10	38177999	.	C	T	0	6	6	0	8	14	0	0
10	38178357	.	G	A	1	1	2	0	0	2	0	0
10	38180732	.	A	T	0	1	1	0	0	1	0	0
10	38199097	.	G	A	5	2	7	0	1	8	0	0
10	38199169	.	T	C	1	2	3	0	0	3	0	0
10	38205149	.	T	C	5	0	5	0	3	8	0	0
10	38211810	.	C	G	1	2	3	0	0	3	0	0
10	38218990	.	C	T	0	1	1	0	0	1	0	0
10	38231165	.	C	T	0	3	3	0	1	4	0	0
10	38235957	.	G	C	2	6	8	0	0	8	0	0
10	38243449	.	G	A	5	4	9	0	2	11	0	0
10	38243543	.	G	A	6	4	10	0	0	10	0	0
10	38257295	.	G	A	7	7	14	0	2	16	0	0
10	38257509	.	C	G	0	6	6	0	6	12	0	0
10	38257558	.	C	T	6	8	14	0	0	14	0	0
10	38257870	.	T	C	8	12	20	0	2	22	0	0
10	38258729	.	C	G	13	10	23	0	0	23	0	0
10	38259033	.	C	T	8	4	12	0	0	12	0	0
10	38259034	.	A	G	7	4	11	0	1	12	0	0
10	38259204	.	G	A	5	6	11	0	1	12	0	0
10	38259217	.	A	G	6	6	12	0	0	12	0	0
10	38259268	.	G	C	2	9	11	0	0	11	0	0
10	38259339	.	A	T	6	3	9	0	1	10	0	0
10	38259449	.	A	C	7	0	7	0	4	11	0	0
10	38259451	.	A	G	7	4	11	0	0	11	0	0
10	38259900	.	T	C	7	1	8	0	10	18	0	0
10	38260002	.	G	A	5	8	13	0	1	14	0	0
10	38260210	.	T	A	9	16	25	0	2	27	0	0
10	38260626	.	A	T	10	5	15	0	1	16	0	0
10	38261085	.	T	G	3	3	6	0	1	7	0	0
10	38261109	.	T	C	3	5	8	0	0	8	0	0
10	38261453	.	G	A	1	4	5	0	0	5	0	0
10	38261485	.	C	T	1	8	9	0	1	10	0	0
10	38261495	.	T	G	2	7	9	0	0	9	0	0
10	38261696	.	C	T	2	5	7	0	1	8	0	0
10	38665994	.	C	T	0	4	4	0	0	4	0	0
10	38666063	.	T	C	8	9	17	0	1	18	0	0
10	38686126	.	T	C	4	2	6	0	1	7	0	0
10	38695152	.	A	C	13	11	24	0	0	24	0	0
10	38695510	.	A	G	14	11	25	0	0	25	0	0
10	38695656	.	A	G	9	16	25	0	1	26	0	0
10	38695877	.	C	T	14	8	22	0	0	22	0	0
10	38695888	.	C	T	15	6	21	0	0	21	0	0
10	38724101	.	C	T	1	1	2	0	0	2	0	0
10	38726441	.	C	T	1	0	1	0	0	1	0	0
10	38885821	.	T	C	3	4	7	0	1	8	0	0
10	38891454	.	C	A	8	8	16	0	0	16	0	0
10	38922043	.	G	A	0	4	4	0	3	7	0	0
10	38934391	.	A	G	4	2	6	0	0	7	1	0
10	38940232	.	A	G	2	4	6	0	1	7	0	0
10	38943265	.	C	G	9	5	14	0	0	14	0	0
10	38950115	.	T	C	1	2	3	0	0	3	0	0
10	38950430	.	G	A	0	7	7	0	12	19	0	0
10	38950484	.	A	G	12	14	26	0	2	28	0	0
10	38950538	.	T	C	6	6	12	0	0	12	0	0
10	38954126	.	C	T	8	11	19	0	0	19	0	0
10	38954141	.	T	C	7	11	18	0	1	19	0	0
10	38954798	.	T	C	9	11	20	0	2	22	0	0
10	38954801	.	C	T	10	14	24	0	0	24	0	0
10	38957061	.	T	C	17	11	28	0	1	29	0	0
10	38957127	.	G	A	0	10	10	0	8	18	0	0
10	38957193	.	C	T	3	7	10	0	0	10	0	0
10	38957748	.	A	C	6	16	22	0	0	22	0	0
10	38957754	.	A	C	5	19	24	0	0	24	0	0
10	38969552	.	A	C	26	16	42	0	3	45	0	0
10	38969598	.	A	C	30	18	48	0	3	51	0	0
10	38969629	.	C	T	26	23	49	0	1	50	0	0
10	38969685	.	A	G	18	23	41	0	4	45	0	0
10	38969778	.	C	T	26	23	49	0	2	51	0	0
10	39011484	.	C	T	16	13	29	0	2	31	0	0
10	39086382	.	C	T	0	1	1	0	0	1	0	0
10	39086981	.	G	A	19	20	39	0	2	41	0	0
10	39087242	.	C	T	9	3	12	0	1	13	0	0
10	39087391	.	A	G	34	0	34	0	27	61	0	0
10	39087625	.	T	A	21	29	50	0	0	50	0	0
10	39087659	.	T	A	19	24	43	0	5	48	0	0
10	39091684	.	C	A	2	2	4	0	1	5	0	0
10	39091792	.	A	G	0	0	0	0	2	2	0	0
10	39098798	.	C	T	1	4	5	0	0	5	0	0
10	39102672	.	G	C	0	2	2	0	0	2	0	0
10	39102776	.	T	C	2	3	5	0	2	7	0	0
10	39110452	.	G	C	2	3	5	0	0	5	0	0
10	39115595	.	G	T	2	3	5	0	0	5	0	0
10	39115596	.	T	C	2	3	5	0	0	5	0	0
10	39120132	.	T	C	8	11	19	0	1	20	0	0
10	39130460	.	C	T	8	15	23	0	4	27	0	0
10	39136564	.	A	G	3	2	5	0	1	6	0	0
10	39140465	.	A	G	1	2	3	0	0	3	0	0
10	39140741	.	T	C	2	0	2	0	0	2	0	0
10	39152038	.	A	G	1	3	4	0	0	4	0	0
10	39153599	.	T	A	3	6	9	0	0	9	0	0
10	39170798	.	A	C	3	1	4	0	0	4	0	0
10	39175139	.	T	C	6	4	10	0	0	10	0	0
10	39175418	.	T	C	2	3	5	0	0	5	0	0
10	39175452	.	C	T	1	2	3	0	0	3	0	0
10	39175475	.	G	A	0	2	2	0	1	3	0	0
10	39177751	.	C	A	2	2	4	0	0	4	0	0
10	39179439	.	G	A	3	3	6	0	1	7	0	0
10	39179565	.	C	T	4	3	7	0	1	8	0	0
10	39179992	.	G	C	9	4	13	0	1	14	0	0
10	39181325	.	G	T	0	5	5	3	5	13	0	0
10	39182173	.	A	G	13	6	19	0	1	20	0	0
10	39182310	.	C	A	15	8	23	0	0	23	0	0
10	39182342	.	A	T	15	7	22	0	1	23	0	0
10	39182401	.	C	A	12	8	20	0	0	21	1	0
10	39182497	.	C	T	8	4	12	0	1	13	0	0
10	39182602	.	G	A	0	6	6	0	3	9	0	0
10	39182640	.	T	A	3	4	7	0	0	7	0	0
10	39182659	.	G	T	5	2	7	0	0	8	1	0
10	39182703	.	T	G	2	0	2	0	4	6	0	0
10	39205021	.	C	T	2	6	8	0	0	8	0	0
10	39205256	.	C	G	3	0	3	0	0	3	0	0
10	39206945	.	A	G	7	6	13	0	0	13	0	0
10	39207397	.	T	A	1	2	3	0	0	3	0	0
10	39207708	.	A	T	6	6	12	0	0	12	0	0
10	39207720	.	A	G	4	6	10	0	0	10	0	0
10	39207749	.	C	T	1	5	6	0	0	6	0	0
10	39216625	.	C	T	10	6	16	0	0	16	0	0
10	39219390	.	T	C	1	1	2	0	0	2	0	0
10	39219540	.	T	A	9	5	14	0	0	14	0	0
10	39222134	.	A	C	3	2	5	0	0	5	0	0
10	39222182	.	A	G	13	8	21	0	0	21	0	0
10	39225504	.	A	C	11	9	20	0	0	20	0	0
10	39225555	.	T	C	8	15	23	0	0	23	0	0
10	39231387	.	G	A	4	6	10	0	0	10	0	0
10	39249103	.	T	C	1	2	3	0	0	3	0	0
10	39251381	.	C	T	1	2	3	0	0	3	0	0
10	39266669	.	A	C	2	4	6	0	0	6	0	0
10	39266702	.	A	G	3	0	3	0	2	5	0	0
10	39277087	.	C	G	2	1	3	0	1	4	0	0
10	39284032	.	A	G	4	4	8	0	0	8	0	0
10	39284092	.	T	G	4	0	4	0	3	7	0	0
10	39284104	.	C	G	3	0	3	0	2	5	0	0
10	39285246	.	A	G	4	9	13	0	0	13	0	0
10	39285288	.	T	C	0	5	5	0	1	6	0	0
10	39287100	.	C	T	2	1	3	0	0	3	0	0
10	39289006	.	A	G	1	0	1	0	1	2	0	0
10	39289036	.	A	C	1	1	2	0	0	2	0	0
10	39292988	.	A	G	0	2	2	0	1	3	0	0
10	39293240	.	C	T	2	3	5	0	0	5	0	0
10	39293241	.	T	G	2	3	5	0	0	5	0	0
10	39293335	.	T	C	5	4	9	0	0	9	0	0
10	39293358	.	G	A	4	2	6	0	0	6	0	0
10	39293705	.	A	G	3	6	9	0	2	11	0	0
10	39293707	.	A	T	6	5	11	0	0	11	0	0
10	39293746	.	G	A	5	4	9	0	0	9	0	0
10	39293751	.	A	G	4	4	8	0	1	9	0	0
10	39294248	.	T	G	6	2	8	0	0	8	0	0
10	39294323	.	T	C	1	0	1	0	0	1	0	0
10	39294334	.	T	G	0	0	0	0	1	1	0	0
10	39476639	.	A	G	4	4	8	0	0	8	0	0
10	39904780	.	C	T	1	1	2	0	0	2	0	0
10	39904851	.	A	T	7	4	11	0	0	11	0	0
10	39904915	.	A	G	7	9	16	0	1	17	0	0
10	39904966	.	T	C	3	6	9	0	0	9	0	0
10	39953689	.	T	C	2	0	2	0	0	2	0	0
10	40089941	.	T	C	3	0	3	0	0	3	0	0
10	40110115	.	A	C	2	2	4	0	0	4	0	0
10	40110397	.	A	G	4	3	7	0	0	7	0	0
10	40110599	.	G	A	0	3	3	0	3	6	0	0
10	40110616	.	G	T	1	3	4	0	0	4	0	0
10	40110666	.	T	A	2	3	5	0	0	5	0	0
10	40110814	.	C	A	5	2	7	0	0	7	0	0
10	40110853	.	A	T	3	1	4	0	0	4	0	0
10	40110869	.	A	T	4	1	5	0	0	5	0	0
10	40111412	.	G	A	2	3	5	0	0	5	0	0
10	40111437	.	T	A	3	4	7	0	0	7	0	0
10	40111610	.	C	T	7	2	9	0	1	10	0	0
10	40111666	.	G	C	6	6	12	0	0	12	0	0
10	40111706	.	A	G	1	5	6	0	1	7	0	0
10	40111732	.	C	T	1	6	7	0	0	7	0	0
10	40111904	.	G	T	3	1	4	0	0	4	0	0
10	40111952	.	C	T	2	2	4	0	0	4	0	0
10	40111964	.	C	A	2	2	4	0	0	4	0	0
10	40112096	.	C	A	1	5	6	0	0	6	0	0
10	40112121	.	A	G	2	4	6	0	0	6	0	0
10	40112157	.	G	A	3	2	5	0	0	5	0	0
10	40112159	.	T	A	2	2	4	0	1	5	0	0
10	40112347	.	A	T	4	5	9	0	0	9	0	0
10	40112476	.	T	A	3	3	6	0	0	6	0	0
10	40112638	.	C	T	4	4	8	0	0	8	0	0
10	40112708	.	A	G	7	3	10	0	0	10	0	0
10	40112834	.	G	A	5	2	7	0	2	9	0	0
10	40113113	.	C	G	1	4	5	0	0	5	0	0
10	40113161	.	C	A	2	4	6	0	0	6	0	0
10	40113197	.	G	A	0	4	4	0	6	10	0	0
10	40113408	.	A	G	8	7	15	0	0	15	0	0
10	40113446	.	T	C	10	4	14	0	1	15	0	0
10	40113508	.	A	T	5	3	8	0	0	8	0	0
10	40113713	.	A	G	2	3	5	0	0	5	0	0
10	40204788	.	A	G	1	5	6	0	0	6	0	0
10	40204845	.	G	A	0	5	5	0	4	9	0	0
10	40236068	.	A	G	5	0	5	0	11	16	0	0
10	40262338	.	T	C	6	7	13	0	0	13	0	0
10	40262347	.	A	G	6	1	7	0	4	11	0	0
10	40266160	.	A	G	2	5	7	0	0	7	0	0
10	40266259	.	A	C	6	6	12	0	0	12	0	0
10	40274411	.	G	A	3	4	7	0	0	7	0	0
10	40274541	.	G	A	0	12	12	0	8	20	0	0
10	40274626	.	C	T	2	4	6	0	1	7	0	0
10	40275055	.	G	C	0	3	3	0	4	7	0	0
10	40275070	.	T	G	3	3	6	0	0	6	0	0
10	40275158	.	G	A	0	4	4	0	5	9	0	0
10	40296841	.	G	A	0	2	2	0	2	4	0	0
10	40296896	.	C	T	1	1	2	0	0	2	0	0
10	40303924	.	G	C	1	0	1	0	0	1	0	0
10	40314175	.	A	C	2	4	6	0	1	7	0	0
10	40314177	.	A	C	2	5	7	0	0	7	0	0
10	40316924	.	T	G	2	5	7	0	1	8	0	0
10	40316968	.	T	C	3	3	6	0	0	6	0	0
10	40317095	.	G	T	8	5	13	0	1	14	0	0
10	40317190	.	T	G	6	2	8	0	1	9	0	0
10	40317192	.	G	T	7	2	9	0	0	9	0	0
10	40317285	.	A	T	2	8	10	0	0	10	0	0
10	40822252	.	C	T	0	3	3	0	9	12	0	0
10	40826436	.	A	G	4	4	8	0	1	9	0	0
10	40826494	.	A	G	8	7	15	0	1	16	0	0
10	40826516	.	A	G	13	7	20	0	1	21	0	0
10	40826589	.	C	T	17	8	25	0	2	27	0	0
10	40826590	.	A	G	17	9	26	0	1	27	0	0
10	40859464	.	A	G	6	2	8	0	1	9	0	0
10	40859503	.	G	A	2	3	5	0	0	5	0	0
10	40859512	.	C	T	1	2	3	0	0	3	0	0
10	40859647	.	A	C	3	2	5	0	0	5	0	0
10	40859722	.	A	G	7	3	10	0	1	11	0	0
10	40859968	.	T	C	6	3	9	0	1	10	0	0
10	40861563	.	C	A	0	2	2	0	1	3	0	0
10	40861650	.	G	A	3	3	6	0	1	7	0	0
10	40861701	.	G	T	5	2	7	0	1	8	0	0
10	40866244	.	T	C	3	0	3	0	3	6	0	0
10	41089380	.	A	G	5	1	6	0	1	7	0	0
10	41099458	.	A	G	6	2	8	0	0	8	0	0
10	41104088	.	G	C	0	0	0	0	2	2	0	0
10	41106892	.	A	C	5	1	6	0	0	6	0	0
10	41106982	.	G	A	3	3	6	0	0	6	0	0
10	41107066	.	A	T	1	2	3	0	0	3	0	0
10	41108246	.	G	T	3	0	3	0	0	3	0	0
10	41111804	.	C	A	0	1	1	0	0	1	0	0
10	41111851	.	C	T	0	4	4	0	6	10	0	0
10	41111877	.	G	A	8	8	16	0	1	17	0	0
10	41111975	.	T	C	12	5	17	0	0	17	0	0
10	41111993	.	C	T	0	4	4	0	9	13	0	0
10	41112076	.	T	C	0	0	0	0	2	2	0	0
10	41115360	.	C	A	2	2	4	0	0	4	0	0
10	41121590	.	C	A	2	4	6	0	0	6	0	0
10	41129375	.	T	C	1	0	1	0	0	1	0	0
10	41136356	.	G	A	1	1	2	0	0	2	0	0
10	41136365	.	G	A	1	2	3	0	0	3	0	0
10	41143525	.	G	A	2	4	6	0	0	6	0	0
10	41156278	.	A	G	2	2	4	0	1	5	0	0
10	41156370	.	A	T	1	5	6	0	0	6	0	0
10	41156857	.	G	T	1	4	5	0	0	5	0	0
10	41192623	.	C	A	2	0	2	0	1	3	0	0
10	41362430	.	A	G	3	4	7	0	0	7	0	0
10	41362763	.	C	G	18	11	29	0	1	30	0	0
10	41362839	.	A	G	13	8	21	0	1	22	0	0
10	41362986	.	T	A	1	0	1	0	0	1	0	0
10	41368569	.	G	A	2	0	2	0	0	2	0	0
10	41368626	.	C	T	0	1	1	0	4	5	0	0
10	41373231	.	G	A	0	2	2	0	0	2	0	0
10	41376895	.	G	A	1	0	1	0	0	1	0	0
10	41379918	.	G	C	5	5	10	0	0	10	0	0
10	41379992	.	G	A	10	7	17	0	0	17	0	0
10	41380079	.	G	C	10	0	10	0	6	16	0	0
10	41397380	.	G	T	4	6	10	0	2	12	0	0
10	41397404	.	G	A	8	9	17	0	0	17	0	0
10	41397443	.	G	A	9	8	17	0	1	18	0	0
10	41397533	.	A	G	4	5	9	0	0	9	0	0
10	41397712	.	A	G	4	3	7	0	0	7	0	0
10	41399919	.	G	A	2	2	4	0	0	4	0	0
10	41399968	.	G	T	10	5	15	0	0	15	0	0
10	41409570	.	G	T	1	3	4	0	0	4	0	0
10	41409578	.	T	A	1	5	6	0	0	6	0	0
10	41409781	.	C	T	3	6	9	0	0	9	0	0
10	41605886	.	C	T	3	4	7	0	0	7	0	0
10	41606172	.	G	C	3	4	7	0	0	7	0	0
10	41607357	.	C	T	5	5	10	0	0	10	0	0
10	41607396	.	C	T	5	1	6	0	0	7	1	0
10	41607492	.	A	G	0	0	0	0	2	2	0	0
10	41607787	.	A	C	3	2	5	0	0	5	0	0
10	41607939	.	C	A	4	5	9	0	3	12	0	0
10	41608254	.	A	C	3	4	7	0	0	7	0	0
10	41608320	.	T	C	6	3	9	0	0	9	0	0
10	41608410	.	A	C	4	4	8	0	1	9	0	0
10	41608425	.	T	A	3	5	8	0	1	9	0	0
10	41608479	.	G	A	5	9	14	0	0	14	0	0
10	41608513	.	A	G	6	0	6	0	6	12	0	0
10	41608561	.	A	T	2	6	8	0	0	8	0	0
10	41608827	.	C	T	4	5	9	0	1	10	0	0
10	41608871	.	G	T	6	4	10	0	0	10	0	0
10	41608935	.	G	A	0	5	5	0	9	14	0	0
10	41690840	.	T	C	1	2	3	0	0	3	0	0
10	41735272	.	C	T	3	3	6	0	0	6	0	0
10	41735419	.	C	T	1	2	3	0	0	3	0	0
10	41765973	.	C	T	9	4	13	0	0	13	0	0
10	41766022	.	A	G	7	1	8	0	2	10	0	0
10	41801664	.	G	A	3	3	6	0	0	6	0	0
10	41801721	.	G	A	2	3	5	0	1	6	0	0
10	41816988	.	C	T	4	4	8	0	1	9	0	0
10	41816991	.	G	A	4	4	8	0	1	9	0	0
10	41817054	.	T	C	9	3	12	0	2	14	0	0
10	41817094	.	C	A	7	6	13	0	0	13	0	0
10	41830403	.	G	A	20	10	30	0	1	31	0	0
10	41830435	.	C	T	16	10	26	0	7	33	0	0
10	41832092	.	C	A	8	14	22	0	2	24	0	0
10	41834276	.	G	T	6	8	14	0	0	14	0	0
10	41834300	.	C	T	0	3	3	0	0	3	0	0
10	41835199	.	C	T	5	6	11	0	0	11	0	0
10	41835283	.	G	T	3	4	7	0	0	7	0	0
10	41837039	.	T	C	8	17	25	0	0	25	0	0
10	41837425	.	G	C	5	7	12	0	0	12	0	0
10	41837486	.	T	C	7	6	13	0	1	14	0	0
10	41837528	.	A	G	13	7	20	0	0	20	0	0
10	41841178	.	G	T	11	5	16	0	2	18	0	0
10	41841209	.	C	G	11	3	14	0	0	14	0	0
10	41841214	.	G	C	11	3	14	0	0	14	0	0
10	41843743	.	C	A	0	2	2	0	2	4	0	0
10	41879500	.	A	G	1	2	3	0	0	3	0	0
10	41891658	.	C	G	0	1	1	0	1	2	0	0
10	41894738	.	T	A	2	4	6	0	0	6	0	0
10	41902778	.	A	C	2	0	2	0	4	6	0	0
10	41902817	.	A	G	2	3	5	0	0	5	0	0
10	41921139	.	G	A	1	2	3	0	4	7	0	0
10	41959597	.	T	C	2	5	7	0	0	7	0	0
10	41983674	.	C	T	2	3	5	0	0	5	0	0
10	41983858	.	G	A	1	1	2	0	0	2	0	0
10	41983874	.	T	A	2	1	3	0	1	4	0	0
10	41984544	.	C	G	1	2	3	0	0	3	0	0
10	41985911	.	G	A	2	4	6	0	0	6	0	0
10	41995897	.	A	G	1	2	3	0	1	4	0	0
10	42006943	.	A	G	3	0	3	0	0	3	0	0
10	42011054	.	T	C	4	7	11	0	0	11	0	0
10	42011060	.	G	T	4	7	11	0	0	11	0	0
10	42011245	.	C	T	2	4	6	0	0	6	0	0
10	42011293	.	G	A	1	4	5	0	0	5	0	0
10	42017620	.	C	T	5	2	7	0	0	7	0	0
10	42017854	.	C	T	5	2	7	0	0	7	0	0
10	42020205	.	T	A	8	3	11	0	0	11	0	0
10	42020285	.	G	A	3	2	5	0	0	5	0	0
10	42020422	.	C	T	6	9	15	0	1	16	0	0
10	42020451	.	C	T	9	7	16	0	0	16	0	0
10	42020592	.	G	T	7	6	13	0	1	14	0	0
10	42020684	.	A	G	11	0	11	0	8	19	0	0
10	42021194	.	A	G	2	3	5	0	1	6	0	0
10	42021321	.	G	A	4	4	8	0	0	8	0	0
10	42021384	.	T	C	5	3	8	0	0	8	0	0
10	42021485	.	A	T	6	6	12	0	1	13	0	0
10	42021515	.	T	A	2	3	5	0	0	5	0	0
10	42021543	.	T	C	4	2	6	0	0	6	0	0
10	42022014	.	C	G	5	12	17	0	1	18	0	0
10	42044337	.	C	T	7	7	14	0	0	14	0	0
10	42044480	.	G	A	8	15	23	0	2	25	0	0
10	42044497	.	A	G	11	13	24	0	1	25	0	0
10	42044745	.	T	G	5	15	20	0	1	21	0	0
10	42044746	.	C	T	4	16	20	0	1	21	0	0
10	42044809	.	T	A	12	14	26	0	0	26	0	0
10	42045075	.	T	G	18	5	23	0	0	23	0	0
10	42045254	.	C	T	0	8	8	0	12	20	0	0
10	42045300	.	G	C	9	7	16	0	2	18	0	0
10	42046066	.	T	C	3	0	3	0	3	6	0	0
10	42090214	.	A	G	9	9	18	0	2	20	0	0
10	42090222	.	A	G	11	14	25	0	1	26	0	0
10	42090315	.	T	C	13	9	22	0	1	23	0	0
10	42093928	.	A	G	2	6	8	0	0	8	0	0
10	42101122	.	A	G	1	3	4	0	0	4	0	0
10	42104361	.	T	G	6	7	13	0	1	14	0	0
10	42107853	.	C	T	2	4	6	0	0	6	0	0
10	42107884	.	C	T	0	5	5	0	1	6	0	0
10	42108029	.	G	A	7	5	12	0	0	12	0	0
10	42108077	.	T	A	7	8	15	0	0	15	0	0
10	42111601	.	G	A	3	4	7	0	1	8	0	0
10	42111883	.	C	T	0	4	4	0	5	9	0	0
10	42112010	.	A	G	3	4	7	0	0	7	0	0
10	42112019	.	A	T	3	3	6	0	0	6	0	0
10	42112062	.	T	A	1	5	6	0	0	6	0	0
10	42112075	.	T	C	2	0	2	0	5	7	0	0
10	42119816	.	A	G	3	4	7	0	0	7	0	0
10	42123309	.	C	G	1	0	1	0	0	1	0	0
10	42123334	.	T	C	2	0	2	0	3	5	0	0
10	42123388	.	A	G	4	6	10	0	2	12	0	0
10	42125549	.	C	T	3	1	4	0	0	4	0	0
10	42128886	.	A	G	9	6	15	0	0	15	0	0
10	42128898	.	C	T	6	4	10	0	1	11	0	0
10	42131297	.	A	T	6	7	13	0	0	13	0	0
10	42134447	.	C	G	1	4	5	0	0	5	0	0
10	42134574	.	A	G	4	5	9	0	0	9	0	0
10	42134629	.	C	T	2	3	5	0	0	5	0	0
10	42135131	.	A	G	3	7	10	0	1	11	0	0
10	42135449	.	T	C	3	5	8	0	0	8	0	0
10	42135472	.	A	G	4	2	6	0	0	6	0	0
10	42135490	.	T	C	2	2	4	0	0	4	0	0
10	42136386	.	T	C	2	2	4	0	0	4	0	0
10	42136526	.	A	C	4	1	5	0	4	9	0	0
10	42136645	.	C	T	0	2	2	0	3	5	0	0
10	42136716	.	T	C	3	0	3	0	2	5	0	0
10	42136734	.	C	A	1	3	4	0	0	4	0	0
10	42136847	.	T	C	2	2	4	0	0	4	0	0
10	42136856	.	T	C	2	2	4	0	0	4	0	0
10	42137161	.	G	T	2	2	4	0	0	4	0	0
10	42137167	.	C	T	1	2	3	0	1	4	0	0
10	42137503	.	T	C	2	2	4	0	0	4	0	0
10	42138221	.	C	T	0	3	3	0	1	4	0	0
10	42138380	.	T	C	2	0	2	0	6	8	0	0
10	42140224	.	A	T	2	3	5	0	0	5	0	0
10	42463547	.	G	A	0	3	3	0	1	4	0	0
10	42691349	.	T	C	2	3	5	0	1	6	0	0
10	42694573	.	A	G	2	0	2	0	0	2	0	0
10	42701006	.	C	T	7	4	11	0	0	11	0	0
10	42701027	.	C	G	9	4	13	0	0	13	0	0
10	42701051	.	T	C	9	6	15	0	0	15	0	0
10	42704643	.	A	T	5	3	8	0	1	9	0	0
10	42704929	.	C	T	6	4	10	0	0	10	0	0
10	42704988	.	T	C	8	4	12	0	0	12	0	0
10	42708132	.	C	T	6	2	8	0	0	8	0	0
10	42709610	.	T	C	10	4	14	0	0	14	0	0
10	42715853	.	C	T	33	11	44	0	0	44	0	0
10	42738094	.	A	G	4	3	7	0	0	7	0	0
10	42738095	.	C	T	4	3	7	0	0	7	0	0
10	42738132	.	T	A	3	6	9	0	0	9	0	0
10	42738452	.	A	T	3	4	7	0	2	9	0	0
10	42738671	.	C	T	2	4	6	0	0	6	0	0
10	42739527	.	A	G	7	7	14	0	0	14	0	0
10	42739589	.	G	A	13	13	26	0	1	27	0	0
10	42739593	.	T	C	13	14	27	0	0	27	0	0
10	42739690	.	A	T	6	3	9	0	2	11	0	0
10	42739938	.	C	T	8	4	12	0	0	12	0	0
10	42740111	.	G	A	0	9	9	0	14	23	0	0
10	42740302	.	T	A	9	9	18	0	2	20	0	0
10	42740386	.	A	C	14	5	19	0	1	20	0	0
10	42741347	.	T	G	16	21	37	0	7	44	0	0
10	42741469	.	T	A	20	21	41	0	3	45	1	0
10	42741528	.	G	T	32	14	46	0	1	47	0	0
10	42741662	.	G	A	33	10	43	0	7	50	0	0
10	42741815	.	G	A	23	13	36	0	1	37	0	0
10	42741918	.	C	T	18	11	29	0	4	33	0	0
10	42742058	.	T	C	7	0	7	0	7	14	0	0
10	42742101	.	T	A	3	4	7	0	0	7	0	0
10	42742412	.	G	T	6	9	15	1	2	18	0	0
10	42742415	.	T	G	8	10	18	1	0	19	0	0
10	42742472	.	C	G	10	7	17	0	3	20	0	0
10	42742511	.	G	A	18	6	24	0	1	25	0	0
10	42742544	.	T	C	9	16	25	0	0	25	0	0
10	42742560	.	T	C	12	13	25	0	1	26	0	0
10	42742594	.	A	G	9	13	22	0	0	22	0	0
10	42742604	.	G	T	8	13	21	0	1	22	0	0
10	42742760	.	T	C	7	6	13	2	0	15	0	0
10	42742981	.	T	A	2	2	4	0	1	5	0	0
10	42742998	.	C	A	4	2	6	0	0	6	0	0
10	42743608	.	A	C	2	7	9	0	0	9	0	0
10	42743624	.	T	G	0	5	5	0	0	5	0	0
10	42743666	.	G	T	5	3	8	0	1	9	0	0
10	42744585	.	C	T	9	1	10	0	0	10	0	0
10	42744598	.	C	A	10	1	11	0	0	11	0	0
10	42744705	.	A	T	7	3	10	0	1	11	0	0
10	42744831	.	T	G	5	1	6	0	1	7	0	0
10	42744912	.	C	A	10	6	16	0	1	17	0	0
10	42744923	.	T	C	11	3	14	0	0	14	0	0
10	42745003	.	A	G	7	7	14	0	1	15	0	0
10	42745147	.	A	G	7	11	18	0	1	19	0	0
10	42748084	.	A	T	11	13	24	0	0	24	0	0
10	42748096	.	A	G	13	10	23	0	1	24	0	0
10	42748120	.	A	G	11	7	18	0	0	18	0	0
10	42759781	.	T	A	8	7	15	0	0	15	0	0
10	42762535	.	T	C	4	3	7	0	0	7	0	0
10	42767123	.	G	A	11	13	24	0	1	25	0	0
10	42767252	.	C	T	0	6	6	0	10	16	0	0
10	42775877	.	A	C	0	0	0	0	1	1	0	0
10	42775891	.	C	A	1	2	3	0	0	3	0	0
10	42875710	.	T	C	2	0	2	0	2	4	0	0
10	42876221	.	C	T	2	2	4	0	0	4	0	0
10	42876255	.	A	T	3	2	5	0	0	5	0	0
10	42881370	.	C	T	0	2	2	0	2	4	0	0
10	42900909	.	G	T	0	5	5	0	2	7	0	0
10	42902618	.	T	C	2	1	3	0	0	3	0	0
10	42902666	.	G	A	1	1	2	0	1	3	0	0
10	42909661	.	A	T	0	1	1	0	0	1	0	0
10	42930781	.	T	C	6	0	6	0	4	10	0	0
10	42930814	.	T	C	6	8	14	0	0	14	0	0
10	42930828	.	T	C	4	10	14	0	0	14	0	0
10	42931278	.	T	C	7	4	11	0	0	11	0	0
10	42992877	.	T	C	1	0	1	0	0	1	0	0
10	43044188	.	G	T	2	4	6	0	0	6	0	0
10	43044206	.	T	C	3	3	6	0	1	7	0	0
10	43057697	.	C	T	2	0	2	0	0	2	0	0
10	43072939	.	A	G	4	2	6	0	0	6	0	0
10	43072943	.	T	C	4	2	6	0	0	6	0	0
10	43073103	.	A	G	2	2	4	0	0	4	0	0
10	43149237	.	A	G	3	0	3	0	3	6	0	0
10	43157426	.	C	A	1	1	2	0	0	2	0	0
10	43225563	.	G	A	0	2	2	0	5	7	0	0
10	43231264	.	A	G	4	3	7	0	0	7	0	0
10	43231279	.	A	G	3	0	3	0	3	6	0	0
10	43231317	.	C	A	1	4	5	0	0	5	0	0
10	43231887	.	C	T	1	3	4	0	0	4	0	0
10	43231919	.	G	A	2	4	6	0	0	6	0	0
10	43231972	.	G	A	0	2	2	0	2	4	0	0
10	43232668	.	A	C	1	3	4	0	0	4	0	0
10	43290759	.	C	T	6	3	9	0	0	9	0	0
10	43355979	.	A	G	7	6	13	0	0	13	0	0
10	43365046	.	A	G	7	7	14	0	1	15	0	0
10	43372035	.	A	G	4	2	6	0	0	6	0	0
10	43372466	.	C	T	4	3	7	0	0	7	0	0
10	43375407	.	T	A	1	2	3	0	0	3	0	0
10	43450144	.	C	T	3	2	5	0	0	5	0	0
10	43450145	.	T	C	3	2	5	0	0	5	0	0
10	43545446	.	T	A	10	7	17	0	0	17	0	0
10	43545475	.	A	C	7	8	15	0	0	15	0	0
10	43545681	.	C	T	3	10	13	0	0	13	0	0
10	43546889	.	T	C	6	3	9	0	0	9	0	0
10	43546890	.	T	C	5	4	9	0	0	9	0	0
10	43546953	.	T	C	5	2	7	0	0	7	0	0
10	43547194	.	T	A	3	6	9	0	0	9	0	0
10	43548297	.	G	A	4	5	9	0	0	9	0	0
10	43548301	.	A	G	4	5	9	0	0	9	0	0
10	43548488	.	A	T	1	3	4	0	1	5	0	0
10	43548952	.	T	C	5	0	5	0	2	7	0	0
10	43548955	.	T	G	5	2	7	0	0	7	0	0
10	43549060	.	G	A	1	3	4	0	0	4	0	0
10	43549062	.	G	T	1	3	4	0	0	4	0	0
10	43549435	.	T	A	4	4	8	0	0	8	0	0
10	43554507	.	A	G	1	2	3	0	0	3	0	0
10	43611596	.	T	A	1	2	3	0	1	4	0	0
10	43709084	.	T	C	4	3	7	0	0	7	0	0
10	43709085	.	G	C	4	3	7	0	0	7	0	0
10	43709204	.	A	G	12	7	19	0	1	20	0	0
10	43711059	.	T	A	1	2	3	0	0	3	0	0
10	43715981	.	G	A	10	11	21	0	1	22	0	0
10	43721415	.	C	T	13	12	25	0	0	25	0	0
10	43761719	.	T	A	4	11	15	0	0	15	0	0
10	43761755	.	A	G	9	13	22	0	1	23	0	0
10	43761996	.	G	A	5	6	11	0	0	11	0	0
10	43762021	.	C	T	6	5	11	0	1	12	0	0
10	43762142	.	C	T	0	5	5	0	2	7	0	0
10	43762519	.	A	G	6	11	17	0	0	17	0	0
10	43762654	.	A	G	7	6	13	0	0	13	0	0
10	43762717	.	A	G	10	7	17	0	0	17	0	0
10	43762755	.	A	C	13	4	17	0	1	18	0	0
10	43765291	.	G	C	2	2	4	0	0	4	0	0
10	43766688	.	T	G	2	5	7	0	0	7	0	0
10	43766817	.	A	C	1	0	1	0	1	2	0	0
10	43771142	.	C	T	5	3	8	0	1	9	0	0
10	43771238	.	G	A	3	2	5	0	0	5	0	0
10	43771246	.	C	T	3	1	4	0	0	4	0	0
10	43771302	.	G	A	1	4	5	0	0	5	0	0
10	43806993	.	A	C	5	2	7	0	0	7	0	0
10	43807019	.	G	C	5	2	7	0	0	7	0	0
10	43807904	.	G	A	0	3	3	0	3	6	0	0
10	43863701	.	T	A	0	2	2	0	0	2	0	0
10	43863742	.	A	C	0	5	5	0	0	5	0	0
10	43863819	.	C	G	1	2	3	0	1	4	0	0
10	43863846	.	G	A	2	3	5	0	0	5	0	0
10	43864938	.	T	C	1	2	3	0	0	3	0	0
10	43864960	.	T	C	1	3	4	0	0	4	0	0
10	43958439	.	A	C	1	3	4	0	0	4	0	0
10	43999640	.	G	T	3	3	6	0	1	7	0	0
10	43999733	.	G	T	1	2	3	0	0	3	0	0
10	44002836	.	G	A	0	3	3	0	0	3	0	0
10	44011744	.	A	G	0	5	5	0	0	5	0	0
10	44057263	.	T	A	4	11	15	0	2	17	0	0
10	44146313	.	C	T	3	2	5	0	0	5	0	0
10	44176257	.	C	T	2	3	5	0	0	5	0	0
10	44180299	.	C	T	14	12	26	0	0	26	0	0
10	44189322	.	G	A	3	7	10	0	2	12	0	0
10	44297245	.	G	T	4	6	10	0	2	12	0	0
10	44314569	.	C	T	1	2	3	0	0	3	0	0
10	44314579	.	A	G	2	1	3	0	0	3	0	0
10	44320823	.	G	C	6	4	10	0	1	11	0	0
10	44337487	.	C	G	3	2	5	0	0	5	0	0
10	44337652	.	G	T	2	5	7	0	0	7	0	0
10	44345005	.	C	T	0	3	3	0	4	7	0	0
10	44346449	.	T	C	3	0	3	0	5	8	0	0
10	44353914	.	G	A	5	3	8	0	0	8	0	0
10	44354053	.	G	C	1	5	6	0	1	7	0	0
10	44354718	.	T	C	1	0	1	0	0	1	0	0
10	44354736	.	A	C	2	2	4	0	0	4	0	0
10	44363242	.	G	T	10	4	14	0	1	15	0	0
10	44364604	.	A	T	1	1	2	0	0	2	0	0
10	44364610	.	C	T	0	0	0	0	1	1	0	0
10	44371710	.	G	T	0	18	18	0	9	27	0	0
10	44375738	.	T	G	6	0	6	0	5	11	0	0
10	44375785	.	G	A	0	3	3	0	4	7	0	0
10	44377942	.	G	C	8	9	17	0	2	19	0	0
10	44377991	.	C	T	0	6	6	0	1	7	0	0
10	44409402	.	C	G	1	1	2	0	0	2	0	0
10	44410082	.	C	T	3	7	10	0	0	10	0	0
10	44410088	.	G	A	5	3	8	0	1	9	0	0
10	44410975	.	T	C	2	2	4	0	0	4	0	0
10	44437145	.	T	C	7	5	12	0	1	13	0	0
10	44465477	.	C	T	0	2	2	0	0	2	0	0
10	44503882	.	G	A	7	7	14	0	0	14	0	0
10	44506313	.	C	T	0	3	3	0	2	5	0	0
10	44513232	.	T	C	2	3	5	0	1	6	0	0
10	44513270	.	T	C	3	0	3	0	5	8	0	0
10	44513307	.	T	C	1	3	4	0	0	4	0	0
10	44513402	.	T	C	4	0	4	0	8	12	0	0
10	44513421	.	C	T	0	7	7	0	6	13	0	0
10	44515911	.	G	C	2	2	4	0	0	4	0	0
10	44515927	.	T	C	2	2	4	0	1	5	0	0
10	44516001	.	C	T	0	5	5	0	4	9	0	0
10	44516270	.	G	T	5	2	7	0	1	8	0	0
10	44516907	.	G	T	2	2	4	0	0	4	0	0
10	44516908	.	T	C	2	0	2	0	2	4	0	0
10	44516955	.	C	T	2	4	6	0	0	6	0	0
10	44517092	.	G	A	4	2	6	0	0	6	0	0
10	44517170	.	C	T	0	1	1	0	1	2	0	0
10	44581983	.	C	G	1	0	1	0	0	1	0	0
10	44640688	.	A	C	1	7	8	0	1	9	0	0
10	44640700	.	C	T	2	8	10	0	0	10	0	0
10	44640725	.	C	A	6	2	8	0	0	8	0	0
10	44640742	.	G	A	0	4	4	0	6	10	0	0
10	44640832	.	G	A	5	7	12	0	0	12	0	0
10	44640873	.	G	A	2	4	6	0	1	7	0	0
10	44640910	.	A	C	7	4	11	0	0	11	0	0
10	44641025	.	G	A	2	2	4	0	0	4	0	0
10	44641815	.	C	A	6	6	12	0	0	12	0	0
10	44648115	.	G	T	0	4	4	0	8	12	0	0
10	44648627	.	C	T	2	0	2	0	0	2	0	0
10	44650913	.	G	A	0	9	9	0	10	19	0	0
10	44652561	.	G	A	0	1	1	0	1	2	0	0
10	44656821	.	C	G	3	2	5	0	0	5	0	0
10	44656863	.	C	T	10	8	18	0	0	18	0	0
10	44656926	.	C	T	3	0	3	0	0	3	0	0
10	44659668	.	A	G	3	3	6	0	1	7	0	0
10	44663082	.	A	G	11	11	22	0	1	23	0	0
10	44665345	.	G	T	0	6	6	0	8	14	0	0
10	44665536	.	A	T	10	11	21	0	0	21	0	0
10	44665620	.	C	T	8	5	13	0	0	13	0	0
10	44667125	.	T	C	3	7	10	0	0	10	0	0
10	44669497	.	A	G	7	9	16	0	0	16	0	0
10	44671799	.	G	A	1	15	16	0	13	29	0	0
10	44671818	.	A	C	16	12	28	0	2	31	1	0
10	44672036	.	T	A	20	22	42	0	0	42	0	0
10	44672228	.	G	A	8	7	15	0	0	15	0	0
10	44693445	.	G	A	3	6	9	5	2	16	0	0
10	44693523	.	T	G	26	4	30	2	18	50	0	0
10	44693556	.	C	T	15	15	30	1	2	33	0	0
10	44693769	.	C	T	15	13	28	2	7	37	0	0
10	44693799	.	T	C	16	12	28	0	1	29	0	0
10	44693868	.	G	A	1	0	1	2	1	4	0	0
10	44694354	.	G	A	1	14	15	0	4	19	0	0
10	44738221	.	G	A	0	3	3	0	1	4	0	0
10	44738290	.	C	T	0	5	5	0	0	5	0	0
10	44746221	.	T	C	1	1	2	0	1	3	0	0
10	44900001	.	T	C	1	2	3	0	0	3	0	0
10	44900578	.	A	G	0	7	7	0	0	7	0	0
10	44900592	.	G	A	1	7	8	0	0	8	0	0
10	44900901	.	T	G	1	2	3	0	0	3	0	0
10	44905224	.	A	G	3	1	4	0	0	4	0	0
10	44914623	.	A	G	10	0	10	0	6	16	0	0
10	44914685	.	G	T	11	9	20	0	0	20	0	0
10	44914761	.	T	A	6	7	13	0	0	13	0	0
10	44940952	.	G	T	0	4	4	0	5	9	0	0
10	44941051	.	C	T	1	3	4	0	0	4	0	0
10	44941408	.	G	A	1	2	3	0	0	3	0	0
10	44979593	.	A	T	2	3	5	0	0	5	0	0
10	44979767	.	A	G	1	3	4	0	1	5	0	0
10	44980379	.	T	C	6	5	11	0	0	11	0	0
10	44980391	.	C	T	5	4	9	0	0	9	0	0
10	44980638	.	G	C	6	4	10	0	0	10	0	0
10	44980913	.	C	T	8	4	12	0	0	12	0	0
10	44989378	.	C	T	2	3	5	0	1	6	0	0
10	44989384	.	T	C	3	6	9	0	0	9	0	0
10	44990917	.	C	T	7	5	12	0	1	13	0	0
10	45045097	.	T	C	0	1	1	0	0	1	0	0
10	45053620	.	C	A	3	2	5	0	1	6	0	0
10	45055879	.	G	A	8	6	14	0	1	15	0	0
10	45055948	.	G	A	2	1	3	0	0	3	0	0
10	45059822	.	C	T	6	4	10	0	1	11	0	0
10	45064957	.	C	T	21	10	31	0	0	31	0	0
10	45099498	.	T	C	2	6	8	0	0	8	0	0
10	45099522	.	T	C	2	6	8	0	0	8	0	0
10	45101543	.	G	A	0	2	2	0	0	2	0	0
10	45103519	.	C	T	5	1	6	0	0	6	0	0
10	45105244	.	T	C	2	1	3	0	0	3	0	0
10	45160904	.	C	A	1	0	1	0	0	1	0	0
10	45160907	.	C	T	1	0	1	0	0	1	0	0
10	45175496	.	G	A	0	2	2	0	0	2	0	0
10	45180335	.	C	T	4	2	6	0	0	6	0	0
10	45187450	.	T	C	1	5	6	0	0	6	0	0
10	45190629	.	C	T	3	1	4	0	0	4	0	0
10	45203109	.	T	C	2	2	4	0	0	4	0	0
10	45203154	.	A	G	3	5	8	0	0	8	0	0
10	45203271	.	T	A	3	5	8	0	1	9	0	0
10	45203502	.	A	G	4	0	4	0	2	6	0	0
10	45203645	.	A	G	1	3	4	0	0	4	0	0
10	45203700	.	A	C	3	2	5	0	0	5	0	0
10	45203704	.	T	G	3	2	5	0	0	5	0	0
10	45203793	.	G	A	1	2	3	0	10	13	0	0
10	45203856	.	G	A	8	6	14	0	1	15	0	0
10	45203882	.	A	G	13	3	16	0	0	16	0	0
10	45204151	.	A	G	3	3	6	0	0	6	0	0
10	45204611	.	A	G	4	1	5	0	0	5	0	0
10	45204621	.	T	C	4	2	6	0	1	7	0	0
10	45204769	.	T	A	1	2	3	0	0	3	0	0
10	45205166	.	A	C	4	6	10	1	2	13	0	0
10	45205175	.	A	G	4	0	4	0	6	10	0	0
10	45205226	.	A	G	6	0	6	0	8	14	0	0
10	45205237	.	C	G	7	0	7	0	9	17	1	0
10	45205284	.	A	C	9	12	21	0	1	22	0	0
10	45205295	.	A	G	7	0	7	0	13	20	0	0
10	45205400	.	C	A	1	7	8	0	0	8	0	0
10	45205757	.	C	A	2	4	6	0	0	6	0	0
10	45205758	.	A	G	2	4	6	0	0	6	0	0
10	45206103	.	C	G	3	4	7	0	0	8	1	0
10	45206182	.	G	A	3	5	8	0	0	8	0	0
10	45206199	.	A	C	4	0	4	0	4	8	0	0
10	45206217	.	C	A	4	2	6	0	0	6	0	0
10	45206241	.	T	A	11	7	18	0	0	18	0	0
10	45206289	.	G	C	10	0	10	0	9	19	0	0
10	45208153	.	A	G	1	5	6	0	1	7	0	0
10	45208667	.	C	T	0	3	3	0	2	5	0	0
10	45208875	.	G	A	3	2	5	0	0	5	0	0
10	45208899	.	C	A	1	1	2	0	0	2	0	0
10	45213798	.	C	T	0	2	2	0	2	4	0	0
10	45222613	.	T	C	1	0	1	0	2	3	0	0
10	45229710	.	C	T	1	2	3	0	0	3	0	0
10	45248527	.	A	C	3	8	11	0	0	11	0	0
10	45248548	.	T	A	6	7	13	0	0	13	0	0
10	45248638	.	G	A	5	7	12	0	0	12	0	0
10	45313560	.	C	T	2	1	3	0	0	3	0	0
10	45313623	.	G	A	0	4	4	0	7	11	0	0
10	45313671	.	C	T	5	5	10	0	0	10	0	0
10	45322668	.	A	G	3	0	3	0	4	7	0	0
10	45325302	.	G	A	0	6	6	0	9	15	0	0
10	45334688	.	C	T	3	1	4	0	1	5	0	0
10	45336565	.	T	C	9	10	19	0	2	21	0	0
10	45340105	.	G	T	0	5	5	0	5	10	0	0
10	45340654	.	A	G	2	3	5	0	0	5	0	0
10	45340835	.	G	C	5	7	12	0	1	13	0	0
10	45340930	.	G	T	4	6	10	0	2	12	0	0
10	45341210	.	T	A	2	4	6	0	0	6	0	0
10	45341403	.	A	G	5	9	14	0	1	15	0	0
10	45341410	.	A	G	6	0	6	0	10	16	0	0
10	45341452	.	T	G	3	10	13	0	0	13	0	0
10	45341537	.	A	C	9	9	18	0	1	19	0	0
10	45341546	.	A	C	8	9	17	0	1	18	0	0
10	45341572	.	G	C	0	9	9	0	8	17	0	0
10	45341596	.	C	T	4	7	11	0	3	14	0	0
10	45341762	.	A	T	6	7	13	0	0	13	0	0
10	45345626	.	C	T	2	4	6	0	0	6	0	0
10	45349924	.	G	A	9	13	22	0	1	23	0	0
10	45351037	.	C	T	9	7	16	0	1	17	0	0
10	45352231	.	C	T	18	12	30	0	3	33	0	0
10	45375714	.	G	T	4	1	5	0	0	5	0	0
10	45375732	.	C	T	2	1	3	0	0	3	0	0
11	126334	.	G	A	7	4	11	0	1	12	0	0
11	126595	.	A	T	4	9	13	0	1	14	0	0
11	127139	.	G	A	1	2	3	0	0	3	0	0
11	185396	.	C	T	0	4	4	0	4	8	0	0
11	185624	.	T	A	13	17	30	0	0	30	0	0
11	185678	.	G	A	6	16	22	0	0	22	0	0
11	185775	.	C	T	0	20	20	0	14	34	0	0
11	185890	.	A	G	13	20	33	0	1	34	0	0
11	185902	.	A	G	13	18	31	0	0	31	0	0
11	186235	.	G	A	3	10	13	0	2	15	0	0
11	186526	.	A	T	2	3	5	0	1	6	0	0
11	186580	.	G	A	8	6	14	0	0	14	0	0
11	186745	.	G	T	5	13	18	0	0	18	0	0
11	186798	.	T	G	5	15	20	0	0	20	0	0
11	186939	.	A	G	13	17	30	0	5	35	0	0
11	187022	.	C	A	11	18	29	0	1	30	0	0
11	187104	.	T	A	19	19	38	0	3	41	0	0
11	187399	.	A	C	2	8	10	0	0	10	0	0
11	221929	.	T	C	19	1	20	0	16	36	0	0
11	222488	.	C	G	6	9	15	0	1	16	0	0
11	222722	.	C	T	0	11	11	0	5	16	0	0
11	222729	.	C	T	0	11	11	0	7	18	0	0
11	222776	.	C	T	7	19	26	0	0	26	0	0
11	222787	.	A	G	7	16	23	0	1	24	0	0
11	223319	.	G	A	8	3	11	0	0	11	0	0
11	223806	.	A	G	14	11	25	0	0	25	0	0
11	233672	.	A	T	15	9	24	0	0	24	0	0
11	233674	.	G	A	12	9	21	0	3	24	0	0
11	236437	.	C	T	5	4	9	0	0	9	0	0
11	236551	.	G	A	11	5	16	0	0	16	0	0
11	236602	.	A	C	4	0	4	0	8	12	0	0
11	260909	.	G	A	16	4	20	0	0	20	0	0
11	265097	.	T	G	3	3	6	0	0	6	0	0
11	265404	.	G	A	11	10	21	0	0	21	0	0
11	265497	.	C	T	0	9	9	0	19	28	0	0
11	265506	.	G	C	19	9	28	0	0	28	0	0
11	268887	.	G	A	2	0	2	0	0	2	0	0
11	270090	.	A	G	12	11	23	0	2	25	0	0
11	281887	.	A	T	3	4	7	0	0	7	0	0
11	281961	.	A	G	3	5	8	0	1	9	0	0
11	282193	.	T	G	5	3	8	0	2	10	0	0
11	282279	.	A	T	7	10	17	0	0	17	0	0
11	282362	.	T	C	7	3	10	0	0	10	0	0
11	282546	.	G	T	10	10	20	0	0	20	0	0
11	282553	.	A	G	9	9	18	0	1	19	0	0
11	282602	.	T	G	8	7	15	0	0	15	0	0
11	283164	.	G	C	3	1	4	0	1	5	0	0
11	284424	.	G	T	4	5	9	0	0	9	0	0
11	296453	.	T	A	6	2	8	0	0	8	0	0
11	322076	.	G	A	0	2	2	0	3	5	0	0
11	339678	.	G	T	0	1	1	0	0	1	0	0
11	475314	.	C	T	0	7	7	0	0	7	0	0
11	675382	.	G	C	28	23	51	0	0	51	0	0
11	677100	.	A	G	10	9	19	0	6	25	0	0
11	677264	.	T	C	25	25	50	0	7	57	0	0
11	677341	.	T	C	14	27	41	0	2	43	0	0
11	682905	.	C	T	5	9	14	0	1	15	0	0
11	682926	.	A	G	10	19	29	0	0	29	0	0
11	682943	.	G	A	13	24	37	0	0	37	0	0
11	687501	.	G	A	7	7	14	0	0	14	0	0
11	718214	.	G	A	13	5	18	0	0	18	0	0
11	718404	.	A	C	2	5	7	0	0	7	0	0
11	762445	.	A	G	13	11	24	0	3	27	0	0
11	779785	.	C	A	8	5	13	0	0	13	0	0
11	779863	.	T	A	1	4	5	0	0	5	0	0
11	813652	.	A	G	3	2	5	0	0	5	0	0
11	813851	.	T	C	7	0	7	0	8	15	0	0
11	813923	.	T	C	2	0	2	0	6	8	0	0
11	1148869	.	G	A	23	16	39	0	1	40	0	0
11	1148889	.	G	A	17	22	39	0	1	40	0	0
11	1149105	.	C	T	24	16	40	0	2	42	0	0
11	1149593	.	A	G	32	9	41	0	2	43	0	0
11	1149812	.	C	T	5	28	33	0	32	65	0	0
11	1163295	.	C	T	36	17	53	0	1	54	0	0
11	1165993	.	G	A	6	3	9	0	0	9	0	0
11	1166326	.	G	C	27	2	29	0	23	52	0	0
11	1177389	.	C	A	0	3	3	0	4	7	0	0
11	1183007	.	G	A	7	3	10	0	0	10	0	0
11	1183602	.	C	T	1	10	11	0	7	18	0	0
11	1183739	.	G	T	16	24	40	0	1	41	0	0
11	1198390	.	G	C	8	9	17	0	0	17	0	0
11	1198419	.	G	A	16	15	31	0	0	31	0	0
11	1198450	.	G	A	15	24	39	0	0	39	0	0
11	1198507	.	G	T	16	19	35	0	7	42	0	0
11	1203619	.	G	A	11	9	20	0	1	21	0	0
11	1221865	.	A	G	15	17	32	0	0	32	0	0
11	1222025	.	T	G	16	14	30	0	1	31	0	0
11	1337621	.	C	G	1	3	4	0	0	4	0	0
11	1341402	.	C	T	0	2	2	0	1	3	0	0
11	1342778	.	G	A	3	1	4	0	0	4	0	0
11	1342826	.	A	G	8	5	13	0	0	13	0	0
11	1348596	.	A	G	0	1	1	0	0	1	0	0
11	1348821	.	A	C	4	7	11	0	0	11	0	0
11	1351542	.	C	T	0	4	4	0	3	7	0	0
11	1351563	.	T	G	3	8	11	0	0	11	0	0
11	1351611	.	A	G	4	5	9	0	0	9	0	0
11	1359391	.	G	T	1	0	1	0	0	1	0	0
11	1365078	.	T	C	3	3	6	0	0	6	0	0
11	1389712	.	A	G	1	1	2	0	0	2	0	0
11	1396244	.	T	G	1	2	3	0	0	3	0	0
11	1396343	.	T	C	13	18	31	0	3	34	0	0
11	1399367	.	G	A	1	2	3	0	1	4	0	0
11	1403921	.	A	C	3	4	7	0	0	7	0	0
11	1403969	.	G	A	4	3	7	0	0	7	0	0
11	1404031	.	A	C	1	4	5	0	0	5	0	0
11	1404165	.	C	T	4	6	10	0	0	10	0	0
11	1404481	.	C	A	3	8	11	0	0	11	0	0
11	1404640	.	T	C	4	0	4	0	3	7	0	0
11	1404642	.	A	G	3	3	6	0	1	7	0	0
11	1406012	.	T	C	1	2	3	0	0	3	0	0
11	1408791	.	G	T	1	3	4	0	0	4	0	0
11	1408802	.	G	T	2	3	5	0	0	5	0	0
11	1427981	.	T	C	1	0	1	0	0	1	0	0
11	1435736	.	A	G	7	6	13	0	0	13	0	0
11	1467114	.	T	C	11	0	11	0	6	17	0	0
11	1467130	.	C	A	0	3	3	0	9	12	0	0
11	1469842	.	C	T	5	7	12	0	7	19	0	0
11	1469859	.	A	G	7	14	21	0	1	22	0	0
11	1469895	.	A	G	6	13	19	0	1	20	0	0
11	1470503	.	G	A	6	13	19	0	1	20	0	0
11	1470535	.	G	C	3	7	10	0	0	10	0	0
11	1470574	.	T	C	0	1	1	0	0	1	0	0
11	1474629	.	C	T	3	0	3	0	2	5	0	0
11	1512947	.	T	C	5	3	8	0	0	8	0	0
11	1512950	.	A	C	4	3	7	0	1	8	0	0
11	1516755	.	T	G	0	2	2	0	0	2	0	0
11	1516773	.	G	T	0	2	2	0	0	2	0	0
11	1517289	.	C	A	1	5	6	0	0	6	0	0
11	1522194	.	C	G	17	0	17	0	20	37	0	0
11	1522205	.	G	T	20	16	36	0	2	38	0	0
11	1522291	.	T	C	7	9	16	0	0	16	0	0
11	1523846	.	T	C	3	2	5	0	0	5	0	0
11	1524079	.	T	C	5	6	11	0	2	13	0	0
11	1524108	.	C	T	8	9	17	0	1	18	0	0
11	1525081	.	G	C	10	9	19	0	2	21	0	0
11	1525389	.	G	T	4	8	12	0	1	13	0	0
11	1525416	.	T	A	1	2	3	0	1	4	0	0
11	1526749	.	A	G	2	1	3	0	0	3	0	0
11	1529260	.	A	G	23	11	34	0	0	34	0	0
11	1529526	.	G	A	15	10	25	0	1	26	0	0
11	1529743	.	G	A	11	15	26	0	2	28	0	0
11	1529789	.	A	C	9	14	23	0	1	24	0	0
11	1529796	.	A	T	9	14	23	0	2	25	0	0
11	1529838	.	A	G	8	10	18	0	3	21	0	0
11	1529852	.	A	G	12	5	17	0	1	18	0	0
11	1530027	.	G	A	8	12	20	0	0	20	0	0
11	1530196	.	A	G	21	7	28	0	4	32	0	0
11	1530295	.	A	C	16	13	29	0	1	30	0	0
11	1530363	.	A	G	7	20	27	0	1	28	0	0
11	1530489	.	A	G	11	1	12	0	15	27	0	0
11	1530541	.	A	G	10	14	24	0	1	25	0	0
11	1530584	.	G	A	0	16	16	0	16	32	0	0
11	1530593	.	G	T	15	14	29	0	3	32	0	0
11	1530642	.	G	A	8	10	18	0	3	21	0	0
11	1535427	.	C	A	3	3	6	0	0	6	0	0
11	1542605	.	A	G	1	0	1	0	1	2	0	0
11	1545883	.	A	C	2	2	4	0	1	5	0	0
11	1718046	.	A	G	1	2	3	0	0	3	0	0
11	1741883	.	C	T	1	2	3	0	0	3	0	0
11	1742003	.	C	T	0	2	2	0	0	2	0	0
11	1751589	.	T	A	2	1	3	0	0	3	0	0
11	1764291	.	C	T	1	2	3	0	0	3	0	0
11	1764381	.	C	T	0	1	1	0	0	1	0	0
11	1764731	.	C	T	3	6	9	0	0	9	0	0
11	1771294	.	T	C	1	2	3	0	1	4	0	0
11	1776672	.	G	A	2	2	4	0	0	4	0	0
11	1793477	.	A	C	0	1	1	0	0	1	0	0
11	1796835	.	C	T	0	2	2	0	0	2	0	0
11	1799763	.	G	A	0	2	2	0	0	2	0	0
11	1799778	.	C	T	0	2	2	0	0	2	0	0
11	1805810	.	T	C	1	1	2	0	0	2	0	0
11	1812288	.	A	G	3	0	3	0	7	10	0	0
11	1812951	.	T	A	0	1	1	0	0	1	0	0
11	1813240	.	A	G	8	4	12	0	0	12	0	0
11	1815978	.	C	T	8	5	13	0	1	14	0	0
11	1818005	.	C	T	0	1	1	0	0	1	0	0
11	1823329	.	T	G	5	0	5	0	6	11	0	0
11	1829952	.	C	T	3	3	6	0	1	7	0	0
11	1830621	.	T	C	1	4	5	0	0	5	0	0
11	1834124	.	T	C	5	9	14	0	1	15	0	0
11	1836100	.	C	A	0	1	1	0	0	1	0	0
11	1836995	.	C	G	14	0	14	0	9	23	0	0
11	1838725	.	G	C	0	4	4	0	2	6	0	0
11	1841961	.	G	C	3	1	4	0	1	5	0	0
11	1843339	.	G	T	1	2	3	0	0	3	0	0
11	1843771	.	C	A	10	13	23	0	0	23	0	0
11	1843812	.	A	G	6	0	6	0	6	12	0	0
11	1843818	.	G	A	5	4	9	0	0	9	0	0
11	1863846	.	T	G	16	15	31	0	1	32	0	0
11	1864095	.	C	A	17	12	29	0	1	30	0	0
11	1864216	.	C	T	11	12	23	0	0	23	0	0
11	1917820	.	G	A	1	2	3	0	0	3	0	0
11	1918503	.	A	C	1	1	2	0	1	3	0	0
11	1919016	.	T	A	2	1	3	0	0	3	0	0
11	1919054	.	T	G	4	0	4	0	3	7	0	0
11	1945034	.	T	A	9	11	20	0	2	22	0	0
11	1945036	.	C	T	9	13	22	0	0	22	0	0
11	1945229	.	C	T	5	1	6	0	0	6	0	0
11	1947965	.	A	G	6	4	10	0	0	10	0	0
11	1948373	.	A	T	9	9	18	0	0	18	0	0
11	1967076	.	C	A	3	8	11	0	0	11	0	0
11	1967111	.	T	A	4	11	15	0	1	16	0	0
11	1967187	.	T	C	6	7	13	0	0	13	0	0
11	2218261	.	C	G	0	2	2	0	4	6	0	0
11	2240120	.	A	C	9	5	14	0	3	17	0	0
11	2244445	.	A	G	4	3	7	0	1	8	0	0
11	2249884	.	A	G	15	19	34	0	0	34	0	0
11	2249920	.	C	T	2	5	7	0	1	8	0	0
11	2253154	.	G	A	11	3	14	0	0	14	0	0
11	2254466	.	G	T	0	2	2	0	0	2	0	0
11	2255025	.	T	G	5	10	15	0	0	15	0	0
11	2255027	.	T	G	5	10	15	0	0	15	0	0
11	2263484	.	T	G	2	0	2	0	0	2	0	0
11	2290246	.	T	C	2	1	3	0	0	3	0	0
11	2292997	.	G	A	5	1	6	0	1	7	0	0
11	2445312	.	G	T	0	0	0	0	1	1	0	0
11	2445314	.	A	T	1	0	1	0	0	1	0	0
11	2458371	.	T	G	4	3	7	0	1	8	0	0
11	2462830	.	A	G	3	3	6	0	0	6	0	0
11	2462831	.	G	A	3	3	6	0	0	6	0	0
11	2506878	.	C	T	3	5	8	0	0	8	0	0
11	2507001	.	G	A	0	2	2	0	3	5	0	0
11	2507529	.	C	G	0	1	1	0	0	1	0	0
11	2507539	.	C	T	3	0	3	0	0	3	0	0
11	2541797	.	T	C	4	2	6	0	1	7	0	0
11	2542391	.	C	T	1	5	6	0	0	6	0	0
11	2543188	.	A	C	2	0	2	0	3	5	0	0
11	2545012	.	C	T	0	2	2	0	2	4	0	0
11	2545018	.	A	G	2	2	4	0	0	4	0	0
11	2545462	.	C	G	4	1	5	0	0	5	0	0
11	2545487	.	G	A	1	4	5	0	0	5	0	0
11	2545582	.	A	G	1	3	4	0	0	4	0	0
11	2559681	.	T	C	1	1	2	0	0	2	0	0
11	2571562	.	T	A	2	3	5	0	0	5	0	0
11	2571635	.	A	G	8	5	13	0	1	14	0	0
11	2571685	.	C	A	1	2	3	0	0	3	0	0
11	2571686	.	A	T	1	2	3	0	0	3	0	0
11	2576843	.	T	C	2	0	2	0	1	3	0	0
11	2576876	.	C	T	1	0	1	0	0	1	0	0
11	2584328	.	C	T	0	1	1	0	0	1	0	0
11	2585371	.	T	C	1	3	4	0	0	4	0	0
11	2587205	.	T	C	1	3	4	0	0	4	0	0
11	2593620	.	T	A	1	4	5	0	0	5	0	0
11	2593645	.	T	G	1	3	4	0	0	4	0	0
11	2593659	.	A	T	3	2	5	0	0	5	0	0
11	2597009	.	G	A	2	2	4	0	0	4	0	0
11	2597028	.	T	G	1	0	1	0	2	3	0	0
11	2601114	.	T	A	4	2	6	0	0	6	0	0
11	2601414	.	C	T	1	3	4	0	0	4	0	0
11	2603073	.	G	T	0	1	1	0	0	1	0	0
11	2605763	.	G	A	0	1	1	0	0	1	0	0
11	2605981	.	A	G	2	1	3	0	0	3	0	0
11	2609385	.	A	T	3	3	6	0	1	7	0	0
11	2609527	.	A	G	1	0	1	0	2	3	0	0
11	2616956	.	T	C	11	12	23	0	0	23	0	0
11	2617031	.	T	A	6	14	20	0	1	21	0	0
11	2617072	.	A	G	3	8	11	0	0	11	0	0
11	2617179	.	A	G	10	3	13	0	0	13	0	0
11	2618036	.	A	G	11	4	15	0	0	15	0	0
11	2618049	.	T	C	10	3	13	0	1	14	0	0
11	2618653	.	C	A	10	5	15	0	0	15	0	0
11	2619089	.	G	A	7	15	22	0	0	22	0	0
11	2619129	.	C	A	8	12	20	0	0	20	0	0
11	2619515	.	T	A	8	5	13	0	1	14	0	0
11	2619538	.	T	A	9	7	16	0	1	17	0	0
11	2619588	.	G	C	10	0	10	0	13	23	0	0
11	2621839	.	G	A	5	8	13	0	0	13	0	0
11	2625178	.	G	A	7	11	18	0	0	18	0	0
11	2625224	.	T	A	8	11	19	0	0	19	0	0
11	2625247	.	T	C	6	7	13	0	1	14	0	0
11	2628038	.	T	G	10	5	15	0	0	15	0	0
11	2650018	.	T	G	8	8	16	0	0	16	0	0
11	2655888	.	G	C	1	2	3	0	0	3	0	0
11	2655957	.	G	C	0	7	7	0	8	15	0	0
11	2656062	.	C	G	5	6	11	0	0	11	0	0
11	2660045	.	A	G	0	1	1	0	1	2	0	0
11	2660075	.	G	A	2	3	5	0	0	5	0	0
11	2660602	.	T	C	1	0	1	0	0	1	0	0
11	2660809	.	G	A	0	6	6	0	4	10	0	0
11	2664585	.	A	C	1	4	5	0	1	6	0	0
11	2665236	.	T	A	3	6	9	0	0	9	0	0
11	2673624	.	T	C	5	5	10	0	0	10	0	0
11	2675447	.	C	A	5	12	17	0	0	17	0	0
11	2675454	.	A	C	11	5	16	0	1	17	0	0
11	2677377	.	G	C	3	1	4	0	0	4	0	0
11	2677404	.	G	A	0	6	6	0	5	11	0	0
11	2677428	.	A	G	10	6	16	0	1	17	0	0
11	2677440	.	C	T	9	7	16	0	0	16	0	0
11	2678064	.	G	A	4	9	13	0	0	13	0	0
11	2678088	.	G	A	11	5	16	0	2	18	0	0
11	2680570	.	G	A	0	4	4	0	6	10	0	0
11	2680747	.	C	T	7	3	10	0	1	11	0	0
11	2680797	.	G	C	8	6	14	0	0	14	0	0
11	2681432	.	A	G	0	5	5	0	0	5	0	0
11	2682123	.	C	T	1	2	3	0	0	3	0	0
11	2682157	.	A	G	1	1	2	0	0	2	0	0
11	2682316	.	A	G	4	1	5	0	0	5	0	0
11	2682414	.	A	G	2	3	5	0	0	5	0	0
11	2682441	.	A	T	2	3	5	0	2	7	0	0
11	2682470	.	A	T	2	3	5	0	0	6	1	0
11	2682551	.	C	T	7	5	12	0	0	12	0	0
11	2682555	.	A	T	5	6	11	0	1	12	0	0
11	2682644	.	A	T	7	4	11	0	0	11	0	0
11	2682664	.	T	A	3	4	7	0	1	8	0	0
11	2682866	.	T	C	3	4	7	0	0	7	0	0
11	2683509	.	T	C	3	17	20	0	1	21	0	0
11	2687421	.	C	T	0	2	2	0	0	2	0	0
11	2687472	.	C	T	5	3	8	0	2	10	0	0
11	2687526	.	G	A	7	6	13	0	0	13	0	0
11	2687550	.	A	C	9	6	15	0	1	16	0	0
11	2688119	.	G	A	5	8	13	0	0	13	0	0
11	2688582	.	A	C	4	8	12	0	1	13	0	0
11	2688916	.	G	C	2	8	10	0	0	10	0	0
11	2689336	.	G	A	2	5	7	0	0	7	0	0
11	2689337	.	G	A	2	5	7	0	0	7	0	0
11	2689842	.	A	G	4	2	6	0	0	6	0	0
11	2690122	.	A	G	3	3	6	0	0	6	0	0
11	2690131	.	A	G	4	4	8	0	0	8	0	0
11	2690233	.	G	T	3	10	13	0	0	13	0	0
11	2690303	.	G	C	7	9	16	0	0	16	0	0
11	2690445	.	G	T	5	12	17	0	0	17	0	0
11	2690499	.	C	T	7	4	11	0	0	11	0	0
11	2690564	.	G	T	9	4	13	0	0	13	0	0
11	2690612	.	A	C	9	5	14	0	0	14	0	0
11	2690869	.	C	A	4	7	11	0	0	11	0	0
11	2690873	.	G	A	0	6	6	0	4	10	0	0
11	2692180	.	C	T	4	3	7	0	1	8	0	0
11	2692579	.	T	G	2	0	2	0	3	5	0	0
11	2702718	.	T	C	3	6	9	0	0	9	0	0
11	2702766	.	C	T	4	7	11	0	0	11	0	0
11	2702808	.	T	C	1	1	2	0	0	2	0	0
11	2705206	.	C	T	1	9	10	0	2	12	0	0
11	2705273	.	A	G	6	0	6	0	5	11	0	0
11	2705325	.	G	A	12	3	15	0	0	15	0	0
11	2705355	.	T	A	6	15	21	0	0	21	0	0
11	2705657	.	A	G	12	5	17	0	1	18	0	0
11	2706517	.	T	G	11	11	22	0	0	22	0	0
11	2706734	.	T	C	14	11	25	0	0	25	0	0
11	2706838	.	A	G	8	6	14	0	0	14	0	0
11	2706988	.	C	A	5	2	7	0	0	7	0	0
11	2710611	.	A	T	4	5	9	0	0	9	0	0
11	2710642	.	G	A	5	6	11	0	1	12	0	0
11	2710770	.	A	T	6	3	9	0	0	9	0	0
11	2743661	.	C	T	3	6	9	0	0	9	0	0
11	2755120	.	A	T	1	1	2	0	0	2	0	0
11	2756250	.	C	T	6	7	13	0	0	13	0	0
11	2757582	.	T	C	3	5	8	0	0	8	0	0
11	2758204	.	C	T	7	9	16	0	0	16	0	0
11	2759003	.	C	A	3	3	6	0	0	6	0	0
11	2759007	.	C	T	3	3	6	0	0	6	0	0
11	2759043	.	A	T	6	8	14	0	0	14	0	0
11	2759425	.	A	G	2	2	4	0	2	6	0	0
11	2759461	.	T	C	7	7	14	0	0	14	0	0
11	2759475	.	G	T	8	5	13	0	0	13	0	0
11	2759498	.	G	A	4	5	9	0	0	9	0	0
11	2759833	.	G	A	0	16	16	0	4	20	0	0
11	2759843	.	G	A	0	18	18	0	5	23	0	0
11	2759901	.	T	G	6	14	20	0	0	20	0	0
11	2759903	.	A	T	13	6	19	0	1	20	0	0
11	2759938	.	A	G	6	13	19	0	0	19	0	0
11	2760240	.	C	T	4	2	6	0	0	6	0	0
11	2805410	.	C	A	6	9	15	0	0	15	0	0
11	2809744	.	C	T	5	7	12	0	1	13	0	0
11	2809777	.	A	G	10	0	10	0	13	23	0	0
11	2809804	.	A	G	14	13	27	0	1	28	0	0
11	2813856	.	G	C	14	16	30	0	2	32	0	0
11	2815790	.	C	G	9	11	20	0	0	20	0	0
11	2815845	.	C	T	25	16	41	0	2	43	0	0
11	2820876	.	T	G	8	8	16	0	1	17	0	0
11	2820900	.	A	C	4	0	4	0	1	5	0	0
11	2826184	.	T	C	16	14	30	0	1	31	0	0
11	2826338	.	G	T	18	14	32	0	1	33	0	0
11	2826485	.	C	A	11	13	24	0	1	25	0	0
11	2828174	.	A	G	8	25	33	0	0	33	0	0
11	2828276	.	C	A	18	11	29	0	0	29	0	0
11	2828388	.	G	A	13	13	26	0	0	26	0	0
11	2920211	.	T	A	1	0	1	0	0	1	0	0
11	2920219	.	T	A	1	1	2	0	0	2	0	0
11	3148157	.	C	A	0	1	1	0	0	1	0	0
11	3170359	.	A	G	4	0	4	0	3	7	0	0
11	3195739	.	G	T	0	5	5	0	2	7	0	0
11	3195757	.	A	C	2	4	6	0	0	6	0	0
11	3217970	.	C	T	1	2	3	0	0	3	0	0
11	3221014	.	C	T	1	0	1	0	0	1	0	0
11	3222083	.	A	G	0	2	2	0	0	2	0	0
11	3227302	.	A	T	2	7	9	0	0	9	0	0
11	3227343	.	G	A	3	2	5	0	1	6	0	0
11	3230284	.	G	A	4	2	6	0	0	6	0	0
11	3235543	.	C	T	2	4	6	0	0	6	0	0
11	3238484	.	A	G	3	2	5	0	0	5	0	0
11	3238651	.	C	T	2	1	3	0	0	3	0	0
11	3238720	.	T	C	2	2	4	0	0	4	0	0
11	3240457	.	G	A	0	5	5	0	3	8	0	0
11	3243124	.	A	G	0	0	0	0	1	1	0	0
11	3246120	.	A	G	1	12	13	0	0	13	0	0
11	3246133	.	A	G	3	15	18	0	0	18	0	0
11	3246590	.	A	C	2	0	2	0	0	2	0	0
11	3249253	.	C	T	6	4	10	0	0	10	0	0
11	3249346	.	C	T	4	6	10	0	0	10	0	0
11	3249370	.	A	G	4	0	4	0	4	8	0	0
11	3317389	.	A	T	5	3	8	0	0	8	0	0
11	3321115	.	A	G	6	2	8	0	0	8	0	0
11	3321141	.	A	T	9	3	12	0	0	12	0	0
11	3323377	.	G	T	7	6	13	0	0	13	0	0
11	3327451	.	G	A	4	3	7	0	0	7	0	0
11	3333841	.	T	C	3	3	6	0	0	6	0	0
11	3336700	.	T	G	25	30	55	0	2	57	0	0
11	3336793	.	C	T	33	34	67	0	2	69	0	0
11	3337038	.	A	G	44	23	67	0	1	68	0	0
11	3337253	.	A	G	27	35	62	0	3	65	0	0
11	3337256	.	T	C	25	1	26	0	37	63	0	0
11	3337481	.	T	G	21	29	50	0	1	51	0	0
11	3337482	.	A	T	22	27	49	0	2	51	0	0
11	3337718	.	G	C	24	25	49	0	2	51	0	0
11	3338060	.	C	G	23	22	45	0	1	46	0	0
11	3338144	.	T	C	36	20	56	0	2	58	0	0
11	3338236	.	T	C	29	0	29	0	21	50	0	0
11	3338288	.	T	A	25	24	49	1	2	52	0	0
11	3338299	.	T	G	23	25	48	1	2	51	0	0
11	3338420	.	A	T	19	27	46	0	6	52	0	0
11	3338431	.	C	T	1	27	28	0	24	52	0	0
11	3338491	.	G	A	23	26	49	0	4	54	1	0
11	3338514	.	C	A	28	32	60	0	1	61	0	0
11	3338618	.	T	C	39	18	57	0	0	57	0	0
11	3338638	.	A	G	36	21	57	0	1	58	0	0
11	3338933	.	A	G	28	23	51	0	3	54	0	0
11	3339098	.	T	C	28	0	28	0	24	53	1	0
11	3339152	.	C	T	20	20	40	0	2	42	0	0
11	3341296	.	G	A	24	15	39	0	0	39	0	0
11	3345676	.	A	G	5	4	9	0	1	10	0	0
11	3345779	.	T	C	3	6	9	0	0	9	0	0
11	3345952	.	T	C	6	6	12	0	1	13	0	0
11	3347324	.	G	A	3	2	5	0	0	5	0	0
11	3347326	.	G	T	3	2	5	0	0	5	0	0
11	3348004	.	T	G	3	2	5	0	0	5	0	0
11	3351273	.	C	T	0	1	1	0	1	2	0	0
11	3351364	.	C	T	0	2	2	0	3	5	0	0
11	3351365	.	G	T	3	2	5	0	0	5	0	0
11	3367789	.	T	C	3	0	3	0	5	8	0	0
11	3367924	.	G	C	7	7	14	0	1	15	0	0
11	3367937	.	T	C	9	4	13	0	1	14	0	0
11	3369843	.	G	A	3	3	6	0	1	7	0	0
11	3373418	.	A	G	1	1	2	0	0	2	0	0
11	3373448	.	G	A	1	1	2	0	0	2	0	0
11	3373996	.	C	T	0	1	1	0	0	1	0	0
11	3377127	.	T	C	1	0	1	0	2	3	0	0
11	3379999	.	G	T	3	2	5	0	0	5	0	0
11	3380012	.	C	G	6	2	8	0	0	8	0	0
11	3380135	.	A	G	0	2	2	0	0	2	0	0
11	3381261	.	C	A	3	10	13	0	0	13	0	0
11	3395069	.	G	A	2	2	4	0	0	4	0	0
11	3395070	.	A	T	2	2	4	0	0	4	0	0
11	3395303	.	G	A	1	1	2	0	0	2	0	0
11	3395324	.	C	T	3	10	13	0	0	13	0	0
11	3395501	.	A	G	4	2	6	0	0	6	0	0
11	3401899	.	C	A	7	7	14	0	0	14	0	0
11	3422086	.	T	C	0	2	2	0	0	2	0	0
11	3423390	.	G	A	5	0	5	0	0	5	0	0
11	3423411	.	A	G	5	0	5	0	0	5	0	0
11	3425175	.	G	A	2	4	6	0	1	7	0	0
11	3494891	.	A	G	8	8	16	0	0	16	0	0
11	3494930	.	T	A	3	5	8	0	1	9	0	0
11	3514154	.	T	C	2	2	4	0	0	4	0	0
11	3520631	.	A	G	0	2	2	0	0	2	0	0
11	3523724	.	A	G	11	7	18	0	1	19	0	0
11	3523826	.	G	A	5	9	14	0	0	14	0	0
11	3523976	.	A	C	6	0	6	0	4	10	0	0
11	3523991	.	C	T	5	2	7	0	2	9	0	0
11	3524064	.	G	T	6	7	13	0	0	13	0	0
11	3524111	.	G	A	6	12	18	0	0	18	0	0
11	3524121	.	A	G	5	14	19	0	0	19	0	0
11	3524236	.	C	T	10	11	21	0	0	21	0	0
11	3524397	.	T	C	9	9	18	0	1	19	0	0
11	3524462	.	C	T	6	5	11	0	1	12	0	0
11	3524541	.	A	T	13	6	19	0	0	19	0	0
11	3524724	.	T	A	7	7	14	0	0	14	0	0
11	3524849	.	G	A	13	9	22	0	0	22	0	0
11	3526521	.	A	G	13	6	19	0	0	19	0	0
11	3526605	.	C	G	4	5	9	0	0	9	0	0
11	3528320	.	A	T	13	9	22	0	1	23	0	0
11	3530791	.	C	G	3	3	6	0	0	6	0	0
11	3530991	.	T	C	2	0	2	0	3	5	0	0
11	3532836	.	A	G	4	2	6	0	0	6	0	0
11	3533330	.	T	C	0	0	0	0	1	1	0	0
11	3533345	.	T	C	0	0	0	0	1	1	0	0
11	3535397	.	A	G	3	8	11	0	0	11	0	0
11	3535431	.	T	C	4	9	13	0	0	13	0	0
11	3535434	.	A	G	4	9	13	0	0	13	0	0
11	3550448	.	A	G	6	6	12	0	0	13	1	0
11	3550454	.	T	A	7	6	13	0	1	14	0	0
11	3551309	.	A	G	4	8	12	0	1	13	0	0
11	3551944	.	G	A	29	25	54	0	1	55	0	0
11	3563124	.	G	A	4	2	6	0	0	6	0	0
11	3563569	.	T	C	1	1	2	0	0	2	0	0
11	3563644	.	C	T	0	2	2	0	2	4	0	0
11	3563647	.	G	A	2	3	5	0	0	5	0	0
11	3563680	.	A	G	2	4	6	0	0	6	0	0
11	3579430	.	T	A	2	2	4	0	0	4	0	0
11	3593434	.	T	C	3	7	10	0	1	11	0	0
11	3593490	.	A	C	5	12	17	0	0	17	0	0
11	3593748	.	A	G	9	4	13	0	1	14	0	0
11	3593791	.	G	C	7	4	11	0	1	12	0	0
11	3593988	.	G	T	9	5	14	0	1	15	0	0
11	3594217	.	G	T	10	12	22	0	0	22	0	0
11	3594277	.	T	G	9	11	20	0	2	22	0	0
11	3594321	.	T	C	9	0	9	0	10	19	0	0
11	3594327	.	T	A	9	9	18	0	0	18	0	0
11	3594366	.	A	G	12	16	28	0	1	29	0	0
11	3594419	.	A	G	7	12	19	0	1	20	0	0
11	3594452	.	T	G	4	3	7	0	2	9	0	0
11	3594828	.	T	C	7	1	8	0	2	10	0	0
11	3595308	.	G	A	3	7	10	0	1	11	0	0
11	3595579	.	A	G	6	10	16	0	0	16	0	0
11	3602382	.	T	C	8	5	13	0	1	14	0	0
11	3603434	.	T	C	1	0	1	0	0	1	0	0
11	3604729	.	T	G	2	5	7	0	0	7	0	0
11	3604732	.	C	G	0	5	5	0	2	7	0	0
11	3604825	.	G	A	2	1	3	1	0	4	0	0
11	3606897	.	C	T	0	1	1	0	0	1	0	0
11	3606914	.	T	C	1	0	1	0	3	4	0	0
11	3606957	.	C	T	4	8	12	0	0	12	0	0
11	3609448	.	A	T	0	3	3	0	0	3	0	0
11	3848283	.	G	A	11	15	26	0	2	28	0	0
11	3848323	.	C	T	0	14	14	0	15	29	0	0
11	3848656	.	C	T	11	14	25	0	0	25	0	0
11	3860159	.	A	T	1	6	7	0	0	7	0	0
11	3893635	.	C	T	18	17	35	0	0	35	0	0
11	3893636	.	T	G	18	16	34	0	1	35	0	0
11	3893918	.	G	A	12	22	34	0	0	34	0	0
11	3893928	.	G	C	13	20	33	0	2	35	0	0
11	3894023	.	T	C	5	18	23	0	0	23	0	0
11	3898730	.	C	A	0	0	0	0	1	1	0	0
11	3898736	.	A	G	1	5	6	0	0	6	0	0
11	3899066	.	C	A	1	15	16	0	9	25	0	0
11	3899117	.	G	A	5	8	13	0	0	13	0	0
11	3901733	.	C	G	0	15	15	0	16	31	0	0
11	3904469	.	A	G	15	10	25	0	3	28	0	0
11	3904517	.	C	G	1	13	14	0	17	31	0	0
11	3904564	.	C	T	19	14	33	1	1	35	0	0
11	3904666	.	A	G	2	6	8	0	2	10	0	0
11	3904674	.	T	G	3	3	6	0	1	7	0	0
11	3921491	.	A	G	3	4	7	0	0	7	0	0
11	3921563	.	T	A	20	16	36	0	0	36	0	0
11	3922983	.	G	A	5	2	7	0	0	7	0	0
11	3925822	.	T	C	5	0	5	0	4	9	0	0
11	3925906	.	A	G	6	9	15	0	1	16	0	0
11	3925939	.	T	C	2	5	7	0	0	7	0	0
11	3928044	.	A	T	3	2	5	0	1	6	0	0
11	3931773	.	C	T	11	11	22	0	1	23	0	0
11	3933807	.	G	A	4	6	10	0	0	10	0	0
11	3933956	.	A	G	9	4	13	0	0	13	0	0
11	3934190	.	A	G	7	8	15	0	0	15	0	0
11	3934319	.	T	G	1	1	2	0	0	2	0	0
11	3939291	.	C	G	0	2	2	0	2	4	0	0
11	3941180	.	C	T	4	2	6	0	1	7	0	0
11	3941641	.	T	C	2	0	2	0	0	2	0	0
11	3952936	.	T	C	0	0	0	0	1	1	0	0
11	3963388	.	C	T	1	2	3	0	0	3	0	0
11	3963581	.	C	T	2	6	8	0	0	8	0	0
11	3963608	.	G	T	4	7	11	0	0	11	0	0
11	3963639	.	T	A	4	3	7	0	0	7	0	0
11	3964193	.	T	A	2	2	4	0	0	4	0	0
11	3965837	.	G	A	3	2	5	0	1	6	0	0
11	3965867	.	C	T	1	0	1	0	0	1	0	0
11	3965984	.	T	A	1	2	3	0	0	3	0	0
11	3966031	.	T	C	0	1	1	0	0	1	0	0
11	3966360	.	G	C	0	2	2	0	4	6	0	0
11	3967408	.	A	G	3	1	4	0	8	12	0	0
11	3967445	.	A	G	0	3	3	0	1	4	0	0
11	3968915	.	T	G	0	6	6	0	0	6	0	0
11	3968930	.	A	G	0	0	0	0	2	2	0	0
11	3970703	.	T	A	2	3	5	0	0	5	0	0
11	3970713	.	T	A	1	3	4	0	0	4	0	0
11	3977783	.	T	A	1	1	2	0	0	2	0	0
11	3993452	.	G	A	1	5	6	0	5	11	0	0
11	3994901	.	C	A	1	2	3	0	0	3	0	0
11	3995459	.	G	A	0	4	4	0	0	4	0	0
11	3995479	.	G	T	2	4	6	0	1	7	0	0
11	3997023	.	T	C	5	0	5	0	4	9	0	0
11	3997029	.	C	A	0	4	4	0	6	10	0	0
11	4006956	.	C	T	3	1	4	0	0	4	0	0
11	4010601	.	G	T	0	3	3	0	0	3	0	0
11	4010696	.	G	T	2	2	4	0	1	5	0	0
11	4011001	.	T	C	5	0	5	0	3	8	0	0
11	4014428	.	A	T	2	0	2	0	0	2	0	0
11	4014458	.	A	G	0	3	3	0	0	3	0	0
11	4014634	.	A	G	0	1	1	0	0	1	0	0
11	4014737	.	C	T	0	3	3	0	1	4	0	0
11	4113825	.	G	A	0	2	2	0	2	4	0	0
11	4128836	.	A	T	15	9	24	0	3	27	0	0
11	4131300	.	A	T	12	7	19	0	1	20	0	0
11	4131423	.	T	A	11	11	22	0	2	24	0	0
11	4132110	.	G	T	13	5	18	0	1	19	0	0
11	4132296	.	A	C	23	23	46	0	2	48	0	0
11	4132378	.	G	C	18	12	30	0	1	31	0	0
11	4132440	.	A	G	12	15	27	0	0	27	0	0
11	4132599	.	T	C	5	4	9	0	0	9	0	0
11	4205612	.	T	A	1	3	4	0	0	4	0	0
11	4209004	.	T	C	0	1	1	0	0	1	0	0
11	6942436	.	A	G	6	7	13	0	2	15	0	0
11	6942441	.	A	G	5	4	9	0	2	11	0	0
11	7041058	.	T	C	4	4	8	0	0	8	0	0
11	7042376	.	T	C	5	3	8	0	0	8	0	0
11	7103408	.	A	G	1	3	4	0	0	4	0	0
11	7103409	.	A	G	2	2	4	0	0	4	0	0
11	10468756	.	T	C	0	3	3	1	1	5	0	0
11	10468772	.	T	A	0	3	3	1	0	4	0	0
11	10670435	.	T	C	38	5	43	0	10	53	0	0
11	10670439	.	T	C	28	17	45	0	6	52	1	0
11	10671836	.	T	C	16	13	29	0	2	31	0	0
11	10672024	.	T	C	25	7	32	0	2	34	0	0
11	10672025	.	T	C	25	0	25	0	9	34	0	0
11	10672087	.	T	C	24	10	34	0	2	36	0	0
11	11126751	.	C	T	2	4	6	0	0	6	0	0
11	11126781	.	G	A	0	4	4	0	2	6	0	0
11	11141647	.	A	G	0	0	0	0	1	1	0	0
11	11141779	.	G	A	0	1	1	0	0	1	0	0
11	11148954	.	T	A	1	2	3	0	0	3	0	0
11	11148961	.	A	T	1	1	2	0	0	2	0	0
11	11154884	.	A	T	0	1	1	0	0	1	0	0
11	11157255	.	C	A	2	2	4	0	0	4	0	0
11	11161603	.	T	A	1	1	2	0	0	2	0	0
11	11171320	.	T	G	0	1	1	0	0	1	0	0
11	11171351	.	A	G	2	3	5	0	0	5	0	0
11	11171613	.	C	T	0	1	1	0	0	1	0	0
11	11177387	.	T	C	2	5	7	0	0	7	0	0
11	11177406	.	C	T	5	10	15	0	0	15	0	0
11	11177436	.	T	C	9	13	22	0	1	23	0	0
11	11177481	.	A	G	5	6	11	0	1	12	0	0
11	11181955	.	G	A	0	7	7	0	7	14	0	0
11	11181978	.	C	T	8	9	17	0	1	18	0	0
11	11184707	.	C	T	6	5	11	0	0	11	0	0
11	11184743	.	A	C	9	7	16	0	2	18	0	0
11	11184818	.	T	C	6	11	17	0	0	17	0	0
11	11185053	.	G	A	11	10	21	0	0	21	0	0
11	11185074	.	G	C	12	12	24	0	1	25	0	0
11	11186248	.	G	C	5	9	14	0	0	14	0	0
11	11191840	.	C	T	6	4	10	0	1	11	0	0
11	11191845	.	C	T	7	6	13	0	1	14	0	0
11	11191995	.	T	C	21	20	41	0	0	41	0	0
11	11192053	.	C	T	9	19	28	0	1	29	0	0
11	11192170	.	T	A	8	5	13	0	1	14	0	0
11	11192276	.	G	A	11	13	24	0	2	26	0	0
11	11192342	.	T	G	10	11	21	0	0	21	0	0
11	11192724	.	T	C	11	14	25	0	3	28	0	0
11	11193030	.	C	T	2	2	4	0	0	4	0	0
11	11260297	.	C	A	2	2	4	0	0	4	0	0
11	11272175	.	C	T	2	1	3	0	0	3	0	0
11	11274615	.	A	T	20	13	33	0	3	36	0	0
11	11275675	.	T	A	0	2	2	0	0	2	0	0
11	11319180	.	A	G	1	5	6	0	1	7	0	0
11	11324286	.	T	G	1	0	1	0	0	1	0	0
11	11324295	.	T	G	1	0	1	0	0	1	0	0
11	11325486	.	G	A	2	2	4	0	0	4	0	0
11	11326502	.	A	G	2	8	10	0	0	10	0	0
11	11326968	.	C	A	0	3	3	0	2	5	0	0
11	11332986	.	A	G	6	4	10	0	0	10	0	0
11	11332990	.	T	A	5	4	9	0	0	9	0	0
11	11333135	.	C	T	0	3	3	0	0	3	0	0
11	11333661	.	T	G	7	3	10	0	1	11	0	0
11	11333670	.	T	G	6	3	9	0	1	10	0	0
11	11468756	.	T	G	12	10	22	0	2	24	0	0
11	11469128	.	C	T	16	5	21	0	2	23	0	0
11	11469143	.	C	T	14	6	20	0	1	21	0	0
11	11469203	.	G	A	6	4	10	0	0	10	0	0
11	11469215	.	C	T	3	2	5	0	0	5	0	0
11	11469968	.	C	T	2	2	4	0	1	5	0	0
11	11470678	.	A	C	1	1	2	0	0	2	0	0
11	11471147	.	C	A	3	5	8	0	1	9	0	0
11	11471372	.	A	C	5	0	5	0	4	9	0	0
11	11471434	.	T	A	6	5	11	0	0	11	0	0
11	11516245	.	T	G	5	3	8	0	1	9	0	0
11	11516279	.	T	C	2	0	2	0	3	5	0	0
11	11597120	.	A	T	1	6	7	0	0	7	0	0
11	11597374	.	A	G	6	14	20	0	1	21	0	0
11	11597679	.	G	C	12	10	22	0	0	22	0	0
11	11597985	.	A	T	13	7	20	0	0	20	0	0
11	11598692	.	C	A	9	3	12	0	0	12	0	0
11	11607492	.	G	A	1	5	6	0	3	9	0	0
11	11607498	.	C	G	5	5	10	0	0	10	0	0
11	11607705	.	C	T	6	12	18	0	0	18	0	0
11	11612715	.	G	A	4	8	12	0	1	13	0	0
11	11612758	.	A	G	2	6	8	0	1	9	0	0
11	11612773	.	C	T	2	4	6	0	0	6	0	0
11	11614914	.	A	T	2	0	2	0	0	2	0	0
11	11616542	.	G	A	0	1	1	0	0	1	0	0
11	11619931	.	A	G	5	4	9	0	0	9	0	0
11	11624909	.	C	T	1	2	3	0	0	3	0	0
11	11624939	.	T	C	8	2	10	0	1	11	0	0
11	11625066	.	C	G	5	6	11	0	0	11	0	0
11	11780816	.	A	T	1	2	3	0	0	3	0	0
11	11781172	.	C	T	0	3	3	0	1	4	0	0
11	11871049	.	C	T	0	2	2	0	3	5	0	0
11	11875643	.	C	T	0	2	2	0	3	5	0	0
11	11891768	.	T	A	0	1	1	0	1	2	0	0
11	11901740	.	G	A	1	2	3	0	0	3	0	0
11	11928205	.	C	T	2	3	5	0	0	5	0	0
11	11932967	.	C	T	0	0	0	0	1	1	0	0
11	11983710	.	T	C	10	0	10	0	8	18	0	0
11	11983713	.	A	C	10	8	18	0	0	18	0	0
11	11983748	.	A	C	6	1	7	0	10	17	0	0
11	11983789	.	G	T	6	12	18	0	0	18	0	0
11	11983827	.	C	T	5	6	11	0	1	12	0	0
11	11983868	.	C	T	0	3	3	0	6	9	0	0
11	11983937	.	T	C	2	7	9	0	1	10	0	0
11	11984120	.	A	G	3	7	10	0	0	10	0	0
11	11984501	.	A	T	1	5	6	0	0	6	0	0
11	11984522	.	A	G	5	2	7	0	0	7	0	0
11	11984666	.	A	G	5	3	8	0	0	8	0	0
11	12004040	.	T	C	5	5	10	0	1	11	0	0
11	12004277	.	A	G	4	4	8	0	0	8	0	0
11	12004304	.	G	T	4	4	8	0	0	8	0	0
11	12016650	.	G	A	7	4	11	0	0	11	0	0
11	12050039	.	T	C	6	4	10	0	0	10	0	0
11	12050265	.	A	G	5	2	7	0	1	8	0	0
11	12050291	.	G	A	3	4	7	0	0	7	0	0
11	12051505	.	G	T	7	9	16	0	1	17	0	0
11	12096578	.	C	T	8	4	12	0	2	14	0	0
11	12096593	.	G	A	7	5	12	0	0	12	0	0
11	12108486	.	T	C	7	9	16	0	0	16	0	0
11	12108725	.	G	A	13	13	26	0	0	26	0	0
11	12108822	.	C	A	7	6	13	0	0	13	0	0
11	12131044	.	T	G	3	1	4	0	0	4	0	0
11	12136025	.	A	C	3	0	3	0	6	9	0	0
11	12141467	.	T	C	5	5	10	0	0	10	0	0
11	12141482	.	A	G	4	4	8	0	0	8	0	0
11	12146303	.	G	A	1	3	4	0	0	4	0	0
11	12152056	.	G	T	2	0	2	0	0	2	0	0
11	12720049	.	T	A	2	2	4	0	0	4	0	0
11	12727504	.	A	G	17	28	45	0	2	47	0	0
11	12727685	.	T	C	18	20	38	0	0	38	0	0
11	12727879	.	A	C	10	6	16	0	0	16	0	0
11	12728195	.	T	G	9	11	20	0	1	21	0	0
11	12728249	.	C	T	6	9	15	0	1	16	0	0
11	12732334	.	T	A	0	2	2	0	1	3	0	0
11	12732505	.	A	T	7	10	17	0	0	17	0	0
11	12732696	.	T	A	3	2	5	0	0	5	0	0
11	12733235	.	T	C	1	0	1	0	4	5	0	0
11	12733277	.	C	T	5	3	8	0	0	8	0	0
11	12733278	.	G	C	3	5	8	0	0	8	0	0
11	12733741	.	C	T	5	2	7	0	0	7	0	0
11	12733743	.	G	A	5	2	7	0	0	7	0	0
11	12733892	.	T	G	2	4	6	0	0	6	0	0
11	12733965	.	C	T	3	5	8	0	0	8	0	0
11	12734072	.	G	A	2	3	5	0	0	5	0	0
11	12752161	.	A	T	1	5	6	0	0	6	0	0
11	12759728	.	G	T	3	2	5	0	0	5	0	0
11	12759737	.	C	T	3	2	5	0	1	6	0	0
11	12767964	.	A	G	1	0	1	0	3	4	0	0
11	12768221	.	C	T	10	17	27	0	1	28	0	0
11	12768299	.	C	T	6	12	18	0	1	19	0	0
11	12768351	.	A	G	12	8	20	0	1	21	0	0
11	12768394	.	A	C	7	3	10	0	0	10	0	0
11	12782503	.	G	A	4	5	9	0	0	9	0	0
11	12782524	.	A	C	2	8	10	0	2	12	0	0
11	12782593	.	T	C	4	0	4	0	4	8	0	0
11	12784355	.	T	A	1	2	3	0	0	3	0	0
11	12784430	.	A	T	1	3	4	0	0	4	0	0
11	12795711	.	T	C	4	6	10	0	0	10	0	0
11	12796790	.	G	T	0	1	1	0	0	1	0	0
11	12829985	.	C	T	0	1	1	0	0	1	0	0
11	12829994	.	G	T	0	1	1	0	0	1	0	0
11	12845101	.	T	A	1	2	3	0	0	3	0	0
11	12845150	.	T	C	2	3	5	0	0	5	0	0
11	12845160	.	G	A	0	3	3	0	2	5	0	0
11	12858798	.	G	A	0	0	0	0	1	1	0	0
11	12861196	.	A	G	5	7	12	0	0	12	0	0
11	12869192	.	G	T	0	12	12	0	10	22	0	0
11	12869309	.	T	C	6	14	20	0	0	20	0	0
11	12869409	.	C	A	6	9	15	0	0	15	0	0
11	12869414	.	C	T	3	9	12	0	3	15	0	0
11	12872549	.	A	T	3	2	5	0	0	5	0	0
11	12874407	.	T	C	1	3	4	0	0	4	0	0
11	12987870	.	G	T	2	4	6	0	0	6	0	0
11	12987981	.	G	T	1	3	4	0	1	5	0	0
11	12988038	.	G	A	5	4	9	0	0	9	0	0
11	13055470	.	G	A	9	12	21	0	0	21	0	0
11	13055694	.	C	A	7	11	18	0	1	19	0	0
11	13055748	.	T	C	1	2	3	0	1	4	0	0
11	13067750	.	A	T	5	4	9	0	1	10	0	0
11	13071855	.	C	T	6	9	15	0	0	15	0	0
11	13071920	.	A	G	3	2	5	0	0	5	0	0
11	13074127	.	T	C	0	2	2	0	0	2	0	0
11	13082107	.	C	T	1	1	2	0	0	2	0	0
11	13085294	.	G	A	4	0	4	0	0	4	0	0
11	13094199	.	C	T	17	10	27	0	0	27	0	0
11	13094247	.	A	G	13	6	19	0	2	21	0	0
11	13094368	.	T	A	9	5	14	0	1	15	0	0
11	13094473	.	A	T	20	12	32	0	0	32	0	0
11	13094668	.	C	A	16	29	45	0	0	45	0	0
11	13094678	.	T	C	10	27	37	0	3	40	0	0
11	13094778	.	T	C	14	18	32	0	2	34	0	0
11	13094938	.	G	T	23	24	47	0	1	48	0	0
11	13095049	.	G	A	17	14	31	0	0	31	0	0
11	13101378	.	A	G	2	4	6	0	0	6	0	0
11	13104057	.	C	A	0	0	0	0	1	1	0	0
11	13181747	.	G	A	0	1	1	0	2	3	0	0
11	13182847	.	C	T	2	1	3	0	0	3	0	0
11	13182850	.	C	T	1	2	3	0	0	3	0	0
11	13185862	.	A	G	1	2	3	0	0	3	0	0
11	13185970	.	C	T	2	2	4	0	0	4	0	0
11	13188753	.	G	A	0	3	3	0	3	6	0	0
11	13188768	.	C	A	1	3	4	0	0	4	0	0
11	13189062	.	A	G	2	0	2	0	0	2	0	0
11	13189079	.	T	A	0	2	2	0	0	2	0	0
11	13189116	.	G	A	0	2	2	0	0	2	0	0
11	13189339	.	G	T	4	4	8	0	0	8	0	0
11	13189461	.	A	G	2	4	6	0	0	6	0	0
11	13189469	.	A	G	2	4	6	0	0	6	0	0
11	13189592	.	G	A	4	5	9	0	2	11	0	0
11	13189623	.	T	A	2	4	6	0	0	6	0	0
11	13189627	.	T	G	2	2	4	0	0	4	0	0
11	13208755	.	T	A	17	12	29	0	2	31	0	0
11	13208839	.	C	G	18	39	57	0	1	58	0	0
11	13209085	.	G	C	33	32	65	0	3	68	0	0
11	13209391	.	C	T	11	8	19	0	0	19	0	0
11	13210650	.	A	C	25	37	62	0	0	62	0	0
11	13210667	.	C	T	29	25	54	0	1	55	0	0
11	13210897	.	A	T	23	34	57	0	4	61	0	0
11	13210906	.	C	T	36	26	62	0	6	68	0	0
11	13212186	.	A	T	17	25	42	0	1	43	0	0
11	13212306	.	C	T	24	29	53	0	3	56	0	0
11	13280580	.	A	G	4	15	19	0	1	20	0	0
11	13280752	.	T	C	2	1	3	1	2	6	0	0
11	13281122	.	T	C	15	14	29	0	0	29	0	0
11	13281158	.	A	T	9	12	21	0	0	21	0	0
11	13281243	.	C	A	2	1	3	0	0	3	0	0
11	13281331	.	A	T	14	6	20	0	2	22	0	0
11	13281398	.	G	C	5	5	10	0	0	10	0	0
11	13281594	.	T	C	12	11	23	0	2	25	0	0
11	13281653	.	C	T	16	11	27	0	0	27	0	0
11	13282016	.	T	C	10	11	21	0	1	22	0	0
11	13282099	.	T	C	3	8	11	1	0	12	0	0
11	13282130	.	T	C	14	3	17	0	1	18	0	0
11	13282201	.	G	T	6	7	13	0	2	15	0	0
11	13282439	.	C	A	3	7	10	0	0	10	0	0
11	13282443	.	G	A	2	7	9	0	1	10	0	0
11	13282660	.	C	T	5	16	21	0	0	21	0	0
11	13282881	.	T	C	5	3	8	0	0	8	0	0
11	13282883	.	A	G	4	3	7	0	1	8	0	0
11	13283156	.	T	A	10	10	20	0	0	20	0	0
11	13283181	.	C	T	7	9	16	0	1	17	0	0
11	13283220	.	C	G	0	11	11	0	8	19	0	0
11	13283243	.	T	C	6	0	6	0	10	16	0	0
11	13283368	.	C	A	8	13	21	0	1	22	0	0
11	13283403	.	T	G	8	13	21	0	1	22	0	0
11	13283447	.	G	A	7	9	16	0	0	16	0	0
11	13283476	.	C	T	7	9	16	0	0	16	0	0
11	13283634	.	C	T	8	5	13	0	0	13	0	0
11	13283713	.	G	A	12	6	18	0	0	18	0	0
11	13292012	.	C	T	4	4	8	0	0	8	0	0
11	13292027	.	A	T	4	5	9	0	0	9	0	0
11	13292084	.	A	G	5	10	15	0	0	15	0	0
11	13292105	.	C	T	0	10	10	0	7	17	0	0
11	13292462	.	C	T	3	4	7	0	0	7	0	0
11	13292576	.	C	T	1	8	9	0	8	17	0	0
11	13297711	.	T	C	0	3	3	0	0	3	0	0
11	13304426	.	G	A	0	2	2	0	0	2	0	0
11	13305949	.	G	A	2	3	5	0	0	5	0	0
11	13306186	.	C	T	0	5	5	0	0	5	0	0
11	13313208	.	C	T	1	1	2	0	0	2	0	0
11	13313524	.	G	A	3	2	5	0	0	5	0	0
11	13446023	.	C	T	1	3	4	0	0	4	0	0
11	13485112	.	C	T	1	0	1	0	0	1	0	0
11	13485140	.	A	G	1	0	1	0	3	4	0	0
11	13505575	.	G	C	2	3	5	0	0	5	0	0
11	13528735	.	G	A	0	2	2	0	4	6	0	0
11	13529975	.	G	T	1	0	1	0	0	1	0	0
11	13530399	.	A	C	1	1	2	0	0	2	0	0
11	13530498	.	G	A	2	4	6	0	0	6	0	0
11	13531730	.	C	T	5	8	13	0	1	14	0	0
11	13531954	.	C	T	1	1	2	0	0	2	0	0
11	13532763	.	C	T	10	3	13	0	0	13	0	0
11	13533072	.	A	G	9	5	14	0	0	14	0	0
11	13533094	.	T	G	4	9	13	0	0	13	0	0
11	13533124	.	G	A	4	13	17	0	1	18	0	0
11	13533429	.	G	T	6	8	14	0	0	14	0	0
11	13636198	.	C	T	2	3	5	0	0	5	0	0
11	13639185	.	C	G	2	2	4	0	0	4	0	0
11	13697910	.	T	C	1	1	2	0	0	2	0	0
11	14062157	.	T	G	2	3	5	0	0	5	0	0
11	14062474	.	A	C	2	3	5	0	0	5	0	0
11	14062972	.	G	A	0	3	3	0	0	3	0	0
11	14063185	.	C	T	2	2	4	0	0	4	0	0
11	14063191	.	G	C	1	1	2	0	0	2	0	0
11	14064419	.	A	G	4	2	6	0	0	6	0	0
11	14064454	.	A	G	3	3	6	0	0	6	0	0
11	14073005	.	A	T	6	3	9	0	0	9	0	0
11	14073241	.	T	C	4	4	8	0	0	8	0	0
11	14073503	.	G	A	9	13	22	0	0	22	0	0
11	14073560	.	T	A	8	11	19	0	0	19	0	0
11	14073730	.	G	T	4	7	11	0	3	14	0	0
11	14074125	.	T	C	4	8	12	0	0	12	0	0
11	14074174	.	T	C	4	10	14	0	0	14	0	0
11	14074245	.	T	C	5	4	9	0	1	10	0	0
11	14074397	.	A	G	4	10	14	0	1	15	0	0
11	14074584	.	T	G	4	3	7	0	0	7	0	0
11	14074628	.	T	A	3	2	5	0	0	5	0	0
11	14074649	.	A	G	3	2	5	0	0	5	0	0
11	14074738	.	G	A	2	5	7	0	0	7	0	0
11	14074843	.	A	C	5	7	12	0	1	13	0	0
11	14074951	.	C	T	3	4	7	0	0	7	0	0
11	14074952	.	A	T	3	4	7	0	0	7	0	0
11	14075147	.	G	A	14	7	21	0	1	22	0	0
11	14075302	.	A	G	9	9	18	0	0	18	0	0
11	14092579	.	T	G	2	3	5	0	0	5	0	0
11	14101295	.	C	A	0	3	3	0	2	5	0	0
11	14101497	.	A	T	4	6	10	0	0	10	0	0
11	14101521	.	A	T	5	5	10	0	0	10	0	0
11	14101597	.	G	A	3	6	9	0	0	9	0	0
11	14102018	.	C	T	1	4	5	0	0	5	0	0
11	14104721	.	T	C	3	2	5	0	0	5	0	0
11	14143452	.	C	A	7	6	13	0	0	13	0	0
11	14143498	.	T	C	2	2	4	0	0	4	0	0
11	14143499	.	G	A	2	2	4	0	0	4	0	0
11	14148179	.	A	G	11	4	15	0	0	15	0	0
11	14148341	.	T	A	9	12	21	0	1	22	0	0
11	14149964	.	T	C	2	5	7	0	0	7	0	0
11	14159425	.	C	T	10	11	21	0	0	21	0	0
11	14159513	.	A	G	15	17	32	0	1	33	0	0
11	14159555	.	A	G	16	13	29	0	1	30	0	0
11	14159622	.	T	C	15	17	32	0	1	33	0	0
11	14159979	.	T	C	23	15	38	0	3	41	0	0
11	14160131	.	A	G	18	16	34	0	2	36	0	0
11	14160941	.	C	A	10	5	15	0	3	18	0	0
11	14161073	.	A	G	14	16	30	0	1	31	0	0
11	14161077	.	C	A	14	13	27	0	3	30	0	0
11	14161291	.	A	T	17	11	28	0	1	29	0	0
11	14161304	.	A	G	19	13	32	0	0	32	0	0
11	14249012	.	A	G	1	1	2	0	1	3	0	0
11	14266826	.	G	T	1	6	7	0	19	26	0	0
11	14267075	.	T	C	10	7	17	0	1	18	0	0
11	14267076	.	G	A	11	6	17	0	1	18	0	0
11	14267236	.	A	G	14	0	14	0	5	19	0	0
11	14267239	.	C	G	14	5	19	0	0	19	0	0
11	14318207	.	T	A	1	2	3	0	0	3	0	0
11	14338454	.	C	G	4	3	7	0	0	7	0	0
11	14431661	.	G	A	1	2	3	0	0	3	0	0
11	14431750	.	A	G	1	0	1	0	3	4	0	0
11	14432169	.	C	A	2	4	6	0	0	6	0	0
11	14640155	.	A	G	2	2	4	0	0	4	0	0
11	14676604	.	A	T	5	3	8	0	1	9	0	0
11	14955592	.	A	G	4	13	17	0	0	17	0	0
11	14955897	.	A	G	4	5	9	0	0	9	0	0
11	14956525	.	A	G	4	4	8	0	3	11	0	0
11	14957155	.	A	T	10	13	23	0	2	25	0	0
11	15834311	.	C	T	8	7	15	0	1	16	0	0
11	15834318	.	T	G	7	7	14	0	0	14	0	0
11	15834436	.	T	A	1	6	7	0	0	7	0	0
11	15850735	.	C	T	2	1	3	0	0	3	0	0
11	15874809	.	C	A	0	2	2	0	1	3	0	0
11	15874820	.	A	G	2	4	6	0	0	6	0	0
11	15894885	.	G	A	0	3	3	0	5	8	0	0
11	15915274	.	G	T	3	1	4	0	1	5	0	0
11	16006016	.	C	T	0	7	7	0	1	8	0	0
11	16006030	.	C	T	4	6	10	0	0	10	0	0
11	16011177	.	T	C	5	2	7	0	0	7	0	0
11	16012829	.	G	T	14	9	23	0	0	23	0	0
11	16095020	.	T	C	5	10	15	0	2	17	0	0
11	16095042	.	C	G	6	11	17	0	1	18	0	0
11	16099700	.	G	A	1	0	1	0	0	1	0	0
11	16104175	.	T	C	4	8	12	0	0	12	0	0
11	16115692	.	C	T	6	6	12	0	1	13	0	0
11	16143740	.	G	A	22	28	50	0	0	50	0	0
11	16143781	.	T	C	14	19	33	0	2	35	0	0
11	16153368	.	G	A	2	11	13	0	14	27	0	0
11	16158555	.	G	A	12	14	26	0	1	27	0	0
11	16159101	.	C	T	0	2	2	0	0	2	0	0
11	16159316	.	C	T	6	4	10	0	1	11	0	0
11	16159875	.	T	C	2	3	5	0	0	5	0	0
11	16159903	.	C	T	2	5	7	0	0	7	0	0
11	16159926	.	C	T	5	2	7	0	0	7	0	0
11	16160074	.	C	T	2	1	3	0	0	3	0	0
11	16165233	.	A	G	7	13	20	0	1	21	0	0
11	16165395	.	G	A	11	9	20	0	0	20	0	0
11	16177158	.	G	A	0	5	5	0	1	6	0	0
11	16179830	.	T	A	17	23	40	0	1	41	0	0
11	16179882	.	T	A	16	22	38	0	6	44	0	0
11	16184865	.	A	T	15	14	29	0	0	29	0	0
11	16192224	.	G	A	17	15	32	0	0	32	0	0
11	16214941	.	G	A	9	13	22	0	0	22	0	0
11	16329862	.	G	T	2	3	5	0	0	5	0	0
11	16329929	.	T	C	3	3	6	0	0	6	0	0
11	16330072	.	A	C	0	3	3	0	0	3	0	0
11	16330300	.	C	A	4	3	7	0	0	7	0	0
11	16330585	.	A	G	6	6	12	0	0	12	0	0
11	16330686	.	T	G	2	10	12	0	0	12	0	0
11	16330720	.	G	A	5	5	10	0	1	11	0	0
11	16331143	.	T	A	4	4	8	0	0	8	0	0
11	16331363	.	A	G	2	4	6	0	1	7	0	0
11	16331375	.	G	T	4	3	7	0	0	7	0	0
11	16331531	.	T	G	5	4	9	0	0	9	0	0
11	16331762	.	T	C	1	4	5	0	0	5	0	0
11	16332040	.	G	T	2	2	4	0	0	4	0	0
11	16583904	.	C	T	2	3	5	0	0	5	0	0
11	16583916	.	A	G	2	0	2	0	4	6	0	0
11	16584470	.	A	T	6	3	9	0	2	11	0	0
11	16584603	.	G	T	1	2	3	0	0	3	0	0
11	16584623	.	C	T	0	3	3	0	0	3	0	0
11	16585598	.	G	T	3	2	5	0	0	5	0	0
11	16585652	.	A	C	3	2	5	0	0	5	0	0
11	16585775	.	C	G	1	2	3	0	0	3	0	0
11	16585807	.	C	A	1	3	4	0	0	4	0	0
11	16586082	.	A	G	2	0	2	0	3	5	0	0
11	16586083	.	A	G	2	3	5	0	0	5	0	0
11	16586272	.	A	T	3	3	6	0	0	6	0	0
11	16586711	.	G	T	2	2	4	0	0	4	0	0
11	16586722	.	A	G	1	2	3	0	1	4	0	0
11	16586747	.	A	G	0	4	4	0	0	4	0	0
11	16586925	.	T	C	2	3	5	0	0	5	0	0
11	16587446	.	T	G	0	2	2	0	0	2	0	0
11	16587457	.	C	T	3	2	5	0	0	5	0	0
11	16587682	.	A	C	3	2	5	0	0	5	0	0
11	16587782	.	C	T	2	3	5	0	0	5	0	0
11	16587873	.	A	T	2	2	4	0	0	4	0	0
11	16587884	.	T	A	2	2	4	0	0	4	0	0
11	16849887	.	T	G	3	5	8	0	0	8	0	0
11	16849896	.	G	A	3	4	7	0	1	8	0	0
11	17512289	.	T	C	7	9	16	0	2	18	0	0
11	17512522	.	C	A	3	3	6	0	0	6	0	0
11	17512727	.	C	G	1	3	4	0	0	4	0	0
11	17513083	.	C	G	4	6	10	0	0	10	0	0
11	17513159	.	G	T	2	2	4	0	1	5	0	0
11	17513174	.	A	G	2	2	4	0	0	4	0	0
11	17513424	.	T	A	4	6	10	0	0	10	0	0
11	17597188	.	C	T	0	2	2	0	4	6	0	0
11	17597224	.	G	A	7	4	11	0	0	11	0	0
11	17597225	.	T	G	7	3	10	0	0	11	1	0
11	17597424	.	G	A	3	3	6	0	1	7	0	0
11	17608441	.	G	A	1	2	3	0	0	3	0	0
11	17713785	.	A	G	3	3	6	0	0	6	0	0
11	17713928	.	G	T	1	2	3	0	0	3	0	0
11	17741399	.	C	G	0	1	1	0	0	1	0	0
11	17757623	.	G	T	14	8	22	0	0	22	0	0
11	17757624	.	A	G	15	7	22	0	0	22	0	0
11	17757772	.	G	A	10	9	19	0	1	20	0	0
11	17763904	.	C	T	2	1	3	0	0	3	0	0
11	17763928	.	C	T	0	1	1	0	0	1	0	0
11	17765182	.	C	A	5	6	11	0	0	11	0	0
11	17765281	.	T	C	7	0	7	0	7	14	0	0
11	17765293	.	C	T	5	6	11	0	0	11	0	0
11	17765489	.	G	A	0	2	2	0	1	3	0	0
11	17765585	.	T	C	7	0	7	0	3	10	0	0
11	17765618	.	T	C	3	0	3	0	0	3	0	0
11	17769236	.	T	C	1	0	1	0	2	3	0	0
11	17769238	.	C	T	1	2	3	0	0	3	0	0
11	17769711	.	C	T	1	2	3	0	0	3	0	0
11	17770627	.	T	C	8	7	15	0	0	15	0	0
11	17771185	.	T	C	5	1	6	0	0	6	0	0
11	17778528	.	T	C	5	1	6	0	9	15	0	0
11	17778618	.	T	G	6	3	9	0	0	9	0	0
11	17778639	.	C	T	0	2	2	0	8	10	0	0
11	17778819	.	G	A	5	5	10	0	0	10	0	0
11	17779028	.	T	G	5	2	7	0	1	8	0	0
11	17779159	.	A	G	7	5	12	0	0	12	0	0
11	17779231	.	G	A	4	4	8	0	0	8	0	0
11	17779402	.	A	G	13	3	16	0	0	16	0	0
11	17782529	.	A	C	9	0	9	0	6	15	0	0
11	17782669	.	G	C	5	7	12	0	0	12	0	0
11	17782730	.	G	C	4	3	7	0	0	7	0	0
11	17782817	.	G	A	8	6	14	0	0	14	0	0
11	17782832	.	C	T	7	6	13	0	0	13	0	0
11	17785428	.	T	C	17	12	29	0	0	29	0	0
11	17789104	.	C	T	0	3	3	0	3	6	0	0
11	17789243	.	G	A	2	2	4	0	0	4	0	0
11	17797072	.	T	C	0	0	0	0	1	1	0	0
11	17984405	.	G	A	0	5	5	0	6	11	0	0
11	17984503	.	A	G	1	0	1	0	0	1	0	0
11	17994323	.	G	A	0	8	8	0	2	10	0	0
11	18010235	.	G	A	6	6	12	0	0	12	0	0
11	18216527	.	G	T	3	2	5	0	1	6	0	0
11	18216643	.	G	A	7	3	10	0	1	11	0	0
11	18216767	.	C	T	2	9	11	0	0	11	0	0
11	18223337	.	C	T	7	7	14	0	0	14	0	0
11	18223365	.	T	C	9	6	15	0	0	15	0	0
11	18223383	.	C	T	8	9	17	0	0	17	0	0
11	18223485	.	G	A	6	9	15	0	0	15	0	0
11	18237862	.	G	A	8	8	16	0	1	17	0	0
11	18238076	.	C	T	10	10	20	0	2	22	0	0
11	18238171	.	T	C	7	6	13	0	1	14	0	0
11	18243966	.	A	G	11	3	14	0	1	15	0	0
11	18244388	.	T	C	12	3	15	0	4	19	0	0
11	18252912	.	C	T	1	3	4	0	1	5	0	0
11	18253067	.	C	T	2	2	4	0	0	4	0	0
11	18271303	.	G	A	3	2	5	0	1	6	0	0
11	18277370	.	C	T	0	2	2	0	3	5	0	0
11	18282952	.	G	C	6	2	8	0	3	11	0	0
11	18283126	.	C	T	4	4	8	0	1	9	0	0
11	18283268	.	T	C	7	4	11	0	0	11	0	0
11	18287283	.	A	T	8	9	17	0	0	17	0	0
11	18287316	.	G	A	8	8	16	0	1	17	0	0
11	18287378	.	C	T	1	12	13	0	8	21	0	0
11	18287506	.	A	G	7	9	16	0	0	16	0	0
11	18287687	.	T	A	11	7	18	0	0	18	0	0
11	18287779	.	G	A	7	10	17	0	0	17	0	0
11	18287895	.	T	G	7	5	12	0	0	12	0	0
11	18287940	.	A	T	9	7	16	0	0	16	0	0
11	18288212	.	T	C	11	7	18	0	0	18	0	0
11	18288275	.	C	A	0	11	11	0	8	19	0	0
11	18288347	.	G	A	7	9	16	0	2	18	0	0
11	18289356	.	C	T	0	3	3	0	0	3	0	0
11	18290095	.	G	A	4	2	6	0	0	6	0	0
11	18291853	.	T	A	1	5	6	0	0	6	0	0
11	18291943	.	C	T	11	7	18	0	1	19	0	0
11	18292595	.	C	T	0	2	2	0	5	7	0	0
11	18292675	.	C	T	6	9	15	0	0	15	0	0
11	18294857	.	A	G	6	3	9	0	0	9	0	0
11	18294911	.	A	G	3	5	8	0	0	8	0	0
11	18304255	.	T	A	4	0	4	0	0	4	0	0
11	18305804	.	C	G	0	1	1	0	0	1	0	0
11	18309570	.	T	C	3	5	8	0	0	8	0	0
11	18315955	.	C	T	1	1	2	0	0	2	0	0
11	18315988	.	T	A	4	3	7	0	0	7	0	0
11	18345343	.	T	A	3	2	5	0	0	5	0	0
11	18345390	.	C	A	3	3	6	0	0	6	0	0
11	18345719	.	T	G	3	5	8	0	0	8	0	0
11	18345825	.	A	T	1	3	4	0	0	4	0	0
11	18346002	.	T	C	1	4	5	0	0	5	0	0
11	18346827	.	C	T	0	2	2	0	1	3	0	0
11	18346953	.	A	G	0	2	2	0	0	2	0	0
11	18347708	.	T	A	1	2	3	0	0	3	0	0
11	18347854	.	A	T	1	2	3	0	0	3	0	0
11	18347895	.	T	A	1	3	4	0	0	4	0	0
11	18396403	.	A	G	1	2	3	0	0	3	0	0
11	18396404	.	C	A	1	2	3	0	0	3	0	0
11	18397744	.	T	C	3	2	5	0	0	5	0	0
11	18398555	.	T	G	4	4	8	0	0	8	0	0
11	18398578	.	T	G	3	4	7	0	0	7	0	0
11	18399125	.	C	T	0	2	2	0	1	3	0	0
11	18402036	.	A	C	0	2	2	0	0	2	0	0
11	18402045	.	T	C	0	0	0	0	3	3	0	0
11	18433365	.	A	G	1	0	1	0	0	1	0	0
11	18535112	.	T	C	2	2	4	0	0	4	0	0
11	18536769	.	G	A	15	8	23	0	4	27	0	0
11	18536800	.	C	T	0	14	14	0	13	27	0	0
11	18536864	.	G	T	14	10	24	0	0	24	0	0
11	18536866	.	G	A	13	11	24	0	0	24	0	0
11	18537180	.	A	G	9	8	17	0	0	17	0	0
11	18537244	.	G	A	10	8	18	0	1	19	0	0
11	18537447	.	T	C	5	6	11	0	1	12	0	0
11	18537636	.	T	A	16	6	22	0	0	22	0	0
11	18537649	.	G	A	17	6	23	0	2	25	0	0
11	18538122	.	A	T	12	11	23	0	0	23	0	0
11	18538336	.	A	C	10	1	11	0	14	26	1	0
11	18538362	.	T	C	10	0	10	0	12	22	0	0
11	18539155	.	G	C	4	9	13	0	0	13	0	0
11	18539616	.	C	A	5	4	9	0	0	9	0	0
11	18541017	.	T	A	4	1	5	0	0	5	0	0
11	18542168	.	T	C	4	4	8	0	1	9	0	0
11	18542585	.	A	G	1	3	4	0	0	4	0	0
11	18543543	.	T	A	5	2	7	0	0	7	0	0
11	18543870	.	A	G	1	5	6	0	0	6	0	0
11	18546357	.	T	A	1	3	4	0	0	4	0	0
11	18547125	.	A	G	17	9	26	0	0	26	0	0
11	18551089	.	G	A	6	2	8	0	1	9	0	0
11	18551120	.	C	T	0	5	5	0	3	8	0	0
11	18561144	.	T	C	3	7	10	0	0	10	0	0
11	18561477	.	T	G	2	1	3	0	0	3	0	0
11	18561493	.	G	A	1	2	3	0	1	4	0	0
11	18561527	.	C	T	1	3	4	0	0	4	0	0
11	18561538	.	C	T	2	4	6	0	0	6	0	0
11	18561590	.	G	A	11	4	15	0	0	15	0	0
11	18561635	.	T	A	9	8	17	0	0	17	0	0
11	18561674	.	C	T	7	11	18	0	0	18	0	0
11	18561792	.	T	C	15	0	15	0	9	24	0	0
11	18561816	.	A	G	11	5	16	0	1	17	0	0
11	18562059	.	T	G	6	11	17	0	2	19	0	0
11	18562420	.	G	T	5	5	10	0	0	10	0	0
11	18562448	.	T	C	6	0	6	0	8	14	0	0
11	18562655	.	T	C	3	0	3	0	6	9	0	0
11	18562730	.	G	T	5	8	13	0	0	13	0	0
11	18569158	.	A	T	2	0	2	0	0	2	0	0
11	18569298	.	G	A	1	0	1	0	0	1	0	0
11	18569379	.	A	G	12	11	23	0	1	24	0	0
11	18572364	.	T	C	12	1	13	0	11	24	0	0
11	18572586	.	C	T	9	12	21	0	0	21	0	0
11	18572640	.	T	G	9	9	18	0	0	18	0	0
11	18572648	.	G	A	9	11	20	0	1	21	0	0
11	18575031	.	G	C	8	7	15	0	1	16	0	0
11	18575299	.	A	G	4	8	12	0	0	12	0	0
11	18577262	.	T	C	2	1	3	0	0	3	0	0
11	18577787	.	A	G	0	1	1	0	0	1	0	0
11	18579868	.	G	A	3	3	6	0	0	6	0	0
11	18579912	.	A	G	6	4	10	0	0	10	0	0
11	18580170	.	T	C	3	0	3	0	6	9	0	0
11	18586264	.	T	C	1	0	1	0	1	2	0	0
11	18586759	.	A	G	1	0	1	0	0	1	0	0
11	18665791	.	A	T	1	2	3	0	0	3	0	0
11	18678321	.	T	C	3	4	7	0	1	8	0	0
11	18678344	.	T	G	3	3	6	0	0	6	0	0
11	18681086	.	C	G	1	3	4	0	0	4	0	0
11	18681103	.	G	A	0	3	3	0	1	4	0	0
11	18681298	.	C	T	5	3	8	0	0	8	0	0
11	18681382	.	A	G	5	0	5	0	4	9	0	0
11	18681547	.	A	G	2	0	2	0	2	4	0	0
11	18682694	.	A	G	0	1	1	0	0	1	0	0
11	18682826	.	T	C	1	2	3	0	0	3	0	0
11	18686477	.	A	C	6	4	10	0	0	10	0	0
11	18686492	.	G	A	5	4	9	0	1	10	0	0
11	18686513	.	C	T	5	7	12	0	0	12	0	0
11	18686528	.	T	C	3	6	9	0	1	10	0	0
11	18688956	.	T	C	5	10	15	0	2	17	0	0
11	18694013	.	C	T	9	5	14	0	0	14	0	0
11	18697817	.	T	G	3	9	12	0	0	12	0	0
11	18698138	.	A	G	4	1	5	0	2	7	0	0
11	18698256	.	G	T	4	4	8	0	1	9	0	0
11	18698526	.	G	A	4	3	7	0	2	9	0	0
11	18698687	.	A	T	2	3	5	0	0	5	0	0
11	18698767	.	A	T	1	3	4	0	0	5	1	0
11	18699104	.	T	C	13	11	24	0	0	24	0	0
11	18704378	.	G	C	10	1	11	0	4	15	0	0
11	18704383	.	T	A	11	4	15	0	1	16	0	0
11	18704500	.	G	A	15	16	31	0	0	31	0	0
11	18704620	.	C	T	0	15	15	0	15	30	0	0
11	18705108	.	A	G	20	24	44	0	2	46	0	0
11	18784949	.	A	T	3	10	13	0	0	13	0	0
11	18784975	.	C	A	2	17	19	0	0	20	1	0
11	18785019	.	G	A	9	19	28	0	0	28	0	0
11	18785022	.	G	A	8	20	28	0	1	29	0	0
11	18785159	.	G	T	12	12	24	0	6	30	0	0
11	18785214	.	T	C	20	24	44	0	1	45	0	0
11	18785309	.	G	A	12	18	30	0	3	33	0	0
11	18785410	.	G	A	8	18	26	0	1	27	0	0
11	18785421	.	A	G	8	19	27	0	1	28	0	0
11	18785749	.	C	G	6	5	11	0	0	11	0	0
11	18785854	.	A	G	12	10	22	0	1	23	0	0
11	18786085	.	A	T	9	7	16	0	0	16	0	0
11	18794073	.	T	A	1	3	4	0	0	4	0	0
11	18794157	.	C	A	0	6	6	0	4	10	0	0
11	18799832	.	A	T	6	4	10	0	0	10	0	0
11	18799841	.	C	G	5	3	8	0	1	9	0	0
11	18803095	.	C	T	0	1	1	0	6	7	0	0
11	18803621	.	A	G	3	2	5	0	0	5	0	0
11	18814506	.	T	G	0	4	4	0	0	4	0	0
11	19041518	.	G	A	3	5	8	0	0	8	0	0
11	19041852	.	C	T	5	9	14	0	0	14	0	0
11	19042092	.	T	C	6	9	15	0	1	16	0	0
11	19042212	.	T	C	12	7	19	0	1	20	0	0
11	19068394	.	C	T	3	3	6	0	0	6	0	0
11	19072566	.	A	T	17	22	39	0	1	40	0	0
11	19072608	.	T	A	18	18	36	0	3	39	0	0
11	19072695	.	G	A	13	15	28	0	0	28	0	0
11	19072728	.	G	A	1	8	9	0	5	14	0	0
11	19084820	.	C	T	7	6	13	0	0	13	0	0
11	19089286	.	A	G	30	26	56	0	1	57	0	0
11	19089362	.	A	G	26	21	47	0	1	48	0	0
11	19089368	.	C	T	22	21	43	0	3	46	0	0
11	19089608	.	G	A	2	30	32	0	30	62	0	0
11	19089724	.	T	C	23	22	45	0	2	47	0	0
11	19089839	.	G	A	0	15	15	0	21	36	0	0
11	19090203	.	G	A	0	15	15	0	11	26	0	0
11	19090455	.	C	T	25	16	41	0	2	43	0	0
11	19090597	.	A	G	23	22	45	0	3	48	0	0
11	19370801	.	C	T	2	2	4	0	0	4	0	0
11	19370862	.	G	C	4	4	8	0	0	8	0	0
11	19370866	.	C	T	4	4	8	0	0	8	0	0
11	19434043	.	G	C	8	8	16	0	1	17	0	0
11	19462920	.	C	T	1	3	4	0	1	5	0	0
11	19464813	.	A	G	8	4	12	0	0	12	0	0
11	19464957	.	C	G	11	0	11	0	9	20	0	0
11	19465149	.	T	C	11	15	26	0	0	26	0	0
11	19465174	.	C	T	11	11	22	0	0	22	0	0
11	19465269	.	T	C	9	10	19	0	0	19	0	0
11	19465302	.	A	T	8	8	16	0	2	18	0	0
11	19465428	.	C	T	4	6	10	0	1	11	0	0
11	19467673	.	G	A	6	5	11	0	1	12	0	0
11	19467792	.	G	A	0	15	15	0	18	33	0	0
11	19468147	.	C	T	20	17	37	0	2	39	0	0
11	19468330	.	A	G	15	0	15	0	18	33	0	0
11	19502433	.	C	T	17	17	34	0	1	35	0	0
11	19505967	.	T	C	13	13	26	0	1	27	0	0
11	19506260	.	C	T	9	14	23	0	1	24	0	0
11	19512285	.	T	C	2	4	6	0	1	7	0	0
11	19512430	.	C	T	0	3	3	1	4	8	0	0
11	19513245	.	C	T	2	3	5	0	0	5	0	0
11	19513639	.	C	T	3	4	7	0	0	7	0	0
11	19522913	.	A	G	1	0	1	0	0	1	0	0
11	19522962	.	G	C	1	2	3	0	0	3	0	0
11	19604223	.	A	C	8	9	17	0	0	17	0	0
11	19611215	.	C	T	6	4	10	0	0	10	0	0
11	19624552	.	C	T	2	6	8	0	0	8	0	0
11	19624616	.	A	T	3	9	12	0	0	12	0	0
11	19624686	.	T	C	7	6	13	0	0	13	0	0
11	19624730	.	T	G	5	8	13	0	1	14	0	0
11	19625524	.	C	T	0	6	6	0	23	29	0	0
11	19625673	.	A	T	11	9	20	0	0	20	0	0
11	19625732	.	A	G	14	12	26	0	2	28	0	0
11	19625804	.	C	T	6	13	19	0	1	20	0	0
11	19625840	.	G	T	6	7	13	0	1	14	0	0
11	19626209	.	A	G	6	6	12	0	0	12	0	0
11	19626216	.	G	T	7	5	12	0	0	12	0	0
11	19626393	.	A	G	2	2	4	0	0	4	0	0
11	19626536	.	T	A	3	4	7	0	0	7	0	0
11	19626556	.	A	G	5	6	11	0	0	11	0	0
11	19626720	.	G	A	6	3	9	0	0	9	0	0
11	19626959	.	A	G	3	4	7	0	2	9	0	0
11	19627157	.	T	A	7	9	16	0	0	16	0	0
11	19627169	.	A	T	9	9	18	0	1	19	0	0
11	19627277	.	A	T	6	8	14	0	0	14	0	0
11	19627344	.	A	G	7	5	12	0	0	12	0	0
11	19627378	.	G	A	5	3	8	0	0	8	0	0
11	19627394	.	G	A	5	3	8	0	0	8	0	0
11	19632882	.	A	G	1	2	3	0	0	3	0	0
11	19639122	.	A	G	2	2	4	0	0	4	0	0
11	19639197	.	C	T	0	2	2	0	5	7	0	0
11	19729965	.	T	A	3	5	8	0	2	10	0	0
11	19730001	.	A	C	7	0	7	0	9	16	0	0
11	19733136	.	T	C	5	3	8	0	0	8	0	0
11	19733388	.	A	G	5	4	9	0	0	9	0	0
11	19736959	.	G	A	0	2	2	0	0	2	0	0
11	19836147	.	T	C	3	2	5	0	0	5	0	0
11	19964839	.	G	A	0	1	1	0	0	1	0	0
11	19986191	.	G	A	0	1	1	0	1	2	0	0
11	19986251	.	A	G	1	0	1	0	5	6	0	0
11	19999131	.	T	C	1	1	2	0	0	2	0	0
11	20009880	.	T	C	1	0	1	0	0	1	0	0
11	20017802	.	A	G	1	4	5	0	0	5	0	0
11	20036591	.	G	A	5	3	8	0	0	8	0	0
11	20039868	.	G	C	6	4	10	0	0	10	0	0
11	20039877	.	G	A	6	5	11	0	0	11	0	0
11	20039974	.	C	T	6	4	10	0	0	10	0	0
11	20039979	.	T	C	5	3	8	0	0	8	0	0
11	20040014	.	T	A	1	4	5	0	0	5	0	0
11	20040145	.	T	G	11	1	12	0	7	19	0	0
11	20636107	.	C	A	2	0	2	0	0	2	0	0
11	20657517	.	A	C	1	3	4	0	0	4	0	0
11	20657574	.	G	C	5	5	10	0	0	10	0	0
11	20657661	.	T	C	0	1	1	0	0	1	0	0
11	20787999	.	C	T	7	9	16	0	0	16	0	0
11	20788014	.	G	A	0	9	9	0	7	16	0	0
11	20794150	.	T	C	10	15	25	0	2	27	0	0
11	20815757	.	A	G	15	0	15	0	16	31	0	0
11	20826358	.	T	C	11	12	23	0	0	23	0	0
11	20979901	.	A	C	3	4	7	0	0	7	0	0
11	21154727	.	G	A	3	2	5	0	0	5	0	0
11	21154747	.	A	T	4	3	7	0	0	7	0	0
11	21154786	.	A	C	5	5	10	0	0	10	0	0
11	21155290	.	G	A	11	12	23	0	0	23	0	0
11	21155829	.	A	G	5	12	17	0	0	17	0	0
11	21156278	.	G	A	4	4	8	0	0	8	0	0
11	21156372	.	G	A	6	7	13	0	0	13	0	0
11	21158423	.	C	A	0	5	5	0	1	6	0	0
11	21158774	.	A	G	1	0	1	0	0	1	0	0
11	21173971	.	T	C	0	2	2	0	0	2	0	0
11	21217518	.	T	C	3	0	3	0	1	4	0	0
11	21217542	.	T	C	4	2	6	0	1	7	0	0
11	21217834	.	T	C	4	2	6	0	0	6	0	0
11	21217986	.	A	G	3	1	4	0	0	4	0	0
11	21217994	.	G	A	3	1	4	0	1	5	0	0
11	21259665	.	T	A	3	5	8	0	3	11	0	0
11	21259771	.	T	C	3	3	6	0	0	6	0	0
11	21259968	.	A	G	5	2	7	0	1	8	0	0
11	21260676	.	C	T	3	4	7	0	0	7	0	0
11	21260750	.	C	T	2	3	5	0	1	6	0	0
11	21260985	.	A	T	4	6	10	0	0	10	0	0
11	21261546	.	A	G	1	1	2	0	0	2	0	0
11	21261558	.	T	C	2	0	2	0	0	2	0	0
11	21267053	.	A	T	1	3	4	0	0	4	0	0
11	21278950	.	T	A	16	16	32	0	1	33	0	0
11	21279025	.	G	A	12	19	31	0	2	33	0	0
11	21279144	.	A	T	14	15	29	0	4	33	0	0
11	21279225	.	G	A	15	14	29	0	1	30	0	0
11	21279261	.	A	G	10	15	25	0	2	27	0	0
11	21279782	.	T	A	3	2	5	0	0	5	0	0
11	21279827	.	T	C	6	4	10	0	0	10	0	0
11	21279861	.	T	G	7	10	17	0	1	18	0	0
11	21279885	.	A	G	6	11	17	0	0	17	0	0
11	21279921	.	A	C	10	12	22	0	0	22	0	0
11	21279959	.	C	T	12	8	20	0	2	22	0	0
11	21280003	.	T	C	11	7	18	0	0	18	0	0
11	21280149	.	G	T	7	9	16	0	0	16	0	0
11	21280236	.	C	A	8	12	20	0	0	20	0	0
11	21280284	.	T	A	12	8	20	0	1	21	0	0
11	21280347	.	C	T	13	8	21	0	0	21	0	0
11	21280349	.	G	A	13	7	20	0	1	21	0	0
11	21280504	.	A	C	7	8	15	0	1	16	0	0
11	21280636	.	T	A	2	6	8	0	1	9	0	0
11	21280638	.	A	T	3	6	9	0	0	9	0	0
11	21280690	.	T	C	5	6	11	0	0	11	0	0
11	21280801	.	T	A	12	14	26	0	1	27	0	0
11	21280808	.	T	C	10	15	25	0	0	25	0	0
11	21280848	.	T	A	12	14	26	0	0	26	0	0
11	21280864	.	A	G	10	12	22	0	0	22	0	0
11	21280926	.	T	C	5	8	13	0	1	14	0	0
11	21280974	.	G	A	7	13	20	0	1	21	0	0
11	21281017	.	A	T	3	6	9	0	2	11	0	0
11	21281087	.	C	T	10	16	26	0	0	26	0	0
11	21281138	.	G	A	13	17	30	0	3	33	0	0
11	21281148	.	G	A	15	17	32	0	0	32	0	0
11	21281219	.	G	A	10	12	22	0	1	23	0	0
11	21281240	.	G	C	7	10	17	0	0	17	0	0
11	21281269	.	T	C	6	8	14	0	0	14	0	0
11	21281311	.	A	T	11	12	23	0	0	23	0	0
11	21281328	.	C	T	12	13	25	0	1	26	0	0
11	21281599	.	T	C	12	18	30	0	2	32	0	0
11	21281878	.	T	C	7	3	10	0	0	10	0	0
11	21281888	.	G	A	3	9	12	0	0	12	0	0
11	21281916	.	A	G	3	3	6	0	1	7	0	0
11	21282355	.	G	A	8	3	11	0	0	11	0	0
11	21282414	.	G	A	7	4	11	0	1	12	0	0
11	21282424	.	C	G	7	5	12	0	0	12	0	0
11	21282500	.	C	A	8	12	20	0	2	22	0	0
11	21282571	.	G	A	10	8	18	0	1	19	0	0
11	21282747	.	T	C	3	13	16	0	0	16	0	0
11	21282957	.	T	C	11	0	11	0	9	20	0	0
11	21284382	.	G	A	1	3	4	0	0	4	0	0
11	21284400	.	A	T	3	3	6	0	1	7	0	0
11	21284588	.	A	G	5	4	9	0	0	9	0	0
11	21284701	.	A	C	18	0	18	0	12	30	0	0
11	21284733	.	C	T	14	9	23	0	1	24	0	0
11	21303983	.	C	A	0	2	2	0	2	4	0	0
11	21323564	.	A	G	0	1	1	0	1	2	0	0
11	21352744	.	G	C	6	5	11	0	1	12	0	0
11	21352773	.	A	T	10	6	16	0	1	17	0	0
11	21363411	.	T	C	1	0	1	0	2	3	0	0
11	21363479	.	A	G	1	5	6	0	0	6	0	0
11	21363480	.	A	C	1	0	1	0	5	6	0	0
11	21363693	.	A	T	1	3	4	0	0	4	0	0
11	21407073	.	C	A	0	15	15	0	7	22	0	0
11	21407091	.	T	C	4	0	4	0	14	18	0	0
11	21407540	.	A	G	9	11	20	0	0	20	0	0
11	21407591	.	G	A	9	12	21	0	1	22	0	0
11	21407843	.	C	T	7	6	13	0	0	13	0	0
11	21407862	.	A	T	6	5	11	0	0	11	0	0
11	21407895	.	C	G	5	9	14	0	0	14	0	0
11	21407901	.	T	C	6	8	14	0	0	14	0	0
11	21408041	.	G	A	8	4	12	0	0	12	0	0
11	21408201	.	T	A	7	15	22	0	0	22	0	0
11	21408202	.	T	C	7	15	22	0	0	22	0	0
11	21408242	.	C	T	6	8	14	0	1	15	0	0
11	21408328	.	T	C	7	3	10	0	3	13	0	0
11	21408423	.	T	A	3	4	7	0	0	7	0	0
11	21408525	.	A	G	4	10	14	0	0	14	0	0
11	21408862	.	A	G	4	3	7	0	0	7	0	0
11	21408962	.	C	T	5	9	14	0	1	15	0	0
11	21409037	.	A	T	1	3	4	0	0	4	0	0
11	21409236	.	A	T	6	6	12	0	0	12	0	0
11	21409251	.	A	G	6	6	12	0	1	13	0	0
11	21409289	.	T	G	7	4	11	0	2	13	0	0
11	21409331	.	A	G	10	4	14	0	0	14	0	0
11	21409690	.	A	G	10	7	17	0	0	17	0	0
11	21409981	.	C	A	7	7	14	0	0	14	0	0
11	21410009	.	A	G	7	6	13	0	1	14	0	0
11	21410542	.	T	C	10	0	10	0	13	23	0	0
11	21410584	.	G	A	10	10	20	0	0	20	0	0
11	21413929	.	C	T	8	4	12	0	0	12	0	0
11	21419325	.	G	A	6	6	12	0	2	14	0	0
11	21419637	.	A	C	0	2	2	0	0	2	0	0
11	21457875	.	C	T	4	8	12	0	1	13	0	0
11	21583088	.	G	C	4	0	4	0	5	9	0	0
11	21593849	.	A	T	5	7	12	0	0	12	0	0
11	21593869	.	G	C	7	6	13	0	0	13	0	0
11	21594552	.	G	A	0	4	4	0	1	5	0	0
11	21594704	.	T	C	5	2	7	0	0	7	0	0
11	21595189	.	G	A	5	6	11	0	0	11	0	0
11	21595191	.	G	A	0	6	6	0	5	11	0	0
11	21595307	.	G	A	6	3	9	0	0	9	0	0
11	21595615	.	G	A	4	2	6	0	0	6	0	0
11	21596453	.	A	G	0	1	1	0	1	2	0	0
11	21596459	.	T	C	0	4	4	0	0	4	0	0
11	21596492	.	A	G	3	0	3	0	5	8	0	0
11	21596931	.	C	T	4	2	6	0	1	7	0	0
11	21597055	.	T	G	6	12	18	0	0	18	0	0
11	21597107	.	A	G	6	5	11	0	0	11	0	0
11	21597154	.	T	C	7	6	13	0	1	14	0	0
11	21597165	.	C	T	5	5	10	0	1	11	0	0
11	21597261	.	C	T	4	4	8	0	1	9	0	0
11	21597659	.	T	C	1	8	9	0	0	9	0	0
11	21597676	.	C	A	1	6	7	0	1	8	0	0
11	21597702	.	A	G	1	4	5	0	1	6	0	0
11	21597742	.	T	A	2	2	4	0	0	4	0	0
11	21597754	.	T	G	2	2	4	0	0	4	0	0
11	21598002	.	T	C	2	5	7	0	1	8	0	0
11	21598036	.	T	C	4	5	9	0	1	10	0	0
11	23856440	.	A	G	3	8	11	0	0	11	0	0
11	24054359	.	G	T	5	3	8	0	0	8	0	0
11	24191139	.	A	G	1	5	6	0	0	6	0	0
11	24885839	.	A	G	5	0	5	0	4	9	0	0
11	24887702	.	A	G	8	0	8	0	7	15	0	0
11	25405801	.	C	T	1	7	8	0	1	9	0	0
11	25713768	.	T	C	4	15	19	0	1	20	0	0
11	25713820	.	T	C	4	9	13	0	0	13	0	0
11	25882942	.	A	G	0	6	6	0	0	6	0	0
11	26229587	.	T	C	3	2	5	0	2	7	0	0
11	26229588	.	T	C	6	1	7	0	2	9	0	0
11	26366792	.	A	G	1	0	1	0	7	8	0	0
11	26545746	.	A	G	2	2	4	0	0	4	0	0
11	26545779	.	A	G	4	3	7	0	0	7	0	0
11	26545819	.	A	G	5	3	8	0	0	8	0	0
11	26704189	.	A	T	5	1	6	0	1	7	0	0
11	27676540	.	C	T	0	1	1	0	0	1	0	0
11	29918045	.	T	C	8	0	8	0	2	10	0	0
11	29918070	.	T	C	1	7	8	0	0	8	0	0
11	29918168	.	T	C	2	2	4	0	1	5	0	0
11	30640954	.	A	G	1	4	5	0	0	5	0	0
11	30642164	.	A	G	3	3	6	0	0	6	0	0
11	31024887	.	A	G	9	6	15	0	0	15	0	0
11	31558251	.	G	A	0	6	6	0	11	17	0	0
11	31558634	.	C	A	12	19	31	0	0	31	0	0
11	31558782	.	C	T	11	6	17	0	0	17	0	0
11	31602828	.	G	T	7	12	19	0	0	19	0	0
11	31603346	.	G	A	0	3	3	0	4	7	0	0
11	31647283	.	A	C	5	5	10	0	0	10	0	0
11	31649781	.	G	A	0	0	0	0	2	2	0	0
11	31653670	.	T	G	2	0	2	0	3	5	0	0
11	31653700	.	T	C	2	6	8	0	0	8	0	0
11	31664070	.	T	C	6	3	9	0	0	9	0	0
11	31664108	.	T	C	3	1	4	0	1	5	0	0
11	31667490	.	C	A	5	0	5	0	0	5	0	0
11	31667592	.	C	T	14	16	30	0	1	31	0	0
11	31667658	.	C	T	15	16	31	0	1	32	0	0
11	31667946	.	G	A	13	10	23	0	2	25	0	0
11	31668186	.	A	G	11	3	14	0	0	17	3	0
11	31668191	.	A	T	10	2	12	0	1	16	3	0
11	31668330	.	C	A	9	13	22	0	1	23	0	0
11	31668394	.	T	G	10	12	22	0	0	22	0	0
11	31668540	.	T	A	1	8	9	0	0	9	0	0
11	31668588	.	C	A	2	4	6	0	0	6	0	0
11	31668824	.	T	A	3	9	12	0	3	15	0	0
11	31668849	.	A	T	5	10	15	0	0	15	0	0
11	31668893	.	T	C	8	5	13	0	0	13	0	0
11	31668964	.	G	C	2	3	5	0	0	5	0	0
11	31670123	.	A	T	1	4	5	0	0	5	0	0
11	31670130	.	T	A	1	2	3	0	1	4	0	0
11	31670216	.	A	T	6	15	21	0	0	22	1	0
11	31670724	.	A	G	7	0	7	0	7	14	0	0
11	31670749	.	C	A	6	6	12	0	1	13	0	0
11	31670789	.	C	T	11	4	15	0	1	16	0	0
11	31670868	.	T	C	18	14	32	0	1	33	0	0
11	31670881	.	T	A	16	14	30	0	1	31	0	0
11	31670920	.	G	A	0	7	7	0	7	14	0	0
11	31671165	.	G	C	4	7	11	0	2	13	0	0
11	31671189	.	A	G	3	7	10	0	0	10	0	0
11	31671203	.	A	G	11	3	14	0	0	14	0	0
11	31671326	.	G	T	0	4	4	0	2	6	0	0
11	31671328	.	T	G	2	4	6	0	0	6	0	0
11	32576695	.	C	T	12	10	22	0	4	26	0	0
11	32577076	.	T	A	4	5	9	0	0	9	0	0
11	32577258	.	C	T	0	11	11	0	11	22	0	0
11	32577404	.	A	G	15	14	29	0	1	30	0	0
11	32577439	.	G	A	13	14	27	0	3	30	0	0
11	32577800	.	G	A	14	16	30	0	1	31	0	0
11	32577830	.	G	A	17	17	34	0	1	35	0	0
11	32578082	.	C	T	16	17	33	0	0	33	0	0
11	32578172	.	G	A	18	12	30	0	1	31	0	0
11	32720124	.	C	T	22	10	32	0	1	33	0	0
11	32720427	.	A	T	12	17	29	0	1	30	0	0
11	32720505	.	C	T	14	7	21	0	0	21	0	0
11	32720730	.	C	G	10	8	18	0	0	18	0	0
11	32720856	.	A	G	8	12	20	0	0	20	0	0
11	32721057	.	T	A	7	6	13	0	0	13	0	0
11	32721144	.	A	G	12	9	21	0	0	21	0	0
11	32721168	.	A	G	13	12	25	0	0	25	0	0
11	32721333	.	A	G	6	7	13	0	0	13	0	0
11	32721765	.	A	G	3	6	9	0	1	10	0	0
11	32721843	.	G	A	9	7	16	0	0	16	0	0
11	32722547	.	A	G	6	5	11	0	1	12	0	0
11	32723520	.	G	A	4	6	10	0	1	11	0	0
11	32723691	.	C	T	7	6	13	0	1	14	0	0
11	33426728	.	A	G	0	0	0	0	1	1	0	0
11	33477594	.	T	C	1	3	4	0	0	4	0	0
11	33477630	.	C	A	1	2	3	0	0	3	0	0
11	33514693	.	T	G	2	0	2	0	0	2	0	0
11	33530170	.	T	C	2	0	2	0	0	2	0	0
11	33532289	.	A	G	1	1	2	0	0	2	0	0
11	33537435	.	C	T	1	3	4	0	0	4	0	0
11	33539693	.	T	C	1	2	3	0	0	3	0	0
11	33545056	.	A	T	3	2	5	0	0	5	0	0
11	33551200	.	T	C	1	0	1	0	0	1	0	0
11	33553873	.	T	C	12	8	20	0	0	20	0	0
11	33554087	.	G	A	5	8	13	0	0	13	0	0
11	33554116	.	G	A	5	11	16	0	1	17	0	0
11	33554535	.	T	C	5	8	13	0	0	13	0	0
11	33598972	.	A	G	4	2	6	0	0	6	0	0
11	33599038	.	T	C	7	6	13	0	1	14	0	0
11	33599148	.	T	C	7	11	18	0	1	19	0	0
11	33599187	.	T	C	13	0	13	0	10	23	0	0
11	33599223	.	A	G	18	12	30	0	1	31	0	0
11	33599240	.	A	T	16	13	29	0	0	29	0	0
11	33599464	.	C	T	0	5	5	0	5	10	0	0
11	33599900	.	C	T	0	4	4	0	8	12	0	0
11	33600015	.	G	A	8	4	12	0	0	12	0	0
11	33600174	.	G	A	11	10	21	0	1	22	0	0
11	33600215	.	A	G	18	11	29	0	1	31	1	0
11	33600350	.	T	G	8	2	10	0	0	10	0	0
11	33600551	.	C	A	2	2	4	0	0	4	0	0
11	33600572	.	T	A	2	6	8	0	0	8	0	0
11	33600646	.	T	C	9	0	9	0	4	13	0	0
11	33600742	.	A	T	11	5	16	0	0	16	0	0
11	33772552	.	C	T	2	4	6	0	0	6	0	0
11	33827023	.	G	A	0	4	4	0	0	4	0	0
11	33829443	.	A	G	2	2	4	0	0	4	0	0
11	33829515	.	A	G	3	5	8	0	0	8	0	0
11	33832679	.	C	T	6	11	17	0	2	19	0	0
11	33834700	.	A	G	0	3	3	0	0	3	0	0
11	33835385	.	C	A	1	1	2	0	0	2	0	0
11	33835542	.	T	C	2	8	10	0	0	10	0	0
11	33839169	.	C	T	0	1	1	0	0	1	0	0
11	33841788	.	C	T	6	10	16	0	0	16	0	0
11	33841984	.	C	T	7	10	17	0	2	19	0	0
11	33842542	.	C	T	2	6	8	0	0	8	0	0
11	33846519	.	T	C	1	9	10	0	2	12	0	0
11	33846657	.	G	A	4	4	8	0	0	8	0	0
11	33846729	.	T	C	5	0	5	0	3	8	0	0
11	33847080	.	T	G	7	4	11	0	0	11	0	0
11	33847293	.	G	A	5	4	9	0	0	9	0	0
11	33855666	.	G	A	4	1	5	0	0	5	0	0
11	33857576	.	A	C	1	4	5	0	0	5	0	0
11	33857580	.	G	A	1	4	5	0	0	5	0	0
11	33857833	.	T	C	5	11	16	0	0	16	0	0
11	33870464	.	A	T	8	3	11	0	1	12	0	0
11	33871043	.	T	G	6	2	8	0	0	8	0	0
11	33871197	.	T	C	4	0	4	0	3	7	0	0
11	33871210	.	A	G	5	3	8	0	0	8	0	0
11	33871343	.	G	T	5	7	12	0	0	12	0	0
11	33871358	.	G	T	5	4	9	0	0	9	0	0
11	33871378	.	G	T	11	7	18	0	0	18	0	0
11	33871466	.	A	G	14	6	20	2	0	22	0	0
11	33871575	.	A	G	23	13	36	0	0	36	0	0
11	33871897	.	C	T	14	9	23	0	5	28	0	0
11	33871932	.	C	A	21	5	26	0	0	26	0	0
11	33872038	.	G	C	13	0	13	0	13	26	0	0
11	33872289	.	T	C	18	0	18	0	9	27	0	0
11	33872411	.	A	C	10	7	17	0	0	17	0	0
11	33872564	.	G	T	24	9	33	0	0	33	0	0
11	33872661	.	A	G	7	4	11	0	0	11	0	0
11	33872684	.	C	T	6	6	12	0	1	13	0	0
11	33872699	.	A	G	4	6	10	0	0	10	0	0
11	33872759	.	A	G	2	6	8	0	0	8	0	0
11	33872763	.	A	C	2	5	7	0	0	7	0	0
11	33872829	.	C	T	0	8	8	0	8	16	0	0
11	33873408	.	T	C	3	3	6	0	0	6	0	0
11	33873539	.	C	T	0	5	5	0	10	15	0	0
11	33873578	.	A	C	12	12	24	0	0	24	0	0
11	33880086	.	A	G	2	4	6	0	0	6	0	0
11	33880089	.	C	T	0	4	4	0	2	6	0	0
11	33887086	.	C	T	0	1	1	0	1	2	0	0
11	33888884	.	G	A	7	5	12	0	0	12	0	0
11	33900231	.	G	C	0	1	1	0	0	1	0	0
11	33900436	.	G	C	3	3	6	0	0	6	0	0
11	33902072	.	T	C	1	1	2	0	0	2	0	0
11	33902283	.	C	A	2	0	2	0	1	3	0	0
11	33905668	.	G	A	0	1	1	0	0	1	0	0
11	33912573	.	T	C	8	3	11	0	1	12	0	0
11	33912645	.	T	G	2	0	2	0	0	2	0	0
11	33998724	.	C	T	1	2	3	0	0	3	0	0
11	34133827	.	T	C	0	2	2	0	0	2	0	0
11	34147172	.	C	T	2	2	4	0	0	4	0	0
11	34220083	.	G	A	2	3	5	0	0	5	0	0
11	34220129	.	C	T	3	2	5	0	1	6	0	0
11	34228050	.	C	T	0	2	2	0	5	7	0	0
11	34230594	.	G	T	4	4	8	0	0	8	0	0
11	34230613	.	A	C	4	5	9	0	0	9	0	0
11	34231302	.	G	A	5	5	10	0	1	11	0	0
11	34232662	.	A	G	3	9	12	0	0	12	0	0
11	34232681	.	A	G	1	2	3	0	0	3	0	0
11	34235427	.	C	A	5	15	20	0	0	20	0	0
11	34235498	.	C	G	2	9	11	0	0	11	0	0
11	34235528	.	T	C	2	4	6	0	0	6	0	0
11	34235825	.	A	T	6	8	14	0	1	15	0	0
11	34235858	.	A	C	6	10	16	0	2	18	0	0
11	34235918	.	A	G	14	1	15	0	10	25	0	0
11	34236092	.	G	T	14	12	26	0	0	26	0	0
11	34236686	.	T	C	4	2	6	0	0	6	0	0
11	34236708	.	A	G	4	2	6	0	0	6	0	0
11	34237150	.	C	T	11	8	19	0	0	19	0	0
11	34237217	.	A	G	4	6	10	0	1	11	0	0
11	34237521	.	C	G	7	3	10	0	0	10	0	0
11	34779198	.	T	C	2	7	9	0	0	9	0	0
11	34780009	.	T	C	7	2	9	0	2	11	0	0
11	34780333	.	G	A	1	2	3	0	3	6	0	0
11	34824331	.	G	A	6	6	12	0	0	12	0	0
11	34856424	.	A	G	1	3	4	0	0	4	0	0
11	34859637	.	C	T	0	2	2	0	0	2	0	0
11	34860908	.	C	T	0	1	1	0	0	1	0	0
11	34860923	.	G	C	1	2	3	0	0	3	0	0
11	34890099	.	A	G	1	1	2	0	0	2	0	0
11	34899393	.	A	G	3	0	3	0	0	3	0	0
11	34900464	.	C	T	4	5	9	0	0	9	0	0
11	34900516	.	A	G	1	0	1	0	0	1	0	0
11	34900521	.	C	T	1	0	1	0	0	1	0	0
11	34907104	.	C	A	2	4	6	0	1	7	0	0
11	34907118	.	G	T	3	5	8	0	2	10	0	0
11	34907287	.	G	C	4	3	7	0	0	7	0	0
11	34907537	.	A	G	3	0	3	0	5	8	0	0
11	34907649	.	T	G	2	4	6	0	0	6	0	0
11	34907682	.	A	G	4	2	6	0	0	6	0	0
11	34907726	.	T	A	2	5	7	0	0	7	0	0
11	34907794	.	T	C	5	3	8	0	0	8	0	0
11	34907876	.	T	A	10	9	19	0	1	20	0	0
11	34908165	.	C	T	5	9	14	0	0	14	0	0
11	34908187	.	G	C	7	9	16	0	0	16	0	0
11	34908201	.	C	T	7	9	16	0	0	16	0	0
11	34908431	.	G	A	6	2	8	0	1	9	0	0
11	34908448	.	T	A	5	8	13	0	1	14	0	0
11	34908516	.	C	A	6	8	14	0	0	14	0	0
11	34908545	.	A	T	5	4	9	0	0	9	0	0
11	34908597	.	T	C	6	5	11	0	0	11	0	0
11	34908854	.	T	G	1	2	3	0	0	3	0	0
11	34909268	.	T	A	5	12	17	0	0	17	0	0
11	34909288	.	G	T	0	5	5	0	9	14	0	0
11	34909353	.	C	A	5	2	7	0	1	8	0	0
11	34909489	.	A	G	6	4	10	0	0	10	0	0
11	34909513	.	G	T	6	2	8	0	0	8	0	0
11	34909618	.	A	G	9	7	16	0	1	17	0	0
11	34909868	.	C	T	4	7	11	0	0	11	0	0
11	34909916	.	C	T	11	7	18	0	1	19	0	0
11	34909997	.	G	T	13	8	21	0	0	21	0	0
11	34910349	.	C	T	9	6	15	0	0	15	0	0
11	34910468	.	T	C	8	9	17	0	0	17	0	0
11	34910487	.	T	C	8	8	16	0	0	16	0	0
11	34910503	.	C	T	6	9	15	0	0	15	0	0
11	34910654	.	C	T	2	6	8	0	0	8	0	0
11	34910867	.	T	A	10	4	14	0	0	14	0	0
11	34910897	.	A	G	6	14	20	1	0	21	0	0
11	34911229	.	G	A	13	13	26	0	0	26	0	0
11	34911445	.	A	G	11	16	27	0	0	27	0	0
11	34911451	.	T	A	12	15	27	0	0	27	0	0
11	34912481	.	G	A	13	19	32	0	0	32	0	0
11	34912616	.	G	A	18	15	33	0	0	33	0	0
11	34912850	.	G	A	10	9	19	1	0	20	0	0
11	34913101	.	C	A	10	9	19	0	1	20	0	0
11	34913370	.	T	A	12	25	37	0	0	37	0	0
11	34913454	.	G	A	7	5	12	0	0	12	0	0
11	34914190	.	G	A	16	17	33	0	2	35	0	0
11	35019847	.	C	T	2	2	4	0	0	4	0	0
11	35034669	.	G	A	9	11	20	0	0	20	0	0
11	35038124	.	G	C	0	12	12	0	11	23	0	0
11	35182653	.	T	C	2	0	2	0	0	2	0	0
11	35438612	.	A	C	0	8	8	0	3	11	0	0
11	35440173	.	T	A	11	2	13	0	0	13	0	0
11	36046521	.	T	A	2	3	5	0	0	5	0	0
11	36046523	.	A	C	2	3	5	0	0	5	0	0
11	36158379	.	A	C	6	2	8	0	0	8	0	0
11	36158839	.	G	T	2	2	4	0	0	4	0	0
11	36180612	.	C	T	4	5	9	0	1	10	0	0
11	36180666	.	C	T	3	4	7	0	1	8	0	0
11	36180774	.	A	G	7	3	10	0	0	10	0	0
11	36180775	.	T	C	7	3	10	0	0	10	0	0
11	36180876	.	C	A	6	4	10	0	0	10	0	0
11	36205992	.	C	T	6	7	13	0	0	13	0	0
11	36206090	.	C	T	3	3	6	0	0	6	0	0
11	36208199	.	G	A	7	8	15	0	0	15	0	0
11	36208328	.	G	A	1	5	6	0	9	15	0	0
11	36214517	.	C	T	19	11	30	0	1	31	0	0
11	36214815	.	G	A	0	14	14	0	15	29	0	0
11	36214859	.	C	T	12	6	18	0	0	18	0	0
11	36214955	.	A	T	4	12	16	0	3	19	0	0
11	36215346	.	G	A	10	15	25	0	0	26	1	0
11	36215399	.	A	G	12	12	24	0	0	24	0	0
11	36218548	.	G	C	2	1	3	0	0	3	0	0
11	36224573	.	G	A	0	1	1	0	0	1	0	0
11	36224780	.	T	C	0	0	0	0	1	1	0	0
11	36224833	.	C	T	0	1	1	0	0	1	0	0
11	36237094	.	C	T	1	3	4	0	0	4	0	0
11	36237148	.	C	G	1	2	3	0	0	3	0	0
11	36254334	.	C	T	1	1	2	0	1	3	0	0
11	36255005	.	T	C	6	3	9	0	0	9	0	0
11	36255011	.	T	C	5	3	8	0	0	8	0	0
11	36269682	.	G	A	1	3	4	0	0	4	0	0
11	36269768	.	A	G	4	4	8	0	0	8	0	0
11	36269788	.	A	G	2	1	3	0	0	3	0	0
11	36281939	.	T	G	9	5	14	0	0	14	0	0
11	36281943	.	G	A	8	5	13	0	1	14	0	0
11	36282259	.	A	T	7	4	11	0	0	11	0	0
11	36282417	.	G	T	4	6	10	0	0	10	0	0
11	36282450	.	G	T	4	4	8	0	1	9	0	0
11	36282494	.	G	T	7	4	11	0	0	11	0	0
11	36282501	.	C	T	8	3	11	0	1	12	0	0
11	36282534	.	A	G	7	4	11	0	0	11	0	0
11	36282958	.	T	C	3	3	6	0	0	6	0	0
11	36291207	.	G	A	1	1	2	0	0	2	0	0
11	36291208	.	T	C	1	1	2	0	0	2	0	0
11	36340801	.	C	T	2	2	4	0	0	4	0	0
11	36340961	.	A	G	2	4	6	0	0	6	0	0
11	36340991	.	T	C	2	3	5	0	0	5	0	0
11	36343167	.	G	C	15	14	29	0	0	29	0	0
11	36343339	.	A	T	1	1	2	0	1	3	0	0
11	36372690	.	G	A	1	4	5	0	0	5	0	0
11	36373059	.	C	T	2	2	4	0	0	4	0	0
11	36373355	.	C	T	2	2	4	0	0	4	0	0
11	36374764	.	G	A	1	4	5	0	0	5	0	0
11	36374922	.	T	A	2	2	4	0	0	4	0	0
11	36375028	.	A	G	5	0	5	0	6	11	0	0
11	36375367	.	T	C	6	2	8	0	0	8	0	0
11	36375671	.	C	T	10	7	17	0	1	18	0	0
11	36375708	.	A	G	8	7	15	0	2	17	0	0
11	36375774	.	A	T	7	5	12	0	0	12	0	0
11	36375852	.	T	G	6	4	10	0	1	11	0	0
11	36388511	.	A	C	3	3	6	0	0	6	0	0
11	36393111	.	A	G	1	0	1	0	2	3	0	0
11	36393150	.	T	A	2	1	3	0	0	3	0	0
11	36395728	.	T	C	2	0	2	0	0	2	0	0
11	36398192	.	G	A	0	4	4	0	2	6	0	0
11	36398318	.	A	G	3	7	10	0	1	11	0	0
11	36398531	.	A	G	8	0	8	0	6	14	0	0
11	36398558	.	T	A	6	2	8	0	2	10	0	0
11	36398624	.	C	T	2	2	4	0	2	6	0	0
11	36415019	.	A	T	0	1	1	0	1	2	0	0
11	36422351	.	G	A	6	2	8	0	0	8	0	0
11	36452372	.	G	A	1	4	5	0	0	5	0	0
11	36452688	.	A	G	7	7	14	0	0	14	0	0
11	36456056	.	T	C	4	2	6	0	1	7	0	0
11	36456058	.	T	G	5	2	7	0	0	7	0	0
11	36456101	.	T	A	5	9	14	0	0	14	0	0
11	36456125	.	A	C	5	0	5	0	5	10	0	0
11	36460829	.	G	A	4	3	7	0	1	8	0	0
11	36463965	.	T	C	4	5	9	0	0	9	0	0
11	36464376	.	G	T	1	0	1	0	0	1	0	0
11	36464394	.	G	A	1	1	2	0	0	2	0	0
11	36464541	.	T	A	0	1	1	0	1	2	0	0
11	36467942	.	G	A	5	8	13	0	0	13	0	0
11	36467948	.	C	T	9	4	13	0	0	13	0	0
11	36468047	.	G	A	3	3	6	0	1	7	0	0
11	36470493	.	C	T	0	1	1	0	0	1	0	0
11	36470651	.	G	A	3	2	5	0	0	5	0	0
11	36470678	.	G	A	5	2	7	0	0	7	0	0
11	36471901	.	C	T	2	1	3	0	0	3	0	0
11	36477626	.	G	A	0	4	4	0	0	4	0	0
11	36477803	.	C	T	2	3	5	0	0	5	0	0
11	36484836	.	G	A	6	2	8	0	0	8	0	0
11	36485042	.	A	G	4	0	4	0	2	6	0	0
11	36489205	.	T	C	3	5	8	0	1	9	0	0
11	36489706	.	T	C	2	4	6	0	0	6	0	0
11	36689254	.	C	T	1	2	3	0	4	7	0	0
11	36695076	.	A	G	2	2	4	0	1	5	0	0
11	36695094	.	A	G	2	3	5	0	0	5	0	0
11	36795564	.	G	T	8	9	17	0	0	17	0	0
11	36797149	.	C	T	0	1	1	0	3	4	0	0
11	36801796	.	G	A	4	0	4	0	1	5	0	0
11	36806296	.	A	G	2	6	8	0	0	8	0	0
11	36816163	.	T	C	2	6	8	0	1	9	0	0
11	36816171	.	T	C	0	8	8	0	1	9	0	0
11	36818820	.	A	T	0	4	4	0	1	5	0	0
11	36819529	.	C	T	5	1	6	0	0	6	0	0
11	36819904	.	G	A	1	3	4	0	0	4	0	0
11	36838854	.	A	C	0	1	1	0	0	1	0	0
11	36844689	.	A	G	4	0	4	0	0	4	0	0
11	36847101	.	T	C	1	2	3	0	0	3	0	0
11	36864000	.	C	T	1	1	2	0	0	2	0	0
11	36885948	.	G	A	1	1	2	0	0	2	0	0
11	37001740	.	C	T	4	3	7	0	0	7	0	0
11	37004565	.	G	A	3	1	4	0	0	4	0	0
11	37015968	.	T	C	1	2	3	0	0	3	0	0
11	37020723	.	C	T	1	0	1	0	0	1	0	0
11	37020807	.	G	T	2	1	3	0	1	4	0	0
11	37031950	.	C	T	10	8	18	0	0	18	0	0
11	37032474	.	A	G	5	3	8	0	0	8	0	0
11	37032546	.	C	T	9	3	12	0	0	12	0	0
11	37032626	.	T	C	7	8	15	0	0	15	0	0
11	37032880	.	G	T	8	3	11	0	0	11	0	0
11	37033474	.	A	G	1	4	5	0	0	5	0	0
11	37033516	.	G	A	4	6	10	0	0	10	0	0
11	37033552	.	A	G	0	0	0	0	5	5	0	0
11	37033603	.	T	A	6	4	10	0	1	11	0	0
11	37033676	.	C	T	4	9	13	0	0	13	0	0
11	37033813	.	C	G	7	5	12	0	0	12	0	0
11	37033846	.	G	C	5	8	13	0	0	13	0	0
11	37033855	.	T	A	5	8	13	0	1	14	0	0
11	37033900	.	A	T	1	6	7	0	1	8	0	0
11	37034838	.	A	G	8	2	10	0	0	10	0	0
11	37034843	.	A	G	6	4	10	0	0	10	0	0
11	37034948	.	G	A	4	2	6	0	0	6	0	0
11	37035176	.	A	T	6	5	11	0	2	13	0	0
11	37035240	.	T	A	11	4	15	0	6	21	0	0
11	37035454	.	A	G	8	1	9	0	15	24	0	0
11	37049469	.	A	T	3	5	8	0	0	8	0	0
11	37049729	.	G	A	1	2	3	0	0	3	0	0
11	37080971	.	G	T	1	2	3	0	0	3	0	0
11	37082084	.	G	A	2	2	4	0	0	4	0	0
11	37082099	.	T	C	0	2	2	0	0	2	0	0
11	37088448	.	G	A	1	1	2	0	0	2	0	0
11	37101389	.	A	G	1	0	1	0	1	2	0	0
11	37101408	.	G	A	2	2	4	0	0	4	0	0
11	37101616	.	T	A	1	2	3	0	0	3	0	0
11	37109432	.	C	T	0	1	1	0	0	1	0	0
11	37137676	.	G	T	2	6	8	0	0	8	0	0
11	37137762	.	A	T	5	4	9	0	0	9	0	0
11	37137768	.	A	G	5	3	8	0	0	8	0	0
11	37137829	.	A	T	0	2	2	0	0	2	0	0
11	37144864	.	C	T	3	7	10	0	0	10	0	0
11	37152812	.	G	C	3	2	5	0	0	5	0	0
11	37155215	.	A	G	8	0	8	0	4	12	0	0
11	37155247	.	A	T	5	5	10	0	0	10	0	0
11	37155394	.	A	G	3	10	13	0	1	14	0	0
11	37155400	.	T	A	10	4	14	0	0	14	0	0
11	37159289	.	T	A	10	12	22	0	3	25	0	0
11	37159902	.	G	A	1	1	2	0	0	2	0	0
11	37159961	.	A	T	5	5	10	0	0	10	0	0
11	37159994	.	T	A	5	0	5	0	0	5	0	0
11	37160052	.	T	A	8	7	15	0	0	15	0	0
11	37162183	.	A	G	1	1	2	0	0	2	0	0
11	37162563	.	C	A	9	9	18	0	0	18	0	0
11	37162564	.	A	T	9	9	18	0	0	18	0	0
11	37162657	.	C	A	4	4	8	1	1	10	0	0
11	37163874	.	A	G	8	8	16	0	0	16	0	0
11	37163997	.	T	A	6	5	11	0	0	11	0	0
11	37167699	.	A	T	3	13	16	0	2	18	0	0
11	37167834	.	T	C	3	0	3	0	0	3	0	0
11	37167991	.	T	C	3	6	9	0	1	10	0	0
11	37168039	.	A	T	5	10	15	0	0	15	0	0
11	37168147	.	T	C	0	2	2	0	1	3	0	0
11	37168162	.	T	A	0	2	2	0	1	3	0	0
11	37169144	.	G	A	12	12	24	0	1	25	0	0
11	37169238	.	G	A	2	12	14	0	0	14	0	0
11	37169958	.	C	T	2	2	4	0	1	5	0	0
11	37170158	.	A	T	5	3	8	0	0	8	0	0
11	37170162	.	G	C	3	4	7	0	0	7	0	0
11	37297678	.	C	T	9	17	26	1	1	28	0	0
11	37297681	.	A	G	6	19	25	1	0	28	2	0
11	37297811	.	A	T	15	25	40	0	1	41	0	0
11	37297951	.	T	C	26	19	45	0	1	46	0	0
11	37298028	.	T	A	16	5	21	0	1	22	0	0
11	37298569	.	A	G	20	20	40	0	4	44	0	0
11	37298718	.	G	A	18	12	30	0	2	32	0	0
11	37298755	.	G	A	9	20	29	0	0	29	0	0
11	37299378	.	A	T	11	16	27	0	2	29	0	0
11	37315716	.	G	C	2	0	2	0	0	2	0	0
11	37322273	.	G	T	3	5	8	0	0	8	0	0
11	37337360	.	C	T	0	3	3	0	1	4	0	0
11	37431953	.	C	T	18	21	39	0	0	39	0	0
11	37434255	.	T	G	14	11	25	0	2	27	0	0
11	37434259	.	T	G	14	13	27	0	2	29	0	0
11	37434533	.	A	G	15	16	31	0	3	34	0	0
11	37442671	.	G	A	10	15	25	0	2	27	0	0
11	37442752	.	C	G	11	13	24	0	0	24	0	0
11	37442772	.	G	T	10	14	24	0	1	25	0	0
11	37445219	.	A	G	21	11	32	0	3	35	0	0
11	37445502	.	T	C	17	0	17	0	15	32	0	0
11	37445774	.	G	A	4	7	11	0	0	11	0	0
11	37445825	.	G	A	14	7	21	0	1	22	0	0
11	37446107	.	G	A	6	5	11	0	0	11	0	0
11	37446173	.	T	A	5	8	13	0	1	14	0	0
11	37446736	.	C	G	12	12	24	0	2	26	0	0
11	37447754	.	C	T	0	7	7	0	9	16	0	0
11	37450619	.	A	C	3	5	8	0	0	8	0	0
11	37450777	.	T	C	1	2	3	0	0	3	0	0
11	37451040	.	C	T	0	3	3	0	2	5	0	0
11	37452021	.	G	A	5	5	10	0	0	10	0	0
11	37548381	.	C	T	4	5	9	0	0	9	0	0
11	37613515	.	G	A	5	15	20	0	1	21	0	0
11	37613577	.	G	A	23	13	36	0	2	38	0	0
11	37613641	.	A	G	20	20	40	0	1	41	0	0
11	37616775	.	T	C	19	13	32	0	1	33	0	0
11	37616823	.	A	G	6	4	10	0	1	11	0	0
11	37709940	.	T	A	4	2	6	0	0	6	0	0
11	37709943	.	C	A	4	2	6	0	0	6	0	0
11	37710089	.	C	T	0	6	6	0	0	6	0	0
11	37710096	.	C	T	2	3	5	0	2	7	0	0
11	37710327	.	A	G	1	4	5	0	0	5	0	0
11	37710386	.	G	C	4	0	4	0	5	9	0	0
11	37859678	.	C	A	0	2	2	0	2	4	0	0
11	37859693	.	C	A	2	3	5	0	0	5	0	0
11	38033419	.	C	T	0	3	3	0	1	4	0	0
11	38033520	.	A	G	3	6	9	0	0	9	0	0
11	38048836	.	G	A	5	4	9	0	1	10	0	0
11	38051016	.	G	A	3	4	7	0	1	8	0	0
11	38055627	.	C	T	0	2	2	0	4	6	0	0
11	38471444	.	C	T	0	2	2	0	1	3	0	0
11	38505380	.	G	A	6	9	15	0	1	16	0	0
11	38505489	.	G	A	4	5	9	0	2	11	0	0
11	38506401	.	A	T	6	5	11	0	0	11	0	0
11	38506404	.	A	T	4	6	10	0	0	10	0	0
11	38506442	.	A	T	4	4	8	0	2	10	0	0
11	38506463	.	T	C	6	6	12	0	1	13	0	0
11	38506571	.	A	C	1	4	5	0	0	5	0	0
11	38506627	.	A	T	3	3	6	0	1	7	0	0
11	38506790	.	A	T	5	7	12	0	0	12	0	0
11	38506794	.	T	C	5	7	12	0	0	12	0	0
11	38507042	.	C	T	0	5	5	0	1	6	0	0
11	38507151	.	G	A	2	3	5	0	0	5	0	0
11	38507322	.	T	C	2	5	7	0	0	7	0	0
11	38507856	.	C	T	2	3	5	0	0	5	0	0
11	38507918	.	A	G	1	5	6	0	1	7	0	0
11	38508416	.	T	C	2	2	4	0	1	5	0	0
11	38508592	.	T	C	2	3	5	0	0	5	0	0
11	38508717	.	T	C	3	0	3	0	2	5	0	0
11	38508728	.	C	T	3	2	5	0	0	5	0	0
11	38509167	.	G	A	4	7	11	0	0	11	0	0
11	38509205	.	G	A	1	6	7	0	0	7	0	0
11	38509219	.	T	C	1	4	5	0	1	6	0	0
11	38509922	.	G	A	3	4	7	0	1	8	0	0
11	38510025	.	A	G	2	4	6	0	1	7	0	0
11	38510057	.	C	T	0	4	4	0	5	9	0	0
11	38510402	.	G	A	3	2	5	0	0	5	0	0
11	38540251	.	T	A	9	3	12	0	1	13	0	0
11	38540824	.	C	T	25	16	41	0	2	43	0	0
11	38541355	.	A	G	18	19	37	0	0	37	0	0
11	38542088	.	A	T	23	11	34	0	1	35	0	0
11	38542142	.	G	A	13	21	34	0	2	36	0	0
11	38542655	.	T	C	24	1	25	1	19	45	0	0
11	38545790	.	G	C	2	0	2	0	3	5	0	0
11	38545874	.	C	G	1	22	23	0	20	43	0	0
11	38807879	.	G	A	0	2	2	0	1	3	0	0
11	38808113	.	C	T	7	7	14	0	0	14	0	0
11	38846046	.	C	T	4	10	14	0	1	15	0	0
11	38846301	.	T	G	14	0	14	0	10	24	0	0
11	38846316	.	T	A	11	11	22	0	0	22	0	0
11	38850244	.	G	A	0	6	6	0	10	16	0	0
11	38853397	.	A	T	6	7	13	0	0	13	0	0
11	38853511	.	A	G	5	3	8	0	1	9	0	0
11	38868012	.	G	T	7	8	15	0	0	15	0	0
11	38874937	.	G	A	24	13	37	0	2	39	0	0
11	38875221	.	A	G	14	15	29	0	1	30	0	0
11	38875283	.	A	T	13	22	35	0	0	35	0	0
11	38875352	.	G	A	11	17	28	0	2	30	0	0
11	38875397	.	T	G	18	6	24	0	0	24	0	0
11	38875484	.	A	C	15	13	28	0	1	29	0	0
11	38875498	.	C	A	14	12	26	0	0	26	0	0
11	38875660	.	T	C	17	17	34	0	0	34	0	0
11	38875867	.	T	C	6	9	15	0	0	15	0	0
11	38875897	.	T	C	3	4	7	0	0	7	0	0
11	38875912	.	A	G	1	4	5	0	0	5	0	0
11	38876156	.	T	A	3	3	6	0	1	7	0	0
11	39014428	.	T	C	1	0	1	0	2	3	0	0
11	39014431	.	G	T	0	2	2	0	1	3	0	0
11	39014553	.	G	A	9	17	26	0	2	28	0	0
11	39044451	.	T	A	4	10	14	0	2	16	0	0
11	39076138	.	C	T	0	5	5	0	3	8	0	0
11	39104871	.	G	A	0	2	2	0	0	2	0	0
11	39107156	.	C	T	8	1	9	0	0	9	0	0
11	39109555	.	C	T	3	1	4	0	0	4	0	0
11	39110046	.	C	T	0	1	1	0	0	1	0	0
11	39112035	.	A	G	7	8	15	0	0	15	0	0
11	39112068	.	C	T	4	6	10	0	0	10	0	0
11	39114678	.	T	C	2	2	4	0	0	4	0	0
11	39114682	.	C	T	2	2	4	0	0	4	0	0
11	39115034	.	G	A	0	2	2	0	1	3	0	0
11	39115165	.	G	T	1	2	3	0	0	3	0	0
11	39118639	.	G	A	0	2	2	0	0	2	0	0
11	39135393	.	C	T	2	1	3	0	0	3	0	0
11	39141527	.	A	G	25	22	47	0	2	49	0	0
11	39141732	.	T	G	8	15	23	0	0	23	0	0
11	39141924	.	G	T	10	11	21	0	2	23	0	0
11	39147065	.	T	C	13	15	28	0	0	28	0	0
11	39147085	.	C	T	8	15	23	0	1	24	0	0
11	39147387	.	T	C	14	11	25	0	0	25	0	0
11	39147445	.	G	C	17	15	32	0	3	36	1	0
11	39147857	.	G	C	12	12	24	0	6	31	1	0
11	39147905	.	C	A	18	13	31	0	2	33	0	0
11	39147906	.	A	T	18	14	32	0	1	33	0	0
11	39147989	.	T	C	25	14	39	0	8	47	0	0
11	39148015	.	C	T	16	17	33	0	4	37	0	0
11	39168255	.	C	G	1	2	3	0	0	3	0	0
11	39922714	.	A	C	15	16	31	1	0	32	0	0
11	40519824	.	A	T	1	3	4	0	0	4	0	0
11	40519846	.	T	A	1	2	3	0	0	3	0	0
11	40622633	.	T	A	1	1	2	0	0	2	0	0
11	40653819	.	G	A	1	3	4	0	0	4	0	0
11	40657839	.	G	A	15	9	24	0	6	30	0	0
11	40657905	.	G	A	8	12	20	0	3	23	0	0
11	40658022	.	C	T	14	24	38	0	1	39	0	0
11	40658232	.	C	T	9	10	19	0	0	19	0	0
11	40658322	.	T	G	5	5	10	0	0	10	0	0
11	40658352	.	G	A	0	10	10	0	7	17	0	0
11	40661378	.	T	C	5	6	11	0	1	12	0	0
11	40665494	.	C	T	3	1	4	0	0	4	0	0
11	40665602	.	G	T	0	12	12	0	19	31	0	0
11	40673658	.	T	G	2	6	8	0	1	9	0	0
11	40673797	.	C	T	16	11	27	0	0	27	0	0
11	40678445	.	A	C	24	1	25	0	29	54	0	0
11	40831754	.	A	G	1	0	1	0	1	2	0	0
11	40840238	.	T	C	2	1	3	0	0	3	0	0
11	40843028	.	A	G	5	10	15	0	1	16	0	0
11	40843055	.	G	T	0	7	7	0	5	12	0	0
11	40843064	.	C	A	5	5	10	0	2	12	0	0
11	40843439	.	A	G	7	1	8	0	11	19	0	0
11	40843502	.	C	T	10	10	20	0	1	21	0	0
11	40843835	.	G	A	0	7	7	0	8	15	0	0
11	40844085	.	T	G	4	2	6	0	0	6	0	0
11	40844094	.	C	T	3	2	5	0	1	6	0	0
11	40844195	.	A	T	0	9	9	0	1	10	0	0
11	40845006	.	C	T	14	15	29	0	1	30	0	0
11	40845071	.	C	T	3	3	6	0	0	6	0	0
11	40845394	.	A	T	4	3	7	0	3	10	0	0
11	40845397	.	G	T	7	1	8	0	0	8	0	0
11	41066190	.	T	G	0	0	0	0	1	1	0	0
11	41066765	.	T	G	12	13	25	0	0	25	0	0
11	41066871	.	C	T	6	17	23	0	0	23	0	0
11	41066888	.	C	T	3	20	23	0	0	23	0	0
11	41066950	.	A	G	12	18	30	0	0	30	0	0
11	41067275	.	G	A	2	12	14	0	0	14	0	0
11	41067430	.	A	T	7	5	12	0	0	12	0	0
11	41067442	.	C	T	6	6	12	0	0	12	0	0
11	41067488	.	A	C	1	8	9	0	0	9	0	0
11	41067502	.	G	A	1	9	10	0	0	10	0	0
11	41078522	.	C	A	6	6	12	0	2	14	0	0
11	41078762	.	A	T	3	3	6	0	0	6	0	0
11	41084325	.	T	G	1	0	1	0	0	1	0	0
11	41089631	.	G	T	8	8	16	0	0	16	0	0
11	41089641	.	T	C	6	9	15	0	1	16	0	0
11	41101666	.	A	G	10	5	15	0	0	15	0	0
11	41101760	.	A	T	4	3	7	0	0	7	0	0
11	41101800	.	T	A	2	6	8	0	0	8	0	0
11	41101866	.	C	T	4	2	6	0	0	6	0	0
11	41101910	.	G	A	5	3	8	0	0	8	0	0
11	41101918	.	C	T	6	4	10	0	1	11	0	0
11	41101948	.	A	G	4	1	5	0	6	11	0	0
11	41102013	.	A	G	3	0	3	0	4	7	0	0
11	41102026	.	T	C	3	3	6	0	0	6	0	0
11	41102205	.	A	G	2	0	2	0	1	3	0	0
11	41104549	.	A	G	2	6	8	0	0	8	0	0
11	41104934	.	G	A	1	7	8	0	0	8	0	0
11	41104954	.	C	T	4	8	12	0	0	12	0	0
11	41105030	.	G	A	0	6	6	0	6	12	0	0
11	41105144	.	T	G	3	0	3	0	8	11	0	0
11	41111301	.	A	G	5	10	15	0	1	16	0	0
11	41111334	.	T	C	5	10	15	0	1	16	0	0
11	41111370	.	C	T	6	8	14	0	0	14	0	0
11	41111422	.	A	G	6	7	13	0	0	13	0	0
11	41111431	.	A	C	6	4	10	0	0	10	0	0
11	41111561	.	T	A	5	6	11	0	0	11	0	0
11	41111603	.	T	A	4	2	6	0	1	7	0	0
11	41111735	.	G	A	2	8	10	0	0	10	0	0
11	41114055	.	C	T	0	5	5	0	1	6	0	0
11	41114090	.	G	T	2	8	10	0	0	10	0	0
11	41114186	.	A	C	4	4	8	0	0	8	0	0
11	41122665	.	T	C	2	0	2	0	4	6	0	0
11	41132195	.	A	G	3	1	4	0	0	4	0	0
11	41216445	.	A	C	6	3	9	0	0	9	0	0
11	41216455	.	T	C	3	0	3	0	7	10	0	0
11	41216505	.	G	C	4	9	13	0	0	13	0	0
11	41216586	.	C	T	6	4	10	0	0	10	0	0
11	41222940	.	A	G	14	12	26	0	0	26	0	0
11	41284762	.	C	T	0	1	1	0	0	1	0	0
11	41306035	.	G	A	0	4	4	0	4	8	0	0
11	41363814	.	T	C	8	4	12	0	0	12	0	0
11	41459981	.	G	C	2	2	4	0	1	5	0	0
11	41461369	.	T	C	7	4	11	0	0	11	0	0
11	41461417	.	C	G	17	12	29	0	0	29	0	0
11	41468791	.	C	T	7	3	10	0	0	10	0	0
11	41474041	.	T	A	4	12	16	0	1	17	0	0
11	41474042	.	G	T	4	13	17	0	0	17	0	0
11	41666612	.	A	C	2	2	4	0	1	5	0	0
11	41672337	.	T	C	1	4	5	0	0	5	0	0
11	41699744	.	A	C	8	16	24	0	2	26	0	0
11	41838999	.	G	T	3	4	7	0	0	7	0	0
11	41840490	.	A	G	3	0	3	0	1	4	0	0
11	41840493	.	T	C	3	3	6	0	0	6	0	0
11	41840601	.	A	T	3	4	7	0	0	7	0	0
11	41842313	.	C	T	0	6	6	0	0	6	0	0
11	41844192	.	C	A	0	1	1	0	0	1	0	0
11	41845852	.	A	T	5	4	9	0	0	9	0	0
11	41846123	.	A	C	3	0	3	0	2	5	0	0
11	41846151	.	C	A	2	3	5	0	0	5	0	0
11	41846699	.	C	T	0	1	1	0	0	1	0	0
11	41850058	.	A	G	1	3	4	0	0	4	0	0
11	41859542	.	G	A	2	2	4	0	0	4	0	0
11	42152780	.	C	T	1	0	1	0	0	1	0	0
11	42174601	.	G	A	0	2	2	0	0	2	0	0
11	42305689	.	C	T	3	4	7	0	0	7	0	0
11	42305824	.	C	T	7	3	10	0	0	10	0	0
11	42306627	.	C	T	0	6	6	0	5	11	0	0
11	42306928	.	A	T	11	8	19	0	2	21	0	0
11	42307147	.	T	A	10	17	27	0	2	29	0	0
11	42307344	.	T	G	10	10	20	0	0	20	0	0
11	42307400	.	A	T	5	12	17	0	1	18	0	0
11	42307816	.	C	T	0	10	10	0	9	19	0	0
11	42315366	.	G	C	9	11	20	0	0	20	0	0
11	42319340	.	C	T	3	11	14	0	0	14	0	0
11	42325520	.	G	A	0	1	1	0	0	1	0	0
11	42329113	.	C	T	5	8	13	0	0	13	0	0
11	42338894	.	T	C	1	0	1	0	1	2	0	0
11	42350787	.	G	A	9	11	20	0	1	21	0	0
11	42350793	.	G	A	10	12	22	0	1	23	0	0
11	42353054	.	G	A	9	8	17	0	0	17	0	0
11	42355806	.	C	T	1	3	4	0	0	4	0	0
11	42385761	.	A	T	4	0	4	0	0	4	0	0
11	42417479	.	T	G	10	9	19	0	0	19	0	0
11	42417691	.	G	A	6	4	10	0	1	11	0	0
11	42447389	.	C	T	1	2	3	0	0	3	0	0
11	42447415	.	G	T	1	2	3	0	0	3	0	0
11	42456169	.	G	A	1	1	2	0	0	2	0	0
11	42457249	.	G	A	0	2	2	0	0	2	0	0
11	42457261	.	T	C	4	2	6	0	0	6	0	0
11	42457325	.	T	C	6	4	10	0	0	10	0	0
11	42501285	.	T	C	3	4	7	0	0	7	0	0
11	42501390	.	A	G	1	0	1	0	2	3	0	0
11	42502080	.	G	A	0	2	2	0	1	3	0	0
11	42502203	.	T	C	4	2	6	0	0	6	0	0
11	42502212	.	A	G	2	6	8	0	0	8	0	0
11	42502261	.	T	C	1	3	4	0	1	5	0	0
11	42506576	.	T	A	8	7	15	0	1	16	0	0
11	42521982	.	C	G	4	4	8	0	1	9	0	0
11	42521999	.	G	A	4	6	10	0	0	10	0	0
11	42522076	.	C	A	2	4	6	0	0	6	0	0
11	42522304	.	G	A	3	2	5	0	0	5	0	0
11	42522689	.	G	C	3	3	6	0	0	6	0	0
11	42532580	.	T	C	3	4	7	0	0	7	0	0
11	42532681	.	C	T	3	3	6	0	0	6	0	0
11	42532714	.	G	A	1	3	4	0	0	4	0	0
11	42532751	.	T	A	0	4	4	0	0	4	0	0
11	42532938	.	G	A	5	4	9	0	0	9	0	0
11	42533125	.	C	T	5	8	13	0	2	15	0	0
11	42533180	.	C	G	2	3	5	0	15	20	0	0
11	42533237	.	G	A	11	7	18	0	0	18	0	0
11	42533318	.	G	A	4	3	7	0	0	7	0	0
11	42533321	.	T	G	3	3	6	0	0	6	0	0
11	42539476	.	G	A	4	9	13	0	2	15	0	0
11	42557693	.	A	G	8	11	19	0	0	19	0	0
11	42600856	.	A	T	5	3	8	0	0	8	0	0
11	42603955	.	G	T	1	0	1	0	0	1	0	0
11	42604033	.	C	T	0	1	1	0	0	1	0	0
11	42605688	.	G	C	0	1	1	0	0	1	0	0
11	42615275	.	A	C	1	5	6	0	0	6	0	0
11	42618675	.	A	G	8	0	8	0	9	17	0	0
11	42621491	.	G	A	0	4	4	0	2	6	0	0
11	42626276	.	C	T	2	4	6	0	1	7	0	0
11	42715934	.	T	C	2	3	5	0	1	6	0	0
11	42730834	.	C	G	7	8	15	0	0	15	0	0
11	42730901	.	C	T	19	11	30	0	0	30	0	0
11	42731172	.	G	T	3	2	5	0	0	5	0	0
11	42732358	.	T	C	4	5	9	0	0	9	0	0
11	42798519	.	A	G	2	0	2	0	2	4	0	0
11	42801547	.	C	T	0	2	2	0	0	2	0	0
11	42809031	.	C	G	6	10	16	0	1	17	0	0
11	42809162	.	G	A	0	4	4	0	5	9	0	0
11	42809233	.	A	G	5	4	9	0	2	11	0	0
11	42809288	.	T	C	6	4	10	0	0	10	0	0
11	42809300	.	T	C	5	2	7	0	1	8	0	0
11	42809558	.	A	G	5	4	9	0	0	9	0	0
11	42809579	.	T	G	2	4	6	0	0	6	0	0
11	42809657	.	G	T	0	3	3	0	7	10	0	0
11	42816151	.	C	T	5	5	10	0	0	10	0	0
11	42816189	.	G	A	10	3	13	0	0	13	0	0
11	42816208	.	A	T	8	4	12	0	1	13	0	0
11	42816262	.	C	G	9	0	9	0	5	14	0	0
11	42816446	.	A	G	3	9	12	1	1	14	0	0
11	42816496	.	A	G	5	2	7	0	0	7	0	0
11	42816977	.	A	T	1	3	4	0	0	4	0	0
11	42817534	.	G	A	7	5	12	0	0	12	0	0
11	42817552	.	A	G	8	6	14	0	0	14	0	0
11	42912098	.	T	C	1	4	5	0	0	5	0	0
11	42912126	.	A	G	3	2	5	0	1	6	0	0
11	42912324	.	T	C	3	2	5	0	0	5	0	0
11	42912620	.	T	C	0	2	2	0	2	4	0	0
11	42915022	.	T	A	1	2	3	0	0	3	0	0
11	42915887	.	G	A	2	2	4	0	0	4	0	0
11	42933167	.	G	A	3	4	7	0	0	7	0	0
11	42933696	.	A	G	10	5	15	0	0	15	0	0
11	42933703	.	T	C	10	4	14	0	0	14	0	0
11	42933813	.	A	G	3	5	8	0	1	9	0	0
11	42933832	.	C	T	0	2	2	0	0	2	0	0
11	42940748	.	C	T	1	1	2	0	0	2	0	0
11	42942852	.	T	C	2	4	6	0	0	6	0	0
11	42942930	.	G	A	3	6	9	0	0	9	0	0
11	42947471	.	A	G	4	2	6	0	1	7	0	0
11	42947480	.	G	A	3	4	7	0	1	8	0	0
11	42949086	.	T	C	3	0	3	0	4	7	0	0
11	42949819	.	G	A	4	4	8	0	0	8	0	0
11	42949828	.	T	G	3	3	6	0	1	7	0	0
11	42954479	.	G	A	1	1	2	0	0	2	0	0
11	42956694	.	A	G	1	5	6	0	0	6	0	0
11	42958993	.	A	G	3	0	3	0	0	3	0	0
11	42971336	.	A	G	2	3	5	0	0	5	0	0
11	42971408	.	A	C	1	0	1	0	2	3	0	0
11	42975395	.	A	T	0	3	3	0	1	4	0	0
11	42975432	.	C	G	0	2	2	0	0	2	0	0
11	42982982	.	A	G	1	1	2	0	0	2	0	0
11	43045604	.	G	A	6	8	14	0	0	14	0	0
11	43137659	.	C	T	23	31	54	0	0	55	1	0
11	43151260	.	C	T	18	24	42	0	2	44	0	0
11	43159295	.	T	C	27	0	27	0	25	52	0	0
11	43167677	.	A	T	5	9	14	0	0	14	0	0
11	43170699	.	A	G	26	17	43	0	0	43	0	0
11	43170792	.	A	T	19	27	46	0	1	47	0	0
11	43170992	.	G	T	16	24	40	0	0	40	0	0
11	43171263	.	G	A	11	11	22	0	2	24	0	0
11	43171314	.	A	G	14	13	27	0	2	29	0	0
11	43178811	.	T	A	3	7	10	0	0	10	0	0
11	43178823	.	G	A	4	10	14	0	0	14	0	0
11	43178958	.	C	T	13	10	23	0	2	25	0	0
11	43178991	.	G	A	16	7	23	0	3	26	0	0
11	43179006	.	G	C	16	7	23	0	5	28	0	0
11	43179248	.	T	G	11	13	24	0	0	24	0	0
11	43187495	.	T	C	13	11	24	0	5	29	0	0
11	43189115	.	G	A	5	8	13	0	0	13	0	0
11	43189118	.	G	A	4	7	11	0	1	12	0	0
11	43189275	.	T	G	8	8	16	0	1	17	0	0
11	43200419	.	T	A	9	16	25	0	0	25	0	0
11	43387641	.	G	A	2	4	6	0	0	6	0	0
11	43411231	.	C	T	3	8	11	0	0	11	0	0
11	43470332	.	T	C	4	4	8	0	0	8	0	0
11	43470473	.	T	A	5	3	8	0	1	9	0	0
11	43470619	.	C	T	1	4	5	0	0	5	0	0
11	43470740	.	C	T	0	2	2	0	5	7	0	0
11	43470803	.	G	C	3	3	6	0	1	7	0	0
11	43713102	.	A	G	2	0	2	0	2	4	0	0
11	44019868	.	A	G	5	6	11	0	0	11	0	0
11	44021999	.	T	G	4	4	8	0	0	8	0	0
11	44024006	.	C	T	0	0	0	0	1	1	0	0
11	44144928	.	G	A	19	27	46	0	2	48	0	0
11	44144958	.	T	G	17	28	45	0	4	49	0	0
11	44148453	.	A	G	24	19	43	0	2	45	0	0
11	44152579	.	C	T	19	14	33	0	2	35	0	0
11	44152693	.	T	G	25	19	44	0	6	50	0	0
11	44152795	.	T	C	25	25	50	0	4	54	0	0
11	44153038	.	G	A	11	4	15	0	0	15	0	0
11	44155422	.	G	A	3	0	3	0	0	3	0	0
11	44155479	.	T	C	3	0	3	0	0	3	0	0
11	44155485	.	T	C	2	0	2	0	1	3	0	0
11	44155706	.	C	T	0	12	12	0	9	21	0	0
11	44157752	.	G	A	12	10	22	1	1	24	0	0
11	44159320	.	G	C	4	1	5	0	0	5	0	0
11	44163064	.	G	T	2	9	11	0	1	12	0	0
11	44180838	.	G	A	2	2	4	0	0	4	0	0
11	44183196	.	A	C	1	2	3	0	0	3	0	0
11	44183247	.	T	G	2	2	4	0	0	4	0	0
11	44185796	.	T	C	1	2	3	0	0	3	0	0
11	44188436	.	G	A	1	2	3	0	0	3	0	0
11	44189775	.	G	A	0	2	2	0	1	3	0	0
11	44189787	.	C	T	1	2	3	0	0	3	0	0
11	44190253	.	T	C	2	2	4	0	0	4	0	0
11	44226545	.	G	T	0	11	11	0	6	17	0	0
11	44244880	.	T	C	3	2	5	0	0	5	0	0
11	44304360	.	G	A	0	11	11	0	12	23	0	0
11	44329208	.	G	A	0	1	1	0	0	1	0	0
11	44334915	.	C	T	14	18	32	0	3	35	0	0
11	44337497	.	A	G	4	3	7	0	0	7	0	0
11	44356772	.	T	A	1	8	9	0	1	10	0	0
11	44356791	.	A	G	1	9	10	0	0	10	0	0
11	44358904	.	C	T	14	2	16	0	2	18	0	0
11	44442425	.	C	T	4	3	7	0	0	7	0	0
11	44444661	.	C	G	4	3	7	0	0	7	0	0
11	44445095	.	T	A	7	5	12	0	1	13	0	0
11	44445655	.	A	G	6	2	8	0	1	10	1	0
11	44445678	.	C	A	6	2	8	0	2	10	0	0
11	44445778	.	C	T	7	10	17	0	0	17	0	0
11	44445828	.	T	C	4	8	12	0	0	12	0	0
11	44452732	.	T	C	7	8	15	0	0	15	0	0
11	44452790	.	T	C	7	0	7	0	7	14	0	0
11	44452797	.	C	T	0	7	7	0	7	14	0	0
11	44452886	.	A	G	6	13	19	0	0	19	0	0
11	44455901	.	C	T	5	14	19	0	0	19	0	0
11	44457239	.	G	A	13	10	23	0	0	23	0	0
11	44457254	.	A	G	10	7	17	0	1	18	0	0
11	44461386	.	G	C	7	9	16	0	0	16	0	0
11	44461458	.	G	A	11	14	25	0	1	26	0	0
11	44468838	.	G	A	2	4	6	0	1	7	0	0
11	44468842	.	T	C	2	5	7	0	0	7	0	0
11	44478403	.	T	C	1	1	2	0	0	2	0	0
11	44481079	.	A	C	1	0	1	0	2	3	0	0
11	44502660	.	C	T	2	6	8	0	0	8	0	0
11	44522002	.	C	G	7	5	12	0	0	12	0	0
11	44522119	.	C	T	3	4	7	0	1	8	0	0
11	44522158	.	G	T	0	6	6	0	0	6	0	0
11	44522835	.	T	C	0	2	2	0	0	2	0	0
11	44522995	.	A	G	3	1	4	0	0	4	0	0
11	44523385	.	C	A	7	4	11	0	0	11	0	0
11	44523420	.	C	A	12	6	18	0	0	18	0	0
11	44524164	.	A	G	3	0	3	0	5	8	0	0
11	44524391	.	G	A	8	3	11	0	0	11	0	0
11	44524423	.	T	G	3	8	11	0	0	11	0	0
11	44524448	.	G	A	0	2	2	0	6	8	0	0
11	44524583	.	T	C	4	4	8	0	0	8	0	0
11	44524631	.	T	C	5	3	8	0	1	9	0	0
11	44524673	.	T	C	9	4	13	0	1	14	0	0
11	44524834	.	G	T	0	11	11	0	9	20	0	0
11	44527053	.	G	A	6	3	9	0	1	10	0	0
11	44527087	.	G	T	7	9	16	0	2	18	0	0
11	44527115	.	T	A	12	10	22	0	0	22	0	0
11	44527134	.	G	C	11	16	27	0	0	27	0	0
11	44527183	.	T	C	18	1	19	0	10	29	0	0
11	44527367	.	G	A	21	13	34	0	0	34	0	0
11	44527744	.	G	A	16	14	30	0	1	31	0	0
11	44527773	.	G	C	21	0	21	0	10	31	0	0
11	44528307	.	C	T	16	9	25	0	1	26	0	0
11	44528311	.	C	T	0	10	10	0	16	26	0	0
11	44528351	.	A	C	10	8	18	0	0	18	0	0
11	44528405	.	G	A	13	9	22	0	0	22	0	0
11	44528481	.	A	G	17	24	41	0	0	41	0	0
11	44528539	.	A	G	5	9	14	0	1	15	0	0
11	44528694	.	A	G	9	9	18	0	0	18	0	0
11	44528877	.	A	T	13	15	28	0	1	29	0	0
11	44528927	.	G	T	19	4	23	0	0	23	0	0
11	44529149	.	G	A	5	5	10	0	0	10	0	0
11	44529193	.	T	C	3	8	11	0	0	11	0	0
11	44529195	.	T	A	8	3	11	0	0	11	0	0
11	44529719	.	G	A	21	20	41	0	0	41	0	0
11	44530262	.	T	C	5	0	5	0	6	11	0	0
11	44533253	.	T	C	0	0	0	0	2	2	0	0
11	44542958	.	T	A	9	5	14	0	1	15	0	0
11	44606732	.	T	C	2	2	4	0	0	4	0	0
11	44606861	.	C	T	2	8	10	0	0	10	0	0
11	44606883	.	G	C	1	4	5	0	0	5	0	0
11	44606908	.	T	G	0	1	1	0	0	1	0	0
11	44607291	.	T	A	11	7	18	0	2	21	1	0
11	44607303	.	A	T	9	10	19	0	1	20	0	0
11	44622514	.	A	T	3	1	4	0	0	4	0	0
11	44622516	.	G	A	3	1	4	0	0	4	0	0
11	44622565	.	G	A	2	6	8	0	0	8	0	0
11	44622594	.	C	T	2	2	4	0	0	4	0	0
11	44624714	.	C	T	7	4	11	0	0	11	0	0
11	44624723	.	A	C	4	6	10	0	1	11	0	0
11	44632351	.	A	G	0	1	1	0	0	1	0	0
11	44634802	.	A	C	4	7	11	0	0	11	0	0
11	44634828	.	C	A	2	7	9	0	0	9	0	0
11	44634965	.	G	A	1	4	5	0	0	5	0	0
11	44637569	.	T	A	5	8	13	0	0	13	0	0
11	44637704	.	C	T	0	13	13	0	18	31	0	0
11	44637714	.	T	C	16	2	18	0	15	33	0	0
11	44637802	.	G	A	12	18	30	0	1	31	0	0
11	44637950	.	A	G	28	16	44	0	1	45	0	0
11	44637953	.	G	T	16	27	43	0	1	44	0	0
11	44638006	.	G	A	1	5	6	0	1	7	0	0
11	44643882	.	C	T	6	3	9	0	0	9	0	0
11	44723130	.	C	G	16	14	30	0	0	30	0	0
11	44723353	.	G	A	1	15	16	0	22	38	0	0
11	44723500	.	C	T	15	21	36	0	0	36	0	0
11	44723746	.	A	G	21	12	33	0	7	40	0	0
11	44725376	.	C	T	20	22	42	0	2	44	0	0
11	44726119	.	C	T	13	17	30	0	5	35	0	0
11	44805464	.	G	C	1	7	8	0	8	16	0	0
11	44834268	.	G	A	0	1	1	0	0	1	0	0
11	44836755	.	A	G	3	0	3	0	2	5	0	0
11	44843706	.	A	G	1	0	1	0	3	4	0	0
11	44848876	.	A	T	1	0	1	0	0	1	0	0
11	44852627	.	C	G	3	5	8	1	0	9	0	0
11	44852756	.	A	T	4	4	8	0	1	9	0	0
11	44852901	.	G	A	3	2	5	0	0	5	0	0
11	44852988	.	T	A	1	3	4	0	0	4	0	0
11	44853044	.	A	G	2	6	8	0	0	8	0	0
11	44853073	.	A	T	3	8	11	0	0	11	0	0
11	44853115	.	A	T	6	6	12	0	0	12	0	0
11	44853282	.	T	C	5	6	11	0	0	11	0	0
11	44853325	.	T	C	3	5	8	0	0	8	0	0
11	44853670	.	C	T	5	2	7	0	0	7	0	0
11	44853761	.	A	T	4	2	6	0	0	6	0	0
11	44854631	.	C	T	8	3	11	0	2	13	0	0
11	44854636	.	G	T	8	3	11	0	2	13	0	0
11	44854692	.	A	C	4	6	10	0	1	11	0	0
11	44854735	.	A	G	2	0	2	0	7	9	0	0
11	44854787	.	T	G	1	8	9	0	0	9	0	0
11	44854847	.	A	G	8	10	18	0	0	18	0	0
11	44854850	.	T	C	9	11	20	0	0	20	0	0
11	44854996	.	T	C	16	12	28	0	1	29	0	0
11	44855027	.	G	A	0	16	16	0	13	29	0	0
11	44855182	.	G	A	4	6	10	0	0	10	0	0
11	44880288	.	A	G	13	14	27	0	0	27	0	0
11	44880291	.	T	A	13	13	26	0	0	27	1	0
11	44880332	.	G	A	11	10	21	0	0	21	0	0
11	44880345	.	C	G	5	9	14	0	0	14	0	0
11	44887200	.	G	A	20	9	29	0	3	32	0	0
11	44887224	.	T	C	8	0	8	0	17	25	0	0
11	44887612	.	G	T	19	15	34	0	1	35	0	0
11	44891507	.	G	A	1	3	4	0	1	5	0	0
11	44892859	.	T	A	1	1	2	0	0	2	0	0
11	44892883	.	G	A	6	3	9	0	0	9	0	0
11	44892943	.	G	A	12	5	17	0	0	17	0	0
11	44892979	.	T	A	5	1	6	0	0	6	0	0
11	44894409	.	T	C	0	0	0	0	1	1	0	0
11	44897584	.	C	T	11	15	26	0	1	27	0	0
11	44897647	.	A	C	11	10	21	0	1	22	0	0
11	44901315	.	C	T	0	7	7	0	11	18	0	0
11	44901373	.	C	A	23	33	56	0	6	62	0	0
11	44910758	.	T	G	4	0	4	0	0	4	0	0
11	44912485	.	C	A	0	2	2	0	1	3	0	0
11	44913176	.	C	A	0	4	4	0	6	10	0	0
11	44914943	.	G	C	7	7	14	0	2	16	0	0
11	44927159	.	C	A	3	5	8	0	1	9	0	0
11	44927833	.	G	T	2	2	4	0	0	4	0	0
11	44935861	.	G	C	6	10	16	0	0	16	0	0
11	44953813	.	A	T	3	8	11	0	2	13	0	0
11	44954090	.	G	A	10	12	22	0	0	22	0	0
11	44960620	.	G	A	3	2	5	0	0	5	0	0
11	45112699	.	C	A	0	1	1	0	0	1	0	0
11	45120863	.	G	A	0	4	4	0	3	7	0	0
11	45122701	.	C	T	2	4	6	0	0	6	0	0
11	45123979	.	A	C	1	0	1	0	0	1	0	0
11	45125829	.	C	T	7	3	10	0	0	10	0	0
11	45125831	.	A	T	7	3	10	0	0	10	0	0
11	45126658	.	C	T	0	8	8	0	14	22	0	0
11	45126772	.	G	A	2	4	6	0	0	6	0	0
11	45126913	.	A	T	4	4	8	0	0	8	0	0
11	45127266	.	A	G	5	7	12	0	0	12	0	0
11	45127329	.	G	A	7	6	13	0	1	14	0	0
11	45127352	.	C	G	5	7	12	0	0	12	0	0
11	45129347	.	C	A	3	7	10	0	0	10	0	0
11	45130874	.	C	A	0	4	4	0	3	7	0	0
11	45130909	.	G	A	4	3	7	0	0	7	0	0
11	45138768	.	C	A	0	5	5	0	5	10	0	0
11	45140001	.	A	T	5	3	8	0	1	9	0	0
11	45141271	.	G	A	3	3	6	0	1	7	0	0
11	45143405	.	T	C	1	0	1	0	0	1	0	0
11	45143417	.	G	T	1	1	2	0	0	2	0	0
11	45161336	.	C	T	4	2	6	0	0	6	0	0
11	45161381	.	A	T	4	4	8	0	0	8	0	0
11	45161844	.	C	T	2	3	5	0	0	5	0	0
11	45162241	.	A	T	14	8	22	0	1	23	0	0
11	45171184	.	G	C	4	4	8	0	1	9	0	0
11	45227084	.	G	T	0	2	2	0	2	4	0	0
11	45227128	.	T	C	1	1	2	0	0	2	0	0
11	45243089	.	A	C	0	2	2	0	0	2	0	0
11	45243092	.	A	C	0	1	1	0	1	2	0	0
11	45245913	.	A	G	1	3	4	0	0	4	0	0
11	45262178	.	C	T	7	9	16	0	1	17	0	0
11	45262186	.	G	A	2	6	8	0	9	17	0	0
11	45262342	.	C	T	9	11	20	0	0	20	0	0
11	45265859	.	G	C	4	2	6	0	0	6	0	0
11	45265898	.	C	T	5	4	9	0	0	9	0	0
11	45290839	.	A	G	3	0	3	0	2	5	0	0
11	45290869	.	C	T	3	5	8	0	1	9	0	0
11	45290884	.	C	A	4	9	13	0	0	13	0	0
11	45290989	.	A	C	2	2	4	0	0	4	0	0
11	45291944	.	G	A	1	3	4	0	0	4	0	0
11	45294389	.	C	T	5	15	20	0	2	22	0	0
11	45294489	.	C	T	14	12	26	0	1	27	0	0
11	45294493	.	C	T	14	12	26	0	0	26	0	0
11	45326756	.	A	G	0	2	2	0	0	2	0	0
11	45327983	.	G	A	0	6	6	0	5	11	0	0
11	45328001	.	C	T	3	6	9	0	0	9	0	0
11	45328166	.	C	T	3	6	9	0	0	9	0	0
11	45328494	.	T	C	2	2	4	0	0	4	0	0
11	45342757	.	A	G	4	3	7	0	0	7	0	0
11	45342823	.	G	A	7	4	11	0	2	13	0	0
11	45342891	.	C	T	2	5	7	0	0	7	0	0
11	45343176	.	G	C	1	4	5	0	0	5	0	0
11	45343389	.	G	A	7	6	13	0	0	13	0	0
11	45343492	.	G	A	0	6	6	0	4	10	0	0
11	45348490	.	G	A	0	1	1	0	2	3	0	0
11	45355011	.	C	T	0	5	5	0	10	15	0	0
11	45355022	.	C	G	10	8	18	0	0	18	0	0
11	45355436	.	C	G	7	19	26	0	3	29	0	0
11	45355606	.	G	C	9	11	20	0	2	22	0	0
11	45356114	.	G	A	4	10	14	0	3	17	0	0
11	45356296	.	C	T	0	1	1	0	5	8	2	0
11	45356666	.	A	G	6	2	8	0	0	8	0	0
11	45359173	.	G	A	2	3	5	0	0	5	0	0
11	45359923	.	A	G	9	6	15	0	1	16	0	0
11	45359980	.	G	A	4	3	7	0	0	7	0	0
11	45362324	.	T	C	1	1	2	0	0	2	0	0
11	45362862	.	T	C	0	2	2	0	0	2	0	0
11	45366720	.	C	T	6	7	13	0	0	13	0	0
11	45366754	.	T	C	5	0	5	0	5	10	0	0
11	45366798	.	T	A	1	3	4	0	0	4	0	0
11	45370259	.	G	A	9	7	16	0	1	17	0	0
11	45370529	.	G	A	1	1	2	0	0	2	0	0
11	45371438	.	A	C	3	0	3	0	3	6	0	0
11	45371444	.	G	A	3	2	5	0	0	6	1	0
11	45371474	.	C	A	3	1	4	0	0	4	0	0
11	45371831	.	A	G	1	1	2	0	0	2	0	0
11	45371868	.	A	G	2	3	5	0	0	5	0	0
11	45372123	.	C	T	0	6	6	0	3	9	0	0
11	45375266	.	G	T	1	3	4	0	0	4	0	0
11	45388197	.	G	A	1	2	3	0	0	3	0	0
11	45389505	.	T	C	1	4	5	0	0	5	0	0
11	45389599	.	C	G	2	2	4	0	0	4	0	0
11	45389961	.	A	T	5	6	11	0	0	11	0	0
11	45389981	.	G	A	6	10	16	0	1	17	0	0
11	45390057	.	G	A	3	9	12	0	0	12	0	0
11	45391400	.	C	T	5	4	9	0	1	10	0	0
11	45391430	.	G	T	5	5	10	0	0	10	0	0
11	45391725	.	A	G	7	3	10	0	0	10	0	0
11	45391727	.	T	C	7	3	10	0	0	10	0	0
11	45391788	.	C	T	6	8	14	0	0	14	0	0
11	45393395	.	C	T	7	17	24	0	0	24	0	0
11	45393468	.	G	T	26	26	52	0	2	54	0	0
11	45393520	.	A	C	3	4	7	0	12	19	0	0
11	45397372	.	C	T	17	13	30	0	0	30	0	0
11	45399389	.	A	G	12	11	23	0	0	23	0	0
11	45399491	.	C	T	19	31	50	0	1	51	0	0
11	45399589	.	A	G	26	23	49	0	1	50	0	0
11	45402861	.	G	A	20	11	31	0	0	31	0	0
11	45403209	.	A	T	13	13	26	0	3	29	0	0
11	45403712	.	G	A	12	18	30	0	0	30	0	0
11	45403782	.	T	C	16	2	18	0	14	32	0	0
11	45403866	.	G	A	20	12	32	0	0	32	0	0
11	45403914	.	C	T	0	2	2	0	1	3	0	0
11	45410613	.	A	G	7	4	11	0	1	12	0	0
11	45412505	.	C	T	1	4	5	0	7	12	0	0
11	45425460	.	C	G	2	2	4	0	0	4	0	0
11	45434981	.	G	T	3	2	5	0	0	5	0	0
11	45439842	.	G	A	0	0	0	0	1	1	0	0
11	45439858	.	C	A	1	1	2	0	0	2	0	0
11	45448277	.	G	A	0	0	0	0	3	3	0	0
11	45448289	.	C	T	3	0	3	0	0	3	0	0
11	45452786	.	G	A	0	1	1	0	3	4	0	0
11	45454748	.	C	A	5	3	8	0	0	8	0	0
11	45460337	.	G	A	6	5	11	0	1	12	0	0
11	45461318	.	G	A	1	11	12	0	17	29	0	0
11	45461498	.	G	A	0	4	4	0	3	7	0	0
11	45463352	.	T	C	4	4	8	0	0	8	0	0
11	45463490	.	G	T	0	11	11	0	18	29	0	0
11	45464817	.	T	G	10	4	14	0	0	14	0	0
11	45464880	.	C	T	9	8	17	0	0	17	0	0
11	45465080	.	T	A	9	10	19	0	0	19	0	0
11	45468899	.	C	T	2	1	3	0	2	5	0	0
11	45468906	.	T	A	2	4	6	0	0	6	0	0
11	45469020	.	G	A	5	0	5	0	0	5	0	0
11	45469074	.	T	C	1	3	4	0	0	4	0	0
11	45469739	.	G	A	4	3	7	0	3	10	0	0
11	45469766	.	A	G	4	3	7	0	0	7	0	0
11	45469829	.	C	T	1	2	3	0	1	4	0	0
11	45469969	.	C	T	0	2	2	0	0	2	0	0
11	45470010	.	G	A	2	8	10	0	2	12	0	0
11	45470243	.	C	T	3	8	11	0	8	19	0	0
11	45470277	.	C	T	5	8	13	0	6	19	0	0
11	45470279	.	C	A	2	11	13	0	6	19	0	0
12	465732	.	G	A	0	11	11	0	12	23	0	0
12	466174	.	T	A	2	6	8	0	0	8	0	0
12	466221	.	G	C	10	9	19	0	0	19	0	0
12	497201	.	C	T	10	13	23	0	0	23	0	0
12	499855	.	C	T	7	3	10	0	0	10	0	0
12	499865	.	C	T	6	3	9	0	1	10	0	0
12	502221	.	C	T	10	4	14	0	0	14	0	0
12	503308	.	G	A	15	15	30	0	1	31	0	0
12	516845	.	C	T	4	0	4	0	0	4	0	0
12	518107	.	T	C	1	3	4	0	0	4	0	0
12	527402	.	A	C	20	15	35	0	1	36	0	0
12	527693	.	T	G	12	19	31	0	0	31	0	0
12	527712	.	T	C	11	13	24	0	1	25	0	0
12	532019	.	C	G	1	2	3	0	1	4	0	0
12	533607	.	T	C	4	2	6	0	0	6	0	0
12	534078	.	G	A	0	3	3	0	2	5	0	0
12	534090	.	T	G	2	3	5	0	0	5	0	0
12	534252	.	A	T	1	2	3	0	0	3	0	0
12	534258	.	C	G	1	3	4	0	0	4	0	0
12	534642	.	C	T	0	4	4	0	0	4	0	0
12	534927	.	T	C	1	4	5	0	0	5	0	0
12	536596	.	A	G	0	0	0	0	2	2	0	0
12	540021	.	G	C	0	2	2	0	0	2	0	0
12	540155	.	A	C	3	2	5	0	0	5	0	0
12	540156	.	G	A	3	2	5	0	0	5	0	0
12	549605	.	T	C	9	0	9	0	5	14	0	0
12	550387	.	G	T	11	18	29	0	0	29	0	0
12	550513	.	T	A	14	10	24	0	0	24	0	0
12	550516	.	C	T	1	9	10	0	14	24	0	0
12	550973	.	T	C	9	15	24	0	1	25	0	0
12	550985	.	T	C	10	2	12	0	12	24	0	0
12	551098	.	A	G	20	12	32	0	2	34	0	0
12	551192	.	A	G	18	7	25	0	0	25	0	0
12	551372	.	C	T	12	14	26	0	1	27	0	0
12	551398	.	C	T	10	13	23	0	1	24	0	0
12	551549	.	T	C	1	0	1	0	4	5	0	0
12	551892	.	T	C	18	0	18	0	20	38	0	0
12	551927	.	A	G	11	15	26	0	0	26	0	0
12	554210	.	T	C	12	0	12	0	13	25	0	0
12	558142	.	A	C	12	11	23	0	0	23	0	0
12	560710	.	G	T	1	3	4	0	0	4	0	0
12	561131	.	G	T	2	2	4	0	0	4	0	0
12	562200	.	C	T	3	5	8	0	0	8	0	0
12	562203	.	C	T	0	4	4	0	3	7	0	0
12	564552	.	C	T	0	6	6	0	4	10	0	0
12	564553	.	G	A	4	6	10	0	0	10	0	0
12	564650	.	G	T	4	4	8	0	2	10	0	0
12	565571	.	C	G	3	4	7	0	0	7	0	0
12	568872	.	G	A	2	0	2	0	0	2	0	0
12	577838	.	A	C	2	3	5	0	0	5	0	0
12	582786	.	G	A	0	1	1	0	0	1	0	0
12	582795	.	G	A	0	1	1	0	0	1	0	0
12	600798	.	A	G	1	2	3	0	0	3	0	0
12	618522	.	G	T	1	3	4	0	0	4	0	0
12	618537	.	G	C	1	3	4	0	0	4	0	0
12	618585	.	G	A	1	2	3	0	0	3	0	0
12	630495	.	G	A	2	4	6	0	0	6	0	0
12	634241	.	A	G	1	0	1	0	0	1	0	0
12	634292	.	C	T	0	2	2	0	3	5	0	0
12	763635	.	C	T	3	2	5	0	0	5	0	0
12	770274	.	C	T	3	2	5	0	0	5	0	0
12	782731	.	A	G	1	0	1	0	1	2	0	0
12	847787	.	T	C	11	22	33	0	0	33	0	0
12	848846	.	T	C	22	0	22	0	20	42	0	0
12	850303	.	T	C	4	2	6	0	1	7	0	0
12	906722	.	A	G	5	1	6	0	1	7	0	0
12	910704	.	T	C	1	0	1	0	1	2	0	0
12	911042	.	C	T	0	4	4	0	2	6	0	0
12	911162	.	G	C	5	12	17	0	1	18	0	0
12	911180	.	A	C	4	7	11	0	0	11	0	0
12	912274	.	G	C	2	4	6	0	0	6	0	0
12	931371	.	G	A	3	1	4	0	0	4	0	0
12	931410	.	C	A	0	1	1	0	3	4	0	0
12	932092	.	G	T	9	5	14	0	0	14	0	0
12	943314	.	C	T	0	2	2	0	1	3	0	0
12	964877	.	T	C	16	0	16	0	21	37	0	0
12	964888	.	T	G	15	18	33	0	1	34	0	0
12	972975	.	C	T	0	7	7	0	8	15	0	0
12	976154	.	C	G	0	4	4	0	1	5	0	0
12	979718	.	G	A	2	5	7	0	0	7	0	0
12	982979	.	T	A	6	6	12	0	2	14	0	0
12	983074	.	C	T	7	3	10	0	1	11	0	0
12	983176	.	T	A	6	10	16	0	1	17	0	0
12	983222	.	G	A	2	7	9	0	1	10	0	0
12	983340	.	C	T	6	8	14	0	1	15	0	0
12	986834	.	A	G	0	1	1	0	0	1	0	0
12	989974	.	G	C	4	4	8	0	0	8	0	0
12	992615	.	C	T	1	2	3	0	0	3	0	0
12	993237	.	C	G	2	6	8	0	1	9	0	0
12	997320	.	G	A	3	1	4	0	1	5	0	0
12	997909	.	A	G	0	4	4	0	0	4	0	0
12	997917	.	G	A	0	1	1	0	2	3	0	0
12	999517	.	T	C	1	0	1	0	5	6	0	0
12	999579	.	C	G	1	2	3	0	0	3	0	0
12	1014553	.	C	T	0	12	12	0	3	15	0	0
12	1014668	.	A	G	3	6	9	0	1	10	0	0
12	1015197	.	C	T	0	13	13	0	6	19	0	0
12	1015845	.	G	A	3	10	13	0	1	14	0	0
12	1019123	.	C	T	0	5	5	0	4	9	0	0
12	1019243	.	G	T	2	9	11	0	0	11	0	0
12	1019311	.	C	G	2	3	5	0	1	6	0	0
12	1021152	.	G	A	2	5	7	0	0	7	0	0
12	1030048	.	A	G	1	4	5	0	0	5	0	0
12	1404058	.	A	C	1	2	3	0	0	3	0	0
12	1406346	.	C	G	0	2	2	0	2	4	0	0
12	1556396	.	G	A	3	3	6	0	0	6	0	0
12	1556963	.	T	A	2	3	5	0	0	5	0	0
12	1557014	.	G	A	2	3	5	0	0	5	0	0
12	1557164	.	A	C	2	1	3	0	2	5	0	0
12	1947751	.	T	C	4	2	6	0	0	6	0	0
12	1950141	.	C	A	1	2	3	0	0	3	0	0
12	2457411	.	G	A	1	3	4	0	0	4	0	0
12	2457441	.	A	T	0	4	4	0	1	5	0	0
12	2488542	.	C	G	2	4	6	0	0	6	0	0
12	2488770	.	C	T	2	4	6	0	0	6	0	0
12	2488808	.	C	T	4	4	8	0	0	8	0	0
12	2488815	.	T	C	3	4	7	0	1	8	0	0
12	2488938	.	G	A	0	2	2	0	0	2	0	0
12	2492299	.	A	G	3	4	7	0	0	7	0	0
12	2492423	.	G	T	0	7	7	0	5	12	0	0
12	2505557	.	T	G	10	12	22	0	0	22	0	0
12	2505614	.	G	A	14	9	23	0	2	25	0	0
12	2505921	.	G	C	12	0	12	0	16	29	1	0
12	2507295	.	G	A	1	0	1	0	0	1	0	0
12	2507988	.	T	C	2	0	2	0	1	3	0	0
12	2508051	.	T	C	2	0	2	0	6	8	0	0
12	2509851	.	C	G	2	2	4	0	0	4	0	0
12	2514434	.	G	T	2	4	6	0	0	6	0	0
12	2516187	.	T	C	1	0	1	0	1	2	0	0
12	2518125	.	T	C	4	0	4	0	4	8	0	0
12	2743808	.	A	G	1	2	3	0	1	4	0	0
12	2743988	.	A	C	7	4	11	0	0	11	0	0
12	2744291	.	A	T	1	2	3	0	0	3	0	0
12	2833488	.	C	A	2	0	2	0	0	2	0	0
12	2843700	.	C	G	1	1	2	0	2	4	0	0
12	2846146	.	G	T	0	1	1	0	0	1	0	0
12	2846215	.	G	A	3	2	5	0	0	5	0	0
12	2848162	.	C	T	6	6	12	0	0	12	0	0
12	2849908	.	G	A	0	2	2	0	1	3	0	0
12	2849970	.	A	G	4	8	12	0	1	13	0	0
12	2850096	.	C	T	6	3	9	0	0	9	0	0
12	2850623	.	G	A	2	4	6	0	0	6	0	0
12	2850637	.	G	A	6	4	10	0	0	10	0	0
12	2850816	.	T	C	2	0	2	0	7	9	0	0
12	2851355	.	C	T	2	0	2	0	0	2	0	0
12	2856901	.	G	C	4	2	6	0	0	6	0	0
12	2869468	.	T	G	2	2	4	0	0	4	0	0
12	2869479	.	T	C	2	3	5	0	0	5	0	0
12	2870708	.	G	A	2	1	3	0	0	3	0	0
12	2870733	.	G	A	0	1	1	0	2	3	0	0
12	2893006	.	G	A	0	1	1	0	4	5	0	0
12	2895248	.	T	C	11	5	16	0	0	16	0	0
12	2895264	.	G	T	0	10	10	0	8	18	0	0
12	2895344	.	G	A	0	7	7	0	4	11	0	0
12	2895389	.	T	G	4	4	8	0	0	8	0	0
12	2895463	.	A	G	5	4	9	0	0	9	0	0
12	2895716	.	C	T	5	3	8	0	0	8	0	0
12	2993535	.	A	G	2	0	2	0	0	2	0	0
12	2993557	.	A	C	2	0	2	0	0	2	0	0
12	2995996	.	G	T	1	2	3	0	0	3	0	0
12	3001893	.	A	C	1	0	1	0	0	1	0	0
12	3003904	.	T	C	1	2	3	0	0	3	0	0
12	3016783	.	T	C	1	3	4	0	0	4	0	0
12	3019634	.	T	C	1	3	4	0	0	4	0	0
12	3019788	.	T	C	2	2	4	0	0	4	0	0
12	3022947	.	C	A	19	22	41	0	2	43	0	0
12	3033357	.	T	C	17	16	33	0	1	34	0	0
12	3033360	.	A	C	18	17	35	0	0	35	0	0
12	3038920	.	G	A	2	27	29	0	17	46	0	0
12	3038929	.	A	G	26	2	28	0	17	45	0	0
12	3039078	.	G	C	1	17	18	0	28	46	0	0
12	3039210	.	C	T	19	19	38	0	2	40	0	0
12	3039283	.	T	A	9	17	26	0	0	26	0	0
12	3039311	.	T	C	10	15	25	0	0	25	0	0
12	3039321	.	A	G	9	13	22	0	0	22	0	0
12	3039423	.	G	A	0	9	9	0	16	25	0	0
12	3039522	.	T	C	8	25	33	0	3	36	0	0
12	3039652	.	T	C	23	33	56	0	0	56	0	0
12	3039682	.	A	C	27	17	44	0	0	44	0	0
12	3039738	.	A	T	7	13	20	0	1	21	0	0
12	3039940	.	A	G	19	17	36	0	3	39	0	0
12	3040158	.	A	T	17	12	29	0	2	31	0	0
12	3040178	.	T	C	11	11	22	0	2	24	0	0
12	3040329	.	A	G	7	24	31	0	3	34	0	0
12	3040370	.	G	A	0	19	19	0	3	22	0	0
12	3040819	.	T	A	13	20	33	0	1	34	0	0
12	3041087	.	C	A	11	7	18	0	1	19	0	0
12	3041088	.	G	T	1	7	8	0	11	19	0	0
12	3041179	.	T	A	26	12	38	0	0	38	0	0
12	3041390	.	A	T	26	13	39	0	1	40	0	0
12	3041497	.	G	A	1	20	21	0	21	42	0	0
12	3041587	.	A	T	21	16	37	0	3	40	0	0
12	3041606	.	A	T	26	17	43	0	1	44	0	0
12	3041721	.	G	A	0	17	17	0	34	51	0	0
12	3041871	.	C	T	21	22	43	0	6	49	0	0
12	3041905	.	C	A	16	18	34	0	2	36	0	0
12	3060156	.	A	G	1	5	6	0	0	6	0	0
12	3060441	.	G	A	2	2	4	0	0	4	0	0
12	3060823	.	C	A	3	2	5	0	1	6	0	0
12	3060849	.	C	G	3	3	6	0	0	6	0	0
12	3061103	.	T	C	3	3	6	0	0	6	0	0
12	3065997	.	A	G	2	1	3	0	0	3	0	0
12	3072985	.	A	G	4	6	10	0	0	10	0	0
12	3077223	.	T	C	1	5	6	0	0	6	0	0
12	3077257	.	C	T	2	2	4	0	1	5	0	0
12	3077261	.	C	G	2	2	4	0	0	4	0	0
12	3092724	.	G	A	1	3	4	0	0	4	0	0
12	3271553	.	G	A	1	7	8	0	0	8	0	0
12	3272388	.	A	G	4	3	7	0	0	7	0	0
12	3272421	.	A	G	3	8	11	0	1	12	0	0
12	3574348	.	G	A	8	17	25	0	0	25	0	0
12	3574398	.	C	G	9	14	23	0	0	23	0	0
12	3574489	.	G	A	7	3	10	0	0	10	0	0
12	3574581	.	A	T	1	5	6	0	0	6	0	0
12	3714620	.	T	C	6	2	8	0	0	8	0	0
12	3714621	.	T	C	5	2	7	0	1	8	0	0
12	3714731	.	T	C	5	4	9	0	0	9	0	0
12	3714934	.	T	C	7	4	11	0	0	11	0	0
12	3714977	.	T	C	4	0	4	0	11	15	0	0
12	3715201	.	T	C	2	6	8	0	0	8	0	0
12	3715261	.	A	T	6	5	11	0	0	11	0	0
12	3715292	.	T	G	4	10	14	0	0	14	0	0
12	3715327	.	C	A	3	8	11	0	1	12	0	0
12	3715329	.	C	G	3	7	10	0	2	12	0	0
12	3715365	.	T	C	2	3	5	0	0	5	0	0
12	3715489	.	G	T	3	3	6	0	0	6	0	0
12	3715544	.	T	C	6	4	10	0	0	10	0	0
12	3715588	.	C	A	3	3	6	0	1	7	0	0
12	3716621	.	G	C	2	0	2	0	0	2	0	0
12	3719297	.	T	G	2	2	4	0	0	4	0	0
12	3719312	.	T	C	4	1	5	0	4	9	0	0
12	3721941	.	A	G	4	3	7	0	0	7	0	0
12	3723786	.	C	G	6	6	12	0	0	12	0	0
12	3723963	.	G	A	0	6	6	0	5	11	0	0
12	3731590	.	G	A	0	1	1	0	4	5	0	0
12	3731602	.	C	A	1	6	7	0	0	7	0	0
12	3740724	.	T	A	5	18	23	0	1	24	0	0
12	3740735	.	A	T	5	18	23	0	2	25	0	0
12	3740784	.	C	T	17	9	26	0	0	26	0	0
12	3740803	.	G	A	15	12	27	0	0	27	0	0
12	3747652	.	G	C	3	4	7	0	0	7	0	0
12	3753166	.	C	T	0	6	6	0	7	13	0	0
12	3756229	.	G	T	4	13	17	0	0	17	0	0
12	3756237	.	C	T	4	11	15	0	2	17	0	0
12	3756303	.	C	T	2	9	11	0	10	21	0	0
12	3767321	.	G	T	7	8	15	0	0	15	0	0
12	3778218	.	C	T	8	2	10	0	0	10	0	0
12	3789435	.	C	A	0	4	4	0	3	7	0	0
12	3789772	.	T	G	4	6	10	0	0	10	0	0
12	3791925	.	C	A	5	4	9	0	0	9	0	0
12	4144620	.	T	C	0	2	2	0	0	2	0	0
12	4960297	.	A	G	1	0	1	0	5	6	0	0
12	4960634	.	A	G	2	2	4	0	0	4	0	0
12	4961436	.	A	G	3	4	7	0	0	7	0	0
12	6450954	.	T	C	3	2	5	0	0	5	0	0
12	6465617	.	G	C	2	2	4	0	0	4	0	0
12	6465792	.	C	A	1	1	2	0	0	2	0	0
12	6466197	.	C	T	0	3	3	0	1	4	0	0
12	6466198	.	A	G	1	3	4	0	0	4	0	0
12	6543458	.	C	G	5	3	8	0	0	8	0	0
12	6547163	.	C	T	0	2	2	0	0	2	0	0
12	6547214	.	A	G	8	1	9	0	0	9	0	0
12	6549689	.	A	G	1	0	1	0	0	1	0	0
12	6576130	.	A	T	2	0	2	0	0	2	0	0
12	6587222	.	T	C	1	0	1	0	3	4	0	0
12	6658822	.	G	A	1	4	5	0	0	5	0	0
12	6713949	.	G	A	4	2	6	0	0	6	0	0
12	6756394	.	G	C	3	0	3	0	1	4	0	0
12	6767735	.	G	A	1	1	2	0	0	2	0	0
12	6805953	.	A	G	0	1	1	0	0	1	0	0
12	6816881	.	G	A	1	0	1	0	0	1	0	0
12	7193865	.	C	T	7	7	14	0	1	15	0	0
12	7193874	.	A	G	8	9	17	0	0	17	0	0
12	7194410	.	A	G	12	7	19	0	1	20	0	0
12	7194505	.	T	C	11	10	21	0	0	21	0	0
12	7194522	.	T	C	12	10	22	0	0	22	0	0
12	7194587	.	G	A	9	5	14	0	0	14	0	0
12	7194843	.	C	A	4	7	11	0	0	11	0	0
12	7195081	.	G	T	11	11	22	0	0	22	0	0
12	7195139	.	A	T	3	6	9	0	0	9	0	0
12	7195192	.	G	T	0	19	19	0	0	19	0	0
12	7195365	.	T	C	16	8	24	0	1	25	0	0
12	7195454	.	T	A	12	9	21	0	0	21	0	0
12	7195524	.	G	T	7	5	12	0	3	15	0	0
12	7195588	.	G	A	10	2	12	0	0	12	0	0
12	7195600	.	T	C	3	10	13	0	0	13	0	0
12	7195676	.	C	T	0	6	6	0	7	13	0	0
12	7195816	.	C	A	8	4	12	0	0	12	0	0
12	7195888	.	T	C	4	6	10	0	0	10	0	0
12	7195942	.	C	T	4	4	8	0	0	8	0	0
12	7195951	.	T	C	3	0	3	0	4	7	0	0
12	7196059	.	G	A	14	5	19	0	1	20	0	0
12	7196114	.	G	A	10	7	17	0	0	17	0	0
12	7196125	.	A	G	7	10	17	0	0	17	0	0
12	7196175	.	G	A	4	3	7	0	1	8	0	0
12	7196201	.	G	A	2	5	7	0	0	7	0	0
12	7196249	.	G	T	7	9	16	0	1	17	0	0
12	7196456	.	A	G	5	5	10	0	1	11	0	0
12	7196639	.	A	G	10	2	12	0	1	13	0	0
12	7197407	.	T	C	6	7	13	0	0	13	0	0
12	7198135	.	T	A	7	5	12	0	0	12	0	0
12	7198142	.	T	C	6	0	6	0	5	11	0	0
12	7198215	.	C	A	7	2	9	0	0	9	0	0
12	7198317	.	T	A	2	6	8	0	1	9	0	0
12	7198335	.	C	T	0	10	10	0	1	11	0	0
12	7198409	.	G	A	4	4	8	0	0	8	0	0
12	7198572	.	C	T	2	2	4	0	1	5	0	0
12	7199447	.	C	T	4	6	10	0	1	11	0	0
12	7223665	.	C	T	2	2	4	0	0	4	0	0
12	7234692	.	G	A	10	7	17	0	0	17	0	0
12	7234790	.	G	A	8	5	13	0	0	13	0	0
12	7235030	.	G	A	9	9	18	0	0	18	0	0
12	7237756	.	G	A	2	2	4	0	1	5	0	0
12	7263657	.	G	T	0	3	3	0	4	7	0	0
12	7263665	.	G	T	0	3	3	0	3	6	0	0
12	7268804	.	T	C	1	4	5	0	0	5	0	0
12	7268827	.	G	A	3	1	4	0	1	5	0	0
12	7280057	.	C	T	4	4	8	0	0	8	0	0
12	7280160	.	G	T	3	1	4	0	0	4	0	0
12	7454704	.	C	T	7	2	9	0	1	10	0	0
12	7512347	.	T	C	12	6	18	0	0	18	0	0
12	7512469	.	C	T	8	10	18	0	0	18	0	0
12	7512641	.	T	A	10	17	27	0	0	27	0	0
12	7512675	.	G	A	9	11	20	0	0	20	0	0
12	7512682	.	A	G	8	9	17	0	1	18	0	0
12	7512921	.	A	G	10	11	21	0	0	21	0	0
12	7512965	.	C	A	9	9	18	0	0	18	0	0
12	7513446	.	T	A	10	9	19	0	1	20	0	0
12	7513480	.	C	T	8	3	11	1	0	12	0	0
12	7513555	.	G	A	13	5	18	0	1	19	0	0
12	7513613	.	G	A	0	7	7	0	9	16	0	0
12	7513685	.	C	A	7	9	16	0	0	16	0	0
12	7589795	.	A	G	4	3	7	0	2	9	0	0
12	7589816	.	A	G	5	7	12	0	0	12	0	0
12	7589845	.	C	A	5	6	11	0	0	11	0	0
12	7589917	.	C	G	2	6	8	0	1	9	0	0
12	7589995	.	C	A	5	6	11	0	0	11	0	0
12	7590024	.	C	A	8	7	15	0	0	15	0	0
12	7595179	.	C	T	6	11	17	0	0	17	0	0
12	7595204	.	G	A	4	7	11	0	1	12	0	0
12	7595726	.	C	A	6	7	13	0	0	13	0	0
12	7597751	.	T	C	0	2	2	0	0	2	0	0
12	7610033	.	A	G	3	5	8	0	0	8	0	0
12	7610236	.	A	T	7	3	10	0	1	11	0	0
12	7610354	.	C	T	0	3	3	0	1	4	0	0
12	7610478	.	T	A	3	8	11	0	0	11	0	0
12	7610532	.	T	G	10	4	14	0	0	14	0	0
12	7610663	.	T	C	4	0	4	0	6	11	1	0
12	7610740	.	T	C	11	9	20	0	2	22	0	0
12	7610969	.	T	C	5	3	8	0	0	8	0	0
12	7611205	.	T	C	9	5	14	0	0	14	0	0
12	7611286	.	T	C	3	5	8	0	0	8	0	0
12	7611595	.	A	G	2	10	12	0	0	12	0	0
12	7611625	.	G	T	6	5	11	0	4	15	0	0
12	7611751	.	A	C	7	6	13	0	0	13	0	0
12	7612106	.	T	C	0	8	8	0	1	9	0	0
12	7612117	.	G	A	6	5	11	0	0	11	0	0
12	7612406	.	T	A	1	4	5	0	0	5	0	0
12	7620242	.	G	T	3	2	5	0	0	5	0	0
12	7628945	.	A	C	1	1	2	0	0	2	0	0
12	7629226	.	T	C	3	2	5	0	0	5	0	0
12	7633156	.	A	G	4	2	6	0	0	6	0	0
12	7710552	.	C	T	0	1	1	0	0	1	0	0
12	7757781	.	A	G	2	7	9	0	0	9	0	0
12	7785502	.	C	A	1	5	6	0	0	6	0	0
12	7792956	.	A	G	0	2	2	0	0	2	0	0
12	7805039	.	A	G	0	2	2	0	0	2	0	0
12	7853833	.	G	T	1	1	2	0	1	3	0	0
12	7853846	.	A	T	4	2	6	0	0	6	0	0
12	8018992	.	C	T	1	2	3	0	1	4	0	0
12	8019172	.	T	C	1	4	5	0	0	5	0	0
12	8019307	.	T	C	3	2	5	0	0	5	0	0
12	8019511	.	T	C	4	1	5	0	0	5	0	0
12	8019518	.	C	T	3	2	5	0	0	5	0	0
12	8227133	.	T	C	1	2	3	0	0	3	0	0
12	8227145	.	G	C	1	3	4	0	0	4	0	0
12	8307569	.	G	A	0	0	0	0	1	1	0	0
12	8307615	.	A	G	2	0	2	0	3	5	0	0
12	8307734	.	A	C	5	6	11	0	0	11	0	0
12	8822836	.	C	T	2	2	4	0	0	4	0	0
12	8863228	.	G	A	0	0	0	0	1	1	0	0
12	8863240	.	A	T	0	1	1	0	0	1	0	0
12	8866077	.	A	G	2	2	4	0	0	4	0	0
12	8877412	.	T	C	3	2	5	0	0	5	0	0
12	8881469	.	G	A	6	3	9	0	0	9	0	0
12	8881470	.	C	G	3	6	9	0	0	9	0	0
12	8881575	.	C	T	9	4	13	0	0	13	0	0
12	8882062	.	G	T	2	8	10	0	1	11	0	0
12	8955284	.	C	T	0	3	3	0	2	5	0	0
12	8956420	.	C	T	2	3	5	0	0	5	0	0
12	8956932	.	C	T	0	2	2	0	1	3	0	0
12	8968456	.	T	A	4	8	12	0	0	12	0	0
12	8968487	.	T	A	10	4	14	0	0	14	0	0
12	8968512	.	T	G	4	7	11	0	1	12	0	0
12	8968721	.	A	G	7	9	16	0	1	17	0	0
12	8968979	.	C	A	6	10	16	0	0	16	0	0
12	8969084	.	T	C	10	15	25	0	2	27	0	0
12	8969102	.	C	T	0	22	22	0	10	32	0	0
12	8969155	.	C	G	17	11	28	0	1	29	0	0
12	8969426	.	T	C	4	9	13	0	0	13	0	0
12	8969485	.	T	C	15	18	33	0	1	34	0	0
12	8969499	.	G	A	16	20	36	0	0	36	0	0
12	8987502	.	T	C	0	1	1	0	0	1	0	0
12	8997654	.	A	G	3	2	5	0	0	5	0	0
12	9010979	.	G	A	9	2	11	0	0	11	0	0
12	9010988	.	C	T	0	6	6	0	11	17	0	0
12	9039610	.	G	A	5	8	13	0	0	13	0	0
12	9049343	.	C	T	2	9	11	0	1	12	0	0
12	9064504	.	G	A	0	2	2	0	0	2	0	0
12	9084590	.	T	C	13	4	17	0	0	17	0	0
12	9187209	.	A	G	1	0	1	0	0	1	0	0
12	9188488	.	A	G	3	8	11	0	0	11	0	0
12	9190882	.	T	C	0	1	1	0	0	1	0	0
12	9200402	.	C	T	1	2	3	0	0	3	0	0
12	9206038	.	T	C	3	4	7	0	0	7	0	0
12	9206044	.	C	T	3	5	8	0	1	9	0	0
12	9208468	.	T	G	4	0	4	0	8	12	0	0
12	9210441	.	G	A	1	1	2	0	0	2	0	0
12	9210489	.	T	C	5	5	10	0	1	11	0	0
12	9210504	.	A	G	5	5	10	0	1	11	0	0
12	9210528	.	C	T	2	4	6	0	1	7	0	0
12	9217989	.	A	G	2	1	3	0	0	3	0	0
12	9218054	.	T	C	7	5	12	0	1	13	0	0
12	9218176	.	T	C	1	2	3	0	0	3	0	0
12	9218183	.	G	A	1	2	3	0	0	3	0	0
12	9452838	.	T	C	0	0	0	0	3	3	0	0
12	9452880	.	G	C	0	1	1	0	0	1	0	0
12	9463660	.	G	A	2	3	5	0	0	5	0	0
12	9463678	.	T	C	2	2	4	0	0	4	0	0
12	9463840	.	A	G	0	1	1	0	0	1	0	0
12	9463879	.	G	A	3	2	5	0	0	5	0	0
12	9463885	.	G	A	3	2	5	0	0	5	0	0
12	9468373	.	C	T	0	5	5	0	3	8	0	0
12	9468440	.	G	A	3	4	7	0	1	8	0	0
12	9623751	.	T	C	1	3	4	0	0	4	0	0
12	9626057	.	A	C	1	4	5	0	1	6	0	0
12	9627980	.	A	G	1	3	4	0	0	4	0	0
12	9628007	.	T	C	2	0	2	0	0	2	0	0
12	9630730	.	G	A	1	1	2	0	0	2	0	0
12	9630745	.	G	A	1	1	2	0	0	2	0	0
12	9633827	.	G	A	12	15	27	0	1	28	0	0
12	9636532	.	A	C	4	2	6	0	0	6	0	0
12	9636544	.	C	T	0	2	2	0	3	5	0	0
12	9636967	.	C	A	0	2	2	0	2	4	0	0
12	9640309	.	C	T	3	2	5	0	0	5	0	0
12	9642605	.	C	T	2	1	3	0	0	3	0	0
12	9642671	.	A	G	2	2	4	0	0	4	0	0
12	9654101	.	T	A	1	3	4	0	0	4	0	0
12	9654155	.	C	G	0	2	2	0	4	6	0	0
12	9658137	.	A	G	5	2	7	0	0	7	0	0
12	9658168	.	C	T	4	1	5	0	1	6	0	0
12	9660129	.	G	A	1	2	3	0	0	3	0	0
12	9660365	.	A	G	3	4	7	0	0	7	0	0
12	9660389	.	A	G	2	4	6	0	0	6	0	0
12	9676454	.	A	T	2	2	4	0	0	4	0	0
12	9703260	.	C	T	4	4	8	0	1	9	0	0
12	9703831	.	C	T	11	8	19	0	1	20	0	0
12	9703843	.	A	G	7	11	18	0	0	18	0	0
12	9704233	.	T	C	8	8	16	0	1	17	0	0
12	9704254	.	G	T	12	10	22	0	0	22	0	0
12	9704431	.	C	T	7	6	13	0	5	18	0	0
12	9704443	.	G	T	0	10	10	0	6	16	0	0
12	9744544	.	C	T	5	4	9	0	2	11	0	0
12	9749830	.	A	G	8	6	14	0	0	14	0	0
12	9755833	.	C	T	15	8	23	0	3	26	0	0
12	9755869	.	A	G	10	7	17	0	1	18	0	0
12	9761792	.	C	T	7	7	14	0	0	14	0	0
12	9769880	.	A	T	4	4	8	0	1	9	0	0
12	9773157	.	G	A	4	3	7	0	0	7	0	0
12	9773465	.	G	A	0	9	9	0	11	20	0	0
12	9781701	.	T	G	6	4	10	0	0	10	0	0
12	9781789	.	C	T	1	6	7	0	0	7	0	0
12	9782041	.	G	A	2	2	4	0	0	4	0	0
12	9782230	.	C	T	6	4	10	0	0	10	0	0
12	9782404	.	G	A	1	4	5	0	0	5	0	0
12	9782428	.	T	C	2	4	6	0	1	7	0	0
12	9782623	.	G	A	3	3	6	0	0	6	0	0
12	9782635	.	A	G	4	3	7	0	0	7	0	0
12	9782743	.	C	T	0	3	3	0	3	6	0	0
12	9782756	.	G	A	3	2	5	0	0	5	0	0
12	9783596	.	G	A	2	5	7	0	1	8	0	0
12	9790384	.	C	T	0	1	1	0	0	1	0	0
12	9817737	.	A	T	13	12	25	0	0	25	0	0
12	9817771	.	C	T	8	10	18	0	0	18	0	0
12	9817883	.	T	A	14	16	30	0	0	30	0	0
12	9824735	.	C	T	10	12	22	0	0	22	0	0
12	9824762	.	C	A	14	13	27	0	1	28	0	0
12	9824807	.	C	A	2	4	6	0	1	7	0	0
12	9829697	.	C	T	2	1	3	0	0	3	0	0
12	9830983	.	G	A	8	6	14	0	1	15	0	0
12	9830986	.	G	A	9	8	17	0	0	17	0	0
12	9883526	.	G	A	12	37	49	0	1	50	0	0
12	9883849	.	C	T	35	29	64	0	1	65	0	0
12	9883944	.	C	T	35	28	63	0	1	65	1	0
12	9950515	.	C	A	4	3	7	0	0	7	0	0
12	9981026	.	T	G	3	2	5	0	0	5	0	0
12	9981077	.	G	A	3	3	6	0	0	6	0	0
12	9981107	.	A	G	1	2	3	0	0	3	0	0
12	10117236	.	G	A	3	2	5	0	1	6	0	0
12	10124691	.	G	T	5	3	8	0	0	8	0	0
12	10124815	.	T	G	11	10	21	0	0	21	0	0
12	10124819	.	C	T	9	8	17	0	1	18	0	0
12	10124976	.	C	T	13	6	19	0	0	19	0	0
12	10125030	.	G	T	2	6	8	0	7	15	0	0
12	10125031	.	C	A	9	5	14	0	1	15	0	0
12	10125479	.	T	A	3	6	9	0	0	9	0	0
12	10125546	.	A	G	2	6	8	0	0	8	0	0
12	10125573	.	A	G	2	4	6	0	0	6	0	0
12	10167070	.	A	G	0	2	2	0	0	2	0	0
12	10169521	.	T	C	10	6	16	0	0	16	0	0
12	10169614	.	G	A	13	12	25	0	1	26	0	0
12	10169884	.	G	T	12	19	31	0	1	32	0	0
12	10175161	.	C	T	2	2	4	0	1	5	0	0
12	10199695	.	A	G	17	20	37	0	0	37	0	0
12	10199760	.	A	T	11	21	32	0	1	34	1	0
12	10199869	.	C	T	2	14	16	0	11	27	0	0
12	10200028	.	A	G	13	22	35	0	1	36	0	0
12	10209431	.	A	G	11	12	23	0	0	23	0	0
12	10209452	.	T	A	6	7	13	0	1	14	0	0
12	10217660	.	C	T	9	10	19	0	1	20	0	0
12	10217708	.	C	T	7	3	10	0	0	10	0	0
12	10220000	.	G	T	3	2	5	0	0	5	0	0
12	10220117	.	A	G	0	1	1	0	0	1	0	0
12	10243911	.	C	T	7	4	11	0	0	11	0	0
12	10243926	.	C	T	7	3	10	0	2	12	0	0
12	10243971	.	A	C	3	2	5	0	0	5	0	0
12	10304660	.	T	A	6	6	12	0	0	12	0	0
12	10304706	.	G	A	5	2	7	0	0	7	0	0
12	10313241	.	G	A	3	1	4	0	1	5	0	0
12	10344414	.	G	A	1	0	1	0	0	1	0	0
12	10368969	.	T	C	2	0	2	0	2	4	0	0
12	10368978	.	A	G	2	2	4	0	0	4	0	0
12	10369038	.	G	T	1	2	3	0	1	4	0	0
12	10369153	.	T	G	2	6	8	0	0	8	0	0
12	10369459	.	T	G	5	2	7	0	0	7	0	0
12	10369466	.	C	T	1	2	3	0	5	8	0	0
12	10369758	.	A	G	3	6	9	0	0	9	0	0
12	10369780	.	A	G	5	2	7	0	0	7	0	0
12	10370148	.	T	G	1	3	4	0	0	4	0	0
12	10370170	.	T	G	1	2	3	0	0	3	0	0
12	10372481	.	A	G	1	2	3	0	0	3	0	0
12	10382220	.	C	T	3	5	8	0	0	8	0	0
12	10382588	.	C	T	6	4	10	0	1	11	0	0
12	10384982	.	G	A	8	8	16	0	0	16	0	0
12	10387071	.	A	G	7	9	16	0	0	16	0	0
12	10391883	.	C	T	0	1	1	0	0	1	0	0
12	10398820	.	A	G	1	4	5	0	0	5	0	0
12	10399471	.	G	A	1	1	2	0	0	2	0	0
12	10399766	.	T	C	2	5	7	0	0	7	0	0
12	10413298	.	A	G	1	1	2	0	0	2	0	0
12	10421810	.	C	T	1	2	3	0	0	3	0	0
12	10425346	.	T	C	8	6	14	0	1	15	0	0
12	10425465	.	C	T	1	1	2	0	0	2	0	0
12	10425586	.	G	T	3	2	5	0	0	5	0	0
12	10425630	.	A	T	2	2	4	0	1	5	0	0
12	10429054	.	G	A	7	7	14	0	0	14	0	0
12	10429105	.	C	A	1	2	3	0	0	3	0	0
12	10430611	.	G	A	0	3	3	0	1	4	0	0
12	10439619	.	C	A	3	6	9	0	0	9	0	0
12	10439641	.	T	G	3	6	9	0	1	10	0	0
12	10439662	.	G	A	4	5	9	0	1	10	0	0
12	10443916	.	G	T	4	9	13	0	0	13	0	0
12	10443923	.	T	C	3	9	12	0	1	13	0	0
12	10444321	.	A	T	8	3	11	0	0	11	0	0
12	10465000	.	A	C	2	7	9	0	2	11	0	0
12	10465182	.	A	C	5	3	8	0	0	8	0	0
12	10471105	.	A	G	4	3	7	0	0	7	0	0
12	10471120	.	T	C	4	0	4	0	4	8	0	0
12	10471159	.	G	A	1	1	2	0	0	2	0	0
12	10471174	.	A	C	1	0	1	0	0	1	0	0
12	10478804	.	C	A	0	2	2	0	4	6	0	0
12	10478857	.	T	C	4	3	7	0	0	7	0	0
12	10482792	.	T	G	0	2	2	0	0	2	0	0
12	10487620	.	G	T	2	3	5	0	0	5	0	0
12	10492349	.	C	T	0	1	1	0	0	1	0	0
12	10492438	.	C	T	0	3	3	0	2	5	0	0
12	10493597	.	G	A	2	3	5	0	1	6	0	0
12	10505938	.	G	C	1	0	1	0	2	3	0	0
12	10608908	.	C	T	3	2	5	0	0	5	0	0
12	10609474	.	A	G	1	5	6	0	0	6	0	0
12	10646482	.	A	T	2	1	3	0	0	3	0	0
12	10651761	.	A	G	5	2	7	0	0	7	0	0
12	10662152	.	G	T	1	3	4	0	0	4	0	0
12	10679279	.	T	G	2	3	5	0	1	7	1	0
12	10679289	.	G	A	1	3	4	0	0	4	0	0
12	10682392	.	A	G	1	2	3	0	0	3	0	0
12	10685867	.	C	T	4	1	5	0	0	5	0	0
12	10688640	.	C	T	8	11	19	0	1	20	0	0
12	10688704	.	G	A	10	10	20	0	1	21	0	0
12	10688890	.	G	A	1	0	1	0	0	1	0	0
12	10705765	.	T	A	5	10	15	0	0	15	0	0
12	10705775	.	C	G	5	10	15	0	1	16	0	0
12	10723349	.	G	A	1	0	1	0	0	1	0	0
12	11389226	.	T	C	12	3	15	0	1	16	0	0
12	11389229	.	T	C	13	3	16	0	0	16	0	0
12	11390306	.	T	C	7	6	13	0	0	13	0	0
12	11390365	.	T	C	4	5	9	0	0	9	0	0
12	11762849	.	A	T	6	4	10	0	1	11	0	0
12	13473693	.	A	G	8	0	8	0	4	12	0	0
12	13474461	.	A	G	18	6	24	0	2	26	0	0
12	13475225	.	A	G	13	7	20	0	2	22	0	0
12	16099066	.	C	T	5	2	7	0	0	7	0	0
12	18694220	.	A	C	1	0	1	0	0	1	0	0
12	18709398	.	G	T	1	2	3	0	0	3	0	0
12	18713926	.	C	T	6	5	11	0	1	12	0	0
12	18714000	.	C	T	10	9	19	0	1	20	0	0
12	18717085	.	A	G	10	6	16	0	1	17	0	0
12	18717471	.	T	C	1	2	3	0	1	4	0	0
12	18717477	.	T	A	2	3	5	0	0	5	0	0
12	18779450	.	T	A	3	1	4	0	0	4	0	0
12	18779648	.	T	C	0	1	1	0	0	1	0	0
12	18782541	.	G	A	8	5	13	0	0	13	0	0
12	18782763	.	G	A	3	1	4	0	0	4	0	0
12	18786773	.	T	C	5	10	15	0	1	16	0	0
12	18786917	.	T	C	10	8	18	0	1	19	0	0
12	18787009	.	G	A	9	10	19	0	0	19	0	0
12	18787205	.	C	T	8	6	14	0	0	14	0	0
12	18895837	.	T	C	3	2	5	0	0	5	0	0
12	18913503	.	A	G	5	9	14	0	1	15	0	0
12	18913938	.	A	G	9	10	19	0	1	20	0	0
12	18914023	.	A	G	3	4	7	0	0	7	0	0
12	18914039	.	A	G	3	3	6	0	0	6	0	0
12	19301172	.	A	T	8	3	11	0	0	11	0	0
12	19317745	.	G	A	27	3	30	0	1	31	0	0
12	19317791	.	G	A	27	21	48	0	2	50	0	0
12	19317875	.	G	A	14	21	35	0	1	36	0	0
12	19317930	.	G	T	0	17	17	0	12	29	0	0
12	19318157	.	T	C	11	19	30	0	0	30	0	0
12	19318158	.	G	A	11	19	30	0	0	30	0	0
12	19318194	.	G	C	9	19	28	0	1	29	0	0
12	19318210	.	T	C	13	18	31	0	1	32	0	0
12	19318441	.	A	T	2	7	9	0	0	9	0	0
12	19318475	.	G	A	2	6	8	0	1	9	0	0
12	19318487	.	C	A	2	8	10	0	0	10	0	0
12	19318539	.	G	A	4	12	16	0	1	17	0	0
12	19318615	.	A	T	8	11	19	0	0	19	0	0
12	19318823	.	A	G	9	1	10	0	15	25	0	0
12	19318855	.	C	T	12	20	32	0	2	34	0	0
12	19319085	.	T	G	2	3	5	0	0	5	0	0
12	19319105	.	C	T	2	2	4	0	0	4	0	0
12	19320741	.	G	A	3	6	9	0	0	9	0	0
12	19320778	.	G	A	1	6	7	0	0	7	0	0
12	19320821	.	C	A	2	2	4	0	0	4	0	0
12	19323174	.	A	C	2	2	4	0	0	4	0	0
12	19323229	.	T	C	1	2	3	0	0	3	0	0
12	19333787	.	G	T	4	2	6	0	0	6	0	0
12	19337850	.	G	A	8	4	12	0	0	12	0	0
12	19338127	.	G	C	1	3	4	0	0	4	0	0
12	19338280	.	G	A	8	6	14	1	0	15	0	0
12	19338387	.	T	G	4	10	14	0	0	14	0	0
12	19338935	.	T	C	2	3	5	0	0	5	0	0
12	19339065	.	G	T	2	3	5	0	1	6	0	0
12	19339257	.	A	G	2	2	4	0	0	4	0	0
12	19339270	.	T	C	2	4	6	0	1	7	0	0
12	19339403	.	C	A	3	6	9	0	1	10	0	0
12	19339490	.	T	A	7	4	11	0	0	11	0	0
12	19339492	.	C	T	6	4	10	0	1	11	0	0
12	19340016	.	A	G	1	3	4	0	1	5	0	0
12	19340086	.	A	G	3	2	5	0	0	5	0	0
12	19341869	.	G	A	22	16	38	0	1	39	0	0
12	19348622	.	A	G	23	17	40	0	2	42	0	0
12	19348678	.	T	C	19	22	41	0	1	42	0	0
12	19353091	.	C	T	17	23	40	0	5	45	0	0
12	19353174	.	C	T	16	16	32	0	1	33	0	0
12	19353203	.	A	C	21	14	35	0	2	37	0	0
12	19353513	.	A	G	12	10	22	0	3	25	0	0
12	19353622	.	A	T	15	5	20	0	2	22	0	0
12	19362426	.	T	C	7	7	14	0	0	14	0	0
12	19362500	.	C	T	8	4	12	0	0	12	0	0
12	19362624	.	A	G	5	5	10	0	0	10	0	0
12	19369292	.	G	A	3	11	14	0	1	15	0	0
12	19369414	.	A	G	6	4	10	0	1	11	0	0
12	19371801	.	A	G	6	0	6	0	7	13	0	0
12	19373175	.	G	A	4	2	6	0	0	6	0	0
12	19375729	.	T	C	4	4	8	0	0	8	0	0
12	19375741	.	C	T	4	3	7	0	0	7	0	0
12	19379564	.	G	C	0	8	8	0	9	17	0	0
12	19379642	.	C	T	10	5	15	0	0	15	0	0
12	19380120	.	A	G	2	2	4	0	0	4	0	0
12	19383137	.	A	G	10	8	18	0	0	18	0	0
12	19383139	.	T	C	10	7	17	0	1	18	0	0
12	19383217	.	T	C	7	5	12	0	0	12	0	0
12	19383242	.	T	A	5	4	9	0	0	9	0	0
12	19383417	.	T	C	8	11	19	0	0	19	0	0
12	19383539	.	C	T	12	6	18	0	0	18	0	0
12	19383843	.	G	A	8	4	12	0	0	12	0	0
12	19385072	.	G	A	3	3	6	0	0	6	0	0
12	19385287	.	T	C	4	1	5	0	0	5	0	0
12	19385664	.	C	T	1	1	2	0	0	2	0	0
12	19393795	.	A	G	4	2	6	0	0	6	0	0
12	19408417	.	A	T	3	2	5	0	0	5	0	0
12	19408440	.	G	A	1	2	3	0	0	3	0	0
12	19419880	.	C	T	0	1	1	0	0	1	0	0
12	19422124	.	G	A	0	1	1	0	0	1	0	0
12	19422271	.	T	C	0	2	2	0	0	2	0	0
12	19422319	.	T	C	3	4	7	0	1	8	0	0
12	19422410	.	G	A	0	3	3	0	4	7	0	0
12	19430068	.	G	A	0	3	3	0	0	3	0	0
12	19433542	.	C	G	1	0	1	0	0	1	0	0
12	19447036	.	C	T	5	5	10	0	0	10	0	0
12	19637039	.	T	G	10	7	17	0	0	17	0	0
12	19658488	.	G	T	2	10	12	0	0	12	0	0
12	19658505	.	T	C	1	8	9	0	0	9	0	0
12	19658587	.	A	G	3	6	9	0	0	9	0	0
12	19658626	.	C	T	3	5	8	0	0	8	0	0
12	19658691	.	A	G	2	0	2	0	8	10	0	0
12	19658735	.	A	T	6	8	14	0	0	14	0	0
12	19658836	.	G	A	8	8	16	0	0	16	0	0
12	19792566	.	T	C	7	9	16	0	2	18	0	0
12	19792945	.	C	G	13	8	21	0	0	21	0	0
12	19792970	.	G	A	14	8	22	0	0	22	0	0
12	19793001	.	G	A	17	16	33	0	0	33	0	0
12	19793039	.	T	A	22	9	31	0	2	33	0	0
12	19793470	.	C	G	16	21	37	0	1	38	0	0
12	19793534	.	T	A	18	17	35	0	0	35	0	0
12	19793657	.	G	A	17	12	29	0	0	29	0	0
12	19793693	.	A	G	7	2	9	0	0	9	0	0
12	19865090	.	T	C	12	0	12	0	16	28	0	0
12	19865347	.	C	T	9	12	21	0	0	21	0	0
12	19865567	.	G	A	2	14	16	0	0	16	0	0
12	19866983	.	A	G	3	3	6	0	1	7	0	0
12	19877890	.	A	G	1	0	1	0	1	2	0	0
12	19931572	.	A	T	3	3	6	0	0	6	0	0
12	19931609	.	G	A	0	2	2	0	2	4	0	0
12	19931614	.	A	G	2	0	2	0	2	4	0	0
12	19932072	.	T	C	2	4	6	0	0	6	0	0
12	19932122	.	C	A	1	4	5	0	0	5	0	0
12	19967552	.	A	G	1	1	2	0	0	2	0	0
12	19967554	.	A	G	1	1	2	0	0	2	0	0
12	19970187	.	T	C	1	2	3	0	0	3	0	0
12	19973531	.	A	G	7	0	7	0	5	12	0	0
12	19973564	.	T	C	8	5	13	0	0	13	0	0
12	19973939	.	A	G	6	0	6	0	5	11	0	0
12	19973942	.	A	G	5	6	11	0	0	11	0	0
12	19974092	.	G	A	0	6	6	0	9	15	0	0
12	19974196	.	G	A	3	3	6	0	0	6	0	0
12	19974350	.	A	C	1	2	3	0	0	3	0	0
12	19974371	.	G	T	2	2	4	0	0	4	0	0
12	19974421	.	T	G	1	3	4	0	0	4	0	0
12	20018682	.	A	T	1	0	1	0	0	1	0	0
12	20025633	.	C	T	3	4	7	0	0	7	0	0
12	20026597	.	G	A	2	1	3	0	0	3	0	0
12	20034735	.	T	C	4	3	7	0	1	8	0	0
12	20034744	.	T	C	4	3	7	0	1	8	0	0
12	20043897	.	G	C	5	2	7	0	0	7	0	0
12	20043971	.	C	T	5	3	8	0	0	8	0	0
12	20044661	.	C	T	3	3	6	0	0	6	0	0
12	20045067	.	G	T	0	3	3	0	1	4	0	0
12	20045068	.	T	C	1	3	4	0	0	4	0	0
12	20099085	.	A	G	10	10	20	0	2	22	0	0
12	20099478	.	A	G	16	6	22	0	0	22	0	0
12	20099657	.	T	C	9	7	16	0	1	17	0	0
12	20099708	.	T	A	12	10	22	0	0	22	0	0
12	20100109	.	A	G	15	12	27	0	1	28	0	0
12	20100169	.	A	G	15	19	34	0	1	35	0	0
12	20100190	.	T	C	13	0	13	0	18	31	0	0
12	20100391	.	G	A	18	13	31	0	1	32	0	0
12	20122600	.	G	C	2	5	7	0	0	7	0	0
12	20122709	.	A	T	7	8	15	0	1	16	0	0
12	20122785	.	T	C	11	4	15	0	0	15	0	0
12	20123320	.	G	A	0	1	1	0	0	1	0	0
12	20123881	.	A	C	1	4	5	0	0	5	0	0
12	20125561	.	A	G	5	0	5	0	5	10	0	0
12	20147049	.	G	A	7	5	12	0	2	14	0	0
12	20147218	.	G	C	16	4	20	0	0	20	0	0
12	20147229	.	A	G	14	0	14	0	1	15	0	0
12	20147260	.	G	A	14	6	20	0	1	21	0	0
12	20147428	.	G	A	13	8	21	0	1	22	0	0
12	20147486	.	A	G	5	0	5	0	17	22	0	0
12	20147504	.	T	C	8	19	27	0	0	27	0	0
12	20147564	.	A	T	9	8	17	0	2	19	0	0
12	20156168	.	G	A	0	3	3	0	3	6	0	0
12	20156177	.	G	A	2	1	3	0	1	4	0	0
12	20156546	.	A	G	2	2	4	0	0	4	0	0
12	20251213	.	T	C	3	3	6	0	0	6	0	0
12	20379586	.	G	C	8	3	11	0	1	12	0	0
12	20380050	.	C	G	1	1	2	0	0	2	0	0
12	20396459	.	T	A	7	6	13	0	1	14	0	0
12	20406815	.	T	C	1	1	2	0	1	3	0	0
12	20406818	.	G	A	1	2	3	0	0	3	0	0
12	20407789	.	A	G	3	3	6	0	0	6	0	0
12	20409495	.	G	T	5	6	11	0	0	11	0	0
12	20409523	.	A	G	3	8	11	0	0	11	0	0
12	20409585	.	G	C	3	0	3	0	6	9	0	0
12	20409600	.	A	G	4	6	10	0	0	10	0	0
12	20409680	.	T	A	10	5	15	0	1	16	0	0
12	20471189	.	C	T	0	1	1	0	0	1	0	0
12	20482055	.	A	C	1	2	3	0	0	3	0	0
12	20482058	.	G	A	1	1	2	0	1	3	0	0
12	20607308	.	C	T	7	3	10	0	1	11	0	0
12	20607417	.	C	T	3	2	5	0	0	5	0	0
12	20607515	.	G	A	6	5	11	0	0	11	0	0
12	20607711	.	G	C	6	6	12	0	0	12	0	0
12	20608370	.	T	A	5	5	10	0	0	10	0	0
12	20608397	.	G	A	2	8	10	0	0	10	0	0
12	20608518	.	C	T	1	3	4	0	2	6	0	0
12	20651441	.	G	A	0	3	3	0	1	4	0	0
12	20651602	.	G	A	1	2	3	0	0	3	0	0
12	20651623	.	C	A	2	2	4	0	0	4	0	0
12	20652539	.	C	G	1	2	3	0	0	3	0	0
12	20652683	.	C	T	1	4	5	0	0	5	0	0
12	20652732	.	G	A	2	2	4	0	0	4	0	0
12	20653128	.	C	T	3	4	7	0	0	7	0	0
12	20653159	.	G	A	5	4	9	0	0	9	0	0
12	20653244	.	A	T	8	4	12	0	0	12	0	0
12	20653301	.	T	C	3	0	3	0	1	4	0	0
12	20658037	.	T	C	5	10	15	0	0	15	0	0
12	20676252	.	C	T	9	1	10	0	0	10	0	0
12	20676345	.	C	T	2	3	5	0	0	5	0	0
12	20677767	.	T	A	2	3	5	0	1	6	0	0
12	20677874	.	A	G	5	2	7	0	0	7	0	0
12	20700799	.	A	T	1	3	4	0	0	4	0	0
12	20749109	.	G	A	0	1	1	0	0	1	0	0
12	20749139	.	A	G	0	1	1	0	0	1	0	0
12	20772675	.	C	G	0	0	0	0	2	2	0	0
12	20777733	.	C	T	0	3	3	0	0	3	0	0
12	21298689	.	C	T	0	2	2	0	0	2	0	0
12	21549172	.	G	A	9	17	26	0	5	31	0	0
12	21684306	.	A	G	0	0	0	0	1	1	0	0
12	21687757	.	T	C	4	3	7	0	0	7	0	0
12	21801877	.	C	G	1	3	4	0	0	4	0	0
12	22230556	.	A	T	1	2	3	0	0	3	0	0
12	22230970	.	C	A	2	3	5	0	0	5	0	0
12	22237749	.	T	C	1	1	2	0	0	2	0	0
12	22310722	.	T	C	2	3	5	0	0	5	0	0
12	22311500	.	G	A	1	0	1	0	0	1	0	0
12	22373296	.	A	G	1	3	4	0	0	4	0	0
12	22407867	.	G	C	1	2	3	0	0	3	0	0
12	22407920	.	G	A	0	1	1	0	0	1	0	0
12	22409332	.	G	A	4	3	7	0	1	8	0	0
12	22410014	.	C	T	0	2	2	0	0	2	0	0
12	22410077	.	G	T	3	3	6	0	0	6	0	0
12	22412290	.	T	C	2	4	6	0	0	6	0	0
12	22412630	.	A	G	1	4	5	0	0	5	0	0
12	22415825	.	A	G	3	1	4	0	0	4	0	0
12	22415849	.	T	C	4	4	8	0	0	8	0	0
12	22415880	.	T	C	3	4	7	0	0	7	0	0
12	22418297	.	T	C	2	2	4	0	1	5	0	0
12	22420669	.	T	C	2	0	2	0	0	2	0	0
12	22431304	.	G	A	6	8	14	0	0	14	0	0
12	22433246	.	G	A	0	6	6	0	4	10	0	0
12	22435203	.	T	C	0	1	1	0	1	2	0	0
12	22444470	.	C	T	3	7	10	0	0	10	0	0
12	22444613	.	A	T	8	7	15	0	0	15	0	0
12	22444989	.	C	T	1	2	3	0	0	3	0	0
12	22450848	.	T	C	3	2	5	0	1	6	0	0
12	22451304	.	T	C	8	5	13	0	0	13	0	0
12	22451793	.	A	C	7	12	19	0	1	20	0	0
12	22451811	.	A	G	8	12	20	0	1	21	0	0
12	22456934	.	A	G	2	4	6	0	1	7	0	0
12	22460101	.	C	G	1	1	2	0	0	2	0	0
12	22460316	.	G	T	3	3	6	0	0	6	0	0
12	22462021	.	C	G	0	2	2	0	4	6	0	0
12	22467995	.	C	T	1	5	6	0	0	6	0	0
12	22468075	.	G	A	4	3	7	0	0	7	0	0
12	22468118	.	A	T	1	0	1	0	0	1	0	0
12	22468286	.	C	G	1	2	3	0	0	3	0	0
12	22470282	.	T	C	6	4	10	0	1	11	0	0
12	22470303	.	T	C	5	3	8	0	0	8	0	0
12	22471139	.	G	A	0	2	2	0	0	2	0	0
12	22473640	.	A	G	3	3	6	0	0	6	0	0
12	22473736	.	G	A	2	2	4	0	0	4	0	0
12	22480599	.	A	G	1	3	4	0	0	4	0	0
12	22480610	.	A	G	2	4	6	0	0	6	0	0
12	22480850	.	T	C	1	1	2	0	0	2	0	0
12	22480862	.	T	C	1	1	2	0	0	2	0	0
12	22480955	.	C	A	3	2	5	0	0	5	0	0
12	22481012	.	C	T	5	2	7	0	1	8	0	0
12	22487415	.	T	C	0	2	2	0	0	2	0	0
12	22528869	.	G	A	20	13	33	0	2	35	0	0
12	22529407	.	C	T	11	19	30	0	2	32	0	0
12	22529560	.	T	A	25	24	49	0	1	50	0	0
12	22529655	.	C	G	15	16	31	0	1	32	0	0
12	22529952	.	T	C	12	10	22	0	1	23	0	0
12	22530053	.	A	G	6	15	21	0	2	23	0	0
12	22530056	.	G	A	6	15	21	0	1	22	0	0
12	22530352	.	G	A	21	17	38	0	1	39	0	0
12	22530362	.	C	T	2	18	20	0	22	42	0	0
12	22530849	.	C	G	11	12	23	0	1	24	0	0
12	22531212	.	T	A	15	13	28	0	0	28	0	0
12	22531929	.	T	A	15	10	25	0	4	29	0	0
12	22532594	.	C	T	1	12	13	0	24	37	0	0
12	22533319	.	G	A	14	10	24	0	0	24	0	0
12	22533884	.	A	T	13	18	31	0	0	31	0	0
12	22534389	.	T	C	16	0	16	0	16	32	0	0
12	22534794	.	C	T	12	14	26	0	1	27	0	0
12	22535121	.	C	G	12	13	25	0	0	25	0	0
12	22535186	.	C	T	8	13	21	0	1	22	0	0
12	22535380	.	C	T	0	9	9	0	12	21	0	0
12	22535640	.	G	A	4	13	17	0	0	17	0	0
12	22536969	.	C	T	9	9	18	0	1	19	0	0
12	22537244	.	T	C	9	5	14	0	0	14	0	0
12	22537485	.	G	A	7	4	11	0	0	11	0	0
12	22560249	.	A	G	2	4	6	0	0	6	0	0
12	22562808	.	C	T	2	2	4	0	0	4	0	0
12	22563891	.	G	T	5	4	9	0	0	9	0	0
12	22565857	.	G	T	0	1	1	0	0	1	0	0
12	22565860	.	C	T	0	1	1	0	0	1	0	0
12	22568263	.	T	C	4	6	10	0	0	10	0	0
12	22569785	.	C	T	5	3	8	0	0	8	0	0
12	22570379	.	A	T	16	16	32	0	5	37	0	0
12	22570499	.	T	C	14	13	27	0	1	28	0	0
12	22571368	.	G	C	5	4	9	0	0	9	0	0
12	22571592	.	A	T	6	4	10	0	2	12	0	0
12	22572367	.	C	T	14	12	26	0	1	27	0	0
12	22572528	.	T	G	7	9	16	0	0	16	0	0
12	22572585	.	G	A	16	16	32	0	1	33	0	0
12	22572650	.	T	C	14	11	25	0	1	26	0	0
12	22572660	.	G	A	14	10	24	0	1	25	0	0
12	22572738	.	C	T	11	17	28	0	0	28	0	0
12	22572756	.	C	T	18	9	27	0	0	27	0	0
12	22572937	.	C	T	9	9	18	0	2	20	0	0
12	22573185	.	G	A	6	3	9	0	1	10	0	0
12	22628731	.	G	T	0	3	3	0	2	5	0	0
12	22628897	.	G	A	1	4	5	0	0	5	0	0
12	22628902	.	A	T	1	4	5	0	0	5	0	0
12	22643556	.	C	G	1	1	2	0	0	2	0	0
12	22643876	.	T	C	2	1	3	0	1	4	0	0
12	22644038	.	C	A	2	1	3	0	0	3	0	0
12	22644119	.	C	T	2	2	4	0	0	4	0	0
12	22644208	.	T	C	5	2	7	0	0	7	0	0
12	22644209	.	T	C	5	2	7	0	0	7	0	0
12	22644406	.	C	T	2	2	4	0	0	4	0	0
12	22644429	.	T	C	1	3	4	0	0	4	0	0
12	22644576	.	A	G	3	0	3	0	2	5	0	0
12	22644634	.	T	C	4	5	9	0	0	9	0	0
12	22644852	.	C	T	4	4	8	0	0	8	0	0
12	22644878	.	G	A	3	3	6	0	0	6	0	0
12	22644993	.	C	T	3	3	6	0	0	6	0	0
12	22644998	.	A	G	3	2	5	0	0	5	0	0
12	22645184	.	G	A	1	3	4	0	0	4	0	0
12	22645192	.	T	G	1	3	4	0	0	4	0	0
12	22668050	.	T	G	1	5	6	0	0	6	0	0
12	22774778	.	C	T	1	3	4	0	0	4	0	0
12	22774793	.	C	T	1	3	4	0	0	4	0	0
12	22780905	.	G	A	3	2	5	0	1	6	0	0
12	22814994	.	A	G	12	6	18	0	2	20	0	0
12	22815672	.	G	A	3	7	10	0	0	10	0	0
12	22905538	.	A	G	0	2	2	0	0	2	0	0
12	22921525	.	T	A	8	6	14	0	0	14	0	0
12	22927981	.	T	C	13	5	18	0	0	18	0	0
12	22932674	.	T	A	12	10	22	0	1	23	0	0
12	22932675	.	A	T	12	10	22	0	1	23	0	0
12	22932737	.	A	G	11	0	11	0	13	24	0	0
12	22962764	.	T	C	2	5	7	0	0	7	0	0
12	22962911	.	C	A	3	6	9	0	0	9	0	0
12	22963141	.	G	C	1	3	4	0	0	4	0	0
12	22963197	.	G	A	2	2	4	0	0	4	0	0
12	22963667	.	C	G	3	4	7	0	1	8	0	0
12	23001466	.	G	A	1	2	3	0	0	3	0	0
12	23009275	.	C	T	2	4	6	0	0	6	0	0
12	23385168	.	G	A	7	5	12	0	1	13	0	0
12	23400469	.	C	T	14	14	28	0	1	29	0	0
12	23403091	.	T	C	15	15	30	0	2	32	0	0
12	23403149	.	T	C	4	5	9	0	0	9	0	0
12	23406439	.	A	G	20	13	33	0	4	37	0	0
12	23415280	.	C	T	17	21	38	0	0	38	0	0
12	23415347	.	C	T	27	6	33	0	0	33	0	0
12	23415672	.	C	A	16	19	35	0	1	36	0	0
12	23415715	.	T	C	12	23	35	0	0	35	0	0
12	23415878	.	G	A	12	3	15	0	1	16	0	0
12	23424190	.	C	T	4	6	10	0	0	10	0	0
12	23429619	.	G	A	2	2	4	0	1	5	0	0
12	23430144	.	A	G	2	0	2	0	2	4	0	0
12	23665167	.	C	T	3	2	5	0	0	5	0	0
12	23674331	.	T	A	2	2	4	0	0	4	0	0
12	23674354	.	T	C	7	4	11	0	0	11	0	0
12	23674468	.	C	T	2	3	5	0	0	5	0	0
12	23674469	.	A	G	2	3	5	0	0	5	0	0
12	23784201	.	C	G	1	3	4	0	1	5	0	0
12	23784266	.	C	A	3	2	5	0	1	6	0	0
12	23786890	.	T	G	2	2	4	0	0	4	0	0
12	23787826	.	G	T	1	4	5	0	2	7	0	0
12	23787989	.	T	A	2	6	8	0	4	12	0	0
12	23788649	.	C	A	4	8	12	0	1	13	0	0
12	23788682	.	G	A	3	9	12	0	0	12	0	0
12	23794547	.	G	A	0	2	2	0	4	6	0	0
12	23795912	.	T	G	1	2	3	0	0	3	0	0
12	23850941	.	T	C	1	2	3	0	0	3	0	0
12	23867113	.	G	T	0	1	1	0	0	1	0	0
12	23870778	.	C	G	1	2	3	0	0	3	0	0
12	23870798	.	G	C	0	2	2	0	1	3	0	0
12	23912037	.	A	G	0	0	0	0	1	1	0	0
12	23917156	.	T	G	4	0	4	0	2	6	0	0
12	23917160	.	T	G	4	2	6	0	0	6	0	0
12	23917279	.	T	C	1	0	1	0	0	1	0	0
12	23920090	.	G	A	4	2	6	0	0	6	0	0
12	23923434	.	G	A	0	1	1	0	0	1	0	0
12	23925093	.	A	G	1	4	5	0	0	5	0	0
12	23932067	.	T	G	5	8	13	0	0	13	0	0
12	23991524	.	A	T	0	4	4	0	0	4	0	0
12	24030454	.	C	T	5	2	7	0	0	7	0	0
12	24036870	.	T	C	2	0	2	0	0	2	0	0
12	24038339	.	A	C	3	1	4	0	0	4	0	0
12	24038517	.	A	G	2	4	6	0	0	6	0	0
12	24038542	.	T	C	4	9	13	0	0	13	0	0
12	24041322	.	T	A	3	2	5	0	1	6	0	0
12	24041367	.	A	T	4	5	9	0	0	9	0	0
12	24041561	.	T	C	0	2	2	0	0	2	0	0
12	24043679	.	A	G	5	0	5	0	5	10	0	0
12	24043703	.	C	T	7	7	14	0	0	14	0	0
12	24043736	.	C	T	4	5	9	0	0	9	0	0
12	24043909	.	C	T	3	5	8	0	0	8	0	0
12	24043942	.	C	T	5	7	12	0	0	12	0	0
12	24045914	.	T	G	5	0	5	0	2	7	0	0
12	24051717	.	C	G	7	8	15	0	0	15	0	0
12	24051737	.	C	G	6	5	11	0	1	12	0	0
12	24051755	.	T	A	6	4	10	0	0	10	0	0
12	24051894	.	G	T	8	3	11	0	0	11	0	0
12	24052133	.	A	G	4	0	4	0	3	7	0	0
12	24052196	.	A	G	2	3	5	0	0	5	0	0
12	24052219	.	A	C	3	6	9	0	4	13	0	0
12	24052256	.	G	C	5	9	14	0	3	17	0	0
12	24052288	.	T	C	6	5	11	0	1	12	0	0
12	24342518	.	T	A	6	7	13	0	1	14	0	0
12	24342531	.	G	A	5	10	15	0	0	15	0	0
12	24342556	.	T	C	2	10	12	0	0	12	0	0
12	24345427	.	C	A	9	4	13	0	1	14	0	0
12	24345832	.	G	A	0	9	9	0	17	26	0	0
12	24465454	.	C	T	4	1	5	0	0	5	0	0
12	24465466	.	T	C	6	4	10	0	0	10	0	0
12	24465541	.	C	T	14	15	29	0	1	30	0	0
12	24465565	.	T	C	15	13	28	0	1	29	0	0
12	24465607	.	C	T	16	15	31	0	0	31	0	0
12	24484131	.	G	T	14	13	27	0	2	29	0	0
12	24484134	.	C	T	17	12	29	0	1	30	0	0
12	24484215	.	T	C	10	15	25	0	1	26	0	0
12	24561971	.	G	A	3	2	5	0	0	5	0	0
12	24562909	.	C	T	6	8	14	0	0	14	0	0
12	24606963	.	C	T	17	14	31	0	2	33	0	0
12	24635925	.	A	G	39	1	40	0	19	59	0	0
12	24636261	.	C	A	25	24	49	0	3	52	0	0
12	24636746	.	A	G	28	26	54	0	3	57	0	0
12	24637148	.	G	T	5	3	8	0	0	8	0	0
12	24796653	.	G	A	3	7	10	0	1	11	0	0
12	24797128	.	A	T	8	5	13	1	0	14	0	0
12	24797351	.	C	T	11	11	22	0	1	23	0	0
12	24797413	.	C	T	14	11	25	0	1	26	0	0
12	24797541	.	G	A	7	14	21	0	0	21	0	0
12	24797603	.	T	C	9	10	19	0	4	23	0	0
12	24797908	.	C	T	5	6	11	0	1	12	0	0
12	24811423	.	G	A	6	7	13	0	1	14	0	0
12	24811441	.	C	A	7	4	11	0	0	11	0	0
12	24811468	.	G	A	7	4	11	0	0	11	0	0
12	24832098	.	G	A	2	3	5	0	1	6	0	0
12	24842121	.	G	A	14	8	22	0	0	22	0	0
12	24842267	.	T	G	16	14	30	0	1	31	0	0
12	24843292	.	C	T	0	10	10	0	19	29	0	0
12	24843424	.	T	C	9	0	9	0	10	19	0	0
12	24847330	.	T	G	9	6	15	0	0	15	0	0
12	24848399	.	G	A	4	4	8	0	0	8	0	0
12	24851165	.	T	C	4	5	9	0	1	10	0	0
12	24851264	.	G	A	6	5	11	0	1	12	0	0
12	24851297	.	G	A	4	1	5	0	0	5	0	0
12	24857033	.	G	A	4	2	6	0	0	6	0	0
12	24857814	.	T	C	1	4	5	0	0	5	0	0
12	24906618	.	T	C	5	3	8	0	0	8	0	0
12	24910116	.	C	G	7	5	12	0	1	13	0	0
12	24910492	.	A	C	3	5	8	0	1	9	0	0
12	24913442	.	C	G	3	3	6	0	0	6	0	0
12	24913609	.	C	A	2	4	6	0	0	6	0	0
12	24917917	.	C	A	2	1	3	0	0	3	0	0
12	24918034	.	C	T	4	2	6	0	0	6	0	0
12	24918747	.	C	A	1	0	1	0	0	1	0	0
12	24920788	.	A	G	1	1	2	0	0	2	0	0
12	24922646	.	A	T	0	2	2	0	0	2	0	0
12	24953532	.	C	G	1	0	1	0	0	1	0	0
12	24957267	.	A	G	16	17	33	0	0	33	0	0
12	24957416	.	T	C	18	14	32	0	4	36	0	0
12	24957572	.	C	T	4	3	7	0	1	8	0	0
12	24957607	.	A	T	3	4	7	0	0	7	0	0
12	24957806	.	A	G	30	37	67	0	8	75	0	0
12	25043221	.	A	G	3	7	10	0	2	12	0	0
12	25043324	.	C	T	0	2	2	0	5	7	0	0
12	25043594	.	C	T	9	8	17	0	0	17	0	0
12	25044516	.	A	G	9	5	14	0	0	14	0	0
12	25044540	.	C	T	6	9	15	0	0	15	0	0
12	25044786	.	T	G	7	8	15	0	1	17	1	0
12	25045074	.	T	C	5	7	12	0	0	12	0	0
12	25045174	.	C	T	3	6	9	0	2	11	0	0
12	25065680	.	A	G	7	8	15	0	0	15	0	0
12	25094107	.	T	G	14	10	24	0	0	24	0	0
12	25094282	.	T	C	10	3	13	0	0	13	0	0
12	25094358	.	T	C	4	3	7	0	0	7	0	0
12	25094359	.	T	C	0	7	7	0	0	7	0	0
12	25094401	.	C	T	4	4	8	0	1	9	0	0
12	25094522	.	T	C	12	5	17	0	0	17	0	0
12	25094722	.	T	A	10	3	13	0	0	13	0	0
12	25230976	.	A	G	1	5	6	0	0	6	0	0
12	25251716	.	G	A	1	2	3	0	1	4	0	0
12	25254891	.	T	C	7	2	9	0	0	9	0	0
12	25271404	.	T	G	1	4	5	0	0	5	0	0
12	25271409	.	C	A	1	4	5	0	0	5	0	0
12	25271598	.	C	T	8	14	22	0	0	22	0	0
12	25284375	.	G	A	5	5	10	0	0	10	0	0
12	25284414	.	T	C	17	8	25	0	1	26	0	0
12	25284423	.	G	A	15	9	24	0	1	25	0	0
12	25377318	.	A	C	4	0	4	0	3	7	0	0
12	25377345	.	A	T	1	2	3	0	1	4	0	0
12	25377354	.	A	C	2	4	6	0	0	6	0	0
12	25377797	.	A	T	4	2	6	0	1	7	0	0
12	25377817	.	C	G	5	0	5	0	2	7	0	0
12	25378351	.	G	A	7	10	17	0	1	18	0	0
12	25378354	.	C	T	0	8	8	0	8	16	0	0
12	25378475	.	G	A	9	4	13	0	0	13	0	0
12	25378506	.	C	A	0	5	5	0	9	14	0	0
12	25378848	.	G	T	2	3	5	0	0	5	0	0
12	25378882	.	G	T	2	2	4	0	0	4	0	0
12	25467742	.	C	T	17	10	27	0	0	27	0	0
12	25467823	.	T	C	8	12	20	0	2	22	0	0
12	25467887	.	T	C	5	9	14	0	0	14	0	0
12	25468312	.	C	T	19	12	31	0	1	32	0	0
12	25472281	.	C	T	11	10	21	0	0	21	0	0
12	25472290	.	A	G	12	0	12	0	12	24	0	0
12	25484586	.	G	A	15	17	32	0	1	33	0	0
12	25484676	.	T	G	21	9	30	0	3	34	1	0
12	25485203	.	C	T	9	15	24	0	1	25	0	0
12	25600834	.	A	G	6	6	12	0	3	15	0	0
12	25602616	.	T	A	7	11	18	0	1	19	0	0
12	25602828	.	T	A	8	12	20	0	1	21	0	0
12	25713629	.	G	C	7	11	18	0	0	18	0	0
12	25714409	.	T	C	3	2	5	0	0	5	0	0
12	25714480	.	T	G	10	14	24	0	0	24	0	0
12	25754150	.	C	T	5	12	17	0	1	18	0	0
12	25754225	.	C	T	2	2	4	0	0	4	0	0
12	25768096	.	C	T	13	17	30	0	3	33	0	0
12	25768326	.	T	A	18	29	47	0	4	51	0	0
12	25768580	.	G	A	2	18	20	0	21	41	0	0
12	25768660	.	A	T	5	7	12	1	1	14	0	0
12	25768830	.	T	C	3	8	11	0	1	12	0	0
12	25769012	.	G	A	17	20	37	0	1	38	0	0
12	25769177	.	A	T	12	20	32	0	2	34	0	0
12	25769752	.	G	A	23	22	45	0	2	47	0	0
12	25769889	.	G	A	11	14	25	0	0	25	0	0
12	25828308	.	C	T	1	2	3	0	0	3	0	0
12	25828718	.	C	A	1	3	4	0	0	4	0	0
12	25828721	.	T	C	1	3	4	0	0	4	0	0
12	25828816	.	A	T	4	2	6	0	1	7	0	0
12	25829025	.	G	A	2	7	9	0	0	9	0	0
12	25829046	.	T	C	4	5	9	0	0	9	0	0
12	25829105	.	T	C	3	5	8	0	0	8	0	0
12	25845511	.	T	C	4	2	6	0	0	6	0	0
12	25845512	.	G	A	4	2	6	0	0	6	0	0
12	25846021	.	T	C	18	16	34	0	1	35	0	0
12	25856178	.	T	A	2	2	4	0	0	4	0	0
12	25861006	.	T	C	3	2	5	0	0	5	0	0
12	25866543	.	G	A	18	10	28	0	0	28	0	0
12	25872834	.	C	A	0	1	1	0	0	1	0	0
12	25872933	.	C	T	11	5	16	0	0	16	0	0
12	25872938	.	C	A	8	4	12	0	2	14	0	0
12	25873241	.	C	T	2	2	4	0	0	4	0	0
12	25873289	.	C	T	8	7	15	0	0	15	0	0
12	25881185	.	G	C	2	23	25	0	20	45	0	0
12	25881254	.	A	C	15	17	32	0	2	34	0	0
12	25881778	.	T	C	15	19	34	0	1	35	0	0
12	25951057	.	A	G	2	4	6	0	0	6	0	0
12	25951101	.	C	T	9	6	15	0	0	15	0	0
12	25951761	.	C	T	0	3	3	0	2	5	0	0
12	25951781	.	C	A	5	1	6	0	1	7	0	0
12	25952026	.	A	G	5	5	10	0	1	11	0	0
12	25952027	.	C	G	4	6	10	0	1	11	0	0
12	25953817	.	T	C	1	3	4	0	0	4	0	0
12	25954447	.	A	G	0	1	1	0	0	1	0	0
12	26002996	.	C	A	0	1	1	0	0	1	0	0
12	26096395	.	G	C	2	3	5	0	0	5	0	0
12	26203891	.	C	T	0	7	7	0	12	19	0	0
12	26203900	.	A	T	11	6	17	0	1	18	0	0
12	26226655	.	C	G	0	6	6	0	5	11	0	0
12	26227042	.	C	T	8	9	17	0	0	17	0	0
12	26241745	.	G	A	0	3	3	0	0	3	0	0
12	26249908	.	G	A	2	0	2	0	0	2	0	0
12	26318397	.	C	T	0	4	4	0	6	10	0	0
12	26318515	.	A	G	10	3	13	0	1	14	0	0
12	26318625	.	G	A	2	9	11	0	0	11	0	0
12	26318702	.	A	G	7	10	17	0	0	17	0	0
12	26411633	.	T	C	2	4	6	0	0	6	0	0
12	26411667	.	T	A	2	4	6	0	1	7	0	0
12	26411918	.	G	A	1	3	4	0	0	4	0	0
12	26412689	.	C	A	0	4	4	0	1	5	0	0
12	26412694	.	T	C	1	4	5	0	0	5	0	0
12	26476093	.	C	G	8	5	13	0	0	13	0	0
12	26476319	.	A	G	2	2	4	0	0	4	0	0
12	26476424	.	A	G	4	4	8	0	0	8	0	0
12	26486421	.	C	G	9	10	19	0	0	19	0	0
12	26486446	.	A	C	11	19	30	0	0	30	0	0
12	26486580	.	T	C	19	13	32	0	1	33	0	0
12	26486753	.	T	C	10	12	22	0	1	23	0	0
12	26486934	.	T	A	11	10	21	0	1	22	0	0
12	26487002	.	A	T	7	7	14	0	0	14	0	0
12	26487044	.	G	A	7	7	14	0	0	14	0	0
12	26487292	.	T	G	3	5	8	0	1	9	0	0
12	26489766	.	A	T	7	3	10	0	0	10	0	0
12	26491761	.	C	A	1	2	3	0	0	3	0	0
12	26493755	.	G	A	0	4	4	0	4	8	0	0
12	26493806	.	C	T	9	6	15	0	0	15	0	0
12	26493836	.	G	A	0	5	5	0	9	14	0	0
12	26493870	.	G	T	5	5	10	0	0	10	0	0
12	26524914	.	G	C	0	2	2	0	3	5	0	0
12	26542067	.	G	C	3	1	4	0	1	5	0	0
12	26546965	.	A	G	4	6	10	0	1	11	0	0
12	26546966	.	A	G	4	7	11	0	0	11	0	0
12	26547261	.	A	C	3	0	3	0	7	10	0	0
12	26547276	.	A	C	4	7	11	0	0	11	0	0
12	26547631	.	C	T	2	1	3	0	0	3	0	0
12	26547688	.	A	T	2	2	4	0	0	4	0	0
12	26549644	.	C	T	1	2	3	0	0	3	0	0
12	26549729	.	G	A	1	3	4	0	0	4	0	0
12	26587065	.	T	C	1	2	3	0	0	3	0	0
12	26594165	.	C	T	0	10	10	0	9	19	0	0
12	26594216	.	G	A	11	10	21	0	0	21	0	0
12	26597512	.	C	T	0	2	2	0	1	3	0	0
12	26608882	.	C	T	1	2	3	0	3	6	0	0
12	26611673	.	A	T	3	5	8	0	0	8	0	0
12	26612038	.	A	G	1	4	5	0	1	6	0	0
12	26612188	.	T	C	9	0	9	0	6	15	0	0
12	26612225	.	C	G	5	6	11	0	1	12	0	0
12	26612390	.	G	C	0	1	1	0	0	1	0	0
12	26617621	.	C	A	8	3	11	0	0	11	0	0
12	26617882	.	G	A	1	0	1	0	0	1	0	0
12	26620426	.	A	G	0	0	0	0	2	2	0	0
12	26620612	.	T	G	6	2	8	0	0	8	0	0
12	26638166	.	G	A	4	3	7	0	0	7	0	0
12	26638274	.	G	A	3	6	9	0	0	9	0	0
12	26638640	.	C	T	4	4	8	0	0	8	0	0
12	26693547	.	G	A	3	4	7	0	2	9	0	0
12	26708821	.	G	A	0	4	4	0	4	8	0	0
12	26724285	.	A	T	10	3	13	0	0	13	0	0
12	26724327	.	C	A	8	3	11	0	0	11	0	0
12	26724413	.	G	T	7	7	14	0	0	14	0	0
12	26724762	.	A	G	13	0	13	0	6	19	0	0
12	26724975	.	A	G	11	0	11	0	8	19	0	0
12	26724984	.	A	T	10	7	17	0	0	17	0	0
12	26725079	.	C	A	11	5	16	0	0	16	0	0
12	26725402	.	A	G	11	11	22	0	0	22	0	0
12	26750431	.	G	A	8	4	12	0	0	12	0	0
12	26750619	.	A	G	14	21	35	0	0	35	0	0
12	26750924	.	A	C	3	6	9	0	0	9	0	0
12	26751414	.	G	A	14	5	19	0	3	22	0	0
12	26751489	.	A	G	15	12	27	0	0	27	0	0
12	26752074	.	A	C	5	5	10	0	0	10	0	0
12	26752391	.	T	C	10	0	10	0	10	20	0	0
12	26752400	.	C	T	11	10	21	0	0	21	0	0
12	26752528	.	C	T	10	5	15	0	2	17	0	0
12	26752730	.	C	T	1	10	11	0	11	22	0	0
12	26752778	.	G	C	10	13	23	0	1	24	0	0
12	26752871	.	G	A	9	5	14	0	0	14	0	0
12	26752946	.	G	A	7	4	11	0	0	11	0	0
12	26758251	.	A	G	10	14	24	0	0	24	0	0
12	26758521	.	A	G	6	13	19	0	0	19	0	0
12	26758710	.	A	C	5	8	13	0	0	13	0	0
12	26758722	.	T	C	3	6	9	0	1	10	0	0
12	26758793	.	G	T	7	5	12	0	0	12	0	0
12	26761017	.	G	A	4	2	6	0	0	6	0	0
12	26764416	.	C	T	0	2	2	0	2	4	0	0
12	26960964	.	A	C	1	3	4	0	0	4	0	0
12	26961184	.	C	T	1	7	8	0	0	8	0	0
12	27023301	.	C	T	6	4	10	0	1	11	0	0
12	27023677	.	C	T	7	10	17	0	2	19	0	0
12	27025481	.	C	T	6	8	14	0	0	14	0	0
12	27026528	.	A	C	4	7	11	0	0	11	0	0
12	27029347	.	T	C	9	0	9	0	9	18	0	0
12	27029648	.	C	T	8	16	24	0	0	24	0	0
12	27030917	.	T	C	2	0	2	0	5	7	0	0
12	27036471	.	A	G	2	6	8	0	1	9	0	0
12	27036570	.	A	C	1	3	4	0	0	4	0	0
12	27037804	.	C	T	4	5	9	0	0	9	0	0
12	27037813	.	C	T	4	4	8	0	0	8	0	0
12	27050766	.	A	G	0	2	2	0	1	3	0	0
12	27059070	.	A	G	8	9	17	0	4	21	0	0
12	27059581	.	T	C	13	10	23	0	1	24	0	0
12	27059901	.	A	T	16	18	34	0	4	38	0	0
12	27059910	.	A	T	18	16	34	0	1	35	0	0
12	27060018	.	C	T	13	8	21	0	0	21	0	0
12	27060087	.	C	A	5	8	13	0	0	13	0	0
12	27060572	.	G	A	7	8	15	0	0	15	0	0
12	27061951	.	A	T	1	2	3	0	0	3	0	0
12	27066169	.	C	G	2	3	5	0	0	5	0	0
12	27068492	.	G	A	4	2	6	0	1	7	0	0
12	27068513	.	C	A	3	3	6	0	0	6	0	0
12	27072033	.	T	C	1	2	3	0	0	3	0	0
12	27073084	.	A	G	2	1	3	0	0	3	0	0
12	27073135	.	T	C	4	5	9	0	0	9	0	0
12	27078324	.	A	T	3	8	11	0	2	13	0	0
12	27086658	.	C	T	8	4	12	0	0	12	0	0
12	27086943	.	T	C	11	8	19	0	0	19	0	0
12	27086958	.	C	T	11	6	17	0	0	17	0	0
12	27087235	.	T	G	5	3	8	0	0	8	0	0
12	27087261	.	A	G	7	4	11	0	1	12	0	0
12	27087342	.	C	A	2	4	6	0	1	7	0	0
12	27087375	.	T	C	4	4	8	0	0	8	0	0
12	27087570	.	A	T	11	13	24	0	1	25	0	0
12	27087635	.	T	C	10	10	20	0	0	20	0	0
12	27087844	.	G	A	9	9	18	0	2	20	0	0
12	27088199	.	T	C	9	7	16	0	2	18	0	0
12	27088286	.	G	T	8	16	24	0	0	24	0	0
12	27088304	.	T	C	9	14	23	0	0	23	0	0
12	27088357	.	C	T	8	10	18	0	0	18	0	0
12	27088383	.	A	C	7	14	21	0	0	21	0	0
12	27088646	.	T	A	11	20	31	0	0	31	0	0
12	27088758	.	A	C	5	8	13	0	0	13	0	0
12	27088767	.	G	A	6	8	14	0	0	14	0	0
12	27088821	.	A	G	8	0	8	0	8	16	0	0
12	27088836	.	T	C	8	9	17	0	2	19	0	0
12	27089531	.	G	C	6	12	18	0	1	19	0	0
12	27089857	.	T	C	11	11	22	0	0	22	0	0
12	27090630	.	A	C	8	12	20	0	3	23	0	0
12	27090663	.	G	A	0	16	16	0	7	23	0	0
12	27090696	.	A	T	5	15	20	0	2	22	0	0
12	27090756	.	A	G	10	12	22	0	0	22	0	0
12	27090824	.	T	G	9	9	18	0	2	20	0	0
12	27090856	.	A	T	5	12	17	0	1	18	0	0
12	27090864	.	G	C	8	12	20	0	0	20	0	0
12	27090918	.	G	A	7	11	18	0	0	18	0	0
12	27091163	.	C	A	12	8	20	0	0	20	0	0
12	27091305	.	T	C	16	9	25	0	0	25	0	0
12	27127436	.	T	A	1	4	5	0	0	5	0	0
12	27128299	.	T	A	1	2	3	0	0	3	0	0
12	27128305	.	A	G	1	2	3	0	0	3	0	0
12	27130237	.	G	A	0	9	9	0	10	19	0	0
12	27131224	.	T	C	7	5	12	0	0	12	0	0
12	27207050	.	T	G	7	3	10	0	3	13	0	0
12	27207053	.	C	T	9	4	13	0	0	13	0	0
12	27207130	.	G	A	6	7	13	0	0	13	0	0
12	27207466	.	T	C	10	15	25	0	3	28	0	0
12	27218781	.	C	T	5	7	12	0	0	12	0	0
12	27219143	.	C	T	6	14	20	0	1	21	0	0
12	27219450	.	T	C	5	4	9	0	0	9	0	0
12	27219761	.	T	A	7	5	12	0	1	13	0	0
12	27219818	.	G	A	0	10	10	0	7	17	0	0
12	27220582	.	T	C	0	1	1	0	0	1	0	0
12	27221491	.	G	A	1	1	2	0	1	3	0	0
12	27221505	.	A	T	4	5	9	0	0	9	0	0
12	27224057	.	G	A	5	6	11	0	3	14	0	0
12	27224090	.	C	G	2	0	2	0	1	3	0	0
12	27229078	.	A	G	16	7	23	0	0	23	0	0
12	27229216	.	T	A	9	19	28	0	1	29	0	0
12	27229438	.	T	G	9	10	19	0	0	19	0	0
12	27229545	.	G	A	0	10	10	0	8	18	0	0
12	27229775	.	C	T	7	11	18	0	1	19	0	0
12	27243208	.	A	G	14	7	21	0	1	22	0	0
12	27243236	.	T	C	16	15	31	0	1	32	0	0
12	27303000	.	A	G	8	6	14	0	0	14	0	0
12	27303211	.	C	T	4	3	7	0	0	7	0	0
12	27303288	.	C	T	11	5	16	0	0	16	0	0
12	27303295	.	A	C	10	5	15	0	1	16	0	0
12	27303328	.	T	C	10	5	15	0	0	15	0	0
12	27303486	.	A	T	14	8	22	0	0	22	0	0
12	27303496	.	T	C	12	9	21	0	0	21	0	0
12	27303521	.	C	T	10	8	18	0	0	18	0	0
12	27304064	.	C	T	5	5	10	0	0	10	0	0
12	27304215	.	G	A	0	4	4	0	2	6	0	0
12	27304316	.	A	T	5	10	15	0	0	15	0	0
12	27304536	.	C	T	10	3	13	0	1	14	0	0
12	27304596	.	T	A	3	7	10	0	0	10	0	0
12	27304650	.	A	G	6	1	7	0	6	13	0	0
12	27304704	.	A	C	6	10	16	0	1	17	0	0
12	27305054	.	G	A	14	10	24	0	3	27	0	0
12	27305495	.	C	A	9	14	23	0	1	24	0	0
12	27305503	.	A	G	7	15	22	0	3	25	0	0
12	27557809	.	C	T	2	3	5	0	0	5	0	0
12	27558619	.	G	C	8	3	11	0	0	11	0	0
12	27558705	.	G	T	3	3	6	0	0	6	0	0
12	27563459	.	C	T	0	1	1	0	0	1	0	0
12	27566659	.	T	C	6	1	7	0	0	7	0	0
12	27568288	.	T	A	5	5	10	0	0	10	0	0
12	27570675	.	A	G	10	3	13	0	1	14	0	0
12	27570725	.	T	A	10	7	17	0	0	17	0	0
12	27570759	.	T	G	13	8	21	0	0	21	0	0
12	27570838	.	C	G	8	8	16	0	1	17	0	0
12	27570869	.	A	T	10	9	19	0	1	20	0	0
12	27570964	.	G	A	5	3	8	0	0	8	0	0
12	27571015	.	A	G	4	4	8	0	0	8	0	0
12	27571076	.	C	A	5	6	11	0	0	11	0	0
12	27571142	.	A	C	4	3	7	0	0	7	0	0
12	27571151	.	A	T	4	3	7	0	1	8	0	0
12	27571213	.	T	C	11	0	11	0	4	15	0	0
12	27571224	.	C	T	10	4	14	0	1	15	0	0
12	27571625	.	G	A	9	10	19	0	2	21	0	0
12	27573030	.	G	A	9	4	13	0	2	15	0	0
12	27573072	.	G	A	14	7	21	0	0	21	0	0
12	27575444	.	T	C	0	7	7	0	0	7	0	0
12	27575776	.	T	G	0	2	2	0	1	3	0	0
12	27584590	.	A	T	5	3	8	0	1	9	0	0
12	27584827	.	C	T	0	3	3	0	1	4	0	0
12	27586719	.	G	A	1	0	1	0	0	1	0	0
12	27591232	.	G	A	5	2	7	0	0	7	0	0
12	27593678	.	T	C	3	2	5	0	0	5	0	0
12	27593856	.	G	A	0	5	5	0	4	9	0	0
12	27593868	.	A	C	4	4	8	0	1	9	0	0
12	27593892	.	C	T	3	2	5	0	0	5	0	0
12	27593922	.	T	G	1	0	1	0	0	1	0	0
12	27602080	.	A	T	8	5	13	0	1	14	0	0
12	27615642	.	A	G	2	0	2	0	0	2	0	0
12	27622254	.	C	T	7	1	8	0	0	8	0	0
12	27622321	.	G	A	6	6	12	0	0	12	0	0
12	27622336	.	C	A	6	5	11	0	0	11	0	0
12	27627528	.	G	C	4	1	5	0	0	5	0	0
12	27665035	.	T	C	12	12	24	0	1	25	0	0
12	27665289	.	G	C	8	14	22	0	2	24	0	0
12	27665502	.	T	A	3	5	8	0	0	8	0	0
12	27665539	.	T	C	2	4	6	0	0	6	0	0
12	27902871	.	A	G	1	0	1	0	2	3	0	0
12	27906193	.	A	C	0	1	1	0	0	1	0	0
12	27926674	.	T	C	3	1	4	0	0	4	0	0
12	27943009	.	T	C	7	6	13	0	1	14	0	0
12	27999503	.	C	T	3	1	4	0	0	4	0	0
12	28033169	.	C	T	0	0	0	0	1	1	0	0
12	28049096	.	G	A	3	4	7	0	0	7	0	0
12	28178204	.	T	A	3	3	6	0	0	6	0	0
12	28179377	.	A	T	1	3	4	0	0	4	0	0
12	28180122	.	C	G	2	4	6	0	0	6	0	0
12	28180320	.	A	G	1	2	3	0	0	3	0	0
12	28298889	.	C	A	3	3	6	0	0	6	0	0
12	28348521	.	G	A	1	3	4	0	0	4	0	0
12	28350566	.	A	G	11	11	22	0	0	22	0	0
12	28351160	.	G	C	3	1	4	0	0	4	0	0
12	28355486	.	G	A	10	9	19	0	0	19	0	0
12	28367757	.	T	A	19	18	37	0	1	38	0	0
12	28369391	.	G	A	0	2	2	0	7	9	0	0
12	28369412	.	G	T	15	9	24	0	3	27	0	0
12	28369540	.	C	A	24	26	50	0	1	51	0	0
12	28369615	.	G	C	1	20	21	0	23	44	0	0
12	28369909	.	G	T	0	24	24	0	23	47	0	0
12	28369981	.	C	T	14	24	38	0	0	38	0	0
12	28370062	.	G	C	1	16	17	0	21	38	0	0
12	28370335	.	A	C	34	17	51	0	2	53	0	0
12	28370474	.	T	G	12	1	13	0	27	40	0	0
12	28377909	.	T	A	2	5	7	0	3	10	0	0
12	28378045	.	A	T	1	1	2	0	1	3	0	0
12	28378139	.	G	A	4	2	6	0	0	6	0	0
12	28378200	.	T	G	2	3	5	0	0	5	0	0
12	28378237	.	A	C	7	3	10	0	0	10	0	0
12	28378394	.	C	A	0	7	7	0	6	13	0	0
12	28378418	.	G	A	3	8	11	0	0	11	0	0
12	28378645	.	C	T	1	4	5	0	0	5	0	0
12	28378958	.	C	T	3	2	5	0	0	5	0	0
12	28379019	.	A	G	1	1	2	0	0	2	0	0
12	28379042	.	T	C	3	2	5	0	0	5	0	0
12	28379215	.	C	T	5	4	9	0	1	10	0	0
12	28379218	.	C	T	4	4	8	0	2	10	0	0
12	28379385	.	A	T	2	4	6	0	0	6	0	0
12	28379471	.	A	C	2	1	3	0	4	7	0	0
12	28379473	.	G	T	2	5	7	0	0	7	0	0
12	28379860	.	C	T	1	3	4	0	0	4	0	0
12	28380215	.	C	T	0	2	2	0	2	4	0	0
12	28449032	.	G	T	1	4	5	0	0	5	0	0
12	28476588	.	G	A	1	2	3	0	1	4	0	0
12	28497933	.	A	G	2	1	3	0	0	3	0	0
12	28559939	.	T	C	6	5	11	0	1	12	0	0
12	28559973	.	A	C	6	2	8	0	0	8	0	0
12	28560494	.	T	C	3	6	9	0	1	10	0	0
12	28560734	.	T	C	8	9	17	0	0	17	0	0
12	28560990	.	T	C	10	9	19	0	0	19	0	0
12	28561420	.	C	T	8	1	9	0	0	9	0	0
12	28561778	.	A	T	6	7	13	0	0	13	0	0
12	28566224	.	T	C	0	1	1	0	0	1	0	0
12	28568138	.	T	A	1	0	1	0	0	1	0	0
12	28568350	.	G	A	4	3	7	0	1	8	0	0
12	28570908	.	G	A	6	3	9	0	0	9	0	0
12	28668713	.	A	T	14	6	20	0	1	21	0	0
12	28676131	.	C	T	7	14	21	0	0	21	0	0
12	28676551	.	A	G	13	0	13	0	7	20	0	0
12	28676844	.	A	T	8	16	24	0	1	25	0	0
12	28677202	.	C	T	12	10	22	0	0	22	0	0
12	28677314	.	A	G	6	15	21	0	0	21	0	0
12	28677413	.	T	C	5	18	23	0	0	23	0	0
12	28677576	.	A	T	9	11	20	0	0	21	1	0
12	28797777	.	T	C	1	4	5	0	0	5	0	0
12	28800029	.	A	G	7	3	10	0	0	10	0	0
12	28801271	.	A	G	3	0	3	0	3	6	0	0
12	28806022	.	G	A	0	12	12	0	11	23	0	0
12	28806062	.	C	T	11	6	17	0	2	19	0	0
12	28806180	.	C	T	7	6	13	0	0	13	0	0
12	28806285	.	G	A	10	4	14	0	1	15	0	0
12	28806396	.	C	A	12	3	15	0	2	17	0	0
12	28806459	.	A	T	5	10	15	0	1	16	0	0
12	28806494	.	G	A	9	11	20	0	0	20	0	0
12	28806530	.	G	C	16	7	23	0	0	23	0	0
12	28806584	.	T	G	17	5	22	0	0	22	0	0
12	28806586	.	A	T	17	5	22	0	0	22	0	0
12	28806857	.	T	A	1	13	14	0	0	14	0	0
12	28806861	.	T	G	1	12	13	0	0	13	0	0
12	28827450	.	G	A	1	1	2	0	0	2	0	0
12	28827553	.	T	A	1	2	3	0	0	3	0	0
12	28827899	.	A	G	1	0	1	0	0	1	0	0
12	28828016	.	A	C	1	1	2	0	0	2	0	0
12	28828207	.	A	T	4	4	8	0	0	8	0	0
12	28828234	.	T	C	1	1	2	0	0	2	0	0
12	28828358	.	G	A	0	1	1	0	0	1	0	0
12	28830363	.	A	G	8	5	13	0	2	15	0	0
12	28844171	.	T	C	4	9	13	0	0	13	0	0
12	28847439	.	A	C	1	1	2	0	0	2	0	0
12	28856200	.	T	C	7	4	11	0	1	12	0	0
12	28856227	.	T	C	5	2	7	0	1	8	0	0
12	28863046	.	A	T	14	8	22	0	0	22	0	0
12	28863086	.	T	A	7	8	15	0	1	17	1	0
12	28863101	.	T	C	4	11	15	0	0	15	0	0
12	28863582	.	A	G	8	11	19	0	2	21	0	0
12	28863711	.	T	C	8	12	20	0	1	21	0	0
12	28863783	.	A	C	14	9	23	0	0	23	0	0
12	28863811	.	T	C	10	9	19	0	0	19	0	0
12	28864217	.	T	C	10	6	16	0	3	19	0	0
12	28864575	.	T	G	13	0	13	0	8	21	0	0
12	28864719	.	G	C	13	9	22	0	1	23	0	0
12	28864778	.	C	G	10	15	25	0	1	26	0	0
12	28864792	.	A	C	13	17	30	0	1	31	0	0
12	28864847	.	T	C	20	10	30	0	1	31	0	0
12	28865106	.	G	T	7	19	26	0	0	26	0	0
12	28865298	.	T	A	23	18	41	0	0	41	0	0
12	28865668	.	T	G	9	18	27	0	1	28	0	0
12	28865679	.	G	A	10	19	29	0	3	32	0	0
12	28865805	.	A	C	15	11	26	0	0	26	0	0
12	28870504	.	G	T	1	3	4	0	0	4	0	0
12	28870626	.	T	C	12	8	20	0	0	20	0	0
12	28870912	.	C	A	19	21	40	0	1	41	0	0
12	28871068	.	G	T	18	17	35	0	3	38	0	0
12	28871433	.	C	A	0	23	23	0	13	36	0	0
12	28878343	.	C	T	21	20	41	0	3	44	0	0
12	28900439	.	T	C	3	5	8	0	0	8	0	0
12	28916846	.	A	T	3	3	6	0	0	6	0	0
12	28918699	.	G	A	2	3	5	0	0	5	0	0
12	28924363	.	G	A	4	3	7	0	0	7	0	0
12	28927051	.	G	A	6	7	13	0	1	14	0	0
12	28930455	.	T	C	2	3	5	0	1	6	0	0
12	28932389	.	C	T	4	1	5	0	0	5	0	0
12	28932428	.	C	T	11	4	15	0	0	15	0	0
12	28932571	.	G	A	7	5	12	0	1	13	0	0
12	28932581	.	T	A	7	6	13	0	1	14	0	0
12	28948117	.	T	C	7	3	10	0	0	10	0	0
12	28949067	.	A	G	4	5	9	0	2	11	0	0
12	28949112	.	C	A	3	6	9	0	0	9	0	0
12	28950678	.	G	T	1	3	4	0	2	6	0	0
12	28952139	.	T	C	6	7	13	0	1	14	0	0
12	28956533	.	A	G	5	0	5	0	3	8	0	0
12	28956566	.	T	C	4	1	5	0	0	5	0	0
12	28960284	.	T	C	4	9	13	0	0	13	0	0
12	28960321	.	G	A	8	2	10	0	1	11	0	0
12	28960357	.	G	A	0	3	3	0	5	8	0	0
12	29055068	.	A	T	2	5	7	0	1	8	0	0
12	29084032	.	T	C	3	3	6	0	1	7	0	0
12	29102585	.	T	C	13	11	24	0	0	24	0	0
12	29103004	.	T	C	7	7	14	0	0	14	0	0
12	29103041	.	T	A	3	9	12	0	0	12	0	0
12	29105508	.	A	T	6	3	9	0	1	10	0	0
12	29105510	.	A	T	6	3	9	0	1	10	0	0
12	29173678	.	C	G	2	3	5	0	1	6	0	0
12	29207101	.	T	C	0	2	2	0	0	2	0	0
12	29207473	.	G	A	0	5	5	0	2	7	0	0
12	29207533	.	T	C	2	5	7	0	0	7	0	0
12	29207590	.	G	A	0	5	5	0	5	10	0	0
12	29207683	.	G	T	7	13	20	0	0	20	0	0
12	29208099	.	T	G	4	6	10	0	2	12	0	0
12	29209834	.	G	A	5	3	8	0	0	8	0	0
12	29209840	.	A	T	5	3	8	0	0	8	0	0
12	29210371	.	C	A	14	7	21	0	1	22	0	0
12	29210435	.	C	G	9	11	20	0	0	20	0	0
12	29210600	.	C	T	8	8	16	0	0	16	0	0
12	29210719	.	T	A	9	18	27	0	0	27	0	0
12	29211017	.	C	T	4	6	10	0	1	11	0	0
12	29211082	.	G	A	5	8	13	0	1	14	0	0
12	29211195	.	T	A	8	7	15	0	1	16	0	0
12	29211232	.	G	A	0	14	14	0	9	23	0	0
12	29211289	.	T	A	12	19	31	0	0	31	0	0
12	29211292	.	A	G	10	19	29	0	2	31	0	0
12	29223498	.	A	G	1	7	8	0	0	8	0	0
12	29223612	.	T	G	2	4	6	0	0	6	0	0
12	29223689	.	G	A	3	2	5	0	0	5	0	0
12	29223811	.	C	A	4	3	7	0	0	7	0	0
12	29223847	.	C	T	3	2	5	0	0	5	0	0
12	29223921	.	G	A	1	4	5	0	0	5	0	0
12	29224065	.	G	A	3	2	5	0	1	6	0	0
12	29224250	.	T	G	2	2	4	0	0	4	0	0
12	29224310	.	A	G	2	2	4	0	0	4	0	0
12	29224326	.	T	G	2	2	4	0	0	4	0	0
12	29226573	.	A	T	1	2	3	0	1	4	0	0
12	29226752	.	T	A	2	2	4	0	0	4	0	0
12	29226876	.	C	A	0	2	2	0	2	4	0	0
12	29227044	.	G	A	2	2	4	0	0	4	0	0
12	29251251	.	T	C	4	3	7	0	1	8	0	0
12	29258629	.	G	T	2	2	4	0	0	4	0	0
12	29260865	.	A	G	2	2	4	0	0	4	0	0
12	29266917	.	T	C	6	6	12	0	0	12	0	0
12	29269576	.	C	A	5	4	9	0	0	9	0	0
12	29269689	.	G	A	3	6	9	0	0	9	0	0
12	29269695	.	A	G	3	0	3	0	5	8	0	0
12	29269726	.	C	G	3	3	6	0	0	6	0	0
12	29269770	.	G	T	0	3	3	0	4	7	0	0
12	29269774	.	T	G	4	3	7	0	0	7	0	0
12	29350773	.	C	A	2	2	4	0	0	4	0	0
12	29351320	.	A	G	18	16	34	0	3	37	0	0
12	29351810	.	A	G	19	17	36	0	2	38	0	0
12	29358277	.	T	C	3	4	7	0	0	7	0	0
12	29358370	.	G	C	10	1	11	0	9	20	0	0
12	29358384	.	A	G	7	4	11	0	2	13	0	0
12	29358418	.	A	G	0	2	2	0	0	2	0	0
12	29624017	.	G	A	12	18	30	0	2	32	0	0
12	29624272	.	C	A	9	6	15	0	0	15	0	0
12	29624611	.	T	C	4	0	4	0	5	9	0	0
12	29764201	.	C	T	1	2	3	0	1	4	0	0
12	29801179	.	T	C	5	5	10	0	0	10	0	0
12	29801600	.	T	A	1	0	1	0	0	1	0	0
12	29806358	.	C	G	1	0	1	0	0	1	0	0
12	29843460	.	A	G	12	20	32	0	0	32	0	0
12	29844434	.	T	C	7	15	22	0	0	22	0	0
12	29873273	.	C	G	0	1	1	0	0	1	0	0
12	29921114	.	T	G	5	4	9	0	0	9	0	0
12	29947132	.	A	G	3	6	9	0	0	9	0	0
12	29947147	.	C	A	2	5	7	0	0	7	0	0
12	29957074	.	C	T	4	7	11	0	1	12	0	0
12	29957164	.	C	T	5	8	13	0	0	13	0	0
12	29965655	.	G	A	1	1	2	0	0	2	0	0
12	29965724	.	G	A	5	6	11	0	0	11	0	0
12	29965928	.	C	T	3	4	7	0	0	7	0	0
12	29965967	.	G	A	7	3	10	0	0	10	0	0
12	29966039	.	T	C	0	3	3	0	0	3	0	0
12	29966048	.	T	C	3	0	3	0	0	3	0	0
12	29968087	.	T	C	3	0	3	0	2	5	0	0
12	29973800	.	G	A	2	5	7	0	0	7	0	0
12	29976936	.	G	A	4	3	7	0	0	7	0	0
12	29976978	.	T	C	1	1	2	0	0	2	0	0
12	30031336	.	T	C	2	2	4	0	0	4	0	0
12	30031338	.	G	A	1	2	3	0	1	4	0	0
12	30031531	.	T	A	2	3	5	0	0	5	0	0
12	30036731	.	T	A	2	2	4	0	1	5	0	0
12	30109823	.	A	G	3	3	6	0	0	6	0	0
12	30109838	.	C	T	4	5	9	0	0	9	0	0
12	30129351	.	C	T	1	0	1	0	0	1	0	0
12	30156449	.	T	C	1	1	2	0	0	2	0	0
12	30192526	.	A	T	6	8	14	0	0	14	0	0
12	30200741	.	C	T	7	4	11	0	0	11	0	0
12	30207912	.	G	A	1	0	1	0	0	1	0	0
12	30208905	.	T	C	0	4	4	0	0	4	0	0
12	30211165	.	T	A	0	1	1	0	0	1	0	0
12	30216034	.	C	A	5	3	8	0	0	8	0	0
12	30216090	.	G	T	5	2	7	0	0	7	0	0
12	30216248	.	C	T	5	3	8	0	1	9	0	0
12	30216436	.	T	C	3	4	7	0	0	7	0	0
12	30216693	.	C	T	6	3	9	0	0	9	0	0
12	30216697	.	G	A	1	3	4	0	5	9	0	0
12	30217569	.	A	G	1	8	9	0	0	9	0	0
12	30217589	.	A	T	3	9	12	0	1	13	0	0
12	30217705	.	G	A	1	3	4	0	3	7	0	0
12	30217747	.	C	T	3	2	5	0	0	5	0	0
12	30217782	.	T	G	3	4	7	0	0	7	0	0
12	30217783	.	C	A	4	2	6	0	1	7	0	0
12	30217893	.	C	A	3	4	7	0	1	8	0	0
12	30217898	.	T	A	3	5	8	0	0	8	0	0
12	30217966	.	G	A	7	5	12	0	0	12	0	0
12	30217986	.	C	T	4	6	10	0	0	10	0	0
12	30218135	.	C	A	3	3	6	0	0	6	0	0
12	30218150	.	G	A	4	7	11	0	0	11	0	0
12	30218173	.	C	T	6	3	9	0	1	10	0	0
12	30218226	.	A	G	12	4	16	0	0	16	0	0
12	30219306	.	A	T	15	10	25	0	3	28	0	0
12	30219687	.	T	A	5	8	13	0	1	14	0	0
12	30219694	.	A	T	3	7	10	0	2	13	1	0
12	30219739	.	G	A	4	1	5	0	2	7	0	0
12	30219804	.	C	T	10	6	16	0	0	16	0	0
12	30292463	.	A	G	1	0	1	0	1	2	0	0
12	30299061	.	T	C	2	2	4	0	0	4	0	0
12	30299073	.	C	T	1	2	3	0	0	3	0	0
12	30303081	.	C	A	3	3	6	0	0	6	0	0
12	30307913	.	G	T	4	15	19	0	4	23	0	0
12	30372463	.	G	A	0	6	6	0	4	10	0	0
12	30372763	.	G	A	0	2	2	0	0	2	0	0
12	30382341	.	C	T	3	5	8	0	1	9	0	0
12	30383960	.	G	A	0	5	5	0	2	7	0	0
12	30385562	.	C	T	3	3	6	0	0	6	0	0
12	30391136	.	G	A	3	1	4	0	0	4	0	0
12	30418108	.	T	C	9	11	20	0	0	20	0	0
12	30418513	.	C	G	8	10	18	0	1	19	0	0
12	30419123	.	A	T	6	4	10	0	3	13	0	0
12	30419134	.	C	A	5	11	16	0	0	16	0	0
12	30419260	.	T	G	11	9	20	0	0	20	0	0
12	30419646	.	T	C	3	17	20	0	1	21	0	0
12	30419655	.	T	C	4	14	18	0	0	18	0	0
12	30419695	.	T	C	4	7	11	0	0	11	0	0
12	30419727	.	A	G	3	5	8	0	0	8	0	0
12	30442406	.	C	A	7	4	11	0	0	11	0	0
12	30442783	.	G	A	7	11	18	0	1	19	0	0
12	30443462	.	T	C	7	4	11	0	0	11	0	0
12	30459404	.	G	A	3	3	6	0	0	6	0	0
12	30459422	.	A	C	2	3	5	0	0	5	0	0
12	30461015	.	G	T	1	2	3	0	0	3	0	0
12	30461066	.	T	C	2	0	2	0	2	4	0	0
12	30504745	.	T	C	1	2	3	0	0	3	0	0
12	30569921	.	G	A	1	2	3	0	0	3	0	0
12	30706173	.	T	A	6	5	11	0	0	11	0	0
12	30706176	.	T	C	6	5	11	0	0	11	0	0
12	30793107	.	C	T	3	2	5	0	0	5	0	0
12	30796306	.	C	T	0	3	3	0	0	3	0	0
12	30796322	.	C	A	3	2	5	0	0	5	0	0
12	30796345	.	C	T	4	2	6	0	1	7	0	0
12	30798079	.	G	A	7	3	10	0	0	10	0	0
12	30798085	.	A	T	3	7	10	0	0	10	0	0
12	30800128	.	G	A	2	4	6	0	0	6	0	0
12	30803166	.	G	A	0	4	4	0	5	9	0	0
12	30803196	.	T	C	8	6	14	0	0	14	0	0
12	30803629	.	A	G	5	1	6	0	0	6	0	0
12	30805335	.	T	C	1	2	3	0	0	3	0	0
12	30805359	.	T	C	2	3	5	0	0	5	0	0
12	30805455	.	C	T	5	4	9	0	0	9	0	0
12	30806928	.	G	T	1	5	6	0	5	11	0	0
12	30807038	.	A	G	10	11	21	0	1	22	0	0
12	30807245	.	A	G	0	4	4	0	3	7	0	0
12	30807290	.	A	G	3	5	8	0	0	8	0	0
12	30807330	.	T	A	3	5	8	0	0	8	0	0
12	30807361	.	C	A	2	7	9	0	1	10	0	0
12	30807369	.	T	C	2	7	9	0	1	10	0	0
12	30807494	.	G	A	5	8	13	0	0	13	0	0
12	30807504	.	A	C	6	7	13	0	0	13	0	0
12	30807789	.	A	C	2	6	8	0	0	8	0	0
12	30808094	.	C	T	6	3	9	0	0	9	0	0
12	30808150	.	T	A	4	5	9	0	0	9	0	0
12	30808342	.	A	T	4	6	10	0	0	10	0	0
12	30808531	.	G	C	11	6	17	0	0	17	0	0
12	30808766	.	C	T	3	6	9	0	0	9	0	0
12	30808817	.	T	G	2	6	8	0	0	8	0	0
12	30979815	.	A	C	10	10	20	0	3	23	0	0
12	30980566	.	G	A	29	17	46	0	4	50	0	0
12	30981795	.	G	A	29	23	52	0	2	54	0	0
12	30986452	.	G	A	2	0	2	0	1	3	0	0
12	31012667	.	C	T	2	3	5	0	0	5	0	0
12	31012687	.	C	A	2	2	4	0	0	4	0	0
12	31102981	.	A	G	12	9	21	0	2	23	0	0
12	31435977	.	T	A	1	1	2	0	0	2	0	0
12	31438056	.	G	T	7	9	16	0	0	16	0	0
12	31438352	.	A	T	5	9	14	0	1	15	0	0
12	31438440	.	C	A	2	2	4	0	0	4	0	0
12	31516068	.	T	C	1	0	1	0	0	1	0	0
12	31523203	.	T	C	2	0	2	0	0	2	0	0
12	31531950	.	T	G	4	5	9	0	2	11	0	0
12	31532342	.	A	C	8	10	18	0	0	18	0	0
12	31532371	.	G	A	0	7	7	0	6	13	0	0
12	31532397	.	G	C	5	3	8	0	0	8	0	0
12	31532577	.	T	C	7	3	10	0	0	10	0	0
12	31532638	.	A	C	10	4	14	0	0	14	0	0
12	31532715	.	T	C	3	5	8	0	0	8	0	0
12	31629611	.	C	T	2	3	5	0	1	6	0	0
12	31630829	.	G	A	0	3	3	0	2	5	0	0
12	31664770	.	T	A	2	3	5	0	0	5	0	0
12	31664846	.	A	T	3	2	5	0	0	5	0	0
12	31689567	.	T	A	2	2	4	0	0	4	0	0
12	31694713	.	C	T	1	3	4	0	2	6	0	0
12	31704077	.	A	C	4	2	6	0	0	6	0	0
12	31704458	.	G	A	0	6	6	0	2	8	0	0
12	31704485	.	A	G	1	0	1	0	6	7	0	0
12	31704548	.	T	C	2	3	5	0	0	5	0	0
12	31708020	.	C	T	3	5	8	0	0	8	0	0
12	31708025	.	G	A	3	3	6	0	1	7	0	0
12	31708082	.	G	A	3	3	6	0	1	7	0	0
12	31708125	.	C	A	2	4	6	0	0	6	0	0
12	31720799	.	C	T	10	19	29	0	4	33	0	0
12	31721486	.	G	A	8	7	15	0	1	16	0	0
12	31722593	.	G	T	15	16	31	0	1	32	0	0
12	31722811	.	G	T	14	13	27	0	2	29	0	0
12	31722875	.	A	C	14	3	17	0	15	32	0	0
12	31724245	.	A	C	24	22	46	0	0	46	0	0
12	31724252	.	C	T	24	21	45	0	1	46	0	0
12	31729236	.	G	A	6	11	17	0	2	19	0	0
12	31729441	.	A	C	2	6	8	0	0	8	0	0
12	31729455	.	G	T	2	6	8	0	0	8	0	0
12	31740733	.	T	C	1	2	3	0	0	3	0	0
12	31740822	.	C	T	2	5	7	0	0	7	0	0
12	31753752	.	C	T	4	8	12	0	1	13	0	0
12	31753755	.	C	T	3	9	12	0	1	13	0	0
12	31764523	.	T	C	6	11	17	0	2	19	0	0
12	31764526	.	C	A	5	13	18	0	0	18	0	0
12	31765407	.	G	A	14	10	24	0	0	24	0	0
12	31765485	.	G	A	14	7	21	0	0	21	0	0
12	31765517	.	T	C	14	4	18	0	0	18	0	0
12	31765540	.	T	G	15	4	19	0	0	19	0	0
12	31783185	.	G	A	0	4	4	0	0	4	0	0
12	31785314	.	C	T	0	1	1	0	0	1	0	0
12	31789799	.	C	T	13	13	26	0	0	26	0	0
12	31794655	.	G	A	1	1	2	0	0	2	0	0
12	31919143	.	T	G	0	1	1	0	1	2	0	0
12	32039443	.	C	T	1	6	7	0	11	18	0	0
12	32039527	.	A	G	14	8	22	0	0	22	0	0
12	32039546	.	G	A	12	8	20	0	0	20	0	0
12	32039635	.	A	C	16	14	30	0	1	31	0	0
12	32039678	.	C	T	14	26	40	0	1	41	0	0
12	32039937	.	G	A	18	19	37	0	3	40	0	0
12	32039958	.	T	C	19	0	19	0	20	39	0	0
12	32040093	.	G	A	26	18	44	0	0	44	0	0
12	32045155	.	G	A	19	13	32	0	0	32	0	0
12	32045212	.	T	C	17	1	18	0	14	32	0	0
12	32051488	.	G	A	0	1	1	0	0	1	0	0
12	32066061	.	C	A	13	9	22	0	0	22	0	0
12	33351045	.	T	C	3	6	9	0	0	9	0	0
12	33604491	.	A	C	1	2	3	0	0	3	0	0
12	33738703	.	T	A	3	3	6	0	1	7	0	0
12	33935273	.	G	A	5	3	8	0	5	13	0	0
12	33966790	.	T	G	23	23	46	0	4	50	0	0
12	33966886	.	A	G	20	20	40	0	2	42	0	0
12	33966905	.	C	T	14	18	32	0	2	34	0	0
12	33967283	.	C	T	17	14	31	0	2	33	0	0
12	33968073	.	T	A	18	19	37	0	1	38	0	0
12	33988140	.	T	G	2	4	6	0	1	7	0	0
12	33988266	.	C	T	2	6	8	0	0	8	0	0
12	33988623	.	G	C	4	6	10	0	1	11	0	0
12	33991521	.	G	A	15	17	32	0	1	33	0	0
12	33991622	.	T	C	15	16	31	0	0	31	0	0
12	33991781	.	T	C	15	33	48	0	3	51	0	0
12	33991867	.	A	T	23	15	38	0	1	39	0	0
12	33991882	.	T	A	20	18	38	0	1	40	1	0
12	33991987	.	A	C	26	26	52	0	0	52	0	0
12	33992208	.	A	C	11	10	21	1	6	28	0	0
12	33992813	.	C	A	17	22	39	0	2	41	0	0
12	33993008	.	T	A	13	19	32	0	2	34	0	0
12	33993152	.	A	T	21	21	42	0	1	44	1	0
12	33993320	.	C	T	0	2	2	0	5	7	0	0
12	33997324	.	G	A	1	1	2	0	0	2	0	0
12	34119508	.	A	G	1	0	1	0	2	3	0	0
12	34119635	.	G	A	2	0	2	0	0	2	0	0
12	34180040	.	C	A	4	9	13	0	0	13	0	0
12	34180771	.	C	T	3	3	6	0	0	6	0	0
12	34187407	.	A	G	5	0	5	0	6	11	0	0
12	34192041	.	G	A	0	3	3	0	3	6	0	0
12	34192454	.	C	T	4	5	9	0	1	10	0	0
12	34192551	.	C	T	5	7	12	0	0	12	0	0
12	34192679	.	T	C	7	7	14	0	0	14	0	0
12	34209402	.	T	A	3	2	5	0	1	6	0	0
12	34209468	.	G	C	3	0	3	0	2	5	0	0
12	34219670	.	C	T	0	4	4	0	5	9	0	0
12	34378829	.	G	A	1	3	4	0	0	4	0	0
12	34434681	.	T	A	0	2	2	0	0	2	0	0
12	34435143	.	T	A	1	1	2	0	0	2	0	0
12	34445017	.	G	A	1	1	2	0	0	2	0	0
12	34563459	.	G	T	2	1	3	0	0	5	2	0
12	34563469	.	T	C	3	4	7	0	0	7	0	0
12	34564123	.	A	G	5	3	8	0	0	8	0	0
12	34564416	.	A	G	2	2	4	0	0	4	0	0
12	34564646	.	T	C	3	0	3	0	3	6	0	0
12	34564786	.	G	A	6	6	12	0	0	12	0	0
12	34564904	.	A	T	4	4	8	0	0	8	0	0
12	34565200	.	A	C	4	4	8	0	0	8	0	0
12	34565223	.	T	C	1	5	6	0	0	6	0	0
12	34565311	.	C	T	3	5	8	0	0	8	0	0
12	34565354	.	C	G	5	5	10	0	0	10	0	0
12	34565441	.	A	G	5	4	9	0	0	9	0	0
12	34565504	.	A	G	2	5	7	0	0	7	0	0
12	34565787	.	T	A	4	4	8	0	1	9	0	0
12	34566022	.	C	T	8	5	13	0	0	13	0	0
12	34566547	.	T	A	1	5	6	0	0	6	0	0
12	34566715	.	C	T	5	2	7	0	0	7	0	0
12	34568320	.	A	C	2	1	3	0	0	3	0	0
12	34568321	.	C	A	2	1	3	0	0	3	0	0
12	34574380	.	T	C	1	3	4	0	0	4	0	0
12	34574413	.	G	A	3	5	8	0	0	8	0	0
12	34574416	.	T	A	4	3	7	0	1	8	0	0
12	34580590	.	C	T	4	2	6	0	0	6	0	0
12	34583025	.	C	A	0	0	0	0	1	1	0	0
12	34606935	.	C	A	2	4	6	0	0	6	0	0
12	34607231	.	C	G	3	4	7	0	0	7	0	0
12	34614652	.	C	T	0	1	1	0	0	1	0	0
12	34732862	.	A	T	1	2	3	0	0	3	0	0
12	34820013	.	G	A	2	4	6	0	0	6	0	0
12	34820574	.	C	A	3	4	7	0	2	9	0	0
12	34826663	.	G	T	1	0	1	0	0	1	0	0
12	34834887	.	G	T	0	1	1	0	0	1	0	0
12	34834943	.	A	G	1	0	1	0	0	1	0	0
12	34837395	.	G	A	0	1	1	0	2	3	0	0
12	34841852	.	C	T	5	4	9	0	0	9	0	0
12	34841886	.	A	T	3	4	7	0	0	7	0	0
12	34841897	.	C	G	4	3	7	0	0	7	0	0
12	34845018	.	A	T	2	2	4	0	0	4	0	0
12	34845413	.	T	A	3	3	6	0	0	6	0	0
12	34845623	.	C	G	1	4	5	0	0	5	0	0
12	34845669	.	T	G	3	4	7	0	0	7	0	0
12	34845923	.	C	A	4	4	8	0	1	9	0	0
12	34846103	.	C	A	5	2	7	0	0	7	0	0
12	34846581	.	T	C	3	1	4	0	3	7	0	0
12	34847004	.	C	A	2	2	4	0	0	4	0	0
12	34847077	.	T	G	1	5	6	0	0	6	0	0
12	34847234	.	A	T	11	5	16	0	0	16	0	0
12	34847949	.	G	A	5	9	14	0	0	14	0	0
12	34851117	.	G	A	6	3	9	0	0	9	0	0
12	34859100	.	T	A	1	4	5	0	0	5	0	0
12	34876712	.	A	G	5	5	10	0	1	11	0	0
12	34876827	.	A	G	6	4	10	0	0	10	0	0
12	34877048	.	T	A	7	5	12	0	0	12	0	0
12	34883556	.	A	C	7	7	14	0	0	14	0	0
12	34883557	.	G	A	7	7	14	0	0	14	0	0
12	34883640	.	G	A	2	5	7	0	0	7	0	0
12	34884018	.	T	C	4	3	7	0	0	7	0	0
12	34884446	.	C	T	0	2	2	0	5	7	0	0
12	34891681	.	C	T	15	17	32	0	1	33	0	0
12	34892024	.	A	G	13	5	18	0	0	18	0	0
12	34892590	.	T	A	14	10	24	0	0	24	0	0
12	34953641	.	G	T	0	4	4	0	5	9	0	0
12	34981205	.	G	A	0	2	2	0	12	14	0	0
12	35012004	.	C	T	10	12	22	0	0	22	0	0
12	35012127	.	T	C	6	5	11	0	0	11	0	0
12	35014147	.	C	A	5	3	8	0	0	8	0	0
12	35018127	.	C	T	18	23	41	0	1	42	0	0
12	35018320	.	T	G	13	0	13	0	11	24	0	0
12	35021590	.	G	T	3	4	7	0	1	8	0	0
12	35021593	.	G	A	3	2	5	0	2	7	0	0
12	35051265	.	C	T	12	8	20	0	1	21	0	0
12	35082428	.	C	T	0	1	1	0	0	1	0	0
12	35095272	.	T	G	0	2	2	0	1	3	0	0
12	35099775	.	C	A	0	3	3	0	3	6	0	0
12	35103300	.	C	T	5	3	8	0	0	8	0	0
12	35103606	.	T	C	5	0	5	0	5	10	0	0
12	35119833	.	C	A	8	7	15	0	0	15	0	0
12	35146537	.	G	A	0	3	3	0	3	6	0	0
12	35158344	.	C	T	4	5	9	0	0	9	0	0
12	35167333	.	A	G	2	0	2	0	0	2	0	0
12	35178914	.	G	A	8	12	20	0	0	20	0	0
12	35189264	.	G	T	8	10	18	0	0	18	0	0
12	35189295	.	C	T	12	12	24	0	2	26	0	0
12	35189471	.	T	A	2	4	6	0	0	6	0	0
12	35191841	.	T	A	10	6	16	0	1	17	0	0
12	35191856	.	C	T	4	9	13	0	1	14	0	0
12	35316791	.	C	A	3	4	7	0	0	7	0	0
12	35317222	.	A	G	7	3	10	0	0	10	0	0
12	35317294	.	A	G	2	0	2	0	3	5	0	0
12	35317520	.	C	A	2	5	7	0	0	7	0	0
12	35317609	.	C	T	2	3	5	0	0	5	0	0
12	35325591	.	G	T	1	2	3	0	0	3	0	0
12	35325618	.	C	A	5	2	7	0	0	7	0	0
12	35328139	.	C	T	3	3	6	0	0	6	0	0
12	35330107	.	C	T	2	6	8	0	0	8	0	0
12	35332283	.	T	A	4	2	6	0	0	6	0	0
12	35334652	.	C	G	4	4	8	0	0	8	0	0
12	35339212	.	A	G	5	4	9	0	0	9	0	0
12	35339263	.	A	T	7	5	12	0	1	13	0	0
12	35339395	.	C	T	4	3	7	0	0	7	0	0
12	35346498	.	G	A	6	21	27	0	0	27	0	0
12	35346597	.	A	T	23	30	53	0	2	55	0	0
12	35346842	.	T	C	10	24	34	0	1	35	0	0
12	35346873	.	C	T	20	30	50	0	0	50	0	0
12	35347002	.	A	T	24	19	43	0	0	43	0	0
12	35347078	.	G	A	25	31	56	0	4	60	0	0
12	35347084	.	C	T	4	26	30	0	30	60	0	0
12	35347318	.	C	T	26	26	52	0	3	55	0	0
12	35347485	.	T	G	17	21	38	0	1	39	0	0
12	35347795	.	C	T	0	11	11	0	11	22	0	0
12	35347951	.	A	G	23	25	48	0	2	50	0	0
12	35350686	.	G	A	16	23	39	0	1	40	0	0
12	35351392	.	G	T	4	3	7	0	0	7	0	0
12	35381729	.	T	C	0	0	0	0	1	1	0	0
12	35386919	.	A	G	10	7	17	0	0	17	0	0
12	35543736	.	T	G	6	12	18	0	0	18	0	0
12	35543971	.	T	G	6	17	23	0	0	23	0	0
12	35544320	.	T	G	4	11	15	0	0	15	0	0
12	35544460	.	A	G	7	10	17	0	0	17	0	0
12	35544596	.	C	A	8	5	13	0	0	13	0	0
12	35544968	.	A	G	11	16	27	0	0	27	0	0
12	35551120	.	G	A	4	1	5	0	0	5	0	0
12	35556821	.	G	C	1	0	1	0	0	1	0	0
12	35559393	.	G	A	1	0	1	0	0	1	0	0
12	35559614	.	T	G	3	2	5	0	0	5	0	0
12	35568231	.	G	A	6	10	16	0	0	16	0	0
12	35568249	.	C	T	0	8	8	0	12	20	0	0
12	35568270	.	T	A	7	7	14	0	1	15	0	0
12	35568303	.	C	G	10	5	15	0	0	15	0	0
12	35568691	.	A	G	2	1	3	0	0	3	0	0
12	35568787	.	G	A	1	5	6	0	0	6	0	0
12	35568793	.	A	G	1	3	4	0	0	4	0	0
12	35593188	.	C	T	21	17	38	0	1	39	0	0
12	35593469	.	T	A	8	5	13	0	1	14	0	0
12	35594069	.	T	A	12	19	31	0	0	31	0	0
12	35594154	.	C	T	16	8	24	0	1	25	0	0
12	35594169	.	C	T	15	8	23	0	1	24	0	0
12	35594436	.	C	T	9	11	20	0	0	21	1	0
12	35594474	.	A	G	12	12	24	0	0	24	0	0
12	35594495	.	G	A	3	8	11	0	11	22	0	0
12	35594512	.	T	C	16	6	22	0	1	23	0	0
12	35594605	.	C	T	21	7	28	0	2	30	0	0
12	35594623	.	T	A	23	9	32	0	1	33	0	0
12	35674952	.	G	A	7	11	18	0	4	22	0	0
12	35689209	.	C	T	1	3	4	0	0	4	0	0
12	35689210	.	A	G	1	3	4	0	0	4	0	0
12	35704426	.	G	T	23	18	41	0	1	42	0	0
12	35704435	.	G	T	24	22	46	0	3	49	0	0
12	35704735	.	A	G	2	2	4	0	1	5	0	0
12	35704852	.	G	A	0	2	2	0	0	2	0	0
12	35704921	.	A	C	10	15	25	0	1	26	0	0
12	35704996	.	T	G	25	12	37	0	1	38	0	0
12	35705131	.	C	T	19	19	38	0	3	41	0	0
12	35705140	.	A	C	19	0	19	0	20	39	0	0
12	35705224	.	A	G	15	17	32	0	0	32	0	0
12	35705252	.	T	G	14	18	32	0	1	33	0	0
12	35705323	.	G	A	12	15	27	0	0	27	0	0
12	35705367	.	C	T	0	19	19	0	12	31	0	0
12	35705565	.	C	T	0	11	11	0	14	25	0	0
12	35705606	.	A	T	9	8	17	0	0	17	0	0
12	35705661	.	T	C	10	15	25	0	0	25	0	0
12	35705926	.	C	T	17	20	37	0	1	38	0	0
12	35706091	.	C	T	15	12	27	0	1	28	0	0
12	35706124	.	A	G	19	7	26	0	1	27	0	0
12	35706253	.	A	T	8	16	24	0	1	25	0	0
12	35706304	.	A	G	9	15	24	0	1	25	0	0
12	35706524	.	G	A	19	13	32	0	1	33	0	0
12	35706568	.	C	T	12	20	32	0	1	33	0	0
12	35706859	.	C	T	0	13	13	0	12	25	0	0
12	35706970	.	G	T	16	9	25	0	2	27	0	0
12	35707155	.	C	T	7	9	16	0	0	16	0	0
12	35707171	.	T	C	9	6	15	0	0	15	0	0
12	35707225	.	G	A	5	12	17	0	0	17	0	0
12	35707537	.	A	G	9	6	15	0	1	16	0	0
12	35707636	.	G	A	9	7	16	0	0	16	0	0
12	35707660	.	A	C	12	5	17	0	0	17	0	0
12	35707747	.	A	G	9	10	19	0	0	19	0	0
12	35707963	.	T	C	11	0	11	0	10	21	0	0
12	35707987	.	G	A	12	5	17	0	1	18	0	0
12	35708139	.	T	G	8	12	20	0	0	20	0	0
12	35708235	.	A	G	11	10	21	0	1	22	0	0
12	35708272	.	C	T	6	4	10	0	2	12	0	0
12	35708950	.	G	A	9	7	16	0	0	16	0	0
12	35709007	.	G	A	2	7	9	0	0	9	0	0
12	35709028	.	A	G	1	2	3	0	0	3	0	0
12	35710837	.	T	C	5	8	13	0	0	13	0	0
12	35715339	.	A	G	1	1	2	0	0	2	0	0
12	35740605	.	G	T	2	1	3	0	0	3	0	0
12	35837354	.	C	T	1	2	3	0	7	10	0	0
12	35837425	.	T	A	4	8	12	0	0	12	0	0
12	35837468	.	C	A	1	5	6	0	0	6	0	0
12	35837499	.	G	C	4	4	8	0	1	9	0	0
12	35837503	.	T	G	4	4	8	0	1	9	0	0
12	35837751	.	G	A	4	3	7	0	0	7	0	0
12	35837828	.	T	A	10	6	16	0	0	16	0	0
12	35837842	.	G	A	9	6	15	0	0	15	0	0
12	35838070	.	T	A	1	4	5	0	2	7	0	0
12	35838102	.	A	G	3	2	5	0	0	5	0	0
12	35838202	.	C	T	1	2	3	0	0	3	0	0
12	35838672	.	C	A	0	5	5	0	2	7	0	0
12	35838683	.	A	G	2	5	7	0	0	7	0	0
12	35839063	.	A	T	9	6	15	0	2	17	0	0
12	35839090	.	C	T	0	9	9	0	5	14	0	0
12	35839159	.	C	T	0	9	9	0	1	10	0	0
12	35839261	.	C	A	9	8	17	0	0	17	0	0
12	35839680	.	G	A	4	3	7	0	0	7	0	0
12	35839879	.	C	A	0	6	6	0	5	11	0	0
12	35839919	.	C	G	0	0	0	0	6	6	0	0
12	35839942	.	C	T	5	0	5	0	1	6	0	0
12	35840003	.	T	C	4	0	4	0	5	9	0	0
12	35840008	.	C	A	4	5	9	0	0	9	0	0
12	35840483	.	G	A	3	0	3	0	0	3	0	0
12	35840543	.	A	C	4	2	6	0	0	6	0	0
12	35840717	.	A	G	4	3	7	0	0	7	0	0
12	35840800	.	T	G	2	4	6	0	0	6	0	0
12	35841457	.	G	A	1	3	4	0	0	4	0	0
12	35841749	.	C	T	0	2	2	0	5	7	0	0
12	35847493	.	A	T	1	1	2	0	1	3	0	0
12	35847535	.	T	C	1	8	9	0	1	10	0	0
12	35847538	.	C	T	1	7	8	0	2	10	0	0
12	35853678	.	A	G	3	4	7	0	0	7	0	0
12	35853693	.	T	C	3	4	7	0	0	7	0	0
12	35865689	.	C	T	2	2	4	0	0	4	0	0
12	35867935	.	G	A	1	0	1	0	0	1	0	0
12	35868203	.	A	G	1	1	2	0	0	2	0	0
12	35963575	.	T	C	8	10	18	0	0	18	0	0
12	35967239	.	T	C	2	1	3	0	0	3	0	0
12	35976771	.	C	A	3	3	6	0	0	6	0	0
12	35980632	.	T	C	11	11	22	0	2	24	0	0
12	35980758	.	C	T	16	8	24	0	1	25	0	0
12	35980764	.	T	C	16	6	22	0	3	25	0	0
12	35980817	.	T	A	9	1	10	0	3	13	0	0
12	35980917	.	T	G	19	5	24	0	1	25	0	0
12	35981206	.	T	C	6	0	6	0	9	15	0	0
12	35981260	.	T	A	10	6	16	0	0	16	0	0
12	35981303	.	T	G	4	5	9	0	0	9	0	0
12	35981304	.	G	C	4	5	9	0	0	9	0	0
12	35981478	.	A	G	7	5	12	0	0	12	0	0
12	35981627	.	C	T	6	8	14	0	1	15	0	0
12	35981713	.	C	T	0	9	9	0	4	13	0	0
12	35981795	.	T	A	4	10	14	0	1	15	0	0
12	35981832	.	A	G	3	8	11	0	0	11	0	0
12	35988544	.	A	G	1	1	2	0	0	2	0	0
12	35988553	.	G	A	1	3	4	0	0	4	0	0
12	36135764	.	C	T	1	1	2	0	0	2	0	0
12	36158056	.	A	C	4	9	13	0	1	14	0	0
12	36158098	.	G	C	14	17	31	0	0	31	0	0
12	36158099	.	T	C	14	15	29	0	2	31	0	0
12	36158225	.	T	C	11	17	28	0	2	30	0	0
12	36158349	.	G	A	0	19	19	0	12	31	0	0
12	36158538	.	C	T	9	6	15	0	0	15	0	0
12	36159597	.	C	G	10	8	18	0	0	18	0	0
12	36413937	.	A	T	0	1	1	0	0	1	0	0
12	36416669	.	T	C	2	2	4	0	0	4	0	0
12	36416675	.	T	C	2	2	4	0	0	4	0	0
12	36420141	.	T	C	1	1	2	0	0	2	0	0
12	36422537	.	A	G	4	2	6	0	0	6	0	0
12	36424613	.	G	A	6	4	10	0	1	11	0	0
12	36424618	.	G	A	4	9	13	0	0	13	0	0
12	36426775	.	C	T	1	2	3	0	0	3	0	0
12	36462038	.	G	A	2	1	3	0	0	3	0	0
12	36471122	.	A	T	1	3	4	0	0	4	0	0
12	36471149	.	A	C	2	2	4	0	0	4	0	0
12	36471473	.	A	T	1	2	3	0	0	3	0	0
12	36471477	.	C	A	1	2	3	0	0	3	0	0
12	36670336	.	A	C	2	3	5	0	0	5	0	0
12	36671145	.	A	G	1	2	3	0	0	3	0	0
12	36739440	.	C	T	1	2	3	0	0	3	0	0
12	36891583	.	C	T	5	2	7	0	0	7	0	0
12	36895025	.	A	G	4	9	13	0	0	13	0	0
12	36895057	.	T	C	3	6	9	0	0	9	0	0
12	36895067	.	G	A	3	6	9	0	0	9	0	0
12	36952648	.	T	G	0	0	0	0	1	1	0	0
12	36952744	.	C	T	6	5	11	0	0	11	0	0
12	36960197	.	T	C	6	5	11	0	0	11	0	0
12	36960200	.	A	T	5	5	10	0	0	10	0	0
12	37004057	.	T	C	0	3	3	0	0	3	0	0
12	37004290	.	A	C	1	2	3	0	0	3	0	0
12	37004295	.	C	T	1	2	3	0	0	3	0	0
12	37004893	.	G	A	0	1	1	0	1	2	0	0
12	37275712	.	A	T	1	1	2	0	1	3	0	0
12	37275719	.	G	T	1	3	4	0	1	5	0	0
12	37407249	.	G	T	4	9	13	0	0	13	0	0
12	37407392	.	T	A	4	8	12	0	1	13	0	0
12	37407477	.	T	C	8	5	13	0	2	15	0	0
12	37407524	.	C	A	9	8	17	0	0	17	0	0
12	37407632	.	T	A	5	5	10	0	2	12	0	0
12	37407813	.	C	T	2	8	10	0	1	11	0	0
12	37408206	.	A	G	5	13	18	0	0	18	0	0
12	37408232	.	T	A	5	12	17	0	0	17	0	0
12	37408442	.	G	C	2	2	4	0	1	5	0	0
12	37409037	.	C	T	1	5	6	0	0	6	0	0
12	37409269	.	C	T	9	4	13	0	0	13	0	0
12	37409315	.	C	T	0	6	6	0	5	11	0	0
12	37409436	.	C	A	0	8	8	0	1	9	0	0
12	37409481	.	G	A	6	3	9	0	0	9	0	0
12	37409611	.	A	G	2	5	7	0	0	7	0	0
12	37409802	.	C	T	4	7	11	0	0	11	0	0
12	37409836	.	T	G	2	10	12	0	0	12	0	0
12	37410018	.	T	C	2	0	2	0	6	8	0	0
12	37410034	.	C	T	3	5	8	0	0	8	0	0
12	37410111	.	T	C	2	6	8	0	1	9	0	0
12	37410469	.	T	G	1	4	5	0	0	5	0	0
12	37410519	.	C	T	2	4	6	0	0	6	0	0
12	37410546	.	T	C	1	0	1	0	3	4	0	0
12	37410693	.	C	G	2	2	4	0	0	4	0	0
12	37410816	.	A	G	1	6	7	0	0	7	0	0
12	37410966	.	T	C	6	4	10	0	0	10	0	0
12	37463606	.	T	C	11	1	12	0	12	24	0	0
12	37490224	.	G	T	2	0	2	0	1	3	0	0
12	37497149	.	G	A	5	6	11	0	1	12	0	0
12	37503881	.	G	A	6	3	9	0	0	9	0	0
12	37514679	.	A	T	1	1	2	0	0	2	0	0
12	37515112	.	T	C	3	0	3	0	1	4	0	0
12	38563150	.	C	A	2	2	4	0	0	4	0	0
12	38563158	.	C	T	2	2	4	0	0	4	0	0
12	38563219	.	T	A	2	2	4	0	0	4	0	0
12	38676664	.	C	T	2	2	4	0	1	5	0	0
12	38687773	.	A	T	1	2	3	0	0	3	0	0
12	38687957	.	G	T	2	4	6	0	0	6	0	0
12	38782119	.	A	T	2	2	4	0	0	4	0	0
12	38787630	.	G	A	2	0	2	0	0	2	0	0
12	38799627	.	C	T	4	5	9	0	0	9	0	0
12	38799732	.	G	A	4	4	8	0	0	8	0	0
12	38799759	.	C	T	5	2	7	0	0	7	0	0
12	38799822	.	A	C	2	0	2	0	0	2	0	0
12	38802875	.	T	C	5	8	13	0	0	13	0	0
12	38803174	.	C	T	2	2	4	0	0	4	0	0
12	38803411	.	A	G	11	0	11	0	6	17	0	0
12	38803586	.	T	C	1	5	6	0	0	6	0	0
12	38803633	.	C	T	1	5	6	0	0	6	0	0
12	38803649	.	G	C	1	2	3	0	1	4	0	0
12	38804166	.	G	T	0	1	1	0	1	2	0	0
12	38804305	.	A	G	6	6	12	0	0	12	0	0
12	38804314	.	C	T	6	6	12	0	0	12	0	0
12	38804350	.	G	A	5	4	9	0	1	10	0	0
12	38804374	.	T	C	4	3	7	0	0	7	0	0
12	38804405	.	A	G	2	7	9	0	0	9	0	0
12	38804466	.	G	A	1	4	5	0	0	5	0	0
12	38804538	.	A	C	5	4	9	0	0	9	0	0
12	38819679	.	C	T	1	0	1	0	0	1	0	0
12	38819727	.	C	T	1	5	6	0	0	6	0	0
12	38828655	.	C	A	6	4	10	0	0	10	0	0
12	38834491	.	T	G	1	2	3	0	0	3	0	0
12	38842158	.	G	A	2	2	4	0	0	4	0	0
12	38842188	.	C	T	0	2	2	0	0	2	0	0
12	38849546	.	C	A	3	3	6	0	0	6	0	0
12	38850285	.	T	A	0	2	2	0	0	2	0	0
12	38850889	.	C	T	2	2	4	0	0	4	0	0
12	38854919	.	G	T	0	4	4	0	6	10	0	0
12	38854937	.	C	T	6	1	7	0	0	7	0	0
12	38855015	.	A	T	1	6	7	0	0	7	0	0
12	38855049	.	G	A	0	4	4	0	3	7	0	0
12	38855255	.	T	C	3	4	7	0	1	8	0	0
12	38855596	.	T	G	3	0	3	0	7	10	0	0
12	38971950	.	C	T	0	1	1	0	0	1	0	0
12	39744954	.	G	C	0	4	4	0	2	6	0	0
12	40206716	.	G	A	0	4	4	0	4	8	0	0
12	40518043	.	T	C	6	12	18	0	2	20	0	0
12	40518088	.	C	T	7	6	13	0	1	14	0	0
12	40518094	.	T	C	6	7	13	0	0	13	0	0
12	40905599	.	G	A	0	6	6	0	6	12	0	0
12	40945980	.	C	T	6	10	16	0	1	17	0	0
12	41000900	.	G	A	0	0	0	0	6	6	0	0
12	41000969	.	A	G	2	0	2	0	6	8	0	0
12	41000993	.	A	C	0	2	2	0	0	2	0	0
12	41028550	.	A	G	5	7	12	0	0	12	0	0
12	41028626	.	G	A	0	3	3	0	2	5	0	0
12	41037024	.	A	C	10	5	15	0	1	16	0	0
12	41071775	.	T	C	5	3	8	0	0	8	0	0
12	41071841	.	T	C	4	5	9	0	0	9	0	0
12	41112962	.	C	T	2	3	5	0	0	6	1	0
12	41113007	.	T	C	7	7	14	0	0	14	0	0
12	41113040	.	G	A	6	7	13	0	2	15	0	0
12	41113049	.	C	A	9	9	18	0	0	18	0	0
12	41113313	.	A	T	12	9	21	0	1	22	0	0
12	41113701	.	G	A	5	3	8	0	0	8	0	0
12	41437046	.	G	A	0	1	1	0	0	1	0	0
12	41449931	.	C	T	0	1	1	0	0	1	0	0
12	41455861	.	T	C	0	1	1	0	0	1	0	0
12	41458264	.	G	A	0	2	2	0	0	2	0	0
12	41461321	.	A	T	5	9	14	0	1	15	0	0
12	41530191	.	C	T	1	1	2	0	0	2	0	0
12	41535844	.	C	T	5	9	14	0	0	14	0	0
12	41535886	.	A	C	10	5	15	0	0	15	0	0
12	41535898	.	C	T	7	10	17	0	1	18	0	0
12	41535937	.	T	A	8	6	14	0	0	14	0	0
12	41539161	.	C	T	3	1	4	0	1	5	0	0
12	41549214	.	G	A	0	4	4	0	7	11	0	0
12	41549404	.	C	G	9	2	11	0	0	11	0	0
12	41549413	.	G	T	5	9	14	0	1	15	0	0
12	41549476	.	T	C	22	19	41	0	1	42	0	0
12	41581092	.	A	G	9	7	16	0	1	17	0	0
12	41581257	.	A	T	8	11	19	0	4	23	0	0
12	41593093	.	T	A	12	9	21	0	1	22	0	0
12	41606683	.	T	C	6	0	6	0	7	13	0	0
12	41606686	.	G	T	6	4	10	0	2	12	0	0
12	41612061	.	A	G	2	1	3	0	0	3	0	0
12	41631703	.	A	T	3	5	8	0	1	9	0	0
12	41632117	.	A	G	6	8	14	0	0	14	0	0
12	41633644	.	C	A	0	7	7	0	8	15	0	0
12	41636655	.	C	T	8	2	10	0	2	12	0	0
12	41636658	.	G	T	7	4	11	0	2	13	0	0
12	41643177	.	T	A	4	8	12	0	1	13	0	0
12	41643178	.	C	T	5	8	13	0	0	13	0	0
12	41643214	.	C	T	5	8	13	0	0	13	0	0
12	41643217	.	G	A	5	8	13	0	0	13	0	0
12	41647273	.	T	C	2	0	2	0	0	2	0	0
12	41653151	.	G	A	10	3	13	0	0	13	0	0
12	41656554	.	G	A	6	1	7	0	0	7	0	0
12	41661349	.	C	T	2	6	8	0	0	8	0	0
12	41684634	.	G	A	10	6	16	0	0	16	0	0
12	41698056	.	G	A	18	28	46	0	1	47	0	0
12	41702044	.	A	C	4	1	5	0	0	5	0	0
12	41723148	.	T	A	6	6	12	0	1	13	0	0
12	41723310	.	C	T	1	11	12	0	14	26	0	0
12	41723457	.	G	A	10	16	26	0	0	26	0	0
12	41723477	.	C	T	9	6	15	0	1	16	0	0
12	41723516	.	G	A	1	2	3	0	0	3	0	0
12	41723608	.	T	A	15	15	30	0	0	30	0	0
12	41723747	.	C	T	8	13	21	0	0	21	0	0
12	41731908	.	G	A	3	1	4	0	0	4	0	0
12	41732013	.	C	T	0	8	8	0	2	10	0	0
12	41735790	.	T	C	5	2	7	0	2	9	0	0
12	41739297	.	G	T	3	5	8	0	0	8	0	0
12	41739345	.	C	G	0	0	0	0	2	2	0	0
12	41759621	.	A	C	9	0	9	0	9	18	0	0
12	41759669	.	C	T	0	6	6	0	12	18	0	0
12	41991699	.	T	A	2	3	5	0	1	6	0	0
12	41991744	.	T	G	7	8	15	0	0	15	0	0
12	41991796	.	A	C	5	6	11	0	0	11	0	0
12	41991797	.	C	T	5	6	11	0	0	11	0	0
12	41992005	.	A	C	3	4	7	0	0	7	0	0
12	41992971	.	A	T	5	7	12	0	1	13	0	0
12	42007693	.	A	G	8	0	8	0	8	16	0	0
12	42153216	.	A	G	3	5	8	0	0	8	0	0
12	42186478	.	A	G	1	2	3	0	1	4	0	0
12	42195697	.	A	T	8	5	13	0	1	14	0	0
12	42196136	.	T	A	4	3	7	0	0	7	0	0
12	42196286	.	A	T	4	2	6	0	0	6	0	0
12	42196571	.	T	A	3	5	8	0	0	8	0	0
12	42196924	.	A	G	5	5	10	0	1	11	0	0
12	42196933	.	T	G	6	7	13	0	1	14	0	0
12	42197558	.	G	T	2	2	4	0	0	4	0	0
12	42197759	.	G	A	6	3	9	0	0	9	0	0
12	42364455	.	A	G	2	2	4	0	0	4	0	0
12	42364461	.	T	G	2	2	4	0	0	4	0	0
12	42366272	.	G	T	1	2	3	0	1	4	0	0
12	42369685	.	C	T	0	13	13	0	12	25	0	0
12	42369848	.	G	A	13	13	26	0	0	26	0	0
12	42369912	.	A	G	10	15	25	0	1	26	0	0
12	42384900	.	G	T	10	6	16	0	2	18	0	0
12	42384924	.	T	C	5	0	5	0	4	9	0	0
12	42400348	.	T	C	1	2	3	0	0	3	0	0
12	42405143	.	G	T	1	2	3	0	0	3	0	0
12	42405160	.	C	A	1	2	3	0	0	3	0	0
12	42405963	.	T	G	3	2	5	0	0	5	0	0
12	42406178	.	C	T	3	2	5	0	0	5	0	0
12	42576815	.	C	T	19	19	38	0	1	39	0	0
12	42577187	.	C	T	19	15	34	0	2	36	0	0
12	42578117	.	A	T	14	7	21	0	0	21	0	0
12	42578505	.	A	T	21	19	40	0	2	42	0	0
12	42578698	.	A	G	6	0	6	0	8	14	0	0
12	42578958	.	A	G	5	5	10	0	3	14	1	0
12	42578996	.	T	A	15	11	26	0	3	29	0	0
12	43376709	.	C	T	0	5	5	0	14	19	0	0
12	43376960	.	A	T	4	9	13	0	0	13	0	0
12	43377049	.	G	T	2	8	10	0	4	14	0	0
12	43377281	.	G	C	7	8	15	0	0	15	0	0
12	43377505	.	A	T	2	15	17	0	2	19	0	0
12	43377558	.	T	C	7	7	14	0	0	14	0	0
12	43378534	.	G	A	3	2	5	0	0	5	0	0
12	43378839	.	T	A	2	5	7	0	0	7	0	0
12	43384921	.	G	A	3	0	3	0	0	3	0	0
12	43391390	.	T	C	0	0	0	0	1	1	0	0
12	43395597	.	G	A	3	9	12	0	0	12	0	0
12	43395955	.	A	G	2	1	3	0	0	3	0	0
12	43426072	.	A	G	5	6	11	0	0	11	0	0
12	44368836	.	C	G	1	0	1	0	0	1	0	0
12	44416269	.	A	G	0	1	1	0	0	1	0	0
12	44558811	.	C	A	0	1	1	0	0	1	0	0
12	44611465	.	G	A	0	4	4	0	1	5	0	0
12	44611651	.	G	A	2	4	6	0	1	7	0	0
12	44611963	.	G	A	0	2	2	0	4	6	0	0
12	47044800	.	A	T	5	4	9	0	0	9	0	0
12	47282104	.	G	A	0	4	4	0	2	6	0	0
12	47283506	.	C	T	0	2	2	0	0	2	0	0
12	47283514	.	A	G	0	3	3	0	0	3	0	0
12	47283544	.	G	C	5	6	11	0	0	11	0	0
12	47291529	.	G	C	0	5	5	0	3	8	0	0
12	47291703	.	G	A	6	4	10	0	0	10	0	0
12	47295523	.	C	T	6	3	9	0	1	10	0	0
12	47295939	.	C	T	2	3	5	0	1	6	0	0
12	47302828	.	C	T	4	0	4	0	0	4	0	0
12	47302831	.	G	A	3	0	3	0	1	4	0	0
12	47331864	.	C	T	15	10	25	0	1	26	0	0
12	47332185	.	A	G	15	13	28	0	2	30	0	0
12	47332326	.	C	A	13	18	31	0	4	35	0	0
12	47332389	.	G	A	14	19	33	0	0	33	0	0
12	47332575	.	A	G	11	14	25	0	0	25	0	0
12	47332635	.	G	A	14	18	32	0	2	34	0	0
12	47332827	.	C	T	10	10	20	0	2	22	0	0
12	47335257	.	C	T	4	11	15	0	0	15	0	0
12	47335472	.	C	T	2	4	6	0	0	6	0	0
12	47344423	.	T	C	19	23	42	0	1	43	0	0
12	47347875	.	C	T	5	8	13	0	0	13	0	0
12	47448762	.	G	C	1	0	1	0	3	4	0	0
12	47448986	.	C	T	15	13	28	0	0	28	0	0
12	47449121	.	G	A	0	6	6	0	4	10	0	0
12	47449481	.	C	T	11	14	25	0	1	26	0	0
12	47449784	.	A	G	7	0	7	0	5	12	0	0
12	47449886	.	T	C	7	8	15	0	1	16	0	0
12	47449997	.	G	A	11	18	29	0	0	29	0	0
12	47461255	.	G	A	0	5	5	0	0	5	0	0
12	47469850	.	G	C	2	2	4	0	0	4	0	0
12	47480299	.	A	C	3	2	5	0	0	5	0	0
12	47480404	.	G	A	8	10	18	0	0	18	0	0
12	47480434	.	A	G	10	0	10	0	9	19	0	0
12	47480469	.	A	T	9	6	15	0	2	17	0	0
12	47480536	.	A	C	8	15	23	0	0	23	0	0
12	47480565	.	T	A	11	14	25	0	1	26	0	0
12	47480728	.	A	G	11	0	11	0	16	27	0	0
12	47480731	.	T	A	14	10	24	0	5	29	0	0
12	47481112	.	T	G	12	14	26	0	2	28	0	0
12	47481229	.	G	C	0	5	5	0	8	13	0	0
12	47481611	.	G	A	8	4	12	0	0	12	0	0
12	47505208	.	G	A	1	3	4	0	0	4	0	0
12	47510101	.	T	C	6	8	14	0	1	15	0	0
12	47523795	.	A	C	10	7	17	0	1	18	0	0
12	47540933	.	T	C	13	21	34	0	4	38	0	0
12	47540934	.	C	T	14	23	37	0	1	38	0	0
12	47540999	.	A	C	15	12	27	0	3	30	0	0
12	47541265	.	G	A	0	2	2	0	0	2	0	0
12	47544354	.	C	A	0	2	2	0	2	4	0	0
12	47544543	.	A	G	0	4	4	0	0	4	0	0
12	47580442	.	G	A	0	1	1	0	0	1	0	0
12	47862041	.	C	T	3	7	10	0	1	11	0	0
12	47862172	.	G	C	1	2	3	0	0	3	0	0
12	47918804	.	G	A	0	2	2	0	1	3	0	0
12	47922396	.	C	T	0	1	1	0	1	2	0	0
12	47967799	.	C	A	0	2	2	0	3	5	0	0
12	47975228	.	G	A	0	1	1	0	0	1	0	0
12	48094399	.	A	T	1	3	4	0	1	5	0	0
12	48118470	.	A	C	1	4	5	0	0	5	0	0
12	48118598	.	A	T	4	3	7	0	1	8	0	0
12	48118981	.	G	A	4	4	8	0	0	8	0	0
12	48119048	.	G	A	3	4	7	0	0	7	0	0
12	48119153	.	T	G	2	3	5	0	0	5	0	0
12	48119855	.	C	T	0	3	3	0	2	5	0	0
12	48119934	.	C	T	1	3	4	0	0	4	0	0
12	48119941	.	A	G	1	3	4	0	0	4	0	0
12	48120237	.	T	A	1	2	3	0	0	3	0	0
12	48121254	.	A	C	2	2	4	0	0	4	0	0
12	48122106	.	C	G	0	3	3	0	1	4	0	0
12	48133239	.	G	A	5	5	10	0	1	11	0	0
12	48137949	.	G	A	5	6	11	0	0	11	0	0
12	48138307	.	A	G	4	2	6	0	1	7	0	0
12	48143336	.	G	A	0	1	1	0	2	3	0	0
12	48143427	.	C	T	1	2	3	0	0	3	0	0
12	48146371	.	C	T	2	1	3	0	1	4	0	0
12	48146395	.	G	T	2	2	4	0	0	4	0	0
12	48157135	.	G	A	4	2	6	0	0	6	0	0
12	48161625	.	C	T	1	2	3	0	0	3	0	0
12	48168094	.	G	A	2	3	5	0	1	6	0	0
12	48211906	.	T	C	0	1	1	0	1	2	0	0
12	48216789	.	A	T	1	0	1	0	0	1	0	0
12	48220624	.	C	G	2	3	5	0	0	5	0	0
12	48228265	.	A	C	1	0	1	0	0	1	0	0
12	48231039	.	G	A	0	2	2	0	4	6	0	0
12	48231108	.	G	T	4	8	12	0	0	12	0	0
12	48327550	.	T	G	4	10	14	0	1	15	0	0
12	48340578	.	G	A	5	2	7	0	0	7	0	0
12	48341936	.	G	A	4	11	15	0	6	21	0	0
12	48349836	.	C	T	0	7	7	0	2	9	0	0
12	48367360	.	C	T	0	9	9	0	10	19	0	0
12	48367442	.	T	G	1	0	1	0	0	1	0	0
12	48419281	.	G	C	4	5	9	0	0	9	0	0
12	48419520	.	T	A	3	3	6	0	0	6	0	0
12	48419568	.	T	G	5	2	7	0	0	7	0	0
12	48420640	.	A	G	0	1	1	0	0	1	0	0
12	48432078	.	C	T	1	8	9	0	7	16	0	0
12	48432716	.	G	T	0	1	1	0	0	1	0	0
12	48436863	.	T	C	1	0	1	0	1	2	0	0
12	48451923	.	A	G	0	1	1	0	1	2	0	0
12	48465570	.	G	A	1	1	2	0	0	2	0	0
12	48469825	.	C	T	15	14	29	0	0	29	0	0
12	48476965	.	A	T	16	10	26	0	3	29	0	0
12	48476995	.	T	C	13	0	13	0	7	20	0	0
12	48480740	.	G	A	1	7	8	0	0	8	0	0
12	48511751	.	C	T	1	0	1	0	0	1	0	0
12	48522793	.	T	C	0	2	2	0	0	2	0	0
12	48525046	.	G	A	2	1	3	0	0	3	0	0
12	48529757	.	C	T	11	10	21	0	1	22	0	0
12	48532581	.	A	G	3	6	9	0	0	9	0	0
12	48611516	.	A	G	1	2	3	0	1	4	0	0
12	48619421	.	C	T	2	2	4	0	0	4	0	0
12	48623030	.	C	A	4	8	12	0	0	12	0	0
12	48626349	.	A	C	2	4	6	0	0	6	0	0
12	48680110	.	C	G	0	3	3	0	0	3	0	0
12	48681826	.	A	T	5	7	12	0	0	12	0	0
12	48681827	.	T	A	5	6	11	0	1	12	0	0
12	48682002	.	A	G	5	4	9	0	0	9	0	0
12	48682089	.	G	T	4	4	8	0	0	8	0	0
12	48682530	.	G	C	6	7	13	0	0	13	0	0
12	48682701	.	C	T	1	3	4	0	0	4	0	0
12	48682730	.	G	A	1	2	3	0	0	3	0	0
12	48790801	.	C	T	1	2	3	0	0	3	0	0
12	48790802	.	C	T	1	2	3	0	0	3	0	0
12	48792426	.	G	A	1	4	5	0	1	6	0	0
12	48796831	.	C	T	0	3	3	0	0	3	0	0
12	48799261	.	C	T	6	13	19	0	1	20	0	0
12	48803111	.	G	A	0	1	1	0	0	1	0	0
12	48803126	.	G	C	6	8	14	0	0	14	0	0
12	48810338	.	C	T	2	3	5	0	0	5	0	0
12	48810557	.	G	T	0	15	15	0	11	26	0	0
12	48810558	.	C	T	11	15	26	0	0	26	0	0
12	48810865	.	C	T	4	9	13	0	0	13	0	0
12	48811035	.	T	C	8	6	14	0	1	15	0	0
12	48826364	.	C	T	2	1	3	0	0	3	0	0
12	48826626	.	G	A	6	2	8	0	2	10	0	0
12	48828350	.	C	T	0	1	1	0	0	1	0	0
12	48828356	.	C	G	3	0	3	0	0	3	0	0
12	48828431	.	G	A	0	9	9	0	8	17	0	0
12	48828461	.	C	T	3	5	8	0	0	8	0	0
12	48828467	.	G	A	0	2	2	0	4	6	0	0
12	48829379	.	T	C	0	3	3	0	0	3	0	0
12	48829397	.	T	C	2	0	2	0	1	3	0	0
12	48832417	.	C	A	1	1	2	0	0	2	0	0
12	48833090	.	T	C	3	3	6	0	0	6	0	0
12	48833165	.	C	T	1	1	2	0	1	3	0	0
12	48836348	.	A	G	11	8	19	0	1	20	0	0
12	48836482	.	G	A	11	9	20	0	1	21	0	0
12	48836680	.	C	T	1	3	4	0	0	4	0	0
12	48852772	.	G	A	0	1	1	0	1	2	0	0
12	48899089	.	C	T	2	2	4	0	0	4	0	0
12	48909987	.	G	A	1	0	1	0	1	2	0	0
12	48959393	.	A	G	1	2	3	0	0	3	0	0
12	48959630	.	G	A	4	10	14	0	0	14	0	0
12	48974901	.	T	C	1	2	3	0	0	3	0	0
12	48975613	.	G	A	0	2	2	0	1	3	0	0
12	48979256	.	G	T	1	4	5	0	0	5	0	0
12	48979362	.	A	C	1	0	1	0	10	11	0	0
12	48979609	.	C	T	0	7	7	0	9	16	0	0
12	48979648	.	C	T	4	3	7	0	1	8	0	0
12	48982536	.	T	C	2	0	2	0	4	6	0	0
12	48982539	.	C	T	0	4	4	0	2	6	0	0
12	48984334	.	T	C	0	0	0	0	3	3	0	0
12	49004058	.	C	T	0	12	12	0	6	18	0	0
12	49004071	.	C	T	0	6	6	0	5	11	0	0
12	49005119	.	G	T	9	9	18	0	3	21	0	0
12	49005150	.	T	C	6	5	11	0	0	11	0	0
12	49010585	.	C	T	3	2	5	0	1	6	0	0
12	49035269	.	C	T	2	1	3	0	1	4	0	0
12	49100585	.	G	C	1	2	3	0	0	3	0	0
12	49114550	.	G	T	0	9	9	0	17	26	0	0
12	49114592	.	A	G	4	0	4	0	12	16	0	0
12	49114616	.	C	A	4	4	8	0	1	9	0	0
12	49125593	.	G	A	0	2	2	0	1	3	0	0
12	49125936	.	A	G	2	0	2	0	1	3	0	0
12	49125949	.	A	G	0	1	1	0	0	1	0	0
12	49158090	.	T	C	3	0	3	0	9	12	0	0
12	49158104	.	T	C	3	7	10	0	0	10	0	0
12	49158990	.	G	A	0	2	2	0	0	2	0	0
12	49160120	.	G	A	0	1	1	0	0	1	0	0
13	15135	.	A	T	0	6	6	0	0	6	0	0
13	46540	.	T	C	1	5	6	0	0	6	0	0
13	83970	.	C	T	1	4	5	0	1	6	0	0
13	84188	.	T	A	2	0	2	0	0	2	0	0
13	111572	.	G	A	0	4	4	0	2	6	0	0
13	111804	.	C	T	5	5	10	0	1	11	0	0
13	112130	.	A	C	4	2	6	0	6	12	0	0
13	112162	.	T	G	5	5	10	0	3	13	0	0
13	112666	.	C	G	4	6	10	0	1	11	0	0
13	325797	.	G	A	1	5	6	0	1	7	0	0
13	343567	.	G	T	0	4	4	0	0	4	0	0
13	343581	.	C	G	0	3	3	0	0	3	0	0
13	809305	.	A	G	7	7	14	0	0	14	0	0
13	809779	.	A	G	8	6	14	0	1	15	0	0
13	1374642	.	C	A	1	8	9	0	0	9	0	0
13	1415599	.	G	C	3	0	3	0	16	19	0	0
13	2254607	.	A	T	2	5	7	0	0	7	0	0
13	2254638	.	T	C	3	2	5	0	0	5	0	0
13	2254751	.	T	A	3	1	4	0	1	5	0	0
13	2254753	.	G	C	2	0	2	0	3	5	0	0
13	2255417	.	A	G	2	0	2	0	0	2	0	0
13	2269948	.	T	G	0	2	2	0	0	2	0	0
13	2357775	.	G	C	9	7	16	0	0	16	0	0
13	2358026	.	A	T	9	9	18	0	1	19	0	0
13	2366936	.	G	A	1	8	9	0	0	9	0	0
13	2370529	.	G	T	0	8	8	0	8	17	1	0
13	2375550	.	G	A	0	1	1	0	0	1	0	0
13	2382376	.	A	G	3	0	3	0	5	8	0	0
13	2384958	.	A	G	5	1	6	0	0	6	0	0
13	2385782	.	G	T	0	9	9	0	5	14	0	0
13	2385812	.	G	A	8	4	12	0	0	12	0	0
13	2392342	.	G	A	5	6	11	0	0	11	0	0
13	2392434	.	G	A	8	3	11	0	0	11	0	0
13	2392459	.	A	G	4	1	5	0	10	15	0	0
13	2410987	.	C	T	0	2	2	0	0	2	0	0
13	2416221	.	G	A	8	3	11	0	0	11	0	0
13	2416401	.	A	T	5	2	7	0	1	8	0	0
13	2416462	.	C	T	3	2	5	0	0	5	0	0
13	2416764	.	A	T	3	2	5	0	0	5	0	0
13	2416904	.	A	C	2	4	6	1	0	8	1	0
13	2417331	.	A	T	2	2	4	0	1	5	0	0
13	2427174	.	C	T	6	8	14	0	2	16	0	0
13	2427175	.	T	G	7	9	16	0	0	16	0	0
13	2427446	.	G	C	0	7	7	0	0	7	0	0
13	2427522	.	A	G	8	7	15	0	0	15	0	0
13	2429080	.	C	A	20	26	46	0	2	48	0	0
13	2429300	.	A	G	5	6	11	0	0	11	0	0
13	2434335	.	G	T	9	12	21	0	1	22	0	0
13	2453315	.	T	C	0	1	1	0	0	1	0	0
13	2456110	.	G	A	0	1	1	0	1	2	0	0
13	2460971	.	T	C	1	3	4	0	0	4	0	0
13	2464167	.	G	A	0	1	1	0	1	2	0	0
13	2469076	.	A	G	1	0	1	0	0	1	0	0
13	2469091	.	A	T	1	0	1	0	0	1	0	0
13	2495872	.	C	T	5	6	11	0	0	11	0	0
13	2496334	.	C	T	6	12	18	0	0	18	0	0
13	2496496	.	T	A	0	3	3	0	0	3	0	0
13	2520778	.	G	A	2	0	2	0	0	2	0	0
13	2520834	.	C	T	9	7	16	0	0	16	0	0
13	2746350	.	A	G	4	0	4	0	10	14	0	0
13	2764899	.	C	T	1	0	1	0	0	1	0	0
13	2766946	.	A	G	4	0	4	0	0	4	0	0
13	2767003	.	T	C	12	4	16	0	0	16	0	0
13	2769810	.	T	C	1	0	1	0	0	1	0	0
13	2807099	.	A	C	6	5	11	0	1	12	0	0
13	2814352	.	G	A	10	7	17	0	1	18	0	0
13	2814421	.	T	C	3	3	6	0	1	7	0	0
13	2820601	.	C	G	0	0	0	0	1	1	0	0
13	2824513	.	T	C	0	2	2	0	0	2	0	0
13	2826324	.	A	G	13	0	13	0	26	39	0	0
13	2826397	.	T	C	12	17	29	0	0	29	0	0
13	2826445	.	G	C	0	8	8	0	20	28	0	0
13	2826684	.	T	C	21	10	31	0	0	31	0	0
13	2826690	.	C	A	21	10	31	0	0	31	0	0
13	2826790	.	C	T	16	3	19	0	2	21	0	0
13	2827560	.	A	C	11	13	24	0	2	26	0	0
13	2827578	.	C	A	9	10	19	0	3	22	0	0
13	2827670	.	C	T	20	5	25	0	1	26	0	0
13	2827700	.	G	C	17	14	31	0	1	32	0	0
13	2827832	.	G	T	20	11	31	0	0	31	0	0
13	2827844	.	T	C	18	10	28	0	1	29	0	0
13	2827998	.	G	A	13	14	27	0	1	28	0	0
13	2828040	.	C	G	3	13	16	0	0	16	0	0
13	2828062	.	C	A	5	12	17	0	1	18	0	0
13	2845697	.	A	G	1	1	2	0	0	2	0	0
13	2897475	.	T	A	3	3	6	0	2	8	0	0
13	2913822	.	C	T	21	9	30	0	0	30	0	0
13	2913844	.	T	C	4	16	20	0	0	20	0	0
13	2927676	.	C	T	0	10	10	0	9	19	0	0
13	2927778	.	G	A	9	6	15	0	2	17	0	0
13	2938391	.	T	C	2	1	3	0	0	3	0	0
13	2946665	.	T	A	2	0	2	0	0	2	0	0
13	2981378	.	T	A	7	3	10	0	0	10	0	0
13	3109186	.	C	A	6	2	8	0	0	8	0	0
13	3127930	.	G	A	2	7	9	0	0	9	0	0
13	3128038	.	T	C	1	0	1	0	6	7	0	0
13	3133582	.	T	A	1	1	2	0	0	2	0	0
13	3133588	.	G	A	1	3	4	0	0	4	0	0
13	3133645	.	T	G	0	2	2	0	0	2	0	0
13	3154846	.	T	C	1	2	3	0	0	3	0	0
13	3263990	.	G	A	0	7	7	0	1	8	0	0
13	3264012	.	G	A	3	8	11	0	0	11	0	0
13	3264063	.	G	C	12	0	12	0	8	20	0	0
13	3264323	.	C	A	7	3	10	0	1	11	0	0
13	3264406	.	C	T	5	3	8	0	0	8	0	0
13	3264467	.	C	A	5	3	8	0	0	8	0	0
13	3270123	.	A	G	0	1	1	0	0	1	0	0
13	3279588	.	C	T	1	3	4	0	0	4	0	0
13	3279591	.	G	A	1	3	4	0	0	4	0	0
13	3284780	.	C	T	0	1	1	0	3	4	0	0
13	3287096	.	C	T	0	2	2	0	1	3	0	0
13	3289120	.	T	C	1	2	3	0	0	3	0	0
13	3289513	.	T	C	4	2	6	0	0	6	0	0
13	3299514	.	C	G	3	4	7	0	1	8	0	0
13	3302783	.	G	T	0	2	2	0	0	2	0	0
13	3321859	.	C	T	1	2	3	0	0	3	0	0
13	3354930	.	C	T	5	4	9	0	1	10	0	0
13	3369252	.	T	C	1	0	1	0	0	1	0	0
13	3423584	.	A	T	1	0	1	0	0	1	0	0
13	3423585	.	T	G	1	0	1	0	0	1	0	0
13	3474261	.	A	C	1	2	3	0	0	3	0	0
13	3474304	.	C	T	2	2	4	0	0	4	0	0
13	3474310	.	C	T	0	2	2	0	1	3	0	0
13	3474346	.	G	A	1	1	2	0	0	2	0	0
13	3474361	.	G	A	1	1	2	0	0	2	0	0
13	3874427	.	A	G	4	5	9	0	0	9	0	0
13	3874618	.	T	C	7	10	17	0	0	17	0	0
13	3874815	.	T	C	7	0	7	0	4	11	0	0
13	3874903	.	C	A	0	2	2	0	6	9	1	0
13	3874909	.	G	A	7	3	10	0	0	10	0	0
13	3874983	.	A	G	2	5	7	0	0	7	0	0
13	3875113	.	C	G	4	4	8	0	0	8	0	0
13	3881054	.	T	C	1	3	4	0	0	4	0	0
13	3881204	.	T	C	0	5	5	0	0	5	0	0
13	3915333	.	A	G	5	7	12	0	0	12	0	0
13	3915383	.	C	A	10	4	14	0	0	14	0	0
13	3915476	.	A	C	12	9	21	0	0	21	0	0
13	3915644	.	A	C	15	5	20	1	0	21	0	0
13	3915908	.	A	G	10	4	14	0	0	14	0	0
13	3915981	.	C	T	2	5	7	1	14	22	0	0
13	3919353	.	T	G	20	10	30	0	2	32	0	0
13	3919632	.	A	G	13	10	23	0	0	23	0	0
13	3919672	.	T	G	13	5	18	0	1	19	0	0
13	3919686	.	G	A	15	7	22	0	1	23	0	0
13	3920727	.	A	G	1	1	2	0	0	2	0	0
13	3920759	.	C	T	1	1	2	0	0	2	0	0
13	3922791	.	T	C	1	1	2	0	0	2	0	0
13	3926166	.	C	T	3	6	9	0	0	9	0	0
13	3927916	.	T	C	2	0	2	0	1	3	0	0
13	3927931	.	T	C	3	3	6	0	1	7	0	0
13	3927975	.	T	A	3	3	6	0	0	6	0	0
13	3942055	.	G	A	1	17	18	0	13	31	0	0
13	3945643	.	C	T	9	4	13	0	0	13	0	0
13	3950007	.	G	A	9	8	17	1	0	20	2	0
13	3950044	.	A	G	12	8	20	0	1	21	0	0
13	3950307	.	A	G	6	9	15	0	0	15	0	0
13	3950577	.	C	G	8	13	21	0	1	22	0	0
13	3950669	.	T	A	7	7	14	0	0	14	0	0
13	3954695	.	G	T	10	3	13	0	0	13	0	0
13	3958895	.	C	T	2	3	5	0	0	5	0	0
13	3958913	.	A	G	2	2	4	0	0	4	0	0
13	3962569	.	C	T	0	1	1	0	0	1	0	0
13	3962853	.	A	G	3	0	3	0	3	6	0	0
13	3965910	.	T	C	17	6	23	0	1	24	0	0
13	3980164	.	C	T	2	2	4	0	2	6	0	0
13	3980349	.	C	T	0	5	5	0	2	7	0	0
13	3980947	.	T	C	7	0	7	0	12	19	0	0
13	3980962	.	G	A	9	8	17	0	2	19	0	0
13	3980993	.	C	T	1	7	8	0	10	18	0	0
13	3981579	.	G	T	6	5	11	0	0	11	0	0
13	3982679	.	A	G	4	4	8	0	0	8	0	0
13	3983112	.	G	C	3	3	6	0	0	6	0	0
13	4000601	.	G	A	0	2	2	0	0	2	0	0
13	4000625	.	A	G	0	1	1	0	0	1	0	0
13	4205733	.	C	T	1	0	1	0	0	1	0	0
13	4213291	.	A	C	5	2	7	0	0	7	0	0
13	4213300	.	C	T	2	5	7	0	0	7	0	0
13	4213477	.	C	A	3	5	8	0	2	10	0	0
13	4213594	.	G	T	3	3	6	0	0	6	0	0
13	4213598	.	C	T	4	3	7	0	0	7	0	0
13	4213861	.	T	C	10	9	19	0	0	19	0	0
13	4226678	.	C	A	10	14	24	0	0	24	0	0
13	4231368	.	G	T	0	18	18	0	14	32	0	0
13	4231396	.	C	T	17	16	33	0	0	33	0	0
13	4231438	.	T	A	7	9	16	0	0	16	0	0
13	4231819	.	G	A	10	11	21	1	1	23	0	0
13	4232014	.	T	A	3	10	13	0	2	16	1	0
13	4232016	.	G	A	0	5	5	0	11	16	0	0
13	4232054	.	A	T	10	5	15	0	2	17	0	0
13	4232112	.	A	G	13	14	27	0	2	29	0	0
13	4232171	.	C	T	14	22	36	0	1	37	0	0
13	4232737	.	A	G	8	15	23	0	0	23	0	0
13	4233030	.	C	T	0	22	22	0	15	37	0	0
13	4233033	.	G	A	22	13	35	0	2	37	0	0
13	4233361	.	G	T	14	13	27	0	0	27	0	0
13	4233365	.	G	A	12	13	25	0	1	26	0	0
13	4233625	.	T	A	11	14	25	0	2	27	0	0
13	4233779	.	G	A	19	11	30	0	4	34	0	0
13	4233889	.	G	A	10	8	18	0	0	18	0	0
13	4233911	.	G	C	10	9	19	0	0	19	0	0
13	4233970	.	A	G	10	10	20	0	0	20	0	0
13	4234139	.	A	T	7	5	12	2	1	15	0	0
13	4234337	.	G	A	9	13	22	0	2	24	0	0
13	4234349	.	G	T	13	11	24	0	1	25	0	0
13	4234402	.	A	T	12	13	25	0	0	25	0	0
13	4238449	.	T	C	6	7	13	0	0	13	0	0
13	4247007	.	G	A	2	0	2	0	0	2	0	0
13	4256617	.	A	G	6	5	11	0	0	11	0	0
13	4302690	.	A	T	2	4	6	0	0	6	0	0
13	4307782	.	C	T	9	12	21	0	1	22	0	0
13	4308714	.	C	A	15	10	25	0	0	25	0	0
13	4308948	.	C	T	5	10	15	0	2	17	0	0
13	4308983	.	G	C	8	0	8	0	16	24	0	0
13	4309166	.	T	G	8	14	22	0	0	22	0	0
13	4309607	.	T	C	9	13	22	0	1	23	0	0
13	4309746	.	A	G	9	9	18	0	1	19	0	0
13	4309778	.	T	A	9	7	16	0	1	17	0	0
13	4309866	.	T	C	9	11	20	0	0	20	0	0
13	4310247	.	G	A	15	7	22	0	2	24	0	0
13	4310349	.	T	A	9	19	28	0	1	29	0	0
13	4310367	.	C	G	0	21	21	0	10	31	0	0
13	4310511	.	C	T	1	17	18	0	22	40	0	0
13	4310565	.	G	A	17	15	32	0	1	33	0	0
13	4310610	.	C	T	14	14	28	0	0	28	0	0
13	4310976	.	T	C	7	0	7	0	3	10	0	0
13	4311114	.	A	G	10	13	23	0	0	23	0	0
13	4311912	.	C	T	5	5	10	0	0	10	0	0
13	4314226	.	T	G	3	4	7	0	0	7	0	0
13	4314227	.	C	T	3	4	7	0	0	7	0	0
13	4317721	.	T	C	6	8	14	0	1	15	0	0
13	4320781	.	G	C	1	6	7	0	0	7	0	0
13	4325371	.	T	C	4	9	13	0	0	13	0	0
13	4330240	.	G	A	1	2	3	0	0	3	0	0
13	4332807	.	G	A	1	1	2	0	1	3	0	0
13	4332851	.	T	G	4	1	5	0	1	6	0	0
13	4333087	.	T	G	1	4	5	0	0	5	0	0
13	4339638	.	T	C	6	0	6	0	12	18	0	0
13	4343183	.	C	T	0	7	7	0	7	14	0	0
13	4343437	.	C	T	0	5	5	0	6	11	0	0
13	4343468	.	T	A	4	5	9	0	3	12	0	0
13	4343490	.	G	A	7	7	14	0	0	14	0	0
13	4344100	.	C	G	5	2	7	0	0	7	0	0
13	4344378	.	A	T	5	9	14	0	1	15	0	0
13	4344800	.	T	C	2	6	8	0	1	9	0	0
13	4344872	.	G	C	7	8	15	0	0	15	0	0
13	4347531	.	T	C	3	2	5	0	0	5	0	0
13	4349830	.	G	T	0	2	2	0	0	2	0	0
13	4354457	.	A	G	4	1	5	0	0	5	0	0
13	4366180	.	C	A	1	2	3	0	0	3	0	0
13	4399344	.	A	G	4	0	4	0	2	6	0	0
13	4399345	.	A	G	1	4	5	0	1	6	0	0
13	4399395	.	A	G	2	4	6	0	0	6	0	0
13	4399405	.	A	G	4	1	5	0	2	7	0	0
13	4399439	.	C	A	3	2	5	0	0	5	0	0
13	4399511	.	A	T	2	2	4	0	0	4	0	0
13	4399667	.	G	A	6	9	15	0	0	15	0	0
13	4399702	.	G	A	6	10	16	0	0	16	0	0
13	4399786	.	T	C	3	7	10	0	0	10	0	0
13	4400339	.	G	A	3	4	7	0	0	7	0	0
13	4400392	.	A	T	3	4	7	0	0	7	0	0
13	4400421	.	C	T	2	5	7	0	1	8	0	0
13	4400488	.	T	C	1	2	3	0	1	4	0	0
13	4400609	.	T	G	1	2	3	0	0	3	0	0
13	4400698	.	A	T	4	4	8	0	0	8	0	0
13	4400704	.	T	A	3	4	7	0	0	7	0	0
13	4406090	.	T	A	8	19	27	0	1	28	0	0
13	4406271	.	A	C	17	13	30	0	1	31	0	0
13	4406280	.	T	G	22	13	35	0	0	35	0	0
13	4406338	.	A	G	14	20	34	0	2	36	0	0
13	4544101	.	G	A	0	1	1	0	0	1	0	0
13	4608152	.	T	C	1	0	1	0	0	1	0	0
13	4657394	.	T	C	1	2	3	0	0	3	0	0
13	4657403	.	C	T	0	2	2	0	1	3	0	0
13	4657721	.	G	C	6	5	11	0	0	11	0	0
13	4663375	.	G	A	1	3	4	0	0	4	0	0
13	4663402	.	C	T	3	4	7	0	1	8	0	0
13	4712874	.	G	A	10	6	16	0	1	17	0	0
13	4713152	.	G	C	15	12	27	0	0	27	0	0
13	4713254	.	G	A	5	5	10	0	0	10	0	0
13	4713290	.	G	A	4	6	10	0	0	10	0	0
13	4713323	.	A	G	6	3	9	0	0	9	0	0
13	4713711	.	A	G	5	4	9	0	0	9	0	0
13	4713773	.	C	A	6	5	11	0	0	11	0	0
13	4714017	.	C	A	6	3	9	0	2	11	0	0
13	4872079	.	G	A	8	8	16	0	0	16	0	0
13	4888273	.	G	A	0	13	13	0	8	21	0	0
13	4945774	.	T	A	9	9	18	0	2	20	0	0
13	4945804	.	C	T	6	7	13	0	0	13	0	0
13	4948345	.	G	A	3	2	5	0	1	6	0	0
13	4951747	.	T	C	13	8	21	0	2	23	0	0
13	4956151	.	C	T	6	3	9	0	2	11	0	0
13	4968727	.	G	A	17	13	30	0	1	31	0	0
13	4968819	.	T	A	18	8	26	0	2	28	0	0
13	4968905	.	T	C	9	20	29	0	3	32	0	0
13	4969003	.	A	G	11	9	20	0	3	23	0	0
13	4969380	.	A	G	8	10	18	0	0	18	0	0
13	4973775	.	C	A	5	5	10	0	0	10	0	0
13	4973979	.	A	G	5	5	10	0	2	12	0	0
13	4977950	.	C	T	0	2	2	0	2	4	0	0
13	4977962	.	A	G	1	3	4	0	0	4	0	0
13	4978770	.	G	A	8	11	19	0	1	20	0	0
13	4978773	.	G	A	9	10	19	0	1	20	0	0
13	4979471	.	T	C	8	10	18	0	0	19	1	0
13	4981965	.	A	T	1	0	1	0	0	1	0	0
13	4982282	.	C	T	1	4	5	0	7	12	0	0
13	4982336	.	T	C	4	7	11	0	0	11	0	0
13	4982348	.	T	C	4	8	12	0	0	12	0	0
13	4984402	.	A	T	2	2	4	0	0	4	0	0
13	4987659	.	C	A	0	2	2	0	3	5	0	0
13	4987706	.	T	C	4	0	4	0	2	6	0	0
13	4992360	.	A	C	1	5	6	0	0	6	0	0
13	4995494	.	G	C	0	2	2	0	0	2	0	0
13	4995574	.	T	C	21	15	36	0	3	39	0	0
13	4995788	.	C	T	12	14	26	0	1	27	0	0
13	4995902	.	A	G	5	9	14	0	1	15	0	0
13	4995916	.	T	A	3	6	9	0	1	10	0	0
13	5000560	.	A	G	10	6	16	0	0	16	0	0
13	5000606	.	G	A	2	3	5	0	0	5	0	0
13	5000615	.	T	A	2	2	4	0	0	4	0	0
13	5004996	.	C	T	21	15	36	0	1	37	0	0
13	5013671	.	A	G	7	14	21	0	3	24	0	0
13	5013813	.	T	C	1	2	3	0	0	3	0	0
13	5013999	.	A	G	12	13	25	1	0	26	0	0
13	5016700	.	G	A	17	20	37	0	3	40	0	0
13	5017657	.	A	C	11	15	26	0	0	26	0	0
13	5017680	.	G	A	19	17	36	0	2	38	0	0
13	5017699	.	G	A	21	19	40	0	2	42	0	0
13	5017866	.	T	C	2	0	2	0	0	2	0	0
13	5025842	.	G	T	1	21	22	0	14	36	0	0
13	5025938	.	A	G	6	0	6	0	11	17	0	0
13	5026062	.	A	G	2	2	4	0	0	4	0	0
13	5026131	.	C	T	25	24	49	0	3	52	0	0
13	5028224	.	T	G	16	9	25	0	2	27	0	0
13	5028471	.	T	G	25	32	57	0	3	60	0	0
13	5028499	.	A	T	20	26	46	0	4	50	0	0
13	5028538	.	T	G	19	22	41	0	2	43	0	0
13	5028711	.	C	T	21	29	50	0	4	54	0	0
13	5028751	.	T	C	25	26	51	0	3	54	0	0
13	5028802	.	T	C	25	27	52	0	1	53	0	0
13	5028912	.	C	T	21	20	41	0	1	42	0	0
13	5028954	.	C	A	4	3	7	0	0	7	0	0
13	5038238	.	C	G	0	1	1	0	0	1	0	0
13	5048306	.	A	G	2	2	4	0	0	4	0	0
13	5048344	.	G	T	1	1	2	0	0	2	0	0
13	5245016	.	A	G	1	2	3	0	0	3	0	0
13	5247432	.	C	T	2	2	4	0	0	4	0	0
13	5251183	.	T	C	1	2	3	0	0	3	0	0
13	5251237	.	G	A	3	2	5	0	0	5	0	0
13	5251630	.	C	A	0	2	2	0	2	4	0	0
13	5257241	.	T	G	0	1	1	0	0	1	0	0
13	5257243	.	A	G	0	1	1	0	0	1	0	0
13	5257291	.	A	G	2	3	5	0	0	5	0	0
13	5870703	.	C	G	5	2	7	0	0	7	0	0
13	5871196	.	T	C	3	3	6	0	0	6	0	0
13	5871211	.	A	G	2	3	5	0	0	5	0	0
13	5871271	.	C	A	0	3	3	0	1	4	0	0
13	5871281	.	A	T	2	2	4	0	1	5	0	0
13	5871538	.	A	G	3	4	7	0	0	7	0	0
13	5871834	.	C	T	0	3	3	0	2	5	0	0
13	5872027	.	G	A	5	2	7	0	0	7	0	0
13	5872126	.	G	A	5	6	11	0	0	11	0	0
13	5872354	.	T	C	4	3	7	0	1	8	0	0
13	5872355	.	T	C	5	0	5	0	3	8	0	0
13	5872596	.	G	C	7	5	12	0	0	12	0	0
13	5872704	.	A	G	1	0	1	0	0	1	0	0
13	5936742	.	A	T	4	4	8	0	0	8	0	0
13	5936945	.	T	G	9	6	15	0	0	15	0	0
13	5974373	.	C	G	1	5	6	0	1	7	0	0
13	5978865	.	T	C	0	2	2	0	0	2	0	0
13	5978871	.	A	G	0	0	0	0	2	2	0	0
13	5985772	.	A	G	0	4	4	0	0	4	0	0
13	5987702	.	T	C	15	7	22	0	0	22	0	0
13	5987712	.	A	G	11	9	20	0	2	22	0	0
13	5988145	.	A	G	3	4	7	0	1	8	0	0
13	5999159	.	G	A	1	2	3	0	0	3	0	0
13	6271347	.	A	G	0	1	1	0	1	2	0	0
13	6279243	.	T	C	5	2	7	0	0	7	0	0
13	6279570	.	C	T	0	3	3	0	1	4	0	0
13	7061413	.	G	A	5	4	9	0	0	9	0	0
13	7062882	.	C	T	2	3	5	0	0	5	0	0
13	7062883	.	T	A	2	3	5	0	0	5	0	0
13	7062945	.	A	T	2	5	7	0	1	8	0	0
13	7063644	.	C	T	8	7	15	0	1	16	0	0
13	7063757	.	C	G	2	11	13	0	0	13	0	0
13	7170250	.	C	T	3	3	6	0	0	6	0	0
13	7170279	.	C	G	2	2	4	0	0	4	0	0
13	7170288	.	A	G	2	2	4	0	0	4	0	0
13	7171148	.	T	C	1	2	3	0	0	3	0	0
13	7179802	.	A	T	2	3	5	0	0	5	0	0
13	7179808	.	G	A	1	3	4	0	1	5	0	0
13	7180323	.	C	T	0	2	2	0	0	2	0	0
13	7191815	.	C	A	2	5	7	0	0	7	0	0
13	7243445	.	T	G	2	0	2	0	4	6	0	0
13	7306144	.	T	A	1	4	5	0	0	5	0	0
13	7307382	.	A	C	3	3	6	0	0	6	0	0
13	7307701	.	T	C	5	5	10	0	0	10	0	0
13	7308157	.	T	G	2	0	2	0	3	5	0	0
13	7309073	.	C	T	1	3	4	0	0	4	0	0
13	7309710	.	A	G	1	3	4	0	0	4	0	0
13	7309721	.	T	C	1	5	6	0	0	6	0	0
13	7310288	.	A	G	2	8	10	0	0	10	0	0
13	7311263	.	G	A	0	4	4	0	2	6	0	0
13	7311327	.	A	C	8	5	13	0	1	14	0	0
13	7312372	.	G	T	8	4	12	0	0	12	0	0
13	7312931	.	A	G	9	8	17	0	0	17	0	0
13	7313418	.	G	C	7	5	12	0	0	12	0	0
13	7313443	.	A	T	4	5	9	0	0	9	0	0
13	7313898	.	C	T	6	12	18	0	2	20	0	0
13	7314080	.	G	A	5	9	14	0	0	14	0	0
13	7314222	.	A	T	6	7	13	0	0	13	0	0
13	7314451	.	A	G	5	1	6	0	7	13	0	0
13	7314509	.	C	T	3	8	11	0	0	11	0	0
13	7314567	.	C	A	10	6	16	0	0	16	0	0
13	7314568	.	T	G	10	5	15	0	1	16	0	0
13	7314823	.	C	T	9	14	23	0	0	23	0	0
13	7314856	.	G	A	10	11	21	0	2	23	0	0
13	7315015	.	C	T	11	11	22	0	4	26	0	0
13	7315098	.	T	C	19	17	36	0	0	36	0	0
13	7315234	.	A	G	14	15	29	0	1	30	0	0
13	7315424	.	G	A	0	11	11	0	21	32	0	0
13	7316453	.	G	T	5	7	12	0	0	12	0	0
13	7316558	.	G	T	7	9	16	0	0	16	0	0
13	7316603	.	A	T	5	6	11	0	1	12	0	0
13	7316746	.	A	G	11	2	13	0	5	18	0	0
13	7316849	.	A	T	4	4	8	0	0	8	0	0
13	7333342	.	G	T	2	0	2	0	0	2	0	0
13	7339931	.	G	C	0	3	3	0	0	3	0	0
13	7340207	.	A	T	1	2	3	0	0	3	0	0
13	7346864	.	A	G	24	9	33	0	1	34	0	0
13	7347125	.	G	A	5	6	11	0	1	12	0	0
13	7347142	.	A	G	6	2	8	0	0	8	0	0
13	7693681	.	C	T	3	2	5	0	0	5	0	0
13	7696482	.	C	T	2	6	8	0	0	8	0	0
13	7696509	.	C	T	6	2	8	0	0	8	0	0
13	7698480	.	C	T	1	4	5	0	0	5	0	0
13	7711335	.	G	T	2	2	4	0	0	4	0	0
13	7725965	.	C	T	5	4	9	0	0	9	0	0
13	7728958	.	C	T	5	2	7	0	0	7	0	0
13	7744319	.	A	G	2	5	7	0	1	8	0	0
13	7744443	.	G	A	2	0	2	0	0	2	0	0
13	7744624	.	T	G	10	19	29	0	0	29	0	0
13	7745324	.	T	G	4	0	4	0	17	21	0	0
13	7745332	.	T	G	6	0	6	0	12	18	0	0
13	7745372	.	G	A	0	3	3	0	8	11	0	0
13	7745378	.	G	T	2	7	9	0	1	10	0	0
13	7745463	.	C	G	7	8	15	0	2	17	0	0
13	7747513	.	C	G	9	7	16	0	2	18	0	0
13	7747760	.	T	C	6	15	21	0	0	21	0	0
13	7747963	.	G	A	0	3	3	0	1	4	0	0
13	7747964	.	A	G	1	3	4	0	0	4	0	0
13	7748021	.	G	T	7	8	15	0	0	15	0	0
13	7748164	.	A	G	8	0	8	0	16	24	0	0
13	7748218	.	T	C	9	7	16	0	0	16	0	0
13	7748497	.	T	G	4	3	7	0	1	8	0	0
13	7748882	.	A	T	11	11	22	0	0	22	0	0
13	7748995	.	T	A	7	10	17	0	1	18	0	0
13	7749000	.	G	C	7	10	17	0	1	19	1	0
13	7755764	.	A	C	3	1	4	0	1	5	0	0
13	7759403	.	T	C	7	13	20	0	2	22	0	0
13	7766936	.	C	T	0	15	15	0	17	32	0	0
13	8135212	.	A	G	0	3	3	0	0	3	0	0
13	8142558	.	A	G	3	3	6	0	0	6	0	0
13	8170854	.	T	C	1	0	1	0	1	2	0	0
13	8170859	.	A	T	1	2	3	0	0	3	0	0
13	8281619	.	C	A	5	4	9	0	0	9	0	0
13	8281669	.	C	A	4	6	10	0	0	10	0	0
13	8281717	.	C	G	2	8	10	0	1	11	0	0
13	8281876	.	G	T	5	1	6	0	1	7	0	0
13	8281882	.	T	G	5	2	7	0	0	7	0	0
13	8285256	.	T	A	7	4	11	0	0	11	0	0
13	8285430	.	G	A	3	4	7	0	1	8	0	0
13	8285559	.	G	A	0	4	4	0	0	4	0	0
13	8317903	.	C	A	3	2	5	0	0	5	0	0
13	8317944	.	A	T	1	3	4	0	0	4	0	0
13	8317949	.	A	G	1	3	4	0	0	4	0	0
13	8320631	.	T	C	1	2	3	0	0	3	0	0
13	8320785	.	G	A	1	6	7	0	0	7	0	0
13	8320852	.	C	G	3	3	6	0	0	6	0	0
13	8320890	.	A	G	2	2	4	0	0	4	0	0
13	8323740	.	A	C	4	2	6	0	1	7	0	0
13	8330296	.	G	C	1	1	2	0	0	2	0	0
13	8330568	.	G	A	2	3	5	0	2	7	0	0
13	8333864	.	G	A	3	2	5	0	0	5	0	0
13	8340044	.	G	T	2	2	4	0	0	4	0	0
13	8340182	.	G	T	1	1	2	0	0	2	0	0
13	8347708	.	C	T	1	1	2	0	0	2	0	0
13	8348077	.	T	A	3	2	5	0	0	5	0	0
13	8348298	.	G	T	1	2	3	0	0	3	0	0
13	8348367	.	A	G	2	2	4	0	1	5	0	0
13	8352188	.	A	C	1	0	1	0	2	3	0	0
13	8352727	.	G	A	1	2	3	0	0	3	0	0
13	8352804	.	G	A	1	2	3	0	1	4	0	0
13	8378519	.	A	G	4	4	8	0	0	8	0	0
13	8378559	.	C	A	3	6	9	0	0	9	0	0
13	8378839	.	C	T	1	2	3	0	0	3	0	0
13	8378840	.	T	G	1	2	3	0	0	3	0	0
13	8379079	.	A	C	0	0	0	0	6	6	0	0
13	8380477	.	T	C	1	3	4	0	0	4	0	0
13	8380555	.	T	C	1	3	4	0	0	4	0	0
13	8380870	.	T	C	2	0	2	0	4	6	0	0
13	8381666	.	C	A	2	1	3	0	0	3	0	0
13	8381706	.	G	A	1	2	3	0	1	4	0	0
13	8388747	.	A	C	1	2	3	0	0	3	0	0
13	8388748	.	C	T	1	1	2	0	1	3	0	0
13	8452963	.	T	A	1	3	4	0	1	5	0	0
13	8516496	.	T	C	0	1	1	0	0	1	0	0
13	8600706	.	G	T	2	3	5	0	0	5	0	0
13	8605000	.	T	A	2	2	4	0	0	4	0	0
13	8605132	.	T	A	1	4	5	0	0	5	0	0
13	8605145	.	T	A	1	3	4	0	0	4	0	0
13	8621262	.	T	C	3	2	5	0	0	5	0	0
13	8621325	.	C	T	1	4	5	0	0	5	0	0
13	8621601	.	A	C	4	2	6	0	0	6	0	0
13	8622382	.	G	A	2	3	5	0	1	6	0	0
13	8622801	.	T	C	4	4	8	0	0	8	0	0
13	8622993	.	A	G	2	0	2	0	2	4	0	0
13	8623343	.	T	A	4	4	8	0	0	8	0	0
13	8623348	.	A	G	5	4	9	0	0	9	0	0
13	8623387	.	T	C	3	3	6	0	1	7	0	0
13	8623659	.	A	C	1	4	5	0	0	5	0	0
13	8623789	.	T	A	4	2	6	0	1	7	0	0
13	8623806	.	T	C	3	2	5	0	1	6	0	0
13	8623836	.	C	T	4	2	6	0	0	6	0	0
13	8624658	.	T	C	4	4	8	0	0	8	0	0
13	8624659	.	G	T	4	4	8	0	0	8	0	0
13	8624996	.	T	C	1	3	4	0	0	4	0	0
13	8626521	.	G	C	5	3	8	0	0	8	0	0
13	8626699	.	C	T	9	6	15	0	0	15	0	0
13	8626786	.	G	A	0	5	5	0	4	9	0	0
13	8627056	.	T	C	5	4	9	0	1	10	0	0
13	8627178	.	T	A	5	7	12	0	0	12	0	0
13	8627179	.	A	T	5	7	12	0	0	12	0	0
13	8627222	.	C	T	5	5	10	0	1	11	0	0
13	8627302	.	C	A	4	7	11	0	0	11	0	0
13	8627445	.	A	G	4	6	10	0	0	10	0	0
13	8627586	.	G	T	4	4	8	0	0	8	0	0
13	8627626	.	G	A	0	13	13	0	12	25	0	0
13	8627677	.	G	A	10	12	22	0	1	23	0	0
13	8627748	.	T	C	3	6	9	0	0	9	0	0
13	8627921	.	A	T	3	5	8	0	0	8	0	0
13	8627947	.	C	T	2	3	5	0	1	6	0	0
13	8684608	.	G	A	2	9	11	0	2	13	0	0
13	8684705	.	A	G	12	6	18	0	0	18	0	0
13	8685051	.	C	T	0	4	4	0	11	15	0	0
13	8685228	.	G	C	4	3	7	0	0	7	0	0
13	8685272	.	C	T	7	2	9	0	0	9	0	0
13	8685278	.	C	A	3	7	10	0	0	10	0	0
13	8685496	.	A	T	1	6	7	0	0	7	0	0
13	8685622	.	T	C	6	6	12	0	0	12	0	0
13	8692306	.	C	T	7	6	13	0	0	13	0	0
13	8692368	.	C	T	0	3	3	0	10	13	0	0
13	8692395	.	A	G	1	6	7	0	0	7	0	0
13	8692827	.	T	G	3	3	6	0	0	6	0	0
13	8777682	.	C	T	10	16	26	0	0	26	0	0
13	8777724	.	T	C	17	9	26	0	2	28	0	0
13	8778490	.	G	A	18	30	48	0	4	52	0	0
13	8778548	.	G	A	13	27	40	0	2	42	0	0
13	8781159	.	G	C	0	2	2	0	3	5	0	0
13	8781577	.	A	G	9	18	27	0	6	33	0	0
13	8781786	.	C	T	24	19	43	0	4	47	0	0
13	8781789	.	A	C	26	21	47	0	2	49	0	0
13	8782036	.	T	C	2	3	5	0	0	5	0	0
13	8785294	.	C	G	13	8	21	0	0	21	0	0
13	8785327	.	T	C	10	5	15	0	1	16	0	0
13	8901899	.	G	A	0	1	1	0	0	1	0	0
13	8928771	.	G	C	0	1	1	0	0	1	0	0
13	8931027	.	T	G	1	0	1	0	2	3	0	0
13	8931033	.	G	A	1	2	3	0	0	3	0	0
13	8937412	.	A	G	1	3	4	0	0	4	0	0
13	8937472	.	T	G	2	2	4	0	0	4	0	0
13	8945642	.	C	G	2	1	3	0	0	4	1	0
13	8945646	.	T	G	2	2	4	0	0	4	0	0
13	8950795	.	C	A	4	2	6	0	1	7	0	0
13	9299881	.	C	G	4	3	7	0	0	7	0	0
13	9300204	.	G	A	6	4	10	0	0	10	0	0
13	9300224	.	C	T	0	6	6	0	1	7	0	0
13	9304107	.	G	C	7	3	10	0	0	10	0	0
13	9307202	.	C	T	0	7	7	0	7	14	0	0
13	9311011	.	G	T	11	13	24	0	1	25	0	0
13	9313806	.	C	T	2	18	20	0	16	36	0	0
13	9313858	.	A	T	35	23	58	0	3	61	0	0
13	9313975	.	T	C	36	29	65	0	2	67	0	0
13	9314024	.	C	A	40	24	64	0	1	65	0	0
13	9314104	.	C	T	2	34	36	0	25	62	1	0
13	9314238	.	G	A	35	24	59	0	4	63	0	0
13	9314580	.	A	T	31	35	66	0	0	66	0	0
13	9314620	.	C	T	34	26	60	0	3	63	0	0
13	9314630	.	C	T	2	31	33	0	33	66	0	0
13	9314657	.	C	T	33	35	68	0	0	68	0	0
13	9314680	.	G	A	31	36	67	0	2	69	0	0
13	9314710	.	G	A	45	23	68	0	0	68	0	0
13	9314800	.	T	C	32	43	75	0	2	77	0	0
13	9314935	.	G	A	37	49	86	0	1	87	0	0
13	9315045	.	C	G	49	25	74	0	5	79	0	0
13	9315321	.	G	T	32	61	93	0	2	95	0	0
13	9315424	.	G	A	20	22	42	0	0	42	0	0
13	9315686	.	C	T	3	22	25	0	30	55	0	0
13	9315730	.	A	G	7	4	11	0	1	12	0	0
13	9317945	.	C	T	51	31	82	0	2	84	0	0
13	9318003	.	C	T	12	26	38	0	43	81	0	0
13	9318116	.	T	C	41	34	75	0	4	79	0	0
13	9318125	.	C	T	48	37	85	0	1	87	1	0
13	9318263	.	C	T	49	41	90	0	3	93	0	0
13	9318446	.	T	C	47	40	87	0	5	92	0	0
13	9318491	.	G	C	31	52	83	0	0	83	0	0
13	9318521	.	A	G	51	25	76	0	3	79	0	0
13	9318682	.	T	C	24	0	24	0	45	69	0	0
13	9318699	.	A	T	29	42	71	0	1	72	0	0
13	9340093	.	C	T	0	4	4	0	6	10	0	0
13	9340199	.	T	C	5	7	12	0	1	13	0	0
13	9340527	.	C	T	11	8	19	0	0	19	0	0
13	9340671	.	G	A	13	9	22	0	0	22	0	0
13	9344878	.	A	T	6	6	12	0	0	12	0	0
13	9351194	.	T	C	0	1	1	0	0	1	0	0
13	9356123	.	G	T	8	13	21	0	1	22	0	0
13	9358457	.	T	G	11	12	23	0	1	24	0	0
13	9367537	.	A	G	12	10	22	0	0	22	0	0
13	9367600	.	G	T	12	8	20	0	0	20	0	0
13	9373615	.	G	A	1	1	2	0	1	3	0	0
13	9373646	.	G	A	1	2	3	0	0	3	0	0
13	9374188	.	C	T	4	2	6	0	0	6	0	0
13	9374827	.	C	G	1	2	3	0	0	3	0	0
13	9375860	.	G	C	3	2	5	0	0	5	0	0
13	9375900	.	G	A	3	2	5	0	0	5	0	0
13	9375929	.	G	A	1	2	3	0	1	4	0	0
13	9375990	.	A	G	1	3	4	0	0	4	0	0
13	9376045	.	A	G	3	4	7	0	1	8	0	0
13	9376307	.	T	C	1	2	3	0	0	3	0	0
13	9376350	.	G	A	3	3	6	0	0	6	0	0
13	9384839	.	A	G	2	3	5	0	2	7	0	0
13	9384877	.	T	A	1	4	5	0	0	5	0	0
13	9384935	.	A	G	2	4	6	0	0	6	0	0
13	9384997	.	C	G	3	6	9	0	0	9	0	0
13	9384998	.	G	A	0	6	6	0	3	9	0	0
13	9385060	.	C	T	2	3	5	0	0	5	0	0
13	9385127	.	G	T	0	3	3	0	2	5	0	0
13	9385129	.	G	A	0	3	3	0	2	5	0	0
13	9385243	.	G	A	2	2	4	0	0	4	0	0
13	9385304	.	A	T	1	4	5	0	0	5	0	0
13	9385561	.	G	A	0	2	2	0	0	2	0	0
13	9392020	.	G	A	2	6	8	0	0	8	0	0
13	9392047	.	G	A	4	3	7	0	0	7	0	0
13	9392068	.	A	G	5	3	8	0	0	8	0	0
13	9392260	.	G	A	0	5	5	0	1	6	0	0
13	9394684	.	A	T	2	4	6	0	1	7	0	0
13	9394716	.	A	G	2	5	7	0	1	8	0	0
13	9395458	.	G	T	1	5	6	0	0	6	0	0
13	9550911	.	A	G	1	2	3	0	0	3	0	0
13	9554761	.	T	C	1	3	4	0	0	4	0	0
13	9554825	.	T	G	0	3	3	0	0	3	0	0
13	9554828	.	T	C	1	2	3	0	0	3	0	0
13	9554956	.	T	C	2	3	5	0	0	5	0	0
13	9555516	.	A	C	2	3	5	0	1	6	0	0
13	9556178	.	C	T	3	4	7	0	0	7	0	0
13	9556194	.	T	C	6	4	10	0	0	10	0	0
13	9556322	.	A	G	4	0	4	0	7	11	0	0
13	9556426	.	C	T	3	4	7	0	0	7	0	0
13	9556734	.	C	G	4	3	7	0	0	7	0	0
13	9556885	.	A	G	5	1	6	0	0	6	0	0
13	9556950	.	C	G	1	2	3	2	0	5	0	0
13	9556956	.	A	G	0	0	0	2	3	5	0	0
13	9557638	.	T	A	2	2	4	0	0	4	0	0
13	9557917	.	G	C	1	2	3	0	0	3	0	0
13	9558312	.	T	A	1	2	3	0	0	3	0	0
13	9558321	.	T	C	1	3	4	0	0	4	0	0
13	9559527	.	A	C	8	5	13	0	0	13	0	0
13	9559542	.	A	G	7	0	7	0	8	15	0	0
13	9560897	.	T	C	3	4	7	0	0	7	0	0
13	9565065	.	G	A	0	4	4	0	4	8	0	0
13	9568857	.	G	A	0	1	1	0	4	5	0	0
13	9568861	.	T	C	3	1	4	0	0	4	0	0
13	9570532	.	A	T	3	4	7	0	0	7	0	0
13	9570598	.	A	G	3	9	12	0	1	13	0	0
13	9571695	.	C	T	5	6	11	0	0	11	0	0
13	9571949	.	T	C	12	5	17	0	0	17	0	0
13	9571972	.	G	A	11	4	15	0	1	16	0	0
13	9572036	.	G	A	4	4	8	0	1	9	0	0
13	9623933	.	A	G	1	0	1	0	3	4	0	0
13	9623945	.	A	G	1	3	4	0	0	4	0	0
13	9759182	.	C	T	2	4	6	0	0	6	0	0
13	9759700	.	G	T	0	2	2	0	3	5	0	0
13	9760013	.	A	G	3	0	3	0	4	7	0	0
13	9825710	.	T	A	0	1	1	0	1	2	0	0
13	9825852	.	G	A	1	2	3	0	1	4	0	0
13	9828780	.	G	A	4	4	8	0	0	8	0	0
13	9828849	.	G	A	4	7	11	0	0	11	0	0
13	9828933	.	G	T	10	8	18	0	0	18	0	0
13	9829007	.	A	G	1	3	4	0	0	4	0	0
13	9829013	.	C	T	1	4	5	0	0	5	0	0
13	9829197	.	T	C	5	5	10	0	1	11	0	0
13	9829361	.	G	T	4	3	7	0	0	7	0	0
13	9829855	.	C	T	3	4	7	0	0	7	0	0
13	9830066	.	A	T	3	2	5	0	1	6	0	0
13	9830089	.	T	C	1	3	4	0	0	4	0	0
13	9830518	.	A	T	0	9	9	0	1	10	0	0
13	9830521	.	A	C	1	7	8	0	0	8	0	0
13	9844440	.	G	A	5	6	11	0	0	11	0	0
13	9844527	.	A	G	3	0	3	0	0	3	0	0
13	9848385	.	G	A	3	9	12	0	0	12	0	0
13	9848577	.	A	G	23	23	46	0	3	49	0	0
13	9855508	.	G	T	7	13	20	0	0	20	0	0
13	9855874	.	G	A	10	15	25	0	0	25	0	0
13	9856319	.	A	G	12	6	18	0	2	20	0	0
13	9856427	.	A	G	8	11	19	0	3	22	0	0
13	9856493	.	A	T	13	19	32	0	0	32	0	0
13	9856658	.	A	G	27	14	41	0	0	41	0	0
13	9863888	.	G	A	8	3	11	0	1	12	0	0
13	9901540	.	C	G	0	2	2	0	0	2	0	0
13	9924978	.	C	T	1	4	5	0	0	5	0	0
13	9924993	.	G	C	2	4	6	0	0	6	0	0
13	10004132	.	C	T	0	2	2	0	0	2	0	0
13	10004138	.	G	A	0	2	2	0	0	2	0	0
13	10362407	.	A	T	1	3	4	0	0	4	0	0
13	10362422	.	A	G	1	3	4	0	0	4	0	0
13	10362605	.	G	C	1	3	4	0	0	4	0	0
13	10362823	.	T	G	1	2	3	0	0	3	0	0
13	10380372	.	A	G	0	2	2	0	0	2	0	0
13	10403048	.	T	C	0	1	1	0	0	1	0	0
13	10403053	.	A	G	0	1	1	0	0	1	0	0
13	12624860	.	C	T	4	6	10	0	1	11	0	0
13	12628901	.	C	T	14	4	18	0	0	18	0	0
13	12635770	.	C	T	1	1	2	0	0	2	0	0
13	12642077	.	C	A	0	1	1	0	0	1	0	0
13	12646651	.	T	C	1	3	4	0	0	4	0	0
13	12665227	.	C	A	0	6	6	0	1	7	0	0
13	12665411	.	T	A	0	5	5	0	0	5	0	0
13	12665595	.	T	C	13	6	19	0	0	19	0	0
13	12665678	.	T	A	1	10	11	0	1	12	0	0
13	12665745	.	T	C	6	2	8	0	0	8	0	0
13	12665761	.	T	C	2	3	5	0	0	5	0	0
13	12665859	.	A	T	1	1	2	0	0	2	0	0
13	12665863	.	C	T	0	2	2	0	0	2	0	0
13	12665990	.	C	A	4	5	9	0	0	9	0	0
13	12666017	.	T	C	6	0	6	0	4	10	0	0
13	12666038	.	G	A	3	4	7	0	1	8	0	0
13	12666182	.	C	T	4	6	10	0	0	10	0	0
13	12666183	.	G	A	6	3	9	0	1	10	0	0
13	12681386	.	A	T	1	4	5	0	0	5	0	0
13	12681777	.	G	C	2	2	4	0	0	4	0	0
13	12739444	.	G	T	6	8	14	0	2	16	0	0
13	12739894	.	T	A	9	7	16	0	1	17	0	0
13	12739939	.	C	T	9	6	15	0	1	16	0	0
13	12740092	.	G	T	0	9	9	0	8	17	0	0
13	12740113	.	A	T	9	7	16	0	0	16	0	0
13	12740129	.	C	T	6	7	13	0	1	14	0	0
13	12740236	.	A	G	4	6	10	0	2	12	0	0
13	12740971	.	T	G	17	13	30	0	0	30	0	0
13	12762350	.	G	A	2	2	4	0	0	4	0	0
13	12762486	.	T	G	3	4	7	0	0	7	0	0
13	12762978	.	C	T	1	2	3	0	0	3	0	0
13	12769323	.	T	C	0	1	1	0	0	1	0	0
13	12769359	.	A	G	3	0	3	0	2	5	0	0
13	12778142	.	T	C	0	5	5	0	0	5	0	0
13	12778247	.	T	G	4	2	6	0	0	6	0	0
13	12847720	.	C	T	1	3	4	0	0	4	0	0
13	12865979	.	A	T	2	2	4	0	0	4	0	0
13	12866033	.	G	A	0	2	2	0	0	2	0	0
13	12866276	.	G	A	4	2	6	0	0	6	0	0
13	12868492	.	A	G	2	3	5	0	0	5	0	0
13	12874147	.	C	T	0	1	1	0	0	1	0	0
13	12874972	.	G	A	1	3	4	0	0	4	0	0
13	12883529	.	G	A	0	2	2	0	3	5	0	0
13	12891860	.	A	G	5	3	8	0	0	8	0	0
13	12891881	.	A	G	4	4	8	0	0	8	0	0
13	12899310	.	G	C	1	1	2	0	0	2	0	0
13	12899356	.	C	T	3	3	6	0	0	6	0	0
13	12904744	.	G	T	9	8	17	0	0	17	0	0
13	12906773	.	T	C	4	9	13	0	0	13	0	0
13	12915909	.	T	C	1	2	3	0	0	3	0	0
13	12915927	.	A	T	1	2	3	0	0	3	0	0
13	12916079	.	A	C	0	1	1	0	0	1	0	0
13	12917364	.	G	C	1	4	5	0	0	5	0	0
13	12917382	.	C	T	5	4	9	0	0	9	0	0
13	12917424	.	G	A	5	5	10	0	0	10	0	0
13	12917427	.	T	C	5	5	10	0	0	10	0	0
13	12918227	.	G	C	2	1	3	0	0	3	0	0
13	12920837	.	T	C	6	7	13	0	1	14	0	0
13	12920924	.	C	T	6	4	10	0	0	10	0	0
13	12940084	.	C	T	5	4	9	0	0	9	0	0
13	12946108	.	G	A	4	0	4	0	0	4	0	0
13	12955335	.	C	T	8	9	17	0	1	18	0	0
13	12955377	.	C	T	4	8	12	0	0	12	0	0
13	12955413	.	C	T	1	1	2	0	0	2	0	0
13	12955549	.	C	T	3	2	5	0	0	5	0	0
13	12962979	.	G	A	0	0	0	0	1	1	0	0
13	12963052	.	C	T	10	11	21	0	1	22	0	0
13	12967432	.	G	C	7	13	20	0	0	20	0	0
13	12967438	.	C	T	6	10	16	0	2	18	0	0
13	12970797	.	C	T	9	8	17	0	0	17	0	0
13	12971856	.	G	A	6	2	8	0	1	9	0	0
13	12985114	.	C	T	13	19	32	0	2	34	0	0
13	12985193	.	T	A	21	10	31	0	1	32	0	0
13	12985253	.	G	A	1	12	13	0	21	34	0	0
13	12985291	.	G	A	16	12	28	0	3	31	0	0
13	12985376	.	G	A	0	16	16	0	18	34	0	0
13	12985539	.	T	C	16	9	25	0	1	26	0	0
13	12985540	.	A	G	16	0	16	0	10	26	0	0
13	12985822	.	T	G	10	3	13	1	1	15	0	0
13	12994738	.	A	T	8	7	15	0	1	16	0	0
13	12994743	.	G	T	8	7	15	0	1	16	0	0
13	12997845	.	C	T	3	5	8	0	1	9	0	0
13	13001540	.	G	T	6	2	8	0	0	8	0	0
13	13004739	.	G	A	3	0	3	0	0	3	0	0
13	13004748	.	G	A	3	0	3	0	0	3	0	0
13	13008496	.	G	A	1	5	6	0	0	6	0	0
13	13019085	.	G	T	1	3	4	0	0	4	0	0
13	13027068	.	A	C	3	2	5	0	0	5	0	0
13	13027200	.	G	A	1	1	2	0	0	2	0	0
13	13027206	.	C	T	0	2	2	0	1	3	0	0
13	13027245	.	G	A	1	1	2	0	0	2	0	0
13	13027270	.	C	G	1	1	2	0	0	2	0	0
13	13069251	.	C	T	4	4	8	0	0	8	0	0
13	13072658	.	G	T	12	5	17	0	0	17	0	0
13	13091046	.	C	A	1	1	2	0	0	2	0	0
13	13091079	.	T	C	7	7	14	0	0	14	0	0
13	13094191	.	A	G	6	1	7	0	1	8	0	0
13	13096526	.	T	C	4	7	11	0	0	11	0	0
13	13099625	.	T	C	2	5	7	0	0	7	0	0
13	13099710	.	A	T	2	2	4	0	0	4	0	0
13	13213863	.	G	A	2	1	3	0	0	3	0	0
13	13214412	.	G	A	7	8	15	0	4	19	0	0
13	13214571	.	T	A	9	6	15	0	1	16	0	0
13	13214648	.	C	T	5	3	8	0	0	8	0	0
13	13214883	.	A	T	4	3	7	0	0	7	0	0
13	13215010	.	A	G	1	7	8	0	0	8	0	0
13	13215332	.	C	G	4	2	6	0	0	6	0	0
13	13215474	.	C	T	2	2	4	0	0	4	0	0
13	13215984	.	T	C	6	3	9	0	0	9	0	0
13	13216071	.	A	T	6	5	11	0	1	13	1	0
13	13216156	.	G	A	2	2	4	0	0	4	0	0
13	13216495	.	A	C	2	2	4	0	0	4	0	0
13	13216515	.	T	G	2	2	4	0	0	4	0	0
13	13216593	.	C	T	1	3	4	0	0	4	0	0
13	13216863	.	A	G	1	2	3	0	0	3	0	0
13	13217045	.	C	A	2	3	5	0	0	5	0	0
13	13221451	.	G	A	0	1	1	0	0	1	0	0
13	13245530	.	T	A	1	0	1	0	0	1	0	0
13	13697957	.	G	A	0	1	1	0	1	2	0	0
13	13698240	.	G	T	4	4	8	0	0	8	0	0
13	13699913	.	C	T	4	1	5	0	1	6	0	0
13	13704011	.	T	G	1	3	4	0	0	4	0	0
13	13711149	.	A	G	3	0	3	0	1	4	0	0
13	13712633	.	T	C	3	2	5	0	0	5	0	0
13	13733417	.	G	T	12	14	26	0	2	28	0	0
13	13771020	.	G	A	5	3	8	0	1	9	0	0
13	13917976	.	C	T	6	7	13	0	1	14	0	0
13	13917991	.	C	T	8	3	11	0	0	11	0	0
13	13938461	.	G	A	0	0	0	0	6	6	0	0
13	13942565	.	G	T	2	4	6	0	0	6	0	0
13	13943156	.	C	T	7	2	9	0	0	9	0	0
13	13943562	.	G	T	2	2	4	0	0	4	0	0
13	13943788	.	T	C	1	3	4	0	0	4	0	0
13	13944064	.	A	G	2	3	5	0	1	6	0	0
13	13945276	.	T	A	1	2	3	0	0	3	0	0
13	13945408	.	G	T	3	2	5	0	0	5	0	0
13	13970036	.	G	A	2	1	3	0	0	3	0	0
13	13982767	.	G	A	0	3	3	1	2	6	0	0
13	13983055	.	A	G	0	0	0	0	1	1	0	0
13	13983073	.	G	T	0	1	1	0	0	1	0	0
13	13984582	.	G	A	0	1	1	0	0	1	0	0
13	13997299	.	C	T	3	8	11	0	1	12	0	0
13	13997383	.	T	G	5	0	5	0	7	12	0	0
13	13997446	.	G	T	1	4	5	0	3	8	0	0
13	13999004	.	C	G	0	1	1	0	0	1	0	0
13	14002936	.	A	T	6	4	10	0	0	10	0	0
13	14003099	.	A	G	3	3	6	0	0	6	0	0
13	14004209	.	C	T	6	6	12	0	0	12	0	0
13	14004246	.	T	A	5	9	14	0	1	15	0	0
13	14070774	.	A	T	0	2	2	0	0	2	0	0
13	14070868	.	C	T	1	1	2	0	0	2	0	0
13	14070931	.	T	C	2	4	6	0	0	6	0	0
13	14070961	.	C	T	3	2	5	0	0	5	0	0
13	14078691	.	G	A	1	3	4	0	5	9	0	0
13	14078752	.	T	C	2	2	4	0	0	4	0	0
13	14081204	.	A	T	4	4	8	0	0	8	0	0
13	14088909	.	G	T	1	6	7	0	0	7	0	0
13	14092489	.	C	T	1	3	4	0	0	4	0	0
13	14092573	.	G	A	3	4	7	0	0	7	0	0
13	14094441	.	G	A	8	2	10	0	1	11	0	0
13	14098156	.	T	C	1	1	2	0	0	2	0	0
13	14102253	.	C	T	5	6	11	0	0	11	0	0
13	14103916	.	C	T	8	9	17	0	0	17	0	0
13	14116632	.	C	T	3	2	5	0	0	5	0	0
13	14116869	.	T	C	6	7	13	0	0	13	0	0
13	14137061	.	C	T	1	2	3	0	0	3	0	0
13	14181846	.	A	T	15	4	19	0	0	19	0	0
13	14181912	.	A	C	10	9	19	0	1	20	0	0
13	14190780	.	C	T	0	18	18	0	7	25	0	0
13	14191033	.	T	C	8	15	23	0	0	23	0	0
13	14191045	.	G	C	10	15	25	0	0	25	0	0
13	14191724	.	G	A	10	11	21	0	0	21	0	0
13	14192131	.	G	A	5	13	18	0	1	19	0	0
13	14192178	.	A	T	7	8	15	0	0	15	0	0
13	14192376	.	A	G	8	12	20	0	0	20	0	0
13	14192511	.	A	T	8	6	14	0	0	14	0	0
13	14194660	.	G	A	12	4	16	0	0	16	0	0
13	14194836	.	C	T	0	14	14	0	14	28	0	0
13	14194968	.	T	A	8	7	15	0	0	15	0	0
13	14195100	.	A	G	5	3	8	0	0	8	0	0
13	14199220	.	A	T	13	17	30	0	3	33	0	0
13	14220900	.	G	A	6	9	15	0	0	15	0	0
13	14241819	.	C	T	8	6	14	0	0	14	0	0
13	14251160	.	G	A	2	7	9	0	0	9	0	0
13	14251280	.	C	T	0	2	2	0	7	9	0	0
13	14251313	.	C	A	2	1	3	0	0	3	0	0
13	14487445	.	T	C	2	0	2	0	5	7	0	0
13	15113277	.	A	G	6	2	8	0	0	8	0	0
13	15194410	.	T	C	4	2	6	0	0	6	0	0
13	15848895	.	C	T	6	12	18	0	0	18	0	0
13	16759638	.	A	G	2	3	5	0	0	5	0	0
13	17470079	.	C	T	14	13	27	0	0	27	0	0
13	17470112	.	A	G	11	0	11	0	13	24	0	0
13	17470430	.	T	C	10	14	24	0	0	24	0	0
13	17702657	.	C	T	7	7	14	0	0	14	0	0
13	17703164	.	A	T	9	8	17	0	0	17	0	0
13	17703453	.	T	A	12	11	23	0	0	23	0	0
13	17703454	.	C	A	12	11	23	0	0	23	0	0
13	17703548	.	C	T	6	6	12	0	0	12	0	0
13	17703557	.	G	C	0	4	4	0	8	12	0	0
13	17714510	.	G	T	17	31	48	0	2	50	0	0
13	17714881	.	C	T	24	24	48	0	0	48	0	0
13	17714942	.	A	G	23	24	47	0	2	49	0	0
13	17717608	.	G	A	2	0	2	0	2	4	0	0
13	17752932	.	A	T	5	7	12	0	0	12	0	0
13	17753144	.	A	C	2	1	3	0	10	13	0	0
13	17753668	.	A	C	14	12	26	0	1	27	0	0
13	17753732	.	A	T	9	12	21	0	0	21	0	0
13	17753821	.	A	T	13	4	17	0	0	17	0	0
13	17754071	.	T	G	4	5	9	0	0	9	0	0
13	17754275	.	G	T	6	4	10	0	2	12	0	0
13	17755221	.	C	T	2	5	7	0	0	7	0	0
13	17755579	.	A	G	5	7	12	0	0	12	0	0
13	17755743	.	G	C	7	0	7	0	6	13	0	0
13	17755758	.	C	T	0	6	6	0	8	14	0	0
13	17755812	.	T	C	3	2	5	0	0	5	0	0
13	17755830	.	C	A	3	4	7	0	0	7	0	0
13	17755898	.	G	A	5	11	16	0	1	17	0	0
13	17756043	.	G	A	9	4	13	0	0	13	0	0
13	17756112	.	G	A	7	6	13	0	2	15	0	0
13	17756131	.	A	T	9	5	14	0	1	15	0	0
13	17756186	.	C	A	5	3	8	0	1	9	0	0
13	17756235	.	G	A	5	7	12	0	0	12	0	0
13	17756322	.	G	A	5	6	11	0	2	13	0	0
13	17943071	.	C	T	3	2	5	0	0	5	0	0
13	18011158	.	G	T	1	0	1	0	0	1	0	0
13	18019786	.	C	T	0	5	5	0	4	9	0	0
13	18024418	.	C	T	4	3	7	0	0	7	0	0
13	18024419	.	A	G	4	3	7	0	0	7	0	0
13	18033053	.	A	G	2	2	4	0	0	4	0	0
13	18033073	.	T	G	2	5	7	0	0	7	0	0
13	18038643	.	G	A	1	3	4	0	0	4	0	0
13	18046210	.	G	A	1	4	5	0	0	5	0	0
13	18064536	.	C	T	0	1	1	0	1	2	0	0
13	18073433	.	A	G	8	14	22	0	0	22	0	0
13	18073524	.	G	T	14	3	17	0	2	19	0	0
13	18073582	.	G	T	6	5	11	0	1	12	0	0
13	18073706	.	G	A	5	11	16	0	0	16	0	0
13	18076710	.	T	G	6	7	13	0	1	14	0	0
13	18076788	.	G	C	10	10	20	0	1	21	0	0
13	18076818	.	G	A	11	10	21	0	2	23	0	0
13	18076996	.	C	T	9	13	22	0	1	23	0	0
13	18077056	.	G	T	13	12	25	0	0	25	0	0
13	18077116	.	G	A	6	12	18	0	0	18	0	0
13	18077191	.	C	G	17	10	27	0	1	28	0	0
13	18080348	.	G	A	10	6	16	0	2	18	0	0
13	18080411	.	G	T	5	13	18	0	2	20	0	0
13	18083391	.	C	T	0	1	1	0	7	8	0	0
13	18083415	.	G	A	1	5	6	0	2	8	0	0
13	18087946	.	G	A	7	4	11	0	1	12	0	0
13	18088276	.	T	G	5	10	15	0	0	15	0	0
13	18092062	.	G	T	1	0	1	0	0	1	0	0
13	18092084	.	A	G	4	1	5	0	0	5	0	0
13	18092108	.	T	C	4	4	8	0	0	8	0	0
13	18092266	.	C	T	1	0	1	0	0	1	0	0
13	18092279	.	A	G	2	0	2	0	0	2	0	0
13	18092417	.	A	G	1	2	3	0	0	3	0	0
13	18099947	.	T	C	2	0	2	0	4	6	0	0
13	18104890	.	C	T	6	2	8	0	0	8	0	0
13	18104929	.	A	T	12	4	16	0	0	16	0	0
13	18105175	.	G	A	10	4	14	0	0	14	0	0
13	18105382	.	A	G	0	2	2	0	0	2	0	0
13	18110003	.	T	C	0	0	0	0	1	1	0	0
13	18122193	.	C	T	1	2	3	0	0	3	0	0
13	18122263	.	C	G	0	8	8	0	5	13	0	0
13	18179151	.	C	A	2	3	5	0	1	6	0	0
13	18179391	.	G	C	2	0	2	0	4	6	0	0
13	18179521	.	A	G	5	7	12	0	0	12	0	0
13	18179535	.	G	T	4	7	11	0	1	12	0	0
13	18179757	.	T	C	8	18	26	0	0	26	0	0
13	18179859	.	C	A	15	19	34	0	1	35	0	0
13	18185457	.	A	C	2	0	2	0	0	2	0	0
13	18185463	.	C	A	2	0	2	0	0	2	0	0
13	18195926	.	G	A	3	3	6	0	0	6	0	0
13	18274914	.	A	C	4	2	6	0	0	6	0	0
13	18275935	.	T	C	3	2	5	0	0	5	0	0
13	18276338	.	G	T	0	4	4	0	2	6	0	0
13	18282806	.	A	G	1	1	2	0	0	2	0	0
13	18295212	.	C	T	1	2	3	0	0	3	0	0
13	18295423	.	G	A	0	5	5	0	4	9	0	0
13	18295680	.	T	C	6	7	13	0	0	13	0	0
13	18295718	.	A	G	3	7	10	0	1	11	0	0
13	18295760	.	A	G	3	0	3	0	7	10	0	0
13	18314113	.	T	G	3	0	3	0	5	8	0	0
13	18321156	.	T	C	8	5	13	0	0	13	0	0
13	18323464	.	A	G	8	16	24	0	1	25	0	0
13	18323595	.	G	A	0	9	9	0	21	30	0	0
13	18323653	.	A	G	14	0	14	0	12	26	0	0
13	18323787	.	T	A	16	13	29	0	2	31	0	0
13	18358890	.	G	C	15	19	34	0	0	34	0	0
13	18359112	.	G	C	18	16	34	0	3	37	0	0
13	18359304	.	A	T	8	10	18	0	3	21	0	0
13	18359374	.	C	T	7	14	21	0	4	25	0	0
13	18359507	.	A	T	12	10	22	0	0	22	0	0
13	18371186	.	A	C	1	2	3	0	0	3	0	0
13	18375465	.	C	A	4	3	7	0	2	9	0	0
13	18375512	.	T	A	2	2	4	0	0	4	0	0
13	18382132	.	A	C	1	1	2	0	3	5	0	0
13	18382192	.	T	C	6	3	9	0	0	9	0	0
13	18385512	.	C	T	2	2	4	0	0	4	0	0
13	18385797	.	T	A	1	8	9	0	0	9	0	0
13	18394755	.	T	A	7	6	13	0	0	13	0	0
13	18397138	.	C	G	2	4	6	0	0	6	0	0
13	18397449	.	T	C	0	3	3	0	1	4	0	0
13	18397452	.	T	C	0	4	4	0	0	4	0	0
13	18418337	.	C	A	4	9	13	0	0	13	0	0
13	18418528	.	G	A	2	1	3	0	1	4	0	0
13	18428103	.	A	G	7	3	10	0	0	10	0	0
13	18431278	.	T	A	6	0	6	0	0	6	0	0
13	18431301	.	C	T	8	4	12	0	0	12	0	0
13	18431430	.	C	T	8	4	12	0	0	12	0	0
13	18434354	.	T	C	3	4	7	0	0	7	0	0
13	18434427	.	C	T	7	6	13	0	1	14	0	0
13	18434519	.	C	A	9	7	16	0	3	19	0	0
13	18434520	.	G	C	1	8	9	0	10	19	0	0
13	18434818	.	C	G	10	13	23	0	2	25	0	0
13	18434902	.	C	T	6	7	13	0	1	14	0	0
13	18434957	.	G	A	4	8	12	0	0	12	0	0
13	18434962	.	A	G	5	7	12	0	0	12	0	0
13	18471608	.	A	G	1	2	3	0	0	3	0	0
13	18471615	.	G	T	1	2	3	0	0	3	0	0
13	18499773	.	A	T	2	3	5	0	1	6	0	0
13	18499807	.	A	G	2	3	5	0	0	5	0	0
13	18509592	.	G	A	1	14	15	0	14	29	0	0
13	18509925	.	T	C	12	8	20	0	0	20	0	0
13	18509940	.	C	T	12	9	21	0	0	21	0	0
13	18510319	.	C	A	12	13	25	0	2	27	0	0
13	18510324	.	A	G	14	14	28	0	1	29	0	0
13	18510540	.	G	A	1	10	11	0	11	22	0	0
13	18511023	.	C	T	11	12	23	0	2	25	0	0
13	18511140	.	A	G	13	0	13	0	8	21	0	0
13	18511637	.	A	C	6	8	14	0	1	15	0	0
13	18511763	.	T	A	9	13	22	0	0	22	0	0
13	18511996	.	A	T	9	12	21	0	2	23	0	0
13	18512030	.	A	T	10	12	22	0	1	23	0	0
13	18512082	.	C	G	13	13	26	0	0	26	0	0
13	18624124	.	G	C	0	5	5	0	1	6	0	0
13	18659382	.	C	T	0	1	1	0	0	1	0	0
13	18663103	.	G	A	2	1	3	0	0	3	0	0
13	18663947	.	G	A	4	7	11	0	1	12	0	0
13	18677726	.	T	C	6	7	13	0	0	13	0	0
13	18677749	.	C	A	3	6	9	0	0	9	0	0
13	18677761	.	C	T	2	6	8	0	0	8	0	0
13	18677925	.	A	T	10	6	16	0	1	17	0	0
13	18680027	.	G	A	7	12	19	0	0	19	0	0
13	18685598	.	A	G	8	12	20	0	1	21	0	0
13	18685673	.	G	A	3	3	6	0	0	6	0	0
13	18801820	.	T	C	3	5	8	0	0	8	0	0
13	19304688	.	A	G	12	12	24	0	0	24	0	0
13	19306817	.	C	G	11	5	16	0	0	16	0	0
13	19316930	.	G	C	10	15	25	0	1	26	0	0
13	19317016	.	T	A	4	11	15	0	0	15	0	0
13	19317018	.	C	G	4	10	14	0	1	15	0	0
13	19317051	.	T	G	7	9	16	0	0	16	0	0
13	19627150	.	A	G	3	4	7	0	0	7	0	0
13	19627266	.	A	C	1	0	1	0	0	1	0	0
13	19629266	.	C	G	5	11	16	0	1	17	0	0
13	19639198	.	A	G	1	2	3	0	0	3	0	0
13	19639205	.	G	A	1	2	3	0	0	3	0	0
13	19639238	.	T	C	2	2	4	0	0	4	0	0
13	19639256	.	T	C	4	0	4	0	3	7	0	0
13	19799192	.	A	G	4	1	5	0	0	5	0	0
13	19799467	.	G	A	9	7	16	0	1	17	0	0
13	19799522	.	C	T	13	9	22	0	1	23	0	0
13	19799535	.	T	A	12	10	22	0	1	23	0	0
13	19799623	.	T	C	15	9	24	0	1	25	0	0
13	19799646	.	C	A	0	8	8	0	14	22	0	0
13	19799705	.	A	G	13	11	24	0	0	24	0	0
13	19799799	.	C	T	0	4	4	0	4	8	0	0
13	19884720	.	C	T	4	2	6	0	0	6	0	0
13	20401263	.	C	A	1	12	13	0	6	19	0	0
13	20425396	.	C	T	0	10	10	0	12	22	0	0
13	20518620	.	C	T	0	3	3	0	5	8	0	0
13	20518711	.	C	T	12	4	16	0	0	16	0	0
13	21638617	.	T	A	2	2	4	0	0	4	0	0
13	21638671	.	T	C	2	4	6	0	0	6	0	0
13	21638916	.	G	A	6	6	12	0	0	12	0	0
13	21638955	.	C	A	5	6	11	0	0	11	0	0
13	21681224	.	A	T	1	4	5	0	0	5	0	0
13	21683057	.	A	C	5	6	11	0	0	11	0	0
13	21683077	.	T	C	3	9	12	0	2	14	0	0
13	21683488	.	A	T	15	17	32	0	1	33	0	0
13	21683511	.	T	G	12	14	26	0	2	28	0	0
13	21683546	.	C	T	10	13	23	0	2	25	0	0
13	21689373	.	G	A	4	2	6	0	0	6	0	0
13	21689438	.	A	C	8	6	14	0	0	14	0	0
13	21689439	.	C	T	7	6	13	0	1	14	0	0
13	21689839	.	C	T	0	7	7	0	1	8	0	0
13	21689854	.	C	T	7	0	7	0	1	8	0	0
13	21689982	.	G	A	6	6	12	0	2	14	0	0
13	21690096	.	C	G	7	5	12	0	0	12	0	0
13	21690229	.	A	C	7	6	13	1	1	15	0	0
13	21690374	.	G	A	13	9	22	0	0	22	0	0
13	21690530	.	C	T	0	8	8	0	7	15	0	0
13	21690636	.	T	C	10	4	14	0	0	14	0	0
13	21690724	.	A	T	3	8	11	0	1	12	0	0
13	21690877	.	A	C	5	0	5	0	9	14	0	0
13	21691324	.	G	A	1	4	5	1	1	7	0	0
13	21691390	.	G	A	2	6	8	0	1	9	0	0
13	21691416	.	G	A	8	7	15	0	0	15	0	0
13	21691794	.	G	A	4	10	14	0	0	14	0	0
13	21692328	.	C	A	3	3	6	0	1	7	0	0
13	21692338	.	C	T	3	5	8	0	1	9	0	0
13	21692705	.	C	G	0	4	4	0	4	8	0	0
13	21692859	.	C	T	11	4	15	0	1	16	0	0
13	21693187	.	A	G	7	7	14	0	1	15	0	0
13	21693208	.	A	C	8	0	8	0	5	13	0	0
13	21693285	.	A	T	4	5	9	0	0	9	0	0
13	21693342	.	C	T	3	6	9	0	2	11	0	0
13	21693361	.	C	T	7	6	13	0	2	15	0	0
13	21693410	.	G	C	8	5	13	0	0	13	0	0
13	21693514	.	A	T	13	8	21	0	1	22	0	0
13	21695438	.	G	T	8	9	17	0	2	19	0	0
13	21712507	.	G	A	13	14	27	0	0	27	0	0
13	21712526	.	G	A	10	12	22	0	1	23	0	0
13	21712755	.	G	C	3	7	10	0	1	11	0	0
13	21716581	.	T	C	1	5	6	0	0	6	0	0
13	21725502	.	G	T	5	3	8	0	0	8	0	0
13	21725526	.	T	C	5	1	6	0	0	6	0	0
13	21727796	.	T	A	2	4	6	0	0	6	0	0
13	21727799	.	G	A	3	2	5	0	0	5	0	0
13	21735278	.	C	T	1	1	2	0	0	2	0	0
13	21739036	.	A	T	0	2	2	0	1	3	0	0
13	21770891	.	T	C	10	7	17	0	0	17	0	0
13	21775469	.	C	T	4	9	13	0	2	15	0	0
13	21775697	.	C	T	8	10	18	0	0	18	0	0
13	21776039	.	C	T	2	5	7	0	0	7	0	0
13	21776046	.	G	C	1	4	5	0	1	6	0	0
13	21776230	.	G	T	0	4	4	0	1	5	0	0
13	21776650	.	C	A	1	2	3	0	0	3	0	0
13	21821299	.	G	T	4	2	6	0	0	6	0	0
13	21826168	.	C	A	4	2	6	0	0	6	0	0
13	21826203	.	G	T	3	1	4	0	0	4	0	0
13	21826470	.	G	A	0	2	2	0	5	7	0	0
13	21851617	.	C	T	0	1	1	0	0	1	0	0
13	21853237	.	A	G	3	3	6	0	0	6	0	0
13	21853240	.	C	T	2	3	5	0	0	5	0	0
13	21855811	.	C	T	0	5	5	0	0	5	0	0
13	21855829	.	G	A	5	3	8	0	0	8	0	0
13	21855868	.	C	T	5	5	10	0	0	10	0	0
13	21856741	.	G	A	2	3	5	0	1	6	0	0
13	21856849	.	G	A	0	6	6	0	5	11	0	0
13	21860111	.	G	A	1	3	4	0	0	4	0	0
13	21861775	.	A	C	1	7	8	0	1	9	0	0
13	21861777	.	G	A	2	7	9	0	0	9	0	0
13	21862288	.	T	A	4	5	9	0	0	9	0	0
13	21864182	.	T	A	3	3	6	0	0	6	0	0
13	21866357	.	A	C	2	8	10	0	2	12	0	0
13	21869927	.	C	T	7	1	8	0	0	8	0	0
13	21870467	.	G	C	0	15	15	0	13	28	0	0
13	21870575	.	A	G	9	1	10	0	19	29	0	0
13	21870608	.	A	T	10	9	19	0	1	20	0	0
13	21874107	.	C	T	5	3	8	0	0	8	0	0
13	21874149	.	G	T	1	10	11	0	11	22	0	0
13	21874649	.	C	T	10	6	16	0	0	16	0	0
13	21884298	.	C	T	12	16	28	0	0	28	0	0
13	21884328	.	G	A	13	13	26	0	2	28	0	0
13	21884407	.	T	C	12	9	21	0	0	21	0	0
13	21884408	.	C	T	12	8	20	0	1	21	0	0
13	21884979	.	T	C	5	15	20	0	0	20	0	0
13	21884980	.	C	T	5	15	20	0	0	20	0	0
13	21885143	.	C	A	14	14	28	0	2	30	0	0
13	21885198	.	T	A	10	22	32	0	1	33	0	0
13	22064678	.	G	A	2	3	5	0	0	5	0	0
13	22064775	.	G	A	2	3	5	0	1	6	0	0
13	22065631	.	A	G	5	4	9	0	0	9	0	0
13	22065661	.	G	A	5	4	9	0	0	9	0	0
13	22087098	.	C	T	2	3	5	0	0	5	0	0
13	22087508	.	C	T	6	13	19	0	0	19	0	0
13	22088061	.	T	G	3	1	4	0	8	12	0	0
13	22094800	.	T	C	9	8	17	0	0	17	0	0
13	22095589	.	G	A	1	8	9	0	0	9	0	0
13	22095594	.	T	A	2	6	8	0	0	8	0	0
13	22119935	.	T	C	3	2	5	0	0	5	0	0
13	22198502	.	G	A	4	2	6	0	0	6	0	0
13	22207003	.	C	T	3	3	6	0	0	6	0	0
13	22238125	.	C	A	8	9	17	0	0	17	0	0
13	22238209	.	T	C	9	16	25	0	1	26	0	0
13	22238233	.	G	A	15	13	28	0	0	28	0	0
13	22240672	.	T	A	7	3	10	0	0	10	0	0
13	22241103	.	T	A	17	18	35	0	1	36	0	0
13	22241123	.	G	T	0	13	13	0	18	31	0	0
13	22241374	.	A	C	18	20	38	0	2	40	0	0
13	22241482	.	G	C	7	17	24	0	0	24	0	0
13	22241648	.	T	G	24	14	38	0	1	39	0	0
13	22241730	.	G	C	28	21	49	0	2	51	0	0
13	22241731	.	A	T	29	21	50	0	1	51	0	0
13	22242197	.	G	C	27	14	41	0	0	41	0	0
13	22242299	.	C	G	26	17	43	0	1	44	0	0
13	22242394	.	C	G	19	17	36	0	2	38	0	0
13	22242837	.	T	G	34	11	45	0	2	47	0	0
13	22243211	.	A	C	12	10	22	0	1	23	0	0
13	22317066	.	T	C	3	4	7	0	0	7	0	0
13	22328575	.	C	T	1	0	1	0	0	1	0	0
13	22328595	.	A	G	1	0	1	0	0	1	0	0
13	22340444	.	C	T	3	4	7	0	0	7	0	0
13	22340456	.	G	A	2	4	6	0	1	7	0	0
13	22351817	.	G	A	4	3	7	0	0	7	0	0
13	22351910	.	A	G	1	0	1	0	0	1	0	0
13	22357236	.	T	G	5	2	7	0	0	7	0	0
13	22357850	.	A	G	8	1	9	0	5	14	0	0
13	22358021	.	A	G	6	4	10	0	0	10	0	0
13	22361332	.	G	A	5	8	13	0	0	13	0	0
13	22361677	.	G	A	4	3	7	0	0	7	0	0
13	22361679	.	A	T	4	3	7	0	0	7	0	0
13	22361718	.	A	C	0	2	2	0	0	2	0	0
13	22364908	.	T	C	14	14	28	0	1	29	0	0
13	22365016	.	C	T	16	15	31	0	1	32	0	0
13	22365404	.	C	T	14	11	25	0	1	26	0	0
13	22365461	.	A	G	4	6	10	0	2	12	0	0
13	22367600	.	C	A	4	6	10	0	0	10	0	0
13	22369262	.	C	T	2	1	3	0	0	3	0	0
13	22369295	.	T	C	3	10	13	0	1	14	0	0
13	22369399	.	A	C	5	8	13	0	1	14	0	0
13	22369445	.	C	T	4	4	8	0	0	8	0	0
13	22371981	.	G	A	0	16	16	0	20	36	0	0
13	22372015	.	C	G	15	26	41	0	2	43	0	0
13	22372075	.	T	C	17	15	32	0	1	33	0	0
13	22372105	.	G	A	0	13	13	0	22	35	0	0
13	22372126	.	C	T	14	18	32	0	1	33	0	0
13	22372205	.	A	G	18	17	35	0	1	36	0	0
13	22372932	.	G	T	9	3	12	0	0	12	0	0
13	22618316	.	C	T	1	2	3	0	0	3	0	0
13	22618933	.	T	C	0	4	4	0	0	4	0	0
13	22618936	.	G	T	0	4	4	0	0	4	0	0
13	22619067	.	G	A	4	5	9	0	3	12	0	0
13	22619157	.	C	T	8	5	13	0	0	13	0	0
13	22659195	.	C	G	12	0	12	0	18	30	0	0
13	22659196	.	A	G	11	18	29	0	1	30	0	0
13	22659231	.	G	A	0	25	25	0	22	47	0	0
13	22659291	.	A	G	20	17	37	0	5	42	0	0
13	22659363	.	G	A	6	1	7	0	0	7	0	0
13	22659375	.	A	C	0	1	1	0	0	1	0	0
13	22669319	.	T	C	8	12	20	0	0	20	0	0
13	22679837	.	G	A	1	5	6	0	1	7	0	0
13	22683416	.	A	T	2	1	3	0	0	3	0	0
13	22688510	.	G	A	3	2	5	0	0	5	0	0
13	22704711	.	G	T	5	2	7	0	0	7	0	0
13	22708812	.	G	A	0	4	4	0	0	4	0	0
13	22735063	.	T	C	7	2	9	0	2	11	0	0
13	22735139	.	A	G	8	7	15	0	1	16	0	0
13	22742791	.	G	A	6	3	9	0	0	9	0	0
13	22744359	.	A	G	6	8	14	0	1	15	0	0
13	22867888	.	G	A	0	2	2	0	5	7	0	0
13	22867910	.	A	G	5	4	9	0	1	10	0	0
13	22867953	.	G	T	5	8	13	0	0	13	0	0
13	22868017	.	G	A	1	1	2	0	0	2	0	0
13	22868447	.	G	A	0	3	3	0	3	6	0	0
13	22868456	.	T	C	3	4	7	0	0	7	0	0
13	22871900	.	C	A	2	0	2	0	0	2	0	0
13	22872817	.	C	T	3	4	7	0	0	7	0	0
13	22872832	.	T	A	3	4	7	0	0	7	0	0
13	22872915	.	A	T	6	2	8	0	0	8	0	0
13	22876576	.	T	C	8	0	8	0	10	18	0	0
13	22876623	.	G	A	9	9	18	0	0	18	0	0
13	22877076	.	C	T	13	9	22	0	1	23	0	0
13	22877130	.	G	T	16	13	29	0	0	29	0	0
13	22878754	.	G	A	1	1	2	0	0	2	0	0
13	22879149	.	A	T	4	6	10	0	0	10	0	0
13	22890835	.	A	C	15	0	15	0	8	23	0	0
13	22898042	.	A	G	4	1	5	0	0	5	0	0
13	22900733	.	G	A	5	8	13	0	1	14	0	0
13	22900742	.	A	T	4	6	10	0	0	10	0	0
13	22902882	.	A	C	6	8	14	0	0	14	0	0
13	22902987	.	G	A	11	14	25	0	0	25	0	0
13	22932172	.	C	A	0	1	1	0	0	1	0	0
13	22970750	.	T	C	1	3	4	0	0	4	0	0
13	22973314	.	A	G	24	28	52	0	5	57	0	0
13	22973348	.	A	G	21	25	46	0	1	47	0	0
13	22973531	.	T	C	15	1	16	0	26	43	1	0
13	22973895	.	A	G	23	17	40	0	4	44	0	0
13	22974033	.	A	G	20	22	42	0	1	43	0	0
13	22974108	.	C	T	11	8	19	0	0	19	0	0
13	22976067	.	C	A	21	16	37	0	2	39	0	0
13	22976070	.	G	A	21	17	38	0	0	39	1	0
13	22976383	.	T	C	12	0	12	0	13	25	0	0
13	22977283	.	G	A	11	13	24	0	1	25	0	0
13	22977319	.	A	G	21	21	42	0	1	43	0	0
13	22977343	.	A	G	18	22	40	0	0	40	0	0
13	22978059	.	T	C	7	0	7	0	8	15	0	0
13	22978062	.	G	A	7	7	14	0	1	15	0	0
13	22983106	.	A	G	3	8	11	0	0	11	0	0
13	22983109	.	A	G	3	9	12	0	0	12	0	0
13	23002697	.	G	A	1	3	4	0	0	4	0	0
13	23007677	.	A	G	8	8	16	0	0	16	0	0
13	23007811	.	T	C	1	2	3	0	0	3	0	0
13	23017637	.	G	A	5	2	7	0	0	7	0	0
13	23037831	.	C	A	3	9	12	0	0	12	0	0
13	23042321	.	A	G	1	0	1	0	1	2	0	0
13	23042387	.	C	G	14	5	19	0	0	19	0	0
13	23042676	.	A	G	2	3	5	0	0	5	0	0
13	23042745	.	G	A	7	6	13	0	0	13	0	0
13	23042929	.	G	T	1	1	2	0	0	2	0	0
13	23043112	.	T	C	4	1	5	0	0	5	0	0
13	23043117	.	A	G	4	1	5	0	0	5	0	0
13	23062294	.	C	T	0	1	1	0	0	1	0	0
13	23064735	.	T	C	1	1	2	0	0	2	0	0
13	23070787	.	C	T	1	2	3	0	1	4	0	0
13	23070895	.	T	C	8	9	17	0	1	18	0	0
13	23084177	.	C	G	9	17	26	2	0	28	0	0
13	23084841	.	G	C	16	13	29	0	1	30	0	0
13	23090190	.	A	C	6	22	28	0	0	28	0	0
13	23094356	.	T	C	4	0	4	0	3	7	0	0
13	23094895	.	G	T	17	10	27	0	0	27	0	0
13	23116893	.	G	A	2	1	3	0	1	4	0	0
13	23128675	.	A	G	2	0	2	0	1	3	0	0
13	23128685	.	A	G	2	2	4	0	0	4	0	0
13	23169172	.	G	T	0	2	2	0	0	2	0	0
13	23196207	.	C	T	0	1	1	0	0	1	0	0
13	23201307	.	T	A	1	0	1	0	0	1	0	0
13	23212821	.	A	G	2	3	5	0	0	5	0	0
13	23222899	.	A	T	2	2	4	0	0	4	0	0
13	23223122	.	A	G	1	5	6	0	0	6	0	0
13	23223422	.	G	A	6	1	7	0	0	7	0	0
13	23223428	.	C	T	7	1	8	0	1	9	0	0
13	23223469	.	T	A	3	5	8	0	0	8	0	0
13	23223486	.	C	T	3	6	9	0	0	9	0	0
13	23223567	.	C	T	3	4	7	0	1	8	0	0
13	23223572	.	C	T	4	5	9	0	0	9	0	0
13	23224360	.	A	G	5	8	13	0	0	13	0	0
13	23224363	.	T	G	5	8	13	0	0	13	0	0
13	23224427	.	C	T	9	9	18	0	2	20	0	0
13	23224470	.	G	A	5	11	16	0	1	17	0	0
13	23224605	.	G	T	10	9	19	0	0	19	0	0
13	23224727	.	C	T	10	7	17	0	0	17	0	0
13	23224735	.	A	G	9	8	17	0	1	18	0	0
13	23224821	.	T	A	6	8	14	0	0	14	0	0
13	23224860	.	T	A	7	7	14	0	1	15	0	0
13	23225541	.	T	C	9	11	20	0	0	20	0	0
13	23225776	.	T	A	9	7	16	0	0	16	0	0
13	23226114	.	G	A	0	4	4	0	12	16	0	0
13	23226213	.	A	C	8	8	16	0	0	16	0	0
13	23234675	.	C	A	1	2	3	0	0	3	0	0
13	23234680	.	C	T	0	2	2	0	1	3	0	0
13	23314904	.	T	G	11	3	14	0	1	15	0	0
13	23382393	.	G	A	1	4	5	0	0	5	0	0
13	23387252	.	T	C	7	3	10	0	1	11	0	0
13	23387337	.	C	T	8	3	11	0	1	12	0	0
13	23669773	.	C	T	8	4	12	0	0	12	0	0
13	23669870	.	T	G	7	4	11	0	2	13	0	0
13	23675183	.	C	T	9	10	19	0	1	20	0	0
13	23675510	.	T	C	3	4	7	0	0	7	0	0
13	23675892	.	G	C	1	5	6	0	8	15	1	0
13	23676856	.	G	A	0	3	3	0	1	4	0	0
13	23676913	.	C	A	8	7	15	0	3	18	0	0
13	23678001	.	G	A	0	7	7	0	5	12	0	0
13	23679546	.	G	A	0	3	3	0	3	6	0	0
13	23679888	.	G	A	2	7	9	0	0	9	0	0
13	23685075	.	G	A	1	5	6	0	0	6	0	0
13	23685301	.	G	A	3	5	8	0	0	8	0	0
13	23692515	.	C	T	9	17	26	0	0	26	0	0
13	23692572	.	C	T	6	1	7	0	0	7	0	0
13	23703048	.	G	C	11	10	21	0	2	23	0	0
13	23703053	.	T	C	13	12	25	0	1	26	0	0
13	23709532	.	C	T	5	4	9	0	0	9	0	0
13	23709562	.	T	C	9	17	26	0	1	27	0	0
13	23709592	.	A	G	13	26	39	0	0	39	0	0
13	23711937	.	G	A	11	6	17	0	2	19	0	0
13	23728490	.	T	A	3	4	7	0	0	7	0	0
13	23730801	.	G	A	4	10	14	0	1	15	0	0
13	23731988	.	T	A	2	2	4	0	0	4	0	0
13	23876697	.	T	C	2	4	6	0	0	6	0	0
13	23876865	.	C	T	3	1	4	0	1	5	0	0
13	23882377	.	A	G	4	4	8	0	0	8	0	0
13	23882615	.	T	C	4	6	10	0	0	10	0	0
13	23882629	.	T	C	8	5	13	0	0	13	0	0
13	23882686	.	C	T	9	5	14	0	0	14	0	0
13	23882946	.	A	G	4	3	7	0	0	7	0	0
13	23898045	.	T	G	11	6	17	0	0	17	0	0
13	23901334	.	C	T	8	14	22	0	0	22	0	0
13	23901349	.	T	C	8	15	23	0	0	23	0	0
13	23901502	.	A	G	9	10	19	0	2	21	0	0
13	23901555	.	A	G	10	1	11	0	7	18	0	0
13	23901570	.	T	C	10	8	18	0	1	19	0	0
13	23920791	.	A	G	0	1	1	0	0	1	0	0
13	23931192	.	T	C	3	1	4	0	8	12	0	0
13	23932450	.	G	A	1	2	3	0	0	3	0	0
13	23940708	.	T	C	7	0	7	0	3	10	0	0
13	23940754	.	C	A	7	2	9	0	0	10	1	0
13	23996192	.	G	A	1	4	5	0	0	5	0	0
13	23999129	.	G	A	0	4	4	0	0	4	0	0
13	23999264	.	G	C	3	2	5	0	0	5	0	0
13	23999274	.	T	A	3	2	5	0	0	5	0	0
13	24000394	.	G	A	1	3	4	0	1	5	0	0
13	24002850	.	T	C	1	0	1	0	0	1	0	0
13	24014578	.	T	C	0	1	1	0	0	1	0	0
13	24023036	.	G	T	5	2	7	0	0	7	0	0
13	24033950	.	C	T	1	1	2	0	1	3	0	0
13	24033958	.	G	T	0	2	2	0	2	4	0	0
13	24034158	.	A	G	1	4	5	0	0	5	0	0
13	24034206	.	A	G	2	7	9	0	0	9	0	0
13	24034215	.	G	A	1	7	8	0	0	8	0	0
13	24045342	.	C	T	1	0	1	0	0	1	0	0
13	24046953	.	G	A	0	4	4	0	2	6	0	0
13	24056221	.	C	T	5	9	14	0	2	16	0	0
13	24068790	.	C	T	1	5	6	0	15	21	0	0
13	24069624	.	C	A	14	13	27	0	0	27	0	0
13	24069902	.	A	T	11	8	19	0	1	21	1	0
13	24070242	.	C	T	0	7	7	0	11	18	0	0
13	24070730	.	C	T	7	3	10	0	0	10	0	0
13	24096437	.	G	T	5	4	9	0	0	9	0	0
13	24250563	.	C	T	0	2	2	0	1	3	0	0
13	24263391	.	T	A	3	2	5	0	0	5	0	0
13	24266756	.	G	C	2	3	5	0	0	5	0	0
13	24276108	.	A	C	0	4	4	0	0	4	0	0
13	24276128	.	T	A	3	4	7	0	0	7	0	0
13	24276201	.	T	G	1	4	5	0	0	5	0	0
13	24276354	.	A	G	2	8	10	0	0	10	0	0
13	24276366	.	C	T	2	7	9	0	1	10	0	0
13	24276497	.	A	G	1	0	1	0	3	4	0	0
13	24287895	.	C	T	4	3	7	0	1	8	0	0
13	24290132	.	A	T	3	4	7	0	1	8	0	0
13	24290140	.	A	G	4	5	9	0	1	10	0	0
13	24290169	.	T	G	7	0	7	0	8	15	0	0
13	24292374	.	A	G	3	2	5	0	0	5	0	0
13	24292398	.	G	A	3	4	7	0	0	7	0	0
13	24292675	.	A	G	6	9	15	0	0	15	0	0
13	24292727	.	G	A	10	10	20	0	0	20	0	0
13	24292796	.	T	A	13	12	25	0	0	25	0	0
13	24292800	.	A	T	14	13	27	0	0	27	0	0
13	24292947	.	A	T	9	14	23	0	1	24	0	0
13	24293381	.	A	T	18	20	38	0	1	39	0	0
13	24293465	.	C	T	5	22	27	0	11	38	0	0
13	24293516	.	G	A	11	25	36	0	3	39	0	0
13	24293518	.	C	A	14	25	39	0	0	39	0	0
13	24293615	.	G	A	12	11	23	0	13	36	0	0
13	24293698	.	C	T	25	12	37	0	3	40	0	0
13	24293748	.	C	G	5	18	23	0	0	23	0	0
13	24293793	.	A	G	19	7	26	0	2	28	0	0
13	24294046	.	A	G	10	12	22	0	2	24	0	0
13	24295907	.	A	T	3	5	8	0	1	9	0	0
13	24295999	.	T	C	3	5	8	0	1	9	0	0
13	24296071	.	G	A	8	2	10	0	1	11	0	0
13	24296094	.	A	C	5	5	10	0	1	11	0	0
13	24296141	.	G	A	6	3	9	0	0	9	0	0
13	24296198	.	A	T	3	5	8	0	0	8	0	0
13	24296250	.	A	G	1	0	1	0	0	1	0	0
13	24303840	.	G	A	0	2	2	0	0	2	0	0
13	24305975	.	T	G	10	12	22	0	2	24	0	0
13	24311510	.	G	A	3	2	5	0	0	5	0	0
13	24371933	.	A	C	2	0	2	0	6	8	0	0
13	24372392	.	A	G	3	2	5	0	0	5	0	0
13	24372477	.	A	T	2	3	5	0	0	6	1	0
13	24372506	.	G	T	4	2	6	0	0	6	0	0
13	24372533	.	T	A	1	4	5	0	0	5	0	0
13	24378978	.	A	T	1	3	4	0	0	4	0	0
13	24381350	.	A	G	2	1	3	0	0	3	0	0
13	24382137	.	G	A	0	2	2	0	5	7	0	0
13	24382152	.	T	C	4	2	6	0	0	6	0	0
13	24382539	.	T	C	2	2	4	0	0	4	0	0
13	24395373	.	G	A	5	4	9	0	0	9	0	0
13	24397210	.	T	C	0	1	1	0	0	1	0	0
13	24397223	.	G	A	0	2	2	0	0	2	0	0
13	24401087	.	C	G	1	1	2	0	0	2	0	0
13	24401626	.	G	C	0	2	2	0	1	3	0	0
13	24401663	.	C	A	1	2	3	0	0	3	0	0
13	24402560	.	T	C	6	2	8	0	0	8	0	0
13	24411029	.	A	G	14	24	38	0	0	38	0	0
13	24423821	.	C	T	0	2	2	0	0	2	0	0
13	24423930	.	T	C	2	5	7	0	1	8	0	0
13	24424014	.	C	T	4	4	8	0	0	8	0	0
13	24424260	.	A	T	1	3	4	0	1	5	0	0
13	24424899	.	T	G	1	3	4	0	0	4	0	0
13	24425812	.	C	T	0	2	2	0	1	3	0	0
13	24425833	.	C	T	0	1	1	0	2	3	0	0
13	24431365	.	T	G	5	3	8	0	0	8	0	0
13	24432096	.	C	T	11	12	23	0	3	26	0	0
13	24432162	.	G	C	7	11	18	0	0	18	0	0
13	24432350	.	C	T	1	9	10	0	16	26	0	0
13	24436011	.	C	G	5	6	11	0	0	11	0	0
13	24436054	.	G	A	12	8	20	0	1	21	0	0
13	24437225	.	G	A	5	3	8	0	0	8	0	0
13	24439481	.	G	A	4	3	7	0	1	8	0	0
13	24439487	.	G	T	6	2	8	0	1	9	0	0
13	24447235	.	T	G	5	5	10	0	1	11	0	0
13	24447364	.	G	C	7	5	12	0	1	13	0	0
13	24519911	.	G	A	2	4	6	0	1	7	0	0
13	24519921	.	G	T	0	4	4	0	2	6	0	0
13	24520176	.	T	C	1	3	4	0	0	4	0	0
13	24522025	.	A	G	2	2	4	0	0	4	0	0
13	24522140	.	T	C	2	4	6	0	0	6	0	0
13	24522356	.	T	C	1	4	5	0	0	5	0	0
13	24523425	.	A	G	1	5	6	0	0	6	0	0
13	24524206	.	G	A	4	3	7	0	0	7	0	0
13	24524305	.	T	G	1	5	6	0	0	6	0	0
13	24552508	.	C	T	4	1	5	0	0	5	0	0
13	24580372	.	G	A	2	1	3	0	0	3	0	0
13	24580411	.	G	A	11	13	24	0	1	25	0	0
13	24580705	.	C	T	4	14	18	0	0	18	0	0
13	24580756	.	G	C	0	1	1	0	4	5	0	0
13	24580869	.	T	C	4	3	7	0	0	7	0	0
13	24580941	.	T	C	2	2	4	0	0	4	0	0
13	24581274	.	G	A	6	6	12	0	1	13	0	0
13	24581316	.	C	A	10	9	19	0	0	20	1	0
13	24581334	.	G	C	5	7	12	0	0	12	0	0
13	24581358	.	T	C	2	3	5	0	0	5	0	0
13	24581748	.	A	C	10	10	20	0	4	24	0	0
13	24581798	.	T	A	12	10	22	0	1	23	0	0
13	24581840	.	T	G	12	16	28	0	1	29	0	0
13	24581854	.	C	T	15	14	29	0	2	32	1	0
13	24582047	.	A	G	8	10	18	0	0	18	0	0
13	24582110	.	C	T	6	9	15	0	0	15	0	0
13	24582122	.	T	C	5	8	13	0	0	13	0	0
13	24582211	.	C	T	5	7	12	0	0	12	0	0
13	24582213	.	G	A	7	5	12	0	0	12	0	0
13	24584435	.	C	A	1	2	3	0	1	4	0	0
13	24585352	.	C	T	1	1	2	0	0	2	0	0
13	24585402	.	T	A	1	0	1	0	1	2	0	0
13	24663607	.	T	G	3	1	4	0	0	4	0	0
13	24663625	.	C	A	1	3	4	0	0	4	0	0
13	24664144	.	T	A	3	2	5	0	0	5	0	0
13	24664317	.	T	G	1	2	3	0	0	3	0	0
13	24665680	.	A	G	1	7	8	0	1	9	0	0
13	24669108	.	T	C	2	6	8	0	0	8	0	0
13	24702033	.	C	A	0	8	8	0	6	15	1	0
13	24702114	.	T	C	6	5	11	0	1	12	0	0
13	24702198	.	T	C	5	3	8	0	0	8	0	0
13	24702217	.	T	C	1	4	5	0	0	5	0	0
13	24702415	.	T	C	7	7	14	0	1	15	0	0
13	24702478	.	T	G	9	4	13	0	1	14	0	0
13	24702602	.	T	A	11	10	21	0	0	21	0	0
13	24702652	.	A	T	6	10	16	0	0	16	0	0
13	24702883	.	A	T	13	5	18	0	0	18	0	0
13	24703276	.	C	T	3	3	6	0	0	6	0	0
13	24703354	.	C	A	3	3	6	0	0	6	0	0
13	24703362	.	C	A	3	3	6	0	0	6	0	0
13	24703411	.	A	T	2	5	7	0	2	9	0	0
13	24703490	.	G	A	0	2	2	0	2	4	0	0
13	24704032	.	A	G	2	2	4	0	0	4	0	0
13	24704102	.	C	A	10	7	17	0	1	18	0	0
13	24716363	.	T	C	3	5	8	0	0	8	0	0
13	24716375	.	A	T	3	5	8	0	0	8	0	0
13	24716415	.	T	C	2	1	3	0	0	3	0	0
13	24744704	.	A	T	2	3	5	0	0	5	0	0
13	24744742	.	A	T	2	2	4	0	0	4	0	0
13	24745047	.	T	C	1	1	2	0	0	2	0	0
13	24745049	.	G	T	1	1	2	0	0	2	0	0
13	24745169	.	A	G	1	4	5	0	0	5	0	0
13	24745188	.	A	C	1	4	5	0	0	5	0	0
13	24745209	.	T	G	1	2	3	0	0	3	0	0
13	24781536	.	G	A	13	13	26	0	0	26	0	0
13	24781580	.	T	C	8	16	24	0	0	24	0	0
13	24781605	.	T	C	6	19	25	0	1	26	0	0
13	24781640	.	G	A	6	11	17	0	0	17	0	0
13	24781713	.	A	G	5	12	17	0	1	18	0	0
13	24781885	.	G	A	7	12	19	0	2	21	0	0
13	24786900	.	T	A	11	10	21	0	1	23	1	0
13	24791020	.	A	G	2	3	5	0	0	5	0	0
13	24791077	.	G	T	5	2	7	0	1	8	0	0
13	24804104	.	C	T	4	7	11	0	0	11	0	0
13	24804224	.	G	C	2	6	8	0	1	9	0	0
13	24804484	.	A	G	9	4	13	0	1	14	0	0
13	24804765	.	C	T	10	4	14	0	0	14	0	0
13	24805068	.	A	C	5	3	8	0	0	8	0	0
13	24805148	.	A	C	5	5	10	0	0	10	0	0
13	24805257	.	T	C	2	0	2	0	2	4	0	0
13	24805687	.	G	A	1	1	2	0	0	2	0	0
13	24826071	.	C	T	3	2	5	0	0	5	0	0
13	24834446	.	C	T	9	5	14	0	2	16	0	0
13	24837627	.	A	G	11	20	31	0	0	31	0	0
13	24837876	.	T	C	5	7	12	0	2	14	0	0
13	24871866	.	A	G	18	15	33	0	1	34	0	0
13	24872667	.	A	G	14	12	26	0	0	26	0	0
13	24872733	.	G	A	4	8	12	0	1	13	0	0
13	24873141	.	C	A	0	10	10	0	12	22	0	0
13	24873186	.	A	T	9	6	15	0	0	15	0	0
13	24873480	.	A	G	12	10	22	0	1	23	0	0
13	24873579	.	C	T	9	6	15	0	1	16	0	0
13	24874897	.	G	A	12	8	20	0	0	20	0	0
13	24875948	.	A	C	1	1	2	0	0	2	0	0
13	24881635	.	T	C	3	5	8	0	1	9	0	0
13	24885195	.	G	A	1	2	3	0	0	3	0	0
13	24905897	.	G	A	2	2	4	0	0	4	0	0
13	24906196	.	A	T	4	5	9	0	1	10	0	0
13	24918814	.	T	A	7	7	14	0	0	14	0	0
13	24918820	.	T	C	7	7	14	0	0	14	0	0
13	24986203	.	G	A	3	2	5	0	0	5	0	0
13	24986238	.	G	T	7	5	12	0	0	12	0	0
13	24986272	.	T	C	9	0	9	0	9	18	0	0
13	25199240	.	T	C	3	0	3	0	7	10	0	0
13	25208276	.	A	G	2	3	5	0	1	6	0	0
13	25208545	.	T	A	2	2	4	0	0	4	0	0
13	25208692	.	A	T	2	3	5	0	0	5	0	0
13	25212429	.	T	C	2	3	5	0	0	5	0	0
13	25214739	.	G	A	2	2	4	0	0	4	0	0
13	25229573	.	G	A	0	3	3	0	1	4	0	0
13	25229576	.	C	T	1	3	4	0	0	4	0	0
13	25242602	.	C	T	0	1	1	0	0	1	0	0
13	25284140	.	C	A	1	2	3	0	0	3	0	0
13	25365034	.	G	A	5	5	10	0	1	11	0	0
13	25366380	.	T	G	2	2	4	0	0	4	0	0
13	25369449	.	C	T	4	2	6	0	0	6	0	0
13	25371436	.	A	G	4	9	13	0	0	13	0	0
13	25371475	.	C	A	11	8	19	0	0	19	0	0
13	25371918	.	A	G	6	4	10	0	0	10	0	0
13	25378924	.	T	G	6	5	11	2	1	14	0	0
13	25379263	.	A	T	19	12	31	0	1	32	0	0
13	25379304	.	A	G	10	2	12	0	15	27	0	0
13	25379352	.	A	C	12	10	22	0	0	22	0	0
13	25379479	.	C	G	5	4	9	1	1	11	0	0
13	25384281	.	T	C	6	4	10	0	0	10	0	0
13	25386904	.	C	T	3	4	7	0	0	7	0	0
13	25388389	.	G	A	2	4	6	0	1	7	0	0
13	25388764	.	T	G	3	0	3	0	8	11	0	0
13	25429048	.	T	A	10	7	17	0	1	18	0	0
13	25429145	.	G	A	3	4	7	0	1	8	0	0
13	25429158	.	G	A	6	4	10	0	0	10	0	0
13	25436360	.	A	T	11	9	20	0	0	20	0	0
13	25444357	.	C	T	0	8	8	0	1	9	0	0
13	25449688	.	A	C	2	4	6	0	0	6	0	0
13	25449867	.	C	A	1	2	3	0	1	4	0	0
13	25472084	.	C	T	7	8	15	0	1	16	0	0
13	25472336	.	G	A	19	18	37	0	0	37	0	0
13	25472735	.	G	A	15	12	27	0	0	27	0	0
13	25472859	.	G	A	17	18	35	0	0	35	0	0
13	25473084	.	T	A	13	36	49	0	0	49	0	0
13	25473325	.	G	A	6	3	9	0	0	9	0	0
13	25474019	.	G	T	10	18	28	0	2	30	0	0
13	25475904	.	A	G	5	7	12	0	0	12	0	0
13	25477304	.	A	G	6	9	15	0	0	15	0	0
13	25478897	.	G	A	1	3	4	0	0	4	0	0
13	25495556	.	C	T	4	1	5	0	0	5	0	0
13	25495781	.	G	A	10	6	16	0	0	16	0	0
13	25497320	.	A	G	4	0	4	0	3	7	0	0
13	25497700	.	G	C	9	8	17	0	0	17	0	0
13	25497769	.	T	A	12	8	20	0	2	22	0	0
13	25516204	.	T	C	0	1	1	0	0	1	0	0
13	25519063	.	G	A	0	6	6	0	6	12	0	0
13	25523629	.	T	C	8	2	10	0	0	10	0	0
13	25523677	.	G	A	0	2	2	0	6	8	0	0
13	25523680	.	T	A	2	5	7	0	0	7	0	0
13	25525989	.	G	A	6	4	10	0	0	10	0	0
13	25531776	.	T	C	13	6	19	0	0	19	0	0
13	25532352	.	C	T	12	10	22	0	0	22	0	0
13	25532574	.	C	A	19	9	28	0	0	28	0	0
13	25532857	.	A	G	10	9	19	0	0	19	0	0
13	25533233	.	G	A	14	14	28	0	0	28	0	0
13	25533258	.	T	A	15	10	25	0	0	25	0	0
13	25533452	.	A	T	5	15	20	0	1	21	0	0
13	25533657	.	C	G	10	0	10	0	12	22	0	0
13	25533767	.	G	T	14	14	28	0	0	28	0	0
13	25533846	.	G	A	15	8	23	0	2	25	0	0
13	25533897	.	C	T	7	6	13	0	0	13	0	0
13	25534172	.	T	A	9	9	18	0	0	18	0	0
13	25534368	.	A	G	22	0	22	0	16	38	0	0
13	25534551	.	G	A	4	5	9	0	0	9	0	0
13	25540358	.	C	A	1	3	4	0	0	4	0	0
13	25549516	.	A	G	6	0	6	0	6	12	0	0
13	25551722	.	A	G	0	0	0	0	2	2	0	0
13	25551781	.	C	A	4	10	14	0	2	16	0	0
13	25551865	.	T	C	7	4	11	1	1	13	0	0
13	25552219	.	T	C	1	0	1	0	0	1	0	0
13	25559610	.	G	A	4	4	8	0	0	8	0	0
13	25560458	.	A	T	2	2	4	0	0	4	0	0
13	25560471	.	G	A	0	1	1	0	3	4	0	0
13	25563221	.	C	A	2	2	4	0	0	4	0	0
13	25565379	.	T	C	7	11	18	0	2	20	0	0
13	25565985	.	G	A	4	5	9	0	1	10	0	0
13	25565988	.	A	C	4	6	10	0	0	10	0	0
13	25566205	.	A	T	3	7	10	0	0	10	0	0
13	25566222	.	C	T	1	5	6	0	1	7	0	0
13	25569940	.	A	C	4	4	8	0	0	8	0	0
13	25570044	.	C	T	0	4	4	0	6	10	0	0
13	25570104	.	C	T	6	6	12	0	1	13	0	0
13	25570164	.	A	C	2	0	2	0	2	4	0	0
13	25570341	.	T	C	5	0	5	0	4	9	0	0
13	25570410	.	A	G	7	3	10	0	0	10	0	0
13	25570477	.	G	A	8	5	13	0	0	13	0	0
13	25570532	.	A	C	6	0	6	0	9	15	0	0
13	25570618	.	A	T	7	3	10	0	0	10	0	0
13	25570709	.	T	C	8	0	8	0	8	16	0	0
13	25570715	.	C	T	9	7	16	0	0	16	0	0
13	25571057	.	T	C	5	2	7	0	0	7	0	0
13	25571113	.	A	T	5	3	8	0	0	8	0	0
13	25571274	.	C	T	7	9	16	0	0	16	0	0
13	25575396	.	C	T	5	0	5	0	0	5	0	0
13	25575411	.	A	C	5	0	5	0	2	7	0	0
13	25580764	.	C	A	4	3	7	0	0	7	0	0
13	25584993	.	A	T	1	4	5	0	0	5	0	0
13	25585757	.	G	A	8	6	14	0	0	14	0	0
13	25585785	.	T	C	7	4	11	0	1	12	0	0
13	25585876	.	G	T	2	3	5	0	0	5	0	0
13	25585879	.	G	A	2	3	5	0	0	5	0	0
13	25586139	.	A	G	1	3	4	0	0	4	0	0
13	25589241	.	G	A	4	4	8	0	0	8	0	0
13	25590736	.	A	G	2	1	3	0	0	3	0	0
13	25726201	.	C	T	6	7	13	0	0	13	0	0
13	25726308	.	A	C	1	6	7	0	0	7	0	0
13	25728453	.	A	C	9	5	14	0	0	14	0	0
13	25728606	.	A	T	1	6	7	0	0	7	0	0
13	25729076	.	C	T	1	3	4	0	0	4	0	0
13	25740516	.	G	A	2	6	8	0	0	8	0	0
13	25750830	.	G	A	1	4	5	0	0	5	0	0
13	25750868	.	A	T	1	3	4	0	0	4	0	0
13	25824718	.	C	T	13	14	27	0	4	31	0	0
13	25825016	.	G	A	16	14	30	0	1	31	0	0
13	25825445	.	A	T	4	1	5	0	0	5	0	0
13	25827421	.	G	A	11	12	23	0	0	23	0	0
13	25850442	.	A	G	3	3	6	0	0	6	0	0
13	25923392	.	A	G	10	14	24	0	3	27	0	0
13	25923450	.	A	T	7	18	25	0	0	25	0	0
13	25924388	.	C	T	13	16	29	0	0	29	0	0
13	25924523	.	C	T	7	12	19	0	0	19	0	0
13	26433612	.	C	T	0	1	1	0	0	1	0	0
13	26433613	.	A	C	0	1	1	0	0	1	0	0
13	27036582	.	T	C	8	0	8	0	5	13	0	0
13	27036660	.	T	C	8	9	17	0	1	18	0	0
13	27038163	.	G	A	4	5	9	0	0	9	0	0
13	27107520	.	C	T	9	7	16	0	0	16	0	0
13	27189877	.	A	T	1	0	1	0	1	2	0	0
13	27190435	.	C	T	3	3	6	0	0	6	0	0
13	27201552	.	G	A	2	2	4	0	0	4	0	0
13	27209852	.	T	C	2	4	6	0	0	6	0	0
13	27227407	.	C	A	2	3	5	0	0	5	0	0
13	27227449	.	A	G	3	4	7	0	0	7	0	0
13	27232456	.	A	G	2	3	5	0	0	5	0	0
13	27232479	.	C	A	1	2	3	0	0	3	0	0
13	27294656	.	G	A	1	2	3	0	1	4	0	0
13	27294663	.	C	T	3	3	6	0	0	6	0	0
13	27295173	.	C	T	4	2	6	0	0	6	0	0
13	27295459	.	T	C	1	2	3	0	0	3	0	0
13	27296396	.	G	A	4	3	7	0	1	8	0	0
13	27296415	.	T	A	3	3	6	0	0	6	0	0
13	27296433	.	A	G	3	2	5	0	0	5	0	0
13	27296576	.	C	T	4	5	9	0	0	9	0	0
13	27296616	.	T	C	5	3	8	0	1	9	0	0
13	27309128	.	T	G	4	0	4	0	7	11	0	0
13	27312888	.	G	A	2	5	7	0	0	7	0	0
13	27312938	.	C	T	4	2	6	0	0	6	0	0
13	27313044	.	A	C	2	3	5	0	1	6	0	0
13	27313066	.	G	T	2	4	6	0	0	6	0	0
13	27313310	.	T	A	17	5	22	0	0	22	0	0
13	27316778	.	G	T	4	4	8	0	2	10	0	0
13	27316862	.	T	G	4	5	9	0	0	9	0	0
13	27316874	.	G	T	6	5	11	0	0	11	0	0
13	27317026	.	C	T	17	19	36	0	2	38	0	0
13	27320771	.	C	T	1	1	2	0	0	2	0	0
13	27320996	.	G	A	1	12	13	0	14	27	0	0
13	27321072	.	A	T	1	3	4	0	0	4	0	0
13	27321211	.	C	T	29	37	66	0	4	70	0	0
13	27323976	.	G	A	2	18	20	0	15	35	0	0
13	27324341	.	A	T	27	29	56	0	4	60	0	0
13	27324346	.	T	C	30	31	61	0	1	62	0	0
13	27379495	.	A	G	1	2	3	0	0	3	0	0
13	27379798	.	G	A	1	3	4	0	0	4	0	0
13	27634324	.	T	C	17	18	35	0	1	36	0	0
13	27634789	.	A	G	18	15	33	0	0	33	0	0
13	27641472	.	T	C	4	7	11	0	1	12	0	0
13	27675462	.	T	C	7	0	7	0	5	12	0	0
13	27685329	.	C	T	0	10	10	0	13	23	0	0
13	27685363	.	G	A	11	10	21	0	1	22	0	0
13	27685446	.	C	T	9	4	13	0	1	14	0	0
13	27685552	.	G	A	9	22	31	0	0	31	0	0
13	27685583	.	C	T	0	16	16	0	14	30	0	0
13	27686252	.	G	A	10	8	18	0	0	18	0	0
13	27686405	.	G	A	18	14	32	0	1	33	0	0
13	27771607	.	T	G	5	0	5	0	3	8	0	0
13	27782260	.	C	T	1	2	3	0	0	3	0	0
13	27782402	.	A	T	4	7	11	0	1	12	0	0
13	27782585	.	G	A	2	3	5	0	1	6	0	0
13	27951758	.	T	A	6	9	15	0	0	15	0	0
13	27951827	.	G	A	0	13	13	0	5	18	0	0
13	27951883	.	A	G	14	0	14	0	7	21	0	0
13	27952156	.	C	T	16	10	26	0	1	27	0	0
13	27952414	.	A	G	9	23	32	0	1	33	0	0
13	27952441	.	G	T	14	23	37	0	2	39	0	0
13	28009108	.	C	T	14	13	27	0	1	28	0	0
13	28009159	.	G	A	13	9	22	0	0	22	0	0
13	28009178	.	A	C	8	12	20	0	1	21	0	0
13	28009246	.	A	T	18	14	32	0	0	32	0	0
13	28009567	.	G	A	15	9	24	0	1	25	0	0
13	28010183	.	G	A	23	25	48	0	5	53	0	0
13	28010214	.	C	A	4	29	33	0	27	60	0	0
13	28498793	.	G	A	0	2	2	0	0	2	0	0
13	28498812	.	G	A	0	3	3	0	0	3	0	0
13	28561116	.	T	C	4	4	8	0	0	8	0	0
13	28561190	.	A	T	3	2	5	0	0	5	0	0
13	28561244	.	G	C	4	4	8	0	0	8	0	0
13	28596166	.	T	C	3	7	10	0	1	11	0	0
13	28596429	.	C	T	4	2	6	0	1	7	0	0
13	28615556	.	C	T	10	6	16	0	1	17	0	0
13	28615622	.	T	C	5	5	10	0	0	10	0	0
13	28619558	.	T	C	1	3	4	0	0	4	0	0
13	28642816	.	A	C	6	4	10	0	1	11	0	0
13	28642825	.	C	A	5	6	11	0	1	12	0	0
13	28642876	.	C	T	4	3	7	0	0	7	0	0
13	28643087	.	C	T	9	6	15	0	0	15	0	0
13	28650239	.	A	T	8	15	23	0	1	24	0	0
13	28650416	.	G	C	12	8	20	0	0	20	0	0
13	28650683	.	A	G	14	12	26	0	2	28	0	0
13	28650731	.	A	C	8	1	9	0	15	24	0	0
13	28650945	.	T	C	19	15	34	0	0	34	0	0
13	28650954	.	T	G	16	18	34	0	0	34	0	0
13	28650984	.	A	G	13	20	33	0	1	34	0	0
13	28651214	.	C	A	1	19	20	0	22	42	0	0
13	28665065	.	C	T	3	5	8	0	0	8	0	0
13	28676134	.	G	C	8	10	18	0	0	18	0	0
13	28676241	.	A	G	9	5	14	0	0	14	0	0
13	28676358	.	G	A	7	7	14	0	0	14	0	0
13	28676472	.	C	G	11	0	11	0	7	18	0	0
13	28680634	.	T	A	6	8	14	0	1	15	0	0
13	28680847	.	T	A	6	3	9	0	3	12	0	0
13	28694384	.	C	A	4	2	6	0	0	6	0	0
13	28694390	.	C	T	4	3	7	0	0	7	0	0
13	28694664	.	T	C	4	6	10	0	0	10	0	0
13	28701246	.	G	A	0	5	5	0	2	7	0	0
13	28743835	.	C	T	23	9	32	0	1	33	0	0
13	28744061	.	C	A	8	3	11	0	0	11	0	0
13	28744141	.	A	T	6	3	9	0	1	10	0	0
13	28744495	.	G	A	1	20	21	0	13	34	0	0
13	28744775	.	C	T	9	11	20	0	0	20	0	0
13	28744831	.	C	T	5	11	16	0	0	16	0	0
13	28744976	.	C	T	6	4	10	0	1	11	0	0
13	28745801	.	T	G	6	13	19	1	0	20	0	0
13	28745934	.	C	A	4	14	18	0	0	18	0	0
13	28746326	.	A	G	3	3	6	0	0	6	0	0
13	28786409	.	G	A	0	1	1	0	0	1	0	0
13	28786565	.	T	C	3	3	6	0	0	6	0	0
13	28827315	.	T	A	0	1	1	0	0	1	0	0
13	28841987	.	C	T	11	7	18	0	0	18	0	0
13	28841990	.	G	T	11	7	18	0	0	18	0	0
13	28848209	.	C	G	0	1	1	0	0	1	0	0
13	28848220	.	G	A	2	2	4	0	1	5	0	0
13	28848473	.	C	T	1	1	2	0	1	3	0	0
13	28865700	.	T	C	14	13	27	0	1	28	0	0
13	28866413	.	A	T	27	18	45	0	3	48	0	0
13	28866518	.	C	T	25	17	42	0	4	46	0	0
13	28866590	.	A	G	19	30	49	0	0	49	0	0
13	28866615	.	C	T	22	28	50	0	0	50	0	0
13	28866722	.	T	C	19	25	44	0	1	45	0	0
13	28866810	.	G	A	24	17	41	0	0	41	0	0
13	28866857	.	G	A	0	17	17	0	21	38	0	0
13	28867159	.	G	A	2	21	23	0	27	50	0	0
13	28867367	.	C	T	20	26	46	0	0	46	0	0
13	28867382	.	A	T	25	19	44	0	0	44	0	0
13	28870917	.	T	C	31	30	61	0	4	65	0	0
13	28871055	.	T	C	4	5	9	0	0	9	0	0
13	28901714	.	T	A	26	24	50	0	0	50	0	0
13	28902058	.	C	T	25	13	38	0	2	40	0	0
13	28902169	.	C	T	18	14	32	0	0	33	1	0
13	28902170	.	C	G	17	13	30	0	3	33	0	0
13	28902215	.	T	C	18	18	36	0	1	37	0	0
13	29295759	.	A	C	2	2	4	0	0	4	0	0
13	29296096	.	G	C	4	6	10	0	0	10	0	0
13	29333853	.	C	A	4	11	15	0	1	16	0	0
13	29346927	.	G	A	0	2	2	0	6	8	0	0
13	29347156	.	G	A	0	3	3	0	8	11	0	0
13	29347170	.	G	A	7	4	11	0	0	11	0	0
13	29347252	.	T	C	2	5	7	0	0	7	0	0
13	29347265	.	T	A	6	2	8	0	0	8	0	0
13	29347745	.	A	C	6	9	15	0	0	15	0	0
13	29357115	.	T	A	1	1	2	0	0	2	0	0
13	29374514	.	C	T	2	3	5	0	0	5	0	0
13	29381047	.	A	C	6	5	11	0	0	11	0	0
13	29385786	.	A	G	1	0	1	0	1	2	0	0
13	29385894	.	G	A	2	6	8	0	1	9	0	0
13	29392238	.	C	T	1	1	2	0	0	2	0	0
13	29395207	.	C	A	8	7	15	0	0	15	0	0
13	29395236	.	C	T	4	3	7	0	1	8	0	0
13	29402613	.	T	G	6	13	19	0	0	19	0	0
13	29402669	.	C	T	8	7	15	0	0	15	0	0
13	29402681	.	A	C	7	4	11	0	0	11	0	0
13	29403957	.	C	T	7	11	18	0	1	19	0	0
13	29404003	.	G	A	15	3	18	0	2	20	0	0
13	29404145	.	T	C	12	6	18	0	2	20	0	0
13	29404218	.	T	A	8	6	14	0	0	14	0	0
13	29404399	.	A	T	11	16	27	0	0	27	0	0
13	29404400	.	C	T	9	16	25	0	2	27	0	0
13	29404754	.	T	A	4	4	8	0	0	8	0	0
13	29407802	.	T	G	9	14	23	0	1	24	0	0
13	29408226	.	T	C	12	4	16	0	2	18	0	0
13	29408499	.	G	A	9	8	17	0	0	17	0	0
13	29408530	.	C	T	6	4	10	0	1	11	0	0
13	29408650	.	A	G	9	9	18	0	0	18	0	0
13	29408989	.	G	A	9	14	23	0	1	24	0	0
13	29409239	.	G	A	5	6	11	0	1	12	0	0
13	29409265	.	C	T	1	5	6	0	3	9	0	0
13	29412299	.	G	A	1	2	3	0	0	3	0	0
13	29414441	.	G	C	2	1	3	0	0	3	0	0
13	29414546	.	A	G	3	1	4	0	0	4	0	0
13	29415202	.	G	A	4	2	6	0	0	6	0	0
13	29417091	.	G	A	8	8	16	0	0	16	0	0
13	29419583	.	G	A	4	7	11	0	0	11	0	0
13	29420849	.	A	T	3	2	5	0	0	5	0	0
13	29421211	.	G	T	2	2	4	0	0	4	0	0
13	29421296	.	C	T	10	10	20	0	0	20	0	0
13	29422112	.	G	A	1	3	4	0	0	5	1	0
13	29422202	.	C	T	4	4	8	0	0	8	0	0
13	29422808	.	G	A	9	11	20	0	3	23	0	0
13	29449256	.	G	A	6	6	12	0	0	12	0	0
13	29450479	.	T	C	1	1	2	0	1	3	0	0
13	29455199	.	C	T	3	7	10	0	1	11	0	0
13	29455573	.	A	G	5	3	8	0	1	10	1	0
13	29771323	.	T	C	5	3	8	0	0	9	1	0
13	29802607	.	C	A	10	6	16	0	1	17	0	0
13	29802633	.	A	G	5	6	11	0	0	11	0	0
13	29803253	.	C	T	3	5	8	0	0	8	0	0
13	29803801	.	G	A	4	2	6	0	0	6	0	0
13	29804362	.	T	C	7	3	10	0	0	10	0	0
13	29926221	.	G	A	0	1	1	0	0	1	0	0
13	29926242	.	C	T	0	1	1	0	1	2	0	0
13	29928675	.	A	G	7	5	12	0	1	13	0	0
13	29935371	.	A	G	2	4	6	0	0	6	0	0
13	29935678	.	T	G	3	6	9	0	0	9	0	0
13	29935682	.	T	C	3	6	9	0	1	10	0	0
13	29935885	.	C	A	2	4	6	0	0	6	0	0
13	29952902	.	C	T	2	4	6	0	1	7	0	0
13	29952914	.	G	A	3	4	7	0	0	7	0	0
13	29952972	.	C	T	11	6	17	0	0	17	0	0
13	29952973	.	A	T	10	5	15	0	2	17	0	0
13	29953265	.	T	G	7	9	16	0	1	17	0	0
13	29953267	.	C	A	5	10	15	0	2	17	0	0
13	29953383	.	G	T	4	8	12	0	1	13	0	0
13	29953522	.	T	C	8	0	8	0	16	24	0	0
13	29958513	.	T	A	3	8	11	0	1	12	0	0
13	29958551	.	G	A	4	5	9	0	1	10	0	0
13	29965856	.	G	A	9	5	14	0	0	14	0	0
13	29979966	.	T	C	4	12	16	0	1	17	0	0
13	29993072	.	C	T	0	3	3	0	1	4	0	0
13	30008596	.	A	T	24	19	43	0	2	45	0	0
13	30008631	.	T	C	18	20	38	0	1	39	0	0
13	30008737	.	T	C	24	23	47	0	2	49	0	0
13	30009128	.	G	C	8	10	18	0	0	18	0	0
13	30009818	.	A	C	32	26	58	0	0	58	0	0
13	30009968	.	T	C	13	16	29	2	1	32	0	0
13	30010059	.	C	A	26	15	41	0	1	42	0	0
13	30021321	.	T	A	10	9	19	0	0	19	0	0
13	30027133	.	T	G	12	13	25	0	2	27	0	0
13	30027372	.	G	A	3	8	11	0	0	11	0	0
13	30027378	.	G	A	3	7	10	0	0	10	0	0
13	30027523	.	T	A	13	7	20	0	0	20	0	0
13	30027659	.	C	T	4	6	10	0	1	11	0	0
13	30039013	.	C	T	9	8	17	0	0	17	0	0
13	30041662	.	G	A	2	2	4	0	0	4	0	0
13	30043395	.	T	G	3	0	3	0	3	6	0	0
13	30043579	.	A	G	4	6	10	0	0	10	0	0
13	30044214	.	A	T	1	2	3	0	0	3	0	0
13	30106137	.	C	G	6	0	6	0	11	17	0	0
13	30112396	.	C	T	13	15	28	0	3	31	0	0
13	30112414	.	T	A	7	7	14	0	2	16	0	0
13	30115125	.	A	G	5	6	11	0	2	13	0	0
13	30115217	.	C	T	5	4	9	0	0	9	0	0
13	30128388	.	A	T	2	2	4	0	1	5	0	0
13	30131722	.	G	T	22	20	42	0	1	43	0	0
13	30131804	.	G	A	25	25	50	0	2	52	0	0
13	30132190	.	T	C	33	24	57	0	0	57	0	0
13	30139773	.	G	A	0	1	1	0	0	1	0	0
13	30145217	.	A	G	6	5	11	0	0	11	0	0
13	30145514	.	T	A	6	2	8	0	0	8	0	0
13	30145616	.	T	A	1	4	5	0	0	5	0	0
13	30146199	.	C	A	3	0	3	0	0	3	0	0
13	30146447	.	T	A	2	1	3	0	1	4	0	0
13	30152310	.	A	C	7	5	12	0	0	12	0	0
13	30152502	.	G	C	8	11	19	0	1	20	0	0
13	30155934	.	C	T	13	11	24	0	1	25	0	0
13	30155973	.	T	A	6	6	12	0	0	12	0	0
13	30156176	.	T	C	4	4	8	0	1	9	0	0
13	30156347	.	A	T	1	6	7	0	0	7	0	0
13	30158975	.	A	G	8	6	14	0	0	14	0	0
13	30161553	.	T	A	8	10	18	0	1	19	0	0
13	30166340	.	C	A	10	18	28	0	0	28	0	0
13	30167430	.	T	G	12	14	26	0	1	27	0	0
13	30167432	.	A	G	11	14	25	0	2	27	0	0
13	30167711	.	G	A	24	19	43	0	2	45	0	0
13	30167716	.	T	C	25	20	45	0	2	47	0	0
13	30167807	.	G	A	0	22	22	0	20	42	0	0
13	30168662	.	T	A	17	17	34	0	4	38	0	0
13	30190019	.	A	T	3	2	5	0	0	5	0	0
13	30190031	.	C	T	2	2	4	0	1	5	0	0
13	30199107	.	T	G	0	4	4	0	0	4	0	0
13	30199148	.	G	A	4	7	11	0	0	11	0	0
13	30199190	.	T	C	6	3	9	0	0	9	0	0
13	30199210	.	T	C	4	2	6	0	0	6	0	0
13	30199424	.	A	T	2	2	4	0	0	4	0	0
13	30229090	.	A	G	27	3	30	0	31	61	0	0
13	30233273	.	T	A	1	2	3	0	1	4	0	0
13	30234351	.	A	C	2	4	6	0	0	6	0	0
13	30234693	.	T	C	2	2	4	0	0	4	0	0
13	30498325	.	A	G	6	0	6	0	5	11	0	0
13	30509281	.	A	G	2	0	2	0	3	5	0	0
13	30551479	.	T	C	2	4	6	0	0	6	0	0
13	30552253	.	A	G	1	0	1	0	4	5	0	0
13	30552504	.	T	A	3	3	6	0	1	7	0	0
13	30552605	.	C	G	0	1	1	0	0	1	0	0
13	30552915	.	T	C	2	0	2	0	0	2	0	0
13	30553002	.	C	T	4	7	11	0	1	12	0	0
13	30553404	.	T	C	3	6	9	0	0	9	0	0
13	30553682	.	C	T	5	7	12	0	1	13	0	0
13	30555751	.	G	A	2	8	10	0	0	10	0	0
13	30556278	.	C	T	4	3	7	0	0	7	0	0
13	30558555	.	C	A	3	2	5	0	0	5	0	0
13	30558896	.	T	C	2	2	4	0	0	4	0	0
13	30559044	.	A	G	5	2	7	0	1	8	0	0
13	30561686	.	G	T	0	1	1	0	0	1	0	0
13	30562079	.	T	G	8	3	11	0	0	11	0	0
13	30562673	.	T	C	2	2	4	0	0	4	0	0
13	30568158	.	T	C	12	5	17	0	1	18	0	0
13	30568176	.	A	G	11	0	11	0	9	20	0	0
13	30568316	.	T	A	6	9	15	0	1	16	0	0
13	30568875	.	A	G	6	13	19	0	2	21	0	0
13	30569650	.	A	C	5	4	9	0	1	10	0	0
13	30569687	.	A	G	7	5	12	0	0	12	0	0
13	30575206	.	G	A	2	1	3	0	0	3	0	0
13	30575452	.	C	A	1	3	4	0	0	5	1	0
13	30575637	.	T	A	5	5	10	0	0	10	0	0
13	30579552	.	A	G	2	6	8	0	0	8	0	0
13	30579565	.	A	G	3	2	5	0	1	6	0	0
13	30579792	.	T	C	5	1	6	0	5	11	0	0
13	30580409	.	A	C	3	4	7	0	0	7	0	0
13	30580493	.	T	C	2	2	4	0	0	4	0	0
13	30580786	.	A	T	1	3	4	0	1	5	0	0
13	30580935	.	T	C	9	0	9	0	7	16	0	0
13	30580966	.	T	G	6	5	11	0	2	13	0	0
13	30581329	.	C	T	0	6	6	0	6	12	0	0
13	30581334	.	A	T	6	6	12	0	0	12	0	0
13	30581686	.	A	T	4	4	8	0	0	8	0	0
13	30582347	.	T	C	6	0	6	0	3	9	0	0
13	30582393	.	A	G	2	4	6	0	0	6	0	0
13	30582397	.	A	G	2	4	6	0	0	6	0	0
13	30582461	.	T	C	6	0	6	0	6	12	0	0
13	30582468	.	A	G	5	5	10	0	1	11	0	0
13	30582729	.	G	A	2	3	5	0	0	5	0	0
13	30582746	.	C	T	0	2	2	0	2	4	0	0
13	30583036	.	C	G	1	2	3	0	0	3	0	0
13	30583056	.	A	G	1	2	3	0	0	3	0	0
13	30583573	.	A	G	2	3	5	0	0	5	0	0
13	30583664	.	T	A	4	3	7	0	0	7	0	0
13	30584007	.	G	A	2	4	6	0	1	7	0	0
13	30584052	.	A	T	1	6	7	0	0	7	0	0
13	30584073	.	C	T	1	4	5	0	0	5	0	0
13	30584332	.	G	A	1	4	5	0	0	5	0	0
13	31925599	.	C	T	2	2	4	0	0	4	0	0
13	31925651	.	G	A	3	4	7	0	0	7	0	0
13	31925701	.	A	G	4	5	9	0	0	9	0	0
13	31933666	.	A	G	4	2	6	0	0	6	0	0
13	31933684	.	G	A	5	4	9	0	0	9	0	0
13	31936053	.	C	G	3	2	5	0	0	5	0	0
13	31936074	.	A	T	1	2	3	0	0	3	0	0
13	31936907	.	T	C	5	0	5	0	5	10	0	0
13	32150021	.	T	C	1	8	9	0	0	9	0	0
13	32150038	.	G	A	1	7	8	0	2	10	0	0
13	32150081	.	C	A	2	2	4	0	0	4	0	0
13	32446278	.	G	A	2	7	9	0	0	9	0	0
13	32452658	.	C	T	1	4	5	0	0	5	0	0
13	32452924	.	G	T	2	5	7	0	0	7	0	0
13	32452949	.	T	G	5	4	9	0	0	9	0	0
13	32453281	.	C	T	1	2	3	0	1	4	0	0
13	32453582	.	A	G	1	2	3	0	0	3	0	0
13	32454381	.	A	T	11	7	18	0	0	18	0	0
13	32454565	.	T	A	4	6	10	0	0	10	0	0
13	32455739	.	C	A	11	4	15	0	2	17	0	0
13	32455943	.	A	G	5	6	11	0	1	12	0	0
13	32456312	.	C	G	5	4	9	0	1	10	0	0
13	32456350	.	G	A	3	5	8	0	1	9	0	0
13	32456624	.	C	T	3	3	6	0	0	6	0	0
13	32575859	.	T	G	6	4	10	0	0	10	0	0
13	32576154	.	G	A	4	2	6	0	0	6	0	0
13	32576178	.	T	C	3	0	3	0	3	6	0	0
13	32576760	.	C	A	0	2	2	0	1	3	0	0
13	32580556	.	T	G	5	2	7	0	0	7	0	0
13	32583930	.	A	G	10	4	14	0	0	14	0	0
13	32588892	.	A	G	12	4	16	0	0	16	0	0
13	32592973	.	C	T	1	4	5	0	0	5	0	0
13	32593009	.	T	C	2	0	2	0	2	4	0	0
13	32595257	.	C	T	5	6	11	0	0	11	0	0
13	32627481	.	A	G	0	1	1	0	0	1	0	0
13	32627505	.	G	T	0	2	2	0	0	2	0	0
13	32638668	.	C	T	7	10	17	0	2	19	0	0
13	32638670	.	T	C	7	12	19	0	0	19	0	0
13	32638991	.	T	C	0	0	0	0	1	1	0	0
13	32640975	.	C	A	9	10	19	0	1	20	0	0
13	32641165	.	G	A	3	2	5	0	0	5	0	0
13	32641215	.	A	G	1	2	3	0	0	3	0	0
13	32641480	.	T	C	4	2	6	0	0	6	0	0
13	32641926	.	C	A	0	3	3	0	2	5	0	0
13	32641929	.	G	C	2	2	4	0	1	5	0	0
13	32641979	.	C	T	2	2	4	0	0	4	0	0
13	32642185	.	A	G	3	6	9	0	0	9	0	0
13	32642215	.	A	G	4	8	12	0	0	12	0	0
13	32642284	.	C	A	4	4	8	0	0	8	0	0
13	32642369	.	T	C	4	5	9	0	1	10	0	0
13	32642410	.	G	T	6	7	13	0	0	13	0	0
13	32642488	.	A	G	8	4	12	0	0	12	0	0
13	32642528	.	A	T	10	7	17	0	0	17	0	0
13	32642568	.	A	T	8	7	15	0	1	16	0	0
13	32642618	.	T	A	5	2	7	0	0	7	0	0
13	32642684	.	T	C	4	0	4	0	2	6	0	0
13	32642690	.	T	C	4	2	6	0	0	6	0	0
13	32643891	.	G	A	2	3	5	0	1	6	0	0
13	32648327	.	A	G	1	3	4	0	0	4	0	0
13	32665008	.	A	C	3	3	6	0	1	7	0	0
13	32665035	.	G	A	0	2	2	0	0	2	0	0
13	32726095	.	G	T	2	4	6	0	0	6	0	0
13	32726099	.	G	A	2	4	6	0	0	6	0	0
13	32726152	.	G	C	3	3	6	0	0	6	0	0
13	32794413	.	T	C	3	4	7	0	0	7	0	0
13	32795387	.	T	C	4	4	8	0	0	8	0	0
13	32795882	.	A	C	3	5	8	0	0	8	0	0
13	32795985	.	A	G	1	0	1	0	0	1	0	0
13	32812265	.	G	T	1	4	5	0	0	5	0	0
13	32815765	.	C	T	4	4	8	0	0	8	0	0
13	32825086	.	C	T	2	2	4	0	0	4	0	0
13	32825143	.	A	C	11	1	12	0	7	19	0	0
13	32825149	.	T	C	11	0	11	0	9	20	0	0
13	32827754	.	A	G	1	1	2	0	0	2	0	0
13	32833326	.	T	C	0	1	1	0	0	1	0	0
13	32833359	.	A	G	0	1	1	0	0	1	0	0
13	32833364	.	A	C	0	1	1	0	0	1	0	0
13	32838217	.	T	C	0	3	3	0	0	3	0	0
13	32838241	.	C	A	0	3	3	0	0	3	0	0
13	32838254	.	C	T	0	3	3	0	0	3	0	0
13	32838276	.	T	A	0	1	1	0	0	1	0	0
13	32838468	.	A	G	3	9	12	0	0	12	0	0
13	32838507	.	T	A	4	5	9	0	0	9	0	0
13	32841314	.	A	G	5	4	9	0	0	9	0	0
13	32841598	.	A	G	4	2	6	0	0	6	0	0
13	32844777	.	C	T	0	5	5	0	4	9	0	0
13	32902290	.	T	C	2	0	2	0	2	4	0	0
13	32902368	.	C	A	4	2	6	0	0	6	0	0
13	32902537	.	T	G	2	2	4	0	0	4	0	0
13	32902545	.	G	A	2	3	5	0	0	5	0	0
13	32906139	.	T	A	4	3	7	0	1	8	0	0
13	32993962	.	C	T	0	8	8	0	13	21	0	0
13	32994526	.	T	C	15	7	22	0	0	22	0	0
13	32994565	.	T	A	7	7	14	0	0	14	0	0
13	32994697	.	G	T	9	5	14	0	0	14	0	0
13	32994736	.	A	G	6	11	17	0	2	19	0	0
13	32994841	.	A	G	7	8	15	0	0	15	0	0
13	32997196	.	A	T	4	5	9	0	0	9	0	0
13	32997224	.	C	A	4	13	17	0	0	17	0	0
13	32997424	.	G	T	10	13	23	0	2	25	0	0
13	32997517	.	T	A	10	14	24	0	4	28	0	0
13	33000574	.	C	T	0	8	8	0	5	13	0	0
13	33000586	.	T	C	5	9	14	0	1	15	0	0
13	33005284	.	T	C	6	19	25	0	3	28	0	0
13	33007766	.	C	T	6	4	10	0	1	11	0	0
13	33020054	.	T	C	0	0	0	0	1	1	0	0
13	33021814	.	G	T	1	1	2	0	0	2	0	0
13	33024580	.	G	T	2	4	6	0	0	6	0	0
13	33024599	.	C	A	3	7	10	0	0	10	0	0
13	33024743	.	A	C	4	7	11	0	0	11	0	0
13	33024789	.	G	C	20	13	33	0	0	33	0	0
13	33029576	.	A	T	11	20	31	0	0	31	0	0
13	33029594	.	G	A	2	23	25	0	15	40	0	0
13	33029624	.	G	T	1	16	17	0	9	26	0	0
13	33031915	.	A	G	3	2	5	0	0	5	0	0
13	33033330	.	C	T	11	16	27	0	1	28	0	0
13	33033354	.	A	G	19	21	40	0	0	40	0	0
13	33033658	.	G	C	22	0	22	0	2	24	0	0
13	33033688	.	T	C	16	30	46	0	0	46	0	0
13	33040593	.	A	G	2	4	6	0	1	7	0	0
13	33040738	.	A	C	3	2	5	0	0	5	0	0
13	33040753	.	C	T	2	2	4	0	1	5	0	0
13	33041157	.	T	G	5	2	7	0	0	7	0	0
13	33041354	.	A	C	5	4	9	0	0	9	0	0
13	33048095	.	T	C	10	6	16	0	0	16	0	0
13	33048096	.	G	A	10	6	16	0	0	16	0	0
13	33054598	.	T	C	2	1	3	0	0	3	0	0
13	33054706	.	G	A	4	5	9	0	0	9	0	0
13	33059179	.	C	T	1	2	3	0	1	4	0	0
13	33059257	.	T	C	5	8	13	0	0	13	0	0
13	33059260	.	A	G	5	7	12	0	0	12	0	0
13	33062352	.	G	C	11	14	25	0	0	25	0	0
13	33062367	.	C	T	13	14	27	0	0	27	0	0
13	33065614	.	A	C	16	13	29	0	0	29	0	0
13	33066691	.	C	A	0	4	4	0	4	8	0	0
13	33067116	.	T	A	1	3	4	0	0	4	0	0
13	33077094	.	C	T	2	5	7	0	0	7	0	0
13	33079506	.	T	C	1	0	1	0	2	3	0	0
13	33093724	.	G	T	0	1	1	0	0	1	0	0
13	33094995	.	T	C	2	0	2	0	2	4	0	0
13	33122141	.	T	C	4	5	9	0	0	9	0	0
13	33122276	.	T	A	9	5	14	0	0	14	0	0
13	33122312	.	C	A	9	2	11	0	1	12	0	0
13	33122429	.	C	G	3	8	11	0	0	11	0	0
13	33122519	.	T	C	7	3	10	0	1	11	0	0
13	33122541	.	G	T	9	5	14	0	1	15	0	0
13	33122554	.	A	T	13	5	18	0	0	18	0	0
13	33122642	.	G	A	18	6	24	0	1	25	0	0
13	33122847	.	T	G	7	2	9	0	13	22	0	0
13	33122853	.	C	A	8	12	20	0	0	21	1	0
13	33122986	.	A	G	10	0	10	0	12	22	0	0
13	33174533	.	G	A	6	5	11	0	1	12	0	0
13	33174645	.	G	A	7	6	13	0	0	13	0	0
13	33174681	.	G	A	6	5	11	0	1	12	0	0
13	33174732	.	A	G	9	5	14	0	0	14	0	0
13	33174759	.	G	A	10	6	16	0	2	18	0	0
13	33174964	.	T	C	7	0	7	0	4	11	0	0
13	33175097	.	A	C	2	7	9	0	0	9	0	0
13	33175126	.	C	A	1	4	5	0	2	7	0	0
13	33175190	.	A	G	5	4	9	0	2	11	0	0
13	33175202	.	T	C	5	0	5	0	5	10	0	0
13	33177425	.	G	T	4	3	7	0	2	9	0	0
13	33190239	.	G	C	0	0	0	0	1	1	0	0
13	33192619	.	C	A	2	6	8	0	0	8	0	0
13	33194490	.	A	C	2	5	7	0	1	8	0	0
13	33194527	.	G	C	1	7	8	0	1	9	0	0
13	33194854	.	A	T	1	3	4	0	1	5	0	0
13	33195500	.	T	G	2	3	5	0	0	5	0	0
13	33196441	.	A	C	2	3	5	0	0	5	0	0
13	33196534	.	T	C	2	4	6	0	0	6	0	0
13	33196656	.	A	G	4	3	7	0	0	7	0	0
13	33197959	.	G	C	2	3	5	0	1	6	0	0
13	33211397	.	T	A	4	5	9	0	1	10	0	0
13	33211445	.	A	T	4	4	8	0	0	8	0	0
13	33214706	.	C	T	11	6	17	0	0	17	0	0
13	33214709	.	T	C	10	6	16	0	1	17	0	0
13	33216341	.	G	A	13	7	20	0	0	20	0	0
13	33218214	.	C	T	2	7	9	0	2	11	0	0
13	33219988	.	C	A	0	4	4	0	7	11	0	0
13	33220164	.	A	G	5	2	7	0	0	7	0	0
13	33222342	.	C	A	0	1	1	0	1	2	0	0
13	33222396	.	G	A	5	2	7	0	0	7	0	0
13	33224742	.	G	T	7	8	15	0	0	15	0	0
13	33224932	.	C	T	1	5	6	0	6	12	0	0
13	33225029	.	G	A	7	5	12	0	0	12	0	0
13	33229502	.	T	G	5	4	9	0	0	9	0	0
13	33229739	.	T	C	10	13	23	0	1	24	0	0
13	33229753	.	C	T	11	11	22	0	0	22	0	0
13	33230024	.	A	T	20	20	40	0	0	40	0	0
13	33230163	.	G	C	16	15	31	0	2	33	0	0
13	33230177	.	G	A	16	16	32	0	0	32	0	0
13	33230253	.	C	T	9	9	18	0	1	19	0	0
13	33230308	.	A	T	2	1	3	0	0	3	0	0
13	33230310	.	A	G	2	1	3	0	0	3	0	0
13	33230436	.	C	A	3	20	23	0	0	23	0	0
13	33230518	.	T	C	4	0	4	0	12	16	0	0
13	33234522	.	C	T	1	8	9	0	9	18	0	0
13	33236111	.	T	C	3	3	6	0	0	6	0	0
13	33236482	.	G	T	2	3	5	0	0	5	0	0
13	33236691	.	A	G	3	4	7	0	0	7	0	0
13	33239219	.	G	A	11	8	19	0	2	21	0	0
13	33242878	.	C	T	6	5	11	0	0	11	0	0
13	33246227	.	T	A	5	10	15	0	0	15	0	0
13	33246249	.	T	A	5	16	21	0	0	21	0	0
13	33248351	.	C	T	10	7	17	0	0	17	0	0
13	33248677	.	T	A	7	3	10	0	0	10	0	0
13	33250992	.	T	A	9	14	23	0	1	24	0	0
13	33251058	.	C	G	1	0	1	0	4	5	0	0
13	33251718	.	A	G	1	3	4	0	0	4	0	0
13	33253722	.	G	A	1	1	2	0	0	2	0	0
13	33256562	.	G	T	2	2	4	0	0	4	0	0
13	33261198	.	A	G	14	16	30	0	4	34	0	0
13	33261228	.	C	T	17	25	42	0	2	44	0	0
13	33261303	.	A	T	13	27	40	0	3	43	0	0
13	33261326	.	A	T	12	33	45	0	0	45	0	0
13	33261340	.	C	T	11	26	37	0	0	37	0	0
13	33261389	.	T	G	17	17	34	0	1	35	0	0
13	33261577	.	C	G	31	18	49	0	2	51	0	0
13	33261620	.	T	C	28	13	41	0	4	45	0	0
13	33261637	.	G	T	25	10	35	0	0	39	4	0
13	33262044	.	C	A	26	25	51	0	1	52	0	0
13	33262721	.	A	T	11	21	32	0	0	32	0	0
13	33262749	.	A	C	14	18	32	0	2	34	0	0
13	33262909	.	G	T	23	13	36	0	2	38	0	0
13	33262944	.	C	G	15	19	34	0	1	35	0	0
13	33263503	.	G	T	13	21	34	0	1	35	0	0
13	33263985	.	C	A	10	14	24	0	1	25	0	0
13	33264001	.	G	A	15	17	32	0	0	32	0	0
13	33264315	.	T	C	27	18	45	0	3	48	0	0
13	33264318	.	C	T	30	16	46	0	2	48	0	0
13	33264470	.	A	G	23	21	44	0	1	45	0	0
13	33264483	.	T	A	20	16	36	0	2	38	0	0
13	33264635	.	A	T	12	13	25	0	0	25	0	0
13	33264772	.	A	T	14	14	28	0	0	28	0	0
13	33265061	.	G	T	19	19	38	0	1	39	0	0
13	33265062	.	G	T	19	20	39	0	0	39	0	0
13	33265128	.	T	C	14	3	17	0	19	36	0	0
13	33265210	.	T	G	22	19	41	0	2	43	0	0
13	33265323	.	A	C	13	19	32	0	2	34	0	0
13	33265364	.	G	T	16	19	35	0	1	36	0	0
13	33268757	.	A	T	3	2	5	0	2	7	0	0
13	33268791	.	T	C	4	4	8	0	0	8	0	0
13	33273081	.	C	A	4	2	6	0	0	6	0	0
13	33273106	.	C	T	4	2	6	0	0	6	0	0
13	33276048	.	T	C	5	2	7	0	0	7	0	0
13	33280769	.	C	A	1	0	1	0	0	1	0	0
13	33281138	.	G	T	0	5	5	0	1	6	0	0
13	33281218	.	G	A	0	5	5	0	5	10	0	0
13	33282130	.	G	A	4	8	12	0	0	12	0	0
13	33282227	.	G	A	3	3	6	0	0	6	0	0
13	33282236	.	A	G	2	3	5	0	0	5	0	0
13	33293566	.	T	C	2	3	5	0	0	5	0	0
13	33293575	.	C	T	2	3	5	0	0	5	0	0
13	33294207	.	C	T	1	5	6	0	0	6	0	0
13	33295894	.	T	A	2	2	4	0	0	4	0	0
13	33300228	.	A	G	1	1	2	0	0	2	0	0
13	33313037	.	T	C	2	0	2	0	0	2	0	0
13	33314821	.	T	G	1	4	5	0	0	5	0	0
13	33314840	.	A	T	3	6	9	0	1	10	0	0
13	33314863	.	T	C	3	6	9	0	0	9	0	0
13	33314946	.	T	C	2	3	5	0	0	5	0	0
13	33315112	.	C	G	0	2	2	0	0	2	0	0
13	33317143	.	T	A	1	2	3	0	0	3	0	0
13	33368512	.	A	T	2	2	4	0	0	4	0	0
13	33368531	.	C	T	2	3	5	0	0	5	0	0
13	33394476	.	A	C	15	23	38	0	0	38	0	0
13	33394887	.	G	A	18	18	36	0	2	38	0	0
13	33394976	.	T	C	17	15	32	0	2	34	0	0
13	33395174	.	C	G	17	13	30	0	3	33	0	0
13	33395256	.	T	G	9	15	24	0	0	24	0	0
13	33396026	.	A	C	2	0	2	0	3	5	0	0
13	33398365	.	C	T	14	15	29	0	2	32	1	0
13	33398498	.	G	A	13	6	19	0	0	19	0	0
13	33445279	.	G	A	0	1	1	0	0	1	0	0
13	33447169	.	G	A	1	2	3	0	0	3	0	0
13	33447321	.	T	C	2	2	4	0	0	4	0	0
13	33447389	.	T	C	1	3	4	0	0	4	0	0
13	33448245	.	C	A	2	2	4	0	0	4	0	0
13	33609129	.	T	C	1	2	3	0	0	3	0	0
13	33612347	.	C	T	5	6	11	0	1	12	0	0
13	33625095	.	T	C	2	6	8	0	0	8	0	0
13	33633271	.	T	A	3	3	6	0	0	6	0	0
13	33636034	.	A	G	4	3	7	0	0	7	0	0
13	33636548	.	T	C	3	0	3	0	4	7	0	0
13	33636597	.	G	A	2	4	6	0	2	8	0	0
13	33645567	.	C	T	5	4	9	0	0	9	0	0
13	33645892	.	C	T	5	5	10	0	0	10	0	0
13	33645931	.	C	T	2	3	5	0	1	6	0	0
13	33646123	.	T	A	4	12	16	0	0	16	0	0
13	33646132	.	A	T	5	11	16	0	1	17	0	0
13	33646224	.	C	T	1	4	5	0	0	6	1	0
13	33646285	.	G	A	2	4	6	0	0	6	0	0
13	33646333	.	T	C	2	0	2	0	3	5	0	0
13	33646401	.	G	A	3	3	6	0	0	6	0	0
13	33649184	.	T	G	4	6	10	0	0	10	0	0
13	33652588	.	A	G	2	1	3	0	0	3	0	0
13	33655957	.	A	T	3	2	5	0	0	5	0	0
13	33656297	.	A	C	1	3	4	0	0	4	0	0
13	33658722	.	A	G	1	3	4	0	0	4	0	0
13	33661935	.	G	A	1	0	1	0	0	1	0	0
13	33661938	.	A	C	1	0	1	0	0	1	0	0
13	33665483	.	G	T	0	2	2	0	0	2	0	0
13	33682023	.	C	T	22	20	42	0	1	43	0	0
13	33682052	.	T	C	23	19	42	0	3	45	0	0
13	33682068	.	A	C	25	22	47	0	3	50	0	0
13	33682216	.	C	T	17	19	36	0	1	37	0	0
13	33682217	.	A	T	17	16	33	0	4	37	0	0
13	33682379	.	C	A	15	9	24	0	1	25	0	0
13	33682731	.	G	A	14	19	33	0	1	34	0	0
13	33683824	.	A	C	24	29	53	0	2	55	0	0
13	33683829	.	A	T	23	24	47	0	5	52	0	0
13	33813428	.	A	C	12	7	19	0	0	19	0	0
13	33813452	.	T	G	14	7	21	0	0	21	0	0
13	33813792	.	C	T	14	10	24	0	1	25	0	0
13	33814644	.	A	C	13	11	24	0	0	24	0	0
13	33814647	.	T	A	13	10	23	0	0	23	0	0
13	33814773	.	C	T	16	12	28	0	1	29	0	0
13	33815863	.	C	A	1	3	4	0	0	4	0	0
13	33815992	.	C	T	9	6	15	0	0	15	0	0
13	33816200	.	C	T	2	7	9	0	0	9	0	0
13	33816231	.	T	G	1	5	6	0	0	6	0	0
13	33816442	.	C	T	5	7	12	0	0	12	0	0
13	33816509	.	A	G	2	5	7	0	1	8	0	0
13	33816518	.	T	C	3	3	6	0	0	6	0	0
13	33968506	.	T	C	5	3	8	0	0	8	0	0
13	34488737	.	T	G	3	3	6	0	0	6	0	0
13	34519607	.	T	A	2	1	3	0	1	4	0	0
13	34556374	.	C	A	1	3	4	0	0	4	0	0
13	34689840	.	G	T	0	2	2	0	0	2	0	0
13	34703994	.	T	C	1	1	2	0	2	4	0	0
13	34746145	.	A	T	3	4	7	0	1	8	0	0
13	34746179	.	A	C	3	2	5	0	1	6	0	0
13	34746663	.	A	G	2	3	5	0	0	5	0	0
13	34746671	.	G	A	1	5	6	0	0	6	0	0
13	34746752	.	A	G	4	0	4	0	2	6	0	0
13	34746847	.	A	G	1	2	3	0	2	5	0	0
13	34746980	.	A	G	3	2	5	0	0	5	0	0
13	34747137	.	G	A	0	4	4	0	3	7	0	0
13	34747160	.	A	C	2	3	5	0	0	5	0	0
13	34747291	.	G	C	3	3	6	0	1	7	0	0
13	34747916	.	A	C	3	4	7	0	1	8	0	0
13	34748086	.	G	T	4	5	9	0	1	10	0	0
13	34748199	.	C	A	4	3	7	0	1	8	0	0
13	34748362	.	C	T	3	4	7	0	0	7	0	0
13	34748479	.	A	G	4	5	9	0	1	10	0	0
13	34748516	.	C	T	6	7	13	0	1	14	0	0
13	34748791	.	G	T	10	5	15	0	0	15	0	0
13	34748959	.	A	T	3	3	6	0	0	6	0	0
13	34748990	.	T	A	4	4	8	0	1	9	0	0
13	34749542	.	A	G	3	7	10	0	0	10	0	0
13	34749616	.	C	T	10	5	15	0	0	15	0	0
13	34749743	.	G	T	5	3	8	0	1	9	0	0
13	34749751	.	C	T	4	6	10	0	1	11	0	0
13	34749819	.	C	T	7	10	17	0	1	18	0	0
13	34749833	.	A	G	8	6	14	0	1	15	0	0
13	34749936	.	T	A	9	5	14	0	1	15	0	0
13	34750212	.	A	T	2	2	4	0	0	4	0	0
13	34765315	.	A	G	1	2	3	0	0	3	0	0
13	34765346	.	T	G	1	2	3	0	0	3	0	0
13	34765383	.	G	A	3	3	6	0	0	6	0	0
13	34765639	.	G	A	2	2	4	0	0	4	0	0
13	34765690	.	A	G	3	3	6	0	0	6	0	0
13	34765780	.	T	G	4	2	6	0	0	6	0	0
13	34771824	.	T	C	1	3	4	0	0	4	0	0
13	34779859	.	T	C	2	4	6	0	1	7	0	0
13	35042138	.	C	T	14	27	41	0	0	41	0	0
13	35042237	.	G	A	17	21	38	0	2	40	0	0
13	35042279	.	G	A	18	26	44	0	2	46	0	0
13	35042354	.	G	T	15	15	30	0	0	31	1	0
13	35049461	.	A	G	0	3	3	0	1	4	0	0
13	35051624	.	C	T	1	11	12	0	10	22	0	0
13	35051786	.	T	C	12	18	30	0	0	30	0	0
13	35051880	.	G	A	5	9	14	0	0	14	0	0
13	35474933	.	A	G	3	2	5	0	0	5	0	0
13	35474939	.	G	T	3	2	5	0	0	5	0	0
13	35478781	.	T	A	2	0	2	0	0	2	0	0
13	35481419	.	C	T	1	1	2	0	0	2	0	0
13	35481452	.	T	C	2	2	4	0	0	4	0	0
13	35510945	.	T	C	5	4	9	0	0	9	0	0
13	35527647	.	G	T	3	2	5	0	1	6	0	0
13	35723419	.	T	A	1	0	1	0	0	1	0	0
13	35723453	.	G	A	2	2	4	0	0	4	0	0
13	35726735	.	G	C	0	1	1	0	0	1	0	0
13	35728714	.	A	G	0	1	1	0	0	1	0	0
13	35744431	.	T	A	4	5	9	0	0	9	0	0
13	35745657	.	T	C	9	7	16	0	0	16	0	0
13	35746343	.	A	G	3	0	3	0	2	5	0	0
13	35746637	.	C	T	13	12	25	0	0	25	0	0
13	35746838	.	T	C	9	6	15	0	0	15	0	0
13	35747177	.	T	G	15	12	27	0	1	28	0	0
13	35747690	.	A	G	22	0	22	0	10	32	0	0
13	35747918	.	T	C	18	23	41	0	2	43	0	0
13	35747954	.	T	C	19	30	49	0	1	50	0	0
13	35748096	.	C	G	20	0	20	0	14	34	0	0
13	35748249	.	G	A	12	11	23	0	5	28	0	0
13	35748319	.	T	C	10	17	27	0	0	27	0	0
13	35748566	.	C	T	3	2	5	0	0	5	0	0
13	35751047	.	T	C	5	5	10	0	2	12	0	0
13	35751211	.	T	C	9	10	19	0	1	20	0	0
13	35752964	.	T	C	1	0	1	0	0	1	0	0
13	35753242	.	G	A	2	2	4	0	0	4	0	0
13	35756029	.	G	T	3	7	10	0	0	10	0	0
13	35757338	.	T	G	3	8	11	0	0	11	0	0
13	35759904	.	G	A	4	0	4	0	0	4	0	0
13	35775037	.	T	C	0	1	1	0	0	1	0	0
13	35788222	.	G	A	5	7	12	0	0	12	0	0
13	35788302	.	A	C	12	16	28	0	0	28	0	0
13	35788313	.	T	C	8	16	24	0	1	25	0	0
13	35788507	.	G	A	16	12	28	0	1	29	0	0
13	35788562	.	C	G	1	16	17	0	13	30	0	0
13	35791419	.	C	G	9	9	18	0	1	19	0	0
13	35791539	.	G	A	2	6	8	0	0	8	0	0
13	35796882	.	C	T	10	11	21	0	1	22	0	0
13	35796894	.	G	A	11	10	21	0	0	21	0	0
13	35796924	.	C	T	1	5	6	0	6	12	0	0
13	35798915	.	A	G	4	4	8	0	0	8	0	0
13	35798960	.	T	C	6	8	14	0	1	15	0	0
13	35798966	.	G	C	4	10	14	0	1	15	0	0
13	35799146	.	G	A	0	3	3	0	0	3	0	0
13	35799194	.	C	T	1	6	7	0	0	7	0	0
13	35799230	.	A	G	0	3	3	0	0	3	0	0
13	35801452	.	A	G	10	10	20	0	2	22	0	0
13	35801473	.	A	G	11	6	17	0	1	18	0	0
13	35801501	.	T	C	5	0	5	0	5	10	0	0
13	35808949	.	T	C	6	4	10	0	0	10	0	0
13	35811400	.	A	G	2	4	6	0	1	7	0	0
13	35811852	.	C	G	3	2	5	0	0	5	0	0
13	35813549	.	A	G	3	6	9	0	0	9	0	0
13	35813666	.	C	T	0	6	6	0	4	10	0	0
13	35814762	.	A	T	0	3	3	0	0	3	0	0
13	35820971	.	G	A	3	3	6	0	0	6	0	0
13	35844912	.	A	G	4	5	9	0	1	10	0	0
13	35856539	.	G	T	6	5	11	0	1	12	0	0
13	35856826	.	T	C	6	10	16	0	0	16	0	0
13	35866351	.	T	C	0	2	2	0	0	2	0	0
13	35866381	.	A	G	3	5	8	0	0	8	0	0
13	35872207	.	C	T	10	10	20	0	0	20	0	0
13	35904964	.	G	A	1	4	5	0	1	6	0	0
13	35905136	.	G	A	2	6	8	0	1	9	0	0
13	35905265	.	A	G	2	3	5	0	0	5	0	0
13	35905334	.	C	T	0	3	3	0	3	6	0	0
13	35907171	.	A	C	1	2	3	0	0	3	0	0
13	35945633	.	G	A	0	1	1	0	0	1	0	0
13	35950431	.	A	G	2	3	5	0	0	5	0	0
13	35950440	.	C	T	2	2	4	0	0	4	0	0
13	35950720	.	G	A	3	5	8	0	0	8	0	0
13	35950753	.	C	A	1	1	2	0	0	2	0	0
13	35953558	.	G	A	6	8	14	0	0	14	0	0
13	35975643	.	C	G	0	2	2	0	0	2	0	0
13	36039938	.	G	A	20	26	46	0	2	48	0	0
13	36040061	.	G	T	24	12	36	0	3	39	0	0
13	36040127	.	A	T	22	20	42	0	2	44	0	0
13	36040278	.	T	C	22	0	22	0	12	34	0	0
13	36040473	.	A	C	6	8	14	0	1	15	0	0
13	36040611	.	C	T	1	6	7	0	16	23	0	0
13	36040635	.	C	A	11	5	16	0	0	16	0	0
13	36042020	.	T	A	17	7	24	0	2	26	0	0
13	36042057	.	C	T	16	17	33	0	3	36	0	0
13	36042091	.	G	C	10	11	21	0	2	23	0	0
13	36043781	.	T	A	7	11	18	0	0	18	0	0
13	36043796	.	T	C	6	0	6	0	6	12	0	0
13	36043820	.	T	C	1	0	1	0	0	1	0	0
13	36048931	.	A	G	8	7	15	0	0	15	0	0
13	36048981	.	C	T	3	2	5	0	0	5	0	0
13	36054962	.	T	C	20	14	34	0	0	34	0	0
13	36057124	.	C	T	3	2	5	0	2	7	0	0
13	36060640	.	G	A	15	8	23	0	4	27	0	0
13	36060679	.	T	G	9	11	20	0	4	24	0	0
13	36062661	.	T	A	1	2	3	0	0	3	0	0
13	36062904	.	C	A	1	0	1	0	0	1	0	0
13	36067938	.	A	G	3	6	9	0	1	10	0	0
13	36072451	.	C	T	1	5	6	0	1	7	0	0
13	36074085	.	T	C	2	0	2	0	0	2	0	0
13	36074176	.	G	A	4	6	10	0	0	10	0	0
13	36079205	.	G	A	1	1	2	0	0	2	0	0
13	36084169	.	C	G	3	2	5	0	0	5	0	0
13	36086415	.	G	A	4	3	7	0	1	8	0	0
13	36088851	.	A	G	1	1	2	0	0	2	0	0
13	36102706	.	C	T	0	2	2	0	0	2	0	0
13	36103049	.	G	C	2	3	5	0	0	5	0	0
13	36103492	.	G	A	2	5	7	0	0	7	0	0
13	36103688	.	A	G	2	3	5	0	1	6	0	0
13	36134326	.	C	G	1	5	6	0	0	6	0	0
13	36136585	.	A	G	2	3	5	0	1	6	0	0
13	36136669	.	C	G	0	0	0	0	6	6	0	0
13	36146596	.	G	A	16	11	27	0	2	29	0	0
13	36151407	.	G	C	6	4	10	0	0	10	0	0
13	36151462	.	G	A	9	11	20	0	1	21	0	0
13	36151635	.	T	C	15	9	24	0	1	27	2	0
13	36151636	.	C	T	15	9	24	0	3	27	0	0
13	36151894	.	G	C	12	21	33	0	2	35	0	0
13	36151929	.	C	T	17	13	30	0	1	31	0	0
13	36152364	.	T	C	26	18	44	0	1	45	0	0
13	36152402	.	C	T	21	29	50	0	2	52	0	0
13	36152415	.	A	G	22	23	45	0	4	49	0	0
13	36152440	.	T	G	19	0	19	0	26	45	0	0
13	36152700	.	T	A	21	13	34	0	0	34	0	0
13	36152733	.	A	G	20	11	31	0	1	32	0	0
13	36152778	.	A	G	15	14	29	0	1	30	0	0
13	36152795	.	A	C	15	11	26	0	1	27	0	0
13	36152838	.	A	G	11	0	11	0	11	22	0	0
13	36152874	.	C	T	8	4	12	0	0	12	0	0
13	36152952	.	C	A	4	4	8	0	0	8	0	0
13	36153063	.	T	A	4	2	6	0	0	6	0	0
13	36153313	.	T	C	17	12	29	0	2	31	0	0
13	36153382	.	C	T	13	15	28	0	3	31	0	0
13	36168836	.	G	A	2	2	4	0	0	4	0	0
13	36179661	.	G	C	1	5	6	0	0	6	0	0
13	36179697	.	C	T	2	4	6	0	1	7	0	0
13	36179838	.	C	T	2	5	7	0	0	7	0	0
13	36179844	.	A	T	2	5	7	0	0	7	0	0
13	36223870	.	G	T	0	1	1	0	0	1	0	0
13	36264100	.	T	C	1	2	3	0	0	3	0	0
13	36264292	.	T	C	2	3	5	0	0	5	0	0
13	36312080	.	T	C	2	2	4	0	0	4	0	0
13	36312103	.	C	G	2	3	5	0	0	5	0	0
13	36312193	.	G	T	12	5	17	0	0	17	0	0
13	36312361	.	C	A	5	2	7	0	1	8	0	0
13	36312447	.	A	G	3	5	8	0	0	8	0	0
13	36312469	.	T	G	4	3	7	0	0	7	0	0
13	36312497	.	C	T	0	4	4	0	2	6	0	0
13	36312682	.	G	A	3	3	6	0	1	7	0	0
13	36321256	.	C	T	3	5	8	0	1	9	0	0
13	36322099	.	C	T	0	9	9	0	13	22	0	0
13	36322133	.	A	G	13	13	26	0	2	28	0	0
13	36330642	.	G	A	2	4	6	0	0	6	0	0
13	36335033	.	G	A	2	2	4	0	0	4	0	0
13	36335057	.	A	G	2	1	3	0	0	3	0	0
13	36335206	.	A	G	2	1	3	0	0	3	0	0
13	36337349	.	T	C	0	0	0	0	1	1	0	0
13	36338262	.	A	G	2	1	3	0	0	3	0	0
13	36349674	.	G	A	2	1	3	0	0	3	0	0
13	36409233	.	A	T	5	5	10	0	0	10	0	0
13	36409246	.	C	T	5	5	10	0	0	10	0	0
13	36409522	.	T	C	6	0	6	0	3	9	0	0
13	36409691	.	A	G	4	12	16	0	0	16	0	0
13	36410339	.	T	C	10	5	15	0	1	16	0	0
13	36410671	.	T	C	3	8	11	0	0	11	0	0
13	36424414	.	G	A	3	4	7	0	0	7	0	0
13	36438831	.	C	T	4	2	6	0	3	9	0	0
13	36450109	.	C	T	1	3	4	0	0	4	0	0
13	36452977	.	A	G	4	4	8	0	0	8	0	0
13	36461642	.	T	C	1	0	1	0	2	3	0	0
13	36465595	.	C	T	1	2	3	0	0	3	0	0
13	36465604	.	A	G	1	1	2	0	0	2	0	0
13	36467504	.	G	A	1	2	3	0	0	3	0	0
13	36467558	.	G	A	1	2	3	0	0	3	0	0
13	36481823	.	C	T	2	2	4	0	0	4	0	0
13	36606576	.	A	G	8	3	11	0	2	13	0	0
13	37076269	.	T	C	11	10	21	0	5	26	0	0
13	37076337	.	T	C	12	5	17	0	1	18	0	0
13	37671628	.	G	A	5	2	7	0	1	8	0	0
13	38304824	.	A	G	12	6	18	0	0	18	0	0
13	38446709	.	A	G	7	0	7	0	4	11	0	0
13	38466196	.	G	A	1	2	3	0	0	3	0	0
13	38466247	.	C	T	10	8	18	0	0	18	0	0
13	38466343	.	T	C	6	8	14	0	0	14	0	0
13	38566611	.	A	G	4	0	4	0	3	7	0	0
13	38583699	.	C	A	17	23	40	0	4	44	0	0
13	38583714	.	A	G	21	22	43	0	1	44	0	0
13	38593559	.	A	G	33	23	56	0	0	56	0	0
13	38593574	.	A	T	26	24	50	0	0	50	0	0
13	38621607	.	G	T	2	4	6	0	0	6	0	0
13	38622184	.	C	T	0	9	9	0	3	12	0	0
13	38666128	.	G	A	11	7	18	0	1	19	0	0
13	39111237	.	A	G	3	3	6	0	0	6	0	0
13	39112434	.	C	T	2	3	5	0	0	5	0	0
13	39112550	.	A	G	0	2	2	0	1	4	1	0
13	39113101	.	G	T	1	3	4	0	1	5	0	0
13	39113415	.	G	A	2	3	5	0	0	5	0	0
13	39114444	.	C	A	2	2	4	0	0	4	0	0
13	39114474	.	G	T	2	2	4	0	0	4	0	0
13	39217377	.	C	T	3	4	7	0	2	9	0	0
13	39217657	.	C	T	7	8	15	0	0	15	0	0
13	39217887	.	T	G	4	0	4	0	6	10	0	0
13	39218060	.	T	C	3	7	10	0	1	11	0	0
13	39218097	.	A	G	4	4	8	0	4	12	0	0
13	39218133	.	C	A	4	5	9	0	0	9	0	0
13	39218292	.	C	T	8	5	13	0	0	13	0	0
13	39218706	.	T	C	8	14	22	0	0	22	0	0
13	39218843	.	G	A	3	6	9	0	15	24	0	0
13	39221960	.	T	C	4	3	7	0	1	8	0	0
13	39223774	.	A	G	4	3	7	0	0	7	0	0
13	39226666	.	T	C	6	7	13	0	0	13	0	0
13	39227275	.	G	A	0	11	11	0	8	19	0	0
13	39227566	.	A	T	3	2	5	0	0	5	0	0
13	39228272	.	G	A	5	4	9	0	1	10	0	0
13	39270178	.	A	G	2	2	4	0	0	4	0	0
13	39270239	.	C	T	4	2	6	0	0	6	0	0
13	39277927	.	G	T	0	2	2	0	3	5	0	0
13	39303070	.	A	G	5	2	7	0	1	8	0	0
13	39303161	.	A	C	2	0	2	0	0	2	0	0
13	39305208	.	C	G	1	0	1	0	0	1	0	0
13	39360613	.	C	T	0	2	2	0	1	3	0	0
13	39364580	.	G	A	2	0	2	0	0	2	0	0
13	39657068	.	A	G	9	5	14	0	1	15	0	0
13	39657140	.	C	T	0	7	7	0	5	12	0	0
13	39657156	.	T	G	4	7	11	0	0	11	0	0
13	39657625	.	A	C	4	4	8	0	0	8	0	0
13	39657652	.	A	G	5	3	8	0	1	9	0	0
13	40335087	.	T	G	4	4	8	0	1	9	0	0
13	40335135	.	T	G	7	0	7	0	5	12	0	0
13	40344258	.	C	T	2	4	6	0	0	6	0	0
13	40344303	.	G	A	0	9	9	0	8	17	0	0
13	40351869	.	G	A	8	13	21	0	2	23	0	0
13	40351914	.	G	A	1	9	10	0	14	24	0	0
13	40351953	.	C	T	18	9	27	0	2	29	0	0
13	40352345	.	C	T	14	9	23	0	0	23	0	0
13	40352349	.	C	G	14	8	22	0	1	23	0	0
13	40352415	.	T	G	7	7	14	0	0	14	0	0
13	40352476	.	A	G	10	7	17	0	1	18	0	0
13	40353199	.	A	G	12	2	14	0	0	14	0	0
13	40353334	.	A	G	1	0	1	0	4	5	0	0
13	40353512	.	G	T	15	13	28	0	2	30	0	0
13	40353736	.	A	C	12	11	23	0	2	25	0	0
13	40354235	.	C	T	3	3	6	0	0	6	0	0
13	40445253	.	C	T	5	3	8	0	1	9	0	0
13	40463048	.	T	A	5	3	8	0	1	9	0	0
13	40463732	.	C	T	0	7	7	0	12	19	0	0
13	40463784	.	G	C	7	1	8	0	6	14	0	0
13	40482568	.	T	A	1	6	7	0	1	8	0	0
13	40486656	.	G	A	0	1	1	0	0	1	0	0
13	40497631	.	G	A	3	0	3	0	0	3	0	0
13	40497802	.	A	G	7	4	11	0	0	11	0	0
13	40497928	.	C	T	10	3	13	0	0	13	0	0
13	40498129	.	C	G	0	10	10	0	5	15	0	0
13	40498759	.	G	A	3	2	5	0	1	6	0	0
13	40712044	.	T	C	0	4	4	0	0	4	0	0
13	40715089	.	C	T	1	1	2	0	0	2	0	0
13	40715112	.	T	C	1	1	2	0	0	2	0	0
13	40715871	.	C	T	3	3	6	0	0	6	0	0
13	40746971	.	G	T	5	3	8	0	0	8	0	0
13	40747151	.	T	C	3	4	7	0	1	8	0	0
13	40747256	.	T	A	11	6	17	0	0	17	0	0
13	40747274	.	T	C	9	0	9	0	6	15	0	0
13	40747337	.	T	A	3	7	10	0	1	11	0	0
13	40747397	.	C	A	9	4	13	0	0	13	0	0
13	40747398	.	C	A	9	4	13	0	0	13	0	0
13	40747467	.	C	T	0	9	9	0	2	11	0	0
13	40747607	.	G	T	3	5	8	0	0	8	0	0
13	40747839	.	T	C	3	2	5	0	0	5	0	0
13	40747841	.	T	C	3	0	3	0	2	5	0	0
13	40748074	.	A	G	3	2	5	0	0	5	0	0
13	40748246	.	A	C	6	8	14	0	0	14	0	0
13	40748248	.	C	A	5	8	13	0	1	14	0	0
13	40748310	.	T	G	3	2	5	0	0	5	0	0
13	40748356	.	G	T	4	3	7	0	0	7	0	0
13	40748408	.	C	T	5	4	9	0	0	9	0	0
13	40748431	.	G	A	4	4	8	0	0	8	0	0
13	40748582	.	G	A	2	9	11	0	0	11	0	0
13	40748620	.	C	T	1	8	9	0	0	9	0	0
13	40748621	.	T	A	1	8	9	0	0	9	0	0
13	40749104	.	T	C	2	3	5	0	1	6	0	0
13	40749138	.	A	C	2	1	3	0	0	3	0	0
13	40749142	.	C	T	2	2	4	0	0	4	0	0
13	40749445	.	G	A	4	4	8	0	1	9	0	0
13	40749577	.	G	A	3	2	5	0	0	5	0	0
13	40754367	.	T	G	0	1	1	0	0	1	0	0
13	40754433	.	A	T	6	5	11	0	0	11	0	0
13	40754441	.	G	T	6	3	9	0	0	9	0	0
13	41125475	.	C	T	7	5	12	0	1	13	0	0
13	41125652	.	C	T	2	4	6	0	0	6	0	0
13	41125766	.	A	G	5	6	11	0	0	11	0	0
13	41128286	.	G	A	1	1	2	0	0	2	0	0
13	41208028	.	T	C	2	4	6	0	0	6	0	0
13	41214782	.	A	G	1	2	3	0	0	3	0	0
13	41214812	.	G	A	4	4	8	0	0	8	0	0
13	41214863	.	G	A	4	4	8	0	0	8	0	0
13	41279989	.	G	A	0	3	3	0	0	3	0	0
13	41288990	.	A	G	1	4	5	0	0	5	0	0
13	41289112	.	C	T	0	5	5	0	3	8	0	0
13	41289189	.	T	C	1	4	5	0	0	5	0	0
13	41306803	.	G	T	1	0	1	0	0	1	0	0
13	41320070	.	G	C	6	5	11	0	0	11	0	0
13	41388480	.	A	G	0	1	1	0	0	1	0	0
13	41546643	.	A	G	0	2	2	0	0	2	0	0
13	41910428	.	G	A	6	6	12	0	0	12	0	0
13	41911090	.	G	A	17	18	35	0	0	35	0	0
13	41911092	.	C	A	18	17	35	0	0	35	0	0
13	41911265	.	G	A	8	10	18	0	1	19	0	0
13	41911276	.	T	C	8	14	22	0	1	23	0	0
13	41911475	.	G	T	12	10	22	0	1	23	0	0
13	41911477	.	T	C	15	0	15	0	8	23	0	0
13	41911597	.	G	T	11	8	19	0	0	19	0	0
13	41911771	.	A	G	10	4	14	0	0	14	0	0
13	41911788	.	C	T	5	4	9	0	1	10	0	0
13	41911932	.	A	G	6	5	11	0	0	11	0	0
13	41915604	.	A	G	15	12	27	0	2	29	0	0
13	41917003	.	C	A	10	3	13	0	1	14	0	0
13	41936597	.	G	A	0	2	2	0	1	3	0	0
13	41936615	.	A	G	1	2	3	0	1	4	0	0
13	41940198	.	G	A	0	3	3	0	1	4	0	0
13	41944188	.	T	A	1	2	3	0	0	3	0	0
13	41944269	.	T	A	3	2	5	0	1	6	0	0
13	41944446	.	T	G	4	4	8	0	0	8	0	0
13	41944479	.	G	A	4	3	7	0	0	7	0	0
13	41944815	.	C	A	0	8	8	0	6	14	0	0
13	41945455	.	C	T	6	4	10	0	0	10	0	0
13	41945464	.	C	T	0	7	7	0	4	11	0	0
13	41945632	.	C	T	1	6	7	0	3	10	0	0
13	41945737	.	A	G	1	6	7	0	0	7	0	0
13	41947874	.	C	T	4	2	6	0	0	6	0	0
13	41947882	.	C	T	0	2	2	0	3	5	0	0
13	42018012	.	C	T	2	2	4	0	0	4	0	0
13	42018048	.	A	G	1	0	1	0	2	3	0	0
13	42018175	.	A	C	3	4	7	0	1	8	0	0
13	42018304	.	A	T	3	2	5	0	0	5	0	0
13	42066135	.	T	C	6	0	6	0	5	11	0	0
13	42142194	.	C	A	11	8	19	0	0	19	0	0
13	42142296	.	T	C	8	6	14	0	0	14	0	0
13	42142854	.	G	A	9	8	17	0	2	19	0	0
13	42143285	.	A	T	8	9	17	0	0	17	0	0
13	42143294	.	T	G	12	10	22	0	0	22	0	0
13	42143572	.	T	A	0	2	2	0	0	2	0	0
13	42143581	.	T	A	0	2	2	0	0	2	0	0
13	42309890	.	C	A	2	1	3	0	0	3	0	0
13	42319544	.	G	A	2	5	7	0	0	7	0	0
13	42320084	.	G	C	0	1	1	0	0	1	0	0
13	42321191	.	C	T	3	3	6	0	0	6	0	0
13	42349499	.	C	T	5	4	9	0	0	9	0	0
13	42349683	.	C	T	5	5	10	0	1	11	0	0
13	42361795	.	A	G	14	11	25	0	1	26	0	0
13	42365043	.	A	G	1	1	2	0	0	2	0	0
13	42365121	.	T	C	12	6	18	0	0	18	0	0
13	42365139	.	T	C	13	0	13	0	8	21	0	0
13	42365374	.	C	T	6	8	14	0	3	17	0	0
13	42400391	.	T	A	14	11	25	0	0	25	0	0
13	42400473	.	C	T	7	11	18	0	0	18	0	0
13	42407519	.	C	T	4	4	8	0	2	10	0	0
13	42407526	.	A	G	5	4	9	0	1	10	0	0
13	42407618	.	A	C	5	2	7	0	0	7	0	0
13	42443487	.	T	C	1	3	4	0	0	4	0	0
13	42443517	.	T	C	1	2	3	0	0	3	0	0
13	42467430	.	T	C	5	6	11	0	0	11	0	0
13	42471886	.	A	C	2	5	7	0	0	7	0	0
13	42481169	.	T	C	5	5	10	0	0	10	0	0
13	42481256	.	A	G	10	6	16	0	1	17	0	0
13	42481267	.	G	A	10	7	17	0	2	19	0	0
13	42481306	.	T	C	11	5	16	0	2	18	0	0
13	42481512	.	A	G	11	11	22	0	1	23	0	0
13	42481538	.	A	G	14	15	29	0	0	29	0	0
13	42481575	.	T	C	7	9	16	0	0	16	0	0
13	42481599	.	A	G	6	4	10	0	0	10	0	0
13	42483050	.	A	G	8	9	17	0	2	19	0	0
13	42483082	.	A	G	5	4	9	0	0	9	0	0
13	42483089	.	T	C	3	3	6	0	0	6	0	0
13	42488440	.	C	T	4	5	9	0	1	10	0	0
13	42490778	.	T	C	3	4	7	0	0	7	0	0
13	42491406	.	G	A	3	2	5	0	0	5	0	0
13	42491448	.	C	T	0	1	1	0	2	3	0	0
13	42500370	.	A	G	3	2	5	0	0	5	0	0
13	42502659	.	T	A	2	4	6	0	0	6	0	0
13	42502713	.	T	C	1	3	4	0	1	5	0	0
13	42516915	.	C	G	0	4	4	0	2	6	0	0
13	42523723	.	A	T	1	0	1	0	0	1	0	0
13	42523951	.	A	G	1	1	2	0	0	2	0	0
13	42523969	.	G	C	1	1	2	0	0	2	0	0
13	42523987	.	T	C	1	4	5	0	0	5	0	0
13	42526376	.	C	T	1	1	2	0	0	2	0	0
13	42536843	.	T	C	1	2	3	0	0	3	0	0
13	42602533	.	A	T	1	2	3	0	0	3	0	0
13	42604301	.	A	C	2	0	2	0	0	2	0	0
13	42604325	.	C	T	2	0	2	0	0	2	0	0
13	42607276	.	C	G	0	3	3	0	0	3	0	0
13	42610900	.	C	T	1	2	3	0	0	3	0	0
13	42610961	.	A	T	4	3	7	0	0	7	0	0
13	42611019	.	T	C	3	2	5	0	0	5	0	0
13	42611117	.	G	C	0	2	2	0	0	2	0	0
13	42615073	.	T	G	1	3	4	0	0	4	0	0
13	42615094	.	G	A	1	3	4	0	0	4	0	0
13	42616301	.	A	C	1	3	4	0	0	4	0	0
13	42616563	.	T	C	2	1	3	0	0	3	0	0
13	42622006	.	C	T	3	10	13	0	0	13	0	0
13	42622013	.	C	T	4	8	12	0	2	14	0	0
13	42626622	.	C	T	0	3	3	0	0	3	0	0
13	42630536	.	C	T	0	1	1	0	1	2	0	0
13	42632966	.	A	G	3	5	8	0	0	8	0	0
13	42672885	.	T	G	1	0	1	0	0	1	0	0
13	42676262	.	T	A	1	0	1	0	0	1	0	0
13	42681759	.	G	T	8	6	14	0	0	14	0	0
13	42681856	.	T	G	5	14	19	0	0	19	0	0
13	42682033	.	T	A	12	6	18	1	2	21	0	0
13	42691482	.	G	T	2	1	3	0	0	3	0	0
13	42693030	.	G	A	3	4	7	0	0	7	0	0
13	42698930	.	A	T	0	3	3	0	0	3	0	0
13	42702811	.	T	G	3	7	10	0	0	10	0	0
13	42702835	.	T	C	2	5	7	0	0	7	0	0
13	42721011	.	G	A	3	3	6	0	0	6	0	0
13	42726708	.	A	T	1	2	3	0	0	3	0	0
13	43212657	.	A	T	0	2	2	0	1	3	0	0
13	43212772	.	T	A	0	2	2	0	0	2	0	0
13	43212814	.	T	A	1	1	2	0	0	2	0	0
13	43212816	.	A	G	1	1	2	0	0	2	0	0
13	43223679	.	G	A	13	11	24	0	1	25	0	0
13	43223722	.	T	G	11	8	19	0	0	19	0	0
13	43225093	.	C	T	6	4	10	0	2	12	0	0
13	43225201	.	T	C	11	0	11	0	16	27	0	0
13	43226423	.	T	A	17	12	29	0	0	30	1	0
13	43226429	.	C	T	1	7	8	0	18	26	0	0
13	43229872	.	A	C	13	10	23	0	2	25	0	0
13	43229923	.	G	A	15	11	26	0	1	27	0	0
13	43237237	.	T	C	6	7	13	0	0	14	1	0
13	43237255	.	A	C	5	0	5	0	6	11	0	0
13	43238513	.	C	A	9	17	26	0	1	27	0	0
13	43300346	.	C	T	2	6	8	0	0	8	0	0
13	43405371	.	A	G	1	3	4	0	0	4	0	0
13	43405396	.	T	A	1	2	3	0	0	3	0	0
13	43507468	.	T	C	2	0	2	0	6	8	0	0
13	43507470	.	A	G	2	6	8	0	0	8	0	0
13	43507520	.	A	G	6	9	15	0	1	16	0	0
13	43507541	.	A	G	9	11	20	0	2	22	0	0
13	43507711	.	A	T	6	9	15	0	0	15	0	0
13	43507747	.	A	G	4	13	17	0	0	17	0	0
13	43507797	.	A	C	5	8	13	0	0	13	0	0
13	43507889	.	G	A	15	9	24	0	4	28	0	0
13	43508696	.	A	G	8	18	26	0	2	28	0	0
13	43508868	.	G	A	13	17	30	0	0	30	0	0
13	43508986	.	A	G	11	10	21	0	0	21	0	0
13	43508987	.	T	A	11	10	21	0	0	21	0	0
13	43509386	.	G	A	16	15	31	0	1	32	0	0
13	43509443	.	A	T	15	6	21	0	0	21	0	0
13	43509537	.	A	G	14	11	25	0	1	26	0	0
13	43509600	.	T	A	14	12	26	0	0	26	0	0
13	43509609	.	G	A	12	11	23	0	0	23	0	0
13	43512915	.	T	C	1	0	1	0	0	1	0	0
13	44355466	.	C	A	0	1	1	0	0	1	0	0
13	45442952	.	C	T	1	2	3	0	1	4	0	0
13	45468567	.	A	T	17	28	45	0	0	45	0	0
13	45468827	.	G	C	7	1	8	0	10	18	0	0
13	45470601	.	A	G	21	36	57	0	5	63	1	0
13	45470764	.	T	C	33	24	57	0	1	58	0	0
13	45470831	.	G	T	23	26	49	0	0	49	0	0
13	45470865	.	G	A	25	18	43	0	1	44	0	0
13	45470867	.	C	A	26	17	43	0	1	44	0	0
13	45470982	.	C	T	11	19	30	0	1	31	0	0
13	45470983	.	A	G	10	18	28	0	3	31	0	0
13	45471048	.	A	G	9	18	27	0	0	27	0	0
13	45471052	.	A	G	9	21	30	0	0	30	0	0
13	45471201	.	T	C	22	0	22	0	25	47	0	0
13	45471243	.	G	A	18	32	50	0	1	51	0	0
13	45471367	.	A	T	30	16	46	0	2	48	0	0
13	45471615	.	A	G	33	16	49	0	3	52	0	0
13	45471624	.	T	C	32	20	52	0	2	54	0	0
13	45471888	.	C	T	1	17	18	0	19	37	0	0
13	45472124	.	T	G	7	8	15	0	0	15	0	0
13	45472793	.	T	C	42	3	45	0	29	74	0	0
13	45473011	.	G	A	39	26	65	0	1	66	0	0
13	45475204	.	T	C	31	8	39	0	1	40	0	0
13	45475208	.	A	C	32	6	38	0	1	39	0	0
13	45475241	.	A	G	21	2	23	0	1	24	0	0
13	45476400	.	C	T	10	15	25	0	0	25	0	0
13	45476731	.	A	T	2	1	3	0	2	5	0	0
13	45481475	.	G	A	14	9	23	0	3	26	0	0
13	45481792	.	A	G	2	4	6	0	0	6	0	0
13	45488209	.	A	G	5	7	12	0	0	12	0	0
13	45494573	.	C	T	15	28	43	0	0	43	0	0
13	45494757	.	G	A	20	20	40	0	4	44	0	0
13	45494769	.	C	A	17	22	39	0	2	41	0	0
13	45495189	.	G	T	1	9	10	0	20	30	0	0
13	45524500	.	T	C	12	9	21	0	1	22	0	0
13	45557259	.	G	A	0	1	1	0	6	7	0	0
13	45565646	.	G	A	0	8	8	0	4	12	0	0
13	45570300	.	A	C	12	3	15	0	1	16	0	0
13	45786228	.	T	C	1	0	1	0	5	6	0	0
13	45794407	.	C	T	0	3	3	0	7	10	0	0
13	45794475	.	C	T	3	2	5	0	0	5	0	0
13	45794488	.	G	A	1	2	3	0	0	3	0	0
13	45991772	.	T	C	23	17	40	0	4	44	0	0
13	45991801	.	C	T	18	8	26	0	1	27	0	0
13	45999530	.	G	A	0	14	14	0	18	32	0	0
13	45999723	.	C	T	15	16	31	0	3	34	0	0
13	45999879	.	C	T	7	6	13	0	13	26	0	0
13	46000060	.	G	A	0	8	8	0	2	10	0	0
13	46179682	.	C	T	23	25	48	0	2	50	0	0
13	46179689	.	G	A	24	30	54	0	1	55	0	0
13	46179806	.	T	A	25	23	48	0	3	51	0	0
13	46179814	.	A	G	25	24	49	0	4	53	0	0
13	46298763	.	C	T	4	6	10	0	1	11	0	0
13	46298775	.	T	G	4	4	8	0	1	9	0	0
13	46298843	.	G	C	5	5	10	0	0	10	0	0
13	46298871	.	T	C	1	6	7	0	0	7	0	0
13	46299503	.	C	T	4	7	11	0	1	12	0	0
13	46299909	.	C	T	0	2	2	0	6	8	0	0
13	46299968	.	C	G	0	3	3	0	4	7	0	0
13	46299989	.	A	T	2	1	3	0	1	4	0	0
13	46300247	.	A	T	6	3	9	0	1	10	0	0
13	46321988	.	C	T	0	1	1	0	0	1	0	0
13	46520899	.	T	G	4	3	7	0	0	7	0	0
13	46520985	.	G	A	4	2	6	0	1	7	0	0
13	46521542	.	C	T	0	4	4	0	2	6	0	0
13	46521633	.	G	A	10	7	17	0	0	17	0	0
13	46521664	.	C	A	7	5	12	0	0	12	0	0
13	46521974	.	A	T	0	1	1	0	0	1	0	0
13	46552414	.	G	T	1	4	5	0	0	5	0	0
13	46552429	.	G	A	1	6	7	0	0	7	0	0
13	46832214	.	T	C	16	4	20	0	1	21	0	0
13	46833895	.	T	C	4	3	7	0	0	7	0	0
13	46833902	.	T	C	3	2	5	0	0	5	0	0
13	46988414	.	C	T	6	8	14	0	1	15	0	0
13	46988445	.	C	T	3	3	6	0	1	7	0	0
13	46988457	.	C	A	0	1	1	0	1	2	0	0
13	46990974	.	C	A	0	4	4	0	9	13	0	0
13	47834276	.	C	A	1	3	4	0	0	4	0	0
13	47835127	.	A	G	5	0	5	0	10	15	0	0
13	47835137	.	A	G	6	0	6	0	8	14	0	0
13	47835598	.	A	C	3	3	6	0	0	6	0	0
13	47838024	.	G	A	3	8	11	0	0	11	0	0
13	47838650	.	G	C	4	4	8	0	2	10	0	0
13	47839071	.	C	T	2	9	11	0	2	13	0	0
13	48067223	.	C	T	0	2	2	0	0	2	0	0
13	48100564	.	C	T	0	1	1	0	0	1	0	0
13	48104890	.	A	G	2	6	8	0	0	8	0	0
13	48105417	.	T	C	8	5	13	0	1	14	0	0
13	48105447	.	C	T	8	6	14	0	1	15	0	0
13	48105520	.	C	T	3	5	8	0	0	8	0	0
13	48105627	.	T	C	4	4	8	0	0	8	0	0
13	48105669	.	C	T	0	4	4	0	3	7	0	0
13	48105953	.	T	A	2	4	6	0	0	6	0	0
13	48106177	.	C	A	2	5	7	0	0	7	0	0
13	48106535	.	G	A	5	4	9	0	0	9	0	0
13	48106547	.	C	T	2	3	5	0	0	5	0	0
13	48106903	.	T	G	3	3	6	0	0	6	0	0
13	48106943	.	A	G	4	3	7	0	0	7	0	0
13	48107224	.	A	C	6	4	10	0	0	10	0	0
13	48107292	.	C	T	2	3	5	0	0	5	0	0
13	48107293	.	C	A	2	3	5	0	0	5	0	0
13	48107560	.	A	G	3	2	5	0	0	5	0	0
13	48107706	.	G	A	9	5	14	0	0	14	0	0
13	48107890	.	A	G	3	2	5	0	0	5	0	0
13	48107927	.	A	T	3	2	5	0	0	5	0	0
13	48107947	.	C	G	4	3	7	0	0	7	0	0
13	48112752	.	G	T	2	1	3	0	0	3	0	0
13	48112756	.	T	C	2	1	3	0	0	3	0	0
13	48747857	.	T	C	3	2	5	0	1	6	0	0
13	48747876	.	T	C	1	3	4	0	1	5	0	0
13	48748722	.	A	G	4	4	8	0	0	8	0	0
13	48751921	.	A	G	2	0	2	0	1	3	0	0
13	48755035	.	A	G	1	6	7	0	0	7	0	0
13	48755122	.	T	C	0	1	1	0	0	1	0	0
13	48760071	.	G	T	1	2	3	0	0	3	0	0
13	48760101	.	T	C	1	0	1	0	2	3	0	0
13	48760119	.	A	G	2	3	5	0	0	5	0	0
13	48760177	.	C	A	2	2	4	0	0	4	0	0
13	48760180	.	T	C	2	2	4	0	0	4	0	0
13	48766270	.	C	T	3	6	9	0	0	9	0	0
13	49153904	.	T	C	3	4	7	0	0	7	0	0
13	49443868	.	T	C	17	2	19	0	26	45	0	0
13	49444210	.	C	G	20	20	40	0	1	42	1	0
13	49444446	.	C	A	23	18	41	0	2	43	0	0
13	49444517	.	G	A	26	9	35	0	0	35	0	0
13	49544833	.	C	T	14	8	22	0	0	22	0	0
13	49544873	.	T	A	13	17	30	0	0	30	0	0
13	49545039	.	A	G	4	6	10	0	0	10	0	0
13	49575322	.	A	G	1	3	4	0	0	4	0	0
13	49585301	.	T	C	15	28	43	0	1	44	0	0
13	49585341	.	T	A	13	21	34	0	2	36	0	0
13	49585344	.	A	T	11	23	34	0	1	35	0	0
13	49585384	.	T	G	4	6	10	0	1	11	0	0
13	49597294	.	T	C	6	0	6	0	9	15	0	0
13	49597306	.	T	C	9	0	9	0	5	14	0	0
13	49599521	.	G	A	1	1	2	0	0	2	0	0
13	49608858	.	G	A	1	4	5	1	0	6	0	0
13	49608981	.	C	T	3	2	5	0	0	5	0	0
13	49608990	.	C	T	2	2	4	0	1	5	0	0
13	49609241	.	C	T	1	4	5	0	1	6	0	0
13	49609268	.	C	T	4	4	8	0	1	9	0	0
13	49636194	.	C	T	1	3	4	0	1	5	0	0
13	49636198	.	C	T	0	3	3	0	2	5	0	0
13	49636240	.	C	T	2	3	5	0	0	5	0	0
13	49636259	.	C	T	0	2	2	0	2	4	0	0
13	49948426	.	G	A	4	2	6	0	0	6	0	0
13	49948499	.	T	C	2	5	7	0	0	7	0	0
13	49948502	.	T	C	2	5	7	0	0	7	0	0
13	49948820	.	G	C	2	0	2	0	2	4	0	0
13	49951965	.	G	A	1	2	3	0	0	3	0	0
13	50088646	.	A	G	1	2	3	0	0	3	0	0
13	50162280	.	T	C	2	1	3	0	0	3	0	0
13	50166759	.	T	A	1	2	3	0	1	4	0	0
13	50168735	.	C	T	1	2	3	0	0	3	0	0
13	50168744	.	T	A	1	4	5	0	0	5	0	0
13	50168991	.	T	A	2	0	2	0	0	2	0	0
13	50169004	.	C	T	2	2	4	0	0	4	0	0
13	50169193	.	G	T	3	9	12	0	1	13	0	0
13	50169618	.	A	G	4	6	10	0	0	10	0	0
13	50169649	.	C	T	2	3	5	0	0	5	0	0
13	50170055	.	C	T	4	1	5	0	1	6	0	0
13	50170092	.	G	A	1	6	7	0	1	8	0	0
13	50170142	.	A	C	2	2	4	0	0	4	0	0
13	50170147	.	C	T	2	2	4	0	0	4	0	0
13	50236437	.	C	T	0	3	3	0	1	4	0	0
13	50243381	.	C	A	1	2	3	0	0	4	1	0
13	50243387	.	A	C	3	0	3	0	0	3	0	0
13	50333038	.	T	A	0	2	2	0	0	2	0	0
13	50349058	.	T	G	1	2	3	0	0	3	0	0
13	50349099	.	G	A	4	3	7	0	0	7	0	0
13	50349475	.	A	C	9	10	19	0	1	20	0	0
13	50349532	.	G	A	10	11	21	0	4	25	0	0
13	50349586	.	C	T	6	18	24	0	0	24	0	0
13	50352535	.	G	A	1	1	2	0	0	2	0	0
13	50352538	.	T	C	3	1	4	0	0	4	0	0
13	50352780	.	G	C	5	13	18	0	1	19	0	0
13	50352964	.	T	G	8	3	11	0	0	11	0	0
13	50353171	.	A	G	5	6	11	0	2	13	0	0
13	50353192	.	A	G	5	2	7	0	0	7	0	0
13	50359690	.	G	A	1	5	6	0	0	6	0	0
13	50361983	.	G	A	6	5	11	0	0	11	0	0
13	50366708	.	C	T	6	6	12	0	0	12	0	0
13	50371951	.	A	G	9	4	13	0	0	13	0	0
13	50372903	.	C	T	5	2	7	0	0	7	0	0
13	50372985	.	G	A	0	2	2	0	5	7	0	0
13	50397388	.	G	A	2	2	4	0	0	4	0	0
13	50421749	.	C	A	0	0	0	0	3	3	0	0
13	50446532	.	G	A	1	3	4	0	0	4	0	0
13	50670846	.	A	T	4	7	11	0	0	11	0	0
13	50670911	.	G	C	5	8	13	0	0	13	0	0
13	50670959	.	C	G	0	2	2	0	1	3	0	0
13	50712066	.	G	T	2	0	2	0	0	2	0	0
13	50715527	.	G	A	4	0	4	0	0	4	0	0
13	50730670	.	C	A	0	3	3	0	1	4	0	0
13	50730724	.	C	G	2	1	3	0	0	3	0	0
13	50731324	.	C	T	3	1	4	0	2	6	0	0
13	50731336	.	G	A	2	3	5	0	1	6	0	0
13	51147038	.	G	A	4	3	7	0	1	8	0	0
13	51147152	.	G	A	8	2	10	0	0	10	0	0
13	51147164	.	A	G	4	1	5	0	1	6	0	0
13	51147736	.	G	A	2	2	4	0	1	5	0	0
13	51162561	.	A	G	2	2	4	0	0	4	0	0
13	51162579	.	T	G	5	2	7	0	0	7	0	0
13	51169874	.	C	G	6	5	11	0	0	11	0	0
13	51719661	.	G	C	1	4	5	0	0	5	0	0
13	51719871	.	T	C	5	9	14	0	1	15	0	0
13	51720057	.	T	C	9	6	15	0	0	15	0	0
13	51720142	.	A	G	9	7	16	0	1	17	0	0
13	51720240	.	T	C	14	7	21	0	1	22	0	0
13	51728165	.	G	C	2	4	6	0	0	6	0	0
13	51728227	.	G	A	10	10	20	0	0	20	0	0
13	51728597	.	A	G	9	0	9	0	6	15	0	0
13	51728902	.	A	C	9	6	15	0	1	16	0	0
13	51881311	.	C	A	2	1	3	0	0	3	0	0
13	51893754	.	A	T	5	13	18	0	1	19	0	0
13	51893777	.	A	T	7	13	20	0	1	21	0	0
13	51893830	.	G	C	6	7	13	0	1	14	0	0
13	51893891	.	G	A	3	5	8	0	0	8	0	0
13	51893902	.	T	G	4	11	15	2	4	21	0	0
13	51893981	.	C	T	0	9	9	1	14	24	0	0
13	51894215	.	A	T	20	14	34	0	6	40	0	0
13	51898991	.	C	G	2	1	3	0	0	3	0	0
13	51899138	.	C	A	0	11	11	0	14	25	0	0
13	51899707	.	C	T	7	8	15	0	0	15	0	0
13	51899727	.	G	A	4	6	10	0	0	10	0	0
13	51903034	.	A	G	3	2	5	0	0	5	0	0
13	51903040	.	A	G	3	2	5	0	0	5	0	0
13	51951038	.	T	C	1	1	2	0	2	4	0	0
13	51956414	.	T	C	1	6	7	0	1	8	0	0
13	51956418	.	G	A	2	9	11	0	0	11	0	0
13	51956482	.	C	G	5	6	11	0	0	11	0	0
13	51961978	.	C	T	9	5	14	0	0	14	0	0
13	51962752	.	G	A	0	12	12	0	9	21	0	0
13	51962754	.	G	A	0	12	12	0	9	21	0	0
13	51962802	.	G	A	9	7	16	0	0	16	0	0
13	51962822	.	G	T	8	0	8	0	0	8	0	0
13	51962892	.	C	A	9	13	22	0	2	24	0	0
13	51962961	.	C	G	8	8	16	0	0	16	0	0
13	51962993	.	T	C	1	2	3	0	1	4	0	0
13	51963383	.	C	T	4	5	9	0	0	9	0	0
13	51967165	.	G	T	2	2	4	0	1	5	0	0
13	51969126	.	A	G	3	2	5	0	0	5	0	0
13	51969219	.	A	G	1	2	3	0	0	3	0	0
13	51982730	.	A	G	2	0	2	0	2	4	0	0
13	51982742	.	A	G	4	0	4	0	8	12	0	0
13	51982853	.	C	A	5	8	13	0	2	15	0	0
13	52011349	.	T	C	1	5	6	0	0	6	0	0
13	52011379	.	A	G	1	0	1	0	9	10	0	0
13	52012027	.	G	A	0	7	7	0	4	11	0	0
13	52012029	.	A	G	3	0	3	0	8	11	0	0
13	52012902	.	G	T	2	2	4	0	0	4	0	0
13	52013066	.	A	G	2	0	2	0	2	4	0	0
13	52013625	.	A	G	0	3	3	0	0	3	0	0
13	52014156	.	A	C	6	3	9	0	1	10	0	0
13	52014359	.	A	G	2	0	2	0	2	4	0	0
13	52014364	.	T	A	2	2	4	0	0	4	0	0
13	52014856	.	G	A	3	3	6	0	0	6	0	0
13	52105010	.	T	A	3	5	8	0	2	10	0	0
13	52108464	.	C	G	1	2	3	0	0	3	0	0
13	52108574	.	A	G	2	3	5	0	0	5	0	0
13	52108661	.	C	T	1	3	4	0	0	4	0	0
13	52108666	.	T	A	1	2	3	0	0	3	0	0
13	52108748	.	T	A	2	3	5	0	0	5	0	0
14	355425	.	T	A	1	2	3	0	0	3	0	0
14	547170	.	A	G	1	3	4	0	0	4	0	0
14	548449	.	T	C	2	0	2	0	0	2	0	0
14	567500	.	C	T	1	2	3	0	0	3	0	0
14	604089	.	C	T	0	8	8	0	1	9	0	0
14	606255	.	A	G	7	3	10	0	0	10	0	0
14	616648	.	G	A	1	7	8	0	0	8	0	0
14	620200	.	C	A	1	1	2	0	0	2	0	0
14	684179	.	G	A	24	13	37	0	3	40	0	0
14	689762	.	G	A	7	6	13	0	2	15	0	0
14	689764	.	A	G	9	6	15	0	0	15	0	0
14	712170	.	T	G	1	2	3	0	0	3	0	0
14	712205	.	G	C	0	2	2	0	2	4	0	0
14	715123	.	G	C	1	2	3	0	0	3	0	0
14	715126	.	T	C	1	2	3	0	0	3	0	0
14	715201	.	C	T	0	1	1	0	0	1	0	0
14	715207	.	A	G	0	0	0	0	1	1	0	0
14	716714	.	C	T	3	2	5	0	0	5	0	0
14	717927	.	G	A	0	2	2	0	1	3	0	0
14	718194	.	A	C	1	2	3	0	0	3	0	0
14	719447	.	A	G	2	4	6	0	0	6	0	0
14	719926	.	A	G	0	4	4	0	0	4	0	0
14	723539	.	T	C	3	5	8	0	0	8	0	0
14	723542	.	T	C	3	5	8	0	0	8	0	0
14	791067	.	C	G	3	0	3	0	4	7	0	0
14	791913	.	A	T	4	1	5	0	0	5	0	0
14	792173	.	C	A	2	3	5	0	0	5	0	0
14	792499	.	C	G	5	0	5	0	6	11	0	0
14	792536	.	A	C	4	5	9	0	0	9	0	0
14	792686	.	G	A	1	3	4	0	0	4	0	0
14	863515	.	T	C	3	0	3	0	4	7	0	0
14	863767	.	A	G	7	3	10	0	0	10	0	0
14	863807	.	A	T	13	6	19	0	3	22	0	0
14	863868	.	G	T	16	12	28	0	1	29	0	0
14	863949	.	T	C	9	5	14	0	0	14	0	0
14	868838	.	G	A	1	2	3	0	0	3	0	0
14	868855	.	A	G	6	3	9	0	0	9	0	0
14	912775	.	G	A	1	2	3	0	0	3	0	0
14	937345	.	G	A	2	1	3	0	0	3	0	0
14	937849	.	A	C	1	5	6	0	0	6	0	0
14	938290	.	C	A	1	2	3	0	0	3	0	0
14	938292	.	A	G	1	2	3	0	0	3	0	0
14	938683	.	C	T	0	3	3	0	1	4	0	0
14	938688	.	T	C	1	3	4	0	0	4	0	0
14	939805	.	C	T	0	2	2	0	1	3	0	0
14	939813	.	T	C	1	2	3	0	0	3	0	0
14	941345	.	G	C	1	5	6	0	0	6	0	0
14	973379	.	C	A	1	1	2	0	0	2	0	0
14	974448	.	A	G	1	2	3	0	0	3	0	0
14	989848	.	G	T	2	3	5	0	0	5	0	0
14	994353	.	G	T	0	1	1	0	0	1	0	0
14	994413	.	C	T	1	4	5	0	0	5	0	0
14	994437	.	T	C	1	2	3	0	0	3	0	0
14	997273	.	T	A	2	4	6	0	0	6	0	0
14	997484	.	A	G	1	0	1	0	5	6	0	0
14	997603	.	T	C	1	3	4	0	0	4	0	0
14	997651	.	A	C	1	3	4	0	0	4	0	0
14	997705	.	C	A	4	5	9	0	0	9	0	0
14	997765	.	T	C	6	6	12	0	0	12	0	0
14	997783	.	A	G	7	3	10	0	0	10	0	0
14	997853	.	C	T	2	2	4	0	0	4	0	0
14	1119225	.	C	T	3	2	5	0	2	7	0	0
14	1119423	.	A	G	8	1	9	0	1	10	0	0
14	1119432	.	T	C	7	2	9	0	1	10	0	0
14	1119993	.	T	C	2	4	6	0	1	7	0	0
14	1120017	.	T	C	2	4	6	0	0	6	0	0
14	1120072	.	C	A	5	5	10	0	0	10	0	0
14	1120154	.	T	C	5	2	7	0	0	7	0	0
14	1120196	.	T	G	0	0	0	0	5	5	0	0
14	1120236	.	C	T	2	2	4	0	0	4	0	0
14	1120364	.	T	A	1	2	3	0	2	5	0	0
14	1120452	.	G	T	0	5	5	0	1	6	0	0
14	1121029	.	A	G	4	2	6	0	2	8	0	0
14	1121068	.	C	T	2	4	6	0	1	7	0	0
14	1121297	.	T	G	2	2	4	0	0	4	0	0
14	1121303	.	G	C	2	2	4	0	0	4	0	0
14	1124602	.	C	G	2	8	10	0	0	10	0	0
14	1127693	.	G	A	7	10	17	0	1	18	0	0
14	1128836	.	A	C	1	1	2	0	0	2	0	0
14	1138611	.	C	A	1	2	3	0	0	3	0	0
14	1138626	.	G	A	0	2	2	0	4	6	0	0
14	1139509	.	C	T	2	5	7	0	0	7	0	0
14	1146630	.	G	A	1	2	3	0	0	3	0	0
14	1150594	.	A	G	0	1	1	0	0	1	0	0
14	1152544	.	C	A	2	2	4	0	1	5	0	0
14	1153665	.	T	C	1	0	1	0	1	2	0	0
14	1153830	.	T	A	2	2	4	0	0	4	0	0
14	1159869	.	A	G	12	0	12	0	9	21	0	0
14	1160333	.	C	T	13	8	21	0	0	21	0	0
14	1160427	.	T	G	10	8	18	0	0	18	0	0
14	1171023	.	T	C	4	10	14	0	4	18	0	0
14	1171052	.	T	A	7	13	20	0	2	22	0	0
14	1171081	.	T	A	4	7	11	0	0	11	0	0
14	1192448	.	G	A	9	9	18	0	1	19	0	0
14	1192681	.	C	T	4	2	6	0	0	6	0	0
14	1194090	.	C	T	0	1	1	0	2	3	0	0
14	1194133	.	G	A	6	5	11	0	0	11	0	0
14	1194154	.	C	T	0	7	7	0	8	15	0	0
14	1196658	.	T	G	3	4	7	0	0	7	0	0
14	1200460	.	T	G	2	4	6	0	0	6	0	0
14	1200545	.	G	T	6	6	12	0	0	12	0	0
14	1200615	.	A	G	9	2	11	1	0	12	0	0
14	1200676	.	C	T	0	4	4	0	7	11	0	0
14	1200842	.	A	C	2	3	5	0	0	5	0	0
14	1203713	.	A	G	19	16	35	0	4	39	0	0
14	1203770	.	G	T	7	5	12	0	0	12	0	0
14	1204197	.	A	T	2	1	3	0	0	3	0	0
14	1204299	.	G	A	8	16	24	0	0	24	0	0
14	1225227	.	C	T	0	2	2	0	0	2	0	0
14	1956470	.	C	T	0	1	1	0	0	1	0	0
14	2000272	.	C	T	1	2	3	0	0	3	0	0
14	2049794	.	C	A	0	2	2	0	1	3	0	0
14	2189879	.	G	T	3	2	5	0	0	5	0	0
14	2203092	.	T	C	1	3	4	0	0	4	0	0
14	2205747	.	A	G	1	2	3	0	0	3	0	0
14	2212826	.	C	A	0	3	3	0	1	4	0	0
14	2213213	.	A	G	3	2	5	0	0	5	0	0
14	2220101	.	C	T	1	4	5	0	0	5	0	0
14	2351565	.	A	T	4	7	11	2	0	13	0	0
14	2351566	.	G	T	4	7	11	2	0	13	0	0
14	2352280	.	T	G	3	3	6	0	0	6	0	0
14	2356447	.	G	A	5	1	6	0	0	6	0	0
14	2356450	.	G	A	5	1	6	0	0	6	0	0
14	2360116	.	T	A	8	7	15	0	3	18	0	0
14	3187276	.	G	A	1	8	9	0	0	9	0	0
14	3572932	.	T	C	10	3	13	0	0	13	0	0
14	3576058	.	A	T	2	7	9	0	1	10	0	0
14	4183908	.	A	G	7	4	11	0	0	11	0	0
14	4291670	.	A	G	5	4	9	0	0	9	0	0
14	4611041	.	G	A	3	5	8	0	6	14	0	0
14	4813497	.	T	A	0	4	4	0	0	4	0	0
14	6332869	.	A	C	6	3	9	0	0	9	0	0
14	6333022	.	T	C	4	5	9	0	0	9	0	0
14	6341993	.	C	T	3	3	6	0	0	6	0	0
14	6342088	.	G	A	4	4	8	0	0	8	0	0
14	6342102	.	A	G	5	3	8	0	0	8	0	0
14	6342165	.	C	T	0	2	2	0	2	4	0	0
14	6342201	.	T	C	2	3	5	0	1	6	0	0
14	6607673	.	A	C	0	0	0	0	7	7	0	0
14	6625002	.	A	C	5	10	15	6	4	25	0	0
14	6625521	.	G	C	17	35	52	0	4	56	0	0
14	7916066	.	A	G	4	1	5	0	0	5	0	0
14	8496257	.	A	G	1	3	4	1	1	6	0	0
14	8569681	.	A	G	2	2	4	0	0	4	0	0
14	8572095	.	A	G	14	4	18	0	0	18	0	0
14	8572528	.	A	T	0	4	4	0	1	5	0	0
14	9595330	.	T	C	7	14	21	0	0	21	0	0
14	9595520	.	T	C	9	6	15	0	2	17	0	0
14	9595524	.	T	C	6	8	14	0	2	16	0	0
14	10339746	.	T	C	5	11	16	0	1	17	0	0
14	11266530	.	A	T	7	2	9	0	0	9	0	0
14	12486275	.	G	T	7	3	10	0	0	10	0	0
14	13354594	.	G	A	0	7	7	1	0	8	0	0
14	14594938	.	A	G	4	2	6	0	1	7	0	0
14	14594950	.	A	G	1	4	5	0	2	7	0	0
14	15663175	.	T	C	2	3	5	0	0	5	0	0
14	15972418	.	T	G	2	3	5	0	0	5	0	0
14	15972419	.	A	T	2	1	3	0	2	5	0	0
14	15972660	.	C	G	5	8	13	0	1	14	0	0
14	15972666	.	G	A	5	8	13	0	1	14	0	0
14	15973919	.	A	G	4	5	9	1	0	10	0	0
14	15974065	.	C	A	4	2	6	0	0	6	0	0
14	15974069	.	A	T	3	2	5	0	1	6	0	0
14	15974370	.	T	C	2	2	4	0	0	4	0	0
14	15974448	.	A	G	3	2	5	0	0	5	0	0
14	15974508	.	A	G	1	3	4	0	0	4	0	0
14	15974580	.	A	G	2	2	4	0	0	4	0	0
14	15983585	.	T	C	2	2	4	0	0	4	0	0
14	15983590	.	T	C	2	3	5	0	0	5	0	0
14	15983622	.	T	C	3	0	3	0	3	6	0	0
14	16042530	.	C	A	6	5	11	0	0	11	0	0
14	16044274	.	A	C	5	4	9	0	0	9	0	0
14	16044638	.	G	A	0	4	4	0	5	9	0	0
14	16069264	.	A	C	1	4	5	0	0	5	0	0
14	16069354	.	C	T	3	6	9	0	0	9	0	0
14	16069404	.	G	A	1	3	4	0	0	4	0	0
14	16069405	.	A	G	1	3	4	0	0	4	0	0
14	16072889	.	G	C	1	0	1	0	0	1	0	0
14	16082571	.	G	A	7	2	9	0	2	11	0	0
14	16084339	.	C	T	6	6	12	0	1	13	0	0
14	16090764	.	T	C	5	11	16	0	0	16	0	0
14	16090800	.	T	A	2	12	14	0	0	14	0	0
14	16090828	.	A	T	4	12	16	0	0	16	0	0
14	16090897	.	C	T	5	11	16	0	0	16	0	0
14	16090939	.	A	C	4	11	15	0	0	15	0	0
14	16091563	.	C	T	6	9	15	0	2	17	0	0
14	16091586	.	T	A	8	6	14	0	0	14	0	0
14	16091709	.	T	G	6	7	13	0	0	13	0	0
14	16093926	.	G	T	0	3	3	0	2	5	0	0
14	16093983	.	G	A	24	12	36	0	2	38	0	0
14	16095683	.	A	G	12	5	17	0	0	17	0	0
14	16097204	.	T	A	2	2	4	0	0	4	0	0
14	16115278	.	G	A	17	5	22	0	0	22	0	0
14	16115353	.	A	G	1	0	1	0	0	1	0	0
14	16122866	.	T	C	23	13	36	0	3	39	0	0
14	16122962	.	G	A	19	20	39	0	1	40	0	0
14	16123055	.	G	C	1	20	21	0	20	41	0	0
14	16127308	.	C	T	1	0	1	0	0	1	0	0
14	16130167	.	C	G	0	1	1	0	0	1	0	0
14	16132423	.	T	G	1	1	2	0	0	2	0	0
14	16145112	.	T	A	4	3	7	0	0	7	0	0
14	16203904	.	A	T	5	2	7	0	2	9	0	0
14	16288166	.	A	C	8	6	14	0	1	15	0	0
14	16288236	.	T	G	1	1	2	0	0	2	0	0
14	16296383	.	A	G	4	0	4	0	5	9	0	0
14	16433098	.	A	T	8	20	28	0	1	29	0	0
14	16433473	.	C	A	1	23	24	0	15	39	0	0
14	16433496	.	A	G	15	16	31	0	0	31	0	0
14	16433623	.	T	G	17	4	21	1	2	24	0	0
14	16433943	.	C	T	0	13	13	0	11	24	0	0
14	16434131	.	G	C	24	15	39	0	0	39	0	0
14	16434179	.	T	C	23	19	42	0	2	44	0	0
14	16434474	.	T	C	13	1	14	0	7	21	0	0
14	16434791	.	A	G	14	14	28	0	2	30	0	0
14	16434981	.	T	C	26	1	27	0	31	58	0	0
14	16434990	.	T	A	23	18	41	0	19	60	0	0
14	16448208	.	A	T	13	14	27	0	3	30	0	0
14	16456712	.	C	T	6	7	13	0	0	13	0	0
14	16484069	.	C	T	8	4	12	0	0	12	0	0
14	16484558	.	A	T	4	5	9	0	0	9	0	0
14	16484633	.	G	T	4	3	7	0	0	7	0	0
14	16484713	.	A	G	5	3	8	0	0	8	0	0
14	16485222	.	C	T	0	8	8	0	5	13	0	0
14	16606655	.	C	T	0	8	8	0	4	12	0	0
14	16618118	.	G	A	5	7	12	0	0	12	0	0
14	16754120	.	C	A	3	5	8	0	0	8	0	0
14	16754192	.	A	C	2	4	6	0	1	7	0	0
14	16754243	.	G	A	3	4	7	0	1	8	0	0
14	16766053	.	C	T	5	4	9	0	2	11	0	0
14	16769067	.	A	G	10	16	26	0	2	28	0	0
14	16769109	.	T	C	12	15	27	0	0	27	0	0
14	16769189	.	C	T	12	21	33	0	0	33	0	0
14	16769246	.	C	T	14	12	26	0	2	28	0	0
14	16769515	.	G	A	14	9	23	0	1	24	0	0
14	16769550	.	A	G	2	0	2	0	4	6	0	0
14	16770260	.	C	T	11	6	17	0	0	17	0	0
14	16770338	.	T	A	9	6	15	0	2	17	0	0
14	16770646	.	C	A	8	12	20	0	1	21	0	0
14	16770847	.	C	T	14	13	27	0	0	27	0	0
14	16770989	.	A	G	12	0	12	0	6	18	0	0
14	16771137	.	G	T	5	4	9	0	0	9	0	0
14	16771194	.	A	T	3	4	7	0	0	7	0	0
14	16771265	.	A	T	12	11	23	0	0	23	0	0
14	16777673	.	T	C	6	0	6	0	4	10	0	0
14	16777677	.	A	C	6	4	10	0	0	10	0	0
14	16777708	.	T	C	3	4	7	0	0	7	0	0
14	16778080	.	C	T	0	2	2	0	5	7	0	0
14	16790722	.	A	T	0	3	3	0	0	3	0	0
14	16801732	.	C	A	0	2	2	0	1	3	0	0
14	16801807	.	C	T	1	2	3	0	1	4	0	0
14	16801813	.	A	T	1	3	4	0	0	4	0	0
14	16810405	.	G	T	2	4	6	0	0	6	0	0
14	16810410	.	T	C	2	4	6	0	0	6	0	0
14	16813863	.	G	A	8	6	14	0	1	15	0	0
14	16949354	.	A	G	1	0	1	0	3	4	0	0
14	16949357	.	C	T	2	2	4	0	0	4	0	0
14	16968227	.	T	C	1	3	4	0	1	5	0	0
14	16968260	.	C	T	2	5	7	0	0	7	0	0
14	16996870	.	G	A	1	4	5	0	1	6	0	0
14	16996916	.	G	A	10	7	17	0	0	17	0	0
14	16997008	.	G	A	1	2	3	0	0	3	0	0
14	17003570	.	G	A	0	2	2	0	0	2	0	0
14	17003771	.	C	A	0	1	1	0	0	1	0	0
14	17025080	.	A	G	7	0	7	0	6	13	0	0
14	17025109	.	A	T	12	11	23	0	0	23	0	0
14	17025151	.	T	A	11	11	22	0	2	24	0	0
14	17025200	.	G	A	8	8	16	0	1	17	0	0
14	17025215	.	T	C	3	8	11	0	1	13	1	0
14	17025521	.	C	A	7	9	16	0	0	16	0	0
14	17025524	.	T	A	6	10	16	0	1	17	0	0
14	17025574	.	A	G	6	12	18	0	0	18	0	0
14	17025579	.	A	G	7	9	16	0	1	17	0	0
14	17025751	.	T	A	3	5	8	0	0	8	0	0
14	17025752	.	T	C	3	5	8	0	0	8	0	0
14	17025807	.	T	C	6	4	10	0	1	11	0	0
14	17025819	.	C	T	5	6	11	0	0	11	0	0
14	17025849	.	A	G	7	10	17	0	0	17	0	0
14	17026100	.	T	A	7	6	13	0	1	14	0	0
14	17026488	.	G	A	5	6	11	0	0	11	0	0
14	17026572	.	T	G	11	11	22	0	1	23	0	0
14	17026724	.	T	C	11	15	26	0	0	26	0	0
14	17026881	.	G	T	7	6	13	0	0	13	0	0
14	17027207	.	G	A	3	7	10	0	0	11	1	0
14	17088611	.	A	C	1	0	1	0	2	3	0	0
14	17197240	.	A	C	0	1	1	0	1	2	0	0
14	17199990	.	A	G	24	22	46	0	0	46	0	0
14	17200351	.	A	T	11	4	15	0	1	16	0	0
14	17200407	.	C	A	12	6	18	0	0	18	0	0
14	17200653	.	A	C	12	12	24	0	1	25	0	0
14	17230601	.	A	G	1	7	8	0	0	8	0	0
14	17233598	.	C	A	8	11	19	0	0	19	0	0
14	17240587	.	A	G	2	1	3	0	0	3	0	0
14	17266010	.	C	T	0	10	10	0	7	17	0	0
14	17275648	.	G	A	5	5	10	0	0	10	0	0
14	17275708	.	C	G	4	6	10	0	0	10	0	0
14	17278972	.	C	T	4	7	11	0	0	11	0	0
14	17279005	.	T	C	1	1	2	0	0	2	0	0
14	17279197	.	G	A	0	2	2	0	0	2	0	0
14	17279305	.	T	C	5	7	12	0	1	13	0	0
14	17281761	.	A	G	7	7	14	0	0	14	0	0
14	17282061	.	C	T	5	5	10	0	1	11	0	0
14	17282095	.	C	G	4	7	11	0	0	11	0	0
14	17282100	.	C	T	0	5	5	0	5	10	0	0
14	17282139	.	C	T	1	3	4	0	0	4	0	0
14	17305587	.	G	A	3	4	7	0	0	7	0	0
14	17305604	.	G	A	4	6	10	0	0	10	0	0
14	17332911	.	G	A	1	2	3	0	0	3	0	0
14	17349306	.	C	T	5	3	8	0	2	10	0	0
14	17349307	.	C	T	5	2	7	0	3	10	0	0
14	17349409	.	C	T	6	3	9	0	0	9	0	0
14	17349420	.	G	A	4	4	8	0	1	9	0	0
14	17349444	.	T	G	7	4	11	0	0	12	1	0
14	17349639	.	T	C	4	2	6	0	0	6	0	0
14	17349931	.	T	C	4	2	6	0	0	6	0	0
14	17350230	.	C	G	2	3	5	0	0	5	0	0
14	17443283	.	C	T	1	2	3	0	1	4	0	0
14	17567851	.	C	T	4	3	7	0	0	7	0	0
14	17567968	.	T	A	4	3	7	0	1	8	0	0
14	17568099	.	A	G	5	8	13	0	1	14	0	0
14	17572743	.	T	C	1	2	3	0	0	3	0	0
14	17575548	.	A	G	0	1	1	0	0	1	0	0
14	17575607	.	G	T	2	6	8	0	0	8	0	0
14	17575868	.	G	A	2	3	5	0	0	5	0	0
14	17575877	.	G	A	2	1	3	0	0	3	0	0
14	17575918	.	A	G	2	2	4	0	0	4	0	0
14	17580685	.	G	A	12	19	31	0	1	32	0	0
14	17580922	.	C	A	25	22	47	0	0	47	0	0
14	17581084	.	A	T	27	20	47	0	0	47	0	0
14	17581214	.	A	T	31	19	50	0	2	52	0	0
14	17586693	.	G	A	1	4	5	0	0	5	0	0
14	17588131	.	G	T	9	13	22	0	1	23	0	0
14	17593429	.	T	C	1	11	12	0	0	12	0	0
14	17593444	.	G	T	1	12	13	0	0	13	0	0
14	17593490	.	A	G	2	11	13	0	0	13	0	0
14	17593554	.	A	T	5	3	8	0	0	8	0	0
14	17593610	.	A	G	4	6	10	0	0	10	0	0
14	17593720	.	C	T	8	9	17	0	3	20	0	0
14	17593767	.	A	T	7	17	24	0	1	25	0	0
14	17593783	.	T	A	10	16	26	0	0	26	0	0
14	17593823	.	A	T	10	17	27	0	0	27	0	0
14	17593992	.	T	A	11	8	19	0	0	19	0	0
14	17594137	.	G	A	2	3	5	0	1	6	0	0
14	17594527	.	A	G	4	7	11	0	1	12	0	0
14	17595121	.	G	A	4	5	9	0	2	11	0	0
14	17595156	.	A	C	6	0	6	0	5	11	0	0
14	17595192	.	A	T	2	2	4	0	0	4	0	0
14	17595460	.	T	A	4	8	12	0	1	13	0	0
14	17595539	.	T	C	9	10	19	0	1	20	0	0
14	17596070	.	G	T	2	5	7	0	1	8	0	0
14	17596597	.	G	A	4	10	14	0	0	14	0	0
14	18667852	.	T	C	13	18	31	0	0	31	0	0
14	18668731	.	A	G	5	4	9	0	0	9	0	0
14	18669481	.	C	A	13	18	31	0	3	34	0	0
14	18670446	.	C	T	15	12	27	0	1	28	0	0
14	18670582	.	T	A	6	15	21	0	4	25	0	0
14	18670665	.	A	G	9	11	20	0	0	20	0	0
14	18671011	.	A	T	8	8	16	0	0	16	0	0
14	18672491	.	C	T	14	9	23	0	1	24	0	0
14	20190945	.	A	C	0	3	3	0	3	6	0	0
14	20729908	.	A	G	2	3	5	0	0	5	0	0
14	21757206	.	C	T	3	4	7	0	0	7	0	0
14	21761334	.	T	C	0	1	1	0	0	1	0	0
14	21766410	.	C	T	0	1	1	0	0	1	0	0
14	21766428	.	A	G	0	1	1	0	0	1	0	0
14	21768233	.	A	G	2	4	6	0	1	7	0	0
14	21768244	.	G	A	0	4	4	0	5	9	0	0
14	21768418	.	G	A	1	2	3	0	0	3	0	0
14	21770666	.	C	G	6	5	11	0	0	11	0	0
14	21770708	.	A	G	1	0	1	0	4	5	0	0
14	21772267	.	T	C	7	6	13	0	0	13	0	0
14	21772385	.	T	C	6	9	15	0	1	16	0	0
14	21772412	.	C	T	5	6	11	0	1	12	0	0
14	21772459	.	T	C	7	10	17	0	0	17	0	0
14	21772466	.	T	C	7	10	17	0	0	17	0	0
14	21772553	.	C	T	9	10	19	0	0	19	0	0
14	21772594	.	A	G	6	8	14	0	2	16	0	0
14	21772663	.	G	C	8	6	14	0	1	15	0	0
14	21779102	.	C	T	14	6	20	0	0	20	0	0
14	21779142	.	A	C	9	0	9	0	5	14	0	0
14	21779241	.	G	A	11	10	21	0	0	21	0	0
14	21779300	.	T	G	18	8	26	0	1	27	0	0
14	21779518	.	C	T	7	6	13	0	0	13	0	0
14	21779617	.	T	C	2	2	4	0	0	4	0	0
14	21780125	.	A	G	2	6	8	0	0	8	0	0
14	21780155	.	C	G	7	7	14	0	1	15	0	0
14	21780206	.	A	G	3	14	17	0	1	18	0	0
14	21780274	.	A	C	11	10	21	0	0	21	0	0
14	21780321	.	T	C	6	6	12	0	0	12	0	0
14	21783361	.	T	G	5	6	11	0	0	11	0	0
14	21797819	.	T	C	1	2	3	0	0	3	0	0
14	21816373	.	C	T	27	11	38	0	1	39	0	0
14	21816388	.	T	C	24	10	34	0	0	34	0	0
14	21816467	.	G	A	8	6	14	0	2	16	0	0
14	21834912	.	C	T	2	4	6	0	1	7	0	0
14	21840858	.	A	G	1	0	1	0	6	7	0	0
14	21842735	.	A	C	14	22	36	0	3	39	0	0
14	21843297	.	G	C	7	14	21	0	5	26	0	0
14	21843858	.	A	T	17	14	31	0	3	34	0	0
14	21844187	.	T	A	13	12	25	0	1	26	0	0
14	21844486	.	C	T	4	10	14	0	0	14	0	0
14	21844668	.	A	C	13	5	18	0	3	21	0	0
14	21844679	.	T	A	14	6	20	0	1	21	0	0
14	21845129	.	T	A	6	26	32	0	1	33	0	0
14	21845363	.	A	G	15	0	15	0	20	35	0	0
14	21845822	.	A	C	15	6	21	0	1	22	0	0
14	21924299	.	A	G	1	4	5	0	0	5	0	0
14	21924501	.	T	C	0	0	0	0	2	2	0	0
14	21924547	.	G	A	1	3	4	0	0	4	0	0
14	21928788	.	C	A	0	1	1	0	0	1	0	0
14	21931388	.	G	A	1	1	2	0	0	2	0	0
14	21980871	.	C	A	1	2	3	0	0	3	0	0
14	21987518	.	C	T	1	4	5	0	0	5	0	0
14	21999213	.	A	G	1	0	1	0	0	1	0	0
14	22000647	.	T	C	0	1	1	0	0	1	0	0
14	22102298	.	C	G	4	2	6	0	0	6	0	0
14	22102300	.	G	A	4	2	6	0	0	6	0	0
14	22102371	.	A	G	8	5	13	0	1	14	0	0
14	22102381	.	A	G	12	7	19	0	0	19	0	0
14	22104906	.	T	C	2	3	5	0	0	5	0	0
14	22104948	.	G	A	1	1	2	0	0	2	0	0
14	22106222	.	C	G	2	3	5	0	0	5	0	0
14	22106230	.	A	T	2	3	5	0	0	5	0	0
14	22108215	.	C	T	5	9	14	0	0	14	0	0
14	22108368	.	A	T	4	3	7	0	0	7	0	0
14	22108373	.	G	A	4	3	7	0	1	8	0	0
14	22132473	.	T	C	16	16	32	0	0	32	0	0
14	22132536	.	A	T	2	3	5	0	1	6	0	0
14	22139153	.	G	A	2	1	3	0	0	3	0	0
14	22139254	.	G	A	28	27	55	0	4	59	0	0
14	22139358	.	G	A	18	35	53	0	2	55	0	0
14	22139398	.	T	A	33	22	55	0	2	57	0	0
14	22139668	.	G	A	1	29	30	0	19	49	0	0
14	22140150	.	G	A	6	7	13	0	1	14	0	0
14	22140158	.	T	C	5	6	11	0	1	12	0	0
14	22140417	.	T	C	4	7	11	0	2	13	0	0
14	22151875	.	G	A	10	11	21	0	0	21	0	0
14	22151879	.	C	T	0	11	11	0	10	21	0	0
14	22151913	.	C	T	17	11	28	0	2	30	0	0
14	22172138	.	C	T	14	15	29	0	0	29	0	0
14	22249344	.	G	A	7	6	13	0	0	13	0	0
14	22254184	.	T	C	10	13	23	0	1	24	0	0
14	22272120	.	A	G	25	1	26	0	23	49	0	0
14	22272340	.	G	A	24	19	43	0	1	44	0	0
14	22272351	.	G	A	24	22	46	0	0	46	0	0
14	22272749	.	A	G	21	0	21	0	14	35	0	0
14	22478426	.	T	C	1	3	4	0	1	5	0	0
14	23187210	.	C	T	1	1	2	0	0	2	0	0
14	23405034	.	G	A	1	6	7	0	1	8	0	0
14	23411712	.	G	T	0	0	0	0	3	3	0	0
14	23455989	.	G	A	6	7	13	0	0	13	0	0
14	23463681	.	G	A	0	4	4	0	0	4	0	0
14	23463708	.	A	G	1	4	5	0	1	6	0	0
14	23463717	.	A	G	1	0	1	0	5	6	0	0
14	23463760	.	C	A	0	1	1	0	0	1	0	0
14	23599933	.	A	G	1	1	2	0	0	2	0	0
14	23609772	.	C	T	1	5	6	0	0	6	0	0
14	23613274	.	G	T	3	2	5	0	0	5	0	0
14	23615471	.	C	T	4	4	8	0	0	8	0	0
14	23615480	.	G	A	5	3	8	0	1	9	0	0
14	23622190	.	C	T	3	4	7	0	0	7	0	0
14	23653096	.	T	C	2	3	5	0	0	5	0	0
14	23657531	.	G	A	0	5	5	0	2	7	0	0
14	23663911	.	G	C	2	6	8	0	0	8	0	0
14	23664063	.	T	G	1	2	3	0	0	3	0	0
14	23666002	.	C	T	10	6	16	0	0	16	0	0
14	23666227	.	G	A	0	9	9	0	13	22	0	0
14	23666326	.	C	T	7	11	18	0	1	19	0	0
14	23666491	.	G	A	0	2	2	0	1	3	0	0
14	23673373	.	G	A	0	2	2	0	3	5	0	0
14	23673499	.	A	G	8	6	14	0	0	14	0	0
14	23673514	.	G	A	2	6	8	0	3	11	0	0
14	23679170	.	C	T	0	2	2	0	0	2	0	0
14	23679205	.	C	T	0	2	2	0	0	2	0	0
14	23679369	.	T	C	6	0	6	0	4	10	0	0
14	23679375	.	T	A	6	3	9	0	1	10	0	0
14	23679411	.	C	A	6	4	10	0	0	10	0	0
14	23679564	.	T	C	5	4	9	0	0	9	0	0
14	23679592	.	T	C	4	2	6	0	0	6	0	0
14	23679671	.	G	A	4	2	6	0	0	6	0	0
14	23679674	.	T	G	4	1	5	0	0	5	0	0
14	23680405	.	T	C	2	0	2	0	1	3	0	0
14	23684582	.	G	C	1	2	3	0	0	3	0	0
14	23687872	.	G	C	10	9	19	0	0	19	0	0
14	23693720	.	G	T	4	8	12	0	0	12	0	0
14	23693914	.	T	C	7	3	10	0	0	10	0	0
14	23696893	.	A	T	4	0	4	0	0	4	0	0
14	23700121	.	T	C	21	17	38	0	2	40	0	0
14	23700142	.	G	T	21	17	38	0	1	39	0	0
14	23702323	.	G	A	0	7	7	0	2	9	0	0
14	23702703	.	G	A	3	3	6	0	0	6	0	0
14	23704771	.	G	C	0	4	4	0	13	17	0	0
14	23707976	.	A	G	10	10	20	0	2	22	0	0
14	23713595	.	G	T	1	3	4	0	0	4	0	0
14	23717277	.	A	T	20	20	40	0	1	41	0	0
14	23717289	.	A	T	20	17	37	0	2	39	0	0
14	23720196	.	A	T	5	4	9	0	1	10	0	0
14	23722030	.	C	T	5	3	8	0	0	8	0	0
14	23726393	.	C	A	37	21	58	0	2	60	0	0
14	23726413	.	G	A	35	28	63	0	0	63	0	0
14	23726547	.	C	T	25	20	45	0	2	47	0	0
14	23732056	.	C	A	4	10	14	0	0	14	0	0
14	23732117	.	T	C	5	11	16	0	0	16	0	0
14	23732134	.	C	T	4	13	17	0	0	17	0	0
14	23732167	.	C	A	3	12	15	0	1	16	0	0
14	23732368	.	C	A	0	14	14	0	11	25	0	0
14	23732396	.	A	G	8	14	22	0	1	23	0	0
14	23732444	.	G	T	8	16	24	0	0	24	0	0
14	23732497	.	C	A	10	14	24	0	2	26	0	0
14	23732508	.	C	T	12	13	25	0	0	25	0	0
14	23732547	.	T	A	7	5	12	0	1	13	0	0
14	23732691	.	G	T	3	10	13	0	0	13	0	0
14	23732718	.	A	G	5	8	13	0	0	13	0	0
14	23732745	.	C	G	3	8	11	0	0	11	0	0
14	23732824	.	T	A	4	1	5	0	1	6	0	0
14	23732849	.	A	G	2	2	4	0	0	4	0	0
14	23732916	.	C	T	2	6	8	0	0	8	0	0
14	23732924	.	A	T	3	5	8	0	0	8	0	0
14	23733097	.	A	G	5	11	16	0	0	16	0	0
14	23733220	.	G	A	7	12	19	0	3	22	0	0
14	23747360	.	T	A	23	12	35	0	1	36	0	0
14	23748654	.	A	G	17	14	31	0	1	32	0	0
14	23752335	.	C	T	3	4	7	0	1	8	0	0
14	23756410	.	G	A	4	5	9	0	1	10	0	0
14	23756637	.	A	G	5	4	9	0	1	10	0	0
14	23756680	.	A	G	7	8	15	0	0	15	0	0
14	23756716	.	T	A	9	13	22	0	1	23	0	0
14	23756752	.	T	G	9	14	23	0	3	26	0	0
14	23756809	.	G	T	7	17	24	0	2	26	0	0
14	23799271	.	G	T	6	5	11	0	1	12	0	0
14	23799293	.	T	C	8	5	13	0	0	13	0	0
14	23799344	.	G	T	1	1	2	0	0	2	0	0
14	23801145	.	C	A	0	5	5	0	12	17	0	0
14	23801159	.	C	A	0	5	5	0	13	18	0	0
14	23801249	.	G	A	7	6	13	0	0	13	0	0
14	23947586	.	A	G	2	1	3	0	0	3	0	0
14	23947690	.	A	G	0	3	3	0	1	4	0	0
14	23967128	.	T	A	1	5	6	0	1	7	0	0
14	23967226	.	C	T	1	2	3	0	0	3	0	0
14	23967772	.	G	A	3	3	6	0	0	6	0	0
14	23967981	.	T	G	6	3	9	0	1	10	0	0
14	23968467	.	G	C	1	4	5	0	0	5	0	0
14	23968517	.	G	C	2	5	7	0	0	7	0	0
14	23968564	.	T	A	3	2	5	0	1	6	0	0
14	23968657	.	C	A	4	6	10	0	0	10	0	0
14	23968720	.	G	A	12	5	17	0	0	17	0	0
14	23969152	.	G	A	6	1	7	0	2	9	0	0
14	23969154	.	T	C	6	3	9	0	0	9	0	0
14	23969443	.	G	C	4	3	7	0	0	7	0	0
14	23969518	.	T	C	6	2	8	0	1	9	0	0
14	23972351	.	C	T	6	1	7	0	0	7	0	0
14	23972572	.	G	A	3	6	9	0	2	11	0	0
14	23972587	.	C	T	2	4	6	0	0	6	0	0
14	23982623	.	A	T	8	7	15	0	2	17	0	0
14	23991507	.	C	T	7	4	11	0	0	11	0	0
14	23993952	.	A	G	17	14	31	0	0	31	0	0
14	23998961	.	C	A	21	12	33	0	1	34	0	0
14	23999021	.	C	T	17	25	42	0	2	44	0	0
14	23999112	.	A	G	20	21	41	0	1	42	0	0
14	23999315	.	A	G	13	12	25	0	0	25	0	0
14	23999459	.	A	C	6	11	17	0	1	18	0	0
14	24094894	.	G	A	1	0	1	0	0	1	0	0
14	24097686	.	A	G	13	16	29	0	0	29	0	0
14	24097734	.	G	A	15	13	28	0	0	28	0	0
14	24098191	.	T	C	3	0	3	0	8	11	0	0
14	24098470	.	C	G	5	8	13	0	0	13	0	0
14	24098648	.	G	A	12	9	21	0	3	24	0	0
14	24098694	.	G	T	21	9	30	0	1	31	0	0
14	24099059	.	A	T	8	17	25	0	0	25	0	0
14	24099240	.	C	A	7	9	16	0	1	17	0	0
14	24109706	.	T	G	12	9	21	0	2	23	0	0
14	24220467	.	A	G	20	0	20	0	20	40	0	0
14	24220959	.	A	T	14	8	22	0	1	23	0	0
14	24221099	.	C	A	6	3	9	1	1	11	0	0
14	24221104	.	C	A	6	2	8	0	1	9	0	0
14	24221194	.	T	A	15	12	27	0	2	29	0	0
14	24248398	.	C	A	6	3	9	0	0	9	0	0
14	24268332	.	A	C	6	0	6	0	11	18	1	0
14	24268403	.	G	A	4	8	12	0	0	12	0	0
14	24268676	.	A	T	11	12	23	0	0	23	0	0
14	24268781	.	G	A	6	12	18	0	1	19	0	0
14	24274575	.	C	T	1	0	1	0	1	2	0	0
14	24278144	.	C	G	36	10	46	0	0	47	1	0
14	24278162	.	C	G	34	8	42	0	2	44	0	0
14	24278234	.	A	G	19	11	30	0	1	31	0	0
14	24278831	.	T	C	21	20	41	0	0	41	0	0
14	24279011	.	A	C	16	17	33	0	0	33	0	0
14	24279305	.	A	T	7	7	14	0	0	14	0	0
14	24279326	.	A	C	11	8	19	0	1	20	0	0
14	24279383	.	T	A	11	11	22	0	0	22	0	0
14	24279429	.	T	C	12	14	26	0	0	26	0	0
14	24279459	.	C	G	16	13	29	0	0	29	0	0
14	24279551	.	A	G	19	0	19	0	14	33	0	0
14	24279682	.	T	C	16	11	27	0	1	28	0	0
14	24280452	.	T	C	19	6	25	0	0	25	0	0
14	24280517	.	A	C	8	17	25	0	1	26	0	0
14	24280904	.	T	G	8	23	31	0	1	32	0	0
14	24280975	.	A	G	15	12	27	0	1	28	0	0
14	24281118	.	T	A	12	12	24	0	2	26	0	0
14	24281149	.	A	C	6	5	11	0	2	13	0	0
14	24281292	.	T	C	1	0	1	0	0	1	0	0
14	24283536	.	C	T	3	7	10	0	0	10	0	0
14	24283609	.	G	A	15	10	25	0	0	25	0	0
14	24284089	.	T	C	5	5	10	0	0	10	0	0
14	24288525	.	T	A	0	1	1	0	0	1	0	0
14	24301750	.	G	T	9	4	13	0	1	14	0	0
14	24301779	.	T	G	8	3	11	0	1	12	0	0
14	24301946	.	C	A	3	9	12	0	0	12	0	0
14	24302052	.	T	C	6	4	10	0	0	10	0	0
14	24302157	.	G	T	1	4	5	0	0	5	0	0
14	24302236	.	A	C	2	7	9	0	0	9	0	0
14	24302310	.	A	C	5	4	9	0	0	9	0	0
14	24302363	.	T	A	6	3	9	0	1	10	0	0
14	24302428	.	T	C	3	3	6	0	0	6	0	0
14	24302439	.	G	A	3	3	6	0	0	6	0	0
14	24302560	.	G	A	8	6	14	0	0	14	0	0
14	24302766	.	T	G	5	3	8	0	0	8	0	0
14	24302770	.	G	T	0	3	3	0	5	8	0	0
14	24302825	.	T	C	4	5	9	0	0	9	0	0
14	24303104	.	G	C	3	7	10	0	0	10	0	0
14	24303205	.	T	A	3	2	5	0	0	5	0	0
14	24303217	.	G	A	4	2	6	0	0	6	0	0
14	24303465	.	G	T	0	8	8	0	8	16	0	0
14	24303504	.	C	T	8	11	19	0	2	21	0	0
14	24303523	.	G	T	8	10	18	0	2	20	0	0
14	24303660	.	T	C	7	6	13	0	0	13	0	0
14	24303665	.	C	A	7	6	13	0	0	13	0	0
14	24303767	.	C	G	6	4	10	0	0	10	0	0
14	24303873	.	C	A	1	6	7	0	0	7	0	0
14	24304271	.	T	A	11	8	19	0	3	22	0	0
14	24304276	.	G	A	11	11	22	0	1	23	0	0
14	24304309	.	G	A	9	12	21	0	1	23	1	0
14	24304518	.	T	C	11	5	16	0	0	16	0	0
14	24304591	.	T	A	13	8	21	0	0	21	0	0
14	24304823	.	A	G	4	5	9	0	0	9	0	0
14	24317226	.	G	A	19	33	52	0	2	54	0	0
14	24317266	.	A	T	18	37	55	0	5	60	0	0
14	24317272	.	G	A	20	38	58	0	2	60	0	0
14	24317316	.	C	T	33	28	61	0	5	66	0	0
14	24317508	.	T	C	26	33	59	0	1	61	1	0
14	24317576	.	A	G	22	28	50	0	4	54	0	0
14	24317751	.	C	A	0	34	34	0	15	49	0	0
14	24318041	.	A	T	25	19	44	0	2	46	0	0
14	24318087	.	A	T	23	21	44	0	2	46	0	0
14	24318479	.	A	T	23	25	48	0	0	48	0	0
14	24318685	.	G	A	15	16	31	0	2	33	0	0
14	24318723	.	T	C	22	15	37	0	0	37	0	0
14	24318726	.	T	C	22	3	25	0	12	37	0	0
14	24318868	.	T	C	22	27	49	0	3	52	0	0
14	24325537	.	T	C	5	9	14	0	0	14	0	0
14	24326696	.	G	C	1	2	3	0	0	3	0	0
14	24326742	.	T	C	3	2	5	0	2	7	0	0
14	24326937	.	G	A	5	2	7	0	0	7	0	0
14	24327917	.	G	A	10	13	23	0	2	25	0	0
14	24328142	.	T	C	9	20	29	0	0	29	0	0
14	24328303	.	T	C	0	0	0	0	3	3	0	0
14	24332141	.	G	T	1	0	1	0	0	1	0	0
14	24332817	.	A	T	9	12	21	0	0	21	0	0
14	24333761	.	A	G	7	8	15	0	0	15	0	0
14	24369557	.	G	A	3	4	7	0	0	7	0	0
14	24391361	.	A	G	15	11	26	0	0	26	0	0
14	24406609	.	C	G	0	4	4	0	8	12	0	0
14	24409293	.	C	A	0	4	4	0	5	9	0	0
14	24410373	.	G	A	1	1	2	0	1	3	0	0
14	24410384	.	T	C	3	1	4	0	4	8	0	0
14	24410450	.	A	C	14	10	24	0	2	26	0	0
14	24410556	.	T	C	14	13	27	0	1	28	0	0
14	24492051	.	G	C	9	5	14	0	1	15	0	0
14	24492154	.	C	T	6	5	11	0	1	12	0	0
14	24492225	.	G	A	6	4	10	0	1	11	0	0
14	24492226	.	C	A	0	5	5	0	6	11	0	0
14	24497739	.	T	C	2	3	5	0	0	5	0	0
14	24497868	.	T	C	3	0	3	0	4	7	0	0
14	24509941	.	T	C	2	3	5	0	0	5	0	0
14	24533422	.	A	G	3	2	5	0	0	5	0	0
14	24588332	.	A	G	0	2	2	0	0	2	0	0
14	24841001	.	C	T	3	5	8	0	0	8	0	0
14	24852639	.	T	C	4	2	6	0	0	6	0	0
14	24855042	.	A	G	0	1	1	0	0	1	0	0
14	24857218	.	G	A	0	3	3	0	3	6	0	0
14	24985474	.	T	C	6	9	15	0	0	15	0	0
14	24985478	.	C	T	6	9	15	0	0	15	0	0
14	24985582	.	C	A	8	11	19	0	1	20	0	0
14	24990428	.	G	T	5	5	10	0	0	10	0	0
14	24990720	.	G	A	6	3	9	0	0	9	0	0
14	24997535	.	C	T	7	8	15	0	0	15	0	0
14	24997954	.	C	A	6	7	13	0	2	15	0	0
14	24998076	.	A	G	8	0	8	0	14	22	0	0
14	24998093	.	T	C	13	14	27	0	0	27	0	0
14	24998121	.	C	T	18	10	28	0	0	28	0	0
14	24998203	.	C	T	9	10	19	0	1	20	0	0
14	24998359	.	C	A	8	8	16	0	0	16	0	0
14	24998459	.	C	A	9	9	18	0	0	18	0	0
14	24998765	.	A	T	11	10	21	0	1	22	0	0
14	24998930	.	C	G	10	13	23	0	2	25	0	0
14	24999573	.	A	G	17	0	17	0	19	36	0	0
14	25000109	.	A	G	4	12	16	0	0	16	0	0
14	25000492	.	A	T	9	9	18	1	1	20	0	0
14	25000621	.	A	G	13	10	23	0	2	25	0	0
14	25034986	.	A	G	0	3	3	0	0	3	0	0
14	25040144	.	A	G	1	1	2	0	0	2	0	0
14	25040313	.	G	A	3	0	3	0	0	3	0	0
14	25063456	.	C	T	1	1	2	0	0	3	1	0
14	25063607	.	G	T	5	1	6	0	0	6	0	0
14	25063617	.	A	G	4	1	5	0	0	5	0	0
14	25065972	.	T	C	1	0	1	0	4	5	0	0
14	25067463	.	G	T	6	5	11	0	0	11	0	0
14	25067905	.	C	T	19	7	26	0	0	26	0	0
14	25076629	.	A	G	5	6	11	0	0	11	0	0
14	25077642	.	G	A	10	16	26	0	0	26	0	0
14	25078505	.	A	T	7	9	16	0	0	16	0	0
14	25080687	.	C	G	24	14	38	0	0	38	0	0
14	25101400	.	A	T	0	7	7	0	0	7	0	0
14	25102078	.	G	A	0	3	3	1	0	4	0	0
14	25537231	.	T	C	21	8	29	0	3	32	0	0
14	28463281	.	A	G	2	0	2	0	0	2	0	0
14	31644488	.	T	C	3	11	14	0	0	14	0	0
14	31644638	.	A	G	2	5	7	0	0	7	0	0
14	31644646	.	A	G	3	5	8	0	0	8	0	0
14	31647217	.	A	G	3	10	13	0	0	13	0	0
14	31801219	.	T	C	3	0	3	0	5	8	0	0
14	32185284	.	T	A	0	6	6	0	0	6	0	0
14	33754492	.	T	C	0	21	21	0	0	21	0	0
14	33826850	.	T	C	3	2	5	0	0	5	0	0
14	33826997	.	T	C	3	9	12	0	0	12	0	0
14	33827426	.	T	C	5	3	8	0	0	8	0	0
14	33827434	.	T	C	1	7	8	0	1	9	0	0
14	33894839	.	T	C	3	2	5	0	1	6	0	0
14	33900289	.	C	T	0	7	7	0	0	7	0	0
14	33901591	.	T	C	4	5	9	0	1	10	0	0
14	34090422	.	A	G	10	3	13	0	0	13	0	0
14	34125983	.	T	A	1	2	3	0	0	3	0	0
14	34126061	.	T	A	11	4	15	0	1	16	0	0
14	34130042	.	A	G	0	4	4	6	0	10	0	0
14	34488338	.	C	T	2	3	5	0	1	6	0	0
14	34553502	.	A	G	1	3	4	0	0	4	0	0
14	35804833	.	A	G	2	1	3	0	0	3	0	0
14	35813121	.	T	A	0	27	27	0	1	28	0	0
14	36268424	.	T	C	0	3	3	0	0	3	0	0
14	36268426	.	T	C	0	3	3	0	0	3	0	0
14	36720985	.	A	G	7	7	14	0	0	14	0	0
14	36752050	.	T	C	3	0	3	0	3	6	0	0
14	36761837	.	G	A	2	2	4	0	0	4	0	0
14	38656962	.	T	C	1	4	5	0	0	5	0	0
14	38656976	.	A	C	1	3	4	0	0	4	0	0
14	38663969	.	A	C	1	4	5	0	2	7	0	0
14	38663972	.	C	T	0	6	6	0	1	7	0	0
14	38668543	.	G	C	0	5	5	0	0	5	0	0
14	38668546	.	T	C	0	5	5	0	0	5	0	0
14	38668815	.	C	T	2	3	5	0	0	5	0	0
14	38668863	.	T	C	3	3	6	0	0	6	0	0
14	38669487	.	A	G	4	3	7	0	0	7	0	0
14	38669562	.	G	T	0	4	4	0	0	4	0	0
14	38670016	.	C	T	1	1	2	0	0	2	0	0
14	38672310	.	A	G	2	0	2	0	5	7	0	0
14	38672521	.	G	T	2	7	9	0	0	9	0	0
14	38678070	.	C	T	1	0	1	0	0	1	0	0
14	38688730	.	G	A	1	7	8	0	0	8	0	0
14	38688829	.	G	C	5	7	12	0	1	13	0	0
14	38689174	.	G	A	1	6	7	0	0	7	0	0
14	38689332	.	A	G	4	8	12	0	1	13	0	0
14	38689409	.	A	C	1	7	8	0	0	8	0	0
14	38689428	.	G	C	2	6	8	0	0	8	0	0
14	38763334	.	A	C	19	12	31	0	0	31	0	0
14	38763381	.	G	A	21	18	39	0	2	41	0	0
14	38763394	.	G	A	16	22	38	0	2	40	0	0
14	38783272	.	T	C	11	13	24	0	2	26	0	0
14	38802884	.	C	T	4	10	14	0	0	14	0	0
14	38802904	.	A	T	5	12	17	0	0	17	0	0
14	38802960	.	G	A	5	2	7	0	1	8	0	0
14	38802967	.	T	G	5	2	7	0	0	7	0	0
14	38803085	.	G	A	1	2	3	0	0	3	0	0
14	38803088	.	C	T	0	2	2	0	2	4	0	0
14	38806916	.	G	T	4	3	7	0	0	7	0	0
14	38809356	.	G	A	1	5	6	0	0	6	0	0
14	38809512	.	C	T	4	4	8	0	0	8	0	0
14	38809528	.	T	C	3	3	6	0	1	7	0	0
14	38845762	.	T	C	7	16	23	0	0	23	0	0
14	38845912	.	A	G	35	17	52	0	7	59	0	0
14	38846587	.	A	T	39	22	61	0	1	62	0	0
14	38847235	.	A	G	17	9	26	0	3	29	0	0
14	38847497	.	A	G	3	0	3	0	6	9	0	0
14	38849729	.	C	T	26	27	53	0	0	53	0	0
14	38849946	.	A	C	26	27	53	0	1	54	0	0
14	38853381	.	C	G	6	3	9	0	0	9	0	0
14	38853397	.	A	G	2	7	9	0	0	9	0	0
14	38853821	.	C	T	3	1	4	0	0	4	0	0
14	38862589	.	A	G	2	5	7	0	0	7	0	0
14	38862598	.	A	G	4	5	9	0	0	9	0	0
14	38865589	.	C	T	1	1	2	0	0	2	0	0
14	38869753	.	G	A	1	2	3	0	0	3	0	0
14	38872410	.	C	T	0	1	1	0	0	1	0	0
14	38872454	.	T	C	2	4	6	0	1	7	0	0
14	38872541	.	A	G	3	3	6	0	2	8	0	0
14	38872552	.	A	G	1	1	2	0	2	4	0	0
14	38875606	.	G	T	1	2	3	0	0	3	0	0
14	38878552	.	T	C	7	8	15	0	0	15	0	0
14	38881363	.	G	A	1	3	4	0	6	10	0	0
14	38884451	.	T	C	2	2	4	0	0	4	0	0
14	38937085	.	T	C	1	0	1	0	4	5	0	0
14	38937099	.	T	C	3	4	7	0	0	7	0	0
14	38937305	.	C	T	5	4	9	0	0	9	0	0
14	38946732	.	G	A	4	2	6	0	0	6	0	0
14	39002433	.	G	C	6	7	13	0	2	15	0	0
14	39002555	.	C	T	5	6	11	0	0	11	0	0
14	39002562	.	C	T	3	5	8	0	3	11	0	0
14	39002698	.	C	A	4	6	10	0	0	10	0	0
14	39002739	.	G	C	6	0	6	0	10	16	0	0
14	39002752	.	A	G	5	9	14	0	0	14	0	0
14	39002820	.	A	T	6	7	13	0	1	15	1	0
14	39002883	.	A	G	9	8	17	0	0	17	0	0
14	39003039	.	T	G	0	2	2	0	0	2	0	0
14	39074245	.	G	A	0	1	1	0	0	1	0	0
14	39458519	.	C	T	1	3	4	0	1	5	0	0
14	39608615	.	A	G	1	0	1	0	1	2	0	0
14	39651358	.	G	C	4	2	6	0	0	6	0	0
14	39651511	.	A	G	2	1	3	0	0	3	0	0
14	40746227	.	C	T	1	2	3	0	1	4	0	0
14	40852670	.	A	T	9	9	18	0	0	18	0	0
14	40852732	.	T	C	8	7	15	0	0	15	0	0
14	40853268	.	C	G	0	1	1	0	0	1	0	0
14	40857654	.	T	G	2	0	2	0	0	2	0	0
14	40857711	.	G	A	3	0	3	0	0	3	0	0
14	40857881	.	T	C	5	5	10	0	0	10	0	0
14	40857977	.	C	T	4	7	11	0	0	11	0	0
14	40859179	.	A	G	8	0	8	0	14	23	1	0
14	40860291	.	T	A	3	7	10	0	1	11	0	0
14	40860354	.	C	T	4	17	21	0	0	21	0	0
14	40863062	.	A	G	11	20	31	0	0	31	0	0
14	40863161	.	T	C	11	9	20	0	1	21	0	0
14	40863176	.	A	G	7	7	14	0	0	14	0	0
14	40869331	.	C	A	13	10	23	0	0	23	0	0
14	40874026	.	G	T	8	5	13	0	1	14	0	0
14	40924456	.	G	A	1	2	3	0	0	3	0	0
14	41276516	.	T	A	5	7	12	0	1	13	0	0
14	41276608	.	G	A	8	9	17	0	0	17	0	0
14	41277391	.	A	T	6	12	18	0	0	18	0	0
14	41277556	.	A	G	16	35	51	0	2	53	0	0
14	41277624	.	A	T	26	22	48	0	5	53	0	0
14	41278238	.	T	A	22	15	37	0	2	39	0	0
14	41278255	.	A	G	16	21	37	0	1	38	0	0
14	41278386	.	C	T	32	9	41	0	3	45	1	0
14	41278658	.	T	G	9	12	21	0	0	21	0	0
14	41278754	.	C	G	6	10	16	0	0	16	0	0
14	41279133	.	C	T	18	6	24	2	1	27	0	0
14	41279214	.	C	T	22	17	39	0	1	40	0	0
14	41279277	.	G	C	20	16	36	0	4	40	0	0
14	41279479	.	T	A	7	9	16	0	0	16	0	0
14	41279527	.	C	T	0	13	13	0	3	16	0	0
14	41279542	.	C	A	1	7	8	0	14	23	1	0
14	41279974	.	T	G	14	12	26	0	1	27	0	0
14	41279977	.	G	T	13	14	27	0	1	28	0	0
14	41280013	.	G	A	15	13	28	0	1	29	0	0
14	41280149	.	G	A	20	20	40	0	0	40	0	0
14	41280228	.	A	G	29	15	44	0	4	48	0	0
14	41280517	.	G	C	3	2	5	0	0	5	0	0
14	41318507	.	C	T	0	4	4	0	0	4	0	0
14	41318672	.	G	C	1	2	3	0	3	6	0	0
14	41319073	.	C	T	2	1	3	0	0	3	0	0
14	41339309	.	T	C	5	2	7	0	1	8	0	0
14	41339820	.	G	C	7	3	10	0	0	10	0	0
14	41339972	.	G	A	0	2	2	0	2	4	0	0
14	41340054	.	T	A	2	4	6	0	0	6	0	0
14	41340081	.	A	T	5	3	8	0	0	8	0	0
14	41340172	.	A	C	3	5	8	0	1	9	0	0
14	41340231	.	G	A	5	3	8	0	1	9	0	0
14	41361985	.	C	T	0	4	4	0	11	15	0	0
14	41362007	.	G	A	6	9	15	0	0	15	0	0
14	41366823	.	G	A	17	10	27	0	1	28	0	0
14	41366889	.	C	A	0	2	2	0	0	2	0	0
14	41385823	.	G	A	5	3	8	0	0	8	0	0
14	41385895	.	C	T	0	9	9	0	13	22	0	0
14	41414242	.	C	A	3	2	5	0	0	5	0	0
14	41414483	.	C	A	1	1	2	0	1	3	0	0
14	41414857	.	C	T	2	2	4	0	0	4	0	0
14	41428500	.	C	T	5	12	17	0	0	17	0	0
14	41435662	.	C	T	5	9	14	0	0	14	0	0
14	41436773	.	T	A	6	7	13	0	0	13	0	0
14	41436943	.	C	T	2	3	5	0	0	5	0	0
14	41466483	.	T	A	1	9	10	0	0	10	0	0
14	41466522	.	G	A	10	7	17	0	1	18	0	0
14	41466922	.	T	A	12	13	25	0	1	26	0	0
14	41467152	.	T	C	13	21	34	0	0	34	0	0
14	41467155	.	C	T	21	12	33	0	1	34	0	0
14	41467356	.	C	G	12	17	29	0	0	29	0	0
14	41469575	.	T	A	1	3	4	0	0	4	0	0
14	41469662	.	C	A	5	3	8	0	1	9	0	0
14	41469678	.	T	G	4	0	4	0	2	6	0	0
14	41469761	.	G	T	1	3	4	0	0	4	0	0
14	41469827	.	T	C	1	3	4	0	1	5	0	0
14	41469829	.	T	C	1	3	4	0	1	5	0	0
14	41469925	.	T	A	5	5	10	0	0	10	0	0
14	41469935	.	C	T	4	5	9	0	1	10	0	0
14	41470032	.	C	T	0	5	5	0	1	6	0	0
14	41470037	.	A	T	0	5	5	0	1	6	0	0
14	41513433	.	G	A	0	3	3	0	0	3	0	0
14	41513448	.	G	A	1	2	3	0	0	3	0	0
14	41513529	.	C	G	0	2	2	0	0	2	0	0
14	41514915	.	C	T	0	2	2	0	0	2	0	0
14	41601206	.	G	T	1	3	4	0	0	4	0	0
14	41601248	.	A	G	1	4	5	0	0	5	0	0
14	41601826	.	C	T	1	2	3	0	0	3	0	0
14	41601880	.	A	T	2	3	5	0	0	5	0	0
14	42172389	.	A	C	3	4	7	0	1	8	0	0
14	42172457	.	T	A	6	7	13	0	4	17	0	0
14	42172459	.	G	C	0	9	9	0	8	17	0	0
14	42172732	.	G	A	0	3	3	0	3	6	0	0
14	42172951	.	G	A	0	3	3	0	9	12	0	0
14	42173803	.	C	T	3	3	6	0	0	6	0	0
14	42174247	.	G	A	0	8	8	0	13	21	0	0
14	42174401	.	C	T	9	7	16	0	0	16	0	0
14	42174645	.	A	T	13	5	18	0	1	19	0	0
14	42178503	.	C	T	12	7	19	0	0	19	0	0
14	42178728	.	G	A	8	13	21	0	0	21	0	0
14	42178974	.	G	A	12	14	26	0	1	27	0	0
14	42978975	.	A	G	17	12	29	0	2	31	0	0
14	42978980	.	A	C	19	12	31	0	1	32	0	0
14	42979030	.	T	C	14	0	14	0	11	25	0	0
14	42979087	.	A	T	13	11	24	0	0	24	0	0
14	42979090	.	T	A	12	8	20	0	2	22	0	0
14	42979655	.	A	G	19	14	33	0	3	36	0	0
14	42997943	.	G	A	13	12	25	0	0	25	0	0
14	42998353	.	G	A	8	11	19	0	1	20	0	0
14	42998879	.	G	A	9	11	20	0	1	21	0	0
14	42999314	.	C	T	6	8	14	0	1	15	0	0
14	42999524	.	C	T	10	7	17	0	0	17	0	0
14	43000785	.	A	T	10	8	18	0	0	18	0	0
14	43577346	.	C	T	0	7	7	0	9	16	0	0
14	43577704	.	G	A	10	4	14	0	0	14	0	0
14	43577916	.	G	A	3	0	3	0	0	3	0	0
14	43580985	.	G	T	4	4	8	0	0	8	0	0
14	43582551	.	C	G	2	6	8	0	0	8	0	0
14	43582567	.	G	A	2	5	7	0	1	8	0	0
14	43582602	.	C	T	1	1	2	0	0	2	0	0
14	43591152	.	G	T	2	4	6	0	0	6	0	0
14	43591188	.	G	A	6	8	14	0	0	14	0	0
14	43605214	.	T	C	3	2	5	0	0	5	0	0
14	43605462	.	C	T	11	7	18	0	0	18	0	0
14	43605498	.	T	C	7	1	8	0	14	22	0	0
14	43605510	.	G	A	11	5	16	0	1	17	0	0
14	44013794	.	C	A	6	4	10	0	0	10	0	0
14	44589624	.	C	T	9	16	25	0	2	27	0	0
14	44589834	.	A	G	15	6	21	0	1	22	0	0
14	44589972	.	T	A	7	9	16	0	0	16	0	0
14	44589978	.	G	A	6	8	14	0	2	16	0	0
14	44590297	.	G	C	8	11	19	0	0	19	0	0
14	44590301	.	A	G	8	0	8	0	12	20	0	0
14	44590644	.	C	T	18	20	38	0	0	38	0	0
14	44590838	.	T	A	11	6	17	0	0	17	0	0
14	44590935	.	G	A	0	12	12	0	15	27	0	0
14	44590992	.	A	G	8	11	19	0	0	19	0	0
14	44825436	.	T	A	5	3	8	0	0	8	0	0
14	45071319	.	G	T	0	2	2	0	0	2	0	0
14	45294939	.	A	G	8	3	11	0	0	11	0	0
14	45435739	.	T	A	2	1	3	0	0	3	0	0
14	45636070	.	G	A	4	18	22	1	15	38	0	0
14	45926364	.	C	T	1	3	4	0	0	4	0	0
14	45926559	.	T	C	1	2	3	0	0	3	0	0
14	45926910	.	C	T	1	2	3	0	0	3	0	0
14	45927130	.	T	G	6	0	6	0	3	9	0	0
14	45927282	.	A	T	2	4	6	0	0	6	0	0
14	45927849	.	C	T	4	2	6	0	0	6	0	0
14	45927861	.	T	C	3	2	5	0	0	5	0	0
14	45928059	.	T	A	5	3	8	0	0	8	0	0
14	45928154	.	C	T	2	2	4	0	0	4	0	0
14	45928155	.	T	G	2	2	4	0	0	4	0	0
14	45928603	.	T	A	5	2	7	0	0	7	0	0
14	45929100	.	A	T	2	4	6	0	0	6	0	0
14	45929137	.	T	G	2	5	7	0	0	7	0	0
14	45929140	.	T	A	2	5	7	0	0	7	0	0
14	45929173	.	A	G	0	1	1	0	2	3	0	0
14	45929211	.	C	T	2	2	4	0	0	4	0	0
14	45929280	.	C	T	4	2	6	0	0	6	0	0
14	45929409	.	C	T	5	3	8	0	0	8	0	0
14	45929748	.	A	G	5	3	8	0	0	8	0	0
14	45929837	.	T	A	6	2	8	0	1	9	0	0
14	45929974	.	T	C	3	4	7	0	0	7	0	0
14	45930135	.	T	C	6	4	10	0	0	10	0	0
14	45930399	.	C	T	4	5	9	0	0	9	0	0
14	45930669	.	A	G	3	4	7	0	0	7	0	0
14	45930690	.	A	G	4	3	7	0	0	7	0	0
14	45930735	.	T	G	5	4	9	0	1	11	1	0
14	45930794	.	G	A	2	10	12	0	2	14	0	0
14	45931079	.	C	G	12	4	16	0	0	16	0	0
14	45931194	.	G	T	13	7	20	0	0	20	0	0
14	45931504	.	C	G	9	9	18	0	0	18	0	0
14	45931637	.	C	T	7	7	14	0	1	15	0	0
14	45931899	.	C	T	5	7	12	0	1	13	0	0
14	45932128	.	T	G	4	7	11	0	0	11	0	0
14	45932306	.	T	C	1	1	2	0	1	3	0	0
14	45992322	.	A	G	1	0	1	0	0	1	0	0
14	45997103	.	A	G	1	0	1	0	1	2	0	0
14	45997114	.	T	C	1	2	3	0	0	3	0	0
14	46007306	.	A	G	5	7	12	0	2	14	0	0
14	46007321	.	G	A	4	6	10	0	0	10	0	0
14	46009611	.	G	A	9	6	15	0	0	15	0	0
14	46009683	.	A	T	4	1	5	0	0	5	0	0
14	46010711	.	C	T	2	0	2	0	0	2	0	0
14	46010909	.	T	C	1	4	5	0	0	5	0	0
14	46012960	.	T	C	0	2	2	0	0	2	0	0
14	46013121	.	A	T	2	6	8	0	0	8	0	0
14	46013402	.	C	T	14	13	27	0	1	28	0	0
14	46015888	.	C	A	3	0	3	0	0	3	0	0
14	46016107	.	A	G	3	3	6	0	0	6	0	0
14	46017969	.	G	A	17	13	30	0	0	30	0	0
14	46018029	.	C	T	20	14	34	0	2	36	0	0
14	46018381	.	A	G	1	2	3	0	0	3	0	0
14	46018468	.	A	G	1	5	6	0	0	6	0	0
14	46018482	.	A	G	8	4	12	0	0	12	0	0
14	46018548	.	A	G	10	12	22	0	0	22	0	0
14	46018560	.	A	G	12	6	18	0	0	18	0	0
14	46028329	.	G	T	2	9	11	0	0	11	0	0
14	46028330	.	T	A	2	9	11	0	0	11	0	0
14	46028376	.	G	A	4	4	8	0	0	8	0	0
14	46028548	.	G	C	0	3	3	0	2	5	0	0
14	46037489	.	T	C	4	2	6	0	1	7	0	0
14	46039751	.	T	C	5	6	11	0	0	11	0	0
14	46039904	.	C	G	3	0	3	0	4	7	0	0
14	46040318	.	T	C	5	5	10	0	0	10	0	0
14	46041800	.	C	T	9	3	12	0	0	12	0	0
14	46041861	.	A	T	9	8	17	0	0	17	0	0
14	46042005	.	T	C	2	3	5	0	0	5	0	0
14	46048396	.	A	G	2	7	9	0	0	9	0	0
14	46048644	.	C	T	0	8	8	0	7	15	0	0
14	46048704	.	C	G	0	10	10	0	7	17	0	0
14	46048875	.	T	C	6	14	20	0	6	26	0	0
14	46052172	.	T	A	12	7	19	0	0	19	0	0
14	46052244	.	G	T	6	5	11	0	1	12	0	0
14	46074626	.	C	G	5	4	9	0	0	9	0	0
14	46074646	.	G	T	4	6	10	0	1	11	0	0
14	46075015	.	T	C	3	5	8	0	0	8	0	0
14	46075640	.	A	C	7	6	13	0	0	13	0	0
14	46075749	.	A	G	7	5	12	0	1	13	0	0
14	46076407	.	T	C	2	2	4	0	0	4	0	0
14	46076846	.	C	A	5	1	6	0	0	6	0	0
14	46076858	.	T	C	3	3	6	0	1	7	0	0
14	46088595	.	T	A	2	2	4	0	0	4	0	0
14	46088921	.	A	G	3	8	11	0	0	11	0	0
14	46089176	.	C	T	0	10	10	0	1	11	0	0
14	46089234	.	C	G	4	6	10	0	0	10	0	0
14	46089239	.	T	C	4	5	9	0	0	9	0	0
14	46089433	.	T	G	2	4	6	0	1	7	0	0
14	46089515	.	T	C	2	3	5	0	1	6	0	0
14	46089532	.	T	C	3	2	5	0	0	5	0	0
14	46089632	.	T	C	4	0	4	0	2	6	0	0
14	46090499	.	T	C	4	3	7	0	0	7	0	0
14	46090508	.	T	A	4	2	6	0	1	7	0	0
14	46090636	.	A	G	3	3	6	0	0	6	0	0
14	46090653	.	T	A	4	2	6	0	0	6	0	0
14	46090734	.	C	T	2	2	4	0	0	4	0	0
14	46090741	.	T	G	2	2	4	0	0	4	0	0
14	46091199	.	G	A	2	2	4	0	1	5	0	0
14	46091627	.	T	C	2	1	3	0	1	4	0	0
14	46094922	.	C	T	8	6	14	0	3	17	0	0
14	46095043	.	A	G	21	15	36	0	1	37	0	0
14	46095058	.	A	G	20	10	30	0	1	31	0	0
14	46095108	.	A	G	21	27	48	0	2	50	0	0
14	46104150	.	C	T	7	7	14	0	2	16	0	0
14	46104222	.	C	T	0	3	3	0	3	6	0	0
14	46104935	.	G	A	6	4	10	0	0	10	0	0
14	46113296	.	T	G	16	22	38	0	1	40	1	0
14	46113309	.	C	G	0	19	19	0	13	32	0	0
14	46113359	.	T	G	2	2	4	0	0	4	0	0
14	46114929	.	G	A	1	0	1	0	0	1	0	0
14	46116576	.	A	G	8	2	10	0	1	11	0	0
14	46117279	.	G	T	5	7	12	0	1	13	0	0
14	46117300	.	C	T	1	3	4	0	0	4	0	0
14	46128948	.	A	C	0	2	2	0	0	2	0	0
14	46129955	.	C	A	3	3	6	0	0	6	0	0
14	46134040	.	A	G	1	0	1	0	0	1	0	0
14	46140707	.	C	G	2	0	2	0	0	2	0	0
14	46140812	.	C	A	4	3	7	0	0	7	0	0
14	46146715	.	G	A	5	12	17	0	1	18	0	0
14	46146730	.	G	A	4	7	11	0	0	12	1	0
14	46154358	.	C	A	11	9	20	0	1	21	0	0
14	46154713	.	A	G	5	9	14	0	0	14	0	0
14	46154899	.	A	C	8	10	18	0	1	19	0	0
14	46154966	.	T	A	4	5	9	0	3	12	0	0
14	46154969	.	T	A	4	4	8	0	4	12	0	0
14	46183526	.	A	G	3	0	3	0	2	5	0	0
14	46183535	.	A	G	3	2	5	0	0	5	0	0
14	46183610	.	A	G	1	0	1	0	4	5	0	0
14	46184647	.	A	G	2	5	7	0	0	7	0	0
14	46184738	.	A	G	3	3	6	0	0	6	0	0
14	46187317	.	A	G	2	4	6	0	0	6	0	0
14	46188019	.	A	G	4	2	6	0	0	6	0	0
14	46188027	.	A	G	6	3	9	0	0	9	0	0
14	46679301	.	T	C	4	3	7	0	1	8	0	0
14	46679302	.	T	C	4	3	7	0	1	8	0	0
14	46679356	.	T	C	3	5	8	0	0	8	0	0
14	46679370	.	T	C	3	4	7	0	0	7	0	0
14	46680689	.	T	C	6	2	8	0	2	10	0	0
14	46680847	.	T	C	1	0	1	0	2	3	0	0
14	46681886	.	T	C	5	3	8	0	0	8	0	0
14	47003023	.	T	G	5	13	18	0	0	18	0	0
14	47003330	.	A	C	14	18	32	0	1	33	0	0
14	47003696	.	G	T	21	9	30	0	3	33	0	0
14	47003908	.	C	T	0	16	16	0	22	38	0	0
14	47003958	.	T	A	20	18	38	0	1	39	0	0
14	47004090	.	T	G	18	16	34	0	0	34	0	0
14	47004187	.	C	A	15	6	21	0	0	21	0	0
14	47004365	.	G	A	11	11	22	0	1	23	0	0
14	47004734	.	G	A	22	15	37	0	0	37	0	0
14	47004959	.	T	G	21	15	36	0	0	36	0	0
14	47027767	.	G	A	5	10	15	0	1	16	0	0
14	47066764	.	G	A	8	8	16	0	0	16	0	0
14	47074234	.	A	G	7	10	17	0	0	17	0	0
14	47085624	.	A	G	6	8	14	0	2	16	0	0
14	47096209	.	T	C	10	0	10	0	6	16	0	0
14	47131242	.	T	G	1	1	2	0	0	2	0	0
14	47131260	.	G	A	3	4	7	0	0	7	0	0
14	47142032	.	C	T	1	1	2	0	1	3	0	0
14	47264962	.	T	C	1	0	1	0	1	2	0	0
14	47265031	.	A	G	3	3	6	0	0	6	0	0
14	47783003	.	C	A	4	2	6	0	0	6	0	0
14	47882878	.	T	A	3	2	5	0	0	5	0	0
14	48934630	.	C	G	11	16	27	0	2	29	0	0
14	48934639	.	T	C	18	0	18	0	8	26	0	0
14	48997660	.	G	A	1	6	7	0	0	7	0	0
14	48997661	.	G	A	1	6	7	0	0	7	0	0
14	49022071	.	A	G	13	0	13	0	5	18	0	0
14	49022145	.	A	G	5	1	6	0	6	12	0	0
14	49030054	.	A	G	0	3	3	0	0	3	0	0
14	49030348	.	A	G	1	3	4	1	1	6	0	0
14	49040342	.	C	T	0	4	4	0	0	4	0	0
14	49173450	.	A	G	1	1	2	0	0	2	0	0
14	49211001	.	A	G	3	10	13	0	0	13	0	0
14	49211172	.	A	G	4	4	8	0	1	9	0	0
14	49212708	.	A	G	8	2	10	0	1	11	0	0
14	49212718	.	A	G	4	4	8	0	1	9	0	0
14	49213562	.	G	T	1	2	3	0	0	3	0	0
14	49213732	.	A	G	1	2	3	0	1	4	0	0
14	49430817	.	A	G	10	15	25	0	0	25	0	0
14	49430844	.	A	G	24	8	32	0	1	33	0	0
14	49431366	.	T	C	0	8	8	0	0	8	0	0
14	49683812	.	T	C	1	2	3	0	0	3	0	0
14	49738310	.	G	A	0	1	1	0	0	1	0	0
14	49738358	.	C	T	5	2	7	0	0	7	0	0
14	49738424	.	C	T	1	0	1	0	0	1	0	0
14	49750311	.	C	T	2	3	5	0	0	5	0	0
14	49756700	.	A	T	4	7	11	0	1	12	0	0
14	49757069	.	G	T	5	3	8	0	0	8	0	0
14	49757225	.	G	A	3	3	6	0	0	6	0	0
14	49757359	.	C	G	3	0	3	0	5	8	0	0
14	49757491	.	A	G	1	0	1	0	3	4	0	0
14	49757802	.	G	A	3	5	8	0	1	9	0	0
14	49757811	.	A	G	3	4	7	0	0	7	0	0
14	49757843	.	A	C	1	2	3	0	0	3	0	0
14	49759805	.	G	A	1	4	5	0	0	5	0	0
14	49760713	.	G	A	2	3	5	0	1	6	0	0
14	49761874	.	T	C	2	2	4	0	0	4	0	0
14	50808244	.	C	T	0	2	2	0	0	2	0	0
14	50964215	.	A	G	7	1	8	0	0	8	0	0
14	50964260	.	C	T	1	4	5	0	0	5	0	0
14	50968017	.	T	C	4	2	6	0	0	6	0	0
14	50972787	.	C	G	10	4	14	0	1	15	0	0
14	50972822	.	T	C	4	5	9	0	1	10	0	0
14	50972921	.	G	A	0	9	9	0	5	14	0	0
14	50973322	.	A	G	3	2	5	0	2	7	0	0
14	50973374	.	C	A	0	7	7	0	0	7	0	0
14	50973437	.	T	C	8	5	13	0	0	13	0	0
14	50973665	.	A	T	1	3	4	0	0	4	0	0
14	50974729	.	G	A	7	6	13	0	0	13	0	0
14	50974739	.	G	A	0	3	3	0	7	12	2	0
14	50974827	.	A	G	3	5	8	0	1	9	0	0
14	50974870	.	T	G	1	6	7	0	1	8	0	0
14	50974874	.	C	T	2	6	8	0	0	8	0	0
14	50975094	.	A	G	5	5	10	0	0	10	0	0
14	50975501	.	G	A	0	5	5	0	1	6	0	0
14	50994361	.	A	G	6	6	12	0	2	14	0	0
14	50994687	.	G	T	24	15	39	0	2	41	0	0
14	50994695	.	G	C	24	17	41	0	0	41	0	0
14	50999698	.	A	G	7	10	17	0	3	20	0	0
14	51002874	.	G	A	7	3	10	0	3	13	0	0
14	51014221	.	T	G	2	1	3	0	1	4	0	0
14	51017771	.	G	A	0	16	16	0	13	29	0	0
14	51017841	.	A	G	5	15	20	0	0	20	0	0
14	51017952	.	G	A	0	7	7	0	6	13	0	0
14	51017990	.	T	A	4	4	8	0	0	8	0	0
14	51038976	.	A	G	2	5	7	0	0	7	0	0
14	51038980	.	G	T	1	5	6	0	0	6	0	0
14	51829341	.	G	A	25	44	69	0	2	71	0	0
14	51829377	.	A	G	22	44	66	0	3	69	0	0
14	51830952	.	G	A	3	10	13	0	0	13	0	0
14	52357035	.	A	G	2	0	2	0	0	2	0	0
14	52358842	.	A	C	4	4	8	0	0	8	0	0
14	52358971	.	G	C	3	10	13	0	0	13	0	0
14	52361399	.	C	T	2	2	4	0	1	5	0	0
14	52366401	.	G	A	5	5	10	0	0	10	0	0
14	52366464	.	C	T	3	7	10	0	1	11	0	0
14	52369276	.	C	T	0	4	4	0	1	5	0	0
14	52369280	.	C	G	1	4	5	0	0	5	0	0
14	52369558	.	C	A	3	11	14	0	1	15	0	0
14	52369644	.	C	G	3	6	9	0	0	9	0	0
14	52376418	.	G	A	0	1	1	0	0	1	0	0
14	52379686	.	G	A	0	1	1	0	0	1	0	0
14	52379732	.	C	A	7	4	11	0	0	11	0	0
14	52379740	.	T	A	4	8	12	0	1	13	0	0
14	52379876	.	T	C	8	4	12	0	0	12	0	0
14	52379992	.	C	A	4	8	12	0	1	13	0	0
14	52380244	.	A	C	1	3	4	0	0	4	0	0
14	52383817	.	G	A	6	1	7	0	0	7	0	0
14	52383871	.	G	A	7	4	11	0	0	11	0	0
14	52386667	.	G	A	7	5	12	0	0	12	0	0
14	52386736	.	C	T	18	12	30	0	4	34	0	0
14	52386750	.	G	A	19	18	37	0	0	37	0	0
14	52388115	.	G	A	0	4	4	0	0	4	0	0
14	52388136	.	G	C	0	4	4	0	0	4	0	0
14	52391664	.	G	A	6	7	13	0	2	15	0	0
14	52392238	.	G	A	5	5	10	0	0	10	0	0
14	52395438	.	T	C	1	0	1	0	5	6	0	0
14	52395492	.	G	A	7	11	18	0	0	18	0	0
14	52395552	.	C	T	0	1	1	0	0	1	0	0
14	52397293	.	C	T	2	5	7	0	0	7	0	0
14	52399977	.	A	G	4	3	7	0	0	7	0	0
14	52400426	.	G	C	1	3	4	0	1	5	0	0
14	52404637	.	G	A	1	1	2	0	0	2	0	0
14	52408354	.	A	C	1	3	4	0	0	4	0	0
14	52408723	.	T	C	6	6	12	0	0	12	0	0
14	52411315	.	C	G	2	5	7	0	1	8	0	0
14	52413205	.	G	A	0	1	1	0	2	3	0	0
14	52417462	.	T	A	8	7	15	0	0	16	1	0
14	52417470	.	A	T	7	8	15	0	1	16	0	0
14	52418127	.	T	A	9	3	12	0	0	12	0	0
14	52418274	.	C	A	9	5	14	0	0	14	0	0
14	52418565	.	T	G	9	5	14	0	4	18	0	0
14	52418772	.	G	T	11	5	16	0	0	16	0	0
14	52418818	.	A	G	13	8	21	0	0	21	0	0
14	52444771	.	T	C	0	1	1	0	0	1	0	0
14	52476624	.	T	C	3	3	6	0	0	6	0	0
14	52476640	.	A	G	1	3	4	0	0	4	0	0
14	52494442	.	T	C	1	2	3	0	0	3	0	0
14	52494686	.	T	C	6	6	12	0	0	12	0	0
14	52497733	.	G	A	0	8	8	0	3	11	0	0
14	52497766	.	G	C	0	3	3	0	2	5	0	0
14	52512529	.	G	A	0	8	8	0	7	15	0	0
14	52513561	.	C	T	3	1	4	0	0	4	0	0
14	52517957	.	T	C	9	13	22	0	0	22	0	0
14	52518002	.	A	G	12	9	21	0	2	23	0	0
14	52518030	.	G	A	0	10	10	0	9	19	0	0
14	52518125	.	C	A	3	9	12	0	0	12	0	0
14	52520270	.	G	A	8	6	14	0	0	14	0	0
14	52520367	.	T	C	3	3	6	0	1	7	0	0
14	52521365	.	G	T	1	3	4	0	0	4	0	0
14	52521368	.	C	T	1	2	3	0	1	4	0	0
14	52522820	.	T	C	15	6	21	0	0	21	0	0
14	52522822	.	C	T	15	6	21	0	0	21	0	0
14	52522876	.	C	T	9	12	21	0	0	21	0	0
14	52523290	.	C	T	0	3	3	0	10	13	0	0
14	52523575	.	T	C	25	0	25	0	11	36	0	0
14	52523648	.	G	T	10	14	24	0	0	24	0	0
14	52523707	.	A	G	15	5	20	0	1	21	0	0
14	52523893	.	G	A	1	3	4	0	0	4	0	0
14	52524072	.	T	C	1	4	5	0	0	5	0	0
14	52524091	.	A	G	2	5	7	0	0	7	0	0
14	52524110	.	A	G	2	5	7	0	0	7	0	0
14	52524364	.	C	T	0	4	4	0	4	8	0	0
14	52524525	.	A	T	3	2	5	0	0	5	0	0
14	52524651	.	A	T	7	4	11	0	1	12	0	0
14	52524653	.	G	T	7	4	11	0	1	12	0	0
14	52524687	.	T	A	5	7	12	0	2	14	0	0
14	52524767	.	A	G	5	6	11	0	0	11	0	0
14	52524792	.	A	G	4	4	8	0	0	8	0	0
14	52525016	.	C	T	0	9	9	0	8	17	0	0
14	52525673	.	G	A	12	5	17	0	2	19	0	0
14	52525812	.	C	T	0	11	11	0	7	18	0	0
14	52528210	.	G	A	2	0	2	0	0	2	0	0
14	52533500	.	G	A	5	9	14	0	0	14	0	0
14	52536303	.	G	C	4	1	5	0	0	5	0	0
14	52552852	.	A	G	15	4	19	0	3	22	0	0
14	52552863	.	G	A	9	20	29	0	1	30	0	0
14	52571225	.	C	A	2	2	4	0	0	4	0	0
14	52574497	.	C	A	0	1	1	0	0	1	0	0
14	52575707	.	C	T	1	6	7	0	0	7	0	0
14	52575754	.	T	C	3	5	8	0	0	8	0	0
14	52577036	.	G	A	3	4	7	0	0	7	0	0
14	52577042	.	A	G	3	4	7	0	0	7	0	0
14	52580533	.	T	C	5	0	5	0	1	6	0	0
14	52580849	.	G	A	1	1	2	0	0	2	0	0
14	52582987	.	G	T	3	2	5	0	0	5	0	0
14	52583001	.	C	A	3	2	5	0	0	5	0	0
15	611469	.	T	C	4	2	6	0	0	6	0	0
15	636847	.	G	A	1	4	5	0	0	5	0	0
15	870082	.	A	G	2	2	4	2	0	6	0	0
15	870083	.	T	G	2	2	4	2	0	6	0	0
15	886081	.	G	A	0	1	1	0	3	4	0	0
15	908257	.	T	C	3	0	3	1	0	4	0	0
15	1026224	.	T	G	0	2	2	0	0	2	0	0
15	1026323	.	A	G	2	2	4	0	0	4	0	0
15	1033435	.	A	T	3	5	8	0	0	8	0	0
15	1033479	.	T	G	2	5	7	0	0	7	0	0
15	1033564	.	G	T	1	2	3	0	1	4	0	0
15	1033853	.	A	G	6	3	9	0	1	10	0	0
15	1033955	.	C	T	0	2	2	0	2	4	0	0
15	1036614	.	C	T	1	0	1	0	0	1	0	0
15	1036677	.	C	T	0	6	6	0	6	12	0	0
15	1036825	.	T	C	1	3	4	0	0	4	0	0
15	1046204	.	G	A	0	1	1	0	0	1	0	0
15	1158649	.	A	G	1	0	1	0	0	1	0	0
15	1162040	.	A	G	3	3	6	0	0	6	0	0
15	1162048	.	T	C	3	2	5	0	0	5	0	0
15	1167171	.	C	T	4	1	5	0	0	5	0	0
15	1167183	.	C	T	6	1	7	0	0	7	0	0
15	1173016	.	A	G	4	0	4	0	2	6	0	0
15	1173067	.	C	T	7	5	12	0	0	12	0	0
15	1173542	.	C	T	3	5	8	0	0	8	0	0
15	1176447	.	G	A	0	4	4	0	6	10	0	0
15	1178927	.	C	A	6	8	14	0	0	14	0	0
15	1183930	.	G	T	0	1	1	0	0	1	0	0
15	1183984	.	C	T	0	6	6	0	5	11	0	0
15	1186181	.	A	G	5	8	13	0	0	13	0	0
15	1186202	.	C	T	0	5	5	0	4	9	0	0
15	1189664	.	C	T	17	10	27	0	6	33	0	0
15	1191750	.	A	G	1	4	5	0	0	5	0	0
15	1191792	.	G	A	0	10	10	0	9	19	0	0
15	1191822	.	A	G	11	0	11	0	10	21	0	0
15	1194590	.	A	G	13	11	24	0	1	25	0	0
15	1194619	.	G	A	0	11	11	0	14	25	0	0
15	1194633	.	A	G	13	9	22	0	0	22	0	0
15	1194670	.	G	A	18	9	27	0	0	27	0	0
15	1209060	.	G	A	0	1	1	0	2	3	0	0
15	1682187	.	T	C	4	2	6	0	0	6	0	0
15	1730619	.	G	A	1	5	6	0	0	6	0	0
15	1730643	.	A	G	1	4	5	0	0	5	0	0
15	1733125	.	G	C	1	0	1	0	0	1	0	0
15	1749973	.	G	C	3	5	8	0	0	8	0	0
15	1749984	.	A	T	4	5	9	0	0	9	0	0
15	1753501	.	A	G	0	1	1	0	0	1	0	0
15	1766675	.	C	T	7	6	13	0	2	15	0	0
15	1774489	.	G	A	0	1	1	1	4	6	0	0
15	1782156	.	T	C	8	4	12	0	1	13	0	0
15	1828401	.	C	T	2	1	3	0	1	4	0	0
15	1830323	.	A	G	1	0	1	0	0	1	0	0
15	1847246	.	C	G	5	5	10	0	2	12	0	0
15	1847588	.	A	T	8	7	15	0	0	15	0	0
15	1847693	.	A	G	10	8	18	0	4	22	0	0
15	1847908	.	A	C	9	9	18	0	0	18	0	0
15	1847951	.	G	A	4	2	6	0	1	7	0	0
15	1848202	.	G	T	9	4	13	0	0	13	0	0
15	1848308	.	G	A	1	3	4	0	0	4	0	0
15	1848320	.	G	A	2	3	5	0	0	5	0	0
15	1848349	.	A	C	1	3	4	0	0	4	0	0
15	1848373	.	A	C	1	1	2	0	0	2	0	0
15	1850540	.	A	C	0	0	0	0	2	2	0	0
15	1853010	.	A	C	3	6	9	0	0	9	0	0
15	1853028	.	G	A	4	8	12	0	0	12	0	0
15	1858625	.	A	G	4	4	8	0	1	9	0	0
15	1858638	.	C	G	5	5	10	0	0	10	0	0
15	1858914	.	G	C	3	0	3	0	3	6	0	0
15	1859013	.	G	A	0	1	1	0	0	1	0	0
15	1862024	.	C	T	0	1	1	0	1	2	0	0
15	1869631	.	A	T	1	1	2	0	0	2	0	0
15	1869712	.	C	T	0	2	2	0	0	2	0	0
15	1871197	.	T	C	1	1	2	0	0	2	0	0
15	1871245	.	A	G	4	2	6	0	1	7	0	0
15	1871248	.	G	A	5	2	7	0	0	7	0	0
15	1893276	.	C	T	5	2	7	0	0	7	0	0
15	1893293	.	C	G	5	3	8	0	0	8	0	0
15	1893323	.	G	A	0	6	6	0	10	16	0	0
15	1893356	.	A	G	5	0	5	0	4	9	0	0
15	1894694	.	A	G	9	7	16	0	1	17	0	0
15	1895469	.	G	A	9	4	13	0	0	13	0	0
15	1895505	.	G	C	12	10	22	0	0	22	0	0
15	1897576	.	T	C	3	6	9	0	0	9	0	0
15	1898384	.	T	C	1	3	4	0	0	4	0	0
15	1899217	.	A	T	0	1	1	0	0	1	0	0
15	1899304	.	A	C	3	3	6	0	1	7	0	0
15	1899331	.	T	G	2	2	4	0	1	5	0	0
15	1899878	.	T	C	7	8	15	0	0	15	0	0
15	1902259	.	A	G	2	2	4	0	0	4	0	0
15	1905364	.	T	G	3	5	8	0	0	8	0	0
15	2182569	.	G	A	11	5	16	0	0	16	0	0
15	2182752	.	G	C	7	14	21	0	0	21	0	0
15	2182848	.	C	T	4	7	11	0	0	11	0	0
15	2414007	.	A	G	4	2	6	0	0	6	0	0
15	2414212	.	A	G	5	2	7	0	0	7	0	0
15	2414214	.	A	G	5	2	7	0	0	7	0	0
15	2414269	.	A	G	5	4	9	0	0	9	0	0
15	2414584	.	G	T	2	2	4	0	0	4	0	0
15	2414764	.	A	G	6	3	9	0	0	9	0	0
15	2415216	.	A	G	0	2	2	1	0	3	0	0
15	2415228	.	A	G	0	2	2	0	0	2	0	0
15	2729466	.	C	T	0	15	15	0	0	15	0	0
15	2730358	.	T	C	4	10	14	0	1	15	0	0
15	3089383	.	G	A	26	19	45	0	1	46	0	0
15	3089461	.	C	G	1	14	15	0	25	40	0	0
15	3091576	.	G	A	8	8	16	0	3	19	0	0
15	3160337	.	A	G	3	5	8	0	0	8	0	0
15	3161243	.	A	G	5	2	7	0	0	7	0	0
15	3377050	.	C	G	5	8	13	0	2	16	1	0
15	3781808	.	T	A	1	2	3	0	0	3	0	0
15	3899930	.	A	G	1	5	6	0	0	6	0	0
15	3900198	.	C	T	4	3	7	0	0	7	0	0
15	3900485	.	G	A	2	4	6	0	0	6	0	0
15	3920836	.	T	A	1	2	3	0	0	3	0	0
15	3921214	.	T	A	2	2	4	0	0	4	0	0
15	3921218	.	C	T	2	2	4	0	0	4	0	0
15	3921308	.	A	G	1	4	5	0	0	5	0	0
15	3921346	.	A	G	2	0	2	0	2	4	0	0
15	3921902	.	G	T	0	2	2	0	0	2	0	0
15	3922752	.	C	A	1	5	6	0	0	6	0	0
15	3922822	.	C	G	4	2	6	0	0	6	0	0
15	3922835	.	A	C	2	2	4	0	0	4	0	0
15	3923135	.	A	G	3	0	3	0	6	9	0	0
15	3923193	.	A	G	1	3	4	0	0	4	0	0
15	3924349	.	C	G	4	3	7	0	0	7	0	0
15	3925206	.	G	T	0	7	7	0	3	10	0	0
15	3927252	.	G	A	0	3	3	0	0	3	0	0
15	3927464	.	C	T	2	3	5	0	0	5	0	0
15	3927812	.	A	G	3	2	5	0	0	5	0	0
15	3927857	.	G	C	4	2	6	0	0	6	0	0
15	4105164	.	C	T	1	7	8	0	5	13	0	0
15	4105262	.	A	G	7	3	10	0	0	10	0	0
15	4105328	.	A	G	6	4	10	0	0	10	0	0
15	4105416	.	G	T	4	2	6	0	0	6	0	0
15	4111821	.	A	G	2	2	4	0	0	4	0	0
15	4112233	.	C	T	2	0	2	0	0	2	0	0
15	4123660	.	T	G	0	1	1	0	0	1	0	0
15	4172366	.	C	G	8	6	14	0	0	14	0	0
15	4172371	.	G	T	8	5	13	0	0	13	0	0
15	4172458	.	C	T	5	8	13	0	0	13	0	0
15	4172470	.	A	G	8	5	13	0	0	13	0	0
15	4174147	.	T	G	2	1	3	0	0	3	0	0
15	4174174	.	C	T	2	1	3	0	0	3	0	0
15	4174191	.	G	T	2	1	3	0	0	3	0	0
15	4177160	.	C	A	8	8	16	0	2	18	0	0
15	4180093	.	C	A	0	0	0	0	2	2	0	0
15	4182667	.	T	C	2	0	2	0	2	4	0	0
15	4182718	.	A	G	4	4	8	0	0	8	0	0
15	4190893	.	T	A	2	1	3	0	0	3	0	0
15	4202300	.	T	C	7	1	8	0	1	9	0	0
15	4202321	.	C	T	1	5	6	0	0	6	0	0
15	4314014	.	C	A	2	0	2	0	0	2	0	0
15	4353311	.	G	T	18	13	31	0	0	31	0	0
15	4353333	.	T	C	17	0	17	0	6	29	6	0
15	4353965	.	G	A	30	29	59	0	15	74	0	0
15	4354082	.	G	A	33	33	66	0	3	69	0	0
15	4371833	.	T	C	12	13	25	0	0	25	0	0
15	4371863	.	C	T	5	5	10	0	1	11	0	0
15	4376110	.	C	T	0	21	21	0	16	37	0	0
15	4415864	.	G	C	15	5	20	0	1	21	0	0
15	4422222	.	A	G	3	5	8	0	0	8	0	0
15	4422293	.	G	C	1	0	1	0	5	6	0	0
15	4422383	.	A	T	3	4	7	0	0	7	0	0
15	4422394	.	G	A	3	4	7	0	0	7	0	0
15	4426474	.	C	T	3	4	7	0	2	9	0	0
15	4983598	.	G	A	4	1	5	0	1	6	0	0
15	6515063	.	T	C	1	5	6	0	0	6	0	0
15	6519686	.	G	A	1	0	1	0	0	1	0	0
15	6525689	.	G	A	0	1	1	0	0	1	0	0
15	6529881	.	A	G	1	0	1	0	0	1	0	0
15	6529942	.	C	G	0	0	0	0	1	1	0	0
15	6541406	.	A	G	0	2	2	0	0	2	0	0
15	6558249	.	A	C	1	4	5	0	0	5	0	0
15	6559689	.	T	C	0	2	2	0	0	2	0	0
15	6574668	.	A	G	0	2	2	0	0	2	0	0
15	6579239	.	T	G	1	0	1	0	0	1	0	0
15	6652600	.	T	C	8	10	18	0	0	18	0	0
15	6653094	.	T	G	1	2	3	0	0	3	0	0
15	6653209	.	G	T	0	2	2	0	0	2	0	0
15	6654524	.	T	G	1	2	3	0	0	3	0	0
15	6654587	.	C	A	13	14	27	0	3	30	0	0
15	6659159	.	G	A	5	11	16	0	3	19	0	0
15	6661390	.	G	A	7	14	21	0	0	21	0	0
15	6661449	.	T	C	8	18	26	0	2	28	0	0
15	6661499	.	G	A	0	1	1	0	0	1	0	0
15	6727022	.	T	A	3	2	5	0	0	5	0	0
15	6778483	.	A	G	1	4	5	0	0	5	0	0
15	6778813	.	A	G	1	1	2	0	0	2	0	0
15	6778825	.	A	G	1	1	2	0	0	2	0	0
15	6778856	.	C	A	2	4	6	0	0	6	0	0
15	6778877	.	A	G	2	5	7	0	0	7	0	0
15	6784093	.	T	C	2	2	4	0	0	4	0	0
15	6799903	.	G	A	1	4	5	0	0	5	0	0
15	6806712	.	G	C	14	22	36	0	0	36	0	0
15	6806836	.	G	A	12	12	24	0	4	28	0	0
15	6806912	.	T	G	10	9	19	0	3	22	0	0
15	6806931	.	T	G	7	8	15	0	0	15	0	0
15	6807014	.	A	T	8	6	14	0	0	14	0	0
15	6807406	.	C	A	7	4	11	0	0	11	0	0
15	6807500	.	C	G	12	11	23	0	2	25	0	0
15	6807514	.	G	A	14	12	26	0	2	28	0	0
15	6807563	.	A	T	11	21	32	0	0	32	0	0
15	6807874	.	C	T	5	6	11	0	1	12	0	0
15	6838043	.	C	A	3	2	5	0	0	5	0	0
15	6838126	.	G	A	2	2	4	0	0	4	0	0
15	6838154	.	T	A	1	3	4	0	0	4	0	0
15	6838554	.	T	C	1	0	1	0	8	9	0	0
15	6838580	.	G	C	3	7	10	0	0	10	0	0
15	6838771	.	T	C	3	4	7	0	1	8	0	0
15	6838786	.	T	C	4	3	7	0	0	7	0	0
15	6841506	.	G	T	1	1	2	0	0	2	0	0
15	6845567	.	A	G	0	2	2	0	0	2	0	0
15	6845636	.	T	A	3	2	5	0	1	6	0	0
15	6863048	.	C	T	1	0	1	0	2	3	0	0
15	6863102	.	G	A	4	4	8	0	0	8	0	0
15	6957221	.	C	G	4	3	7	0	0	7	0	0
15	9235461	.	T	G	23	28	51	0	3	55	1	0
15	11670120	.	A	G	1	2	3	0	0	3	0	0
15	11681447	.	A	G	1	4	5	0	0	5	0	0
15	13107498	.	C	T	6	10	16	0	2	18	0	0
15	13107561	.	T	C	8	5	13	0	1	14	0	0
15	13107562	.	G	A	9	5	14	0	0	14	0	0
15	13127035	.	A	G	0	4	4	0	1	5	0	0
15	13127248	.	T	C	5	6	11	0	1	12	0	0
15	13129937	.	A	G	7	7	14	0	0	14	0	0
15	13207497	.	C	T	4	3	7	0	0	7	0	0
15	13207561	.	T	G	2	5	7	0	1	8	0	0
15	13207597	.	C	T	0	8	8	0	3	11	0	0
15	13207858	.	G	C	9	5	14	0	1	15	0	0
15	13207870	.	A	G	6	6	12	0	1	13	0	0
15	13208218	.	T	C	7	0	7	0	6	13	0	0
15	13253708	.	T	G	2	1	3	0	0	3	0	0
15	13985123	.	C	A	3	5	8	0	0	8	0	0
15	13985644	.	C	T	5	5	10	0	0	10	0	0
15	13985827	.	C	G	1	5	6	0	0	6	0	0
15	13986009	.	T	C	4	5	9	0	1	10	0	0
15	13986233	.	G	T	8	4	12	0	0	12	0	0
15	13986279	.	A	T	4	3	7	0	0	7	0	0
15	14076096	.	T	C	4	2	6	0	0	6	0	0
15	14076329	.	T	G	4	10	14	0	2	16	0	0
15	14076376	.	C	T	4	4	8	0	0	8	0	0
15	14076710	.	T	A	3	4	7	0	2	9	0	0
15	14079784	.	G	A	1	1	2	0	0	2	0	0
15	14079974	.	G	C	1	4	5	0	0	5	0	0
15	14082347	.	G	T	5	2	7	0	0	7	0	0
15	14083023	.	T	G	1	0	1	0	0	1	0	0
15	14085276	.	T	G	4	8	12	0	0	12	0	0
15	14085800	.	T	C	0	7	7	0	0	7	0	0
15	14085847	.	G	T	4	2	6	0	1	7	0	0
15	14085914	.	G	A	5	7	12	0	0	12	0	0
15	14088146	.	G	A	11	7	18	0	1	19	0	0
15	14088252	.	G	A	4	6	10	0	0	10	0	0
15	14088270	.	C	T	9	4	13	0	0	13	0	0
15	14092805	.	G	A	1	3	4	0	1	5	0	0
15	14092819	.	C	A	5	3	8	0	0	8	0	0
15	14093020	.	G	A	7	10	17	0	0	17	0	0
15	14093032	.	A	G	6	10	16	0	0	16	0	0
15	14093110	.	T	A	6	8	14	0	0	14	0	0
15	14093197	.	C	T	4	5	9	0	1	10	0	0
15	14098221	.	G	A	7	4	11	0	1	12	0	0
15	14206087	.	T	C	4	1	5	0	2	7	0	0
15	14206111	.	C	T	0	2	2	0	5	7	0	0
15	14206430	.	T	C	2	2	4	0	0	4	0	0
15	14206438	.	G	A	3	2	5	0	0	5	0	0
15	14206593	.	C	T	0	3	3	0	2	5	0	0
15	14206594	.	G	A	1	3	4	0	1	5	0	0
15	14206789	.	G	A	3	2	5	0	0	5	0	0
15	14207613	.	G	A	2	2	4	0	0	4	0	0
15	14207871	.	C	T	2	3	5	0	0	5	0	0
15	14207874	.	C	G	2	2	4	0	0	4	0	0
15	14208754	.	C	A	3	2	5	0	0	5	0	0
15	14209963	.	T	A	1	2	3	0	0	3	0	0
15	14303207	.	T	A	4	3	7	0	1	8	0	0
15	14317040	.	G	A	6	4	10	0	2	12	0	0
15	14321321	.	C	G	4	2	6	0	0	6	0	0
15	14321572	.	G	T	1	2	3	0	0	3	0	0
15	14384837	.	T	C	2	2	4	0	0	4	0	0
15	14385092	.	C	T	3	3	6	0	0	6	0	0
15	14385123	.	A	G	1	0	1	0	2	3	0	0
15	14388411	.	G	A	0	1	1	0	1	2	0	0
15	14388459	.	C	T	2	2	4	0	0	4	0	0
15	14388464	.	C	T	2	2	4	0	0	4	0	0
15	14388555	.	T	C	1	0	1	0	2	3	0	0
15	14388588	.	C	T	0	1	1	0	0	1	0	0
15	14417729	.	A	T	4	4	8	0	0	8	0	0
15	14419221	.	A	G	1	5	6	0	0	6	0	0
15	14436442	.	C	T	0	2	2	0	3	6	1	0
15	14436459	.	C	T	2	2	4	0	0	4	0	0
15	14436553	.	C	T	4	3	7	0	0	7	0	0
15	14436554	.	T	A	4	3	7	0	0	7	0	0
15	14436811	.	C	T	0	4	4	0	3	7	0	0
15	14437204	.	A	G	6	7	13	0	0	13	0	0
15	14437239	.	T	A	4	13	17	0	0	17	0	0
15	14443666	.	A	G	2	2	4	0	0	4	0	0
15	14446538	.	C	T	0	1	1	0	5	6	0	0
15	14446565	.	A	C	1	0	1	0	5	6	0	0
15	14554550	.	T	A	5	9	14	0	0	14	0	0
15	14554568	.	A	C	8	10	18	0	0	18	0	0
15	14557015	.	G	A	3	1	4	0	0	4	0	0
15	14557047	.	T	G	3	2	5	0	0	5	0	0
15	14564294	.	T	A	1	4	5	0	0	5	0	0
15	14570991	.	A	T	3	4	7	0	0	7	0	0
15	14571106	.	G	T	4	2	6	0	0	6	0	0
15	14571139	.	G	A	3	5	8	0	0	8	0	0
15	14576659	.	C	T	2	2	4	0	0	4	0	0
15	14592987	.	C	A	1	7	8	0	0	8	0	0
15	14597312	.	C	G	2	2	4	0	0	4	0	0
15	14597342	.	G	A	3	4	7	0	0	7	0	0
15	14597518	.	A	G	5	7	12	0	1	13	0	0
15	14597589	.	G	T	4	3	7	0	1	8	0	0
15	14597653	.	C	T	4	2	6	0	0	6	0	0
15	14597670	.	T	A	3	5	8	0	0	8	0	0
15	14597870	.	A	C	3	7	10	0	0	10	0	0
15	14597887	.	G	T	3	5	8	0	2	10	0	0
15	14597991	.	T	C	5	5	10	0	0	10	0	0
15	14598192	.	G	A	3	7	10	0	0	10	0	0
15	14598321	.	G	A	0	3	3	0	7	10	0	0
15	14598327	.	G	A	8	3	11	0	0	11	0	0
15	14598403	.	G	A	5	6	11	0	1	12	0	0
15	14598669	.	G	A	5	5	10	0	0	10	0	0
15	14598672	.	A	G	5	5	10	0	0	10	0	0
15	14598708	.	C	T	5	5	10	0	0	10	0	0
15	14598807	.	T	C	2	4	6	0	0	6	0	0
15	14598823	.	G	A	0	5	5	0	4	9	0	0
15	14598930	.	G	A	0	11	11	0	5	16	0	0
15	14599152	.	T	C	5	8	13	0	1	14	0	0
15	14599167	.	G	A	0	8	8	0	6	14	0	0
15	14599203	.	A	G	8	4	12	0	1	13	0	0
15	14599486	.	G	A	4	7	11	0	0	11	0	0
15	14630941	.	T	C	4	0	4	0	4	8	0	0
15	14631242	.	A	G	3	7	10	0	1	11	0	0
15	14631258	.	C	T	5	7	12	0	0	12	0	0
15	14631289	.	T	C	6	1	7	0	2	9	0	0
15	14631314	.	G	A	6	0	6	0	1	7	0	0
15	14631531	.	T	C	3	0	3	0	7	10	0	0
15	14631535	.	T	C	3	7	10	0	0	10	0	0
15	14631665	.	A	G	7	3	10	0	2	12	0	0
15	14631743	.	T	A	5	2	7	0	0	7	0	0
15	14631772	.	T	C	3	2	5	0	0	5	0	0
15	14631856	.	G	T	7	4	11	0	1	12	0	0
15	14631930	.	T	C	1	2	3	0	0	3	0	0
15	14631969	.	A	G	7	6	13	0	0	13	0	0
15	14632135	.	C	T	0	6	6	0	13	19	0	0
15	14632160	.	A	T	10	8	18	0	0	18	0	0
15	14632189	.	T	C	9	6	15	0	1	16	0	0
15	14632197	.	G	T	10	5	15	0	0	15	0	0
15	14632244	.	A	T	8	4	12	0	0	12	0	0
15	14632293	.	T	A	6	5	11	0	0	11	0	0
15	14632561	.	T	C	10	0	10	0	4	14	0	0
15	14632834	.	G	C	5	0	5	0	4	9	0	0
15	14632842	.	G	A	4	5	9	0	0	9	0	0
15	14633002	.	A	C	4	3	7	0	1	8	0	0
15	14633011	.	T	C	3	0	3	0	4	7	0	0
15	14633041	.	T	C	3	0	3	0	3	6	0	0
15	14633077	.	T	C	2	0	2	0	4	6	0	0
15	14633404	.	C	T	0	6	6	0	14	20	0	0
15	14633659	.	C	T	6	3	9	0	1	10	0	0
15	14633815	.	A	G	1	4	5	0	1	6	0	0
15	14633875	.	C	T	0	4	4	0	3	7	0	0
15	14633905	.	T	G	4	4	8	0	0	8	0	0
15	14633982	.	A	G	9	4	13	0	0	13	0	0
15	14634166	.	T	C	7	4	11	0	1	12	0	0
15	14634199	.	A	G	4	6	10	0	0	10	0	0
15	14634394	.	T	A	3	5	8	0	0	8	0	0
15	14634501	.	A	G	6	5	11	0	0	11	0	0
15	14636343	.	G	A	3	9	12	0	0	12	0	0
15	14636447	.	G	A	6	2	8	0	0	8	0	0
15	14636475	.	G	T	1	0	1	0	0	1	0	0
15	14638572	.	C	T	1	1	2	0	0	2	0	0
15	14638584	.	A	C	1	1	2	0	0	2	0	0
15	14639435	.	G	A	5	3	8	0	0	8	0	0
15	14641686	.	C	G	0	0	0	0	1	1	0	0
15	14641815	.	G	T	3	2	5	0	0	5	0	0
15	14641823	.	T	G	3	3	6	0	0	6	0	0
15	14641982	.	T	G	2	5	7	0	1	8	0	0
15	14651782	.	C	T	1	2	3	0	0	3	0	0
15	14665761	.	T	C	1	1	2	0	0	2	0	0
15	14666922	.	G	A	1	2	3	0	1	4	0	0
15	14855219	.	C	A	1	4	5	0	0	5	0	0
15	14855291	.	A	G	0	2	2	0	0	2	0	0
15	14856739	.	A	G	0	0	0	0	2	2	0	0
15	14856803	.	A	T	0	3	3	0	0	3	0	0
15	15349693	.	C	T	32	30	62	0	4	66	0	0
15	15349780	.	C	T	27	28	55	0	2	57	0	0
15	15349860	.	T	A	22	29	51	0	1	52	0	0
15	15403927	.	G	T	1	4	5	0	0	5	0	0
15	15407536	.	T	A	1	2	3	0	1	4	0	0
15	15415839	.	T	C	5	2	7	0	1	8	0	0
15	15415903	.	C	G	2	2	4	0	0	4	0	0
15	15445690	.	G	C	6	0	6	0	8	14	0	0
15	15445767	.	T	C	3	0	3	0	3	6	0	0
15	15446104	.	T	C	12	12	24	0	1	25	0	0
15	15446484	.	C	T	0	10	10	0	13	23	0	0
15	15446590	.	G	A	11	8	19	0	1	20	0	0
15	15446609	.	C	A	9	10	19	0	1	20	0	0
15	15447005	.	T	A	9	6	15	0	0	15	0	0
15	15447037	.	C	T	0	10	10	0	9	19	0	0
15	15447109	.	G	A	6	9	15	0	2	17	0	0
15	15447118	.	T	C	6	1	7	0	10	17	0	0
15	15447236	.	A	G	1	3	4	0	0	4	0	0
15	15448975	.	A	G	4	1	5	0	0	5	0	0
15	15449395	.	G	C	7	6	13	0	0	13	0	0
15	15460593	.	A	G	2	1	3	0	0	3	0	0
15	15469045	.	T	C	1	4	5	0	0	5	0	0
15	15513569	.	G	A	3	2	5	0	0	5	0	0
15	15513571	.	A	G	2	2	4	0	1	5	0	0
15	15587093	.	C	T	7	13	20	0	1	21	0	0
15	15587117	.	C	T	9	8	17	0	1	18	0	0
15	15589504	.	C	T	8	8	16	0	0	16	0	0
15	15591868	.	T	A	15	10	25	0	1	26	0	0
15	15592318	.	G	A	15	21	36	0	1	37	0	0
15	15592332	.	C	G	12	1	13	0	22	35	0	0
15	15592504	.	C	T	17	13	30	0	1	31	0	0
15	15592537	.	A	T	13	11	24	0	1	25	0	0
15	15592629	.	T	C	7	16	23	0	1	24	0	0
15	15592641	.	C	G	8	0	8	0	18	26	0	0
15	15592784	.	C	A	15	7	22	0	1	23	0	0
15	15592879	.	C	T	6	7	13	0	0	13	0	0
15	15592991	.	G	A	18	13	31	0	0	31	0	0
15	15593128	.	G	A	11	7	18	0	1	19	0	0
15	15786270	.	C	T	4	7	11	0	0	11	0	0
15	15786463	.	A	C	1	0	1	0	0	1	0	0
15	15789683	.	G	A	4	0	4	0	0	4	0	0
15	15810922	.	G	C	0	6	6	0	7	13	0	0
15	15813810	.	C	T	5	11	16	0	0	16	0	0
15	15819345	.	C	T	1	8	9	0	0	9	0	0
15	15856342	.	T	A	1	2	3	0	0	3	0	0
15	15876974	.	T	C	5	13	18	0	0	18	0	0
15	15877019	.	T	C	6	10	16	0	0	16	0	0
15	15877600	.	G	A	8	14	22	0	0	22	0	0
15	15877616	.	G	C	8	13	21	0	0	21	0	0
15	15886202	.	C	A	13	3	16	0	0	16	0	0
15	15886346	.	A	G	5	4	9	0	0	9	0	0
15	15886461	.	A	T	2	13	15	0	1	16	0	0
15	15886491	.	A	C	5	6	11	0	0	11	0	0
15	15886502	.	A	G	3	6	9	0	0	9	0	0
15	15886564	.	A	G	7	4	11	0	1	12	0	0
15	15886701	.	C	T	0	2	2	0	4	6	0	0
15	15886803	.	C	T	0	9	9	0	14	23	0	0
15	15886806	.	T	C	9	12	21	0	1	22	0	0
15	15906718	.	G	A	2	4	6	0	0	6	0	0
15	15906766	.	C	T	5	7	12	0	1	13	0	0
15	15916216	.	G	A	7	10	17	0	0	17	0	0
15	15923499	.	G	A	12	8	20	0	1	21	0	0
15	15923577	.	G	A	11	3	14	0	0	14	0	0
15	15923616	.	G	A	12	7	19	0	1	20	0	0
15	15923628	.	C	G	1	7	8	0	15	23	0	0
15	15923697	.	T	G	7	5	12	0	2	14	0	0
15	15944045	.	C	T	0	11	11	0	7	18	0	0
15	15944102	.	G	A	6	7	13	0	0	13	0	0
15	15944129	.	G	A	4	12	16	0	0	16	0	0
15	15944287	.	G	A	5	11	16	0	1	17	0	0
15	15944435	.	G	A	8	6	14	0	0	14	0	0
15	15944465	.	A	G	6	9	15	0	0	15	0	0
15	15947466	.	G	A	4	4	8	0	0	8	0	0
15	15949872	.	T	C	4	0	4	0	3	7	0	0
15	15950223	.	A	C	8	5	13	0	1	14	0	0
15	15953681	.	C	A	2	0	2	0	0	2	0	0
15	16066453	.	A	G	28	21	49	0	1	50	0	0
15	16066459	.	C	T	28	21	49	0	1	50	0	0
15	16066508	.	C	T	0	28	28	0	25	53	0	0
15	16067051	.	G	A	26	31	57	0	1	58	0	0
15	16072281	.	A	C	15	24	39	0	1	40	0	0
15	16072690	.	T	C	23	15	38	0	0	38	0	0
15	16072822	.	T	A	20	18	38	0	2	40	0	0
15	16073046	.	C	A	9	7	16	0	0	16	0	0
15	16073055	.	A	C	7	5	12	0	1	13	0	0
15	16073081	.	A	G	8	7	15	0	5	20	0	0
15	16076221	.	A	C	5	3	8	0	0	8	0	0
15	16079597	.	G	A	0	2	2	0	1	3	0	0
15	16079709	.	T	G	16	15	31	0	0	32	1	0
15	16079733	.	G	T	18	17	35	0	1	36	0	0
15	16080258	.	G	A	19	23	42	0	1	43	0	0
15	16086528	.	G	A	0	5	5	0	0	5	0	0
15	16086600	.	G	T	27	27	54	0	2	56	0	0
15	16094383	.	G	A	16	10	26	0	2	28	0	0
15	16094672	.	C	T	0	14	14	0	12	26	0	0
15	16101332	.	G	A	3	4	7	0	0	7	0	0
15	16101357	.	G	A	5	5	10	0	0	10	0	0
15	16104912	.	G	A	0	1	1	0	0	1	0	0
15	16123356	.	C	T	1	7	8	0	0	8	0	0
15	16123358	.	A	G	7	1	8	0	0	8	0	0
15	16123735	.	G	C	8	6	14	0	2	16	0	0
15	16123873	.	G	A	3	9	12	0	0	12	0	0
15	16123921	.	T	C	5	7	12	0	0	12	0	0
15	16124008	.	T	A	6	11	17	0	1	18	0	0
15	16124125	.	G	A	5	5	10	0	0	10	0	0
15	16124210	.	C	T	0	2	2	0	7	9	0	0
15	16125799	.	T	C	1	4	5	0	0	5	0	0
15	16127139	.	C	T	4	2	6	0	0	6	0	0
15	16130244	.	G	A	4	3	7	0	0	7	0	0
15	16136073	.	A	G	3	4	7	0	0	7	0	0
15	16139042	.	T	C	2	0	2	0	0	2	0	0
15	16142225	.	C	T	2	0	2	0	2	4	0	0
15	16142340	.	T	C	4	0	4	0	6	10	0	0
15	16143969	.	A	G	0	1	1	0	0	1	0	0
15	16144053	.	T	C	2	0	2	0	3	5	0	0
15	16144086	.	G	A	2	4	6	0	0	6	0	0
15	16148277	.	C	T	5	2	7	0	0	7	0	0
15	16149660	.	C	T	2	2	4	0	0	4	0	0
15	16150230	.	G	T	2	4	6	0	0	6	0	0
15	16150254	.	C	T	2	3	5	0	0	5	0	0
15	16152470	.	C	T	4	3	7	0	0	7	0	0
15	16152683	.	G	A	1	2	3	0	0	3	0	0
15	16183479	.	C	T	15	14	29	0	1	30	0	0
15	16194155	.	A	T	5	15	20	0	0	20	0	0
15	16194208	.	G	A	11	2	13	0	0	13	0	0
15	16194222	.	G	T	7	3	10	0	1	11	0	0
15	16194254	.	G	C	7	7	14	0	0	14	0	0
15	16194369	.	G	A	17	12	29	0	0	29	0	0
15	16194741	.	T	A	12	19	31	0	1	32	0	0
15	16226598	.	G	A	3	2	5	0	1	6	0	0
15	16323480	.	A	G	6	5	11	0	0	11	0	0
15	16323568	.	T	A	7	10	17	0	1	18	0	0
15	16328623	.	C	T	12	7	19	0	2	21	0	0
15	16332592	.	C	T	2	2	4	0	0	4	0	0
15	16332643	.	T	A	2	2	4	0	0	4	0	0
15	16332844	.	C	A	10	8	18	0	0	18	0	0
15	16377555	.	C	T	8	4	12	0	0	12	0	0
15	16378885	.	C	T	0	4	4	0	5	9	0	0
15	16380097	.	A	T	3	2	5	0	0	5	0	0
15	16380377	.	A	G	6	5	11	0	1	12	0	0
15	16380457	.	T	C	2	3	5	0	0	5	0	0
15	16381349	.	G	T	1	2	3	0	0	3	0	0
15	16398241	.	T	G	0	0	0	0	1	1	0	0
15	16398265	.	T	C	3	4	7	0	0	7	0	0
15	16401668	.	A	G	2	0	2	0	1	3	0	0
15	16406279	.	T	C	1	0	1	0	0	1	0	0
15	16407128	.	G	T	3	4	7	0	0	7	0	0
15	16407354	.	A	G	10	7	17	0	1	18	0	0
15	16407575	.	G	T	8	9	17	0	0	17	0	0
15	16407723	.	G	A	13	13	26	0	0	26	0	0
15	16935759	.	G	T	8	11	19	0	0	19	0	0
15	16935806	.	C	T	5	5	10	0	0	10	0	0
15	16935867	.	C	T	5	10	15	0	1	16	0	0
15	16936271	.	C	T	3	3	6	0	0	6	0	0
15	16936358	.	A	C	1	2	3	0	0	3	0	0
15	16936495	.	A	T	5	6	11	0	0	11	0	0
15	16936716	.	C	T	6	5	11	0	0	11	0	0
15	16937375	.	T	C	2	8	10	0	0	10	0	0
15	16937653	.	T	C	2	3	5	0	2	7	0	0
15	16937662	.	T	C	1	0	1	0	6	7	0	0
15	16937702	.	T	C	8	0	8	0	3	11	0	0
15	16938166	.	A	G	4	5	9	0	2	11	0	0
15	16939218	.	G	C	10	0	10	0	6	16	0	0
15	16939588	.	G	A	1	0	1	0	1	2	0	0
15	16944167	.	T	C	7	2	9	0	0	9	0	0
15	16944173	.	T	C	7	3	10	0	0	10	0	0
15	16944350	.	T	C	0	3	3	0	0	3	0	0
15	16946113	.	T	C	2	4	6	0	0	6	0	0
15	16946533	.	A	G	1	2	3	0	0	3	0	0
15	16946592	.	A	G	1	3	4	0	0	4	0	0
15	16948484	.	T	C	1	2	3	0	1	4	0	0
15	16948565	.	T	C	1	0	1	0	5	6	0	0
15	17081226	.	T	C	0	2	2	0	1	3	0	0
15	17085012	.	T	A	8	16	24	0	0	24	0	0
15	17091003	.	C	T	5	4	9	0	0	9	0	0
15	17091030	.	G	A	4	2	6	0	0	6	0	0
15	17091418	.	G	A	1	5	6	0	8	14	0	0
15	17095457	.	C	T	19	18	37	0	2	39	0	0
15	17100575	.	C	T	1	3	4	0	0	4	0	0
15	17112155	.	C	T	1	1	2	0	0	2	0	0
15	17112170	.	G	A	0	1	1	0	0	1	0	0
15	17114640	.	A	T	1	7	8	0	0	8	0	0
15	17117724	.	T	C	3	3	6	0	0	6	0	0
15	17117949	.	A	G	2	1	3	0	0	3	0	0
15	17122535	.	A	C	5	7	12	0	0	12	0	0
15	17122563	.	T	C	3	2	5	0	0	5	0	0
15	17123012	.	T	C	5	8	13	0	0	13	0	0
15	17123040	.	G	T	6	3	9	0	1	10	0	0
15	17123063	.	A	G	4	2	6	0	0	6	0	0
15	17123191	.	A	G	7	6	13	0	0	13	0	0
15	17123193	.	A	G	6	5	11	0	2	13	0	0
15	17123290	.	A	G	2	15	17	0	0	17	0	0
15	17123937	.	T	A	8	9	17	0	0	17	0	0
15	17123968	.	C	A	14	11	25	0	1	26	0	0
15	17124011	.	A	G	17	11	28	0	1	29	0	0
15	17124012	.	C	G	17	11	28	0	1	29	0	0
15	17124084	.	A	G	17	6	23	0	2	25	0	0
15	17124124	.	C	A	12	6	18	0	1	19	0	0
15	17124246	.	A	G	5	7	12	0	1	13	0	0
15	17124253	.	G	T	8	3	11	0	1	12	0	0
15	17124283	.	A	G	11	3	14	0	0	14	0	0
15	17124296	.	A	G	9	2	11	0	0	11	0	0
15	17124402	.	T	A	2	2	4	0	0	4	0	0
15	17124403	.	G	A	2	2	4	0	0	4	0	0
15	17124437	.	A	C	2	4	6	0	0	6	0	0
15	17124439	.	T	G	2	4	6	0	0	6	0	0
15	17124484	.	T	A	3	5	8	0	2	10	0	0
15	17124580	.	A	G	7	8	15	0	0	15	0	0
15	17124586	.	C	T	7	8	15	0	0	15	0	0
15	17124654	.	T	G	6	4	10	0	0	10	0	0
15	17124768	.	G	C	9	5	14	0	0	14	0	0
15	17124884	.	T	C	7	6	13	0	0	13	0	0
15	17125033	.	A	G	3	5	8	0	0	8	0	0
15	17125102	.	A	T	5	3	8	0	0	8	0	0
15	17125108	.	C	T	4	3	7	0	0	7	0	0
15	17128418	.	T	C	5	1	6	0	8	14	0	0
15	17128468	.	G	A	3	4	7	0	0	7	0	0
15	17131785	.	C	T	12	5	17	0	0	17	0	0
15	17134701	.	C	T	0	17	17	0	13	30	0	0
15	17147012	.	A	G	9	11	20	0	0	20	0	0
15	17147400	.	G	A	9	10	19	0	0	19	0	0
15	17151085	.	T	A	2	6	8	0	0	8	0	0
15	17168668	.	G	A	0	4	4	0	0	4	0	0
15	17268091	.	G	A	3	1	4	0	0	4	0	0
15	17299682	.	T	C	0	3	3	0	0	3	0	0
15	17308206	.	C	A	5	7	12	0	0	12	0	0
15	17308378	.	T	C	9	2	11	0	0	11	0	0
15	17312080	.	T	C	9	7	16	0	1	17	0	0
15	17312299	.	G	A	9	12	21	0	0	21	0	0
15	17312386	.	G	A	1	8	9	0	5	14	0	0
15	17314889	.	C	T	6	2	8	0	0	8	0	0
15	17317008	.	T	A	11	21	32	0	1	33	0	0
15	17317044	.	C	T	10	15	25	0	1	26	0	0
15	17317089	.	T	A	2	2	4	0	1	5	0	0
15	17318566	.	T	C	12	17	29	0	1	30	0	0
15	17319345	.	C	T	7	13	20	0	0	20	0	0
15	17320851	.	T	C	21	22	43	0	0	43	0	0
15	17321164	.	A	G	2	2	4	0	0	4	0	0
15	17321302	.	A	T	1	3	4	0	0	4	0	0
15	17324793	.	C	T	8	11	19	0	0	19	0	0
15	17327501	.	C	T	22	33	55	0	7	62	0	0
15	17339078	.	C	T	25	35	60	0	2	62	0	0
15	17339719	.	T	C	23	20	43	0	1	44	0	0
15	17340104	.	A	C	8	10	18	0	0	18	0	0
15	17348035	.	T	C	2	4	6	0	0	6	0	0
15	17372580	.	C	A	14	9	23	0	1	24	0	0
15	17372721	.	A	T	3	3	6	0	4	10	0	0
15	17372934	.	C	T	9	4	13	0	0	13	0	0
15	17423913	.	A	C	9	10	19	0	1	20	0	0
15	17424011	.	T	C	8	14	22	0	0	22	0	0
15	17424185	.	T	G	8	9	17	0	0	17	0	0
15	17424397	.	G	A	9	3	12	0	0	12	0	0
15	17424472	.	A	T	7	11	18	0	3	21	0	0
15	17424493	.	T	C	4	7	11	0	1	12	0	0
15	17424515	.	A	T	6	12	18	0	0	18	0	0
15	17443677	.	T	C	2	3	5	0	0	5	0	0
15	17443968	.	G	A	3	4	7	0	0	7	0	0
15	17443969	.	T	G	3	4	7	0	0	7	0	0
15	17444203	.	T	C	9	8	17	0	0	17	0	0
15	17444227	.	A	G	11	9	20	0	0	20	0	0
15	17444262	.	G	C	12	9	21	0	0	21	0	0
15	17444284	.	A	C	13	7	20	0	3	23	0	0
15	17444385	.	A	C	2	3	5	0	0	5	0	0
15	17444428	.	C	T	5	4	9	0	0	9	0	0
15	17444533	.	A	C	5	9	14	0	0	14	0	0
15	17444569	.	C	T	8	3	11	0	1	12	0	0
15	17444632	.	T	C	5	3	8	0	0	8	0	0
15	17445606	.	G	A	7	4	11	0	1	12	0	0
15	17445618	.	T	A	7	5	12	0	0	12	0	0
15	17446854	.	C	T	5	3	8	0	1	9	0	0
15	17486317	.	A	C	3	7	10	0	1	11	0	0
15	17486388	.	G	T	5	8	13	0	1	14	0	0
15	17486576	.	C	A	6	14	20	0	0	20	0	0
15	17486715	.	C	T	9	11	20	0	0	20	0	0
15	17486725	.	G	T	8	7	15	0	0	15	0	0
15	17487386	.	C	T	13	8	21	0	2	23	0	0
15	17487544	.	A	G	13	8	21	0	0	21	0	0
15	17487717	.	T	A	8	10	18	0	0	18	0	0
15	17488513	.	C	T	7	12	19	0	1	20	0	0
15	17488672	.	A	G	17	9	26	0	0	26	0	0
15	17488698	.	A	T	16	9	25	0	2	27	0	0
15	17488834	.	A	C	12	14	26	0	0	26	0	0
15	17489033	.	C	T	11	5	16	0	1	17	0	0
15	17489049	.	A	T	12	2	14	0	1	15	0	0
15	17489165	.	G	A	0	11	11	1	7	19	0	0
15	17489191	.	A	G	4	0	4	1	7	12	0	0
15	17489203	.	G	A	0	5	5	0	5	10	0	0
15	17489360	.	A	C	17	15	32	0	1	33	0	0
15	17489440	.	G	C	13	17	30	0	0	30	0	0
15	17489505	.	G	A	9	9	18	0	3	21	0	0
15	17489573	.	G	T	3	2	5	0	2	7	0	0
15	17489575	.	C	G	3	2	5	0	2	7	0	0
15	17866976	.	T	C	14	10	24	0	0	24	0	0
15	17867929	.	A	G	10	9	19	0	4	23	0	0
15	17868250	.	G	A	9	9	18	0	2	20	0	0
15	17868448	.	T	C	9	14	23	0	0	23	0	0
15	17868601	.	T	G	7	5	12	0	1	13	0	0
15	17948414	.	C	G	2	3	5	0	0	5	0	0
15	17948534	.	C	T	6	3	9	0	0	9	0	0
15	17948616	.	C	G	5	9	14	0	0	14	0	0
15	17948786	.	C	G	4	5	9	0	0	9	0	0
15	17948852	.	G	C	5	3	8	0	0	8	0	0
15	17948898	.	T	C	5	2	7	0	0	7	0	0
15	17949100	.	C	T	2	5	7	0	0	7	0	0
15	17949142	.	C	G	3	5	8	0	0	8	0	0
15	17949163	.	C	T	5	3	8	0	0	8	0	0
15	17949252	.	A	G	3	3	6	0	0	6	0	0
15	17960032	.	C	T	6	3	9	0	0	9	0	0
15	17966672	.	C	T	1	1	2	0	0	2	0	0
15	17995659	.	T	C	5	2	7	0	0	7	0	0
15	18102357	.	T	C	3	4	7	0	0	7	0	0
15	18102777	.	C	G	13	11	24	0	0	24	0	0
15	18102898	.	T	C	15	12	27	0	0	27	0	0
15	18103009	.	T	A	4	9	13	0	2	15	0	0
15	18103248	.	T	C	11	9	20	0	0	20	0	0
15	18103363	.	G	A	5	6	11	0	2	13	0	0
15	18106754	.	A	G	2	2	4	0	0	4	0	0
15	18107049	.	A	G	5	7	12	0	0	12	0	0
15	18107081	.	G	A	3	4	7	0	0	7	0	0
15	18111448	.	C	T	0	1	1	0	0	1	0	0
15	18115551	.	T	C	3	9	12	0	0	12	0	0
15	18130119	.	G	A	5	12	17	0	1	18	0	0
15	18130190	.	A	G	10	9	19	0	2	21	0	0
15	18130202	.	A	G	11	0	11	0	12	23	0	0
15	18130305	.	T	C	4	12	16	0	0	16	0	0
15	18141117	.	G	A	13	14	27	0	0	27	0	0
15	18148889	.	G	A	11	13	24	0	1	25	0	0
15	18148892	.	A	G	11	12	23	0	1	24	0	0
15	18148928	.	A	G	4	1	5	0	2	7	0	0
15	18151095	.	G	A	1	2	3	0	0	3	0	0
15	18155273	.	C	T	11	8	19	0	0	19	0	0
15	18155297	.	T	C	14	11	25	0	1	26	0	0
15	18155322	.	G	T	13	11	24	0	0	24	0	0
15	18155342	.	T	A	12	12	24	0	0	24	0	0
15	18155392	.	G	A	8	12	20	0	0	20	0	0
15	18155394	.	C	T	8	11	19	0	1	20	0	0
15	18155588	.	C	T	14	6	20	0	1	21	0	0
15	18155638	.	G	A	18	11	29	0	1	30	0	0
15	18155730	.	A	G	19	18	37	0	0	38	1	0
15	18253900	.	G	A	7	10	17	0	1	18	0	0
15	18254148	.	G	A	8	8	16	0	0	16	0	0
15	18254777	.	C	G	0	8	8	0	16	24	0	0
15	18254821	.	T	A	11	10	21	0	1	22	0	0
15	18254985	.	C	T	19	6	25	0	0	25	0	0
15	18255292	.	A	G	10	11	21	0	1	22	0	0
15	18255653	.	T	C	4	5	9	0	0	9	0	0
15	18255802	.	C	T	4	3	7	0	0	7	0	0
15	18256261	.	T	A	5	4	9	0	0	9	0	0
15	18256541	.	T	A	5	3	8	0	0	8	0	0
15	18257167	.	T	A	4	2	6	0	0	6	0	0
15	18257180	.	A	G	2	2	4	0	0	4	0	0
15	18257434	.	A	T	7	8	15	0	3	18	0	0
15	18257692	.	A	T	7	6	13	0	0	13	0	0
15	18257743	.	T	C	5	4	9	0	0	9	0	0
15	18257754	.	A	G	5	4	9	0	1	10	0	0
15	18258174	.	A	C	2	3	5	0	0	5	0	0
15	18258279	.	G	A	4	6	10	0	0	10	0	0
15	18258947	.	A	C	4	0	4	0	6	10	0	0
15	18259036	.	T	G	3	2	5	0	0	5	0	0
15	18259143	.	G	A	3	4	7	0	0	7	0	0
15	18259585	.	G	T	1	3	4	0	0	4	0	0
15	18259660	.	C	A	1	2	3	0	0	3	0	0
15	18259687	.	C	T	0	3	3	0	2	5	0	0
15	18324886	.	G	A	1	1	2	0	0	2	0	0
15	18358168	.	A	G	1	2	3	0	0	3	0	0
15	18358186	.	A	G	2	2	4	0	0	4	0	0
15	18358435	.	G	A	8	5	13	0	1	14	0	0
15	18358999	.	A	G	2	1	3	0	1	4	0	0
15	18359008	.	T	C	2	3	5	0	1	6	0	0
15	18368983	.	G	A	3	2	5	0	0	5	0	0
15	18371336	.	A	T	2	2	4	0	2	6	0	0
15	18371418	.	T	A	5	12	17	0	0	17	0	0
15	18371509	.	C	T	7	7	14	0	0	14	0	0
15	18371522	.	A	G	7	8	15	0	1	16	0	0
15	18371789	.	T	C	13	1	14	0	8	22	0	0
15	18389548	.	T	C	1	5	6	0	0	6	0	0
15	18389662	.	C	A	0	2	2	0	2	4	0	0
15	18401240	.	G	T	8	10	18	0	0	18	0	0
15	18401270	.	A	G	4	7	11	0	0	11	0	0
15	18426315	.	G	A	6	6	12	0	1	13	0	0
15	18429123	.	T	C	5	0	5	0	7	12	0	0
15	18429526	.	T	C	2	0	2	0	1	3	0	0
15	18469599	.	A	G	1	3	4	0	1	5	0	0
15	18481100	.	G	A	0	4	4	0	0	4	0	0
15	18481130	.	G	A	0	1	1	0	0	1	0	0
15	18482944	.	G	A	0	2	2	0	0	2	0	0
15	18574608	.	C	T	4	3	7	0	0	7	0	0
15	18863936	.	C	T	3	1	4	0	0	4	0	0
15	18988023	.	A	T	1	2	3	0	0	3	0	0
15	19037534	.	A	G	9	8	17	0	1	18	0	0
15	19037618	.	A	G	12	11	23	0	1	24	0	0
15	19037626	.	G	C	14	9	23	0	1	24	0	0
15	19037787	.	G	C	3	6	9	0	1	10	0	0
15	19037895	.	T	C	4	6	10	0	1	11	0	0
15	19038143	.	G	T	3	10	13	0	0	13	0	0
15	19038218	.	G	A	4	17	21	0	0	21	0	0
15	19039025	.	A	G	10	9	19	0	0	19	0	0
15	19039667	.	T	C	8	0	8	0	5	13	0	0
15	19039874	.	A	G	2	5	7	0	1	8	0	0
15	19039985	.	C	A	6	3	9	0	0	9	0	0
15	19042070	.	C	T	4	5	9	0	0	9	0	0
15	19042213	.	A	C	9	10	19	0	0	19	0	0
15	19042347	.	C	T	0	8	8	0	5	13	0	0
15	19045649	.	A	G	1	0	1	0	2	3	0	0
15	19045871	.	C	T	4	10	14	0	1	15	0	0
15	19045886	.	T	C	2	8	10	0	3	13	0	0
15	19051093	.	A	C	1	2	3	0	1	4	0	0
15	19061952	.	T	C	4	1	5	0	0	5	0	0
15	19113687	.	G	C	0	1	1	0	0	1	0	0
15	19132077	.	A	G	18	16	34	0	2	36	0	0
15	19132178	.	G	A	16	9	25	0	2	27	0	0
15	19132203	.	A	T	13	14	27	0	1	28	0	0
15	19132659	.	G	T	7	3	10	0	0	10	0	0
15	19132667	.	T	C	9	0	9	0	3	12	0	0
15	19133310	.	C	T	10	9	19	0	0	19	0	0
15	19133374	.	G	T	9	12	21	0	1	22	0	0
15	19133437	.	A	T	19	15	34	0	1	35	0	0
15	19133647	.	C	T	9	22	31	0	2	33	0	0
15	19133750	.	A	G	14	19	33	0	1	34	0	0
15	19134109	.	T	C	7	0	7	0	10	17	0	0
15	19134710	.	G	A	3	5	8	0	0	8	0	0
15	19134905	.	C	A	5	5	10	0	1	11	0	0
15	19135009	.	T	C	2	3	5	0	1	6	0	0
15	19135122	.	A	G	5	2	7	0	1	8	0	0
15	19135304	.	T	C	6	6	12	0	0	12	0	0
15	19135351	.	G	A	7	7	14	0	1	15	0	0
15	19139757	.	C	T	0	14	14	0	8	22	0	0
15	19146896	.	T	C	2	4	6	0	0	6	0	0
15	19147330	.	G	A	5	3	8	0	0	8	0	0
15	19170879	.	C	T	1	0	1	0	0	1	0	0
15	19175049	.	T	C	1	0	1	0	1	2	0	0
15	19175055	.	T	C	1	0	1	0	1	2	0	0
15	19250469	.	G	C	1	3	4	0	0	4	0	0
15	19293919	.	G	T	15	8	23	0	0	23	0	0
15	19293920	.	G	T	15	8	23	0	0	23	0	0
15	19311505	.	G	T	0	1	1	0	3	4	0	0
15	19311631	.	C	T	17	8	25	0	1	26	0	0
15	19312545	.	G	A	2	2	4	0	0	4	0	0
15	19316500	.	G	T	10	5	15	0	0	15	0	0
15	19316573	.	T	C	5	2	7	0	0	7	0	0
15	19317301	.	A	C	3	2	5	0	0	5	0	0
15	19318445	.	T	G	4	0	4	0	5	9	0	0
15	19318513	.	T	A	5	8	13	0	0	13	0	0
15	19319128	.	A	C	1	4	5	0	1	6	0	0
15	19319227	.	C	G	5	5	10	0	1	11	0	0
15	19319250	.	T	C	4	6	10	0	0	10	0	0
15	19319272	.	G	C	3	5	8	0	0	8	0	0
15	19319376	.	C	T	7	8	15	0	0	15	0	0
15	19319429	.	G	A	5	2	7	0	0	7	0	0
15	19319613	.	A	G	6	6	12	0	0	12	0	0
15	19319691	.	A	T	1	2	3	0	1	4	0	0
15	19324762	.	T	A	8	5	13	0	0	13	0	0
15	19327602	.	C	G	1	0	1	0	0	1	0	0
15	19327665	.	G	A	0	8	8	0	3	11	0	0
15	19328334	.	G	A	6	4	10	0	1	11	0	0
15	19329908	.	G	A	7	8	15	0	0	15	0	0
15	19329962	.	T	C	3	5	8	0	2	10	0	0
15	19330408	.	C	T	7	9	16	0	0	16	0	0
15	19330607	.	T	A	7	6	13	0	0	13	0	0
15	19330745	.	T	A	5	3	8	0	0	8	0	0
15	19330748	.	C	A	5	3	8	0	0	8	0	0
15	19337247	.	A	C	6	6	12	0	0	12	0	0
15	19339789	.	T	A	2	4	6	0	0	6	0	0
15	19472290	.	G	A	8	4	12	0	0	12	0	0
15	19482640	.	G	A	3	2	5	0	0	5	0	0
15	19482661	.	G	T	0	1	1	0	4	5	0	0
15	19482724	.	C	T	2	1	3	0	0	3	0	0
15	19482748	.	C	T	1	2	3	0	0	3	0	0
15	19522052	.	C	T	5	4	9	0	0	9	0	0
15	19522085	.	T	C	1	2	3	0	0	3	0	0
15	19544143	.	T	C	1	2	3	0	0	3	0	0
15	19574919	.	C	T	1	1	2	0	0	2	0	0
15	19577072	.	C	T	5	4	9	0	0	9	0	0
15	19577242	.	G	A	1	6	7	0	1	8	0	0
15	19583841	.	C	T	11	4	15	0	1	16	0	0
15	19584132	.	G	T	4	0	4	0	0	4	0	0
15	19584187	.	T	C	11	8	19	0	0	19	0	0
15	19595508	.	C	T	9	3	12	0	0	12	0	0
15	19595509	.	T	G	3	0	3	0	9	12	0	0
15	19595782	.	G	A	7	8	15	0	0	15	0	0
15	19600214	.	C	T	8	9	17	0	2	19	0	0
15	19600390	.	A	T	1	6	7	0	0	7	0	0
15	19661619	.	A	T	8	7	15	0	0	15	0	0
15	19661664	.	T	A	10	13	23	0	1	24	0	0
15	19661756	.	T	A	19	11	30	0	0	30	0	0
15	19661820	.	G	T	18	13	31	0	0	31	0	0
15	19668105	.	C	T	0	1	1	0	4	5	0	0
15	19668276	.	C	T	1	7	8	0	8	16	0	0
15	19668375	.	G	A	9	14	23	0	0	23	0	0
15	19668585	.	A	G	6	10	16	0	1	17	0	0
15	19668638	.	T	G	1	1	2	0	0	2	0	0
15	19674676	.	G	A	4	6	10	0	0	10	0	0
15	19727331	.	C	T	1	2	3	0	0	3	0	0
15	19727992	.	G	C	2	4	6	0	0	6	0	0
15	19728127	.	A	T	10	6	16	0	1	17	0	0
15	19728307	.	C	T	18	21	39	0	1	40	0	0
15	19772261	.	C	A	1	9	10	0	7	17	0	0
15	19875030	.	G	A	0	1	1	0	1	2	0	0
15	19878869	.	G	A	1	2	3	0	0	3	0	0
15	19878877	.	C	A	2	2	4	0	0	4	0	0
15	19891082	.	A	T	7	5	12	0	0	12	0	0
15	19892083	.	G	A	0	9	9	0	4	13	0	0
15	19893465	.	A	G	12	0	12	0	19	31	0	0
15	19893876	.	G	T	0	4	4	0	7	11	0	0
15	19895304	.	T	A	9	7	16	0	1	17	0	0
15	19896052	.	A	C	12	15	27	0	0	27	0	0
15	19896072	.	C	A	10	14	24	0	1	25	0	0
15	19896589	.	C	T	9	5	14	0	0	14	0	0
15	19906969	.	A	C	1	4	5	0	2	7	0	0
15	19907082	.	G	A	4	2	6	0	0	6	0	0
15	19907083	.	A	G	4	2	6	0	0	6	0	0
15	19907146	.	C	T	1	3	4	0	2	6	0	0
15	19907161	.	G	A	4	2	6	0	0	6	0	0
15	19907233	.	T	C	3	6	9	0	0	9	0	0
15	19907241	.	A	G	3	6	9	0	0	9	0	0
15	19907908	.	C	A	1	5	6	0	0	6	0	0
15	19907914	.	C	T	1	5	6	0	0	6	0	0
15	19908328	.	T	A	5	3	8	0	1	9	0	0
15	19908777	.	A	T	4	6	10	0	0	10	0	0
15	19915674	.	C	A	6	5	11	0	0	11	0	0
15	19916014	.	C	A	7	16	23	0	0	23	0	0
15	19932674	.	G	A	0	20	20	0	15	35	0	0
15	20003130	.	G	A	2	5	7	0	0	7	0	0
15	20005301	.	A	G	8	9	17	0	0	17	0	0
15	20005665	.	C	A	2	2	4	0	0	4	0	0
15	20005863	.	T	A	15	6	21	0	1	22	0	0
15	20007033	.	T	A	0	2	2	0	0	2	0	0
15	20008357	.	C	T	6	3	9	0	2	11	0	0
15	20012049	.	G	T	2	2	4	0	0	4	0	0
15	20012199	.	G	T	2	3	5	0	0	5	0	0
15	20061367	.	G	A	13	5	18	0	0	18	0	0
15	20065029	.	T	C	4	5	9	0	0	9	0	0
15	20065074	.	G	A	10	6	16	0	0	16	0	0
15	20065125	.	A	G	1	0	1	0	1	2	0	0
15	20066656	.	A	T	8	7	15	0	1	16	0	0
15	20071596	.	G	A	4	6	10	0	0	10	0	0
15	20074138	.	G	A	13	7	20	0	0	20	0	0
15	20074261	.	T	A	6	12	18	0	1	19	0	0
15	20076928	.	C	T	0	4	4	0	0	4	0	0
15	20081245	.	T	G	2	4	6	0	0	6	0	0
15	20081275	.	T	A	4	4	8	0	0	8	0	0
15	20081731	.	G	A	6	8	14	0	3	17	0	0
15	20081903	.	G	A	5	3	8	0	0	8	0	0
15	20086508	.	C	A	1	0	1	0	0	1	0	0
15	20094707	.	G	T	2	3	5	0	3	8	0	0
15	20204794	.	A	G	1	2	3	0	0	3	0	0
15	20204850	.	T	G	1	3	4	0	0	4	0	0
15	20204873	.	C	T	4	2	6	0	0	6	0	0
15	20204960	.	A	G	2	4	6	0	0	6	0	0
15	20205014	.	G	A	4	1	5	0	0	5	0	0
15	20205177	.	C	A	1	2	3	0	0	3	0	0
15	20350078	.	T	C	1	3	4	0	0	4	0	0
15	20350083	.	A	C	0	3	3	0	0	3	0	0
15	20352531	.	A	G	1	0	1	0	0	1	0	0
15	20362246	.	G	A	2	3	5	0	1	6	0	0
15	20363063	.	T	G	4	3	7	0	0	7	0	0
15	20363079	.	A	C	2	5	7	0	0	7	0	0
15	20363339	.	C	T	1	2	3	0	0	3	0	0
15	20367662	.	C	T	5	8	13	0	0	13	0	0
15	20374712	.	G	A	0	4	4	0	1	5	0	0
15	20376393	.	A	G	4	1	5	0	0	5	0	0
15	20377873	.	A	T	1	0	1	0	0	1	0	0
15	20378479	.	T	C	7	10	17	0	1	18	0	0
15	20382472	.	C	T	3	1	4	0	0	4	0	0
15	20383967	.	G	T	10	9	19	0	0	19	0	0
15	20384310	.	A	G	8	9	17	0	3	20	0	0
15	20386212	.	A	G	13	7	20	0	2	22	0	0
15	20394788	.	G	A	0	10	10	0	11	21	0	0
15	20394877	.	G	A	12	21	33	0	2	35	0	0
15	20394915	.	G	A	0	23	23	0	16	39	0	0
15	20475865	.	G	A	5	7	12	0	0	12	0	0
15	20476016	.	C	G	7	12	19	0	0	19	0	0
15	20476058	.	A	G	12	15	27	0	0	27	0	0
15	20476075	.	A	G	10	11	21	0	1	22	0	0
15	20478820	.	G	A	5	9	14	0	0	14	0	0
15	20489854	.	C	T	2	3	5	0	0	5	0	0
15	20525524	.	C	T	4	3	7	0	0	7	0	0
15	20525533	.	C	T	3	2	5	0	0	5	0	0
15	20535445	.	T	C	1	2	3	0	0	3	0	0
15	20535475	.	C	T	3	3	6	0	0	6	0	0
15	20540641	.	T	A	4	2	6	0	1	7	0	0
15	20637832	.	C	T	4	3	7	0	0	7	0	0
15	20643476	.	G	A	0	2	2	0	0	2	0	0
15	20652744	.	A	G	0	4	4	0	0	4	0	0
15	20652746	.	G	A	4	0	4	0	0	4	0	0
15	20652787	.	G	A	6	16	22	0	1	23	0	0
15	20653005	.	T	A	18	16	34	0	5	39	0	0
15	20653048	.	A	T	2	14	16	0	2	18	0	0
15	20653074	.	T	A	6	3	9	0	0	9	0	0
15	20653258	.	T	A	20	22	42	0	1	43	0	0
15	20709058	.	G	A	10	13	23	0	0	23	0	0
15	20709184	.	T	A	8	8	16	0	0	16	0	0
15	20709292	.	A	C	18	12	30	0	0	30	0	0
15	20731260	.	G	C	17	15	32	0	0	33	1	0
15	20731345	.	A	C	2	0	2	0	3	5	0	0
15	20731512	.	A	T	2	3	5	0	0	5	0	0
15	20807065	.	A	T	1	1	2	0	0	2	0	0
15	20830937	.	A	G	1	5	6	0	0	6	0	0
15	20830965	.	G	A	1	5	6	0	0	6	0	0
15	20830981	.	A	G	3	4	7	0	0	7	0	0
15	20831105	.	C	T	3	1	4	0	0	4	0	0
15	20835105	.	T	C	3	1	4	0	0	4	0	0
15	20836008	.	A	G	2	2	4	0	0	4	0	0
15	20838334	.	C	T	0	3	3	0	3	6	0	0
15	20843441	.	C	T	2	2	4	0	0	4	0	0
15	20843839	.	A	G	4	3	7	0	0	7	0	0
15	20843859	.	G	C	0	4	4	0	5	9	0	0
15	20844074	.	A	C	5	9	14	0	0	14	0	0
15	20883238	.	C	A	7	4	11	0	0	11	0	0
15	20884503	.	T	G	4	0	4	0	7	11	0	0
15	20884551	.	T	C	5	0	5	0	1	6	0	0
15	20891154	.	T	A	9	11	20	0	1	22	1	0
15	20893320	.	C	A	16	0	16	0	0	16	0	0
15	20893481	.	A	G	11	8	19	0	0	19	0	0
15	20893592	.	C	T	8	15	23	0	0	23	0	0
15	20893644	.	A	G	6	11	17	0	2	19	0	0
15	20894094	.	A	G	10	0	10	0	18	28	0	0
15	20894129	.	C	G	15	14	29	0	1	30	0	0
15	20894464	.	T	C	11	28	39	0	0	39	0	0
15	20894604	.	C	T	11	6	17	0	1	18	0	0
15	20901009	.	C	T	17	15	32	0	0	32	0	0
15	20901053	.	T	C	13	21	34	0	0	34	0	0
15	20901133	.	A	G	15	15	30	0	2	32	0	0
15	20901261	.	G	T	12	24	36	0	0	36	0	0
15	20901358	.	A	G	23	15	38	0	0	38	0	0
15	20901366	.	T	A	16	22	38	0	0	38	0	0
15	20901540	.	C	T	0	9	9	0	6	15	0	0
15	20901562	.	G	A	12	8	20	0	2	22	0	0
15	20907603	.	A	G	5	8	13	0	0	13	0	0
15	20907648	.	A	G	1	0	1	0	0	1	0	0
15	20907651	.	C	T	0	1	1	0	0	1	0	0
15	20907958	.	C	T	5	6	11	0	0	11	0	0
15	20907970	.	C	T	0	10	10	0	6	16	0	0
15	20941485	.	A	T	4	3	7	0	0	7	0	0
15	20943064	.	T	C	2	6	8	0	0	8	0	0
15	20943072	.	G	A	2	7	9	0	0	9	0	0
15	20943248	.	G	T	5	4	9	0	0	9	0	0
15	20943651	.	T	C	9	8	17	0	0	17	0	0
15	20943760	.	T	A	10	5	15	0	1	16	0	0
15	20944217	.	C	A	4	2	6	0	0	6	0	0
15	20944313	.	T	A	3	6	9	0	1	10	0	0
15	20944562	.	G	A	5	6	11	0	0	11	0	0
15	20944577	.	C	G	5	7	12	0	0	12	0	0
15	20944856	.	G	A	9	8	17	0	1	18	0	0
15	20945060	.	C	T	2	5	7	0	0	7	0	0
15	20954495	.	A	C	2	2	4	0	0	4	0	0
15	20956305	.	A	C	1	0	1	0	0	1	0	0
15	21253462	.	C	T	3	3	6	0	1	7	0	0
15	21255145	.	T	C	2	1	3	0	1	4	0	0
15	21258288	.	C	T	4	4	8	0	0	8	0	0
15	21260930	.	A	T	3	2	5	0	0	5	0	0
15	21260966	.	T	G	5	2	7	0	1	8	0	0
15	21263036	.	G	A	2	4	6	0	0	6	0	0
15	21265978	.	G	A	1	2	3	0	0	3	0	0
15	21266018	.	A	G	0	2	2	0	1	3	0	0
15	21267341	.	T	A	1	0	1	0	0	1	0	0
15	21267514	.	A	G	1	0	1	0	1	2	0	0
15	21307477	.	C	T	4	2	6	0	0	6	0	0
15	21315677	.	T	C	1	0	1	0	0	1	0	0
15	21316996	.	A	T	2	0	2	0	0	2	0	0
15	21317192	.	G	A	1	0	1	0	0	1	0	0
15	21319739	.	T	A	2	1	3	0	2	5	0	0
15	21320097	.	T	C	4	4	8	0	0	8	0	0
15	21320329	.	A	G	6	2	8	0	0	8	0	0
15	21320475	.	A	T	5	8	13	0	0	13	0	0
15	21541201	.	C	T	4	10	14	0	0	14	0	0
15	21541620	.	C	T	1	3	4	7	2	13	0	0
15	21541695	.	T	G	3	5	8	0	0	8	0	0
15	21542210	.	G	C	5	0	5	0	5	10	0	0
15	21542542	.	T	C	8	12	20	0	1	21	0	0
15	21542559	.	C	A	6	13	19	1	0	20	0	0
15	21542884	.	C	A	0	15	15	0	4	19	0	0
15	21545866	.	C	T	3	3	6	0	2	8	0	0
15	21545921	.	C	T	0	13	13	0	8	21	0	0
15	21546399	.	A	G	0	1	1	0	0	1	0	0
15	21548403	.	C	T	6	12	18	0	0	18	0	0
15	21552410	.	T	A	1	1	2	0	0	2	0	0
15	21556036	.	C	T	0	4	4	0	2	6	0	0
15	21556193	.	A	G	1	3	4	0	0	4	0	0
15	21556274	.	G	A	5	7	12	0	0	12	0	0
15	21557122	.	A	T	1	4	5	0	0	5	0	0
15	21557403	.	G	C	3	4	7	0	0	7	0	0
15	21557418	.	C	T	0	2	2	0	3	5	0	0
15	21558334	.	A	C	5	0	5	0	1	6	0	0
15	21558380	.	G	A	3	3	6	0	0	6	0	0
15	21561817	.	A	G	3	2	5	0	0	5	0	0
15	21561823	.	G	A	4	2	6	0	0	6	0	0
15	21571033	.	G	A	6	2	8	0	0	8	0	0
15	21571206	.	G	A	2	1	3	0	0	3	0	0
15	21571261	.	G	A	4	2	6	0	0	6	0	0
15	21575741	.	G	A	0	2	2	0	0	2	0	0
15	21579997	.	C	T	1	1	2	0	0	2	0	0
15	21580009	.	G	A	1	1	2	0	0	2	0	0
15	21638389	.	G	A	1	0	1	0	0	1	0	0
15	21638476	.	A	G	1	3	4	0	0	4	0	0
15	21638494	.	C	G	1	2	3	0	0	3	0	0
15	21669462	.	G	C	2	3	5	0	0	5	0	0
15	21669470	.	T	A	0	3	3	0	1	4	0	0
15	21684546	.	T	A	5	3	8	0	1	9	0	0
15	21684558	.	C	G	6	4	10	0	0	10	0	0
15	21684701	.	T	C	4	5	9	0	0	9	0	0
15	21684704	.	T	G	4	4	8	0	0	8	0	0
15	21684933	.	A	G	11	5	16	0	0	16	0	0
15	21685195	.	T	A	10	16	26	1	1	28	0	0
15	21685217	.	C	T	0	17	17	1	15	33	0	0
15	21685357	.	G	A	18	15	33	0	3	36	0	0
15	21685418	.	C	T	11	18	29	0	1	30	0	0
15	21685484	.	A	G	19	8	27	0	0	27	0	0
15	21715339	.	C	T	7	5	12	0	1	13	0	0
15	21715381	.	G	A	6	4	10	0	0	10	0	0
15	21716692	.	G	T	1	4	5	0	0	5	0	0
15	21716760	.	T	A	3	4	7	0	0	7	0	0
15	21716778	.	G	A	2	3	5	0	0	5	0	0
15	21716856	.	C	T	1	3	4	0	0	4	0	0
15	21716964	.	A	G	1	0	1	0	2	3	0	0
15	21747981	.	T	C	3	10	13	0	2	15	0	0
15	21757433	.	C	T	17	17	34	0	0	34	0	0
15	21769619	.	T	C	8	4	12	0	0	12	0	0
15	21769640	.	G	A	10	10	20	0	1	21	0	0
15	21771835	.	A	T	23	21	44	0	0	44	0	0
15	21772073	.	T	C	32	13	45	0	6	51	0	0
15	21772112	.	T	C	40	14	54	0	1	55	0	0
15	21772174	.	T	C	24	21	45	0	4	49	0	0
15	21772208	.	T	C	16	28	44	0	1	45	0	0
15	21772689	.	C	A	17	26	43	0	1	44	0	0
15	21782020	.	G	A	15	17	32	0	2	34	0	0
15	21782028	.	G	A	15	16	31	0	1	32	0	0
15	21782057	.	T	C	12	17	29	0	0	29	0	0
15	21782154	.	C	A	0	13	13	0	11	24	0	0
15	21782171	.	G	A	9	14	23	0	1	24	0	0
15	21782238	.	A	G	7	6	13	0	0	13	0	0
15	21782385	.	G	T	2	8	10	0	2	12	0	0
15	21782946	.	C	G	13	10	23	0	0	23	0	0
15	21783681	.	G	A	7	10	17	0	0	17	0	0
15	21784042	.	G	T	17	10	27	0	4	31	0	0
15	21784226	.	T	C	13	3	16	0	26	42	0	0
15	21784352	.	T	C	0	3	3	0	0	3	0	0
15	21784525	.	C	G	0	4	4	0	3	7	0	0
15	21789819	.	G	T	5	3	8	0	0	8	0	0
15	21791872	.	G	T	10	12	22	0	2	24	0	0
15	21791878	.	C	T	1	11	12	0	13	25	0	0
15	21792220	.	C	T	0	8	8	0	11	19	0	0
15	21798394	.	T	C	5	8	13	0	0	13	0	0
15	21798447	.	T	C	5	5	10	0	2	12	0	0
15	21798540	.	G	T	1	3	4	0	0	4	0	0
15	21813430	.	G	T	8	7	15	0	0	15	0	0
15	21813451	.	G	A	6	3	9	0	0	9	0	0
15	21836607	.	A	G	1	3	4	0	0	4	0	0
15	21843154	.	A	G	1	2	3	0	0	3	0	0
15	22046900	.	A	G	2	4	6	0	0	6	0	0
15	22047131	.	C	G	3	2	5	0	0	5	0	0
15	22047200	.	C	T	1	1	2	0	0	2	0	0
15	22047389	.	T	C	5	3	8	0	0	8	0	0
15	22068832	.	G	A	0	1	1	0	0	1	0	0
15	22133987	.	A	C	7	0	7	0	11	18	0	0
15	22143027	.	G	A	0	2	2	0	0	2	0	0
15	22147174	.	C	G	3	6	9	0	0	9	0	0
15	22147186	.	G	T	3	6	9	0	0	9	0	0
15	22319797	.	C	T	5	4	9	0	0	9	0	0
15	22319830	.	G	A	5	4	9	0	0	9	0	0
15	22324529	.	A	T	0	1	1	0	0	1	0	0
15	22324538	.	T	A	0	1	1	0	0	1	0	0
15	22324760	.	A	G	11	22	33	0	1	34	0	0
15	22324948	.	T	C	10	10	20	0	0	20	0	0
15	22325007	.	C	T	11	5	16	0	0	16	0	0
15	22325278	.	A	G	8	0	8	0	7	16	1	0
15	22325617	.	G	T	7	15	22	0	1	23	0	0
15	22325687	.	A	C	8	2	10	0	0	10	0	0
15	22435565	.	T	G	2	0	2	0	9	11	0	0
15	22435632	.	C	G	5	1	6	0	0	6	0	0
15	22435655	.	C	T	3	1	4	0	0	4	0	0
15	22441639	.	C	T	3	4	7	0	0	7	0	0
15	22441703	.	C	T	3	4	7	0	1	8	0	0
15	22441744	.	A	G	5	5	10	0	0	10	0	0
15	22441852	.	A	G	5	0	5	0	7	12	0	0
15	22441855	.	C	T	4	6	10	0	2	12	0	0
15	22441900	.	T	C	5	7	12	0	0	12	0	0
15	22441972	.	G	A	9	6	15	0	0	15	0	0
15	22442713	.	A	T	8	7	15	0	2	17	0	0
15	22442875	.	G	A	0	5	5	0	8	13	0	0
15	22443048	.	T	G	5	6	11	0	1	12	0	0
15	22443136	.	C	T	13	7	20	0	1	21	0	0
15	22443282	.	C	T	8	4	12	0	0	12	0	0
15	22443289	.	A	T	8	5	13	0	0	13	0	0
15	22443460	.	G	A	0	7	7	0	6	13	0	0
15	22443462	.	A	G	6	0	6	0	7	13	0	0
15	22443520	.	A	G	9	8	17	0	0	17	0	0
15	22443615	.	G	A	13	5	18	0	1	19	0	0
15	22443630	.	G	T	0	12	12	0	9	21	0	0
15	22443798	.	A	G	12	19	31	0	2	33	0	0
15	22443858	.	A	G	13	17	30	0	0	30	0	0
15	22443934	.	G	A	0	14	14	0	19	33	0	0
15	22444062	.	A	G	16	15	31	0	2	33	0	0
15	22444239	.	G	A	1	17	18	0	8	26	0	0
15	22444266	.	A	G	11	19	30	0	0	30	0	0
15	22444310	.	T	A	18	7	25	0	1	26	0	0
15	22444331	.	G	A	7	16	23	0	1	24	0	0
15	22444483	.	T	G	11	0	11	0	4	15	0	0
15	22444486	.	A	T	9	4	13	0	2	15	0	0
15	22444524	.	T	C	5	3	8	0	2	10	0	0
15	22524099	.	C	A	0	2	2	0	0	2	0	0
15	22526463	.	G	C	0	3	3	0	8	11	0	0
15	22533518	.	G	A	4	5	9	0	1	10	0	0
15	22536756	.	C	T	2	2	4	0	0	4	0	0
15	22536795	.	G	C	0	3	3	0	1	4	0	0
15	22537008	.	T	A	3	4	7	0	0	7	0	0
15	22722694	.	C	T	0	1	1	0	0	1	0	0
15	22945140	.	G	A	0	3	3	0	0	3	0	0
15	22999133	.	T	C	2	3	5	0	0	5	0	0
15	22999151	.	C	T	3	1	4	0	1	5	0	0
15	23181511	.	C	A	5	3	8	0	0	8	0	0
15	23187879	.	T	A	6	5	11	0	0	11	0	0
15	23187902	.	T	G	5	2	7	0	2	9	0	0
15	23188245	.	T	A	8	3	11	0	0	11	0	0
15	23208341	.	G	C	4	4	8	0	0	8	0	0
15	23243797	.	T	C	2	5	7	0	0	7	0	0
15	23243860	.	G	A	0	3	3	0	2	5	0	0
15	23244134	.	A	C	1	4	5	0	0	5	0	0
15	23256320	.	C	T	2	1	3	0	0	3	0	0
15	23256449	.	T	C	7	4	11	0	1	12	0	0
15	23256779	.	G	A	0	1	1	0	2	3	0	0
15	23264471	.	G	A	0	5	5	0	4	9	0	0
15	23264547	.	G	A	0	5	5	0	11	16	0	0
15	23264945	.	T	C	9	8	17	0	0	17	0	0
15	23265217	.	C	T	6	6	12	0	1	13	0	0
15	23272060	.	C	T	3	3	6	0	0	6	0	0
15	23273262	.	G	A	3	5	8	0	0	8	0	0
15	23280990	.	G	A	3	4	7	0	0	7	0	0
15	23281017	.	C	G	4	3	7	0	0	7	0	0
15	23281046	.	T	C	0	2	2	0	1	3	0	0
15	23282608	.	C	T	2	1	3	0	1	4	0	0
15	23285931	.	A	G	1	2	3	0	0	3	0	0
15	23357763	.	C	T	1	1	2	0	1	3	0	0
15	23357870	.	G	T	0	4	4	0	2	6	0	0
15	23357909	.	C	T	1	2	3	0	1	4	0	0
15	23357957	.	G	C	2	2	4	0	0	4	0	0
15	23358185	.	A	T	3	6	9	0	1	10	0	0
15	23358186	.	A	T	2	7	9	0	1	10	0	0
15	23358455	.	G	C	5	2	7	0	0	7	0	0
15	23382243	.	C	T	1	7	8	0	5	13	0	0
15	23386976	.	C	T	1	6	7	0	6	13	0	0
15	23387010	.	A	G	6	6	12	0	1	13	0	0
15	23387334	.	G	A	3	6	9	0	0	9	0	0
15	23387567	.	G	A	6	7	13	0	0	13	0	0
15	23387577	.	G	A	7	5	12	0	1	13	0	0
15	23388471	.	G	T	12	5	17	0	2	19	0	0
15	23388609	.	C	T	5	4	9	0	1	10	0	0
15	23389139	.	C	G	4	7	11	0	0	11	0	0
15	23389689	.	A	G	5	6	11	0	0	11	0	0
15	23389809	.	G	A	1	0	1	0	1	2	0	0
15	23391411	.	A	G	1	0	1	0	0	1	0	0
15	23391741	.	A	G	2	2	4	0	1	5	0	0
15	23394773	.	G	A	1	2	3	0	0	3	0	0
15	23397588	.	A	G	1	0	1	0	0	1	0	0
15	23397614	.	C	T	0	0	0	0	1	1	0	0
15	23397987	.	C	T	1	0	1	0	0	1	0	0
15	23398053	.	G	A	0	0	0	0	1	1	0	0
15	23400770	.	G	A	8	6	14	0	0	14	0	0
15	23400954	.	G	A	2	6	8	0	1	9	0	0
15	23400961	.	A	G	2	7	9	0	1	10	0	0
15	23403071	.	G	A	3	5	8	0	0	8	0	0
15	23403097	.	A	G	4	6	10	0	0	10	0	0
15	23403191	.	T	C	4	0	4	0	4	8	0	0
15	23404472	.	G	A	2	2	4	0	0	4	0	0
15	23404925	.	C	T	2	3	5	0	1	6	0	0
15	23423674	.	C	T	5	4	9	0	1	10	0	0
15	23423724	.	G	A	4	6	10	0	1	11	0	0
15	23426717	.	T	A	4	3	7	0	0	7	0	0
15	23427075	.	G	A	2	3	5	0	0	5	0	0
15	23429593	.	G	A	5	6	11	0	0	11	0	0
15	23429915	.	G	A	0	1	1	0	0	1	0	0
15	23431734	.	C	T	0	7	7	0	11	18	0	0
15	23434242	.	C	T	5	0	5	0	1	6	0	0
15	23434251	.	G	A	0	4	4	0	0	4	0	0
15	23437095	.	C	T	3	3	6	0	0	6	0	0
15	23437162	.	T	A	6	8	14	0	1	15	0	0
15	23440676	.	T	C	3	0	3	0	0	3	0	0
15	23440751	.	A	G	3	4	7	0	0	7	0	0
15	23451427	.	T	C	2	2	4	0	0	4	0	0
15	23468224	.	C	A	3	4	7	0	0	7	0	0
15	23468383	.	G	T	3	3	6	0	1	7	0	0
15	23468501	.	G	T	4	3	7	0	0	7	0	0
15	23468522	.	A	T	6	4	10	0	0	10	0	0
15	23468754	.	T	A	3	3	6	0	0	6	0	0
15	23468965	.	A	T	6	2	8	0	0	8	0	0
15	23472735	.	C	T	1	1	2	0	0	2	0	0
15	23474815	.	C	G	2	6	8	0	3	11	0	0
15	23475487	.	A	G	1	6	7	0	0	7	0	0
15	23475943	.	G	A	1	7	8	0	0	8	0	0
15	23478782	.	C	A	2	2	4	0	0	4	0	0
15	23478860	.	G	A	2	2	4	0	1	5	0	0
15	23480174	.	C	T	0	1	1	0	0	1	0	0
15	23512017	.	C	A	2	2	4	0	0	4	0	0
15	23512422	.	T	A	5	2	7	0	0	7	0	0
15	23512882	.	T	C	3	2	5	0	0	5	0	0
15	23513009	.	G	C	7	3	10	0	2	12	0	0
15	23523144	.	T	C	2	2	4	0	0	4	0	0
15	23525314	.	T	G	0	2	2	0	0	2	0	0
15	23525368	.	C	T	2	1	3	0	1	4	0	0
15	23525864	.	C	T	1	3	4	0	0	4	0	0
15	23525927	.	C	T	2	3	5	0	0	5	0	0
15	23525928	.	G	A	0	3	3	0	2	5	0	0
15	23528183	.	G	A	2	2	4	0	0	4	0	0
15	23529022	.	A	T	1	2	3	0	0	3	0	0
15	23531126	.	G	T	3	2	5	0	0	5	0	0
15	23531276	.	G	A	3	5	8	0	0	8	0	0
15	23531933	.	G	A	3	4	7	0	1	8	0	0
15	23532119	.	G	A	0	5	5	0	5	10	0	0
15	23532146	.	A	T	5	4	9	0	0	9	0	0
15	23540079	.	G	A	0	2	2	0	3	5	0	0
15	23540133	.	C	T	1	2	3	0	2	5	0	0
15	23541616	.	C	T	2	2	4	0	1	5	0	0
15	23541943	.	T	G	1	2	3	0	0	3	0	0
15	23551218	.	G	A	0	2	2	0	3	5	0	0
15	23551272	.	C	T	2	6	8	0	0	8	0	0
15	23551295	.	T	A	1	4	5	0	0	5	0	0
15	23551511	.	T	G	2	3	5	0	0	5	0	0
15	23551704	.	G	A	0	6	6	0	3	9	0	0
15	23551769	.	T	G	5	0	5	0	7	12	0	0
15	23551775	.	C	T	5	6	11	0	0	11	0	0
15	23617364	.	G	A	1	5	6	0	7	13	0	0
15	23617612	.	G	T	4	2	6	0	0	6	0	0
15	23619093	.	G	A	0	19	19	0	14	33	0	0
15	23620453	.	T	G	1	1	2	0	0	2	0	0
15	23620511	.	G	A	9	16	25	0	0	25	0	0
15	23620541	.	C	T	11	11	22	0	2	24	0	0
15	23627514	.	G	A	11	11	22	0	3	25	0	0
15	23627540	.	A	C	5	2	7	0	11	18	0	0
15	23640374	.	T	A	11	18	29	0	5	34	0	0
15	23640678	.	A	C	2	0	2	0	33	35	0	0
15	23640807	.	C	T	11	7	18	0	0	18	0	0
15	23641057	.	C	T	9	3	12	0	2	14	0	0
15	23641102	.	T	G	11	6	17	0	2	19	0	0
15	23641107	.	G	C	9	11	20	0	0	20	0	0
15	23641426	.	G	A	10	7	17	0	1	18	0	0
15	23645788	.	C	T	1	1	2	0	0	2	0	0
15	23672960	.	G	T	1	2	3	0	0	3	0	0
15	23677373	.	A	T	1	5	6	0	0	6	0	0
15	23677376	.	G	A	0	5	5	0	1	6	0	0
15	23677426	.	C	A	1	3	4	0	1	5	0	0
15	23684232	.	C	T	0	1	1	0	0	1	0	0
15	23686857	.	G	A	2	1	3	0	0	3	0	0
15	23686877	.	G	A	1	1	2	0	0	2	0	0
15	23689030	.	C	T	1	3	4	0	0	4	0	0
15	23709660	.	G	A	5	3	8	0	0	8	0	0
15	23710339	.	T	C	6	3	9	0	0	9	0	0
15	23710465	.	C	T	7	5	12	0	0	12	0	0
15	23710490	.	G	T	4	7	11	0	1	12	0	0
15	23710515	.	G	A	3	9	12	0	0	12	0	0
15	23710539	.	T	C	3	9	12	0	0	12	0	0
15	23710811	.	A	G	6	4	10	0	1	11	0	0
15	23711890	.	C	T	0	6	6	0	8	15	1	0
15	23711953	.	G	A	3	4	7	0	0	7	0	0
15	23712082	.	A	G	12	11	23	0	2	25	0	0
15	23713679	.	T	G	3	2	5	0	2	7	0	0
15	23713923	.	C	T	7	5	12	0	0	12	0	0
15	23718008	.	G	A	1	2	3	0	0	3	0	0
15	23718403	.	C	T	4	12	16	0	0	16	0	0
15	23723607	.	T	A	4	4	8	0	0	8	0	0
15	23724153	.	G	A	1	0	1	0	1	2	0	0
15	23733485	.	C	A	4	5	9	0	0	9	0	0
15	23738914	.	C	T	8	11	19	0	2	21	0	0
15	23738915	.	G	C	0	12	12	0	9	21	0	0
15	23739032	.	C	T	3	1	4	0	0	4	0	0
15	23745659	.	G	A	4	4	8	0	0	8	0	0
15	23745952	.	C	T	4	3	7	0	0	7	0	0
15	23746655	.	A	T	2	4	6	0	0	6	0	0
15	23746674	.	G	A	1	2	3	0	0	3	0	0
15	23780791	.	A	T	1	3	4	0	0	4	0	0
15	23783242	.	G	T	3	2	5	0	0	5	0	0
15	23783669	.	C	T	2	3	5	0	0	5	0	0
15	23784896	.	C	T	1	0	1	0	0	1	0	0
15	23788266	.	G	A	5	5	10	0	0	10	0	0
15	23793206	.	C	T	5	5	10	0	0	10	0	0
15	23817403	.	T	A	10	12	22	0	1	23	0	0
15	23817517	.	G	A	12	5	17	0	1	18	0	0
15	23817901	.	C	T	1	8	9	0	7	16	0	0
15	23818313	.	T	A	11	7	18	0	0	18	0	0
15	23818405	.	T	C	12	6	18	0	2	20	0	0
15	23818494	.	T	C	10	0	10	0	6	16	0	0
15	23818506	.	T	C	12	6	18	0	0	18	0	0
15	23818765	.	G	A	6	4	10	0	0	10	0	0
15	23819248	.	T	A	7	6	13	0	1	14	0	0
15	23819253	.	C	T	8	6	14	0	1	15	0	0
15	23819423	.	G	A	8	12	20	0	0	20	0	0
15	23823508	.	C	T	9	4	13	0	2	15	0	0
15	23823638	.	G	C	4	4	8	0	1	9	0	0
15	23829245	.	C	T	1	1	2	0	0	2	0	0
15	23830439	.	A	G	2	2	4	0	0	4	0	0
15	23831007	.	C	T	0	3	3	0	0	3	0	0
15	23834301	.	A	T	8	2	10	0	0	10	0	0
15	23860840	.	G	A	3	2	5	0	0	5	0	0
15	23860849	.	G	A	3	2	5	0	0	5	0	0
15	23863843	.	G	A	1	3	4	0	0	4	0	0
15	23912118	.	C	T	0	2	2	0	0	2	0	0
15	23917946	.	A	T	2	2	4	0	0	4	0	0
15	23918333	.	G	C	3	2	5	0	0	5	0	0
15	23918365	.	C	T	3	1	4	0	0	4	0	0
15	23918424	.	A	T	1	2	3	0	0	3	0	0
15	23922714	.	G	A	8	15	23	0	1	24	0	0
15	23922994	.	G	T	13	13	26	0	0	26	0	0
15	23923261	.	T	G	13	8	21	0	0	21	0	0
15	23925372	.	G	C	5	5	10	0	1	11	0	0
15	23927992	.	G	T	12	17	29	0	8	37	0	0
15	23931187	.	A	G	1	5	6	0	0	6	0	0
15	23931454	.	A	G	11	5	16	0	0	16	0	0
15	23942804	.	T	G	15	10	25	0	1	26	0	0
15	24016739	.	T	C	0	2	2	0	0	2	0	0
15	24017280	.	G	A	0	1	1	0	0	1	0	0
15	24020116	.	C	T	1	4	5	0	0	5	0	0
15	24035939	.	C	A	2	2	4	0	0	4	0	0
15	24035940	.	A	C	2	2	4	0	0	4	0	0
15	24052264	.	C	T	0	2	2	0	0	2	0	0
15	24054101	.	C	T	1	2	3	0	0	3	0	0
15	24084737	.	T	A	7	4	11	0	2	13	0	0
15	24084773	.	C	T	10	8	18	0	0	18	0	0
15	24094697	.	T	C	9	1	10	0	0	10	0	0
15	24096474	.	G	A	7	3	10	0	1	11	0	0
15	24096657	.	C	A	3	8	11	0	0	11	0	0
15	24104648	.	C	T	3	2	5	0	0	5	0	0
15	24106821	.	C	T	11	7	18	0	0	18	0	0
15	24119372	.	A	G	6	9	15	0	0	15	0	0
15	24119391	.	C	T	6	9	15	0	0	15	0	0
15	24119571	.	T	C	7	11	18	0	0	18	0	0
15	24119720	.	G	A	1	3	4	0	5	9	0	0
15	24120490	.	G	A	0	4	4	1	6	11	0	0
15	24120588	.	C	T	7	5	12	0	0	12	0	0
15	24150380	.	C	T	0	2	2	0	1	3	0	0
15	24388860	.	C	T	6	5	11	0	2	13	0	0
15	24389369	.	A	C	3	7	10	0	0	10	0	0
15	24391755	.	G	A	0	0	0	0	1	1	0	0
15	24439290	.	G	A	2	0	2	0	0	2	0	0
15	24439382	.	T	C	3	7	10	0	0	10	0	0
15	24489776	.	G	A	1	2	3	0	0	3	0	0
15	24500648	.	G	A	3	2	5	0	0	5	0	0
15	24525815	.	A	G	1	0	1	0	1	2	0	0
15	24525890	.	T	C	8	10	18	0	0	18	0	0
15	24530477	.	G	A	0	8	8	0	7	15	0	0
15	24535495	.	C	T	3	3	6	0	0	6	0	0
15	24543991	.	C	T	1	3	4	0	0	4	0	0
15	24544305	.	T	A	5	4	9	0	0	9	0	0
15	24544325	.	G	A	3	5	8	0	0	8	0	0
15	24544653	.	A	T	10	3	13	0	2	15	0	0
15	24544657	.	A	G	10	0	10	0	5	15	0	0
15	24554786	.	C	A	4	6	10	0	0	10	0	0
15	24557185	.	C	T	4	2	6	0	0	6	0	0
15	24557432	.	A	G	5	5	10	0	0	10	0	0
15	24557540	.	G	A	4	9	13	0	2	15	0	0
15	24557810	.	A	C	6	6	12	0	2	14	0	0
15	24561055	.	T	C	1	3	4	0	0	4	0	0
15	24561414	.	G	A	2	2	4	0	0	4	0	0
15	24561501	.	C	T	9	9	18	0	0	18	0	0
15	24671147	.	A	G	1	0	1	0	1	2	0	0
15	24671222	.	G	A	1	3	4	0	0	4	0	0
15	24673385	.	T	C	2	3	5	0	0	5	0	0
15	24673723	.	T	A	13	11	24	0	0	24	0	0
15	24673997	.	A	G	7	4	11	0	0	11	0	0
15	24678088	.	G	A	0	1	1	0	0	1	0	0
15	24679744	.	T	C	1	0	1	0	0	1	0	0
15	24679944	.	T	C	1	1	2	0	0	2	0	0
15	24683236	.	A	G	6	7	13	0	1	14	0	0
15	24686282	.	C	T	3	9	12	0	0	12	0	0
15	24686450	.	G	A	0	3	3	0	3	6	0	0
15	24689592	.	G	A	0	11	11	0	13	24	0	0
15	24689701	.	G	A	0	12	12	0	9	21	0	0
15	24689948	.	T	C	9	9	18	0	0	18	0	0
15	24691290	.	A	G	8	0	8	0	4	12	0	0
15	24692351	.	A	T	5	3	8	0	1	9	0	0
15	24692716	.	T	A	7	6	13	0	0	13	0	0
15	24733569	.	G	A	7	7	14	0	0	14	0	0
15	24733689	.	G	A	8	14	22	0	0	22	0	0
15	24733791	.	T	G	11	8	19	0	1	20	0	0
15	24733896	.	G	A	3	7	10	0	1	11	0	0
15	24733932	.	T	C	7	4	11	0	0	11	0	0
15	24735111	.	G	T	11	5	16	0	0	16	0	0
15	24735163	.	C	G	8	8	16	0	0	16	0	0
15	24735341	.	C	T	7	15	22	0	0	22	0	0
15	24735472	.	T	C	8	4	12	0	0	12	0	0
15	24735677	.	G	T	15	7	22	0	0	22	0	0
15	24735935	.	T	G	2	4	6	0	0	6	0	0
15	24736107	.	T	C	1	2	3	0	0	3	0	0
15	24736413	.	A	G	5	2	7	0	0	7	0	0
15	24736446	.	C	A	4	4	8	0	1	9	0	0
15	24736525	.	A	G	4	2	6	0	1	7	0	0
15	24737745	.	A	G	14	12	26	0	2	28	0	0
15	24742930	.	G	A	0	17	17	0	14	31	0	0
15	24743843	.	G	A	7	11	18	0	0	18	0	0
15	24744691	.	G	C	9	10	19	0	0	19	0	0
15	24744724	.	A	T	10	11	21	0	1	22	0	0
15	24749895	.	G	A	0	23	23	0	25	48	0	0
15	24751322	.	C	T	7	17	24	0	0	24	0	0
15	24754361	.	A	T	6	4	10	0	1	11	0	0
15	24754524	.	G	A	19	22	41	0	1	42	0	0
15	24772558	.	A	G	0	0	0	0	1	1	0	0
15	24783925	.	A	G	1	0	1	0	1	2	0	0
15	24791413	.	C	T	1	1	2	0	1	3	0	0
15	24791431	.	C	T	1	2	3	0	0	3	0	0
15	24791806	.	G	C	2	3	5	0	0	5	0	0
15	24791911	.	G	C	4	3	7	0	0	7	0	0
15	24792183	.	G	A	3	5	8	0	0	8	0	0
15	24792418	.	C	T	3	4	7	0	0	7	0	0
15	24792604	.	T	C	2	7	9	0	0	9	0	0
15	24794104	.	C	T	9	5	14	0	0	14	0	0
15	24794441	.	T	A	6	4	10	0	0	10	0	0
15	24798529	.	G	A	2	1	3	0	0	3	0	0
15	24806288	.	G	A	2	0	2	0	0	2	0	0
15	24837105	.	G	A	0	13	13	0	8	21	0	0
15	24837474	.	A	G	5	2	7	0	1	8	0	0
15	24845205	.	G	A	19	17	36	0	5	41	0	0
15	24845460	.	C	T	1	3	4	0	10	14	0	0
15	24845500	.	G	T	7	13	20	0	0	20	0	0
15	24846070	.	G	A	7	7	14	0	0	14	0	0
15	24846186	.	T	C	9	8	17	0	0	17	0	0
15	24846311	.	T	A	12	6	18	0	0	18	0	0
15	24846594	.	T	C	9	0	9	0	6	15	0	0
15	24869405	.	T	C	7	0	7	0	11	18	0	0
15	24869684	.	G	A	5	10	15	0	0	15	0	0
15	24946564	.	C	G	0	2	2	0	2	4	0	0
15	24946807	.	C	T	0	5	5	0	6	11	0	0
15	24946809	.	C	G	6	5	11	0	0	11	0	0
15	24946864	.	A	G	3	3	6	0	0	7	1	0
15	24946887	.	C	T	2	3	5	0	0	5	0	0
15	24948851	.	T	G	1	3	4	0	0	4	0	0
15	24960463	.	G	A	2	7	9	0	0	9	0	0
15	25080423	.	G	C	1	2	3	0	0	3	0	0
15	25085266	.	G	C	2	2	4	0	0	4	0	0
15	25096190	.	A	T	1	3	4	0	0	4	0	0
15	25096386	.	G	T	1	4	5	0	1	6	0	0
15	25097179	.	T	A	3	2	5	0	0	5	0	0
15	25097582	.	C	T	5	4	9	0	0	9	0	0
15	25099174	.	A	G	3	2	5	0	0	5	0	0
15	25099206	.	C	T	2	3	5	0	0	5	0	0
15	25099258	.	G	A	1	2	3	0	0	3	0	0
15	25099305	.	C	G	0	4	4	0	3	7	0	0
15	25099334	.	T	C	4	2	6	0	0	6	0	0
15	25101042	.	C	T	5	5	10	0	0	10	0	0
15	25101083	.	A	G	5	6	11	0	0	11	0	0
15	25101085	.	T	G	5	6	11	0	0	11	0	0
15	25101260	.	T	C	6	5	11	0	0	11	0	0
15	25101267	.	A	G	6	7	13	0	0	13	0	0
15	25101302	.	G	A	3	7	10	0	0	10	0	0
15	25101538	.	G	A	7	16	23	0	0	23	0	0
15	25101619	.	A	G	9	9	18	0	0	18	0	0
15	25101740	.	C	A	14	15	29	0	0	29	0	0
15	25101990	.	A	G	18	11	29	0	0	29	0	0
15	25121522	.	A	G	0	2	2	0	0	2	0	0
15	25127854	.	A	G	4	4	8	0	0	8	0	0
15	25152258	.	A	G	1	1	2	0	0	2	0	0
15	25152294	.	A	C	1	0	1	0	1	2	0	0
15	25153250	.	C	A	4	5	9	0	2	11	0	0
15	25153294	.	G	A	3	9	12	0	0	12	0	0
15	25173015	.	C	T	0	3	3	0	5	8	0	0
15	25173157	.	A	G	11	7	18	0	1	19	0	0
15	25173188	.	A	T	13	7	20	0	0	20	0	0
15	25173494	.	A	C	5	11	16	0	0	16	0	0
15	25173759	.	T	C	10	6	16	0	2	18	0	0
15	25173898	.	G	A	2	4	6	0	0	6	0	0
15	25173920	.	G	A	4	4	8	0	0	8	0	0
15	25174048	.	C	A	0	2	2	0	5	7	0	0
15	25174634	.	G	A	4	4	8	0	0	8	0	0
15	25175354	.	G	C	4	5	9	0	0	9	0	0
15	25175476	.	C	G	2	2	4	0	0	4	0	0
15	25175621	.	A	G	2	4	6	0	0	6	0	0
15	25175811	.	A	C	2	3	5	0	0	5	0	0
15	25176075	.	C	T	4	5	9	0	1	10	0	0
15	25176191	.	G	C	4	1	5	0	9	14	0	0
15	25176527	.	C	T	0	5	5	0	9	14	0	0
15	25195068	.	T	C	0	0	0	0	1	1	0	0
15	25214384	.	A	G	5	7	12	0	0	12	0	0
15	25229156	.	A	G	1	0	1	0	0	1	0	0
15	25238885	.	G	A	1	2	3	0	0	3	0	0
15	25238903	.	G	A	1	2	3	0	0	3	0	0
15	25243412	.	C	T	0	3	3	0	0	3	0	0
15	25267804	.	G	A	2	2	4	0	0	4	0	0
15	25273187	.	C	T	13	18	31	0	0	31	0	0
15	25274918	.	T	G	15	16	31	0	3	34	0	0
15	25278986	.	A	G	21	12	33	0	1	34	0	0
15	25281387	.	G	A	5	7	12	0	0	12	0	0
15	25283846	.	A	C	7	1	8	0	6	14	0	0
15	25283963	.	A	G	6	5	11	0	0	11	0	0
15	25304678	.	C	A	6	11	17	0	1	18	0	0
15	25321973	.	G	A	7	5	12	0	0	12	0	0
15	25321982	.	A	C	6	6	12	0	0	12	0	0
15	25322410	.	C	A	0	5	5	0	11	16	0	0
15	25322607	.	T	G	17	13	30	0	1	31	0	0
15	25322783	.	G	A	13	10	23	0	0	23	0	0
15	25322853	.	C	T	7	13	20	0	0	20	0	0
15	25323064	.	G	C	8	8	16	0	1	17	0	0
15	25333922	.	C	T	0	3	3	0	1	4	0	0
15	25344998	.	G	A	6	2	8	0	0	8	0	0
15	25346772	.	G	A	1	0	1	0	0	1	0	0
15	25346775	.	G	A	1	0	1	0	0	1	0	0
15	25349844	.	C	T	7	3	10	0	0	10	0	0
15	25351870	.	C	A	1	3	4	0	0	4	0	0
15	25351927	.	G	A	2	6	8	0	0	8	0	0
15	25352011	.	C	T	3	2	5	0	2	7	0	0
15	25352062	.	C	A	6	2	8	0	2	10	0	0
15	25352113	.	G	A	5	1	6	0	0	6	0	0
15	25357456	.	A	G	1	2	3	0	0	3	0	0
15	25357510	.	G	A	2	5	7	0	0	7	0	0
15	25367067	.	C	T	3	5	8	0	0	8	0	0
15	25367129	.	A	G	5	4	9	0	0	9	0	0
15	25367229	.	G	A	1	2	3	0	0	3	0	0
15	25376029	.	T	C	1	4	5	0	0	5	0	0
15	25376190	.	T	C	6	7	13	0	0	13	0	0
15	25376212	.	T	G	8	6	14	0	0	14	0	0
15	25376332	.	A	T	2	9	11	0	1	12	0	0
15	25376506	.	G	A	2	2	4	0	0	4	0	0
15	25376673	.	G	C	4	3	7	0	0	7	0	0
15	25376674	.	C	T	0	3	3	0	4	7	0	0
15	25376842	.	A	G	3	3	6	0	3	9	0	0
15	25377137	.	C	T	1	6	7	0	6	13	0	0
15	25377155	.	C	T	0	8	8	0	7	15	0	0
15	25377218	.	C	A	1	8	9	0	0	9	0	0
15	25388120	.	C	T	2	3	5	0	0	6	1	0
15	25400018	.	A	G	4	1	5	0	1	6	0	0
15	25400120	.	T	C	2	3	5	0	1	6	0	0
15	25434829	.	T	A	1	2	3	0	0	3	0	0
15	25434830	.	A	G	1	2	3	0	0	3	0	0
15	25434948	.	C	T	0	2	2	0	1	3	0	0
15	25484052	.	A	G	4	2	6	0	1	7	0	0
15	25485155	.	A	G	4	0	4	0	4	8	0	0
15	25485394	.	A	G	0	2	2	0	0	2	0	0
15	25485802	.	A	G	2	5	7	0	0	7	0	0
15	25492912	.	G	A	0	1	1	0	1	2	0	0
15	25498515	.	G	T	0	0	0	0	1	1	0	0
15	25498645	.	G	C	0	3	3	0	6	9	0	0
15	25498718	.	C	A	5	9	14	0	0	14	0	0
15	25498946	.	C	T	4	4	8	0	2	10	0	0
15	25499171	.	A	G	2	3	5	0	0	5	0	0
15	25504064	.	A	G	3	7	10	0	0	10	0	0
15	25504397	.	A	C	8	1	9	0	6	15	0	0
15	25504399	.	T	A	8	7	15	0	0	15	0	0
15	25507942	.	A	T	3	3	6	0	0	6	0	0
15	25508539	.	T	G	5	3	8	0	0	8	0	0
15	25508852	.	T	G	0	3	3	0	0	3	0	0
15	25509414	.	C	A	0	10	10	0	11	21	0	0
15	25509498	.	G	A	4	1	5	0	1	6	0	0
15	25509500	.	C	T	0	1	1	0	5	6	0	0
15	25510372	.	G	T	2	4	6	0	1	7	0	0
15	25512525	.	T	C	7	0	7	0	7	14	0	0
15	25515702	.	G	A	6	3	9	0	0	9	0	0
15	25517116	.	C	T	2	1	3	0	1	4	0	0
15	25528359	.	C	A	8	4	12	0	0	12	0	0
15	25531759	.	G	A	1	1	2	0	0	2	0	0
15	25531772	.	A	G	1	1	2	0	0	2	0	0
15	25532175	.	C	T	3	6	9	0	0	9	0	0
15	25532219	.	C	T	0	3	3	0	0	3	0	0
15	25533279	.	A	T	0	2	2	0	0	2	0	0
15	25533361	.	T	A	2	2	4	0	0	4	0	0
15	25533363	.	T	C	2	2	4	0	0	4	0	0
15	25537641	.	C	A	1	3	4	0	0	4	0	0
15	25537860	.	C	A	2	6	8	0	1	10	1	0
15	25538178	.	A	G	2	5	7	0	3	10	0	0
15	25538381	.	T	C	4	7	11	0	0	11	0	0
15	25538793	.	G	A	0	3	3	0	6	9	0	0
15	25588805	.	A	G	10	20	30	0	0	30	0	0
15	25588836	.	A	C	21	17	38	0	1	39	0	0
15	25588840	.	T	C	21	1	22	0	17	39	0	0
15	25589119	.	G	T	12	10	22	0	0	22	0	0
15	25589197	.	T	A	19	19	38	0	1	39	0	0
15	25589280	.	G	T	9	22	31	0	2	33	0	0
15	25589438	.	C	G	12	16	28	0	1	29	0	0
15	25589582	.	G	C	10	17	27	0	3	30	0	0
15	25589624	.	C	T	13	14	27	0	0	27	0	0
15	25589640	.	T	C	11	13	24	0	2	26	0	0
15	25589708	.	A	G	18	14	32	0	1	33	0	0
15	25589812	.	A	T	17	7	24	0	1	25	0	0
15	25589838	.	A	G	12	10	22	0	2	24	0	0
15	25589979	.	T	A	4	15	19	0	0	19	0	0
15	25589983	.	C	T	4	14	18	0	2	20	0	0
15	25590022	.	A	G	5	13	18	0	1	19	0	0
15	25590129	.	A	G	5	13	18	0	1	19	0	0
15	25590155	.	T	C	7	15	22	0	0	22	0	0
15	25590235	.	A	G	1	9	10	0	0	10	0	0
15	25590240	.	A	G	1	10	11	0	0	11	0	0
15	25590297	.	A	G	4	12	16	0	0	16	0	0
15	25590394	.	T	A	9	5	14	0	2	16	0	0
15	25590474	.	G	A	7	12	19	0	0	19	0	0
15	25590585	.	G	T	4	9	13	1	0	14	0	0
15	25590820	.	A	G	2	10	12	0	0	12	0	0
15	25591541	.	A	T	18	16	34	0	0	34	0	0
15	25591553	.	A	C	16	14	30	0	2	32	0	0
15	25591807	.	C	G	11	10	21	0	0	21	0	0
15	25591820	.	A	T	9	10	19	0	0	19	0	0
15	25591846	.	A	G	8	11	19	0	1	20	0	0
15	25591938	.	C	T	3	4	7	0	0	7	0	0
15	25592064	.	C	T	6	4	10	0	0	10	0	0
15	25592080	.	C	T	0	6	6	0	5	11	0	0
15	25592126	.	C	G	5	4	9	0	0	9	0	0
15	25592223	.	A	G	3	3	6	0	0	6	0	0
15	25592606	.	T	A	5	8	13	0	0	13	0	0
15	25593187	.	T	G	7	4	11	0	0	11	0	0
15	25594091	.	A	G	3	5	8	0	0	8	0	0
15	25594214	.	A	C	3	3	6	0	0	6	0	0
15	25594345	.	C	T	0	10	10	0	2	12	0	0
15	25594810	.	A	C	1	3	4	0	0	4	0	0
15	25595049	.	G	T	5	2	7	0	0	7	0	0
15	25595187	.	T	C	6	3	9	0	1	10	0	0
15	25595702	.	T	C	8	5	13	0	1	14	0	0
15	25598873	.	T	A	0	1	1	0	0	1	0	0
15	25598963	.	G	A	5	11	16	0	2	18	0	0
15	25602843	.	T	C	0	1	1	0	0	1	0	0
15	25602846	.	G	A	0	1	1	0	0	1	0	0
15	25602915	.	A	G	2	5	7	0	1	8	0	0
15	25603017	.	G	A	3	1	4	0	0	4	0	0
15	25605041	.	A	G	7	8	15	0	0	15	0	0
15	25628766	.	T	C	3	3	6	0	1	7	0	0
15	25628860	.	G	C	3	1	4	0	0	4	0	0
15	25628863	.	A	G	3	0	3	0	1	4	0	0
15	25635424	.	C	T	1	8	9	0	1	10	0	0
15	25638600	.	G	A	3	5	8	0	0	8	0	0
15	25640891	.	C	T	3	3	6	0	0	6	0	0
15	25640892	.	T	G	3	3	6	0	0	6	0	0
15	25649944	.	G	A	4	2	6	0	0	6	0	0
15	25649959	.	G	A	6	1	7	0	0	7	0	0
15	25650100	.	T	G	1	1	2	0	0	2	0	0
15	25653349	.	A	G	1	0	1	0	0	1	0	0
15	25656103	.	C	T	5	5	10	0	0	10	0	0
15	25656175	.	A	G	5	3	8	0	1	9	0	0
15	25688079	.	T	C	1	3	4	0	0	4	0	0
15	25910655	.	A	C	4	5	9	0	1	10	0	0
15	25910882	.	A	T	8	3	11	0	0	11	0	0
15	25910901	.	G	A	9	2	11	0	0	11	0	0
15	25971207	.	C	T	4	1	5	0	0	5	0	0
15	25971213	.	C	T	4	1	5	0	0	5	0	0
15	26399801	.	T	C	4	3	7	0	0	7	0	0
15	26400297	.	G	C	4	6	10	0	3	13	0	0
15	26400300	.	A	C	6	6	12	0	2	14	0	0
15	26400743	.	T	G	11	3	14	0	1	15	0	0
15	26400766	.	A	G	17	6	23	0	1	24	0	0
15	26400819	.	A	G	17	8	25	0	2	27	0	0
15	26400836	.	G	A	16	8	24	0	1	25	0	0
15	26400876	.	G	A	10	12	22	0	0	22	0	0
15	26400900	.	C	T	7	9	16	0	1	17	0	0
15	26400924	.	A	T	9	14	23	0	0	23	0	0
15	26401101	.	A	G	7	8	15	0	0	15	0	0
15	26401194	.	T	G	4	3	7	0	0	7	0	0
15	26401200	.	C	T	3	4	7	0	1	8	0	0
15	26401259	.	A	C	4	4	8	0	0	8	0	0
15	26401623	.	A	T	13	6	19	0	0	19	0	0
15	26401779	.	A	G	13	9	22	0	0	22	0	0
15	26401880	.	A	T	4	5	9	0	1	10	0	0
15	26401888	.	G	C	4	3	7	0	1	8	0	0
15	26402167	.	G	A	8	8	16	0	1	17	0	0
15	26498400	.	T	G	3	2	5	0	0	5	0	0
15	26498455	.	A	T	2	5	7	0	1	8	0	0
15	26498615	.	C	T	9	12	21	0	0	21	0	0
15	26498621	.	C	A	10	13	23	0	0	23	0	0
15	26498716	.	A	G	14	8	22	0	1	23	0	0
15	26498749	.	A	T	12	11	23	0	1	24	0	0
15	26498820	.	T	G	8	15	23	0	3	26	0	0
15	26505495	.	C	A	4	1	5	0	0	5	0	0
15	26515021	.	C	T	0	4	4	0	3	7	0	0
15	26534203	.	G	A	3	3	6	0	0	7	1	0
15	26538874	.	A	G	2	3	5	0	0	5	0	0
15	26538885	.	G	A	2	4	6	0	0	6	0	0
15	26553093	.	A	T	2	8	10	0	0	10	0	0
15	26553095	.	T	C	2	8	10	0	0	10	0	0
15	26553491	.	C	T	2	3	5	0	0	5	0	0
15	26554162	.	A	G	3	3	6	0	0	6	0	0
15	26554181	.	T	C	3	2	5	0	0	5	0	0
15	26554442	.	C	T	2	2	4	0	0	4	0	0
15	26554686	.	G	A	5	2	7	0	0	7	0	0
15	26554939	.	T	C	2	0	2	0	5	7	0	0
15	26561347	.	G	A	2	8	10	0	0	10	0	0
15	26561407	.	C	G	2	3	5	0	0	5	0	0
15	26561468	.	C	T	1	2	3	0	0	3	0	0
15	26561610	.	A	T	4	2	6	0	0	6	0	0
15	26563751	.	A	G	1	0	1	0	0	1	0	0
15	26564209	.	G	A	2	2	4	0	0	4	0	0
15	26565371	.	G	A	3	2	5	0	0	5	0	0
15	26566114	.	G	A	2	2	4	0	0	4	0	0
15	26616188	.	T	C	1	0	1	0	3	4	0	0
15	26616225	.	C	T	1	1	2	0	0	2	0	0
15	26678917	.	C	A	0	4	4	0	4	8	0	0
15	26678932	.	T	A	3	6	9	0	0	9	0	0
15	26679070	.	T	A	3	4	7	0	0	7	0	0
15	26679374	.	C	T	3	3	6	0	0	6	0	0
15	26679908	.	C	T	0	8	8	0	7	15	0	0
15	26683504	.	A	G	2	1	3	0	0	3	0	0
15	26683758	.	G	A	16	10	26	0	0	26	0	0
15	26683764	.	G	A	10	14	24	0	1	25	0	0
15	26686828	.	A	T	1	1	2	0	1	15	12	0
15	26707518	.	G	A	4	8	12	0	0	12	0	0
15	26707569	.	G	T	2	0	2	0	0	2	0	0
15	26710306	.	G	A	7	5	12	0	0	12	0	0
15	26720581	.	C	T	0	2	2	0	2	4	0	0
15	26729480	.	G	A	6	4	10	0	0	10	0	0
15	26787927	.	C	T	1	1	2	0	0	2	0	0
15	26843956	.	A	G	1	1	2	0	0	2	0	0
15	26844074	.	T	G	6	4	10	0	0	10	0	0
15	26844077	.	A	T	6	4	10	0	0	10	0	0
15	26849351	.	A	G	1	2	3	0	0	3	0	0
15	26849890	.	G	A	5	3	8	0	0	8	0	0
15	26880427	.	G	T	1	2	3	0	1	4	0	0
15	26884010	.	G	C	1	0	1	0	0	1	0	0
15	26885449	.	C	T	0	1	1	0	0	1	0	0
15	26904430	.	A	G	7	5	12	0	0	12	0	0
15	26904779	.	G	A	5	3	8	0	0	8	0	0
15	26904838	.	A	G	7	4	11	0	0	11	0	0
15	26904942	.	C	A	0	3	3	0	4	7	0	0
15	26905088	.	A	G	7	4	11	0	0	11	0	0
15	26905118	.	T	G	6	4	10	0	1	11	0	0
15	26915384	.	T	A	13	9	22	0	2	24	0	0
15	26915531	.	A	G	12	9	21	0	0	21	0	0
15	26915568	.	G	A	14	10	24	0	1	25	0	0
15	26915633	.	C	T	3	8	11	0	0	11	0	0
15	26915651	.	T	C	2	4	6	0	0	6	0	0
15	26919255	.	T	C	2	4	6	0	2	8	0	0
15	26921873	.	T	C	1	0	1	0	0	1	0	0
15	26924056	.	T	C	7	5	12	0	1	13	0	0
15	26924080	.	C	G	0	5	5	0	5	10	0	0
15	26926474	.	G	A	2	4	6	0	0	6	0	0
15	26926653	.	A	C	0	1	1	0	0	1	0	0
15	26935032	.	A	T	5	6	11	0	1	12	0	0
15	26935696	.	G	A	3	0	3	0	0	3	0	0
15	26938324	.	A	C	1	4	5	0	1	6	0	0
15	26939031	.	C	A	6	4	10	0	1	11	0	0
15	26939224	.	G	T	6	1	7	0	0	7	0	0
15	26939233	.	A	C	2	5	7	0	2	9	0	0
15	26939279	.	G	A	0	6	6	0	5	11	0	0
15	26939364	.	A	G	1	1	2	0	1	3	0	0
15	27071096	.	C	G	2	1	3	0	1	4	0	0
15	27071099	.	A	G	3	1	4	0	0	4	0	0
15	27071735	.	G	A	1	2	3	0	0	3	0	0
15	27071792	.	T	G	9	5	14	0	0	14	0	0
15	27071849	.	G	A	10	3	13	0	1	14	0	0
15	27087813	.	C	T	6	6	12	0	2	14	0	0
15	27328142	.	T	G	1	0	1	0	12	13	0	0
15	27352608	.	G	A	1	3	4	0	0	4	0	0
15	27352760	.	T	A	0	2	2	0	1	3	0	0
15	27353481	.	G	A	2	4	6	0	0	6	0	0
15	27354412	.	T	A	12	16	28	0	0	28	0	0
15	27371021	.	T	A	3	6	9	0	0	9	0	0
15	27703845	.	A	G	13	20	33	0	2	35	0	0
15	27704220	.	C	A	0	7	7	0	20	27	0	0
15	27710392	.	A	G	6	8	14	0	0	14	0	0
15	27710396	.	C	T	5	8	13	0	1	14	0	0
15	28079317	.	T	A	2	5	7	0	0	8	1	0
15	28082567	.	A	G	1	3	4	0	0	4	0	0
15	28085382	.	T	C	3	4	7	0	0	7	0	0
15	28085422	.	G	A	4	3	7	0	0	7	0	0
15	28106804	.	A	G	2	6	8	0	0	8	0	0
15	28124642	.	C	T	4	2	6	0	0	6	0	0
15	28124913	.	T	C	1	2	3	0	0	3	0	0
15	28125146	.	A	G	3	0	3	0	10	13	0	0
15	28125186	.	A	G	4	7	11	0	0	11	0	0
15	28178147	.	C	T	3	3	6	0	0	6	0	0
15	28178188	.	C	T	1	4	5	0	0	5	0	0
15	28178197	.	C	T	1	5	6	0	0	6	0	0
15	28178256	.	A	G	1	2	3	0	0	3	0	0
15	28178263	.	C	T	1	2	3	0	0	3	0	0
15	28180123	.	G	A	0	3	3	0	0	3	0	0
15	28180126	.	G	C	0	2	2	0	1	3	0	0
15	28182837	.	A	G	1	0	1	0	0	1	0	0
15	28182924	.	T	C	4	2	6	0	0	6	0	0
15	28182927	.	T	C	3	2	5	0	1	6	0	0
15	28189029	.	T	A	5	7	12	0	0	12	0	0
15	28189046	.	T	G	7	8	15	0	0	15	0	0
15	28189409	.	A	C	4	7	11	0	0	11	0	0
15	28189589	.	T	C	6	0	6	0	9	15	0	0
15	28189591	.	T	C	5	9	14	0	1	15	0	0
15	28189945	.	T	G	2	4	6	0	0	6	0	0
15	28192706	.	A	G	10	13	23	0	0	23	0	0
15	28194669	.	T	C	2	2	4	0	2	6	0	0
15	28194708	.	A	G	5	8	13	0	0	13	0	0
15	28199233	.	G	A	2	3	5	0	0	5	0	0
15	28199431	.	A	G	2	6	8	0	0	8	0	0
15	28199437	.	A	T	2	4	6	0	1	7	0	0
15	28199574	.	T	C	3	2	5	0	0	5	0	0
15	28199905	.	T	G	6	1	7	0	0	7	0	0
15	28199912	.	T	C	6	1	7	0	1	8	0	0
15	28230658	.	A	G	2	3	5	0	0	5	0	0
15	28230738	.	G	A	0	2	2	0	0	2	0	0
15	28247443	.	A	C	3	2	5	0	0	5	0	0
15	28247465	.	C	G	2	2	4	0	0	4	0	0
15	28249301	.	G	T	4	8	12	0	0	12	0	0
15	28251094	.	T	A	1	1	2	0	0	2	0	0
15	28252597	.	T	C	12	9	21	0	0	21	0	0
15	28252599	.	A	G	12	8	20	0	1	21	0	0
15	28253171	.	C	A	0	10	10	0	9	19	0	0
15	28253522	.	C	T	7	5	12	0	0	12	0	0
15	28253773	.	C	T	7	6	13	0	1	14	0	0
15	28254184	.	T	C	0	2	2	0	0	2	0	0
15	28254202	.	G	T	4	4	8	0	0	8	0	0
15	28257277	.	A	G	0	1	1	0	0	1	0	0
15	28259321	.	T	C	3	2	5	0	0	5	0	0
15	28259773	.	C	T	0	3	3	0	3	6	0	0
15	28259971	.	G	A	4	2	6	0	1	7	0	0
15	28260007	.	C	T	4	2	6	0	0	6	0	0
15	28260031	.	A	G	1	1	2	0	0	2	0	0
15	28260381	.	A	T	3	7	10	0	0	10	0	0
15	28260522	.	T	A	0	1	1	0	1	2	0	0
15	28343667	.	C	T	0	3	3	0	0	3	0	0
15	28349816	.	C	T	3	1	4	0	0	4	0	0
15	28350079	.	C	G	3	4	7	0	0	7	0	0
15	28350095	.	C	T	4	4	8	0	0	8	0	0
15	28350999	.	T	G	4	2	6	0	0	6	0	0
15	28351020	.	A	G	8	2	10	0	0	10	0	0
15	28351571	.	T	G	2	1	3	0	0	3	0	0
15	28351591	.	G	T	2	2	4	0	1	5	0	0
15	28352138	.	T	C	7	4	11	0	0	11	0	0
15	28352168	.	C	A	8	4	12	0	0	12	0	0
15	28368884	.	G	A	5	2	7	0	0	7	0	0
15	28370974	.	T	C	1	1	2	0	0	2	0	0
15	28392769	.	G	T	5	6	11	0	0	11	0	0
15	28401905	.	A	T	2	0	2	0	0	2	0	0
15	28403365	.	C	T	7	4	11	0	0	11	0	0
15	28432697	.	C	A	6	17	23	0	2	25	0	0
15	28432739	.	C	T	10	15	25	0	1	26	0	0
15	28432741	.	A	T	8	16	24	0	1	26	1	0
15	28432871	.	T	C	10	3	13	0	1	14	0	0
15	28432993	.	C	T	0	13	13	0	9	22	0	0
15	28433073	.	A	G	6	8	14	0	1	15	0	0
15	28433102	.	C	A	4	8	12	0	0	12	0	0
15	28433126	.	G	T	4	5	9	0	0	9	0	0
15	28433161	.	T	C	2	7	9	0	0	9	0	0
15	28433282	.	G	A	15	9	24	0	1	25	0	0
15	28433947	.	A	G	13	13	26	0	1	27	0	0
15	28437178	.	G	T	6	4	10	0	1	11	0	0
15	28439441	.	G	A	3	2	5	0	0	5	0	0
15	28443495	.	T	C	1	0	1	0	2	3	0	0
15	28446791	.	A	T	7	8	15	0	1	16	0	0
15	28452844	.	A	G	2	2	4	0	0	4	0	0
15	28453081	.	C	A	0	3	3	0	2	5	0	0
15	28453102	.	C	T	1	0	1	0	0	1	0	0
15	28463609	.	C	T	0	6	6	0	0	6	0	0
15	28480345	.	A	T	4	3	7	0	0	7	0	0
15	28483230	.	C	T	3	6	9	0	0	9	0	0
15	28483333	.	A	C	3	2	5	0	0	5	0	0
15	28509840	.	G	A	3	6	9	0	0	9	0	0
15	28515428	.	C	A	6	3	9	0	0	9	0	0
15	28520856	.	A	G	1	0	1	0	2	3	0	0
15	28526386	.	A	T	2	5	7	0	0	7	0	0
15	28537810	.	T	A	6	8	14	0	2	16	0	0
15	28537852	.	T	C	7	6	13	0	1	14	0	0
15	28537872	.	G	A	1	3	4	0	8	12	0	0
15	28537906	.	A	C	5	3	8	0	0	8	0	0
15	28537965	.	T	A	3	3	6	0	0	6	0	0
15	28538012	.	G	A	0	7	7	0	8	15	0	0
15	28538097	.	A	G	7	0	7	0	6	13	0	0
15	28538173	.	G	A	5	4	9	0	1	10	0	0
15	28538199	.	T	C	7	4	11	0	0	11	0	0
15	28538239	.	G	T	9	3	12	0	0	12	0	0
15	28538405	.	T	C	7	10	17	0	0	17	0	0
15	28538602	.	A	T	9	3	12	0	1	13	0	0
15	28538605	.	G	A	0	2	2	0	10	12	0	0
15	28538667	.	A	G	5	4	9	0	1	10	0	0
15	28538761	.	A	G	8	5	13	0	1	14	0	0
15	28538765	.	C	T	8	5	13	0	0	13	0	0
15	28538984	.	C	T	2	4	6	0	0	6	0	0
15	28539022	.	C	A	7	7	14	0	0	14	0	0
15	28539112	.	C	T	5	5	10	0	0	10	0	0
15	28539160	.	T	C	6	4	10	0	2	12	0	0
15	28539232	.	C	T	7	4	11	0	1	12	0	0
15	28539381	.	A	T	3	5	8	0	1	10	1	0
15	28539383	.	A	T	4	6	10	0	0	10	0	0
15	28539523	.	T	C	3	12	15	0	0	15	0	0
15	28539556	.	G	A	3	11	14	0	0	14	0	0
15	28539607	.	A	G	2	4	6	0	2	8	0	0
15	28539649	.	T	A	7	2	9	0	0	9	0	0
15	28549003	.	G	A	5	2	7	0	0	7	0	0
15	28549347	.	G	T	7	3	10	0	0	10	0	0
15	28549348	.	T	A	7	3	10	0	0	10	0	0
15	28549392	.	A	C	8	5	13	0	0	13	0	0
15	28549872	.	A	C	5	2	7	0	0	7	0	0
15	28550758	.	G	C	1	0	1	0	0	1	0	0
15	28551281	.	G	A	3	2	5	0	0	5	0	0
15	28551285	.	G	A	3	2	5	0	0	5	0	0
15	28551498	.	A	G	6	3	9	0	0	9	0	0
15	28552415	.	G	C	1	2	3	0	0	3	0	0
15	28609097	.	G	A	1	5	6	0	1	7	0	0
15	28634719	.	G	A	7	12	19	0	0	19	0	0
15	28646687	.	G	A	0	1	1	0	0	1	0	0
15	28646696	.	T	C	0	0	0	0	2	2	0	0
15	28672508	.	T	G	2	0	2	0	0	2	0	0
15	28677558	.	T	A	0	1	1	0	0	1	0	0
15	28677671	.	C	A	1	2	3	0	0	3	0	0
15	28677675	.	G	A	1	2	3	0	0	3	0	0
15	28686433	.	A	T	24	10	34	0	2	36	0	0
15	28758907	.	G	C	0	18	18	0	17	35	0	0
15	28758988	.	C	T	15	25	40	0	0	40	0	0
15	28759171	.	T	G	21	0	21	0	16	37	0	0
15	28759246	.	G	C	1	8	9	0	29	38	0	0
15	28759558	.	C	G	14	0	14	0	10	24	0	0
15	28759639	.	G	A	7	8	15	0	0	15	0	0
15	28760090	.	T	C	15	24	39	0	0	39	0	0
15	28760675	.	A	T	21	15	36	0	0	36	0	0
15	28761031	.	T	C	13	9	22	0	1	23	0	0
15	28761173	.	T	C	10	16	26	0	2	28	0	0
15	28761284	.	T	A	12	16	28	0	1	30	1	0
15	28762440	.	C	T	15	27	42	0	2	44	0	0
15	28763124	.	T	C	13	25	38	0	1	39	0	0
15	28763134	.	T	C	11	23	34	0	2	36	0	0
15	28763677	.	C	A	24	17	41	0	1	43	1	0
15	28763770	.	T	C	16	29	45	0	1	46	0	0
15	28763927	.	G	A	0	29	29	0	20	49	0	0
15	28763986	.	G	A	3	26	29	0	16	45	0	0
15	28764206	.	G	T	0	17	17	0	16	33	0	0
15	28764252	.	A	G	20	1	21	0	32	53	0	0
15	28766069	.	A	G	7	5	12	0	0	12	0	0
15	28787262	.	T	A	2	3	5	0	0	5	0	0
15	28792399	.	C	A	1	3	4	0	0	4	0	0
15	28802136	.	A	T	1	3	4	0	0	4	0	0
15	28881717	.	G	A	1	7	8	0	0	8	0	0
15	28882675	.	T	A	8	9	17	0	1	18	0	0
15	28882687	.	A	G	8	5	13	0	1	14	0	0
15	28886882	.	A	T	0	3	3	0	1	4	0	0
15	28887280	.	G	T	4	1	5	0	0	5	0	0
15	28887667	.	A	G	3	4	7	0	0	7	0	0
15	28963310	.	T	C	2	3	5	0	0	5	0	0
15	28972971	.	A	G	5	4	9	0	0	9	0	0
15	28973434	.	C	A	2	3	5	0	0	5	0	0
15	29000989	.	C	T	13	18	31	0	2	33	0	0
15	29001556	.	C	T	21	16	37	0	2	39	0	0
15	29001583	.	T	C	14	10	24	0	2	26	0	0
15	29005346	.	T	A	9	19	28	0	0	28	0	0
15	29005363	.	A	C	8	12	20	0	2	22	0	0
15	29005564	.	T	G	3	15	18	0	2	20	0	0
15	29005600	.	A	C	11	17	28	0	0	28	0	0
15	29005862	.	T	A	21	10	31	0	2	33	0	0
15	29005869	.	A	T	19	9	28	0	2	30	0	0
15	29005935	.	C	T	22	15	37	0	1	38	0	0
15	29005984	.	C	T	22	15	37	0	1	38	0	0
15	29005996	.	C	A	19	16	35	0	0	35	0	0
15	29006097	.	C	T	16	19	35	1	1	37	0	0
15	29006142	.	G	A	0	14	14	0	26	40	0	0
15	29089143	.	T	A	26	19	45	0	1	46	0	0
15	29089279	.	C	A	26	12	38	0	6	44	0	0
15	29089317	.	A	G	29	12	41	0	1	42	0	0
15	29089392	.	A	G	15	20	35	0	0	35	0	0
15	29089524	.	T	C	26	20	46	0	0	46	0	0
15	29089788	.	G	A	18	28	46	0	1	47	0	0
15	29089827	.	G	T	0	17	17	0	26	43	0	0
15	29089870	.	C	T	28	21	49	0	2	51	0	0
15	29090181	.	A	G	26	29	55	0	4	59	0	0
15	29091565	.	G	A	25	18	43	0	5	48	0	0
15	29092871	.	C	T	4	3	7	0	0	7	0	0
15	29097640	.	A	G	7	6	13	0	0	13	0	0
15	29100574	.	T	G	5	4	9	0	0	9	0	0
15	29100623	.	G	A	4	3	7	0	0	7	0	0
15	29100934	.	C	G	1	0	1	0	0	1	0	0
15	29104050	.	G	A	2	3	5	0	1	6	0	0
15	29108812	.	T	C	8	3	11	0	0	11	0	0
15	29108872	.	A	G	1	1	2	0	0	2	0	0
15	29111902	.	A	C	3	0	3	0	3	6	0	0
15	29111969	.	C	T	2	1	3	0	0	3	0	0
15	29111970	.	T	C	2	1	3	0	0	3	0	0
15	29112164	.	C	T	1	0	1	0	0	1	0	0
15	29114289	.	C	A	4	3	7	0	0	7	0	0
15	29114337	.	C	G	0	3	3	0	11	14	0	0
15	29114361	.	A	T	11	3	14	0	1	15	0	0
15	29116177	.	T	C	5	8	13	0	0	13	0	0
15	29116264	.	A	G	6	18	24	0	0	24	0	0
15	29119813	.	A	C	2	3	5	0	0	5	0	0
15	29119829	.	A	C	2	3	5	0	0	5	0	0
15	29122072	.	T	A	7	10	17	0	1	18	0	0
15	29123085	.	G	T	1	2	3	0	1	4	0	0
15	29136127	.	A	T	2	0	2	0	0	2	0	0
15	29148674	.	T	C	1	6	7	0	0	7	0	0
15	29148675	.	T	G	1	0	1	0	6	7	0	0
15	29152041	.	G	T	5	3	8	0	0	8	0	0
15	29297445	.	C	T	3	2	5	0	0	5	0	0
15	29297752	.	G	A	3	3	6	0	0	6	0	0
15	29312303	.	C	A	1	3	4	0	0	4	0	0
15	29312748	.	T	C	2	1	3	0	1	4	0	0
15	29312763	.	C	T	2	1	3	0	1	4	0	0
15	29316909	.	A	G	4	4	8	0	0	8	0	0
15	29343748	.	A	G	1	4	5	0	0	5	0	0
15	29343826	.	G	A	1	4	5	0	0	5	0	0
15	29343863	.	A	G	2	3	5	0	1	6	0	0
15	29344098	.	C	T	1	5	6	0	0	6	0	0
15	29353911	.	C	T	1	1	2	0	1	3	0	0
15	29383494	.	T	C	1	2	3	0	0	3	0	0
15	29383771	.	C	G	1	2	3	0	0	3	0	0
15	29454352	.	G	A	0	2	2	0	0	2	0	0
15	29456387	.	A	G	7	1	8	0	0	8	0	0
15	29456410	.	C	T	4	0	4	0	1	5	0	0
15	29459013	.	A	G	4	2	6	0	0	6	0	0
15	29459046	.	G	A	6	5	11	0	0	11	0	0
15	29465874	.	T	C	8	5	13	0	1	14	0	0
15	29467216	.	T	A	11	7	18	0	1	19	0	0
15	29467254	.	A	G	12	1	13	0	7	20	0	0
15	29469851	.	G	T	8	3	11	0	1	12	0	0
15	29481884	.	A	G	9	14	23	0	0	23	0	0
15	29481921	.	G	A	0	6	6	0	13	19	0	0
15	29482286	.	G	C	12	5	17	0	0	17	0	0
15	29482439	.	A	G	7	9	16	0	0	16	0	0
15	29483095	.	T	G	5	3	8	0	1	9	0	0
15	29483326	.	G	A	0	2	2	0	6	8	0	0
15	29483434	.	G	C	8	10	18	0	2	20	0	0
15	29483608	.	A	T	6	10	16	0	0	16	0	0
15	29483851	.	G	T	20	9	29	0	0	29	0	0
15	29549217	.	A	G	2	2	4	0	0	4	0	0
15	29549804	.	C	T	0	4	4	0	4	8	0	0
15	29555793	.	A	G	4	7	11	0	0	11	0	0
15	29709825	.	T	C	2	4	6	0	0	6	0	0
15	29710065	.	A	G	11	5	16	0	1	17	0	0
15	29710305	.	T	C	4	4	8	0	1	9	0	0
15	29710737	.	G	T	2	3	5	0	0	5	0	0
15	29712127	.	C	A	4	7	11	0	0	11	0	0
15	29712210	.	G	A	0	9	9	0	9	18	0	0
15	29712221	.	C	T	6	11	17	0	0	17	0	0
15	29712405	.	G	A	8	9	17	0	2	19	0	0
15	29712794	.	C	T	2	3	5	0	0	5	0	0
15	29772299	.	T	A	6	2	8	0	0	8	0	0
15	29775134	.	A	G	4	2	6	0	1	7	0	0
15	29889577	.	G	A	1	2	3	0	1	4	0	0
15	30127451	.	T	C	2	2	4	0	0	4	0	0
15	30130286	.	G	T	3	4	7	0	0	7	0	0
15	30130530	.	A	C	4	10	14	0	0	14	0	0
15	30130664	.	G	A	0	6	6	0	10	16	0	0
15	30131482	.	G	A	6	10	16	0	1	17	0	0
15	30131585	.	C	T	9	6	15	0	0	15	0	0
15	30131803	.	G	A	1	5	6	0	0	6	0	0
15	30134489	.	G	A	10	9	19	0	0	19	0	0
15	30134679	.	C	G	4	7	11	0	0	11	0	0
15	30134779	.	G	T	7	6	13	0	0	13	0	0
15	30135016	.	T	A	3	5	8	0	0	8	0	0
15	30135206	.	G	A	0	8	8	0	9	17	0	0
15	30135572	.	A	G	5	0	5	0	15	20	0	0
15	30135920	.	A	G	3	10	13	0	0	13	0	0
15	30136445	.	G	A	3	5	8	0	1	9	0	0
15	30136472	.	A	G	4	2	6	0	0	6	0	0
15	30136512	.	T	A	4	4	8	0	0	8	0	0
15	30136962	.	A	G	11	0	11	0	11	22	0	0
15	30137561	.	C	T	9	19	28	0	0	28	0	0
15	30157713	.	A	G	4	1	5	0	8	13	0	0
15	30158096	.	G	T	0	5	5	0	9	14	0	0
15	30158798	.	A	C	2	1	3	0	10	13	0	0
15	30159050	.	A	T	9	6	15	0	1	16	0	0
15	30252414	.	T	C	6	6	12	0	0	12	0	0
15	30265017	.	C	T	6	3	9	0	0	9	0	0
15	30301196	.	G	A	0	6	6	0	7	13	0	0
15	30301239	.	G	A	1	4	5	0	5	10	0	0
15	30301320	.	T	C	11	11	22	0	0	22	0	0
15	30301447	.	G	A	4	9	13	0	0	13	0	0
15	30301474	.	G	A	6	6	12	0	0	12	0	0
15	30311016	.	C	T	4	5	9	0	1	10	0	0
15	30311062	.	G	T	0	5	5	0	8	13	0	0
15	30311616	.	T	G	0	2	2	0	0	2	0	0
15	30311760	.	A	C	0	3	3	0	0	3	0	0
15	30311762	.	A	G	0	3	3	0	0	3	0	0
15	30354513	.	G	T	7	7	14	0	1	15	0	0
15	30354603	.	A	T	3	7	10	0	0	10	0	0
15	30424673	.	C	T	1	6	7	0	5	12	0	0
15	30425715	.	C	T	7	2	9	0	1	10	0	0
15	30425936	.	G	A	8	8	16	0	1	17	0	0
15	30838455	.	C	G	4	7	11	0	1	12	0	0
15	30838498	.	G	A	0	10	10	0	0	10	0	0
15	30838777	.	G	A	22	17	39	0	0	39	0	0
15	30838867	.	C	T	19	14	33	0	0	33	0	0
15	30838991	.	C	A	11	6	17	0	6	23	0	0
15	30839168	.	A	T	11	11	22	0	0	22	0	0
15	30852433	.	G	A	6	8	14	0	3	17	0	0
15	30852598	.	T	C	4	5	9	0	0	9	0	0
15	30853039	.	G	T	11	6	17	0	4	21	0	0
15	30853096	.	T	A	8	13	21	0	1	22	0	0
15	30861987	.	C	A	0	2	2	0	11	13	0	0
15	30862251	.	A	T	8	11	19	0	1	20	0	0
15	30862449	.	A	G	6	5	11	0	1	12	0	0
15	30862452	.	G	T	5	7	12	0	0	12	0	0
15	30862517	.	G	A	3	4	7	0	0	7	0	0
15	30862712	.	G	A	8	7	15	0	2	17	0	0
15	30862785	.	C	T	7	5	12	0	0	12	0	0
15	30862814	.	A	G	8	11	19	0	1	20	0	0
15	30862997	.	T	G	1	2	3	0	0	3	0	0
15	30863059	.	T	C	4	0	4	0	4	8	0	0
15	30863117	.	T	C	3	2	5	0	0	5	0	0
15	30863123	.	A	C	2	4	6	0	0	6	0	0
15	30863242	.	T	C	3	4	7	0	1	8	0	0
15	30863354	.	C	T	6	5	11	0	0	11	0	0
15	30863535	.	G	T	14	10	24	0	3	27	0	0
15	30863569	.	G	A	18	12	30	0	0	30	0	0
15	30863799	.	T	C	7	0	7	0	5	12	0	0
15	30863834	.	G	T	6	8	14	0	0	14	0	0
15	30863850	.	T	C	8	9	17	0	0	17	0	0
15	30864072	.	T	G	3	3	6	0	0	6	0	0
15	30864308	.	C	A	10	16	26	0	0	26	0	0
15	30864354	.	T	C	5	2	7	0	7	14	0	0
15	30874327	.	A	G	11	8	19	0	1	20	0	0
15	30874387	.	G	A	3	2	5	0	0	5	0	0
15	30883761	.	T	C	3	0	3	0	3	6	0	0
15	30887163	.	G	A	0	1	1	0	1	2	0	0
15	30889297	.	T	C	0	1	1	0	0	1	0	0
15	30891570	.	A	G	5	2	7	0	0	7	0	0
15	30891636	.	C	T	4	2	6	0	0	6	0	0
15	30891645	.	G	A	3	2	5	0	1	6	0	0
15	30900478	.	A	G	2	5	7	0	0	7	0	0
15	30902892	.	C	T	0	2	2	0	2	4	0	0
15	30904802	.	G	A	0	2	2	0	0	2	0	0
15	30906732	.	T	C	2	1	3	0	0	3	0	0
15	30906733	.	C	T	2	1	3	0	0	3	0	0
15	30906972	.	G	A	4	3	7	0	0	7	0	0
15	30907089	.	C	G	0	2	2	0	2	4	0	0
15	30907811	.	A	G	1	7	8	0	1	9	0	0
15	30907818	.	G	A	0	7	7	0	2	9	0	0
15	30907884	.	C	A	9	5	14	0	1	15	0	0
15	30907888	.	A	G	9	0	9	0	6	16	1	0
15	30909175	.	C	G	13	0	13	0	15	28	0	0
15	30909308	.	G	A	0	18	18	0	8	26	0	0
15	30909572	.	C	A	10	12	22	0	1	24	1	0
15	30909639	.	A	G	11	9	20	0	1	21	0	0
15	30909663	.	G	A	10	5	15	0	0	15	0	0
15	30909707	.	A	T	3	11	14	0	1	15	0	0
15	30909771	.	T	C	3	14	17	0	0	17	0	0
15	30909798	.	A	G	3	0	3	0	7	10	0	0
15	30909824	.	A	C	4	9	13	0	0	13	0	0
15	30909884	.	C	T	18	7	25	0	0	25	0	0
15	30917695	.	T	G	1	1	2	0	5	7	0	0
15	30917715	.	A	G	3	8	11	0	0	11	0	0
15	30917737	.	C	T	7	7	14	0	0	14	0	0
15	30917750	.	A	T	7	11	18	0	0	18	0	0
15	30919478	.	C	T	5	5	10	0	0	10	0	0
15	30919595	.	T	C	5	6	11	0	2	13	0	0
15	30919676	.	G	T	10	5	15	0	1	16	0	0
15	30919784	.	A	G	11	6	17	0	2	19	0	0
15	30919854	.	T	G	8	6	14	0	0	14	0	0
15	30920135	.	A	G	5	5	10	0	0	10	0	0
15	30920242	.	A	C	6	5	11	0	0	11	0	0
15	30920698	.	C	A	11	11	22	0	2	24	0	0
15	30920780	.	T	C	6	9	15	0	0	15	0	0
15	30920795	.	A	G	7	6	13	0	0	13	0	0
15	30939882	.	T	C	2	0	2	0	0	2	0	0
15	30943184	.	A	G	0	1	1	0	0	1	0	0
15	30953189	.	C	G	2	2	4	0	0	4	0	0
15	30955388	.	G	A	0	2	2	0	0	2	0	0
15	31162074	.	T	A	14	11	25	0	0	25	0	0
15	31162122	.	A	G	12	22	34	0	0	34	0	0
15	31162186	.	G	C	8	18	26	0	1	27	0	0
15	31162795	.	G	A	14	10	24	0	1	25	0	0
15	31162836	.	A	G	13	9	22	0	0	22	0	0
15	31163089	.	G	A	10	10	20	0	0	20	0	0
15	31163148	.	T	A	9	13	22	0	2	24	0	0
15	31163335	.	A	T	8	12	20	0	1	21	0	0
15	31163621	.	T	A	28	16	44	0	1	45	0	0
15	31166755	.	C	A	5	6	11	0	0	11	0	0
15	31166788	.	A	G	0	2	2	0	0	2	0	0
15	31173414	.	G	A	6	8	14	0	0	14	0	0
15	31177053	.	A	G	8	1	9	0	0	9	0	0
15	31177054	.	T	A	7	1	8	0	1	9	0	0
15	31177214	.	T	G	9	7	16	0	0	16	0	0
15	31203002	.	A	G	0	2	2	0	1	3	0	0
15	31205723	.	A	G	4	8	12	0	1	13	0	0
15	31206401	.	A	G	2	8	10	0	0	10	0	0
15	31213017	.	T	C	3	0	3	0	6	9	0	0
15	31213046	.	T	G	2	6	8	0	0	8	0	0
15	31213208	.	C	T	1	9	10	0	2	12	0	0
15	31244298	.	C	T	0	3	3	0	3	6	0	0
15	31244339	.	A	T	5	2	7	0	1	8	0	0
15	31244412	.	C	T	0	12	12	0	8	20	0	0
15	31513561	.	G	A	22	27	49	0	4	53	0	0
15	31513842	.	A	G	22	24	46	0	2	48	0	0
15	31513848	.	T	C	20	23	43	0	2	45	0	0
15	31513893	.	C	A	0	6	6	0	2	8	0	0
15	31514325	.	A	G	17	21	38	0	2	40	0	0
15	31516046	.	G	A	2	7	9	0	0	9	0	0
15	31564314	.	G	A	2	5	7	0	0	7	0	0
15	31564691	.	A	G	2	2	4	0	0	4	0	0
15	31564864	.	G	T	7	2	9	0	0	9	0	0
15	31568159	.	C	T	0	0	0	0	5	5	0	0
15	31674120	.	G	T	4	0	4	0	0	4	0	0
15	31700738	.	C	T	3	4	7	0	1	8	0	0
15	31706200	.	G	C	2	3	5	0	0	5	0	0
15	31732502	.	A	G	7	7	14	0	1	15	0	0
15	31770141	.	C	A	0	1	1	0	0	1	0	0
15	31880100	.	A	T	1	3	4	0	0	4	0	0
15	31880109	.	T	G	0	2	2	0	0	2	0	0
15	31881873	.	G	A	0	6	6	0	4	10	0	0
15	31881954	.	T	C	8	5	13	0	0	13	0	0
15	31882044	.	A	G	7	2	9	0	0	9	0	0
15	31882167	.	G	A	3	2	5	0	1	6	0	0
15	31882176	.	A	G	3	4	7	0	0	7	0	0
15	31882269	.	G	A	1	3	4	0	1	5	0	0
15	31882272	.	A	G	2	3	5	0	0	5	0	0
15	31882342	.	C	T	2	6	8	0	0	8	0	0
15	31889005	.	T	G	1	4	5	0	0	5	0	0
15	31889086	.	A	G	2	3	5	0	0	5	0	0
15	31889332	.	C	T	1	0	1	0	0	1	0	0
15	31890902	.	T	G	5	4	9	0	0	9	0	0
15	31893536	.	A	C	5	6	11	0	0	11	0	0
15	31893599	.	C	T	0	2	2	0	1	3	0	0
15	31895248	.	A	G	3	0	3	0	7	10	0	0
15	31897859	.	T	G	1	0	1	0	8	9	0	0
15	31905040	.	G	A	19	11	30	0	0	30	0	0
15	31905097	.	A	G	10	3	13	0	1	14	0	0
15	31909454	.	A	C	18	8	26	0	0	26	0	0
15	31909819	.	G	A	0	4	4	0	5	9	0	0
15	31922969	.	T	C	2	1	3	0	0	3	0	0
15	32165799	.	G	C	1	0	1	0	0	1	0	0
15	32194223	.	A	T	1	3	4	0	0	4	0	0
15	32194286	.	G	A	1	3	4	0	2	6	0	0
15	32194550	.	A	C	2	2	4	0	0	4	0	0
15	32194630	.	C	A	1	2	3	0	0	3	0	0
15	32194945	.	C	A	3	2	5	0	0	5	0	0
15	32195432	.	G	A	4	5	9	0	0	9	0	0
15	32195521	.	T	C	3	7	10	0	1	11	0	0
15	32195718	.	G	A	2	2	4	0	0	4	0	0
15	32195729	.	A	G	1	2	3	0	0	3	0	0
15	32196093	.	G	A	0	2	2	0	4	6	0	0
15	32196613	.	T	C	1	2	3	0	0	3	0	0
15	32196615	.	G	T	0	2	2	0	1	3	0	0
15	32196655	.	A	C	1	2	3	0	0	3	0	0
15	32249188	.	G	A	14	13	27	0	1	28	0	0
15	32259056	.	G	A	11	7	18	0	1	19	0	0
15	32261461	.	G	C	0	13	13	0	11	24	0	0
15	32261464	.	T	C	13	10	23	0	1	24	0	0
15	32265889	.	T	C	14	11	25	0	0	25	0	0
15	32266557	.	A	T	8	8	16	0	1	17	0	0
15	32266653	.	A	G	10	10	20	0	1	21	0	0
15	32266661	.	A	G	5	16	21	0	0	21	0	0
15	32266921	.	G	A	0	11	11	0	15	26	0	0
15	32267078	.	A	G	2	5	7	0	1	8	0	0
15	32349754	.	A	G	9	7	16	0	0	16	0	0
15	32349980	.	A	G	6	5	11	0	1	12	0	0
15	32350116	.	G	T	8	6	14	0	1	15	0	0
15	32350515	.	A	G	16	9	25	0	2	27	0	0
15	32350762	.	A	G	8	6	14	0	0	14	0	0
15	32351183	.	A	G	5	3	8	0	0	8	0	0
15	32699447	.	G	A	0	3	3	0	1	4	0	0
15	32887799	.	A	G	7	4	11	0	1	12	0	0
15	32887803	.	A	G	9	0	9	0	3	12	0	0
15	32887858	.	A	G	6	5	11	0	2	13	0	0
15	32888352	.	A	G	3	1	4	0	1	5	0	0
15	33692044	.	C	T	1	0	1	0	0	1	0	0
15	33853701	.	C	T	4	1	5	0	0	5	0	0
15	33864152	.	A	G	3	5	8	0	0	8	0	0
15	33864266	.	G	A	10	10	20	0	0	20	0	0
15	33864585	.	G	A	9	7	16	0	0	16	0	0
15	33864713	.	T	C	2	3	5	0	0	5	0	0
15	33891825	.	G	A	20	12	32	0	0	32	0	0
15	33891826	.	G	A	19	11	30	0	2	32	0	0
15	33891869	.	G	T	14	13	27	0	0	27	0	0
15	33896117	.	G	T	13	14	27	0	1	28	0	0
15	33896177	.	T	C	14	24	38	0	5	43	0	0
15	33896213	.	T	C	19	2	21	0	27	48	0	0
15	33896303	.	T	A	19	21	40	0	2	42	0	0
15	33896306	.	A	G	22	18	40	0	1	41	0	0
15	33896832	.	T	C	13	16	29	0	2	31	0	0
15	33899556	.	C	G	11	12	23	0	1	24	0	0
15	33899808	.	T	A	15	16	31	0	4	35	0	0
15	33902388	.	C	G	0	12	12	0	11	23	0	0
15	33910546	.	G	C	5	3	8	0	0	8	0	0
15	33970841	.	A	G	19	1	20	0	15	35	0	0
15	33970854	.	C	T	18	14	32	0	1	33	0	0
15	33970907	.	C	T	3	3	6	0	0	6	0	0
15	33971097	.	G	C	15	18	33	0	0	33	0	0
15	33977716	.	A	T	18	14	32	0	2	34	0	0
15	33977760	.	A	G	16	0	16	0	18	34	0	0
15	33977942	.	A	C	8	11	19	0	0	19	0	0
15	34074558	.	C	T	2	5	7	0	0	7	0	0
15	34174532	.	T	A	12	16	28	0	2	30	0	0
15	34174568	.	T	A	11	12	23	0	3	26	0	0
15	34174635	.	T	C	10	7	17	0	0	17	0	0
15	34175101	.	T	C	16	15	31	0	2	33	0	0
15	34175359	.	G	A	7	3	10	0	2	12	0	0
15	34175426	.	T	A	9	8	17	0	2	19	0	0
15	34175718	.	G	A	4	7	11	0	0	11	0	0
15	34175917	.	C	T	9	7	16	0	0	16	0	0
15	34175929	.	C	T	8	11	19	0	1	20	0	0
15	34176203	.	A	T	17	7	24	0	0	24	0	0
15	34176214	.	C	T	7	15	22	0	1	23	0	0
15	34176379	.	A	C	8	9	17	0	0	17	0	0
15	34176841	.	A	T	8	6	14	0	0	14	0	0
15	34176993	.	G	A	10	9	19	0	0	19	0	0
15	34182135	.	G	A	2	3	5	0	0	5	0	0
15	34186690	.	A	T	0	1	1	0	0	1	0	0
15	34189452	.	G	A	14	8	22	0	0	22	0	0
15	34239191	.	C	T	0	2	2	0	1	3	0	0
15	34326217	.	G	A	1	2	3	0	0	3	0	0
15	34335272	.	C	T	2	0	2	0	0	2	0	0
15	34534245	.	C	G	2	0	2	0	0	2	0	0
15	34534265	.	C	T	0	1	1	0	0	1	0	0
15	34558428	.	G	A	4	6	10	0	0	10	0	0
15	34558438	.	G	T	3	4	7	0	1	8	0	0
15	34573337	.	C	T	3	3	6	0	1	7	0	0
15	34573343	.	A	G	3	4	7	0	0	7	0	0
15	34573437	.	G	A	1	4	5	0	0	5	0	0
15	34573597	.	A	T	3	3	6	0	0	6	0	0
15	34573664	.	G	T	3	4	7	0	0	7	0	0
15	34573952	.	T	A	3	7	10	0	0	10	0	0
15	34573959	.	A	T	3	10	13	0	0	13	0	0
15	34574116	.	G	A	7	7	14	0	0	14	0	0
15	34577749	.	G	A	1	0	1	0	0	1	0	0
15	34590772	.	A	G	3	2	5	0	0	5	0	0
15	34618456	.	T	G	7	2	9	0	0	9	0	0
15	34618669	.	A	T	16	12	28	0	1	29	0	0
15	34618906	.	C	A	9	8	17	0	1	18	0	0
15	34618948	.	T	G	9	16	25	0	1	26	0	0
15	34618958	.	G	A	6	18	24	0	4	28	0	0
15	34621868	.	G	A	9	11	20	0	0	20	0	0
15	34621875	.	G	A	15	9	24	0	0	24	0	0
15	34627792	.	T	A	3	2	5	0	0	5	0	0
15	34627874	.	T	C	14	4	18	0	0	18	0	0
15	34635321	.	C	A	3	5	8	0	0	8	0	0
15	34635336	.	A	C	4	0	4	0	5	9	0	0
15	34637582	.	C	T	0	5	5	0	0	5	0	0
15	34638847	.	C	T	0	13	13	0	12	25	0	0
15	34641276	.	G	A	5	3	8	0	0	8	0	0
15	34641300	.	G	A	3	3	6	0	0	6	0	0
15	34641384	.	G	A	6	3	9	0	0	9	0	0
15	35091591	.	A	G	2	2	4	0	0	4	0	0
15	35102653	.	G	A	0	2	2	0	0	2	0	0
15	35103129	.	T	C	2	2	4	0	0	4	0	0
15	35115699	.	A	G	0	2	2	0	0	2	0	0
15	35157052	.	T	A	3	5	8	0	1	9	0	0
15	35157054	.	G	A	3	5	8	0	1	9	0	0
15	35158661	.	T	G	3	2	5	0	1	6	0	0
15	35163492	.	T	G	2	2	4	0	0	4	0	0
15	35167298	.	A	G	1	0	1	0	0	1	0	0
15	35187682	.	C	T	0	1	1	0	1	2	0	0
15	35212147	.	C	G	0	2	2	0	1	3	0	0
15	35212177	.	G	A	3	8	11	0	0	11	0	0
15	35212318	.	A	T	6	2	8	0	1	9	0	0
15	35212386	.	T	C	2	5	7	0	1	8	0	0
15	35212418	.	G	C	1	4	5	0	0	5	0	0
15	35214784	.	T	A	6	8	14	0	0	14	0	0
15	35214859	.	A	C	14	0	14	0	7	21	0	0
15	35214901	.	G	A	12	7	19	0	0	19	0	0
15	35217424	.	G	A	1	0	1	0	0	1	0	0
15	35217475	.	T	C	10	6	16	0	1	17	0	0
15	35217487	.	C	A	0	8	8	0	13	21	0	0
15	35221304	.	A	T	5	2	7	0	1	8	0	0
15	35224269	.	G	C	4	6	10	0	0	10	0	0
15	35227221	.	A	T	16	4	20	0	0	20	0	0
15	35247678	.	A	T	16	9	25	0	3	28	0	0
15	35247687	.	A	G	21	13	34	0	0	34	0	0
15	35247729	.	A	G	16	20	36	0	1	37	0	0
15	35247762	.	T	C	16	18	34	0	2	36	0	0
15	35718398	.	A	C	4	2	6	0	0	6	0	0
15	35737680	.	T	C	5	3	8	0	1	9	0	0
15	35737908	.	T	C	1	0	1	0	0	1	0	0
15	35760970	.	G	A	2	2	4	0	0	4	0	0
15	35761024	.	T	C	3	4	7	0	0	7	0	0
15	35761027	.	A	G	3	5	8	0	0	8	0	0
15	35761126	.	G	A	1	4	5	0	5	10	0	0
15	35761225	.	G	A	7	5	12	0	1	13	0	0
15	35761516	.	T	C	1	7	8	0	0	8	0	0
15	35780654	.	G	A	1	2	3	0	0	3	0	0
15	35889183	.	C	A	2	3	5	0	1	6	0	0
15	35889865	.	A	G	4	3	7	0	0	7	0	0
15	35890046	.	G	A	3	6	9	0	0	9	0	0
15	35890148	.	C	T	4	1	5	0	1	6	0	0
15	35891639	.	T	A	3	3	6	0	0	6	0	0
15	35892879	.	T	C	0	1	1	0	1	2	0	0
15	35926711	.	G	C	1	2	3	0	0	3	0	0
15	35944474	.	A	C	2	2	4	0	0	4	0	0
15	35944647	.	A	G	0	0	0	0	3	3	0	0
15	37222589	.	T	C	3	0	3	0	0	3	0	0
15	37227033	.	T	G	24	38	62	0	3	65	0	0
15	37227059	.	A	G	25	0	25	0	39	64	0	0
15	37227509	.	A	G	31	1	32	0	29	62	1	0
15	37227714	.	A	G	25	1	26	0	23	49	0	0
15	37227770	.	G	A	25	20	45	0	2	53	6	0
15	37228164	.	A	G	27	30	57	0	2	59	0	0
15	37228236	.	C	T	12	42	54	0	1	55	0	0
15	37228266	.	T	C	12	39	51	0	3	54	0	0
15	37228301	.	T	A	20	26	46	0	0	46	0	0
15	37228338	.	T	A	25	8	33	0	0	33	0	0
15	37228620	.	G	C	31	19	50	0	0	50	0	0
15	37228626	.	G	A	30	19	49	0	0	49	0	0
15	37228665	.	C	G	27	20	47	0	0	47	0	0
15	37228843	.	T	A	41	17	58	1	1	60	0	0
15	37228845	.	T	G	43	16	59	1	0	60	0	0
15	37229199	.	A	G	12	0	12	9	6	27	0	0
15	37229216	.	T	G	10	3	13	8	0	21	0	0
15	37229871	.	A	T	24	33	57	0	3	60	0	0
15	37229991	.	C	A	23	42	65	0	0	66	1	0
15	37230038	.	G	A	34	26	60	0	0	60	0	0
15	37230100	.	G	A	37	28	65	0	1	66	0	0
15	37459369	.	T	C	2	7	9	0	0	9	0	0
15	37459438	.	T	C	4	0	4	0	3	7	0	0
15	37459819	.	T	C	9	5	14	0	1	15	0	0
15	37460405	.	T	C	4	4	8	0	1	9	0	0
15	37561828	.	A	G	4	2	6	0	0	6	0	0
15	37561838	.	A	G	3	2	5	0	0	5	0	0
15	38859746	.	C	T	3	3	6	0	0	6	0	0
15	38859753	.	A	C	2	3	5	0	0	5	0	0
15	38892060	.	T	C	7	4	11	0	2	13	0	0
15	39128662	.	C	T	5	3	8	0	0	8	0	0
15	39140121	.	C	A	13	12	25	0	1	26	0	0
15	39140568	.	G	A	0	3	3	0	3	6	0	0
15	39141465	.	T	C	1	1	2	0	0	2	0	0
15	39208133	.	C	A	14	14	28	0	1	29	0	0
15	39208150	.	C	T	10	16	26	0	1	27	0	0
15	39208201	.	C	A	9	12	21	0	3	24	0	0
15	39208211	.	C	T	10	14	24	0	1	25	0	0
15	39208258	.	C	T	13	8	21	0	0	21	0	0
15	39228174	.	A	G	20	15	35	0	3	38	0	0
15	39278501	.	G	T	6	4	10	0	3	13	0	0
15	39281923	.	A	G	11	7	18	0	1	19	0	0
15	39282007	.	G	C	15	1	16	0	13	29	0	0
15	39282070	.	A	G	4	2	6	0	0	6	0	0
15	39282091	.	G	A	1	3	4	0	1	5	0	0
15	39294391	.	C	T	13	7	20	0	0	20	0	0
15	39296706	.	A	G	4	8	12	0	1	13	0	0
15	39296730	.	G	A	6	6	12	0	1	13	0	0
15	39297051	.	G	A	8	12	20	0	1	21	0	0
15	39297081	.	A	G	9	3	12	0	1	13	0	0
15	39305598	.	G	A	0	3	3	0	0	3	0	0
15	39326986	.	C	T	2	4	6	0	0	6	0	0
15	39339460	.	T	A	5	5	10	0	0	10	0	0
15	39345641	.	G	A	2	3	5	0	0	5	0	0
15	39354726	.	G	A	3	3	6	0	0	6	0	0
15	39368952	.	A	C	3	2	5	0	0	5	0	0
15	39372699	.	G	A	2	1	3	0	0	3	0	0
15	39967275	.	G	A	11	15	26	0	0	26	0	0
15	39969923	.	T	G	17	20	37	0	0	37	0	0
15	39986125	.	C	A	4	1	5	0	0	5	0	0
15	39987655	.	C	T	2	2	4	0	0	4	0	0
15	39987691	.	T	C	7	8	15	0	1	16	0	0
15	40000966	.	C	A	5	6	11	0	0	11	0	0
15	40000981	.	A	T	6	8	14	0	0	14	0	0
15	40002242	.	C	T	4	4	8	0	0	8	0	0
15	40002319	.	C	T	10	10	20	0	0	20	0	0
15	40002325	.	C	T	11	9	20	0	0	20	0	0
15	40002534	.	A	T	8	7	15	0	0	15	0	0
15	40004780	.	A	G	7	0	7	0	3	10	0	0
15	40004820	.	G	A	4	4	8	0	0	8	0	0
15	40005279	.	C	T	4	4	8	0	0	8	0	0
15	40005297	.	A	C	4	5	9	0	1	10	0	0
15	40005466	.	C	T	9	14	23	0	0	23	0	0
15	40005545	.	T	C	9	10	19	0	2	22	1	0
15	40006090	.	A	C	6	10	16	0	0	16	0	0
15	40008449	.	C	T	13	16	29	0	1	30	0	0
15	40008498	.	C	T	14	20	34	0	3	37	0	0
15	40008544	.	C	A	26	25	51	0	1	52	0	0
15	40018239	.	G	A	3	11	14	0	14	28	0	0
15	40018290	.	C	T	2	4	6	0	0	6	0	0
15	40027138	.	C	T	19	27	46	0	3	49	0	0
15	40027279	.	T	C	44	27	71	0	2	73	0	0
15	40027484	.	T	G	21	1	22	0	37	59	0	0
15	40027540	.	A	C	20	37	57	0	2	59	0	0
15	40027717	.	A	G	25	23	48	0	0	48	0	0
15	40028457	.	T	G	33	34	67	0	3	70	0	0
15	40028568	.	G	A	24	28	52	0	1	53	0	0
15	40028574	.	A	G	23	30	53	0	5	58	0	0
15	40091068	.	C	T	4	8	12	0	1	13	0	0
15	40099812	.	C	T	10	4	14	0	0	14	0	0
15	40099844	.	T	C	7	3	10	0	0	10	0	0
15	40104028	.	T	C	7	5	12	0	1	13	0	0
15	40108886	.	T	C	7	10	17	0	0	17	0	0
15	40108898	.	C	T	6	9	15	0	1	16	0	0
15	40115610	.	A	T	5	5	10	0	0	10	0	0
15	40115676	.	C	T	5	8	13	0	1	14	0	0
15	40122221	.	A	G	4	4	8	0	0	8	0	0
15	40122625	.	G	A	8	7	15	0	0	15	0	0
15	40126698	.	A	G	12	1	13	0	15	28	0	0
15	40128979	.	C	G	14	21	35	0	0	35	0	0
15	40129543	.	G	C	15	13	28	0	1	29	0	0
15	40129594	.	T	G	12	22	34	0	0	34	0	0
15	40129604	.	A	T	12	24	36	0	0	36	0	0
15	40129810	.	A	C	10	11	21	0	0	21	0	0
15	40130181	.	G	A	0	14	14	0	7	21	0	0
15	40130208	.	G	A	6	15	21	0	0	21	0	0
15	40130759	.	A	G	4	6	10	1	0	11	0	0
15	40131001	.	G	A	0	14	14	0	8	22	0	0
15	40131060	.	A	G	11	11	22	0	1	23	0	0
15	40131112	.	C	A	15	16	31	0	0	31	0	0
15	40131139	.	T	A	21	15	36	0	0	36	0	0
15	40131157	.	A	G	16	12	28	0	2	30	0	0
15	40131216	.	G	A	10	4	14	0	0	14	0	0
15	40131232	.	C	T	10	3	13	0	1	14	0	0
15	40131276	.	C	G	10	11	21	0	1	22	0	0
15	40131297	.	C	G	14	9	23	0	0	23	0	0
15	40131316	.	C	A	17	9	26	0	1	27	0	0
15	40131363	.	G	T	1	14	15	0	13	28	0	0
15	40131498	.	A	G	7	2	9	0	29	38	0	0
15	40131500	.	A	G	6	31	37	0	1	38	0	0
15	40131547	.	T	C	7	21	28	0	3	31	0	0
15	40131560	.	T	A	7	23	30	0	0	30	0	0
15	40131586	.	C	T	10	21	31	0	2	33	0	0
15	40131619	.	T	C	15	21	36	0	1	37	0	0
15	40131624	.	T	A	16	19	35	0	0	35	0	0
15	40131769	.	T	C	14	9	23	0	1	24	0	0
15	40202354	.	T	G	24	25	49	0	3	52	0	0
15	40202393	.	C	T	14	4	18	0	0	18	0	0
15	40211507	.	T	C	5	7	12	0	0	12	0	0
15	40211591	.	A	C	34	21	55	0	1	56	0	0
15	40211618	.	A	G	32	0	32	0	24	56	0	0
15	40211741	.	C	G	20	23	43	0	1	44	0	0
15	40211954	.	G	T	8	16	24	0	2	26	0	0
15	40219512	.	T	C	0	4	4	0	0	4	0	0
15	40794052	.	A	T	1	2	3	0	0	3	0	0
15	40794058	.	T	G	1	2	3	0	0	3	0	0
15	40794142	.	C	T	1	2	3	0	0	3	0	0
15	40795639	.	C	T	2	2	4	0	0	4	0	0
15	40796470	.	C	T	2	2	4	0	0	4	0	0
15	40877098	.	G	A	0	0	0	0	1	1	0	0
15	40894385	.	T	A	1	2	3	0	0	3	0	0
15	40905299	.	G	A	1	2	3	0	0	3	0	0
15	40926702	.	C	T	4	2	6	0	0	6	0	0
15	40930419	.	G	A	1	4	5	0	0	5	0	0
15	40935869	.	T	C	2	1	3	0	0	3	0	0
15	40938072	.	C	T	4	5	9	0	0	9	0	0
15	40938119	.	G	A	5	4	9	0	2	11	0	0
15	40938305	.	C	T	5	5	10	0	0	10	0	0
15	40938498	.	T	C	7	3	10	0	0	10	0	0
15	40941322	.	G	A	4	5	9	0	0	9	0	0
15	40945651	.	A	G	2	1	3	0	0	3	0	0
15	40945690	.	T	C	4	4	8	0	0	8	0	0
15	40952226	.	A	G	0	1	1	0	0	1	0	0
15	40962160	.	T	C	3	4	7	0	0	7	0	0
15	40962280	.	G	C	0	4	4	0	1	5	0	0
15	40988189	.	T	C	14	4	18	0	5	23	0	0
15	40988228	.	C	T	15	6	21	0	2	23	0	0
15	40988565	.	A	G	12	9	21	0	0	21	0	0
15	40988659	.	C	A	4	2	6	0	1	7	0	0
15	40989320	.	C	G	3	0	3	0	4	7	0	0
15	40989327	.	A	G	3	5	8	0	0	8	0	0
15	40989690	.	A	G	8	4	12	0	0	12	0	0
15	40989801	.	A	G	7	1	8	0	3	11	0	0
15	41170289	.	A	G	12	17	29	0	1	30	0	0
15	41170445	.	G	T	10	11	21	0	0	21	0	0
15	41170460	.	T	C	11	5	16	0	1	17	0	0
15	41170499	.	T	C	12	8	20	0	0	20	0	0
15	41170710	.	G	A	12	11	23	0	0	23	0	0
15	41170968	.	C	A	2	7	9	1	0	10	0	0
15	41170992	.	G	A	10	5	15	1	0	16	0	0
15	41171081	.	T	C	14	0	14	0	9	23	0	0
15	41171135	.	A	G	8	10	18	0	0	18	0	0
15	41171335	.	A	T	6	8	14	0	4	18	0	0
15	41171448	.	A	C	8	17	25	0	0	25	0	0
15	41171471	.	G	T	10	13	23	0	3	26	0	0
15	41171516	.	C	A	0	10	10	0	19	29	0	0
15	41172103	.	G	A	8	8	16	0	0	16	0	0
15	41172427	.	T	C	5	2	7	0	0	7	0	0
15	41172649	.	T	A	3	4	7	0	0	7	0	0
15	41172745	.	C	T	1	4	5	0	0	5	0	0
15	41172893	.	A	C	8	6	14	0	3	17	0	0
15	41172904	.	G	C	10	8	18	0	0	18	0	0
15	41173093	.	A	T	9	6	15	0	2	17	0	0
15	41173109	.	C	T	9	6	15	0	1	16	0	0
15	41173142	.	G	A	3	3	6	0	1	7	0	0
15	41173261	.	T	G	7	7	14	0	1	15	0	0
15	41173326	.	C	T	10	8	18	0	1	19	0	0
15	41173620	.	G	A	4	2	6	0	0	6	0	0
15	41695120	.	T	C	0	3	3	0	0	3	0	0
15	41695207	.	A	G	6	2	8	0	0	8	0	0
15	41768841	.	T	C	4	2	6	0	0	6	0	0
15	41828235	.	C	T	0	6	6	0	0	6	0	0
15	41844806	.	T	C	3	3	6	0	1	7	0	0
15	41844815	.	C	G	4	3	7	0	0	7	0	0
15	41845121	.	G	A	5	7	12	0	0	12	0	0
15	41845139	.	C	T	6	4	10	0	0	10	0	0
15	41845310	.	G	T	6	4	10	0	0	10	0	0
15	41845526	.	G	A	1	3	4	0	1	5	0	0
15	41947772	.	A	T	1	3	4	0	0	4	0	0
15	41948276	.	A	C	2	2	4	0	0	4	0	0
15	41948826	.	T	C	2	2	4	0	0	4	0	0
15	41949768	.	C	T	0	4	4	0	0	4	0	0
15	41950245	.	G	T	2	3	5	0	0	5	0	0
15	41950369	.	G	A	2	3	5	0	0	5	0	0
15	41950379	.	G	A	1	3	4	0	0	4	0	0
15	41950896	.	G	A	2	0	2	0	0	2	0	0
15	42264955	.	C	T	0	2	2	0	7	9	0	0
15	42265070	.	G	C	11	9	20	0	3	23	0	0
15	42265197	.	G	A	15	33	48	0	2	50	0	0
15	42265263	.	A	G	8	4	12	0	0	12	0	0
15	42267390	.	C	T	0	1	1	0	2	3	0	0
15	42267408	.	T	A	5	5	10	0	1	11	0	0
15	42272452	.	C	A	3	14	17	0	0	17	0	0
15	42278936	.	T	A	4	6	10	0	0	10	0	0
15	42279535	.	A	G	6	12	18	0	1	19	0	0
15	42280689	.	G	A	7	3	10	0	1	11	0	0
15	42283746	.	C	T	3	4	7	0	0	7	0	0
15	42285766	.	A	G	8	0	8	0	10	18	0	0
15	42285767	.	G	T	9	8	17	0	1	18	0	0
15	42302915	.	A	G	10	14	24	0	2	26	0	0
15	42344847	.	C	T	4	3	7	0	1	8	0	0
15	42346196	.	T	C	10	4	14	0	1	15	0	0
15	42346771	.	C	A	2	8	10	0	0	10	0	0
15	42346818	.	A	T	2	10	12	0	1	13	0	0
15	42346841	.	T	C	6	2	8	0	0	8	0	0
15	42346902	.	C	T	1	7	8	0	1	9	0	0
15	42434256	.	A	C	1	3	4	0	0	4	0	0
15	42434265	.	A	T	1	3	4	0	0	4	0	0
15	42436972	.	T	A	1	3	4	0	0	4	0	0
15	42486184	.	T	C	4	2	6	0	0	6	0	0
15	42538243	.	A	G	2	2	4	0	0	4	0	0
15	42538267	.	C	T	2	1	3	0	0	3	0	0
15	42543850	.	G	A	1	2	3	0	4	7	0	0
15	42545582	.	G	A	1	3	4	0	0	4	0	0
15	42550961	.	C	T	6	5	11	0	0	11	0	0
15	42551067	.	G	A	1	9	10	0	6	16	0	0
15	42679685	.	T	C	2	2	4	0	2	6	0	0
15	42767880	.	G	A	0	2	2	0	7	9	0	0
15	42920317	.	A	G	6	3	9	0	0	9	0	0
15	42920332	.	G	T	4	4	8	0	0	8	0	0
15	42920365	.	C	T	1	5	6	0	0	6	0	0
15	42933283	.	C	T	2	3	5	0	0	5	0	0
15	42933343	.	G	A	0	0	0	0	3	3	0	0
15	42947514	.	C	T	2	3	5	0	0	5	0	0
15	42947664	.	C	G	4	3	7	0	0	7	0	0
15	42947799	.	A	G	0	1	1	0	0	1	0	0
15	42952655	.	A	G	2	2	4	0	0	4	0	0
15	42952673	.	C	G	3	2	5	0	0	5	0	0
15	42952872	.	G	T	2	3	5	0	0	5	0	0
15	42958701	.	C	T	2	3	5	0	1	6	0	0
15	42976368	.	C	T	2	2	4	0	0	4	0	0
15	42976371	.	C	A	2	2	4	0	0	4	0	0
15	42980862	.	T	C	6	4	10	0	0	10	0	0
15	42981069	.	C	T	1	7	8	0	0	8	0	0
15	42981223	.	A	G	7	6	13	0	1	14	0	0
15	42981303	.	T	A	4	4	8	0	0	8	0	0
15	42981321	.	G	A	3	3	6	0	0	6	0	0
15	42981345	.	A	G	2	0	2	0	4	6	0	0
15	42981395	.	T	A	1	5	6	0	1	7	0	0
15	43099964	.	G	A	1	2	3	0	0	3	0	0
15	43099974	.	C	A	1	2	3	0	0	3	0	0
15	43187423	.	T	C	16	23	39	0	1	40	0	0
15	43195924	.	G	A	3	6	9	0	0	9	0	0
15	43196102	.	A	T	29	42	71	0	6	77	0	0
15	43196106	.	A	G	27	6	33	0	45	78	0	0
15	43196202	.	C	A	22	44	66	0	3	69	0	0
15	43196306	.	C	T	18	50	68	0	3	71	0	0
15	43196341	.	T	A	24	43	67	0	2	69	0	0
15	43196483	.	C	A	19	51	70	0	0	70	0	0
15	43196491	.	T	C	17	49	66	0	2	68	0	0
15	43196803	.	G	A	1	2	3	0	0	3	0	0
15	43196804	.	A	C	1	2	3	0	0	3	0	0
15	43604903	.	C	G	2	2	4	0	1	5	0	0
15	43604988	.	G	C	3	3	6	0	0	6	0	0
15	43604996	.	A	G	3	2	5	0	0	5	0	0
15	43605309	.	G	T	2	2	4	0	0	4	0	0
15	43605466	.	T	A	5	2	7	0	3	10	0	0
15	43656519	.	G	T	3	5	8	0	0	8	0	0
15	43662857	.	G	A	2	5	7	0	1	8	0	0
15	43969899	.	A	G	1	1	2	0	0	2	0	0
15	43969914	.	T	C	0	0	0	0	2	2	0	0
15	43982517	.	T	C	1	4	5	0	0	5	0	0
15	43982835	.	A	G	1	2	3	0	0	3	0	0
15	43982925	.	T	C	1	2	3	0	0	3	0	0
15	43988716	.	C	T	3	1	4	0	0	4	0	0
15	44029553	.	G	A	1	2	3	0	0	3	0	0
15	44072776	.	T	C	5	0	5	0	2	7	0	0
15	44074653	.	A	G	2	1	3	0	1	4	0	0
15	44075125	.	C	T	0	5	5	0	5	10	0	0
15	44077766	.	A	T	3	10	13	0	1	14	0	0
15	44113320	.	T	C	1	1	2	0	0	2	0	0
15	44140324	.	T	G	6	0	6	0	4	10	0	0
15	44140360	.	G	A	5	5	10	0	1	11	0	0
15	44140546	.	T	C	2	4	6	0	0	6	0	0
15	44140583	.	C	T	4	2	6	0	0	6	0	0
15	44140716	.	C	T	4	2	6	0	0	6	0	0
15	44140780	.	A	G	2	7	9	0	0	9	0	0
15	44141311	.	A	G	4	4	8	0	0	8	0	0
15	44141560	.	C	T	0	2	2	0	0	2	0	0
15	44141644	.	A	C	2	6	8	0	0	8	0	0
15	44209147	.	T	G	3	2	5	0	0	5	0	0
15	44252374	.	T	C	2	1	3	0	0	3	0	0
15	44255001	.	G	A	7	2	9	0	0	9	0	0
15	44255130	.	A	T	7	4	11	0	0	11	0	0
15	44255212	.	A	C	6	5	11	0	0	11	0	0
15	44255438	.	A	G	4	1	5	0	3	8	0	0
15	44255467	.	C	T	3	3	6	0	0	6	0	0
15	44255473	.	T	C	3	2	5	0	1	6	0	0
15	44290546	.	C	T	1	3	4	0	0	4	0	0
15	44295044	.	G	A	1	3	4	0	0	4	0	0
15	44323349	.	T	C	0	0	0	0	1	1	0	0
15	44336923	.	A	T	3	4	7	0	1	8	0	0
15	44344283	.	G	A	0	1	1	0	0	1	0	0
15	44370890	.	C	A	5	7	12	0	0	12	0	0
15	44371076	.	C	T	8	6	14	0	1	15	0	0
15	44371289	.	C	T	3	9	12	0	0	12	0	0
15	44371484	.	T	C	4	6	10	0	0	10	0	0
15	44384767	.	T	C	11	8	19	0	1	20	0	0
15	44385021	.	G	A	4	3	7	0	0	7	0	0
15	44385117	.	T	C	4	2	6	0	1	7	0	0
15	44385126	.	C	T	3	4	7	0	1	8	0	0
15	44399204	.	C	T	4	2	6	0	1	7	0	0
15	44445243	.	C	T	2	4	6	0	0	6	0	0
15	44447906	.	C	T	0	3	3	0	0	3	0	0
15	44462839	.	C	T	1	0	1	0	0	1	0	0
15	44465352	.	G	A	2	1	3	0	0	3	0	0
15	44472844	.	G	A	0	2	2	0	2	4	0	0
15	44475356	.	G	A	3	3	6	0	1	7	0	0
15	44475398	.	C	T	2	2	4	0	0	4	0	0
15	44499445	.	A	G	8	15	23	0	0	23	0	0
15	44499653	.	T	A	17	21	38	0	3	41	0	0
15	44499730	.	C	T	16	21	37	0	0	37	0	0
15	44534976	.	G	A	8	6	14	0	0	14	0	0
15	44733135	.	G	A	9	10	19	0	0	19	0	0
15	44733157	.	A	G	8	9	17	0	0	17	0	0
15	44755727	.	G	A	1	1	2	0	0	2	0	0
15	45027401	.	G	A	3	8	11	0	0	11	0	0
15	45034764	.	C	T	0	3	3	0	2	5	0	0
15	45048200	.	G	A	2	2	4	0	0	4	0	0
15	45056518	.	T	C	4	3	7	0	0	7	0	0
15	45056530	.	G	A	2	4	6	0	0	6	0	0
15	46662011	.	G	T	22	0	22	0	1	23	0	0
15	46691114	.	G	T	1	3	4	0	0	4	0	0
15	46704595	.	T	C	3	3	6	0	0	6	0	0
15	46727382	.	G	A	2	1	3	0	0	3	0	0
15	46727571	.	G	A	1	0	1	0	0	1	0	0
15	46736165	.	A	C	2	0	2	0	4	6	0	0
15	47029331	.	G	A	1	2	3	0	0	3	0	0
15	47063594	.	C	T	1	1	2	0	0	2	0	0
15	47063638	.	C	T	1	1	2	0	0	2	0	0
15	47086656	.	C	T	2	2	4	0	0	4	0	0
15	47086658	.	T	C	2	2	4	0	0	4	0	0
15	47100599	.	C	T	0	4	4	0	1	5	0	0
15	47107256	.	A	G	2	2	4	0	0	4	0	0
15	47111163	.	T	C	4	5	9	0	0	9	0	0
15	47115252	.	G	A	0	1	1	0	1	2	0	0
15	47336295	.	G	A	6	7	13	0	0	13	0	0
15	47386982	.	T	A	7	14	21	0	2	23	0	0
15	47410231	.	C	A	3	2	5	0	0	5	0	0
15	47418607	.	G	A	0	2	2	0	12	14	0	0
15	47418627	.	G	A	11	3	14	0	0	14	0	0
15	47419090	.	G	A	0	18	18	0	17	35	0	0
15	47419096	.	C	T	12	25	37	0	0	37	0	0
15	47419240	.	C	T	11	21	32	0	2	34	0	0
15	47419394	.	C	T	7	18	25	0	2	27	0	0
15	47419395	.	A	T	8	19	27	0	0	27	0	0
15	47420838	.	T	A	32	21	53	0	2	55	0	0
15	47421203	.	T	C	16	10	26	0	0	26	0	0
15	47421329	.	A	G	12	12	24	0	0	24	0	0
15	47421669	.	C	T	13	21	34	0	2	36	0	0
15	47421675	.	G	C	20	11	31	0	2	33	0	0
15	47448596	.	G	C	2	2	4	0	0	4	0	0
15	47453236	.	C	T	1	1	2	0	0	2	0	0
15	47453251	.	A	T	1	3	4	0	0	4	0	0
15	47456937	.	T	C	1	0	1	0	2	3	0	0
15	47830783	.	C	T	4	2	6	0	0	6	0	0
15	47830837	.	G	T	2	1	3	0	0	3	0	0
15	47830973	.	C	A	7	4	11	0	0	11	0	0
15	47831096	.	C	T	7	12	19	0	1	20	0	0
15	47831195	.	G	C	5	5	10	0	0	10	0	0
15	47831249	.	C	T	3	4	7	0	0	7	0	0
15	47831265	.	T	A	3	4	7	0	0	7	0	0
15	47831495	.	C	G	14	4	18	0	0	18	0	0
15	47831511	.	C	T	1	5	6	0	13	19	0	0
15	47831565	.	C	A	14	7	21	0	1	22	0	0
15	47831717	.	T	C	0	11	11	0	0	11	0	0
15	47831731	.	T	G	7	4	11	0	0	11	0	0
15	47832930	.	C	T	4	5	9	0	1	10	0	0
15	47832931	.	C	T	0	5	5	0	5	10	0	0
15	47833083	.	G	A	11	7	18	0	0	18	0	0
15	47833392	.	G	A	10	2	12	0	1	13	0	0
15	47833395	.	C	T	0	3	3	0	10	13	0	0
15	47833493	.	C	T	0	3	3	0	7	10	0	0
15	47833662	.	C	T	7	4	11	0	0	11	0	0
15	47833814	.	C	T	3	7	10	0	0	10	0	0
15	47833875	.	A	G	1	3	4	0	0	4	0	0
15	47834202	.	T	C	9	0	9	0	6	15	0	0
15	47834487	.	C	T	0	3	3	0	5	8	0	0
15	47834559	.	G	A	5	3	8	0	0	8	0	0
15	47839080	.	G	A	2	3	5	0	0	5	0	0
15	47845908	.	A	G	2	0	2	0	0	2	0	0
15	47847180	.	T	C	0	0	0	0	4	4	0	0
15	47847373	.	G	A	3	5	8	0	0	8	0	0
15	47848495	.	C	T	25	21	46	0	1	47	0	0
15	47851205	.	T	A	33	23	56	0	0	56	0	0
15	47851340	.	C	G	36	12	48	1	0	57	8	0
15	47851342	.	C	G	41	12	53	1	3	57	0	0
15	47851455	.	T	G	24	35	59	0	3	62	0	0
15	47851486	.	G	A	31	27	58	0	1	59	0	0
15	47851522	.	C	T	2	24	26	0	34	61	1	0
15	47851751	.	A	G	31	21	52	0	0	52	0	0
15	47851828	.	G	A	20	22	42	0	0	42	0	0
15	47851978	.	C	T	11	6	17	0	2	19	0	0
15	47851979	.	A	G	11	8	19	0	0	19	0	0
15	47852049	.	G	T	14	8	22	0	2	24	0	0
15	47855085	.	A	G	3	23	26	1	2	29	0	0
15	47855169	.	G	A	11	6	17	0	2	19	0	0
15	47856418	.	T	C	10	2	12	0	0	12	0	0
15	47860443	.	C	T	1	16	17	0	20	37	0	0
16	50458	.	C	A	7	4	11	0	2	13	0	0
16	51458	.	C	T	1	2	3	0	0	3	0	0
16	68254	.	A	G	9	8	17	0	2	19	0	0
16	68355	.	T	C	6	4	10	0	1	11	0	0
16	68356	.	C	T	6	4	10	0	1	11	0	0
16	68404	.	A	G	6	12	18	0	0	18	0	0
16	68477	.	G	A	0	7	7	0	6	13	0	0
16	68513	.	G	C	1	9	10	0	9	19	0	0
16	68812	.	A	G	14	15	29	0	0	29	0	0
16	68854	.	T	C	11	12	23	0	3	26	0	0
16	69005	.	T	A	10	7	17	0	1	18	0	0
16	69428	.	A	C	10	13	23	0	1	24	0	0
16	70697	.	T	C	10	6	16	0	0	16	0	0
16	70839	.	A	G	8	0	8	0	4	12	0	0
16	70881	.	A	G	5	4	9	0	2	11	0	0
16	221747	.	G	A	4	8	12	0	0	12	0	0
16	221828	.	C	T	24	23	47	0	1	48	0	0
16	224707	.	A	G	26	17	43	0	0	43	0	0
16	224734	.	C	G	23	19	42	0	2	44	0	0
16	224743	.	C	A	20	21	41	0	3	44	0	0
16	224837	.	A	C	23	26	49	0	1	51	1	0
16	224886	.	G	A	1	24	25	0	32	57	0	0
16	224974	.	A	T	32	14	46	0	2	48	0	0
16	225005	.	T	C	27	29	56	0	4	60	0	0
16	225304	.	C	A	22	30	52	0	2	54	0	0
16	225564	.	T	C	25	25	50	0	4	54	0	0
16	225615	.	A	G	24	26	50	0	4	54	0	0
16	225660	.	C	G	21	29	50	0	1	51	0	0
16	226361	.	C	G	23	19	42	0	1	43	0	0
16	226374	.	T	A	24	22	46	0	0	46	0	0
16	226526	.	A	G	15	13	28	0	2	30	0	0
16	227797	.	T	C	3	0	3	0	4	7	0	0
16	250422	.	T	A	4	7	11	0	0	11	0	0
16	253879	.	G	C	1	0	1	0	2	3	0	0
16	253885	.	C	T	0	2	2	0	1	3	0	0
16	277917	.	T	C	6	0	6	0	14	20	0	0
16	277949	.	G	T	3	9	12	0	2	14	0	0
16	278750	.	C	T	0	8	8	0	12	20	0	0
16	278978	.	A	G	1	4	5	0	0	5	0	0
16	379417	.	A	G	3	3	6	0	0	6	0	0
16	558932	.	A	G	2	1	3	0	2	5	0	0
16	559050	.	T	A	3	6	9	0	0	9	0	0
16	560755	.	G	A	9	3	12	0	0	12	0	0
16	815859	.	C	T	11	5	16	0	1	17	0	0
16	815967	.	G	A	8	5	13	0	2	15	0	0
16	816096	.	A	G	11	10	21	0	0	21	0	0
16	1199324	.	C	T	0	2	2	0	2	4	0	0
16	1199699	.	C	T	1	4	5	0	0	5	0	0
16	1199740	.	A	G	3	3	6	0	1	7	0	0
16	1199741	.	C	T	3	3	6	0	1	7	0	0
16	1204061	.	G	A	0	3	3	0	1	4	0	0
16	1205135	.	G	A	4	2	6	0	0	6	0	0
16	1207124	.	C	T	4	2	6	0	0	6	0	0
16	1207149	.	T	A	5	7	12	0	0	12	0	0
16	1207227	.	G	A	7	11	18	0	2	20	0	0
16	1207948	.	C	G	1	4	5	0	0	5	0	0
16	1209528	.	C	T	5	11	16	0	0	16	0	0
16	1210280	.	G	A	4	7	11	0	0	11	0	0
16	1210403	.	C	T	7	12	19	0	1	20	0	0
16	1210557	.	C	G	1	0	1	0	2	3	0	0
16	1210558	.	C	G	0	0	0	0	3	3	0	0
16	1228093	.	A	C	5	7	12	0	0	12	0	0
16	1234138	.	A	T	1	0	1	0	0	1	0	0
16	1239500	.	T	C	6	6	12	0	0	12	0	0
16	1334452	.	C	T	2	3	5	0	1	6	0	0
16	1354513	.	A	G	3	0	3	0	0	3	0	0
16	1355316	.	A	T	11	5	16	0	0	16	0	0
16	1355720	.	T	C	2	9	11	0	1	12	0	0
16	1359119	.	T	C	0	2	2	0	0	2	0	0
16	1389448	.	C	T	1	1	2	0	0	2	0	0
16	1394717	.	A	G	1	2	3	0	0	3	0	0
16	1395795	.	A	T	2	2	4	0	0	4	0	0
16	1397817	.	T	C	3	4	7	0	0	7	0	0
16	1398295	.	C	G	2	2	4	0	0	4	0	0
16	1398319	.	A	T	1	3	4	0	0	4	0	0
16	1398355	.	A	G	2	0	2	0	2	4	0	0
16	1398492	.	G	T	3	3	6	0	0	6	0	0
16	1398530	.	A	G	6	3	9	0	0	9	0	0
16	1398604	.	A	G	4	0	4	0	3	7	0	0
16	1523892	.	A	G	4	5	9	0	0	9	0	0
16	1523911	.	G	C	5	1	6	0	9	15	0	0
16	1549920	.	A	G	1	2	3	0	0	3	0	0
16	1551146	.	T	G	0	2	2	0	0	2	0	0
16	1569758	.	A	G	1	3	4	0	0	4	0	0
16	1573215	.	C	T	1	3	4	0	0	4	0	0
16	1573259	.	T	G	1	3	4	0	0	4	0	0
16	1577676	.	G	A	0	2	2	0	0	2	0	0
16	1580006	.	G	C	1	0	1	0	4	5	0	0
16	1906682	.	C	A	4	5	9	0	0	9	0	0
16	1996533	.	A	G	3	3	6	0	0	6	0	0
16	1996569	.	A	C	1	2	3	0	0	3	0	0
16	1996577	.	C	T	1	2	3	0	0	3	0	0
16	2009844	.	T	G	4	4	8	0	1	9	0	0
16	2043021	.	C	T	10	11	21	0	1	22	0	0
16	2043122	.	G	C	1	7	8	0	6	14	0	0
16	2071535	.	G	A	0	6	6	0	8	14	0	0
16	2102037	.	T	C	10	3	13	0	3	16	0	0
16	2102495	.	A	G	2	0	2	0	7	9	0	0
16	2102544	.	T	A	5	3	8	0	0	8	0	0
16	2102683	.	C	T	2	2	4	0	1	5	0	0
16	2103052	.	C	T	18	5	23	0	0	23	0	0
16	2103058	.	G	T	18	6	24	0	0	24	0	0
16	2103088	.	G	A	0	6	6	0	18	24	0	0
16	2103167	.	C	T	15	5	20	0	0	20	0	0
16	2103209	.	C	T	7	6	13	0	1	14	0	0
16	2103241	.	T	A	7	7	14	0	0	14	0	0
16	2103268	.	A	T	5	8	13	0	2	15	0	0
16	2103307	.	T	C	11	7	18	0	1	19	0	0
16	2103714	.	A	T	2	5	7	0	0	7	0	0
16	2104114	.	T	A	2	2	4	0	1	5	0	0
16	2104202	.	T	C	6	3	9	0	0	9	0	0
16	2104312	.	A	C	9	14	23	0	1	24	0	0
16	2104400	.	T	C	8	12	20	0	1	21	0	0
16	2104597	.	T	C	24	21	45	0	2	47	0	0
16	2104604	.	A	G	24	0	24	0	24	48	0	0
16	2105035	.	A	G	4	2	6	0	0	6	0	0
16	2353191	.	C	A	2	3	5	0	0	5	0	0
16	2353224	.	A	T	2	3	5	0	0	5	0	0
16	2353226	.	C	A	2	3	5	0	0	5	0	0
16	2373689	.	T	C	0	2	2	0	0	2	0	0
16	2382011	.	G	T	2	0	2	0	0	2	0	0
16	2388216	.	A	G	1	0	1	0	0	1	0	0
16	2388237	.	A	C	2	0	2	0	0	2	0	0
16	2472263	.	G	A	11	3	14	0	1	15	0	0
16	2472284	.	T	C	7	2	9	0	1	10	0	0
16	2484064	.	C	T	0	6	6	0	9	15	0	0
16	2485904	.	G	A	1	2	3	0	0	3	0	0
16	2494323	.	T	C	5	0	5	0	9	14	0	0
16	2495649	.	G	C	3	3	6	0	0	6	0	0
16	2517184	.	G	T	6	3	9	0	3	12	0	0
16	2519056	.	T	C	4	2	6	0	0	6	0	0
16	2519071	.	T	C	0	2	2	0	0	2	0	0
16	2526035	.	C	T	1	1	2	0	0	2	0	0
16	2528209	.	A	G	6	1	7	0	0	7	0	0
16	2539405	.	G	A	1	3	4	0	0	4	0	0
16	2540235	.	G	A	6	2	8	0	1	9	0	0
16	2545290	.	C	T	1	5	6	0	1	7	0	0
16	2558252	.	G	C	2	3	5	0	1	6	0	0
16	2567316	.	A	G	11	0	11	0	7	18	0	0
16	2568847	.	G	A	1	9	10	0	13	23	0	0
16	2574963	.	C	T	0	1	1	0	1	2	0	0
16	2580255	.	T	A	13	11	24	0	2	26	0	0
16	2637703	.	C	A	1	2	3	0	0	3	0	0
16	2638507	.	G	C	2	1	3	0	0	3	0	0
16	2807474	.	C	T	0	2	2	0	0	2	0	0
16	2824645	.	G	C	0	1	1	0	0	1	0	0
16	2843950	.	A	C	5	2	7	0	0	7	0	0
16	2987434	.	T	A	1	1	2	0	0	2	0	0
16	3071320	.	C	T	0	1	1	0	0	1	0	0
16	3091150	.	C	T	0	1	1	0	0	1	0	0
16	3091178	.	C	T	2	2	4	0	0	4	0	0
16	3091195	.	A	G	2	2	4	0	0	4	0	0
16	3091279	.	A	C	1	1	2	0	0	2	0	0
16	3093794	.	C	T	2	2	4	0	0	4	0	0
16	3093806	.	T	A	1	1	2	0	0	2	0	0
16	3095897	.	T	C	0	2	2	0	0	2	0	0
16	3096160	.	C	G	3	2	5	0	0	5	0	0
16	3096166	.	T	C	3	2	5	0	0	5	0	0
16	3096319	.	T	C	5	6	11	0	1	12	0	0
16	3096384	.	C	T	5	7	12	0	0	12	0	0
16	3096420	.	T	C	6	7	13	0	0	13	0	0
16	3096446	.	A	T	6	7	13	0	0	13	0	0
16	3096516	.	G	A	4	5	9	0	0	9	0	0
16	3463895	.	A	G	7	8	15	0	1	16	0	0
16	3470212	.	G	A	5	10	15	0	0	15	0	0
16	3470332	.	A	G	5	8	13	0	0	13	0	0
16	3499306	.	G	A	0	4	4	0	0	4	0	0
16	3499423	.	A	C	5	0	5	0	3	8	0	0
16	3531599	.	A	G	1	1	2	0	0	2	0	0
16	3579786	.	T	G	1	3	4	0	0	4	0	0
16	3678475	.	A	G	1	2	3	0	0	3	0	0
16	3678624	.	G	A	2	2	4	0	0	4	0	0
16	4061794	.	C	T	1	2	3	0	0	3	0	0
16	4067675	.	C	T	1	0	1	0	0	1	0	0
16	4067809	.	G	T	2	1	3	0	0	3	0	0
16	4067897	.	C	A	0	3	3	0	0	3	0	0
16	4071284	.	G	T	1	2	3	0	3	6	0	0
16	4105539	.	C	A	0	3	3	0	0	3	0	0
16	4117682	.	G	C	1	1	2	0	0	2	0	0
16	4126464	.	C	T	1	3	4	0	1	5	0	0
16	4126927	.	C	T	3	0	3	0	0	3	0	0
16	4128322	.	C	T	3	0	3	0	0	3	0	0
16	4129136	.	T	A	2	0	2	0	0	2	0	0
16	4131062	.	T	C	5	6	11	0	2	13	0	0
16	4138416	.	G	A	2	3	5	0	0	5	0	0
16	4138638	.	G	A	1	6	7	0	0	7	0	0
16	4138698	.	G	A	2	3	5	0	0	5	0	0
16	4160144	.	A	G	2	0	2	0	0	2	0	0
16	4163585	.	G	T	6	2	8	0	0	8	0	0
16	4163671	.	A	G	3	0	3	0	8	11	0	0
16	4163705	.	C	T	3	5	8	0	0	8	0	0
16	4186458	.	G	A	0	2	2	0	0	2	0	0
16	4190292	.	G	T	1	2	3	0	0	3	0	0
16	4200749	.	G	T	2	2	4	0	0	4	0	0
16	4201948	.	C	G	8	8	16	0	1	17	0	0
16	4202081	.	T	C	5	6	11	0	0	11	0	0
16	4202128	.	A	G	3	1	4	0	0	4	0	0
16	4287704	.	C	A	5	2	7	0	0	7	0	0
16	4287961	.	G	A	2	5	7	0	0	7	0	0
16	4288656	.	T	A	2	7	9	0	0	9	0	0
16	4288960	.	T	C	3	3	6	0	0	6	0	0
16	4289022	.	A	T	3	2	5	0	0	5	0	0
16	4293419	.	G	T	0	2	2	0	0	2	0	0
16	4309183	.	A	G	3	2	5	0	0	5	0	0
16	4309192	.	T	G	3	4	7	0	0	7	0	0
16	4317365	.	G	A	3	3	6	0	0	6	0	0
16	4317534	.	T	A	1	3	4	0	0	4	0	0
16	4514746	.	T	C	3	0	3	0	4	7	0	0
16	4515085	.	T	C	1	2	3	0	0	3	0	0
16	4858456	.	T	C	4	2	6	0	0	6	0	0
16	4858477	.	G	A	5	3	8	0	0	8	0	0
16	4858779	.	G	T	0	3	3	0	0	3	0	0
16	4860516	.	A	G	1	1	2	0	0	2	0	0
16	4861083	.	T	C	11	6	17	0	1	18	0	0
16	4864771	.	G	A	0	3	3	0	1	4	0	0
16	4867496	.	A	G	6	4	10	0	0	10	0	0
16	4872281	.	G	A	2	2	4	0	0	4	0	0
16	4875198	.	A	G	2	4	6	0	0	6	0	0
16	4875417	.	C	T	3	2	5	0	0	5	0	0
16	4876470	.	C	T	5	2	7	0	1	8	0	0
16	4882206	.	C	T	3	7	10	0	0	10	0	0
16	4882491	.	C	T	9	5	14	0	1	15	0	0
16	4882492	.	G	A	0	5	5	0	9	15	1	0
16	5014564	.	A	G	2	3	5	0	1	6	0	0
16	5025494	.	G	A	2	5	7	0	0	7	0	0
16	5086725	.	G	A	8	3	11	0	0	11	0	0
16	5091076	.	G	A	0	2	2	0	0	2	0	0
16	5105119	.	T	G	4	4	8	0	0	8	0	0
16	5105221	.	G	A	13	16	29	0	0	29	0	0
16	5105291	.	C	A	0	3	3	0	0	3	0	0
16	5115533	.	C	T	1	1	2	0	0	2	0	0
16	5124590	.	C	A	0	1	1	0	0	1	0	0
16	5124593	.	G	A	0	1	1	0	0	1	0	0
16	5167010	.	A	G	10	0	10	0	13	23	0	0
16	5167050	.	A	G	10	0	10	0	9	19	0	0
16	5167249	.	A	C	11	10	21	0	2	23	0	0
16	5187795	.	G	A	8	9	17	0	1	18	0	0
16	5187919	.	T	C	5	1	6	0	1	7	0	0
16	5193353	.	C	T	0	1	1	0	0	1	0	0
16	5193539	.	G	A	7	3	10	0	1	11	0	0
16	5193605	.	T	G	3	8	11	0	1	12	0	0
16	5193682	.	C	T	5	6	11	0	0	11	0	0
16	5193884	.	C	A	0	1	1	0	0	1	0	0
16	5196377	.	C	T	6	2	8	0	1	9	0	0
16	5196630	.	C	T	6	4	10	0	0	10	0	0
16	5196813	.	C	A	3	6	9	0	0	9	0	0
16	5199442	.	C	T	6	5	11	0	0	11	0	0
16	5199476	.	C	T	8	7	15	0	0	15	0	0
16	5205146	.	G	A	0	4	4	0	8	12	0	0
16	5216707	.	G	C	3	4	7	0	0	7	0	0
16	5221622	.	T	A	13	6	19	0	1	20	0	0
16	5223206	.	G	A	5	9	14	0	0	14	0	0
16	5223355	.	G	A	9	8	17	0	0	17	0	0
16	5223375	.	A	G	10	8	18	0	0	18	0	0
16	5223454	.	C	T	6	6	12	0	1	13	0	0
16	5223470	.	G	A	6	6	12	0	1	13	0	0
16	5223880	.	G	C	0	16	16	0	8	24	0	0
16	5224328	.	A	G	15	14	29	0	1	30	0	0
16	5224375	.	G	C	2	14	16	0	18	34	0	0
16	5224429	.	A	T	3	6	9	0	0	9	0	0
16	5492301	.	T	C	1	3	4	0	0	4	0	0
16	5496955	.	T	G	3	2	5	0	0	5	0	0
16	5580914	.	T	C	5	1	6	0	0	6	0	0
16	5604765	.	A	T	4	3	7	0	0	7	0	0
16	5633881	.	C	T	3	4	7	0	0	7	0	0
16	5636328	.	T	G	0	0	0	0	4	4	0	0
16	5687499	.	T	C	1	4	5	0	0	5	0	0
16	5693445	.	G	A	1	2	3	0	0	3	0	0
16	5697039	.	C	T	2	7	9	0	0	9	0	0
16	5697114	.	C	T	1	3	4	0	0	4	0	0
16	5700055	.	G	A	1	3	4	0	2	6	0	0
16	5700058	.	T	C	3	3	6	0	0	6	0	0
16	5700402	.	A	G	8	10	18	0	2	20	0	0
16	5700574	.	G	T	3	7	10	0	7	17	0	0
16	5700578	.	T	C	10	7	17	0	0	17	0	0
16	5700646	.	T	C	4	5	9	0	0	9	0	0
16	5702948	.	C	T	2	0	2	0	0	2	0	0
16	5708077	.	C	A	13	7	20	0	0	20	0	0
16	5708175	.	C	T	4	4	8	0	0	8	0	0
16	5708181	.	G	A	3	2	5	0	0	5	0	0
16	5710483	.	G	A	0	2	2	0	3	5	0	0
16	5710582	.	G	T	3	3	6	0	0	6	0	0
16	5776245	.	T	C	18	15	33	0	1	34	0	0
16	5776356	.	C	T	19	19	38	0	1	39	0	0
16	5776371	.	T	G	15	10	25	0	4	29	0	0
16	5786945	.	G	A	3	4	7	0	0	7	0	0
16	5786977	.	G	A	2	6	8	0	0	8	0	0
16	5787185	.	A	T	7	5	12	0	1	13	0	0
16	5787435	.	T	C	4	9	13	0	0	13	0	0
16	5787436	.	C	A	4	9	13	0	0	13	0	0
16	5787485	.	T	A	8	8	16	0	0	16	0	0
16	5787519	.	G	A	6	4	10	0	0	10	0	0
16	5787670	.	A	G	10	12	22	0	0	22	0	0
16	5787911	.	T	G	3	7	10	0	0	10	0	0
16	5787931	.	A	G	3	9	12	0	0	12	0	0
16	5787981	.	T	C	3	5	8	0	0	8	0	0
16	5788079	.	A	G	4	4	8	0	0	8	0	0
16	5788451	.	G	A	10	4	14	0	0	14	0	0
16	5788534	.	G	C	3	2	5	0	0	5	0	0
16	5788655	.	T	C	4	6	10	0	0	10	0	0
16	5788705	.	T	C	5	2	7	0	1	8	0	0
16	5789124	.	C	A	1	8	9	0	12	21	0	0
16	5789340	.	G	C	9	1	10	0	10	20	0	0
16	5800670	.	C	T	0	7	7	0	8	15	0	0
16	5806440	.	G	A	4	3	7	0	0	7	0	0
16	5806578	.	G	T	5	6	11	0	0	11	0	0
16	5808790	.	G	A	0	2	2	0	1	3	0	0
16	5808802	.	A	G	1	3	4	0	0	4	0	0
16	5808868	.	G	T	3	8	11	0	1	12	0	0
16	5808910	.	T	C	3	6	9	0	0	9	0	0
16	5812624	.	G	T	3	2	5	0	0	5	0	0
16	5817655	.	T	C	1	0	1	0	1	2	0	0
16	5819132	.	A	G	1	3	4	0	0	4	0	0
16	5819209	.	T	A	2	2	4	0	0	4	0	0
16	5820045	.	C	T	0	1	1	0	0	1	0	0
16	5873756	.	G	A	2	2	4	0	0	4	0	0
16	6182755	.	C	T	17	25	42	0	0	42	0	0
16	6183022	.	A	C	28	18	46	0	0	46	0	0
16	6183658	.	T	G	26	27	53	0	2	55	0	0
16	6191514	.	A	G	37	26	63	0	2	65	0	0
16	6191526	.	G	C	36	28	64	0	1	65	0	0
16	6197212	.	T	C	20	16	36	0	0	36	0	0
16	6205657	.	G	T	8	6	14	0	0	15	1	0
16	6356766	.	A	G	2	2	4	0	1	5	0	0
16	6356823	.	T	A	2	6	8	0	0	8	0	0
16	6356850	.	T	C	2	4	6	0	0	6	0	0
16	6648795	.	T	C	1	2	3	0	0	3	0	0
16	6649968	.	T	G	4	0	4	0	2	6	0	0
16	6650097	.	C	T	1	2	3	0	0	3	0	0
16	6650889	.	G	T	0	2	2	0	6	8	0	0
16	6650931	.	C	T	3	6	9	0	1	10	0	0
16	6651049	.	T	C	1	5	6	0	0	6	0	0
16	6653139	.	G	T	2	1	3	0	0	3	0	0
16	6735215	.	A	G	1	0	1	0	3	4	0	0
16	6735218	.	G	A	0	3	3	0	1	4	0	0
16	6745856	.	C	G	2	3	5	0	0	5	0	0
16	6746038	.	C	A	2	5	7	0	0	7	0	0
16	6747256	.	G	T	3	2	5	0	0	5	0	0
16	6758712	.	C	A	1	2	3	0	0	3	0	0
16	6764962	.	T	C	1	1	2	0	0	2	0	0
16	6765015	.	T	C	2	2	4	0	0	4	0	0
16	6769286	.	A	G	1	4	5	0	0	5	0	0
16	6776120	.	G	A	1	2	3	0	0	3	0	0
16	6778482	.	A	G	1	5	6	0	0	6	0	0
16	6778545	.	C	T	1	4	5	0	0	5	0	0
16	6782653	.	T	C	4	6	10	0	0	10	0	0
16	6782680	.	T	C	3	7	10	0	0	10	0	0
16	6782948	.	T	C	1	1	2	0	0	2	0	0
16	6784609	.	C	G	0	3	3	0	0	3	0	0
16	6784866	.	C	T	6	5	11	0	1	12	0	0
16	6787801	.	A	G	6	0	6	0	6	12	0	0
16	6790964	.	C	T	2	1	3	0	0	3	0	0
16	6790978	.	C	T	2	2	4	0	0	4	0	0
16	6792044	.	C	T	4	3	7	0	2	9	0	0
16	6792059	.	C	G	4	2	6	0	1	7	0	0
16	6793333	.	C	G	1	2	3	0	0	3	0	0
16	6796118	.	C	T	6	2	8	0	0	8	0	0
16	6796195	.	A	G	2	4	6	0	2	8	0	0
16	6800033	.	G	A	5	3	8	0	0	8	0	0
16	6800043	.	G	A	0	3	3	0	4	7	0	0
16	6800140	.	C	T	8	6	14	0	0	14	0	0
16	6800209	.	G	A	5	4	9	0	1	10	0	0
16	6800211	.	A	G	6	1	7	0	3	10	0	0
16	6800383	.	G	A	6	3	9	0	1	10	0	0
16	6803650	.	A	T	14	17	31	0	2	33	0	0
16	6803736	.	G	C	21	16	37	0	2	39	0	0
16	6809872	.	A	G	6	10	16	0	1	17	0	0
16	6820725	.	G	A	5	16	21	0	0	21	0	0
16	6820746	.	G	C	10	12	22	0	2	24	0	0
16	6821214	.	G	A	9	7	16	0	1	17	0	0
16	6821248	.	C	T	0	7	7	0	10	17	0	0
16	6821423	.	A	G	9	10	19	0	0	19	0	0
16	6822014	.	G	A	9	11	20	0	1	21	0	0
16	6849625	.	A	G	3	1	4	0	0	4	0	0
16	6864798	.	A	G	1	7	8	0	0	8	0	0
16	6864838	.	G	A	0	3	3	0	2	5	0	0
16	6920023	.	T	C	3	3	6	0	0	6	0	0
16	6920026	.	G	A	0	3	3	0	4	7	0	0
16	6920250	.	G	A	0	1	1	0	0	1	0	0
16	6923824	.	A	G	3	0	3	0	2	5	0	0
16	6932384	.	A	T	2	4	6	0	0	6	0	0
16	6932420	.	G	A	5	3	8	0	1	9	0	0
16	6932423	.	C	T	5	3	8	0	1	9	0	0
16	6932477	.	G	A	3	6	9	0	0	9	0	0
16	6932820	.	T	A	1	3	4	0	1	5	0	0
16	6933004	.	T	C	4	3	7	0	0	7	0	0
16	6933030	.	A	C	7	3	10	0	1	11	0	0
16	6937543	.	T	C	1	0	1	0	2	3	0	0
16	6947998	.	T	C	6	13	19	0	0	19	0	0
16	6955048	.	G	A	10	24	34	0	0	34	0	0
16	6955368	.	A	G	10	5	15	2	3	20	0	0
16	7023972	.	G	C	0	1	1	0	1	2	0	0
16	7054250	.	T	C	0	2	2	0	0	2	0	0
16	7202907	.	G	A	2	2	4	0	1	5	0	0
16	7202910	.	A	G	3	2	5	0	0	5	0	0
16	7203210	.	G	C	1	0	1	0	2	3	0	0
16	7208565	.	C	T	0	3	3	0	2	5	0	0
16	7217013	.	A	G	8	6	14	0	0	14	0	0
16	7217052	.	G	T	8	12	20	0	0	20	0	0
16	7220142	.	A	G	3	1	4	0	0	4	0	0
16	7220225	.	C	T	0	3	3	0	7	10	0	0
16	7221846	.	C	T	0	3	3	0	3	6	0	0
16	7226998	.	G	A	1	1	2	0	0	2	0	0
16	7239320	.	T	A	15	5	20	0	1	21	0	0
16	7239374	.	A	C	3	9	12	0	0	12	0	0
16	7242677	.	C	T	4	4	8	0	0	8	0	0
16	7242729	.	A	T	5	8	13	0	1	14	0	0
16	7242735	.	T	A	5	8	13	0	0	13	0	0
16	7242790	.	A	G	2	4	6	0	1	7	0	0
16	7242821	.	A	T	7	7	14	0	0	14	0	0
16	7242878	.	A	G	14	8	22	0	2	24	0	0
16	7242961	.	A	G	7	4	11	0	0	11	0	0
16	7252871	.	T	C	9	19	28	0	2	30	0	0
16	7254778	.	G	A	0	17	17	0	7	24	0	0
16	7259719	.	T	C	6	7	13	0	0	13	0	0
16	7259869	.	T	A	4	7	11	0	0	11	0	0
16	7259900	.	A	G	6	9	15	0	2	17	0	0
16	7259956	.	A	T	5	19	24	0	0	24	0	0
16	7259957	.	G	A	5	19	24	0	0	24	0	0
16	7260156	.	T	C	7	7	14	0	0	14	0	0
16	7260262	.	G	A	6	7	13	0	0	13	0	0
16	7260280	.	T	A	5	6	11	0	1	12	0	0
16	7315413	.	T	C	3	1	4	0	2	6	0	0
16	7315654	.	A	T	1	2	3	0	0	3	0	0
16	7316083	.	G	A	2	4	6	0	0	6	0	0
16	7316409	.	G	A	1	6	7	0	0	7	0	0
16	7316584	.	T	G	1	3	4	0	0	4	0	0
16	7316585	.	C	T	0	3	3	0	1	4	0	0
16	7656775	.	T	A	3	2	5	0	0	5	0	0
16	7723232	.	A	T	1	1	2	0	0	2	0	0
16	7728327	.	A	G	0	1	1	0	0	1	0	0
16	7728408	.	C	T	1	0	1	0	0	1	0	0
16	7730647	.	C	A	2	3	5	0	0	5	0	0
16	7743398	.	C	T	0	5	5	0	4	9	0	0
16	7745053	.	C	G	5	4	9	0	0	9	0	0
16	7745398	.	A	G	1	3	4	0	0	4	0	0
16	7745513	.	A	C	3	2	5	0	0	5	0	0
16	7745741	.	G	A	6	5	11	0	0	11	0	0
16	7746524	.	A	G	5	3	8	0	0	8	0	0
16	7746846	.	A	T	0	2	2	0	0	2	0	0
16	7748211	.	G	A	1	5	6	0	0	6	0	0
16	7748526	.	A	G	1	2	3	0	0	3	0	0
16	7803192	.	C	A	4	3	7	0	0	7	0	0
16	7803200	.	C	G	4	2	6	0	0	6	0	0
16	7803455	.	C	A	3	5	8	0	0	8	0	0
16	7803492	.	C	G	0	4	4	0	1	5	0	0
16	7803549	.	C	T	0	7	7	0	6	13	0	0
16	7803560	.	A	G	7	7	14	0	0	14	0	0
16	7803765	.	C	G	12	8	20	0	0	20	0	0
16	7803782	.	C	A	0	7	7	0	8	15	0	0
16	7803905	.	G	C	7	0	7	0	7	14	0	0
16	7803923	.	T	A	5	5	10	0	1	11	0	0
16	7803971	.	T	A	2	3	5	0	0	5	0	0
16	7804114	.	T	C	3	0	3	0	3	6	0	0
16	7804321	.	G	A	3	8	11	0	0	11	0	0
16	7804569	.	C	A	5	3	8	0	0	8	0	0
16	7804990	.	A	C	1	5	6	0	0	6	0	0
16	7805410	.	T	G	4	4	8	0	0	8	0	0
16	7805611	.	G	A	2	3	5	0	1	6	0	0
16	7821241	.	C	T	6	5	11	0	0	11	0	0
16	7821244	.	G	A	6	5	11	0	0	11	0	0
16	7824113	.	G	A	0	3	3	0	1	4	0	0
16	7824124	.	T	G	0	3	3	0	0	3	0	0
16	7828792	.	G	T	1	0	1	0	1	2	0	0
16	7968216	.	C	T	1	2	3	0	0	3	0	0
16	7976359	.	T	A	2	2	4	0	0	4	0	0
16	7994890	.	C	T	1	0	1	0	0	1	0	0
16	8027172	.	G	A	0	2	2	0	4	6	0	0
16	8040833	.	C	G	6	7	13	0	0	13	0	0
16	8040843	.	T	G	6	1	7	0	8	15	0	0
16	8040927	.	A	T	10	7	17	0	0	17	0	0
16	8041010	.	A	G	5	6	11	0	1	12	0	0
16	8041173	.	G	A	1	6	7	0	0	7	0	0
16	8041179	.	A	G	1	6	7	0	0	7	0	0
16	8051558	.	T	G	6	15	21	0	5	27	1	0
16	8051941	.	T	C	12	0	12	0	11	23	0	0
16	8052329	.	T	C	12	10	22	0	1	23	0	0
16	8052469	.	G	A	6	17	23	0	0	23	0	0
16	8052652	.	A	G	14	13	27	0	1	28	0	0
16	8052673	.	G	C	13	1	14	0	19	33	0	0
16	8052747	.	A	G	8	15	23	0	1	24	0	0
16	8052831	.	T	A	9	12	21	0	0	21	0	0
16	8052909	.	T	A	1	8	9	1	0	10	0	0
16	8052982	.	T	C	6	5	11	0	0	11	0	0
16	8053202	.	C	T	3	7	10	0	1	11	0	0
16	8053206	.	T	G	4	6	10	0	1	11	0	0
16	8053716	.	A	G	15	12	27	0	1	28	0	0
16	8053717	.	T	C	16	12	28	0	0	28	0	0
16	8053893	.	A	G	10	8	18	0	0	18	0	0
16	8054389	.	C	T	0	2	2	0	4	6	0	0
16	8054434	.	T	C	7	0	7	0	7	14	0	0
16	8066237	.	A	C	15	7	22	0	1	23	0	0
16	8066318	.	A	G	10	8	18	0	0	18	0	0
16	8119672	.	G	A	9	3	12	0	2	14	0	0
16	8119922	.	G	A	6	12	18	0	1	19	0	0
16	8120090	.	G	A	7	14	21	0	2	23	0	0
16	8120237	.	T	G	4	1	5	0	14	19	0	0
16	8132704	.	C	T	0	2	2	0	4	6	0	0
16	8132706	.	T	C	3	0	3	0	3	6	0	0
16	8158715	.	G	A	0	1	1	0	0	1	0	0
16	8160322	.	C	T	2	2	4	0	0	4	0	0
16	8160589	.	T	C	2	3	5	0	1	6	0	0
16	8161735	.	G	A	4	3	7	0	0	7	0	0
16	8161759	.	C	T	4	4	8	0	0	8	0	0
16	8161774	.	G	A	0	3	3	0	3	6	0	0
16	8162076	.	C	T	2	2	4	0	0	4	0	0
16	8162081	.	C	T	2	2	4	0	0	4	0	0
16	8298607	.	C	T	3	3	6	0	0	6	0	0
16	8298642	.	T	C	3	3	6	0	0	6	0	0
16	8298915	.	T	C	6	3	9	0	0	9	0	0
16	8299009	.	A	T	3	3	6	0	1	7	0	0
16	8299932	.	G	A	5	2	7	0	0	7	0	0
16	8300218	.	T	A	3	3	6	0	0	6	0	0
16	8300289	.	A	T	3	3	6	0	0	6	0	0
16	8301175	.	A	C	3	2	5	0	0	5	0	0
16	8310813	.	A	G	1	0	1	0	0	1	0	0
16	8323452	.	C	T	1	4	5	0	0	5	0	0
16	8335057	.	T	A	2	0	2	0	0	2	0	0
16	8342695	.	C	T	0	1	1	0	2	3	0	0
16	8531076	.	A	T	2	3	5	0	0	5	0	0
16	8531249	.	C	T	0	2	2	0	1	3	0	0
16	8531293	.	A	G	2	3	5	0	0	5	0	0
16	8531643	.	G	A	2	5	7	0	0	7	0	0
16	8531682	.	C	T	2	2	4	0	0	4	0	0
16	8531744	.	T	C	3	2	5	0	0	5	0	0
16	8532284	.	G	A	2	3	5	0	0	5	0	0
16	8536034	.	T	A	5	2	7	0	0	7	0	0
16	8536133	.	T	C	2	0	2	0	2	4	0	0
16	8539523	.	C	T	3	4	7	0	1	8	0	0
16	8539810	.	G	A	1	2	3	0	0	3	0	0
16	8539930	.	T	C	3	0	3	0	3	6	0	0
16	8540664	.	G	T	2	2	4	0	0	4	0	0
16	8564763	.	C	A	0	2	2	0	2	4	0	0
16	8564967	.	C	T	0	3	3	0	1	4	0	0
16	8771091	.	A	G	6	9	15	0	0	15	0	0
16	8772812	.	A	T	9	11	20	0	0	20	0	0
16	8772821	.	A	G	8	7	15	0	2	17	0	0
16	8788446	.	A	G	10	9	19	0	1	20	0	0
16	8819113	.	T	C	1	0	1	0	0	1	0	0
16	8828212	.	G	T	3	0	3	0	0	3	0	0
16	8834732	.	A	G	2	2	4	0	0	4	0	0
16	8837830	.	G	A	5	6	11	0	1	12	0	0
16	8837836	.	C	T	0	7	7	0	5	12	0	0
16	8845726	.	C	T	9	11	20	0	0	20	0	0
16	8845738	.	T	G	11	6	17	0	1	18	0	0
16	8847272	.	T	C	2	6	8	0	0	8	0	0
16	8888205	.	G	A	1	4	5	0	0	5	0	0
16	8890908	.	T	A	1	4	5	0	0	5	0	0
16	8890929	.	G	T	4	3	7	0	0	7	0	0
16	8905929	.	C	T	4	7	11	0	1	12	0	0
16	8905971	.	C	T	5	5	10	0	0	10	0	0
16	8905997	.	C	T	4	2	6	0	0	6	0	0
16	8906085	.	G	A	3	4	7	0	0	7	0	0
16	8927360	.	C	T	0	1	1	0	0	1	0	0
16	9275806	.	C	T	2	6	8	0	1	9	0	0
16	9276020	.	C	T	7	5	12	0	1	13	0	0
16	9282707	.	C	T	1	0	1	0	0	1	0	0
16	9286997	.	G	A	6	0	6	0	0	6	0	0
16	9297889	.	C	T	2	0	2	0	0	2	0	0
16	9299775	.	A	T	0	4	4	0	0	4	0	0
16	9300116	.	A	C	0	0	0	0	6	6	0	0
16	9300314	.	G	A	4	6	10	0	0	10	0	0
16	9406059	.	A	C	1	1	2	0	0	2	0	0
16	9408946	.	G	C	0	1	1	0	1	2	0	0
16	9408980	.	A	G	1	0	1	0	3	4	0	0
16	9412048	.	T	C	3	5	8	0	0	8	0	0
16	9412125	.	A	G	4	3	7	0	1	8	0	0
16	9412151	.	T	C	4	5	9	0	0	9	0	0
16	9412177	.	A	G	4	0	4	0	5	9	0	0
16	9412401	.	C	T	3	4	7	0	0	7	0	0
16	9415740	.	G	A	4	3	7	0	0	7	0	0
16	9415793	.	C	T	2	6	8	0	0	8	0	0
16	9420003	.	G	A	0	1	1	0	0	1	0	0
16	9433855	.	A	G	3	3	6	0	0	6	0	0
16	9433856	.	C	A	1	3	4	0	2	6	0	0
16	9444111	.	T	C	0	1	1	0	0	1	0	0
16	9444117	.	C	T	0	1	1	0	0	1	0	0
16	9580775	.	A	G	4	2	6	0	0	6	0	0
16	9584814	.	A	G	1	0	1	0	1	2	0	0
16	9590406	.	A	G	3	2	5	0	0	5	0	0
16	9602508	.	C	T	4	4	8	0	0	8	0	0
16	9602523	.	G	A	4	7	11	0	1	12	0	0
16	9602672	.	A	G	3	1	4	0	0	4	0	0
16	9605728	.	G	C	4	6	10	0	0	10	0	0
16	9605823	.	A	T	5	9	14	0	1	15	0	0
16	9605982	.	C	A	14	8	22	0	0	22	0	0
16	9714080	.	G	A	7	1	8	0	0	8	0	0
16	9714133	.	A	G	2	1	3	0	0	3	0	0
16	9718216	.	G	A	2	4	6	0	0	6	0	0
16	9722035	.	C	T	4	2	6	0	0	6	0	0
16	9723539	.	A	G	0	1	1	0	0	1	0	0
16	9723606	.	A	G	1	1	2	0	1	3	0	0
16	9724725	.	A	C	4	3	7	0	0	7	0	0
16	9724918	.	G	A	4	5	9	0	0	9	0	0
16	9724919	.	T	A	4	5	9	0	0	9	0	0
16	9724959	.	C	T	4	7	11	0	0	11	0	0
16	9725016	.	C	G	4	3	7	0	0	7	0	0
16	9751678	.	T	C	8	4	12	0	0	12	0	0
16	9752318	.	G	A	1	1	2	0	0	2	0	0
16	9758128	.	C	T	4	0	4	0	0	4	0	0
16	9758164	.	C	T	1	5	6	0	1	7	0	0
16	9758414	.	T	G	7	4	11	0	0	11	0	0
16	9758485	.	G	A	2	4	6	0	0	6	0	0
16	9758844	.	A	G	6	6	12	0	0	12	0	0
16	9758956	.	A	G	6	9	15	0	0	15	0	0
16	9758985	.	A	G	6	1	7	0	6	13	0	0
16	9759244	.	A	G	3	12	15	0	0	15	0	0
16	9759336	.	C	T	4	1	5	0	0	5	0	0
16	9759698	.	A	C	8	5	13	0	0	13	0	0
16	9759703	.	C	G	6	0	6	0	7	13	0	0
16	9760083	.	T	C	7	10	17	0	1	18	0	0
16	9760085	.	C	A	8	10	18	0	0	18	0	0
16	9760248	.	T	C	9	8	17	0	0	17	0	0
16	9760775	.	G	C	4	2	6	0	0	6	0	0
16	9760783	.	G	A	4	1	5	0	1	6	0	0
16	9760894	.	A	T	8	8	16	0	1	17	0	0
16	9761141	.	G	A	0	12	12	0	10	22	0	0
16	9761298	.	C	T	5	2	7	0	0	7	0	0
16	9761336	.	T	A	6	9	15	0	0	15	0	0
16	9761525	.	G	A	9	16	25	0	0	25	0	0
16	9771283	.	C	G	10	11	21	0	1	23	1	0
16	9771284	.	T	C	11	12	23	0	0	23	0	0
16	9774187	.	G	A	6	15	21	0	1	22	0	0
16	9777497	.	T	C	13	20	33	0	2	35	0	0
16	9777613	.	A	G	8	14	22	0	1	23	0	0
16	9777629	.	A	T	6	15	21	0	1	22	0	0
16	9777716	.	A	G	9	8	17	0	0	17	0	0
16	9777789	.	C	T	5	4	9	0	1	10	0	0
16	9785990	.	G	A	15	20	35	0	1	36	0	0
16	9787891	.	T	G	23	16	39	0	1	40	0	0
16	9787925	.	A	G	20	27	47	0	3	50	0	0
16	9788005	.	C	T	23	23	46	0	1	47	0	0
16	9788019	.	T	A	20	21	41	0	1	42	0	0
16	9788194	.	A	C	5	4	9	0	1	10	0	0
16	9788447	.	T	C	3	9	12	0	0	12	0	0
16	9788504	.	A	T	5	16	21	0	1	22	0	0
16	9788672	.	G	A	13	7	20	0	1	21	0	0
16	9788929	.	T	G	9	9	18	0	0	18	0	0
16	9789007	.	A	T	7	9	16	0	2	18	0	0
16	9789015	.	C	G	8	9	17	0	0	17	0	0
16	9789048	.	G	T	6	5	11	0	0	11	0	0
16	9789063	.	A	C	6	8	14	0	1	15	0	0
16	9789097	.	C	T	8	11	19	0	2	21	0	0
16	9789225	.	A	C	14	7	21	0	4	25	0	0
16	9789371	.	C	G	12	0	12	0	6	18	0	0
16	9789513	.	C	G	17	19	36	0	1	37	0	0
16	9793972	.	C	T	1	3	4	0	0	4	0	0
16	9797128	.	A	C	1	0	1	0	2	3	0	0
16	9813388	.	G	A	2	3	5	0	0	5	0	0
16	9813415	.	C	T	1	3	4	0	0	4	0	0
16	9833315	.	T	A	5	3	8	0	1	9	0	0
16	9833482	.	A	T	4	8	12	0	1	13	0	0
16	9833559	.	A	T	3	3	6	0	0	6	0	0
16	9833577	.	G	A	3	3	6	0	2	8	0	0
16	9833791	.	T	A	17	18	35	0	6	42	1	0
16	9833794	.	T	A	23	20	43	0	1	44	0	0
16	9833889	.	C	A	22	23	45	0	2	47	0	0
16	9834258	.	G	A	17	16	33	0	1	35	1	0
16	9834271	.	C	T	16	22	38	0	0	38	0	0
16	9834491	.	T	A	10	21	31	0	1	32	0	0
16	9834748	.	G	C	18	15	33	0	2	35	0	0
16	9834873	.	G	C	15	14	29	0	1	30	0	0
16	9847149	.	G	A	15	14	29	0	0	29	0	0
16	9978350	.	A	T	21	18	39	0	0	39	0	0
16	10055679	.	A	G	5	4	9	0	1	10	0	0
16	10055865	.	G	A	2	2	4	0	0	4	0	0
16	10065578	.	G	A	4	6	10	0	0	10	0	0
16	10065899	.	A	G	3	2	5	0	1	6	0	0
16	10066164	.	A	G	4	10	14	0	0	14	0	0
16	10066166	.	T	C	4	10	14	0	0	14	0	0
16	10068095	.	C	G	1	3	4	0	0	4	0	0
16	10068125	.	C	G	1	5	6	0	0	6	0	0
16	10071730	.	G	A	7	3	10	0	0	10	0	0
16	10071812	.	C	T	4	8	12	0	1	13	0	0
16	10271399	.	A	G	2	0	2	0	1	3	0	0
16	10275625	.	C	T	1	3	4	0	0	4	0	0
16	10275694	.	C	T	1	0	1	0	0	1	0	0
16	10279536	.	G	A	3	4	7	0	1	8	0	0
16	10283438	.	C	A	2	1	3	0	0	3	0	0
16	10284593	.	T	A	5	4	9	0	0	9	0	0
16	10287996	.	G	A	5	5	10	0	0	10	0	0
16	10288022	.	C	A	3	5	8	0	0	8	0	0
16	10288230	.	A	G	10	4	14	0	0	14	0	0
16	10288260	.	C	T	5	4	9	0	0	9	0	0
16	10288311	.	G	C	4	1	5	0	0	5	0	0
16	10288765	.	G	A	3	2	5	0	0	5	0	0
16	10288827	.	T	A	4	2	6	0	0	6	0	0
16	10288859	.	A	T	1	3	4	0	0	4	0	0
16	10292782	.	A	G	2	3	5	0	0	5	0	0
16	10300466	.	G	T	2	2	4	0	0	4	0	0
16	10304255	.	A	G	3	1	4	0	0	4	0	0
16	10323903	.	C	T	2	3	5	0	0	5	0	0
16	10325723	.	G	A	0	5	5	0	4	9	0	0
16	10325732	.	T	C	10	5	15	0	0	15	0	0
16	10325960	.	G	A	0	17	17	0	14	31	0	0
16	10326092	.	C	T	13	23	36	0	0	36	0	0
16	10326305	.	G	A	0	17	17	0	21	38	0	0
16	10326347	.	T	G	24	0	24	0	17	41	0	0
16	10326704	.	C	T	25	21	46	0	6	52	0	0
16	10326737	.	A	G	30	22	52	0	1	53	0	0
16	10326990	.	G	A	2	25	27	0	12	39	0	0
16	10326993	.	A	T	23	13	36	0	2	38	0	0
16	10327128	.	C	T	18	14	32	0	1	33	0	0
16	10327530	.	C	A	10	14	24	0	0	24	0	0
16	10333676	.	T	A	2	2	4	0	0	4	0	0
16	10337612	.	G	A	1	1	2	0	1	3	0	0
16	10337630	.	A	T	1	2	3	0	0	3	0	0
16	10338134	.	A	G	2	2	4	0	0	4	0	0
16	10338166	.	A	C	5	2	7	0	1	8	0	0
16	10338171	.	G	A	5	2	7	0	1	8	0	0
16	10338384	.	G	A	0	2	2	0	1	3	0	0
16	10339682	.	G	A	2	3	5	0	0	5	0	0
16	10339709	.	A	C	2	3	5	0	0	5	0	0
16	10339872	.	G	T	3	7	10	0	0	10	0	0
16	10339887	.	C	A	2	6	8	0	0	8	0	0
16	10340008	.	C	G	2	3	5	0	0	5	0	0
16	10340050	.	A	T	6	3	9	0	0	9	0	0
16	10340060	.	A	T	8	2	10	0	0	10	0	0
16	10340349	.	G	A	6	4	10	0	1	11	0	0
16	10340399	.	A	T	5	4	9	0	1	10	0	0
16	10340621	.	T	A	1	3	4	0	0	4	0	0
16	10340630	.	G	C	1	3	4	0	0	4	0	0
16	10340840	.	G	A	3	8	11	0	0	11	0	0
16	10340935	.	G	C	6	4	10	0	0	10	0	0
16	10340941	.	T	C	5	5	10	0	0	10	0	0
16	10341355	.	G	A	1	2	3	0	0	3	0	0
16	10341377	.	A	T	2	4	6	0	0	6	0	0
16	10341452	.	G	A	4	4	8	0	1	9	0	0
16	10341470	.	G	A	6	8	14	0	2	16	0	0
16	10341508	.	A	G	8	6	14	0	1	15	0	0
16	10341548	.	G	A	5	2	7	0	1	8	0	0
16	10341778	.	C	A	6	2	8	0	1	9	0	0
16	10341881	.	A	G	5	5	10	0	0	10	0	0
16	10342169	.	C	T	1	5	6	0	0	6	0	0
16	10342275	.	C	T	1	0	1	0	0	1	0	0
16	10345595	.	A	G	3	5	8	0	0	8	0	0
16	10346378	.	A	T	7	3	10	0	0	10	0	0
16	10346444	.	T	G	3	1	4	0	0	4	0	0
16	10360971	.	C	T	5	5	10	0	1	11	0	0
16	10364706	.	T	C	10	4	14	0	1	15	0	0
16	10366768	.	C	T	1	1	2	0	0	2	0	0
16	10367894	.	A	C	9	10	19	0	2	21	0	0
16	10367961	.	C	T	11	7	18	0	1	19	0	0
16	10368002	.	T	A	6	10	16	0	3	19	0	0
16	10368086	.	A	T	5	10	15	0	2	17	0	0
16	10368098	.	T	C	3	11	14	0	0	14	0	0
16	10368200	.	C	T	9	4	13	0	0	13	0	0
16	10368219	.	T	G	4	9	13	0	0	13	0	0
16	10368352	.	T	G	10	5	15	0	0	15	0	0
16	10368407	.	A	G	3	3	6	0	1	7	0	0
16	10368408	.	C	A	4	2	6	0	0	7	1	0
16	10368452	.	T	A	5	8	13	0	1	14	0	0
16	10368564	.	G	C	5	4	9	0	1	10	0	0
16	10368594	.	C	A	7	3	10	0	0	10	0	0
16	10368713	.	G	T	8	8	16	0	1	17	0	0
16	10368801	.	C	T	9	4	13	0	0	13	0	0
16	10368820	.	C	A	6	7	13	0	1	14	0	0
16	10369068	.	C	T	6	5	11	0	0	11	0	0
16	10369168	.	C	G	6	7	13	0	0	13	0	0
16	10369266	.	G	A	7	15	22	0	0	22	0	0
16	10413815	.	C	A	6	7	13	0	0	13	0	0
16	10425795	.	C	T	1	2	3	0	0	3	0	0
16	10425842	.	C	T	2	6	8	0	0	8	0	0
16	10426088	.	A	G	1	2	3	0	0	3	0	0
16	10426265	.	G	C	3	2	5	0	0	5	0	0
16	10426335	.	T	C	3	4	7	0	0	7	0	0
16	10426343	.	T	A	2	4	6	0	0	6	0	0
16	10426522	.	C	A	5	4	9	0	1	10	0	0
16	10426525	.	G	A	0	3	3	0	7	10	0	0
16	10426612	.	T	A	1	4	5	0	0	5	0	0
16	10427576	.	G	A	1	4	5	0	2	7	0	0
16	10427590	.	G	C	2	7	9	0	0	9	0	0
16	10427746	.	T	G	1	4	5	0	0	5	0	0
16	10427786	.	T	G	1	4	5	0	0	5	0	0
16	10427827	.	T	C	5	4	9	0	1	10	0	0
16	10427964	.	A	C	2	10	12	0	0	12	0	0
16	10431994	.	G	A	3	6	9	0	1	10	0	0
16	10432015	.	C	A	5	5	10	0	0	10	0	0
16	10432168	.	T	G	4	0	4	0	1	5	0	0
16	10438833	.	G	A	2	3	5	0	0	5	0	0
16	10439910	.	G	A	0	1	1	0	2	3	0	0
16	10440612	.	G	A	0	3	3	0	3	6	0	0
16	10444018	.	G	A	1	0	1	0	0	1	0	0
16	10444033	.	C	A	1	2	3	0	0	3	0	0
16	10447983	.	C	T	1	2	3	0	0	3	0	0
16	10454950	.	G	A	0	5	5	0	0	5	0	0
16	10459006	.	C	A	3	0	3	0	0	3	0	0
16	10461712	.	A	T	0	3	3	0	0	3	0	0
16	10464534	.	A	C	1	0	1	0	0	1	0	0
16	10464570	.	T	C	6	3	9	0	1	10	0	0
16	10464609	.	A	G	6	8	14	0	1	15	0	0
16	10468283	.	T	C	6	3	9	0	0	9	0	0
16	10475006	.	C	T	16	10	26	0	0	26	0	0
16	10475646	.	A	G	4	6	10	0	0	10	0	0
16	10477836	.	C	T	0	13	13	0	8	21	0	0
16	10478061	.	G	T	12	13	25	0	0	25	0	0
16	10481488	.	C	T	0	2	2	0	5	7	0	0
16	10489410	.	G	A	1	5	6	0	1	7	0	0
16	10502069	.	A	G	3	1	4	0	0	4	0	0
16	10504444	.	C	A	6	3	9	0	0	9	0	0
16	10506411	.	C	T	5	3	8	0	0	8	0	0
16	10617196	.	C	T	2	4	6	0	0	6	0	0
16	10620183	.	T	C	4	4	8	0	0	8	0	0
16	10620213	.	C	T	1	4	5	0	0	5	0	0
16	10633215	.	A	G	4	8	12	0	0	12	0	0
16	10633287	.	C	A	7	7	14	0	0	14	0	0
16	10633656	.	C	T	7	7	14	0	1	15	0	0
16	10633690	.	C	A	7	10	17	0	1	18	0	0
16	10634013	.	A	G	4	1	5	0	6	11	0	0
16	10634027	.	A	G	0	0	0	0	8	8	0	0
16	10634271	.	C	T	5	3	8	0	0	8	0	0
16	10634289	.	T	G	6	5	11	0	1	12	0	0
16	10634460	.	T	C	2	4	6	0	0	6	0	0
16	10634510	.	C	T	4	4	8	0	0	8	0	0
16	10634568	.	A	T	2	0	2	0	0	2	0	0
16	10635179	.	T	A	2	6	8	0	1	9	0	0
16	10635338	.	A	T	5	7	12	0	2	14	0	0
16	10635401	.	T	G	8	11	19	0	1	20	0	0
16	10635532	.	T	C	7	5	12	0	0	12	0	0
16	10635551	.	A	C	6	5	11	0	0	11	0	0
16	10635838	.	T	C	8	6	14	0	0	14	0	0
16	10635927	.	A	G	13	6	19	0	2	21	0	0
16	10636009	.	A	G	5	7	12	0	0	12	0	0
16	10636140	.	A	G	10	0	10	0	5	15	0	0
16	10636173	.	A	G	6	4	10	0	1	11	0	0
16	10636418	.	T	C	4	3	7	0	1	8	0	0
16	10636527	.	A	G	9	6	15	0	1	16	0	0
16	10636698	.	T	A	6	8	14	0	0	14	0	0
16	10636947	.	T	G	5	1	6	0	6	12	0	0
16	10637050	.	C	T	4	14	18	0	2	20	0	0
16	10637192	.	G	A	0	2	2	0	7	9	0	0
16	10637329	.	C	A	8	12	20	0	0	20	0	0
16	10637379	.	T	A	11	15	26	0	1	27	0	0
16	10637510	.	T	C	3	10	13	0	0	13	0	0
16	10637544	.	T	C	1	9	10	0	0	10	0	0
16	10637629	.	T	C	0	3	3	0	0	3	0	0
16	10637701	.	T	A	4	5	9	0	0	9	0	0
16	10637943	.	T	A	4	5	9	0	0	9	0	0
16	10724812	.	A	G	1	3	4	0	0	4	0	0
16	10724845	.	G	C	4	3	7	0	0	7	0	0
16	10724941	.	T	C	3	3	6	0	0	6	0	0
16	10724995	.	C	G	1	0	1	0	2	3	0	0
16	10731571	.	A	T	5	4	9	0	0	9	0	0
16	10731648	.	T	C	4	3	7	0	2	9	0	0
16	10731968	.	A	C	2	3	5	0	0	5	0	0
16	10731995	.	G	A	3	2	5	0	0	5	0	0
16	10734032	.	A	C	2	1	3	0	0	3	0	0
16	10777005	.	A	G	2	8	10	0	0	10	0	0
16	10795620	.	G	A	16	14	30	0	1	31	0	0
16	10799155	.	T	C	13	12	25	0	2	27	0	0
16	10801121	.	G	A	11	10	21	0	0	21	0	0
16	10801127	.	T	C	13	10	23	0	0	23	0	0
16	10801374	.	T	C	13	22	35	0	0	35	0	0
16	10801422	.	G	A	3	2	5	0	0	5	0	0
16	10801517	.	T	C	3	6	9	0	0	9	0	0
16	10806318	.	C	T	0	1	1	0	0	1	0	0
16	10807360	.	T	A	26	25	51	0	0	51	0	0
16	10807471	.	A	G	17	25	42	0	3	45	0	0
16	10807486	.	C	T	14	19	33	0	1	35	1	0
16	10813372	.	C	T	22	22	44	0	2	46	0	0
16	10815907	.	A	G	12	0	12	0	21	33	0	0
16	10819971	.	C	T	26	24	50	0	0	50	0	0
16	10819972	.	C	T	21	24	45	0	5	50	0	0
16	10820157	.	G	A	2	34	36	0	28	65	1	0
16	10820215	.	A	T	31	24	55	0	1	56	0	0
16	10820224	.	T	A	32	27	59	0	1	60	0	0
16	10820255	.	G	C	25	30	55	0	1	56	0	0
16	10820274	.	C	T	25	30	55	0	0	55	0	0
16	10820299	.	C	T	24	25	49	0	2	51	0	0
16	10820310	.	T	C	23	22	45	0	0	45	0	0
16	10820803	.	C	T	19	32	51	0	8	59	0	0
16	10820866	.	A	G	13	16	29	0	2	31	0	0
16	10828887	.	T	C	7	1	8	0	0	8	0	0
16	10829458	.	T	C	15	0	15	0	11	26	0	0
16	10829569	.	A	T	16	4	20	0	0	20	0	0
16	10829633	.	A	T	9	6	15	0	0	15	0	0
16	10829635	.	A	C	9	5	14	0	1	15	0	0
16	10830013	.	T	G	15	10	25	0	2	27	0	0
16	10830145	.	T	G	11	8	19	0	0	19	0	0
16	10830147	.	T	A	11	8	19	0	0	19	0	0
16	10830309	.	T	A	9	4	13	0	0	13	0	0
16	10830328	.	T	C	8	7	15	0	0	15	0	0
16	10830625	.	G	C	2	5	7	0	0	7	0	0
16	10832217	.	C	T	0	1	1	0	0	1	0	0
16	10833900	.	C	G	3	3	6	0	0	6	0	0
16	10833987	.	G	A	12	7	19	0	0	19	0	0
16	10841193	.	T	C	1	5	6	0	0	6	0	0
16	10841612	.	T	C	2	3	5	0	0	5	0	0
16	10843402	.	A	G	1	1	2	0	3	5	0	0
16	10846654	.	A	G	5	10	15	0	0	15	0	0
16	10855924	.	A	G	13	7	20	0	1	21	0	0
16	10856130	.	A	G	6	9	15	0	2	17	0	0
16	10856235	.	C	G	9	8	17	0	2	19	0	0
16	10856406	.	A	T	4	6	10	0	0	10	0	0
16	10858554	.	G	A	7	13	20	0	0	20	0	0
16	10858656	.	A	G	11	5	16	0	1	17	0	0
16	10859434	.	C	T	18	21	39	0	2	41	0	0
16	10859435	.	T	C	17	21	38	0	3	41	0	0
16	10859857	.	T	C	27	15	42	0	1	43	0	0
16	10861880	.	G	A	4	0	4	0	0	4	0	0
16	10861899	.	T	C	10	3	13	0	0	13	0	0
16	10861956	.	A	G	24	12	36	0	1	37	0	0
16	10861971	.	T	A	25	13	38	0	0	38	0	0
16	10862331	.	C	G	12	15	27	0	4	31	0	0
16	10862627	.	G	A	0	15	15	0	28	43	0	0
16	10862762	.	C	T	17	16	33	0	2	35	0	0
16	10862773	.	T	C	16	18	34	0	2	36	0	0
16	10919051	.	A	T	1	2	3	0	0	3	0	0
16	10987970	.	A	C	5	2	7	0	1	8	0	0
16	10988778	.	A	G	2	2	4	0	0	4	0	0
16	10990177	.	G	A	0	5	5	0	1	6	0	0
16	10990578	.	A	T	4	3	7	0	0	7	0	0
16	11029931	.	G	C	2	2	4	0	0	4	0	0
16	11030141	.	C	A	1	2	3	0	0	3	0	0
16	11134959	.	G	C	1	2	3	0	1	4	0	0
16	11134962	.	T	C	1	3	4	0	0	4	0	0
16	11137369	.	G	T	0	1	1	0	0	1	0	0
16	11137732	.	G	A	3	4	7	0	0	7	0	0
16	11137738	.	T	C	3	4	7	0	0	7	0	0
16	11137837	.	G	C	3	3	6	0	0	6	0	0
16	11138081	.	C	T	2	5	7	0	0	7	0	0
16	11138861	.	A	G	1	5	6	0	0	6	0	0
16	11138867	.	A	G	1	4	5	0	0	5	0	0
16	11139008	.	G	A	0	0	0	0	1	1	0	0
16	11139040	.	G	A	0	2	2	0	0	2	0	0
16	11139043	.	C	A	0	2	2	0	0	2	0	0
16	11139933	.	A	G	6	3	9	0	0	9	0	0
16	11140001	.	A	G	6	0	6	0	1	7	0	0
16	11140004	.	G	A	6	1	7	0	0	7	0	0
16	11140151	.	T	C	4	8	12	0	0	12	0	0
16	11140184	.	C	A	3	2	5	0	0	5	0	0
16	11140274	.	G	T	6	2	8	0	0	8	0	0
16	11140322	.	A	G	8	0	8	0	3	11	0	0
16	11140364	.	A	G	8	7	15	0	0	15	0	0
16	11140435	.	A	G	2	6	8	0	0	8	0	0
16	11140475	.	T	C	3	6	9	0	1	10	0	0
16	11140494	.	T	C	4	4	8	0	1	9	0	0
16	11140896	.	G	A	2	4	6	0	0	6	0	0
16	11141451	.	C	G	4	3	7	0	0	7	0	0
16	11141466	.	A	T	2	4	6	0	0	6	0	0
16	11141776	.	C	G	5	2	7	0	0	7	0	0
16	11141908	.	G	A	0	5	5	0	6	11	0	0
16	11142018	.	G	A	0	6	6	0	1	7	0	0
16	11142064	.	G	A	1	2	3	0	0	3	0	0
16	11142340	.	A	C	2	2	4	0	1	5	0	0
16	11142341	.	G	C	2	0	2	0	3	5	0	0
16	11151884	.	G	A	3	6	9	0	0	9	0	0
16	11166805	.	C	T	1	3	4	0	0	4	0	0
16	11166908	.	G	A	3	5	8	0	1	9	0	0
16	11167436	.	G	A	3	4	7	0	0	7	0	0
16	11167461	.	G	A	2	4	6	0	1	7	0	0
16	11167586	.	T	G	2	4	6	0	0	6	0	0
16	11167908	.	T	C	5	2	7	0	0	7	0	0
16	11168205	.	A	G	6	6	12	0	0	12	0	0
16	11168922	.	T	A	1	4	5	0	0	5	0	0
16	11169212	.	G	C	2	4	6	0	0	6	0	0
16	11169325	.	C	T	5	2	7	0	0	7	0	0
16	11169381	.	C	T	7	7	14	0	2	16	0	0
16	11169438	.	C	A	9	5	14	0	0	14	0	0
16	11169447	.	A	G	10	6	16	0	0	16	0	0
16	11170152	.	C	G	6	3	9	0	1	10	0	0
16	11170334	.	C	T	6	6	12	0	0	12	0	0
16	11188937	.	G	A	0	2	2	0	4	6	0	0
16	11193643	.	A	G	7	13	20	0	2	22	0	0
16	11193652	.	A	G	9	0	9	0	17	26	0	0
16	11195922	.	G	A	1	2	3	0	1	4	0	0
16	11199190	.	A	G	11	0	11	0	12	23	0	0
16	11199220	.	C	T	14	16	30	0	0	30	0	0
16	11199293	.	T	C	13	16	29	0	2	31	0	0
16	11206313	.	A	C	7	4	11	0	0	11	0	0
16	11206316	.	C	T	7	4	11	0	1	12	0	0
16	11212111	.	C	A	28	16	44	0	3	47	0	0
16	11212332	.	A	T	11	16	27	0	2	29	0	0
16	11212398	.	A	G	13	16	29	0	4	33	0	0
16	11212438	.	A	G	17	0	17	0	17	34	0	0
16	11215495	.	C	T	17	15	32	0	0	32	0	0
16	11215515	.	T	C	22	16	38	0	1	39	0	0
16	11221071	.	A	G	12	23	35	0	2	37	0	0
16	11221398	.	G	A	15	13	28	0	2	30	0	0
16	11221406	.	A	C	16	14	30	0	2	32	0	0
16	11221667	.	A	G	12	16	28	0	0	28	0	0
16	11222030	.	T	A	12	11	23	0	2	25	0	0
16	11222139	.	G	A	15	11	26	0	2	28	0	0
16	11222738	.	G	A	1	15	16	0	17	33	0	0
16	11227434	.	C	T	4	2	6	0	0	6	0	0
16	11227611	.	G	A	5	4	9	0	0	9	0	0
16	11227702	.	G	T	2	2	4	0	0	4	0	0
16	11227711	.	G	A	2	2	4	0	0	4	0	0
16	11227813	.	A	T	3	2	5	0	0	5	0	0
16	11227865	.	C	T	2	4	6	0	0	6	0	0
16	11228292	.	T	G	2	2	4	0	1	5	0	0
16	11228358	.	C	A	0	5	5	0	1	6	0	0
16	11228848	.	G	C	3	2	5	0	0	5	0	0
16	11229180	.	G	T	2	2	4	0	2	6	0	0
16	11229747	.	G	A	0	1	1	0	0	1	0	0
16	11231177	.	C	T	1	1	2	0	1	3	0	0
16	11235489	.	C	T	1	2	3	0	0	3	0	0
16	11241078	.	A	G	1	2	3	0	2	5	0	0
16	11242495	.	T	A	11	19	30	0	1	31	0	0
16	11242542	.	C	G	11	16	27	0	0	27	0	0
16	11266016	.	T	G	7	5	12	0	0	12	0	0
16	11275795	.	C	T	13	7	20	0	0	20	0	0
16	11275980	.	A	G	5	0	5	0	3	8	0	0
16	11290844	.	C	A	13	10	23	0	1	24	0	0
16	11290975	.	A	C	9	8	17	0	1	18	0	0
16	11291799	.	T	C	20	15	35	0	2	37	0	0
16	11291803	.	G	A	17	13	30	0	5	35	0	0
16	11318484	.	G	A	0	7	7	0	5	12	0	0
16	11318700	.	A	G	1	3	4	0	0	4	0	0
16	11344556	.	C	T	5	2	7	0	1	8	0	0
16	11486360	.	G	A	0	4	4	0	3	7	0	0
16	11531018	.	A	G	5	4	9	0	0	9	0	0
16	11531069	.	T	C	6	5	11	0	1	12	0	0
16	11533864	.	T	C	3	3	6	0	0	6	0	0
16	11533897	.	C	T	0	2	2	0	0	2	0	0
16	11541776	.	T	C	1	7	8	0	0	8	0	0
16	11542083	.	C	T	7	9	16	0	0	16	0	0
16	11544525	.	C	T	11	5	16	0	0	16	0	0
16	11544636	.	A	G	7	4	11	0	0	11	0	0
16	11544645	.	A	T	4	4	8	0	1	9	0	0
16	11544672	.	T	C	2	3	5	0	0	5	0	0
16	11554859	.	C	T	11	10	21	0	1	22	0	0
16	11554874	.	A	G	13	0	13	0	11	24	0	0
16	11554907	.	T	C	15	9	24	0	1	25	0	0
16	11554916	.	A	G	14	8	22	0	1	23	0	0
16	11554970	.	A	C	9	12	21	0	2	23	0	0
16	11555034	.	A	C	14	15	29	0	1	30	0	0
16	11555111	.	A	G	10	0	10	0	16	27	1	0
16	11555160	.	C	T	19	8	27	0	4	31	0	0
16	11555542	.	T	A	16	9	25	0	3	28	0	0
16	11774168	.	G	A	9	3	12	0	1	13	0	0
16	11774237	.	T	C	10	0	10	0	17	27	0	0
16	11774291	.	G	A	9	19	28	0	0	28	0	0
16	11774336	.	C	T	1	17	18	0	10	28	0	0
16	11774361	.	T	C	10	11	21	0	0	21	0	0
16	11774584	.	T	C	3	3	6	0	0	6	0	0
16	11774694	.	T	C	1	0	1	0	1	2	0	0
16	11774702	.	A	C	1	0	1	0	1	2	0	0
16	11774790	.	A	T	3	4	7	0	0	7	0	0
16	11774948	.	T	A	11	10	21	0	3	24	0	0
16	11775200	.	A	G	7	6	13	0	0	13	0	0
16	11775279	.	T	C	5	10	15	0	0	15	0	0
16	11775361	.	T	C	12	9	21	0	0	21	0	0
16	11775614	.	G	A	18	17	35	0	1	36	0	0
16	11775683	.	T	C	14	11	25	0	0	25	0	0
16	11778299	.	G	A	4	6	10	0	0	10	0	0
16	11778302	.	T	A	4	5	9	0	0	9	0	0
16	11965673	.	G	T	15	23	38	0	1	39	0	0
16	11965803	.	G	T	24	15	39	0	0	39	0	0
16	11965931	.	T	C	12	1	13	0	29	42	0	0
16	11968056	.	A	G	9	12	21	0	1	22	0	0
16	11970128	.	A	G	3	8	11	0	2	13	0	0
16	11970161	.	G	A	9	10	19	0	4	23	0	0
16	11978028	.	A	G	11	22	33	0	1	34	0	0
16	11978045	.	G	A	10	25	35	0	0	35	0	0
16	11978094	.	A	C	6	13	19	0	0	19	0	0
16	11979494	.	G	A	2	2	4	0	0	4	0	0
16	11982323	.	G	A	1	3	4	0	0	4	0	0
16	11986208	.	G	A	8	8	16	0	1	17	0	0
16	11986257	.	G	A	10	13	23	0	0	23	0	0
16	11986258	.	C	T	1	13	14	0	9	23	0	0
16	11992678	.	T	A	0	2	2	0	0	2	0	0
16	11997201	.	G	A	0	2	2	0	0	2	0	0
16	12054273	.	C	T	0	6	6	0	1	7	0	0
16	12064906	.	A	T	10	3	13	0	0	13	0	0
16	12064980	.	G	T	9	4	13	0	0	13	0	0
16	12065201	.	C	T	13	17	30	0	1	31	0	0
16	12065410	.	A	G	9	9	18	0	1	19	0	0
16	12069729	.	C	T	0	11	11	0	12	23	0	0
16	12076492	.	A	G	4	5	9	0	0	9	0	0
16	12076537	.	C	T	0	1	1	0	0	1	0	0
16	12078042	.	T	C	0	2	2	0	0	2	0	0
16	12078916	.	A	G	3	3	6	0	1	7	0	0
16	12078976	.	C	T	4	4	8	0	0	8	0	0
16	12083632	.	A	G	2	1	3	0	0	3	0	0
16	12095103	.	T	C	2	2	4	0	0	4	0	0
16	12102432	.	T	A	22	20	42	0	0	43	1	0
16	12102492	.	A	T	23	22	45	0	0	45	0	0
16	12102709	.	G	A	34	33	67	0	3	70	0	0
16	12103083	.	T	C	30	5	35	0	26	62	1	0
16	12103263	.	A	T	27	26	53	0	3	56	0	0
16	12103292	.	A	T	29	28	57	0	0	57	0	0
16	12103598	.	G	A	31	18	49	0	1	50	0	0
16	12103732	.	C	T	1	19	20	0	25	45	0	0
16	12103934	.	C	T	22	27	49	0	4	53	0	0
16	12103941	.	A	G	27	26	53	0	3	56	0	0
16	12104209	.	A	C	36	9	45	0	1	46	0	0
16	12104316	.	T	A	31	10	41	0	2	43	0	0
16	12104454	.	T	C	32	11	43	0	3	46	0	0
16	12104455	.	G	A	34	12	46	0	0	46	0	0
16	12104925	.	C	G	32	14	46	0	3	49	0	0
16	12105265	.	T	A	33	11	44	0	2	46	0	0
16	12105689	.	C	T	1	23	24	0	13	37	0	0
16	12105720	.	T	C	15	24	39	0	1	40	0	0
16	12105854	.	A	G	23	28	51	0	1	52	0	0
16	12108607	.	G	A	23	32	55	0	2	57	0	0
16	12114975	.	G	A	12	8	20	0	1	21	0	0
16	12115290	.	G	A	1	10	11	0	0	11	0	0
16	12126861	.	T	C	18	0	18	0	16	34	0	0
16	12127040	.	A	G	6	4	10	0	0	10	0	0
16	12138841	.	G	A	15	12	27	0	0	27	0	0
16	12150403	.	A	G	1	3	4	0	0	4	0	0
16	12150415	.	T	C	4	0	4	0	5	9	0	0
16	12150457	.	A	G	11	11	22	0	2	24	0	0
16	12150460	.	C	T	12	11	23	0	2	25	0	0
16	12173361	.	G	C	3	1	4	0	0	4	0	0
16	12173406	.	A	G	12	7	19	0	2	21	0	0
16	12173511	.	T	A	10	13	23	0	2	25	0	0
16	12175007	.	A	T	1	5	6	0	0	6	0	0
16	12175047	.	T	G	3	5	8	0	0	8	0	0
16	12363982	.	G	A	1	0	1	0	0	1	0	0
16	12367100	.	A	G	1	0	1	0	0	1	0	0
16	12367109	.	T	C	1	0	1	0	0	1	0	0
16	12475737	.	T	C	2	0	2	0	0	2	0	0
16	12484658	.	A	C	1	0	1	0	1	2	0	0
16	12505303	.	G	T	19	29	48	0	0	48	0	0
16	12632593	.	G	C	4	6	10	0	0	10	0	0
16	12632664	.	T	C	1	1	2	0	1	3	0	0
16	12636911	.	A	C	5	4	9	0	0	9	0	0
16	12637433	.	A	C	2	5	7	0	0	7	0	0
16	12637434	.	A	G	1	0	1	0	6	7	0	0
16	12637543	.	C	T	3	6	9	0	0	9	0	0
16	12637624	.	G	A	5	4	9	0	0	9	0	0
16	12638349	.	A	C	4	2	6	0	0	6	0	0
16	12639156	.	T	A	10	8	18	1	1	20	0	0
16	12639161	.	C	G	10	0	10	1	8	19	0	0
16	12639377	.	T	G	4	5	9	0	3	12	0	0
16	12639503	.	T	G	1	2	3	0	0	3	0	0
16	12639617	.	C	G	1	0	1	0	2	3	0	0
16	12730412	.	G	A	19	10	29	0	1	30	0	0
16	12738351	.	T	C	6	0	6	0	0	6	0	0
16	12740926	.	C	T	1	7	8	0	0	8	0	0
16	12740949	.	C	G	4	12	16	0	0	16	0	0
16	12744138	.	A	G	1	2	3	0	1	4	0	0
16	12747312	.	A	G	6	4	10	0	1	11	0	0
16	12748058	.	A	G	0	0	0	0	10	10	0	0
16	12748517	.	A	T	9	6	15	0	2	17	0	0
16	12748568	.	T	C	13	14	27	0	1	28	0	0
16	12748646	.	G	A	0	16	16	0	18	34	0	0
16	12748857	.	G	A	2	1	3	0	0	3	0	0
16	12748908	.	G	C	0	12	12	0	11	23	0	0
16	12748989	.	T	C	8	6	14	0	1	15	0	0
16	12754621	.	A	G	13	0	13	0	20	33	0	0
16	12754690	.	C	T	5	6	11	0	0	11	0	0
16	12754849	.	T	C	15	22	37	0	2	39	0	0
16	12755260	.	G	A	0	17	17	0	17	34	0	0
16	12755992	.	C	T	25	10	35	0	3	38	0	0
16	12756051	.	G	T	9	15	24	0	1	25	0	0
16	12756255	.	C	T	14	6	20	0	0	20	0	0
16	12756376	.	T	A	2	2	4	0	0	4	0	0
16	12794028	.	A	G	2	6	8	0	1	9	0	0
16	12794075	.	C	G	3	6	9	1	0	10	0	0
16	12809604	.	T	C	4	3	7	0	0	7	0	0
16	12809645	.	G	A	1	2	3	0	0	3	0	0
16	12812496	.	T	C	3	3	6	0	0	6	0	0
16	12814300	.	T	A	2	4	6	0	0	6	0	0
16	12816486	.	T	C	4	1	5	0	1	6	0	0
16	12816745	.	A	C	7	6	13	0	0	13	0	0
16	12817298	.	C	T	1	0	1	0	0	1	0	0
16	12818220	.	G	T	6	4	10	0	2	12	0	0
16	12963064	.	T	C	2	4	6	0	0	6	0	0
16	12963109	.	A	G	6	7	13	0	0	13	0	0
16	12963696	.	T	G	24	21	45	0	6	51	0	0
16	12963975	.	A	G	23	24	47	0	1	48	0	0
16	13033243	.	G	A	0	5	5	0	0	5	0	0
16	13180389	.	T	C	3	5	8	0	0	8	0	0
16	13181465	.	T	C	6	4	10	0	1	11	0	0
16	13207435	.	A	G	0	1	1	0	0	1	0	0
16	13453231	.	A	T	2	2	4	0	0	4	0	0
16	13599957	.	G	A	9	6	15	0	1	16	0	0
16	13600680	.	A	C	10	13	23	0	3	26	0	0
16	13601026	.	T	C	9	16	25	0	1	26	0	0
16	13601254	.	G	C	6	3	9	0	0	9	0	0
16	13601328	.	C	T	1	5	6	0	0	6	0	0
16	13602164	.	T	C	7	14	21	0	0	21	0	0
16	13602454	.	T	A	12	10	22	0	1	23	0	0
16	13602488	.	T	C	7	9	16	0	2	18	0	0
16	13602697	.	A	G	5	16	21	0	2	23	0	0
16	13602800	.	T	A	7	7	14	0	2	16	0	0
16	13602922	.	A	G	9	10	19	0	0	19	0	0
16	13603375	.	C	T	3	5	8	0	1	9	0	0
16	13606896	.	A	T	1	7	8	0	1	9	0	0
16	13606977	.	G	A	6	15	21	0	0	21	0	0
16	13610726	.	T	A	20	26	46	0	4	50	0	0
16	13610882	.	G	A	17	14	31	0	3	34	0	0
16	13610966	.	A	G	11	7	18	0	0	18	0	0
16	13611035	.	G	A	12	5	17	0	0	17	0	0
16	13612999	.	T	A	14	3	17	0	0	17	0	0
16	13613104	.	T	C	6	3	9	0	0	9	0	0
16	13617023	.	C	T	0	10	10	0	9	19	0	0
16	13617152	.	C	T	7	16	23	0	0	23	0	0
16	13617291	.	G	A	5	10	15	0	0	15	0	0
16	13617329	.	T	G	7	9	16	0	0	16	0	0
16	13617767	.	G	T	2	2	4	0	1	5	0	0
16	13618170	.	A	G	11	11	22	0	5	27	0	0
16	13618172	.	C	G	10	12	22	0	5	27	0	0
16	13618374	.	A	T	12	15	27	0	0	27	0	0
16	13618644	.	T	A	14	8	22	0	1	23	0	0
16	13619001	.	A	C	10	4	14	0	1	16	1	0
16	13619319	.	T	A	6	2	8	0	0	8	0	0
16	13619436	.	A	G	5	7	12	0	0	12	0	0
16	13619448	.	T	C	5	8	13	0	0	13	0	0
16	13619509	.	G	T	8	10	18	0	0	18	0	0
16	13621056	.	G	A	5	4	9	0	0	9	0	0
16	13621605	.	A	G	7	8	15	0	0	15	0	0
16	13621752	.	G	A	3	6	9	0	0	9	0	0
16	13623641	.	A	C	7	4	11	0	0	11	0	0
16	13636760	.	G	A	22	22	44	0	1	45	0	0
16	13643969	.	C	A	17	17	34	0	0	34	0	0
16	13644509	.	A	T	11	19	30	0	2	32	0	0
16	13644781	.	T	A	7	5	12	0	3	15	0	0
16	13645076	.	A	T	13	9	22	0	0	22	0	0
16	13645242	.	G	C	11	8	19	0	2	21	0	0
16	13645318	.	T	G	15	13	28	0	1	29	0	0
16	13645419	.	T	A	6	8	14	0	1	15	0	0
16	13645610	.	T	C	0	0	0	0	1	1	0	0
16	13673142	.	T	C	8	4	12	0	1	13	0	0
16	13673143	.	T	C	5	7	12	0	1	13	0	0
16	13673660	.	T	A	2	6	8	0	0	8	0	0
16	13680585	.	A	G	5	5	10	0	0	10	0	0
16	13701482	.	C	T	5	8	13	0	0	13	0	0
16	13701599	.	A	G	0	2	2	0	2	4	0	0
16	13706061	.	G	A	3	2	5	0	0	5	0	0
16	13706207	.	G	C	7	7	14	0	2	16	0	0
16	13706714	.	G	T	8	4	12	0	1	13	0	0
16	13721408	.	C	T	10	8	18	0	1	19	0	0
16	13721420	.	G	A	6	9	15	0	1	16	0	0
16	13729810	.	C	T	5	2	7	0	0	7	0	0
16	13741584	.	C	T	5	3	8	0	0	8	0	0
16	13743117	.	T	C	2	0	2	0	4	6	0	0
16	13743198	.	G	T	3	11	14	0	2	16	0	0
16	13743327	.	C	T	0	9	9	0	8	17	0	0
16	13743345	.	T	C	9	8	17	0	0	17	0	0
16	13780375	.	G	A	7	5	12	0	0	12	0	0
16	13780415	.	T	A	1	1	2	0	0	2	0	0
16	13789765	.	G	A	5	4	9	0	1	10	0	0
16	13818640	.	T	A	5	0	5	0	0	5	0	0
16	13818644	.	G	A	5	0	5	0	0	5	0	0
16	13819008	.	T	C	0	1	1	0	0	1	0	0
16	13826195	.	C	T	4	2	6	0	0	6	0	0
16	13841360	.	T	A	2	3	5	0	2	7	0	0
16	13845368	.	G	A	1	14	15	0	9	24	0	0
16	13845846	.	A	G	4	6	10	0	1	11	0	0
16	13855142	.	T	C	12	9	21	0	0	21	0	0
16	13855472	.	T	C	11	16	27	0	0	27	0	0
16	13855482	.	T	A	14	9	23	0	0	23	0	0
16	13870508	.	A	C	5	8	13	0	0	13	0	0
16	13870517	.	A	G	3	11	14	0	0	14	0	0
16	13870685	.	A	C	7	5	12	0	0	12	0	0
16	13870857	.	T	A	5	4	9	0	0	9	0	0
16	13876657	.	T	A	1	2	3	0	0	3	0	0
16	13876917	.	T	C	1	2	3	0	0	3	0	0
16	13881040	.	T	G	1	2	3	0	0	3	0	0
16	13883968	.	C	A	5	3	8	0	0	8	0	0
16	13883980	.	A	C	5	3	8	0	0	8	0	0
16	14010794	.	C	T	0	2	2	0	0	2	0	0
16	14016057	.	T	C	0	1	1	0	0	1	0	0
16	14021817	.	G	T	5	3	8	0	1	9	0	0
16	14021886	.	C	T	5	3	8	0	0	8	0	0
16	14021907	.	T	A	2	1	3	0	0	3	0	0
16	14022035	.	A	C	6	1	7	0	0	7	0	0
16	14022445	.	T	C	8	9	17	0	1	18	0	0
16	14022585	.	C	A	6	5	11	0	0	11	0	0
16	14022697	.	T	A	7	5	12	0	0	12	0	0
16	14022975	.	G	T	1	2	3	0	0	3	0	0
16	14022976	.	T	A	1	1	2	0	1	3	0	0
16	14029359	.	A	C	11	14	25	0	0	25	0	0
16	14039604	.	T	C	0	3	3	0	0	3	0	0
16	14039616	.	A	C	2	3	5	0	0	5	0	0
16	14051150	.	G	C	15	17	32	0	1	33	0	0
16	14051249	.	T	C	18	17	35	0	6	41	0	0
16	14051329	.	A	T	24	17	41	0	0	41	0	0
16	14051339	.	A	C	24	19	43	0	0	43	0	0
16	14052681	.	A	G	22	15	37	0	0	37	0	0
16	14055071	.	A	T	6	7	13	0	0	13	0	0
16	14093909	.	T	A	4	3	7	0	2	9	0	0
16	14094219	.	A	G	4	2	6	0	2	8	0	0
16	14094222	.	C	A	3	2	5	0	1	6	0	0
16	14094364	.	A	C	9	5	14	0	1	15	0	0
16	14094422	.	C	G	15	10	25	0	0	25	0	0
16	14094601	.	G	A	10	15	25	0	2	27	0	0
16	14094604	.	T	A	13	12	25	0	2	27	0	0
16	14094640	.	G	T	13	7	20	0	0	20	0	0
16	14094668	.	T	A	15	7	22	0	1	23	0	0
16	14094801	.	C	T	9	4	13	0	0	13	0	0
16	14094806	.	G	A	8	4	12	0	1	13	0	0
16	14095097	.	C	T	0	8	8	0	11	19	0	0
16	14095126	.	T	A	4	5	9	0	1	10	0	0
16	14095176	.	A	T	7	4	11	0	1	12	0	0
16	14095183	.	G	C	6	4	10	0	1	11	0	0
16	14095279	.	C	A	10	16	26	0	2	28	0	0
16	14095397	.	A	C	12	15	27	0	0	27	0	0
16	14095563	.	A	C	10	0	10	0	12	22	0	0
16	14098014	.	C	T	12	14	26	0	1	27	0	0
16	14101832	.	G	A	0	3	3	0	0	3	0	0
16	14101864	.	T	C	7	9	16	0	1	17	0	0
16	14126267	.	C	T	9	7	16	0	0	16	0	0
16	14126294	.	T	C	4	2	6	0	1	7	0	0
16	14133317	.	G	A	2	5	7	0	1	8	0	0
16	14133521	.	G	A	10	14	24	0	0	24	0	0
16	14133547	.	G	T	11	14	25	0	3	28	0	0
16	14133721	.	C	T	7	11	18	0	0	18	0	0
16	14133734	.	A	C	8	10	18	0	1	19	0	0
16	14133874	.	C	T	11	7	18	0	0	18	0	0
16	14133910	.	C	G	11	5	16	0	0	16	0	0
16	14134020	.	C	T	0	9	9	0	11	20	0	0
16	14134116	.	A	T	1	2	3	0	0	3	0	0
16	14154105	.	A	G	10	12	22	0	0	22	0	0
16	14154150	.	T	G	6	13	19	0	1	20	0	0
16	14154240	.	T	A	8	9	17	0	0	17	0	0
16	14154324	.	T	C	8	0	8	0	11	19	0	0
16	14154708	.	G	A	9	11	20	0	0	20	0	0
16	14155364	.	T	C	8	6	14	0	0	14	0	0
16	14155605	.	T	A	10	8	18	0	0	18	0	0
16	14155997	.	A	T	5	4	9	0	0	9	0	0
16	14156157	.	T	C	3	6	9	0	2	11	0	0
16	14156177	.	G	A	8	5	13	0	1	14	0	0
16	14156518	.	T	A	4	5	9	0	1	10	0	0
16	14156775	.	C	A	0	3	3	0	8	11	0	0
16	14156865	.	A	G	2	3	5	0	0	5	0	0
16	14157055	.	C	T	3	6	9	0	0	9	0	0
16	14157112	.	C	T	2	7	9	0	0	9	0	0
16	14157316	.	A	G	6	5	11	0	0	11	0	0
16	14157390	.	G	A	6	12	18	0	0	18	0	0
16	14157447	.	T	A	6	7	13	0	0	13	0	0
16	14157448	.	A	T	6	7	13	0	0	13	0	0
16	14158490	.	G	A	4	5	9	0	0	9	0	0
16	14158619	.	G	A	2	4	6	0	0	6	0	0
16	14158655	.	T	C	5	5	10	0	0	10	0	0
16	14158666	.	T	G	6	4	10	0	0	10	0	0
16	14167360	.	G	A	0	1	1	0	0	1	0	0
16	14167480	.	T	C	2	3	5	0	0	5	0	0
16	14202111	.	A	C	4	2	6	0	0	6	0	0
16	14202116	.	C	T	5	3	8	0	0	8	0	0
16	14202192	.	A	C	6	4	10	0	0	10	0	0
16	14202197	.	T	A	6	2	8	0	0	8	0	0
16	14209142	.	A	C	3	6	9	0	0	9	0	0
16	14209195	.	G	A	3	3	6	0	0	6	0	0
16	14209348	.	T	C	7	10	17	0	0	17	0	0
16	14214961	.	G	C	1	0	1	0	0	1	0	0
16	14215565	.	C	G	1	3	4	0	0	4	0	0
16	14216726	.	A	G	3	3	6	0	0	6	0	0
16	14220104	.	T	A	2	2	4	0	0	4	0	0
16	14220123	.	C	T	3	4	7	0	0	7	0	0
16	14223186	.	A	C	0	1	1	0	0	1	0	0
16	14223225	.	C	T	1	2	3	0	0	3	0	0
16	14223252	.	C	T	3	2	5	0	0	6	1	0
16	14223260	.	T	C	3	3	6	0	0	6	0	0
16	14223963	.	G	A	0	7	7	0	4	11	0	0
16	14228009	.	A	G	4	3	7	0	0	7	0	0
16	14228010	.	G	A	4	3	7	0	0	7	0	0
16	14228668	.	A	G	2	1	3	0	0	3	0	0
16	14229614	.	A	G	2	9	11	0	0	11	0	0
16	14230373	.	T	C	3	3	6	0	2	8	0	0
16	14231135	.	G	A	0	6	6	0	8	14	0	0
16	14231138	.	C	T	7	6	13	0	1	14	0	0
16	14231928	.	C	A	13	8	21	0	0	21	0	0
16	14240609	.	G	A	0	3	3	0	0	3	0	0
16	14242688	.	C	T	0	1	1	0	10	11	0	0
16	14242811	.	A	G	8	8	16	0	1	17	0	0
16	14249570	.	G	C	1	1	2	0	0	2	0	0
16	14266647	.	A	T	0	1	1	0	0	1	0	0
16	14269975	.	C	T	1	3	4	0	0	4	0	0
16	14588225	.	A	C	6	16	22	0	0	22	0	0
16	14588390	.	T	C	3	5	8	0	1	9	0	0
16	14588430	.	A	G	2	2	4	0	0	4	0	0
16	14588450	.	G	A	1	2	3	0	0	3	0	0
16	14588705	.	C	T	0	2	2	0	0	2	0	0
16	14602380	.	C	G	1	2	3	0	0	3	0	0
16	14671097	.	A	T	3	2	5	0	0	5	0	0
16	14671098	.	A	C	3	2	5	0	0	5	0	0
16	14671135	.	A	G	1	4	5	0	0	5	0	0
16	14671227	.	C	T	2	5	7	0	1	8	0	0
16	14674706	.	C	T	7	12	19	0	1	20	0	0
16	14674718	.	T	G	6	15	21	0	1	22	0	0
16	14674788	.	T	G	5	10	15	0	0	15	0	0
16	14674801	.	G	T	4	8	12	0	1	13	0	0
16	14674855	.	A	G	5	4	9	0	0	9	0	0
16	14674923	.	A	T	3	10	13	0	0	13	0	0
16	14675016	.	A	G	6	0	6	0	5	11	0	0
16	14675101	.	T	A	10	10	20	0	1	21	0	0
16	14675373	.	A	C	10	6	16	0	1	17	0	0
16	14675513	.	A	C	1	5	6	0	0	6	0	0
16	14675658	.	A	G	4	11	15	0	2	17	0	0
16	14675780	.	A	G	7	4	11	0	1	12	0	0
16	14821780	.	A	G	1	1	2	0	0	2	0	0
16	14823883	.	C	G	1	2	3	0	0	3	0	0
16	14913497	.	C	T	2	1	3	0	0	3	0	0
16	14913560	.	G	A	1	1	2	0	0	2	0	0
16	15034906	.	C	T	1	1	2	0	0	2	0	0
16	15037775	.	G	A	3	9	12	0	0	12	0	0
16	15037778	.	C	T	8	3	11	0	0	11	0	0
16	15048253	.	T	C	6	11	17	0	0	17	0	0
16	15048338	.	G	A	0	6	6	0	15	21	0	0
16	15049093	.	G	T	2	3	5	0	0	5	0	0
16	15049278	.	A	T	1	5	6	0	0	6	0	0
16	15049594	.	A	G	1	0	1	0	2	3	0	0
16	15049760	.	A	C	1	6	7	0	0	7	0	0
16	15050195	.	T	C	7	3	10	0	4	14	0	0
16	15050277	.	G	A	6	5	11	0	0	11	0	0
16	15050372	.	C	T	13	10	23	0	0	23	0	0
16	15050478	.	T	A	8	7	15	0	1	16	0	0
16	15143512	.	G	A	1	1	2	0	0	2	0	0
16	15168740	.	G	A	0	2	2	0	0	2	0	0
16	15943424	.	C	T	9	7	16	0	2	18	0	0
16	15944980	.	A	T	5	2	7	0	1	8	0	0
16	15956855	.	C	A	3	2	5	0	0	5	0	0
16	15958358	.	T	C	7	4	11	0	0	11	0	0
16	15958715	.	T	C	2	0	2	0	2	4	0	0
16	15987984	.	A	G	1	4	5	0	0	5	0	0
16	16042986	.	T	C	11	12	23	0	1	24	0	0
16	16070136	.	C	T	4	2	6	0	1	7	0	0
16	16078951	.	A	G	1	4	5	0	0	5	0	0
16	16081095	.	C	G	0	0	0	0	3	3	0	0
16	16081104	.	T	A	1	3	4	0	1	5	0	0
16	16165179	.	T	A	29	28	57	0	2	59	0	0
16	16165361	.	A	G	27	47	74	0	0	74	0	0
16	16165418	.	C	T	32	38	70	0	1	71	0	0
16	16165725	.	A	C	31	44	75	0	1	76	0	0
16	16212520	.	A	G	9	5	14	0	0	14	0	0
16	16232963	.	T	C	2	5	7	0	0	7	0	0
16	16233410	.	A	G	8	3	11	0	1	12	0	0
16	16233520	.	C	T	6	6	12	0	0	12	0	0
16	16233538	.	A	T	2	4	6	0	4	10	0	0
16	16234309	.	C	A	0	9	9	0	6	15	0	0
16	16234840	.	A	T	8	5	13	0	0	13	0	0
16	16266645	.	A	G	1	2	3	0	0	3	0	0
16	16266653	.	A	T	1	2	3	0	0	3	0	0
16	16266809	.	A	G	1	3	4	0	1	5	0	0
16	16267814	.	C	G	3	2	5	0	0	5	0	0
16	16267823	.	T	C	3	2	5	0	0	5	0	0
16	16267895	.	G	A	0	2	2	0	1	3	0	0
16	16267903	.	A	G	0	2	2	0	1	3	0	0
16	16268284	.	C	T	1	2	3	0	0	3	0	0
16	16269089	.	A	G	3	2	5	0	0	5	0	0
16	16269118	.	C	T	3	4	7	0	0	7	0	0
16	16269502	.	C	T	4	3	7	0	1	8	0	0
16	16269508	.	C	T	3	4	7	0	1	8	0	0
16	16269690	.	G	A	0	2	2	0	5	7	0	0
16	16269724	.	G	A	7	4	11	0	0	11	0	0
16	16269926	.	G	C	1	2	3	0	0	3	0	0
16	16269964	.	T	C	2	6	8	0	0	8	0	0
16	16270163	.	C	A	3	3	6	0	1	7	0	0
16	16270326	.	G	A	2	6	8	0	1	9	0	0
16	16270358	.	A	G	2	4	6	0	0	6	0	0
16	16270361	.	T	C	2	4	6	0	0	6	0	0
16	16270424	.	T	C	1	1	2	0	0	2	0	0
16	16271683	.	G	A	2	4	6	0	0	6	0	0
16	16271695	.	A	G	2	3	5	0	0	5	0	0
16	16275288	.	T	C	3	1	4	0	0	4	0	0
16	16276938	.	T	C	1	2	3	0	0	3	0	0
16	16277689	.	A	G	8	5	13	0	0	13	0	0
16	16277728	.	G	A	5	4	9	0	0	9	0	0
16	16277810	.	G	A	2	4	6	0	0	6	0	0
16	16277954	.	G	A	3	7	10	0	0	10	0	0
16	16278013	.	A	T	6	7	13	0	0	13	0	0
16	16278043	.	T	C	7	7	14	0	0	14	0	0
16	16278356	.	C	A	3	2	5	0	0	5	0	0
16	16278755	.	G	C	4	8	12	0	0	12	0	0
16	16278756	.	C	A	4	8	12	0	0	12	0	0
16	16281740	.	A	C	2	6	8	0	0	8	0	0
16	16284057	.	T	C	7	11	18	0	0	18	0	0
16	16284159	.	G	A	0	12	12	0	17	29	0	0
16	16284192	.	C	A	11	14	25	0	2	27	0	0
16	16289121	.	C	T	8	4	12	0	0	12	0	0
16	16297057	.	G	A	1	0	1	0	0	1	0	0
16	16302166	.	T	C	6	9	15	0	1	16	0	0
16	16302247	.	A	T	14	8	22	0	1	23	0	0
16	16302371	.	A	C	9	12	21	0	1	22	0	0
16	16302426	.	T	A	8	14	22	0	1	23	0	0
16	16302477	.	G	A	0	8	8	0	9	17	0	0
16	16302835	.	T	C	17	4	21	0	1	22	0	0
16	16303025	.	C	T	12	13	25	0	1	26	0	0
16	16303065	.	A	G	9	10	19	0	0	19	0	0
16	16303086	.	T	A	11	10	21	0	0	21	0	0
16	16303163	.	G	A	0	8	8	0	8	16	0	0
16	16303196	.	A	G	8	0	8	0	7	15	0	0
16	16303293	.	T	G	5	7	12	0	0	12	0	0
16	16553899	.	C	T	4	2	6	0	0	6	0	0
16	16555611	.	A	G	10	9	19	0	3	22	0	0
16	16555664	.	A	G	9	6	15	0	0	15	0	0
16	16555975	.	T	A	5	5	10	0	1	11	0	0
16	16565963	.	G	C	10	14	24	0	0	24	0	0
16	16565998	.	C	T	7	9	16	0	0	16	0	0
16	16566182	.	T	C	6	6	12	0	0	12	0	0
16	16566402	.	G	A	2	0	2	0	0	2	0	0
16	16569047	.	G	A	4	2	6	0	0	6	0	0
16	16569578	.	C	G	7	4	11	0	1	12	0	0
16	16574168	.	T	C	1	0	1	0	0	1	0	0
16	16586232	.	C	T	9	14	23	0	4	27	0	0
16	16586290	.	G	A	10	11	21	0	0	21	0	0
16	16589462	.	G	A	1	0	1	0	0	1	0	0
16	16589552	.	G	A	5	5	10	0	0	10	0	0
16	16590715	.	T	C	8	4	12	0	0	12	0	0
16	16597863	.	A	G	2	2	4	0	0	4	0	0
16	16598043	.	G	A	1	2	3	0	0	3	0	0
16	16598049	.	T	C	1	2	3	0	0	3	0	0
16	16598146	.	T	C	3	2	5	0	0	5	0	0
16	16603081	.	C	A	0	1	1	0	0	1	0	0
16	16603651	.	T	A	1	0	1	0	0	1	0	0
16	16849326	.	C	T	2	2	4	0	0	4	0	0
16	16877130	.	G	T	1	3	4	0	0	4	0	0
16	16887359	.	C	T	1	2	3	0	0	3	0	0
16	16906094	.	A	G	2	2	4	0	0	4	0	0
16	16906124	.	G	A	1	2	3	0	0	3	0	0
16	16908586	.	G	A	3	6	9	0	0	9	0	0
16	16912252	.	T	G	0	0	0	0	1	1	0	0
16	16913102	.	G	A	3	4	7	0	0	7	0	0
16	16916699	.	G	A	4	7	11	0	0	11	0	0
16	16916893	.	C	T	1	1	2	0	0	2	0	0
16	16916955	.	A	G	3	0	3	0	3	6	0	0
16	16920823	.	G	A	2	2	4	0	1	5	0	0
16	16921134	.	G	A	4	9	13	0	1	14	0	0
16	16923651	.	A	G	3	6	9	0	0	9	0	0
16	16939663	.	G	T	1	4	5	0	0	5	0	0
16	16940732	.	A	G	5	3	8	0	0	8	0	0
16	16940768	.	A	G	6	0	6	0	11	17	0	0
16	16941121	.	G	A	0	9	9	0	6	15	0	0
16	16941237	.	G	A	0	13	13	0	10	23	0	0
16	16941270	.	G	A	0	10	10	0	8	18	0	0
16	16941343	.	G	A	9	6	15	0	1	16	0	0
16	16941361	.	T	C	11	4	15	0	0	15	0	0
16	16941394	.	C	T	10	5	15	0	1	16	0	0
16	16941741	.	C	T	10	9	19	0	0	19	0	0
16	16941927	.	A	G	8	0	8	0	6	14	0	0
16	16941979	.	C	A	5	6	11	0	1	12	0	0
16	16942001	.	G	A	1	5	6	0	6	12	0	0
16	16942130	.	C	A	3	3	6	0	3	9	0	0
16	16942200	.	C	T	7	5	12	0	4	16	0	0
16	16942293	.	T	A	8	5	13	0	0	13	0	0
16	16942332	.	G	A	6	3	9	0	1	10	0	0
16	16942867	.	A	G	8	16	24	0	0	24	0	0
16	16942906	.	C	G	8	16	24	0	0	24	0	0
16	16942953	.	A	G	10	8	18	0	1	19	0	0
16	16943258	.	C	A	8	16	24	0	1	25	0	0
16	16943348	.	C	A	9	11	20	0	1	21	0	0
16	16943388	.	T	A	7	9	16	0	0	16	0	0
16	16943651	.	A	T	10	10	20	0	0	21	1	0
16	16944023	.	G	T	9	13	22	0	2	24	0	0
16	16944066	.	T	C	10	10	20	0	2	22	0	0
16	16944142	.	A	T	10	11	21	0	0	21	0	0
16	16944150	.	T	C	12	10	22	0	0	22	0	0
16	16944884	.	A	G	7	4	11	0	1	12	0	0
16	16945328	.	G	A	7	10	17	0	0	17	0	0
16	16945365	.	T	G	7	11	18	0	1	19	0	0
16	16985499	.	C	T	5	4	9	0	0	9	0	0
16	16985511	.	A	T	2	1	3	0	0	3	0	0
16	17122132	.	C	A	0	8	8	0	12	20	0	0
16	17136998	.	C	T	0	4	4	0	0	4	0	0
16	17162524	.	C	A	10	8	18	0	2	20	0	0
16	17194984	.	A	G	1	0	1	0	0	1	0	0
16	17234845	.	C	A	5	2	7	0	0	7	0	0
16	17238475	.	T	A	0	2	2	0	0	2	0	0
16	17238490	.	A	G	0	2	2	0	0	2	0	0
16	17238757	.	A	T	0	1	1	0	0	1	0	0
16	17238793	.	G	A	0	1	1	0	0	1	0	0
16	17247089	.	A	G	1	1	2	0	0	2	0	0
16	17247514	.	G	T	1	2	3	0	0	3	0	0
16	17252909	.	G	C	8	8	16	0	1	17	0	0
16	17253056	.	T	C	8	8	16	0	3	19	0	0
16	17253085	.	C	T	8	7	15	0	1	16	0	0
16	17253274	.	T	C	3	6	9	0	1	10	0	0
16	17254689	.	G	T	0	2	2	0	0	2	0	0
16	17254761	.	T	C	4	3	7	0	0	7	0	0
16	17256120	.	C	T	3	3	6	0	0	6	0	0
16	17302526	.	T	C	4	7	11	0	1	12	0	0
16	17302821	.	A	G	1	2	3	0	0	3	0	0
16	17316397	.	G	A	2	5	7	0	0	7	0	0
16	17316462	.	T	G	3	4	7	0	0	7	0	0
16	17316757	.	A	G	5	7	12	0	0	12	0	0
16	17316785	.	T	C	6	5	11	0	1	12	0	0
16	17319183	.	T	C	0	1	1	0	0	1	0	0
16	17466205	.	T	A	5	2	7	0	0	7	0	0
16	17467011	.	G	A	5	5	10	0	0	10	0	0
16	17467021	.	C	T	2	5	7	0	0	7	0	0
16	17467361	.	G	A	0	2	2	0	6	8	0	0
16	17549443	.	T	C	1	0	1	0	2	3	0	0
16	17551266	.	A	T	1	4	5	0	1	6	0	0
16	17551272	.	A	G	2	3	5	0	0	5	0	0
16	17560294	.	G	A	1	0	1	0	0	1	0	0
16	17580032	.	C	T	3	3	6	0	1	7	0	0
16	17580836	.	C	T	2	2	4	0	0	4	0	0
16	17581021	.	A	T	6	10	16	0	0	16	0	0
16	17639989	.	T	A	1	11	12	0	1	13	0	0
16	17640184	.	C	T	11	5	16	0	0	16	0	0
16	17640297	.	G	A	10	9	19	0	0	19	0	0
16	17640550	.	A	T	10	12	22	0	1	23	0	0
16	17640693	.	G	A	5	11	16	0	0	16	0	0
16	17646269	.	T	C	4	2	6	0	0	6	0	0
16	17763933	.	T	A	4	7	11	0	0	11	0	0
16	17764238	.	G	A	2	11	13	0	0	13	0	0
16	17798055	.	T	C	6	9	15	0	0	15	0	0
16	17798056	.	C	T	5	9	14	0	1	15	0	0
16	18146283	.	A	G	1	1	2	0	2	4	0	0
16	18535689	.	G	A	7	7	14	0	2	16	0	0
16	18552492	.	C	T	2	1	3	0	0	3	0	0
16	18624101	.	T	C	1	1	2	0	2	4	0	0
16	19124404	.	T	C	1	1	2	0	0	2	0	0
16	19124452	.	A	G	1	1	2	0	0	2	0	0
16	19126439	.	A	G	6	0	6	0	0	6	0	0
16	19136322	.	C	T	1	3	4	0	0	4	0	0
16	19150814	.	T	A	7	5	12	0	1	13	0	0
16	19150952	.	T	A	7	6	13	0	0	13	0	0
16	19151187	.	T	G	6	4	10	0	1	11	0	0
16	19151189	.	T	G	6	5	11	0	0	11	0	0
16	19151254	.	A	G	3	4	7	0	0	7	0	0
16	19151680	.	A	T	5	2	7	0	0	7	0	0
16	19151694	.	T	C	4	2	6	0	0	6	0	0
16	19537565	.	G	A	0	3	3	0	3	6	0	0
16	19538162	.	T	C	8	3	11	0	0	11	0	0
16	19538840	.	G	A	3	3	6	0	3	9	0	0
16	19538936	.	A	G	4	3	7	0	0	7	0	0
16	19539036	.	G	A	5	2	7	0	0	7	0	0
16	19539235	.	C	A	4	2	6	0	0	6	0	0
16	19539574	.	C	A	3	4	7	0	0	7	0	0
16	19840562	.	T	C	11	7	18	0	0	18	0	0
16	19840645	.	T	A	12	5	17	0	0	17	0	0
16	19840658	.	A	C	8	7	15	0	3	18	0	0
16	19840867	.	A	G	6	16	22	0	1	23	0	0
16	19841082	.	C	G	1	15	16	0	20	36	0	0
16	19841135	.	C	T	14	16	30	0	1	31	0	0
16	19841290	.	A	T	8	13	21	0	0	21	0	0
16	19841358	.	C	T	6	10	16	0	1	17	0	0
16	19841502	.	A	T	4	6	10	0	0	10	0	0
16	19841591	.	A	G	3	8	11	0	1	12	0	0
16	19841786	.	A	T	5	12	17	0	0	17	0	0
16	19841890	.	G	A	2	5	7	0	1	8	0	0
16	19842493	.	G	A	5	13	18	0	2	20	0	0
16	19842530	.	A	G	4	13	17	0	1	18	0	0
16	19843053	.	G	T	13	11	24	0	0	24	0	0
16	19843056	.	G	T	12	13	25	0	0	25	0	0
16	19850683	.	G	T	13	12	25	0	2	27	0	0
16	19853074	.	G	A	2	2	4	0	0	4	0	0
16	19853098	.	C	T	9	9	18	0	2	20	0	0
16	19853230	.	A	C	5	2	7	0	0	7	0	0
16	19864588	.	G	T	11	5	16	0	1	17	0	0
16	20123692	.	C	T	1	0	1	0	0	1	0	0
16	20123828	.	G	A	0	1	1	0	0	1	0	0
16	20123849	.	T	C	0	2	2	0	0	2	0	0
16	20126448	.	G	T	0	2	2	0	3	5	0	0
16	20148670	.	C	T	0	0	0	0	1	1	0	0
16	20151770	.	A	G	7	9	16	0	0	16	0	0
16	20151841	.	T	C	8	10	18	0	0	18	0	0
16	20151936	.	A	G	9	4	13	0	1	14	0	0
16	20152044	.	C	A	6	5	11	0	0	14	3	0
16	20152106	.	A	T	7	7	14	0	1	15	0	0
16	20152203	.	A	G	7	0	7	0	5	12	0	0
16	20152250	.	T	C	3	5	8	0	0	8	0	0
16	20152405	.	A	G	4	3	7	0	0	7	0	0
16	20152474	.	A	G	3	6	9	0	1	10	0	0
16	20152476	.	C	A	4	4	8	0	2	10	0	0
16	20193844	.	C	G	3	2	5	0	0	5	0	0
16	20235482	.	T	C	1	2	3	0	0	3	0	0
16	20235506	.	G	A	2	2	4	0	0	4	0	0
16	20236803	.	T	C	1	2	3	0	0	3	0	0
16	20238365	.	T	G	2	3	5	0	0	5	0	0
16	20238905	.	G	C	5	6	11	0	0	11	0	0
16	20238932	.	G	A	8	6	14	0	0	14	0	0
16	20265655	.	T	C	3	0	3	0	6	9	0	0
16	20265928	.	C	T	1	2	3	0	1	4	0	0
16	20265936	.	T	A	2	2	4	0	1	5	0	0
16	20266106	.	T	C	2	2	4	0	0	4	0	0
16	20266109	.	T	A	2	2	4	0	0	4	0	0
16	20266321	.	T	C	4	2	6	0	0	6	0	0
16	20266840	.	T	A	10	6	16	0	0	16	0	0
16	20267424	.	A	T	7	3	10	0	0	10	0	0
16	20267604	.	T	A	2	0	2	0	0	2	0	0
16	20267909	.	A	T	5	6	11	0	0	11	0	0
16	20268322	.	A	G	1	3	4	0	0	4	0	0
16	20268328	.	A	T	1	3	4	0	0	4	0	0
16	20271634	.	T	G	2	1	3	0	0	3	0	0
16	20271756	.	A	G	2	1	3	0	0	3	0	0
16	20304889	.	A	G	1	0	1	0	1	2	0	0
16	20304900	.	C	T	1	2	3	0	0	3	0	0
16	20324870	.	C	T	14	8	22	0	1	23	0	0
16	20371350	.	A	G	3	2	5	0	0	5	0	0
16	20402139	.	G	T	7	8	15	0	0	15	0	0
16	20402193	.	C	T	0	10	10	0	7	17	0	0
16	20402199	.	A	G	7	9	16	0	0	16	0	0
16	20403022	.	C	A	0	4	4	0	2	6	0	0
16	20492604	.	C	T	4	5	9	0	0	9	0	0
16	20497297	.	A	C	2	4	6	0	0	6	0	0
16	20497302	.	C	T	3	2	5	0	1	6	0	0
16	20499829	.	G	A	0	4	4	0	0	4	0	0
16	20500142	.	A	G	3	4	7	0	0	7	0	0
16	20513152	.	A	G	11	11	22	0	1	23	0	0
16	20792982	.	T	A	4	4	8	0	0	8	0	0
16	20800347	.	C	T	3	5	8	0	1	9	0	0
16	20806006	.	C	T	11	5	16	0	2	18	0	0
16	20806747	.	A	G	16	12	28	0	2	30	0	0
16	20813628	.	C	T	0	17	17	0	22	39	0	0
16	20815743	.	A	G	5	6	11	0	0	11	0	0
16	20822881	.	T	C	4	6	10	0	0	10	0	0
16	20824508	.	C	G	2	3	5	0	0	5	0	0
16	20824566	.	C	T	18	11	29	0	2	31	0	0
16	20826697	.	T	C	12	19	31	0	1	32	0	0
16	20836218	.	G	A	9	7	16	0	2	18	0	0
16	20836870	.	G	A	12	6	18	0	0	18	0	0
16	20855582	.	G	A	11	8	19	0	1	20	0	0
16	20874252	.	T	C	6	4	10	0	0	10	0	0
16	20889292	.	G	A	9	8	17	0	1	18	0	0
16	20889325	.	C	T	8	5	13	0	0	13	0	0
16	20889514	.	G	T	1	3	4	0	0	4	0	0
16	21404630	.	A	G	4	2	6	0	0	6	0	0
16	22751655	.	T	C	7	4	11	0	1	12	0	0
16	22751656	.	T	C	8	0	8	0	4	12	0	0
16	23353727	.	G	A	3	5	8	0	0	8	0	0
16	23353859	.	G	T	5	5	10	0	0	10	0	0
16	23353901	.	G	T	2	2	4	0	0	4	0	0
16	23379183	.	A	G	0	1	1	0	0	1	0	0
16	23379386	.	T	G	2	4	6	0	0	6	0	0
16	23383399	.	T	A	0	3	3	0	1	4	0	0
16	23385909	.	A	G	2	5	7	0	1	8	0	0
16	23388400	.	A	T	3	13	16	0	0	16	0	0
16	23398489	.	T	C	2	4	6	0	1	7	0	0
16	23399307	.	T	C	1	2	3	0	1	4	0	0
16	23495775	.	A	T	4	3	7	0	4	11	0	0
16	23495820	.	C	T	10	4	14	0	0	14	0	0
16	23556448	.	T	C	7	17	24	0	0	24	0	0
16	23556748	.	A	G	12	0	12	0	13	25	0	0
16	23556758	.	C	T	12	14	26	0	1	27	0	0
16	23556822	.	A	G	7	16	23	0	0	23	0	0
16	23557013	.	G	A	2	5	7	0	0	7	0	0
16	23557051	.	T	C	1	8	9	0	0	9	0	0
16	23557153	.	T	C	1	2	3	0	0	3	0	0
16	23557175	.	T	A	2	2	4	0	0	4	0	0
16	23599103	.	A	C	2	2	4	0	0	4	0	0
16	23706953	.	A	G	3	0	3	0	1	4	0	0
16	23718419	.	G	C	14	17	31	0	0	31	0	0
16	23718687	.	A	G	4	8	12	0	0	12	0	0
16	23718700	.	A	G	6	8	14	0	0	14	0	0
16	23718999	.	T	C	7	3	10	0	1	11	0	0
16	23719011	.	A	G	8	3	11	0	1	12	0	0
16	23788830	.	A	G	27	32	59	0	2	61	0	0
16	23809280	.	T	C	1	2	3	0	0	3	0	0
16	23809311	.	A	C	1	2	3	0	0	3	0	0
16	23821654	.	T	A	6	7	13	0	0	14	1	0
16	23831697	.	A	G	3	2	5	0	0	5	0	0
16	23831836	.	A	T	4	1	5	0	0	5	0	0
16	23831892	.	C	T	13	5	18	0	0	18	0	0
16	23832045	.	T	A	9	3	12	0	0	12	0	0
16	23832204	.	C	T	4	10	14	0	0	14	0	0
16	23832302	.	T	C	4	6	10	0	0	10	0	0
16	23832304	.	A	T	4	6	10	0	0	10	0	0
16	23832520	.	A	C	13	9	22	0	0	22	0	0
16	23832561	.	T	C	15	10	25	0	0	25	0	0
16	23832589	.	G	A	10	12	22	0	1	23	0	0
16	23832646	.	A	T	11	14	25	0	1	26	0	0
16	23832695	.	A	G	3	17	20	0	3	24	1	0
16	23832787	.	T	C	12	4	16	0	0	16	0	0
16	23832850	.	A	G	13	5	18	0	1	19	0	0
16	23833070	.	A	C	13	6	19	0	0	19	0	0
16	23833121	.	A	G	9	9	18	0	0	18	0	0
16	23833274	.	T	A	8	9	17	0	1	18	0	0
16	23833284	.	T	C	8	7	15	0	0	15	0	0
16	23833309	.	A	T	8	12	20	0	0	20	0	0
16	23833347	.	T	A	12	7	19	0	1	20	0	0
16	23833377	.	G	T	11	5	16	0	0	16	0	0
16	23833420	.	G	T	5	7	12	0	1	13	0	0
16	23833442	.	G	A	6	9	15	0	1	16	0	0
16	23833528	.	A	T	4	10	14	0	0	14	0	0
16	23833663	.	A	G	12	4	16	0	0	16	0	0
16	23833723	.	A	G	15	10	25	0	0	25	0	0
16	23834001	.	A	C	13	7	20	0	1	21	0	0
16	23834540	.	T	C	15	8	23	0	0	23	0	0
16	23834554	.	A	G	7	13	20	0	9	29	0	0
16	23834859	.	A	G	8	5	13	0	1	14	0	0
16	23834885	.	A	T	7	9	16	0	0	16	0	0
16	23835310	.	T	A	1	5	6	0	3	9	0	0
16	23835758	.	G	A	3	0	3	0	0	7	4	0
16	23864388	.	T	C	2	3	5	0	1	6	0	0
16	23864527	.	T	C	3	2	5	0	0	5	0	0
16	23864624	.	C	T	6	5	11	0	0	11	0	0
16	23864668	.	A	G	2	0	2	0	4	6	0	0
16	23864805	.	A	G	6	3	9	0	0	9	0	0
16	23864902	.	G	A	1	2	3	0	0	3	0	0
16	23864905	.	C	T	0	2	2	0	1	3	0	0
16	23880158	.	G	T	3	2	5	0	0	5	0	0
16	23901394	.	C	T	1	4	5	0	0	5	0	0
16	23901420	.	G	C	1	3	4	0	0	4	0	0
16	23901614	.	T	G	1	4	5	0	0	5	0	0
16	23901754	.	A	G	1	2	3	0	0	3	0	0
16	23901805	.	G	A	1	2	3	0	0	3	0	0
16	23902179	.	C	T	1	1	2	0	1	3	0	0
16	23902235	.	T	C	0	4	4	0	2	6	0	0
16	23961878	.	C	T	4	6	10	0	0	10	0	0
16	23962007	.	G	A	11	8	19	0	1	20	0	0
16	23963241	.	C	T	17	14	31	0	3	34	0	0
16	23963257	.	G	T	20	15	35	0	0	35	0	0
16	23972939	.	G	A	2	2	4	0	0	4	0	0
16	23973691	.	C	T	1	3	4	0	0	4	0	0
16	24517791	.	A	T	1	2	3	0	0	3	0	0
16	24517824	.	G	A	10	8	18	0	0	18	0	0
16	24551929	.	A	T	1	2	3	0	0	3	0	0
16	24552024	.	A	T	2	3	5	0	0	5	0	0
16	24552155	.	A	C	7	5	12	0	0	12	0	0
16	24552176	.	C	G	7	6	13	0	0	13	0	0
16	24552215	.	C	T	3	11	14	0	0	14	0	0
16	24552368	.	A	T	7	1	8	0	1	9	0	0
16	24552369	.	A	T	8	1	9	0	0	9	0	0
16	24552459	.	A	G	2	3	5	0	0	5	0	0
16	24552801	.	A	G	4	4	8	0	3	11	0	0
16	24552826	.	G	A	6	4	10	0	0	10	0	0
16	24552931	.	G	T	4	4	8	0	0	8	0	0
16	24552934	.	G	A	3	4	7	0	1	8	0	0
16	24553450	.	T	C	4	9	13	0	0	13	0	0
16	24553464	.	G	T	5	7	12	0	0	12	0	0
16	24553633	.	A	G	3	8	11	0	0	11	0	0
16	24553663	.	T	G	5	6	11	0	0	11	0	0
16	24554475	.	A	G	9	5	14	0	2	16	0	0
16	24554509	.	C	T	8	9	17	0	1	18	0	0
16	24590767	.	T	A	11	16	27	0	0	27	0	0
16	24590804	.	G	T	12	22	34	0	3	37	0	0
16	24590823	.	C	T	15	21	36	0	2	38	0	0
16	24590950	.	T	A	16	8	24	0	2	26	0	0
16	24590999	.	A	G	17	12	29	0	0	29	0	0
16	24591010	.	G	A	16	12	28	0	1	29	0	0
16	24591036	.	T	C	17	13	30	0	1	31	0	0
16	24591074	.	G	A	17	16	33	0	0	33	0	0
16	24591172	.	A	G	16	22	38	0	1	39	0	0
16	24591207	.	T	G	11	10	21	0	5	26	0	0
16	24591379	.	C	T	7	12	19	0	0	19	0	0
16	24591422	.	C	A	5	5	10	0	0	10	0	0
16	24596192	.	C	T	2	0	2	0	0	2	0	0
16	24632148	.	T	C	10	13	23	0	0	23	0	0
16	24632306	.	C	A	6	15	21	0	0	21	0	0
16	24637342	.	G	T	7	10	17	0	1	18	0	0
16	24637369	.	A	C	1	4	5	0	1	6	0	0
16	24639396	.	G	A	5	8	13	0	0	13	0	0
16	24645240	.	C	T	4	1	5	0	0	5	0	0
16	24645448	.	C	G	10	7	17	0	0	17	0	0
16	24645476	.	A	T	11	9	20	0	2	22	0	0
16	24645769	.	T	G	6	1	7	0	5	12	0	0
16	24645796	.	G	A	7	7	14	0	0	14	0	0
16	24645820	.	A	T	4	9	13	0	0	13	0	0
16	24645888	.	G	T	9	4	13	0	1	14	0	0
16	24645895	.	C	G	10	4	14	0	1	15	0	0
16	24645978	.	A	T	4	11	15	0	0	15	0	0
16	24646000	.	A	T	3	9	12	0	0	12	0	0
16	24646620	.	T	C	1	4	5	0	4	9	0	0
16	24646684	.	C	A	3	4	7	0	1	8	0	0
16	24669991	.	T	C	1	2	3	0	0	3	0	0
16	24692635	.	T	C	28	35	63	0	1	64	0	0
16	24692685	.	A	G	14	1	15	0	14	29	0	0
16	24695295	.	C	G	34	27	61	0	0	61	0	0
16	24695301	.	T	C	32	27	59	0	2	61	0	0
16	24695520	.	G	A	32	25	57	0	3	60	0	0
16	24695551	.	G	A	3	27	30	0	24	54	0	0
16	24721757	.	C	T	3	4	7	0	0	7	0	0
16	24721860	.	T	C	3	0	3	0	0	3	0	0
16	24723430	.	A	C	4	5	9	0	0	9	0	0
16	24725170	.	G	A	1	5	6	0	0	6	0	0
16	24727766	.	G	A	2	2	4	0	1	5	0	0
16	24727826	.	A	T	2	3	5	0	0	5	0	0
16	24729093	.	G	C	0	1	1	0	0	1	0	0
16	24732829	.	A	G	3	0	3	0	10	13	0	0
16	24732869	.	G	T	7	7	14	0	0	14	0	0
16	24732921	.	C	A	4	7	11	0	0	11	0	0
16	24733125	.	A	G	2	6	8	0	0	8	0	0
16	24733127	.	A	G	2	4	6	0	2	8	0	0
16	24740103	.	G	T	1	2	3	0	0	3	0	0
16	24740119	.	G	C	0	2	2	0	1	3	0	0
16	24819475	.	T	C	2	0	2	0	2	4	0	0
16	24819613	.	C	T	0	2	2	0	1	4	1	0
16	24819620	.	T	C	2	2	4	0	0	4	0	0
16	24980299	.	A	G	1	0	1	0	0	1	0	0
16	24989616	.	C	T	2	6	8	0	0	8	0	0
16	24990603	.	G	A	2	7	9	0	0	9	0	0
16	24991391	.	T	C	6	6	12	0	0	12	0	0
16	24991741	.	T	C	2	3	5	0	0	5	0	0
16	25012045	.	A	C	3	6	9	0	0	9	0	0
16	25012123	.	T	C	7	2	9	0	0	9	0	0
16	25012143	.	T	A	4	0	4	0	0	4	0	0
16	25030191	.	T	A	2	4	6	0	0	6	0	0
16	25030333	.	C	T	3	3	6	0	0	6	0	0
16	25030338	.	G	A	3	3	6	0	0	6	0	0
16	25030541	.	G	A	4	6	10	0	0	10	0	0
16	25030623	.	A	G	2	3	5	0	0	5	0	0
16	25030649	.	A	T	3	3	6	0	0	6	0	0
16	25030671	.	T	C	5	4	9	0	0	9	0	0
16	25030685	.	A	G	5	6	11	0	0	11	0	0
16	25030807	.	G	A	3	2	5	0	0	5	0	0
16	25030831	.	G	T	3	6	9	0	0	9	0	0
16	25030848	.	G	A	4	6	10	0	1	11	0	0
16	25030956	.	A	C	3	3	6	0	0	6	0	0
16	25030981	.	G	T	2	2	4	0	0	4	0	0
16	25031019	.	C	A	2	2	4	0	0	4	0	0
16	25031185	.	C	A	1	5	6	0	0	6	0	0
16	25031211	.	C	A	2	7	9	0	0	9	0	0
16	25031220	.	C	T	2	7	9	0	0	9	0	0
16	25031250	.	G	A	3	4	7	0	0	7	0	0
16	25031261	.	C	G	4	2	6	0	0	6	0	0
16	25031400	.	T	C	3	5	8	0	0	8	0	0
16	25031414	.	C	A	3	8	11	0	0	11	0	0
16	25031435	.	G	C	3	8	11	0	0	11	0	0
16	25031712	.	T	G	5	2	7	0	0	7	0	0
16	25031785	.	G	A	5	2	7	0	0	7	0	0
16	25031811	.	T	C	2	2	4	0	0	4	0	0
16	25033071	.	G	A	8	12	20	0	0	20	0	0
16	25033306	.	C	T	6	7	13	0	0	13	0	0
16	25033319	.	C	T	6	9	15	0	0	15	0	0
16	25033423	.	A	T	4	5	9	0	0	9	0	0
16	25033659	.	C	A	8	9	17	0	0	17	0	0
16	25033953	.	G	A	5	9	14	0	0	14	0	0
16	25033983	.	T	A	7	5	12	0	1	13	0	0
16	25034115	.	A	G	5	5	10	0	0	10	0	0
16	25034187	.	C	A	2	4	6	0	1	7	0	0
16	25034223	.	A	C	9	5	14	0	0	14	0	0
16	25034241	.	G	A	9	6	15	0	1	16	0	0
16	25034416	.	A	C	6	10	16	0	0	16	0	0
16	25034445	.	A	G	6	11	17	0	1	18	0	0
16	25034682	.	A	G	4	0	4	0	14	18	0	0
16	25034766	.	G	A	15	5	20	0	1	21	0	0
16	25035024	.	T	G	3	0	3	0	10	13	0	0
16	25035129	.	A	G	9	10	19	0	3	22	0	0
16	25035169	.	G	T	10	12	22	0	1	23	0	0
16	25035471	.	A	G	9	4	13	0	0	13	0	0
16	25035906	.	A	T	5	12	17	0	0	17	0	0
16	25038011	.	T	C	15	8	23	0	2	25	0	0
16	25038412	.	A	G	6	12	18	0	1	19	0	0
16	25038429	.	C	T	6	11	17	0	0	17	0	0
16	25038689	.	A	C	6	6	12	0	0	12	0	0
16	25038696	.	A	T	5	5	10	0	0	10	0	0
16	25066960	.	C	T	3	4	7	0	0	7	0	0
16	25068568	.	C	T	2	2	4	0	0	4	0	0
16	25068794	.	A	G	3	0	3	0	5	8	0	0
16	25076311	.	C	T	3	2	5	0	0	5	0	0
16	25076704	.	A	G	1	3	4	0	0	4	0	0
16	25076831	.	T	A	2	3	5	0	0	5	0	0
16	25076919	.	G	C	3	3	6	0	0	6	0	0
16	25078815	.	G	C	4	3	7	0	0	7	0	0
16	25095659	.	C	T	5	4	9	0	0	9	0	0
16	25096098	.	A	G	6	6	12	0	0	12	0	0
16	25104031	.	T	C	11	17	28	0	0	28	0	0
16	25104196	.	A	G	8	10	18	0	1	19	0	0
16	25104226	.	A	G	13	9	22	0	0	22	0	0
16	25104454	.	C	G	16	13	29	0	1	30	0	0
16	25104595	.	C	T	12	10	22	0	1	23	0	0
16	25104850	.	A	C	13	10	23	0	0	23	0	0
16	25111633	.	T	A	2	1	3	0	0	3	0	0
16	25111665	.	C	A	5	3	8	0	0	8	0	0
16	25111755	.	T	A	7	4	11	0	0	11	0	0
16	25112115	.	G	A	8	5	13	0	0	13	0	0
16	25112337	.	T	C	3	4	7	0	0	7	0	0
16	25112625	.	C	T	0	2	2	0	1	3	0	0
16	25112760	.	C	T	5	3	8	0	0	8	0	0
16	25113091	.	A	T	6	10	16	0	0	16	0	0
16	25114362	.	C	T	5	8	13	0	0	13	0	0
16	25114450	.	G	A	0	8	8	0	8	16	0	0
16	25114451	.	C	G	8	8	16	0	0	16	0	0
16	25114508	.	C	A	8	8	16	0	0	16	0	0
16	25114522	.	A	C	7	9	16	0	1	17	0	0
16	25114546	.	A	G	6	7	13	0	1	14	0	0
16	25114848	.	A	G	16	12	28	0	2	30	0	0
16	25114881	.	T	C	11	11	22	0	1	23	0	0
16	25114944	.	T	C	11	13	24	0	2	26	0	0
16	25118688	.	G	A	4	4	8	0	0	8	0	0
16	25120851	.	T	C	4	4	8	0	0	8	0	0
16	25121541	.	G	A	1	3	4	0	0	4	0	0
16	25121607	.	T	C	2	3	5	0	0	5	0	0
16	25121654	.	A	G	3	0	3	0	4	7	0	0
16	25122086	.	G	T	4	4	8	0	0	8	0	0
16	25122193	.	C	T	9	8	17	0	0	17	0	0
16	25122240	.	C	T	8	7	15	0	0	15	0	0
16	25122770	.	T	A	3	11	14	0	1	15	0	0
16	25123129	.	A	G	2	4	6	0	3	9	0	0
16	25123130	.	A	G	2	7	9	0	0	9	0	0
16	25123248	.	G	A	4	5	9	0	0	9	0	0
16	25123424	.	A	G	2	3	5	0	2	7	0	0
16	25123435	.	A	G	2	3	5	0	1	6	0	0
16	25123832	.	A	G	5	5	10	0	0	10	0	0
16	25123843	.	T	A	4	5	9	0	0	9	0	0
16	25123938	.	A	G	6	4	10	0	0	10	0	0
16	25124138	.	T	G	2	4	6	0	0	6	0	0
16	25124163	.	T	G	5	0	5	0	5	10	0	0
16	25124203	.	T	C	3	4	7	0	0	7	0	0
16	25124662	.	G	T	0	3	3	0	1	4	0	0
16	25124763	.	A	T	6	3	9	0	0	9	0	0
16	25124832	.	C	T	4	2	6	0	0	6	0	0
16	25137567	.	A	G	0	3	3	0	0	3	0	0
16	25142125	.	A	G	2	0	2	0	4	6	0	0
16	25146020	.	T	C	0	2	2	0	0	2	0	0
16	25146125	.	G	C	1	2	3	0	0	3	0	0
16	25148559	.	C	T	2	2	4	1	0	5	0	0
16	25148565	.	G	A	0	2	2	1	3	6	0	0
16	25148887	.	G	C	2	2	4	0	0	4	0	0
16	25149076	.	G	A	2	2	4	0	0	4	0	0
16	25149123	.	G	A	1	4	5	0	0	5	0	0
16	25149147	.	C	T	1	5	6	0	0	6	0	0
16	25149164	.	C	A	3	6	9	0	0	9	0	0
16	25149191	.	G	A	5	6	11	0	0	11	0	0
16	25149254	.	G	T	3	3	6	0	0	6	0	0
16	25149466	.	G	A	3	5	8	0	0	8	0	0
16	25149474	.	C	T	3	4	7	0	1	8	0	0
16	25149654	.	T	C	2	3	5	0	0	5	0	0
16	25149705	.	C	A	2	6	8	0	0	8	0	0
16	25149779	.	G	A	7	4	11	0	1	12	0	0
16	25149867	.	A	G	4	0	4	0	5	9	0	0
16	25149878	.	T	C	3	5	8	0	0	8	0	0
16	25149992	.	A	C	6	3	9	0	0	9	0	0
16	25150086	.	T	C	1	5	6	0	0	6	0	0
16	25150087	.	A	C	1	5	6	0	0	6	0	0
16	25150464	.	G	C	0	6	6	0	5	11	0	0
16	25150641	.	C	T	2	3	5	0	0	5	0	0
16	25151012	.	T	C	6	6	12	0	0	12	0	0
16	25151059	.	G	A	0	4	4	0	3	7	0	0
16	25151079	.	A	G	2	0	2	0	3	5	0	0
16	25151419	.	G	A	5	8	13	0	0	13	0	0
16	25151456	.	G	A	2	6	8	0	0	8	0	0
16	25151512	.	G	C	2	4	6	0	0	6	0	0
16	25151554	.	G	T	2	4	6	0	0	6	0	0
16	25157440	.	A	C	1	2	3	0	0	3	0	0
16	25161292	.	A	G	8	6	14	0	0	14	0	0
16	25161315	.	T	C	11	5	16	0	0	16	0	0
16	25161420	.	G	T	1	3	4	0	3	7	0	0
16	25161454	.	A	G	6	2	8	0	0	8	0	0
16	25161739	.	T	C	7	8	15	0	0	15	0	0
16	25161876	.	T	C	9	9	18	0	0	18	0	0
16	25162163	.	G	A	0	3	3	0	1	4	0	0
16	25162514	.	G	A	0	3	3	0	4	7	0	0
16	25162516	.	T	C	4	3	7	0	0	7	0	0
16	25167828	.	T	C	6	6	12	0	0	12	0	0
16	25169003	.	A	G	10	11	21	0	0	21	0	0
16	25169501	.	T	A	1	2	3	0	0	3	0	0
16	25173793	.	C	A	0	3	3	0	1	4	0	0
16	25176546	.	G	A	1	4	5	0	0	5	0	0
16	25177248	.	G	A	0	2	2	0	6	8	0	0
16	25180397	.	A	C	2	3	5	0	0	5	0	0
16	25180485	.	T	C	2	3	5	0	0	5	0	0
16	25180534	.	C	T	2	2	4	0	0	4	0	0
16	25180561	.	C	A	3	4	7	0	0	7	0	0
16	25180642	.	G	A	4	4	8	0	0	8	0	0
16	25180733	.	G	T	1	3	4	0	0	4	0	0
16	25180846	.	T	C	2	2	4	0	0	4	0	0
16	25181046	.	A	G	2	2	4	0	0	4	0	0
16	25181350	.	A	T	1	1	2	0	0	2	0	0
16	25259332	.	T	C	2	3	5	0	0	5	0	0
16	25272148	.	G	T	0	5	5	0	1	6	0	0
16	25272149	.	A	G	1	4	5	0	1	6	0	0
16	25272215	.	C	T	2	3	5	0	0	5	0	0
16	25272268	.	A	T	4	4	8	0	0	8	0	0
16	25272321	.	G	A	1	2	3	0	0	3	0	0
16	25275984	.	C	T	0	12	12	0	14	26	0	0
16	25283378	.	A	G	6	5	11	0	0	11	0	0
16	25283402	.	G	T	3	1	4	0	0	4	0	0
16	25297762	.	C	T	0	0	0	0	1	1	0	0
16	25311654	.	G	A	3	2	5	0	0	5	0	0
16	25314708	.	G	A	1	1	2	0	0	2	0	0
16	25317000	.	G	A	5	9	14	0	2	16	0	0
16	25327155	.	C	A	4	4	8	0	0	8	0	0
16	25327730	.	C	T	2	6	8	0	0	8	0	0
16	25329319	.	C	T	1	1	2	0	0	2	0	0
16	25334326	.	A	G	0	7	7	0	0	7	0	0
16	25334353	.	T	C	5	8	13	0	0	13	0	0
16	25337665	.	T	G	1	9	10	0	1	11	0	0
16	25344051	.	C	A	2	2	4	0	0	4	0	0
16	25344055	.	T	G	2	0	2	0	2	4	0	0
16	25347762	.	G	A	2	7	9	0	0	9	0	0
16	25348038	.	T	C	2	2	4	0	0	4	0	0
16	25348134	.	C	T	2	2	4	0	0	4	0	0
16	25348407	.	T	C	1	2	3	0	0	3	0	0
16	25348683	.	T	C	1	5	6	0	0	6	0	0
16	25349279	.	T	C	2	4	6	0	0	6	0	0
16	25353019	.	C	T	9	3	12	0	0	12	0	0
16	25354336	.	G	A	0	3	3	0	0	3	0	0
16	25357980	.	T	A	4	4	8	0	0	8	0	0
16	25357989	.	C	T	4	3	7	0	1	8	0	0
16	25360557	.	T	A	2	2	4	0	1	5	0	0
16	25360605	.	C	A	2	8	10	0	0	10	0	0
16	25373900	.	A	C	4	6	10	0	1	11	0	0
16	25373924	.	G	A	6	12	18	0	1	19	0	0
16	25373979	.	T	A	4	7	11	0	1	12	0	0
16	25374247	.	G	T	5	6	11	0	0	11	0	0
16	25374365	.	T	C	5	4	9	0	0	9	0	0
16	25374441	.	C	T	0	4	4	0	2	6	0	0
16	25374508	.	T	G	5	5	10	0	0	10	0	0
16	25393277	.	G	T	6	2	8	0	0	8	0	0
16	25395154	.	G	T	2	6	8	0	0	8	0	0
16	25395700	.	A	T	1	5	6	0	0	6	0	0
16	25395702	.	G	T	1	4	5	0	1	6	0	0
16	25399585	.	A	T	3	4	7	0	0	7	0	0
16	25399588	.	A	T	3	4	7	0	0	7	0	0
16	25400055	.	G	C	2	0	2	0	0	2	0	0
16	25407294	.	T	C	2	2	4	0	0	4	0	0
16	25407389	.	G	A	4	3	7	0	1	8	0	0
16	25407426	.	A	T	2	2	4	0	0	4	0	0
16	25407532	.	A	C	2	5	7	0	0	7	0	0
16	25470975	.	A	G	6	3	9	0	0	9	0	0
16	25477398	.	G	C	0	5	5	0	8	13	0	0
16	25477557	.	G	A	6	6	12	0	2	14	0	0
16	25477692	.	G	A	3	1	4	0	3	7	0	0
16	25477788	.	C	T	4	6	10	0	0	10	0	0
16	25487346	.	T	C	3	3	6	0	0	6	0	0
16	25487720	.	A	G	9	7	16	0	0	16	0	0
16	25490833	.	A	G	0	1	1	0	0	1	0	0
16	25500137	.	A	G	2	8	10	0	0	10	0	0
16	25500223	.	T	C	4	5	9	0	1	10	0	0
16	25500293	.	T	A	3	7	10	0	0	10	0	0
16	25504122	.	C	T	0	4	4	0	7	11	0	0
16	25504180	.	C	T	1	9	10	0	9	19	0	0
16	25504315	.	C	T	20	9	29	0	1	30	0	0
16	25504337	.	G	A	14	11	25	0	1	26	0	0
16	25504398	.	A	T	21	11	32	0	0	32	0	0
16	25504537	.	T	C	23	5	28	0	4	32	0	0
16	25504585	.	C	T	21	9	30	0	2	32	0	0
16	25504642	.	G	A	21	21	42	0	1	43	0	0
16	25507392	.	C	T	1	3	4	0	3	7	0	0
16	25507485	.	G	A	14	15	29	0	2	31	0	0
16	25507536	.	G	A	4	3	7	0	1	8	0	0
16	25507582	.	T	A	2	4	6	0	0	6	0	0
16	25507643	.	T	A	4	8	12	0	0	12	0	0
16	25507696	.	T	C	7	3	10	0	0	10	0	0
16	25519635	.	A	G	9	19	28	0	1	29	0	0
16	25527541	.	T	G	1	7	8	0	1	9	0	0
16	25535229	.	C	T	0	8	8	0	7	15	0	0
16	25535283	.	T	C	3	2	5	0	0	5	0	0
16	25555806	.	A	G	12	8	20	0	2	22	0	0
16	25557690	.	C	T	7	8	15	0	1	16	0	0
16	25558007	.	C	G	0	12	12	0	6	18	0	0
16	25558223	.	A	G	5	9	14	0	0	14	0	0
16	25558351	.	C	T	0	8	8	0	4	12	0	0
16	25558484	.	T	C	11	4	15	0	0	15	0	0
16	25558600	.	G	A	14	6	20	0	1	21	0	0
16	25558845	.	G	A	5	6	11	0	0	11	0	0
16	25558986	.	A	G	7	12	19	0	0	19	0	0
16	25559028	.	A	C	11	8	19	0	0	19	0	0
16	25559165	.	A	C	6	3	9	0	1	10	0	0
16	25559193	.	A	G	5	4	9	0	1	10	0	0
16	25559296	.	T	C	1	3	4	0	0	4	0	0
16	25559495	.	T	A	5	5	10	0	0	10	0	0
16	25559643	.	C	T	3	2	5	0	0	5	0	0
16	25559743	.	A	T	6	4	10	0	0	10	0	0
16	25560265	.	G	A	4	6	10	0	0	10	0	0
16	25560586	.	A	G	1	4	5	0	0	5	0	0
16	25560715	.	T	C	1	2	3	0	0	3	0	0
16	25560863	.	C	T	7	4	11	0	0	11	0	0
16	25561001	.	A	C	5	3	8	0	0	8	0	0
16	25561011	.	A	T	5	3	8	0	1	9	0	0
16	25561175	.	A	G	3	7	10	0	0	10	0	0
16	25561471	.	C	G	0	2	2	0	6	8	0	0
16	25561630	.	C	T	11	3	14	0	0	14	0	0
16	25561699	.	T	C	6	5	11	0	1	12	0	0
16	25561714	.	A	G	6	6	12	0	1	13	0	0
16	25563354	.	A	G	2	6	8	0	0	8	0	0
16	25567951	.	T	G	2	1	3	0	0	3	0	0
16	25568130	.	G	A	13	5	18	0	2	20	0	0
16	25593973	.	G	A	12	4	16	0	0	16	0	0
16	25594415	.	C	T	4	2	6	0	0	6	0	0
16	25597492	.	A	G	5	4	9	0	1	10	0	0
16	25641050	.	G	A	13	10	23	0	1	24	0	0
16	25642713	.	T	A	14	14	28	0	1	29	0	0
16	25642848	.	C	A	6	6	12	0	8	20	0	0
16	25643818	.	G	T	7	6	13	0	2	15	0	0
16	25673880	.	T	C	6	7	13	0	0	13	0	0
16	25683018	.	T	C	7	5	12	0	0	12	0	0
16	25683152	.	A	T	7	11	18	0	0	18	0	0
16	25683440	.	G	T	9	8	17	0	2	19	0	0
16	25688709	.	C	A	3	3	6	0	0	6	0	0
16	25697956	.	C	A	3	2	5	0	0	5	0	0
16	25697971	.	A	T	4	5	9	0	0	9	0	0
16	25698045	.	G	A	1	9	10	0	0	10	0	0
16	25698449	.	A	C	6	6	12	0	1	13	0	0
16	26021245	.	A	G	9	9	18	0	0	18	0	0
16	26027081	.	G	T	15	14	29	0	2	31	0	0
16	26027158	.	A	T	29	10	39	0	11	50	0	0
16	26030380	.	T	A	16	11	27	0	0	27	0	0
16	26039945	.	C	T	0	1	1	0	1	2	0	0
16	26046772	.	A	G	2	0	2	0	0	2	0	0
16	26141290	.	G	T	5	4	9	0	0	9	0	0
16	26141295	.	T	A	4	4	8	0	0	8	0	0
16	26141395	.	C	A	5	2	7	0	0	7	0	0
16	26141396	.	T	C	5	0	5	0	2	7	0	0
16	26141599	.	T	A	1	8	9	0	0	9	0	0
16	26141665	.	T	C	4	4	8	0	0	8	0	0
16	26141817	.	T	G	8	7	15	0	0	15	0	0
16	26142209	.	C	T	4	2	6	0	1	7	0	0
16	26142703	.	A	T	7	9	16	0	1	17	0	0
16	26151592	.	G	A	1	0	1	0	0	1	0	0
16	26157099	.	G	A	2	1	3	0	0	3	0	0
16	26167733	.	G	A	1	0	1	0	0	1	0	0
16	26169515	.	T	G	2	1	3	0	0	3	0	0
16	26186178	.	C	A	4	0	4	0	0	4	0	0
16	26234291	.	G	A	2	2	4	0	0	4	0	0
16	26234381	.	G	A	1	3	4	0	0	4	0	0
16	26234401	.	A	G	1	2	3	0	0	3	0	0
16	26234732	.	T	C	2	2	4	0	0	4	0	0
16	26234772	.	T	C	4	6	10	0	0	10	0	0
16	26235461	.	A	G	3	3	6	0	0	6	0	0
16	26235510	.	C	A	0	2	2	0	4	6	0	0
16	26235539	.	C	A	3	2	5	0	0	5	0	0
16	26236263	.	G	A	2	2	4	0	0	4	0	0
16	26236664	.	C	A	2	3	5	0	1	6	0	0
16	26236942	.	T	C	2	2	4	0	0	4	0	0
16	26236947	.	G	A	1	2	3	0	0	3	0	0
16	26237122	.	T	C	1	5	6	0	2	8	0	0
16	26237501	.	A	T	5	4	9	0	0	9	0	0
16	26381538	.	T	C	5	8	13	0	0	13	0	0
16	26384219	.	G	A	3	8	11	0	1	12	0	0
16	26413746	.	T	C	2	0	2	0	1	3	0	0
16	26437569	.	T	C	1	3	4	0	0	4	0	0
16	26439576	.	A	G	0	3	3	0	0	3	0	0
16	26439860	.	T	C	3	3	6	0	0	6	0	0
16	26441526	.	T	A	2	3	5	0	0	5	0	0
16	26441532	.	T	C	2	3	5	0	1	6	0	0
16	26441561	.	G	A	2	2	4	0	0	4	0	0
16	26444480	.	C	T	4	4	8	0	0	8	0	0
16	26444541	.	G	T	9	5	14	0	1	15	0	0
16	26444569	.	A	T	6	4	10	0	0	10	0	0
16	26444634	.	G	T	6	2	8	0	0	8	0	0
16	26444644	.	A	T	5	2	7	0	0	7	0	0
16	26445032	.	C	T	6	5	11	0	0	11	0	0
16	26445069	.	A	T	3	5	8	0	0	8	0	0
16	26445458	.	T	C	0	4	4	0	0	4	0	0
16	26445676	.	A	G	1	0	1	0	6	7	0	0
16	26445990	.	G	A	2	8	10	0	0	10	0	0
16	26446005	.	G	A	2	5	7	0	0	7	0	0
16	26483122	.	C	A	0	1	1	0	0	1	0	0
16	26510997	.	G	A	5	6	11	0	0	11	0	0
16	26516813	.	G	C	3	5	8	0	0	8	0	0
16	26631418	.	A	G	2	0	2	0	2	4	0	0
16	26634530	.	T	A	5	4	9	0	1	10	0	0
16	26689955	.	T	C	4	0	4	0	0	4	0	0
16	26691240	.	G	A	1	3	4	0	0	4	0	0
16	26691475	.	G	A	6	5	11	0	1	12	0	0
16	26691646	.	T	C	2	4	6	0	0	6	0	0
16	26691665	.	C	T	3	3	6	0	0	6	0	0
16	26696120	.	G	C	2	2	4	0	0	4	0	0
16	26698589	.	G	A	1	5	6	0	1	7	0	0
16	26702745	.	T	C	10	7	17	0	2	19	0	0
16	26702870	.	T	C	6	13	19	0	1	20	0	0
16	26703111	.	T	C	8	7	15	0	1	16	0	0
16	26706551	.	G	A	2	3	5	0	0	5	0	0
16	26706584	.	G	A	3	3	6	0	0	6	0	0
16	26706623	.	T	C	1	0	1	0	0	1	0	0
16	26706840	.	T	A	5	3	8	0	1	9	0	0
16	26710777	.	G	A	1	7	8	0	12	20	0	0
16	26710798	.	C	T	13	10	23	0	3	26	0	0
16	26710900	.	C	A	14	12	26	0	0	26	0	0
16	26710954	.	A	T	12	11	23	0	0	23	0	0
16	26710969	.	C	A	12	10	22	0	0	22	0	0
16	26713964	.	G	T	12	12	24	0	0	24	0	0
16	26766657	.	A	G	1	3	4	0	0	4	0	0
16	26766807	.	A	G	3	2	5	0	0	5	0	0
16	26768803	.	A	G	5	5	10	0	0	10	0	0
16	26769167	.	T	G	1	2	3	0	0	3	0	0
16	26816806	.	G	T	7	4	11	0	0	11	0	0
16	26816885	.	A	G	5	2	7	0	0	7	0	0
16	26816962	.	C	T	4	4	8	0	1	9	0	0
16	26817304	.	T	C	7	0	7	0	5	12	0	0
16	26817556	.	T	C	5	0	5	0	7	12	0	0
16	26817754	.	C	T	0	5	5	0	2	7	0	0
16	26817922	.	T	C	2	0	2	0	3	5	0	0
16	26818213	.	A	T	2	3	5	0	0	5	0	0
16	26818703	.	A	T	0	1	1	0	1	2	0	0
16	26850694	.	C	T	1	5	6	0	0	6	0	0
16	26850845	.	T	C	6	10	16	0	1	17	0	0
16	26850870	.	G	A	5	13	18	0	0	18	0	0
16	26850885	.	C	T	4	13	17	0	1	18	0	0
16	26851025	.	C	G	1	4	5	0	0	5	0	0
16	26851071	.	C	A	2	6	8	0	1	9	0	0
16	26851149	.	T	C	4	5	9	0	0	9	0	0
16	26851191	.	C	T	6	6	12	0	0	12	0	0
16	26863604	.	A	C	6	5	11	0	0	11	0	0
16	26863622	.	T	C	5	5	10	0	0	10	0	0
16	26994555	.	T	C	1	2	3	0	0	3	0	0
16	26994564	.	G	T	1	3	4	0	0	4	0	0
16	26994618	.	A	G	3	4	7	0	0	7	0	0
16	27025096	.	T	C	6	8	14	0	0	14	0	0
16	27061912	.	A	C	6	8	14	0	1	15	0	0
16	27069527	.	C	T	2	3	5	0	0	5	0	0
16	27072464	.	C	T	4	6	10	0	0	10	0	0
16	27089100	.	T	G	4	6	10	0	1	11	0	0
16	27098530	.	A	G	7	12	19	0	0	19	0	0
16	27098549	.	A	T	6	7	13	0	1	14	0	0
16	27098719	.	G	T	4	6	10	0	0	10	0	0
16	27098806	.	G	A	8	12	20	0	0	20	0	0
16	27099069	.	A	C	2	3	5	0	0	5	0	0
16	27099121	.	A	T	2	6	8	0	0	8	0	0
16	27099214	.	C	G	2	3	5	0	0	5	0	0
16	27099323	.	G	A	0	11	11	0	10	21	0	0
16	27099506	.	C	T	5	5	10	0	0	10	0	0
16	27100133	.	A	C	9	4	13	0	0	13	0	0
16	27100139	.	A	T	9	6	15	0	0	15	0	0
16	27100198	.	T	A	13	11	24	0	0	24	0	0
16	27126615	.	G	A	13	13	26	0	1	27	0	0
16	27126695	.	G	T	12	16	28	0	1	29	0	0
16	27126849	.	C	T	15	6	21	0	2	23	0	0
16	27126998	.	A	G	4	11	15	0	1	16	0	0
16	27126999	.	T	A	4	12	16	0	0	16	0	0
16	27127046	.	A	T	9	16	25	0	0	25	0	0
16	27127157	.	G	C	15	14	29	0	0	29	0	0
16	27127158	.	C	A	15	14	29	0	0	29	0	0
16	27127281	.	T	G	11	7	18	0	2	20	0	0
16	27127497	.	T	A	9	14	23	0	0	23	0	0
16	27127643	.	T	C	15	1	16	1	19	36	0	0
16	27138391	.	C	G	3	1	4	0	1	5	0	0
16	27148864	.	G	T	0	1	1	0	0	1	0	0
16	27158753	.	T	C	9	4	13	0	0	13	0	0
16	27159111	.	A	G	1	1	2	0	0	2	0	0
16	27159205	.	T	C	2	0	2	0	0	2	0	0
16	27161327	.	A	T	6	6	12	0	2	14	0	0
16	27166174	.	A	G	11	9	20	0	0	20	0	0
16	27166205	.	A	G	11	12	23	0	2	25	0	0
16	27166277	.	G	A	11	13	24	0	0	24	0	0
16	27169529	.	G	A	13	12	25	0	1	26	0	0
16	27169586	.	G	A	8	14	22	0	1	23	0	0
16	27169809	.	G	A	1	4	5	0	0	5	0	0
16	27170170	.	G	A	0	2	2	0	0	2	0	0
16	27216398	.	G	T	2	2	4	0	0	4	0	0
16	27216419	.	C	A	2	2	4	0	0	4	0	0
16	27231410	.	G	A	25	21	46	0	5	51	0	0
16	27231469	.	T	G	18	19	37	0	1	38	0	0
16	27231589	.	T	G	0	1	1	0	2	3	0	0
16	27231594	.	T	G	0	1	1	0	2	3	0	0
16	27345748	.	C	T	4	5	9	0	1	10	0	0
16	27346195	.	T	C	2	1	3	0	0	3	0	0
16	27354984	.	T	G	3	5	8	0	0	8	0	0
16	27354985	.	C	A	3	5	8	0	0	8	0	0
16	27363079	.	G	A	5	3	8	0	0	8	0	0
16	27363205	.	G	A	1	3	4	0	4	8	0	0
16	27367624	.	A	G	4	2	6	0	0	6	0	0
16	27367695	.	T	C	10	12	22	0	0	22	0	0
16	27368086	.	T	C	5	8	13	0	0	13	0	0
16	27368168	.	A	G	10	0	10	0	8	18	0	0
16	27368516	.	C	T	10	9	19	0	0	19	0	0
16	27368577	.	A	G	5	16	21	0	0	21	0	0
16	27368705	.	C	T	8	10	18	0	1	19	0	0
16	27368756	.	A	G	4	2	6	0	1	7	0	0
16	27369057	.	T	C	9	7	16	0	1	17	0	0
16	27383777	.	G	C	1	2	3	0	0	3	0	0
16	27383789	.	C	T	0	2	2	0	0	2	0	0
16	27383813	.	G	C	0	2	2	0	0	2	0	0
16	27417573	.	T	C	8	9	17	0	1	18	0	0
16	27427109	.	T	C	3	0	3	0	0	3	0	0
16	27427919	.	A	G	6	7	13	0	1	14	0	0
16	27510736	.	C	A	2	4	6	0	7	13	0	0
16	27543577	.	G	T	0	1	1	0	0	1	0	0
16	27543963	.	A	G	1	5	6	0	0	6	0	0
16	27547540	.	A	C	2	2	4	0	0	4	0	0
16	27547545	.	A	T	2	2	4	0	0	4	0	0
16	27550215	.	G	A	2	3	5	0	1	6	0	0
16	27555175	.	T	C	15	7	22	0	1	23	0	0
16	27555362	.	C	T	2	6	8	0	1	9	0	0
16	27567568	.	T	C	2	2	4	0	0	4	0	0
16	27569881	.	A	G	0	1	1	0	0	1	0	0
16	27571114	.	G	A	1	2	3	0	0	3	0	0
16	27571147	.	A	T	0	1	1	0	0	1	0	0
16	27573776	.	C	T	2	0	2	0	0	2	0	0
16	27581100	.	T	C	0	1	1	0	0	1	0	0
16	27615102	.	C	T	5	12	17	0	1	18	0	0
16	27615184	.	A	T	12	12	24	0	0	24	0	0
16	27615203	.	A	G	10	11	21	0	2	23	0	0
16	27617046	.	C	T	3	4	7	0	0	7	0	0
16	27617130	.	C	T	3	4	7	0	0	7	0	0
16	27621645	.	A	T	10	12	22	0	2	24	0	0
16	27621780	.	A	C	6	11	17	0	0	17	0	0
16	27621830	.	T	G	12	10	22	0	0	22	0	0
16	27621869	.	A	G	9	11	20	0	0	20	0	0
16	27621897	.	A	T	8	11	19	0	0	19	0	0
16	27626228	.	G	A	3	2	5	0	0	5	0	0
16	27626566	.	G	T	25	27	52	0	0	52	0	0
16	27627051	.	T	C	1	0	1	0	0	1	0	0
16	27629052	.	C	T	29	11	40	0	3	43	0	0
16	27629212	.	C	T	0	3	3	0	0	3	0	0
16	27629220	.	T	C	0	1	1	0	0	1	0	0
16	27629455	.	T	G	25	19	44	0	0	45	1	0
16	27629483	.	G	A	22	21	43	0	1	44	0	0
16	27629713	.	T	C	23	16	39	0	1	40	0	0
16	27630087	.	C	T	0	20	20	0	19	39	0	0
16	27630174	.	A	T	21	13	34	0	2	36	0	0
16	27630209	.	T	C	18	18	36	0	0	36	0	0
16	27630294	.	G	A	15	20	35	0	3	38	0	0
16	27630399	.	G	T	24	16	40	0	2	42	0	0
16	27630785	.	G	A	14	14	28	0	1	29	0	0
16	27630998	.	T	C	11	0	11	0	8	19	0	0
16	27631061	.	G	A	8	14	22	0	0	22	0	0
16	27631768	.	G	A	16	12	28	0	2	30	0	0
16	27632289	.	C	T	12	13	25	0	1	26	0	0
16	27632705	.	G	A	7	15	22	0	0	22	0	0
16	27632879	.	T	C	6	12	18	0	1	19	0	0
16	27632880	.	G	A	7	12	19	0	0	19	0	0
16	27633002	.	G	A	5	7	12	0	0	12	0	0
16	27633089	.	A	G	2	12	14	0	2	16	0	0
16	27633940	.	C	G	5	12	17	0	1	18	0	0
16	27640955	.	C	A	0	6	6	0	8	14	0	0
16	27640979	.	G	A	6	6	12	0	0	12	0	0
16	27660103	.	T	C	2	3	5	0	0	5	0	0
16	27660104	.	A	C	2	3	5	0	0	5	0	0
16	27660144	.	T	C	8	3	11	0	0	11	0	0
16	27660196	.	A	T	6	5	11	0	0	11	0	0
16	27660219	.	G	T	5	3	8	0	0	9	1	0
16	27660548	.	A	G	2	2	4	0	0	4	0	0
16	27660750	.	C	T	0	5	5	0	9	14	0	0
16	27660781	.	G	A	10	3	13	0	0	13	0	0
16	27660868	.	A	G	5	5	10	0	2	12	0	0
16	27660934	.	C	T	3	4	7	0	2	9	0	0
16	27667213	.	G	A	1	2	3	0	0	3	0	0
16	27667312	.	G	T	0	1	1	0	0	1	0	0
16	27669912	.	T	C	4	0	4	0	3	7	0	0
16	27674156	.	A	G	5	1	6	0	0	6	0	0
16	27675763	.	C	T	0	3	3	0	3	6	0	0
16	27675865	.	A	C	2	2	4	0	0	4	0	0
16	27736518	.	T	G	0	3	3	0	1	4	0	0
16	27736537	.	C	T	0	3	3	0	0	3	0	0
16	28112951	.	C	A	1	5	6	0	1	7	0	0
16	28112989	.	C	T	4	7	11	0	0	11	0	0
16	28113033	.	C	T	0	4	4	0	8	12	0	0
16	28113049	.	G	A	5	2	7	0	0	7	0	0
16	28256806	.	G	A	1	4	5	0	0	5	0	0
16	28263526	.	G	A	5	3	8	0	0	8	0	0
16	28263597	.	C	A	1	3	4	0	0	4	0	0
16	28265687	.	T	C	0	1	1	0	0	1	0	0
16	28270067	.	G	T	0	2	2	0	2	4	0	0
16	28270118	.	C	T	4	3	7	0	0	7	0	0
16	28270157	.	C	A	2	3	5	0	0	5	0	0
16	28270258	.	T	G	4	0	4	0	5	9	0	0
16	28270443	.	T	C	5	2	7	0	1	8	0	0
16	28270561	.	C	T	7	5	12	0	0	12	0	0
16	28270695	.	G	A	1	3	4	0	1	5	0	0
16	28270709	.	C	A	1	3	4	0	1	5	0	0
16	28276383	.	T	C	4	5	9	0	0	9	0	0
16	28276389	.	C	T	4	5	9	0	0	9	0	0
16	28276455	.	C	T	1	12	13	0	1	14	0	0
16	28277340	.	C	G	5	9	14	0	0	14	0	0
16	28277385	.	G	C	3	3	6	0	0	6	0	0
16	28278345	.	T	C	1	0	1	0	0	1	0	0
16	28278360	.	T	C	1	0	1	0	0	1	0	0
16	28278387	.	C	T	1	0	1	0	0	1	0	0
16	28309479	.	A	T	0	0	0	0	1	1	0	0
16	28313822	.	G	A	3	2	5	0	0	5	0	0
16	28313823	.	G	A	2	2	4	0	1	5	0	0
16	28370465	.	C	T	12	20	32	0	1	33	0	0
16	28370513	.	G	C	11	22	33	0	0	33	0	0
16	28370566	.	A	C	12	11	23	0	1	24	0	0
16	28370703	.	A	G	5	3	8	0	0	8	0	0
16	28370943	.	A	T	9	8	17	0	1	18	0	0
16	28371138	.	T	C	5	7	12	0	0	12	0	0
16	28371148	.	A	G	6	9	15	0	1	16	0	0
16	28547195	.	A	T	0	2	2	0	1	3	0	0
16	28554272	.	C	T	1	1	2	0	0	2	0	0
16	28554359	.	G	A	4	2	6	0	0	6	0	0
16	28573333	.	C	T	6	2	8	0	0	8	0	0
16	28573514	.	T	C	7	4	11	0	1	12	0	0
16	28573574	.	G	A	1	6	7	0	5	12	0	0
16	28573634	.	C	T	4	10	14	0	1	15	0	0
16	28573795	.	G	A	0	7	7	0	7	14	0	0
16	28574063	.	C	T	6	2	8	0	1	9	0	0
16	28574403	.	C	T	7	7	14	0	0	14	0	0
16	28574465	.	G	A	0	5	5	0	5	10	0	0
16	28580884	.	T	C	0	4	4	0	0	4	0	0
16	28581874	.	A	C	7	5	12	0	0	12	0	0
16	28591305	.	A	T	18	10	28	0	0	28	0	0
16	28591363	.	G	A	19	9	28	0	0	28	0	0
16	28591459	.	G	A	1	10	11	0	7	18	0	0
16	28592946	.	G	A	6	6	12	0	0	12	0	0
16	28593242	.	A	G	5	2	7	0	0	7	0	0
16	28593802	.	T	C	9	5	14	0	0	14	0	0
16	28593867	.	T	C	4	0	4	0	8	12	0	0
16	28598780	.	T	A	30	14	44	0	3	47	0	0
16	28598790	.	A	T	29	12	41	0	2	43	0	0
16	28598846	.	G	T	1	10	11	0	7	18	0	0
16	28598979	.	A	C	7	10	17	1	1	19	0	0
16	28603517	.	T	A	1	1	2	0	0	2	0	0
16	28620777	.	A	G	0	0	0	0	1	1	0	0
16	28624648	.	G	C	0	4	4	0	5	9	0	0
16	28626790	.	C	A	3	3	6	0	1	7	0	0
16	28626843	.	G	A	6	3	9	0	0	9	0	0
16	28626844	.	G	T	6	3	9	0	0	9	0	0
16	28627127	.	C	T	6	3	9	0	1	10	0	0
16	28627178	.	A	G	2	2	4	0	0	4	0	0
16	28627240	.	G	A	7	3	10	0	0	10	0	0
16	28627341	.	T	G	3	7	10	0	0	10	0	0
16	28627342	.	T	A	3	7	10	0	0	10	0	0
16	28627383	.	T	G	3	4	7	0	0	7	0	0
16	28627385	.	T	A	2	2	4	0	3	7	0	0
16	28627485	.	C	T	1	2	3	0	1	4	0	0
16	28627522	.	G	T	1	2	3	0	0	3	0	0
16	28629285	.	C	A	7	8	15	0	1	16	0	0
16	28632525	.	C	T	2	9	11	0	0	11	0	0
16	28638364	.	C	T	0	3	3	0	1	4	0	0
16	28649795	.	G	A	1	1	2	0	0	2	0	0
16	28663339	.	G	C	3	2	5	0	1	6	0	0
16	28664720	.	A	C	2	7	9	0	0	9	0	0
16	28664721	.	C	T	2	7	9	0	0	9	0	0
16	28664818	.	A	T	3	3	6	0	0	6	0	0
16	28664833	.	C	T	3	4	7	0	0	7	0	0
16	28665062	.	C	T	2	2	4	0	0	4	0	0
16	28666016	.	C	G	1	6	7	0	0	7	0	0
16	28667313	.	A	T	2	0	2	0	0	2	0	0
16	28671513	.	G	T	1	1	2	0	0	2	0	0
16	28674339	.	C	T	1	0	1	0	0	1	0	0
16	28678327	.	T	C	0	0	0	0	3	3	0	0
16	28681493	.	T	G	1	3	4	0	0	4	0	0
16	28842438	.	C	T	16	26	42	0	2	44	0	0
16	28846595	.	G	T	16	16	32	0	1	33	0	0
16	28846647	.	G	T	18	14	32	0	0	32	0	0
16	28846761	.	T	C	11	7	18	0	1	19	0	0
16	28855946	.	C	G	14	4	18	0	1	19	0	0
16	28856026	.	G	A	16	18	34	0	1	35	0	0
16	28856034	.	G	A	13	19	32	0	0	32	0	0
16	28882411	.	A	C	1	2	3	0	0	3	0	0
16	28983897	.	G	A	1	0	1	0	0	1	0	0
16	28983936	.	T	C	2	2	4	0	0	4	0	0
16	28983939	.	C	T	2	2	4	0	0	4	0	0
16	28986722	.	A	G	1	2	3	0	0	3	0	0
16	28986728	.	C	T	1	3	4	0	0	4	0	0
16	29009092	.	G	T	4	4	8	0	0	8	0	0
16	29010059	.	G	T	1	1	2	0	0	2	0	0
16	29010293	.	T	G	2	0	2	0	0	2	0	0
16	29010819	.	A	G	1	2	3	0	0	3	0	0
16	29012961	.	C	T	10	3	13	0	1	14	0	0
16	29013126	.	C	T	6	4	10	0	0	10	0	0
16	29013134	.	C	A	7	5	12	0	0	12	0	0
16	29013188	.	C	T	5	4	9	0	0	9	0	0
16	29013327	.	C	A	4	2	6	0	0	6	0	0
16	29013377	.	C	T	6	6	12	0	1	13	0	0
16	29014091	.	A	T	2	7	9	0	0	9	0	0
16	29014109	.	T	C	3	6	9	0	0	9	0	0
16	29017221	.	T	C	5	5	10	0	1	11	0	0
16	29019039	.	G	A	8	9	17	0	0	17	0	0
16	29020482	.	G	T	3	4	7	0	0	7	0	0
16	29022955	.	C	A	6	7	13	0	1	14	0	0
16	29022963	.	A	G	6	6	12	0	1	13	0	0
16	29023266	.	A	T	2	3	5	0	0	5	0	0
16	29024181	.	A	G	3	2	5	0	0	5	0	0
16	29024280	.	T	G	5	0	5	0	7	12	0	0
16	29024341	.	T	C	1	3	4	0	0	4	0	0
16	29024405	.	C	T	4	4	8	0	0	8	0	0
16	29024409	.	C	T	5	4	9	0	0	9	0	0
16	29029444	.	G	A	2	6	8	0	0	8	0	0
16	29029476	.	A	G	2	3	5	0	0	5	0	0
16	29029575	.	T	C	4	2	6	0	0	6	0	0
16	29029593	.	G	A	3	1	4	0	1	5	0	0
16	29030235	.	A	G	1	3	4	0	0	4	0	0
16	29030364	.	A	G	1	0	1	0	3	4	0	0
16	29030383	.	G	C	1	3	4	0	0	4	0	0
16	29052001	.	T	A	3	2	5	0	0	5	0	0
16	29052030	.	C	T	3	5	8	0	1	9	0	0
16	29052653	.	A	T	6	2	8	0	1	9	0	0
16	29052752	.	C	G	5	0	5	0	3	8	0	0
16	29052914	.	G	A	7	3	10	0	0	10	0	0
16	29052991	.	C	T	2	3	5	0	0	5	0	0
16	29053045	.	T	A	5	4	9	0	0	9	0	0
16	29053166	.	A	G	4	5	9	0	0	9	0	0
16	29053781	.	A	T	9	10	19	0	1	20	0	0
16	29053798	.	C	G	12	0	12	0	12	24	0	0
16	29053923	.	C	A	2	1	3	0	1	4	0	0
16	29073092	.	T	A	6	3	9	0	0	9	0	0
16	29073539	.	C	T	15	9	24	0	5	29	0	0
16	29073621	.	T	A	6	4	10	0	0	10	0	0
16	29074254	.	G	A	24	20	44	0	3	47	0	0
16	29074535	.	A	G	14	18	32	0	0	32	0	0
16	29074688	.	A	G	22	16	38	0	2	40	0	0
16	29075222	.	T	A	11	11	22	0	5	27	0	0
16	29075343	.	G	A	15	17	32	0	3	35	0	0
16	29075674	.	C	A	17	12	29	0	2	31	0	0
16	29075715	.	C	A	17	5	22	0	2	24	0	0
16	29075757	.	A	G	10	9	19	0	1	20	0	0
16	29075870	.	G	T	13	15	28	0	1	29	0	0
16	29075959	.	C	T	7	12	19	0	2	21	0	0
16	29076009	.	T	A	14	10	24	0	1	25	0	0
16	29076019	.	A	C	14	10	24	0	0	24	0	0
16	29076407	.	C	T	0	22	22	0	22	44	0	0
16	29076575	.	C	G	1	22	23	0	20	43	0	0
16	29076633	.	G	A	16	16	32	0	0	32	0	0
16	29076669	.	A	G	5	6	11	0	2	13	0	0
16	29076678	.	T	C	3	0	3	0	5	8	0	0
16	29091699	.	T	C	10	9	19	0	0	19	0	0
16	29111066	.	T	C	10	1	11	0	20	31	0	0
16	29146310	.	A	G	12	6	18	0	1	19	0	0
16	29146623	.	G	A	4	6	10	0	0	10	0	0
16	29146646	.	A	G	1	0	1	0	0	1	0	0
16	29194443	.	A	G	9	7	16	0	1	17	0	0
16	29222033	.	T	C	12	18	30	0	1	31	0	0
16	29222167	.	G	A	1	4	5	0	0	5	0	0
16	29225752	.	A	G	1	4	5	0	0	5	0	0
16	29225763	.	A	G	1	5	6	0	0	6	0	0
16	29225902	.	G	C	5	12	17	0	0	17	0	0
16	29226151	.	C	T	2	4	6	0	0	6	0	0
16	29226241	.	A	T	1	2	3	0	0	3	0	0
16	29226538	.	G	T	5	4	9	0	0	9	0	0
16	29226566	.	T	C	3	6	9	0	0	9	0	0
16	29266115	.	G	A	1	2	3	0	0	3	0	0
16	29266140	.	A	C	2	2	4	0	0	4	0	0
16	29266533	.	A	G	3	2	5	0	1	6	0	0
16	29266610	.	C	T	3	2	5	0	0	5	0	0
16	29306983	.	T	C	3	2	5	0	0	5	0	0
16	29307100	.	G	C	3	2	5	0	0	5	0	0
16	29310281	.	C	G	14	11	25	0	1	26	0	0
16	29310455	.	C	T	13	9	22	0	0	22	0	0
16	29310530	.	C	A	19	12	31	0	1	32	0	0
16	29310541	.	A	G	18	11	29	0	2	31	0	0
16	29311367	.	C	A	17	6	23	0	0	23	0	0
16	29311489	.	A	G	24	11	35	0	1	36	0	0
16	29314147	.	C	A	1	2	3	0	0	3	0	0
16	29320647	.	A	G	8	3	11	0	0	11	0	0
16	29320870	.	T	C	9	0	9	0	3	12	0	0
16	29321310	.	C	T	5	4	9	0	1	10	0	0
16	29323865	.	G	A	10	2	12	0	2	14	0	0
16	29324825	.	G	T	8	3	11	0	0	11	0	0
16	29324828	.	T	C	7	2	9	0	2	11	0	0
16	29325232	.	A	G	2	1	3	0	1	4	0	0
16	29330513	.	A	G	4	3	7	0	0	7	0	0
16	29330712	.	A	G	1	4	5	0	0	5	0	0
16	29377838	.	G	A	2	1	3	0	0	3	0	0
16	29377848	.	A	T	1	2	3	0	0	3	0	0
16	29380846	.	C	G	1	2	3	0	0	3	0	0
16	29380991	.	C	T	1	2	3	0	2	5	0	0
16	29381123	.	G	A	0	2	2	0	4	6	0	0
16	29381125	.	A	G	4	2	6	0	0	6	0	0
16	29383834	.	A	C	1	1	2	0	0	2	0	0
16	29384090	.	T	C	3	5	8	0	0	8	0	0
16	29384099	.	T	A	4	5	9	0	1	10	0	0
16	29384139	.	G	A	2	7	9	0	0	9	0	0
16	29384182	.	C	T	1	4	5	0	1	6	0	0
16	29384187	.	T	C	1	5	6	0	0	6	0	0
16	29408060	.	T	C	25	36	61	0	2	63	0	0
16	29408172	.	T	A	31	39	70	0	0	70	0	0
16	29408926	.	A	T	21	20	41	0	0	41	0	0
16	29409181	.	T	A	2	3	5	0	0	5	0	0
16	29409219	.	A	G	2	3	5	0	0	5	0	0
16	29409361	.	T	C	26	13	39	0	2	41	0	0
16	29409476	.	T	C	28	17	45	0	3	48	0	0
16	29409480	.	T	C	26	18	44	0	2	46	0	0
16	29409533	.	T	G	17	12	29	0	1	30	0	0
16	29409544	.	T	C	19	11	30	0	0	30	0	0
16	29409732	.	T	G	22	25	47	0	0	48	1	0
16	29409876	.	T	C	28	13	41	0	1	42	0	0
16	29409918	.	T	G	19	21	40	0	1	41	0	0
16	29410032	.	A	G	17	13	30	0	1	31	0	0
16	29410033	.	G	A	18	12	30	0	1	31	0	0
16	29410107	.	A	C	21	32	53	0	2	55	0	0
16	29410129	.	C	T	20	36	56	0	0	56	0	0
16	29410251	.	T	A	22	10	32	0	4	36	0	0
16	29410418	.	C	T	0	25	25	0	26	51	0	0
16	29410425	.	A	G	23	25	48	0	2	50	0	0
16	29410620	.	T	C	17	0	17	0	8	25	0	0
16	29410679	.	T	G	9	17	26	0	0	26	0	0
16	29410921	.	G	A	21	24	45	0	0	45	0	0
16	29411196	.	A	G	22	23	45	0	1	46	0	0
16	29411436	.	G	C	22	15	37	0	3	40	0	0
16	29411646	.	G	A	16	12	28	0	1	29	0	0
16	29411741	.	T	A	6	19	25	0	0	25	0	0
16	29411830	.	T	G	2	8	10	0	1	11	0	0
16	29412074	.	T	A	11	8	19	0	2	21	0	0
16	29412264	.	T	A	3	2	5	0	0	5	0	0
16	29413166	.	C	T	18	23	41	0	2	43	0	0
16	29424985	.	T	A	10	10	20	0	0	20	0	0
16	29431617	.	A	G	7	2	9	0	0	10	1	0
16	29456630	.	A	C	2	0	2	0	2	4	0	0
16	29457158	.	A	G	12	6	18	0	0	18	0	0
16	29457320	.	T	C	8	0	8	0	9	17	0	0
16	29457819	.	C	T	0	7	7	0	6	13	0	0
16	29457866	.	A	G	5	5	10	0	0	10	0	0
16	29458226	.	C	G	7	4	11	0	0	11	0	0
16	29458388	.	T	C	4	0	4	0	8	12	0	0
16	29458403	.	A	G	2	7	9	0	0	9	0	0
16	29461000	.	T	A	2	2	4	0	0	4	0	0
16	30268764	.	A	G	20	7	27	0	2	29	0	0
16	30268767	.	A	G	19	8	27	0	2	29	0	0
16	30423224	.	T	C	8	0	8	0	3	11	0	0
16	30612308	.	T	C	1	2	3	0	0	3	0	0
16	31516778	.	A	G	3	2	5	0	1	6	0	0
16	31602170	.	A	G	2	1	3	0	0	3	0	0
16	31608012	.	A	G	2	5	7	0	0	7	0	0
16	31608101	.	C	T	0	5	5	0	6	11	0	0
16	31608967	.	G	T	2	3	5	0	0	5	0	0
16	31609241	.	C	T	0	4	4	0	3	7	0	0
16	31610375	.	C	T	0	2	2	0	0	2	0	0
16	31614272	.	C	G	1	0	1	0	0	1	0	0
16	31614918	.	G	A	3	3	6	0	0	6	0	0
16	31615114	.	G	A	8	4	12	0	0	12	0	0
16	31717646	.	G	A	2	3	5	0	1	6	0	0
16	31728309	.	G	A	0	1	1	0	0	1	0	0
16	31762960	.	C	T	16	10	26	0	0	26	0	0
16	31763316	.	T	C	16	10	26	0	1	27	0	0
16	31763318	.	C	T	16	9	25	0	2	27	0	0
16	31763668	.	C	G	6	18	24	0	2	26	0	0
16	31763743	.	T	A	19	15	34	0	0	34	0	0
16	31763751	.	A	C	20	13	33	0	1	34	0	0
16	31763785	.	G	A	13	20	33	0	1	34	0	0
16	31763786	.	C	A	11	19	30	0	4	34	0	0
16	31763880	.	A	G	21	17	38	0	1	39	0	0
16	31764987	.	C	T	4	0	4	0	0	4	0	0
16	31766937	.	T	A	1	2	3	0	0	3	0	0
16	31767116	.	T	C	9	0	9	0	6	15	0	0
16	31767152	.	A	G	6	6	12	0	0	12	0	0
16	31767163	.	G	A	4	3	7	0	0	7	0	0
16	31767191	.	T	C	2	0	2	0	0	2	0	0
16	31768343	.	C	G	5	18	23	0	0	23	0	0
16	31768394	.	T	C	7	14	21	0	1	22	0	0
16	31768436	.	T	C	11	11	22	0	1	23	0	0
16	31769317	.	G	A	3	5	8	0	0	8	0	0
16	31769395	.	A	G	8	9	17	0	0	17	0	0
16	31769428	.	G	A	4	1	5	0	0	5	0	0
16	31770050	.	T	C	7	0	7	0	7	14	0	0
16	31776125	.	C	T	3	3	6	0	0	6	0	0
16	31780108	.	C	T	0	8	8	0	4	12	0	0
16	31789327	.	C	T	2	5	7	0	0	7	0	0
16	31810887	.	C	T	0	1	1	0	0	1	0	0
16	31815638	.	C	T	14	6	20	0	3	23	0	0
16	31815878	.	G	A	4	17	21	0	1	22	0	0
16	31816005	.	C	A	12	7	19	0	0	19	0	0
16	31816205	.	C	T	10	3	13	0	0	13	0	0
16	31816336	.	C	T	1	7	8	0	7	15	0	0
16	31816596	.	C	T	8	17	25	0	1	26	0	0
16	31827642	.	T	A	17	17	34	0	0	34	0	0
16	31827703	.	C	T	17	14	31	0	3	34	0	0
16	31832606	.	A	G	12	0	12	0	22	34	0	0
16	31853932	.	T	A	0	3	3	0	0	3	0	0
16	31854325	.	C	A	0	1	1	0	1	2	0	0
16	31855271	.	T	C	7	4	11	0	0	11	0	0
16	31855327	.	G	A	8	7	15	0	0	15	0	0
16	31855351	.	G	C	5	13	18	0	1	19	0	0
16	31855575	.	C	T	15	12	27	0	0	27	0	0
16	31855576	.	C	T	15	11	26	0	1	27	0	0
16	31855814	.	T	G	6	2	8	0	7	15	0	0
16	31856239	.	A	G	6	4	10	0	0	10	0	0
16	31856276	.	G	A	0	3	3	0	5	8	0	0
16	31859227	.	T	C	11	23	34	0	0	34	0	0
16	31859341	.	C	T	20	15	35	0	2	37	0	0
16	31859371	.	T	C	20	18	38	0	2	40	0	0
16	31859416	.	T	C	9	26	35	0	3	38	0	0
16	31859425	.	C	T	4	26	30	0	4	34	0	0
16	31859686	.	G	A	9	8	17	0	0	17	0	0
16	31868443	.	G	A	19	15	34	0	0	34	0	0
16	31922892	.	A	G	4	3	7	0	2	9	0	0
16	31923083	.	G	A	26	19	45	0	2	47	0	0
16	31923435	.	A	G	27	24	51	0	1	52	0	0
16	31924485	.	T	C	17	26	43	0	1	44	0	0
16	31924501	.	A	C	16	25	41	0	1	42	0	0
16	31925035	.	A	G	1	2	3	0	0	3	0	0
16	31925727	.	G	A	0	2	2	0	0	2	0	0
16	31946983	.	A	G	0	1	1	0	0	1	0	0
16	31951694	.	G	C	4	3	7	0	1	8	0	0
16	31955226	.	C	G	0	2	2	0	0	2	0	0
16	31958957	.	G	T	0	2	2	0	0	2	0	0
16	31959098	.	G	A	0	2	2	0	2	4	0	0
16	31959277	.	A	T	2	5	7	0	0	7	0	0
16	31959496	.	A	G	2	0	2	0	2	4	0	0
16	31959845	.	A	G	1	0	1	0	4	5	0	0
16	31960037	.	G	A	0	3	3	0	1	4	0	0
16	31960064	.	G	C	2	5	7	0	0	7	0	0
16	31960145	.	C	T	6	7	13	0	1	14	0	0
16	31960152	.	C	T	5	8	13	0	0	13	0	0
16	32009736	.	A	T	3	6	9	0	0	9	0	0
16	32011649	.	C	T	6	5	11	0	0	11	0	0
16	32013272	.	G	A	0	2	2	0	0	2	0	0
16	32013766	.	T	G	4	2	6	0	0	6	0	0
16	32013861	.	G	A	6	5	11	0	0	11	0	0
16	32013891	.	G	A	4	4	8	0	0	8	0	0
16	32014627	.	T	A	1	4	5	0	0	5	0	0
16	32014633	.	A	T	1	4	5	0	0	5	0	0
16	32018590	.	C	T	2	1	3	0	0	3	0	0
16	32019695	.	G	A	1	1	2	0	0	2	0	0
16	32021999	.	C	T	3	5	8	0	0	8	0	0
16	32023124	.	T	A	5	4	9	0	1	10	0	0
16	32025648	.	T	A	8	11	19	0	0	19	0	0
16	32025758	.	C	A	5	2	7	0	0	7	0	0
16	32025978	.	G	A	7	8	15	0	0	15	0	0
16	32025987	.	T	A	9	9	18	0	0	18	0	0
16	32026105	.	T	A	7	6	13	0	1	14	0	0
16	32026154	.	T	G	2	3	5	0	0	5	0	0
16	32026203	.	C	T	2	2	4	0	0	4	0	0
16	32026206	.	A	G	2	2	4	0	0	4	0	0
16	32051854	.	A	C	8	7	15	0	0	15	0	0
16	32052004	.	T	G	4	1	5	0	0	5	0	0
16	32052283	.	T	A	2	0	2	0	0	2	0	0
16	32052307	.	T	C	5	3	8	0	0	8	0	0
16	32052328	.	T	A	5	8	13	0	0	13	0	0
16	32052404	.	G	T	1	4	5	0	7	12	0	0
16	32055726	.	T	G	8	7	15	0	1	16	0	0
16	32057809	.	T	C	9	5	14	0	1	15	0	0
16	32060021	.	G	A	0	6	6	0	10	16	0	0
16	32060121	.	G	T	8	7	15	0	1	16	0	0
16	32060130	.	C	A	7	6	13	0	3	16	0	0
16	32063433	.	C	T	6	6	12	0	0	12	0	0
16	32066465	.	T	C	1	2	3	0	0	3	0	0
16	32068332	.	G	A	6	7	13	0	0	13	0	0
16	32068452	.	C	A	9	9	18	0	0	18	0	0
16	32068503	.	T	C	8	6	14	0	0	14	0	0
16	32068824	.	G	C	5	8	13	0	0	13	0	0
16	32069310	.	T	A	18	7	25	0	2	27	0	0
16	32069653	.	A	G	11	8	19	0	1	20	0	0
16	32070489	.	A	G	10	0	10	0	8	18	0	0
16	32070570	.	C	T	16	10	26	0	1	27	0	0
16	32070981	.	G	C	10	11	21	0	0	21	0	0
16	32071965	.	G	C	8	9	17	0	0	17	0	0
16	32071997	.	C	A	7	16	23	0	0	23	0	0
16	32072334	.	A	G	12	18	30	0	1	31	0	0
16	32073301	.	A	C	19	19	38	0	0	38	0	0
16	32073507	.	A	C	23	23	46	0	0	46	0	0
16	32073555	.	A	G	23	22	45	0	3	48	0	0
16	32073760	.	G	A	13	27	40	0	2	42	0	0
16	32074041	.	G	A	18	18	36	0	3	39	0	0
16	32074257	.	A	G	26	2	28	0	18	46	0	0
16	32074293	.	T	A	21	13	34	0	3	37	0	0
16	32074294	.	A	G	22	13	35	0	2	37	0	0
16	32080069	.	G	T	0	4	4	0	13	17	0	0
16	32080099	.	G	A	3	4	7	0	0	7	0	0
16	32080196	.	T	C	2	2	4	0	2	6	0	0
16	32080206	.	T	C	2	4	6	0	0	6	0	0
16	32080306	.	T	A	9	3	12	0	1	13	0	0
16	32080508	.	T	A	12	17	29	0	1	30	0	0
16	32080738	.	G	A	5	3	8	0	1	9	0	0
16	32082397	.	T	C	6	6	12	0	0	12	0	0
16	32082589	.	G	A	6	8	14	0	0	14	0	0
16	32082597	.	G	A	6	9	15	0	0	15	0	0
16	32082642	.	G	A	5	4	9	0	1	10	0	0
16	32085319	.	T	A	1	2	3	0	0	3	0	0
16	32085631	.	A	G	1	1	2	0	0	2	0	0
16	32085778	.	A	C	0	4	4	0	0	4	0	0
16	32086136	.	C	T	6	4	10	0	0	10	0	0
16	32090349	.	C	T	13	8	21	0	0	21	0	0
16	32090425	.	G	C	8	4	12	0	1	13	0	0
16	32110659	.	A	G	11	17	28	0	0	28	0	0
16	32111246	.	G	T	13	17	30	0	0	30	0	0
16	32113155	.	G	A	16	5	21	0	0	21	0	0
16	32113218	.	G	A	6	2	8	0	0	8	0	0
16	32116790	.	A	T	1	3	4	0	0	4	0	0
16	32117345	.	T	A	7	6	13	0	1	14	0	0
16	32119618	.	C	T	7	4	11	0	0	11	0	0
16	32119895	.	G	T	7	13	20	0	1	21	0	0
16	32120138	.	G	T	7	9	16	0	1	17	0	0
16	32120141	.	T	C	7	0	7	0	9	16	0	0
16	32120173	.	G	A	13	6	19	0	1	20	0	0
16	32120204	.	G	T	13	6	19	0	4	23	0	0
16	32120279	.	A	C	8	8	16	0	0	16	0	0
16	32128259	.	T	A	2	4	6	0	0	6	0	0
16	32140378	.	C	T	7	3	10	0	0	10	0	0
16	32140538	.	T	A	6	2	8	0	0	8	0	0
16	32140638	.	G	C	5	5	10	0	0	10	0	0
16	32140977	.	C	T	5	5	10	0	0	10	0	0
16	32140999	.	A	G	4	5	9	0	0	9	0	0
16	32141036	.	G	A	2	3	5	0	0	5	0	0
16	32141058	.	A	G	0	3	3	0	0	3	0	0
16	32141544	.	A	G	7	0	7	0	12	19	0	0
16	32141565	.	A	C	5	8	13	0	2	15	0	0
16	32144337	.	T	C	5	5	10	0	1	11	0	0
16	32144377	.	T	C	11	7	18	0	2	20	0	0
16	32144854	.	G	T	0	5	5	0	2	7	0	0
16	32144989	.	T	C	4	4	8	0	0	8	0	0
16	32145160	.	T	A	7	4	11	0	0	11	0	0
16	32145391	.	G	A	4	3	7	0	0	7	0	0
16	32145636	.	A	G	9	10	19	0	0	19	0	0
16	32241591	.	C	T	1	2	3	0	0	3	0	0
16	32252878	.	A	G	1	4	5	0	0	5	0	0
16	32257179	.	T	A	1	1	2	0	0	2	0	0
16	32267128	.	G	A	7	5	12	0	0	12	0	0
16	32267203	.	G	A	0	6	6	0	4	10	0	0
16	32273066	.	G	T	7	4	11	0	1	12	0	0
16	32273192	.	G	A	0	3	3	0	9	12	0	0
16	32274935	.	G	A	0	2	2	0	0	2	0	0
16	32275601	.	T	A	5	8	13	0	1	14	0	0
16	32275628	.	A	T	9	5	14	0	3	17	0	0
16	32561581	.	T	A	1	4	5	0	0	5	0	0
16	32561618	.	T	C	1	4	5	0	0	5	0	0
16	32562038	.	A	T	8	3	11	0	1	12	0	0
16	32562817	.	A	T	3	3	6	0	1	7	0	0
16	32677043	.	C	T	4	2	6	0	0	6	0	0
16	33735481	.	G	A	5	5	10	0	0	10	0	0
16	33735503	.	C	T	6	3	9	0	0	9	0	0
16	33736174	.	A	T	2	2	4	0	0	4	0	0
16	33736196	.	A	C	2	4	6	0	0	6	0	0
16	33774584	.	C	A	0	2	2	0	1	3	0	0
16	33905018	.	C	T	1	3	4	0	0	4	0	0
16	33909384	.	G	A	0	3	3	0	2	5	0	0
16	33910305	.	G	A	0	2	2	0	0	2	0	0
16	33915011	.	C	T	1	0	1	0	0	1	0	0
16	33919623	.	G	A	4	3	7	0	0	7	0	0
16	33923421	.	G	T	2	3	5	0	0	5	0	0
16	33923448	.	G	T	6	5	11	0	0	11	0	0
16	33923514	.	G	A	6	8	14	0	1	15	0	0
16	33925132	.	G	C	0	1	1	0	0	1	0	0
16	33925356	.	G	A	0	3	3	0	5	8	0	0
16	33925565	.	T	G	6	4	10	0	0	10	0	0
16	33926074	.	C	T	0	1	1	0	0	1	0	0
16	33927009	.	C	G	1	3	4	0	0	4	0	0
16	33928015	.	G	A	1	2	3	0	0	3	0	0
16	33933213	.	C	T	2	2	4	0	0	4	0	0
16	33933496	.	G	C	6	3	9	0	0	9	0	0
16	33933498	.	C	T	3	6	9	0	0	9	0	0
16	33933732	.	G	A	0	2	2	0	1	3	0	0
16	33939824	.	T	C	1	4	5	0	0	5	0	0
16	33939859	.	C	T	4	6	10	0	0	10	0	0
16	33940098	.	G	A	4	5	9	0	1	10	0	0
16	33940122	.	G	A	3	3	6	0	1	7	0	0
16	33940364	.	A	G	0	0	0	0	7	7	0	0
16	33940379	.	T	A	3	6	9	0	1	10	0	0
16	33953652	.	T	A	1	6	7	0	0	7	0	0
16	33953968	.	C	T	3	5	8	0	1	9	0	0
16	33964788	.	G	T	2	2	4	0	0	4	0	0
16	33971993	.	G	A	0	9	9	0	11	20	0	0
16	33972008	.	G	A	11	10	21	0	1	22	0	0
16	33972037	.	A	C	7	10	17	0	2	19	0	0
16	33972067	.	A	G	9	5	14	0	2	16	0	0
16	33972193	.	G	A	0	7	7	0	8	15	0	0
16	33972242	.	G	T	11	7	18	0	0	18	0	0
16	33972249	.	C	T	9	7	16	0	1	17	0	0
16	33972454	.	C	T	5	7	12	0	0	12	0	0
16	33978019	.	A	G	4	0	4	0	2	6	0	0
16	33979746	.	A	T	5	8	13	0	0	13	0	0
16	33981439	.	C	T	4	4	8	0	0	8	0	0
16	33981873	.	A	G	8	0	8	0	7	15	0	0
16	33983784	.	T	G	9	5	14	0	0	14	0	0
16	33983904	.	C	T	4	10	14	0	0	14	0	0
16	33984178	.	C	T	6	6	12	0	0	12	0	0
16	33984190	.	C	T	5	7	12	0	0	12	0	0
16	33985050	.	G	T	1	11	12	0	13	26	1	0
16	33985362	.	C	T	10	12	22	0	1	23	0	0
16	33986452	.	T	G	21	16	37	0	1	38	0	0
16	33989391	.	A	G	2	0	2	0	2	4	0	0
16	33989606	.	G	T	0	3	3	0	2	5	0	0
16	33994640	.	G	A	0	5	5	0	3	8	0	0
16	33996739	.	C	T	0	1	1	0	0	1	0	0
16	34004562	.	G	A	0	7	7	0	4	11	0	0
16	34004595	.	T	C	6	9	15	0	0	15	0	0
16	34004862	.	C	T	4	4	8	0	0	8	0	0
16	34005290	.	C	T	7	3	10	0	0	10	0	0
16	34005415	.	C	T	3	6	9	0	1	10	0	0
16	34005577	.	A	G	7	2	9	0	1	10	0	0
16	34005669	.	C	T	5	5	10	0	0	10	0	0
16	34005686	.	C	T	4	6	10	0	0	10	0	0
16	34005812	.	T	A	10	3	13	0	1	14	0	0
16	34005858	.	A	G	3	4	7	0	0	7	0	0
16	34006020	.	G	C	1	5	6	0	0	6	0	0
16	34006208	.	C	T	0	2	2	0	0	2	0	0
16	34053445	.	A	G	2	0	2	0	0	2	0	0
16	34054171	.	A	G	0	5	5	0	0	5	0	0
16	34054321	.	C	T	1	5	6	0	0	6	0	0
16	34054345	.	A	G	2	0	2	0	4	6	0	0
16	34054712	.	T	G	3	0	3	0	4	7	0	0
16	34054778	.	G	A	3	2	5	0	0	5	0	0
16	34054786	.	T	G	3	2	5	0	0	5	0	0
16	34056324	.	T	G	2	5	7	0	0	7	0	0
16	34172916	.	G	A	3	3	6	0	0	6	0	0
16	34173000	.	T	C	5	5	10	0	0	10	0	0
16	34173624	.	G	A	4	4	8	0	0	8	0	0
16	34173821	.	G	A	2	4	6	0	0	6	0	0
16	34173834	.	C	T	0	3	3	0	0	3	0	0
16	34185709	.	A	C	3	2	5	0	0	5	0	0
16	34185906	.	A	T	3	7	10	0	2	12	0	0
16	34200704	.	C	T	4	1	5	0	0	5	0	0
16	34201023	.	A	G	6	5	11	0	0	11	0	0
16	34208582	.	T	C	13	1	14	0	15	29	0	0
16	34208696	.	A	G	14	14	28	0	0	28	0	0
16	34212477	.	A	G	5	18	23	0	1	24	0	0
16	34212516	.	A	G	7	19	26	0	0	26	0	0
16	34212565	.	G	A	10	13	23	0	4	27	0	0
16	34212567	.	G	C	13	14	27	0	0	27	0	0
16	34212630	.	T	C	16	3	19	0	22	42	1	0
16	34212676	.	G	C	8	1	9	0	10	19	0	0
16	34212711	.	T	G	2	5	7	0	10	17	0	0
16	34222439	.	T	G	9	12	21	0	2	23	0	0
16	34225173	.	T	C	1	2	3	0	0	3	0	0
16	34225392	.	A	G	10	14	24	0	3	27	0	0
16	34225472	.	G	A	15	8	23	0	0	23	0	0
16	34267938	.	C	T	0	5	5	0	3	8	0	0
16	34267991	.	G	C	3	2	5	0	0	5	0	0
16	34303761	.	T	G	1	1	2	0	0	2	0	0
16	34321568	.	A	T	4	7	11	0	0	11	0	0
16	34322346	.	G	A	14	18	32	0	0	32	0	0
16	34322372	.	C	T	0	13	13	0	16	29	0	0
16	34331489	.	A	G	1	2	3	0	0	3	0	0
16	34337976	.	A	T	11	10	21	0	4	25	0	0
16	34338475	.	A	G	13	10	23	0	1	24	0	0
16	34339168	.	A	C	11	6	17	0	1	18	0	0
16	34339432	.	A	T	13	6	19	0	4	23	0	0
16	34339693	.	C	T	10	5	15	0	0	15	0	0
16	34339808	.	A	G	10	4	14	0	0	14	0	0
16	34339857	.	T	G	9	5	14	0	0	14	0	0
16	34340179	.	A	T	8	4	12	0	0	12	0	0
16	34340397	.	A	C	9	5	14	0	0	14	0	0
16	34340520	.	G	T	4	6	10	0	2	12	0	0
16	34340538	.	C	T	5	6	11	0	1	12	0	0
16	34340965	.	C	T	2	9	11	0	1	12	0	0
16	34340967	.	A	G	2	10	12	0	0	12	0	0
16	34341012	.	C	T	4	4	8	0	0	8	0	0
16	34341021	.	C	T	4	4	8	0	0	8	0	0
16	34341080	.	T	C	1	7	8	0	0	8	0	0
16	34461322	.	G	A	1	4	5	0	0	5	0	0
16	34497755	.	T	A	6	2	8	0	1	9	0	0
16	34497992	.	T	A	4	10	14	0	0	14	0	0
16	34498734	.	A	G	3	0	3	0	5	8	0	0
16	34498785	.	G	C	9	4	13	0	0	13	0	0
16	34498787	.	A	G	9	4	13	0	0	13	0	0
16	34499400	.	A	G	3	3	6	0	1	7	0	0
16	34499778	.	G	A	1	3	4	0	0	4	0	0
16	34500007	.	C	T	8	5	13	0	0	13	0	0
16	34500542	.	G	C	6	13	19	0	0	19	0	0
16	34500840	.	T	G	13	9	22	0	0	22	0	0
16	34500899	.	G	A	12	13	25	0	0	25	0	0
16	34501136	.	C	T	6	16	22	0	0	22	0	0
16	34501137	.	A	G	6	16	22	0	0	22	0	0
16	34501380	.	C	T	6	8	14	0	1	15	0	0
16	34501794	.	G	A	6	6	12	0	1	13	0	0
16	34525621	.	C	A	18	27	45	0	6	51	0	0
16	34526092	.	C	G	27	30	57	0	3	60	0	0
16	34526093	.	A	C	16	32	48	0	12	60	0	0
16	34526926	.	A	T	29	25	54	0	7	61	0	0
16	34527183	.	C	T	6	10	16	0	5	21	0	0
16	34532205	.	G	A	1	18	19	0	12	31	0	0
16	34532635	.	T	C	5	4	9	0	0	9	0	0
16	34532720	.	C	G	2	5	7	0	0	7	0	0
16	34532799	.	G	A	0	8	8	0	9	17	0	0
16	34930635	.	A	G	3	3	6	0	0	6	0	0
16	34930719	.	C	T	0	5	5	0	6	11	0	0
16	34948262	.	C	T	4	4	8	0	1	9	0	0
16	34953166	.	C	T	4	4	8	0	0	8	0	0
16	34989800	.	C	T	0	3	3	0	1	4	0	0
16	35022679	.	G	A	4	7	11	0	0	11	0	0
16	35023920	.	C	T	1	3	4	0	0	4	0	0
16	35023934	.	T	C	1	3	4	0	0	4	0	0
16	35043863	.	C	T	7	6	13	0	0	13	0	0
16	35053907	.	C	G	4	5	9	0	1	10	0	0
16	35329655	.	G	A	2	1	3	0	0	3	0	0
16	35376598	.	G	T	2	2	4	0	1	5	0	0
16	35376825	.	C	T	1	7	8	0	0	8	0	0
16	35376832	.	G	T	1	6	7	0	0	7	0	0
16	35411363	.	T	C	1	10	11	0	1	12	0	0
16	35414455	.	A	G	9	2	11	0	0	11	0	0
16	35414470	.	T	C	7	2	9	0	0	9	0	0
16	35415710	.	A	G	7	3	10	0	0	10	0	0
16	35415872	.	G	A	3	9	12	0	2	14	0	0
16	35416158	.	C	T	1	1	2	0	0	2	0	0
16	35418744	.	T	C	1	0	1	0	2	3	0	0
16	35418792	.	T	C	1	0	1	0	7	8	0	0
16	35418804	.	G	A	1	7	8	0	0	8	0	0
16	35420600	.	T	C	3	0	3	0	6	9	0	0
16	35422323	.	A	G	4	4	8	0	0	8	0	0
16	35423651	.	A	G	10	5	15	0	1	16	0	0
16	35423985	.	C	T	3	4	7	0	0	7	0	0
16	35424003	.	A	T	1	2	3	0	0	3	0	0
16	35426998	.	T	C	9	0	9	0	8	17	0	0
16	35535353	.	T	G	2	1	3	0	0	3	0	0
16	35536480	.	G	A	17	13	30	1	0	31	0	0
16	35536574	.	C	A	8	10	18	0	1	19	0	0
16	35536576	.	G	A	0	11	11	0	8	19	0	0
16	35536739	.	C	T	7	12	19	0	1	20	0	0
16	35536960	.	T	C	6	9	15	0	0	15	0	0
16	35537153	.	G	A	5	12	17	0	0	17	0	0
16	35556275	.	C	A	4	2	6	0	0	6	0	0
16	35556365	.	A	G	6	4	10	0	0	10	0	0
16	35556378	.	G	A	4	5	9	0	1	10	0	0
16	35556619	.	T	C	2	3	5	0	0	5	0	0
16	35556819	.	A	T	3	3	6	0	0	6	0	0
16	35560134	.	A	G	1	1	2	0	0	2	0	0
16	35572630	.	G	A	2	2	4	0	0	4	0	0
16	35578923	.	T	C	2	4	6	0	0	6	0	0
16	35661979	.	A	G	1	7	8	0	0	8	0	0
16	35661995	.	T	C	1	4	5	0	0	5	0	0
16	35662031	.	T	C	4	3	7	0	0	7	0	0
16	35728994	.	G	A	0	1	1	0	0	1	0	0
16	35729045	.	C	T	5	3	8	0	0	8	0	0
16	35743809	.	A	G	3	4	7	0	1	8	0	0
16	35750548	.	T	C	5	3	8	0	0	8	0	0
16	35750647	.	T	G	12	11	23	0	2	25	0	0
16	35750648	.	G	C	13	12	25	0	0	25	0	0
16	35750714	.	T	A	11	11	22	0	1	23	0	0
16	35772762	.	C	T	12	7	19	0	0	19	0	0
16	35772933	.	T	C	9	15	24	0	2	26	0	0
16	35773005	.	A	G	10	13	23	0	0	23	0	0
16	36041247	.	G	A	0	1	1	0	0	1	0	0
16	36046966	.	G	A	2	3	5	0	0	5	0	0
16	36062265	.	T	C	7	0	7	0	6	13	0	0
16	36075471	.	G	A	5	9	14	0	0	14	0	0
16	36075478	.	T	A	6	8	14	0	0	14	0	0
16	36075677	.	C	A	10	5	15	0	0	15	0	0
16	36075999	.	A	G	7	12	19	0	0	19	0	0
16	36076082	.	G	A	7	8	15	0	0	15	0	0
16	36080364	.	C	T	9	17	26	0	1	27	0	0
16	36080376	.	A	C	7	14	21	0	1	22	0	0
16	36087550	.	A	C	4	0	4	0	2	6	0	0
16	36118166	.	T	C	4	0	4	0	4	8	0	0
16	36150674	.	A	G	5	1	6	0	1	7	0	0
16	36150707	.	C	T	12	9	21	0	3	24	0	0
16	36150949	.	C	T	11	13	24	0	1	25	0	0
16	36150964	.	C	T	7	10	17	0	3	20	0	0
16	36151000	.	C	A	3	2	5	0	3	8	0	0
16	36159928	.	T	C	24	16	40	0	2	42	0	0
16	36162013	.	C	T	10	22	32	0	2	34	0	0
16	36162201	.	A	G	8	8	16	0	0	16	0	0
16	36162584	.	G	C	0	10	10	0	11	21	0	0
16	36162650	.	T	C	13	15	28	0	0	28	0	0
16	36162727	.	A	G	20	9	29	0	0	29	0	0
16	36162754	.	A	G	17	10	27	0	1	28	0	0
16	36162938	.	G	T	8	3	11	0	2	13	0	0
16	36163005	.	G	A	5	2	7	0	4	11	0	0
16	36163006	.	A	C	5	3	8	0	3	11	0	0
16	36168251	.	C	T	2	3	5	0	0	5	0	0
16	36168317	.	G	C	4	9	13	0	1	14	0	0
16	36168416	.	T	C	9	7	16	0	0	16	0	0
16	36168450	.	A	T	5	3	8	0	0	8	0	0
16	36168510	.	A	T	5	2	7	0	0	7	0	0
16	36168787	.	T	A	4	3	7	0	0	7	0	0
16	36168994	.	C	T	5	6	11	0	0	11	0	0
16	36169007	.	T	C	3	5	8	0	0	8	0	0
16	36169057	.	T	G	2	4	6	0	0	6	0	0
16	36169150	.	T	C	6	4	10	0	0	10	0	0
16	36169568	.	G	T	6	5	11	0	0	11	0	0
16	36171552	.	A	G	0	1	1	0	0	1	0	0
16	36172961	.	A	G	2	0	2	0	0	2	0	0
16	36172982	.	C	T	2	1	3	0	0	3	0	0
16	36173406	.	A	T	6	3	9	0	0	9	0	0
16	36180540	.	G	A	0	2	2	0	1	3	0	0
16	36180591	.	A	G	1	5	6	0	1	7	0	0
16	36180753	.	A	G	2	1	3	0	0	3	0	0
16	36183047	.	A	G	0	1	1	0	0	1	0	0
16	36185315	.	G	A	1	2	3	0	0	3	0	0
16	36189865	.	G	A	1	5	6	0	0	6	0	0
16	36195921	.	C	T	3	1	4	0	0	4	0	0
16	36196411	.	T	C	1	3	4	0	0	4	0	0
16	36721560	.	A	T	3	10	13	0	0	13	0	0
16	36721589	.	T	G	4	12	16	0	0	16	0	0
16	36724010	.	C	G	0	5	5	0	5	10	0	0
16	36729322	.	A	T	1	0	1	0	4	5	0	0
16	36729352	.	G	T	7	6	13	0	0	13	0	0
16	36729373	.	A	G	10	7	17	0	0	17	0	0
16	36731307	.	A	G	7	13	20	0	0	20	0	0
16	36735751	.	T	C	2	4	6	0	0	6	0	0
16	36735760	.	T	C	1	0	1	0	1	2	0	0
16	36741148	.	T	C	1	1	2	0	0	2	0	0
16	36743328	.	G	A	6	8	14	0	0	14	0	0
16	36743351	.	G	A	7	7	14	0	0	14	0	0
16	36743757	.	T	C	1	8	9	0	0	9	0	0
16	36743787	.	A	G	1	8	9	0	0	9	0	0
16	36745973	.	C	T	0	2	2	0	0	2	0	0
16	36746103	.	C	T	0	1	1	0	0	1	0	0
16	36746466	.	G	A	2	3	5	0	0	5	0	0
16	36746484	.	A	G	1	5	6	0	1	7	0	0
16	36748214	.	T	G	0	1	1	0	0	1	0	0
16	36748366	.	T	C	2	0	2	0	6	8	0	0
16	36749242	.	T	G	2	0	2	0	3	5	0	0
16	36752278	.	T	C	0	2	2	0	0	2	0	0
16	36759812	.	A	G	1	0	1	0	2	3	0	0
16	36759834	.	T	C	3	4	7	0	0	7	0	0
16	36759908	.	A	T	5	2	7	0	1	8	0	0
16	36766180	.	T	G	20	4	24	0	1	26	1	0
16	36766467	.	G	T	12	8	20	0	4	24	0	0
16	36766497	.	T	G	0	1	1	0	16	17	0	0
16	36906805	.	C	T	4	2	6	0	0	6	0	0
16	36908630	.	C	T	6	2	8	0	0	8	0	0
16	36908844	.	C	A	5	5	10	0	0	10	0	0
16	36911214	.	C	A	5	1	6	0	0	6	0	0
16	36918992	.	G	A	2	2	4	0	0	4	0	0
16	36923298	.	C	T	10	6	16	0	1	17	0	0
16	36925462	.	G	A	0	0	0	0	3	3	0	0
16	36926775	.	C	A	3	2	5	0	0	5	0	0
16	36926779	.	A	C	3	1	4	0	0	4	0	0
16	36928169	.	A	T	5	3	8	0	0	8	0	0
16	36928179	.	A	C	5	3	8	0	0	8	0	0
16	36928429	.	A	G	6	5	11	0	0	11	0	0
16	36931728	.	T	C	17	9	26	0	1	27	0	0
16	36931822	.	T	C	7	3	10	0	0	10	0	0
16	36934191	.	T	A	9	9	18	0	0	18	0	0
16	36934340	.	C	A	0	2	2	0	3	5	0	0
16	36934398	.	G	C	5	1	6	1	2	9	0	0
16	36939973	.	T	C	2	0	2	0	3	5	0	0
16	36939982	.	A	G	6	2	8	0	0	8	0	0
16	36941706	.	T	C	1	0	1	0	1	2	0	0
16	36941790	.	T	C	4	5	9	0	1	10	0	0
16	36941961	.	T	C	0	0	0	0	4	4	0	0
16	36942068	.	C	A	2	2	4	0	1	5	0	0
16	36945182	.	T	G	3	2	5	0	1	6	0	0
16	36945288	.	G	A	5	9	14	0	0	14	0	0
16	36945564	.	T	C	1	6	7	0	4	11	0	0
16	36945566	.	T	A	4	6	10	0	1	11	0	0
16	36974719	.	T	C	2	3	5	0	0	5	0	0
16	36975141	.	G	A	5	6	11	0	1	12	0	0
16	36975146	.	C	T	0	5	5	0	5	10	0	0
16	36975318	.	T	A	4	4	8	0	1	9	0	0
16	36976721	.	A	G	10	7	17	0	0	17	0	0
16	36977387	.	A	G	2	1	3	0	0	3	0	0
16	36979518	.	G	A	12	10	22	0	0	22	0	0
16	36979521	.	A	G	11	10	21	0	1	22	0	0
16	37167545	.	T	A	5	5	10	0	1	11	0	0
16	37167589	.	T	G	2	8	10	0	1	11	0	0
16	37167784	.	C	G	1	8	9	0	0	9	0	0
16	37167968	.	G	A	5	8	13	0	0	13	0	0
16	37306905	.	G	A	5	13	18	0	0	18	0	0
16	37470964	.	T	C	2	2	4	0	0	4	0	0
16	37471169	.	A	T	2	3	5	0	0	5	0	0
16	37520679	.	T	A	3	3	6	0	0	6	0	0
16	37521130	.	A	G	5	4	9	0	0	9	0	0
16	37543137	.	A	C	1	5	6	0	1	7	0	0
16	37552348	.	A	C	2	4	6	0	0	6	0	0
16	37552966	.	G	A	6	3	9	0	1	10	0	0
16	37554821	.	C	T	7	8	15	0	0	15	0	0
16	37563601	.	G	A	1	0	1	0	0	1	0	0
16	37563643	.	T	G	1	0	1	0	0	1	0	0
16	37565676	.	C	G	0	2	2	0	0	2	0	0
16	37593444	.	G	A	4	3	7	0	0	7	0	0
16	37596645	.	C	T	2	3	5	0	1	6	0	0
16	37596669	.	G	A	1	2	3	0	1	4	0	0
16	37614071	.	A	G	3	1	4	0	0	4	0	0
16	37617219	.	A	G	9	0	9	0	11	20	0	0
16	37617304	.	A	G	12	0	12	0	15	27	0	0
16	37617738	.	T	C	21	19	40	0	1	41	0	0
16	37627216	.	T	G	20	6	26	0	4	30	0	0
16	37627218	.	T	G	13	15	28	0	4	32	0	0
16	37627762	.	G	A	0	13	13	0	23	36	0	0
16	37627997	.	T	G	24	20	44	0	2	46	0	0
16	37923207	.	A	G	0	0	0	0	1	1	0	0
16	37947944	.	C	T	6	3	9	0	0	9	0	0
16	37948061	.	A	G	7	6	13	0	0	13	0	0
16	37948199	.	C	T	4	6	10	0	0	10	0	0
16	37948205	.	T	C	4	0	4	0	5	9	0	0
16	37948256	.	G	T	2	4	6	0	0	6	0	0
16	37948425	.	A	G	11	6	17	0	1	18	0	0
16	37948426	.	G	T	12	6	18	0	0	18	0	0
16	37948624	.	G	A	12	3	15	0	0	15	0	0
16	37948625	.	G	A	12	3	15	0	0	15	0	0
16	37964057	.	A	G	7	3	10	0	0	10	0	0
16	37964252	.	T	A	0	3	3	0	1	4	0	0
16	38017710	.	G	C	1	3	4	0	0	4	0	0
16	38017722	.	A	G	2	2	4	0	1	5	0	0
16	38018015	.	A	G	1	2	3	0	0	3	0	0
16	38018786	.	G	A	4	2	6	0	0	6	0	0
16	38121528	.	G	A	0	0	0	0	1	1	0	0
16	38124907	.	T	G	2	0	2	0	2	4	0	0
16	38125202	.	T	A	2	0	2	0	0	2	0	0
16	38125293	.	G	C	3	2	5	0	0	5	0	0
16	38125299	.	G	C	3	2	5	0	0	5	0	0
16	38125370	.	C	T	3	4	7	0	0	7	0	0
16	38125662	.	A	G	2	1	3	0	0	3	0	0
16	38127708	.	T	A	4	1	5	0	0	5	0	0
16	38129427	.	T	A	3	3	6	0	0	6	0	0
16	38129496	.	T	C	1	2	3	0	0	3	0	0
16	38130661	.	T	C	5	4	9	0	0	9	0	0
16	38131803	.	G	A	6	6	12	0	0	12	0	0
16	38131813	.	C	A	3	5	8	0	1	9	0	0
16	38132166	.	C	T	2	2	4	0	0	4	0	0
16	38132438	.	A	G	4	3	7	0	0	7	0	0
16	38132537	.	T	A	4	5	9	0	0	9	0	0
16	38133170	.	G	C	3	8	11	0	0	11	0	0
16	38133696	.	A	T	4	2	6	0	0	6	0	0
16	38133732	.	C	G	8	4	12	0	0	12	0	0
16	38133804	.	C	T	11	7	18	0	0	18	0	0
16	38133903	.	A	G	8	7	15	0	2	17	0	0
16	38134152	.	A	G	5	7	12	0	0	12	0	0
16	38134215	.	G	A	8	8	16	0	0	16	0	0
16	38134302	.	C	T	5	3	8	0	0	8	0	0
16	38134428	.	C	A	5	5	10	0	1	11	0	0
16	38134515	.	C	T	12	8	20	0	0	20	0	0
16	38134653	.	A	G	5	0	5	0	6	11	0	0
16	38134676	.	C	A	4	6	10	0	1	11	0	0
16	38134710	.	T	A	7	7	14	0	0	14	0	0
16	38134875	.	G	A	8	3	11	0	0	11	0	0
16	38134908	.	A	T	5	7	12	0	0	12	0	0
16	38135166	.	C	A	13	13	26	0	0	26	0	0
16	38135591	.	G	T	1	9	10	0	0	10	0	0
16	38135740	.	T	C	7	10	17	0	0	17	0	0
16	38135763	.	A	G	6	9	15	0	0	15	0	0
16	38135816	.	T	C	6	3	9	0	0	9	0	0
16	38135953	.	A	T	7	3	10	0	1	12	1	0
16	38136022	.	G	A	1	4	5	0	0	5	0	0
16	38136028	.	C	T	1	3	4	0	0	4	0	0
16	38136317	.	G	A	10	9	19	0	2	21	0	0
16	38154236	.	A	G	0	1	1	0	0	1	0	0
16	38154537	.	T	C	0	0	0	0	1	1	0	0
16	38159817	.	C	A	7	2	9	0	0	9	0	0
16	38167511	.	C	T	7	4	11	0	0	11	0	0
16	38167734	.	T	C	4	3	7	0	0	7	0	0
16	38167904	.	A	G	4	0	4	0	6	10	0	0
16	38168009	.	A	G	11	9	20	0	2	22	0	0
16	38188955	.	G	A	0	9	9	0	7	16	0	0
16	38191645	.	C	T	1	6	7	0	0	7	0	0
16	38193969	.	A	G	6	5	11	0	0	11	0	0
16	38194017	.	T	C	3	4	7	0	1	8	0	0
16	38198125	.	C	A	5	9	14	0	0	14	0	0
16	38198418	.	T	G	13	11	24	0	1	25	0	0
16	38198648	.	G	A	7	6	13	0	1	14	0	0
16	38198836	.	A	T	12	12	24	0	0	24	0	0
16	38199369	.	T	A	2	5	7	0	0	7	0	0
16	38251932	.	T	C	1	0	1	0	0	1	0	0
16	38266188	.	T	A	2	2	4	0	1	5	0	0
16	38313176	.	G	T	1	3	4	0	0	4	0	0
16	38351061	.	T	A	1	2	3	0	0	3	0	0
16	38354134	.	A	G	4	7	11	0	0	11	0	0
16	38454783	.	T	A	3	4	7	0	0	7	0	0
16	38499053	.	C	T	0	2	2	0	6	8	0	0
16	38553647	.	C	T	3	1	4	0	0	4	0	0
16	38568644	.	G	C	13	6	19	0	3	22	0	0
16	38590735	.	A	C	3	3	6	0	1	7	0	0
16	38626434	.	T	C	3	3	6	0	0	6	0	0
16	38663163	.	G	A	1	3	4	0	8	12	0	0
16	38729551	.	G	T	2	5	7	0	4	11	0	0
16	38940811	.	T	G	4	4	8	0	1	9	0	0
16	39146808	.	G	A	2	3	5	0	0	5	0	0
16	39146871	.	A	C	10	9	19	0	2	21	0	0
16	39147386	.	C	A	0	1	1	0	0	1	0	0
16	39157751	.	C	A	13	23	36	0	0	36	0	0
16	39157885	.	T	A	1	3	4	0	1	5	0	0
16	39160445	.	C	T	5	11	16	0	1	17	0	0
16	39166299	.	G	T	16	25	41	0	1	42	0	0
16	39166422	.	G	A	0	15	15	0	25	40	0	0
16	39166591	.	G	A	16	23	39	0	0	39	0	0
16	39166773	.	C	T	18	18	36	0	2	38	0	0
16	39166854	.	C	T	19	32	51	0	4	55	0	0
16	39167028	.	C	A	18	11	29	0	1	30	0	0
16	39167088	.	C	T	7	5	12	0	1	13	0	0
16	39185271	.	T	G	0	4	4	0	0	4	0	0
16	39190767	.	T	G	6	5	11	0	0	11	0	0
16	39191557	.	T	C	2	0	2	0	5	7	0	0
16	39194303	.	A	G	1	3	4	0	0	4	0	0
16	39213314	.	G	A	3	2	5	0	0	5	0	0
16	39238437	.	A	C	6	0	6	0	4	10	0	0
16	39245587	.	C	A	8	10	18	0	0	18	0	0
16	39249184	.	A	G	6	5	11	0	0	11	0	0
16	39267151	.	T	C	1	2	3	0	0	3	0	0
16	39267164	.	T	A	1	2	3	0	0	3	0	0
16	39271394	.	G	C	3	2	5	0	0	5	0	0
16	39271438	.	A	G	3	4	7	0	0	7	0	0
16	39287126	.	G	T	1	2	3	0	0	3	0	0
16	39325121	.	G	A	2	2	4	0	0	4	0	0
16	39361889	.	C	T	3	3	6	0	1	7	0	0
16	39362147	.	C	A	2	4	6	0	1	7	0	0
16	39372345	.	G	A	10	6	16	0	1	17	0	0
16	39372372	.	T	C	9	8	17	0	1	18	0	0
16	39372735	.	G	C	0	11	11	0	9	20	0	0
16	39372780	.	C	A	6	8	14	0	1	15	0	0
16	39382047	.	C	G	14	8	22	0	0	22	0	0
16	39382226	.	G	A	3	6	9	0	0	9	0	0
16	39382467	.	C	G	2	4	6	0	0	6	0	0
16	39385755	.	T	C	12	0	12	0	11	23	0	0
16	39386920	.	C	T	0	18	18	0	13	31	0	0
16	39393370	.	A	G	0	8	8	0	1	9	0	0
16	39394581	.	A	G	5	6	11	0	0	11	0	0
16	39396983	.	C	T	0	7	7	0	3	10	0	0
16	39413496	.	T	C	6	7	13	0	0	13	0	0
16	39413514	.	C	T	3	4	7	0	0	7	0	0
16	39505190	.	A	C	2	4	6	0	0	6	0	0
16	39505447	.	C	T	0	3	3	0	4	7	0	0
16	39901274	.	G	A	5	4	9	0	0	9	0	0
16	39901290	.	C	A	6	3	9	0	0	9	0	0
16	39901344	.	C	T	0	2	2	0	2	4	0	0
16	40025019	.	A	G	1	1	2	0	2	4	0	0
16	40025025	.	T	G	2	1	3	0	0	3	0	0
16	40026573	.	A	G	1	0	1	0	2	3	0	0
16	40031649	.	A	G	3	8	11	0	2	13	0	0
16	40340844	.	C	A	2	3	5	0	0	5	0	0
16	40340847	.	A	G	2	0	2	0	3	5	0	0
16	40340967	.	A	G	4	2	6	0	0	6	0	0
16	40341255	.	C	G	1	3	4	0	1	5	0	0
16	40343465	.	G	A	4	3	7	0	1	8	0	0
16	40343482	.	A	G	4	5	9	0	0	9	0	0
16	40346775	.	T	G	0	1	1	0	0	1	0	0
16	40426076	.	A	T	1	2	3	0	0	3	0	0
16	40426272	.	G	A	1	3	4	0	0	4	0	0
16	40426284	.	T	C	2	3	5	0	0	5	0	0
16	40426311	.	A	G	2	2	4	0	0	4	0	0
16	40503994	.	G	A	3	4	7	0	0	7	0	0
16	40508911	.	A	G	2	0	2	0	2	4	0	0
16	40530062	.	T	C	2	1	3	0	0	3	0	0
16	40541340	.	T	C	2	3	5	0	0	5	0	0
16	40541345	.	A	G	3	2	5	0	0	5	0	0
16	40541839	.	C	T	1	2	3	0	0	3	0	0
16	40560713	.	C	T	4	4	8	0	0	8	0	0
16	40563673	.	G	T	3	4	7	0	0	7	0	0
16	40568274	.	G	A	1	2	3	0	3	6	0	0
16	40568336	.	A	G	5	0	5	0	5	10	0	0
16	40569129	.	T	A	2	3	5	0	1	6	0	0
16	40569130	.	G	A	3	3	6	0	0	6	0	0
16	40569264	.	T	C	4	6	10	0	2	12	0	0
16	40569285	.	T	C	6	7	13	0	0	13	0	0
16	40569701	.	T	G	4	7	11	0	0	11	0	0
16	40583149	.	C	A	1	2	3	0	0	3	0	0
16	40594146	.	G	A	2	7	9	0	0	9	0	0
16	40594224	.	A	G	2	3	5	0	1	6	0	0
16	40594590	.	G	C	1	0	1	0	0	1	0	0
16	40597763	.	T	C	1	0	1	0	0	1	0	0
16	40602823	.	G	A	2	2	4	0	0	4	0	0
16	40602886	.	G	A	3	2	5	0	0	5	0	0
16	40607351	.	T	A	3	3	6	0	0	6	0	0
16	40609954	.	T	G	4	3	7	0	1	8	0	0
16	40610018	.	G	C	1	1	2	0	0	2	0	0
16	40610727	.	C	T	2	5	7	0	0	7	0	0
16	40632736	.	T	C	1	3	4	0	0	4	0	0
16	40632787	.	A	C	1	0	1	0	3	4	0	0
16	40633120	.	C	T	2	2	4	0	0	4	0	0
16	40633323	.	T	C	1	0	1	0	2	3	0	0
16	41685319	.	T	C	3	0	3	0	2	5	0	0
16	42940490	.	T	C	2	3	5	0	0	5	0	0
16	43227842	.	C	T	1	3	4	0	0	4	0	0
16	43291844	.	A	G	4	2	6	0	0	6	0	0
16	44984622	.	A	G	1	2	3	0	0	3	0	0
16	46200745	.	A	G	46	12	58	0	3	61	0	0
16	46464090	.	A	C	0	7	7	0	0	7	0	0
16	46464219	.	G	A	18	5	23	0	0	23	0	0
16	46464279	.	G	A	19	5	24	0	0	24	0	0
16	46464423	.	A	G	1	2	3	0	2	5	0	0
16	48565712	.	T	C	0	4	4	0	0	4	0	0
16	50124874	.	T	C	2	1	3	0	0	3	0	0
16	51183892	.	A	T	8	3	11	0	0	11	0	0
16	51244487	.	T	C	1	3	4	0	1	5	0	0
16	51244500	.	T	C	3	2	5	0	0	5	0	0
16	51559527	.	C	T	3	7	10	0	0	10	0	0
16	51950940	.	G	A	2	40	42	0	3	45	0	0
16	51951690	.	T	C	8	18	26	0	2	28	0	0
16	51951691	.	T	C	19	9	28	0	0	28	0	0
16	51952711	.	T	C	13	6	19	0	0	19	0	0
16	52105324	.	G	A	0	2	2	0	0	2	0	0
16	52208238	.	C	T	1	1	2	0	0	2	0	0
16	52214476	.	C	T	6	6	12	0	0	12	0	0
16	52218769	.	C	T	4	2	6	0	0	6	0	0
16	52218876	.	C	G	1	1	2	0	0	2	0	0
16	52223760	.	C	G	2	2	4	0	0	4	0	0
16	53152935	.	C	T	1	1	2	0	0	2	0	0
16	53191089	.	T	C	0	1	1	0	0	1	0	0
16	53213713	.	C	T	1	2	3	0	0	3	0	0
16	53224473	.	G	C	0	3	3	0	3	6	0	0
16	53224629	.	C	T	6	2	8	0	1	9	0	0
16	53247109	.	T	A	3	2	5	0	0	5	0	0
16	53278406	.	A	G	1	0	1	0	3	4	0	0
16	53278513	.	A	G	8	0	8	0	12	20	0	0
16	53290842	.	G	A	0	2	2	0	4	6	0	0
16	53408619	.	C	T	2	4	6	0	0	6	0	0
16	53443714	.	C	T	0	3	3	0	0	3	0	0
16	53443724	.	G	T	0	0	0	0	3	3	0	0
16	53449751	.	C	T	1	2	3	0	0	3	0	0
16	53449943	.	T	C	2	2	4	0	0	4	0	0
16	53451141	.	A	G	1	4	5	0	0	5	0	0
16	53495455	.	G	A	0	5	5	0	8	13	0	0
16	53495521	.	C	T	11	5	16	0	0	16	0	0
16	53502390	.	C	T	3	2	5	0	0	5	0	0
16	53513549	.	C	T	7	6	13	0	0	13	0	0
16	53513618	.	C	G	5	0	5	0	5	10	0	0
16	53516147	.	T	G	12	10	22	0	2	24	0	0
16	53516232	.	G	A	17	11	28	0	4	32	0	0
16	53516303	.	T	C	5	5	10	0	0	10	0	0
16	53529665	.	T	C	4	2	6	0	1	7	0	0
16	53530490	.	A	T	6	7	13	0	0	13	0	0
16	53539389	.	G	A	1	4	5	0	0	5	0	0
16	53539399	.	T	C	2	0	2	0	0	2	0	0
16	53541879	.	A	G	8	3	11	0	1	12	0	0
16	53541963	.	T	A	5	6	11	0	0	11	0	0
16	53586329	.	G	C	0	4	4	0	0	4	0	0
16	53586351	.	T	C	5	1	6	3	0	9	0	0
16	53590609	.	C	T	1	4	5	0	0	5	0	0
16	53591872	.	G	A	11	4	15	0	1	16	0	0
16	53591908	.	C	G	5	8	13	0	0	13	0	0
16	53592058	.	T	A	16	6	22	0	0	22	0	0
16	53596872	.	C	T	2	4	6	0	0	6	0	0
16	53601486	.	A	G	3	1	4	0	11	15	0	0
16	53609415	.	A	G	0	1	1	0	0	1	0	0
16	53610144	.	C	T	3	1	4	0	0	4	0	0
16	53621578	.	A	G	0	0	0	0	3	3	0	0
16	53626805	.	C	T	1	1	2	0	0	2	0	0
16	53626853	.	T	C	2	1	3	0	0	3	0	0
16	53701171	.	A	C	6	8	14	0	3	17	0	0
16	53708312	.	C	G	31	34	65	0	5	70	0	0
16	53708537	.	G	T	5	2	7	0	0	7	0	0
16	53708564	.	T	C	3	2	5	0	0	5	0	0
16	53733920	.	C	A	0	4	4	0	1	5	0	0
16	53734303	.	A	G	2	2	4	0	0	4	0	0
16	53734454	.	G	T	2	3	5	0	0	5	0	0
16	53734522	.	A	C	2	3	5	0	0	5	0	0
16	54186911	.	C	T	0	1	1	0	0	1	0	0
16	54209554	.	A	G	0	2	2	0	0	2	0	0
16	54217347	.	A	C	0	2	2	0	0	2	0	0
16	54217408	.	G	A	0	2	2	0	1	3	0	0
16	54222382	.	C	T	2	6	8	0	0	8	0	0
16	54222433	.	T	C	4	7	11	0	1	12	0	0
16	54222448	.	G	A	3	7	10	0	1	11	0	0
16	54245580	.	T	A	3	5	8	0	1	9	0	0
16	54245609	.	C	T	2	5	7	0	0	7	0	0
16	54245777	.	G	A	3	3	6	0	0	6	0	0
16	54245781	.	T	A	3	2	5	0	1	6	0	0
16	54245812	.	T	C	2	4	6	0	0	6	0	0
16	54245832	.	A	C	2	3	5	0	0	5	0	0
16	54303499	.	G	A	1	6	7	0	0	7	0	0
16	54303742	.	G	C	4	3	7	0	0	7	0	0
16	54313643	.	T	A	0	1	1	0	0	1	0	0
16	54314463	.	C	G	1	1	2	0	0	2	0	0
16	54320243	.	A	G	4	5	9	0	0	9	0	0
16	54829650	.	C	T	23	28	51	0	3	54	0	0
16	54829656	.	A	G	22	29	51	0	2	53	0	0
16	54837250	.	T	C	11	6	17	0	1	18	0	0
16	54843723	.	C	T	27	39	66	0	3	69	0	0
16	54843798	.	A	G	12	3	15	0	24	39	0	0
16	54846250	.	G	A	0	2	2	0	9	11	0	0
16	54930903	.	A	G	2	3	5	0	2	7	0	0
16	54930916	.	T	A	3	2	5	0	0	5	0	0
16	54932914	.	C	A	3	2	5	0	0	5	0	0
16	54947978	.	G	A	7	5	12	0	0	12	0	0
16	54948227	.	A	G	8	7	15	0	0	15	0	0
16	54948369	.	T	A	5	6	11	0	1	12	0	0
16	54948467	.	C	A	3	4	7	0	0	7	0	0
16	54948483	.	T	A	2	3	5	0	1	6	0	0
16	54948571	.	T	C	2	4	6	0	1	7	0	0
16	54949140	.	G	A	9	16	25	0	1	26	0	0
16	54952935	.	G	A	5	4	9	0	1	10	0	0
16	54953031	.	C	T	0	10	10	0	8	18	0	0
16	54953067	.	G	A	5	3	8	0	0	8	0	0
16	54956620	.	C	T	7	4	11	0	1	12	0	0
16	54956777	.	T	C	4	2	6	0	0	6	0	0
16	54957387	.	A	G	2	1	3	0	0	3	0	0
16	54957388	.	C	G	2	1	3	0	0	3	0	0
16	54958913	.	G	A	1	0	1	0	0	1	0	0
16	54960951	.	A	C	6	6	12	0	0	12	0	0
16	54964146	.	A	G	4	4	8	0	0	8	0	0
16	55004655	.	A	T	4	6	10	0	0	10	0	0
16	55004716	.	T	C	7	0	7	0	11	18	0	0
16	55007670	.	G	A	11	6	17	0	0	17	0	0
16	55078485	.	T	C	1	6	7	0	0	7	0	0
16	55090853	.	G	T	7	2	9	0	0	9	0	0
16	55095633	.	T	C	1	4	5	0	0	5	0	0
16	55102467	.	G	A	6	1	7	0	3	10	0	0
16	55102568	.	T	C	1	6	7	0	0	7	0	0
16	55102608	.	T	C	3	3	6	0	1	7	0	0
16	55106058	.	T	A	5	7	12	0	0	12	0	0
16	55106111	.	A	C	2	5	7	0	2	9	0	0
16	55106206	.	T	C	15	1	16	0	0	16	0	0
16	55106207	.	T	C	12	4	16	0	0	16	0	0
16	55106279	.	C	A	15	19	34	0	0	34	0	0
16	55106367	.	A	C	19	13	32	0	0	32	0	0
16	55106405	.	G	A	12	3	15	0	0	15	0	0
16	55106443	.	C	T	0	5	5	0	1	6	0	0
16	55106474	.	C	T	0	11	11	0	3	14	0	0
16	55108828	.	C	T	5	8	13	0	0	13	0	0
16	55122779	.	T	C	9	14	23	0	2	25	0	0
16	55181458	.	C	A	2	4	6	0	0	6	0	0
16	55181459	.	C	G	1	4	5	0	1	6	0	0
16	55181565	.	G	A	0	2	2	0	3	5	0	0
16	55182146	.	T	G	3	2	5	0	0	5	0	0
16	55182217	.	G	A	2	2	4	0	0	4	0	0
16	55182249	.	A	T	1	2	3	0	0	3	0	0
17	69894	.	A	G	1	1	2	0	1	3	0	0
17	70497	.	G	C	8	6	14	0	0	14	0	0
17	70668	.	A	G	3	0	3	0	4	7	0	0
17	71012	.	A	T	4	5	9	0	1	10	0	0
17	71063	.	T	C	8	3	11	0	0	11	0	0
17	118732	.	A	G	1	1	2	0	1	3	0	0
17	132695	.	G	A	4	3	7	0	0	7	0	0
17	132932	.	A	C	3	4	7	0	0	7	0	0
17	133001	.	C	G	4	5	9	0	0	9	0	0
17	133232	.	G	A	0	2	2	0	4	6	0	0
17	136304	.	A	G	2	3	5	0	0	5	0	0
17	136599	.	G	A	14	6	20	0	0	20	0	0
17	338188	.	C	A	6	2	8	0	0	8	0	0
17	338443	.	A	C	4	5	9	0	0	9	0	0
17	338449	.	G	T	4	4	8	0	0	8	0	0
17	346672	.	A	C	4	2	6	0	0	6	0	0
17	347016	.	A	G	3	0	3	0	2	5	0	0
17	585963	.	G	A	0	3	3	0	1	4	0	0
17	599913	.	T	A	5	6	11	0	0	11	0	0
17	600039	.	A	T	6	2	8	0	1	9	0	0
17	601550	.	A	G	5	1	6	0	0	6	0	0
17	604766	.	A	T	3	2	5	0	0	5	0	0
17	604796	.	A	G	4	1	5	0	1	6	0	0
17	604853	.	G	A	3	5	8	0	1	9	0	0
17	604934	.	T	G	6	5	11	0	0	11	0	0
17	604955	.	A	G	4	6	10	0	1	11	0	0
17	605332	.	G	A	4	4	8	0	0	8	0	0
17	635311	.	C	T	1	3	4	0	0	4	0	0
17	635319	.	G	A	2	3	5	0	0	5	0	0
17	636178	.	C	T	0	1	1	0	0	1	0	0
17	636796	.	C	A	2	3	5	0	0	5	0	0
17	645486	.	T	C	1	0	1	0	0	1	0	0
17	660617	.	C	A	1	24	25	0	15	40	0	0
17	681127	.	G	A	12	17	29	0	1	30	0	0
17	707248	.	A	G	1	2	3	0	0	3	0	0
17	734235	.	T	C	16	1	17	0	10	27	0	0
17	734244	.	T	C	15	8	23	0	0	23	0	0
17	734492	.	T	C	7	0	7	0	6	13	0	0
17	735297	.	C	G	0	0	0	0	2	2	0	0
17	735472	.	G	A	5	2	7	0	0	7	0	0
17	735511	.	T	C	7	0	7	0	4	11	0	0
17	735520	.	G	A	4	4	8	0	0	8	0	0
17	742225	.	C	T	4	7	11	0	0	11	0	0
17	742274	.	A	T	9	6	15	0	0	15	0	0
17	743576	.	T	A	12	7	19	0	0	19	0	0
17	743851	.	C	A	15	17	32	0	0	32	0	0
17	860186	.	T	C	5	1	6	0	6	12	0	0
17	860339	.	G	A	9	10	19	0	1	20	0	0
17	860451	.	C	G	7	13	20	0	0	20	0	0
17	860501	.	G	A	8	15	23	0	0	23	0	0
17	860645	.	C	T	0	10	10	0	9	19	0	0
17	860704	.	G	A	6	7	13	0	1	14	0	0
17	860852	.	A	G	10	5	15	0	0	15	0	0
17	861065	.	G	A	5	5	10	0	0	10	0	0
17	867178	.	T	G	0	2	2	0	0	2	0	0
17	867190	.	T	C	1	3	4	0	0	4	0	0
17	867896	.	G	T	7	7	14	0	2	16	0	0
17	923611	.	A	G	7	3	10	0	0	10	0	0
17	927187	.	A	G	6	7	13	0	0	13	0	0
17	931976	.	G	T	3	4	7	0	0	7	0	0
17	932270	.	G	A	7	5	12	0	0	12	0	0
17	932759	.	A	G	7	3	10	0	0	10	0	0
17	932789	.	G	C	4	3	7	0	0	7	0	0
17	932858	.	C	A	1	5	6	0	5	11	0	0
17	933002	.	A	G	1	1	2	0	0	2	0	0
17	936203	.	G	A	2	4	6	0	1	7	0	0
17	937642	.	A	G	3	5	8	0	0	8	0	0
17	939749	.	A	G	8	1	9	0	2	11	0	0
17	939806	.	C	T	1	4	5	0	0	5	0	0
17	940742	.	C	T	2	0	2	0	0	2	0	0
17	945704	.	G	C	3	1	4	0	7	11	0	0
17	945731	.	T	C	4	8	12	0	0	12	0	0
17	945812	.	C	T	2	7	9	0	7	16	0	0
17	973958	.	A	G	4	3	7	0	0	7	0	0
17	974775	.	C	T	0	2	2	0	0	2	0	0
17	974838	.	G	T	5	4	9	0	2	11	0	0
17	979925	.	A	T	8	13	21	0	2	23	0	0
17	1141376	.	G	T	0	1	1	0	0	1	0	0
17	1141380	.	G	A	1	0	1	0	0	1	0	0
17	1174853	.	C	T	0	2	2	0	0	2	0	0
17	1258380	.	C	T	2	2	4	0	0	4	0	0
17	1354412	.	A	G	2	2	4	0	0	4	0	0
17	1360292	.	G	T	0	1	1	0	1	2	0	0
17	1362172	.	C	T	0	1	1	0	0	1	0	0
17	1362295	.	G	T	0	2	2	0	1	3	0	0
17	1527642	.	T	C	1	2	3	0	0	3	0	0
17	1585156	.	G	T	1	2	3	0	0	3	0	0
17	1590741	.	T	C	2	3	5	0	0	5	0	0
17	1591201	.	T	C	3	3	6	0	0	6	0	0
17	1591245	.	A	G	1	2	3	0	0	3	0	0
17	1602351	.	T	A	0	1	1	0	0	1	0	0
17	1603491	.	A	G	0	0	0	0	1	1	0	0
17	1605946	.	T	C	2	3	5	0	0	5	0	0
17	1664989	.	C	T	0	2	2	0	0	2	0	0
17	1704833	.	T	C	1	0	1	0	2	3	0	0
17	2063925	.	A	G	23	25	48	0	3	51	0	0
17	2091858	.	G	A	0	3	3	0	5	8	0	0
17	2095454	.	T	C	9	13	22	0	3	25	0	0
17	2095525	.	A	G	13	0	13	0	38	51	0	0
17	2109014	.	C	T	0	14	14	0	5	19	0	0
17	2110588	.	G	A	16	9	25	0	1	26	0	0
17	2110642	.	C	G	9	14	23	0	1	24	0	0
17	2110657	.	T	C	8	0	8	0	18	26	0	0
17	2115464	.	A	T	2	4	6	0	0	6	0	0
17	2121955	.	T	A	0	3	3	0	0	3	0	0
17	2122175	.	A	G	4	5	9	0	0	9	0	0
17	2122252	.	C	T	11	15	26	0	0	26	0	0
17	2226867	.	T	C	2	3	5	0	0	5	0	0
17	2226876	.	T	C	2	3	5	0	0	5	0	0
17	2226906	.	A	T	4	4	8	0	0	8	0	0
17	2226957	.	A	G	1	2	3	0	0	3	0	0
17	2231485	.	T	C	2	4	6	0	0	6	0	0
17	2231608	.	T	C	0	2	2	0	0	2	0	0
17	2231611	.	T	A	0	2	2	0	0	2	0	0
17	2239799	.	C	G	1	1	2	0	0	2	0	0
17	2242754	.	T	C	3	1	4	0	0	4	0	0
17	2369970	.	C	T	0	1	1	0	0	1	0	0
17	2373940	.	T	C	0	0	0	0	1	1	0	0
17	2374070	.	T	C	0	0	0	0	3	3	0	0
17	2479620	.	C	A	3	4	7	0	0	7	0	0
17	2498487	.	T	C	3	1	4	0	0	4	0	0
17	2498572	.	C	T	5	5	10	0	0	10	0	0
17	2498573	.	C	G	5	5	10	0	0	10	0	0
17	2498615	.	C	G	2	0	2	0	0	2	0	0
17	2698146	.	A	G	4	3	7	0	0	7	0	0
17	2705815	.	A	G	0	2	2	0	0	2	0	0
17	2705834	.	T	G	0	3	3	0	0	3	0	0
17	2705875	.	G	C	0	2	2	0	0	2	0	0
17	2902815	.	G	T	7	8	15	0	0	15	0	0
17	2902880	.	A	G	6	4	10	0	0	10	0	0
17	2902911	.	T	G	4	2	6	0	0	6	0	0
17	2903230	.	T	A	1	3	4	0	0	4	0	0
17	2903237	.	A	G	0	3	3	0	0	3	0	0
17	2903355	.	T	C	1	2	3	0	0	3	0	0
17	2903388	.	T	C	2	0	2	0	2	4	0	0
17	2905019	.	A	G	6	4	10	0	0	10	0	0
17	2905049	.	T	A	6	3	9	0	1	10	0	0
17	3184594	.	G	A	3	2	5	0	0	5	0	0
17	3189790	.	G	A	1	3	4	0	0	4	0	0
17	3189916	.	G	A	1	2	3	0	0	3	0	0
17	3281934	.	A	G	1	7	8	0	0	8	0	0
17	3282028	.	G	A	2	2	4	0	0	4	0	0
17	3282034	.	G	A	2	2	4	0	0	4	0	0
17	3282394	.	A	G	5	2	7	0	0	7	0	0
17	3288101	.	A	G	6	4	10	0	0	10	0	0
17	3290700	.	A	G	3	5	8	0	0	8	0	0
17	3446847	.	T	C	6	4	10	0	1	11	0	0
17	3514131	.	C	T	4	1	5	0	1	6	0	0
17	3529998	.	C	T	0	1	1	0	0	1	0	0
17	3530031	.	C	T	3	5	8	0	0	8	0	0
17	3530178	.	G	C	0	1	1	0	0	1	0	0
17	3569169	.	A	G	8	11	19	0	1	20	0	0
17	3854266	.	T	C	8	7	15	0	2	17	0	0
17	3854290	.	C	T	9	10	19	0	0	19	0	0
17	3854347	.	C	G	0	8	8	0	0	8	0	0
17	3855436	.	T	C	10	0	10	0	7	17	0	0
17	3870739	.	T	A	3	2	5	0	0	5	0	0
17	3970905	.	C	T	0	2	2	0	1	3	0	0
17	3986204	.	A	G	4	5	9	0	0	9	0	0
17	3994649	.	A	G	2	0	2	0	0	2	0	0
17	4009449	.	T	C	0	1	1	0	0	1	0	0
17	4017237	.	T	C	2	2	4	0	0	4	0	0
17	4017271	.	G	A	3	3	6	0	0	6	0	0
17	4017277	.	T	C	3	3	6	0	0	6	0	0
17	4017321	.	A	G	2	3	5	0	0	5	0	0
17	4227454	.	C	T	0	2	2	0	0	2	0	0
17	4227463	.	C	T	0	2	2	0	0	2	0	0
17	4231530	.	G	C	2	2	4	0	0	4	0	0
17	4239975	.	C	T	2	15	17	0	0	17	0	0
17	4240253	.	C	T	0	4	4	0	14	18	0	0
17	4240385	.	T	A	2	2	4	0	1	5	0	0
17	4297546	.	C	T	17	13	30	0	2	32	0	0
17	4297780	.	T	A	4	2	6	0	0	6	0	0
17	4298221	.	T	A	25	11	36	0	5	42	1	0
17	4298349	.	T	A	18	9	27	2	5	34	0	0
17	4298768	.	T	G	3	11	14	0	0	14	0	0
17	4298945	.	G	A	19	9	28	0	0	28	0	0
17	4298990	.	A	G	13	16	29	0	2	31	0	0
17	4298996	.	C	T	15	17	32	0	3	35	0	0
17	4299031	.	C	T	14	21	35	0	2	37	0	0
17	4307164	.	G	A	11	5	16	0	1	17	0	0
17	4317738	.	G	A	7	4	11	0	0	11	0	0
17	4368900	.	T	A	6	1	7	0	0	7	0	0
17	4368968	.	G	A	6	4	10	0	0	10	0	0
17	4369304	.	T	C	5	5	10	0	0	10	0	0
17	4369403	.	G	A	0	3	3	0	5	8	0	0
17	4378219	.	C	T	2	1	3	0	0	3	0	0
17	5061184	.	G	C	12	4	16	0	1	17	0	0
17	5071257	.	G	A	0	1	1	0	0	1	0	0
17	5079706	.	C	T	4	1	5	0	0	5	0	0
17	5081445	.	G	A	0	11	11	0	23	34	0	0
17	5084892	.	G	A	13	22	35	0	1	36	0	0
17	5087222	.	G	A	14	6	20	0	1	21	0	0
17	5090829	.	G	A	0	9	9	0	18	27	0	0
17	5090871	.	T	C	21	9	30	0	2	32	0	0
17	5090919	.	C	T	7	5	12	0	0	12	0	0
17	5090922	.	G	A	0	5	5	0	7	12	0	0
17	5091108	.	T	C	4	3	7	0	0	7	0	0
17	5094330	.	T	A	10	7	17	0	1	18	0	0
17	5094355	.	T	C	12	15	27	0	2	29	0	0
17	5096691	.	T	C	21	17	38	0	4	42	0	0
17	5101234	.	A	G	15	0	15	0	8	23	0	0
17	5105702	.	T	A	17	9	26	0	1	27	0	0
17	5105828	.	T	C	10	10	20	0	0	20	0	0
17	5239046	.	C	T	0	1	1	0	1	2	0	0
17	6394928	.	C	T	1	7	8	0	0	8	0	0
17	6808341	.	A	G	8	6	14	0	0	14	0	0
17	6808406	.	A	G	3	5	8	0	1	9	0	0
17	6808796	.	A	G	6	21	27	0	1	28	0	0
17	7781255	.	T	A	1	3	4	0	0	4	0	0
17	7781263	.	A	G	1	2	3	0	0	3	0	0
17	7781305	.	G	T	3	3	6	0	0	6	0	0
17	7781333	.	C	T	3	2	5	0	0	5	0	0
17	7781413	.	G	A	2	3	5	0	0	5	0	0
17	7781458	.	T	A	3	3	6	0	0	6	0	0
17	7789643	.	A	G	1	2	3	0	0	3	0	0
17	7795583	.	T	A	3	2	5	0	1	6	0	0
17	7799980	.	A	G	3	0	3	0	1	4	0	0
17	7815212	.	C	T	1	5	6	0	0	6	0	0
17	7815360	.	T	C	2	0	2	0	4	6	0	0
17	7818872	.	T	A	0	3	3	0	2	5	0	0
17	7835058	.	G	A	0	0	0	0	1	1	0	0
17	7841786	.	G	T	2	3	5	0	1	6	0	0
17	7845085	.	T	A	8	5	13	0	1	14	0	0
17	7845288	.	A	G	8	4	12	0	0	12	0	0
17	7845364	.	G	C	16	15	31	0	1	32	0	0
17	7845412	.	T	C	14	14	28	0	0	28	0	0
17	7845566	.	C	T	20	9	29	0	0	29	0	0
17	7845604	.	G	A	20	16	36	0	0	36	0	0
17	7845661	.	G	T	20	17	37	0	0	37	0	0
17	7845733	.	G	A	20	22	42	0	1	43	0	0
17	7845776	.	C	G	0	19	19	0	15	34	0	0
17	7845800	.	A	G	8	15	23	0	2	25	0	0
17	7861124	.	C	T	14	18	32	0	0	32	0	0
17	7868632	.	G	A	2	1	3	0	0	3	0	0
17	7879327	.	C	G	5	2	7	0	0	7	0	0
17	7882941	.	G	A	13	11	24	0	0	24	0	0
17	7882998	.	G	A	15	17	32	0	1	33	0	0
17	7883016	.	C	T	12	14	26	0	0	26	0	0
17	7885635	.	G	A	4	9	13	0	0	13	0	0
17	7885662	.	A	G	6	12	18	0	2	20	0	0
17	7888351	.	G	A	9	7	16	0	0	16	0	0
17	7888369	.	G	A	17	11	28	0	1	29	0	0
17	7896340	.	G	A	12	7	19	0	0	19	0	0
17	7896356	.	C	T	0	15	15	0	9	24	0	0
17	7902203	.	A	G	3	2	5	0	0	5	0	0
17	7906612	.	G	A	8	7	15	0	0	15	0	0
17	7910537	.	C	T	9	14	23	0	1	24	0	0
17	7917414	.	T	A	10	13	23	0	0	23	0	0
17	7917997	.	G	A	1	2	3	0	0	3	0	0
17	7918075	.	C	T	7	3	10	0	2	12	0	0
17	7918244	.	C	T	0	10	10	0	9	19	0	0
17	7918310	.	C	T	0	9	9	0	7	16	0	0
17	7924263	.	G	A	2	2	4	0	1	5	0	0
17	7928615	.	T	G	6	3	9	0	0	9	0	0
17	7929597	.	T	C	5	3	8	0	0	8	0	0
17	7931722	.	T	A	0	1	1	0	0	1	0	0
17	7931737	.	G	A	1	2	3	0	0	3	0	0
17	7942122	.	G	A	3	5	8	0	0	8	0	0
17	7942127	.	T	C	3	5	8	0	0	8	0	0
17	7942191	.	T	G	6	0	6	0	0	6	0	0
17	7942375	.	C	T	1	5	6	0	1	7	0	0
17	7945421	.	C	G	7	3	10	0	2	12	0	0
17	7945485	.	A	G	0	2	2	0	0	2	0	0
17	7949066	.	G	A	4	9	13	0	1	14	0	0
17	7949119	.	G	T	1	8	9	0	1	10	0	0
17	7950339	.	G	T	2	4	6	0	0	6	0	0
17	7974804	.	T	C	3	7	10	0	0	10	0	0
17	7981566	.	C	T	5	11	16	0	1	17	0	0
17	7985633	.	G	C	2	4	6	0	0	6	0	0
17	7985970	.	C	T	0	3	3	0	4	7	0	0
17	7988467	.	C	T	0	3	3	0	3	6	0	0
17	7994305	.	A	G	2	0	2	0	0	2	0	0
17	8000122	.	C	A	1	4	5	0	0	5	0	0
17	8002895	.	G	T	3	0	3	0	0	3	0	0
17	8003009	.	G	A	5	2	7	0	0	7	0	0
17	8003027	.	T	C	4	4	8	0	0	8	0	0
17	8003165	.	G	T	0	3	3	0	0	3	0	0
17	8006088	.	C	T	0	3	3	0	0	3	0	0
17	8006696	.	T	C	4	2	6	0	1	7	0	0
17	8014187	.	G	A	1	4	5	0	0	5	0	0
17	8019852	.	G	A	0	1	1	0	0	1	0	0
17	8022620	.	C	G	0	1	1	0	0	1	0	0
17	8024338	.	C	T	1	2	3	0	0	3	0	0
17	8024551	.	G	A	2	4	6	0	0	6	0	0
17	8036086	.	T	C	3	0	3	0	2	5	0	0
17	8042133	.	G	A	1	1	2	0	0	2	0	0
17	8042148	.	G	A	1	0	1	0	0	1	0	0
17	8045475	.	C	T	1	3	4	0	0	4	0	0
17	8045486	.	C	T	1	3	4	0	0	4	0	0
17	8045540	.	T	C	3	2	5	0	0	5	0	0
17	8046725	.	C	T	0	1	1	0	0	1	0	0
17	8052960	.	T	C	1	0	1	0	0	1	0	0
17	8064770	.	G	A	2	2	4	0	0	4	0	0
17	8064830	.	T	C	1	2	3	0	0	3	0	0
17	8066418	.	C	T	1	1	2	0	0	2	0	0
17	8078652	.	C	T	0	1	1	0	0	2	1	0
17	8094875	.	A	T	0	2	2	0	0	2	0	0
17	8179098	.	C	T	1	2	3	0	0	3	0	0
17	8184435	.	A	G	7	0	7	0	7	14	0	0
17	8184515	.	A	T	3	9	12	0	0	12	0	0
17	8188963	.	G	T	0	5	5	0	4	9	0	0
17	8191370	.	C	A	3	5	8	0	0	8	0	0
17	8191382	.	C	A	5	4	9	0	0	9	0	0
17	8191475	.	A	G	3	7	10	0	0	10	0	0
17	8194715	.	C	A	3	2	5	0	1	6	0	0
17	8197141	.	G	A	2	1	3	0	0	3	0	0
17	8197569	.	C	A	3	6	9	0	1	10	0	0
17	8199812	.	C	T	2	4	6	0	0	6	0	0
17	8202778	.	T	C	21	10	31	0	1	32	0	0
17	8203231	.	T	A	17	16	33	0	3	36	0	0
17	8203234	.	G	A	17	12	29	0	5	34	0	0
17	8203471	.	C	T	8	13	21	0	2	23	0	0
17	8203498	.	G	A	10	15	25	0	1	26	0	0
17	8203729	.	T	C	18	8	26	0	0	26	0	0
17	8204086	.	G	C	11	11	22	0	0	22	0	0
17	8204248	.	A	G	8	0	8	0	19	27	0	0
17	8204533	.	C	T	13	14	27	0	0	27	0	0
17	8204755	.	A	G	19	25	44	0	2	46	0	0
17	8204818	.	A	G	17	14	31	0	3	34	0	0
17	8204962	.	C	T	25	15	40	0	1	41	0	0
17	8205508	.	T	C	10	18	28	0	2	30	0	0
17	8209686	.	A	G	18	6	24	0	1	25	0	0
17	8209931	.	C	A	13	12	25	0	0	25	0	0
17	8210327	.	A	T	12	13	25	0	1	26	0	0
17	8210355	.	T	A	15	10	25	0	0	25	0	0
17	8210365	.	C	T	15	12	27	0	0	27	0	0
17	8210415	.	C	A	7	13	20	0	0	20	0	0
17	8210552	.	A	G	10	12	22	0	0	22	0	0
17	8210596	.	A	C	14	13	27	0	1	28	0	0
17	8210801	.	C	T	13	15	28	0	0	28	0	0
17	8230126	.	G	A	0	2	2	0	1	3	0	0
17	8230135	.	A	G	1	2	3	0	0	3	0	0
17	8234886	.	C	G	2	0	2	0	0	2	0	0
17	8234889	.	C	T	0	0	0	0	2	2	0	0
17	8245790	.	C	A	1	0	1	0	0	1	0	0
17	8246329	.	T	C	1	3	4	0	0	4	0	0
17	8248987	.	A	G	1	2	3	0	0	3	0	0
17	8249153	.	A	T	3	6	9	0	1	10	0	0
17	8253267	.	A	G	0	2	2	0	0	2	0	0
17	8259753	.	T	C	1	2	3	0	0	3	0	0
17	8259808	.	T	C	1	2	3	0	0	3	0	0
17	8261535	.	T	C	2	5	7	0	0	7	0	0
17	8261799	.	C	T	3	3	6	0	0	6	0	0
17	8265406	.	G	A	1	2	3	0	0	3	0	0
17	8278668	.	A	G	3	1	4	0	0	4	0	0
17	8278679	.	T	A	2	1	3	0	0	3	0	0
17	8286764	.	C	T	1	5	6	0	0	6	0	0
17	8286877	.	A	G	1	2	3	0	0	3	0	0
17	8286879	.	C	A	1	2	3	0	0	3	0	0
17	8427407	.	C	T	0	3	3	0	0	3	0	0
17	8427443	.	G	A	0	5	5	0	0	5	0	0
17	8499025	.	C	T	0	3	3	0	4	7	0	0
17	8502883	.	G	A	6	7	13	0	0	13	0	0
17	8502931	.	G	A	2	4	6	0	1	7	0	0
17	8502949	.	G	C	5	0	5	0	5	10	0	0
17	8502982	.	G	A	4	3	7	0	0	7	0	0
17	8505413	.	G	A	1	3	4	0	0	4	0	0
17	8514511	.	G	A	2	1	3	0	0	3	0	0
17	8515363	.	G	A	2	3	5	0	0	5	0	0
17	8519109	.	A	G	2	2	4	0	0	4	0	0
17	8570194	.	T	A	4	2	6	0	1	7	0	0
17	8570202	.	C	A	4	2	6	0	0	6	0	0
17	8597078	.	C	A	1	16	17	0	17	34	0	0
17	8597174	.	T	A	11	13	24	0	1	25	0	0
17	8597515	.	A	T	22	19	41	0	0	41	0	0
17	8597702	.	A	T	20	14	34	0	0	34	0	0
17	8597871	.	T	C	20	6	26	0	1	27	0	0
17	8598070	.	C	T	0	15	15	0	27	42	0	0
17	8598168	.	G	A	22	19	41	0	2	43	0	0
17	8598345	.	T	A	9	10	19	0	0	19	0	0
17	8623396	.	G	A	9	10	19	0	0	19	0	0
17	8623480	.	C	T	0	25	25	0	9	34	0	0
17	8623540	.	C	T	0	12	12	0	8	20	0	0
17	8630043	.	C	A	12	11	23	0	1	24	0	0
17	8727630	.	C	A	2	4	6	0	0	6	0	0
17	8762239	.	A	G	1	0	1	0	0	1	0	0
17	8772776	.	C	T	1	2	3	0	0	3	0	0
17	8780716	.	G	A	3	10	13	0	0	13	0	0
17	8780728	.	C	T	9	3	12	0	0	12	0	0
17	8782396	.	C	T	1	3	4	0	0	4	0	0
17	8784742	.	G	A	0	7	7	0	7	14	0	0
17	8785774	.	C	T	1	4	5	0	0	5	0	0
17	8785795	.	G	A	1	5	6	0	0	6	0	0
17	8789449	.	G	A	0	1	1	0	0	1	0	0
17	8791613	.	T	A	8	5	13	0	0	13	0	0
17	8791618	.	C	G	5	8	13	0	1	14	0	0
17	8927638	.	A	G	5	6	11	0	0	11	0	0
17	8927641	.	A	G	5	6	11	0	0	11	0	0
17	8930017	.	C	T	10	2	12	0	1	13	0	0
17	8934235	.	C	T	14	15	29	0	1	30	0	0
17	8938011	.	G	A	7	1	8	0	1	9	0	0
17	8938249	.	T	C	6	8	14	0	1	15	0	0
17	8938269	.	G	A	13	9	22	0	1	23	0	0
17	8941206	.	G	A	3	3	6	0	0	6	0	0
17	8941264	.	T	C	8	12	20	0	1	21	0	0
17	8951516	.	C	A	5	3	8	1	0	9	0	0
17	8951606	.	C	G	0	10	10	0	11	21	0	0
17	8951867	.	C	T	0	2	2	0	4	6	0	0
17	8954377	.	G	A	9	15	24	0	1	25	0	0
17	8954482	.	C	T	12	13	25	0	1	26	0	0
17	8969278	.	A	G	6	2	8	0	1	9	0	0
17	8972806	.	T	C	15	0	15	0	10	25	0	0
17	8972821	.	G	A	8	11	19	0	0	19	0	0
17	8976273	.	A	G	16	5	21	0	0	21	0	0
17	9017898	.	A	T	4	4	8	0	0	8	0	0
17	9017899	.	T	G	4	4	8	0	0	8	0	0
17	9017950	.	A	G	2	5	7	0	1	8	0	0
17	9017972	.	G	A	3	4	7	0	0	7	0	0
17	9018124	.	C	T	1	2	3	0	0	3	0	0
17	9040248	.	T	C	2	5	7	0	1	8	0	0
17	9042447	.	C	T	2	7	9	0	0	9	0	0
17	9042623	.	T	C	2	8	10	0	0	10	0	0
17	9042652	.	T	C	2	6	8	0	0	8	0	0
17	9059105	.	A	G	0	2	2	0	0	2	0	0
17	9157385	.	A	G	4	3	7	0	0	7	0	0
17	9225184	.	G	A	0	6	6	0	10	16	0	0
17	9225223	.	A	G	3	3	6	0	0	6	0	0
17	9248656	.	A	G	1	0	1	0	7	8	0	0
17	9253504	.	A	T	7	6	13	0	0	13	0	0
17	9253705	.	T	C	8	3	11	0	0	11	0	0
17	9254269	.	T	A	3	9	12	0	1	13	0	0
17	9255196	.	G	A	0	8	8	0	3	11	0	0
17	9255547	.	G	C	9	13	22	0	1	23	0	0
17	9255703	.	C	T	11	12	23	0	1	24	0	0
17	9266298	.	C	T	16	9	25	0	2	27	0	0
17	9266501	.	G	T	0	10	10	0	14	24	0	0
17	9601121	.	G	C	0	2	2	0	0	2	0	0
17	9601133	.	C	T	0	1	1	0	1	2	0	0
17	9847215	.	C	T	2	1	3	0	2	5	0	0
17	9888958	.	C	G	8	9	17	0	1	18	0	0
17	9889223	.	C	T	8	11	19	0	3	22	0	0
17	9889427	.	G	A	6	8	14	0	0	14	0	0
17	9944725	.	A	G	5	2	7	0	0	7	0	0
17	9944733	.	A	G	4	2	6	0	1	7	0	0
17	9944848	.	T	A	5	7	12	0	0	12	0	0
17	9944874	.	C	T	9	5	14	0	1	15	0	0
17	9944960	.	A	T	3	4	7	0	0	7	0	0
17	9951885	.	G	A	3	4	7	0	0	7	0	0
17	9952033	.	C	T	0	6	6	0	3	9	0	0
17	9955952	.	C	T	4	0	4	0	0	4	0	0
17	9964125	.	T	A	1	5	6	0	0	6	0	0
17	9964177	.	C	A	2	2	4	0	1	5	0	0
17	9964359	.	T	C	1	2	3	0	0	3	0	0
17	9964361	.	A	G	1	2	3	0	0	3	0	0
17	9964437	.	A	T	7	4	11	0	0	11	0	0
17	9964944	.	C	A	7	4	11	0	0	11	0	0
17	9965231	.	T	C	2	0	2	0	3	5	0	0
17	9965263	.	T	C	4	0	4	0	4	8	0	0
17	9965344	.	T	A	1	2	3	0	0	3	0	0
17	9977591	.	G	A	0	2	2	0	0	2	0	0
17	9981995	.	A	G	1	2	3	0	0	3	0	0
17	10008358	.	C	T	0	3	3	0	6	9	0	0
17	10032625	.	G	A	2	6	8	0	0	8	0	0
17	10079554	.	G	A	8	10	18	0	0	18	0	0
17	10095554	.	A	G	0	2	2	0	0	2	0	0
17	10095961	.	G	C	0	1	1	0	2	3	0	0
17	10102289	.	T	C	1	4	5	0	0	5	0	0
17	10103185	.	C	T	0	1	1	0	0	1	0	0
17	10128550	.	A	T	2	1	3	0	0	3	0	0
17	10133901	.	G	A	0	1	1	0	0	1	0	0
17	10133902	.	C	T	0	1	1	0	0	1	0	0
17	10142416	.	G	C	3	5	8	0	0	8	0	0
17	10142474	.	T	G	2	4	6	0	0	6	0	0
17	10142481	.	A	G	1	3	4	0	0	4	0	0
17	10143058	.	A	T	1	2	3	0	0	3	0	0
17	10143801	.	A	G	8	0	8	0	2	10	0	0
17	10143808	.	A	G	2	6	8	0	0	8	0	0
17	10143919	.	G	C	1	2	3	0	0	3	0	0
17	10143944	.	G	T	3	2	5	0	0	5	0	0
17	10143960	.	C	T	2	4	6	0	1	7	0	0
17	10144027	.	A	C	2	12	14	0	0	14	0	0
17	10144057	.	A	G	7	2	9	0	0	9	0	0
17	10144616	.	C	T	2	4	6	0	0	6	0	0
17	10145004	.	G	T	12	15	27	0	1	28	0	0
17	10145281	.	C	T	5	8	13	0	1	14	0	0
17	10243794	.	C	A	4	3	7	0	0	7	0	0
17	10247875	.	C	A	2	2	4	0	0	4	0	0
17	10248157	.	A	G	8	6	14	0	0	14	0	0
17	10318123	.	T	A	2	1	3	0	0	3	0	0
17	10318125	.	A	T	1	1	2	0	1	3	0	0
17	10320093	.	T	C	4	2	6	0	1	7	0	0
17	10566694	.	G	T	3	2	5	0	0	5	0	0
17	10572844	.	C	T	3	2	5	0	0	5	0	0
17	10572847	.	G	T	3	2	5	0	0	5	0	0
17	10573186	.	A	G	3	3	6	0	0	6	0	0
17	10573366	.	C	T	1	2	3	0	0	3	0	0
17	10573655	.	G	A	1	2	3	0	0	3	0	0
17	10574981	.	G	A	0	2	2	0	0	2	0	0
17	10575393	.	C	T	1	1	2	0	0	2	0	0
17	10577617	.	A	G	1	0	1	0	1	2	0	0
17	10578806	.	C	A	4	3	7	0	0	7	0	0
17	10585056	.	G	A	8	5	13	0	2	15	0	0
17	10585083	.	G	A	0	5	5	0	10	15	0	0
17	10585101	.	G	A	7	4	11	0	1	12	0	0
17	10585140	.	C	T	5	4	9	0	0	9	0	0
17	10585363	.	A	T	6	7	13	0	1	14	0	0
17	10586161	.	A	T	5	4	9	0	0	9	0	0
17	10586449	.	A	G	7	14	21	0	0	21	0	0
17	10586664	.	A	C	10	12	22	0	0	22	0	0
17	10587020	.	G	T	6	6	12	0	0	12	0	0
17	10587330	.	A	C	5	4	9	0	1	10	0	0
17	10587601	.	A	G	8	4	12	0	1	13	0	0
17	10589221	.	A	C	2	2	4	0	0	4	0	0
17	10589488	.	C	T	1	3	4	0	0	4	0	0
17	10672997	.	A	G	0	0	0	0	1	1	0	0
17	10680447	.	A	G	0	1	1	0	1	2	0	0
17	10686248	.	A	T	1	2	3	0	0	3	0	0
17	10686287	.	A	G	1	3	4	0	0	4	0	0
17	10694630	.	G	A	1	1	2	0	0	2	0	0
17	10694756	.	T	C	1	0	1	0	0	1	0	0
17	10695904	.	G	A	4	3	7	0	0	7	0	0
17	10695922	.	A	G	2	2	4	0	2	6	0	0
17	10696137	.	A	T	1	1	2	0	0	2	0	0
17	10696498	.	A	T	1	0	1	0	0	1	0	0
17	10696676	.	A	T	6	8	14	0	1	15	0	0
17	10696688	.	T	C	7	8	15	0	0	15	0	0
17	10698537	.	A	C	6	8	14	0	0	14	0	0
17	10698681	.	G	T	4	4	8	0	0	8	0	0
17	10698977	.	A	C	3	2	5	0	0	5	0	0
17	10699076	.	G	T	0	5	5	0	7	12	0	0
17	10699077	.	A	C	3	7	10	0	2	12	0	0
17	10699151	.	A	G	4	0	4	0	7	11	0	0
17	10703478	.	A	G	1	1	2	0	0	2	0	0
17	10703673	.	T	G	2	1	3	0	0	3	0	0
17	10703731	.	C	T	4	6	10	0	0	10	0	0
17	10703764	.	C	A	4	7	11	0	1	12	0	0
17	10726617	.	C	T	1	3	4	0	0	4	0	0
17	10736503	.	G	A	5	4	9	0	0	9	0	0
17	10736563	.	C	A	6	2	8	0	0	8	0	0
17	10736572	.	G	A	4	2	6	0	0	6	0	0
17	10737844	.	T	A	3	2	5	0	0	5	0	0
17	10748708	.	G	C	0	7	7	0	3	10	0	0
17	10751051	.	T	C	2	0	2	0	0	2	0	0
17	10755512	.	A	G	8	9	17	0	1	18	0	0
17	10755656	.	T	C	4	4	8	0	0	8	0	0
17	10761763	.	T	C	3	1	4	0	0	4	0	0
17	10765286	.	C	T	4	2	6	0	0	6	0	0
17	10765328	.	A	G	13	0	13	0	6	19	0	0
17	10765683	.	T	A	1	2	3	0	1	4	0	0
17	10765766	.	A	G	4	3	7	0	0	7	0	0
17	10765773	.	A	G	1	5	6	0	1	7	0	0
17	10766074	.	G	C	15	8	23	0	0	23	0	0
17	10766142	.	T	A	9	5	14	0	0	14	0	0
17	10766181	.	A	G	7	5	12	0	0	12	0	0
17	10766205	.	G	T	5	4	9	0	1	10	0	0
17	10766219	.	A	T	6	4	10	0	0	10	0	0
17	10783885	.	A	G	5	9	14	0	1	15	0	0
17	10784149	.	C	T	0	11	11	0	12	23	0	0
17	10784151	.	T	C	12	10	22	0	1	23	0	0
17	10784210	.	A	C	7	0	7	0	15	22	0	0
17	10784441	.	A	G	14	14	28	0	0	28	0	0
17	10784618	.	G	A	10	13	23	0	0	23	0	0
17	10784646	.	C	G	9	14	23	0	1	24	0	0
17	10784948	.	A	T	12	10	22	0	1	24	1	0
17	10785020	.	A	G	14	7	21	0	0	21	0	0
17	10785206	.	A	G	12	12	24	0	1	25	0	0
17	10785289	.	T	C	11	5	16	0	1	17	0	0
17	10785552	.	A	G	6	5	11	0	0	11	0	0
17	10785616	.	T	A	10	5	15	0	0	15	0	0
17	10785619	.	C	T	8	4	12	0	3	15	0	0
17	10786085	.	C	A	5	3	8	0	0	8	0	0
17	10786149	.	T	A	3	4	7	0	0	7	0	0
17	10786520	.	T	C	4	3	7	0	0	7	0	0
17	10796797	.	T	C	2	4	6	0	2	8	0	0
17	10813718	.	G	A	2	2	4	0	0	4	0	0
17	10813783	.	A	T	8	6	14	0	0	14	0	0
17	10813817	.	G	T	9	6	15	0	1	16	0	0
17	10825196	.	C	T	1	2	3	0	0	3	0	0
17	10827141	.	G	A	0	1	1	0	0	1	0	0
17	11585279	.	G	A	2	3	5	0	0	5	0	0
17	11585399	.	T	C	1	2	3	0	0	3	0	0
17	11585561	.	T	C	1	2	3	0	0	3	0	0
17	11658769	.	C	T	1	3	4	0	0	4	0	0
17	11708797	.	G	A	0	3	3	0	1	4	0	0
17	11709187	.	G	A	3	5	8	0	0	8	0	0
17	11709199	.	C	T	3	5	8	0	0	8	0	0
17	11709394	.	A	T	1	2	3	0	1	4	0	0
17	11714598	.	T	A	2	4	6	0	0	6	0	0
17	11714635	.	G	C	6	7	13	0	0	13	0	0
17	11714874	.	T	C	1	1	2	0	0	2	0	0
17	11715808	.	G	T	0	2	2	0	3	5	0	0
17	11715917	.	G	C	12	10	22	0	0	22	0	0
17	11716068	.	T	C	8	6	14	0	2	16	0	0
17	11716113	.	T	G	8	4	12	0	1	13	0	0
17	11716509	.	G	T	3	2	5	0	0	5	0	0
17	11716702	.	A	G	5	5	10	0	1	11	0	0
17	11716741	.	C	T	2	1	3	0	0	3	0	0
17	11717109	.	C	T	9	14	23	0	5	28	0	0
17	11717131	.	C	T	8	10	18	0	3	21	0	0
17	11717362	.	A	G	0	0	0	0	4	4	0	0
17	11717384	.	A	G	0	1	1	0	16	17	0	0
17	11718038	.	A	C	13	11	24	0	2	26	0	0
17	11718118	.	A	G	10	15	25	0	1	26	0	0
17	13636722	.	C	G	0	2	2	0	1	3	0	0
17	13763454	.	T	C	3	2	5	0	0	5	0	0
17	13763835	.	C	T	4	4	8	0	0	8	0	0
17	13764198	.	C	T	4	3	7	0	1	8	0	0
17	13764513	.	A	C	4	3	7	0	2	9	0	0
17	13764624	.	T	C	5	5	10	0	0	10	0	0
17	14442430	.	G	A	2	1	3	0	0	3	0	0
17	14442467	.	A	T	1	1	2	0	0	2	0	0
17	14443537	.	A	T	2	2	4	0	0	4	0	0
17	14443539	.	A	G	2	2	4	0	0	4	0	0
17	14443633	.	T	A	4	6	10	0	0	10	0	0
17	14443651	.	T	C	2	0	2	0	7	9	0	0
17	14443697	.	G	A	7	4	11	0	0	11	0	0
17	14443820	.	T	G	3	2	5	0	1	6	0	0
17	14444166	.	A	G	4	7	11	0	1	12	0	0
17	14444167	.	G	A	5	6	11	0	1	12	0	0
17	14447282	.	A	G	1	0	1	0	0	1	0	0
17	14449386	.	C	T	0	0	0	0	2	2	0	0
17	14451264	.	T	C	1	1	2	0	0	2	0	0
17	14457452	.	T	G	3	5	8	0	1	9	0	0
17	14457911	.	C	A	3	4	7	0	1	8	0	0
17	14458364	.	T	C	5	2	7	0	0	7	0	0
17	14467471	.	G	A	7	9	16	0	0	16	0	0
17	14468247	.	C	T	0	8	8	0	13	21	0	0
17	14468263	.	T	G	11	7	18	0	1	19	0	0
17	14468370	.	A	T	15	7	22	0	1	24	1	0
17	14468386	.	T	A	16	9	25	0	0	25	0	0
17	14468433	.	G	A	12	13	25	0	1	26	0	0
17	14470340	.	A	G	2	0	2	0	0	2	0	0
17	14494395	.	A	G	4	8	12	0	1	13	0	0
17	14494429	.	A	G	5	11	16	0	0	16	0	0
17	14502454	.	T	A	4	6	10	0	2	12	0	0
17	14523518	.	G	T	4	5	9	0	1	10	0	0
17	14614452	.	T	C	5	13	18	0	2	20	0	0
17	14614471	.	A	G	5	12	17	0	0	17	0	0
17	14614509	.	C	A	11	11	22	0	2	24	0	0
17	14614863	.	C	A	10	16	26	0	0	26	0	0
17	14614900	.	G	A	11	11	22	0	0	22	0	0
17	14614973	.	C	G	10	8	18	0	0	18	0	0
17	14615089	.	T	C	9	17	26	0	1	27	0	0
17	14617171	.	G	A	0	1	1	0	0	1	0	0
17	14618038	.	C	G	4	6	10	0	0	10	0	0
17	14618051	.	G	A	4	8	12	0	0	12	0	0
17	14618842	.	C	T	0	1	1	0	1	2	0	0
17	14618857	.	C	T	0	5	5	0	3	8	0	0
17	14620476	.	T	G	1	7	8	0	0	8	0	0
17	14621230	.	C	T	0	0	0	0	1	1	0	0
17	14623340	.	A	G	0	1	1	0	1	2	0	0
17	14623352	.	T	A	1	3	4	0	0	4	0	0
17	14623391	.	A	T	4	6	10	0	0	10	0	0
17	14624088	.	G	T	1	1	2	0	0	2	0	0
17	14694711	.	C	A	24	19	43	0	2	45	0	0
17	14694744	.	A	G	21	16	37	0	0	37	0	0
17	14694802	.	C	G	20	23	43	0	1	44	0	0
17	14722223	.	A	G	10	5	15	0	1	16	0	0
17	14723137	.	C	T	14	18	32	0	0	32	0	0
17	14723208	.	T	C	20	12	32	0	1	33	0	0
17	14723302	.	A	G	13	17	30	0	1	31	0	0
17	14724005	.	C	A	7	8	15	0	1	16	0	0
17	14724057	.	T	C	13	15	28	0	0	28	0	0
17	14724489	.	T	C	5	5	10	0	1	11	0	0
17	14724514	.	T	C	3	0	3	0	6	9	0	0
17	14725246	.	A	C	10	0	10	0	10	20	0	0
17	14725561	.	C	T	1	7	8	0	8	16	0	0
17	14725648	.	C	T	8	11	19	0	1	20	0	0
17	14725831	.	T	A	6	7	13	0	1	14	0	0
17	14731522	.	G	T	5	7	12	0	0	12	0	0
17	14731560	.	T	C	6	7	13	0	0	13	0	0
17	14731819	.	T	C	4	3	7	0	0	7	0	0
17	14734632	.	C	T	3	6	9	0	1	10	0	0
17	14734734	.	G	A	6	4	10	0	0	10	0	0
17	14737070	.	G	A	0	4	4	0	0	4	0	0
17	14751227	.	T	A	4	6	10	0	0	10	0	0
17	14755275	.	A	G	3	6	9	0	0	9	0	0
17	14755852	.	G	A	1	3	4	0	0	4	0	0
17	14756129	.	A	G	2	1	3	0	0	3	0	0
17	14758562	.	G	A	7	10	17	0	0	17	0	0
17	14768652	.	T	A	5	10	15	0	0	15	0	0
17	14784323	.	T	C	7	13	20	0	1	21	0	0
17	14785663	.	C	T	5	6	11	0	0	11	0	0
17	14794285	.	A	G	5	5	10	0	1	11	0	0
17	14794485	.	G	T	16	19	35	0	0	35	0	0
17	14794639	.	A	T	2	7	9	0	0	9	0	0
17	14918378	.	A	G	2	2	4	0	0	4	0	0
17	14918382	.	G	C	2	1	3	0	1	4	0	0
17	14918683	.	T	A	1	2	3	0	0	3	0	0
17	14918688	.	A	G	1	2	3	0	0	3	0	0
17	14919126	.	T	G	2	2	4	0	0	4	0	0
17	14933285	.	T	A	0	2	2	0	0	2	0	0
17	14933455	.	A	G	1	2	3	0	0	3	0	0
17	14938834	.	C	T	1	4	5	0	0	5	0	0
17	14941634	.	T	A	1	2	3	0	0	3	0	0
17	14945613	.	T	C	2	4	6	0	0	6	0	0
17	14948914	.	A	T	1	1	2	0	0	2	0	0
17	14953698	.	A	G	1	1	2	0	0	2	0	0
17	14953761	.	G	A	3	2	5	0	0	5	0	0
17	14953949	.	T	G	0	2	2	0	1	3	0	0
17	14953953	.	T	C	1	2	3	0	0	3	0	0
17	14953989	.	C	G	1	3	4	0	1	5	0	0
17	14953999	.	C	G	1	4	5	0	0	5	0	0
17	14954037	.	C	T	0	3	3	0	1	4	0	0
17	15005217	.	A	G	6	4	10	0	0	10	0	0
17	15021944	.	G	A	0	1	1	0	0	1	0	0
17	15023286	.	G	A	0	1	1	0	0	1	0	0
17	15029290	.	G	A	1	2	3	0	0	3	0	0
17	15029432	.	G	T	1	3	4	0	0	4	0	0
17	15117504	.	A	T	1	4	5	0	0	5	0	0
17	15122021	.	T	G	9	1	10	0	2	12	0	0
17	15124513	.	G	A	2	3	5	0	0	5	0	0
17	15126123	.	C	A	2	2	4	0	0	4	0	0
17	15148903	.	A	G	1	4	5	0	0	5	0	0
17	15149034	.	T	C	1	2	3	0	0	3	0	0
17	15149153	.	A	T	2	2	4	0	0	4	0	0
17	15149218	.	A	T	2	1	3	0	0	3	0	0
17	15149221	.	G	A	2	1	3	0	0	3	0	0
17	15213620	.	C	T	1	2	3	0	0	3	0	0
17	15216134	.	A	T	2	4	6	0	1	7	0	0
17	15219325	.	A	C	2	3	5	0	0	5	0	0
17	15220092	.	C	T	1	2	3	0	2	5	0	0
17	15224052	.	G	A	1	2	3	0	0	3	0	0
17	15229577	.	T	C	3	0	3	0	0	3	0	0
17	15316001	.	T	C	10	5	15	0	2	17	0	0
17	15316022	.	T	C	6	3	9	0	0	9	0	0
17	15319232	.	G	A	9	3	12	0	0	12	0	0
17	15353984	.	G	A	15	7	22	0	0	22	0	0
17	15374507	.	G	A	13	16	29	0	1	30	0	0
17	15374744	.	C	G	11	4	15	0	1	16	0	0
17	15382421	.	T	A	16	7	23	0	0	23	0	0
17	15382486	.	C	T	13	5	18	0	1	19	0	0
17	15633379	.	T	C	3	22	25	0	1	26	0	0
17	15633530	.	C	T	3	3	6	0	0	6	0	0
17	15633605	.	T	C	7	7	14	0	0	14	0	0
17	15633721	.	T	C	3	5	8	0	0	8	0	0
17	15636751	.	T	C	11	6	17	0	0	17	0	0
17	15884990	.	C	T	1	0	1	0	0	1	0	0
17	15888422	.	A	C	1	0	1	0	0	1	0	0
17	15892233	.	G	A	4	3	7	0	0	7	0	0
17	15892479	.	G	A	0	3	3	0	3	6	0	0
17	15918664	.	C	A	2	2	4	0	0	4	0	0
17	15933470	.	C	T	1	2	3	0	0	3	0	0
17	15963538	.	T	A	1	2	3	0	1	4	0	0
17	15963548	.	G	A	2	2	4	0	0	4	0	0
17	15964579	.	G	T	0	4	4	0	2	6	0	0
17	15964581	.	G	A	2	4	6	0	0	6	0	0
17	15964692	.	T	C	4	2	6	0	0	6	0	0
17	15964732	.	A	G	2	6	8	0	1	9	0	0
17	15964903	.	A	G	1	3	4	0	0	4	0	0
17	15964997	.	T	C	1	1	2	0	1	3	0	0
17	15965469	.	A	C	3	2	5	0	1	6	0	0
17	15965589	.	C	A	1	2	3	0	1	4	0	0
17	15965708	.	T	A	4	5	9	0	1	10	0	0
17	15983530	.	C	T	4	7	11	0	0	11	0	0
17	16022530	.	C	T	5	11	16	0	1	17	0	0
17	16024587	.	A	G	4	4	8	0	0	8	0	0
17	16024590	.	G	A	4	4	8	0	0	8	0	0
17	16024677	.	A	G	0	1	1	0	1	2	0	0
17	16026207	.	T	A	2	1	3	0	0	3	0	0
17	16026293	.	A	G	14	11	25	0	0	25	0	0
17	16026345	.	A	G	14	11	25	0	1	26	0	0
17	16026486	.	C	T	2	6	8	0	0	8	0	0
17	16026593	.	C	T	3	8	11	0	0	11	0	0
17	16027718	.	G	A	7	4	11	0	0	11	0	0
17	16027720	.	A	G	6	4	10	0	1	11	0	0
17	16027935	.	G	T	11	7	18	0	0	18	0	0
17	16027983	.	A	T	13	10	23	0	0	23	0	0
17	16028040	.	G	A	10	9	19	0	1	20	0	0
17	16051805	.	A	G	5	3	8	0	1	9	0	0
17	16051968	.	G	A	6	6	12	0	1	13	0	0
17	16052075	.	A	G	5	9	14	0	0	14	0	0
17	16052229	.	C	T	11	9	20	0	0	20	0	0
17	16052282	.	G	A	10	4	14	0	1	15	0	0
17	16052563	.	G	A	5	11	16	0	2	18	0	0
17	16052587	.	T	G	7	5	12	0	0	12	0	0
17	16055049	.	T	C	8	8	16	0	0	16	0	0
17	16055179	.	G	A	4	2	6	0	0	6	0	0
17	16057798	.	C	T	15	13	28	0	0	28	0	0
17	16057877	.	C	A	0	1	1	0	1	2	0	0
17	16059802	.	T	G	8	9	17	0	0	17	0	0
17	16059831	.	T	G	10	5	15	0	1	16	0	0
17	16059854	.	G	T	9	10	19	0	0	19	0	0
17	16059889	.	A	C	11	0	11	0	4	15	0	0
17	16059928	.	T	A	0	3	3	0	0	3	0	0
17	16064779	.	A	T	2	3	5	0	1	6	0	0
17	16064843	.	G	T	1	10	11	0	1	12	0	0
17	16083852	.	C	T	1	2	3	0	0	3	0	0
17	16084178	.	G	A	2	2	4	0	0	4	0	0
17	16099691	.	C	T	1	4	5	0	0	5	0	0
17	16099784	.	A	G	0	1	1	0	0	1	0	0
17	16107111	.	C	T	3	3	6	0	0	6	0	0
17	16107167	.	T	A	4	3	7	0	0	7	0	0
17	16107882	.	A	G	5	0	5	0	4	9	0	0
17	16108231	.	T	A	2	3	5	0	0	5	0	0
17	16108242	.	T	G	2	0	2	0	3	5	0	0
17	16110234	.	A	G	4	4	8	0	0	8	0	0
17	16110291	.	T	A	5	4	9	0	0	9	0	0
17	16110336	.	T	C	6	7	13	0	0	13	0	0
17	16110447	.	T	G	7	6	13	0	0	13	0	0
17	16110527	.	C	G	0	4	4	0	5	9	0	0
17	16110552	.	C	T	7	3	10	0	0	10	0	0
17	16110573	.	A	G	3	6	9	0	0	9	0	0
17	16110687	.	G	A	6	4	10	0	0	10	0	0
17	16110773	.	A	G	3	2	5	0	0	5	0	0
17	16111427	.	C	T	8	3	11	0	0	11	0	0
17	16804958	.	C	A	2	3	5	0	5	10	0	0
17	16804961	.	G	A	1	0	1	0	7	8	0	0
17	16805140	.	T	A	1	7	8	0	0	8	0	0
17	18179927	.	T	C	0	9	9	0	0	9	0	0
17	18180649	.	C	T	2	2	4	0	3	7	0	0
17	18180651	.	C	G	2	0	2	0	5	7	0	0
17	19511074	.	A	G	1	0	1	0	1	2	0	0
17	21155707	.	T	C	4	2	6	0	0	6	0	0
17	21160107	.	G	A	0	2	2	0	0	2	0	0
17	23575413	.	A	G	5	12	17	0	1	18	0	0
17	23934511	.	T	C	3	2	5	0	0	5	0	0
17	24443182	.	G	C	0	2	2	0	0	2	0	0
17	24601654	.	A	C	5	1	6	0	12	18	0	0
17	25480158	.	G	T	6	0	6	0	2	8	0	0
17	26298967	.	C	T	2	3	5	0	0	5	0	0
17	26335000	.	G	A	2	2	4	0	0	4	0	0
17	26346175	.	T	A	2	0	2	0	0	2	0	0
17	26362130	.	G	A	6	3	9	0	2	11	0	0
17	26362500	.	C	T	3	2	5	0	0	5	0	0
17	26362539	.	C	T	2	3	5	0	0	5	0	0
17	26362741	.	C	T	1	6	7	0	1	8	0	0
17	26477743	.	A	C	12	2	14	0	0	14	0	0
17	26477747	.	T	A	10	2	12	0	2	14	0	0
17	26477795	.	A	C	11	7	18	0	1	19	0	0
17	26477857	.	T	C	17	10	27	0	0	27	0	0
17	26477860	.	C	T	17	10	27	0	0	27	0	0
17	26478023	.	T	C	14	5	19	0	0	19	0	0
17	26478403	.	T	G	7	5	12	0	1	13	0	0
17	26478592	.	A	G	10	6	16	0	0	16	0	0
17	26478952	.	G	A	5	8	13	0	2	15	0	0
17	26478986	.	A	G	10	8	18	0	0	18	0	0
17	26479063	.	A	G	6	4	10	0	0	10	0	0
17	26479145	.	T	C	10	11	21	0	3	24	0	0
17	26479916	.	G	T	3	4	7	0	0	7	0	0
17	26479997	.	A	T	4	4	8	0	0	8	0	0
17	26480254	.	G	A	1	1	2	0	1	3	0	0
17	26480421	.	A	G	7	8	15	0	0	15	0	0
17	26480423	.	T	C	7	8	15	0	0	15	0	0
17	26480622	.	A	T	5	3	8	0	1	9	0	0
17	26480926	.	T	G	6	4	10	0	0	10	0	0
17	26502013	.	A	G	0	1	1	0	0	1	0	0
17	26502047	.	A	C	2	0	2	0	2	4	0	0
17	26502107	.	G	A	9	4	13	0	0	13	0	0
17	26507294	.	G	A	2	0	2	0	0	2	0	0
17	26516745	.	G	C	2	1	3	0	0	3	0	0
17	26516748	.	G	C	1	1	2	0	1	3	0	0
17	26516878	.	G	A	3	4	7	0	0	7	0	0
17	26517310	.	A	C	4	0	4	0	6	10	0	0
17	26519475	.	T	C	1	0	1	0	3	4	0	0
17	26519681	.	C	T	5	5	10	0	0	10	0	0
17	26519823	.	T	C	4	1	5	0	3	8	0	0
17	26577293	.	T	C	3	4	7	0	0	7	0	0
17	26585135	.	G	T	11	7	18	0	0	18	0	0
17	26585163	.	A	T	5	9	14	0	0	14	0	0
17	26585298	.	G	T	0	2	2	0	3	6	1	0
17	26585316	.	C	T	3	8	11	0	0	11	0	0
17	26585727	.	C	T	6	9	15	0	2	17	0	0
17	26585748	.	A	G	13	1	14	0	9	23	0	0
17	26585763	.	T	A	13	10	23	0	1	24	0	0
17	26590091	.	C	T	5	6	11	0	0	11	0	0
17	26590170	.	A	T	6	3	9	0	0	9	0	0
17	26590330	.	T	C	11	4	15	0	1	16	0	0
17	26590495	.	A	G	1	4	5	0	0	5	0	0
17	26590650	.	G	T	6	3	9	0	0	9	0	0
17	26594968	.	G	C	1	4	5	0	0	5	0	0
17	26600555	.	T	A	1	5	6	0	1	7	0	0
17	26600639	.	G	A	7	6	13	0	1	14	0	0
17	26600667	.	C	T	4	6	10	0	0	10	0	0
17	26600785	.	G	A	1	1	2	0	0	2	0	0
17	26600881	.	G	A	5	1	6	0	0	6	0	0
17	26603369	.	A	T	0	3	3	0	0	3	0	0
17	26604751	.	G	C	8	9	17	0	0	17	0	0
17	26604758	.	C	T	8	8	16	0	0	16	0	0
17	26604801	.	C	A	6	5	11	0	2	13	0	0
17	26604917	.	G	A	2	4	6	0	0	6	0	0
17	26630909	.	C	T	2	2	4	0	0	4	0	0
17	26639659	.	C	T	8	5	13	0	0	13	0	0
17	26639725	.	A	G	5	0	5	0	9	14	0	0
17	26642775	.	C	A	3	3	6	0	0	7	1	0
17	26642817	.	T	G	7	0	7	0	8	15	0	0
17	26642818	.	T	C	7	8	15	0	0	15	0	0
17	26657852	.	T	C	13	8	21	0	0	21	0	0
17	26662347	.	C	T	11	5	16	0	0	16	0	0
17	26683466	.	T	C	2	0	2	0	0	2	0	0
17	26683526	.	C	T	13	9	22	0	0	22	0	0
17	26689753	.	G	A	12	21	33	0	5	38	0	0
17	26689768	.	C	A	26	8	34	0	1	36	1	0
17	26689792	.	C	A	7	29	36	0	0	36	0	0
17	26690112	.	T	A	20	17	37	0	2	39	0	0
17	26690250	.	C	T	7	11	18	0	0	18	0	0
17	26690276	.	C	T	13	8	21	0	0	21	0	0
17	26690478	.	C	T	13	11	24	0	2	26	0	0
17	26690558	.	G	A	1	15	16	0	11	27	0	0
17	26714009	.	C	T	29	29	58	0	2	61	1	0
17	26722954	.	A	C	0	1	1	0	0	1	0	0
17	26734345	.	C	T	1	1	2	0	0	2	0	0
17	26735735	.	T	C	1	2	3	0	0	3	0	0
17	26741227	.	C	T	2	2	4	0	0	4	0	0
17	26741254	.	T	C	1	2	3	0	2	5	0	0
17	26743948	.	T	C	1	2	3	0	0	3	0	0
17	26744174	.	G	A	2	2	4	0	0	4	0	0
17	26744207	.	G	C	1	0	1	0	0	1	0	0
17	26744748	.	T	A	1	3	4	2	0	6	0	0
17	26744840	.	A	G	4	2	6	0	0	6	0	0
17	26744862	.	G	A	1	4	5	0	0	5	0	0
17	26745106	.	T	C	3	4	7	0	0	7	0	0
17	26745110	.	C	T	3	3	6	0	1	7	0	0
17	26747348	.	A	G	1	0	1	0	0	1	0	0
17	26747392	.	G	T	0	1	1	0	0	1	0	0
17	26749836	.	G	A	2	2	4	0	0	4	0	0
17	26810380	.	C	T	14	9	23	0	2	25	0	0
17	26813285	.	T	C	4	13	17	0	3	20	0	0
17	26831861	.	G	A	1	0	1	0	0	1	0	0
17	26832713	.	C	T	3	1	4	0	0	4	0	0
17	26832738	.	A	G	1	1	2	0	0	2	0	0
17	26846203	.	C	T	7	9	16	0	1	17	0	0
17	26846650	.	G	A	2	2	4	0	0	4	0	0
17	26846707	.	G	A	0	5	5	0	5	10	0	0
17	26846901	.	T	G	9	9	18	0	2	20	0	0
17	26847905	.	C	A	5	2	7	0	0	7	0	0
17	26879854	.	A	C	9	9	18	0	0	18	0	0
17	26879869	.	A	G	11	11	22	0	0	22	0	0
17	26879893	.	A	G	15	16	31	0	0	31	0	0
17	26880107	.	G	A	16	20	36	0	2	38	0	0
17	26880231	.	T	C	20	30	50	0	1	51	0	0
17	26880424	.	T	C	25	22	47	0	2	49	0	0
17	26880926	.	T	C	15	0	15	0	20	35	0	0
17	26880964	.	A	G	21	24	45	0	1	46	0	0
17	26881131	.	T	A	23	13	36	0	2	38	0	0
17	26881354	.	A	G	21	16	37	0	4	41	0	0
17	26881777	.	A	G	26	17	43	0	3	46	0	0
17	26911747	.	A	G	18	16	34	0	0	34	0	0
17	26924308	.	C	T	0	2	2	0	1	3	0	0
17	26926548	.	G	A	4	4	8	0	0	8	0	0
17	26928727	.	T	C	1	3	4	0	0	4	0	0
17	26928994	.	C	T	5	4	9	0	0	9	0	0
17	26929475	.	T	C	4	4	8	0	0	8	0	0
17	26929577	.	C	A	4	7	11	0	1	12	0	0
17	26929649	.	A	G	5	4	9	0	1	10	0	0
17	26929654	.	T	A	5	5	10	0	0	10	0	0
17	26929776	.	C	T	9	5	14	0	0	14	0	0
17	26933223	.	A	G	5	1	6	0	0	6	0	0
17	26933328	.	C	T	0	2	2	0	0	2	0	0
17	26934417	.	C	T	0	3	3	0	3	6	0	0
17	26935254	.	G	T	8	5	13	0	0	13	0	0
17	26935274	.	G	T	5	8	13	0	1	15	1	0
17	26935331	.	G	C	1	2	3	0	0	3	0	0
17	26985158	.	G	A	0	9	9	0	12	21	0	0
17	26985544	.	T	A	7	7	14	0	1	15	0	0
17	26985561	.	T	G	4	1	5	0	9	14	0	0
17	26985586	.	C	T	4	16	20	0	1	21	0	0
17	26985638	.	T	G	4	12	16	0	0	16	0	0
17	26985656	.	T	A	3	9	12	0	0	12	0	0
17	26985692	.	G	T	2	9	11	0	0	11	0	0
17	27064523	.	T	A	4	6	10	0	0	10	0	0
17	27064725	.	T	C	5	7	12	0	0	12	0	0
17	27064840	.	G	C	0	6	6	0	6	12	0	0
17	27154695	.	A	G	2	0	2	0	0	2	0	0
17	27160846	.	C	T	0	1	1	0	0	1	0	0
17	27160912	.	G	A	4	3	7	0	0	7	0	0
17	27163266	.	T	C	3	2	5	0	0	5	0	0
17	27164497	.	T	C	2	4	6	0	0	6	0	0
17	27164530	.	C	T	3	0	3	0	0	3	0	0
17	27166221	.	T	C	1	2	3	0	0	3	0	0
17	27166257	.	T	C	3	3	6	0	0	6	0	0
17	27166521	.	C	T	1	2	3	0	1	4	0	0
17	27168957	.	G	T	0	3	3	0	3	6	0	0
17	27169783	.	A	C	5	5	10	0	1	11	0	0
17	27170017	.	G	A	0	4	4	0	5	9	0	0
17	27170341	.	G	A	1	3	4	0	0	4	0	0
17	27170516	.	G	A	0	9	9	0	6	15	0	0
17	27170549	.	G	A	5	4	9	0	2	11	0	0
17	27170605	.	T	G	5	5	10	0	0	10	0	0
17	27170678	.	C	A	3	6	9	0	1	10	0	0
17	27170730	.	T	G	4	7	11	0	2	13	0	0
17	27170746	.	A	T	5	13	18	0	0	18	0	0
17	27170961	.	T	C	2	4	6	0	0	6	0	0
17	27176640	.	G	A	6	6	12	0	0	12	0	0
17	27176871	.	G	A	6	4	10	0	1	11	0	0
17	27176967	.	G	C	6	7	13	0	0	13	0	0
17	27176991	.	C	T	6	6	12	0	2	14	0	0
17	27177064	.	C	T	1	5	6	0	2	8	0	0
17	27177083	.	G	A	1	5	6	0	2	8	0	0
17	27177251	.	A	G	1	5	6	0	0	6	0	0
17	27177473	.	C	T	9	7	16	0	0	16	0	0
17	27177745	.	G	A	8	4	12	0	0	12	0	0
17	27177776	.	G	T	7	3	10	0	1	11	0	0
17	27177945	.	G	T	2	2	4	0	1	5	0	0
17	27178024	.	T	A	3	6	9	0	0	9	0	0
17	27178088	.	T	A	6	6	12	0	0	12	0	0
17	27178191	.	G	A	3	5	8	0	0	8	0	0
17	27178232	.	A	G	8	5	13	0	2	15	0	0
17	27178254	.	C	A	5	8	13	0	1	14	0	0
17	27178273	.	G	T	6	5	11	0	0	11	0	0
17	27178296	.	G	A	0	3	3	0	9	12	0	0
17	27178356	.	T	A	4	6	10	0	1	11	0	0
17	27178383	.	C	G	4	3	7	0	0	7	0	0
17	27178401	.	C	T	4	4	8	0	0	8	0	0
17	27178557	.	C	T	5	9	14	0	0	14	0	0
17	27178638	.	C	G	10	7	17	0	0	17	0	0
17	27178730	.	C	A	4	5	9	0	0	9	0	0
17	27178870	.	T	C	6	4	10	0	1	11	0	0
17	27179189	.	A	G	6	8	14	0	0	14	0	0
17	27179203	.	G	T	1	7	8	0	3	11	0	0
17	27179434	.	G	T	4	3	7	0	0	7	0	0
17	27180407	.	T	A	4	5	9	0	0	9	0	0
17	27180447	.	A	T	3	5	8	0	0	8	0	0
17	27180847	.	A	G	4	2	6	0	0	6	0	0
17	27181021	.	T	C	4	7	11	0	0	11	0	0
17	27181048	.	C	G	7	9	16	0	0	16	0	0
17	27181129	.	G	A	5	12	17	0	2	19	0	0
17	27181130	.	G	A	5	12	17	0	2	19	0	0
17	27181257	.	A	C	8	8	16	0	1	17	0	0
17	27181323	.	A	G	12	0	12	0	11	23	0	0
17	27181411	.	A	G	3	0	3	0	12	15	0	0
17	27181427	.	C	T	4	11	15	0	0	15	0	0
17	27181463	.	A	G	4	0	4	0	8	12	0	0
17	27181481	.	A	G	1	4	5	0	1	6	0	0
17	27181680	.	C	T	4	10	14	0	0	14	0	0
17	27181829	.	A	G	9	6	15	0	0	15	0	0
17	27182006	.	G	T	13	4	17	0	1	18	0	0
17	27182039	.	T	C	12	8	20	0	0	20	0	0
17	27182114	.	A	G	4	10	14	0	1	15	0	0
17	27182146	.	C	T	7	10	17	0	1	18	0	0
17	27182331	.	T	G	3	7	10	0	0	10	0	0
17	27182340	.	C	T	3	9	12	0	1	13	0	0
17	27182449	.	G	T	7	10	17	0	0	17	0	0
17	27182484	.	T	C	5	15	20	0	1	21	0	0
17	27182645	.	G	T	15	22	37	0	1	38	0	0
17	27182649	.	A	G	15	21	36	0	3	39	0	0
17	27182769	.	A	G	3	9	12	0	3	15	0	0
17	27182894	.	T	C	11	8	19	0	2	21	0	0
17	27182925	.	A	T	10	8	18	0	0	18	0	0
17	27182979	.	C	T	4	12	16	0	0	16	0	0
17	27190731	.	C	G	2	2	4	0	0	4	0	0
17	27190732	.	C	T	2	1	3	0	1	4	0	0
17	27192698	.	C	T	1	2	3	0	0	3	0	0
17	27194087	.	G	A	1	2	3	0	0	3	0	0
17	27194168	.	A	G	3	2	5	0	0	5	0	0
17	27194183	.	A	G	3	4	7	0	0	7	0	0
17	27194669	.	C	T	1	2	3	0	0	3	0	0
17	27194867	.	A	G	1	2	3	0	0	3	0	0
17	27272913	.	T	C	4	6	10	0	0	10	0	0
17	27273013	.	C	T	11	7	18	0	2	20	0	0
17	27401038	.	A	T	8	5	13	0	5	18	0	0
17	27408386	.	A	G	8	9	17	0	4	21	0	0
17	27408472	.	C	T	11	18	29	0	2	31	0	0
17	27408523	.	G	T	4	11	15	0	2	17	0	0
17	27408531	.	T	A	5	8	13	0	0	13	0	0
17	27408637	.	T	C	5	1	6	0	7	13	0	0
17	27408836	.	T	G	1	16	17	0	1	18	0	0
17	27408889	.	T	C	1	5	6	0	1	7	0	0
17	27413564	.	T	C	1	0	1	0	0	1	0	0
17	27413705	.	T	C	3	15	18	0	0	18	0	0
17	27414035	.	G	A	7	8	15	0	0	15	0	0
17	27414098	.	C	A	5	13	18	0	1	19	0	0
17	27414203	.	G	A	9	15	24	0	0	24	0	0
17	27414215	.	C	T	1	9	10	0	17	27	0	0
17	27414367	.	A	G	11	16	27	0	0	27	0	0
17	27414658	.	T	C	3	14	17	0	0	17	0	0
17	27414701	.	A	G	3	13	16	0	2	18	0	0
17	27414791	.	A	G	6	9	15	0	1	16	0	0
17	27414815	.	G	A	5	11	16	0	0	16	0	0
17	27415010	.	C	T	0	8	8	0	11	19	0	0
17	27723800	.	G	T	9	2	11	0	0	12	1	0
17	27807455	.	T	C	21	16	37	0	0	37	0	0
17	27808190	.	A	G	11	0	11	1	18	30	0	0
17	27808335	.	A	G	19	16	35	0	0	35	0	0
17	27808686	.	G	A	5	6	11	0	0	11	0	0
17	27808700	.	G	A	6	8	14	0	0	14	0	0
17	27808987	.	G	T	2	19	21	0	29	50	0	0
17	27809548	.	T	A	16	14	30	0	0	30	0	0
17	27809631	.	G	T	1	10	11	0	12	23	0	0
17	27809779	.	C	A	24	17	41	2	4	47	0	0
17	27809885	.	A	G	26	24	50	0	1	51	0	0
17	27811199	.	T	A	5	9	14	0	0	14	0	0
17	27811209	.	A	G	4	10	14	0	1	15	0	0
17	27811254	.	T	C	5	7	12	0	0	12	0	0
17	27811529	.	A	G	1	2	3	0	0	3	0	0
17	27812525	.	A	C	20	12	32	0	0	32	0	0
17	27812562	.	G	A	1	11	12	0	20	32	0	0
17	27812702	.	A	T	16	11	27	0	0	27	0	0
17	27812780	.	T	A	3	4	7	0	0	7	0	0
17	27812789	.	A	G	3	0	3	0	3	6	0	0
17	27813221	.	C	T	10	7	17	0	0	17	0	0
17	27813222	.	A	G	10	6	16	0	1	17	0	0
17	27813549	.	C	G	10	4	14	0	1	15	0	0
17	27813553	.	C	G	8	3	11	0	2	13	0	0
17	28049663	.	A	T	6	7	13	0	0	13	0	0
17	28049804	.	G	T	7	4	11	0	0	11	0	0
17	28050500	.	T	A	5	10	15	0	0	15	0	0
17	28050530	.	A	G	4	9	13	0	0	13	0	0
17	28050954	.	G	A	9	5	14	0	1	15	0	0
17	28051073	.	C	T	6	5	11	0	1	12	0	0
17	28051129	.	G	A	5	4	9	0	1	10	0	0
17	28051222	.	C	T	4	2	6	0	0	6	0	0
17	28051247	.	T	A	5	5	10	0	0	10	0	0
17	28051465	.	T	C	4	2	6	0	1	7	0	0
17	28051504	.	G	T	3	7	10	0	0	10	0	0
17	28051605	.	A	G	3	9	12	0	0	12	0	0
17	28051739	.	A	G	12	4	16	0	1	17	0	0
17	28052322	.	C	A	7	6	13	0	0	13	0	0
17	28067389	.	C	T	10	4	14	0	0	14	0	0
17	28067472	.	A	C	10	5	15	0	3	18	0	0
17	28067618	.	A	G	7	5	12	0	0	12	0	0
17	28067856	.	C	T	8	9	17	0	1	18	0	0
17	28068083	.	T	C	11	3	14	0	0	14	0	0
17	28068087	.	G	T	11	3	14	0	0	14	0	0
17	28068168	.	G	A	4	8	12	0	1	13	0	0
17	28068262	.	T	G	14	0	14	0	8	22	0	0
17	28068276	.	C	T	9	7	16	0	3	19	0	0
17	28068507	.	A	G	6	7	13	0	1	14	0	0
17	28068514	.	T	C	6	6	12	0	0	12	0	0
17	28068832	.	T	A	3	5	8	0	0	8	0	0
17	28068916	.	C	T	10	8	18	0	1	19	0	0
17	28069170	.	G	A	13	13	26	0	1	27	0	0
17	28069341	.	G	T	7	4	11	0	0	11	0	0
17	28069342	.	T	C	6	4	10	0	0	11	1	0
17	28069645	.	G	T	16	13	29	0	0	29	0	0
17	28069716	.	G	C	17	20	37	0	0	37	0	0
17	28069787	.	G	A	0	19	19	0	19	38	0	0
17	28070078	.	G	C	11	19	30	0	0	30	0	0
17	28070167	.	C	T	10	12	22	0	0	22	0	0
17	28070284	.	G	A	7	5	12	0	0	12	0	0
17	28070286	.	A	C	7	5	12	0	0	12	0	0
17	28070481	.	T	A	16	13	29	0	0	29	0	0
17	28070600	.	C	A	15	10	25	0	2	27	0	0
17	28070840	.	G	A	5	15	20	0	0	20	0	0
17	28070879	.	T	G	8	7	15	0	1	16	0	0
17	28070897	.	T	A	4	5	9	0	2	11	0	0
17	28071194	.	C	T	10	3	13	0	3	16	0	0
17	28071260	.	A	G	11	7	18	0	1	19	0	0
17	28084592	.	C	T	13	6	19	0	1	20	0	0
17	28084908	.	C	T	12	21	33	0	0	33	0	0
17	28097235	.	G	A	1	4	5	0	0	5	0	0
17	28100598	.	C	T	0	11	11	0	11	22	0	0
17	28167312	.	G	A	3	7	10	0	0	10	0	0
17	28167313	.	A	T	3	7	10	0	0	10	0	0
17	28168645	.	C	T	4	3	7	0	0	7	0	0
17	28168712	.	T	A	3	5	8	0	2	10	0	0
17	28168941	.	A	T	3	4	7	0	0	7	0	0
17	28169141	.	A	C	0	1	1	0	0	1	0	0
17	28197797	.	A	T	2	1	3	0	0	3	0	0
17	28197957	.	G	A	2	3	5	0	0	5	0	0
17	28340740	.	A	T	3	3	6	0	0	6	0	0
17	28408024	.	A	C	0	0	0	0	1	1	0	0
17	28440212	.	T	A	3	6	9	0	0	9	0	0
17	28461857	.	G	A	0	2	2	0	5	7	0	0
17	28466273	.	C	T	2	6	8	0	0	8	0	0
17	28610150	.	G	C	1	1	2	0	0	2	0	0
17	28632871	.	C	T	2	2	4	0	0	4	0	0
17	28654157	.	G	T	0	2	2	0	0	2	0	0
17	28658629	.	C	T	4	2	6	0	1	7	0	0
17	28661628	.	C	G	9	0	9	0	3	12	0	0
17	28661931	.	G	T	1	2	3	0	2	5	0	0
17	28666381	.	C	T	1	1	2	0	0	2	0	0
17	28670351	.	T	A	3	7	10	0	0	10	0	0
17	28670352	.	C	T	3	7	10	0	0	10	0	0
17	28675202	.	G	A	2	2	4	0	0	4	0	0
17	28680593	.	T	C	3	9	12	0	0	12	0	0
17	28683074	.	C	T	1	0	1	0	0	1	0	0
17	28683415	.	T	C	2	2	4	0	0	4	0	0
17	28688931	.	G	T	8	5	13	0	2	15	0	0
17	28694574	.	A	T	0	3	3	0	0	3	0	0
17	28694589	.	T	C	0	5	5	0	1	6	0	0
17	28695956	.	G	A	11	5	16	0	1	17	0	0
17	28696109	.	C	A	15	7	22	0	1	23	0	0
17	28696160	.	C	T	9	11	20	0	1	21	0	0
17	28696311	.	C	T	7	12	19	0	1	20	0	0
17	28696397	.	A	G	7	0	7	0	18	25	0	0
17	28700311	.	T	C	0	1	1	0	1	2	0	0
17	28700428	.	G	A	16	20	36	0	0	36	0	0
17	28701100	.	G	A	12	6	18	0	2	20	0	0
17	28707851	.	C	A	0	3	3	0	9	12	0	0
17	28730705	.	C	T	6	3	9	0	0	9	0	0
17	28738387	.	C	T	6	1	7	0	0	7	0	0
17	28738675	.	A	G	5	0	5	0	3	8	0	0
17	28741421	.	A	C	12	13	25	0	3	28	0	0
17	28741540	.	A	G	10	0	10	0	7	17	0	0
17	28741752	.	C	T	9	11	20	0	0	20	0	0
17	28741934	.	C	T	7	8	15	0	1	16	0	0
17	28742263	.	G	C	12	16	28	0	0	28	0	0
17	28742385	.	T	A	10	6	16	0	0	16	0	0
17	28742395	.	G	A	0	10	10	0	7	17	0	0
17	28742559	.	C	T	12	20	32	0	1	33	0	0
17	28742681	.	C	T	2	7	9	0	0	9	0	0
17	28742755	.	C	A	2	2	4	0	0	4	0	0
17	28771228	.	T	A	3	2	5	0	0	5	0	0
17	28777803	.	C	T	0	3	3	0	0	3	0	0
17	28784090	.	G	T	3	2	5	0	1	6	0	0
17	28784102	.	G	A	2	4	6	0	0	6	0	0
17	28785010	.	G	A	3	1	4	0	0	4	0	0
17	28785013	.	C	T	1	3	4	0	0	4	0	0
17	28789014	.	C	T	0	5	5	0	3	8	0	0
17	28793818	.	G	A	1	3	4	0	0	4	0	0
17	28942683	.	C	T	0	1	1	0	0	1	0	0
17	28948818	.	G	A	3	0	3	0	0	3	0	0
17	28958371	.	C	T	1	1	2	0	0	2	0	0
17	28959148	.	T	C	11	4	15	0	2	17	0	0
17	28968461	.	T	C	22	17	39	0	0	39	0	0
17	28968611	.	C	T	6	2	8	0	0	8	0	0
17	29117355	.	G	A	9	3	12	0	1	13	0	0
17	29227691	.	T	A	2	2	4	0	0	4	0	0
17	29252207	.	G	A	6	7	13	0	0	13	0	0
17	29253050	.	T	C	1	3	4	0	0	4	0	0
17	29282901	.	C	A	5	4	9	0	0	9	0	0
17	29283270	.	C	T	1	4	5	0	0	5	0	0
17	29283273	.	C	T	1	4	5	0	0	5	0	0
17	29283380	.	T	A	2	4	6	0	2	8	0	0
17	29283866	.	T	C	6	12	18	0	1	19	0	0
17	29283920	.	A	C	6	0	6	0	11	17	0	0
17	29283943	.	A	G	4	7	11	0	1	12	0	0
17	29283962	.	A	G	3	5	8	0	0	8	0	0
17	29288057	.	G	T	2	6	8	0	0	8	0	0
17	29288718	.	A	G	2	1	3	0	0	3	0	0
17	29298191	.	G	C	2	0	2	0	2	4	0	0
17	29300641	.	A	T	3	3	6	0	1	7	0	0
17	29300650	.	A	G	4	4	8	0	0	8	0	0
17	29301058	.	G	C	2	4	6	0	0	6	0	0
17	29306598	.	A	C	1	3	4	0	1	5	0	0
17	29306670	.	C	T	4	7	11	0	0	11	0	0
17	29306854	.	C	T	0	1	1	0	5	6	0	0
17	29308639	.	G	T	9	4	13	0	1	14	0	0
17	29308693	.	G	A	5	9	14	0	0	14	0	0
17	29308706	.	G	A	5	5	10	0	0	10	0	0
17	29308987	.	A	T	2	5	7	0	0	7	0	0
17	29310200	.	T	C	2	7	9	0	0	9	0	0
17	29312434	.	C	T	0	5	5	0	1	6	0	0
17	29334520	.	T	A	0	2	2	0	0	2	0	0
17	29334569	.	A	C	1	3	4	0	0	4	0	0
17	29335645	.	G	A	1	1	2	0	0	2	0	0
17	29336179	.	G	A	6	5	11	0	1	12	0	0
17	29336180	.	G	T	6	6	12	0	0	12	0	0
17	29341079	.	C	T	9	4	13	0	0	13	0	0
17	29341123	.	C	A	2	6	8	0	0	8	0	0
17	29345725	.	T	G	11	9	20	0	2	22	0	0
17	29345890	.	T	A	9	6	15	0	0	15	0	0
17	29366113	.	G	A	0	5	5	0	6	11	0	0
17	29369642	.	G	T	16	10	26	0	1	27	0	0
17	29369644	.	G	A	16	11	27	0	0	27	0	0
17	29797906	.	C	T	14	11	25	0	4	29	0	0
17	29804291	.	G	C	8	8	16	0	2	18	0	0
17	29804441	.	T	C	1	0	1	0	4	5	0	0
17	29876956	.	G	A	6	1	7	0	0	7	0	0
17	29877094	.	A	G	3	9	12	0	0	12	0	0
17	29877283	.	C	A	0	9	9	0	8	17	0	0
17	30397326	.	A	T	0	1	1	0	0	1	0	0
17	30397333	.	T	C	0	1	1	0	0	1	0	0
17	30411474	.	C	T	1	2	3	0	0	3	0	0
17	30414463	.	C	A	3	5	8	0	0	8	0	0
17	30450275	.	G	A	6	2	8	0	0	8	0	0
17	30590075	.	A	T	6	7	13	0	0	13	0	0
17	30590661	.	G	A	2	3	5	0	0	5	0	0
17	30590663	.	T	A	2	2	4	0	1	5	0	0
17	30857431	.	A	T	2	10	12	0	2	14	0	0
17	30857433	.	A	T	3	8	11	0	3	14	0	0
17	30979391	.	T	C	10	0	10	0	17	27	0	0
17	31297768	.	G	T	0	10	10	0	0	10	0	0
17	31621894	.	C	T	0	13	13	0	0	13	0	0
17	31935728	.	C	T	6	2	8	0	0	8	0	0
17	33306723	.	A	G	2	3	5	0	0	5	0	0
17	34105333	.	G	A	0	0	0	0	1	1	0	0
17	34141488	.	T	G	5	5	10	0	0	10	0	0
17	34158945	.	G	A	7	7	14	0	0	14	0	0
17	34162932	.	G	C	6	6	12	0	0	12	0	0
17	34173297	.	C	T	0	0	0	0	1	1	0	0
17	34182672	.	G	A	2	5	7	0	9	16	0	0
17	34182949	.	C	T	13	8	21	0	1	22	0	0
17	34183002	.	T	C	18	14	32	0	0	32	0	0
17	34183320	.	T	G	38	13	51	0	0	51	0	0
17	34183497	.	T	C	18	13	31	0	1	32	0	0
17	34183512	.	A	T	20	14	34	0	1	35	0	0
17	34244437	.	G	T	7	13	20	0	0	20	0	0
17	34246289	.	T	C	3	8	11	0	1	12	0	0
17	34246295	.	A	G	4	9	13	0	0	13	0	0
17	34254065	.	A	G	10	7	17	0	0	17	0	0
17	34807498	.	T	A	19	24	43	0	0	43	0	0
17	34807781	.	C	T	5	2	7	0	1	8	0	0
17	34808024	.	T	C	4	3	7	0	1	8	0	0
17	34810865	.	A	C	0	2	2	0	0	2	0	0
17	34810866	.	C	A	0	2	2	0	0	2	0	0
17	34970088	.	A	G	1	3	4	0	0	4	0	0
17	34973964	.	G	A	2	2	4	0	0	4	0	0
17	34978627	.	A	G	1	2	3	0	0	3	0	0
17	35187858	.	T	C	3	2	5	0	0	5	0	0
17	35189322	.	T	C	5	1	6	0	0	6	0	0
17	35193156	.	C	T	0	3	3	0	0	3	0	0
17	35198161	.	T	A	3	3	6	0	0	6	0	0
17	35198221	.	G	A	0	2	2	0	1	3	0	0
17	35199296	.	A	G	0	1	1	0	0	1	0	0
17	35203236	.	T	C	2	1	3	0	0	3	0	0
17	35204714	.	T	C	1	1	2	0	0	2	0	0
17	35204720	.	A	T	1	1	2	0	0	2	0	0
17	35210724	.	T	C	2	0	2	0	0	2	0	0
17	35210811	.	T	C	5	10	15	0	0	15	0	0
17	35210853	.	A	G	7	8	15	0	1	16	0	0
17	35210868	.	C	A	7	11	18	0	0	18	0	0
17	35213989	.	G	A	9	8	17	0	0	17	0	0
17	35222582	.	G	A	0	7	7	0	2	9	0	0
17	35222762	.	C	A	8	5	13	0	0	13	0	0
17	35222864	.	G	A	6	3	9	0	0	9	0	0
17	35222994	.	A	T	7	5	12	0	1	13	0	0
17	35223051	.	A	T	5	9	14	0	0	14	0	0
17	35223057	.	A	G	5	8	13	0	1	14	0	0
17	35223151	.	T	C	9	8	17	0	1	18	0	0
17	35223195	.	C	T	5	11	16	0	0	16	0	0
17	35223368	.	G	A	0	6	6	0	11	17	0	0
17	35226377	.	G	A	1	5	6	0	0	6	0	0
17	35229163	.	T	A	3	0	3	0	0	3	0	0
17	35246383	.	G	A	1	2	3	0	1	4	0	0
17	35246994	.	A	G	3	3	6	0	0	6	0	0
17	35247012	.	T	A	4	1	5	0	1	6	0	0
17	35247682	.	T	C	6	0	6	0	8	14	0	0
17	35247838	.	T	C	17	11	28	0	2	30	0	0
17	35248038	.	C	T	9	12	21	0	0	21	0	0
17	35248121	.	T	A	4	7	11	0	1	12	0	0
17	35248264	.	G	A	9	9	18	0	0	18	0	0
17	35248577	.	T	C	4	5	9	0	0	9	0	0
17	35249136	.	G	A	6	3	9	0	0	9	0	0
17	35249141	.	T	G	6	4	10	0	0	10	0	0
17	35249206	.	C	A	6	6	12	0	0	12	0	0
17	35249230	.	T	G	4	3	7	0	0	7	0	0
17	35249422	.	A	C	9	6	15	0	0	15	0	0
17	35249577	.	G	A	15	4	19	0	0	19	0	0
17	35249688	.	A	G	12	5	17	0	0	17	0	0
17	35249795	.	T	C	12	0	12	0	1	13	0	0
17	35250060	.	C	A	0	5	5	0	6	11	0	0
17	35250300	.	C	T	12	9	21	0	3	24	0	0
17	35250328	.	G	A	14	11	25	0	1	26	0	0
17	35260787	.	A	G	9	7	16	0	0	16	0	0
17	35261077	.	T	C	1	3	4	0	0	4	0	0
17	35267038	.	G	T	4	6	10	0	0	10	0	0
17	35267068	.	A	T	0	1	1	0	0	1	0	0
17	35275631	.	T	C	1	0	1	0	2	3	0	0
17	35276147	.	C	G	7	5	12	0	0	12	0	0
17	35278679	.	A	G	3	8	11	0	0	11	0	0
17	35287371	.	C	T	8	4	12	0	0	12	0	0
17	35302531	.	G	T	5	2	7	0	0	7	0	0
17	35315119	.	G	A	4	1	5	0	0	5	0	0
17	35317524	.	G	T	1	1	2	0	0	2	0	0
17	35360486	.	T	A	2	3	5	0	0	5	0	0
17	35878860	.	G	T	5	2	7	0	6	13	0	0
17	35881126	.	G	T	17	20	37	0	0	37	0	0
17	35881148	.	T	C	14	17	31	0	2	33	0	0
17	36588754	.	C	T	4	5	9	0	2	11	0	0
17	36589295	.	C	T	5	11	16	0	1	17	0	0
17	36589435	.	C	A	4	3	7	0	0	7	0	0
17	36589554	.	G	A	2	7	9	0	1	10	0	0
17	36699801	.	C	T	1	1	2	0	0	2	0	0
17	36867298	.	C	T	0	13	13	0	10	23	0	0
17	36867355	.	T	C	12	9	21	0	1	22	0	0
17	36867450	.	T	C	9	7	16	0	0	16	0	0
17	36867471	.	G	A	8	9	17	0	2	19	0	0
17	36867558	.	T	C	10	0	10	0	6	16	0	0
17	36867568	.	A	G	6	6	12	0	2	14	0	0
17	36867738	.	T	C	12	1	13	0	15	28	0	0
17	36867915	.	A	G	15	8	23	0	2	25	0	0
17	36867945	.	T	C	6	0	6	0	3	9	0	0
17	36867951	.	A	G	6	1	7	0	0	7	0	0
17	36872564	.	C	T	0	3	3	0	3	6	0	0
17	36884529	.	A	G	8	7	15	0	1	16	0	0
17	36899746	.	A	T	23	14	37	0	0	37	0	0
17	36899760	.	T	A	24	16	40	0	0	40	0	0
17	36899853	.	T	C	16	26	42	0	0	42	0	0
17	36905905	.	A	G	7	7	14	0	1	15	0	0
17	36905998	.	A	G	17	24	41	0	0	41	0	0
17	36906007	.	G	C	19	0	19	0	24	43	0	0
17	36909904	.	C	T	1	5	6	0	6	12	0	0
17	36911113	.	T	C	4	0	4	0	2	6	0	0
17	36914689	.	C	T	0	5	5	0	7	12	0	0
17	36915353	.	A	G	10	5	15	0	0	15	0	0
17	36929111	.	T	C	9	14	23	0	0	23	0	0
17	36929198	.	C	T	17	15	32	0	0	32	0	0
17	36937975	.	G	A	21	17	38	0	2	40	0	0
17	36938035	.	C	T	16	19	35	0	1	36	0	0
17	36938761	.	T	A	14	13	27	0	1	28	0	0
17	36938819	.	G	A	17	9	26	0	4	30	0	0
17	36938979	.	A	G	5	10	15	0	1	16	0	0
17	36939029	.	A	G	7	7	14	0	1	15	0	0
17	36939064	.	A	G	10	6	16	0	0	16	0	0
17	36939400	.	T	A	5	5	10	0	0	10	0	0
17	36939493	.	G	A	11	3	14	0	1	15	0	0
17	36939574	.	A	G	9	7	16	0	0	16	0	0
17	36939698	.	G	C	8	16	24	0	1	25	0	0
17	36939736	.	C	T	15	8	23	0	2	25	0	0
17	36939973	.	T	G	2	9	11	0	0	11	0	0
17	36940074	.	T	C	10	6	16	0	0	16	0	0
17	36940236	.	T	C	8	0	8	0	5	13	0	0
17	36940424	.	C	A	6	8	14	0	1	15	0	0
17	36940451	.	G	A	5	5	10	0	0	10	0	0
17	36940974	.	T	G	3	14	17	0	1	18	0	0
17	36940977	.	T	C	3	13	16	0	1	17	0	0
17	36941065	.	C	T	5	3	8	0	0	8	0	0
17	36941121	.	A	C	10	7	17	0	1	18	0	0
17	36941291	.	C	T	0	6	6	0	5	11	0	0
17	36941352	.	G	A	3	4	7	0	2	9	0	0
17	36941523	.	A	G	7	2	9	0	2	11	0	0
17	36941675	.	G	A	3	4	7	0	0	7	0	0
17	36941788	.	G	T	5	3	8	0	0	8	0	0
17	36947137	.	T	C	2	2	4	0	0	4	0	0
17	36947218	.	G	A	3	2	5	0	0	5	0	0
17	36951602	.	C	A	2	2	4	0	0	4	0	0
17	36956946	.	A	G	2	4	6	0	0	6	0	0
17	36956993	.	C	T	0	4	4	0	2	6	0	0
17	36957029	.	T	C	1	1	2	0	0	2	0	0
17	36962179	.	G	A	1	1	2	0	0	2	0	0
17	36970705	.	A	G	3	6	9	0	0	9	0	0
17	36970937	.	T	C	6	6	12	0	0	12	0	0
17	37013465	.	A	G	5	8	13	0	0	13	0	0
17	37070262	.	G	C	9	6	15	0	1	16	0	0
17	37070310	.	G	A	6	7	13	0	2	15	0	0
17	37070497	.	T	C	14	0	14	0	9	23	0	0
17	37070550	.	C	G	5	6	11	0	0	11	0	0
17	37073530	.	G	A	3	4	7	0	0	7	0	0
17	37076276	.	C	A	0	10	10	0	12	22	0	0
17	37086637	.	A	T	7	4	11	0	0	11	0	0
17	37086670	.	C	T	0	8	8	0	10	18	0	0
17	37088463	.	T	C	0	0	0	0	4	4	0	0
17	37088514	.	G	A	2	2	4	0	1	5	0	0
17	37134165	.	G	T	8	8	16	0	0	16	0	0
17	37143651	.	A	G	15	7	22	0	0	22	0	0
17	37143669	.	C	G	11	6	17	0	1	18	0	0
17	37156496	.	G	T	7	9	16	0	0	16	0	0
17	37156512	.	T	A	4	7	11	0	0	11	0	0
17	37162624	.	C	T	2	3	5	0	0	5	0	0
17	37162645	.	G	T	2	3	5	0	0	5	0	0
17	37162953	.	A	T	2	4	6	0	0	6	0	0
17	37163016	.	T	G	2	3	5	0	0	5	0	0
17	37163699	.	A	G	1	2	3	0	0	3	0	0
17	37163858	.	A	G	3	2	5	0	0	5	0	0
17	37164035	.	G	A	2	2	4	0	0	4	0	0
17	37165320	.	G	A	1	1	2	0	0	2	0	0
17	37165684	.	A	G	3	1	4	0	0	4	0	0
17	37165734	.	A	T	2	2	4	0	0	4	0	0
17	37195040	.	G	A	2	3	5	0	1	6	0	0
17	37204273	.	A	C	9	6	15	0	0	15	0	0
17	37204417	.	G	A	7	13	20	0	1	21	0	0
17	37204484	.	T	C	7	0	7	0	17	24	0	0
17	37210305	.	C	T	0	3	3	0	5	8	0	0
17	37212127	.	A	G	9	9	18	0	1	19	0	0
17	37212154	.	T	C	4	4	8	0	1	9	0	0
17	37212485	.	T	A	5	6	11	0	0	11	0	0
17	37212592	.	T	G	16	17	33	0	1	34	0	0
17	37212616	.	G	T	15	15	30	0	1	31	0	0
17	37212634	.	C	T	13	18	31	0	0	31	0	0
17	37212725	.	T	C	15	18	33	0	0	33	0	0
17	37212757	.	T	C	17	19	36	0	0	36	0	0
17	37212832	.	G	A	10	15	25	0	1	26	0	0
17	37213231	.	C	T	12	12	24	0	1	25	0	0
17	37213416	.	G	T	6	9	15	0	0	15	0	0
17	37213677	.	T	C	16	16	32	0	1	33	0	0
17	37213887	.	G	A	9	16	25	0	0	25	0	0
17	37213900	.	C	A	12	13	25	0	1	26	0	0
17	37213928	.	T	C	11	11	22	0	0	22	0	0
17	37213999	.	A	G	17	14	31	0	0	31	0	0
17	37214022	.	C	T	19	15	34	0	1	35	0	0
17	37220101	.	T	G	2	0	2	0	3	5	0	0
17	37220104	.	A	G	2	0	2	0	3	5	0	0
17	37220317	.	T	C	1	3	4	0	0	4	0	0
17	37220515	.	A	G	1	0	1	0	2	3	0	0
17	37220647	.	A	C	3	2	5	0	0	5	0	0
17	37228020	.	C	A	1	0	1	0	0	1	0	0
17	37231271	.	C	G	2	0	2	0	0	2	0	0
17	37234489	.	T	C	3	0	3	0	0	3	0	0
17	37237230	.	T	C	3	2	5	0	0	5	0	0
17	37239402	.	T	G	6	7	13	0	1	14	0	0
17	37239981	.	C	T	1	5	6	0	0	6	0	0
17	37240088	.	T	C	0	1	1	0	0	1	0	0
17	37241661	.	A	G	9	12	21	0	2	23	0	0
17	37241676	.	T	G	7	4	11	0	14	25	0	0
17	37241700	.	C	T	4	12	16	0	2	18	0	0
17	37252299	.	T	A	5	10	15	0	2	17	0	0
17	37252352	.	G	A	12	6	18	0	0	18	0	0
17	37252374	.	G	T	0	11	11	0	13	24	0	0
17	37252441	.	A	T	10	10	20	0	1	21	0	0
17	37252716	.	G	A	0	6	6	0	4	10	0	0
17	37253742	.	G	A	0	2	2	0	3	5	0	0
17	37253832	.	C	G	3	0	3	0	3	6	0	0
17	37254017	.	T	C	1	1	2	0	1	3	0	0
17	37263068	.	T	C	3	3	6	0	0	6	0	0
17	37263101	.	T	G	2	0	2	0	1	3	0	0
17	37267740	.	A	G	3	0	3	0	4	7	0	0
17	37268036	.	A	G	6	8	14	0	0	14	0	0
17	37268063	.	A	G	7	8	15	0	0	15	0	0
17	37273585	.	C	T	1	2	3	0	0	3	0	0
17	37280950	.	A	T	2	4	6	0	0	6	0	0
17	37280974	.	C	T	4	3	7	0	0	7	0	0
17	37291436	.	C	G	0	4	4	0	0	4	0	0
17	37291447	.	G	A	0	3	3	0	0	3	0	0
17	37316418	.	C	A	0	2	2	0	0	2	0	0
17	37316713	.	C	T	1	2	3	0	0	3	0	0
17	37316889	.	A	G	2	0	2	0	5	7	0	0
17	37317028	.	T	A	3	6	9	0	0	9	0	0
17	37317165	.	A	G	2	6	8	0	1	9	0	0
17	37317171	.	A	T	3	5	8	0	0	8	0	0
17	37317507	.	T	C	7	7	14	0	0	14	0	0
17	37317636	.	G	A	5	7	12	0	0	12	0	0
17	37317756	.	A	G	12	8	20	0	1	21	0	0
17	37317809	.	T	C	5	3	8	0	1	9	0	0
17	37317885	.	A	C	2	5	7	0	0	7	0	0
17	37317922	.	G	A	4	5	9	0	0	9	0	0
17	37317945	.	A	G	3	3	6	0	0	6	0	0
17	37318011	.	A	G	3	2	5	0	0	5	0	0
17	37320150	.	C	G	11	6	17	0	0	17	0	0
17	37320153	.	T	C	11	6	17	0	0	17	0	0
17	37323060	.	T	G	2	0	2	0	18	20	0	0
17	37323168	.	G	A	0	5	5	0	7	12	0	0
17	37323303	.	C	T	1	1	2	0	0	2	0	0
17	37323306	.	T	C	1	1	2	0	0	2	0	0
17	37350660	.	T	C	5	4	9	0	0	9	0	0
17	37350708	.	C	T	5	4	9	0	0	9	0	0
17	37352961	.	C	A	4	1	5	0	0	5	0	0
17	37353043	.	T	C	12	5	17	0	0	17	0	0
17	37360975	.	C	G	3	0	3	0	8	11	0	0
17	37361173	.	G	A	4	4	8	0	0	8	0	0
17	37361233	.	C	T	6	6	12	0	0	12	0	0
17	37361349	.	C	T	6	8	14	0	0	14	0	0
17	37361556	.	T	A	4	3	7	0	2	9	0	0
17	37361605	.	G	A	0	5	5	0	2	7	0	0
17	37361669	.	C	T	5	1	6	0	0	6	0	0
17	37362139	.	C	G	6	5	11	0	1	12	0	0
17	37362153	.	G	T	6	8	14	0	1	15	0	0
17	37362181	.	C	T	3	6	9	0	0	9	0	0
17	37362198	.	C	T	4	5	9	0	0	9	0	0
17	37362249	.	G	A	1	4	5	0	2	7	0	0
17	37362258	.	T	A	1	6	7	0	0	7	0	0
17	37362298	.	C	G	7	4	11	0	0	11	0	0
17	37362380	.	C	A	6	4	10	0	0	10	0	0
17	37362506	.	T	C	2	4	6	0	0	6	0	0
17	37362574	.	T	A	5	2	7	0	0	7	0	0
17	37362851	.	A	T	4	2	6	0	0	6	0	0
17	37362876	.	T	C	2	3	5	0	0	5	0	0
17	37363115	.	T	C	4	5	9	0	0	9	0	0
17	37363309	.	C	G	5	5	10	0	0	10	0	0
17	37363609	.	G	A	2	4	6	0	2	8	0	0
17	37363679	.	A	T	1	2	3	0	0	3	0	0
17	37363737	.	A	C	1	2	3	0	1	4	0	0
17	37363802	.	T	A	3	9	12	0	0	12	0	0
17	37363809	.	C	T	3	9	12	0	0	12	0	0
17	37363855	.	T	G	2	5	7	0	0	7	0	0
17	37363857	.	T	C	2	5	7	0	0	7	0	0
17	37363959	.	A	T	1	3	4	0	0	4	0	0
17	37363998	.	G	A	1	3	4	0	0	4	0	0
17	37364061	.	G	T	7	9	16	0	0	16	0	0
17	37364517	.	C	T	7	7	14	0	0	14	0	0
17	37364533	.	T	C	4	5	9	0	2	11	0	0
17	37364620	.	C	T	10	8	18	0	1	19	0	0
17	37364676	.	A	C	5	3	8	0	1	9	0	0
17	37365020	.	A	G	11	11	22	0	1	23	0	0
17	37385920	.	T	A	4	2	6	0	0	6	0	0
17	37446789	.	A	C	15	1	16	0	2	18	0	0
17	37446790	.	A	C	16	2	18	0	0	18	0	0
17	38714446	.	A	G	1	2	3	0	0	3	0	0
17	38887156	.	C	T	1	3	4	0	1	5	0	0
17	38887271	.	T	G	4	8	12	0	0	12	0	0
17	38927932	.	T	C	6	4	10	0	1	11	0	0
17	38928775	.	C	T	2	1	3	0	1	4	0	0
17	38928947	.	A	T	2	6	8	0	0	8	0	0
17	38929142	.	T	G	7	6	13	0	1	14	0	0
17	38929437	.	C	T	1	3	4	0	0	4	0	0
17	38938727	.	G	A	5	2	7	0	0	7	0	0
17	38941193	.	T	C	2	2	4	0	0	4	0	0
17	38941286	.	G	A	4	4	8	0	0	8	0	0
17	38946528	.	G	A	1	3	4	0	0	4	0	0
17	38946619	.	G	A	0	1	1	0	0	1	0	0
17	38989302	.	G	C	1	0	1	0	1	2	0	0
17	39697690	.	T	C	7	4	11	0	1	12	0	0
17	39703380	.	C	A	4	1	5	0	1	6	0	0
17	39707421	.	C	T	8	5	13	0	0	13	0	0
17	39717616	.	T	C	0	1	1	0	0	1	0	0
17	39717645	.	A	G	2	1	3	0	2	5	0	0
17	39720791	.	T	C	8	4	12	0	3	15	0	0
17	39728239	.	C	T	3	10	13	0	0	13	0	0
17	39728261	.	G	T	4	14	18	0	1	19	0	0
17	39728423	.	T	A	4	6	10	0	0	10	0	0
17	39729014	.	G	A	8	12	20	0	2	23	1	0
17	39732512	.	C	T	3	8	11	0	0	11	0	0
17	39732573	.	C	A	11	5	16	0	0	16	0	0
17	39732584	.	G	A	6	11	17	0	0	17	0	0
17	39736088	.	T	A	9	8	17	0	2	19	0	0
17	39736103	.	G	A	12	8	20	0	0	20	0	0
17	39736130	.	T	C	12	11	23	0	1	24	0	0
17	39739842	.	A	T	4	6	10	0	0	10	0	0
17	39862334	.	A	G	1	2	3	0	0	3	0	0
17	39862536	.	C	G	7	7	14	0	1	15	0	0
17	40214030	.	T	A	1	9	10	0	2	12	0	0
17	40223456	.	G	A	2	4	6	0	0	6	0	0
17	40223457	.	G	A	2	4	6	0	0	6	0	0
17	40860266	.	C	T	2	3	5	0	0	5	0	0
17	40879510	.	A	G	5	4	9	0	0	9	0	0
17	40879822	.	C	T	4	2	6	0	1	7	0	0
17	40879823	.	C	T	3	3	6	0	1	7	0	0
17	40880042	.	G	A	6	4	10	0	0	10	0	0
17	40883361	.	T	A	5	2	7	0	0	7	0	0
17	40887272	.	T	C	0	2	2	0	0	2	0	0
17	40887285	.	G	T	4	0	4	0	0	4	0	0
17	40888907	.	A	C	1	1	2	0	0	2	0	0
17	40888909	.	G	C	1	1	2	0	0	2	0	0
17	40889613	.	C	A	0	0	0	0	1	1	0	0
17	40889637	.	T	C	0	2	2	0	0	2	0	0
17	40889661	.	T	G	1	3	4	0	0	4	0	0
17	40889697	.	A	G	5	1	6	0	0	6	0	0
17	40890056	.	C	T	2	2	4	0	0	4	0	0
17	40890107	.	G	T	4	2	6	0	0	6	0	0
17	40890396	.	C	T	2	5	7	0	0	7	0	0
17	40890433	.	G	A	1	1	2	0	1	3	0	0
17	40890443	.	C	T	0	1	1	0	0	1	0	0
17	40893919	.	A	T	0	1	1	0	0	1	0	0
17	40899449	.	A	G	1	4	5	0	0	5	0	0
17	40899489	.	A	C	4	4	8	0	1	9	0	0
17	40899527	.	C	T	2	3	5	0	0	5	0	0
17	40899528	.	T	A	2	3	5	0	0	5	0	0
17	40899873	.	T	G	0	3	3	0	0	3	0	0
17	40899880	.	C	T	2	3	5	0	0	5	0	0
17	40900354	.	C	T	7	6	13	0	0	13	0	0
17	40900686	.	T	G	10	4	14	0	0	14	0	0
17	40901695	.	G	C	6	10	16	0	2	19	1	0
17	40901712	.	C	G	7	8	15	0	0	15	0	0
17	40901752	.	G	A	1	4	5	0	0	5	0	0
17	40901799	.	A	C	1	3	4	0	0	4	0	0
17	40901804	.	A	T	1	3	4	0	0	4	0	0
17	40902005	.	C	A	4	6	10	0	2	12	0	0
17	40902065	.	G	A	6	7	13	0	0	13	0	0
17	40902148	.	G	T	6	5	11	0	0	11	0	0
17	40902180	.	G	C	4	8	12	0	0	12	0	0
17	40902276	.	A	G	5	2	7	0	1	8	0	0
17	40902297	.	A	G	2	10	12	0	0	12	0	0
17	40902347	.	C	T	6	8	14	0	0	14	0	0
17	40902598	.	G	A	7	3	10	0	1	11	0	0
17	40902629	.	A	T	7	6	13	0	1	14	0	0
17	40902657	.	A	C	8	7	15	0	0	15	0	0
17	40902830	.	A	T	4	10	14	0	0	14	0	0
17	40903162	.	C	T	6	6	12	0	1	13	0	0
17	40990061	.	T	A	7	8	15	0	0	16	1	0
17	40990097	.	T	A	1	3	4	0	0	4	0	0
17	40999460	.	A	G	12	10	22	0	0	22	0	0
17	40999697	.	C	G	5	7	12	0	1	13	0	0
17	40999700	.	C	A	5	10	15	0	0	15	0	0
17	40999732	.	A	G	8	4	12	0	1	13	0	0
17	41084670	.	T	C	7	5	12	0	1	13	0	0
17	41092465	.	C	T	1	1	2	0	0	2	0	0
17	41220064	.	T	A	1	1	2	0	0	2	0	0
17	41254741	.	C	T	2	2	4	0	1	5	0	0
17	41264165	.	C	A	4	2	6	0	0	6	0	0
17	41314040	.	G	T	0	15	15	0	11	26	0	0
17	41314097	.	T	C	14	10	24	0	2	26	0	0
17	41314471	.	G	A	8	6	14	0	2	16	0	0
17	41314501	.	A	G	4	3	7	0	0	7	0	0
17	41317234	.	A	G	6	2	8	0	10	18	0	0
17	41317494	.	G	A	8	19	27	0	1	28	0	0
17	41317999	.	G	A	13	10	23	0	2	25	0	0
17	41318310	.	A	G	14	13	27	0	1	28	0	0
17	41318392	.	G	A	7	5	12	0	0	12	0	0
17	41343243	.	G	A	0	2	2	0	0	2	0	0
17	41464090	.	G	A	0	5	5	0	7	12	0	0
17	41465504	.	A	C	7	3	10	0	0	10	0	0
17	41475863	.	T	C	11	12	23	0	1	24	0	0
17	41476104	.	T	C	18	0	18	0	16	34	0	0
17	41476161	.	A	G	17	19	36	0	0	36	0	0
17	41476279	.	G	A	19	13	32	0	1	33	0	0
17	41476298	.	T	A	16	14	30	0	3	33	0	0
17	41476833	.	T	C	6	4	10	0	0	10	0	0
17	41476906	.	A	C	2	0	2	0	8	10	0	0
17	41476917	.	C	T	0	8	8	0	5	13	0	0
17	41476970	.	T	C	8	10	18	0	0	18	0	0
17	41476994	.	G	A	6	6	12	0	2	14	0	0
17	41477007	.	C	T	0	8	8	0	6	14	0	0
17	41477157	.	T	C	5	4	9	0	1	10	0	0
17	41477324	.	G	A	6	14	20	0	0	20	0	0
17	41488489	.	G	T	1	0	1	0	0	1	0	0
17	41571328	.	T	A	7	5	12	0	1	13	0	0
17	41583555	.	C	G	0	8	8	0	8	16	0	0
17	41583747	.	G	T	11	8	19	0	1	20	0	0
17	41583768	.	T	C	5	0	5	0	9	14	0	0
17	41583786	.	A	G	2	4	6	0	0	6	0	0
17	41601633	.	G	A	1	1	2	0	1	3	0	0
17	41602081	.	T	C	1	1	2	0	0	2	0	0
17	41610991	.	G	A	2	2	4	0	0	4	0	0
17	41631083	.	C	A	0	2	2	0	6	8	0	0
17	41639674	.	A	G	2	0	2	0	0	2	0	0
17	41639675	.	G	A	2	0	2	0	0	2	0	0
17	41667069	.	G	A	6	7	13	0	0	13	0	0
17	41667109	.	C	T	0	3	3	0	4	7	0	0
17	41669288	.	G	A	4	4	8	0	1	9	0	0
17	41669406	.	A	G	1	0	1	0	0	1	0	0
17	41673488	.	C	T	1	1	2	0	0	2	0	0
17	41673513	.	G	A	3	1	4	0	0	4	0	0
17	41675497	.	T	A	1	1	2	0	1	3	0	0
17	41675511	.	T	C	2	2	4	0	0	4	0	0
17	41685644	.	G	A	2	2	4	0	1	5	0	0
17	41798753	.	C	T	1	2	3	0	1	4	0	0
17	41994768	.	G	T	2	6	8	0	0	8	0	0
17	42003872	.	C	T	4	2	6	0	0	6	0	0
17	42095602	.	A	G	2	3	5	0	0	5	0	0
17	42095620	.	C	T	2	2	4	0	0	4	0	0
17	42096960	.	C	G	1	7	8	0	3	11	0	0
17	42611658	.	G	A	1	2	3	0	0	3	0	0
17	42871419	.	G	T	11	9	20	0	1	21	0	0
17	43013675	.	G	A	5	5	10	0	2	12	0	0
17	43017672	.	C	T	16	16	32	0	1	33	0	0
17	43017687	.	G	A	16	15	31	0	0	31	0	0
17	43017830	.	A	G	8	12	20	0	0	20	0	0
17	43017863	.	A	C	13	13	26	0	0	26	0	0
17	43018037	.	G	A	0	15	15	0	17	32	0	0
17	43018124	.	A	G	20	0	20	0	2	22	0	0
17	43018273	.	G	A	16	23	39	0	2	41	0	0
17	43018382	.	T	G	15	17	32	0	1	33	0	0
17	43018502	.	T	A	15	23	38	0	1	39	0	0
17	43018549	.	C	G	14	11	25	0	1	26	0	0
17	43018638	.	A	T	12	16	28	0	0	28	0	0
17	43018815	.	A	G	16	18	34	0	2	36	0	0
17	43018899	.	T	A	11	17	28	0	0	28	0	0
17	43030696	.	T	C	3	6	9	0	2	11	0	0
17	43030737	.	T	G	10	13	23	0	2	25	0	0
17	43030828	.	G	A	9	6	15	0	0	15	0	0
17	43031495	.	G	A	4	2	6	0	0	6	0	0
17	43033177	.	G	A	10	8	18	0	2	20	0	0
17	43035798	.	T	C	15	15	30	0	3	33	0	0
17	43035958	.	A	G	17	7	24	0	5	29	0	0
17	43035996	.	G	T	9	19	28	0	2	30	0	0
17	43036025	.	A	G	12	11	23	0	1	24	0	0
17	43036055	.	T	C	11	6	17	0	1	18	0	0
17	43040422	.	T	A	3	5	8	0	0	8	0	0
17	43077327	.	C	T	0	1	1	0	0	1	0	0
17	43082871	.	G	A	1	0	1	0	1	2	0	0
17	43082976	.	A	T	7	3	10	0	0	10	0	0
17	43104590	.	T	A	0	3	3	0	0	3	0	0
17	43146487	.	G	A	1	3	4	0	0	4	0	0
17	43146607	.	G	C	2	3	5	0	0	5	0	0
17	43169143	.	G	A	0	1	1	0	0	1	0	0
17	43220001	.	A	G	4	1	5	0	0	5	0	0
17	43220058	.	G	A	1	0	1	0	0	1	0	0
17	43286920	.	C	T	3	3	6	0	0	6	0	0
17	43297561	.	T	G	4	3	7	0	0	7	0	0
17	43297946	.	G	C	15	16	31	0	0	31	0	0
17	43298011	.	G	A	11	17	28	0	1	29	0	0
17	43298068	.	G	A	14	16	30	0	1	31	0	0
17	43302492	.	G	A	8	9	17	0	0	17	0	0
17	43309095	.	A	G	7	6	13	0	1	14	0	0
17	43309164	.	C	T	1	4	5	0	8	13	0	0
17	43315085	.	C	T	2	2	4	0	0	4	0	0
17	43348986	.	T	C	1	4	5	0	2	7	0	0
17	43391434	.	G	T	8	4	12	0	0	12	0	0
17	43391442	.	C	T	8	3	11	0	1	12	0	0
17	43436782	.	T	C	16	1	17	0	17	34	0	0
17	43437305	.	G	C	11	12	23	0	0	23	0	0
17	43437365	.	C	G	4	5	9	0	0	9	0	0
17	43439720	.	G	T	15	13	28	0	2	30	0	0
17	43441575	.	A	T	2	0	2	0	0	2	0	0
17	43453507	.	T	C	3	9	12	0	2	14	0	0
17	43453531	.	G	A	5	14	19	0	1	20	0	0
17	43456825	.	C	T	15	10	25	0	1	26	0	0
17	43456900	.	G	A	12	13	25	0	0	25	0	0
17	43456921	.	T	C	7	9	16	0	0	16	0	0
17	43461181	.	G	A	2	2	4	0	0	4	0	0
17	43469515	.	G	T	3	4	7	0	1	8	0	0
17	43473913	.	T	C	8	2	10	0	0	10	0	0
17	43475562	.	T	C	11	12	23	0	1	24	0	0
17	43475577	.	G	A	0	12	12	0	11	23	0	0
17	43475619	.	A	G	10	0	10	0	14	24	0	0
17	43475691	.	T	A	4	4	8	0	0	8	0	0
17	43475994	.	T	G	5	4	9	0	0	9	0	0
17	43476137	.	T	A	3	5	8	0	1	9	0	0
17	43494970	.	A	G	0	0	0	0	4	4	0	0
17	43497376	.	A	G	3	7	10	0	0	10	0	0
17	43513318	.	C	T	0	3	3	0	5	8	0	0
17	43516451	.	T	A	0	3	3	0	1	4	0	0
17	43516464	.	T	A	2	3	5	0	0	5	0	0
17	43516502	.	G	T	4	7	11	0	1	12	0	0
17	43516506	.	A	C	5	7	12	0	1	13	0	0
17	43516548	.	A	G	4	9	13	0	0	13	0	0
17	43524233	.	T	C	1	2	3	0	0	3	0	0
17	43524245	.	T	G	1	2	3	0	0	3	0	0
17	43525600	.	C	G	2	1	3	0	0	3	0	0
17	43525757	.	A	G	1	2	3	0	0	3	0	0
17	43525804	.	G	A	2	3	5	0	0	5	0	0
17	43538081	.	G	A	3	6	9	0	1	10	0	0
17	43538097	.	C	T	2	7	9	0	0	9	0	0
17	43538209	.	C	T	2	7	9	0	3	12	0	0
17	43547945	.	A	G	1	2	3	0	0	3	0	0
17	43575504	.	C	T	0	2	2	0	5	7	0	0
17	43575782	.	C	T	4	2	6	0	0	6	0	0
17	43575886	.	G	T	1	4	5	0	1	6	0	0
17	43576107	.	T	A	2	2	4	0	0	4	0	0
17	43581769	.	G	A	0	1	1	0	0	1	0	0
17	43594806	.	T	C	1	2	3	0	0	3	0	0
17	43623882	.	C	A	2	4	6	0	0	6	0	0
17	43623892	.	G	T	2	3	5	0	0	5	0	0
17	43629055	.	G	C	1	6	7	0	1	8	0	0
17	43629092	.	A	G	4	0	4	0	5	9	0	0
17	43629418	.	G	A	0	2	2	0	2	4	0	0
17	43629422	.	G	C	2	2	4	0	0	4	0	0
17	43629502	.	G	A	0	4	4	0	8	12	0	0
17	43632931	.	G	T	0	1	1	0	0	1	0	0
17	43659950	.	T	G	3	2	5	0	0	5	0	0
17	43660168	.	C	T	12	4	16	0	0	16	0	0
17	43660232	.	G	A	11	11	22	0	0	22	0	0
17	43661176	.	C	G	3	5	8	0	0	8	0	0
17	43661223	.	G	T	3	8	11	0	0	11	0	0
17	43661578	.	A	G	6	4	10	0	0	10	0	0
17	43661618	.	T	A	6	5	11	0	0	11	0	0
17	43663611	.	T	G	6	4	10	0	1	11	0	0
17	43664128	.	G	C	13	16	29	0	3	32	0	0
17	43664176	.	C	A	2	13	15	0	13	28	0	0
17	43664605	.	G	A	13	6	19	0	0	19	0	0
17	43708608	.	C	T	7	8	15	0	1	16	0	0
17	43711502	.	G	A	3	5	8	0	0	8	0	0
17	43850878	.	A	T	10	3	13	0	2	15	0	0
17	43853767	.	A	T	6	5	11	0	1	12	0	0
17	43853778	.	C	T	1	5	6	0	4	10	0	0
17	43853938	.	C	T	0	1	1	0	0	1	0	0
17	43854010	.	T	G	7	8	15	0	1	16	0	0
17	43856232	.	T	C	2	2	4	0	1	5	0	0
17	43859306	.	A	T	6	6	12	0	1	13	0	0
17	43859378	.	C	T	10	13	23	0	0	23	0	0
17	43859387	.	C	T	9	11	20	0	0	20	0	0
17	43863540	.	C	A	12	11	23	0	2	25	0	0
17	43926650	.	C	A	1	1	2	0	0	2	0	0
17	43946490	.	T	G	3	0	3	0	4	7	0	0
17	43951792	.	A	C	4	5	9	0	0	9	0	0
17	43951834	.	G	A	7	9	16	0	1	17	0	0
17	43952984	.	C	T	1	4	5	0	0	5	0	0
17	43954926	.	A	C	3	4	7	0	0	7	0	0
17	43955964	.	G	A	0	1	1	0	2	3	0	0
17	43956910	.	T	C	1	1	2	0	0	2	0	0
17	43959078	.	A	G	3	0	3	0	7	10	0	0
17	43959098	.	A	G	3	0	3	0	9	12	0	0
17	43959594	.	A	G	2	1	3	0	0	3	0	0
17	43961801	.	T	C	2	4	6	0	0	6	0	0
17	43968605	.	A	G	0	1	1	0	0	1	0	0
17	43976947	.	C	A	2	0	2	0	0	2	0	0
17	43977416	.	G	A	3	2	5	0	0	5	0	0
17	43977433	.	T	G	4	2	6	0	0	6	0	0
17	43985045	.	G	A	3	2	5	0	0	5	0	0
17	43985075	.	C	T	4	4	8	0	1	9	0	0
17	43986863	.	C	T	4	2	6	0	1	7	0	0
17	43996483	.	G	A	4	5	9	0	0	9	0	0
17	43996485	.	G	A	3	5	8	0	1	9	0	0
17	43996620	.	A	T	2	1	3	0	0	3	0	0
17	43996667	.	G	A	7	2	9	0	0	9	0	0
17	44001833	.	T	C	4	10	14	0	1	15	0	0
17	44001880	.	T	A	5	13	18	0	0	18	0	0
17	44002000	.	C	G	11	0	11	0	12	23	0	0
17	44006579	.	G	T	1	3	4	0	0	4	0	0
17	44006924	.	G	C	3	3	6	0	1	7	0	0
17	44006927	.	G	A	4	3	7	0	0	7	0	0
17	44007314	.	G	C	2	0	2	0	1	3	0	0
17	44079441	.	G	A	3	3	6	0	1	7	0	0
17	44079803	.	G	T	2	3	5	0	0	5	0	0
17	44080212	.	G	A	3	2	5	0	0	5	0	0
17	44080227	.	C	T	1	3	4	0	0	4	0	0
17	44080530	.	A	G	1	2	3	0	0	3	0	0
17	44115587	.	T	C	4	2	6	0	0	6	0	0
17	44245452	.	T	C	14	23	37	0	2	39	0	0
17	44247495	.	G	A	17	13	30	0	3	33	0	0
17	44249428	.	T	G	3	4	7	0	0	7	0	0
17	44252640	.	T	A	4	7	11	0	0	11	0	0
17	44474592	.	T	G	1	4	5	0	0	5	0	0
17	45138591	.	T	C	7	6	13	0	1	14	0	0
17	45138733	.	T	C	14	10	24	0	0	24	0	0
17	45138741	.	T	C	17	7	24	0	0	24	0	0
17	45481166	.	T	C	0	2	2	0	0	2	0	0
17	47140976	.	T	C	4	2	6	0	0	6	0	0
17	47191232	.	T	C	4	2	6	0	0	6	0	0
17	47191842	.	T	C	2	8	10	0	0	10	0	0
17	47191871	.	T	C	5	0	5	0	3	8	0	0
17	47191891	.	T	C	1	4	5	0	0	5	0	0
17	47192331	.	T	C	1	2	3	0	0	3	0	0
17	48127513	.	C	T	4	3	7	0	0	7	0	0
17	48138525	.	G	A	0	1	1	0	1	2	0	0
17	48139415	.	C	T	1	3	4	0	1	5	0	0
17	48156580	.	C	T	5	5	10	0	1	11	0	0
17	48156631	.	G	A	4	7	11	0	0	11	0	0
17	48205851	.	A	G	1	2	3	0	0	3	0	0
17	48850344	.	A	C	1	2	3	0	1	4	0	0
17	48906437	.	G	C	4	4	8	0	2	10	0	0
17	48908803	.	C	T	0	1	1	0	4	5	0	0
17	48911097	.	T	G	4	2	6	0	0	6	0	0
17	48915349	.	T	C	6	2	8	0	0	8	0	0
17	48915387	.	A	T	2	2	4	0	0	4	0	0
17	48923299	.	T	C	1	0	1	0	2	3	0	0
17	48928906	.	G	A	1	2	3	0	0	3	0	0
17	48965350	.	T	G	7	1	8	0	4	12	0	0
17	49003651	.	A	G	5	5	10	0	1	11	0	0
17	49006619	.	A	T	3	2	5	0	0	5	0	0
17	49008376	.	A	G	1	3	4	0	0	4	0	0
17	49010727	.	T	C	2	3	5	0	1	6	0	0
17	49011627	.	T	C	1	3	4	0	0	4	0	0
17	49014085	.	A	G	6	3	9	0	2	11	0	0
17	49014663	.	G	T	0	3	3	0	4	7	0	0
17	49018023	.	G	A	0	12	12	0	10	22	0	0
17	49018107	.	C	T	17	9	26	0	1	27	0	0
17	49018113	.	A	T	14	10	24	0	3	27	0	0
17	49018164	.	A	C	13	8	21	0	1	22	0	0
17	49018508	.	C	G	12	12	24	0	1	25	0	0
17	49018899	.	C	T	10	16	26	0	0	26	0	0
17	49018935	.	A	C	16	13	29	0	2	31	0	0
17	49019101	.	T	C	8	20	28	0	1	29	0	0
17	49019288	.	A	C	17	16	33	0	1	34	0	0
17	49019299	.	A	T	11	12	23	0	9	32	0	0
17	49019380	.	G	A	1	9	10	0	8	18	0	0
17	49103268	.	C	T	0	1	1	0	0	1	0	0
17	49199317	.	C	G	2	0	2	0	4	6	0	0
17	49208766	.	C	T	1	1	2	0	0	2	0	0
17	49208775	.	A	T	4	1	5	0	0	5	0	0
17	49212630	.	G	C	0	3	3	0	1	4	0	0
17	49217106	.	T	A	5	3	8	0	0	8	0	0
17	49217209	.	G	A	0	7	7	0	7	14	0	0
17	49217466	.	T	C	4	4	8	0	0	8	0	0
17	49217507	.	C	T	2	3	5	0	0	5	0	0
17	49217577	.	C	T	6	9	15	0	1	16	0	0
17	49217658	.	G	T	6	4	10	0	0	10	0	0
17	49217703	.	C	A	7	2	9	0	1	10	0	0
17	49217887	.	A	G	6	3	9	0	0	9	0	0
17	49288764	.	A	G	4	2	6	0	0	6	0	0
17	49304987	.	T	C	1	2	3	0	0	3	0	0
17	49306334	.	G	A	0	3	3	0	4	7	0	0
17	49416327	.	T	C	9	5	14	0	0	14	0	0
17	49416396	.	G	T	11	5	16	0	1	17	0	0
17	49418225	.	G	A	3	6	9	0	0	9	0	0
17	49418765	.	G	A	3	8	11	0	0	11	0	0
17	49418792	.	C	T	3	5	8	0	0	8	0	0
17	49418940	.	T	A	4	4	8	0	0	8	0	0
17	49419182	.	T	A	5	3	8	0	1	9	0	0
17	49419188	.	C	T	5	5	10	0	1	11	0	0
17	49419247	.	T	C	5	8	13	0	1	14	0	0
17	49419491	.	A	G	6	2	8	0	0	8	0	0
17	49419590	.	T	C	4	3	7	0	0	7	0	0
17	49419761	.	G	T	6	3	9	0	0	9	0	0
17	49419887	.	C	T	0	7	7	0	5	12	0	0
17	49419954	.	C	T	5	7	12	0	1	13	0	0
17	49420049	.	T	G	4	4	8	0	0	8	0	0
17	49420454	.	A	T	3	2	5	0	0	5	0	0
17	49420565	.	A	C	6	0	6	0	4	10	0	0
17	49420655	.	A	C	4	2	6	0	0	6	0	0
17	49420677	.	G	A	6	4	10	0	0	10	0	0
17	49420727	.	C	A	0	8	8	0	4	12	0	0
17	49420954	.	G	T	4	2	6	0	0	6	0	0
17	49429844	.	T	C	2	5	7	0	0	7	0	0
17	49481635	.	C	G	4	2	6	0	0	6	0	0
17	49481638	.	T	C	2	0	2	0	4	6	0	0
17	49503569	.	G	T	2	1	3	0	0	3	0	0
17	49503632	.	G	A	8	7	15	0	0	15	0	0
17	49503647	.	C	T	6	7	13	0	0	13	0	0
17	49503940	.	G	A	5	7	12	0	0	12	0	0
17	49504033	.	A	T	1	0	1	0	0	1	0	0
17	49507155	.	C	T	6	1	7	0	0	7	0	0
17	49509606	.	G	A	4	9	13	0	0	13	0	0
17	49518977	.	C	T	1	3	4	0	0	4	0	0
17	49519061	.	C	T	0	4	4	0	0	4	0	0
17	49519070	.	T	A	0	2	2	0	0	2	0	0
17	49522248	.	G	A	3	3	6	0	0	6	0	0
17	49526584	.	T	C	2	2	4	0	0	4	0	0
17	49526839	.	A	G	11	5	16	0	0	16	0	0
17	49526977	.	A	T	3	5	8	0	0	8	0	0
17	49527099	.	T	G	3	1	4	0	0	4	0	0
17	49527115	.	T	C	2	0	2	0	0	2	0	0
17	49527357	.	A	T	3	3	6	0	0	6	0	0
17	49528082	.	C	G	10	11	21	0	1	22	0	0
17	49528291	.	A	G	11	0	11	0	6	17	0	0
17	49631878	.	A	T	1	2	3	0	0	3	0	0
17	49631901	.	G	C	0	2	2	0	0	2	0	0
17	49632191	.	A	G	1	3	4	0	0	4	0	0
17	49632267	.	A	C	4	0	4	0	6	10	0	0
17	49632738	.	C	G	1	6	7	0	0	7	0	0
17	49632753	.	A	C	1	0	1	0	5	6	0	0
17	49635656	.	C	T	4	6	10	0	1	11	0	0
17	49635693	.	G	A	3	6	9	0	1	10	0	0
17	49635701	.	G	A	3	8	11	0	0	11	0	0
17	49635749	.	C	G	3	9	12	0	0	12	0	0
17	49635881	.	A	T	1	1	2	0	0	2	0	0
17	49636810	.	T	C	1	0	1	0	1	2	0	0
17	49636959	.	T	C	2	2	4	0	0	4	0	0
17	49637421	.	T	A	1	3	4	0	0	4	0	0
17	49637487	.	A	G	1	1	2	0	0	2	0	0
17	49637509	.	G	A	1	1	2	0	1	3	0	0
17	49638746	.	T	G	1	0	1	0	0	1	0	0
17	49640903	.	A	G	3	3	6	0	2	8	0	0
17	49640938	.	A	T	3	3	6	0	0	6	0	0
17	49640957	.	A	G	6	3	9	0	1	10	0	0
17	49640986	.	C	G	8	3	11	0	0	11	0	0
17	49641046	.	C	A	4	6	10	0	0	10	0	0
17	49641136	.	A	G	1	0	1	0	0	1	0	0
17	49641629	.	C	T	1	4	5	0	0	5	0	0
17	49983202	.	A	T	10	9	19	0	0	19	0	0
17	49983273	.	C	T	12	17	29	0	1	30	0	0
17	49987618	.	A	T	5	9	14	0	1	15	0	0
17	49992629	.	G	A	5	9	14	0	2	16	0	0
17	49998167	.	C	T	14	10	24	0	0	24	0	0
17	49998221	.	G	A	19	11	30	0	0	30	0	0
17	49998591	.	T	G	8	9	17	0	0	17	0	0
17	49998804	.	C	A	25	22	47	0	0	47	0	0
17	49998995	.	G	C	22	1	23	0	14	37	0	0
17	49999037	.	G	T	22	23	45	0	0	45	0	0
17	50002381	.	A	G	27	17	44	0	1	45	0	0
17	50010011	.	A	G	18	18	36	0	0	36	0	0
17	50010024	.	G	C	21	17	38	0	1	39	0	0
17	50084344	.	T	C	2	1	3	0	0	3	0	0
17	50097129	.	G	A	1	1	2	0	0	2	0	0
17	50097168	.	G	A	2	2	4	0	0	4	0	0
17	50107391	.	G	A	4	1	5	0	0	5	0	0
17	50110192	.	C	A	2	5	7	0	1	8	0	0
17	50110255	.	G	C	5	3	8	0	0	8	0	0
17	50110304	.	T	A	4	2	6	0	0	6	0	0
17	50110442	.	C	T	8	4	12	0	0	12	0	0
17	50110517	.	G	A	0	2	2	0	3	5	0	0
17	50110574	.	A	G	1	0	1	0	3	4	0	0
17	50110636	.	C	A	1	2	3	0	2	5	0	0
17	50111266	.	G	A	0	4	4	0	2	6	0	0
17	50111573	.	C	T	14	6	20	0	1	21	0	0
17	50111680	.	A	T	4	3	7	2	1	10	0	0
17	50111727	.	C	T	3	2	5	0	0	5	0	0
17	50111746	.	A	T	1	3	4	0	0	4	0	0
17	50112054	.	T	A	5	2	7	0	0	7	0	0
17	50112097	.	A	G	1	5	6	0	0	6	0	0
17	50112145	.	A	C	6	2	8	0	0	8	0	0
17	50112153	.	T	C	7	2	9	0	1	10	0	0
17	50113141	.	G	A	7	3	10	0	0	10	0	0
17	50113336	.	C	T	1	4	5	0	0	5	0	0
17	50127721	.	A	T	7	4	11	0	2	13	0	0
17	50141766	.	T	A	6	2	8	0	0	8	0	0
17	50171937	.	T	C	3	6	9	0	0	9	0	0
17	50176061	.	G	A	1	1	2	0	0	2	0	0
17	50176139	.	T	C	4	5	9	0	0	9	0	0
17	50176519	.	C	A	1	3	4	0	0	4	0	0
17	50178553	.	G	C	1	2	3	0	0	3	0	0
17	50180672	.	C	T	3	4	7	0	0	7	0	0
17	50185659	.	C	A	13	13	26	0	0	26	0	0
17	50185665	.	T	A	14	13	27	0	1	28	0	0
17	50185831	.	C	A	12	9	21	0	2	23	0	0
17	50185930	.	T	C	12	13	25	0	0	25	0	0
17	50186011	.	G	A	0	9	9	0	9	18	0	0
17	50186041	.	T	A	7	11	18	0	1	19	0	0
17	50186097	.	G	A	6	10	16	0	0	16	0	0
17	50186241	.	T	A	6	8	14	0	1	15	0	0
17	50186243	.	A	C	4	8	12	0	0	15	3	0
17	50219716	.	C	G	0	1	1	0	0	1	0	0
17	50229409	.	T	C	18	6	24	0	0	24	0	0
17	50245673	.	T	C	24	14	38	0	2	40	0	0
17	50245715	.	C	G	13	22	35	0	2	37	0	0
17	50247886	.	T	C	1	0	1	0	1	2	0	0
17	50278884	.	C	A	1	0	1	0	0	1	0	0
17	50284899	.	T	A	14	16	30	0	2	32	0	0
17	50284935	.	A	T	11	13	24	0	1	25	0	0
17	50285009	.	A	T	8	8	16	0	0	16	0	0
17	50285221	.	A	T	9	6	15	0	0	15	0	0
17	50285402	.	A	C	9	1	10	0	0	10	0	0
17	50417613	.	T	C	0	6	6	0	0	6	0	0
17	51056292	.	A	G	0	1	1	0	0	1	0	0
17	51231756	.	T	C	3	5	8	0	2	10	0	0
17	51231811	.	T	C	6	6	12	0	1	13	0	0
17	51231980	.	T	C	4	9	13	0	0	13	0	0
17	51232123	.	T	C	2	4	6	0	0	6	0	0
17	51232188	.	T	C	1	4	5	0	1	6	0	0
17	51232193	.	T	C	2	4	6	0	0	6	0	0
17	51232547	.	T	C	7	3	10	0	1	11	0	0
17	51241185	.	G	A	2	4	6	0	0	6	0	0
17	51241203	.	C	T	3	3	6	0	1	7	0	0
17	51257053	.	G	A	5	6	11	0	0	11	0	0
17	51257376	.	C	T	0	6	6	0	9	15	0	0
17	51260322	.	T	G	3	6	9	0	0	9	0	0
17	51260362	.	G	C	3	6	9	0	0	9	0	0
17	51276021	.	G	A	9	2	11	0	6	17	0	0
17	51301246	.	T	C	2	4	6	0	0	6	0	0
17	51303130	.	G	A	1	7	8	0	16	24	0	0
17	51305422	.	A	T	11	11	22	0	1	23	0	0
17	51307706	.	G	A	7	9	16	0	0	16	0	0
17	51307871	.	A	G	2	0	2	0	9	11	0	0
17	51307979	.	G	A	0	2	2	0	1	3	0	0
17	51682501	.	T	A	1	2	3	0	0	3	0	0
17	51690559	.	T	C	0	0	0	0	1	1	0	0
17	51690562	.	A	G	0	0	0	0	1	1	0	0
17	51711040	.	A	G	6	10	16	0	0	16	0	0
17	51711184	.	C	A	2	4	6	0	0	6	0	0
17	51711194	.	C	A	4	2	6	0	0	6	0	0
17	51715641	.	G	A	1	1	2	0	0	2	0	0
17	51720176	.	C	T	6	4	10	0	1	11	0	0
17	51720177	.	A	T	6	4	10	0	1	11	0	0
17	51720449	.	A	G	2	2	4	0	0	4	0	0
17	51720462	.	T	A	1	2	3	0	0	3	0	0
17	51720615	.	T	C	1	4	5	0	0	5	0	0
17	51743916	.	A	G	1	5	6	0	0	6	0	0
17	51749545	.	G	T	0	6	6	0	7	13	0	0
17	51752790	.	A	G	4	9	13	0	0	13	0	0
17	51753138	.	T	G	1	1	2	0	0	2	0	0
17	51757010	.	G	A	9	7	16	0	0	16	0	0
17	51757380	.	T	G	4	4	8	0	1	9	0	0
17	51757387	.	A	T	4	3	7	0	0	7	0	0
17	51788735	.	C	T	1	1	2	0	0	2	0	0
17	51788754	.	G	A	0	1	1	0	1	2	0	0
17	51788933	.	A	G	4	4	8	0	0	8	0	0
17	51789032	.	G	A	3	3	6	0	0	6	0	0
17	51789038	.	T	C	3	3	6	0	0	6	0	0
17	51796837	.	A	G	4	3	7	0	1	8	0	0
17	51796843	.	A	T	4	4	8	0	0	8	0	0
17	51796888	.	G	A	2	5	7	0	0	7	0	0
17	51797004	.	G	A	2	3	5	0	0	5	0	0
17	51797015	.	T	C	4	0	4	0	4	8	0	0
17	51797145	.	A	G	3	4	7	0	0	7	0	0
17	51797223	.	G	A	3	2	5	0	0	5	0	0
17	51797333	.	A	G	2	5	7	0	0	7	0	0
17	51797782	.	C	T	10	6	16	0	0	16	0	0
17	51797788	.	T	A	9	4	13	0	1	14	0	0
17	51797863	.	G	A	5	6	11	0	0	11	0	0
17	51804037	.	G	A	3	5	8	0	0	8	0	0
17	51805764	.	T	G	2	2	4	0	0	4	0	0
17	51807494	.	G	A	0	1	1	0	0	1	0	0
17	51807539	.	T	A	3	3	6	0	0	6	0	0
17	51807545	.	G	A	4	3	7	0	0	7	0	0
17	51808019	.	A	C	1	4	5	0	0	5	0	0
17	51815206	.	C	G	0	1	1	0	0	1	0	0
17	51822481	.	G	A	3	6	9	0	2	11	0	0
17	51823152	.	A	G	10	6	16	0	0	16	0	0
17	51823568	.	G	A	17	6	23	0	3	26	0	0
17	51823989	.	G	T	5	0	5	1	0	6	0	0
17	51823995	.	A	T	2	3	5	1	0	6	0	0
17	51824081	.	A	C	2	8	10	0	0	10	0	0
17	51824708	.	G	A	0	2	2	0	0	2	0	0
17	51824716	.	C	T	0	4	4	0	0	4	0	0
17	51824759	.	C	T	2	5	7	0	2	9	0	0
17	51824790	.	T	C	5	6	11	0	1	12	0	0
17	51825059	.	A	T	2	9	11	0	0	11	0	0
17	51825086	.	A	G	3	8	11	0	3	14	0	0
17	51825094	.	G	A	2	6	8	0	5	13	0	0
17	51825138	.	C	T	0	6	6	0	10	16	0	0
17	51825161	.	T	C	9	4	13	0	0	13	0	0
17	51825205	.	T	G	9	4	13	0	0	13	0	0
17	51825421	.	T	G	3	6	9	0	0	9	0	0
17	51825455	.	A	G	5	5	10	0	0	10	0	0
17	51825813	.	T	A	6	5	11	0	1	12	0	0
17	51825969	.	A	T	6	7	13	0	1	14	0	0
17	51826062	.	G	T	7	9	16	0	1	17	0	0
17	51826088	.	A	G	10	13	23	0	0	23	0	0
17	51826149	.	A	C	11	0	11	0	7	18	0	0
17	51826172	.	T	C	9	0	9	0	7	16	0	0
17	51832999	.	G	A	6	4	10	0	0	10	0	0
17	52006019	.	T	A	1	3	4	0	0	4	0	0
17	52036940	.	G	A	0	0	0	0	3	3	0	0
17	52300110	.	T	C	2	3	5	0	0	5	0	0
17	52359082	.	G	A	0	2	2	0	2	4	0	0
17	52385529	.	A	G	2	2	4	0	0	4	0	0
17	52533036	.	C	G	10	11	21	0	0	21	0	0
17	52533073	.	C	T	6	2	8	0	3	11	0	0
17	52534241	.	G	A	0	10	10	0	9	19	0	0
17	52534343	.	G	A	7	8	15	0	4	19	0	0
17	52541342	.	G	A	0	11	11	0	9	20	0	0
17	52553107	.	C	A	19	10	29	0	1	30	0	0
17	52553141	.	T	C	11	15	26	0	0	26	0	0
17	52553270	.	G	A	13	25	38	0	2	41	1	0
17	52565832	.	T	G	1	1	2	0	0	2	0	0
17	52565833	.	C	T	0	1	1	0	1	2	0	0
17	52566100	.	C	T	0	4	4	0	3	7	0	0
17	52566423	.	T	C	4	1	5	0	8	13	0	0
17	52566925	.	A	G	2	3	5	0	0	5	0	0
17	52568040	.	A	C	1	0	1	0	0	1	0	0
17	52568112	.	C	G	4	1	5	0	0	5	0	0
17	52571312	.	G	A	0	2	2	0	0	2	0	0
17	52574059	.	G	A	3	2	5	0	0	5	0	0
17	52574077	.	G	A	3	2	5	0	0	5	0	0
17	52576316	.	G	A	2	6	8	0	1	9	0	0
17	52576380	.	A	G	5	6	11	0	1	12	0	0
17	52576394	.	C	T	7	5	12	0	0	12	0	0
17	52578489	.	A	G	1	1	2	0	0	2	0	0
17	52578491	.	A	G	1	1	2	0	0	2	0	0
17	52615536	.	A	G	1	2	3	0	0	3	0	0
17	52630641	.	A	G	3	3	6	0	0	6	0	0
17	52630719	.	T	G	4	1	5	0	0	5	0	0
17	52630752	.	A	C	0	0	0	0	4	4	0	0
17	52630907	.	A	T	2	4	6	0	0	6	0	0
17	52632139	.	A	G	10	7	17	0	1	18	0	0
17	52632151	.	G	C	10	8	18	0	0	18	0	0
17	52632386	.	T	C	1	0	1	0	1	2	0	0
17	52632404	.	G	A	1	1	2	0	0	2	0	0
17	52635258	.	A	G	3	10	13	0	1	14	0	0
17	52635261	.	C	T	0	10	10	0	6	16	0	0
17	52635954	.	C	T	0	1	1	0	0	1	0	0
17	52636296	.	T	C	2	0	2	0	0	2	0	0
17	52636829	.	C	T	6	9	15	0	0	15	0	0
17	52636831	.	C	G	6	9	15	0	0	15	0	0
17	52636922	.	C	T	2	2	4	0	0	4	0	0
17	52636928	.	A	T	1	2	3	0	0	3	0	0
17	52639729	.	C	T	0	16	16	0	10	26	0	0
17	52640311	.	G	A	22	14	36	0	1	37	0	0
17	52640385	.	G	C	18	22	40	0	0	40	0	0
17	52640419	.	C	T	0	18	18	0	18	36	0	0
17	52640540	.	C	T	0	15	15	0	17	32	0	0
17	52640645	.	T	G	10	14	24	0	0	24	0	0
17	52641091	.	A	T	12	14	26	0	1	27	0	0
17	52641571	.	C	T	11	6	17	0	1	18	0	0
17	52641724	.	A	C	16	11	27	0	2	29	0	0
17	52641751	.	G	C	10	0	10	0	16	26	0	0
17	52650878	.	G	C	1	3	4	0	0	4	0	0
17	52856614	.	T	C	16	11	27	0	5	32	0	0
17	52920792	.	C	T	26	19	45	1	3	49	0	0
17	52940952	.	T	C	2	3	5	0	1	6	0	0
17	52941467	.	G	A	1	3	4	0	1	5	0	0
17	52983924	.	A	G	0	1	1	0	0	1	0	0
17	53156722	.	A	C	1	3	4	0	0	4	0	0
17	53186632	.	G	A	0	3	3	0	4	7	0	0
17	53186659	.	T	C	2	3	5	0	0	5	0	0
17	53250861	.	C	T	4	9	13	0	3	16	0	0
17	53250909	.	G	A	0	5	5	0	8	13	0	0
17	53251101	.	A	G	1	2	3	0	1	4	0	0
17	53298000	.	C	G	3	0	3	0	5	8	0	0
17	53298033	.	C	T	3	9	12	0	1	13	0	0
17	53298051	.	G	A	6	3	9	0	0	9	0	0
17	53298457	.	A	G	0	4	4	0	0	4	0	0
17	53298472	.	A	G	2	2	4	0	0	4	0	0
17	53298514	.	C	G	4	2	6	0	0	6	0	0
17	53299220	.	G	A	0	1	1	0	1	2	0	0
17	53299485	.	T	C	4	4	8	0	0	8	0	0
17	53302527	.	T	C	2	3	5	0	0	5	0	0
17	53303258	.	G	A	0	4	4	0	7	11	0	0
17	53303980	.	G	C	5	5	10	0	1	11	0	0
17	53304566	.	G	A	3	8	11	0	0	11	0	0
17	53304635	.	A	T	9	2	11	1	0	12	0	0
17	53305318	.	G	C	6	4	10	0	0	10	0	0
17	53305327	.	C	T	3	2	5	0	0	5	0	0
17	53307580	.	C	G	10	15	25	0	1	26	0	0
17	53308737	.	T	C	9	10	19	0	1	20	0	0
17	53308820	.	C	T	1	5	6	0	3	9	0	0
17	53314981	.	A	G	7	0	7	0	3	10	0	0
17	53315422	.	C	T	4	4	8	0	0	8	0	0
17	53315604	.	G	A	6	2	8	0	2	10	0	0
17	53315750	.	C	G	3	3	6	0	0	6	0	0
17	53317065	.	C	T	0	1	1	0	0	1	0	0
17	53317123	.	T	C	1	7	8	0	0	8	0	0
17	53317175	.	G	A	0	0	0	0	6	6	0	0
17	53317663	.	T	C	3	2	5	0	0	5	0	0
17	53317664	.	C	A	3	2	5	0	0	5	0	0
17	53317906	.	A	G	3	0	3	0	4	7	0	0
17	53317917	.	A	G	1	5	6	0	1	7	0	0
17	53346600	.	G	A	3	4	7	0	0	7	0	0
17	53346648	.	C	A	4	4	8	0	1	9	0	0
17	53349843	.	T	G	1	3	4	0	0	4	0	0
17	53364181	.	C	T	1	11	12	0	0	12	0	0
17	53390354	.	A	G	1	3	4	0	0	4	0	0
17	53393165	.	G	A	11	15	26	0	1	27	0	0
18	298740	.	C	T	2	2	4	0	0	4	0	0
18	302902	.	C	T	16	11	27	0	0	27	0	0
18	303136	.	G	T	0	1	1	0	0	1	0	0
18	316039	.	C	T	18	9	27	0	1	28	0	0
18	318821	.	T	C	9	14	23	0	0	23	0	0
18	318824	.	C	T	8	12	20	0	2	22	0	0
18	321802	.	T	C	11	7	18	0	1	19	0	0
18	321820	.	C	T	5	10	15	0	2	17	0	0
18	321934	.	C	T	4	6	10	0	2	12	0	0
18	323840	.	G	A	1	6	7	0	9	16	0	0
18	324190	.	T	C	6	9	15	0	0	15	0	0
18	324243	.	G	A	3	7	10	0	0	10	0	0
18	324317	.	G	A	7	11	18	0	1	19	0	0
18	324325	.	A	G	8	13	21	0	0	21	0	0
18	324380	.	T	G	13	7	20	0	0	20	0	0
18	324409	.	C	T	9	11	20	0	1	21	0	0
18	324465	.	T	C	20	8	28	0	0	28	0	0
18	324692	.	A	T	12	13	25	0	0	25	0	0
18	324834	.	T	G	15	0	15	0	17	32	0	0
18	324835	.	G	T	14	16	30	0	2	32	0	0
18	325044	.	A	G	22	20	42	0	0	42	0	0
18	325189	.	C	T	26	20	46	0	0	46	0	0
18	325290	.	G	A	0	18	18	0	24	42	0	0
18	325312	.	G	T	20	24	44	0	1	46	1	0
18	325407	.	T	G	13	14	27	0	0	27	0	0
18	328733	.	A	G	4	3	7	0	0	7	0	0
18	328795	.	G	C	10	6	16	0	2	18	0	0
18	330474	.	A	G	8	7	15	0	0	15	0	0
18	333765	.	T	C	5	7	12	0	1	13	0	0
18	334018	.	C	T	9	7	16	0	0	16	0	0
18	334049	.	A	T	6	5	11	0	0	11	0	0
18	334248	.	T	C	2	4	6	0	0	6	0	0
18	334262	.	T	C	4	0	4	0	3	7	0	0
18	334291	.	T	C	7	8	15	0	0	15	0	0
18	334298	.	T	C	2	15	17	0	0	17	0	0
18	334361	.	T	C	11	5	16	0	0	16	0	0
18	334431	.	T	G	4	4	8	0	0	8	0	0
18	334436	.	G	T	4	3	7	0	1	8	0	0
18	334560	.	T	C	4	6	10	0	0	10	0	0
18	334634	.	G	A	5	6	11	0	0	11	0	0
18	334872	.	C	T	0	6	6	0	8	14	0	0
18	336212	.	A	C	1	4	5	0	0	5	0	0
18	336586	.	T	C	10	4	14	0	0	14	0	0
18	336607	.	T	G	8	6	14	0	2	16	0	0
18	344332	.	G	A	7	3	10	0	0	10	0	0
18	344388	.	T	G	4	4	8	0	0	8	0	0
18	344437	.	C	A	0	5	5	0	4	9	0	0
18	357011	.	C	T	0	1	1	0	0	1	0	0
18	370129	.	C	T	0	5	5	0	1	6	0	0
18	609365	.	A	G	2	3	5	0	0	5	0	0
18	610041	.	A	G	14	0	14	0	7	21	0	0
18	1292176	.	C	T	0	8	8	0	2	10	0	0
18	2189335	.	C	T	3	2	5	0	0	5	0	0
18	2197638	.	A	C	6	7	13	0	1	14	0	0
18	2215642	.	A	G	1	1	2	0	0	2	0	0
18	2215650	.	T	C	1	0	1	0	1	2	0	0
18	2216320	.	G	T	2	0	2	0	1	3	0	0
18	2225862	.	A	C	3	6	9	0	0	9	0	0
18	2377338	.	T	A	8	10	18	0	2	20	0	0
18	2377413	.	C	T	5	13	18	0	0	18	0	0
18	2377486	.	A	T	7	10	17	0	2	19	0	0
18	2377516	.	A	G	5	12	17	0	0	17	0	0
18	2377566	.	A	G	13	8	21	0	0	21	0	0
18	2377582	.	G	T	14	11	25	0	0	25	0	0
18	2377645	.	T	C	6	0	6	0	13	19	0	0
18	2377700	.	C	T	0	11	11	0	8	19	0	0
18	2377714	.	A	G	6	13	19	0	0	19	0	0
18	2377768	.	G	A	10	13	23	0	1	24	0	0
18	2377775	.	C	T	9	13	22	0	1	23	0	0
18	2377860	.	G	A	12	7	19	0	0	19	0	0
18	2378273	.	T	C	5	2	7	0	2	9	0	0
18	2378510	.	C	A	3	6	9	0	1	10	0	0
18	2378542	.	G	C	3	7	10	0	0	10	0	0
18	2378568	.	T	A	4	5	9	0	0	9	0	0
18	2378713	.	T	G	12	9	21	0	1	22	0	0
18	2684322	.	T	C	5	3	8	0	0	8	0	0
18	2934938	.	C	T	9	3	12	0	1	13	0	0
18	3159886	.	T	C	7	4	11	0	0	11	0	0
18	5170069	.	A	G	20	2	22	0	30	52	0	0
18	5519138	.	A	G	5	3	8	0	1	9	0	0
18	6868483	.	A	G	22	7	29	0	3	32	0	0
18	7099981	.	A	G	0	4	4	0	0	4	0	0
18	7571412	.	A	G	1	2	3	0	0	3	0	0
18	11506860	.	T	G	1	0	1	0	2	3	0	0
18	11507253	.	T	G	4	3	7	0	0	7	0	0
18	11507263	.	G	A	3	4	7	0	0	7	0	0
18	11541046	.	A	G	0	2	2	0	0	2	0	0
18	11862896	.	G	T	2	2	4	0	0	4	0	0
18	11878673	.	C	G	0	1	1	0	0	1	0	0
18	12058480	.	T	A	7	6	13	0	1	14	0	0
18	12105548	.	G	A	0	3	3	0	1	4	0	0
18	12111431	.	A	C	1	0	1	0	0	1	0	0
18	12111625	.	A	G	6	3	9	0	0	9	0	0
18	12111628	.	A	T	6	3	9	0	0	9	0	0
18	12111925	.	G	A	1	2	3	0	0	3	0	0
18	12112105	.	T	C	6	6	12	0	0	12	0	0
18	12112153	.	T	C	3	5	8	0	1	9	0	0
18	12112219	.	C	T	4	12	16	0	0	16	0	0
18	12112246	.	A	G	6	0	6	0	10	16	0	0
18	12112726	.	C	T	2	2	4	0	1	5	0	0
18	12112750	.	G	A	0	1	1	0	1	2	0	0
18	12113515	.	C	A	5	10	15	0	0	15	0	0
18	12113516	.	C	T	5	10	15	0	0	15	0	0
18	12148050	.	T	G	0	0	0	0	2	2	0	0
18	12171277	.	C	T	2	1	3	0	0	3	0	0
18	12196939	.	G	A	0	1	1	0	2	3	0	0
18	12207046	.	A	G	10	6	16	0	0	16	0	0
18	12207070	.	C	A	7	9	16	0	2	18	0	0
18	12214299	.	A	G	0	3	3	0	0	3	0	0
18	12228217	.	C	A	2	3	5	0	0	5	0	0
18	12228758	.	C	T	2	2	4	0	0	4	0	0
18	12228834	.	G	C	3	5	8	0	0	8	0	0
18	12229120	.	A	T	2	8	10	0	1	11	0	0
18	12229223	.	A	C	4	2	6	0	0	6	0	0
18	12229245	.	C	T	1	2	3	0	0	3	0	0
18	12229405	.	G	A	8	5	13	0	0	13	0	0
18	12236126	.	T	A	1	1	2	0	1	3	0	0
18	12236351	.	C	T	2	5	7	0	0	7	0	0
18	12238082	.	G	A	2	4	6	0	0	6	0	0
18	12240681	.	C	T	3	2	5	0	1	6	0	0
18	12242967	.	C	T	0	0	0	0	1	1	0	0
18	12244480	.	A	G	0	1	1	0	0	1	0	0
18	12244487	.	C	T	0	1	1	0	0	1	0	0
18	12244667	.	G	A	4	2	6	0	0	6	0	0
18	12245525	.	A	G	2	2	4	0	0	4	0	0
18	12245576	.	A	G	3	4	7	0	0	7	0	0
18	12254905	.	G	A	2	3	5	0	0	5	0	0
18	12255012	.	T	C	2	1	3	0	0	3	0	0
18	12259919	.	G	A	0	1	1	0	0	1	0	0
18	12264032	.	A	G	1	3	4	0	0	4	0	0
18	12276859	.	C	T	8	9	17	0	0	17	0	0
18	12277052	.	A	G	7	6	13	0	0	13	0	0
18	12277206	.	G	C	9	11	20	0	0	20	0	0
18	12277490	.	G	A	21	17	38	0	0	38	0	0
18	12280269	.	C	T	8	18	26	0	0	26	0	0
18	12292017	.	G	A	21	24	45	0	1	46	0	0
18	12327321	.	C	A	0	2	2	0	2	4	0	0
18	12366097	.	G	T	1	1	2	0	0	2	0	0
18	12366171	.	C	G	1	0	1	0	0	1	0	0
18	12374168	.	A	G	8	5	13	0	0	13	0	0
18	12416307	.	G	A	1	2	3	0	0	3	0	0
18	12416324	.	G	T	1	2	3	0	0	3	0	0
18	12417903	.	G	C	2	2	4	0	0	4	0	0
18	12464794	.	C	T	0	5	5	0	3	8	0	0
18	12464867	.	C	A	6	3	9	0	0	9	0	0
18	12465290	.	G	A	11	8	19	0	1	20	0	0
18	12465316	.	C	T	9	6	15	0	3	18	0	0
18	12467834	.	G	C	8	0	8	0	7	15	0	0
18	12470013	.	G	T	4	8	12	0	1	13	0	0
18	12470136	.	G	A	6	5	11	0	1	12	0	0
18	12470148	.	A	G	5	5	10	0	0	10	0	0
18	12470211	.	C	T	0	2	2	0	2	4	0	0
18	12471210	.	T	C	0	2	2	0	0	2	0	0
18	12495185	.	C	T	6	4	10	0	0	10	0	0
18	12612160	.	A	G	1	5	6	0	2	8	0	0
18	12653846	.	G	C	2	3	5	0	0	5	0	0
18	12659226	.	C	T	0	1	1	0	0	1	0	0
18	12776727	.	C	T	2	2	4	0	0	4	0	0
18	12779357	.	T	A	7	9	16	0	0	16	0	0
18	13124621	.	T	C	2	2	4	0	0	4	0	0
18	17141858	.	T	A	2	0	2	0	0	2	0	0
18	17535741	.	A	T	0	10	10	0	0	10	0	0
18	17535748	.	A	T	0	4	4	0	2	6	0	0
18	18421826	.	T	G	2	10	12	0	0	12	0	0
18	18472104	.	T	G	4	0	4	0	0	4	0	0
18	18472114	.	T	G	4	0	4	0	0	4	0	0
18	20583420	.	T	C	7	3	10	0	0	10	0	0
18	20585558	.	T	C	4	4	8	0	0	8	0	0
18	20585561	.	T	C	3	5	8	0	0	8	0	0
18	21144502	.	A	T	0	2	2	0	0	2	0	0
18	21861669	.	G	A	6	3	9	0	1	10	0	0
18	26807563	.	T	C	4	1	5	0	0	5	0	0
18	27568337	.	A	G	16	3	19	0	0	19	0	0
18	27568352	.	A	G	14	7	21	0	0	21	0	0
18	30012537	.	A	G	3	2	5	0	0	5	0	0
18	35407271	.	C	T	1	1	2	0	0	2	0	0
18	35407688	.	C	A	1	0	1	0	0	1	0	0
18	35407690	.	T	C	1	0	1	0	0	1	0	0
18	35407972	.	G	T	2	2	4	0	0	4	0	0
18	35429677	.	C	A	5	2	7	0	0	7	0	0
18	35430630	.	A	C	3	2	5	0	0	5	0	0
18	35491518	.	A	T	9	16	25	0	0	25	0	0
18	35497031	.	A	C	1	5	6	0	1	7	0	0
18	35503636	.	A	G	2	1	3	0	0	3	0	0
18	35503654	.	C	T	6	7	13	0	1	14	0	0
18	35506377	.	C	G	0	3	3	0	7	11	1	0
18	35506393	.	C	T	8	7	15	0	0	15	0	0
18	35508097	.	G	A	5	9	14	0	1	15	0	0
18	35508139	.	C	A	0	2	2	0	2	4	0	0
18	35508151	.	A	T	1	1	2	0	0	2	0	0
18	35508304	.	C	T	1	4	5	0	0	5	0	0
18	35509687	.	G	A	4	7	11	0	0	11	0	0
18	35509699	.	G	T	2	6	8	0	0	8	0	0
18	35510011	.	G	A	2	3	5	0	1	6	0	0
18	35510290	.	G	T	9	7	16	0	0	16	0	0
18	35510590	.	C	A	3	4	7	0	0	7	0	0
18	35548101	.	T	C	1	0	1	0	0	1	0	0
18	35561289	.	A	C	0	1	1	0	0	1	0	0
18	35561331	.	C	T	0	1	1	0	0	1	0	0
18	35561463	.	G	A	1	1	2	0	0	2	0	0
18	35561496	.	T	G	1	3	4	0	0	4	0	0
18	35561547	.	C	T	1	4	5	0	1	6	0	0
18	35565108	.	A	G	1	2	3	0	0	3	0	0
18	35577577	.	G	A	1	1	2	0	0	2	0	0
18	35579487	.	G	C	1	0	1	0	1	2	0	0
18	35583885	.	G	C	1	0	1	0	2	3	0	0
18	35583888	.	G	A	1	2	3	0	0	3	0	0
18	35584080	.	A	G	1	2	3	0	0	3	0	0
18	35585730	.	C	T	1	0	1	0	0	1	0	0
18	35596867	.	G	A	0	1	1	0	0	1	0	0
18	35625935	.	A	G	0	2	2	0	0	2	0	0
18	35807789	.	C	T	13	14	27	0	1	28	0	0
18	35807902	.	A	T	9	6	15	0	0	15	0	0
18	35807960	.	G	A	8	8	16	0	0	16	0	0
18	35808206	.	C	A	8	8	16	1	1	18	0	0
18	35808223	.	G	A	8	8	16	1	1	18	0	0
18	35808320	.	A	G	20	13	33	0	1	34	0	0
18	35827399	.	T	A	1	3	4	0	1	5	0	0
18	35827621	.	T	A	2	2	4	0	0	4	0	0
18	35829794	.	T	C	3	7	10	0	0	10	0	0
18	35832931	.	C	T	3	10	13	0	1	14	0	0
18	35833077	.	G	A	1	1	2	0	0	2	0	0
18	35837643	.	A	G	5	5	10	0	0	10	0	0
18	35839257	.	T	C	4	1	5	0	6	11	0	0
18	35839293	.	G	A	3	3	6	0	1	7	0	0
18	35839374	.	T	A	4	2	6	0	1	7	0	0
18	35839384	.	A	G	8	2	10	0	0	10	0	0
18	35839412	.	G	C	8	5	13	0	0	13	0	0
18	35839673	.	A	G	6	7	13	0	1	14	0	0
18	35842461	.	A	T	10	14	24	0	0	24	0	0
18	35898617	.	C	T	6	2	8	0	0	8	0	0
18	36065768	.	T	G	2	2	4	0	1	5	0	0
18	36066048	.	T	C	4	3	7	0	0	7	0	0
18	36066054	.	C	G	3	3	6	0	1	7	0	0
18	36066480	.	A	T	3	3	6	0	0	6	0	0
18	36071039	.	G	T	0	0	0	0	1	1	0	0
18	36071217	.	C	G	1	0	1	0	3	4	0	0
18	36071262	.	C	T	1	3	4	0	0	4	0	0
18	36075306	.	C	T	5	17	22	0	0	22	0	0
18	36080688	.	A	G	13	16	29	0	2	31	0	0
18	36080993	.	T	C	13	9	22	0	0	22	0	0
18	36081018	.	G	A	15	9	24	0	1	25	0	0
18	36081483	.	G	T	7	7	14	0	1	15	0	0
18	36081728	.	C	T	4	4	8	0	0	8	0	0
18	36081773	.	G	A	4	5	9	0	1	10	0	0
18	36114463	.	T	A	9	7	16	0	1	17	0	0
18	36114464	.	A	C	10	7	17	0	0	17	0	0
18	36128954	.	C	T	4	3	7	0	0	7	0	0
18	36129177	.	G	A	7	9	16	0	1	17	0	0
18	36142578	.	C	T	0	0	0	0	3	3	0	0
18	36142649	.	C	T	1	3	4	0	0	4	0	0
18	36142652	.	A	C	1	2	3	0	0	3	0	0
18	36591704	.	G	T	3	1	4	0	0	4	0	0
18	36593564	.	T	C	3	0	3	0	1	4	0	0
18	36597757	.	A	G	1	0	1	0	0	1	0	0
18	36597952	.	C	T	7	8	15	0	0	15	0	0
18	36598134	.	T	C	2	4	6	0	1	7	0	0
18	36598208	.	G	T	2	2	4	0	0	4	0	0
18	36598273	.	T	A	4	6	10	0	0	10	0	0
18	36598332	.	A	G	5	6	11	0	0	11	0	0
18	36598439	.	A	G	7	3	10	0	0	10	0	0
18	36598441	.	C	T	6	4	10	0	0	10	0	0
18	36614822	.	T	G	0	0	0	0	2	2	0	0
18	36615056	.	G	A	1	0	1	0	0	1	0	0
18	36630615	.	T	C	8	12	20	0	0	20	0	0
18	36774767	.	T	C	1	5	6	0	0	6	0	0
18	36799090	.	C	T	7	7	14	0	0	14	0	0
18	36799167	.	A	C	3	6	9	0	0	9	0	0
18	36799219	.	T	C	7	4	11	0	0	11	0	0
18	36799229	.	T	G	8	5	13	0	0	13	0	0
18	36799680	.	A	G	3	3	6	0	0	6	0	0
18	36799685	.	C	G	3	4	7	0	0	7	0	0
18	36800002	.	C	T	1	3	4	0	1	5	0	0
18	36800035	.	T	G	1	2	3	0	0	3	0	0
18	36806632	.	A	T	13	11	24	0	0	24	0	0
18	36806650	.	A	G	7	8	15	0	6	21	0	0
18	36806681	.	T	C	6	7	13	0	2	15	0	0
18	36806707	.	C	T	4	6	10	0	0	10	0	0
18	36806727	.	C	T	2	7	9	0	1	10	0	0
18	36806749	.	A	G	3	10	13	0	0	13	0	0
18	36806939	.	T	G	3	5	8	0	1	9	0	0
18	36869131	.	G	A	0	6	6	0	13	19	0	0
18	36869180	.	T	C	14	9	23	0	0	23	0	0
18	36869242	.	C	A	11	9	20	0	0	20	0	0
18	36869387	.	C	T	8	4	12	0	2	14	0	0
18	36869389	.	G	A	0	4	4	0	10	14	0	0
18	36869530	.	C	G	11	16	27	0	2	29	0	0
18	36869627	.	C	T	14	16	30	0	2	32	0	0
18	36869632	.	C	T	14	17	31	0	0	31	0	0
18	36869863	.	G	A	16	8	24	0	4	28	0	0
18	36870174	.	G	A	7	10	17	0	0	17	0	0
18	36870378	.	A	G	14	0	14	0	11	25	0	0
18	36870448	.	C	G	11	7	18	0	1	19	0	0
18	36870460	.	T	C	14	8	22	0	1	23	0	0
18	36870702	.	A	T	15	13	28	0	3	31	0	0
18	36949178	.	A	G	5	5	10	0	0	10	0	0
18	36951632	.	G	T	3	11	14	0	0	14	0	0
18	36951823	.	G	A	4	6	10	0	1	11	0	0
18	36951829	.	T	C	4	4	8	0	0	8	0	0
18	36951888	.	A	G	6	5	11	0	1	12	0	0
18	36951990	.	G	A	12	4	16	0	0	16	0	0
18	36954186	.	A	G	2	3	5	0	1	6	0	0
18	36954250	.	A	G	5	4	9	0	0	9	0	0
18	36956672	.	G	A	4	4	8	0	0	8	0	0
18	36957310	.	T	C	2	7	9	0	0	9	0	0
18	36959656	.	A	T	3	1	4	0	1	5	0	0
18	36963204	.	A	G	5	1	6	0	0	6	0	0
18	36963315	.	T	A	1	3	4	0	0	4	0	0
18	37006638	.	C	G	2	4	6	0	0	6	0	0
18	37006758	.	C	A	3	2	5	0	1	6	0	0
18	37143773	.	T	C	2	0	2	0	0	2	0	0
18	37155941	.	C	A	0	3	3	0	0	3	0	0
18	37155953	.	G	T	0	1	1	0	0	1	0	0
18	37191246	.	C	T	1	4	5	0	0	5	0	0
18	37191286	.	G	A	3	3	6	0	1	7	0	0
18	37191396	.	G	C	2	6	8	0	0	8	0	0
18	37219291	.	C	G	6	7	13	0	0	13	0	0
18	37219541	.	A	G	1	2	3	0	1	4	0	0
18	37219558	.	T	C	1	4	5	0	1	6	0	0
18	37219646	.	T	C	2	4	6	0	0	6	0	0
18	37219987	.	T	A	1	1	2	0	0	2	0	0
18	37227090	.	T	G	1	4	5	0	0	5	0	0
18	37228562	.	C	G	0	6	6	0	0	6	0	0
18	37230433	.	A	G	2	0	2	0	0	2	0	0
18	37230456	.	C	G	3	2	5	0	0	5	0	0
18	37230629	.	T	C	1	4	5	0	1	6	0	0
18	37234081	.	T	C	7	7	14	0	1	15	0	0
18	37234289	.	A	G	3	3	6	0	0	6	0	0
18	37259911	.	A	G	17	23	40	0	2	42	0	0
18	37260088	.	C	T	2	2	4	0	0	4	0	0
18	37260192	.	A	G	16	0	16	0	8	24	0	0
18	37267398	.	C	A	10	10	20	0	1	21	0	0
18	37267464	.	G	A	21	9	30	0	2	32	0	0
18	37267529	.	G	A	7	8	15	0	0	15	0	0
18	37269904	.	A	G	4	1	5	0	0	5	0	0
18	37270225	.	A	G	18	16	34	0	1	35	0	0
18	37270498	.	C	T	16	11	27	0	2	29	0	0
18	37270598	.	T	G	15	7	22	0	2	24	0	0
18	37837371	.	C	T	1	15	16	0	14	30	0	0
18	37837511	.	A	G	15	17	32	0	1	33	0	0
18	37837536	.	T	C	17	16	33	0	0	33	0	0
18	37837655	.	A	G	15	17	32	0	0	32	0	0
18	37837706	.	A	C	11	12	23	0	0	23	0	0
18	37837708	.	T	A	11	12	23	0	0	23	0	0
18	37837879	.	G	T	17	10	27	0	0	27	0	0
18	37838160	.	G	T	23	17	40	0	0	40	0	0
18	37838250	.	G	C	23	8	31	0	1	32	0	0
18	37840290	.	A	G	5	2	7	0	0	7	0	0
18	37866417	.	C	T	0	0	0	0	1	1	0	0
18	38193279	.	G	A	0	1	1	0	0	1	0	0
18	38194336	.	C	A	1	3	4	0	0	4	0	0
18	38199482	.	A	G	4	1	5	0	1	6	0	0
18	38202827	.	T	C	1	0	1	0	0	1	0	0
18	38206907	.	A	G	0	0	0	0	1	1	0	0
18	38209562	.	T	G	3	5	8	0	0	8	0	0
18	38209586	.	C	G	1	5	6	0	0	6	0	0
18	38209597	.	T	C	3	5	8	0	0	8	0	0
18	38209776	.	A	G	8	8	16	0	0	16	0	0
18	38210029	.	G	T	2	2	4	0	0	4	0	0
18	38217181	.	A	G	1	0	1	0	0	1	0	0
18	38222514	.	A	G	3	8	11	0	0	11	0	0
18	38223448	.	A	G	0	2	2	0	0	2	0	0
18	38223735	.	A	G	9	7	16	0	0	16	0	0
18	38224672	.	G	T	1	5	6	0	0	6	0	0
18	38224681	.	A	C	1	5	6	0	0	6	0	0
18	38225491	.	A	G	1	0	1	0	0	1	0	0
18	38225547	.	G	A	4	0	4	0	0	4	0	0
18	38235716	.	T	G	4	5	9	0	0	9	0	0
18	38235726	.	A	T	2	5	7	0	0	7	0	0
18	38239034	.	A	G	1	1	2	0	0	2	0	0
18	38239040	.	A	G	1	1	2	0	0	2	0	0
18	38239073	.	C	T	1	1	2	0	0	2	0	0
18	38248121	.	T	C	10	12	22	0	0	22	0	0
18	38250924	.	A	G	9	6	15	0	0	15	0	0
18	38256265	.	T	C	4	0	4	0	9	13	0	0
18	38256668	.	A	G	6	17	23	0	1	24	0	0
18	38260330	.	A	G	7	16	23	0	0	23	0	0
18	38260352	.	C	A	7	11	18	0	0	18	0	0
18	38260377	.	C	T	5	7	12	0	0	12	0	0
18	38263910	.	G	C	1	1	2	0	0	2	0	0
18	38266979	.	C	T	11	6	17	0	1	18	0	0
18	38270559	.	T	C	7	8	15	0	1	16	0	0
18	38296046	.	C	G	10	7	17	0	0	17	0	0
18	38296089	.	G	T	6	8	14	0	0	14	0	0
18	38296452	.	A	C	1	2	3	0	1	4	0	0
18	38296467	.	T	C	3	3	6	0	0	6	0	0
18	39104846	.	T	C	8	5	13	0	0	13	0	0
18	39172728	.	A	T	0	11	11	0	0	11	0	0
18	39172746	.	A	C	0	3	3	0	0	3	0	0
18	39523002	.	T	C	0	3	3	0	0	3	0	0
18	40373365	.	C	T	0	2	2	0	0	2	0	0
18	40375564	.	C	T	1	2	3	0	0	3	0	0
18	40379477	.	G	T	0	1	1	0	3	4	0	0
18	40379516	.	C	T	4	4	8	0	0	8	0	0
18	40379560	.	C	T	1	5	6	0	0	6	0	0
18	40379612	.	G	A	1	0	1	0	0	1	0	0
18	40382019	.	A	G	0	0	0	0	1	1	0	0
18	40383282	.	T	A	7	8	15	0	0	15	0	0
18	40383665	.	T	A	7	6	13	0	0	13	0	0
18	40384022	.	G	T	0	9	9	0	8	17	0	0
18	40384160	.	C	T	6	12	18	0	0	18	0	0
18	40384214	.	T	C	11	6	17	0	0	17	0	0
18	40384253	.	A	G	4	4	8	0	4	12	0	0
18	40384277	.	T	A	3	5	8	0	0	8	0	0
18	40387506	.	C	T	9	16	25	0	0	25	0	0
18	40387606	.	G	A	14	6	20	0	0	20	0	0
18	40387650	.	T	A	11	12	23	0	0	23	0	0
18	40387811	.	T	A	5	9	14	0	0	14	0	0
18	40468686	.	A	C	1	4	5	0	0	5	0	0
18	40468717	.	C	T	1	3	4	0	0	4	0	0
18	40469018	.	C	A	5	2	7	0	0	7	0	0
18	40480383	.	A	G	1	2	3	0	0	3	0	0
18	40489539	.	G	A	8	5	13	0	0	13	0	0
18	40492204	.	C	T	10	4	14	0	0	14	0	0
18	40492253	.	T	C	7	11	18	0	1	19	0	0
18	40493076	.	T	G	2	2	4	0	0	4	0	0
18	40669727	.	T	C	4	3	7	0	0	7	0	0
18	40669741	.	T	C	2	4	6	0	0	6	0	0
18	40762874	.	T	A	3	3	6	0	0	6	0	0
18	41364890	.	T	C	2	4	6	0	0	6	0	0
18	41648941	.	T	C	5	17	22	0	1	23	0	0
18	41649949	.	C	T	0	2	2	0	5	7	0	0
18	41650171	.	C	T	3	4	7	0	0	7	0	0
18	41650222	.	C	T	10	10	20	0	1	21	0	0
18	41650396	.	G	A	4	8	12	0	0	12	0	0
18	41757373	.	G	C	16	10	26	0	1	27	0	0
18	42151412	.	A	C	12	1	13	0	9	22	0	0
18	42162369	.	G	A	5	4	9	0	0	9	0	0
18	42165295	.	A	C	1	2	3	0	0	3	0	0
18	42171988	.	T	C	9	0	9	0	10	19	0	0
18	42201031	.	C	G	3	2	5	0	0	5	0	0
18	42201141	.	C	G	2	1	3	0	0	3	0	0
18	42218721	.	G	A	6	5	11	0	0	11	0	0
18	42218741	.	G	A	4	1	5	0	0	5	0	0
18	42258933	.	T	A	3	3	6	0	0	6	0	0
18	43162650	.	T	C	15	9	24	0	2	26	0	0
18	43183845	.	T	C	8	13	21	0	1	22	0	0
18	43225614	.	T	C	18	15	33	0	3	36	0	0
18	43225650	.	C	T	20	16	36	0	1	37	0	0
18	43225683	.	C	T	15	20	35	0	1	36	0	0
18	43225896	.	C	T	29	24	53	0	0	53	0	0
18	43867416	.	A	G	9	13	22	0	1	23	0	0
18	43867775	.	T	C	7	6	13	0	0	13	0	0
18	43867892	.	C	T	9	4	13	0	0	13	0	0
18	43868073	.	A	C	6	9	15	0	0	15	0	0
18	43868229	.	A	T	7	12	19	0	3	22	0	0
18	43868234	.	T	A	6	15	21	0	2	23	0	0
18	43869326	.	A	G	2	7	9	0	0	9	0	0
18	43869403	.	T	C	2	5	7	0	2	9	0	0
18	43869424	.	G	A	4	4	8	0	0	8	0	0
18	43869475	.	A	G	2	4	6	0	0	6	0	0
18	43869561	.	A	G	2	2	4	0	1	5	0	0
18	43869659	.	C	T	2	2	4	0	2	6	0	0
18	43869976	.	T	C	3	7	10	0	2	12	0	0
18	43870180	.	C	T	0	6	6	0	2	8	0	0
18	43870501	.	T	C	8	4	12	0	0	12	0	0
18	43870525	.	G	A	7	9	16	0	0	16	0	0
18	43870541	.	A	G	7	10	17	0	1	18	0	0
18	43870592	.	C	A	3	8	11	0	0	11	0	0
18	43870655	.	G	T	5	3	8	0	3	11	0	0
18	43870660	.	A	G	7	3	10	0	0	10	0	0
18	43896892	.	A	G	15	13	28	0	0	28	0	0
18	43896919	.	C	T	0	13	13	0	20	33	0	0
18	43897048	.	C	T	1	16	17	0	20	37	0	0
18	43897405	.	C	G	3	9	12	0	0	12	0	0
18	43897522	.	C	T	10	6	16	0	0	16	0	0
18	43897816	.	G	A	8	10	18	0	0	18	0	0
18	43898211	.	G	T	9	8	17	0	0	17	0	0
18	43898223	.	A	T	9	5	14	0	1	15	0	0
18	43898526	.	C	T	12	8	20	0	2	22	0	0
18	43898928	.	A	G	2	4	6	0	0	6	0	0
18	43899558	.	T	C	2	4	6	0	1	7	0	0
18	43899825	.	G	A	8	11	19	0	0	19	0	0
18	43900299	.	G	A	2	3	5	0	0	5	0	0
18	43908395	.	G	C	3	3	6	0	0	6	0	0
18	44053584	.	T	C	1	2	3	0	0	3	0	0
18	44065135	.	A	G	7	2	9	0	0	9	0	0
18	44075782	.	T	C	0	2	2	0	0	2	0	0
18	44321914	.	T	C	3	2	5	0	1	6	0	0
18	44321949	.	T	C	2	2	4	0	0	4	0	0
18	44321950	.	T	C	2	1	3	0	1	4	0	0
18	45231238	.	C	T	1	3	4	0	0	4	0	0
18	45235903	.	G	T	0	2	2	0	2	4	0	0
18	45235924	.	T	C	2	0	2	0	0	2	0	0
18	45257475	.	C	T	2	5	7	0	0	7	0	0
18	45260131	.	T	C	3	8	11	0	2	13	0	0
18	45260228	.	T	C	5	6	11	0	0	11	0	0
18	45260316	.	A	C	7	5	12	0	0	12	0	0
18	45261177	.	C	T	5	13	18	0	0	18	0	0
18	45261203	.	T	C	2	7	9	0	2	11	0	0
18	45261284	.	A	C	10	4	14	0	1	15	0	0
18	45261299	.	T	A	10	3	13	0	0	13	0	0
18	45261319	.	A	T	7	3	10	0	0	10	0	0
18	45261355	.	C	T	10	4	14	0	0	14	0	0
18	45261369	.	G	T	8	4	12	0	0	12	0	0
18	45261412	.	A	G	7	0	7	0	6	13	0	0
18	45261501	.	G	C	0	2	2	0	0	2	0	0
18	45261587	.	G	T	1	5	6	0	0	6	0	0
18	45261687	.	A	G	2	4	6	0	0	6	0	0
18	45261691	.	G	A	2	3	5	0	0	5	0	0
18	45261845	.	T	A	3	7	10	0	0	10	0	0
18	45261968	.	C	T	5	6	11	0	0	11	0	0
18	45262000	.	G	A	7	4	11	0	0	11	0	0
18	45262397	.	C	T	6	10	16	0	0	16	0	0
18	45262440	.	C	A	6	7	13	0	0	13	0	0
18	45262469	.	C	A	10	6	16	0	0	16	0	0
18	45262605	.	T	A	8	3	11	0	0	11	0	0
18	45550831	.	G	C	0	8	8	0	19	27	0	0
18	45550839	.	A	C	16	8	24	0	3	28	1	0
18	45561677	.	G	T	2	3	5	0	0	5	0	0
18	45563800	.	A	C	9	5	14	0	0	14	0	0
18	45574140	.	A	G	12	14	26	0	1	27	0	0
18	45574232	.	A	G	10	12	22	0	1	23	0	0
18	45575079	.	G	A	0	8	8	0	17	25	0	0
18	45578543	.	A	G	7	9	16	0	0	16	0	0
18	45581704	.	C	A	7	15	22	0	0	22	0	0
18	45584036	.	C	T	7	11	18	0	0	18	0	0
18	45586597	.	G	A	1	3	4	0	1	5	0	0
18	45591836	.	A	T	11	16	27	0	0	27	0	0
18	45591929	.	G	A	15	11	26	0	1	27	0	0
18	45592002	.	A	C	8	13	21	0	1	22	0	0
18	45592031	.	G	A	10	12	22	0	2	24	0	0
18	45649916	.	A	G	3	0	3	0	9	12	0	0
18	45651032	.	C	T	6	5	11	0	0	11	0	0
18	45651731	.	T	A	7	7	14	0	0	14	0	0
18	45656089	.	T	C	6	2	8	0	0	8	0	0
18	45677240	.	A	G	2	4	6	0	0	6	0	0
18	45677259	.	T	C	2	3	5	0	0	5	0	0
18	45684977	.	T	C	3	3	6	0	0	6	0	0
18	45685659	.	T	A	1	2	3	0	0	3	0	0
18	45685907	.	A	G	5	0	5	0	4	9	0	0
18	45686452	.	A	G	7	5	12	0	0	12	0	0
18	45686483	.	A	C	5	3	8	0	0	8	0	0
18	45686664	.	T	C	9	4	13	0	1	14	0	0
18	45686840	.	T	C	5	5	10	0	0	10	0	0
18	45687156	.	T	G	4	0	4	0	5	9	0	0
18	45687258	.	G	C	2	2	4	0	0	4	0	0
18	45689081	.	C	T	2	2	4	0	0	4	0	0
18	45689115	.	G	C	3	2	5	0	0	5	0	0
18	45697582	.	C	T	1	5	6	0	0	6	0	0
18	45697833	.	A	T	2	4	6	0	0	6	0	0
18	45697967	.	C	T	3	2	5	0	0	5	0	0
18	45698032	.	A	G	2	1	3	0	4	7	0	0
18	45698143	.	G	A	0	2	2	0	1	3	0	0
18	45698344	.	C	A	3	4	7	0	1	8	0	0
18	45734521	.	G	C	8	4	12	0	0	12	0	0
18	45740194	.	T	C	6	4	10	0	1	11	0	0
18	45743518	.	G	A	2	6	8	0	0	8	0	0
18	45743522	.	G	A	2	6	8	0	0	8	0	0
18	45743555	.	C	A	2	5	7	0	0	8	1	0
18	45745504	.	A	T	7	1	8	0	0	8	0	0
18	45759309	.	G	T	9	7	16	0	0	16	0	0
18	45786801	.	T	C	15	12	27	0	0	27	0	0
18	45788695	.	T	C	2	2	4	0	0	4	0	0
18	45807942	.	G	C	0	11	11	0	5	16	0	0
18	45813396	.	G	A	2	1	3	0	0	3	0	0
18	45818602	.	C	T	13	13	26	0	0	26	0	0
18	45820510	.	G	A	0	4	4	0	3	7	0	0
18	45820588	.	A	G	8	10	18	0	3	21	0	0
18	45824315	.	C	T	13	15	28	0	0	28	0	0
18	45824467	.	G	A	0	8	8	0	17	25	0	0
18	45840402	.	A	G	8	0	8	0	4	12	0	0
18	45842491	.	T	C	8	5	13	0	0	13	0	0
18	45842679	.	G	A	0	11	11	0	10	21	0	0
18	45844458	.	C	T	16	23	39	0	0	39	0	0
18	45844473	.	A	T	15	23	38	0	1	39	0	0
18	45849253	.	T	C	4	4	8	0	0	8	0	0
18	45849283	.	C	T	7	20	27	0	0	27	0	0
18	45851540	.	G	A	0	3	3	0	7	10	0	0
18	45862949	.	G	A	1	4	5	0	0	5	0	0
18	45884971	.	A	T	1	3	4	0	0	4	0	0
18	45886957	.	G	T	3	3	6	0	0	6	0	0
18	45932401	.	C	A	1	2	3	0	0	3	0	0
18	45934691	.	G	T	1	4	5	0	0	5	0	0
18	45944522	.	G	A	2	1	3	0	1	4	0	0
18	45947835	.	C	T	6	4	10	0	0	10	0	0
18	45947880	.	C	A	2	4	6	0	1	7	0	0
18	45955140	.	T	A	11	9	20	0	3	23	0	0
18	45955142	.	T	C	12	11	23	0	0	23	0	0
18	45962620	.	T	C	25	15	40	0	0	40	0	0
18	45967083	.	A	G	12	24	36	0	7	43	0	0
18	45967107	.	C	T	15	26	41	0	1	42	0	0
18	45969252	.	C	A	5	1	6	0	1	7	0	0
18	45979887	.	C	T	6	9	15	0	0	15	0	0
18	45983268	.	A	C	30	16	46	0	2	48	0	0
18	46010180	.	A	G	8	3	11	0	2	13	0	0
18	46010243	.	C	T	4	0	4	0	0	4	0	0
18	46012619	.	A	C	1	2	3	0	0	3	0	0
18	46015830	.	G	A	2	0	2	0	0	2	0	0
18	46059029	.	A	G	1	7	8	0	0	8	0	0
18	46059095	.	A	G	9	7	16	0	0	16	0	0
18	46061242	.	G	A	4	5	9	0	2	11	0	0
18	46063648	.	C	T	3	7	10	0	0	10	0	0
18	46107344	.	A	G	2	4	6	0	0	6	0	0
18	46116974	.	C	T	3	6	9	0	0	9	0	0
18	46117139	.	T	C	2	5	7	0	0	7	0	0
18	46117466	.	T	G	1	2	3	0	0	3	0	0
18	46118881	.	C	A	1	5	6	0	0	6	0	0
18	46118929	.	A	G	1	3	4	0	0	4	0	0
18	46194102	.	C	G	4	6	10	0	1	11	0	0
18	46194243	.	T	C	4	2	6	0	0	6	0	0
18	46194360	.	T	G	8	10	18	0	0	18	0	0
18	46196280	.	C	T	0	0	0	0	1	1	0	0
18	46198152	.	G	C	12	4	16	0	0	16	0	0
18	46198253	.	G	T	19	8	27	0	3	30	0	0
18	46202801	.	T	C	12	9	21	0	0	21	0	0
18	46203195	.	T	C	15	0	15	0	13	28	0	0
18	46203199	.	C	T	16	10	26	0	2	28	0	0
18	46203291	.	G	A	13	15	28	0	2	30	0	0
18	46203457	.	G	T	13	7	20	0	1	21	0	0
18	46203562	.	T	C	12	13	25	0	4	29	0	0
18	46203563	.	C	T	0	12	12	0	17	29	0	0
18	46367691	.	G	C	1	0	1	0	0	1	0	0
18	46367733	.	G	A	9	2	11	0	1	12	0	0
18	46367772	.	C	G	0	5	5	0	12	17	0	0
18	46368513	.	T	C	7	1	8	0	10	18	0	0
18	46368771	.	C	T	0	8	8	0	2	10	0	0
18	46369173	.	T	C	5	5	10	0	0	10	0	0
18	46417181	.	C	T	2	6	8	0	1	9	0	0
18	46417342	.	A	G	16	16	32	0	2	34	0	0
18	46417402	.	G	A	9	16	25	0	1	26	0	0
18	46417624	.	T	C	12	13	25	0	1	26	0	0
18	46417714	.	G	C	8	8	16	0	1	17	0	0
18	46417775	.	T	C	16	1	17	0	5	22	0	0
18	46418632	.	G	A	11	11	22	0	1	23	0	0
18	46418818	.	C	A	10	8	18	0	0	18	0	0
18	46418860	.	C	T	0	8	8	0	11	19	0	0
18	46418932	.	T	A	13	4	17	0	0	17	0	0
18	46419056	.	C	T	7	8	15	0	1	16	0	0
18	46419124	.	T	C	6	9	15	0	0	15	0	0
18	46419275	.	T	C	12	12	24	0	0	24	0	0
18	46419451	.	A	T	5	7	12	0	0	12	0	0
18	46419616	.	T	C	9	7	16	0	0	16	0	0
18	46635323	.	G	T	5	6	11	0	0	11	0	0
18	46635390	.	G	C	5	3	8	0	0	8	0	0
18	46635591	.	C	T	11	3	14	0	1	15	0	0
18	46635805	.	C	G	9	11	20	0	1	21	0	0
18	46653344	.	G	A	3	4	7	0	1	8	0	0
18	46684230	.	A	T	10	3	13	0	0	13	0	0
18	46684258	.	G	T	10	3	13	0	1	14	0	0
18	46699773	.	G	A	25	26	51	0	2	53	0	0
18	46702492	.	G	A	25	19	44	0	3	47	0	0
18	46714896	.	A	G	15	11	26	0	1	27	0	0
18	46729044	.	A	G	11	5	16	0	0	16	0	0
18	46729321	.	A	G	8	4	12	0	1	13	0	0
18	46732406	.	C	G	2	4	6	0	0	6	0	0
18	46732417	.	T	A	1	2	3	0	0	3	0	0
18	46735972	.	T	C	1	0	1	0	0	1	0	0
18	46738862	.	C	A	1	14	15	0	7	22	0	0
18	46738955	.	A	C	18	13	31	0	1	32	0	0
18	46738990	.	A	T	15	15	30	0	2	32	0	0
18	47301204	.	T	C	6	8	14	0	0	14	0	0
18	47305433	.	A	G	2	3	5	0	0	5	0	0
18	47306782	.	A	G	1	3	4	0	0	4	0	0
18	47523393	.	A	G	1	6	7	0	0	7	0	0
18	47566919	.	A	T	1	3	4	0	0	4	0	0
18	47567902	.	C	T	2	1	3	0	0	3	0	0
18	48620495	.	C	T	3	7	10	0	0	10	0	0
18	48640143	.	G	C	0	4	4	0	3	7	0	0
18	48640155	.	G	C	0	5	5	0	1	6	0	0
18	48640317	.	G	T	0	4	4	0	4	8	0	0
18	48640348	.	A	G	3	0	3	0	8	11	0	0
18	48640417	.	G	C	2	5	7	0	0	7	0	0
18	48640420	.	A	G	2	5	7	0	0	7	0	0
18	48640707	.	C	T	1	3	4	0	0	4	0	0
18	48641417	.	T	C	1	3	4	0	0	4	0	0
18	48642161	.	A	T	3	3	6	0	1	7	0	0
18	48642270	.	G	A	1	4	5	0	0	5	0	0
18	48642335	.	C	T	1	2	3	0	0	3	0	0
18	48642372	.	T	C	3	6	9	0	0	9	0	0
18	48642373	.	T	C	3	6	9	0	0	9	0	0
18	48642821	.	C	T	3	3	6	0	1	7	0	0
18	48642856	.	T	A	2	4	6	0	0	6	0	0
18	48642868	.	A	T	1	4	5	0	0	5	0	0
18	48643055	.	A	G	4	3	7	0	0	7	0	0
18	48759970	.	A	C	2	6	8	0	2	10	0	0
18	48807499	.	A	G	0	4	4	0	1	5	0	0
18	48807521	.	T	C	1	3	4	0	0	4	0	0
18	48807623	.	C	T	4	2	6	0	1	7	0	0
18	48808043	.	A	G	2	3	5	0	2	7	0	0
18	48808099	.	A	G	3	4	7	0	0	7	0	0
18	48808659	.	G	A	0	4	4	0	2	6	0	0
18	48808708	.	T	A	4	2	6	0	0	6	0	0
18	48809226	.	G	A	3	4	7	0	0	7	0	0
18	48864856	.	T	C	3	14	17	0	0	17	0	0
18	48864944	.	C	T	7	10	17	0	1	18	0	0
18	48898641	.	C	T	1	2	3	0	0	3	0	0
18	48928230	.	C	T	13	22	35	0	2	37	0	0
18	48928240	.	A	G	13	1	14	0	24	38	0	0
18	48928342	.	A	G	16	0	16	0	20	36	0	0
18	48928387	.	T	A	11	19	30	0	3	33	0	0
18	48934524	.	T	C	10	8	18	0	0	18	0	0
18	48934593	.	T	C	2	4	6	0	0	6	0	0
18	48934805	.	A	G	13	20	33	0	0	33	0	0
18	48934833	.	T	C	14	12	26	0	0	26	0	0
18	48935170	.	G	A	23	14	37	0	1	38	0	0
18	48935279	.	T	G	25	19	44	0	1	45	0	0
18	48935282	.	T	G	26	19	45	0	2	47	0	0
18	48935394	.	A	T	11	14	25	0	0	25	0	0
18	48935709	.	A	G	15	15	30	0	0	30	0	0
18	48951563	.	A	G	1	2	3	0	0	3	0	0
18	48962318	.	C	T	0	5	5	0	0	5	0	0
18	48964912	.	G	C	1	0	1	0	1	2	0	0
18	48964915	.	G	A	0	1	1	0	1	2	0	0
18	48967500	.	T	C	2	3	5	0	1	6	0	0
18	48968436	.	C	G	1	0	1	0	5	6	0	0
18	48971165	.	T	C	3	6	9	0	0	9	0	0
18	48971192	.	A	G	1	4	5	0	0	5	0	0
18	48972490	.	A	T	6	10	16	0	0	16	0	0
18	49154079	.	A	G	10	4	14	0	0	14	0	0
18	49154130	.	A	G	8	8	16	0	0	16	0	0
18	49154131	.	A	G	12	4	16	0	0	16	0	0
18	49154328	.	G	A	11	6	17	0	1	18	0	0
18	49154458	.	G	T	15	8	23	0	0	23	0	0
18	49154483	.	G	T	0	9	9	0	19	28	0	0
18	49154525	.	C	T	15	10	25	0	2	27	0	0
18	49154527	.	T	C	15	9	24	0	3	27	0	0
18	49154722	.	A	G	17	12	29	0	0	29	0	0
18	49155211	.	C	A	14	4	18	0	1	19	0	0
18	49155303	.	G	A	5	3	8	1	0	9	0	0
18	49155941	.	C	T	11	12	23	0	1	24	0	0
18	49155956	.	T	C	13	16	29	0	0	29	0	0
18	49155976	.	A	T	8	11	19	0	0	19	0	0
18	49156009	.	G	C	11	10	21	0	0	21	0	0
18	49156034	.	A	C	9	13	22	0	2	24	0	0
18	49156077	.	A	G	12	0	12	0	14	26	0	0
18	49156113	.	A	G	11	4	15	0	0	15	0	0
18	49156370	.	A	G	5	4	9	0	0	9	0	0
18	49156405	.	C	A	4	2	6	0	0	6	0	0
18	49156437	.	T	A	6	4	10	0	0	10	0	0
18	49156444	.	G	A	5	5	10	0	0	10	0	0
18	49156482	.	G	T	4	5	9	0	0	9	0	0
18	49241958	.	A	G	0	1	1	0	0	1	0	0
18	49242211	.	G	T	0	1	1	0	1	2	0	0
18	49244819	.	C	A	6	5	11	0	0	11	0	0
18	49244821	.	C	A	6	5	11	0	0	11	0	0
18	49245256	.	G	C	2	7	9	0	0	9	0	0
18	49246672	.	T	A	2	4	6	0	2	8	0	0
18	49248524	.	G	T	5	5	10	0	0	10	0	0
18	49261687	.	T	C	3	4	7	0	0	7	0	0
18	49265001	.	G	T	6	11	17	0	0	17	0	0
18	49265002	.	G	T	6	10	16	0	1	17	0	0
18	49265434	.	C	A	1	4	5	0	0	5	0	0
18	49266248	.	A	G	2	3	5	0	0	5	0	0
18	49266251	.	A	G	1	4	5	0	0	5	0	0
18	49266589	.	A	G	2	7	9	0	0	9	0	0
18	49266635	.	A	G	2	3	5	0	1	6	0	0
18	49266715	.	C	T	1	3	4	0	0	4	0	0
18	49266746	.	A	G	1	4	5	0	0	5	0	0
18	49266998	.	A	G	8	4	12	0	0	12	0	0
18	49267489	.	A	G	3	2	5	0	0	5	0	0
18	49267605	.	A	G	3	4	7	0	0	7	0	0
18	49274395	.	T	C	1	0	1	0	3	4	0	0
18	49274468	.	A	T	1	4	5	0	0	5	0	0
18	49310480	.	G	C	1	3	4	0	0	4	0	0
18	49310668	.	A	G	1	2	3	0	0	3	0	0
18	49311466	.	T	A	1	0	1	0	0	1	0	0
18	49412367	.	G	T	5	4	9	0	0	9	0	0
18	49412394	.	A	G	5	3	8	0	0	8	0	0
18	49412709	.	G	A	0	4	4	0	7	11	0	0
18	49428280	.	G	A	4	5	9	0	0	9	0	0
18	49428793	.	T	C	5	5	10	0	0	10	0	0
18	49446190	.	G	T	5	3	8	0	0	8	0	0
18	49446293	.	C	G	5	2	7	0	0	7	0	0
18	49446312	.	G	A	3	3	6	0	1	7	0	0
18	49446398	.	G	A	4	7	11	0	0	11	0	0
18	49446456	.	A	G	3	0	3	0	5	8	0	0
18	49446490	.	A	G	4	5	9	0	0	9	0	0
18	49446764	.	A	T	2	3	5	0	0	5	0	0
18	49446796	.	C	A	1	5	6	0	0	6	0	0
18	49446803	.	T	A	0	4	4	0	1	5	0	0
18	49446881	.	T	C	6	1	7	0	0	7	0	0
18	49447008	.	C	A	6	7	13	0	0	13	0	0
18	49447041	.	G	A	0	11	11	0	6	17	0	0
18	49969631	.	A	C	4	3	7	0	2	9	0	0
18	49969646	.	A	G	6	3	9	0	3	12	0	0
18	49969819	.	T	C	7	3	10	0	1	11	0	0
18	50034871	.	A	G	3	0	3	0	5	8	0	0
18	50038631	.	A	G	0	3	3	0	0	3	0	0
18	50038651	.	A	G	1	0	1	0	3	4	0	0
18	50038720	.	T	G	2	6	8	0	0	9	1	0
18	50038721	.	G	T	2	7	9	0	0	9	0	0
18	50039295	.	C	A	3	5	8	0	0	8	0	0
18	50039684	.	T	C	5	3	8	0	0	8	0	0
18	50039852	.	G	T	5	9	14	0	0	14	0	0
18	50039917	.	T	A	3	5	8	0	1	9	0	0
18	50039939	.	C	T	5	3	8	0	0	8	0	0
18	50047733	.	A	G	2	1	3	0	0	3	0	0
18	50089090	.	G	A	0	2	2	0	3	5	0	0
18	50093398	.	C	A	1	2	3	0	0	3	0	0
18	50276173	.	C	T	15	16	31	0	1	32	0	0
18	50276435	.	G	A	6	13	19	0	1	20	0	0
18	50276476	.	C	G	1	7	8	0	1	9	0	0
18	50279112	.	A	T	13	18	31	0	6	37	0	0
18	50353650	.	C	T	16	26	42	0	0	42	0	0
18	50356440	.	G	A	22	20	42	0	6	48	0	0
18	50356518	.	C	A	22	22	44	0	6	50	0	0
18	50356532	.	G	A	23	22	45	0	2	47	0	0
18	50356632	.	T	C	18	21	39	0	2	41	0	0
18	50443666	.	T	C	2	2	4	0	0	4	0	0
18	50443851	.	G	A	2	2	4	0	0	4	0	0
18	50495604	.	C	T	1	4	5	0	0	5	0	0
18	50523952	.	T	G	1	4	5	0	0	5	0	0
18	50529552	.	T	A	1	1	2	0	1	3	0	0
18	50532421	.	C	T	4	7	11	0	0	11	0	0
18	50536843	.	C	T	0	2	2	0	9	11	0	0
18	50537374	.	T	C	14	5	19	1	0	20	0	0
18	50537377	.	T	C	14	4	18	1	1	20	0	0
18	50537647	.	A	G	7	0	7	0	0	7	0	0
18	50537884	.	G	A	4	14	18	0	1	19	0	0
18	50538019	.	A	C	7	9	16	0	1	17	0	0
18	50538020	.	G	A	8	9	17	0	0	17	0	0
18	50538289	.	T	C	17	8	25	0	0	25	0	0
18	50538340	.	T	C	6	14	20	0	0	20	0	0
18	50538442	.	T	C	10	4	14	0	0	14	0	0
18	50538533	.	T	C	4	2	6	0	0	6	0	0
18	50538539	.	T	G	4	4	8	0	2	10	0	0
18	50538598	.	T	C	12	2	14	0	0	14	0	0
18	50538601	.	T	C	10	3	13	0	0	13	0	0
18	50538760	.	G	A	2	4	6	0	0	6	0	0
18	50538875	.	G	C	5	2	7	0	1	8	0	0
18	50538969	.	T	G	3	7	10	0	0	10	0	0
18	50539041	.	G	T	2	3	5	0	0	5	0	0
18	50539271	.	G	A	2	5	7	0	0	7	0	0
18	50539341	.	G	C	9	7	16	0	0	16	0	0
18	50559500	.	C	T	2	2	4	0	1	5	0	0
18	50579546	.	G	A	8	5	13	0	0	13	0	0
18	50579551	.	C	T	9	5	14	0	0	14	0	0
18	50601149	.	G	A	1	6	7	0	0	7	0	0
18	50601426	.	C	G	5	6	11	0	1	12	0	0
18	50601630	.	C	A	9	18	27	0	1	28	0	0
18	50601636	.	A	G	20	11	31	0	0	31	0	0
18	50606024	.	T	C	9	0	9	0	11	20	0	0
18	50614145	.	T	A	1	7	8	0	2	10	0	0
18	50689577	.	T	C	0	2	2	0	0	2	0	0
18	50689583	.	G	A	2	0	2	0	0	2	0	0
18	50706691	.	C	A	0	3	3	0	0	3	0	0
18	50706696	.	C	T	0	3	3	0	0	3	0	0
18	50766625	.	G	A	4	3	7	0	2	9	0	0
18	50911943	.	C	G	6	0	6	0	0	6	0	0
18	50911951	.	T	C	0	5	5	0	0	5	0	0
19	175345	.	A	G	6	3	9	0	0	9	0	0
19	371653	.	A	G	1	3	4	0	0	4	0	0
19	371857	.	A	G	6	3	9	0	0	9	0	0
19	372170	.	A	G	2	1	3	0	1	4	0	0
19	372209	.	A	G	5	2	7	0	0	7	0	0
19	372211	.	A	G	3	4	7	0	0	7	0	0
19	426116	.	G	A	4	1	5	0	0	5	0	0
19	433735	.	T	C	2	4	6	0	0	6	0	0
19	433736	.	T	C	1	5	6	0	0	6	0	0
19	1013131	.	T	C	6	4	10	0	1	11	0	0
19	1185281	.	G	A	5	5	10	0	0	10	0	0
19	1408133	.	A	G	0	2	2	0	0	2	0	0
19	2000142	.	C	G	4	4	8	0	1	9	0	0
19	2001557	.	T	C	3	1	4	0	0	4	0	0
19	2001618	.	A	C	6	3	9	0	0	9	0	0
19	2002992	.	A	G	2	0	2	0	2	4	0	0
19	2003150	.	T	C	5	5	10	0	0	10	0	0
19	2003158	.	C	T	5	6	11	0	0	11	0	0
19	2003634	.	T	C	2	3	5	0	0	5	0	0
19	2003767	.	C	T	7	10	17	0	1	18	0	0
19	2003803	.	C	G	10	0	10	0	12	22	0	0
19	2003902	.	A	T	12	8	20	0	0	20	0	0
19	2003962	.	G	T	1	8	9	0	11	20	0	0
19	2004046	.	G	C	10	12	22	0	2	24	0	0
19	2019147	.	C	T	0	0	0	0	2	2	0	0
19	2019430	.	G	A	3	1	4	0	0	4	0	0
19	2019480	.	C	T	0	3	3	0	6	9	0	0
19	2028006	.	T	C	1	0	1	0	0	1	0	0
19	2064629	.	G	A	3	3	6	0	0	6	0	0
19	2064762	.	G	C	8	3	11	0	1	12	0	0
19	2083254	.	C	T	2	2	4	0	0	4	0	0
19	2084982	.	G	A	0	4	4	0	0	4	0	0
19	2089667	.	C	A	2	1	3	0	0	3	0	0
19	2279284	.	C	T	3	2	5	0	0	5	0	0
19	2289508	.	T	C	4	0	4	0	0	4	0	0
19	2294971	.	G	C	3	3	6	0	0	6	0	0
19	2296826	.	G	C	5	7	12	0	0	12	0	0
19	2296827	.	C	T	5	7	12	0	0	12	0	0
19	2307248	.	C	A	7	5	12	0	0	12	0	0
19	2307268	.	C	T	6	5	11	0	0	11	0	0
19	2315511	.	C	T	0	2	2	0	6	8	0	0
19	2315666	.	A	G	5	5	10	0	0	10	0	0
19	2315752	.	A	T	7	2	9	0	0	9	0	0
19	2316215	.	G	A	1	5	6	0	0	6	0	0
19	2316510	.	T	C	4	8	12	0	0	12	0	0
19	2316729	.	G	C	6	3	9	0	0	9	0	0
19	2316765	.	T	C	5	7	12	0	0	12	0	0
19	2316894	.	T	C	4	5	9	0	0	9	0	0
19	2395512	.	C	A	2	2	4	0	0	4	0	0
19	2396022	.	C	T	0	1	1	0	1	2	0	0
19	2396492	.	C	A	5	2	7	0	0	7	0	0
19	2396708	.	C	T	3	3	6	0	0	6	0	0
19	2396743	.	A	G	4	4	8	0	0	8	0	0
19	2396948	.	C	T	1	2	3	0	0	3	0	0
19	2397381	.	G	C	1	3	4	0	0	4	0	0
19	2400403	.	G	A	2	0	2	0	0	2	0	0
19	2402609	.	T	A	5	2	7	0	0	7	0	0
19	2402611	.	T	A	5	3	8	0	0	8	0	0
19	2403807	.	C	T	2	1	3	0	0	3	0	0
19	2403906	.	T	C	3	0	3	0	4	7	0	0
19	2546871	.	T	A	1	4	5	0	0	5	0	0
19	2550676	.	G	A	4	2	6	0	2	8	0	0
19	2550839	.	C	T	7	6	13	0	0	13	0	0
19	2551214	.	C	T	7	5	12	0	0	12	0	0
19	2551727	.	C	T	7	5	12	0	0	12	0	0
19	2560950	.	A	G	6	4	10	0	2	12	0	0
19	2561048	.	A	C	9	9	18	0	0	18	0	0
19	2561739	.	G	A	1	7	8	0	10	18	0	0
19	2570645	.	A	T	1	1	2	0	0	2	0	0
19	2570654	.	G	A	1	1	2	0	0	2	0	0
19	2602934	.	G	A	2	3	5	0	1	6	0	0
19	2645115	.	C	T	3	5	8	0	0	8	0	0
19	2651272	.	A	G	3	2	5	0	0	5	0	0
19	2651344	.	G	A	0	0	0	0	1	1	0	0
19	2654388	.	A	T	8	5	13	0	1	14	0	0
19	2654424	.	C	T	4	7	11	0	1	12	0	0
19	2663609	.	A	G	10	14	24	0	0	24	0	0
19	2664394	.	C	T	7	10	17	0	1	18	0	0
19	2664613	.	T	C	9	5	14	0	0	14	0	0
19	2685839	.	T	C	3	4	7	0	1	8	0	0
19	2695314	.	G	A	3	7	10	0	2	12	0	0
19	2695351	.	A	G	3	0	3	0	7	10	0	0
19	2695358	.	G	A	1	7	8	0	1	9	0	0
19	2731100	.	C	T	0	2	2	0	0	2	0	0
19	2732833	.	C	T	8	4	12	0	1	13	0	0
19	2732836	.	G	A	8	4	12	0	1	13	0	0
19	2744169	.	C	G	4	1	5	0	0	5	0	0
19	2746008	.	G	A	0	4	4	0	3	7	0	0
19	2746134	.	C	T	6	0	6	0	0	6	0	0
19	2750162	.	G	A	0	3	3	0	1	4	0	0
19	2871511	.	A	G	6	6	12	0	1	13	0	0
19	2871553	.	C	T	3	4	7	0	0	7	0	0
19	2871559	.	G	A	3	2	5	0	0	5	0	0
19	2877359	.	C	T	2	3	5	0	0	5	0	0
19	2877371	.	C	T	2	3	5	0	0	5	0	0
19	2930451	.	G	A	3	3	6	0	0	6	0	0
19	2930597	.	A	G	10	7	17	0	0	17	0	0
19	2934321	.	A	G	0	1	1	0	0	1	0	0
19	2967894	.	A	G	0	2	2	0	0	2	0	0
19	3002047	.	G	A	0	2	2	0	1	3	0	0
19	3052828	.	A	G	1	0	1	0	0	1	0	0
19	3052836	.	A	T	1	0	1	0	0	1	0	0
19	3052970	.	A	G	6	3	9	0	0	9	0	0
19	3056629	.	C	T	4	3	7	0	0	7	0	0
19	3080572	.	G	A	7	6	13	0	0	13	0	0
19	3080712	.	T	A	8	6	14	0	1	15	0	0
19	3080863	.	A	T	7	2	9	0	0	9	0	0
19	3081008	.	A	G	4	0	4	0	5	9	0	0
19	3081206	.	G	T	2	4	6	0	0	6	0	0
19	3081388	.	A	G	5	0	5	0	6	11	0	0
19	3081394	.	A	G	4	5	9	0	0	9	0	0
19	3081704	.	A	T	2	2	4	0	0	7	3	0
19	3081927	.	G	A	12	4	16	0	0	16	0	0
19	3081933	.	G	A	0	4	4	0	12	16	0	0
19	3082053	.	T	C	8	3	11	0	0	11	0	0
19	3087180	.	C	A	1	1	2	0	0	2	0	0
19	3137727	.	C	T	0	32	32	0	24	56	0	0
19	3137761	.	C	A	19	29	48	0	0	49	1	0
19	3137803	.	A	T	20	25	45	0	5	50	0	0
19	3137888	.	T	C	24	1	25	0	24	49	0	0
19	3138166	.	G	T	21	7	28	0	0	29	1	0
19	3138325	.	A	C	27	14	41	0	1	42	0	0
19	3138355	.	T	G	25	16	41	0	3	44	0	0
19	3138638	.	T	C	14	0	14	0	12	27	1	0
19	3149296	.	A	C	3	8	11	0	0	11	0	0
19	3149320	.	T	G	5	9	14	0	0	14	0	0
19	3149368	.	A	T	6	7	13	0	1	14	0	0
19	3229424	.	A	G	2	1	3	0	0	3	0	0
19	3238395	.	T	A	15	20	35	0	2	37	0	0
19	3238425	.	T	C	20	15	35	0	0	35	0	0
19	3238721	.	T	A	31	27	58	0	1	59	0	0
19	3240409	.	G	C	24	26	50	0	1	51	0	0
19	3376893	.	G	C	2	0	2	0	4	6	0	0
19	3386258	.	T	A	9	12	21	0	0	21	0	0
19	3386358	.	A	G	3	9	12	0	2	14	0	0
19	3386485	.	C	A	8	9	17	0	1	18	0	0
19	3386580	.	T	A	9	4	13	0	2	15	0	0
19	3386873	.	C	T	7	16	23	0	3	26	0	0
19	3387040	.	C	A	2	10	12	0	15	27	0	0
19	3387068	.	A	C	15	14	29	0	1	30	0	0
19	3387097	.	C	G	15	18	33	0	1	34	0	0
19	3387506	.	G	A	19	16	35	0	1	36	0	0
19	3387713	.	G	A	14	29	43	0	1	44	0	0
19	3388376	.	T	C	14	20	34	0	2	36	0	0
19	3388467	.	T	C	17	16	33	0	1	34	0	0
19	3388617	.	G	A	16	20	36	0	0	36	0	0
19	3390203	.	G	A	14	13	27	0	1	28	0	0
19	3390283	.	G	T	1	5	6	0	1	7	0	0
19	3390506	.	C	G	0	8	8	0	0	8	0	0
19	3391479	.	G	A	5	8	13	0	0	13	0	0
19	3391530	.	G	T	7	5	12	0	0	12	0	0
19	3391608	.	T	A	10	6	16	0	0	16	0	0
19	3391669	.	A	G	11	5	16	0	0	16	0	0
19	3391805	.	T	G	11	11	22	0	0	22	0	0
19	3392127	.	G	A	4	8	12	0	0	12	0	0
19	3392178	.	C	T	2	5	7	1	0	8	0	0
19	3392415	.	G	T	7	11	18	0	1	19	0	0
19	3392481	.	A	G	5	8	13	0	1	14	0	0
19	3393128	.	A	T	8	8	16	0	1	17	0	0
19	3393343	.	G	C	10	6	16	0	2	18	0	0
19	3393437	.	T	A	5	5	10	0	2	12	0	0
19	3393924	.	G	A	7	8	15	0	0	15	0	0
19	3395435	.	C	T	4	4	8	0	1	9	0	0
19	3395457	.	T	A	4	5	9	0	0	9	0	0
19	3395523	.	G	A	1	4	5	0	0	5	0	0
19	3395763	.	T	A	5	5	10	0	0	10	0	0
19	3395889	.	A	G	3	5	8	0	1	9	0	0
19	3396103	.	A	G	1	6	7	0	0	7	0	0
19	3396288	.	T	C	3	3	6	0	1	7	0	0
19	3539605	.	G	A	2	2	4	0	1	5	0	0
19	3540218	.	G	A	3	2	5	0	0	5	0	0
19	3540240	.	T	C	3	3	6	0	0	6	0	0
19	3573912	.	A	T	2	4	6	0	1	7	0	0
19	3573971	.	A	G	1	4	5	0	0	5	0	0
19	3577907	.	C	A	3	1	4	0	0	4	0	0
19	3577953	.	A	C	3	3	6	0	0	6	0	0
19	3577994	.	A	G	2	2	4	0	0	4	0	0
19	3577997	.	A	G	2	2	4	0	0	4	0	0
19	3653989	.	C	T	3	2	5	0	0	5	0	0
19	3654052	.	T	A	2	2	4	0	0	4	0	0
19	3681134	.	C	T	2	4	6	0	0	6	0	0
19	3698249	.	C	G	4	1	5	0	0	5	0	0
19	3702314	.	A	G	1	2	3	0	1	4	0	0
19	3702316	.	C	T	2	2	4	0	0	4	0	0
19	3702402	.	A	G	1	2	3	0	0	3	0	0
19	3702476	.	A	T	1	1	2	0	0	2	0	0
19	3702675	.	G	A	4	4	8	0	0	8	0	0
19	3702941	.	G	A	0	8	8	0	3	11	0	0
19	3703149	.	A	G	3	3	6	0	2	8	0	0
19	3703178	.	C	T	4	5	9	0	0	9	0	0
19	3706875	.	C	T	2	2	4	0	1	5	0	0
19	3706902	.	C	G	4	1	5	0	1	6	0	0
19	3707235	.	A	G	8	7	15	0	1	16	0	0
19	3707562	.	T	A	3	2	5	0	0	5	0	0
19	3707576	.	C	T	3	2	5	0	0	5	0	0
19	3718110	.	A	T	9	12	21	0	1	22	0	0
19	3718222	.	G	A	13	17	30	0	0	30	0	0
19	3718251	.	C	A	10	17	27	0	1	29	1	0
19	3718330	.	G	A	18	12	30	0	1	31	0	0
19	3718415	.	G	T	18	24	42	0	2	44	0	0
19	3718675	.	C	A	12	22	34	0	0	34	0	0
19	3865928	.	C	T	0	10	10	0	7	17	0	0
19	3866029	.	C	T	6	15	21	0	0	21	0	0
19	3866031	.	G	A	6	15	21	0	0	21	0	0
19	3866075	.	T	C	16	10	26	0	0	26	0	0
19	3866102	.	A	G	16	13	29	0	0	29	0	0
19	3866165	.	T	C	10	7	17	0	6	23	0	0
19	3866179	.	T	C	12	0	12	0	7	19	0	0
19	3866289	.	C	G	9	4	13	0	0	13	0	0
19	3866424	.	A	T	14	10	24	0	0	24	0	0
19	3866727	.	C	T	0	10	10	0	15	25	0	0
19	3868535	.	T	C	6	11	17	0	0	17	0	0
19	3868541	.	C	T	1	11	12	0	7	19	0	0
19	3872386	.	G	A	0	1	1	0	0	1	0	0
19	3872419	.	C	T	4	4	8	0	0	8	0	0
19	3872833	.	C	T	8	7	15	0	0	15	0	0
19	3873019	.	C	T	2	12	14	0	0	14	0	0
19	3873055	.	C	T	2	4	6	0	0	6	0	0
19	3873847	.	A	C	10	11	21	0	1	22	0	0
19	3873955	.	G	A	5	9	14	0	1	15	0	0
19	3874195	.	A	G	11	7	18	0	1	19	0	0
19	3874277	.	C	A	7	7	14	0	0	14	0	0
19	3874339	.	G	A	7	7	14	0	1	15	0	0
19	3874381	.	G	A	7	7	14	0	2	16	0	0
19	3876296	.	C	T	2	4	6	0	0	6	0	0
19	3878548	.	C	T	9	4	13	0	0	13	0	0
19	3937971	.	T	C	25	25	50	0	4	54	0	0
19	3939887	.	C	T	19	15	34	0	1	35	0	0
19	3939902	.	G	T	26	17	43	0	1	44	0	0
19	3940022	.	C	T	0	19	19	0	23	42	0	0
19	3945750	.	G	T	13	4	17	0	2	19	0	0
19	4010175	.	C	A	9	10	19	0	0	19	0	0
19	4089843	.	A	C	10	0	10	0	5	15	0	0
19	4090131	.	G	T	2	2	4	0	0	4	0	0
19	4090149	.	A	G	1	2	3	0	0	3	0	0
19	4127217	.	G	A	3	3	6	0	0	6	0	0
19	4130082	.	C	T	1	2	3	0	0	3	0	0
19	4134782	.	A	G	2	3	5	0	0	5	0	0
19	4137043	.	G	A	0	4	4	0	1	5	0	0
19	4137044	.	A	G	0	4	4	0	1	5	0	0
19	4142777	.	G	A	1	4	5	0	0	5	0	0
19	4143053	.	A	T	0	3	3	0	0	3	0	0
19	4169933	.	T	G	1	3	4	0	1	5	0	0
19	4169939	.	C	T	2	3	5	0	0	5	0	0
19	4194072	.	T	C	1	5	6	0	0	6	0	0
19	4279835	.	A	C	7	7	14	0	0	14	0	0
19	4341539	.	T	C	5	5	10	0	0	10	0	0
19	4443334	.	T	C	3	4	7	0	2	9	0	0
19	4443403	.	T	C	9	8	17	0	0	17	0	0
19	4445154	.	T	C	4	6	10	0	0	10	0	0
19	4445222	.	A	T	4	3	7	0	0	7	0	0
19	4447502	.	T	A	5	5	10	0	0	10	0	0
19	4464121	.	G	A	3	4	7	0	0	7	0	0
19	4464173	.	C	T	2	3	5	0	0	5	0	0
19	4828379	.	T	G	1	4	5	0	0	5	0	0
19	4828395	.	T	C	2	3	5	0	0	5	0	0
19	4828428	.	A	T	3	6	9	0	0	9	0	0
19	4828463	.	A	G	9	2	11	0	0	11	0	0
19	4828464	.	A	T	8	2	10	0	1	11	0	0
19	4828696	.	G	A	0	1	1	0	0	1	0	0
19	4833274	.	A	G	0	0	0	0	1	1	0	0
19	4857547	.	G	A	5	3	8	0	0	8	0	0
19	4857910	.	A	G	9	8	17	0	0	17	0	0
19	4857967	.	T	C	8	7	15	0	0	15	0	0
19	4866919	.	T	C	16	13	29	0	0	29	0	0
19	4867128	.	C	T	9	15	24	0	3	27	0	0
19	4867132	.	G	A	0	7	7	0	20	27	0	0
19	4875595	.	A	G	4	1	5	0	0	5	0	0
19	4877141	.	T	C	9	2	11	0	0	11	0	0
19	4878742	.	G	T	6	9	15	0	0	15	0	0
19	4878751	.	C	T	8	5	13	0	1	14	0	0
19	4881345	.	G	T	0	2	2	0	0	2	0	0
19	4888756	.	G	A	0	7	7	0	15	22	0	0
19	4892154	.	G	A	5	1	6	0	1	7	0	0
19	4892530	.	G	T	0	7	7	0	13	20	0	0
19	4892590	.	C	T	2	4	6	0	0	6	0	0
19	4892946	.	A	T	4	7	11	0	6	17	0	0
19	4903907	.	C	T	7	7	14	0	0	14	0	0
19	4903971	.	A	T	10	25	35	0	0	35	0	0
19	4904041	.	C	T	12	6	18	0	3	21	0	0
19	4904042	.	A	T	6	14	20	0	1	21	0	0
19	4904247	.	T	A	2	5	7	0	0	7	0	0
19	4904407	.	T	C	0	6	6	0	0	6	0	0
19	4904429	.	G	A	3	4	7	0	0	7	0	0
19	4904503	.	C	T	1	7	8	0	0	8	0	0
19	4904529	.	T	A	2	5	7	0	2	9	0	0
19	4904569	.	T	C	3	5	8	0	1	9	0	0
19	4904665	.	A	C	1	2	3	0	0	3	0	0
19	4905088	.	G	T	7	7	14	0	0	14	0	0
19	4905239	.	C	T	5	4	9	0	0	9	0	0
19	4912841	.	G	A	2	0	2	0	0	2	0	0
19	4961950	.	A	T	12	11	23	0	0	23	0	0
19	4961977	.	A	T	11	9	20	0	1	21	0	0
19	4962019	.	C	T	2	6	8	0	0	8	0	0
19	4970776	.	C	T	4	2	6	0	0	6	0	0
19	4973136	.	G	A	0	5	5	0	3	8	0	0
19	4976906	.	C	T	2	4	6	0	0	6	0	0
19	4976925	.	C	G	2	3	5	0	0	5	0	0
19	4978660	.	G	T	1	1	2	0	0	2	0	0
19	4978716	.	A	G	1	1	2	0	0	2	0	0
19	4984668	.	T	G	3	3	6	0	1	7	0	0
19	4984739	.	G	A	8	3	11	0	0	11	0	0
19	4998579	.	C	A	1	3	4	0	0	4	0	0
19	4998654	.	G	A	0	2	2	0	1	3	0	0
19	5001119	.	C	T	0	5	5	0	4	9	0	0
19	5003359	.	T	G	1	7	8	0	0	8	0	0
19	5007465	.	G	A	6	6	12	0	0	12	0	0
19	5007549	.	G	A	9	18	27	0	1	28	0	0
19	5009353	.	G	A	3	4	7	0	1	8	0	0
19	5009489	.	G	A	3	2	5	0	2	7	0	0
19	5016257	.	G	C	5	2	7	0	3	10	0	0
19	5018307	.	A	G	6	7	13	0	0	13	0	0
19	5019697	.	G	C	8	7	15	0	0	15	0	0
19	5019712	.	A	T	5	5	10	0	0	10	0	0
19	5019736	.	A	G	1	3	4	0	0	4	0	0
19	5022301	.	C	T	6	10	16	0	2	18	0	0
19	5024424	.	G	A	2	2	4	0	0	4	0	0
19	5024436	.	C	T	5	4	9	0	0	9	0	0
19	5024541	.	C	T	0	3	3	0	0	3	0	0
19	5024685	.	T	C	2	1	3	0	0	3	0	0
19	5025813	.	T	C	3	1	4	0	3	7	0	0
19	5030032	.	T	C	6	5	11	0	0	11	0	0
19	5030214	.	G	T	3	1	4	0	0	4	0	0
19	5030274	.	G	A	3	3	6	0	1	7	0	0
19	5031455	.	A	C	6	1	7	0	0	7	0	0
19	5031461	.	G	A	1	6	7	0	0	7	0	0
19	5034965	.	G	A	9	4	13	0	0	14	1	0
19	5035253	.	G	A	4	5	9	0	0	9	0	0
19	5037382	.	T	C	7	0	7	0	6	13	0	0
19	5048954	.	T	A	3	4	7	0	0	7	0	0
19	5054876	.	C	T	0	1	1	0	0	1	0	0
19	5058188	.	C	T	0	2	2	0	8	10	0	0
19	5058763	.	G	A	5	3	8	0	1	9	0	0
19	5077167	.	A	G	12	11	23	0	0	23	0	0
19	5077173	.	C	T	11	11	22	0	1	23	0	0
19	5080112	.	A	C	3	1	4	0	0	4	0	0
19	5081758	.	T	C	12	17	29	0	0	29	0	0
19	5089900	.	C	G	35	3	38	0	30	68	0	0
19	5090035	.	C	G	31	24	55	0	1	56	0	0
19	5091587	.	G	C	21	31	52	0	3	55	0	0
19	5091688	.	T	C	3	2	5	0	0	5	0	0
19	5094288	.	G	T	0	4	4	0	2	6	0	0
19	5094389	.	C	T	8	5	13	0	0	13	0	0
19	5094405	.	C	A	0	10	10	0	5	15	0	0
19	5094471	.	T	C	10	12	22	0	1	23	0	0
19	5094504	.	A	G	9	19	28	0	0	28	0	0
19	5094591	.	C	T	13	9	22	0	0	22	0	0
19	5094616	.	C	T	1	13	14	0	16	30	0	0
19	5100191	.	G	A	19	11	30	0	2	32	0	0
19	5135247	.	T	G	6	12	18	0	0	18	0	0
19	5135258	.	C	G	5	11	16	0	0	16	0	0
19	5144107	.	C	T	2	3	5	0	0	5	0	0
19	5146708	.	C	T	9	15	24	0	0	24	0	0
19	5149867	.	C	T	9	10	19	0	0	19	0	0
19	5158443	.	A	T	4	3	7	0	0	7	0	0
19	5158572	.	G	A	27	27	54	0	3	57	0	0
19	5158657	.	G	A	38	41	79	0	0	79	0	0
19	5158795	.	A	G	32	32	64	0	6	70	0	0
19	5159120	.	C	T	38	33	71	0	6	77	0	0
19	5159399	.	T	A	33	26	59	0	4	63	0	0
19	5160048	.	C	G	30	30	60	0	6	66	0	0
19	5160121	.	T	C	23	1	24	0	29	53	0	0
19	5160133	.	C	A	0	32	32	0	25	57	0	0
19	5160201	.	A	G	26	28	54	0	3	57	0	0
19	5160302	.	T	C	26	2	28	0	16	44	0	0
19	5160310	.	C	T	3	19	22	0	25	47	0	0
19	5160379	.	T	A	33	20	53	0	2	55	0	0
19	5160996	.	A	T	23	21	44	0	2	46	0	0
19	5161556	.	A	G	14	9	23	0	22	45	0	0
19	5161750	.	A	G	29	24	53	0	1	54	0	0
19	5162521	.	G	A	19	28	47	0	0	47	0	0
19	5162679	.	A	G	23	22	45	0	0	45	0	0
19	5163409	.	G	A	24	32	56	0	0	56	0	0
19	5163910	.	T	C	35	26	61	0	1	62	0	0
19	5300120	.	T	C	5	6	11	0	0	11	0	0
19	5302286	.	A	G	1	1	2	0	1	3	0	0
19	5305025	.	C	T	2	3	5	0	0	5	0	0
19	5305193	.	T	C	6	4	10	0	2	12	0	0
19	5305418	.	A	G	10	8	18	0	1	19	0	0
19	5305530	.	A	G	4	5	9	0	0	9	0	0
19	5305681	.	A	G	2	0	2	0	3	5	0	0
19	5316439	.	T	C	5	7	12	0	0	12	0	0
19	5378808	.	T	A	1	2	3	0	1	4	0	0
19	5611772	.	G	A	24	17	41	0	2	43	0	0
19	5611856	.	A	T	17	23	40	0	0	40	0	0
19	5615654	.	T	C	9	8	17	0	3	20	0	0
19	5619892	.	G	A	13	10	23	0	0	23	0	0
19	5619926	.	G	A	1	10	11	0	8	19	0	0
19	5620094	.	A	T	10	9	19	0	2	21	0	0
19	5620175	.	T	G	5	11	16	0	1	17	0	0
19	5620208	.	G	T	6	9	15	0	0	15	0	0
19	5620370	.	T	C	16	14	30	0	1	31	0	0
19	5620419	.	G	A	19	19	38	0	2	40	0	0
19	5620459	.	T	C	13	25	38	0	1	39	0	0
19	5621165	.	G	A	10	11	21	0	1	22	0	0
19	5621269	.	C	T	1	3	4	0	1	5	0	0
19	5779151	.	A	G	5	2	7	0	0	7	0	0
19	5779170	.	C	T	7	4	11	0	1	12	0	0
19	5779271	.	A	G	4	5	9	0	0	9	0	0
19	5779829	.	G	T	11	13	24	0	0	24	0	0
19	5779835	.	C	T	11	13	24	0	0	24	0	0
19	5779897	.	T	C	13	15	28	0	0	28	0	0
19	5780032	.	C	G	0	2	2	0	8	10	0	0
19	5780293	.	A	T	12	8	20	0	0	20	0	0
19	5780312	.	A	T	10	12	22	0	0	22	0	0
19	5780462	.	A	T	0	2	2	0	1	3	0	0
19	5780506	.	T	A	2	3	5	0	1	6	0	0
19	5780585	.	G	T	6	5	11	0	1	12	0	0
19	5780688	.	A	C	7	12	19	0	0	19	0	0
19	5780989	.	G	A	10	7	17	0	0	17	0	0
19	5781259	.	A	T	6	9	15	0	0	15	0	0
19	5781316	.	G	T	6	7	13	0	1	14	0	0
19	5781367	.	T	C	6	7	13	0	1	14	0	0
19	5793484	.	C	G	5	2	7	0	0	7	0	0
19	5793532	.	T	C	4	5	9	0	0	9	0	0
19	5801151	.	G	A	4	4	8	0	0	8	0	0
19	5805833	.	G	A	3	4	7	0	1	8	0	0
19	5805839	.	G	A	4	4	8	0	0	8	0	0
19	5849563	.	T	G	0	0	0	0	3	3	0	0
19	6060281	.	T	A	9	11	20	0	1	21	0	0
19	6060309	.	A	T	14	11	25	0	2	27	0	0
19	6060415	.	C	A	0	8	8	0	8	16	0	0
19	6076813	.	C	A	5	6	11	0	0	11	0	0
19	6083524	.	G	A	4	8	12	0	0	12	0	0
19	6085957	.	A	T	11	3	14	0	2	16	0	0
19	6086441	.	C	G	7	15	22	0	1	23	0	0
19	6086577	.	C	T	0	13	13	0	13	26	0	0
19	6087130	.	T	A	5	8	13	0	2	15	0	0
19	6087146	.	C	T	0	12	12	0	7	19	0	0
19	6087186	.	A	T	7	10	17	0	0	17	0	0
19	6087619	.	T	C	6	0	6	0	10	16	0	0
19	6087894	.	G	A	4	12	16	0	1	17	0	0
19	6087948	.	A	T	8	4	12	0	0	12	0	0
19	6088000	.	C	T	0	10	10	0	15	25	0	0
19	6088166	.	T	C	7	10	17	0	0	17	0	0
19	6088259	.	A	C	10	15	25	0	1	26	0	0
19	6088368	.	A	G	12	18	30	0	2	32	0	0
19	6090702	.	T	C	5	1	6	0	1	7	0	0
19	6090732	.	T	A	2	0	2	0	0	2	0	0
19	6094162	.	A	C	7	6	13	0	1	14	0	0
19	6097473	.	C	A	4	5	9	0	0	9	0	0
19	6100295	.	A	G	14	12	26	0	0	26	0	0
19	6102594	.	A	T	4	2	6	0	1	7	0	0
19	6102732	.	T	C	0	3	3	0	0	3	0	0
19	6105528	.	A	T	4	1	5	0	0	5	0	0
19	6111085	.	G	A	6	6	12	0	0	12	0	0
19	6111214	.	A	G	11	11	22	0	3	25	0	0
19	6111223	.	A	G	12	12	24	0	0	24	0	0
19	6111268	.	G	A	14	10	24	0	1	25	0	0
19	6111544	.	A	G	9	6	15	0	1	16	0	0
19	6111724	.	T	C	4	7	11	0	0	11	0	0
19	6111793	.	G	A	2	1	3	0	0	3	0	0
19	6116477	.	A	G	3	6	9	0	0	9	0	0
19	6116638	.	A	G	1	1	2	0	0	2	0	0
19	6122614	.	A	G	5	2	7	0	0	7	0	0
19	6125329	.	G	T	5	3	8	0	0	8	0	0
19	6125350	.	A	G	5	5	10	0	0	10	0	0
19	6125425	.	A	T	2	8	10	0	0	10	0	0
19	6125656	.	G	C	8	9	17	0	0	17	0	0
19	6125926	.	G	A	4	8	12	0	2	14	0	0
19	6125941	.	C	T	5	10	15	0	1	16	0	0
19	6126001	.	G	A	3	7	10	0	3	13	0	0
19	6126046	.	A	T	1	2	3	0	8	11	0	0
19	6126277	.	G	A	3	5	8	0	0	8	0	0
19	6126403	.	C	G	3	5	8	0	0	8	0	0
19	6126544	.	A	G	4	2	6	0	1	7	0	0
19	6126625	.	G	A	4	5	9	0	1	10	0	0
19	6126645	.	T	C	3	3	6	0	1	7	0	0
19	6127108	.	C	A	3	4	7	0	1	8	0	0
19	6127669	.	C	A	3	3	6	0	0	6	0	0
19	6127696	.	T	C	3	2	5	0	1	6	0	0
19	6127764	.	A	G	2	2	4	0	0	4	0	0
19	6127768	.	A	G	1	3	4	0	0	4	0	0
19	6127847	.	G	T	2	2	4	0	0	4	0	0
19	6128416	.	G	A	7	5	12	0	0	12	0	0
19	6142187	.	C	A	0	2	2	0	5	7	0	0
19	6142669	.	T	A	8	9	17	0	1	18	0	0
19	6142714	.	A	T	6	9	15	0	1	16	0	0
19	6142802	.	G	T	4	4	8	0	0	8	0	0
19	6142803	.	A	G	4	4	8	0	0	8	0	0
19	6143608	.	C	T	0	8	8	0	4	12	0	0
19	6143825	.	C	T	4	2	6	0	0	6	0	0
19	6143919	.	T	C	5	3	8	0	0	8	0	0
19	6144267	.	C	A	6	4	10	0	0	10	0	0
19	6144659	.	G	A	5	3	8	0	0	8	0	0
19	6144722	.	C	T	4	4	8	0	0	8	0	0
19	6145736	.	G	A	1	7	8	0	0	8	0	0
19	6145964	.	A	G	1	4	5	0	0	5	0	0
19	6193005	.	C	G	3	1	4	0	0	4	0	0
19	6214598	.	G	A	1	3	4	0	0	4	0	0
19	6214884	.	T	A	3	5	8	0	0	8	0	0
19	6217132	.	T	A	4	2	6	0	0	6	0	0
19	6217667	.	A	G	5	3	8	0	0	8	0	0
19	6232242	.	T	C	0	0	0	0	1	1	0	0
19	6233690	.	C	A	0	3	3	0	1	4	0	0
19	6328442	.	T	C	39	5	44	0	39	83	0	0
19	6328514	.	A	C	35	26	61	0	2	63	0	0
19	6328533	.	A	G	40	25	65	0	3	68	0	0
19	6328830	.	T	G	34	37	71	0	8	79	0	0
19	6328859	.	G	A	30	30	60	0	4	66	2	0
19	6328889	.	C	T	2	38	40	0	29	69	0	0
19	6328906	.	G	A	28	39	67	0	1	68	0	0
19	6328963	.	T	C	38	28	66	0	3	69	0	0
19	6329062	.	A	T	41	25	66	0	0	66	0	0
19	6329381	.	A	T	33	22	55	0	0	55	0	0
19	6329382	.	T	G	31	21	52	0	3	55	0	0
19	6329533	.	C	T	4	33	37	0	32	69	0	0
19	6329813	.	G	A	31	39	70	0	1	71	0	0
19	6330194	.	A	C	43	1	44	0	23	67	0	0
19	6330239	.	C	A	0	4	4	0	14	18	0	0
19	6332767	.	A	C	13	3	16	0	12	28	0	0
19	6332902	.	C	A	0	7	7	0	10	17	0	0
19	6332947	.	C	T	1	15	16	0	13	29	0	0
19	6332973	.	G	A	3	9	12	0	0	12	0	0
19	6338207	.	A	G	9	7	16	0	1	17	0	0
19	6338261	.	A	G	23	24	47	0	1	48	0	0
19	6342278	.	G	T	21	20	41	0	2	43	0	0
19	6344522	.	G	C	31	1	32	0	31	63	0	0
19	6346506	.	C	G	27	25	52	0	0	53	1	0
19	6346587	.	C	T	1	25	26	0	26	52	0	0
19	6347662	.	C	T	14	20	34	0	2	36	0	0
19	6352379	.	A	G	19	8	27	0	1	28	0	0
19	6352448	.	G	A	23	12	35	0	4	39	0	0
19	6352511	.	G	A	20	26	46	0	2	48	0	0
19	6358232	.	A	G	8	9	17	0	0	17	0	0
19	6606673	.	T	A	4	8	12	0	0	12	0	0
19	6606725	.	T	C	6	7	13	0	1	14	0	0
19	6606764	.	A	T	2	2	4	0	0	4	0	0
19	6869051	.	T	C	1	2	3	0	0	3	0	0
19	6871741	.	C	T	2	0	2	0	0	2	0	0
19	6872539	.	T	C	4	6	10	0	0	10	0	0
19	6872595	.	C	T	1	6	7	0	0	7	0	0
19	6893008	.	A	G	2	2	4	0	0	4	0	0
19	6900560	.	G	A	1	2	3	0	0	3	0	0
19	6900561	.	G	A	1	2	3	0	0	3	0	0
19	6900897	.	G	A	1	2	3	0	0	3	0	0
19	6900903	.	T	C	1	2	3	0	0	3	0	0
19	6901116	.	A	T	3	4	7	0	0	7	0	0
19	6906995	.	A	T	1	2	3	0	0	3	0	0
19	6907006	.	A	G	1	2	3	0	1	4	0	0
19	6907740	.	T	C	1	2	3	0	0	3	0	0
19	6907785	.	G	A	2	5	7	0	1	8	0	0
19	6907848	.	G	A	2	6	8	0	0	8	0	0
19	6907857	.	C	T	2	7	9	0	0	9	0	0
19	6908650	.	T	C	1	3	4	0	0	4	0	0
19	6908651	.	T	C	1	3	4	0	0	4	0	0
19	6910409	.	A	G	2	5	7	0	1	8	0	0
19	6914145	.	G	A	1	2	3	0	0	3	0	0
19	6914280	.	A	T	2	2	4	0	1	5	0	0
19	6914319	.	T	A	5	3	8	0	0	8	0	0
19	6914370	.	A	C	1	2	3	0	0	3	0	0
19	6914415	.	T	C	5	2	7	2	0	9	0	0
19	6915030	.	T	C	3	3	6	0	0	6	0	0
19	6915114	.	C	T	3	1	4	0	0	4	0	0
19	6915234	.	G	A	1	2	3	0	0	3	0	0
19	6915869	.	A	C	1	3	4	0	0	4	0	0
19	6915921	.	C	T	2	2	4	0	0	4	0	0
19	6915922	.	G	T	0	2	2	0	2	4	0	0
19	6923116	.	G	A	2	2	4	0	0	4	0	0
19	6923549	.	T	C	1	2	3	0	0	3	0	0
19	6923556	.	C	A	1	2	3	0	0	3	0	0
19	6928402	.	C	T	1	2	3	0	0	3	0	0
19	6938364	.	A	T	4	8	12	0	0	12	0	0
19	6938377	.	A	T	4	7	11	0	0	11	0	0
19	6940213	.	C	T	0	1	1	0	0	1	0	0
19	6949256	.	G	A	2	18	20	0	18	38	0	0
19	6949316	.	C	A	13	7	20	0	1	21	0	0
19	6952600	.	T	C	18	17	35	0	2	37	0	0
19	6955061	.	C	T	16	18	34	0	4	38	0	0
19	6955130	.	C	T	17	7	24	0	1	25	0	0
19	6955131	.	C	T	16	8	24	0	1	25	0	0
19	6955198	.	C	A	16	18	34	0	2	36	0	0
19	6955411	.	C	T	9	4	13	0	0	13	0	0
19	6955475	.	T	C	7	7	14	0	0	14	0	0
19	6955609	.	C	G	13	14	27	0	0	27	0	0
19	6955620	.	G	A	0	8	8	0	15	23	0	0
19	6955920	.	G	A	7	15	22	0	2	24	0	0
19	6956135	.	A	G	24	8	32	0	1	33	0	0
19	6956259	.	C	A	3	1	4	0	1	5	0	0
19	6956553	.	A	C	5	2	7	0	0	7	0	0
19	6956555	.	A	T	5	2	7	0	0	7	0	0
19	6956665	.	C	A	14	12	26	0	0	26	0	0
19	6956728	.	T	A	19	11	30	0	1	31	0	0
19	6956829	.	T	A	18	3	21	0	2	23	0	0
19	6956835	.	C	G	16	5	21	0	0	21	0	0
19	6956881	.	T	C	13	7	20	0	0	20	0	0
19	6956892	.	T	A	7	11	18	0	1	19	0	0
19	6957127	.	A	T	30	13	43	0	1	44	0	0
19	6957131	.	C	A	26	13	39	0	5	44	0	0
19	6960653	.	C	A	8	4	12	0	1	13	0	0
19	6961211	.	T	C	1	2	3	0	0	3	0	0
19	6961421	.	T	A	8	5	13	0	0	13	0	0
19	6961610	.	G	A	6	4	10	0	0	10	0	0
19	6961674	.	A	G	7	3	10	0	2	12	0	0
19	6963020	.	C	T	4	4	8	0	0	8	0	0
19	6963863	.	C	A	4	4	8	0	0	8	0	0
19	6963996	.	G	A	4	5	9	0	0	9	0	0
19	6964041	.	A	G	9	3	12	0	0	12	0	0
19	6964273	.	C	A	4	5	9	0	0	9	0	0
19	6964364	.	C	T	7	7	14	0	0	14	0	0
19	6964381	.	T	C	6	8	14	0	1	15	0	0
19	6964417	.	A	G	6	5	11	0	0	11	0	0
19	6964636	.	C	T	3	2	5	0	0	5	0	0
19	6964641	.	T	C	3	0	3	0	2	5	0	0
19	6964866	.	C	T	1	3	4	0	0	4	0	0
19	6965315	.	G	T	1	2	3	0	0	3	0	0
19	6965319	.	A	C	1	2	3	0	0	3	0	0
19	6965420	.	A	T	2	2	4	0	0	4	0	0
19	6965767	.	G	A	3	2	5	0	0	5	0	0
19	6965894	.	C	A	0	4	4	0	3	7	0	0
19	6965897	.	C	T	2	4	6	0	1	7	0	0
19	6966003	.	C	A	6	4	10	0	0	10	0	0
19	6966022	.	A	G	6	3	9	0	1	10	0	0
19	6966208	.	G	A	4	5	9	0	0	9	0	0
19	6966781	.	A	T	8	5	13	0	1	14	0	0
19	6980493	.	C	T	2	3	5	0	0	5	0	0
19	6988778	.	T	C	5	2	7	0	2	9	0	0
19	6994666	.	G	A	0	2	2	0	1	3	0	0
19	6995874	.	G	T	0	2	2	0	0	2	0	0
19	6996072	.	T	A	1	1	2	0	0	2	0	0
19	6996114	.	C	A	1	3	4	0	0	4	0	0
19	6996131	.	A	G	1	3	4	0	0	4	0	0
19	7004841	.	G	A	0	2	2	0	0	2	0	0
19	7004865	.	C	T	1	2	3	0	0	3	0	0
19	7004886	.	A	T	2	2	4	0	1	5	0	0
19	7005030	.	C	T	3	4	7	0	0	7	0	0
19	7005032	.	G	C	3	4	7	0	0	7	0	0
19	7005198	.	A	G	1	2	3	0	0	3	0	0
19	7005282	.	T	C	1	4	5	0	0	5	0	0
19	7005462	.	G	A	0	6	6	0	2	8	0	0
19	7005630	.	C	T	2	3	5	0	0	5	0	0
19	7005881	.	C	T	3	2	5	0	0	5	0	0
19	7006215	.	C	T	3	6	9	0	0	9	0	0
19	7006682	.	G	A	2	3	5	0	0	5	0	0
19	7006709	.	G	T	0	5	5	0	4	9	0	0
19	7006826	.	C	A	3	3	6	0	0	6	0	0
19	7006837	.	A	C	1	2	3	0	0	3	0	0
19	7014570	.	C	A	1	5	6	0	0	6	0	0
19	7014743	.	G	A	2	4	6	0	0	6	0	0
19	7014778	.	T	A	5	3	8	0	2	10	0	0
19	7014815	.	C	T	5	4	9	0	1	10	0	0
19	7014863	.	T	G	1	3	4	0	1	5	0	0
19	7014948	.	T	C	3	0	3	0	2	5	0	0
19	7014957	.	C	T	0	1	1	0	3	4	0	0
19	7015111	.	A	G	0	2	2	0	0	2	0	0
19	7018202	.	G	A	1	2	3	0	0	3	0	0
19	7022107	.	G	A	5	2	7	0	1	8	0	0
19	7022128	.	G	A	4	2	6	0	1	7	0	0
19	7024591	.	T	G	5	5	10	0	0	10	0	0
19	7024593	.	C	T	5	1	6	0	4	10	0	0
19	7024627	.	T	C	3	4	7	0	0	7	0	0
19	7027127	.	G	C	1	2	3	0	0	3	0	0
19	7027810	.	A	T	1	3	4	0	0	4	0	0
19	7027927	.	G	A	4	2	6	0	0	6	0	0
19	7029915	.	A	G	3	0	3	0	1	4	0	0
19	7038803	.	C	A	1	2	3	0	1	4	0	0
19	7038901	.	A	C	2	4	6	0	1	7	0	0
19	7039308	.	G	A	0	2	2	0	0	2	0	0
19	7039335	.	T	C	0	0	0	0	1	1	0	0
19	7039344	.	G	A	0	1	1	0	0	1	0	0
19	7040158	.	A	G	1	2	3	0	0	3	0	0
19	7048507	.	T	A	1	6	7	0	0	7	0	0
19	7100810	.	A	T	2	2	4	0	0	4	0	0
19	7128225	.	T	C	1	3	4	0	0	4	0	0
19	7128538	.	T	C	3	2	5	0	0	5	0	0
19	7128540	.	G	C	3	2	5	0	0	5	0	0
19	7128598	.	T	C	0	3	3	0	0	3	0	0
19	7128605	.	G	T	0	2	2	0	0	2	0	0
19	7152971	.	G	T	0	12	12	0	5	17	0	0
19	7152974	.	G	A	5	11	16	0	1	18	1	0
19	7154729	.	A	G	12	20	32	0	2	34	0	0
19	7154770	.	A	C	14	18	32	0	0	32	0	0
19	7155001	.	A	T	11	14	25	0	0	25	0	0
19	7155034	.	A	G	13	11	24	0	1	25	0	0
19	7155065	.	T	C	15	13	28	0	0	28	0	0
19	7158469	.	C	T	7	10	17	0	0	17	0	0
19	7158546	.	A	G	4	1	5	0	3	8	0	0
19	7159062	.	G	A	0	4	4	0	3	7	0	0
19	7159107	.	T	C	7	6	13	0	0	13	0	0
19	7160991	.	G	C	2	3	5	0	0	5	0	0
19	7161452	.	G	A	1	1	2	0	0	2	0	0
19	7161527	.	A	G	3	0	3	0	4	7	0	0
19	7161539	.	G	T	3	1	4	0	1	5	0	0
19	7163872	.	C	T	7	9	16	0	0	16	0	0
19	7163908	.	A	G	8	13	21	0	0	21	0	0
19	7164022	.	G	A	5	7	12	0	0	12	0	0
19	7166211	.	C	T	7	11	18	0	2	20	0	0
19	7166454	.	C	A	2	1	3	0	0	3	0	0
19	7169204	.	A	C	8	6	14	0	2	16	0	0
19	7169228	.	C	T	13	9	22	0	4	26	0	0
19	7169587	.	A	G	6	2	8	0	1	9	0	0
19	7169588	.	G	A	7	2	9	0	0	9	0	0
19	7169770	.	A	C	8	6	14	0	1	15	0	0
19	7169809	.	C	T	8	6	14	0	0	14	0	0
19	7169880	.	T	C	9	4	13	0	0	13	0	0
19	7169886	.	G	A	8	4	12	0	0	12	0	0
19	7169929	.	G	A	7	4	11	0	2	13	0	0
19	7170014	.	A	C	7	5	12	0	0	12	0	0
19	7170015	.	T	C	7	5	12	0	0	12	0	0
19	7170128	.	A	G	6	10	16	0	0	16	0	0
19	7170191	.	A	C	2	8	10	0	0	10	0	0
19	7170228	.	A	T	6	6	12	0	0	12	0	0
19	7174417	.	C	A	1	2	3	0	0	3	0	0
19	7174693	.	A	G	4	3	7	0	2	9	0	0
19	7249800	.	A	G	15	12	27	0	0	27	0	0
19	7249811	.	T	C	15	11	26	0	1	27	0	0
19	7250372	.	T	C	3	3	6	0	0	6	0	0
19	7258085	.	A	G	7	6	13	0	0	13	0	0
19	7258118	.	C	T	5	7	12	0	0	12	0	0
19	7265377	.	T	C	2	2	4	0	0	4	0	0
19	7270102	.	G	A	5	8	13	0	0	13	0	0
19	7270156	.	C	A	0	6	6	0	3	9	0	0
19	7272224	.	C	A	1	2	3	0	0	3	0	0
19	7272935	.	G	A	8	4	12	0	1	13	0	0
19	7276106	.	G	A	14	9	23	0	1	24	0	0
19	7276149	.	A	G	22	21	43	0	0	43	0	0
19	7276194	.	T	A	28	25	53	0	1	54	0	0
19	7276559	.	G	A	32	32	64	0	4	68	0	0
19	7276610	.	G	A	18	32	50	0	7	57	0	0
19	7279235	.	A	G	15	14	29	0	0	29	0	0
19	7279721	.	A	G	8	3	11	0	1	12	0	0
19	7282541	.	C	T	11	9	20	0	0	20	0	0
19	7282554	.	G	A	16	16	32	0	0	32	0	0
19	7283427	.	C	A	20	19	39	0	1	40	0	0
19	7283499	.	A	G	10	21	31	0	3	34	0	0
19	7284840	.	C	T	1	16	17	0	18	35	0	0
19	7286301	.	A	G	7	8	15	0	1	16	0	0
19	7286355	.	A	G	23	23	46	0	0	46	0	0
19	7286421	.	T	A	9	12	21	0	0	21	0	0
19	7286742	.	A	G	11	8	19	0	1	20	0	0
19	7287600	.	T	C	21	29	50	0	1	51	0	0
19	7287603	.	G	A	21	28	49	0	1	50	0	0
19	7288195	.	A	G	14	2	16	0	1	17	0	0
19	7290175	.	A	G	3	1	4	0	0	4	0	0
19	7290214	.	A	G	16	18	34	0	3	37	0	0
19	7291642	.	A	T	2	1	3	0	0	3	0	0
19	7292621	.	G	A	1	3	4	0	0	4	0	0
19	7292636	.	A	T	1	3	4	0	0	4	0	0
19	7293138	.	A	G	2	4	6	0	0	6	0	0
19	7295279	.	G	A	5	6	11	0	0	11	0	0
19	7295572	.	G	C	2	6	8	0	0	8	0	0
19	7309154	.	G	A	13	8	21	0	0	21	0	0
19	7309391	.	C	A	19	18	37	0	1	38	0	0
19	7309522	.	G	C	23	12	35	0	1	36	0	0
19	7309556	.	T	A	16	11	27	0	0	27	0	0
19	7309557	.	T	A	16	11	27	0	0	27	0	0
19	7309754	.	T	G	9	17	26	0	2	28	0	0
19	7309929	.	A	T	20	12	32	0	2	34	0	0
19	7309968	.	G	T	15	16	31	0	0	31	0	0
19	7310117	.	T	C	18	0	18	0	14	32	0	0
19	7310131	.	C	T	16	12	28	0	3	31	0	0
19	7310154	.	A	T	15	13	28	0	2	30	0	0
19	7310974	.	T	G	0	1	1	0	0	1	0	0
19	7311678	.	T	G	3	3	6	0	0	6	0	0
19	7313933	.	C	G	12	10	22	0	1	23	0	0
19	7327462	.	A	G	12	8	20	0	0	20	0	0
19	7327519	.	C	T	9	11	20	0	0	20	0	0
19	7327564	.	G	T	3	4	7	0	0	7	0	0
19	7327570	.	T	C	1	2	3	0	0	3	0	0
19	7338033	.	C	T	0	13	13	0	22	35	0	0
19	7338125	.	C	T	10	10	20	0	4	24	0	0
19	7338150	.	G	A	9	7	16	0	1	17	0	0
19	7338218	.	A	T	11	5	16	0	0	16	0	0
19	7338309	.	C	T	0	13	13	0	7	20	0	0
19	7338402	.	C	T	0	9	9	0	13	22	0	0
19	7338425	.	T	C	6	7	13	0	1	14	0	0
19	7338444	.	T	C	9	0	9	0	7	16	0	0
19	7338969	.	C	T	9	10	19	0	2	21	0	0
19	7338978	.	T	C	11	0	11	0	11	22	0	0
19	7339008	.	T	G	6	10	16	0	1	17	0	0
19	7341300	.	G	A	13	8	21	0	4	25	0	0
19	7341385	.	A	G	2	0	2	0	0	2	0	0
19	7358131	.	A	G	6	4	10	0	0	10	0	0
19	7379601	.	C	T	6	8	14	0	0	14	0	0
19	7379637	.	T	C	5	0	5	0	10	15	0	0
19	7406810	.	G	T	3	1	4	0	0	4	0	0
19	7408360	.	T	G	7	7	14	0	0	14	0	0
19	7409904	.	C	T	2	2	4	0	0	4	0	0
19	7412062	.	T	C	2	0	2	0	0	2	0	0
19	7412320	.	C	T	6	9	15	0	0	15	0	0
19	7412358	.	A	T	3	10	13	0	0	13	0	0
19	7412490	.	T	C	2	7	9	0	0	9	0	0
19	7412586	.	T	C	2	3	5	0	0	5	0	0
19	7424794	.	G	A	4	1	5	0	0	5	0	0
19	7426637	.	C	T	7	6	13	0	0	13	0	0
19	7426814	.	C	T	13	8	21	0	1	22	0	0
19	7426832	.	G	A	11	7	18	0	2	20	0	0
19	7426967	.	T	C	10	11	21	0	0	21	0	0
19	7427099	.	C	A	4	1	5	0	0	5	0	0
19	7430160	.	T	C	12	13	25	0	2	27	0	0
19	7430607	.	G	A	0	12	12	0	13	25	0	0
19	7430652	.	C	T	10	9	19	0	0	19	0	0
19	7433068	.	T	A	3	2	5	0	1	6	0	0
19	7433149	.	A	T	4	4	8	0	0	8	0	0
19	7433637	.	C	A	1	2	3	0	1	4	0	0
19	7434139	.	T	C	1	4	5	0	0	5	0	0
19	7434161	.	G	T	3	2	5	0	2	7	0	0
19	7434252	.	T	C	2	2	4	0	0	4	0	0
19	7434555	.	C	T	4	4	8	0	0	8	0	0
19	7434611	.	G	C	10	5	15	0	0	15	0	0
19	7434731	.	G	C	5	2	7	0	3	10	0	0
19	7434753	.	A	G	8	3	11	0	0	11	0	0
19	7434813	.	G	A	1	3	4	0	0	4	0	0
19	7435535	.	C	A	5	4	9	0	0	9	0	0
19	7435605	.	T	C	2	1	3	0	0	3	0	0
19	7437053	.	A	G	1	2	3	0	0	3	0	0
19	7439799	.	C	T	1	0	1	0	0	1	0	0
19	7441832	.	T	A	3	3	6	0	0	6	0	0
19	7445676	.	G	A	5	4	9	0	0	9	0	0
19	7445897	.	C	T	19	33	52	0	1	53	0	0
19	7446050	.	T	C	25	30	55	0	2	57	0	0
19	7446137	.	G	T	18	30	48	0	2	50	0	0
19	7446286	.	G	T	31	22	53	0	1	54	0	0
19	7446495	.	G	T	29	33	62	0	3	65	0	0
19	7446621	.	C	A	36	27	63	0	2	65	0	0
19	7446702	.	T	C	2	3	5	0	0	5	0	0
19	7450572	.	G	A	15	24	39	0	1	40	0	0
19	7450658	.	T	C	16	17	33	0	0	33	0	0
19	7450750	.	A	G	16	6	22	0	0	22	0	0
19	7450783	.	C	T	0	4	4	0	9	13	0	0
19	7454109	.	A	C	6	4	10	0	1	11	0	0
19	7456364	.	T	C	3	11	14	0	0	14	0	0
19	7456371	.	A	C	3	10	13	0	1	14	0	0
19	7456722	.	C	G	2	7	9	0	1	10	0	0
19	7456793	.	A	G	2	9	11	0	0	11	0	0
19	7456816	.	C	G	2	9	11	0	1	12	0	0
19	7468556	.	G	T	2	4	6	0	1	7	0	0
19	7468580	.	C	T	1	5	6	0	2	8	0	0
19	7468746	.	T	A	0	1	1	0	0	1	0	0
19	7474242	.	T	C	7	7	14	0	1	15	0	0
19	7474245	.	T	G	7	0	7	0	8	15	0	0
19	7478159	.	A	G	9	13	22	0	1	23	0	0
19	7478283	.	C	T	5	7	12	0	0	12	0	0
19	7478356	.	G	A	3	9	12	0	0	12	0	0
19	7482931	.	C	T	6	2	8	0	0	8	0	0
19	7482993	.	G	A	2	5	7	0	0	7	0	0
19	7483059	.	A	T	4	2	6	0	1	7	0	0
19	7483469	.	T	G	3	6	9	0	0	9	0	0
19	7483667	.	G	A	2	3	5	0	1	6	0	0
19	7484313	.	T	A	2	4	6	0	0	6	0	0
19	7484354	.	A	T	2	5	7	0	0	7	0	0
19	7484357	.	G	A	2	5	7	0	0	7	0	0
19	7484536	.	G	T	3	2	5	0	1	6	0	0
19	7484559	.	C	G	3	2	5	0	0	5	0	0
19	7484668	.	A	T	1	2	3	0	0	3	0	0
19	7484834	.	A	G	1	2	3	0	0	3	0	0
19	7484856	.	C	G	0	3	3	0	3	6	0	0
19	7484990	.	G	T	4	2	6	0	0	6	0	0
19	7485117	.	C	T	4	4	8	0	0	8	0	0
19	7485457	.	C	T	1	2	3	0	0	3	0	0
19	7485503	.	G	A	4	4	8	0	0	8	0	0
19	7485528	.	T	C	4	0	4	0	4	8	0	0
19	7485839	.	G	T	2	3	5	0	0	5	0	0
19	7486353	.	G	A	2	2	4	0	1	5	0	0
19	7486791	.	T	C	4	4	8	0	0	8	0	0
19	7487096	.	G	A	3	4	7	0	0	7	0	0
19	7487103	.	G	A	1	4	5	0	0	5	0	0
19	7487321	.	C	T	2	2	4	0	1	5	0	0
19	7487592	.	T	A	3	6	9	0	0	9	0	0
19	7490873	.	T	A	3	2	5	0	0	5	0	0
19	7495867	.	A	T	3	6	9	0	0	9	0	0
19	7498046	.	T	C	10	9	19	0	1	20	0	0
19	7498079	.	A	G	7	13	20	0	3	23	0	0
19	7498103	.	A	G	7	14	21	0	0	21	0	0
19	7505591	.	A	G	7	4	11	0	1	12	0	0
19	7505907	.	A	G	4	0	4	0	3	7	0	0
19	7506036	.	A	G	4	0	4	0	7	11	0	0
19	7507833	.	A	T	10	4	14	0	1	15	0	0
19	7510223	.	T	C	11	9	20	0	0	20	0	0
19	7510348	.	T	C	10	10	20	0	1	21	0	0
19	7510501	.	G	A	0	7	7	0	8	15	0	0
19	7510567	.	C	T	4	8	12	0	0	12	0	0
19	7512406	.	C	G	11	15	26	0	0	26	0	0
19	7513085	.	C	T	11	9	20	0	1	21	0	0
19	7513291	.	A	C	8	13	21	0	1	22	0	0
19	7513406	.	A	T	8	7	15	0	3	18	0	0
19	7513631	.	A	G	4	5	9	0	2	11	0	0
19	7513651	.	A	G	5	7	12	0	0	12	0	0
19	7514025	.	T	C	11	4	15	0	0	15	0	0
19	7514512	.	T	C	10	5	15	0	0	15	0	0
19	7514697	.	A	G	6	0	6	0	5	11	0	0
19	7514708	.	A	G	8	5	13	0	1	14	0	0
19	7514852	.	A	G	10	12	22	0	1	23	0	0
19	7515336	.	A	T	14	6	20	0	4	24	0	0
19	7515356	.	G	A	14	10	24	0	0	24	0	0
19	7515423	.	A	G	8	4	12	0	0	12	0	0
19	7515458	.	A	G	7	0	7	0	0	7	0	0
19	7515468	.	T	G	6	0	6	0	0	6	0	0
19	7515787	.	A	T	13	9	22	0	2	24	0	0
19	7515829	.	C	T	10	12	22	0	0	22	0	0
19	7515845	.	A	T	11	13	24	0	0	24	0	0
19	7516035	.	A	G	7	14	21	0	0	21	0	0
19	7516063	.	A	C	10	16	26	0	0	26	0	0
19	7516169	.	C	A	11	10	21	0	0	21	0	0
19	7516183	.	T	G	6	11	17	0	0	17	0	0
19	7525222	.	T	G	3	3	6	0	0	6	0	0
19	7525337	.	C	A	11	4	15	0	0	15	0	0
19	7529754	.	C	G	1	6	7	0	4	11	0	0
19	7540354	.	C	T	0	2	2	0	6	8	0	0
19	7549916	.	G	A	6	4	10	0	0	10	0	0
19	7552736	.	C	G	2	3	5	0	0	5	0	0
19	7552737	.	G	T	0	3	3	0	2	5	0	0
19	7552875	.	G	C	0	2	2	0	2	4	0	0
19	7552887	.	A	G	4	3	7	0	0	7	0	0
19	7553368	.	T	C	0	1	1	0	0	1	0	0
19	7553416	.	C	T	0	1	1	0	1	2	0	0
19	7557447	.	C	A	7	11	18	0	0	18	0	0
19	7557538	.	T	C	19	14	33	0	1	34	0	0
19	7557589	.	T	G	16	0	16	0	17	33	0	0
19	7557619	.	A	T	20	15	35	0	2	37	0	0
19	7557773	.	A	T	10	16	26	1	1	28	0	0
19	7557793	.	G	C	15	11	26	1	0	27	0	0
19	7557992	.	C	T	5	4	9	0	0	9	0	0
19	7558009	.	G	A	2	1	3	0	0	3	0	0
19	7559818	.	G	T	8	6	14	0	1	15	0	0
19	7559905	.	A	G	5	17	22	0	1	23	0	0
19	7564073	.	A	G	4	7	11	0	1	12	0	0
19	7565142	.	G	A	15	17	32	0	3	35	0	0
19	7565244	.	A	G	18	26	44	0	1	45	0	0
19	7566493	.	A	T	11	4	15	0	1	16	0	0
19	7567021	.	T	A	16	17	33	0	1	34	0	0
19	7567196	.	A	C	4	3	7	0	0	7	0	0
19	7590695	.	A	T	1	2	3	0	0	3	0	0
19	7590964	.	G	A	0	3	3	0	2	5	0	0
19	7604866	.	G	A	1	2	3	0	1	4	0	0
19	7608836	.	G	A	1	4	5	0	0	5	0	0
19	7630329	.	T	A	4	4	8	0	0	8	0	0
19	7630359	.	T	A	3	3	6	0	0	6	0	0
19	7630435	.	A	G	3	4	7	0	0	7	0	0
19	7630689	.	A	T	2	3	5	0	0	5	0	0
19	7630785	.	C	T	1	2	3	0	0	3	0	0
19	7631700	.	G	A	1	15	16	0	14	30	0	0
19	7631784	.	A	G	11	10	21	0	1	22	0	0
19	7631829	.	C	A	11	9	20	0	1	21	0	0
19	7631860	.	T	C	12	10	22	0	0	22	0	0
19	7632056	.	C	T	5	4	9	0	0	9	0	0
19	7632216	.	C	T	8	8	16	0	0	16	0	0
19	7632348	.	G	A	0	6	6	0	12	18	0	0
19	7632470	.	C	T	11	5	16	0	2	18	0	0
19	7632526	.	T	C	5	10	15	0	2	17	0	0
19	7632837	.	C	T	8	7	15	0	0	15	0	0
19	7678900	.	A	G	2	2	4	0	0	4	0	0
19	7679551	.	C	T	1	2	3	0	0	3	0	0
19	7765259	.	G	A	1	2	3	0	0	3	0	0
19	7784681	.	T	A	4	5	9	0	2	11	0	0
19	7784684	.	T	A	4	6	10	0	1	11	0	0
19	7785138	.	C	T	8	1	9	0	1	10	0	0
19	7794887	.	C	T	14	16	30	0	5	35	0	0
19	7796398	.	C	T	27	20	47	0	1	48	0	0
19	7796842	.	C	A	8	13	21	0	6	28	1	0
19	7796888	.	G	A	17	16	33	0	1	34	0	0
19	7796986	.	A	T	14	10	24	0	1	25	0	0
19	7797259	.	T	A	15	16	31	0	2	33	0	0
19	7797534	.	C	T	18	13	31	0	1	32	0	0
19	7797651	.	G	T	2	8	10	0	0	10	0	0
19	7802700	.	G	A	5	6	11	0	1	12	0	0
19	7802825	.	A	G	0	1	1	0	0	1	0	0
19	7802826	.	C	T	0	1	1	0	0	1	0	0
19	7802873	.	G	A	1	0	1	0	0	1	0	0
19	7803424	.	C	A	7	6	13	0	0	13	0	0
19	7803685	.	C	A	5	10	15	0	1	16	0	0
19	7804785	.	A	C	3	2	5	0	0	5	0	0
19	7819991	.	G	A	9	9	18	0	0	18	0	0
19	7820031	.	T	A	6	10	16	0	0	16	0	0
19	7820040	.	T	C	10	6	16	0	0	16	0	0
19	7820079	.	T	A	5	6	11	0	0	11	0	0
19	7820107	.	G	A	4	5	9	0	0	9	0	0
19	7820466	.	C	A	2	4	6	0	3	9	0	0
19	7820665	.	T	A	18	8	26	0	2	28	0	0
19	7820980	.	C	T	11	10	21	0	0	21	0	0
19	7822581	.	T	C	1	0	1	0	4	5	0	0
19	7823285	.	G	A	0	1	1	0	0	1	0	0
19	7823306	.	G	A	1	4	5	0	0	5	0	0
19	7827016	.	G	A	1	3	4	0	0	4	0	0
19	7827031	.	T	G	7	2	9	0	0	9	0	0
19	7827377	.	C	T	0	10	10	0	5	15	0	0
19	7827579	.	G	A	1	2	3	0	0	3	0	0
19	7827672	.	G	C	5	2	7	0	0	7	0	0
19	7828576	.	G	A	4	9	13	0	0	13	0	0
19	7828621	.	C	A	2	7	9	0	0	9	0	0
19	7828672	.	C	G	7	4	11	0	0	11	0	0
19	7828674	.	G	A	4	6	10	0	1	11	0	0
19	7828774	.	A	G	3	5	8	0	0	8	0	0
19	7828912	.	G	A	5	6	11	0	0	11	0	0
19	7828930	.	T	G	7	6	13	0	0	13	0	0
19	7829124	.	T	C	1	0	1	0	3	4	0	0
19	7829174	.	C	G	2	5	7	0	0	7	0	0
19	7829175	.	C	T	1	5	6	0	1	7	0	0
19	7830013	.	G	A	6	6	12	0	0	12	0	0
19	7830625	.	C	T	2	5	7	0	0	7	0	0
19	7830700	.	G	A	2	2	4	0	0	4	0	0
19	7835774	.	G	A	1	4	5	0	0	5	0	0
19	7837830	.	C	T	1	2	3	0	1	4	0	0
19	7967063	.	C	T	2	2	4	0	0	4	0	0
19	7967067	.	T	C	3	2	5	0	0	5	0	0
19	7967113	.	G	A	4	3	7	0	0	7	0	0
19	8144609	.	G	A	3	5	8	0	0	8	0	0
19	8315244	.	T	C	0	1	1	0	0	1	0	0
19	8315385	.	A	G	4	0	4	0	5	9	0	0
19	8315418	.	G	A	5	3	8	0	1	9	0	0
19	8315478	.	C	T	5	7	12	0	0	12	0	0
19	8336054	.	A	G	5	0	5	0	13	18	0	0
19	8336208	.	C	T	4	6	10	0	0	10	0	0
19	8336335	.	C	A	4	4	8	0	1	9	0	0
19	8336642	.	C	T	12	9	21	0	1	22	0	0
19	8336689	.	G	A	8	5	13	0	1	14	0	0
19	8337182	.	A	G	2	0	2	0	4	6	0	0
19	8337185	.	C	G	2	4	6	0	0	6	0	0
19	8338559	.	A	G	7	5	12	0	1	13	0	0
19	8338616	.	T	A	5	15	20	0	0	20	0	0
19	8338649	.	T	A	3	14	17	0	1	18	0	0
19	8338711	.	C	G	3	3	6	0	3	9	0	0
19	8339202	.	T	A	13	15	28	0	0	28	0	0
19	8481852	.	A	G	2	2	4	0	0	4	0	0
19	8500928	.	A	T	3	4	7	0	0	7	0	0
19	8500960	.	A	T	4	3	7	0	0	7	0	0
19	8501019	.	G	A	0	6	6	0	8	14	0	0
19	8501218	.	G	A	7	10	17	0	1	18	0	0
19	8501490	.	G	T	9	6	15	0	4	19	0	0
19	8501703	.	A	C	1	4	5	0	0	5	0	0
19	8501961	.	G	A	1	3	4	0	8	12	0	0
19	8501962	.	G	A	8	4	12	0	0	12	0	0
19	8502104	.	C	G	5	9	14	0	0	14	0	0
19	8502133	.	C	T	5	10	15	0	2	17	0	0
19	8502166	.	G	T	0	10	10	0	7	17	0	0
19	8502225	.	T	A	7	16	23	0	0	23	0	0
19	8502244	.	G	A	10	12	22	0	0	22	0	0
19	8534126	.	G	C	2	2	4	0	1	5	0	0
19	8534201	.	A	T	2	6	8	0	0	8	0	0
19	8534996	.	A	G	1	0	1	0	0	1	0	0
19	8535005	.	T	G	1	0	1	0	0	1	0	0
19	8582763	.	T	C	0	5	5	0	0	5	0	0
19	8583065	.	A	G	6	8	14	0	1	15	0	0
19	8583131	.	G	A	6	8	14	0	0	14	0	0
19	8583170	.	G	T	8	7	15	0	1	16	0	0
19	8587075	.	T	C	1	1	2	0	4	6	0	0
19	8589693	.	C	T	5	5	10	0	0	10	0	0
19	8589714	.	C	T	3	2	5	0	0	5	0	0
19	8592973	.	T	A	2	0	2	0	0	2	0	0
19	8598667	.	A	G	3	1	4	0	0	4	0	0
19	8600156	.	G	A	1	2	3	0	0	3	0	0
19	8604154	.	A	G	2	2	4	0	0	4	0	0
19	8604172	.	G	A	3	2	5	0	0	5	0	0
19	8612844	.	T	G	2	2	4	0	0	4	0	0
19	8612981	.	G	C	1	9	10	0	6	16	0	0
19	8613041	.	G	C	9	8	17	0	1	18	0	0
19	8628830	.	G	T	1	8	9	0	4	13	0	0
19	8637657	.	T	C	5	3	8	0	1	9	0	0
19	8638539	.	C	A	1	0	1	0	0	1	0	0
19	8647747	.	T	A	7	5	12	0	2	14	0	0
19	8680667	.	C	T	0	2	2	0	6	8	0	0
19	8681443	.	A	G	2	5	7	0	0	7	0	0
19	8681470	.	G	A	3	5	8	0	0	8	0	0
19	8681509	.	G	A	3	7	10	0	0	10	0	0
19	8689870	.	A	G	0	2	2	0	0	2	0	0
19	8689882	.	T	A	0	2	2	0	0	2	0	0
19	8699707	.	T	C	1	2	3	0	0	3	0	0
19	8747688	.	G	A	21	16	37	0	2	39	0	0
19	8775362	.	A	T	6	6	12	0	0	12	0	0
19	8817121	.	C	A	2	6	8	0	0	8	0	0
19	8817608	.	G	A	29	13	42	0	0	42	0	0
19	8831895	.	T	C	4	0	4	0	5	9	0	0
19	8831907	.	C	T	0	2	2	0	2	4	0	0
19	8834529	.	A	G	10	7	17	0	0	17	0	0
19	8834583	.	T	C	21	17	38	0	2	40	0	0
19	8836805	.	C	T	9	5	14	0	2	16	0	0
19	8880614	.	C	G	4	5	9	0	1	10	0	0
19	8894119	.	T	A	6	4	10	0	0	10	0	0
19	8894138	.	A	G	7	3	10	0	0	10	0	0
19	8895514	.	C	A	0	2	2	0	5	7	0	0
19	8895546	.	C	T	2	4	6	0	0	6	0	0
19	8895630	.	C	T	3	8	11	0	1	12	0	0
19	8897625	.	A	C	3	0	3	0	7	10	0	0
19	8898125	.	G	A	4	2	6	1	0	7	0	0
19	8898184	.	G	A	6	5	11	0	1	12	0	0
19	8898188	.	G	A	6	5	11	0	0	11	0	0
19	8901058	.	T	C	3	0	3	0	0	3	0	0
19	8901419	.	A	G	1	2	3	0	0	3	0	0
19	8901446	.	T	G	1	3	4	0	0	4	0	0
19	8904026	.	A	G	2	0	2	0	0	2	0	0
19	8928718	.	G	A	9	7	16	0	0	16	0	0
19	8928767	.	G	C	15	11	26	0	0	26	0	0
19	8929057	.	G	A	6	3	9	0	0	9	0	0
19	8929708	.	A	T	5	6	11	0	1	12	0	0
19	8929839	.	G	A	11	9	20	0	0	20	0	0
19	8929860	.	T	C	11	7	18	0	0	18	0	0
19	8932643	.	T	C	9	2	11	0	5	16	0	0
19	8939917	.	C	T	11	8	19	0	1	20	0	0
19	8958892	.	A	G	13	19	32	0	1	33	0	0
19	8962835	.	C	T	6	5	11	0	0	11	0	0
19	8979060	.	G	T	1	2	3	0	1	4	0	0
19	8979185	.	G	T	0	4	4	0	0	4	0	0
19	8983454	.	T	A	1	1	2	0	0	2	0	0
19	8985221	.	G	A	4	6	10	0	0	10	0	0
19	8985408	.	C	T	3	5	8	0	0	8	0	0
19	8985564	.	G	A	0	16	16	0	16	32	0	0
19	8989992	.	G	A	0	4	4	0	11	15	0	0
19	8997629	.	G	A	7	4	11	0	0	11	0	0
19	8997903	.	C	T	4	3	7	0	0	7	0	0
19	9000665	.	C	T	17	26	43	0	1	44	0	0
19	9000674	.	T	C	20	22	42	0	3	45	0	0
19	9000907	.	A	G	9	2	11	0	21	32	0	0
19	9001058	.	C	T	15	15	30	0	1	31	0	0
19	9001100	.	C	T	17	13	30	0	2	32	0	0
19	9001151	.	C	T	17	17	34	0	0	34	0	0
19	9001246	.	C	T	15	8	23	0	1	24	0	0
19	9001315	.	C	T	12	15	27	0	0	27	0	0
19	9001317	.	G	A	15	12	27	0	0	27	0	0
19	9033383	.	A	T	0	2	2	0	0	2	0	0
19	9043035	.	C	T	6	4	10	0	0	10	0	0
19	9045651	.	A	T	5	5	10	0	0	10	0	0
19	9046119	.	G	C	3	5	8	0	0	8	0	0
19	9046230	.	T	G	4	10	14	0	1	15	0	0
19	9046327	.	C	T	8	7	15	0	1	16	0	0
19	9046383	.	T	A	9	4	13	0	3	16	0	0
19	9046467	.	G	A	12	16	28	0	0	28	0	0
19	9046542	.	A	C	8	11	19	0	1	20	0	0
19	9046551	.	T	C	7	11	18	0	1	19	0	0
19	9047004	.	G	A	0	5	5	0	4	9	0	0
19	9047283	.	A	G	7	5	12	0	0	12	0	0
19	9047806	.	T	A	9	5	14	0	1	15	0	0
19	9048345	.	C	T	5	7	12	0	0	12	0	0
19	9048538	.	A	C	4	6	10	0	1	11	0	0
19	9048614	.	C	T	5	5	10	0	0	10	0	0
19	9050305	.	G	A	15	17	32	0	2	34	0	0
19	9050319	.	C	T	13	15	28	0	0	28	0	0
19	9050737	.	G	C	5	8	13	0	1	14	0	0
19	9050745	.	A	G	5	8	13	0	0	13	0	0
19	9055793	.	C	T	5	14	19	0	0	19	0	0
19	9058454	.	T	C	1	2	3	0	0	3	0	0
19	9064759	.	T	C	1	7	8	0	1	9	0	0
19	9064777	.	C	A	4	10	14	0	0	14	0	0
19	9064822	.	A	G	9	11	20	0	1	21	0	0
19	9064853	.	T	C	8	7	15	0	0	15	0	0
19	9064885	.	G	A	2	1	3	0	0	3	0	0
19	9067211	.	G	A	7	4	11	0	1	12	0	0
19	9070546	.	T	G	5	1	6	0	8	14	0	0
19	9072451	.	C	T	15	7	22	0	1	23	0	0
19	9077465	.	C	T	8	9	17	0	1	18	0	0
19	9084688	.	T	C	9	16	25	0	1	26	0	0
19	9085359	.	A	T	12	3	15	0	1	16	0	0
19	9085423	.	G	A	6	16	22	0	3	25	0	0
19	9085730	.	A	G	4	0	4	0	2	8	2	0
19	9085757	.	A	C	10	13	23	0	1	24	0	0
19	9086084	.	T	A	17	16	33	0	3	36	0	0
19	9086132	.	C	A	11	23	34	0	0	34	0	0
19	9086416	.	T	A	3	3	6	0	0	6	0	0
19	9086429	.	G	T	3	5	8	0	0	8	0	0
19	9111649	.	T	G	4	2	6	0	0	6	0	0
19	9111711	.	G	T	2	0	2	0	0	2	0	0
19	9111712	.	T	A	0	1	1	0	1	2	0	0
19	9117473	.	T	G	6	8	14	0	0	15	1	0
19	9123493	.	C	T	8	5	13	0	0	13	0	0
19	9125062	.	G	A	2	1	3	0	0	3	0	0
19	9130205	.	T	A	0	5	5	0	0	5	0	0
19	9135053	.	C	T	5	2	7	0	0	7	0	0
19	9135754	.	A	T	6	11	17	0	0	17	0	0
19	9138850	.	C	A	3	2	5	0	1	6	0	0
19	9140507	.	A	G	4	0	4	0	1	5	0	0
19	9140618	.	C	T	5	2	7	0	0	7	0	0
19	9140675	.	A	T	6	12	18	0	2	20	0	0
19	9144234	.	C	T	6	4	10	0	0	10	0	0
19	9161595	.	G	A	5	4	9	0	1	10	0	0
19	9161621	.	C	T	1	4	5	0	1	6	0	0
19	9161631	.	T	G	1	3	4	0	0	4	0	0
19	9161824	.	T	C	12	13	25	0	0	25	0	0
19	9161830	.	C	T	12	10	22	0	1	23	0	0
19	9166374	.	G	A	3	0	3	0	0	3	0	0
19	9168513	.	C	T	21	19	40	0	3	43	0	0
19	9168622	.	C	T	17	15	32	0	0	32	0	0
19	9168947	.	G	T	1	21	22	0	14	37	1	0
19	9169099	.	G	A	8	8	16	0	0	16	0	0
19	9169162	.	G	C	3	9	12	0	0	12	0	0
19	9216201	.	T	A	12	8	20	0	7	27	0	0
19	9216221	.	A	C	7	9	16	0	1	17	0	0
19	9216367	.	G	A	3	7	10	0	0	10	0	0
19	9217143	.	C	T	20	18	38	0	1	39	0	0
19	9218405	.	G	A	20	14	34	0	0	34	0	0
19	9220813	.	C	T	7	15	22	0	1	23	0	0
19	9220828	.	C	T	10	19	29	0	1	30	0	0
19	9220849	.	T	C	28	12	40	0	2	42	0	0
19	9220939	.	T	C	6	8	14	0	0	14	0	0
19	9223369	.	T	C	22	17	39	0	1	40	0	0
19	9228196	.	T	G	18	19	37	0	2	39	0	0
19	9228378	.	A	G	16	0	16	0	14	30	0	0
19	9228380	.	C	T	15	13	28	0	2	30	0	0
19	9241530	.	C	T	1	2	3	0	0	3	0	0
19	9245752	.	A	G	0	2	2	0	1	3	0	0
19	9251136	.	G	A	0	1	1	0	1	2	0	0
19	9252173	.	A	T	2	2	4	0	0	4	0	0
19	9252183	.	C	A	2	2	4	0	0	4	0	0
19	9260018	.	G	A	0	1	1	0	0	1	0	0
19	9262519	.	C	T	3	1	4	0	0	4	0	0
19	9263000	.	A	G	2	1	3	0	0	3	0	0
19	9265267	.	G	A	0	4	4	0	1	5	0	0
19	9265377	.	C	T	1	2	3	0	0	3	0	0
19	9265417	.	C	T	2	2	4	0	0	4	0	0
19	9265429	.	G	T	2	3	5	0	0	5	0	0
19	9265516	.	A	C	6	2	8	0	1	9	0	0
19	9265517	.	G	A	6	3	9	0	0	9	0	0
19	9266121	.	T	C	5	7	12	0	1	13	0	0
19	9266326	.	C	T	7	6	13	0	0	13	0	0
19	9266793	.	A	C	5	5	10	0	0	10	0	0
19	9266963	.	C	T	3	6	9	0	0	9	0	0
19	9268433	.	C	T	2	0	2	0	1	3	0	0
19	9268458	.	G	A	2	1	3	0	0	3	0	0
19	9268468	.	A	C	2	1	3	0	0	3	0	0
19	9268589	.	A	G	4	0	4	0	4	8	0	0
19	9268619	.	C	A	4	5	9	0	0	9	0	0
19	9273768	.	T	A	4	7	11	0	0	11	0	0
19	9274070	.	G	A	0	6	6	0	9	15	0	0
19	9274095	.	G	T	7	5	12	0	1	13	0	0
19	9274248	.	T	A	5	3	8	0	1	9	0	0
19	9274500	.	T	C	3	4	7	0	1	8	0	0
19	9274666	.	T	C	2	8	10	0	0	10	0	0
19	9274705	.	C	T	6	3	9	0	0	9	0	0
19	9274844	.	A	C	7	5	12	0	0	12	0	0
19	9458166	.	A	G	19	0	19	0	24	43	0	0
19	9458181	.	A	C	18	19	37	0	1	39	1	0
19	9458304	.	G	A	5	21	26	0	1	27	0	0
19	9458328	.	T	C	9	20	29	0	0	29	0	0
19	9458421	.	G	A	16	20	36	0	2	38	0	0
19	9458463	.	C	T	16	24	40	0	3	43	0	0
19	9459325	.	T	A	24	14	38	0	0	38	0	0
19	9459330	.	C	T	25	7	32	0	0	32	0	0
19	9459378	.	A	G	25	0	25	0	26	51	0	0
19	9459597	.	G	A	0	8	8	0	20	28	0	0
19	9459673	.	G	A	0	15	15	0	20	35	0	0
19	9459820	.	T	C	18	15	33	0	1	34	0	0
19	9460128	.	A	C	12	6	18	0	4	22	0	0
19	9460196	.	A	G	13	18	31	0	1	32	0	0
19	9460499	.	A	G	29	16	45	0	1	46	0	0
19	9460531	.	G	T	32	20	52	0	3	55	0	0
19	9461072	.	A	G	33	12	45	0	2	47	0	0
19	9461141	.	T	G	23	26	49	0	2	51	0	0
19	9461376	.	A	G	25	29	54	0	2	56	0	0
19	9461841	.	A	G	17	22	39	0	3	42	0	0
19	9471066	.	G	A	24	31	55	0	3	58	0	0
19	9472368	.	T	A	3	1	4	0	0	4	0	0
19	9472405	.	A	G	5	1	6	0	0	6	0	0
19	9472865	.	G	A	21	27	48	0	1	49	0	0
19	9481781	.	T	G	2	10	12	0	0	12	0	0
19	9482126	.	C	T	0	5	5	0	8	13	0	0
19	9482127	.	G	T	7	6	13	0	0	13	0	0
19	9482261	.	A	G	13	17	30	0	1	31	0	0
19	9485543	.	A	G	2	3	5	0	0	5	0	0
19	9502229	.	T	G	2	0	2	0	0	2	0	0
19	9502456	.	A	C	10	5	15	0	1	16	0	0
19	9502640	.	T	C	11	14	25	0	0	25	0	0
19	9502656	.	A	G	11	10	21	0	0	21	0	0
19	9502968	.	C	T	12	9	21	0	1	22	0	0
19	9503303	.	A	G	7	6	13	0	0	13	0	0
19	9503356	.	T	G	5	8	13	0	0	13	0	0
19	9513443	.	T	C	6	7	13	0	2	15	0	0
19	9513572	.	A	C	10	15	25	0	1	26	0	0
19	9513863	.	A	C	7	9	16	0	1	17	0	0
19	9513869	.	A	C	9	8	17	0	0	17	0	0
19	9516869	.	A	G	5	13	18	0	0	18	0	0
19	9519284	.	G	A	2	2	4	0	0	4	0	0
19	9533299	.	C	G	6	3	9	0	0	9	0	0
19	9585421	.	C	T	10	7	17	0	0	17	0	0
19	9585436	.	G	A	9	6	15	0	0	15	0	0
19	9598053	.	C	T	9	7	16	0	0	16	0	0
19	9598080	.	A	G	8	13	21	0	0	21	0	0
19	9598119	.	C	A	5	7	12	0	1	13	0	0
19	9603062	.	C	T	5	9	14	0	10	24	0	0
19	9603160	.	G	A	0	9	9	0	11	20	0	0
19	9603233	.	G	T	0	6	6	0	8	14	0	0
19	9603425	.	C	T	10	10	20	0	2	22	0	0
19	9603432	.	T	A	10	14	24	0	1	25	0	0
19	9603752	.	C	T	3	2	5	0	0	5	0	0
19	9604050	.	T	A	5	2	7	0	1	8	0	0
19	9604114	.	A	G	2	9	11	0	0	11	0	0
19	9685506	.	A	G	18	17	35	0	2	37	0	0
19	9685695	.	A	G	32	17	49	0	0	49	0	0
19	9686123	.	G	T	9	13	22	0	1	23	0	0
19	9686128	.	A	G	10	12	22	0	0	22	0	0
19	9686160	.	T	C	12	10	22	0	1	23	0	0
19	9686163	.	C	A	12	11	23	0	0	23	0	0
19	9686421	.	G	T	13	16	29	0	0	29	0	0
19	9686515	.	T	A	7	11	18	0	0	18	0	0
19	9686519	.	G	A	7	11	18	0	0	18	0	0
19	9686615	.	T	C	13	19	32	0	0	32	0	0
19	9686627	.	T	C	16	17	33	0	0	33	0	0
19	9686678	.	T	A	19	17	36	0	0	36	0	0
19	9686806	.	T	C	8	9	17	0	0	17	0	0
19	9686807	.	C	T	6	8	14	0	3	17	0	0
19	9686902	.	T	A	5	7	12	0	0	12	0	0
19	9686905	.	T	C	5	1	6	0	7	13	0	0
19	9687001	.	T	G	9	6	15	0	1	17	1	0
19	9687146	.	T	C	21	17	38	0	1	39	0	0
19	9687206	.	T	A	21	12	33	0	0	33	0	0
19	9687306	.	G	A	25	14	39	0	3	42	0	0
19	9691780	.	A	G	13	10	23	0	1	24	0	0
19	9711421	.	T	C	7	6	13	0	0	13	0	0
19	9711444	.	G	A	7	4	11	0	0	11	0	0
19	9712337	.	G	A	3	7	10	0	0	10	0	0
19	9712357	.	T	A	5	13	18	0	0	18	0	0
19	9712444	.	G	A	11	8	19	0	0	19	0	0
19	9712514	.	C	T	1	8	9	0	0	9	0	0
19	9813781	.	C	A	0	4	4	0	5	9	0	0
19	9813905	.	A	G	8	7	15	0	0	15	0	0
19	9813942	.	A	G	7	9	16	0	2	18	0	0
19	9814291	.	C	T	0	31	31	0	13	44	0	0
19	9814336	.	T	C	16	31	47	0	1	48	0	0
19	9814423	.	A	G	17	24	41	0	1	42	0	0
19	9814444	.	G	A	17	20	37	0	3	40	0	0
19	9814504	.	G	A	15	31	46	0	0	46	0	0
19	9814516	.	A	G	15	32	47	0	1	48	0	0
19	9814549	.	T	C	17	29	46	0	3	49	0	0
19	9814611	.	A	G	8	14	22	0	2	24	0	0
19	9814621	.	C	T	0	13	13	0	8	21	0	0
19	9822566	.	G	C	17	14	31	0	1	32	0	0
19	9822610	.	G	A	20	13	33	0	2	35	0	0
19	9840924	.	C	T	13	13	26	0	0	26	0	0
19	9841006	.	A	G	12	15	27	0	0	27	0	0
19	9841035	.	G	A	13	12	25	0	1	26	0	0
19	9841054	.	T	C	8	0	8	0	9	17	0	0
19	9841077	.	T	A	7	6	13	0	0	13	0	0
19	9841203	.	A	T	13	16	29	0	0	29	0	0
19	9841450	.	C	G	8	13	21	0	1	23	1	0
19	9841523	.	G	A	8	17	25	0	0	25	0	0
19	9842252	.	T	C	18	17	35	0	2	37	0	0
19	9859170	.	A	G	3	2	5	0	0	5	0	0
19	9866930	.	C	G	5	10	15	0	1	16	0	0
19	9910842	.	G	A	7	12	19	0	0	19	0	0
19	9911566	.	T	A	7	6	13	0	0	13	0	0
19	9911587	.	T	G	4	7	11	0	0	11	0	0
19	9911904	.	A	T	5	6	11	0	0	11	0	0
19	9911948	.	G	A	7	5	12	0	0	12	0	0
19	9911955	.	T	A	6	4	10	0	1	11	0	0
19	9912040	.	G	A	7	3	10	1	0	11	0	0
19	9912113	.	A	C	4	3	7	0	1	8	0	0
19	9912117	.	C	T	4	3	7	0	1	8	0	0
19	9912487	.	A	T	3	4	7	0	0	7	0	0
19	9912496	.	A	G	3	4	7	0	0	7	0	0
19	9912561	.	A	C	0	4	4	0	0	4	0	0
19	9912663	.	G	C	7	0	7	0	5	12	0	0
19	9912665	.	G	T	7	5	12	0	0	12	0	0
19	9912844	.	A	C	3	3	6	0	0	6	0	0
19	9914424	.	T	A	8	8	16	0	0	16	0	0
19	9914737	.	A	G	6	5	11	0	1	12	0	0
19	9914866	.	T	A	4	12	16	0	7	23	0	0
19	9916197	.	C	T	8	3	11	0	0	11	0	0
19	9916597	.	C	T	4	4	8	0	0	8	0	0
19	9916630	.	G	T	6	6	12	0	0	12	0	0
19	9916786	.	A	G	5	4	9	0	0	9	0	0
19	9916840	.	G	A	5	4	9	0	0	9	0	0
19	9916918	.	A	G	1	3	4	0	1	5	0	0
19	9917581	.	G	A	3	2	5	0	0	5	0	0
19	9919114	.	G	T	2	1	3	0	0	3	0	0
19	9919150	.	C	A	3	3	6	0	0	6	0	0
19	9932568	.	A	G	3	2	5	0	0	5	0	0
19	10007696	.	T	A	0	1	1	0	0	1	0	0
19	10007762	.	C	G	0	3	3	0	2	5	0	0
19	10007889	.	T	C	0	1	1	0	0	1	0	0
19	10042519	.	T	C	1	2	3	0	0	3	0	0
19	10177382	.	C	A	18	13	31	0	2	33	0	0
19	10177951	.	A	G	25	23	48	0	0	48	0	0
19	10190085	.	A	G	1	1	2	0	0	2	0	0
19	10195375	.	C	G	1	1	2	0	0	2	0	0
19	10195376	.	A	C	1	0	1	0	1	2	0	0
19	10195432	.	T	C	6	6	12	0	0	12	0	0
19	10196049	.	T	A	6	8	14	0	0	14	0	0
19	10201566	.	T	G	4	10	14	0	1	15	0	0
19	10201719	.	A	G	14	15	29	0	1	30	0	0
19	10202598	.	T	C	6	0	6	0	9	15	0	0
19	10203420	.	T	C	15	18	33	0	0	33	0	0
19	10203480	.	C	T	0	10	10	0	11	21	0	0
19	10203936	.	T	G	5	9	14	0	0	14	0	0
19	10204023	.	G	A	9	13	22	0	0	22	0	0
19	10204476	.	C	T	4	4	8	0	0	8	0	0
19	10205409	.	T	A	8	8	16	0	0	16	0	0
19	10206414	.	G	A	8	4	12	0	0	12	0	0
19	10206420	.	G	A	3	6	9	0	1	10	0	0
19	10206552	.	A	G	5	7	12	0	0	12	0	0
19	10207286	.	A	G	2	2	4	0	2	6	0	0
19	10207336	.	C	T	0	3	3	0	2	5	0	0
19	10207439	.	A	T	1	2	3	0	0	3	0	0
19	10207704	.	A	T	1	2	3	0	0	3	0	0
19	10218136	.	T	A	10	14	24	0	0	24	0	0
19	10218807	.	C	T	1	7	8	0	9	17	0	0
19	10219051	.	T	A	8	10	18	0	0	18	0	0
19	10219186	.	C	A	13	14	27	0	1	28	0	0
19	10219209	.	T	G	10	10	20	0	3	23	0	0
19	10219387	.	T	C	20	6	26	0	3	29	0	0
19	10220013	.	G	A	25	20	45	0	3	48	0	0
19	10220283	.	T	G	24	11	35	0	0	35	0	0
19	10235373	.	T	C	16	13	29	0	3	32	0	0
19	10235899	.	G	C	26	18	44	0	0	44	0	0
19	10236249	.	C	T	6	14	20	0	1	21	0	0
19	10236490	.	C	A	13	11	24	0	0	24	0	0
19	10236569	.	T	C	6	13	19	0	1	20	0	0
19	10236853	.	A	G	8	7	15	0	0	15	0	0
19	10237198	.	G	C	3	2	5	0	1	6	0	0
19	10237241	.	G	A	5	1	6	0	1	7	0	0
19	10237394	.	A	G	16	13	29	0	0	29	0	0
19	10237446	.	A	T	18	20	38	0	0	38	0	0
19	10237815	.	A	T	10	11	21	0	0	21	0	0
19	10237950	.	T	C	5	0	5	0	18	23	0	0
19	10238011	.	G	C	7	1	8	0	14	22	0	0
19	10238045	.	C	G	9	12	21	0	1	22	0	0
19	10238301	.	G	C	4	0	4	0	5	9	0	0
19	10238303	.	T	C	1	5	6	0	3	9	0	0
19	10238348	.	G	A	3	4	7	0	0	7	0	0
19	10238350	.	C	G	3	4	7	0	0	7	0	0
19	10238580	.	G	A	10	6	16	0	0	16	0	0
19	10252413	.	T	C	9	5	14	0	2	16	0	0
19	10252588	.	T	C	3	1	4	0	1	5	0	0
19	10252630	.	G	C	2	0	2	0	2	4	0	0
19	10252650	.	A	G	3	2	5	0	0	5	0	0
19	10252679	.	A	T	4	3	7	0	0	7	0	0
19	10252736	.	T	C	7	3	10	0	0	10	0	0
19	10252740	.	G	T	7	2	9	0	0	9	0	0
19	10253087	.	T	G	2	9	11	0	0	11	0	0
19	10253140	.	A	T	3	10	13	0	0	13	0	0
19	10253160	.	G	A	3	6	9	0	0	9	0	0
19	10253915	.	T	C	5	3	8	0	1	9	0	0
19	10254128	.	T	G	1	4	5	0	1	6	0	0
19	10254146	.	A	C	3	7	10	0	0	10	0	0
19	10254303	.	C	A	3	3	6	0	0	6	0	0
19	10254690	.	A	C	4	10	14	0	0	14	0	0
19	10254772	.	C	T	3	6	9	0	1	10	0	0
19	10254840	.	C	T	0	7	7	0	4	11	0	0
19	10255158	.	A	T	3	3	6	0	0	6	0	0
19	10255456	.	G	A	4	5	9	0	0	9	0	0
19	10255680	.	G	A	7	6	13	0	0	13	0	0
19	10255702	.	A	C	9	6	15	0	0	15	0	0
19	10264727	.	T	G	1	1	2	0	0	2	0	0
19	10272707	.	A	G	2	3	5	0	0	5	0	0
19	10272803	.	T	C	1	0	1	0	2	3	0	0
19	10273753	.	C	T	0	2	2	0	5	7	0	0
19	10274118	.	T	C	0	1	1	0	0	1	0	0
19	10299174	.	A	C	14	10	24	0	2	26	0	0
19	10299383	.	G	A	14	17	31	0	3	34	0	0
19	10299579	.	C	A	11	14	25	0	1	26	0	0
19	10299593	.	A	G	12	8	20	0	2	22	0	0
19	10299634	.	C	T	4	3	7	0	7	14	0	0
19	10299706	.	C	T	1	24	25	0	12	37	0	0
19	10301236	.	T	C	6	15	21	0	0	21	0	0
19	10351959	.	A	T	3	3	6	0	0	6	0	0
19	10351964	.	T	A	3	3	6	0	0	6	0	0
19	10376610	.	A	C	13	0	13	0	0	13	0	0
19	10377097	.	C	T	16	10	26	0	1	27	0	0
19	10377534	.	G	T	11	12	23	0	2	25	0	0
19	10377633	.	A	G	7	15	22	0	1	23	0	0
19	10377777	.	T	C	9	15	24	0	1	25	0	0
19	10377815	.	A	C	15	15	30	0	1	31	0	0
19	10377892	.	A	C	16	12	28	0	1	29	0	0
19	10377911	.	A	T	15	15	30	0	1	31	0	0
19	10378192	.	G	A	22	18	40	0	1	41	0	0
19	10378457	.	A	T	5	12	17	0	3	20	0	0
19	10378544	.	C	T	9	13	22	0	4	26	0	0
19	10378599	.	T	C	9	13	22	0	1	23	0	0
19	10378618	.	C	T	10	10	20	0	1	21	0	0
19	10378700	.	A	G	7	14	21	0	3	24	0	0
19	10378848	.	C	T	11	11	22	0	0	22	0	0
19	10378868	.	T	C	10	1	11	0	12	23	0	0
19	10378889	.	C	T	10	13	23	0	0	23	0	0
19	10378959	.	C	A	13	12	25	0	0	25	0	0
19	10379011	.	T	C	8	4	12	0	0	12	0	0
19	10379183	.	C	A	4	10	14	0	1	15	0	0
19	10379192	.	C	T	4	10	14	0	0	14	0	0
19	10379314	.	C	T	1	15	16	0	7	23	0	0
19	10379321	.	C	T	7	14	21	0	2	23	0	0
19	10379369	.	C	T	17	5	22	0	1	23	0	0
19	10379475	.	A	G	14	13	27	0	0	27	0	0
19	10379555	.	T	G	12	16	28	0	0	28	0	0
19	10379575	.	A	G	14	11	25	0	1	26	0	0
19	10379821	.	T	A	17	25	42	0	1	43	0	0
19	10379833	.	T	G	17	25	42	0	1	43	0	0
19	10379873	.	A	G	14	16	30	0	0	30	0	0
19	10379965	.	T	C	15	6	21	0	2	23	0	0
19	10383100	.	A	G	9	10	19	0	1	20	0	0
19	10383112	.	G	T	14	10	24	0	0	24	0	0
19	10383532	.	G	A	11	9	20	0	1	21	0	0
19	10383533	.	T	A	6	8	14	0	7	21	0	0
19	10383616	.	C	T	0	6	6	0	1	7	0	0
19	10383631	.	C	T	0	1	1	0	2	3	0	0
19	10386619	.	C	T	12	8	20	0	0	20	0	0
19	10388285	.	C	T	7	7	14	0	1	15	0	0
19	10393034	.	G	A	5	5	10	0	0	10	0	0
19	10393072	.	A	G	5	5	10	0	1	11	0	0
19	10394835	.	T	G	1	3	4	0	0	4	0	0
19	10407312	.	C	T	4	6	10	0	1	11	0	0
19	10407546	.	A	T	14	28	42	0	6	48	0	0
19	10407732	.	T	A	28	29	57	0	0	57	0	0
19	10407767	.	G	T	23	23	46	0	3	49	0	0
19	10558602	.	T	C	4	2	6	0	0	6	0	0
19	10558604	.	G	A	4	2	6	0	0	6	0	0
19	10561001	.	A	G	8	9	17	0	1	18	0	0
19	10562737	.	T	C	3	1	4	0	0	4	0	0
19	10565385	.	C	T	1	1	2	0	0	2	0	0
19	10569122	.	T	C	2	2	4	0	0	4	0	0
19	10575315	.	T	C	6	3	9	0	2	11	0	0
19	10575318	.	G	T	8	4	12	0	0	12	0	0
19	10575565	.	G	C	0	9	9	0	12	21	0	0
19	10575824	.	T	G	11	8	19	0	0	19	0	0
19	10576289	.	C	G	1	5	6	0	1	7	0	0
19	10576297	.	A	T	1	4	5	0	1	6	0	0
19	10576443	.	A	G	5	3	8	0	0	8	0	0
19	10576482	.	C	T	2	5	7	0	1	8	0	0
19	10576520	.	T	C	7	6	13	0	1	14	0	0
19	10576909	.	G	A	9	4	13	0	1	14	0	0
19	10576970	.	A	T	11	7	18	0	0	18	0	0
19	10577011	.	T	G	13	1	14	0	6	20	0	0
19	10577194	.	T	A	7	3	10	0	0	10	0	0
19	10577253	.	T	A	3	5	8	0	0	8	0	0
19	10649711	.	T	A	5	2	7	0	0	7	0	0
19	10649722	.	T	C	5	2	7	0	0	7	0	0
19	10654540	.	G	A	1	5	6	0	0	6	0	0
19	10654553	.	C	A	0	4	4	0	6	10	0	0
19	10668840	.	G	A	0	1	1	0	0	1	0	0
19	10671730	.	A	G	0	1	1	0	0	1	0	0
19	10826516	.	G	A	1	2	3	0	0	3	0	0
19	10826564	.	A	G	1	2	3	0	1	4	0	0
19	10841477	.	G	T	10	6	16	0	1	17	0	0
19	10866745	.	G	T	1	3	4	0	0	4	0	0
19	10866935	.	T	A	4	2	6	0	0	6	0	0
19	10866995	.	G	T	3	3	6	0	0	6	0	0
19	10868742	.	C	T	1	2	3	0	1	4	0	0
19	10869001	.	A	C	2	3	5	0	0	5	0	0
19	10869022	.	C	A	2	3	5	0	0	5	0	0
19	10869501	.	C	A	6	4	10	0	0	10	0	0
19	10870305	.	A	G	6	1	7	0	3	10	0	0
19	10870361	.	C	T	4	6	10	0	1	11	0	0
19	10870602	.	G	A	1	2	3	0	0	3	0	0
19	10870737	.	A	G	1	3	4	0	1	5	0	0
19	10870845	.	C	T	2	4	6	0	0	6	0	0
19	10870954	.	A	G	0	0	0	0	4	4	0	0
19	10870956	.	A	G	0	3	3	0	1	4	0	0
19	10871235	.	G	A	3	2	5	0	0	5	0	0
19	10871259	.	A	T	4	3	7	0	0	7	0	0
19	10871719	.	A	G	10	7	17	0	0	17	0	0
19	10871803	.	C	T	0	6	6	0	8	14	0	0
19	10871823	.	A	G	5	6	11	0	0	11	0	0
19	10872397	.	C	T	2	4	6	0	0	6	0	0
19	10875854	.	A	G	21	12	33	0	0	33	0	0
19	10876446	.	C	T	3	0	3	0	0	3	0	0
19	10893374	.	C	T	0	1	1	0	1	2	0	0
19	10915776	.	A	G	3	4	7	0	1	8	0	0
19	10989189	.	A	C	15	6	21	0	0	21	0	0
19	10989343	.	T	A	16	13	29	0	2	31	0	0
19	10989457	.	T	C	9	20	29	0	2	31	0	0
19	10989511	.	A	G	15	9	24	0	0	24	0	0
19	10989653	.	C	A	16	15	31	0	1	32	0	0
19	10997288	.	A	G	3	3	6	0	1	7	0	0
19	11014636	.	G	A	17	17	34	0	0	34	0	0
19	11014675	.	A	G	7	14	21	0	0	21	0	0
19	11015047	.	T	C	1	0	1	0	2	3	0	0
19	11039829	.	G	C	4	7	11	0	1	12	0	0
19	11040493	.	A	T	13	13	26	0	0	26	0	0
19	11045311	.	C	A	0	13	13	0	12	25	0	0
19	11045323	.	C	T	15	13	28	0	2	30	0	0
19	11045864	.	A	C	8	10	18	0	2	20	0	0
19	11048822	.	C	T	1	0	1	0	2	3	0	0
19	11051581	.	T	C	8	5	13	0	0	13	0	0
19	11063846	.	C	T	9	4	13	0	0	13	0	0
19	11070738	.	A	G	4	3	7	0	0	7	0	0
19	11070794	.	G	A	8	6	14	0	0	14	0	0
19	11093564	.	T	C	1	6	7	0	0	7	0	0
19	11093567	.	A	G	1	5	6	0	0	6	0	0
19	11172188	.	G	A	2	1	3	0	0	3	0	0
19	11172236	.	C	A	0	1	1	0	2	3	0	0
19	11231386	.	C	A	4	18	22	0	0	22	0	0
19	11237043	.	A	G	10	8	18	0	0	18	0	0
19	11237049	.	T	C	10	8	18	0	1	19	0	0
19	12937792	.	T	C	7	3	10	0	0	10	0	0
19	13151155	.	A	G	6	0	6	0	21	27	0	0
19	13413615	.	A	G	0	10	10	0	1	11	0	0
19	13413617	.	A	G	2	9	11	0	0	11	0	0
19	13413674	.	A	G	10	6	16	0	0	16	0	0
19	13413683	.	A	G	5	10	15	0	1	16	0	0
19	13413740	.	A	G	10	2	12	0	0	12	0	0
19	13413752	.	A	G	6	3	9	0	0	10	1	0
19	15307883	.	T	C	9	4	13	0	0	13	0	0
19	17275765	.	A	G	9	3	12	0	0	12	0	0
19	17516478	.	G	A	14	3	17	0	16	33	0	0
19	17517136	.	T	C	7	6	13	0	0	13	0	0
19	17517282	.	T	C	3	2	5	0	0	5	0	0
19	20454324	.	G	A	1	8	9	0	0	9	0	0
19	20721761	.	A	C	2	15	17	0	7	24	0	0
19	20741969	.	T	C	1	0	1	0	0	1	0	0
19	20753194	.	G	T	3	2	5	0	0	5	0	0
19	22415484	.	A	G	4	2	6	0	0	6	0	0
19	24391414	.	G	A	0	2	2	0	0	2	0	0
19	24391730	.	T	A	0	2	2	0	0	2	0	0
19	24916543	.	A	T	1	3	4	0	1	5	0	0
19	29818263	.	C	G	8	0	8	0	10	18	0	0
19	30416496	.	G	T	0	8	8	0	0	8	0	0
19	30519530	.	T	A	4	2	6	0	0	6	0	0
19	31517478	.	T	C	1	4	5	0	1	6	0	0
19	31532296	.	G	C	0	2	2	0	1	3	0	0
19	31560775	.	G	A	6	8	14	0	1	15	0	0
19	31569338	.	A	G	1	2	3	0	1	4	0	0
19	31569535	.	C	T	2	2	4	0	0	4	0	0
19	31571563	.	T	C	2	3	5	0	1	6	0	0
19	31571572	.	G	A	3	3	6	0	0	6	0	0
19	31574150	.	G	T	2	3	5	0	0	5	0	0
19	31576055	.	T	C	1	3	4	0	0	4	0	0
19	31576954	.	A	G	3	7	10	0	1	11	0	0
19	31579783	.	T	A	21	14	35	0	0	35	0	0
19	31579860	.	G	T	23	27	50	0	0	50	0	0
19	31580071	.	C	A	1	14	15	0	22	37	0	0
19	31580103	.	A	T	28	16	44	0	3	47	0	0
19	31580160	.	T	A	16	23	39	0	4	43	0	0
19	31580186	.	T	G	11	25	36	0	1	37	0	0
19	31580328	.	A	C	16	3	19	0	21	40	0	0
19	31582349	.	C	T	0	1	1	0	0	1	0	0
19	31583137	.	A	G	9	10	19	0	1	20	0	0
19	31583179	.	C	T	18	8	26	0	1	27	0	0
19	31583289	.	C	T	9	15	24	0	3	27	0	0
19	31583305	.	A	G	12	8	20	0	0	20	0	0
19	31584018	.	T	G	14	18	32	0	0	32	0	0
19	31590601	.	G	A	1	1	2	0	0	2	0	0
19	31593550	.	A	G	5	7	12	0	0	12	0	0
19	31593594	.	C	A	7	7	14	0	0	14	0	0
19	31593595	.	C	A	7	7	14	0	0	14	0	0
19	31593706	.	G	C	9	7	16	0	0	16	0	0
19	31593762	.	G	A	13	8	21	0	2	23	0	0
19	31593957	.	C	T	10	9	19	0	0	19	0	0
19	31596948	.	C	G	1	2	3	0	0	3	0	0
19	31598108	.	G	T	2	2	4	0	0	4	0	0
19	31598113	.	G	A	2	2	4	0	0	4	0	0
19	31603351	.	G	C	5	7	12	0	0	12	0	0
19	31603398	.	C	T	0	3	3	0	1	4	0	0
19	31603416	.	G	C	1	0	1	0	0	1	0	0
19	31612666	.	T	C	4	2	6	0	0	6	0	0
19	31613176	.	G	A	2	4	6	0	1	7	0	0
19	31686155	.	T	G	1	2	3	0	0	3	0	0
19	31771335	.	T	A	23	23	46	0	0	46	0	0
19	31789533	.	C	G	0	5	5	0	4	9	0	0
19	31789666	.	C	T	18	22	40	0	8	48	0	0
19	31790042	.	C	A	30	14	44	0	0	44	0	0
19	31790079	.	A	G	32	15	47	0	0	47	0	0
19	31790097	.	C	T	34	15	49	0	1	50	0	0
19	31790115	.	C	A	13	28	41	0	1	42	0	0
19	31790283	.	G	C	39	22	61	0	3	64	0	0
19	31790385	.	A	G	18	21	39	0	6	45	0	0
19	31797778	.	G	A	1	5	6	0	0	6	0	0
19	31797834	.	G	T	1	5	6	0	1	7	0	0
19	31798162	.	T	C	2	2	4	0	0	4	0	0
19	31798203	.	C	G	2	3	5	0	0	5	0	0
19	31798479	.	C	T	3	5	8	0	0	8	0	0
19	31798660	.	G	A	1	3	4	0	0	4	0	0
19	31798713	.	A	T	2	3	5	0	3	8	0	0
19	31798722	.	C	A	0	3	3	0	4	7	0	0
19	31882114	.	G	A	1	4	5	0	0	5	0	0
19	31891350	.	A	G	8	9	17	0	0	17	0	0
19	31938817	.	T	C	2	4	6	0	2	8	0	0
19	32041686	.	T	C	2	2	4	0	0	4	0	0
19	32041747	.	T	C	1	3	4	0	1	5	0	0
19	32042056	.	C	T	2	2	4	0	0	4	0	0
19	32049055	.	A	G	7	10	17	0	0	17	0	0
19	32049443	.	T	C	12	12	24	0	3	27	0	0
19	32049485	.	A	T	8	13	21	0	1	22	0	0
19	32049775	.	G	A	7	16	23	0	1	24	0	0
19	32049850	.	A	G	13	18	31	0	4	35	0	0
19	32049891	.	A	G	14	15	29	0	1	30	0	0
19	32050174	.	T	G	10	12	22	0	0	22	0	0
19	32050535	.	A	T	20	13	33	0	0	33	0	0
19	32050536	.	T	A	18	13	31	0	2	33	0	0
19	32050593	.	A	T	0	15	15	0	0	15	0	0
19	32050679	.	C	A	9	7	16	0	0	16	0	0
19	32050702	.	G	A	5	11	16	0	0	16	0	0
19	32050944	.	A	T	11	13	24	0	0	24	0	0
19	32051218	.	C	A	4	5	9	0	0	9	0	0
19	32051226	.	G	A	6	3	9	0	0	9	0	0
19	32051541	.	T	G	4	1	5	0	0	5	0	0
19	32051566	.	G	C	0	1	1	0	0	1	0	0
19	32064557	.	T	G	9	12	21	0	1	22	0	0
19	32064872	.	C	T	0	2	2	0	5	7	0	0
19	32149988	.	A	C	14	14	28	0	1	29	0	0
19	32167216	.	T	C	0	0	0	0	0	1	1	0
19	32202141	.	G	A	0	4	4	0	1	5	0	0
19	32202179	.	A	C	1	2	3	0	0	3	0	0
19	32456894	.	A	G	1	0	1	0	3	4	0	0
19	32457087	.	G	T	1	2	3	0	1	4	0	0
19	32457264	.	C	G	5	6	11	0	0	11	0	0
19	32457390	.	T	C	7	4	11	0	0	11	0	0
19	32457564	.	T	C	3	7	10	0	0	10	0	0
19	32458152	.	C	T	7	6	13	0	1	14	0	0
19	32458158	.	T	C	6	6	12	0	1	13	0	0
19	32458255	.	G	A	0	2	2	0	5	7	0	0
19	32458422	.	G	A	1	1	2	0	1	3	0	0
19	32473399	.	A	G	7	5	12	0	0	12	0	0
19	32473451	.	G	A	4	3	7	0	1	8	0	0
19	32473881	.	G	A	1	2	3	0	0	3	0	0
19	32473936	.	C	T	0	3	3	0	5	8	0	0
19	32474031	.	T	G	3	1	4	0	0	4	0	0
19	32474042	.	C	A	0	2	2	0	1	3	0	0
19	32474181	.	G	T	2	3	5	0	0	5	0	0
19	32474193	.	G	T	3	3	6	0	0	6	0	0
19	32474355	.	T	A	6	5	11	0	0	11	0	0
19	32474723	.	G	T	3	2	5	0	0	5	0	0
19	32474885	.	A	G	3	6	9	0	0	9	0	0
19	32487242	.	T	C	2	3	5	0	1	6	0	0
19	32487373	.	T	C	1	5	6	0	0	6	0	0
19	32487408	.	C	T	1	3	4	0	1	5	0	0
19	32490366	.	C	T	2	2	4	0	0	4	0	0
19	32497388	.	C	T	4	1	5	0	0	5	0	0
19	32499736	.	G	A	2	4	6	0	0	6	0	0
19	32499932	.	G	A	3	6	9	0	0	9	0	0
19	32499983	.	G	A	3	2	5	0	0	5	0	0
19	32500130	.	T	C	0	0	0	0	2	2	0	0
19	32500172	.	G	C	1	7	8	0	0	8	0	0
19	32500236	.	T	C	3	3	6	0	0	6	0	0
19	32505825	.	C	T	4	5	9	0	0	9	0	0
19	32505846	.	C	A	3	6	9	0	1	10	0	0
19	32505875	.	C	T	0	9	9	0	3	12	0	0
19	32505927	.	G	T	1	5	6	0	0	6	0	0
19	32515377	.	T	A	6	10	16	0	1	17	0	0
19	32572647	.	T	C	6	5	11	0	1	12	0	0
19	32572999	.	A	T	6	6	12	0	0	12	0	0
19	32573001	.	T	A	6	6	12	0	0	12	0	0
19	32573057	.	G	A	3	6	9	0	1	10	0	0
19	32573064	.	C	T	5	7	12	0	0	12	0	0
19	32573100	.	C	A	6	5	11	0	0	11	0	0
19	32573173	.	T	C	10	0	10	0	4	14	0	0
19	32573193	.	A	G	8	4	12	0	0	13	1	0
19	32573229	.	A	G	11	4	15	0	0	15	0	0
19	32573269	.	T	C	10	10	20	0	0	20	0	0
19	32575190	.	G	A	6	5	11	0	0	11	0	0
19	32582654	.	A	G	2	1	3	0	0	3	0	0
19	32588706	.	C	T	3	5	8	0	0	8	0	0
19	32588775	.	G	A	8	7	15	0	0	15	0	0
19	32600644	.	C	T	0	1	1	0	3	4	0	0
19	32600720	.	A	C	5	6	11	0	1	12	0	0
19	32623259	.	G	A	4	4	8	0	1	9	0	0
19	32623687	.	G	A	19	33	52	0	1	53	0	0
19	32624048	.	A	C	16	24	40	0	2	42	0	0
19	32624138	.	G	A	26	20	46	0	1	47	0	0
19	32624247	.	A	G	14	32	46	0	2	48	0	0
19	32638212	.	G	A	31	22	53	0	3	56	0	0
19	32767799	.	T	C	1	0	1	0	2	3	0	0
19	32767889	.	A	G	2	2	4	0	0	4	0	0
19	32767891	.	T	A	2	2	4	0	0	4	0	0
19	32767965	.	C	T	4	4	8	0	0	8	0	0
19	32768075	.	C	A	1	5	6	0	0	6	0	0
19	32768080	.	A	C	1	5	6	0	0	6	0	0
19	32768397	.	C	G	3	5	8	0	0	8	0	0
19	32768434	.	T	C	3	5	8	0	0	8	0	0
19	32768551	.	C	T	4	2	6	0	0	6	0	0
19	32768668	.	T	C	2	3	5	0	1	6	0	0
19	32768763	.	T	C	3	3	6	0	0	6	0	0
19	32768771	.	G	A	4	3	7	0	0	7	0	0
19	32768880	.	G	T	4	4	8	0	0	8	0	0
19	32768935	.	T	G	3	3	6	0	0	6	0	0
19	32768954	.	A	C	1	3	4	0	0	4	0	0
19	32768985	.	G	A	1	2	3	0	0	3	0	0
19	32769271	.	G	T	4	6	10	0	0	10	0	0
19	32769296	.	T	C	6	6	12	0	0	12	0	0
19	32773651	.	A	G	1	2	3	0	0	3	0	0
19	32774790	.	C	G	0	2	2	0	1	3	0	0
19	32774799	.	G	A	1	1	2	0	0	2	0	0
19	32807301	.	A	T	3	2	5	0	0	5	0	0
19	32807915	.	A	G	3	3	6	0	1	7	0	0
19	32807933	.	A	C	3	3	6	0	0	6	0	0
19	32808140	.	C	T	0	2	2	0	0	2	0	0
19	32808332	.	G	T	0	3	3	0	2	5	0	0
19	32814334	.	G	T	1	5	6	0	0	6	0	0
19	32818503	.	G	T	0	4	4	0	6	10	0	0
19	32818824	.	A	G	9	5	14	0	3	17	0	0
19	32818825	.	G	A	9	8	17	0	0	17	0	0
19	32818910	.	G	A	0	5	5	0	5	10	0	0
19	32819234	.	G	A	8	12	20	0	2	22	0	0
19	32819303	.	T	C	12	13	25	0	0	25	0	0
19	32819347	.	C	T	12	11	23	0	1	24	0	0
19	32819640	.	A	G	3	4	7	0	1	8	0	0
19	32819760	.	A	T	6	9	15	0	0	15	0	0
19	32819798	.	C	T	5	10	15	0	1	16	0	0
19	32838396	.	T	A	3	8	11	0	3	14	0	0
19	32838662	.	C	T	1	2	3	0	0	3	0	0
19	32838666	.	C	T	0	1	1	0	1	2	0	0
19	32860668	.	G	T	12	7	19	0	0	19	0	0
19	32864963	.	T	G	15	15	30	0	0	30	0	0
19	32865113	.	G	A	21	15	36	0	0	36	0	0
19	32865276	.	A	T	15	8	23	0	3	26	0	0
19	32865337	.	C	A	14	12	26	0	0	26	0	0
19	32865347	.	C	T	16	12	28	0	0	28	0	0
19	32866126	.	A	C	10	17	27	0	0	27	0	0
19	32866234	.	T	G	12	9	21	0	1	22	0	0
19	32866264	.	G	C	12	0	12	0	6	18	0	0
19	32866322	.	A	G	9	9	18	0	0	18	0	0
19	32866362	.	T	A	10	13	23	0	1	24	0	0
19	32866372	.	C	T	7	13	20	0	2	22	0	0
19	32866475	.	T	A	14	12	26	0	1	27	0	0
19	32866570	.	T	A	15	18	33	0	3	36	0	0
19	32866571	.	A	G	15	20	35	0	1	36	0	0
19	32866620	.	G	A	8	7	15	0	2	17	0	0
19	32867218	.	G	A	13	11	24	0	2	26	0	0
19	32867274	.	A	T	18	11	29	0	2	32	1	0
19	32872674	.	A	G	8	4	12	0	0	12	0	0
19	32878103	.	G	A	0	1	1	0	0	1	0	0
19	32878370	.	A	G	5	3	8	0	1	9	0	0
19	32884256	.	C	T	0	2	2	0	7	9	0	0
19	32895748	.	G	T	19	12	31	0	0	31	0	0
19	32896001	.	G	A	15	6	21	0	0	21	0	0
19	32896174	.	A	T	4	2	6	0	0	6	0	0
19	32896336	.	G	T	5	6	11	0	2	13	0	0
19	32896427	.	C	A	1	9	10	0	12	22	0	0
19	32896499	.	T	G	18	7	25	0	1	26	0	0
19	32896519	.	T	C	14	8	22	0	0	22	0	0
19	32899313	.	T	A	2	2	4	0	0	4	0	0
19	32899328	.	T	A	0	2	2	0	0	2	0	0
19	32899452	.	A	G	1	1	2	0	0	2	0	0
19	32918241	.	T	A	18	3	21	0	4	25	0	0
19	32918807	.	T	C	4	2	6	0	0	6	0	0
19	32919074	.	A	G	10	3	13	0	2	15	0	0
19	32919215	.	A	T	1	0	1	0	0	1	0	0
19	32928367	.	A	T	1	1	2	0	0	2	0	0
19	32928446	.	T	C	10	0	10	0	6	16	0	0
19	32931100	.	A	T	19	24	43	0	0	43	0	0
19	32931101	.	C	T	0	24	24	0	19	43	0	0
19	32933891	.	C	A	28	27	55	0	2	57	0	0
19	32935480	.	G	C	9	7	16	0	0	16	0	0
19	32936989	.	T	C	7	5	12	0	0	12	0	0
19	32937663	.	C	A	6	6	12	0	0	12	0	0
19	32944034	.	A	G	21	10	31	0	0	31	0	0
19	32979329	.	T	G	2	2	4	0	0	4	0	0
19	32979625	.	A	G	10	8	18	0	2	20	0	0
19	33029392	.	C	T	3	0	3	0	0	3	0	0
19	33029587	.	T	C	3	4	7	0	1	8	0	0
19	33043749	.	T	C	6	3	9	0	0	9	0	0
19	33066783	.	C	G	13	1	14	0	17	31	0	0
19	33071055	.	C	G	12	7	19	0	0	19	0	0
19	33071126	.	G	T	11	12	23	0	1	24	0	0
19	33071172	.	G	T	8	12	20	0	0	20	0	0
19	33071249	.	G	C	9	10	19	0	1	20	0	0
19	33071635	.	A	T	2	3	5	0	1	6	0	0
19	33071795	.	A	T	7	18	25	0	2	27	0	0
19	33123179	.	A	G	3	7	10	0	1	11	0	0
19	33124700	.	A	T	1	4	5	0	0	5	0	0
19	33127718	.	T	C	8	11	19	0	0	19	0	0
19	33131666	.	C	T	3	1	4	0	0	4	0	0
19	33132033	.	T	A	0	1	1	0	0	1	0	0
19	33136410	.	A	G	16	1	17	0	34	51	0	0
19	33137436	.	A	G	20	1	21	0	22	43	0	0
19	33137667	.	C	T	5	4	9	0	0	9	0	0
19	33139195	.	A	G	2	3	5	0	0	5	0	0
19	33139520	.	A	C	1	2	3	0	0	3	0	0
19	33139671	.	C	G	5	0	5	0	5	10	0	0
19	33139701	.	C	A	5	3	8	0	0	8	0	0
19	33139827	.	G	A	1	3	4	0	0	4	0	0
19	33140052	.	T	G	4	2	6	0	0	6	0	0
19	33140259	.	A	C	7	7	14	0	0	14	0	0
19	33203432	.	T	A	2	2	4	0	0	4	0	0
19	33203437	.	C	A	2	2	4	0	0	4	0	0
19	33203744	.	G	A	5	7	12	0	1	13	0	0
19	33205130	.	G	A	6	4	10	0	0	10	0	0
19	33205223	.	T	A	5	3	8	0	0	8	0	0
19	33205255	.	C	G	0	8	8	0	4	12	0	0
19	33205316	.	G	A	6	2	8	0	0	8	0	0
19	33211741	.	T	C	1	3	4	0	1	5	0	0
19	33512144	.	G	A	1	2	3	0	0	3	0	0
19	33513272	.	G	T	0	6	6	0	1	7	0	0
19	33513293	.	A	T	1	5	6	0	0	6	0	0
19	33513322	.	T	C	3	3	6	0	0	6	0	0
19	33514481	.	C	T	2	3	5	0	0	5	0	0
19	33514655	.	G	A	1	4	5	0	0	5	0	0
19	33701679	.	C	T	6	2	8	0	0	8	0	0
19	33701722	.	A	T	7	3	10	0	1	11	0	0
19	33701838	.	G	A	1	5	6	0	10	16	0	0
19	33701887	.	T	A	13	6	19	0	1	20	0	0
19	33701923	.	T	A	11	7	18	0	0	18	0	0
19	33732336	.	G	A	2	5	7	0	0	7	0	0
19	33732393	.	C	T	2	3	5	0	0	5	0	0
19	33755973	.	G	A	0	11	11	0	9	20	0	0
19	33755985	.	A	G	7	0	7	0	12	19	0	0
19	33756009	.	G	T	5	13	18	0	0	18	0	0
19	33765636	.	C	T	14	18	32	0	2	34	0	0
19	33772226	.	T	A	18	13	31	0	2	33	0	0
19	33772280	.	T	C	10	16	26	0	4	30	0	0
19	33775750	.	C	T	9	10	19	0	1	20	0	0
19	33775810	.	T	C	4	6	10	0	0	10	0	0
19	33782757	.	A	G	13	1	14	0	14	28	0	0
19	33782914	.	A	G	7	12	19	0	3	22	0	0
19	33783332	.	A	T	10	12	22	0	1	23	0	0
19	33784221	.	T	A	3	6	9	0	2	11	0	0
19	33784896	.	T	C	20	12	32	0	1	33	0	0
19	33784897	.	C	T	21	12	33	0	0	33	0	0
19	33785094	.	C	T	13	14	27	0	1	28	0	0
19	33785109	.	C	T	11	12	23	0	0	23	0	0
19	33785175	.	G	A	3	19	22	0	1	23	0	0
19	33785197	.	G	A	0	20	20	0	4	24	0	0
19	33785234	.	A	G	8	0	8	0	14	22	0	0
19	33785240	.	T	C	7	14	21	0	1	22	0	0
19	33785357	.	C	A	10	12	22	0	2	24	0	0
19	33785379	.	G	A	13	13	26	0	1	27	0	0
19	33785512	.	T	C	15	9	24	0	2	26	0	0
19	33785704	.	G	T	16	17	33	0	4	37	0	0
19	33785735	.	T	G	15	1	16	0	17	33	0	0
19	33836444	.	A	G	1	2	3	0	0	3	0	0
19	33836747	.	G	A	11	4	15	0	2	17	0	0
19	33837007	.	G	T	10	4	14	0	1	15	0	0
19	33837178	.	G	C	0	1	1	0	0	1	0	0
19	33837183	.	G	A	0	1	1	0	0	1	0	0
19	33847935	.	A	T	2	2	4	0	0	4	0	0
19	33856820	.	A	G	1	2	3	0	0	3	0	0
19	33858734	.	A	G	0	3	3	0	0	3	0	0
19	33861476	.	A	G	1	2	3	0	0	3	0	0
19	33861500	.	T	C	3	2	5	0	0	5	0	0
19	33861796	.	A	G	2	2	4	0	0	4	0	0
19	33864177	.	T	A	1	4	5	0	0	5	0	0
19	33872816	.	T	G	8	4	12	0	0	12	0	0
19	33888520	.	A	C	37	18	55	0	2	57	0	0
19	33888881	.	T	G	7	1	8	0	0	8	0	0
19	33902586	.	G	A	10	5	15	0	0	15	0	0
19	33915802	.	C	T	7	7	14	0	1	15	0	0
19	33921715	.	A	G	5	7	12	0	0	12	0	0
19	33956909	.	C	T	3	1	4	0	0	4	0	0
19	33963773	.	G	T	0	3	3	0	0	3	0	0
19	33964282	.	G	A	3	7	10	0	0	10	0	0
19	33964353	.	A	G	14	8	22	0	3	25	0	0
19	33996170	.	G	A	2	2	4	0	0	4	0	0
19	34074028	.	G	A	8	7	15	0	0	15	0	0
19	34074072	.	A	G	6	8	14	0	1	15	0	0
19	34074386	.	T	G	5	15	20	0	1	21	0	0
19	34089132	.	T	G	10	14	24	0	1	25	0	0
19	34107286	.	T	C	1	2	3	0	0	3	0	0
19	34107295	.	T	C	1	2	3	0	0	3	0	0
19	34208065	.	A	C	1	2	3	0	0	3	0	0
19	34563588	.	T	C	4	12	16	0	1	17	0	0
19	34595032	.	C	T	3	0	3	0	0	3	0	0
19	34602472	.	G	A	1	1	2	0	1	3	0	0
19	34696829	.	T	A	0	1	1	0	0	1	0	0
19	34696921	.	C	T	1	4	5	0	0	5	0	0
19	34698294	.	G	A	1	4	5	0	0	5	0	0
19	34698321	.	A	T	1	4	5	0	0	5	0	0
19	34716569	.	C	T	0	0	0	0	1	1	0	0
19	34720217	.	G	A	3	2	5	0	0	5	0	0
19	34742382	.	C	T	1	2	3	0	0	3	0	0
19	34742818	.	C	T	2	1	3	0	1	4	0	0
19	34744060	.	T	G	1	1	2	0	0	2	0	0
19	34744231	.	T	C	1	3	4	0	0	4	0	0
19	34744288	.	C	A	0	3	3	0	0	3	0	0
19	34746659	.	G	A	6	8	14	0	1	15	0	0
19	34753645	.	G	A	1	1	2	0	0	2	0	0
19	34753669	.	G	C	1	1	2	0	4	6	0	0
19	34770489	.	G	C	0	1	1	0	0	1	0	0
19	34783443	.	C	T	1	0	1	0	0	1	0	0
19	34957672	.	C	T	1	2	3	0	0	3	0	0
19	34960099	.	A	G	1	8	9	0	0	9	0	0
19	34960143	.	A	G	3	5	8	0	0	8	0	0
19	34960147	.	G	A	3	5	8	0	0	8	0	0
19	34960190	.	C	G	0	6	6	0	10	16	0	0
19	34960198	.	T	C	10	7	17	0	2	19	0	0
19	34960315	.	T	A	8	9	17	0	0	17	0	0
19	34960574	.	A	G	1	3	4	0	1	5	0	0
19	34960694	.	T	A	4	5	9	0	0	9	0	0
19	34961152	.	C	T	5	5	10	0	1	11	0	0
19	34961269	.	A	G	0	1	1	0	0	1	0	0
19	35002450	.	G	A	5	4	9	0	0	9	0	0
19	35002508	.	T	A	2	0	2	0	1	3	0	0
19	35002527	.	G	A	0	2	2	0	0	2	0	0
19	35002714	.	A	C	2	5	7	0	0	7	0	0
19	35002723	.	T	C	2	2	4	0	1	5	0	0
19	35003312	.	A	G	1	2	3	1	0	4	0	0
19	35003319	.	G	A	1	2	3	1	0	4	0	0
19	35004117	.	A	C	7	5	12	0	0	12	0	0
19	35004135	.	C	T	6	5	11	0	0	11	0	0
19	35004920	.	G	A	6	5	11	0	0	11	0	0
19	35004941	.	T	C	6	5	11	0	0	11	0	0
19	35005136	.	A	C	5	3	8	0	1	9	0	0
19	35005137	.	A	T	4	3	7	0	2	9	0	0
19	35005318	.	G	A	8	9	17	0	7	24	0	0
19	35007220	.	G	A	1	2	3	0	1	4	0	0
19	35007235	.	G	A	2	1	3	0	0	3	0	0
19	35013806	.	C	T	18	17	35	0	2	37	0	0
19	35016477	.	C	T	0	1	1	0	0	1	0	0
19	35016553	.	T	G	21	12	33	0	0	33	0	0
19	35016646	.	A	T	21	14	35	0	1	36	0	0
19	35016696	.	T	G	12	16	28	0	0	28	0	0
19	35016835	.	C	T	10	8	18	0	2	20	0	0
19	35016962	.	T	A	8	4	12	0	2	14	0	0
19	35019339	.	C	A	1	3	4	0	0	4	0	0
19	35019351	.	T	C	1	2	3	0	0	3	0	0
19	35019490	.	T	A	3	4	7	0	0	7	0	0
19	35019560	.	A	G	3	4	7	0	1	8	0	0
19	35040003	.	G	T	7	4	11	0	1	12	0	0
19	35041158	.	T	A	29	18	47	0	4	51	0	0
19	35041308	.	A	G	24	30	54	0	3	57	0	0
19	35041458	.	T	C	13	1	14	0	7	21	0	0
19	35052411	.	G	T	6	13	19	0	0	19	0	0
19	35052435	.	T	C	7	0	7	0	13	20	0	0
19	35055889	.	A	G	10	8	18	0	0	18	0	0
19	35057869	.	C	T	3	1	4	0	0	4	0	0
19	35058232	.	T	C	5	7	12	0	1	13	0	0
19	35060217	.	A	C	14	17	31	0	0	31	0	0
19	35065906	.	A	T	3	3	6	0	0	6	0	0
19	35067367	.	G	A	10	13	23	0	0	23	0	0
19	35069299	.	G	T	3	2	5	0	0	5	0	0
19	35069755	.	C	A	4	5	9	0	0	10	1	0
19	35069934	.	T	G	1	2	3	0	1	4	0	0
19	35070015	.	C	T	2	9	11	0	2	13	0	0
19	35072613	.	A	C	18	6	24	0	1	25	0	0
19	35072712	.	G	C	5	0	5	0	5	10	0	0
19	35075637	.	C	T	0	15	15	0	15	30	0	0
19	35076301	.	C	T	0	8	8	0	10	18	0	0
19	35076773	.	G	A	10	7	17	0	0	17	0	0
19	35078584	.	T	C	8	0	8	0	10	18	0	0
19	35078632	.	T	C	7	0	7	0	6	13	0	0
19	35079259	.	C	T	3	8	11	0	1	12	0	0
19	35079515	.	A	T	2	1	3	0	0	3	0	0
19	35083010	.	G	A	3	2	5	0	0	5	0	0
19	35083019	.	C	T	2	1	3	0	0	3	0	0
19	35083182	.	C	T	0	1	1	0	1	2	0	0
19	35116228	.	A	G	8	11	19	0	1	20	0	0
19	35116297	.	T	C	8	3	11	0	0	11	0	0
19	35116405	.	A	G	5	9	14	0	1	15	0	0
19	35116438	.	G	A	8	7	15	0	0	15	0	0
19	35118813	.	G	C	4	5	9	0	0	9	0	0
19	35118842	.	T	C	0	3	3	0	0	3	0	0
19	35118860	.	G	T	3	3	6	0	0	6	0	0
19	35118911	.	C	A	7	5	12	0	0	12	0	0
19	35118983	.	A	T	7	6	13	0	0	13	0	0
19	35119039	.	T	C	7	3	10	0	0	10	0	0
19	35119169	.	G	A	3	11	14	0	1	15	0	0
19	35119205	.	G	A	2	10	12	0	0	12	0	0
19	35119436	.	C	T	7	11	18	0	0	18	0	0
19	35121381	.	T	C	6	0	6	0	0	6	0	0
19	35121459	.	T	C	4	2	6	0	0	6	0	0
19	35122875	.	G	A	0	3	3	0	1	4	0	0
19	35122876	.	C	A	0	4	4	0	0	4	0	0
19	35123508	.	T	C	8	0	8	0	10	18	0	0
19	35128238	.	T	C	5	3	8	0	1	9	0	0
19	35131332	.	G	A	0	1	1	0	0	1	0	0
19	35134092	.	G	T	1	1	2	0	0	2	0	0
19	35134181	.	G	A	4	5	9	0	0	9	0	0
19	35135406	.	C	A	0	4	4	0	3	7	0	0
19	35135466	.	G	A	1	2	3	0	0	3	0	0
19	35135927	.	T	G	3	4	7	0	0	7	0	0
19	35135961	.	A	G	5	5	10	0	0	10	0	0
19	35137910	.	A	G	2	3	5	0	0	5	0	0
19	35138260	.	A	G	2	3	5	0	0	5	0	0
19	35155676	.	C	T	4	4	8	0	0	8	0	0
19	35157621	.	C	T	0	1	1	0	3	4	0	0
19	35159665	.	G	T	2	0	2	0	0	2	0	0
19	35159668	.	G	A	2	0	2	0	0	2	0	0
19	35159826	.	G	T	0	2	2	0	0	2	0	0
19	35167278	.	A	T	2	2	4	0	0	4	0	0
19	35167368	.	C	G	1	1	2	0	0	2	0	0
19	35184402	.	A	G	0	3	3	0	0	3	0	0
19	35339938	.	C	T	0	2	2	0	2	4	0	0
19	35339968	.	G	A	1	2	3	0	0	3	0	0
19	35359341	.	C	T	26	19	45	0	0	45	0	0
19	35379917	.	A	G	5	4	9	0	0	9	0	0
19	35379923	.	G	A	5	4	9	0	0	9	0	0
19	35379998	.	A	G	4	5	9	0	0	9	0	0
19	35380031	.	G	A	4	6	10	0	0	10	0	0
19	35380070	.	G	A	9	8	17	0	0	17	0	0
19	35380168	.	T	C	6	0	6	0	3	9	0	0
19	35381625	.	T	A	1	1	2	0	0	2	0	0
19	35381956	.	A	G	4	5	9	0	0	9	0	0
19	35383571	.	G	A	1	1	2	0	2	4	0	0
19	35383586	.	C	T	1	1	2	0	1	3	0	0
19	35386288	.	T	G	2	3	5	0	0	5	0	0
19	35390668	.	T	C	2	4	6	0	2	8	0	0
19	35418974	.	T	A	2	2	4	0	0	4	0	0
19	35419026	.	C	T	1	6	7	0	3	10	0	0
19	35419202	.	A	G	2	6	8	0	0	8	0	0
19	35419215	.	T	A	3	5	8	0	1	9	0	0
19	35422354	.	T	C	3	3	6	0	0	6	0	0
19	35428735	.	G	A	3	1	4	0	0	4	0	0
19	35459414	.	A	G	19	13	32	1	0	33	0	0
19	35459737	.	G	A	20	20	40	0	2	42	0	0
19	35459801	.	A	T	24	19	43	0	2	45	0	0
19	35473080	.	C	A	0	3	3	0	4	7	0	0
19	35723170	.	T	G	2	13	15	0	0	15	0	0
19	35852381	.	A	G	5	2	7	0	0	7	0	0
19	36115044	.	G	A	9	7	16	0	0	16	0	0
19	36115210	.	G	A	14	7	21	0	1	22	0	0
19	36120265	.	C	T	0	3	3	0	7	10	0	0
19	36122534	.	C	T	3	3	6	0	0	6	0	0
19	36139613	.	C	T	1	3	4	0	1	5	0	0
19	36141868	.	G	A	1	2	3	0	0	3	0	0
19	36159141	.	G	A	0	1	1	0	0	1	0	0
19	36167704	.	A	G	5	5	10	0	0	10	0	0
19	36169872	.	A	G	3	1	4	0	0	4	0	0
19	36171084	.	G	A	1	0	1	0	0	1	0	0
19	36212370	.	G	A	2	1	3	0	0	3	0	0
19	36258165	.	C	T	0	1	1	0	3	4	0	0
19	36277799	.	G	A	1	3	4	0	0	4	0	0
19	36287753	.	T	C	0	1	1	0	0	1	0	0
19	36290642	.	A	G	1	0	1	0	0	1	0	0
19	36350821	.	G	A	1	3	4	0	0	4	0	0
19	36350841	.	T	C	5	0	5	0	1	6	0	0
19	36350860	.	C	A	4	2	6	0	0	6	0	0
19	36351155	.	A	G	3	3	6	0	0	6	0	0
19	36365526	.	A	C	0	0	0	0	3	3	0	0
19	36374326	.	T	C	0	0	0	0	2	2	0	0
19	36427054	.	C	G	1	0	1	0	0	1	0	0
19	37122536	.	A	G	5	0	5	0	4	9	0	0
19	37133825	.	G	A	6	5	11	0	0	11	0	0
19	37133844	.	C	T	4	6	10	0	0	10	0	0
19	37138388	.	G	A	0	3	3	0	9	12	0	0
19	37138643	.	G	A	0	15	15	0	11	26	0	0
19	37138955	.	A	G	13	10	23	0	0	23	0	0
19	37478230	.	C	A	2	1	3	0	0	3	0	0
19	37481628	.	C	A	1	4	5	0	0	5	0	0
19	37481658	.	C	T	2	3	5	0	1	6	0	0
19	37484508	.	A	C	0	2	2	0	0	2	0	0
19	37484720	.	G	C	0	6	6	0	4	10	0	0
19	37485121	.	C	T	1	3	4	0	0	4	0	0
19	37488593	.	C	T	1	2	3	0	0	3	0	0
19	37488830	.	C	T	5	2	7	0	0	7	0	0
19	37491644	.	C	A	2	2	4	0	1	5	0	0
19	37491689	.	G	A	2	2	4	0	0	4	0	0
19	37492351	.	G	A	6	6	12	0	0	12	0	0
19	37492514	.	A	T	3	2	5	0	0	5	0	0
19	37501935	.	A	G	21	18	39	0	1	40	0	0
19	37502105	.	A	G	7	6	13	0	1	14	0	0
19	37505808	.	G	A	3	3	6	0	0	6	0	0
19	37702123	.	T	A	3	3	6	0	0	6	0	0
19	37775889	.	C	T	3	4	7	0	0	7	0	0
19	37802904	.	A	G	2	0	2	0	3	5	0	0
19	37802966	.	C	T	5	2	7	0	0	7	0	0
19	37802971	.	A	T	4	2	6	0	0	6	0	0
19	37804452	.	G	A	0	2	2	0	4	6	0	0
19	37804477	.	G	A	0	2	2	0	3	5	0	0
19	37804647	.	C	T	4	2	6	0	0	6	0	0
19	37815763	.	G	A	3	3	6	0	0	6	0	0
19	37835322	.	G	A	3	1	4	0	1	5	0	0
19	37835367	.	G	A	5	7	12	0	0	12	0	0
19	37835433	.	A	C	2	7	9	0	0	9	0	0
19	37835502	.	A	G	0	1	1	0	1	2	0	0
19	37835508	.	T	C	1	1	2	0	0	2	0	0
19	37858144	.	G	C	8	13	21	0	0	21	0	0
19	37926003	.	C	T	18	18	36	0	2	38	0	0
19	37926066	.	C	A	21	15	36	0	1	37	0	0
19	37926653	.	A	T	6	15	21	0	2	23	0	0
19	37926666	.	C	A	7	19	26	0	1	27	0	0
19	37926816	.	T	G	29	13	42	0	0	42	0	0
19	37926865	.	G	A	31	13	44	0	0	44	0	0
19	37927304	.	G	T	0	10	10	0	8	18	0	0
19	38171067	.	G	A	0	4	4	0	0	4	0	0
19	38175399	.	C	T	7	7	14	0	0	14	0	0
19	38175515	.	G	C	6	2	8	0	0	8	0	0
19	38175630	.	A	T	4	4	8	0	0	8	0	0
19	38175655	.	G	A	1	4	5	0	0	5	0	0
19	38227086	.	T	G	1	5	6	0	0	6	0	0
19	38240541	.	A	G	1	0	1	0	2	3	0	0
19	38240844	.	C	T	1	1	2	0	0	2	0	0
19	38327018	.	G	A	1	2	3	0	0	3	0	0
19	38327091	.	A	T	2	5	7	0	0	7	0	0
19	38327377	.	A	T	0	1	1	0	0	1	0	0
19	38474998	.	A	G	2	2	4	0	0	4	0	0
19	38805570	.	G	A	1	0	1	0	0	1	0	0
19	38823928	.	C	T	1	2	3	0	0	3	0	0
19	40026661	.	T	C	16	21	37	0	1	38	0	0
19	40031002	.	G	A	5	6	11	0	0	11	0	0
19	40039603	.	G	A	8	10	18	0	0	18	0	0
19	40039606	.	T	A	8	8	16	0	2	18	0	0
19	40053055	.	A	G	13	0	13	0	19	32	0	0
19	40053061	.	A	T	13	20	33	0	1	34	0	0
19	40055030	.	A	G	4	5	9	0	0	9	0	0
19	40055305	.	A	G	1	0	1	0	0	1	0	0
19	40055318	.	A	G	3	1	4	0	0	4	0	0
19	40071539	.	T	G	0	1	1	0	0	1	0	0
19	40071541	.	G	A	0	1	1	0	0	1	0	0
19	40083731	.	C	T	1	4	5	0	0	5	0	0
19	40085806	.	T	C	2	3	5	0	0	5	0	0
19	40096548	.	G	A	0	1	1	0	0	1	0	0
19	40099361	.	C	T	1	4	5	0	0	5	0	0
19	40099478	.	G	A	2	0	2	0	0	2	0	0
19	40102040	.	A	C	2	1	3	0	0	3	0	0
19	40110840	.	G	A	0	4	4	0	1	5	0	0
19	40113305	.	G	A	0	1	1	0	1	2	0	0
19	40113425	.	C	A	7	4	11	0	1	12	0	0
19	40113549	.	T	G	8	5	13	0	1	14	0	0
19	40113677	.	C	G	8	6	14	0	0	14	0	0
19	40113692	.	G	T	6	4	10	0	0	10	0	0
19	40116117	.	A	T	1	3	4	0	0	4	0	0
19	40121259	.	A	G	2	3	5	0	1	6	0	0
19	40121260	.	T	A	2	3	5	0	1	6	0	0
19	40122463	.	C	A	1	2	3	0	0	3	0	0
19	40122480	.	A	T	1	2	3	0	0	3	0	0
19	40122695	.	G	C	2	2	4	0	0	4	0	0
19	40129299	.	C	T	3	2	5	0	0	5	0	0
19	40129387	.	A	T	5	5	10	0	0	10	0	0
19	40129443	.	A	G	2	1	3	0	0	3	0	0
19	40129474	.	A	G	0	0	0	0	1	1	0	0
19	40137034	.	C	T	3	1	4	0	1	5	0	0
19	40137070	.	T	C	3	2	5	0	0	5	0	0
19	40145423	.	C	T	2	3	5	0	0	5	0	0
19	40145504	.	T	C	3	1	4	0	0	4	0	0
19	40146215	.	G	A	0	0	0	0	1	1	0	0
19	40147821	.	G	A	1	7	8	0	9	17	0	0
19	40149006	.	A	C	2	1	3	0	0	3	0	0
19	40151970	.	G	A	6	6	12	0	3	15	0	0
19	40151983	.	C	T	4	5	9	0	1	10	0	0
19	40155144	.	C	A	4	6	10	0	0	10	0	0
19	40155317	.	T	C	17	2	19	0	1	20	0	0
19	40156870	.	T	C	3	1	4	0	0	4	0	0
19	40160049	.	T	C	8	9	17	0	0	17	0	0
19	40162945	.	C	A	11	15	26	0	1	28	1	0
19	40163256	.	C	T	13	7	20	0	1	21	0	0
19	40165405	.	A	G	19	8	27	0	2	29	0	0
19	40165681	.	A	G	4	0	4	0	3	7	0	0
19	40177406	.	G	T	0	0	0	0	3	3	0	0
19	40177762	.	T	C	1	1	2	0	0	2	0	0
19	40179763	.	G	A	0	1	1	0	1	2	0	0
19	40179858	.	C	A	2	0	2	0	0	2	0	0
19	40180011	.	C	T	8	7	15	0	0	15	0	0
19	40180100	.	A	G	3	5	8	0	0	8	0	0
19	40191250	.	A	G	1	2	3	0	0	3	0	0
19	40326205	.	T	C	1	2	3	0	0	3	0	0
19	40326950	.	C	T	0	1	1	0	1	2	0	0
19	40328334	.	C	G	1	2	3	0	0	3	0	0
19	40340319	.	A	G	2	4	6	0	0	6	0	0
19	40344730	.	A	C	2	1	3	0	0	3	0	0
19	40345966	.	G	T	5	3	8	0	0	8	0	0
19	40347600	.	T	G	1	0	1	0	1	2	0	0
19	40347702	.	T	A	13	21	34	0	1	35	0	0
19	40347760	.	T	A	23	14	37	0	0	37	0	0
19	40347785	.	A	T	18	8	26	0	4	30	0	0
19	40347842	.	G	T	0	6	6	0	3	9	0	0
19	40685448	.	C	T	6	7	13	0	0	13	0	0
19	40685520	.	T	C	7	8	15	0	0	15	0	0
19	40685845	.	G	A	2	6	8	0	0	8	0	0
19	40685935	.	A	G	2	7	9	0	0	9	0	0
19	40686351	.	A	C	3	2	5	0	2	7	0	0
19	40717309	.	G	A	3	5	8	0	0	8	0	0
19	40717649	.	C	A	8	11	19	0	1	20	0	0
19	40859147	.	C	A	6	5	11	0	0	11	0	0
19	40892215	.	G	A	1	1	2	0	0	2	0	0
19	40895763	.	G	A	2	7	9	0	0	9	0	0
19	40895829	.	C	T	2	1	3	0	1	4	0	0
19	40898468	.	C	T	4	5	9	0	0	9	0	0
19	40900132	.	A	C	8	6	14	1	0	15	0	0
19	40900205	.	T	C	7	0	7	0	14	22	1	0
19	40900283	.	G	T	8	4	12	0	1	13	0	0
19	40906094	.	G	A	21	8	29	0	0	29	0	0
19	41031941	.	G	A	0	5	5	0	6	11	0	0
19	41033898	.	C	T	16	16	32	0	0	32	0	0
19	41033929	.	C	A	17	8	25	0	1	26	0	0
19	41034183	.	A	G	4	0	4	0	4	8	0	0
19	41038728	.	T	A	1	2	3	0	1	4	0	0
19	41038855	.	C	T	21	13	34	0	0	34	0	0
19	41038942	.	C	A	22	24	46	0	1	47	0	0
19	41038961	.	A	C	23	20	43	0	0	43	0	0
19	41039012	.	G	C	10	0	10	0	12	22	0	0
19	41052229	.	G	A	13	12	25	0	0	25	0	0
19	41052274	.	G	A	20	23	43	0	1	44	0	0
19	41060384	.	C	T	0	17	17	0	15	32	0	0
19	41060856	.	A	G	9	8	17	0	1	18	0	0
19	41069442	.	G	A	4	7	11	0	0	11	0	0
19	41069564	.	G	C	6	14	20	0	0	20	0	0
19	41080353	.	G	A	1	2	3	0	0	3	0	0
19	41147081	.	C	T	4	3	7	0	0	7	0	0
19	41156254	.	G	A	0	3	3	0	1	4	0	0
19	41160202	.	A	T	1	3	4	0	0	4	0	0
19	41533991	.	A	T	0	8	8	0	0	8	0	0
19	42118441	.	T	A	1	4	5	0	0	5	0	0
19	42573186	.	A	G	0	2	2	0	1	3	0	0
19	42843596	.	A	G	7	5	12	0	1	13	0	0
19	42843640	.	A	G	12	1	13	0	5	18	0	0
19	42843645	.	A	G	13	0	13	0	5	18	0	0
19	42843894	.	A	G	17	18	35	0	2	37	0	0
19	42873905	.	A	G	8	3	11	0	1	12	0	0
19	42997263	.	G	A	0	15	15	0	0	15	0	0
19	42997337	.	C	G	0	7	7	0	0	7	0	0
19	43542261	.	G	A	0	4	4	0	1	5	0	0
19	43547906	.	C	T	0	2	2	0	0	2	0	0
19	43547913	.	A	T	0	2	2	0	0	2	0	0
19	43900144	.	T	C	9	4	13	0	0	13	0	0
19	43901062	.	A	G	6	4	10	0	0	10	0	0
19	45856295	.	A	G	9	11	20	0	0	20	0	0
19	45856414	.	A	G	16	13	29	0	0	29	0	0
19	45859824	.	C	T	10	10	20	0	2	22	0	0
19	45868237	.	A	C	1	4	5	0	0	5	0	0
19	45883626	.	C	A	11	11	22	0	0	22	0	0
19	45962080	.	T	G	2	2	4	0	0	4	0	0
19	45962161	.	A	C	1	5	6	0	1	7	0	0
19	45962171	.	A	G	1	6	7	0	0	7	0	0
19	45967297	.	C	G	4	0	4	0	6	10	0	0
19	45967306	.	A	T	6	4	10	0	1	11	0	0
19	45967372	.	G	A	11	5	16	0	0	16	0	0
19	45967596	.	T	A	4	3	7	0	0	7	0	0
19	45970765	.	G	A	2	4	6	0	0	6	0	0
19	45979306	.	C	T	3	6	9	0	0	9	0	0
19	45979312	.	G	A	0	4	4	0	6	10	0	0
19	45979380	.	C	T	9	5	14	0	0	15	1	0
19	45979394	.	A	G	8	6	14	0	0	14	0	0
19	45979431	.	A	C	6	3	9	0	0	9	0	0
19	45980423	.	T	A	3	4	7	0	1	8	0	0
19	45980428	.	A	C	3	5	8	0	0	8	0	0
19	45994212	.	A	G	4	3	7	0	0	7	0	0
19	46001101	.	A	G	1	0	1	0	0	1	0	0
19	46006240	.	G	A	1	2	3	0	0	3	0	0
19	46015031	.	G	A	1	2	3	0	0	3	0	0
19	46019603	.	G	A	6	6	12	0	2	14	0	0
19	46019616	.	G	T	8	7	15	0	0	15	0	0
19	46019803	.	A	G	11	13	24	0	2	26	0	0
19	46020228	.	G	A	6	14	20	0	1	21	0	0
19	46020453	.	C	A	4	15	19	0	1	20	0	0
19	46020471	.	G	T	5	17	22	0	0	22	0	0
19	46022418	.	A	G	5	2	7	0	1	8	0	0
19	46022453	.	C	T	0	9	9	0	8	17	0	0
19	46032475	.	A	G	8	5	13	0	0	13	0	0
19	46032485	.	G	T	7	7	14	0	0	14	0	0
19	46032527	.	G	T	7	6	13	0	0	13	0	0
19	46032947	.	A	G	5	3	8	0	0	8	0	0
19	46035300	.	C	A	3	4	7	0	1	8	0	0
19	46036290	.	G	A	0	1	1	0	0	1	0	0
19	46036414	.	C	T	2	1	3	0	0	3	0	0
19	46043943	.	G	T	2	2	4	0	1	5	0	0
19	46049173	.	G	A	4	4	8	0	0	8	0	0
19	46050782	.	A	C	1	3	4	0	0	4	0	0
19	46225960	.	C	T	8	0	8	0	1	9	0	0
19	47976325	.	C	T	29	28	57	0	0	57	0	0
2	114825	.	G	A	0	2	2	0	1	3	0	0
2	280612	.	A	G	5	3	8	0	1	9	0	0
2	1062670	.	G	A	0	0	0	0	1	1	0	0
2	1220802	.	T	C	2	0	2	0	0	2	0	0
2	1595275	.	T	C	4	19	23	0	0	23	0	0
2	1595283	.	T	C	18	6	24	0	0	24	0	0
2	1597355	.	T	C	5	3	8	0	0	8	0	0
2	1597617	.	T	C	6	8	14	0	0	14	0	0
2	2988441	.	T	A	7	0	7	0	0	7	0	0
2	3027065	.	T	A	5	6	11	0	0	11	0	0
2	3027066	.	A	T	5	5	10	0	1	11	0	0
2	3028893	.	A	G	0	8	8	0	0	8	0	0
2	3028908	.	A	T	0	5	5	0	0	5	0	0
2	3401100	.	A	C	5	12	17	0	0	17	0	0
2	4045377	.	T	C	12	3	15	0	0	15	0	0
2	4900645	.	T	C	28	10	38	0	5	43	0	0
2	4900650	.	T	C	28	9	37	0	4	41	0	0
2	4900798	.	T	C	12	28	40	0	1	41	0	0
2	5407096	.	A	G	7	3	10	0	1	11	0	0
2	5407137	.	A	G	5	5	10	0	2	12	0	0
2	5579958	.	A	G	9	0	9	0	3	12	0	0
2	5734952	.	T	C	4	5	9	0	1	10	0	0
2	5775963	.	C	A	2	3	5	0	0	5	0	0
2	5811863	.	A	G	1	4	5	0	0	5	0	0
2	5811966	.	G	C	2	4	6	0	1	7	0	0
2	5811971	.	T	G	5	2	7	0	0	7	0	0
2	5812149	.	T	A	6	4	10	0	0	10	0	0
2	5813313	.	C	T	0	3	3	0	1	4	0	0
2	5813681	.	C	T	1	3	4	0	0	4	0	0
2	5813710	.	C	T	4	2	6	0	0	6	0	0
2	5814004	.	C	T	0	3	3	0	0	3	0	0
2	5817327	.	T	G	1	0	1	0	0	1	0	0
2	5830336	.	G	A	0	1	1	0	0	1	0	0
2	5843996	.	C	T	4	2	6	0	0	6	0	0
2	5844019	.	T	G	5	3	8	0	1	9	0	0
2	5844113	.	G	A	5	6	11	0	0	11	0	0
2	5844235	.	A	G	3	5	8	0	0	8	0	0
2	5844242	.	T	A	2	7	9	0	0	9	0	0
2	5852823	.	A	T	0	1	1	0	0	1	0	0
2	5856164	.	A	G	0	2	2	0	0	2	0	0
2	5856206	.	T	C	6	3	9	0	0	9	0	0
2	5856242	.	T	C	7	3	10	0	0	10	0	0
2	5856248	.	A	T	7	3	10	0	0	10	0	0
2	5856326	.	G	T	0	1	1	0	0	1	0	0
2	5856557	.	G	T	0	3	3	0	6	9	0	0
2	5866850	.	T	A	2	3	5	0	0	5	0	0
2	5866977	.	C	T	4	6	10	0	0	10	0	0
2	5866989	.	G	A	5	2	7	0	0	7	0	0
2	5872652	.	C	T	2	2	4	0	0	4	0	0
2	5872950	.	C	T	4	1	5	0	0	5	0	0
2	5880396	.	G	A	4	1	5	0	0	5	0	0
2	5882398	.	A	T	3	3	6	0	1	7	0	0
2	5882726	.	T	C	4	9	13	0	0	13	0	0
2	5882793	.	A	C	5	13	18	0	1	19	0	0
2	5883198	.	G	A	6	7	13	1	1	15	0	0
2	5883558	.	A	T	4	7	11	0	0	11	0	0
2	5884019	.	A	T	5	4	9	0	0	9	0	0
2	5884127	.	A	C	4	4	8	0	1	9	0	0
2	5884322	.	C	T	5	9	14	0	0	14	0	0
2	5884355	.	A	G	1	10	11	0	0	11	0	0
2	5887811	.	G	T	0	3	3	0	0	3	0	0
2	5887812	.	T	A	0	3	3	0	0	3	0	0
2	5898946	.	C	T	0	3	3	0	0	3	0	0
2	5898955	.	C	T	0	1	1	0	0	1	0	0
2	5901471	.	C	T	1	2	3	0	0	3	0	0
2	5919314	.	C	T	6	3	9	0	0	9	0	0
2	5921661	.	C	T	1	2	3	0	0	3	0	0
2	5923178	.	G	C	0	5	5	0	6	11	0	0
2	5923438	.	G	A	8	4	12	0	1	13	0	0
2	5923517	.	G	A	5	8	13	0	0	13	0	0
2	5923679	.	G	A	5	7	12	0	0	12	0	0
2	5923728	.	T	A	0	3	3	0	0	3	0	0
2	5923762	.	C	T	0	6	6	0	0	6	0	0
2	5923863	.	C	T	6	5	11	0	2	13	0	0
2	5923890	.	T	A	3	6	9	0	0	9	0	0
2	5923943	.	C	T	4	3	7	0	0	7	0	0
2	5924085	.	A	T	5	5	10	0	0	10	0	0
2	5934195	.	A	T	4	5	9	0	0	9	0	0
2	5934262	.	C	T	0	10	10	0	8	18	0	0
2	5934804	.	T	G	7	5	12	0	2	14	0	0
2	5935097	.	A	G	6	7	13	0	0	13	0	0
2	5935132	.	C	T	6	9	15	0	0	15	0	0
2	5935137	.	A	G	6	9	15	0	0	15	0	0
2	5935222	.	C	T	1	12	13	0	12	25	0	0
2	5935223	.	G	T	12	12	24	0	1	25	0	0
2	5935294	.	G	A	8	5	13	0	1	14	0	0
2	5935341	.	T	C	1	1	2	0	3	5	0	0
2	5935364	.	A	C	2	6	8	0	0	8	0	0
2	5935425	.	C	T	3	5	8	0	0	8	0	0
2	5935434	.	A	G	4	4	8	0	1	9	0	0
2	5935660	.	A	T	7	4	11	2	1	14	0	0
2	5935861	.	G	T	4	1	5	0	0	5	0	0
2	5936035	.	T	C	2	9	11	0	0	11	0	0
2	5936038	.	A	G	2	8	10	0	0	10	0	0
2	5936071	.	C	T	0	6	6	0	0	6	0	0
2	5936180	.	A	G	2	5	7	0	1	8	0	0
2	5936228	.	G	A	2	5	7	0	0	7	0	0
2	5936248	.	A	C	1	4	5	0	1	6	0	0
2	5936856	.	C	A	2	6	8	0	0	8	0	0
2	5937020	.	C	T	4	4	8	0	0	8	0	0
2	5937035	.	G	A	5	6	11	0	1	12	0	0
2	5937079	.	T	G	2	3	5	0	0	5	0	0
2	5942173	.	T	A	3	1	4	0	0	4	0	0
2	6005568	.	T	G	3	3	6	0	0	6	0	0
2	6037004	.	C	A	0	1	1	0	0	1	0	0
2	6039644	.	C	T	2	2	4	0	0	4	0	0
2	6039678	.	T	C	2	3	5	0	0	5	0	0
2	6042195	.	T	C	12	9	21	0	0	21	0	0
2	6052066	.	T	C	1	0	1	0	2	3	0	0
2	6052179	.	A	T	2	5	7	0	0	7	0	0
2	6052379	.	C	A	4	2	6	0	0	6	0	0
2	6052380	.	A	T	4	2	6	0	0	6	0	0
2	6052580	.	T	A	3	2	5	0	0	5	0	0
2	6052932	.	G	A	6	2	8	0	0	8	0	0
2	6054935	.	A	G	3	0	3	0	0	3	0	0
2	6058633	.	G	A	1	3	4	0	0	4	0	0
2	6073849	.	G	A	0	1	1	0	0	1	0	0
2	6082748	.	T	C	6	3	9	0	1	10	0	0
2	6082752	.	A	C	7	1	8	0	1	9	0	0
2	6089471	.	T	C	6	2	8	0	0	8	0	0
2	6091653	.	A	G	2	3	5	0	0	5	0	0
2	6091689	.	G	A	0	3	3	0	4	7	0	0
2	6091819	.	A	G	2	0	2	0	2	4	0	0
2	6091876	.	A	T	0	3	3	0	0	3	0	0
2	6106727	.	T	C	2	0	2	0	6	8	0	0
2	6106742	.	G	A	3	7	10	0	0	10	0	0
2	6107289	.	G	A	10	12	22	0	0	22	0	0
2	6107310	.	A	T	5	8	13	0	0	13	0	0
2	6126753	.	T	A	13	9	22	0	2	25	1	0
2	6126783	.	A	T	12	6	18	0	0	18	0	0
2	6126857	.	T	C	11	9	20	0	1	21	0	0
2	6143912	.	T	C	2	2	4	0	0	4	0	0
2	6144085	.	G	A	0	5	5	0	8	13	0	0
2	6149006	.	T	C	4	11	15	0	2	17	0	0
2	6149220	.	T	G	1	3	4	0	0	4	0	0
2	6149267	.	C	T	2	4	6	0	0	6	0	0
2	6186956	.	T	A	3	2	5	0	1	6	0	0
2	6187031	.	G	T	7	11	18	0	1	19	0	0
2	6187138	.	T	C	5	10	15	0	1	16	0	0
2	6191691	.	T	C	13	15	28	0	0	28	0	0
2	6191829	.	C	T	0	3	3	0	0	3	0	0
2	6194151	.	T	C	7	4	11	0	4	15	0	0
2	6196798	.	T	A	6	5	11	0	0	11	0	0
2	6196804	.	A	G	6	1	7	0	6	13	0	0
2	6196858	.	C	A	9	12	21	0	0	21	0	0
2	6197216	.	G	T	8	7	15	0	0	15	0	0
2	6197249	.	G	A	8	5	13	0	0	13	0	0
2	6258231	.	C	T	2	4	6	0	0	6	0	0
2	6258564	.	G	A	3	1	4	0	1	5	0	0
2	6265929	.	C	A	17	21	38	0	2	40	0	0
2	6266115	.	T	A	15	15	30	0	0	30	0	0
2	6292405	.	T	G	20	17	37	0	1	38	0	0
2	6292416	.	G	C	20	19	39	0	1	40	0	0
2	6292453	.	G	T	20	19	39	0	1	40	0	0
2	6323084	.	C	T	0	2	2	0	1	3	0	0
2	6326226	.	C	T	0	5	5	0	1	6	0	0
2	6338835	.	A	T	0	1	1	0	0	1	0	0
2	6734490	.	G	A	1	3	4	0	0	4	0	0
2	6761213	.	C	G	6	5	11	0	0	11	0	0
2	6805112	.	G	A	7	10	17	0	0	17	0	0
2	6805363	.	G	A	3	2	5	0	0	5	0	0
2	6886758	.	T	G	4	0	4	0	3	7	0	0
2	6886837	.	G	A	0	6	6	0	5	11	0	0
2	6888679	.	G	A	7	13	20	0	1	21	0	0
2	6926573	.	C	T	4	3	7	0	1	8	0	0
2	6926619	.	C	A	7	2	9	0	1	10	0	0
2	6931552	.	A	G	1	0	1	0	0	1	0	0
2	6941439	.	C	T	0	2	2	0	0	2	0	0
2	6941440	.	G	A	0	2	2	0	0	2	0	0
2	6948707	.	C	T	9	8	17	0	0	17	0	0
2	6948717	.	T	C	10	11	21	0	0	21	0	0
2	6952460	.	G	A	2	12	14	0	6	20	0	0
2	6952596	.	C	T	2	6	8	0	0	8	0	0
2	6952610	.	A	C	2	8	10	0	0	10	0	0
2	6952707	.	A	G	3	5	8	0	0	8	0	0
2	6952740	.	C	A	2	4	6	0	0	6	0	0
2	6958671	.	A	T	14	8	22	0	0	22	0	0
2	6958677	.	A	T	14	8	22	0	1	23	0	0
2	6958940	.	C	A	10	11	21	0	0	21	0	0
2	6958974	.	T	G	5	5	10	0	1	11	0	0
2	7039765	.	C	A	3	9	12	0	0	12	0	0
2	7040053	.	A	T	1	1	2	0	0	2	0	0
2	7040253	.	C	T	1	1	2	0	0	2	0	0
2	7042165	.	C	T	2	3	5	0	0	5	0	0
2	7046777	.	C	T	5	3	8	0	0	8	0	0
2	7051164	.	G	A	0	11	11	0	11	22	0	0
2	7056102	.	G	A	10	6	16	0	2	18	0	0
2	7056359	.	G	T	2	13	15	0	0	15	0	0
2	7056417	.	C	T	5	8	13	0	0	13	0	0
2	7056604	.	A	G	3	0	3	0	7	10	0	0
2	7056610	.	A	G	4	5	9	0	0	9	0	0
2	7056711	.	T	G	4	4	8	0	2	10	0	0
2	7056761	.	G	A	0	4	4	0	8	12	0	0
2	7056763	.	G	A	0	4	4	0	8	12	0	0
2	7057010	.	T	C	6	5	11	0	0	11	0	0
2	7132376	.	C	T	1	2	3	0	0	3	0	0
2	7134386	.	T	C	3	3	6	0	0	6	0	0
2	7150075	.	G	T	8	4	12	0	0	12	0	0
2	7150571	.	C	G	10	5	15	0	0	15	0	0
2	7150573	.	A	G	10	5	15	0	0	15	0	0
2	7150908	.	C	G	7	7	14	0	0	14	0	0
2	7150950	.	A	T	7	8	15	0	3	18	0	0
2	7151148	.	A	G	1	4	5	0	0	5	0	0
2	7151161	.	A	T	1	6	7	0	0	7	0	0
2	7151197	.	C	T	4	7	11	0	1	12	0	0
2	7151392	.	C	A	0	11	11	0	9	20	0	0
2	7151485	.	A	T	10	4	14	0	1	15	0	0
2	7151613	.	A	G	5	4	9	0	0	9	0	0
2	7151647	.	C	G	5	4	9	0	0	9	0	0
2	7151667	.	C	G	2	5	7	0	1	8	0	0
2	7151682	.	C	A	1	8	9	0	1	10	0	0
2	7151843	.	C	A	0	5	5	0	9	14	0	0
2	7152168	.	C	T	1	4	5	0	6	11	0	0
2	7152196	.	T	A	2	4	6	0	0	6	0	0
2	7152263	.	G	A	9	6	15	0	1	16	0	0
2	7152268	.	T	C	10	7	17	0	0	17	0	0
2	7152326	.	G	A	5	6	11	0	0	11	0	0
2	7152350	.	C	A	0	5	5	0	6	11	0	0
2	7152409	.	T	C	2	7	9	0	0	9	0	0
2	7152431	.	T	C	2	9	11	0	0	11	0	0
2	7152469	.	G	T	2	4	6	0	0	6	0	0
2	7152518	.	A	G	2	6	8	0	0	8	0	0
2	7152520	.	C	G	2	6	8	0	0	8	0	0
2	7152681	.	C	A	3	2	5	0	0	5	0	0
2	7153293	.	A	T	6	3	9	0	0	9	0	0
2	7153829	.	T	A	1	3	4	0	0	5	1	0
2	7153861	.	T	C	1	3	4	0	0	4	0	0
2	7154018	.	C	T	0	2	2	0	2	4	0	0
2	7154619	.	T	C	0	4	4	0	0	4	0	0
2	7154626	.	T	C	0	4	4	0	0	4	0	0
2	7163378	.	G	A	4	2	6	0	0	6	0	0
2	7168179	.	T	A	2	8	10	0	0	10	0	0
2	7168257	.	G	A	3	4	7	0	2	9	0	0
2	7168762	.	G	A	3	5	8	0	1	9	0	0
2	7239047	.	C	T	6	5	11	0	1	12	0	0
2	7239079	.	T	C	6	8	14	0	0	14	0	0
2	7239308	.	G	A	4	3	7	0	0	7	0	0
2	7239505	.	T	C	5	9	14	0	1	15	0	0
2	7239812	.	G	A	6	9	15	0	0	15	0	0
2	7239816	.	C	T	6	9	15	0	0	15	0	0
2	7239919	.	A	T	2	5	7	0	1	8	0	0
2	7240378	.	G	A	2	2	4	0	0	4	0	0
2	7240865	.	C	T	0	3	3	0	2	5	0	0
2	7240874	.	G	A	3	1	4	0	0	4	0	0
2	7241356	.	T	G	3	5	8	0	0	8	0	0
2	7241358	.	T	G	3	5	8	0	0	8	0	0
2	7241649	.	C	T	3	1	4	0	1	5	0	0
2	7241704	.	G	C	4	3	7	0	1	8	0	0
2	7241962	.	G	A	7	9	16	0	1	17	0	0
2	7241980	.	T	A	6	7	13	0	1	14	0	0
2	7422454	.	T	C	3	4	7	0	0	7	0	0
2	7422457	.	T	C	3	3	6	0	1	7	0	0
2	7422927	.	C	T	1	3	4	0	8	12	0	0
2	7422939	.	T	C	7	0	7	0	5	12	0	0
2	7423098	.	T	C	1	6	7	0	0	7	0	0
2	7423129	.	T	C	1	7	8	0	0	8	0	0
2	7423142	.	T	C	5	0	5	0	6	11	0	0
2	7602133	.	T	G	5	3	8	0	1	9	0	0
2	7602149	.	A	G	5	4	9	0	0	9	0	0
2	7720800	.	C	T	18	19	37	0	1	38	0	0
2	7720836	.	T	C	16	14	30	0	0	30	0	0
2	7720879	.	C	A	6	2	8	0	0	8	0	0
2	7726414	.	T	A	2	4	6	0	0	6	0	0
2	7726924	.	T	A	19	13	32	0	0	32	0	0
2	7767301	.	C	T	1	4	5	0	0	5	0	0
2	7767314	.	C	T	2	4	6	0	0	6	0	0
2	7768293	.	G	A	0	4	4	0	1	5	0	0
2	7768295	.	A	G	1	2	3	0	2	5	0	0
2	7991728	.	C	A	5	2	7	0	0	7	0	0
2	8062447	.	A	G	3	2	5	0	0	5	0	0
2	8064838	.	G	A	0	3	3	0	0	3	0	0
2	8065311	.	C	T	0	3	3	0	1	4	0	0
2	8066897	.	C	T	0	1	1	0	1	2	0	0
2	8111294	.	G	A	1	1	2	0	1	3	0	0
2	8113705	.	T	C	14	17	31	0	0	31	0	0
2	8113819	.	A	G	17	14	31	0	0	31	0	0
2	8114005	.	G	T	0	15	15	0	10	25	0	0
2	8114179	.	T	C	14	22	36	0	1	37	0	0
2	8840131	.	G	C	0	4	4	1	0	5	0	0
2	9330704	.	G	A	1	3	4	0	0	4	0	0
2	10607686	.	T	C	0	2	2	0	1	3	0	0
2	11209756	.	G	A	2	0	2	0	2	4	0	0
2	11216842	.	C	A	3	2	5	0	0	5	0	0
2	11508771	.	A	G	5	7	12	0	1	13	0	0
2	11509517	.	T	C	22	1	23	0	30	53	0	0
2	11512254	.	C	T	5	4	9	0	0	9	0	0
2	11640026	.	C	T	7	6	13	0	1	14	0	0
2	11640104	.	A	T	4	6	10	0	1	11	0	0
2	11643077	.	C	T	3	4	7	0	0	7	0	0
2	11643084	.	C	G	3	3	6	0	0	6	0	0
2	11648332	.	C	T	10	6	16	0	2	18	0	0
2	11648698	.	C	T	1	3	4	0	0	4	0	0
2	11651573	.	A	T	5	5	10	0	1	11	0	0
2	11654370	.	G	A	3	3	6	0	0	6	0	0
2	11656775	.	A	G	14	13	27	0	0	27	0	0
2	11661234	.	G	A	12	11	23	0	0	24	1	0
2	11661287	.	C	T	0	6	6	0	3	9	0	0
2	11662621	.	A	C	15	13	28	0	2	30	0	0
2	11831218	.	G	A	2	3	5	0	0	5	0	0
2	11831421	.	C	T	6	4	10	0	0	10	0	0
2	11853958	.	T	C	3	0	3	0	1	4	0	0
2	11853995	.	T	C	5	3	8	0	1	9	0	0
2	11854009	.	T	C	7	3	10	0	0	10	0	0
2	11854040	.	T	C	3	3	6	0	1	7	0	0
2	11923921	.	G	A	0	1	1	0	0	1	0	0
2	11926016	.	C	T	2	3	5	0	0	5	0	0
2	11930007	.	A	G	6	7	13	0	0	13	0	0
2	11930012	.	T	C	6	6	12	0	0	12	0	0
2	11930494	.	G	A	2	2	4	0	0	4	0	0
2	11936125	.	T	C	2	2	4	0	0	4	0	0
2	11944741	.	G	A	2	2	4	0	0	4	0	0
2	11945070	.	C	G	3	5	8	0	0	8	0	0
2	11945155	.	A	G	6	0	6	0	5	11	0	0
2	11945171	.	T	C	7	6	13	0	0	13	0	0
2	11945329	.	G	C	3	9	12	0	1	13	0	0
2	11945334	.	G	C	6	8	14	0	1	15	0	0
2	11945679	.	T	A	3	4	7	0	2	9	0	0
2	11945680	.	T	C	5	4	9	0	0	9	0	0
2	11945823	.	T	C	8	5	13	0	0	13	0	0
2	11945864	.	G	C	3	4	7	0	0	7	0	0
2	11965241	.	C	T	6	3	9	0	1	10	0	0
2	11969431	.	A	G	0	2	2	0	0	2	0	0
2	11970199	.	C	T	0	2	2	0	0	2	0	0
2	11976487	.	A	T	3	4	7	0	1	8	0	0
2	11976563	.	C	T	0	6	6	0	7	13	0	0
2	11976603	.	T	C	6	0	6	0	6	12	0	0
2	11976741	.	C	T	0	4	4	0	9	13	0	0
2	11976844	.	G	A	5	2	7	0	0	7	0	0
2	11976896	.	T	G	6	8	14	0	1	16	1	0
2	11977495	.	A	G	5	7	12	0	0	12	0	0
2	11978032	.	T	A	5	6	11	0	1	12	0	0
2	11978137	.	T	A	2	9	11	0	0	11	0	0
2	11978342	.	A	G	8	3	11	0	0	11	0	0
2	11980710	.	C	A	0	0	0	0	1	1	0	0
2	11981009	.	G	C	2	7	9	0	2	11	0	0
2	11998037	.	C	T	3	5	8	0	0	8	0	0
2	11998058	.	T	C	0	1	1	0	0	1	0	0
2	12002323	.	A	G	1	0	1	0	5	6	0	0
2	12002385	.	T	A	3	3	6	0	1	7	0	0
2	12002697	.	A	T	1	5	6	0	0	6	0	0
2	12002766	.	A	G	6	2	8	0	2	10	0	0
2	12002885	.	T	C	2	3	5	0	0	5	0	0
2	12002899	.	T	G	2	3	5	0	0	5	0	0
2	12002945	.	A	T	2	6	8	0	0	9	1	0
2	12002950	.	T	C	2	8	10	0	0	10	0	0
2	12002993	.	C	G	3	4	7	0	0	7	0	0
2	12104948	.	T	A	16	19	35	0	1	36	0	0
2	12104949	.	C	T	16	20	36	0	0	36	0	0
2	12105078	.	A	T	14	11	25	0	0	25	0	0
2	12130837	.	G	A	5	6	11	0	0	11	0	0
2	12130846	.	A	G	4	6	10	0	1	11	0	0
2	12155797	.	A	G	1	2	3	0	0	3	0	0
2	12155959	.	A	C	1	0	1	0	0	1	0	0
2	12242171	.	G	A	3	4	7	0	0	7	0	0
2	12242818	.	G	T	6	6	12	0	2	14	0	0
2	12379872	.	C	T	12	4	16	0	0	16	0	0
2	12405310	.	G	A	1	18	19	0	14	33	0	0
2	12406260	.	C	T	14	9	23	0	1	24	0	0
2	12406490	.	A	G	17	18	35	0	1	36	0	0
2	12407113	.	C	G	15	9	24	0	2	26	0	0
2	12407205	.	T	C	18	0	18	0	14	32	0	0
2	12407586	.	G	T	17	16	33	0	0	33	0	0
2	12407610	.	G	A	16	20	36	0	0	36	0	0
2	12407799	.	C	T	19	11	30	0	1	31	0	0
2	12408085	.	G	A	9	8	17	0	0	17	0	0
2	12429868	.	G	A	3	0	3	0	0	3	0	0
2	12436163	.	A	G	14	5	19	0	0	19	0	0
2	12436202	.	G	A	17	5	22	0	0	22	0	0
2	12481522	.	A	G	1	3	4	0	0	4	0	0
2	12481528	.	A	G	1	2	3	0	0	3	0	0
2	12496522	.	G	C	4	4	8	0	0	8	0	0
2	12502394	.	G	A	1	1	2	0	0	2	0	0
2	12898063	.	C	G	1	0	1	0	0	1	0	0
2	12956071	.	T	G	0	2	2	0	0	2	0	0
2	12982009	.	G	A	1	2	3	0	0	3	0	0
2	12998961	.	T	A	5	3	8	0	0	8	0	0
2	12999296	.	T	C	3	2	5	0	0	5	0	0
2	13000291	.	A	G	1	0	1	0	4	5	0	0
2	13000418	.	G	A	4	5	9	0	0	9	0	0
2	13001291	.	C	A	3	4	7	0	0	7	0	0
2	13003810	.	G	A	1	2	3	0	0	3	0	0
2	13006973	.	A	G	2	0	2	0	3	5	0	0
2	13007141	.	T	A	4	6	10	0	1	11	0	0
2	13007360	.	G	A	3	5	8	0	0	8	0	0
2	13010202	.	A	G	2	4	6	0	0	6	0	0
2	13011555	.	G	T	0	4	4	0	0	4	0	0
2	13018408	.	T	C	4	4	8	0	2	10	0	0
2	13019956	.	A	T	5	3	8	0	0	8	0	0
2	13020122	.	T	A	1	0	1	0	0	1	0	0
2	13020264	.	C	A	4	12	16	0	1	17	0	0
2	13020284	.	G	C	1	9	10	0	3	13	0	0
2	13020611	.	C	A	5	9	14	0	0	14	0	0
2	13023068	.	C	A	6	2	8	0	0	8	0	0
2	13026080	.	G	A	0	12	12	0	9	21	0	0
2	13035847	.	T	A	6	12	18	0	0	18	0	0
2	13036009	.	T	C	17	5	22	0	0	22	0	0
2	13036649	.	G	C	0	4	4	0	6	10	0	0
2	13036769	.	T	C	13	9	22	0	1	23	0	0
2	13036951	.	A	T	19	9	28	0	0	28	0	0
2	13037124	.	T	C	7	9	16	0	2	18	0	0
2	13185332	.	T	G	8	6	14	0	0	14	0	0
2	13185534	.	G	A	6	3	9	0	0	9	0	0
2	13186237	.	A	T	4	9	13	0	1	14	0	0
2	13186333	.	G	T	14	6	20	0	0	20	0	0
2	13186504	.	C	T	20	14	34	0	1	35	0	0
2	13186521	.	T	C	19	17	36	0	0	36	0	0
2	13186986	.	C	T	17	9	26	0	3	29	0	0
2	13187154	.	A	G	19	8	27	0	1	28	0	0
2	13187210	.	T	G	23	18	41	0	0	41	0	0
2	13187263	.	C	A	25	14	39	0	0	39	0	0
2	13187332	.	G	T	18	19	37	0	2	39	0	0
2	13187386	.	T	G	14	17	31	0	7	38	0	0
2	13187507	.	G	A	19	11	30	0	1	31	0	0
2	13187534	.	A	C	21	8	29	0	1	30	0	0
2	13187749	.	T	A	9	8	17	0	0	17	0	0
2	13187781	.	T	C	9	7	16	0	0	16	0	0
2	13187860	.	T	G	5	8	13	0	1	14	0	0
2	13187868	.	G	A	7	8	15	0	2	17	0	0
2	13187905	.	G	A	9	7	16	0	0	16	0	0
2	13187944	.	G	A	19	9	28	0	0	28	0	0
2	13187958	.	C	A	20	12	32	0	0	32	0	0
2	13188073	.	A	T	10	25	35	0	3	38	0	0
2	13215694	.	C	A	16	15	31	0	0	31	0	0
2	13215795	.	G	T	17	18	35	0	1	36	0	0
2	13215870	.	A	G	10	9	19	0	0	19	0	0
2	13224697	.	G	A	8	6	14	0	0	15	1	0
2	13224702	.	T	C	8	5	13	0	0	13	0	0
2	13224981	.	A	G	7	4	11	0	0	11	0	0
2	13225073	.	A	C	5	4	9	0	0	9	0	0
2	13237699	.	A	G	3	3	6	0	0	6	0	0
2	13242171	.	G	A	1	1	2	0	0	2	0	0
2	13254542	.	A	G	5	3	8	0	0	8	0	0
2	13254625	.	C	T	2	7	9	0	0	9	0	0
2	13256668	.	T	G	6	8	14	0	0	14	0	0
2	13256795	.	G	C	5	4	9	0	0	9	0	0
2	13259120	.	G	T	5	6	11	0	0	11	0	0
2	13694984	.	C	T	4	2	6	0	0	6	0	0
2	13710826	.	T	C	3	3	6	0	0	6	0	0
2	13717388	.	C	T	9	12	21	0	0	21	0	0
2	13717651	.	A	G	5	2	7	0	0	7	0	0
2	13743370	.	G	T	3	3	6	0	0	6	0	0
2	13743776	.	C	T	2	9	11	0	0	11	0	0
2	13743907	.	A	T	1	3	4	0	1	5	0	0
2	13744343	.	A	G	5	4	9	0	0	9	0	0
2	13773911	.	G	C	2	3	5	0	0	5	0	0
2	13940480	.	C	T	4	2	6	0	0	6	0	0
2	14278412	.	A	C	8	8	16	0	1	17	0	0
2	14366676	.	T	A	16	6	22	0	2	24	0	0
2	14366886	.	G	C	18	1	19	0	16	35	0	0
2	14445180	.	A	G	3	6	9	0	0	9	0	0
2	14445297	.	C	T	3	3	6	0	0	6	0	0
2	14445697	.	T	C	1	4	5	0	0	5	0	0
2	14454087	.	G	A	0	0	0	0	1	1	0	0
2	14464794	.	T	C	1	0	1	0	3	4	0	0
2	14587157	.	T	C	1	2	3	0	0	3	0	0
2	14655196	.	A	C	1	4	5	0	1	6	0	0
2	14655666	.	G	T	2	4	6	0	0	6	0	0
2	14791200	.	A	T	1	6	7	0	0	7	0	0
2	15035485	.	A	C	2	5	7	0	0	7	0	0
2	15035521	.	C	A	1	3	4	0	0	4	0	0
2	15036227	.	A	G	3	4	7	0	0	7	0	0
2	15039468	.	G	A	1	2	3	0	0	3	0	0
2	15074470	.	C	T	4	5	9	0	1	10	0	0
2	15074491	.	C	T	3	4	7	0	0	7	0	0
2	15075015	.	A	G	2	2	4	0	1	5	0	0
2	15106517	.	A	C	1	2	3	0	0	3	0	0
2	15106545	.	G	A	0	2	2	0	1	3	0	0
2	15109704	.	T	C	6	7	13	0	0	13	0	0
2	15109884	.	A	G	2	2	4	0	0	4	0	0
2	15111806	.	C	T	0	0	0	0	1	1	0	0
2	15111948	.	C	T	1	1	2	0	0	2	0	0
2	15342428	.	T	C	1	0	1	0	3	4	0	0
2	15344015	.	G	A	9	4	13	0	0	13	0	0
2	15344036	.	A	C	7	0	7	0	8	15	0	0
2	15344081	.	A	G	4	7	11	0	0	11	0	0
2	15344120	.	A	G	1	4	5	0	1	6	0	0
2	15344210	.	C	A	0	1	1	0	5	6	0	0
2	15790060	.	A	G	4	5	9	0	0	9	0	0
2	15790135	.	T	G	2	3	5	0	1	6	0	0
2	15864127	.	C	T	6	5	11	0	1	12	0	0
2	15864349	.	G	A	1	3	4	0	2	6	0	0
2	15900093	.	G	A	0	4	4	0	6	10	0	0
2	15942458	.	G	T	11	14	25	0	2	27	0	0
2	15942636	.	A	G	5	2	7	0	0	7	0	0
2	15942877	.	C	T	9	6	15	0	0	15	0	0
2	15942964	.	T	C	5	5	10	0	0	10	0	0
2	16164479	.	C	T	0	6	6	0	1	7	0	0
2	16164536	.	A	G	0	2	2	0	0	2	0	0
2	16172160	.	T	C	2	7	9	0	0	9	0	0
2	16174314	.	G	C	4	5	9	0	0	9	0	0
2	16174346	.	T	C	1	3	4	0	0	4	0	0
2	16176276	.	A	G	6	7	13	0	0	13	0	0
2	16176308	.	G	A	5	6	11	0	0	11	0	0
2	16177521	.	A	G	3	2	5	0	0	5	0	0
2	16177590	.	C	G	3	2	5	0	0	5	0	0
2	16188827	.	A	T	2	3	5	0	0	5	0	0
2	16188834	.	G	A	0	2	2	0	2	4	0	0
2	16191697	.	G	C	0	3	3	0	6	9	0	0
2	16191748	.	A	G	9	13	22	0	4	26	0	0
2	16191841	.	A	C	11	15	26	0	0	26	0	0
2	16194018	.	A	G	7	0	7	0	7	14	0	0
2	16194019	.	T	C	7	7	14	0	0	14	0	0
2	16198864	.	T	C	12	1	13	0	14	27	0	0
2	16198932	.	A	G	14	17	31	0	1	32	0	0
2	16199331	.	A	G	21	21	42	0	2	44	0	0
2	16199332	.	G	A	22	22	44	0	0	44	0	0
2	16199411	.	C	T	2	20	22	0	26	48	0	0
2	16204689	.	T	G	3	3	6	0	0	6	0	0
2	16204716	.	C	G	0	3	3	0	3	6	0	0
2	16206766	.	G	T	8	7	15	0	1	16	0	0
2	16207346	.	T	C	12	10	22	0	1	23	0	0
2	16209406	.	T	C	15	18	33	0	1	34	0	0
2	16209753	.	G	A	27	14	41	0	4	45	0	0
2	16212643	.	G	A	1	4	5	0	0	5	0	0
2	16212924	.	A	G	12	7	19	0	0	19	0	0
2	16212957	.	A	G	13	13	26	0	0	26	0	0
2	16216365	.	T	C	8	0	8	0	3	11	0	0
2	16216524	.	A	T	9	4	13	0	1	14	0	0
2	16216830	.	G	T	8	15	23	0	2	25	0	0
2	16221213	.	T	C	3	0	3	0	6	9	0	0
2	16254439	.	T	G	4	2	6	0	0	6	0	0
2	16254659	.	C	T	0	4	4	0	2	6	0	0
2	16269024	.	A	T	1	3	4	0	0	4	0	0
2	16269431	.	T	A	1	2	3	0	0	3	0	0
2	16365971	.	T	G	2	2	4	0	1	5	0	0
2	16376416	.	G	C	3	3	6	0	0	6	0	0
2	16376687	.	C	T	0	6	6	0	6	12	0	0
2	16376947	.	G	A	5	6	11	0	1	13	1	0
2	16377474	.	A	G	3	3	6	0	0	6	0	0
2	16378171	.	G	A	1	8	9	0	0	9	0	0
2	16378195	.	T	G	1	7	8	0	0	8	0	0
2	16384597	.	G	A	3	1	4	0	2	6	0	0
2	16384615	.	C	T	4	2	6	0	1	7	0	0
2	16390423	.	T	C	1	2	3	0	0	3	0	0
2	16390438	.	C	T	0	2	2	0	1	3	0	0
2	16393337	.	T	C	1	1	2	0	0	2	0	0
2	16393720	.	C	T	1	3	4	0	0	4	0	0
2	16397538	.	A	G	2	3	5	0	0	5	0	0
2	16415498	.	C	G	0	2	2	0	0	2	0	0
2	16458163	.	T	C	2	1	3	0	0	3	0	0
2	16479015	.	A	G	14	7	21	0	1	22	0	0
2	16543474	.	T	C	1	2	3	0	0	3	0	0
2	16543475	.	A	C	1	2	3	0	0	3	0	0
2	16543746	.	G	C	1	2	3	0	0	3	0	0
2	16547866	.	T	C	6	8	14	0	1	15	0	0
2	16548236	.	T	G	8	9	17	0	2	19	0	0
2	16548508	.	T	C	16	6	22	0	1	23	0	0
2	16548514	.	T	C	12	10	22	0	1	23	0	0
2	16554174	.	G	A	1	3	4	0	0	4	0	0
2	16554191	.	A	T	1	3	4	0	0	4	0	0
2	16565384	.	T	G	7	5	12	0	0	12	0	0
2	16565424	.	T	C	15	5	20	0	0	20	0	0
2	16589703	.	T	G	1	1	2	0	0	2	0	0
2	16594482	.	A	G	0	2	2	0	1	3	0	0
2	16594510	.	T	G	0	2	2	0	0	2	0	0
2	16594528	.	T	G	0	5	5	0	0	5	0	0
2	16594575	.	T	C	1	6	7	0	0	7	0	0
2	16594616	.	T	A	1	2	3	0	0	3	0	0
2	16594697	.	T	C	1	1	2	0	0	2	0	0
2	16594906	.	C	T	1	4	5	0	0	5	0	0
2	16614840	.	C	T	2	1	3	0	0	3	0	0
2	16617854	.	G	A	1	3	4	0	0	4	0	0
2	16632788	.	T	C	3	2	5	0	0	5	0	0
2	16637276	.	G	A	1	1	2	0	0	2	0	0
2	16637277	.	A	T	1	1	2	0	0	2	0	0
2	16638432	.	C	G	0	1	1	0	0	1	0	0
2	16639434	.	G	A	1	0	1	0	1	2	0	0
2	16639435	.	C	G	1	1	2	0	0	2	0	0
2	16639664	.	T	A	2	0	2	0	1	3	0	0
2	16639827	.	G	T	3	1	4	0	1	6	1	0
2	16642963	.	T	C	0	1	1	0	0	1	0	0
2	16643054	.	C	T	0	1	1	0	0	1	0	0
2	16643718	.	T	C	1	2	3	0	0	3	0	0
2	16645852	.	T	A	6	3	9	0	2	11	0	0
2	16646377	.	T	A	2	10	12	0	0	12	0	0
2	16646475	.	T	C	9	9	18	0	0	18	0	0
2	16646519	.	A	T	6	9	15	0	0	15	0	0
2	16646593	.	T	C	4	5	9	0	1	10	0	0
2	16646684	.	A	G	2	2	4	0	0	4	0	0
2	16646693	.	T	C	2	1	3	0	0	3	0	0
2	16702630	.	T	C	3	0	3	0	0	3	0	0
2	16706898	.	T	A	18	17	35	0	1	36	0	0
2	16706994	.	T	C	14	15	29	0	2	31	0	0
2	16707014	.	C	A	14	18	32	0	0	32	0	0
2	16707030	.	G	T	18	17	35	0	0	35	0	0
2	16707056	.	C	G	18	17	35	0	2	37	0	0
2	16707290	.	G	T	4	10	14	0	1	15	0	0
2	16707329	.	A	C	11	15	26	0	0	26	0	0
2	16707509	.	C	A	14	20	34	0	3	37	0	0
2	16707582	.	T	A	11	14	25	0	1	26	0	0
2	16707631	.	C	G	15	6	21	0	2	23	0	0
2	16707718	.	G	A	2	5	7	0	0	7	0	0
2	16723925	.	C	G	0	1	1	0	0	1	0	0
2	16728507	.	T	C	2	3	5	0	0	5	0	0
2	16731783	.	C	T	5	3	8	0	1	9	0	0
2	16734657	.	A	G	0	1	1	0	0	1	0	0
2	16735052	.	G	T	4	5	9	0	0	9	0	0
2	16735160	.	G	A	5	10	15	0	1	16	0	0
2	16735262	.	G	A	0	4	4	0	4	8	0	0
2	16735292	.	C	A	1	1	2	0	0	2	0	0
2	16736612	.	C	T	3	1	4	1	0	5	0	0
2	16736678	.	T	C	10	14	24	0	0	24	0	0
2	16736941	.	T	A	11	11	22	0	0	22	0	0
2	16736964	.	T	C	8	9	17	0	1	18	0	0
2	16737086	.	C	T	11	5	16	0	1	17	0	0
2	16798805	.	A	G	1	1	2	0	0	2	0	0
2	16829585	.	A	G	2	2	4	0	0	4	0	0
2	17728132	.	G	A	0	1	1	0	0	1	0	0
2	17946951	.	T	C	4	0	4	0	2	6	0	0
2	17947129	.	A	G	5	8	13	0	0	13	0	0
2	18698517	.	C	A	13	18	31	0	0	31	0	0
2	18698560	.	T	A	16	13	29	0	2	31	0	0
2	18698648	.	G	A	9	12	21	0	1	22	0	0
2	18698659	.	G	T	8	12	20	0	0	20	0	0
2	18698686	.	C	T	11	12	23	0	0	23	0	0
2	18698912	.	C	G	22	11	33	0	0	33	0	0
2	18698920	.	G	A	22	11	33	0	0	33	0	0
2	18698957	.	A	T	22	13	35	0	1	36	0	0
2	18699071	.	G	A	19	9	28	0	1	29	0	0
2	18699192	.	C	T	12	11	23	0	1	24	0	0
2	18699315	.	C	G	14	11	25	0	0	25	0	0
2	18699474	.	G	T	19	21	40	0	1	41	0	0
2	18699533	.	T	A	12	21	33	0	2	35	0	0
2	18699586	.	G	T	9	18	27	0	1	28	0	0
2	18699590	.	G	T	11	19	30	0	0	30	0	0
2	18700148	.	G	A	15	12	27	0	0	27	0	0
2	18700194	.	T	A	10	14	24	0	0	24	0	0
2	18700346	.	A	T	6	6	12	0	0	12	0	0
2	18700484	.	C	T	4	3	7	0	0	7	0	0
2	18700489	.	A	G	3	2	5	0	0	5	0	0
2	18700554	.	A	C	2	2	4	0	0	4	0	0
2	18700750	.	G	A	9	10	19	0	0	19	0	0
2	18700753	.	G	A	9	10	19	0	0	19	0	0
2	18701033	.	G	A	7	15	22	0	0	22	0	0
2	18701228	.	A	G	7	13	20	0	2	22	0	0
2	18701232	.	T	C	8	12	20	0	2	22	0	0
2	18701367	.	A	T	17	6	23	0	0	23	0	0
2	18701380	.	G	T	17	5	22	0	0	22	0	0
2	18701576	.	T	C	3	7	10	0	0	10	0	0
2	18701779	.	T	C	12	6	18	0	0	18	0	0
2	18701827	.	A	C	12	9	21	0	1	22	0	0
2	18701924	.	A	T	4	6	10	0	0	10	0	0
2	18701982	.	T	A	4	9	13	0	0	13	0	0
2	18702029	.	C	T	5	5	10	0	0	10	0	0
2	18702199	.	A	T	10	7	17	0	0	17	0	0
2	18702222	.	G	T	8	5	13	0	0	13	0	0
2	18702359	.	G	T	6	1	7	0	1	8	0	0
2	18702657	.	G	T	8	20	28	0	1	29	0	0
2	18702710	.	T	C	13	0	13	0	14	27	0	0
2	18702716	.	A	C	11	12	23	0	1	25	1	0
2	18702772	.	G	A	4	8	12	0	1	13	0	0
2	18702825	.	T	G	7	14	21	0	0	21	0	0
2	18702861	.	C	A	4	10	14	0	0	14	0	0
2	18702862	.	A	G	4	10	14	0	0	14	0	0
2	18703265	.	T	A	10	13	23	0	1	24	0	0
2	18703273	.	A	G	10	15	25	0	0	25	0	0
2	18703344	.	A	T	11	16	27	0	1	28	0	0
2	18703345	.	T	G	9	17	26	0	2	28	0	0
2	18714519	.	A	G	3	5	8	0	0	8	0	0
2	18725918	.	G	A	7	10	17	0	0	17	0	0
2	18735032	.	A	G	7	9	16	0	0	16	0	0
2	18735038	.	A	G	7	10	17	0	0	17	0	0
2	18830386	.	A	G	7	10	17	0	0	17	0	0
2	18830493	.	G	A	4	6	10	0	1	11	0	0
2	18830645	.	T	A	2	4	6	0	0	6	0	0
2	18830646	.	G	A	2	4	6	0	0	6	0	0
2	18990241	.	G	C	28	21	49	0	3	52	0	0
2	18991317	.	T	C	8	9	17	0	0	17	0	0
2	18991362	.	T	C	28	28	56	0	1	57	0	0
2	18992144	.	G	C	22	24	46	0	0	46	0	0
2	19100786	.	A	T	8	6	14	0	0	14	0	0
2	19100788	.	A	T	8	6	14	0	0	14	0	0
2	19101393	.	A	T	9	6	15	0	0	15	0	0
2	19101485	.	T	G	1	0	1	0	0	2	1	0
2	19101732	.	C	G	11	5	16	0	0	16	0	0
2	19101950	.	A	G	6	6	12	0	0	12	0	0
2	19102757	.	T	A	3	5	8	0	0	8	0	0
2	19103424	.	C	A	1	4	5	0	0	5	0	0
2	19104850	.	G	A	6	9	15	0	1	16	0	0
2	19109272	.	G	T	0	1	1	0	0	1	0	0
2	19109300	.	T	A	0	2	2	0	0	2	0	0
2	19214451	.	T	C	1	3	4	0	1	5	0	0
2	19247451	.	C	A	0	1	1	0	0	1	0	0
2	19273227	.	C	T	2	2	4	0	0	4	0	0
2	19280915	.	A	T	0	4	4	0	0	4	0	0
2	19281295	.	T	G	3	4	7	0	0	7	0	0
2	19290129	.	A	G	4	6	10	0	0	10	0	0
2	19308439	.	G	C	4	4	8	0	0	8	0	0
2	19318112	.	C	A	1	4	5	0	0	5	0	0
2	19318459	.	T	C	4	6	10	0	0	10	0	0
2	19318791	.	A	G	2	2	4	0	0	4	0	0
2	19643123	.	G	A	2	1	3	0	0	3	0	0
2	19645797	.	T	A	0	4	4	0	0	4	0	0
2	19645840	.	T	C	1	6	7	0	0	7	0	0
2	19646233	.	G	A	1	2	3	0	0	3	0	0
2	19784751	.	C	T	8	6	14	0	0	14	0	0
2	19794484	.	C	T	9	8	17	0	1	19	1	0
2	19794753	.	A	G	11	11	22	0	0	22	0	0
2	19794847	.	T	G	11	0	11	0	19	30	0	0
2	19794937	.	C	T	14	12	26	0	1	27	0	0
2	19795249	.	C	T	14	6	20	0	1	21	0	0
2	19795301	.	A	G	10	9	19	0	0	19	0	0
2	19795333	.	G	C	9	11	20	0	0	20	0	0
2	19795344	.	G	A	0	13	13	0	7	20	0	0
2	19795400	.	A	G	5	18	23	0	0	23	0	0
2	20145760	.	T	C	6	2	8	0	0	8	0	0
2	20323825	.	A	G	1	4	5	0	0	5	0	0
2	20323830	.	A	T	1	4	5	0	0	5	0	0
2	20331937	.	C	A	2	3	5	0	0	5	0	0
2	20332061	.	T	A	5	3	8	0	0	8	0	0
2	20332135	.	A	G	3	3	6	0	0	6	0	0
2	20367927	.	G	T	6	9	15	0	1	16	0	0
2	20368101	.	T	C	8	5	13	0	0	13	0	0
2	20368173	.	T	C	9	7	16	0	1	17	0	0
2	20368320	.	G	A	2	8	10	0	0	10	0	0
2	20368383	.	A	G	5	1	6	0	3	9	0	0
2	20368537	.	A	C	15	12	27	0	0	27	0	0
2	20368569	.	A	C	18	13	31	0	2	33	0	0
2	20368812	.	G	A	16	15	31	0	2	33	0	0
2	20368965	.	C	T	21	20	41	0	1	42	0	0
2	20369162	.	A	C	13	10	23	0	3	26	0	0
2	20369240	.	T	G	15	28	43	0	0	43	0	0
2	20369516	.	A	G	19	21	40	0	2	42	0	0
2	20369836	.	A	T	13	26	39	0	0	39	0	0
2	20369925	.	T	A	14	16	30	0	0	30	0	0
2	20369947	.	A	C	14	9	23	0	6	29	0	0
2	20370090	.	G	C	14	18	32	0	0	32	0	0
2	20370143	.	C	T	21	11	32	0	1	33	0	0
2	20370792	.	T	C	24	18	42	0	1	43	0	0
2	20370893	.	C	T	15	14	29	0	0	29	0	0
2	20370998	.	A	G	18	14	32	0	0	32	0	0
2	20371060	.	T	A	18	3	21	0	1	22	0	0
2	20371210	.	G	C	3	6	9	0	3	12	0	0
2	20437703	.	C	A	6	7	13	0	0	13	0	0
2	20437826	.	G	A	0	9	9	0	5	14	0	0
2	20437834	.	C	T	4	9	13	0	0	13	0	0
2	20437878	.	G	A	3	6	9	0	1	10	0	0
2	20437901	.	G	T	2	8	10	0	0	10	0	0
2	20437916	.	G	T	4	5	9	0	0	9	0	0
2	20438061	.	A	T	14	15	29	0	1	30	0	0
2	20438110	.	C	A	8	10	18	0	1	19	0	0
2	20438167	.	G	A	1	16	17	0	8	25	0	0
2	20438219	.	G	A	11	16	27	0	1	28	0	0
2	20438373	.	A	G	11	6	17	0	1	18	0	0
2	20438443	.	G	A	11	12	23	0	1	24	0	0
2	20438589	.	C	T	8	9	17	0	1	18	0	0
2	20438876	.	A	C	15	15	30	0	1	31	0	0
2	20439089	.	T	C	11	17	28	0	0	28	0	0
2	20439303	.	C	T	8	11	19	0	0	19	0	0
2	20439490	.	A	G	14	11	25	0	3	28	0	0
2	20440244	.	G	A	0	1	1	0	0	1	0	0
2	20440307	.	A	C	0	6	6	0	0	6	0	0
2	20440328	.	C	A	0	1	1	0	0	1	0	0
2	20442735	.	G	A	5	7	12	0	1	13	0	0
2	20442939	.	A	G	6	7	13	0	1	14	0	0
2	20475831	.	A	G	4	5	9	0	0	9	0	0
2	20487136	.	A	C	3	5	8	0	1	9	0	0
2	20487211	.	C	T	4	3	7	0	0	7	0	0
2	20496574	.	T	C	2	3	5	0	0	5	0	0
2	20496616	.	T	A	4	10	14	0	1	15	0	0
2	20503698	.	C	A	8	13	21	0	0	21	0	0
2	20503734	.	T	G	10	0	10	0	18	28	0	0
2	20503770	.	C	T	3	7	10	0	0	10	0	0
2	20505995	.	C	T	2	5	7	0	0	7	0	0
2	20506067	.	G	A	3	3	6	0	0	6	0	0
2	20506439	.	T	C	8	6	14	0	0	14	0	0
2	20509561	.	A	G	9	11	20	0	2	22	0	0
2	20509603	.	A	T	6	4	10	0	0	10	0	0
2	20511713	.	C	A	5	5	10	0	0	10	0	0
2	20511725	.	T	C	5	7	12	0	1	13	0	0
2	20511770	.	C	T	2	5	7	0	0	7	0	0
2	20514915	.	A	G	1	0	1	0	0	1	0	0
2	20515377	.	C	T	1	1	2	0	0	2	0	0
2	20516291	.	G	A	3	3	6	0	1	7	0	0
2	20518033	.	A	G	8	14	22	0	0	22	0	0
2	20518057	.	C	G	8	11	19	0	1	20	0	0
2	20518081	.	T	C	2	7	9	0	0	9	0	0
2	20518093	.	C	T	0	4	4	0	0	4	0	0
2	20520618	.	T	C	11	21	32	0	4	36	0	0
2	20520636	.	T	C	13	22	35	0	1	36	0	0
2	20614879	.	T	C	4	2	6	0	0	6	0	0
2	20662405	.	C	G	1	3	4	0	1	5	0	0
2	20811104	.	G	A	2	4	6	0	0	6	0	0
2	20811728	.	A	T	7	4	11	0	1	12	0	0
2	20811739	.	A	G	6	5	11	0	0	11	0	0
2	20811792	.	A	C	9	4	13	0	0	13	0	0
2	20814225	.	A	T	0	1	1	0	0	1	0	0
2	20814754	.	G	T	0	2	2	0	0	2	0	0
2	20817736	.	G	A	2	4	6	0	0	6	0	0
2	20819762	.	G	T	8	17	25	0	3	28	0	0
2	20820587	.	C	T	8	2	10	0	0	10	0	0
2	20824654	.	T	C	2	0	2	0	2	4	0	0
2	20826495	.	T	C	2	3	5	0	0	5	0	0
2	20828322	.	A	G	12	10	22	0	0	22	0	0
2	20830336	.	A	G	2	6	8	0	0	8	0	0
2	20830342	.	C	T	3	7	10	0	0	10	0	0
2	20830993	.	C	G	6	3	9	0	1	10	0	0
2	20833345	.	G	A	5	1	6	0	0	6	0	0
2	20833432	.	A	C	2	0	2	0	7	9	0	0
2	20833914	.	C	T	1	5	6	0	0	6	0	0
2	20833917	.	A	C	1	5	6	0	0	6	0	0
2	20837017	.	G	A	1	2	3	0	0	3	0	0
2	20840328	.	T	C	4	3	7	0	0	7	0	0
2	20840539	.	C	A	6	11	17	0	0	17	0	0
2	20840596	.	C	T	0	2	2	0	0	2	0	0
2	20840837	.	T	C	3	0	3	0	3	6	0	0
2	20844349	.	T	C	3	2	5	0	0	5	0	0
2	20870961	.	T	C	0	2	2	0	0	2	0	0
2	20871012	.	G	A	0	1	1	0	2	3	0	0
2	20874515	.	T	C	1	0	1	0	0	1	0	0
2	20875064	.	C	T	5	4	9	0	1	10	0	0
2	20875112	.	G	A	0	4	4	0	6	10	0	0
2	20875166	.	C	T	0	3	3	0	0	3	0	0
2	20875175	.	A	G	0	3	3	0	0	3	0	0
2	20875922	.	T	A	0	2	2	0	1	3	0	0
2	20916956	.	C	T	2	2	4	0	0	4	0	0
2	20973176	.	C	T	6	3	9	0	1	10	0	0
2	20973369	.	G	A	2	2	4	0	0	4	0	0
2	20973419	.	G	A	1	2	3	0	0	3	0	0
2	20973698	.	A	G	3	2	5	0	0	5	0	0
2	20973864	.	G	A	0	2	2	0	7	9	0	0
2	20973966	.	G	A	0	5	5	1	4	11	1	0
2	20974085	.	G	A	4	2	6	0	0	6	0	0
2	20974232	.	G	T	4	3	7	0	0	7	0	0
2	20974244	.	A	T	3	5	8	0	0	8	0	0
2	20974867	.	G	A	2	2	4	0	1	5	0	0
2	20974880	.	T	C	3	2	5	0	0	5	0	0
2	20975451	.	T	C	5	4	9	0	1	10	0	0
2	20980280	.	C	G	4	6	10	0	0	10	0	0
2	21064752	.	T	C	9	3	12	0	0	12	0	0
2	21064754	.	T	C	9	3	12	0	0	12	0	0
2	21064800	.	T	A	5	3	8	0	1	9	0	0
2	21071401	.	T	A	1	0	1	0	0	1	0	0
2	21073286	.	T	A	4	2	6	0	0	6	0	0
2	21073350	.	A	C	0	3	3	0	0	3	0	0
2	21076203	.	C	T	6	6	12	0	4	16	0	0
2	21076342	.	T	C	6	6	12	0	0	12	0	0
2	21076542	.	G	A	5	4	9	0	0	9	0	0
2	21076763	.	G	A	7	3	10	0	0	10	0	0
2	21076774	.	C	T	9	3	12	0	0	12	0	0
2	21076932	.	A	T	8	3	11	0	0	11	0	0
2	21077191	.	A	C	14	0	14	0	14	28	0	0
2	21077208	.	C	G	16	14	30	0	1	31	0	0
2	21077390	.	G	A	10	7	17	0	1	18	0	0
2	21077466	.	C	A	10	4	14	0	1	15	0	0
2	21077726	.	C	T	4	4	8	0	1	9	0	0
2	21077967	.	G	A	17	16	33	0	0	33	0	0
2	21079612	.	T	C	8	10	18	0	0	18	0	0
2	21080291	.	G	A	7	8	15	0	1	16	0	0
2	21081087	.	T	A	11	9	20	0	2	22	0	0
2	21082460	.	C	A	17	19	36	0	2	38	0	0
2	21082585	.	C	G	3	5	8	0	0	8	0	0
2	21082596	.	C	A	3	4	7	0	0	7	0	0
2	21135461	.	T	C	6	4	10	0	1	11	0	0
2	21151002	.	T	C	1	1	2	0	0	2	0	0
2	21156207	.	T	C	6	4	10	0	0	10	0	0
2	21156350	.	G	A	8	4	12	0	1	13	0	0
2	21156613	.	T	A	1	5	6	0	0	6	0	0
2	21156809	.	T	A	10	8	18	0	3	21	0	0
2	21165176	.	G	A	10	5	15	0	0	15	0	0
2	21166042	.	A	G	3	2	5	0	0	5	0	0
2	21167395	.	G	A	0	0	0	0	1	1	0	0
2	21175143	.	A	G	6	2	8	0	9	17	0	0
2	21177237	.	G	A	1	1	2	0	0	2	0	0
2	21179651	.	A	G	5	8	13	0	2	15	0	0
2	21179866	.	T	G	14	11	25	0	0	25	0	0
2	21179939	.	A	G	15	18	33	0	0	33	0	0
2	21182451	.	G	T	4	4	8	0	3	11	0	0
2	21182482	.	G	T	6	5	11	0	1	12	0	0
2	21298857	.	C	A	1	2	3	0	0	3	0	0
2	21300087	.	G	A	1	1	2	0	1	3	0	0
2	21312257	.	T	C	3	4	7	0	0	7	0	0
2	21312464	.	T	C	5	2	7	0	0	7	0	0
2	21312866	.	G	A	0	3	3	0	2	5	0	0
2	21312877	.	C	A	2	4	6	0	0	6	0	0
2	21317042	.	C	T	4	4	8	0	1	9	0	0
2	21320445	.	T	C	6	3	9	0	0	9	0	0
2	21320537	.	C	T	5	3	8	0	0	8	0	0
2	21320664	.	C	T	5	3	8	0	0	8	0	0
2	21320837	.	A	G	4	5	9	0	1	10	0	0
2	21321015	.	A	G	1	5	6	0	1	7	0	0
2	21338276	.	T	C	3	1	4	0	0	4	0	0
2	21371159	.	G	A	4	3	7	0	0	7	0	0
2	21376407	.	C	T	2	6	8	0	0	8	0	0
2	21381230	.	C	T	4	4	8	0	2	10	0	0
2	21459157	.	T	C	4	7	11	0	0	11	0	0
2	21459196	.	C	T	5	8	13	0	0	13	0	0
2	21459701	.	C	A	4	3	7	0	0	7	0	0
2	21463923	.	A	T	17	16	33	0	1	34	0	0
2	21466555	.	T	C	19	11	30	0	1	31	0	0
2	21466567	.	A	T	18	12	30	0	2	32	0	0
2	21468732	.	T	G	17	12	29	0	1	30	0	0
2	21468825	.	G	A	14	19	33	0	1	34	0	0
2	21468953	.	C	T	11	10	21	0	0	21	0	0
2	21469080	.	T	G	12	7	19	0	1	20	0	0
2	21469490	.	T	C	12	11	23	0	0	23	0	0
2	21469577	.	A	G	13	5	18	0	0	18	0	0
2	21469579	.	T	G	13	5	18	0	0	18	0	0
2	21469644	.	A	G	12	4	16	0	0	16	0	0
2	21487190	.	G	A	4	2	6	0	1	7	0	0
2	21502364	.	C	T	2	4	6	0	0	6	0	0
2	21607456	.	G	C	6	3	9	0	0	9	0	0
2	21608582	.	G	A	7	18	25	0	0	25	0	0
2	21608587	.	C	T	8	16	24	0	1	25	0	0
2	21608880	.	T	A	3	3	6	0	0	6	0	0
2	21609016	.	A	T	6	6	12	0	0	12	0	0
2	21609223	.	C	T	0	2	2	0	3	5	0	0
2	21609443	.	C	A	5	6	11	0	0	11	0	0
2	21609446	.	C	T	5	6	11	0	0	11	0	0
2	21612356	.	T	G	6	4	10	0	1	11	0	0
2	21612380	.	C	T	0	6	6	0	8	14	0	0
2	21618394	.	G	C	0	2	2	0	0	2	0	0
2	21621762	.	T	C	8	4	12	0	0	12	0	0
2	21634467	.	G	C	1	0	1	0	0	1	0	0
2	21733971	.	A	G	1	3	4	0	0	4	0	0
2	21766237	.	G	A	7	7	14	0	1	15	0	0
2	21766277	.	G	A	5	8	13	0	4	17	0	0
2	21766319	.	G	A	9	10	19	0	2	21	0	0
2	21766323	.	A	G	10	10	20	0	1	21	0	0
2	21766478	.	T	A	4	7	11	0	1	12	0	0
2	21767207	.	C	T	14	13	27	0	1	28	0	0
2	21767286	.	T	C	5	5	10	0	0	10	0	0
2	21768168	.	G	A	3	5	8	0	1	9	0	0
2	21769256	.	A	G	2	3	5	0	0	5	0	0
2	21769386	.	T	A	2	3	5	0	0	5	0	0
2	21770775	.	G	A	3	3	6	0	1	7	0	0
2	21770888	.	T	C	3	7	10	0	0	10	0	0
2	21771091	.	G	T	2	2	4	0	1	6	1	0
2	21771191	.	G	T	5	2	7	0	1	8	0	0
2	21771245	.	A	T	1	5	6	0	0	6	0	0
2	21772082	.	G	A	3	5	8	0	0	8	0	0
2	21781538	.	G	A	0	2	2	0	0	2	0	0
2	21807265	.	T	G	3	3	6	0	1	7	0	0
2	21807295	.	C	T	2	5	7	0	0	7	0	0
2	21821936	.	A	G	27	19	46	0	2	48	0	0
2	21822288	.	C	A	23	26	49	0	5	54	0	0
2	21822816	.	T	A	19	14	33	0	4	37	0	0
2	21823100	.	C	A	34	21	55	0	3	58	0	0
2	21855248	.	C	G	7	15	22	0	1	23	0	0
2	21865620	.	G	C	6	14	20	0	0	20	0	0
2	21869023	.	T	C	16	11	27	0	1	28	0	0
2	21877560	.	G	A	4	7	11	0	0	11	0	0
2	21877711	.	C	G	7	8	15	0	0	15	0	0
2	21877743	.	T	G	5	12	17	0	0	17	0	0
2	21877769	.	A	T	5	15	20	0	2	22	0	0
2	21877795	.	T	C	3	11	14	0	2	16	0	0
2	21877931	.	T	A	7	7	14	0	2	16	0	0
2	21878036	.	G	C	11	11	22	0	1	23	0	0
2	21878258	.	A	T	16	14	30	0	0	30	0	0
2	21878415	.	C	T	11	18	29	0	1	30	0	0
2	21983059	.	C	T	4	12	16	0	0	16	0	0
2	22058254	.	G	A	9	12	21	0	0	21	0	0
2	22058281	.	C	T	2	6	8	0	1	9	0	0
2	22071062	.	A	C	13	11	24	0	1	25	0	0
2	22073020	.	A	G	4	3	7	0	0	7	0	0
2	22073176	.	C	T	17	12	29	0	1	30	0	0
2	22093084	.	A	G	14	0	14	0	17	31	0	0
2	22104309	.	C	G	28	10	38	0	1	39	0	0
2	22104415	.	C	A	17	11	28	0	3	31	0	0
2	22104506	.	T	C	9	16	25	0	2	27	0	0
2	22104912	.	T	C	13	19	32	0	0	32	0	0
2	22208560	.	G	A	8	12	20	0	1	21	0	0
2	22208767	.	G	A	7	8	15	0	0	15	0	0
2	22208776	.	A	G	10	10	20	0	0	20	0	0
2	22209045	.	C	A	8	15	23	0	1	25	1	0
2	22209743	.	A	G	11	5	16	0	0	16	0	0
2	22209920	.	C	T	15	6	21	0	1	22	0	0
2	22210137	.	T	C	7	0	7	0	11	18	0	0
2	22210412	.	G	A	15	9	24	0	0	24	0	0
2	22286813	.	T	A	5	4	9	0	1	10	0	0
2	22353522	.	T	C	7	0	7	0	22	29	0	0
2	22353568	.	T	C	8	18	26	0	1	27	0	0
2	22353661	.	T	A	11	8	19	0	2	21	0	0
2	22353662	.	A	C	13	8	21	0	0	21	0	0
2	22353993	.	T	C	4	1	5	0	0	5	0	0
2	22362290	.	G	A	14	13	27	0	2	29	0	0
2	22362302	.	G	A	10	12	22	0	3	25	0	0
2	22362347	.	T	C	4	0	4	0	2	6	0	0
2	22363365	.	T	C	1	0	1	0	0	1	0	0
2	22363418	.	T	A	2	0	2	0	0	2	0	0
2	22364024	.	C	G	1	2	3	0	0	3	0	0
2	22364079	.	T	C	1	3	4	0	0	4	0	0
2	22396145	.	G	A	4	3	7	0	1	8	0	0
2	22396184	.	T	C	1	4	5	0	1	6	0	0
2	22396205	.	A	G	1	2	3	0	0	3	0	0
2	22396421	.	G	A	3	2	5	0	0	5	0	0
2	22396425	.	A	G	2	2	4	0	1	5	0	0
2	22397012	.	G	T	1	4	5	0	0	5	0	0
2	22397029	.	A	G	1	3	4	0	0	4	0	0
2	22397461	.	C	T	3	3	6	0	0	6	0	0
2	22397527	.	G	T	8	4	12	0	0	12	0	0
2	22397534	.	A	G	8	3	11	0	1	12	0	0
2	22397564	.	G	A	5	2	7	0	1	8	0	0
2	22397571	.	T	C	4	3	7	0	0	7	0	0
2	22480272	.	T	C	7	0	7	0	11	18	0	0
2	22483381	.	A	G	8	9	17	0	0	17	0	0
2	22486393	.	A	G	1	0	1	0	1	2	0	0
2	22507132	.	T	A	10	11	21	0	0	21	0	0
2	22513202	.	A	G	4	5	9	0	0	9	0	0
2	22516758	.	A	G	3	1	4	0	0	4	0	0
2	22517039	.	G	A	3	5	8	0	0	8	0	0
2	22521557	.	T	A	4	3	7	0	0	7	0	0
2	22521582	.	A	T	3	3	6	0	0	6	0	0
2	22521905	.	C	A	1	3	4	0	0	4	0	0
2	22522302	.	A	G	5	8	13	0	0	13	0	0
2	22522406	.	A	T	2	2	4	0	0	4	0	0
2	22522448	.	A	G	4	4	8	0	0	8	0	0
2	22522472	.	A	G	6	3	9	0	0	9	0	0
2	22522895	.	T	C	2	2	4	0	0	4	0	0
2	22523573	.	G	A	1	3	4	0	0	4	0	0
2	22602424	.	T	C	3	2	5	0	0	5	0	0
2	22602826	.	C	T	10	7	17	0	1	18	0	0
2	22607462	.	G	A	0	0	0	0	2	2	0	0
2	22608314	.	G	T	7	6	13	0	1	14	0	0
2	22612623	.	T	C	2	0	2	0	0	2	0	0
2	22614355	.	G	A	3	5	8	0	0	8	0	0
2	22614357	.	T	A	3	5	8	0	0	8	0	0
2	22614448	.	T	A	6	6	12	0	0	12	0	0
2	22614568	.	A	G	9	7	16	0	0	16	0	0
2	22614988	.	T	C	6	9	15	0	1	16	0	0
2	22615055	.	T	A	13	7	20	0	0	20	0	0
2	22615155	.	G	A	4	7	11	0	0	11	0	0
2	22627149	.	G	A	8	7	15	0	1	16	0	0
2	22628981	.	A	G	15	27	42	0	1	43	0	0
2	22634040	.	T	G	14	12	26	0	0	26	0	0
2	22653693	.	T	A	4	6	10	0	0	10	0	0
2	22656870	.	A	G	4	7	11	0	0	11	0	0
2	22659072	.	G	A	0	4	4	0	0	4	0	0
2	22702423	.	T	C	2	6	8	0	0	8	0	0
2	22702505	.	C	G	12	21	33	0	1	34	0	0
2	22707536	.	A	C	7	5	12	0	1	13	0	0
2	22710985	.	T	C	0	1	1	0	0	1	0	0
2	22714603	.	A	G	15	13	28	0	0	28	0	0
2	22714618	.	G	A	12	12	24	0	0	24	0	0
2	22717198	.	A	G	3	1	4	0	0	4	0	0
2	22721695	.	T	C	16	14	30	0	1	31	0	0
2	22721734	.	A	T	8	4	12	0	2	14	0	0
2	22731426	.	C	T	6	10	16	0	0	16	0	0
2	22731456	.	G	A	2	8	10	0	0	10	0	0
2	22733715	.	T	C	2	4	6	0	0	6	0	0
2	22733813	.	A	G	15	16	31	0	1	32	0	0
2	22735037	.	T	A	2	3	5	0	0	5	0	0
2	22735205	.	A	T	12	15	27	0	1	28	0	0
2	22735232	.	C	T	4	8	12	0	0	12	0	0
2	22742179	.	C	T	6	10	16	0	0	17	1	0
2	22747304	.	C	T	6	13	19	0	0	19	0	0
2	22749202	.	A	C	13	20	33	0	1	34	0	0
2	22749221	.	A	G	11	0	11	0	14	25	0	0
2	22750164	.	C	T	1	2	3	0	0	3	0	0
2	22750621	.	C	T	3	6	9	0	0	9	0	0
2	22750622	.	A	G	3	6	9	0	0	9	0	0
2	22756245	.	T	G	24	28	52	0	0	52	0	0
2	22756289	.	A	G	24	26	50	0	1	51	0	0
2	22802004	.	T	A	33	16	49	0	0	49	0	0
2	22802402	.	T	C	23	16	39	0	2	41	0	0
2	22802504	.	G	A	21	19	40	0	1	41	0	0
2	22803074	.	G	A	0	32	32	0	17	49	0	0
2	22803366	.	C	T	31	26	57	0	2	59	0	0
2	22853289	.	A	T	1	2	3	0	0	3	0	0
2	22857388	.	A	G	2	2	4	0	1	5	0	0
2	22857403	.	A	G	1	2	3	0	0	3	0	0
2	22858664	.	T	C	2	3	5	0	0	5	0	0
2	22860300	.	A	G	2	0	2	0	1	3	0	0
2	22860330	.	A	T	1	2	3	0	0	3	0	0
2	22932684	.	G	C	6	7	13	0	0	13	0	0
2	22932715	.	T	C	3	7	10	0	0	10	0	0
2	22932725	.	G	A	3	5	8	0	0	8	0	0
2	22932931	.	A	G	3	5	8	0	0	8	0	0
2	22933175	.	T	G	1	3	4	0	1	5	0	0
2	22933218	.	C	A	1	4	5	0	0	5	0	0
2	22933242	.	A	G	1	6	7	0	0	7	0	0
2	22933377	.	G	T	1	3	4	0	0	4	0	0
2	22933455	.	T	C	7	5	12	0	0	12	0	0
2	22935766	.	A	T	2	5	7	0	0	7	0	0
2	22944185	.	C	T	2	3	5	0	1	6	0	0
2	22953005	.	T	C	1	1	2	0	0	2	0	0
2	22953020	.	A	C	1	0	1	0	1	2	0	0
2	22957533	.	G	A	1	3	4	0	0	4	0	0
2	22959179	.	A	G	1	1	2	0	0	2	0	0
2	22962013	.	A	G	0	1	1	0	0	1	0	0
2	22962241	.	G	A	2	1	3	0	0	3	0	0
2	22970603	.	A	C	4	2	6	0	0	6	0	0
2	22986552	.	T	C	3	3	6	0	0	6	0	0
2	22986555	.	C	T	3	4	7	0	0	7	0	0
2	22993548	.	G	C	5	2	7	0	0	7	0	0
2	22994322	.	C	T	3	8	11	0	0	11	0	0
2	22994412	.	C	T	4	7	11	0	0	11	0	0
2	23022896	.	A	G	2	4	6	0	0	6	0	0
2	23023121	.	G	A	0	6	6	0	1	7	0	0
2	23023337	.	G	A	2	4	6	0	0	6	0	0
2	23023535	.	A	T	2	3	5	0	0	5	0	0
2	23023675	.	G	A	2	3	5	0	0	5	0	0
2	23023804	.	A	G	2	2	4	0	0	4	0	0
2	23023811	.	A	G	2	2	4	0	0	4	0	0
2	23023959	.	A	T	2	2	4	0	0	4	0	0
2	23048494	.	T	G	2	7	9	0	1	10	0	0
2	23061791	.	T	C	4	3	7	0	0	7	0	0
2	23066671	.	C	T	4	1	5	0	1	6	0	0
2	23073536	.	A	G	4	6	10	0	0	10	0	0
2	23077839	.	A	C	11	10	21	0	0	21	0	0
2	23078532	.	T	C	7	7	14	0	0	14	0	0
2	23081309	.	G	A	0	3	3	0	2	5	0	0
2	23083308	.	T	C	3	1	4	0	0	4	0	0
2	23085121	.	C	T	1	1	2	0	0	2	0	0
2	23085188	.	T	A	1	4	5	0	0	5	0	0
2	23085189	.	T	G	1	4	5	0	0	5	0	0
2	23085223	.	G	A	3	8	11	0	0	11	0	0
2	23088951	.	G	A	0	1	1	0	0	1	0	0
2	23098472	.	A	T	3	2	5	0	0	5	0	0
2	23098506	.	C	A	4	3	7	0	0	7	0	0
2	23098563	.	G	A	3	2	5	0	0	5	0	0
2	23098565	.	A	G	3	2	5	0	0	5	0	0
2	23099038	.	T	A	4	3	7	0	0	7	0	0
2	23099307	.	T	C	3	2	5	0	0	5	0	0
2	23165475	.	A	T	5	2	7	0	0	7	0	0
2	23227385	.	A	G	0	1	1	0	0	1	0	0
2	23232881	.	A	G	3	2	5	0	2	7	0	0
2	23232884	.	T	C	3	3	6	0	1	7	0	0
2	23245557	.	C	T	5	5	10	0	0	10	0	0
2	23254074	.	A	G	3	4	7	0	0	7	0	0
2	23254158	.	G	A	1	3	4	0	1	5	0	0
2	23274792	.	C	T	4	5	9	0	0	9	0	0
2	23292123	.	A	T	2	0	2	0	0	2	0	0
2	23292432	.	C	A	19	12	31	0	1	32	0	0
2	23292490	.	C	G	11	12	23	0	0	23	0	0
2	23292549	.	C	A	4	10	14	0	2	16	0	0
2	23292584	.	C	A	4	7	11	0	3	14	0	0
2	23292595	.	T	A	4	6	10	0	2	12	0	0
2	23292690	.	T	A	9	5	14	0	0	14	0	0
2	23292869	.	A	G	1	2	3	0	0	3	0	0
2	23292870	.	T	C	1	2	3	0	0	3	0	0
2	23293029	.	T	C	2	10	12	0	0	12	0	0
2	23293123	.	G	C	9	12	21	0	0	21	0	0
2	23293230	.	A	T	9	7	16	0	1	17	0	0
2	23293246	.	T	C	10	6	16	0	0	16	0	0
2	23293376	.	C	A	4	10	14	0	2	16	0	0
2	23352323	.	G	A	1	5	6	0	0	6	0	0
2	23361020	.	T	G	12	14	26	0	0	26	0	0
2	23361208	.	C	T	17	12	29	0	4	33	0	0
2	23361359	.	T	C	13	13	26	0	0	26	0	0
2	23361605	.	C	T	21	10	31	0	0	31	0	0
2	23379480	.	G	C	2	5	7	0	0	7	0	0
2	23379532	.	G	A	2	5	7	0	2	9	0	0
2	23379588	.	C	T	8	10	18	0	0	18	0	0
2	23379757	.	T	A	9	4	13	0	0	13	0	0
2	23379861	.	G	A	6	3	9	0	0	9	0	0
2	23380621	.	C	A	2	4	6	0	1	7	0	0
2	23381056	.	A	G	1	0	1	0	0	1	0	0
2	23387139	.	C	T	1	1	2	0	0	2	0	0
2	23623933	.	G	T	1	3	4	0	0	4	0	0
2	23624172	.	G	T	1	3	4	0	0	4	0	0
2	23624214	.	T	C	2	3	5	0	0	5	0	0
2	23624418	.	A	G	1	2	3	0	0	3	0	0
2	23644299	.	A	G	1	2	3	0	0	3	0	0
2	23707408	.	C	A	5	7	12	0	1	13	0	0
2	23711756	.	C	T	1	1	2	0	0	2	0	0
2	23711990	.	T	A	0	2	2	0	0	2	0	0
2	23713763	.	G	A	2	2	4	0	0	4	0	0
2	23713775	.	T	C	1	1	2	0	0	2	0	0
2	23714650	.	C	T	1	1	2	0	0	2	0	0
2	23714743	.	A	T	2	0	2	0	0	2	0	0
2	23716572	.	T	C	2	3	5	0	0	5	0	0
2	23721729	.	T	A	5	4	9	0	0	9	0	0
2	23721974	.	C	A	3	5	8	0	0	8	0	0
2	23722311	.	C	T	4	5	9	0	0	9	0	0
2	23722338	.	G	A	3	8	11	0	0	11	0	0
2	23722414	.	A	G	1	0	1	0	2	3	0	0
2	23722444	.	A	T	1	6	7	0	0	7	0	0
2	23722594	.	T	A	4	2	6	0	0	6	0	0
2	23722828	.	G	A	2	10	12	0	2	14	0	0
2	23723172	.	A	C	6	2	8	0	0	8	0	0
2	23723187	.	A	G	8	3	11	0	0	11	0	0
2	23723438	.	G	T	0	4	4	0	1	5	0	0
2	23723711	.	T	G	4	4	8	0	0	8	0	0
2	23724423	.	T	A	6	4	10	0	0	10	0	0
2	23725075	.	G	A	13	4	17	0	0	17	0	0
2	23725144	.	T	C	9	8	17	0	0	17	0	0
2	23725184	.	C	A	9	7	16	0	0	16	0	0
2	23725239	.	C	T	4	5	9	0	0	9	0	0
2	23725754	.	A	T	8	5	13	0	0	13	0	0
2	23725756	.	A	T	8	5	13	0	0	13	0	0
2	23725834	.	G	C	4	4	8	0	1	9	0	0
2	23725872	.	T	C	3	4	7	0	1	8	0	0
2	23725980	.	A	C	4	3	7	0	0	7	0	0
2	23725986	.	G	T	6	4	10	0	0	10	0	0
2	23726099	.	A	T	8	11	19	0	0	19	0	0
2	23726155	.	C	A	12	7	19	0	0	19	0	0
2	23726180	.	A	G	14	6	20	0	0	20	0	0
2	23726206	.	T	A	11	5	16	0	0	16	0	0
2	23726230	.	A	T	6	4	10	0	1	11	0	0
2	23726290	.	T	C	9	11	20	0	0	20	0	0
2	23726353	.	G	A	13	9	22	0	1	23	0	0
2	23726393	.	C	T	10	7	17	0	0	17	0	0
2	23796627	.	A	G	3	1	4	0	0	4	0	0
2	23796636	.	G	A	3	1	4	0	0	4	0	0
2	23796665	.	A	T	1	1	2	0	0	2	0	0
2	23803346	.	G	A	0	5	5	0	3	8	0	0
2	23808760	.	G	A	3	8	11	0	0	11	0	0
2	23816293	.	A	C	7	4	11	0	1	12	0	0
2	23816932	.	C	T	4	2	6	0	0	6	0	0
2	23817924	.	T	G	1	4	5	0	0	5	0	0
2	23817946	.	G	A	1	3	4	0	0	4	0	0
2	23818418	.	A	T	2	5	7	0	1	8	0	0
2	23818580	.	T	A	4	2	6	0	1	7	0	0
2	23818765	.	A	G	4	2	6	0	0	6	0	0
2	23818790	.	A	G	1	0	1	0	1	2	0	0
2	23819302	.	C	G	3	2	5	0	1	6	0	0
2	23819862	.	A	C	1	5	6	0	0	6	0	0
2	23819946	.	T	G	3	1	4	0	2	6	0	0
2	23823684	.	A	T	0	1	1	0	1	2	0	0
2	23823719	.	A	G	0	2	2	0	0	2	0	0
2	23835209	.	T	C	0	3	3	0	0	3	0	0
2	23836807	.	A	C	0	3	3	0	0	3	0	0
2	23937310	.	T	C	2	2	4	0	0	4	0	0
2	23937432	.	T	G	1	4	5	0	0	5	0	0
2	23937631	.	T	G	2	5	7	0	0	7	0	0
2	24029267	.	C	T	0	2	2	0	0	2	0	0
2	24202456	.	G	A	8	12	20	0	1	21	0	0
2	24202855	.	A	G	6	0	6	0	15	21	0	0
2	24219115	.	G	A	19	31	50	0	0	50	0	0
2	24222069	.	A	C	15	9	24	0	0	24	0	0
2	24223991	.	A	G	30	26	56	0	11	67	0	0
2	24238629	.	C	T	3	4	7	0	0	7	0	0
2	24238809	.	A	G	12	7	19	0	0	19	0	0
2	24248619	.	T	G	34	17	51	0	5	56	0	0
2	24248677	.	A	T	35	15	50	0	4	54	0	0
2	24248702	.	T	C	34	19	53	0	0	53	0	0
2	24248767	.	T	C	31	12	43	0	0	43	0	0
2	24248768	.	A	G	31	0	31	0	12	43	0	0
2	24248809	.	C	T	22	29	51	0	2	53	0	0
2	24248871	.	A	G	34	1	35	0	26	61	0	0
2	24249044	.	A	C	24	23	47	0	3	50	0	0
2	24249211	.	A	G	33	23	56	0	1	57	0	0
2	24249299	.	A	G	30	25	55	0	3	59	1	0
2	24249320	.	A	G	30	0	30	0	30	60	0	0
2	24249411	.	T	A	36	18	54	0	2	56	0	0
2	24249516	.	A	G	24	0	24	0	24	48	0	0
2	24249947	.	T	G	27	0	27	1	11	39	0	0
2	24250140	.	T	C	9	29	38	0	0	38	0	0
2	24250182	.	T	G	17	16	33	0	0	33	0	0
2	24250209	.	A	C	16	3	19	0	3	22	0	0
2	24250303	.	C	T	32	15	47	0	0	47	0	0
2	24250345	.	A	C	24	18	42	0	1	43	0	0
2	24250625	.	T	A	24	28	52	0	2	54	0	0
2	24250637	.	A	G	19	30	49	0	3	52	0	0
2	24250681	.	T	C	26	28	54	0	1	55	0	0
2	24251848	.	T	C	38	30	68	0	4	72	0	0
2	24252088	.	C	T	34	32	66	0	0	66	0	0
2	24310822	.	C	T	10	11	21	0	1	22	0	0
2	24310850	.	G	C	14	12	26	0	0	26	0	0
2	24310897	.	G	A	15	16	31	0	0	31	0	0
2	24311035	.	T	C	16	1	17	0	21	38	0	0
2	24311118	.	T	A	6	3	9	0	1	10	0	0
2	24311697	.	C	T	9	4	13	0	3	16	0	0
2	24311703	.	A	G	10	5	15	0	2	17	0	0
2	24311793	.	G	C	17	27	44	0	2	46	0	0
2	24313884	.	T	C	9	16	25	0	0	25	0	0
2	24314185	.	T	A	3	8	11	0	2	13	0	0
2	24315047	.	A	G	2	4	6	0	0	6	0	0
2	24315068	.	A	G	0	2	2	0	0	2	0	0
2	24316545	.	C	T	1	3	4	0	0	4	0	0
2	24317537	.	G	A	6	6	12	0	0	12	0	0
2	24319851	.	T	C	8	7	15	0	2	17	0	0
2	24319945	.	T	G	3	3	6	0	1	7	0	0
2	24320173	.	C	T	13	7	20	0	1	21	0	0
2	24321853	.	T	C	10	1	11	0	4	15	0	0
2	24322180	.	G	T	16	11	27	0	0	27	0	0
2	24326455	.	A	G	10	4	14	0	0	14	0	0
2	24326509	.	G	A	6	5	11	0	0	11	0	0
2	24328453	.	A	T	0	0	0	0	1	1	0	0
2	24331297	.	T	C	10	6	16	0	1	17	0	0
2	24335246	.	G	A	1	5	6	0	0	6	0	0
2	24338492	.	G	A	2	1	3	0	0	3	0	0
2	24348609	.	T	G	4	4	8	0	0	8	0	0
2	24348915	.	G	A	2	8	10	0	0	10	0	0
2	24382093	.	A	G	7	4	11	0	0	11	0	0
2	24385361	.	T	C	2	4	6	0	0	6	0	0
2	24385402	.	A	G	3	8	11	0	0	11	0	0
2	24385447	.	T	C	4	5	9	0	0	9	0	0
2	24385885	.	T	A	4	0	4	0	0	4	0	0
2	24390847	.	T	G	0	2	2	0	1	3	0	0
2	24390856	.	T	C	1	2	3	0	0	3	0	0
2	24411053	.	A	G	19	14	33	0	0	33	0	0
2	24411056	.	C	T	0	16	16	0	19	35	0	0
2	24411114	.	G	C	23	12	35	0	1	36	0	0
2	24411501	.	T	G	16	8	24	0	0	24	0	0
2	24411536	.	T	C	13	0	13	0	12	25	0	0
2	24411625	.	T	C	17	11	28	0	1	30	1	0
2	24411781	.	T	G	16	11	27	0	0	28	1	0
2	24411812	.	A	T	20	12	32	0	2	34	0	0
2	24411840	.	T	C	19	16	35	0	0	35	0	0
2	24411989	.	C	T	9	4	13	0	1	14	0	0
2	24412150	.	T	C	20	0	20	0	15	35	0	0
2	24413710	.	T	C	16	9	25	0	0	25	0	0
2	24413882	.	T	C	5	8	13	0	1	14	0	0
2	24416775	.	A	G	5	4	9	0	0	9	0	0
2	24421686	.	G	A	1	2	3	0	0	3	0	0
2	24421813	.	T	C	1	0	1	0	1	2	0	0
2	24432538	.	G	A	3	6	9	0	1	10	0	0
2	24444650	.	C	T	8	4	12	0	0	12	0	0
2	24444839	.	C	G	0	5	5	0	7	12	0	0
2	24461305	.	C	T	0	6	6	0	7	13	0	0
2	24461649	.	T	C	4	9	13	0	0	13	0	0
2	24461957	.	G	A	8	6	14	0	0	14	0	0
2	24548957	.	G	C	1	2	3	0	0	3	0	0
2	24565123	.	A	G	7	5	12	0	2	14	0	0
2	24578215	.	G	A	2	4	6	0	0	6	0	0
2	24578272	.	A	G	1	3	4	0	0	4	0	0
2	24578568	.	A	G	1	2	3	0	0	3	0	0
2	24594669	.	T	G	2	2	4	0	0	4	0	0
2	24594673	.	T	A	2	2	4	0	0	4	0	0
2	24649228	.	A	G	0	0	0	0	1	1	0	0
2	24664557	.	C	T	0	1	1	0	0	1	0	0
2	24666197	.	C	T	2	1	3	0	0	3	0	0
2	24682951	.	T	C	12	12	24	0	4	28	0	0
2	24683093	.	A	G	10	4	14	0	4	18	0	0
2	24701098	.	T	C	5	3	8	0	0	8	0	0
2	24729837	.	C	T	2	3	5	0	0	5	0	0
2	24737749	.	C	T	6	0	6	0	0	6	0	0
2	24737776	.	C	T	3	0	3	0	0	3	0	0
2	24739910	.	G	T	2	1	3	0	0	3	0	0
2	24740121	.	G	C	0	3	3	0	2	5	0	0
2	24740439	.	C	T	4	3	7	0	1	8	0	0
2	24740468	.	T	A	2	1	3	0	0	3	0	0
2	24743855	.	G	A	2	2	4	0	0	4	0	0
2	24748144	.	A	G	2	2	4	0	0	4	0	0
2	24748197	.	C	T	0	2	2	0	0	2	0	0
2	24748580	.	T	A	2	2	4	0	0	4	0	0
2	24751165	.	T	C	5	4	9	0	0	9	0	0
2	24751286	.	C	T	3	3	6	0	1	7	0	0
2	24751430	.	C	T	7	0	7	0	0	7	0	0
2	24751567	.	T	A	5	5	10	0	1	11	0	0
2	24751572	.	A	G	6	4	10	0	0	10	0	0
2	24751608	.	A	T	3	4	7	0	0	7	0	0
2	24751888	.	A	G	3	0	3	0	4	7	0	0
2	24751986	.	T	G	8	0	8	0	9	17	0	0
2	24751991	.	A	G	8	6	14	0	1	15	0	0
2	24752048	.	C	T	5	4	9	0	0	9	0	0
2	24752071	.	A	G	4	5	9	0	0	9	0	0
2	24752157	.	G	A	12	9	21	0	0	21	0	0
2	24752179	.	C	T	10	14	24	0	1	25	0	0
2	24752391	.	A	G	10	8	18	0	1	19	0	0
2	24752737	.	A	G	5	2	7	0	0	7	0	0
2	24753085	.	C	G	6	3	9	0	0	9	0	0
2	24753164	.	G	A	2	2	4	0	0	4	0	0
2	24753492	.	G	C	5	11	16	0	1	17	0	0
2	24753535	.	A	C	10	5	15	0	0	15	0	0
2	24753639	.	G	A	2	4	6	0	0	6	0	0
2	24753980	.	T	A	5	3	8	0	1	9	0	0
2	24754383	.	C	T	1	1	2	0	0	2	0	0
2	24754390	.	T	G	0	0	0	0	3	3	0	0
2	24754434	.	A	G	2	2	4	0	0	4	0	0
2	24754444	.	A	G	2	2	4	0	0	4	0	0
2	24754489	.	G	A	3	0	3	0	0	3	0	0
2	24754565	.	A	T	5	3	8	0	1	9	0	0
2	24754641	.	G	A	0	10	10	0	13	23	0	0
2	24754794	.	G	A	14	15	29	0	1	30	0	0
2	24754883	.	T	A	14	7	21	0	0	21	0	0
2	24755018	.	T	C	21	13	34	0	0	34	0	0
2	24767285	.	T	C	2	5	7	0	0	7	0	0
2	24770628	.	G	C	0	3	3	0	1	4	0	0
2	24770666	.	A	G	2	3	5	0	0	5	0	0
2	24770898	.	T	C	6	2	8	0	0	8	0	0
2	24770928	.	A	G	1	1	2	0	5	7	0	0
2	24774452	.	C	T	0	2	2	0	0	2	0	0
2	24862677	.	G	A	0	2	2	0	3	5	0	0
2	24862691	.	T	C	1	2	3	0	0	3	0	0
2	24863757	.	G	T	2	3	5	0	0	5	0	0
2	24864536	.	A	T	2	3	5	0	0	5	0	0
2	24865961	.	A	G	5	7	12	0	0	12	0	0
2	24865972	.	A	T	4	7	11	0	0	11	0	0
2	24873047	.	G	A	4	5	9	0	0	9	0	0
2	24877010	.	A	G	13	11	24	0	0	24	0	0
2	24877227	.	C	T	9	11	20	0	0	20	0	0
2	24877276	.	A	C	11	11	22	0	0	22	0	0
2	24877294	.	T	C	10	9	19	0	2	21	0	0
2	24877327	.	T	C	5	6	11	0	0	11	0	0
2	24878017	.	T	A	17	14	31	0	0	31	0	0
2	24878081	.	T	A	16	15	31	0	0	31	0	0
2	24878265	.	G	T	9	10	19	0	0	19	0	0
2	24936807	.	G	A	4	3	7	0	0	7	0	0
2	24942639	.	T	C	6	6	12	2	0	14	0	0
2	24943237	.	G	A	4	14	18	0	12	30	0	0
2	24943398	.	C	T	6	6	12	0	1	13	0	0
2	24943567	.	A	G	2	2	4	0	3	7	0	0
2	24943597	.	T	C	2	3	5	0	0	5	0	0
2	24944067	.	A	G	12	2	14	0	4	18	0	0
2	24944187	.	C	T	12	2	14	0	0	14	0	0
2	24944317	.	A	G	8	3	11	0	1	12	0	0
2	24944485	.	T	G	11	4	15	0	0	16	1	0
2	24944566	.	G	A	11	5	16	0	0	16	0	0
2	24947372	.	T	C	5	0	5	0	4	9	0	0
2	24947642	.	C	T	1	0	1	0	0	1	0	0
2	24952186	.	G	A	0	4	4	0	0	4	0	0
2	24956856	.	T	C	0	1	1	0	2	3	0	0
2	24957073	.	T	C	4	2	6	0	1	7	0	0
2	24957086	.	C	T	0	3	3	0	5	8	0	0
2	24958873	.	T	C	1	2	3	0	0	3	0	0
2	24958921	.	G	A	2	4	6	0	0	6	0	0
2	24958945	.	C	T	1	1	2	0	0	2	0	0
2	24961833	.	C	T	1	0	1	0	0	1	0	0
2	24990621	.	T	A	4	11	15	0	0	15	0	0
2	24990629	.	T	A	3	10	13	0	1	14	0	0
2	24990751	.	A	T	5	4	9	0	1	10	0	0
2	24990845	.	T	C	2	8	10	0	2	12	0	0
2	24991202	.	C	G	7	13	20	0	0	20	0	0
2	24991265	.	T	G	5	13	18	0	0	18	0	0
2	24991387	.	G	T	10	9	19	0	0	19	0	0
2	24991429	.	G	A	15	6	21	0	1	22	0	0
2	24991564	.	A	C	21	0	21	0	12	33	0	0
2	24991573	.	A	G	17	12	29	0	3	32	0	0
2	24991909	.	A	G	12	11	23	0	0	23	0	0
2	24992134	.	G	A	15	12	27	0	1	28	0	0
2	24992185	.	T	C	14	8	22	0	0	22	0	0
2	24992242	.	C	T	0	11	11	0	19	30	0	0
2	24992352	.	G	A	8	16	24	0	1	25	0	0
2	24992407	.	G	A	13	9	22	0	1	23	0	0
2	24992422	.	G	A	16	12	28	0	0	28	0	0
2	24996241	.	C	T	3	2	5	0	0	5	0	0
2	25076552	.	A	C	0	2	2	0	0	2	0	0
2	25076569	.	C	T	0	2	2	0	0	2	0	0
2	25077569	.	T	C	1	0	1	0	0	1	0	0
2	25091203	.	G	A	1	0	1	0	0	1	0	0
2	25095096	.	T	C	4	2	6	0	0	6	0	0
2	25095118	.	T	C	6	5	11	0	0	11	0	0
2	25095177	.	T	C	4	5	9	0	0	9	0	0
2	25097106	.	G	A	0	1	1	0	5	6	0	0
2	25097289	.	G	A	2	1	3	0	1	4	0	0
2	25097543	.	C	T	2	4	6	0	0	6	0	0
2	25097576	.	T	G	1	2	3	0	0	3	0	0
2	25100106	.	A	G	2	0	2	0	2	4	0	0
2	25101118	.	A	G	6	5	11	0	0	11	0	0
2	25101124	.	T	C	6	5	11	0	0	11	0	0
2	25101160	.	A	G	1	0	1	0	3	4	0	0
2	25104866	.	A	G	1	1	2	0	0	2	0	0
2	25105482	.	G	A	4	3	7	0	0	7	0	0
2	25105507	.	G	C	5	4	9	0	0	9	0	0
2	25105586	.	C	T	12	6	18	0	1	19	0	0
2	25105856	.	T	A	9	10	19	0	0	19	0	0
2	25105857	.	C	A	9	10	19	0	0	19	0	0
2	25105900	.	C	T	12	7	19	0	1	20	0	0
2	25105992	.	G	A	8	6	14	0	1	15	0	0
2	25106082	.	G	A	1	2	3	0	3	6	0	0
2	25106098	.	T	A	3	3	6	0	0	6	0	0
2	25106244	.	A	T	9	7	16	0	1	17	0	0
2	25106343	.	T	A	6	9	15	0	0	15	0	0
2	25106477	.	G	A	8	5	13	0	0	13	0	0
2	25106508	.	G	C	10	6	16	0	1	17	0	0
2	25106554	.	G	T	8	6	14	0	0	14	0	0
2	25106631	.	C	G	4	3	7	0	0	7	0	0
2	25106671	.	A	C	2	5	7	0	0	7	0	0
2	25106874	.	A	C	3	5	8	0	0	8	0	0
2	25107026	.	A	C	2	1	3	0	0	3	0	0
2	25107049	.	G	A	1	4	5	0	1	6	0	0
2	25107188	.	G	A	1	3	4	0	0	4	0	0
2	25107710	.	T	C	8	7	15	0	0	15	0	0
2	25107713	.	T	C	8	7	15	0	0	15	0	0
2	25108042	.	A	G	11	5	16	0	0	16	0	0
2	25108137	.	C	T	11	9	20	0	2	22	0	0
2	25108377	.	T	A	6	5	11	0	0	11	0	0
2	25108865	.	T	C	7	3	10	0	1	11	0	0
2	25113168	.	A	G	1	0	1	0	0	1	0	0
2	25119637	.	A	G	10	6	16	0	0	17	1	0
2	25119667	.	G	T	4	4	8	0	0	8	0	0
2	25119950	.	T	G	8	3	11	0	1	12	0	0
2	25124650	.	T	G	5	5	10	0	1	11	0	0
2	25125073	.	G	A	1	2	3	0	0	3	0	0
2	25125437	.	G	A	2	4	6	0	0	6	0	0
2	25127042	.	G	T	4	2	6	0	1	7	0	0
2	25127219	.	T	C	4	3	7	0	1	8	0	0
2	25127261	.	G	T	0	3	3	0	4	7	0	0
2	25127651	.	C	T	2	3	5	0	0	5	0	0
2	25128019	.	C	G	2	3	5	0	1	6	0	0
2	25128024	.	C	T	4	3	7	0	0	7	0	0
2	25128590	.	C	T	2	5	7	0	0	7	0	0
2	25128668	.	C	T	6	7	13	0	0	13	0	0
2	25128780	.	T	A	6	9	15	0	1	16	0	0
2	25128858	.	C	T	4	6	10	0	1	11	0	0
2	25128920	.	G	T	3	5	8	0	0	8	0	0
2	25128934	.	A	G	3	5	8	0	0	8	0	0
2	25128997	.	C	G	2	0	2	0	4	6	0	0
2	25246512	.	C	T	1	4	5	0	1	6	0	0
2	25282463	.	T	G	1	0	1	0	0	1	0	0
2	25289894	.	C	T	2	4	6	0	0	6	0	0
2	25290690	.	A	C	2	2	4	0	1	5	0	0
2	25480226	.	A	G	1	0	1	0	1	2	0	0
2	25542890	.	C	A	5	1	6	0	4	10	0	0
2	25767288	.	A	G	3	0	3	0	0	3	0	0
2	25781757	.	C	T	1	1	2	0	0	2	0	0
2	25786170	.	A	C	1	1	2	0	0	2	0	0
2	25786254	.	T	C	1	3	4	0	1	5	0	0
2	25787292	.	C	T	0	2	2	0	1	3	0	0
2	25794226	.	A	G	0	4	4	0	0	4	0	0
2	25797439	.	C	T	3	7	10	0	0	10	0	0
2	25797472	.	C	T	0	7	7	0	0	7	0	0
2	25800881	.	C	T	4	2	6	0	1	7	0	0
2	25839381	.	G	T	0	6	6	0	13	19	0	0
2	25843532	.	T	C	6	13	19	0	4	23	0	0
2	25843806	.	G	A	0	12	12	0	11	23	0	0
2	25844341	.	T	C	5	11	16	0	2	18	0	0
2	25844345	.	A	T	6	11	17	0	1	18	0	0
2	25844986	.	T	A	12	7	19	0	1	20	0	0
2	25845264	.	G	A	2	3	5	0	0	5	0	0
2	25845269	.	T	C	2	4	6	0	0	6	0	0
2	25947351	.	C	T	0	2	2	0	0	2	0	0
2	25947408	.	G	T	3	7	10	0	0	10	0	0
2	25947531	.	C	T	2	2	4	0	0	4	0	0
2	25947585	.	T	C	5	5	10	0	1	11	0	0
2	25947593	.	G	A	0	6	6	0	7	13	0	0
2	25947678	.	T	C	5	4	9	0	0	9	0	0
2	25947699	.	T	C	5	6	11	0	0	11	0	0
2	25952953	.	T	C	9	6	15	0	0	15	0	0
2	25952983	.	C	T	3	3	6	0	0	6	0	0
2	25963401	.	T	A	6	6	12	0	0	12	0	0
2	25984751	.	G	A	8	2	10	0	0	10	0	0
2	25984913	.	T	C	9	9	18	0	1	19	0	0
2	25984928	.	T	C	12	10	22	0	0	22	0	0
2	25984970	.	C	T	13	8	21	0	1	22	0	0
2	25984982	.	C	T	9	10	19	0	3	22	0	0
2	25985012	.	C	T	10	13	23	0	0	23	0	0
2	25985219	.	T	C	11	4	15	0	0	15	0	0
2	25985268	.	G	A	10	7	17	0	0	17	0	0
2	25985300	.	A	C	7	13	20	0	0	20	0	0
2	25985351	.	C	G	6	6	12	0	3	15	0	0
2	25988414	.	G	A	1	7	8	0	13	21	0	0
2	25988475	.	C	T	6	11	17	0	0	17	0	0
2	25988570	.	T	C	16	9	25	0	0	25	0	0
2	25989100	.	A	G	13	10	23	0	0	23	0	0
2	25989290	.	T	G	14	10	24	0	0	24	0	0
2	25990020	.	C	A	24	10	34	0	5	39	0	0
2	25990180	.	C	T	22	15	37	0	0	37	0	0
2	25990302	.	A	G	9	13	22	0	2	24	0	0
2	25990337	.	A	G	16	5	21	0	1	22	0	0
2	25990447	.	G	A	29	13	42	0	0	42	0	0
2	25990522	.	A	C	9	9	18	0	0	18	0	0
2	25990563	.	A	G	13	7	20	0	1	21	0	0
2	25990628	.	C	A	19	5	24	0	1	25	0	0
2	26155762	.	G	A	1	2	3	0	1	4	0	0
2	26155917	.	G	A	0	3	3	0	2	5	0	0
2	26156582	.	G	A	2	2	4	0	0	4	0	0
2	26156618	.	T	A	2	2	4	0	0	4	0	0
2	26206930	.	A	G	3	3	6	0	1	7	0	0
2	26206942	.	G	T	0	3	3	0	5	8	0	0
2	26207038	.	A	C	6	10	16	0	1	17	0	0
2	26207071	.	C	T	6	8	14	0	0	14	0	0
2	26207080	.	G	C	6	8	14	0	2	16	0	0
2	26207155	.	C	T	7	3	10	0	1	11	0	0
2	26207254	.	A	G	8	6	14	0	3	17	0	0
2	26207263	.	T	A	6	10	16	0	1	17	0	0
2	26207368	.	A	G	6	7	13	0	0	13	0	0
2	26207713	.	G	A	13	4	17	0	0	17	0	0
2	26207752	.	C	T	8	7	15	0	0	15	0	0
2	26207938	.	C	T	13	8	21	0	0	21	0	0
2	26208480	.	A	C	6	9	15	0	0	15	0	0
2	26208520	.	A	G	5	8	13	0	0	13	0	0
2	26208589	.	A	G	10	7	17	0	0	17	0	0
2	26208668	.	T	G	14	0	14	0	11	25	0	0
2	26208733	.	C	A	7	4	11	0	1	12	0	0
2	26208815	.	G	T	8	11	19	0	1	20	0	0
2	26208996	.	A	G	14	6	20	0	1	21	0	0
2	26209120	.	C	T	4	2	6	0	0	6	0	0
2	26209141	.	G	A	3	3	6	0	0	6	0	0
2	26209169	.	C	T	2	6	8	0	2	10	0	0
2	26209266	.	A	C	5	4	9	0	0	9	0	0
2	26209325	.	G	A	0	2	2	0	0	2	0	0
2	26240742	.	C	T	21	17	38	0	3	41	0	0
2	26240805	.	T	C	22	14	36	0	1	37	0	0
2	26240857	.	C	T	23	11	34	0	0	34	0	0
2	26277924	.	C	A	3	2	5	0	2	7	0	0
2	26282745	.	C	T	18	27	45	0	2	47	0	0
2	26282814	.	T	C	19	21	40	0	2	42	0	0
2	26282829	.	A	G	20	0	20	0	20	40	0	0
2	26282916	.	A	G	25	0	25	0	19	44	0	0
2	26298803	.	G	A	0	2	2	0	2	4	0	0
2	26300016	.	T	C	1	8	9	0	0	9	0	0
2	26300172	.	A	G	2	2	4	0	0	4	0	0
2	26303719	.	T	G	7	0	7	0	5	12	0	0
2	26303985	.	A	G	3	7	10	0	0	10	0	0
2	26304066	.	T	C	5	6	11	0	0	11	0	0
2	26304266	.	A	G	2	3	5	0	0	5	0	0
2	26304329	.	A	G	1	7	8	0	1	9	0	0
2	26422287	.	C	T	5	4	9	0	0	9	0	0
2	26443211	.	A	C	9	12	21	0	0	21	0	0
2	26443476	.	C	T	4	4	8	0	0	8	0	0
2	26444170	.	T	C	4	1	5	0	2	7	0	0
2	26444332	.	C	A	2	4	6	0	0	6	0	0
2	26463459	.	C	T	0	8	8	0	9	17	0	0
2	26463622	.	A	G	8	12	20	0	1	21	0	0
2	26468243	.	G	A	2	2	4	0	1	5	0	0
2	26468665	.	A	T	0	2	2	0	0	2	0	0
2	26470237	.	G	T	13	14	27	0	0	27	0	0
2	26470267	.	G	A	11	16	27	0	1	29	1	0
2	26470357	.	G	A	14	13	27	0	0	27	0	0
2	26470666	.	A	G	25	18	43	0	0	43	0	0
2	26473078	.	A	G	1	2	3	0	1	4	0	0
2	26473361	.	C	T	9	5	14	0	1	15	0	0
2	26473458	.	C	A	3	2	5	0	0	5	0	0
2	26473461	.	G	A	3	2	5	0	0	5	0	0
2	26476109	.	G	A	1	2	3	0	0	3	0	0
2	26480101	.	A	G	4	3	7	0	4	11	0	0
2	26481029	.	C	T	5	3	8	0	0	8	0	0
2	26483946	.	G	T	4	6	10	0	0	10	0	0
2	26489500	.	C	T	1	0	1	0	0	1	0	0
2	26489681	.	T	C	4	3	7	0	1	8	0	0
2	26491830	.	C	A	3	4	7	0	0	7	0	0
2	26494507	.	G	A	1	5	6	0	0	6	0	0
2	26499519	.	C	T	16	12	28	0	0	28	0	0
2	26500872	.	T	C	23	25	48	0	3	51	0	0
2	26500989	.	C	T	10	2	12	0	0	12	0	0
2	26577125	.	T	C	2	2	4	0	0	4	0	0
2	26577189	.	T	C	9	7	16	0	1	17	0	0
2	26577267	.	G	C	9	7	16	0	0	16	0	0
2	26577314	.	T	A	9	8	17	0	0	17	0	0
2	26577378	.	A	G	8	8	16	0	0	16	0	0
2	26578227	.	T	G	3	4	7	0	0	7	0	0
2	26586185	.	C	G	0	2	2	0	0	2	0	0
2	26599287	.	G	A	3	3	6	0	0	6	0	0
2	26604890	.	G	A	3	2	5	0	1	6	0	0
2	26605050	.	A	G	1	2	3	0	0	3	0	0
2	26609651	.	C	A	0	0	0	0	1	1	0	0
2	26609710	.	C	T	2	1	3	0	0	3	0	0
2	26610677	.	T	C	0	1	1	0	0	1	0	0
2	26612624	.	G	C	8	4	12	0	0	12	0	0
2	26612893	.	T	C	10	14	24	0	2	26	0	0
2	26617098	.	A	G	11	8	19	0	0	19	0	0
2	26619829	.	G	T	1	0	1	0	1	2	0	0
2	26620695	.	A	G	8	9	17	0	0	17	0	0
2	26627301	.	C	A	18	16	34	0	1	35	0	0
2	26627332	.	T	A	7	2	9	0	2	11	0	0
2	26630587	.	C	T	1	16	17	0	12	29	0	0
2	26632384	.	T	G	8	9	17	0	0	17	0	0
2	26638355	.	T	G	1	6	7	0	0	7	0	0
2	26638809	.	C	T	2	0	2	0	1	3	0	0
2	26639157	.	T	C	5	4	9	0	1	10	0	0
2	26639217	.	A	G	3	8	11	0	1	12	0	0
2	26662113	.	T	C	7	5	12	0	1	13	0	0
2	26662143	.	T	A	2	3	5	0	0	5	0	0
2	26665065	.	A	G	5	7	12	0	1	13	0	0
2	26665081	.	A	G	6	8	14	0	0	14	0	0
2	26665198	.	T	C	4	5	9	0	0	9	0	0
2	26665199	.	T	C	4	5	9	0	0	9	0	0
2	26665631	.	A	T	9	5	14	0	1	15	0	0
2	26665650	.	A	G	9	8	17	0	0	17	0	0
2	26672266	.	A	G	14	18	32	0	1	33	0	0
2	26672320	.	G	A	10	9	19	0	0	19	0	0
2	26672395	.	G	A	2	11	13	0	2	15	0	0
2	26672440	.	A	G	7	10	17	0	0	17	0	0
2	26672672	.	G	A	8	13	21	0	0	21	0	0
2	26672761	.	T	G	4	1	5	0	6	11	0	0
2	26672826	.	A	C	3	3	6	0	0	6	0	0
2	26676807	.	T	A	4	2	6	0	0	6	0	0
2	26677109	.	T	A	5	6	11	0	0	11	0	0
2	26677111	.	T	A	5	5	10	0	1	11	0	0
2	26677346	.	T	G	3	6	9	0	2	11	0	0
2	26677361	.	C	A	4	7	11	0	0	11	0	0
2	26677445	.	A	G	11	4	15	0	0	15	0	0
2	26677453	.	T	C	12	3	15	0	0	15	0	0
2	26680213	.	G	A	3	4	7	0	0	7	0	0
2	26680440	.	G	A	5	3	8	0	0	8	0	0
2	26681076	.	A	G	4	5	9	0	0	9	0	0
2	26681499	.	T	G	1	4	5	0	0	5	0	0
2	26681500	.	A	T	1	4	5	0	0	5	0	0
2	26681837	.	G	A	4	6	10	0	0	10	0	0
2	26681942	.	A	C	2	5	7	0	0	7	0	0
2	26681958	.	G	T	1	3	4	0	0	4	0	0
2	26682031	.	G	T	0	4	4	0	5	9	0	0
2	26688691	.	A	T	7	5	12	0	0	12	0	0
2	26688737	.	G	A	2	2	4	0	0	4	0	0
2	26688747	.	A	G	2	0	2	0	3	5	0	0
2	26697666	.	C	T	0	1	1	0	2	3	0	0
2	26697929	.	A	G	0	3	3	0	0	3	0	0
2	26714144	.	A	G	4	3	7	0	0	7	0	0
2	26714399	.	C	T	1	2	3	0	0	3	0	0
2	26714402	.	C	T	1	2	3	0	0	3	0	0
2	27000728	.	G	T	0	0	0	0	2	2	0	0
2	27000729	.	A	C	1	1	2	0	0	2	0	0
2	27010330	.	A	G	2	0	2	0	4	6	0	0
2	27064687	.	T	C	3	3	6	0	2	8	0	0
2	27330838	.	T	A	3	4	7	0	0	7	0	0
2	27341572	.	C	A	0	3	3	0	0	3	0	0
2	27341611	.	A	T	1	3	4	0	0	4	0	0
2	27341726	.	C	T	4	2	6	0	0	6	0	0
2	27372537	.	C	G	2	4	6	0	1	7	0	0
2	27372576	.	G	A	0	3	3	0	0	3	0	0
2	27377541	.	T	A	5	3	8	0	0	8	0	0
2	27377590	.	T	C	4	5	9	0	0	9	0	0
2	27378071	.	T	A	3	3	6	0	0	6	0	0
2	27378266	.	A	G	6	8	14	0	1	15	0	0
2	27378439	.	A	G	1	0	1	0	2	3	0	0
2	27378524	.	T	A	8	4	12	0	2	14	0	0
2	27378840	.	T	C	4	3	7	0	1	8	0	0
2	27379049	.	C	T	1	5	6	0	0	6	0	0
2	27379084	.	T	A	1	3	4	0	0	4	0	0
2	27379170	.	C	T	3	2	5	0	0	5	0	0
2	27380114	.	A	G	2	2	4	0	0	4	0	0
2	27380292	.	G	T	5	4	9	0	2	11	0	0
2	27380336	.	G	A	4	3	7	0	1	8	0	0
2	27380366	.	C	A	0	6	6	0	5	11	0	0
2	27380500	.	G	T	2	6	8	0	0	8	0	0
2	27382232	.	C	G	1	4	5	0	0	5	0	0
2	27382489	.	G	A	1	2	3	0	0	3	0	0
2	27384708	.	C	T	1	1	2	0	0	2	0	0
2	27384765	.	G	C	1	0	1	0	1	2	0	0
2	27385755	.	T	A	1	4	5	0	0	5	0	0
2	27388731	.	A	G	3	0	3	0	2	5	0	0
2	27391188	.	G	A	2	2	4	0	0	4	0	0
2	27532523	.	A	G	2	1	3	0	0	3	0	0
2	27540182	.	C	T	1	2	3	0	0	3	0	0
2	27540488	.	C	A	15	8	23	0	1	24	0	0
2	27540614	.	C	T	15	11	26	0	2	28	0	0
2	27540905	.	T	C	12	8	20	0	1	21	0	0
2	27541246	.	A	C	2	2	4	0	0	4	0	0
2	27541468	.	C	T	10	5	15	0	0	15	0	0
2	27541914	.	A	C	8	9	17	0	0	17	0	0
2	27542083	.	G	A	9	10	19	0	1	20	0	0
2	27542958	.	A	G	8	8	16	0	1	17	0	0
2	27543499	.	C	A	3	5	8	0	1	9	0	0
2	27614046	.	A	G	2	2	4	0	0	4	0	0
2	27614082	.	G	C	1	0	1	0	0	1	0	0
2	27635488	.	T	C	2	2	4	0	0	4	0	0
2	27635788	.	C	T	1	3	4	0	0	4	0	0
2	27635849	.	C	A	6	4	10	0	1	11	0	0
2	27635928	.	T	A	1	2	3	0	1	4	0	0
2	27641159	.	T	C	2	0	2	0	2	4	0	0
2	27641287	.	G	A	0	1	1	0	0	1	0	0
2	27642776	.	C	G	1	3	4	0	0	4	0	0
2	27646615	.	A	C	2	3	5	0	0	5	0	0
2	27646626	.	C	G	1	1	2	0	0	2	0	0
2	27658973	.	T	G	5	7	12	0	0	12	0	0
2	27659018	.	T	C	9	8	17	0	0	17	0	0
2	27662706	.	T	C	1	3	4	0	1	5	0	0
2	27662711	.	T	G	2	0	2	0	2	4	0	0
2	27663513	.	A	G	3	2	5	0	1	6	0	0
2	27663616	.	T	G	6	5	11	0	1	12	0	0
2	27663673	.	G	A	0	16	16	0	3	19	0	0
2	27663867	.	C	T	3	7	10	0	0	10	0	0
2	27664105	.	G	A	2	6	8	0	0	8	0	0
2	27664195	.	A	C	1	3	4	0	0	4	0	0
2	27664317	.	G	T	6	2	8	0	1	9	0	0
2	27664407	.	G	C	4	3	7	0	1	8	0	0
2	27670760	.	T	C	7	3	10	0	0	10	0	0
2	27670769	.	T	C	9	2	11	0	0	11	0	0
2	27670836	.	C	T	0	11	11	0	8	19	0	0
2	27670886	.	T	C	8	0	8	0	9	17	0	0
2	27672705	.	A	G	9	8	17	0	1	18	0	0
2	27673041	.	A	G	5	14	19	0	1	20	0	0
2	27673173	.	A	G	10	9	19	0	1	20	0	0
2	27673194	.	C	T	7	12	19	0	1	20	0	0
2	27673233	.	T	C	10	9	19	0	0	19	0	0
2	27691348	.	T	C	12	0	12	0	12	24	0	0
2	27691375	.	G	A	12	13	25	0	0	25	0	0
2	27691408	.	T	C	9	11	20	0	1	21	0	0
2	27691459	.	A	G	1	4	5	0	0	5	0	0
2	27812578	.	G	A	2	2	4	0	0	4	0	0
2	27812592	.	C	A	1	0	1	0	0	1	0	0
2	27843848	.	C	T	4	2	6	0	0	6	0	0
2	27846053	.	T	A	5	4	9	0	1	10	0	0
2	27846108	.	G	A	6	9	15	0	0	15	0	0
2	27848151	.	T	G	6	8	14	0	1	15	0	0
2	27849787	.	G	A	3	2	5	0	0	5	0	0
2	27858983	.	A	G	1	2	3	0	0	3	0	0
2	27858997	.	T	C	1	2	3	0	0	3	0	0
2	27932918	.	G	A	1	3	4	0	0	4	0	0
2	27932919	.	A	G	1	3	4	0	0	4	0	0
2	27933143	.	C	T	3	4	7	0	0	7	0	0
2	27933215	.	C	A	8	3	11	0	0	11	0	0
2	27969534	.	T	C	1	0	1	0	0	1	0	0
2	27975150	.	G	A	1	0	1	0	0	1	0	0
2	28049445	.	T	C	16	8	24	0	0	24	0	0
2	28049996	.	A	G	10	14	24	0	0	24	0	0
2	28050565	.	T	A	7	5	12	0	0	12	0	0
2	28050600	.	G	C	3	1	4	0	6	10	0	0
2	28050759	.	A	G	4	7	11	0	0	11	0	0
2	28050933	.	G	A	6	8	14	0	0	14	0	0
2	28057518	.	G	A	6	3	9	0	0	9	0	0
2	28077152	.	C	A	0	2	2	0	1	3	0	0
2	28077171	.	A	G	3	3	6	0	0	6	0	0
2	28085730	.	T	A	3	4	7	0	0	7	0	0
2	28085746	.	A	G	1	3	4	0	1	5	0	0
2	28650238	.	A	G	1	5	6	0	3	9	0	0
2	28650248	.	C	A	1	5	6	0	3	9	0	0
2	28650273	.	C	A	2	5	7	0	1	8	0	0
2	28650309	.	A	T	1	4	5	0	0	5	0	0
2	28650352	.	A	C	3	6	9	0	0	9	0	0
2	28650358	.	T	A	2	6	8	0	1	9	0	0
2	28650422	.	T	C	6	8	14	0	0	14	0	0
2	28650504	.	T	C	4	5	9	0	0	9	0	0
2	28650521	.	G	A	2	2	4	0	0	7	3	0
2	28650567	.	G	T	7	2	9	0	0	9	0	0
2	28650577	.	A	T	10	2	12	0	0	12	0	0
2	28651193	.	A	G	11	9	20	0	0	20	0	0
2	28651497	.	G	A	6	4	10	0	1	11	0	0
2	28657936	.	T	C	0	2	2	0	0	2	0	0
2	28682654	.	A	G	0	1	1	0	0	1	0	0
2	28930159	.	T	C	1	2	3	0	0	3	0	0
2	28934011	.	C	T	8	9	17	0	1	18	0	0
2	28934041	.	A	G	7	0	7	0	8	15	0	0
2	29113515	.	G	A	1	1	2	0	0	2	0	0
2	29113527	.	A	G	1	2	3	0	0	3	0	0
2	29113581	.	A	G	0	0	0	0	2	2	0	0
2	29113587	.	G	A	0	2	2	0	0	2	0	0
2	29257726	.	T	C	0	1	1	0	0	1	0	0
2	29310996	.	G	A	0	2	2	0	3	5	0	0
2	29317718	.	G	A	9	4	13	0	0	13	0	0
2	29352333	.	G	A	0	12	12	0	7	19	0	0
2	29352479	.	C	T	5	5	10	0	0	10	0	0
2	29477733	.	A	T	18	14	32	0	0	32	0	0
2	29477769	.	G	T	13	15	28	0	3	31	0	0
2	29477895	.	A	T	20	11	31	0	1	32	0	0
2	29477979	.	T	G	6	7	13	0	1	14	0	0
2	29484113	.	A	G	14	13	27	0	0	28	1	0
2	29485046	.	G	A	4	4	8	0	0	8	0	0
2	29491445	.	C	T	1	2	3	0	0	3	0	0
2	29491504	.	T	C	1	2	3	0	0	3	0	0
2	29610350	.	A	G	2	5	7	0	1	8	0	0
2	29610464	.	G	A	1	6	7	0	0	7	0	0
2	29610866	.	A	C	1	4	5	0	0	5	0	0
2	29676848	.	T	C	2	1	3	0	0	3	0	0
2	29685506	.	G	A	0	1	1	0	0	1	0	0
2	29685575	.	A	G	5	1	6	0	5	11	0	0
2	29892926	.	G	A	3	2	5	0	0	5	0	0
2	29894409	.	A	T	2	2	4	0	0	4	0	0
2	29894410	.	C	T	2	2	4	0	0	4	0	0
2	29895896	.	A	T	0	3	3	0	0	3	0	0
2	29905111	.	T	A	1	6	7	0	0	7	0	0
2	29914231	.	G	T	0	1	1	0	0	1	0	0
2	29916028	.	G	A	2	3	5	0	0	5	0	0
2	29976960	.	T	A	7	8	15	0	2	17	0	0
2	29986517	.	T	C	1	1	2	0	0	2	0	0
2	29986609	.	C	G	0	1	1	0	0	1	0	0
2	29995868	.	T	C	2	0	2	0	2	4	0	0
2	30106271	.	A	G	12	11	23	0	1	24	0	0
2	30108443	.	T	C	7	4	11	0	1	12	0	0
2	30108456	.	T	C	11	5	16	0	1	17	0	0
2	30108542	.	T	G	2	1	3	0	1	4	0	0
2	30109678	.	C	T	3	5	8	0	1	9	0	0
2	30116206	.	C	T	8	7	15	0	0	15	0	0
2	30116586	.	C	A	6	5	11	0	0	11	0	0
2	30116589	.	C	T	5	5	10	0	1	11	0	0
2	30116688	.	A	C	8	5	13	0	0	13	0	0
2	30116808	.	T	A	11	6	17	0	0	17	0	0
2	30116889	.	C	A	9	8	17	1	0	18	0	0
2	30116905	.	A	G	9	4	13	0	2	15	0	0
2	30117123	.	C	A	1	4	5	0	0	5	0	0
2	30117169	.	T	C	1	7	8	0	0	8	0	0
2	30117201	.	T	C	3	6	9	0	1	10	0	0
2	30117245	.	A	T	6	3	9	0	0	9	0	0
2	30117249	.	A	T	6	4	10	0	0	10	0	0
2	30176159	.	T	C	2	4	6	0	0	6	0	0
2	30178100	.	C	T	2	2	4	0	0	4	0	0
2	30194777	.	C	T	6	6	12	0	1	13	0	0
2	30194938	.	G	A	1	4	5	0	0	5	0	0
2	30245900	.	G	C	2	5	7	0	0	7	0	0
2	30245922	.	T	C	5	9	14	0	0	14	0	0
2	30246029	.	T	A	9	13	22	0	1	23	0	0
2	30250126	.	A	T	7	4	11	0	2	13	0	0
2	30251864	.	G	T	3	6	9	0	0	9	0	0
2	30252029	.	T	C	3	7	10	0	0	10	0	0
2	30252071	.	G	A	0	5	5	0	4	9	0	0
2	30252206	.	T	C	3	5	8	0	0	8	0	0
2	30252235	.	C	T	1	3	4	0	0	4	0	0
2	30290749	.	A	G	6	4	10	0	0	10	0	0
2	30290946	.	C	T	5	2	7	0	0	7	0	0
2	30290956	.	C	T	4	2	6	0	0	6	0	0
2	30291072	.	A	C	6	9	15	0	1	16	0	0
2	30295050	.	T	A	5	10	15	0	2	17	0	0
2	30295052	.	T	G	6	11	17	0	0	17	0	0
2	30295155	.	G	C	1	11	12	0	1	13	0	0
2	30295156	.	G	A	1	6	7	0	6	13	0	0
2	30295288	.	A	G	7	10	17	0	0	17	0	0
2	30319374	.	C	T	2	9	11	0	0	11	0	0
2	30319375	.	T	G	2	9	11	0	0	11	0	0
2	30319463	.	C	G	3	8	11	0	0	11	0	0
2	30423663	.	C	G	3	3	6	0	0	6	0	0
2	30428310	.	C	G	4	5	9	0	0	9	0	0
2	30428553	.	G	A	0	4	4	0	7	11	0	0
2	30428637	.	A	G	3	0	3	0	5	8	0	0
2	30428790	.	A	T	3	2	5	0	1	6	0	0
2	30429006	.	C	T	6	3	9	0	0	9	0	0
2	30429367	.	C	T	2	3	5	0	0	5	0	0
2	30429710	.	A	T	4	6	10	0	0	10	0	0
2	30429711	.	T	C	4	6	10	0	0	10	0	0
2	30430226	.	T	A	2	2	4	0	0	4	0	0
2	30458754	.	G	A	15	20	35	0	0	35	0	0
2	30460135	.	A	G	10	7	17	0	0	17	0	0
2	30481172	.	T	G	1	5	6	0	0	6	0	0
2	30481379	.	G	A	0	2	2	0	2	4	0	0
2	30504472	.	A	G	0	1	1	0	0	1	0	0
2	30519768	.	C	T	7	3	10	0	0	10	0	0
2	30519975	.	G	A	0	10	10	0	10	20	0	0
2	30520026	.	G	T	4	4	8	0	0	8	0	0
2	30523047	.	A	G	4	3	7	0	1	8	0	0
2	30523053	.	C	T	5	3	8	0	0	8	0	0
2	30524966	.	C	T	19	15	34	0	0	34	0	0
2	30524992	.	T	C	22	15	37	0	2	39	0	0
2	30525062	.	A	G	9	15	24	0	3	27	0	0
2	30525105	.	A	G	12	9	21	0	5	26	0	0
2	30525117	.	C	T	18	11	29	0	2	31	0	0
2	30525169	.	G	T	1	6	7	0	15	22	0	0
2	30525297	.	T	C	7	12	19	0	0	19	0	0
2	30525378	.	C	A	8	12	20	0	1	21	0	0
2	30525596	.	A	G	13	1	14	0	16	30	0	0
2	30525970	.	A	G	23	15	38	0	1	39	0	0
2	30554512	.	G	A	18	9	27	0	2	29	0	0
2	30556102	.	C	A	3	19	22	0	20	42	0	0
2	30556103	.	G	T	19	19	38	0	4	42	0	0
2	30556386	.	G	A	12	9	21	0	4	25	0	0
2	30556419	.	G	T	13	11	24	0	5	29	0	0
2	30561285	.	T	C	5	7	12	0	0	12	0	0
2	30568944	.	A	T	11	5	16	0	0	16	0	0
2	30568959	.	C	T	10	5	15	0	0	15	0	0
2	30579831	.	G	A	2	3	5	0	1	6	0	0
2	30613964	.	A	G	4	4	8	0	1	9	0	0
2	30614153	.	C	A	9	12	21	0	1	22	0	0
2	30693533	.	A	G	3	2	5	0	0	5	0	0
2	30693712	.	G	A	7	2	9	0	0	9	0	0
2	30743041	.	T	C	5	6	11	0	0	11	0	0
2	30743864	.	A	G	7	13	20	0	0	20	0	0
2	30743907	.	T	C	10	16	26	0	2	28	0	0
2	30743951	.	C	A	4	1	5	0	0	5	0	0
2	30752675	.	C	T	5	3	8	0	0	8	0	0
2	30753072	.	A	T	16	8	24	0	1	25	0	0
2	30753273	.	G	A	10	13	23	0	1	24	0	0
2	30753720	.	C	T	0	7	7	0	11	18	0	0
2	30753722	.	A	C	11	7	18	0	0	18	0	0
2	30753813	.	G	A	7	10	17	0	2	19	0	0
2	30753928	.	G	A	4	7	11	0	1	12	0	0
2	30753991	.	A	G	7	7	14	0	0	14	0	0
2	30754113	.	T	C	11	11	22	0	1	23	0	0
2	30754196	.	G	A	11	17	28	0	1	29	0	0
2	30754300	.	C	T	14	12	26	0	3	29	0	0
2	30754346	.	A	G	17	20	37	0	1	38	0	0
2	30754432	.	G	T	16	18	34	0	1	35	0	0
2	30754777	.	A	T	9	11	20	0	0	20	0	0
2	30754793	.	A	T	9	7	16	0	0	16	0	0
2	30754885	.	A	T	6	4	10	0	1	11	0	0
2	30754932	.	A	G	3	2	5	0	0	5	0	0
2	30754940	.	T	A	2	3	5	0	1	6	0	0
2	30755134	.	G	A	2	2	4	0	1	5	0	0
2	30755195	.	G	A	3	4	7	0	1	8	0	0
2	30755272	.	T	C	5	0	5	0	6	11	0	0
2	30755278	.	C	A	0	4	4	0	4	8	0	0
2	30755345	.	T	G	6	9	15	1	0	16	0	0
2	30755386	.	T	C	10	0	10	1	6	17	0	0
2	30755660	.	A	G	6	11	17	0	0	17	0	0
2	30755666	.	A	T	6	9	15	0	1	16	0	0
2	30755733	.	A	T	4	8	12	0	0	12	0	0
2	30756091	.	T	C	2	3	5	0	0	5	0	0
2	30756157	.	G	T	6	8	14	0	0	14	0	0
2	30756264	.	A	G	3	9	12	0	0	12	0	0
2	30756320	.	T	A	5	4	9	0	1	10	0	0
2	30756903	.	A	G	11	11	22	0	0	22	0	0
2	30786795	.	T	C	0	3	3	0	0	3	0	0
2	30787387	.	A	C	3	2	5	0	0	5	0	0
2	30794792	.	T	C	2	4	6	0	0	6	0	0
2	30821859	.	G	A	12	15	27	0	0	27	0	0
2	30821965	.	C	T	15	10	25	0	2	27	0	0
2	30823438	.	T	G	2	0	2	0	2	4	0	0
2	30846719	.	A	G	22	12	34	0	2	36	0	0
2	30886228	.	C	T	1	5	6	0	0	6	0	0
2	30886240	.	T	C	1	4	5	0	0	5	0	0
2	30897111	.	C	T	9	3	12	0	1	13	0	0
2	30897990	.	C	T	6	4	10	0	0	10	0	0
2	30898196	.	T	C	1	2	3	0	0	3	0	0
2	30900927	.	C	A	5	9	14	0	4	18	0	0
2	30900945	.	G	C	7	7	14	0	1	15	0	0
2	30900994	.	T	A	12	12	24	0	0	24	0	0
2	30901060	.	A	G	13	1	14	0	8	22	0	0
2	30904137	.	G	A	5	4	9	0	0	9	0	0
2	30905298	.	G	A	3	3	6	0	1	7	0	0
2	30907655	.	T	A	11	18	29	0	0	29	0	0
2	30908006	.	A	T	7	3	10	0	2	12	0	0
2	30960401	.	A	G	18	4	22	0	0	22	0	0
2	30960455	.	A	G	3	0	3	0	15	18	0	0
2	30960456	.	T	C	3	15	18	0	0	18	0	0
2	30971642	.	T	C	4	9	13	0	0	13	0	0
2	30971726	.	T	C	6	8	14	0	1	15	0	0
2	30971783	.	T	C	8	6	14	0	3	17	0	0
2	30971951	.	G	A	3	2	5	0	1	6	0	0
2	30972259	.	A	G	5	0	5	0	8	13	0	0
2	30982409	.	T	C	5	9	14	0	0	14	0	0
2	30982612	.	T	C	12	14	26	0	4	30	0	0
2	30982640	.	A	G	14	11	25	0	0	25	0	0
2	30982897	.	A	G	6	9	15	0	1	16	0	0
2	30982929	.	T	A	8	9	17	0	1	18	0	0
2	30983267	.	G	A	10	16	26	0	1	27	0	0
2	30983294	.	T	C	9	15	24	0	6	30	0	0
2	31297980	.	A	G	21	33	54	0	1	55	0	0
2	31298077	.	A	G	26	30	56	0	2	58	0	0
2	31298280	.	A	G	20	23	43	0	2	45	0	0
2	31298342	.	G	A	26	27	53	0	1	54	0	0
2	31298483	.	C	A	21	33	54	0	0	54	0	0
2	31298550	.	T	C	12	27	39	0	2	41	0	0
2	31298703	.	T	G	18	27	45	0	2	47	0	0
2	31298723	.	C	T	18	24	42	0	5	47	0	0
2	31298824	.	A	C	35	24	59	0	3	62	0	0
2	31299241	.	A	C	13	10	23	0	0	23	0	0
2	31301318	.	T	C	1	2	3	0	0	3	0	0
2	31302609	.	C	T	8	5	13	0	0	13	0	0
2	31308668	.	T	A	1	7	8	0	1	9	0	0
2	31308849	.	C	T	2	5	7	0	0	7	0	0
2	31345207	.	A	C	5	2	7	0	0	7	0	0
2	31348414	.	C	T	4	5	9	0	0	9	0	0
2	31348474	.	G	A	0	7	7	0	4	11	0	0
2	31360724	.	G	A	7	2	9	0	0	9	0	0
2	31360799	.	G	A	14	6	20	0	3	23	0	0
2	31361205	.	C	T	10	9	19	0	1	20	0	0
2	31361380	.	A	C	2	4	6	0	1	7	0	0
2	31361466	.	C	G	7	3	10	0	2	12	0	0
2	31361836	.	A	G	11	3	14	0	0	14	0	0
2	31362285	.	A	G	12	4	16	0	0	16	0	0
2	31362642	.	T	C	9	8	17	0	0	17	0	0
2	31362681	.	T	C	11	4	15	0	0	15	0	0
2	31362730	.	A	T	6	4	10	0	0	10	0	0
2	31362859	.	T	A	9	5	14	0	0	14	0	0
2	31362896	.	T	C	7	6	13	0	0	14	1	0
2	31363190	.	C	T	14	6	20	0	1	21	0	0
2	31363322	.	A	T	1	3	4	0	0	4	0	0
2	31451284	.	G	A	4	3	7	0	0	7	0	0
2	31451288	.	A	G	4	3	7	0	0	7	0	0
2	31451518	.	G	A	8	4	12	0	0	12	0	0
2	31451542	.	G	A	9	6	15	0	0	15	0	0
2	31451568	.	C	T	8	8	16	0	1	17	0	0
2	31451778	.	G	T	15	15	30	0	0	30	0	0
2	31451871	.	T	A	12	11	23	0	1	24	0	0
2	31452078	.	C	T	21	10	31	0	1	32	0	0
2	31452226	.	T	C	9	24	33	0	2	35	0	0
2	31452354	.	C	T	19	15	34	0	0	34	0	0
2	31507750	.	A	T	6	4	10	0	0	10	0	0
2	31507882	.	T	C	1	0	1	0	0	1	0	0
2	31511760	.	C	A	9	9	18	0	2	20	0	0
2	31511763	.	C	T	10	9	19	0	1	20	0	0
2	31511810	.	C	A	6	10	16	0	3	19	0	0
2	31511884	.	A	C	9	5	14	0	0	14	0	0
2	31511945	.	G	A	10	4	14	0	0	14	0	0
2	31511946	.	G	A	10	4	14	0	0	14	0	0
2	31515883	.	C	G	2	6	8	0	0	8	0	0
2	31515892	.	G	T	1	3	4	0	1	5	0	0
2	31627079	.	T	A	5	1	6	0	1	7	0	0
2	31627150	.	C	A	9	3	12	0	0	12	0	0
2	31627173	.	C	T	9	5	14	0	0	14	0	0
2	31627212	.	C	G	7	5	12	0	0	12	0	0
2	31627219	.	C	T	7	6	13	0	0	13	0	0
2	31627423	.	C	G	0	3	3	0	3	6	0	0
2	31630129	.	A	T	10	5	15	0	0	15	0	0
2	31630443	.	G	A	2	0	2	0	0	2	0	0
2	31634870	.	A	G	6	11	17	0	0	17	0	0
2	31634929	.	A	C	11	6	17	0	1	18	0	0
2	31635007	.	A	T	11	8	19	0	0	19	0	0
2	31635161	.	A	G	6	13	19	0	2	21	0	0
2	31635229	.	C	T	14	7	21	0	1	22	0	0
2	31635287	.	T	C	16	10	26	0	1	27	0	0
2	31635395	.	T	G	6	11	17	0	0	17	0	0
2	31635490	.	A	T	9	11	20	0	1	21	0	0
2	31635599	.	T	C	8	5	13	0	0	13	0	0
2	31635803	.	G	T	4	6	10	0	0	10	0	0
2	31635824	.	C	T	4	5	9	0	0	9	0	0
2	31635859	.	C	T	5	6	11	0	0	11	0	0
2	31635860	.	T	C	5	6	11	0	0	11	0	0
2	31635900	.	T	C	4	10	14	0	1	15	0	0
2	31636048	.	A	G	6	6	12	0	0	12	0	0
2	31636057	.	T	C	5	0	5	0	6	11	0	0
2	31638004	.	C	T	2	6	8	0	0	8	0	0
2	31638111	.	G	T	6	9	15	0	1	16	0	0
2	31638124	.	G	A	5	13	18	0	0	18	0	0
2	31638323	.	A	C	8	0	8	0	5	13	0	0
2	31640332	.	G	A	0	2	2	0	0	2	0	0
2	31640561	.	T	C	2	0	2	0	0	2	0	0
2	31690434	.	T	A	4	10	14	0	0	14	0	0
2	31690442	.	A	C	4	8	12	0	0	12	0	0
2	31692370	.	T	C	0	1	1	0	0	1	0	0
2	31700352	.	A	T	3	3	6	0	0	6	0	0
2	31700378	.	T	G	1	2	3	0	0	3	0	0
2	31703368	.	T	A	4	2	6	0	0	6	0	0
2	31703407	.	A	G	3	6	9	0	0	9	0	0
2	31703443	.	C	T	1	4	5	0	0	5	0	0
2	31703678	.	C	T	0	5	5	0	1	6	0	0
2	31707724	.	C	G	1	3	4	0	0	4	0	0
2	31710374	.	A	T	1	2	3	0	0	3	0	0
2	31722631	.	A	T	6	5	11	0	0	11	0	0
2	31727584	.	G	C	1	1	2	0	0	2	0	0
2	31735068	.	T	G	10	7	17	0	0	17	0	0
2	31781901	.	A	G	3	2	5	0	0	5	0	0
2	31782003	.	T	C	7	6	13	0	0	13	0	0
2	31784132	.	A	T	3	3	6	0	0	6	0	0
2	31806920	.	C	T	2	9	11	0	0	11	0	0
2	31820830	.	T	C	7	6	13	0	0	13	0	0
2	31821290	.	C	A	3	4	7	0	0	7	0	0
2	31826750	.	C	T	16	13	29	0	2	31	0	0
2	31827649	.	A	G	10	9	19	0	1	20	0	0
2	31827714	.	A	G	11	1	12	0	5	18	1	0
2	31833082	.	C	T	2	3	5	0	0	5	0	0
2	31834099	.	G	T	21	15	36	0	2	38	0	0
2	31834110	.	T	C	21	12	33	0	1	34	0	0
2	31834187	.	C	T	14	9	23	0	1	24	0	0
2	31836113	.	T	G	18	12	30	0	1	31	0	0
2	31836119	.	G	T	1	12	13	0	20	33	0	0
2	31836307	.	T	A	16	9	25	0	2	27	0	0
2	31836440	.	A	G	12	1	13	0	10	23	0	0
2	31836508	.	G	A	1	2	3	0	0	3	0	0
2	31836512	.	A	G	1	0	1	0	2	3	0	0
2	31836550	.	C	A	3	3	6	0	0	6	0	0
2	31836588	.	T	C	4	9	13	0	0	13	0	0
2	31836763	.	T	A	10	2	12	0	1	13	0	0
2	31838524	.	A	G	5	1	6	0	0	6	0	0
2	31842454	.	T	G	3	6	9	0	1	10	0	0
2	31891344	.	T	A	12	11	23	0	0	25	2	0
2	31891447	.	A	T	14	13	27	0	5	32	0	0
2	31891513	.	T	C	14	25	39	0	4	43	0	0
2	31891549	.	C	A	16	30	46	0	1	47	0	0
2	31891618	.	A	G	26	25	51	0	2	53	0	0
2	31892076	.	A	G	25	10	35	0	1	36	0	0
2	31892100	.	C	T	1	13	14	0	26	40	0	0
2	31894220	.	T	C	5	5	10	0	0	10	0	0
2	31901953	.	T	C	6	16	22	0	1	23	0	0
2	31902939	.	G	A	4	12	16	0	0	16	0	0
2	31902954	.	C	T	8	20	28	0	0	28	0	0
2	31913491	.	A	G	0	1	1	0	0	1	0	0
2	31919171	.	G	A	6	5	11	0	0	11	0	0
2	31927266	.	C	T	0	2	2	0	3	5	0	0
2	31943187	.	A	G	2	4	6	0	0	6	0	0
2	31944840	.	C	T	2	0	2	0	0	2	0	0
2	31948424	.	A	G	5	6	11	0	0	11	0	0
2	31948438	.	A	G	3	8	11	0	0	11	0	0
2	31948459	.	C	T	1	9	10	0	0	10	0	0
2	31957808	.	T	C	13	10	23	0	0	23	0	0
2	31975190	.	G	C	7	9	16	0	1	17	0	0
2	31987267	.	A	G	5	4	9	0	0	9	0	0
2	31987352	.	A	C	6	7	13	0	0	13	0	0
2	31987360	.	C	T	3	6	9	0	1	10	0	0
2	31989876	.	T	C	8	7	15	0	0	15	0	0
2	31993886	.	T	C	2	5	7	0	0	7	0	0
2	32005371	.	G	A	8	9	17	0	0	17	0	0
2	32018077	.	A	C	3	6	9	0	1	10	0	0
2	32018141	.	A	G	4	1	5	0	4	9	0	0
2	32089317	.	A	G	2	1	3	0	0	3	0	0
2	32264673	.	T	C	17	1	18	0	16	34	0	0
2	32264879	.	G	A	8	11	19	0	1	20	0	0
2	32264927	.	T	A	17	9	26	0	1	27	0	0
2	32265437	.	T	A	11	12	23	0	1	24	0	0
2	32265508	.	T	C	4	11	15	0	0	15	0	0
2	32265525	.	T	C	5	0	5	0	10	15	0	0
2	32265543	.	A	T	6	9	15	0	0	15	0	0
2	32265890	.	G	T	4	4	8	0	0	8	0	0
2	32265911	.	T	C	7	4	11	0	1	12	0	0
2	32266064	.	G	C	14	10	24	0	0	25	1	0
2	32266101	.	T	G	9	5	14	1	1	16	0	0
2	32266711	.	C	T	0	16	16	0	8	24	0	0
2	32266895	.	A	G	8	8	16	0	0	16	0	0
2	32267105	.	T	G	11	23	34	0	1	35	0	0
2	32267117	.	C	T	0	21	21	0	12	33	0	0
2	32267285	.	A	G	9	16	25	0	0	25	0	0
2	32267506	.	T	C	5	12	17	0	3	20	0	0
2	32267950	.	G	A	8	8	16	0	1	17	0	0
2	32268096	.	C	T	0	14	14	0	5	19	0	0
2	32270976	.	T	C	13	6	19	0	0	19	0	0
2	32270991	.	T	C	11	0	11	0	6	17	0	0
2	32276277	.	G	A	5	6	11	0	1	12	0	0
2	32299324	.	A	G	1	2	3	0	0	3	0	0
2	32299336	.	C	T	3	2	5	0	1	6	0	0
2	32299387	.	A	C	2	6	8	0	0	8	0	0
2	32306297	.	C	T	2	3	5	0	0	5	0	0
2	32352883	.	A	G	5	4	9	0	0	9	0	0
2	32357811	.	G	A	10	9	19	0	0	19	0	0
2	32357888	.	A	G	13	7	20	0	2	22	0	0
2	32357980	.	T	C	10	1	11	0	8	19	0	0
2	32358059	.	T	C	13	0	13	0	5	18	0	0
2	32358081	.	A	T	12	6	18	0	2	20	0	0
2	32361446	.	A	T	1	2	3	0	0	3	0	0
2	32361447	.	G	T	1	2	3	0	0	3	0	0
2	32361687	.	T	C	3	0	3	0	3	6	0	0
2	32366137	.	T	C	2	3	5	0	0	5	0	0
2	32366191	.	C	T	12	10	22	0	0	22	0	0
2	32378607	.	T	C	4	5	9	0	0	9	0	0
2	32380649	.	A	G	3	2	5	0	0	5	0	0
2	32386318	.	T	C	1	3	4	0	0	4	0	0
2	32386752	.	T	G	2	4	6	0	1	7	0	0
2	32392314	.	C	T	1	3	4	0	0	4	0	0
2	32392724	.	A	G	5	2	7	0	0	7	0	0
2	32392988	.	T	C	2	5	7	0	0	7	0	0
2	32393125	.	C	T	0	2	2	0	1	3	0	0
2	32393259	.	A	G	1	6	7	0	0	7	0	0
2	32393281	.	T	A	2	5	7	0	0	7	0	0
2	32393460	.	C	T	0	4	4	0	2	6	0	0
2	32393516	.	T	C	3	1	4	0	3	7	0	0
2	32393579	.	T	C	4	2	6	0	0	6	0	0
2	32393670	.	A	G	1	4	5	0	0	5	0	0
2	32393731	.	G	A	8	7	15	0	0	15	0	0
2	32393834	.	C	T	0	3	3	0	6	9	0	0
2	32394424	.	T	C	1	2	3	0	0	3	0	0
2	32396773	.	A	G	0	1	1	0	0	1	0	0
2	32414168	.	A	G	1	3	4	0	0	4	0	0
2	32414171	.	T	G	1	3	4	0	0	4	0	0
2	32426956	.	T	C	3	2	5	0	0	5	0	0
2	32475941	.	A	T	7	3	10	0	0	10	0	0
2	32476018	.	T	G	7	3	10	0	0	10	0	0
2	32476288	.	C	T	13	8	21	0	0	21	0	0
2	32479556	.	T	C	10	0	10	0	12	22	0	0
2	32479616	.	G	A	3	1	4	0	0	4	0	0
2	32485832	.	A	G	13	10	23	0	0	23	0	0
2	32485895	.	C	T	0	6	6	0	10	16	0	0
2	32485962	.	G	A	6	11	17	0	1	18	0	0
2	32505664	.	G	A	7	7	14	0	3	17	0	0
2	32509247	.	G	A	16	7	23	0	1	24	0	0
2	32513440	.	C	T	0	0	0	0	1	1	0	0
2	32516268	.	C	A	0	12	12	0	10	22	0	0
2	32516509	.	A	T	8	10	18	0	0	18	0	0
2	32519666	.	A	G	2	4	6	0	0	6	0	0
2	32519690	.	G	A	4	3	7	0	0	7	0	0
2	32569745	.	A	G	9	5	14	0	0	14	0	0
2	32569909	.	T	C	4	0	4	0	10	14	0	0
2	32577552	.	C	A	3	4	7	0	0	7	0	0
2	32578124	.	A	T	8	10	18	0	1	19	0	0
2	32578330	.	A	G	8	7	15	0	0	15	0	0
2	32578642	.	A	G	8	14	22	0	0	22	0	0
2	32579109	.	C	T	7	8	15	0	0	15	0	0
2	32579170	.	C	A	4	0	4	0	0	4	0	0
2	32579330	.	G	T	2	2	4	0	0	4	0	0
2	32583144	.	A	G	8	11	19	0	0	19	0	0
2	32583345	.	C	T	8	3	11	0	0	11	0	0
2	32583528	.	C	T	0	7	7	0	6	13	0	0
2	32583600	.	A	G	5	8	13	0	1	14	0	0
2	32583629	.	A	C	5	0	5	0	9	14	0	0
2	32583639	.	T	C	4	0	4	0	6	10	0	0
2	32584548	.	C	T	0	3	3	0	1	4	0	0
2	32588669	.	A	G	1	2	3	0	0	3	0	0
2	32590861	.	A	G	4	3	7	0	0	7	0	0
2	32591287	.	A	G	1	0	1	0	0	1	0	0
2	32591381	.	G	A	4	2	6	0	0	6	0	0
2	32591566	.	C	A	5	4	9	0	0	9	0	0
2	32591818	.	A	G	6	9	15	0	0	15	0	0
2	32594279	.	A	G	2	4	6	0	0	6	0	0
2	32594352	.	T	A	5	6	11	0	0	11	0	0
2	32594376	.	A	G	1	6	7	0	1	8	0	0
2	32594411	.	C	G	4	1	5	0	0	5	0	0
2	32594424	.	T	A	4	2	6	0	0	6	0	0
2	32594486	.	G	A	2	3	5	0	0	5	0	0
2	32610908	.	G	A	1	1	2	0	0	2	0	0
2	32637366	.	G	A	12	4	16	0	0	16	0	0
2	32637367	.	T	A	12	3	15	0	1	16	0	0
2	32637585	.	G	T	2	2	4	0	0	4	0	0
2	32637590	.	T	C	2	2	4	0	0	4	0	0
2	32654034	.	A	G	3	1	4	0	2	6	0	0
2	32654040	.	T	C	3	0	3	0	5	8	0	0
2	32654570	.	T	C	24	11	35	0	1	36	0	0
2	32655542	.	T	C	24	1	25	0	11	36	0	0
2	32670836	.	C	T	0	1	1	0	0	1	0	0
2	32676292	.	G	A	3	9	12	0	0	12	0	0
2	32680338	.	C	T	3	7	10	0	0	10	0	0
2	32680356	.	C	T	6	9	15	0	0	15	0	0
2	32680383	.	A	C	5	0	5	0	8	13	0	0
2	32681833	.	T	A	6	5	11	0	0	11	0	0
2	32681845	.	C	A	4	4	8	0	0	8	0	0
2	32682129	.	C	T	11	8	19	0	0	19	0	0
2	32682216	.	C	T	1	1	2	0	0	2	0	0
2	32686412	.	C	T	1	0	1	0	0	1	0	0
2	32686597	.	A	G	4	1	5	0	1	6	0	0
2	32738137	.	C	T	9	5	14	0	1	15	0	0
2	32738342	.	T	G	3	6	9	0	0	9	0	0
2	32750692	.	G	A	0	3	3	0	3	6	0	0
2	32750695	.	A	G	3	3	6	0	0	6	0	0
2	32752300	.	T	C	0	1	1	0	0	1	0	0
2	32752378	.	C	T	4	3	7	0	0	7	0	0
2	32754695	.	C	T	3	2	5	0	0	5	0	0
2	32754749	.	T	G	1	0	1	0	0	1	0	0
2	32814503	.	G	A	1	3	4	0	0	4	0	0
2	32814677	.	G	C	5	5	10	0	0	10	0	0
2	32814695	.	T	C	5	9	14	0	0	14	0	0
2	32815234	.	G	A	3	1	4	0	0	4	0	0
2	32820806	.	G	T	8	5	13	0	0	13	0	0
2	32823461	.	C	T	3	4	7	0	1	8	0	0
2	32824526	.	A	G	9	11	20	0	0	20	0	0
2	32824745	.	C	A	0	3	3	0	5	8	0	0
2	32824778	.	G	A	6	6	12	0	0	12	0	0
2	32824896	.	C	T	10	6	16	0	0	16	0	0
2	32825018	.	C	G	0	6	6	0	8	14	0	0
2	32825480	.	T	G	1	6	7	0	0	7	0	0
2	32826820	.	A	C	1	1	2	0	0	2	0	0
2	32827055	.	T	C	1	3	4	0	0	4	0	0
2	32828704	.	C	T	2	2	4	0	0	4	0	0
2	32833590	.	C	T	3	2	5	0	0	5	0	0
2	33645058	.	A	G	5	6	11	0	0	11	0	0
2	33645157	.	A	G	9	6	15	0	0	15	0	0
2	33645250	.	C	A	7	6	13	0	0	13	0	0
2	33645335	.	G	A	6	2	8	0	0	8	0	0
2	33676209	.	A	G	4	2	6	0	0	6	0	0
2	33676218	.	G	A	3	2	5	0	0	5	0	0
2	33681337	.	A	T	28	18	46	0	6	52	0	0
2	33687090	.	G	A	19	13	32	0	5	37	0	0
2	33687110	.	C	A	23	22	45	0	1	46	0	0
2	33969861	.	C	A	1	3	4	0	0	4	0	0
2	34022992	.	T	A	3	1	4	0	0	4	0	0
2	34024832	.	A	G	3	3	6	0	0	6	0	0
2	34025167	.	G	A	3	7	10	0	0	10	0	0
2	34029353	.	G	A	0	2	2	0	0	2	0	0
2	34071782	.	T	A	2	3	5	0	0	5	0	0
2	34112170	.	C	G	2	0	2	0	1	3	0	0
2	34119467	.	A	C	3	2	5	0	2	7	0	0
2	34119783	.	G	A	0	3	3	0	2	5	0	0
2	34122859	.	A	G	9	7	16	0	1	17	0	0
2	34122985	.	C	T	1	2	3	0	0	3	0	0
2	34126040	.	T	C	5	6	11	0	0	11	0	0
2	34173018	.	T	A	3	5	8	0	0	8	0	0
2	34173335	.	A	C	5	8	13	0	0	13	0	0
2	34173336	.	G	A	5	7	12	0	1	13	0	0
2	34381013	.	T	G	11	12	23	0	0	23	0	0
2	34381032	.	T	C	13	11	24	0	0	24	0	0
2	34381066	.	C	T	13	9	22	0	0	22	0	0
2	34555410	.	A	G	8	6	14	0	0	14	0	0
2	34573032	.	A	T	10	9	19	0	1	20	0	0
2	34573064	.	C	T	7	5	12	0	0	12	0	0
2	34698215	.	C	A	11	6	17	0	2	19	0	0
2	34714557	.	A	G	4	0	4	0	2	6	0	0
2	34725878	.	A	G	3	7	10	0	1	11	0	0
2	34924412	.	A	G	6	25	31	0	1	32	0	0
2	35395976	.	G	T	0	3	3	0	7	10	0	0
2	35396012	.	T	G	5	4	9	0	0	9	0	0
2	35418898	.	A	G	1	3	4	0	0	4	0	0
2	35418909	.	T	C	1	3	4	0	0	4	0	0
2	35420591	.	T	A	0	2	2	0	0	2	0	0
2	35420597	.	T	A	0	2	2	0	0	2	0	0
2	35421306	.	T	C	2	3	5	0	0	5	0	0
2	35421469	.	A	G	5	0	5	0	3	8	0	0
2	35421471	.	A	G	4	3	7	0	1	8	0	0
2	35424633	.	C	T	2	5	7	0	0	7	0	0
2	35457782	.	C	T	1	0	1	0	0	1	0	0
2	35468911	.	T	C	8	11	19	0	0	19	0	0
2	35473715	.	G	A	1	6	7	0	7	14	0	0
2	35474112	.	T	C	5	4	9	0	1	10	0	0
2	35496871	.	A	T	1	3	4	0	0	4	0	0
2	35593848	.	T	C	15	7	22	0	0	22	0	0
2	35594003	.	G	A	10	5	15	0	1	16	0	0
2	35595551	.	A	T	11	8	19	0	1	20	0	0
2	35595561	.	A	G	9	7	16	0	0	16	0	0
2	35596842	.	A	G	12	21	33	0	1	34	0	0
2	35598219	.	A	T	8	9	17	0	0	17	0	0
2	35598257	.	C	G	4	6	10	0	0	10	0	0
2	35601159	.	A	G	7	0	7	0	9	16	0	0
2	35603795	.	A	G	7	10	17	0	1	18	0	0
2	35605429	.	C	T	4	4	8	0	1	9	0	0
2	35607077	.	G	C	3	3	6	0	0	6	0	0
2	35607191	.	C	T	16	13	29	0	0	29	0	0
2	35607206	.	C	T	12	9	21	0	2	23	0	0
2	35607472	.	T	C	3	6	9	0	0	9	0	0
2	35610541	.	T	C	8	15	23	0	3	26	0	0
2	35610598	.	T	C	9	20	29	0	1	30	0	0
2	35611279	.	C	T	13	13	26	0	1	27	0	0
2	35611595	.	T	G	14	13	27	0	1	28	0	0
2	35731019	.	C	G	0	2	2	0	0	2	0	0
2	35731054	.	A	T	1	2	3	0	0	3	0	0
2	35795452	.	A	G	2	0	2	0	1	3	0	0
2	35825679	.	T	C	1	1	2	0	0	2	0	0
2	35837252	.	A	C	5	4	9	0	0	9	0	0
2	35837270	.	A	G	5	4	9	0	0	9	0	0
2	35837510	.	G	A	0	2	2	0	3	5	0	0
2	35839687	.	G	A	0	9	9	0	2	11	0	0
2	35839714	.	G	A	0	5	5	0	6	11	0	0
2	35842020	.	G	A	9	3	12	0	3	15	0	0
2	35843605	.	T	C	7	3	10	0	1	11	0	0
2	35843680	.	A	G	8	9	17	0	0	17	0	0
2	35843812	.	G	A	16	10	26	0	5	31	0	0
2	35844070	.	A	G	8	0	8	0	9	17	0	0
2	35844160	.	A	C	8	9	17	0	1	18	0	0
2	35844433	.	A	G	7	13	20	0	7	27	0	0
2	35846511	.	A	G	2	0	2	0	6	8	0	0
2	35851152	.	C	T	4	6	10	0	0	10	0	0
2	35854264	.	T	C	4	4	8	0	0	8	0	0
2	35855502	.	G	A	0	1	1	0	0	1	0	0
2	35857057	.	C	T	5	5	10	0	0	10	0	0
2	35858435	.	C	T	1	4	5	0	0	5	0	0
2	35861574	.	C	T	2	5	7	0	0	7	0	0
2	35862971	.	T	C	3	3	6	0	1	7	0	0
2	35866246	.	A	T	4	6	10	0	0	10	0	0
2	35866515	.	T	G	5	11	16	0	1	17	0	0
2	35866593	.	G	A	3	0	3	0	0	3	0	0
2	35866787	.	T	C	2	1	3	0	0	3	0	0
2	35868275	.	T	G	0	3	3	0	1	4	0	0
2	35868319	.	A	G	7	10	17	0	0	17	0	0
2	35868568	.	G	A	1	3	4	0	0	4	0	0
2	35868896	.	A	G	5	9	14	0	0	14	0	0
2	35978524	.	C	A	4	1	5	0	0	5	0	0
2	35978542	.	T	A	3	2	5	0	1	6	0	0
2	36028957	.	G	A	10	6	16	0	0	16	0	0
2	36032791	.	C	T	1	0	1	0	0	1	0	0
2	36035697	.	T	C	3	3	6	0	0	6	0	0
2	36040733	.	T	C	21	26	47	0	0	47	0	0
2	36053260	.	T	C	0	2	2	0	0	2	0	0
2	36061201	.	G	A	0	4	4	0	5	9	0	0
2	36062111	.	T	C	2	1	3	0	0	3	0	0
2	36064439	.	G	A	2	1	3	0	1	4	0	0
2	36065871	.	A	G	13	12	25	0	0	25	0	0
2	36065976	.	A	G	12	0	12	0	16	28	0	0
2	36066156	.	C	T	6	3	9	0	1	10	0	0
2	36067656	.	G	A	12	8	20	0	0	20	0	0
2	36067842	.	A	C	9	9	18	0	0	18	0	0
2	36067849	.	A	G	9	0	9	0	7	16	0	0
2	36076419	.	T	G	11	8	19	0	1	20	0	0
2	36077276	.	A	G	16	0	16	0	11	27	0	0
2	36077384	.	A	G	2	6	8	0	2	10	0	0
2	36077542	.	T	C	11	12	23	0	1	24	0	0
2	36077543	.	T	G	11	0	11	0	13	24	0	0
2	36077664	.	C	T	10	10	20	0	0	21	1	0
2	36078370	.	T	G	15	6	21	0	0	21	0	0
2	36154761	.	A	G	2	2	4	0	0	4	0	0
2	36630933	.	A	T	0	1	1	0	0	1	0	0
2	36664493	.	T	G	20	10	30	0	4	34	0	0
2	36664545	.	A	G	17	10	27	0	0	27	0	0
2	36664679	.	C	G	15	13	28	0	2	30	0	0
2	36664799	.	G	T	22	14	36	0	1	37	0	0
2	36668765	.	G	A	11	4	15	0	0	15	0	0
2	36670595	.	A	G	10	5	15	0	1	16	0	0
2	36670778	.	G	A	9	3	12	0	0	12	0	0
2	36670785	.	T	G	8	3	11	0	0	11	0	0
2	36671026	.	C	A	3	6	9	0	0	9	0	0
2	36673643	.	T	A	1	3	4	0	0	4	0	0
2	36673805	.	C	T	9	10	19	0	0	19	0	0
2	36673866	.	G	T	16	7	23	0	1	24	0	0
2	36840789	.	C	T	4	1	5	0	0	5	0	0
2	37826908	.	A	G	2	2	4	1	0	5	0	0
2	39549928	.	A	G	12	4	16	0	0	16	0	0
2	39549932	.	A	G	9	7	16	0	0	16	0	0
2	39551381	.	A	G	9	0	9	0	4	13	0	0
2	39553213	.	A	G	18	8	26	0	0	26	0	0
2	40831927	.	T	C	4	6	10	0	0	10	0	0
2	40902323	.	A	G	5	2	7	0	0	7	0	0
2	44924320	.	A	G	1	4	5	1	0	6	0	0
2	44925081	.	A	G	1	2	3	0	0	3	0	0
2	44943621	.	C	A	10	3	13	0	0	13	0	0
2	44981125	.	A	G	3	2	5	0	0	5	0	0
2	44981142	.	A	G	3	2	5	0	0	5	0	0
2	47602024	.	A	G	5	1	6	0	0	6	0	0
2	50337982	.	A	G	6	2	8	0	0	8	0	0
2	50892572	.	A	G	17	7	24	0	0	24	0	0
2	53065392	.	G	A	1	5	6	0	1	7	0	0
2	53065421	.	A	G	1	7	8	0	1	9	0	0
2	53091285	.	C	T	3	1	4	0	0	4	0	0
2	53673285	.	G	A	0	0	0	0	3	3	0	0
2	53673342	.	G	A	14	13	27	0	0	27	0	0
2	53673354	.	T	G	16	14	30	0	0	30	0	0
2	53673393	.	C	A	15	11	26	0	3	29	0	0
2	53675227	.	C	T	17	4	21	0	2	23	0	0
2	54017861	.	G	T	6	8	14	0	0	14	0	0
2	54017885	.	C	A	0	11	11	0	5	16	0	0
2	54018350	.	C	T	0	5	5	0	8	13	0	0
2	54018407	.	G	A	10	8	18	0	0	18	0	0
2	54018413	.	T	A	8	7	15	0	1	16	0	0
2	54018461	.	G	A	8	7	15	0	0	15	0	0
2	54039142	.	A	G	2	6	8	0	0	8	0	0
2	54039159	.	C	T	0	9	9	0	2	11	0	0
2	54049402	.	T	C	2	6	8	0	0	8	0	0
2	54049453	.	C	A	0	3	3	0	0	3	0	0
2	54054112	.	C	T	3	2	5	0	0	5	0	0
2	54054184	.	T	A	4	3	7	0	1	8	0	0
2	54832405	.	A	G	3	3	6	0	0	6	0	0
2	54832605	.	T	C	3	1	4	0	0	4	0	0
2	54832622	.	A	G	3	2	5	0	0	5	0	0
2	54923826	.	A	C	1	1	2	0	0	2	0	0
2	55489067	.	G	T	0	6	6	0	2	8	0	0
2	55964513	.	T	G	2	3	5	0	0	5	0	0
2	55967847	.	A	G	0	0	0	0	3	3	0	0
2	55967882	.	C	T	0	6	6	0	0	6	0	0
2	55968617	.	T	A	1	5	6	0	1	7	0	0
2	56126778	.	T	A	4	2	6	0	0	6	0	0
2	56159430	.	G	A	0	2	2	0	0	2	0	0
2	56508695	.	T	C	13	18	31	0	2	33	0	0
2	56510628	.	T	C	5	4	9	0	0	9	0	0
2	57240283	.	G	T	3	3	6	0	0	6	0	0
2	57240340	.	A	T	3	4	7	0	0	7	0	0
2	57240345	.	C	T	3	4	7	0	0	7	0	0
2	57240570	.	A	T	5	4	9	0	1	10	0	0
2	57240668	.	G	T	5	2	7	0	0	7	0	0
2	57240708	.	C	T	1	2	3	0	1	4	0	0
2	57240736	.	G	A	3	6	9	0	0	9	0	0
2	57247385	.	C	G	1	4	5	0	0	5	0	0
2	57268868	.	G	A	15	20	35	0	0	35	0	0
2	57268898	.	T	A	17	15	32	0	2	34	0	0
2	57268947	.	C	A	21	26	47	0	0	47	0	0
2	57269123	.	C	A	17	12	29	0	2	31	0	0
2	57284550	.	A	T	1	1	2	0	0	2	0	0
2	57331947	.	C	G	1	0	1	0	0	1	0	0
2	57416930	.	T	C	2	3	5	0	0	5	0	0
2	57416951	.	T	A	2	6	8	0	0	8	0	0
2	57417092	.	A	C	1	4	5	0	0	5	0	0
2	57442945	.	T	C	2	4	6	0	0	6	0	0
2	57609378	.	C	T	0	2	2	0	2	4	0	0
2	57609714	.	T	C	1	3	4	0	0	4	0	0
2	57620034	.	A	C	1	3	4	0	0	4	0	0
2	57624474	.	G	A	1	4	5	0	1	6	0	0
2	57830385	.	T	C	15	0	15	0	12	27	0	0
2	57834927	.	T	C	10	10	20	0	0	20	0	0
2	57834930	.	T	C	10	9	19	0	0	19	0	0
2	57848889	.	G	C	14	9	23	0	0	23	0	0
2	57848936	.	G	C	16	6	22	0	0	22	0	0
2	57867406	.	G	A	1	6	7	0	10	17	0	0
2	57867471	.	C	T	8	4	12	0	0	12	0	0
2	57867473	.	C	T	8	4	12	0	0	12	0	0
2	57867579	.	G	T	9	5	14	0	0	14	0	0
2	57867642	.	A	T	11	3	14	0	5	19	0	0
2	57868151	.	C	T	4	2	6	0	0	6	0	0
2	57868208	.	A	G	6	2	8	0	1	9	0	0
2	57868263	.	A	G	1	2	3	0	5	8	0	0
2	57868433	.	T	C	7	8	15	0	1	16	0	0
2	57868580	.	A	G	13	12	25	0	0	25	0	0
2	57868825	.	A	T	1	2	3	0	0	3	0	0
2	57868827	.	A	C	1	0	1	0	2	3	0	0
2	57869887	.	A	T	2	1	3	0	0	3	0	0
2	57869922	.	A	G	2	1	3	0	0	3	0	0
2	57870049	.	G	A	5	2	7	0	1	8	0	0
2	57870051	.	A	G	5	0	5	0	3	8	0	0
2	57870106	.	T	C	1	4	5	0	1	6	0	0
2	57870155	.	C	T	10	11	21	0	1	22	0	0
2	57870180	.	T	C	16	14	30	0	4	34	0	0
2	57870323	.	G	T	5	4	9	0	0	9	0	0
2	57870343	.	A	G	7	2	9	1	4	14	0	0
2	57870383	.	G	A	7	9	16	1	0	17	0	0
2	57870622	.	G	C	3	2	5	0	0	5	0	0
2	57870659	.	A	T	8	5	13	0	0	13	0	0
2	57870713	.	C	G	11	4	15	0	0	15	0	0
2	57870794	.	G	T	18	7	25	0	2	27	0	0
2	57870795	.	T	A	18	9	27	0	0	27	0	0
2	57870830	.	A	G	8	15	23	0	3	26	0	0
2	57870868	.	G	A	1	14	15	0	10	25	0	0
2	57870887	.	A	G	13	1	14	0	7	21	0	0
2	57870934	.	T	C	10	7	17	0	0	17	0	0
2	57870984	.	A	T	8	7	15	0	3	18	0	0
2	57879582	.	T	C	10	16	26	0	1	27	0	0
2	57879615	.	T	C	3	1	4	0	7	11	0	0
2	57879618	.	T	C	2	8	10	0	0	10	0	0
2	57883433	.	C	T	9	14	23	0	1	24	0	0
2	57883452	.	C	T	11	23	34	0	1	35	0	0
2	57883509	.	C	T	0	24	24	0	10	34	0	0
2	57891444	.	G	A	4	17	21	0	0	21	0	0
2	57891463	.	T	C	0	9	9	0	0	9	0	0
2	57893340	.	A	T	1	2	3	0	0	3	0	0
2	57893494	.	G	A	4	7	11	0	0	11	0	0
2	57893547	.	A	G	1	4	5	0	0	5	0	0
2	57893826	.	A	G	2	3	5	0	0	5	0	0
2	57893933	.	C	G	2	2	4	0	0	4	0	0
2	57894012	.	T	C	4	0	4	0	5	9	0	0
2	57894127	.	T	G	2	6	8	0	0	8	0	0
2	57897379	.	T	C	4	3	7	0	0	7	0	0
2	57897388	.	C	T	4	3	7	0	0	7	0	0
2	57898875	.	G	A	0	0	0	1	0	1	0	0
2	57898902	.	A	G	0	2	2	0	0	2	0	0
2	57899003	.	G	A	1	4	5	0	1	6	0	0
2	57900222	.	T	C	4	2	6	0	1	7	0	0
2	57913799	.	T	C	4	4	8	0	0	8	0	0
2	57913904	.	A	G	3	3	6	0	1	7	0	0
2	57913913	.	G	A	3	5	8	0	0	8	0	0
2	57918008	.	G	A	1	0	1	0	1	2	0	0
2	57918247	.	A	T	1	4	5	0	0	5	0	0
2	57930092	.	A	T	0	1	1	0	0	1	0	0
2	57940770	.	G	A	1	3	4	0	1	5	0	0
2	58009111	.	T	C	1	3	4	0	0	4	0	0
2	58009112	.	G	C	1	3	4	0	0	4	0	0
2	58009416	.	A	G	1	4	5	0	0	5	0	0
2	58012271	.	T	C	5	9	14	0	1	15	0	0
2	58012293	.	T	C	7	6	13	0	0	13	0	0
2	58013135	.	T	A	2	3	5	0	1	6	0	0
2	58013140	.	G	C	4	1	5	0	0	5	0	0
2	58013308	.	A	T	5	14	19	1	0	20	0	0
2	58013336	.	T	C	6	11	17	0	1	18	0	0
2	58013903	.	A	G	3	0	3	0	5	8	0	0
2	58014110	.	G	T	5	9	14	0	0	14	0	0
2	58014156	.	A	T	4	13	17	0	1	18	0	0
2	58014364	.	G	A	4	10	14	0	1	15	0	0
2	58014502	.	G	A	5	7	12	0	0	12	0	0
2	58014537	.	T	C	4	9	13	0	0	13	0	0
2	58077783	.	T	G	1	4	5	0	0	5	0	0
2	58077795	.	C	A	2	5	7	0	1	8	0	0
2	58077869	.	T	C	3	5	8	0	0	8	0	0
2	58078071	.	G	C	3	2	5	0	0	5	0	0
2	58122023	.	A	T	0	3	3	0	0	3	0	0
2	58126268	.	C	T	1	3	4	0	0	4	0	0
2	58129968	.	C	G	2	1	3	0	0	3	0	0
2	58129992	.	A	G	2	1	3	0	0	3	0	0
2	58132558	.	A	C	3	1	4	0	0	4	0	0
2	58137902	.	A	C	0	3	3	0	0	3	0	0
2	58186945	.	T	C	11	4	15	0	0	15	0	0
2	58187038	.	G	A	8	1	9	0	2	11	0	0
2	58187052	.	T	A	11	2	13	0	1	14	0	0
2	58187187	.	T	C	10	0	10	0	7	17	0	0
2	58187621	.	G	T	13	9	22	0	0	22	0	0
2	58187624	.	C	T	0	8	8	0	14	22	0	0
2	58242505	.	C	T	1	2	3	0	0	3	0	0
2	58349088	.	A	G	2	3	5	0	0	5	0	0
2	58349253	.	G	A	1	2	3	0	1	4	0	0
2	58349274	.	T	C	0	1	1	0	0	1	0	0
2	58355559	.	A	C	3	0	3	0	4	7	0	0
2	58358627	.	T	G	1	2	3	0	0	3	0	0
2	58361787	.	C	G	2	5	7	0	0	7	0	0
2	58365973	.	C	T	0	3	3	0	0	3	0	0
2	58411998	.	T	C	6	5	11	0	0	11	0	0
2	58514819	.	T	C	2	2	4	0	0	4	0	0
2	58516445	.	C	A	6	7	13	0	0	13	0	0
2	58541894	.	C	T	9	13	22	0	0	22	0	0
2	58541939	.	G	A	16	16	32	0	0	32	0	0
2	58541981	.	C	G	11	14	25	0	1	26	0	0
2	58546821	.	G	T	10	7	17	0	0	17	0	0
2	58546893	.	G	A	17	9	26	0	0	26	0	0
2	58570715	.	C	G	2	0	2	0	0	2	0	0
2	58581582	.	G	C	2	1	3	0	0	3	0	0
2	58632210	.	T	C	4	0	4	0	7	11	0	0
2	58632475	.	G	A	0	1	1	0	0	1	0	0
2	58739511	.	C	T	3	13	16	0	0	16	0	0
2	58739574	.	C	T	3	0	3	0	0	3	0	0
2	58739714	.	G	A	6	9	15	0	0	15	0	0
2	58785866	.	T	C	0	4	4	0	2	6	0	0
2	58786094	.	G	A	3	4	7	0	0	7	0	0
2	58788301	.	A	G	6	1	7	0	1	8	0	0
2	58789112	.	G	A	5	3	8	0	0	8	0	0
2	58789495	.	C	T	0	2	2	0	0	2	0	0
2	58793396	.	C	T	0	13	13	0	14	27	0	0
2	58793438	.	A	G	12	10	22	0	0	22	0	0
2	58793652	.	A	G	7	6	13	0	2	15	0	0
2	58795599	.	C	T	2	0	2	0	0	2	0	0
2	58841219	.	T	C	4	8	12	0	1	13	0	0
2	58845239	.	C	T	2	2	4	0	1	5	0	0
2	58845396	.	T	C	8	8	16	0	1	17	0	0
2	58848646	.	T	G	35	4	39	0	23	62	0	0
2	58848767	.	C	T	19	18	37	0	0	37	0	0
2	58868439	.	T	C	10	0	10	0	10	20	0	0
2	58868577	.	G	C	11	0	11	0	9	20	0	0
2	58868679	.	G	A	7	10	17	0	1	18	0	0
2	58868841	.	G	A	3	5	8	0	0	8	0	0
2	58869037	.	C	G	0	2	2	0	0	2	0	0
2	58869142	.	G	A	11	7	18	0	0	18	0	0
2	58869319	.	G	T	10	3	13	0	3	16	0	0
2	58879122	.	C	G	16	0	16	0	11	27	0	0
2	58887726	.	A	G	1	2	3	0	0	3	0	0
2	58887817	.	C	T	1	9	10	0	7	17	0	0
2	58888870	.	A	G	4	2	6	0	1	7	0	0
2	58888966	.	C	A	9	8	17	0	1	18	0	0
2	58892142	.	T	C	12	0	12	0	7	20	1	0
2	58892160	.	C	T	6	9	15	0	2	17	0	0
2	58898910	.	A	G	10	4	14	0	0	14	0	0
2	58914807	.	A	T	2	5	7	0	1	8	0	0
2	59004046	.	C	T	0	1	1	0	0	1	0	0
2	59032670	.	T	C	6	7	13	0	0	13	0	0
2	59045797	.	G	A	0	0	0	0	1	1	0	0
2	59050160	.	C	T	1	2	3	0	0	3	0	0
2	59056203	.	C	T	7	20	27	0	1	28	0	0
2	59056212	.	G	A	7	12	19	0	3	22	0	0
2	59057670	.	C	T	14	6	20	0	1	21	0	0
2	59063227	.	T	C	5	2	7	0	1	8	0	0
20	944315	.	T	C	2	3	5	0	1	6	0	0
20	1241522	.	T	C	7	1	8	0	3	11	0	0
20	1241523	.	T	C	8	2	10	0	1	11	0	0
20	1294344	.	G	T	8	0	8	0	5	14	1	0
20	1294356	.	C	A	11	5	16	0	0	16	0	0
20	1295390	.	G	A	6	0	6	0	1	7	0	0
20	1295728	.	T	C	3	3	6	0	0	6	0	0
20	1607617	.	T	G	1	3	4	0	0	4	0	0
20	2066940	.	A	G	3	5	8	0	0	8	0	0
20	2069429	.	T	G	1	3	4	0	0	4	0	0
20	2069445	.	T	A	1	4	5	0	0	5	0	0
20	2156211	.	T	C	1	0	1	0	0	1	0	0
20	2164887	.	C	T	1	1	2	0	0	2	0	0
20	2174815	.	T	A	1	0	1	0	0	1	0	0
20	2179676	.	C	T	0	1	1	0	0	1	0	0
20	2206190	.	T	A	3	4	7	0	0	7	0	0
20	2206192	.	A	T	3	3	6	0	1	7	0	0
20	2206266	.	T	C	1	3	4	0	0	4	0	0
20	2227912	.	C	T	7	1	8	0	0	8	0	0
20	2227929	.	A	T	6	1	7	0	2	9	0	0
20	2227981	.	A	G	2	2	4	0	3	7	0	0
20	2228008	.	G	A	0	4	4	0	1	5	0	0
20	2228217	.	A	T	3	3	6	0	0	6	0	0
20	2240414	.	C	T	2	2	4	0	0	4	0	0
20	2240626	.	C	A	2	4	6	0	1	7	0	0
20	2241179	.	A	C	3	4	7	0	0	7	0	0
20	2241590	.	A	C	3	7	10	0	1	11	0	0
20	2241871	.	C	T	3	5	8	0	0	8	0	0
20	2241905	.	T	C	7	7	14	0	0	14	0	0
20	2290470	.	G	A	7	3	10	0	0	10	0	0
20	2293263	.	C	A	0	9	9	0	4	13	0	0
20	2295306	.	T	C	12	13	25	0	6	31	0	0
20	2295532	.	G	A	20	15	35	0	1	36	0	0
20	2295640	.	A	G	6	10	16	0	0	16	0	0
20	2318995	.	A	G	5	4	9	0	0	9	0	0
20	2319013	.	C	T	0	3	3	0	1	4	0	0
20	2338942	.	C	T	4	8	12	0	0	12	0	0
20	2338954	.	C	A	8	4	12	0	0	12	0	0
20	2359155	.	T	A	9	19	28	0	1	29	0	0
20	2361074	.	G	A	2	4	6	0	2	8	0	0
20	2361194	.	C	T	2	11	13	0	2	15	0	0
20	2361200	.	C	T	0	11	11	0	3	14	0	0
20	2460902	.	G	C	7	5	12	0	1	13	0	0
20	2479225	.	C	T	12	10	22	0	3	25	0	0
20	2499995	.	C	T	16	14	30	0	3	33	0	0
20	2500083	.	G	A	5	3	8	0	0	8	0	0
20	2506085	.	G	T	6	4	10	0	0	10	0	0
20	2513660	.	C	A	1	1	2	0	0	2	0	0
20	2515792	.	A	G	4	2	6	0	0	6	0	0
20	2515807	.	C	T	4	5	9	0	0	9	0	0
20	2519064	.	G	A	2	4	6	0	0	6	0	0
20	2519136	.	G	A	4	6	10	0	1	11	0	0
20	2519854	.	G	A	2	0	2	0	1	3	0	0
20	2524424	.	G	A	1	0	1	0	0	1	0	0
20	2524484	.	C	T	3	8	11	0	0	11	0	0
20	2524499	.	G	A	4	9	13	0	0	13	0	0
20	2544882	.	T	G	2	2	4	0	0	4	0	0
20	2544891	.	T	C	2	2	4	0	1	5	0	0
20	2545635	.	G	A	1	3	4	0	0	4	0	0
20	2548481	.	A	G	1	4	5	0	0	5	0	0
20	2548520	.	C	T	1	5	6	0	0	6	0	0
20	2548523	.	C	T	0	5	5	0	1	6	0	0
20	2551716	.	A	G	4	6	10	0	0	10	0	0
20	2551806	.	T	C	1	3	4	0	0	4	0	0
20	2552049	.	T	A	3	3	6	0	0	6	0	0
20	2554738	.	G	C	2	0	2	0	3	5	0	0
20	2554834	.	A	G	0	1	1	0	0	1	0	0
20	2556537	.	G	A	3	4	7	0	0	7	0	0
20	2700017	.	A	C	3	4	7	0	0	7	0	0
20	2700026	.	G	A	4	3	7	0	0	7	0	0
20	2706294	.	T	C	1	0	1	0	1	2	0	0
20	2716055	.	A	G	6	2	8	0	0	8	0	0
20	2716234	.	A	G	6	9	15	0	1	16	0	0
20	2716614	.	A	G	1	5	6	0	0	6	0	0
20	2718866	.	G	A	11	11	22	0	0	22	0	0
20	2721834	.	G	A	8	7	15	0	1	16	0	0
20	2725716	.	C	T	17	14	31	0	0	31	0	0
20	2737535	.	G	A	6	3	9	0	0	9	0	0
20	2738620	.	C	T	7	3	10	0	0	10	0	0
20	2739065	.	C	T	15	22	37	0	2	39	0	0
20	2739543	.	T	C	12	13	25	0	0	25	0	0
20	2739760	.	A	T	5	5	10	0	1	11	0	0
20	2741340	.	T	C	1	0	1	0	0	1	0	0
20	2742486	.	G	A	3	7	10	0	0	10	0	0
20	2744280	.	A	T	10	8	18	0	0	18	0	0
20	2744455	.	A	T	14	11	25	0	0	25	0	0
20	2744759	.	G	T	15	11	26	0	0	26	0	0
20	2744945	.	C	A	10	8	18	0	1	19	0	0
20	2745303	.	A	T	2	3	5	0	1	6	0	0
20	2882428	.	G	A	4	2	6	0	0	6	0	0
20	2970030	.	C	T	14	13	27	0	0	27	0	0
20	2971562	.	T	A	5	2	7	0	0	7	0	0
20	2971604	.	G	A	4	3	7	0	0	7	0	0
20	2971625	.	A	T	4	5	9	0	1	10	0	0
20	2971760	.	T	A	6	3	9	0	0	9	0	0
20	2971784	.	T	G	3	5	8	0	0	8	0	0
20	2972260	.	A	G	1	0	1	0	31	32	0	0
20	2975121	.	A	C	24	18	42	0	2	44	0	0
20	2975271	.	C	T	21	22	43	0	0	43	0	0
20	2976257	.	A	G	14	9	23	0	0	23	0	0
20	2976727	.	A	G	4	15	19	1	0	20	0	0
20	2976909	.	C	A	17	11	28	1	3	32	0	0
20	2977257	.	C	T	26	16	42	0	1	43	0	0
20	2977417	.	C	A	20	0	20	0	0	20	0	0
20	2977418	.	C	A	20	0	20	0	0	20	0	0
20	2982464	.	C	T	1	2	3	0	0	3	0	0
20	2982755	.	G	T	5	9	14	0	2	16	0	0
20	2982943	.	T	C	4	2	6	0	0	6	0	0
20	2983673	.	G	T	1	0	1	0	0	1	0	0
20	2986822	.	G	C	4	3	7	0	0	7	0	0
20	2986861	.	G	A	3	1	4	0	0	4	0	0
20	2996564	.	A	C	1	0	1	0	3	4	0	0
20	2996621	.	C	T	0	1	1	0	0	1	0	0
20	3017445	.	C	T	6	2	8	0	0	8	0	0
20	3017513	.	C	A	0	10	10	0	12	22	0	0
20	3018319	.	T	C	5	0	5	0	5	10	0	0
20	3020281	.	A	T	0	3	3	0	0	3	0	0
20	3028142	.	A	G	1	0	1	0	0	1	0	0
20	3029617	.	G	C	4	4	8	0	0	8	0	0
20	3029659	.	A	C	2	1	3	0	0	3	0	0
20	3029662	.	A	G	2	1	3	0	0	3	0	0
20	3050877	.	T	C	6	0	6	0	4	10	0	0
20	3086374	.	G	A	3	2	5	0	0	5	0	0
20	3086570	.	G	C	2	3	5	0	0	5	0	0
20	3086730	.	T	A	1	2	3	0	0	3	0	0
20	3086745	.	A	C	2	2	4	0	0	4	0	0
20	3087029	.	T	C	1	0	1	0	4	5	0	0
20	3115207	.	A	T	3	0	3	0	0	3	0	0
20	3115284	.	C	T	6	5	11	0	0	11	0	0
20	3115516	.	C	T	4	3	7	0	0	7	0	0
20	3118148	.	G	A	6	3	9	0	0	9	0	0
20	3118250	.	A	C	2	7	9	0	0	9	0	0
20	3118397	.	A	T	5	11	16	0	0	16	0	0
20	3118502	.	T	G	5	0	5	0	4	9	0	0
20	3118720	.	C	T	3	4	7	0	0	7	0	0
20	3121407	.	T	C	3	3	6	0	0	6	0	0
20	3121462	.	T	A	5	5	10	0	0	10	0	0
20	3121475	.	T	C	5	4	9	0	0	9	0	0
20	3121539	.	T	A	6	5	11	0	1	12	0	0
20	3121623	.	C	T	3	7	10	0	0	10	0	0
20	3121644	.	G	A	0	2	2	0	7	9	0	0
20	3121689	.	T	A	6	2	8	0	0	8	0	0
20	3121778	.	C	T	4	4	8	0	0	8	0	0
20	3121865	.	T	A	4	2	6	0	0	6	0	0
20	3121947	.	G	A	6	8	14	0	0	14	0	0
20	3122094	.	G	A	6	3	9	0	0	9	0	0
20	3122251	.	G	A	8	5	13	0	1	14	0	0
20	3129754	.	C	G	3	0	3	0	0	3	0	0
20	3130347	.	C	A	2	3	5	0	0	5	0	0
20	3130596	.	C	A	4	4	8	0	0	8	0	0
20	3130601	.	C	A	3	4	7	0	0	7	0	0
20	3145796	.	A	G	1	3	4	0	0	4	0	0
20	3145831	.	G	A	1	2	3	0	0	3	0	0
20	3239324	.	C	T	2	7	9	0	6	15	0	0
20	3239470	.	T	G	7	8	15	0	0	15	0	0
20	3242661	.	C	T	3	2	5	0	1	6	0	0
20	3242664	.	T	A	2	4	6	0	1	7	0	0
20	3242887	.	T	A	0	1	1	0	0	1	0	0
20	3242944	.	A	G	1	1	2	0	0	2	0	0
20	3246643	.	A	G	0	1	1	0	1	2	0	0
20	3248766	.	G	A	10	4	14	0	0	14	0	0
20	3249029	.	G	A	14	8	22	0	0	22	0	0
20	3249414	.	A	T	8	12	20	0	1	21	0	0
20	3249796	.	G	T	6	7	13	0	1	14	0	0
20	3249850	.	T	C	1	9	10	0	0	10	0	0
20	3266067	.	A	G	2	5	7	0	1	8	0	0
20	3279928	.	G	A	0	2	2	0	1	3	0	0
20	3283238	.	G	T	1	1	2	0	0	2	0	0
20	3283313	.	C	T	1	0	1	0	0	1	0	0
20	3284553	.	C	T	4	3	7	0	0	7	0	0
20	3286355	.	G	A	1	1	2	0	1	3	0	0
20	3287847	.	A	G	2	0	2	0	0	4	2	0
20	3288058	.	C	T	5	3	8	0	0	8	0	0
20	3290378	.	G	T	10	6	16	0	3	19	0	0
20	3290462	.	G	A	12	6	18	0	0	18	0	0
20	3290744	.	G	A	1	3	4	0	0	4	0	0
20	3292039	.	C	T	0	1	1	0	0	1	0	0
20	3294838	.	G	T	0	1	1	0	2	3	0	0
20	3295009	.	T	C	5	4	9	0	0	9	0	0
20	3298096	.	T	C	5	3	8	0	0	8	0	0
20	3298321	.	T	C	2	0	2	0	0	2	0	0
20	3303484	.	C	T	5	4	9	0	0	9	0	0
20	3307626	.	G	A	3	2	5	0	0	5	0	0
20	3308070	.	C	T	5	5	10	0	0	10	0	0
20	3308121	.	G	A	2	2	4	0	0	4	0	0
20	3308264	.	T	A	5	5	10	0	0	10	0	0
20	3308794	.	T	C	4	2	6	0	0	6	0	0
20	3309893	.	C	T	5	9	14	0	0	14	0	0
20	3309933	.	C	A	0	6	6	0	4	10	0	0
20	3313205	.	G	T	2	5	7	0	0	7	0	0
20	3313206	.	C	T	2	4	6	0	1	7	0	0
20	3313282	.	C	T	5	6	11	0	1	12	0	0
20	3316578	.	C	A	1	2	3	0	0	3	0	0
20	3316715	.	G	A	3	2	5	0	0	5	0	0
20	3316725	.	G	A	2	2	4	0	1	5	0	0
20	3316852	.	C	A	0	2	2	0	2	4	0	0
20	3317024	.	A	G	2	4	6	0	0	6	0	0
20	3317063	.	G	C	3	5	8	0	0	8	0	0
20	3339288	.	A	T	2	2	4	0	0	4	0	0
20	3339521	.	G	A	7	2	9	0	0	9	0	0
20	3341134	.	C	A	0	1	1	0	0	1	0	0
20	3343829	.	A	C	1	0	1	0	0	1	0	0
20	3343934	.	C	T	6	4	10	0	1	11	0	0
20	3344016	.	G	C	3	5	8	0	0	8	0	0
20	3344084	.	G	A	1	4	5	0	0	5	0	0
20	3344324	.	C	T	3	2	5	0	0	5	0	0
20	3344696	.	G	T	0	4	4	0	4	8	0	0
20	3344735	.	A	C	6	2	8	0	0	8	0	0
20	3344975	.	T	C	7	9	16	0	1	17	0	0
20	3345151	.	G	A	1	5	6	0	5	11	0	0
20	3345197	.	G	T	5	2	7	0	1	8	0	0
20	3345198	.	T	C	3	5	8	0	0	8	0	0
20	3346490	.	A	T	13	7	20	0	2	22	0	0
20	3346497	.	C	A	0	10	10	0	11	21	0	0
20	3346599	.	G	A	11	18	29	0	0	29	0	0
20	3346629	.	C	T	22	5	27	0	1	28	0	0
20	3346710	.	C	T	13	14	27	0	0	27	0	0
20	3346865	.	C	G	0	7	7	0	6	13	0	0
20	3349049	.	A	G	13	7	20	0	0	20	0	0
20	3349067	.	T	A	9	5	14	0	1	15	0	0
20	3351627	.	A	T	10	6	16	0	0	16	0	0
20	3351661	.	A	C	3	6	9	0	0	9	0	0
20	3353337	.	C	T	5	13	18	0	1	19	0	0
20	3355695	.	A	T	5	2	7	0	0	7	0	0
20	3357024	.	C	T	8	2	10	0	0	10	0	0
20	3359346	.	C	T	11	4	15	0	0	15	0	0
20	3361480	.	A	T	9	3	12	0	0	12	0	0
20	3365747	.	C	T	0	4	4	0	0	4	0	0
20	3365752	.	C	A	0	4	4	0	0	4	0	0
20	3369377	.	G	A	3	0	3	0	0	3	0	0
20	3369392	.	A	G	0	1	1	0	0	1	0	0
20	3372441	.	G	A	1	1	2	0	0	2	0	0
20	3372643	.	T	G	0	0	0	0	1	1	0	0
20	3375982	.	C	T	3	4	7	0	0	7	0	0
20	3376003	.	T	G	4	3	7	0	0	7	0	0
20	3376295	.	G	C	3	6	9	0	0	9	0	0
20	3376379	.	C	T	3	5	8	0	1	9	0	0
20	3377369	.	A	G	4	2	6	0	1	7	0	0
20	3378027	.	A	G	2	4	6	0	0	6	0	0
20	3378053	.	C	T	0	5	5	0	2	7	0	0
20	3379641	.	C	T	2	1	3	0	3	6	0	0
20	3379653	.	A	G	4	3	7	0	0	7	0	0
20	3380196	.	T	G	2	2	4	0	0	4	0	0
20	3916456	.	T	A	7	7	14	0	0	14	0	0
20	3916464	.	C	T	8	8	16	0	0	16	0	0
20	3916621	.	T	G	7	8	15	0	2	17	0	0
20	3920746	.	T	G	7	6	13	0	0	13	0	0
20	3920873	.	T	A	7	13	20	0	1	21	0	0
20	3920875	.	G	A	7	12	19	0	2	21	0	0
20	3920977	.	G	A	0	2	2	0	15	17	0	0
20	3921127	.	A	T	6	10	16	0	1	17	0	0
20	3921184	.	G	A	9	7	16	0	1	17	0	0
20	3921202	.	T	C	5	5	10	0	1	11	0	0
20	3923735	.	C	G	5	9	14	0	0	14	0	0
20	3923983	.	G	A	0	10	10	0	9	19	0	0
20	3924349	.	G	A	9	11	20	0	1	21	0	0
20	3924430	.	G	A	0	3	3	0	9	12	0	0
20	3924528	.	C	A	6	8	14	0	0	14	0	0
20	3924824	.	A	C	5	4	9	0	0	9	0	0
20	3924943	.	T	G	7	0	7	0	6	13	0	0
20	3925146	.	A	T	8	7	15	0	0	15	0	0
20	3925447	.	G	C	9	22	31	0	0	32	1	0
20	3925465	.	A	G	11	0	11	1	20	32	0	0
20	3925537	.	T	C	4	11	15	0	0	15	0	0
20	3925604	.	A	G	15	6	21	0	1	22	0	0
20	3925934	.	C	T	3	2	5	1	0	6	0	0
20	3925942	.	A	G	2	5	7	0	0	7	0	0
20	3926337	.	C	T	4	7	11	2	0	13	0	0
20	3926721	.	T	C	7	5	12	0	0	12	0	0
20	3926736	.	T	A	8	7	15	0	0	15	0	0
20	3926907	.	T	G	20	15	35	0	1	36	0	0
20	3926928	.	T	A	21	14	35	0	2	37	0	0
20	3926951	.	A	G	26	15	41	0	0	41	0	0
20	3927267	.	C	A	17	12	29	0	2	31	0	0
20	3927326	.	A	G	14	11	25	0	0	25	0	0
20	3927446	.	C	G	7	15	22	0	3	25	0	0
20	3927601	.	A	G	3	2	5	0	0	5	0	0
20	3940133	.	C	T	1	2	3	0	0	3	0	0
20	3947006	.	T	G	1	2	3	0	0	3	0	0
20	3947058	.	C	A	2	4	6	0	0	6	0	0
20	3947100	.	C	T	3	1	4	0	0	4	0	0
20	3953593	.	T	C	9	5	14	0	0	14	0	0
20	3954813	.	G	C	4	3	7	0	0	7	0	0
20	3954870	.	C	T	0	3	3	0	1	4	0	0
20	3958130	.	G	A	1	1	2	0	0	2	0	0
20	3971246	.	G	C	0	1	1	0	0	1	0	0
20	3994351	.	T	G	0	1	1	0	0	1	0	0
20	4000366	.	C	T	3	1	4	0	0	4	0	0
20	4009409	.	C	G	5	2	7	0	0	7	0	0
20	4010217	.	C	T	1	6	7	0	0	7	0	0
20	4010267	.	A	T	2	8	10	0	2	12	0	0
20	4010462	.	C	T	3	6	9	0	0	9	0	0
20	4010573	.	A	G	1	3	4	0	0	4	0	0
20	4011135	.	G	A	1	2	3	0	0	3	0	0
20	4011545	.	G	T	2	3	5	0	0	5	0	0
20	4035858	.	G	C	6	3	9	0	0	9	0	0
20	4036272	.	G	T	1	2	3	0	0	3	0	0
20	4036462	.	A	G	1	4	5	0	0	5	0	0
20	4036795	.	T	C	3	3	6	0	0	6	0	0
20	4037016	.	T	C	1	3	4	0	0	4	0	0
20	4037154	.	T	C	1	2	3	0	0	3	0	0
20	4037349	.	T	C	3	2	5	0	0	5	0	0
20	4037409	.	T	A	6	5	11	0	0	11	0	0
20	4037461	.	G	T	5	6	11	0	0	11	0	0
20	4037500	.	C	T	4	3	7	0	0	7	0	0
20	4037708	.	C	T	0	5	5	0	5	10	0	0
20	4037823	.	G	C	2	0	2	0	4	6	0	0
20	4037824	.	T	G	2	4	6	0	0	6	0	0
20	4037942	.	C	T	4	2	6	0	0	6	0	0
20	4038131	.	T	C	2	0	2	0	3	5	0	0
20	4043508	.	C	G	2	5	7	0	0	7	0	0
20	4051818	.	C	T	7	12	19	0	0	19	0	0
20	4052490	.	G	A	7	2	9	0	0	9	0	0
20	4052502	.	G	T	0	4	4	0	7	11	0	0
20	4052854	.	G	C	2	3	5	0	1	6	0	0
20	4053012	.	G	A	0	12	12	0	3	15	0	0
20	4091851	.	G	A	0	1	1	0	0	1	0	0
20	4124207	.	A	T	1	1	2	0	0	2	0	0
20	4124294	.	T	C	1	2	3	0	0	3	0	0
20	4153436	.	A	G	5	5	10	0	0	10	0	0
20	4157066	.	A	C	4	3	7	0	0	7	0	0
20	4170812	.	T	C	0	1	1	0	0	1	0	0
20	4180743	.	C	T	0	3	3	0	0	3	0	0
20	4250176	.	G	A	0	2	2	0	0	2	0	0
20	4250187	.	C	T	0	2	2	0	0	2	0	0
20	4250235	.	A	T	1	2	3	0	0	3	0	0
20	4453024	.	T	C	4	9	13	0	0	13	0	0
20	4454196	.	C	A	4	3	7	0	1	8	0	0
20	4712880	.	G	A	5	4	9	0	0	9	0	0
20	4712979	.	A	T	9	18	27	0	2	29	0	0
20	4713027	.	T	A	6	13	19	0	0	19	0	0
20	4713033	.	C	T	6	13	19	0	0	19	0	0
20	4713169	.	G	T	12	19	31	0	2	33	0	0
20	4713654	.	G	A	14	9	23	0	0	23	0	0
20	4713716	.	G	A	14	15	29	0	2	31	0	0
20	4713956	.	C	T	10	16	26	0	2	28	0	0
20	4716436	.	A	G	0	5	5	0	0	5	0	0
20	4717647	.	C	T	13	4	17	0	2	19	0	0
20	4726806	.	G	T	2	5	7	0	0	7	0	0
20	4726955	.	A	T	6	9	15	0	2	17	0	0
20	4726973	.	A	G	6	12	18	0	1	19	0	0
20	4728418	.	T	G	2	2	4	0	0	4	0	0
20	4728437	.	A	G	2	2	4	0	0	4	0	0
20	4728808	.	C	T	13	13	26	0	0	26	0	0
20	4734412	.	C	T	0	2	2	0	0	2	0	0
20	4738004	.	T	C	13	5	18	0	1	19	0	0
20	4747480	.	G	T	2	3	5	0	0	5	0	0
20	4756804	.	C	A	1	1	2	0	0	2	0	0
20	4761643	.	A	G	2	0	2	0	0	2	0	0
20	4761674	.	A	G	2	0	2	0	0	2	0	0
20	4761680	.	A	G	1	0	1	0	0	1	0	0
20	4766579	.	T	A	2	2	4	0	2	6	0	0
20	4769923	.	G	A	1	2	3	0	1	4	0	0
20	4769924	.	T	G	0	2	2	0	2	4	0	0
20	4769969	.	T	A	2	2	4	0	0	4	0	0
20	4770299	.	G	A	1	2	3	0	0	3	0	0
20	4813847	.	C	T	2	2	4	0	0	4	0	0
20	4813881	.	T	A	2	3	5	0	1	6	0	0
20	4813976	.	C	A	3	2	5	0	1	6	0	0
20	4813998	.	C	T	3	2	5	0	0	5	0	0
20	4828019	.	C	T	4	2	6	0	0	6	0	0
20	4828170	.	T	A	4	5	9	0	0	9	0	0
20	4887996	.	G	T	4	3	7	0	0	7	0	0
20	4888004	.	A	G	4	3	7	0	0	7	0	0
20	4888037	.	T	C	2	0	2	0	0	2	0	0
20	4895176	.	A	C	1	0	1	0	1	2	0	0
20	4895955	.	C	T	13	11	24	0	0	24	0	0
20	4896240	.	A	C	2	8	10	0	2	12	0	0
20	4898126	.	A	G	0	4	4	0	1	5	0	0
20	4898515	.	C	T	12	18	30	0	0	30	0	0
20	4898575	.	A	T	13	12	25	0	1	26	0	0
20	4898631	.	A	T	15	4	19	0	1	20	0	0
20	4898855	.	C	T	0	14	14	0	11	25	0	0
20	4899342	.	T	G	18	9	27	0	1	28	0	0
20	4899479	.	A	G	6	14	20	0	1	21	0	0
20	4899642	.	T	A	3	1	4	0	1	5	0	0
20	4899643	.	G	A	3	2	5	0	0	5	0	0
20	4899716	.	G	T	5	3	8	0	1	9	0	0
20	4899935	.	A	T	17	9	26	0	1	27	0	0
20	4899969	.	T	G	12	9	21	0	1	22	0	0
20	4900495	.	C	T	1	8	9	0	11	20	0	0
20	4900564	.	T	C	6	6	12	0	0	12	0	0
20	4900609	.	T	C	5	0	5	0	6	11	0	0
20	4900697	.	T	C	8	5	13	0	2	15	0	0
20	4900909	.	T	C	2	2	4	0	3	7	0	0
20	4900921	.	A	G	2	5	7	0	3	10	0	0
20	4901013	.	C	T	10	6	16	0	0	16	0	0
20	4901545	.	T	G	3	4	7	0	0	7	0	0
20	4902868	.	T	G	2	0	2	0	0	2	0	0
20	4902871	.	C	T	0	0	0	0	2	2	0	0
20	4902954	.	A	G	8	6	14	0	0	14	0	0
20	4903334	.	G	C	10	5	15	0	0	15	0	0
20	4903456	.	A	G	9	4	13	0	0	13	0	0
20	4911237	.	C	T	1	3	4	0	0	4	0	0
20	4911252	.	T	C	1	4	5	0	0	5	0	0
20	4921034	.	G	A	4	5	9	0	0	9	0	0
20	4933977	.	A	G	1	4	5	0	0	5	0	0
20	4934016	.	T	C	2	1	3	0	6	9	0	0
20	4938844	.	A	G	1	3	4	0	1	5	0	0
20	5052112	.	C	T	4	3	7	0	0	7	0	0
20	5065444	.	A	T	5	6	11	0	0	11	0	0
20	5065776	.	T	A	1	4	5	0	1	6	0	0
20	5066065	.	A	T	0	1	1	0	0	1	0	0
20	5067424	.	A	T	1	1	2	0	0	2	0	0
20	5069212	.	C	G	2	0	2	0	7	9	0	0
20	5069389	.	G	A	12	4	16	0	1	18	1	0
20	5074193	.	G	A	0	2	2	0	0	2	0	0
20	5075196	.	C	T	2	0	2	0	0	2	0	0
20	5090938	.	G	A	0	3	3	0	9	12	0	0
20	5093872	.	A	T	2	4	6	0	0	6	0	0
20	5093882	.	G	A	3	4	7	0	0	7	0	0
20	5093959	.	A	G	2	2	4	0	0	4	0	0
20	5094205	.	A	C	5	5	10	0	0	10	0	0
20	5158691	.	C	T	0	2	2	0	0	2	0	0
20	5158705	.	A	G	0	3	3	0	0	3	0	0
20	5158890	.	C	G	1	4	5	0	0	5	0	0
20	5159001	.	A	C	3	3	6	0	0	6	0	0
20	5163286	.	C	T	1	3	4	0	0	4	0	0
20	5228516	.	G	A	2	3	5	0	1	6	0	0
20	5330859	.	C	G	6	4	10	0	1	11	0	0
20	5330875	.	A	G	8	7	15	0	0	15	0	0
20	5330990	.	T	A	4	3	7	0	0	7	0	0
20	5331095	.	A	G	3	2	5	0	0	5	0	0
20	5331112	.	G	C	3	2	5	0	0	5	0	0
20	5331362	.	A	C	2	0	2	0	3	5	0	0
20	5331668	.	T	C	1	2	3	0	1	4	0	0
20	5331685	.	A	C	2	2	4	0	0	4	0	0
20	5332145	.	C	G	7	7	14	1	0	15	0	0
20	5332551	.	G	A	0	3	3	0	0	3	0	0
20	5332700	.	G	C	1	5	6	0	0	6	0	0
20	5332728	.	G	A	3	2	5	0	0	5	0	0
20	5332742	.	A	C	3	1	4	0	0	4	0	0
20	5332901	.	T	C	5	0	5	0	3	8	0	0
20	5333317	.	A	G	3	5	8	0	0	8	0	0
20	5333405	.	T	G	1	4	5	0	0	5	0	0
20	5337006	.	G	A	1	4	5	0	0	5	0	0
20	5348081	.	G	A	2	2	4	0	0	4	0	0
20	5354306	.	T	A	2	2	4	0	0	4	0	0
20	5358482	.	A	G	1	1	2	0	0	2	0	0
20	5361156	.	A	G	0	2	2	0	0	2	0	0
20	5369097	.	A	G	1	3	4	0	0	4	0	0
20	5369099	.	T	C	1	3	4	0	0	4	0	0
20	5390784	.	A	T	4	0	4	0	1	5	0	0
20	5391138	.	G	T	4	6	10	0	1	12	1	0
20	5394584	.	G	A	4	5	9	0	0	9	0	0
20	5563732	.	T	C	1	3	4	0	0	4	0	0
20	5563744	.	A	T	1	3	4	0	0	4	0	0
20	5563798	.	G	A	1	3	4	0	0	4	0	0
20	5563813	.	C	T	0	3	3	0	1	4	0	0
20	5564002	.	T	C	2	5	7	0	0	7	0	0
20	5564233	.	T	C	4	2	6	0	1	7	0	0
20	5564292	.	A	G	4	0	4	0	5	9	0	0
20	5679786	.	T	C	8	3	11	0	1	12	0	0
20	5696971	.	C	A	6	4	10	0	0	10	0	0
20	5700002	.	C	T	1	2	3	0	1	4	0	0
20	5742118	.	C	T	5	3	8	0	1	9	0	0
20	5742169	.	T	C	4	3	7	0	0	7	0	0
20	5744339	.	T	C	2	2	4	0	0	4	0	0
20	5921278	.	T	C	11	9	20	0	1	21	0	0
20	6308648	.	G	A	6	6	12	0	0	12	0	0
20	6540485	.	C	A	1	2	3	0	1	4	0	0
20	6540486	.	G	A	0	3	3	0	1	4	0	0
20	6666099	.	T	G	2	3	5	0	0	5	0	0
20	6666224	.	G	C	8	5	13	0	0	13	0	0
20	6666528	.	A	C	1	2	3	0	0	3	0	0
20	6773973	.	G	C	4	2	6	0	0	6	0	0
20	6774066	.	G	T	1	2	3	0	0	3	0	0
20	6791662	.	A	G	6	0	6	0	2	8	0	0
20	6802354	.	T	G	4	4	8	0	0	8	0	0
20	6802879	.	A	G	7	6	13	0	0	13	0	0
20	6803497	.	C	T	1	4	5	0	0	5	0	0
20	6803734	.	A	T	2	4	6	0	0	6	0	0
20	6803771	.	A	T	3	2	5	0	0	5	0	0
20	6809612	.	C	T	4	3	7	0	0	7	0	0
20	6810046	.	T	C	2	1	3	0	0	3	0	0
20	6894902	.	A	G	2	5	7	0	0	7	0	0
20	6894999	.	A	G	4	2	6	0	0	6	0	0
20	6898118	.	A	G	3	8	11	0	0	11	0	0
20	6918437	.	A	G	3	4	7	0	0	7	0	0
20	6944977	.	G	A	1	1	2	0	0	2	0	0
20	6948366	.	A	G	1	3	4	0	0	4	0	0
20	6967149	.	A	G	1	0	1	0	0	1	0	0
20	6988975	.	A	G	2	2	4	0	0	4	0	0
20	7449788	.	G	A	0	1	1	0	0	1	0	0
20	7464337	.	G	A	1	1	2	0	0	2	0	0
20	7469280	.	G	A	2	2	4	0	0	4	0	0
20	7469367	.	C	T	4	3	7	0	0	7	0	0
20	7582925	.	G	A	1	3	4	0	2	6	0	0
20	7583021	.	T	C	2	2	4	0	3	7	0	0
20	7588957	.	A	G	2	0	2	0	4	6	0	0
20	7965965	.	G	A	2	5	7	0	0	7	0	0
20	7966006	.	A	T	3	3	6	0	0	6	0	0
20	7966049	.	T	G	3	4	7	0	0	7	0	0
20	7966090	.	T	G	2	6	8	0	0	8	0	0
20	7966127	.	G	A	2	5	7	0	0	7	0	0
20	7966135	.	A	C	2	5	7	0	0	7	0	0
20	7966227	.	A	G	1	6	7	0	0	7	0	0
20	7966402	.	G	A	1	4	5	0	0	5	0	0
20	7966419	.	G	C	2	4	6	0	0	6	0	0
20	7966555	.	C	G	3	3	6	0	0	6	0	0
20	7966938	.	G	A	1	1	2	0	0	2	0	0
20	7967128	.	C	T	0	4	4	0	4	8	0	0
20	7967305	.	A	G	0	3	3	0	1	4	0	0
20	8040660	.	T	A	1	0	1	0	0	1	0	0
20	8053250	.	A	G	0	0	0	0	2	2	0	0
20	8055224	.	C	G	0	1	1	0	0	1	0	0
20	8055612	.	T	C	1	2	3	0	0	3	0	0
20	8055681	.	G	C	1	2	3	0	0	3	0	0
20	8060106	.	G	A	3	3	6	0	0	6	0	0
20	8060214	.	A	C	1	4	5	0	0	5	0	0
20	8067423	.	G	A	1	1	2	0	0	2	0	0
20	8067684	.	C	A	2	2	4	0	0	4	0	0
20	8154169	.	A	G	6	5	11	0	0	11	0	0
20	8154562	.	A	G	8	3	11	0	0	11	0	0
20	8163955	.	C	T	3	3	6	0	1	7	0	0
20	9081204	.	A	C	1	0	1	0	2	3	0	0
20	9097597	.	T	A	4	6	10	0	0	10	0	0
20	9097639	.	A	G	7	5	12	0	1	13	0	0
20	9097666	.	T	C	3	4	7	0	0	7	0	0
20	9105204	.	C	G	5	4	9	0	1	10	0	0
20	9111228	.	A	G	2	2	4	0	0	4	0	0
20	9113147	.	G	T	0	1	1	0	0	1	0	0
20	9113325	.	G	C	1	0	1	0	0	1	0	0
20	9115200	.	C	A	4	3	7	0	0	7	0	0
20	9115236	.	G	T	3	3	6	0	0	6	0	0
20	9115241	.	G	A	3	3	6	0	0	6	0	0
20	9124503	.	A	T	4	4	8	0	0	8	0	0
20	9124759	.	C	T	2	2	4	0	1	5	0	0
20	9124996	.	A	G	2	0	2	0	4	6	0	0
20	9133095	.	G	C	1	1	2	0	0	2	0	0
20	9148121	.	G	C	6	5	11	0	1	12	0	0
20	9172370	.	C	T	4	4	8	0	0	8	0	0
20	9174014	.	T	C	16	15	31	0	0	31	0	0
20	9183159	.	T	G	2	2	4	0	0	4	0	0
20	9184708	.	C	T	10	5	15	0	0	15	0	0
20	9185389	.	G	T	2	0	2	0	0	2	0	0
20	9185479	.	G	T	9	5	14	0	0	14	0	0
20	9185515	.	T	C	3	1	4	0	0	4	0	0
20	9186200	.	A	G	4	4	8	0	0	8	0	0
20	9186281	.	T	C	9	0	9	0	9	18	0	0
20	9190238	.	A	T	4	11	15	0	2	17	0	0
20	9190468	.	T	G	4	4	8	0	0	8	0	0
20	9190510	.	C	T	1	1	2	0	0	2	0	0
20	9190637	.	G	T	0	2	2	0	0	2	0	0
20	9190712	.	A	G	5	8	13	0	1	14	0	0
20	9190723	.	A	T	5	5	10	0	3	13	0	0
20	9190767	.	T	C	5	10	15	0	1	16	0	0
20	9190768	.	T	C	5	10	15	0	1	16	0	0
20	9190991	.	A	G	8	11	19	0	0	19	0	0
20	9191203	.	G	T	8	11	19	0	0	19	0	0
20	9191255	.	T	C	3	0	3	0	13	16	0	0
20	9191267	.	T	A	2	10	12	0	2	14	0	0
20	9191353	.	T	G	3	4	7	0	0	7	0	0
20	9191461	.	C	T	7	14	21	0	1	22	0	0
20	9191729	.	C	T	6	3	9	0	0	9	0	0
20	9192375	.	T	A	6	7	13	0	0	13	0	0
20	9193359	.	C	T	5	3	8	0	1	9	0	0
20	9193818	.	T	A	2	8	10	0	0	10	0	0
20	9199482	.	C	T	5	6	11	0	1	12	0	0
20	9199598	.	C	T	5	8	13	0	2	15	0	0
20	9211591	.	T	C	0	2	2	0	0	2	0	0
20	9211600	.	G	T	0	2	2	0	0	2	0	0
20	9216564	.	A	G	0	1	1	0	0	1	0	0
20	9242422	.	G	C	5	6	11	0	0	11	0	0
20	9242476	.	T	C	6	5	11	0	0	11	0	0
20	9246461	.	C	A	0	1	1	0	0	1	0	0
20	9248482	.	T	C	1	0	1	0	2	3	0	0
20	9248635	.	C	T	0	2	2	0	4	6	0	0
20	9249934	.	C	T	0	2	2	0	5	7	0	0
20	9291019	.	C	G	1	3	4	0	0	4	0	0
20	9291022	.	A	G	1	0	1	0	3	4	0	0
20	9355967	.	C	T	6	9	15	0	0	15	0	0
20	9420974	.	A	T	12	14	26	1	1	28	0	0
20	9420976	.	C	T	13	14	27	1	0	28	0	0
20	10099521	.	T	G	2	5	7	0	0	7	0	0
20	10099602	.	C	A	2	5	7	0	0	7	0	0
20	10099603	.	C	A	2	5	7	0	0	7	0	0
20	10099640	.	G	A	8	3	11	0	2	13	0	0
20	10099816	.	C	T	6	8	14	0	2	16	0	0
20	10099932	.	C	A	7	9	16	0	0	16	0	0
20	10102593	.	G	A	5	3	8	0	1	9	0	0
20	10118393	.	A	T	5	3	8	0	1	9	0	0
20	10118691	.	T	C	3	4	7	0	0	7	0	0
20	10173919	.	A	G	4	0	4	0	3	7	0	0
20	10173991	.	C	G	2	5	7	0	0	7	0	0
20	10174063	.	C	G	2	2	4	0	0	4	0	0
20	10210313	.	C	T	1	3	4	0	0	4	0	0
20	10210328	.	A	G	3	0	3	0	3	6	0	0
20	10210358	.	C	T	3	4	7	0	0	7	0	0
20	10215552	.	G	A	0	4	4	0	2	6	0	0
20	10218890	.	C	T	4	3	7	0	0	7	0	0
20	10218937	.	C	A	7	5	12	0	0	12	0	0
20	10219396	.	A	T	2	3	5	0	0	5	0	0
20	10219447	.	G	A	3	5	8	0	0	8	0	0
20	10219467	.	C	A	4	3	7	0	0	7	0	0
20	10219504	.	G	A	0	3	3	0	3	6	0	0
20	10219537	.	C	T	4	2	6	0	0	6	0	0
20	10219985	.	A	T	1	3	4	0	0	4	0	0
20	10219988	.	A	G	1	4	5	0	0	5	0	0
20	10220188	.	A	C	0	3	3	0	0	3	0	0
20	10220213	.	G	A	2	3	5	0	0	5	0	0
20	10220261	.	G	T	7	4	11	0	0	11	0	0
20	10353220	.	G	A	4	5	9	0	1	10	0	0
20	10353222	.	G	A	4	5	9	0	1	10	0	0
20	10353318	.	G	A	3	2	5	0	0	5	0	0
20	10353335	.	T	C	4	2	6	0	0	6	0	0
20	10353528	.	G	A	6	5	11	0	0	11	0	0
20	10353654	.	T	C	3	0	3	0	5	8	0	0
20	10353912	.	G	C	5	9	14	0	0	14	0	0
20	10354329	.	A	G	1	2	3	0	0	3	0	0
20	10422619	.	A	C	4	3	7	0	0	7	0	0
20	10489564	.	A	G	3	5	8	0	0	8	0	0
20	11098255	.	G	A	12	4	16	0	0	16	0	0
20	11098301	.	T	C	3	5	8	0	0	8	0	0
20	11098547	.	T	A	4	6	10	0	1	11	0	0
20	11098710	.	C	A	8	6	14	0	0	14	0	0
20	11098859	.	G	A	1	4	5	0	0	5	0	0
20	11099013	.	G	A	6	5	11	0	0	11	0	0
20	11099064	.	C	T	7	4	11	0	2	13	0	0
20	11099223	.	C	T	1	7	8	0	4	12	0	0
20	11099304	.	A	G	3	5	8	0	2	10	0	0
20	11099345	.	T	A	4	2	6	0	0	6	0	0
20	11102169	.	G	A	2	2	4	0	0	4	0	0
20	11102328	.	C	T	0	4	4	0	2	6	0	0
20	11102805	.	G	A	4	4	8	0	0	8	0	0
20	11103241	.	C	A	3	4	7	0	1	8	0	0
20	11103244	.	T	A	2	1	3	0	2	5	0	0
20	11104920	.	C	G	2	2	4	0	1	5	0	0
20	11104994	.	G	A	1	2	3	0	0	3	0	0
20	11105676	.	A	G	1	3	4	0	0	4	0	0
20	13567503	.	T	C	7	0	7	0	8	15	0	0
20	15152036	.	T	A	1	3	4	0	0	4	0	0
20	15934592	.	T	C	2	1	3	0	3	6	0	0
20	18249646	.	T	C	15	13	28	0	0	28	0	0
20	18255673	.	G	T	7	4	11	0	1	12	0	0
20	18255748	.	A	G	9	8	17	0	0	17	0	0
20	18255755	.	A	G	9	7	16	0	0	16	0	0
20	18255929	.	A	G	15	0	15	0	11	26	0	0
20	18255931	.	A	T	16	10	26	0	0	26	0	0
20	18256170	.	G	A	5	4	9	0	0	9	0	0
20	18312860	.	C	T	6	13	19	0	1	20	0	0
20	18354627	.	C	T	6	2	8	0	0	8	0	0
20	18363238	.	T	C	5	1	6	0	2	8	0	0
20	18373014	.	T	G	3	2	5	0	0	5	0	0
20	18376800	.	C	T	1	4	5	0	0	5	0	0
20	18392845	.	C	T	18	19	37	0	0	37	0	0
20	18393128	.	G	A	5	10	15	0	0	15	0	0
20	18393132	.	A	C	5	9	14	0	0	14	0	0
20	18393249	.	T	C	12	15	27	0	0	27	0	0
20	18393359	.	A	T	8	13	21	0	0	21	0	0
20	18393376	.	C	T	9	13	22	0	1	23	0	0
20	18396134	.	A	G	2	5	7	0	0	7	0	0
20	18413987	.	T	C	8	0	8	0	11	19	0	0
20	18417768	.	G	A	9	10	19	0	1	20	0	0
20	18417777	.	T	C	8	10	18	0	1	19	0	0
20	18431770	.	T	C	0	0	0	0	2	2	0	0
20	18432732	.	C	T	4	5	9	0	0	9	0	0
20	18443489	.	T	C	5	5	10	0	1	11	0	0
20	18443543	.	C	G	0	2	2	0	2	4	0	0
20	18443554	.	C	T	0	1	1	0	2	3	0	0
20	18456785	.	C	T	2	0	2	0	0	2	0	0
20	18456791	.	T	C	2	0	2	0	0	2	0	0
20	18459961	.	G	A	4	0	4	0	0	4	0	0
20	18459976	.	C	T	4	0	4	0	0	4	0	0
20	18535350	.	G	A	1	2	3	0	0	3	0	0
20	18551728	.	T	A	13	7	20	0	2	22	0	0
20	18591704	.	G	A	13	23	36	0	0	36	0	0
20	18591716	.	A	C	10	19	29	0	1	30	0	0
20	18591743	.	A	T	4	12	16	0	1	17	0	0
20	18594958	.	C	A	20	23	43	0	1	44	0	0
20	18672033	.	G	A	1	14	15	0	0	15	0	0
20	18672064	.	C	T	3	12	15	0	3	18	0	0
20	18672094	.	T	C	4	12	16	0	1	17	0	0
20	18672162	.	G	A	3	3	6	0	0	6	0	0
20	18672610	.	C	G	4	4	8	0	0	8	0	0
20	18672733	.	A	T	8	12	20	0	2	22	0	0
20	18672970	.	G	A	7	11	18	0	1	19	0	0
20	18673132	.	C	T	11	13	24	0	1	25	0	0
20	18677343	.	G	A	0	1	1	0	0	1	0	0
20	18683158	.	T	C	4	5	9	0	2	11	0	0
20	18683177	.	A	G	1	0	1	0	1	2	0	0
20	18684760	.	G	A	10	11	21	0	0	21	0	0
20	18684769	.	G	A	12	12	24	0	2	26	0	0
20	18685235	.	C	G	9	9	18	0	0	18	0	0
20	18685256	.	G	A	8	5	13	0	1	14	0	0
20	18685279	.	G	C	0	5	5	0	4	9	0	0
20	18708770	.	T	C	15	14	29	0	6	35	0	0
20	18713016	.	C	T	18	26	44	0	1	45	0	0
20	18713067	.	T	C	17	12	29	0	1	30	0	0
20	18714282	.	A	G	1	0	1	0	4	5	0	0
20	18714390	.	G	A	0	3	3	0	2	5	0	0
20	18721340	.	G	T	2	5	7	0	0	7	0	0
20	18721383	.	A	T	2	2	4	0	1	5	0	0
20	18721788	.	C	T	20	12	32	0	0	32	0	0
20	18721910	.	G	A	15	11	26	0	0	26	0	0
20	18722565	.	A	T	17	18	35	0	1	36	0	0
20	18722652	.	T	A	9	7	16	0	0	16	0	0
20	18722860	.	A	T	12	7	19	0	0	19	0	0
20	18722943	.	G	A	6	2	8	0	3	11	0	0
20	18723105	.	C	T	16	6	22	0	4	26	0	0
20	18723277	.	T	C	17	10	27	0	2	29	0	0
20	18723362	.	T	C	9	12	21	0	0	21	0	0
20	18723383	.	A	T	14	8	22	0	0	22	0	0
20	18723401	.	T	C	7	0	7	0	16	23	0	0
20	18723511	.	T	C	9	3	12	0	0	12	0	0
20	18727506	.	T	C	5	9	14	0	1	15	0	0
20	18730498	.	G	A	12	6	18	0	0	18	0	0
20	18730840	.	T	C	12	5	17	0	1	18	0	0
20	18731068	.	C	T	8	10	18	0	0	18	0	0
20	18747036	.	C	T	1	1	2	0	0	2	0	0
20	18747062	.	C	A	1	1	2	0	0	2	0	0
20	18756047	.	A	T	3	3	6	1	0	7	0	0
20	18756069	.	A	G	4	3	7	1	0	8	0	0
20	18756628	.	A	G	3	2	5	0	0	5	0	0
20	18774616	.	A	G	2	2	4	0	0	4	0	0
20	18774618	.	T	C	2	1	3	0	1	4	0	0
20	18775947	.	A	G	2	2	4	0	0	4	0	0
20	18801644	.	G	A	3	2	5	0	0	5	0	0
20	18802438	.	A	G	6	6	12	0	0	12	0	0
20	18802567	.	T	C	1	4	5	0	1	6	0	0
20	18802603	.	C	T	6	4	10	0	1	11	0	0
20	18915249	.	C	T	6	5	11	0	0	11	0	0
20	18947388	.	A	G	6	16	22	0	1	23	0	0
20	18958090	.	G	A	1	3	4	0	5	10	1	0
20	18958106	.	C	G	9	9	18	0	0	18	0	0
20	18958420	.	T	C	12	10	22	0	1	23	0	0
20	18958433	.	G	A	0	12	12	0	17	29	0	0
20	18958477	.	G	A	0	10	10	0	6	16	0	0
20	18961838	.	C	T	5	9	14	0	0	14	0	0
20	18968826	.	C	T	9	14	23	0	0	23	0	0
20	19406666	.	T	C	5	2	7	0	0	7	0	0
20	20311904	.	A	G	3	2	5	0	1	6	0	0
20	20602232	.	T	C	12	6	18	1	0	19	0	0
20	20605071	.	T	C	1	7	8	0	0	8	0	0
20	20605078	.	T	C	6	3	9	0	0	9	0	0
20	21638431	.	C	A	4	3	7	0	0	7	0	0
20	21638575	.	T	C	2	7	9	0	0	9	0	0
20	21638903	.	T	C	1	2	3	0	0	3	0	0
20	21815659	.	G	T	9	12	21	0	0	21	0	0
20	21815986	.	C	T	1	15	16	0	13	29	0	0
20	21816061	.	C	G	12	17	29	0	0	29	0	0
20	21819062	.	T	C	21	18	39	0	1	40	0	0
20	21839504	.	G	A	5	8	13	0	0	13	0	0
20	21841312	.	G	A	1	2	3	0	0	3	0	0
20	21841316	.	G	T	1	2	3	0	0	3	0	0
20	21855195	.	T	C	2	6	8	0	0	8	0	0
20	21862963	.	C	T	0	17	17	0	11	28	0	0
20	21862975	.	C	T	0	11	11	0	15	26	0	0
20	21872945	.	A	G	2	3	5	0	0	5	0	0
20	21872990	.	G	A	5	3	8	0	0	8	0	0
20	21875111	.	G	A	3	1	4	0	0	4	0	0
20	21875162	.	G	A	11	5	16	0	1	17	0	0
20	21875165	.	T	G	11	5	16	0	1	17	0	0
20	21875411	.	C	A	2	1	3	0	0	3	0	0
20	21910005	.	C	T	0	5	5	0	12	17	0	0
20	22045180	.	A	T	4	1	5	0	0	5	0	0
20	22045209	.	C	T	3	3	6	0	1	7	0	0
20	22045260	.	A	C	0	2	2	0	0	2	0	0
20	22160859	.	T	A	1	2	3	0	0	3	0	0
20	22163667	.	T	C	0	1	1	0	0	1	0	0
20	22166199	.	G	A	3	3	6	0	0	6	0	0
20	22168567	.	C	T	3	3	6	0	0	6	0	0
20	22175625	.	T	C	2	3	5	0	0	5	0	0
20	22175815	.	T	C	8	3	11	0	0	11	0	0
20	22175830	.	G	A	7	2	9	0	1	10	0	0
20	22179962	.	T	A	9	6	15	0	0	16	1	0
20	22186632	.	G	A	6	10	16	0	0	16	0	0
20	22186738	.	G	A	7	11	18	0	0	18	0	0
20	22186765	.	C	G	10	10	20	0	0	20	0	0
20	22186886	.	A	G	6	4	10	0	0	10	0	0
20	22186914	.	A	G	8	6	14	0	1	15	0	0
20	22186971	.	C	T	10	7	17	0	1	18	0	0
20	22186973	.	C	T	11	7	18	0	0	18	0	0
20	22187233	.	T	C	7	12	19	0	0	19	0	0
20	22191361	.	A	T	14	10	24	0	3	27	0	0
20	22191376	.	A	G	14	12	26	0	1	27	0	0
20	22191493	.	T	C	4	0	4	0	6	10	0	0
20	22193013	.	C	A	1	3	4	0	6	11	1	0
20	22194285	.	C	T	0	5	5	0	3	9	1	0
20	22194385	.	A	T	4	3	7	0	1	8	0	0
20	22194395	.	G	A	4	4	8	0	0	8	0	0
20	22196960	.	T	G	3	2	5	0	0	5	0	0
20	22198957	.	C	A	4	2	6	0	0	6	0	0
20	22277176	.	G	C	2	2	4	0	0	4	0	0
20	22435335	.	C	A	1	2	3	0	1	4	0	0
20	22435609	.	T	A	1	2	3	0	1	4	0	0
20	22435893	.	T	A	3	2	5	0	0	5	0	0
20	22435901	.	C	T	3	2	5	0	0	5	0	0
20	22709610	.	C	A	18	16	34	0	0	35	1	0
20	22709685	.	T	A	10	15	25	0	2	27	0	0
20	22722200	.	C	A	21	19	40	0	0	40	0	0
20	22722255	.	G	C	18	9	27	0	0	27	0	0
20	22730689	.	C	G	2	10	12	0	1	13	0	0
20	22734031	.	G	A	0	15	15	0	11	26	0	0
20	22734052	.	G	A	0	22	22	0	15	37	0	0
20	22736673	.	C	T	23	22	45	0	0	45	0	0
20	22738204	.	C	A	8	10	18	0	0	18	0	0
20	22739946	.	C	A	22	20	42	0	2	44	0	0
20	22740056	.	C	T	20	15	35	0	1	36	0	0
20	22740140	.	C	T	15	23	38	0	2	40	0	0
20	22740230	.	A	G	24	26	50	0	0	50	0	0
20	22740533	.	A	T	18	9	27	0	0	27	0	0
20	22740567	.	A	G	11	0	11	0	18	29	0	0
20	22800060	.	G	A	1	2	3	0	0	3	0	0
20	22802259	.	C	A	5	3	8	0	0	8	0	0
20	22907915	.	C	T	0	1	1	0	0	1	0	0
20	23017227	.	T	C	2	1	3	0	0	3	0	0
20	23021287	.	G	T	3	5	8	0	0	8	0	0
20	23021292	.	A	T	4	6	10	0	0	10	0	0
20	23023364	.	G	A	8	6	14	0	0	14	0	0
20	23023471	.	C	T	9	8	17	0	0	17	0	0
20	23023482	.	A	G	8	7	15	0	1	16	0	0
20	23023623	.	G	A	9	8	17	0	1	18	0	0
20	23023641	.	A	G	9	5	14	0	0	14	0	0
20	23023835	.	A	G	5	4	9	0	0	9	0	0
20	23024096	.	G	A	4	5	9	0	0	9	0	0
20	23026133	.	C	T	0	7	7	0	6	13	0	0
20	23101008	.	G	A	0	3	3	0	2	5	0	0
20	23175425	.	A	G	12	16	28	0	0	28	0	0
20	23175479	.	C	A	13	10	23	0	1	24	0	0
20	23175495	.	C	A	13	11	24	0	1	25	0	0
20	23178078	.	T	C	15	13	28	0	4	32	0	0
20	23179753	.	A	G	7	0	7	0	4	11	0	0
20	23204754	.	C	A	10	10	20	0	4	24	0	0
20	23205102	.	T	C	14	5	19	0	1	20	0	0
20	23205831	.	A	C	4	0	4	0	14	18	0	0
20	23205868	.	T	C	15	22	37	0	0	37	0	0
20	23205879	.	G	A	18	23	41	0	0	41	0	0
20	23245852	.	C	T	1	8	9	0	0	9	0	0
20	23246215	.	G	A	2	4	6	0	0	6	0	0
20	23248635	.	T	C	8	13	21	0	2	23	0	0
20	23250530	.	C	A	7	3	10	0	0	10	0	0
20	23253455	.	G	A	3	3	6	0	0	6	0	0
20	23368411	.	T	C	2	0	2	0	0	2	0	0
20	23368510	.	A	G	3	0	3	0	2	5	0	0
20	23372087	.	C	T	0	1	1	0	0	1	0	0
20	23374412	.	C	T	0	2	2	0	0	2	0	0
20	23376342	.	C	T	4	4	8	0	0	8	0	0
20	23385556	.	G	A	2	0	2	0	0	2	0	0
20	23385922	.	T	C	3	4	7	0	1	8	0	0
20	23386096	.	G	A	8	3	11	0	0	11	0	0
20	23386198	.	A	T	6	8	14	0	0	14	0	0
20	23387832	.	T	C	2	1	3	0	0	3	0	0
20	23395369	.	A	C	2	2	4	0	11	15	0	0
20	23395404	.	C	T	4	0	4	0	1	5	0	0
20	23402554	.	A	G	5	9	14	0	0	14	0	0
20	23406545	.	T	A	10	18	28	0	1	29	0	0
20	23408734	.	T	C	4	2	6	0	0	6	0	0
20	23418228	.	G	A	7	7	14	0	0	14	0	0
20	23418291	.	C	G	18	8	26	0	1	27	0	0
20	23420784	.	A	T	19	12	31	0	3	34	0	0
20	23421695	.	T	C	23	24	47	0	0	47	0	0
20	23422061	.	T	C	12	21	33	0	1	34	0	0
20	23422205	.	A	T	15	12	27	0	1	29	1	0
20	23431702	.	C	T	0	5	5	0	3	8	0	0
20	23432117	.	T	C	1	0	1	0	2	3	0	0
20	23446698	.	G	A	8	14	22	0	1	23	0	0
20	23446854	.	C	T	7	4	11	0	3	14	0	0
20	23447086	.	T	C	12	0	12	0	6	18	0	0
20	23447540	.	C	T	3	15	18	0	0	18	0	0
20	23447564	.	C	G	14	5	19	0	0	19	0	0
20	23453642	.	C	T	8	2	10	0	1	11	0	0
20	23453671	.	C	T	2	0	2	0	2	4	0	0
20	23453802	.	G	A	1	1	2	0	0	2	0	0
20	23467400	.	C	A	0	0	0	0	1	1	0	0
20	23471742	.	G	A	7	4	11	0	2	13	0	0
20	23471859	.	C	A	5	4	9	0	0	9	0	0
20	23472036	.	C	T	2	3	5	0	0	5	0	0
20	23472039	.	C	T	3	3	6	0	0	6	0	0
20	23472186	.	T	C	4	2	6	0	0	6	0	0
20	23472239	.	C	T	0	3	3	0	8	11	0	0
20	23472259	.	G	T	6	3	9	0	1	10	0	0
20	23478231	.	C	T	2	2	4	0	0	4	0	0
20	23480658	.	C	T	0	1	1	0	1	2	0	0
20	23637561	.	G	A	1	0	1	0	0	1	0	0
20	23643495	.	T	C	0	3	3	0	0	3	0	0
20	23647541	.	C	T	3	2	5	0	0	5	0	0
20	23647669	.	C	T	2	2	4	0	1	5	0	0
20	23647770	.	C	A	0	2	2	0	3	5	0	0
20	23648828	.	G	A	2	5	7	0	2	9	0	0
20	23651156	.	C	A	6	3	9	0	0	9	0	0
20	23651254	.	G	A	3	2	5	0	0	5	0	0
20	23651294	.	C	T	2	4	6	0	0	6	0	0
20	23651503	.	T	C	3	0	3	0	5	8	0	0
20	23655749	.	A	T	0	4	4	0	0	4	0	0
20	23655767	.	C	T	2	0	2	0	0	2	0	0
20	23656226	.	T	A	4	2	6	0	1	7	0	0
20	23656454	.	A	G	5	5	10	0	0	10	0	0
20	23664970	.	G	A	0	2	2	0	5	7	0	0
20	23665041	.	G	A	0	3	3	0	1	4	0	0
20	23665185	.	A	T	4	2	6	0	2	8	0	0
20	23665793	.	G	T	1	8	9	0	7	16	0	0
20	23665863	.	G	A	0	10	10	0	13	23	0	0
20	23666135	.	G	A	2	2	4	0	0	4	0	0
20	23666137	.	G	T	2	2	4	0	0	4	0	0
20	23685062	.	G	A	5	2	7	0	0	7	0	0
20	23685106	.	A	T	5	2	7	0	0	7	0	0
20	23685259	.	G	T	0	1	1	0	0	1	0	0
20	23685270	.	T	A	1	1	2	0	0	2	0	0
20	23685529	.	T	A	1	2	3	0	0	3	0	0
20	23689902	.	T	C	3	3	6	0	0	6	0	0
20	23689933	.	G	C	5	6	11	0	0	11	0	0
20	23689996	.	G	A	5	5	10	0	0	10	0	0
20	23690051	.	A	T	3	3	6	0	0	6	0	0
20	23690077	.	C	A	2	0	2	0	0	2	0	0
20	23691015	.	G	A	0	2	2	0	0	2	0	0
20	23691911	.	T	C	2	1	3	0	0	3	0	0
20	23691917	.	C	T	2	0	2	0	1	3	0	0
20	23692094	.	T	C	5	9	14	0	1	15	0	0
20	23694005	.	C	T	1	2	3	0	0	3	0	0
20	23694299	.	G	T	0	4	4	0	13	17	0	0
20	23705719	.	G	A	3	2	5	0	0	5	0	0
20	23705974	.	G	A	5	2	7	0	0	7	0	0
20	23713122	.	G	A	0	5	5	0	3	8	0	0
20	23713266	.	G	A	0	3	3	0	2	5	0	0
20	23713475	.	T	A	1	4	5	0	1	6	0	0
20	23713497	.	G	T	3	4	7	0	0	7	0	0
20	23713512	.	A	T	3	4	7	0	0	7	0	0
20	23713763	.	G	A	6	3	9	0	1	10	0	0
20	23713858	.	T	G	1	0	1	0	2	3	0	0
20	23713883	.	A	G	2	0	2	0	6	8	0	0
20	23742684	.	T	C	2	2	4	0	0	4	0	0
20	23742692	.	G	A	2	1	3	0	1	4	0	0
20	23746672	.	G	A	0	1	1	0	0	1	0	0
20	23746966	.	C	G	1	0	1	0	5	6	0	0
20	23747167	.	A	G	2	1	3	0	0	3	0	0
20	23796406	.	T	C	4	2	6	0	0	6	0	0
20	23796565	.	C	T	2	2	4	0	0	4	0	0
20	23797195	.	T	C	0	1	1	0	0	1	0	0
20	23801255	.	G	C	0	6	6	0	3	9	0	0
20	23826955	.	G	A	2	3	5	0	0	5	0	0
20	23828102	.	G	T	2	3	5	0	0	5	0	0
20	23829131	.	A	G	0	1	1	0	0	1	0	0
20	23829161	.	A	G	2	0	2	0	2	4	0	0
20	23829170	.	C	T	3	2	5	0	0	5	0	0
20	23829413	.	A	G	5	0	5	0	4	9	0	0
20	23832884	.	G	C	1	2	3	0	0	3	0	0
20	23833193	.	G	T	0	0	0	0	1	1	0	0
20	23835228	.	C	T	6	4	10	0	0	10	0	0
20	23835472	.	C	T	9	5	14	0	0	14	0	0
20	23835591	.	G	T	3	4	7	0	0	7	0	0
20	23836009	.	G	T	2	4	6	0	0	6	0	0
20	23836037	.	G	A	0	4	4	0	2	6	0	0
20	23836106	.	A	T	3	5	8	0	0	8	0	0
20	23836161	.	C	T	2	3	5	0	0	5	0	0
20	23836343	.	G	C	1	7	8	0	0	8	0	0
20	23836344	.	T	C	1	7	8	0	0	8	0	0
20	23836685	.	A	T	9	3	12	0	0	12	0	0
20	23836688	.	C	A	3	9	12	0	0	12	0	0
20	23836756	.	G	A	0	3	3	0	3	6	0	0
20	23836880	.	C	T	3	5	8	0	0	8	0	0
20	23836915	.	A	G	1	0	1	0	3	4	0	0
20	23856274	.	T	A	6	2	8	0	0	8	0	0
20	23856345	.	A	T	14	9	23	0	1	24	0	0
20	23857214	.	G	C	11	20	31	0	1	32	0	0
20	23857407	.	C	A	3	2	5	0	0	5	0	0
20	23857559	.	G	A	2	13	15	0	0	15	0	0
20	23857592	.	C	T	0	1	1	0	0	1	0	0
20	23859383	.	G	C	6	1	7	0	0	7	0	0
20	23859386	.	A	G	6	1	7	0	0	7	0	0
20	23859425	.	G	A	1	6	7	0	9	16	0	0
20	23859458	.	A	G	10	7	17	0	3	20	0	0
20	23859486	.	G	A	0	4	4	0	8	12	0	0
20	23861053	.	C	T	4	2	6	0	0	6	0	0
20	23861066	.	C	T	2	2	4	0	1	5	0	0
20	23877623	.	G	A	3	4	7	0	0	7	0	0
20	23879879	.	G	T	2	0	2	0	1	3	0	0
20	23879903	.	C	A	1	1	2	0	0	2	0	0
20	23881731	.	C	G	2	3	5	0	0	5	0	0
20	23882437	.	C	T	7	6	13	0	1	14	0	0
20	23883008	.	T	C	3	3	6	0	0	6	0	0
20	23883351	.	T	A	7	4	11	0	1	12	0	0
20	23883599	.	T	C	3	0	3	0	0	3	0	0
20	23885485	.	T	A	2	3	5	0	0	5	0	0
20	23885505	.	C	T	0	1	1	0	2	3	0	0
20	23885925	.	G	A	1	2	3	0	0	3	0	0
20	23886277	.	A	G	3	4	7	0	1	8	0	0
20	23886358	.	A	G	2	1	3	0	0	3	0	0
20	23888878	.	C	G	2	3	5	0	0	5	0	0
20	23889403	.	T	G	5	5	10	0	0	10	0	0
20	23890376	.	C	T	0	6	6	0	2	8	0	0
20	23890478	.	C	T	2	6	8	0	0	8	0	0
20	23890489	.	C	T	2	7	9	0	1	10	0	0
20	23892006	.	G	A	2	2	4	0	0	4	0	0
20	23892027	.	C	T	0	1	1	0	4	5	0	0
20	23892059	.	G	A	0	1	1	0	0	1	0	0
20	23897315	.	G	A	2	3	5	0	0	5	0	0
20	23897328	.	G	A	2	2	4	0	0	4	0	0
20	23899009	.	T	C	0	1	1	0	0	1	0	0
20	23950624	.	A	G	1	3	4	0	0	4	0	0
20	23951203	.	C	A	2	2	4	0	0	4	0	0
20	23951630	.	C	T	1	2	3	0	0	3	0	0
20	23952628	.	T	C	4	4	8	0	0	8	0	0
20	23952632	.	A	C	4	4	8	0	0	8	0	0
20	23952796	.	G	A	3	2	5	0	0	5	0	0
20	23952801	.	G	A	2	3	5	0	0	5	0	0
20	23955171	.	G	T	2	3	5	0	0	6	1	0
20	23955237	.	C	G	1	4	5	0	0	5	0	0
20	23955326	.	G	T	0	3	3	0	6	9	0	0
20	23955384	.	A	T	4	7	11	0	0	11	0	0
20	23972997	.	C	T	0	5	5	0	1	6	0	0
20	23973245	.	T	G	1	5	6	0	0	6	0	0
20	23973253	.	T	A	1	5	6	0	0	6	0	0
20	23973433	.	T	C	6	5	11	0	1	12	0	0
20	23974834	.	T	C	2	3	5	0	0	5	0	0
20	23974953	.	T	G	4	2	6	0	0	6	0	0
20	23975055	.	T	C	1	0	1	0	3	4	0	0
20	23996985	.	C	A	1	5	6	0	0	6	0	0
20	24151599	.	C	T	0	5	5	0	12	17	0	0
20	24152098	.	G	A	7	5	12	0	0	12	0	0
20	24152821	.	G	A	12	13	25	0	3	28	0	0
20	24152822	.	G	A	15	13	28	0	0	28	0	0
20	24175892	.	A	G	3	2	5	0	0	5	0	0
20	24180690	.	C	T	6	2	8	0	0	8	0	0
20	24182980	.	C	T	5	2	7	0	0	7	0	0
20	24183288	.	G	A	3	8	11	0	0	11	0	0
20	24818673	.	G	A	12	8	20	0	0	20	0	0
20	24819091	.	A	G	7	9	16	0	0	16	0	0
20	24819152	.	C	G	2	5	7	0	1	8	0	0
20	24819582	.	C	T	1	12	13	0	10	23	0	0
20	24819646	.	C	T	8	9	17	0	1	18	0	0
20	24819698	.	G	A	8	5	13	0	1	14	0	0
20	24819858	.	T	C	3	5	8	0	0	8	0	0
20	24819929	.	T	C	11	7	18	0	0	18	0	0
20	24820746	.	A	T	3	3	6	0	0	6	0	0
20	24820758	.	C	A	3	5	8	0	0	8	0	0
20	24820885	.	C	T	0	9	9	0	10	19	0	0
20	24820963	.	T	A	11	4	15	0	0	15	0	0
20	24821048	.	C	A	10	9	19	0	0	19	0	0
20	24821072	.	A	G	7	11	18	0	0	18	0	0
20	24821499	.	T	G	4	3	7	0	2	9	0	0
20	24835754	.	C	T	0	4	4	0	7	11	0	0
20	24856399	.	C	T	1	0	1	0	0	1	0	0
20	24915538	.	G	A	5	2	7	0	0	7	0	0
20	24915591	.	T	C	6	0	6	0	6	12	0	0
20	24959732	.	A	G	1	5	6	0	0	6	0	0
20	24962956	.	G	A	2	5	7	0	0	7	0	0
20	25269827	.	T	A	1	2	3	0	0	3	0	0
20	25342164	.	C	T	1	1	2	0	0	2	0	0
20	25342397	.	C	T	3	1	4	0	0	4	0	0
20	25342721	.	C	T	5	8	13	0	1	14	0	0
20	25368871	.	C	T	8	6	14	0	1	15	0	0
20	25371869	.	A	G	4	4	8	0	0	8	0	0
20	25371914	.	C	T	0	1	1	0	2	3	0	0
20	25372677	.	A	G	3	2	5	0	0	5	0	0
20	25378556	.	C	T	0	1	1	0	0	1	0	0
20	25378583	.	T	G	0	1	1	0	0	1	0	0
20	25387850	.	T	A	1	3	4	0	0	4	0	0
20	25387865	.	A	G	4	2	6	0	0	6	0	0
20	25440724	.	G	T	8	3	11	0	2	13	0	0
20	25441033	.	G	T	12	9	21	0	1	22	0	0
20	25444929	.	A	G	9	3	12	0	0	12	0	0
20	25494432	.	G	A	1	0	1	0	0	1	0	0
20	25499412	.	A	C	1	0	1	0	0	1	0	0
20	25500859	.	A	G	6	0	6	0	0	6	0	0
20	25500922	.	C	T	3	0	3	0	0	3	0	0
20	25509842	.	C	A	10	12	22	0	1	23	0	0
20	25509851	.	A	T	9	11	20	0	2	22	0	0
20	25509934	.	T	C	6	5	11	0	0	11	0	0
20	25510234	.	A	T	4	8	12	0	0	12	0	0
20	25510256	.	T	A	8	5	13	0	0	13	0	0
20	25510270	.	G	T	7	6	13	0	0	13	0	0
20	25510331	.	A	G	15	6	21	0	0	21	0	0
20	25510481	.	A	G	8	5	13	0	0	13	0	0
20	25510586	.	A	G	6	5	11	0	0	11	0	0
20	25510630	.	G	A	7	11	18	0	3	21	0	0
20	25510739	.	C	A	6	11	17	0	1	18	0	0
20	25510769	.	T	C	4	9	13	0	0	13	0	0
20	25510897	.	G	C	6	7	13	0	0	13	0	0
20	25511312	.	T	A	6	11	17	0	2	19	0	0
20	25511609	.	T	C	9	11	20	0	0	20	0	0
20	25511785	.	T	C	11	3	14	0	0	14	0	0
20	25511940	.	G	A	0	8	8	0	5	13	0	0
20	25511957	.	A	T	7	6	13	0	0	13	0	0
20	25511997	.	A	G	1	3	4	0	0	4	0	0
20	25518103	.	G	A	1	2	3	0	0	3	0	0
20	25548780	.	C	T	0	3	3	0	4	7	0	0
20	25618336	.	A	C	7	5	12	0	1	13	0	0
20	25618601	.	T	A	5	8	13	0	2	15	0	0
20	25623770	.	A	T	3	2	5	0	0	5	0	0
20	25623778	.	A	T	3	4	7	0	0	7	0	0
20	25626064	.	A	T	1	3	4	0	0	4	0	0
20	25628390	.	C	T	0	1	1	0	1	2	0	0
20	25629158	.	T	A	3	2	5	0	0	5	0	0
20	25636002	.	A	G	0	1	1	0	0	1	0	0
20	25660033	.	T	A	8	6	14	0	1	15	0	0
20	25661199	.	A	G	22	14	36	0	0	36	0	0
20	25661509	.	G	A	17	24	41	0	0	41	0	0
20	25663590	.	T	G	3	3	6	0	0	6	0	0
20	25665101	.	G	T	20	18	38	0	0	38	0	0
20	25665115	.	G	T	20	12	32	0	2	34	0	0
20	25665144	.	G	T	21	10	31	0	0	31	0	0
20	25665195	.	G	A	23	8	31	0	0	31	0	0
20	25665325	.	T	G	5	14	19	0	0	19	0	0
20	25665506	.	C	T	7	7	14	0	1	15	0	0
20	25665515	.	C	T	7	9	16	0	0	16	0	0
20	25665627	.	T	C	7	10	17	0	0	17	0	0
20	25665822	.	G	A	13	15	28	0	0	28	0	0
20	25665927	.	T	C	16	6	22	0	0	22	0	0
20	25666142	.	C	T	12	10	22	0	1	23	0	0
20	25666277	.	G	T	10	8	18	0	2	20	0	0
20	25666812	.	T	A	13	21	34	0	0	34	0	0
20	25666947	.	C	T	8	6	14	1	0	15	0	0
20	25669567	.	T	G	4	8	12	0	0	12	0	0
20	25669888	.	C	A	2	2	4	0	0	4	0	0
20	25853191	.	T	C	4	6	10	0	0	10	0	0
20	25853228	.	T	C	9	3	12	0	0	12	0	0
20	25853767	.	A	G	14	24	38	0	3	41	0	0
20	25855561	.	G	A	1	1	2	0	0	2	0	0
20	25859494	.	C	T	10	12	22	0	1	23	0	0
20	25906391	.	T	C	1	2	3	0	0	3	0	0
20	25909276	.	T	C	0	7	7	0	0	7	0	0
20	25909330	.	C	T	3	10	13	0	2	15	0	0
20	25909462	.	T	C	3	12	15	0	0	15	0	0
20	25909699	.	C	T	8	17	25	0	1	26	0	0
20	25909765	.	A	C	7	13	20	0	0	20	0	0
20	25910298	.	A	T	5	6	11	0	1	12	0	0
20	25910366	.	A	T	10	5	15	0	0	15	0	0
20	25910368	.	A	T	9	5	14	0	1	15	0	0
20	25919371	.	T	C	8	4	12	0	1	13	0	0
20	25921009	.	C	T	11	10	21	0	1	22	0	0
20	25923747	.	T	C	12	10	22	0	3	25	0	0
20	25923960	.	T	C	16	18	34	0	2	36	0	0
20	25926048	.	A	G	10	20	30	0	1	31	0	0
20	25926474	.	G	A	9	12	21	0	0	21	0	0
20	25926505	.	T	C	7	8	15	0	1	16	0	0
20	25926540	.	T	A	8	13	21	0	0	21	0	0
20	25926623	.	A	G	2	16	18	0	1	19	0	0
20	25927126	.	C	A	13	10	23	0	1	24	0	0
20	25927259	.	C	G	19	1	20	0	14	34	0	0
20	25928098	.	C	T	14	9	23	0	1	24	0	0
20	25929913	.	T	A	16	16	32	0	2	34	0	0
20	25930671	.	T	C	5	5	10	0	0	10	0	0
20	25936751	.	G	T	0	1	1	0	0	1	0	0
20	25936754	.	A	C	0	1	1	0	0	1	0	0
20	25953538	.	T	C	1	2	3	0	0	3	0	0
20	26002683	.	T	C	4	3	7	0	1	8	0	0
20	26002780	.	T	A	7	6	13	0	1	14	0	0
20	26002822	.	A	G	5	2	7	0	0	7	0	0
20	26002900	.	C	G	8	8	16	0	0	16	0	0
20	26002970	.	A	G	4	0	4	0	6	10	0	0
20	26004160	.	T	A	7	9	16	0	1	18	1	0
20	26004251	.	A	G	8	10	18	0	2	20	0	0
20	26023822	.	T	C	5	4	9	0	0	9	0	0
20	26024196	.	G	A	11	22	33	0	1	34	0	0
20	26024432	.	C	T	10	16	26	0	0	26	0	0
20	26024434	.	A	G	9	16	25	0	1	26	0	0
20	26024565	.	G	A	0	15	15	0	19	34	0	0
20	26027434	.	G	T	4	6	10	0	1	11	0	0
20	26027630	.	C	T	4	5	9	0	0	9	0	0
20	26030641	.	G	T	1	3	4	0	1	5	0	0
20	26035649	.	A	G	2	1	3	0	0	3	0	0
20	26037691	.	G	T	0	1	1	0	0	1	0	0
20	26047462	.	G	A	7	9	16	0	0	16	0	0
20	26048815	.	C	T	3	3	6	0	0	6	0	0
20	26049961	.	G	A	4	4	8	0	0	8	0	0
20	26050226	.	T	C	9	1	10	0	3	13	0	0
20	26054503	.	A	G	6	2	8	0	0	8	0	0
20	26055709	.	A	C	1	2	3	0	0	3	0	0
20	26270488	.	T	C	1	1	2	0	1	3	0	0
20	26271357	.	G	T	0	5	5	0	0	5	0	0
20	26273194	.	T	C	1	4	5	0	0	5	0	0
20	26279817	.	A	C	1	4	5	0	0	5	0	0
20	26279961	.	A	C	3	3	6	0	0	6	0	0
20	26283471	.	C	A	5	3	8	0	1	9	0	0
20	26285416	.	A	G	3	0	3	0	2	5	0	0
20	26285606	.	G	A	1	0	1	0	0	1	0	0
20	26290451	.	G	A	5	6	11	0	0	11	0	0
20	26290667	.	A	T	4	6	10	0	0	10	0	0
20	26290738	.	A	T	1	6	7	0	0	7	0	0
20	26290739	.	T	C	1	6	7	0	0	7	0	0
20	26290778	.	A	G	1	3	4	0	0	4	0	0
20	26290947	.	A	G	2	9	11	0	0	11	0	0
20	26290962	.	C	T	3	9	12	0	0	12	0	0
20	26291016	.	G	C	1	6	7	0	0	7	0	0
20	26291147	.	T	C	1	3	4	0	0	4	0	0
20	26291213	.	A	G	1	4	5	0	1	6	0	0
20	26291331	.	T	C	1	5	6	0	0	6	0	0
20	26298380	.	G	A	5	6	11	0	2	13	0	0
20	26300495	.	A	G	2	2	4	0	0	4	0	0
20	26300840	.	G	T	5	2	7	0	0	7	0	0
20	26304918	.	G	A	1	1	2	0	0	2	0	0
20	26304921	.	G	A	1	2	3	0	0	3	0	0
20	26305019	.	A	T	8	10	18	0	0	18	0	0
20	26310596	.	T	A	4	5	9	0	0	9	0	0
20	26310637	.	C	T	1	1	2	0	0	2	0	0
20	26320288	.	T	C	3	9	12	0	0	12	0	0
20	26321073	.	G	A	5	4	9	0	0	9	0	0
20	26323356	.	T	C	4	6	10	0	0	10	0	0
20	26325671	.	A	G	12	9	21	0	0	21	0	0
20	26326345	.	T	C	12	18	30	0	0	30	0	0
20	26327719	.	C	T	6	11	17	0	0	17	0	0
20	26328051	.	C	T	10	9	19	0	0	19	0	0
20	26329035	.	G	A	1	5	6	0	0	6	0	0
20	26331595	.	A	G	2	3	5	0	0	5	0	0
20	26334446	.	C	T	7	10	17	0	1	18	0	0
20	26336921	.	C	G	3	2	5	0	0	5	0	0
20	26337036	.	C	T	7	10	17	0	1	18	0	0
20	26337733	.	C	T	22	20	42	0	6	48	0	0
20	26342889	.	C	T	5	5	10	0	0	10	0	0
20	26344835	.	A	G	7	6	13	0	0	13	0	0
20	26345856	.	T	A	14	18	32	0	2	34	0	0
20	26346710	.	C	T	20	31	51	0	0	51	0	0
20	26348838	.	G	A	0	8	8	0	6	14	0	0
20	26351914	.	T	G	10	0	10	0	23	33	0	0
20	26353751	.	T	C	14	9	23	0	2	25	0	0
20	26353770	.	A	G	19	13	32	0	3	35	0	0
20	26353793	.	T	C	20	17	37	0	2	39	0	0
20	26358574	.	T	C	24	25	49	0	0	49	0	0
20	26360192	.	C	T	4	2	6	0	0	6	0	0
20	26360549	.	A	G	3	0	3	0	2	5	0	0
20	26361403	.	G	A	2	3	5	0	1	6	0	0
20	26387181	.	G	A	7	7	14	0	0	14	0	0
20	26387288	.	T	A	8	7	15	0	2	17	0	0
20	26387413	.	A	T	6	4	10	0	0	10	0	0
20	26387881	.	T	G	6	4	10	0	2	12	0	0
20	26390906	.	C	T	1	1	2	0	1	3	0	0
20	26390912	.	G	A	1	2	3	0	0	3	0	0
20	26402615	.	T	C	2	7	9	0	0	9	0	0
20	26404443	.	G	A	0	4	4	0	1	5	0	0
20	26404696	.	G	A	0	3	3	0	8	11	0	0
20	26404860	.	T	A	4	9	13	0	0	13	0	0
20	26405356	.	A	T	7	3	10	0	0	10	0	0
20	26405406	.	T	G	3	0	3	0	3	6	0	0
20	26405669	.	C	A	2	3	5	0	0	5	0	0
20	26405683	.	T	C	2	2	4	0	0	4	0	0
20	26405808	.	T	A	5	2	7	0	1	8	0	0
20	26406160	.	G	A	0	5	5	0	7	12	0	0
20	26406252	.	T	C	2	2	4	0	0	4	0	0
20	26406640	.	G	T	0	2	2	0	7	9	0	0
20	26406792	.	T	A	1	2	3	0	0	3	0	0
20	26406806	.	C	T	1	2	3	0	0	3	0	0
20	26406978	.	A	G	3	0	3	0	3	6	0	0
20	26409194	.	T	A	7	6	13	0	0	13	0	0
20	26409261	.	C	A	1	9	10	0	10	20	0	0
20	26409295	.	C	A	12	13	25	0	0	25	0	0
20	26409310	.	A	T	14	12	26	0	0	26	0	0
20	26409403	.	A	T	9	3	12	0	1	13	0	0
20	26409471	.	C	T	0	14	14	0	11	25	0	0
20	26409599	.	C	T	22	14	36	0	1	37	0	0
20	26409922	.	T	C	15	15	30	0	2	32	0	0
20	26409931	.	C	T	17	15	32	0	3	35	0	0
20	26410224	.	G	T	9	5	14	0	1	16	1	0
20	26410275	.	G	A	5	10	15	0	1	16	0	0
20	26410341	.	A	G	12	11	23	0	3	26	0	0
20	26410344	.	A	C	13	12	25	0	0	25	0	0
20	26412372	.	T	A	15	13	28	0	1	29	0	0
20	26412479	.	C	T	8	7	15	0	0	15	0	0
20	26412501	.	G	A	10	6	16	0	0	16	0	0
20	26412579	.	C	A	8	16	24	0	0	24	0	0
20	26412830	.	G	T	16	17	33	0	1	34	0	0
20	26412831	.	G	T	16	17	33	0	1	34	0	0
20	26412876	.	G	A	17	11	28	0	3	31	0	0
20	26412968	.	T	A	13	26	39	0	2	41	0	0
20	26413057	.	G	A	13	16	29	0	2	31	0	0
20	26413181	.	T	C	8	12	20	0	1	21	0	0
20	26413269	.	C	A	10	12	22	0	2	24	0	0
20	26413280	.	A	C	10	1	11	0	13	24	0	0
20	26413311	.	C	T	9	16	25	0	2	27	0	0
20	26413470	.	G	T	4	9	13	0	0	13	0	0
20	26413584	.	G	A	3	6	9	0	0	9	0	0
20	26413923	.	C	T	7	7	14	0	0	14	0	0
20	26413998	.	A	T	9	9	18	0	1	19	0	0
20	26414724	.	C	T	0	4	4	0	4	8	0	0
20	26414747	.	C	T	5	7	12	0	0	12	0	0
20	26414832	.	C	T	3	5	8	0	0	8	0	0
20	26414844	.	G	A	3	5	8	0	0	8	0	0
20	26414919	.	A	G	11	6	17	0	1	18	0	0
20	26415021	.	G	T	5	4	9	0	0	9	0	0
20	26416114	.	A	G	3	5	8	0	0	8	0	0
20	26416218	.	C	T	5	7	12	0	1	13	0	0
20	26416265	.	C	T	3	3	6	0	0	6	0	0
20	26416266	.	T	A	3	3	6	0	0	6	0	0
20	26416353	.	T	G	3	11	14	0	1	15	0	0
20	26416469	.	C	G	7	3	10	0	0	10	0	0
20	26416514	.	T	C	6	6	12	0	1	13	0	0
20	26416551	.	A	T	5	4	9	0	1	10	0	0
20	26467216	.	C	T	7	8	15	0	1	16	0	0
20	26467293	.	T	C	4	3	7	0	1	8	0	0
20	26467302	.	G	A	3	3	6	0	0	6	0	0
20	26587834	.	A	G	7	4	11	0	0	11	0	0
20	26594516	.	G	T	2	2	4	0	0	4	0	0
20	26597977	.	G	A	0	4	4	0	0	4	0	0
20	26599709	.	C	T	2	2	4	0	0	4	0	0
20	26601222	.	G	A	2	1	3	0	1	4	0	0
20	26610433	.	G	A	10	4	14	0	0	14	0	0
20	26613462	.	A	G	3	6	9	0	1	10	0	0
20	26616241	.	G	C	2	0	2	0	1	3	0	0
20	26807385	.	G	A	3	6	9	0	0	9	0	0
20	26809059	.	A	G	3	3	6	0	0	6	0	0
20	26822389	.	A	G	4	6	10	0	0	10	0	0
20	26822449	.	A	G	8	9	17	0	0	17	0	0
20	26886607	.	A	G	1	1	2	0	1	3	0	0
20	26893058	.	C	A	0	3	3	0	0	3	0	0
20	26893097	.	G	A	0	2	2	0	0	2	0	0
20	26895337	.	A	G	3	2	5	0	0	5	0	0
20	26915443	.	T	C	0	3	3	0	0	3	0	0
20	26919197	.	T	C	2	2	4	0	0	4	0	0
20	26920805	.	G	C	1	4	5	0	0	5	0	0
20	26920879	.	C	G	2	3	5	0	0	5	0	0
20	26921043	.	A	G	1	2	3	0	0	3	0	0
20	26921070	.	T	C	5	2	7	0	0	7	0	0
20	26921313	.	T	C	4	5	9	0	0	9	0	0
20	26924590	.	T	C	1	1	2	0	0	2	0	0
20	26939926	.	C	T	6	13	19	0	0	19	0	0
20	26944106	.	G	A	14	16	30	0	1	31	0	0
20	26944311	.	G	A	19	18	37	0	4	41	0	0
20	26944576	.	C	T	16	17	33	0	1	34	0	0
20	26944762	.	C	T	13	10	23	0	1	24	0	0
20	26944971	.	G	A	5	7	12	0	0	12	0	0
20	26945180	.	T	A	5	8	13	0	2	15	0	0
20	26945394	.	C	T	9	7	16	0	0	16	0	0
20	26945735	.	C	T	9	13	22	0	0	22	0	0
20	26945913	.	T	C	13	16	29	0	0	29	0	0
20	26948033	.	A	T	2	3	5	0	2	7	0	0
20	26948161	.	A	G	6	4	10	0	0	10	0	0
20	26958737	.	C	T	9	9	18	0	2	20	0	0
20	26959139	.	G	C	3	9	12	0	1	13	0	0
20	26959624	.	C	T	7	2	9	0	0	9	0	0
20	26959829	.	C	T	8	5	13	0	0	13	0	0
20	26959900	.	G	A	0	9	9	0	7	16	0	0
20	26959902	.	G	C	7	9	16	0	0	16	0	0
20	26960032	.	G	C	7	14	21	0	1	22	0	0
20	26960540	.	A	G	4	0	4	0	9	13	0	0
20	26960619	.	A	G	16	5	21	0	1	22	0	0
20	26960673	.	A	G	8	4	12	0	1	13	0	0
20	26960802	.	T	C	8	7	15	0	1	16	0	0
20	26960877	.	G	A	0	8	8	0	11	19	0	0
20	26961040	.	G	A	0	3	3	0	1	4	0	0
20	26961041	.	G	A	1	3	4	0	0	4	0	0
20	26961079	.	G	A	0	3	3	0	3	6	0	0
20	26961149	.	A	G	7	4	11	0	0	11	0	0
20	26961533	.	A	G	3	5	8	0	0	8	0	0
20	26961643	.	C	T	4	2	6	0	0	6	0	0
20	26961719	.	T	A	5	9	14	0	2	16	0	0
20	26961758	.	A	T	6	11	17	0	2	19	0	0
20	26961799	.	C	T	6	8	14	0	1	15	0	0
20	26961832	.	T	G	8	1	9	0	0	11	2	0
20	26961907	.	A	G	5	13	18	0	1	19	0	0
20	26962077	.	G	A	0	13	13	0	8	21	0	0
20	26962095	.	T	C	6	14	20	0	0	20	0	0
20	26962385	.	T	A	7	6	13	0	1	14	0	0
20	26962455	.	G	A	1	7	8	0	8	16	0	0
20	26972810	.	C	T	1	1	2	0	0	2	0	0
20	26989248	.	T	G	3	2	5	0	0	5	0	0
20	26989258	.	T	G	2	2	4	0	0	5	1	0
20	26992102	.	G	A	4	3	7	0	0	7	0	0
20	26993506	.	C	T	3	1	4	0	0	4	0	0
20	26999506	.	T	A	2	1	3	0	0	3	0	0
20	27001816	.	A	C	9	14	23	0	1	24	0	0
20	27001864	.	T	A	10	11	21	0	1	22	0	0
20	27001867	.	C	T	11	10	21	0	0	21	0	0
20	27001903	.	C	T	11	10	21	0	0	21	0	0
20	27001915	.	T	C	12	11	23	0	0	23	0	0
20	27002144	.	G	T	2	0	2	0	6	8	0	0
20	27002271	.	A	G	4	5	9	0	0	9	0	0
20	27020221	.	G	A	7	9	16	0	1	17	0	0
20	27020294	.	T	A	19	27	46	0	0	46	0	0
20	27020346	.	A	C	11	18	29	0	2	31	0	0
20	27020442	.	G	T	2	4	6	0	0	6	0	0
20	27020446	.	G	A	2	1	3	0	1	4	0	0
20	27029685	.	A	C	0	2	2	0	0	2	0	0
20	27033700	.	C	T	0	7	7	0	0	7	0	0
20	27033847	.	A	T	17	37	54	0	3	57	0	0
20	27033914	.	A	G	23	22	45	0	2	47	0	0
20	27039364	.	G	T	1	37	38	0	25	63	0	0
20	27039400	.	G	A	23	36	59	0	4	63	0	0
20	27039498	.	C	T	24	38	62	0	1	63	0	0
20	27039550	.	A	T	28	29	57	0	3	60	0	0
20	27039577	.	C	T	19	23	42	0	1	43	0	0
20	27045649	.	T	G	24	6	30	0	29	59	0	0
20	27045703	.	A	G	17	17	34	0	1	35	0	0
20	27045719	.	T	C	16	14	30	0	1	31	0	0
20	27045875	.	T	C	6	16	22	0	3	25	0	0
20	27087569	.	C	T	5	5	10	0	0	10	0	0
20	27089717	.	C	T	3	3	6	0	0	6	0	0
20	27089858	.	A	T	3	3	6	0	1	7	0	0
20	27089870	.	T	A	3	2	5	0	0	5	0	0
20	27090340	.	A	G	4	4	8	0	1	9	0	0
20	27090401	.	C	T	7	3	10	0	0	10	0	0
20	27090525	.	T	G	4	5	9	0	0	9	0	0
20	27090551	.	A	T	3	3	6	0	0	6	0	0
20	27090648	.	C	T	4	2	6	0	0	6	0	0
20	27091064	.	G	A	2	6	8	0	0	8	0	0
20	27091143	.	G	A	9	7	16	0	1	17	0	0
20	27092182	.	C	T	9	12	21	0	0	21	0	0
20	27092245	.	A	G	13	12	25	0	0	25	0	0
20	27093198	.	A	T	6	4	10	0	0	10	0	0
20	27093286	.	C	T	4	3	7	0	0	7	0	0
20	27094615	.	A	G	2	5	7	0	0	7	0	0
20	27094624	.	C	T	1	5	6	0	1	7	0	0
20	27094693	.	T	C	1	6	7	0	0	7	0	0
20	27096092	.	A	T	1	4	5	0	0	5	0	0
20	27096469	.	G	T	0	1	1	0	3	4	0	0
20	27100005	.	T	C	4	7	11	0	0	11	0	0
20	27102325	.	C	T	7	6	13	0	0	13	0	0
20	27107173	.	A	C	6	6	12	0	2	14	0	0
20	27107241	.	C	A	8	1	9	0	0	9	0	0
20	27107545	.	G	T	0	2	2	0	5	7	0	0
20	27107572	.	C	G	5	4	9	0	0	9	0	0
20	27115030	.	T	C	4	4	8	0	0	8	0	0
20	27194883	.	C	T	3	2	5	0	0	5	0	0
20	27194884	.	C	A	3	2	5	0	0	5	0	0
20	27264482	.	G	A	1	5	6	0	0	6	0	0
20	27280808	.	G	A	2	7	9	0	0	9	0	0
20	27280840	.	G	A	0	9	9	0	3	12	0	0
20	27281624	.	T	C	7	6	13	0	0	13	0	0
20	27281678	.	A	C	3	8	11	2	1	14	0	0
20	27281814	.	T	A	4	3	7	0	0	7	0	0
20	27282437	.	A	G	6	9	15	0	1	16	0	0
20	27282438	.	G	A	6	10	16	0	0	16	0	0
20	27282561	.	T	C	7	6	13	0	0	13	0	0
20	27282592	.	A	G	6	7	13	0	0	13	0	0
20	27282598	.	T	A	6	6	12	0	0	12	0	0
20	27282898	.	A	G	3	0	3	0	7	10	0	0
20	27282929	.	T	C	2	5	7	0	0	7	0	0
20	27324907	.	T	C	0	0	0	0	2	2	0	0
20	27324945	.	T	C	0	0	0	0	2	2	0	0
20	27331149	.	G	A	10	8	18	0	1	19	0	0
20	27352584	.	T	C	5	1	6	0	0	6	0	0
20	27353040	.	T	C	1	2	3	0	0	3	0	0
20	27358777	.	C	A	8	0	8	0	0	8	0	0
20	27366122	.	G	A	5	2	7	0	0	7	0	0
20	27366597	.	T	G	7	10	17	0	2	19	0	0
20	27368882	.	A	C	1	1	2	0	0	2	0	0
20	27370340	.	G	A	7	10	17	0	1	18	0	0
20	27371629	.	T	C	9	27	36	0	3	39	0	0
20	27371642	.	A	C	11	27	38	0	2	40	0	0
20	27371693	.	T	A	15	9	24	0	2	26	0	0
20	27371735	.	A	G	13	17	30	0	0	30	0	0
20	27371737	.	T	C	13	0	13	0	17	30	0	0
20	27371821	.	C	A	21	32	53	0	0	53	0	0
20	27374961	.	C	T	11	26	37	0	0	37	0	0
20	27375008	.	C	T	0	15	15	0	15	30	0	0
20	27378174	.	C	T	25	24	49	0	2	51	0	0
20	27378252	.	A	T	23	21	44	0	1	45	0	0
20	27378321	.	G	T	26	23	49	0	0	49	0	0
20	27381508	.	G	A	6	3	9	0	0	9	0	0
20	27381529	.	T	G	10	7	17	0	1	18	0	0
20	27396384	.	T	A	5	15	20	0	2	22	0	0
20	27396385	.	A	T	5	16	21	0	1	22	0	0
20	27396478	.	A	T	7	7	14	0	0	14	0	0
20	27396489	.	C	T	5	7	12	0	0	12	0	0
20	27528655	.	C	A	0	2	2	0	0	2	0	0
20	27528660	.	T	C	0	2	2	0	0	2	0	0
20	27542951	.	A	G	4	2	6	0	0	6	0	0
20	27546071	.	A	G	1	0	1	0	0	1	0	0
20	27549217	.	A	G	1	0	1	0	0	1	0	0
20	27549491	.	G	A	1	2	3	0	0	3	0	0
20	27549524	.	G	A	1	3	4	0	0	4	0	0
20	27550063	.	G	A	2	3	5	0	0	5	0	0
20	27550104	.	G	T	2	4	6	0	1	7	0	0
20	27550148	.	C	T	5	2	7	0	0	7	0	0
20	27550150	.	A	C	5	2	7	0	0	7	0	0
20	27550287	.	C	T	2	4	6	0	0	6	0	0
20	27550977	.	G	A	0	2	2	0	2	4	0	0
20	27551113	.	A	T	3	2	5	0	0	5	0	0
20	27551253	.	A	C	1	4	5	0	1	6	0	0
20	27551329	.	A	G	2	3	5	0	0	5	0	0
20	27551624	.	C	T	3	6	9	0	0	9	0	0
20	27692934	.	T	C	1	3	4	0	0	4	0	0
20	27693086	.	G	C	1	4	5	0	0	5	0	0
20	27708016	.	G	A	4	2	6	0	2	8	0	0
20	27708181	.	C	T	2	9	11	0	0	11	0	0
20	27708306	.	A	G	5	3	8	0	1	9	0	0
20	27716086	.	G	A	0	4	4	0	0	4	0	0
20	27716093	.	C	T	0	6	6	0	0	6	0	0
20	27716190	.	T	C	1	6	7	0	0	7	0	0
20	27717055	.	T	A	2	6	8	0	0	8	0	0
20	27717884	.	G	A	2	2	4	0	0	4	0	0
20	27717945	.	C	T	2	2	4	0	0	4	0	0
20	27718549	.	T	A	1	8	9	0	0	9	0	0
20	27718578	.	A	T	4	6	10	0	0	10	0	0
20	27718824	.	C	G	1	2	3	0	0	3	0	0
20	27719088	.	A	G	4	5	9	0	0	9	0	0
20	27719099	.	A	G	3	5	8	0	0	8	0	0
20	27719578	.	T	C	2	3	5	0	0	5	0	0
20	27719763	.	G	A	3	6	9	0	1	10	0	0
20	27732628	.	A	G	5	3	8	0	0	8	0	0
20	27732832	.	A	G	5	6	11	0	0	11	0	0
20	27733034	.	G	A	3	10	13	0	3	16	0	0
20	27733611	.	T	C	5	6	11	0	1	12	0	0
20	27733631	.	G	C	5	0	5	0	7	12	0	0
20	27733650	.	C	A	0	11	11	0	3	14	0	0
20	28310920	.	A	G	4	5	9	0	0	9	0	0
20	28316845	.	G	T	2	3	5	0	0	5	0	0
20	28322943	.	C	T	2	4	6	0	1	7	0	0
20	28326229	.	G	A	2	1	3	0	0	3	0	0
20	28326283	.	A	T	7	3	10	0	0	10	0	0
20	28326508	.	T	C	0	1	1	0	1	2	0	0
20	28337616	.	G	A	1	3	4	0	0	4	0	0
20	28337640	.	A	G	1	2	3	0	0	3	0	0
20	28349054	.	T	G	1	3	4	0	0	4	0	0
20	28354549	.	T	A	2	11	13	0	1	14	0	0
20	28354588	.	A	G	8	10	18	0	1	19	0	0
20	28354951	.	A	G	7	4	11	0	0	11	0	0
20	28356989	.	T	C	2	8	10	0	0	10	0	0
20	28356998	.	G	A	3	9	12	0	0	12	0	0
20	28357028	.	A	G	4	10	14	0	0	14	0	0
20	28357184	.	A	G	6	5	11	0	1	12	0	0
20	28357190	.	C	T	9	5	14	0	0	14	0	0
20	28357463	.	A	G	5	10	15	0	0	15	0	0
20	28357538	.	G	A	5	6	11	0	1	12	0	0
20	28357570	.	A	G	6	7	13	0	0	13	0	0
20	28357610	.	A	G	7	6	13	0	0	13	0	0
20	28357688	.	T	C	6	2	8	0	0	8	0	0
20	28357718	.	T	C	2	5	7	0	0	7	0	0
20	28357733	.	G	A	1	5	6	0	1	7	0	0
20	28357769	.	A	G	3	5	8	0	1	9	0	0
20	28357823	.	T	A	2	4	6	0	1	7	0	0
20	28357883	.	C	T	1	3	4	0	1	5	0	0
20	28358060	.	C	G	2	3	5	0	1	6	0	0
20	28358333	.	T	C	3	6	9	0	0	9	0	0
20	28361044	.	C	T	0	2	2	0	1	3	0	0
20	28361408	.	A	T	3	2	5	0	0	5	0	0
20	28399987	.	C	A	0	4	4	0	1	5	0	0
20	28400232	.	A	T	3	2	5	0	0	5	0	0
20	28400422	.	C	T	4	6	10	0	0	10	0	0
20	28400455	.	A	C	9	8	17	0	0	17	0	0
20	28400481	.	A	G	8	6	14	0	1	15	0	0
20	28400619	.	G	A	15	13	28	0	0	28	0	0
20	28401147	.	A	G	17	8	25	0	0	25	0	0
20	28401694	.	G	A	3	1	4	0	1	5	0	0
20	28402253	.	G	A	1	0	1	0	0	1	0	0
20	28404191	.	A	G	7	3	10	0	0	10	0	0
20	28404247	.	T	C	3	0	3	0	5	8	0	0
20	28404270	.	T	G	7	3	10	0	0	10	0	0
20	28408028	.	C	T	2	4	6	0	1	7	0	0
20	28409601	.	C	T	2	3	5	0	0	5	0	0
20	28411204	.	A	G	0	1	1	0	0	1	0	0
20	28414423	.	T	C	1	3	4	0	0	4	0	0
20	28418587	.	C	T	4	5	9	0	0	9	0	0
20	28418730	.	A	T	2	6	8	0	0	8	0	0
20	28418741	.	A	G	3	0	3	0	6	9	0	0
20	28418939	.	T	C	11	4	15	0	1	16	0	0
20	28419015	.	A	T	9	4	13	0	0	13	0	0
20	28419755	.	G	C	2	0	2	0	0	2	0	0
20	28419767	.	C	A	1	0	1	0	0	1	0	0
20	28419807	.	T	A	7	4	11	0	1	12	0	0
20	28420496	.	C	T	5	4	9	0	1	10	0	0
20	28420613	.	C	T	1	2	3	0	0	3	0	0
20	28422842	.	C	A	3	2	5	0	1	6	0	0
20	28422854	.	C	G	1	2	3	0	0	3	0	0
20	28422920	.	A	G	2	4	6	0	0	6	0	0
20	28422927	.	T	C	2	0	2	0	3	5	0	0
20	28423035	.	G	T	4	5	9	0	0	9	0	0
20	28423062	.	G	A	2	4	6	0	0	6	0	0
20	28423072	.	A	T	2	5	7	0	0	7	0	0
20	28456574	.	T	C	7	3	10	0	0	10	0	0
20	28469982	.	A	G	4	8	12	0	0	12	0	0
20	28487287	.	T	C	5	1	6	0	0	6	0	0
20	28514841	.	A	G	7	7	14	0	0	14	0	0
20	28514878	.	T	C	10	6	16	0	0	16	0	0
20	28514955	.	C	T	4	3	7	0	0	7	0	0
20	28541754	.	A	G	2	3	5	0	0	5	0	0
20	28641940	.	A	T	5	10	15	0	2	17	0	0
20	28641997	.	T	A	6	4	10	0	0	10	0	0
20	28642007	.	G	A	4	3	7	0	0	7	0	0
20	28650323	.	T	C	10	17	27	0	3	30	0	0
20	28650328	.	A	C	12	15	27	0	3	30	0	0
20	28650945	.	A	T	14	17	31	0	1	32	0	0
20	28650946	.	T	G	14	15	29	0	2	32	1	0
20	28651194	.	C	T	16	22	38	0	0	38	0	0
20	28651239	.	A	G	15	23	38	0	2	40	0	0
20	28651454	.	G	A	15	15	30	0	3	33	0	0
20	28651709	.	T	C	14	0	14	0	12	26	0	0
20	28651958	.	T	G	4	13	17	0	0	17	0	0
20	28652449	.	G	C	15	15	30	0	0	30	0	0
20	28654339	.	G	A	3	1	4	0	0	4	0	0
20	28658666	.	A	C	7	11	18	0	2	20	0	0
20	28658693	.	T	C	4	0	4	0	9	13	0	0
20	28659924	.	A	G	8	4	12	0	0	12	0	0
20	28659969	.	G	T	10	7	17	0	0	17	0	0
20	28660050	.	G	A	6	5	11	0	0	11	0	0
20	28660795	.	G	A	8	6	14	0	0	14	0	0
20	28660828	.	G	T	6	2	8	0	1	9	0	0
20	28675587	.	C	A	0	5	5	0	3	8	0	0
20	28677911	.	G	T	4	5	9	0	0	9	0	0
20	28682989	.	T	C	4	4	8	0	0	8	0	0
20	28693295	.	C	T	5	6	11	0	1	12	0	0
20	28698284	.	T	C	5	0	5	0	4	9	0	0
20	28783046	.	T	C	15	11	26	0	2	28	0	0
20	28783327	.	T	C	6	6	12	0	1	13	0	0
20	28783502	.	C	G	9	7	16	0	0	16	0	0
20	28783607	.	T	C	12	1	13	0	4	17	0	0
20	28783627	.	T	C	9	8	17	0	1	18	0	0
20	28783688	.	C	A	12	13	25	0	2	27	0	0
20	28783781	.	A	C	12	0	12	0	12	24	0	0
20	28783999	.	G	T	2	4	6	0	1	7	0	0
20	28784045	.	G	T	8	11	19	0	0	19	0	0
20	28800961	.	A	G	28	9	37	0	0	37	0	0
20	28804089	.	G	A	12	5	17	0	2	19	0	0
20	28814902	.	T	C	0	2	2	0	0	2	0	0
20	28817492	.	A	G	1	1	2	0	0	2	0	0
20	28822696	.	T	A	7	5	12	0	0	12	0	0
20	28822735	.	T	C	3	1	4	0	0	4	0	0
20	28823116	.	T	C	1	1	2	0	0	2	0	0
20	28825375	.	C	T	9	5	14	0	0	14	0	0
20	28827208	.	A	G	0	1	1	0	0	1	0	0
20	28827350	.	T	C	11	5	16	0	0	16	0	0
20	28827388	.	C	A	10	11	21	0	1	22	0	0
20	28827416	.	C	T	5	12	17	0	0	17	0	0
20	28827433	.	A	C	6	16	22	0	1	23	0	0
20	28827633	.	T	C	7	5	12	0	0	12	0	0
20	28833245	.	C	T	16	18	34	0	2	36	0	0
20	28833312	.	C	A	24	21	45	0	2	47	0	0
20	28833793	.	A	G	20	16	36	0	2	38	0	0
20	28833878	.	T	C	17	1	18	0	25	43	0	0
20	28834008	.	C	T	21	22	43	0	6	49	0	0
20	28834536	.	C	A	6	4	10	0	1	11	0	0
20	28870806	.	C	G	25	32	57	0	0	57	0	0
20	28870843	.	T	C	45	11	56	0	3	59	0	0
20	28871062	.	T	C	1	0	1	0	17	18	0	0
20	28871133	.	T	C	4	19	23	0	1	24	0	0
20	28871830	.	G	A	29	38	67	1	2	70	0	0
20	28875824	.	T	C	15	0	15	0	21	36	0	0
20	28876885	.	G	A	3	20	23	0	1	24	0	0
20	28876899	.	A	G	2	17	19	0	0	19	0	0
20	28876942	.	T	A	13	12	25	0	1	26	0	0
20	28876971	.	A	C	10	0	10	0	20	30	0	0
20	28876996	.	T	A	12	15	27	0	1	28	0	0
20	28877028	.	C	T	10	13	23	0	0	23	0	0
20	28877085	.	T	A	10	7	17	0	1	18	0	0
20	28877136	.	A	T	13	8	21	0	0	21	0	0
20	28877696	.	T	C	12	0	12	0	21	33	0	0
20	28878097	.	T	G	12	6	18	0	1	19	0	0
20	28878229	.	T	A	3	6	9	0	0	9	0	0
20	28884768	.	T	A	0	2	2	0	0	2	0	0
20	28886159	.	A	T	9	6	15	0	0	15	0	0
20	28886311	.	T	C	16	12	28	0	0	28	0	0
20	28886608	.	C	A	5	3	8	0	0	8	0	0
20	28886618	.	C	A	4	2	6	0	0	6	0	0
20	28886735	.	T	C	11	12	23	0	1	24	0	0
20	28886771	.	A	C	6	11	17	0	0	17	0	0
20	28887303	.	A	G	10	7	17	0	0	17	0	0
20	28887498	.	T	A	10	10	20	0	1	21	0	0
20	28887590	.	G	C	14	15	29	0	0	29	0	0
20	28888012	.	C	A	5	9	14	0	0	14	0	0
20	28888041	.	A	T	6	10	16	0	0	16	0	0
20	28888198	.	G	C	8	1	9	0	15	24	0	0
20	28888331	.	T	A	9	10	19	0	0	19	0	0
20	28888514	.	C	G	5	2	7	0	0	7	0	0
20	28888629	.	T	G	2	9	11	0	1	12	0	0
20	28888743	.	T	A	7	4	11	0	0	12	1	0
20	28888856	.	A	G	7	3	10	0	2	12	0	0
20	28889248	.	G	T	9	8	17	0	1	18	0	0
20	28889306	.	A	G	5	8	13	0	0	13	0	0
20	28897255	.	G	A	3	1	4	0	0	4	0	0
20	28897595	.	A	G	6	12	18	0	1	19	0	0
20	28935620	.	T	A	4	2	6	0	0	6	0	0
20	28973655	.	A	C	4	6	10	0	0	10	0	0
20	28973834	.	T	C	5	7	12	0	0	12	0	0
20	29268260	.	A	G	5	3	8	0	0	8	0	0
20	29269095	.	T	C	12	0	12	0	7	19	0	0
20	29336702	.	A	G	1	2	3	0	0	3	0	0
20	30877864	.	C	T	1	2	3	0	0	3	0	0
20	30878346	.	A	G	1	0	1	0	2	3	0	0
20	30879494	.	G	A	3	2	5	0	0	5	0	0
20	30879843	.	A	C	2	2	4	0	1	5	0	0
20	30879954	.	T	G	1	2	3	0	0	3	0	0
20	30889792	.	T	A	3	3	6	0	0	6	0	0
20	30894333	.	T	C	1	0	1	0	7	8	0	0
20	30894408	.	C	T	3	0	3	0	0	3	0	0
20	30894427	.	C	T	2	1	3	0	1	4	0	0
20	30894496	.	G	T	4	5	9	0	0	9	0	0
20	30894510	.	T	A	4	3	7	0	0	7	0	0
20	30894630	.	A	T	3	4	7	0	0	7	0	0
20	30895007	.	A	G	3	7	10	0	0	10	0	0
20	30895013	.	A	G	2	6	8	0	1	9	0	0
20	30897944	.	G	A	2	7	9	0	1	10	0	0
20	30897948	.	G	T	2	7	9	0	1	10	0	0
20	30899353	.	A	G	2	1	3	0	0	3	0	0
20	30900880	.	A	C	2	0	2	0	2	4	0	0
20	30900928	.	C	G	0	4	4	0	5	9	0	0
20	30900969	.	T	G	2	2	4	0	0	4	0	0
20	30922687	.	G	A	7	7	14	0	1	15	0	0
20	30922688	.	A	T	7	8	15	0	0	15	0	0
20	30922808	.	T	A	5	4	9	0	1	10	0	0
20	30922836	.	C	A	7	5	12	0	0	12	0	0
20	30923101	.	T	C	6	5	11	0	1	12	0	0
20	30925253	.	T	C	1	0	1	0	2	3	0	0
20	30926205	.	T	C	6	3	9	0	0	9	0	0
20	30931021	.	A	T	2	0	2	0	0	2	0	0
20	30931108	.	G	A	5	4	9	0	0	9	0	0
20	30931671	.	G	A	12	8	20	0	0	20	0	0
20	30932277	.	T	C	16	0	16	0	23	39	0	0
20	30936755	.	T	C	2	0	2	0	3	5	0	0
20	30939177	.	T	C	11	9	20	0	3	23	0	0
20	30940566	.	C	G	5	8	13	0	0	13	0	0
20	30947353	.	T	C	21	24	45	0	3	48	0	0
20	30947433	.	T	C	7	8	15	0	3	18	0	0
20	31003145	.	T	C	1	2	3	0	0	3	0	0
20	31003147	.	C	T	1	2	3	0	0	3	0	0
20	31005200	.	T	A	1	1	2	0	0	2	0	0
20	31105619	.	G	A	2	0	2	0	0	2	0	0
20	31147609	.	G	A	3	6	9	0	0	9	0	0
20	31170202	.	G	A	16	7	23	0	1	24	0	0
20	31171010	.	G	A	7	3	10	0	1	11	0	0
20	31172725	.	A	C	3	3	6	0	0	6	0	0
20	31172996	.	C	T	11	7	18	0	0	18	0	0
20	31178425	.	G	T	5	9	14	0	1	15	0	0
20	31181050	.	A	G	10	8	18	0	1	19	0	0
20	31182194	.	G	A	4	1	5	0	0	5	0	0
20	31185594	.	C	A	4	5	9	0	0	9	0	0
20	31186253	.	T	C	3	4	7	0	0	7	0	0
20	31187975	.	G	A	17	16	33	0	1	34	0	0
20	31192304	.	A	C	2	5	7	0	1	8	0	0
20	31192720	.	C	T	12	6	18	0	0	18	0	0
20	31193762	.	G	A	0	3	3	0	5	8	0	0
20	31193826	.	C	T	10	11	21	0	1	22	0	0
20	31197217	.	G	T	15	6	21	0	1	22	0	0
20	31197307	.	G	A	0	10	10	0	5	15	0	0
20	31197465	.	T	C	8	10	18	0	1	19	0	0
20	31199655	.	G	A	1	1	2	0	0	2	0	0
20	31202316	.	C	T	4	5	9	0	0	9	0	0
20	31204173	.	T	C	14	14	28	0	0	28	0	0
20	31204191	.	A	C	14	14	28	0	3	31	0	0
20	31206649	.	A	G	4	1	5	0	0	5	0	0
20	31211701	.	T	A	14	13	27	0	1	28	0	0
20	31211710	.	A	G	16	11	27	0	3	30	0	0
20	31211812	.	G	A	0	4	4	0	13	17	0	0
20	31211846	.	G	A	0	8	8	0	10	18	0	0
20	31212156	.	G	A	0	11	11	0	14	25	0	0
20	31212390	.	G	C	3	11	14	0	1	15	0	0
20	31217572	.	C	G	5	4	9	0	0	9	0	0
20	31217612	.	T	C	2	2	4	0	0	4	0	0
20	31222978	.	T	G	6	0	6	0	9	15	0	0
20	31223282	.	C	T	2	1	3	0	0	3	0	0
20	31223336	.	C	T	3	6	9	0	0	9	0	0
20	31225875	.	C	T	3	2	5	0	0	5	0	0
20	31233329	.	C	T	0	3	3	0	7	10	0	0
20	31233463	.	T	G	5	3	8	0	0	8	0	0
20	31233566	.	T	G	1	5	6	0	0	6	0	0
20	31233623	.	T	C	5	3	8	0	1	9	0	0
20	31233679	.	A	G	3	8	11	0	1	12	0	0
20	31233780	.	T	G	3	1	4	0	1	5	0	0
20	31233837	.	G	C	5	1	6	0	0	6	0	0
20	31252532	.	G	A	0	1	1	0	1	2	0	0
20	31429700	.	T	C	14	4	18	0	1	19	0	0
20	31429701	.	T	C	14	0	14	0	5	19	0	0
20	31429917	.	T	G	3	4	7	0	0	7	0	0
20	31431345	.	C	T	6	4	10	0	0	10	0	0
20	31431457	.	T	A	2	6	8	0	1	9	0	0
20	31431501	.	G	T	3	4	7	0	1	8	0	0
20	31431561	.	A	G	6	2	8	0	2	10	0	0
20	31436387	.	T	C	10	0	10	0	10	20	0	0
20	31436483	.	C	T	7	16	23	0	1	24	0	0
20	31436504	.	T	C	7	0	7	0	13	20	0	0
20	31436984	.	C	T	0	1	1	0	0	1	0	0
20	31442308	.	C	T	0	1	1	0	0	1	0	0
20	31447356	.	A	G	1	1	2	0	1	3	0	0
20	31447455	.	C	T	3	2	5	0	0	5	0	0
20	31451649	.	A	G	1	2	3	0	1	4	0	0
20	31458512	.	C	T	0	1	1	0	0	1	0	0
20	31458514	.	G	A	0	1	1	0	0	1	0	0
20	31743161	.	C	T	1	3	4	0	0	4	0	0
20	31746212	.	T	A	6	7	13	0	3	16	0	0
20	31747695	.	G	C	17	19	36	0	1	37	0	0
20	31747860	.	C	T	0	9	9	0	15	24	0	0
20	31748183	.	C	T	15	12	27	0	3	30	0	0
20	31748448	.	A	G	16	9	25	0	2	27	0	0
20	31748518	.	C	T	9	19	28	0	0	28	0	0
20	31748755	.	G	A	6	6	12	0	1	13	0	0
20	31748765	.	A	G	12	6	18	0	1	19	0	0
20	31748803	.	A	G	17	7	24	0	0	24	0	0
20	31748845	.	A	T	15	8	23	0	0	23	0	0
20	31749118	.	A	G	17	17	34	0	1	35	0	0
20	31769469	.	A	G	11	5	16	0	0	16	0	0
20	31769523	.	T	A	6	7	13	0	0	13	0	0
20	31771899	.	G	A	2	0	2	0	0	2	0	0
20	31777192	.	C	T	0	8	8	0	8	16	0	0
20	31786688	.	T	A	1	4	5	0	0	5	0	0
20	32053122	.	G	A	15	12	27	0	1	28	0	0
20	32061596	.	G	A	6	12	18	0	1	19	0	0
20	32061611	.	C	A	0	9	9	0	6	15	0	0
20	32071494	.	A	G	1	6	7	0	0	7	0	0
20	32098046	.	A	G	10	17	27	0	4	31	0	0
20	32110172	.	T	C	2	0	2	0	2	4	0	0
20	32110331	.	G	A	19	12	31	0	1	32	0	0
20	32110370	.	T	C	12	0	12	0	22	34	0	0
20	32110790	.	T	C	14	6	20	0	1	21	0	0
20	32110898	.	A	T	7	7	14	0	2	16	0	0
20	32118658	.	A	G	14	0	14	0	11	25	0	0
20	32136584	.	T	A	8	10	18	0	0	18	0	0
20	32136588	.	G	T	8	9	17	0	0	17	0	0
20	32136847	.	C	G	5	4	9	0	0	9	0	0
20	32136921	.	G	A	5	7	12	0	1	13	0	0
20	32136953	.	C	T	3	10	13	0	0	13	0	0
20	32137529	.	A	T	10	11	21	0	0	21	0	0
20	32137752	.	G	T	10	15	25	0	2	27	0	0
20	32138171	.	T	C	11	9	20	0	0	20	0	0
20	32138478	.	A	G	11	13	24	0	0	24	0	0
20	32138692	.	G	A	14	9	23	0	1	24	0	0
20	32138723	.	A	G	11	0	11	0	9	20	0	0
20	32138754	.	T	C	10	15	25	0	1	26	0	0
20	32138828	.	C	T	16	13	29	0	2	31	0	0
20	32138965	.	A	T	3	4	7	0	0	7	0	0
20	32138977	.	G	A	0	4	4	0	2	6	0	0
20	32139001	.	G	T	1	2	3	0	0	3	0	0
20	32146960	.	T	C	0	0	0	0	2	2	0	0
20	32146975	.	T	C	0	2	2	0	0	2	0	0
20	32148199	.	C	T	1	1	2	0	0	2	0	0
20	32224485	.	C	A	9	8	17	0	3	20	0	0
20	32224532	.	T	C	4	9	13	0	0	13	0	0
20	32225711	.	G	A	3	2	5	0	0	5	0	0
20	32228863	.	G	A	17	16	33	0	1	34	0	0
20	32228936	.	A	C	10	9	19	0	0	19	0	0
20	32229004	.	G	A	18	24	42	0	1	43	0	0
20	32229053	.	C	T	19	14	33	0	3	36	0	0
20	32229095	.	T	C	18	12	30	0	0	30	0	0
20	32230168	.	T	C	15	17	32	0	1	33	0	0
20	32230301	.	T	C	9	8	17	0	0	17	0	0
20	32230376	.	T	C	9	14	23	0	1	24	0	0
20	32230574	.	T	A	11	16	27	0	3	30	0	0
20	32230592	.	T	A	15	15	30	0	0	30	0	0
20	32230620	.	C	T	12	15	27	0	2	29	0	0
20	32230680	.	A	G	14	10	24	0	0	24	0	0
20	32230720	.	C	G	13	10	23	0	0	23	0	0
20	32230776	.	G	A	11	18	29	0	0	29	0	0
20	32230781	.	G	C	12	19	31	0	0	31	0	0
20	32230836	.	T	C	8	11	19	0	0	19	0	0
20	32286800	.	C	T	1	9	10	0	11	21	0	0
20	32286877	.	A	C	18	17	35	0	2	37	0	0
20	32286923	.	A	T	11	19	30	0	3	33	0	0
20	32286960	.	A	C	17	12	29	0	3	32	0	0
20	32287181	.	C	T	0	8	8	0	10	18	0	0
20	32287317	.	C	T	10	7	17	0	1	18	0	0
20	32287943	.	A	C	8	9	17	0	1	18	0	0
20	32288318	.	T	A	7	9	16	0	0	16	0	0
20	32288372	.	T	C	11	0	11	0	9	20	0	0
20	32290149	.	T	A	11	9	20	0	1	21	0	0
20	32290222	.	G	A	14	9	23	0	0	23	0	0
20	32290435	.	A	G	19	17	36	0	0	36	0	0
20	32330687	.	G	C	6	0	6	0	4	10	0	0
20	32330924	.	T	G	12	10	22	0	0	22	0	0
20	32332298	.	T	C	13	0	13	0	8	21	0	0
20	32332463	.	A	G	3	4	7	0	0	7	0	0
20	32337734	.	A	C	1	3	4	0	1	5	0	0
20	32337918	.	A	C	0	1	1	0	0	1	0	0
20	32339847	.	A	G	2	2	4	0	0	4	0	0
20	32348568	.	C	T	0	2	2	0	0	2	0	0
20	32393289	.	G	C	0	1	1	0	0	1	0	0
20	32403599	.	A	G	3	4	7	0	0	7	0	0
20	32403611	.	C	T	3	2	5	0	0	5	0	0
20	32432315	.	G	T	8	20	28	0	0	28	0	0
20	32432657	.	A	G	5	0	5	0	8	13	0	0
20	32438446	.	A	T	1	3	4	0	1	5	0	0
20	32441025	.	A	T	1	0	1	0	0	1	0	0
20	32484600	.	C	T	4	6	10	0	1	11	0	0
20	32489646	.	T	A	5	2	7	0	0	7	0	0
20	32490004	.	G	T	4	7	11	0	0	11	0	0
20	32490047	.	A	T	6	6	12	0	1	13	0	0
20	32498635	.	C	A	1	3	4	0	0	4	0	0
20	32498639	.	C	A	2	3	5	0	0	5	0	0
20	32498771	.	C	G	3	2	5	0	0	5	0	0
20	32498813	.	A	T	3	2	5	0	0	5	0	0
20	32499166	.	G	A	0	5	5	0	3	8	0	0
20	32499199	.	T	C	1	4	5	0	1	7	1	0
20	32499263	.	T	C	2	2	4	0	0	4	0	0
20	32501840	.	T	G	8	6	14	0	0	14	0	0
20	32510813	.	A	G	1	1	2	0	0	2	0	0
20	32513235	.	G	A	3	6	9	0	0	9	0	0
20	32513256	.	G	A	3	4	7	0	1	8	0	0
20	32520330	.	T	C	17	11	28	0	0	28	0	0
20	32520351	.	A	G	14	0	14	0	13	27	0	0
20	32520365	.	A	G	17	0	17	0	11	28	0	0
20	32520615	.	T	A	7	14	21	0	0	21	0	0
20	32520673	.	A	G	7	10	17	0	1	18	0	0
20	32520815	.	A	G	4	2	6	0	9	15	0	0
20	32520852	.	A	G	3	10	13	0	2	15	0	0
20	32521203	.	C	T	11	12	23	0	0	23	0	0
20	32521377	.	C	T	6	7	13	0	0	13	0	0
20	32521477	.	C	T	8	3	11	0	4	15	0	0
20	32521686	.	A	C	10	16	26	0	2	28	0	0
20	32521719	.	A	C	13	16	29	0	2	31	0	0
20	32521742	.	G	A	15	18	33	0	0	33	0	0
20	32567835	.	G	T	1	3	4	0	0	4	0	0
20	32571781	.	C	T	3	6	9	0	0	9	0	0
20	32571913	.	T	C	5	0	5	0	0	5	0	0
20	32574127	.	A	T	3	1	4	0	0	4	0	0
20	32576667	.	T	C	2	7	9	0	0	9	0	0
20	32757807	.	C	G	12	1	13	0	8	21	0	0
20	32758490	.	A	G	9	16	25	0	0	25	0	0
20	32758558	.	T	C	12	8	20	0	1	21	0	0
20	32838551	.	A	G	1	2	3	0	1	4	0	0
20	32838589	.	A	G	1	3	4	0	0	4	0	0
20	32925890	.	T	C	3	4	7	0	0	7	0	0
20	32935624	.	G	A	5	2	7	0	0	7	0	0
20	32935630	.	A	G	5	2	7	0	0	7	0	0
20	32935676	.	G	T	4	2	6	0	0	6	0	0
20	32935681	.	G	A	3	2	5	0	0	5	0	0
20	32939176	.	T	C	1	2	3	0	0	3	0	0
20	32999053	.	G	C	1	0	1	0	0	1	0	0
20	33007794	.	A	C	1	1	2	0	0	2	0	0
20	33020372	.	C	G	1	3	4	0	0	4	0	0
20	33087945	.	T	C	0	1	1	0	1	2	0	0
20	33140962	.	A	G	1	2	3	0	0	3	0	0
20	33177904	.	C	T	0	1	1	0	0	1	0	0
20	33180295	.	G	A	5	4	9	0	0	9	0	0
20	33180547	.	C	T	5	1	6	0	0	6	0	0
20	33189326	.	T	G	5	0	5	0	12	17	0	0
20	33189631	.	G	A	5	8	13	0	0	13	0	0
20	33297776	.	A	C	4	8	12	0	0	12	0	0
20	33298651	.	G	A	7	13	20	0	0	20	0	0
20	33468040	.	T	G	23	16	39	0	1	40	0	0
20	33471085	.	G	A	3	4	7	0	0	7	0	0
20	33471127	.	A	T	8	5	13	0	0	13	0	0
20	33471166	.	C	T	0	8	8	0	10	18	0	0
20	33471199	.	T	C	7	0	7	0	10	17	0	0
20	33484083	.	G	A	5	6	11	0	0	11	0	0
20	33484387	.	T	C	6	8	14	0	1	15	0	0
20	33484438	.	G	C	4	0	4	0	8	12	0	0
20	33486846	.	G	A	3	6	9	0	1	10	0	0
20	33486989	.	T	C	6	0	6	0	3	9	0	0
20	33487238	.	C	T	4	5	9	0	0	9	0	0
20	33487370	.	T	A	4	5	9	0	0	9	0	0
20	33487374	.	G	T	4	5	9	0	0	9	0	0
20	33487603	.	C	T	9	6	15	0	1	16	0	0
20	33494064	.	A	G	7	11	18	0	2	20	0	0
20	33494436	.	C	T	19	15	34	0	4	38	0	0
20	33668670	.	C	T	0	1	1	0	0	1	0	0
20	33668690	.	T	C	0	1	1	0	0	1	0	0
20	33748921	.	T	A	1	2	3	0	0	3	0	0
20	33759014	.	C	T	2	0	2	0	0	2	0	0
20	33771521	.	G	A	0	2	2	0	0	2	0	0
20	33789729	.	T	C	5	0	5	0	5	10	0	0
20	33789927	.	C	T	0	9	9	0	11	20	0	0
20	33789965	.	G	T	14	15	29	0	1	30	0	0
20	33809783	.	C	A	9	15	24	0	0	24	0	0
20	33809846	.	G	C	8	18	26	0	1	27	0	0
20	33809927	.	T	A	10	12	22	0	0	22	0	0
20	33810496	.	G	A	2	5	7	0	0	7	0	0
20	33810775	.	T	A	6	3	9	0	0	9	0	0
20	33810845	.	C	T	11	6	17	0	0	17	0	0
20	33811230	.	T	A	1	4	5	0	0	5	0	0
20	33811257	.	T	G	2	2	4	0	0	4	0	0
20	33811400	.	A	T	6	4	10	0	0	10	0	0
20	33811435	.	G	A	4	3	7	0	2	9	0	0
20	33811436	.	C	A	6	3	9	0	0	9	0	0
20	33811622	.	A	G	11	13	24	0	0	24	0	0
20	33856416	.	A	T	5	8	13	0	1	14	0	0
20	33856421	.	T	C	5	9	14	0	0	14	0	0
20	33859788	.	A	T	1	3	4	0	0	4	0	0
20	33859869	.	C	T	0	20	20	0	11	32	1	0
20	33862741	.	G	A	2	3	5	0	0	5	0	0
20	33863932	.	T	C	1	0	1	0	0	1	0	0
20	33864772	.	A	G	4	9	13	0	1	14	0	0
20	33994771	.	C	A	1	3	4	0	0	4	0	0
20	33994822	.	C	A	1	2	3	0	0	3	0	0
20	34007589	.	G	C	0	1	1	0	0	1	0	0
20	34008141	.	G	A	0	1	1	0	1	2	0	0
20	34009363	.	G	A	0	1	1	0	0	1	0	0
20	34009947	.	A	G	5	7	12	0	0	12	0	0
20	34009952	.	C	A	5	6	11	0	0	11	0	0
20	34010028	.	A	G	4	6	10	0	0	10	0	0
20	34012916	.	A	T	4	8	12	0	2	14	0	0
20	34015845	.	C	T	8	13	21	0	2	23	0	0
20	34020861	.	T	A	1	1	2	0	0	2	0	0
20	34023551	.	T	C	2	1	3	0	0	3	0	0
20	34028271	.	C	T	1	3	4	0	1	5	0	0
20	34039408	.	A	C	5	3	8	0	0	8	0	0
20	34042070	.	A	G	5	6	11	0	0	11	0	0
20	34042209	.	A	G	1	5	6	0	0	6	0	0
20	34044813	.	G	A	3	11	14	0	1	15	0	0
20	34044845	.	A	T	0	3	3	0	0	3	0	0
20	34049141	.	G	A	2	1	3	0	0	3	0	0
20	34051417	.	G	A	3	6	9	0	0	9	0	0
20	34053787	.	T	A	0	2	2	0	0	2	0	0
20	34054401	.	C	T	0	4	4	0	0	4	0	0
20	34056227	.	C	T	4	4	8	0	0	8	0	0
20	34056656	.	A	G	2	6	8	0	0	8	0	0
20	34057305	.	T	C	4	2	6	0	0	6	0	0
20	34059259	.	C	T	7	4	11	0	0	11	0	0
20	34061117	.	C	T	1	2	3	0	0	3	0	0
20	34061286	.	A	G	2	2	4	0	0	4	0	0
20	34061577	.	A	T	6	3	9	0	0	9	0	0
20	34061784	.	C	T	6	4	10	0	0	10	0	0
20	34061788	.	G	T	6	4	10	0	0	10	0	0
20	34061986	.	G	A	2	3	5	0	0	5	0	0
20	34062631	.	T	G	1	1	2	0	0	2	0	0
20	34063517	.	A	C	2	6	8	0	0	8	0	0
20	34066128	.	G	A	1	0	1	0	0	1	0	0
20	34154118	.	T	C	2	6	8	0	0	8	0	0
20	34155025	.	C	T	8	11	19	0	1	20	0	0
20	34155134	.	G	A	6	5	11	0	0	11	0	0
20	34155339	.	C	A	10	9	19	0	2	21	0	0
20	34155428	.	A	G	16	6	22	0	0	22	0	0
20	34737886	.	T	A	9	5	14	0	1	15	0	0
20	34737944	.	G	C	4	8	12	0	0	12	0	0
20	34738198	.	G	A	21	15	36	0	5	41	0	0
20	34738314	.	G	A	16	19	35	0	3	38	0	0
20	34738397	.	G	T	10	12	22	0	0	22	0	0
20	34738473	.	T	G	9	18	27	0	2	29	0	0
20	34738756	.	A	G	19	15	34	0	0	34	0	0
20	34742840	.	G	A	7	1	8	0	0	8	0	0
20	34745872	.	A	G	6	5	11	0	0	11	0	0
20	34746019	.	G	A	10	11	21	0	1	22	0	0
20	34746842	.	A	G	3	2	5	0	0	5	0	0
20	34747208	.	T	C	2	5	7	0	0	7	0	0
20	34749747	.	G	A	11	11	22	0	0	22	0	0
20	34777607	.	C	T	1	2	3	0	0	3	0	0
20	34780289	.	T	C	2	2	4	0	0	4	0	0
20	34794668	.	T	C	9	3	12	0	2	14	0	0
20	34794939	.	C	T	28	27	55	0	3	58	0	0
20	34795111	.	C	A	35	27	62	0	3	65	0	0
20	34795126	.	A	G	36	30	66	0	2	68	0	0
20	34795296	.	T	C	26	35	61	0	2	63	0	0
20	34795379	.	T	C	38	29	67	0	0	67	0	0
20	34795473	.	C	T	1	27	28	0	33	61	0	0
20	34795689	.	C	T	35	29	64	0	2	66	0	0
20	34797252	.	G	T	34	28	62	0	1	63	0	0
20	34797598	.	A	T	33	29	62	0	3	65	0	0
20	34955791	.	C	T	47	16	63	0	2	65	0	0
20	34956159	.	A	T	24	11	35	0	1	36	0	0
20	34956164	.	T	A	22	13	35	0	2	37	0	0
20	34967476	.	T	C	8	0	8	0	6	14	0	0
20	34969773	.	A	T	4	7	11	0	1	12	0	0
20	34975831	.	G	A	2	2	4	0	0	4	0	0
20	34980452	.	T	C	5	8	13	0	0	13	0	0
20	34982018	.	C	T	0	2	2	0	0	2	0	0
20	34982323	.	T	A	3	8	11	0	0	11	0	0
20	34985184	.	C	T	5	6	11	0	0	11	0	0
20	34985368	.	C	A	1	9	10	0	9	19	0	0
20	34985424	.	T	G	6	14	20	0	1	21	0	0
20	34985462	.	A	G	11	8	19	0	1	20	0	0
20	34985480	.	A	T	10	5	15	0	0	15	0	0
20	34985499	.	A	C	8	5	13	0	0	13	0	0
20	34991739	.	T	A	4	4	8	0	0	8	0	0
20	34991804	.	C	T	0	2	2	0	3	5	0	0
20	35001423	.	G	A	4	3	7	0	1	8	0	0
20	35007466	.	A	G	1	0	1	0	0	1	0	0
20	35011946	.	C	T	2	4	6	0	1	7	0	0
20	35013713	.	A	G	2	2	4	0	0	4	0	0
20	35014533	.	A	G	2	2	4	0	0	4	0	0
20	35017831	.	C	T	1	2	3	0	0	3	0	0
20	35019124	.	A	T	0	3	3	0	0	3	0	0
20	35059085	.	G	A	0	15	15	0	17	32	0	0
20	35064469	.	T	C	14	20	34	0	0	34	0	0
20	35064808	.	C	T	6	1	7	0	0	7	0	0
20	35065345	.	G	A	0	2	2	0	3	5	0	0
20	35065573	.	A	C	6	6	12	0	9	21	0	0
20	35066821	.	G	A	1	9	10	0	17	27	0	0
20	35066935	.	G	A	1	27	28	0	28	56	0	0
20	35068064	.	A	G	15	0	15	0	8	23	0	0
20	35068790	.	A	T	9	9	18	0	0	18	0	0
20	35069063	.	A	C	7	6	13	0	1	14	0	0
20	35069756	.	A	G	10	17	27	0	4	31	0	0
20	35069963	.	A	C	20	16	36	0	0	36	0	0
20	35070176	.	C	T	18	11	29	0	1	30	0	0
20	35070217	.	T	G	22	21	43	0	0	43	0	0
20	35142856	.	A	G	1	2	3	0	0	3	0	0
20	35159500	.	C	A	4	5	9	0	0	9	0	0
20	35159707	.	T	C	1	1	2	0	0	2	0	0
20	35159766	.	C	T	1	1	2	0	0	2	0	0
20	35162012	.	T	G	0	2	2	0	0	2	0	0
20	35164811	.	A	T	4	9	13	0	1	14	0	0
20	35165533	.	G	A	0	1	1	0	0	1	0	0
20	35177501	.	T	C	2	5	7	0	0	7	0	0
20	35183406	.	A	G	1	0	1	0	2	3	0	0
20	35184413	.	T	C	2	1	3	0	0	3	0	0
20	35184419	.	T	C	2	1	3	0	0	3	0	0
20	35188776	.	G	A	5	9	14	0	0	14	0	0
20	35195535	.	A	G	4	5	9	0	0	9	0	0
20	35204702	.	A	C	8	5	13	0	1	14	0	0
20	35204729	.	T	C	6	3	9	0	0	9	0	0
20	35204773	.	C	T	7	8	15	0	0	15	0	0
20	35204814	.	A	G	9	1	10	0	4	14	0	0
20	35204848	.	T	G	5	4	9	0	1	10	0	0
20	35204944	.	G	A	6	6	12	0	1	13	0	0
20	35205061	.	C	T	6	8	14	0	0	14	0	0
20	35205182	.	T	C	0	7	7	0	1	8	0	0
20	35205552	.	T	G	11	0	11	0	4	15	0	0
20	35205600	.	A	T	9	7	16	0	0	16	0	0
20	35205680	.	A	G	10	5	15	0	0	15	0	0
20	35206101	.	A	T	12	9	21	0	0	21	0	0
20	35208046	.	A	G	7	6	13	0	0	13	0	0
20	35209012	.	G	A	2	5	7	0	0	7	0	0
20	35209080	.	T	A	5	4	9	0	0	9	0	0
20	35209201	.	C	T	9	4	13	0	0	13	0	0
20	35209405	.	C	T	16	5	21	0	1	22	0	0
20	35209481	.	G	A	13	11	24	0	1	25	0	0
20	35210175	.	C	A	13	9	22	0	0	22	0	0
20	35210212	.	G	T	6	10	16	0	0	16	0	0
20	35210229	.	A	C	3	7	10	0	1	11	0	0
20	35210282	.	T	C	4	0	4	0	6	10	0	0
20	35210538	.	C	G	2	2	4	0	1	5	0	0
20	35210575	.	C	T	2	4	6	0	0	6	0	0
20	35210649	.	A	G	6	3	9	0	0	9	0	0
20	35210781	.	A	G	4	3	7	0	0	7	0	0
20	35210853	.	A	T	5	5	10	0	0	10	0	0
20	35210909	.	T	C	2	2	4	0	0	4	0	0
20	35211062	.	A	G	3	2	5	0	0	5	0	0
20	35211153	.	A	G	2	3	5	0	0	5	0	0
20	35211399	.	G	A	5	3	8	0	1	9	0	0
20	35211515	.	C	T	0	3	3	0	4	7	0	0
20	35211760	.	G	A	5	8	13	0	0	13	0	0
20	35212366	.	T	C	2	6	8	0	0	8	0	0
20	35212398	.	A	G	3	4	7	0	0	7	0	0
20	35215671	.	C	T	2	1	3	0	0	3	0	0
20	35215680	.	T	G	2	1	3	0	0	3	0	0
20	35226167	.	C	A	1	2	3	0	0	3	0	0
20	35226554	.	T	G	3	3	6	0	0	6	0	0
20	35243721	.	T	C	4	0	4	0	4	8	0	0
20	35280037	.	A	T	0	2	2	0	0	2	0	0
20	35295208	.	C	T	1	1	2	0	0	2	0	0
20	35296980	.	T	C	3	7	10	0	0	10	0	0
20	35297212	.	T	G	0	0	0	0	1	1	0	0
20	35297417	.	T	G	10	12	22	0	0	22	0	0
20	35297693	.	G	A	5	10	15	0	0	15	0	0
20	35297699	.	A	G	6	9	15	0	0	15	0	0
20	35297870	.	T	C	6	4	10	0	0	10	0	0
20	35392100	.	C	T	11	8	19	0	1	20	0	0
20	35427409	.	G	C	34	19	53	0	2	55	0	0
20	35427676	.	T	G	24	0	24	0	33	57	0	0
20	35427745	.	A	G	28	2	30	0	33	63	0	0
20	35427782	.	T	C	30	26	56	0	2	58	0	0
20	35427907	.	C	G	23	25	48	0	1	51	2	0
20	35427946	.	A	G	18	1	19	0	27	46	0	0
20	35428035	.	A	G	34	21	55	0	2	57	0	0
20	35428089	.	A	G	34	16	50	0	1	51	0	0
20	35428128	.	A	T	42	15	57	0	3	60	0	0
20	35428436	.	G	A	37	29	66	0	3	69	0	0
20	35428633	.	T	C	33	33	66	0	4	70	0	0
20	35428802	.	A	G	21	39	60	0	6	66	0	0
20	35429017	.	T	A	31	9	40	0	1	41	0	0
20	35429054	.	A	G	31	2	33	0	38	71	0	0
20	35429610	.	A	T	33	37	70	0	0	70	0	0
20	35433311	.	A	G	19	0	19	0	22	41	0	0
20	35501022	.	G	T	1	2	3	0	0	3	0	0
20	35798043	.	T	A	2	2	4	0	0	4	0	0
20	35798370	.	G	A	13	24	37	0	1	38	0	0
20	35798697	.	A	T	5	8	13	0	0	13	0	0
20	35798973	.	T	A	6	13	19	0	0	19	0	0
20	35799001	.	A	G	7	11	18	0	0	18	0	0
20	35799135	.	G	A	12	10	22	0	0	22	0	0
20	35799175	.	T	C	10	9	19	0	0	19	0	0
20	35799192	.	T	A	14	4	18	0	0	18	0	0
20	35799291	.	G	C	5	6	11	0	1	12	0	0
20	35799534	.	T	C	13	9	22	0	0	22	0	0
20	35799612	.	A	T	10	9	19	0	0	19	0	0
20	35799673	.	T	A	8	11	19	0	0	19	0	0
20	35799729	.	T	A	14	11	25	0	1	26	0	0
20	35799751	.	G	A	15	4	19	0	2	22	1	0
20	35799764	.	T	C	11	0	11	0	8	19	0	0
20	35799889	.	A	T	13	7	20	0	0	20	0	0
20	35799913	.	T	G	10	4	14	0	0	14	0	0
20	35799931	.	A	T	14	1	15	0	1	16	0	0
20	35800032	.	G	A	10	9	19	0	5	24	0	0
20	35800042	.	T	G	5	15	20	0	7	27	0	0
20	35800098	.	G	A	15	23	38	0	0	38	0	0
20	35800338	.	T	G	7	8	15	0	2	17	0	0
20	35800349	.	C	T	7	10	17	0	1	18	0	0
20	35800520	.	G	A	8	14	22	0	0	22	0	0
20	35800557	.	G	A	8	9	17	0	0	17	0	0
20	35800564	.	T	C	8	8	16	0	0	16	0	0
20	35800749	.	G	A	8	5	13	0	2	15	0	0
20	35816533	.	A	G	3	5	8	0	0	8	0	0
20	35816534	.	A	G	3	5	8	0	0	8	0	0
20	35827930	.	A	G	3	4	7	0	2	9	0	0
20	35831719	.	C	T	3	4	7	0	0	7	0	0
20	35841393	.	C	T	6	7	13	0	0	13	0	0
20	35927851	.	A	G	1	1	2	0	0	2	0	0
20	35941146	.	G	A	0	1	1	0	1	2	0	0
20	35979910	.	T	G	1	7	8	0	0	8	0	0
20	35980021	.	C	T	3	3	6	0	0	6	0	0
20	36067796	.	C	T	0	2	2	0	1	3	0	0
20	36067823	.	T	C	3	2	5	0	0	5	0	0
20	36068980	.	G	A	2	2	4	0	1	5	0	0
20	36069388	.	G	A	1	2	3	0	1	4	0	0
20	36069553	.	A	G	2	2	4	0	0	4	0	0
20	36069562	.	A	T	2	2	4	0	0	4	0	0
20	36234084	.	C	A	7	7	14	0	1	15	0	0
20	36290217	.	C	T	9	7	16	0	0	16	0	0
20	36297356	.	G	A	1	16	17	0	14	31	0	0
20	36297418	.	C	A	11	14	25	0	0	25	0	0
20	36297871	.	A	T	6	14	20	0	2	22	0	0
20	36395833	.	T	C	1	3	4	0	0	4	0	0
20	36395895	.	G	A	1	2	3	0	0	3	0	0
20	36403820	.	T	A	2	1	3	0	0	3	0	0
20	36420218	.	A	C	7	13	20	0	0	20	0	0
20	36420713	.	C	T	1	19	20	0	13	33	0	0
20	36420753	.	T	A	8	17	25	0	0	25	0	0
20	36420804	.	G	T	17	9	26	0	0	26	0	0
20	36421219	.	G	A	9	11	20	0	1	21	0	0
20	36421238	.	C	T	7	14	21	0	0	21	0	0
20	36421342	.	G	T	5	0	5	0	9	15	1	0
20	36421530	.	A	C	12	0	12	0	13	25	0	0
20	36421757	.	C	T	0	6	6	0	6	12	0	0
20	36422098	.	C	A	19	14	33	0	1	34	0	0
20	36422146	.	G	C	13	14	27	0	1	28	0	0
20	36422291	.	G	T	7	11	18	0	0	18	0	0
20	36434308	.	A	G	5	10	15	0	0	15	0	0
20	36439858	.	A	C	3	2	5	0	2	7	0	0
20	36440170	.	C	T	0	11	11	0	21	32	0	0
20	36449286	.	G	A	2	1	3	0	0	3	0	0
20	36449385	.	C	T	11	10	21	0	1	22	0	0
20	36449442	.	A	C	11	15	26	0	2	28	0	0
20	36449601	.	C	T	9	8	17	0	0	17	0	0
20	36559761	.	T	G	5	3	8	0	0	8	0	0
20	36623850	.	C	T	9	3	12	0	0	12	0	0
20	36623860	.	T	A	10	6	16	0	0	16	0	0
20	36626195	.	A	G	8	0	8	0	13	21	0	0
20	36626218	.	C	T	9	13	22	0	1	23	0	0
20	36626248	.	G	A	10	15	25	0	1	26	0	0
20	36626335	.	C	T	14	12	26	0	0	26	0	0
20	36626354	.	C	A	17	8	25	0	0	25	0	0
20	36626465	.	C	T	2	3	5	0	0	5	0	0
20	36629281	.	A	G	2	2	4	0	0	4	0	0
20	36637604	.	T	A	3	9	12	0	0	12	0	0
20	36637657	.	A	C	8	4	12	1	0	13	0	0
20	36637999	.	G	A	3	6	9	0	0	9	0	0
20	36638033	.	G	T	4	8	12	0	0	12	0	0
20	36638138	.	C	G	4	3	7	0	0	7	0	0
20	36647133	.	C	T	4	3	7	0	0	7	0	0
20	36647218	.	T	C	1	1	2	0	0	2	0	0
20	36671656	.	T	G	1	0	1	0	0	1	0	0
20	36675294	.	G	C	8	0	8	0	4	12	0	0
20	36675456	.	G	A	5	5	10	0	2	12	0	0
20	36675468	.	C	T	4	6	10	0	1	11	0	0
20	36677457	.	C	T	4	4	8	0	0	8	0	0
20	36677574	.	G	A	1	3	4	0	0	4	0	0
20	36682562	.	G	A	0	2	2	0	0	2	0	0
20	36768736	.	T	C	1	3	4	0	0	4	0	0
20	36773807	.	A	G	6	9	15	0	0	15	0	0
20	36773918	.	A	G	2	0	2	0	10	12	0	0
20	36773984	.	A	G	3	0	3	0	2	5	0	0
20	36783480	.	C	T	2	5	7	0	0	7	0	0
20	36785477	.	G	A	5	3	8	0	1	9	0	0
20	36788775	.	C	T	2	2	4	0	0	4	0	0
20	36791885	.	C	T	7	9	16	0	1	17	0	0
20	36792123	.	T	C	2	4	6	0	0	6	0	0
20	36816471	.	G	A	3	6	9	0	0	9	0	0
20	36816522	.	G	A	4	10	14	0	0	14	0	0
20	36816961	.	A	C	3	6	9	0	0	9	0	0
20	36816972	.	C	T	2	6	8	0	0	8	0	0
20	36817095	.	T	A	1	3	4	0	0	4	0	0
20	36817101	.	A	G	2	3	5	0	0	5	0	0
20	36817184	.	G	A	0	4	4	0	4	8	0	0
20	36821214	.	A	G	1	7	8	0	1	9	0	0
20	36828833	.	T	C	10	6	16	0	0	16	0	0
20	36828948	.	A	C	9	7	16	0	0	16	0	0
20	36829040	.	T	C	2	7	9	0	1	10	0	0
20	36829208	.	T	C	10	8	18	0	0	18	0	0
20	36829517	.	T	G	4	0	4	0	11	15	0	0
20	36838717	.	C	T	5	7	12	0	1	13	0	0
20	36838805	.	C	T	4	5	9	0	0	9	0	0
20	36838871	.	C	T	3	11	14	0	0	14	0	0
20	36838896	.	A	G	4	10	14	0	0	14	0	0
20	36915481	.	G	A	9	6	15	0	2	17	0	0
20	36915529	.	G	A	16	7	23	0	0	23	0	0
20	36916004	.	G	A	12	15	27	0	0	27	0	0
20	36916050	.	A	G	12	11	23	0	0	23	0	0
20	36917631	.	C	T	5	10	15	0	0	15	0	0
20	37913866	.	A	G	5	7	12	0	0	12	0	0
20	37914001	.	A	G	8	5	13	0	0	13	0	0
20	37914025	.	A	G	9	0	9	0	4	13	0	0
20	38538248	.	C	T	1	9	10	0	0	10	0	0
20	39579329	.	A	G	1	2	3	0	0	3	0	0
20	39582056	.	A	T	3	2	5	0	0	5	0	0
20	39689513	.	T	C	3	3	6	0	1	7	0	0
20	39692306	.	G	C	1	3	4	0	0	4	0	0
20	39692392	.	T	G	1	3	4	0	0	4	0	0
20	39692524	.	A	G	1	3	4	0	0	4	0	0
20	39692528	.	G	C	1	3	4	0	0	4	0	0
20	39701769	.	C	T	0	1	1	0	0	1	0	0
20	39713145	.	G	A	2	1	3	0	0	3	0	0
20	39807080	.	G	A	2	2	4	0	0	4	0	0
20	40004883	.	G	A	1	0	1	0	0	1	0	0
20	40119242	.	T	A	4	2	6	0	1	7	0	0
20	40119306	.	C	T	0	2	2	0	1	3	0	0
20	40119353	.	A	T	4	2	6	0	0	6	0	0
20	40119676	.	C	T	2	7	9	0	0	9	0	0
20	40269926	.	T	C	8	1	9	0	19	28	0	0
20	40319575	.	A	C	7	8	15	0	0	15	0	0
20	40319649	.	C	G	5	5	10	0	0	10	0	0
20	40369463	.	C	A	4	4	8	0	0	8	0	0
20	40372729	.	G	A	14	12	26	0	2	28	0	0
20	40372760	.	T	A	13	15	28	0	3	31	0	0
20	40372811	.	A	G	16	19	35	0	1	36	0	0
20	40451106	.	C	T	1	2	3	0	0	3	0	0
20	40457669	.	G	C	9	9	18	0	0	18	0	0
20	40461550	.	G	A	20	26	46	0	4	50	0	0
20	40464613	.	C	G	1	5	6	0	0	6	0	0
20	40466540	.	C	T	16	11	27	0	0	27	0	0
20	40466662	.	C	T	9	12	21	0	2	23	0	0
20	40467044	.	C	T	24	12	36	0	1	37	0	0
20	40471756	.	A	T	37	32	69	0	5	74	0	0
20	40471844	.	C	T	21	21	42	0	2	44	0	0
20	40471866	.	A	T	19	7	26	0	6	33	1	0
20	40471886	.	T	A	17	9	26	0	3	29	0	0
20	40472009	.	T	A	29	28	57	0	2	59	0	0
20	40472075	.	C	A	27	25	52	0	0	53	1	0
20	40472175	.	G	C	32	32	64	0	1	65	0	0
20	40475815	.	C	T	5	9	14	0	0	14	0	0
20	40475872	.	G	A	5	12	17	0	0	17	0	0
20	40476030	.	A	C	6	2	8	0	0	8	0	0
20	40476094	.	G	A	16	3	19	0	1	20	0	0
20	40476165	.	C	T	20	21	41	0	0	41	0	0
20	40476214	.	A	T	21	14	35	0	10	45	0	0
20	40478289	.	A	C	4	1	5	0	0	5	0	0
20	40480227	.	G	T	12	11	23	0	0	23	0	0
20	40480250	.	C	T	10	15	25	0	0	25	0	0
20	40485077	.	T	G	1	0	1	0	0	1	0	0
20	40715260	.	A	G	20	15	35	0	2	37	0	0
20	40716123	.	A	G	0	7	7	0	13	20	0	0
20	40716899	.	G	A	26	19	45	0	0	45	0	0
20	40716911	.	A	G	19	26	45	0	1	46	0	0
20	40717271	.	G	T	13	8	21	0	6	27	0	0
20	40717418	.	G	A	6	8	14	0	0	14	0	0
20	40717691	.	G	A	3	4	7	0	0	7	0	0
20	40762073	.	A	G	3	5	8	0	0	8	0	0
20	40762361	.	T	C	1	3	4	0	1	5	0	0
20	40763990	.	T	C	2	5	7	0	0	7	0	0
20	40764004	.	G	A	2	3	5	0	1	6	0	0
20	40764132	.	G	T	2	6	8	0	1	9	0	0
20	40810988	.	T	C	1	2	3	0	0	3	0	0
20	40812158	.	T	G	1	0	1	0	0	1	0	0
20	40819423	.	C	G	4	1	5	0	0	5	0	0
20	40835131	.	A	G	2	3	5	0	0	5	0	0
20	40840802	.	G	A	6	8	14	0	0	14	0	0
20	40840963	.	A	C	3	5	8	0	0	8	0	0
20	41160499	.	C	T	1	0	1	0	0	1	0	0
20	41219512	.	C	T	1	0	1	0	1	2	0	0
20	41236764	.	G	A	0	10	10	0	5	16	1	0
20	41237086	.	T	A	2	2	4	0	0	4	0	0
20	41237675	.	T	C	1	2	3	0	1	4	0	0
20	41237948	.	A	G	3	2	5	0	1	6	0	0
20	41238104	.	C	T	1	5	6	0	1	7	0	0
20	41239038	.	T	C	3	4	7	0	0	7	0	0
20	41239110	.	G	A	0	2	2	0	1	3	0	0
20	41239439	.	T	C	9	4	13	0	0	13	0	0
20	41239461	.	C	T	10	4	14	0	0	14	0	0
20	41239604	.	C	T	8	8	16	0	0	16	0	0
20	41239624	.	G	A	9	9	18	0	1	19	0	0
20	41239753	.	G	T	0	9	9	0	4	13	0	0
20	41239760	.	G	A	0	10	10	0	4	14	0	0
20	41239838	.	A	G	2	8	10	0	0	10	0	0
20	41239899	.	G	T	6	5	11	0	0	11	0	0
20	41239916	.	A	T	6	5	11	0	0	11	0	0
20	41239946	.	A	G	7	6	13	0	0	13	0	0
20	41239977	.	T	C	3	5	8	0	0	8	0	0
20	41239992	.	T	C	2	5	7	0	0	7	0	0
20	41240107	.	G	C	6	7	13	0	0	13	0	0
20	41240108	.	A	G	6	0	6	0	7	13	0	0
20	41240148	.	A	G	5	0	5	0	10	15	0	0
20	41240480	.	A	G	3	0	3	0	9	12	0	0
20	41240512	.	A	C	7	11	18	0	0	18	0	0
20	41240643	.	G	A	0	6	6	0	3	9	0	0
20	41240736	.	T	C	3	7	10	0	0	10	0	0
20	41240958	.	A	G	8	7	15	0	1	16	0	0
20	41240986	.	A	G	11	0	11	0	8	19	0	0
20	41241316	.	G	C	8	3	11	0	0	11	0	0
20	41241350	.	C	A	11	6	17	0	0	17	0	0
20	41241355	.	C	T	11	6	17	0	0	17	0	0
20	41241443	.	A	C	8	6	14	0	0	14	0	0
20	41242045	.	G	A	0	12	12	0	9	21	0	0
20	41640701	.	A	C	4	4	8	0	0	8	0	0
20	41640743	.	G	A	14	9	23	0	4	27	0	0
20	41640878	.	T	G	8	9	17	0	0	17	0	0
20	41640903	.	T	C	7	10	17	0	0	17	0	0
20	41640917	.	A	G	5	10	15	0	2	17	0	0
20	41641019	.	A	T	9	8	17	0	0	17	0	0
20	41643457	.	C	T	9	14	23	0	0	23	0	0
20	41651639	.	C	T	3	8	11	0	0	11	0	0
20	41655513	.	G	A	0	9	9	0	9	18	0	0
20	41689967	.	A	G	14	18	32	0	0	32	0	0
20	41689979	.	C	T	13	12	25	0	1	26	0	0
20	41734344	.	C	T	5	13	18	0	1	19	0	0
20	41757835	.	A	G	8	15	23	0	1	24	0	0
20	41765105	.	T	C	12	12	24	0	0	24	0	0
20	41838965	.	G	A	0	3	3	0	1	4	0	0
20	41859385	.	C	T	6	2	8	0	0	8	0	0
20	41946745	.	A	G	1	0	1	0	0	1	0	0
20	41949354	.	G	T	0	2	2	0	2	4	0	0
20	41949355	.	C	T	2	2	4	0	0	4	0	0
20	41961113	.	C	T	2	3	5	0	0	5	0	0
20	41961779	.	C	T	4	6	10	0	0	10	0	0
20	41961880	.	G	A	3	0	3	0	0	3	0	0
20	41961909	.	A	T	2	1	3	0	0	3	0	0
20	41962677	.	C	G	3	0	3	0	4	7	0	0
20	41962872	.	A	G	3	4	7	0	1	8	0	0
20	41962923	.	A	T	2	4	6	0	0	7	1	0
20	41963188	.	G	A	0	3	3	0	0	3	0	0
20	41963398	.	T	G	2	2	4	0	0	4	0	0
20	41963451	.	G	A	0	4	4	0	6	10	0	0
20	41963530	.	A	G	8	5	13	0	0	13	0	0
20	41963652	.	C	T	3	3	6	0	0	6	0	0
20	41963660	.	C	T	4	3	7	0	0	7	0	0
20	41998601	.	C	G	15	7	22	0	1	23	0	0
20	41999025	.	C	A	19	8	27	0	0	27	0	0
20	41999046	.	G	A	21	9	30	0	0	30	0	0
20	41999106	.	A	G	11	6	17	0	1	18	0	0
20	42047386	.	C	T	3	0	3	0	0	3	0	0
20	42049122	.	G	A	1	3	4	0	0	4	0	0
20	42049131	.	G	A	0	2	2	0	0	2	0	0
20	42221269	.	T	C	1	5	6	0	0	6	0	0
20	42221360	.	G	A	1	8	9	0	0	9	0	0
20	42221438	.	C	A	2	5	7	0	1	8	0	0
20	42221439	.	A	T	2	6	8	0	0	8	0	0
20	42221710	.	C	T	10	7	17	0	1	18	0	0
20	42222023	.	T	C	4	2	6	0	1	7	0	0
20	42222113	.	A	G	2	5	7	0	1	8	0	0
20	42222480	.	C	T	6	3	9	0	0	9	0	0
20	42222546	.	A	T	2	5	7	0	1	8	0	0
20	42222549	.	A	T	2	7	9	0	0	9	0	0
20	42222770	.	T	C	3	6	9	0	1	10	0	0
20	42222823	.	T	A	5	5	10	0	0	10	0	0
20	42222824	.	A	T	4	5	9	0	1	10	0	0
20	42222883	.	T	C	2	6	8	0	1	9	0	0
20	42223350	.	A	T	5	3	8	0	0	8	0	0
20	42232554	.	A	G	2	2	4	0	0	4	0	0
20	42241224	.	T	G	6	7	13	0	0	13	0	0
20	42241254	.	A	T	3	6	9	0	0	9	0	0
20	42241367	.	C	T	0	5	5	0	6	11	0	0
20	42246990	.	C	T	3	6	9	0	0	9	0	0
20	42247180	.	T	C	5	8	13	0	0	13	0	0
20	42247231	.	G	A	2	2	4	0	0	4	0	0
20	42275414	.	C	T	9	7	16	0	1	17	0	0
20	42278043	.	C	T	9	4	13	0	0	13	0	0
20	42281068	.	C	T	2	7	9	0	0	9	0	0
20	42281408	.	G	A	0	7	7	0	5	12	0	0
20	42296674	.	C	T	1	2	3	0	0	3	0	0
20	42297806	.	T	C	4	2	6	0	0	6	0	0
20	42297875	.	T	C	2	3	5	0	0	5	0	0
20	43120256	.	T	G	6	8	14	0	0	14	0	0
20	43121501	.	T	C	8	0	8	0	6	14	0	0
20	43121503	.	T	C	11	3	14	0	0	14	0	0
20	43122184	.	T	C	3	3	6	0	0	6	0	0
20	44373112	.	T	C	14	10	24	0	0	24	0	0
20	44373117	.	T	C	11	9	20	0	1	21	0	0
20	45406736	.	A	T	11	0	11	0	1	12	0	0
20	45644152	.	G	C	9	2	11	0	0	11	0	0
20	45644163	.	G	T	8	7	15	0	0	15	0	0
20	46746710	.	C	T	2	1	3	0	1	4	0	0
20	47297733	.	T	G	2	1	3	0	3	6	0	0
20	48483184	.	T	A	2	2	4	0	0	4	0	0
20	48483405	.	T	A	3	1	4	0	1	5	0	0
20	48483921	.	C	G	4	8	12	0	0	12	0	0
20	48483989	.	A	T	4	6	10	0	0	10	0	0
20	48484411	.	A	C	9	0	9	0	4	13	0	0
20	48490177	.	A	G	0	1	1	0	2	3	0	0
20	48598493	.	C	T	0	2	2	0	0	2	0	0
20	48785457	.	T	C	2	2	4	0	0	4	0	0
20	48844050	.	T	C	4	0	4	0	3	7	0	0
20	48844134	.	A	G	2	6	8	0	1	9	0	0
20	48860755	.	G	A	6	3	9	0	0	9	0	0
20	48869895	.	G	A	4	3	7	0	0	7	0	0
20	48877311	.	G	T	1	1	2	0	0	2	0	0
20	48877475	.	G	A	2	4	6	0	1	7	0	0
20	48886005	.	C	T	0	1	1	0	0	1	0	0
20	48895103	.	G	A	2	2	4	0	1	5	0	0
20	49082581	.	C	T	2	5	7	0	0	7	0	0
20	49085648	.	G	A	3	5	8	0	0	8	0	0
20	49087816	.	G	T	1	2	3	0	0	3	0	0
20	49089192	.	T	C	1	5	6	0	0	6	0	0
20	49089237	.	C	T	1	5	6	0	0	6	0	0
20	49094970	.	C	T	1	1	2	0	0	2	0	0
20	49094973	.	T	C	1	1	2	0	0	2	0	0
20	49099900	.	A	G	4	2	6	0	0	6	0	0
20	49100237	.	C	T	6	2	8	0	2	10	0	0
20	49103131	.	G	A	7	7	14	0	1	15	0	0
20	49103164	.	G	A	7	7	14	0	0	14	0	0
20	49103217	.	A	T	5	3	8	0	0	8	0	0
20	49105469	.	A	T	2	2	4	0	1	5	0	0
20	49787832	.	A	G	4	1	5	0	2	7	0	0
20	49787847	.	C	T	4	2	6	0	1	7	0	0
20	49788219	.	G	A	0	3	3	0	1	4	0	0
20	49788228	.	C	G	1	2	3	0	0	3	0	0
20	49797899	.	C	A	0	2	2	0	0	2	0	0
20	49804501	.	C	T	3	1	4	0	0	4	0	0
20	49916653	.	T	C	3	6	9	0	1	10	0	0
20	49928358	.	A	T	6	2	8	0	0	8	0	0
20	49940969	.	G	T	11	4	15	0	1	16	0	0
20	49952738	.	A	G	7	6	13	0	0	13	0	0
20	49960314	.	A	G	12	3	15	0	0	15	0	0
20	49961268	.	G	T	3	3	6	0	1	7	0	0
20	50015754	.	C	T	4	2	6	0	0	6	0	0
20	50037402	.	T	G	4	0	4	0	4	8	0	0
20	50041707	.	A	G	2	2	4	0	0	4	0	0
20	50049036	.	G	C	35	1	36	0	22	58	0	0
20	50049078	.	C	A	18	7	25	0	1	26	0	0
20	50057348	.	C	T	2	1	3	0	0	3	0	0
20	50074077	.	C	T	0	2	2	0	0	2	0	0
20	50074173	.	C	T	10	9	19	0	0	19	0	0
20	50074212	.	C	T	5	6	11	0	1	12	0	0
20	50076480	.	G	A	1	6	7	0	3	10	0	0
20	50079067	.	T	C	6	3	9	0	0	9	0	0
20	50079070	.	A	G	6	4	10	0	0	10	0	0
20	50082425	.	A	G	5	6	11	0	1	12	0	0
20	50082861	.	T	C	3	4	7	0	0	7	0	0
20	50085935	.	T	A	1	3	4	0	0	4	0	0
20	50725479	.	G	A	0	3	3	0	1	4	0	0
20	50740230	.	G	T	0	5	5	0	3	8	0	0
20	50898883	.	T	C	1	1	2	0	0	2	0	0
20	50917646	.	T	C	2	0	2	0	0	2	0	0
20	50923848	.	G	A	9	8	17	0	2	19	0	0
20	50926695	.	G	A	0	3	3	0	10	13	0	0
20	50989199	.	A	G	10	0	10	0	7	17	0	0
20	50999024	.	C	G	20	24	44	0	1	45	0	0
20	50999297	.	C	A	4	5	9	0	1	10	0	0
20	50999311	.	T	C	0	4	4	0	0	4	0	0
20	51069864	.	A	G	8	1	9	0	8	17	0	0
20	51069996	.	T	C	5	5	10	0	2	12	0	0
20	51073369	.	A	T	9	2	11	0	0	11	0	0
20	51073449	.	G	A	0	8	8	0	12	20	0	0
20	51073670	.	A	T	4	5	9	0	0	9	0	0
20	51073692	.	G	A	8	8	16	0	0	16	0	0
20	51073730	.	G	A	10	9	19	0	2	21	0	0
20	51074209	.	G	T	1	1	2	0	0	2	0	0
20	51074291	.	A	G	2	0	2	0	5	7	0	0
20	51074317	.	C	T	1	3	4	0	2	6	0	0
20	51074352	.	A	T	3	5	8	0	1	9	0	0
20	51074463	.	T	C	4	2	6	0	0	6	0	0
20	51076204	.	C	T	0	3	3	0	0	3	0	0
20	51076206	.	C	T	0	3	3	0	0	3	0	0
20	51077597	.	T	C	1	2	3	0	0	3	0	0
20	51088802	.	A	T	30	28	58	0	0	58	0	0
20	51089054	.	T	C	15	30	45	0	1	46	0	0
20	51089236	.	T	C	16	0	16	0	23	39	0	0
20	51089243	.	T	C	14	29	43	0	0	43	0	0
20	51100498	.	T	C	12	9	21	0	2	23	0	0
20	51100562	.	A	G	29	16	45	0	1	46	0	0
20	51112184	.	C	T	1	4	5	0	1	6	0	0
20	51112208	.	C	T	12	6	18	0	0	18	0	0
20	51117661	.	A	C	10	6	16	0	0	16	0	0
20	51117664	.	G	A	6	10	16	0	0	16	0	0
20	51118227	.	A	G	7	0	7	0	10	17	0	0
20	51118281	.	C	A	27	23	50	0	2	52	0	0
20	51118314	.	T	C	13	12	25	0	0	25	0	0
20	51122939	.	C	T	10	13	23	0	2	25	0	0
20	51123088	.	C	T	14	10	24	0	0	24	0	0
20	51123109	.	G	C	14	7	21	0	1	22	0	0
20	51123229	.	C	T	4	2	6	0	0	6	0	0
20	51132127	.	C	G	9	7	16	0	0	16	0	0
20	51132284	.	A	G	24	12	36	0	4	40	0	0
20	51141284	.	C	T	1	11	12	0	13	25	0	0
20	51146152	.	T	G	11	6	17	0	1	18	0	0
20	51146153	.	G	A	7	10	17	0	1	18	0	0
20	51146194	.	A	G	6	3	9	0	1	10	0	0
20	51150029	.	G	T	4	6	10	0	0	10	0	0
20	51151647	.	G	A	1	1	2	0	0	2	0	0
20	51157010	.	T	G	4	3	7	0	0	7	0	0
20	51157061	.	C	T	0	6	6	0	14	20	0	0
20	51157082	.	T	C	15	5	20	0	0	20	0	0
20	51157109	.	C	T	7	19	26	0	0	26	0	0
20	51157204	.	G	A	4	14	18	0	0	18	0	0
20	51168502	.	T	C	10	5	15	0	0	15	0	0
20	51200015	.	C	T	30	27	57	0	4	61	0	0
20	51204759	.	C	T	15	17	32	0	3	35	0	0
20	51205691	.	T	G	12	12	24	0	0	24	0	0
20	51205745	.	G	A	50	34	84	0	2	86	0	0
20	51206976	.	C	A	29	40	69	0	4	73	0	0
20	51207030	.	C	T	29	36	65	0	4	69	0	0
20	51207051	.	G	A	34	36	70	0	1	71	0	0
20	51207609	.	C	A	1	5	6	0	1	7	0	0
20	51207672	.	C	T	32	42	74	0	1	75	0	0
20	51207726	.	C	T	49	35	84	0	3	87	0	0
20	51211455	.	G	A	8	29	37	0	29	66	0	0
20	51239329	.	A	G	6	3	9	0	0	9	0	0
20	51240121	.	C	G	0	2	2	0	1	3	0	0
20	51274693	.	C	T	3	1	4	0	1	5	0	0
20	51313049	.	C	T	4	4	8	0	0	8	0	0
20	51332530	.	C	T	1	2	3	0	0	3	0	0
20	51332686	.	C	T	4	4	8	0	0	8	0	0
20	51333118	.	A	T	2	3	5	0	0	5	0	0
20	51333238	.	T	C	3	3	6	0	0	6	0	0
20	51333410	.	T	C	2	2	4	0	0	4	0	0
20	51333698	.	A	C	3	3	6	0	0	6	0	0
20	51334173	.	G	T	5	2	7	0	0	7	0	0
20	51363902	.	C	T	0	8	8	0	2	10	0	0
20	51363926	.	A	T	2	8	10	0	0	10	0	0
20	51370329	.	C	T	10	12	22	0	1	23	0	0
20	51377075	.	C	T	2	1	3	0	2	5	0	0
20	51383472	.	G	A	3	5	8	0	2	10	0	0
20	51383706	.	C	T	0	10	10	0	7	17	0	0
20	51383804	.	C	G	6	4	10	0	0	10	0	0
20	51384072	.	C	T	1	0	1	0	0	1	0	0
20	51489485	.	A	C	1	4	5	0	0	5	0	0
20	51492709	.	A	G	1	1	2	0	0	2	0	0
20	51647988	.	A	T	6	5	11	0	1	12	0	0
20	51648072	.	A	G	5	6	11	0	0	11	0	0
20	51648156	.	T	C	3	5	8	0	0	8	0	0
20	51648662	.	C	T	3	2	5	0	0	5	0	0
20	51648683	.	G	T	3	0	3	0	2	5	0	0
20	51649884	.	C	G	0	4	4	0	4	8	0	0
20	51649887	.	A	G	4	4	8	0	0	8	0	0
20	51649935	.	G	A	3	3	6	0	0	6	0	0
20	51703406	.	T	C	6	9	15	0	1	16	0	0
20	51703939	.	G	A	17	11	28	0	0	28	0	0
20	51704001	.	C	T	3	0	3	0	0	3	0	0
20	51720465	.	A	G	3	0	3	0	0	3	0	0
20	51723187	.	G	T	5	7	12	0	0	12	0	0
20	51730662	.	T	G	2	2	4	0	0	4	0	0
20	51743891	.	T	C	2	0	2	0	0	2	0	0
20	51753384	.	A	T	8	9	17	0	0	17	0	0
20	51753509	.	G	A	0	5	5	0	5	10	0	0
20	51753562	.	C	T	1	6	7	0	1	8	0	0
20	51753617	.	C	G	5	3	8	0	0	8	0	0
20	51758602	.	A	C	8	8	16	0	2	18	0	0
20	51758975	.	A	G	10	9	19	0	0	19	0	0
20	51759191	.	A	C	7	9	16	0	0	16	0	0
20	51759272	.	G	A	5	8	13	0	0	13	0	0
20	51759273	.	T	A	5	8	13	0	0	13	0	0
20	51787380	.	A	G	6	0	6	0	0	6	0	0
20	51794071	.	A	G	2	1	3	0	0	3	0	0
20	51798112	.	T	C	1	2	3	0	1	4	0	0
20	51799052	.	G	A	0	2	2	0	0	2	0	0
20	51803856	.	G	T	1	7	8	0	0	8	0	0
20	51807449	.	C	T	0	3	3	0	4	7	0	0
20	51813790	.	A	G	1	2	3	0	0	3	0	0
20	51819309	.	C	G	0	1	1	0	0	1	0	0
20	51821286	.	G	T	1	2	3	0	0	3	0	0
20	51821380	.	T	C	1	3	4	0	0	4	0	0
20	51822177	.	A	G	2	2	4	0	0	4	0	0
20	51822648	.	T	C	1	3	4	0	0	4	0	0
20	52199177	.	G	A	0	2	2	0	0	2	0	0
20	52333008	.	C	T	5	2	7	0	0	7	0	0
20	52333009	.	A	T	5	2	7	0	0	7	0	0
20	52333052	.	A	G	4	2	6	0	0	6	0	0
20	52333070	.	A	G	1	3	4	0	0	4	0	0
20	52333177	.	T	C	4	0	4	0	10	14	0	0
20	52333202	.	T	C	5	11	16	0	0	16	0	0
20	52333344	.	A	G	4	4	8	0	1	9	0	0
20	52333388	.	A	G	3	7	10	0	1	11	0	0
20	52390235	.	C	G	3	0	3	0	6	9	0	0
20	52390271	.	T	C	1	3	4	0	1	5	0	0
20	52404347	.	G	A	3	4	7	0	0	7	0	0
20	52404387	.	T	A	2	2	4	0	1	5	0	0
20	52404398	.	T	C	2	3	5	0	0	5	0	0
20	52404578	.	C	T	2	7	9	0	1	10	0	0
20	52404722	.	T	C	2	5	7	0	0	7	0	0
20	52404935	.	T	A	1	3	4	0	0	4	0	0
20	52415876	.	T	C	2	7	9	0	0	9	0	0
20	52415935	.	C	G	1	6	7	0	0	7	0	0
20	52416020	.	C	A	6	9	15	0	0	15	0	0
20	52416107	.	C	T	3	0	3	0	0	3	0	0
20	52420015	.	T	G	2	0	2	0	11	13	0	0
20	52458788	.	C	G	2	7	9	0	0	9	0	0
20	52458831	.	A	T	2	3	5	0	0	5	0	0
20	52458987	.	G	T	0	4	4	0	2	6	0	0
20	52473266	.	C	T	2	4	6	0	0	6	0	0
20	52482448	.	G	A	2	5	7	0	1	8	0	0
20	52482484	.	T	C	1	2	3	0	0	3	0	0
20	52487851	.	C	T	1	2	3	0	0	3	0	0
20	52488226	.	A	T	1	5	6	0	1	7	0	0
20	52540601	.	G	A	0	5	5	0	3	8	0	0
20	52540721	.	A	G	5	6	11	0	0	11	0	0
20	52540928	.	C	T	6	3	9	0	2	11	0	0
20	52540992	.	G	A	6	2	8	0	1	9	0	0
20	52541014	.	C	A	5	2	7	0	0	7	0	0
20	52541276	.	A	G	1	1	2	0	1	3	0	0
20	52541291	.	A	G	2	0	2	0	3	5	0	0
20	52541325	.	T	A	1	1	2	0	2	4	0	0
20	52544394	.	G	T	0	4	4	0	1	5	0	0
20	52544491	.	A	C	4	6	10	0	0	10	0	0
20	52544559	.	T	C	6	9	15	0	0	15	0	0
20	52544612	.	G	T	5	3	8	0	0	8	0	0
20	52554222	.	G	A	12	21	33	0	0	33	0	0
20	52554283	.	C	T	11	17	28	0	0	28	0	0
20	52574813	.	G	A	0	19	19	0	18	37	0	0
20	52574900	.	G	A	1	30	31	0	27	58	0	0
20	52575020	.	A	G	24	3	27	0	21	48	0	0
20	52575377	.	T	C	20	10	30	0	2	32	0	0
20	52582594	.	A	T	9	5	14	0	0	14	0	0
20	53279543	.	C	T	1	3	4	0	0	4	0	0
20	53312604	.	G	T	10	9	19	0	6	25	0	0
20	53318814	.	G	T	4	10	14	0	0	14	0	0
20	53318884	.	C	T	0	3	3	0	1	4	0	0
20	53365862	.	C	T	5	5	10	0	0	10	0	0
20	53366073	.	A	C	5	6	11	0	1	12	0	0
20	53377661	.	A	G	1	0	1	0	1	2	0	0
20	53377691	.	G	A	1	1	2	0	0	2	0	0
20	53378919	.	T	G	1	0	1	0	3	4	0	0
20	53393594	.	T	C	4	1	5	0	0	5	0	0
20	53393669	.	C	A	5	4	9	0	2	11	0	0
20	53398784	.	T	A	7	6	13	0	0	13	0	0
20	53401771	.	T	C	9	5	14	0	1	15	0	0
20	53401778	.	A	G	10	4	14	0	1	15	0	0
20	53480029	.	T	C	1	1	2	0	0	2	0	0
20	53600801	.	T	C	2	4	6	0	0	6	0	0
20	53601313	.	C	T	2	3	5	0	0	5	0	0
20	53601323	.	T	C	3	4	7	0	0	7	0	0
20	53601437	.	C	T	0	2	2	0	4	6	0	0
20	53601461	.	T	C	4	0	4	0	3	7	0	0
20	53601590	.	G	A	1	3	4	0	1	5	0	0
20	53601608	.	C	T	2	3	5	0	0	5	0	0
20	53635042	.	T	C	0	2	2	0	0	2	0	0
20	53637686	.	G	A	2	8	10	0	0	10	0	0
20	53637818	.	C	T	0	1	1	0	0	1	0	0
20	53639152	.	C	T	1	4	5	0	1	6	0	0
20	53639358	.	C	T	4	3	7	0	1	8	0	0
20	53639391	.	C	G	1	5	6	0	0	6	0	0
20	53639876	.	T	C	1	2	3	0	1	4	0	0
20	53639980	.	C	T	5	2	7	0	0	7	0	0
20	53640199	.	A	T	1	0	1	0	0	1	0	0
20	53640200	.	T	C	1	0	1	0	0	1	0	0
20	53803637	.	C	T	11	13	24	0	1	25	0	0
20	53803783	.	T	A	8	14	22	0	1	23	0	0
20	53804306	.	A	G	9	7	16	0	0	16	0	0
20	53804342	.	A	G	14	10	24	0	0	24	0	0
20	53804439	.	A	G	9	11	20	0	0	20	0	0
20	53804470	.	G	A	9	9	18	0	1	19	0	0
20	53804618	.	G	C	7	3	10	0	0	10	0	0
20	53810197	.	A	T	17	12	29	0	0	29	0	0
20	53898735	.	T	A	16	13	29	0	2	31	0	0
20	53898770	.	C	T	0	19	19	0	12	31	0	0
20	53898930	.	G	A	3	17	20	0	0	20	0	0
20	53899023	.	G	C	9	27	36	0	1	37	0	0
20	53899035	.	G	A	9	25	34	0	1	35	0	0
20	53900860	.	C	T	4	2	6	0	1	7	0	0
20	53901183	.	A	G	2	4	6	0	0	6	0	0
20	53902151	.	G	A	3	6	9	0	0	9	0	0
20	53902155	.	G	C	3	6	9	0	0	9	0	0
20	53906381	.	T	C	1	6	7	0	0	7	0	0
20	53912151	.	T	C	4	0	4	0	16	20	0	0
20	53912208	.	C	T	0	7	7	0	4	11	0	0
20	53921147	.	T	C	3	2	5	0	0	5	0	0
20	53928363	.	T	C	0	0	0	0	2	2	0	0
20	53930457	.	G	A	0	7	7	0	0	7	0	0
20	53930466	.	C	T	0	5	5	0	0	5	0	0
20	53949741	.	A	G	4	8	12	0	0	12	0	0
20	53968105	.	A	G	28	26	54	0	2	56	0	0
20	54048057	.	C	T	1	3	4	0	0	4	0	0
20	54048078	.	T	C	1	3	4	0	0	4	0	0
20	54048330	.	G	A	1	2	3	0	0	3	0	0
20	54050670	.	A	G	2	2	4	0	1	5	0	0
20	54050873	.	A	G	2	3	5	0	1	6	0	0
20	54050877	.	T	A	2	2	4	0	1	5	0	0
20	54051059	.	C	T	3	2	5	0	0	5	0	0
20	54051096	.	T	G	3	0	3	0	1	4	0	0
20	54067345	.	A	G	8	5	13	0	1	14	0	0
20	54067399	.	G	A	5	6	11	0	1	12	0	0
20	54067414	.	G	A	4	8	12	0	1	13	0	0
20	54067714	.	A	G	10	15	25	0	1	26	0	0
20	54067894	.	G	A	6	4	10	0	1	11	0	0
20	54085851	.	T	C	9	5	14	0	0	14	0	0
20	54175011	.	A	G	1	2	3	0	0	3	0	0
20	54175383	.	A	C	1	0	1	0	4	5	0	0
20	54175443	.	C	T	2	2	4	0	0	4	0	0
20	54175527	.	A	G	1	2	3	0	0	3	0	0
20	54196615	.	C	T	1	2	3	0	0	3	0	0
20	54197221	.	A	C	18	0	18	0	15	33	0	0
20	54197287	.	A	T	14	28	42	0	1	43	0	0
20	54197383	.	G	A	15	16	31	0	0	31	0	0
20	54197473	.	A	G	13	18	31	0	1	32	0	0
20	54197485	.	C	T	0	17	17	0	12	29	0	0
20	54197751	.	A	G	11	13	24	0	1	25	0	0
20	54197752	.	G	A	11	12	23	0	2	25	0	0
20	54205704	.	C	T	8	6	14	0	2	16	0	0
20	54215073	.	C	A	5	8	13	0	0	13	0	0
20	54215081	.	T	C	4	1	5	0	10	15	0	0
20	54215133	.	A	C	7	16	23	0	1	24	0	0
20	54219286	.	T	C	3	0	3	0	2	5	0	0
20	54228003	.	A	T	14	13	27	0	2	29	0	0
20	54233207	.	T	C	2	0	2	0	3	5	0	0
20	54235969	.	G	A	9	9	18	0	3	21	0	0
20	54236421	.	A	C	3	1	4	0	0	4	0	0
20	54236423	.	G	A	3	1	4	0	0	4	0	0
20	54249577	.	G	C	11	4	15	0	1	16	0	0
20	54251406	.	T	C	6	3	9	0	0	9	0	0
20	54274561	.	G	A	10	7	17	0	2	19	0	0
20	54277241	.	A	C	0	1	1	0	0	1	0	0
20	54278129	.	T	A	2	2	4	0	0	4	0	0
20	54283833	.	T	C	6	4	10	0	1	11	0	0
20	54284869	.	A	G	9	0	9	0	9	18	0	0
20	54284986	.	A	G	18	22	40	0	2	42	0	0
20	54285758	.	T	C	10	25	35	0	3	38	0	0
20	54285799	.	C	T	11	23	34	0	0	34	0	0
20	54285804	.	C	T	13	25	38	0	1	39	0	0
20	54285853	.	A	T	17	16	33	0	2	35	0	0
20	54286016	.	G	A	19	13	32	0	1	33	0	0
20	54286097	.	A	T	26	11	37	0	0	37	0	0
20	54286454	.	C	A	8	12	20	0	0	20	0	0
20	54286666	.	C	T	13	17	30	0	1	31	0	0
20	54286682	.	G	A	12	14	26	0	4	30	0	0
20	54286797	.	G	T	9	2	11	0	1	12	0	0
20	54286798	.	A	G	9	3	12	0	0	12	0	0
20	54334478	.	C	T	6	9	15	0	2	17	0	0
20	54339998	.	C	T	6	6	12	0	0	12	0	0
20	54340018	.	G	C	4	3	7	0	0	7	0	0
20	54340285	.	C	T	13	8	21	0	0	21	0	0
20	54340700	.	T	C	3	4	7	0	0	7	0	0
20	54341019	.	A	G	5	5	10	0	0	10	0	0
20	54341082	.	A	C	5	11	16	0	1	17	0	0
20	54341108	.	G	T	0	11	11	0	5	16	0	0
20	54341130	.	C	T	3	7	10	0	1	11	0	0
20	54341154	.	A	G	3	3	6	0	0	6	0	0
20	54341203	.	T	A	5	6	11	0	0	11	0	0
20	54342227	.	A	C	3	3	6	0	1	7	0	0
20	54342530	.	G	T	4	2	6	0	1	7	0	0
20	54342589	.	A	T	7	7	14	0	1	15	0	0
20	54342674	.	T	C	4	2	6	0	0	6	0	0
20	54342715	.	C	T	5	2	7	0	0	7	0	0
20	54343566	.	G	C	0	7	7	0	10	17	0	0
20	54343682	.	T	C	8	8	16	0	0	16	0	0
20	54343695	.	A	T	10	10	20	0	1	21	0	0
20	54343866	.	G	A	8	5	13	0	0	13	0	0
20	54343928	.	A	G	8	6	14	0	0	14	0	0
20	54344711	.	A	G	8	1	9	0	11	20	0	0
20	54344748	.	T	C	5	13	18	0	1	19	0	0
20	54344795	.	G	A	8	6	14	0	1	15	0	0
20	54344815	.	G	T	10	3	13	0	2	15	0	0
20	54344910	.	C	T	7	3	10	0	0	10	0	0
20	54345226	.	C	T	2	2	4	0	0	4	0	0
20	54345955	.	A	T	15	8	23	0	1	24	0	0
20	54345979	.	A	G	17	9	26	0	0	26	0	0
20	54346012	.	G	C	1	5	6	0	18	26	2	0
20	54346159	.	G	T	0	6	6	0	11	17	0	0
20	54346178	.	G	T	13	10	23	0	1	24	0	0
20	54346239	.	A	G	12	7	19	0	1	20	0	0
20	54356452	.	G	C	7	8	15	0	0	15	0	0
20	54357955	.	C	T	4	6	10	0	1	11	0	0
20	54358656	.	T	C	4	2	6	0	0	6	0	0
20	54360143	.	G	A	3	3	6	0	0	6	0	0
20	54360148	.	G	T	0	3	3	0	3	6	0	0
20	54397812	.	T	C	3	10	13	0	1	14	0	0
20	54397846	.	A	G	7	1	8	0	13	21	0	0
20	54397897	.	G	C	10	12	22	0	2	24	0	0
20	54398242	.	C	T	4	14	18	0	0	18	0	0
20	54398380	.	T	A	12	7	19	0	0	19	0	0
20	54398443	.	A	G	9	13	22	0	0	22	0	0
20	54402157	.	G	T	0	14	14	0	12	26	0	0
20	54402346	.	G	A	13	13	26	0	0	26	0	0
20	54402489	.	G	A	22	11	33	0	0	33	0	0
20	54406699	.	A	T	14	14	28	0	1	29	0	0
20	54406813	.	A	G	11	9	20	0	0	20	0	0
20	54407401	.	G	C	16	13	29	0	3	32	0	0
20	54407456	.	T	C	14	9	23	0	0	23	0	0
20	54407556	.	C	T	7	7	14	0	0	14	0	0
20	54422636	.	G	A	13	14	27	0	1	28	0	0
20	54422909	.	C	T	14	15	29	0	0	29	0	0
20	54422929	.	G	A	9	16	25	0	0	25	0	0
20	54423005	.	T	C	10	10	20	0	0	20	0	0
20	54423027	.	C	G	11	9	20	0	0	20	0	0
20	54428696	.	A	G	2	3	5	0	0	5	0	0
20	54432835	.	T	C	9	0	9	0	18	27	0	0
20	54432855	.	T	C	8	0	8	0	12	20	0	0
20	54434895	.	G	A	11	18	29	0	3	32	0	0
20	54434918	.	C	T	12	20	32	0	4	36	0	0
20	54446877	.	G	A	12	13	25	0	1	26	0	0
20	54462151	.	G	C	4	7	11	0	0	11	0	0
20	54522615	.	G	C	2	2	4	0	0	4	0	0
20	54525439	.	T	C	2	3	5	0	0	5	0	0
20	54563425	.	A	G	8	12	20	0	0	20	0	0
20	54563866	.	C	A	4	3	7	0	0	7	0	0
20	54563995	.	G	A	11	3	14	0	0	14	0	0
20	54563998	.	G	C	10	4	14	0	0	14	0	0
20	54670746	.	T	C	0	1	1	0	0	1	0	0
20	54670770	.	T	G	1	3	4	0	0	4	0	0
20	54670966	.	A	G	4	3	7	0	0	7	0	0
20	54670984	.	T	A	4	2	6	0	0	6	0	0
20	54671032	.	A	C	9	3	12	0	0	12	0	0
20	54671864	.	T	G	2	3	5	0	0	5	0	0
20	54671894	.	A	C	1	3	4	0	1	5	0	0
20	54672839	.	A	G	5	0	5	0	5	10	0	0
20	54672869	.	T	C	7	7	14	0	0	14	0	0
20	54672891	.	T	C	6	7	13	0	0	13	0	0
20	54672974	.	G	A	0	6	6	0	10	16	0	0
20	54673175	.	T	C	8	2	10	0	0	10	0	0
20	54673198	.	T	A	8	4	12	0	0	12	0	0
20	54675294	.	T	C	4	5	9	0	0	9	0	0
20	54675308	.	C	G	5	1	6	0	5	11	0	0
20	54675356	.	C	T	10	5	15	0	0	15	0	0
20	54675391	.	T	C	8	7	15	0	0	15	0	0
20	54676529	.	A	G	6	0	6	0	8	14	0	0
20	54676532	.	T	G	5	9	14	0	1	15	0	0
20	54676583	.	C	T	4	2	6	0	0	6	0	0
20	54681734	.	G	A	5	6	11	0	0	11	0	0
20	54681797	.	T	A	4	7	11	0	0	11	0	0
20	54681944	.	A	T	8	3	11	0	0	11	0	0
20	54698791	.	C	T	6	7	13	0	1	14	0	0
20	54699133	.	C	T	9	10	19	0	2	21	0	0
20	54708193	.	T	C	10	10	20	0	1	21	0	0
20	54708277	.	G	A	0	5	5	0	9	14	0	0
20	54711535	.	G	C	5	5	10	0	0	10	0	0
20	54738249	.	C	G	5	4	9	0	0	9	0	0
20	54740904	.	G	A	14	13	27	0	2	29	0	0
20	54740907	.	A	G	14	2	16	0	14	30	0	0
20	54740955	.	C	T	10	8	18	0	2	20	0	0
20	54740976	.	G	T	1	10	11	0	7	18	0	0
20	54741763	.	G	A	3	8	11	0	0	11	0	0
20	54742641	.	C	G	8	11	19	0	2	21	0	0
20	54742714	.	C	T	14	8	22	0	1	23	0	0
20	54742750	.	A	G	13	0	13	0	7	20	0	0
20	54742765	.	A	C	11	7	18	0	1	19	0	0
20	54742912	.	A	C	10	10	20	0	1	21	0	0
20	54743565	.	T	C	15	9	24	3	1	28	0	0
20	54743851	.	T	G	24	12	36	0	0	36	0	0
20	54743917	.	G	A	18	9	27	0	2	29	0	0
20	54743937	.	C	T	15	9	24	0	1	25	0	0
20	54744230	.	C	T	14	14	28	0	2	30	0	0
20	54744314	.	A	G	11	0	11	0	20	31	0	0
20	54744363	.	A	G	17	1	18	0	16	34	0	0
20	54744419	.	A	G	15	14	29	0	1	30	0	0
20	54744451	.	A	G	13	10	23	0	0	23	0	0
21	238575	.	T	C	7	7	14	0	2	16	0	0
21	734868	.	A	G	14	0	14	0	5	19	0	0
21	734962	.	A	G	11	0	11	0	12	23	0	0
21	735222	.	A	G	38	0	38	1	17	56	0	0
21	1741801	.	C	G	0	2	2	0	1	3	0	0
21	1780912	.	A	C	2	1	3	0	1	4	0	0
21	1788234	.	A	G	2	3	5	0	0	5	0	0
21	1788474	.	G	A	2	4	6	0	0	6	0	0
21	1788621	.	G	A	2	2	4	0	0	4	0	0
21	1788624	.	G	A	2	2	4	0	0	4	0	0
21	1798961	.	C	T	3	4	7	0	0	7	0	0
21	1907038	.	C	A	5	14	19	0	1	20	0	0
21	1907080	.	C	T	1	10	11	0	12	23	0	0
21	1930112	.	A	T	10	4	14	0	0	14	0	0
21	1934091	.	T	C	10	13	23	0	0	23	0	0
21	1934156	.	A	G	15	10	25	0	0	25	0	0
21	1944766	.	A	G	7	11	18	0	1	19	0	0
21	1948578	.	T	C	1	0	1	0	3	4	0	0
21	1963391	.	G	A	2	0	2	0	0	2	0	0
21	1963433	.	A	G	6	4	10	0	0	10	0	0
21	1968842	.	T	C	1	2	3	0	1	4	0	0
21	1991007	.	G	T	25	11	36	0	2	38	0	0
21	1991097	.	A	G	15	19	34	0	5	39	0	0
21	1991118	.	G	A	14	20	34	0	4	38	0	0
21	1991160	.	G	A	9	13	22	0	0	22	0	0
21	1996944	.	T	C	2	0	2	0	1	3	0	0
21	2014639	.	G	A	0	2	2	0	0	2	0	0
21	2025607	.	C	T	12	11	23	0	0	23	0	0
21	2030212	.	C	T	2	0	2	0	0	2	0	0
21	2031804	.	C	T	2	2	4	0	1	5	0	0
21	2031810	.	G	T	3	3	6	0	0	6	0	0
21	2031843	.	A	G	4	7	11	0	1	12	0	0
21	2031849	.	A	G	4	8	12	0	0	12	0	0
21	2031894	.	A	G	1	3	4	0	0	4	0	0
21	2033854	.	G	A	1	0	1	0	0	1	0	0
21	2033964	.	T	G	3	1	4	0	1	5	0	0
21	2035056	.	C	A	0	5	5	0	4	9	0	0
21	2035059	.	C	G	3	5	8	0	1	9	0	0
21	2035146	.	T	A	2	3	5	0	0	5	0	0
21	2036975	.	G	A	2	2	4	0	0	4	0	0
21	2042005	.	C	T	1	1	2	0	9	11	0	0
21	2112595	.	A	T	1	5	6	0	0	6	0	0
21	2119814	.	G	A	1	4	5	0	0	5	0	0
21	2119871	.	A	G	3	2	5	0	0	5	0	0
21	2119872	.	C	T	3	2	5	0	0	5	0	0
21	2120038	.	T	C	3	2	5	0	0	5	0	0
21	2120061	.	C	G	1	3	4	0	2	6	0	0
21	2120073	.	G	A	0	3	3	0	1	4	0	0
21	2120193	.	A	G	1	2	3	0	0	3	0	0
21	2120217	.	T	A	1	2	3	0	0	3	0	0
21	2124147	.	A	C	0	0	0	0	1	1	0	0
21	2124201	.	G	A	0	1	1	0	0	1	0	0
21	2124206	.	T	G	0	1	1	0	0	1	0	0
21	2171472	.	T	C	5	2	7	0	1	8	0	0
21	2180054	.	C	T	5	2	7	0	0	7	0	0
21	2208791	.	C	T	0	5	5	0	1	6	0	0
21	2738221	.	C	T	5	9	14	0	0	14	0	0
21	2950257	.	G	A	2	4	6	0	0	6	0	0
21	2950290	.	C	A	0	2	2	0	2	4	0	0
21	2957806	.	A	G	2	2	4	0	0	4	0	0
21	3301916	.	C	T	1	6	7	0	0	7	0	0
21	3301931	.	C	A	2	5	7	0	1	8	0	0
21	3302296	.	A	G	1	0	1	0	1	2	0	0
21	3422565	.	T	G	9	11	20	0	1	21	0	0
21	3452462	.	A	G	7	10	17	0	0	17	0	0
21	3478014	.	A	G	3	5	8	0	0	8	0	0
21	3485351	.	T	C	6	0	6	0	13	19	0	0
21	3536050	.	A	G	1	2	3	0	0	3	0	0
21	3536056	.	T	A	1	2	3	0	0	3	0	0
21	3536113	.	A	C	1	0	1	0	0	1	0	0
21	3536116	.	G	A	1	0	1	0	0	1	0	0
21	3536597	.	C	T	0	1	1	0	2	3	0	0
21	3539275	.	C	T	6	5	11	0	0	11	0	0
21	3567722	.	A	G	4	5	9	0	0	9	0	0
21	3613551	.	G	A	3	2	5	0	0	5	0	0
21	3715950	.	A	G	9	9	18	0	3	21	0	0
21	3715986	.	T	A	8	10	18	0	0	18	0	0
21	3715989	.	A	G	7	10	17	0	0	17	0	0
21	3716058	.	T	A	10	10	20	0	0	20	0	0
21	3716512	.	T	G	2	3	5	0	0	5	0	0
21	3716517	.	C	A	2	3	5	0	0	5	0	0
21	3716553	.	T	C	4	3	7	0	0	7	0	0
21	3716732	.	G	T	18	12	30	0	1	31	0	0
21	3716845	.	G	A	6	4	10	0	5	15	0	0
21	3716846	.	A	T	3	3	6	0	9	15	0	0
21	3716930	.	G	A	15	12	27	0	4	31	0	0
21	3717055	.	G	A	25	16	41	0	2	43	0	0
21	3717505	.	T	C	2	0	2	0	4	6	0	0
21	3719779	.	G	A	7	2	9	0	0	9	0	0
21	3725881	.	A	C	2	0	2	0	4	6	0	0
21	3738181	.	C	T	0	7	7	0	5	12	0	0
21	3775605	.	G	T	1	3	4	0	0	4	0	0
21	3778633	.	T	C	4	6	10	0	0	10	0	0
21	3786377	.	C	T	3	4	7	0	1	8	0	0
21	3787070	.	G	C	5	5	10	0	0	10	0	0
21	3787071	.	A	C	5	4	9	0	1	10	0	0
21	3789922	.	T	A	14	8	22	0	0	22	0	0
21	3789930	.	C	T	14	12	26	0	0	26	0	0
21	3789998	.	A	G	13	17	30	0	0	30	0	0
21	3793211	.	G	A	4	3	7	0	0	7	0	0
21	3793309	.	T	C	0	1	1	0	0	1	0	0
21	3793413	.	C	T	19	19	38	0	1	39	0	0
21	3796376	.	G	T	13	12	25	0	2	27	0	0
21	3796398	.	G	T	9	6	15	0	2	17	0	0
21	3821525	.	A	G	1	0	1	0	0	1	0	0
21	3822666	.	T	C	1	0	1	0	8	9	0	0
21	3822827	.	T	G	3	9	12	0	0	12	0	0
21	3822841	.	A	T	2	8	10	0	0	10	0	0
21	3822896	.	T	C	1	0	1	0	3	4	0	0
21	3825019	.	T	A	5	8	13	0	0	13	0	0
21	3844113	.	G	A	2	2	4	0	0	4	0	0
21	3859098	.	C	T	2	2	4	0	0	4	0	0
21	3866706	.	A	G	3	0	3	0	2	5	0	0
21	3880834	.	C	A	5	3	8	0	0	8	0	0
21	3880885	.	G	A	0	3	3	0	2	5	0	0
21	3881003	.	G	A	4	7	11	0	0	11	0	0
21	3881105	.	C	T	4	2	6	0	0	6	0	0
21	3912699	.	C	G	3	4	7	0	0	7	0	0
21	3917912	.	C	A	6	4	10	0	4	14	0	0
21	3918006	.	A	G	7	8	15	0	1	16	0	0
21	3918186	.	G	A	4	4	8	0	1	9	0	0
21	3955319	.	C	A	4	2	6	0	0	6	0	0
21	3955445	.	G	A	2	2	4	0	1	5	0	0
21	3958058	.	T	C	4	2	6	0	0	6	0	0
21	3958285	.	A	G	1	3	4	0	0	4	0	0
21	3962692	.	T	C	0	4	4	0	0	4	0	0
21	3972766	.	G	A	4	6	10	0	0	10	0	0
21	4116559	.	T	C	2	4	6	0	0	6	0	0
21	4182811	.	C	G	0	1	1	0	0	1	0	0
21	4188200	.	G	A	4	2	6	0	0	6	0	0
21	4188269	.	A	G	2	1	3	0	2	5	0	0
21	4188272	.	G	C	3	1	4	0	0	4	0	0
21	4191043	.	T	A	0	2	2	0	0	2	0	0
21	4207582	.	A	G	0	1	1	0	0	1	0	0
21	4207585	.	T	C	0	0	0	0	1	1	0	0
21	4209078	.	T	C	1	3	4	0	0	4	0	0
21	4210998	.	A	G	0	1	1	0	1	2	0	0
21	4219400	.	T	A	4	5	9	0	0	9	0	0
21	4219450	.	C	T	1	5	6	0	2	8	0	0
21	4219518	.	C	T	1	3	4	0	0	4	0	0
21	4227261	.	G	T	4	3	7	0	0	7	0	0
21	4227266	.	T	C	4	0	4	0	2	6	0	0
21	4227387	.	C	G	6	5	11	0	0	11	0	0
21	4227392	.	T	A	5	6	11	0	0	11	0	0
21	4227433	.	T	G	2	3	5	0	0	5	0	0
21	4227740	.	A	T	5	3	8	0	0	8	0	0
21	4227744	.	T	A	6	1	7	0	0	7	0	0
21	4227788	.	G	A	7	5	12	0	0	12	0	0
21	4228026	.	G	A	4	8	12	0	0	12	0	0
21	4232774	.	A	G	2	1	3	0	0	3	0	0
21	4237466	.	T	A	1	2	3	0	0	3	0	0
21	4237496	.	C	T	0	2	2	0	1	3	0	0
21	4240121	.	T	C	2	3	5	0	0	5	0	0
21	4244348	.	T	A	6	13	19	0	1	20	0	0
21	4244377	.	C	G	8	10	18	0	1	19	0	0
21	4250583	.	C	A	5	3	8	0	0	8	0	0
21	4250596	.	C	T	0	6	6	0	4	10	0	0
21	4250634	.	G	A	2	5	7	0	0	7	0	0
21	4250642	.	T	A	2	5	7	0	0	7	0	0
21	4288171	.	A	G	2	2	4	0	0	4	0	0
21	4293557	.	C	A	1	2	3	0	0	3	0	0
21	4293620	.	C	T	1	2	3	0	0	3	0	0
21	4304471	.	T	C	3	3	6	0	0	6	0	0
21	4304489	.	A	T	3	3	6	0	0	6	0	0
21	4304725	.	G	A	0	6	6	0	3	9	0	0
21	4304744	.	T	C	5	5	10	0	0	10	0	0
21	4304822	.	G	A	5	5	10	0	1	11	0	0
21	4304848	.	C	T	7	4	11	0	0	11	0	0
21	4304875	.	T	A	6	4	10	0	0	10	0	0
21	4304912	.	A	T	1	5	6	0	0	6	0	0
21	4304913	.	C	T	1	5	6	0	0	6	0	0
21	4518181	.	A	T	1	1	2	0	0	2	0	0
21	4518530	.	A	G	2	1	3	0	0	3	0	0
21	4534186	.	T	C	3	2	5	0	0	5	0	0
21	4534248	.	A	C	3	2	5	0	0	5	0	0
21	4535154	.	A	T	1	2	3	0	0	3	0	0
21	4535546	.	T	C	2	0	2	0	2	4	0	0
21	4539862	.	T	A	2	2	4	0	0	4	0	0
21	4568499	.	T	C	1	3	4	0	0	4	0	0
21	4568502	.	C	T	1	3	4	0	0	4	0	0
21	4573597	.	A	G	0	1	1	0	0	1	0	0
21	4576310	.	G	C	3	2	5	0	0	5	0	0
21	4576319	.	G	C	0	2	2	0	3	5	0	0
21	4578122	.	G	A	0	1	1	0	1	2	0	0
21	4578137	.	G	A	0	2	2	0	1	3	0	0
21	4578428	.	C	A	2	7	9	0	0	9	0	0
21	4578520	.	T	C	1	2	3	0	0	3	0	0
21	4585012	.	A	C	1	2	3	0	0	3	0	0
21	4585027	.	A	G	1	0	1	0	3	4	0	0
21	4585189	.	C	A	2	1	3	0	0	3	0	0
21	4589826	.	A	G	2	5	7	0	1	8	0	0
21	4591407	.	C	G	4	6	10	0	0	10	0	0
21	4591410	.	A	T	4	6	10	0	0	10	0	0
21	4591502	.	A	G	1	0	1	0	0	1	0	0
21	4592959	.	T	C	0	3	3	0	0	3	0	0
21	4592984	.	A	G	0	3	3	0	0	3	0	0
21	4593008	.	A	T	0	2	2	0	0	2	0	0
21	4596883	.	G	T	6	11	17	0	0	17	0	0
21	4596970	.	A	G	5	7	12	0	0	12	0	0
21	4603372	.	C	T	6	6	12	0	0	12	0	0
21	4647939	.	C	T	1	4	5	0	0	5	0	0
21	4656793	.	A	T	2	1	3	0	0	3	0	0
21	4659003	.	T	C	0	1	1	0	0	1	0	0
21	4660804	.	G	C	1	4	5	0	0	5	0	0
21	4667092	.	C	T	3	3	6	0	0	6	0	0
21	4670307	.	T	C	1	0	1	0	3	4	0	0
21	4670308	.	T	G	1	3	4	0	0	4	0	0
21	4679623	.	T	C	1	2	3	0	0	3	0	0
21	4679703	.	C	G	1	1	2	0	0	2	0	0
21	4712743	.	A	G	6	6	12	0	0	12	0	0
21	4712756	.	T	C	5	1	6	0	6	12	0	0
21	4713252	.	T	C	16	0	16	0	18	34	0	0
21	4718518	.	G	A	5	10	15	0	2	17	0	0
21	4720325	.	C	T	2	2	4	0	0	4	0	0
21	4723670	.	G	A	11	9	20	0	0	20	0	0
21	4724351	.	C	T	0	8	8	0	7	15	0	0
21	4724428	.	A	G	5	4	9	0	1	10	0	0
21	4724564	.	G	A	8	12	20	0	0	20	0	0
21	4724810	.	T	C	3	3	6	0	1	7	0	0
21	4729876	.	G	A	5	2	7	0	0	7	0	0
21	4740850	.	A	G	2	1	3	0	0	3	0	0
21	4742721	.	A	G	6	5	11	0	0	11	0	0
21	4742793	.	G	A	0	3	3	0	0	3	0	0
21	4748802	.	G	C	2	5	7	0	0	7	0	0
21	4899868	.	C	T	0	4	4	0	2	6	0	0
21	5003129	.	T	C	2	3	5	0	1	6	0	0
21	5004192	.	T	C	3	4	7	0	1	8	0	0
21	5004199	.	T	C	4	4	8	0	0	8	0	0
21	5056600	.	T	C	2	0	2	0	5	7	0	0
21	5066371	.	A	G	3	4	7	0	0	7	0	0
21	5066417	.	T	C	7	0	7	0	5	12	0	0
21	5066425	.	T	C	6	0	6	0	4	10	0	0
21	5160219	.	T	C	3	3	6	0	0	6	0	0
21	5160428	.	G	A	4	3	7	0	0	7	0	0
21	5169217	.	T	A	17	16	33	0	0	33	0	0
21	5171036	.	C	T	27	18	45	0	1	46	0	0
21	5173402	.	T	G	10	0	10	0	5	15	0	0
21	5173447	.	C	T	20	22	42	0	0	42	0	0
21	5173638	.	T	C	18	10	28	2	1	31	0	0
21	5199875	.	G	A	7	6	13	0	0	13	0	0
21	5200683	.	C	T	27	15	42	0	1	43	0	0
21	5209585	.	A	G	14	0	14	0	12	26	0	0
21	5209666	.	C	T	11	10	21	0	1	22	0	0
21	5237137	.	G	A	3	4	7	0	0	7	0	0
21	5240259	.	C	T	12	20	32	0	0	32	0	0
21	6725381	.	G	T	1	2	3	0	0	3	0	0
21	8343954	.	T	C	6	5	11	0	0	11	0	0
21	8344326	.	T	C	13	19	32	0	1	33	0	0
21	8346125	.	T	C	8	8	16	0	0	16	0	0
21	8348920	.	G	A	0	14	14	0	6	20	0	0
21	8348959	.	T	C	12	19	31	0	4	35	0	0
21	8348980	.	A	G	10	17	27	0	0	27	0	0
21	8348998	.	T	C	5	8	13	0	1	14	0	0
21	8352010	.	T	A	8	7	15	0	1	16	0	0
21	8427115	.	G	A	0	3	3	0	7	10	0	0
21	8444173	.	C	T	0	1	1	0	0	1	0	0
21	8444176	.	C	T	0	1	1	0	0	1	0	0
21	9370684	.	C	T	1	1	2	0	2	4	0	0
21	9370780	.	G	A	2	1	3	0	0	3	0	0
21	9377080	.	G	A	2	1	3	0	0	3	0	0
21	9377107	.	T	C	1	0	1	0	1	2	0	0
21	9391712	.	C	T	0	3	3	0	3	6	0	0
21	9399918	.	G	C	2	0	2	0	0	2	0	0
21	9406494	.	A	G	1	2	3	0	0	3	0	0
21	9418214	.	A	G	2	2	4	0	0	4	0	0
21	9418217	.	A	G	2	2	4	0	0	4	0	0
21	9425950	.	G	A	2	1	3	0	0	3	0	0
21	9429698	.	A	C	1	0	1	0	0	1	0	0
21	9429749	.	G	A	3	2	5	0	1	6	0	0
21	9439493	.	A	T	0	2	2	0	0	2	0	0
21	9439520	.	A	T	0	2	2	0	0	2	0	0
21	9446650	.	A	G	2	2	4	0	0	4	0	0
21	9576315	.	A	C	5	5	10	0	1	11	0	0
21	9576316	.	T	G	5	1	6	0	5	11	0	0
21	9987496	.	T	A	4	2	6	0	0	6	0	0
21	9987923	.	C	G	10	6	16	0	1	17	0	0
21	9989373	.	A	G	8	2	10	0	2	12	0	0
21	9991332	.	T	C	5	3	8	0	0	8	0	0
21	9991340	.	A	C	6	4	10	0	0	10	0	0
21	9997550	.	A	G	2	0	2	0	2	4	0	0
21	10095584	.	G	A	0	4	4	0	1	5	0	0
21	10095647	.	A	T	2	3	5	0	0	5	0	0
21	10100254	.	A	G	1	0	1	0	4	5	0	0
21	10100892	.	C	T	1	5	6	0	0	6	0	0
21	10254231	.	A	T	7	10	17	0	3	20	0	0
21	10254246	.	C	T	0	13	13	0	7	20	0	0
21	10319303	.	G	A	7	5	12	0	0	12	0	0
21	10422603	.	C	T	0	2	2	0	3	5	0	0
21	10702074	.	T	A	3	2	5	0	0	5	0	0
21	10702215	.	G	A	2	2	4	0	0	4	0	0
21	10713176	.	G	A	2	2	4	0	1	5	0	0
21	10715837	.	G	A	4	3	7	0	1	8	0	0
21	10715855	.	T	C	3	4	7	0	0	7	0	0
21	10729109	.	C	T	8	4	12	0	0	12	0	0
21	10731101	.	A	G	10	4	14	0	1	15	0	0
21	10731133	.	A	G	4	4	8	0	0	8	0	0
21	10731142	.	G	C	2	3	5	0	1	6	0	0
21	10795402	.	T	G	3	1	4	0	2	6	0	0
21	10796440	.	A	T	1	3	4	0	0	4	0	0
21	10799550	.	T	A	1	3	4	0	0	4	0	0
21	10890736	.	G	T	7	7	14	0	2	16	0	0
21	10891065	.	T	G	5	4	9	0	0	9	0	0
21	10891085	.	T	C	6	0	6	0	4	10	0	0
21	10892031	.	A	G	4	3	7	0	0	7	0	0
21	10903625	.	T	C	2	5	7	0	1	8	0	0
21	10918101	.	G	A	2	1	3	0	0	3	0	0
21	10933016	.	G	A	1	3	4	0	1	5	0	0
21	11111434	.	T	C	0	1	1	0	0	1	0	0
21	11130947	.	C	T	1	2	3	0	0	3	0	0
21	11130950	.	C	T	1	2	3	0	0	3	0	0
21	11131691	.	A	G	3	0	3	0	0	5	2	0
21	11132059	.	G	T	1	3	4	0	0	4	0	0
21	11132923	.	T	C	4	2	6	0	0	6	0	0
21	11132926	.	A	G	4	2	6	0	0	6	0	0
21	11133117	.	C	T	4	1	5	0	0	5	0	0
21	11133355	.	C	A	2	2	4	0	0	4	0	0
21	11133356	.	T	C	2	2	4	0	0	4	0	0
21	11133471	.	A	T	6	3	9	0	0	9	0	0
21	11134299	.	A	G	3	3	6	0	1	7	0	0
21	11134803	.	T	G	1	2	3	0	0	3	0	0
21	11134829	.	A	T	0	2	2	0	0	2	0	0
21	11180201	.	T	C	7	3	10	0	1	11	0	0
21	11180215	.	C	T	7	3	10	0	0	10	0	0
21	11182127	.	G	T	4	5	9	0	1	10	0	0
21	11189725	.	C	T	8	3	11	0	0	11	0	0
21	11191971	.	A	T	3	2	5	0	0	5	0	0
21	11193317	.	A	G	2	1	3	0	0	3	0	0
21	11193391	.	C	T	2	3	5	0	0	5	0	0
21	11199079	.	T	G	2	2	4	0	0	4	0	0
21	11199135	.	G	C	3	2	5	0	0	5	0	0
21	11199333	.	A	G	3	3	6	0	0	6	0	0
21	11330670	.	T	A	1	1	2	0	0	2	0	0
21	11330874	.	C	G	7	4	11	0	1	12	0	0
21	11330903	.	T	G	7	3	10	0	0	10	0	0
21	11339654	.	A	T	1	4	5	0	0	5	0	0
21	11339704	.	T	C	4	3	7	0	1	8	0	0
21	11339710	.	T	C	5	0	5	0	3	8	0	0
21	11340011	.	G	A	2	2	4	0	0	4	0	0
21	11342333	.	A	G	9	3	12	0	0	12	0	0
21	11342740	.	A	G	4	3	7	0	1	8	0	0
21	11349583	.	A	T	3	0	3	0	0	3	0	0
21	11349584	.	T	G	3	0	3	0	0	3	0	0
21	11349676	.	T	C	5	2	7	0	0	7	0	0
21	11349836	.	G	T	3	2	5	0	0	5	0	0
21	11352470	.	G	A	0	3	3	0	0	3	0	0
21	11354025	.	T	C	1	3	4	0	0	4	0	0
21	11354077	.	A	G	2	2	4	0	0	4	0	0
21	11356652	.	G	A	1	0	1	0	0	1	0	0
21	11363785	.	C	A	3	4	7	0	0	7	0	0
21	11363835	.	G	A	2	3	5	0	0	5	0	0
21	11364114	.	A	G	2	4	6	0	0	6	0	0
21	11365321	.	G	T	1	2	3	0	0	3	0	0
21	11365441	.	G	A	1	2	3	0	0	3	0	0
21	11367396	.	T	C	4	3	7	0	0	7	0	0
21	11367444	.	C	T	2	2	4	0	0	4	0	0
21	11369788	.	G	T	0	1	1	0	4	5	0	0
21	11369857	.	A	C	1	7	8	0	0	8	0	0
21	11369871	.	A	G	1	8	9	0	0	9	0	0
21	11369899	.	A	T	0	4	4	0	0	4	0	0
21	11380368	.	A	G	0	1	1	0	0	1	0	0
21	11382887	.	C	T	3	8	11	0	0	11	0	0
21	11382899	.	T	C	3	9	12	0	0	12	0	0
21	11415249	.	T	A	1	3	4	0	0	4	0	0
21	11415494	.	G	A	0	9	9	0	10	19	0	0
21	11425152	.	C	T	10	4	14	0	0	14	0	0
21	11425182	.	G	A	9	10	19	0	0	19	0	0
21	11425218	.	T	C	5	11	16	0	1	17	0	0
21	11427850	.	T	C	2	4	6	0	0	6	0	0
21	11431070	.	G	T	2	5	7	0	0	7	0	0
21	11434022	.	C	A	9	13	22	0	1	23	0	0
21	11434116	.	T	C	3	11	14	0	1	15	0	0
21	11468957	.	A	C	18	28	46	0	1	47	0	0
21	11469119	.	A	G	28	19	47	0	1	48	0	0
21	11477418	.	A	G	13	0	13	0	10	23	0	0
21	11477496	.	T	C	29	17	46	0	4	50	0	0
21	11486933	.	T	C	7	9	16	0	2	18	0	0
21	11492826	.	C	T	39	19	58	0	3	61	0	0
21	11493661	.	A	G	39	15	54	0	2	56	0	0
21	11494536	.	A	G	26	2	28	0	24	52	0	0
21	11501308	.	T	C	22	26	48	0	4	52	0	0
21	11501618	.	T	A	27	16	43	0	1	44	0	0
21	11501665	.	C	T	26	26	52	0	0	52	0	0
21	11501975	.	A	G	38	14	52	0	3	55	0	0
21	11502120	.	T	C	31	22	53	0	1	54	0	0
21	11502143	.	A	G	20	29	49	0	4	54	1	0
21	11502807	.	G	T	1	19	20	0	23	43	0	0
21	11521251	.	T	A	2	3	5	0	0	5	0	0
21	11521268	.	T	C	1	2	3	0	0	3	0	0
21	11527709	.	G	A	4	1	5	0	1	6	0	0
21	11527723	.	C	G	2	0	2	0	4	6	0	0
21	11527746	.	T	C	3	4	7	0	0	7	0	0
21	11527950	.	A	G	1	0	1	0	2	3	0	0
21	11528040	.	A	G	1	3	4	0	0	4	0	0
21	11528047	.	A	C	1	3	4	0	0	4	0	0
21	11528094	.	G	A	2	3	5	0	0	5	0	0
21	11529117	.	G	A	0	2	2	0	1	3	0	0
21	11566285	.	T	G	4	7	11	0	0	11	0	0
21	11566478	.	G	T	8	6	14	0	1	15	0	0
21	11571108	.	G	A	5	0	5	0	0	5	0	0
21	11571147	.	T	C	5	0	5	0	0	5	0	0
21	11571159	.	G	T	1	0	1	0	2	3	0	0
21	11571353	.	G	A	2	0	2	0	0	2	0	0
21	11575596	.	T	G	2	2	4	0	0	4	0	0
21	11575611	.	T	C	2	2	4	0	0	4	0	0
21	11575632	.	T	A	1	0	1	0	0	1	0	0
21	11575748	.	G	A	3	2	5	0	0	5	0	0
21	11577590	.	T	C	1	1	2	0	0	2	0	0
21	11602249	.	T	A	0	1	1	0	0	1	0	0
21	11605650	.	A	G	1	1	2	0	0	2	0	0
21	11607758	.	T	C	0	0	0	0	1	1	0	0
21	11612150	.	G	A	1	0	1	0	0	1	0	0
21	11709084	.	G	A	1	0	1	0	0	1	0	0
21	11713042	.	G	A	0	12	12	0	10	22	0	0
21	11718420	.	T	C	11	5	16	0	0	16	0	0
21	11721310	.	T	C	6	0	6	0	1	7	0	0
21	11721984	.	A	G	14	0	14	0	20	34	0	0
21	11722262	.	C	T	9	9	18	0	3	21	0	0
21	11722277	.	C	T	9	10	19	0	1	20	0	0
21	11764327	.	G	A	0	0	0	0	3	3	0	0
21	11766523	.	A	T	4	6	10	0	0	10	0	0
21	11766535	.	G	A	0	10	10	0	4	14	0	0
21	11766598	.	T	A	1	3	4	0	4	8	0	0
21	11767009	.	G	C	4	2	6	0	0	6	0	0
21	11781541	.	A	G	4	7	11	0	0	11	0	0
21	11799553	.	A	G	7	3	10	0	0	10	0	0
21	11814897	.	A	G	2	1	3	0	0	3	0	0
21	11816763	.	C	A	0	1	1	0	0	1	0	0
21	11830015	.	G	A	1	2	3	0	0	3	0	0
21	11855947	.	C	T	4	4	8	0	0	8	0	0
21	11866057	.	A	C	11	9	20	0	0	20	0	0
21	11867908	.	T	C	7	3	10	0	2	12	0	0
21	11869420	.	T	A	4	8	12	0	3	15	0	0
21	11869495	.	C	A	9	9	18	0	0	18	0	0
21	11869774	.	G	C	0	11	11	0	11	22	0	0
21	11869870	.	C	T	10	8	18	0	2	20	0	0
21	11880927	.	G	A	1	1	2	0	0	2	0	0
21	11880996	.	G	A	9	9	18	0	1	19	0	0
21	11881129	.	G	C	6	7	13	0	0	13	0	0
21	11881140	.	C	T	8	8	16	0	0	16	0	0
21	11881344	.	G	A	7	7	14	0	2	16	0	0
21	11881715	.	C	T	14	11	25	0	0	25	0	0
21	11881980	.	C	T	1	1	2	0	0	2	0	0
21	11882650	.	C	T	3	2	5	0	0	5	0	0
21	11882653	.	T	G	3	2	5	0	0	5	0	0
21	11883850	.	A	T	1	4	5	0	0	5	0	0
21	11883896	.	C	T	1	4	5	0	1	6	0	0
21	11883901	.	A	G	2	4	6	0	0	6	0	0
21	11883984	.	C	A	2	3	5	0	0	5	0	0
21	11883991	.	A	T	2	4	6	0	0	6	0	0
21	11898772	.	A	C	1	1	2	0	0	2	0	0
21	11911722	.	A	T	12	9	21	0	1	22	0	0
21	11911730	.	A	T	12	7	19	0	0	19	0	0
21	11911921	.	C	T	10	12	22	0	0	22	0	0
21	11927113	.	C	T	6	7	13	0	0	13	0	0
21	11927809	.	G	C	0	8	8	0	9	17	0	0
21	11932372	.	T	C	3	2	5	0	0	5	0	0
21	11937522	.	A	G	12	14	26	0	7	33	0	0
21	11942334	.	T	C	8	14	22	0	1	23	0	0
21	11942407	.	T	C	13	8	21	0	0	21	0	0
21	11946133	.	C	T	8	10	18	0	0	18	0	0
21	11949317	.	C	T	7	4	11	0	0	11	0	0
21	11950217	.	C	A	3	4	7	0	0	7	0	0
21	11955208	.	A	C	4	9	13	0	8	21	0	0
21	11958852	.	A	T	4	4	8	0	1	9	0	0
21	11958928	.	A	G	12	10	22	0	0	22	0	0
21	11958971	.	G	T	9	10	19	0	1	21	1	0
21	11958982	.	C	T	9	11	20	0	0	20	0	0
21	11959034	.	G	A	8	12	20	0	0	20	0	0
21	11959061	.	T	G	6	15	21	0	0	21	0	0
21	11959185	.	A	G	13	8	21	0	1	22	0	0
21	11959309	.	T	C	2	0	2	0	0	2	0	0
21	11961122	.	C	T	4	10	14	0	1	15	0	0
21	11963090	.	T	G	1	4	5	0	0	5	0	0
21	11963114	.	C	A	1	3	4	0	0	4	0	0
21	11963648	.	C	G	0	4	4	0	1	5	0	0
21	11963778	.	C	A	5	2	7	0	0	7	0	0
21	11964981	.	C	T	5	7	12	0	0	12	0	0
21	11965035	.	T	G	4	6	10	0	1	11	0	0
21	11967077	.	T	C	2	0	2	0	0	2	0	0
21	11967857	.	A	C	4	2	6	0	0	6	0	0
21	11970139	.	C	T	1	0	1	0	0	1	0	0
21	12023854	.	C	T	2	2	4	0	1	5	0	0
21	12023880	.	A	C	4	4	8	0	1	9	0	0
21	12028080	.	G	A	10	7	17	0	0	17	0	0
21	12036013	.	C	T	8	6	14	0	0	14	0	0
21	12073880	.	G	A	1	2	3	0	0	3	0	0
21	12080051	.	C	G	0	15	15	0	17	32	0	0
21	12104957	.	C	A	6	13	19	0	0	19	0	0
21	12107367	.	A	G	3	1	4	0	0	4	0	0
21	12272375	.	T	G	15	16	31	0	0	31	0	0
21	13193928	.	C	T	17	16	33	0	0	33	0	0
21	13329495	.	C	T	1	1	2	0	0	2	0	0
21	13353301	.	T	A	6	3	9	0	0	9	0	0
21	13360446	.	C	T	6	6	12	0	0	12	0	0
21	13362830	.	A	C	0	5	5	0	0	5	0	0
21	13362896	.	C	T	3	6	9	0	0	9	0	0
21	13364790	.	T	A	10	7	17	0	1	18	0	0
21	13364802	.	T	C	12	9	21	0	0	21	0	0
21	13384144	.	A	G	3	2	5	0	0	5	0	0
21	13388223	.	T	C	2	2	4	0	0	4	0	0
21	13389927	.	A	C	1	1	2	0	0	2	0	0
21	13389943	.	G	A	0	1	1	0	1	2	0	0
21	13431198	.	G	A	4	7	11	0	0	11	0	0
21	13431261	.	G	C	8	4	12	0	1	13	0	0
21	13431309	.	A	G	5	0	5	0	6	11	0	0
21	13431363	.	A	T	3	4	7	0	0	7	0	0
21	13431379	.	T	A	1	3	4	0	0	4	0	0
21	13431470	.	A	G	2	5	7	0	0	7	0	0
21	13431573	.	T	C	4	7	11	0	0	11	0	0
21	13431620	.	T	C	6	4	10	0	0	10	0	0
21	13431639	.	C	T	7	2	9	0	0	9	0	0
21	13431720	.	T	A	5	2	7	0	0	7	0	0
21	13431924	.	A	G	3	5	8	0	0	8	0	0
21	13431947	.	A	T	6	5	11	0	0	11	0	0
21	13432071	.	A	C	4	1	5	0	0	5	0	0
21	13432117	.	T	G	5	0	5	0	1	6	0	0
21	13432315	.	T	C	9	14	23	0	1	24	0	0
21	13432369	.	C	A	6	6	12	0	2	14	0	0
21	13493234	.	A	G	3	2	5	0	0	5	0	0
21	13611849	.	G	A	3	3	6	0	0	6	0	0
21	13612174	.	T	A	1	5	6	0	0	6	0	0
21	13612559	.	A	T	6	4	10	0	0	10	0	0
21	13612827	.	G	A	1	3	4	0	0	4	0	0
21	13612846	.	T	C	3	0	3	0	5	8	0	0
21	13612927	.	A	T	3	3	6	0	0	6	0	0
21	13613002	.	T	C	3	2	5	0	0	5	0	0
21	13613017	.	A	G	2	2	4	0	0	4	0	0
21	13613037	.	T	C	3	1	4	0	0	4	0	0
21	13613053	.	T	C	0	2	2	0	0	2	0	0
21	13613255	.	T	C	1	4	5	0	0	5	0	0
21	13613559	.	T	C	1	3	4	0	0	4	0	0
21	13614075	.	T	C	2	2	4	0	0	4	0	0
21	13614077	.	C	T	2	2	4	0	0	4	0	0
21	13614703	.	G	T	4	2	6	0	0	6	0	0
21	13617335	.	A	G	1	2	3	0	1	4	0	0
21	13702751	.	A	T	14	13	27	0	1	28	0	0
21	13714602	.	T	C	13	10	23	0	4	27	0	0
21	13714603	.	G	A	15	12	27	0	0	27	0	0
21	13715285	.	T	A	2	1	3	0	0	3	0	0
21	13715347	.	T	A	7	5	12	0	0	12	0	0
21	13715356	.	A	G	5	4	9	0	0	9	0	0
21	13751205	.	G	C	7	8	15	0	0	15	0	0
21	13762760	.	C	T	2	2	4	0	0	4	0	0
21	13765938	.	T	C	0	1	1	0	0	1	0	0
21	13765957	.	T	C	0	0	0	0	1	1	0	0
21	13766022	.	C	G	1	2	3	0	4	7	0	0
21	13771160	.	G	T	2	3	5	0	0	5	0	0
21	13786089	.	G	A	1	1	2	0	1	3	0	0
21	13794652	.	G	T	3	3	6	0	0	6	0	0
21	13796033	.	G	A	1	1	2	0	0	2	0	0
21	13796165	.	G	A	5	7	12	0	1	13	0	0
21	13796743	.	A	G	9	15	24	0	1	25	0	0
21	13895741	.	C	T	6	7	13	0	2	16	1	0
21	13895799	.	C	A	25	30	55	0	1	56	0	0
21	13895849	.	G	A	0	4	4	0	9	13	0	0
21	13895862	.	A	C	3	0	3	0	0	3	0	0
21	14174060	.	G	A	4	2	6	0	0	6	0	0
21	14174098	.	G	A	1	2	3	0	0	3	0	0
21	14239956	.	C	T	7	5	12	0	1	13	0	0
21	14239988	.	C	T	8	4	12	0	0	12	0	0
21	14240025	.	G	T	5	2	7	0	0	7	0	0
21	14241982	.	G	T	3	3	6	0	0	6	0	0
21	14251160	.	T	A	6	4	10	0	0	10	0	0
21	14381335	.	G	A	3	5	8	0	0	8	0	0
21	14381356	.	C	T	0	3	3	0	5	8	0	0
21	14381422	.	G	A	2	2	4	0	0	4	0	0
21	14383767	.	T	C	4	0	4	0	3	7	0	0
21	14399710	.	T	G	2	3	5	0	0	5	0	0
21	14399729	.	A	G	2	3	5	0	0	5	0	0
21	14415698	.	A	G	1	1	2	0	0	2	0	0
21	14456531	.	C	T	2	2	4	0	0	4	0	0
21	14469501	.	A	G	2	3	5	0	0	5	0	0
21	14644363	.	T	C	2	7	9	0	1	10	0	0
21	14644704	.	A	T	4	12	16	0	0	16	0	0
21	14644869	.	C	G	11	14	25	0	1	26	0	0
21	14644885	.	A	T	11	14	25	0	1	26	0	0
21	14644969	.	A	G	5	11	16	0	1	17	0	0
21	14644981	.	G	C	8	6	14	0	0	14	0	0
21	14645006	.	G	A	2	10	12	0	1	13	0	0
21	14645021	.	G	A	6	12	18	0	1	19	0	0
21	14645113	.	A	G	5	11	16	0	0	16	0	0
21	14645125	.	A	G	5	10	15	0	0	15	0	0
21	14645238	.	C	A	6	4	10	0	0	10	0	0
21	14645239	.	C	A	6	4	10	0	0	10	0	0
21	14645300	.	G	A	6	8	14	0	2	16	0	0
21	14645369	.	A	T	6	9	15	0	0	15	0	0
21	14645641	.	C	A	8	7	15	0	0	15	0	0
21	14645642	.	A	C	8	7	15	0	0	15	0	0
21	14654497	.	G	A	0	5	5	0	0	5	0	0
21	14657314	.	C	T	0	1	1	0	2	3	0	0
21	14659421	.	C	T	1	2	3	0	0	3	0	0
21	14659462	.	T	A	1	1	2	0	0	2	0	0
21	14663428	.	A	G	5	2	7	0	0	7	0	0
21	14663853	.	C	G	2	3	5	0	1	6	0	0
21	14663911	.	T	C	7	4	11	0	0	11	0	0
21	14664425	.	T	C	6	10	16	0	1	17	0	0
21	14664851	.	T	C	1	1	2	0	0	2	0	0
21	14665343	.	C	T	0	4	4	0	6	10	0	0
21	14665397	.	C	A	1	2	3	0	0	3	0	0
21	14665427	.	C	T	4	4	8	0	0	8	0	0
21	14665510	.	C	A	1	0	1	0	0	1	0	0
21	14701897	.	G	A	9	9	18	0	1	19	0	0
21	14702073	.	C	G	6	8	14	0	0	14	0	0
21	14702193	.	C	T	1	3	4	0	0	4	0	0
21	14702211	.	C	T	0	2	2	0	0	2	0	0
21	14704871	.	G	A	2	0	2	0	0	2	0	0
21	14706677	.	C	A	2	2	4	0	1	5	0	0
21	14719613	.	G	C	6	0	6	0	1	7	0	0
21	14810988	.	T	C	4	4	8	0	0	8	0	0
21	14812964	.	G	A	3	7	10	0	0	10	0	0
21	14813064	.	A	G	7	8	15	0	1	16	0	0
21	14813138	.	A	G	3	4	7	0	0	7	0	0
21	14813282	.	C	G	11	9	20	0	0	20	0	0
21	14813380	.	G	C	10	7	17	0	0	17	0	0
21	14813402	.	T	A	15	11	26	0	0	26	0	0
21	14813479	.	T	C	9	1	10	0	12	22	0	0
21	14815804	.	A	G	9	13	22	0	0	22	0	0
21	14819421	.	C	G	0	1	1	0	1	2	0	0
21	14819766	.	G	A	0	1	1	0	0	1	0	0
21	14823792	.	T	G	1	0	1	0	0	1	0	0
21	14825147	.	T	C	0	2	2	0	0	2	0	0
21	14825171	.	A	G	0	3	3	0	0	3	0	0
21	14825750	.	G	A	1	1	2	0	0	2	0	0
21	14825756	.	G	A	1	1	2	0	0	2	0	0
21	14828692	.	C	T	0	3	3	0	2	5	0	0
21	14828722	.	A	C	4	4	8	0	0	8	0	0
21	14828848	.	T	C	3	5	8	0	0	8	0	0
21	14828935	.	T	C	3	6	9	0	0	9	0	0
21	14829091	.	G	A	7	2	9	0	0	9	0	0
21	14829145	.	A	G	2	3	5	0	0	5	0	0
21	14831911	.	A	G	2	2	4	0	0	4	0	0
21	14831929	.	T	C	1	0	1	0	3	4	0	0
21	14832141	.	C	T	2	2	4	0	0	4	0	0
21	14842944	.	T	C	0	2	2	0	0	2	0	0
21	14843085	.	C	T	1	0	1	0	0	1	0	0
21	14846607	.	T	C	8	7	15	0	0	15	0	0
21	14848426	.	A	C	6	9	15	0	1	16	0	0
21	14848427	.	T	A	6	10	16	0	0	16	0	0
21	14859396	.	C	T	7	12	19	0	1	20	0	0
21	14859447	.	A	C	2	4	6	0	0	6	0	0
21	14862981	.	G	A	5	3	8	0	0	8	0	0
21	14877995	.	C	T	0	8	8	0	8	16	0	0
21	14892293	.	A	T	1	3	4	0	0	4	0	0
21	14904837	.	G	A	2	4	6	0	0	6	0	0
21	14909372	.	C	G	1	1	2	0	0	2	0	0
21	14913330	.	G	C	1	1	2	0	0	2	0	0
21	14921242	.	G	A	0	1	1	0	0	1	0	0
21	14939576	.	G	A	0	2	2	0	0	2	0	0
21	15125661	.	G	A	16	12	28	0	1	29	0	0
21	15125667	.	G	A	16	11	27	0	0	27	0	0
21	15125825	.	T	C	12	0	12	0	6	18	0	0
21	15125859	.	T	C	17	9	26	0	2	28	0	0
21	15125867	.	C	T	18	9	27	0	2	29	0	0
21	15126048	.	G	A	11	7	18	0	2	20	0	0
21	15126068	.	G	T	10	8	18	0	0	18	0	0
21	15126088	.	G	A	12	6	18	0	2	20	0	0
21	15154547	.	A	T	17	18	35	0	1	36	0	0
21	15154625	.	A	G	14	13	27	0	0	27	0	0
21	15230556	.	C	T	0	16	16	0	19	35	0	0
21	15234284	.	T	A	24	19	43	0	4	47	0	0
21	15252402	.	G	A	8	10	18	0	2	20	0	0
21	15252491	.	C	A	1	5	6	0	8	14	0	0
21	15260170	.	A	C	2	0	2	0	1	3	0	0
21	15263962	.	C	T	0	3	3	0	2	5	0	0
21	17192901	.	C	A	1	2	3	0	1	4	0	0
21	17192940	.	C	T	6	11	17	0	0	17	0	0
21	17246756	.	G	A	5	7	12	0	0	12	0	0
21	17253496	.	T	C	0	0	0	0	2	2	0	0
21	17255773	.	C	T	5	5	10	0	0	10	0	0
21	17255815	.	C	G	5	5	10	0	0	10	0	0
21	17256590	.	A	C	14	11	25	0	2	27	0	0
21	17256656	.	A	G	7	3	10	0	0	10	0	0
21	17258362	.	A	G	13	9	22	0	0	22	0	0
21	17258421	.	T	A	14	9	23	0	1	24	0	0
21	17258486	.	C	T	10	17	27	0	0	27	0	0
21	17258576	.	T	G	6	11	17	0	1	18	0	0
21	17258670	.	A	G	4	0	4	0	10	14	0	0
21	17258771	.	G	A	0	14	14	0	6	20	0	0
21	17258784	.	A	C	6	13	19	0	0	19	0	0
21	17258842	.	A	G	3	5	8	0	0	8	0	0
21	17259081	.	C	G	11	9	20	0	1	21	0	0
21	17259279	.	G	T	1	7	8	0	6	14	0	0
21	17259332	.	T	C	6	11	17	0	0	17	0	0
21	17259466	.	A	T	11	5	16	0	0	16	0	0
21	17260532	.	C	G	7	3	10	0	1	11	0	0
21	17307144	.	C	T	1	2	3	0	0	3	0	0
21	17313776	.	G	A	2	2	4	0	0	4	0	0
21	17322472	.	G	A	0	4	4	0	1	5	0	0
21	17322478	.	C	A	0	1	1	0	1	2	0	0
21	17325413	.	G	A	2	3	5	0	0	5	0	0
21	17325965	.	G	A	2	3	5	0	0	5	0	0
21	17327264	.	A	G	7	0	7	0	5	13	1	0
21	17327293	.	A	G	4	0	4	0	9	13	0	0
21	17327518	.	T	A	2	3	5	0	0	5	0	0
21	17327524	.	G	A	2	3	5	0	0	5	0	0
21	17327599	.	C	T	2	3	5	0	0	5	0	0
21	17335595	.	T	C	3	2	5	0	1	6	0	0
21	17335709	.	C	T	5	2	7	0	0	7	0	0
21	17337807	.	C	T	11	7	18	0	4	22	0	0
21	17337865	.	C	T	4	9	13	0	0	13	0	0
21	17337898	.	A	T	3	9	12	0	1	13	0	0
21	17338101	.	A	C	10	16	26	0	1	27	0	0
21	17338141	.	T	G	7	17	24	0	1	25	0	0
21	17338352	.	A	G	4	5	9	0	0	9	0	0
21	17338593	.	G	A	3	5	8	0	1	9	0	0
21	17339664	.	C	T	15	17	32	0	2	34	0	0
21	17339716	.	G	A	5	10	15	0	2	17	0	0
21	17419958	.	C	T	0	4	4	0	3	7	0	0
21	17420492	.	G	A	2	2	4	0	0	4	0	0
21	17420960	.	A	C	4	4	8	0	0	8	0	0
21	17478552	.	T	A	2	6	8	0	0	8	0	0
21	17478936	.	C	T	0	17	17	0	24	41	0	0
21	17480251	.	T	A	2	2	4	0	0	4	0	0
21	17482237	.	A	G	16	10	26	0	2	28	0	0
21	17549205	.	C	T	0	1	1	0	0	1	0	0
21	17567289	.	G	A	17	12	29	0	1	30	0	0
21	17567593	.	T	C	5	7	12	0	1	13	0	0
21	17567612	.	C	T	7	9	16	0	0	16	0	0
21	17567642	.	T	C	9	13	22	0	0	22	0	0
21	17567649	.	T	C	8	16	24	0	1	25	0	0
21	17567857	.	C	A	15	10	25	0	1	26	0	0
21	17567880	.	A	T	14	6	20	0	0	20	0	0
21	17567911	.	C	T	10	3	13	0	0	13	0	0
21	17567940	.	C	A	7	4	11	0	1	12	0	0
21	17567994	.	A	C	4	2	6	0	0	7	1	0
21	17568027	.	G	A	3	3	6	0	5	11	0	0
21	17568482	.	A	G	7	12	19	0	1	20	0	0
21	17568507	.	A	T	9	14	23	0	1	24	0	0
21	17568543	.	A	G	11	16	27	0	1	28	0	0
21	17568655	.	G	A	0	17	17	0	17	34	0	0
21	17568819	.	G	A	0	7	7	0	13	20	0	0
21	17568825	.	T	A	13	8	21	0	0	21	0	0
21	17569200	.	A	G	13	10	23	0	1	24	0	0
21	17569587	.	C	A	13	17	30	0	4	34	0	0
21	17569647	.	T	C	20	11	31	0	2	34	1	0
21	17569745	.	T	A	11	9	20	0	1	21	0	0
21	17569747	.	T	A	11	9	20	0	1	21	0	0
21	17569808	.	A	C	7	5	12	0	0	12	0	0
21	17569812	.	C	G	6	4	10	0	0	10	0	0
21	17572916	.	C	T	0	4	4	0	3	7	0	0
21	17572988	.	C	A	3	9	12	0	2	14	0	0
21	17577997	.	G	C	4	0	4	0	8	12	0	0
21	17578010	.	G	T	3	7	10	0	0	10	0	0
21	17578655	.	C	T	1	4	5	0	7	12	0	0
21	17578717	.	G	A	5	2	7	0	0	7	0	0
21	17580509	.	G	A	0	3	3	0	1	4	0	0
21	17580599	.	C	T	3	1	4	0	0	4	0	0
21	17587937	.	A	G	3	2	5	0	0	5	0	0
21	17587946	.	A	G	3	2	5	0	0	5	0	0
21	17603075	.	T	A	0	1	1	0	0	1	0	0
21	17603098	.	C	T	0	1	1	0	2	3	0	0
21	17910473	.	A	C	4	4	8	0	0	8	0	0
21	17944772	.	C	T	3	4	7	0	0	7	0	0
21	17984484	.	C	A	11	11	22	0	1	23	0	0
21	17984685	.	G	A	8	14	22	0	1	23	0	0
21	17984919	.	G	A	8	5	13	0	1	14	0	0
21	17984965	.	G	A	6	4	10	0	2	12	0	0
21	17985047	.	C	T	3	3	6	0	0	6	0	0
21	18013155	.	T	C	5	2	7	0	0	7	0	0
21	18023170	.	G	T	9	10	19	0	1	20	0	0
21	18023283	.	G	A	5	8	13	0	1	14	0	0
21	18023309	.	T	G	2	5	7	0	0	7	0	0
21	18023704	.	A	G	9	4	13	0	1	14	0	0
21	18023717	.	A	G	8	4	12	0	0	12	0	0
21	18024032	.	A	C	7	6	13	0	1	14	0	0
21	18024633	.	C	T	1	10	11	0	9	20	0	0
21	18032121	.	G	T	0	1	1	0	0	1	0	0
21	18032981	.	T	C	1	2	3	0	0	3	0	0
21	18062056	.	C	T	1	2	3	0	0	3	0	0
21	18065958	.	T	C	1	2	3	0	0	3	0	0
21	18266852	.	A	T	5	3	8	0	0	8	0	0
21	18269653	.	C	T	0	6	6	0	10	16	0	0
21	18269695	.	C	T	4	5	9	0	1	10	0	0
21	18271138	.	C	T	8	9	17	0	3	20	0	0
21	18271650	.	T	A	5	3	8	0	0	8	0	0
21	18272195	.	T	C	12	8	20	0	0	20	0	0
21	18272435	.	T	C	7	7	14	0	0	14	0	0
21	18272687	.	T	C	3	3	6	0	0	6	0	0
21	18273434	.	G	A	7	13	20	0	0	20	0	0
21	18273485	.	A	T	11	8	19	0	2	21	0	0
21	18276073	.	A	G	11	0	11	0	5	16	0	0
21	18286641	.	C	T	7	0	7	0	0	7	0	0
21	18289749	.	T	C	18	17	35	0	0	35	0	0
21	18289909	.	G	C	9	12	21	0	0	21	0	0
21	18370570	.	G	A	0	9	9	0	9	18	0	0
21	18372700	.	T	G	5	0	5	0	9	14	0	0
21	18372902	.	G	A	7	10	17	0	12	29	0	0
21	18375442	.	A	G	4	5	9	0	0	9	0	0
21	18375662	.	G	A	0	2	2	0	1	3	0	0
21	18382501	.	T	C	11	4	15	0	0	15	0	0
21	18385061	.	C	T	6	7	13	0	0	13	0	0
21	18386613	.	C	T	6	7	13	0	0	13	0	0
21	18386704	.	A	G	6	0	6	0	11	17	0	0
21	18386849	.	C	T	6	11	17	0	0	17	0	0
21	18600454	.	T	C	1	5	6	0	1	7	0	0
21	18600495	.	G	A	0	3	3	0	0	3	0	0
21	18600505	.	G	A	2	2	4	0	1	5	0	0
21	18600764	.	A	G	1	2	3	0	0	3	0	0
21	18600880	.	C	T	0	8	8	0	4	12	0	0
21	18602893	.	A	T	3	4	7	0	0	7	0	0
21	18604999	.	T	C	2	3	5	0	0	5	0	0
21	18616098	.	T	C	3	2	5	0	0	5	0	0
21	18701475	.	A	G	2	2	4	0	0	4	0	0
21	18760100	.	A	G	1	2	3	0	0	3	0	0
21	18760160	.	T	C	0	2	2	0	0	2	0	0
21	18823666	.	C	A	1	2	3	0	0	3	0	0
21	18921035	.	C	A	3	1	4	0	1	5	0	0
21	18921053	.	T	C	3	3	6	0	0	6	0	0
21	18921369	.	G	A	2	1	3	0	0	3	0	0
21	18922940	.	T	C	2	3	5	0	0	5	0	0
21	18923115	.	A	G	3	2	5	0	0	5	0	0
21	18924082	.	G	A	0	2	2	0	1	3	0	0
21	18924676	.	C	T	1	2	3	0	0	3	0	0
21	18924712	.	T	C	0	2	2	0	0	2	0	0
21	18925278	.	A	G	2	2	4	0	0	4	0	0
21	18925286	.	A	G	0	3	3	0	1	4	0	0
21	18925411	.	G	C	3	2	5	0	0	5	0	0
21	18929509	.	T	C	7	11	18	0	1	19	0	0
21	18932088	.	A	G	4	4	8	0	0	8	0	0
21	18932287	.	C	T	0	5	5	0	6	11	0	0
21	18932717	.	G	A	11	4	15	0	1	16	0	0
21	18933748	.	G	T	4	2	6	0	2	8	0	0
21	18934265	.	C	A	0	7	7	0	9	16	0	0
21	18934289	.	C	T	0	5	5	0	11	16	0	0
21	18938388	.	A	G	5	6	11	0	0	11	0	0
21	18938391	.	C	T	5	5	10	0	1	11	0	0
21	18950633	.	C	T	6	5	11	0	1	12	0	0
21	18950754	.	G	A	7	2	9	0	0	9	0	0
21	18950997	.	T	G	17	7	24	0	1	25	0	0
21	18956779	.	C	T	12	10	22	0	0	22	0	0
21	18956883	.	T	A	6	11	17	0	1	18	0	0
21	18957259	.	G	A	13	14	27	0	1	28	0	0
21	18957601	.	C	G	7	8	15	0	0	15	0	0
21	18957624	.	T	C	7	8	15	0	0	15	0	0
21	18957776	.	T	C	12	9	21	0	1	22	0	0
21	18958010	.	C	T	1	3	4	0	0	4	0	0
21	19005512	.	G	A	2	0	2	0	0	2	0	0
21	19008736	.	G	A	11	20	31	0	1	32	0	0
21	19008845	.	C	T	24	14	38	0	1	39	0	0
21	19009346	.	T	C	16	18	34	0	0	34	0	0
21	19014036	.	T	G	17	25	42	0	0	42	0	0
21	19014298	.	C	T	29	35	64	0	0	64	0	0
21	19015460	.	C	A	25	26	51	0	2	53	0	0
21	19015461	.	C	A	25	24	49	0	4	53	0	0
21	19017819	.	G	A	23	33	56	0	0	56	0	0
21	19018434	.	T	A	9	19	28	0	0	28	0	0
21	19061762	.	C	T	1	0	1	0	0	1	0	0
21	19067092	.	A	G	18	21	39	0	0	39	0	0
21	19071919	.	C	T	2	1	3	0	0	3	0	0
21	19073046	.	A	T	0	6	6	0	1	7	0	0
21	19073143	.	G	T	3	3	6	0	0	6	0	0
21	19329135	.	C	T	3	6	9	0	0	9	0	0
21	19329971	.	C	G	0	1	1	0	0	1	0	0
21	19333485	.	T	C	1	2	3	0	0	3	0	0
21	19341581	.	C	T	1	0	1	0	0	1	0	0
21	19342284	.	A	G	2	0	2	0	1	3	0	0
21	19345807	.	C	T	1	2	3	0	0	3	0	0
21	19347929	.	A	G	3	2	5	0	0	5	0	0
21	19347971	.	G	A	0	2	2	0	1	3	0	0
21	19353416	.	C	T	1	2	3	0	0	3	0	0
21	19602313	.	G	A	2	2	4	0	0	4	0	0
21	19602415	.	T	C	1	2	3	0	1	4	0	0
21	19602444	.	A	G	2	2	4	0	0	4	0	0
21	19602484	.	A	G	1	4	5	0	0	5	0	0
21	19603286	.	G	A	0	2	2	0	3	5	0	0
21	19603399	.	G	A	3	4	7	0	0	7	0	0
21	19607340	.	G	T	2	2	4	0	0	4	0	0
21	19763668	.	C	T	15	19	34	0	0	34	0	0
21	19763692	.	A	T	17	23	40	0	1	41	0	0
21	19763715	.	T	G	21	24	45	0	5	50	0	0
21	19763942	.	G	A	33	19	52	0	1	53	0	0
21	19764230	.	C	T	29	23	52	0	4	56	0	0
21	19764432	.	G	A	26	18	44	0	2	46	0	0
21	19785355	.	G	T	13	19	32	0	2	34	0	0
21	19785379	.	A	T	19	23	42	0	0	42	0	0
21	19790527	.	A	C	8	3	11	0	2	13	0	0
21	19790590	.	G	A	7	20	27	0	1	28	0	0
21	19792767	.	T	G	8	11	19	0	2	21	0	0
21	19792803	.	G	A	15	21	36	0	1	37	0	0
21	19796215	.	G	A	17	14	31	0	1	32	0	0
21	19804193	.	T	G	6	0	6	0	0	6	0	0
21	19805635	.	G	A	5	6	11	0	0	11	0	0
21	19805647	.	G	A	10	8	18	0	1	19	0	0
21	19809122	.	T	C	10	0	10	0	5	15	0	0
21	19820016	.	G	T	1	2	3	0	0	3	0	0
21	19821323	.	C	A	0	7	7	0	12	20	1	0
21	19821449	.	A	T	1	2	3	0	0	3	0	0
21	19868489	.	C	T	6	11	17	0	0	17	0	0
21	19868674	.	G	A	4	8	12	0	1	13	0	0
21	19869129	.	C	T	5	7	12	0	2	14	0	0
21	19872772	.	G	A	9	6	15	0	1	16	0	0
21	19872904	.	C	T	6	14	20	0	0	20	0	0
21	19903584	.	G	A	7	5	12	0	0	12	0	0
21	19904556	.	T	C	3	3	6	0	0	6	0	0
21	19904713	.	G	C	4	6	10	0	0	10	0	0
21	19905105	.	G	A	3	2	5	0	0	5	0	0
21	19905564	.	G	A	6	3	9	0	0	9	0	0
21	19905609	.	C	G	5	4	9	0	0	9	0	0
21	19905762	.	T	C	5	3	8	0	0	8	0	0
21	19905915	.	A	G	5	2	7	0	0	7	0	0
21	19906355	.	G	A	6	4	10	0	2	12	0	0
21	19906513	.	T	C	5	3	8	0	0	8	0	0
21	19906589	.	G	C	6	3	9	0	0	9	0	0
21	19906590	.	A	C	6	0	6	0	3	9	0	0
21	19906666	.	C	T	4	4	8	0	0	8	0	0
21	19911433	.	G	T	1	4	5	0	1	6	0	0
21	19911467	.	C	A	2	1	3	0	0	3	0	0
21	19913445	.	G	C	4	3	7	0	0	7	0	0
21	19914263	.	T	G	0	2	2	0	0	2	0	0
21	19915594	.	T	G	3	2	5	0	0	5	0	0
21	19915703	.	C	T	0	3	3	0	0	3	0	0
21	19915724	.	T	C	2	3	5	0	0	5	0	0
21	19926210	.	C	T	1	4	5	0	0	5	0	0
21	19926444	.	T	C	3	4	7	0	0	7	0	0
21	19929996	.	T	C	2	0	2	0	0	2	0	0
21	20035065	.	T	C	4	6	10	0	1	11	0	0
21	20067528	.	C	T	1	1	2	0	0	2	0	0
21	20067531	.	C	T	1	1	2	0	0	2	0	0
21	20080608	.	G	T	0	1	1	0	4	5	0	0
21	20086915	.	C	T	1	1	2	0	1	3	0	0
21	20089886	.	C	T	7	13	20	0	0	20	0	0
21	20101713	.	A	G	3	0	3	0	0	3	0	0
21	20105111	.	A	T	1	4	5	0	0	5	0	0
21	20105129	.	C	T	1	0	1	0	0	1	0	0
21	20106551	.	A	G	7	7	14	0	1	15	0	0
21	20108258	.	A	T	20	7	27	0	1	28	0	0
21	20108363	.	C	T	1	7	8	0	0	8	0	0
21	20113519	.	C	A	9	5	14	0	1	15	0	0
21	20113659	.	A	G	2	6	8	0	0	8	0	0
21	20114148	.	G	A	9	12	21	0	0	21	0	0
21	20118979	.	C	T	4	3	7	0	0	7	0	0
21	20120057	.	A	G	6	11	17	0	0	17	0	0
21	20120404	.	G	A	9	9	18	0	0	18	0	0
21	20339796	.	C	T	0	10	10	0	4	14	0	0
21	20341491	.	T	G	0	1	1	0	0	1	0	0
21	20341506	.	C	A	0	1	1	0	0	1	0	0
21	20377931	.	C	T	4	6	10	0	4	14	0	0
21	20377944	.	C	T	5	8	13	0	2	15	0	0
21	20393019	.	T	C	1	3	4	0	0	4	0	0
21	20394687	.	C	T	1	3	4	0	0	4	0	0
21	20394936	.	C	T	2	3	5	0	0	5	0	0
21	20633249	.	T	C	3	3	6	0	1	7	0	0
21	20633739	.	C	T	1	2	3	0	0	3	0	0
21	20635186	.	A	G	1	0	1	0	4	5	0	0
21	20635659	.	T	A	7	0	7	0	0	7	0	0
21	20636130	.	G	T	3	3	6	0	0	6	0	0
21	20636403	.	C	T	6	8	14	0	0	14	0	0
21	20715089	.	G	A	0	4	4	0	1	5	0	0
21	20909676	.	C	T	3	4	7	0	0	7	0	0
21	20922923	.	C	T	1	1	2	0	0	2	0	0
21	20950679	.	T	C	7	2	9	0	1	10	0	0
21	20950811	.	C	G	3	3	6	0	0	6	0	0
21	20950841	.	A	G	3	3	6	0	0	6	0	0
21	21013693	.	C	T	14	0	14	0	6	21	1	0
21	21017513	.	C	T	13	14	27	0	1	28	0	0
21	21020589	.	C	T	7	4	11	0	0	11	0	0
21	21029465	.	G	C	7	3	10	0	0	10	0	0
21	21038891	.	G	T	6	4	10	0	3	13	0	0
21	21039092	.	C	T	2	5	7	0	0	7	0	0
21	21046882	.	C	T	1	3	4	0	0	4	0	0
21	21046960	.	G	A	9	3	12	0	0	12	0	0
21	21048363	.	G	A	13	6	19	0	0	19	0	0
21	21049323	.	G	A	4	4	8	0	0	8	0	0
21	21051391	.	A	C	11	1	12	0	10	22	0	0
21	21051688	.	G	A	8	17	25	0	3	28	0	0
21	21065212	.	A	T	1	3	4	0	0	4	0	0
21	21069395	.	C	A	0	4	4	0	12	16	0	0
21	21069692	.	G	C	2	4	6	0	0	6	0	0
21	21069858	.	A	G	3	3	6	0	0	6	0	0
21	21072309	.	C	T	3	3	6	0	1	7	0	0
21	21075987	.	C	T	1	0	1	0	0	1	0	0
21	21076080	.	C	T	0	9	9	0	2	11	0	0
21	21170737	.	G	A	2	2	4	0	0	4	0	0
21	21177120	.	T	C	1	1	2	0	0	2	0	0
21	21210857	.	T	C	0	2	2	0	1	3	0	0
21	21216078	.	G	A	0	0	0	0	1	1	0	0
21	21217799	.	C	T	1	1	2	0	0	2	0	0
21	21217999	.	G	A	3	2	5	0	0	5	0	0
21	21221151	.	C	T	0	1	1	0	0	1	0	0
21	21228207	.	T	A	1	3	4	0	0	4	0	0
21	21230016	.	C	T	3	3	6	0	0	6	0	0
21	21230137	.	C	A	4	1	5	0	0	5	0	0
21	21232768	.	G	T	1	0	1	0	0	1	0	0
21	21233095	.	T	C	1	6	7	0	0	7	0	0
21	21233182	.	G	A	7	3	10	0	1	11	0	0
21	21233266	.	A	T	3	5	8	0	1	9	0	0
21	21233281	.	G	A	1	3	4	0	0	4	0	0
21	21233674	.	T	A	4	5	9	0	1	10	0	0
21	21234939	.	C	T	1	0	1	0	0	1	0	0
21	21236883	.	G	A	3	9	12	0	0	12	0	0
21	21236886	.	G	A	9	3	12	0	0	12	0	0
21	21238089	.	C	T	3	2	5	0	0	5	0	0
21	21238098	.	C	T	3	2	5	0	0	5	0	0
21	21239969	.	A	G	5	3	8	0	0	8	0	0
21	21239977	.	A	C	3	5	8	0	0	8	0	0
21	21240568	.	C	T	11	4	15	0	0	15	0	0
21	21240651	.	C	T	15	8	23	0	1	24	0	0
21	21240927	.	C	G	4	7	11	0	0	11	0	0
21	21241218	.	T	A	4	2	6	0	1	7	0	0
21	21241223	.	T	A	4	3	7	0	1	8	0	0
21	21241364	.	T	A	7	4	11	0	2	13	0	0
21	21241598	.	A	G	4	2	6	0	0	6	0	0
21	21241802	.	C	T	3	4	7	0	0	7	0	0
21	21241900	.	C	T	9	5	14	0	0	14	0	0
21	21242132	.	A	G	1	4	5	0	0	5	0	0
21	21264861	.	G	A	1	3	4	0	0	4	0	0
21	21269737	.	A	G	2	5	7	0	1	8	0	0
21	21273096	.	A	G	3	1	4	0	0	4	0	0
21	21277089	.	G	A	1	3	4	0	2	6	0	0
21	21277238	.	A	G	1	3	4	0	0	4	0	0
21	21279262	.	G	T	1	8	9	0	7	16	0	0
21	21279360	.	A	G	4	0	4	0	10	14	0	0
21	21279368	.	G	A	1	5	6	0	9	15	0	0
21	21279791	.	T	C	2	2	4	0	0	4	0	0
21	21286183	.	G	C	0	2	2	0	0	2	0	0
21	21294260	.	C	T	16	7	23	0	0	23	0	0
21	21294272	.	C	T	18	5	23	0	0	23	0	0
21	21294299	.	C	T	16	8	24	0	1	25	0	0
21	21294362	.	A	G	2	0	2	0	4	6	0	0
21	21295195	.	A	C	1	0	1	0	0	1	0	0
21	21298158	.	G	T	10	5	15	0	0	15	0	0
21	21298340	.	G	A	9	17	26	0	2	28	0	0
21	21298387	.	A	G	9	1	10	0	12	22	0	0
21	21313543	.	G	A	1	4	5	0	0	5	0	0
21	21314012	.	G	A	0	1	1	0	0	1	0	0
21	21314061	.	A	G	2	1	3	0	1	4	0	0
21	21325628	.	T	G	6	6	12	0	0	12	0	0
21	21326118	.	C	A	5	2	7	0	1	8	0	0
21	21326139	.	C	T	6	2	8	0	0	8	0	0
21	21326220	.	A	C	1	1	2	0	0	2	0	0
21	21326222	.	A	G	0	1	1	0	1	2	0	0
21	21333080	.	T	G	2	1	3	0	0	3	0	0
21	21339410	.	A	T	4	2	6	0	0	6	0	0
21	21342595	.	A	G	2	8	10	0	1	11	0	0
21	21343266	.	A	G	3	5	8	0	0	8	0	0
21	21346850	.	C	T	11	18	29	0	1	30	0	0
21	21347039	.	G	A	7	3	10	0	1	11	0	0
21	21347053	.	T	A	9	2	11	0	1	12	0	0
21	21347180	.	G	C	10	7	17	0	1	18	0	0
21	21368363	.	A	G	9	17	26	0	1	27	0	0
21	21370406	.	T	C	7	0	7	0	3	10	0	0
21	21372874	.	T	A	12	9	21	0	4	25	0	0
21	21450574	.	C	T	7	8	15	0	0	15	0	0
21	21450789	.	G	C	3	2	5	0	0	5	0	0
21	21451013	.	T	C	9	0	9	0	5	14	0	0
21	21451025	.	C	A	8	4	12	0	1	13	0	0
21	21523303	.	T	A	5	6	11	0	0	11	0	0
21	21523344	.	A	G	4	6	10	0	1	11	0	0
21	21523465	.	A	G	3	2	5	0	0	5	0	0
21	21523612	.	G	T	2	1	3	0	0	3	0	0
21	21527417	.	A	G	3	4	7	0	0	7	0	0
21	21633459	.	A	T	0	3	3	0	0	3	0	0
21	21633774	.	G	A	2	3	5	0	0	5	0	0
21	21640565	.	G	A	1	2	3	0	0	3	0	0
21	21744345	.	T	C	2	1	3	0	0	3	0	0
21	21745654	.	G	A	1	6	7	0	0	7	0	0
21	21746132	.	G	A	0	6	6	0	4	10	0	0
21	21746136	.	G	T	4	6	10	0	0	10	0	0
21	21750684	.	T	C	2	0	2	0	0	2	0	0
21	21750702	.	A	G	3	2	5	0	0	5	0	0
21	21754470	.	T	C	5	8	13	0	0	13	0	0
21	21754624	.	G	A	6	3	9	0	0	9	0	0
21	21791917	.	T	C	3	2	5	0	1	6	0	0
21	21791934	.	A	T	4	4	8	0	0	8	0	0
21	21793873	.	A	C	2	6	8	0	0	8	0	0
21	21793903	.	C	T	4	6	10	0	1	11	0	0
21	21794443	.	G	A	1	2	3	0	0	3	0	0
21	21820136	.	A	G	3	2	5	0	0	5	0	0
21	21996637	.	G	A	3	5	8	0	0	8	0	0
21	22030596	.	A	G	2	0	2	0	1	3	0	0
21	22038369	.	T	C	4	9	13	0	0	13	0	0
21	22044690	.	T	A	16	7	23	0	0	23	0	0
21	22048143	.	G	A	10	13	23	0	3	26	0	0
21	22070486	.	A	G	2	1	3	0	0	3	0	0
21	22070522	.	C	T	9	4	13	0	0	13	0	0
21	22070591	.	G	A	1	9	10	0	13	23	0	0
21	22070633	.	C	T	5	7	12	0	2	14	0	0
21	22073477	.	A	G	0	3	3	0	0	3	0	0
21	22082184	.	C	T	19	16	35	0	1	36	0	0
21	22082257	.	C	T	14	12	26	0	4	30	0	0
21	22099610	.	A	G	8	6	14	0	0	14	0	0
21	22099698	.	A	G	23	22	45	0	1	46	0	0
21	22099727	.	A	G	25	25	50	0	1	51	0	0
21	22099869	.	G	A	30	32	62	0	1	63	0	0
21	22100026	.	A	G	32	31	63	0	2	65	0	0
21	22100156	.	A	G	34	3	37	2	10	49	0	0
21	22100453	.	C	T	28	28	56	0	4	60	0	0
21	22100511	.	G	A	34	14	48	0	0	48	0	0
21	22100594	.	A	G	27	28	55	0	2	57	0	0
21	22100767	.	C	T	31	27	58	0	4	62	0	0
21	22101056	.	C	A	27	19	46	0	2	48	0	0
21	22101423	.	C	T	4	23	27	0	30	57	0	0
21	22101460	.	C	T	36	9	45	0	1	46	0	0
21	22101540	.	G	A	31	29	60	0	0	60	0	0
21	22101637	.	T	C	29	4	33	0	20	53	0	0
21	22101769	.	A	G	22	21	43	0	5	48	0	0
21	22101777	.	G	A	24	23	47	0	3	50	0	0
21	22101827	.	C	G	10	22	32	0	26	58	0	0
21	22101835	.	C	T	32	24	56	0	0	56	0	0
21	22101917	.	A	T	36	24	60	0	4	64	0	0
21	22102037	.	G	A	18	31	49	0	0	49	0	0
21	22102154	.	C	A	26	20	46	0	3	49	0	0
21	22102281	.	A	C	20	29	49	0	2	52	1	0
21	22102361	.	C	G	20	30	50	0	0	50	0	0
21	22102365	.	A	T	20	29	49	0	0	50	1	0
21	22102416	.	C	T	2	34	36	0	19	55	0	0
21	22102440	.	A	C	17	32	49	0	0	49	0	0
21	22102457	.	A	C	14	25	39	0	2	41	0	0
21	22102542	.	C	T	14	28	42	0	1	43	0	0
21	22102586	.	C	A	13	32	45	0	0	45	0	0
21	22102653	.	A	G	7	29	36	0	0	36	0	0
21	22102838	.	T	G	21	25	46	0	0	46	0	0
21	22102930	.	C	T	27	27	54	0	0	54	0	0
21	22110288	.	T	C	9	2	11	0	7	18	0	0
21	22110303	.	G	A	7	5	12	0	0	12	0	0
21	22111880	.	G	A	4	7	11	0	0	11	0	0
21	22111982	.	C	A	6	8	14	0	0	14	0	0
21	22132862	.	C	G	4	0	4	0	5	9	0	0
21	22135934	.	G	A	0	4	4	0	4	8	0	0
21	22140937	.	C	A	2	2	4	0	0	4	0	0
21	22142362	.	A	G	6	4	10	0	0	10	0	0
21	22142820	.	G	A	0	8	8	0	6	14	0	0
21	22210511	.	C	T	1	2	3	0	1	4	0	0
21	22330468	.	C	A	2	2	4	0	0	4	0	0
21	22336365	.	C	T	1	1	2	0	0	2	0	0
21	22347502	.	C	T	1	4	5	0	0	5	0	0
21	22347507	.	T	A	1	4	5	0	0	5	0	0
21	22347765	.	C	T	3	4	7	0	0	7	0	0
21	22387140	.	T	A	1	4	5	0	0	5	0	0
21	22387556	.	G	T	2	2	4	0	0	4	0	0
21	22394785	.	T	C	1	2	3	0	0	3	0	0
21	22404852	.	T	C	1	4	5	0	2	7	0	0
21	22404855	.	T	C	3	3	6	0	1	7	0	0
21	22405045	.	T	C	2	5	7	0	0	7	0	0
21	22405232	.	T	A	5	2	7	0	0	7	0	0
21	22406755	.	T	C	1	5	6	0	0	6	0	0
21	22407000	.	T	C	3	1	4	0	0	4	0	0
21	22410965	.	T	A	1	4	5	0	0	5	0	0
21	22412343	.	C	T	18	12	30	0	1	31	0	0
21	22421867	.	T	G	9	12	21	0	0	21	0	0
21	22422052	.	A	G	13	21	34	0	0	34	0	0
21	22422184	.	A	G	4	13	17	0	0	17	0	0
21	22422565	.	C	G	9	7	16	0	0	16	0	0
21	22422733	.	A	G	5	6	11	0	0	11	0	0
21	22880016	.	A	T	1	15	16	0	0	16	0	0
21	25045315	.	A	G	2	12	14	0	0	14	0	0
21	25103676	.	T	A	4	11	15	0	0	15	0	0
21	26545683	.	T	C	3	2	5	0	0	5	0	0
21	30010042	.	T	C	0	2	2	0	0	2	0	0
21	30019156	.	A	C	4	2	6	0	2	8	0	0
21	30270012	.	T	G	0	5	5	0	7	12	0	0
21	30270015	.	C	G	0	1	1	0	12	13	0	0
21	30692632	.	A	G	2	4	6	0	0	6	0	0
21	32281076	.	G	A	7	4	11	0	0	11	0	0
21	32281122	.	G	A	8	12	20	0	0	20	0	0
21	32281155	.	G	A	9	12	21	0	0	21	0	0
21	32283519	.	G	A	2	3	5	0	0	5	0	0
21	32284398	.	A	G	4	6	10	0	0	10	0	0
21	32285080	.	C	T	4	2	6	0	2	8	0	0
21	32285135	.	T	C	4	0	4	0	4	8	0	0
21	32285161	.	A	G	6	3	9	0	0	9	0	0
21	32342458	.	G	A	2	2	4	0	0	4	0	0
21	32343230	.	C	A	4	2	6	0	0	6	0	0
21	32343248	.	C	A	8	4	12	0	0	12	0	0
21	32343316	.	T	A	17	13	30	0	2	32	0	0
21	32343453	.	C	T	13	12	25	0	1	26	0	0
21	32343577	.	T	C	8	10	18	0	1	19	0	0
21	32343649	.	C	A	9	11	20	0	1	21	0	0
21	32343721	.	T	G	4	0	4	0	12	16	0	0
21	32344021	.	C	A	10	13	23	0	1	24	0	0
21	32345162	.	T	C	9	4	13	0	0	13	0	0
21	32345318	.	G	A	1	6	7	0	4	11	0	0
21	32345499	.	A	G	4	11	15	0	1	16	0	0
21	32345607	.	C	T	10	9	19	0	0	19	0	0
21	32345724	.	A	G	2	6	8	0	2	10	0	0
21	32345749	.	A	G	2	6	8	0	0	8	0	0
21	32345774	.	A	T	5	8	13	0	0	13	0	0
21	32345827	.	C	A	6	3	9	0	1	10	0	0
21	32346021	.	A	C	2	3	5	0	1	6	0	0
21	32346273	.	G	A	15	16	31	0	0	31	0	0
21	32346603	.	G	C	16	15	31	0	0	31	0	0
21	32346630	.	T	C	9	15	24	0	1	25	0	0
21	32346674	.	T	A	14	10	24	0	0	24	0	0
21	32346689	.	A	G	11	6	17	0	3	20	0	0
21	32346799	.	G	A	13	10	23	0	1	24	0	0
21	32346800	.	T	A	14	10	24	0	0	24	0	0
21	32346899	.	A	G	20	11	31	0	0	31	0	0
21	32346901	.	A	G	19	10	29	0	2	31	0	0
21	32347134	.	T	A	16	23	39	0	1	40	0	0
21	32347569	.	G	T	14	14	28	0	0	28	0	0
21	32347855	.	T	C	17	9	26	0	2	28	0	0
21	32347966	.	A	C	10	0	10	0	13	23	0	0
21	32348230	.	A	T	10	9	19	0	1	20	0	0
21	32348321	.	C	A	2	2	4	0	0	4	0	0
21	32348512	.	G	T	10	9	19	0	2	21	0	0
21	32348542	.	A	T	8	12	20	0	0	20	0	0
21	32348570	.	C	T	8	10	18	0	0	18	0	0
21	32348600	.	C	T	9	14	23	0	1	24	0	0
21	32348664	.	G	A	10	16	26	0	1	27	0	0
21	32353049	.	G	A	2	8	10	0	0	10	0	0
21	32354980	.	A	G	7	12	19	0	2	21	0	0
21	32374460	.	A	T	8	13	21	0	0	21	0	0
21	32457785	.	T	C	8	13	21	0	0	21	0	0
21	32457923	.	C	A	7	18	25	0	2	27	0	0
21	32457931	.	T	G	9	19	28	0	1	29	0	0
21	32457983	.	G	A	20	15	35	0	0	35	0	0
21	32458261	.	A	G	16	23	39	0	0	39	0	0
21	32458315	.	T	A	17	17	34	0	1	35	0	0
21	32460782	.	G	C	1	3	4	0	0	4	0	0
21	32460912	.	A	G	10	16	26	0	0	26	0	0
21	32466140	.	G	C	7	5	12	0	0	12	0	0
21	32467660	.	A	G	11	11	22	0	1	23	0	0
21	32467724	.	T	C	24	15	39	0	3	42	0	0
21	32476760	.	A	G	29	21	50	0	1	51	0	0
21	32477584	.	T	C	30	14	44	0	2	46	0	0
21	32477967	.	C	T	24	20	44	0	2	46	0	0
21	32477987	.	A	T	23	16	39	0	6	46	1	0
21	32478227	.	G	T	19	6	25	0	1	26	0	0
21	32482797	.	C	T	4	11	15	0	2	17	0	0
21	32482854	.	T	C	19	4	23	0	25	48	0	0
21	32523607	.	C	T	3	3	6	0	0	6	0	0
21	32552555	.	A	T	2	1	3	0	0	3	0	0
21	32758254	.	G	A	10	9	19	0	1	20	0	0
21	32758351	.	C	T	13	3	16	0	2	18	0	0
21	32758584	.	G	A	14	14	28	0	1	29	0	0
21	32759129	.	G	A	12	3	15	0	0	15	0	0
21	32759421	.	C	T	16	8	24	0	0	24	0	0
21	32766389	.	G	A	13	5	18	0	2	20	0	0
21	32772450	.	G	A	2	1	3	0	0	3	0	0
21	33058940	.	G	C	9	4	13	0	0	13	0	0
21	33066214	.	T	G	3	2	5	0	0	5	0	0
21	33069896	.	A	G	2	0	2	0	0	2	0	0
21	33211243	.	A	G	5	2	7	0	0	7	0	0
21	33211506	.	T	A	8	11	19	0	1	20	0	0
21	33211568	.	C	T	7	7	14	0	1	15	0	0
21	33211664	.	T	G	11	7	18	0	2	20	0	0
21	33211809	.	A	T	11	6	17	0	1	18	0	0
21	33213315	.	C	T	7	5	12	0	1	13	0	0
21	33213384	.	G	A	3	3	6	0	0	6	0	0
21	33218312	.	T	C	4	4	8	0	0	8	0	0
21	33218405	.	G	A	6	8	14	0	0	14	0	0
21	33447251	.	A	G	7	9	16	0	1	17	0	0
21	33463486	.	A	G	1	0	1	0	0	1	0	0
21	34001982	.	C	T	14	4	18	0	2	20	0	0
21	34002041	.	C	A	13	10	23	0	0	23	0	0
21	34002154	.	A	C	10	13	23	0	0	23	0	0
21	34002155	.	A	T	10	13	23	0	0	23	0	0
21	34002333	.	T	C	5	6	11	0	0	11	0	0
21	34002455	.	G	A	3	10	13	0	0	13	0	0
21	34002507	.	A	G	6	11	17	0	1	18	0	0
21	34026657	.	T	C	1	4	5	0	0	5	0	0
21	34031232	.	G	A	4	9	13	0	0	13	0	0
21	34057611	.	T	G	7	4	11	0	1	12	0	0
21	34074618	.	A	G	2	10	12	0	1	13	0	0
21	34074684	.	G	A	2	5	7	0	0	7	0	0
21	34074712	.	T	C	2	4	6	0	1	7	0	0
21	34098048	.	C	T	1	2	3	0	0	3	0	0
21	34103275	.	G	A	0	2	2	0	2	4	0	0
21	34114410	.	G	A	3	1	4	0	0	4	0	0
21	34128660	.	A	G	3	8	11	0	0	11	0	0
21	34129007	.	C	G	2	0	2	0	4	6	0	0
21	34129073	.	G	C	8	14	22	0	3	25	0	0
21	34129195	.	G	T	12	13	25	0	0	25	0	0
21	34129279	.	A	G	12	23	35	0	2	37	0	0
21	34129629	.	A	G	1	3	4	0	1	5	0	0
21	34199704	.	T	C	5	3	8	0	0	8	0	0
21	34210970	.	G	A	5	6	11	0	0	11	0	0
21	34211206	.	T	C	6	13	19	0	0	19	0	0
21	34211344	.	G	A	10	12	22	0	0	22	0	0
21	34211418	.	G	A	1	8	9	0	6	16	1	0
21	34211427	.	A	C	5	9	14	0	1	15	0	0
21	34211511	.	A	T	8	5	13	0	1	14	0	0
21	34364595	.	G	A	11	4	15	0	0	15	0	0
21	34364774	.	G	A	2	2	4	0	0	4	0	0
21	34364962	.	G	T	8	8	16	0	2	18	0	0
21	34391104	.	C	T	9	9	18	0	1	19	0	0
21	34391155	.	T	C	0	3	3	0	1	4	0	0
21	34392786	.	C	T	2	2	4	0	0	4	0	0
21	34392828	.	G	T	9	9	18	0	0	18	0	0
21	34424116	.	A	G	6	9	15	0	1	16	0	0
21	34714359	.	G	A	0	6	6	0	4	10	0	0
21	34714403	.	C	A	5	8	13	0	0	13	0	0
21	34724797	.	G	A	8	3	11	0	0	11	0	0
21	34724956	.	C	T	0	6	6	0	0	6	0	0
21	34741120	.	T	C	0	2	2	0	0	2	0	0
21	34770460	.	G	A	2	2	4	0	0	4	0	0
21	34770483	.	G	A	2	2	4	0	0	4	0	0
21	34770510	.	C	T	2	2	4	0	0	4	0	0
21	34792896	.	G	A	1	5	6	0	0	6	0	0
21	34793224	.	C	T	15	9	24	0	0	24	0	0
21	34793405	.	C	T	10	12	22	0	1	23	0	0
21	34793660	.	T	A	7	6	13	0	0	13	0	0
21	34793694	.	T	C	4	10	14	0	0	14	0	0
21	34793753	.	A	C	9	5	14	0	1	15	0	0
21	34793786	.	C	G	7	4	11	0	1	12	0	0
21	34826781	.	G	A	0	2	2	0	1	3	0	0
21	34826838	.	G	C	0	0	0	0	1	1	0	0
21	34834292	.	C	G	2	3	5	0	0	6	1	0
21	34834295	.	A	G	3	0	3	0	3	6	0	0
21	34834430	.	G	C	1	4	5	0	1	6	0	0
21	34834472	.	A	T	4	1	5	0	0	5	0	0
21	34834829	.	T	A	4	2	6	0	0	6	0	0
21	34849534	.	A	G	3	5	8	0	0	8	0	0
21	34851824	.	G	A	0	1	1	0	3	4	0	0
21	34856770	.	C	T	5	2	7	0	1	8	0	0
21	34878938	.	A	C	0	2	2	0	0	2	0	0
21	34981031	.	G	A	6	6	12	0	0	12	0	0
21	34987505	.	C	T	5	6	11	0	1	12	0	0
21	34987612	.	G	A	0	7	7	0	5	12	0	0
21	34987662	.	G	T	6	4	10	0	0	10	0	0
21	34987708	.	A	G	0	0	0	0	4	4	0	0
21	34987726	.	A	T	1	2	3	0	0	3	0	0
21	35009472	.	C	T	0	2	2	0	0	2	0	0
21	35010135	.	A	T	2	0	2	0	0	2	0	0
21	35013762	.	A	G	4	2	6	0	0	6	0	0
21	35025581	.	A	G	2	2	4	0	0	4	0	0
21	35025588	.	G	A	0	2	2	0	3	5	0	0
21	35033847	.	G	A	1	4	5	0	1	6	0	0
21	35033853	.	G	A	0	3	3	0	0	3	0	0
21	35035560	.	G	A	0	3	3	0	2	5	0	0
21	35040310	.	C	T	7	8	15	0	1	16	0	0
21	35040965	.	G	A	2	2	4	0	1	5	0	0
21	35048278	.	T	A	2	4	6	0	0	6	0	0
21	35048320	.	A	G	1	0	1	0	1	2	0	0
21	35055009	.	G	A	1	2	3	0	1	4	0	0
21	35279874	.	C	T	6	7	13	0	0	13	0	0
21	35280099	.	A	G	12	6	18	0	1	19	0	0
21	35280209	.	G	A	0	3	3	0	6	9	0	0
21	35280233	.	T	C	3	2	5	0	0	5	0	0
21	35280285	.	G	A	4	4	8	0	0	8	0	0
21	35280388	.	T	A	6	5	11	0	0	11	0	0
21	35280389	.	A	T	6	5	11	0	0	11	0	0
21	35280482	.	G	T	3	5	8	0	0	8	0	0
21	35280938	.	C	T	19	7	26	0	2	28	0	0
21	35281246	.	A	C	10	12	22	0	1	23	0	0
21	35302246	.	T	C	3	7	10	0	0	10	0	0
21	35327489	.	C	A	0	1	1	0	0	1	0	0
21	35382549	.	T	G	1	2	3	0	1	4	0	0
21	35652761	.	G	C	4	4	8	0	1	9	0	0
21	35653077	.	A	C	2	5	7	0	0	7	0	0
21	35653321	.	G	A	1	1	2	0	0	2	0	0
21	35831056	.	G	A	0	1	1	0	0	1	0	0
21	36386928	.	G	A	8	3	11	0	0	11	0	0
21	36387018	.	A	G	13	7	20	0	0	20	0	0
21	36387051	.	T	C	8	2	10	0	0	10	0	0
21	36407542	.	A	T	1	2	3	0	0	3	0	0
21	36417026	.	C	T	3	2	5	0	0	5	0	0
21	36419430	.	A	G	1	2	3	0	1	4	0	0
21	36430887	.	G	A	1	2	3	0	0	3	0	0
21	36435575	.	G	C	3	4	7	0	0	7	0	0
21	36435810	.	C	T	1	0	1	0	0	1	0	0
21	36435851	.	G	A	0	1	1	0	0	1	0	0
21	36435859	.	G	A	0	0	0	0	1	1	0	0
21	36442260	.	T	A	5	2	7	0	1	8	0	0
21	36442633	.	G	A	11	7	18	0	2	20	0	0
21	36446952	.	A	G	7	6	13	0	0	13	0	0
21	36449385	.	T	G	2	7	9	0	0	9	0	0
21	36449427	.	G	A	5	6	11	0	0	11	0	0
21	36449686	.	T	C	8	12	20	0	1	21	0	0
21	36449716	.	G	A	9	4	13	0	0	13	0	0
21	36468431	.	G	A	3	6	9	0	0	9	0	0
21	36474383	.	G	C	0	1	1	0	0	1	0	0
21	36474390	.	G	C	0	2	2	0	0	2	0	0
21	36489790	.	C	T	0	1	1	0	1	2	0	0
21	36496157	.	C	T	2	3	5	0	0	5	0	0
21	36496160	.	C	T	0	2	2	0	2	4	0	0
21	36501319	.	C	T	1	2	3	0	0	3	0	0
21	36525559	.	C	A	0	2	2	0	2	4	0	0
21	36525582	.	A	T	2	2	4	0	0	4	0	0
21	36570995	.	A	G	1	2	3	0	1	4	0	0
21	36571428	.	C	T	0	2	2	0	1	3	0	0
21	36571694	.	T	A	2	3	5	0	0	5	0	0
21	36592117	.	T	C	0	1	1	0	0	1	0	0
21	36592164	.	G	A	0	5	5	0	0	5	0	0
21	36592212	.	T	C	5	5	10	0	1	11	0	0
21	36598047	.	T	C	0	1	1	0	0	1	0	0
21	36598143	.	G	A	1	7	8	0	7	15	0	0
21	36598349	.	T	G	1	3	4	0	1	5	0	0
21	36598471	.	T	C	7	5	12	0	1	13	0	0
21	36598474	.	C	A	6	6	12	0	1	13	0	0
21	36598529	.	G	T	12	4	16	0	0	16	0	0
21	36598583	.	T	C	2	6	8	0	1	9	0	0
21	36598596	.	A	G	3	2	5	0	1	6	0	0
21	36598750	.	A	G	6	2	8	0	1	9	0	0
21	36598853	.	G	A	0	9	9	0	9	18	0	0
21	36598915	.	C	T	1	3	4	1	0	5	0	0
21	36599020	.	A	T	6	8	14	0	0	14	0	0
21	36599077	.	T	C	8	6	14	0	2	16	0	0
21	36599320	.	C	T	4	5	9	0	0	9	0	0
21	36599358	.	A	C	4	6	10	0	1	11	0	0
21	36599847	.	G	A	11	3	14	0	1	15	0	0
21	36599944	.	C	T	3	5	8	0	0	8	0	0
21	36600049	.	G	A	4	6	10	0	1	11	0	0
21	36600174	.	C	A	4	4	8	3	0	11	0	0
21	36612586	.	T	A	3	4	7	0	0	7	0	0
21	36612633	.	T	C	3	3	6	0	0	6	0	0
21	37107035	.	T	A	16	18	34	0	0	35	1	0
21	37107307	.	G	A	8	8	16	0	0	16	0	0
21	37107432	.	A	T	3	9	12	0	0	12	0	0
21	37107614	.	T	C	10	6	16	0	0	16	0	0
21	37107861	.	T	C	7	9	16	0	1	17	0	0
21	37108022	.	A	G	8	9	17	0	1	18	0	0
21	37108204	.	A	T	17	10	27	0	0	27	0	0
21	38013518	.	T	C	5	2	7	0	1	8	0	0
21	38013631	.	T	C	3	4	7	0	0	7	0	0
21	38013707	.	T	C	3	2	5	0	0	5	0	0
21	38013863	.	T	C	1	2	3	0	0	3	0	0
21	38587378	.	T	C	9	12	21	0	0	21	0	0
21	40354884	.	A	G	3	1	4	0	0	4	0	0
21	40354894	.	A	T	3	2	5	0	0	5	0	0
21	40355102	.	G	A	6	6	12	0	1	13	0	0
21	40355113	.	A	G	6	6	12	0	0	12	0	0
21	40355226	.	G	A	6	6	12	0	1	13	0	0
21	40355350	.	T	C	2	5	7	0	4	11	0	0
21	40355844	.	A	T	5	10	15	0	0	15	0	0
21	40355886	.	T	G	8	8	16	0	0	16	0	0
21	40355968	.	T	A	9	6	15	0	0	15	0	0
21	40356104	.	T	C	8	0	8	0	8	16	0	0
21	40364758	.	C	A	6	5	11	0	1	12	0	0
21	40365404	.	G	A	8	3	11	0	0	11	0	0
21	40369108	.	C	T	0	5	5	0	10	15	0	0
21	40373086	.	A	T	2	7	9	0	0	9	0	0
21	40373137	.	C	T	0	7	7	0	5	12	0	0
21	40373200	.	A	C	9	6	15	0	1	16	0	0
21	40373283	.	C	G	4	5	9	0	0	9	0	0
21	40373320	.	A	T	7	3	10	0	0	10	0	0
21	40376536	.	G	A	3	1	4	0	0	4	0	0
21	40377861	.	A	G	1	4	5	0	0	5	0	0
21	40382278	.	C	T	0	2	2	0	2	4	0	0
21	40386112	.	G	A	2	3	5	0	0	5	0	0
21	40386127	.	G	A	1	3	4	0	1	5	0	0
21	40387881	.	A	C	0	2	2	0	0	2	0	0
21	40403423	.	A	G	11	8	19	0	0	19	0	0
21	40403581	.	G	C	3	6	9	0	1	10	0	0
21	40406485	.	A	T	2	1	3	0	0	3	0	0
21	40406796	.	C	A	2	5	7	0	0	7	0	0
21	40411034	.	G	A	9	6	15	0	0	15	0	0
21	40411061	.	C	T	3	6	9	0	0	9	0	0
21	40452357	.	T	C	4	3	7	0	0	7	0	0
21	40464991	.	T	C	3	3	6	0	0	6	0	0
21	40466539	.	A	G	4	1	5	0	7	12	0	0
21	40466711	.	G	A	0	4	4	0	4	8	0	0
21	40467039	.	C	T	4	4	8	0	0	8	0	0
21	40467126	.	G	A	0	8	8	0	6	14	0	0
21	40474875	.	G	A	7	9	16	0	1	17	0	0
21	40475370	.	A	G	7	0	7	0	5	12	0	0
21	40475579	.	G	T	13	6	19	0	0	19	0	0
21	40475643	.	T	C	5	3	8	0	0	8	0	0
21	40530901	.	A	G	8	17	25	0	0	25	0	0
21	40531217	.	A	T	8	7	15	0	0	15	0	0
21	40531240	.	C	T	0	5	5	0	6	11	0	0
21	40531316	.	C	T	10	15	25	0	1	26	0	0
21	40531615	.	G	A	9	23	32	0	1	33	0	0
21	40531971	.	A	T	5	5	10	0	0	10	0	0
21	40531993	.	G	A	9	5	14	0	3	17	0	0
21	40532139	.	A	T	7	8	15	0	1	16	0	0
21	40532147	.	A	G	7	9	16	0	0	16	0	0
21	40532204	.	A	G	5	10	15	0	0	15	0	0
21	40532206	.	T	C	5	10	15	0	0	15	0	0
21	40532312	.	A	G	4	4	8	0	0	8	0	0
21	40532368	.	T	C	2	6	8	0	0	8	0	0
21	40532490	.	T	C	3	8	11	0	0	11	0	0
21	40532497	.	T	C	6	6	12	0	0	12	0	0
21	40532545	.	T	C	10	7	17	0	0	17	0	0
21	40532649	.	T	C	11	0	11	0	5	16	0	0
21	40532665	.	T	C	9	6	15	0	0	15	0	0
21	40532848	.	G	A	6	10	16	0	0	16	0	0
21	40532886	.	T	C	3	8	11	0	0	11	0	0
21	40532989	.	A	G	5	8	13	0	0	13	0	0
21	40532990	.	T	A	5	8	13	0	0	13	0	0
21	40533076	.	C	T	1	4	5	0	4	9	0	0
21	40533165	.	A	G	7	8	15	0	2	17	0	0
21	40533313	.	C	T	4	8	12	0	1	13	0	0
21	40533456	.	A	G	6	14	20	0	0	20	0	0
21	40537188	.	A	G	11	17	28	0	0	29	1	0
21	40546922	.	T	C	5	9	14	0	0	14	0	0
21	40547729	.	G	A	5	3	8	0	0	8	0	0
21	40553288	.	A	G	5	4	9	0	0	9	0	0
21	40553497	.	G	A	1	4	5	0	0	5	0	0
21	40553547	.	C	T	0	6	6	0	5	11	0	0
21	40562600	.	G	A	2	2	4	0	0	4	0	0
21	40671338	.	T	C	1	0	1	0	3	4	0	0
21	40673148	.	A	T	1	1	2	0	1	3	0	0
21	40673203	.	G	A	1	2	3	0	0	3	0	0
21	40675140	.	G	A	1	2	3	0	0	3	0	0
21	40685948	.	A	G	12	0	12	0	10	22	0	0
21	40685964	.	A	C	13	11	24	0	0	24	0	0
21	40685990	.	C	A	9	10	19	0	0	19	0	0
21	40686010	.	G	C	5	5	10	0	1	11	0	0
21	40686109	.	G	A	8	11	19	0	0	19	0	0
21	40686158	.	T	A	5	5	10	0	2	12	0	0
21	40686170	.	T	A	5	10	15	0	0	15	0	0
21	40691452	.	G	A	13	11	24	0	0	24	0	0
21	40691464	.	G	A	14	12	26	0	1	27	0	0
21	40703190	.	C	T	1	1	2	0	0	2	0	0
21	40703402	.	A	C	11	7	18	0	0	18	0	0
21	40703445	.	G	A	0	9	9	0	6	15	0	0
21	40708974	.	T	A	8	14	22	0	2	24	0	0
21	40708978	.	C	A	10	15	25	0	0	25	0	0
21	40731131	.	A	C	4	3	7	0	0	7	0	0
21	40731530	.	G	A	3	2	5	0	0	5	0	0
21	40930179	.	G	A	7	4	11	0	1	12	0	0
21	40930400	.	C	A	3	1	4	0	1	5	0	0
21	40930430	.	C	G	7	1	8	0	1	10	1	0
21	40930469	.	T	C	8	2	10	0	2	12	0	0
21	40930528	.	C	A	7	6	13	0	0	13	0	0
21	40930650	.	T	A	8	7	15	0	0	15	0	0
21	40930651	.	G	A	8	7	15	0	0	15	0	0
21	40931215	.	A	G	3	2	5	0	0	5	0	0
21	40931236	.	T	C	1	0	1	0	0	1	0	0
21	40932888	.	T	A	5	4	9	0	0	9	0	0
21	40934586	.	G	A	7	3	10	0	0	10	0	0
21	40934703	.	T	C	7	0	7	0	6	13	0	0
21	40936544	.	G	A	3	0	3	0	0	3	0	0
21	40936548	.	A	G	0	3	3	0	0	3	0	0
21	40944757	.	G	A	0	1	1	0	3	4	0	0
21	40959282	.	A	G	3	0	3	0	4	7	0	0
21	41028902	.	A	G	7	6	13	0	0	13	0	0
21	41029033	.	A	C	1	2	3	0	0	3	0	0
21	41029134	.	A	T	4	4	8	0	0	8	0	0
21	41029378	.	A	G	4	3	7	0	1	8	0	0
21	41034863	.	A	G	2	1	3	0	0	3	0	0
21	41039914	.	T	G	1	1	2	0	1	3	0	0
21	41040346	.	T	C	2	0	2	0	4	6	0	0
21	41046647	.	T	A	0	1	1	0	1	2	0	0
21	41046745	.	T	A	2	1	3	0	0	3	0	0
21	41046746	.	G	C	2	1	3	0	0	3	0	0
21	41049488	.	A	G	1	2	3	0	0	3	0	0
21	41060465	.	T	C	0	1	1	0	0	1	0	0
21	41256821	.	C	T	3	12	15	0	12	27	0	0
21	41257136	.	A	G	33	14	47	0	0	47	0	0
21	41257157	.	C	G	31	15	46	0	2	48	0	0
21	41257228	.	T	G	24	23	47	0	1	48	0	0
21	41257256	.	T	C	21	28	49	0	5	54	0	0
21	41257357	.	G	A	29	30	59	0	0	59	0	0
21	41257374	.	C	T	30	31	61	0	1	62	0	0
21	41257599	.	T	A	33	27	60	0	1	61	0	0
21	41293435	.	G	A	11	17	28	0	1	29	0	0
21	41305128	.	G	T	3	3	6	0	0	6	0	0
21	41305269	.	C	T	4	0	4	0	0	4	0	0
21	41305271	.	C	T	0	3	3	0	1	4	0	0
21	41311605	.	A	G	17	12	29	0	1	30	0	0
21	41311922	.	G	A	17	13	30	0	0	30	0	0
21	41312058	.	A	T	14	9	23	0	0	23	0	0
21	41312822	.	C	G	23	18	41	0	3	44	0	0
21	41313042	.	A	G	14	18	32	0	0	32	0	0
21	41313124	.	G	A	13	19	32	0	3	35	0	0
21	41313216	.	G	A	17	18	35	0	2	37	0	0
21	41313257	.	T	C	15	16	31	0	2	33	0	0
21	41316974	.	C	T	14	15	29	0	0	29	0	0
21	41323551	.	C	T	0	0	0	0	1	1	0	0
21	41599060	.	T	C	0	9	9	0	0	9	0	0
21	41599147	.	G	A	18	5	23	0	0	23	0	0
21	41599605	.	T	C	10	4	14	0	0	14	0	0
21	41600036	.	A	C	0	6	6	0	0	6	0	0
21	41600660	.	T	C	3	6	9	0	0	9	0	0
21	41600763	.	T	C	6	2	8	0	0	8	0	0
21	42046871	.	T	C	35	1	36	0	2	38	0	0
21	42046874	.	G	A	37	1	38	0	0	38	0	0
21	42046969	.	G	A	0	6	6	7	0	13	0	0
21	42051117	.	G	C	10	3	13	0	29	42	0	0
21	42971463	.	T	C	29	15	44	0	10	54	0	0
21	43420719	.	T	C	3	2	5	0	1	6	0	0
21	43461205	.	T	C	7	3	10	0	0	10	0	0
21	43461212	.	T	C	6	0	6	0	5	11	0	0
21	43476276	.	T	C	17	9	26	0	0	26	0	0
21	45352211	.	G	A	4	10	14	0	0	14	0	0
21	45352212	.	G	A	4	9	13	0	1	14	0	0
21	45551466	.	A	G	7	3	10	0	0	10	0	0
21	45715271	.	G	A	29	12	41	0	2	43	0	0
21	45768787	.	A	T	1	1	2	0	1	3	0	0
21	45768825	.	A	T	2	1	3	0	1	4	0	0
21	45838192	.	T	A	0	2	2	0	0	2	0	0
22	724757	.	T	C	0	21	21	3	0	24	0	0
22	860224	.	G	A	1	5	6	0	0	6	0	0
22	1837971	.	C	T	1	0	1	0	0	1	0	0
22	1946723	.	C	A	1	2	3	0	0	3	0	0
22	1954561	.	G	A	1	2	3	0	0	3	0	0
22	2411961	.	C	G	1	0	1	0	0	1	0	0
22	2411966	.	A	G	1	0	1	0	0	1	0	0
22	2627736	.	A	T	0	7	7	0	0	7	0	0
22	2653023	.	T	C	1	8	9	0	0	9	0	0
22	4747456	.	C	A	8	3	11	0	0	11	0	0
22	4952789	.	G	T	1	2	3	0	0	3	0	0
22	4962472	.	T	A	1	4	5	0	0	5	0	0
22	4962559	.	G	A	10	12	22	0	1	23	0	0
22	4962610	.	A	T	10	11	21	0	0	21	0	0
22	4962635	.	A	G	7	12	19	0	1	20	0	0
22	4962696	.	T	C	2	0	2	0	0	2	0	0
22	4962878	.	G	A	12	12	24	0	1	25	0	0
22	4968955	.	A	G	0	4	4	0	0	4	0	0
22	4969051	.	G	A	10	4	14	0	0	14	0	0
22	4970773	.	T	C	1	0	1	0	3	4	0	0
22	4970797	.	G	C	5	4	9	0	1	10	0	0
22	4972848	.	T	G	11	7	18	0	2	20	0	0
22	4972980	.	C	T	0	1	1	0	3	4	0	0
22	4975236	.	T	A	7	19	26	0	5	31	0	0
22	4977106	.	G	A	8	6	14	0	1	15	0	0
22	4985831	.	G	C	3	1	4	0	0	4	0	0
22	4985888	.	T	C	5	0	5	0	9	14	0	0
22	5056425	.	G	T	5	8	13	0	2	15	0	0
22	5056706	.	G	A	8	5	13	0	0	13	0	0
22	5056760	.	T	G	9	12	21	0	1	22	0	0
22	5056978	.	A	T	5	5	10	0	1	11	0	0
22	5057421	.	C	A	1	9	10	0	8	19	1	0
22	5057443	.	T	C	10	1	11	0	8	19	0	0
22	5057489	.	T	A	10	9	19	0	0	19	0	0
22	5057504	.	T	A	9	11	20	0	0	20	0	0
22	5059916	.	A	G	6	1	7	0	1	8	0	0
22	5060087	.	T	G	1	3	4	0	0	4	0	0
22	5060162	.	T	A	1	0	1	0	0	1	0	0
22	5062457	.	G	A	0	2	2	0	0	2	0	0
22	5075291	.	T	C	2	1	3	0	0	3	0	0
22	5075673	.	A	G	4	8	12	0	0	12	0	0
22	5075732	.	T	C	0	4	4	0	0	4	0	0
22	5087451	.	G	A	7	14	21	0	0	21	0	0
22	5087488	.	G	A	7	10	17	0	0	17	0	0
22	5090115	.	C	A	0	4	4	0	1	5	0	0
22	5098433	.	G	T	9	7	16	0	0	16	0	0
22	5112644	.	G	T	1	1	2	0	0	2	0	0
22	5112749	.	T	C	4	10	14	0	0	14	0	0
22	5112864	.	G	A	6	2	8	0	1	9	0	0
22	5112915	.	A	C	5	3	8	0	2	10	0	0
22	5114380	.	G	C	0	8	8	0	12	20	0	0
22	5116267	.	A	C	11	9	20	0	0	20	0	0
22	5118373	.	A	G	1	0	1	0	4	5	0	0
22	5118378	.	G	A	0	4	4	0	1	5	0	0
22	5118437	.	C	T	0	3	3	0	1	4	0	0
22	5121464	.	C	T	3	5	8	0	0	8	0	0
22	5121471	.	C	T	3	5	8	0	0	8	0	0
22	5121623	.	A	G	3	0	3	0	0	3	0	0
22	5144645	.	C	T	7	5	12	0	0	12	0	0
22	5144750	.	T	A	2	5	7	0	0	8	1	0
22	5144981	.	T	C	3	6	9	0	0	9	0	0
22	5145109	.	C	A	1	5	6	0	0	6	0	0
22	5145199	.	C	G	3	3	6	0	0	6	0	0
22	5229048	.	G	A	4	5	9	0	0	9	0	0
22	5229058	.	G	C	5	5	10	0	0	10	0	0
22	5229249	.	A	T	2	0	2	0	0	2	0	0
22	5229267	.	A	C	0	2	2	0	0	2	0	0
22	5756066	.	G	A	8	7	15	0	0	15	0	0
22	5756317	.	C	T	6	2	8	0	1	9	0	0
22	5756340	.	A	T	4	2	6	0	0	6	0	0
22	5758678	.	C	T	5	11	16	0	2	18	0	0
22	5758689	.	A	T	4	14	18	0	1	19	0	0
22	5761968	.	G	A	0	2	2	0	0	2	0	0
22	5763846	.	G	A	1	3	4	0	0	4	0	0
22	5763881	.	A	G	0	1	1	0	0	1	0	0
22	5773401	.	T	C	4	3	7	0	0	7	0	0
22	5773482	.	G	A	3	0	3	0	0	3	0	0
22	5777193	.	A	G	1	0	1	0	0	1	0	0
22	5908914	.	C	A	1	6	7	0	0	7	0	0
22	5908955	.	C	T	1	4	5	0	0	5	0	0
22	6029259	.	C	T	1	3	4	0	0	4	0	0
22	6073946	.	G	A	3	6	9	0	0	9	0	0
22	6073953	.	G	T	2	6	8	0	1	9	0	0
22	6074074	.	T	C	1	0	1	0	0	1	0	0
22	6074079	.	A	T	1	0	1	0	0	1	0	0
22	6075180	.	G	A	1	2	3	0	0	3	0	0
22	6075343	.	T	G	1	1	2	0	0	2	0	0
22	6075652	.	G	T	2	7	9	0	2	11	0	0
22	6075656	.	T	G	1	8	9	0	2	11	0	0
22	6075714	.	A	C	1	1	2	0	0	2	0	0
22	6077657	.	T	C	1	0	1	0	3	4	0	0
22	6078223	.	C	A	3	3	6	0	0	6	0	0
22	6078310	.	C	G	2	5	7	0	0	7	0	0
22	6099106	.	C	T	1	2	3	0	0	3	0	0
22	6300363	.	C	T	2	3	5	0	0	5	0	0
22	6300409	.	G	T	2	4	6	0	0	6	0	0
22	6300506	.	A	G	3	2	5	0	1	6	0	0
22	6300543	.	G	A	1	3	4	0	0	4	0	0
22	6487855	.	T	G	2	13	15	0	0	16	1	0
22	6487920	.	C	A	3	9	12	0	0	12	0	0
22	6487932	.	A	G	6	6	12	0	0	12	0	0
22	6488007	.	T	G	2	2	4	0	0	4	0	0
22	6488050	.	A	T	13	5	18	0	2	20	0	0
22	6488068	.	G	A	13	6	19	0	2	21	0	0
22	6488204	.	G	A	6	9	15	0	0	15	0	0
22	6488261	.	A	G	7	12	19	0	1	20	0	0
22	6488266	.	A	C	8	10	18	0	0	18	0	0
22	6488313	.	T	A	2	9	11	0	1	12	0	0
22	6488364	.	A	G	4	4	8	0	0	8	0	0
22	6488433	.	G	T	2	6	8	0	0	8	0	0
22	6488528	.	G	C	2	0	2	0	11	13	0	0
22	6488548	.	T	C	2	9	11	0	0	11	0	0
22	6488565	.	A	G	2	7	9	0	0	9	0	0
22	6488598	.	G	T	5	7	12	0	0	12	0	0
22	6494840	.	G	A	2	5	7	0	0	7	0	0
22	6494855	.	A	T	5	5	10	0	1	11	0	0
22	6527546	.	C	T	7	7	14	0	1	15	0	0
22	6527758	.	G	T	5	9	14	0	0	14	0	0
22	6528151	.	T	C	7	4	11	0	1	12	0	0
22	6528177	.	C	T	0	5	5	0	6	11	0	0
22	6528445	.	C	A	10	3	13	0	0	13	0	0
22	6528446	.	A	G	10	3	13	0	0	13	0	0
22	6528586	.	C	T	4	3	7	0	0	7	0	0
22	6529068	.	A	C	4	3	7	0	0	7	0	0
22	6546965	.	C	G	2	5	7	0	0	7	0	0
22	6547964	.	C	T	0	2	2	0	0	2	0	0
22	6547969	.	A	G	0	3	3	0	0	3	0	0
22	6548010	.	C	T	0	4	4	0	0	4	0	0
22	6548408	.	C	T	1	1	2	0	0	2	0	0
22	6548425	.	A	G	1	0	1	0	0	1	0	0
22	6562428	.	A	T	0	2	2	0	0	2	0	0
22	6562432	.	T	C	0	2	2	0	0	2	0	0
22	6996116	.	T	C	6	0	6	0	5	11	0	0
22	6996343	.	G	A	6	7	13	0	0	13	0	0
22	6998904	.	A	G	13	13	26	0	1	27	0	0
22	6998949	.	G	T	13	6	19	0	0	19	0	0
22	6998988	.	T	C	10	9	19	0	3	22	0	0
22	6999006	.	A	G	10	12	22	0	0	22	0	0
22	6999060	.	G	C	0	0	0	0	3	3	0	0
22	7001528	.	C	T	1	3	4	0	0	4	0	0
22	7001827	.	G	A	2	2	4	0	0	4	0	0
22	7003603	.	A	G	2	3	5	0	0	5	0	0
22	7006913	.	T	C	3	0	3	0	4	7	0	0
22	7009333	.	A	T	10	12	22	0	3	25	0	0
22	7009393	.	A	G	4	6	10	0	0	10	0	0
22	7009833	.	C	T	8	9	17	0	1	18	0	0
22	7009835	.	T	G	9	9	18	0	0	18	0	0
22	7009911	.	A	G	8	6	14	0	0	14	0	0
22	7009915	.	C	T	1	7	8	0	8	16	0	0
22	7010011	.	A	C	26	14	40	0	0	40	0	0
22	7010100	.	T	C	16	0	16	0	23	39	0	0
22	7010151	.	T	C	13	20	33	0	1	34	0	0
22	7012898	.	C	T	0	8	8	0	10	18	0	0
22	7012931	.	C	G	5	7	12	0	0	12	0	0
22	7016655	.	A	G	3	9	12	0	0	12	0	0
22	7018223	.	G	A	5	3	8	0	1	9	0	0
22	7019397	.	C	A	0	13	13	0	14	27	0	0
22	7044667	.	T	G	6	7	13	0	2	15	0	0
22	7044681	.	T	C	4	7	11	0	1	12	0	0
22	7045031	.	G	A	7	7	14	0	0	14	0	0
22	7045041	.	C	A	5	6	11	0	0	11	0	0
22	7045070	.	C	T	5	2	7	0	1	8	0	0
22	7045215	.	A	G	11	9	20	0	0	20	0	0
22	7056645	.	C	T	2	1	3	0	0	3	0	0
22	7128897	.	C	G	5	2	7	0	0	7	0	0
22	7129007	.	A	G	1	2	3	0	0	3	0	0
22	7129110	.	C	T	0	2	2	0	3	5	0	0
22	7129212	.	G	C	4	6	10	0	0	10	0	0
22	7359844	.	T	C	5	3	8	0	0	8	0	0
22	7400193	.	A	G	9	8	17	0	0	17	0	0
22	7526994	.	G	A	1	0	1	0	0	1	0	0
22	7676984	.	G	T	1	3	4	0	0	4	0	0
22	7683668	.	A	T	4	0	4	0	0	4	0	0
22	7683921	.	T	C	1	0	1	0	0	1	0	0
22	7971790	.	G	A	1	3	4	0	0	4	0	0
22	7972792	.	A	G	4	7	11	0	0	11	0	0
22	7972848	.	A	G	8	4	12	0	0	12	0	0
22	7972851	.	T	C	8	3	11	0	1	12	0	0
22	7974302	.	C	G	1	0	1	0	0	1	0	0
22	8074067	.	C	T	0	3	3	0	6	9	0	0
22	8074121	.	T	G	2	1	3	0	0	3	0	0
22	8161804	.	T	G	2	4	6	0	0	6	0	0
22	8161809	.	T	C	2	1	3	0	4	7	0	0
22	8162059	.	C	T	0	4	4	0	5	9	0	0
22	8163863	.	T	C	5	0	5	0	6	11	0	0
22	8163917	.	G	A	9	5	14	0	0	14	0	0
22	8164035	.	C	T	2	5	7	0	1	8	0	0
22	8240517	.	A	C	1	3	4	0	0	4	0	0
22	8240737	.	A	C	0	3	3	0	0	3	0	0
22	8240843	.	G	A	1	4	5	0	0	5	0	0
22	8240852	.	A	T	1	5	6	0	0	6	0	0
22	8240892	.	T	A	0	6	6	0	1	7	0	0
22	8240902	.	A	T	1	4	5	0	0	5	0	0
22	8245932	.	C	T	1	2	3	0	0	3	0	0
22	8245941	.	A	G	1	2	3	0	0	3	0	0
22	8246050	.	T	C	4	2	6	0	0	6	0	0
22	8296763	.	G	T	5	4	9	0	0	9	0	0
22	8339700	.	G	C	1	2	3	0	0	3	0	0
22	8339805	.	A	T	1	2	3	0	0	3	0	0
22	8340682	.	T	G	0	2	2	0	1	3	0	0
22	8341919	.	T	A	1	2	3	0	0	3	0	0
22	8583548	.	G	T	2	3	5	0	0	5	0	0
22	8634180	.	T	A	0	5	5	0	0	5	0	0
22	8638996	.	A	T	2	2	4	0	0	4	0	0
22	8715470	.	A	T	1	2	3	0	0	3	0	0
22	8715641	.	C	T	3	2	5	0	0	5	0	0
22	8769388	.	G	A	4	2	6	0	0	6	0	0
22	8769393	.	C	T	4	4	8	0	0	8	0	0
22	8769431	.	A	G	5	5	10	0	1	11	0	0
22	8769518	.	G	C	6	5	11	0	1	12	0	0
22	8769579	.	T	G	2	2	4	0	0	4	0	0
22	8769730	.	T	C	2	2	4	0	0	4	0	0
22	8769952	.	A	T	3	6	9	0	0	9	0	0
22	8769954	.	G	A	3	5	8	0	1	9	0	0
22	8770013	.	G	A	0	4	4	0	3	7	0	0
22	8770302	.	T	C	1	2	3	0	0	3	0	0
22	8784482	.	G	A	0	2	2	0	3	5	0	0
22	8784483	.	C	A	3	2	5	0	0	5	0	0
22	8784585	.	T	A	1	3	4	0	0	4	0	0
22	8785185	.	A	G	1	2	3	0	1	4	0	0
22	8785621	.	C	T	2	2	4	0	1	5	0	0
22	8785914	.	C	T	4	3	7	0	0	7	0	0
22	8785965	.	C	T	3	2	5	0	1	6	0	0
22	8785982	.	T	G	2	3	5	0	0	5	0	0
22	8786056	.	T	G	2	4	6	0	1	7	0	0
22	8786060	.	C	T	2	4	6	0	0	6	0	0
22	8786316	.	C	T	1	2	3	0	0	3	0	0
22	8786445	.	G	A	0	4	4	0	3	8	1	0
22	9029072	.	A	G	1	7	8	0	0	8	0	0
22	9057022	.	A	G	1	4	5	0	0	5	0	0
22	9057025	.	A	G	1	3	4	0	1	5	0	0
22	9371384	.	A	G	0	1	1	0	0	1	0	0
22	9379664	.	A	T	1	2	3	0	0	4	1	0
22	9472870	.	T	C	0	3	3	0	0	3	0	0
22	9472873	.	T	C	0	2	2	0	0	3	1	0
22	9481053	.	G	A	4	5	9	0	0	9	0	0
22	9481089	.	A	G	2	0	2	0	6	8	0	0
22	9484355	.	T	C	3	2	5	0	0	5	0	0
22	9490564	.	G	A	1	0	1	0	0	1	0	0
22	9490730	.	C	T	1	0	1	0	1	2	0	0
22	9496617	.	G	A	1	1	2	0	0	2	0	0
22	9503739	.	G	A	0	5	5	0	0	5	0	0
22	9504689	.	C	T	4	4	8	0	0	8	0	0
22	9504749	.	T	C	10	8	18	0	1	19	0	0
22	9508114	.	G	A	3	3	6	0	0	6	0	0
22	9509637	.	G	A	1	5	6	0	2	8	0	0
22	9512565	.	A	C	16	23	39	0	2	41	0	0
22	9512717	.	C	T	5	12	17	0	0	17	0	0
22	9512731	.	T	A	4	8	12	0	0	12	0	0
22	9512829	.	A	G	8	8	16	0	0	16	0	0
22	9513039	.	C	T	13	15	28	0	2	30	0	0
22	9523557	.	A	T	4	6	10	0	0	10	0	0
22	9525415	.	C	T	2	0	2	0	0	2	0	0
22	9526251	.	A	G	1	0	1	0	2	3	0	0
22	9527373	.	T	C	3	3	6	0	0	6	0	0
22	9530328	.	T	C	2	11	13	0	0	13	0	0
22	9530377	.	G	A	6	10	16	0	2	18	0	0
22	9530388	.	C	T	10	8	18	0	2	20	0	0
22	9530418	.	A	G	6	0	6	0	11	17	0	0
22	9532431	.	G	A	1	3	4	0	0	4	0	0
22	9532488	.	G	A	6	2	8	0	0	8	0	0
22	9534066	.	C	T	0	2	2	0	0	2	0	0
22	9534138	.	C	T	2	2	4	0	1	5	0	0
22	9535914	.	G	A	11	3	14	0	0	14	0	0
22	9535932	.	C	A	2	9	11	0	0	11	0	0
22	9537339	.	C	T	14	7	21	0	0	21	0	0
22	9537583	.	T	C	13	19	32	0	16	48	0	0
22	9537859	.	C	T	18	7	25	0	1	26	0	0
22	9591295	.	C	T	2	2	4	0	0	4	0	0
22	9835039	.	C	T	2	5	7	0	0	7	0	0
22	9835108	.	C	T	2	6	8	0	0	8	0	0
22	9835393	.	G	A	4	4	8	0	0	8	0	0
22	9835604	.	G	A	4	2	6	0	0	6	0	0
22	9835622	.	A	G	7	1	8	0	0	8	0	0
22	9835639	.	T	C	4	2	6	0	1	7	0	0
22	9835885	.	T	C	1	1	2	0	0	2	0	0
22	9835894	.	A	C	1	0	1	0	1	2	0	0
22	9835984	.	T	A	0	3	3	0	0	3	0	0
22	9835999	.	T	C	2	4	6	0	0	6	0	0
22	9858768	.	G	A	0	2	2	0	0	2	0	0
22	9858797	.	C	A	0	1	1	0	0	1	0	0
22	9877900	.	G	T	1	1	2	0	0	2	0	0
22	9877902	.	C	T	0	2	2	0	0	2	0	0
22	9877998	.	A	G	5	3	8	0	1	9	0	0
22	9887777	.	T	A	4	2	6	0	0	6	0	0
22	9887803	.	C	T	2	3	5	0	0	5	0	0
22	9887881	.	A	G	1	4	5	0	0	5	0	0
22	9887977	.	A	C	0	3	3	0	0	3	0	0
22	9888366	.	G	A	2	5	7	1	0	8	0	0
22	9888379	.	C	T	0	8	8	1	2	11	0	0
22	9888783	.	T	C	2	3	5	0	0	5	0	0
22	9893688	.	G	A	0	4	4	0	1	5	0	0
22	9893706	.	T	C	0	3	3	0	0	3	0	0
22	9893729	.	T	G	0	2	2	0	0	2	0	0
22	9894327	.	G	T	2	0	2	0	0	2	0	0
22	9894340	.	T	G	1	0	1	0	0	1	0	0
22	9896120	.	G	A	0	2	2	0	0	2	0	0
22	9898052	.	A	G	2	3	5	0	0	5	0	0
22	9898094	.	A	G	3	3	6	0	0	6	0	0
22	9898355	.	C	T	4	10	14	0	0	14	0	0
22	9898733	.	T	A	6	2	8	0	0	8	0	0
22	9899174	.	G	A	5	2	7	0	0	7	0	0
22	9899181	.	T	A	5	2	7	0	0	7	0	0
22	9899279	.	A	G	3	2	5	1	0	6	0	0
22	9899453	.	T	C	0	3	3	0	0	3	0	0
22	9899645	.	G	T	1	4	5	0	0	5	0	0
22	9899657	.	T	C	1	3	4	0	0	4	0	0
22	9926449	.	T	C	0	2	2	0	0	2	0	0
22	9926459	.	G	T	0	2	2	0	0	2	0	0
22	9926532	.	C	G	5	2	7	0	0	7	0	0
22	9933064	.	G	A	3	2	5	0	1	6	0	0
22	9933972	.	C	T	0	2	2	0	0	2	0	0
22	10019568	.	C	T	4	7	11	0	0	11	0	0
22	10019645	.	C	G	2	3	5	0	0	5	0	0
22	10019712	.	A	G	2	2	4	0	0	4	0	0
22	10039417	.	G	A	3	2	5	0	0	5	0	0
22	10039889	.	G	T	3	3	6	0	0	6	0	0
22	10040135	.	T	C	1	3	4	0	0	4	0	0
22	10045173	.	A	T	1	2	3	0	0	3	0	0
22	10045212	.	T	C	1	2	3	0	0	3	0	0
22	10048389	.	G	T	1	2	3	0	0	3	0	0
22	10048454	.	T	C	2	2	4	0	0	4	0	0
22	10049148	.	G	T	2	2	4	0	0	4	0	0
22	10049217	.	C	T	1	2	3	0	0	3	0	0
22	10054492	.	G	A	1	2	3	0	0	3	0	0
22	10054511	.	A	G	1	2	3	0	0	3	0	0
22	10071165	.	T	C	1	2	3	0	0	3	0	0
22	10123910	.	G	C	5	11	16	0	1	17	0	0
22	10123962	.	T	C	8	0	8	0	12	20	0	0
22	10123998	.	C	T	0	3	3	0	9	12	0	0
22	10129878	.	A	G	10	6	16	0	0	16	0	0
22	10159339	.	C	T	1	0	1	0	0	1	0	0
22	10162958	.	A	T	1	0	1	0	0	1	0	0
22	10178520	.	G	A	3	2	5	0	0	5	0	0
22	10184079	.	T	A	2	1	3	0	0	3	0	0
22	10189781	.	G	A	3	0	3	0	0	3	0	0
22	10190801	.	T	C	1	1	2	0	0	2	0	0
22	10196055	.	A	T	6	2	8	0	0	8	0	0
22	10196058	.	T	A	6	2	8	0	0	8	0	0
22	10196291	.	T	C	11	13	24	0	0	24	0	0
22	10196297	.	A	T	12	10	22	0	1	23	0	0
22	10196330	.	C	T	7	6	13	0	1	14	0	0
22	10196468	.	A	T	11	11	22	0	0	22	0	0
22	10196483	.	A	G	12	9	21	0	0	21	0	0
22	10196508	.	T	A	8	7	15	0	0	15	0	0
22	10196634	.	C	T	7	14	21	0	2	23	0	0
22	10196813	.	A	G	8	0	8	0	22	30	0	0
22	10196821	.	C	T	21	8	29	0	2	31	0	0
22	10196928	.	G	A	0	3	3	0	6	9	0	0
22	10196929	.	G	A	6	3	9	0	0	9	0	0
22	10197180	.	T	A	19	4	23	0	3	26	0	0
22	10197195	.	T	C	13	7	20	0	1	21	0	0
22	10197395	.	G	T	0	13	13	0	11	24	0	0
22	10197433	.	T	A	10	13	23	0	0	23	0	0
22	10197957	.	C	A	10	14	24	0	5	29	0	0
22	10197966	.	C	T	16	12	28	0	2	30	0	0
22	10198018	.	A	C	12	12	24	0	0	24	0	0
22	10198075	.	T	G	4	0	4	0	5	9	0	0
22	10198120	.	A	T	2	5	7	0	0	7	0	0
22	10198167	.	G	A	7	14	21	0	0	21	0	0
22	10198211	.	T	C	7	13	20	0	0	20	0	0
22	10198232	.	T	A	5	8	13	0	0	13	0	0
22	10198335	.	A	C	13	16	29	0	1	30	0	0
22	10198359	.	G	A	18	16	34	0	0	34	0	0
22	10198399	.	T	A	24	17	41	0	1	42	0	0
22	10205736	.	C	T	5	9	14	0	0	14	0	0
22	10208212	.	C	T	20	14	34	0	3	37	0	0
22	10210467	.	T	C	6	6	12	0	0	12	0	0
22	10212089	.	C	T	9	9	18	0	1	19	0	0
22	10212161	.	A	C	28	22	50	0	3	53	0	0
22	10212307	.	C	T	17	26	43	0	2	45	0	0
22	10212416	.	T	A	6	9	15	0	2	17	0	0
22	10215506	.	G	C	1	0	1	0	0	1	0	0
22	10218656	.	A	T	5	9	14	0	2	16	0	0
22	10218682	.	A	T	4	4	8	0	3	11	0	0
22	10218916	.	T	A	6	5	11	0	1	12	0	0
22	10218973	.	T	C	8	5	13	0	0	13	0	0
22	10219030	.	T	C	5	5	10	0	0	10	0	0
22	10260258	.	G	A	0	5	5	0	7	12	0	0
22	10260468	.	A	G	8	0	8	0	8	16	0	0
22	10261037	.	C	T	1	5	6	0	0	6	0	0
22	10261723	.	A	G	6	5	11	0	2	13	0	0
22	10261792	.	T	A	6	7	13	0	0	13	0	0
22	10261853	.	G	A	10	11	21	0	0	21	0	0
22	10261905	.	T	C	12	13	25	0	0	25	0	0
22	10262236	.	T	G	14	7	21	0	0	21	0	0
22	10282344	.	G	A	1	2	3	0	0	3	0	0
22	10361385	.	C	G	7	5	12	0	0	12	0	0
22	10361391	.	T	C	5	8	13	0	0	13	0	0
22	10361577	.	G	C	10	1	11	0	10	21	0	0
22	10361937	.	C	T	0	8	8	0	9	17	0	0
22	10362072	.	G	A	7	7	14	0	0	14	0	0
22	10362239	.	G	A	10	11	21	0	1	22	0	0
22	10368054	.	A	T	4	1	5	0	0	5	0	0
22	10372950	.	A	C	11	0	11	0	6	17	0	0
22	10373099	.	C	T	0	9	9	0	3	12	0	0
22	10373118	.	A	T	6	5	11	0	0	11	0	0
22	10373263	.	G	T	4	7	11	0	0	11	0	0
22	10373795	.	A	T	3	2	5	0	1	6	0	0
22	10373849	.	G	A	3	4	7	0	0	7	0	0
22	10373879	.	C	A	2	8	10	0	0	10	0	0
22	10373931	.	T	A	4	4	8	0	0	8	0	0
22	10374012	.	G	A	5	5	10	0	1	11	0	0
22	10374042	.	A	C	2	3	5	0	0	5	0	0
22	10383159	.	A	G	5	4	9	0	0	9	0	0
22	10386019	.	G	T	0	1	1	0	1	2	0	0
22	10386085	.	T	G	2	4	6	0	0	6	0	0
22	10391280	.	G	A	2	1	3	0	0	3	0	0
22	10391347	.	C	T	7	2	9	0	0	9	0	0
22	10396971	.	G	C	1	0	1	0	0	1	0	0
22	10430183	.	C	A	0	1	1	0	1	2	0	0
22	10430292	.	G	C	1	2	3	0	1	4	0	0
22	10430369	.	A	T	1	6	7	0	1	8	0	0
22	10514288	.	G	T	10	5	15	0	2	17	0	0
22	10514302	.	C	T	1	4	5	0	9	14	0	0
22	10516614	.	G	T	1	3	4	0	0	4	0	0
22	10519951	.	T	C	2	2	4	0	0	4	0	0
22	10519955	.	A	C	1	1	2	0	0	2	0	0
22	10522404	.	C	T	1	2	3	0	0	3	0	0
22	10522461	.	G	A	0	2	2	0	0	2	0	0
22	10522512	.	A	G	1	3	4	0	0	4	0	0
22	10540812	.	G	T	4	7	11	0	0	11	0	0
22	10543340	.	T	A	0	3	3	0	1	4	0	0
22	10545408	.	G	A	5	5	10	0	0	10	0	0
22	10548171	.	G	A	1	3	4	0	0	4	0	0
22	10548198	.	G	C	1	3	4	0	0	4	0	0
22	10550310	.	C	G	0	0	0	0	1	1	0	0
22	10553526	.	G	A	2	4	6	0	0	6	0	0
22	10553532	.	C	T	1	6	7	0	0	7	0	0
22	10553620	.	G	T	3	6	9	0	1	10	0	0
22	10553626	.	G	A	4	6	10	0	0	10	0	0
22	10557870	.	T	G	1	2	3	0	0	3	0	0
22	10557898	.	C	T	1	2	3	0	0	3	0	0
22	10560944	.	C	G	2	2	4	0	0	4	0	0
22	10561514	.	A	G	9	11	20	0	0	20	0	0
22	10561758	.	A	G	16	10	26	0	0	26	0	0
22	10564220	.	T	C	5	0	5	0	10	15	0	0
22	10564247	.	A	C	9	8	17	0	0	17	0	0
22	10567550	.	T	A	3	4	7	0	1	8	0	0
22	10570575	.	T	C	5	6	11	0	0	11	0	0
22	10592426	.	C	A	8	4	12	0	1	13	0	0
22	10592719	.	T	C	12	9	21	0	1	22	0	0
22	10593310	.	A	G	4	4	8	0	0	8	0	0
22	10593527	.	A	G	14	9	23	0	1	24	0	0
22	10593531	.	G	A	14	11	25	0	0	25	0	0
22	10593831	.	T	C	10	5	15	0	0	15	0	0
22	10593990	.	A	G	12	7	19	0	0	19	0	0
22	10594008	.	G	T	11	5	16	0	3	19	0	0
22	10594074	.	C	T	12	5	17	0	2	19	0	0
22	10594098	.	G	A	12	10	22	0	0	22	0	0
22	10594170	.	A	G	6	6	12	0	0	12	0	0
22	10597715	.	T	C	5	0	5	0	4	9	0	0
22	10599510	.	A	G	5	7	12	0	0	12	0	0
22	10600175	.	T	C	6	3	9	0	0	9	0	0
22	10600265	.	C	T	0	4	4	0	4	8	0	0
22	10602243	.	A	G	2	4	6	0	0	6	0	0
22	10604423	.	C	T	2	11	13	0	0	13	0	0
22	10615158	.	G	C	2	0	2	0	0	3	1	0
22	10615559	.	A	G	1	2	3	0	0	3	0	0
22	10622000	.	G	T	0	3	3	0	7	10	0	0
22	10626747	.	T	C	6	5	11	0	0	11	0	0
22	10626861	.	T	C	3	3	6	0	0	6	0	0
22	10626873	.	C	T	3	2	5	0	0	5	0	0
22	10629133	.	T	C	5	8	13	0	0	13	0	0
22	10631774	.	C	G	0	1	1	0	0	1	0	0
22	10632503	.	C	T	0	1	1	0	0	1	0	0
22	10634437	.	G	A	6	8	14	0	1	15	0	0
22	10634822	.	G	A	4	2	6	0	0	6	0	0
22	10636581	.	T	C	3	0	3	0	0	3	0	0
22	10636762	.	A	T	6	8	14	0	0	14	0	0
22	10636974	.	G	C	15	6	21	0	1	22	0	0
22	10637232	.	A	G	11	12	23	0	3	26	0	0
22	10637253	.	T	C	14	13	27	0	0	27	0	0
22	10637298	.	C	A	12	13	25	0	0	25	0	0
22	10637669	.	G	T	8	6	14	0	0	14	0	0
22	10637729	.	T	C	7	3	10	0	1	11	0	0
22	10638536	.	A	T	3	6	9	0	0	9	0	0
22	10638700	.	T	C	3	4	7	0	0	7	0	0
22	10638887	.	T	C	7	3	10	0	2	12	0	0
22	10638974	.	G	A	2	5	7	0	1	8	0	0
22	10640086	.	T	A	0	1	1	0	1	2	0	0
22	10640369	.	A	G	1	4	5	0	0	5	0	0
22	10646792	.	G	T	1	2	3	0	0	3	0	0
22	10651808	.	A	C	0	2	2	0	1	3	0	0
22	10651827	.	C	G	1	3	4	0	0	4	0	0
22	10654549	.	C	T	0	4	4	0	0	4	0	0
22	10657980	.	A	G	2	2	4	0	0	4	0	0
22	10658007	.	T	A	2	2	4	0	0	4	0	0
22	10658042	.	A	C	2	2	4	0	0	4	0	0
22	10658090	.	G	A	0	4	4	0	0	4	0	0
22	10658102	.	A	C	0	5	5	0	0	5	0	0
22	10660261	.	A	T	9	9	18	0	3	21	0	0
22	10662886	.	C	T	11	3	14	0	0	14	0	0
22	10662952	.	C	T	3	2	5	0	0	5	0	0
22	10663090	.	G	T	0	3	3	0	2	5	0	0
22	10663390	.	T	G	9	6	15	0	0	15	0	0
22	10663433	.	A	T	4	8	12	0	2	14	0	0
22	10663469	.	T	A	5	11	16	0	1	17	0	0
22	10663504	.	T	A	8	10	18	0	1	19	0	0
22	10663567	.	A	T	13	13	26	0	0	26	0	0
22	10678954	.	A	G	1	3	4	0	1	5	0	0
22	10679121	.	G	T	0	2	2	0	2	4	0	0
22	10679133	.	C	T	2	2	4	0	0	4	0	0
22	10687844	.	C	T	0	1	1	0	0	1	0	0
22	10688155	.	G	A	1	4	5	0	0	5	0	0
22	10688179	.	T	A	1	5	6	0	0	6	0	0
22	10689322	.	T	A	1	3	4	0	0	4	0	0
22	10690497	.	T	A	3	4	7	0	1	8	0	0
22	10698635	.	A	T	3	9	12	0	1	13	0	0
22	10699054	.	C	G	6	6	12	0	0	12	0	0
22	10704081	.	T	G	4	0	4	0	4	8	0	0
22	10704255	.	A	C	6	4	10	0	1	11	0	0
22	10704279	.	T	C	4	1	5	0	0	5	0	0
22	10706462	.	G	A	0	15	15	0	12	27	0	0
22	10706586	.	T	G	13	6	19	0	2	21	0	0
22	10706603	.	G	A	0	10	10	0	18	28	0	0
22	10706726	.	A	T	4	6	10	0	1	11	0	0
22	10706732	.	A	G	5	5	10	0	0	10	0	0
22	10706855	.	T	A	8	4	12	0	0	12	0	0
22	10713819	.	C	T	5	4	9	0	1	10	0	0
22	10713858	.	T	C	5	8	13	0	0	13	0	0
22	10713880	.	C	A	8	7	15	0	0	15	0	0
22	10726968	.	T	C	2	5	7	0	1	8	0	0
22	10729626	.	C	T	10	3	13	0	0	13	0	0
22	10729675	.	C	A	3	0	3	0	0	3	0	0
22	10733284	.	C	G	4	0	4	0	8	12	0	0
22	10733360	.	A	G	11	1	12	0	20	32	0	0
22	10733512	.	C	T	13	7	20	0	0	20	0	0
22	10733554	.	G	A	11	10	21	0	0	21	0	0
22	10733946	.	T	C	1	2	3	0	0	3	0	0
22	10733992	.	A	T	5	3	8	0	0	8	0	0
22	10734916	.	G	A	10	7	17	0	0	17	0	0
22	10734967	.	A	T	7	12	19	0	0	19	0	0
22	10735015	.	C	A	4	6	10	0	0	10	0	0
22	10735119	.	T	A	6	4	10	0	0	10	0	0
22	10735140	.	A	T	5	3	8	0	0	8	0	0
22	10755600	.	A	G	9	14	23	0	0	23	0	0
22	10755652	.	T	A	7	6	13	0	0	13	0	0
22	10755746	.	G	T	13	23	36	0	2	38	0	0
22	10755888	.	T	C	16	12	28	0	2	30	0	0
22	10771195	.	C	T	0	3	3	0	3	6	0	0
22	10771284	.	T	C	8	11	19	0	0	19	0	0
22	10771369	.	G	A	6	11	17	0	0	17	0	0
22	10771415	.	A	T	5	13	18	0	2	20	0	0
22	10771628	.	T	C	8	5	13	0	0	13	0	0
22	10771743	.	C	G	5	10	15	0	1	16	0	0
22	10771752	.	G	A	6	9	15	0	0	15	0	0
22	10771919	.	T	C	8	0	8	0	10	18	0	0
22	10774628	.	G	A	9	6	15	0	0	15	0	0
22	10774632	.	T	C	7	6	13	0	1	14	0	0
22	10784824	.	T	G	1	0	1	0	3	4	0	0
22	10784833	.	T	A	1	3	4	0	0	4	0	0
22	10785154	.	G	A	0	3	3	0	2	5	0	0
22	10795745	.	T	C	1	2	3	0	0	3	0	0
22	10816880	.	T	C	2	0	2	0	5	7	0	0
22	10927722	.	G	A	1	2	3	0	0	3	0	0
22	10928084	.	A	G	4	3	7	0	0	7	0	0
22	10932048	.	G	A	1	4	5	0	0	5	0	0
22	10953355	.	C	T	0	2	2	0	1	3	0	0
22	10953379	.	G	A	1	3	4	0	0	4	0	0
22	10953490	.	T	C	3	0	3	0	3	6	0	0
22	10953496	.	A	G	3	3	6	0	0	6	0	0
22	11004566	.	A	G	4	2	6	0	0	6	0	0
22	11053089	.	G	A	0	2	2	0	0	2	0	0
22	11071011	.	G	C	1	0	1	0	5	6	0	0
22	11071053	.	A	G	3	3	6	0	0	6	0	0
22	11071059	.	C	T	3	2	5	0	0	5	0	0
22	11071416	.	G	C	4	1	5	0	1	6	0	0
22	11071505	.	A	G	2	3	5	0	0	5	0	0
22	11071568	.	C	A	3	1	4	0	0	4	0	0
22	11071698	.	T	G	3	7	10	0	0	10	0	0
22	11075978	.	A	G	5	5	10	0	1	11	0	0
22	11078902	.	T	C	1	1	2	0	0	2	0	0
22	11078944	.	C	A	0	7	7	0	4	11	0	0
22	11103229	.	T	A	1	3	4	0	0	4	0	0
22	11103913	.	G	A	0	2	2	0	1	3	0	0
22	11123770	.	C	T	28	22	50	0	0	50	0	0
22	11123889	.	T	C	20	17	37	0	1	38	0	0
22	11124524	.	T	C	2	2	4	0	0	4	0	0
22	11126857	.	A	G	8	11	19	0	0	19	0	0
22	11126866	.	G	A	11	14	25	0	0	25	0	0
22	11129995	.	G	A	10	19	29	0	1	30	0	0
22	11130058	.	T	C	8	0	8	0	8	16	0	0
22	11135408	.	G	A	3	1	4	0	0	4	0	0
22	11135446	.	G	A	16	15	31	0	2	33	0	0
22	11136606	.	G	A	5	9	14	0	0	14	0	0
22	11144774	.	T	A	0	1	1	0	0	1	0	0
22	11155404	.	C	A	3	4	7	0	0	7	0	0
22	11156578	.	A	G	1	0	1	0	6	8	1	0
22	11156977	.	C	A	4	2	6	0	1	7	0	0
22	11157023	.	G	C	3	3	6	0	0	6	0	0
22	11157035	.	A	T	2	1	3	0	0	3	0	0
22	11170855	.	T	C	4	4	8	0	0	8	0	0
22	11170954	.	T	C	11	6	17	0	0	17	0	0
22	11170966	.	T	G	10	0	10	0	6	16	0	0
22	11171086	.	G	A	11	6	17	0	0	17	0	0
22	11188598	.	C	T	6	6	12	0	0	12	0	0
22	11199942	.	T	A	15	18	33	0	0	33	0	0
22	11200160	.	C	T	2	3	5	0	1	6	0	0
22	11200401	.	G	A	1	10	11	0	11	22	0	0
22	12163370	.	T	A	1	1	2	0	0	2	0	0
22	12171293	.	G	A	4	4	8	0	0	8	0	0
22	12174573	.	T	G	14	6	20	0	0	20	0	0
22	12174740	.	A	G	9	6	15	0	1	16	0	0
22	12175021	.	T	G	16	0	16	0	13	29	0	0
22	12175181	.	T	C	15	6	21	0	2	23	0	0
22	12175556	.	A	G	11	0	11	0	11	22	0	0
22	12175583	.	A	T	11	10	21	0	3	24	0	0
22	12176043	.	G	T	20	10	30	0	1	31	0	0
22	12230054	.	G	A	1	2	3	0	0	3	0	0
22	12259248	.	C	A	0	2	2	0	0	2	0	0
22	12649633	.	A	G	4	2	6	0	0	6	0	0
22	13459294	.	A	G	8	8	16	0	1	17	0	0
22	13459472	.	T	A	10	4	14	0	2	16	0	0
22	13459596	.	T	C	1	0	1	0	8	9	0	0
22	13459611	.	A	G	2	8	10	0	0	10	0	0
22	13459636	.	G	T	2	8	10	0	1	11	0	0
22	13459718	.	A	G	6	10	16	0	0	16	0	0
22	13459865	.	G	C	1	1	2	0	6	8	0	0
22	13460080	.	A	G	12	8	20	0	1	21	0	0
22	13460084	.	A	G	12	9	21	0	0	21	0	0
22	13460406	.	T	C	7	12	19	0	1	20	0	0
22	13460441	.	C	T	0	14	14	0	4	18	0	0
22	13460483	.	A	G	7	12	19	0	1	20	0	0
22	13460509	.	T	G	7	9	16	0	1	17	0	0
22	13461012	.	A	G	6	7	13	0	0	13	0	0
22	13461073	.	C	G	1	13	14	0	0	14	0	0
22	13461084	.	C	T	2	13	15	0	1	16	0	0
22	13461529	.	T	G	4	13	17	0	0	17	0	0
22	13461622	.	T	C	4	5	9	1	0	10	0	0
22	13461993	.	A	G	6	4	10	0	0	10	0	0
22	13461996	.	A	G	5	4	9	0	0	9	0	0
22	13462863	.	T	C	3	7	10	0	2	12	0	0
22	13463071	.	A	G	3	12	15	0	0	15	0	0
22	13472514	.	G	A	4	3	7	0	0	7	0	0
22	13472568	.	G	C	6	0	6	0	8	14	0	0
22	13479802	.	G	A	0	1	1	0	0	1	0	0
22	13479990	.	A	G	7	4	11	0	0	11	0	0
22	13481352	.	A	G	7	4	11	0	1	12	0	0
22	13481363	.	A	C	7	3	10	0	0	10	0	0
22	13486398	.	A	T	1	1	2	0	0	2	0	0
22	13511222	.	A	G	2	1	3	0	0	3	0	0
22	13514736	.	A	G	3	3	6	0	0	6	0	0
22	13526458	.	G	A	2	4	6	0	0	6	0	0
22	13526489	.	A	T	0	3	3	0	0	3	0	0
22	13526497	.	A	G	0	3	3	0	0	3	0	0
22	13846395	.	T	A	3	5	8	0	0	9	1	0
22	13846606	.	G	A	6	6	12	0	3	15	0	0
22	13846788	.	C	A	7	4	11	0	0	11	0	0
22	13847783	.	A	G	35	19	54	0	1	55	0	0
22	13847797	.	C	G	31	19	50	0	3	53	0	0
22	13847940	.	G	A	21	25	46	0	2	48	0	0
22	13848006	.	A	C	23	0	23	0	25	48	0	0
22	13848031	.	G	A	26	22	48	0	0	48	0	0
22	13848085	.	G	A	18	15	33	0	3	36	0	0
22	13848106	.	A	G	11	12	23	1	0	24	0	0
22	13850865	.	A	G	21	12	33	0	1	34	0	0
22	13919476	.	G	A	2	3	5	0	0	5	0	0
22	13920202	.	A	T	1	2	3	0	0	3	0	0
22	13920370	.	T	C	1	2	3	0	0	3	0	0
22	13939993	.	G	C	0	2	2	0	0	2	0	0
22	13940036	.	T	C	6	4	10	0	0	10	0	0
22	14366222	.	G	A	5	4	9	0	4	13	0	0
22	14366267	.	C	T	3	2	5	0	1	6	0	0
22	14380352	.	G	A	0	1	1	0	0	1	0	0
22	14381780	.	A	T	1	0	1	0	0	1	0	0
22	14381812	.	G	T	2	2	4	0	0	4	0	0
22	14381857	.	T	G	2	3	5	0	0	5	0	0
22	14381873	.	T	C	2	2	4	0	0	4	0	0
22	14390053	.	A	T	1	2	3	0	0	3	0	0
22	14390142	.	C	T	1	2	3	0	0	3	0	0
22	14398606	.	G	T	6	2	8	0	0	8	0	0
22	14398645	.	G	A	3	4	7	0	0	7	0	0
22	14398690	.	A	G	1	1	2	0	0	2	0	0
22	14402487	.	T	A	1	0	1	0	0	1	0	0
22	14402488	.	G	A	1	0	1	0	0	1	0	0
22	14408112	.	C	A	0	1	1	0	0	1	0	0
22	14408161	.	T	G	0	2	2	0	0	2	0	0
22	14408192	.	A	G	0	1	1	0	0	1	0	0
22	14410011	.	C	A	0	4	4	0	1	5	0	0
22	14445860	.	G	C	0	0	0	0	1	1	0	0
22	14458857	.	T	A	1	1	2	0	0	2	0	0
22	14459142	.	A	G	3	4	7	0	0	7	0	0
22	14480650	.	C	T	1	2	3	0	0	3	0	0
22	14495941	.	C	T	1	1	2	0	0	2	0	0
22	14556620	.	T	C	1	2	3	0	0	3	0	0
22	14850790	.	T	A	1	3	4	0	0	4	0	0
22	15010604	.	C	A	2	2	4	0	0	4	0	0
22	16335500	.	C	T	2	3	5	0	0	5	0	0
22	16341498	.	G	A	0	2	2	0	1	3	0	0
22	16342137	.	C	T	2	2	4	0	0	4	0	0
22	16342239	.	A	C	1	0	1	0	0	1	0	0
22	16342535	.	T	A	3	3	6	0	0	6	0	0
22	16345485	.	A	G	1	1	2	0	0	2	0	0
22	16345668	.	C	A	1	0	1	0	0	1	0	0
22	16350682	.	G	A	12	16	28	0	1	29	0	0
22	16350792	.	T	A	22	12	34	0	3	37	0	0
22	16350811	.	T	G	22	10	32	0	2	34	0	0
22	16350862	.	C	T	25	5	30	0	1	31	0	0
22	16350877	.	T	A	23	6	29	0	1	30	0	0
22	16351141	.	G	A	13	11	24	0	1	25	0	0
22	16351199	.	C	G	10	14	24	0	2	26	0	0
22	16351345	.	A	T	7	2	9	0	2	11	0	0
22	16351353	.	G	A	5	4	9	0	0	9	0	0
22	16351390	.	A	C	3	2	5	0	0	5	0	0
22	16351404	.	C	T	1	6	7	0	1	8	0	0
22	16351439	.	C	T	6	9	15	0	2	17	0	0
22	16351490	.	T	G	9	9	18	0	2	20	0	0
22	16351552	.	A	T	11	4	15	0	0	15	0	0
22	16352146	.	G	T	2	2	4	0	0	4	0	0
22	16352215	.	A	G	5	5	10	0	1	11	0	0
22	16352249	.	T	C	7	8	15	0	0	15	0	0
22	16352269	.	T	G	8	7	15	0	0	15	0	0
22	16352668	.	T	C	16	0	16	0	17	33	0	0
22	16352768	.	A	G	11	16	27	0	1	28	0	0
22	16357818	.	A	G	2	1	3	0	0	3	0	0
22	16357831	.	A	G	3	3	6	0	0	6	0	0
22	16357867	.	G	A	6	5	11	0	0	11	0	0
22	16357909	.	C	T	1	2	3	0	1	4	0	0
22	16367007	.	T	C	9	2	11	0	5	16	0	0
22	16367055	.	A	G	10	10	20	0	0	20	0	0
22	16377364	.	A	G	6	6	12	0	0	12	0	0
22	16412091	.	A	G	4	1	5	0	0	5	0	0
22	16416462	.	T	C	0	1	1	0	0	1	0	0
22	16418990	.	G	A	2	3	5	0	0	5	0	0
22	16419007	.	A	T	3	3	6	0	0	6	0	0
22	16423042	.	G	A	0	2	2	0	2	4	0	0
22	16424576	.	T	C	8	3	11	0	1	12	0	0
22	16427969	.	A	G	4	0	4	0	5	9	0	0
22	16428005	.	C	A	4	8	12	0	1	13	0	0
22	16430623	.	G	A	10	10	20	0	1	21	0	0
22	16430782	.	T	A	8	7	15	0	0	15	0	0
22	16430913	.	T	C	5	3	8	0	1	9	0	0
22	16430924	.	G	C	1	2	3	0	0	3	0	0
22	16433009	.	G	A	11	5	16	0	1	17	0	0
22	16433054	.	T	A	15	12	27	0	0	27	0	0
22	16433078	.	G	A	17	10	27	0	0	27	0	0
22	16433096	.	A	G	15	16	31	0	0	31	0	0
22	16433337	.	T	C	3	4	7	0	0	7	0	0
22	16433378	.	G	A	10	5	15	0	0	15	0	0
22	16433394	.	G	A	9	4	13	0	1	14	0	0
22	16433422	.	A	G	7	3	10	0	1	11	0	0
22	16433636	.	A	T	2	3	5	0	0	5	0	0
22	16433665	.	C	T	0	3	3	0	2	6	1	0
22	16433895	.	T	C	9	7	16	0	0	16	0	0
22	16433912	.	T	A	12	5	17	0	0	17	0	0
22	16434056	.	G	A	16	8	24	0	0	24	0	0
22	16440072	.	G	A	4	3	7	0	0	7	0	0
22	16440086	.	T	C	2	0	2	0	1	3	0	0
22	16476636	.	T	C	1	3	4	0	0	4	0	0
22	16484167	.	A	T	2	5	7	0	0	7	0	0
22	16484489	.	G	C	11	0	11	0	21	32	0	0
22	16484712	.	C	T	4	9	13	0	0	13	0	0
22	16484877	.	A	T	5	14	19	0	0	19	0	0
22	16484938	.	A	G	6	23	29	0	0	29	0	0
22	16484944	.	T	C	7	17	24	0	3	27	0	0
22	16485238	.	A	C	5	15	20	0	1	21	0	0
22	16485379	.	A	T	7	14	21	0	1	22	0	0
22	16485538	.	T	C	13	0	13	0	9	22	0	0
22	16485563	.	A	T	8	2	10	0	0	10	0	0
22	16485688	.	G	A	4	6	10	0	0	10	0	0
22	16485768	.	G	A	7	3	10	0	0	10	0	0
22	16485790	.	C	T	5	3	8	0	0	8	0	0
22	16485920	.	G	A	6	12	18	0	0	18	0	0
22	16485962	.	C	G	6	9	15	0	2	17	0	0
22	16486008	.	A	C	6	3	9	0	4	13	0	0
22	16486027	.	G	A	4	9	13	0	0	13	0	0
22	16486102	.	G	A	8	7	15	0	2	17	0	0
22	16486112	.	T	C	8	9	17	0	2	19	0	0
22	16491711	.	C	A	5	5	10	0	0	10	0	0
22	16491942	.	G	A	11	15	26	0	1	27	0	0
22	16498232	.	T	C	15	10	25	0	1	26	0	0
22	16498333	.	A	C	21	11	32	0	3	35	0	0
22	16498661	.	A	G	8	1	9	0	13	22	0	0
22	16537701	.	C	T	5	2	7	0	0	7	0	0
22	16537854	.	C	T	6	8	14	0	1	15	0	0
22	16537878	.	C	A	7	10	17	0	2	19	0	0
22	16544186	.	A	G	5	7	12	0	1	13	0	0
22	16544197	.	A	G	10	2	12	0	2	14	0	0
22	16544243	.	C	T	7	8	15	0	0	15	0	0
22	16544308	.	A	G	1	4	5	1	0	6	0	0
22	16544384	.	G	A	6	12	18	0	0	18	0	0
22	16544400	.	T	G	5	11	16	0	0	16	0	0
22	16544498	.	T	G	12	4	16	0	1	17	0	0
22	16544599	.	A	G	14	2	16	0	16	32	0	0
22	16544674	.	T	G	13	24	37	0	2	39	0	0
22	16544780	.	A	T	11	11	22	0	3	25	0	0
22	16544800	.	G	A	13	6	19	0	0	19	0	0
22	16594852	.	G	A	1	1	2	0	1	3	0	0
22	16594870	.	T	A	1	3	4	0	2	6	0	0
22	16594981	.	C	A	6	6	12	0	0	12	0	0
22	16597623	.	G	A	0	2	2	0	0	2	0	0
22	16601400	.	C	T	4	4	8	0	1	9	0	0
22	16601422	.	C	T	2	3	5	0	0	5	0	0
22	16606938	.	G	A	1	1	2	0	1	3	0	0
22	16775197	.	G	A	0	12	12	0	12	24	0	0
22	16775284	.	T	G	13	7	20	0	1	21	0	0
22	16775306	.	C	T	6	9	15	0	2	17	0	0
22	16840260	.	G	A	1	5	6	0	0	6	0	0
22	16840292	.	T	C	3	2	5	0	1	6	0	0
22	16840301	.	A	C	5	3	8	0	0	8	0	0
22	16862842	.	A	G	3	3	6	0	1	7	0	0
22	16893867	.	C	T	0	0	0	0	1	1	0	0
22	16991847	.	C	T	0	3	3	0	0	3	0	0
22	17189869	.	G	A	0	2	2	0	0	2	0	0
22	17200635	.	G	A	10	5	15	0	0	15	0	0
22	17200890	.	G	A	8	12	20	0	3	23	0	0
22	17200985	.	A	C	10	13	23	0	2	25	0	0
22	17201015	.	C	G	13	14	27	0	0	27	0	0
22	17201102	.	C	G	13	6	19	0	0	19	0	0
22	17201135	.	G	A	13	9	22	0	0	22	0	0
22	17201172	.	C	T	8	7	15	0	0	15	0	0
22	17208680	.	T	C	5	2	7	0	0	7	0	0
22	17208695	.	A	G	7	6	13	0	1	14	0	0
22	17208770	.	T	C	13	13	26	0	0	26	0	0
22	17208973	.	G	A	16	5	21	0	0	21	0	0
22	17208983	.	T	C	16	7	23	0	0	23	0	0
22	17209036	.	A	T	21	5	26	0	3	29	0	0
22	17209384	.	A	C	19	28	47	0	4	51	0	0
22	17209413	.	T	A	14	29	43	0	1	44	0	0
22	17209484	.	T	A	18	12	30	0	0	30	0	0
22	17209492	.	T	A	18	11	29	0	0	29	0	0
22	17209523	.	A	T	17	7	24	0	2	26	0	0
22	17209737	.	T	C	18	17	35	0	1	36	0	0
22	17209762	.	T	C	15	15	30	0	2	32	0	0
22	17209986	.	A	T	18	17	35	0	0	35	0	0
22	17209993	.	A	T	15	17	32	0	3	35	0	0
22	17210157	.	T	A	17	16	33	0	0	33	0	0
22	17210196	.	C	G	16	0	16	0	12	28	0	0
22	17210217	.	C	A	19	9	28	0	3	31	0	0
22	17210820	.	A	C	26	19	45	0	4	49	0	0
22	17210825	.	G	A	2	18	20	0	27	47	0	0
22	17211295	.	T	C	16	6	22	0	0	22	0	0
22	17211343	.	C	T	16	13	29	0	3	32	0	0
22	17211361	.	A	G	15	10	25	0	1	26	0	0
22	17211431	.	C	T	22	12	34	0	3	37	0	0
22	17211438	.	T	C	24	13	37	0	1	38	0	0
22	17211875	.	G	C	27	14	41	0	2	43	0	0
22	17211990	.	A	G	14	17	31	0	1	32	0	0
22	17212235	.	T	A	17	11	28	0	0	28	0	0
22	17212236	.	T	C	17	10	27	0	1	28	0	0
22	17216903	.	A	T	2	2	4	0	0	4	0	0
22	17218901	.	C	T	1	1	2	0	0	2	0	0
22	17226483	.	T	C	1	1	2	0	0	2	0	0
22	17231190	.	C	T	4	4	8	0	0	8	0	0
22	17231194	.	T	C	4	3	7	0	0	7	0	0
22	17234620	.	G	A	0	2	2	0	3	5	0	0
22	17235449	.	A	C	0	1	1	0	0	1	0	0
22	17235841	.	T	C	1	7	8	0	1	9	0	0
22	17251692	.	G	C	1	2	3	0	0	3	0	0
22	17280302	.	A	T	2	3	5	0	0	5	0	0
22	17315288	.	G	A	0	0	0	0	2	2	0	0
22	17315296	.	C	G	2	0	2	0	0	2	0	0
22	17318172	.	C	T	0	1	1	0	0	1	0	0
22	17318401	.	T	C	3	3	6	0	0	6	0	0
22	17318404	.	T	C	2	3	5	0	0	5	0	0
22	17322532	.	C	T	1	2	3	0	0	3	0	0
22	17331325	.	A	G	3	1	4	0	0	4	0	0
22	17343530	.	A	G	2	1	3	0	0	3	0	0
22	17359735	.	A	G	13	0	13	0	10	23	0	0
22	17359816	.	G	C	1	8	9	0	6	15	0	0
22	17360107	.	C	A	7	12	19	0	0	19	0	0
22	17360428	.	G	A	1	12	13	0	7	20	0	0
22	17405361	.	C	T	3	7	10	0	0	10	0	0
22	17446858	.	T	C	1	3	4	0	0	4	0	0
22	17448778	.	G	A	2	1	3	0	0	3	0	0
22	17448781	.	C	T	2	1	3	0	0	3	0	0
22	17450115	.	G	A	1	17	18	0	16	34	0	0
22	17452798	.	C	T	10	20	30	0	0	30	0	0
22	17453286	.	T	G	17	18	35	0	3	38	0	0
22	17453336	.	A	G	22	0	22	0	12	34	0	0
22	17453419	.	G	A	13	10	23	0	2	25	0	0
22	17453478	.	T	A	19	22	41	0	0	41	0	0
22	17453552	.	T	C	16	11	27	0	0	27	0	0
22	17453569	.	C	G	12	10	22	0	0	22	0	0
22	17453680	.	C	T	16	15	31	0	0	31	0	0
22	17453688	.	A	G	14	14	28	0	1	29	0	0
22	17453742	.	A	G	12	10	22	0	1	23	0	0
22	17453836	.	A	G	10	15	25	0	0	25	0	0
22	17453883	.	A	T	12	16	28	0	0	28	0	0
22	17453884	.	T	C	11	16	27	0	1	28	0	0
22	17454015	.	T	C	10	21	31	0	3	34	0	0
22	17454038	.	G	T	10	19	29	0	0	29	0	0
22	17454120	.	C	T	7	10	17	0	1	18	0	0
22	17454178	.	A	G	6	0	6	0	11	17	0	0
22	17454179	.	T	G	6	11	17	0	0	17	0	0
22	17454320	.	T	C	11	24	35	0	1	36	0	0
22	17454382	.	C	T	11	11	22	0	0	22	0	0
22	17454424	.	C	T	1	3	4	0	0	4	0	0
22	17501623	.	G	C	5	9	14	0	0	14	0	0
22	17505820	.	A	C	29	21	50	0	2	52	0	0
22	17506536	.	A	T	12	21	33	0	2	35	0	0
22	17506537	.	T	G	11	23	34	0	1	35	0	0
22	17509449	.	A	T	5	5	10	0	0	10	0	0
22	17509494	.	T	A	9	12	21	0	1	22	0	0
22	17509533	.	T	A	2	3	5	0	2	7	0	0
22	17517881	.	G	A	4	0	4	0	0	4	0	0
22	17520792	.	A	G	5	0	5	0	5	10	0	0
22	17531044	.	G	A	0	5	5	0	9	14	0	0
22	17531188	.	A	G	13	11	24	0	2	26	0	0
22	17533907	.	C	T	6	8	14	0	0	14	0	0
22	17539297	.	C	T	22	25	47	0	5	52	0	0
22	17539633	.	G	A	11	8	19	0	1	20	0	0
22	17540807	.	C	T	0	1	1	0	0	1	0	0
22	17541191	.	T	G	8	8	16	0	0	16	0	0
22	17541450	.	C	A	8	10	18	0	1	19	0	0
22	17541593	.	G	A	16	16	32	0	0	33	1	0
22	17542016	.	C	T	19	9	28	0	0	28	0	0
22	17542057	.	C	T	21	9	30	0	1	31	0	0
22	17542117	.	T	C	10	15	25	0	1	26	0	0
22	17542136	.	G	A	11	18	29	0	0	29	0	0
22	17542199	.	A	T	10	10	20	0	0	20	0	0
22	17542293	.	C	T	15	8	23	0	3	26	0	0
22	17542594	.	G	T	5	4	9	0	2	11	0	0
22	17542702	.	G	A	6	4	10	0	0	10	0	0
22	17543079	.	C	G	3	9	12	0	0	12	0	0
22	17543408	.	A	G	4	4	8	0	0	8	0	0
22	17543421	.	G	A	2	4	6	0	1	7	0	0
22	17543552	.	G	A	6	10	16	0	2	18	0	0
22	17543634	.	A	C	10	8	18	0	0	18	0	0
22	17543668	.	A	T	5	4	9	0	0	9	0	0
22	17543748	.	A	C	2	0	2	0	10	12	0	0
22	17543903	.	A	G	5	10	15	0	0	15	0	0
22	17550643	.	T	C	3	1	4	0	6	10	0	0
22	17550664	.	G	A	5	9	14	0	1	15	0	0
22	17550684	.	C	T	0	5	5	0	6	11	0	0
22	17550724	.	T	G	2	0	2	0	0	2	0	0
22	17552526	.	A	G	6	4	10	0	1	11	0	0
22	17554785	.	G	A	7	5	12	0	1	13	0	0
22	17560376	.	A	C	0	4	4	0	0	4	0	0
22	17564009	.	T	C	6	14	20	0	1	21	0	0
22	17565735	.	C	T	11	7	18	0	0	18	0	0
22	17565837	.	A	G	1	1	2	0	1	4	1	0
22	17571428	.	G	A	1	2	3	0	0	3	0	0
22	17571533	.	C	A	6	3	9	0	0	9	0	0
22	17590019	.	G	A	0	2	2	0	0	2	0	0
22	17590037	.	C	T	0	1	1	0	1	2	0	0
22	17591712	.	G	A	7	16	23	0	1	24	0	0
22	17596874	.	G	A	0	2	2	0	0	2	0	0
22	17596903	.	C	G	5	18	23	0	0	23	0	0
22	17596943	.	A	T	7	25	32	0	3	35	0	0
22	17606908	.	A	C	10	5	15	0	0	15	0	0
22	17607226	.	G	A	9	8	17	0	0	17	0	0
22	17609589	.	C	G	1	0	1	0	0	1	0	0
22	17828741	.	C	T	9	7	16	0	1	17	0	0
22	17829069	.	A	C	8	5	13	0	0	13	0	0
22	17829168	.	A	G	15	8	23	0	0	23	0	0
22	17830360	.	A	G	23	14	37	0	1	38	0	0
22	17830632	.	A	G	11	14	25	0	1	26	0	0
22	17830640	.	A	G	12	15	27	0	0	27	0	0
22	17864952	.	G	A	1	7	8	0	0	8	0	0
22	17865043	.	A	G	4	11	15	0	3	18	0	0
22	17865106	.	G	A	2	10	12	0	1	13	0	0
22	17867570	.	C	T	5	16	21	0	0	21	0	0
22	17878868	.	G	A	1	1	2	0	0	2	0	0
22	17998481	.	G	A	1	3	4	0	0	4	0	0
22	17998719	.	A	C	4	0	4	0	1	5	0	0
22	17998726	.	G	A	4	2	6	0	0	6	0	0
22	17999671	.	T	C	0	1	1	0	1	2	0	0
22	18004724	.	C	T	1	2	3	0	1	4	0	0
22	18022162	.	G	A	1	4	5	0	0	5	0	0
22	18156459	.	G	A	1	0	1	0	0	1	0	0
22	18164768	.	T	A	0	2	2	0	0	2	0	0
22	18175132	.	T	A	2	1	3	0	0	3	0	0
22	18175154	.	C	G	0	2	2	0	0	2	0	0
22	18211058	.	G	A	0	1	1	0	0	1	0	0
22	18213480	.	A	C	0	3	3	0	1	4	0	0
22	18213656	.	A	T	1	1	2	0	0	2	0	0
22	18214077	.	A	T	1	2	3	0	0	3	0	0
22	18231011	.	G	C	1	2	3	0	0	3	0	0
22	18231370	.	A	G	3	4	7	0	2	9	0	0
22	18231673	.	T	A	4	7	11	0	0	11	0	0
22	18231770	.	C	G	3	1	4	0	2	6	0	0
22	18231836	.	A	T	2	4	6	0	0	6	0	0
22	18232416	.	G	A	4	2	6	0	0	6	0	0
22	18232475	.	A	C	2	4	6	0	0	6	0	0
22	18232503	.	G	C	2	3	5	0	0	5	0	0
22	18232527	.	C	T	3	4	7	0	0	7	0	0
22	18232754	.	T	C	1	4	5	0	0	5	0	0
22	18232868	.	G	T	3	3	6	0	0	6	0	0
22	18232935	.	T	G	5	5	10	0	0	10	0	0
22	18233053	.	C	A	6	8	14	0	0	14	0	0
22	18233284	.	T	A	7	4	11	0	0	11	0	0
22	18233367	.	T	A	7	4	11	0	0	11	0	0
22	18233403	.	G	A	5	6	11	0	1	12	0	0
22	18233747	.	T	C	3	4	7	0	1	8	0	0
22	18234340	.	A	C	1	0	1	0	0	1	0	0
22	18247883	.	T	C	4	3	7	0	1	8	0	0
22	18353302	.	T	G	1	2	3	0	0	3	0	0
22	18373283	.	C	A	1	1	2	0	0	2	0	0
22	18376143	.	G	C	0	1	1	0	1	2	0	0
22	18376359	.	C	A	4	9	13	0	0	13	0	0
22	18376434	.	G	A	6	1	7	0	3	10	0	0
22	18376467	.	A	C	5	2	7	0	1	8	0	0
22	18383311	.	G	T	0	4	4	0	4	8	0	0
22	18384306	.	G	T	5	5	10	0	0	10	0	0
22	18384330	.	T	G	5	5	10	0	0	10	0	0
22	18384352	.	G	C	7	5	12	0	1	13	0	0
22	18459182	.	C	T	7	2	9	0	0	9	0	0
22	18461964	.	C	T	5	5	10	0	1	11	0	0
22	18462018	.	A	G	12	7	19	0	0	19	0	0
22	18462239	.	C	T	7	11	18	0	1	19	0	0
22	18464455	.	T	C	1	2	3	0	0	3	0	0
22	18488823	.	T	C	3	6	9	0	0	9	0	0
22	18488952	.	C	A	6	3	9	0	0	9	0	0
22	18489191	.	A	G	1	0	1	0	0	1	0	0
22	18542090	.	C	T	25	15	40	0	3	43	0	0
22	18542508	.	A	G	27	5	32	0	2	34	0	0
22	18542720	.	A	T	19	20	39	0	2	41	0	0
22	18543819	.	C	G	33	21	54	0	0	54	0	0
22	18543847	.	T	G	35	25	60	0	1	61	0	0
22	18544465	.	C	T	0	4	4	0	6	10	0	0
22	18544992	.	T	C	14	5	19	0	0	19	0	0
22	18726040	.	A	T	17	16	33	0	2	35	0	0
22	18726470	.	A	T	18	18	36	0	1	37	0	0
22	18726505	.	T	A	13	25	38	0	1	39	0	0
22	18726668	.	C	A	16	13	29	0	1	30	0	0
22	18727787	.	C	A	0	6	6	0	11	17	0	0
22	18727890	.	G	A	12	12	24	0	1	25	0	0
22	18736155	.	T	C	14	0	14	0	25	39	0	0
22	18736182	.	C	T	14	25	39	0	1	40	0	0
22	18736859	.	A	G	17	16	33	0	3	36	0	0
22	18746486	.	A	G	3	13	16	0	1	17	0	0
22	18778872	.	C	T	24	33	57	0	1	58	0	0
22	18778895	.	A	C	20	34	54	0	2	56	0	0
22	18787118	.	G	A	1	4	5	0	0	5	0	0
22	18799110	.	T	G	1	3	4	0	0	4	0	0
22	18799190	.	C	T	8	5	13	0	0	13	0	0
22	18966298	.	T	C	2	3	5	0	0	5	0	0
22	18966421	.	G	A	4	4	8	0	0	8	0	0
22	18966575	.	T	C	1	0	1	0	0	1	0	0
22	18971667	.	T	C	4	7	11	1	0	12	0	0
22	18971697	.	T	C	2	7	9	0	0	9	0	0
22	18971725	.	T	C	2	4	6	0	0	6	0	0
22	20475744	.	A	G	4	2	6	0	0	6	0	0
22	21342101	.	G	A	1	2	3	0	0	3	0	0
22	21361753	.	T	C	1	2	3	0	0	3	0	0
22	21365143	.	C	T	0	2	2	0	3	5	0	0
22	21367155	.	G	C	3	3	6	0	1	7	0	0
22	21369882	.	C	T	0	4	4	0	3	7	0	0
22	21399836	.	A	G	2	0	2	0	3	5	0	0
22	21407312	.	T	C	1	2	3	0	0	3	0	0
22	21454448	.	A	G	2	0	2	0	1	3	0	0
22	21465109	.	T	C	3	5	8	0	0	8	0	0
22	21465156	.	T	C	2	4	6	0	0	6	0	0
22	21465232	.	T	C	1	4	5	0	1	6	0	0
22	21465263	.	T	C	3	3	6	0	0	6	0	0
22	21465461	.	G	A	1	2	3	0	0	3	0	0
22	21465597	.	G	T	5	5	10	0	0	10	0	0
22	21465606	.	T	C	5	5	10	0	0	10	0	0
22	21544232	.	G	A	0	2	2	0	0	2	0	0
22	21583985	.	G	A	2	2	4	0	0	4	0	0
22	21584038	.	G	A	2	2	4	0	0	4	0	0
22	21618495	.	A	G	5	1	6	0	3	9	0	0
22	21618633	.	G	A	5	15	20	0	3	23	0	0
22	21624764	.	G	C	6	6	12	0	0	12	0	0
22	21657871	.	C	T	1	2	3	0	1	4	0	0
22	21661029	.	T	C	5	9	14	0	0	14	0	0
22	21661258	.	T	A	2	2	4	0	0	4	0	0
22	21661611	.	A	G	0	0	0	0	4	4	0	0
22	21661789	.	G	A	4	2	6	0	0	6	0	0
22	21661819	.	T	C	0	8	8	0	0	8	0	0
22	21662138	.	G	A	0	6	6	0	3	9	0	0
22	21676215	.	A	G	1	2	3	0	0	3	0	0
22	21676233	.	G	A	3	7	10	0	0	10	0	0
22	21680218	.	G	T	7	5	12	0	1	13	0	0
22	21680240	.	T	A	5	3	8	0	0	8	0	0
22	21737948	.	T	C	0	0	0	0	1	1	0	0
22	21852158	.	C	T	10	20	30	0	1	31	0	0
22	21852269	.	A	G	8	9	17	0	0	17	0	0
22	21852281	.	T	C	6	0	6	0	5	11	0	0
22	22129883	.	T	C	4	3	7	0	0	7	0	0
22	22130015	.	T	A	7	4	11	0	0	11	0	0
22	22130085	.	C	T	7	10	17	0	0	17	0	0
22	22130255	.	G	A	7	12	19	0	0	19	0	0
22	22130414	.	A	C	3	0	3	0	3	6	0	0
22	22130468	.	T	C	0	0	0	0	8	8	0	0
22	22130528	.	G	A	2	3	5	0	1	6	0	0
22	22130549	.	T	C	3	3	6	0	1	7	0	0
22	22141567	.	G	A	3	3	6	0	0	6	0	0
22	22175503	.	T	C	3	0	3	0	0	3	0	0
22	22179825	.	C	T	1	5	6	0	1	7	0	0
22	22188682	.	T	C	7	13	20	0	0	20	0	0
22	22196339	.	G	A	6	5	11	0	1	12	0	0
22	22199227	.	G	A	6	4	10	0	1	11	0	0
22	22204002	.	C	T	9	6	15	0	0	15	0	0
22	22204098	.	C	T	6	3	9	0	0	9	0	0
22	22204395	.	G	A	3	8	11	0	0	11	0	0
22	22204440	.	G	A	1	1	2	0	0	2	0	0
22	22214852	.	T	C	2	4	6	0	1	7	0	0
22	22215458	.	G	T	0	4	4	0	0	4	0	0
22	22231662	.	C	T	10	5	15	0	0	15	0	0
22	22231717	.	A	T	7	7	14	0	0	14	0	0
22	22234418	.	C	T	1	10	11	0	12	23	0	0
22	22241772	.	A	T	5	5	10	0	0	10	0	0
22	22245400	.	T	C	2	5	7	0	0	7	0	0
22	22245781	.	G	T	6	11	17	0	0	17	0	0
22	22251493	.	A	C	7	0	7	0	7	14	0	0
22	22259155	.	G	A	2	7	9	0	0	9	0	0
22	22260456	.	G	A	3	2	5	0	0	5	0	0
22	22266519	.	T	C	0	7	7	0	0	7	0	0
22	22267524	.	G	C	0	0	0	0	2	2	0	0
22	22273388	.	C	T	3	3	6	0	0	6	0	0
22	22273871	.	A	C	8	5	13	0	0	13	0	0
22	22274000	.	A	T	6	10	16	0	0	16	0	0
22	22274137	.	C	T	4	5	9	0	0	9	0	0
22	22274157	.	G	T	3	4	7	0	0	7	0	0
22	22274249	.	T	G	3	5	8	0	1	9	0	0
22	22276418	.	C	T	5	3	8	0	1	9	0	0
22	22276595	.	T	C	1	3	4	0	0	4	0	0
22	22276714	.	C	T	0	3	3	0	0	3	0	0
22	22282815	.	G	A	3	2	5	0	0	5	0	0
22	22311283	.	T	C	2	0	2	0	0	2	0	0
22	22312463	.	G	A	4	2	6	0	0	6	0	0
22	22312548	.	C	A	7	2	9	0	1	10	0	0
22	22313260	.	A	T	1	4	5	0	1	6	0	0
22	22313376	.	T	C	1	5	6	0	0	6	0	0
22	22313395	.	G	A	0	7	7	0	3	10	0	0
22	22313574	.	A	G	1	0	1	0	3	4	0	0
22	22313601	.	C	T	4	3	7	0	0	7	0	0
22	22313639	.	A	C	3	5	8	0	1	9	0	0
22	22313927	.	G	C	2	6	8	0	0	8	0	0
22	22313953	.	T	A	1	7	8	0	0	8	0	0
22	22314547	.	T	A	5	4	9	0	0	9	0	0
22	22314564	.	C	A	6	4	10	0	1	11	0	0
22	22314721	.	A	G	12	6	18	0	0	18	0	0
22	22314861	.	C	G	4	4	8	0	0	8	0	0
22	22314870	.	G	C	3	4	7	0	0	7	0	0
22	22314991	.	T	C	2	4	6	0	0	6	0	0
22	22315048	.	T	C	2	2	4	0	1	5	0	0
22	22315211	.	A	G	2	2	4	0	0	4	0	0
22	22345136	.	C	T	0	8	8	0	7	15	0	0
22	22345179	.	A	C	9	9	18	0	3	21	0	0
22	22345255	.	G	A	10	18	28	0	0	28	0	0
22	22345367	.	C	T	1	9	10	0	18	28	0	0
22	22345403	.	G	A	11	17	28	0	1	29	0	0
22	22345418	.	G	A	13	13	26	0	4	30	0	0
22	22351103	.	A	T	3	5	8	0	0	8	0	0
22	22351180	.	A	T	8	4	12	0	0	12	0	0
22	22352611	.	A	C	13	7	20	0	1	21	0	0
22	22352693	.	T	A	9	6	15	0	1	16	0	0
22	22353222	.	G	A	8	13	21	0	1	22	0	0
22	22353416	.	A	G	8	10	18	0	1	19	0	0
22	22353779	.	G	A	2	6	8	0	0	8	0	0
22	22353887	.	G	A	7	12	19	0	0	20	1	0
22	22354145	.	G	A	7	10	17	0	0	17	0	0
22	22354217	.	G	A	3	3	6	0	0	6	0	0
22	22354698	.	C	T	0	1	1	0	3	4	0	0
22	22376081	.	G	C	1	0	1	0	0	1	0	0
22	22376174	.	C	T	0	7	7	0	3	10	0	0
22	22397336	.	G	A	4	8	12	0	0	12	0	0
22	22397402	.	A	C	4	0	4	0	4	8	0	0
22	22416255	.	G	T	3	3	6	0	0	6	0	0
22	22420420	.	A	G	5	8	13	0	0	13	0	0
22	22420664	.	A	G	3	4	7	0	0	7	0	0
22	22420746	.	G	T	1	2	3	0	1	4	0	0
22	22422123	.	A	T	4	2	6	0	0	6	0	0
22	22422264	.	C	T	1	0	1	0	1	2	0	0
22	22422270	.	G	T	1	0	1	0	1	2	0	0
22	22424034	.	G	A	1	0	1	0	0	1	0	0
22	22424058	.	C	T	3	2	5	0	0	5	0	0
22	22425439	.	T	C	4	3	7	0	0	7	0	0
22	22427442	.	T	C	1	4	5	0	0	5	0	0
22	22427612	.	C	T	4	7	11	0	1	12	0	0
22	22427694	.	C	T	4	9	13	0	2	15	0	0
22	22427880	.	C	T	1	4	5	0	1	6	0	0
22	22428015	.	T	A	2	2	4	0	0	4	0	0
22	22428076	.	A	G	1	0	1	0	2	3	0	0
22	22636374	.	G	T	2	2	4	0	0	4	0	0
22	22636482	.	G	C	1	3	4	0	0	4	0	0
22	23479064	.	G	A	0	2	2	0	2	4	0	0
22	23493268	.	C	A	2	2	4	0	0	4	0	0
22	23512582	.	G	C	1	2	3	0	0	3	0	0
22	23512621	.	G	T	1	2	3	0	1	4	0	0
22	23513044	.	C	T	0	1	1	0	0	1	0	0
22	23513045	.	G	T	0	1	1	0	0	1	0	0
22	23515509	.	A	C	1	2	3	0	0	3	0	0
22	23515530	.	C	T	0	2	2	0	1	3	0	0
22	24157961	.	G	C	12	16	28	0	2	30	0	0
22	24158037	.	T	A	11	10	21	0	0	21	0	0
22	24158146	.	A	C	14	8	22	0	0	22	0	0
22	24158190	.	C	T	19	12	31	0	1	32	0	0
22	24158242	.	C	A	15	13	28	0	3	31	0	0
22	24158275	.	G	C	13	13	26	0	2	28	0	0
22	24166896	.	G	A	1	13	14	0	12	26	0	0
22	24166919	.	A	G	14	16	30	0	0	30	0	0
22	24167633	.	C	T	15	12	27	0	2	29	0	0
22	24168125	.	T	C	11	21	32	0	0	32	0	0
22	24168573	.	T	C	16	17	33	0	0	33	0	0
22	24168610	.	T	A	17	16	33	0	1	34	0	0
22	24218656	.	T	A	3	5	8	0	1	9	0	0
22	24220962	.	A	G	11	19	30	0	0	30	0	0
22	24220996	.	G	A	21	13	34	0	1	35	0	0
22	24221009	.	C	T	14	15	29	0	1	30	0	0
22	24225409	.	T	C	4	6	10	0	0	10	0	0
22	24229513	.	T	C	14	17	31	0	1	32	0	0
22	24229890	.	T	C	7	2	9	0	0	9	0	0
22	24230005	.	G	A	0	2	2	0	5	7	0	0
22	24230020	.	G	A	7	9	16	0	0	16	0	0
22	24233536	.	G	T	19	9	28	0	1	29	0	0
22	24233730	.	C	T	2	2	4	0	0	4	0	0
22	24359272	.	A	G	5	0	5	0	2	7	0	0
22	24359834	.	A	G	6	2	8	0	0	8	0	0
22	24361095	.	A	G	10	4	14	0	0	14	0	0
22	24621873	.	A	G	4	4	8	0	0	8	0	0
22	24715404	.	A	G	2	0	2	0	10	12	0	0
22	24716636	.	T	A	17	13	30	0	0	30	0	0
22	24717105	.	G	A	6	7	13	0	1	14	0	0
22	24718973	.	T	C	11	9	20	0	0	20	0	0
22	24975613	.	C	T	1	7	8	0	0	8	0	0
22	24975753	.	G	A	2	2	4	0	0	4	0	0
22	24975792	.	C	T	2	1	3	0	0	3	0	0
22	24981171	.	T	C	1	0	1	0	0	1	0	0
22	24984053	.	A	C	0	1	1	0	0	1	0	0
22	25025208	.	G	A	16	26	42	0	0	42	0	0
22	25028424	.	G	A	10	12	22	0	1	23	0	0
22	25028660	.	G	A	4	2	6	0	0	6	0	0
22	25028694	.	G	A	13	6	19	0	0	19	0	0
22	25032266	.	C	T	8	19	27	0	2	29	0	0
22	25032344	.	C	T	1	16	17	0	10	27	0	0
22	25032532	.	C	G	12	12	24	0	0	24	0	0
22	25032572	.	G	A	7	15	22	0	2	24	0	0
22	25032620	.	A	C	11	2	13	0	15	28	0	0
22	25032857	.	G	A	13	12	25	0	1	26	0	0
22	25032863	.	A	G	13	11	24	0	1	25	0	0
22	25032921	.	A	T	12	8	20	0	0	20	0	0
22	25040898	.	T	C	0	0	0	0	1	1	0	0
22	25042830	.	A	G	2	2	4	0	0	4	0	0
22	25050339	.	G	A	1	4	5	0	0	5	0	0
22	25053542	.	C	T	0	1	1	0	0	1	0	0
22	25053744	.	A	G	1	1	2	0	0	2	0	0
22	25054425	.	G	A	1	0	1	0	0	1	0	0
22	25055645	.	G	T	0	2	2	0	0	2	0	0
22	25059919	.	G	A	0	2	2	0	2	4	0	0
22	25060629	.	C	A	2	0	2	0	0	2	0	0
22	25063474	.	C	T	1	2	3	0	0	3	0	0
22	25063696	.	A	G	5	0	5	0	9	14	0	0
22	25063745	.	C	A	4	6	10	0	2	12	0	0
22	25063767	.	C	A	7	6	13	0	0	13	0	0
22	25066332	.	C	T	0	0	0	0	3	3	0	0
22	25066410	.	T	C	8	12	20	0	1	21	0	0
22	25066585	.	G	A	3	5	8	0	0	8	0	0
22	25066939	.	C	T	9	5	14	0	0	14	0	0
22	25067269	.	G	A	4	1	5	0	0	5	0	0
22	25067274	.	A	G	2	3	5	0	0	5	0	0
22	25067596	.	C	T	6	3	9	0	1	10	0	0
22	25069856	.	G	A	3	5	8	0	1	9	0	0
22	25069884	.	C	A	2	6	8	0	1	9	0	0
22	25072073	.	G	A	2	2	4	0	1	5	0	0
22	25072474	.	C	G	1	2	3	0	0	3	0	0
22	25076701	.	G	A	4	2	6	0	0	6	0	0
22	25076727	.	A	G	4	6	10	0	0	10	0	0
22	25078630	.	A	C	9	11	20	0	0	20	0	0
22	25554236	.	C	T	2	4	6	0	0	6	0	0
22	25554258	.	T	C	4	4	8	0	0	8	0	0
22	25566614	.	G	A	1	1	2	0	0	2	0	0
22	25573161	.	C	T	1	1	2	0	0	2	0	0
22	25573197	.	G	T	7	3	10	0	0	10	0	0
22	25577248	.	C	T	1	1	2	0	0	2	0	0
22	25582764	.	T	C	3	2	5	0	1	6	0	0
22	25586963	.	C	T	5	2	7	0	0	7	0	0
22	25842741	.	G	T	1	2	3	0	0	3	0	0
22	25844997	.	C	T	1	3	4	0	0	4	0	0
22	25845159	.	T	G	4	2	6	0	0	6	0	0
22	25931976	.	A	G	2	0	2	0	3	5	0	0
22	25935627	.	G	A	0	5	5	0	3	8	0	0
22	25937001	.	G	A	0	2	2	0	2	4	0	0
22	25937037	.	T	A	6	5	11	0	0	11	0	0
22	25937052	.	T	C	5	8	13	0	1	14	0	0
22	25938882	.	T	C	2	2	4	0	0	4	0	0
22	25938915	.	C	T	1	0	1	0	0	1	0	0
22	25942660	.	A	G	4	2	6	0	0	6	0	0
22	25942728	.	A	G	2	0	2	0	4	6	0	0
22	25942822	.	A	G	4	5	9	0	0	9	0	0
22	25942884	.	C	T	2	4	6	0	0	6	0	0
22	25942997	.	T	G	3	5	8	0	1	9	0	0
22	26239602	.	T	C	2	4	6	0	1	7	0	0
22	26239654	.	A	T	4	7	11	0	0	11	0	0
22	26239681	.	C	T	0	8	8	0	5	13	0	0
22	26239752	.	G	A	5	5	10	0	0	10	0	0
22	26239774	.	T	A	5	4	9	0	1	10	0	0
22	26239798	.	C	A	0	5	5	0	4	9	0	0
22	26239873	.	T	A	10	5	15	0	0	15	0	0
22	26239879	.	G	A	10	5	15	0	1	16	0	0
22	26243236	.	A	C	6	0	6	0	4	10	0	0
22	26243242	.	C	T	6	5	11	0	0	11	0	0
22	26244755	.	C	T	4	3	7	0	1	8	0	0
22	26265498	.	A	T	3	1	4	0	0	4	0	0
22	26266807	.	T	A	0	1	1	0	0	1	0	0
22	26274099	.	G	A	3	3	6	0	0	6	0	0
22	26274106	.	A	T	4	4	8	0	0	8	0	0
22	26277695	.	T	C	8	7	15	0	2	17	0	0
22	26277735	.	A	C	5	11	16	0	0	16	0	0
22	26277773	.	G	A	10	11	21	0	2	23	0	0
22	26277820	.	T	C	12	6	18	0	2	20	0	0
22	26277939	.	T	C	7	0	7	0	4	11	0	0
22	26278042	.	T	C	9	4	13	0	0	13	0	0
22	26278081	.	C	T	13	4	17	0	0	17	0	0
22	26278273	.	G	A	4	2	6	0	0	6	0	0
22	26281043	.	A	G	9	13	22	0	1	23	0	0
22	26289430	.	G	A	5	3	8	0	0	8	0	0
22	26289501	.	A	T	2	5	7	0	0	7	0	0
22	26290508	.	C	T	16	18	34	0	1	35	0	0
22	26290764	.	A	G	3	2	5	0	0	5	0	0
22	26290797	.	T	G	2	0	2	0	4	6	0	0
22	26290851	.	A	T	2	6	8	0	0	8	0	0
22	26307620	.	T	G	0	3	3	0	0	3	0	0
22	26307671	.	A	G	4	7	11	0	0	11	0	0
22	26307728	.	A	G	6	3	9	0	0	9	0	0
22	26307743	.	T	C	3	0	3	0	3	6	0	0
22	26313876	.	A	T	0	4	4	0	0	4	0	0
22	26317666	.	T	A	1	3	4	0	0	4	0	0
22	26317671	.	A	G	1	3	4	0	0	4	0	0
22	26525112	.	T	C	2	3	5	0	0	5	0	0
22	26525118	.	C	T	0	2	2	0	3	5	0	0
22	26525935	.	T	G	1	5	6	0	0	6	0	0
22	26525960	.	A	G	3	5	8	0	0	8	0	0
22	26525979	.	C	T	3	5	8	0	1	9	0	0
22	26526004	.	A	T	2	3	5	0	1	6	0	0
22	26526057	.	C	T	0	3	3	0	7	10	0	0
22	26526249	.	A	T	1	7	8	0	0	8	0	0
22	26526296	.	A	G	6	3	9	0	0	9	0	0
22	26526412	.	G	A	5	3	8	0	0	8	0	0
22	26526522	.	G	A	1	2	3	0	1	4	0	0
22	26526864	.	C	A	4	5	9	0	1	10	0	0
22	26527493	.	A	G	3	5	8	0	0	8	0	0
22	26527864	.	C	T	1	4	5	0	0	5	0	0
22	26528861	.	A	T	2	3	5	0	0	5	0	0
22	26529315	.	G	A	6	5	11	0	1	12	0	0
22	26529438	.	C	A	1	2	3	0	5	8	0	0
22	26529471	.	G	T	5	0	5	0	0	5	0	0
22	26529500	.	T	G	0	2	2	0	0	2	0	0
22	26703217	.	G	A	3	3	6	0	3	9	0	0
22	26703218	.	C	A	3	3	6	0	3	9	0	0
22	26703503	.	C	T	3	4	7	0	0	7	0	0
22	26738889	.	A	C	0	2	2	0	0	2	0	0
22	26739000	.	C	T	3	6	9	0	0	9	0	0
22	26739087	.	A	G	8	0	8	0	7	15	0	0
22	26739094	.	G	A	8	3	11	0	1	12	0	0
22	26739273	.	T	C	2	3	5	0	0	5	0	0
22	26739480	.	C	T	3	0	3	0	0	3	0	0
22	26751297	.	C	T	1	2	3	0	0	3	0	0
22	26768020	.	C	G	0	1	1	0	0	1	0	0
22	26768023	.	T	C	0	1	1	0	0	1	0	0
22	26768400	.	A	G	3	0	3	0	1	4	0	0
22	26768433	.	A	G	3	3	6	0	0	6	0	0
22	26771067	.	G	T	6	5	11	0	0	11	0	0
22	26771494	.	G	A	0	1	1	0	5	6	0	0
22	26774079	.	G	A	0	3	3	0	4	7	0	0
22	26774660	.	C	T	1	1	2	0	0	2	0	0
22	26776678	.	C	T	6	3	9	0	1	10	0	0
22	26776681	.	G	A	7	3	10	0	1	11	0	0
22	26785290	.	C	T	4	1	5	0	0	5	0	0
22	26786013	.	A	G	5	4	9	0	0	9	0	0
22	26786559	.	C	A	5	5	10	0	1	11	0	0
22	26787710	.	G	T	6	12	18	0	0	18	0	0
22	26787911	.	C	T	12	24	36	0	3	39	0	0
22	26788340	.	G	A	8	11	19	0	3	22	0	0
22	26788449	.	T	C	15	16	31	0	3	34	0	0
22	26788565	.	T	C	16	17	33	0	2	35	0	0
22	26788885	.	C	A	11	7	18	0	6	24	0	0
22	26789228	.	G	A	1	16	17	0	14	31	0	0
22	26789465	.	A	G	17	1	18	0	9	27	0	0
22	26789667	.	C	G	6	0	6	0	6	12	0	0
22	26789742	.	G	A	2	1	3	0	1	4	0	0
22	26789813	.	A	T	10	9	19	0	0	19	0	0
22	26790074	.	C	T	11	13	24	0	0	24	0	0
22	26790436	.	A	T	10	9	19	0	1	20	0	0
22	26799927	.	G	A	0	2	2	0	2	4	0	0
22	26799960	.	A	G	2	3	5	0	0	5	0	0
22	26804317	.	G	A	0	2	2	0	0	2	0	0
22	26806276	.	A	G	1	2	3	0	0	3	0	0
22	26812016	.	A	G	6	3	9	0	0	9	0	0
22	26812031	.	G	A	5	3	8	0	0	8	0	0
22	26812336	.	A	G	3	0	3	0	4	7	0	0
22	26812506	.	C	T	6	3	9	0	2	11	0	0
22	26812751	.	G	A	2	1	3	0	0	3	0	0
22	26812754	.	A	G	2	2	4	0	0	4	0	0
22	26812825	.	G	A	1	3	4	0	1	5	0	0
22	26813028	.	T	A	5	2	7	0	1	8	0	0
22	26813046	.	G	A	0	3	3	0	4	7	0	0
22	26813224	.	T	C	2	3	5	0	0	5	0	0
22	26813412	.	C	T	3	3	6	0	0	6	0	0
22	26813620	.	A	T	3	4	7	0	0	7	0	0
22	26813642	.	A	T	2	5	7	0	1	8	0	0
22	26813670	.	G	A	6	6	12	0	0	12	0	0
22	26813801	.	A	C	7	5	12	0	0	12	0	0
22	26814164	.	C	G	4	2	6	0	0	6	0	0
22	26818086	.	G	A	0	3	3	0	14	17	0	0
22	26818700	.	T	C	4	6	10	0	1	11	0	0
22	26818851	.	T	A	7	4	11	0	1	12	0	0
22	26818907	.	A	G	5	0	5	0	7	12	0	0
22	26832125	.	G	A	7	7	14	0	0	14	0	0
22	26839502	.	T	A	6	7	13	0	0	13	0	0
22	26839505	.	G	A	5	6	11	0	1	12	0	0
22	26839538	.	T	G	7	5	12	0	0	12	0	0
22	26844260	.	G	A	16	14	30	0	1	31	0	0
22	26844345	.	A	C	5	6	11	0	0	11	0	0
22	26851904	.	A	C	4	0	4	0	5	9	0	0
22	26851963	.	T	C	6	4	10	0	3	13	0	0
22	26852142	.	A	C	1	6	7	0	0	7	0	0
22	26852163	.	A	C	1	6	7	0	0	7	0	0
22	26852209	.	G	A	4	4	8	0	0	8	0	0
22	26852243	.	C	T	0	3	3	0	5	8	0	0
22	26854336	.	T	G	0	1	1	0	0	1	0	0
22	26854465	.	A	G	5	2	7	0	0	7	0	0
22	26854530	.	T	C	4	2	6	0	0	6	0	0
22	26854626	.	C	A	6	2	8	0	0	8	0	0
22	26854815	.	A	C	1	3	4	0	0	4	0	0
22	26854965	.	A	G	3	3	6	0	1	7	0	0
22	26855037	.	C	G	2	5	7	0	0	7	0	0
22	26855766	.	A	G	1	3	4	0	0	4	0	0
22	26856023	.	A	G	7	8	15	0	0	15	0	0
22	26856059	.	A	T	5	7	12	0	0	12	0	0
22	26858002	.	A	G	9	7	16	0	1	17	0	0
22	26858037	.	T	C	12	8	20	0	4	24	0	0
22	26858153	.	T	C	1	0	1	0	8	9	0	0
22	26858161	.	T	C	3	6	9	0	0	9	0	0
22	26858216	.	T	C	10	7	17	1	0	18	0	0
22	26860639	.	C	T	0	17	17	0	9	26	0	0
22	26860753	.	T	C	14	7	21	0	0	21	0	0
22	26861264	.	T	C	6	0	6	0	7	13	0	0
22	26865182	.	C	A	3	4	7	0	0	7	0	0
22	26929689	.	G	A	5	1	6	0	0	6	0	0
22	26929826	.	C	A	11	13	24	1	3	28	0	0
22	26929931	.	A	T	16	15	31	0	1	32	0	0
22	26929969	.	A	G	23	14	37	0	1	38	0	0
22	26930076	.	A	G	19	13	32	0	1	33	0	0
22	26930079	.	G	T	19	15	34	0	0	34	0	0
22	26930133	.	G	C	21	14	35	0	1	36	0	0
22	26930313	.	C	T	9	11	20	0	0	20	0	0
22	26930335	.	A	T	13	9	22	0	2	24	0	0
22	26930390	.	C	T	15	17	32	0	1	33	0	0
22	26930489	.	C	G	11	13	24	0	0	24	0	0
22	26930527	.	T	A	9	14	23	0	1	24	0	0
22	26930601	.	T	C	4	9	13	0	0	13	0	0
22	26930735	.	G	C	10	0	10	0	12	22	0	0
22	26930894	.	C	T	0	8	8	0	14	22	0	0
22	26931509	.	G	T	4	3	7	0	0	7	0	0
22	26931544	.	G	A	2	3	5	0	0	5	0	0
22	26931567	.	C	A	1	2	3	0	0	3	0	0
22	26931906	.	C	T	5	6	11	0	1	12	0	0
22	26931967	.	G	A	11	10	21	0	0	21	0	0
22	26940409	.	G	A	1	5	6	0	0	6	0	0
22	27091989	.	C	T	1	5	6	0	0	6	0	0
22	27098736	.	G	A	9	11	20	0	0	20	0	0
22	27102556	.	C	T	5	1	6	0	0	6	0	0
22	27104159	.	C	G	0	1	1	0	1	2	0	0
22	28236839	.	A	T	7	5	12	0	0	12	0	0
22	28240544	.	A	G	0	1	1	0	1	2	0	0
22	28240555	.	T	A	1	1	2	0	0	2	0	0
22	28241719	.	A	T	1	0	1	0	0	1	0	0
22	28241831	.	T	A	1	0	1	0	0	1	0	0
22	28244972	.	A	G	5	2	7	0	0	7	0	0
22	28255399	.	G	T	0	2	2	0	0	2	0	0
22	28255495	.	T	C	1	1	2	0	1	3	0	0
22	28255514	.	C	G	2	0	2	0	0	2	0	0
22	28265596	.	T	G	3	4	7	0	0	7	0	0
22	28284646	.	A	C	0	6	6	0	0	6	0	0
22	28284659	.	C	T	0	2	2	0	0	2	0	0
22	28287669	.	T	C	1	0	1	0	0	1	0	0
22	28290817	.	C	T	3	1	4	0	0	4	0	0
22	28303025	.	C	T	8	2	10	0	0	10	0	0
22	28303091	.	C	A	5	4	9	0	1	10	0	0
22	28446657	.	A	G	1	0	1	0	2	3	0	0
22	28474403	.	T	C	1	0	1	0	0	1	0	0
22	28481589	.	C	T	1	3	4	0	0	4	0	0
22	28481616	.	A	C	2	4	6	0	0	6	0	0
22	28481641	.	G	A	0	4	4	0	2	6	0	0
22	28481742	.	C	T	2	4	6	0	0	6	0	0
22	28481770	.	A	G	2	0	2	0	2	4	0	0
22	28482204	.	G	A	0	4	4	0	2	6	0	0
22	28642555	.	G	A	4	4	8	0	0	8	0	0
22	28642695	.	A	C	3	2	5	0	0	5	0	0
22	28642715	.	C	A	0	2	2	0	3	5	0	0
22	28642818	.	C	A	3	2	5	0	0	5	0	0
22	28642997	.	C	A	3	6	9	0	0	9	0	0
22	28769149	.	G	A	2	3	5	0	0	5	0	0
22	28774089	.	T	C	1	2	3	0	0	3	0	0
22	28774099	.	T	A	1	2	3	0	0	3	0	0
22	28804013	.	G	A	0	7	7	0	2	9	0	0
22	28836202	.	C	T	4	2	6	0	0	6	0	0
22	28836346	.	G	A	4	4	8	0	0	8	0	0
22	28836631	.	A	G	2	5	7	0	1	8	0	0
22	28837231	.	A	G	12	15	27	0	2	29	0	0
22	28839917	.	A	C	9	6	15	0	0	15	0	0
22	28840101	.	C	A	13	10	23	0	0	23	0	0
22	28840154	.	A	G	11	6	17	0	0	17	0	0
22	28847988	.	G	A	15	7	22	0	0	22	0	0
22	28848724	.	A	T	8	7	15	0	1	16	0	0
22	28848735	.	T	C	10	6	16	0	0	16	0	0
22	28848920	.	A	G	6	6	12	0	0	12	0	0
22	28858314	.	A	G	14	11	25	0	2	27	0	0
22	28859346	.	G	A	11	5	16	0	0	16	0	0
22	28859409	.	A	G	26	17	43	0	0	43	0	0
22	28859618	.	A	G	12	13	25	0	0	25	0	0
22	28859683	.	G	T	12	14	26	0	2	28	0	0
22	28862534	.	A	G	5	14	19	0	1	20	0	0
22	28863137	.	G	A	5	2	7	0	1	8	0	0
22	28863140	.	G	A	4	2	6	0	2	8	0	0
22	28865752	.	G	A	4	1	5	0	0	5	0	0
22	28865970	.	A	G	10	11	21	0	0	22	1	0
22	28868174	.	A	G	1	3	4	0	0	4	0	0
22	28871698	.	G	C	13	0	13	0	13	26	0	0
22	29075278	.	C	T	3	5	8	0	2	10	0	0
22	29076126	.	A	G	12	2	14	0	0	14	0	0
22	29076172	.	G	A	9	6	15	0	0	15	0	0
22	29076236	.	T	C	8	10	18	0	0	18	0	0
22	29076381	.	G	C	8	6	14	0	0	14	0	0
22	29076389	.	A	G	9	6	15	0	0	15	0	0
22	29076581	.	G	A	4	4	8	0	1	9	0	0
22	29076616	.	T	A	2	2	4	0	1	5	0	0
22	29076755	.	G	A	4	3	7	0	0	7	0	0
22	29077023	.	T	A	5	12	17	0	0	17	0	0
22	29077380	.	G	A	2	8	10	0	1	11	0	0
22	29077432	.	A	G	4	5	9	0	0	9	0	0
22	29077515	.	G	A	1	4	5	0	0	5	0	0
22	29077665	.	T	A	4	3	7	0	0	7	0	0
22	29078255	.	T	A	5	6	11	0	0	11	0	0
22	29078715	.	C	T	3	8	11	0	0	11	0	0
22	29079722	.	G	T	7	3	10	0	1	11	0	0
22	29079761	.	T	C	6	4	10	0	0	10	0	0
22	29080205	.	G	A	8	6	14	0	1	15	0	0
22	29080233	.	G	A	9	5	14	0	1	15	0	0
22	29091732	.	G	C	3	3	6	0	0	6	0	0
22	29092222	.	C	A	1	3	4	0	0	4	0	0
22	29093632	.	G	T	4	5	9	0	1	10	0	0
22	29096343	.	C	T	0	3	3	0	0	3	0	0
22	29096361	.	G	A	1	4	5	0	0	5	0	0
22	29097228	.	C	T	0	3	3	0	0	3	0	0
22	29097303	.	A	G	7	0	7	0	3	10	0	0
22	29097327	.	T	C	5	3	8	0	0	8	0	0
22	29097354	.	T	A	0	2	2	0	0	2	0	0
22	29103453	.	A	G	2	0	2	0	0	2	0	0
22	29114351	.	G	A	11	4	15	0	4	19	0	0
22	29118736	.	G	A	0	2	2	0	4	6	0	0
22	29119270	.	T	C	5	9	14	0	0	14	0	0
22	29121740	.	G	A	0	1	1	0	2	3	0	0
22	29121765	.	C	T	4	3	7	0	0	7	0	0
22	29121789	.	G	A	0	6	6	0	12	18	0	0
22	29125660	.	C	T	6	3	9	0	0	9	0	0
22	29125699	.	T	A	4	3	7	0	0	7	0	0
22	29125866	.	T	A	5	2	7	0	0	7	0	0
22	29125867	.	T	C	5	2	7	0	0	7	0	0
22	29168879	.	G	A	25	32	57	0	5	63	1	0
22	29168940	.	T	A	32	32	64	0	1	65	0	0
22	29242280	.	A	G	21	13	34	0	1	35	0	0
22	29242296	.	G	C	17	17	34	0	1	35	0	0
22	29242317	.	G	A	5	15	20	0	0	20	0	0
22	29312360	.	T	A	0	3	3	0	1	4	0	0
22	29312363	.	T	C	1	3	4	0	0	4	0	0
22	29312851	.	A	C	6	6	12	0	1	13	0	0
22	29316091	.	T	A	3	3	6	0	0	6	0	0
22	29316139	.	A	T	3	4	7	0	0	7	0	0
22	29585169	.	G	A	2	2	4	0	0	4	0	0
22	29585244	.	G	A	2	2	4	0	0	4	0	0
22	29585247	.	G	C	2	2	4	0	0	4	0	0
22	29585571	.	C	T	3	2	5	0	0	5	0	0
22	29612096	.	A	G	3	1	4	0	1	5	0	0
22	29615056	.	A	G	1	0	1	0	0	1	0	0
22	29617050	.	G	A	2	3	5	0	0	5	0	0
22	29620306	.	A	G	5	4	9	0	0	9	0	0
22	29620488	.	T	G	3	8	11	0	0	11	0	0
22	29640098	.	T	C	3	2	5	0	0	5	0	0
22	29651938	.	C	T	13	15	28	0	1	29	0	0
22	29652161	.	T	A	6	14	20	0	0	20	0	0
22	29652201	.	A	G	4	1	5	0	9	14	0	0
22	29659031	.	T	A	4	2	6	0	0	6	0	0
22	29659637	.	G	A	14	11	25	0	0	25	0	0
22	29666501	.	G	A	20	10	30	0	0	30	0	0
22	29666505	.	C	T	0	20	20	0	12	32	0	0
22	29666746	.	G	A	8	9	17	0	1	18	0	0
22	29668796	.	C	T	2	4	6	0	0	6	0	0
22	29668799	.	C	T	4	1	5	0	0	5	0	0
22	29670324	.	G	A	10	7	17	0	1	18	0	0
22	29671553	.	A	G	0	1	1	0	0	1	0	0
22	29689458	.	T	C	5	4	9	0	1	10	0	0
22	31374023	.	G	A	0	0	0	0	1	1	0	0
22	31383515	.	A	G	1	1	2	0	0	2	0	0
22	31404427	.	T	A	4	3	7	0	0	7	0	0
22	31406548	.	G	A	0	1	1	0	1	2	0	0
22	31440806	.	C	T	2	1	3	0	0	3	0	0
22	31445113	.	A	G	1	2	3	0	0	3	0	0
22	31456026	.	A	T	2	4	6	0	0	6	0	0
22	31668049	.	T	C	4	0	4	0	5	9	0	0
22	31671957	.	T	A	9	8	17	0	0	17	0	0
22	31933332	.	G	A	0	0	0	0	2	2	0	0
22	31933335	.	T	G	0	2	2	0	0	2	0	0
22	33193699	.	G	T	0	5	5	0	0	5	0	0
22	34701901	.	G	C	15	15	30	0	1	31	0	0
22	34706938	.	T	C	16	13	29	0	0	29	0	0
22	34707041	.	A	G	25	3	28	0	12	40	0	0
22	34707062	.	T	G	24	7	31	0	0	32	1	0
22	34707084	.	C	T	20	15	35	0	0	35	0	0
22	34707119	.	G	T	13	23	36	0	3	39	0	0
22	34707272	.	T	A	14	16	30	0	2	32	0	0
22	34707295	.	C	T	14	9	23	0	2	25	0	0
22	34843569	.	C	T	2	3	5	0	0	5	0	0
22	34843892	.	C	T	0	3	3	0	4	7	0	0
22	34843910	.	T	C	4	3	7	0	0	7	0	0
22	34849054	.	A	C	0	0	0	0	2	2	0	0
22	34849285	.	G	A	1	1	2	0	0	2	0	0
22	34849297	.	A	C	1	0	1	0	1	2	0	0
22	34851302	.	T	C	1	0	1	0	2	3	0	0
22	34969696	.	A	G	1	3	4	0	0	4	0	0
22	34969708	.	A	G	1	3	4	0	0	4	0	0
22	34975839	.	G	A	1	2	3	0	0	3	0	0
22	34975842	.	G	A	1	2	3	0	0	3	0	0
22	35013549	.	A	T	4	3	7	0	0	7	0	0
22	35013675	.	C	T	0	5	5	0	4	9	0	0
22	35013679	.	C	T	4	5	9	0	0	9	0	0
22	35014014	.	G	A	3	3	6	0	0	6	0	0
22	35015738	.	G	A	1	2	3	0	0	3	0	0
22	35015828	.	C	T	4	3	7	0	0	7	0	0
22	35016177	.	G	A	8	9	17	0	0	17	0	0
22	35016185	.	A	G	7	10	17	0	0	17	0	0
22	35041537	.	T	C	1	2	3	0	1	4	0	0
22	35049063	.	A	G	0	1	1	0	0	1	0	0
22	35058599	.	A	G	1	1	2	0	0	2	0	0
22	35520389	.	C	T	1	3	4	0	0	4	0	0
22	35531281	.	G	A	2	5	7	0	0	7	0	0
22	35531376	.	A	G	1	4	5	0	0	5	0	0
22	35945668	.	G	A	0	5	5	0	2	7	0	0
22	36505067	.	G	A	1	3	4	0	0	4	0	0
22	36507991	.	A	G	4	6	10	0	0	10	0	0
22	36508008	.	G	A	3	6	9	0	0	9	0	0
22	36521516	.	G	A	1	2	3	0	1	4	0	0
22	36524302	.	T	C	2	4	6	0	1	7	0	0
22	36524374	.	T	A	2	3	5	0	0	5	0	0
22	36527636	.	A	G	0	2	2	0	0	2	0	0
22	36530090	.	C	T	0	5	5	0	8	13	0	0
22	36530155	.	T	C	4	2	6	0	0	6	0	0
22	36592548	.	C	A	1	2	3	0	0	3	0	0
22	36622717	.	A	G	0	2	2	0	0	2	0	0
22	36634111	.	T	C	2	6	8	0	0	8	0	0
22	36634127	.	T	C	2	5	7	0	0	7	0	0
22	36634167	.	G	C	0	2	2	0	1	3	0	0
22	36676056	.	G	C	9	13	22	0	0	22	0	0
22	36679390	.	G	A	13	27	40	0	3	43	0	0
22	36683803	.	C	A	4	1	5	0	0	5	0	0
22	36685729	.	C	T	23	20	43	0	1	44	0	0
22	36686828	.	G	A	4	2	6	0	1	7	0	0
22	36686867	.	G	A	12	13	25	0	1	26	0	0
22	36686870	.	A	G	12	13	25	0	1	26	0	0
22	36686948	.	G	T	3	2	5	0	2	7	0	0
22	36687328	.	G	A	3	5	8	0	2	10	0	0
22	36687403	.	G	A	9	10	19	0	0	19	0	0
22	36687541	.	T	C	2	4	6	0	1	7	0	0
22	36687616	.	C	T	0	16	16	0	8	24	0	0
22	36690668	.	T	A	17	17	34	0	2	36	0	0
22	36690743	.	A	G	3	3	6	0	0	6	0	0
22	36741467	.	T	C	1	0	1	0	2	3	0	0
22	36755582	.	T	C	1	0	1	0	2	3	0	0
22	36755586	.	A	G	1	2	3	0	0	3	0	0
22	36755751	.	A	T	3	3	6	0	0	6	0	0
22	36755831	.	G	A	5	0	5	0	1	6	0	0
22	36755963	.	G	C	9	0	9	0	12	21	0	0
22	36756112	.	A	G	5	10	15	0	0	15	0	0
22	36756325	.	G	A	11	5	16	0	1	17	0	0
22	36756333	.	T	C	5	1	6	0	9	15	0	0
22	36756400	.	C	T	8	6	14	0	0	14	0	0
22	36756404	.	G	C	8	6	14	0	0	14	0	0
22	36756464	.	T	A	5	6	11	0	1	12	0	0
22	36768060	.	C	T	0	2	2	0	3	5	0	0
22	36768102	.	G	A	4	0	4	0	0	4	0	0
22	36795845	.	G	T	5	10	15	0	0	15	0	0
22	36798416	.	G	A	1	1	2	0	0	2	0	0
22	36800981	.	G	C	4	8	12	0	0	12	0	0
22	36801929	.	T	A	1	3	4	0	0	4	0	0
22	36802034	.	A	T	2	4	6	0	0	6	0	0
22	36802106	.	C	T	1	3	4	0	0	4	0	0
22	36802928	.	C	T	0	4	4	0	1	5	0	0
22	36802988	.	A	T	3	4	7	0	0	7	0	0
22	36803210	.	C	T	1	2	3	0	0	3	0	0
22	36803414	.	G	T	2	2	4	0	0	4	0	0
22	36803501	.	T	C	3	2	5	0	0	5	0	0
22	36803531	.	G	A	1	3	4	0	0	4	0	0
22	36803561	.	A	G	0	2	2	0	0	2	0	0
22	36875581	.	T	C	1	7	8	0	1	9	0	0
22	36875584	.	A	G	1	0	1	0	7	8	0	0
22	36877484	.	G	T	0	1	1	0	0	1	0	0
22	36877531	.	G	A	0	4	4	0	4	8	0	0
22	36877534	.	G	T	0	4	4	0	4	8	0	0
22	36877963	.	G	A	1	0	1	0	0	1	0	0
22	36879468	.	G	T	9	1	10	0	0	10	0	0
22	36882150	.	G	A	7	8	15	0	0	15	0	0
22	36882168	.	G	A	0	9	9	0	14	23	0	0
22	36882189	.	G	A	0	8	8	0	8	16	0	0
22	36882388	.	T	C	4	4	8	0	0	8	0	0
22	36882409	.	T	A	4	2	6	0	0	6	0	0
22	36887954	.	C	T	4	0	4	0	0	4	0	0
22	36891142	.	G	A	0	1	1	0	0	1	0	0
22	36893330	.	T	C	9	2	11	0	0	11	0	0
22	36893357	.	G	A	3	13	16	0	0	16	0	0
22	36894316	.	T	A	5	9	14	0	0	15	1	0
22	36894410	.	A	C	2	3	5	0	0	5	0	0
22	36896641	.	G	A	0	1	1	0	1	2	0	0
22	36896677	.	G	T	3	6	9	0	0	9	0	0
22	36899269	.	C	T	3	4	7	0	0	7	0	0
22	36899621	.	A	T	3	11	14	0	0	14	0	0
22	36947793	.	T	A	5	7	12	0	1	13	0	0
22	36947849	.	G	A	3	3	6	0	0	6	0	0
22	36947879	.	G	C	2	6	8	0	1	9	0	0
22	36947997	.	A	G	3	10	13	0	0	13	0	0
22	36948052	.	T	G	3	8	11	0	0	11	0	0
22	36948133	.	G	A	3	6	9	0	2	11	0	0
22	36948134	.	C	T	4	6	10	0	1	11	0	0
22	36948202	.	C	A	2	4	6	0	0	6	0	0
22	36948312	.	C	T	0	8	8	0	6	14	0	0
22	36948395	.	T	C	8	0	8	0	12	20	0	0
22	36948603	.	T	A	5	10	15	0	1	16	0	0
22	36988248	.	C	T	1	3	4	0	1	5	0	0
22	37276635	.	T	C	4	0	4	0	9	13	0	0
22	37276709	.	C	T	0	5	5	0	4	9	0	0
22	37277669	.	G	A	1	2	3	0	0	3	0	0
22	37277688	.	A	G	2	2	4	0	0	4	0	0
22	37278475	.	A	G	11	11	22	0	1	23	0	0
22	37278479	.	T	C	10	0	10	0	11	21	0	0
22	37278634	.	C	T	0	4	4	0	0	4	0	0
22	37347512	.	A	T	1	2	3	0	0	3	0	0
22	37352700	.	C	G	4	9	13	0	1	14	0	0
22	37534122	.	C	G	1	4	5	0	0	5	0	0
22	37543070	.	A	T	7	10	17	0	1	18	0	0
22	37543457	.	A	G	10	10	20	0	0	20	0	0
22	37551481	.	G	C	3	0	3	0	4	7	0	0
22	37551496	.	T	C	0	0	0	0	1	1	0	0
22	37552717	.	G	A	7	7	14	0	2	16	0	0
22	37552783	.	A	C	12	0	12	0	10	22	0	0
22	37553015	.	C	T	0	2	2	0	2	4	0	0
22	37557531	.	G	A	9	13	22	0	1	23	0	0
22	37559603	.	G	A	4	2	6	0	0	6	0	0
22	37561609	.	G	A	1	4	5	0	1	6	0	0
22	37561642	.	C	G	4	2	6	0	1	7	0	0
22	37588622	.	T	C	4	1	5	0	8	13	0	0
22	37588667	.	A	C	3	12	15	0	0	15	0	0
22	37588715	.	T	C	7	8	15	0	4	19	0	0
22	37589898	.	A	T	13	4	17	1	0	18	0	0
22	37590171	.	C	T	3	3	6	0	0	6	0	0
22	37590339	.	A	T	12	8	20	0	3	23	0	0
22	37590535	.	C	T	8	6	14	0	0	14	0	0
22	37590611	.	T	G	3	5	8	0	0	8	0	0
22	37590710	.	T	G	2	6	8	0	0	8	0	0
22	37590711	.	C	T	2	5	7	0	1	8	0	0
22	37590925	.	T	C	5	8	13	0	0	13	0	0
22	37591023	.	A	C	6	8	14	0	0	14	0	0
22	37591491	.	A	T	9	6	15	0	1	16	0	0
22	37599007	.	C	A	2	2	4	0	0	4	0	0
22	37599058	.	G	A	2	4	6	0	0	6	0	0
22	37599076	.	A	G	1	1	2	0	1	3	0	0
22	37602479	.	A	C	2	2	4	0	0	4	0	0
22	37608435	.	T	C	3	0	3	0	5	8	0	0
22	37608465	.	G	A	1	4	5	0	0	5	0	0
22	37611298	.	T	G	2	4	6	0	0	6	0	0
22	37639239	.	C	T	5	7	12	0	0	12	0	0
22	37639311	.	C	T	3	2	5	0	0	5	0	0
22	37641741	.	G	A	6	5	11	0	0	11	0	0
22	37644009	.	C	A	6	10	16	0	1	17	0	0
22	37644021	.	C	G	5	11	16	0	0	16	0	0
22	37644048	.	A	G	2	0	2	0	1	3	0	0
22	37646124	.	C	T	5	3	8	0	0	8	0	0
22	37646226	.	T	A	1	0	1	0	0	1	0	0
22	37652191	.	C	T	4	5	9	0	1	10	0	0
22	37652925	.	C	T	2	0	2	0	0	2	0	0
22	37655702	.	C	T	3	0	3	0	0	3	0	0
22	37697408	.	C	T	7	3	10	0	4	14	0	0
22	37708199	.	T	A	19	14	33	0	1	34	0	0
22	37710178	.	G	T	2	1	3	0	0	3	0	0
22	37712570	.	A	G	8	0	8	0	20	28	0	0
22	37716493	.	G	C	2	6	8	0	0	8	0	0
22	37716613	.	A	T	3	2	5	0	0	5	0	0
22	37805329	.	C	T	17	13	30	0	0	30	0	0
22	37823332	.	C	A	0	2	2	0	6	8	0	0
22	37852868	.	T	C	1	0	1	1	4	6	0	0
22	37874723	.	C	T	1	4	5	0	0	5	0	0
22	37875270	.	T	C	2	5	7	0	0	7	0	0
22	37881126	.	C	T	2	10	12	0	0	12	0	0
22	37881134	.	G	A	2	11	13	0	1	14	0	0
22	37933803	.	T	C	2	1	3	0	0	3	0	0
22	37951769	.	G	A	1	1	2	0	1	3	0	0
22	38001277	.	A	C	3	4	7	0	1	8	0	0
22	38001504	.	G	A	2	1	3	0	0	3	0	0
22	38005108	.	C	A	0	1	1	0	3	4	0	0
22	38014726	.	T	C	1	1	2	0	0	2	0	0
22	38016901	.	G	C	1	1	2	0	0	2	0	0
22	38022147	.	C	T	3	2	5	0	0	5	0	0
22	38026190	.	G	T	1	3	4	0	0	4	0	0
22	38034830	.	C	T	0	2	2	0	1	3	0	0
22	38037578	.	A	T	13	7	20	0	0	20	0	0
22	38037603	.	G	T	8	4	12	0	1	13	0	0
22	38040050	.	G	A	0	3	3	0	0	3	0	0
22	38040070	.	T	G	2	0	2	0	1	3	0	0
22	38044902	.	G	C	0	9	9	0	7	16	0	0
22	38045009	.	T	A	5	10	15	0	6	21	0	0
22	38178747	.	G	A	1	2	3	0	0	3	0	0
22	38191715	.	A	G	2	5	7	0	0	7	0	0
22	38191718	.	T	A	5	2	7	0	0	7	0	0
22	38192440	.	A	G	1	2	3	0	1	4	0	0
22	38194106	.	C	T	4	3	7	0	1	8	0	0
22	38194415	.	A	G	2	3	5	0	1	6	0	0
22	38194419	.	G	C	1	3	4	0	2	6	0	0
22	38195217	.	G	A	11	6	17	0	0	17	0	0
22	38197777	.	C	T	1	1	2	0	0	2	0	0
22	38197783	.	G	C	2	3	5	0	0	5	0	0
22	38199812	.	A	G	3	4	7	0	1	8	0	0
22	38202898	.	T	C	0	2	2	0	0	2	0	0
22	38202904	.	C	T	0	2	2	0	0	2	0	0
22	38205099	.	C	T	0	5	5	0	5	10	0	0
22	38207367	.	T	A	4	1	5	0	0	5	0	0
22	38209139	.	T	G	0	2	2	0	0	2	0	0
22	38209190	.	C	T	1	4	5	0	0	5	0	0
22	38211271	.	C	A	0	3	3	0	5	8	0	0
22	38211350	.	A	G	0	1	1	0	0	1	0	0
22	38216622	.	T	C	2	0	2	0	3	5	0	0
22	38216690	.	G	T	1	2	3	0	0	3	0	0
22	38217308	.	G	C	0	0	0	0	1	1	0	0
22	38283993	.	A	G	1	5	6	0	0	6	0	0
22	38284020	.	A	C	3	5	8	0	2	10	0	0
22	38796652	.	A	T	1	12	13	0	0	13	0	0
22	39080168	.	A	G	1	1	2	0	9	11	0	0
23	320667	.	C	T	0	5	5	0	2	7	0	0
23	358023	.	G	A	3	1	4	0	0	4	0	0
23	367521	.	G	A	1	7	8	0	0	8	0	0
23	458254	.	T	C	4	7	11	0	0	11	0	0
23	496319	.	G	T	0	2	2	0	0	2	0	0
23	496329	.	G	A	1	1	2	0	0	2	0	0
23	527353	.	T	C	3	2	5	0	1	6	0	0
23	552367	.	T	C	3	6	9	0	0	9	0	0
23	552392	.	C	G	0	3	3	0	4	7	0	0
23	570688	.	G	A	8	8	16	0	0	16	0	0
23	570702	.	A	C	8	9	17	0	0	17	0	0
23	571355	.	A	G	12	12	24	0	0	24	0	0
23	571415	.	C	A	0	8	8	0	5	13	0	0
23	571724	.	A	G	1	3	4	0	0	4	0	0
23	580115	.	G	C	0	1	1	0	2	3	0	0
23	584411	.	A	T	12	5	17	0	2	19	0	0
23	584426	.	C	A	10	10	20	0	2	22	0	0
23	584580	.	G	A	0	9	9	0	9	18	0	0
23	584790	.	G	A	0	8	8	0	7	15	0	0
23	585116	.	A	G	4	2	6	0	1	7	0	0
23	585655	.	C	T	4	7	11	0	1	12	0	0
23	585756	.	T	A	10	10	20	0	1	21	0	0
23	585825	.	A	G	5	8	13	0	0	13	0	0
23	585848	.	A	G	7	0	7	0	8	15	0	0
23	585877	.	A	T	7	8	15	0	0	15	0	0
23	586117	.	A	G	9	0	9	0	5	14	0	0
23	586149	.	T	C	6	6	12	0	0	12	0	0
23	586158	.	A	T	5	10	15	0	1	16	0	0
23	586529	.	C	G	9	1	10	0	6	16	0	0
23	586614	.	A	T	7	3	10	0	0	10	0	0
23	586874	.	G	A	9	8	17	0	0	17	0	0
23	587025	.	A	G	18	7	25	0	1	26	0	0
23	587031	.	A	G	6	16	22	0	0	22	0	0
23	587161	.	A	G	11	9	20	0	0	20	0	0
23	587169	.	A	C	10	9	19	0	1	20	0	0
23	587341	.	G	T	14	5	19	0	0	19	0	0
23	587410	.	C	G	11	7	18	0	0	18	0	0
23	587437	.	G	T	9	7	16	0	1	17	0	0
23	587581	.	G	A	13	15	28	0	2	30	0	0
23	587614	.	T	G	13	11	24	0	2	26	0	0
23	587806	.	T	G	4	13	17	0	0	17	0	0
23	587830	.	A	C	11	8	19	0	0	19	0	0
23	587890	.	A	C	13	13	26	0	0	28	2	0
23	587924	.	A	T	12	20	32	0	4	36	0	0
23	587966	.	C	T	15	15	30	0	1	31	0	0
23	588102	.	C	A	9	5	14	0	7	21	0	0
23	597127	.	A	C	12	6	18	0	0	18	0	0
23	597548	.	T	G	8	17	25	0	0	25	0	0
23	597657	.	G	A	15	16	31	0	1	32	0	0
23	607157	.	G	A	0	3	3	0	1	4	0	0
23	607189	.	C	G	2	6	8	0	0	8	0	0
23	607222	.	G	T	3	4	7	0	1	8	0	0
23	607246	.	T	A	2	6	8	0	1	9	0	0
23	608125	.	G	A	2	2	4	0	0	4	0	0
23	608384	.	C	T	0	2	2	0	0	2	0	0
23	608781	.	T	C	2	0	2	0	0	2	0	0
23	610381	.	C	T	0	1	1	0	2	3	0	0
23	610881	.	T	G	2	3	5	0	0	5	0	0
23	610894	.	T	C	2	3	5	0	0	5	0	0
23	610924	.	G	A	3	1	4	0	0	4	0	0
23	611827	.	C	T	0	2	2	0	0	2	0	0
23	611858	.	G	A	1	5	6	0	0	6	0	0
23	614651	.	G	A	1	1	2	0	0	2	0	0
23	618814	.	T	C	4	3	7	0	0	7	0	0
23	618817	.	T	C	3	2	5	0	0	5	0	0
23	3712648	.	C	T	0	3	3	0	0	3	0	0
23	3712654	.	A	G	3	0	3	0	0	3	0	0
23	3712719	.	A	G	5	5	10	0	0	10	0	0
23	3712723	.	C	T	4	5	9	0	0	9	0	0
23	4087597	.	A	G	2	2	4	0	0	4	0	0
23	4271730	.	G	C	8	14	22	0	2	24	0	0
23	6353605	.	C	T	1	1	2	0	0	2	0	0
23	6421788	.	G	A	2	1	3	0	0	3	0	0
23	6573783	.	A	G	0	1	1	0	0	1	0	0
23	6573973	.	G	A	1	2	3	0	0	3	0	0
23	6600949	.	C	T	1	2	3	0	0	3	0	0
23	6631132	.	G	T	2	3	5	0	0	5	0	0
23	6631499	.	G	T	3	3	6	0	0	6	0	0
23	6632043	.	G	A	1	2	3	0	0	3	0	0
23	6632044	.	A	T	1	2	3	0	0	3	0	0
23	6652060	.	C	T	0	1	1	0	1	2	0	0
23	6673694	.	T	A	10	6	16	0	0	16	0	0
23	6673724	.	C	A	0	9	9	0	9	18	0	0
23	6673956	.	A	G	12	13	25	0	1	26	0	0
23	6673991	.	A	C	12	12	24	0	2	26	0	0
23	6674823	.	T	C	1	0	1	0	2	3	0	0
23	6675100	.	C	T	5	8	13	0	0	13	0	0
23	6675135	.	G	A	3	6	9	0	0	9	0	0
23	6675325	.	G	T	8	9	17	0	2	19	0	0
23	6675537	.	G	A	11	12	23	0	0	23	0	0
23	6675550	.	A	T	11	12	23	0	0	23	0	0
23	6675835	.	G	A	9	7	16	0	0	16	0	0
23	6675959	.	C	G	7	6	13	0	0	13	0	0
23	6680521	.	T	C	6	0	6	0	8	14	0	0
23	6680805	.	G	A	2	0	2	0	0	2	0	0
23	6680880	.	C	T	9	17	26	0	0	26	0	0
23	6682025	.	C	T	6	2	8	0	1	9	0	0
23	6683992	.	C	A	0	11	11	0	7	18	0	0
23	6692100	.	T	C	4	0	4	0	4	8	0	0
23	6694340	.	G	A	7	6	13	0	1	14	0	0
23	6694341	.	A	T	8	6	14	0	0	14	0	0
23	6694608	.	A	T	8	9	17	0	1	18	0	0
23	6694634	.	G	T	9	9	18	0	0	18	0	0
23	6694929	.	C	T	0	5	5	0	3	8	0	0
23	6695073	.	T	C	2	5	7	0	1	8	0	0
23	6700626	.	C	A	4	2	6	0	0	6	0	0
23	6703099	.	G	A	0	2	2	0	0	2	0	0
23	6704783	.	C	T	3	3	6	0	0	6	0	0
23	6707243	.	T	A	8	10	18	0	1	19	0	0
23	6707357	.	G	A	7	4	11	0	0	11	0	0
23	6711172	.	C	G	0	4	4	0	4	8	0	0
23	6711634	.	A	C	1	2	3	0	0	3	0	0
23	6714412	.	T	C	7	0	7	0	7	14	0	0
23	6714810	.	G	T	3	4	7	0	0	7	0	0
23	6716785	.	G	A	3	2	5	0	0	5	0	0
23	6717050	.	G	A	5	3	8	0	1	9	0	0
23	6736121	.	T	A	7	6	13	0	0	13	0	0
23	6736166	.	C	T	1	4	5	0	9	14	0	0
23	6744328	.	C	T	0	3	3	0	0	3	0	0
23	6744385	.	C	T	6	1	7	0	1	8	0	0
23	6744576	.	T	G	0	1	1	0	0	1	0	0
23	6749754	.	C	G	6	9	15	0	1	16	0	0
23	6749783	.	T	C	7	0	7	0	10	17	0	0
23	6752944	.	T	A	5	5	10	0	0	10	0	0
23	6753191	.	A	G	5	5	10	0	1	11	0	0
23	6753309	.	C	T	9	6	15	0	0	15	0	0
23	6753363	.	C	T	12	8	20	0	0	20	0	0
23	6753414	.	C	T	5	13	18	0	0	18	0	0
23	6753462	.	G	T	1	14	15	0	3	18	0	0
23	6763911	.	C	A	0	2	2	0	2	4	0	0
23	6773374	.	T	C	8	6	14	0	0	14	0	0
23	6773392	.	G	A	10	7	17	0	0	17	0	0
23	6780803	.	A	G	4	12	16	0	0	16	0	0
23	6780856	.	G	A	0	6	6	0	5	11	0	0
23	6780859	.	G	A	4	7	11	0	0	11	0	0
23	6780895	.	A	G	1	1	2	0	1	3	0	0
23	6783957	.	C	T	5	1	6	0	0	6	0	0
23	6784176	.	C	T	1	2	3	0	0	3	0	0
23	6788768	.	T	C	5	5	10	0	0	10	0	0
23	6795737	.	A	T	6	7	13	0	1	14	0	0
23	6808515	.	C	T	1	2	3	0	0	3	0	0
23	6809524	.	G	A	5	3	8	0	1	9	0	0
23	6814119	.	T	G	9	4	13	0	0	13	0	0
23	6827511	.	C	T	2	3	5	0	0	5	0	0
23	6841005	.	T	C	7	11	18	0	0	18	0	0
23	6841021	.	G	A	1	10	11	0	7	18	0	0
23	6841138	.	C	A	10	4	14	0	1	15	0	0
23	6958166	.	A	G	0	1	1	0	0	1	0	0
23	6958211	.	A	T	1	3	4	0	0	4	0	0
23	6961424	.	G	A	0	2	2	0	0	2	0	0
23	7000229	.	C	T	2	3	5	0	1	6	0	0
23	7003572	.	G	T	8	6	14	0	0	14	0	0
23	7007480	.	C	T	5	5	10	0	0	10	0	0
23	7007879	.	C	T	0	1	1	0	0	1	0	0
23	7017443	.	A	G	2	2	4	0	0	4	0	0
23	7024631	.	T	C	8	10	18	0	1	19	0	0
23	7027534	.	C	T	0	5	5	0	5	10	0	0
23	7029585	.	G	A	3	2	5	0	0	5	0	0
23	7029777	.	A	T	5	2	7	0	0	7	0	0
23	7029964	.	A	C	2	0	2	0	3	5	0	0
23	7032435	.	C	A	5	8	13	0	1	14	0	0
23	7040258	.	G	A	2	6	8	0	1	9	0	0
23	7040708	.	T	A	0	2	2	0	0	2	0	0
23	7040725	.	G	A	0	1	1	0	0	1	0	0
23	7046813	.	G	A	4	6	10	0	0	10	0	0
23	7046816	.	G	C	4	0	4	0	6	10	0	0
23	7047072	.	T	C	9	0	9	0	8	17	0	0
23	7067236	.	T	G	1	6	7	0	2	9	0	0
23	7067257	.	T	C	4	6	10	0	1	11	0	0
23	7068349	.	G	A	5	3	8	0	0	8	0	0
23	7125366	.	A	T	2	2	4	0	0	4	0	0
23	7567446	.	C	T	1	0	1	0	1	2	0	0
23	7573845	.	T	C	0	1	1	0	0	1	0	0
23	7715195	.	G	A	0	2	2	0	1	3	0	0
23	7716281	.	T	C	4	6	10	0	1	11	0	0
23	7718380	.	G	A	3	0	3	0	0	3	0	0
23	7718999	.	C	T	4	2	6	0	0	6	0	0
23	7725252	.	T	C	3	1	4	0	0	4	0	0
23	7728594	.	T	C	5	3	8	0	0	8	0	0
23	7728606	.	C	T	4	2	6	0	0	6	0	0
23	7732760	.	C	G	3	2	5	0	1	6	0	0
23	7732918	.	G	A	3	7	10	0	0	10	0	0
23	7733043	.	C	T	10	6	16	0	1	17	0	0
23	7733081	.	A	G	9	5	14	0	1	15	0	0
23	7733088	.	C	G	6	9	15	0	0	15	0	0
23	7733374	.	C	T	4	5	9	0	0	9	0	0
23	7733444	.	A	G	2	3	5	0	0	5	0	0
23	7733768	.	G	T	2	4	6	0	0	6	0	0
23	7734116	.	G	A	2	4	6	0	0	6	0	0
23	7734321	.	C	T	4	2	6	0	0	6	0	0
23	7734436	.	G	A	5	3	8	0	0	8	0	0
23	7734801	.	C	A	4	1	5	0	0	5	0	0
23	7735497	.	T	C	6	7	13	0	0	13	0	0
23	7735695	.	C	T	4	7	11	0	0	11	0	0
23	7735830	.	G	A	0	2	2	0	1	3	0	0
23	7736257	.	G	A	2	2	4	0	1	5	0	0
23	7743670	.	T	C	5	9	14	0	1	15	0	0
23	7743691	.	T	C	6	6	12	0	0	12	0	0
23	7743871	.	C	T	1	9	10	0	13	23	0	0
23	7743961	.	G	A	0	2	2	0	0	2	0	0
23	7746618	.	T	C	1	1	2	0	2	4	0	0
23	7755088	.	T	C	0	0	0	0	2	2	0	0
23	7755112	.	A	C	2	4	6	0	0	6	0	0
23	7755189	.	T	G	5	5	10	0	0	10	0	0
23	7755215	.	T	C	1	4	5	0	0	5	0	0
23	7765955	.	G	A	4	3	7	0	0	7	0	0
23	7768578	.	C	T	2	1	3	0	0	3	0	0
23	7771378	.	A	T	6	3	9	0	0	9	0	0
23	7771440	.	G	A	1	0	1	0	0	1	0	0
23	7778670	.	G	A	10	6	16	0	0	16	0	0
23	7789930	.	C	T	0	5	5	0	7	12	0	0
23	7792432	.	C	T	11	6	17	0	0	17	0	0
23	8284903	.	C	T	5	4	9	0	0	9	0	0
23	8284991	.	G	T	7	3	10	0	0	10	0	0
23	8285094	.	G	T	3	4	7	0	0	7	0	0
23	8285220	.	G	A	13	15	28	0	0	28	0	0
23	8285297	.	C	T	0	16	16	0	16	32	0	0
23	8285332	.	C	T	18	8	26	0	1	27	0	0
23	8285468	.	T	C	9	5	14	0	1	15	0	0
23	8285585	.	A	T	7	13	20	0	1	21	0	0
23	8285640	.	C	T	5	11	16	0	0	16	0	0
23	8286237	.	G	A	12	10	22	0	0	22	0	0
23	8286261	.	C	T	0	13	13	0	11	24	0	0
23	8286333	.	G	T	8	8	16	0	1	17	0	0
23	8286342	.	C	T	0	6	6	0	10	16	0	0
23	8286384	.	G	T	10	7	17	0	2	19	0	0
23	8286483	.	G	A	6	5	11	0	2	13	0	0
23	8303831	.	A	C	1	0	1	0	5	6	0	0
23	8303897	.	C	T	1	0	1	0	0	1	0	0
23	8699593	.	C	A	3	3	6	0	0	6	0	0
23	8699956	.	C	T	4	4	8	0	0	8	0	0
23	8729994	.	C	T	0	1	1	0	0	1	0	0
23	8730081	.	C	G	3	3	6	0	0	6	0	0
23	8799677	.	C	G	1	3	4	0	0	4	0	0
23	9013456	.	C	G	5	0	5	0	4	9	0	0
23	9013771	.	T	A	7	5	12	0	1	13	0	0
23	9058108	.	C	A	2	3	5	0	0	5	0	0
23	9058408	.	C	T	2	2	4	0	0	4	0	0
23	9058444	.	A	T	3	6	9	0	0	9	0	0
23	9081142	.	T	C	3	2	5	0	0	5	0	0
23	9081490	.	T	G	4	2	6	0	1	7	0	0
23	9081574	.	T	A	3	3	6	0	0	6	0	0
23	9123637	.	C	T	2	3	5	0	0	5	0	0
23	9132147	.	A	G	4	3	7	0	0	7	0	0
23	9132150	.	T	C	4	3	7	0	0	7	0	0
23	9137372	.	G	A	1	3	4	0	0	4	0	0
23	9268466	.	T	C	5	11	16	0	0	16	0	0
23	9272674	.	C	T	5	4	9	0	0	9	0	0
23	9272984	.	T	C	4	8	12	0	0	12	0	0
23	9287629	.	C	T	5	2	7	0	0	7	0	0
23	9794959	.	T	A	14	13	27	0	3	30	0	0
23	9795057	.	A	G	18	16	34	0	1	35	0	0
23	9795097	.	C	T	0	19	19	0	16	35	0	0
23	9795663	.	A	C	8	12	20	0	0	20	0	0
23	9795908	.	C	T	14	12	26	0	0	26	0	0
23	9800761	.	T	G	3	9	12	0	0	12	0	0
23	9800993	.	G	T	3	8	11	0	1	12	0	0
23	9809863	.	A	G	11	13	24	0	1	25	0	0
23	9809977	.	C	T	0	4	4	0	7	11	0	0
23	9810491	.	C	G	13	4	17	1	1	19	0	0
23	10450481	.	A	G	3	3	6	0	0	6	0	0
23	10638386	.	A	G	1	3	4	0	0	4	0	0
23	10638774	.	A	T	4	2	6	0	0	6	0	0
23	10638775	.	T	A	4	2	6	0	0	6	0	0
23	10639037	.	A	G	2	5	7	0	0	7	0	0
23	10642720	.	T	C	2	8	10	0	0	10	0	0
23	10642729	.	A	G	2	7	9	0	1	10	0	0
23	10696523	.	A	G	2	1	3	0	0	3	0	0
23	10724336	.	A	G	13	8	21	0	2	23	0	0
23	10724695	.	A	C	8	0	8	0	3	11	0	0
23	10725012	.	T	C	9	10	19	0	0	19	0	0
23	10725013	.	G	A	8	10	18	0	1	19	0	0
23	10725491	.	T	G	12	11	23	0	1	24	0	0
23	10725753	.	A	C	8	11	19	0	2	21	0	0
23	10727644	.	C	T	0	2	2	0	0	2	0	0
23	10745058	.	G	T	5	5	10	0	1	11	0	0
23	10745139	.	T	G	7	10	17	0	0	17	0	0
23	10762922	.	G	A	11	8	19	0	1	20	0	0
23	10763070	.	G	A	6	4	10	0	1	11	0	0
23	10763182	.	G	C	8	5	13	0	0	13	0	0
23	10763301	.	T	C	8	6	14	0	3	17	0	0
23	10763303	.	T	C	10	7	17	0	0	17	0	0
23	10771991	.	C	A	0	15	15	0	14	29	0	0
23	10805275	.	A	G	3	2	5	0	0	5	0	0
23	10817292	.	T	G	2	4	6	0	1	7	0	0
23	10825541	.	T	A	3	6	9	0	1	10	0	0
23	10825569	.	A	G	9	2	11	0	5	16	0	0
23	10825591	.	C	T	7	5	12	0	1	13	0	0
23	10825996	.	G	A	4	5	9	0	0	9	0	0
23	10826120	.	C	T	12	5	17	0	1	18	0	0
23	10826194	.	C	A	6	4	10	0	0	10	0	0
23	10826618	.	T	C	7	16	23	0	0	23	0	0
23	10826856	.	A	T	6	5	11	0	0	11	0	0
23	10828929	.	T	C	0	3	3	0	1	4	0	0
23	10830346	.	G	A	2	0	2	0	0	2	0	0
23	11669538	.	T	A	1	3	4	0	0	4	0	0
23	11843358	.	C	T	2	2	4	0	0	4	0	0
23	11848645	.	C	T	0	1	1	0	0	1	0	0
23	11851459	.	C	A	4	3	7	0	1	8	0	0
23	11851467	.	C	T	3	4	7	0	1	8	0	0
23	11851545	.	T	C	1	6	7	0	0	7	0	0
23	11861321	.	T	C	1	1	2	0	0	2	0	0
23	11861367	.	C	T	6	3	9	0	0	9	0	0
23	11864948	.	T	C	18	21	39	0	3	42	0	0
23	11865055	.	T	A	8	10	18	0	1	19	0	0
23	11865274	.	A	C	10	9	19	0	0	19	0	0
23	11865510	.	T	C	17	13	30	0	2	32	0	0
23	11865545	.	A	G	22	12	34	0	1	35	0	0
23	11866086	.	G	A	17	18	35	0	2	37	0	0
23	11866259	.	T	C	19	17	36	0	5	41	0	0
23	11870063	.	T	C	3	1	4	0	2	6	0	0
23	11871807	.	G	A	17	18	35	0	0	35	0	0
23	11872533	.	A	G	0	1	1	0	0	1	0	0
23	11878173	.	A	G	8	7	15	0	0	15	0	0
23	11920705	.	G	A	1	5	6	0	0	6	0	0
23	12014796	.	C	T	6	10	16	0	1	17	0	0
23	12014872	.	T	C	17	1	18	0	13	31	0	0
23	12150658	.	G	A	5	2	7	0	0	7	0	0
23	12155166	.	G	A	4	8	12	0	0	12	0	0
23	12155298	.	G	A	9	5	14	0	1	15	0	0
23	12155319	.	G	A	12	6	18	0	0	18	0	0
23	12155364	.	A	G	11	8	19	0	0	19	0	0
23	12155391	.	G	A	8	10	18	0	0	18	0	0
23	12155638	.	A	C	1	0	1	0	0	1	0	0
23	12158399	.	G	A	2	2	4	0	0	4	0	0
23	12161851	.	T	A	3	2	5	0	0	5	0	0
23	12233117	.	G	A	10	12	22	0	0	22	0	0
23	12260903	.	T	C	1	2	3	0	0	3	0	0
23	12278655	.	A	C	1	0	1	0	0	1	0	0
23	12612350	.	A	G	1	4	5	0	0	5	0	0
23	12840452	.	C	T	0	3	3	0	0	3	0	0
23	13313801	.	G	A	4	1	5	0	0	5	0	0
23	13454551	.	A	G	0	2	2	0	0	2	0	0
23	13516414	.	C	T	2	2	4	0	0	4	0	0
23	13558711	.	C	T	1	3	4	0	0	4	0	0
23	13589383	.	A	G	1	1	2	0	0	2	0	0
23	13598632	.	T	C	11	8	19	0	0	19	0	0
23	13598679	.	C	T	4	6	10	0	0	10	0	0
23	13598766	.	A	C	7	8	15	0	1	16	0	0
23	13722416	.	C	A	3	7	10	0	0	10	0	0
23	13806444	.	T	C	14	9	23	0	1	24	0	0
23	13832393	.	A	G	2	1	3	0	1	4	0	0
23	13832412	.	T	C	3	2	5	0	0	5	0	0
23	13833376	.	T	A	2	2	4	0	1	5	0	0
23	13839846	.	A	G	5	4	9	0	0	9	0	0
23	13840362	.	C	T	0	4	4	0	14	18	0	0
23	13845114	.	A	C	6	9	15	0	0	15	0	0
23	13845149	.	T	G	9	10	19	0	0	19	0	0
23	13845201	.	A	G	7	7	14	0	1	15	0	0
23	13845247	.	G	T	3	5	8	0	0	8	0	0
23	13845411	.	G	T	5	8	13	0	0	13	0	0
23	13845447	.	T	C	12	10	22	0	1	23	0	0
23	13845544	.	C	T	11	9	20	0	0	20	0	0
23	13845558	.	C	T	0	10	10	0	6	16	0	0
23	13845764	.	A	G	5	2	7	0	0	7	0	0
23	13846207	.	A	T	3	2	5	0	0	5	0	0
23	13846540	.	C	A	3	3	6	0	0	6	0	0
23	13846631	.	C	T	3	4	7	0	0	7	0	0
23	13846664	.	T	C	3	5	8	0	0	8	0	0
23	13846854	.	C	T	2	2	4	0	0	4	0	0
23	13847142	.	G	A	5	1	6	0	1	7	0	0
23	13847220	.	T	C	4	6	10	0	1	11	0	0
23	13848537	.	G	A	0	2	2	0	1	3	0	0
23	13850343	.	A	G	9	3	12	0	0	12	0	0
23	13851386	.	A	C	3	4	7	0	0	7	0	0
23	13851392	.	A	G	2	4	6	0	1	7	0	0
23	13861509	.	G	A	1	3	4	0	0	4	0	0
23	13872465	.	A	G	2	1	3	0	0	3	0	0
23	13941275	.	C	T	11	6	17	0	1	18	0	0
23	13944394	.	A	G	2	1	3	0	0	3	0	0
23	13948990	.	A	G	3	9	12	0	0	12	0	0
23	13948993	.	G	A	2	9	11	0	1	12	0	0
23	13949074	.	T	C	9	7	16	0	1	17	0	0
23	13949089	.	T	C	7	7	14	0	1	15	0	0
23	13949110	.	C	T	0	8	8	0	8	16	0	0
23	13962739	.	A	G	3	3	6	0	0	6	0	0
23	13963821	.	A	T	1	2	3	0	0	3	0	0
23	13986276	.	G	A	3	4	7	0	0	7	0	0
23	14006105	.	G	A	0	1	1	0	0	1	0	0
23	14056595	.	A	G	5	5	10	0	0	10	0	0
23	14056679	.	G	A	4	2	6	0	1	7	0	0
23	14059036	.	A	G	2	2	4	0	0	4	0	0
23	14059063	.	G	A	1	1	2	0	0	2	0	0
23	14159182	.	A	G	1	0	1	0	0	1	0	0
23	14179725	.	T	G	1	2	3	0	0	3	0	0
23	14193640	.	T	C	1	6	7	0	0	7	0	0
23	14193649	.	G	T	1	5	6	0	2	8	0	0
23	14193777	.	C	T	10	12	22	0	0	22	0	0
23	14193851	.	A	G	12	22	34	0	0	34	0	0
23	14193991	.	T	A	10	7	17	0	2	19	0	0
23	14193996	.	C	A	10	9	19	0	0	19	0	0
23	14194101	.	T	A	6	15	21	0	0	21	0	0
23	14194125	.	A	G	7	13	20	0	0	20	0	0
23	14198137	.	G	A	3	7	10	0	1	11	0	0
23	14201512	.	T	C	11	4	15	0	1	16	0	0
23	14201521	.	T	C	12	5	17	0	0	17	0	0
23	14203829	.	T	G	11	11	22	0	0	22	0	0
23	14208718	.	A	G	4	5	9	0	1	10	0	0
23	14208817	.	A	T	5	6	11	0	0	11	0	0
23	14209024	.	T	G	5	5	10	0	0	10	0	0
23	14211707	.	C	T	5	7	12	0	1	13	0	0
23	14230410	.	A	T	1	2	3	0	0	3	0	0
23	14432386	.	C	A	5	3	8	0	0	8	0	0
23	14432447	.	T	C	2	3	5	0	1	6	0	0
23	14590894	.	T	C	2	2	4	0	0	4	0	0
23	14720159	.	G	A	1	1	2	0	0	2	0	0
23	14720234	.	G	A	0	5	5	0	1	6	0	0
23	14743497	.	A	G	3	2	5	0	0	5	0	0
23	14777039	.	A	C	5	4	9	0	0	9	0	0
23	14782566	.	A	G	4	5	9	0	1	10	0	0
23	14782599	.	C	T	1	1	2	0	0	2	0	0
23	14784198	.	T	A	2	6	8	0	0	8	0	0
23	14784237	.	A	C	3	4	7	0	0	7	0	0
23	14786347	.	T	C	1	7	8	0	0	8	0	0
23	14786429	.	A	T	4	5	9	0	1	10	0	0
23	14787336	.	A	G	3	1	4	0	1	5	0	0
23	14787372	.	T	C	7	6	13	0	0	13	0	0
23	14787378	.	A	G	6	1	7	0	6	13	0	0
23	14787409	.	G	A	0	3	3	0	4	7	0	0
23	14787426	.	G	A	3	2	5	0	0	5	0	0
23	14790659	.	T	C	3	0	3	0	0	3	0	0
23	14790795	.	A	G	0	1	1	0	0	1	0	0
23	14790827	.	G	A	1	3	4	0	1	5	0	0
23	14799653	.	T	C	4	4	8	0	0	8	0	0
23	14808335	.	C	T	1	3	4	0	0	4	0	0
23	14808537	.	G	T	4	3	7	0	1	8	0	0
23	14809613	.	C	A	2	3	5	0	0	5	0	0
23	14832585	.	T	G	4	12	16	0	3	19	0	0
23	14832733	.	G	A	21	19	40	0	3	43	0	0
23	14832740	.	A	C	23	20	43	0	1	44	0	0
23	14832866	.	C	T	21	29	50	0	2	52	0	0
23	14832941	.	C	A	0	27	27	0	23	50	0	0
23	14833142	.	A	T	18	26	44	0	1	45	0	0
23	14833143	.	A	T	18	25	43	0	2	45	0	0
23	14833389	.	A	C	27	9	36	0	1	37	0	0
23	14861741	.	A	G	1	0	1	0	0	1	0	0
23	14990819	.	G	T	5	13	18	0	2	20	0	0
23	14993089	.	G	A	12	14	26	0	1	27	0	0
23	14993302	.	A	C	13	10	23	0	1	24	0	0
23	14993393	.	C	A	7	9	16	0	0	16	0	0
23	14993421	.	G	A	7	5	12	0	0	12	0	0
23	14993438	.	A	G	11	7	18	0	0	18	0	0
23	14993493	.	A	T	11	9	20	0	0	20	0	0
23	14993525	.	A	T	8	9	17	0	0	17	0	0
23	14993563	.	C	G	12	13	25	0	0	25	0	0
23	14997341	.	A	G	9	8	17	0	0	17	0	0
23	14999053	.	C	T	15	8	23	0	1	24	0	0
23	14999095	.	C	T	2	14	16	0	15	31	0	0
23	15003551	.	T	C	8	0	8	0	7	15	0	0
23	15022206	.	T	C	10	1	11	0	11	22	0	0
23	15022511	.	C	T	2	0	2	0	0	2	0	0
23	15022526	.	C	T	2	0	2	0	0	2	0	0
23	15025084	.	G	C	1	0	1	0	5	6	0	0
23	15036698	.	G	A	2	3	5	0	1	6	0	0
23	15046644	.	T	C	2	0	2	0	5	7	0	0
23	15047157	.	C	T	3	2	5	0	0	5	0	0
23	15047322	.	T	C	2	2	4	0	0	4	0	0
23	15047446	.	T	C	1	0	1	0	6	7	0	0
23	15047468	.	A	G	1	7	8	0	0	8	0	0
23	15047674	.	A	G	3	4	7	0	0	7	0	0
23	15050912	.	T	C	1	0	1	0	0	1	0	0
23	15076070	.	T	C	1	2	3	0	0	3	0	0
23	15087187	.	G	C	2	4	6	0	0	6	0	0
23	15204028	.	C	T	22	10	32	0	3	35	0	0
23	15204038	.	T	G	23	8	31	0	0	31	0	0
23	15204222	.	C	T	0	21	21	0	14	35	0	0
23	15204321	.	T	A	11	7	18	0	1	19	0	0
23	15204324	.	T	A	10	8	18	0	2	20	0	0
23	15204417	.	A	G	21	13	34	0	1	35	0	0
23	15204926	.	C	A	8	12	20	0	2	22	0	0
23	15204936	.	G	T	14	8	22	0	0	22	0	0
23	15205100	.	T	G	17	18	35	0	2	37	0	0
23	15205428	.	A	T	16	16	32	0	1	33	0	0
23	15205487	.	C	G	19	15	34	0	2	36	0	0
23	15211253	.	G	C	20	17	37	0	3	40	0	0
23	15215709	.	G	A	15	11	26	0	2	28	0	0
23	15216664	.	G	T	5	1	6	0	1	7	0	0
23	15222509	.	G	A	3	7	10	0	0	10	0	0
23	15222521	.	C	T	4	8	12	0	0	12	0	0
23	15259821	.	G	A	4	8	12	0	0	12	0	0
23	15284602	.	G	T	3	6	9	0	1	10	0	0
23	15284668	.	A	G	3	7	10	0	0	10	0	0
23	15284671	.	G	A	3	6	9	0	0	9	0	0
23	15851064	.	A	G	21	8	29	0	0	29	0	0
23	15851506	.	C	G	16	11	27	0	0	27	0	0
23	15854004	.	T	C	17	24	41	0	0	41	0	0
23	15854102	.	A	C	10	5	15	0	0	15	0	0
23	15861092	.	C	T	0	9	9	0	9	18	0	0
23	15861536	.	T	C	6	5	11	0	0	11	0	0
23	15872605	.	T	A	3	0	3	0	0	3	0	0
23	15900255	.	C	T	8	6	14	0	0	14	0	0
23	15900330	.	G	A	20	11	31	0	0	31	0	0
23	15900387	.	G	A	10	14	24	0	0	24	0	0
23	15916232	.	A	T	10	12	22	0	0	22	0	0
23	16640860	.	A	G	5	23	28	0	0	28	0	0
23	16640925	.	A	G	8	15	23	0	2	25	0	0
23	16648643	.	A	G	3	3	6	0	0	6	0	0
23	16648656	.	A	G	2	3	5	0	1	6	0	0
23	16660094	.	G	T	3	1	4	0	0	4	0	0
23	16748903	.	A	T	2	11	13	0	0	13	0	0
23	16748915	.	T	A	3	10	13	0	0	13	0	0
23	16753735	.	T	C	2	2	4	0	0	4	0	0
23	16757414	.	T	G	0	0	0	0	1	1	0	0
23	16761407	.	A	G	0	4	4	0	0	4	0	0
23	16769220	.	C	A	1	8	9	0	0	9	0	0
23	16769255	.	T	C	1	7	8	0	0	8	0	0
23	16769385	.	T	A	1	5	6	0	0	6	0	0
23	16769700	.	A	G	1	6	7	0	0	7	0	0
23	16769862	.	A	T	2	4	6	1	0	7	0	0
23	16769949	.	T	C	1	8	9	0	0	9	0	0
23	16769991	.	T	G	3	0	3	0	9	12	0	0
23	16770008	.	G	A	0	4	4	0	3	7	0	0
23	16770121	.	G	A	0	3	3	0	2	5	0	0
23	16807443	.	C	G	1	2	3	0	1	4	0	0
23	16810343	.	A	G	0	2	2	0	0	2	0	0
23	16831106	.	A	T	2	5	7	0	0	7	0	0
23	16831207	.	A	T	1	2	3	0	0	3	0	0
23	16831386	.	G	A	3	6	9	0	0	9	0	0
23	16831507	.	A	T	0	2	2	0	1	3	0	0
23	16831822	.	G	A	0	3	3	0	2	5	0	0
23	16831976	.	G	T	0	1	1	0	0	1	0	0
23	16883876	.	G	A	0	5	5	0	2	7	0	0
23	16964140	.	G	A	5	2	7	0	0	7	0	0
23	16964518	.	T	G	1	3	4	0	0	4	0	0
23	16978400	.	T	C	1	1	2	0	0	2	0	0
23	16978403	.	C	G	1	0	1	0	0	1	0	0
23	17113923	.	T	C	3	2	5	0	1	6	0	0
23	17113938	.	A	G	3	2	5	0	0	5	0	0
23	17339044	.	C	T	7	3	10	0	0	10	0	0
23	17339959	.	G	A	0	2	2	0	1	3	0	0
23	17340346	.	G	A	0	2	2	0	4	6	0	0
23	17342788	.	T	C	3	2	5	0	0	5	0	0
23	17346121	.	T	C	3	3	6	0	1	7	0	0
23	17355498	.	G	T	2	3	5	0	0	5	0	0
23	17812711	.	C	T	24	24	48	0	2	50	0	0
23	17812720	.	T	A	21	26	47	0	2	49	0	0
23	17812755	.	G	T	18	23	41	0	1	42	0	0
23	17813057	.	G	A	19	12	31	0	0	31	0	0
23	17813161	.	T	A	6	1	7	7	1	15	0	0
23	17813717	.	G	A	19	29	48	0	2	50	0	0
23	17813924	.	A	G	6	2	8	0	0	8	0	0
23	17813952	.	G	T	8	8	16	0	0	16	0	0
23	17814223	.	C	T	16	22	38	0	11	49	0	0
23	17814281	.	G	T	24	21	45	0	2	47	0	0
23	17814299	.	A	C	23	18	41	0	1	42	0	0
23	17814408	.	A	C	11	15	26	0	0	26	0	0
23	17849275	.	T	G	9	10	19	0	1	20	0	0
23	17849296	.	C	G	0	12	12	0	13	25	0	0
23	17849627	.	C	T	4	6	10	0	1	11	0	0
23	17849699	.	C	G	1	1	2	0	0	2	0	0
23	17851768	.	C	T	0	10	10	0	7	17	0	0
23	17853145	.	T	G	3	2	5	0	0	5	0	0
23	17853396	.	A	T	1	1	2	0	0	2	0	0
23	17855427	.	C	A	5	5	10	0	0	10	0	0
23	17870758	.	G	T	0	3	3	0	4	7	0	0
23	17871775	.	A	G	0	1	1	0	1	2	0	0
23	17871787	.	A	T	0	2	2	0	0	2	0	0
23	17872443	.	G	A	6	2	8	0	1	9	0	0
23	17873750	.	C	A	29	18	47	0	3	51	1	0
23	17879066	.	C	A	6	3	9	0	2	11	0	0
23	17879107	.	C	T	1	7	8	0	0	8	0	0
23	17879152	.	A	T	2	6	8	0	0	8	0	0
23	17879153	.	A	C	6	2	8	0	0	8	0	0
23	17879299	.	G	A	10	2	12	0	1	13	0	0
23	17880800	.	C	T	5	5	10	0	0	10	0	0
23	17903519	.	G	A	0	1	1	0	1	2	0	0
23	17903574	.	C	T	3	6	9	0	0	9	0	0
23	17994101	.	T	A	3	2	5	0	1	6	0	0
23	17994274	.	C	G	3	3	6	0	1	7	0	0
23	17994354	.	T	C	2	5	7	0	0	7	0	0
23	17994359	.	C	T	4	2	6	0	0	6	0	0
23	17994615	.	T	C	4	2	6	0	0	6	0	0
23	17995469	.	G	T	11	4	15	0	0	15	0	0
23	17996051	.	A	T	1	3	4	0	0	4	0	0
23	17997033	.	A	G	2	1	3	0	0	3	0	0
23	17997043	.	T	C	2	0	2	0	1	3	0	0
23	18001836	.	A	C	1	0	1	0	0	1	0	0
23	18004297	.	A	G	1	3	4	0	0	4	0	0
23	18032772	.	G	A	2	2	4	0	0	4	0	0
23	18032912	.	A	C	4	8	12	0	0	12	0	0
23	18032924	.	T	A	7	3	10	0	0	10	0	0
23	18118653	.	A	T	3	4	7	0	1	8	0	0
23	18118922	.	G	A	23	18	41	0	1	42	0	0
23	18119166	.	C	T	18	20	38	0	0	38	0	0
23	18119192	.	T	C	13	0	13	0	19	32	0	0
23	18119399	.	A	G	15	15	30	0	0	30	0	0
23	18286781	.	G	A	5	7	12	0	1	13	0	0
23	18286782	.	C	T	4	8	12	0	1	13	0	0
23	18372124	.	A	T	1	2	3	0	0	3	0	0
23	18372135	.	C	T	1	3	4	0	0	4	0	0
23	18375847	.	G	A	2	0	2	0	0	2	0	0
23	18375853	.	T	C	0	1	1	0	5	6	0	0
23	18387709	.	T	A	18	27	45	0	3	48	0	0
23	18388004	.	G	A	18	11	29	0	0	29	0	0
23	18388166	.	T	A	8	11	19	0	1	21	1	0
23	18388476	.	G	A	6	9	15	0	0	15	0	0
23	18388555	.	A	G	9	15	24	0	0	24	0	0
23	18388620	.	A	C	9	10	19	0	3	22	0	0
23	18388685	.	G	A	9	13	22	0	1	23	0	0
23	18388764	.	G	A	3	11	14	0	0	14	0	0
23	18388858	.	T	G	6	4	10	0	0	10	0	0
23	18388954	.	G	A	8	8	16	0	1	17	0	0
23	18389594	.	G	T	20	12	32	0	0	32	0	0
23	18390402	.	G	A	12	10	22	0	1	23	0	0
23	18390635	.	G	A	10	13	23	0	1	24	0	0
23	18390758	.	T	C	8	0	8	0	11	19	0	0
23	18390780	.	C	T	15	10	25	0	0	25	0	0
23	18394401	.	T	G	12	13	25	0	0	25	0	0
23	18405812	.	C	T	4	7	11	0	0	11	0	0
23	18406479	.	G	A	8	8	16	0	0	16	0	0
23	18406573	.	C	A	9	7	16	0	0	16	0	0
23	18409242	.	C	T	11	5	16	0	0	16	0	0
23	18415329	.	G	C	7	8	15	0	0	15	0	0
23	18415427	.	T	A	3	3	6	0	0	6	0	0
23	18415493	.	C	A	0	3	3	0	3	6	0	0
23	18537414	.	A	G	2	2	4	0	0	4	0	0
23	18561051	.	T	C	10	6	16	0	1	17	0	0
23	18561289	.	T	A	18	13	31	0	1	32	0	0
23	18561434	.	C	T	0	11	11	0	18	29	0	0
23	18562299	.	A	T	3	2	5	0	0	5	0	0
23	18562358	.	T	G	3	2	5	0	0	5	0	0
23	18562427	.	C	T	5	7	12	0	2	14	0	0
23	18562522	.	A	C	1	2	3	0	0	3	0	0
23	18562623	.	C	T	11	8	19	0	0	19	0	0
23	18562911	.	C	A	2	8	10	0	13	23	0	0
23	18563951	.	G	T	9	8	17	0	0	17	0	0
23	18563952	.	T	C	9	1	10	0	7	17	0	0
23	18568144	.	G	A	3	2	5	0	0	5	0	0
23	18568206	.	G	A	5	7	12	0	0	12	0	0
23	18568520	.	G	A	1	5	6	0	0	6	0	0
23	18569380	.	T	A	4	8	12	0	0	12	0	0
23	18569399	.	C	A	1	6	7	0	6	13	0	0
23	18569455	.	T	G	5	7	12	0	1	13	0	0
23	18569462	.	T	A	5	7	12	0	0	12	0	0
23	18569543	.	T	C	21	15	36	0	1	37	0	0
23	18569625	.	A	G	22	11	33	0	5	38	0	0
23	18572547	.	T	A	11	4	15	0	0	15	0	0
23	18572605	.	T	A	7	8	15	0	2	17	0	0
23	18572618	.	G	A	4	4	8	0	2	10	0	0
23	18574353	.	G	A	14	9	23	0	0	23	0	0
23	18574720	.	T	C	14	20	34	0	1	35	0	0
23	18574800	.	C	T	0	10	10	0	12	22	0	0
23	18580933	.	C	A	3	2	5	0	0	5	0	0
23	18580939	.	C	A	0	4	4	0	2	6	0	0
23	18581065	.	A	G	0	3	3	0	2	5	0	0
23	18581835	.	G	A	6	4	10	0	0	10	0	0
23	18581933	.	T	G	10	7	17	0	0	17	0	0
23	18584225	.	G	A	14	11	25	0	3	28	0	0
23	18588969	.	C	T	8	10	18	0	1	19	0	0
23	18597667	.	G	A	12	12	24	0	0	24	0	0
23	18616304	.	C	A	1	2	3	0	0	3	0	0
23	18616310	.	A	T	2	2	4	0	2	6	0	0
23	18616517	.	A	T	9	3	12	0	0	12	0	0
23	18616880	.	T	A	8	13	21	0	1	22	0	0
23	18616980	.	C	G	5	9	14	0	0	14	0	0
23	18617300	.	G	A	9	9	18	0	2	20	0	0
23	18619766	.	C	T	0	2	2	0	0	2	0	0
23	18622541	.	T	G	10	11	21	0	0	21	0	0
23	18628460	.	T	G	1	0	1	0	0	1	0	0
23	18628746	.	C	T	8	8	16	0	0	16	0	0
23	18629024	.	T	C	5	1	6	0	0	6	0	0
23	18651789	.	G	A	4	3	7	0	0	7	0	0
23	18651918	.	C	A	2	3	5	0	0	5	0	0
23	18652067	.	T	C	8	4	12	0	0	12	0	0
23	18668440	.	T	C	5	6	11	0	0	11	0	0
23	18707455	.	T	C	1	4	5	0	0	5	0	0
23	18759802	.	C	A	6	4	10	0	0	10	0	0
23	18759827	.	T	C	5	9	14	0	0	14	0	0
23	18760004	.	G	C	5	1	6	0	3	9	0	0
23	18760049	.	T	A	3	7	10	0	0	10	0	0
23	18760223	.	T	A	4	4	8	0	0	8	0	0
23	18760256	.	C	T	2	3	5	0	0	5	0	0
23	18760519	.	T	A	2	2	4	0	1	5	0	0
23	18764770	.	A	C	1	1	2	0	0	2	0	0
23	18767148	.	T	C	1	0	1	0	1	2	0	0
23	18769161	.	T	C	2	0	2	0	1	3	0	0
23	18774122	.	T	C	2	6	8	0	0	8	0	0
23	18777816	.	C	T	3	0	3	0	0	3	0	0
23	18795055	.	T	C	4	5	9	0	1	10	0	0
23	18795620	.	A	G	17	17	34	0	1	35	0	0
23	18795721	.	C	T	7	5	12	0	1	13	0	0
23	18801275	.	G	A	7	5	12	0	2	14	0	0
23	18869550	.	C	A	0	3	3	0	1	4	0	0
23	18870235	.	A	T	5	11	16	0	1	17	0	0
23	18870245	.	T	C	11	0	11	0	7	18	0	0
23	18870716	.	G	T	8	2	10	0	0	10	0	0
23	18944543	.	G	A	0	7	7	0	5	12	0	0
23	18947344	.	C	A	16	17	33	0	1	34	0	0
23	18947385	.	G	C	10	15	25	0	0	25	0	0
23	18950968	.	T	C	10	14	24	0	0	24	0	0
23	18950970	.	T	A	9	14	23	0	1	24	0	0
23	18951010	.	G	A	6	14	20	0	0	20	0	0
23	18951103	.	T	C	1	2	3	0	0	3	0	0
23	18954023	.	A	G	3	10	13	0	0	13	0	0
23	18954100	.	A	G	8	9	17	0	0	17	0	0
23	18954151	.	G	A	10	11	21	0	0	21	0	0
23	18954542	.	G	C	2	4	6	0	0	6	0	0
23	18954759	.	T	G	14	15	29	0	0	29	0	0
23	18979342	.	C	T	14	15	29	0	2	31	0	0
23	18979561	.	G	A	9	18	27	0	1	28	0	0
23	18979756	.	T	C	14	7	21	0	1	22	0	0
23	18982375	.	G	A	11	11	22	0	0	22	0	0
23	18986338	.	G	A	10	7	17	0	2	19	0	0
23	18986344	.	G	A	8	13	21	0	2	23	0	0
23	18990914	.	C	T	1	5	6	0	9	15	0	0
23	18993525	.	T	C	13	6	19	0	0	19	0	0
23	18993827	.	C	T	0	2	2	0	6	8	0	0
23	18996030	.	C	T	1	4	5	0	0	5	0	0
23	19003263	.	A	G	3	5	8	0	0	8	0	0
23	19005426	.	G	T	2	0	2	0	0	2	0	0
23	19005486	.	T	C	2	9	11	0	0	11	0	0
23	19005758	.	C	T	1	0	1	0	0	1	0	0
23	19007389	.	G	T	6	4	10	0	1	11	0	0
23	19017421	.	C	A	3	0	3	0	0	3	0	0
23	19017466	.	G	T	1	4	5	0	0	5	0	0
23	19022254	.	A	G	2	1	3	0	0	3	0	0
23	19022534	.	G	A	7	5	12	0	0	12	0	0
23	19035542	.	A	G	2	4	6	0	0	6	0	0
23	19036052	.	C	G	3	8	11	0	0	11	0	0
23	19042706	.	A	T	1	1	2	0	1	3	0	0
23	19051737	.	C	T	5	2	7	0	1	8	0	0
23	19051739	.	G	A	5	3	8	0	0	8	0	0
23	19051831	.	C	T	3	2	5	0	1	6	0	0
23	19098900	.	G	A	1	0	1	0	0	1	0	0
23	19118372	.	G	T	5	4	9	0	0	9	0	0
23	19118960	.	G	T	4	3	7	0	0	7	0	0
23	19198348	.	A	T	5	9	14	0	0	14	0	0
23	19198588	.	A	T	3	3	6	0	0	6	0	0
23	19200168	.	G	A	8	5	13	0	0	13	0	0
23	19201103	.	C	A	11	12	23	0	0	23	0	0
23	19201148	.	G	T	4	5	9	0	1	10	0	0
23	19202799	.	A	T	2	4	6	0	0	6	0	0
23	19202800	.	A	T	2	4	6	0	0	6	0	0
23	19202958	.	A	G	1	0	1	0	0	1	0	0
23	19204597	.	G	A	1	2	3	0	0	3	0	0
23	19205844	.	A	C	1	2	3	0	0	3	0	0
23	19206052	.	C	T	0	2	2	0	1	3	0	0
23	19220478	.	C	A	0	3	3	0	0	3	0	0
23	19222218	.	C	A	2	4	6	0	1	7	0	0
23	19222257	.	G	A	2	5	7	0	0	7	0	0
23	19250476	.	G	T	1	3	4	0	0	4	0	0
23	19474823	.	G	T	16	10	26	0	1	27	0	0
23	19483010	.	C	T	0	1	1	0	2	3	0	0
23	19575044	.	G	A	1	9	10	0	15	25	0	0
23	19575134	.	C	T	11	14	25	0	1	26	0	0
23	19577464	.	G	A	1	16	17	0	17	34	0	0
23	19582481	.	T	C	19	17	36	0	1	37	0	0
23	19582559	.	G	T	9	12	21	0	0	21	0	0
23	19582668	.	T	C	8	18	26	0	1	27	0	0
23	19582678	.	C	T	10	19	29	0	1	30	0	0
23	19583208	.	G	A	0	11	11	0	8	19	0	0
23	19583252	.	C	T	10	14	24	0	1	25	0	0
23	19603630	.	T	C	11	12	23	0	0	23	0	0
23	19603753	.	T	C	29	27	56	0	2	58	0	0
23	19603803	.	T	C	21	28	49	0	1	50	0	0
23	19603880	.	A	T	25	15	40	0	5	45	0	0
23	19603994	.	G	A	26	20	46	0	1	47	0	0
23	19604263	.	A	G	13	0	13	0	22	35	0	0
23	19604351	.	G	T	15	12	27	0	1	28	0	0
23	19606526	.	A	C	2	2	4	0	0	4	0	0
23	19630610	.	G	A	1	0	1	0	0	1	0	0
23	19670139	.	G	C	5	4	9	0	0	9	0	0
23	19670185	.	A	T	3	6	9	0	0	9	0	0
23	19672720	.	T	C	3	9	12	0	0	12	0	0
23	19673170	.	C	T	13	15	28	0	0	28	0	0
23	19673376	.	C	T	11	9	20	0	0	20	0	0
23	19712898	.	G	A	21	21	42	0	1	43	0	0
23	19713291	.	A	G	10	18	28	0	0	28	0	0
23	19713324	.	A	G	25	24	49	0	2	51	0	0
23	19788102	.	T	C	3	3	6	0	1	7	0	0
23	19788136	.	T	C	2	3	5	0	0	5	0	0
23	19788562	.	A	T	0	2	2	0	0	2	0	0
23	19790452	.	G	A	0	2	2	0	3	5	0	0
23	19792704	.	G	A	2	2	4	0	0	4	0	0
23	19796643	.	A	T	2	0	2	0	0	2	0	0
23	19796651	.	G	A	1	0	1	0	0	1	0	0
23	19798174	.	A	G	0	1	1	0	0	1	0	0
23	19798216	.	T	C	1	2	3	0	0	3	0	0
23	19804543	.	C	A	0	2	2	0	0	2	0	0
23	19804878	.	T	C	0	1	1	0	0	1	0	0
23	19805577	.	A	T	3	3	6	0	0	6	0	0
23	19808022	.	C	T	5	5	10	0	1	11	0	0
23	19808078	.	T	C	10	5	15	0	0	15	0	0
23	19808691	.	G	A	1	11	12	0	8	20	0	0
23	19815467	.	G	A	1	1	2	0	0	2	0	0
23	19821136	.	A	G	3	0	3	0	7	10	0	0
23	19821150	.	C	T	3	11	14	0	0	14	0	0
23	19821277	.	A	C	10	12	22	0	0	22	0	0
23	19821408	.	C	T	4	6	10	0	1	11	0	0
23	19821447	.	G	C	3	5	8	0	0	8	0	0
23	19821470	.	G	A	0	3	3	0	3	6	0	0
23	19821489	.	A	T	3	3	6	0	0	6	0	0
23	19821549	.	C	A	1	4	5	0	0	5	0	0
23	19822100	.	G	T	2	6	8	0	0	8	0	0
23	19825653	.	G	C	1	2	3	0	0	3	0	0
23	19825909	.	C	T	0	2	2	0	0	2	0	0
23	19827641	.	A	C	0	0	0	0	1	1	0	0
23	19835308	.	T	C	35	15	50	0	5	55	0	0
23	19836260	.	C	T	26	28	54	0	1	55	0	0
23	19837080	.	T	C	24	25	49	0	2	51	0	0
23	19837503	.	G	A	23	27	50	0	3	53	0	0
23	19837939	.	A	G	16	8	24	0	2	26	0	0
23	19837974	.	G	A	17	11	28	0	2	30	0	0
23	19838100	.	C	A	26	21	47	0	0	47	0	0
23	19838295	.	T	G	11	5	16	0	1	17	0	0
23	19838312	.	A	T	11	4	15	0	1	16	0	0
23	19838387	.	A	T	9	12	21	0	0	21	0	0
23	19838388	.	T	A	8	12	20	0	1	21	0	0
23	19838458	.	A	T	14	10	24	0	0	24	0	0
23	19838459	.	A	C	14	9	23	0	1	24	0	0
23	19869132	.	G	A	8	16	24	0	4	28	0	0
23	19871615	.	A	G	21	28	49	0	3	52	0	0
23	19879576	.	C	T	0	6	6	0	6	12	0	0
23	19883318	.	T	C	1	3	4	0	0	4	0	0
23	19893409	.	A	T	18	11	29	0	0	29	0	0
23	19933542	.	A	G	15	15	30	0	0	30	0	0
23	19933578	.	G	A	11	12	23	0	0	23	0	0
23	19933742	.	G	A	13	13	26	0	2	28	0	0
23	19933850	.	A	G	18	10	28	0	0	28	0	0
23	19933896	.	A	G	16	12	28	0	0	28	0	0
23	19933952	.	A	G	17	9	26	0	1	27	0	0
23	19952743	.	C	T	1	15	16	0	17	33	0	0
23	19952869	.	T	A	15	7	22	0	0	22	0	0
23	19969420	.	A	T	2	1	3	0	1	4	0	0
23	19969552	.	A	T	1	3	4	0	0	4	0	0
23	19969557	.	T	A	2	5	7	0	0	7	0	0
23	19969710	.	G	A	2	3	5	0	1	6	0	0
23	19974092	.	G	A	2	4	6	0	0	6	0	0
23	19981510	.	G	T	3	4	7	0	1	8	0	0
23	19981554	.	T	C	4	2	6	0	1	7	0	0
23	19981608	.	A	T	4	6	10	0	0	10	0	0
23	19985054	.	A	G	7	3	10	0	1	11	0	0
23	19985201	.	A	G	4	2	6	0	1	7	0	0
23	19985210	.	G	T	3	3	6	0	1	7	0	0
23	19985403	.	T	C	4	2	6	0	0	6	0	0
23	20000716	.	A	G	3	5	8	0	4	12	0	0
23	20002339	.	G	C	4	5	9	0	0	9	0	0
23	20002373	.	T	A	3	4	7	0	1	8	0	0
23	20002439	.	G	C	2	0	2	0	6	8	0	0
23	20010287	.	T	A	0	1	1	0	0	1	0	0
23	20010481	.	A	C	2	0	2	0	4	6	0	0
23	20014285	.	A	T	4	5	9	0	0	9	0	0
23	20014390	.	C	T	0	1	1	0	2	3	0	0
23	20014407	.	A	T	4	3	7	0	0	7	0	0
23	20014474	.	T	A	6	3	9	0	0	9	0	0
23	20014486	.	C	T	0	3	3	0	5	8	0	0
23	20014802	.	T	A	4	3	7	0	0	7	0	0
23	20014811	.	C	T	0	3	3	0	4	7	0	0
23	20014995	.	T	G	1	2	3	0	0	3	0	0
23	20014996	.	C	T	1	2	3	0	0	3	0	0
23	20022144	.	A	G	1	2	3	0	0	3	0	0
23	20022199	.	G	A	0	2	2	0	0	2	0	0
23	20113599	.	T	C	11	14	25	0	1	26	0	0
23	20113848	.	G	T	23	17	40	0	1	41	0	0
23	20114327	.	C	A	2	6	8	0	0	8	0	0
23	20117625	.	C	G	0	14	14	0	21	35	0	0
23	20117830	.	A	G	2	2	4	0	0	4	0	0
23	20117938	.	A	C	7	0	7	0	9	16	0	0
23	20118597	.	T	G	4	1	5	0	0	5	0	0
23	20118730	.	T	A	8	3	11	0	0	11	0	0
23	20120646	.	T	C	13	0	13	0	7	20	0	0
23	20121265	.	T	A	1	3	4	0	0	4	0	0
23	20121270	.	G	T	1	5	6	0	0	6	0	0
23	20121326	.	G	A	22	13	35	0	2	37	0	0
23	20122190	.	A	G	7	5	12	0	0	12	0	0
23	20123375	.	G	A	6	9	15	0	0	15	0	0
23	20123386	.	G	T	6	9	15	0	0	15	0	0
23	20123575	.	C	A	10	5	15	0	1	16	0	0
23	20123576	.	C	T	11	5	16	0	0	16	0	0
23	20123629	.	A	G	6	1	7	0	0	7	0	0
23	20138134	.	T	C	0	2	2	0	0	2	0	0
23	20139248	.	T	C	2	3	5	0	0	5	0	0
23	20141865	.	G	C	2	0	2	0	2	4	0	0
23	20141925	.	C	T	1	5	6	0	1	7	0	0
23	20142886	.	G	A	3	3	6	0	0	6	0	0
23	20142968	.	C	A	0	3	3	0	1	4	0	0
23	20143037	.	T	G	1	3	4	0	0	4	0	0
23	20143177	.	G	A	2	4	6	0	0	6	0	0
23	20145420	.	T	A	10	15	25	0	2	27	0	0
23	20145823	.	T	C	7	8	15	0	1	16	0	0
23	20146080	.	A	G	10	10	20	0	0	20	0	0
23	20152477	.	T	C	3	5	8	0	0	8	0	0
23	20152640	.	G	A	6	6	12	0	0	12	0	0
23	20154486	.	A	G	5	4	9	0	0	9	0	0
23	20157790	.	G	A	1	7	8	0	0	8	0	0
23	20157923	.	G	C	3	0	3	0	7	10	0	0
23	20157930	.	T	C	3	0	3	0	8	11	0	0
23	20159225	.	C	T	0	4	4	0	3	7	0	0
23	20159234	.	G	T	2	4	6	0	0	6	0	0
23	20162522	.	C	T	0	4	4	0	1	5	0	0
23	20167944	.	T	C	5	7	12	0	0	12	0	0
23	20167966	.	G	A	5	11	16	0	0	16	0	0
23	20168111	.	T	A	6	8	14	0	0	14	0	0
23	20168127	.	C	T	0	6	6	0	4	10	0	0
23	20168404	.	C	G	7	5	12	0	0	12	0	0
23	20168568	.	T	C	5	4	9	0	0	9	0	0
23	20168573	.	A	G	5	5	10	0	0	10	0	0
23	20168642	.	G	A	4	9	13	0	0	13	0	0
23	20168739	.	T	C	0	1	1	0	0	1	0	0
23	20170945	.	T	A	3	3	6	0	0	6	0	0
23	20183551	.	A	G	1	1	2	0	0	2	0	0
23	20192748	.	T	C	1	2	3	0	1	4	0	0
23	20262814	.	A	C	1	2	3	0	0	3	0	0
23	20902390	.	T	A	7	7	14	0	1	15	0	0
23	20931095	.	C	A	8	9	17	0	5	22	0	0
23	20931119	.	C	T	8	7	15	0	1	16	0	0
23	20936226	.	G	A	0	4	4	0	9	13	0	0
23	20936395	.	T	A	12	6	18	0	0	18	0	0
23	20936467	.	T	C	5	7	12	0	0	12	0	0
23	21067456	.	A	T	2	2	4	0	0	4	0	0
23	21067478	.	A	T	1	2	3	0	0	3	0	0
23	21089840	.	C	A	3	2	5	0	0	5	0	0
23	21106219	.	A	T	2	2	4	0	0	4	0	0
23	21108312	.	T	C	1	1	2	0	0	2	0	0
23	21111170	.	A	G	5	0	5	0	10	15	0	0
23	21113750	.	T	C	1	2	3	0	0	3	0	0
23	21113770	.	C	T	1	2	3	0	0	3	0	0
23	21114732	.	A	C	4	3	7	0	3	10	0	0
23	21264226	.	A	G	0	1	1	0	1	2	0	0
23	21265351	.	T	C	0	2	2	0	0	2	0	0
23	21265446	.	C	T	7	4	11	0	0	11	0	0
23	21266896	.	C	T	2	1	3	0	0	3	0	0
23	21267105	.	G	C	0	2	2	0	1	3	0	0
23	21268808	.	T	C	2	4	6	0	0	6	0	0
23	21269494	.	A	G	1	5	6	0	2	8	0	0
23	21269620	.	A	G	1	4	5	0	1	6	0	0
23	21269626	.	T	G	2	2	4	0	1	5	0	0
23	21269792	.	T	G	6	7	13	0	0	13	0	0
23	21272845	.	G	T	0	0	0	0	1	1	0	0
23	21276362	.	T	C	8	8	16	0	0	16	0	0
23	21277208	.	G	A	3	5	8	0	0	8	0	0
23	21277247	.	T	A	5	7	12	0	0	12	0	0
23	21306051	.	A	T	2	4	6	0	0	6	0	0
23	21306061	.	G	T	0	3	3	0	2	5	0	0
23	21314054	.	G	A	0	3	3	0	2	5	0	0
23	21314094	.	C	T	3	2	5	0	0	5	0	0
23	21315209	.	A	T	0	1	1	0	0	1	0	0
23	21316361	.	C	T	2	2	4	0	1	5	0	0
23	21326441	.	A	G	1	3	4	0	0	4	0	0
23	21328482	.	C	T	3	2	5	0	0	5	0	0
23	21329165	.	C	A	1	3	4	0	0	4	0	0
23	21330786	.	T	C	1	0	1	0	0	1	0	0
23	21330864	.	T	C	3	4	7	0	0	7	0	0
23	21331172	.	C	A	1	2	3	0	0	3	0	0
23	21338789	.	A	G	3	1	4	0	1	5	0	0
23	21338834	.	C	T	4	3	7	0	0	7	0	0
23	21338846	.	G	A	4	1	5	0	1	6	0	0
23	21338888	.	C	T	3	2	5	0	0	5	0	0
23	21339130	.	G	C	0	2	2	0	0	2	0	0
23	21339136	.	C	T	0	2	2	0	0	2	0	0
23	21341304	.	G	A	3	3	6	0	0	6	0	0
23	21343661	.	A	G	3	2	5	0	0	5	0	0
23	21343718	.	T	C	2	3	5	0	0	5	0	0
23	21343903	.	T	C	3	1	4	0	0	4	0	0
23	21350008	.	T	C	0	3	3	0	0	3	0	0
23	21352523	.	G	A	3	6	9	0	1	10	0	0
23	21353837	.	C	T	6	3	9	0	0	9	0	0
23	21356056	.	C	T	5	6	11	0	0	11	0	0
23	21361347	.	T	C	2	2	4	0	1	5	0	0
23	21361570	.	G	A	2	2	4	0	0	4	0	0
23	21362178	.	G	A	0	4	4	0	2	6	0	0
23	21362217	.	G	T	3	7	10	0	1	11	0	0
23	21362735	.	G	A	6	1	7	0	1	8	0	0
23	21362822	.	C	T	2	7	9	0	1	10	0	0
23	21363039	.	C	A	5	4	9	0	1	10	0	0
23	21364431	.	G	A	4	7	11	0	0	11	0	0
23	21364449	.	G	A	0	8	8	0	10	18	0	0
23	21364725	.	C	T	2	1	3	0	0	3	0	0
23	21366588	.	C	T	3	1	4	0	0	4	0	0
23	21366743	.	A	C	6	2	8	0	1	9	0	0
23	21366764	.	C	T	2	1	3	0	0	3	0	0
23	21367861	.	A	G	4	6	10	0	0	10	0	0
23	21367994	.	A	T	3	0	3	0	0	3	0	0
23	21368078	.	C	T	12	15	27	0	3	30	0	0
23	21368090	.	G	A	10	16	26	0	3	29	0	0
23	21368156	.	A	G	3	10	13	0	2	15	0	0
23	21368183	.	G	A	2	4	6	0	1	7	0	0
23	21369126	.	G	C	1	3	4	0	2	6	0	0
23	21369678	.	T	C	11	22	33	0	0	33	0	0
23	21369703	.	C	A	6	21	27	0	0	27	0	0
23	21369750	.	C	T	2	6	8	0	0	8	0	0
23	21376413	.	T	A	18	15	33	0	3	36	0	0
23	21376570	.	C	T	25	12	37	0	0	37	0	0
23	21376617	.	A	G	18	0	18	0	8	26	0	0
23	21376678	.	G	T	12	12	24	0	0	24	0	0
23	21376689	.	C	T	11	9	20	0	2	22	0	0
23	21376787	.	C	G	12	13	25	0	0	25	0	0
23	21380288	.	C	T	2	3	5	0	0	5	0	0
23	21380370	.	C	A	1	2	3	0	0	3	0	0
23	21455210	.	C	T	6	3	9	0	0	9	0	0
23	21455212	.	T	A	6	3	9	0	0	9	0	0
23	21483656	.	C	T	7	2	9	0	0	9	0	0
23	21483803	.	G	A	7	4	11	0	1	12	0	0
23	21488054	.	T	C	7	5	12	0	1	13	0	0
23	21488438	.	C	A	1	3	4	0	0	4	0	0
23	21488726	.	T	C	1	2	3	0	0	3	0	0
23	21488872	.	G	A	4	5	9	0	1	10	0	0
23	21489121	.	C	T	8	8	16	0	1	17	0	0
23	21489233	.	T	C	6	8	14	0	0	14	0	0
23	21489567	.	T	C	7	2	9	0	0	9	0	0
23	21489929	.	A	G	3	3	6	0	0	6	0	0
23	21490321	.	A	G	2	2	4	0	0	4	0	0
23	21490343	.	T	C	2	2	4	0	0	4	0	0
23	21492314	.	A	T	5	4	9	0	0	9	0	0
23	21492756	.	A	T	2	0	2	0	0	2	0	0
23	21492777	.	C	T	0	2	2	0	0	2	0	0
23	21497808	.	C	T	7	2	9	0	0	9	0	0
23	21498165	.	T	C	5	2	7	0	0	7	0	0
23	21498240	.	A	G	2	0	2	0	2	4	0	0
23	21498326	.	C	T	6	4	10	0	0	10	0	0
23	21498383	.	A	T	3	4	7	0	0	7	0	0
23	21498449	.	T	C	6	6	12	0	0	12	0	0
23	21498478	.	T	C	8	5	13	0	0	13	0	0
23	21533380	.	A	T	1	1	2	0	0	2	0	0
23	21569490	.	G	A	0	1	1	0	1	2	0	0
23	21575986	.	C	T	4	5	9	0	0	9	0	0
23	21618055	.	C	T	4	1	5	0	0	5	0	0
23	21626211	.	C	T	3	11	14	0	0	14	0	0
23	21630363	.	T	G	2	11	13	0	0	13	0	0
23	21630393	.	G	A	0	8	8	0	1	9	0	0
23	21630676	.	G	A	11	8	19	0	0	19	0	0
23	21630973	.	C	T	10	7	17	0	0	17	0	0
23	21638300	.	C	T	7	7	14	0	0	14	0	0
23	21647187	.	C	T	3	5	8	0	0	8	0	0
23	21647196	.	G	A	0	3	3	0	5	8	0	0
23	21661227	.	C	T	8	12	20	0	0	20	0	0
23	21674163	.	G	T	1	4	5	0	0	5	0	0
23	21674167	.	G	T	1	4	5	0	0	5	0	0
23	21721568	.	T	C	4	4	8	0	1	9	0	0
23	21721667	.	C	T	5	1	6	0	0	6	0	0
23	21721868	.	G	A	3	4	7	0	0	7	0	0
23	21735034	.	G	A	0	3	3	0	1	4	0	0
23	21741133	.	C	T	0	3	3	0	1	4	0	0
23	21744521	.	T	A	3	3	6	0	0	6	0	0
23	21744522	.	C	T	3	3	6	0	0	6	0	0
23	21796976	.	G	A	1	2	3	0	0	3	0	0
23	21797387	.	G	A	5	7	12	0	0	12	0	0
23	21803494	.	T	G	2	2	4	0	0	4	0	0
23	21803925	.	T	A	4	4	8	0	0	8	0	0
23	21804805	.	T	C	1	2	3	0	0	3	0	0
23	21805579	.	T	C	3	3	6	0	0	6	0	0
23	21806130	.	C	T	2	4	6	0	0	6	0	0
23	21807113	.	T	C	4	2	6	0	0	6	0	0
23	21810048	.	A	G	2	3	5	0	0	5	0	0
23	21978739	.	C	A	2	4	6	0	0	6	0	0
23	21978923	.	T	C	4	1	5	0	0	5	0	0
23	21978933	.	C	A	0	4	4	0	0	4	0	0
23	22018738	.	G	T	4	2	6	0	0	6	0	0
23	22030235	.	T	C	4	7	11	0	0	11	0	0
23	22033653	.	C	T	0	1	1	0	0	1	0	0
23	22033661	.	G	A	0	3	3	0	0	3	0	0
23	22034473	.	G	A	0	1	1	0	4	5	0	0
23	22051041	.	G	A	1	3	4	0	0	4	0	0
23	22051380	.	C	T	3	3	6	0	1	7	0	0
23	22054542	.	C	A	2	0	2	0	0	2	0	0
23	22064493	.	A	G	4	8	12	0	0	12	0	0
23	22067865	.	G	T	1	3	4	0	0	4	0	0
23	22072641	.	T	G	2	3	5	0	0	5	0	0
23	22084512	.	T	G	3	2	5	0	0	5	0	0
23	22084627	.	A	G	1	4	5	0	0	5	0	0
23	22097192	.	C	T	0	2	2	0	0	2	0	0
23	22105755	.	G	A	3	1	4	0	0	4	0	0
23	22130744	.	T	A	1	1	2	0	0	2	0	0
23	22130755	.	C	G	1	1	2	0	0	2	0	0
23	22208920	.	A	G	0	2	2	0	1	3	0	0
23	22209186	.	C	T	3	3	6	0	0	6	0	0
23	22379008	.	T	C	5	3	8	0	0	8	0	0
23	22384741	.	C	T	2	1	3	0	0	3	0	0
23	22394219	.	G	A	5	9	14	0	1	15	0	0
23	22424506	.	T	A	1	2	3	0	0	3	0	0
23	22424524	.	C	T	4	2	6	0	1	7	0	0
23	22424562	.	A	G	5	6	11	0	0	11	0	0
23	22424574	.	G	A	0	4	4	0	5	9	0	0
23	22424764	.	C	T	4	6	10	0	0	10	0	0
23	22425126	.	G	C	6	5	11	0	1	12	0	0
23	22496525	.	C	A	4	5	9	0	1	10	0	0
23	22496589	.	A	G	11	6	17	0	1	18	0	0
23	22497049	.	A	T	6	2	8	0	0	8	0	0
23	22497550	.	A	G	2	4	6	0	0	6	0	0
23	22508141	.	A	T	2	3	5	0	0	5	0	0
23	22591304	.	C	A	4	4	8	0	0	8	0	0
23	22591327	.	T	C	2	2	4	0	0	4	0	0
23	22635036	.	T	A	4	3	7	0	0	7	0	0
23	22635284	.	G	A	7	5	12	0	2	14	0	0
23	22635466	.	T	C	10	5	15	0	0	15	0	0
23	22635490	.	C	G	4	8	12	0	0	12	0	0
23	22635720	.	T	A	2	5	7	0	0	7	0	0
23	22635732	.	C	A	0	4	4	0	4	8	0	0
23	22667247	.	C	T	30	31	61	0	6	67	0	0
23	22674704	.	C	T	2	4	6	0	1	7	0	0
23	22677394	.	A	C	8	8	16	0	0	16	0	0
23	22677496	.	C	T	31	49	80	0	5	85	0	0
23	22677638	.	C	T	31	24	55	0	7	62	0	0
23	22895465	.	G	A	1	3	4	0	0	4	0	0
23	22922775	.	A	C	11	6	17	0	4	21	0	0
23	22922795	.	G	T	6	6	12	0	0	12	0	0
23	22923021	.	A	C	14	15	29	0	1	30	0	0
23	22923033	.	C	T	16	15	31	0	1	32	0	0
23	22923198	.	C	T	7	10	17	0	1	18	0	0
23	22923339	.	C	T	15	14	29	0	0	29	0	0
23	22923537	.	C	T	12	13	25	0	3	28	0	0
23	22923603	.	T	C	9	7	16	0	1	17	0	0
23	22925490	.	C	A	1	1	2	0	0	2	0	0
23	23096495	.	A	G	1	0	1	0	0	1	0	0
23	23118653	.	A	T	5	4	9	0	0	9	0	0
23	23118815	.	C	T	2	7	9	0	0	9	0	0
23	23122381	.	C	T	3	6	9	0	0	9	0	0
23	23122955	.	G	T	1	1	2	1	0	3	0	0
23	23123146	.	G	T	2	5	7	0	0	7	0	0
23	23123715	.	C	T	3	2	5	0	1	6	0	0
23	23126589	.	A	C	2	2	4	0	0	4	0	0
23	23126621	.	T	C	4	2	6	0	0	7	1	0
23	23154388	.	T	A	1	1	2	0	0	2	0	0
23	23170963	.	T	G	5	3	8	0	0	8	0	0
23	23190151	.	T	A	5	12	17	0	0	17	0	0
23	23192478	.	G	A	7	5	12	0	1	13	0	0
23	23192514	.	A	T	0	4	4	0	0	4	0	0
23	23194228	.	C	T	6	10	16	0	2	18	0	0
23	23205469	.	A	G	12	0	12	0	19	31	0	0
23	23205511	.	T	C	6	7	13	0	0	13	0	0
23	23210288	.	A	G	10	18	28	0	1	29	0	0
23	23210303	.	A	G	16	22	38	0	2	40	0	0
23	23210339	.	C	T	19	19	38	0	0	38	0	0
23	23212257	.	C	T	7	3	10	0	0	10	0	0
23	23212567	.	C	T	16	17	33	0	0	33	0	0
23	23213219	.	T	C	21	15	36	0	3	39	0	0
23	23213437	.	G	A	0	15	15	0	14	29	0	0
23	23213582	.	C	A	18	16	34	0	2	36	0	0
23	23213613	.	T	A	16	21	37	0	0	37	0	0
23	23213657	.	G	A	23	19	42	0	1	43	0	0
23	23213757	.	G	A	23	20	43	0	2	45	0	0
23	23213800	.	G	A	0	10	10	0	17	27	0	0
23	23213917	.	T	A	11	10	21	0	2	23	0	0
23	23213939	.	T	A	12	11	23	0	2	25	0	0
23	23214070	.	C	T	12	7	19	0	2	21	0	0
23	23214531	.	G	A	3	3	6	0	0	6	0	0
23	23399987	.	T	C	5	6	11	0	0	11	0	0
23	23400332	.	G	C	7	5	12	0	1	13	0	0
23	23658600	.	A	G	2	2	4	0	1	5	0	0
23	23754415	.	C	T	5	8	13	0	1	14	0	0
23	23816509	.	A	C	4	7	11	0	0	11	0	0
23	23825441	.	A	C	1	7	8	0	1	9	0	0
23	23830985	.	C	G	0	1	1	0	0	1	0	0
23	23860113	.	T	A	2	4	6	0	0	6	0	0
23	23860117	.	G	A	2	3	5	0	0	5	0	0
23	23877088	.	A	G	10	0	10	0	5	15	0	0
23	23888136	.	G	A	0	8	8	0	7	15	0	0
23	23891551	.	G	A	1	1	2	0	4	6	0	0
23	23903278	.	G	A	0	11	11	0	5	16	0	0
23	23903432	.	C	T	5	8	13	0	0	13	0	0
23	23912720	.	G	T	12	17	29	0	1	30	0	0
23	23912723	.	C	A	13	16	29	0	0	29	0	0
23	23912900	.	C	G	8	18	26	0	0	26	0	0
23	23913240	.	G	T	9	23	32	0	0	32	0	0
23	23913818	.	A	T	18	13	31	0	2	33	0	0
23	23913858	.	A	C	17	20	37	0	2	39	0	0
23	23914017	.	G	A	1	12	13	0	20	33	0	0
23	23914101	.	T	A	18	0	18	0	2	20	0	0
23	23914176	.	A	T	17	13	30	0	3	33	0	0
23	23973724	.	T	A	4	4	8	0	1	9	0	0
23	23983662	.	A	T	5	7	12	0	1	13	0	0
23	23983677	.	C	T	3	8	11	0	1	12	0	0
23	23987646	.	A	G	1	3	4	0	0	4	0	0
23	23987652	.	G	A	0	1	1	0	0	1	0	0
23	23994537	.	T	C	1	5	6	0	0	6	0	0
23	23994595	.	C	T	4	12	16	0	0	16	0	0
23	23995111	.	G	T	4	5	9	0	0	9	0	0
23	24112973	.	C	A	3	2	5	0	0	5	0	0
23	24144860	.	A	G	1	3	4	0	0	4	0	0
23	24144872	.	T	C	1	2	3	0	0	3	0	0
23	24145904	.	A	T	3	2	5	0	0	5	0	0
23	24148183	.	T	C	1	2	3	0	0	3	0	0
23	24170870	.	G	A	12	9	21	0	0	21	0	0
23	24188087	.	C	T	0	1	1	0	2	3	0	0
23	24195469	.	C	T	10	9	19	0	1	20	0	0
23	24195611	.	T	C	5	0	5	0	5	10	0	0
23	24202602	.	C	T	1	5	6	0	0	6	0	0
23	24202658	.	G	A	6	4	10	0	0	10	0	0
23	24202858	.	C	T	6	3	9	0	0	9	0	0
23	24202985	.	T	C	4	3	7	0	0	7	0	0
23	24208176	.	G	A	5	5	10	0	0	10	0	0
23	24208208	.	G	C	4	3	7	0	0	7	0	0
23	24214381	.	G	A	5	3	8	0	0	8	0	0
23	24214414	.	C	T	4	2	6	0	0	6	0	0
23	24216127	.	C	G	0	2	2	0	0	2	0	0
23	24216192	.	G	A	3	2	5	0	0	5	0	0
23	24216339	.	A	C	4	0	4	0	0	4	0	0
23	24226487	.	C	T	2	3	5	0	0	5	0	0
23	24227352	.	A	T	3	8	11	0	0	11	0	0
23	24227380	.	A	G	4	9	13	0	0	13	0	0
23	24227458	.	T	C	5	11	16	0	1	17	0	0
23	24227673	.	C	A	17	24	41	0	1	43	1	0
23	24228767	.	G	A	13	8	21	0	1	22	0	0
23	24229110	.	G	A	10	6	16	0	1	17	0	0
23	24231222	.	A	G	6	7	13	0	1	14	0	0
23	24233458	.	A	G	10	3	13	0	0	13	0	0
23	24233831	.	A	G	3	2	5	0	1	6	0	0
23	24238659	.	C	T	0	1	1	0	3	4	0	0
23	24238676	.	A	T	2	3	5	0	0	5	0	0
23	24240979	.	G	T	8	12	20	0	1	21	0	0
23	24243168	.	G	A	1	1	2	0	0	2	0	0
23	24244694	.	C	T	0	4	4	0	1	5	0	0
23	24247719	.	A	T	4	2	6	0	0	6	0	0
23	24251628	.	C	A	0	1	1	0	0	1	0	0
23	24251829	.	T	A	4	7	11	0	1	12	0	0
23	24300958	.	T	A	1	2	3	0	0	3	0	0
23	24301288	.	G	A	1	3	4	0	0	4	0	0
23	24304648	.	T	C	0	3	3	0	0	3	0	0
23	24308568	.	G	A	0	1	1	0	0	1	0	0
23	24439480	.	G	T	12	17	29	0	0	29	0	0
23	24439780	.	G	A	16	10	26	0	2	28	0	0
23	24440397	.	C	T	3	13	16	1	3	20	0	0
23	24442787	.	T	G	1	2	3	0	0	3	0	0
23	24443161	.	G	T	8	12	20	0	4	24	0	0
23	24443576	.	A	G	10	16	26	0	2	28	0	0
23	24443609	.	C	T	1	17	18	0	7	25	0	0
23	24444291	.	A	G	16	15	31	0	2	33	0	0
23	24444344	.	C	G	12	12	24	0	0	24	0	0
23	24444543	.	C	T	0	7	7	0	8	15	0	0
23	24444803	.	T	G	7	10	17	0	2	19	0	0
23	24444861	.	G	A	15	8	23	0	2	25	0	0
23	24445112	.	G	T	11	12	23	0	0	23	0	0
23	24445338	.	A	G	13	13	26	0	0	26	0	0
23	24445584	.	A	G	12	10	22	0	1	23	0	0
23	24445876	.	A	G	11	9	20	0	0	20	0	0
23	24445906	.	G	C	11	9	20	0	1	21	0	0
23	24446411	.	C	T	10	5	15	0	0	15	0	0
23	24447113	.	C	T	7	5	12	0	0	12	0	0
23	24447297	.	C	T	5	3	8	0	0	8	0	0
23	24447794	.	G	A	8	9	17	0	0	17	0	0
23	24448071	.	T	A	6	6	12	0	0	12	0	0
23	24448146	.	T	C	4	6	10	0	0	10	0	0
23	24448273	.	G	C	4	6	10	0	1	11	0	0
23	24448621	.	G	C	5	5	10	0	0	10	0	0
23	24448630	.	G	T	5	2	7	0	1	8	0	0
23	24449429	.	G	A	4	5	9	0	1	10	0	0
23	24451083	.	A	G	3	6	9	0	0	9	0	0
23	24451512	.	T	C	6	5	11	0	1	12	0	0
23	24452496	.	C	T	2	1	3	0	0	3	0	0
23	24452508	.	G	A	2	1	3	0	0	3	0	0
23	24475726	.	T	C	2	4	6	0	0	6	0	0
23	24475749	.	G	T	4	4	8	0	0	8	0	0
23	24504389	.	A	G	6	0	6	0	3	9	0	0
23	24590709	.	G	A	0	3	3	0	1	4	0	0
23	24591466	.	A	G	2	3	5	0	0	5	0	0
23	24593017	.	G	A	1	2	3	0	0	3	0	0
23	24600513	.	C	T	3	2	5	0	0	5	0	0
23	24600947	.	T	C	5	5	10	0	0	10	0	0
23	24604042	.	C	T	8	13	21	0	0	21	0	0
23	24604323	.	C	T	0	1	1	0	0	1	0	0
23	24604461	.	A	G	2	0	2	0	4	6	0	0
23	24605243	.	T	A	4	3	7	0	0	8	1	0
23	24608805	.	G	A	4	4	8	0	0	8	0	0
23	24608847	.	G	A	1	9	10	0	14	24	0	0
23	24652929	.	G	A	0	2	2	0	1	3	0	0
23	24653058	.	C	T	3	3	6	0	0	6	0	0
23	24653164	.	T	C	5	2	7	0	0	7	0	0
23	24654287	.	G	T	3	2	5	0	0	5	0	0
23	24654391	.	A	T	3	4	7	0	0	7	0	0
23	24654528	.	G	T	4	2	6	0	0	6	0	0
23	24655227	.	T	C	3	6	9	0	0	9	0	0
23	24655478	.	C	T	3	5	8	0	0	8	0	0
23	24655761	.	T	G	3	0	3	0	8	11	0	0
23	24659777	.	C	T	2	2	4	0	0	4	0	0
23	24661851	.	C	T	10	6	16	0	0	16	0	0
23	24669381	.	C	T	1	7	8	0	9	17	0	0
23	24669633	.	T	C	12	1	13	0	11	24	0	0
23	24672365	.	C	T	7	2	9	0	0	9	0	0
23	24676192	.	G	C	8	2	10	0	0	10	0	0
23	24694242	.	C	A	17	17	34	0	0	34	0	0
23	24694756	.	C	T	0	4	4	0	0	4	0	0
23	24694763	.	T	A	1	6	7	0	0	7	0	0
23	24697036	.	G	A	16	15	31	0	1	32	0	0
23	24699281	.	T	A	18	27	45	0	1	46	0	0
23	24747961	.	G	A	1	2	3	0	0	3	0	0
23	24749514	.	A	G	2	0	2	0	3	5	0	0
23	24749528	.	A	T	1	3	4	0	0	4	0	0
23	24749673	.	C	T	1	2	3	0	1	4	0	0
23	24750010	.	C	T	2	2	4	0	0	4	0	0
23	24750141	.	T	A	1	4	5	0	0	5	0	0
23	24750339	.	C	A	1	2	3	0	0	3	0	0
23	24803130	.	C	T	17	13	30	0	2	32	0	0
23	24803221	.	T	C	3	0	3	0	4	7	0	0
23	24819831	.	C	G	7	8	15	0	1	16	0	0
23	24823899	.	T	C	7	5	12	0	0	12	0	0
23	24855864	.	G	T	0	1	1	0	0	1	0	0
23	24926470	.	G	A	4	11	15	0	4	19	0	0
23	24932493	.	G	T	2	5	7	0	0	7	0	0
23	24932979	.	G	A	8	6	14	0	0	14	0	0
23	24933121	.	C	T	9	10	19	0	1	20	0	0
23	24934567	.	T	C	9	4	13	0	1	14	0	0
23	24934597	.	C	G	8	5	13	0	0	13	0	0
23	24938290	.	T	A	5	4	9	0	1	10	0	0
23	24957161	.	G	C	1	2	3	0	0	3	0	0
23	24957184	.	A	G	3	0	3	0	3	6	0	0
23	24959374	.	G	C	4	2	6	0	0	6	0	0
23	24959406	.	T	C	4	3	7	0	0	7	0	0
23	24960393	.	T	A	3	4	7	0	0	7	0	0
23	24960701	.	C	T	3	1	4	0	1	5	0	0
23	24960702	.	C	T	3	2	5	0	0	5	0	0
23	24960740	.	T	G	4	3	7	0	1	8	0	0
23	24960741	.	G	T	4	4	8	0	0	8	0	0
23	24962414	.	A	T	0	1	1	0	0	1	0	0
23	24962560	.	G	A	0	1	1	0	0	1	0	0
23	24965393	.	C	T	8	11	19	0	0	19	0	0
23	24965396	.	G	A	8	12	20	0	0	20	0	0
23	24965432	.	G	T	7	9	16	0	1	17	0	0
23	24968676	.	C	A	4	1	5	0	0	5	0	0
23	24970331	.	A	G	2	0	2	0	1	3	0	0
23	24970372	.	G	A	2	8	10	0	1	11	0	0
23	24970451	.	T	C	5	2	7	0	0	7	0	0
23	24970589	.	A	G	2	5	7	0	0	7	0	0
23	24970593	.	G	A	2	5	7	0	0	7	0	0
23	24970710	.	G	A	2	5	7	0	0	7	0	0
23	24970732	.	C	T	2	4	6	0	0	6	0	0
23	24973871	.	T	C	7	5	12	0	1	13	0	0
23	24973928	.	A	G	4	3	7	0	0	7	0	0
23	24973931	.	A	G	4	0	4	0	3	7	0	0
23	24980349	.	T	A	2	1	3	0	0	3	0	0
23	24984969	.	A	C	1	1	2	0	0	2	0	0
23	25517732	.	A	T	2	2	4	0	0	4	0	0
23	25518832	.	G	T	4	2	6	0	0	6	0	0
23	25525335	.	A	G	3	3	6	0	0	6	0	0
23	25533562	.	T	C	0	0	0	0	1	1	0	0
23	25533607	.	T	C	1	3	4	0	0	4	0	0
23	25533609	.	A	G	0	3	3	0	1	4	0	0
23	25533685	.	C	T	0	2	2	0	4	6	0	0
23	25537722	.	G	A	3	4	7	0	0	7	0	0
23	25564734	.	G	T	0	2	2	0	0	2	0	0
23	25757012	.	G	A	0	2	2	0	0	2	0	0
23	25757378	.	G	A	0	2	2	0	2	4	0	0
23	25767757	.	G	A	0	3	3	0	4	7	0	0
23	25770804	.	T	A	3	5	8	0	1	9	0	0
23	25772369	.	A	G	0	1	1	0	1	2	0	0
23	25772799	.	G	A	4	3	7	0	0	7	0	0
23	25773460	.	G	A	6	3	9	0	0	9	0	0
23	25773469	.	G	A	3	3	6	0	0	6	0	0
23	25776824	.	C	T	0	2	2	0	1	3	0	0
23	25777286	.	A	G	3	2	5	0	0	5	0	0
23	25796410	.	T	A	9	2	11	0	2	13	0	0
23	25796484	.	G	C	6	0	6	0	5	11	0	0
23	25796563	.	C	A	2	2	4	0	0	4	0	0
23	25796670	.	T	G	2	5	7	0	0	7	0	0
23	25796691	.	T	C	1	0	1	0	5	6	0	0
23	25797011	.	T	A	4	3	7	0	1	8	0	0
23	25797022	.	T	A	2	2	4	0	2	6	0	0
23	25797143	.	G	C	10	5	15	0	0	15	0	0
23	25797216	.	G	A	6	9	15	0	0	15	0	0
23	25869424	.	A	G	5	0	5	0	11	16	0	0
23	25869571	.	G	A	4	4	8	0	0	8	0	0
23	25869596	.	C	A	5	3	8	0	0	8	0	0
23	25869658	.	C	T	13	4	17	0	0	17	0	0
23	25869706	.	A	G	7	8	15	0	3	18	0	0
23	25871764	.	C	A	7	4	11	0	0	11	0	0
23	25872703	.	G	A	0	2	2	0	1	3	0	0
23	25873444	.	C	A	5	4	9	0	4	13	0	0
23	25873670	.	A	G	1	2	3	0	0	3	0	0
23	25873876	.	A	T	5	3	8	0	0	8	0	0
23	25873882	.	G	C	5	2	7	0	0	7	0	0
23	25873967	.	T	A	6	4	10	0	0	10	0	0
23	25873976	.	T	A	5	6	11	0	0	11	0	0
23	25874249	.	A	G	17	0	17	0	10	27	0	0
23	25874261	.	T	A	18	8	26	0	1	27	0	0
23	25874334	.	C	G	5	6	11	0	0	11	0	0
23	25874355	.	A	T	8	5	13	0	0	13	0	0
23	25874459	.	A	T	7	11	18	0	0	18	0	0
23	25874498	.	G	A	6	5	11	0	1	12	0	0
23	25874615	.	G	A	2	6	8	0	0	8	0	0
23	25879786	.	A	G	5	11	16	0	1	17	0	0
23	25879930	.	A	C	2	4	6	0	0	6	0	0
23	25930689	.	C	T	2	3	5	0	1	6	0	0
23	25942399	.	T	G	13	0	13	0	9	22	0	0
23	25942559	.	T	A	1	8	9	0	0	9	0	0
23	25942708	.	G	A	0	3	3	0	4	7	0	0
23	25946766	.	C	T	1	3	4	0	0	4	0	0
23	25947416	.	T	G	0	2	2	0	0	2	0	0
23	25947599	.	T	C	2	0	2	0	3	5	0	0
23	25948000	.	G	A	2	2	4	0	0	4	0	0
23	26063560	.	A	T	28	20	48	0	3	51	0	0
23	26063614	.	A	C	27	28	55	0	1	56	0	0
23	26063734	.	G	A	23	20	43	0	3	46	0	0
23	26063843	.	G	A	24	24	48	0	5	53	0	0
23	26063985	.	A	T	24	28	52	0	3	55	0	0
23	26064050	.	T	A	28	23	51	0	3	54	0	0
23	26064122	.	T	A	10	21	31	0	1	32	0	0
23	26064124	.	T	A	23	7	30	0	2	32	0	0
23	26064266	.	T	A	17	19	36	0	2	38	0	0
23	26064923	.	T	C	22	2	24	0	32	56	0	0
23	26064948	.	T	G	22	24	46	0	4	50	0	0
23	26064989	.	A	G	31	18	49	0	3	52	0	0
23	26065079	.	T	C	24	35	59	0	3	62	0	0
23	26074123	.	G	A	18	7	25	0	1	26	0	0
23	26074252	.	T	A	1	2	3	0	0	3	0	0
23	26083822	.	A	C	1	0	1	0	0	1	0	0
23	26085897	.	A	C	0	2	2	0	0	2	0	0
23	26088845	.	A	G	2	3	5	0	0	5	0	0
23	26093095	.	C	T	11	6	17	0	0	17	0	0
23	26093331	.	T	C	2	2	4	0	0	4	0	0
23	26093868	.	T	C	3	4	7	0	0	7	0	0
23	26093933	.	A	T	5	4	9	0	0	9	0	0
23	26094063	.	A	G	4	3	7	0	0	7	0	0
23	26094533	.	A	G	2	9	11	0	1	12	0	0
23	26094589	.	G	C	7	15	22	0	1	23	0	0
23	26094617	.	T	C	12	20	32	0	0	32	0	0
23	26094626	.	T	C	13	0	13	0	22	35	0	0
23	26094877	.	A	G	9	12	21	0	0	21	0	0
23	26094932	.	G	A	9	5	14	0	2	16	0	0
23	26094938	.	C	A	10	5	15	0	0	15	0	0
23	26095081	.	G	A	7	16	23	0	0	23	0	0
23	26095096	.	C	T	8	15	23	0	0	23	0	0
23	26095153	.	G	A	9	10	19	0	1	20	0	0
23	26095285	.	T	A	8	8	16	0	2	18	0	0
23	26095400	.	C	T	15	11	26	0	1	27	0	0
23	26095416	.	T	G	13	10	23	0	0	23	0	0
23	26110735	.	G	A	11	9	20	0	0	20	0	0
23	26120198	.	C	A	0	4	4	0	8	12	0	0
23	26126392	.	T	C	0	7	7	3	0	10	0	0
23	26126478	.	G	A	2	2	4	1	0	5	0	0
23	26187735	.	C	T	1	1	2	0	0	2	0	0
23	26225907	.	A	T	8	3	11	0	0	11	0	0
23	26227697	.	C	T	0	6	6	0	7	13	0	0
23	26232509	.	C	A	8	13	21	0	0	21	0	0
23	26240860	.	G	A	1	7	8	0	0	8	0	0
23	26249884	.	G	A	0	1	1	0	0	1	0	0
23	26251940	.	G	A	1	4	5	0	1	6	0	0
23	26251946	.	A	G	1	7	8	0	0	8	0	0
23	26258065	.	C	T	0	4	4	0	7	11	0	0
23	26273212	.	C	T	0	2	2	0	1	3	0	0
23	26273215	.	G	A	2	1	3	0	0	3	0	0
23	26299011	.	T	C	2	0	2	0	2	4	0	0
23	26311056	.	T	C	4	2	6	0	0	6	0	0
23	26330387	.	C	T	1	1	2	0	0	2	0	0
23	26499179	.	T	C	1	2	3	0	0	3	0	0
23	26499228	.	A	G	1	1	2	0	1	3	0	0
23	26503884	.	T	C	27	0	27	0	25	52	0	0
23	26504151	.	A	C	29	0	29	0	21	50	0	0
23	26504202	.	A	T	36	11	47	0	1	48	0	0
23	26504254	.	G	A	31	13	44	0	1	45	0	0
23	26504264	.	C	T	33	17	50	0	0	50	0	0
23	26507741	.	G	A	18	30	48	0	0	48	0	0
23	26509764	.	G	A	15	28	43	0	0	43	0	0
23	26517183	.	G	A	21	22	43	0	2	45	0	0
23	26522647	.	A	G	11	11	22	0	1	23	0	0
23	26522892	.	G	A	15	13	28	0	1	29	0	0
23	26763798	.	A	T	8	4	12	0	0	12	0	0
23	26763994	.	C	A	2	3	5	0	1	6	0	0
23	26764230	.	G	T	4	5	9	0	0	9	0	0
23	26766668	.	A	G	5	6	11	0	3	14	0	0
23	26770180	.	C	T	0	2	2	0	0	2	0	0
23	26774334	.	G	A	1	1	2	0	0	2	0	0
23	26777492	.	G	A	1	2	3	0	0	3	0	0
23	26777537	.	G	A	1	1	2	0	0	2	0	0
23	26797108	.	T	A	2	5	7	0	0	7	0	0
23	26801696	.	C	T	1	3	4	0	0	4	0	0
23	26813850	.	C	T	0	2	2	0	0	2	0	0
23	26835280	.	G	A	1	2	3	0	0	3	0	0
23	26946805	.	A	G	2	3	5	0	0	5	0	0
23	26951926	.	G	A	0	1	1	0	0	1	0	0
23	26955383	.	C	T	1	2	3	0	0	3	0	0
23	26955401	.	A	G	1	2	3	0	0	3	0	0
23	26958483	.	A	G	0	0	0	0	1	1	0	0
23	26979223	.	C	A	10	14	24	0	0	24	0	0
23	27003630	.	T	A	10	8	18	0	0	18	0	0
23	27003720	.	G	A	27	27	54	0	0	54	0	0
23	27003801	.	T	C	21	25	46	0	6	53	1	0
23	27004310	.	C	T	23	16	39	0	0	39	0	0
23	27004339	.	C	T	18	16	34	0	3	37	0	0
23	27004347	.	G	A	21	19	40	0	0	40	0	0
23	27004383	.	C	T	12	19	31	0	0	31	0	0
23	27004397	.	T	C	9	18	27	0	0	27	0	0
23	27004665	.	T	C	18	12	30	0	1	31	0	0
23	27005195	.	G	A	20	17	37	0	3	40	0	0
23	27005514	.	A	G	15	0	15	0	14	29	0	0
23	27041461	.	A	T	4	3	7	0	0	7	0	0
23	27041503	.	C	G	2	6	8	0	0	8	0	0
23	27042132	.	A	G	12	6	18	0	1	19	0	0
23	27042454	.	T	C	3	4	7	0	0	7	0	0
23	27042533	.	C	T	1	2	3	0	0	3	0	0
23	27044241	.	C	T	4	8	12	0	0	12	0	0
23	27044526	.	A	G	3	4	7	0	0	7	0	0
23	27044638	.	T	A	2	6	8	0	0	8	0	0
23	27052123	.	C	A	11	7	18	0	0	18	0	0
23	27052125	.	C	T	11	7	18	0	0	18	0	0
23	27054361	.	C	T	6	9	15	0	1	16	0	0
23	27059120	.	G	A	2	12	14	0	16	30	0	0
23	27059376	.	T	A	16	14	30	0	2	32	0	0
23	27059422	.	C	T	16	21	37	0	2	39	0	0
23	27059459	.	A	G	19	0	19	0	18	37	0	0
23	27059526	.	G	A	0	20	20	0	14	34	0	0
23	27135178	.	A	T	2	2	4	0	0	4	0	0
23	27251789	.	G	C	24	17	41	0	1	42	0	0
23	27251859	.	G	A	21	25	46	0	2	48	0	0
23	27251872	.	C	T	0	26	26	0	21	47	0	0
23	27252425	.	G	A	24	21	45	0	2	47	0	0
23	27252587	.	A	G	14	19	33	0	4	37	0	0
23	27252833	.	A	G	22	11	33	0	1	34	0	0
23	27254226	.	T	C	6	3	9	0	0	9	0	0
23	27254586	.	C	T	0	19	19	0	18	37	0	0
23	27274110	.	G	A	3	1	4	0	0	4	0	0
23	27274266	.	G	A	0	3	3	0	0	3	0	0
23	27279281	.	A	G	9	10	19	0	0	19	0	0
23	27279320	.	A	G	17	9	26	0	0	26	0	0
23	27279476	.	G	A	11	17	28	0	0	28	0	0
23	27279533	.	C	T	15	8	23	0	1	24	0	0
23	27294611	.	G	A	10	9	19	0	1	20	0	0
23	27296964	.	G	C	8	0	8	0	12	20	0	0
23	27305186	.	C	T	12	11	23	0	0	23	0	0
23	27305195	.	G	A	11	8	19	0	2	21	0	0
23	27358990	.	A	T	6	8	14	0	1	15	0	0
23	27359203	.	A	G	9	8	17	0	0	17	0	0
23	27359410	.	G	A	3	6	9	0	0	9	0	0
23	27359526	.	T	C	5	8	13	0	0	13	0	0
23	27359755	.	C	T	0	6	6	0	3	9	0	0
23	27359825	.	C	A	8	9	17	0	0	17	0	0
23	27359867	.	A	C	8	4	12	0	2	14	0	0
23	27360007	.	G	A	5	4	9	0	1	10	0	0
23	27361210	.	A	T	2	2	4	0	3	7	0	0
23	27361216	.	G	A	5	3	8	0	0	8	0	0
23	27364018	.	C	T	4	7	11	0	0	11	0	0
23	27366669	.	C	T	1	1	2	0	0	2	0	0
23	27373181	.	C	T	0	0	0	0	1	1	0	0
23	27373186	.	G	T	1	0	1	0	0	1	0	0
23	27380215	.	C	T	0	4	4	0	1	5	0	0
23	27380430	.	A	C	1	0	1	0	0	1	0	0
23	27448184	.	G	A	0	2	2	0	0	2	0	0
23	27497811	.	T	A	4	4	8	0	2	10	0	0
23	27497960	.	A	T	8	11	19	0	2	21	0	0
23	27498040	.	C	G	3	14	17	0	0	17	0	0
23	27498195	.	A	T	11	17	28	0	1	29	0	0
23	27498441	.	A	T	5	5	10	0	1	11	0	0
23	27498564	.	T	A	6	3	9	0	0	9	0	0
23	27498798	.	C	T	1	19	20	0	11	31	0	0
23	27499096	.	G	A	12	15	27	0	0	27	0	0
23	27499195	.	A	T	10	18	28	0	1	29	0	0
23	27499246	.	G	A	17	10	27	0	2	29	0	0
23	27499306	.	C	T	8	15	23	0	0	23	0	0
23	27501872	.	A	G	12	9	21	0	1	22	0	0
23	27513952	.	A	G	4	4	8	0	0	8	0	0
23	27515931	.	G	A	4	5	9	0	0	9	0	0
23	27518434	.	G	A	8	10	18	0	3	21	0	0
23	27521608	.	A	T	2	2	4	0	1	5	0	0
23	27521815	.	G	A	1	3	4	0	0	4	0	0
23	27521863	.	A	G	7	4	11	0	1	12	0	0
23	27547467	.	C	T	0	2	2	0	3	5	0	0
23	27547568	.	G	A	6	6	12	0	0	12	0	0
23	27547650	.	A	T	2	4	6	0	0	6	0	0
23	27576708	.	G	A	1	2	3	0	0	3	0	0
23	27583700	.	C	T	1	3	4	0	0	4	0	0
23	27583703	.	T	A	1	3	4	0	0	4	0	0
23	27591834	.	C	T	5	6	11	0	1	12	0	0
23	27591859	.	C	T	3	7	10	0	2	12	0	0
23	27591939	.	A	G	5	11	16	0	1	17	0	0
23	27592411	.	A	C	8	6	14	0	0	14	0	0
23	27592796	.	T	C	14	0	14	0	6	20	0	0
23	27593230	.	C	T	9	8	17	0	0	17	0	0
23	27597141	.	C	A	0	2	2	0	1	3	0	0
23	27597808	.	G	A	9	6	15	0	1	16	0	0
23	27597980	.	G	A	0	1	1	0	0	1	0	0
23	27597981	.	C	A	0	1	1	0	0	1	0	0
23	27599110	.	A	C	1	1	2	0	0	2	0	0
23	27603302	.	G	A	1	3	4	0	0	4	0	0
23	27608131	.	G	A	5	4	9	0	0	9	0	0
23	27622036	.	T	A	17	21	38	0	1	39	0	0
23	27622212	.	C	A	13	12	25	0	0	25	0	0
23	27622258	.	T	C	13	14	27	0	1	28	0	0
23	27622324	.	T	C	8	17	25	0	0	25	0	0
23	27622386	.	T	G	7	6	13	0	1	14	0	0
23	27629923	.	A	T	1	2	3	0	0	3	0	0
23	27641607	.	C	T	3	2	5	0	0	5	0	0
23	27643941	.	T	C	1	0	1	0	2	3	0	0
23	27657924	.	A	C	1	2	3	0	0	3	0	0
23	27677263	.	G	A	22	14	36	0	4	40	0	0
23	27677278	.	G	A	15	17	32	0	2	34	0	0
23	27683248	.	C	A	0	2	2	0	3	5	0	0
23	27683497	.	C	T	4	4	8	0	0	8	0	0
23	27683629	.	C	T	0	4	4	0	5	9	0	0
23	27683710	.	G	A	6	6	12	0	0	12	0	0
23	27684618	.	T	C	5	0	5	0	4	9	0	0
23	27780905	.	A	G	2	2	4	0	0	4	0	0
23	27781618	.	T	C	2	3	5	0	0	5	0	0
23	27784281	.	A	T	2	2	4	0	1	5	0	0
23	27784466	.	G	A	3	3	6	0	1	7	0	0
23	27785026	.	A	C	2	4	6	0	0	6	0	0
23	27785413	.	G	A	0	3	3	0	1	4	0	0
23	27787598	.	T	C	3	2	5	0	0	5	0	0
23	27787851	.	T	C	1	1	2	0	0	2	0	0
23	27788133	.	G	A	1	4	5	0	0	5	0	0
23	27788665	.	C	T	6	6	12	0	1	13	0	0
23	27788768	.	G	A	6	10	16	0	1	17	0	0
23	27793510	.	T	C	11	5	16	0	1	17	0	0
23	27800570	.	A	G	1	4	5	0	2	7	0	0
23	27800681	.	G	T	10	6	16	0	1	17	0	0
23	27800954	.	A	C	4	9	13	0	1	14	0	0
23	27800977	.	C	T	8	13	21	0	1	22	0	0
23	27801081	.	T	C	10	6	16	0	2	18	0	0
23	27801101	.	T	C	9	0	9	0	6	15	0	0
23	27801237	.	T	C	8	14	22	0	1	23	0	0
23	27801268	.	C	A	15	14	29	0	1	30	0	0
23	27801629	.	C	T	8	6	14	0	0	14	0	0
23	27801849	.	G	A	10	4	14	0	0	14	0	0
23	27801880	.	G	T	11	3	14	0	0	14	0	0
23	27805414	.	A	G	4	5	9	0	1	10	0	0
23	27807294	.	A	G	16	6	22	0	1	23	0	0
23	27807523	.	A	G	0	3	3	0	0	3	0	0
23	27807664	.	G	A	2	5	7	0	0	7	0	0
23	27835898	.	G	A	5	3	8	0	0	8	0	0
23	27836003	.	C	G	6	7	13	0	0	13	0	0
23	27836235	.	C	T	0	3	3	0	5	8	0	0
23	27836245	.	G	A	4	3	7	0	1	8	0	0
23	27839682	.	A	G	2	3	5	0	0	5	0	0
23	27912116	.	C	A	4	3	7	0	0	7	0	0
23	27912136	.	T	C	3	2	5	0	0	5	0	0
23	27966981	.	G	A	5	7	12	0	0	12	0	0
23	27967014	.	T	G	4	8	12	0	0	12	0	0
23	28005087	.	C	T	7	3	10	0	0	10	0	0
23	28005338	.	A	G	12	5	17	0	0	17	0	0
23	28023784	.	T	C	13	4	17	0	1	18	0	0
23	28025586	.	G	A	11	11	22	0	1	23	0	0
23	28025664	.	A	G	6	9	15	0	0	15	0	0
23	28087734	.	A	G	1	1	2	0	0	2	0	0
23	28125796	.	C	T	2	3	5	0	0	5	0	0
23	28125932	.	T	A	2	5	7	0	1	8	0	0
23	28128445	.	T	C	1	2	3	0	0	3	0	0
23	28130983	.	G	A	1	1	2	0	1	3	0	0
23	28130999	.	A	G	2	4	6	0	0	6	0	0
23	28131047	.	T	C	4	5	9	0	0	9	0	0
23	28131083	.	A	G	4	2	6	0	2	8	0	0
23	28131248	.	C	T	3	4	7	0	1	8	0	0
23	28131251	.	C	T	3	4	7	0	0	7	0	0
23	28131285	.	C	T	6	6	12	0	0	12	0	0
23	28131320	.	G	A	6	6	12	0	1	13	0	0
23	28136167	.	G	T	2	4	6	0	0	6	0	0
23	28136471	.	T	G	3	2	5	0	0	5	0	0
23	28136498	.	A	G	3	3	6	0	0	6	0	0
23	28139515	.	C	T	3	3	6	0	0	6	0	0
23	28139564	.	A	G	9	5	14	0	1	15	0	0
23	28139633	.	T	C	4	5	9	0	0	9	0	0
23	28141324	.	G	C	3	4	7	0	1	8	0	0
23	28186060	.	T	A	9	12	21	0	1	22	0	0
23	28186688	.	T	G	2	4	6	0	0	6	0	0
23	28186995	.	T	C	13	1	14	0	8	22	0	0
23	28190648	.	A	G	9	6	15	0	0	15	0	0
23	28200967	.	A	G	17	7	24	0	0	24	0	0
23	28231248	.	G	A	2	1	3	0	0	3	0	0
23	28294259	.	T	A	3	1	4	0	0	4	0	0
23	28374570	.	G	A	14	23	37	0	2	39	0	0
23	28374711	.	C	A	18	20	38	0	0	38	0	0
23	28374756	.	A	G	10	12	22	0	0	22	0	0
23	28377424	.	T	C	0	3	3	0	0	3	0	0
23	28382953	.	C	T	5	11	16	0	1	17	0	0
23	28383548	.	T	C	1	2	3	0	0	3	0	0
23	28388013	.	C	A	6	20	26	0	1	27	0	0
23	28388318	.	C	T	16	10	26	0	0	26	0	0
23	28388325	.	T	C	14	10	24	0	0	24	0	0
23	28388474	.	G	T	1	3	4	0	1	5	0	0
23	28422830	.	A	G	1	3	4	0	0	4	0	0
23	28422952	.	C	T	1	3	4	0	0	4	0	0
23	28487088	.	C	A	0	4	4	0	7	11	0	0
23	28508169	.	C	A	1	1	2	0	0	2	0	0
23	28515768	.	C	T	1	2	3	0	0	3	0	0
23	28522491	.	A	G	7	0	7	0	3	10	0	0
23	28525270	.	T	C	2	3	5	0	0	5	0	0
23	28527739	.	A	C	3	2	5	0	0	5	0	0
23	28532518	.	G	A	6	1	7	0	0	7	0	0
23	28537575	.	G	A	0	4	4	0	8	12	0	0
23	28538590	.	T	A	0	0	0	0	1	1	0	0
23	28539108	.	T	C	2	3	5	0	0	5	0	0
23	28539279	.	G	A	0	4	4	0	4	8	0	0
23	28539626	.	G	A	7	8	15	0	1	16	0	0
23	28541413	.	A	G	2	2	4	0	1	5	0	0
23	28541416	.	T	C	2	3	5	0	0	5	0	0
23	28541593	.	T	C	5	8	13	0	1	14	0	0
23	28541633	.	A	G	4	6	10	0	2	12	0	0
23	28541638	.	C	T	3	5	8	0	1	9	0	0
23	28541683	.	G	T	2	7	9	0	0	9	0	0
23	28546798	.	T	C	4	7	11	0	0	11	0	0
23	28551764	.	A	G	6	0	6	0	7	13	0	0
23	28552149	.	A	C	5	0	5	0	14	19	0	0
23	28561502	.	C	A	20	18	38	0	0	38	0	0
23	28561836	.	C	T	6	2	8	0	1	9	0	0
23	28564191	.	C	A	18	10	28	0	1	29	0	0
23	28661120	.	T	C	0	2	2	0	1	3	0	0
23	28663266	.	G	A	3	5	8	0	0	8	0	0
23	28667294	.	T	C	3	3	6	0	0	6	0	0
23	28672063	.	G	A	0	0	0	0	2	2	0	0
23	28674046	.	C	T	1	6	7	0	0	7	0	0
23	28674252	.	G	A	1	2	3	0	0	3	0	0
23	28674634	.	T	A	1	0	1	0	0	1	0	0
23	28679693	.	A	G	7	8	15	0	0	15	0	0
23	28679696	.	C	T	7	9	16	0	0	16	0	0
23	28679753	.	C	T	10	10	20	0	1	21	0	0
23	28680239	.	A	G	0	1	1	0	0	1	0	0
23	28681558	.	G	C	24	26	50	0	2	52	0	0
23	28681559	.	C	A	23	27	50	0	2	52	0	0
23	28681723	.	T	A	24	23	47	0	3	50	0	0
23	28687561	.	C	T	4	1	5	0	0	5	0	0
23	28693280	.	T	A	7	4	11	0	0	11	0	0
23	28693308	.	T	A	8	3	11	0	0	11	0	0
23	28695772	.	A	G	1	0	1	0	0	1	0	0
23	28698340	.	T	C	7	13	20	0	0	20	0	0
23	28704611	.	G	A	7	12	19	0	1	20	0	0
23	28704683	.	G	A	0	1	1	0	0	1	0	0
23	28705908	.	C	T	8	8	16	0	0	16	0	0
23	28707195	.	T	A	6	5	11	0	0	11	0	0
23	28710429	.	T	C	14	7	21	0	0	21	0	0
23	28712193	.	T	G	5	1	6	0	0	6	0	0
23	28722887	.	G	A	3	4	7	0	0	7	0	0
23	28722917	.	C	T	8	5	13	0	0	13	0	0
23	28723338	.	C	A	2	3	5	0	0	5	0	0
23	28724964	.	A	G	6	3	9	0	0	9	0	0
23	28725174	.	G	A	0	3	3	0	1	4	0	0
23	28725600	.	A	T	2	3	5	0	0	5	0	0
23	28725644	.	G	A	7	4	11	0	2	13	0	0
23	28725743	.	A	G	4	4	8	0	0	8	0	0
23	28725804	.	G	A	3	5	8	0	0	8	0	0
23	28725822	.	G	C	2	3	5	0	0	5	0	0
23	28725991	.	T	C	2	4	6	0	0	6	0	0
23	28725994	.	G	A	2	3	5	0	1	6	0	0
23	28726026	.	T	C	1	2	3	0	0	3	0	0
23	28726193	.	A	G	1	1	2	0	0	2	0	0
23	28726196	.	C	A	1	1	2	0	0	2	0	0
23	28726521	.	A	G	4	8	12	0	0	12	0	0
23	28726634	.	A	C	6	6	12	0	1	13	0	0
23	28731489	.	A	C	23	30	53	0	3	56	0	0
23	28731499	.	C	T	26	27	53	0	2	55	0	0
23	28731834	.	C	T	25	38	63	0	2	65	0	0
23	28731914	.	T	C	34	27	61	0	3	64	0	0
23	28803167	.	A	G	2	2	4	0	0	4	0	0
23	28803209	.	T	C	2	2	4	0	0	4	0	0
23	28803213	.	C	T	2	2	4	0	0	4	0	0
23	28803248	.	T	C	3	0	3	0	2	5	0	0
23	28803251	.	T	C	1	3	4	0	1	5	0	0
23	28803302	.	T	C	1	7	8	0	1	9	0	0
23	28803305	.	C	T	2	6	8	0	1	9	0	0
23	28803398	.	C	A	0	2	2	0	1	3	0	0
23	28803597	.	G	A	1	3	4	0	0	4	0	0
23	28806278	.	A	G	2	2	4	0	0	4	0	0
23	28882508	.	T	C	1	0	1	0	0	1	0	0
23	28922165	.	C	A	3	7	10	0	0	10	0	0
23	28922300	.	G	A	0	2	2	0	2	4	0	0
23	28923192	.	G	T	1	1	2	0	0	2	0	0
23	28923217	.	T	G	2	0	2	0	5	7	0	0
23	28923407	.	C	A	1	2	3	0	0	3	0	0
23	28923416	.	C	T	1	2	3	0	0	3	0	0
23	28923717	.	T	A	3	2	5	0	0	5	0	0
23	28923760	.	T	A	3	4	7	0	0	7	0	0
23	28923962	.	A	G	7	4	11	0	0	11	0	0
23	28924117	.	G	C	2	8	10	0	1	11	0	0
23	28924399	.	C	G	4	2	6	0	1	7	0	0
23	28924672	.	C	T	4	3	7	0	0	7	0	0
23	28924806	.	A	G	4	3	7	0	1	8	0	0
23	28925275	.	T	C	4	4	8	0	0	8	0	0
23	28925354	.	T	C	5	6	11	0	0	11	0	0
23	28925441	.	G	A	5	5	10	0	0	10	0	0
23	28925451	.	A	T	4	5	9	0	0	9	0	0
23	28967458	.	T	G	0	3	3	0	0	3	0	0
23	28970042	.	A	G	2	2	4	0	0	4	0	0
23	28970219	.	A	G	2	2	4	0	0	4	0	0
23	29003403	.	A	T	1	3	4	0	0	4	0	0
23	29003421	.	T	C	1	3	4	0	0	4	0	0
23	29358241	.	G	A	2	17	19	0	28	47	0	0
23	29358253	.	C	T	26	18	44	0	2	46	0	0
23	29359664	.	T	A	12	10	22	0	1	23	0	0
23	29360407	.	G	T	0	10	10	0	21	32	1	0
23	29360687	.	G	T	2	6	8	0	2	10	0	0
23	29360707	.	G	T	3	5	8	0	1	9	0	0
23	29361357	.	C	A	17	10	27	0	1	29	1	0
23	29361365	.	A	C	15	11	26	0	2	28	0	0
23	29361557	.	A	T	9	10	19	0	0	19	0	0
23	29361581	.	A	T	6	0	6	0	8	14	0	0
23	29376410	.	C	T	13	5	18	0	0	18	0	0
23	29381612	.	C	A	6	8	14	0	1	15	0	0
23	29386735	.	C	T	2	0	2	0	0	2	0	0
23	29393787	.	A	G	3	3	6	0	1	7	0	0
23	29393817	.	T	C	8	4	12	0	0	12	0	0
23	29396452	.	C	T	1	17	18	0	29	47	0	0
23	29397116	.	C	G	24	10	34	0	2	36	0	0
23	29397230	.	T	A	29	26	55	0	1	56	0	0
23	29397501	.	C	T	23	23	46	0	3	49	0	0
23	29397506	.	T	G	21	26	47	0	2	49	0	0
23	29397563	.	C	T	0	20	20	0	20	40	0	0
23	29397816	.	G	A	18	29	47	0	2	49	0	0
23	29397907	.	T	C	42	14	56	0	2	58	0	0
23	29398065	.	T	C	25	20	45	0	1	46	0	0
23	29398544	.	C	A	1	24	25	0	25	51	1	0
23	29398548	.	A	G	24	23	47	0	1	48	0	0
23	29399085	.	T	C	7	0	7	0	7	14	0	0
23	29403306	.	T	G	8	12	20	0	0	20	0	0
23	29403437	.	G	A	11	9	20	0	0	20	0	0
23	29403491	.	C	A	10	9	19	0	1	20	0	0
23	29403515	.	A	C	0	3	3	0	0	3	0	0
23	29405829	.	A	G	26	14	40	0	3	43	0	0
23	29408773	.	A	G	30	17	47	0	4	51	0	0
23	29412411	.	A	G	13	16	29	0	0	29	0	0
23	29415484	.	A	G	10	9	19	0	1	20	0	0
23	29421959	.	C	G	16	16	32	0	3	35	0	0
23	29431995	.	T	C	20	21	41	0	1	42	0	0
23	29432040	.	A	G	17	19	36	0	2	38	0	0
23	29432055	.	G	A	14	20	34	0	3	37	0	0
23	29432867	.	T	G	9	6	15	0	0	15	0	0
23	29433715	.	C	A	15	10	25	0	1	26	0	0
23	29435044	.	T	C	2	4	6	0	1	7	0	0
23	29457909	.	G	A	4	5	9	0	0	9	0	0
23	29457942	.	T	C	8	1	9	0	9	18	0	0
23	29463158	.	A	G	2	1	3	0	0	3	0	0
23	29468959	.	A	G	17	9	26	0	0	26	0	0
23	29468980	.	G	A	18	5	23	0	1	24	0	0
23	29469261	.	A	G	0	0	0	0	1	1	0	0
23	29502227	.	C	T	0	8	8	0	11	19	0	0
23	29502302	.	C	T	0	4	4	0	12	16	0	0
23	29502311	.	C	T	7	5	12	0	1	13	0	0
23	29505482	.	C	T	0	10	10	0	8	18	0	0
23	29507723	.	A	T	17	16	33	0	0	33	0	0
23	29507825	.	T	C	10	0	10	0	9	19	0	0
23	29507859	.	T	G	9	10	19	0	1	20	0	0
23	29507883	.	G	A	7	10	17	0	1	18	0	0
23	29508247	.	G	C	3	0	3	0	4	7	0	0
23	29516726	.	T	C	8	6	14	0	1	15	0	0
23	29519565	.	G	A	3	3	6	0	1	7	0	0
23	29519769	.	G	C	6	11	17	0	0	17	0	0
23	29520070	.	A	C	5	1	6	0	0	6	0	0
23	29523602	.	G	A	7	3	10	0	0	10	0	0
23	29541251	.	C	T	8	7	15	0	0	15	0	0
23	29541317	.	G	A	1	3	4	0	0	4	0	0
23	29555019	.	T	A	1	2	3	0	0	3	0	0
23	29565835	.	T	C	1	1	2	0	0	2	0	0
23	29570627	.	C	G	4	7	11	0	2	13	0	0
23	29574430	.	G	C	2	3	5	0	0	5	0	0
23	29574435	.	C	T	0	3	3	0	1	4	0	0
23	29574629	.	A	G	1	2	3	0	0	3	0	0
23	29582634	.	C	A	41	22	63	0	2	65	0	0
23	29582673	.	A	G	38	22	60	0	4	64	0	0
23	29583417	.	T	A	28	37	65	0	1	66	0	0
23	29583708	.	G	A	35	27	62	0	2	64	0	0
23	29583814	.	T	A	46	37	83	0	3	86	0	0
23	29583882	.	A	G	32	37	69	0	2	71	0	0
23	29583960	.	G	A	29	26	55	0	4	60	1	0
23	29586380	.	G	A	16	15	31	0	2	33	0	0
23	29589392	.	A	G	18	21	39	0	1	40	0	0
23	29592588	.	T	C	20	1	21	0	14	35	0	0
23	29592708	.	G	A	28	31	59	0	2	61	0	0
23	29592741	.	C	T	25	20	45	0	3	48	0	0
23	29592927	.	T	C	15	1	16	0	17	33	0	0
23	29594441	.	A	G	17	13	30	0	1	31	0	0
23	29601269	.	C	T	15	11	26	0	0	26	0	0
23	29603174	.	T	C	5	2	7	0	0	7	0	0
23	29607011	.	A	G	21	27	48	0	1	49	0	0
23	29607029	.	A	G	26	21	47	0	1	48	0	0
23	29608769	.	A	G	7	5	12	0	3	15	0	0
23	29617571	.	A	C	14	1	15	0	10	26	1	0
23	29667473	.	A	C	4	1	5	0	0	5	0	0
23	29667480	.	G	A	7	5	12	0	0	12	0	0
23	29667614	.	C	G	16	11	27	0	5	32	0	0
23	29667784	.	G	A	1	6	7	0	0	7	0	0
23	29667812	.	T	C	0	0	0	0	4	4	0	0
23	29667848	.	T	C	0	2	2	0	0	2	0	0
23	29711788	.	G	A	13	13	26	0	0	26	0	0
23	29711911	.	C	T	17	6	23	0	1	24	0	0
23	29711998	.	G	A	19	12	31	0	0	31	0	0
23	29712140	.	G	A	9	6	15	0	2	17	0	0
23	29712465	.	G	A	14	6	20	0	4	24	0	0
23	29712493	.	C	T	0	7	7	0	12	19	0	0
23	29712670	.	G	A	16	4	20	0	3	23	0	0
23	29712922	.	C	A	15	19	34	0	0	34	0	0
23	29756865	.	A	T	5	6	11	0	0	11	0	0
23	29757038	.	G	A	6	6	12	0	0	12	0	0
23	29757980	.	T	C	4	0	4	0	8	12	0	0
23	29758030	.	C	T	0	9	9	0	5	14	0	0
23	29758088	.	A	G	7	13	20	0	1	21	0	0
23	29764120	.	T	C	1	5	6	0	0	6	0	0
23	29810779	.	G	A	0	2	2	0	0	2	0	0
23	29812595	.	G	C	6	7	13	0	1	14	0	0
23	29812663	.	A	T	4	3	7	0	0	7	0	0
23	29827748	.	G	A	7	3	10	0	0	10	0	0
23	29829160	.	A	T	2	3	5	0	0	5	0	0
23	29829186	.	A	C	2	3	5	0	0	5	0	0
23	29840171	.	T	C	2	0	2	0	0	2	0	0
23	29840178	.	A	G	3	1	4	0	0	4	0	0
23	29840274	.	C	A	7	13	20	0	1	21	0	0
23	29841374	.	T	C	3	3	6	0	0	6	0	0
23	29841965	.	T	C	3	3	6	1	0	7	0	0
23	29842402	.	T	A	2	3	5	0	0	5	0	0
23	29842966	.	C	T	4	4	8	0	0	8	0	0
23	29842967	.	T	G	4	4	8	0	0	8	0	0
23	29843067	.	A	T	1	2	3	0	0	3	0	0
23	29843847	.	A	C	1	2	3	0	0	3	0	0
23	29843863	.	T	C	2	0	2	0	2	4	0	0
23	29844310	.	C	A	0	3	3	0	2	5	0	0
23	29849025	.	A	G	3	3	6	0	0	6	0	0
23	29854443	.	G	A	2	4	6	0	0	6	0	0
23	29854491	.	C	T	3	2	5	0	0	5	0	0
23	29857920	.	A	T	1	1	2	0	0	2	0	0
23	29857967	.	T	A	4	6	10	0	1	11	0	0
23	29858023	.	C	A	2	4	6	0	0	6	0	0
23	29861645	.	A	T	7	4	11	0	0	11	0	0
23	29861973	.	A	G	10	22	32	0	0	32	0	0
23	29861976	.	T	C	10	0	10	0	21	31	0	0
23	29867576	.	G	A	5	2	7	0	0	7	0	0
23	29872254	.	A	G	10	8	18	0	0	18	0	0
23	29886897	.	G	C	19	10	29	0	1	30	0	0
23	29886937	.	T	A	17	14	31	0	4	35	0	0
23	29966518	.	A	T	3	2	5	0	0	5	0	0
23	29980935	.	C	T	4	2	6	0	0	6	0	0
23	29992023	.	G	C	4	4	8	0	0	8	0	0
23	29992278	.	A	T	0	0	0	0	4	4	0	0
23	29992279	.	C	G	0	0	0	0	4	4	0	0
23	30009382	.	C	T	3	3	6	0	0	6	0	0
23	30010029	.	A	T	1	2	3	0	0	3	0	0
23	30061605	.	A	C	25	5	30	0	1	31	0	0
23	30061763	.	C	T	1	25	26	0	20	46	0	0
23	30061804	.	A	C	21	27	48	0	0	49	1	0
23	30061960	.	T	C	22	2	24	0	21	45	0	0
23	30062364	.	T	A	18	19	37	0	1	38	0	0
23	30062792	.	C	T	10	15	25	0	0	25	0	0
23	30062888	.	C	T	2	18	20	0	10	30	0	0
23	30063216	.	T	C	19	0	19	0	13	32	0	0
23	30063217	.	T	G	18	13	31	0	1	32	0	0
23	30063527	.	G	A	8	11	19	0	0	19	0	0
23	30063578	.	A	G	9	10	19	0	3	22	0	0
23	30063643	.	C	T	7	10	17	0	5	22	0	0
23	30063722	.	G	A	8	8	16	0	2	18	0	0
23	30064289	.	T	C	7	17	24	0	2	26	0	0
23	30064579	.	A	G	17	16	33	0	0	33	0	0
23	30064743	.	C	A	13	14	27	0	1	28	0	0
23	30064804	.	A	G	18	11	29	0	0	29	0	0
23	30064853	.	A	G	14	14	28	0	0	28	0	0
23	30065144	.	G	A	6	9	15	0	0	15	0	0
23	30065640	.	A	G	2	4	6	0	0	7	1	0
23	30071637	.	G	A	0	1	1	0	0	1	0	0
23	30075201	.	G	A	8	14	22	0	1	23	0	0
23	30077023	.	T	C	7	0	7	0	15	22	0	0
23	30085812	.	A	T	3	6	9	0	0	9	0	0
23	30124048	.	A	C	3	0	3	0	10	13	0	0
23	30124303	.	C	T	0	15	15	0	8	23	0	0
23	30124430	.	C	G	6	11	17	0	0	17	0	0
23	30124651	.	A	G	13	9	22	0	0	22	0	0
23	30124818	.	C	T	4	6	10	0	2	12	0	0
23	30124960	.	G	A	2	5	7	0	1	8	0	0
23	30124998	.	T	C	4	5	9	0	1	10	0	0
23	30125004	.	G	A	4	5	9	0	0	9	0	0
23	30125206	.	A	G	12	10	22	0	0	22	0	0
23	30125443	.	G	A	4	9	13	0	0	13	0	0
23	30125599	.	G	A	11	10	21	0	0	21	0	0
23	30125698	.	A	G	7	3	10	0	0	10	0	0
23	30715328	.	T	C	4	5	9	0	0	9	0	0
23	30715397	.	G	A	0	1	1	0	3	4	0	0
23	30715991	.	A	G	0	0	0	0	1	1	0	0
23	30716096	.	C	T	4	9	13	0	0	13	0	0
23	30718554	.	A	G	7	0	7	0	2	9	0	0
23	30724230	.	C	A	3	8	11	0	0	11	0	0
23	30724698	.	T	A	1	4	5	0	0	5	0	0
23	30724828	.	G	C	2	2	4	0	0	4	0	0
23	30730194	.	C	T	2	4	6	0	0	6	0	0
23	30750183	.	G	A	0	19	19	0	10	29	0	0
23	30750402	.	C	A	10	16	26	0	1	27	0	0
23	30752095	.	C	A	11	8	19	0	0	19	0	0
23	30752233	.	T	G	2	5	7	0	0	7	0	0
23	30752352	.	A	T	7	7	14	0	0	14	0	0
23	30761144	.	G	A	4	2	6	0	0	6	0	0
23	30764212	.	T	C	11	11	22	0	0	22	0	0
23	30770193	.	A	G	5	6	11	0	0	11	0	0
23	30772902	.	C	T	3	2	5	0	0	5	0	0
23	30775273	.	T	C	4	1	5	0	1	6	0	0
23	30778358	.	T	C	2	6	8	0	0	8	0	0
23	30778499	.	G	A	9	8	17	0	0	17	0	0
23	30859543	.	C	A	3	6	9	0	0	9	0	0
23	30878451	.	G	A	0	1	1	0	1	2	0	0
23	30890191	.	T	G	3	4	7	0	0	7	0	0
23	30898132	.	C	T	1	5	6	0	0	6	0	0
23	30898150	.	T	C	2	4	6	0	0	6	0	0
23	30898297	.	T	C	3	3	6	0	0	6	0	0
23	30898355	.	A	C	2	5	7	0	0	7	0	0
23	30898387	.	C	T	4	4	8	0	0	8	0	0
23	30919027	.	T	G	1	3	4	0	0	4	0	0
23	31245593	.	A	T	1	7	8	0	1	9	0	0
23	31276396	.	T	A	3	7	10	0	0	10	0	0
23	31276453	.	G	A	5	6	11	0	0	11	0	0
23	31276509	.	C	T	4	3	7	0	1	8	0	0
23	31276657	.	T	C	6	4	10	0	0	10	0	0
23	31278183	.	G	T	5	5	10	0	0	10	0	0
23	31278237	.	C	T	0	2	2	0	3	5	0	0
23	31278322	.	A	G	5	7	12	0	2	14	0	0
23	31278375	.	A	G	8	9	17	0	0	17	0	0
23	31278732	.	C	T	3	2	5	0	0	5	0	0
23	31279122	.	G	T	1	2	3	0	0	3	0	0
23	31280198	.	G	A	2	2	4	0	0	4	0	0
23	31281768	.	T	G	0	1	1	0	0	1	0	0
23	31281936	.	T	G	0	1	1	0	0	1	0	0
23	31309710	.	T	C	2	4	6	0	0	6	0	0
23	31309722	.	T	C	1	2	3	0	0	3	0	0
23	31358342	.	A	T	11	18	29	0	3	32	0	0
23	31358344	.	A	T	12	20	32	0	0	32	0	0
23	31358489	.	T	G	20	15	35	0	1	37	1	0
23	31358631	.	G	A	24	31	55	0	1	56	0	0
23	31381068	.	C	T	4	2	6	0	0	6	0	0
23	31381335	.	A	G	2	1	3	0	0	3	0	0
23	31381356	.	G	A	3	3	6	0	1	7	0	0
23	31381389	.	T	C	3	3	6	0	1	7	0	0
23	31381392	.	C	T	3	4	7	0	0	7	0	0
23	31405519	.	C	T	11	5	16	0	0	16	0	0
23	31405570	.	A	C	13	11	24	0	2	26	0	0
23	31419064	.	C	T	4	1	5	0	0	5	0	0
23	31419172	.	A	T	6	6	12	0	0	12	0	0
23	31422369	.	A	T	5	6	11	0	1	12	0	0
23	31422429	.	C	T	5	5	10	0	0	10	0	0
23	31422577	.	A	G	4	4	8	0	0	8	0	0
23	31422600	.	C	T	5	9	14	0	1	15	0	0
23	31422768	.	A	G	6	3	9	0	1	10	0	0
23	31423091	.	T	C	7	4	11	0	0	11	0	0
23	31423145	.	G	A	1	11	12	0	8	20	0	0
23	31423392	.	C	A	14	8	22	0	0	22	0	0
23	31423427	.	A	G	18	0	18	0	7	25	0	0
23	31423432	.	C	A	16	9	25	0	0	25	0	0
23	31432102	.	A	G	5	0	5	0	9	14	0	0
23	31440119	.	T	A	3	2	5	0	0	5	0	0
23	31596584	.	T	G	4	0	4	0	4	8	0	0
23	31597571	.	T	C	8	3	11	0	0	11	0	0
23	31604900	.	C	T	6	4	10	0	0	10	0	0
23	31604912	.	G	T	6	3	9	0	0	9	0	0
23	31641153	.	C	A	21	23	44	0	1	45	0	0
23	31641197	.	A	G	15	27	42	0	2	44	0	0
23	31641270	.	G	A	22	27	49	0	1	50	0	0
23	31643818	.	A	G	11	16	27	0	0	27	0	0
23	31644368	.	A	G	10	10	20	0	1	21	0	0
23	31644419	.	A	G	7	5	12	0	0	12	0	0
23	31644602	.	T	G	6	21	27	0	2	29	0	0
23	31684244	.	A	G	1	1	2	0	1	3	0	0
23	31684299	.	T	G	3	0	3	0	19	22	0	0
23	31684352	.	G	A	13	17	30	0	2	32	0	0
23	31752717	.	A	G	1	4	5	0	0	5	0	0
23	31756210	.	G	A	1	9	10	0	0	10	0	0
23	31756216	.	C	T	0	8	8	0	2	10	0	0
23	31768596	.	T	C	3	3	6	0	0	6	0	0
23	31771282	.	T	C	1	2	3	0	1	4	0	0
23	31774194	.	G	A	6	2	8	0	0	8	0	0
23	31778174	.	A	G	1	2	3	0	0	3	0	0
23	31778183	.	C	T	0	2	2	0	1	3	0	0
23	31782969	.	T	C	0	0	0	0	1	1	0	0
23	31785175	.	G	A	9	6	15	0	1	16	0	0
23	31785183	.	T	G	10	6	16	0	0	16	0	0
23	31787127	.	C	G	0	1	1	0	0	1	0	0
23	31804162	.	A	G	3	2	5	0	0	5	0	0
23	31909338	.	T	A	2	0	2	0	0	2	0	0
23	31914316	.	C	T	1	0	1	0	0	1	0	0
23	31914667	.	T	C	1	1	2	0	0	2	0	0
23	31914675	.	G	A	1	1	2	0	0	2	0	0
23	31940681	.	C	A	3	2	5	0	1	6	0	0
23	31940818	.	C	T	2	2	4	0	0	4	0	0
23	31953228	.	A	T	1	3	4	0	0	4	0	0
23	31953501	.	A	G	4	3	7	0	0	7	0	0
23	31962648	.	A	T	3	5	8	0	0	8	0	0
23	31962650	.	T	C	2	4	6	0	2	8	0	0
23	31962971	.	T	C	8	5	13	0	0	13	0	0
23	31963226	.	C	T	4	11	15	0	2	17	0	0
23	31963360	.	A	G	3	4	7	0	0	7	0	0
23	31964680	.	C	T	4	6	10	0	0	10	0	0
23	31981951	.	A	C	4	2	6	0	0	6	0	0
23	31982041	.	T	C	1	3	4	0	0	4	0	0
23	31982042	.	C	T	1	3	4	0	0	4	0	0
23	31984871	.	C	T	2	2	4	0	0	4	0	0
23	31986705	.	T	G	2	0	2	0	2	4	0	0
23	31992375	.	T	C	0	3	3	0	0	3	0	0
23	31992522	.	T	C	4	3	7	0	0	7	0	0
23	31992537	.	C	T	4	2	6	0	0	6	0	0
23	31993590	.	C	T	0	1	1	0	0	1	0	0
23	31995113	.	G	A	0	0	0	0	2	2	0	0
23	31997582	.	G	A	6	6	12	0	0	12	0	0
23	31998162	.	T	C	3	3	6	0	0	6	0	0
23	31998741	.	A	G	2	0	2	0	2	4	0	0
23	32000336	.	G	C	3	3	6	0	0	6	0	0
23	32003354	.	T	A	6	11	17	0	0	17	0	0
23	32003808	.	T	C	4	9	13	0	0	13	0	0
23	32003820	.	G	T	1	8	9	0	0	9	0	0
23	32007376	.	T	G	5	2	7	0	0	7	0	0
23	32007445	.	T	A	4	9	13	0	0	13	0	0
23	32007520	.	T	C	5	4	9	0	0	9	0	0
23	32007526	.	C	G	5	4	9	0	0	9	0	0
23	32026927	.	T	C	2	2	4	0	0	4	0	0
23	32026978	.	C	T	1	5	6	0	1	7	0	0
23	32026996	.	G	A	1	3	4	0	1	5	0	0
23	32033105	.	A	C	0	1	1	0	0	1	0	0
23	32034328	.	G	A	0	1	1	0	1	2	0	0
23	32034342	.	G	A	1	1	2	0	0	2	0	0
23	32081708	.	C	T	7	4	11	0	0	11	0	0
23	32081717	.	T	C	7	4	11	0	0	11	0	0
23	32085908	.	G	T	1	5	6	0	0	6	0	0
23	32096873	.	C	T	0	4	4	0	4	8	0	0
23	32128848	.	A	T	2	2	4	0	0	4	0	0
23	32129476	.	G	T	8	6	14	0	0	14	0	0
23	32129514	.	G	T	5	6	11	0	0	11	0	0
23	32151669	.	A	C	16	13	29	0	0	29	0	0
23	32152022	.	C	T	11	16	27	0	0	27	0	0
23	32154021	.	G	T	5	3	8	0	0	8	0	0
23	32155325	.	A	G	4	3	7	0	0	7	0	0
23	32155719	.	C	T	8	5	13	0	1	14	0	0
23	32155720	.	C	T	0	5	5	0	9	14	0	0
23	32155864	.	A	C	4	1	5	0	2	7	0	0
23	32155975	.	C	T	4	3	7	0	2	9	0	0
23	32157787	.	G	T	1	3	4	0	0	4	0	0
23	32200071	.	A	G	4	3	7	0	0	7	0	0
23	32200076	.	T	G	4	3	7	0	0	7	0	0
23	32200114	.	A	C	4	2	6	0	0	6	0	0
23	32200482	.	T	C	2	4	6	0	0	6	0	0
23	32200689	.	G	A	1	2	3	0	0	3	0	0
23	32200979	.	A	G	8	6	14	0	0	14	0	0
23	32239474	.	A	G	6	2	8	0	0	8	0	0
23	32239824	.	G	A	12	9	21	0	2	23	0	0
23	32240290	.	A	G	8	3	11	0	2	13	0	0
23	32242086	.	C	A	4	4	8	0	0	8	0	0
23	32242251	.	T	C	5	6	11	0	1	12	0	0
23	32248595	.	C	G	2	3	5	0	0	5	0	0
23	32250286	.	C	T	0	1	1	0	1	2	0	0
23	32251473	.	T	G	0	1	1	0	0	1	0	0
23	32252805	.	A	G	1	1	2	0	0	2	0	0
23	32309187	.	T	C	13	10	23	0	0	23	0	0
23	32309193	.	G	A	13	10	23	0	0	23	0	0
23	32309323	.	G	A	8	16	24	0	0	25	1	0
23	32309533	.	A	G	16	11	27	0	0	27	0	0
23	32309659	.	C	A	1	9	10	0	11	21	0	0
23	32309709	.	G	A	14	8	22	0	0	22	0	0
23	32309846	.	T	A	5	3	8	0	1	9	0	0
23	32309860	.	C	T	4	3	7	0	0	7	0	0
23	32309943	.	A	G	4	2	6	0	1	7	0	0
23	32310148	.	G	T	2	3	5	0	0	5	0	0
23	32310151	.	G	A	2	3	5	0	0	5	0	0
23	32310209	.	C	T	6	6	12	0	0	12	0	0
23	32310288	.	T	A	3	2	5	0	0	5	0	0
23	32310943	.	T	C	3	3	6	0	0	6	0	0
23	32311418	.	T	C	8	7	15	0	0	15	0	0
23	32311555	.	G	C	17	15	32	0	1	33	0	0
23	32311612	.	G	A	25	12	37	0	1	38	0	0
23	32318047	.	A	G	19	13	32	0	1	33	0	0
23	32326532	.	A	G	3	4	7	0	0	7	0	0
23	32362317	.	A	G	3	1	4	0	0	4	0	0
23	32531948	.	T	C	1	2	3	0	0	3	0	0
23	32532018	.	T	G	1	2	3	0	0	3	0	0
23	32589398	.	C	T	2	2	4	0	0	4	0	0
23	32592331	.	A	G	4	7	11	0	0	11	0	0
23	32592581	.	T	A	1	6	7	0	0	7	0	0
23	32599214	.	G	T	2	1	3	0	0	3	0	0
23	32636197	.	G	A	2	3	5	0	0	5	0	0
23	32641956	.	C	T	0	1	1	0	1	2	0	0
23	32641959	.	G	A	0	3	3	0	0	3	0	0
23	32668999	.	A	G	3	3	6	0	0	6	0	0
23	32685487	.	C	A	2	5	7	0	0	7	0	0
23	32702864	.	C	T	0	2	2	0	3	5	0	0
23	32702993	.	C	T	0	3	3	0	0	3	0	0
23	33337995	.	A	G	0	2	2	0	0	2	0	0
23	33357260	.	T	G	5	2	7	0	0	7	0	0
23	33357856	.	A	C	3	2	5	0	0	5	0	0
23	33357953	.	T	A	4	2	6	0	0	6	0	0
23	33361256	.	C	T	0	7	7	0	5	12	0	0
23	33633592	.	T	C	2	2	4	0	0	4	0	0
23	33654452	.	T	C	2	0	2	0	2	4	0	0
23	33657431	.	T	A	12	10	22	0	1	23	0	0
23	33657460	.	C	T	16	11	27	0	0	27	0	0
23	33657467	.	T	A	17	12	29	0	1	30	0	0
23	33657714	.	T	G	6	8	14	0	0	14	0	0
23	33679494	.	G	T	4	2	6	0	0	6	0	0
23	33681816	.	C	T	1	2	3	0	0	3	0	0
23	33682045	.	A	T	5	3	8	0	0	8	0	0
23	33682416	.	T	A	3	5	8	0	0	8	0	0
23	33682442	.	C	A	4	2	6	0	0	6	0	0
23	33682736	.	A	G	5	3	8	0	1	9	0	0
23	33682740	.	A	T	6	2	8	0	0	8	0	0
23	33682780	.	C	T	2	2	4	0	0	4	0	0
23	33682992	.	T	A	3	4	7	0	0	7	0	0
23	33683092	.	T	G	3	8	11	0	0	11	0	0
23	33683299	.	T	A	1	3	4	0	0	4	0	0
23	33693482	.	G	A	2	1	3	0	0	3	0	0
23	33693572	.	T	C	0	2	2	0	0	2	0	0
23	33696938	.	C	G	2	0	2	0	0	2	0	0
23	33709937	.	G	A	1	3	4	0	0	4	0	0
23	33718699	.	T	C	26	19	45	0	2	47	0	0
23	33724825	.	G	A	2	19	21	0	24	45	0	0
23	33727916	.	C	T	21	15	36	0	0	36	0	0
23	33728398	.	A	T	12	15	27	0	4	31	0	0
23	33728518	.	T	C	18	20	38	0	0	38	0	0
23	33728609	.	A	T	24	19	43	0	2	45	0	0
23	33728877	.	T	A	18	26	44	0	0	44	0	0
23	33728994	.	T	A	19	5	24	0	0	24	0	0
23	33729231	.	T	A	4	5	9	0	0	9	0	0
23	33729510	.	A	G	23	18	41	0	1	42	0	0
23	33837975	.	C	T	0	1	1	0	0	1	0	0
23	33837983	.	A	G	0	0	0	0	1	1	0	0
23	33873137	.	T	A	0	2	2	0	0	2	0	0
23	33873187	.	C	G	1	4	5	0	0	5	0	0
23	33887839	.	C	T	1	0	1	0	0	1	0	0
23	33892021	.	C	T	2	7	9	0	0	9	0	0
23	33901271	.	C	T	3	12	15	1	0	16	0	0
23	33907969	.	C	A	11	10	21	0	3	24	0	0
23	33907990	.	A	G	11	0	11	0	13	24	0	0
23	33918162	.	C	T	20	17	37	0	0	37	0	0
23	33920287	.	G	A	13	11	24	0	2	26	0	0
23	33920311	.	A	G	17	16	33	0	1	34	0	0
23	33920344	.	C	T	16	9	25	0	1	26	0	0
23	33920431	.	C	T	1	3	4	0	0	4	0	0
23	33923716	.	A	G	8	1	9	0	5	14	0	0
23	33926555	.	C	A	2	3	5	0	0	5	0	0
23	33926663	.	C	T	22	28	50	0	2	52	0	0
23	33927045	.	C	T	27	23	50	0	2	52	0	0
23	33927244	.	G	A	0	22	22	0	12	34	0	0
23	33927500	.	T	A	17	9	26	0	0	26	0	0
23	33927897	.	T	G	22	21	43	0	3	46	0	0
23	33927941	.	C	T	18	28	46	0	3	49	0	0
23	33935471	.	C	G	6	8	14	0	0	14	0	0
23	33935549	.	C	T	3	2	5	0	1	6	0	0
23	33942036	.	C	T	1	3	4	0	0	4	0	0
23	33944059	.	G	A	11	10	21	0	0	21	0	0
23	33944188	.	C	T	3	15	18	0	0	18	0	0
23	33944295	.	T	G	4	6	10	0	0	10	0	0
23	33944336	.	A	T	7	8	15	0	0	15	0	0
23	33944337	.	G	A	6	8	14	0	1	15	0	0
23	33961746	.	A	G	9	3	12	0	0	12	0	0
23	33961885	.	C	G	2	1	3	0	1	4	0	0
23	33963655	.	G	T	1	3	4	0	0	4	0	0
23	33974392	.	T	C	4	5	9	0	0	9	0	0
23	33974659	.	C	A	9	13	22	0	0	22	0	0
23	33974662	.	A	T	8	14	22	0	1	23	0	0
23	33974827	.	A	T	11	23	34	0	0	34	0	0
23	33974904	.	T	A	9	13	22	0	2	24	0	0
23	33975854	.	T	A	16	8	24	0	2	26	0	0
23	33975994	.	G	A	0	3	3	0	1	4	0	0
23	33978028	.	T	G	5	4	9	0	3	12	0	0
23	33978049	.	A	T	7	5	12	0	0	12	0	0
23	33978125	.	A	C	2	5	7	0	0	7	0	0
23	33978462	.	T	A	16	13	29	0	2	31	0	0
23	33978469	.	C	T	14	15	29	0	1	30	0	0
23	33978577	.	C	T	4	8	12	0	0	12	0	0
23	33978639	.	G	T	5	8	13	0	0	13	0	0
23	33978671	.	T	A	12	8	20	0	2	22	0	0
23	33983333	.	G	C	4	6	10	0	0	10	0	0
23	33984364	.	G	A	3	10	13	0	0	13	0	0
23	33987467	.	T	G	11	7	18	0	1	19	0	0
23	33987637	.	C	T	6	5	11	0	0	11	0	0
23	33991132	.	G	A	5	2	7	0	0	7	0	0
23	33991460	.	A	G	0	2	2	0	1	3	0	0
23	33993191	.	T	C	1	2	3	0	1	4	0	0
23	34005089	.	G	T	6	9	15	0	0	15	0	0
23	34005095	.	T	C	5	5	10	0	3	13	0	0
23	34035241	.	G	T	7	0	7	0	0	7	0	0
23	34035295	.	G	A	10	11	21	0	0	21	0	0
23	34035364	.	C	T	0	1	1	0	1	2	0	0
23	34036432	.	A	G	1	2	3	0	0	3	0	0
23	34038436	.	C	T	16	16	32	0	1	33	0	0
23	34042998	.	C	T	20	19	39	0	0	39	0	0
23	34043308	.	G	T	20	20	40	0	0	40	0	0
23	34043335	.	G	A	0	26	26	0	17	43	0	0
23	34043423	.	G	A	19	20	39	0	0	39	0	0
23	34043536	.	T	C	8	16	24	0	1	25	0	0
23	34043596	.	T	C	6	5	11	0	0	11	0	0
23	34047440	.	G	A	0	8	8	0	0	8	0	0
23	34110634	.	C	T	1	1	2	0	0	2	0	0
23	34136467	.	C	T	12	9	21	0	0	21	0	0
23	34385435	.	C	T	1	2	3	0	1	4	0	0
23	34385720	.	G	A	3	7	10	0	0	10	0	0
23	34559971	.	C	T	0	4	4	0	0	4	0	0
23	34641484	.	C	T	3	2	5	0	1	6	0	0
23	34641505	.	G	A	0	2	2	0	4	6	0	0
23	34659533	.	C	T	2	0	2	0	0	2	0	0
23	34678957	.	G	T	4	4	8	0	0	8	0	0
23	34679008	.	A	G	7	6	13	0	1	14	0	0
23	34696631	.	C	T	5	5	10	0	0	10	0	0
23	34726384	.	A	G	3	0	3	0	7	10	0	0
23	34726387	.	A	G	4	6	10	0	2	12	0	0
23	34726438	.	T	C	6	6	12	0	0	12	0	0
23	34726444	.	G	T	5	6	11	0	1	12	0	0
23	34732871	.	A	G	4	0	4	0	3	7	0	0
23	34748833	.	G	A	0	5	5	0	9	14	0	0
23	34753803	.	A	G	15	15	30	0	0	30	0	0
23	35027248	.	A	G	1	2	3	0	0	3	0	0
23	35027386	.	T	G	4	3	7	0	0	7	0	0
23	35027480	.	T	G	3	2	5	0	0	5	0	0
23	35027736	.	C	G	10	3	13	0	0	13	0	0
23	35039803	.	C	T	0	3	3	0	0	3	0	0
23	35064271	.	T	G	1	3	4	0	0	4	0	0
23	35188562	.	G	A	3	3	6	0	0	6	0	0
23	35192619	.	A	G	2	3	5	0	0	5	0	0
23	35256186	.	G	A	3	4	7	0	0	7	0	0
23	35362951	.	C	T	13	5	18	0	0	18	0	0
23	35362973	.	G	T	8	3	11	0	0	11	0	0
23	35363024	.	A	T	6	6	12	0	1	13	0	0
23	35363067	.	A	T	10	3	13	0	3	16	0	0
23	35363106	.	G	A	13	7	20	0	1	21	0	0
23	35363111	.	C	G	11	8	19	0	1	20	0	0
23	35363226	.	T	C	17	0	17	0	15	32	0	0
23	35363341	.	A	G	17	5	22	0	2	24	0	0
23	35369733	.	G	A	5	4	9	0	0	9	0	0
23	35376893	.	A	G	3	0	3	0	0	3	0	0
23	35382971	.	C	T	3	0	3	0	0	3	0	0
23	35383037	.	C	T	1	1	2	0	0	2	0	0
23	35389118	.	C	T	2	2	4	0	0	4	0	0
23	35393459	.	A	G	2	2	4	0	0	4	0	0
23	35393473	.	G	T	0	2	2	0	0	2	0	0
23	35394053	.	G	C	1	0	1	0	0	1	0	0
23	35396735	.	C	A	2	2	4	0	1	5	0	0
23	35469479	.	A	G	4	7	11	0	1	12	0	0
23	35469668	.	G	T	10	5	15	0	1	16	0	0
23	35473640	.	A	G	3	1	4	0	0	4	0	0
23	35479283	.	A	C	0	1	1	0	0	1	0	0
23	35537599	.	G	A	5	12	17	0	1	18	0	0
23	35537617	.	G	A	5	6	11	0	3	14	0	0
23	35537693	.	A	C	3	2	5	0	0	5	0	0
23	35642195	.	C	T	5	4	9	0	0	9	0	0
23	35642327	.	T	G	4	6	10	0	1	11	0	0
23	35651790	.	T	C	1	1	2	0	0	2	0	0
23	35661380	.	C	T	2	5	7	0	0	7	0	0
23	35661530	.	T	C	6	5	11	0	2	13	0	0
23	35661549	.	A	C	5	5	10	0	0	10	0	0
23	35661572	.	A	C	2	4	6	0	1	7	0	0
23	35661660	.	T	G	6	0	6	0	4	10	0	0
23	35661692	.	C	A	5	6	11	0	0	11	0	0
23	35661723	.	A	C	3	4	7	0	0	7	0	0
23	35663421	.	T	G	7	3	10	0	1	11	0	0
23	35664298	.	A	G	1	3	4	0	1	5	0	0
23	35691989	.	G	A	0	0	0	2	0	2	0	0
23	35710179	.	A	C	22	17	39	1	0	40	0	0
23	37465414	.	G	A	2	13	15	0	0	15	0	0
23	37467056	.	A	G	6	0	6	0	6	12	0	0
23	37467073	.	A	G	5	6	11	0	0	11	0	0
23	37467109	.	A	G	7	0	7	0	7	14	0	0
23	37467115	.	A	G	7	0	7	0	8	15	0	0
23	39758994	.	T	C	6	4	10	0	0	10	0	0
23	39809185	.	G	A	3	4	7	1	0	8	0	0
23	39901425	.	A	G	3	1	4	0	0	4	0	0
23	40526760	.	G	A	9	9	18	0	0	18	0	0
23	40527632	.	G	A	2	7	9	0	0	9	0	0
23	40527993	.	A	C	6	2	8	0	1	9	0	0
23	40528019	.	C	T	5	5	10	0	0	10	0	0
23	40528059	.	T	C	3	2	5	0	0	5	0	0
23	40528064	.	G	A	1	1	2	0	1	3	0	0
23	40528267	.	T	C	5	3	8	0	2	10	0	0
23	40528389	.	T	C	2	0	2	0	4	6	0	0
23	40720200	.	T	C	3	3	6	0	0	6	0	0
23	40720216	.	G	A	0	4	4	0	4	8	0	0
23	40720324	.	G	A	0	4	4	0	1	5	0	0
23	40741765	.	C	T	3	4	7	0	0	7	0	0
23	40742067	.	G	A	0	2	2	0	4	6	0	0
23	40742133	.	G	C	10	9	19	0	0	19	0	0
23	40742234	.	C	A	10	6	16	0	0	16	0	0
23	40742236	.	G	C	6	10	16	0	0	16	0	0
23	40756296	.	A	C	0	1	1	0	0	1	0	0
23	40766470	.	C	T	2	5	7	0	0	7	0	0
23	40873218	.	T	A	3	5	8	0	0	8	0	0
23	40873232	.	A	T	3	6	9	0	0	9	0	0
23	40873613	.	T	G	1	3	4	0	0	4	0	0
23	40873902	.	C	T	0	2	2	0	1	3	0	0
23	40937583	.	G	T	0	1	1	0	0	1	0	0
23	40972121	.	G	A	0	2	2	0	0	2	0	0
23	40972205	.	A	T	2	5	7	0	0	7	0	0
23	40972208	.	C	T	3	2	5	0	1	6	0	0
23	40986765	.	G	A	0	1	1	0	0	1	0	0
23	40987369	.	G	A	0	1	1	0	0	1	0	0
23	41198801	.	C	T	0	2	2	0	0	2	0	0
23	42258973	.	G	A	0	3	3	0	1	4	0	0
23	42259236	.	G	A	0	1	1	0	4	5	0	0
23	42283476	.	A	G	11	3	14	0	0	14	0	0
23	42328175	.	A	G	1	0	1	0	3	4	0	0
23	42328184	.	T	C	1	3	4	0	0	4	0	0
23	42329868	.	C	T	1	2	3	0	0	3	0	0
23	42330063	.	C	T	1	2	3	0	0	3	0	0
23	42330090	.	C	G	2	2	4	0	0	4	0	0
23	42330213	.	A	T	1	3	4	0	0	4	0	0
23	42330254	.	A	G	2	2	4	0	0	4	0	0
23	42330268	.	T	G	2	2	4	0	0	4	0	0
23	42641781	.	A	G	1	7	8	0	0	8	0	0
23	43508198	.	A	G	2	0	2	0	2	4	0	0
23	43517458	.	A	G	2	0	2	0	0	2	0	0
23	43519354	.	C	G	1	3	4	0	0	4	0	0
23	43519571	.	C	G	1	2	3	0	1	4	0	0
23	43519579	.	T	C	1	3	4	0	0	4	0	0
23	43530699	.	A	G	1	3	4	0	0	4	0	0
23	43530703	.	T	C	1	3	4	0	0	4	0	0
23	43652306	.	G	C	2	3	5	0	0	5	0	0
23	43652590	.	T	C	3	1	4	0	1	5	0	0
23	43652831	.	G	C	4	3	7	0	0	7	0	0
23	43688291	.	T	C	2	5	7	0	0	7	0	0
23	43688409	.	A	T	1	3	4	0	1	5	0	0
23	43688805	.	C	T	2	7	9	0	0	9	0	0
23	43688810	.	T	C	2	7	9	0	0	9	0	0
23	43688852	.	C	G	3	5	8	0	0	8	0	0
23	43688959	.	C	G	4	2	6	0	0	6	0	0
23	43689621	.	C	G	4	0	4	0	6	10	0	0
23	43689675	.	T	C	2	2	4	0	0	4	0	0
23	43689729	.	G	A	0	2	2	0	0	2	0	0
23	43690361	.	T	C	2	2	4	0	0	4	0	0
23	43690394	.	A	G	3	3	6	0	0	6	0	0
23	43690490	.	A	G	4	3	7	0	0	7	0	0
23	43690622	.	G	C	3	8	11	0	0	11	0	0
23	43690625	.	T	G	4	9	13	0	0	13	0	0
23	43690715	.	T	C	4	2	6	0	2	8	0	0
23	43690762	.	C	A	4	3	7	0	0	7	0	0
23	43690913	.	T	G	4	2	6	0	0	6	0	0
23	43691515	.	C	T	1	2	3	0	0	3	0	0
23	43691528	.	C	T	1	2	3	0	0	3	0	0
23	43691770	.	T	C	2	4	6	0	1	7	0	0
23	43695927	.	C	A	0	4	4	0	6	11	1	0
23	43695956	.	C	T	2	9	11	0	4	15	0	0
23	43696355	.	G	A	9	16	25	0	0	25	0	0
23	43699846	.	A	G	5	18	23	0	0	23	0	0
23	43700064	.	T	C	5	0	5	0	11	16	0	0
23	43700082	.	C	G	8	13	21	0	0	21	0	0
23	43700114	.	G	A	4	7	11	0	0	11	0	0
23	43700121	.	G	A	3	6	9	0	0	9	0	0
23	43705961	.	G	T	6	13	19	0	1	20	0	0
23	43706003	.	A	G	5	29	34	0	1	35	0	0
23	43706102	.	T	G	8	14	22	0	0	22	0	0
23	43707165	.	C	T	2	5	7	0	0	7	0	0
23	43718042	.	C	A	3	6	9	0	1	10	0	0
23	43723615	.	G	A	3	1	4	0	0	4	0	0
23	43770583	.	C	A	12	6	18	0	1	19	0	0
23	43770667	.	A	G	6	1	7	0	8	15	0	0
23	43770682	.	T	C	9	7	16	0	2	18	0	0
23	43770715	.	C	T	4	8	12	0	2	14	0	0
23	43770832	.	T	C	5	3	8	0	1	9	0	0
23	43780214	.	C	T	1	6	7	0	0	7	0	0
23	43781781	.	C	T	2	5	7	0	0	7	0	0
23	43784985	.	C	T	8	10	18	0	1	19	0	0
23	43799463	.	T	C	5	4	9	0	0	9	0	0
23	43799542	.	G	C	3	2	5	0	0	5	0	0
23	43799634	.	A	G	2	0	2	0	3	5	0	0
23	43799699	.	T	C	1	2	3	0	1	4	0	0
23	43800594	.	C	T	1	3	4	0	0	4	0	0
23	43800621	.	G	C	0	2	2	0	1	3	0	0
23	43800684	.	G	A	0	4	4	0	1	5	0	0
23	43800701	.	T	C	1	4	5	0	0	5	0	0
23	43800723	.	G	A	0	5	5	0	1	6	0	0
23	43800747	.	A	C	0	4	4	0	0	4	0	0
23	43800912	.	C	T	2	4	6	0	0	6	0	0
23	43800968	.	T	G	1	3	4	0	1	5	0	0
23	43800983	.	G	A	1	2	3	0	0	3	0	0
23	43801018	.	A	G	0	0	0	0	2	2	0	0
23	43801090	.	A	C	3	4	7	0	0	7	0	0
23	43801284	.	C	G	1	2	3	0	3	6	0	0
23	43801635	.	A	G	1	0	1	0	2	3	0	0
23	43801687	.	C	T	1	3	4	0	0	4	0	0
23	43802049	.	C	T	2	4	6	0	0	6	0	0
23	43830408	.	C	T	1	2	3	0	0	3	0	0
23	43830412	.	T	C	0	1	1	0	1	2	0	0
23	43876103	.	C	A	2	3	5	0	0	5	0	0
23	43876109	.	T	A	2	3	5	0	0	5	0	0
23	43889641	.	T	C	1	1	2	0	1	3	0	0
23	43898075	.	C	T	0	1	1	0	0	1	0	0
23	43898097	.	A	C	0	4	4	0	0	4	0	0
23	43989294	.	C	T	1	3	4	0	1	5	0	0
23	44090326	.	T	A	5	4	9	0	0	9	0	0
23	44092839	.	T	A	4	2	6	0	0	6	0	0
23	44096060	.	A	G	14	0	14	0	14	28	0	0
23	44098511	.	A	G	4	6	10	0	0	10	0	0
23	44098517	.	C	T	3	6	9	0	0	9	0	0
23	44102199	.	G	T	0	3	3	0	0	3	0	0
23	44106540	.	C	T	26	23	49	0	1	50	0	0
23	44106591	.	G	C	22	21	43	0	3	46	0	0
23	44107138	.	C	T	9	14	23	0	4	27	0	0
23	44236361	.	G	T	4	8	12	0	0	12	0	0
23	44236388	.	A	T	3	5	8	0	1	9	0	0
23	44236561	.	G	A	1	2	3	0	0	3	0	0
23	44236673	.	C	T	6	5	11	0	1	12	0	0
23	44236939	.	G	A	0	6	6	0	4	10	0	0
23	44236946	.	C	T	2	6	8	0	1	9	0	0
23	44237029	.	T	C	4	2	6	0	0	6	0	0
23	44237030	.	A	G	4	0	4	0	2	6	0	0
23	44237158	.	A	C	8	6	14	0	0	14	0	0
23	44237416	.	T	C	8	6	14	0	1	15	0	0
23	44237531	.	G	T	12	10	22	0	0	22	0	0
23	44237611	.	G	C	0	11	11	0	16	27	0	0
23	44237701	.	C	A	10	14	24	0	0	24	0	0
23	44238125	.	G	T	9	9	18	0	0	18	0	0
23	44238186	.	C	T	9	9	18	0	0	18	0	0
23	44242535	.	A	C	2	3	5	0	0	5	0	0
23	44242608	.	T	C	13	11	24	0	0	24	0	0
23	44250638	.	A	G	3	1	4	0	10	14	0	0
23	44250702	.	C	A	3	9	12	0	0	12	0	0
23	44250736	.	C	T	14	5	19	0	0	19	0	0
23	44308088	.	G	A	2	5	7	0	2	9	0	0
23	44312611	.	G	A	0	6	6	0	2	8	0	0
23	44313190	.	G	C	0	3	3	0	0	4	1	0
23	44328488	.	G	A	3	1	4	0	0	4	0	0
23	44328557	.	C	T	10	4	14	0	1	15	0	0
23	44332614	.	C	T	11	25	36	0	1	37	0	0
23	44332617	.	C	T	24	12	36	0	1	37	0	0
23	44332675	.	C	T	17	9	26	0	3	29	0	0
23	44428067	.	A	C	14	9	23	0	2	25	0	0
23	44430544	.	C	T	7	7	14	0	1	15	0	0
23	44432608	.	C	T	1	1	2	0	0	2	0	0
23	44440489	.	C	T	7	15	22	0	0	22	0	0
23	44478131	.	A	G	3	4	7	0	0	7	0	0
23	44487465	.	C	G	0	4	4	0	1	5	0	0
23	44487521	.	A	G	4	0	4	0	0	4	0	0
23	44489428	.	A	C	1	0	1	0	0	1	0	0
23	44489449	.	C	T	0	1	1	0	0	1	0	0
23	44515717	.	C	T	1	2	3	0	0	3	0	0
23	44518177	.	T	G	1	3	4	0	0	4	0	0
23	44518479	.	G	A	1	5	6	0	0	6	0	0
23	44518668	.	A	T	2	4	6	0	0	6	0	0
23	44519149	.	A	T	1	3	4	0	0	4	0	0
23	44519180	.	C	T	1	3	4	0	0	4	0	0
23	44519381	.	T	G	2	0	2	0	4	6	0	0
23	44521264	.	A	T	10	3	13	0	1	14	0	0
23	44521330	.	A	G	10	8	18	0	0	18	0	0
23	44521495	.	G	A	2	7	9	0	0	9	0	0
23	44521516	.	A	C	2	7	9	0	0	9	0	0
23	44521676	.	C	T	1	0	1	0	0	1	0	0
23	44521721	.	T	G	0	3	3	0	0	3	0	0
23	44521725	.	G	C	0	2	2	0	1	3	0	0
23	44521841	.	G	T	0	3	3	0	2	5	0	0
23	44537383	.	G	A	1	3	4	0	0	4	0	0
23	44546116	.	G	A	4	2	6	0	0	6	0	0
23	44550446	.	G	A	8	8	16	0	0	16	0	0
23	44603710	.	T	C	1	4	5	0	0	5	0	0
23	44603912	.	G	A	8	3	11	0	1	12	0	0
23	44603990	.	C	G	5	6	11	0	0	11	0	0
23	44617600	.	T	C	0	2	2	0	0	2	0	0
23	44620750	.	C	T	1	0	1	0	0	1	0	0
23	44620911	.	C	T	3	1	4	0	0	4	0	0
23	44621684	.	C	A	6	1	7	0	0	7	0	0
23	44621690	.	C	A	3	1	4	0	0	4	0	0
23	44652697	.	T	G	5	1	6	0	0	6	0	0
23	44652702	.	T	A	1	4	5	0	1	6	0	0
23	44652877	.	A	G	5	6	11	0	0	11	0	0
23	44653259	.	A	T	5	7	12	0	1	13	0	0
23	44653647	.	A	G	2	0	2	0	6	8	0	0
23	44677247	.	C	A	0	2	2	0	0	2	0	0
23	44732976	.	G	A	26	24	50	0	4	54	0	0
23	44761680	.	G	C	24	20	44	0	3	47	0	0
23	44762190	.	T	C	23	35	58	0	0	58	0	0
23	44850211	.	A	T	2	1	3	0	0	3	0	0
23	44858352	.	T	G	1	1	2	0	0	2	0	0
23	44858858	.	C	T	1	2	3	0	0	3	0	0
23	44858903	.	G	A	1	0	1	0	1	2	0	0
23	44861891	.	T	A	1	3	4	0	0	4	0	0
23	44861899	.	A	G	1	3	4	0	0	4	0	0
23	44871834	.	A	G	0	1	1	0	0	1	0	0
23	44871837	.	T	A	0	1	1	0	0	1	0	0
23	44973321	.	G	T	1	5	6	0	1	7	0	0
23	44991467	.	T	A	3	4	7	0	0	7	0	0
23	44991476	.	T	C	2	0	2	0	3	5	0	0
23	44991504	.	A	G	1	0	1	0	0	1	0	0
23	44995892	.	C	G	4	4	8	0	0	8	0	0
23	44999663	.	A	C	2	4	6	0	0	6	0	0
23	45027911	.	C	T	14	11	25	0	2	27	0	0
23	45028191	.	T	C	29	21	50	0	2	52	0	0
23	45028248	.	C	T	16	8	24	0	2	26	0	0
23	45043654	.	G	A	8	6	14	0	0	14	0	0
23	45423043	.	G	A	5	2	7	0	1	8	0	0
23	46208578	.	T	G	18	14	32	0	2	34	0	0
23	46208611	.	T	G	20	19	39	1	2	42	0	0
23	46208718	.	G	A	25	21	46	0	2	48	0	0
23	46217045	.	C	A	6	3	9	0	0	9	0	0
24	20671	.	T	C	1	1	2	0	0	2	0	0
24	20740	.	C	G	2	0	2	0	4	6	0	0
24	24470	.	T	C	1	6	7	0	0	7	0	0
24	24473	.	C	T	2	6	8	0	0	8	0	0
24	26103	.	C	T	0	1	1	0	0	1	0	0
24	44306	.	C	T	3	4	7	0	0	7	0	0
24	86698	.	G	C	1	1	2	0	0	2	0	0
24	86722	.	G	C	1	1	2	0	0	2	0	0
24	91430	.	A	G	2	0	2	0	0	2	0	0
24	139014	.	A	G	0	0	0	0	3	3	0	0
24	145697	.	A	C	0	3	3	0	0	3	0	0
24	166969	.	T	G	0	7	7	0	2	9	0	0
24	167149	.	A	T	8	6	14	0	2	16	0	0
24	167177	.	A	G	3	3	6	0	0	6	0	0
24	174353	.	A	G	7	0	7	0	6	13	0	0
24	178693	.	G	A	7	7	14	0	1	15	0	0
24	184800	.	A	G	11	0	11	0	14	25	0	0
24	184818	.	C	T	7	8	15	0	0	15	0	0
24	187371	.	T	A	9	14	23	0	1	24	0	0
24	187414	.	T	A	9	9	18	0	1	19	0	0
24	187686	.	T	A	8	14	22	0	0	22	0	0
24	187811	.	A	T	10	9	19	0	0	19	0	0
24	187971	.	A	G	3	3	6	0	3	9	0	0
24	188155	.	C	G	8	8	16	0	0	16	0	0
24	188191	.	T	A	9	5	14	0	1	15	0	0
24	188199	.	A	G	11	5	16	0	1	17	0	0
24	188363	.	G	A	15	9	24	0	1	25	0	0
24	188382	.	G	A	0	13	13	0	12	25	0	0
24	188423	.	T	C	7	18	25	0	1	26	0	0
24	188425	.	A	T	7	18	25	0	1	26	0	0
24	188464	.	T	C	9	23	32	0	1	33	0	0
24	196679	.	G	A	5	7	12	0	1	13	0	0
24	197062	.	C	T	2	0	2	0	0	2	0	0
24	197072	.	C	T	0	0	0	0	2	2	0	0
24	788327	.	A	G	1	5	6	0	0	6	0	0
24	943020	.	T	A	0	1	1	0	0	1	0	0
24	945706	.	T	C	12	13	25	0	2	27	0	0
24	945841	.	T	G	8	3	11	0	2	13	0	0
24	947503	.	G	C	5	5	10	0	0	10	0	0
24	947518	.	C	T	1	4	5	0	4	9	0	0
24	947611	.	C	T	0	9	9	0	3	12	0	0
24	947680	.	T	C	14	1	15	0	6	21	0	0
24	947957	.	C	A	2	9	11	0	9	20	0	0
24	947984	.	G	C	8	13	21	0	1	22	0	0
24	948201	.	T	A	13	3	16	0	0	16	0	0
24	948360	.	A	G	8	3	11	0	2	13	0	0
24	948438	.	T	C	8	4	12	0	7	19	0	0
24	948466	.	C	G	4	7	11	0	7	18	0	0
24	948503	.	C	T	0	9	9	0	10	19	0	0
24	948565	.	T	C	8	4	12	0	7	19	0	0
24	948571	.	G	A	8	11	19	0	0	19	0	0
24	948806	.	G	A	8	12	20	0	1	21	0	0
24	948848	.	C	T	0	5	5	0	8	13	0	0
24	948868	.	T	C	4	7	11	0	1	12	0	0
24	985094	.	A	T	10	6	16	0	0	16	0	0
24	985266	.	G	T	10	3	13	0	2	15	0	0
24	985740	.	C	G	6	6	12	0	0	12	0	0
24	988373	.	A	C	4	0	4	0	7	12	1	0
24	994885	.	T	C	2	0	2	0	6	8	0	0
24	1000112	.	G	A	7	7	14	0	0	14	0	0
24	1002664	.	T	C	7	7	14	0	1	15	0	0
24	1002757	.	T	C	1	0	1	0	0	1	0	0
24	1003494	.	C	T	0	12	12	0	8	20	0	0
24	1003551	.	C	A	0	8	8	0	5	13	0	0
24	1009078	.	A	G	5	5	10	0	1	11	0	0
24	1009381	.	C	A	0	4	4	0	1	5	0	0
24	1009978	.	A	C	4	1	5	0	7	12	0	0
24	1010167	.	A	G	3	3	6	0	1	7	0	0
24	1010168	.	G	A	3	3	6	0	1	7	0	0
24	1011439	.	T	C	4	5	9	0	0	9	0	0
24	1012034	.	A	C	3	2	5	0	0	5	0	0
24	1012101	.	A	T	4	3	7	0	1	8	0	0
24	1012613	.	C	G	4	2	6	0	0	6	0	0
24	1013290	.	G	C	8	3	11	0	1	12	0	0
24	1013303	.	G	A	9	4	13	0	0	13	0	0
24	1013359	.	G	C	2	3	5	0	0	5	0	0
24	1013375	.	A	T	2	2	4	0	1	5	0	0
24	1013531	.	G	A	2	2	4	0	0	4	0	0
24	1013559	.	T	G	1	2	3	0	0	3	0	0
24	1013763	.	T	C	2	2	4	0	0	4	0	0
24	1014681	.	T	A	3	2	5	0	0	5	0	0
24	1015292	.	T	C	16	1	17	0	9	26	0	0
24	1018672	.	T	C	9	0	9	0	10	19	0	0
24	1110150	.	T	C	4	6	10	0	2	12	0	0
24	1110152	.	T	A	5	7	12	0	0	12	0	0
24	1110227	.	G	A	3	4	7	0	0	7	0	0
24	1110325	.	C	A	5	6	11	0	0	11	0	0
24	1110595	.	G	C	4	7	11	0	0	11	0	0
24	1110601	.	G	A	6	7	13	0	0	13	0	0
24	1110748	.	T	C	2	3	5	0	0	5	0	0
24	1111102	.	G	T	4	4	8	0	0	8	0	0
24	1111164	.	T	C	3	6	9	0	0	9	0	0
24	1111273	.	T	C	3	3	6	0	1	7	0	0
24	1111453	.	T	A	5	3	8	0	0	8	0	0
24	1111469	.	C	T	0	3	3	0	6	9	0	0
24	1111628	.	A	C	4	2	6	0	0	6	0	0
24	1111857	.	C	T	3	2	5	0	1	6	0	0
24	1112087	.	T	G	2	5	7	0	0	7	0	0
24	1112205	.	A	G	1	1	2	0	1	3	0	0
24	1112337	.	A	G	1	4	5	0	0	5	0	0
24	1112365	.	T	C	2	0	2	0	6	8	0	0
24	1119052	.	G	A	3	4	7	0	0	7	0	0
24	1129975	.	C	T	0	1	1	0	0	1	0	0
24	1163061	.	G	A	19	13	32	0	0	32	0	0
24	1166957	.	G	A	3	6	9	0	0	9	0	0
24	1166975	.	T	C	0	1	1	0	0	1	0	0
24	1167496	.	G	A	4	6	10	0	0	10	0	0
24	1167506	.	G	A	3	4	7	0	0	7	0	0
24	1169291	.	C	T	1	9	10	0	12	22	0	0
24	1177074	.	T	A	8	7	15	0	1	16	0	0
24	1185142	.	G	A	1	5	6	0	0	6	0	0
24	1185271	.	G	A	14	6	20	0	0	20	0	0
24	1203471	.	A	T	3	4	7	0	1	8	0	0
24	1203573	.	A	G	2	5	7	0	0	7	0	0
24	1221280	.	C	T	0	1	1	0	3	4	0	0
24	1229646	.	G	C	10	0	10	0	17	27	0	0
24	1229683	.	G	C	4	6	10	0	0	10	0	0
24	1236358	.	A	G	15	13	28	0	1	29	0	0
24	1301258	.	C	T	1	2	3	0	0	3	0	0
24	1303892	.	A	G	5	7	12	0	1	13	0	0
24	2284456	.	A	T	11	16	27	0	4	31	0	0
24	2284526	.	T	C	13	0	13	0	14	27	0	0
24	2284647	.	C	T	0	3	3	0	10	13	0	0
24	2290232	.	T	C	4	0	4	0	7	11	0	0
24	2297093	.	T	A	3	0	3	0	0	3	0	0
24	2297117	.	A	G	3	2	5	0	0	5	0	0
24	2303715	.	T	G	0	1	1	0	0	1	0	0
24	2303784	.	C	T	4	4	8	0	0	8	0	0
24	2307342	.	C	T	3	5	8	0	0	8	0	0
24	2308075	.	A	G	5	4	9	0	1	10	0	0
24	2308122	.	T	G	1	0	1	0	0	1	0	0
24	2322273	.	T	C	1	3	4	0	0	4	0	0
24	2322351	.	T	C	0	1	1	0	1	2	0	0
24	2322519	.	A	G	1	1	2	0	0	2	0	0
24	2324350	.	G	C	2	2	4	0	0	4	0	0
24	2324477	.	C	T	0	3	3	0	0	3	0	0
24	2324534	.	T	C	1	2	3	0	0	3	0	0
24	2327866	.	C	G	3	4	7	0	0	7	0	0
24	2327935	.	T	C	2	4	6	0	0	6	0	0
24	2330491	.	T	C	2	2	4	0	0	4	0	0
24	2331156	.	A	G	3	0	3	0	2	5	0	0
24	2331198	.	G	A	5	5	10	0	1	11	0	0
24	2331330	.	A	G	2	0	2	0	4	6	0	0
24	2331387	.	G	A	0	2	2	0	1	3	0	0
24	2334066	.	G	A	3	2	5	0	0	5	0	0
24	2334069	.	C	G	3	2	5	0	0	5	0	0
24	2340671	.	A	T	2	2	4	0	1	5	0	0
24	2346976	.	A	G	1	2	3	0	0	3	0	0
24	2346989	.	G	T	1	2	3	0	0	3	0	0
24	3470086	.	T	C	3	3	6	0	3	9	0	0
24	3470088	.	T	C	5	4	9	0	0	9	0	0
24	3470608	.	T	C	6	4	10	0	1	11	0	0
24	3471477	.	T	C	7	5	12	0	1	13	0	0
24	6011364	.	A	G	2	5	7	0	0	7	0	0
24	7535464	.	C	T	6	2	8	0	0	8	0	0
24	7826449	.	A	T	0	1	1	0	1	2	0	0
24	8857593	.	T	A	1	3	4	0	0	4	0	0
24	8861380	.	T	C	1	6	7	0	0	7	0	0
24	8861521	.	G	C	2	2	4	0	0	4	0	0
24	8906130	.	A	T	0	1	1	0	0	1	0	0
24	8979615	.	C	G	3	7	10	0	0	10	0	0
24	8979618	.	G	A	3	8	11	0	0	11	0	0
24	8979708	.	C	T	1	12	13	0	9	22	0	0
24	8979917	.	G	A	6	4	10	0	0	10	0	0
24	8979937	.	G	A	4	5	9	0	0	9	0	0
24	8980122	.	G	A	2	7	9	0	0	9	0	0
24	8999699	.	T	A	1	1	2	0	0	2	0	0
24	9162820	.	A	G	1	3	4	0	0	4	0	0
24	9163150	.	T	C	1	2	3	0	0	3	0	0
24	9163528	.	T	C	1	3	4	0	0	4	0	0
24	9260452	.	A	C	4	3	7	0	0	7	0	0
24	9269953	.	G	A	1	2	3	0	0	3	0	0
24	9270074	.	G	A	3	2	5	0	0	5	0	0
24	9288889	.	G	T	15	15	30	0	3	33	0	0
24	9293831	.	A	G	7	8	15	0	0	15	0	0
24	9298312	.	G	A	1	2	3	0	0	3	0	0
24	9298592	.	G	A	0	2	2	0	3	5	0	0
24	9298623	.	C	T	2	2	4	0	0	4	0	0
24	9298678	.	T	A	1	2	3	0	0	3	0	0
24	9298826	.	G	A	1	2	3	0	0	3	0	0
24	9673568	.	G	T	8	8	16	0	0	16	0	0
24	9676144	.	T	C	5	6	11	0	0	11	0	0
24	9683072	.	G	A	7	9	16	0	0	16	0	0
24	9683376	.	A	G	4	3	7	0	0	7	0	0
24	9689613	.	G	T	4	1	5	0	0	5	0	0
24	9702114	.	T	C	0	2	2	0	1	3	0	0
24	9702118	.	C	T	0	2	2	0	1	3	0	0
24	9706647	.	A	G	1	0	1	0	1	2	0	0
24	9706655	.	C	T	1	2	3	0	0	3	0	0
24	9706939	.	T	C	2	4	6	0	0	6	0	0
24	9706946	.	C	T	2	3	5	0	1	6	0	0
24	9707007	.	G	C	0	2	2	0	0	2	0	0
24	9717383	.	C	T	1	3	4	0	0	4	0	0
24	9723217	.	G	A	0	2	2	0	2	4	0	0
24	9723677	.	G	C	0	2	2	0	0	2	0	0
24	9725084	.	C	G	0	3	3	0	0	3	0	0
24	9726828	.	C	G	1	4	5	0	0	5	0	0
24	9729835	.	T	C	0	1	1	0	0	1	0	0
24	9730098	.	G	A	1	4	5	0	0	5	0	0
24	9732066	.	T	A	1	0	1	0	1	2	0	0
24	9732132	.	T	C	1	3	4	0	0	4	0	0
24	9744227	.	G	A	5	5	10	0	0	10	0	0
24	9744236	.	G	A	0	4	4	0	5	9	0	0
24	9746370	.	T	A	2	2	4	0	0	4	0	0
24	9865836	.	G	A	1	11	12	0	11	23	0	0
24	9866192	.	A	T	6	6	12	0	1	13	0	0
24	9866270	.	G	A	7	10	17	0	1	18	0	0
24	9866562	.	A	T	9	10	19	0	1	20	0	0
24	9866623	.	G	T	6	7	13	0	1	14	0	0
24	9866721	.	C	T	9	9	18	0	1	19	0	0
24	9867105	.	T	A	10	6	16	0	1	17	0	0
24	10270376	.	G	A	1	2	3	0	0	3	0	0
24	10303168	.	C	T	1	6	7	0	0	7	0	0
24	10309119	.	G	C	0	3	3	0	1	4	0	0
24	10309244	.	G	A	7	2	9	0	0	9	0	0
24	10309611	.	G	T	6	2	8	0	0	8	0	0
24	10314437	.	T	A	1	1	2	0	0	2	0	0
24	10319089	.	A	G	1	4	5	0	0	5	0	0
24	10319106	.	C	T	1	4	5	0	0	5	0	0
24	10319239	.	G	C	0	3	3	0	2	5	0	0
24	10319270	.	G	A	2	2	4	0	0	4	0	0
24	10319598	.	G	T	2	2	4	0	0	4	0	0
24	10319620	.	T	C	2	2	4	0	0	4	0	0
24	10344333	.	C	G	2	1	3	0	0	3	0	0
24	10349671	.	C	T	4	6	10	0	0	10	0	0
24	10349783	.	G	T	2	4	6	0	0	6	0	0
24	10349818	.	G	A	2	10	12	0	0	12	0	0
24	10349865	.	T	G	3	8	11	0	0	11	0	0
24	10349898	.	T	C	4	5	9	0	0	9	0	0
24	10350089	.	T	A	1	3	4	0	1	5	0	0
24	10356563	.	G	A	3	4	7	0	0	7	0	0
24	10356592	.	T	C	2	3	5	0	0	5	0	0
24	10393951	.	C	G	1	2	3	0	2	5	0	0
24	10393979	.	G	T	5	2	7	0	1	8	0	0
24	10393995	.	A	C	5	2	7	0	2	9	0	0
24	10394079	.	A	C	1	4	5	0	0	5	0	0
24	10414439	.	G	T	1	6	7	0	4	11	0	0
24	10415193	.	A	G	4	14	18	0	1	19	0	0
24	10415424	.	A	C	5	8	13	0	1	14	0	0
24	10415487	.	G	A	1	9	10	0	8	18	0	0
24	10415827	.	T	G	1	2	3	0	1	4	0	0
24	10828512	.	A	G	0	1	1	0	0	1	0	0
24	10897254	.	G	A	1	1	2	0	0	2	0	0
24	10901467	.	A	C	5	3	8	0	0	8	0	0
24	10901696	.	C	G	26	27	53	0	0	54	1	0
24	10901759	.	G	T	20	20	40	0	1	41	0	0
24	10901946	.	C	T	10	11	21	0	2	23	0	0
24	10902065	.	T	G	13	11	24	0	3	27	0	0
24	10902268	.	G	A	11	6	17	0	1	18	0	0
24	10902688	.	G	A	17	14	31	0	2	33	0	0
24	10907000	.	T	C	4	4	8	0	0	8	0	0
24	10907473	.	C	T	17	17	34	0	5	39	0	0
24	10907587	.	G	T	6	5	11	0	1	12	0	0
24	10915813	.	A	G	1	0	1	0	0	1	0	0
24	10917040	.	C	T	2	7	9	0	0	9	0	0
24	10917046	.	C	T	0	7	7	0	3	10	0	0
24	10917238	.	C	T	1	4	5	0	0	5	0	0
24	10919519	.	A	G	8	4	12	0	0	12	0	0
24	10919563	.	G	T	5	1	6	0	1	7	0	0
24	10924880	.	C	T	7	11	18	0	2	20	0	0
24	10924912	.	C	T	5	10	15	0	0	15	0	0
24	10924930	.	T	A	3	6	9	0	0	9	0	0
24	10944579	.	T	A	0	3	3	0	0	3	0	0
24	12799196	.	C	T	0	0	0	0	1	1	0	0
24	14442357	.	C	G	2	0	2	0	3	5	0	0
24	14442510	.	C	T	5	2	7	0	0	7	0	0
24	17020761	.	T	A	0	4	4	0	0	4	0	0
24	17020764	.	A	T	0	4	4	0	0	4	0	0
24	17214629	.	T	C	15	10	25	1	1	27	0	0
24	17418588	.	T	C	8	2	10	0	0	10	0	0
24	17419198	.	G	A	1	2	3	0	0	3	0	0
24	18521384	.	T	A	6	3	9	0	0	9	0	0
24	18684818	.	C	T	1	6	7	0	0	7	0	0
24	19373816	.	A	T	0	1	1	0	1	2	0	0
24	19402231	.	G	A	0	6	6	0	2	8	0	0
24	19656939	.	G	A	0	3	3	0	1	4	0	0
24	19692822	.	C	A	1	2	3	0	0	3	0	0
24	19692828	.	G	A	0	2	2	0	0	2	0	0
24	19696728	.	G	A	0	3	3	0	0	3	0	0
24	19696794	.	C	G	3	5	8	0	0	8	0	0
24	19697387	.	A	G	3	3	6	0	1	7	0	0
24	19707838	.	G	A	9	18	27	0	0	27	0	0
24	19711576	.	G	T	9	13	22	0	0	23	1	0
24	19719122	.	G	A	10	16	26	0	1	27	0	0
24	19719189	.	G	T	5	8	13	0	1	14	0	0
24	20064232	.	G	A	13	6	19	0	0	19	0	0
24	20064504	.	G	A	2	3	5	0	2	7	0	0
24	20064967	.	T	C	5	2	7	0	1	8	0	0
24	20064988	.	A	C	6	3	9	0	0	9	0	0
24	20065553	.	C	T	4	3	7	0	0	7	0	0
24	20066111	.	G	T	5	2	7	0	1	8	0	0
24	20066116	.	T	C	5	3	8	0	0	8	0	0
24	20072399	.	G	A	1	1	2	0	0	2	0	0
24	20072405	.	G	A	1	1	2	0	0	2	0	0
24	20082881	.	T	C	1	4	5	0	0	5	0	0
24	20082944	.	G	A	0	0	0	0	1	1	0	0
24	20194475	.	A	G	0	1	1	0	0	1	0	0
24	20200528	.	A	G	1	0	1	0	2	3	0	0
24	20200540	.	T	C	2	1	3	0	1	4	0	0
24	20208353	.	A	G	4	8	12	0	0	12	0	0
24	20214496	.	T	C	2	4	6	0	0	6	0	0
24	20320628	.	T	G	2	2	4	0	0	4	0	0
24	20325475	.	G	A	0	2	2	0	2	4	0	0
24	20325754	.	G	A	1	1	2	0	1	3	0	0
24	20328567	.	G	C	0	3	3	0	0	3	0	0
24	20328609	.	G	A	0	1	1	0	0	1	0	0
24	20336686	.	T	C	1	2	3	0	0	3	0	0
24	20341318	.	C	A	0	1	1	0	0	1	0	0
24	20450191	.	A	G	12	10	22	0	0	22	0	0
24	20450270	.	G	C	6	4	10	0	0	10	0	0
24	20450417	.	C	G	6	6	12	0	0	12	0	0
24	20450467	.	C	G	3	13	16	0	0	16	0	0
24	20450672	.	C	G	8	9	17	0	0	17	0	0
24	20450843	.	A	C	7	0	7	0	10	18	1	0
24	20470788	.	A	G	5	3	8	0	0	8	0	0
24	20531566	.	C	T	7	8	15	0	1	16	0	0
24	20531692	.	C	A	9	7	16	0	0	16	0	0
24	20537515	.	A	T	3	7	10	0	0	10	0	0
24	20537554	.	C	A	1	2	3	0	0	3	0	0
24	20541421	.	C	T	1	0	1	0	0	1	0	0
24	20542972	.	T	C	3	4	7	0	0	7	0	0
24	20554857	.	G	T	9	5	14	0	2	16	0	0
24	20554858	.	T	G	10	6	16	0	0	16	0	0
24	20589791	.	G	A	7	5	12	0	0	12	0	0
24	20591775	.	G	A	2	3	5	0	0	5	0	0
24	20644356	.	C	T	4	6	10	0	1	11	0	0
24	20645858	.	A	T	17	18	35	0	1	36	0	0
24	20646694	.	G	A	8	13	21	0	0	21	0	0
24	20647423	.	G	T	10	10	20	0	2	22	0	0
24	20648945	.	T	C	2	4	6	0	0	6	0	0
24	20649013	.	T	C	7	11	18	0	1	19	0	0
24	20658421	.	T	G	0	3	3	0	0	3	0	0
24	20658427	.	T	A	0	3	3	0	0	3	0	0
24	20708388	.	A	G	2	2	4	0	0	4	0	0
24	20717280	.	A	G	0	2	2	0	0	2	0	0
24	20893161	.	C	T	1	4	5	0	0	5	0	0
24	20893389	.	A	G	8	3	11	0	1	12	0	0
24	20895293	.	T	A	3	2	5	0	0	5	0	0
24	20895308	.	A	G	3	2	5	0	0	5	0	0
24	20898334	.	T	C	3	3	6	0	0	6	0	0
24	20898363	.	A	G	1	3	4	0	0	4	0	0
24	20898402	.	A	G	1	2	3	0	0	3	0	0
24	20898439	.	G	T	1	4	5	0	0	5	0	0
24	20898485	.	G	A	3	5	8	0	0	8	0	0
24	20900142	.	A	G	2	2	4	0	0	4	0	0
24	20900182	.	T	C	1	0	1	0	1	2	0	0
24	20902081	.	G	A	1	2	3	0	0	3	0	0
24	20902184	.	C	T	1	1	2	0	1	3	0	0
24	20902188	.	C	T	0	3	3	0	1	4	0	0
24	20903313	.	T	C	2	0	2	0	2	4	0	0
24	20908035	.	A	C	3	0	3	0	2	5	0	0
24	20908042	.	A	T	2	2	4	0	0	4	0	0
24	20908081	.	C	T	1	1	2	0	1	3	0	0
24	20908083	.	G	A	1	2	3	0	0	3	0	0
24	20913145	.	G	A	0	2	2	0	0	2	0	0
24	20913316	.	G	A	0	3	3	1	0	4	0	0
24	20913353	.	A	G	0	4	4	0	0	4	0	0
24	20913362	.	C	T	0	3	3	0	0	3	0	0
24	20916874	.	A	T	0	3	3	0	0	3	0	0
24	20917017	.	T	C	0	2	2	0	0	2	0	0
24	20917029	.	T	C	0	0	0	0	2	2	0	0
24	20918385	.	C	A	3	0	3	0	0	3	0	0
24	20918394	.	T	A	2	0	2	0	1	3	0	0
24	20921565	.	C	A	3	7	10	0	1	11	0	0
24	20921615	.	A	G	5	5	10	0	0	10	0	0
24	20921645	.	A	G	4	3	7	0	0	7	0	0
24	20922783	.	G	A	2	1	3	0	0	3	0	0
24	20934223	.	C	T	3	8	11	0	0	11	0	0
24	20941605	.	A	G	9	12	21	0	0	21	0	0
24	20941687	.	A	G	12	19	31	0	3	34	0	0
24	20941789	.	A	G	15	21	36	0	3	39	0	0
24	20942281	.	G	A	14	14	28	0	1	29	0	0
24	20942341	.	G	A	1	2	3	0	3	6	0	0
24	20942541	.	G	T	20	15	35	0	3	38	0	0
24	20946263	.	G	A	3	3	6	0	0	6	0	0
24	20946305	.	C	T	13	12	25	0	0	25	0	0
24	20948122	.	C	T	12	12	24	0	1	25	0	0
24	20948330	.	G	A	0	1	1	0	0	1	0	0
24	20949494	.	A	G	16	16	32	0	2	34	0	0
24	20953045	.	C	T	3	2	5	0	0	5	0	0
24	20969385	.	C	T	0	1	1	0	0	1	0	0
24	20969491	.	G	A	0	2	2	0	4	6	0	0
24	20969536	.	T	C	2	2	4	0	0	4	0	0
24	20969650	.	A	G	0	0	0	0	4	4	0	0
24	20980039	.	A	G	1	0	1	0	1	2	0	0
24	20980141	.	A	G	6	8	14	0	0	14	0	0
24	20980197	.	C	T	0	2	2	0	0	2	0	0
24	20987865	.	A	G	4	2	6	0	0	6	0	0
24	21005729	.	A	G	4	10	14	0	0	14	0	0
24	21005908	.	A	T	5	3	8	0	0	8	0	0
24	21005973	.	A	T	7	9	16	0	4	20	0	0
24	21060253	.	A	T	1	2	3	0	0	3	0	0
24	21154415	.	A	G	17	21	38	0	0	38	0	0
24	21154421	.	A	T	14	21	35	0	1	36	0	0
24	21154707	.	A	G	14	26	40	0	3	43	0	0
24	21157661	.	G	A	5	5	10	0	0	10	0	0
24	21159814	.	A	G	25	15	40	0	1	41	0	0
24	21161459	.	C	T	1	12	13	0	8	21	0	0
24	21167389	.	A	G	5	3	8	0	0	8	0	0
24	21167443	.	G	A	19	17	36	0	1	37	0	0
24	21167446	.	G	A	20	16	36	0	2	38	0	0
24	21167660	.	G	A	9	8	17	0	2	19	0	0
24	21168638	.	G	A	13	9	22	0	2	24	0	0
24	21172062	.	G	A	2	3	5	0	0	5	0	0
24	21177180	.	T	C	1	0	1	0	0	1	0	0
24	21182156	.	A	G	5	3	8	0	0	8	0	0
24	21182444	.	A	G	3	13	16	0	0	16	0	0
24	21182642	.	G	A	14	15	29	0	1	30	0	0
24	21182783	.	C	T	6	22	28	0	1	29	0	0
24	21183047	.	A	C	6	8	14	0	1	15	0	0
24	21183181	.	C	T	11	10	21	0	0	21	0	0
24	21183228	.	C	G	15	13	28	0	1	29	0	0
24	21183290	.	A	C	12	18	30	0	1	31	0	0
24	21183467	.	T	C	5	6	11	0	0	11	0	0
24	21196410	.	A	G	4	3	7	0	0	7	0	0
24	21196446	.	T	G	2	5	7	0	0	7	0	0
24	21196637	.	T	A	2	2	4	0	0	4	0	0
24	21197665	.	T	G	1	2	3	0	0	3	0	0
24	21198192	.	A	G	3	4	7	0	0	7	0	0
24	21198226	.	G	T	2	5	7	0	0	7	0	0
24	21198611	.	A	G	3	1	4	0	3	7	0	0
24	21199460	.	C	T	1	3	4	0	0	4	0	0
24	21200926	.	C	T	3	3	6	0	1	7	0	0
24	21200953	.	C	G	3	6	9	0	0	9	0	0
24	21201380	.	T	C	10	10	20	0	0	20	0	0
24	21201500	.	G	T	2	7	9	0	17	26	0	0
24	21201506	.	T	C	16	7	23	0	1	24	0	0
24	21201830	.	A	T	9	11	20	0	0	20	0	0
24	21202067	.	G	T	4	2	6	0	0	6	0	0
24	21202203	.	A	G	1	7	8	0	1	9	0	0
24	21202225	.	C	T	4	3	7	0	0	7	0	0
24	21206347	.	T	A	1	2	3	0	0	3	0	0
24	21206352	.	G	T	1	2	3	0	0	3	0	0
24	21206903	.	T	A	4	4	8	0	0	8	0	0
24	21207571	.	G	C	2	0	2	0	0	2	0	0
24	21210728	.	G	T	1	2	3	0	0	3	0	0
24	21212663	.	A	G	1	2	3	0	0	3	0	0
24	21240661	.	T	C	1	2	3	0	0	3	0	0
24	21371848	.	T	C	19	0	19	0	28	47	0	0
24	21382737	.	C	A	4	4	8	0	0	8	0	0
24	21392168	.	T	C	3	1	4	0	0	4	0	0
24	21392258	.	T	C	3	4	7	0	0	7	0	0
24	21411514	.	G	A	8	6	14	0	0	14	0	0
24	21411834	.	G	T	7	8	15	0	0	15	0	0
24	21417797	.	C	T	1	12	13	0	16	29	0	0
24	21438161	.	G	A	9	7	16	0	0	16	0	0
24	21442815	.	A	G	5	4	9	0	0	9	0	0
24	21450130	.	C	T	8	4	12	0	0	12	0	0
24	21462810	.	A	G	3	2	5	0	0	5	0	0
24	21469067	.	T	G	4	4	8	0	0	8	0	0
24	21469157	.	T	C	8	0	8	0	7	15	0	0
24	21470795	.	G	C	5	0	5	0	3	8	0	0
24	21470892	.	A	C	4	4	8	0	1	9	0	0
24	21501990	.	C	G	1	5	6	0	0	6	0	0
24	21502133	.	T	C	8	0	8	0	3	11	0	0
24	21502305	.	A	G	12	6	18	0	1	19	0	0
24	21502973	.	G	A	7	8	15	0	0	15	0	0
24	21503043	.	G	T	12	10	22	0	0	22	0	0
24	21503350	.	C	T	3	3	6	0	0	6	0	0
24	21503766	.	T	C	6	0	6	0	4	10	0	0
24	21504169	.	T	G	2	4	6	0	0	6	0	0
24	21504467	.	A	G	12	2	14	0	1	15	0	0
24	21504746	.	C	T	0	7	7	0	10	17	0	0
24	21504785	.	A	G	6	11	17	0	1	18	0	0
24	21504860	.	G	T	6	7	13	0	1	14	0	0
24	21505178	.	A	C	8	12	20	0	2	22	0	0
24	21505255	.	T	G	7	4	11	0	0	11	0	0
24	21505446	.	A	T	3	4	7	0	0	7	0	0
24	21505895	.	A	G	5	8	13	0	0	13	0	0
24	21507501	.	A	G	2	0	2	0	0	2	0	0
24	21514386	.	T	A	6	11	17	0	0	17	0	0
24	21514437	.	T	C	4	9	13	0	2	15	0	0
24	21538430	.	C	T	10	10	20	0	2	22	0	0
24	21538441	.	T	G	10	0	10	0	9	19	0	0
24	21538568	.	A	C	10	10	20	0	0	20	0	0
24	21538982	.	T	A	10	11	21	0	1	22	0	0
24	21561074	.	C	T	2	0	2	0	0	2	0	0
24	21567672	.	C	T	3	2	5	0	0	5	0	0
24	21568808	.	T	A	7	6	13	0	0	13	0	0
24	21572604	.	G	T	7	7	14	0	0	14	0	0
24	21575273	.	T	A	1	1	2	0	0	2	0	0
24	21575311	.	G	C	6	8	14	0	0	14	0	0
24	21575372	.	G	A	14	9	23	0	0	23	0	0
24	21577239	.	G	A	0	0	0	0	1	1	0	0
24	21577450	.	C	G	5	7	12	0	0	12	0	0
24	21577620	.	T	G	0	2	2	0	0	2	0	0
24	21578174	.	C	G	4	2	6	0	0	6	0	0
24	21584115	.	T	C	9	7	16	0	1	17	0	0
24	21584116	.	A	C	10	7	17	0	0	17	0	0
24	21584231	.	T	A	5	4	9	0	0	9	0	0
24	21585307	.	A	G	4	2	6	0	0	6	0	0
24	21585802	.	G	A	3	5	8	0	1	9	0	0
24	21586020	.	C	T	3	4	7	0	0	7	0	0
24	21586189	.	G	A	4	4	8	0	0	8	0	0
24	21586190	.	C	A	4	4	8	0	0	8	0	0
24	21586229	.	G	A	3	5	8	0	0	8	0	0
24	21587309	.	T	G	2	2	4	0	0	4	0	0
24	21646704	.	G	T	28	20	48	0	2	50	0	0
24	21646808	.	G	A	7	21	28	0	0	28	0	0
24	21646847	.	A	C	1	6	7	0	0	7	0	0
24	21650088	.	G	A	16	16	32	0	0	33	1	0
24	21657738	.	T	C	11	0	11	0	19	30	0	0
24	21659864	.	A	T	5	2	7	0	0	7	0	0
24	21659873	.	A	G	2	1	3	0	0	3	0	0
24	21724424	.	C	T	0	1	1	0	0	1	0	0
24	21729346	.	C	T	4	3	7	0	0	7	0	0
24	21744239	.	G	A	0	4	4	0	3	7	0	0
24	21744266	.	A	G	2	2	4	0	0	4	0	0
24	21747672	.	G	A	0	5	5	0	6	11	0	0
24	21748175	.	A	G	9	9	18	0	0	18	0	0
24	21748249	.	T	C	14	13	27	0	2	29	0	0
24	21750867	.	A	G	1	2	3	0	0	3	0	0
24	21751022	.	T	G	1	2	3	0	0	3	0	0
24	21780981	.	A	G	2	3	5	0	0	5	0	0
24	21781146	.	A	G	3	5	8	0	0	8	0	0
24	21781451	.	T	G	11	4	15	0	1	16	0	0
24	21788194	.	C	T	1	1	2	0	0	2	0	0
24	21917704	.	G	C	4	6	10	0	0	10	0	0
24	21917745	.	T	G	4	11	15	0	0	15	0	0
24	21920915	.	A	G	3	7	10	0	0	10	0	0
24	21920918	.	T	G	2	6	8	0	1	9	0	0
24	21921104	.	T	C	3	3	6	0	0	6	0	0
24	21927434	.	G	A	1	1	2	0	1	3	0	0
24	21927503	.	A	G	3	3	6	0	1	7	0	0
24	21927506	.	A	G	4	4	8	0	0	8	0	0
24	21929107	.	T	C	0	0	0	0	1	1	0	0
24	21960044	.	C	A	1	3	4	0	0	4	0	0
24	21960098	.	T	A	2	5	7	0	0	7	0	0
24	21960130	.	C	T	0	3	3	0	0	3	0	0
24	21960293	.	C	T	7	8	15	0	1	16	0	0
24	21960299	.	G	A	9	7	16	0	0	16	0	0
24	21960445	.	A	T	4	9	13	0	0	13	0	0
24	21960598	.	T	A	5	4	9	0	0	9	0	0
24	21960609	.	T	C	3	5	8	0	2	10	0	0
24	21960930	.	C	T	5	7	12	0	0	12	0	0
24	21968103	.	A	G	1	1	2	0	0	2	0	0
24	21978531	.	A	G	8	12	20	0	1	21	0	0
24	21978593	.	T	C	9	2	11	0	15	26	0	0
24	21978647	.	C	G	7	14	21	0	1	22	0	0
24	21978733	.	C	T	18	14	32	0	2	34	0	0
24	21978790	.	T	C	15	19	34	0	0	35	1	0
24	21984192	.	C	A	0	1	1	0	0	1	0	0
24	21984256	.	C	A	0	8	8	0	5	13	0	0
24	21986826	.	C	G	1	1	2	0	0	2	0	0
24	22070389	.	T	A	2	4	6	0	0	6	0	0
24	22071146	.	G	C	3	3	6	0	0	6	0	0
24	22071183	.	C	T	1	3	4	0	0	4	0	0
24	22071185	.	C	A	1	3	4	0	0	4	0	0
24	22071556	.	G	C	9	1	10	0	17	27	0	0
24	22071644	.	G	T	17	16	33	0	3	36	0	0
24	22071649	.	G	T	20	14	34	0	3	37	0	0
24	22100861	.	G	C	5	6	11	0	0	11	0	0
24	22122826	.	A	C	13	2	15	0	2	18	1	0
24	22122922	.	C	T	2	12	14	0	10	24	0	0
24	22123784	.	T	A	13	19	32	0	2	34	0	0
24	22123927	.	A	C	13	0	13	0	16	29	0	0
24	22123930	.	G	T	16	12	28	0	1	29	0	0
24	22124020	.	G	A	11	10	21	0	0	21	0	0
24	22442301	.	T	C	0	0	0	0	3	3	0	0
24	22442349	.	T	C	0	1	1	0	0	1	0	0
24	22533940	.	T	C	0	1	1	0	0	1	0	0
24	22650131	.	T	C	0	0	0	0	1	1	0	0
24	22650143	.	G	A	1	1	2	0	0	2	0	0
24	22740589	.	T	C	5	5	10	0	1	11	0	0
24	22740772	.	T	A	19	6	25	0	0	25	0	0
24	22744487	.	C	T	9	2	11	0	0	11	0	0
24	22744502	.	A	G	1	7	8	0	1	9	0	0
24	22746843	.	T	G	4	5	9	0	0	9	0	0
24	22759703	.	C	T	15	17	32	0	2	34	0	0
24	22769484	.	C	T	3	8	11	0	0	11	0	0
24	23213411	.	C	A	2	3	5	0	0	5	0	0
24	23213886	.	G	A	0	2	2	0	1	3	0	0
24	23243257	.	A	G	0	4	4	0	0	4	0	0
24	23244265	.	G	A	1	13	14	0	3	17	0	0
24	23250116	.	T	A	4	7	11	0	0	11	0	0
24	23300755	.	A	G	1	5	6	0	0	6	0	0
24	23302371	.	A	G	2	7	9	0	0	9	0	0
24	23302441	.	A	G	1	2	3	0	0	3	0	0
24	23687836	.	C	T	0	2	2	0	0	2	0	0
24	23708870	.	G	A	1	2	3	0	0	3	0	0
24	23716060	.	G	T	2	2	4	0	0	4	0	0
24	23717064	.	C	G	9	9	18	0	0	18	0	0
24	23720091	.	G	A	8	7	15	0	0	15	0	0
24	23723983	.	G	A	4	4	8	0	1	9	0	0
24	23758880	.	A	C	4	5	9	0	0	9	0	0
24	23759679	.	G	A	9	5	14	0	1	15	0	0
24	23766841	.	G	A	5	0	5	0	0	5	0	0
24	23768788	.	G	A	3	7	10	0	0	10	0	0
24	23784555	.	T	A	1	2	3	0	1	4	0	0
24	23784647	.	G	A	4	13	17	0	0	17	0	0
24	23838535	.	T	A	1	3	4	0	0	4	0	0
24	23839024	.	T	C	8	8	16	0	1	17	0	0
24	23839088	.	C	T	4	6	10	0	0	10	0	0
24	23839600	.	A	G	10	6	16	0	0	16	0	0
24	23839644	.	T	C	1	3	4	0	0	4	0	0
24	23841963	.	T	C	0	1	1	0	0	1	0	0
24	23937985	.	C	T	7	7	14	0	1	15	0	0
24	23941618	.	G	T	4	8	12	0	0	12	0	0
24	23942642	.	G	A	7	2	9	0	0	9	0	0
24	23971063	.	C	T	1	2	3	0	0	3	0	0
24	23971151	.	C	G	10	15	25	0	0	25	0	0
24	23971205	.	T	C	2	6	8	0	0	8	0	0
24	23972311	.	T	G	0	2	2	0	0	2	0	0
24	23974411	.	C	T	28	26	54	0	1	55	0	0
24	23974484	.	C	T	0	20	20	0	16	36	0	0
24	23974526	.	T	A	1	2	3	0	0	3	0	0
24	23989380	.	T	A	1	3	4	0	0	4	0	0
24	24014987	.	C	A	2	3	5	0	1	6	0	0
24	24020314	.	C	T	1	0	1	0	0	1	0	0
24	24027939	.	A	G	6	9	15	0	0	15	0	0
24	24028016	.	C	T	12	11	23	0	0	23	0	0
24	24028032	.	G	C	10	6	16	0	0	16	0	0
24	24028059	.	T	A	12	6	18	0	0	18	0	0
24	24102026	.	C	T	1	4	5	0	9	14	0	0
24	24102091	.	T	C	18	0	18	0	20	38	0	0
24	24102190	.	A	T	19	14	33	0	0	33	0	0
24	24102318	.	A	C	24	15	39	0	1	40	0	0
24	24108653	.	T	C	12	5	17	0	0	17	0	0
24	24111587	.	G	T	0	1	1	0	1	2	0	0
24	24114321	.	C	T	18	18	36	0	0	36	0	0
24	24114744	.	G	A	12	11	23	0	1	24	0	0
24	24115352	.	T	G	8	12	20	0	1	21	0	0
24	24115485	.	C	G	0	13	13	0	9	22	0	0
24	24115602	.	A	G	8	11	19	0	0	19	0	0
24	24115626	.	G	T	10	8	18	0	1	19	0	0
24	24118213	.	A	C	1	0	1	0	0	1	0	0
24	24118272	.	A	G	5	2	7	0	0	7	0	0
24	24118316	.	A	G	11	4	15	0	0	15	0	0
24	24118362	.	C	T	11	3	14	0	0	14	0	0
24	24118366	.	A	T	10	2	12	0	1	14	1	0
24	24119362	.	C	T	3	1	4	0	0	4	0	0
24	24119611	.	C	A	2	2	4	0	0	4	0	0
24	24121130	.	C	T	20	19	39	0	3	42	0	0
24	24121568	.	C	T	12	14	26	0	2	28	0	0
24	24121582	.	T	C	15	0	15	0	18	33	0	0
24	24121826	.	G	T	17	26	43	0	1	44	0	0
24	24121851	.	A	T	21	29	50	0	1	51	0	0
24	24122040	.	G	A	2	1	3	0	0	3	0	0
24	24124517	.	G	A	9	21	30	0	0	30	0	0
24	24129728	.	C	T	17	13	30	0	0	30	0	0
24	24135906	.	G	A	2	2	4	0	1	5	0	0
24	24146815	.	T	A	9	8	17	0	1	18	0	0
24	24155586	.	T	C	4	5	9	0	1	10	0	0
24	24163114	.	C	T	7	6	13	0	0	13	0	0
24	24164278	.	C	A	9	2	11	0	0	11	0	0
24	24164770	.	G	A	18	15	33	0	1	34	0	0
24	24164935	.	A	C	10	12	22	0	1	23	0	0
24	24165563	.	G	T	7	3	10	0	2	12	0	0
24	24168471	.	C	G	5	4	9	0	0	9	0	0
24	24174791	.	C	T	1	2	3	0	0	3	0	0
24	24174826	.	C	T	2	2	4	0	0	4	0	0
24	24175497	.	G	T	2	5	7	0	2	9	0	0
24	24176257	.	G	A	2	4	6	0	0	6	0	0
24	24176723	.	A	G	7	3	10	0	1	11	0	0
24	24177080	.	G	A	4	8	12	0	0	12	0	0
24	24177137	.	A	G	5	4	9	0	0	9	0	0
24	24177158	.	T	C	6	2	8	0	0	8	0	0
24	24177200	.	G	T	5	6	11	0	0	11	0	0
24	24177288	.	G	A	1	4	5	0	0	5	0	0
24	24183959	.	T	G	2	2	4	0	0	4	0	0
24	24183974	.	T	C	2	4	6	0	1	7	0	0
24	24183996	.	C	T	4	5	9	0	0	9	0	0
24	24184394	.	T	C	3	0	3	0	3	6	0	0
24	24184414	.	A	C	4	4	8	0	0	8	0	0
24	24184677	.	T	A	7	12	19	0	1	20	0	0
24	24187454	.	T	G	5	3	8	0	0	8	0	0
24	24189345	.	T	A	1	1	2	0	0	2	0	0
24	24189516	.	C	T	0	0	0	0	4	4	0	0
24	24194328	.	A	G	4	4	8	0	0	8	0	0
24	24194331	.	A	G	4	4	8	0	0	8	0	0
24	24210479	.	C	T	1	2	3	0	0	3	0	0
24	24210485	.	G	A	1	2	3	0	0	3	0	0
24	24273914	.	A	G	1	4	5	0	0	5	0	0
24	24274024	.	A	G	6	1	7	0	0	7	0	0
24	24274069	.	A	T	0	3	3	0	0	3	0	0
24	24287980	.	T	C	1	2	3	0	0	3	0	0
24	24288004	.	T	C	1	2	3	0	0	3	0	0
24	24288223	.	T	C	8	6	14	0	1	15	0	0
24	24299421	.	G	A	0	3	3	0	2	5	0	0
24	24417214	.	C	T	0	1	1	0	2	3	0	0
24	24461710	.	T	A	8	9	17	0	0	17	0	0
24	24462021	.	C	T	10	14	24	0	2	26	0	0
24	24462036	.	G	C	2	11	13	0	14	27	0	0
24	24462081	.	C	T	10	11	21	0	0	21	0	0
24	24463030	.	T	A	14	9	23	0	1	24	0	0
24	24463060	.	A	G	18	6	24	0	2	26	0	0
24	24463212	.	T	A	22	15	37	0	1	38	0	0
24	24701885	.	C	G	7	5	12	0	1	13	0	0
24	24701938	.	T	C	5	13	18	0	0	18	0	0
24	24702119	.	A	C	5	0	5	0	10	15	0	0
24	24702674	.	C	T	11	15	26	0	1	27	0	0
24	24702930	.	C	T	0	4	4	0	4	8	0	0
24	24702936	.	T	C	2	3	5	0	0	5	0	0
24	24720991	.	G	A	2	5	7	0	1	8	0	0
24	24733667	.	C	A	9	3	12	0	1	13	0	0
24	24745966	.	T	C	2	0	2	0	1	3	0	0
24	24796567	.	C	G	0	4	4	0	4	8	0	0
24	24848118	.	C	T	1	17	18	0	23	41	0	0
24	24931465	.	T	C	9	5	14	0	0	14	0	0
24	24934236	.	A	G	8	6	14	0	0	14	0	0
24	24934347	.	T	C	3	5	8	0	0	8	0	0
24	24935527	.	G	A	2	2	4	0	1	5	0	0
24	24935560	.	A	G	10	0	10	0	5	15	0	0
24	24935791	.	G	C	3	2	5	0	1	6	0	0
24	24935810	.	T	C	7	2	9	0	0	9	0	0
24	24944387	.	A	C	5	16	21	0	0	21	0	0
24	24948089	.	T	A	5	9	14	0	0	14	0	0
24	24948101	.	T	A	4	4	8	0	0	8	0	0
24	24950569	.	T	C	2	1	3	0	0	3	0	0
24	24954478	.	T	C	1	7	8	0	0	8	0	0
24	24989293	.	T	G	7	6	13	0	0	13	0	0
24	24989368	.	C	T	0	11	11	0	8	19	0	0
24	24992522	.	G	A	1	2	3	0	0	3	0	0
24	25008884	.	G	A	11	5	16	0	0	16	0	0
24	25008887	.	G	A	10	4	14	0	1	15	0	0
24	25020054	.	T	G	5	7	12	0	0	12	0	0
24	25026278	.	G	A	0	2	2	0	0	2	0	0
24	25026344	.	C	T	0	9	9	0	4	13	0	0
24	25029860	.	T	A	2	1	3	0	0	3	0	0
24	25029971	.	C	G	2	6	8	0	0	8	0	0
24	25029972	.	C	T	0	6	6	0	2	8	0	0
24	25041054	.	T	C	2	3	5	0	0	5	0	0
24	25049209	.	C	T	2	9	11	0	0	11	0	0
24	25049436	.	T	C	0	3	3	0	0	3	0	0
24	25049484	.	T	G	0	3	3	0	0	3	0	0
24	25049658	.	T	C	3	0	3	0	0	3	0	0
24	25052078	.	C	T	0	4	4	0	0	4	0	0
24	25052723	.	T	A	6	3	9	0	1	10	0	0
24	25052774	.	C	T	7	17	24	0	0	24	0	0
24	25053032	.	C	A	4	6	10	0	0	10	0	0
24	25059127	.	C	T	4	6	10	0	0	10	0	0
24	25059129	.	T	C	4	6	10	0	0	10	0	0
24	25069670	.	G	A	5	9	14	0	0	14	0	0
24	25069926	.	A	G	7	1	8	0	9	17	0	0
24	25069928	.	T	A	10	7	17	0	0	17	0	0
24	25070289	.	C	T	4	7	11	0	2	13	0	0
24	25070515	.	C	T	8	9	17	0	0	17	0	0
24	25070745	.	G	A	0	5	5	0	7	12	0	0
24	25070921	.	C	T	6	6	12	0	0	12	0	0
24	25070922	.	T	G	6	6	12	0	0	12	0	0
24	25071270	.	T	A	10	6	16	0	2	18	0	0
24	25071474	.	T	C	15	16	31	0	2	33	0	0
24	25071486	.	A	T	17	13	30	0	2	32	0	0
24	25071726	.	G	A	4	11	15	0	0	15	0	0
24	25071742	.	T	C	4	9	13	0	0	13	0	0
24	25071939	.	G	A	3	3	6	0	0	6	0	0
24	25072088	.	T	C	11	6	17	0	0	17	0	0
24	25072102	.	T	C	7	10	17	0	2	19	0	0
24	25072311	.	C	T	6	4	10	0	1	11	0	0
24	25072487	.	A	G	16	8	24	0	0	24	0	0
24	25072511	.	T	G	8	10	18	0	0	18	0	0
24	25072711	.	G	A	13	13	26	0	1	27	0	0
24	25093550	.	G	T	2	2	4	0	2	6	0	0
24	25093587	.	A	T	3	2	5	0	0	5	0	0
24	25093601	.	C	G	0	2	2	0	3	5	0	0
24	25347794	.	G	T	4	3	7	0	1	8	0	0
24	25348187	.	C	A	3	3	6	0	0	6	0	0
24	25348354	.	C	T	5	4	9	0	0	9	0	0
24	25351955	.	C	T	3	6	9	0	0	9	0	0
24	25352574	.	C	T	1	3	4	0	0	4	0	0
24	25353471	.	A	G	4	2	6	0	0	6	0	0
24	25363324	.	C	G	2	2	4	0	0	4	0	0
24	25411458	.	G	A	1	1	2	0	0	2	0	0
24	25448127	.	A	T	5	5	10	0	0	10	0	0
24	25448155	.	G	A	7	7	14	0	0	14	0	0
24	25448475	.	C	T	5	4	9	0	1	10	0	0
24	25448800	.	T	C	5	5	10	0	1	11	0	0
24	25448820	.	T	C	6	2	8	0	0	8	0	0
24	25449182	.	G	A	2	4	6	0	0	6	0	0
24	25449245	.	A	C	4	6	10	0	1	11	0	0
24	25496549	.	C	G	8	4	12	0	1	13	0	0
24	25497036	.	A	T	5	9	14	0	1	15	0	0
24	25497085	.	C	G	7	7	14	0	2	16	0	0
24	25497099	.	G	C	6	4	10	0	2	12	0	0
24	25497189	.	G	A	6	5	11	0	0	11	0	0
24	25497236	.	A	C	4	7	11	0	0	11	0	0
24	25497327	.	T	C	6	5	11	0	2	13	0	0
24	25497353	.	G	A	0	4	4	0	9	13	0	0
24	25497524	.	A	G	7	5	12	0	0	12	0	0
24	25497543	.	A	G	8	4	12	0	2	14	0	0
24	25497979	.	T	A	3	3	6	0	0	6	0	0
24	25498880	.	G	T	2	2	4	0	0	4	0	0
24	25514777	.	A	T	7	3	10	0	2	12	0	0
24	25525977	.	G	T	9	10	19	0	1	20	0	0
24	25535863	.	T	C	2	3	5	0	2	7	0	0
24	25535917	.	A	G	0	1	1	0	0	1	0	0
24	25564486	.	T	A	2	3	5	0	1	6	0	0
24	25565407	.	T	C	3	0	3	0	4	7	0	0
24	25575049	.	A	G	3	4	7	0	0	7	0	0
24	25693003	.	G	A	19	18	37	0	2	39	0	0
24	25693026	.	C	T	16	22	38	0	3	41	0	0
24	25693948	.	A	G	21	24	45	0	0	45	0	0
24	25693992	.	T	A	22	18	40	0	4	44	0	0
24	25694537	.	A	C	14	19	33	0	3	36	0	0
24	25694858	.	G	A	0	4	4	0	6	10	0	0
24	25761637	.	T	C	2	3	5	0	0	5	0	0
24	25762272	.	G	A	4	4	8	0	1	9	0	0
24	25762600	.	T	C	1	3	4	0	0	4	0	0
24	25762635	.	A	T	1	2	3	0	1	4	0	0
24	25762884	.	C	T	1	5	6	0	0	6	0	0
24	25762930	.	C	A	1	3	4	0	0	4	0	0
24	25763513	.	A	G	1	2	3	0	1	4	0	0
24	25764281	.	A	G	1	2	3	0	0	3	0	0
24	25764892	.	A	T	1	2	3	0	0	3	0	0
24	25787029	.	G	A	1	2	3	0	0	3	0	0
24	25794522	.	C	A	5	6	11	0	0	11	0	0
24	25794530	.	G	A	5	5	10	0	1	11	0	0
24	25872390	.	C	T	4	6	10	0	2	12	0	0
24	25987514	.	A	T	1	3	4	0	0	4	0	0
24	25988133	.	C	A	1	3	4	0	0	4	0	0
24	25988171	.	T	G	1	2	3	0	0	3	0	0
24	26017133	.	T	C	3	5	8	0	0	8	0	0
24	26017175	.	T	A	4	6	10	0	0	10	0	0
24	26017188	.	A	G	3	4	7	0	2	9	0	0
24	26020514	.	T	G	3	6	9	0	0	9	0	0
24	26021871	.	G	A	2	2	4	0	0	4	0	0
24	26025151	.	T	C	3	2	5	0	1	6	0	0
24	26025384	.	T	A	2	4	6	0	1	7	0	0
24	26026179	.	A	T	3	3	6	0	0	6	0	0
24	26030340	.	T	G	1	2	3	0	0	3	0	0
24	26030571	.	C	T	13	19	32	0	0	32	0	0
24	26030663	.	T	C	10	12	22	0	1	23	0	0
24	26030827	.	A	C	14	16	30	0	2	33	1	0
24	26030849	.	T	A	16	17	33	0	1	34	0	0
24	26030893	.	G	A	15	10	25	0	2	27	0	0
24	26030985	.	A	T	9	7	16	0	0	16	0	0
24	26039798	.	A	G	0	3	3	0	1	4	0	0
24	26041227	.	T	C	1	1	2	0	0	2	0	0
24	26045132	.	C	T	1	1	2	0	0	2	0	0
24	26045910	.	A	G	2	0	2	0	0	2	0	0
24	26045916	.	T	C	2	0	2	0	0	2	0	0
24	26046588	.	A	G	2	0	2	0	2	4	0	0
24	26046618	.	G	A	0	1	1	0	0	1	0	0
24	26046820	.	A	G	3	0	3	0	0	3	0	0
24	26046822	.	T	C	3	0	3	0	0	3	0	0
24	26048017	.	G	A	4	1	5	0	1	6	0	0
24	26049166	.	G	T	3	3	6	0	2	8	0	0
24	26049825	.	T	C	8	8	16	0	0	16	0	0
24	26049946	.	A	C	5	5	10	0	0	10	0	0
24	26050066	.	A	T	6	15	21	0	0	21	0	0
24	26052082	.	T	C	0	3	3	0	0	3	0	0
24	26197142	.	T	C	3	4	7	0	0	7	0	0
24	26277152	.	G	T	0	1	1	0	0	1	0	0
24	26280058	.	G	A	4	2	6	0	0	6	0	0
24	26280505	.	G	A	4	3	7	0	1	8	0	0
24	26280668	.	A	C	1	3	4	0	0	4	0	0
24	26280756	.	G	A	2	2	4	0	0	4	0	0
24	26284612	.	G	T	8	4	12	0	0	12	0	0
24	26333366	.	G	A	1	7	8	0	0	8	0	0
24	26333597	.	C	T	4	5	9	0	0	9	0	0
24	26333801	.	C	T	2	3	5	0	0	5	0	0
24	26334257	.	G	A	6	6	12	0	0	12	0	0
24	26334299	.	A	G	6	0	6	0	3	9	0	0
24	26342519	.	G	C	0	3	3	0	2	5	0	0
24	26373354	.	G	A	3	2	5	0	1	6	0	0
24	26373473	.	G	A	8	9	17	0	0	17	0	0
24	26373498	.	G	A	5	9	14	0	1	15	0	0
24	26376380	.	A	G	13	11	24	0	0	25	1	0
24	26383253	.	C	T	11	3	14	0	0	14	0	0
24	26383430	.	A	G	12	6	18	0	1	19	0	0
24	26383604	.	T	A	7	4	11	0	0	11	0	0
24	26383670	.	A	G	6	8	14	0	0	14	0	0
24	26383700	.	C	T	1	4	5	0	6	11	0	0
24	26383829	.	C	T	0	7	7	0	4	11	0	0
24	26383840	.	C	T	11	3	14	0	0	14	0	0
24	26383907	.	T	C	4	6	10	0	0	10	0	0
24	26383971	.	A	C	3	0	3	0	3	6	0	0
24	26399297	.	C	T	1	2	3	0	0	3	0	0
24	26399355	.	G	A	3	2	5	0	0	5	0	0
24	26406895	.	C	A	5	4	9	0	1	10	0	0
24	26406898	.	A	G	6	0	6	0	4	10	0	0
24	26406967	.	G	T	1	2	3	0	0	3	0	0
24	26415190	.	T	C	5	4	9	0	0	9	0	0
24	26419764	.	G	A	0	1	1	0	0	1	0	0
24	26420141	.	T	C	2	6	8	0	0	8	0	0
24	26429443	.	T	C	10	5	15	0	1	16	0	0
24	26429456	.	C	T	10	8	18	0	1	19	0	0
24	26475383	.	C	G	7	10	17	0	0	17	0	0
24	26475434	.	C	T	2	0	2	0	0	2	0	0
24	26482097	.	A	G	18	23	41	0	2	43	0	0
24	26482133	.	C	A	31	22	53	0	5	58	0	0
24	26482337	.	T	C	38	33	71	0	0	71	0	0
24	26484274	.	A	T	2	3	5	0	0	5	0	0
24	26492113	.	C	T	1	15	16	0	10	26	0	0
24	26492505	.	G	T	7	8	15	0	1	16	0	0
24	26493077	.	T	C	10	0	10	0	9	19	0	0
24	26494477	.	C	T	0	2	2	0	4	6	0	0
24	26508844	.	A	G	8	9	17	0	2	19	0	0
24	26510341	.	C	A	6	4	10	0	0	10	0	0
24	26511001	.	C	T	0	3	3	0	1	4	0	0
24	26513292	.	T	A	3	5	8	0	0	8	0	0
24	26516732	.	A	G	1	1	2	0	0	2	0	0
24	26516788	.	C	T	2	1	3	0	0	3	0	0
24	26530814	.	T	A	4	6	10	0	1	11	0	0
24	26558029	.	A	G	5	9	14	0	0	14	0	0
24	26560384	.	G	A	4	11	15	0	0	15	0	0
24	26572615	.	A	T	2	0	2	0	0	2	0	0
24	26631978	.	T	C	2	2	4	0	0	4	0	0
24	26663232	.	A	T	3	3	6	0	0	6	0	0
24	26663381	.	C	T	0	3	3	0	1	4	0	0
24	26663696	.	G	T	4	2	6	0	0	6	0	0
24	26663842	.	G	C	2	5	7	0	0	7	0	0
24	26666778	.	G	A	1	6	7	0	0	7	0	0
24	26704833	.	G	A	0	1	1	0	0	1	0	0
24	26710718	.	T	C	2	2	4	0	0	4	0	0
24	26949229	.	T	C	6	7	13	0	0	13	0	0
24	26949412	.	C	T	8	3	11	0	1	12	0	0
24	26949606	.	T	C	4	2	6	0	0	6	0	0
24	26958347	.	A	G	5	6	11	0	1	12	0	0
24	26958365	.	T	A	7	10	17	0	0	17	0	0
24	26959816	.	G	A	2	2	4	0	2	6	0	0
24	26959891	.	T	C	2	0	2	0	2	4	0	0
24	26964659	.	C	T	3	2	5	0	1	6	0	0
24	26964695	.	A	G	1	2	3	0	1	4	0	0
24	26968308	.	G	A	1	4	5	0	0	5	0	0
24	26970846	.	C	T	0	3	3	0	0	3	0	0
24	26970879	.	A	G	2	6	8	0	0	8	0	0
24	26970936	.	T	C	1	0	1	0	2	3	0	0
24	26971461	.	A	T	1	2	3	0	0	3	0	0
24	26997920	.	G	A	3	3	6	0	1	7	0	0
24	27006002	.	G	A	0	1	1	0	0	1	0	0
24	27011189	.	T	A	0	1	1	0	1	2	0	0
24	27013469	.	A	T	6	8	14	0	0	14	0	0
24	27014011	.	C	T	4	1	5	0	0	5	0	0
24	27019276	.	C	T	9	9	18	0	0	18	0	0
24	27023403	.	C	T	2	6	8	0	0	8	0	0
24	27130971	.	A	T	1	2	3	0	0	3	0	0
24	27153245	.	C	T	2	2	4	0	0	4	0	0
24	27181048	.	T	A	8	2	10	0	0	10	0	0
24	27181057	.	G	A	4	6	10	0	0	10	0	0
24	27185859	.	T	A	6	1	7	0	0	7	0	0
24	27216987	.	G	A	0	0	0	0	1	1	0	0
24	27222937	.	G	A	0	10	10	0	10	20	0	0
24	27224064	.	T	A	17	15	32	0	1	33	0	0
24	27224385	.	G	A	3	10	13	0	18	31	0	0
24	27224863	.	C	A	11	7	18	0	1	19	0	0
24	27225096	.	T	C	4	12	16	0	2	18	0	0
24	27225238	.	C	T	1	10	11	0	8	19	0	0
24	27225342	.	G	A	16	19	35	0	2	37	0	0
24	27225675	.	T	A	8	15	23	0	1	24	0	0
24	27225693	.	A	G	13	11	24	0	3	27	0	0
24	27225859	.	C	G	13	8	21	0	0	21	0	0
24	27225960	.	G	A	17	10	27	0	0	27	0	0
24	27226044	.	A	G	2	9	11	0	1	12	0	0
24	27226057	.	C	T	2	9	11	0	1	12	0	0
24	27226368	.	C	T	6	10	16	0	0	16	0	0
24	27236653	.	C	T	11	15	26	0	1	27	0	0
24	27236716	.	T	C	12	14	26	0	6	32	0	0
24	27245021	.	C	A	2	2	4	0	1	5	0	0
24	27251249	.	C	T	3	8	11	0	1	12	0	0
24	27332828	.	A	G	0	0	0	0	1	1	0	0
24	27341496	.	C	A	0	1	1	0	0	1	0	0
24	27346792	.	C	T	3	1	4	0	0	4	0	0
24	27346819	.	G	A	6	2	8	0	0	8	0	0
24	27346837	.	C	T	6	3	9	0	0	9	0	0
24	27399940	.	G	A	2	3	5	0	0	5	0	0
24	27572532	.	T	C	2	2	4	0	0	4	0	0
24	27572658	.	C	T	1	2	3	0	0	3	0	0
24	27572705	.	A	G	1	2	3	0	0	3	0	0
24	27712011	.	A	G	2	1	3	0	0	3	0	0
24	27713822	.	G	A	2	4	6	0	0	6	0	0
24	27714331	.	C	T	2	6	8	0	0	8	0	0
24	27714338	.	C	T	2	6	8	0	0	8	0	0
24	27714419	.	G	A	2	3	5	0	0	5	0	0
24	27784009	.	C	T	4	7	11	0	0	11	0	0
24	27784036	.	A	G	8	5	13	0	0	13	0	0
24	27784057	.	T	C	7	6	13	0	1	14	0	0
24	27784102	.	C	G	6	11	17	0	0	17	0	0
24	27784129	.	A	G	6	16	22	0	0	22	0	0
24	27784210	.	G	T	6	4	10	0	0	10	0	0
24	27784246	.	G	A	9	4	13	0	3	16	0	0
24	27784348	.	C	T	3	4	7	0	1	8	0	0
24	28137429	.	G	A	0	4	4	0	0	4	0	0
24	28242709	.	T	C	0	0	0	0	4	4	0	0
24	28252898	.	C	A	15	9	24	0	0	24	0	0
24	28253127	.	G	A	9	6	15	0	2	17	0	0
24	28253646	.	A	T	10	3	13	0	0	13	0	0
24	28253663	.	G	A	8	1	9	0	0	9	0	0
24	28253740	.	A	T	18	19	37	0	0	37	0	0
24	28258999	.	G	A	3	2	5	0	0	5	0	0
24	28293347	.	C	T	0	4	4	0	5	9	0	0
24	28306386	.	T	A	3	2	5	0	0	5	0	0
24	28306413	.	A	C	3	0	3	0	4	7	0	0
24	28306471	.	C	T	3	2	5	0	0	5	0	0
24	28312326	.	T	A	9	8	17	0	1	18	0	0
24	28312359	.	G	A	11	9	20	0	2	22	0	0
24	28312431	.	G	A	5	8	13	0	1	14	0	0
24	28312460	.	A	T	2	4	6	0	0	6	0	0
24	28354675	.	T	G	2	6	8	0	1	9	0	0
24	28381103	.	C	T	1	2	3	0	0	3	0	0
24	28381130	.	T	C	3	4	7	0	0	7	0	0
24	28381298	.	C	A	0	2	2	0	2	4	0	0
24	28381351	.	C	A	2	3	5	0	0	5	0	0
24	28381406	.	C	A	2	2	4	0	0	4	0	0
24	28394446	.	G	T	3	2	5	0	0	5	0	0
24	28394461	.	A	T	2	2	4	0	0	4	0	0
24	28394482	.	C	T	2	2	4	0	0	4	0	0
24	28397724	.	C	A	2	4	6	0	0	6	0	0
24	28426082	.	T	A	14	7	21	0	5	26	0	0
24	28426161	.	T	C	6	1	7	0	1	8	0	0
24	28426185	.	T	A	6	0	6	0	1	7	0	0
24	28426363	.	T	G	17	25	42	0	4	46	0	0
24	28426583	.	T	A	18	21	39	0	2	41	0	0
24	28426615	.	G	A	19	22	41	0	1	42	0	0
24	28426705	.	T	A	13	16	29	0	0	29	0	0
24	28426717	.	C	T	1	17	18	0	12	30	0	0
24	28432162	.	A	G	9	4	13	0	0	13	0	0
24	28432297	.	A	C	17	22	39	0	0	39	0	0
24	28432372	.	G	A	17	15	32	0	1	33	0	0
24	28437375	.	A	G	11	11	22	0	1	23	0	0
24	28437405	.	G	A	17	17	34	0	2	36	0	0
24	28437562	.	G	C	9	7	16	0	0	16	0	0
24	28437681	.	C	T	13	8	21	0	0	21	0	0
24	28556150	.	C	T	2	2	4	0	0	4	0	0
24	28686291	.	T	A	1	1	2	0	0	2	0	0
24	28691389	.	C	T	4	4	8	0	2	10	0	0
24	28691457	.	C	T	0	9	9	0	8	17	0	0
24	28710915	.	G	T	7	9	16	0	1	17	0	0
24	28710953	.	G	A	9	11	20	0	0	20	0	0
24	28711027	.	T	A	7	7	14	0	0	14	0	0
24	28765119	.	C	A	4	2	6	0	0	6	0	0
24	28960786	.	T	G	4	0	4	0	0	4	0	0
24	28963133	.	C	T	6	8	14	0	0	14	0	0
24	28963445	.	C	T	1	1	2	0	0	2	0	0
24	28964215	.	A	G	1	3	4	0	0	4	0	0
24	28964747	.	T	A	3	2	5	0	0	5	0	0
24	28965373	.	A	C	1	3	4	0	0	4	0	0
24	28965861	.	G	A	2	2	4	0	0	4	0	0
24	28965870	.	T	C	2	2	4	0	0	4	0	0
24	28965979	.	A	G	3	1	4	0	0	4	0	0
24	28965995	.	G	T	4	1	5	0	0	5	0	0
24	28966068	.	T	A	1	2	3	0	0	3	0	0
24	28966088	.	A	T	2	2	4	0	0	4	0	0
24	28966407	.	A	G	1	3	4	0	0	4	0	0
24	28966810	.	T	C	6	9	15	0	0	15	0	0
24	28966812	.	T	G	6	9	15	0	0	15	0	0
24	28966892	.	T	C	8	4	12	0	0	12	0	0
24	28967234	.	A	G	1	0	1	0	3	4	0	0
24	28967826	.	T	C	1	3	4	0	0	4	0	0
24	29352296	.	T	A	8	3	11	0	0	11	0	0
24	29353340	.	T	A	3	4	7	0	0	7	0	0
24	29382235	.	T	C	14	11	25	0	1	26	0	0
24	29450177	.	T	C	5	9	14	0	0	14	0	0
24	29450195	.	C	T	4	11	15	0	1	16	0	0
24	29450222	.	C	T	10	8	18	0	1	19	0	0
24	29525071	.	C	T	11	12	23	0	1	24	0	0
24	29525169	.	T	A	12	10	22	0	5	27	0	0
24	29627577	.	G	A	0	2	2	0	0	2	0	0
24	29920351	.	G	T	0	1	1	0	1	2	0	0
24	29920352	.	A	G	1	1	2	0	0	2	0	0
24	29961904	.	C	G	3	6	9	0	0	9	0	0
24	29961958	.	G	A	1	2	3	0	0	3	0	0
24	29962084	.	A	G	1	2	3	0	0	3	0	0
24	29965446	.	T	C	1	1	2	0	2	4	0	0
24	29997145	.	A	T	1	3	4	0	0	4	0	0
24	31116765	.	T	C	1	0	1	0	0	1	0	0
24	31170701	.	C	T	0	5	5	0	7	12	0	0
24	31176087	.	A	G	1	1	2	0	1	3	0	0
24	31218903	.	G	T	1	0	1	0	0	1	0	0
24	31222905	.	T	C	0	1	1	0	1	2	0	0
24	31222923	.	A	G	1	1	2	0	0	2	0	0
24	31290330	.	G	A	2	2	4	0	0	4	0	0
24	31310981	.	T	G	12	5	17	0	0	17	0	0
24	31311110	.	T	A	8	15	23	0	0	23	0	0
24	31311137	.	A	G	8	8	16	0	0	17	1	0
24	31311185	.	T	G	6	3	9	0	0	9	0	0
24	31315500	.	A	G	4	7	11	0	1	12	0	0
24	31319363	.	A	C	0	2	2	0	0	2	0	0
24	31319544	.	T	C	1	1	2	0	0	2	0	0
24	31319606	.	A	G	1	1	2	0	1	3	0	0
24	31320006	.	A	G	0	1	1	0	0	1	0	0
24	31320049	.	G	A	0	1	1	0	0	1	0	0
24	31322911	.	G	C	0	0	0	0	2	2	0	0
24	31322920	.	A	G	0	4	4	0	0	4	0	0
24	31323287	.	A	C	3	1	4	0	0	4	0	0
24	31323293	.	G	A	3	2	5	0	0	5	0	0
24	31325202	.	T	C	1	0	1	0	0	1	0	0
24	31329983	.	C	G	0	1	1	0	0	1	0	0
24	31330040	.	G	A	0	1	1	0	0	1	0	0
24	31334313	.	A	G	17	10	27	0	1	28	0	0
24	31340562	.	A	C	4	4	8	0	1	9	0	0
24	31340610	.	C	G	22	3	25	0	27	52	0	0
24	31340922	.	A	G	12	1	13	0	20	33	0	0
24	31342684	.	A	G	2	4	6	0	0	6	0	0
24	31342746	.	A	T	3	3	6	0	0	6	0	0
24	31342883	.	T	A	1	2	3	0	0	3	0	0
24	31364567	.	G	A	3	0	3	0	0	3	0	0
24	31364622	.	C	T	5	5	10	0	0	10	0	0
24	31367533	.	T	C	6	4	10	0	1	11	0	0
24	31367748	.	G	T	0	3	3	0	4	7	0	0
24	31367775	.	A	G	4	2	6	0	0	6	0	0
24	31367841	.	C	A	1	2	3	0	0	3	0	0
24	31367851	.	G	A	1	2	3	0	0	3	0	0
24	31379892	.	C	G	3	3	6	0	0	6	0	0
24	31393957	.	A	T	0	2	2	0	0	2	0	0
24	31397840	.	G	A	7	2	9	0	0	9	0	0
24	31834468	.	T	C	2	3	5	0	0	5	0	0
24	31834472	.	G	A	0	4	4	0	0	4	0	0
24	32650263	.	T	G	4	11	15	0	0	15	0	0
24	32674686	.	T	A	14	7	21	0	1	22	0	0
24	32674708	.	C	T	7	7	14	0	0	14	0	0
24	32674886	.	A	G	8	11	19	0	0	19	0	0
24	32674960	.	T	A	1	5	6	0	1	7	0	0
24	33685344	.	T	C	1	0	1	0	0	1	0	0
24	33709247	.	C	G	27	21	48	0	4	52	0	0
24	33714797	.	A	G	14	21	35	0	2	37	0	0
24	33714854	.	G	A	5	5	10	0	0	10	0	0
24	33723289	.	C	A	0	4	4	0	8	12	0	0
24	33755683	.	C	T	18	19	37	0	1	38	0	0
24	33767992	.	T	C	7	8	15	0	0	15	0	0
24	33768192	.	G	A	5	9	14	0	0	14	0	0
24	33768346	.	T	A	8	3	11	1	0	12	0	0
24	33768509	.	C	T	10	5	15	0	2	17	0	0
24	33768530	.	G	T	11	7	18	0	0	18	0	0
24	33768705	.	A	G	4	5	9	0	0	9	0	0
24	33774457	.	G	A	1	0	1	0	0	1	0	0
24	33777341	.	C	T	0	0	0	0	1	1	0	0
24	33784409	.	A	C	2	1	3	0	0	3	0	0
24	33788330	.	G	A	3	2	5	0	0	5	0	0
24	33790094	.	G	A	6	5	11	0	0	12	1	0
24	33800095	.	C	T	0	5	5	0	6	11	0	0
24	33806426	.	C	T	1	8	9	0	1	10	0	0
24	33813214	.	G	A	1	3	4	0	0	4	0	0
24	33813399	.	G	A	0	2	2	0	2	4	0	0
24	33813525	.	C	T	4	3	7	0	0	7	0	0
24	33813573	.	A	G	1	0	1	0	4	5	0	0
24	33824554	.	G	A	0	6	6	0	1	7	0	0
24	33824590	.	A	G	4	0	4	0	3	7	0	0
24	33824635	.	C	T	2	3	5	0	0	5	0	0
24	33834884	.	G	A	0	2	2	0	0	2	0	0
24	33835259	.	T	G	2	2	4	0	1	5	0	0
24	33835327	.	A	G	1	3	4	0	1	5	0	0
24	33836380	.	A	T	0	4	4	0	0	4	0	0
24	33836581	.	C	T	4	2	6	0	1	7	0	0
24	33837210	.	A	G	2	4	6	0	1	7	0	0
24	33837595	.	A	G	2	3	5	0	0	5	0	0
24	33837636	.	G	T	2	4	6	0	0	6	0	0
24	33837790	.	A	G	4	6	10	0	1	11	0	0
24	33838012	.	A	C	4	3	7	0	0	8	1	0
24	33838270	.	A	G	2	5	7	0	0	7	0	0
24	33838293	.	A	G	3	8	11	0	0	11	0	0
24	33838358	.	T	A	5	4	9	0	1	10	0	0
24	33838363	.	A	G	3	4	7	0	0	7	0	0
24	33838405	.	C	T	0	5	5	0	1	6	0	0
24	33838486	.	G	A	0	4	4	0	3	7	0	0
24	33838753	.	G	A	3	2	5	0	1	6	0	0
24	33838876	.	A	G	9	1	10	0	11	21	0	0
24	33838954	.	A	C	10	7	17	0	1	18	0	0
24	33839031	.	G	A	7	8	15	0	0	15	0	0
24	33839211	.	T	C	3	0	3	0	1	4	0	0
24	33839221	.	A	C	3	2	5	0	0	5	0	0
24	33873397	.	C	T	0	1	1	0	3	4	0	0
24	34034647	.	T	G	1	4	5	0	1	6	0	0
24	34115343	.	C	T	4	2	6	0	0	6	0	0
24	34115661	.	G	C	1	2	3	0	0	3	0	0
24	34116386	.	G	C	1	3	4	0	2	6	0	0
24	34116399	.	C	T	1	2	3	0	1	4	0	0
24	34139278	.	G	A	5	9	14	0	1	15	0	0
24	34139317	.	C	T	3	6	9	0	0	9	0	0
24	34139323	.	T	C	2	0	2	0	6	8	0	0
24	34176593	.	C	T	2	4	6	0	0	6	0	0
24	34185156	.	T	C	0	3	3	0	0	3	0	0
24	34185357	.	G	T	6	5	11	0	0	11	0	0
24	34185364	.	G	A	6	4	10	0	1	11	0	0
24	34208678	.	G	A	5	3	8	0	1	9	0	0
24	34208684	.	T	C	5	4	9	0	0	9	0	0
24	34208747	.	A	G	2	1	3	0	0	3	0	0
24	34284596	.	G	T	6	12	18	0	2	20	0	0
24	34488472	.	G	C	1	2	3	0	0	3	0	0
24	34607240	.	C	T	9	11	20	0	0	20	0	0
24	34607282	.	C	G	10	13	23	0	0	23	0	0
24	34608653	.	C	T	14	12	26	0	0	26	0	0
24	34608844	.	C	T	9	8	17	0	0	17	0	0
24	34610158	.	A	G	18	0	18	0	9	27	0	0
24	34610215	.	G	T	0	11	11	0	12	23	0	0
24	34610515	.	G	A	10	9	19	0	0	19	0	0
24	34610655	.	G	A	1	7	8	0	6	14	0	0
24	34610874	.	A	G	16	11	27	0	0	27	0	0
24	34610920	.	A	T	11	11	22	0	1	23	0	0
24	34611151	.	T	C	15	15	30	0	0	30	0	0
24	34611211	.	G	A	18	17	35	0	2	37	0	0
24	34611236	.	G	A	0	19	19	0	25	44	0	0
24	34611378	.	G	T	22	14	36	0	0	36	0	0
24	34611407	.	G	C	16	15	31	0	2	33	0	0
24	34611445	.	A	G	17	12	29	0	3	32	0	0
24	34611536	.	G	A	14	17	31	0	3	34	0	0
24	34611623	.	A	G	9	15	24	0	0	24	0	0
24	34611681	.	C	T	16	5	21	0	1	22	0	0
24	34611757	.	T	G	13	5	18	0	1	19	0	0
24	34611915	.	A	G	9	0	9	0	9	18	0	0
24	34612187	.	C	A	19	11	30	0	1	31	0	0
24	34612317	.	G	A	18	20	38	0	1	39	0	0
24	34612327	.	A	T	17	18	35	0	2	37	0	0
24	35196166	.	C	T	12	9	21	0	1	22	0	0
24	35213755	.	T	C	2	3	5	0	0	5	0	0
24	35213764	.	G	A	0	7	7	0	3	10	0	0
24	35216439	.	A	T	8	12	20	0	0	20	0	0
24	35216835	.	A	G	10	14	24	0	1	25	0	0
24	35216973	.	C	T	3	7	10	1	0	11	0	0
24	35217222	.	A	T	14	6	20	0	0	20	0	0
24	35217255	.	G	A	12	11	23	0	2	25	0	0
24	35217258	.	C	G	13	10	23	0	1	24	0	0
24	35217308	.	C	T	7	7	14	0	0	14	0	0
24	35217426	.	C	T	4	3	7	0	3	10	0	0
24	35218334	.	G	A	0	2	2	0	2	4	0	0
24	35218336	.	T	G	2	2	4	0	0	4	0	0
24	35242896	.	C	T	0	1	1	0	0	1	0	0
24	35269915	.	A	G	3	3	6	0	1	7	0	0
24	35522379	.	A	T	11	6	17	0	1	18	0	0
24	35522417	.	C	A	6	16	22	0	2	24	0	0
24	35522568	.	C	T	21	22	43	0	3	46	0	0
24	35522962	.	A	G	18	22	40	0	0	40	0	0
24	35523088	.	A	T	21	23	44	0	4	48	0	0
24	35523134	.	T	A	25	11	36	0	2	38	0	0
24	35530249	.	T	G	29	13	42	0	0	42	0	0
24	35537156	.	G	A	1	0	1	0	0	1	0	0
24	35565350	.	C	G	2	1	3	0	4	7	0	0
24	35681625	.	G	A	24	18	42	0	4	46	0	0
24	35681753	.	G	A	3	2	5	0	2	7	0	0
24	35683349	.	T	C	9	6	15	0	1	16	0	0
24	35683883	.	A	G	23	17	40	0	3	43	0	0
24	35686180	.	A	G	15	20	35	0	3	38	0	0
24	35692741	.	C	T	0	0	0	0	3	3	0	0
24	35713710	.	T	C	6	5	11	0	0	11	0	0
24	35720498	.	C	T	2	7	9	0	4	13	0	0
24	35742791	.	A	G	2	2	4	0	0	4	0	0
24	35749858	.	C	A	0	1	1	0	0	1	0	0
24	35906191	.	G	A	0	5	5	0	4	9	0	0
24	35918445	.	C	G	1	2	3	0	0	3	0	0
24	35925145	.	T	C	1	3	4	0	0	4	0	0
24	35925163	.	C	A	2	3	5	0	0	5	0	0
24	35925499	.	T	C	1	0	1	0	0	1	0	0
24	35925529	.	T	C	2	0	2	0	0	2	0	0
24	35926460	.	C	T	2	3	5	0	0	5	0	0
24	35930005	.	A	C	4	3	7	0	0	7	0	0
24	35930056	.	T	G	3	3	6	0	0	6	0	0
24	36027212	.	T	C	12	15	27	0	3	30	0	0
24	36166121	.	T	G	1	4	5	0	0	5	0	0
24	36166196	.	A	G	4	2	6	0	0	6	0	0
24	36175078	.	G	A	0	1	1	0	0	1	0	0
24	36175099	.	T	G	2	2	4	0	1	5	0	0
24	36175205	.	G	A	6	6	12	0	0	12	0	0
24	36175208	.	C	T	6	6	12	0	0	12	0	0
24	36177597	.	A	C	5	6	11	0	0	11	0	0
24	36177609	.	T	C	8	5	13	0	0	13	0	0
24	36178063	.	C	G	3	2	5	0	0	5	0	0
24	36182443	.	A	G	2	3	5	0	0	5	0	0
24	36182455	.	G	A	1	5	6	0	1	7	0	0
24	36182503	.	G	C	2	6	8	0	0	8	0	0
24	36187933	.	A	T	0	2	2	0	0	2	0	0
24	36187963	.	C	T	0	1	1	0	1	2	0	0
24	36193431	.	C	T	0	1	1	0	3	4	0	0
24	36193557	.	C	A	7	3	10	0	1	11	0	0
24	36193803	.	T	C	4	2	6	0	0	6	0	0
24	36193938	.	A	C	1	2	3	0	0	3	0	0
24	36194330	.	T	C	2	4	6	0	2	8	0	0
24	36194365	.	C	T	3	3	6	0	0	6	0	0
24	36194736	.	C	T	2	2	4	0	0	4	0	0
24	36195103	.	G	A	1	1	2	0	1	3	0	0
24	36195168	.	A	G	1	3	4	0	0	4	0	0
24	36213074	.	T	C	1	2	3	0	0	3	0	0
24	36220106	.	A	T	2	0	2	0	0	2	0	0
24	36223627	.	T	C	2	2	4	0	0	4	0	0
24	36244407	.	C	T	2	5	7	0	0	7	0	0
24	36247261	.	A	T	1	0	1	0	0	1	0	0
24	36248705	.	C	T	2	5	7	0	1	8	0	0
24	36249910	.	G	T	0	1	1	0	0	1	0	0
24	36250403	.	T	C	1	2	3	0	0	3	0	0
24	36253324	.	C	T	22	20	42	0	1	43	0	0
24	36261666	.	T	C	1	5	6	0	0	6	0	0
24	36261730	.	C	T	0	1	1	0	0	1	0	0
24	36266649	.	T	C	1	0	1	0	1	2	0	0
24	36270566	.	A	C	1	4	5	0	0	5	0	0
24	36271269	.	T	A	3	3	6	0	0	6	0	0
24	36271274	.	T	A	3	4	7	0	0	7	0	0
24	36275987	.	C	T	2	2	4	0	0	4	0	0
24	36276035	.	A	C	2	5	7	0	0	7	0	0
24	36276059	.	G	T	2	3	5	0	0	5	0	0
24	36276087	.	A	G	2	4	6	0	0	6	0	0
24	36276363	.	A	G	4	4	8	0	0	8	0	0
24	36276364	.	G	T	4	4	8	0	0	8	0	0
24	36280272	.	A	G	1	1	2	0	0	2	0	0
24	36280296	.	T	G	3	1	4	0	0	4	0	0
24	36284470	.	G	A	3	4	7	0	0	7	0	0
24	36287396	.	G	T	5	3	8	0	0	8	0	0
24	36289642	.	T	C	1	1	2	0	0	2	0	0
24	36295445	.	C	T	0	4	4	0	6	10	0	0
24	36295448	.	C	T	6	5	11	0	0	11	0	0
24	36295817	.	A	G	2	4	6	0	0	6	0	0
24	36295833	.	G	C	2	4	6	0	0	6	0	0
24	36298963	.	A	G	1	0	1	0	0	1	0	0
24	36300941	.	T	A	1	5	6	0	0	6	0	0
24	36301035	.	T	G	4	2	6	0	0	6	0	0
24	36303718	.	G	A	1	2	3	0	0	3	0	0
24	36325256	.	C	G	0	1	1	0	1	2	0	0
24	36325262	.	C	G	0	1	1	0	1	2	0	0
24	36329292	.	A	G	2	3	5	0	0	5	0	0
24	36334589	.	G	A	1	1	2	0	0	2	0	0
24	36334677	.	T	C	9	6	15	0	1	16	0	0
24	36334724	.	A	G	4	5	9	0	0	9	0	0
24	36334848	.	A	G	7	3	10	0	0	10	0	0
24	36334857	.	G	A	6	3	9	0	0	9	0	0
24	36335024	.	C	G	5	4	9	0	1	10	0	0
24	36335139	.	T	C	3	0	3	0	5	8	0	0
24	36335196	.	C	G	4	4	8	0	0	8	0	0
24	36335228	.	T	C	6	0	6	0	4	10	0	0
24	36345780	.	A	C	2	0	2	0	1	3	0	0
24	36349911	.	C	T	1	2	3	0	0	3	0	0
24	36349915	.	G	A	1	2	3	0	0	3	0	0
24	36352446	.	G	A	0	2	2	0	2	4	0	0
24	36352450	.	G	A	1	3	4	0	1	5	0	0
24	36357567	.	G	A	5	2	7	0	0	7	0	0
24	36362031	.	G	C	2	9	11	0	0	11	0	0
24	36362141	.	T	C	3	3	6	0	0	6	0	0
24	36364454	.	A	G	4	4	8	0	1	9	0	0
24	37329616	.	T	A	1	3	4	0	0	4	0	0
24	37568186	.	A	C	3	37	40	0	0	40	0	0
24	37623247	.	A	C	2	6	8	0	0	8	0	0
24	37634889	.	G	T	0	1	1	0	0	1	0	0
24	37636887	.	G	A	2	0	2	0	0	2	0	0
24	37647015	.	A	G	1	1	2	0	0	2	0	0
24	37649810	.	T	C	2	3	5	0	1	6	0	0
24	37655213	.	C	T	1	5	6	0	0	6	0	0
24	37661443	.	T	A	1	2	3	0	0	3	0	0
24	37661474	.	A	G	2	2	4	0	0	4	0	0
24	37661996	.	C	T	1	2	3	0	0	3	0	0
24	37661999	.	G	A	1	2	3	0	0	3	0	0
24	37681556	.	G	T	2	1	3	0	0	3	0	0
24	37689919	.	T	C	36	17	53	0	2	55	0	0
24	37692529	.	G	A	10	14	24	0	2	26	0	0
24	37695799	.	T	C	2	2	4	0	0	4	0	0
24	37695870	.	C	T	0	3	3	0	1	4	0	0
24	37696508	.	T	C	9	3	12	0	1	13	0	0
24	37704287	.	G	C	2	1	3	0	0	3	0	0
24	37708017	.	T	C	0	1	1	0	0	1	0	0
24	37708288	.	A	C	2	8	10	0	0	10	0	0
24	37718769	.	T	C	2	2	4	0	0	4	0	0
24	37718813	.	C	T	5	4	9	0	0	9	0	0
24	37718892	.	C	T	1	1	2	0	0	2	0	0
24	37722162	.	T	C	2	2	4	0	0	4	0	0
24	37723173	.	A	T	2	3	5	0	0	5	0	0
24	37723415	.	A	G	3	2	5	0	0	5	0	0
24	37723444	.	C	A	2	2	4	0	0	4	0	0
24	37723950	.	C	A	3	6	9	0	0	9	0	0
24	37724045	.	A	T	4	4	8	0	0	8	0	0
24	37724175	.	A	G	3	2	5	0	0	5	0	0
24	37724206	.	T	C	4	3	7	0	0	7	0	0
24	37725117	.	T	C	2	8	10	0	0	10	0	0
24	37725817	.	G	A	5	3	8	0	1	9	0	0
24	37725860	.	T	G	5	3	8	0	0	8	0	0
24	37726004	.	G	A	1	4	5	0	0	5	0	0
24	37726188	.	C	A	4	4	8	0	0	8	0	0
24	37726198	.	T	C	4	4	8	0	0	8	0	0
24	37726367	.	C	T	8	4	12	0	0	12	0	0
24	37726377	.	A	G	4	7	11	0	0	11	0	0
24	37726649	.	G	A	1	5	6	0	6	12	0	0
24	37726867	.	C	G	5	5	10	0	0	10	0	0
24	37726991	.	C	T	5	7	12	0	0	12	0	0
24	37726997	.	G	A	8	5	13	0	0	13	0	0
24	37746094	.	G	A	0	1	1	0	0	1	0	0
24	37781428	.	G	A	6	6	12	0	0	12	0	0
24	37781446	.	C	T	4	4	8	0	1	9	0	0
24	37791099	.	C	T	3	4	7	0	1	8	0	0
24	37793276	.	C	A	5	2	7	0	0	7	0	0
24	37793282	.	C	T	6	3	9	0	0	9	0	0
24	37793315	.	C	T	10	5	15	0	1	16	0	0
24	37793725	.	C	T	8	8	16	0	2	18	0	0
24	37800433	.	C	T	1	1	2	0	0	2	0	0
24	37802272	.	G	A	0	3	3	0	1	4	0	0
24	37805414	.	T	C	2	1	3	0	0	3	0	0
24	37816405	.	C	T	1	2	3	0	0	3	0	0
24	37823329	.	T	C	1	3	4	0	0	4	0	0
24	37836280	.	C	G	1	2	3	0	0	3	0	0
24	37888518	.	C	T	2	5	7	0	0	7	0	0
24	37893269	.	A	G	2	0	2	0	0	2	0	0
24	37895022	.	C	T	4	1	5	0	0	5	0	0
24	37896875	.	C	T	5	2	7	0	0	7	0	0
24	37899479	.	A	T	3	2	5	0	0	5	0	0
24	37900945	.	G	A	0	4	4	0	1	5	0	0
24	37941922	.	A	C	6	5	11	0	0	11	0	0
24	37942032	.	C	T	3	7	10	0	2	12	0	0
24	37942183	.	A	T	5	4	9	0	0	9	0	0
24	37942224	.	T	C	4	2	6	0	0	6	0	0
24	37942242	.	A	G	3	2	5	0	0	5	0	0
24	37942423	.	G	A	3	6	9	0	1	10	0	0
24	37942559	.	C	T	4	4	8	0	0	8	0	0
24	37942664	.	T	C	2	3	5	0	0	5	0	0
24	37943052	.	A	G	1	5	6	0	1	7	0	0
24	37943664	.	G	C	3	3	6	0	0	6	0	0
24	37943666	.	T	C	3	3	6	0	0	6	0	0
24	37943767	.	C	T	0	4	4	0	2	6	0	0
24	38073247	.	A	G	9	15	24	0	2	26	0	0
24	38073271	.	G	A	14	13	27	0	3	30	0	0
24	38073625	.	A	G	20	11	31	0	5	36	0	0
24	38073712	.	C	T	14	22	36	0	1	37	0	0
24	38073754	.	A	C	9	30	39	0	0	39	0	0
24	38180213	.	G	A	0	2	2	0	2	4	0	0
24	38187937	.	T	C	3	2	5	0	0	5	0	0
24	38188229	.	A	G	2	3	5	0	1	6	0	0
24	38189538	.	G	A	5	2	7	0	0	7	0	0
24	38189702	.	A	C	5	5	10	0	1	11	0	0
24	38190121	.	A	G	1	3	4	0	0	4	0	0
24	38190387	.	T	C	1	3	4	0	0	4	0	0
24	38190396	.	A	C	1	4	5	0	0	5	0	0
24	38190594	.	G	T	0	3	3	0	1	4	0	0
24	38190606	.	A	T	1	4	5	0	1	6	0	0
24	38190654	.	T	C	2	2	4	0	0	4	0	0
24	38190768	.	G	A	1	3	4	0	0	4	0	0
24	38190868	.	A	G	1	4	5	0	0	5	0	0
24	38190894	.	G	A	2	4	6	0	0	6	0	0
24	38191525	.	A	C	5	2	7	0	1	8	0	0
24	38191537	.	C	T	3	4	7	0	0	7	0	0
24	38191590	.	T	C	2	5	7	0	0	7	0	0
24	38191900	.	A	G	2	3	5	0	0	5	0	0
24	38369559	.	T	A	17	17	34	0	1	35	0	0
24	38369873	.	G	A	23	25	48	0	2	50	0	0
24	38370188	.	A	G	17	13	30	0	1	31	0	0
24	38370245	.	C	G	0	13	13	0	16	29	0	0
24	38370443	.	C	T	0	14	14	0	15	29	0	0
24	38370998	.	A	G	13	10	23	0	1	24	0	0
24	38371178	.	A	G	3	10	13	0	0	13	0	0
24	38384245	.	A	T	9	10	19	0	0	19	0	0
24	38574377	.	C	T	0	1	1	0	0	1	0	0
24	38618659	.	C	T	1	0	1	0	1	2	0	0
24	38618668	.	G	A	1	2	3	0	0	3	0	0
24	38816010	.	G	T	4	6	10	0	0	10	0	0
24	38816340	.	T	G	2	3	5	0	0	5	0	0
24	39051126	.	C	T	4	6	10	0	0	10	0	0
24	39051803	.	A	C	3	9	12	0	0	12	0	0
24	39051981	.	G	A	0	1	1	0	6	7	0	0
24	39052200	.	C	T	8	8	16	0	1	17	0	0
24	39052236	.	G	T	0	9	9	0	7	16	0	0
24	39052302	.	G	A	7	7	14	0	0	14	0	0
24	39052311	.	C	T	6	8	14	0	1	15	0	0
24	39052410	.	C	T	0	2	2	0	0	2	0	0
24	39073885	.	G	A	0	1	1	0	0	1	0	0
24	39075534	.	T	C	9	7	16	0	1	17	0	0
24	39078597	.	A	G	5	0	5	0	1	6	0	0
24	39081150	.	C	T	2	2	4	0	0	4	0	0
24	39137015	.	C	T	6	9	15	0	2	17	0	0
24	39137027	.	G	C	6	10	16	0	0	16	0	0
24	39137777	.	G	A	1	9	10	0	8	18	0	0
24	39137785	.	G	T	7	11	18	0	0	18	0	0
24	39151067	.	A	G	0	0	0	0	17	17	0	0
24	39151075	.	A	G	6	13	19	0	1	20	0	0
24	39151989	.	A	G	20	9	29	0	2	31	0	0
24	39152523	.	A	G	3	2	5	0	0	5	0	0
24	39152794	.	A	G	5	11	16	0	1	17	0	0
24	39152798	.	A	G	10	7	17	0	1	18	0	0
24	39215736	.	G	T	0	2	2	0	3	5	0	0
24	39268891	.	A	G	9	9	18	0	1	19	0	0
24	39272041	.	A	G	2	3	5	0	1	6	0	0
24	39274821	.	A	G	3	5	8	0	1	9	0	0
24	39277575	.	C	G	11	7	18	0	2	20	0	0
24	39287210	.	A	G	5	6	11	0	1	12	0	0
24	39298214	.	C	T	1	2	3	0	0	3	0	0
24	39309684	.	A	G	6	0	6	0	12	18	0	0
24	39309889	.	A	T	18	16	34	0	2	36	0	0
24	39310129	.	G	A	9	14	23	0	0	23	0	0
24	39310163	.	G	T	13	9	22	0	1	23	0	0
24	39310253	.	C	T	7	9	16	0	0	16	0	0
24	39321017	.	T	C	11	18	29	0	1	30	0	0
24	39322945	.	G	T	2	9	11	0	10	21	0	0
24	39323791	.	C	T	10	5	15	0	1	16	0	0
24	39330763	.	C	T	0	2	2	0	0	2	0	0
24	39333916	.	C	T	4	5	9	0	0	9	0	0
24	39334153	.	T	G	18	17	35	0	1	36	0	0
24	39334388	.	A	G	9	29	38	0	4	42	0	0
24	39334681	.	G	T	14	39	53	0	1	54	0	0
24	39334796	.	G	A	1	10	11	0	17	28	0	0
24	39353424	.	T	C	1	2	3	0	0	3	0	0
24	39510891	.	T	C	3	3	6	0	0	6	0	0
24	39511016	.	T	C	2	4	6	0	0	6	0	0
24	39511034	.	G	A	2	5	7	0	0	7	0	0
24	39511298	.	A	C	2	5	7	0	0	7	0	0
24	39514296	.	C	G	7	2	9	0	0	9	0	0
24	39518554	.	C	G	0	1	1	0	0	1	0	0
24	39530034	.	G	A	0	6	6	0	5	11	0	0
24	39533836	.	C	T	2	10	12	0	0	12	0	0
24	39533987	.	T	A	7	8	15	0	1	16	0	0
24	39534532	.	A	G	2	1	3	0	7	10	0	0
24	39544398	.	G	A	3	5	8	0	0	8	0	0
24	39544430	.	A	G	0	0	0	0	3	3	0	0
24	39549343	.	G	A	0	1	1	0	1	2	0	0
24	39549379	.	C	T	3	2	5	0	0	5	0	0
24	39556276	.	G	T	0	4	4	0	1	5	0	0
24	39556716	.	C	G	1	1	2	0	0	2	0	0
24	39556760	.	G	A	0	1	1	0	1	2	0	0
24	39559345	.	A	G	4	0	4	0	3	7	0	0
24	39559356	.	C	T	3	3	6	0	0	6	0	0
24	39559386	.	G	A	2	0	2	0	0	2	0	0
24	39576071	.	A	T	1	5	6	0	0	6	0	0
24	39576247	.	C	T	4	2	6	0	0	6	0	0
24	39576414	.	C	T	4	3	7	0	1	8	0	0
24	39579730	.	A	G	10	5	15	0	0	15	0	0
24	39586778	.	A	T	1	3	4	0	0	4	0	0
24	39587369	.	C	G	0	2	2	0	0	2	0	0
24	39587371	.	T	C	0	2	2	0	0	2	0	0
24	39593009	.	T	C	1	1	2	0	0	2	0	0
24	39593038	.	G	A	0	4	4	0	3	7	0	0
24	39595866	.	A	C	3	2	5	0	0	5	0	0
24	39606237	.	G	A	9	24	33	0	1	34	0	0
24	39610535	.	G	T	9	20	29	0	1	30	0	0
24	39614901	.	G	A	3	3	6	0	0	6	0	0
24	39614915	.	A	G	2	2	4	0	0	4	0	0
24	39615406	.	G	A	7	10	17	0	0	17	0	0
24	39615434	.	G	A	4	1	5	2	0	7	0	0
24	39616170	.	C	A	8	3	11	0	0	11	0	0
24	39620548	.	A	G	1	1	2	0	3	5	0	0
24	39625539	.	T	C	1	4	5	0	0	5	0	0
24	39627628	.	T	A	0	1	1	0	0	1	0	0
24	39627640	.	C	A	0	1	1	0	0	1	0	0
24	39632991	.	G	T	0	1	1	0	0	1	0	0
24	39638642	.	G	A	16	24	40	0	0	40	0	0
24	39642072	.	A	T	9	12	21	0	2	23	0	0
24	39642220	.	A	G	4	7	11	0	1	12	0	0
24	39642229	.	A	G	3	9	12	0	0	12	0	0
24	39642336	.	C	A	12	7	19	0	0	19	0	0
24	39642361	.	G	T	14	6	20	0	2	22	0	0
24	39644259	.	T	C	7	8	15	0	0	15	0	0
24	39646762	.	C	T	10	14	24	0	0	24	0	0
24	39647021	.	C	T	5	4	9	0	0	9	0	0
24	39647042	.	G	C	10	14	24	0	0	24	0	0
24	39648806	.	C	T	12	11	23	0	1	24	0	0
24	39651567	.	T	G	28	19	47	0	3	50	0	0
24	39651612	.	A	T	15	12	27	0	5	32	0	0
24	39653626	.	G	A	21	20	41	13	1	55	0	0
24	39660219	.	C	T	2	2	4	0	0	4	0	0
24	39661890	.	T	A	1	2	3	0	0	3	0	0
24	39661905	.	C	T	3	4	7	0	0	7	0	0
24	39662074	.	T	C	5	2	7	0	0	7	0	0
24	39663197	.	A	G	4	3	7	0	1	8	0	0
24	39667348	.	T	C	12	8	20	0	0	20	0	0
24	39742273	.	G	A	5	7	12	0	0	12	0	0
24	39742336	.	G	A	5	4	9	0	0	9	0	0
24	39742396	.	G	A	3	4	7	0	0	7	0	0
24	39742786	.	T	A	8	7	15	0	1	16	0	0
24	39742869	.	G	T	1	1	2	0	0	2	0	0
24	39771659	.	G	T	3	5	8	0	1	9	0	0
24	39771976	.	G	A	9	3	12	0	0	12	0	0
24	39771983	.	A	G	9	5	14	0	1	15	0	0
24	39778970	.	C	T	2	2	4	0	0	4	0	0
24	39787653	.	G	C	0	0	0	0	1	1	0	0
24	40495406	.	G	A	1	3	4	0	1	5	0	0
24	40495415	.	C	T	2	4	6	0	0	6	0	0
24	41246800	.	G	A	0	2	2	0	0	2	0	0
24	41281297	.	T	C	0	2	2	0	0	2	0	0
24	41281385	.	G	C	2	2	4	0	0	4	0	0
24	41290602	.	G	A	0	1	1	0	1	2	0	0
24	41290604	.	G	A	1	1	2	0	0	2	0	0
24	41290712	.	C	T	1	0	1	0	0	1	0	0
24	41293409	.	G	A	2	7	9	0	0	9	0	0
24	41309374	.	T	C	1	3	4	0	0	4	0	0
24	41309398	.	C	G	1	3	4	0	0	4	0	0
24	41317090	.	A	T	19	14	33	0	4	37	0	0
24	41317132	.	G	A	10	8	18	0	3	21	0	0
24	41317285	.	T	A	4	15	19	0	4	23	0	0
24	41317287	.	T	A	3	16	19	0	4	23	0	0
24	41317350	.	G	C	4	0	4	0	10	14	0	0
24	41560116	.	G	C	3	3	6	0	0	6	0	0
24	41560146	.	G	A	6	3	9	0	0	9	0	0
24	41738523	.	G	A	0	2	2	0	1	3	0	0
24	41742837	.	C	T	1	4	5	0	0	5	0	0
24	41757941	.	C	A	0	3	3	0	0	3	0	0
24	41764121	.	G	A	0	5	5	0	1	6	0	0
24	41773216	.	G	C	0	5	5	0	2	7	0	0
24	41781968	.	C	T	2	5	7	0	2	9	0	0
24	41783906	.	G	A	0	7	7	0	4	11	0	0
24	41786281	.	C	G	3	5	8	0	0	8	0	0
24	41786304	.	G	A	3	4	7	0	0	7	0	0
24	41916447	.	G	T	8	4	12	0	0	12	0	0
24	41916584	.	G	A	7	8	15	0	0	15	0	0
24	41916677	.	A	G	7	0	7	0	6	13	0	0
24	41916887	.	G	A	8	9	17	0	3	20	0	0
24	41917543	.	T	C	9	7	16	0	0	16	0	0
24	41953649	.	T	G	4	2	6	0	1	7	0	0
24	41954745	.	A	G	9	1	10	0	10	20	0	0
24	41954764	.	A	C	7	9	16	0	2	18	0	0
24	41954781	.	C	T	7	10	17	0	2	19	0	0
24	41964613	.	A	C	4	6	10	0	1	11	0	0
24	41965111	.	G	A	2	0	2	0	0	2	0	0
24	41965147	.	T	C	9	8	17	0	0	17	0	0
24	41969781	.	C	A	2	4	6	0	1	7	0	0
24	41972519	.	A	G	18	12	30	0	1	31	0	0
24	41972633	.	C	G	4	0	4	0	6	10	0	0
24	41972638	.	A	T	4	2	6	0	0	6	0	0
24	41974769	.	C	T	4	6	10	0	0	10	0	0
24	41981865	.	A	G	3	4	7	0	0	7	0	0
24	41986626	.	G	C	2	19	21	0	17	38	0	0
24	41986704	.	C	T	20	15	35	0	0	35	0	0
24	41989416	.	C	G	7	4	11	0	1	12	0	0
24	41989455	.	C	T	6	3	9	0	0	9	0	0
24	41990626	.	A	T	9	5	14	0	2	16	0	0
24	41990821	.	G	A	0	7	7	0	14	21	0	0
24	41994096	.	G	A	9	10	19	0	1	20	0	0
24	41994147	.	G	T	10	14	24	0	0	24	0	0
24	42061369	.	C	T	5	6	11	0	0	11	0	0
24	42061423	.	G	T	5	6	11	0	0	11	0	0
24	42061426	.	G	A	5	6	11	0	0	11	0	0
24	42083876	.	A	G	11	19	30	0	3	33	0	0
24	42138533	.	A	G	15	0	15	0	15	30	0	0
24	42141461	.	T	C	8	0	8	0	7	15	0	0
24	42141605	.	G	A	1	0	1	0	0	1	0	0
24	42141770	.	T	C	11	6	17	0	0	17	0	0
24	42153241	.	A	G	8	5	13	0	0	13	0	0
24	42155187	.	T	C	9	14	23	0	0	23	0	0
25	14095	.	C	T	2	14	16	0	2	18	0	0
25	15542	.	T	C	12	12	24	0	0	24	0	0
25	15764	.	A	G	15	1	16	0	8	24	0	0
25	127683	.	T	G	3	0	3	0	2	5	0	0
25	127770	.	G	T	0	3	3	0	8	11	0	0
25	127786	.	A	G	8	1	9	0	3	12	0	0
25	136788	.	T	C	16	9	25	0	1	26	0	0
25	136857	.	C	T	16	10	26	0	1	27	0	0
25	136986	.	C	T	17	13	30	0	1	31	0	0
25	137043	.	C	A	4	2	6	0	3	9	0	0
25	137367	.	T	C	2	1	3	0	1	4	0	0
25	137369	.	T	G	2	1	3	0	1	4	0	0
25	137492	.	C	A	4	8	12	0	3	16	1	0
25	146159	.	G	A	0	10	10	0	13	23	0	0
25	146282	.	C	T	11	4	15	0	2	17	0	0
25	146735	.	C	G	17	15	32	0	1	33	0	0
25	154440	.	C	T	6	4	10	0	0	11	1	0
25	156522	.	C	T	7	5	12	0	0	12	0	0
25	156608	.	C	T	1	2	3	0	0	3	0	0
25	157151	.	T	C	0	4	4	0	0	4	0	0
25	157157	.	C	T	0	2	2	0	0	2	0	0
25	157389	.	T	C	1	4	5	0	0	5	0	0
25	157996	.	C	A	3	2	5	0	1	6	0	0
25	158641	.	T	C	1	2	3	0	1	4	0	0
25	158770	.	C	T	8	5	13	0	0	13	0	0
25	159510	.	C	T	2	9	11	0	0	11	0	0
25	159543	.	T	C	13	8	21	0	0	21	0	0
25	168172	.	G	A	1	2	3	0	0	3	0	0
25	187241	.	T	G	3	2	5	0	0	5	0	0
25	203396	.	T	C	6	8	14	0	3	17	0	0
25	237012	.	G	A	0	0	0	0	1	1	0	0
25	238588	.	A	G	3	2	5	0	0	5	0	0
25	241694	.	C	T	2	5	7	0	0	7	0	0
25	241695	.	A	G	2	4	6	0	1	7	0	0
25	244115	.	C	T	1	4	5	0	2	7	0	0
25	267138	.	T	C	1	1	2	0	2	4	0	0
25	269134	.	A	C	0	0	0	0	3	3	0	0
25	314968	.	G	C	5	4	9	0	0	9	0	0
25	315157	.	C	T	1	3	4	0	0	4	0	0
25	320881	.	T	A	3	2	5	0	0	5	0	0
25	324502	.	G	A	1	1	2	0	0	2	0	0
25	388320	.	C	A	3	2	5	0	0	5	0	0
25	399691	.	G	A	5	4	9	0	1	10	0	0
25	400361	.	G	A	0	2	2	0	4	6	0	0
25	401039	.	C	T	5	3	8	0	0	8	0	0
25	401363	.	T	C	5	4	9	0	0	9	0	0
25	401558	.	C	A	6	9	15	0	1	16	0	0
25	402152	.	T	C	4	4	8	0	1	9	0	0
25	402348	.	G	A	0	5	5	0	10	15	0	0
25	402359	.	T	G	9	0	9	0	6	15	0	0
25	403761	.	C	T	6	7	13	0	0	13	0	0
25	403935	.	T	G	7	5	12	0	0	12	0	0
25	404795	.	T	A	10	6	16	0	2	18	0	0
25	405253	.	G	A	5	9	14	0	1	15	0	0
25	450354	.	C	T	7	8	15	0	2	17	0	0
25	474938	.	T	A	19	14	33	0	1	34	0	0
25	485389	.	T	C	1	3	4	0	0	4	0	0
25	485437	.	C	T	10	5	15	0	0	15	0	0
25	485612	.	C	T	3	14	17	0	19	36	0	0
25	485772	.	C	A	13	17	30	0	0	30	0	0
25	485802	.	T	C	16	15	31	0	0	31	0	0
25	485847	.	T	C	17	13	30	0	2	32	0	0
25	485863	.	A	T	15	16	31	0	0	31	0	0
25	486284	.	G	A	15	11	26	0	2	28	0	0
25	486472	.	A	T	8	9	17	0	1	18	0	0
25	486712	.	G	A	12	10	22	0	1	23	0	0
25	486895	.	C	T	6	10	16	0	0	16	0	0
25	487039	.	C	A	16	15	31	0	2	33	0	0
25	487045	.	C	T	16	19	35	0	0	35	0	0
25	487078	.	T	G	18	15	33	0	0	33	0	0
25	488701	.	G	C	8	2	10	0	10	20	0	0
25	488817	.	G	T	12	6	18	0	0	18	0	0
25	489874	.	C	T	0	7	7	0	10	17	0	0
25	495366	.	G	A	3	2	5	0	0	5	0	0
25	498814	.	T	C	9	5	14	0	0	14	0	0
25	502608	.	G	A	3	1	4	0	0	4	0	0
25	504837	.	G	A	4	2	6	0	0	6	0	0
25	505214	.	C	T	6	8	14	0	1	15	0	0
25	509223	.	G	T	4	3	7	0	1	8	0	0
25	509625	.	G	A	4	8	12	0	1	13	0	0
25	509744	.	A	T	8	10	18	0	0	18	0	0
25	509899	.	C	T	3	7	10	0	0	10	0	0
25	509917	.	T	A	2	6	8	0	1	9	0	0
25	510000	.	T	G	5	5	10	0	0	10	0	0
25	510505	.	T	C	3	0	3	0	5	8	0	0
25	510514	.	T	A	8	3	11	0	0	11	0	0
25	510645	.	G	A	2	5	7	0	0	7	0	0
25	523342	.	C	T	0	2	2	0	4	6	0	0
25	523414	.	G	A	1	5	6	0	0	6	0	0
25	552560	.	G	A	6	6	12	0	0	12	0	0
25	552872	.	G	A	2	5	7	0	1	8	0	0
25	663178	.	C	T	2	1	3	0	1	4	0	0
25	663284	.	G	A	0	2	2	0	5	7	0	0
25	664590	.	A	C	1	1	2	0	0	2	0	0
25	713080	.	T	G	1	3	4	0	0	4	0	0
25	763774	.	T	C	1	5	6	0	0	6	0	0
25	769484	.	A	G	2	2	4	0	0	4	0	0
25	824627	.	C	T	1	0	1	0	0	1	0	0
25	824774	.	C	T	3	3	6	0	0	6	0	0
25	824807	.	G	A	4	3	7	0	0	7	0	0
25	824881	.	G	T	5	6	11	0	0	11	0	0
25	824909	.	G	A	6	8	14	0	1	15	0	0
25	825656	.	G	A	3	4	7	0	1	8	0	0
25	825704	.	A	C	2	0	2	0	2	4	0	0
25	825746	.	T	C	4	0	4	0	3	7	0	0
25	825805	.	G	T	1	2	3	0	0	3	0	0
25	825842	.	T	A	1	5	6	0	0	6	0	0
25	825866	.	G	A	2	7	9	0	0	9	0	0
25	825902	.	G	T	9	5	14	0	0	14	0	0
25	825968	.	A	C	3	7	10	0	0	10	0	0
25	826445	.	G	T	1	3	4	0	0	4	0	0
25	826722	.	C	T	1	3	4	0	0	4	0	0
25	827027	.	C	T	2	3	5	0	0	5	0	0
25	827246	.	A	G	1	2	3	0	1	4	0	0
25	827255	.	G	A	4	2	6	0	0	6	0	0
25	946980	.	T	C	2	3	5	0	0	5	0	0
25	997618	.	C	T	1	3	4	0	1	5	0	0
25	1048504	.	A	G	4	4	8	0	0	8	0	0
25	1048512	.	T	A	3	5	8	0	0	8	0	0
25	1048654	.	A	C	1	1	2	0	1	3	0	0
25	1048759	.	C	T	2	2	4	0	0	4	0	0
25	1055072	.	G	A	0	2	2	0	0	2	0	0
25	1089010	.	G	A	11	8	19	0	0	19	0	0
25	1089026	.	G	A	6	7	13	0	0	13	0	0
25	1091806	.	G	A	0	1	1	0	0	1	0	0
25	1092442	.	C	A	0	6	6	0	3	9	0	0
25	1092451	.	C	T	4	2	6	0	0	6	0	0
25	1093520	.	G	A	5	7	12	0	0	12	0	0
25	1093567	.	G	A	0	1	1	0	0	1	0	0
25	1101431	.	A	G	1	2	3	0	0	3	0	0
25	1101659	.	A	G	3	8	11	0	1	12	0	0
25	1101704	.	C	G	5	6	11	0	0	11	0	0
25	1101707	.	G	A	5	5	10	0	0	10	0	0
25	1102626	.	G	T	1	3	4	0	2	6	0	0
25	1102731	.	C	T	1	1	2	0	0	2	0	0
25	1104000	.	T	C	5	1	6	0	0	6	0	0
25	1106187	.	G	A	6	5	11	0	0	11	0	0
25	1106247	.	C	G	5	4	9	0	0	9	0	0
25	1107992	.	G	A	3	6	9	0	2	11	0	0
25	1108057	.	T	C	1	0	1	0	3	4	0	0
25	1108210	.	G	A	1	2	3	0	0	3	0	0
25	1112164	.	G	T	1	0	1	0	0	1	0	0
25	1118764	.	T	C	1	0	1	0	3	4	0	0
25	1124405	.	C	T	0	3	3	0	1	4	0	0
25	1124488	.	C	G	5	4	9	0	0	9	0	0
25	1132509	.	G	A	3	12	15	0	2	17	0	0
25	1132543	.	G	A	5	10	15	0	2	17	0	0
25	1220400	.	G	T	2	0	2	0	0	2	0	0
25	1304556	.	G	A	7	7	14	0	0	14	0	0
25	1305338	.	T	G	8	8	16	0	0	16	0	0
25	1335681	.	G	A	3	5	8	0	0	8	0	0
25	1335805	.	T	C	4	2	6	0	0	6	0	0
25	1335814	.	T	C	4	2	6	0	0	6	0	0
25	1335847	.	A	G	2	3	5	0	0	5	0	0
25	1338263	.	C	T	4	3	7	0	0	7	0	0
25	1338689	.	T	C	2	2	4	0	0	4	0	0
25	1338860	.	T	A	4	2	6	0	0	6	0	0
25	1339403	.	C	T	4	9	13	0	2	15	0	0
25	1339601	.	G	T	0	4	4	0	6	10	0	0
25	1339760	.	C	T	8	5	13	0	0	13	0	0
25	1340021	.	A	G	1	0	1	0	3	4	0	0
25	1340042	.	C	T	1	3	4	0	0	4	0	0
25	1340215	.	G	A	4	6	10	0	0	10	0	0
25	1354315	.	A	G	0	3	3	0	0	3	0	0
25	1644857	.	C	T	0	2	2	0	0	2	0	0
25	2253135	.	T	C	2	2	4	0	1	5	0	0
25	2264091	.	C	A	2	3	5	0	0	5	0	0
25	2264112	.	T	C	2	3	5	0	0	5	0	0
25	2264824	.	A	C	1	2	3	0	2	5	0	0
25	2264830	.	A	G	3	3	6	0	0	6	0	0
25	2264875	.	C	A	3	1	4	0	1	5	0	0
25	2273945	.	C	T	1	3	4	0	1	5	0	0
25	2276704	.	C	T	2	1	3	0	2	5	0	0
25	2276770	.	T	C	3	1	4	0	1	5	0	0
25	2276781	.	A	G	3	3	6	0	0	6	0	0
25	2276828	.	T	A	2	4	6	0	1	7	0	0
25	2276869	.	C	T	2	6	8	0	1	9	0	0
25	2282566	.	A	G	10	3	13	0	11	24	0	0
25	2282846	.	A	C	17	15	32	0	0	32	0	0
25	2286066	.	C	T	4	6	10	0	0	10	0	0
25	2286120	.	G	A	10	9	19	0	0	19	0	0
25	2286328	.	T	G	4	1	5	0	1	6	0	0
25	2286376	.	T	C	2	3	5	0	0	5	0	0
25	2286502	.	T	C	13	10	23	0	0	23	0	0
25	2286600	.	A	T	6	12	18	0	2	20	0	0
25	2286762	.	A	C	4	10	14	0	2	16	0	0
25	2286798	.	A	C	10	11	21	0	0	22	1	0
25	2286837	.	C	T	12	7	19	0	0	19	0	0
25	2286841	.	C	A	12	5	17	0	1	18	0	0
25	2702718	.	A	G	5	0	5	0	5	10	0	0
25	2702722	.	A	G	4	8	12	0	0	12	0	0
25	2706818	.	C	A	2	3	5	0	0	5	0	0
25	3246593	.	A	G	7	4	11	0	0	11	0	0
25	4689688	.	A	G	3	2	5	0	0	5	0	0
25	4708086	.	A	C	1	1	2	0	3	5	0	0
25	4850989	.	G	A	2	31	33	0	3	36	0	0
25	4874057	.	C	A	1	2	3	0	0	3	0	0
25	5676227	.	C	T	3	0	3	0	0	3	0	0
25	5676235	.	C	T	3	0	3	0	0	3	0	0
25	6403890	.	T	C	3	2	5	0	1	6	0	0
25	7229255	.	T	A	9	5	14	0	1	15	0	0
25	7230239	.	T	C	6	7	13	0	0	13	0	0
25	7324580	.	C	T	3	0	3	0	0	3	0	0
25	7327718	.	C	T	12	16	28	1	0	29	0	0
25	7333751	.	G	A	15	18	33	0	0	33	0	0
25	7333841	.	C	T	17	8	25	0	1	26	0	0
25	7334900	.	A	G	7	0	7	0	3	10	0	0
25	7334951	.	T	C	19	11	30	0	0	30	0	0
25	7334987	.	G	C	6	8	14	0	0	14	0	0
25	7336096	.	T	A	10	7	17	0	1	18	0	0
25	7398977	.	C	A	3	1	4	0	1	5	0	0
25	7400872	.	T	A	2	2	4	0	1	5	0	0
25	7401054	.	C	T	3	3	6	0	0	6	0	0
25	7401539	.	C	T	2	3	5	0	0	5	0	0
25	7401580	.	A	G	0	2	2	0	2	4	0	0
25	7410399	.	A	G	6	3	9	0	0	9	0	0
25	7410558	.	C	A	4	5	9	0	0	9	0	0
25	7410822	.	G	A	0	3	3	0	2	5	0	0
25	7412640	.	T	G	4	5	9	0	1	10	0	0
25	7412985	.	C	T	5	8	13	0	0	13	0	0
25	7413288	.	T	A	5	2	7	0	0	7	0	0
25	7413501	.	C	T	2	2	4	0	0	4	0	0
25	7413736	.	G	T	1	2	3	0	0	3	0	0
25	7428932	.	A	C	0	4	4	0	1	5	0	0
25	7428971	.	A	T	2	1	3	0	1	4	0	0
25	7429028	.	C	A	2	0	2	0	1	3	0	0
25	7439859	.	T	C	2	2	4	0	0	4	0	0
25	7445883	.	G	C	0	4	4	0	0	4	0	0
25	7451133	.	C	A	4	4	8	0	0	8	0	0
25	7454578	.	T	C	5	5	10	0	2	12	0	0
25	7454599	.	T	C	5	7	12	0	0	12	0	0
25	7456535	.	C	A	1	2	3	0	0	3	0	0
25	7456843	.	G	A	0	2	2	0	1	3	0	0
25	7456860	.	G	A	0	0	0	0	1	1	0	0
25	7458924	.	G	A	5	3	8	0	0	8	0	0
25	7477641	.	C	T	6	9	15	0	0	15	0	0
25	7487835	.	G	C	28	21	49	0	0	49	0	0
25	7488407	.	T	C	18	27	45	0	0	45	0	0
25	7488599	.	G	T	21	16	37	0	0	37	0	0
25	7488660	.	C	T	26	7	33	0	0	33	0	0
25	7488812	.	G	A	30	18	48	0	3	51	0	0
25	7488813	.	G	T	29	18	47	0	4	51	0	0
25	7489011	.	A	T	27	27	54	0	3	57	0	0
25	7489034	.	G	A	1	29	30	0	18	48	0	0
25	7489197	.	G	T	11	23	34	0	1	35	0	0
25	7492888	.	C	T	9	9	18	0	1	19	0	0
25	7492927	.	T	A	8	4	12	0	0	12	0	0
25	7494243	.	G	A	0	9	9	0	7	16	0	0
25	7496003	.	C	T	1	5	6	0	0	6	0	0
25	7496021	.	C	T	2	4	6	0	0	6	0	0
25	7496039	.	C	T	4	5	9	0	0	9	0	0
25	7496992	.	G	C	0	4	4	0	8	12	0	0
25	7500473	.	T	C	8	7	15	0	0	15	0	0
25	7501997	.	G	A	11	16	27	0	0	27	0	0
25	7502022	.	G	C	14	13	27	0	0	27	0	0
25	7502119	.	T	C	12	6	18	0	0	18	0	0
25	7502241	.	G	A	0	2	2	0	0	2	0	0
25	7502271	.	T	G	2	2	4	0	6	10	0	0
25	7890372	.	T	C	0	3	3	0	0	3	0	0
25	7891965	.	T	C	4	3	7	0	0	7	0	0
25	7892311	.	T	C	6	2	8	0	1	9	0	0
25	8627941	.	T	C	5	0	5	0	7	12	0	0
25	8627943	.	T	C	4	8	12	0	0	12	0	0
25	8916632	.	G	A	1	6	7	0	0	7	0	0
25	9678666	.	G	A	10	10	20	0	0	20	0	0
25	9679242	.	G	A	13	12	25	0	1	26	0	0
25	9679389	.	G	A	10	7	17	0	1	18	0	0
25	9679413	.	C	T	0	8	8	0	9	17	0	0
25	9679539	.	T	C	4	5	9	0	1	10	0	0
25	9680022	.	T	C	9	7	16	0	0	16	0	0
25	9680196	.	T	A	4	3	7	0	0	7	0	0
25	9680448	.	A	G	2	5	7	0	1	8	0	0
25	9805253	.	G	C	6	7	13	0	0	13	0	0
25	9805257	.	G	C	6	6	12	0	1	13	0	0
25	11538805	.	T	C	1	2	3	0	0	3	0	0
25	11538838	.	T	C	1	0	1	0	0	1	0	0
25	11702910	.	T	C	1	3	4	0	0	4	0	0
25	11796531	.	T	C	11	1	12	0	8	20	0	0
25	11796579	.	T	A	15	15	30	0	0	30	0	0
25	11796728	.	A	T	13	13	26	0	0	26	0	0
25	11796860	.	T	C	15	11	26	0	1	27	0	0
25	11796987	.	A	G	10	5	15	0	0	15	0	0
25	11797056	.	G	C	6	6	12	0	1	13	0	0
25	11797515	.	A	G	11	8	19	0	1	20	0	0
25	11797550	.	G	T	11	6	17	0	2	19	0	0
25	11797789	.	A	T	5	4	9	0	0	9	0	0
25	11797979	.	A	G	4	6	10	0	0	10	0	0
25	11797990	.	A	G	4	6	10	0	0	10	0	0
25	11798081	.	T	C	9	0	9	0	7	16	0	0
25	11798215	.	A	C	6	2	8	0	0	8	0	0
25	11798227	.	T	A	5	3	8	0	1	9	0	0
25	11798333	.	A	T	6	11	17	0	0	17	0	0
25	11798381	.	T	A	6	12	18	0	1	19	0	0
25	11798509	.	A	T	3	5	8	0	0	8	0	0
25	11798511	.	C	A	0	5	5	0	3	8	0	0
25	11798598	.	C	T	2	2	4	0	2	6	0	0
25	11798659	.	A	T	6	4	10	0	0	10	0	0
25	11798863	.	G	C	2	4	6	0	0	6	0	0
25	11798922	.	A	G	4	6	10	0	0	10	0	0
25	11799527	.	A	T	7	11	18	0	0	18	0	0
25	11799577	.	G	A	5	6	11	0	1	12	0	0
25	11799625	.	A	T	5	6	11	0	1	12	0	0
25	11799670	.	G	T	3	3	6	0	0	6	0	0
25	11799685	.	A	G	3	2	5	0	0	5	0	0
25	11800098	.	G	C	3	4	7	0	1	8	0	0
25	11800140	.	A	G	4	8	12	0	0	12	0	0
25	11800358	.	C	A	2	3	5	0	0	5	0	0
25	11800522	.	G	A	10	6	16	0	1	17	0	0
25	11800652	.	C	T	0	8	8	0	7	15	0	0
25	11800883	.	C	T	8	5	13	0	0	13	0	0
25	11801111	.	C	A	7	8	15	0	1	16	0	0
25	11801513	.	A	C	3	4	7	0	0	7	0	0
25	11801642	.	C	G	5	6	11	0	0	11	0	0
25	11801731	.	C	G	4	2	6	0	0	6	0	0
25	11801838	.	A	C	4	0	4	0	7	11	0	0
25	11801841	.	G	T	4	3	7	0	3	10	0	0
25	11802044	.	A	G	2	4	6	0	0	6	0	0
25	11802066	.	C	G	3	2	5	0	0	5	0	0
25	11802115	.	C	A	4	3	7	0	0	7	0	0
25	11802192	.	T	A	9	6	15	0	0	15	0	0
25	11802306	.	C	A	0	6	6	0	6	12	0	0
25	11802485	.	C	T	0	7	7	0	4	11	0	0
25	11803455	.	G	T	6	6	12	0	0	12	0	0
25	11803467	.	A	T	6	6	12	0	0	12	0	0
25	11804330	.	C	G	0	3	3	0	4	7	0	0
25	11804490	.	T	G	3	6	9	0	0	9	0	0
25	11804688	.	T	G	1	6	7	0	0	7	0	0
25	11804969	.	T	A	3	4	7	0	0	7	0	0
25	11805417	.	C	T	3	2	5	0	1	6	0	0
25	11805675	.	T	A	3	2	5	0	1	6	0	0
25	11806125	.	C	T	2	3	5	0	0	5	0	0
25	11833526	.	G	A	1	7	8	0	0	8	0	0
25	12008336	.	A	G	1	3	4	0	0	4	0	0
25	12842025	.	T	C	1	2	3	0	0	3	0	0
25	12853318	.	C	A	22	6	28	0	1	29	0	0
25	12853640	.	G	A	42	12	54	0	2	56	0	0
25	12853691	.	C	T	16	32	48	0	3	51	0	0
25	12853811	.	G	A	20	13	33	0	0	33	0	0
25	12853971	.	T	A	16	30	46	0	1	47	0	0
25	12854112	.	C	T	43	12	55	0	0	55	0	0
25	12854201	.	C	T	16	15	31	1	1	33	0	0
25	12854266	.	A	T	13	17	30	0	1	31	0	0
25	13104333	.	C	A	0	2	2	0	5	7	0	0
25	13104393	.	T	C	6	6	12	0	0	12	0	0
25	13105061	.	A	G	2	4	6	0	1	7	0	0
25	13332531	.	C	T	28	30	58	0	4	62	0	0
25	13332693	.	G	A	31	43	74	0	2	76	0	0
25	13332737	.	A	G	39	33	72	0	10	82	0	0
25	13333027	.	A	G	36	26	62	0	6	68	0	0
25	13333287	.	A	G	29	35	64	0	7	71	0	0
25	13333986	.	T	A	36	43	79	0	4	83	0	0
25	13333994	.	C	T	36	46	82	0	3	85	0	0
25	13334023	.	T	A	34	33	67	0	2	69	0	0
25	13334049	.	A	T	34	29	63	0	3	66	0	0
25	13334061	.	A	G	31	30	61	0	4	65	0	0
25	13334334	.	A	T	33	24	57	0	2	59	0	0
25	13334371	.	T	C	32	29	61	0	2	63	0	0
25	13334397	.	C	G	30	35	65	0	1	66	0	0
25	13334429	.	T	C	29	28	57	0	4	61	0	0
25	13334526	.	A	G	38	17	55	0	3	58	0	0
25	13334537	.	T	C	41	0	41	0	12	53	0	0
25	13334589	.	C	T	41	13	54	0	1	55	0	0
25	13334729	.	C	T	31	43	74	0	3	77	0	0
25	13335021	.	G	T	36	24	60	0	3	63	0	0
25	13335059	.	G	C	33	19	52	0	2	54	0	0
25	13335078	.	A	G	30	12	42	0	0	42	0	0
25	13335185	.	A	G	24	36	60	0	7	67	0	0
25	13335225	.	T	C	27	27	54	0	5	60	1	0
25	13335331	.	T	C	27	28	55	0	0	55	0	0
25	13335359	.	C	T	0	29	29	0	32	61	0	0
25	13335524	.	T	C	26	27	53	0	6	59	0	0
25	13335892	.	A	G	22	32	54	0	1	55	0	0
25	13335897	.	T	C	23	28	51	0	2	53	0	0
25	13336391	.	G	A	24	48	72	0	1	73	0	0
25	13336409	.	A	C	23	40	63	0	5	68	0	0
25	13336755	.	G	T	30	38	68	0	4	72	0	0
25	13336780	.	A	G	28	35	63	0	2	66	1	0
25	13336815	.	T	A	26	35	61	0	2	63	0	0
25	13336967	.	T	A	15	35	50	0	3	53	0	0
25	13337044	.	G	A	31	26	57	0	5	62	0	0
25	13337136	.	A	G	30	33	63	0	3	66	0	0
25	13350259	.	A	G	4	6	10	0	0	10	0	0
25	13351894	.	T	A	7	8	15	0	4	19	0	0
25	13352304	.	T	A	0	0	0	0	1	1	0	0
25	13352316	.	A	G	0	1	1	0	0	1	0	0
25	13353747	.	G	A	18	7	25	0	1	26	0	0
25	13400216	.	A	G	1	3	4	0	0	4	0	0
25	13469844	.	A	G	9	1	10	0	15	25	0	0
25	13469858	.	T	C	10	10	20	0	1	21	0	0
25	13470424	.	C	T	13	11	24	0	0	24	0	0
25	13470430	.	A	T	12	14	26	0	0	26	0	0
25	13470544	.	A	T	7	6	13	0	0	13	0	0
25	13471127	.	A	G	14	0	14	0	15	29	0	0
25	13474146	.	C	A	1	4	5	0	0	5	0	0
25	13474246	.	C	T	1	2	3	0	0	3	0	0
25	13474362	.	C	G	3	7	10	0	0	10	0	0
25	13474411	.	A	G	1	7	8	0	0	8	0	0
25	13486323	.	C	T	0	1	1	0	1	2	0	0
25	13509942	.	T	A	5	4	9	0	0	9	0	0
25	13510356	.	A	G	8	3	11	0	0	11	0	0
25	13525164	.	A	T	5	6	11	0	1	12	0	0
25	13525295	.	C	G	11	11	22	0	1	23	0	0
25	13525407	.	G	A	11	12	23	0	0	23	0	0
25	13525453	.	C	T	12	11	23	0	1	24	0	0
25	13525521	.	A	C	6	9	15	0	1	16	0	0
25	13525633	.	A	C	8	4	12	0	0	12	0	0
25	13525848	.	A	T	13	11	24	0	0	24	0	0
25	13525864	.	G	A	13	15	28	0	1	29	0	0
25	13525890	.	A	C	15	14	29	0	1	30	0	0
25	13526171	.	A	C	15	10	25	0	0	25	0	0
25	13528361	.	G	A	2	2	4	0	0	4	0	0
25	13529294	.	A	G	3	5	8	0	0	8	0	0
25	13536504	.	T	A	1	2	3	0	0	3	0	0
25	13559168	.	T	G	3	3	6	0	0	6	0	0
25	13559194	.	G	A	4	7	11	0	0	11	0	0
25	13559220	.	G	A	6	13	19	0	1	20	0	0
25	13559446	.	T	A	5	13	18	0	1	19	0	0
25	13559500	.	T	C	4	10	14	0	0	14	0	0
25	13559723	.	T	A	4	7	11	0	1	12	0	0
25	13559740	.	A	G	4	5	9	0	1	10	0	0
25	13559760	.	T	C	4	0	4	0	4	8	0	0
25	13559844	.	C	T	0	11	11	0	10	21	0	0
25	13559953	.	A	T	5	7	12	0	2	14	0	0
25	13560080	.	C	T	4	8	12	0	0	12	0	0
25	13560136	.	C	T	2	3	5	0	2	7	0	0
25	13560149	.	C	T	5	3	8	0	1	9	0	0
25	13560186	.	A	G	6	3	9	0	0	9	0	0
25	13560207	.	T	C	6	4	10	0	0	10	0	0
25	13560547	.	C	T	0	11	11	0	7	18	0	0
25	13560576	.	C	T	3	11	14	0	0	14	0	0
25	13560598	.	T	G	1	10	11	0	0	11	0	0
25	13561133	.	T	C	2	5	7	0	0	7	0	0
25	13561149	.	T	C	2	5	7	0	0	7	0	0
25	13561296	.	A	G	6	5	11	0	0	11	0	0
25	13561775	.	C	A	0	4	4	0	5	9	0	0
25	13561851	.	A	C	4	3	7	0	0	7	0	0
25	13562066	.	G	A	1	3	4	0	0	4	0	0
25	13562371	.	G	A	1	4	5	0	0	5	0	0
25	13562742	.	T	C	2	0	2	0	4	6	0	0
25	13614475	.	G	C	3	0	3	0	4	7	0	0
25	13614509	.	C	G	3	3	6	0	1	7	0	0
25	13614536	.	C	T	1	4	5	0	1	6	0	0
25	13645911	.	C	T	5	2	7	0	1	8	0	0
25	13646153	.	G	A	2	2	4	0	0	4	0	0
25	13651394	.	A	T	1	8	9	0	0	9	0	0
25	13658316	.	C	T	0	9	9	0	9	18	0	0
25	13658940	.	G	A	7	3	10	0	3	13	0	0
25	13659075	.	T	A	9	12	21	0	1	22	0	0
25	13672106	.	T	A	6	4	10	0	1	11	0	0
25	13672111	.	A	T	7	4	11	0	1	12	0	0
25	13672296	.	T	G	6	3	9	0	0	9	0	0
25	13672349	.	G	A	4	3	7	0	0	7	0	0
25	13672591	.	T	G	1	4	5	0	0	5	0	0
25	13672592	.	A	G	1	3	4	0	1	5	0	0
25	13672629	.	A	C	5	4	9	0	1	10	0	0
25	13673119	.	A	G	7	3	10	0	2	12	0	0
25	13673377	.	A	G	4	2	6	0	0	6	0	0
25	13674202	.	A	G	5	5	10	0	0	10	0	0
25	13674214	.	A	G	7	5	12	0	0	12	0	0
25	13677352	.	G	A	0	3	3	0	2	5	0	0
25	13677396	.	A	G	1	5	6	0	1	7	0	0
25	13686607	.	A	G	1	2	3	0	1	4	0	0
25	13686608	.	T	C	2	2	4	0	0	4	0	0
25	13689166	.	G	A	1	2	3	0	1	4	0	0
25	13689341	.	T	C	2	6	8	0	0	8	0	0
25	13689359	.	C	A	3	5	8	0	0	8	0	0
25	13689575	.	A	G	7	5	12	0	0	12	0	0
25	13689612	.	A	G	6	4	10	0	0	10	0	0
25	13689617	.	C	A	6	3	9	0	0	9	0	0
25	13695726	.	G	A	2	0	2	0	0	2	0	0
25	13695768	.	A	G	4	1	5	0	0	5	0	0
25	13698970	.	G	A	0	2	2	0	1	3	0	0
25	13744547	.	G	T	2	2	4	0	0	4	0	0
25	13745659	.	A	G	27	37	64	0	0	64	0	0
25	13745665	.	A	G	22	37	59	0	4	63	0	0
25	13745776	.	A	G	4	9	13	0	1	14	0	0
25	13745788	.	A	C	0	0	0	0	3	3	0	0
25	13747722	.	G	C	23	2	25	0	15	40	0	0
25	13747948	.	T	C	19	0	19	0	23	42	0	0
25	13750734	.	T	A	13	7	20	0	2	22	0	0
25	13754015	.	A	G	4	1	5	0	0	5	0	0
25	13754094	.	T	A	21	22	43	0	1	45	1	0
25	13754338	.	T	G	0	1	1	0	0	1	0	0
25	13754359	.	A	G	3	6	9	0	0	9	0	0
25	13759547	.	G	A	6	7	13	0	1	14	0	0
25	13762889	.	T	C	1	3	4	0	1	5	0	0
25	13763626	.	A	G	4	4	8	0	0	8	0	0
25	13763641	.	C	T	2	2	4	0	0	4	0	0
25	13767612	.	G	A	9	11	20	0	1	21	0	0
25	13767726	.	G	A	2	1	3	0	0	3	0	0
25	13768396	.	G	A	4	3	7	0	0	7	0	0
25	13768547	.	A	G	3	2	5	0	0	5	0	0
25	13774036	.	C	T	1	0	1	0	0	1	0	0
25	13774400	.	G	A	5	0	5	0	0	5	0	0
25	13775158	.	A	G	2	1	3	0	0	3	0	0
25	13776771	.	T	A	2	1	3	0	0	3	0	0
25	13777997	.	T	A	2	3	5	0	1	6	0	0
25	13780322	.	C	G	4	8	12	0	0	12	0	0
25	13782361	.	T	C	2	1	3	0	0	3	0	0
25	13782376	.	A	G	3	1	4	0	0	4	0	0
25	13782544	.	A	G	1	1	2	0	0	2	0	0
25	13787514	.	A	T	2	1	3	0	0	3	0	0
25	13791853	.	A	C	8	9	17	0	0	17	0	0
25	13795332	.	G	A	1	1	2	0	1	3	0	0
25	13795440	.	T	C	15	13	28	0	3	31	0	0
25	13795441	.	G	A	17	12	29	0	1	31	1	0
25	13795494	.	A	G	6	6	12	0	0	12	0	0
25	13796379	.	T	C	1	2	3	0	0	3	0	0
25	13799172	.	G	A	4	1	5	0	1	6	0	0
25	13799689	.	C	T	8	18	26	0	3	29	0	0
25	13801895	.	G	C	20	13	33	0	3	36	0	0
25	13801933	.	C	T	14	13	27	0	4	31	0	0
25	13802100	.	C	T	20	13	33	0	5	38	0	0
25	13802235	.	T	A	13	8	21	0	0	21	0	0
25	13802673	.	C	T	2	15	17	0	7	24	0	0
25	13802688	.	C	A	12	16	28	0	2	30	0	0
25	13802710	.	C	T	13	18	31	0	0	31	0	0
25	13802918	.	A	G	15	22	37	0	0	37	0	0
25	13802940	.	A	T	17	18	35	0	0	35	0	0
25	13803710	.	A	G	13	18	31	0	0	31	0	0
25	13803712	.	T	G	13	18	31	0	0	31	0	0
25	13803895	.	A	G	15	12	27	0	2	29	0	0
25	13803903	.	C	T	14	15	29	0	1	30	0	0
25	13804056	.	C	T	8	14	22	0	2	25	1	0
25	13804097	.	T	A	10	19	29	0	1	30	0	0
25	13804216	.	C	T	13	12	25	0	1	26	0	0
25	13813656	.	A	G	9	7	16	0	0	16	0	0
25	13813659	.	G	A	9	8	17	0	0	17	0	0
25	13815325	.	G	A	8	4	12	0	0	12	0	0
25	13815361	.	A	G	8	14	22	0	0	22	0	0
25	13816724	.	G	A	6	17	23	0	1	24	0	0
25	13816840	.	C	T	2	5	7	0	8	15	0	0
25	13817135	.	C	G	6	8	14	0	0	14	0	0
25	13817243	.	C	T	0	1	1	0	4	5	0	0
25	13821187	.	C	T	3	2	5	0	0	5	0	0
25	13846984	.	A	G	3	5	8	0	2	10	0	0
25	13847533	.	A	G	11	9	20	0	3	23	0	0
25	13848801	.	G	A	13	16	29	0	3	32	0	0
25	13848930	.	A	G	2	8	10	0	0	10	0	0
25	13850757	.	A	C	6	2	8	0	0	8	0	0
25	13854838	.	G	A	14	8	22	0	0	22	0	0
25	13855707	.	T	A	11	9	20	0	0	20	0	0
25	13856023	.	C	A	0	9	9	0	3	12	0	0
25	13871070	.	C	T	7	10	17	0	0	17	0	0
25	14018007	.	T	C	6	8	14	0	1	15	0	0
25	14019921	.	G	A	1	12	13	0	6	19	0	0
25	14020923	.	C	A	1	1	2	0	2	4	0	0
25	14020924	.	A	C	1	3	4	0	0	4	0	0
25	14021062	.	A	G	3	2	5	0	0	5	0	0
25	14021070	.	T	C	3	2	5	0	0	5	0	0
25	14033268	.	T	C	17	16	33	0	0	33	0	0
25	14033670	.	T	G	5	9	14	0	1	15	0	0
25	14033867	.	A	G	6	7	13	0	0	13	0	0
25	14033914	.	G	A	6	4	10	0	2	12	0	0
25	14033984	.	G	T	4	7	11	0	1	12	0	0
25	14034065	.	T	C	6	3	9	0	0	9	0	0
25	14034240	.	G	C	16	15	31	0	1	32	0	0
25	14034398	.	C	T	13	4	17	0	0	17	0	0
25	14034406	.	G	A	15	5	20	0	0	20	0	0
25	14034512	.	C	T	14	8	22	0	1	23	0	0
25	14034513	.	T	A	14	9	23	0	0	23	0	0
25	14034620	.	A	G	8	10	18	0	2	20	0	0
25	14034667	.	C	T	9	12	21	0	0	21	0	0
25	14034725	.	T	A	13	4	17	0	0	17	0	0
25	14034881	.	T	C	7	12	19	0	0	19	0	0
25	14034911	.	C	G	6	8	14	0	2	16	0	0
25	14035012	.	T	G	8	10	18	0	0	18	0	0
25	14035017	.	T	A	8	10	18	0	0	18	0	0
25	14035229	.	C	T	9	6	15	0	0	15	0	0
25	14035247	.	T	G	9	4	13	0	0	13	0	0
25	14035414	.	A	T	8	8	16	0	2	18	0	0
25	14035500	.	T	G	10	6	16	0	0	16	0	0
25	14035559	.	T	G	8	7	15	0	1	16	0	0
25	14035684	.	A	C	1	2	3	0	0	3	0	0
25	14035833	.	A	C	3	5	8	0	0	8	0	0
25	14035834	.	A	T	3	5	8	0	0	8	0	0
25	14035908	.	A	C	10	5	15	0	0	15	0	0
25	14035990	.	T	C	2	0	2	0	7	9	0	0
25	14361812	.	C	T	13	5	18	0	2	20	0	0
25	14363216	.	C	T	12	11	23	0	4	27	0	0
25	14363291	.	T	A	9	9	18	0	0	18	0	0
25	14363572	.	G	T	9	11	20	0	1	21	0	0
25	14365546	.	G	A	3	1	4	0	0	4	0	0
25	14365781	.	C	T	11	13	24	0	0	24	0	0
25	14365834	.	C	T	14	12	26	0	0	26	0	0
25	14366056	.	T	A	12	9	21	0	1	23	1	0
25	14369587	.	G	T	10	3	13	0	0	13	0	0
25	14369631	.	C	T	7	10	17	0	0	17	0	0
25	14369712	.	G	A	12	7	19	0	2	21	0	0
25	14369869	.	T	A	5	4	9	0	1	10	0	0
25	14369883	.	T	C	6	0	6	0	8	14	0	0
25	14381497	.	T	G	6	2	8	0	0	8	0	0
25	14381513	.	G	T	7	3	10	0	1	11	0	0
25	14381583	.	A	G	12	18	30	0	0	30	0	0
25	14381763	.	G	A	14	9	23	0	0	23	0	0
25	14384028	.	G	T	15	15	30	0	1	31	0	0
25	14387616	.	C	T	2	4	6	0	0	6	0	0
25	14388955	.	A	T	8	4	12	0	0	12	0	0
25	14392808	.	C	G	9	15	24	0	0	24	0	0
25	14393533	.	A	G	6	5	11	0	0	11	0	0
25	14398703	.	A	C	1	2	3	0	0	3	0	0
25	14398744	.	A	T	1	0	1	0	0	1	0	0
25	14401150	.	C	T	4	3	7	0	0	7	0	0
25	14401219	.	C	A	5	7	12	0	0	12	0	0
25	14403369	.	T	C	14	7	21	0	0	21	0	0
25	14403404	.	C	T	2	6	8	0	1	9	0	0
25	14406621	.	T	C	3	6	9	0	0	9	0	0
25	14406649	.	A	T	5	7	12	0	0	12	0	0
25	14409257	.	A	C	3	0	3	0	5	8	0	0
25	14409642	.	G	A	0	1	1	0	0	1	0	0
25	14409936	.	T	C	3	1	4	0	1	5	0	0
25	14426344	.	A	C	1	2	3	0	0	3	0	0
25	14510031	.	G	A	0	3	3	0	2	5	0	0
25	14511319	.	T	A	2	2	4	0	0	4	0	0
25	14511322	.	T	C	2	0	2	0	2	4	0	0
25	14511458	.	T	A	4	3	7	0	0	7	0	0
25	14511470	.	G	T	2	3	5	0	0	5	0	0
25	14511493	.	G	T	5	2	7	0	0	7	0	0
25	14511605	.	T	A	2	2	4	0	0	4	0	0
25	14513992	.	C	T	3	2	5	0	0	5	0	0
25	14518815	.	A	G	1	2	3	0	0	3	0	0
25	14694979	.	T	C	7	3	10	0	0	10	0	0
25	14695065	.	T	C	6	2	8	0	0	8	0	0
25	14695092	.	C	T	3	4	7	0	1	8	0	0
25	14695122	.	A	G	1	0	1	0	4	5	0	0
25	14702821	.	C	T	7	5	12	1	1	14	0	0
25	14733824	.	C	T	0	5	5	0	0	5	0	0
25	14734122	.	A	G	2	1	3	0	1	4	0	0
25	14738298	.	T	C	1	4	5	0	0	5	0	0
25	14738462	.	T	A	2	2	4	0	1	5	0	0
25	14738535	.	A	T	4	3	7	0	0	7	0	0
25	14738541	.	T	C	4	4	8	0	0	8	0	0
25	14870811	.	T	C	1	2	3	0	0	3	0	0
25	15029225	.	C	T	3	8	11	0	1	12	0	0
25	15031851	.	A	G	1	2	3	0	0	3	0	0
25	15032087	.	A	G	9	4	13	0	0	13	0	0
25	15034012	.	C	T	0	3	3	0	3	6	0	0
25	15045221	.	T	A	2	4	6	0	0	6	0	0
25	15273455	.	A	T	7	4	11	0	0	11	0	0
25	15275985	.	G	A	1	0	1	0	1	2	0	0
25	15276105	.	T	C	4	13	17	0	1	18	0	0
25	15281889	.	C	T	7	11	18	0	0	18	0	0
25	15281891	.	A	G	7	11	18	0	0	18	0	0
25	15284485	.	T	C	12	6	18	0	0	18	0	0
25	15284644	.	C	G	8	0	8	0	8	16	0	0
25	15284734	.	G	T	12	20	32	0	1	33	0	0
25	15284799	.	C	T	10	15	25	0	1	26	0	0
25	15284862	.	T	C	9	16	25	0	0	25	0	0
25	15284959	.	T	C	8	19	27	0	0	27	0	0
25	15285004	.	A	C	9	16	25	0	0	25	0	0
25	15285092	.	T	C	11	10	21	0	0	21	0	0
25	15285105	.	C	A	10	10	20	0	0	20	0	0
25	15285213	.	G	C	10	11	21	0	1	22	0	0
25	15285256	.	T	A	8	16	24	0	1	25	0	0
25	15285470	.	C	T	2	4	6	0	2	8	0	0
25	15285471	.	C	A	3	5	8	0	0	8	0	0
25	15342700	.	G	A	3	2	5	0	0	5	0	0
25	15343016	.	C	A	3	5	8	0	0	8	0	0
25	15345474	.	C	A	3	2	5	0	2	7	0	0
25	15347416	.	A	G	4	0	4	0	10	14	0	0
25	15347460	.	G	A	1	2	3	0	5	8	0	0
25	15347613	.	A	G	3	0	3	0	4	7	0	0
25	15347688	.	G	A	1	5	6	0	0	6	0	0
25	15348263	.	A	T	2	3	5	0	0	5	0	0
25	15348359	.	A	G	3	3	6	0	0	6	0	0
25	15350012	.	A	G	3	3	6	0	1	7	0	0
25	15350016	.	G	A	4	4	8	0	0	8	0	0
25	15350058	.	A	G	5	8	13	0	1	14	0	0
25	15350402	.	T	G	6	5	11	0	0	11	0	0
25	15350467	.	T	C	6	3	9	0	0	9	0	0
25	15351088	.	A	G	4	10	14	0	0	14	0	0
25	15354333	.	G	T	11	10	21	0	0	21	0	0
25	15354360	.	C	T	10	8	18	0	0	18	0	0
25	15404898	.	G	A	13	15	28	0	1	29	0	0
25	15408820	.	G	A	1	16	17	0	20	37	0	0
25	15409013	.	T	C	13	12	25	0	0	25	0	0
25	15430310	.	T	C	5	14	19	0	3	22	0	0
25	15430334	.	T	C	7	4	11	0	0	11	0	0
25	15432769	.	G	A	7	6	13	0	0	13	0	0
25	15434566	.	T	C	12	4	16	0	2	18	0	0
25	15434579	.	C	T	11	3	14	0	1	15	0	0
25	15438723	.	G	A	0	23	23	0	16	39	0	0
25	15438789	.	C	A	2	4	6	0	1	7	0	0
25	15450807	.	C	G	21	15	36	0	1	37	0	0
25	15465167	.	T	C	1	5	6	0	0	6	0	0
25	15472286	.	C	A	33	25	58	0	1	59	0	0
25	15477186	.	G	A	0	7	7	0	12	19	0	0
25	15478092	.	A	G	9	10	19	0	0	19	0	0
25	15480676	.	G	A	3	15	18	0	15	33	0	0
25	15480711	.	T	C	22	27	49	0	1	50	0	0
25	15481040	.	C	T	8	11	19	0	5	24	0	0
25	15481240	.	A	G	19	38	57	0	5	62	0	0
25	15481481	.	T	G	19	17	36	0	1	37	0	0
25	15481759	.	G	A	20	19	39	0	1	40	0	0
25	15647886	.	C	T	4	5	9	0	0	9	0	0
25	15648042	.	G	A	6	8	14	0	0	14	0	0
25	15648092	.	A	G	3	9	12	0	1	13	0	0
25	15648237	.	T	A	3	9	12	0	0	12	0	0
25	15648243	.	C	A	2	9	11	0	0	11	0	0
25	15648330	.	C	A	6	12	18	0	0	18	0	0
25	15648342	.	G	C	5	9	14	0	0	14	0	0
25	15649992	.	G	A	0	4	4	0	1	5	0	0
25	16613004	.	C	T	0	7	7	0	0	7	0	0
25	16963906	.	T	C	1	6	7	0	1	8	0	0
25	17479278	.	T	C	2	4	6	0	0	6	0	0
25	17892352	.	A	T	4	5	9	0	0	9	0	0
25	18906741	.	A	G	1	3	4	0	0	4	0	0
25	18906889	.	A	G	5	2	7	0	0	7	0	0
25	18906917	.	A	G	4	5	9	0	1	10	0	0
25	18907449	.	A	G	7	3	10	0	0	10	0	0
25	18907482	.	A	G	5	2	7	0	0	7	0	0
25	18977066	.	A	G	2	2	4	0	0	4	0	0
25	18977092	.	A	G	1	4	5	0	2	7	0	0
25	18977133	.	A	G	2	6	8	0	0	8	0	0
25	18977138	.	A	G	2	6	8	0	0	8	0	0
25	18977422	.	A	G	9	5	14	0	1	15	0	0
25	18977423	.	A	G	7	7	14	0	1	15	0	0
25	19205277	.	G	A	0	3	3	0	1	4	0	0
25	19676411	.	G	A	0	1	1	0	3	4	0	0
25	19934648	.	A	T	3	3	6	0	1	7	0	0
25	19935446	.	C	G	2	1	3	0	20	23	0	0
25	20126661	.	G	T	2	2	4	0	0	4	0	0
25	20998134	.	A	G	0	4	4	0	0	4	0	0
25	21277721	.	A	G	4	2	6	0	1	7	0	0
25	21277739	.	C	T	1	7	8	0	3	11	0	0
25	21277811	.	C	T	2	9	11	0	1	12	0	0
25	21277892	.	C	A	0	4	4	0	6	10	0	0
25	21277927	.	G	T	6	6	12	0	1	14	1	0
25	21278053	.	T	A	5	4	9	0	0	9	0	0
25	21278055	.	A	G	5	4	9	0	0	9	0	0
25	21278193	.	G	A	8	7	15	0	2	17	0	0
25	21298370	.	A	C	1	0	1	0	2	3	0	0
25	21298444	.	C	T	3	2	5	0	0	5	0	0
25	21298540	.	C	T	1	0	1	0	0	1	0	0
25	21324661	.	C	T	8	3	11	0	0	11	0	0
25	21324726	.	C	A	6	10	16	0	2	18	0	0
25	21342512	.	C	T	15	12	27	0	0	27	0	0
25	21343301	.	C	T	12	11	23	0	0	23	0	0
25	21343408	.	T	C	12	8	20	0	0	20	0	0
25	21343420	.	A	T	11	7	18	0	0	18	0	0
25	21343487	.	C	T	9	4	13	0	0	13	0	0
25	21343631	.	T	A	11	16	27	0	1	28	0	0
25	21343643	.	A	G	12	0	12	0	18	30	0	0
25	21343843	.	C	T	16	16	32	0	1	33	0	0
25	21343901	.	T	C	13	12	25	0	1	26	0	0
25	21344201	.	T	G	16	16	32	0	2	34	0	0
25	21344290	.	G	T	16	8	24	0	0	24	0	0
25	21344417	.	A	G	6	9	15	0	1	16	0	0
25	21518033	.	G	T	1	4	5	0	1	6	0	0
25	21518382	.	G	A	2	3	5	0	0	5	0	0
25	21518393	.	T	C	2	1	3	0	2	5	0	0
25	21518633	.	T	C	7	0	7	0	2	9	0	0
25	21518679	.	T	A	1	5	6	0	0	6	0	0
25	21523355	.	T	C	2	3	5	0	1	6	0	0
25	21523356	.	T	A	2	3	5	0	1	6	0	0
25	21523857	.	G	A	1	2	3	0	0	3	0	0
25	21541179	.	G	A	2	2	4	0	0	4	0	0
25	21565575	.	G	A	2	1	3	0	0	3	0	0
25	21738460	.	G	A	1	2	3	0	0	3	0	0
25	21739116	.	T	C	3	3	6	0	0	6	0	0
25	21741444	.	A	G	5	5	10	0	0	10	0	0
25	21743694	.	A	G	3	0	3	0	2	5	0	0
25	21743838	.	T	G	2	2	4	0	0	4	0	0
25	21782389	.	G	A	14	12	26	0	1	27	0	0
25	21832972	.	C	T	5	7	12	0	0	12	0	0
25	21835081	.	T	C	26	28	54	0	1	55	0	0
25	21835268	.	T	C	9	8	17	0	0	17	0	0
25	21838627	.	A	T	4	5	9	0	0	9	0	0
25	21838951	.	G	A	3	8	11	0	0	11	0	0
25	21838963	.	A	G	3	7	10	0	1	11	0	0
25	21838987	.	C	T	3	8	11	0	0	11	0	0
25	21843369	.	G	T	21	22	43	0	2	45	0	0
25	21860811	.	T	A	2	4	6	0	1	7	0	0
25	21860820	.	T	C	5	1	6	0	0	6	0	0
25	21860969	.	G	T	8	11	19	0	1	20	0	0
25	21860999	.	C	A	8	10	18	0	0	18	0	0
25	21861041	.	G	A	10	7	17	0	1	18	0	0
25	21861070	.	C	T	0	9	9	0	8	17	0	0
25	21861098	.	T	C	4	0	4	0	4	8	0	0
25	21863452	.	C	T	1	3	4	0	0	4	0	0
25	21863477	.	C	T	3	5	8	0	0	8	0	0
25	21863525	.	T	G	7	3	10	0	1	11	0	0
25	21863540	.	C	T	0	6	6	0	5	11	0	0
25	21863600	.	G	T	4	3	7	0	2	9	0	0
25	21863630	.	C	T	5	6	11	0	0	11	0	0
25	21863636	.	G	A	5	5	10	0	0	10	0	0
25	21866431	.	C	T	0	1	1	0	4	5	0	0
25	21893897	.	G	C	2	4	6	0	0	6	0	0
25	21893988	.	G	C	5	9	14	0	0	14	0	0
25	21894072	.	A	G	3	7	10	0	0	10	0	0
25	22017292	.	A	T	1	1	2	0	0	2	0	0
25	22070352	.	C	T	2	4	6	0	0	6	0	0
25	22076324	.	C	T	1	2	3	0	0	3	0	0
25	22079682	.	T	C	4	2	6	0	0	6	0	0
25	22087025	.	T	C	2	4	6	0	0	6	0	0
25	22092134	.	T	A	0	1	1	0	0	1	0	0
25	22092137	.	G	A	0	1	1	0	0	1	0	0
25	22095022	.	C	T	3	3	6	0	0	6	0	0
25	22095054	.	G	A	4	5	9	0	0	9	0	0
25	22095118	.	A	G	2	3	5	0	0	5	0	0
25	22095199	.	T	C	3	3	6	0	0	6	0	0
25	22232831	.	C	A	6	5	11	0	1	12	0	0
25	22232873	.	C	A	5	3	8	0	0	9	1	0
25	22288473	.	G	C	4	3	7	0	0	7	0	0
25	22288605	.	A	G	2	0	2	0	0	2	0	0
25	22291766	.	T	C	5	2	7	0	0	7	0	0
25	22291805	.	G	A	7	2	9	0	0	9	0	0
25	22292640	.	T	A	1	5	6	0	0	6	0	0
25	22292647	.	A	G	1	0	1	0	4	5	0	0
25	22635999	.	C	A	14	24	38	0	0	38	0	0
25	22636020	.	T	A	10	20	30	0	0	30	0	0
25	22636075	.	C	A	13	14	27	0	2	29	0	0
25	22636565	.	A	T	18	31	49	0	2	51	0	0
25	22637012	.	C	T	29	19	48	0	1	49	0	0
25	22637101	.	T	C	18	20	38	0	2	40	0	0
25	22637273	.	A	G	15	23	38	0	3	42	1	0
25	22637873	.	C	A	19	27	46	0	0	46	0	0
25	22638017	.	C	T	14	10	24	0	1	25	0	0
25	22638023	.	A	T	15	12	27	0	0	27	0	0
25	22638101	.	G	A	6	11	17	0	0	17	0	0
25	22730409	.	T	C	3	2	5	0	0	5	0	0
25	22737094	.	G	A	0	3	3	0	7	10	0	0
25	22737119	.	C	T	10	7	17	0	0	17	0	0
25	22739486	.	G	T	0	3	3	0	1	4	0	0
25	22743865	.	T	C	0	3	3	0	0	3	0	0
25	22743983	.	A	G	1	1	2	0	0	2	0	0
25	22748533	.	G	T	2	2	4	0	0	4	0	0
25	22748535	.	A	C	2	2	4	0	0	4	0	0
25	22748589	.	T	C	5	7	12	0	0	12	0	0
25	22748739	.	T	C	5	1	6	0	0	6	0	0
25	22754907	.	A	G	3	0	3	0	1	4	0	0
25	22754943	.	A	T	6	4	10	0	0	10	0	0
25	22762088	.	G	A	1	3	4	0	5	9	0	0
25	22763599	.	G	A	1	2	3	0	0	3	0	0
25	22779492	.	G	A	1	1	2	0	0	2	0	0
25	22784956	.	G	A	3	3	6	0	0	6	0	0
25	22807977	.	T	C	3	3	6	0	0	6	0	0
25	22808076	.	A	G	7	2	9	0	1	10	0	0
25	22821577	.	A	G	4	0	4	0	7	11	0	0
25	22829714	.	T	C	8	5	13	0	0	13	0	0
25	22829738	.	C	T	6	5	11	0	0	11	0	0
25	22834487	.	G	A	1	4	5	0	0	5	0	0
25	22853789	.	A	T	1	2	3	0	0	3	0	0
25	22853810	.	G	A	1	3	4	0	0	4	0	0
25	22854008	.	C	T	1	7	8	0	2	10	0	0
25	22854194	.	A	T	5	8	13	0	0	13	0	0
25	22854251	.	G	A	1	4	5	0	2	7	0	0
25	22854378	.	A	C	2	2	4	0	1	5	0	0
25	22854452	.	A	C	3	6	9	0	0	9	0	0
25	22854563	.	G	A	1	2	3	0	0	3	0	0
25	22854653	.	T	C	3	4	7	0	0	7	0	0
25	22863226	.	C	A	1	4	5	0	0	5	0	0
25	22863295	.	T	A	4	1	5	0	0	5	0	0
25	22863768	.	C	T	3	4	7	0	0	7	0	0
25	22863792	.	A	G	3	2	5	0	0	5	0	0
25	22878133	.	T	C	1	0	1	0	6	7	0	0
25	22979939	.	A	G	9	6	15	0	0	15	0	0
25	22979996	.	C	G	3	3	6	0	0	6	0	0
25	22980436	.	G	T	10	10	20	0	0	20	0	0
25	22981075	.	A	C	6	9	15	0	3	18	0	0
25	22981268	.	A	G	9	11	20	0	0	20	0	0
25	22981493	.	A	G	8	13	21	0	1	22	0	0
25	22981550	.	G	A	16	6	22	0	0	22	0	0
25	22981774	.	T	C	9	12	21	0	2	23	0	0
25	22982469	.	A	G	1	2	3	0	0	3	0	0
25	22982478	.	G	T	3	2	5	0	0	5	0	0
25	22982698	.	A	G	1	0	1	0	0	1	0	0
25	22982752	.	A	G	10	5	15	0	0	15	0	0
25	23015692	.	T	C	4	0	4	0	7	11	0	0
25	23359109	.	A	G	1	3	4	0	0	4	0	0
25	23359126	.	A	C	2	4	6	0	0	6	0	0
25	23359188	.	A	T	1	5	6	0	0	6	0	0
25	23359277	.	A	G	3	2	5	0	1	6	0	0
25	23359310	.	T	C	6	3	9	0	0	9	0	0
25	23403835	.	G	C	0	3	3	0	4	7	0	0
25	23403850	.	C	T	4	4	8	0	0	8	0	0
25	23419896	.	G	A	4	3	7	0	0	7	0	0
25	23448513	.	T	C	14	10	24	0	0	24	0	0
25	23448584	.	A	G	4	0	4	0	8	12	0	0
25	23449787	.	A	G	5	3	8	0	0	8	0	0
25	23449814	.	A	G	4	0	4	0	6	10	0	0
25	23450319	.	T	A	11	7	18	0	0	18	0	0
25	23450388	.	A	G	11	2	13	0	0	13	0	0
25	23450390	.	C	A	11	2	13	0	0	13	0	0
25	23450424	.	A	G	10	5	15	0	0	15	0	0
25	23525518	.	G	T	2	2	4	0	0	4	0	0
25	23525524	.	A	T	3	1	4	0	1	5	0	0
25	23525983	.	A	C	8	0	8	0	3	11	0	0
25	23555998	.	A	T	5	3	8	0	0	8	0	0
25	23556378	.	C	G	7	7	14	0	1	15	0	0
25	23556452	.	T	C	6	3	9	0	0	9	0	0
25	23562487	.	C	T	0	1	1	0	7	8	0	0
25	23571614	.	A	G	4	3	7	0	0	7	0	0
25	23625907	.	G	A	1	0	1	0	0	1	0	0
25	23636135	.	G	T	1	1	2	0	1	3	0	0
25	23636144	.	C	T	1	2	3	0	0	3	0	0
25	23636329	.	C	T	1	2	3	0	1	4	0	0
25	23643111	.	A	C	1	4	5	0	1	6	0	0
25	23643122	.	A	T	1	5	6	0	1	7	0	0
25	23643172	.	A	G	1	0	1	0	2	3	0	0
25	23643477	.	C	T	6	2	8	0	0	8	0	0
25	23643840	.	A	C	1	2	3	0	0	3	0	0
25	23777510	.	C	A	5	9	14	0	0	14	0	0
25	23777545	.	G	A	7	9	16	0	4	20	0	0
25	23815540	.	C	T	15	10	25	0	0	25	0	0
25	24040247	.	A	C	2	2	4	0	0	4	0	0
25	24041252	.	T	G	2	2	4	0	0	4	0	0
25	24055419	.	T	C	5	0	5	0	5	10	0	0
25	24060460	.	G	A	0	1	1	0	0	1	0	0
25	24181349	.	A	G	3	2	5	0	0	5	0	0
25	24181367	.	T	C	2	0	2	0	3	5	0	0
25	24181456	.	T	C	1	3	4	0	0	4	0	0
25	24188421	.	C	T	0	1	1	0	0	1	0	0
25	24236512	.	T	C	1	4	5	0	0	5	0	0
25	24236530	.	A	G	1	4	5	0	0	5	0	0
25	24237407	.	T	C	1	2	3	0	0	3	0	0
25	24237636	.	G	A	11	8	19	1	0	20	0	0
25	24238066	.	T	G	7	6	13	0	0	13	0	0
25	24238134	.	A	C	10	1	11	0	0	11	0	0
25	24238243	.	T	C	1	7	8	0	0	8	0	0
25	24240918	.	C	T	9	10	19	0	0	19	0	0
25	24241338	.	T	G	7	12	19	0	2	21	0	0
25	24241350	.	G	A	9	12	21	0	0	21	0	0
25	24242001	.	A	G	9	8	17	0	1	18	0	0
25	24242103	.	A	G	7	5	12	0	0	12	0	0
25	24242115	.	T	C	5	3	8	0	1	9	0	0
25	24247267	.	C	G	6	6	12	0	0	12	0	0
25	24247282	.	A	C	6	6	12	0	0	12	0	0
25	24247758	.	A	C	6	1	7	0	9	16	0	0
25	24247765	.	T	C	6	9	15	0	0	15	0	0
25	24247814	.	T	C	2	7	9	0	0	9	0	0
25	24247852	.	A	G	2	5	7	0	1	8	0	0
25	24247985	.	G	A	5	5	10	0	0	10	0	0
25	24250326	.	T	A	7	3	10	0	0	10	0	0
25	24262227	.	A	T	3	2	5	0	0	5	0	0
25	24264276	.	G	A	0	5	5	0	7	12	0	0
25	24292561	.	A	G	2	3	5	0	0	5	0	0
25	24292583	.	T	C	3	3	6	0	0	6	0	0
25	24388630	.	A	G	0	0	0	0	2	2	0	0
25	24593493	.	G	A	0	2	2	0	0	2	0	0
25	24593517	.	C	T	1	3	4	0	0	4	0	0
25	24593686	.	C	G	5	5	10	0	0	10	0	0
25	24593689	.	G	A	5	6	11	0	0	11	0	0
25	24593833	.	A	T	9	4	13	0	0	13	0	0
25	24596961	.	T	C	2	1	3	0	0	3	0	0
25	24596976	.	T	A	2	1	3	0	0	3	0	0
25	24598869	.	T	C	2	3	5	0	0	5	0	0
25	24605595	.	G	T	3	5	8	0	0	8	0	0
25	24605598	.	A	C	3	5	8	0	0	8	0	0
25	24607933	.	A	G	3	0	3	0	4	7	0	0
25	24609348	.	C	T	1	0	1	0	0	1	0	0
25	24609418	.	A	T	1	1	2	0	0	2	0	0
25	24609463	.	T	A	2	1	3	0	0	3	0	0
25	24609515	.	A	G	5	4	9	0	2	11	0	0
25	24610020	.	G	A	8	3	11	0	0	11	0	0
25	24610030	.	T	C	7	4	11	0	0	11	0	0
25	24610543	.	A	T	4	10	14	0	0	14	0	0
25	24610544	.	A	G	3	9	12	0	2	14	0	0
25	24712483	.	G	A	0	1	1	0	1	2	0	0
25	24716931	.	C	T	1	1	2	0	0	2	0	0
25	24716984	.	A	G	2	0	2	0	2	4	0	0
25	24720580	.	A	G	1	1	2	0	0	2	0	0
25	24736579	.	A	T	6	14	20	0	1	21	0	0
25	24736828	.	A	T	3	8	11	0	0	11	0	0
25	24736875	.	T	G	4	7	11	0	1	12	0	0
25	24736921	.	G	A	7	10	17	0	0	17	0	0
25	24737026	.	C	T	5	6	11	0	1	12	0	0
25	24737154	.	C	T	0	3	3	0	4	7	0	0
25	24737215	.	C	T	5	7	12	0	1	13	0	0
25	24737244	.	A	C	5	7	12	0	0	12	0	0
25	24737335	.	C	A	0	2	2	0	4	6	0	0
25	24737664	.	C	A	5	6	11	0	0	11	0	0
25	24737961	.	C	T	2	5	7	0	0	7	0	0
25	24738023	.	T	C	6	0	6	0	8	14	0	0
25	24738084	.	T	C	11	0	11	0	11	22	0	0
25	24738114	.	C	G	11	8	19	0	1	20	0	0
25	24738826	.	G	A	3	8	11	0	0	11	0	0
25	24739029	.	A	G	6	14	20	0	1	21	0	0
25	24752181	.	A	G	7	5	12	0	0	12	0	0
25	24763746	.	A	G	3	0	3	0	0	3	0	0
25	24763755	.	G	T	4	0	4	0	1	5	0	0
25	24792647	.	C	A	3	5	8	0	0	8	0	0
25	24805912	.	T	A	4	4	8	0	0	8	0	0
25	24826237	.	G	T	3	4	7	0	0	7	0	0
25	24826240	.	T	C	3	0	3	0	6	9	0	0
25	24826290	.	A	G	1	4	5	0	0	5	0	0
25	24847561	.	A	T	3	0	3	0	0	3	0	0
25	25058302	.	C	T	1	4	5	0	1	6	0	0
25	25058334	.	A	C	1	0	1	0	5	6	0	0
25	25123410	.	G	A	10	3	13	0	0	13	0	0
25	25123445	.	T	C	2	5	7	0	0	7	0	0
25	25124779	.	A	T	11	11	22	0	1	23	0	0
25	25127090	.	C	T	10	5	15	0	0	15	0	0
25	25127250	.	A	G	7	16	23	0	1	24	0	0
25	25130648	.	C	T	19	34	53	0	4	57	0	0
25	25130693	.	C	T	19	33	52	0	4	56	0	0
25	25130747	.	C	T	22	17	39	0	1	40	0	0
25	25130782	.	G	A	25	21	46	0	2	48	0	0
25	25130908	.	C	T	29	14	43	0	1	44	0	0
25	25130924	.	T	C	30	17	47	0	2	49	0	0
25	25130968	.	C	T	24	22	46	0	1	47	0	0
25	25131274	.	A	G	11	16	27	0	1	28	0	0
25	25131298	.	A	T	13	24	37	0	1	39	1	0
25	25131389	.	A	T	15	35	50	0	0	50	0	0
25	25131464	.	G	A	27	7	34	0	1	35	0	0
25	25131631	.	C	T	22	17	39	0	2	44	3	0
25	25131710	.	A	G	18	17	35	0	0	35	0	0
25	25132985	.	C	T	15	11	26	0	1	27	0	0
25	25133030	.	G	A	10	9	19	0	0	19	0	0
25	25133123	.	T	G	12	14	26	0	2	28	0	0
25	25133171	.	A	G	12	15	27	0	0	27	0	0
25	25133353	.	G	A	14	14	28	0	2	30	0	0
25	25133365	.	T	A	17	17	34	0	1	35	0	0
25	25133509	.	A	G	10	3	13	0	0	13	0	0
25	25142127	.	G	A	7	4	11	0	1	15	3	0
25	25142171	.	T	C	6	8	14	0	2	16	0	0
25	25396237	.	T	C	18	8	26	0	0	26	0	0
25	25396295	.	T	C	0	3	3	0	0	3	0	0
25	25488772	.	T	G	2	2	4	0	0	4	0	0
25	25535319	.	T	G	0	1	1	0	0	1	0	0
25	25536088	.	A	C	2	3	5	0	1	6	0	0
25	25536089	.	G	A	2	4	6	0	0	6	0	0
25	25536707	.	T	C	6	3	9	0	0	9	0	0
25	25538143	.	A	C	2	2	4	0	0	4	0	0
25	25538151	.	C	T	4	3	7	0	0	7	0	0
25	25538206	.	G	T	10	8	18	0	0	18	0	0
25	25538354	.	T	A	6	3	9	0	1	10	0	0
25	25538440	.	T	G	10	6	16	0	0	16	0	0
25	25538624	.	C	A	7	5	12	0	0	12	0	0
25	25538786	.	T	G	5	1	6	0	5	11	0	0
25	25539028	.	G	A	5	7	12	0	0	12	0	0
25	25539270	.	C	A	7	4	11	0	0	11	0	0
25	25539398	.	G	A	7	8	15	0	0	15	0	0
25	25539434	.	G	A	0	6	6	0	4	10	0	0
25	25539518	.	A	G	4	4	8	0	2	10	0	0
25	25539723	.	C	A	7	11	18	0	1	19	0	0
25	25539783	.	G	C	3	10	13	0	0	13	0	0
25	25539800	.	A	G	4	6	10	0	1	11	0	0
25	25539834	.	A	T	3	6	9	0	1	10	0	0
25	25539928	.	A	G	5	0	5	0	6	11	0	0
25	25540245	.	A	G	6	3	9	0	0	9	0	0
25	25540444	.	T	C	3	2	5	0	0	5	0	0
25	25540490	.	C	T	5	3	8	0	0	8	0	0
25	25540954	.	G	A	7	12	19	0	0	19	0	0
25	25545131	.	T	C	7	5	12	0	0	12	0	0
25	25545149	.	G	C	7	7	14	0	0	14	0	0
25	25545365	.	G	C	9	3	12	0	0	12	0	0
25	25545700	.	A	T	0	3	3	0	0	3	0	0
25	25545722	.	T	C	1	2	3	0	0	3	0	0
25	25545810	.	A	C	2	2	4	0	0	4	0	0
25	25546053	.	G	A	1	2	3	0	0	3	0	0
25	25547043	.	C	A	3	5	8	0	0	8	0	0
25	25547137	.	C	A	2	2	4	0	0	4	0	0
25	25547150	.	T	A	3	2	5	0	0	5	0	0
25	25547228	.	G	A	2	4	6	0	0	6	0	0
25	25548032	.	G	T	0	2	2	0	0	2	0	0
25	25592238	.	A	G	5	5	10	0	0	10	0	0
25	25593980	.	T	C	2	4	6	0	0	6	0	0
25	25646510	.	A	T	1	3	4	0	0	4	0	0
25	25646521	.	T	G	3	3	6	0	0	6	0	0
25	25646548	.	A	G	3	2	5	0	1	6	0	0
25	25646690	.	C	T	3	2	5	0	0	5	0	0
25	25736865	.	T	C	10	0	10	0	4	14	0	0
25	25736923	.	C	G	13	13	26	0	1	28	1	0
25	25736949	.	C	T	9	12	21	0	0	21	0	0
25	25737674	.	C	A	3	7	10	0	0	10	0	0
25	25737676	.	G	A	3	7	10	0	0	10	0	0
25	25737716	.	T	A	2	2	4	0	0	4	0	0
25	25737729	.	A	G	2	2	4	0	0	4	0	0
25	25747119	.	C	A	6	3	9	0	0	9	0	0
25	25766157	.	G	A	0	1	1	0	0	1	0	0
25	26673298	.	C	A	2	2	4	0	0	4	0	0
25	26738746	.	T	C	5	5	10	0	1	11	0	0
25	26738838	.	T	A	1	3	4	0	0	4	0	0
25	26738868	.	A	T	1	5	6	0	0	6	0	0
25	26739161	.	G	T	8	4	12	0	1	13	0	0
25	26739184	.	T	C	5	4	9	0	2	11	0	0
25	26752970	.	A	G	2	5	7	0	0	7	0	0
25	26818292	.	C	T	1	1	2	0	0	2	0	0
25	26823007	.	T	C	0	1	1	0	0	1	0	0
25	26823927	.	T	C	2	2	4	0	0	4	0	0
25	26824177	.	G	A	3	6	9	0	1	10	0	0
25	26824236	.	T	C	1	4	5	0	0	5	0	0
25	26824254	.	A	G	1	4	5	0	0	5	0	0
25	26829261	.	C	T	0	4	4	0	0	4	0	0
25	26830555	.	G	A	4	3	7	0	1	8	0	0
25	26831784	.	A	G	3	9	12	0	0	12	0	0
25	26831874	.	G	A	3	5	8	0	0	8	0	0
25	26831958	.	G	A	2	2	4	0	0	4	0	0
25	26853906	.	C	T	0	1	1	0	0	1	0	0
25	26854734	.	T	C	0	2	2	0	0	2	0	0
25	26866776	.	G	T	1	2	3	0	0	3	0	0
25	26866974	.	A	T	6	2	8	0	1	9	0	0
25	26867541	.	G	A	1	2	3	0	0	3	0	0
25	26867546	.	T	C	1	2	3	0	0	3	0	0
25	26867671	.	A	T	4	2	6	0	0	6	0	0
25	26879592	.	T	C	10	6	16	0	0	16	0	0
25	26884407	.	C	T	2	5	7	0	0	7	0	0
25	26888024	.	A	G	3	6	9	0	0	9	0	0
25	26888170	.	A	G	5	7	12	0	1	13	0	0
25	26890845	.	A	G	0	1	1	0	0	1	0	0
25	26906224	.	A	G	1	0	1	0	0	1	0	0
25	26908052	.	A	C	1	1	2	0	0	2	0	0
25	26909041	.	A	C	3	4	7	0	0	7	0	0
25	26909197	.	G	A	5	10	15	0	0	15	0	0
25	26909269	.	A	G	8	8	16	0	0	16	0	0
25	26909392	.	A	T	6	9	15	0	0	15	0	0
25	26909560	.	T	C	8	10	18	0	0	18	0	0
25	26909572	.	A	G	10	0	10	0	12	22	0	0
25	26911236	.	A	C	6	2	8	0	1	10	1	0
25	26911428	.	A	C	1	2	3	0	0	3	0	0
25	26911554	.	T	A	8	7	15	0	0	15	0	0
25	26911605	.	C	A	8	11	19	0	0	19	0	0
25	26911768	.	A	G	5	2	7	0	0	7	0	0
25	26911883	.	A	G	5	13	18	0	0	18	0	0
25	26912037	.	C	T	6	3	9	0	1	10	0	0
25	26922991	.	A	G	6	5	11	0	0	11	0	0
25	26923108	.	A	G	3	0	3	0	4	7	0	0
25	26923116	.	C	T	3	3	6	0	0	6	0	0
25	26923378	.	T	A	2	1	3	0	1	4	0	0
25	26923426	.	T	C	2	5	7	0	0	7	0	0
25	26923438	.	T	C	2	6	8	0	1	9	0	0
25	27166182	.	A	G	1	0	1	0	4	5	0	0
25	27174500	.	G	A	10	8	18	0	0	18	0	0
25	27174512	.	A	G	12	0	12	0	8	20	0	0
25	27237022	.	A	G	3	7	10	0	0	10	0	0
25	27493723	.	A	T	3	2	5	0	0	5	0	0
25	27494243	.	A	G	1	2	3	0	0	3	0	0
25	27494555	.	T	G	1	0	1	0	2	3	0	0
25	27494578	.	A	T	2	2	4	0	0	4	0	0
25	27499322	.	T	C	1	4	5	0	0	5	0	0
25	27499382	.	T	C	0	3	3	0	1	4	0	0
25	27500038	.	C	A	5	3	8	0	0	8	0	0
25	27543009	.	T	C	1	2	3	0	0	3	0	0
25	27550532	.	A	G	1	2	3	0	0	3	0	0
25	27550694	.	C	A	0	2	2	0	3	5	0	0
25	27550907	.	G	A	1	2	3	0	0	3	0	0
25	27629801	.	C	T	1	2	3	0	0	3	0	0
25	27629818	.	A	T	1	2	3	0	0	3	0	0
25	27715234	.	A	G	4	7	11	0	3	14	0	0
25	27715335	.	T	G	2	12	14	0	1	15	0	0
25	27715423	.	A	T	7	3	10	0	0	10	0	0
25	27715429	.	A	G	7	5	12	0	0	12	0	0
25	27715499	.	T	A	1	6	7	0	1	8	0	0
25	27715535	.	C	G	1	3	4	0	0	4	0	0
25	27716160	.	C	T	0	1	1	0	6	7	0	0
25	27716204	.	C	A	11	5	16	0	0	16	0	0
25	27716265	.	T	C	11	6	17	0	0	17	0	0
25	27716270	.	A	T	10	7	17	0	2	19	0	0
25	27716374	.	G	A	1	1	2	0	0	2	0	0
25	27718481	.	C	T	2	0	2	0	0	2	0	0
25	27718641	.	A	T	3	1	4	0	0	4	0	0
25	27718698	.	A	G	5	5	10	0	0	10	0	0
25	27718709	.	T	C	3	4	7	0	1	8	0	0
25	27718739	.	G	A	2	1	3	0	0	3	0	0
25	28640462	.	G	T	3	2	5	0	1	6	0	0
25	28715414	.	T	C	3	3	6	0	1	7	0	0
25	32216322	.	A	G	5	2	7	0	0	7	0	0
25	32216389	.	A	G	6	0	6	0	10	16	0	0
25	32739551	.	C	T	5	3	8	0	1	9	0	0
25	33009304	.	T	C	1	0	1	0	0	1	0	0
25	33009312	.	G	T	1	0	1	0	0	1	0	0
25	33038216	.	A	G	1	0	1	0	1	2	0	0
25	33065530	.	A	G	1	0	1	0	0	1	0	0
25	33065551	.	C	T	1	1	2	0	0	2	0	0
25	33068039	.	G	T	0	0	0	0	1	1	0	0
25	33078229	.	G	A	1	1	2	0	0	2	0	0
25	33078253	.	A	C	1	0	1	0	0	1	0	0
25	33093485	.	T	C	3	3	6	0	0	6	0	0
25	33104491	.	T	C	2	2	4	0	0	4	0	0
25	33104494	.	T	C	2	1	3	0	0	3	0	0
25	33110633	.	T	C	1	3	4	0	0	4	0	0
25	33121219	.	T	C	3	1	4	0	1	5	0	0
25	33121740	.	C	T	3	2	5	0	0	5	0	0
25	33121782	.	A	G	3	0	3	0	2	5	0	0
25	33125194	.	A	C	1	3	4	0	0	5	1	0
25	33145031	.	C	T	4	1	5	0	0	5	0	0
25	33151573	.	C	G	0	0	0	0	2	2	0	0
25	33225248	.	A	G	10	10	20	0	0	20	0	0
25	33225287	.	G	A	13	12	25	0	1	26	0	0
25	33237969	.	T	C	2	2	4	0	0	4	0	0
25	33237974	.	G	T	1	2	3	0	0	3	0	0
25	33238957	.	G	T	1	2	3	0	0	3	0	0
25	33242605	.	A	T	5	3	8	0	1	9	0	0
25	33242606	.	T	G	4	3	7	0	2	9	0	0
25	33249905	.	T	G	14	17	31	0	0	31	0	0
25	33250017	.	C	A	8	12	20	0	0	20	0	0
25	33250053	.	A	G	13	11	24	0	1	25	0	0
25	33258739	.	G	A	0	6	6	0	4	10	0	0
25	33258745	.	T	G	4	0	4	0	5	9	0	0
25	33258811	.	A	G	0	0	0	0	5	5	0	0
25	33258817	.	C	T	0	5	5	0	0	5	0	0
25	33259568	.	A	G	4	0	4	0	7	11	0	0
25	33262180	.	A	G	4	9	13	0	0	13	0	0
25	33265814	.	C	T	3	9	12	0	0	12	0	0
25	33265898	.	C	T	2	10	12	0	1	13	0	0
25	33266029	.	G	A	5	7	12	0	0	12	0	0
25	33266128	.	A	G	4	1	5	0	8	13	0	0
25	33266157	.	A	C	2	4	6	0	1	7	0	0
25	33962809	.	G	A	0	6	6	0	14	20	0	0
25	33963168	.	C	A	6	6	12	0	1	13	0	0
25	33963427	.	A	T	9	7	16	0	0	17	1	0
25	33964791	.	A	G	11	7	18	0	1	19	0	0
25	33964962	.	A	G	6	6	12	0	3	15	0	0
25	33964968	.	A	G	7	4	11	0	2	13	0	0
25	33965016	.	C	A	8	4	12	0	0	12	0	0
25	33965238	.	A	G	7	3	10	0	1	11	0	0
25	33965251	.	G	A	1	2	3	0	6	9	0	0
25	33965518	.	G	T	11	4	15	0	1	16	0	0
25	33965541	.	C	T	12	6	18	0	0	18	0	0
25	33965695	.	C	T	9	7	16	0	0	16	0	0
25	33965893	.	C	T	5	9	14	0	0	14	0	0
25	33965974	.	A	C	8	15	23	0	3	26	0	0
25	33966100	.	G	A	4	8	12	0	1	13	0	0
25	33966251	.	T	G	14	12	26	0	1	27	0	0
25	33966585	.	C	G	15	1	16	0	15	31	0	0
25	33966731	.	T	C	11	5	16	0	1	17	0	0
25	33966854	.	C	T	13	12	25	0	0	25	0	0
25	33966969	.	T	A	10	8	18	0	1	19	0	0
25	33967133	.	T	A	9	11	20	0	2	22	0	0
25	33967361	.	A	G	14	12	26	0	0	26	0	0
25	33967495	.	T	C	8	3	11	0	2	13	0	0
25	33967695	.	T	C	6	6	12	0	1	13	0	0
25	33967791	.	C	T	13	8	21	0	0	21	0	0
25	33967803	.	G	A	11	6	17	0	0	17	0	0
25	33968091	.	C	T	10	9	19	0	0	19	0	0
25	33968470	.	T	A	9	8	17	0	2	19	0	0
25	33968691	.	A	G	10	15	25	0	1	26	0	0
25	33968842	.	G	C	22	12	34	0	0	34	0	0
25	33968857	.	C	T	18	10	28	0	0	28	0	0
25	33968881	.	T	A	18	13	31	0	0	31	0	0
25	33983031	.	G	A	5	3	8	0	0	8	0	0
25	33983286	.	C	T	3	5	8	0	0	8	0	0
25	33983303	.	T	C	3	5	8	0	0	8	0	0
25	33988893	.	G	A	1	1	2	0	0	2	0	0
25	33988899	.	T	C	1	1	2	0	0	2	0	0
25	33988928	.	A	T	1	2	3	0	0	3	0	0
25	34000414	.	A	G	1	3	4	0	0	4	0	0
25	34002853	.	T	C	3	3	6	0	0	6	0	0
25	34017089	.	A	G	1	1	2	0	0	2	0	0
25	34018537	.	C	T	2	3	5	0	0	5	0	0
25	34022288	.	T	C	4	2	6	0	0	6	0	0
25	34022309	.	T	C	4	2	6	0	0	6	0	0
25	34027086	.	A	T	16	7	23	0	0	23	0	0
25	34027263	.	G	T	6	5	11	0	2	13	0	0
25	34154496	.	A	T	11	6	17	0	0	17	0	0
25	34154540	.	T	G	13	10	23	0	0	23	0	0
25	34154678	.	G	A	20	14	34	0	3	37	0	0
25	34251807	.	G	A	0	1	1	0	0	1	0	0
25	34257427	.	T	C	0	4	4	0	0	4	0	0
25	34257433	.	G	A	0	5	5	0	0	5	0	0
25	34267672	.	C	T	1	2	3	0	0	3	0	0
25	34911352	.	A	G	6	4	10	0	0	10	0	0
25	34972856	.	T	A	1	0	1	0	0	1	0	0
25	34973070	.	C	T	3	2	5	0	0	5	0	0
25	34973090	.	C	A	2	4	6	0	0	6	0	0
25	34976444	.	G	A	2	3	5	0	0	5	0	0
25	35002394	.	G	A	28	24	52	0	2	55	1	0
25	35005362	.	G	A	7	10	17	0	3	21	1	0
25	35006830	.	G	A	1	13	14	0	29	43	0	0
25	35006989	.	C	T	17	21	38	0	2	40	0	0
25	35007857	.	C	T	5	6	11	0	0	11	0	0
25	35007864	.	G	A	7	9	16	0	0	16	0	0
25	35270407	.	A	G	2	5	7	0	0	7	0	0
25	35441803	.	C	T	0	2	2	0	0	2	0	0
25	35467184	.	G	A	2	1	3	0	0	3	0	0
25	35713260	.	G	A	10	2	12	0	1	13	0	0
25	35713263	.	G	C	11	1	12	0	0	12	0	0
25	35717196	.	C	G	3	6	9	0	0	9	0	0
25	35717205	.	C	T	1	4	5	0	0	5	0	0
25	36199100	.	T	C	20	5	25	0	3	28	0	0
25	37325590	.	A	G	2	1	3	0	0	3	0	0
25	37470588	.	G	C	5	2	7	0	0	7	0	0
3	13937	.	C	T	0	5	5	0	1	6	0	0
3	196978	.	T	C	1	2	3	0	1	4	0	0
3	196979	.	T	C	2	2	4	0	0	4	0	0
3	240735	.	C	A	3	1	4	0	0	4	0	0
3	1323879	.	T	A	6	7	13	0	0	13	0	0
3	1324064	.	C	A	13	5	18	0	0	18	0	0
3	1324281	.	G	T	8	3	11	0	0	11	0	0
3	1324300	.	T	C	8	2	10	0	2	12	0	0
3	1324383	.	G	C	3	0	3	0	5	10	2	0
3	1324509	.	C	A	4	9	13	0	0	13	0	0
3	1324515	.	C	T	11	5	16	0	0	16	0	0
3	1337593	.	A	G	6	6	12	0	0	12	0	0
3	1337674	.	T	C	9	0	9	1	10	20	0	0
3	1339147	.	T	A	2	4	6	0	0	6	0	0
3	3610150	.	A	T	2	3	5	0	0	5	0	0
3	3610185	.	C	A	7	6	13	0	0	13	0	0
3	3610202	.	A	T	9	7	16	0	0	16	0	0
3	3610224	.	C	T	5	8	13	0	0	13	0	0
3	3617633	.	G	A	0	4	4	0	6	10	0	0
3	3630587	.	T	C	2	1	3	0	0	3	0	0
3	3631407	.	T	C	15	9	24	0	1	25	0	0
3	3634408	.	G	A	11	7	18	0	1	19	0	0
3	3668404	.	A	G	0	2	2	0	1	3	0	0
3	3813805	.	G	A	0	2	2	0	0	2	0	0
3	3820708	.	T	C	3	0	3	0	1	4	0	0
3	4459436	.	T	C	1	0	1	0	2	3	0	0
3	4465966	.	T	C	1	4	5	0	0	5	0	0
3	4466011	.	A	G	1	2	3	0	0	3	0	0
3	4500995	.	C	G	1	2	3	0	0	3	0	0
3	4506897	.	A	G	5	4	9	0	0	9	0	0
3	4506961	.	G	A	0	1	1	0	1	2	0	0
3	4508042	.	A	C	12	12	24	0	0	24	0	0
3	4508093	.	C	A	11	8	19	0	3	22	0	0
3	4508120	.	C	T	6	5	11	0	2	13	0	0
3	4511052	.	T	C	5	2	7	0	0	7	0	0
3	4511163	.	A	G	0	1	1	0	0	1	0	0
3	4514030	.	G	A	0	3	3	0	0	3	0	0
3	4530061	.	G	A	3	1	4	0	0	4	0	0
3	4530118	.	T	A	3	6	9	0	0	9	0	0
3	4648886	.	C	A	0	2	2	0	1	3	0	0
3	4997559	.	C	T	1	2	3	0	0	3	0	0
3	4997623	.	C	T	1	2	3	0	0	3	0	0
3	4997917	.	A	T	0	1	1	0	0	1	0	0
3	5009112	.	G	C	4	0	4	0	2	6	0	0
3	5012832	.	C	G	0	5	5	0	4	9	0	0
3	5019660	.	T	C	1	3	4	0	0	4	0	0
3	5019801	.	A	G	6	10	16	0	0	16	0	0
3	5021432	.	G	A	7	3	10	0	0	10	0	0
3	5021453	.	C	T	0	11	11	0	3	14	0	0
3	5040591	.	A	G	9	4	13	0	0	13	0	0
3	5052823	.	T	G	4	13	17	0	3	20	0	0
3	5052868	.	G	A	2	9	11	0	0	11	0	0
3	5053060	.	C	T	0	23	23	0	28	51	0	0
3	5053454	.	T	A	26	23	49	0	0	49	0	0
3	5053934	.	G	A	24	25	49	0	1	50	0	0
3	5053988	.	C	G	20	28	48	0	1	49	0	0
3	5056247	.	G	A	11	31	42	0	5	47	0	0
3	5056390	.	A	T	6	0	6	0	0	7	1	0
3	5062827	.	C	T	2	1	3	0	0	3	0	0
3	5063125	.	G	A	21	20	41	0	2	43	0	0
3	5063176	.	G	A	5	9	14	0	0	14	0	0
3	5067581	.	T	A	13	11	24	0	1	25	0	0
3	5130851	.	T	C	3	1	4	0	2	6	0	0
3	5134113	.	G	A	1	5	6	0	0	6	0	0
3	5134122	.	G	A	5	2	7	0	0	7	0	0
3	5134669	.	T	C	3	9	12	0	3	15	0	0
3	5136617	.	G	A	3	0	3	0	0	3	0	0
3	5140851	.	A	G	0	2	2	0	0	2	0	0
3	5141035	.	C	T	3	3	6	0	0	6	0	0
3	5141152	.	C	T	4	2	6	0	1	7	0	0
3	5143119	.	C	T	6	4	10	0	2	12	0	0
3	5143522	.	C	T	2	0	2	0	0	2	0	0
3	5145139	.	C	A	0	1	1	0	0	1	0	0
3	5147544	.	G	A	4	4	8	0	0	8	0	0
3	5150391	.	G	A	2	3	5	0	0	5	0	0
3	5159345	.	G	A	1	1	2	0	0	2	0	0
3	5163418	.	C	G	2	5	7	0	0	7	0	0
3	5163442	.	G	T	1	5	6	0	0	6	0	0
3	5163826	.	C	T	0	3	3	0	3	6	0	0
3	5163889	.	G	A	2	1	3	0	0	3	0	0
3	5171303	.	G	T	0	1	1	0	0	1	0	0
3	5193511	.	T	C	2	0	2	0	3	5	0	0
3	5228084	.	A	G	2	3	5	0	1	6	0	0
3	5265754	.	C	T	10	17	27	0	1	28	0	0
3	5267221	.	G	A	10	2	12	0	0	12	0	0
3	5270274	.	C	T	0	8	8	0	16	24	0	0
3	5605876	.	A	C	0	4	4	0	0	4	0	0
3	5609143	.	T	G	4	2	6	0	0	6	0	0
3	5624487	.	C	T	0	5	5	0	4	9	0	0
3	5633056	.	A	G	15	16	31	0	0	31	0	0
3	5633089	.	G	A	15	14	29	0	1	30	0	0
3	5633122	.	A	G	14	16	30	0	2	32	0	0
3	5634976	.	A	G	8	6	14	0	1	15	0	0
3	5637213	.	A	C	4	7	11	0	0	11	0	0
3	5637222	.	A	G	2	6	8	0	0	8	0	0
3	5647991	.	G	C	2	2	4	0	0	4	0	0
3	5648017	.	A	G	1	4	5	0	1	6	0	0
3	5719007	.	G	T	1	4	5	0	0	5	0	0
3	5723632	.	A	G	1	2	3	0	0	3	0	0
3	5723652	.	A	T	1	2	3	0	0	3	0	0
3	5778981	.	G	A	15	5	20	0	1	21	0	0
3	5779044	.	T	A	7	17	24	0	2	26	0	0
3	5779093	.	G	T	4	12	16	0	0	16	0	0
3	5782501	.	A	G	3	2	5	0	0	5	0	0
3	5782715	.	A	G	2	2	4	0	0	4	0	0
3	5812205	.	C	T	0	1	1	0	0	1	0	0
3	5812802	.	C	T	0	1	1	0	3	4	0	0
3	5812813	.	G	A	0	2	2	0	0	2	0	0
3	5814475	.	C	T	3	4	7	0	0	7	0	0
3	5814478	.	C	T	3	3	6	0	1	7	0	0
3	5823477	.	G	A	2	1	3	0	0	3	0	0
3	5823483	.	C	A	0	1	1	0	2	3	0	0
3	5824826	.	T	C	1	1	2	0	0	2	0	0
3	5824858	.	C	T	5	2	7	0	0	7	0	0
3	5824870	.	C	T	2	6	8	0	0	8	0	0
3	5829415	.	A	G	4	8	12	0	2	14	0	0
3	5886917	.	C	T	0	21	21	0	31	52	0	0
3	5887223	.	T	C	14	18	32	0	2	34	0	0
3	5887463	.	T	G	16	19	35	0	2	37	0	0
3	5887661	.	A	T	17	12	29	0	3	32	0	0
3	5887673	.	G	C	21	2	23	0	14	37	0	0
3	5887715	.	T	C	15	14	29	0	1	30	0	0
3	5887841	.	T	A	23	19	42	0	5	47	0	0
3	5887931	.	A	T	16	20	36	0	2	39	1	0
3	5888245	.	C	T	14	18	32	0	0	32	0	0
3	5888664	.	G	A	10	12	22	0	1	23	0	0
3	5888868	.	G	A	13	12	25	0	3	28	0	0
3	5889077	.	G	T	13	10	23	0	2	25	0	0
3	5889302	.	T	C	11	7	18	0	2	20	0	0
3	5889642	.	A	T	11	7	18	0	2	20	0	0
3	5889983	.	A	G	6	5	11	0	0	11	0	0
3	5890274	.	T	A	7	9	16	0	1	17	0	0
3	5890287	.	A	G	8	12	20	0	2	22	0	0
3	5890698	.	C	T	0	14	14	0	13	27	0	0
3	5908262	.	C	T	4	10	14	0	0	14	0	0
3	5908302	.	T	C	5	0	5	0	5	10	0	0
3	5908452	.	T	C	9	0	9	0	7	16	0	0
3	5908569	.	C	A	0	6	6	0	9	15	0	0
3	5964113	.	G	A	1	2	3	0	1	4	0	0
3	5991798	.	C	T	0	5	5	0	3	8	0	0
3	5991822	.	G	A	2	4	6	0	2	8	0	0
3	5994984	.	C	T	4	3	7	0	0	7	0	0
3	5995038	.	A	G	1	2	3	0	0	3	0	0
3	5995071	.	A	G	0	1	1	0	0	1	0	0
3	6015843	.	A	G	1	2	3	0	0	3	0	0
3	6018562	.	A	G	3	5	8	0	0	8	0	0
3	6018622	.	G	A	1	3	4	0	0	4	0	0
3	6035431	.	G	T	1	0	1	0	0	1	0	0
3	6035440	.	G	A	1	0	1	0	0	1	0	0
3	6380368	.	T	C	13	18	31	0	3	34	0	0
3	6417172	.	G	A	21	13	34	0	1	35	0	0
3	6444075	.	C	A	5	5	10	0	1	11	0	0
3	6474593	.	A	G	0	2	2	0	1	3	0	0
3	6491117	.	C	A	0	2	2	1	0	3	0	0
3	6491540	.	C	T	3	7	10	0	2	12	0	0
3	6491542	.	G	T	4	8	12	0	0	12	0	0
3	6491670	.	C	T	2	6	8	0	0	8	0	0
3	6491820	.	A	T	2	4	6	0	2	8	0	0
3	6491833	.	A	G	4	7	11	0	0	11	0	0
3	6491881	.	G	T	3	8	11	0	2	13	0	0
3	6491906	.	T	C	3	8	11	0	0	11	0	0
3	6492062	.	T	A	2	2	4	0	0	4	0	0
3	6492076	.	A	T	4	2	6	0	0	6	0	0
3	6495017	.	G	A	2	0	2	0	0	2	0	0
3	6498049	.	C	G	0	9	9	0	6	15	0	0
3	6499636	.	A	G	1	2	3	0	2	5	0	0
3	6504814	.	T	A	3	4	7	0	0	7	0	0
3	6505007	.	G	T	0	2	2	0	0	2	0	0
3	6505010	.	T	C	0	2	2	0	0	2	0	0
3	6515014	.	C	G	5	0	5	0	0	5	0	0
3	6515029	.	A	G	1	0	1	0	0	1	0	0
3	6516457	.	C	T	0	1	1	0	0	1	0	0
3	6608276	.	T	A	2	2	4	0	0	4	0	0
3	6639871	.	G	C	0	1	1	0	1	2	0	0
3	6659702	.	G	A	0	4	4	0	3	7	0	0
3	6659843	.	C	T	2	1	3	0	0	3	0	0
3	6663606	.	G	A	3	4	7	0	0	7	0	0
3	6664173	.	G	A	2	2	4	0	0	4	0	0
3	6664514	.	A	G	3	2	5	1	1	7	0	0
3	6664915	.	A	G	3	4	7	0	0	7	0	0
3	6664932	.	G	A	3	2	5	0	0	5	0	0
3	6665437	.	T	A	1	3	4	0	0	4	0	0
3	6665456	.	T	C	2	0	2	0	0	2	0	0
3	6665479	.	A	G	1	2	3	0	0	3	0	0
3	6665738	.	A	T	1	4	5	0	0	5	0	0
3	6665951	.	C	A	4	3	7	0	0	7	0	0
3	6665985	.	A	T	4	4	8	0	0	8	0	0
3	6666027	.	C	T	5	3	8	0	0	8	0	0
3	6666080	.	A	G	5	8	13	0	0	13	0	0
3	6666092	.	T	C	8	4	12	0	1	13	0	0
3	6666194	.	G	C	8	9	17	0	0	17	0	0
3	6666283	.	A	T	10	6	16	0	1	17	0	0
3	6666342	.	A	G	8	1	9	0	1	10	0	0
3	6666362	.	G	A	4	5	9	0	1	10	0	0
3	6666846	.	T	C	2	3	5	0	1	6	0	0
3	6667060	.	G	C	12	16	28	0	2	30	0	0
3	6667209	.	C	T	10	7	17	0	0	17	0	0
3	6667383	.	T	C	4	2	6	1	0	7	0	0
3	6667983	.	C	G	1	0	1	0	2	3	0	0
3	6721278	.	A	G	6	8	14	0	0	14	0	0
3	6721286	.	G	C	6	7	13	0	0	13	0	0
3	6721421	.	T	G	10	8	18	0	1	19	0	0
3	6721456	.	A	T	9	4	13	0	0	13	0	0
3	6721497	.	T	A	6	5	11	0	0	11	0	0
3	6721504	.	A	T	7	6	13	0	3	16	0	0
3	6721763	.	T	C	6	5	11	0	1	12	0	0
3	6721773	.	T	G	7	5	12	0	0	12	0	0
3	6721851	.	C	T	7	7	14	0	0	14	0	0
3	6722021	.	T	A	7	9	16	0	0	16	0	0
3	6722070	.	C	G	2	10	12	0	0	12	0	0
3	6722333	.	C	A	7	9	16	1	0	17	0	0
3	6722341	.	G	A	7	9	16	0	0	16	0	0
3	6722401	.	T	C	4	11	15	0	0	15	0	0
3	6722438	.	C	T	4	9	13	0	0	13	0	0
3	6722487	.	T	G	3	2	5	3	0	8	0	0
3	6723257	.	A	G	6	6	12	1	0	13	0	0
3	6725130	.	C	T	8	2	10	0	0	10	0	0
3	6725150	.	G	C	4	4	8	0	0	8	0	0
3	6725378	.	A	T	2	3	5	0	2	7	0	0
3	6725699	.	C	G	0	5	5	0	6	11	0	0
3	6725704	.	A	G	4	8	12	0	0	12	0	0
3	6725737	.	T	A	2	5	7	0	0	7	0	0
3	6725951	.	A	G	4	2	6	0	0	7	1	0
3	6726004	.	A	G	5	6	11	0	0	11	0	0
3	6726020	.	C	T	5	3	8	0	2	10	0	0
3	6726053	.	T	C	4	5	9	0	0	9	0	0
3	6726170	.	G	T	4	6	10	0	1	11	0	0
3	6726284	.	A	T	2	6	8	0	1	9	0	0
3	6726323	.	T	G	5	6	11	0	0	11	0	0
3	6726359	.	G	A	8	5	13	0	2	15	0	0
3	6727154	.	C	T	2	12	14	0	5	19	0	0
3	6731289	.	G	T	3	4	7	0	0	7	0	0
3	6732346	.	T	A	2	4	6	0	0	6	0	0
3	6732620	.	G	T	1	1	2	0	4	6	0	0
3	6732626	.	T	C	1	0	1	0	6	7	0	0
3	6732696	.	G	A	0	1	1	0	0	1	0	0
3	6732697	.	C	T	0	1	1	0	0	1	0	0
3	6737099	.	G	T	3	2	5	0	0	5	0	0
3	6744653	.	A	G	2	0	2	0	0	2	0	0
3	6749311	.	T	C	3	2	5	0	0	5	0	0
3	6749326	.	A	G	3	2	5	0	0	5	0	0
3	7007530	.	T	A	1	3	4	0	0	4	0	0
3	7008290	.	C	T	3	4	7	0	0	7	0	0
3	7008415	.	C	T	8	4	12	0	0	12	0	0
3	7008690	.	C	A	2	2	4	0	0	4	0	0
3	7081385	.	A	C	1	1	2	0	1	3	0	0
3	7081405	.	G	T	3	2	5	0	1	6	0	0
3	7081493	.	G	A	2	2	4	0	0	4	0	0
3	7081675	.	G	A	3	4	7	0	0	7	0	0
3	7081699	.	T	C	3	0	3	0	3	6	0	0
3	7099285	.	G	T	1	8	9	0	0	9	0	0
3	7099600	.	T	C	1	2	3	0	1	4	0	0
3	7099791	.	G	A	3	2	5	0	0	5	0	0
3	7099888	.	T	C	1	2	3	1	0	4	0	0
3	7112990	.	C	T	0	3	3	0	6	9	0	0
3	7113036	.	G	T	5	6	11	0	0	11	0	0
3	7113075	.	T	G	7	5	12	0	0	12	0	0
3	7113126	.	A	G	4	5	9	0	0	9	0	0
3	7113327	.	T	C	4	0	4	0	5	9	0	0
3	7113330	.	T	C	4	4	8	0	1	9	0	0
3	7113660	.	A	G	1	3	4	0	0	4	0	0
3	7113669	.	C	T	2	1	3	0	1	4	0	0
3	7113720	.	G	A	4	5	9	0	0	9	0	0
3	7113821	.	A	T	3	2	5	0	0	5	0	0
3	7113822	.	A	G	3	2	5	0	0	5	0	0
3	7114043	.	T	G	4	2	6	0	0	6	0	0
3	7124584	.	G	T	1	3	4	0	0	4	0	0
3	7124585	.	G	T	1	3	4	0	0	4	0	0
3	7124659	.	C	T	3	2	5	0	0	5	0	0
3	7133388	.	G	A	1	2	3	1	1	5	0	0
3	7133435	.	T	G	1	4	5	0	0	5	0	0
3	7133743	.	A	G	5	4	9	0	0	9	0	0
3	7133751	.	A	G	6	3	9	0	0	9	0	0
3	7133925	.	T	C	0	4	4	0	1	5	0	0
3	7133967	.	G	A	3	3	6	0	0	6	0	0
3	7134079	.	T	G	2	2	4	0	0	4	0	0
3	7141527	.	G	T	1	3	4	0	0	4	0	0
3	7141562	.	A	T	3	3	6	0	0	6	0	0
3	7141846	.	G	A	2	4	6	0	0	6	0	0
3	7141981	.	C	T	0	3	3	0	0	3	0	0
3	7142011	.	G	A	0	2	2	0	0	2	0	0
3	7142350	.	A	G	4	3	7	0	0	7	0	0
3	7142372	.	C	G	3	2	5	3	0	8	0	0
3	7155039	.	T	C	1	3	4	0	0	4	0	0
3	7155156	.	C	T	2	3	5	0	0	5	0	0
3	7155196	.	T	A	5	5	10	0	0	10	0	0
3	7155198	.	A	G	5	5	10	0	0	10	0	0
3	7155428	.	G	A	4	3	7	0	1	8	0	0
3	7156035	.	C	T	4	9	13	0	0	13	0	0
3	7156141	.	C	T	0	2	2	0	0	2	0	0
3	7277008	.	A	T	1	3	4	0	0	4	0	0
3	7277080	.	G	C	1	2	3	0	0	3	0	0
3	7509800	.	T	A	2	2	4	0	0	4	0	0
3	7510466	.	T	A	1	2	3	0	0	3	0	0
3	7510948	.	C	T	2	2	4	0	0	4	0	0
3	7546477	.	A	G	1	2	3	0	0	3	0	0
3	7638510	.	A	G	9	7	16	0	0	16	0	0
3	8080840	.	T	C	1	2	3	0	0	3	0	0
3	8323624	.	G	A	3	3	6	0	0	6	0	0
3	8399709	.	A	G	5	5	10	0	1	11	0	0
3	8399799	.	C	T	1	2	3	0	0	3	0	0
3	9417690	.	A	G	3	3	6	0	0	6	0	0
3	9418178	.	G	A	1	3	4	0	0	4	0	0
3	9418575	.	C	T	2	5	7	0	0	7	0	0
3	9418654	.	G	A	3	2	5	0	0	5	0	0
3	9418700	.	A	G	1	2	3	0	2	5	0	0
3	9418839	.	A	T	2	2	4	0	0	4	0	0
3	9419272	.	A	G	2	0	2	0	0	2	0	0
3	9420002	.	G	A	3	3	6	0	2	8	0	0
3	9420518	.	A	T	3	3	6	0	0	6	0	0
3	9420541	.	T	C	3	4	7	0	0	7	0	0
3	9420613	.	A	T	3	1	4	0	0	4	0	0
3	9420973	.	A	G	1	4	5	0	1	6	0	0
3	9421209	.	A	T	1	3	4	0	0	4	0	0
3	9421668	.	G	A	0	6	6	0	10	16	0	0
3	9421878	.	C	A	7	6	13	0	0	13	0	0
3	9593344	.	A	T	0	1	1	0	0	1	0	0
3	9599885	.	G	T	0	0	0	0	1	1	0	0
3	9611371	.	G	A	0	8	8	0	4	12	0	0
3	9615718	.	G	A	2	0	2	0	0	2	0	0
3	9616399	.	C	T	1	2	3	0	0	3	0	0
3	9624849	.	G	A	0	2	2	0	0	2	0	0
3	9624882	.	G	A	0	2	2	0	0	2	0	0
3	9625735	.	C	T	1	2	3	0	1	4	0	0
3	9626138	.	G	T	7	3	10	0	0	10	0	0
3	9626141	.	T	C	7	3	10	0	0	10	0	0
3	9626189	.	A	C	2	4	6	0	1	7	0	0
3	9626190	.	A	G	3	3	6	0	1	7	0	0
3	9626276	.	G	T	3	3	6	0	0	6	0	0
3	9626307	.	T	G	4	7	11	0	0	11	0	0
3	9626373	.	T	C	6	0	6	0	0	6	0	0
3	9639162	.	A	G	9	9	18	0	1	19	0	0
3	9640322	.	C	T	0	8	8	0	14	22	0	0
3	9640467	.	A	G	9	11	20	0	1	21	0	0
3	9641205	.	C	T	6	9	15	0	0	15	0	0
3	9641217	.	T	C	5	9	14	0	1	15	0	0
3	9641244	.	C	T	5	6	11	0	2	13	0	0
3	9641337	.	C	T	10	11	21	0	3	24	0	0
3	9641451	.	C	T	0	13	13	0	10	23	0	0
3	9641859	.	G	A	9	4	13	0	0	13	0	0
3	9644745	.	G	A	1	3	4	0	0	4	0	0
3	9644772	.	A	G	0	3	3	0	0	3	0	0
3	9646926	.	A	G	0	2	2	0	0	2	0	0
3	9650313	.	A	G	6	4	10	0	1	11	0	0
3	9650327	.	A	G	5	8	13	0	1	14	0	0
3	9650403	.	A	G	3	5	8	0	0	8	0	0
3	9650598	.	G	A	1	0	1	0	0	1	0	0
3	9650631	.	C	T	0	2	2	0	1	3	0	0
3	9654675	.	G	A	3	10	13	0	0	13	0	0
3	9656656	.	C	T	0	3	3	0	7	10	0	0
3	9658463	.	C	T	0	4	4	0	1	5	0	0
3	9658481	.	A	G	1	2	3	0	0	3	0	0
3	9664193	.	C	T	0	1	1	0	3	4	0	0
3	9665608	.	G	T	3	0	3	0	0	3	0	0
3	9665629	.	A	G	0	2	2	0	0	2	0	0
3	9706117	.	T	G	0	2	2	0	0	2	0	0
3	9706331	.	A	G	3	3	6	0	0	6	0	0
3	9706445	.	T	C	5	7	12	0	1	13	0	0
3	9706577	.	T	C	1	2	3	0	0	3	0	0
3	9738962	.	G	T	1	2	3	0	0	3	0	0
3	10162939	.	T	C	0	1	1	0	0	1	0	0
3	10163116	.	G	A	0	4	4	0	1	5	0	0
3	10163153	.	C	A	2	4	6	0	0	6	0	0
3	10163815	.	G	A	4	4	8	0	1	9	0	0
3	10163971	.	G	A	0	3	3	0	0	3	0	0
3	10164025	.	C	T	1	3	4	0	0	4	0	0
3	10164338	.	C	G	2	3	5	0	0	5	0	0
3	10164352	.	A	C	3	3	6	0	1	7	0	0
3	10410994	.	C	A	1	5	6	0	1	7	0	0
3	10411002	.	T	A	2	6	8	0	0	8	0	0
3	10411054	.	T	C	0	1	1	0	0	1	0	0
3	10536511	.	C	T	15	8	23	0	1	24	0	0
3	10536673	.	A	G	6	1	7	0	0	7	0	0
3	10551014	.	G	A	0	2	2	0	0	2	0	0
3	10559821	.	T	C	0	0	0	0	1	1	0	0
3	10559824	.	G	T	0	0	0	0	1	1	0	0
3	10561044	.	C	T	0	0	0	0	1	1	0	0
3	10574232	.	A	G	3	3	6	0	0	6	0	0
3	10612103	.	G	A	1	7	8	0	0	8	0	0
3	10634422	.	C	T	11	6	17	0	3	20	0	0
3	10634437	.	T	C	8	12	20	0	2	22	0	0
3	10637399	.	G	A	1	3	4	0	0	4	0	0
3	10637419	.	T	C	3	1	4	0	0	4	0	0
3	11073388	.	A	G	1	3	4	0	0	4	0	0
3	11073431	.	C	T	5	6	11	0	1	12	0	0
3	11073454	.	T	C	9	3	12	0	0	12	0	0
3	11073517	.	C	T	2	9	11	0	1	12	0	0
3	11074764	.	C	G	7	0	7	0	11	18	0	0
3	11075120	.	G	A	10	16	26	0	0	27	1	0
3	11075190	.	G	A	0	19	19	0	12	31	0	0
3	11075310	.	A	G	17	1	18	0	15	33	0	0
3	11075377	.	C	A	6	5	11	0	0	11	0	0
3	11548516	.	C	T	8	3	11	0	0	11	0	0
3	11554135	.	A	G	2	0	2	0	0	2	0	0
3	11554141	.	T	C	2	0	2	0	0	2	0	0
3	11575354	.	G	A	0	5	5	0	4	9	0	0
3	11575471	.	T	C	8	7	15	0	2	17	0	0
3	11575591	.	C	A	4	7	11	1	0	12	0	0
3	11575675	.	C	G	0	11	11	0	1	12	0	0
3	11585488	.	T	A	12	14	26	0	2	28	0	0
3	11585492	.	G	A	12	11	23	0	3	26	0	0
3	11585815	.	A	G	10	8	18	0	0	18	0	0
3	11585852	.	T	A	11	6	17	0	1	18	0	0
3	11585937	.	G	A	13	9	22	0	3	25	0	0
3	11586002	.	T	G	11	5	16	0	10	26	0	0
3	11586028	.	T	A	6	3	9	0	1	10	0	0
3	11586051	.	T	C	8	0	8	0	3	11	0	0
3	11586331	.	C	T	0	10	10	0	20	30	0	0
3	11586346	.	C	T	18	13	31	0	2	33	0	0
3	11586382	.	G	A	21	20	41	0	2	43	0	0
3	11586635	.	A	G	29	11	40	0	2	42	0	0
3	11586679	.	C	T	17	7	24	0	2	26	0	0
3	11586695	.	C	T	0	7	7	0	12	19	0	0
3	11590280	.	A	G	10	14	24	0	0	24	0	0
3	11614970	.	T	C	4	3	7	0	1	8	0	0
3	11615007	.	A	T	16	9	25	0	6	31	0	0
3	11615041	.	T	C	23	1	24	0	24	48	0	0
3	11615109	.	G	A	20	11	31	0	2	33	0	0
3	11615133	.	A	G	28	12	40	0	3	43	0	0
3	11615224	.	A	G	28	21	49	0	1	50	0	0
3	11624298	.	A	G	21	10	31	0	2	33	0	0
3	11781003	.	A	C	13	16	29	2	0	31	0	0
3	11781079	.	T	C	17	9	26	0	2	28	0	0
3	11781113	.	G	A	17	12	29	0	3	32	0	0
3	11784743	.	G	A	19	14	33	0	5	38	0	0
3	11797076	.	C	T	0	5	5	0	6	11	0	0
3	11947261	.	A	G	12	4	16	0	0	16	0	0
3	12203028	.	C	G	2	4	6	0	0	6	0	0
3	13488280	.	C	A	3	2	5	0	0	5	0	0
3	14496823	.	T	C	23	11	34	0	1	35	0	0
3	14507505	.	A	G	3	4	7	0	0	7	0	0
3	15310678	.	T	A	0	1	1	0	0	1	0	0
3	15332538	.	C	G	14	17	31	0	1	32	0	0
3	15332601	.	G	T	14	8	22	0	4	26	0	0
3	15332881	.	G	A	19	12	31	0	2	33	0	0
3	15332902	.	C	A	0	14	14	0	20	34	0	0
3	15332923	.	G	A	20	18	38	0	2	40	0	0
3	15333065	.	G	A	18	20	38	0	3	41	0	0
3	15358652	.	C	T	9	6	15	0	0	15	0	0
3	15360723	.	C	T	3	2	5	0	0	5	0	0
3	15361086	.	G	T	8	14	22	0	2	24	0	0
3	15361222	.	T	C	10	6	16	0	0	16	0	0
3	15361359	.	T	A	4	5	9	0	1	10	0	0
3	15362277	.	C	T	6	8	14	0	0	14	0	0
3	15362403	.	A	C	4	11	15	0	0	15	0	0
3	15391564	.	G	C	1	2	3	0	24	27	0	0
3	15392401	.	G	A	5	10	15	0	1	16	0	0
3	15392460	.	A	G	6	6	12	1	2	15	0	0
3	15400517	.	G	A	4	1	5	0	0	5	0	0
3	15416645	.	G	A	0	1	1	0	9	10	0	0
3	15419098	.	C	T	11	3	14	0	2	16	0	0
3	15455662	.	A	G	5	6	11	0	0	11	0	0
3	15458554	.	G	A	6	5	11	0	0	11	0	0
3	15476676	.	T	A	1	2	3	0	0	3	0	0
3	15476843	.	G	A	6	9	15	0	0	15	0	0
3	15476891	.	G	T	4	11	15	0	0	15	0	0
3	15480386	.	A	T	11	3	14	0	1	15	0	0
3	15480437	.	G	T	3	5	8	0	1	9	0	0
3	15480464	.	A	G	3	3	6	0	0	6	0	0
3	15486290	.	G	A	1	2	3	0	0	3	0	0
3	15489831	.	T	C	1	2	3	0	0	3	0	0
3	15489862	.	G	A	1	5	6	0	0	6	0	0
3	15490026	.	A	C	2	5	7	0	0	7	0	0
3	15490543	.	C	T	0	0	0	0	1	1	0	0
3	15490681	.	T	G	3	7	10	0	0	10	0	0
3	15491473	.	G	A	1	3	4	0	0	4	0	0
3	15491503	.	A	C	4	0	4	0	6	10	0	0
3	15496463	.	G	T	4	5	9	0	0	9	0	0
3	15505359	.	T	C	19	11	30	0	1	31	0	0
3	15505700	.	A	G	0	2	2	0	0	2	0	0
3	15505703	.	C	G	0	1	1	0	0	1	0	0
3	15505856	.	A	T	11	6	17	0	0	17	0	0
3	15505864	.	G	A	0	7	7	0	12	19	0	0
3	15505910	.	C	T	10	6	16	0	0	16	0	0
3	15505911	.	G	A	0	6	6	0	10	16	0	0
3	15505979	.	G	A	2	2	4	0	0	4	0	0
3	15550837	.	C	T	1	2	3	0	0	3	0	0
3	15551446	.	A	C	1	1	2	0	0	2	0	0
3	15551723	.	G	A	2	0	2	0	0	2	0	0
3	15562804	.	G	A	1	12	13	0	8	21	0	0
3	15562834	.	A	C	2	6	8	0	0	8	0	0
3	15591107	.	C	T	2	2	4	0	1	5	0	0
3	15599576	.	A	G	1	0	1	0	9	10	0	0
3	15607970	.	T	G	14	13	27	0	2	29	0	0
3	15622576	.	G	A	1	3	4	0	0	4	0	0
3	15622804	.	A	C	5	0	5	0	6	11	0	0
3	15623132	.	T	G	0	1	1	0	0	1	0	0
3	15627447	.	A	G	2	3	5	0	0	5	0	0
3	15627493	.	C	T	0	3	3	0	3	6	0	0
3	15627539	.	G	A	3	4	7	0	0	7	0	0
3	15627722	.	G	A	8	7	15	0	2	17	0	0
3	15627767	.	G	A	5	13	18	0	0	18	0	0
3	15627806	.	G	C	12	6	18	0	0	18	0	0
3	15628455	.	G	A	3	4	7	0	0	7	0	0
3	15628458	.	A	C	3	0	3	0	4	7	0	0
3	15628508	.	A	G	3	2	5	0	0	5	0	0
3	15628782	.	G	A	1	5	6	0	0	6	0	0
3	15628956	.	G	A	3	3	6	0	1	7	0	0
3	15629022	.	T	C	6	8	14	0	1	15	0	0
3	15629349	.	A	G	3	2	5	0	0	5	0	0
3	15629819	.	A	G	3	2	5	0	0	5	0	0
3	15629967	.	G	C	3	2	5	0	0	5	0	0
3	15630257	.	A	T	1	5	6	0	1	7	0	0
3	15635054	.	G	A	1	2	3	0	1	4	0	0
3	15635069	.	A	G	2	3	5	0	1	6	0	0
3	15637713	.	T	A	1	1	2	0	0	2	0	0
3	15637716	.	C	G	1	1	2	0	0	2	0	0
3	15638264	.	C	T	2	7	9	0	3	12	0	0
3	15642367	.	C	T	1	2	3	0	0	3	0	0
3	15642384	.	T	C	2	2	4	0	0	4	0	0
3	15642539	.	C	T	4	4	8	0	1	9	0	0
3	15642564	.	T	C	5	6	11	0	0	11	0	0
3	15642576	.	G	C	7	4	11	0	0	11	0	0
3	15642812	.	T	A	1	5	6	0	0	6	0	0
3	15647699	.	C	T	6	4	10	0	2	12	0	0
3	15648759	.	T	C	4	5	9	0	0	9	0	0
3	15648767	.	C	T	5	5	10	0	0	10	0	0
3	15648886	.	C	T	6	2	8	0	0	8	0	0
3	15649094	.	T	C	2	2	4	0	0	4	0	0
3	15649096	.	G	A	2	2	4	0	0	4	0	0
3	15649431	.	A	C	6	2	8	1	0	9	0	0
3	15649452	.	C	T	5	3	8	1	0	9	0	0
3	15649675	.	G	A	5	2	7	0	1	8	0	0
3	15649731	.	C	T	0	7	7	0	0	7	0	0
3	15661675	.	G	A	1	8	9	0	0	9	0	0
3	15661705	.	G	A	0	6	6	0	2	8	0	0
3	15661849	.	T	C	4	0	4	0	6	10	0	0
3	15670303	.	C	A	2	1	3	0	0	3	0	0
3	15670305	.	T	C	2	1	3	0	0	3	0	0
3	15670722	.	C	T	0	3	3	0	0	3	0	0
3	15670778	.	T	C	3	2	5	0	0	5	0	0
3	15670922	.	C	T	0	4	4	0	5	9	0	0
3	15670923	.	G	C	3	5	8	0	1	9	0	0
3	15671055	.	G	A	11	6	17	0	0	17	0	0
3	15671578	.	A	T	4	5	9	0	0	9	0	0
3	15671631	.	T	C	3	3	6	0	0	6	0	0
3	15671635	.	T	A	3	4	7	0	0	7	0	0
3	15678918	.	G	A	5	7	12	0	0	12	0	0
3	15679004	.	C	A	3	2	5	0	0	5	0	0
3	15679039	.	C	A	1	2	3	0	1	4	0	0
3	15697388	.	A	G	10	12	22	0	1	23	0	0
3	15697454	.	A	G	12	10	22	0	0	22	0	0
3	15697487	.	G	T	4	4	8	0	3	11	0	0
3	15697529	.	C	T	0	3	3	0	0	3	0	0
3	15706550	.	T	A	7	2	9	0	0	9	0	0
3	15706582	.	G	A	15	5	20	0	0	20	0	0
3	15715907	.	T	C	3	4	7	0	0	7	0	0
3	15717641	.	C	G	2	1	3	0	0	3	0	0
3	15722591	.	G	A	1	0	1	0	0	1	0	0
3	15725435	.	T	C	2	0	2	0	0	2	0	0
3	15741954	.	C	T	14	11	25	0	2	27	0	0
3	15744752	.	A	G	1	0	1	0	2	3	0	0
3	15744895	.	G	A	4	10	14	0	0	14	0	0
3	15746427	.	T	A	13	7	20	0	0	20	0	0
3	15746488	.	T	C	15	12	27	0	0	27	0	0
3	15746518	.	G	T	14	17	31	0	0	31	0	0
3	15746612	.	G	A	10	17	27	0	0	27	0	0
3	15746613	.	T	C	9	17	26	0	1	27	0	0
3	15746701	.	C	T	6	8	14	0	2	16	0	0
3	15746884	.	G	T	11	19	30	0	0	31	1	0
3	15774083	.	T	A	4	2	6	0	0	6	0	0
3	15775992	.	C	G	8	0	8	0	4	12	0	0
3	15776000	.	G	A	0	8	8	0	3	11	0	0
3	15776027	.	G	A	0	6	6	0	5	11	0	0
3	15776060	.	C	T	10	4	14	0	1	15	0	0
3	15776153	.	T	C	1	6	7	0	0	7	0	0
3	15776377	.	G	A	3	7	10	0	0	10	0	0
3	15776603	.	T	A	6	6	12	0	0	12	0	0
3	15776624	.	G	A	5	5	10	0	0	10	0	0
3	15794907	.	C	G	5	1	6	0	12	18	0	0
3	15795012	.	C	T	12	9	21	0	3	24	0	0
3	15795090	.	C	T	15	6	21	0	2	23	0	0
3	15795192	.	A	G	12	15	27	0	3	30	0	0
3	15795395	.	G	A	8	10	18	0	1	19	0	0
3	15809862	.	C	T	1	2	3	0	0	3	0	0
3	15809868	.	A	C	0	2	2	0	0	2	0	0
3	15818992	.	T	C	5	5	10	0	0	10	0	0
3	15821653	.	C	T	4	5	9	0	0	9	0	0
3	15821763	.	C	T	8	5	13	0	0	13	0	0
3	15821919	.	C	T	7	6	13	0	0	13	0	0
3	15822017	.	A	T	6	5	11	0	0	11	0	0
3	15822193	.	A	T	5	5	10	0	0	11	1	0
3	15822260	.	G	A	0	5	5	0	3	8	0	0
3	15822354	.	A	G	4	0	4	0	7	11	0	0
3	15822542	.	A	T	4	6	10	0	0	10	0	0
3	15822628	.	A	T	4	8	12	0	0	12	0	0
3	15822668	.	T	C	7	9	16	0	0	16	0	0
3	15822706	.	A	T	8	6	14	0	0	14	0	0
3	15822721	.	T	C	9	5	14	0	2	16	0	0
3	15823252	.	T	A	2	1	3	0	0	3	0	0
3	15823267	.	C	A	1	0	1	0	1	2	0	0
3	15823373	.	C	A	8	11	19	0	0	19	0	0
3	15823578	.	T	A	8	3	11	0	1	12	0	0
3	15823695	.	C	T	15	6	21	0	0	21	0	0
3	15823701	.	T	C	14	5	19	0	0	19	0	0
3	15823857	.	T	A	13	8	21	0	1	22	0	0
3	15823858	.	C	T	13	8	21	0	1	22	0	0
3	15823958	.	A	G	5	8	13	0	1	14	0	0
3	15835605	.	A	C	14	13	27	0	3	30	0	0
3	15835616	.	G	A	0	16	16	0	14	30	0	0
3	15835777	.	G	A	0	18	18	0	10	28	0	0
3	15856170	.	G	C	2	3	5	0	0	5	0	0
3	15856234	.	C	A	0	1	1	0	3	4	0	0
3	15862687	.	G	A	13	7	20	0	1	21	0	0
3	15862895	.	G	A	8	7	15	0	2	17	0	0
3	15863256	.	A	G	4	5	9	0	1	10	0	0
3	15863295	.	A	G	6	7	13	0	0	13	0	0
3	15863301	.	T	C	6	1	7	0	7	14	0	0
3	15863398	.	G	C	1	2	3	0	0	3	0	0
3	15867593	.	G	A	6	4	10	0	2	12	0	0
3	15868504	.	C	T	4	0	4	0	1	5	0	0
3	15868578	.	C	T	9	8	17	0	3	20	0	0
3	15873653	.	A	G	4	3	7	0	0	7	0	0
3	15876085	.	T	A	0	5	5	0	0	5	0	0
3	15878957	.	A	G	2	6	8	0	0	8	0	0
3	15879331	.	G	A	1	1	2	0	0	2	0	0
3	15882141	.	A	G	1	4	5	0	0	5	0	0
3	15882171	.	T	C	3	1	4	0	0	4	0	0
3	15882177	.	G	T	2	1	3	0	0	3	0	0
3	15887079	.	C	T	1	1	2	0	2	4	0	0
3	15900668	.	A	C	6	7	13	0	1	14	0	0
3	15900849	.	T	C	3	8	11	0	0	11	0	0
3	15900875	.	T	G	3	0	3	0	6	9	0	0
3	15900998	.	C	T	8	2	10	0	0	10	0	0
3	15901024	.	C	T	6	4	10	0	0	10	0	0
3	15901147	.	A	T	8	8	16	0	1	17	0	0
3	15901187	.	A	G	7	0	7	0	8	15	0	0
3	15901481	.	C	T	5	5	10	0	0	10	0	0
3	15902013	.	A	C	5	8	13	0	0	13	0	0
3	15907410	.	G	A	19	17	36	0	0	36	0	0
3	15907421	.	T	C	15	18	33	0	0	33	0	0
3	15907523	.	T	G	17	23	40	0	1	41	0	0
3	15907610	.	T	G	17	18	35	0	2	37	0	0
3	15907619	.	C	T	17	18	35	0	1	36	0	0
3	15921020	.	A	G	6	13	19	0	0	19	0	0
3	15921045	.	T	C	8	14	22	0	1	23	0	0
3	15921089	.	T	C	2	2	4	0	0	4	0	0
3	15922002	.	A	T	4	7	11	0	0	11	0	0
3	15957830	.	T	G	8	0	8	0	5	13	0	0
3	15957896	.	T	C	22	17	39	0	3	42	0	0
3	15957962	.	T	C	3	4	7	0	0	7	0	0
3	15969632	.	A	C	15	17	32	0	0	32	0	0
3	15974017	.	A	T	10	15	25	0	0	25	0	0
3	15986073	.	G	A	0	26	26	0	20	46	0	0
3	15988337	.	A	G	6	15	21	0	1	22	0	0
3	15990607	.	C	T	1	3	4	0	3	7	0	0
3	15990688	.	C	A	7	11	18	0	1	19	0	0
3	15990698	.	A	G	8	9	17	0	0	17	0	0
3	15990797	.	C	T	7	6	13	0	0	13	0	0
3	15990891	.	G	A	4	4	8	0	1	9	0	0
3	15990929	.	A	T	5	3	8	0	0	8	0	0
3	15991041	.	C	A	0	6	6	0	9	15	0	0
3	15991141	.	C	T	0	8	8	0	2	10	0	0
3	15993894	.	T	C	4	0	4	0	6	10	0	0
3	15994064	.	C	T	6	3	9	0	0	9	0	0
3	15996759	.	G	T	6	10	16	0	1	17	0	0
3	15996819	.	G	T	3	3	6	0	0	6	0	0
3	16003199	.	C	A	3	2	5	0	0	5	0	0
3	16003208	.	T	C	1	3	4	0	1	5	0	0
3	16003276	.	T	A	5	9	14	0	0	14	0	0
3	16003282	.	A	T	6	9	15	0	0	15	0	0
3	16003331	.	T	A	9	13	22	0	3	25	0	0
3	16004015	.	G	A	9	19	28	0	1	29	0	0
3	16004240	.	G	A	8	9	17	0	0	17	0	0
3	16018378	.	T	G	4	5	9	0	0	9	0	0
3	16018463	.	A	T	4	7	11	0	1	12	0	0
3	16018813	.	G	A	4	4	8	0	0	8	0	0
3	16019165	.	C	A	7	13	20	0	0	20	0	0
3	16019451	.	A	G	7	4	11	0	4	15	0	0
3	16019455	.	A	T	8	7	15	0	0	15	0	0
3	16019999	.	G	A	2	2	4	0	0	4	0	0
3	16020123	.	C	A	1	3	4	0	0	4	0	0
3	16020902	.	G	A	2	2	4	0	0	4	0	0
3	16021057	.	A	G	2	2	4	0	0	4	0	0
3	16021208	.	G	A	4	2	6	0	0	6	0	0
3	16021210	.	T	G	4	2	6	0	0	6	0	0
3	16021244	.	G	A	1	6	7	0	0	7	0	0
3	16021397	.	C	T	4	3	7	0	0	7	0	0
3	16021491	.	T	C	1	4	5	0	0	5	0	0
3	16021820	.	G	A	2	3	5	0	0	5	0	0
3	16021870	.	G	T	7	4	11	0	0	11	0	0
3	16021960	.	C	T	2	4	6	0	0	6	0	0
3	16022076	.	C	T	1	7	8	0	13	21	0	0
3	16024429	.	C	T	4	3	7	0	0	7	0	0
3	16024459	.	G	A	3	4	7	0	0	7	0	0
3	16035067	.	T	G	4	5	9	0	1	10	0	0
3	16039493	.	G	A	6	3	9	0	0	9	0	0
3	16045215	.	G	A	18	12	30	0	4	34	0	0
3	16045404	.	A	C	35	31	66	0	5	71	0	0
3	16068159	.	T	G	24	15	39	0	1	40	0	0
3	16073274	.	A	T	20	17	37	0	1	38	0	0
3	16073434	.	A	C	10	2	12	0	20	32	0	0
3	16073453	.	G	A	12	22	34	0	1	35	0	0
3	16073481	.	C	T	10	24	34	0	2	36	0	0
3	16073547	.	C	T	21	18	39	0	0	39	0	0
3	16073594	.	C	T	1	23	24	0	17	41	0	0
3	16073991	.	G	A	28	27	55	0	6	61	0	0
3	16074016	.	T	A	24	32	56	0	5	61	0	0
3	16074031	.	G	A	26	32	58	0	0	58	0	0
3	16074141	.	G	T	27	15	42	0	0	42	0	0
3	16074155	.	G	A	25	8	33	0	0	33	0	0
3	16074340	.	C	G	24	15	39	0	1	40	0	0
3	16074376	.	C	T	0	4	4	0	8	12	0	0
3	16138950	.	C	G	8	12	20	0	0	20	0	0
3	16141709	.	A	T	1	7	8	0	0	8	0	0
3	16141803	.	C	T	5	4	9	0	0	9	0	0
3	16141828	.	C	A	0	3	3	0	2	5	0	0
3	16141870	.	C	T	2	3	5	0	0	5	0	0
3	16157160	.	C	T	3	4	7	0	0	7	0	0
3	16157194	.	A	G	4	6	10	0	0	10	0	0
3	16157220	.	T	G	6	6	12	0	1	13	0	0
3	16157243	.	T	A	8	10	18	0	0	18	0	0
3	16157328	.	G	T	9	15	24	0	1	25	0	0
3	16161653	.	G	T	7	6	13	0	0	13	0	0
3	16165135	.	T	C	3	5	8	0	0	8	0	0
3	16171589	.	G	A	6	5	11	0	0	11	0	0
3	16191248	.	C	T	0	3	3	0	0	3	0	0
3	16227536	.	A	C	9	10	19	0	0	19	0	0
3	16241621	.	A	G	3	3	6	0	0	6	0	0
3	16241695	.	A	G	1	4	5	0	0	5	0	0
3	16245242	.	T	C	1	0	1	0	2	3	0	0
3	16281384	.	T	A	0	1	1	0	1	2	0	0
3	16282080	.	T	A	1	3	4	0	0	4	0	0
3	16282086	.	A	C	1	2	3	0	0	3	0	0
3	16282254	.	C	G	1	2	3	0	0	3	0	0
3	16283092	.	C	T	2	2	4	0	0	4	0	0
3	16283196	.	A	T	2	2	4	0	0	4	0	0
3	16283989	.	G	T	7	3	10	0	0	10	0	0
3	16284258	.	C	T	2	3	5	0	0	5	0	0
3	16637877	.	G	A	8	5	13	0	0	13	0	0
3	16644872	.	C	T	4	2	6	0	0	6	0	0
3	16645507	.	A	C	16	17	33	0	2	35	0	0
3	16646520	.	A	G	13	17	30	0	1	31	0	0
3	16646562	.	T	C	7	9	16	0	0	16	0	0
3	16650129	.	G	A	6	3	9	0	0	9	0	0
3	16652265	.	C	T	6	6	12	0	0	12	0	0
3	16668614	.	G	A	0	1	1	0	1	2	0	0
3	16670880	.	T	G	3	0	3	0	2	5	0	0
3	16671831	.	A	G	11	0	11	0	5	16	0	0
3	16671849	.	A	G	8	0	8	0	5	13	0	0
3	16671903	.	G	A	0	1	1	0	0	1	0	0
3	16679820	.	C	T	2	2	4	0	0	4	0	0
3	16715490	.	A	C	1	0	1	0	0	1	0	0
3	16731938	.	A	G	4	0	4	0	2	6	0	0
3	16746036	.	T	C	12	13	25	0	2	27	0	0
3	16746153	.	A	C	14	21	35	0	1	36	0	0
3	16746659	.	A	T	1	4	5	0	0	5	0	0
3	16746666	.	T	C	2	5	7	0	0	7	0	0
3	16746718	.	T	A	4	6	10	0	0	10	0	0
3	16746756	.	G	A	7	3	10	0	2	12	0	0
3	16746849	.	C	A	4	11	15	0	0	15	0	0
3	16746871	.	T	G	5	12	17	0	0	17	0	0
3	16747148	.	T	C	15	6	21	0	0	21	0	0
3	16841984	.	C	A	0	1	1	0	0	1	0	0
3	16842168	.	A	G	2	2	4	0	0	4	0	0
3	16863449	.	T	C	0	2	2	0	0	2	0	0
3	16871413	.	C	G	4	0	4	0	4	8	0	0
3	16872084	.	A	G	2	2	4	0	0	4	0	0
3	16872131	.	A	C	2	1	3	0	0	3	0	0
3	16872508	.	G	T	6	5	11	0	0	11	0	0
3	16872572	.	T	C	5	5	10	0	0	10	0	0
3	16872634	.	A	G	3	5	8	0	0	8	0	0
3	16972991	.	T	C	3	2	5	0	0	5	0	0
3	17070217	.	T	C	4	2	6	0	0	6	0	0
3	17078552	.	C	T	0	1	1	0	0	1	0	0
3	17090749	.	T	C	0	1	1	0	0	1	0	0
3	17090941	.	G	A	6	3	9	0	1	10	0	0
3	17090956	.	T	C	6	4	10	0	0	10	0	0
3	17093097	.	T	C	2	3	5	0	0	5	0	0
3	17104220	.	T	C	1	0	1	0	0	1	0	0
3	17277949	.	C	T	0	3	3	0	0	3	0	0
3	17289515	.	G	A	0	3	3	0	1	4	0	0
3	17321179	.	G	T	0	2	2	0	3	5	0	0
3	17458054	.	C	T	0	2	2	0	0	2	0	0
3	17522960	.	A	G	1	0	1	0	6	7	0	0
3	17600108	.	G	T	0	3	3	0	1	4	0	0
3	17600574	.	A	T	2	3	5	0	0	5	0	0
3	17600849	.	A	G	3	0	3	0	4	7	0	0
3	17600870	.	A	T	6	3	9	0	0	9	0	0
3	17600916	.	T	C	3	2	5	0	0	5	0	0
3	17603387	.	C	T	0	2	2	0	0	2	0	0
3	17615630	.	A	C	2	8	10	0	0	10	0	0
3	17634816	.	T	C	8	10	18	0	0	18	0	0
3	17640544	.	C	T	18	6	24	0	1	25	0	0
3	17647236	.	T	C	4	1	5	0	0	5	0	0
3	17650732	.	A	G	22	24	46	0	3	49	0	0
3	17650927	.	C	G	17	22	39	0	1	40	0	0
3	17650983	.	G	A	13	23	36	0	2	38	0	0
3	17651072	.	A	G	20	1	21	0	22	43	0	0
3	17651208	.	C	A	16	13	29	0	5	34	0	0
3	17651382	.	C	T	16	13	29	0	0	29	0	0
3	17651508	.	G	A	15	18	33	0	0	33	0	0
3	17651847	.	C	A	7	10	17	0	3	20	0	0
3	17653813	.	A	T	1	3	4	0	0	4	0	0
3	17654944	.	T	C	0	2	2	0	0	2	0	0
3	17654983	.	A	T	0	5	5	0	0	5	0	0
3	17660084	.	A	G	0	1	1	0	0	1	0	0
3	17660156	.	C	T	1	5	6	0	0	6	0	0
3	17660204	.	T	C	1	1	2	0	0	2	0	0
3	17664912	.	G	C	2	4	6	0	1	7	0	0
3	17665017	.	G	A	0	4	4	0	1	5	0	0
3	17669406	.	G	A	1	3	4	0	1	5	0	0
3	17669427	.	A	G	2	5	7	0	0	7	0	0
3	17669484	.	T	C	2	1	3	0	0	3	0	0
3	17669502	.	T	A	1	0	1	0	0	1	0	0
3	17671567	.	C	T	2	6	8	0	1	9	0	0
3	17673157	.	G	C	0	1	1	0	0	1	0	0
3	17677237	.	G	T	3	2	5	0	0	5	0	0
3	17744438	.	T	A	4	4	8	0	0	8	0	0
3	17806557	.	G	C	6	4	10	0	0	11	1	0
3	17806561	.	G	A	1	4	5	0	6	11	0	0
3	17813564	.	A	G	1	0	1	0	2	3	0	0
3	17847103	.	T	G	10	10	20	0	0	20	0	0
3	17853383	.	T	C	8	13	21	0	0	21	0	0
3	17853488	.	C	T	3	0	3	0	0	3	0	0
3	17867319	.	A	G	3	3	6	0	1	7	0	0
3	17867334	.	A	G	3	5	8	0	1	9	0	0
3	17867440	.	T	C	4	4	8	0	1	9	0	0
3	17867564	.	T	C	15	8	23	0	2	25	0	0
3	17867668	.	T	A	8	5	13	0	0	13	0	0
3	17867683	.	T	A	7	4	11	0	0	11	0	0
3	17867784	.	T	C	3	3	6	0	2	8	0	0
3	17867855	.	T	C	7	4	11	1	1	13	0	0
3	17867970	.	G	C	10	9	19	0	1	20	0	0
3	17868103	.	G	A	6	2	8	0	0	8	0	0
3	17868296	.	T	C	3	4	7	0	1	8	0	0
3	17868297	.	T	C	1	4	5	0	0	8	3	0
3	17868416	.	G	A	6	2	8	0	0	8	0	0
3	17868540	.	T	C	7	0	7	0	8	15	0	0
3	17868585	.	G	A	11	7	18	0	1	19	0	0
3	17868586	.	T	C	10	7	17	0	2	19	0	0
3	17868710	.	T	C	9	7	16	0	0	16	0	0
3	17868776	.	C	T	5	6	11	0	0	11	0	0
3	17868949	.	G	C	9	11	20	0	0	20	0	0
3	17869030	.	G	C	8	6	14	0	0	14	0	0
3	17878505	.	A	G	3	6	9	0	0	9	0	0
3	17894416	.	A	G	1	2	3	0	1	4	0	0
3	17896899	.	T	C	7	2	9	0	0	9	0	0
3	17896956	.	T	C	5	4	9	0	0	9	0	0
3	17899820	.	A	G	3	0	3	0	1	4	0	0
3	17902600	.	C	T	20	14	34	0	0	34	0	0
3	17907520	.	C	T	11	7	18	0	0	18	0	0
3	17907545	.	T	C	17	15	32	0	1	33	0	0
3	17907626	.	T	C	23	20	43	0	1	44	0	0
3	17907741	.	A	T	20	24	44	0	3	47	0	0
3	17907801	.	T	A	25	23	48	0	1	49	0	0
3	17907812	.	T	C	23	21	44	0	0	44	0	0
3	17907861	.	G	T	17	20	37	0	1	38	0	0
3	17907907	.	T	C	16	16	32	0	8	40	0	0
3	17907976	.	G	A	0	18	18	0	21	39	0	0
3	17908002	.	A	G	26	20	46	0	0	46	0	0
3	17908034	.	G	T	22	20	42	0	1	43	0	0
3	17908730	.	T	C	11	22	33	0	1	34	0	0
3	17939970	.	C	T	3	5	8	0	2	10	0	0
3	17940057	.	G	C	4	7	11	0	2	13	0	0
3	17940184	.	G	A	1	5	6	0	7	13	0	0
3	17940382	.	T	G	6	3	9	0	0	9	0	0
3	17940383	.	T	G	6	3	9	0	0	9	0	0
3	17942432	.	C	T	2	7	9	0	0	9	0	0
3	17942468	.	G	A	0	7	7	0	5	12	0	0
3	17942471	.	C	T	4	7	11	0	0	11	0	0
3	17942627	.	C	A	7	6	13	0	2	15	0	0
3	17942948	.	G	C	8	7	15	0	0	15	0	0
3	17943332	.	A	G	7	3	10	0	0	10	0	0
3	17943523	.	G	T	9	8	17	0	1	19	1	0
3	17943529	.	C	A	8	10	18	0	0	18	0	0
3	17943567	.	C	A	8	6	14	0	0	14	0	0
3	17943648	.	A	C	7	9	16	0	0	16	0	0
3	17943679	.	C	T	8	7	15	0	3	18	0	0
3	17944149	.	A	G	8	8	16	0	0	16	0	0
3	17967826	.	C	A	0	2	2	0	0	2	0	0
3	17967859	.	G	A	4	4	8	0	0	8	0	0
3	17967880	.	A	G	4	4	8	0	0	8	0	0
3	17967896	.	T	A	3	2	5	0	1	6	0	0
3	17984415	.	G	A	3	4	7	0	0	7	0	0
3	17986376	.	A	C	9	4	13	0	0	13	0	0
3	17988049	.	T	A	6	6	12	0	1	13	0	0
3	17991395	.	A	T	6	3	9	0	1	10	0	0
3	17991465	.	C	T	7	6	13	0	0	13	0	0
3	17991468	.	A	G	4	0	4	0	8	12	0	0
3	17993540	.	G	A	5	1	6	0	0	6	0	0
3	17993892	.	C	T	4	3	7	0	0	7	0	0
3	17995833	.	G	A	5	15	20	0	1	21	0	0
3	17995860	.	T	C	6	13	19	0	2	21	0	0
3	17996064	.	A	T	0	3	3	0	0	3	0	0
3	17996133	.	T	C	1	1	2	0	0	2	0	0
3	17999665	.	T	G	3	3	6	0	0	6	0	0
3	17999773	.	T	C	10	8	18	0	2	20	0	0
3	18002989	.	T	G	17	20	37	0	0	37	0	0
3	18004984	.	T	C	12	6	18	0	0	18	0	0
3	18004987	.	C	T	12	6	18	0	0	18	0	0
3	18006423	.	T	C	2	2	4	0	0	4	0	0
3	18007946	.	T	G	13	22	35	0	0	35	0	0
3	18008040	.	C	G	18	22	40	0	5	45	0	0
3	18008083	.	T	C	10	23	33	0	2	35	0	0
3	18008095	.	A	T	12	25	37	0	1	38	0	0
3	18008273	.	T	A	15	22	37	0	1	38	0	0
3	18008351	.	C	G	22	21	43	0	1	44	0	0
3	18008510	.	T	C	26	9	35	0	1	36	0	0
3	18008564	.	A	G	21	21	42	0	2	44	0	0
3	18008642	.	G	C	13	17	30	0	1	31	0	0
3	18008833	.	C	A	4	4	8	0	2	10	0	0
3	18008853	.	G	A	5	2	7	0	0	7	0	0
3	18056951	.	G	C	0	1	1	0	0	1	0	0
3	18059698	.	G	A	0	1	1	0	0	1	0	0
3	18060929	.	C	A	4	4	8	0	0	8	0	0
3	18061160	.	G	C	5	2	7	0	0	7	0	0
3	18061478	.	G	T	3	4	7	0	0	7	0	0
3	18063189	.	G	A	0	3	3	0	8	11	0	0
3	18066006	.	T	C	10	6	16	0	1	17	0	0
3	18069821	.	C	T	7	15	22	0	0	22	0	0
3	18070082	.	T	C	1	1	2	0	0	2	0	0
3	18079296	.	G	A	7	8	15	0	0	15	0	0
3	18079331	.	C	G	6	10	16	0	0	16	0	0
3	18079662	.	A	G	6	0	6	0	10	16	0	0
3	18079754	.	T	C	7	10	17	0	0	17	0	0
3	18079787	.	C	T	7	9	16	0	0	16	0	0
3	18080208	.	G	A	8	6	14	0	1	15	0	0
3	18186295	.	C	T	3	15	18	0	12	30	0	0
3	18189151	.	C	A	18	17	35	0	1	36	0	0
3	18189250	.	A	T	19	17	36	0	1	37	0	0
3	18303452	.	A	G	7	5	12	0	0	12	0	0
3	18303473	.	G	C	8	5	13	0	0	13	0	0
3	18303515	.	T	C	4	1	5	0	0	5	0	0
3	18303521	.	T	A	3	0	3	0	0	3	0	0
3	18322462	.	T	G	6	4	10	0	0	10	0	0
3	18322504	.	G	A	3	4	7	0	0	7	0	0
3	18325373	.	G	A	1	1	2	0	0	2	0	0
3	18349286	.	C	T	1	2	3	0	0	3	0	0
3	18349301	.	T	C	2	2	4	0	0	4	0	0
3	18376403	.	A	T	14	7	21	0	0	21	0	0
3	18376408	.	A	T	13	7	20	0	0	20	0	0
3	18376464	.	T	C	14	15	29	0	1	30	0	0
3	18377229	.	T	G	8	7	15	0	0	15	0	0
3	18377230	.	A	G	8	7	15	0	0	15	0	0
3	18377406	.	C	T	0	16	16	0	8	24	0	0
3	18377441	.	A	T	6	17	23	0	2	25	0	0
3	18377514	.	T	C	4	13	17	0	2	19	0	0
3	18377728	.	C	T	1	15	16	0	15	31	0	0
3	18379645	.	T	G	6	10	16	0	1	17	0	0
3	18383126	.	A	G	3	5	8	0	0	8	0	0
3	18383141	.	G	A	3	5	8	0	0	8	0	0
3	18384272	.	C	T	1	3	4	0	0	4	0	0
3	18384424	.	T	A	11	9	20	0	0	20	0	0
3	18384456	.	G	A	1	2	3	0	0	3	0	0
3	18399412	.	A	G	23	18	41	0	5	46	0	0
3	18399695	.	G	A	9	7	16	0	2	18	0	0
3	18400615	.	A	C	10	17	27	0	0	27	0	0
3	18400819	.	G	A	20	20	40	0	0	40	0	0
3	18405239	.	A	C	8	0	8	0	10	18	0	0
3	18407179	.	A	T	10	5	15	0	0	15	0	0
3	18407184	.	T	C	13	0	13	0	6	19	0	0
3	18409607	.	A	G	4	11	15	0	0	15	0	0
3	18409612	.	T	G	2	8	10	0	0	10	0	0
3	18410941	.	T	C	6	8	14	0	0	14	0	0
3	18429667	.	G	A	0	3	3	0	1	4	0	0
3	18431867	.	C	A	2	1	3	0	0	3	0	0
3	18435053	.	C	T	0	2	2	0	0	2	0	0
3	18435063	.	G	C	0	2	2	0	0	2	0	0
3	18435107	.	T	C	1	2	3	0	0	3	0	0
3	18435421	.	T	A	1	2	3	0	0	3	0	0
3	18447738	.	T	C	2	1	3	0	0	3	0	0
3	18448093	.	C	T	6	5	11	0	0	11	0	0
3	18448234	.	A	G	2	6	8	0	0	8	0	0
3	18448294	.	T	C	5	6	11	0	1	12	0	0
3	18468857	.	T	C	3	3	6	0	0	6	0	0
3	18468905	.	G	A	2	5	7	0	0	7	0	0
3	18468932	.	T	G	4	6	10	0	0	10	0	0
3	18469004	.	T	C	1	0	1	0	0	1	0	0
3	18473078	.	A	G	9	0	9	0	4	13	0	0
3	18487320	.	G	T	5	10	15	0	0	15	0	0
3	18498313	.	T	C	9	9	18	0	2	20	0	0
3	18498486	.	C	T	10	3	13	0	2	15	0	0
3	18498689	.	C	G	0	0	0	0	6	6	0	0
3	18561461	.	T	C	6	4	10	0	1	11	0	0
3	18562193	.	T	C	8	5	13	0	0	13	0	0
3	18562235	.	G	A	6	4	10	0	1	11	0	0
3	18562418	.	T	C	4	5	9	0	3	12	0	0
3	18562584	.	T	C	2	3	5	0	0	5	0	0
3	18563512	.	A	T	3	5	8	0	1	9	0	0
3	18569431	.	G	A	2	2	4	0	0	4	0	0
3	18569439	.	A	G	2	1	3	0	1	4	0	0
3	18569617	.	T	G	8	3	11	0	1	12	0	0
3	18569659	.	G	C	6	6	12	0	1	13	0	0
3	18569699	.	C	A	5	5	10	0	1	11	0	0
3	18570029	.	A	T	8	6	14	0	0	14	0	0
3	18570041	.	G	T	0	5	5	0	8	13	0	0
3	18570142	.	T	C	4	4	8	0	0	8	0	0
3	18570161	.	C	T	2	4	6	0	0	6	0	0
3	18570434	.	A	C	7	14	21	0	0	21	0	0
3	18570683	.	G	C	3	7	10	0	0	10	0	0
3	18570696	.	G	A	3	6	9	0	0	9	0	0
3	18570730	.	C	A	6	4	10	0	0	10	0	0
3	18570759	.	A	G	8	6	14	0	0	14	0	0
3	18570815	.	G	A	5	3	8	0	2	10	0	0
3	18570904	.	G	A	3	3	6	0	0	6	0	0
3	18676153	.	C	T	2	4	6	0	0	6	0	0
3	18676186	.	G	A	4	6	10	0	0	10	0	0
3	18676190	.	T	A	5	6	11	0	0	11	0	0
3	18676224	.	A	T	5	5	10	0	0	10	0	0
3	18676349	.	A	G	3	1	4	0	0	4	0	0
3	18676551	.	C	T	0	4	4	0	5	9	0	0
3	18676830	.	G	A	6	3	9	0	0	9	0	0
3	18676832	.	G	A	6	3	9	0	0	9	0	0
3	18676953	.	T	C	1	5	6	0	0	6	0	0
3	18677047	.	A	T	8	7	15	0	0	15	0	0
3	18677077	.	A	G	14	6	20	0	1	21	0	0
3	18677171	.	C	T	13	13	26	0	2	28	0	0
3	18677314	.	C	T	10	2	12	0	0	12	0	0
3	18677389	.	G	T	8	3	11	0	0	11	0	0
3	18680023	.	A	C	3	6	9	0	0	9	0	0
3	18685468	.	A	T	20	21	41	0	2	43	0	0
3	18685471	.	T	A	18	24	42	0	3	45	0	0
3	18685669	.	T	C	14	12	26	0	5	31	0	0
3	18685762	.	C	G	1	12	13	0	16	29	0	0
3	18685918	.	T	C	21	11	32	0	1	33	0	0
3	18686542	.	T	C	14	14	28	0	0	28	0	0
3	18686781	.	T	C	8	1	9	0	14	23	0	0
3	18688780	.	G	A	1	2	3	0	0	3	0	0
3	18688852	.	A	G	5	7	12	0	0	12	0	0
3	18692264	.	C	T	0	1	1	0	0	1	0	0
3	18694054	.	T	C	4	0	4	0	9	13	0	0
3	18702639	.	T	C	1	0	1	0	0	1	0	0
3	18702657	.	T	G	3	1	4	0	0	4	0	0
3	18704081	.	C	A	4	3	7	0	0	7	0	0
3	18704114	.	T	A	5	3	8	0	0	8	0	0
3	18704159	.	A	G	3	5	8	0	0	8	0	0
3	18704171	.	A	G	3	5	8	0	0	8	0	0
3	18704195	.	A	C	1	0	1	0	3	4	0	0
3	18708094	.	C	T	0	2	2	0	1	3	0	0
3	18708095	.	G	A	1	2	3	0	0	3	0	0
3	18710296	.	A	G	0	1	1	0	0	1	0	0
3	18710326	.	G	A	4	3	7	0	0	7	0	0
3	18710413	.	T	G	1	2	3	0	2	5	0	0
3	18720644	.	C	T	0	7	7	0	4	11	0	0
3	18720949	.	G	A	2	1	3	0	0	3	0	0
3	18723030	.	G	A	6	6	12	0	0	12	0	0
3	18723036	.	T	C	5	7	12	0	0	12	0	0
3	18723095	.	A	G	4	3	7	0	0	7	0	0
3	18758171	.	C	T	1	2	3	0	0	3	0	0
3	18760534	.	T	C	1	0	1	0	0	1	0	0
3	18760539	.	G	A	0	0	0	0	1	1	0	0
3	18768933	.	T	C	2	2	4	0	0	4	0	0
3	18769081	.	T	C	5	4	9	0	0	9	0	0
3	18769165	.	T	C	4	3	7	0	0	7	0	0
3	18769380	.	C	A	2	3	5	0	0	5	0	0
3	18769436	.	G	C	5	3	8	0	0	8	0	0
3	18769741	.	G	A	6	2	8	0	0	9	1	0
3	18769793	.	T	A	7	2	9	0	0	9	0	0
3	18774922	.	T	A	6	7	13	0	1	14	0	0
3	18775305	.	C	A	10	17	27	0	1	28	0	0
3	18777284	.	T	C	12	3	15	0	0	15	0	0
3	18778996	.	A	T	3	4	7	0	0	7	0	0
3	18787884	.	G	A	3	10	13	0	1	14	0	0
3	18795907	.	G	T	0	3	3	0	4	7	0	0
3	18795938	.	T	A	3	6	9	0	0	9	0	0
3	18796218	.	C	T	2	5	7	0	0	7	0	0
3	18798670	.	A	T	1	2	3	0	0	3	0	0
3	18798680	.	T	G	1	2	3	0	0	3	0	0
3	18799370	.	T	C	1	1	2	0	1	3	0	0
3	18817622	.	T	C	1	0	1	0	0	1	0	0
3	18818395	.	G	A	0	1	1	0	2	3	0	0
3	18818893	.	T	C	1	0	1	0	1	2	0	0
3	18818929	.	C	T	3	1	4	0	0	4	0	0
3	18819979	.	T	C	4	3	7	0	0	7	0	0
3	18821163	.	C	T	6	7	13	0	0	13	0	0
3	18823027	.	T	C	2	2	4	0	0	4	0	0
3	18823331	.	T	C	0	1	1	0	0	1	0	0
3	18827249	.	G	T	1	3	4	0	0	4	0	0
3	18827491	.	T	C	4	1	5	0	1	6	0	0
3	18827509	.	G	A	3	0	3	0	0	3	0	0
3	18833001	.	G	A	0	0	0	0	1	1	0	0
3	18833016	.	C	T	2	1	3	0	0	3	0	0
3	18835665	.	C	T	0	1	1	0	0	1	0	0
3	18835852	.	C	G	10	10	20	0	0	20	0	0
3	18836023	.	T	C	5	6	11	0	1	12	0	0
3	18836168	.	A	G	6	3	9	0	0	9	0	0
3	18836518	.	C	T	6	2	8	0	0	8	0	0
3	18836857	.	A	T	13	4	17	0	3	20	0	0
3	18836935	.	T	G	8	6	14	0	0	14	0	0
3	18837029	.	G	A	4	2	6	0	0	6	0	0
3	18837095	.	A	T	6	11	17	0	0	17	0	0
3	18837111	.	G	A	0	12	12	0	4	16	0	0
3	18837456	.	G	A	6	9	15	0	0	15	0	0
3	18837468	.	A	T	5	7	12	0	1	13	0	0
3	18837887	.	G	A	0	8	8	0	15	23	0	0
3	18837917	.	A	T	13	9	22	0	0	22	0	0
3	18837995	.	C	T	9	4	13	0	1	14	0	0
3	18838097	.	A	C	8	4	12	0	0	12	0	0
3	18838559	.	T	A	12	9	21	0	0	21	0	0
3	18838721	.	T	C	4	4	8	0	0	8	0	0
3	18838728	.	T	G	4	5	9	0	1	10	0	0
3	18838878	.	C	T	3	4	7	0	1	8	0	0
3	18838981	.	C	T	2	4	6	0	0	6	0	0
3	18839017	.	C	T	10	3	13	0	0	13	0	0
3	18840990	.	G	A	1	3	4	0	0	4	0	0
3	18840996	.	A	G	1	4	5	0	0	5	0	0
3	20108790	.	T	C	9	14	23	1	1	25	0	0
3	20109247	.	T	C	12	0	12	0	13	25	0	0
3	20110268	.	T	C	27	13	40	0	1	41	0	0
3	20110269	.	T	C	30	9	39	0	2	41	0	0
3	21888977	.	A	G	1	5	6	0	0	6	0	0
3	21889223	.	A	G	4	2	6	0	0	6	0	0
3	21889268	.	A	G	8	4	12	0	0	12	0	0
3	22054517	.	A	C	1	0	1	0	14	15	0	0
3	22153885	.	A	G	2	6	8	0	0	8	0	0
3	22154051	.	A	G	6	3	9	0	1	10	0	0
3	22154329	.	A	G	10	3	13	0	1	14	0	0
3	22154368	.	A	G	4	5	9	0	0	9	0	0
3	22154430	.	A	G	9	1	10	0	2	12	0	0
3	22154431	.	A	G	10	2	12	0	0	12	0	0
3	23488794	.	T	A	10	11	21	0	0	21	0	0
3	23488816	.	T	C	13	10	23	0	0	23	0	0
3	23492529	.	A	T	18	8	26	0	1	28	1	0
3	23493864	.	C	T	26	17	43	0	0	43	0	0
3	23494015	.	G	A	2	19	21	0	25	46	0	0
3	23494216	.	T	C	34	25	59	0	3	62	0	0
3	23494780	.	A	G	8	7	15	0	0	15	0	0
3	23494805	.	G	A	0	12	12	0	14	26	0	0
3	23495767	.	T	C	17	12	29	0	2	31	0	0
3	23495872	.	T	C	16	12	28	0	0	28	0	0
3	23495905	.	G	T	7	7	14	0	2	17	1	0
3	23522639	.	C	T	0	2	2	0	1	3	0	0
3	23584052	.	G	A	6	2	8	0	1	9	0	0
3	23584128	.	G	A	6	5	11	0	0	11	0	0
3	23584173	.	G	C	7	8	15	0	3	18	0	0
3	23584703	.	A	T	10	9	19	0	1	20	0	0
3	23584704	.	T	A	10	9	19	0	1	20	0	0
3	23584748	.	C	A	4	9	13	0	1	14	0	0
3	23584977	.	A	C	7	8	15	0	1	16	0	0
3	23585082	.	T	A	3	6	9	0	0	9	0	0
3	23585197	.	T	A	4	11	15	0	0	15	0	0
3	23585253	.	T	A	10	8	18	0	0	18	0	0
3	23585442	.	G	T	17	7	24	0	2	26	0	0
3	23592988	.	G	T	9	3	12	0	0	12	0	0
3	23596401	.	G	A	5	10	15	0	1	16	0	0
3	23596632	.	G	C	16	9	25	0	0	25	0	0
3	23596791	.	T	A	21	8	29	0	1	30	0	0
3	23599443	.	G	T	23	30	53	0	0	53	0	0
3	23690146	.	C	T	4	2	6	0	0	6	0	0
3	23705327	.	T	G	5	0	5	0	4	9	0	0
3	23708080	.	G	A	0	10	10	0	10	20	0	0
3	23709399	.	A	G	7	0	7	0	3	10	0	0
3	23710000	.	G	T	6	2	8	0	0	8	0	0
3	24065389	.	A	T	15	13	28	0	0	28	0	0
3	24065395	.	A	G	13	15	28	0	2	30	0	0
3	24065437	.	C	T	5	7	12	0	0	12	0	0
3	24067629	.	A	T	4	3	7	0	0	7	0	0
3	24070118	.	C	T	17	12	29	0	2	31	0	0
3	24070251	.	T	C	8	14	22	0	0	22	0	0
3	24070336	.	G	A	7	9	16	0	0	16	0	0
3	24070815	.	G	T	8	6	14	0	2	16	0	0
3	24071108	.	T	C	10	9	19	0	1	20	0	0
3	24071163	.	G	A	10	10	20	0	1	21	0	0
3	24071294	.	A	T	9	7	16	0	1	17	0	0
3	24073254	.	G	A	2	2	4	0	0	4	0	0
3	24109865	.	T	A	3	2	5	0	0	5	0	0
3	24109896	.	T	A	4	2	6	0	0	6	0	0
3	24109973	.	G	A	3	2	5	0	0	5	0	0
3	24110160	.	T	C	3	0	3	0	0	5	2	0
3	24110250	.	C	T	1	5	6	0	0	6	0	0
3	24110260	.	A	C	1	2	3	0	0	3	0	0
3	24110822	.	C	T	9	4	13	0	0	13	0	0
3	24111129	.	T	C	5	10	15	0	1	16	0	0
3	24111135	.	A	G	4	10	14	0	0	14	0	0
3	24134607	.	T	G	3	1	4	0	1	5	0	0
3	24137904	.	T	A	1	1	2	0	1	3	0	0
3	24142965	.	C	T	11	9	20	0	1	21	0	0
3	24143468	.	C	T	6	3	9	0	0	9	0	0
3	24143497	.	T	A	7	4	11	0	0	11	0	0
3	24144037	.	A	G	6	6	12	0	0	12	0	0
3	24144708	.	T	A	3	1	4	0	0	4	0	0
3	24144716	.	C	T	3	2	5	0	0	5	0	0
3	24144773	.	G	A	3	5	8	0	1	9	0	0
3	24171034	.	C	G	1	3	4	0	0	4	0	0
3	24171066	.	C	T	1	3	4	0	0	4	0	0
3	24196365	.	T	G	3	1	4	0	1	5	0	0
3	24197954	.	G	A	0	2	2	0	0	2	0	0
3	24199073	.	T	G	17	0	17	0	38	55	0	0
3	24199154	.	T	C	17	34	51	0	3	54	0	0
3	24199577	.	T	C	31	34	65	0	1	66	0	0
3	24199689	.	T	C	32	31	63	0	2	65	0	0
3	24200287	.	T	A	34	31	65	0	1	66	0	0
3	24200563	.	T	A	16	10	26	0	3	29	0	0
3	24200578	.	C	T	13	19	32	0	3	35	0	0
3	24200643	.	C	T	9	16	25	0	1	26	0	0
3	24200645	.	A	G	10	15	25	0	1	26	0	0
3	24200768	.	G	T	7	5	12	0	1	13	0	0
3	24203272	.	C	T	6	9	15	0	0	15	0	0
3	24203310	.	A	G	11	6	17	0	1	18	0	0
3	24203513	.	G	A	9	10	19	0	1	20	0	0
3	24203584	.	C	T	7	3	10	0	0	10	0	0
3	24203588	.	T	C	5	5	10	0	2	12	0	0
3	24203735	.	G	A	2	3	5	0	0	5	0	0
3	24207449	.	T	C	3	10	13	0	0	13	0	0
3	24209715	.	T	A	3	5	8	0	0	8	0	0
3	24209852	.	T	C	1	0	1	0	0	1	0	0
3	24212197	.	T	G	10	7	17	0	0	17	0	0
3	24216029	.	A	G	2	8	10	0	0	10	0	0
3	24216161	.	T	C	2	2	4	0	0	4	0	0
3	24218564	.	A	C	2	5	7	0	1	8	0	0
3	24292634	.	A	G	1	0	1	0	0	1	0	0
3	24295292	.	T	C	0	2	2	0	0	2	0	0
3	24295314	.	T	G	3	2	5	0	0	5	0	0
3	24295426	.	G	T	1	8	9	0	0	9	0	0
3	24295429	.	T	C	1	8	9	0	0	9	0	0
3	24361132	.	C	T	17	21	38	0	0	38	0	0
3	24361245	.	T	C	30	23	53	0	1	54	0	0
3	24361257	.	T	C	29	23	52	0	1	53	0	0
3	24433057	.	C	A	5	9	14	0	0	14	0	0
3	24434494	.	T	A	36	25	61	0	10	71	0	0
3	24434694	.	A	G	40	29	69	0	3	72	0	0
3	24434833	.	C	A	10	19	29	0	2	31	0	0
3	24463828	.	C	T	1	4	5	0	0	5	0	0
3	24483064	.	C	A	18	17	35	0	0	35	0	0
3	24483259	.	G	A	2	11	13	0	18	31	0	0
3	24483322	.	C	T	19	18	37	0	0	37	0	0
3	24487821	.	A	G	18	20	38	0	1	39	0	0
3	24487905	.	A	G	16	12	28	0	3	31	0	0
3	24489838	.	A	G	15	11	26	0	3	29	0	0
3	24514136	.	C	T	1	1	2	0	0	2	0	0
3	24517881	.	C	T	3	3	6	0	0	6	0	0
3	24517886	.	C	T	3	2	5	0	0	5	0	0
3	24518388	.	A	G	2	3	5	0	0	5	0	0
3	24542048	.	A	G	0	1	1	0	0	1	0	0
3	24684339	.	C	T	1	0	1	0	0	1	0	0
3	24691573	.	A	G	1	2	3	0	0	3	0	0
3	24691593	.	T	A	2	4	6	0	1	7	0	0
3	24692005	.	G	T	0	3	3	0	2	5	0	0
3	24692014	.	T	C	2	4	6	0	0	6	0	0
3	24692120	.	G	A	3	5	8	0	0	8	0	0
3	24763520	.	A	G	1	0	1	0	2	3	0	0
3	24764263	.	G	A	1	3	4	0	0	4	0	0
3	24764877	.	G	T	1	3	4	0	0	4	0	0
3	24764940	.	A	G	1	2	3	0	0	3	0	0
3	24765011	.	C	T	3	4	7	0	0	7	0	0
3	24765117	.	C	G	2	5	7	0	0	7	0	0
3	24973667	.	T	A	10	25	35	0	1	36	0	0
3	24990746	.	A	C	24	25	49	0	0	49	0	0
3	24993349	.	G	A	0	15	15	0	12	27	0	0
3	24993449	.	G	A	23	24	47	0	2	49	0	0
3	24993663	.	G	A	16	23	39	0	0	39	0	0
3	24993682	.	A	G	15	20	35	0	3	38	0	0
3	24993791	.	G	A	0	20	20	0	29	49	0	0
3	24994253	.	T	C	17	27	44	0	1	45	0	0
3	24997955	.	A	T	13	7	20	0	0	20	0	0
3	24998797	.	C	T	13	4	17	0	1	18	0	0
3	24998977	.	G	T	9	8	17	0	2	19	0	0
3	24999259	.	G	A	7	18	25	0	0	25	0	0
3	24999358	.	T	G	9	6	15	0	0	15	0	0
3	24999601	.	C	T	0	6	6	0	11	17	0	0
3	24999636	.	A	C	8	7	15	0	0	15	0	0
3	24999916	.	A	G	5	11	16	0	0	16	0	0
3	24999967	.	A	G	5	7	12	0	0	12	0	0
3	25000417	.	C	A	0	5	5	0	7	12	0	0
3	25005814	.	A	C	0	5	5	0	0	5	0	0
3	25024580	.	C	T	5	6	11	0	0	11	0	0
3	25030198	.	G	T	0	1	1	0	0	1	0	0
3	25030209	.	C	A	0	3	3	0	0	3	0	0
3	25030431	.	C	T	0	1	1	0	1	2	0	0
3	25030809	.	C	T	0	1	1	0	0	1	0	0
3	25031999	.	G	A	2	0	2	0	0	2	0	0
3	25033548	.	C	T	2	0	2	0	1	3	0	0
3	25039390	.	T	C	3	1	4	0	0	4	0	0
3	25046097	.	A	G	0	1	1	0	0	1	0	0
3	25046205	.	G	A	3	3	6	0	2	8	0	0
3	25051437	.	A	G	2	4	6	0	0	6	0	0
3	25055424	.	T	C	0	0	0	0	2	2	0	0
3	25059690	.	A	G	2	3	5	0	0	5	0	0
3	25059771	.	A	G	1	5	6	0	1	7	0	0
3	25059864	.	T	A	5	8	13	0	0	13	0	0
3	25060009	.	C	T	4	2	6	0	1	7	0	0
3	25075675	.	T	C	1	1	2	0	0	2	0	0
3	25080982	.	G	T	4	5	9	0	0	9	0	0
3	25081126	.	T	G	4	3	7	0	0	7	0	0
3	25086904	.	A	G	3	2	5	0	0	5	0	0
3	25097047	.	C	A	15	11	26	0	3	29	0	0
3	25099018	.	A	G	2	0	2	0	1	3	0	0
3	25099988	.	T	A	15	22	37	0	2	39	0	0
3	25100004	.	A	G	20	11	31	0	1	32	0	0
3	25100159	.	A	G	21	8	29	0	5	34	0	0
3	25100182	.	A	T	27	10	37	0	2	39	0	0
3	25100260	.	A	G	16	24	40	0	1	41	0	0
3	25100311	.	C	G	23	17	40	0	1	41	0	0
3	25100430	.	T	C	28	25	53	0	0	53	0	0
3	25100535	.	G	T	10	14	24	0	2	26	0	0
3	25100565	.	T	G	7	0	7	0	11	18	0	0
3	25100620	.	G	A	7	6	13	0	0	13	0	0
3	25102030	.	A	T	12	17	29	0	0	29	0	0
3	25102121	.	C	T	11	12	23	0	0	23	0	0
3	25107705	.	T	C	4	5	9	0	0	9	0	0
3	25107729	.	A	T	4	5	9	0	0	9	0	0
3	25136479	.	C	T	0	5	5	0	6	11	0	0
3	25136571	.	G	A	4	10	14	0	2	16	0	0
3	25136655	.	T	A	7	5	12	0	2	14	0	0
3	25136819	.	T	G	9	5	14	0	0	14	0	0
3	25136855	.	G	T	8	3	11	0	0	11	0	0
3	25137144	.	G	T	8	3	11	0	2	13	0	0
3	25137544	.	T	C	1	0	1	0	3	4	0	0
3	25137545	.	A	G	1	3	4	0	0	4	0	0
3	25137706	.	A	G	2	2	4	0	0	4	0	0
3	25138011	.	G	A	5	4	9	0	0	9	0	0
3	25138114	.	A	G	7	10	17	0	0	17	0	0
3	25138264	.	G	T	5	9	14	0	0	14	0	0
3	25138306	.	C	T	7	9	16	0	0	16	0	0
3	25138624	.	G	A	6	4	10	0	0	10	0	0
3	25138668	.	G	A	5	3	8	0	0	8	0	0
3	25138804	.	C	G	0	7	7	0	3	10	0	0
3	25142371	.	T	A	2	1	3	0	0	3	0	0
3	25144109	.	T	C	4	3	7	0	0	7	0	0
3	25147990	.	C	G	0	3	3	0	1	4	0	0
3	25167117	.	T	C	5	4	9	0	1	10	0	0
3	25167162	.	A	G	10	7	17	0	0	17	0	0
3	25167168	.	C	T	10	6	16	0	0	16	0	0
3	25167238	.	C	A	6	6	12	0	0	12	0	0
3	25167332	.	A	C	3	12	15	0	0	15	0	0
3	25167351	.	A	C	5	8	13	0	1	14	0	0
3	25168882	.	T	C	6	6	12	0	0	12	0	0
3	25168907	.	A	T	10	9	19	0	0	19	0	0
3	25168994	.	C	T	11	8	19	0	2	21	0	0
3	25270048	.	G	T	15	13	28	0	0	28	0	0
3	25270320	.	A	G	25	29	54	0	13	67	0	0
3	25270515	.	G	A	22	48	70	0	1	71	0	0
3	25271209	.	T	A	21	40	61	0	4	65	0	0
3	25271653	.	T	C	15	27	42	0	0	42	0	0
3	25272051	.	T	A	3	3	6	0	0	6	0	0
3	25272623	.	C	T	30	27	57	0	7	64	0	0
3	25272653	.	T	C	17	17	34	0	1	35	0	0
3	25272859	.	T	A	35	29	64	0	1	65	0	0
3	25273524	.	G	C	8	5	13	0	0	13	0	0
3	25273648	.	A	G	8	11	19	0	3	22	0	0
3	25282004	.	C	T	0	6	6	0	3	9	0	0
3	25282063	.	A	C	4	2	6	0	0	6	0	0
3	25282102	.	T	C	1	4	5	0	0	5	0	0
3	25282135	.	T	C	3	0	3	0	7	10	0	0
3	25282348	.	T	C	9	13	22	0	0	22	0	0
3	25282387	.	T	G	7	8	15	0	0	15	0	0
3	25282422	.	A	G	7	6	13	0	2	15	0	0
3	25282928	.	G	A	9	10	19	0	0	19	0	0
3	25282979	.	T	C	3	4	7	0	0	7	0	0
3	25286050	.	G	A	6	7	13	0	0	13	0	0
3	25312797	.	C	A	4	6	10	0	0	10	0	0
3	25322673	.	G	A	2	0	2	0	1	3	0	0
3	25381494	.	G	A	16	10	26	0	1	27	0	0
3	25391167	.	G	A	3	4	7	0	0	7	0	0
3	25393509	.	G	C	9	15	24	0	0	24	0	0
3	25393602	.	T	A	12	13	25	0	5	30	0	0
3	25393641	.	C	T	0	11	11	0	29	40	0	0
3	25393677	.	A	C	19	0	19	0	24	43	0	0
3	25393707	.	A	C	13	0	13	0	27	40	0	0
3	25393785	.	C	T	13	13	26	0	9	35	0	0
3	25396597	.	C	T	0	1	1	0	7	8	0	0
3	25396731	.	G	A	14	18	32	0	1	33	0	0
3	25400320	.	C	T	1	2	3	0	0	3	0	0
3	25403685	.	G	A	2	7	9	0	0	9	0	0
3	25403812	.	G	C	4	7	11	0	1	12	0	0
3	25404045	.	A	G	3	2	5	0	1	6	0	0
3	25404444	.	G	T	5	5	10	0	0	10	0	0
3	25404591	.	G	A	2	8	10	0	0	10	0	0
3	25404618	.	T	C	1	6	7	0	0	7	0	0
3	25404626	.	G	T	2	6	8	0	0	8	0	0
3	25404699	.	G	A	1	1	2	0	0	2	0	0
3	25405033	.	C	T	3	3	6	0	0	6	0	0
3	25405540	.	T	C	1	2	3	0	1	4	0	0
3	25409114	.	A	T	2	1	3	0	1	4	0	0
3	25414648	.	T	C	3	5	8	0	0	8	0	0
3	25416925	.	A	G	2	4	6	0	2	8	0	0
3	25416928	.	T	C	3	4	7	0	1	8	0	0
3	25417042	.	A	G	4	4	8	0	0	8	0	0
3	25417327	.	T	C	3	4	7	0	0	7	0	0
3	25420829	.	C	A	3	3	6	0	0	6	0	0
3	25420845	.	T	C	3	3	6	0	0	6	0	0
3	25436439	.	G	C	8	5	13	0	1	14	0	0
3	25436440	.	C	T	0	5	5	0	9	14	0	0
3	25436493	.	T	A	10	5	15	0	0	15	0	0
3	25436561	.	A	G	17	8	25	0	1	26	0	0
3	25436620	.	A	G	14	17	31	0	2	33	0	0
3	25436631	.	T	C	15	2	17	0	18	35	0	0
3	25436830	.	T	C	7	3	10	0	1	11	0	0
3	25437017	.	G	A	10	8	18	0	1	19	0	0
3	25437451	.	A	G	18	23	41	0	0	41	0	0
3	25437517	.	G	A	13	19	32	0	0	32	0	0
3	25491134	.	A	G	7	14	21	0	1	22	0	0
3	25492299	.	A	G	6	8	14	0	3	17	0	0
3	25509314	.	A	G	3	2	5	0	0	5	0	0
3	25510408	.	G	T	8	4	12	0	0	12	0	0
3	25510465	.	A	G	4	2	6	0	1	7	0	0
3	25510531	.	T	C	5	5	10	0	0	10	0	0
3	25510551	.	C	G	4	1	5	0	0	5	0	0
3	25510580	.	T	C	4	2	6	0	0	6	0	0
3	25510782	.	A	G	1	0	1	0	4	5	0	0
3	25510832	.	T	A	1	5	6	0	0	6	0	0
3	25510848	.	A	T	2	4	6	0	1	7	0	0
3	25510981	.	G	T	2	4	6	0	0	6	0	0
3	25511122	.	G	A	1	2	3	0	0	3	0	0
3	25511420	.	C	T	3	2	5	0	0	5	0	0
3	25511506	.	A	T	2	6	8	0	0	8	0	0
3	25709176	.	T	A	7	7	14	0	0	15	1	0
3	25709242	.	A	G	2	4	6	0	1	7	0	0
3	25710398	.	G	A	6	2	8	0	0	8	0	0
3	25710632	.	A	T	1	2	3	0	0	3	0	0
3	25710753	.	G	C	7	2	9	0	0	9	0	0
3	25710758	.	C	A	0	2	2	0	7	9	0	0
3	25710828	.	A	C	1	5	6	0	0	6	0	0
3	25710952	.	A	G	3	8	11	0	1	12	0	0
3	25711158	.	C	T	3	2	5	0	0	5	0	0
3	25756204	.	A	G	1	2	3	0	0	3	0	0
3	25812638	.	A	G	3	2	5	0	0	5	0	0
3	25813178	.	G	A	1	2	3	0	1	4	0	0
3	25813214	.	A	C	3	0	3	0	2	5	0	0
3	25813253	.	A	C	2	1	3	0	3	6	0	0
3	25813286	.	G	A	2	4	6	0	0	6	0	0
3	25857125	.	A	C	1	0	1	0	0	1	0	0
3	25857144	.	G	A	0	0	0	0	1	1	0	0
3	25894035	.	A	G	1	2	3	0	0	3	0	0
3	25914122	.	G	T	5	4	9	0	1	10	0	0
3	25914125	.	T	C	4	5	9	0	1	10	0	0
3	25914386	.	A	C	8	8	16	0	0	16	0	0
3	25914415	.	C	T	4	6	10	0	1	11	0	0
3	25917795	.	C	T	4	5	9	0	0	9	0	0
3	25918090	.	G	A	1	3	4	0	0	4	0	0
3	25938298	.	C	T	3	10	13	0	0	13	0	0
3	25938375	.	T	C	6	3	9	0	0	9	0	0
3	25938377	.	T	C	6	3	9	0	0	9	0	0
3	25938793	.	A	C	11	6	17	0	0	17	0	0
3	25938950	.	G	T	16	9	25	0	1	26	0	0
3	25990199	.	T	C	3	3	6	0	0	6	0	0
3	25992741	.	T	C	0	1	1	0	0	1	0	0
3	26032392	.	A	G	6	4	10	0	0	10	0	0
3	26157621	.	T	C	4	0	4	0	2	6	0	0
3	26157625	.	T	C	2	3	5	0	0	5	0	0
3	27695326	.	A	G	5	0	5	0	2	7	0	0
3	27695434	.	A	G	3	0	3	0	6	9	0	0
3	27695450	.	A	G	3	0	3	0	5	8	0	0
3	27767182	.	A	G	6	3	9	0	0	9	0	0
3	27767284	.	A	G	4	10	14	0	1	15	0	0
3	27767288	.	A	G	11	6	17	0	0	17	0	0
3	27831574	.	A	G	2	0	2	0	3	5	0	0
3	27833009	.	T	C	24	7	31	0	0	31	0	0
3	27833093	.	T	C	14	10	24	0	3	27	0	0
3	27834134	.	T	C	21	8	29	0	2	31	0	0
3	27834305	.	T	C	21	10	31	0	2	33	0	0
3	27834412	.	T	C	14	14	28	0	2	30	0	0
3	27836036	.	T	C	12	8	20	0	0	20	0	0
3	28208772	.	C	A	1	9	10	0	0	10	0	0
3	28581572	.	C	T	0	2	2	0	0	2	0	0
3	28626340	.	A	C	4	3	7	0	1	8	0	0
3	28627044	.	T	A	4	5	9	0	0	9	0	0
3	28634485	.	T	A	9	3	12	0	0	12	0	0
3	28634549	.	A	G	13	14	27	0	1	28	0	0
3	28634883	.	C	A	16	9	25	0	3	28	0	0
3	28634884	.	A	C	15	8	23	0	5	28	0	0
3	28635106	.	G	A	19	15	34	0	0	34	0	0
3	28640608	.	C	T	1	8	9	0	5	14	0	0
3	28640734	.	G	A	18	11	29	0	0	29	0	0
3	28650721	.	T	C	3	0	3	0	0	3	0	0
3	28665218	.	T	C	14	12	26	0	1	27	0	0
3	28665239	.	G	A	13	8	21	0	0	21	0	0
3	28719103	.	G	A	3	2	5	0	0	5	0	0
3	28719160	.	C	A	3	3	6	0	0	6	0	0
3	28719189	.	C	T	2	3	5	0	0	5	0	0
3	28719506	.	C	G	5	9	14	0	2	16	0	0
3	28719592	.	T	G	12	9	21	0	1	22	0	0
3	28719730	.	G	T	2	9	11	0	0	11	0	0
3	28719852	.	T	C	10	5	15	0	1	16	0	0
3	28719878	.	G	A	7	4	11	0	1	12	0	0
3	28719905	.	C	A	0	3	3	0	6	9	0	0
3	28719971	.	C	A	0	4	4	0	7	11	0	0
3	28720010	.	G	A	5	4	9	0	0	9	0	0
3	28750223	.	G	T	3	3	6	0	1	7	0	0
3	28750376	.	A	C	7	3	10	0	1	11	0	0
3	28750377	.	G	C	8	3	11	0	0	11	0	0
3	29950927	.	T	C	10	10	20	0	0	20	0	0
3	29951384	.	T	C	11	13	24	0	0	24	0	0
3	30749508	.	T	C	3	1	4	0	3	7	0	0
3	30749541	.	G	A	6	3	9	0	0	9	0	0
3	30801282	.	G	A	5	9	14	0	0	14	0	0
3	30801297	.	G	T	8	7	15	0	0	15	0	0
3	30860896	.	A	T	1	1	2	0	0	2	0	0
3	30868430	.	A	G	2	2	4	0	0	4	0	0
3	30868853	.	T	G	8	10	18	0	0	18	0	0
3	30868855	.	T	C	8	10	18	0	0	18	0	0
3	30869205	.	A	G	8	12	20	0	0	20	0	0
3	30869206	.	C	T	8	7	15	0	5	20	0	0
3	30869662	.	C	T	4	7	11	0	0	11	0	0
3	30869728	.	C	T	1	10	11	0	5	16	0	0
3	30869938	.	A	G	8	6	14	0	0	14	0	0
3	30870409	.	G	A	3	3	6	0	0	6	0	0
3	30870508	.	G	A	4	6	10	0	0	10	0	0
3	30870670	.	G	A	2	4	6	0	1	7	0	0
3	30870838	.	T	A	4	6	10	0	1	11	0	0
3	30870974	.	A	C	5	6	11	0	0	11	0	0
3	30871021	.	G	T	3	4	7	0	0	7	0	0
3	30871478	.	A	T	2	4	6	0	0	6	0	0
3	30871873	.	C	G	0	1	1	0	4	5	0	0
3	30872004	.	C	T	2	5	7	0	0	7	0	0
3	30872264	.	T	G	8	4	12	0	0	12	0	0
3	30872608	.	C	T	0	4	4	0	4	8	0	0
3	30872655	.	T	C	6	6	12	0	0	12	0	0
3	30873029	.	G	A	5	5	10	0	0	10	0	0
3	30873048	.	G	A	6	5	11	0	0	11	0	0
3	30873102	.	T	C	3	2	5	0	0	5	0	0
3	30873165	.	C	T	4	3	7	0	0	7	0	0
3	30873185	.	A	T	3	3	6	0	0	6	0	0
3	30873408	.	T	C	1	3	4	0	0	4	0	0
3	30890630	.	T	A	13	12	25	0	0	25	0	0
3	30890869	.	G	A	19	28	47	0	2	49	0	0
3	30891201	.	A	G	19	19	38	0	4	42	0	0
3	30894281	.	A	G	10	13	23	0	0	23	0	0
3	30926689	.	A	G	1	0	1	0	0	1	0	0
3	30926817	.	T	C	1	0	1	0	1	2	0	0
3	30948173	.	G	A	6	3	9	0	0	9	0	0
3	30948206	.	C	A	5	6	11	0	0	11	0	0
3	30962456	.	C	G	1	3	4	0	0	4	0	0
3	30962536	.	C	T	1	3	4	0	4	8	0	0
3	31043733	.	A	C	2	3	5	0	0	5	0	0
3	31043876	.	A	C	3	0	3	0	2	5	0	0
3	31044431	.	C	T	4	5	9	0	0	9	0	0
3	31044493	.	A	C	2	3	5	0	0	5	0	0
3	31044579	.	A	G	10	4	14	0	0	14	0	0
3	31044649	.	T	C	1	4	5	0	1	6	0	0
3	31044782	.	A	C	1	0	1	0	4	5	0	0
3	31044850	.	T	C	4	3	7	0	0	7	0	0
3	31044986	.	G	T	1	3	4	0	0	4	0	0
3	31045098	.	G	A	1	4	5	0	0	5	0	0
3	31045271	.	T	G	4	2	6	0	1	7	0	0
3	31045335	.	C	G	3	3	6	0	0	6	0	0
3	31045407	.	C	A	4	3	7	0	0	7	0	0
3	31045415	.	A	T	4	3	7	0	1	8	0	0
3	31052466	.	T	C	4	4	8	0	0	8	0	0
3	31052589	.	G	A	2	2	4	0	0	4	0	0
3	31053268	.	A	C	2	0	2	0	0	2	0	0
3	31060219	.	A	G	3	0	3	0	7	10	0	0
3	31060366	.	C	T	4	2	6	0	1	7	0	0
3	31063319	.	A	G	4	4	8	0	0	8	0	0
3	31063625	.	A	T	2	5	7	0	1	8	0	0
3	31066143	.	C	G	2	2	4	0	0	4	0	0
3	31069634	.	T	C	13	19	32	0	3	35	0	0
3	31070892	.	A	G	4	4	8	0	1	9	0	0
3	31084598	.	C	T	3	1	4	0	0	4	0	0
3	31086366	.	A	G	1	4	5	0	0	5	0	0
3	31090424	.	T	C	1	4	5	0	0	5	0	0
3	31104104	.	G	C	3	2	5	0	0	5	0	0
3	31104127	.	A	T	3	3	6	0	0	6	0	0
3	31104209	.	A	T	3	2	5	0	0	5	0	0
3	31104309	.	C	T	0	2	2	0	3	5	0	0
3	31104333	.	A	G	5	3	8	0	0	8	0	0
3	31104355	.	G	A	5	2	7	0	0	7	0	0
3	31104969	.	G	A	8	4	12	0	0	12	0	0
3	31105259	.	A	C	24	26	50	0	2	52	0	0
3	31120249	.	C	T	6	9	15	0	1	16	0	0
3	31122581	.	T	G	11	16	27	0	1	28	0	0
3	31135832	.	T	C	6	1	7	0	8	15	0	0
3	31135898	.	T	C	2	0	2	0	3	5	0	0
3	31137926	.	T	C	1	0	1	0	1	2	0	0
3	31137957	.	G	A	3	1	4	0	0	4	0	0
3	31138225	.	A	G	6	1	7	0	0	7	0	0
3	31138247	.	C	T	8	2	10	0	0	10	0	0
3	31140267	.	C	T	1	3	4	0	0	4	0	0
3	31143129	.	T	G	1	0	1	0	0	1	0	0
3	31146690	.	C	T	1	0	1	0	0	1	0	0
3	31149781	.	C	A	1	1	2	0	0	2	0	0
3	31150996	.	G	A	1	2	3	0	0	3	0	0
3	31151008	.	T	A	1	3	4	0	0	4	0	0
3	31187564	.	C	G	7	5	12	0	0	12	0	0
3	31187608	.	C	T	5	3	8	0	0	8	0	0
3	31201643	.	T	G	5	2	7	0	0	7	0	0
3	31217714	.	G	T	2	4	6	0	1	7	0	0
3	31217723	.	G	A	2	6	8	0	0	8	0	0
3	31218230	.	G	A	3	5	8	0	0	8	0	0
3	31218240	.	T	A	5	2	7	0	0	7	0	0
3	31396212	.	A	G	5	0	5	0	4	9	0	0
3	31396679	.	A	G	11	6	17	0	0	17	0	0
3	31396760	.	A	C	8	8	16	0	0	16	0	0
3	31396781	.	C	G	6	0	6	0	9	15	0	0
3	31396826	.	T	C	2	4	6	0	0	6	0	0
3	31430327	.	T	C	3	4	7	0	0	7	0	0
3	31600731	.	T	C	4	3	7	0	0	7	0	0
3	31603787	.	G	A	1	2	3	0	0	3	0	0
3	31603925	.	A	G	2	5	7	0	0	7	0	0
3	31603976	.	G	A	4	3	7	0	0	7	0	0
3	31604030	.	T	C	4	3	7	0	0	7	0	0
3	31604053	.	G	A	3	3	6	0	0	6	0	0
3	31604133	.	T	C	2	2	4	0	0	4	0	0
3	31604834	.	A	T	6	7	13	0	0	13	0	0
3	31623718	.	G	T	2	5	7	0	0	7	0	0
3	31706607	.	C	A	13	10	23	0	1	24	0	0
3	31706966	.	T	C	4	8	12	0	0	12	0	0
3	31709010	.	C	T	14	16	30	0	1	31	0	0
3	31709079	.	G	A	10	7	17	0	1	18	0	0
3	31711526	.	T	C	10	8	18	0	0	18	0	0
3	31712328	.	G	T	3	2	5	0	0	5	0	0
3	31717595	.	C	T	16	16	32	0	1	33	0	0
3	31722101	.	A	T	19	12	31	0	2	33	0	0
3	31722342	.	A	G	4	5	9	0	1	10	0	0
3	31725824	.	C	T	15	19	34	0	3	37	0	0
3	31726066	.	T	C	12	23	35	0	0	35	0	0
3	31726395	.	G	A	1	12	13	0	16	29	0	0
3	31726541	.	A	T	4	10	14	0	2	16	0	0
3	31726829	.	C	T	8	10	18	0	2	20	0	0
3	31726946	.	T	A	1	2	3	0	0	3	0	0
3	31729160	.	T	A	1	2	3	0	0	3	0	0
3	31729177	.	G	C	2	1	3	0	1	4	0	0
3	31729707	.	C	T	0	4	4	0	6	10	0	0
3	31734188	.	C	T	0	1	1	0	3	4	0	0
3	31792600	.	T	A	3	6	9	0	0	9	0	0
3	31792601	.	G	A	6	3	9	0	0	9	0	0
3	31792856	.	G	A	6	17	23	0	0	23	0	0
3	31793080	.	C	T	12	11	23	0	0	23	0	0
3	31793515	.	T	G	6	9	15	0	0	15	0	0
3	31793518	.	G	A	8	6	14	0	1	15	0	0
3	31793557	.	A	G	5	7	12	0	2	14	0	0
3	31793715	.	G	C	8	5	13	0	0	13	0	0
3	31793739	.	C	T	4	3	7	0	0	7	0	0
3	31797508	.	C	G	7	7	14	0	1	15	0	0
3	31797749	.	A	G	2	1	3	0	0	3	0	0
3	31804244	.	A	G	4	3	7	0	0	7	0	0
3	31816243	.	C	T	1	2	3	0	0	3	0	0
3	31874969	.	G	T	6	6	12	0	0	12	0	0
3	31879513	.	T	A	3	3	6	0	0	6	0	0
3	31879626	.	G	A	4	6	10	0	1	11	0	0
3	31879725	.	T	A	10	6	16	0	1	17	0	0
3	31879726	.	C	A	11	6	17	0	0	17	0	0
3	31879880	.	G	T	9	10	19	0	2	21	0	0
3	31879911	.	T	C	11	12	23	0	1	24	0	0
3	31880184	.	C	G	0	4	4	0	5	9	0	0
3	31880641	.	C	T	1	14	15	0	13	28	0	0
3	31881082	.	G	T	4	3	7	0	0	8	1	0
3	31884001	.	A	G	2	1	3	0	0	3	0	0
3	31884321	.	C	T	0	1	1	0	1	2	0	0
3	31884477	.	C	T	9	11	20	0	0	20	0	0
3	31886783	.	C	T	0	3	3	0	4	7	0	0
3	31892324	.	C	T	0	1	1	0	0	1	0	0
3	31897120	.	T	A	6	5	11	0	0	11	0	0
3	31914167	.	T	A	4	3	7	0	0	7	0	0
3	31916624	.	T	G	5	0	5	0	14	19	0	0
3	31916701	.	A	T	8	8	16	0	0	17	1	0
3	31916724	.	A	G	11	12	23	0	0	23	0	0
3	31916787	.	G	T	16	8	24	0	2	26	0	0
3	31916863	.	T	C	14	13	27	0	0	27	0	0
3	31917075	.	T	G	7	0	7	0	9	16	0	0
3	31917279	.	G	T	6	7	13	0	0	13	0	0
3	31922838	.	G	C	1	1	2	0	0	2	0	0
3	31939272	.	A	G	0	2	2	0	1	3	0	0
3	31939473	.	G	T	0	21	21	0	7	28	0	0
3	31939566	.	C	A	17	18	35	0	1	36	0	0
3	31941152	.	C	T	5	6	11	0	1	12	0	0
3	31944357	.	A	T	12	5	17	0	1	18	0	0
3	31951034	.	A	C	2	2	4	0	1	5	0	0
3	31961992	.	G	A	1	10	11	0	11	22	0	0
3	32021628	.	G	A	15	13	28	0	2	30	0	0
3	32049689	.	C	A	13	4	17	0	1	18	0	0
3	32049740	.	C	T	9	10	19	0	1	20	0	0
3	32079667	.	T	A	1	4	5	0	0	5	0	0
3	32081451	.	G	A	0	2	2	0	0	2	0	0
3	32082225	.	A	G	0	0	0	0	2	2	0	0
3	32083179	.	C	T	1	0	1	0	0	1	0	0
3	32087455	.	T	G	1	3	4	0	0	4	0	0
3	32098194	.	C	T	1	5	6	0	0	6	0	0
3	32099841	.	A	G	26	2	28	0	23	51	0	0
3	32100183	.	G	T	7	7	14	0	0	14	0	0
3	32100206	.	T	C	7	5	12	0	1	13	0	0
3	32100755	.	T	C	11	11	22	0	1	23	0	0
3	32105746	.	C	A	2	4	6	0	0	6	0	0
3	32139701	.	C	G	2	2	4	1	0	5	0	0
3	32169677	.	C	T	1	4	5	0	0	5	0	0
3	32175758	.	C	T	0	1	1	0	0	1	0	0
3	32294745	.	G	A	23	17	40	0	0	40	0	0
3	32294869	.	C	G	1	15	16	0	31	47	0	0
3	32295151	.	C	T	11	16	27	0	1	29	1	0
3	32295294	.	G	A	22	11	33	0	1	34	0	0
3	32295519	.	A	C	21	7	28	0	1	29	0	0
3	32295635	.	T	A	14	7	21	0	2	23	0	0
3	32296122	.	C	T	14	11	25	0	4	29	0	0
3	32296202	.	G	A	14	12	26	0	0	26	0	0
3	32296253	.	T	A	11	8	19	0	0	19	0	0
3	32296283	.	G	A	5	7	12	0	1	13	0	0
3	32296306	.	G	A	4	8	12	0	0	12	0	0
3	32296379	.	A	G	19	10	29	0	0	29	0	0
3	32296559	.	G	A	14	14	28	0	1	29	0	0
3	32296560	.	C	T	0	14	14	0	15	29	0	0
3	32296673	.	A	G	17	12	29	0	1	30	0	0
3	32296873	.	G	A	20	12	32	0	0	32	0	0
3	32303045	.	G	A	3	5	8	0	2	10	0	0
3	32303698	.	A	G	0	1	1	0	0	1	0	0
3	32314732	.	G	A	0	1	1	0	0	1	0	0
3	32325218	.	A	G	2	6	8	0	1	9	0	0
3	32329167	.	A	T	4	8	12	0	1	13	0	0
3	32357596	.	C	T	20	16	36	0	4	40	0	0
3	32357799	.	A	C	33	21	54	0	1	55	0	0
3	32360978	.	G	A	9	8	17	0	0	17	0	0
3	32361669	.	G	A	20	17	37	0	0	37	0	0
3	32361865	.	A	G	7	7	14	0	0	14	0	0
3	32366131	.	T	C	11	12	23	0	0	23	0	0
3	32366279	.	T	C	11	10	21	0	2	23	0	0
3	32366332	.	G	A	15	10	25	0	1	26	0	0
3	32366403	.	C	T	19	14	33	0	1	34	0	0
3	32400967	.	C	T	27	29	56	0	4	60	0	0
3	32401159	.	C	A	24	34	58	0	1	59	0	0
3	32401252	.	C	T	22	26	48	0	5	53	0	0
3	32403959	.	T	G	10	0	10	0	11	21	0	0
3	32405571	.	C	T	3	5	8	0	0	8	0	0
3	32405865	.	G	C	18	21	39	0	0	39	0	0
3	32405910	.	C	T	20	16	36	0	4	40	0	0
3	32406447	.	T	C	25	35	60	0	2	62	0	0
3	32406547	.	T	C	23	26	49	0	0	49	0	0
3	32406618	.	G	A	28	25	53	0	1	54	0	0
3	32406631	.	C	G	23	23	46	0	2	48	0	0
3	32414109	.	T	C	2	2	4	0	0	4	0	0
3	32414273	.	A	T	1	1	2	0	0	2	0	0
3	32414873	.	T	C	3	3	6	0	2	8	0	0
3	32414882	.	G	C	5	5	10	0	0	11	1	0
3	32415781	.	A	C	2	3	5	0	0	5	0	0
3	32434974	.	G	A	0	6	6	0	11	17	0	0
3	32435034	.	G	T	1	12	13	0	7	20	0	0
3	32435481	.	T	C	1	3	4	0	1	7	2	0
3	32435757	.	G	A	0	8	8	0	4	12	0	0
3	32435874	.	G	A	0	6	6	0	4	10	0	0
3	32436024	.	C	A	7	10	17	0	0	17	0	0
3	32436109	.	T	A	8	5	13	0	0	13	0	0
3	32436156	.	T	C	6	4	10	0	0	10	0	0
3	32436426	.	C	T	17	9	26	0	1	27	0	0
3	32436736	.	G	C	13	5	18	0	1	19	0	0
3	32436774	.	G	A	5	4	9	0	1	10	0	0
3	32438425	.	A	C	10	14	24	0	0	24	0	0
3	32440805	.	A	G	4	5	9	0	0	9	0	0
3	32441156	.	T	G	18	0	18	0	17	35	0	0
3	32441297	.	C	A	16	12	28	0	2	30	0	0
3	32441385	.	G	C	18	16	34	0	4	38	0	0
3	32441532	.	G	A	1	14	15	0	0	15	0	0
3	32441779	.	C	T	20	17	37	0	2	39	0	0
3	32447386	.	G	A	12	5	17	0	1	18	0	0
3	32447505	.	G	T	20	8	28	0	1	29	0	0
3	32447674	.	C	G	16	12	28	0	0	28	0	0
3	32447800	.	T	C	2	4	6	0	1	7	0	0
3	32450399	.	T	C	11	6	17	0	0	17	0	0
3	32453727	.	G	A	7	7	14	0	1	15	0	0
3	32457325	.	G	A	1	9	10	0	3	13	0	0
3	32457620	.	T	C	19	18	37	0	0	37	0	0
3	32457686	.	T	C	16	21	37	0	1	38	0	0
3	32458627	.	C	T	11	11	22	0	2	24	0	0
3	32460652	.	C	T	0	2	2	0	1	3	0	0
3	32477891	.	T	C	9	5	14	0	1	15	0	0
3	32477950	.	T	A	2	1	3	0	1	4	0	0
3	32479471	.	T	C	0	1	1	0	0	1	0	0
3	32482222	.	A	T	9	12	21	0	0	21	0	0
3	32482231	.	A	G	9	0	9	0	12	21	0	0
3	32482495	.	G	T	0	11	11	0	7	18	0	0
3	32482834	.	A	G	10	5	15	0	1	16	0	0
3	32483557	.	T	G	16	15	31	0	1	32	0	0
3	32483956	.	T	C	12	9	21	0	1	22	0	0
3	32484034	.	A	G	22	0	22	0	10	32	0	0
3	32484039	.	A	G	20	0	20	0	14	34	0	0
3	32484204	.	T	C	9	20	29	0	1	30	0	0
3	32484472	.	T	C	8	13	21	0	0	21	0	0
3	32484676	.	T	G	11	19	30	0	1	31	0	0
3	32484892	.	A	G	14	6	20	0	1	21	0	0
3	32485306	.	A	G	22	13	35	0	1	36	0	0
3	32485324	.	C	T	23	17	40	0	0	40	0	0
3	32485366	.	A	G	18	14	32	0	0	32	0	0
3	32485519	.	A	C	10	17	27	0	3	30	0	0
3	32485967	.	C	A	23	17	40	0	3	43	0	0
3	32486049	.	A	T	18	19	37	0	2	39	0	0
3	32486069	.	C	G	13	0	13	0	18	32	1	0
3	32489613	.	C	T	24	18	42	0	1	43	0	0
3	32490098	.	C	T	15	13	28	0	0	28	0	0
3	32490251	.	G	T	13	15	28	0	0	28	0	0
3	32490264	.	G	A	9	8	17	0	2	19	0	0
3	32490487	.	G	T	9	8	17	0	0	17	0	0
3	32532878	.	C	T	3	3	6	0	0	6	0	0
3	32534263	.	A	G	6	3	9	0	0	9	0	0
3	32534353	.	C	T	5	3	8	0	1	9	0	0
3	32534365	.	T	A	4	1	5	0	0	5	0	0
3	32587304	.	C	T	4	4	8	0	1	9	0	0
3	32641716	.	T	G	9	6	15	0	1	16	0	0
3	32643512	.	G	A	6	12	18	0	1	19	0	0
3	32647124	.	T	C	17	14	31	0	1	32	0	0
3	32647194	.	C	T	7	13	20	0	0	20	0	0
3	32647252	.	G	A	10	9	19	0	2	21	0	0
3	32647308	.	G	C	10	11	21	0	0	21	0	0
3	32647414	.	A	G	1	0	1	0	0	1	0	0
3	32647558	.	A	G	5	0	5	0	10	15	0	0
3	32649846	.	C	T	8	15	23	0	0	23	0	0
3	32649960	.	G	A	7	10	17	0	2	19	0	0
3	32650004	.	A	G	10	8	18	0	0	18	0	0
3	32650199	.	C	A	5	4	9	0	1	10	0	0
3	32658076	.	T	C	2	1	3	0	0	3	0	0
3	32662034	.	A	C	1	4	5	0	0	5	0	0
3	32663255	.	T	C	2	4	6	0	0	6	0	0
3	32663485	.	T	C	5	5	10	0	0	10	0	0
3	32663638	.	A	G	1	2	3	0	1	4	0	0
3	32663764	.	T	G	4	7	11	0	0	11	0	0
3	32667118	.	A	C	5	2	7	0	0	7	0	0
3	32668806	.	A	G	6	13	19	0	0	19	0	0
3	32668818	.	A	G	7	10	17	0	1	18	0	0
3	32669040	.	C	G	2	4	6	0	0	6	0	0
3	32669077	.	T	A	2	3	5	0	0	5	0	0
3	32672501	.	C	A	0	1	1	0	0	1	0	0
3	32675236	.	G	A	8	7	15	0	0	15	0	0
3	32679267	.	T	A	7	7	14	0	0	14	0	0
3	32679289	.	T	A	11	10	21	0	2	23	0	0
3	32679332	.	C	T	13	13	26	0	0	26	0	0
3	32679528	.	C	A	12	12	24	0	0	24	0	0
3	32685708	.	A	G	5	0	5	0	6	11	0	0
3	32686230	.	A	G	3	0	3	0	4	7	0	0
3	32686245	.	T	C	0	1	1	0	0	1	0	0
3	32686433	.	A	G	1	0	1	0	3	4	0	0
3	32698458	.	T	C	4	3	7	0	1	8	0	0
3	32698500	.	A	G	9	13	22	0	1	23	0	0
3	32700697	.	A	G	6	6	12	0	1	13	0	0
3	32700758	.	A	G	11	14	25	0	1	26	0	0
3	32700988	.	C	T	14	19	33	0	0	33	0	0
3	32701031	.	T	G	7	0	7	0	17	24	0	0
3	32702596	.	T	A	15	6	21	0	1	22	0	0
3	32707219	.	G	A	6	10	16	0	0	16	0	0
3	32707267	.	T	C	7	11	18	0	0	18	0	0
3	32707272	.	C	A	5	11	16	0	1	17	0	0
3	32707480	.	C	T	6	13	19	0	0	19	0	0
3	32707621	.	C	G	14	11	25	0	0	25	0	0
3	32707813	.	C	G	14	17	31	0	2	33	0	0
3	32708077	.	T	C	14	5	19	0	0	19	0	0
3	32710705	.	A	G	9	10	19	0	0	19	0	0
3	32710812	.	G	A	0	1	1	0	6	7	0	0
3	32710999	.	C	A	6	6	12	0	0	12	0	0
3	32711117	.	T	C	3	4	7	0	0	7	0	0
3	32711147	.	T	A	2	6	8	0	0	8	0	0
3	32718945	.	C	G	6	4	10	0	0	10	0	0
3	32719715	.	T	C	5	10	15	0	1	16	0	0
3	32720184	.	A	C	2	5	7	0	0	7	0	0
3	32722973	.	C	T	3	4	7	0	0	7	0	0
3	32723033	.	A	G	3	0	3	0	7	10	0	0
3	32723497	.	A	G	5	1	6	0	5	11	0	0
3	32723698	.	C	T	3	4	7	0	0	7	0	0
3	32724010	.	G	A	0	3	3	0	5	8	0	0
3	32726271	.	A	G	1	7	8	0	0	8	0	0
3	32728304	.	T	C	4	3	7	0	2	9	0	0
3	32729150	.	T	C	6	8	14	0	0	14	0	0
3	32729232	.	T	C	6	10	16	0	2	18	0	0
3	32729429	.	T	A	5	1	6	0	2	8	0	0
3	32729564	.	A	G	4	2	6	0	0	6	0	0
3	32729591	.	C	T	6	5	11	0	0	11	0	0
3	32729663	.	C	T	6	6	12	0	0	12	0	0
3	32729759	.	C	A	2	4	6	0	0	6	0	0
3	32729827	.	A	T	5	7	12	0	0	12	0	0
3	32729845	.	G	A	5	5	10	0	1	11	0	0
3	32730011	.	A	G	2	0	2	0	11	13	0	0
3	32730071	.	T	A	4	5	9	0	0	9	0	0
3	32730131	.	A	G	6	5	11	0	1	12	0	0
3	32731255	.	A	G	5	0	5	0	14	19	0	0
3	32731418	.	C	T	8	7	15	0	0	15	0	0
3	32731750	.	A	G	3	0	3	0	1	4	0	0
3	32731804	.	T	C	9	5	14	0	0	14	0	0
3	32731840	.	T	C	4	5	9	0	0	9	0	0
3	32731855	.	T	C	2	4	6	0	0	6	0	0
3	32731879	.	A	G	0	0	0	0	2	2	0	0
3	32737727	.	C	T	4	3	7	0	0	7	0	0
3	32741137	.	G	A	0	10	10	0	10	20	0	0
3	32741187	.	G	A	1	3	4	0	8	12	0	0
3	32741385	.	G	A	0	5	5	0	6	11	0	0
3	32741809	.	A	G	5	0	5	0	13	18	0	0
3	32777481	.	A	C	7	16	23	0	6	29	0	0
3	32777733	.	G	T	6	19	25	0	1	26	0	0
3	32789654	.	G	T	2	3	5	0	10	15	0	0
3	32789985	.	T	C	1	2	3	0	0	3	0	0
3	32794931	.	C	A	4	7	11	0	0	11	0	0
3	32795068	.	C	T	7	12	19	0	2	21	0	0
3	32795425	.	G	A	1	2	3	0	0	3	0	0
3	32795461	.	A	T	5	3	8	0	2	10	0	0
3	32795614	.	C	T	2	5	7	0	0	7	0	0
3	32807667	.	G	A	4	5	9	0	0	9	0	0
3	32808023	.	T	A	13	13	26	0	0	26	0	0
3	32808185	.	T	C	12	18	30	0	2	32	0	0
3	32808214	.	G	A	14	15	29	0	5	34	0	0
3	32808338	.	A	C	18	20	38	0	2	40	0	0
3	32808554	.	T	G	9	11	20	0	1	21	0	0
3	32808771	.	G	A	7	9	16	0	0	16	0	0
3	32808772	.	G	C	7	9	16	0	0	16	0	0
3	32808979	.	T	G	10	22	32	0	1	33	0	0
3	32809154	.	A	T	12	12	24	0	1	25	0	0
3	32809368	.	G	A	12	15	27	0	1	28	0	0
3	32809410	.	G	A	9	10	19	0	1	20	0	0
3	32809432	.	T	A	8	10	18	0	1	19	0	0
3	32809548	.	T	C	6	9	15	0	1	16	0	0
3	32809561	.	G	A	7	10	17	0	0	17	0	0
3	32809836	.	A	G	2	0	2	0	12	14	0	0
3	32809927	.	T	C	7	11	18	0	0	18	0	0
3	32810011	.	T	A	11	8	19	0	0	19	0	0
3	32810580	.	C	T	5	15	20	0	3	23	0	0
3	32810715	.	A	G	13	19	32	0	0	32	0	0
3	32811094	.	A	T	8	11	19	0	0	19	0	0
3	32824042	.	T	C	4	3	7	0	0	7	0	0
3	32824056	.	T	C	4	6	10	0	0	10	0	0
3	32824612	.	T	C	1	2	3	0	1	4	0	0
3	32825427	.	C	T	4	3	7	0	1	8	0	0
3	32825564	.	T	A	3	2	5	0	1	6	0	0
3	32825565	.	C	T	3	2	5	0	1	6	0	0
3	32831417	.	T	C	0	1	1	0	1	2	0	0
3	32837514	.	G	A	9	3	12	0	1	13	0	0
3	32837643	.	G	A	16	10	26	0	8	34	0	0
3	32837904	.	A	G	21	0	21	0	21	42	0	0
3	32838033	.	G	A	0	11	11	0	5	16	0	0
3	32838039	.	A	G	5	8	13	0	0	13	0	0
3	32842163	.	C	T	9	8	17	0	0	17	0	0
3	32842235	.	G	T	14	6	20	0	0	20	0	0
3	32842318	.	C	T	3	5	8	0	0	8	0	0
3	32847607	.	C	T	8	4	12	0	0	12	0	0
3	32847771	.	G	A	1	3	4	0	4	8	0	0
3	32847839	.	C	A	6	5	11	0	0	11	0	0
3	32847923	.	C	A	5	2	7	0	1	8	0	0
3	32847942	.	A	G	5	0	5	0	3	8	0	0
3	32848001	.	A	C	11	5	16	0	0	16	0	0
3	32848175	.	T	G	7	7	14	0	0	14	0	0
3	32848418	.	C	T	9	4	13	0	0	13	0	0
3	32848714	.	A	G	7	8	15	0	0	15	0	0
3	32849079	.	C	T	10	8	18	0	0	18	0	0
3	32849679	.	T	A	11	19	30	0	0	30	0	0
3	32850029	.	A	T	9	3	12	0	0	12	0	0
3	32850265	.	A	G	1	0	1	0	0	1	0	0
3	32854276	.	T	C	7	5	12	0	0	12	0	0
3	32854533	.	T	C	12	3	15	0	0	15	0	0
3	32854743	.	C	G	8	0	8	0	5	13	0	0
3	32854744	.	A	G	7	5	12	0	1	13	0	0
3	32855066	.	G	A	4	12	16	0	0	16	0	0
3	32855500	.	T	C	2	3	5	0	0	5	0	0
3	32863016	.	A	G	3	4	7	0	0	7	0	0
3	32864848	.	A	G	2	2	4	0	2	6	0	0
3	32864854	.	T	A	3	3	6	0	0	6	0	0
3	32867865	.	A	G	0	1	1	0	0	1	0	0
3	32868114	.	G	T	4	4	8	0	0	8	0	0
3	32868143	.	C	T	3	1	4	0	0	4	0	0
3	32868519	.	G	T	4	3	7	0	1	8	0	0
3	32868590	.	C	T	5	8	13	0	0	13	0	0
3	32868593	.	A	G	4	5	9	0	4	13	0	0
3	32869770	.	C	T	2	9	11	0	0	11	0	0
3	32869773	.	G	A	3	8	11	0	0	11	0	0
3	32869913	.	C	T	4	2	6	0	0	6	0	0
3	32869930	.	C	T	4	2	6	0	0	6	0	0
3	32870756	.	A	G	5	0	5	0	1	6	0	0
3	32870766	.	G	A	4	3	7	0	0	7	0	0
3	32871023	.	G	C	4	2	6	0	0	6	0	0
3	32871247	.	A	G	1	4	5	0	1	6	0	0
3	32871413	.	G	A	1	4	5	0	0	5	0	0
3	32871414	.	A	C	1	1	2	0	3	5	0	0
3	32871532	.	A	T	1	2	3	0	0	3	0	0
3	32889849	.	T	C	11	1	12	0	13	25	0	0
3	32890002	.	G	T	15	19	34	0	1	35	0	0
3	32890058	.	A	G	13	16	29	0	0	29	0	0
3	32892061	.	G	A	2	12	14	0	0	14	0	0
3	32892422	.	A	G	2	6	8	0	1	9	0	0
3	32900428	.	A	G	3	9	12	0	0	12	0	0
3	32924386	.	G	A	5	5	10	0	0	10	0	0
3	32924643	.	G	A	3	2	5	0	1	6	0	0
3	32924836	.	T	A	13	11	24	0	2	26	0	0
3	32924989	.	G	A	0	1	1	0	0	1	0	0
3	32925066	.	G	A	5	3	8	0	0	8	0	0
3	32925264	.	G	T	4	4	8	0	0	8	0	0
3	32926016	.	C	T	0	4	4	0	1	5	0	0
3	32926025	.	G	A	1	5	6	0	0	6	0	0
3	32926058	.	A	G	3	4	7	0	1	8	0	0
3	32933774	.	A	C	3	4	7	0	1	8	0	0
3	32933849	.	A	T	5	11	16	0	0	16	0	0
3	32935936	.	A	G	8	0	8	0	6	14	0	0
3	32937628	.	A	G	8	15	23	0	1	24	0	0
3	32941242	.	G	A	5	5	10	0	0	10	0	0
3	32941661	.	A	G	10	7	17	0	0	17	0	0
3	32944203	.	C	A	13	10	23	0	0	23	0	0
3	32944569	.	C	T	4	4	8	0	1	9	0	0
3	32944668	.	C	A	15	10	25	0	0	25	0	0
3	32944854	.	C	T	17	16	33	0	1	34	0	0
3	32947971	.	T	C	2	3	5	0	1	6	0	0
3	32950959	.	G	A	8	15	23	0	1	24	0	0
3	32950977	.	G	A	0	14	14	0	9	23	0	0
3	32951001	.	G	T	0	13	13	0	8	21	0	0
3	32951394	.	G	A	20	20	40	0	3	43	0	0
3	32951564	.	A	C	8	14	22	0	1	23	0	0
3	32951637	.	G	A	10	9	19	0	1	20	0	0
3	32951778	.	C	T	15	12	27	0	3	30	0	0
3	32951891	.	T	C	13	11	24	0	2	26	0	0
3	33065985	.	A	G	11	6	17	1	1	19	0	0
3	33066155	.	C	T	0	10	10	0	4	14	0	0
3	33066292	.	C	T	11	8	19	0	2	21	0	0
3	33066629	.	C	T	0	2	2	0	4	6	0	0
3	33066804	.	T	C	8	0	8	0	8	16	0	0
3	33066809	.	C	G	9	6	15	0	1	16	0	0
3	33066969	.	T	C	4	0	4	0	8	12	0	0
3	33066976	.	T	C	4	9	13	0	0	13	0	0
3	33067092	.	A	T	2	2	4	0	0	4	0	0
3	33067376	.	G	A	6	5	11	0	0	11	0	0
3	33067438	.	G	A	2	1	3	0	0	3	0	0
3	33069274	.	A	C	4	6	10	0	0	10	0	0
3	33069596	.	G	A	7	3	10	0	3	13	0	0
3	33075167	.	C	T	2	0	2	0	0	2	0	0
3	33341072	.	T	A	4	8	12	0	0	12	0	0
3	33344470	.	T	A	9	6	15	0	0	15	0	0
3	33368134	.	T	C	3	6	9	0	1	10	0	0
3	33372555	.	G	C	1	10	11	0	5	16	0	0
3	33373443	.	T	C	0	1	1	0	0	1	0	0
3	33373540	.	A	C	6	8	14	0	0	14	0	0
3	33375645	.	C	A	2	9	11	0	0	11	0	0
3	33379072	.	C	T	7	3	10	0	1	11	0	0
3	33379405	.	T	A	2	2	4	0	0	4	0	0
3	33396310	.	A	G	1	2	3	0	0	3	0	0
3	33424010	.	C	T	0	6	6	0	6	12	0	0
3	33424420	.	G	A	15	16	31	0	3	34	0	0
3	33426513	.	G	A	6	7	13	0	2	15	0	0
3	33432379	.	A	C	9	0	9	0	3	12	0	0
3	33432605	.	C	T	2	2	4	0	0	4	0	0
3	33433621	.	G	A	9	5	14	0	1	15	0	0
3	33440693	.	C	T	6	3	9	0	0	9	0	0
3	33445039	.	A	T	6	4	10	0	0	10	0	0
3	33445090	.	G	C	0	6	6	0	6	12	0	0
3	33449405	.	C	T	4	6	10	0	0	10	0	0
3	33449554	.	G	A	0	5	5	0	6	11	0	0
3	33452168	.	C	T	24	21	45	1	2	48	0	0
3	33455809	.	G	A	0	12	12	0	4	16	0	0
3	33458803	.	C	T	18	22	40	0	0	40	0	0
3	33458911	.	A	T	9	16	25	0	0	25	0	0
3	33459394	.	T	A	15	7	22	0	1	23	0	0
3	33459489	.	C	T	2	6	8	0	1	9	0	0
3	33459517	.	C	T	5	6	11	0	0	11	0	0
3	33459532	.	G	A	6	5	11	0	0	11	0	0
3	33461366	.	C	T	0	14	14	0	16	30	0	0
3	33461646	.	C	T	1	6	7	0	8	15	0	0
3	33461796	.	A	T	13	10	23	0	1	24	0	0
3	33469614	.	T	A	4	6	10	0	0	10	0	0
3	33473131	.	C	T	0	11	11	0	12	23	0	0
3	33476589	.	T	C	6	5	11	0	0	11	0	0
3	33478690	.	G	A	6	5	11	0	0	11	0	0
3	33494089	.	A	T	10	17	27	0	0	28	1	0
3	33494091	.	G	C	11	16	27	0	1	28	0	0
3	33570763	.	G	A	4	8	12	0	0	12	0	0
3	33571231	.	C	T	4	4	8	0	2	10	0	0
3	33571264	.	T	C	6	0	6	0	6	12	0	0
3	33571294	.	C	T	6	4	10	0	0	10	0	0
3	33572206	.	G	C	5	0	5	0	4	9	0	0
3	33572298	.	G	A	6	4	10	0	0	10	0	0
3	33572335	.	C	T	4	7	11	0	0	11	0	0
3	33572464	.	T	C	1	0	1	0	9	10	0	0
3	33572473	.	A	G	2	9	11	0	1	13	1	0
3	33572512	.	C	A	4	7	11	0	1	12	0	0
3	33572553	.	T	G	3	5	8	0	0	8	0	0
3	33572668	.	A	G	4	2	6	0	1	7	0	0
3	33573178	.	G	A	2	2	4	0	0	4	0	0
3	33747527	.	A	G	0	1	1	0	0	1	0	0
3	33747563	.	A	G	5	1	6	0	6	12	0	0
3	33761597	.	C	T	10	7	17	0	1	18	0	0
3	33761705	.	G	A	0	10	10	0	9	19	0	0
3	33761834	.	G	A	9	8	17	0	2	19	0	0
3	33761835	.	A	T	9	7	16	0	3	19	0	0
3	33762068	.	A	G	6	5	11	0	0	11	0	0
3	33762278	.	A	G	7	9	16	0	0	16	0	0
3	33762310	.	C	A	9	12	21	0	0	21	0	0
3	33762408	.	T	A	2	11	13	0	0	13	0	0
3	33762480	.	C	T	6	7	13	0	0	13	0	0
3	33773294	.	A	G	19	11	30	0	4	34	0	0
3	33777317	.	T	G	9	12	21	0	3	24	0	0
3	33777425	.	A	G	20	19	39	0	0	39	0	0
3	33777807	.	A	G	3	2	5	0	0	5	0	0
3	33820291	.	T	C	2	7	9	0	0	9	0	0
3	33820568	.	C	T	2	2	4	0	0	4	0	0
3	33820580	.	A	G	2	2	4	0	0	4	0	0
3	33821929	.	C	T	4	2	6	0	0	6	0	0
3	33844761	.	T	C	1	0	1	0	0	1	0	0
3	33847104	.	A	G	3	4	7	0	0	7	0	0
3	33847131	.	C	T	4	5	9	0	1	10	0	0
3	33847191	.	T	C	5	3	8	0	1	9	0	0
3	33854879	.	T	C	4	4	8	0	0	8	0	0
3	33854927	.	G	A	2	3	5	0	1	6	0	0
3	33918537	.	T	A	1	2	3	0	0	3	0	0
3	33918611	.	A	G	4	4	8	0	1	9	0	0
3	33918675	.	T	G	5	4	9	0	0	9	0	0
3	33918775	.	A	G	4	6	10	0	0	10	0	0
3	33921663	.	A	C	6	9	15	0	1	16	0	0
3	33921805	.	G	A	3	2	5	0	1	6	0	0
3	33921806	.	G	A	4	2	6	0	0	6	0	0
3	33922198	.	C	T	1	3	4	0	0	4	0	0
3	33922359	.	G	A	6	7	13	0	0	13	0	0
3	33922413	.	T	A	3	8	11	0	0	11	0	0
3	33922415	.	G	A	3	7	10	0	1	11	0	0
3	33922471	.	T	C	3	5	8	0	0	8	0	0
3	33932170	.	C	T	0	1	1	0	6	7	0	0
3	33932628	.	G	A	3	2	5	0	0	5	0	0
3	33934848	.	T	C	1	4	5	0	1	6	0	0
3	33934849	.	G	C	2	4	6	0	0	6	0	0
3	33936783	.	G	C	3	5	8	0	0	8	0	0
3	34129941	.	C	T	0	8	8	0	18	26	0	0
3	34135868	.	C	T	2	1	3	0	0	3	0	0
3	34144353	.	A	T	1	1	2	0	0	2	0	0
3	34144807	.	C	G	2	2	4	0	0	4	0	0
3	34144808	.	G	A	0	2	2	0	2	4	0	0
3	34145131	.	T	G	2	2	4	0	0	4	0	0
3	34146338	.	C	T	3	3	6	0	0	6	0	0
3	34146882	.	G	T	5	7	12	0	0	12	0	0
3	34146955	.	A	G	7	5	12	0	0	12	0	0
3	34166288	.	C	A	2	5	7	0	0	7	0	0
3	34170913	.	G	A	16	16	32	0	0	32	0	0
3	34180096	.	G	T	0	1	1	0	0	1	0	0
3	34180386	.	G	A	6	5	11	0	0	11	0	0
3	34182164	.	C	T	2	6	8	0	0	8	0	0
3	34182306	.	G	C	10	6	16	0	0	16	0	0
3	34182376	.	A	C	8	9	17	0	0	17	0	0
3	34182386	.	G	A	1	8	9	0	8	17	0	0
3	34220359	.	A	T	2	2	4	0	0	4	0	0
3	34258965	.	G	A	10	10	20	0	1	21	0	0
3	34259013	.	C	G	19	7	26	0	3	29	0	0
3	34259060	.	C	T	21	11	32	0	2	34	0	0
3	34259868	.	A	G	8	6	14	0	10	24	0	0
3	34260325	.	T	C	8	8	16	0	1	17	0	0
3	34260808	.	T	C	15	7	22	0	0	22	0	0
3	34261204	.	T	C	6	12	18	0	0	18	0	0
3	34261354	.	A	G	12	19	31	0	0	31	0	0
3	34261795	.	G	A	9	7	16	0	3	19	0	0
3	34262290	.	C	T	15	12	27	0	1	28	0	0
3	34262421	.	C	A	11	9	20	0	0	20	0	0
3	34262639	.	G	A	16	12	28	0	2	30	0	0
3	34262823	.	A	T	9	12	21	0	2	23	0	0
3	34263007	.	C	T	1	9	10	0	6	16	0	0
3	34264140	.	A	T	6	4	10	0	0	10	0	0
3	34264634	.	T	A	2	11	13	0	3	16	0	0
3	34264657	.	A	T	7	6	13	0	2	15	0	0
3	34270546	.	A	G	7	10	17	0	1	18	0	0
3	34327103	.	G	A	0	1	1	0	1	2	0	0
3	34337389	.	A	G	2	2	4	0	1	5	0	0
3	34456538	.	A	G	1	2	3	0	1	4	0	0
3	34588104	.	A	G	3	2	5	0	0	5	0	0
3	34588493	.	A	G	5	2	7	0	0	7	0	0
3	34589396	.	A	C	2	4	6	0	0	6	0	0
3	34604202	.	A	G	2	1	3	0	1	4	0	0
3	34697461	.	G	A	4	7	11	0	0	11	0	0
3	34697514	.	T	C	11	0	11	0	10	21	0	0
3	34703722	.	T	G	3	4	7	0	0	7	0	0
3	34703731	.	G	C	3	3	6	0	0	6	0	0
3	34766992	.	T	C	4	3	7	0	3	10	0	0
3	34767112	.	G	T	19	25	44	0	4	48	0	0
3	34767662	.	T	G	29	33	62	0	2	64	0	0
3	34767669	.	G	A	28	34	62	0	1	63	0	0
3	34772941	.	T	G	14	24	38	0	0	38	0	0
3	34775942	.	G	A	21	19	40	0	1	41	0	0
3	34776115	.	T	G	3	3	6	0	1	7	0	0
3	34776133	.	G	C	5	2	7	0	1	8	0	0
3	34776151	.	C	A	5	3	8	0	0	8	0	0
3	34781074	.	A	G	30	26	56	0	2	58	0	0
3	34781095	.	C	T	31	21	52	0	4	56	0	0
3	34781448	.	T	C	7	14	21	0	0	21	0	0
3	34781586	.	T	C	3	0	3	0	1	4	0	0
3	34783970	.	G	A	6	6	12	0	1	13	0	0
3	34783982	.	A	G	7	9	16	0	0	16	0	0
3	34801034	.	T	C	6	9	15	0	0	15	0	0
3	34804427	.	A	G	7	9	16	0	3	19	0	0
3	34814839	.	A	G	3	4	7	0	1	8	0	0
3	34822049	.	C	T	16	16	32	0	1	33	0	0
3	34822169	.	C	T	15	12	27	0	0	27	0	0
3	34822214	.	T	C	11	16	27	0	0	27	0	0
3	34919853	.	A	G	3	0	3	0	2	5	0	0
3	34919892	.	C	T	6	13	19	0	0	19	0	0
3	34977497	.	A	G	2	1	3	0	6	9	0	0
3	34977508	.	A	G	1	0	1	0	2	3	0	0
3	34994140	.	C	T	30	25	55	0	2	57	0	0
3	34994750	.	A	G	9	15	24	0	0	24	0	0
3	35170112	.	T	C	7	7	14	0	0	14	0	0
3	35225160	.	A	G	16	0	16	0	13	29	0	0
3	35225202	.	C	T	16	18	34	0	2	36	0	0
3	35248387	.	T	C	13	6	19	0	8	27	0	0
3	35248470	.	T	C	9	7	16	0	1	17	0	0
3	35248492	.	T	A	11	10	21	0	0	21	0	0
3	35249369	.	T	C	16	11	27	0	0	27	0	0
3	35249535	.	T	C	10	21	31	0	0	31	0	0
3	35250145	.	A	T	24	22	46	0	0	46	0	0
3	35250188	.	A	G	12	21	33	0	4	37	0	0
3	35264406	.	T	G	26	23	49	0	1	52	2	0
3	35264460	.	C	T	22	20	42	0	1	43	0	0
3	35264744	.	T	A	20	12	32	0	0	32	0	0
3	35264951	.	G	A	12	15	27	0	0	27	0	0
3	35265350	.	T	C	20	12	32	0	1	33	0	0
3	35265419	.	T	G	17	15	32	0	0	32	0	0
3	35265654	.	G	A	0	28	28	0	25	53	0	0
3	35298531	.	G	T	4	9	13	0	0	13	0	0
3	35298725	.	T	A	5	7	12	0	2	14	0	0
3	35374719	.	C	T	11	15	26	0	1	27	0	0
3	35375112	.	G	A	20	8	28	0	1	29	0	0
3	35375162	.	T	A	22	10	32	0	1	33	0	0
3	35375279	.	A	T	12	7	19	0	2	21	0	0
3	35375306	.	T	C	11	8	19	0	0	19	0	0
3	35375448	.	T	G	20	0	20	0	11	32	1	0
3	35375638	.	T	A	15	19	34	0	1	35	0	0
3	35406475	.	G	A	3	11	14	0	1	15	0	0
3	35406648	.	G	T	0	6	6	0	1	7	0	0
3	35419683	.	A	T	11	12	23	0	1	24	0	0
3	35420588	.	A	G	8	7	15	0	1	16	0	0
3	35420604	.	C	T	8	4	12	0	1	13	0	0
3	35514786	.	C	T	7	9	16	0	0	16	0	0
3	35514849	.	C	A	6	8	14	0	3	17	0	0
3	35515053	.	G	T	7	5	12	0	2	14	0	0
3	35515074	.	C	T	6	6	12	0	1	13	0	0
3	35515103	.	G	A	3	6	9	0	0	9	0	0
3	35515179	.	T	C	3	6	9	0	0	9	0	0
3	35515206	.	G	A	4	3	7	0	0	7	0	0
3	35515304	.	T	G	4	7	11	0	0	11	0	0
3	35515866	.	A	T	10	7	17	0	0	17	0	0
3	35517999	.	A	C	3	9	12	0	0	12	0	0
3	35518036	.	C	G	9	10	19	0	0	19	0	0
3	35518464	.	A	C	0	1	1	0	0	1	0	0
3	35518962	.	C	A	2	5	7	0	1	8	0	0
3	35523824	.	C	G	7	8	15	0	0	15	0	0
3	35527024	.	T	C	3	4	7	0	0	7	0	0
3	35529040	.	T	C	10	16	26	0	0	26	0	0
3	35530165	.	T	A	3	1	4	0	0	4	0	0
3	35530167	.	T	A	3	1	4	0	0	4	0	0
3	35530787	.	C	T	3	4	7	0	0	7	0	0
3	35531018	.	T	C	7	10	17	0	0	17	0	0
3	35531028	.	T	C	11	10	21	0	0	21	0	0
3	35531328	.	G	A	0	9	9	0	9	18	0	0
3	35531329	.	A	T	9	9	18	0	0	18	0	0
3	35531671	.	A	T	5	14	19	0	1	20	0	0
3	35531791	.	A	G	20	1	21	0	18	39	0	0
3	35531866	.	T	A	17	19	36	0	1	37	0	0
3	35531985	.	G	A	22	18	40	0	1	41	0	0
3	35532074	.	A	T	16	10	26	0	0	26	0	0
3	35532452	.	A	T	22	22	44	0	3	47	0	0
3	35532634	.	A	G	17	0	17	0	16	33	0	0
3	35532665	.	C	T	12	15	27	0	4	31	0	0
3	35532736	.	A	C	14	6	20	0	1	21	0	0
3	35535484	.	G	A	2	2	4	0	0	4	0	0
3	35535588	.	A	G	1	3	4	0	0	4	0	0
3	35535589	.	C	T	0	3	3	0	1	4	0	0
3	35536115	.	C	G	7	8	15	0	0	15	0	0
3	35536269	.	G	A	2	1	3	0	0	3	0	0
3	35541273	.	A	G	30	28	58	0	2	60	0	0
3	35548780	.	T	C	3	5	8	0	0	8	0	0
3	35548822	.	C	A	2	1	3	0	2	5	0	0
3	35549002	.	G	A	6	5	11	0	0	11	0	0
3	35549223	.	A	T	2	2	4	0	0	4	0	0
3	35549282	.	T	G	3	2	5	0	0	5	0	0
3	35551047	.	A	T	13	16	29	0	2	31	0	0
3	35551190	.	C	T	0	6	6	0	14	20	0	0
3	35589548	.	C	T	21	25	46	0	4	50	0	0
3	35589881	.	T	C	17	22	39	0	6	45	0	0
3	35589908	.	A	G	24	26	50	0	0	50	0	0
3	35589918	.	G	A	24	26	50	0	1	51	0	0
3	35590270	.	T	C	27	2	29	0	23	52	0	0
3	35602007	.	A	C	21	0	21	0	26	47	0	0
3	35602047	.	A	G	25	26	51	0	1	52	0	0
3	35602153	.	A	G	18	17	35	0	2	37	0	0
3	35602154	.	T	A	18	18	36	0	1	37	0	0
3	35617940	.	A	C	2	3	5	0	0	5	0	0
3	35617943	.	A	C	2	3	5	0	0	5	0	0
3	35621473	.	G	A	0	2	2	0	2	4	0	0
3	35621515	.	T	G	7	0	7	0	4	11	0	0
3	35623614	.	A	G	2	1	3	0	0	3	0	0
3	35634953	.	A	G	2	5	7	0	0	7	0	0
3	35635039	.	C	T	7	4	11	0	0	11	0	0
3	35636157	.	A	G	4	2	6	0	0	6	0	0
3	35636188	.	A	G	3	0	3	0	8	11	0	0
3	35636388	.	A	G	2	3	5	0	1	6	0	0
3	35636410	.	A	G	2	4	6	0	0	6	0	0
3	35638008	.	T	A	18	9	27	0	0	27	0	0
3	35638119	.	A	C	18	17	35	0	0	35	0	0
3	35638201	.	A	G	7	16	23	0	2	25	0	0
3	35638240	.	C	T	11	9	20	0	1	21	0	0
3	35638366	.	T	C	7	8	15	0	0	15	0	0
3	35638450	.	T	A	5	10	15	0	1	16	0	0
3	35638513	.	G	A	13	9	22	0	0	22	0	0
3	35638908	.	C	T	0	26	26	0	16	42	0	0
3	35638986	.	C	A	17	22	39	0	0	39	0	0
3	35639020	.	A	G	18	14	32	0	1	33	0	0
3	35639021	.	G	A	18	14	32	0	1	33	0	0
3	35639194	.	T	C	8	15	23	0	3	26	0	0
3	35639621	.	A	C	13	15	28	0	0	28	0	0
3	35639817	.	T	A	2	10	12	0	2	14	0	0
3	35639862	.	G	T	12	9	21	0	0	21	0	0
3	35639884	.	T	C	11	0	11	0	9	20	0	0
3	35640042	.	A	G	11	7	18	0	1	19	0	0
3	35640122	.	G	T	11	10	21	0	1	22	0	0
3	35640441	.	C	A	9	6	15	0	0	15	0	0
3	35640588	.	A	G	4	7	11	1	0	12	0	0
3	35640625	.	C	T	8	12	20	0	0	20	0	0
3	35640784	.	T	C	16	17	33	0	1	34	0	0
3	35640828	.	A	G	11	6	17	0	1	18	0	0
3	35641173	.	C	T	3	7	10	0	0	10	0	0
3	35641371	.	C	T	0	17	17	0	17	34	0	0
3	35641382	.	G	A	20	16	36	0	0	36	0	0
3	35641595	.	A	T	10	8	18	0	1	19	0	0
3	35641663	.	T	C	10	3	13	0	0	13	0	0
3	35641785	.	C	T	0	12	12	0	8	20	0	0
3	35642012	.	A	T	10	10	20	0	0	20	0	0
3	35642072	.	A	G	10	10	20	0	0	20	0	0
3	35642242	.	T	C	6	0	6	0	4	10	0	0
3	35642462	.	T	C	14	0	14	0	4	18	0	0
3	35643320	.	G	A	4	4	8	0	0	8	0	0
3	35643373	.	A	C	2	0	2	0	5	7	0	0
3	35643378	.	T	G	0	0	0	0	13	13	0	0
3	35643540	.	G	A	8	7	15	0	0	15	0	0
3	35643546	.	A	T	7	5	12	0	1	13	0	0
3	35645380	.	T	C	14	2	16	0	14	30	0	0
3	35645411	.	G	A	8	7	15	0	1	16	0	0
3	35645661	.	T	G	14	17	31	0	0	31	0	0
3	35646025	.	G	T	10	8	18	0	1	19	0	0
3	35646160	.	G	T	10	3	13	0	0	13	0	0
3	35646611	.	T	G	3	7	10	0	0	10	0	0
3	35647181	.	A	G	12	12	24	0	1	25	0	0
3	35647321	.	G	A	6	15	21	0	0	21	0	0
3	35647882	.	G	A	1	0	1	0	0	1	0	0
3	35647975	.	A	G	2	4	6	0	0	6	0	0
3	35652750	.	G	A	0	1	1	0	0	1	0	0
3	35652765	.	G	A	2	2	4	0	0	4	0	0
3	35800614	.	C	G	2	5	7	0	3	10	0	0
3	35800738	.	T	C	2	5	7	0	0	7	0	0
3	35800936	.	A	C	3	3	6	0	0	6	0	0
3	35800995	.	A	G	1	2	3	0	0	3	0	0
3	35801019	.	A	T	1	2	3	0	0	3	0	0
3	35831029	.	T	C	1	1	2	0	0	2	0	0
3	35831167	.	T	C	3	2	5	0	0	5	0	0
3	35837532	.	C	T	0	3	3	0	0	3	0	0
3	35840264	.	A	G	1	0	1	0	9	10	0	0
3	35840267	.	T	A	1	9	10	0	0	10	0	0
3	35845735	.	A	G	0	1	1	0	0	1	0	0
3	35845774	.	T	C	3	2	5	0	0	5	0	0
3	35845805	.	A	G	3	3	6	0	0	6	0	0
3	35846120	.	C	G	3	4	7	0	0	7	0	0
3	35846343	.	C	G	4	3	7	0	0	7	0	0
3	35846410	.	A	T	3	4	7	0	0	7	0	0
3	35846440	.	G	A	2	5	7	0	1	8	0	0
3	35846823	.	A	G	5	8	13	0	0	13	0	0
3	35850254	.	G	A	1	2	3	0	0	3	0	0
3	35850364	.	A	G	2	4	6	0	0	6	0	0
3	35850380	.	C	T	3	6	9	0	0	9	0	0
3	35864419	.	G	A	0	2	2	0	0	2	0	0
3	35864993	.	T	G	1	2	3	0	0	3	0	0
3	36023342	.	T	G	17	20	37	0	0	37	0	0
3	36023455	.	A	G	13	24	37	0	1	38	0	0
3	36023465	.	A	G	13	26	39	0	1	40	0	0
3	36026294	.	C	G	0	15	15	0	5	20	0	0
3	36032241	.	G	A	6	0	6	0	0	6	0	0
3	36038631	.	G	A	17	19	36	0	1	37	0	0
3	36040863	.	A	G	2	8	10	0	0	10	0	0
3	36041017	.	A	C	10	7	17	0	0	17	0	0
3	36123546	.	G	A	1	1	2	0	0	2	0	0
3	36125256	.	C	G	0	2	2	0	5	7	0	0
3	36127040	.	A	G	1	2	3	0	0	3	0	0
3	36127055	.	T	A	1	2	3	0	0	3	0	0
3	36127105	.	T	C	4	0	4	0	2	6	0	0
3	36127108	.	G	A	4	2	6	0	0	6	0	0
3	36129027	.	A	T	1	3	4	0	0	4	0	0
3	36129646	.	T	G	1	2	3	0	0	3	0	0
3	36131883	.	T	A	6	4	10	0	0	10	0	0
3	36132099	.	C	T	1	0	1	0	0	1	0	0
3	36132740	.	T	C	7	9	16	0	0	16	0	0
3	36134956	.	T	C	2	2	4	0	0	4	0	0
3	36134960	.	G	T	2	2	4	0	0	4	0	0
3	36135084	.	A	G	3	3	6	0	0	6	0	0
3	36135481	.	A	G	2	3	5	0	0	5	0	0
3	36135599	.	T	C	2	2	4	0	0	4	0	0
3	36135641	.	T	A	2	2	4	0	0	4	0	0
3	36135867	.	A	C	0	1	1	0	2	3	0	0
3	36136855	.	C	T	3	2	5	0	0	5	0	0
3	36143844	.	G	A	1	1	2	0	0	2	0	0
3	36167286	.	T	C	2	5	7	0	0	7	0	0
3	36173633	.	T	C	14	13	27	0	0	27	0	0
3	36174175	.	C	A	10	18	28	0	5	33	0	0
3	36174248	.	C	G	15	10	25	0	0	25	0	0
3	36174276	.	T	C	15	1	16	0	12	28	0	0
3	36184806	.	A	G	2	10	12	0	0	12	0	0
3	36188400	.	A	G	0	8	8	0	0	8	0	0
3	36210030	.	G	A	7	7	14	0	0	14	0	0
3	36210074	.	C	T	5	7	12	0	0	12	0	0
3	36210307	.	T	A	3	2	5	0	0	5	0	0
3	36228319	.	T	G	0	3	3	0	0	3	0	0
3	36229823	.	G	A	2	6	8	0	0	8	0	0
3	36232218	.	A	G	2	4	6	0	0	6	0	0
3	36232331	.	C	T	4	7	11	0	0	11	0	0
3	36232368	.	A	C	4	4	8	0	0	8	0	0
3	36241839	.	T	C	4	1	5	0	0	5	0	0
3	36241938	.	T	C	5	1	6	0	4	10	0	0
3	36242239	.	C	T	0	1	1	0	5	6	0	0
3	36249172	.	C	T	14	5	19	0	0	19	0	0
3	36249419	.	G	A	22	3	25	0	1	26	0	0
3	36249476	.	T	A	20	18	38	0	2	40	0	0
3	36249516	.	T	A	13	12	25	0	1	26	0	0
3	36249518	.	A	C	13	12	25	0	1	26	0	0
3	36253186	.	G	A	1	0	1	0	0	1	0	0
3	36255436	.	A	G	4	3	7	0	1	8	0	0
3	36259855	.	T	C	18	18	36	0	0	36	0	0
3	36262799	.	A	C	16	0	16	0	13	29	0	0
3	36263099	.	T	C	15	0	15	0	18	33	0	0
3	36263151	.	A	G	14	17	31	0	3	34	0	0
3	36263163	.	C	T	14	19	33	0	0	33	0	0
3	36263464	.	C	A	12	18	30	0	0	30	0	0
3	36263557	.	A	G	11	16	27	0	0	27	0	0
3	36263563	.	T	A	11	17	28	0	0	28	0	0
3	36263596	.	T	C	8	0	8	0	14	22	0	0
3	36263666	.	T	C	2	0	2	0	18	20	0	0
3	36263824	.	T	C	23	19	42	0	0	42	0	0
3	36263895	.	A	T	15	17	32	0	2	34	0	0
3	36264028	.	T	C	16	1	17	0	15	32	0	0
3	36264204	.	T	G	12	11	23	0	0	23	0	0
3	36264217	.	A	C	10	11	21	0	0	22	1	0
3	36264248	.	T	C	18	8	26	0	0	26	0	0
3	36264822	.	C	A	3	7	10	0	1	11	0	0
3	36265895	.	C	T	0	6	6	0	2	8	0	0
3	36266137	.	T	A	3	1	4	0	0	4	0	0
3	36266173	.	A	G	9	3	12	0	2	14	0	0
3	36268616	.	A	G	12	11	23	0	2	25	0	0
3	36285177	.	C	A	4	2	6	0	1	7	0	0
3	36291213	.	A	G	8	0	8	0	3	11	0	0
3	36292481	.	G	C	0	1	1	0	7	8	0	0
3	36292657	.	T	C	1	3	4	0	1	5	0	0
3	36293950	.	C	T	5	4	9	0	0	9	0	0
3	36293964	.	C	T	5	4	9	0	0	9	0	0
3	36305854	.	A	G	18	17	35	0	1	36	0	0
3	36305860	.	A	G	18	0	18	0	19	37	0	0
3	36305971	.	T	A	6	13	19	0	0	19	0	0
3	36319778	.	T	A	4	2	6	0	0	6	0	0
3	36323001	.	T	C	2	4	6	0	1	7	0	0
3	36323598	.	A	C	0	3	3	0	0	3	0	0
3	36323604	.	C	T	0	3	3	0	0	3	0	0
3	36325569	.	T	A	2	3	5	0	0	5	0	0
3	36325648	.	A	T	10	5	15	0	1	16	0	0
3	36325726	.	C	T	5	4	9	0	0	9	0	0
3	36325802	.	A	G	3	0	3	0	8	11	0	0
3	36326003	.	T	C	3	2	5	0	0	5	0	0
3	36326031	.	C	T	4	3	7	0	0	7	0	0
3	36326091	.	A	C	5	2	7	0	1	8	0	0
3	36326108	.	A	T	5	2	7	0	0	7	0	0
3	36326139	.	T	G	1	4	5	0	0	5	0	0
3	36326370	.	A	G	8	6	14	0	0	14	0	0
3	36326554	.	G	A	4	2	6	0	0	6	0	0
3	36326681	.	T	C	5	2	7	0	0	7	0	0
3	36326685	.	T	A	5	2	7	0	0	7	0	0
3	36327129	.	G	A	9	7	16	0	0	16	0	0
3	36327260	.	T	C	3	2	5	0	0	5	0	0
3	36327773	.	A	T	3	5	8	0	0	8	0	0
3	36327872	.	G	A	7	4	11	0	1	12	0	0
3	36327906	.	G	T	6	5	11	0	1	12	0	0
3	36327909	.	G	T	0	5	5	0	7	12	0	0
3	36328029	.	T	G	4	3	7	0	0	7	0	0
3	36328083	.	G	T	2	6	8	0	0	8	0	0
3	36328204	.	C	A	9	2	11	0	1	12	0	0
3	36328218	.	G	A	11	4	15	0	0	15	0	0
3	36328339	.	G	A	2	3	5	0	0	5	0	0
3	36328390	.	A	T	1	2	3	0	0	3	0	0
3	36328414	.	T	A	1	3	4	0	0	4	0	0
3	36349176	.	T	C	0	2	2	0	0	2	0	0
3	36402930	.	T	C	1	0	1	0	5	6	0	0
3	36407283	.	C	A	1	1	2	0	0	2	0	0
3	36407604	.	A	G	5	2	7	0	0	7	0	0
3	36408402	.	G	T	2	1	3	0	0	3	0	0
3	36409656	.	C	T	2	2	4	0	0	4	0	0
3	36409721	.	G	A	2	2	4	0	0	4	0	0
3	36409877	.	C	T	4	9	13	0	0	13	0	0
3	36409969	.	T	C	3	5	8	0	0	8	0	0
3	36409995	.	T	C	2	0	2	0	4	6	0	0
3	36410038	.	T	A	1	2	3	0	0	3	0	0
3	36410157	.	A	G	2	2	4	0	0	4	0	0
3	36410172	.	A	G	1	2	3	0	1	4	0	0
3	36415987	.	A	G	0	1	1	0	0	1	0	0
3	36416026	.	C	A	1	2	3	0	1	4	0	0
3	36419413	.	A	C	2	4	6	0	0	6	0	0
3	36419512	.	C	T	1	2	3	0	0	3	0	0
3	36428612	.	T	A	16	16	32	0	3	35	0	0
3	36428620	.	T	A	21	13	34	0	1	35	0	0
3	36431380	.	T	C	9	9	18	0	1	19	0	0
3	36442021	.	T	C	4	7	11	0	1	12	0	0
3	36442029	.	A	G	4	5	9	0	0	9	0	0
3	36442071	.	A	G	1	4	5	0	0	5	0	0
3	36442551	.	C	T	0	13	13	0	11	24	0	0
3	36442661	.	T	G	14	6	20	0	0	20	0	0
3	36442726	.	A	G	18	10	28	0	1	29	0	0
3	36443189	.	G	A	0	2	2	0	0	2	0	0
3	36446613	.	A	G	5	5	10	0	0	10	0	0
3	37051914	.	A	G	1	2	3	0	0	3	0	0
3	37107093	.	C	T	4	2	6	0	3	9	0	0
3	37237897	.	T	C	6	6	12	0	3	15	0	0
3	37237898	.	T	C	10	5	15	0	0	15	0	0
3	37559334	.	A	T	28	25	53	0	1	54	0	0
3	37559905	.	A	C	23	17	40	0	1	41	0	0
3	37560271	.	A	G	22	3	25	0	3	28	0	0
3	37564769	.	G	A	14	21	35	0	0	35	0	0
3	37649598	.	G	C	1	4	5	0	0	5	0	0
3	37660307	.	G	A	5	6	11	0	0	11	0	0
3	37664117	.	A	T	13	8	21	0	1	22	0	0
3	37664635	.	A	G	13	9	22	0	0	22	0	0
3	37665855	.	G	A	21	23	44	0	1	45	0	0
3	37666774	.	C	T	0	13	13	0	22	35	0	0
3	37667562	.	C	T	0	10	10	0	25	35	0	0
3	37667608	.	G	C	16	13	29	0	1	30	0	0
3	37667646	.	C	T	12	14	26	0	2	28	0	0
3	37667952	.	C	T	0	14	14	0	12	26	0	0
3	37668319	.	A	G	7	7	14	0	0	14	0	0
3	37668667	.	C	A	10	11	21	0	0	21	0	0
3	37673750	.	T	A	4	6	10	0	0	10	0	0
3	37725453	.	A	G	3	0	3	0	5	8	0	0
3	37726111	.	C	T	2	2	4	0	0	4	0	0
3	37727784	.	T	C	3	4	7	0	1	8	0	0
3	37737680	.	C	A	11	5	16	0	1	17	0	0
3	37737735	.	T	G	2	0	2	0	4	6	0	0
3	37737736	.	C	T	2	3	5	0	1	6	0	0
3	37737852	.	A	G	0	2	2	0	0	2	0	0
3	37738024	.	A	G	4	10	14	0	1	15	0	0
3	37738050	.	C	G	8	7	15	0	0	15	0	0
3	37738089	.	G	A	8	4	12	0	0	12	0	0
3	37742152	.	T	C	3	3	6	0	1	7	0	0
3	37742338	.	C	G	3	3	6	0	0	6	0	0
3	37742363	.	C	T	3	3	6	0	0	6	0	0
3	37776713	.	T	C	2	10	12	0	0	12	0	0
3	37777309	.	A	T	5	7	12	0	1	13	0	0
3	37777417	.	G	C	4	6	10	0	0	10	0	0
3	37777590	.	C	T	5	5	10	0	0	10	0	0
3	37777811	.	C	T	1	6	7	0	7	14	0	0
3	37781162	.	A	G	3	2	5	0	0	5	0	0
3	37788401	.	T	C	2	0	2	0	0	2	0	0
3	37789216	.	G	T	4	4	8	0	1	9	0	0
3	37803375	.	A	G	0	0	0	0	1	1	0	0
3	37824441	.	C	A	2	4	6	0	1	7	0	0
3	37827822	.	C	T	2	7	9	0	0	9	0	0
3	37827948	.	C	T	2	1	3	0	1	4	0	0
3	38505629	.	A	G	4	4	8	0	0	8	0	0
3	38614366	.	C	T	3	1	4	0	0	4	0	0
3	38614426	.	A	G	4	0	4	0	3	7	0	0
3	38614562	.	C	T	2	3	5	0	0	5	0	0
3	38624737	.	A	G	2	0	2	0	4	6	0	0
3	38624823	.	G	A	15	17	32	0	2	34	0	0
3	38625098	.	A	C	16	9	25	0	1	26	0	0
3	38625497	.	G	T	12	9	21	0	0	21	0	0
3	38625559	.	T	C	9	6	15	0	1	16	0	0
3	38625605	.	G	A	14	8	22	0	2	24	0	0
3	38625751	.	A	C	9	11	20	0	0	20	0	0
3	38625901	.	T	G	8	8	16	0	0	16	0	0
3	38649991	.	A	T	7	13	20	0	0	20	0	0
3	38650440	.	T	C	6	8	14	0	1	15	0	0
3	38650462	.	T	C	5	5	10	0	0	10	0	0
3	38650477	.	T	C	10	4	14	0	0	14	0	0
3	38763153	.	T	A	14	5	19	0	3	22	0	0
3	38763391	.	A	G	8	13	21	0	1	22	0	0
3	38763449	.	C	T	8	6	14	0	0	14	0	0
3	38763527	.	C	T	0	4	4	0	10	14	0	0
3	38763564	.	C	A	5	8	13	0	0	13	0	0
3	38763700	.	G	A	4	7	11	0	2	13	0	0
3	38764227	.	C	T	3	1	4	0	1	5	0	0
3	38764229	.	G	A	3	2	5	0	0	5	0	0
3	38764990	.	G	T	3	3	6	0	0	6	0	0
3	38765149	.	A	T	1	5	6	0	1	7	0	0
3	38765447	.	T	G	0	0	0	0	0	1	1	0
3	38765811	.	A	T	2	3	5	0	0	5	0	0
3	38766207	.	C	T	0	6	6	0	9	15	0	0
3	38766507	.	G	A	3	2	5	0	0	5	0	0
3	38766759	.	G	A	2	2	4	0	0	4	0	0
3	38766813	.	A	G	1	2	3	0	0	3	0	0
3	38793631	.	C	T	2	4	6	0	0	6	0	0
3	38793674	.	A	G	0	5	5	0	0	5	0	0
3	38793729	.	G	T	0	3	3	0	3	6	0	0
3	38794422	.	G	C	4	3	7	0	0	7	0	0
3	38858514	.	T	G	1	0	1	0	4	5	0	0
3	38858673	.	C	A	1	3	4	0	0	4	0	0
3	38858722	.	G	A	0	3	3	0	1	4	0	0
3	38858908	.	G	A	0	4	4	0	1	5	0	0
3	38858949	.	G	C	4	2	6	0	0	6	0	0
3	38859066	.	G	A	8	3	11	0	0	11	0	0
3	38859126	.	A	T	3	2	5	0	1	6	0	0
3	39181635	.	C	T	4	4	8	0	0	8	0	0
3	39184156	.	A	G	5	5	10	0	0	10	0	0
3	39184180	.	C	T	5	6	11	0	0	11	0	0
3	39184710	.	A	G	3	4	7	0	1	8	0	0
3	39186729	.	T	C	3	3	6	0	0	6	0	0
3	39238579	.	C	A	8	4	12	0	0	12	0	0
3	39238580	.	C	A	8	4	12	0	0	12	0	0
3	39239380	.	A	G	6	6	12	0	1	13	0	0
3	39241350	.	G	T	6	2	8	0	0	8	0	0
3	39248863	.	A	G	7	10	17	0	0	17	0	0
3	39251020	.	G	T	1	0	1	0	2	3	0	0
3	39251341	.	T	C	1	2	3	0	0	3	0	0
3	39259624	.	T	C	10	0	10	0	9	19	0	0
3	39261182	.	C	A	0	3	3	0	2	5	0	0
3	39261230	.	C	T	0	2	2	0	0	2	0	0
3	39261270	.	C	T	0	2	2	0	1	3	0	0
3	39263444	.	T	G	2	3	5	0	0	5	0	0
3	39313310	.	A	G	5	6	11	0	0	11	0	0
3	39313625	.	T	C	8	5	13	0	0	13	0	0
3	39314028	.	C	T	18	19	37	0	2	39	0	0
3	39314101	.	T	C	14	8	22	0	2	24	0	0
3	39314146	.	C	G	11	17	28	0	0	28	0	0
3	39314260	.	A	G	8	8	16	0	0	16	0	0
3	39314502	.	G	C	10	13	23	0	0	23	0	0
3	39314631	.	C	T	0	11	11	0	11	22	0	0
3	39314677	.	C	T	10	7	17	0	0	17	0	0
3	39315154	.	C	A	2	11	13	0	0	13	0	0
3	39315169	.	C	G	3	10	13	0	0	13	0	0
3	39315191	.	C	G	3	8	11	0	0	11	0	0
3	39315229	.	A	T	3	2	5	0	0	5	0	0
3	39315728	.	C	T	5	4	9	0	0	9	0	0
3	39315737	.	T	C	4	4	8	0	0	8	0	0
3	39315816	.	A	G	0	6	6	0	1	7	0	0
3	39315874	.	C	A	3	8	11	0	0	11	0	0
3	39315876	.	C	T	3	8	11	0	0	11	0	0
3	39315937	.	A	C	4	1	5	0	8	13	0	0
3	39316037	.	T	C	9	7	16	0	0	16	0	0
3	39316062	.	G	A	10	7	17	0	1	19	1	0
3	39316167	.	A	G	6	7	13	0	0	13	0	0
3	39316570	.	G	A	6	4	10	0	1	11	0	0
3	39316846	.	T	C	9	14	23	0	2	25	0	0
3	39316906	.	C	A	14	16	30	0	0	30	0	0
3	39316912	.	G	A	12	13	25	0	1	26	0	0
3	39316996	.	A	G	13	13	26	0	1	27	0	0
3	39317215	.	C	G	6	6	12	0	0	12	0	0
3	39317279	.	C	T	6	7	13	0	3	16	0	0
3	39317310	.	T	C	8	10	18	0	0	18	0	0
3	39317370	.	C	T	5	6	11	0	0	11	0	0
3	39322109	.	G	A	1	4	5	0	1	6	0	0
3	39328095	.	G	C	4	6	10	0	0	10	0	0
3	39330407	.	T	C	4	0	4	0	5	9	0	0
3	39348533	.	G	A	3	9	12	0	0	12	0	0
3	39348914	.	G	A	2	7	9	0	1	10	0	0
3	39454708	.	C	G	3	3	6	0	0	6	0	0
3	39560664	.	T	C	2	2	4	0	0	4	0	0
3	39563252	.	C	T	1	3	4	0	0	4	0	0
3	39568368	.	T	G	3	5	8	0	1	9	0	0
3	39568856	.	A	G	16	21	37	0	1	38	0	0
3	39574883	.	C	A	15	23	38	0	2	40	0	0
3	39574961	.	G	A	34	33	67	0	5	72	0	0
3	39576621	.	T	G	18	4	22	0	35	57	0	0
3	39576663	.	A	G	27	50	77	0	2	79	0	0
3	39576866	.	T	C	21	18	39	0	2	41	0	0
3	39579562	.	T	C	3	2	5	0	1	6	0	0
3	39579616	.	C	A	1	4	5	0	0	5	0	0
3	39579660	.	G	T	0	3	3	0	0	3	0	0
3	39580908	.	T	C	1	0	1	0	0	1	0	0
3	39592640	.	T	G	1	2	3	0	0	3	0	0
3	39592797	.	C	T	3	5	8	0	0	8	0	0
3	39592800	.	G	C	0	6	6	0	3	9	0	0
3	39606220	.	C	T	6	4	10	0	0	10	0	0
3	39612261	.	T	A	15	11	26	0	0	26	0	0
3	39612430	.	T	C	9	10	19	0	1	20	0	0
3	39612579	.	G	C	8	12	20	0	0	20	0	0
3	39612715	.	A	T	7	8	15	0	1	16	0	0
3	39613024	.	T	C	9	9	18	0	0	18	0	0
3	39631505	.	T	C	4	4	8	0	0	8	0	0
3	39683715	.	A	G	3	2	5	0	1	6	0	0
3	39685635	.	G	T	1	1	2	0	1	3	0	0
3	39686016	.	C	A	1	2	3	0	0	3	0	0
3	39686776	.	T	A	1	3	4	0	0	4	0	0
3	39686807	.	A	T	1	3	4	0	0	4	0	0
3	39687418	.	C	T	1	2	3	0	2	5	0	0
3	39688558	.	T	G	2	2	4	0	0	4	0	0
3	39688892	.	T	C	6	3	9	0	1	10	0	0
3	39688906	.	C	T	7	3	10	0	0	10	0	0
3	39689234	.	G	T	7	3	10	0	2	12	0	0
3	39689277	.	A	G	5	4	9	0	0	9	0	0
3	39691978	.	C	G	1	5	6	0	0	6	0	0
3	39692008	.	G	T	3	7	10	0	0	10	0	0
3	39692165	.	A	T	3	8	11	0	0	11	0	0
3	39692196	.	C	T	0	8	8	0	4	12	0	0
3	39692206	.	C	T	5	9	14	0	0	14	0	0
3	39692235	.	C	A	6	9	15	0	3	18	0	0
3	39692265	.	G	A	8	4	12	0	1	13	0	0
3	39692307	.	A	G	9	4	13	0	0	13	0	0
3	39878663	.	C	T	3	4	7	0	0	7	0	0
3	39884348	.	G	A	0	2	2	0	2	4	0	0
3	39909569	.	A	G	4	0	4	0	3	7	0	0
3	39919127	.	G	A	1	1	2	0	1	3	0	0
3	39923512	.	G	A	0	0	0	0	2	2	0	0
3	39925012	.	T	G	0	0	0	0	2	2	0	0
3	39940210	.	T	C	0	4	4	0	0	4	0	0
3	39945696	.	A	G	1	2	3	0	0	3	0	0
3	39949389	.	G	A	2	4	6	0	0	6	0	0
3	39949650	.	G	A	0	3	3	0	1	4	0	0
3	39950276	.	A	C	11	17	28	0	1	29	0	0
3	39950340	.	C	T	18	4	22	0	3	25	0	0
3	39950414	.	T	C	12	7	19	0	0	19	0	0
3	39950954	.	T	C	12	7	19	0	0	19	0	0
3	39951124	.	C	T	8	7	15	0	0	15	0	0
3	39951216	.	T	C	3	6	9	0	1	10	0	0
3	39951703	.	A	T	9	7	16	0	1	17	0	0
3	39952025	.	T	C	7	7	14	0	0	14	0	0
3	39952272	.	A	G	14	9	23	0	0	23	0	0
3	39952273	.	A	T	14	9	23	0	0	23	0	0
3	39958680	.	C	T	3	5	8	0	0	8	0	0
3	39958729	.	T	A	5	8	13	0	0	13	0	0
3	39959679	.	A	C	13	7	20	0	0	20	0	0
3	39960535	.	G	C	0	1	1	0	0	1	0	0
3	39962981	.	T	C	7	7	14	0	1	15	0	0
3	39963053	.	T	C	6	9	15	0	0	15	0	0
3	39963089	.	A	G	2	8	10	0	0	10	0	0
3	39963128	.	G	A	1	2	3	0	0	3	0	0
3	39963131	.	A	G	1	2	3	0	0	3	0	0
3	39970555	.	G	A	6	8	14	0	0	14	0	0
3	39970641	.	T	G	5	14	19	0	2	21	0	0
3	39971335	.	T	A	4	6	10	0	0	11	1	0
3	39971365	.	T	C	6	2	8	0	0	8	0	0
3	39971470	.	T	C	4	6	10	0	0	10	0	0
3	39971499	.	T	C	5	4	9	0	0	9	0	0
3	39971592	.	T	C	6	4	10	0	0	10	0	0
3	39971615	.	T	C	8	4	12	0	0	12	0	0
3	39971894	.	T	C	4	8	12	0	0	12	0	0
3	39972055	.	T	C	5	2	7	0	2	9	0	0
3	39972073	.	G	A	4	5	9	0	0	9	0	0
3	39972130	.	T	C	4	1	5	0	4	9	0	0
3	39975467	.	T	C	4	0	4	0	12	16	0	0
3	39982019	.	C	T	3	8	11	0	1	12	0	0
3	39982198	.	A	T	0	3	3	0	0	3	0	0
3	39982423	.	T	C	0	0	0	0	2	2	0	0
3	39984551	.	C	T	0	1	1	0	0	1	0	0
3	39987992	.	T	C	0	0	0	0	2	2	0	0
3	39990108	.	G	A	5	2	7	0	0	7	0	0
3	40003947	.	T	G	3	3	6	0	0	6	0	0
3	40015244	.	T	G	3	2	5	0	0	5	0	0
3	40054647	.	C	T	0	7	7	0	2	9	0	0
3	40207086	.	T	C	14	19	33	0	4	37	0	0
3	40256199	.	A	T	5	5	10	0	0	10	0	0
3	40256334	.	T	C	2	4	6	0	0	6	0	0
3	40256418	.	C	T	5	7	12	0	0	12	0	0
3	40257357	.	A	G	4	0	4	0	4	8	0	0
3	40258465	.	T	C	2	0	2	0	0	2	0	0
3	40278023	.	C	T	0	16	16	0	13	29	0	0
3	40278180	.	T	C	7	0	7	0	4	11	0	0
3	40280034	.	T	C	2	2	4	0	0	4	0	0
3	40284375	.	T	C	13	0	13	0	8	21	0	0
3	40284447	.	T	A	13	10	23	0	1	24	0	0
3	40284860	.	G	T	16	9	25	0	0	25	0	0
3	40284982	.	T	C	7	6	13	0	0	13	0	0
3	40287185	.	G	C	1	8	9	0	12	21	0	0
3	40287188	.	G	A	13	8	21	0	0	21	0	0
3	40287227	.	C	T	4	2	6	0	0	6	0	0
3	40287538	.	C	T	2	3	5	0	0	5	0	0
3	40287691	.	T	C	3	3	6	0	0	6	0	0
3	40287712	.	T	A	2	5	7	0	0	7	0	0
3	40290123	.	T	C	5	3	8	0	0	8	0	0
3	40290138	.	A	G	6	4	10	0	0	10	0	0
3	40294179	.	G	A	2	1	3	0	0	3	0	0
3	40294260	.	A	T	8	14	22	0	0	22	0	0
3	40294511	.	G	C	5	9	14	0	1	15	0	0
3	40296839	.	C	T	4	3	7	0	0	7	0	0
3	40297428	.	G	A	18	20	38	0	1	39	0	0
3	40297479	.	C	T	5	7	12	0	0	12	0	0
3	40299995	.	G	A	5	8	13	0	0	13	0	0
3	40301233	.	A	G	2	2	4	0	0	4	0	0
3	40315555	.	G	T	8	3	11	0	0	11	0	0
3	40318555	.	C	G	2	1	3	0	1	4	0	0
3	40318556	.	C	G	2	2	4	0	0	4	0	0
3	40318613	.	A	G	5	6	11	0	0	11	0	0
3	40318733	.	T	A	2	3	5	0	1	6	0	0
3	40329683	.	T	C	4	1	5	0	0	5	0	0
3	40333577	.	A	G	2	0	2	0	3	5	0	0
3	40333592	.	C	T	4	5	9	0	0	9	0	0
3	40333700	.	A	G	6	0	6	0	5	11	0	0
3	40333793	.	T	C	1	0	1	0	1	2	0	0
3	40346035	.	C	T	9	10	19	0	2	21	0	0
3	40346059	.	T	C	6	7	13	0	0	13	0	0
3	40348839	.	T	C	14	14	28	0	1	29	0	0
3	40349310	.	A	G	12	5	17	0	1	18	0	0
3	40349354	.	T	G	9	6	15	0	0	15	0	0
3	40404688	.	A	T	6	3	9	0	0	9	0	0
3	40430922	.	G	A	0	3	3	0	7	10	0	0
3	40443096	.	C	G	4	4	8	0	2	10	0	0
3	40444020	.	C	T	3	4	7	0	0	7	0	0
3	40444539	.	T	C	2	7	9	0	0	9	0	0
3	40448097	.	A	C	7	3	10	0	0	10	0	0
3	40448130	.	A	G	6	0	6	0	5	11	0	0
3	40448220	.	T	C	0	3	3	0	0	3	0	0
3	40449595	.	C	A	8	2	10	0	0	10	0	0
3	40449603	.	T	C	10	3	13	0	0	13	0	0
3	40449696	.	C	T	13	6	19	0	1	20	0	0
3	40450743	.	C	T	7	13	20	0	1	21	0	0
3	40450961	.	T	G	11	0	11	0	13	24	0	0
3	40451268	.	C	T	15	5	20	0	0	20	0	0
3	40451319	.	T	C	10	3	13	0	0	13	0	0
3	40451574	.	A	C	3	3	6	0	0	6	0	0
3	40452119	.	G	C	7	5	12	0	0	12	0	0
3	40452134	.	A	G	8	0	8	0	6	14	0	0
3	40458594	.	G	A	0	9	9	0	11	20	0	0
3	40467486	.	G	A	0	1	1	0	1	2	0	0
3	40467693	.	A	G	11	0	11	0	6	17	0	0
3	40467756	.	C	T	19	6	25	0	1	26	0	0
3	40469891	.	T	C	7	8	15	0	0	15	0	0
3	40480877	.	G	A	0	2	2	0	0	2	0	0
3	40480986	.	G	T	13	9	22	0	0	22	0	0
3	40481346	.	G	A	0	1	1	0	6	7	0	0
3	40481459	.	C	T	17	19	36	0	0	36	0	0
3	40481513	.	A	G	12	9	21	0	0	21	0	0
3	40481649	.	T	G	11	6	17	0	0	17	0	0
3	40481930	.	T	A	12	13	25	0	0	25	0	0
3	40482007	.	T	C	9	14	23	0	0	23	0	0
3	40482027	.	A	G	14	1	15	0	9	24	0	0
3	40482289	.	C	A	23	15	38	1	2	41	0	0
3	40482446	.	A	G	11	15	26	0	4	30	0	0
3	40484376	.	A	T	13	4	17	0	0	17	0	0
3	40485360	.	C	A	10	10	20	0	2	22	0	0
3	40485378	.	T	G	13	11	24	0	0	24	0	0
3	40485422	.	G	T	0	17	17	0	11	28	0	0
3	40485499	.	G	A	14	15	29	0	2	31	0	0
3	40485965	.	G	C	16	7	23	0	0	23	0	0
3	40487095	.	G	T	8	14	22	0	0	22	0	0
3	40487162	.	A	C	9	7	16	0	0	16	0	0
3	40487385	.	T	A	14	13	27	0	0	27	0	0
3	40487704	.	T	C	17	11	28	0	1	29	0	0
3	40487820	.	A	G	16	16	32	0	4	36	0	0
3	40487821	.	G	C	16	19	35	0	1	36	0	0
3	40488212	.	C	T	19	13	32	0	3	35	0	0
3	40488264	.	C	T	7	15	22	0	10	32	0	0
3	40488630	.	T	C	3	11	14	0	0	15	1	0
3	40488640	.	T	C	3	6	9	0	2	11	0	0
3	40527028	.	G	A	24	21	45	0	0	45	0	0
3	40527512	.	G	A	32	38	70	0	2	72	0	0
3	40527575	.	G	A	9	12	21	0	2	23	0	0
3	40527665	.	A	G	8	5	13	0	0	13	0	0
3	40527727	.	G	A	8	4	12	0	1	13	0	0
3	40528241	.	A	T	20	19	39	0	2	41	0	0
3	40576600	.	C	T	17	27	44	0	2	46	0	0
3	40576736	.	C	T	15	22	37	0	1	38	0	0
3	40576972	.	A	G	17	3	20	0	23	43	0	0
3	40577032	.	C	T	16	20	36	0	1	37	0	0
3	40583989	.	C	G	8	6	14	0	0	14	0	0
3	40584318	.	T	A	12	18	30	0	3	34	1	0
3	40587967	.	C	T	24	28	52	0	5	57	0	0
3	40588109	.	A	T	30	26	56	0	0	56	0	0
3	40588195	.	T	C	25	24	49	0	0	49	0	0
3	40588363	.	C	T	25	19	44	0	0	44	0	0
3	40588410	.	C	A	19	25	44	0	3	47	0	0
3	40588467	.	T	C	15	18	33	0	4	37	0	0
3	40588595	.	A	C	20	18	38	0	0	38	0	0
3	40588746	.	C	G	20	17	37	0	0	37	0	0
3	40588845	.	A	G	19	18	37	0	1	38	0	0
3	40589147	.	T	C	34	21	55	0	2	57	0	0
3	40589179	.	C	A	29	24	53	0	3	56	0	0
3	40589191	.	T	G	32	22	54	0	1	55	0	0
3	40589214	.	C	A	31	18	49	0	3	52	0	0
3	40589232	.	A	G	33	17	50	0	0	50	0	0
3	40589266	.	C	T	24	18	42	0	4	46	0	0
3	40589348	.	A	G	18	18	36	0	0	36	0	0
3	40589356	.	A	G	19	15	34	0	0	34	0	0
3	40656338	.	A	G	0	3	3	0	0	3	0	0
3	40656368	.	T	C	1	3	4	0	0	4	0	0
3	40690704	.	T	C	8	0	8	0	8	16	0	0
3	40690901	.	G	A	0	5	5	0	2	7	0	0
3	40690937	.	T	A	6	3	9	0	0	9	0	0
3	40691448	.	A	G	6	4	10	0	1	11	0	0
3	40691473	.	A	T	7	4	11	0	0	11	0	0
3	40691792	.	T	C	5	0	5	0	3	8	0	0
3	40691969	.	C	T	9	10	19	0	0	19	0	0
3	40692064	.	A	T	8	4	12	0	1	13	0	0
3	40698424	.	C	A	6	1	7	0	0	7	0	0
3	40712935	.	G	A	1	0	1	0	0	1	0	0
3	40713085	.	G	T	9	7	16	0	1	17	0	0
3	40768371	.	A	T	2	5	7	0	1	8	0	0
3	40804286	.	T	G	30	4	34	0	0	34	0	0
3	40814587	.	G	A	1	2	3	0	0	3	0	0
3	40819959	.	A	C	1	0	1	0	0	1	0	0
3	40820007	.	A	G	0	1	1	0	0	1	0	0
3	40821838	.	C	A	7	16	23	0	3	26	0	0
3	40821871	.	A	T	15	18	33	0	1	34	0	0
3	40821953	.	C	A	1	20	21	0	12	33	0	0
3	40828768	.	T	C	0	0	0	0	1	1	0	0
3	40870851	.	A	T	1	2	3	0	0	3	0	0
3	40876757	.	G	A	5	6	11	0	3	14	0	0
3	40881515	.	C	T	0	1	1	0	0	1	0	0
3	40888123	.	A	G	3	0	3	0	0	3	0	0
3	40894989	.	A	C	1	2	3	0	0	3	0	0
3	40902163	.	C	T	0	6	6	0	9	15	0	0
3	40907953	.	T	C	2	0	2	0	6	8	0	0
3	40913730	.	G	A	2	2	4	0	1	5	0	0
3	40927653	.	C	T	6	7	13	0	0	13	0	0
3	40933304	.	A	T	1	2	3	0	0	3	0	0
3	40969547	.	C	T	0	2	2	0	2	4	0	0
3	40970157	.	A	G	0	1	1	0	0	1	0	0
3	40973247	.	C	A	0	1	1	0	2	3	0	0
3	40973539	.	C	T	1	1	2	0	0	2	0	0
3	40974812	.	T	C	0	0	0	0	1	1	0	0
3	40979281	.	T	C	5	2	7	0	0	7	0	0
3	40979791	.	G	C	10	4	14	0	0	14	0	0
3	40980024	.	G	A	10	9	19	0	0	19	0	0
3	40980166	.	T	A	12	4	16	0	2	18	0	0
3	40983062	.	A	G	2	10	12	0	0	12	0	0
3	40983077	.	G	A	1	9	10	0	0	10	0	0
3	41000159	.	T	C	2	0	2	0	7	9	0	0
3	41003413	.	G	A	2	1	3	0	0	3	0	0
3	41084442	.	G	C	2	0	2	0	1	3	0	0
3	41086781	.	T	C	5	2	7	0	0	7	0	0
3	41088983	.	G	A	0	1	1	0	0	1	0	0
3	41092046	.	G	C	2	3	5	0	0	5	0	0
3	41092137	.	A	T	3	2	5	0	2	7	0	0
3	41092392	.	T	A	2	0	2	0	0	2	0	0
3	41162888	.	T	G	2	2	4	0	0	4	0	0
3	41511148	.	G	C	2	2	4	0	0	4	0	0
3	41705560	.	A	G	3	2	5	0	0	5	0	0
3	41705626	.	G	T	0	2	2	0	0	2	0	0
3	41719049	.	G	A	4	3	7	0	0	7	0	0
3	41721916	.	G	A	6	1	7	0	0	7	0	0
3	41723437	.	G	A	7	9	16	0	0	16	0	0
3	41724806	.	G	A	11	18	29	0	1	30	0	0
3	41922757	.	T	C	2	0	2	0	0	2	0	0
3	41922766	.	A	G	3	0	3	0	1	4	0	0
3	41922799	.	C	T	4	2	6	0	0	6	0	0
3	41923195	.	T	C	1	4	5	0	0	5	0	0
3	41923288	.	C	T	1	2	3	0	0	3	0	0
3	41925154	.	C	T	4	2	6	0	0	6	0	0
3	41925508	.	A	G	4	2	6	0	1	7	0	0
3	41925541	.	C	G	4	3	7	0	0	7	0	0
3	41925823	.	C	T	3	4	7	0	0	7	0	0
3	41925889	.	T	C	2	5	7	0	0	7	0	0
3	41926557	.	G	A	4	3	7	0	0	7	0	0
3	41926633	.	T	A	2	2	4	0	1	5	0	0
3	41926695	.	T	C	2	2	4	0	1	5	0	0
3	41955449	.	A	G	1	5	6	0	1	7	0	0
3	41955613	.	G	T	16	17	33	0	0	33	0	0
3	41955911	.	C	G	13	18	31	0	0	31	0	0
3	41956040	.	G	T	11	13	24	0	1	25	0	0
3	41956299	.	T	C	11	9	20	0	2	22	0	0
3	41956353	.	T	A	8	7	15	0	0	15	0	0
3	41956467	.	T	A	2	6	8	0	0	8	0	0
3	41956504	.	C	T	1	6	7	0	0	7	0	0
3	41956792	.	A	T	7	12	19	0	1	20	0	0
3	41956818	.	T	C	6	13	19	0	0	19	0	0
3	41956837	.	T	G	5	14	19	0	0	19	0	0
3	41956855	.	C	T	6	16	22	0	0	22	0	0
3	41956921	.	T	A	2	9	11	0	0	11	0	0
3	41956941	.	T	C	3	7	10	0	1	11	0	0
3	41956978	.	G	A	9	9	18	0	1	19	0	0
3	41957457	.	T	A	5	2	7	0	1	8	0	0
3	41957580	.	G	T	9	3	12	0	2	14	0	0
3	41957839	.	A	T	1	3	4	0	1	5	0	0
3	41957993	.	G	A	2	2	4	0	0	4	0	0
3	41958004	.	G	T	1	2	3	0	0	3	0	0
3	41958291	.	T	G	3	8	11	0	0	11	0	0
3	41959370	.	G	T	9	11	20	0	2	22	0	0
3	41959658	.	G	T	5	9	14	0	1	15	0	0
3	41959772	.	A	G	5	7	12	0	0	12	0	0
3	41959906	.	T	A	2	6	8	0	0	8	0	0
3	41959943	.	T	C	2	8	10	0	1	11	0	0
3	41959958	.	A	G	4	7	11	0	0	11	0	0
3	41960005	.	C	A	7	4	11	0	1	12	0	0
3	41960069	.	G	T	6	6	12	0	0	12	0	0
3	41960346	.	A	G	2	6	8	0	0	8	0	0
3	41960652	.	G	A	2	4	6	0	0	6	0	0
3	41960654	.	T	A	2	4	6	0	0	6	0	0
3	41960700	.	C	T	1	4	5	0	0	5	0	0
3	41960873	.	A	C	1	1	2	0	0	3	1	0
3	41961314	.	G	A	3	5	8	0	0	8	0	0
3	41961341	.	T	G	7	4	11	0	1	13	1	0
3	41961469	.	A	G	1	10	11	0	1	12	0	0
3	41961558	.	A	T	5	3	8	0	1	9	0	0
3	41961587	.	T	G	4	8	12	0	0	12	0	0
3	41961651	.	G	A	6	5	11	0	0	11	0	0
3	41961688	.	T	C	8	0	8	0	10	18	0	0
3	41961993	.	C	G	0	5	5	0	1	6	0	0
3	41962098	.	T	C	0	10	10	0	0	10	0	0
3	41985866	.	G	A	0	1	1	0	1	2	0	0
3	41985953	.	C	T	1	2	3	0	2	5	0	0
3	41985959	.	G	A	2	3	5	0	0	5	0	0
3	42016675	.	A	T	1	0	1	0	0	1	0	0
3	42016682	.	C	G	0	0	0	0	1	1	0	0
3	42122108	.	A	G	1	1	2	0	0	2	0	0
3	42125518	.	A	G	0	1	1	0	0	1	0	0
3	42126551	.	A	G	0	4	4	0	0	4	0	0
3	42126594	.	A	T	0	4	4	0	0	4	0	0
3	42918924	.	C	A	5	14	19	0	0	19	0	0
3	42919474	.	C	T	11	8	19	0	0	19	0	0
3	42919510	.	C	T	8	4	12	0	1	13	0	0
3	42919664	.	C	T	4	4	8	0	0	8	0	0
3	42919846	.	T	G	2	6	8	0	0	8	0	0
3	42919849	.	C	T	1	6	7	0	1	8	0	0
3	42919881	.	C	T	1	2	3	0	2	5	0	0
3	42919895	.	A	G	2	2	4	0	0	4	0	0
3	42919943	.	G	C	1	1	2	0	0	2	0	0
3	42919959	.	A	T	1	1	2	0	0	2	0	0
3	42956778	.	C	A	0	2	2	0	1	3	0	0
3	43000474	.	A	G	3	3	6	0	0	6	0	0
3	43000489	.	G	A	0	2	2	0	3	5	0	0
3	43000552	.	T	A	2	3	5	0	0	5	0	0
3	43014152	.	A	G	0	2	2	0	0	2	0	0
3	43014396	.	T	C	2	1	3	0	0	3	0	0
3	43017888	.	A	C	1	0	1	0	0	1	0	0
3	43017912	.	T	C	2	0	2	0	0	2	0	0
3	43018005	.	C	T	1	3	4	0	0	4	0	0
3	43029889	.	T	C	2	3	5	0	0	5	0	0
3	43038222	.	G	A	3	6	9	0	0	9	0	0
3	43039306	.	A	G	4	5	9	0	0	9	0	0
3	43040677	.	G	A	0	9	9	0	3	12	0	0
3	43040779	.	C	T	6	2	8	0	0	8	0	0
3	43052230	.	T	C	5	11	16	0	1	17	0	0
3	43059090	.	A	G	0	1	1	0	0	1	0	0
3	43059153	.	A	G	2	10	12	0	0	12	0	0
3	43060866	.	T	C	3	2	5	0	0	5	0	0
3	43376543	.	A	G	2	0	2	0	0	2	0	0
3	43380283	.	C	T	5	5	10	0	1	11	0	0
3	43392755	.	T	A	5	4	9	0	0	9	0	0
3	43392795	.	C	A	7	6	13	0	0	13	0	0
3	43396163	.	G	A	0	2	2	0	0	2	0	0
3	43467654	.	T	C	3	9	12	0	1	13	0	0
3	43474920	.	A	T	5	7	12	0	0	12	0	0
3	43475184	.	C	T	5	2	7	0	0	7	0	0
3	43475265	.	G	A	9	10	19	0	0	19	0	0
3	43475325	.	A	G	5	10	15	0	1	17	1	0
3	43475376	.	T	C	3	11	14	0	1	15	0	0
3	43475397	.	C	T	1	7	8	0	0	8	0	0
3	43475592	.	A	C	8	5	13	0	0	13	0	0
3	43475617	.	G	T	0	5	5	0	6	11	0	0
3	43475654	.	C	T	6	7	13	0	0	13	0	0
3	43475742	.	G	T	3	3	6	0	0	6	0	0
3	43475772	.	A	G	5	3	8	0	1	9	0	0
3	43476435	.	G	T	8	3	11	0	0	11	0	0
3	43476508	.	T	A	10	0	10	0	0	10	0	0
3	43476514	.	A	C	3	7	10	0	0	10	0	0
3	43476698	.	A	G	6	2	8	0	0	8	0	0
3	43476880	.	C	T	9	8	17	0	0	17	0	0
3	43476887	.	T	G	10	7	17	0	0	17	0	0
3	43477705	.	T	A	3	3	6	0	1	7	0	0
3	43478137	.	T	C	9	6	15	0	0	15	0	0
3	43478238	.	C	T	7	6	13	0	0	13	0	0
3	43478310	.	T	G	17	4	21	0	1	22	0	0
3	43478321	.	A	G	13	0	13	0	5	18	0	0
3	43478433	.	A	T	6	3	9	0	0	9	0	0
3	43478586	.	C	T	4	3	7	0	0	7	0	0
3	43579820	.	C	T	0	15	15	0	6	21	0	0
3	43580055	.	A	G	14	9	23	0	1	24	0	0
3	43580195	.	A	T	11	10	21	0	1	22	0	0
3	43580583	.	T	C	8	8	16	0	0	16	0	0
3	43581272	.	A	C	9	12	21	0	0	21	0	0
3	43584423	.	T	C	9	0	9	0	17	26	0	0
3	43584453	.	T	C	7	12	19	0	0	19	0	0
3	43594256	.	A	G	4	0	4	0	0	4	0	0
3	43594358	.	C	T	9	7	16	0	1	17	0	0
3	43594376	.	C	T	2	6	8	0	9	17	0	0
3	43594577	.	G	A	8	4	12	0	0	12	0	0
3	43594655	.	C	T	0	5	5	0	9	14	0	0
3	43594658	.	G	A	8	6	14	0	0	14	0	0
3	43594735	.	T	C	4	11	15	0	0	15	0	0
3	43600999	.	C	T	0	8	8	0	4	12	0	0
3	43645900	.	G	C	9	7	16	0	0	16	0	0
3	43646161	.	A	G	5	8	13	0	0	13	0	0
3	43646362	.	C	T	0	5	5	0	7	12	0	0
3	43711455	.	A	T	1	0	1	0	0	1	0	0
3	43754851	.	G	C	2	1	3	0	0	3	0	0
3	43754860	.	T	A	1	2	3	0	0	3	0	0
3	43774440	.	C	A	1	3	4	0	0	4	0	0
3	43776859	.	T	C	0	1	1	0	0	1	0	0
3	43785646	.	A	T	1	0	1	0	0	1	0	0
3	43791284	.	T	C	8	6	14	0	0	14	0	0
3	43791317	.	G	A	5	4	9	0	0	9	0	0
3	43793147	.	T	C	0	1	1	0	0	1	0	0
3	43793273	.	G	A	0	2	2	0	1	3	0	0
3	43796956	.	T	G	0	0	0	0	1	1	0	0
3	43797073	.	C	T	2	0	2	0	0	2	0	0
3	43801338	.	C	T	3	4	7	0	1	8	0	0
3	43807512	.	T	C	7	6	13	0	0	13	0	0
3	43807921	.	C	A	6	8	14	0	0	14	0	0
3	43807945	.	T	A	7	4	11	0	0	12	1	0
3	43814607	.	C	T	7	8	15	0	0	15	0	0
3	43821273	.	G	T	14	7	21	0	0	21	0	0
3	43821328	.	A	G	11	3	14	0	1	15	0	0
3	43825892	.	T	A	2	2	4	0	0	4	0	0
3	43828902	.	G	A	2	3	5	0	0	5	0	0
3	43828906	.	T	C	2	3	5	0	0	5	0	0
3	43829179	.	G	C	3	2	5	0	0	5	0	0
3	43829370	.	A	C	3	3	6	0	0	6	0	0
3	43829411	.	C	T	1	2	3	0	0	3	0	0
3	43829413	.	C	T	1	2	3	0	0	3	0	0
3	43829712	.	G	A	0	6	6	0	3	9	0	0
3	43942053	.	A	C	3	4	7	0	0	7	0	0
3	43944611	.	A	G	0	3	3	0	0	3	0	0
3	43953805	.	C	T	3	4	7	0	0	7	0	0
3	43953883	.	T	C	9	0	9	0	8	17	0	0
3	44077429	.	A	C	1	3	4	0	0	4	0	0
3	44077543	.	G	T	6	3	9	0	0	9	0	0
3	44082239	.	T	G	1	1	2	0	0	2	0	0
3	44089225	.	T	G	0	1	1	0	0	1	0	0
3	44541766	.	C	T	0	5	5	0	2	7	0	0
3	44541955	.	C	A	0	1	1	0	0	1	0	0
3	45714678	.	C	T	3	2	5	0	0	5	0	0
3	45715511	.	T	A	3	2	5	0	0	5	0	0
3	45715655	.	A	G	3	3	6	0	0	6	0	0
3	45715716	.	C	T	5	3	8	0	0	8	0	0
3	45715776	.	T	C	1	4	5	0	1	6	0	0
3	45716082	.	T	C	5	2	7	0	0	7	0	0
3	45716098	.	C	T	4	2	6	0	0	6	0	0
3	45716766	.	A	G	3	1	4	0	3	7	0	0
3	45717180	.	C	T	7	8	15	0	3	18	0	0
3	45776520	.	T	C	22	0	22	0	19	41	0	0
3	45776721	.	T	C	7	18	25	0	0	25	0	0
3	45790559	.	T	C	1	1	2	0	0	2	0	0
3	45805605	.	C	G	0	2	2	0	0	2	0	0
3	45814631	.	A	T	5	4	9	0	0	9	0	0
3	45815894	.	A	C	5	5	10	0	0	10	0	0
3	45815997	.	G	A	1	4	5	0	6	11	0	0
3	45816004	.	C	T	6	3	9	0	0	9	0	0
3	45816549	.	A	G	6	2	8	0	0	8	0	0
3	45816618	.	T	C	7	6	13	0	0	13	0	0
3	46043483	.	G	A	1	6	7	0	0	7	0	0
3	46043528	.	T	A	2	3	5	0	0	5	0	0
3	46044190	.	G	T	3	2	5	0	0	5	0	0
3	46114398	.	A	G	0	1	1	0	0	1	0	0
3	46114491	.	C	A	2	2	4	0	0	4	0	0
3	46114925	.	C	G	1	6	7	0	0	7	0	0
3	46338286	.	A	G	0	3	3	0	0	3	0	0
3	46338289	.	G	A	0	0	0	0	3	3	0	0
3	46353405	.	C	A	0	2	2	0	0	2	0	0
3	46353747	.	C	A	1	4	5	0	0	5	0	0
3	46353917	.	C	T	1	2	3	0	0	3	0	0
3	46354031	.	C	T	2	0	2	0	0	2	0	0
3	46358537	.	A	G	0	0	0	0	1	1	0	0
3	46361536	.	C	A	1	5	6	0	0	6	0	0
3	46362640	.	C	T	0	3	3	0	0	3	0	0
3	46362753	.	C	A	3	4	7	0	1	8	0	0
3	46362895	.	T	C	1	2	3	0	0	3	0	0
3	46363666	.	A	G	2	0	2	0	2	4	0	0
3	46364542	.	G	A	3	4	7	0	1	8	0	0
3	46364583	.	T	C	2	4	6	0	0	6	0	0
3	46364654	.	G	A	0	3	3	0	1	4	0	0
3	46365432	.	T	C	3	5	8	0	2	10	0	0
3	46379820	.	A	G	6	3	9	0	0	9	0	0
3	46379849	.	C	G	3	3	6	0	0	6	0	0
3	46380144	.	A	C	3	3	6	0	0	6	0	0
3	46380189	.	A	G	10	8	18	0	1	19	0	0
3	46380194	.	T	A	9	7	16	0	3	19	0	0
3	46388058	.	C	T	9	13	22	0	3	25	0	0
3	46388285	.	G	A	15	8	23	0	0	23	0	0
3	46388439	.	A	T	13	5	18	0	0	18	0	0
3	46388487	.	A	C	11	3	14	0	0	14	0	0
3	46388490	.	T	A	10	3	13	0	0	13	0	0
3	46388636	.	T	C	6	6	12	0	0	12	0	0
3	46388711	.	C	T	7	3	10	0	0	10	0	0
3	46388714	.	G	A	3	7	10	0	0	10	0	0
3	46388854	.	T	C	12	7	19	0	0	19	0	0
3	46388905	.	G	A	9	9	18	0	0	18	0	0
3	46388954	.	A	C	12	12	24	0	0	24	0	0
3	46388968	.	G	C	11	10	21	0	1	22	0	0
3	46389009	.	C	T	12	12	24	0	2	26	0	0
3	46391844	.	C	T	0	9	9	0	7	16	0	0
3	46398380	.	G	A	9	5	14	0	1	15	0	0
3	46403743	.	C	T	0	5	5	0	6	11	0	0
3	46410288	.	T	C	1	2	3	0	0	3	0	0
3	46463113	.	T	C	2	5	7	0	0	7	0	0
3	46463156	.	C	T	1	6	7	0	0	7	0	0
3	46463213	.	A	C	2	3	5	0	0	5	0	0
3	46473247	.	G	C	0	2	2	0	2	4	0	0
3	46473292	.	G	A	2	5	7	0	0	7	0	0
3	46494019	.	C	A	0	2	2	0	0	2	0	0
3	46528871	.	T	C	0	1	1	0	0	1	0	0
3	46550242	.	T	C	1	2	3	0	0	3	0	0
3	46551189	.	G	A	5	2	7	0	1	8	0	0
3	46551285	.	T	A	4	4	8	0	0	8	0	0
3	46552775	.	G	A	5	2	7	0	0	7	0	0
3	46552832	.	A	C	3	6	9	0	0	9	0	0
3	46552993	.	A	G	4	4	8	0	1	9	0	0
3	46553206	.	T	G	3	8	11	0	1	12	0	0
3	46553292	.	G	C	0	3	3	0	0	3	0	0
3	46553299	.	A	T	0	3	3	0	0	3	0	0
3	46553360	.	A	C	0	2	2	0	0	2	0	0
3	46553470	.	A	G	1	0	1	0	5	6	0	0
3	46553480	.	C	A	3	2	5	0	2	7	0	0
3	46553534	.	C	T	3	3	6	0	2	8	0	0
3	46553540	.	C	A	3	2	5	0	3	8	0	0
3	46553677	.	T	C	5	1	6	0	0	6	0	0
3	46553678	.	A	T	4	1	5	0	1	6	0	0
3	46553720	.	C	A	9	3	12	0	1	13	0	0
3	46553850	.	A	C	8	7	15	0	0	15	0	0
3	46553893	.	T	C	10	8	18	0	0	18	0	0
3	46553986	.	A	T	6	10	16	0	1	17	0	0
3	46554177	.	C	A	9	3	12	0	1	13	0	0
3	46554181	.	C	A	3	10	13	0	0	13	0	0
3	46554259	.	G	A	4	2	6	0	0	6	0	0
3	46554360	.	C	G	4	2	6	0	1	7	0	0
3	46554458	.	G	T	1	4	5	0	1	6	0	0
3	46554564	.	A	G	11	5	16	0	0	16	0	0
3	46554648	.	T	A	6	3	9	0	0	9	0	0
3	46554711	.	G	A	9	10	19	0	2	21	0	0
3	46749479	.	A	G	0	1	1	0	0	1	0	0
3	46750272	.	C	T	5	5	10	0	0	10	0	0
3	46750752	.	G	A	10	6	16	0	1	17	0	0
3	46750996	.	C	T	7	8	15	0	2	17	0	0
3	46751630	.	G	A	5	6	11	0	1	12	0	0
3	46752486	.	A	C	8	8	16	0	0	16	0	0
3	46752522	.	T	G	5	4	9	0	1	10	0	0
3	46753340	.	T	G	7	0	7	0	0	8	1	0
3	46753613	.	T	C	10	7	17	0	1	18	0	0
3	46753619	.	G	A	9	6	15	0	1	16	0	0
3	46753742	.	A	G	9	0	9	0	11	20	0	0
3	46754078	.	T	A	21	17	38	0	3	41	0	0
3	46754296	.	A	T	5	8	13	0	1	14	0	0
3	46764485	.	A	T	0	2	2	0	0	2	0	0
3	46764572	.	A	T	3	4	7	0	0	7	0	0
3	46767646	.	T	C	1	1	2	0	0	2	0	0
3	46778789	.	G	T	5	6	11	0	0	11	0	0
3	46800490	.	A	T	37	25	62	0	3	65	0	0
3	46800692	.	G	A	25	36	61	0	4	65	0	0
3	46800940	.	C	T	28	25	53	0	0	53	0	0
3	46800946	.	T	G	26	24	50	0	1	51	0	0
3	46802227	.	T	C	24	2	26	0	18	44	0	0
3	46919523	.	C	T	4	6	10	0	0	10	0	0
3	46923471	.	T	C	2	3	5	0	1	6	0	0
3	46923509	.	G	A	2	4	6	0	1	7	0	0
3	46925154	.	G	A	1	1	2	0	0	2	0	0
3	46925227	.	A	G	3	5	8	0	0	8	0	0
3	46927089	.	A	G	0	1	1	0	0	1	0	0
3	46927137	.	G	A	1	2	3	0	0	3	0	0
3	46928680	.	G	C	1	1	2	0	0	2	0	0
3	46928716	.	A	G	2	2	4	0	0	4	0	0
3	46928778	.	G	A	2	1	3	0	0	3	0	0
3	46932545	.	A	G	4	3	7	0	0	7	0	0
3	46942272	.	A	G	3	4	7	0	0	7	0	0
3	47114558	.	G	A	2	3	5	0	1	6	0	0
3	47114573	.	A	G	3	1	4	0	1	5	0	0
3	47114734	.	A	G	1	0	1	0	0	1	0	0
3	47114746	.	G	A	1	0	1	0	0	1	0	0
3	47119900	.	G	A	3	3	6	0	0	6	0	0
3	47125636	.	T	A	0	2	2	0	0	2	0	0
3	47125693	.	G	A	4	2	6	0	1	7	0	0
3	47167574	.	C	A	2	3	5	0	0	5	0	0
3	47170313	.	T	C	1	3	4	0	0	4	0	0
3	47198805	.	G	A	4	4	8	0	1	9	0	0
3	47201409	.	C	T	1	5	6	0	1	7	0	0
3	47201440	.	A	G	3	7	10	0	1	11	0	0
3	47201479	.	T	C	3	8	11	0	0	11	0	0
3	47201482	.	T	C	3	7	10	0	0	10	0	0
3	47201518	.	C	T	1	6	7	0	0	7	0	0
3	47205408	.	C	T	0	1	1	0	0	1	0	0
3	47205417	.	A	G	1	0	1	0	2	3	0	0
3	47205507	.	G	A	6	6	12	0	0	12	0	0
3	47205534	.	A	G	4	0	4	0	10	14	0	0
3	47205543	.	C	T	6	7	13	0	0	13	0	0
3	47205585	.	A	T	4	3	7	0	1	8	0	0
3	47205597	.	C	T	4	3	7	0	0	7	0	0
3	47209257	.	A	T	1	2	3	0	0	3	0	0
3	47209433	.	T	C	3	7	10	0	1	11	0	0
3	47209445	.	A	T	2	5	7	0	0	7	0	0
3	47212774	.	T	C	1	2	3	0	0	3	0	0
3	47212790	.	A	G	2	0	2	0	2	4	0	0
3	47212826	.	A	G	1	2	3	0	1	4	0	0
3	47212896	.	A	T	2	7	9	0	0	9	0	0
3	47212914	.	T	C	2	8	10	0	0	10	0	0
3	47213009	.	A	T	5	2	7	0	0	7	0	0
3	47213025	.	G	T	3	3	6	0	0	6	0	0
3	47213046	.	G	A	3	4	7	0	0	7	0	0
3	47213067	.	C	G	2	5	7	0	0	7	0	0
3	47376818	.	C	T	4	2	6	0	0	6	0	0
3	47384653	.	T	C	0	2	2	0	0	2	0	0
3	47387084	.	A	C	1	4	5	0	0	5	0	0
3	47387085	.	A	C	1	4	5	0	0	5	0	0
3	47387347	.	T	G	0	5	5	0	0	5	0	0
3	47498493	.	C	T	0	2	2	0	5	7	0	0
3	47498565	.	A	T	6	3	9	0	0	9	0	0
3	47498625	.	C	A	3	3	6	0	1	7	0	0
3	47498633	.	G	A	4	2	6	0	0	6	0	0
3	47498937	.	G	C	8	6	14	0	0	14	0	0
3	47498981	.	T	G	8	5	13	0	0	13	0	0
3	47498985	.	C	T	3	8	11	0	0	11	0	0
3	47499240	.	G	A	3	3	6	0	0	6	0	0
3	47526005	.	A	G	1	1	2	0	0	2	0	0
3	47526262	.	C	T	6	6	12	0	0	12	0	0
3	47526271	.	G	A	6	6	12	0	0	12	0	0
3	47529406	.	G	A	1	4	5	0	0	5	0	0
3	47875576	.	A	T	1	2	3	0	0	3	0	0
3	48226259	.	G	A	0	1	1	0	0	1	0	0
3	48229390	.	A	G	3	0	3	0	5	8	0	0
3	48229423	.	C	T	2	4	6	0	0	6	0	0
3	48229507	.	A	G	4	3	7	0	0	7	0	0
3	48229654	.	C	T	1	2	3	0	0	3	0	0
3	48229719	.	G	T	0	3	3	0	0	3	0	0
3	48244963	.	G	A	0	1	1	0	1	2	0	0
3	48247601	.	A	G	2	2	4	0	0	4	0	0
3	48253489	.	G	A	1	3	4	0	0	4	0	0
3	48253673	.	C	T	1	2	3	0	0	3	0	0
3	48253733	.	T	G	1	2	3	0	0	3	0	0
3	48253881	.	C	T	1	0	1	0	0	1	0	0
3	48283580	.	G	A	1	0	1	0	0	1	0	0
3	48286490	.	C	T	1	5	6	0	1	7	0	0
3	48286514	.	T	C	1	4	5	0	2	7	0	0
3	48301180	.	A	G	2	1	3	0	0	3	0	0
3	48305837	.	C	G	3	2	5	0	0	5	0	0
3	48305841	.	G	A	0	3	3	0	2	5	0	0
3	48305898	.	C	G	2	2	4	0	1	5	0	0
3	48320968	.	A	G	1	2	3	0	0	3	0	0
3	48326568	.	G	A	2	1	3	0	0	3	0	0
3	48326631	.	C	T	3	1	4	0	0	4	0	0
3	48326725	.	A	C	0	1	1	0	0	1	0	0
3	48327002	.	G	A	2	1	3	0	0	3	0	0
3	48473521	.	C	A	4	2	6	0	0	6	0	0
3	48473546	.	C	A	3	4	7	0	1	8	0	0
3	48473565	.	A	G	5	6	11	0	1	12	0	0
3	48479982	.	C	T	2	2	4	0	0	4	0	0
3	48480156	.	T	G	4	7	11	0	0	11	0	0
3	48488909	.	G	T	8	4	12	0	0	12	0	0
3	48488993	.	T	C	3	6	9	0	0	9	0	0
3	48489101	.	C	G	2	0	2	0	3	5	0	0
3	48489154	.	A	G	4	0	4	0	5	9	0	0
3	48550676	.	G	A	22	16	38	0	1	39	0	0
3	48557707	.	T	C	1	0	1	0	3	4	0	0
3	48584800	.	A	T	6	11	17	0	1	18	0	0
3	48585222	.	C	T	0	14	14	0	15	29	0	0
3	48585236	.	C	A	15	13	28	0	1	29	0	0
3	48585271	.	A	C	18	11	29	0	1	30	0	0
3	48585331	.	A	G	22	5	27	0	3	30	0	0
3	48585377	.	G	T	13	11	24	0	2	26	0	0
3	48585411	.	G	T	10	10	20	0	1	21	0	0
3	48586985	.	A	G	22	17	39	0	1	40	0	0
3	48587176	.	C	A	7	26	33	0	0	33	0	0
3	48587191	.	C	T	7	23	30	0	0	30	0	0
3	48588830	.	A	G	9	5	14	0	0	14	0	0
3	48588884	.	A	G	5	9	14	0	0	14	0	0
3	48589156	.	A	G	1	1	2	0	0	2	0	0
3	48591769	.	A	G	6	13	19	0	0	19	0	0
3	48591825	.	G	T	1	2	3	0	0	3	0	0
3	48593781	.	T	C	12	18	30	0	0	30	0	0
3	48593811	.	G	A	11	6	17	0	2	19	0	0
3	48594098	.	T	C	8	0	8	0	19	27	0	0
3	48596834	.	T	C	8	9	17	0	0	17	0	0
3	48612027	.	T	C	1	0	1	0	1	2	0	0
3	48612038	.	A	G	1	2	3	0	0	3	0	0
3	48638932	.	C	T	1	2	3	0	0	3	0	0
3	48645863	.	A	C	8	5	13	0	1	14	0	0
3	48661465	.	C	A	0	2	2	0	6	8	0	0
3	48661500	.	A	G	9	6	15	0	0	15	0	0
3	48661700	.	G	A	4	4	8	0	2	10	0	0
3	48665832	.	T	A	4	5	9	0	1	10	0	0
3	48665841	.	T	G	3	6	9	0	1	10	0	0
3	48686990	.	G	A	3	0	3	0	0	3	0	0
3	48687134	.	C	T	0	2	2	0	3	5	0	0
3	48700453	.	G	A	1	0	1	0	0	1	0	0
3	48704776	.	G	A	0	1	1	0	0	1	0	0
3	48704848	.	G	A	1	1	2	0	0	2	0	0
3	49130387	.	A	C	2	0	2	0	3	5	0	0
3	49130480	.	G	A	2	4	6	0	0	6	0	0
3	49134236	.	A	C	3	11	14	0	0	14	0	0
3	49154025	.	G	A	5	4	9	0	0	9	0	0
3	49154214	.	G	A	5	3	8	0	0	8	0	0
3	49163407	.	G	T	2	3	5	0	0	5	0	0
3	49163417	.	C	T	4	3	7	0	0	7	0	0
3	49163528	.	G	T	7	4	11	0	0	11	0	0
3	49163558	.	T	C	5	4	9	0	0	9	0	0
3	49426063	.	G	A	10	8	18	0	0	18	0	0
3	49426184	.	G	A	5	15	20	0	2	22	0	0
3	49439587	.	A	G	1	1	2	0	0	2	0	0
3	49440129	.	G	T	1	2	3	0	0	3	0	0
3	49447514	.	C	A	0	9	9	0	6	15	0	0
3	49478380	.	T	C	3	0	3	0	0	3	0	0
3	49503880	.	A	G	15	14	29	0	2	31	0	0
3	49559444	.	C	T	23	39	62	0	3	65	0	0
3	49559523	.	C	T	32	37	69	0	2	71	0	0
3	49559527	.	G	T	33	33	66	0	2	68	0	0
3	49559637	.	G	T	33	32	65	0	5	70	0	0
3	49559703	.	G	A	36	30	66	0	3	69	0	0
3	49559904	.	G	A	33	36	69	0	4	73	0	0
3	49559979	.	A	G	33	31	64	0	2	66	0	0
3	49559988	.	T	A	33	29	62	0	1	63	0	0
3	49560084	.	A	G	36	32	68	0	2	70	0	0
3	49560204	.	G	C	29	37	66	0	1	67	0	0
3	49560276	.	T	G	33	29	62	0	5	67	0	0
3	49560420	.	C	T	31	28	59	0	0	59	0	0
3	49560507	.	G	A	27	33	60	0	3	63	0	0
3	49759036	.	G	A	1	2	3	0	0	3	0	0
3	49759790	.	T	C	1	3	4	0	0	4	0	0
3	49759820	.	T	C	1	0	1	0	3	4	0	0
3	49768289	.	G	A	1	1	2	0	0	2	0	0
3	50054508	.	G	A	6	4	10	0	1	11	0	0
3	50054619	.	A	T	5	4	9	0	2	11	0	0
3	50054766	.	G	A	11	4	15	0	0	15	0	0
3	50059143	.	A	T	14	10	24	0	0	24	0	0
3	50063458	.	C	T	9	5	14	0	1	15	0	0
3	50063491	.	C	T	0	10	10	0	8	18	0	0
3	50066373	.	A	G	15	17	32	0	4	36	0	0
3	50066402	.	G	A	13	17	30	0	3	33	0	0
3	50066497	.	C	T	0	3	3	0	0	3	0	0
3	50077028	.	T	C	1	3	4	0	0	4	0	0
3	50077050	.	G	A	1	9	10	0	0	10	0	0
3	50077077	.	G	A	14	3	17	0	2	19	0	0
3	50077311	.	A	G	16	17	33	0	1	34	0	0
3	50077364	.	T	A	15	9	24	0	2	26	0	0
3	50077371	.	G	A	9	14	23	0	0	23	0	0
3	50077428	.	G	C	0	3	3	0	0	3	0	0
3	50081696	.	G	A	6	3	9	0	0	9	0	0
3	50083980	.	C	A	3	1	4	0	1	5	0	0
3	50084011	.	A	G	10	10	20	0	1	21	0	0
3	50087361	.	C	A	0	3	3	0	4	7	0	0
3	50087370	.	G	A	6	4	10	0	0	10	0	0
3	50087433	.	C	A	1	8	9	0	22	31	0	0
3	50089113	.	G	A	1	3	4	0	0	4	0	0
3	50089470	.	T	C	3	4	7	0	0	7	0	0
3	50091985	.	A	G	12	16	28	0	1	29	0	0
3	50095869	.	A	T	3	1	4	0	0	4	0	0
3	50095929	.	C	T	0	2	2	0	5	7	0	0
3	50110202	.	T	C	3	0	3	0	1	4	0	0
3	50110205	.	C	A	2	0	2	0	2	4	0	0
3	50110369	.	T	C	2	2	4	0	0	4	0	0
3	50110399	.	A	G	2	2	4	0	0	4	0	0
3	50123650	.	C	A	1	14	15	0	15	30	0	0
3	50123709	.	A	G	20	22	42	0	0	42	0	0
3	50123758	.	A	G	24	14	38	0	0	38	0	0
3	50123760	.	C	A	14	23	37	0	1	38	0	0
3	50123936	.	G	A	13	25	38	0	0	38	0	0
3	50124107	.	A	G	13	14	27	0	1	28	0	0
3	50124108	.	C	G	13	13	26	0	2	28	0	0
3	50127039	.	G	T	9	6	15	0	0	15	0	0
3	50127196	.	G	A	3	2	5	0	0	5	0	0
3	50156275	.	T	C	1	3	4	0	0	4	0	0
3	50159356	.	C	G	0	0	0	0	2	2	0	0
3	50159431	.	C	T	2	3	5	0	0	5	0	0
3	50166550	.	T	C	0	3	3	0	0	3	0	0
3	50170236	.	A	G	2	1	3	0	3	6	0	0
3	50170338	.	T	A	0	1	1	0	1	2	0	0
3	50172725	.	G	C	2	8	10	0	0	10	0	0
3	50175940	.	G	T	3	2	5	0	0	5	0	0
3	50176620	.	G	T	4	4	8	0	0	8	0	0
3	50253969	.	G	A	2	3	5	0	0	5	0	0
3	50256938	.	A	C	3	5	8	0	0	8	0	0
3	50265852	.	C	T	7	10	17	0	0	17	0	0
3	50265903	.	A	C	7	13	20	0	1	21	0	0
3	50265906	.	T	C	9	12	21	0	0	21	0	0
3	50265994	.	C	T	5	3	8	0	0	8	0	0
3	50266043	.	C	A	2	2	4	0	0	4	0	0
3	50266063	.	A	G	1	2	3	0	0	3	0	0
3	50266198	.	T	C	2	2	4	0	0	4	0	0
3	50266330	.	T	A	10	8	18	0	0	18	0	0
3	50266384	.	A	G	4	2	6	0	0	6	0	0
3	50266394	.	T	A	3	1	4	0	0	4	0	0
3	50266474	.	G	A	1	2	3	0	0	3	0	0
3	50266765	.	A	G	1	3	4	0	0	4	0	0
3	50266945	.	A	G	1	7	8	0	0	8	0	0
3	50267171	.	T	G	1	3	4	0	0	4	0	0
3	50267256	.	T	A	4	2	6	0	0	6	0	0
3	50267460	.	G	A	6	3	9	0	2	11	0	0
3	50267471	.	A	T	5	2	7	0	0	7	0	0
3	50267686	.	T	C	5	12	17	0	0	17	0	0
3	50267860	.	A	T	7	8	15	0	1	17	1	0
3	50267981	.	G	C	8	7	15	0	0	15	0	0
3	50267992	.	T	A	8	6	14	0	1	15	0	0
3	50268016	.	T	C	4	7	11	0	0	11	0	0
3	50268052	.	A	T	7	5	12	0	0	12	0	0
3	50268073	.	A	G	8	6	14	0	0	14	0	0
3	50268106	.	G	T	5	7	12	0	0	12	0	0
3	50268146	.	T	A	6	6	12	0	0	12	0	0
3	50268220	.	C	T	5	3	8	0	2	10	0	0
3	50268422	.	G	A	6	3	9	0	0	9	0	0
3	50268535	.	A	C	12	8	20	0	0	20	0	0
3	50268715	.	C	T	7	5	12	0	1	13	0	0
3	50268744	.	G	A	8	7	15	0	1	16	0	0
3	50269138	.	A	C	1	2	3	0	0	3	0	0
3	50272168	.	C	T	0	4	4	0	5	9	0	0
3	50272435	.	T	G	8	7	15	0	0	15	0	0
3	50272438	.	T	G	9	6	15	0	0	15	0	0
3	50273026	.	G	A	4	12	16	0	1	17	0	0
3	50273031	.	C	T	4	11	15	0	1	16	0	0
3	50273469	.	C	T	0	2	2	0	2	4	0	0
3	50276336	.	A	T	1	0	1	0	0	1	0	0
3	50365808	.	C	A	0	5	5	0	1	6	0	0
3	50418826	.	G	C	11	4	15	0	0	15	0	0
3	50419046	.	C	T	4	8	12	0	1	13	0	0
3	50419155	.	C	T	5	8	13	0	0	13	0	0
3	50419329	.	G	A	5	2	7	0	1	8	0	0
3	50419344	.	T	A	2	7	9	0	0	9	0	0
3	50419626	.	A	T	1	3	4	0	0	4	0	0
3	50419658	.	T	A	2	5	7	0	0	7	0	0
3	50419686	.	A	T	4	9	13	0	0	13	0	0
3	50419722	.	G	C	6	10	16	0	1	17	0	0
3	50419723	.	C	A	6	11	17	0	0	17	0	0
3	50419759	.	C	T	9	8	17	0	1	18	0	0
3	50419791	.	T	C	12	5	17	0	0	17	0	0
3	50419803	.	C	A	4	11	15	0	0	15	0	0
3	50419827	.	T	C	4	8	12	0	0	12	0	0
3	50419866	.	T	A	4	6	10	0	0	10	0	0
3	50419867	.	A	C	6	4	10	0	0	10	0	0
3	50420001	.	A	C	1	4	5	0	0	5	0	0
3	50420139	.	A	T	9	8	17	0	1	18	0	0
3	50420152	.	G	T	9	9	18	0	2	20	0	0
3	50420191	.	A	T	10	15	25	0	1	26	0	0
3	50420194	.	T	A	15	9	24	0	2	26	0	0
3	50861448	.	G	T	2	2	4	0	0	4	0	0
3	50861538	.	A	G	1	3	4	0	0	4	0	0
3	50951299	.	C	A	2	5	7	0	2	9	0	0
3	50951770	.	T	G	6	3	9	0	1	10	0	0
3	50952163	.	G	A	6	3	9	0	0	9	0	0
3	51034995	.	G	T	6	1	7	0	0	7	0	0
3	51039012	.	C	T	0	1	1	0	1	2	0	0
3	51043176	.	G	A	3	3	6	0	0	6	0	0
3	51043976	.	G	A	2	3	5	0	0	5	0	0
3	51043994	.	G	A	3	3	6	0	0	6	0	0
3	51046799	.	A	G	1	0	1	0	0	1	0	0
3	51046805	.	A	G	1	0	1	0	0	1	0	0
3	51056311	.	C	G	4	2	6	0	0	6	0	0
3	51056350	.	A	G	2	0	2	0	0	2	0	0
3	51060094	.	A	G	1	2	3	0	0	3	0	0
3	51063396	.	C	T	2	1	3	0	0	3	0	0
3	51063398	.	C	T	2	1	3	0	0	3	0	0
3	51065802	.	A	G	1	3	4	0	0	4	0	0
3	51066110	.	C	T	0	1	1	0	1	2	0	0
3	51074579	.	T	A	4	2	6	0	0	6	0	0
3	51074618	.	C	T	0	2	2	0	2	4	0	0
3	51077378	.	T	C	1	0	1	0	0	1	0	0
3	51077458	.	G	A	1	0	1	0	0	1	0	0
3	51563736	.	G	A	0	4	4	0	5	9	0	0
3	51563824	.	T	C	1	2	3	0	0	3	0	0
3	51563874	.	G	C	2	5	7	0	0	7	0	0
3	51563876	.	T	G	2	5	7	0	0	7	0	0
3	51563911	.	T	C	2	3	5	0	1	6	0	0
3	51619708	.	G	A	3	1	4	0	0	4	0	0
3	51619762	.	C	T	3	2	5	0	0	5	0	0
3	51619789	.	A	C	2	3	5	0	0	5	0	0
3	51619801	.	T	A	1	3	4	0	0	4	0	0
3	51619846	.	T	C	0	3	3	0	0	3	0	0
3	51642491	.	G	A	1	1	2	0	0	2	0	0
3	51642720	.	C	T	1	0	1	0	0	1	0	0
3	51645783	.	C	T	2	1	3	0	0	3	0	0
3	51653411	.	G	A	9	4	13	0	0	13	0	0
3	51653435	.	C	T	11	3	14	0	1	15	0	0
3	51656849	.	T	A	7	3	10	0	0	10	0	0
3	51656921	.	T	C	4	8	12	0	0	12	0	0
3	51656931	.	G	A	5	8	13	0	0	13	0	0
3	51656973	.	C	A	6	6	12	0	0	12	0	0
3	51657033	.	T	A	10	5	15	0	0	15	0	0
3	51657082	.	C	T	10	3	13	0	2	15	0	0
3	51657158	.	A	G	9	0	9	0	7	16	0	0
3	51657291	.	G	A	10	8	18	0	1	19	0	0
3	51657314	.	G	A	10	7	17	0	1	18	0	0
3	51657339	.	C	T	6	6	12	0	0	12	0	0
3	51657382	.	G	C	3	2	5	0	0	5	0	0
3	51657439	.	A	G	5	5	10	0	0	10	0	0
3	51657456	.	C	T	6	5	11	0	0	11	0	0
3	51742263	.	G	A	1	0	1	0	0	1	0	0
3	51808378	.	C	T	1	0	1	0	0	1	0	0
3	51834434	.	C	T	1	1	2	0	1	3	0	0
3	51861767	.	G	A	10	6	16	0	1	17	0	0
3	51871663	.	A	T	10	7	17	0	1	18	0	0
3	51871671	.	C	T	11	6	17	0	0	17	0	0
3	51871704	.	G	C	6	4	10	0	0	10	0	0
3	51871788	.	G	A	2	5	7	0	0	7	0	0
3	51874119	.	C	A	1	1	2	0	0	2	0	0
3	51874163	.	G	A	3	4	7	0	0	7	0	0
3	51874274	.	G	A	5	7	12	0	0	12	0	0
3	51879297	.	G	T	7	13	20	0	0	20	0	0
3	51891785	.	A	G	8	0	8	0	14	22	0	0
3	51891787	.	C	T	9	11	20	0	2	22	0	0
3	51892136	.	A	T	6	6	12	0	0	12	0	0
3	51892162	.	A	G	4	7	11	0	1	12	0	0
3	51892176	.	T	A	5	7	12	0	1	13	0	0
3	51892212	.	A	G	5	4	9	0	0	9	0	0
3	51892225	.	T	A	5	5	10	0	0	10	0	0
3	51892539	.	A	T	2	2	4	0	0	4	0	0
3	51892573	.	T	C	7	4	11	0	1	12	0	0
3	51899772	.	T	A	11	11	22	0	0	23	1	0
3	51899802	.	C	T	0	12	12	0	6	18	0	0
3	51899872	.	C	T	2	8	10	0	7	17	0	0
3	51900357	.	C	A	6	12	18	0	0	18	0	0
3	51900400	.	A	G	13	4	17	0	0	17	0	0
3	51900415	.	T	C	7	12	19	0	2	21	0	0
3	51900487	.	A	C	11	15	26	0	2	28	0	0
3	51900552	.	A	G	5	7	12	0	2	14	0	0
3	51900587	.	C	T	6	10	16	0	1	17	0	0
3	51900589	.	A	C	6	11	17	0	0	17	0	0
3	51900693	.	C	G	14	15	29	0	0	29	0	0
3	51900702	.	C	A	0	14	14	0	13	27	0	0
3	51900768	.	T	A	6	8	14	0	1	15	0	0
3	51900784	.	T	C	8	0	8	0	5	13	0	0
3	51901018	.	C	T	3	1	4	0	1	5	0	0
3	51901092	.	A	T	13	13	26	0	1	27	0	0
3	51901127	.	A	G	12	19	31	0	1	32	0	0
3	51901178	.	T	A	4	13	17	0	0	17	0	0
3	51901199	.	G	T	1	4	5	0	0	5	0	0
3	51901309	.	G	A	8	3	11	0	0	11	0	0
3	51901344	.	T	C	15	9	24	0	0	24	0	0
3	51901413	.	A	G	4	2	6	0	0	6	0	0
3	51901670	.	C	T	10	15	25	0	0	25	0	0
3	51901799	.	T	C	16	14	30	0	0	30	0	0
3	51901835	.	G	A	18	17	35	0	2	37	0	0
3	51901873	.	A	G	21	18	39	0	0	39	0	0
3	51901885	.	T	C	18	17	35	0	3	38	0	0
3	51902099	.	C	T	15	9	24	0	3	27	0	0
3	51902171	.	T	A	9	11	20	0	1	21	0	0
3	51902454	.	T	A	6	13	19	0	2	21	0	0
3	51902471	.	C	T	6	11	17	0	0	17	0	0
3	51902591	.	T	A	6	10	16	0	1	17	0	0
3	51902695	.	C	T	13	5	18	0	3	21	0	0
3	51902834	.	A	G	13	9	22	0	0	22	0	0
3	51902883	.	G	A	12	11	23	0	0	23	0	0
3	51902987	.	A	G	11	10	21	0	0	21	0	0
3	51903048	.	A	C	8	7	15	0	3	18	0	0
3	51903080	.	A	G	6	9	15	0	1	16	0	0
3	51903168	.	C	T	8	8	16	0	0	16	0	0
3	51903198	.	A	C	9	0	9	0	15	24	0	0
3	51903211	.	T	G	10	16	26	0	0	26	0	0
3	51903233	.	A	G	10	16	26	0	1	27	0	0
3	51903286	.	G	T	9	20	29	0	1	30	0	0
3	51903495	.	A	G	11	7	18	0	1	19	0	0
3	51903591	.	C	T	7	7	14	0	1	15	0	0
3	51903605	.	G	A	8	8	16	0	0	16	0	0
3	51903742	.	C	G	5	9	14	0	1	15	0	0
3	51903810	.	T	G	6	7	13	0	2	15	0	0
3	51903815	.	T	A	5	8	13	0	1	14	0	0
3	51903979	.	T	C	5	6	11	0	1	12	0	0
3	51904019	.	G	T	9	5	14	0	1	15	0	0
3	51904043	.	G	T	10	7	17	0	2	19	0	0
3	51904226	.	A	G	6	4	10	0	1	11	0	0
3	51904359	.	T	A	8	15	23	0	1	24	0	0
3	51904826	.	G	A	1	1	2	0	0	2	0	0
3	51907077	.	G	T	8	3	11	0	0	11	0	0
3	51907297	.	G	A	0	2	2	0	0	2	0	0
3	51911718	.	A	C	0	1	1	0	0	1	0	0
3	51911727	.	A	G	0	1	1	0	0	1	0	0
3	52558309	.	G	A	0	2	2	0	1	3	0	0
3	52558333	.	A	G	2	3	5	0	0	5	0	0
3	52558558	.	T	A	1	1	2	0	0	2	0	0
3	52563568	.	C	T	6	3	9	0	0	9	0	0
3	52584332	.	C	T	3	6	9	0	1	10	0	0
3	52584428	.	C	T	6	4	10	0	0	10	0	0
3	52588941	.	C	T	0	5	5	0	0	5	0	0
3	52594760	.	G	A	9	4	13	0	1	14	0	0
3	52594966	.	T	C	10	9	19	0	1	20	0	0
3	52603216	.	A	C	8	10	18	0	0	18	0	0
3	52641771	.	C	A	1	3	4	0	0	4	0	0
3	52642132	.	T	A	6	5	11	0	0	11	0	0
3	52642488	.	A	G	1	1	2	0	0	2	0	0
3	52642614	.	T	C	5	0	5	0	1	6	0	0
3	52644611	.	C	T	1	2	3	0	0	3	0	0
3	52644648	.	G	A	2	6	8	0	0	8	0	0
3	52647218	.	T	C	1	2	3	0	0	3	0	0
3	52647283	.	A	G	1	5	6	0	0	6	0	0
3	52647284	.	A	T	2	5	7	0	0	8	1	0
3	52647825	.	G	A	2	2	4	0	0	4	0	0
3	52647870	.	C	T	5	2	7	0	0	7	0	0
3	52648764	.	G	A	2	2	4	0	1	5	0	0
3	52648842	.	T	C	1	4	5	0	0	5	0	0
3	52660438	.	A	G	0	1	1	0	0	1	0	0
3	52660538	.	A	T	0	1	1	0	0	1	0	0
3	52660929	.	T	A	4	4	8	0	0	8	0	0
3	52668150	.	C	T	1	2	3	0	7	10	0	0
3	52668542	.	G	A	3	9	12	0	0	12	0	0
3	52668679	.	C	T	0	2	2	0	3	5	0	0
3	52673834	.	T	A	3	6	9	0	2	11	0	0
3	52673854	.	A	T	6	3	9	0	0	9	0	0
3	52674017	.	T	A	3	6	9	0	1	10	0	0
3	52674018	.	A	C	6	4	10	0	0	10	0	0
3	52674105	.	A	C	2	2	4	0	0	4	0	0
3	52676973	.	A	G	1	2	3	0	0	3	0	0
3	52677087	.	C	T	0	4	4	0	2	6	0	0
3	52677279	.	G	A	0	4	4	0	0	4	0	0
3	52677281	.	C	T	0	4	4	0	0	4	0	0
3	52677492	.	C	G	4	1	5	0	0	5	0	0
3	52677501	.	T	C	4	1	5	0	0	5	0	0
3	52689511	.	C	T	1	2	3	0	0	3	0	0
3	52697304	.	G	C	1	0	1	0	0	1	0	0
3	52697312	.	A	C	1	0	1	0	0	1	0	0
3	52697371	.	T	A	1	1	2	0	0	2	0	0
3	52699405	.	G	A	5	3	8	0	0	8	0	0
3	52699441	.	G	A	9	2	11	0	0	11	0	0
3	52699449	.	G	T	0	4	4	0	7	11	0	0
3	52699494	.	A	G	6	6	12	0	0	12	0	0
3	52699503	.	T	C	4	5	9	0	0	9	0	0
3	52699576	.	T	C	3	1	4	0	1	5	0	0
3	52699581	.	C	A	3	2	5	0	0	5	0	0
3	52699775	.	C	T	6	2	8	0	0	8	0	0
3	52699995	.	T	C	14	4	18	0	0	18	0	0
3	52895631	.	G	A	3	1	4	0	0	4	0	0
3	52895667	.	G	A	3	3	6	0	0	6	0	0
3	52895688	.	C	T	3	3	6	0	0	6	0	0
3	52898520	.	C	T	0	2	2	0	1	3	0	0
3	52902240	.	G	A	0	2	2	0	2	4	0	0
3	52902344	.	G	A	0	9	9	0	2	11	0	0
3	52902356	.	T	C	2	6	8	0	0	8	0	0
3	52913391	.	T	C	1	2	3	0	0	3	0	0
3	52913508	.	C	T	1	0	1	0	0	1	0	0
3	52913529	.	A	G	2	1	3	0	0	3	0	0
3	52913559	.	T	A	3	3	6	0	0	6	0	0
3	52921735	.	C	T	3	2	5	0	0	5	0	0
3	52921780	.	A	G	2	2	4	0	1	5	0	0
3	52921926	.	A	G	1	0	1	0	1	2	0	0
3	52925915	.	G	A	0	4	4	0	1	5	0	0
3	52931588	.	T	C	1	3	4	0	0	4	0	0
3	52932793	.	A	C	1	2	3	0	0	3	0	0
3	52935355	.	C	A	1	0	1	0	0	1	0	0
3	52937419	.	T	C	3	1	4	0	0	4	0	0
3	52937723	.	G	T	7	3	10	0	2	12	0	0
3	52937747	.	G	A	1	2	3	0	4	7	0	0
3	52945346	.	G	A	1	2	3	0	0	3	0	0
3	53000280	.	G	A	0	3	3	0	5	8	0	0
3	53000517	.	T	C	5	5	10	0	0	10	0	0
3	53000673	.	G	T	0	3	3	0	1	4	0	0
3	53001045	.	C	A	2	4	6	0	0	6	0	0
3	53048032	.	C	T	1	5	6	0	1	7	0	0
3	53074317	.	C	T	10	16	26	1	4	31	0	0
3	53074581	.	C	T	7	13	20	0	3	23	0	0
3	53075050	.	C	A	8	6	14	0	1	15	0	0
3	53075475	.	T	G	12	6	18	0	0	18	0	0
3	53076037	.	A	T	10	16	26	0	2	28	0	0
3	53076160	.	G	T	0	30	30	0	17	47	0	0
3	53192505	.	C	T	8	4	12	0	1	13	0	0
3	53196776	.	C	T	1	1	2	0	0	2	0	0
3	53198736	.	T	C	4	10	14	0	1	15	0	0
3	53198987	.	T	G	4	8	12	0	0	12	0	0
3	53199113	.	G	A	0	5	5	0	3	8	0	0
3	53199433	.	A	T	1	3	4	0	0	4	0	0
3	53203566	.	C	T	1	3	4	0	0	4	0	0
3	53203782	.	A	G	2	0	2	0	0	2	0	0
3	53203823	.	T	G	6	0	6	0	4	10	0	0
3	53204009	.	C	T	2	6	8	0	0	8	0	0
3	53206055	.	A	G	4	0	4	0	6	10	0	0
3	53206260	.	A	G	8	8	16	0	0	16	0	0
3	53206418	.	G	A	9	10	19	0	2	21	0	0
3	53206427	.	C	T	7	10	17	0	0	17	0	0
3	53206469	.	A	T	5	14	19	0	1	20	0	0
3	53206472	.	C	T	5	11	16	0	1	17	0	0
3	53211168	.	G	C	10	3	13	0	4	17	0	0
3	53211170	.	T	C	10	7	17	0	0	17	0	0
3	53211206	.	A	T	5	10	15	0	2	17	0	0
3	53211239	.	A	G	5	14	19	0	3	22	0	0
3	53211248	.	T	G	9	0	9	0	12	21	0	0
3	53211356	.	A	T	4	9	13	0	1	14	0	0
3	53211366	.	C	A	5	6	11	0	1	12	0	0
3	53211604	.	C	G	10	12	22	0	2	24	0	0
3	53211605	.	C	T	9	13	22	0	2	24	0	0
3	53214615	.	T	C	6	2	8	0	0	8	0	0
3	53215711	.	T	A	6	10	16	0	0	16	0	0
3	53215729	.	G	A	6	5	11	0	1	12	0	0
3	53218471	.	C	T	9	8	17	0	0	17	0	0
3	53222943	.	G	T	0	9	9	0	8	17	0	0
3	53223032	.	C	A	8	10	18	0	0	18	0	0
3	53223110	.	T	C	13	8	21	0	0	21	0	0
3	53223290	.	G	A	13	12	25	0	2	27	0	0
3	53223415	.	C	T	10	9	19	0	0	19	0	0
3	53223686	.	G	T	18	7	25	0	3	28	0	0
3	53223691	.	G	T	18	7	25	0	3	28	0	0
3	53223783	.	C	T	9	10	19	0	1	20	0	0
3	53223973	.	A	C	10	10	20	0	0	20	0	0
3	53224029	.	G	A	9	4	13	0	1	14	0	0
3	53224181	.	A	G	17	6	23	0	2	25	0	0
3	53224231	.	C	G	7	8	15	0	2	17	0	0
3	53229021	.	G	A	3	7	10	0	0	10	0	0
3	53229036	.	T	A	2	7	9	0	1	10	0	0
3	53230980	.	T	C	3	3	6	0	0	6	0	0
3	53271759	.	A	G	0	0	0	0	1	1	0	0
3	53271890	.	A	G	1	0	1	0	0	1	0	0
3	53273599	.	A	G	2	3	5	0	0	5	0	0
3	53273763	.	G	A	3	1	4	0	2	6	0	0
3	53317135	.	C	A	0	2	2	0	0	2	0	0
3	53327031	.	C	A	2	5	7	0	0	7	0	0
3	53329518	.	C	T	1	2	3	0	0	3	0	0
3	53331913	.	G	A	1	1	2	0	0	2	0	0
3	53340939	.	G	C	0	0	0	0	1	1	0	0
3	53343415	.	C	T	1	1	2	0	0	2	0	0
3	53343418	.	C	T	1	1	2	0	0	2	0	0
3	53344694	.	T	C	4	3	7	0	0	7	0	0
3	53344842	.	C	T	0	1	1	0	0	1	0	0
3	53350410	.	T	C	6	6	12	0	0	12	0	0
3	53350411	.	G	A	6	6	12	0	0	12	0	0
3	53352516	.	G	T	6	5	11	0	0	11	0	0
3	53352621	.	G	A	0	2	2	0	1	3	0	0
3	53398022	.	C	T	1	2	3	0	0	3	0	0
3	53398107	.	G	T	2	2	4	0	0	4	0	0
3	53444492	.	G	A	1	2	3	0	1	4	0	0
3	53445378	.	A	T	5	5	10	0	0	10	0	0
3	53445979	.	C	T	7	3	10	0	0	10	0	0
3	53446039	.	A	C	3	1	4	0	0	4	0	0
3	53446126	.	G	A	3	2	5	0	0	5	0	0
3	53446429	.	A	G	1	1	2	0	0	2	0	0
3	53446569	.	C	T	4	4	8	0	0	8	0	0
3	53447714	.	C	T	6	2	8	0	0	8	0	0
3	53447717	.	C	T	6	2	8	0	0	8	0	0
3	53448188	.	T	C	1	0	1	0	0	1	0	0
3	53448920	.	A	G	0	0	0	0	3	3	0	0
3	53449227	.	C	A	9	4	13	0	1	14	0	0
3	53449263	.	A	G	9	3	12	0	1	13	0	0
3	53527681	.	T	C	2	4	6	0	0	6	0	0
3	53528017	.	T	C	7	3	10	0	0	10	0	0
3	53528039	.	G	A	8	4	12	0	0	12	0	0
3	53528090	.	T	C	4	2	6	0	1	7	0	0
3	53528190	.	T	C	6	3	9	0	2	11	0	0
3	53528251	.	C	A	0	6	6	0	7	13	0	0
3	53528750	.	T	A	1	4	5	0	2	7	0	0
3	53528893	.	A	T	2	3	5	0	0	5	0	0
3	53529969	.	A	G	2	2	4	0	0	4	0	0
3	53530097	.	C	A	6	3	9	0	1	10	0	0
3	53530298	.	G	A	5	2	7	0	0	7	0	0
3	53530334	.	G	A	5	5	10	0	0	10	0	0
3	53530423	.	C	T	3	3	6	0	2	8	0	0
3	53530656	.	C	T	3	3	6	0	0	6	0	0
3	53687791	.	A	T	3	3	6	0	0	6	0	0
3	53688047	.	A	T	4	3	7	0	0	7	0	0
3	53688077	.	C	G	0	2	2	0	5	7	0	0
3	53688276	.	T	C	2	0	2	0	5	7	0	0
3	54047599	.	T	G	10	7	17	0	1	18	0	0
3	54047881	.	T	C	2	3	5	0	0	5	0	0
3	54168046	.	C	T	15	14	29	0	3	32	0	0
3	54168127	.	C	T	12	5	17	0	0	17	0	0
3	54168174	.	T	C	8	10	18	0	0	18	0	0
3	54168192	.	T	C	8	9	17	0	1	18	0	0
3	54168318	.	T	C	4	4	8	0	0	8	0	0
3	54207610	.	C	T	21	23	44	0	0	44	0	0
3	54223504	.	G	A	4	2	6	0	0	6	0	0
3	54236621	.	T	G	5	7	12	0	0	12	0	0
3	54236657	.	C	A	12	17	29	0	0	29	0	0
3	54236750	.	A	G	18	27	45	0	1	46	0	0
3	54236996	.	G	A	1	29	30	0	29	59	0	0
3	54237347	.	C	T	33	15	48	0	1	49	0	0
3	54237443	.	G	C	9	11	20	0	1	21	0	0
3	54237472	.	T	C	8	9	17	0	1	18	0	0
3	54434398	.	C	T	0	3	3	0	2	5	0	0
3	54435002	.	A	G	5	2	7	0	1	8	0	0
3	54435018	.	A	G	6	2	8	0	0	8	0	0
3	54435273	.	G	A	4	6	10	0	1	11	0	0
3	54435336	.	C	G	1	6	7	0	6	13	0	0
3	54435453	.	G	A	1	0	1	0	0	1	0	0
3	54438753	.	G	A	3	3	6	0	0	6	0	0
3	54455057	.	T	C	3	2	5	0	0	5	0	0
3	54455120	.	T	C	4	0	4	0	5	9	0	0
3	54455168	.	C	T	0	2	2	0	3	5	0	0
3	54455616	.	G	T	5	4	9	0	0	9	0	0
3	54455657	.	T	G	2	1	3	0	0	3	0	0
3	54455827	.	G	A	2	1	3	0	0	3	0	0
3	54500103	.	T	C	2	2	4	0	1	5	0	0
3	54500111	.	C	G	3	4	7	0	0	7	0	0
3	54554306	.	C	G	1	0	1	0	2	3	0	0
3	54555866	.	C	T	0	2	2	0	0	2	0	0
3	54555875	.	A	G	0	2	2	0	0	2	0	0
3	54561375	.	A	G	5	8	13	0	1	14	0	0
3	54567303	.	T	A	3	5	8	0	0	8	0	0
3	54567463	.	T	A	5	3	8	0	0	8	0	0
3	54567502	.	G	A	6	5	11	0	0	11	0	0
3	54567715	.	A	C	1	4	5	0	1	6	0	0
3	54567777	.	A	G	2	0	2	0	4	6	0	0
3	54583742	.	C	T	3	3	6	0	0	6	0	0
3	54585281	.	A	G	1	3	4	0	1	5	0	0
3	54585359	.	C	T	3	6	9	0	1	10	0	0
3	54585637	.	T	C	22	25	47	0	0	47	0	0
3	54585685	.	C	T	8	9	17	0	0	17	0	0
3	54586125	.	T	C	2	2	4	0	0	4	0	0
3	54589582	.	T	C	8	9	17	0	0	17	0	0
3	54591385	.	G	A	3	3	6	0	0	6	0	0
3	54591432	.	A	C	8	8	16	0	0	16	0	0
3	54591677	.	G	A	7	6	13	0	0	13	0	0
3	54591701	.	A	G	2	3	5	0	0	5	0	0
3	54591849	.	G	A	10	10	20	0	1	21	0	0
3	54592322	.	G	A	10	10	20	0	0	20	0	0
3	54592376	.	A	T	9	12	21	0	2	23	0	0
3	54592986	.	T	C	2	0	2	0	2	4	0	0
3	54593034	.	A	T	6	9	15	0	0	15	0	0
3	54593046	.	C	T	7	8	15	0	0	15	0	0
3	54594823	.	C	T	2	5	7	0	0	7	0	0
3	54594865	.	T	A	5	6	11	0	0	11	0	0
3	54594880	.	T	C	4	4	8	0	0	8	0	0
3	54595071	.	G	A	8	3	11	0	0	11	0	0
3	54596362	.	A	G	7	6	13	0	0	13	0	0
3	54596385	.	C	T	3	4	7	0	0	7	0	0
3	54596634	.	G	A	1	1	2	0	0	2	0	0
3	54596651	.	G	A	1	1	2	0	0	2	0	0
3	54596892	.	T	C	10	0	10	0	10	20	0	0
3	54596935	.	A	G	8	5	13	0	0	13	0	0
3	54597183	.	G	A	2	12	14	0	0	14	0	0
3	54597712	.	A	C	4	4	8	0	0	8	0	0
3	54598196	.	T	G	2	1	3	0	0	3	0	0
3	54601833	.	G	A	0	1	1	0	0	1	0	0
3	54601836	.	C	T	0	1	1	0	0	1	0	0
3	54601958	.	T	C	0	0	0	0	6	6	0	0
3	54602027	.	A	G	2	2	4	0	1	5	0	0
3	54602054	.	G	A	1	1	2	0	0	2	0	0
3	54603808	.	C	T	1	5	6	0	0	6	0	0
3	54604010	.	C	T	0	2	2	0	1	3	0	0
3	54607032	.	C	A	0	2	2	0	0	2	0	0
3	54771645	.	C	T	1	4	5	0	0	5	0	0
3	54771659	.	A	T	0	3	3	0	1	4	0	0
3	54809707	.	C	T	4	2	6	0	0	6	0	0
3	54810164	.	G	A	0	0	0	1	0	1	0	0
3	54834830	.	A	G	5	2	7	0	0	7	0	0
3	54835016	.	G	A	1	2	3	0	0	3	0	0
3	54836244	.	T	A	1	3	4	0	1	5	0	0
3	54837768	.	C	T	0	3	3	0	1	4	0	0
3	54849409	.	T	A	3	4	7	1	0	8	0	0
3	54849576	.	T	A	4	7	11	0	0	11	0	0
3	54850678	.	C	T	2	1	3	0	0	3	0	0
3	54856549	.	A	T	0	1	1	0	0	1	0	0
3	54856591	.	T	C	2	5	7	0	0	7	0	0
3	54856592	.	C	T	2	5	7	0	0	7	0	0
3	54856645	.	T	C	5	6	11	0	0	11	0	0
3	54859022	.	G	A	0	3	3	0	0	3	0	0
3	54859127	.	T	C	10	5	15	0	1	16	0	0
3	54866207	.	A	G	5	3	8	0	0	8	0	0
3	54868514	.	C	T	7	8	15	0	0	15	0	0
3	54871515	.	C	A	14	9	23	0	2	25	0	0
3	54871745	.	C	T	6	13	19	0	1	21	1	0
3	54872003	.	C	G	5	7	12	0	1	13	0	0
3	54872172	.	T	A	22	9	31	0	1	32	0	0
3	54872207	.	T	C	27	5	32	0	1	33	0	0
3	54872213	.	A	C	26	5	31	0	1	33	1	0
3	54872520	.	C	G	7	6	13	0	0	13	0	0
3	54873055	.	C	A	8	13	21	0	0	21	0	0
3	54873844	.	T	C	12	19	31	0	0	31	0	0
3	54874245	.	C	T	8	12	20	0	0	20	0	0
3	54874371	.	C	T	8	11	19	0	2	21	0	0
3	54874477	.	A	G	17	11	28	0	2	30	0	0
3	54874631	.	G	A	16	15	31	0	0	31	0	0
3	54874660	.	C	T	17	13	30	0	2	32	0	0
3	54874711	.	G	A	8	7	15	0	1	16	0	0
3	54888004	.	A	G	1	2	3	0	1	4	0	0
3	54892819	.	A	G	1	4	5	0	0	5	0	0
3	54892837	.	G	A	3	2	5	0	0	5	0	0
3	54896608	.	A	G	1	4	5	0	0	5	0	0
3	54896748	.	A	C	5	1	6	0	3	9	0	0
3	54896985	.	A	G	5	4	9	0	0	9	0	0
3	54897039	.	G	A	3	3	6	0	0	6	0	0
3	54897099	.	G	T	5	8	13	0	0	13	0	0
3	54902365	.	C	T	0	2	2	0	1	3	0	0
3	54907937	.	C	T	0	1	1	0	1	2	0	0
3	54911854	.	T	G	2	0	2	0	0	2	0	0
3	54914258	.	A	G	3	3	6	0	0	6	0	0
3	54916497	.	T	C	0	1	1	0	0	1	0	0
3	55042728	.	C	T	1	2	3	0	0	3	0	0
3	55045602	.	T	A	9	3	12	0	0	12	0	0
3	55045709	.	G	T	4	3	7	0	1	8	0	0
3	55046165	.	A	G	2	8	10	0	0	11	1	0
3	55050175	.	A	G	10	5	15	0	0	15	0	0
3	55050191	.	T	A	5	8	13	0	0	13	0	0
3	55057370	.	T	C	2	4	6	0	0	6	0	0
3	55057421	.	T	G	0	1	1	0	0	1	0	0
3	55057436	.	C	T	0	1	1	0	0	1	0	0
3	55063295	.	C	T	0	0	0	0	2	2	0	0
3	55070980	.	A	C	0	0	0	0	3	3	0	0
3	55079251	.	C	T	2	3	5	0	0	5	0	0
3	55079269	.	T	C	3	3	6	0	1	7	0	0
3	55079287	.	T	C	2	0	2	0	3	5	0	0
3	55079508	.	A	T	1	5	6	0	0	6	0	0
3	55100228	.	T	C	4	0	4	0	0	4	0	0
3	55100522	.	A	G	6	4	10	0	2	12	0	0
3	55100590	.	T	G	2	6	8	0	1	9	0	0
3	55100795	.	A	G	19	10	29	0	1	30	0	0
3	55104214	.	T	C	5	0	5	0	4	9	0	0
3	55104215	.	A	G	5	4	9	0	0	9	0	0
3	55105254	.	T	C	6	4	10	0	0	10	0	0
3	55105886	.	A	G	9	5	14	0	0	14	0	0
3	55161724	.	C	T	4	2	6	0	0	6	0	0
3	55161753	.	C	T	3	2	5	0	0	5	0	0
3	55161763	.	G	T	2	2	4	0	0	4	0	0
3	55174830	.	G	A	4	4	8	0	0	8	0	0
3	55174832	.	C	A	4	4	8	0	0	8	0	0
3	55174998	.	G	A	2	6	8	0	0	8	0	0
3	55177759	.	C	T	1	2	3	0	0	3	0	0
3	55218724	.	C	T	0	8	8	0	1	9	0	0
3	55218943	.	T	G	3	3	6	0	0	6	0	0
3	55222778	.	G	T	0	3	3	0	0	3	0	0
3	55229759	.	G	A	2	3	5	0	0	5	0	0
3	55269307	.	G	A	0	1	1	0	0	1	0	0
3	55422011	.	G	A	4	3	7	0	0	7	0	0
3	55422165	.	A	T	5	2	7	0	0	7	0	0
3	55422831	.	G	A	5	4	9	0	1	10	0	0
3	55422850	.	G	T	5	4	9	0	1	10	0	0
3	55422980	.	T	C	2	2	4	0	0	4	0	0
3	55423611	.	G	A	6	6	12	0	0	12	0	0
3	55424465	.	C	T	4	2	6	0	1	7	0	0
3	55426258	.	T	C	2	0	2	0	0	2	0	0
3	55430451	.	T	C	0	2	2	0	0	2	0	0
3	55430475	.	G	A	0	3	3	0	0	3	0	0
3	55438733	.	C	T	4	1	5	0	0	5	0	0
3	56786762	.	A	T	0	3	3	0	0	3	0	0
3	57462953	.	T	C	7	4	11	0	1	12	0	0
3	57462962	.	T	C	2	8	10	0	0	10	0	0
3	58197600	.	A	G	0	2	2	0	0	2	0	0
3	58210564	.	A	G	0	5	5	0	0	5	0	0
3	58210593	.	T	A	0	3	3	0	2	5	0	0
3	58608283	.	C	G	0	6	6	1	0	7	0	0
3	58608380	.	G	A	2	2	4	0	0	4	0	0
3	58610890	.	G	A	3	2	5	2	1	8	0	0
3	58611186	.	G	A	1	4	5	1	2	8	0	0
3	58615428	.	T	G	3	6	9	0	0	9	0	0
3	58704640	.	T	C	2	9	11	0	0	11	0	0
3	58704655	.	C	A	2	4	6	0	0	6	0	0
3	58710350	.	T	C	4	11	15	0	1	16	0	0
3	58710351	.	T	A	11	4	15	0	1	16	0	0
3	60219080	.	T	C	1	3	4	0	0	4	0	0
3	60219093	.	T	C	1	2	3	0	0	3	0	0
3	60219624	.	C	T	1	1	2	0	1	3	0	0
3	60294089	.	C	G	1	3	4	0	0	4	0	0
3	60578642	.	T	C	1	2	3	0	0	3	0	0
3	60578643	.	T	C	1	2	3	0	0	3	0	0
3	60596020	.	G	A	6	3	9	0	0	9	0	0
3	60596347	.	A	G	6	2	8	0	0	8	0	0
3	60596479	.	T	C	4	1	5	0	0	5	0	0
3	60817859	.	C	T	1	5	6	0	0	6	0	0
3	61078363	.	T	G	6	2	8	0	0	8	0	0
3	61156566	.	G	A	1	2	3	0	0	3	0	0
3	61221250	.	A	T	6	4	10	0	0	10	0	0
3	61244015	.	C	T	2	3	5	0	0	5	0	0
3	61272235	.	C	T	1	2	3	0	0	3	0	0
3	61277028	.	C	G	2	4	6	0	1	7	0	0
3	61278692	.	C	T	2	7	9	0	0	9	0	0
3	61278992	.	C	T	6	3	9	0	1	10	0	0
3	61279427	.	A	C	2	6	8	0	0	8	0	0
3	61279585	.	G	A	0	4	4	0	12	16	0	0
3	61279643	.	T	C	11	5	16	0	2	18	0	0
3	61280055	.	G	A	8	11	19	0	0	19	0	0
3	61280117	.	T	C	9	10	19	0	3	22	0	0
3	61280343	.	G	C	12	7	19	0	1	20	0	0
3	61280350	.	C	G	11	8	19	0	1	20	0	0
3	61280381	.	T	A	12	9	21	0	0	21	0	0
3	61280579	.	T	G	7	0	7	0	12	19	0	0
3	61281051	.	A	G	8	10	18	0	1	19	0	0
3	61281681	.	G	A	0	6	6	0	2	8	0	0
3	61285757	.	A	G	8	5	13	0	0	13	0	0
3	61285787	.	C	T	11	8	19	0	0	19	0	0
3	61286009	.	A	C	5	4	9	0	0	9	0	0
3	61286062	.	T	A	6	6	12	0	0	12	0	0
3	61286081	.	C	A	6	6	12	0	0	12	0	0
3	61286325	.	C	G	5	0	5	0	9	14	0	0
3	61286387	.	C	T	2	2	4	0	0	4	0	0
3	61286468	.	C	T	6	8	14	0	1	15	0	0
3	61286528	.	A	T	0	7	7	0	0	7	0	0
3	61286564	.	T	C	0	9	9	0	0	9	0	0
3	61286576	.	C	T	5	4	9	0	0	9	0	0
3	61286687	.	T	A	4	3	7	0	0	7	0	0
3	61286889	.	T	C	20	7	27	0	0	27	0	0
3	61287491	.	T	A	12	13	25	0	0	25	0	0
3	61287590	.	G	T	16	17	33	0	0	33	0	0
3	61287627	.	C	G	14	15	29	0	0	29	0	0
3	61287893	.	T	G	11	1	12	0	15	27	0	0
3	61288028	.	T	C	16	9	25	0	1	26	0	0
3	61288105	.	C	A	16	13	29	0	1	30	0	0
3	61288238	.	A	C	20	14	34	0	0	34	0	0
3	61288469	.	T	G	13	2	15	0	23	38	0	0
3	61288639	.	C	G	2	2	4	0	0	4	0	0
3	61293028	.	A	G	1	2	3	0	0	3	0	0
3	61297154	.	C	T	1	1	2	0	0	2	0	0
3	61306994	.	C	T	3	2	5	0	0	5	0	0
3	61331755	.	A	G	1	1	2	0	0	2	0	0
3	61342120	.	G	A	1	4	5	0	1	6	0	0
3	61342225	.	G	A	6	2	8	0	1	9	0	0
3	61342368	.	T	C	1	7	8	0	1	9	0	0
3	61342387	.	G	A	1	7	8	0	1	9	0	0
3	61342423	.	G	C	2	8	10	0	3	13	0	0
3	61342770	.	G	A	6	6	12	0	1	13	0	0
3	61342891	.	A	G	1	8	9	0	0	9	0	0
3	61342942	.	T	C	2	3	5	0	0	5	0	0
3	61343076	.	C	T	3	6	9	0	0	9	0	0
3	61343224	.	C	T	1	5	6	0	0	6	0	0
3	61343339	.	A	T	2	3	5	0	0	5	0	0
3	61343509	.	C	T	1	5	6	0	4	10	0	0
3	61343589	.	T	C	1	3	4	0	0	4	0	0
3	61349602	.	G	A	5	7	12	0	0	12	0	0
3	61349654	.	C	T	4	4	8	0	0	8	0	0
3	61349887	.	A	T	5	8	13	0	0	13	0	0
3	61349931	.	G	T	7	4	11	0	0	11	0	0
3	61350156	.	A	G	2	3	5	0	0	5	0	0
3	61350238	.	A	G	1	2	3	0	0	3	0	0
3	61350529	.	T	A	3	5	8	0	0	8	0	0
3	61350600	.	T	C	0	5	5	0	0	5	0	0
3	61350673	.	T	G	1	3	4	0	0	4	0	0
3	61350700	.	C	T	2	1	3	0	0	3	0	0
3	61350787	.	A	T	1	4	5	0	0	5	0	0
3	61350788	.	T	G	1	4	5	0	0	5	0	0
3	61351691	.	C	G	1	4	5	0	0	5	0	0
3	61354072	.	A	T	2	0	2	0	0	2	0	0
3	61354108	.	C	A	0	2	2	0	0	2	0	0
3	61358662	.	C	A	6	2	8	0	1	9	0	0
3	61358682	.	T	C	6	2	8	0	0	8	0	0
3	61359027	.	A	T	1	2	3	0	0	3	0	0
3	61359266	.	G	T	2	2	4	0	0	4	0	0
3	61359713	.	C	A	0	5	5	0	1	6	0	0
3	61359849	.	C	T	2	2	4	0	0	4	0	0
3	61360125	.	T	C	4	4	8	0	2	10	0	0
3	61360127	.	C	T	7	3	10	0	0	10	0	0
3	61361306	.	T	C	2	3	5	0	2	7	0	0
3	61365135	.	G	A	7	3	10	1	0	11	0	0
3	61366070	.	T	G	1	3	4	0	0	4	0	0
3	61372168	.	T	C	3	3	6	0	0	6	0	0
3	61372328	.	G	A	0	2	2	0	0	2	0	0
3	61372342	.	T	G	0	1	1	0	0	1	0	0
3	61372627	.	T	A	2	2	4	0	1	5	0	0
3	61372898	.	T	C	2	1	3	0	3	6	0	0
3	61382682	.	C	T	0	4	4	4	1	9	0	0
3	61383062	.	A	T	1	1	2	0	0	2	0	0
3	61383072	.	C	T	0	2	2	0	1	3	0	0
3	61391953	.	C	A	5	12	17	0	0	17	0	0
3	61392048	.	A	G	3	0	3	0	4	7	0	0
3	61395211	.	G	A	0	1	1	0	2	3	0	0
3	61396868	.	A	T	4	3	7	0	0	7	0	0
3	61396891	.	C	A	6	3	9	0	0	9	0	0
3	61396911	.	C	T	6	2	8	0	0	8	0	0
3	61397093	.	C	T	1	6	7	0	0	7	0	0
3	61397141	.	G	T	9	4	13	0	0	13	0	0
3	61397231	.	C	A	4	6	10	0	0	10	0	0
3	61397248	.	A	G	8	0	8	0	6	14	0	0
3	61398326	.	A	G	6	3	9	0	1	10	0	0
3	61398505	.	C	G	4	5	9	0	0	9	0	0
3	61398728	.	A	G	7	6	13	0	0	13	0	0
3	61398835	.	G	A	3	7	10	0	3	13	0	0
3	61398839	.	T	C	5	8	13	0	0	13	0	0
3	61401662	.	T	G	3	3	6	0	0	6	0	0
3	61542631	.	A	C	1	3	4	0	0	4	0	0
3	61542663	.	G	A	0	3	3	0	1	4	0	0
3	61542700	.	C	T	1	4	5	0	0	5	0	0
3	61542889	.	C	A	1	3	4	0	0	4	0	0
3	61542910	.	C	T	1	2	3	0	0	3	0	0
3	61543130	.	G	A	1	2	3	0	0	3	0	0
3	61566380	.	T	C	3	0	3	0	2	5	0	0
3	61566559	.	G	A	4	2	6	0	0	6	0	0
3	61592775	.	T	C	3	0	3	0	2	5	0	0
3	61959393	.	T	C	0	1	1	0	0	1	0	0
3	62034943	.	G	A	5	4	9	0	0	9	0	0
3	62035030	.	G	A	0	5	5	0	2	7	0	0
3	62035861	.	C	T	3	3	6	0	1	7	0	0
3	62036047	.	G	A	0	4	4	0	4	8	0	0
3	62036426	.	G	A	3	3	6	0	0	6	0	0
3	62036570	.	G	A	4	6	10	0	0	10	0	0
3	62037105	.	T	C	7	6	13	0	0	13	0	0
3	62037343	.	G	C	7	4	11	0	0	11	0	0
3	62037716	.	G	A	3	5	8	0	0	8	0	0
3	62038739	.	G	C	7	11	18	0	0	18	0	0
3	62038993	.	G	A	0	7	7	0	14	21	0	0
3	62039278	.	A	G	9	1	10	0	9	19	0	0
3	62039657	.	G	A	0	9	9	0	10	19	0	0
3	62039689	.	C	A	4	12	16	0	0	16	0	0
3	62039718	.	G	A	4	9	13	0	1	14	0	0
3	62039813	.	T	A	14	4	18	0	1	19	0	0
3	62040555	.	G	A	4	6	10	0	0	10	0	0
3	62051107	.	C	T	13	5	18	0	1	19	0	0
3	62051125	.	C	T	12	3	15	0	0	15	0	0
3	62051395	.	A	G	3	7	10	0	1	11	0	0
3	62051660	.	T	A	9	6	15	0	0	15	0	0
3	62051731	.	G	A	7	4	11	0	0	11	0	0
3	62068866	.	A	G	3	5	8	0	0	8	0	0
3	62068871	.	A	G	3	4	7	0	0	7	0	0
3	62068902	.	C	T	0	1	1	0	2	3	0	0
3	62069739	.	G	T	5	0	5	0	0	5	0	0
3	62069815	.	G	A	3	6	9	0	1	10	0	0
3	62069821	.	G	A	4	5	9	0	0	9	0	0
3	62070762	.	T	C	0	1	1	0	0	1	0	0
3	62073967	.	T	A	0	3	3	0	0	3	0	0
3	62074030	.	T	C	5	11	16	0	0	16	0	0
3	62080117	.	G	C	7	9	16	0	1	17	0	0
3	62080172	.	G	A	4	9	13	0	0	13	0	0
3	62091398	.	A	G	2	5	7	0	0	7	0	0
3	62091632	.	T	A	10	7	17	0	1	18	0	0
3	62091660	.	T	A	8	8	16	0	0	16	0	0
3	62091880	.	C	T	11	10	21	0	0	21	0	0
3	62091975	.	C	A	18	9	27	0	0	27	0	0
3	62091995	.	G	T	17	7	24	0	2	26	0	0
3	62092025	.	C	T	0	7	7	0	18	25	0	0
3	62092262	.	T	A	7	11	18	0	0	18	0	0
3	62092279	.	A	T	3	9	12	0	1	13	0	0
3	62092666	.	G	A	9	6	15	0	0	15	0	0
3	62092715	.	A	C	7	14	21	0	0	21	0	0
3	62092749	.	G	C	6	10	16	0	0	16	0	0
3	62092801	.	C	T	10	10	20	0	1	21	0	0
3	62092902	.	A	T	8	5	13	0	0	13	0	0
3	62093241	.	T	A	11	17	28	0	2	30	0	0
3	62093955	.	T	A	1	3	4	0	0	4	0	0
3	62094327	.	C	T	7	6	13	0	1	14	0	0
3	62094645	.	A	G	2	8	10	0	1	11	0	0
3	62094849	.	A	G	6	8	14	0	0	14	0	0
3	62095051	.	G	A	2	7	9	0	0	9	0	0
3	62095175	.	T	A	3	8	11	0	0	11	0	0
3	62095397	.	T	C	2	14	16	0	0	16	0	0
3	62095404	.	C	T	3	13	16	0	0	17	1	0
3	62095572	.	T	A	3	3	6	0	0	6	0	0
3	62095573	.	G	T	3	3	6	0	0	6	0	0
3	62095734	.	G	A	2	3	5	0	0	5	0	0
3	62095980	.	A	C	3	2	5	0	0	5	0	0
3	62096288	.	A	T	1	2	3	0	0	3	0	0
3	62097300	.	A	T	4	2	6	0	1	7	0	0
3	62097490	.	A	T	5	7	12	0	2	14	0	0
3	62097548	.	A	T	1	5	6	0	0	6	0	0
3	62114615	.	C	T	0	2	2	0	4	6	0	0
3	62114663	.	C	T	3	2	5	0	0	5	0	0
3	62117154	.	C	T	0	0	0	0	1	1	0	0
3	62117187	.	C	T	2	2	4	0	0	4	0	0
3	62126986	.	C	T	1	1	2	0	0	2	0	0
3	62126992	.	T	A	1	2	3	0	0	3	0	0
3	62127190	.	G	A	3	0	3	0	1	4	0	0
3	62129751	.	T	C	6	1	7	0	0	7	0	0
3	62129754	.	G	A	6	1	7	0	0	7	0	0
3	62149774	.	C	T	1	3	4	0	0	4	0	0
3	62167715	.	G	T	0	2	2	0	0	2	0	0
3	62173443	.	A	T	3	3	6	0	0	6	0	0
3	62173503	.	G	T	8	5	13	0	0	13	0	0
3	62173546	.	C	T	4	7	11	0	1	12	0	0
3	62173593	.	T	C	3	6	9	0	0	9	0	0
3	62173628	.	T	C	5	6	11	0	0	11	0	0
3	62176426	.	T	C	3	0	3	0	3	6	0	0
3	62180788	.	G	A	2	6	8	0	0	8	0	0
3	62188877	.	A	G	1	1	2	0	0	2	0	0
3	62188883	.	G	A	1	1	2	0	0	2	0	0
3	62196977	.	C	T	0	1	1	0	0	1	0	0
3	62203509	.	G	A	5	6	11	0	1	12	0	0
3	62208736	.	A	G	4	2	6	0	0	6	0	0
3	62209183	.	A	G	5	0	5	0	8	13	0	0
3	62209216	.	A	G	4	8	12	0	0	12	0	0
3	62209325	.	A	G	3	2	5	0	0	5	0	0
3	62238692	.	G	A	4	2	6	0	0	6	0	0
3	62238721	.	C	T	4	2	6	0	1	7	0	0
3	62240421	.	A	T	4	2	6	0	0	6	0	0
3	62275155	.	T	C	0	4	4	0	0	4	0	0
3	62275415	.	T	A	2	5	7	0	0	7	0	0
3	62275507	.	T	A	6	3	9	0	0	9	0	0
3	62275598	.	G	A	4	3	7	0	1	8	0	0
3	62275667	.	A	G	2	0	2	0	3	5	0	0
3	62275855	.	G	C	1	2	3	0	0	3	0	0
3	62276009	.	A	T	2	4	6	0	0	6	0	0
3	62323165	.	T	C	6	5	11	0	1	12	0	0
3	62323384	.	G	A	6	2	8	0	0	8	0	0
3	62323648	.	G	A	5	3	8	0	0	8	0	0
3	62324030	.	C	T	1	2	3	0	0	3	0	0
3	62324063	.	A	T	5	3	8	0	1	9	0	0
3	62324109	.	G	A	0	3	3	0	8	11	0	0
3	62328846	.	G	C	0	1	1	0	0	1	0	0
3	62328938	.	A	C	2	3	5	2	0	7	0	0
3	62328970	.	A	G	4	3	7	0	0	7	0	0
3	62329097	.	G	C	6	6	12	0	1	13	0	0
3	62329199	.	A	G	2	0	2	0	4	6	0	0
3	62329545	.	G	T	2	8	10	0	0	10	0	0
3	62345471	.	A	T	2	6	8	0	0	8	0	0
3	62345588	.	T	A	0	5	5	0	0	5	0	0
3	62345686	.	T	A	1	6	7	0	0	7	0	0
3	62345770	.	A	T	5	7	12	0	0	12	0	0
3	62353679	.	G	T	1	7	8	0	0	8	0	0
3	62353952	.	G	A	3	1	4	0	1	5	0	0
3	62359440	.	G	T	3	0	3	0	0	3	0	0
3	62360484	.	C	T	6	6	12	0	0	12	0	0
3	62360686	.	G	A	1	2	3	0	0	3	0	0
3	62360736	.	C	A	5	4	9	0	0	9	0	0
3	62369864	.	G	A	11	22	33	0	1	34	0	0
3	62370068	.	A	G	11	9	20	0	0	20	0	0
3	62370381	.	A	G	5	15	20	0	0	20	0	0
3	62370476	.	G	A	8	5	13	0	0	13	0	0
3	62379739	.	C	T	9	3	12	0	0	12	0	0
3	62382863	.	A	G	33	34	67	0	1	68	0	0
3	62383314	.	T	G	40	11	51	0	1	52	0	0
3	62383315	.	G	T	39	12	51	0	1	52	0	0
3	62383438	.	G	A	22	40	62	0	0	62	0	0
3	62383439	.	A	G	22	38	60	0	2	62	0	0
3	62383565	.	T	A	29	23	52	0	1	53	0	0
3	62383589	.	A	C	22	19	41	0	4	45	0	0
3	62383610	.	G	C	17	1	18	0	20	38	0	0
3	62383706	.	C	T	27	20	47	0	3	50	0	0
3	62384055	.	G	A	8	9	17	1	1	19	0	0
3	62384208	.	C	T	1	43	44	0	13	57	0	0
3	62384219	.	G	A	41	7	48	0	6	54	0	0
3	62384423	.	C	G	34	27	61	0	1	62	0	0
3	62384428	.	T	A	29	30	59	0	3	62	0	0
3	62384565	.	C	G	27	22	49	0	2	51	0	0
3	62386420	.	T	C	28	0	28	0	24	52	0	0
3	62386955	.	G	T	2	5	7	0	0	7	0	0
3	62387141	.	C	T	0	9	9	0	11	20	0	0
3	62387144	.	C	T	11	10	21	0	0	21	0	0
3	62390349	.	A	G	2	3	5	0	0	5	0	0
3	62393297	.	T	C	22	8	30	0	5	35	0	0
3	62393321	.	G	A	24	10	34	0	1	35	0	0
3	62393337	.	C	T	28	9	37	0	1	38	0	0
3	62399218	.	C	T	0	0	0	0	2	2	0	0
3	62399310	.	T	C	1	4	5	0	0	5	0	0
3	62399314	.	A	C	1	3	4	0	0	4	0	0
3	62433064	.	C	T	12	6	18	0	0	18	0	0
3	62433138	.	T	G	0	1	1	0	0	1	0	0
3	62521137	.	G	A	5	2	7	0	1	8	0	0
3	62521142	.	T	C	5	1	6	0	4	10	0	0
3	62521263	.	T	A	14	12	26	0	1	27	0	0
3	62521956	.	G	A	8	10	18	0	1	19	0	0
3	62522063	.	A	T	7	9	16	0	2	18	0	0
3	62522065	.	G	T	6	10	16	0	2	18	0	0
3	62522238	.	A	G	3	8	11	0	0	11	0	0
3	62522804	.	C	T	0	7	7	0	8	15	0	0
3	62522808	.	C	T	3	7	10	0	5	15	0	0
3	62522899	.	C	G	11	8	19	0	1	20	0	0
3	62523031	.	A	G	0	2	2	0	1	3	0	0
3	62523032	.	A	T	3	0	3	0	0	3	0	0
3	62523325	.	G	T	13	7	20	0	1	21	0	0
3	62523502	.	G	A	6	4	10	0	0	10	0	0
3	62523550	.	C	T	4	9	13	0	0	13	0	0
3	62527397	.	G	T	3	3	6	0	0	6	0	0
3	62527533	.	C	A	1	2	3	0	0	4	1	0
4	233812	.	T	C	2	6	8	0	1	9	0	0
4	316946	.	A	T	15	28	43	0	0	44	1	0
4	317091	.	A	G	9	24	33	0	1	34	0	0
4	317217	.	T	A	12	15	27	0	0	27	0	0
4	317275	.	G	T	11	13	24	0	0	24	0	0
4	317938	.	G	A	6	4	10	0	1	11	0	0
4	325126	.	G	A	2	6	8	0	0	8	0	0
4	325136	.	G	A	4	8	12	0	0	12	0	0
4	325161	.	A	C	9	0	9	0	7	16	0	0
4	343328	.	T	C	2	0	2	0	1	3	0	0
4	348201	.	G	A	0	2	2	0	3	5	0	0
4	348216	.	C	T	3	3	6	0	0	6	0	0
4	348297	.	T	C	5	7	12	0	0	12	0	0
4	349490	.	A	C	1	6	7	0	1	8	0	0
4	349514	.	T	C	2	5	7	0	0	7	0	0
4	349886	.	T	C	0	1	1	0	0	1	0	0
4	350652	.	C	T	1	1	2	0	1	3	0	0
4	350832	.	G	A	3	3	6	0	1	7	0	0
4	351840	.	G	C	2	3	5	0	0	5	0	0
4	351845	.	A	C	1	3	4	0	0	5	1	0
4	352284	.	A	G	6	0	6	0	6	12	0	0
4	352289	.	T	C	6	6	12	0	0	12	0	0
4	352504	.	T	C	9	8	17	0	0	17	0	0
4	353049	.	A	T	6	3	9	0	0	9	0	0
4	353064	.	C	G	5	3	8	0	0	8	0	0
4	353238	.	T	G	8	0	8	0	4	12	0	0
4	353247	.	T	C	7	3	10	0	0	10	0	0
4	353379	.	A	T	4	9	13	0	4	17	0	0
4	353638	.	C	T	1	1	2	0	0	2	0	0
4	353778	.	T	A	5	4	9	0	1	10	0	0
4	357887	.	T	G	8	6	14	0	0	14	0	0
4	358080	.	T	C	1	0	1	0	0	1	0	0
4	362282	.	C	T	5	1	6	0	1	7	0	0
4	385092	.	C	T	10	14	24	0	5	29	0	0
4	385576	.	T	A	2	1	3	0	1	4	0	0
4	385668	.	G	A	11	3	14	0	0	14	0	0
4	385710	.	T	C	12	9	21	0	0	21	0	0
4	386537	.	T	A	10	13	23	0	1	24	0	0
4	386538	.	T	A	12	13	25	0	0	25	0	0
4	386839	.	A	G	21	1	22	0	4	26	0	0
4	394020	.	T	C	17	14	31	0	2	33	0	0
4	397913	.	A	G	3	5	8	0	0	8	0	0
4	397974	.	G	T	5	2	7	0	1	8	0	0
4	647752	.	G	T	1	1	2	0	0	2	0	0
4	659276	.	C	T	6	6	12	0	0	12	0	0
4	659345	.	T	C	0	1	1	0	0	1	0	0
4	660571	.	G	A	5	5	10	0	1	11	0	0
4	660649	.	T	A	7	12	19	0	0	19	0	0
4	660655	.	G	A	0	10	10	0	8	18	0	0
4	660715	.	T	C	9	4	13	0	2	15	0	0
4	667358	.	T	C	6	4	10	0	0	10	0	0
4	667382	.	A	G	9	0	9	0	5	14	0	0
4	674838	.	T	C	8	5	13	0	0	13	0	0
4	675080	.	T	C	6	4	10	0	0	10	0	0
4	676885	.	A	G	7	4	11	0	0	11	0	0
4	676942	.	A	G	1	1	2	0	0	2	0	0
4	678853	.	C	T	5	3	8	0	0	8	0	0
4	679441	.	C	G	0	7	7	0	11	18	0	0
4	680314	.	G	T	8	5	13	0	1	14	0	0
4	680320	.	C	T	9	5	14	0	1	15	0	0
4	680359	.	C	T	6	2	8	0	0	8	0	0
4	680395	.	T	C	1	0	1	0	1	2	0	0
4	680404	.	G	A	1	0	1	0	0	1	0	0
4	681595	.	G	A	6	6	12	0	0	12	0	0
4	686987	.	G	A	0	2	2	0	4	6	0	0
4	686999	.	C	G	5	5	10	0	0	10	0	0
4	687083	.	A	G	3	0	3	0	1	4	0	0
4	694254	.	T	C	2	5	7	0	0	7	0	0
4	694680	.	A	C	10	10	20	0	0	20	0	0
4	694718	.	G	A	2	5	7	0	2	9	0	0
4	694741	.	T	G	0	2	2	0	1	3	0	0
4	700281	.	A	C	10	8	18	0	0	18	0	0
4	700284	.	G	T	1	8	9	0	10	19	0	0
4	700563	.	G	T	6	2	8	0	2	10	0	0
4	700569	.	G	A	0	3	3	0	6	9	0	0
4	700598	.	A	T	3	5	8	0	0	8	0	0
4	700606	.	T	C	3	4	7	0	0	7	0	0
4	700634	.	A	C	1	3	4	0	0	4	0	0
4	702061	.	C	G	3	5	8	0	1	9	0	0
4	702130	.	G	A	0	1	1	0	0	1	0	0
4	736442	.	A	G	4	7	11	0	1	12	0	0
4	737636	.	A	T	4	3	7	0	0	7	0	0
4	737883	.	T	A	1	2	3	0	0	3	0	0
4	737927	.	T	G	1	1	2	0	0	2	0	0
4	740435	.	A	T	2	0	2	0	0	2	0	0
4	740921	.	T	C	10	5	15	0	0	15	0	0
4	740965	.	T	G	8	2	10	0	0	10	0	0
4	749803	.	G	A	16	9	25	0	0	25	0	0
4	749989	.	G	T	12	6	18	0	0	18	0	0
4	750016	.	T	C	5	0	5	0	2	7	0	0
4	750526	.	C	G	3	1	4	0	0	4	0	0
4	750531	.	C	T	4	1	5	0	0	5	0	0
4	750661	.	C	T	0	4	4	0	4	8	0	0
4	751275	.	A	G	2	4	6	0	1	7	0	0
4	751546	.	G	A	8	8	16	0	0	16	0	0
4	751553	.	C	T	9	8	17	0	1	18	0	0
4	751640	.	T	G	6	11	17	0	0	17	0	0
4	755539	.	C	T	9	6	15	0	0	15	0	0
4	757405	.	C	T	0	1	1	0	0	1	0	0
4	765112	.	A	G	7	13	20	0	0	20	0	0
4	766575	.	G	A	8	4	12	0	0	12	0	0
4	766588	.	G	A	7	7	14	0	1	15	0	0
4	766613	.	A	C	8	9	17	0	1	18	0	0
4	769533	.	A	T	2	0	2	0	0	2	0	0
4	772363	.	C	T	5	4	9	0	0	9	0	0
4	776550	.	G	T	1	1	2	0	0	2	0	0
4	777976	.	A	G	1	3	4	0	1	5	0	0
4	778111	.	G	A	5	3	8	0	0	8	0	0
4	779310	.	G	A	2	1	3	0	0	3	0	0
4	779363	.	T	C	4	0	4	0	8	12	0	0
4	779429	.	A	G	8	11	19	0	1	20	0	0
4	779442	.	G	A	9	13	22	0	0	22	0	0
4	779523	.	T	C	1	4	5	0	1	6	0	0
4	779539	.	C	A	0	2	2	0	0	2	0	0
4	783816	.	G	T	18	16	34	0	0	34	0	0
4	783835	.	A	G	21	13	34	0	2	36	0	0
4	784002	.	T	A	24	12	36	0	0	36	0	0
4	784177	.	T	C	22	24	46	0	2	48	0	0
4	784325	.	A	T	13	12	25	0	1	26	0	0
4	784373	.	T	A	4	9	13	0	1	14	0	0
4	784543	.	A	C	1	1	2	0	1	3	0	0
4	784558	.	G	A	4	3	7	0	0	7	0	0
4	784642	.	G	A	7	5	12	0	0	12	0	0
4	784733	.	T	A	5	5	10	0	1	11	0	0
4	784854	.	C	A	8	5	13	0	0	13	0	0
4	784990	.	T	A	12	18	30	0	2	32	0	0
4	785011	.	T	C	13	6	19	0	3	22	0	0
4	785132	.	G	A	19	22	41	0	3	44	0	0
4	788970	.	G	C	3	0	3	0	18	21	0	0
4	789589	.	A	G	10	12	22	0	0	22	0	0
4	798743	.	G	C	1	4	5	0	0	5	0	0
4	798804	.	G	A	8	10	18	0	1	19	0	0
4	798850	.	A	C	12	15	27	0	1	28	0	0
4	798861	.	G	T	13	14	27	0	1	28	0	0
4	799006	.	G	T	20	13	33	0	1	34	0	0
4	799090	.	T	C	16	11	27	0	0	27	0	0
4	799127	.	T	G	13	13	26	0	1	27	0	0
4	799245	.	G	A	16	10	26	0	0	26	0	0
4	799475	.	A	G	10	11	21	0	0	21	0	0
4	799513	.	G	A	13	15	28	0	2	30	0	0
4	799620	.	C	T	26	10	36	0	0	36	0	0
4	799643	.	T	A	25	10	35	0	4	39	0	0
4	799933	.	C	T	27	17	44	0	0	44	0	0
4	800027	.	C	T	17	12	29	0	0	29	0	0
4	800094	.	A	G	20	12	32	0	0	32	0	0
4	800113	.	A	G	18	15	33	0	4	37	0	0
4	800363	.	C	T	0	20	20	0	18	38	0	0
4	800520	.	T	C	11	8	19	0	0	19	0	0
4	802909	.	T	A	8	12	20	0	1	21	0	0
4	803862	.	T	C	4	0	4	0	5	9	0	0
4	806319	.	G	A	3	5	8	0	0	8	0	0
4	806322	.	T	C	3	5	8	0	0	8	0	0
4	807895	.	C	G	6	3	9	0	2	11	0	0
4	807898	.	A	G	3	4	7	0	4	11	0	0
4	808031	.	C	T	0	2	2	0	0	2	0	0
4	808421	.	A	G	1	0	1	0	0	1	0	0
4	809456	.	A	G	9	11	20	0	0	20	0	0
4	809512	.	T	C	16	0	16	0	21	37	0	0
4	809549	.	A	G	6	12	18	0	1	19	0	0
4	813157	.	G	A	10	7	17	0	0	17	0	0
4	813226	.	A	G	7	15	22	0	1	23	0	0
4	819178	.	C	G	0	2	2	0	0	2	0	0
4	819412	.	A	G	1	3	4	0	0	4	0	0
4	824032	.	C	A	1	1	2	0	0	2	0	0
4	824040	.	C	G	1	2	3	0	0	3	0	0
4	824428	.	A	G	1	2	3	0	0	3	0	0
4	844545	.	C	A	0	3	3	0	0	3	0	0
4	844547	.	T	C	0	3	3	0	0	3	0	0
4	844745	.	A	G	5	3	8	0	0	8	0	0
4	862009	.	A	G	6	3	9	0	0	9	0	0
4	867601	.	G	C	0	2	2	0	0	2	0	0
4	870833	.	C	T	0	2	2	0	4	6	0	0
4	872296	.	T	C	0	0	0	0	1	1	0	0
4	874241	.	G	T	1	2	3	0	0	3	0	0
4	874323	.	C	T	2	1	3	0	0	3	0	0
4	880201	.	A	C	0	2	2	0	0	2	0	0
4	880275	.	A	G	2	3	5	0	0	5	0	0
4	880286	.	C	T	2	2	4	0	0	4	0	0
4	880318	.	G	T	2	2	4	0	0	4	0	0
4	880323	.	C	G	2	2	4	0	0	4	0	0
4	880934	.	A	C	1	0	1	0	2	3	0	0
4	881180	.	G	A	4	2	6	0	0	6	0	0
4	881980	.	T	A	1	2	3	0	0	3	0	0
4	881997	.	A	C	1	2	3	0	0	3	0	0
4	882294	.	A	T	2	2	4	0	0	4	0	0
4	882808	.	C	T	1	2	3	0	1	4	0	0
4	883709	.	C	T	1	2	3	0	1	4	0	0
4	883729	.	A	G	2	4	6	0	0	6	0	0
4	883760	.	T	C	2	0	2	0	4	6	0	0
4	905612	.	G	A	1	5	6	0	0	6	0	0
4	905657	.	A	G	2	4	6	0	0	6	0	0
4	958978	.	A	T	2	4	6	0	0	6	0	0
4	959015	.	T	C	6	2	8	0	0	8	0	0
4	961542	.	G	A	3	3	6	0	0	6	0	0
4	963452	.	A	G	1	1	2	0	0	2	0	0
4	965124	.	C	G	0	4	4	0	3	7	0	0
4	967974	.	C	T	2	2	4	0	0	4	0	0
4	968001	.	G	A	0	5	5	0	3	8	0	0
4	968121	.	T	C	0	1	1	0	0	1	0	0
4	969475	.	A	T	0	1	1	0	0	1	0	0
4	969486	.	T	G	0	0	0	0	2	2	0	0
4	970689	.	A	G	6	0	6	0	4	10	0	0
4	971842	.	G	C	0	2	2	0	1	3	0	0
4	974465	.	A	T	0	4	4	0	0	4	0	0
4	974482	.	C	T	5	4	9	0	0	9	0	0
4	975735	.	G	C	0	0	0	0	3	3	0	0
4	975758	.	C	T	5	7	12	0	0	12	0	0
4	975792	.	G	C	0	8	8	0	10	18	0	0
4	982892	.	G	A	3	5	8	0	0	8	0	0
4	982893	.	T	C	5	3	8	0	0	8	0	0
4	982938	.	C	G	3	4	7	0	2	9	0	0
4	982958	.	A	G	2	3	5	0	1	6	0	0
4	986133	.	A	G	2	2	4	0	0	4	0	0
4	986210	.	T	C	3	2	5	0	0	5	0	0
4	986350	.	C	A	0	3	3	0	2	5	0	0
4	1054775	.	G	A	11	14	25	0	4	29	0	0
4	1054866	.	G	T	27	2	29	0	7	36	0	0
4	1054868	.	G	A	29	2	31	0	5	36	0	0
4	1055081	.	C	T	34	7	41	0	2	43	0	0
4	1055095	.	T	A	25	10	35	0	5	40	0	0
4	1055149	.	A	G	15	9	24	0	1	25	0	0
4	1055200	.	A	G	11	4	15	0	1	16	0	0
4	1055724	.	C	T	18	22	40	0	3	43	0	0
4	1055770	.	A	G	30	16	46	0	0	46	0	0
4	1146384	.	T	C	3	3	6	0	0	6	0	0
4	1146466	.	G	C	1	2	3	0	0	3	0	0
4	1283605	.	A	G	2	0	2	0	3	5	0	0
4	1283626	.	T	C	4	4	8	0	0	8	0	0
4	1283707	.	C	T	2	4	6	0	0	6	0	0
4	1284013	.	C	A	4	3	7	0	1	8	0	0
4	1301582	.	G	A	1	5	6	0	0	6	0	0
4	1301848	.	G	A	3	3	6	0	0	6	0	0
4	1301866	.	A	T	4	5	9	0	0	9	0	0
4	1301921	.	T	C	3	0	3	0	4	7	0	0
4	1302059	.	T	C	5	0	5	0	3	8	0	0
4	1302155	.	A	G	2	10	12	0	0	12	0	0
4	1302198	.	G	A	5	0	5	0	0	5	0	0
4	1302219	.	G	T	3	1	4	0	1	5	0	0
4	1302385	.	G	A	4	4	8	0	0	8	0	0
4	1302401	.	G	A	3	4	7	0	0	7	0	0
4	1302437	.	A	G	7	6	13	0	0	13	0	0
4	1302485	.	T	C	5	0	5	0	9	14	0	0
4	1302488	.	T	C	5	0	5	0	9	14	0	0
4	1302584	.	A	G	3	3	6	1	0	7	0	0
4	1302702	.	C	A	5	7	12	0	0	12	0	0
4	1302785	.	C	T	1	5	6	0	3	9	0	0
4	1303044	.	C	T	2	3	5	0	0	5	0	0
4	1389106	.	C	T	7	12	19	0	0	19	0	0
4	1390851	.	T	C	16	1	17	0	19	36	0	0
4	1390926	.	C	T	6	10	16	0	2	18	0	0
4	1390932	.	T	C	6	10	16	0	0	16	0	0
4	1392957	.	G	A	9	10	19	0	1	20	0	0
4	1393032	.	T	A	5	8	13	0	0	13	0	0
4	1393062	.	A	G	3	6	9	0	0	9	0	0
4	1396176	.	C	T	1	2	3	0	0	3	0	0
4	1469393	.	T	C	2	0	2	0	3	5	0	0
4	1469839	.	A	T	2	4	6	0	1	7	0	0
4	1469872	.	A	G	5	2	7	0	1	8	0	0
4	1470380	.	C	A	22	7	29	0	0	29	0	0
4	1477538	.	A	G	11	3	14	0	1	15	0	0
4	1479855	.	C	A	2	2	4	0	0	4	0	0
4	1547304	.	G	C	1	3	4	0	0	4	0	0
4	1564041	.	T	C	1	2	3	0	0	3	0	0
4	1565059	.	T	G	1	2	3	0	0	3	0	0
4	1565587	.	G	A	9	5	14	0	1	15	0	0
4	1565673	.	T	C	6	3	9	0	0	9	0	0
4	1566427	.	C	A	7	6	13	0	0	13	0	0
4	1566501	.	T	C	4	2	6	0	0	6	0	0
4	1566502	.	T	G	2	0	2	0	4	6	0	0
4	1639944	.	T	C	4	6	10	0	0	10	0	0
4	1834169	.	C	G	3	6	9	0	0	9	0	0
4	1834190	.	G	A	2	2	4	0	0	4	0	0
4	1835801	.	C	T	1	1	2	0	0	2	0	0
4	1835950	.	G	T	3	1	4	0	0	4	0	0
4	1837647	.	A	T	6	2	8	0	0	8	0	0
4	1839142	.	T	C	6	4	10	0	0	10	0	0
4	1988669	.	G	A	1	6	7	0	0	7	0	0
4	1988856	.	T	C	4	0	4	0	5	9	0	0
4	1989101	.	T	C	2	0	2	0	6	8	0	0
4	1989156	.	T	C	4	2	6	0	0	6	0	0
4	1994560	.	A	T	1	3	4	0	0	4	0	0
4	1997528	.	C	T	0	5	5	0	3	8	0	0
4	2036617	.	C	A	0	1	1	0	2	3	0	0
4	2044213	.	A	G	8	14	22	0	0	22	0	0
4	2044432	.	G	T	13	12	25	1	1	27	0	0
4	2044517	.	A	G	13	20	33	0	1	34	0	0
4	2044721	.	A	C	5	3	8	0	0	8	0	0
4	2044904	.	T	G	3	3	6	0	0	6	0	0
4	2044944	.	T	A	2	3	5	0	0	5	0	0
4	2051223	.	C	G	0	0	0	0	1	1	0	0
4	2051248	.	C	T	1	0	1	0	0	1	0	0
4	2051447	.	A	G	3	4	7	0	0	7	0	0
4	2055067	.	C	A	4	4	8	0	7	15	0	0
4	2055103	.	G	T	4	4	8	0	0	8	0	0
4	2055118	.	T	A	3	4	7	0	1	8	0	0
4	2055265	.	G	A	10	11	21	0	5	26	0	0
4	2055318	.	G	A	8	8	16	0	2	18	0	0
4	2056028	.	G	A	16	17	33	0	0	33	0	0
4	2059765	.	C	A	7	8	15	0	0	15	0	0
4	2059801	.	T	A	14	9	23	0	1	24	0	0
4	2059831	.	C	G	18	11	29	0	0	29	0	0
4	2059846	.	A	T	12	10	22	0	3	25	0	0
4	2060125	.	T	C	2	3	5	0	0	5	0	0
4	2060134	.	C	T	2	1	3	0	0	3	0	0
4	2061214	.	G	A	4	4	8	0	0	8	0	0
4	2062085	.	A	G	5	3	8	0	0	8	0	0
4	2062133	.	G	A	6	4	10	0	1	11	0	0
4	2062237	.	T	A	7	9	16	0	0	16	0	0
4	2151743	.	G	A	4	6	10	0	0	10	0	0
4	2160995	.	G	A	4	1	5	0	1	6	0	0
4	2162664	.	T	G	8	4	12	0	0	12	0	0
4	2162726	.	C	G	1	8	9	0	6	15	0	0
4	2162798	.	G	A	10	5	15	0	2	17	0	0
4	2162804	.	A	G	12	7	19	0	0	19	0	0
4	2163383	.	T	C	8	0	8	0	3	11	0	0
4	2163521	.	A	G	3	1	4	0	0	4	0	0
4	2260515	.	T	C	1	0	1	0	2	3	0	0
4	2349386	.	G	A	8	8	16	0	0	16	0	0
4	2349391	.	C	T	5	8	13	0	1	14	0	0
4	2349527	.	A	G	11	9	20	0	0	20	0	0
4	2349542	.	A	T	11	6	17	0	0	17	0	0
4	2349576	.	A	C	7	9	16	0	0	16	0	0
4	2349656	.	T	C	3	3	6	0	1	7	0	0
4	2349798	.	G	A	8	12	20	0	1	21	0	0
4	2349805	.	G	T	10	10	20	0	0	20	0	0
4	2361733	.	G	A	2	5	7	0	0	7	0	0
4	2361835	.	T	C	7	0	7	0	3	10	0	0
4	2362945	.	C	A	1	17	18	0	11	29	0	0
4	2396616	.	C	T	0	1	1	0	0	1	0	0
4	2404782	.	T	G	1	0	1	0	0	1	0	0
4	2404785	.	G	A	1	0	1	0	0	1	0	0
4	2404872	.	A	G	6	4	10	0	0	10	0	0
4	2412025	.	A	G	0	2	2	0	0	2	0	0
4	2497044	.	T	C	3	4	7	0	0	7	0	0
4	3338195	.	A	G	1	3	4	0	0	4	0	0
4	3338219	.	A	G	2	0	2	0	2	4	0	0
4	3474618	.	A	G	2	4	6	0	1	7	0	0
4	3474718	.	A	G	3	2	5	0	0	5	0	0
4	3474744	.	A	G	0	3	3	0	0	3	0	0
4	4079716	.	T	C	1	2	3	0	0	3	0	0
4	4090438	.	C	T	2	0	2	0	0	2	0	0
4	4098479	.	T	A	1	3	4	0	0	4	0	0
4	4104264	.	A	G	1	0	1	0	4	5	0	0
4	4106546	.	T	G	5	5	10	0	4	14	0	0
4	4111070	.	A	G	7	3	10	0	4	14	0	0
4	4111180	.	C	T	2	6	8	0	0	8	0	0
4	4111396	.	T	C	5	13	18	0	0	18	0	0
4	4117174	.	A	C	1	6	7	0	2	9	0	0
4	4117730	.	T	C	2	0	2	0	2	4	0	0
4	4117876	.	G	A	1	2	3	0	0	3	0	0
4	4118119	.	C	A	0	3	3	0	1	4	0	0
4	4119065	.	C	T	0	3	3	0	1	4	0	0
4	4120854	.	C	T	1	1	2	0	0	2	0	0
4	4120872	.	A	G	1	2	3	0	0	3	0	0
4	4122577	.	G	A	1	2	3	0	0	3	0	0
4	4122652	.	C	T	1	2	3	0	0	3	0	0
4	4233088	.	T	C	2	2	4	0	0	4	0	0
4	4235162	.	A	G	19	18	37	0	2	39	0	0
4	4238175	.	C	T	0	3	3	0	5	8	0	0
4	4240177	.	T	C	5	4	9	0	0	9	0	0
4	4243084	.	G	A	9	9	18	0	1	19	0	0
4	4249690	.	G	A	1	2	3	0	0	3	0	0
4	4258884	.	A	G	1	3	4	0	1	5	0	0
4	4258927	.	T	C	6	14	20	0	1	21	0	0
4	4258951	.	C	T	8	17	25	0	4	29	0	0
4	4327793	.	C	T	2	2	4	0	0	4	0	0
4	4331151	.	C	T	1	2	3	0	0	3	0	0
4	4348785	.	C	T	5	5	10	0	0	10	0	0
4	4348902	.	A	G	1	0	1	0	1	2	0	0
4	4355714	.	C	T	5	7	12	0	0	12	0	0
4	4355791	.	G	T	0	6	6	0	7	13	0	0
4	4357073	.	A	G	3	13	16	0	3	19	0	0
4	4357173	.	C	T	7	9	16	0	0	16	0	0
4	4357175	.	G	A	7	9	16	0	0	16	0	0
4	4358288	.	C	A	11	4	15	3	1	19	0	0
4	4358292	.	C	T	12	6	18	3	0	21	0	0
4	4358471	.	C	T	8	8	16	0	0	16	0	0
4	4358610	.	C	A	9	8	17	1	0	18	0	0
4	4484788	.	A	G	11	13	24	0	0	24	0	0
4	4484914	.	T	A	20	19	39	0	2	41	0	0
4	4485186	.	A	T	22	19	41	0	6	47	0	0
4	4485247	.	A	T	15	24	39	0	1	40	0	0
4	4485306	.	T	C	18	12	30	0	1	31	0	0
4	4485534	.	C	A	21	20	41	0	0	41	0	0
4	4485650	.	A	T	7	16	23	0	1	24	0	0
4	4485736	.	T	G	14	12	26	0	0	26	0	0
4	4485793	.	C	G	13	9	22	0	0	22	0	0
4	4488137	.	A	G	8	6	14	0	1	15	0	0
4	4488207	.	G	A	15	8	23	0	2	25	0	0
4	4491740	.	T	C	3	0	3	0	3	6	0	0
4	4491782	.	T	C	3	0	3	0	2	5	0	0
4	4492003	.	C	T	6	3	9	0	2	11	0	0
4	4492336	.	A	G	5	4	9	0	1	10	0	0
4	4492369	.	C	A	0	9	9	0	5	14	0	0
4	4492444	.	A	G	2	7	9	0	0	9	0	0
4	4492456	.	T	C	2	0	2	0	5	7	0	0
4	4494733	.	C	A	3	1	4	0	0	4	0	0
4	4510097	.	A	G	4	0	4	0	3	7	0	0
4	4514215	.	A	G	11	0	11	0	6	17	0	0
4	4516310	.	G	C	0	9	9	0	17	26	0	0
4	4516313	.	A	G	14	0	14	0	12	26	0	0
4	4519688	.	G	A	7	6	13	0	0	13	0	0
4	4519697	.	T	C	5	5	10	0	0	10	0	0
4	4523403	.	C	G	12	18	30	0	1	31	0	0
4	4523579	.	T	C	15	34	49	0	1	50	0	0
4	4523885	.	A	C	16	17	33	0	0	33	0	0
4	4524215	.	T	A	3	6	9	0	0	9	0	0
4	4635691	.	C	G	10	16	26	0	0	26	0	0
4	4640605	.	G	A	14	10	24	0	0	24	0	0
4	4640614	.	G	A	14	9	23	0	1	24	0	0
4	4647977	.	A	G	12	9	21	0	0	21	0	0
4	4653380	.	A	C	3	0	3	0	0	3	0	0
4	4657961	.	G	A	1	2	3	0	0	3	0	0
4	4706687	.	G	T	0	1	1	0	0	1	0	0
4	4706819	.	C	T	0	8	8	0	14	22	0	0
4	4706825	.	C	G	10	11	21	0	1	22	0	0
4	4712951	.	G	A	4	2	6	0	0	6	0	0
4	4713042	.	T	G	1	3	4	0	0	4	0	0
4	4713899	.	T	G	2	2	4	0	0	4	0	0
4	4713962	.	T	A	2	2	4	0	0	4	0	0
4	4714338	.	A	T	1	2	3	0	0	3	0	0
4	4714358	.	C	T	0	1	1	0	3	4	0	0
4	4714402	.	A	G	1	3	4	0	0	4	0	0
4	4714590	.	T	C	1	0	1	0	2	3	0	0
4	4753372	.	T	A	0	1	1	0	0	1	0	0
4	4754474	.	A	G	4	5	9	0	1	10	0	0
4	4758089	.	G	A	2	3	5	0	1	6	0	0
4	4758291	.	C	A	1	2	3	0	0	3	0	0
4	4758452	.	T	C	3	0	3	0	2	5	0	0
4	4758458	.	A	G	3	2	5	0	0	5	0	0
4	4760581	.	C	T	2	2	4	0	0	4	0	0
4	4762804	.	T	A	1	1	2	0	0	2	0	0
4	4780448	.	C	T	3	3	6	0	0	6	0	0
4	4782962	.	A	C	0	4	4	0	0	4	0	0
4	4783059	.	A	T	6	4	10	0	2	12	0	0
4	4783067	.	C	T	6	6	12	0	1	13	0	0
4	4784802	.	G	A	5	3	8	0	1	9	0	0
4	4786350	.	A	G	3	2	5	0	0	5	0	0
4	4786383	.	G	A	3	4	7	0	1	8	0	0
4	4786443	.	A	C	4	0	4	0	6	10	0	0
4	4831660	.	G	A	3	4	7	0	1	8	0	0
4	4831722	.	A	C	4	2	6	0	0	6	0	0
4	4831885	.	A	C	3	2	5	0	0	5	0	0
4	4831898	.	T	C	2	4	6	0	1	7	0	0
4	4831968	.	A	C	2	4	6	0	0	6	0	0
4	4832110	.	C	G	1	0	1	0	3	4	0	0
4	4832241	.	A	G	4	6	10	0	1	11	0	0
4	4834125	.	G	A	3	1	4	0	0	4	0	0
4	4834497	.	A	G	12	8	20	0	1	21	0	0
4	4834526	.	T	C	10	5	15	0	0	15	0	0
4	4894486	.	C	A	4	2	6	0	0	6	0	0
4	4902137	.	A	C	2	2	4	0	2	6	0	0
4	4902425	.	G	C	10	9	19	0	1	20	0	0
4	4911071	.	C	T	3	3	6	0	0	6	0	0
4	4911247	.	A	G	2	3	5	0	0	5	0	0
4	4913422	.	C	T	10	0	10	0	0	10	0	0
4	4914832	.	A	G	4	10	14	0	0	14	0	0
4	4921733	.	T	C	5	10	15	0	1	16	0	0
4	4921773	.	G	A	0	3	3	0	2	5	0	0
4	4923290	.	A	T	13	7	20	0	0	20	0	0
4	4923323	.	C	T	4	3	7	0	0	7	0	0
4	4923755	.	T	G	5	9	14	0	0	14	0	0
4	4925611	.	C	T	5	2	7	0	0	7	0	0
4	4926035	.	G	A	6	9	15	0	0	15	0	0
4	4926037	.	G	T	9	6	15	0	0	15	0	0
4	4971354	.	C	A	8	5	13	0	0	13	0	0
4	4971836	.	T	C	2	2	4	0	0	4	0	0
4	4971847	.	T	A	3	2	5	0	0	5	0	0
4	4971911	.	G	T	1	5	6	0	1	7	0	0
4	4971947	.	A	G	5	0	5	0	0	5	0	0
4	4972056	.	C	T	6	9	15	0	0	15	0	0
4	4972533	.	G	A	14	11	25	0	0	25	0	0
4	4972555	.	G	C	11	10	21	0	1	22	0	0
4	4973053	.	G	A	8	6	14	0	0	14	0	0
4	4975329	.	C	G	2	2	4	0	0	4	0	0
4	4980443	.	G	A	1	4	5	0	0	5	0	0
4	4980458	.	C	T	0	5	5	0	1	6	0	0
4	4983209	.	T	C	0	1	1	0	0	1	0	0
4	4985789	.	G	A	2	3	5	0	0	5	0	0
4	4992114	.	A	C	1	3	4	0	0	4	0	0
4	5006535	.	T	C	0	1	1	0	0	1	0	0
4	5006562	.	G	T	0	1	1	0	0	1	0	0
4	5025964	.	G	C	16	11	27	0	2	29	0	0
4	5026355	.	T	C	4	6	10	0	0	10	0	0
4	5042689	.	T	A	0	2	2	0	0	2	0	0
4	5042755	.	C	T	9	8	17	0	0	17	0	0
4	5048903	.	C	T	6	5	11	0	0	11	0	0
4	5094237	.	C	T	4	3	7	0	0	7	0	0
4	5097421	.	C	T	0	1	1	0	0	1	0	0
4	5098152	.	G	A	1	5	6	0	1	7	0	0
4	5098507	.	A	G	1	2	3	0	0	3	0	0
4	5102316	.	A	C	4	0	4	0	4	8	0	0
4	5104859	.	G	A	1	4	5	0	2	7	0	0
4	5158749	.	C	T	3	2	5	0	0	5	0	0
4	5161241	.	G	T	2	3	5	0	0	5	0	0
4	5161256	.	A	C	5	5	10	0	0	10	0	0
4	5240203	.	A	C	24	2	26	0	18	44	0	0
4	5240265	.	C	T	27	22	49	1	0	50	0	0
4	5240472	.	T	A	28	24	52	0	4	56	0	0
4	5240505	.	A	G	16	32	48	0	4	52	0	0
4	5242055	.	T	G	3	12	15	0	0	15	0	0
4	5242300	.	C	G	8	2	10	0	0	10	0	0
4	5243657	.	C	A	1	4	5	0	0	5	0	0
4	5244568	.	C	A	2	2	4	0	0	4	0	0
4	5244789	.	G	A	0	1	1	0	0	1	0	0
4	5247107	.	G	A	23	25	48	0	1	49	0	0
4	5247127	.	G	C	28	25	53	0	2	55	0	0
4	5247145	.	C	T	0	26	26	0	30	56	0	0
4	5255128	.	C	A	10	14	24	0	3	27	0	0
4	5255148	.	C	T	16	13	29	0	1	30	0	0
4	5255180	.	T	C	4	11	15	0	1	16	0	0
4	5256482	.	A	G	5	10	15	0	0	15	0	0
4	5256659	.	A	G	5	2	7	0	4	11	0	0
4	5256674	.	G	T	7	6	13	0	0	13	0	0
4	5256737	.	A	G	5	6	11	0	1	12	0	0
4	5256788	.	G	A	4	2	6	0	0	6	0	0
4	5269608	.	G	A	11	7	18	0	0	18	0	0
4	5269660	.	C	G	15	18	33	0	0	33	0	0
4	5291755	.	T	C	6	9	15	0	1	16	0	0
4	5291794	.	T	C	2	3	5	0	0	5	0	0
4	5302127	.	C	T	1	20	21	0	20	41	0	0
4	5302195	.	A	G	19	22	41	0	1	42	0	0
4	5302327	.	G	A	18	18	36	0	0	36	0	0
4	5302689	.	G	A	8	5	13	0	0	13	0	0
4	5318995	.	G	A	9	4	13	0	3	16	0	0
4	5324871	.	G	T	11	10	21	0	0	21	0	0
4	5325105	.	C	T	12	8	20	0	1	21	0	0
4	5329849	.	G	A	3	2	5	0	0	5	0	0
4	5329850	.	G	A	2	3	5	0	0	5	0	0
4	5330192	.	C	A	1	3	4	0	0	4	0	0
4	5331720	.	G	A	6	7	13	0	0	13	0	0
4	5334029	.	G	C	4	2	6	0	1	7	0	0
4	5334061	.	G	A	4	2	6	0	1	7	0	0
4	5338909	.	T	A	8	4	12	0	0	13	1	0
4	5338950	.	G	T	10	7	17	0	1	18	0	0
4	5339053	.	T	A	12	18	30	0	1	31	0	0
4	5341713	.	T	C	1	3	4	0	0	4	0	0
4	5360970	.	A	G	0	2	2	0	0	2	0	0
4	5361135	.	G	A	0	2	2	0	0	2	0	0
4	5363744	.	A	C	2	2	4	0	0	4	0	0
4	5363760	.	A	T	3	4	7	0	0	7	0	0
4	5363836	.	G	A	3	4	7	0	0	7	0	0
4	5365199	.	A	G	1	5	6	0	0	6	0	0
4	5365359	.	A	G	3	1	4	0	1	5	0	0
4	5365399	.	G	A	6	7	13	0	0	13	0	0
4	5366305	.	T	A	2	2	4	0	1	5	0	0
4	5366462	.	C	G	4	2	6	0	0	6	0	0
4	5366663	.	C	T	4	3	7	0	0	7	0	0
4	5366700	.	G	T	3	4	7	0	1	8	0	0
4	5366765	.	G	A	1	3	4	0	0	4	0	0
4	5367319	.	T	C	1	3	4	0	1	5	0	0
4	5367493	.	C	T	0	3	3	0	1	4	0	0
4	5370156	.	A	T	1	1	2	0	0	2	0	0
4	5513298	.	A	T	1	2	3	0	0	3	0	0
4	5515160	.	T	G	1	3	4	0	0	4	0	0
4	5515184	.	G	A	0	2	2	0	1	3	0	0
4	5521510	.	C	T	14	13	27	0	3	30	0	0
4	5522154	.	G	T	17	8	25	0	3	28	0	0
4	5522161	.	C	T	8	17	25	0	1	26	0	0
4	5522298	.	C	A	3	3	6	0	0	6	0	0
4	5595171	.	C	T	5	6	11	0	1	12	0	0
4	5597604	.	C	A	1	4	5	0	1	6	0	0
4	5643321	.	G	A	1	0	1	0	0	1	0	0
4	5644808	.	G	A	3	13	16	0	0	16	0	0
4	5644974	.	G	A	6	10	16	0	0	16	0	0
4	5645097	.	C	T	1	10	11	0	0	11	0	0
4	5645116	.	T	G	1	5	6	0	0	6	0	0
4	5665612	.	T	C	2	0	2	0	5	7	0	0
4	5742551	.	G	A	8	11	19	0	0	19	0	0
4	5742831	.	A	C	15	16	31	0	1	32	0	0
4	5742846	.	C	T	16	15	31	0	0	31	0	0
4	5742936	.	G	A	1	15	16	0	11	27	0	0
4	5742962	.	A	T	8	13	21	0	0	21	0	0
4	5743027	.	A	G	7	8	15	0	0	15	0	0
4	5750854	.	G	A	11	5	16	0	1	17	0	0
4	5750884	.	T	A	8	8	16	0	1	17	0	0
4	5750924	.	A	G	6	12	18	0	0	18	0	0
4	5751381	.	A	C	13	15	28	0	0	28	0	0
4	5751382	.	C	T	0	15	15	0	13	28	0	0
4	5751551	.	G	A	8	10	18	0	4	22	0	0
4	5755018	.	C	T	0	8	8	0	14	22	0	0
4	5755027	.	C	T	0	13	13	0	7	20	0	0
4	5757253	.	C	T	7	3	10	0	0	10	0	0
4	5759617	.	T	G	6	2	8	0	0	8	0	0
4	5763975	.	G	A	14	13	27	0	1	28	0	0
4	5764128	.	T	A	11	11	22	0	2	24	0	0
4	5765181	.	C	T	3	8	11	0	0	11	0	0
4	5765183	.	C	T	8	3	11	0	0	11	0	0
4	5765516	.	T	G	3	6	9	0	0	9	0	0
4	5765529	.	T	G	3	5	8	0	0	8	0	0
4	5765985	.	C	A	3	5	8	0	0	8	0	0
4	5766156	.	C	T	0	8	8	0	5	13	0	0
4	5766200	.	T	A	4	5	9	0	0	9	0	0
4	5766315	.	G	A	4	12	16	0	1	17	0	0
4	5786267	.	G	T	3	3	6	0	0	6	0	0
4	5790426	.	G	A	1	2	3	0	0	3	0	0
4	5790438	.	C	A	2	2	4	0	0	4	0	0
4	5794219	.	G	A	4	2	6	0	0	6	0	0
4	5806810	.	T	A	1	2	3	0	0	3	0	0
4	5834538	.	A	C	1	2	3	0	0	3	0	0
4	5835688	.	T	G	4	2	6	0	0	6	0	0
4	5835733	.	G	A	2	1	3	0	0	3	0	0
4	5838505	.	G	A	6	2	8	0	0	8	0	0
4	5849003	.	C	A	2	4	6	0	0	6	0	0
4	5849180	.	A	G	4	1	5	0	8	13	0	0
4	5849225	.	G	A	5	7	12	0	1	13	0	0
4	5849282	.	C	T	3	1	4	0	1	5	0	0
4	5849295	.	T	A	3	0	3	0	0	3	0	0
4	5849408	.	A	G	1	3	4	0	0	4	0	0
4	5849676	.	A	C	1	7	8	0	0	8	0	0
4	5850169	.	T	C	6	3	9	0	0	9	0	0
4	5850281	.	T	C	7	7	14	0	0	14	0	0
4	5850297	.	A	G	7	8	15	0	0	15	0	0
4	5850604	.	C	G	1	2	3	0	0	3	0	0
4	5851097	.	C	G	0	4	4	0	0	4	0	0
4	5900768	.	T	G	1	0	1	0	1	2	0	0
4	5900783	.	C	A	1	1	2	0	0	2	0	0
4	5905677	.	C	T	4	3	7	0	0	7	0	0
4	5905707	.	T	C	3	2	5	0	0	5	0	0
4	5907100	.	C	T	2	1	3	0	0	3	0	0
4	5907145	.	C	T	5	3	8	0	0	8	0	0
4	5907465	.	G	T	0	0	0	0	1	1	0	0
4	5908763	.	T	C	4	6	10	0	0	10	0	0
4	5908764	.	C	T	4	6	10	0	0	10	0	0
4	5910302	.	C	T	3	6	9	0	0	9	0	0
4	5910492	.	A	G	11	7	18	0	9	27	0	0
4	5910644	.	G	A	20	23	43	0	1	44	0	0
4	5912445	.	C	T	2	1	3	0	0	3	0	0
4	5912475	.	G	A	10	10	20	0	0	20	0	0
4	5912707	.	A	G	2	3	5	0	0	5	0	0
4	6436701	.	G	A	4	9	13	0	0	13	0	0
4	6436845	.	G	A	6	8	14	0	0	14	0	0
4	6508193	.	A	G	3	4	7	0	0	7	0	0
4	6508320	.	G	A	0	3	3	0	2	5	0	0
4	6508382	.	G	C	3	2	5	0	0	5	0	0
4	6552491	.	T	A	0	1	1	0	0	1	0	0
4	6578209	.	A	T	2	2	4	0	0	4	0	0
4	6579308	.	G	A	0	2	2	0	1	3	0	0
4	6579603	.	A	G	1	2	3	0	0	3	0	0
4	6946608	.	C	T	5	8	13	0	0	13	0	0
4	6960377	.	C	T	2	2	4	0	0	4	0	0
4	6989731	.	G	A	0	2	2	0	0	2	0	0
4	6991438	.	A	C	3	9	12	0	0	12	0	0
4	6991480	.	T	G	7	9	16	0	0	16	0	0
4	6991582	.	C	A	8	6	14	0	0	14	0	0
4	6991825	.	C	A	8	9	17	0	0	17	0	0
4	6991975	.	T	A	10	6	16	0	0	16	0	0
4	6992264	.	G	T	12	16	28	0	3	31	0	0
4	6992348	.	C	A	12	18	30	0	4	34	0	0
4	6992744	.	C	T	2	12	14	0	1	15	0	0
4	6992808	.	T	C	5	14	19	0	0	19	0	0
4	7836176	.	A	G	13	5	18	0	2	20	0	0
4	7870599	.	T	C	2	4	6	0	0	6	0	0
4	7870624	.	T	C	2	4	6	0	0	6	0	0
4	7870660	.	T	A	1	4	5	0	0	5	0	0
4	7870669	.	A	G	2	3	5	0	0	5	0	0
4	7870913	.	T	G	5	8	13	0	0	13	0	0
4	7870952	.	C	T	0	6	6	0	3	9	0	0
4	7870983	.	C	T	6	4	10	0	0	10	0	0
4	7871084	.	A	C	1	1	2	0	0	2	0	0
4	7872637	.	G	A	0	1	1	0	0	1	0	0
4	7875702	.	A	T	1	0	1	0	0	1	0	0
4	7875901	.	T	G	1	1	2	0	0	2	0	0
4	7875917	.	A	T	1	1	2	0	0	2	0	0
4	7879522	.	A	G	2	0	2	0	2	4	0	0
4	7881534	.	C	G	4	1	5	0	4	9	0	0
4	7883462	.	A	C	3	8	11	0	0	11	0	0
4	7883466	.	G	A	3	8	11	0	0	11	0	0
4	7888181	.	A	C	8	4	12	0	2	14	0	0
4	7943958	.	C	T	1	1	2	0	0	2	0	0
4	7959162	.	T	C	3	6	9	0	0	9	0	0
4	8027183	.	A	T	0	2	2	0	0	2	0	0
4	8609609	.	T	A	4	1	5	0	1	6	0	0
4	8609648	.	G	A	7	9	16	0	1	17	0	0
4	8609799	.	T	C	13	12	25	0	0	25	0	0
4	8680965	.	C	T	9	10	19	0	0	19	0	0
4	8681039	.	C	T	1	1	2	0	0	2	0	0
4	8702687	.	G	A	6	4	10	0	0	10	0	0
4	8702729	.	C	A	5	9	14	0	0	14	0	0
4	8702765	.	C	T	6	3	9	0	0	9	0	0
4	8704655	.	C	T	5	6	11	0	2	13	0	0
4	8706385	.	G	A	7	8	15	0	1	16	0	0
4	8706412	.	G	T	7	6	13	0	0	13	0	0
4	8706716	.	A	G	7	5	12	0	2	14	0	0
4	8706855	.	A	T	5	8	13	0	0	13	0	0
4	8707154	.	C	T	7	11	18	0	1	19	0	0
4	8707182	.	T	C	8	10	18	0	3	21	0	0
4	8755661	.	G	C	3	2	5	0	0	5	0	0
4	8761205	.	C	T	0	4	4	0	2	6	0	0
4	8795167	.	G	A	2	3	5	0	0	5	0	0
4	8797201	.	T	A	27	21	48	0	2	50	0	0
4	8797234	.	T	A	25	25	50	0	4	54	0	0
4	8797315	.	T	C	15	25	40	0	2	42	0	0
4	8803071	.	C	T	4	4	8	0	0	8	0	0
4	8805792	.	T	C	12	11	23	0	2	25	0	0
4	8808775	.	C	T	7	7	14	0	0	14	0	0
4	8808823	.	C	T	20	17	37	0	3	40	0	0
4	8808974	.	C	T	26	22	48	0	1	49	0	0
4	8809268	.	T	G	28	15	43	0	0	43	0	0
4	8809431	.	T	G	6	13	19	2	0	21	0	0
4	8809444	.	T	G	14	6	20	0	0	20	0	0
4	8809506	.	A	T	12	14	26	0	0	26	0	0
4	8809544	.	C	G	19	0	19	0	19	38	0	0
4	8809690	.	G	T	0	15	15	0	1	16	0	0
4	8809695	.	C	T	0	23	23	0	2	25	0	0
4	8809772	.	T	A	7	7	14	0	0	14	0	0
4	8809879	.	T	G	6	8	14	0	0	14	0	0
4	8809985	.	G	T	15	7	22	0	1	23	0	0
4	8810200	.	G	T	13	10	23	0	1	24	0	0
4	8810367	.	A	C	16	33	49	0	2	51	0	0
4	8810474	.	A	T	21	17	38	0	1	39	0	0
4	8810597	.	A	T	16	19	35	0	1	36	0	0
4	8810607	.	C	T	15	19	34	0	2	36	0	0
4	8850984	.	A	G	2	3	5	0	2	7	0	0
4	8850998	.	G	A	5	2	7	0	0	7	0	0
4	8851503	.	T	A	7	16	23	0	1	24	0	0
4	8851547	.	A	G	15	13	28	0	1	29	0	0
4	8851740	.	G	A	13	10	23	0	0	23	0	0
4	8851864	.	G	A	8	11	19	0	0	19	0	0
4	8851999	.	C	T	12	10	22	0	0	22	0	0
4	8852085	.	G	T	15	11	26	0	0	26	0	0
4	8854403	.	G	T	11	9	20	0	2	22	0	0
4	8882297	.	G	T	1	4	5	0	0	5	0	0
4	8898917	.	C	T	0	11	11	0	9	20	0	0
4	8898939	.	G	A	13	8	21	0	0	21	0	0
4	8903051	.	T	A	2	4	6	0	0	6	0	0
4	8909871	.	A	C	3	0	3	0	3	6	0	0
4	9012215	.	T	G	0	0	0	0	2	2	0	0
4	9012218	.	T	C	0	3	3	0	0	3	0	0
4	9012258	.	A	T	2	7	9	0	0	9	0	0
4	9017996	.	C	T	0	2	2	0	0	2	0	0
4	9021369	.	T	C	6	10	16	0	1	17	0	0
4	9024665	.	T	G	10	10	20	0	0	20	0	0
4	9024671	.	A	G	10	11	21	0	0	21	0	0
4	9024720	.	A	C	8	11	19	0	0	19	0	0
4	9024784	.	A	G	8	8	16	0	1	17	0	0
4	9024807	.	A	G	9	6	15	0	1	16	0	0
4	9028868	.	T	C	1	3	4	0	0	4	0	0
4	9045012	.	T	C	0	2	2	0	0	2	0	0
4	9045979	.	C	T	1	0	1	0	0	1	0	0
4	9048957	.	G	T	2	2	4	0	0	4	0	0
4	9052228	.	C	G	0	5	5	0	2	7	0	0
4	9085337	.	A	G	7	0	7	0	7	14	0	0
4	9094270	.	G	T	6	3	9	0	0	9	0	0
4	9094347	.	G	A	7	4	11	0	1	12	0	0
4	9094666	.	T	G	5	5	10	0	0	10	0	0
4	9094668	.	T	A	5	5	10	0	0	10	0	0
4	9104510	.	T	C	4	0	4	0	4	8	0	0
4	9105199	.	T	C	2	0	2	0	6	8	0	0
4	9128095	.	T	C	2	0	2	0	3	5	0	0
4	9173425	.	A	G	4	6	10	0	0	10	0	0
4	9180680	.	G	A	17	9	26	0	1	27	0	0
4	9180746	.	T	C	8	6	14	0	0	14	0	0
4	9183115	.	T	A	4	2	6	0	0	6	0	0
4	9192444	.	G	A	3	5	8	0	2	10	0	0
4	9192507	.	A	C	2	0	2	0	2	4	0	0
4	9208383	.	A	G	5	5	10	0	0	10	0	0
4	9208486	.	C	G	3	3	6	0	0	6	0	0
4	9208598	.	C	A	0	2	2	0	1	3	0	0
4	9208911	.	C	A	1	2	3	0	0	3	0	0
4	9209469	.	G	A	2	4	6	0	0	6	0	0
4	9209486	.	G	A	2	4	6	0	0	6	0	0
4	9210013	.	C	G	2	2	4	1	0	5	0	0
4	9302284	.	T	C	2	3	5	0	1	6	0	0
4	9308332	.	C	T	1	3	4	0	1	5	0	0
4	9308344	.	G	A	2	1	3	0	1	4	0	0
4	9317959	.	T	C	1	2	3	0	0	3	0	0
4	9329819	.	T	A	5	4	9	0	0	9	0	0
4	9329912	.	C	A	3	4	7	0	0	7	0	0
4	9331330	.	G	A	0	11	11	0	5	16	0	0
4	9331495	.	T	G	3	0	3	0	2	5	0	0
4	9333565	.	G	A	0	9	9	0	13	22	0	0
4	9333739	.	A	C	14	25	39	0	1	40	0	0
4	9334180	.	G	C	0	5	5	0	7	12	0	0
4	9334196	.	A	G	3	7	10	0	0	10	0	0
4	9334735	.	A	G	13	1	14	0	5	19	0	0
4	9339140	.	G	A	4	6	10	0	1	11	0	0
4	9339202	.	G	A	4	3	7	0	0	7	0	0
4	9339274	.	C	T	5	4	9	0	0	9	0	0
4	9339316	.	C	T	1	7	8	0	4	12	0	0
4	9339637	.	C	T	0	5	5	0	5	10	0	0
4	9339964	.	T	C	1	0	1	0	2	3	0	0
4	9371180	.	G	T	0	1	1	0	0	1	0	0
4	9372530	.	C	T	0	1	1	0	0	1	0	0
4	9385390	.	A	G	11	0	11	0	11	22	0	0
4	9386108	.	C	T	1	6	7	0	0	7	0	0
4	9388890	.	C	T	4	5	9	0	0	9	0	0
4	9389003	.	A	C	8	4	12	0	0	12	0	0
4	9389112	.	G	A	6	2	8	0	1	9	0	0
4	9429583	.	A	T	1	0	1	0	0	1	0	0
4	9429769	.	G	A	1	0	1	0	0	1	0	0
4	9446126	.	C	G	2	2	4	0	0	4	0	0
4	9447758	.	C	T	6	3	9	0	0	9	0	0
4	9448634	.	G	A	5	7	12	0	0	12	0	0
4	9448643	.	G	T	3	6	9	0	0	9	0	0
4	9460213	.	A	G	7	0	7	0	9	16	0	0
4	9460603	.	A	C	5	4	9	0	0	9	0	0
4	9461548	.	A	G	1	0	1	0	3	4	0	0
4	9461822	.	C	A	3	2	5	0	0	5	0	0
4	9461839	.	C	A	2	2	4	0	1	5	0	0
4	9461946	.	T	A	9	7	16	0	0	16	0	0
4	9462039	.	T	G	2	4	6	0	0	7	1	0
4	9462237	.	T	C	5	3	8	0	0	8	0	0
4	9463840	.	C	G	5	3	8	0	0	8	0	0
4	9463855	.	T	A	6	4	10	0	1	11	0	0
4	9464224	.	T	C	1	5	6	0	0	6	0	0
4	9465637	.	A	G	3	4	7	0	0	7	0	0
4	9465832	.	G	T	6	9	15	0	0	15	0	0
4	9465899	.	C	A	12	3	15	0	0	15	0	0
4	9465900	.	C	A	10	3	13	0	2	15	0	0
4	9466075	.	G	T	9	9	18	0	1	19	0	0
4	9495749	.	C	G	0	1	1	0	0	1	0	0
4	9496926	.	C	T	1	3	4	0	0	4	0	0
4	9496934	.	G	A	1	3	4	0	0	4	0	0
4	9496969	.	A	T	0	2	2	0	0	2	0	0
4	9496976	.	C	G	0	2	2	0	0	2	0	0
4	9498886	.	G	C	2	5	7	0	0	7	0	0
4	9499404	.	G	A	4	3	7	0	0	7	0	0
4	9499448	.	C	A	0	2	2	0	1	3	0	0
4	9500311	.	A	T	3	5	8	0	0	8	0	0
4	9500312	.	G	T	3	5	8	0	0	8	0	0
4	9500370	.	G	A	0	1	1	0	0	1	0	0
4	9502243	.	G	T	8	6	14	0	2	16	0	0
4	9502312	.	T	A	6	3	9	0	2	11	0	0
4	9502347	.	C	G	7	0	7	0	5	12	0	0
4	9502388	.	T	C	3	5	8	0	0	8	0	0
4	9502422	.	G	A	7	6	13	0	2	15	0	0
4	9502440	.	A	G	8	0	8	0	9	17	0	0
4	9502608	.	T	G	12	0	12	0	8	20	0	0
4	9525625	.	A	C	1	2	3	0	0	3	0	0
4	9525657	.	G	A	2	2	4	0	0	4	0	0
4	9525660	.	C	T	2	2	4	0	0	4	0	0
4	9537015	.	A	G	7	8	15	0	0	15	0	0
4	9537025	.	C	T	7	7	14	0	0	14	0	0
4	9539303	.	G	A	4	2	6	0	1	7	0	0
4	9573368	.	G	A	2	2	4	0	0	4	0	0
4	9579297	.	C	G	2	3	5	0	0	5	0	0
4	9592782	.	A	T	1	3	4	0	0	4	0	0
4	9593832	.	C	A	4	3	7	0	0	7	0	0
4	9596614	.	A	G	6	5	11	0	0	11	0	0
4	9597837	.	G	A	1	2	3	0	0	3	0	0
4	9597862	.	G	A	1	2	3	0	0	3	0	0
4	9598642	.	C	T	3	4	7	0	1	8	0	0
4	9598690	.	C	T	1	1	2	0	0	2	0	0
4	9601158	.	C	T	5	5	10	0	0	10	0	0
4	9601174	.	T	C	7	4	11	0	0	11	0	0
4	9601256	.	A	C	3	3	6	0	0	6	0	0
4	9601329	.	C	T	8	5	13	0	0	13	0	0
4	9601401	.	A	T	5	11	16	0	1	17	0	0
4	9601628	.	G	T	2	4	6	0	0	6	0	0
4	9603424	.	G	A	3	2	5	0	0	5	0	0
4	9603559	.	G	A	4	3	7	0	0	7	0	0
4	9603791	.	G	A	6	9	15	0	0	15	0	0
4	9603803	.	G	A	10	7	17	0	3	20	0	0
4	9604134	.	G	A	8	9	17	0	0	17	0	0
4	9604294	.	C	T	0	7	7	0	9	16	0	0
4	9604336	.	T	C	7	0	7	0	7	14	0	0
4	9604384	.	A	G	6	3	9	0	0	9	0	0
4	9605221	.	C	T	0	2	2	0	1	3	0	0
4	9605397	.	A	G	3	1	4	0	0	4	0	0
4	9605505	.	C	T	0	1	1	0	0	1	0	0
4	9607259	.	A	G	0	1	1	0	0	1	0	0
4	9616190	.	A	G	2	2	4	0	0	4	0	0
4	9618432	.	A	G	0	1	1	0	0	1	0	0
4	9618867	.	A	C	3	1	4	0	0	4	0	0
4	9653570	.	A	G	5	3	8	0	1	9	0	0
4	9653574	.	C	A	0	4	4	0	5	9	0	0
4	9653626	.	G	A	1	6	7	0	1	8	0	0
4	9653925	.	T	G	7	7	14	0	2	16	0	0
4	9654020	.	T	A	5	5	10	0	3	13	0	0
4	9654071	.	T	C	8	7	15	0	0	15	0	0
4	9654103	.	A	G	8	9	17	0	0	17	0	0
4	9654114	.	C	T	0	8	8	0	8	16	0	0
4	9654149	.	C	G	1	5	6	0	0	6	0	0
4	9655534	.	T	C	4	0	4	0	5	9	0	0
4	9655807	.	G	A	10	8	18	0	0	18	0	0
4	9659858	.	G	A	0	2	2	0	1	3	0	0
4	9661625	.	T	A	2	0	2	0	0	2	0	0
4	9664900	.	G	A	0	3	3	0	0	3	0	0
4	9669846	.	A	T	8	9	17	0	0	17	0	0
4	9669869	.	C	T	7	5	12	0	0	12	0	0
4	9674206	.	G	A	5	5	10	0	0	10	0	0
4	9675420	.	G	A	0	4	4	0	3	7	0	0
4	9677280	.	G	C	2	5	7	0	1	8	0	0
4	9686153	.	A	G	4	0	4	0	8	12	0	0
4	9688093	.	T	C	5	8	13	0	1	14	0	0
4	9688570	.	C	T	11	9	20	0	2	22	0	0
4	9688636	.	G	A	21	9	30	0	1	31	0	0
4	9689825	.	G	A	0	26	26	0	18	44	0	0
4	9697346	.	A	G	3	4	7	0	0	7	0	0
4	9697599	.	C	A	9	8	17	0	2	19	0	0
4	9697763	.	A	C	5	3	8	0	0	8	0	0
4	9697813	.	C	T	8	5	13	0	0	13	0	0
4	9698023	.	C	T	0	1	1	0	0	1	0	0
4	9724441	.	A	G	9	6	15	0	0	15	0	0
4	9724635	.	T	A	7	17	24	0	1	25	0	0
4	9724644	.	C	T	6	18	24	0	1	25	0	0
4	9724718	.	C	A	8	13	21	0	0	21	0	0
4	9724898	.	A	G	9	12	21	0	1	22	0	0
4	9736186	.	A	G	3	2	5	0	0	5	0	0
4	9736211	.	C	T	3	3	6	0	0	6	0	0
4	9737157	.	G	T	6	8	14	0	0	14	0	0
4	9737314	.	A	C	8	0	8	0	19	27	0	0
4	9739228	.	C	A	5	6	11	0	0	11	0	0
4	9740769	.	G	A	8	7	15	0	0	15	0	0
4	9743708	.	G	C	2	4	6	0	0	6	0	0
4	9743762	.	T	G	4	9	13	0	0	13	0	0
4	9743774	.	C	T	5	9	14	0	0	14	0	0
4	9746547	.	C	T	3	3	6	0	0	6	0	0
4	9746559	.	C	A	2	3	5	0	1	6	0	0
4	9746604	.	G	A	4	7	11	0	0	11	0	0
4	9747647	.	C	T	4	8	12	0	0	12	0	0
4	9750109	.	G	T	2	4	6	0	0	6	0	0
4	9750154	.	T	G	3	6	9	0	0	9	0	0
4	9751310	.	T	G	3	1	4	0	0	4	0	0
4	9753200	.	A	G	6	2	8	0	0	8	0	0
4	9755341	.	G	A	7	5	12	0	0	12	0	0
4	9755350	.	G	A	6	4	10	0	0	10	0	0
4	9756488	.	G	T	3	2	5	0	0	5	0	0
4	9758862	.	C	A	0	2	2	0	2	4	0	0
4	9784331	.	T	A	9	7	16	0	0	16	0	0
4	9784444	.	C	T	6	6	12	0	2	14	0	0
4	9784669	.	G	A	7	6	13	0	1	14	0	0
4	9784678	.	C	T	0	5	5	0	8	13	0	0
4	9784740	.	A	G	4	6	10	0	0	10	0	0
4	9784747	.	T	A	3	6	9	0	1	10	0	0
4	9785900	.	T	A	4	6	10	0	1	11	0	0
4	9785985	.	C	T	10	2	12	0	1	13	0	0
4	9785996	.	G	A	7	2	9	0	0	9	0	0
4	9786203	.	A	G	5	13	18	0	0	18	0	0
4	9786338	.	T	A	8	5	13	0	0	13	0	0
4	9786466	.	C	G	0	3	3	0	8	11	0	0
4	9786514	.	C	T	3	4	7	0	0	7	0	0
4	9786574	.	T	A	10	1	11	0	0	11	0	0
4	9786617	.	C	A	10	4	14	0	0	14	0	0
4	9786670	.	C	A	6	6	12	0	0	12	0	0
4	9786925	.	T	C	1	0	1	0	2	3	0	0
4	9786935	.	T	C	2	0	2	0	1	3	0	0
4	9786976	.	G	A	1	2	3	0	1	4	0	0
4	9787025	.	T	G	2	5	7	0	0	7	0	0
4	9787130	.	A	G	4	3	7	0	0	7	0	0
4	9787250	.	A	G	4	3	7	0	0	7	0	0
4	9787415	.	G	A	6	10	16	0	0	16	0	0
4	9787516	.	C	T	6	7	13	0	1	14	0	0
4	9787600	.	G	T	12	8	20	0	0	20	0	0
4	9787761	.	A	G	7	8	15	0	0	15	0	0
4	9789478	.	A	G	2	6	8	0	0	8	0	0
4	9791466	.	A	T	5	4	9	0	0	9	0	0
4	9791493	.	T	C	3	0	3	0	3	6	0	0
4	9792102	.	T	G	2	0	2	0	0	2	0	0
4	9792229	.	G	T	10	6	16	0	0	16	0	0
4	9792726	.	T	G	2	1	3	0	0	3	0	0
4	9792798	.	A	G	3	1	4	0	0	4	0	0
4	9794644	.	C	A	0	3	3	0	3	6	0	0
4	9795288	.	C	T	3	3	6	0	0	6	0	0
4	9795309	.	C	T	5	4	9	0	0	9	0	0
4	9795417	.	T	A	0	2	2	0	0	2	0	0
4	9797312	.	C	T	0	5	5	0	1	6	0	0
4	9797376	.	G	A	1	2	3	0	0	3	0	0
4	9798229	.	T	C	0	0	0	0	1	1	0	0
4	9798825	.	C	A	0	5	5	0	8	13	0	0
4	9801626	.	G	A	4	3	7	0	2	9	0	0
4	9801662	.	A	G	5	2	7	0	0	7	0	0
4	9801730	.	A	T	7	8	15	0	1	16	0	0
4	9801747	.	G	A	9	8	17	0	2	19	0	0
4	9801935	.	A	G	9	7	16	0	0	16	0	0
4	9802472	.	A	T	4	3	7	0	1	8	0	0
4	9802487	.	C	T	0	6	6	0	4	10	0	0
4	9809733	.	T	G	3	3	6	0	0	6	0	0
4	9809829	.	T	C	1	0	1	0	1	2	0	0
4	9813844	.	T	A	2	3	5	0	0	5	0	0
4	9813902	.	C	A	2	2	4	0	0	4	0	0
4	9814044	.	C	G	4	5	9	0	0	9	0	0
4	9817327	.	C	T	4	1	5	0	0	5	0	0
4	9819858	.	A	T	4	3	7	0	1	8	0	0
4	9819944	.	T	C	2	4	6	0	1	7	0	0
4	9822506	.	T	C	2	0	2	0	2	4	0	0
4	9836583	.	T	A	16	8	24	0	0	24	0	0
4	9838875	.	T	C	12	4	16	0	1	17	0	0
4	9838932	.	C	T	6	5	11	0	0	11	0	0
4	9838974	.	T	C	7	9	16	0	0	16	0	0
4	9840136	.	T	C	0	2	2	0	0	2	0	0
4	9840338	.	T	C	4	3	7	0	1	8	0	0
4	9841657	.	G	A	18	18	36	0	2	38	0	0
4	9853700	.	A	G	1	2	3	0	0	3	0	0
4	9854313	.	T	C	3	9	12	0	1	13	0	0
4	9854458	.	T	C	3	1	4	0	3	7	0	0
4	9854467	.	C	T	2	5	7	0	1	8	0	0
4	9858023	.	A	G	2	1	3	0	1	4	0	0
4	9858050	.	C	T	5	2	7	0	1	8	0	0
4	9863747	.	C	T	2	2	4	0	1	5	0	0
4	9863771	.	T	C	1	0	1	0	0	1	0	0
4	9863795	.	A	G	1	0	1	0	0	1	0	0
4	9866911	.	C	T	0	4	4	0	1	5	0	0
4	9866926	.	T	C	1	5	6	0	0	6	0	0
4	9943066	.	T	C	1	2	3	0	0	3	0	0
4	9955338	.	A	G	1	0	1	0	4	5	0	0
4	9955350	.	C	T	2	3	5	0	0	5	0	0
4	9957319	.	T	C	2	5	7	0	1	8	0	0
4	9957331	.	C	T	0	6	6	0	1	7	0	0
4	9957367	.	T	C	0	3	3	0	0	3	0	0
4	9961823	.	T	A	1	0	1	0	0	1	0	0
4	9962466	.	C	T	5	1	6	0	1	7	0	0
4	9964153	.	T	C	4	7	11	0	1	12	0	0
4	9964161	.	C	G	5	8	13	0	0	13	0	0
4	9969261	.	C	T	7	3	10	0	0	10	0	0
4	9969306	.	G	T	9	7	16	0	0	16	0	0
4	9969447	.	T	C	3	2	5	0	0	5	0	0
4	9979792	.	T	C	3	7	10	0	0	10	0	0
4	9980400	.	G	A	0	1	1	0	3	4	0	0
4	9981838	.	G	A	4	6	10	0	2	12	0	0
4	9982775	.	G	T	0	2	2	0	0	2	0	0
4	9982872	.	A	T	4	3	7	0	0	7	0	0
4	9982883	.	A	G	4	2	6	0	0	6	0	0
4	9983251	.	G	A	1	5	6	0	0	6	0	0
4	9983269	.	C	G	3	6	9	0	0	9	0	0
4	9983347	.	G	T	6	4	10	0	0	10	0	0
4	9983940	.	C	T	7	4	11	0	0	11	0	0
4	9983943	.	T	C	7	3	10	0	1	11	0	0
4	9985320	.	G	C	2	1	3	0	1	4	0	0
4	9986279	.	G	A	7	7	14	0	1	15	0	0
4	9988867	.	C	T	1	1	2	0	0	2	0	0
4	9990796	.	G	A	2	2	4	0	1	5	0	0
4	9993789	.	C	T	12	7	19	0	0	19	0	0
4	9996182	.	T	C	7	7	14	0	0	14	0	0
4	9998553	.	G	A	0	15	15	0	14	30	1	0
4	9998566	.	A	C	10	17	27	0	4	31	0	0
4	9998677	.	A	G	13	8	21	0	0	21	0	0
4	9998986	.	A	T	12	14	26	0	0	27	1	0
4	9998988	.	T	C	12	15	27	0	0	27	0	0
4	9999240	.	C	T	15	17	32	0	0	32	0	0
4	9999367	.	A	G	22	15	37	0	0	37	0	0
4	9999830	.	T	C	14	7	21	0	4	25	0	0
4	9999909	.	A	T	6	6	12	0	0	12	0	0
4	10006223	.	A	G	1	0	1	0	0	1	0	0
4	10011770	.	A	C	2	1	3	0	0	3	0	0
4	10017468	.	A	G	15	22	37	0	2	39	0	0
4	10038009	.	T	C	0	2	2	0	0	2	0	0
4	10040249	.	G	A	0	21	21	0	22	43	0	0
4	10040285	.	A	G	27	0	27	0	24	51	0	0
4	10040297	.	C	T	25	23	48	0	1	49	0	0
4	10128125	.	T	C	1	2	3	0	0	3	0	0
4	10366043	.	G	A	0	3	3	0	1	4	0	0
4	10366045	.	C	T	1	3	4	0	0	4	0	0
4	10366710	.	G	A	1	3	4	0	0	4	0	0
4	10367349	.	G	A	3	2	5	0	0	5	0	0
4	10367358	.	A	G	0	0	0	0	5	5	0	0
4	10367412	.	A	C	5	6	11	0	1	12	0	0
4	10367610	.	C	T	3	2	5	0	0	5	0	0
4	10367619	.	C	T	3	2	5	0	0	5	0	0
4	10553528	.	G	A	5	4	9	0	0	9	0	0
4	10558370	.	C	T	6	5	11	0	0	11	0	0
4	10558510	.	T	C	2	3	5	0	0	5	0	0
4	10559042	.	A	T	4	2	6	0	0	6	0	0
4	10559088	.	C	A	5	2	7	0	2	9	0	0
4	10559213	.	C	G	6	5	11	0	0	11	0	0
4	10559621	.	C	A	7	8	15	0	1	16	0	0
4	10559919	.	G	T	0	4	4	0	0	4	0	0
4	10559938	.	T	C	2	3	5	0	0	5	0	0
4	10560246	.	G	A	11	8	19	0	1	20	0	0
4	10560253	.	A	T	10	10	20	0	1	21	0	0
4	10560284	.	C	T	11	15	26	0	1	27	0	0
4	10560404	.	A	T	12	8	20	0	0	20	0	0
4	10560607	.	A	G	7	6	13	0	0	13	0	0
4	10560916	.	C	T	12	7	19	0	1	20	0	0
4	10561598	.	T	C	10	12	22	0	0	22	0	0
4	10561603	.	G	A	11	13	24	0	0	24	0	0
4	10605409	.	T	C	3	3	6	0	0	6	0	0
4	10605457	.	C	T	0	1	1	0	0	1	0	0
4	10608878	.	G	T	6	8	14	0	0	14	0	0
4	10611014	.	T	A	14	9	23	0	3	26	0	0
4	10615123	.	A	T	12	10	22	0	2	24	0	0
4	10615127	.	G	T	13	9	22	0	1	23	0	0
4	10615175	.	A	G	9	0	9	0	7	16	0	0
4	10761803	.	C	G	1	0	1	0	3	4	0	0
4	10762071	.	G	A	2	2	4	0	0	4	0	0
4	10763272	.	A	C	1	2	3	0	0	3	0	0
4	10763273	.	G	A	1	2	3	0	0	3	0	0
4	10772108	.	T	C	2	2	4	0	0	4	0	0
4	10772118	.	A	G	2	2	4	0	0	4	0	0
4	10825629	.	G	A	1	0	1	0	0	1	0	0
4	10888842	.	G	C	0	3	3	0	4	7	0	0
4	10888890	.	T	A	1	6	7	0	1	8	0	0
4	10888935	.	C	A	1	2	3	0	0	3	0	0
4	10890822	.	G	A	4	4	8	0	0	8	0	0
4	10896354	.	G	C	3	6	9	0	0	9	0	0
4	10896570	.	G	A	3	6	9	0	1	10	0	0
4	10896582	.	G	T	2	4	6	0	0	6	0	0
4	10896618	.	C	T	3	5	8	0	0	8	0	0
4	10896620	.	A	T	3	5	8	0	0	8	0	0
4	10904784	.	C	T	3	1	4	0	0	4	0	0
4	10905246	.	C	T	6	6	12	0	0	12	0	0
4	10906254	.	C	T	12	8	20	0	1	21	0	0
4	10908001	.	C	T	13	17	30	0	0	30	0	0
4	10908294	.	C	T	8	8	16	0	0	16	0	0
4	10908726	.	T	C	7	5	12	0	0	12	0	0
4	10974722	.	G	A	4	7	11	0	0	11	0	0
4	10974747	.	A	T	3	2	5	0	0	5	0	0
4	10976944	.	G	A	1	0	1	0	1	2	0	0
4	10982291	.	C	T	1	1	2	0	0	2	0	0
4	10982339	.	T	G	1	2	3	0	0	3	0	0
4	10982390	.	C	A	0	0	0	0	1	1	0	0
4	10987895	.	T	A	5	2	7	0	0	7	0	0
4	10988546	.	G	C	3	4	7	0	0	7	0	0
4	10988581	.	C	T	0	2	2	0	0	2	0	0
4	10995138	.	G	A	0	3	3	0	0	3	0	0
4	11053851	.	G	A	0	8	8	0	4	12	0	0
4	11054484	.	A	C	10	6	16	0	0	16	0	0
4	11054509	.	G	C	10	6	16	0	0	16	0	0
4	11344964	.	G	A	0	2	2	0	0	2	0	0
4	11356555	.	A	G	3	5	8	0	0	8	0	0
4	11358626	.	C	T	2	1	3	0	0	3	0	0
4	11366360	.	T	C	6	9	15	0	1	16	0	0
4	11366481	.	G	A	5	9	14	0	5	19	0	0
4	11367668	.	T	A	11	6	17	0	0	17	0	0
4	11367952	.	T	C	11	4	15	0	0	15	0	0
4	11368056	.	A	T	16	14	30	0	3	33	0	0
4	11368076	.	G	T	17	22	39	0	1	40	0	0
4	11368171	.	G	A	1	22	23	0	19	42	0	0
4	11368432	.	A	T	1	5	6	0	1	7	0	0
4	11385001	.	T	C	1	2	3	0	0	3	0	0
4	11387131	.	G	T	4	3	7	0	1	8	0	0
4	11387698	.	A	T	2	1	3	0	0	3	0	0
4	11389372	.	G	C	0	2	2	0	4	7	1	0
4	11414424	.	A	T	1	2	3	0	1	4	0	0
4	11415471	.	G	A	4	4	8	0	1	9	0	0
4	11415483	.	G	A	4	4	8	0	0	8	0	0
4	11416701	.	C	T	3	7	10	0	1	12	1	0
4	11416758	.	T	A	4	8	12	0	0	12	0	0
4	11416854	.	G	A	10	14	24	0	2	26	0	0
4	11417753	.	G	T	5	4	9	0	0	9	0	0
4	11417829	.	C	A	3	6	9	0	0	9	0	0
4	11417838	.	A	T	0	7	7	0	0	7	0	0
4	11418969	.	C	T	10	10	20	0	0	20	0	0
4	11419062	.	G	A	4	3	7	0	0	7	0	0
4	11419163	.	C	G	2	4	6	0	0	6	0	0
4	11419510	.	C	T	5	6	11	0	0	11	0	0
4	11419656	.	C	T	5	6	11	0	1	12	0	0
4	11419836	.	A	T	8	6	14	0	1	15	0	0
4	11419869	.	T	C	8	4	12	0	0	12	0	0
4	11420005	.	A	T	7	15	22	0	5	27	0	0
4	11421575	.	C	T	10	10	20	0	0	20	0	0
4	11422121	.	C	T	12	12	24	0	0	24	0	0
4	11425839	.	G	T	2	3	5	0	0	5	0	0
4	11439544	.	C	A	5	5	10	0	0	10	0	0
4	11446078	.	A	G	18	17	35	0	0	35	0	0
4	11446365	.	A	T	20	20	40	0	0	40	0	0
4	11446771	.	A	G	15	4	19	0	0	19	0	0
4	11446943	.	A	G	11	4	15	0	0	15	0	0
4	11447135	.	T	C	22	16	38	0	1	39	0	0
4	11447144	.	G	A	14	19	33	0	2	35	0	0
4	11447226	.	T	G	9	3	12	0	12	24	0	0
4	11447251	.	T	C	10	12	22	0	3	25	0	0
4	11447719	.	T	G	28	11	39	0	1	40	0	0
4	11448296	.	A	T	9	25	34	0	1	35	0	0
4	11448403	.	G	A	0	20	20	0	24	44	0	0
4	11458171	.	G	T	0	3	3	0	13	16	0	0
4	11458318	.	T	G	1	4	5	0	0	5	0	0
4	11461181	.	C	G	2	8	10	0	0	10	0	0
4	11461914	.	A	G	3	5	8	0	0	8	0	0
4	11464390	.	A	G	2	5	7	0	1	8	0	0
4	11470854	.	A	G	3	1	4	0	0	4	0	0
4	11471203	.	T	C	9	4	13	0	1	14	0	0
4	11472674	.	T	C	7	13	20	0	1	21	0	0
4	11476472	.	G	A	0	30	30	0	22	52	0	0
4	11476487	.	C	T	23	27	50	0	4	54	0	0
4	11476740	.	C	T	30	21	51	0	0	51	0	0
4	11476868	.	C	G	31	17	48	0	5	53	0	0
4	11476945	.	C	T	33	29	62	0	2	64	0	0
4	11477047	.	T	A	23	33	56	0	1	57	0	0
4	11477377	.	C	T	41	14	55	0	0	55	0	0
4	11480649	.	T	C	4	5	9	0	0	9	0	0
4	11480824	.	C	A	5	8	13	0	0	13	0	0
4	11480866	.	C	T	1	0	1	0	0	1	0	0
4	11482235	.	G	A	0	8	8	0	8	16	0	0
4	11482259	.	G	A	10	7	17	0	3	20	0	0
4	11482358	.	T	G	1	1	2	0	0	2	0	0
4	11482367	.	C	G	1	0	1	0	0	1	0	0
4	11482668	.	T	A	13	7	20	0	1	21	0	0
4	11482830	.	C	T	2	5	7	0	0	7	0	0
4	11482943	.	C	A	1	2	3	0	0	3	0	0
4	11484854	.	A	G	2	2	4	0	0	4	0	0
4	11704180	.	C	T	2	0	2	0	0	2	0	0
4	11704195	.	A	G	1	0	1	0	0	1	0	0
4	11712704	.	G	T	0	5	5	0	1	6	0	0
4	11712794	.	T	C	0	1	1	0	0	1	0	0
4	11721731	.	C	T	3	3	6	0	0	6	0	0
4	11726366	.	T	A	0	5	5	0	1	6	0	0
4	11728959	.	G	A	0	3	3	0	2	5	0	0
4	11729719	.	G	A	7	8	15	0	1	16	0	0
4	11730159	.	G	C	8	5	13	0	1	14	0	0
4	11730515	.	C	A	6	3	9	0	0	9	0	0
4	11732222	.	G	A	3	3	6	0	0	6	0	0
4	11732456	.	G	A	7	3	10	0	0	10	0	0
4	11732589	.	T	C	7	8	15	0	0	15	0	0
4	11732590	.	T	C	7	8	15	0	0	15	0	0
4	11732956	.	A	G	6	4	10	0	0	10	0	0
4	11732975	.	G	A	4	5	9	0	0	9	0	0
4	11733061	.	A	C	5	2	7	0	0	7	0	0
4	11733114	.	A	C	3	1	4	0	4	8	0	0
4	11733170	.	T	C	5	0	5	0	3	8	0	0
4	11733201	.	T	A	4	3	7	0	1	8	0	0
4	11733357	.	C	A	1	2	3	0	0	3	0	0
4	11733545	.	T	C	3	0	3	0	4	7	0	0
4	11733573	.	G	A	4	3	7	0	0	7	0	0
4	11733726	.	A	C	5	4	9	0	0	9	0	0
4	11733830	.	G	A	2	2	4	0	1	5	0	0
4	11733909	.	A	T	2	3	5	0	0	5	0	0
4	11734001	.	A	T	1	7	8	0	0	8	0	0
4	11734071	.	T	C	3	3	6	0	0	6	0	0
4	11734072	.	A	C	3	3	6	0	0	6	0	0
4	11734150	.	A	G	3	2	5	0	0	5	0	0
4	11734490	.	T	C	3	4	7	0	0	7	0	0
4	11734696	.	C	G	1	4	5	0	0	5	0	0
4	11765871	.	C	T	5	2	7	0	0	7	0	0
4	11780629	.	T	C	4	2	6	0	0	6	0	0
4	11804825	.	C	G	5	6	11	0	1	12	0	0
4	11804940	.	G	A	2	8	10	0	0	10	0	0
4	11805396	.	G	T	2	3	5	0	0	5	0	0
4	11805423	.	T	C	1	5	6	0	1	7	0	0
4	11806934	.	G	A	5	3	8	0	0	8	0	0
4	11806965	.	G	C	3	3	6	0	1	7	0	0
4	11810123	.	T	G	4	0	4	0	0	4	0	0
4	11810129	.	A	G	4	0	4	0	0	4	0	0
4	11814022	.	A	G	20	7	27	0	0	27	0	0
4	11814055	.	C	T	1	25	26	0	13	40	1	0
4	11814074	.	T	A	16	25	41	0	1	42	0	0
4	11814429	.	A	T	9	9	18	0	1	19	0	0
4	11814456	.	A	G	8	7	15	0	1	16	0	0
4	11814471	.	G	A	6	8	14	0	0	14	0	0
4	11814494	.	C	T	4	5	9	0	0	9	0	0
4	11814565	.	A	T	10	9	19	0	2	21	0	0
4	11814684	.	C	T	15	7	22	0	1	23	0	0
4	11814723	.	A	C	12	14	26	0	1	27	0	0
4	11815137	.	G	T	17	14	31	0	1	33	1	0
4	11815143	.	C	G	18	14	32	0	1	33	0	0
4	11815324	.	A	C	16	19	35	0	0	35	0	0
4	11815801	.	T	A	7	11	18	0	0	18	0	0
4	11816535	.	T	C	5	0	5	0	3	8	0	0
4	11818347	.	G	A	5	2	7	0	0	7	0	0
4	11818353	.	A	G	4	1	5	0	1	7	1	0
4	11827171	.	C	T	0	5	5	0	0	5	0	0
4	11841949	.	T	A	4	9	13	0	0	13	0	0
4	12006542	.	G	A	11	5	16	0	0	16	0	0
4	12006761	.	C	T	0	6	6	0	5	11	0	0
4	12007149	.	T	A	4	4	8	0	0	8	0	0
4	12013470	.	T	G	11	6	17	0	2	19	0	0
4	12013513	.	A	T	7	9	16	0	0	17	1	0
4	12020936	.	C	T	2	4	6	0	1	7	0	0
4	12021120	.	C	T	6	2	8	0	1	9	0	0
4	12021703	.	C	T	5	5	10	0	0	10	0	0
4	12021748	.	G	T	0	14	14	0	12	27	1	0
4	12022108	.	A	G	11	0	11	0	22	33	0	0
4	12022444	.	T	C	17	10	27	0	0	27	0	0
4	12023445	.	A	C	9	12	21	0	1	22	0	0
4	12025771	.	G	A	3	14	17	0	0	17	0	0
4	12026098	.	G	A	8	8	16	0	0	16	0	0
4	12026286	.	A	T	12	19	31	0	2	33	0	0
4	12026305	.	T	C	11	17	28	0	1	29	0	0
4	12026369	.	G	T	11	14	25	0	0	25	0	0
4	12026429	.	C	A	8	11	19	0	0	19	0	0
4	12078423	.	T	C	1	0	1	0	1	2	0	0
4	12080673	.	C	T	7	5	12	0	1	13	0	0
4	12080911	.	T	G	6	6	12	0	0	12	0	0
4	12087262	.	G	C	3	0	3	0	1	4	0	0
4	12091037	.	T	C	8	0	8	0	9	17	0	0
4	12091104	.	G	T	12	11	23	0	1	24	0	0
4	12103535	.	G	A	2	5	7	0	0	7	0	0
4	12103619	.	T	C	3	0	3	0	4	7	0	0
4	12103840	.	G	T	3	1	4	0	0	4	0	0
4	12103911	.	A	T	1	5	6	0	2	8	0	0
4	12103964	.	T	A	6	18	24	0	1	25	0	0
4	12106000	.	G	C	8	0	8	0	4	12	0	0
4	12111399	.	G	A	4	4	8	0	1	9	0	0
4	12113128	.	C	T	2	3	5	0	0	5	0	0
4	12234792	.	A	G	15	7	22	0	0	22	0	0
4	12235922	.	A	G	8	4	12	0	0	12	0	0
4	12235934	.	A	G	6	8	14	0	0	14	0	0
4	12236452	.	A	G	12	6	18	0	3	21	0	0
4	12236495	.	A	G	10	0	10	0	10	20	0	0
4	12236496	.	A	G	15	4	19	0	1	20	0	0
4	12679190	.	C	T	1	3	4	0	0	4	0	0
4	12902609	.	G	A	0	1	1	0	0	1	0	0
4	12917237	.	G	T	12	9	21	0	0	21	0	0
4	12917348	.	A	G	6	5	11	0	0	11	0	0
4	12917534	.	C	T	0	11	11	0	3	14	0	0
4	12921893	.	T	C	4	0	4	0	4	8	0	0
4	12929147	.	C	T	0	3	3	0	9	12	0	0
4	12971436	.	A	G	14	20	34	0	0	34	0	0
4	12971495	.	C	A	21	16	37	0	0	37	0	0
4	12971935	.	A	T	19	7	26	0	1	27	0	0
4	12972000	.	T	A	17	10	27	0	0	27	0	0
4	12972017	.	T	A	20	10	30	0	1	31	0	0
4	12972215	.	C	T	0	27	27	0	18	45	0	0
4	12976735	.	G	A	9	5	14	0	3	17	0	0
4	12976983	.	T	C	14	0	14	1	13	28	0	0
4	12978779	.	G	A	11	11	22	0	1	23	0	0
4	12978843	.	A	C	23	17	40	0	0	40	0	0
4	13035881	.	A	G	17	12	29	0	1	30	0	0
4	13035962	.	T	C	14	15	29	0	0	29	0	0
4	13036046	.	G	A	18	17	35	0	0	35	0	0
4	13036572	.	G	A	12	10	22	0	1	23	0	0
4	13041589	.	C	T	0	6	6	0	3	9	0	0
4	13054610	.	G	A	1	1	2	0	0	2	0	0
4	13056441	.	G	A	9	5	14	0	0	14	0	0
4	13138021	.	T	C	6	5	11	0	0	11	0	0
4	13419775	.	G	C	0	5	5	0	8	13	0	0
4	13424839	.	G	A	12	21	33	0	3	36	0	0
4	13424968	.	A	C	9	9	18	0	0	18	0	0
4	13453445	.	T	C	4	6	10	0	0	10	0	0
4	13457965	.	A	G	4	6	10	0	0	10	0	0
4	13458010	.	T	C	6	5	11	0	0	11	0	0
4	13458187	.	A	T	5	2	7	0	0	7	0	0
4	13458241	.	C	G	4	4	8	0	3	11	0	0
4	13458627	.	A	C	8	6	14	0	0	14	0	0
4	13458888	.	G	A	0	2	2	0	8	10	0	0
4	13458961	.	A	T	3	2	5	0	1	6	0	0
4	13459670	.	A	G	3	4	7	0	1	8	0	0
4	13459753	.	G	T	9	4	13	0	0	13	0	0
4	13459823	.	G	A	5	6	11	0	1	12	0	0
4	13460937	.	T	C	5	7	12	0	0	12	0	0
4	13461007	.	G	T	7	14	21	0	0	21	0	0
4	13461031	.	T	C	8	13	21	0	1	22	0	0
4	13461312	.	A	T	3	5	8	0	1	9	0	0
4	13461328	.	T	A	3	4	7	0	3	10	0	0
4	13551447	.	G	A	1	2	3	0	0	3	0	0
4	13555289	.	C	G	3	1	4	0	0	4	0	0
4	13557934	.	G	T	1	1	2	0	0	2	0	0
4	13557947	.	G	A	1	1	2	0	0	2	0	0
4	13558039	.	G	C	0	0	0	0	2	2	0	0
4	13570609	.	G	A	3	5	8	0	1	9	0	0
4	13570899	.	T	C	1	2	3	0	0	3	0	0
4	13571711	.	T	C	5	11	16	0	0	16	0	0
4	13572951	.	G	A	1	5	6	0	10	16	0	0
4	13575521	.	C	T	2	5	7	0	3	10	0	0
4	13575570	.	A	G	3	1	4	0	8	12	0	0
4	13575618	.	G	A	0	9	9	0	7	16	0	0
4	13575623	.	A	G	7	7	14	0	0	14	0	0
4	13575672	.	A	G	5	1	6	0	8	14	0	0
4	13575701	.	C	T	2	6	8	0	0	8	0	0
4	13575709	.	A	C	1	5	6	0	0	6	0	0
4	13575757	.	T	A	2	2	4	0	0	4	0	0
4	13575826	.	G	A	5	2	7	0	1	8	0	0
4	13575828	.	A	C	5	2	7	0	1	8	0	0
4	13575996	.	C	T	6	16	22	0	0	22	0	0
4	13576105	.	G	T	8	5	13	0	1	14	0	0
4	13576139	.	G	A	0	3	3	0	4	7	0	0
4	13589685	.	C	T	4	7	11	0	0	11	0	0
4	13589787	.	G	A	3	4	7	0	0	7	0	0
4	13591793	.	A	G	5	4	9	0	3	12	0	0
4	13593060	.	G	A	0	10	10	0	5	15	0	0
4	13593078	.	T	C	6	5	11	0	0	11	0	0
4	13593309	.	A	G	4	1	5	0	1	6	0	0
4	13597529	.	T	A	1	1	2	0	0	2	0	0
4	13597547	.	A	G	1	2	3	0	1	4	0	0
4	13597646	.	A	G	3	1	4	0	1	5	0	0
4	13597782	.	C	G	2	0	2	0	3	5	0	0
4	13597849	.	C	T	2	4	6	0	0	6	0	0
4	13599365	.	G	T	4	3	7	0	0	7	0	0
4	13599410	.	C	T	4	2	6	0	0	6	0	0
4	13599570	.	A	G	4	0	4	0	5	9	0	0
4	13599840	.	C	T	12	4	16	0	1	17	0	0
4	13604574	.	T	C	17	19	36	0	0	36	0	0
4	13626695	.	T	C	1	2	3	0	0	3	0	0
4	13629927	.	T	G	7	8	15	0	1	16	0	0
4	13631308	.	C	T	8	7	15	0	0	15	0	0
4	13642715	.	A	T	11	10	21	0	1	22	0	0
4	13643251	.	G	T	0	9	9	0	4	13	0	0
4	13643418	.	C	G	3	5	8	0	0	8	0	0
4	13643427	.	G	A	3	5	8	0	0	8	0	0
4	13696609	.	G	T	6	2	8	0	0	8	0	0
4	13702400	.	C	T	5	8	13	0	0	13	0	0
4	13702490	.	C	T	2	1	3	0	0	3	0	0
4	13706138	.	G	A	5	9	14	0	0	14	0	0
4	13707603	.	G	A	2	1	3	0	0	3	0	0
4	13709490	.	T	G	0	1	1	0	0	1	0	0
4	13710585	.	G	T	0	0	0	0	1	1	0	0
4	13710868	.	T	C	2	1	3	0	0	3	0	0
4	13713042	.	A	G	6	9	15	0	2	17	0	0
4	13714183	.	G	A	3	2	5	0	0	5	0	0
4	13716481	.	C	G	3	3	6	0	0	6	0	0
4	13723458	.	C	T	9	5	14	0	0	14	0	0
4	13724578	.	G	A	2	1	3	0	0	3	0	0
4	13724581	.	T	C	2	1	3	0	0	3	0	0
4	13728097	.	T	C	1	3	4	0	0	4	0	0
4	13742550	.	A	G	6	0	6	0	6	12	0	0
4	13742619	.	A	G	8	19	27	0	0	27	0	0
4	13742827	.	A	G	4	2	6	0	0	6	0	0
4	13744441	.	T	C	7	3	10	0	1	11	0	0
4	13744451	.	C	A	7	4	11	0	1	12	0	0
4	13744591	.	T	A	3	1	4	0	0	4	0	0
4	13744717	.	G	A	4	3	7	0	0	7	0	0
4	13747503	.	C	T	2	9	11	0	0	11	0	0
4	13747566	.	A	C	6	15	21	0	0	21	0	0
4	13748217	.	C	T	7	12	19	0	2	21	0	0
4	13748250	.	T	C	6	8	14	0	1	15	0	0
4	13748521	.	T	G	12	9	21	0	1	22	0	0
4	13750453	.	T	A	10	17	27	0	1	28	0	0
4	13753561	.	A	T	2	4	6	0	0	6	0	0
4	13753717	.	C	T	13	6	19	0	0	19	0	0
4	13753738	.	C	G	6	1	7	0	1	8	0	0
4	13753864	.	T	C	10	10	20	0	1	21	0	0
4	13754405	.	C	T	16	18	34	0	1	35	0	0
4	13754456	.	A	C	10	23	33	0	1	34	0	0
4	13755254	.	T	G	12	11	23	0	5	28	0	0
4	13755307	.	C	A	13	6	19	0	0	19	0	0
4	13755320	.	C	G	16	0	16	0	8	24	0	0
4	13755455	.	A	T	17	12	29	0	1	30	0	0
4	13755476	.	G	T	15	12	27	0	1	28	0	0
4	13755521	.	T	A	10	12	22	0	0	22	0	0
4	13755551	.	C	T	9	6	15	0	0	15	0	0
4	13755805	.	C	G	10	13	23	0	0	23	0	0
4	13755896	.	G	A	12	19	31	0	1	32	0	0
4	13756203	.	A	C	5	7	12	0	6	18	0	0
4	13756222	.	T	G	9	11	20	0	1	21	0	0
4	13756324	.	T	C	7	16	23	0	1	24	0	0
4	13756481	.	C	A	4	7	11	0	0	11	0	0
4	13756508	.	T	G	3	0	3	0	4	7	0	0
4	13810875	.	C	T	3	5	8	0	0	8	0	0
4	13810885	.	A	C	3	7	10	0	0	10	0	0
4	13810947	.	G	A	0	4	4	0	2	6	0	0
4	13810958	.	T	A	1	2	3	0	0	4	1	0
4	13847775	.	G	A	1	1	2	0	0	2	0	0
4	13905730	.	T	C	4	0	4	0	2	6	0	0
4	13905846	.	A	G	3	4	7	0	2	9	0	0
4	13905860	.	G	A	3	6	9	0	0	9	0	0
4	13905985	.	C	T	8	7	15	0	1	16	0	0
4	13906171	.	T	G	2	7	9	0	0	9	0	0
4	13906217	.	G	T	2	12	14	0	0	14	0	0
4	13906547	.	G	C	5	3	8	0	0	8	0	0
4	13906567	.	A	G	6	6	12	0	0	12	0	0
4	13906766	.	G	A	16	15	31	0	0	31	0	0
4	13906847	.	C	T	0	12	12	0	15	27	0	0
4	13925593	.	T	C	9	0	9	0	8	17	0	0
4	13929511	.	A	G	1	0	1	0	0	1	0	0
4	13931460	.	T	A	3	2	5	0	0	5	0	0
4	13931831	.	T	A	2	3	5	0	0	5	0	0
4	13931846	.	G	A	2	2	4	0	1	5	0	0
4	13935669	.	T	C	4	6	10	0	0	10	0	0
4	13943890	.	A	T	4	1	5	0	0	5	0	0
4	13943911	.	T	A	6	3	9	0	0	9	0	0
4	13944129	.	T	A	2	6	8	0	0	9	1	0
4	13950946	.	C	T	1	0	1	0	0	1	0	0
4	13953957	.	C	A	3	2	5	0	0	5	0	0
4	13963045	.	T	C	12	5	17	0	1	18	0	0
4	13963202	.	T	A	3	2	5	0	0	5	0	0
4	13964085	.	A	G	0	2	2	0	0	2	0	0
4	13964366	.	G	A	1	7	8	0	0	8	0	0
4	13964769	.	A	T	5	2	7	0	0	7	0	0
4	13964865	.	G	A	2	6	8	0	0	8	0	0
4	13965245	.	A	G	2	2	4	0	0	4	0	0
4	13965824	.	T	G	4	2	6	0	0	6	0	0
4	13966709	.	C	T	0	1	1	0	0	1	0	0
4	13966829	.	G	A	1	2	3	0	0	3	0	0
4	13995677	.	T	C	1	2	3	0	0	3	0	0
4	14193512	.	T	C	6	0	6	0	7	13	0	0
4	14194426	.	G	A	4	5	9	0	2	11	0	0
4	14194650	.	G	A	3	2	5	0	0	5	0	0
4	14196368	.	T	C	6	2	8	0	0	8	0	0
4	14198342	.	C	A	2	5	7	0	0	7	0	0
4	14205253	.	A	T	4	6	10	0	0	10	0	0
4	14248043	.	A	G	31	24	55	0	0	55	0	0
4	14248128	.	G	A	35	19	54	0	2	56	0	0
4	14248157	.	G	A	38	22	60	0	1	61	0	0
4	14248277	.	A	T	31	25	56	0	2	58	0	0
4	14248279	.	G	A	31	26	57	0	1	58	0	0
4	14248419	.	T	C	31	2	33	4	20	57	0	0
4	14248433	.	A	T	30	18	48	4	0	52	0	0
4	14248615	.	T	A	32	26	58	0	1	59	0	0
4	14248700	.	C	G	24	36	60	0	0	60	0	0
4	14249544	.	G	T	19	18	37	0	0	37	0	0
4	14249583	.	A	T	10	13	23	0	0	23	0	0
4	14249649	.	T	C	8	4	12	0	2	14	0	0
4	14249799	.	T	C	10	17	27	0	1	28	0	0
4	14249984	.	T	G	20	20	40	0	9	49	0	0
4	14250024	.	T	A	11	15	26	0	7	33	0	0
4	14250831	.	G	A	11	30	41	0	1	42	0	0
4	14250840	.	T	C	10	0	10	0	21	31	0	0
4	14282192	.	G	T	1	2	3	0	0	3	0	0
4	14282244	.	A	G	16	16	32	0	2	34	0	0
4	14303321	.	A	G	20	23	43	0	2	45	0	0
4	14305901	.	G	A	18	10	28	0	1	29	0	0
4	14315713	.	T	A	3	3	6	0	0	6	0	0
4	14328925	.	A	G	13	4	17	0	0	17	0	0
4	14348492	.	C	T	6	3	9	0	0	9	0	0
4	14348510	.	A	C	7	3	10	0	0	10	0	0
4	14348562	.	A	C	2	2	4	0	0	4	0	0
4	14369527	.	T	G	4	1	5	0	0	5	0	0
4	14370932	.	C	T	6	3	9	0	1	10	0	0
4	14372509	.	A	T	8	13	21	0	3	24	0	0
4	14372610	.	C	A	8	10	18	0	0	18	0	0
4	14372785	.	C	T	17	14	31	0	1	32	0	0
4	14433948	.	C	T	0	2	2	0	3	5	0	0
4	14444836	.	G	A	3	4	7	0	2	9	0	0
4	14444846	.	C	T	6	3	9	0	3	12	0	0
4	14444878	.	G	A	7	3	10	0	0	10	0	0
4	14444881	.	C	G	7	3	10	0	0	10	0	0
4	14449276	.	A	C	2	3	5	0	0	5	0	0
4	14449297	.	G	A	3	4	7	0	0	7	0	0
4	14449492	.	G	C	5	1	6	0	13	19	0	0
4	14449762	.	T	A	7	8	15	0	0	15	0	0
4	14449795	.	T	C	4	4	8	0	0	8	0	0
4	14450330	.	T	C	3	1	4	0	5	9	0	0
4	14450355	.	A	T	3	5	8	0	0	8	0	0
4	14450377	.	T	C	2	3	5	0	0	5	0	0
4	14450501	.	G	A	3	10	13	0	0	13	0	0
4	14450634	.	A	T	0	6	6	0	1	7	0	0
4	14456539	.	G	A	1	1	2	0	0	2	0	0
4	14466078	.	A	G	2	1	3	0	0	3	0	0
4	14466213	.	T	G	6	0	6	0	0	6	0	0
4	14467771	.	C	G	2	1	3	0	0	3	0	0
4	14469803	.	T	C	1	2	3	0	0	3	0	0
4	14471761	.	T	G	0	2	2	0	0	2	0	0
4	14477720	.	G	C	1	0	1	0	0	1	0	0
4	14477722	.	A	G	1	0	1	0	0	1	0	0
4	14485525	.	A	G	1	2	3	0	0	3	0	0
4	14665050	.	T	A	2	1	3	0	0	3	0	0
4	14667035	.	C	T	1	2	3	0	0	3	0	0
4	14676139	.	T	G	1	0	1	0	1	2	0	0
4	14692667	.	C	T	2	1	3	0	0	3	0	0
4	14692931	.	T	C	0	1	1	0	0	1	0	0
4	14700843	.	A	T	2	0	2	0	0	2	0	0
4	14702044	.	T	C	2	4	6	0	0	6	0	0
4	14711899	.	A	G	3	4	7	0	0	7	0	0
4	14711984	.	G	T	1	1	2	0	0	2	0	0
4	14728640	.	T	A	7	9	16	0	1	17	0	0
4	14734276	.	A	T	9	4	13	0	0	13	0	0
4	14734336	.	C	T	13	13	26	0	0	26	0	0
4	14736369	.	G	A	13	13	26	0	1	27	0	0
4	14736506	.	G	T	4	2	6	0	0	6	0	0
4	14736546	.	C	T	2	2	4	0	0	4	0	0
4	14826305	.	G	A	7	4	11	0	0	11	0	0
4	14844000	.	T	C	2	3	5	0	0	5	0	0
4	14863210	.	T	C	4	3	7	0	0	7	0	0
4	14863321	.	A	C	4	8	12	0	2	14	0	0
4	14863363	.	C	T	7	8	15	0	0	15	0	0
4	14895902	.	T	C	3	2	5	0	0	5	0	0
4	14896440	.	T	C	4	7	11	0	0	11	0	0
4	14905622	.	G	A	2	0	2	0	0	2	0	0
4	14906746	.	C	G	7	3	10	0	2	12	0	0
4	14906767	.	G	A	9	4	13	0	0	13	0	0
4	14906795	.	G	T	10	3	13	0	0	13	0	0
4	14906991	.	T	G	8	8	16	0	0	16	0	0
4	14906993	.	C	A	8	8	16	0	0	16	0	0
4	14907046	.	G	A	4	2	6	0	1	7	0	0
4	14907047	.	A	T	4	3	7	0	0	7	0	0
4	14907103	.	A	G	4	2	6	0	1	7	0	0
4	14909287	.	G	C	0	2	2	0	0	2	0	0
4	14912823	.	A	G	3	0	3	0	0	3	0	0
4	14912826	.	G	A	3	0	3	0	0	3	0	0
4	14912950	.	G	A	1	0	1	0	0	1	0	0
4	14918590	.	C	A	0	1	1	0	0	1	0	0
4	14919877	.	T	C	2	5	7	0	0	7	0	0
4	14920763	.	A	G	4	2	6	0	0	6	0	0
4	14925742	.	A	G	1	5	6	0	0	6	0	0
4	14926096	.	G	A	1	0	1	0	0	1	0	0
4	14926967	.	C	T	14	11	25	0	1	26	0	0
4	14928719	.	C	T	1	4	5	0	1	6	0	0
4	14928731	.	G	A	3	7	10	0	0	10	0	0
4	14929107	.	T	G	6	6	12	0	0	12	0	0
4	14931446	.	G	A	17	17	34	0	0	34	0	0
4	14932200	.	T	C	13	15	28	0	0	28	0	0
4	14932821	.	G	C	10	3	13	0	1	14	0	0
4	14932915	.	C	G	3	6	9	0	1	10	0	0
4	14933444	.	A	T	8	3	11	0	0	11	0	0
4	14933446	.	G	C	7	3	10	0	1	11	0	0
4	14933567	.	C	T	0	5	5	0	5	10	0	0
4	14933750	.	G	A	0	6	6	0	0	6	0	0
4	14933768	.	C	G	0	1	1	0	0	1	0	0
4	14951465	.	A	G	2	3	5	0	0	5	0	0
4	14954007	.	A	T	3	2	5	0	0	5	0	0
4	14954012	.	C	T	1	2	3	0	2	5	0	0
4	14977456	.	C	T	1	2	3	0	0	3	0	0
4	14991806	.	A	G	8	10	18	0	1	19	0	0
4	14992059	.	T	A	9	4	13	0	0	13	0	0
4	14992080	.	A	G	5	4	9	0	0	9	0	0
4	14992142	.	G	C	4	2	6	0	0	6	0	0
4	14992257	.	T	A	5	6	11	0	1	12	0	0
4	14992324	.	C	A	3	8	11	0	1	12	0	0
4	14992353	.	T	C	2	8	10	0	0	10	0	0
4	14992426	.	T	C	3	5	8	0	0	8	0	0
4	14992452	.	A	G	2	8	10	0	0	10	0	0
4	14992529	.	T	C	13	6	19	0	0	19	0	0
4	14992723	.	T	C	6	4	10	0	0	10	0	0
4	14992774	.	G	C	6	8	14	0	0	14	0	0
4	14992838	.	A	T	3	3	6	0	0	6	0	0
4	14992902	.	G	A	3	7	10	0	0	10	0	0
4	14992910	.	T	C	4	0	4	0	4	8	0	0
4	14993263	.	A	C	7	7	14	0	0	14	0	0
4	15003761	.	G	A	4	7	11	0	0	11	0	0
4	15007968	.	A	G	0	1	1	0	0	1	0	0
4	15008565	.	A	G	3	0	3	0	2	5	0	0
4	15009332	.	G	C	4	4	8	0	0	8	0	0
4	15009874	.	T	C	1	3	4	0	0	4	0	0
4	15010386	.	G	A	0	4	4	0	3	7	0	0
4	15010584	.	T	G	3	10	13	0	0	13	0	0
4	15010680	.	A	G	5	6	11	0	0	11	0	0
4	15010789	.	T	A	1	4	5	0	0	5	0	0
4	15058352	.	A	G	21	19	40	0	1	41	0	0
4	15058663	.	A	C	12	10	22	1	1	24	0	0
4	15058968	.	T	G	10	3	13	0	17	30	0	0
4	15059028	.	G	A	0	9	9	0	12	21	0	0
4	15059070	.	A	T	14	12	26	0	0	26	0	0
4	15059147	.	A	G	16	11	27	0	1	28	0	0
4	15059367	.	A	G	15	2	17	0	0	17	0	0
4	15059498	.	T	A	16	16	32	0	0	32	0	0
4	15059823	.	A	T	17	20	37	0	1	38	0	0
4	15081490	.	C	T	5	3	8	0	0	8	0	0
4	15081703	.	G	A	12	13	25	0	1	26	0	0
4	15081829	.	T	C	12	11	23	0	0	23	0	0
4	15081871	.	C	T	8	13	21	0	1	22	0	0
4	15081985	.	T	C	9	12	21	0	1	22	0	0
4	15082573	.	C	G	3	6	9	0	0	10	1	0
4	15096627	.	A	G	12	10	22	0	0	22	0	0
4	15100365	.	C	T	1	2	3	0	0	3	0	0
4	15218134	.	T	C	13	0	13	0	10	23	0	0
4	15218258	.	A	G	11	18	29	0	2	31	0	0
4	15218342	.	T	A	15	27	42	0	2	44	0	0
4	15218389	.	C	T	16	20	36	0	0	36	0	0
4	15218505	.	C	T	11	18	29	0	1	30	0	0
4	15218595	.	T	C	4	5	9	0	1	10	0	0
4	15218656	.	G	A	11	14	25	0	0	25	0	0
4	15218772	.	C	A	15	15	30	0	0	30	0	0
4	15218886	.	A	C	14	10	24	0	0	24	0	0
4	15219291	.	G	A	16	16	32	0	2	34	0	0
4	15219368	.	C	T	0	18	18	0	14	32	0	0
4	15219533	.	T	A	12	16	28	0	1	29	0	0
4	15219787	.	T	C	16	10	26	0	0	26	0	0
4	15219840	.	G	T	16	13	29	0	1	30	0	0
4	15219955	.	G	A	22	22	44	0	0	44	0	0
4	15220001	.	A	T	21	17	38	0	1	39	0	0
4	15220022	.	A	G	20	10	30	0	0	30	0	0
4	15220467	.	T	G	8	10	18	0	1	19	0	0
4	15238347	.	G	A	7	5	12	0	1	13	0	0
4	15247902	.	A	T	1	2	3	0	0	3	0	0
4	15250568	.	C	T	5	3	8	0	0	8	0	0
4	15500617	.	G	T	2	0	2	0	0	2	0	0
4	15500663	.	T	C	4	0	4	0	5	9	0	0
4	15585852	.	G	T	1	0	1	0	0	1	0	0
4	15600824	.	G	A	6	2	8	0	0	8	0	0
4	15601126	.	C	T	0	2	2	0	10	12	0	0
4	15603487	.	G	C	7	4	11	0	0	11	0	0
4	15630128	.	A	G	0	2	2	0	1	3	0	0
4	15630131	.	G	A	1	2	3	0	0	3	0	0
4	15636947	.	A	G	5	2	7	0	0	7	0	0
4	15775430	.	G	A	3	10	13	0	1	14	0	0
4	15795098	.	G	A	6	7	13	0	0	13	0	0
4	15799413	.	G	A	7	11	18	0	0	18	0	0
4	15799452	.	G	T	4	7	11	0	0	11	0	0
4	15799488	.	T	C	3	2	5	0	0	5	0	0
4	15816414	.	G	A	0	10	10	0	10	20	0	0
4	15833476	.	C	A	0	3	3	0	0	3	0	0
4	15981260	.	A	G	18	11	29	1	0	30	0	0
4	15981266	.	C	T	20	11	31	1	1	33	0	0
4	15981362	.	T	C	8	18	26	0	1	27	0	0
4	15981428	.	C	T	9	14	23	0	1	24	0	0
4	15984753	.	C	T	0	1	1	0	0	1	0	0
4	15989142	.	G	A	0	1	1	0	2	3	0	0
4	15989313	.	A	C	1	4	5	0	0	5	0	0
4	15989643	.	T	C	4	4	8	0	0	8	0	0
4	15989661	.	A	G	1	2	3	0	0	3	0	0
4	15989988	.	C	T	12	8	20	0	0	20	0	0
4	15991026	.	C	T	10	8	18	0	0	18	0	0
4	15992146	.	G	A	15	23	38	0	0	38	0	0
4	15992206	.	T	C	16	19	35	0	0	35	0	0
4	15993801	.	C	T	2	6	8	0	0	8	0	0
4	15993917	.	G	C	6	1	7	0	0	7	0	0
4	15993959	.	C	T	14	6	20	0	0	20	0	0
4	15995876	.	A	G	16	11	27	0	1	28	0	0
4	15996044	.	T	C	14	7	21	0	0	21	0	0
4	15996066	.	C	G	13	6	19	0	1	20	0	0
4	15998315	.	A	T	2	0	2	0	0	2	0	0
4	16001060	.	T	A	3	4	7	0	0	7	0	0
4	16077260	.	T	C	14	15	29	0	3	32	0	0
4	16078080	.	A	T	16	12	28	0	1	29	0	0
4	16078203	.	C	T	30	19	49	0	0	49	0	0
4	16078979	.	A	G	25	17	42	0	0	42	0	0
4	16081306	.	G	T	21	17	38	0	2	40	0	0
4	16085420	.	T	G	18	17	35	0	2	37	0	0
4	16086969	.	A	G	2	3	5	0	0	5	0	0
4	16086987	.	C	G	5	8	13	0	0	13	0	0
4	16087595	.	T	G	10	8	18	0	0	18	0	0
4	16088528	.	C	T	10	11	21	0	0	21	0	0
4	16088622	.	T	C	10	0	10	0	13	23	0	0
4	16088673	.	C	T	3	6	9	0	0	9	0	0
4	16090262	.	A	G	2	11	13	0	0	13	0	0
4	16098903	.	A	C	15	17	32	0	1	33	0	0
4	16098930	.	C	T	4	10	14	0	0	14	0	0
4	16111890	.	A	T	13	10	23	0	2	25	0	0
4	16112013	.	C	T	9	10	19	0	0	19	0	0
4	16632353	.	G	A	10	3	13	0	0	13	0	0
4	16633451	.	T	C	8	5	13	0	0	13	0	0
4	16791673	.	C	A	0	5	5	0	0	5	0	0
4	16982845	.	C	A	8	2	10	0	0	10	0	0
4	17873930	.	C	T	1	3	4	0	1	5	0	0
4	18208068	.	A	G	8	8	16	0	0	16	0	0
4	18208215	.	C	T	11	14	25	0	0	25	0	0
4	18208814	.	A	G	2	8	10	0	0	10	0	0
4	18208939	.	C	T	9	4	13	0	1	14	0	0
4	18209084	.	G	A	8	3	11	0	0	11	0	0
4	18235114	.	T	C	1	6	7	0	0	7	0	0
4	18235140	.	A	G	0	4	4	0	0	4	0	0
4	18240451	.	G	A	2	2	4	0	1	5	0	0
4	18240464	.	C	A	3	2	5	0	1	6	0	0
4	18240536	.	G	T	2	7	9	0	0	9	0	0
4	18240607	.	C	A	0	4	4	0	2	6	0	0
4	18240811	.	G	A	2	2	4	0	0	4	0	0
4	18240907	.	G	A	1	5	6	0	0	6	0	0
4	18241030	.	A	G	2	2	4	0	0	4	0	0
4	18241297	.	C	T	6	5	11	0	0	11	0	0
4	18241378	.	C	G	1	7	8	0	3	11	0	0
4	18244669	.	G	A	2	0	2	0	0	2	0	0
4	18244670	.	G	C	2	0	2	0	0	2	0	0
4	18248692	.	C	T	0	4	4	0	6	10	0	0
4	18249120	.	G	C	1	4	5	0	0	5	0	0
4	18249414	.	T	C	2	1	3	0	0	3	0	0
4	18249423	.	G	T	2	1	3	0	0	3	0	0
4	18251316	.	T	C	0	2	2	0	0	2	0	0
4	18253992	.	C	T	0	1	1	0	0	1	0	0
4	18283025	.	C	T	1	3	4	0	0	4	0	0
4	18283111	.	A	G	1	2	3	0	0	3	0	0
4	18287467	.	A	G	1	6	7	0	0	7	0	0
4	18296099	.	T	C	2	0	2	0	2	4	0	0
4	18296126	.	T	C	2	1	3	0	0	3	0	0
4	18383328	.	G	A	2	2	4	0	0	4	0	0
4	18416486	.	A	T	1	2	3	0	0	3	0	0
4	18432189	.	A	T	1	2	3	0	0	3	0	0
4	18432295	.	A	T	3	3	6	0	0	6	0	0
4	18432317	.	T	C	2	2	4	0	0	4	0	0
4	18432363	.	G	T	0	3	3	0	0	3	0	0
4	18432599	.	A	T	4	8	12	0	0	12	0	0
4	18432790	.	C	A	3	2	5	0	0	5	0	0
4	18436614	.	T	C	2	2	4	0	0	4	0	0
4	18453875	.	T	A	3	3	6	0	0	6	0	0
4	18454423	.	G	A	7	2	9	0	0	9	0	0
4	18454583	.	T	C	1	0	1	0	0	1	0	0
4	18497679	.	T	A	2	1	3	0	0	3	0	0
4	18497681	.	G	A	2	1	3	0	0	3	0	0
4	18502494	.	C	T	3	2	5	0	0	5	0	0
4	18504505	.	T	A	1	2	3	0	0	3	0	0
4	18508230	.	C	T	0	1	1	0	0	1	0	0
4	18510478	.	C	T	1	1	2	0	0	2	0	0
4	18595520	.	T	A	2	2	4	0	0	4	0	0
4	18597685	.	C	T	0	3	3	0	0	3	0	0
4	18599118	.	C	T	1	1	2	0	0	2	0	0
4	18599126	.	T	A	1	3	4	0	0	4	0	0
4	18599283	.	C	T	1	2	3	0	0	3	0	0
4	18599482	.	T	A	1	2	3	0	0	3	0	0
4	18609636	.	T	C	4	0	4	0	7	11	0	0
4	18609769	.	A	G	0	4	4	0	0	4	0	0
4	18609855	.	G	C	6	5	11	0	0	11	0	0
4	18610030	.	G	A	5	8	13	0	1	14	0	0
4	18614484	.	G	A	1	1	2	0	0	2	0	0
4	18720905	.	C	T	4	3	7	0	0	7	0	0
4	18733596	.	G	A	2	1	3	0	0	3	0	0
4	18836957	.	A	T	3	7	10	0	0	10	0	0
4	18837307	.	T	C	1	7	8	0	4	12	0	0
4	18837559	.	C	T	0	11	11	0	13	24	0	0
4	18837561	.	T	G	13	11	24	0	0	24	0	0
4	18838057	.	C	T	6	2	8	0	0	8	0	0
4	18838857	.	G	A	2	0	2	0	0	2	0	0
4	18839942	.	G	A	7	7	14	0	0	14	0	0
4	18839957	.	C	T	5	7	12	0	0	12	0	0
4	18846932	.	G	A	2	2	4	0	0	4	0	0
4	18850786	.	A	T	1	1	2	0	0	2	0	0
4	18851145	.	T	C	1	2	3	0	0	3	0	0
4	18851149	.	A	T	1	2	3	0	0	3	0	0
4	18852954	.	T	A	2	2	4	0	0	4	0	0
4	18853815	.	A	G	11	14	25	0	1	26	0	0
4	18853972	.	C	G	6	12	18	0	1	19	0	0
4	18854250	.	A	C	10	0	10	0	17	27	0	0
4	18854417	.	T	A	3	7	10	0	4	14	0	0
4	18854519	.	A	C	7	2	9	0	1	10	0	0
4	18854525	.	A	C	9	3	12	0	0	12	0	0
4	18953471	.	T	A	1	1	2	0	1	3	0	0
4	18967321	.	C	T	2	3	5	0	0	5	0	0
4	18976574	.	C	T	1	2	3	0	0	3	0	0
4	18979820	.	T	A	5	4	9	0	0	9	0	0
4	18981945	.	A	G	4	5	9	0	0	9	0	0
4	18984234	.	A	C	12	16	28	0	3	31	0	0
4	18984588	.	A	G	12	8	20	0	0	20	0	0
4	18984628	.	G	A	11	6	17	0	1	18	0	0
4	18984902	.	G	A	0	5	5	0	1	6	0	0
4	18984939	.	C	T	1	4	5	0	0	5	0	0
4	18984950	.	A	T	6	3	9	0	0	9	0	0
4	18984999	.	T	C	8	2	10	0	2	12	0	0
4	18985048	.	A	T	1	8	9	0	0	9	0	0
4	18985142	.	G	A	9	7	16	0	0	16	0	0
4	18985206	.	T	C	6	11	17	0	1	18	0	0
4	18985216	.	T	C	5	15	20	0	0	20	0	0
4	18985327	.	A	C	6	4	10	0	0	10	0	0
4	18985406	.	G	T	0	7	7	0	3	10	0	0
4	18985730	.	G	A	10	7	17	0	0	17	0	0
4	18986413	.	G	A	12	12	24	0	2	26	0	0
4	18986497	.	C	T	0	14	14	0	9	23	0	0
4	18986754	.	T	C	6	6	12	0	0	12	0	0
4	18986805	.	G	T	13	5	18	0	0	18	0	0
4	18986873	.	C	T	5	6	11	0	1	12	0	0
4	18986893	.	C	G	4	7	11	0	0	11	0	0
4	18986997	.	G	A	1	6	7	0	0	7	0	0
4	18987202	.	C	A	4	5	9	0	1	10	0	0
4	18987250	.	G	A	8	5	13	0	1	14	0	0
4	18987391	.	G	A	11	5	16	0	0	16	0	0
4	18988651	.	G	A	6	5	11	0	0	11	0	0
4	18988912	.	G	A	8	5	13	0	1	14	0	0
4	18989253	.	T	G	4	4	8	0	2	10	0	0
4	18989389	.	G	A	1	2	3	0	0	3	0	0
4	18999680	.	C	T	1	2	3	0	4	7	0	0
4	19007187	.	C	T	0	5	5	0	5	10	0	0
4	19007357	.	C	T	0	9	9	0	4	13	0	0
4	19007377	.	T	A	8	5	13	0	1	14	0	0
4	19007506	.	T	C	7	0	7	0	11	18	0	0
4	19007615	.	G	A	7	11	18	0	0	18	0	0
4	19007811	.	T	C	7	9	16	0	0	16	0	0
4	19007823	.	A	G	7	7	14	0	0	14	0	0
4	19397640	.	A	T	10	12	22	0	1	23	0	0
4	19397641	.	A	T	14	8	22	0	1	23	0	0
4	19414905	.	G	A	3	1	4	0	0	4	0	0
4	19493773	.	G	T	5	13	18	0	0	18	0	0
4	19535360	.	T	A	11	8	19	0	1	20	0	0
4	19535841	.	T	G	15	15	30	0	1	31	0	0
4	19536344	.	A	T	13	11	24	0	0	24	0	0
4	19536554	.	A	T	13	16	29	0	0	29	0	0
4	19536953	.	C	T	16	22	38	0	3	41	0	0
4	19536959	.	G	A	16	23	39	0	3	42	0	0
4	19537268	.	G	A	1	22	23	0	29	52	0	0
4	19537703	.	A	G	20	31	51	0	0	51	0	0
4	19537937	.	A	G	27	0	27	0	29	56	0	0
4	19538578	.	A	T	16	22	38	0	7	45	0	0
4	19539017	.	C	T	12	4	16	0	1	17	0	0
4	19611670	.	C	T	0	0	0	0	1	1	0	0
4	19611694	.	G	A	3	7	10	0	1	11	0	0
4	19611739	.	T	G	7	8	15	0	0	15	0	0
4	19611769	.	G	A	1	3	4	0	0	4	0	0
4	19651917	.	G	A	2	0	2	0	0	2	0	0
4	19664993	.	T	C	3	0	3	0	2	5	0	0
4	19675261	.	C	T	6	7	13	0	0	13	0	0
4	19681585	.	C	T	1	0	1	0	0	1	0	0
4	19690484	.	C	A	0	0	0	0	1	1	0	0
4	19693953	.	T	C	5	0	5	0	6	11	0	0
4	19884000	.	G	A	1	2	3	0	1	4	0	0
4	19907484	.	C	G	1	0	1	0	0	1	0	0
4	19947743	.	G	T	3	6	9	0	1	10	0	0
4	19947781	.	G	T	5	4	9	0	1	10	0	0
4	19948746	.	T	C	4	3	7	0	0	7	0	0
4	19948826	.	A	G	1	2	3	0	0	3	0	0
4	19948829	.	C	T	1	3	4	0	0	4	0	0
4	19948883	.	C	G	3	5	8	0	0	8	0	0
4	19949215	.	T	C	3	3	6	0	0	6	0	0
4	19949388	.	C	A	0	5	5	0	3	8	0	0
4	19949651	.	C	T	0	3	3	0	2	5	0	0
4	19949730	.	T	C	1	3	4	0	0	4	0	0
4	19949793	.	C	T	0	5	5	0	2	7	0	0
4	19949865	.	T	A	5	10	15	0	1	16	0	0
4	19949985	.	T	C	4	3	7	0	1	8	0	0
4	19950236	.	A	T	2	3	5	0	0	5	0	0
4	19950381	.	G	A	2	2	4	0	0	4	0	0
4	19962034	.	G	A	3	4	7	0	1	8	0	0
4	20053901	.	C	T	13	8	21	0	0	21	0	0
4	20054036	.	C	T	11	11	22	0	1	23	0	0
4	20054516	.	C	T	1	2	3	0	0	3	0	0
4	20065453	.	C	T	3	3	6	0	0	6	0	0
4	20065477	.	C	A	3	4	7	0	0	7	0	0
4	20065762	.	C	A	7	3	10	0	0	10	0	0
4	20066208	.	G	A	8	3	11	0	1	12	0	0
4	20066276	.	G	A	0	7	7	0	2	9	0	0
4	20068185	.	A	G	5	4	9	0	2	11	0	0
4	20068446	.	G	A	9	8	17	0	2	19	0	0
4	20069091	.	T	C	6	4	10	0	1	11	0	0
4	20069343	.	C	A	8	9	17	0	0	17	0	0
4	20071344	.	A	T	4	4	8	0	1	9	0	0
4	20071401	.	G	T	3	5	8	0	1	9	0	0
4	20071509	.	T	C	3	3	6	0	0	6	0	0
4	20071604	.	T	C	1	0	1	0	5	6	0	0
4	20072035	.	T	C	1	3	4	0	0	4	0	0
4	20072094	.	C	T	7	3	10	0	0	10	0	0
4	20072129	.	T	G	4	13	17	0	1	18	0	0
4	20072176	.	A	T	5	12	17	0	0	17	0	0
4	20072429	.	T	G	9	9	18	0	1	19	0	0
4	20072441	.	C	T	10	7	17	0	2	19	0	0
4	20073790	.	T	C	1	0	1	0	0	1	0	0
4	20075025	.	A	G	2	1	3	0	0	3	0	0
4	20075028	.	T	C	2	1	3	0	0	3	0	0
4	20082639	.	A	T	4	3	7	0	0	7	0	0
4	20082834	.	G	A	1	0	1	0	0	1	0	0
4	20091024	.	T	C	2	6	8	0	0	8	0	0
4	20091055	.	G	C	0	5	5	0	11	16	0	0
4	20093155	.	A	T	1	5	6	0	0	6	0	0
4	20094257	.	T	C	2	1	3	0	0	3	0	0
4	20098662	.	T	A	8	3	11	0	1	12	0	0
4	20098793	.	C	G	4	6	10	0	0	10	0	0
4	20099131	.	C	T	9	7	16	0	1	17	0	0
4	20099631	.	T	C	8	5	13	0	0	13	0	0
4	20100081	.	C	T	5	4	9	0	0	9	0	0
4	20100574	.	A	C	4	4	8	0	0	8	0	0
4	20100730	.	A	T	9	5	14	0	1	15	0	0
4	20100754	.	A	G	11	0	11	0	5	16	0	0
4	20100805	.	C	T	6	6	12	0	1	13	0	0
4	20101072	.	G	A	7	7	14	0	1	15	0	0
4	20101399	.	A	C	4	6	10	0	0	10	0	0
4	20101404	.	G	A	4	6	10	0	0	10	0	0
4	20101508	.	A	G	5	8	13	0	0	13	0	0
4	20101510	.	A	T	5	8	13	0	0	13	0	0
4	20101562	.	T	C	4	4	8	0	0	8	0	0
4	20102188	.	C	T	0	2	2	0	0	2	0	0
4	20102905	.	A	T	3	4	7	0	0	7	0	0
4	20105434	.	G	A	1	1	2	0	1	3	0	0
4	20107619	.	C	T	1	2	3	0	0	3	0	0
4	20127909	.	C	T	0	3	3	0	0	3	0	0
4	20130015	.	G	T	0	1	1	0	0	1	0	0
4	20150138	.	G	T	1	3	4	0	0	4	0	0
4	20903186	.	G	A	3	3	6	0	0	6	0	0
4	20903477	.	G	T	1	1	2	0	1	3	0	0
4	20919919	.	G	A	0	1	1	0	0	1	0	0
4	20951080	.	C	T	1	5	6	0	0	6	0	0
4	20970268	.	T	A	2	2	4	0	0	4	0	0
4	20971490	.	C	T	0	0	0	0	1	1	0	0
4	20979410	.	C	A	1	3	4	0	0	4	0	0
4	20980971	.	A	G	2	2	4	0	0	4	0	0
4	20981184	.	T	C	11	6	17	0	1	18	0	0
4	20981198	.	G	A	1	12	13	0	6	19	0	0
4	20981273	.	A	C	3	2	5	0	1	6	0	0
4	20986930	.	A	T	7	6	13	0	0	13	0	0
4	20987317	.	A	T	4	3	7	0	0	7	0	0
4	20987326	.	T	G	4	3	7	0	0	7	0	0
4	21263703	.	C	T	3	7	10	0	2	12	0	0
4	21290798	.	G	A	11	17	28	0	1	29	0	0
4	21312731	.	C	G	36	25	61	0	0	61	0	0
4	21312981	.	C	T	22	23	45	0	7	52	0	0
4	21313779	.	T	G	30	25	55	0	1	56	0	0
4	21313805	.	G	A	0	29	29	0	36	65	0	0
4	21314036	.	T	A	31	28	59	0	2	61	0	0
4	21314338	.	G	T	34	33	67	0	2	69	0	0
4	21314663	.	C	T	29	29	58	0	1	59	0	0
4	21314771	.	T	C	28	34	62	0	3	65	0	0
4	21314940	.	C	T	39	36	75	0	0	75	0	0
4	21323345	.	C	A	1	4	5	0	0	5	0	0
4	21323363	.	G	C	4	2	6	0	0	6	0	0
4	21369434	.	G	A	2	5	7	0	0	7	0	0
4	21466265	.	A	G	5	6	11	0	0	11	0	0
4	21466553	.	T	C	1	0	1	0	3	4	0	0
4	21489110	.	G	A	9	17	26	0	1	27	0	0
4	21489242	.	G	A	14	17	31	0	3	34	0	0
4	21489551	.	A	G	10	2	12	0	0	12	0	0
4	21489975	.	T	A	9	24	33	0	0	33	0	0
4	21507026	.	G	A	5	6	11	0	1	12	0	0
4	21508317	.	G	A	1	6	7	0	0	7	0	0
4	21508410	.	T	C	16	0	16	0	10	26	0	0
4	21512191	.	C	T	8	5	13	0	0	13	0	0
4	21519783	.	C	T	9	10	19	0	1	20	0	0
4	21523541	.	A	T	7	6	13	0	1	15	1	0
4	21523789	.	T	G	7	6	13	0	0	13	0	0
4	21525430	.	G	T	0	1	1	0	0	1	0	0
4	21539658	.	G	A	3	3	6	0	0	6	0	0
4	21651465	.	A	T	11	11	22	0	0	22	0	0
4	21651525	.	G	A	8	8	16	0	2	18	0	0
4	21752284	.	G	A	6	8	14	0	2	16	0	0
4	21752291	.	C	T	6	8	14	0	2	16	0	0
4	21752372	.	T	A	3	7	10	0	0	10	0	0
4	21752495	.	C	G	5	6	11	0	0	11	0	0
4	21752688	.	G	C	9	0	9	0	16	25	0	0
4	21752699	.	C	T	11	8	19	0	2	21	0	0
4	21752728	.	A	T	11	6	17	0	3	20	0	0
4	21752736	.	T	C	12	10	22	0	0	22	0	0
4	21752867	.	T	C	6	10	16	0	1	17	0	0
4	21753145	.	T	C	18	11	29	0	0	29	0	0
4	21761688	.	A	T	7	6	13	0	0	13	0	0
4	21766808	.	G	A	8	17	25	0	2	27	0	0
4	21851415	.	G	T	3	3	6	0	0	6	0	0
4	21958043	.	A	G	5	14	19	0	3	22	0	0
4	21958210	.	A	C	11	13	24	0	0	24	0	0
4	21958226	.	T	G	13	13	26	0	1	27	0	0
4	21962364	.	T	A	6	0	6	0	0	6	0	0
4	21966456	.	G	A	2	2	4	0	0	4	0	0
4	21966457	.	C	A	2	2	4	0	0	4	0	0
4	21966643	.	T	A	3	2	5	0	0	5	0	0
4	21966688	.	A	T	1	2	3	0	0	3	0	0
4	21973713	.	T	C	6	2	8	0	0	8	0	0
4	21975248	.	G	A	9	11	20	0	0	20	0	0
4	21975489	.	G	T	2	2	4	0	0	4	0	0
4	21981022	.	G	A	0	1	1	0	0	1	0	0
4	21981118	.	T	C	5	7	12	0	1	13	0	0
4	21987662	.	G	A	0	3	3	0	0	3	0	0
4	21998286	.	A	G	2	4	6	0	0	6	0	0
4	22006507	.	C	A	0	2	2	0	0	2	0	0
4	22010283	.	A	G	2	1	3	0	0	3	0	0
4	22010301	.	A	G	1	0	1	0	0	1	0	0
4	22299976	.	A	G	2	1	3	0	3	6	0	0
4	22300125	.	A	C	3	7	10	0	0	10	0	0
4	22313107	.	A	T	5	3	8	0	0	8	0	0
4	22313244	.	G	A	13	7	20	0	0	20	0	0
4	22313397	.	C	A	5	6	11	0	2	13	0	0
4	22313677	.	A	G	3	4	7	0	0	7	0	0
4	22313722	.	A	C	2	5	7	0	0	7	0	0
4	22313861	.	T	A	5	10	15	0	1	16	0	0
4	22314085	.	G	A	12	12	24	0	1	25	0	0
4	22314094	.	A	C	12	11	23	0	0	23	0	0
4	22316148	.	T	C	9	2	11	0	1	12	0	0
4	22316321	.	C	T	6	6	12	0	0	12	0	0
4	22316323	.	C	T	0	5	5	0	7	12	0	0
4	22316481	.	C	T	9	7	16	0	0	16	0	0
4	22316558	.	G	A	8	12	20	0	0	20	0	0
4	22316624	.	A	T	15	10	25	0	0	25	0	0
4	22318046	.	A	G	4	6	10	0	0	10	0	0
4	22318144	.	C	T	4	3	7	0	1	8	0	0
4	22318574	.	T	C	2	4	6	0	0	6	0	0
4	22318640	.	A	T	5	9	14	0	0	14	0	0
4	22319558	.	G	A	3	7	10	0	0	10	0	0
4	22319951	.	C	T	1	2	3	0	1	4	0	0
4	22320056	.	C	T	4	5	9	0	2	11	0	0
4	22320156	.	G	A	5	8	13	0	0	13	0	0
4	22320941	.	C	T	0	3	3	0	2	5	0	0
4	22320949	.	A	G	2	3	5	0	0	5	0	0
4	22321089	.	T	C	4	2	6	0	0	6	0	0
4	22321111	.	C	A	2	2	4	0	0	4	0	0
4	22321175	.	T	C	0	3	3	0	1	4	0	0
4	22321176	.	G	A	1	2	3	0	1	4	0	0
4	22321246	.	T	C	3	2	5	0	2	7	0	0
4	22321629	.	T	C	3	2	5	0	0	5	0	0
4	22321745	.	C	T	1	3	4	0	0	4	0	0
4	22321746	.	T	C	1	0	1	0	3	4	0	0
4	22321803	.	A	G	1	1	2	0	0	2	0	0
4	22321822	.	A	C	1	2	3	0	0	3	0	0
4	22322957	.	A	G	1	1	2	0	0	2	0	0
4	22327352	.	C	T	1	0	1	0	0	1	0	0
4	22327554	.	T	G	0	1	1	0	0	1	0	0
4	22327675	.	T	A	1	2	3	0	0	3	0	0
4	22328126	.	G	A	0	4	4	0	0	4	0	0
4	22328163	.	C	T	0	5	5	0	0	5	0	0
4	22328525	.	A	G	2	3	5	0	0	5	0	0
4	22328770	.	A	C	1	3	4	0	0	4	0	0
4	22328984	.	C	A	3	3	6	0	0	6	0	0
4	22334598	.	A	G	2	2	4	0	0	4	0	0
4	22365152	.	C	T	9	13	22	0	4	26	0	0
4	22365356	.	T	G	12	11	23	0	1	24	0	0
4	22365400	.	G	A	11	8	19	0	1	20	0	0
4	22365489	.	C	A	20	18	38	0	1	39	0	0
4	22418493	.	G	T	0	1	1	0	0	1	0	0
4	22418966	.	C	G	22	25	47	0	2	49	0	0
4	22419003	.	A	G	22	24	46	0	3	49	0	0
4	22419483	.	G	T	22	23	45	0	4	49	0	0
4	22424891	.	A	G	23	14	37	0	2	39	0	0
4	22424927	.	A	T	27	10	37	0	4	41	0	0
4	22425115	.	G	A	11	15	26	0	0	26	0	0
4	22428148	.	C	T	0	9	9	0	15	24	0	0
4	22428619	.	T	C	5	2	7	0	0	7	0	0
4	22429021	.	T	C	4	6	10	0	1	11	0	0
4	22432825	.	G	T	7	6	13	0	0	13	0	0
4	22433062	.	C	T	0	1	1	0	0	1	0	0
4	22433307	.	A	G	12	9	21	0	1	22	0	0
4	22433348	.	G	A	12	12	24	0	1	25	0	0
4	22433366	.	A	T	8	13	21	0	2	23	0	0
4	22433474	.	T	C	5	2	7	0	0	7	0	0
4	22472526	.	C	T	0	6	6	0	4	10	0	0
4	22480266	.	G	T	24	25	49	0	2	51	0	0
4	22480279	.	T	A	21	24	45	0	2	47	0	0
4	22482828	.	C	G	5	5	10	0	1	11	0	0
4	22482923	.	T	C	7	10	17	0	1	18	0	0
4	22482930	.	G	A	8	11	19	0	0	19	0	0
4	22483117	.	T	A	2	5	7	0	0	7	0	0
4	22485085	.	C	T	4	4	8	0	2	10	0	0
4	22485148	.	C	T	0	10	10	0	2	12	0	0
4	22491854	.	G	A	1	3	4	0	1	5	0	0
4	22492322	.	T	A	0	2	2	0	0	2	0	0
4	22492367	.	A	T	2	7	9	0	0	9	0	0
4	22492406	.	T	C	7	6	13	0	0	13	0	0
4	22494593	.	A	G	5	5	10	0	1	11	0	0
4	22494630	.	C	T	5	7	12	0	1	13	0	0
4	22495375	.	G	A	1	0	1	0	0	1	0	0
4	22500811	.	A	G	4	4	8	0	0	8	0	0
4	22502671	.	T	C	1	0	1	0	1	2	0	0
4	22506945	.	C	T	0	1	1	0	2	3	0	0
4	22652698	.	A	C	1	3	4	0	0	4	0	0
4	22652743	.	A	G	2	0	2	0	5	7	0	0
4	22652782	.	T	C	3	6	9	0	0	9	0	0
4	22652836	.	G	A	3	2	5	0	1	6	0	0
4	22658838	.	A	G	5	9	14	0	1	16	1	0
4	22660036	.	A	T	2	1	3	0	0	3	0	0
4	22670410	.	A	G	1	3	4	0	0	4	0	0
4	22671170	.	T	A	2	2	4	0	0	4	0	0
4	22671208	.	A	C	8	0	8	0	4	12	0	0
4	22671354	.	T	C	7	11	18	0	1	19	0	0
4	22680636	.	G	T	1	10	11	0	11	22	0	0
4	22697095	.	C	G	0	0	0	0	4	4	0	0
4	22697209	.	T	C	2	6	8	0	1	9	0	0
4	22707767	.	T	C	21	19	40	0	1	41	0	0
4	22707820	.	C	T	9	11	20	0	0	20	0	0
4	22713026	.	G	A	2	1	3	0	0	3	0	0
4	22713260	.	A	G	9	0	9	0	14	23	0	0
4	22713644	.	A	G	15	23	38	0	4	42	0	0
4	22713946	.	T	G	15	0	15	0	10	25	0	0
4	22730856	.	C	T	2	3	5	0	0	5	0	0
4	22730951	.	A	C	3	6	9	0	0	9	0	0
4	22731883	.	C	T	0	1	1	0	0	1	0	0
4	22731943	.	T	G	5	4	9	0	0	9	0	0
4	22734643	.	C	T	6	7	13	0	1	14	0	0
4	22734676	.	C	T	2	4	6	0	0	6	0	0
4	22736977	.	A	G	3	1	4	0	0	4	0	0
4	22738694	.	C	T	3	3	6	0	0	6	0	0
4	22740885	.	C	T	1	2	3	0	0	3	0	0
4	22740891	.	G	C	1	2	3	0	0	3	0	0
4	22740936	.	T	C	0	1	1	0	0	1	0	0
4	22743616	.	A	G	9	4	13	0	0	13	0	0
4	22749481	.	C	T	0	1	1	0	0	1	0	0
4	22749482	.	T	C	0	1	1	0	0	1	0	0
4	22755549	.	T	C	6	0	6	0	5	11	0	0
4	22756239	.	T	C	9	15	24	0	0	24	0	0
4	22756301	.	A	C	12	15	27	0	0	27	0	0
4	22756333	.	C	T	13	10	23	0	1	24	0	0
4	22756436	.	G	A	11	7	18	0	1	19	0	0
4	22756593	.	A	T	7	3	10	0	2	12	0	0
4	22756879	.	G	A	6	5	11	0	0	11	0	0
4	22756886	.	C	T	0	6	6	0	6	12	0	0
4	22757136	.	A	T	2	9	11	0	0	11	0	0
4	22757402	.	T	G	6	6	12	0	1	13	0	0
4	22757494	.	T	A	7	6	13	0	1	14	0	0
4	22757519	.	A	T	6	8	14	0	0	14	0	0
4	22758095	.	C	T	6	5	11	0	1	12	0	0
4	22758343	.	C	T	6	9	15	0	0	15	0	0
4	22758553	.	C	T	0	5	5	0	8	13	0	0
4	22768137	.	G	T	4	2	6	0	0	6	0	0
4	22773483	.	T	C	1	1	2	0	0	2	0	0
4	22776277	.	G	T	3	6	9	0	0	9	0	0
4	22776286	.	G	A	3	6	9	0	0	9	0	0
4	22776849	.	A	G	6	6	12	0	0	12	0	0
4	22865973	.	T	C	3	0	3	0	1	4	0	0
4	22981750	.	A	G	1	3	4	0	0	4	0	0
4	23117624	.	A	C	5	4	9	0	0	9	0	0
4	23117644	.	G	A	6	3	9	0	3	12	0	0
4	23117665	.	G	T	7	3	10	0	0	10	0	0
4	23117698	.	C	A	6	1	7	0	0	7	0	0
4	23117727	.	G	A	2	2	4	0	0	4	0	0
4	23117833	.	G	A	2	3	5	0	0	5	0	0
4	23117883	.	T	C	2	5	7	0	0	7	0	0
4	23122031	.	T	C	2	1	3	0	0	3	0	0
4	23122759	.	T	C	4	3	7	0	1	8	0	0
4	23122999	.	T	C	6	3	9	0	0	9	0	0
4	23129080	.	A	G	1	4	5	0	0	5	0	0
4	23132725	.	G	A	0	4	4	0	0	4	0	0
4	23132830	.	A	G	0	0	0	0	1	1	0	0
4	23134282	.	C	G	9	17	26	0	0	26	0	0
4	23134520	.	T	C	6	8	14	0	1	15	0	0
4	23134541	.	G	A	5	5	10	0	1	11	0	0
4	23135038	.	G	A	4	4	8	0	0	8	0	0
4	23135047	.	G	A	4	4	8	0	0	8	0	0
4	23135330	.	A	G	2	10	12	0	0	12	0	0
4	23135354	.	G	C	3	6	9	0	0	9	0	0
4	23135399	.	A	T	8	6	14	0	0	14	0	0
4	23135406	.	C	T	8	6	14	0	0	14	0	0
4	23135717	.	C	G	1	2	3	0	0	3	0	0
4	23135791	.	A	C	1	2	3	0	0	3	0	0
4	23229121	.	A	G	1	3	4	0	0	4	0	0
4	23303501	.	A	G	2	2	4	1	0	5	0	0
4	23303510	.	G	A	2	3	5	0	0	5	0	0
4	23312240	.	G	A	2	7	9	0	0	9	0	0
4	23312264	.	T	C	2	7	9	0	0	9	0	0
4	23385119	.	A	G	4	3	7	0	0	7	0	0
4	23385122	.	C	T	4	3	7	0	1	8	0	0
4	23391628	.	T	C	3	3	6	0	0	6	0	0
4	23408029	.	G	A	5	10	15	0	0	15	0	0
4	23458752	.	G	T	4	3	7	0	1	8	0	0
4	23459111	.	C	T	0	4	4	0	0	4	0	0
4	23465482	.	A	G	0	3	3	0	0	3	0	0
4	23486639	.	G	A	3	4	7	2	0	9	0	0
4	23527631	.	G	A	3	3	6	0	0	6	0	0
4	23775387	.	A	C	4	0	4	0	12	16	0	0
4	25055479	.	C	G	1	9	10	0	17	27	0	0
4	25055602	.	A	G	30	22	52	0	3	55	0	0
4	25084487	.	T	G	5	3	8	0	1	9	0	0
4	25084596	.	A	G	4	2	6	0	0	6	0	0
4	25084744	.	A	G	4	9	13	0	2	15	0	0
4	25104957	.	C	T	8	12	20	0	1	21	0	0
4	25105502	.	G	T	14	13	27	0	4	31	0	0
4	25105662	.	A	G	8	6	14	0	1	15	0	0
4	25165623	.	A	G	4	6	10	0	0	10	0	0
4	25165692	.	C	T	1	3	4	0	0	4	0	0
4	25165694	.	A	G	1	3	4	0	0	4	0	0
4	25168280	.	T	C	3	5	8	0	1	9	0	0
4	25168368	.	G	A	8	13	21	0	0	21	0	0
4	25168417	.	A	G	4	6	10	0	1	11	0	0
4	25168418	.	A	G	3	7	10	0	1	11	0	0
4	25173387	.	T	C	10	21	31	0	3	34	0	0
4	25173396	.	A	G	11	14	25	0	4	29	0	0
4	25176093	.	A	G	11	12	23	0	1	24	0	0
4	25178069	.	G	T	1	3	4	0	0	4	0	0
4	25178402	.	G	C	4	4	8	0	1	9	0	0
4	25178425	.	G	A	10	13	23	0	1	24	0	0
4	25179897	.	A	G	6	5	11	0	0	11	0	0
4	25179948	.	C	T	0	21	21	0	18	39	0	0
4	25179996	.	A	G	5	8	13	0	1	14	0	0
4	25184559	.	C	T	3	5	8	0	0	8	0	0
4	25184565	.	G	A	3	5	8	0	0	8	0	0
4	25184603	.	G	A	0	2	2	0	0	2	0	0
4	25184890	.	C	T	1	0	1	0	0	1	0	0
4	25185797	.	T	C	4	2	6	0	0	6	0	0
4	25354389	.	C	A	1	4	5	0	1	6	0	0
4	25354412	.	C	T	2	3	5	0	0	5	0	0
4	25356921	.	T	C	3	3	6	0	0	6	0	0
4	25358409	.	A	G	4	3	7	0	0	7	0	0
4	25473048	.	G	T	0	4	4	0	2	6	0	0
4	25473708	.	A	T	9	8	17	0	0	17	0	0
4	25473927	.	C	A	0	6	6	0	8	14	0	0
4	25473934	.	T	G	5	9	14	0	1	15	0	0
4	25474417	.	G	A	8	18	26	0	3	29	0	0
4	25476629	.	G	A	7	4	11	0	0	11	0	0
4	25479704	.	G	A	5	4	9	0	0	9	0	0
4	25480983	.	T	C	3	0	3	0	5	8	0	0
4	25480989	.	G	A	2	5	7	0	0	7	0	0
4	25481635	.	G	A	3	0	3	0	0	3	0	0
4	25482595	.	C	A	1	2	3	0	1	4	0	0
4	25485302	.	C	T	4	4	8	0	1	9	0	0
4	25485348	.	G	A	5	5	10	0	0	10	0	0
4	25485350	.	G	A	5	4	9	0	1	10	0	0
4	25485394	.	A	T	2	3	5	0	1	6	0	0
4	25497398	.	G	A	6	4	10	0	0	10	0	0
4	25497411	.	T	C	4	0	4	0	5	9	0	0
4	25497464	.	T	C	3	0	3	0	2	5	0	0
4	25502038	.	C	T	1	1	2	0	0	2	0	0
4	25506417	.	G	A	7	3	10	0	0	10	0	0
4	25506896	.	A	G	2	4	6	0	1	7	0	0
4	25511451	.	T	C	7	11	18	0	0	18	0	0
4	25512840	.	C	T	7	4	11	0	0	11	0	0
4	25515157	.	C	T	0	1	1	0	0	1	0	0
4	25694866	.	G	T	0	2	2	0	3	5	0	0
4	25697282	.	T	G	0	2	2	0	0	2	0	0
4	25703068	.	A	T	0	2	2	0	0	2	0	0
4	25747994	.	C	T	5	1	6	0	0	6	0	0
4	25750826	.	C	T	5	2	7	0	1	8	0	0
4	25754991	.	A	G	6	7	13	0	0	13	0	0
4	25755137	.	C	T	5	4	9	0	2	11	0	0
4	25755191	.	T	A	2	2	4	0	0	4	0	0
4	25755194	.	A	G	2	2	4	0	0	4	0	0
4	25755834	.	T	C	4	0	4	0	3	7	0	0
4	25755922	.	C	T	4	3	7	0	0	7	0	0
4	25756105	.	A	G	1	3	4	0	1	5	0	0
4	25756305	.	A	C	7	3	10	0	0	10	0	0
4	25756453	.	G	T	5	4	9	0	0	9	0	0
4	25759198	.	C	T	0	8	8	0	5	13	0	0
4	25759327	.	G	A	7	7	14	0	1	15	0	0
4	25759518	.	C	A	0	9	9	0	4	13	0	0
4	25759549	.	T	C	5	7	12	0	0	12	0	0
4	25796765	.	G	A	9	5	14	0	0	14	0	0
4	25829939	.	G	A	6	6	12	0	0	13	1	0
4	25833221	.	G	A	7	2	9	0	0	9	0	0
4	25839817	.	A	C	2	0	2	0	3	5	0	0
4	25839832	.	A	G	3	2	5	0	0	5	0	0
4	25839911	.	G	C	8	3	11	0	0	11	0	0
4	25839931	.	C	T	0	6	6	0	7	13	0	0
4	25842788	.	C	T	5	3	8	0	0	8	0	0
4	25842977	.	G	A	1	1	2	0	0	2	0	0
4	25843004	.	A	G	2	2	4	0	0	4	0	0
4	25853058	.	C	T	0	2	2	0	0	2	0	0
4	25860868	.	A	G	1	4	5	0	0	5	0	0
4	25861165	.	A	G	2	4	6	0	0	6	0	0
4	25861256	.	A	G	0	4	4	0	0	4	0	0
4	25920291	.	C	T	3	3	6	0	0	6	0	0
4	25927026	.	C	T	2	2	4	0	0	4	0	0
4	25927056	.	G	T	2	5	7	0	0	7	0	0
4	25927090	.	G	C	4	1	5	0	0	5	0	0
4	25934709	.	C	T	2	2	4	0	0	4	0	0
4	25936437	.	A	G	5	4	9	0	0	9	0	0
4	25936491	.	A	G	3	2	5	0	1	6	0	0
4	25936512	.	C	T	1	2	3	0	0	3	0	0
4	26010878	.	T	C	2	4	6	0	0	6	0	0
4	26012322	.	C	T	2	2	4	0	0	5	1	0
4	26015476	.	C	T	5	0	5	0	1	6	0	0
4	26022351	.	C	G	6	4	10	0	1	11	0	0
4	26022413	.	C	T	3	2	5	0	0	5	0	0
4	26028813	.	C	T	2	5	7	0	0	7	0	0
4	26028873	.	C	T	0	5	5	0	4	9	0	0
4	26029119	.	A	G	3	3	6	0	0	6	0	0
4	26029362	.	T	A	2	4	6	0	1	7	0	0
4	26029413	.	T	C	2	0	2	0	2	4	0	0
4	26056542	.	A	G	1	0	1	0	0	1	0	0
4	26065007	.	G	C	0	1	1	0	0	1	0	0
4	26072844	.	G	A	2	4	6	0	0	6	0	0
4	26075640	.	G	C	1	3	4	0	0	4	0	0
4	26075673	.	G	A	1	1	2	0	0	2	0	0
4	26075794	.	T	G	0	0	0	0	1	1	0	0
4	26077426	.	C	T	5	3	8	0	0	8	0	0
4	26077483	.	T	C	4	10	14	0	0	14	0	0
4	26077671	.	A	T	9	12	21	0	0	21	0	0
4	26078205	.	G	A	0	4	4	0	4	8	0	0
4	26078341	.	C	T	4	4	8	0	0	8	0	0
4	26078359	.	G	T	3	4	7	0	0	7	0	0
4	26078733	.	G	A	2	2	4	0	0	4	0	0
4	26078847	.	A	G	3	5	8	0	0	8	0	0
4	26078850	.	G	A	6	3	9	0	0	9	0	0
4	26079267	.	T	G	5	0	5	0	4	9	0	0
4	26079353	.	A	C	3	1	4	0	0	4	0	0
4	26079372	.	C	T	2	2	4	0	1	5	0	0
4	26079838	.	A	G	2	4	6	0	1	7	0	0
4	26079940	.	T	C	4	3	7	0	0	7	0	0
4	26080102	.	A	T	1	2	3	0	0	3	0	0
4	26080320	.	A	G	8	3	11	0	0	11	0	0
4	26080414	.	A	T	8	5	13	0	0	14	1	0
4	26080441	.	C	T	1	8	9	0	1	10	0	0
4	26081006	.	G	A	7	6	13	0	0	13	0	0
4	26303911	.	A	G	4	9	13	0	1	14	0	0
4	26303953	.	T	C	5	17	22	0	1	23	0	0
4	26304190	.	T	A	13	4	17	0	0	17	0	0
4	26304240	.	T	G	18	11	29	0	0	29	0	0
4	26304730	.	G	T	8	8	16	0	0	16	0	0
4	26305191	.	T	C	9	7	16	0	0	16	0	0
4	26305286	.	C	A	7	16	23	0	0	23	0	0
4	26305309	.	T	A	5	19	24	0	3	27	0	0
4	26305324	.	C	T	6	16	22	0	0	22	0	0
4	26305368	.	C	T	12	13	25	0	0	25	0	0
4	26305382	.	G	A	13	10	23	0	1	24	0	0
4	26305413	.	A	C	10	7	17	0	1	18	0	0
4	26305468	.	A	T	6	11	17	0	0	17	0	0
4	26305516	.	A	T	4	8	12	0	2	14	0	0
4	26305578	.	A	T	6	6	12	0	1	13	0	0
4	26322651	.	C	T	8	9	17	0	0	17	0	0
4	26629672	.	C	T	9	12	21	0	0	21	0	0
4	26762518	.	G	T	3	3	6	0	0	6	0	0
4	26762524	.	G	T	6	4	10	0	1	11	0	0
4	26765056	.	T	C	5	3	8	0	0	8	0	0
4	26765057	.	A	T	5	3	8	0	0	8	0	0
4	27082166	.	T	C	1	4	5	0	0	5	0	0
4	27112663	.	T	A	2	4	6	0	0	6	0	0
4	27113265	.	T	A	4	3	7	0	0	7	0	0
4	27114157	.	T	C	1	7	8	0	0	8	0	0
4	27114894	.	A	G	8	6	14	0	1	15	0	0
4	27115228	.	G	T	10	3	13	0	1	14	0	0
4	27115478	.	A	G	4	5	9	0	0	9	0	0
4	27115765	.	A	G	5	5	10	0	0	10	0	0
4	27116080	.	T	C	1	4	5	0	0	5	0	0
4	27130530	.	G	T	2	5	7	0	0	7	0	0
4	27132314	.	A	C	2	4	6	0	1	7	0	0
4	27137406	.	C	T	3	5	8	0	0	8	0	0
4	27137517	.	T	A	3	5	8	0	0	8	0	0
4	27139739	.	T	C	6	2	8	0	0	8	0	0
4	27139922	.	A	G	4	5	9	0	0	9	0	0
4	27140031	.	G	A	0	1	1	0	0	1	0	0
4	27140644	.	C	T	0	1	1	0	0	1	0	0
4	27147440	.	T	G	3	2	5	0	0	5	0	0
4	27147510	.	T	C	1	5	6	0	0	6	0	0
4	27147752	.	A	G	9	11	20	0	0	20	0	0
4	27148046	.	G	A	0	3	3	0	9	12	0	0
4	27148142	.	T	C	3	6	9	0	0	9	0	0
4	27148267	.	A	G	2	9	11	0	0	11	0	0
4	27148927	.	G	A	3	4	7	0	0	7	0	0
4	27252178	.	C	T	0	10	10	0	12	22	0	0
4	27252581	.	G	A	11	10	21	0	2	23	0	0
4	27252813	.	C	T	13	7	20	0	3	23	0	0
4	27253043	.	T	A	15	20	35	0	1	36	0	0
4	27350666	.	G	A	11	7	18	0	0	18	0	0
4	27627569	.	C	T	2	2	4	0	0	4	0	0
4	27628113	.	G	A	4	2	6	0	1	7	0	0
4	27628170	.	G	A	5	3	8	0	1	9	0	0
4	27628190	.	T	A	6	2	8	0	0	8	0	0
4	27628373	.	G	A	1	4	5	0	0	5	0	0
4	27628643	.	C	G	1	2	3	0	2	5	0	0
4	27628788	.	T	A	5	3	8	0	0	8	0	0
4	27921925	.	A	G	5	4	9	0	0	9	0	0
4	27921962	.	G	C	0	3	3	0	3	6	0	0
4	27937093	.	G	A	0	1	1	0	1	2	0	0
4	27938777	.	G	A	1	2	3	0	0	3	0	0
4	27938837	.	G	A	1	0	1	0	0	1	0	0
4	27945941	.	T	C	1	8	9	0	0	9	0	0
4	27945947	.	C	T	1	8	9	0	0	9	0	0
4	27945995	.	G	A	0	4	4	0	5	9	0	0
4	27946067	.	A	T	0	1	1	0	0	1	0	0
4	27953774	.	C	T	3	4	7	0	0	7	0	0
4	28062846	.	T	A	6	3	9	0	0	9	0	0
4	28062920	.	T	C	3	0	3	0	3	6	0	0
4	28063086	.	G	A	8	4	12	0	0	12	0	0
4	28063385	.	G	A	5	5	10	0	0	10	0	0
4	28063469	.	T	C	4	0	4	0	5	9	0	0
4	28063635	.	A	G	12	5	17	0	0	17	0	0
4	28063653	.	G	T	11	7	18	0	1	19	0	0
4	28063715	.	A	G	6	5	11	0	0	11	0	0
4	28063873	.	T	C	0	3	3	0	1	4	0	0
4	28063876	.	T	C	0	3	3	0	1	4	0	0
4	28063911	.	C	G	1	7	8	0	5	13	0	0
4	28064028	.	T	C	3	7	10	0	0	10	0	0
4	28066394	.	G	A	4	2	6	0	0	6	0	0
4	28066425	.	C	T	4	2	6	0	0	6	0	0
4	28068908	.	G	A	4	3	7	0	0	7	0	0
4	28084928	.	T	C	4	2	6	0	0	6	0	0
4	28084993	.	A	G	3	5	8	0	0	8	0	0
4	28093323	.	A	G	3	5	8	0	0	8	0	0
4	28194299	.	C	T	1	1	2	0	0	2	0	0
4	28194359	.	G	A	1	2	3	0	1	4	0	0
4	28197964	.	T	G	1	0	1	0	0	1	0	0
4	28198271	.	A	G	2	1	3	0	1	4	0	0
4	28198292	.	T	A	4	1	5	0	0	5	0	0
4	28202709	.	G	T	0	1	1	0	0	1	0	0
4	28209922	.	G	A	1	3	4	0	0	4	0	0
4	28344009	.	G	A	1	1	2	0	0	2	0	0
4	28344012	.	A	G	1	1	2	0	0	2	0	0
4	28353449	.	A	T	3	3	6	0	1	7	0	0
4	28373791	.	T	G	6	7	13	0	0	13	0	0
4	28374646	.	A	C	4	3	7	0	0	7	0	0
4	28377244	.	A	G	0	1	1	0	0	1	0	0
4	28379172	.	T	A	3	4	7	0	0	7	0	0
4	28379740	.	G	A	2	3	5	0	0	5	0	0
4	28419637	.	G	A	1	0	1	0	0	1	0	0
4	28423483	.	T	C	1	3	4	0	0	4	0	0
4	28423499	.	A	T	1	4	5	0	0	5	0	0
4	28423528	.	C	G	1	0	1	0	2	3	0	0
4	28423547	.	C	T	0	2	2	0	0	2	0	0
4	28423595	.	A	G	2	5	7	0	0	7	0	0
4	28423669	.	A	G	2	2	4	0	0	4	0	0
4	28423735	.	C	T	6	4	10	0	1	11	0	0
4	28423775	.	T	G	4	0	4	0	4	8	0	0
4	28423786	.	A	T	3	3	6	0	0	6	0	0
4	28423886	.	A	C	2	2	4	0	0	4	0	0
4	28423923	.	T	C	3	2	5	0	0	5	0	0
4	28821220	.	C	A	0	2	2	0	0	2	0	0
4	28821416	.	G	A	0	2	2	0	4	6	0	0
4	28821417	.	A	T	4	2	6	0	0	6	0	0
4	28821606	.	G	A	0	3	3	0	2	5	0	0
4	28975750	.	A	G	2	0	2	0	2	4	0	0
4	28975776	.	A	G	2	0	2	0	2	4	0	0
4	28975943	.	G	A	1	2	3	0	0	3	0	0
4	29040548	.	A	G	3	4	7	0	0	7	0	0
4	29040677	.	G	A	1	4	5	0	0	5	0	0
4	29041388	.	T	C	4	2	6	0	0	6	0	0
4	29041638	.	T	A	2	4	6	0	0	6	0	0
4	29042521	.	T	C	4	4	8	0	0	8	0	0
4	29050168	.	T	A	3	2	5	0	0	5	0	0
4	29285069	.	A	T	1	3	4	0	0	4	0	0
4	29287717	.	A	G	2	0	2	0	2	4	0	0
4	29287720	.	T	C	2	2	4	0	0	4	0	0
4	29287803	.	C	A	3	2	5	0	1	6	0	0
4	40585341	.	T	C	0	2	2	1	0	3	0	0
4	40959626	.	C	T	5	2	7	0	1	8	0	0
4	40959639	.	T	G	3	5	8	0	0	8	0	0
4	49554122	.	T	A	1	0	1	0	6	7	0	0
4	49569096	.	T	C	3	2	5	0	0	5	0	0
4	50755658	.	C	A	0	3	3	0	1	4	0	0
4	70842200	.	A	G	4	2	6	0	0	6	0	0
4	70842205	.	A	G	3	2	5	0	1	6	0	0
4	70842953	.	G	T	6	2	8	0	0	8	0	0
4	70846240	.	G	A	1	0	1	0	0	1	0	0
4	70851202	.	T	C	2	0	2	0	6	8	0	0
4	70855939	.	C	T	1	4	5	0	8	13	0	0
4	70860034	.	A	C	1	0	1	0	0	1	0	0
4	70860166	.	A	G	8	6	14	0	0	14	0	0
4	70864441	.	C	G	0	1	1	0	0	1	0	0
4	70866787	.	A	T	4	5	9	0	0	9	0	0
4	70866791	.	A	T	2	7	9	0	0	9	0	0
4	72216897	.	G	A	0	1	1	0	0	1	0	0
4	72217647	.	T	C	3	3	6	0	0	6	0	0
4	72217813	.	T	C	3	3	6	0	0	6	0	0
4	72217847	.	G	A	0	2	2	0	1	3	0	0
4	72235804	.	C	T	2	4	6	0	0	6	0	0
4	72272269	.	G	C	6	0	6	0	4	10	0	0
4	72272491	.	A	G	1	2	3	0	0	3	0	0
4	72272506	.	G	A	2	2	4	0	0	4	0	0
4	72272779	.	T	C	7	6	13	0	0	13	0	0
4	72272890	.	A	C	3	0	3	0	4	7	0	0
4	72275250	.	G	A	0	1	1	0	0	1	0	0
4	72295873	.	T	A	4	3	7	0	1	8	0	0
4	72436638	.	A	T	5	4	9	0	0	9	0	0
4	72436642	.	G	A	5	4	9	0	0	9	0	0
4	72436939	.	A	T	1	2	3	0	0	3	0	0
4	72437926	.	G	C	5	4	9	0	0	9	0	0
4	72438874	.	A	G	1	2	3	0	0	3	0	0
4	72438889	.	A	G	2	2	4	0	0	4	0	0
4	72547612	.	A	T	2	2	4	0	0	4	0	0
4	72550304	.	G	A	2	3	5	0	1	6	0	0
4	72550314	.	C	T	1	3	4	0	0	4	0	0
4	72550341	.	T	C	1	2	3	0	0	3	0	0
4	72550354	.	T	A	1	2	3	0	0	3	0	0
4	72559171	.	G	T	2	2	4	0	0	4	0	0
4	72559396	.	G	A	2	4	6	0	0	6	0	0
4	72559417	.	A	G	5	2	7	0	0	7	0	0
4	72559585	.	A	G	3	4	7	0	0	7	0	0
4	72559990	.	C	T	5	2	7	0	0	7	0	0
4	72560020	.	C	A	0	2	2	0	1	3	0	0
4	72560107	.	C	T	0	2	2	0	4	6	0	0
4	72560456	.	A	G	1	5	6	0	1	7	0	0
4	72573242	.	A	C	2	0	2	0	0	2	0	0
4	72573245	.	T	C	2	0	2	0	0	2	0	0
4	72573302	.	T	G	0	2	2	0	0	2	0	0
4	72629250	.	T	A	2	2	4	0	0	4	0	0
4	72629739	.	G	A	1	2	3	0	1	4	0	0
4	72629859	.	G	A	6	2	8	0	0	8	0	0
4	72630231	.	G	A	5	3	8	0	0	8	0	0
4	72630351	.	C	A	5	2	7	0	0	7	0	0
4	72678551	.	C	T	3	2	5	0	0	5	0	0
4	72681963	.	A	G	1	0	1	0	0	1	0	0
4	72723788	.	T	C	22	14	36	0	0	36	0	0
4	72748096	.	T	C	5	9	14	0	0	14	0	0
4	72772769	.	T	C	14	13	27	0	1	28	0	0
4	72774085	.	C	T	5	9	14	0	0	14	0	0
4	72775687	.	C	A	3	3	6	0	0	6	0	0
4	72784800	.	T	C	8	8	16	0	0	17	1	0
4	72785055	.	T	C	2	2	4	0	0	4	0	0
4	72785056	.	T	C	2	2	4	0	0	4	0	0
4	72785238	.	T	A	1	2	3	0	0	3	0	0
4	72785245	.	C	T	1	3	4	0	0	4	0	0
4	72785425	.	C	T	3	2	5	0	0	5	0	0
4	72785632	.	A	G	1	0	1	0	2	3	0	0
4	73015287	.	C	T	0	2	2	0	0	2	0	0
4	73059245	.	C	T	3	2	5	0	0	5	0	0
4	73059408	.	T	C	0	1	1	0	0	1	0	0
4	73063082	.	A	G	1	0	1	0	1	2	0	0
4	73186138	.	T	C	2	1	3	0	1	4	0	0
4	73186143	.	C	A	2	2	4	0	0	4	0	0
4	73274151	.	T	C	2	1	3	0	0	3	0	0
4	73335956	.	G	A	2	2	4	0	1	5	0	0
4	73335990	.	T	A	5	3	8	0	0	8	0	0
4	73336084	.	T	C	3	2	5	0	0	5	0	0
4	73336211	.	T	C	3	0	3	0	2	5	0	0
4	73336213	.	T	C	2	3	5	0	0	5	0	0
4	73336441	.	C	T	2	3	5	0	0	5	0	0
4	73336462	.	T	A	2	3	5	0	0	5	0	0
4	73336818	.	C	T	3	2	5	0	0	5	0	0
4	73336863	.	A	C	3	2	5	0	1	6	0	0
4	73336869	.	G	C	3	3	6	0	0	6	0	0
4	73337244	.	A	G	1	3	4	0	0	4	0	0
4	73337248	.	G	A	1	3	4	0	0	4	0	0
4	73337565	.	T	A	1	2	3	0	1	4	0	0
4	73337911	.	T	A	2	3	5	2	0	7	0	0
4	73343074	.	A	G	2	2	4	0	0	4	0	0
4	73347191	.	C	T	0	2	2	0	0	2	0	0
4	73347302	.	T	C	2	0	2	0	0	2	0	0
4	73347304	.	C	T	0	0	0	0	2	2	0	0
4	73383499	.	G	A	3	2	5	0	0	5	0	0
4	73411116	.	C	T	1	0	1	0	0	1	0	0
4	73411128	.	G	A	1	0	1	0	0	1	0	0
4	73418638	.	C	T	0	1	1	0	3	4	0	0
4	73418647	.	G	A	2	2	4	0	0	4	0	0
4	73418744	.	A	T	1	7	8	0	1	9	0	0
4	73418823	.	T	C	2	8	10	0	0	10	0	0
4	73419010	.	G	A	1	2	3	0	0	3	0	0
4	73419026	.	C	T	2	2	4	0	0	4	0	0
4	73419160	.	C	T	2	5	7	2	0	10	1	0
4	73419209	.	G	T	1	3	4	0	0	4	0	0
4	73419217	.	G	A	1	4	5	0	0	5	0	0
4	73419550	.	G	A	2	3	5	0	0	5	0	0
4	73447096	.	C	T	0	0	0	0	1	1	0	0
4	73456087	.	T	G	0	2	2	0	0	2	0	0
4	73456106	.	C	T	1	2	3	0	0	3	0	0
4	73470885	.	T	C	1	1	2	0	0	2	0	0
4	73473074	.	C	T	6	2	8	0	0	8	0	0
4	73473076	.	C	T	5	3	8	0	0	8	0	0
4	73473685	.	G	A	1	2	3	0	0	3	0	0
4	73473715	.	G	A	1	2	3	0	0	3	0	0
4	73491352	.	C	A	0	3	3	0	1	4	0	0
4	73491361	.	G	A	1	3	4	0	0	4	0	0
4	73498990	.	T	C	5	3	8	0	0	8	0	0
4	73499046	.	T	C	8	4	12	0	1	13	0	0
4	73499204	.	G	A	4	5	9	0	0	9	0	0
4	73499433	.	G	A	5	3	8	0	0	8	0	0
4	73499468	.	G	T	6	3	9	0	0	9	0	0
4	73499476	.	C	G	5	4	9	0	0	9	0	0
4	73499902	.	G	T	0	2	2	0	1	3	0	0
4	73500807	.	C	G	2	2	4	0	0	4	0	0
4	73500810	.	A	G	2	2	4	0	0	4	0	0
4	73519156	.	C	A	1	2	3	0	0	3	0	0
4	73519310	.	C	T	4	2	6	0	1	7	0	0
4	73542326	.	A	C	2	3	5	0	0	5	0	0
4	73542567	.	C	A	3	4	7	0	0	7	0	0
4	73542573	.	G	T	3	4	7	0	1	8	0	0
4	73542671	.	T	A	4	3	7	0	0	7	0	0
4	73542786	.	G	A	3	4	7	0	0	7	0	0
4	73543369	.	A	G	2	2	4	0	3	7	0	0
4	73550741	.	T	C	1	0	1	0	3	4	0	0
4	73551240	.	T	C	4	2	6	0	0	6	0	0
4	73551507	.	A	G	1	2	3	0	0	3	0	0
4	73564339	.	A	G	0	2	2	0	0	2	0	0
4	73564409	.	G	T	0	2	2	0	0	2	0	0
4	73565026	.	A	G	1	2	3	0	0	3	0	0
4	73565656	.	G	A	1	2	3	0	1	4	0	0
4	73573850	.	A	G	3	3	6	0	0	6	0	0
4	73573870	.	T	G	3	3	6	0	0	6	0	0
4	73573887	.	A	C	2	3	5	0	0	5	0	0
4	73574153	.	C	A	4	2	6	0	0	6	0	0
4	73574179	.	G	T	2	2	4	0	0	4	0	0
4	73574235	.	A	G	3	3	6	0	0	6	0	0
4	73574249	.	G	A	3	3	6	0	0	6	0	0
4	73574274	.	T	A	3	2	5	0	0	5	0	0
4	73575171	.	A	G	1	3	4	0	0	4	0	0
4	73575858	.	C	A	0	2	2	0	3	5	0	0
4	73639570	.	A	T	3	0	3	0	1	4	0	0
4	73639575	.	C	A	3	2	5	0	0	5	0	0
4	73657590	.	A	C	1	2	3	0	0	3	0	0
4	73681663	.	T	A	2	2	4	0	0	4	0	0
4	73713139	.	C	T	1	2	3	0	0	3	0	0
4	73713587	.	A	T	1	2	3	0	0	3	0	0
4	73713789	.	T	C	2	2	4	0	0	4	0	0
4	73713818	.	A	G	0	2	2	0	1	3	0	0
4	73713850	.	G	T	1	5	6	0	0	6	0	0
4	73713998	.	G	C	0	2	2	0	0	2	0	0
4	73715682	.	T	C	1	2	3	0	0	3	0	0
4	73730341	.	G	A	2	2	4	0	0	4	0	0
4	73730469	.	C	T	3	1	4	0	0	4	0	0
4	73730880	.	T	G	3	2	5	0	0	5	0	0
4	73740169	.	G	C	6	2	8	0	0	8	0	0
4	73740179	.	G	A	5	4	9	0	0	9	0	0
4	73740209	.	G	A	7	4	11	0	0	11	0	0
4	73740391	.	C	G	8	6	14	0	0	14	0	0
4	73740409	.	C	A	8	7	15	0	0	15	0	0
4	73740487	.	C	G	4	2	6	0	0	6	0	0
4	73740651	.	G	C	1	2	3	0	1	4	0	0
4	73740691	.	T	A	3	2	5	0	1	6	0	0
4	73740763	.	T	A	2	2	4	0	0	4	0	0
4	73740879	.	A	C	5	5	10	0	0	10	0	0
4	73741749	.	G	T	2	3	5	0	0	5	0	0
4	73741764	.	G	A	2	4	6	0	0	6	0	0
4	73758411	.	T	C	3	0	3	0	2	5	0	0
4	73758426	.	T	C	2	2	4	0	0	4	0	0
4	73780760	.	C	G	0	2	2	0	0	2	0	0
4	73780903	.	G	T	1	3	4	0	0	4	0	0
4	73796484	.	A	G	3	4	7	0	1	8	0	0
4	73796694	.	C	T	3	2	5	0	0	5	0	0
4	73797006	.	T	G	1	2	3	0	0	3	0	0
4	73797007	.	C	T	0	2	2	0	1	3	0	0
4	73815178	.	C	T	2	1	3	0	3	6	0	0
4	73815375	.	T	A	1	3	4	0	0	4	0	0
4	73816765	.	A	G	2	3	5	0	0	5	0	0
4	73817631	.	A	T	2	2	4	0	0	4	0	0
4	74006572	.	C	T	0	4	4	0	0	4	0	0
4	74008621	.	A	G	2	0	2	0	6	8	0	0
4	74008704	.	C	T	1	4	5	0	0	5	0	0
4	74008708	.	A	G	1	3	4	0	1	5	0	0
4	74087781	.	G	A	13	11	24	0	1	25	0	0
4	74087785	.	G	C	13	9	22	0	3	25	0	0
4	74088060	.	T	G	10	14	24	0	0	24	0	0
4	74109763	.	A	T	13	7	20	0	0	20	0	0
4	74131583	.	T	G	6	0	6	0	6	12	0	0
4	74131652	.	T	C	12	7	19	0	0	19	0	0
4	74131717	.	G	A	0	7	7	0	8	15	0	0
4	74135244	.	G	T	1	3	4	0	0	4	0	0
4	74135295	.	A	G	7	11	18	0	0	18	0	0
4	74135415	.	C	T	14	11	25	0	1	26	0	0
4	74141580	.	C	A	8	6	14	0	1	15	0	0
4	74141819	.	T	C	4	2	6	0	0	6	0	0
4	74180716	.	G	A	0	4	4	0	14	18	0	0
4	74180788	.	T	C	1	2	3	0	1	4	0	0
4	74182382	.	G	C	6	3	9	0	1	10	0	0
4	74182389	.	G	T	6	2	8	0	0	8	0	0
4	74193480	.	C	G	1	1	2	0	0	2	0	0
4	74196686	.	T	C	0	2	2	0	0	2	0	0
4	74196704	.	T	C	1	4	5	0	0	5	0	0
4	74196764	.	G	T	3	5	8	0	0	8	0	0
4	74200391	.	C	T	2	2	4	0	0	4	0	0
4	74204177	.	T	C	11	7	18	0	0	18	0	0
4	74204236	.	G	T	0	4	4	0	7	11	0	0
4	74204494	.	A	T	1	2	3	0	0	3	0	0
4	74204770	.	A	G	4	3	7	0	0	7	0	0
4	74204842	.	A	G	10	7	17	0	0	17	0	0
4	74205295	.	T	C	3	3	6	0	0	6	0	0
4	74267225	.	A	G	9	5	14	0	0	14	0	0
4	74267348	.	C	T	7	3	10	0	0	10	0	0
4	74267519	.	A	G	14	9	23	0	2	25	0	0
4	74267540	.	G	A	0	11	11	0	13	24	0	0
4	74267582	.	T	G	10	11	21	0	0	21	0	0
4	74267639	.	T	A	11	10	21	0	1	22	0	0
4	74267733	.	A	T	15	15	30	0	2	32	0	0
4	74267748	.	C	T	17	11	28	0	1	29	0	0
4	74267865	.	A	C	8	9	17	0	0	17	0	0
4	74268175	.	A	G	7	9	16	0	1	17	0	0
4	74268182	.	C	T	6	8	14	0	0	14	0	0
4	74271251	.	G	A	3	5	8	0	1	9	0	0
4	74278079	.	T	G	4	6	10	0	0	10	0	0
4	74278093	.	C	T	0	5	5	0	4	9	0	0
4	74282709	.	C	T	1	1	2	0	0	2	0	0
4	74282917	.	G	A	4	5	9	0	0	9	0	0
4	74284790	.	A	C	1	1	2	0	0	2	0	0
4	74287776	.	T	A	1	0	1	0	0	1	0	0
4	74301564	.	C	T	1	2	3	0	0	3	0	0
4	74888611	.	G	A	0	1	1	0	0	1	0	0
4	74891617	.	A	T	2	4	6	0	0	6	0	0
4	74891619	.	C	G	2	4	6	0	0	6	0	0
4	74929459	.	A	T	2	2	4	0	0	4	0	0
4	74943202	.	A	T	8	13	21	0	0	21	0	0
4	74952477	.	G	A	13	14	27	0	0	27	0	0
4	74952525	.	A	G	12	1	13	0	14	27	0	0
4	74952660	.	G	T	0	12	12	0	14	26	0	0
4	74960826	.	C	T	22	10	32	0	4	36	0	0
4	74961011	.	C	T	18	7	25	0	2	27	0	0
4	74961075	.	G	A	15	15	30	0	1	31	0	0
4	74961520	.	T	A	5	3	8	0	0	8	0	0
4	75013576	.	T	C	1	3	4	0	1	5	0	0
4	75013669	.	C	T	0	3	3	0	1	4	0	0
4	75028185	.	T	C	1	0	1	0	0	1	0	0
4	75028263	.	A	G	0	0	0	0	1	1	0	0
4	75031420	.	A	G	1	0	1	0	0	1	0	0
4	75138668	.	T	G	4	3	7	0	1	8	0	0
4	75138707	.	G	A	5	6	11	0	1	12	0	0
4	75138750	.	A	G	3	6	9	0	0	9	0	0
4	75139194	.	C	T	4	4	8	0	1	9	0	0
4	75142239	.	C	T	12	6	18	0	0	18	0	0
4	75142269	.	G	A	5	6	11	0	0	11	0	0
4	75146453	.	C	T	1	1	2	0	0	2	0	0
4	75149026	.	T	C	10	9	19	0	0	19	0	0
4	75149056	.	C	T	14	10	24	0	0	24	0	0
4	75149071	.	T	A	15	9	24	0	0	24	0	0
4	75149125	.	C	A	0	4	4	0	8	12	0	0
4	75149149	.	C	T	0	1	1	0	3	4	0	0
4	75150767	.	G	A	3	4	7	0	0	7	0	0
4	75153925	.	C	T	1	0	1	0	0	1	0	0
4	75154498	.	G	T	0	1	1	0	0	1	0	0
4	75157664	.	T	C	1	4	5	0	0	5	0	0
4	75157666	.	T	G	4	1	5	0	0	5	0	0
4	75268018	.	C	T	4	2	6	0	0	6	0	0
4	75416521	.	C	T	0	1	1	0	0	1	0	0
4	75416590	.	C	T	3	4	7	0	0	7	0	0
4	75416680	.	A	T	4	2	6	0	0	6	0	0
4	75416706	.	G	A	3	3	6	0	0	6	0	0
4	75416760	.	G	A	0	3	3	0	2	5	0	0
4	75417250	.	T	G	5	5	10	0	0	10	0	0
4	75417258	.	T	A	4	7	11	0	0	11	0	0
4	75417723	.	C	A	2	1	3	0	1	4	0	0
4	75417735	.	T	C	2	2	4	0	0	4	0	0
4	75417762	.	A	G	2	4	6	0	0	6	0	0
4	75417916	.	C	A	3	2	5	0	0	5	0	0
4	75419353	.	C	T	4	2	6	0	0	6	0	0
4	75419387	.	C	T	2	3	5	0	0	5	0	0
4	75419421	.	G	T	1	3	4	0	0	4	0	0
4	75419428	.	C	T	1	3	4	0	0	4	0	0
4	75419528	.	G	C	0	5	5	0	2	7	0	0
4	75419551	.	G	C	3	5	8	0	0	8	0	0
4	75419683	.	G	T	0	4	4	0	4	8	0	0
4	75419819	.	C	G	6	14	20	0	0	20	0	0
4	75419822	.	A	C	6	13	19	0	0	19	0	0
4	75419916	.	G	T	8	7	15	0	0	15	0	0
4	75419928	.	T	G	8	0	8	0	5	14	1	0
4	75419961	.	A	C	11	8	19	0	1	20	0	0
4	75419970	.	G	A	0	10	10	0	12	22	0	0
4	75420186	.	A	G	8	0	8	0	6	14	0	0
4	75420194	.	T	C	7	5	12	0	1	13	0	0
4	75420264	.	C	A	10	4	14	0	1	15	0	0
4	75420270	.	A	G	8	7	15	0	2	17	0	0
4	75420647	.	A	T	6	3	9	0	0	9	0	0
4	75420754	.	T	A	5	3	8	0	0	8	0	0
4	75420873	.	A	C	4	11	15	0	0	15	0	0
4	75420931	.	A	G	2	6	8	1	0	9	0	0
4	76320439	.	C	T	4	2	6	0	0	6	0	0
4	76322771	.	T	C	12	4	16	0	1	17	0	0
4	76322882	.	G	A	0	3	3	0	1	4	0	0
4	76336468	.	T	A	2	2	4	0	0	4	0	0
4	76336471	.	A	C	2	2	4	0	0	4	0	0
4	76343850	.	A	G	4	5	9	0	1	10	0	0
4	76344109	.	C	A	4	2	6	0	0	6	0	0
4	76344120	.	C	A	2	2	4	0	1	5	0	0
4	76345689	.	C	T	5	4	9	0	0	9	0	0
4	76345733	.	A	G	0	1	1	0	2	3	0	0
4	76345974	.	A	G	3	3	6	0	0	6	0	0
4	76346004	.	T	C	4	2	6	0	0	6	0	0
4	76346011	.	T	C	4	2	6	0	0	6	0	0
4	76346153	.	G	C	2	4	6	0	0	6	0	0
4	76346188	.	T	A	4	10	14	0	0	14	0	0
4	76346238	.	C	A	9	3	12	0	3	15	0	0
4	76346564	.	C	T	3	5	8	0	0	8	0	0
4	76347058	.	A	G	4	0	4	0	4	8	0	0
4	76347126	.	T	C	3	3	6	0	0	6	0	0
4	76347163	.	A	G	5	4	9	0	0	9	0	0
4	76347216	.	A	G	6	3	9	0	0	9	0	0
4	76347225	.	A	G	3	0	3	0	4	7	0	0
4	76347467	.	A	G	5	0	5	0	3	8	0	0
4	76347508	.	T	G	5	4	9	0	0	9	0	0
4	76359632	.	C	T	0	2	2	0	0	2	0	0
4	76359636	.	C	T	0	3	3	0	0	3	0	0
4	76360446	.	T	C	1	4	5	0	0	5	0	0
4	76360593	.	C	G	1	1	2	0	0	2	0	0
4	76363195	.	C	T	0	3	3	0	1	4	0	0
4	76363204	.	A	C	1	3	4	0	0	4	0	0
4	76364322	.	G	C	1	2	3	0	0	3	0	0
4	76364359	.	T	A	1	4	5	0	0	5	0	0
4	76378449	.	T	C	1	2	3	0	0	3	0	0
4	76409020	.	G	A	1	2	3	0	0	3	0	0
4	76409155	.	T	C	2	4	6	0	1	7	0	0
4	76409461	.	A	G	1	0	1	0	3	4	0	0
4	76409494	.	A	C	1	4	5	0	0	5	0	0
4	76409518	.	C	G	0	7	7	0	0	7	0	0
4	76409751	.	A	T	4	2	6	0	0	6	0	0
4	76410940	.	G	T	1	2	3	0	1	4	0	0
4	76410955	.	C	T	3	2	5	0	0	5	0	0
4	76411346	.	T	C	2	3	5	0	0	5	0	0
4	76411505	.	C	T	1	2	3	0	0	3	0	0
4	76411517	.	T	C	1	2	3	0	0	3	0	0
4	76411990	.	A	G	2	0	2	0	3	5	0	0
4	76412061	.	A	G	3	3	6	0	0	6	0	0
4	76412107	.	C	T	2	4	6	0	0	6	0	0
4	76412108	.	T	G	2	4	6	0	0	6	0	0
4	76412252	.	A	T	4	2	6	0	0	6	0	0
4	76412570	.	G	A	4	6	10	0	0	10	0	0
4	76412625	.	C	A	3	2	5	0	0	5	0	0
4	76416857	.	G	T	1	1	2	0	0	2	0	0
4	76420800	.	A	G	0	3	3	0	0	3	0	0
4	76420809	.	A	G	0	3	3	0	0	3	0	0
4	76420883	.	G	A	1	2	3	0	0	3	0	0
4	76420930	.	T	A	1	6	7	0	0	7	0	0
4	76421602	.	A	C	5	2	7	0	0	7	0	0
4	76421958	.	C	T	2	2	4	0	0	4	0	0
4	76421987	.	G	T	3	3	6	0	0	6	0	0
4	76422057	.	T	A	1	5	6	0	1	8	1	0
4	76422129	.	G	T	0	4	4	0	4	8	0	0
4	76422231	.	G	A	0	5	5	0	3	8	0	0
4	76422395	.	C	T	3	2	5	0	1	6	0	0
4	76422424	.	A	G	4	1	5	0	0	5	0	0
4	76422432	.	G	A	2	3	5	0	0	5	0	0
4	76423234	.	G	A	1	0	1	0	0	1	0	0
4	76423418	.	A	G	2	3	5	0	1	6	0	0
4	76423462	.	A	G	1	0	1	0	3	4	0	0
4	76423537	.	C	T	2	3	5	0	0	5	0	0
4	76427137	.	G	C	1	2	3	0	0	3	0	0
4	76427145	.	A	G	1	2	3	0	0	3	0	0
4	76429191	.	G	A	2	3	5	0	0	5	0	0
4	76429234	.	A	C	3	3	6	0	0	6	0	0
4	76429237	.	G	C	3	3	6	0	0	6	0	0
4	76429545	.	C	A	2	2	4	0	0	4	0	0
4	76429584	.	A	G	3	2	5	0	0	5	0	0
4	76437753	.	T	G	1	2	3	0	0	3	0	0
4	76437826	.	G	A	0	1	1	0	0	1	0	0
4	76437848	.	A	T	0	2	2	0	0	2	0	0
4	76437869	.	A	G	1	1	2	0	0	2	0	0
4	76438829	.	C	A	3	1	4	0	0	4	0	0
4	76438841	.	T	C	3	0	3	0	0	3	0	0
4	76439149	.	C	T	2	2	4	0	0	4	0	0
4	76439339	.	C	A	5	1	6	0	1	7	0	0
4	76439374	.	C	T	6	6	12	0	0	12	0	0
4	76439435	.	A	G	3	0	3	0	3	6	0	0
4	76462659	.	A	G	0	3	3	0	0	3	0	0
4	76462661	.	C	T	0	3	3	0	0	3	0	0
4	76463475	.	A	G	2	7	9	0	0	9	0	0
4	76463517	.	G	A	1	2	3	0	0	3	0	0
4	76473973	.	C	A	3	1	4	0	1	5	0	0
4	76473985	.	C	A	2	2	4	0	0	4	0	0
4	76474339	.	G	C	3	3	6	0	0	6	0	0
4	76474370	.	T	C	1	2	3	0	0	3	0	0
4	76474584	.	A	T	1	2	3	0	0	3	0	0
4	76480491	.	A	C	0	3	3	0	2	5	0	0
4	76480834	.	C	G	1	2	3	0	0	3	0	0
4	76480852	.	T	G	1	2	3	0	0	3	0	0
4	76480943	.	C	A	0	2	2	0	2	4	0	0
4	76480996	.	C	T	0	1	1	0	2	3	0	0
4	76481027	.	A	G	2	0	2	0	0	2	0	0
4	76481177	.	T	C	6	0	6	0	3	9	0	0
4	76481403	.	T	A	8	14	22	0	1	24	1	0
4	76481665	.	A	T	4	3	7	0	0	7	0	0
4	76481692	.	T	C	2	0	2	0	2	4	0	0
4	76482245	.	C	T	4	4	8	0	0	8	0	0
4	76482273	.	C	G	2	1	3	0	0	3	0	0
4	76482696	.	T	A	6	4	10	0	0	10	0	0
4	76484531	.	T	C	1	0	1	0	0	1	0	0
4	76488269	.	G	T	2	1	3	0	0	3	0	0
4	76488514	.	T	A	1	7	8	0	2	10	0	0
4	76488617	.	G	A	7	4	11	0	0	11	0	0
4	76488624	.	A	G	3	7	10	0	0	10	0	0
4	76488742	.	G	C	1	5	6	0	1	7	0	0
4	76488820	.	G	A	3	2	5	0	0	5	0	0
4	76581336	.	G	A	0	3	3	0	3	6	0	0
4	76581351	.	A	G	2	0	2	0	4	6	0	0
4	76587462	.	T	C	2	6	8	0	1	9	0	0
4	76587474	.	C	T	2	5	7	0	0	7	0	0
4	76588133	.	A	C	4	9	13	0	0	13	0	0
4	76588134	.	C	G	4	0	4	0	9	13	0	0
4	76588177	.	T	C	4	4	8	0	1	9	0	0
4	76588256	.	G	C	7	4	11	0	0	11	0	0
4	76588295	.	G	T	5	5	10	0	0	10	0	0
4	76588328	.	G	A	1	3	4	0	0	4	0	0
4	76839217	.	A	G	4	0	4	0	5	9	0	0
4	76839227	.	G	A	1	5	6	0	4	10	0	0
4	76839263	.	C	T	4	3	7	0	0	7	0	0
4	76839269	.	C	G	5	1	6	0	0	6	0	0
4	76855934	.	A	C	0	3	3	0	0	3	0	0
4	76855936	.	T	C	0	3	3	0	0	3	0	0
4	76855979	.	T	C	2	3	5	0	0	5	0	0
4	76867743	.	T	C	6	3	9	2	1	12	0	0
4	76867829	.	C	G	3	4	7	0	0	7	0	0
4	77047114	.	A	G	1	1	2	0	0	2	0	0
4	77047149	.	G	C	1	1	2	0	0	2	0	0
4	77052677	.	A	G	3	0	3	0	3	6	0	0
4	77057152	.	C	A	1	2	3	0	1	4	0	0
4	77057169	.	A	G	2	3	5	0	0	5	0	0
4	77057243	.	G	C	1	4	5	0	0	5	0	0
4	77057635	.	C	T	3	2	5	0	0	5	0	0
4	77057914	.	A	T	4	2	6	0	0	6	0	0
4	77058024	.	G	A	4	5	9	0	0	9	0	0
4	77058097	.	T	C	3	7	10	0	0	10	0	0
4	77058108	.	A	G	3	6	9	0	0	9	0	0
4	77058420	.	C	G	7	2	9	0	1	10	0	0
4	77058436	.	A	T	8	4	12	0	1	13	0	0
4	77058503	.	G	C	2	4	6	0	0	6	0	0
4	77058543	.	G	A	1	2	3	0	0	3	0	0
4	77058723	.	A	G	2	4	6	0	0	6	0	0
4	77058875	.	T	A	4	3	7	0	0	7	0	0
4	77064778	.	T	C	1	1	2	0	0	2	0	0
4	77064908	.	C	G	3	3	6	0	0	6	0	0
4	77065082	.	T	A	2	2	4	0	0	4	0	0
4	77065304	.	A	T	2	2	4	0	1	5	0	0
4	77145931	.	C	T	1	2	3	0	0	3	0	0
4	77146423	.	A	G	1	2	3	0	0	3	0	0
4	77146786	.	T	C	2	3	5	0	0	5	0	0
4	77148561	.	A	G	3	0	3	0	2	5	0	0
4	77148661	.	T	C	4	4	8	0	0	8	0	0
4	77148853	.	T	A	2	2	4	0	0	4	0	0
4	77149412	.	G	A	0	2	2	0	2	4	0	0
4	77149414	.	C	T	2	2	4	0	0	4	0	0
4	77149729	.	G	A	0	2	2	0	0	2	0	0
4	77149765	.	C	T	0	3	3	0	0	3	0	0
4	77149805	.	A	T	3	5	8	0	1	9	0	0
4	77149888	.	C	T	7	5	12	0	0	12	0	0
4	77149989	.	C	A	2	2	4	0	0	4	0	0
4	77149990	.	T	G	2	2	4	0	0	4	0	0
4	77207768	.	G	C	3	7	10	0	0	10	0	0
4	77207903	.	C	T	0	7	7	0	0	7	0	0
4	77212090	.	T	A	5	3	8	0	0	8	0	0
4	77214843	.	C	A	0	1	1	0	3	4	0	0
4	77214846	.	G	A	3	1	4	0	0	4	0	0
4	77219843	.	G	A	1	3	4	0	0	4	0	0
4	77221967	.	A	T	3	2	5	0	0	5	0	0
4	77221974	.	A	G	3	2	5	0	0	5	0	0
4	77222180	.	G	A	1	2	3	0	0	3	0	0
4	77227478	.	C	G	1	2	3	0	0	3	0	0
4	77227487	.	C	T	0	2	2	0	1	3	0	0
4	77229432	.	T	C	1	2	3	0	0	3	0	0
4	77230155	.	G	A	1	2	3	0	0	3	0	0
4	77230747	.	A	T	1	2	3	0	0	3	0	0
4	77233708	.	C	G	1	2	3	0	0	3	0	0
4	77237386	.	C	T	1	3	4	0	1	5	0	0
4	77250581	.	T	C	2	2	4	0	0	4	0	0
4	77250598	.	T	A	2	2	4	0	0	4	0	0
4	77250925	.	T	C	5	4	9	0	0	9	0	0
4	77251225	.	T	C	2	5	7	0	2	9	0	0
4	77251255	.	A	G	6	2	8	0	1	9	0	0
4	77251264	.	A	G	7	2	9	0	1	10	0	0
4	77254446	.	C	G	0	3	3	0	6	9	0	0
4	77254999	.	T	C	1	4	5	0	1	6	0	0
4	77270251	.	A	G	4	3	7	0	0	7	0	0
4	77270278	.	T	A	1	2	3	0	0	3	0	0
4	77270604	.	A	T	7	3	10	0	0	10	0	0
4	77270683	.	G	A	3	4	7	0	1	8	0	0
4	77270773	.	G	C	2	5	7	0	0	7	0	0
4	77271020	.	G	A	1	4	5	0	0	5	0	0
4	77271057	.	A	G	2	7	9	0	0	9	0	0
4	77271121	.	T	C	3	0	3	0	3	6	0	0
4	77271123	.	C	T	3	3	6	0	0	6	0	0
4	77271203	.	C	T	4	6	10	0	0	10	0	0
4	77271257	.	T	C	3	0	3	0	6	9	0	0
4	77271278	.	G	A	2	3	5	0	0	5	0	0
4	77271310	.	C	T	4	3	7	0	0	7	0	0
4	77271552	.	C	T	1	4	5	0	7	12	0	0
4	77271902	.	C	T	0	2	2	0	3	5	0	0
4	77271920	.	G	A	3	3	6	0	0	6	0	0
4	77271937	.	T	G	2	6	8	0	0	8	0	0
4	77271975	.	C	T	2	4	6	0	0	6	0	0
4	77271984	.	G	A	2	6	8	0	0	8	0	0
4	77272192	.	G	A	5	3	8	0	0	8	0	0
4	77272250	.	A	T	2	2	4	1	0	5	0	0
4	77272429	.	C	A	0	3	3	0	1	4	0	0
4	77272478	.	G	A	1	3	4	1	0	5	0	0
4	77273319	.	A	G	1	2	3	0	0	3	0	0
4	77274205	.	T	G	2	3	5	0	0	5	0	0
4	77274208	.	G	A	1	2	3	0	2	5	0	0
4	77389929	.	G	C	9	3	12	0	0	12	0	0
4	77389932	.	C	A	8	2	10	0	1	11	0	0
4	77928526	.	G	C	2	2	4	0	0	4	0	0
4	77931408	.	G	A	2	1	3	0	1	4	0	0
4	77932143	.	C	T	6	6	12	0	0	12	0	0
4	77932186	.	T	C	6	11	17	0	2	19	0	0
4	77932198	.	A	G	7	9	16	0	1	17	0	0
4	77932221	.	A	G	5	6	11	0	1	12	0	0
4	77932408	.	G	C	6	4	10	0	1	11	0	0
4	77932414	.	T	C	5	3	8	0	1	9	0	0
4	77932461	.	G	A	11	4	15	0	0	15	0	0
4	77932489	.	A	G	9	4	13	0	0	13	0	0
4	77945109	.	G	A	0	1	1	0	0	1	0	0
4	77948591	.	G	A	2	4	6	0	0	6	0	0
4	77953368	.	G	A	0	2	2	0	1	3	0	0
4	77954200	.	G	A	3	5	8	0	0	8	0	0
4	77954203	.	G	A	5	3	8	0	0	8	0	0
4	77959109	.	T	C	1	1	2	0	0	2	0	0
4	77960149	.	C	T	0	9	9	0	2	11	0	0
4	77963270	.	A	G	3	1	4	0	1	5	0	0
4	77963637	.	T	G	5	0	5	0	4	9	0	0
4	77964609	.	G	A	0	2	2	0	6	8	0	0
4	77965345	.	T	C	4	9	13	0	1	14	0	0
4	77965360	.	G	C	5	8	13	0	2	15	0	0
4	77966234	.	A	G	1	0	1	0	4	5	0	0
4	77966266	.	G	A	0	2	2	0	5	7	0	0
4	77967069	.	T	A	1	0	1	0	0	1	0	0
4	77968573	.	C	T	0	3	3	0	0	3	0	0
4	77968574	.	G	A	0	1	1	0	2	3	0	0
4	77976057	.	G	A	2	2	4	0	1	5	0	0
4	77981599	.	C	T	6	2	8	0	0	8	0	0
4	77981644	.	G	A	2	5	7	0	5	12	0	0
4	77981663	.	G	A	0	8	8	0	4	12	0	0
4	77993148	.	T	A	1	6	7	0	1	8	0	0
4	77993555	.	G	T	3	3	6	0	0	6	0	0
4	77993916	.	G	A	12	5	17	0	1	18	0	0
4	77995494	.	C	G	6	7	13	0	0	13	0	0
4	77995677	.	C	A	1	2	3	0	1	4	0	0
4	77995988	.	A	C	4	1	5	0	3	8	0	0
4	77996032	.	C	A	1	2	3	0	0	3	0	0
4	77996171	.	C	T	0	1	1	0	0	1	0	0
4	78020231	.	G	A	1	1	2	0	0	2	0	0
4	78022662	.	C	A	0	12	12	0	12	24	0	0
4	78024265	.	G	A	16	15	31	0	3	34	0	0
4	78024322	.	C	T	0	9	9	0	9	18	0	0
4	78024558	.	C	T	0	10	10	0	10	20	0	0
4	78025223	.	C	T	1	9	10	0	20	30	0	0
4	78025241	.	A	G	13	26	39	0	2	41	0	0
4	78025434	.	T	A	1	2	3	0	0	3	0	0
5	97140	.	A	G	0	1	1	0	0	1	0	0
5	318077	.	G	A	1	0	1	0	0	1	0	0
5	318125	.	C	T	1	0	1	0	0	1	0	0
5	320383	.	T	C	4	0	4	0	0	4	0	0
5	895581	.	T	C	0	2	2	0	0	2	0	0
5	899952	.	C	T	3	3	6	0	0	6	0	0
5	905263	.	C	A	8	2	10	0	1	11	0	0
5	917336	.	C	T	1	3	4	0	1	5	0	0
5	1055103	.	C	T	1	2	3	0	0	3	0	0
5	1059697	.	T	C	4	3	7	0	0	7	0	0
5	1068116	.	T	A	7	4	11	0	0	11	0	0
5	1079480	.	C	T	10	14	24	0	0	24	0	0
5	1079558	.	G	T	1	1	2	0	0	2	0	0
5	1083203	.	G	C	5	9	14	0	0	14	0	0
5	1083237	.	T	A	2	2	4	0	1	5	0	0
5	1083242	.	T	C	2	3	5	0	0	5	0	0
5	1083283	.	G	T	0	5	5	0	0	5	0	0
5	1083679	.	G	A	0	3	3	0	2	5	0	0
5	1083894	.	T	G	8	0	8	0	10	18	0	0
5	1152013	.	G	C	4	3	7	0	0	7	0	0
5	1207835	.	C	T	5	4	9	0	0	9	0	0
5	1216494	.	A	G	6	4	10	0	0	10	0	0
5	1216536	.	C	T	0	8	8	0	7	15	0	0
5	1216575	.	G	A	1	4	5	0	0	5	0	0
5	1219263	.	C	T	17	10	27	0	0	27	0	0
5	1219381	.	G	A	9	4	13	0	2	15	0	0
5	1223368	.	A	T	13	9	22	0	1	23	0	0
5	1223369	.	C	T	14	8	22	0	1	23	0	0
5	1223460	.	G	A	10	6	16	0	0	16	0	0
5	1223487	.	G	T	10	7	17	0	1	18	0	0
5	1240403	.	C	A	0	5	5	0	3	8	0	0
5	1240517	.	T	C	6	4	10	0	1	11	0	0
5	1240534	.	G	A	5	2	7	0	0	7	0	0
5	1244952	.	C	T	0	1	1	0	0	1	0	0
5	1245017	.	T	C	1	2	3	0	0	3	0	0
5	1271483	.	C	G	0	1	1	0	0	1	0	0
5	1274734	.	C	T	1	5	6	0	0	6	0	0
5	1274749	.	T	C	1	3	4	0	0	4	0	0
5	1299350	.	C	G	2	0	2	0	0	2	0	0
5	1306074	.	G	A	0	12	12	0	4	18	2	0
5	1311041	.	G	A	5	2	7	0	1	8	0	0
5	1317871	.	T	C	7	7	14	0	0	14	0	0
5	1317883	.	G	A	3	4	7	0	0	7	0	0
5	1420729	.	A	G	15	7	22	0	1	23	0	0
5	1421052	.	T	A	2	7	9	0	0	9	0	0
5	1421116	.	A	T	0	2	2	0	1	3	0	0
5	1438628	.	G	A	4	1	5	0	0	5	0	0
5	1445964	.	G	A	8	7	15	0	0	15	0	0
5	1451568	.	G	A	0	4	4	0	0	4	0	0
5	1451666	.	T	C	0	0	0	0	1	1	0	0
5	1456393	.	G	A	2	3	5	0	0	5	0	0
5	1456411	.	T	C	2	4	6	0	1	7	0	0
5	1519571	.	G	C	4	3	7	0	0	7	0	0
5	1519574	.	T	A	4	3	7	0	0	7	0	0
5	2242795	.	G	A	4	2	6	0	0	6	0	0
5	2251629	.	C	T	1	2	3	0	0	3	0	0
5	2251669	.	A	G	3	2	5	0	0	5	0	0
5	2251670	.	T	A	3	2	5	0	0	5	0	0
5	2251704	.	T	C	2	0	2	0	2	4	0	0
5	2254721	.	G	T	1	2	3	0	0	3	0	0
5	2658348	.	G	A	11	5	16	0	0	16	0	0
5	2693660	.	G	A	0	4	4	0	0	4	0	0
5	2709533	.	A	G	2	2	4	0	1	5	0	0
5	2709561	.	T	C	2	3	5	0	0	5	0	0
5	2709609	.	T	C	2	2	4	0	1	5	0	0
5	2713967	.	A	G	26	16	42	0	0	42	0	0
5	2714042	.	C	T	25	21	46	0	0	46	0	0
5	2714135	.	C	T	24	29	53	0	1	54	0	0
5	2714237	.	G	A	29	21	50	0	2	52	0	0
5	2714495	.	G	A	22	29	51	0	2	53	0	0
5	2714507	.	A	G	24	26	50	0	2	52	0	0
5	2714531	.	T	C	19	0	19	0	18	37	0	0
5	2716930	.	G	A	16	10	26	0	0	26	0	0
5	2716963	.	G	A	18	10	28	0	0	28	0	0
5	2717014	.	G	A	17	13	30	0	1	31	0	0
5	2717022	.	G	A	18	12	30	0	0	30	0	0
5	2717260	.	T	C	1	4	5	0	1	7	1	0
5	2717350	.	G	C	10	0	10	0	17	27	0	0
5	2717611	.	C	T	7	5	12	0	1	13	0	0
5	2717623	.	A	G	3	4	7	0	0	7	0	0
5	2717960	.	A	G	0	4	4	0	0	4	0	0
5	2718696	.	A	G	10	10	20	0	0	20	0	0
5	2718834	.	G	A	1	2	3	0	0	3	0	0
5	2720119	.	A	G	2	4	6	0	0	6	0	0
5	2721588	.	C	T	0	4	4	0	0	4	0	0
5	2742784	.	A	G	8	9	17	0	0	17	0	0
5	2744938	.	C	T	3	11	14	0	0	14	0	0
5	2744962	.	C	G	5	8	13	0	1	14	0	0
5	2744998	.	C	T	9	3	12	0	1	13	0	0
5	2745220	.	G	T	3	2	5	0	0	5	0	0
5	2750087	.	G	A	14	9	23	0	0	23	0	0
5	2750127	.	G	A	12	11	23	0	0	23	0	0
5	2750244	.	G	A	6	6	12	0	0	12	0	0
5	2750256	.	G	A	5	6	11	0	0	11	0	0
5	2751319	.	G	A	4	2	6	0	1	7	0	0
5	2751511	.	G	A	7	11	18	0	1	19	0	0
5	3185155	.	T	C	0	4	4	0	0	4	0	0
5	3185164	.	C	G	0	3	3	0	2	5	0	0
5	3185195	.	A	T	3	2	5	0	0	5	0	0
5	3192019	.	C	T	0	1	1	0	1	2	0	0
5	3197134	.	C	A	0	0	0	0	1	1	0	0
5	3362996	.	G	A	2	6	8	0	1	9	0	0
5	3363014	.	C	T	1	8	9	0	0	9	0	0
5	3544098	.	C	T	8	4	12	0	0	12	0	0
5	3544380	.	C	T	25	32	57	0	2	59	0	0
5	3544955	.	T	C	17	20	37	0	1	38	0	0
5	3545011	.	T	A	21	20	41	0	2	43	0	0
5	3568494	.	C	T	3	11	14	0	0	14	0	0
5	3568518	.	G	T	2	9	11	0	0	11	0	0
5	3568530	.	C	T	5	2	7	0	0	7	0	0
5	3573946	.	A	C	1	5	6	0	0	6	0	0
5	3611842	.	C	T	1	1	2	0	0	2	0	0
5	3611843	.	C	G	1	1	2	0	0	2	0	0
5	3611952	.	C	T	0	3	3	0	5	8	0	0
5	3612011	.	A	T	4	2	6	0	0	6	0	0
5	3612254	.	A	G	2	4	6	0	0	6	0	0
5	3612415	.	G	T	1	6	7	0	0	7	0	0
5	3617505	.	C	T	0	7	7	0	3	10	0	0
5	3617544	.	G	A	2	1	3	0	0	3	0	0
5	3618064	.	G	A	6	2	8	0	3	11	0	0
5	3670231	.	G	A	3	1	4	0	0	4	0	0
5	3891528	.	C	T	5	5	10	0	0	10	0	0
5	3891532	.	G	C	5	5	10	0	0	10	0	0
5	3891603	.	C	T	5	2	7	0	0	7	0	0
5	3914638	.	T	G	13	11	24	0	0	24	0	0
5	3925732	.	A	C	4	0	4	0	3	7	0	0
5	3925769	.	T	C	10	17	27	0	1	28	0	0
5	3927524	.	G	A	14	16	30	0	0	30	0	0
5	3928017	.	T	C	3	2	5	0	0	5	0	0
5	4010507	.	G	C	3	2	5	0	0	5	0	0
5	4010515	.	G	A	3	2	5	0	0	5	0	0
5	4010639	.	G	C	2	4	6	0	0	6	0	0
5	4024746	.	A	G	1	0	1	0	5	6	0	0
5	4024797	.	G	T	5	4	9	0	1	10	0	0
5	4024857	.	G	A	0	7	7	0	6	13	0	0
5	4024863	.	T	C	5	3	8	0	2	10	0	0
5	4052191	.	G	A	6	3	9	0	0	9	0	0
5	4052225	.	A	G	4	4	8	0	0	8	0	0
5	4137043	.	A	G	0	2	2	0	1	3	0	0
5	4142581	.	T	A	0	4	4	0	0	4	0	0
5	4142582	.	T	G	0	4	4	0	0	4	0	0
5	4254061	.	C	T	0	8	8	0	11	19	0	0
5	4260424	.	T	C	2	0	2	0	0	2	0	0
5	4265417	.	T	C	6	7	13	0	1	14	0	0
5	4273144	.	T	C	3	4	7	0	0	7	0	0
5	4273159	.	T	C	4	6	10	0	1	11	0	0
5	4275481	.	C	T	0	4	4	0	2	6	0	0
5	4281626	.	A	G	3	3	6	0	0	6	0	0
5	4281634	.	A	G	4	3	7	0	0	7	0	0
5	4292545	.	A	T	1	2	3	0	0	3	0	0
5	4292578	.	A	G	0	2	2	0	0	2	0	0
5	4293975	.	T	C	2	3	5	0	0	5	0	0
5	4293978	.	C	A	2	3	5	0	0	5	0	0
5	4296556	.	C	G	7	1	8	0	0	8	0	0
5	4299588	.	A	G	3	0	3	0	4	7	0	0
5	4373684	.	C	T	3	11	14	0	2	16	0	0
5	4373701	.	G	T	0	9	9	0	2	11	0	0
5	4373819	.	A	G	1	2	3	0	0	3	0	0
5	4373874	.	T	C	1	1	2	0	1	3	0	0
5	4382543	.	A	G	7	4	11	0	0	11	0	0
5	4384706	.	G	A	2	0	2	0	0	2	0	0
5	4397741	.	A	G	2	0	2	0	0	2	0	0
5	4414178	.	C	T	5	4	9	0	1	10	0	0
5	4444829	.	G	A	4	3	7	0	0	7	0	0
5	4444925	.	A	G	1	1	2	0	1	3	0	0
5	4445039	.	T	C	0	2	2	0	0	2	0	0
5	4448249	.	G	A	0	3	3	0	2	5	0	0
5	4448306	.	T	C	2	2	4	0	0	4	0	0
5	4733927	.	C	T	0	5	5	0	6	11	0	0
5	5171846	.	A	T	3	2	5	0	0	5	0	0
5	5185955	.	G	C	2	4	6	0	0	6	0	0
5	5195882	.	A	G	2	3	5	0	0	5	0	0
5	5217028	.	G	A	2	2	4	0	0	4	0	0
5	5308502	.	A	G	1	1	2	0	0	2	0	0
5	5321191	.	C	T	3	4	7	0	0	7	0	0
5	5394327	.	A	C	0	3	3	0	0	3	0	0
5	5394390	.	A	G	1	1	2	0	1	3	0	0
5	5399006	.	G	A	2	2	4	0	0	4	0	0
5	5399025	.	T	A	3	2	5	0	0	5	0	0
5	5406727	.	G	A	0	3	3	0	2	5	0	0
5	5486039	.	T	C	1	3	4	0	0	4	0	0
5	5622203	.	G	A	1	3	4	0	0	4	0	0
5	5632422	.	C	T	0	1	1	0	2	3	0	0
5	5642756	.	C	A	0	0	0	0	1	1	0	0
5	5669820	.	G	A	2	3	5	0	0	5	0	0
5	5720021	.	G	A	4	2	6	0	0	6	0	0
5	5731919	.	C	T	3	2	5	0	0	5	0	0
5	5733101	.	T	C	0	1	1	0	0	1	0	0
5	5733130	.	C	T	1	2	3	0	1	4	0	0
5	5733227	.	C	G	1	0	1	0	0	1	0	0
5	5736673	.	A	G	2	1	3	0	0	3	0	0
5	5736683	.	C	T	0	1	1	0	2	3	0	0
5	5778624	.	G	A	2	2	4	0	2	6	0	0
5	5780248	.	A	T	1	3	4	0	0	4	0	0
5	5783092	.	T	A	1	0	1	0	0	1	0	0
5	5797883	.	T	A	1	4	5	0	0	5	0	0
5	5798690	.	C	T	0	2	2	0	1	3	0	0
5	5799197	.	C	T	1	2	3	0	0	3	0	0
5	6427002	.	C	T	2	2	4	0	0	4	0	0
5	6672965	.	G	T	1	3	4	0	1	5	0	0
5	6714368	.	A	G	1	1	2	0	0	2	0	0
5	6726416	.	T	C	3	4	7	0	2	9	0	0
5	6726866	.	A	C	1	0	1	0	0	1	0	0
5	6796383	.	G	A	0	1	1	0	3	4	0	0
5	6807812	.	G	A	0	3	3	0	0	3	0	0
5	6820663	.	G	A	1	1	2	0	0	2	0	0
5	6827651	.	G	A	3	5	8	0	0	8	0	0
5	6827669	.	G	C	6	5	11	0	0	11	0	0
5	6828589	.	A	T	3	3	6	0	0	6	0	0
5	6828721	.	G	A	3	2	5	0	0	5	0	0
5	6832646	.	C	T	0	1	1	0	0	1	0	0
5	6839136	.	A	C	1	2	3	0	0	4	1	0
5	6844179	.	C	T	6	5	11	0	0	11	0	0
5	6858380	.	C	A	1	8	9	0	1	10	0	0
5	6858540	.	T	A	10	5	15	0	1	16	0	0
5	6858779	.	G	T	0	8	8	0	7	15	0	0
5	6863647	.	C	T	19	6	25	0	0	25	0	0
5	6863768	.	G	C	4	7	11	0	0	11	0	0
5	6863793	.	G	A	8	8	16	0	0	16	0	0
5	6863834	.	A	G	8	0	8	0	6	14	0	0
5	6863855	.	G	A	7	3	10	0	0	10	0	0
5	6864010	.	C	T	4	2	6	0	1	7	0	0
5	6864061	.	A	G	4	2	6	0	0	6	0	0
5	6878597	.	T	C	1	2	3	0	0	3	0	0
5	6881679	.	C	T	2	3	5	0	0	5	0	0
5	6881773	.	C	T	2	3	5	0	0	5	0	0
5	6892209	.	G	A	0	1	1	0	1	2	0	0
5	6921448	.	A	G	2	3	5	0	0	5	0	0
5	6956547	.	C	G	1	2	3	0	0	3	0	0
5	6958910	.	T	C	2	4	6	0	1	7	0	0
5	6958965	.	G	C	2	7	9	0	1	10	0	0
5	6959148	.	C	A	2	6	8	0	0	8	0	0
5	6959834	.	T	A	11	3	14	0	0	14	0	0
5	6959839	.	C	T	12	3	15	0	0	15	0	0
5	7444058	.	C	A	4	2	6	0	0	6	0	0
5	7477276	.	C	G	0	2	2	0	0	2	0	0
5	8006474	.	A	G	7	2	9	0	0	9	0	0
5	8006503	.	A	G	2	8	10	0	2	12	0	0
5	8006977	.	A	G	6	3	9	0	2	11	0	0
5	8015099	.	C	T	0	8	8	0	5	13	0	0
5	8015165	.	G	A	9	4	13	0	0	13	0	0
5	8015252	.	C	T	3	3	6	0	0	6	0	0
5	8015361	.	G	T	5	10	15	0	0	15	0	0
5	8019962	.	A	G	4	4	8	0	0	8	0	0
5	8020001	.	C	T	4	3	7	0	0	7	0	0
5	8038472	.	C	T	1	2	3	0	0	3	0	0
5	9443250	.	T	C	2	8	10	0	0	10	0	0
5	9443251	.	T	C	3	7	10	0	0	10	0	0
5	9824885	.	C	T	2	2	4	0	0	4	0	0
5	10046718	.	G	A	0	2	2	0	2	4	0	0
5	10766286	.	G	A	5	6	11	0	0	11	0	0
5	10766505	.	A	G	9	21	30	0	3	33	0	0
5	10766529	.	G	A	24	7	31	0	3	34	0	0
5	10766879	.	A	G	15	12	27	0	1	28	0	0
5	10767113	.	C	T	19	9	28	0	0	28	0	0
5	10767259	.	A	G	16	21	37	0	0	37	0	0
5	10767456	.	G	A	6	4	10	0	0	10	0	0
5	10767588	.	C	T	4	5	9	0	0	9	0	0
5	10768089	.	G	A	7	11	18	0	1	19	0	0
5	10768182	.	G	A	13	9	22	0	0	22	0	0
5	10768215	.	T	C	5	0	5	0	5	10	0	0
5	10946038	.	G	A	5	6	11	0	1	12	0	0
5	10946085	.	G	T	7	6	13	0	0	13	0	0
5	11244625	.	T	C	3	2	5	0	0	5	0	0
5	11244675	.	A	G	3	1	4	0	0	4	0	0
5	11250049	.	C	T	0	2	2	0	1	3	0	0
5	11507602	.	A	G	1	3	4	0	0	4	0	0
5	11573461	.	C	T	10	8	18	0	1	19	0	0
5	11727696	.	T	G	0	2	2	0	1	3	0	0
5	11727757	.	T	C	1	2	3	0	0	3	0	0
5	11812278	.	C	T	2	7	9	0	0	9	0	0
5	11816599	.	G	A	3	1	4	0	0	4	0	0
5	11824059	.	G	A	1	0	1	0	3	4	0	0
5	11824188	.	T	C	1	1	2	0	1	3	0	0
5	11826347	.	T	C	4	1	5	0	1	6	0	0
5	11836437	.	T	C	11	8	19	0	1	20	0	0
5	11864572	.	C	G	1	4	5	0	0	5	0	0
5	11864593	.	A	G	1	5	6	0	0	6	0	0
5	11864774	.	T	G	7	4	11	0	0	11	0	0
5	11869576	.	C	A	0	7	7	0	3	10	0	0
5	11900230	.	T	C	3	0	3	0	3	6	0	0
5	11905038	.	G	A	5	1	6	0	1	7	0	0
5	11905044	.	A	C	6	2	8	0	1	9	0	0
5	11905725	.	C	T	2	4	6	0	0	6	0	0
5	11905890	.	A	G	4	8	12	0	1	13	0	0
5	11905903	.	T	G	6	3	9	0	0	9	0	0
5	11917125	.	C	T	8	6	14	0	1	15	0	0
5	11917436	.	G	A	2	12	14	0	0	14	0	0
5	11917485	.	G	A	9	3	12	0	0	12	0	0
5	11917596	.	C	A	0	19	19	0	12	31	0	0
5	11933155	.	A	G	7	6	13	0	0	13	0	0
5	11935444	.	G	A	0	6	6	0	0	6	0	0
5	11937486	.	G	A	1	2	3	0	0	3	0	0
5	11941903	.	T	C	2	0	2	0	5	7	0	0
5	11943662	.	A	C	5	2	7	0	0	7	0	0
5	11943868	.	G	A	6	12	18	0	0	18	0	0
5	11943948	.	T	A	1	13	14	0	0	14	0	0
5	11943989	.	G	A	4	7	11	0	0	11	0	0
5	11944060	.	T	G	8	3	11	0	0	11	0	0
5	11949244	.	G	T	7	12	19	0	0	19	0	0
5	11959776	.	G	T	0	11	11	0	16	28	1	0
5	11959777	.	C	T	14	13	27	0	1	28	0	0
5	11959818	.	C	T	15	17	32	0	0	32	0	0
5	11959966	.	C	G	12	7	19	0	1	20	0	0
5	11959988	.	G	A	1	10	11	0	9	20	0	0
5	11982950	.	C	A	4	4	8	0	0	8	0	0
5	11983017	.	T	C	6	5	11	0	0	11	0	0
5	11983268	.	A	G	1	4	5	0	0	5	0	0
5	11983395	.	T	A	1	5	6	0	1	7	0	0
5	11983548	.	C	G	7	7	14	0	0	14	0	0
5	11984086	.	T	C	4	4	8	0	1	9	0	0
5	11984133	.	C	T	5	7	12	0	0	12	0	0
5	11984141	.	T	A	5	7	12	0	1	13	0	0
5	12066142	.	G	A	0	1	1	0	0	1	0	0
5	12100335	.	G	A	6	4	10	0	0	10	0	0
5	12113257	.	T	C	1	0	1	0	0	1	0	0
5	12115313	.	A	G	4	1	5	0	0	5	0	0
5	12144035	.	T	C	0	1	1	0	0	1	0	0
5	12146026	.	A	G	3	2	5	0	1	6	0	0
5	12284075	.	C	T	15	10	25	0	2	27	0	0
5	12285172	.	T	C	12	0	12	0	7	19	0	0
5	12285316	.	C	T	2	1	3	0	1	4	0	0
5	12285504	.	C	A	2	2	4	0	0	4	0	0
5	12285601	.	C	G	5	4	9	0	1	10	0	0
5	12288511	.	T	C	4	8	12	0	2	14	0	0
5	12288541	.	A	G	3	5	8	0	0	8	0	0
5	12322321	.	G	A	1	1	2	0	0	2	0	0
5	12357538	.	G	A	1	0	1	0	0	1	0	0
5	12357554	.	C	T	4	0	4	0	0	4	0	0
5	12454563	.	T	C	7	0	7	0	11	18	0	0
5	12503554	.	G	A	4	2	6	0	1	7	0	0
5	12524938	.	A	G	8	3	11	0	0	11	0	0
5	12533197	.	C	T	1	1	2	0	0	2	0	0
5	12535785	.	A	T	0	1	1	0	0	1	0	0
5	12549258	.	C	T	5	5	10	0	0	10	0	0
5	12549326	.	C	T	3	9	12	0	0	12	0	0
5	12549776	.	G	T	5	2	7	0	0	7	0	0
5	12549807	.	A	G	3	3	6	0	1	7	0	0
5	12549981	.	G	T	4	7	11	0	0	11	0	0
5	12553935	.	C	T	0	3	3	0	2	5	0	0
5	12554119	.	A	G	4	3	7	0	0	7	0	0
5	12558090	.	C	T	1	5	6	0	0	6	0	0
5	12664278	.	G	A	1	5	6	0	0	6	0	0
5	12664330	.	T	C	2	2	4	0	0	4	0	0
5	12724121	.	C	T	8	4	12	0	2	14	0	0
5	12724224	.	G	A	9	11	20	0	0	20	0	0
5	12724249	.	A	C	10	2	12	0	0	12	0	0
5	12724292	.	C	A	7	1	8	0	0	8	0	0
5	12724307	.	A	G	3	4	7	0	2	9	0	0
5	12724412	.	A	G	4	2	6	0	0	6	0	0
5	12724450	.	C	T	0	6	6	0	5	11	0	0
5	12724505	.	C	A	4	18	22	0	1	23	0	0
5	12724518	.	G	C	5	0	5	0	18	23	0	0
5	12724567	.	A	G	13	9	22	0	0	22	0	0
5	12724694	.	C	T	1	11	12	0	14	26	0	0
5	12725930	.	G	A	0	3	3	0	0	3	0	0
5	12726842	.	A	G	2	3	5	0	0	5	0	0
5	12729397	.	C	T	1	2	3	0	0	3	0	0
5	12732247	.	C	T	4	2	6	0	0	6	0	0
5	12734883	.	G	T	3	2	5	0	0	5	0	0
5	12734910	.	T	C	3	3	6	0	0	6	0	0
5	12743011	.	C	A	9	4	13	0	0	13	0	0
5	12743159	.	A	T	5	3	8	0	0	8	0	0
5	12837064	.	G	A	4	6	10	0	0	10	0	0
5	12859258	.	T	C	11	16	27	0	1	28	0	0
5	12903862	.	G	C	4	4	8	0	0	8	0	0
5	12905070	.	A	C	1	2	3	0	0	3	0	0
5	12905911	.	A	C	2	4	6	0	0	6	0	0
5	12906014	.	C	T	1	3	4	0	0	4	0	0
5	12906273	.	C	T	1	0	1	0	0	1	0	0
5	12906343	.	A	G	2	0	2	0	3	5	0	0
5	12908828	.	C	A	2	6	8	0	1	9	0	0
5	12926507	.	C	A	1	0	1	0	0	1	0	0
5	12935223	.	A	G	0	1	1	0	2	3	0	0
5	12956918	.	T	C	1	2	3	0	0	3	0	0
5	12956960	.	C	T	1	1	2	0	1	3	0	0
5	12975532	.	C	T	0	1	1	0	1	2	0	0
5	12979846	.	C	T	5	2	7	0	1	8	0	0
5	12979848	.	C	A	5	2	7	0	1	8	0	0
5	13037199	.	C	T	0	9	9	0	2	11	0	0
5	13037723	.	A	G	3	3	6	0	0	6	0	0
5	13037939	.	T	G	4	10	14	0	2	16	0	0
5	13037967	.	G	A	6	11	17	0	0	17	0	0
5	13037998	.	A	G	7	10	17	0	1	18	0	0
5	13105020	.	C	T	25	15	40	0	7	47	0	0
5	13105070	.	C	A	1	23	24	0	25	49	0	0
5	13112979	.	G	A	2	1	3	0	2	5	0	0
5	13167048	.	A	T	9	13	22	0	1	23	0	0
5	13212507	.	T	A	0	2	2	0	0	2	0	0
5	13213082	.	T	C	1	3	4	0	0	4	0	0
5	13214008	.	A	T	1	2	3	0	0	3	0	0
5	13214802	.	C	G	7	3	10	0	0	10	0	0
5	13216416	.	T	C	3	2	5	0	0	5	0	0
5	13223062	.	G	A	3	1	4	0	0	4	0	0
5	13229024	.	C	A	0	1	1	0	0	1	0	0
5	13229846	.	G	T	2	1	3	0	0	3	0	0
5	13235157	.	G	C	0	2	2	0	0	2	0	0
5	13251681	.	A	C	2	0	2	0	1	3	0	0
5	13308778	.	A	C	1	3	4	0	0	4	0	0
5	13308997	.	G	T	1	6	7	0	0	7	0	0
5	13309174	.	T	C	3	1	4	0	11	15	0	0
5	13309215	.	C	T	13	6	19	0	1	20	0	0
5	13309273	.	C	T	11	18	29	0	1	30	0	0
5	13309309	.	G	A	12	11	23	0	2	25	0	0
5	13309402	.	A	G	11	17	28	0	1	29	0	0
5	13309435	.	A	T	9	19	28	0	0	28	0	0
5	13309522	.	G	A	9	14	23	0	1	24	0	0
5	13312671	.	A	T	1	1	2	0	0	2	0	0
5	13312746	.	G	A	10	15	25	0	0	25	0	0
5	13315490	.	G	C	6	4	10	0	0	10	0	0
5	13315526	.	T	C	11	5	16	0	0	16	0	0
5	13315603	.	A	C	14	8	22	0	0	22	0	0
5	13326851	.	C	T	1	3	4	0	0	4	0	0
5	13332930	.	A	G	3	2	5	0	1	6	0	0
5	13335291	.	C	T	1	1	2	0	1	3	0	0
5	13335373	.	G	T	0	8	8	0	2	10	0	0
5	13335423	.	C	T	5	5	10	0	0	10	0	0
5	13337803	.	C	T	9	11	20	0	3	23	0	0
5	13337883	.	T	A	10	17	27	0	4	31	0	0
5	13338441	.	C	T	1	17	18	0	20	38	0	0
5	13338762	.	A	T	13	9	22	0	1	23	0	0
5	13339038	.	G	C	20	15	35	0	11	46	0	0
5	13385888	.	A	G	1	0	1	0	2	3	0	0
5	13385916	.	T	A	3	1	4	0	0	4	0	0
5	13410768	.	A	G	1	3	4	0	0	4	0	0
5	13416419	.	C	T	1	2	3	0	0	3	0	0
5	13419418	.	T	C	3	3	6	0	0	6	0	0
5	13465095	.	T	C	2	4	6	0	0	6	0	0
5	13468108	.	G	T	0	3	3	0	2	5	0	0
5	13468440	.	T	A	3	4	7	0	1	8	0	0
5	13468574	.	G	A	3	5	8	0	0	8	0	0
5	13469105	.	T	A	1	2	3	0	0	3	0	0
5	13469137	.	C	A	3	4	7	0	0	7	0	0
5	13472279	.	C	T	6	6	12	0	0	12	0	0
5	13472295	.	G	T	6	6	12	0	0	12	0	0
5	13472743	.	A	T	3	3	6	0	0	6	0	0
5	13473094	.	T	G	1	4	5	0	0	5	0	0
5	13473334	.	G	A	0	4	4	0	6	10	0	0
5	13501228	.	T	C	1	1	2	0	0	2	0	0
5	13501288	.	C	A	3	1	4	0	0	4	0	0
5	13539403	.	A	G	1	0	1	0	5	6	0	0
5	13539493	.	A	G	1	0	1	0	3	4	0	0
5	13540689	.	C	T	6	9	15	0	0	15	0	0
5	13540738	.	C	T	5	4	9	0	0	9	0	0
5	13540846	.	T	A	5	5	10	0	0	10	0	0
5	13553485	.	C	T	1	3	4	0	0	4	0	0
5	13553764	.	A	G	1	3	4	0	0	4	0	0
5	13553784	.	A	G	1	3	4	0	0	4	0	0
5	13557614	.	T	C	1	2	3	0	0	3	0	0
5	13643325	.	G	A	13	9	22	0	1	23	0	0
5	13643411	.	C	T	1	24	25	0	21	46	0	0
5	13643824	.	G	A	16	9	25	0	1	26	0	0
5	13644126	.	A	T	19	14	33	0	2	35	0	0
5	13644185	.	T	G	13	17	30	0	0	30	0	0
5	13644189	.	T	G	11	17	28	0	1	29	0	0
5	13644227	.	A	G	12	8	20	0	0	20	0	0
5	13644256	.	A	T	13	3	16	0	1	17	0	0
5	13644581	.	T	G	15	23	38	0	3	41	0	0
5	13644602	.	T	A	19	20	39	0	0	39	0	0
5	13644781	.	C	T	8	6	14	0	0	14	0	0
5	13644797	.	A	G	6	6	12	0	0	12	0	0
5	13645047	.	C	G	14	15	29	0	1	30	0	0
5	13645746	.	A	G	12	11	23	0	4	27	0	0
5	13645885	.	T	C	13	9	22	0	2	24	0	0
5	13649518	.	C	T	8	6	14	0	0	14	0	0
5	13671624	.	G	T	9	4	13	0	3	16	0	0
5	13671631	.	A	C	7	10	17	0	0	17	0	0
5	13671899	.	C	G	16	11	27	0	1	28	0	0
5	13672004	.	C	T	0	21	21	0	23	44	0	0
5	13672211	.	C	T	16	28	44	0	2	46	0	0
5	13672232	.	C	T	26	15	41	0	2	43	0	0
5	13673016	.	C	G	0	7	7	0	6	13	0	0
5	13684132	.	A	G	19	28	47	0	3	50	0	0
5	13684502	.	C	A	5	23	28	0	17	45	0	0
5	15357403	.	A	G	12	0	12	0	16	28	0	0
5	15357517	.	A	G	9	8	17	0	1	18	0	0
5	15808230	.	G	A	2	6	8	0	0	8	0	0
5	15808327	.	A	G	3	0	3	0	3	6	0	0
5	15808329	.	A	G	3	0	3	0	3	6	0	0
5	15808536	.	C	T	1	7	8	0	0	8	0	0
5	15809602	.	A	G	2	3	5	0	0	5	0	0
5	15809671	.	G	T	3	3	6	0	0	6	0	0
5	15809708	.	C	A	2	2	4	0	0	4	0	0
5	15809754	.	C	T	2	2	4	0	1	5	0	0
5	15809903	.	C	T	0	2	2	0	1	3	0	0
5	15811534	.	A	G	1	1	2	0	0	2	0	0
5	16124992	.	A	G	5	2	7	0	0	7	0	0
5	18827368	.	T	C	8	3	11	0	2	13	0	0
5	18827683	.	C	T	1	6	7	0	0	7	0	0
5	19008334	.	A	G	27	7	34	0	10	44	0	0
5	20419373	.	G	C	12	7	19	0	0	19	0	0
5	20787190	.	T	C	3	6	9	0	1	10	0	0
5	20787281	.	T	C	1	2	3	0	0	3	0	0
5	20787283	.	T	C	1	2	3	0	0	3	0	0
5	20787995	.	C	T	6	2	8	0	1	9	0	0
5	20933321	.	C	A	0	38	38	0	3	41	0	0
5	20933332	.	T	C	0	0	0	0	41	41	0	0
5	22012452	.	T	C	7	4	11	0	0	11	0	0
5	22012459	.	T	C	5	6	11	0	0	11	0	0
5	22015647	.	G	A	2	2	4	0	0	4	0	0
5	22828072	.	T	C	0	1	1	0	4	5	0	0
5	23370824	.	T	C	1	6	7	0	1	8	0	0
5	23397221	.	T	C	3	2	5	0	0	5	0	0
5	23575646	.	T	C	3	6	9	0	0	9	0	0
5	24163098	.	A	G	4	3	7	0	0	7	0	0
5	24163099	.	A	G	4	3	7	0	0	7	0	0
5	24245085	.	T	A	0	6	6	0	0	6	0	0
5	24712264	.	G	A	1	7	8	0	0	8	0	0
5	24818475	.	T	C	7	4	11	0	1	12	0	0
5	24818488	.	T	C	8	3	11	0	1	12	0	0
5	24818529	.	T	C	7	3	10	0	2	12	0	0
5	24818564	.	T	C	6	6	12	0	0	12	0	0
5	24818651	.	T	C	3	3	6	0	0	6	0	0
5	25115210	.	C	T	0	2	2	0	1	3	0	0
5	25372384	.	C	T	0	3	3	0	0	3	0	0
5	26062514	.	A	G	6	5	11	0	1	12	0	0
5	26062532	.	A	G	8	5	13	0	0	13	0	0
5	26062582	.	A	G	9	8	17	0	0	17	0	0
5	26165250	.	G	T	1	0	1	0	0	1	0	0
5	26816836	.	A	C	5	1	6	0	11	17	0	0
5	29001203	.	A	G	8	8	16	0	1	17	0	0
5	29598984	.	T	C	28	0	28	0	23	51	0	0
5	30606363	.	A	G	3	2	5	0	0	5	0	0
5	31432387	.	A	G	0	5	5	0	2	7	0	0
5	32796788	.	T	C	1	2	3	0	0	4	1	0
5	33019181	.	G	A	5	4	9	0	0	9	0	0
5	33019571	.	C	G	5	6	11	0	0	11	0	0
5	33019598	.	G	A	3	5	8	0	0	8	0	0
5	33019826	.	T	C	4	2	6	0	0	6	0	0
5	33021257	.	A	T	2	1	3	0	0	3	0	0
5	33200071	.	G	A	5	12	17	0	2	19	0	0
5	33200279	.	T	C	2	0	2	0	2	4	0	0
5	33208429	.	A	G	13	10	23	0	2	25	0	0
5	33215307	.	G	A	4	8	12	0	1	13	0	0
5	33239090	.	G	T	4	3	7	0	0	7	0	0
5	33239099	.	C	T	2	3	5	0	0	5	0	0
5	33239444	.	G	T	7	5	12	0	0	12	0	0
5	33239486	.	A	G	3	8	11	0	0	11	0	0
5	33239551	.	A	T	3	6	9	0	0	9	0	0
5	33239625	.	T	C	5	8	13	0	3	16	0	0
5	33239996	.	T	C	4	3	7	0	1	8	0	0
5	33240295	.	G	A	10	15	25	0	2	27	0	0
5	33240425	.	A	T	4	6	10	0	1	11	0	0
5	33240469	.	T	C	3	12	15	0	0	15	0	0
5	33240600	.	G	A	9	7	16	0	0	16	0	0
5	33240930	.	A	T	8	5	13	0	0	13	0	0
5	33245668	.	C	A	0	8	8	0	4	12	0	0
5	33245860	.	C	T	0	8	8	0	4	12	0	0
5	33247152	.	C	T	1	3	4	0	0	4	0	0
5	33251276	.	A	T	6	5	11	0	0	11	0	0
5	33266608	.	G	C	2	1	3	0	2	5	0	0
5	33266919	.	C	G	2	2	4	0	0	4	0	0
5	33266924	.	A	C	2	2	4	0	0	4	0	0
5	33268218	.	T	C	2	0	2	0	0	2	0	0
5	33272649	.	A	G	1	1	2	0	0	2	0	0
5	33272654	.	A	T	1	1	2	0	0	2	0	0
5	33274560	.	G	A	0	1	1	0	0	1	0	0
5	33274563	.	A	G	0	1	1	0	0	1	0	0
5	33277701	.	A	G	2	1	3	0	0	3	0	0
5	33277928	.	C	T	0	4	4	0	5	9	0	0
5	33280612	.	C	T	0	1	1	0	0	1	0	0
5	33280658	.	C	T	3	3	6	0	0	6	0	0
5	33280951	.	A	G	3	3	6	0	0	6	0	0
5	33280976	.	G	A	3	2	5	0	0	5	0	0
5	33281047	.	A	C	4	3	7	0	1	8	0	0
5	33282484	.	A	C	2	5	7	0	0	7	0	0
5	33285096	.	C	T	0	8	8	0	4	12	0	0
5	33289072	.	T	G	3	0	3	0	1	4	0	0
5	33289170	.	A	T	10	4	14	0	0	14	0	0
5	33290815	.	A	G	10	0	10	0	6	16	0	0
5	33295805	.	A	G	2	4	6	0	0	6	0	0
5	33295806	.	A	G	2	4	6	0	0	6	0	0
5	33296924	.	G	T	10	9	19	0	2	21	0	0
5	33304337	.	T	C	0	1	1	0	0	1	0	0
5	33307621	.	C	G	11	17	28	0	0	28	0	0
5	33307805	.	C	G	1	4	5	0	0	5	0	0
5	33307812	.	C	A	1	1	2	0	0	2	0	0
5	33310458	.	G	T	0	2	2	0	0	2	0	0
5	33310947	.	T	G	7	4	11	0	0	11	0	0
5	33314422	.	G	C	1	2	3	0	0	3	0	0
5	33315247	.	A	T	6	5	11	0	0	11	0	0
5	33318597	.	G	A	0	2	2	0	2	4	0	0
5	33328791	.	C	A	13	11	24	0	0	24	0	0
5	33328939	.	A	G	6	3	9	0	1	10	0	0
5	33329210	.	G	A	0	17	17	0	5	22	0	0
5	33329345	.	G	A	0	10	10	0	16	26	0	0
5	33329418	.	G	A	13	17	30	0	1	31	0	0
5	33329600	.	T	C	10	10	20	0	2	22	0	0
5	33329740	.	G	T	10	8	18	0	0	18	0	0
5	33329774	.	A	G	3	7	10	0	0	10	0	0
5	33329786	.	A	G	3	8	11	0	0	11	0	0
5	33330146	.	G	C	8	10	18	0	0	18	0	0
5	33336805	.	C	A	1	2	3	0	0	3	0	0
5	33336920	.	A	G	4	4	8	0	0	8	0	0
5	33336934	.	C	T	1	5	6	0	0	6	0	0
5	33337366	.	T	G	3	2	5	0	2	7	0	0
5	33337593	.	A	T	6	6	12	0	0	12	0	0
5	33337610	.	A	G	8	6	14	0	0	14	0	0
5	33337776	.	A	C	3	3	6	0	0	6	0	0
5	33338099	.	T	A	8	4	12	0	0	12	0	0
5	33360761	.	C	G	10	8	18	0	1	19	0	0
5	33360835	.	T	G	7	9	16	0	0	16	0	0
5	33360884	.	T	C	1	3	4	0	0	4	0	0
5	33385512	.	T	A	1	3	4	0	1	5	0	0
5	33387624	.	A	G	5	1	6	0	0	6	0	0
5	33537918	.	T	A	1	6	7	0	1	8	0	0
5	33538011	.	G	T	3	4	7	0	0	7	0	0
5	33538197	.	C	T	0	6	6	0	2	8	0	0
5	33554892	.	T	C	1	5	6	0	0	6	0	0
5	33612040	.	G	A	1	3	4	0	0	4	0	0
5	33612317	.	G	A	4	2	6	0	0	6	0	0
5	33636449	.	C	T	6	2	8	0	0	8	0	0
5	33636887	.	A	G	0	1	1	0	0	1	0	0
5	33640552	.	A	G	2	1	3	0	0	3	0	0
5	33658010	.	G	A	3	4	7	0	0	7	0	0
5	33668821	.	G	A	5	4	9	0	0	9	0	0
5	33668827	.	C	T	5	4	9	0	0	9	0	0
5	33668894	.	C	T	4	3	7	0	0	7	0	0
5	33668936	.	G	T	1	3	4	0	0	4	0	0
5	33668943	.	A	T	4	0	4	0	0	4	0	0
5	33679862	.	T	G	5	7	12	0	0	12	0	0
5	33680184	.	T	G	9	14	23	0	0	23	0	0
5	33692389	.	C	T	0	6	6	0	3	9	0	0
5	33694109	.	T	C	8	3	11	0	0	11	0	0
5	33698666	.	G	A	7	5	12	0	0	12	0	0
5	34066594	.	C	T	6	5	11	0	0	11	0	0
5	34066837	.	G	A	2	1	3	0	0	3	0	0
5	34098880	.	G	T	2	1	3	0	0	3	0	0
5	34142962	.	A	G	2	8	10	0	0	10	0	0
5	34185186	.	C	G	5	8	13	0	0	13	0	0
5	34185195	.	C	T	4	8	12	0	0	12	0	0
5	34185399	.	A	T	2	3	5	0	0	5	0	0
5	34532673	.	T	C	1	3	4	0	0	4	0	0
5	34542344	.	C	T	4	2	6	0	0	6	0	0
5	34568883	.	T	C	9	17	26	0	3	29	0	0
5	34573792	.	T	C	1	5	6	0	0	6	0	0
5	34573807	.	T	C	5	11	16	0	0	16	0	0
5	34574165	.	G	A	16	6	22	0	1	23	0	0
5	34574191	.	T	G	13	8	21	0	0	21	0	0
5	34574224	.	G	A	12	12	24	0	0	24	0	0
5	34574238	.	C	A	9	14	23	0	0	23	0	0
5	34574267	.	G	A	15	13	28	0	1	29	0	0
5	34574546	.	A	G	14	0	14	0	19	33	0	0
5	34574915	.	C	T	17	13	30	0	2	32	0	0
5	34574919	.	A	G	18	17	35	0	1	36	0	0
5	34575079	.	T	A	20	1	21	0	0	21	0	0
5	34586139	.	T	G	0	3	3	0	0	3	0	0
5	34588977	.	A	G	2	0	2	0	4	6	0	0
5	34589009	.	G	T	4	7	11	0	0	11	0	0
5	34589225	.	G	T	0	2	2	0	1	3	0	0
5	34593568	.	A	G	1	3	4	0	0	4	0	0
5	34600639	.	C	G	2	4	6	0	0	6	0	0
5	34603792	.	T	G	6	6	12	0	0	12	0	0
5	34603811	.	T	C	4	4	8	0	0	8	0	0
5	34606570	.	C	T	1	1	2	0	0	2	0	0
5	34609005	.	A	G	1	2	3	0	0	3	0	0
5	34609116	.	G	C	2	0	2	0	5	7	0	0
5	34609321	.	A	G	2	3	5	0	0	5	0	0
5	34609324	.	G	A	2	3	5	0	0	5	0	0
5	34609357	.	G	A	3	4	7	0	0	7	0	0
5	34614057	.	A	G	0	2	2	0	0	2	0	0
5	34625152	.	G	A	0	2	2	0	1	3	0	0
5	34625623	.	T	C	2	2	4	0	0	4	0	0
5	34626076	.	T	C	3	3	6	0	0	6	0	0
5	34633673	.	C	T	3	3	6	0	0	6	0	0
5	34634180	.	C	A	3	6	9	0	1	10	0	0
5	34634253	.	T	G	9	5	14	0	0	14	0	0
5	34634894	.	G	T	5	5	10	0	0	10	0	0
5	34635098	.	T	A	10	8	18	0	0	18	0	0
5	34635133	.	A	T	7	6	13	0	1	14	0	0
5	34635194	.	A	G	8	5	13	0	0	13	0	0
5	34635673	.	G	A	7	5	12	0	0	12	0	0
5	34635701	.	T	C	7	2	9	0	1	10	0	0
5	34635795	.	A	T	5	1	6	0	1	8	1	0
5	34636252	.	G	A	7	7	14	0	0	14	0	0
5	34636347	.	G	T	6	1	7	0	0	7	0	0
5	34636413	.	G	A	2	5	7	0	0	7	0	0
5	34636457	.	A	T	3	6	9	0	0	9	0	0
5	34636638	.	T	C	5	4	9	0	0	9	0	0
5	34636731	.	A	T	4	8	12	0	1	13	0	0
5	34636986	.	T	G	2	4	6	0	1	7	0	0
5	34637067	.	T	C	6	5	11	0	0	11	0	0
5	34637399	.	A	C	5	6	11	2	0	13	0	0
5	34637466	.	T	C	11	5	16	0	1	17	0	0
5	34637539	.	A	G	7	11	18	0	0	18	0	0
5	34637667	.	T	G	4	4	8	0	3	11	0	0
5	34637681	.	A	G	7	5	12	0	1	13	0	0
5	34637706	.	T	G	10	7	17	0	2	19	0	0
5	34637843	.	A	G	8	16	24	0	0	24	0	0
5	34637849	.	G	C	9	17	26	0	0	26	0	0
5	34637997	.	A	C	21	18	39	0	0	39	0	0
5	34830080	.	T	A	3	3	6	0	0	6	0	0
5	34830084	.	G	T	3	2	5	0	1	6	0	0
5	34981636	.	A	T	1	1	2	0	0	2	0	0
5	34982414	.	G	A	7	5	12	0	0	12	0	0
5	34982866	.	C	G	8	1	9	0	12	21	0	0
5	34987043	.	A	T	14	16	30	0	3	33	0	0
5	34987812	.	G	A	6	8	14	0	0	14	0	0
5	34991271	.	C	T	30	20	50	0	3	53	0	0
5	35123955	.	C	T	5	7	12	0	0	12	0	0
5	35124398	.	C	T	10	10	20	0	0	20	0	0
5	35124435	.	T	C	10	1	11	0	10	21	0	0
5	35124939	.	G	A	1	7	8	0	1	9	0	0
5	35125414	.	C	T	0	3	3	0	9	12	0	0
5	35125423	.	C	T	7	4	11	0	1	12	0	0
5	35125492	.	C	T	0	2	2	0	5	7	0	0
5	35125882	.	G	A	5	6	11	0	0	11	0	0
5	35125883	.	A	T	4	6	10	0	1	11	0	0
5	35127255	.	G	C	3	2	5	0	0	5	0	0
5	35129861	.	C	A	1	3	4	0	0	4	0	0
5	35129892	.	T	C	1	0	1	0	1	2	0	0
5	35137621	.	C	T	0	1	1	0	2	3	0	0
5	35202676	.	A	G	3	2	5	0	0	5	0	0
5	35202815	.	T	A	10	7	17	0	1	18	0	0
5	35202958	.	G	A	12	3	15	0	1	16	0	0
5	35202959	.	A	T	12	3	15	0	1	16	0	0
5	35203092	.	G	A	7	11	18	0	4	22	0	0
5	35203629	.	C	T	0	13	13	0	19	32	0	0
5	35204077	.	T	G	5	6	11	0	2	13	0	0
5	35204390	.	G	A	7	7	14	0	0	14	0	0
5	35204681	.	A	C	3	5	8	0	0	8	0	0
5	35204689	.	A	C	3	0	3	0	4	7	0	0
5	35204857	.	T	C	10	0	10	0	3	13	0	0
5	35204934	.	A	T	13	9	22	0	0	22	0	0
5	35204945	.	T	C	10	12	22	0	1	23	0	0
5	35205005	.	G	A	8	8	16	0	0	16	0	0
5	35205123	.	C	G	1	2	3	0	0	3	0	0
5	35207914	.	T	G	1	5	6	0	0	6	0	0
5	35218361	.	G	A	1	1	2	0	0	2	0	0
5	35220402	.	T	A	5	4	9	0	1	10	0	0
5	35222413	.	T	G	1	0	1	0	0	1	0	0
5	35224334	.	A	G	0	1	1	0	0	1	0	0
5	35229964	.	G	A	1	4	5	0	1	6	0	0
5	35230015	.	G	A	1	2	3	0	0	3	0	0
5	35253608	.	T	C	3	0	3	0	3	6	0	0
5	35259846	.	G	C	0	3	3	0	0	3	0	0
5	35260553	.	A	G	0	1	1	0	0	1	0	0
5	35260554	.	C	T	0	1	1	0	0	1	0	0
5	35271001	.	C	T	22	17	39	0	1	40	0	0
5	35271465	.	T	C	33	21	54	0	2	56	0	0
5	35271613	.	G	A	17	25	42	0	2	44	0	0
5	35271706	.	C	T	14	35	49	0	0	49	0	0
5	35271791	.	T	A	18	11	29	0	1	30	0	0
5	35271824	.	C	A	2	14	16	0	0	16	0	0
5	35271889	.	T	A	18	17	35	0	1	37	1	0
5	35272562	.	A	C	12	19	31	0	0	31	0	0
5	35272774	.	T	G	18	20	38	0	0	38	0	0
5	35272835	.	G	A	23	25	48	0	0	48	0	0
5	35272909	.	A	G	22	22	44	0	3	47	0	0
5	35273099	.	G	C	20	24	44	0	0	44	0	0
5	35273164	.	T	C	18	24	42	0	0	42	0	0
5	35273632	.	T	C	11	18	29	0	0	29	0	0
5	35273793	.	A	T	16	17	33	0	0	33	0	0
5	35273825	.	C	A	18	10	28	0	1	29	0	0
5	35273838	.	A	C	12	19	31	0	1	32	0	0
5	35274029	.	C	A	18	16	34	0	2	36	0	0
5	35275070	.	G	A	14	22	36	0	1	37	0	0
5	35275103	.	C	T	19	18	37	0	3	40	0	0
5	35276154	.	A	G	18	10	28	0	4	32	0	0
5	35276911	.	C	T	1	12	13	0	11	24	0	0
5	35277256	.	T	A	10	10	20	0	1	21	0	0
5	35277319	.	T	C	14	17	31	0	0	31	0	0
5	35277459	.	T	C	8	14	22	0	2	24	0	0
5	35278597	.	C	T	11	12	23	0	0	23	0	0
5	35278863	.	C	T	11	8	19	0	0	19	0	0
5	35278933	.	T	C	8	1	9	0	9	18	0	0
5	35278977	.	T	G	6	6	12	0	2	14	0	0
5	35279275	.	T	G	11	10	21	0	0	21	0	0
5	35279341	.	G	A	8	13	21	0	2	23	0	0
5	35279387	.	T	G	8	12	20	0	0	20	0	0
5	35279647	.	G	T	6	9	15	0	1	16	0	0
5	35279884	.	G	A	6	3	9	0	0	9	0	0
5	35280157	.	T	C	2	0	2	0	8	10	0	0
5	35280226	.	C	T	0	5	5	0	0	5	0	0
5	35301563	.	A	G	2	0	2	0	0	2	0	0
5	35422550	.	G	C	3	0	3	0	6	9	0	0
5	35422692	.	C	T	12	13	25	0	0	25	0	0
5	35431641	.	A	G	6	6	12	0	0	12	0	0
5	35431703	.	T	G	0	2	2	0	1	3	0	0
5	35454416	.	C	T	0	6	6	0	11	17	0	0
5	35454464	.	C	T	4	6	10	0	0	10	0	0
5	35478326	.	G	A	0	2	2	0	0	2	0	0
5	35478593	.	G	C	0	1	1	0	2	3	0	0
5	35485487	.	A	G	2	2	4	0	0	4	0	0
5	35487132	.	C	T	10	7	17	0	1	18	0	0
5	35487658	.	G	C	4	3	7	0	0	7	0	0
5	35678570	.	G	A	0	3	3	0	5	8	0	0
5	35682826	.	C	T	0	2	2	0	1	3	0	0
5	35749458	.	A	G	4	0	4	0	0	4	0	0
5	35749470	.	A	G	0	4	4	0	0	4	0	0
5	35749826	.	A	G	3	3	6	0	0	6	0	0
5	35751883	.	G	T	3	4	7	0	0	7	0	0
5	35751970	.	C	T	6	5	11	0	1	12	0	0
5	35751977	.	A	G	4	6	10	0	1	11	0	0
5	35754354	.	A	G	10	10	20	0	1	21	0	0
5	35754481	.	T	G	19	13	32	0	0	32	0	0
5	35877578	.	C	A	3	3	6	0	0	6	0	0
5	35880250	.	T	C	2	3	5	0	0	5	0	0
5	35955514	.	T	C	10	14	24	0	1	25	0	0
5	35955534	.	G	T	17	9	26	0	0	26	0	0
5	35955663	.	T	A	4	3	7	0	0	7	0	0
5	35967234	.	C	T	4	10	14	0	1	15	0	0
5	35967438	.	A	T	1	2	3	0	0	3	0	0
5	36274750	.	C	A	2	3	5	0	0	5	0	0
5	36296066	.	G	A	1	3	4	0	1	5	0	0
5	36296114	.	T	C	1	4	5	0	0	5	0	0
5	36416597	.	C	G	14	20	34	0	1	35	0	0
5	36421991	.	G	A	0	9	9	0	11	20	0	0
5	36537182	.	G	A	0	6	6	0	8	14	0	0
5	36537510	.	A	G	10	4	14	0	0	14	0	0
5	36551614	.	C	A	7	16	23	0	0	23	0	0
5	36551824	.	C	T	0	7	7	0	15	22	0	0
5	36558059	.	G	A	6	4	10	0	2	12	0	0
5	36558286	.	G	A	9	10	19	0	0	19	0	0
5	36558369	.	G	A	15	11	26	0	0	26	0	0
5	36558441	.	C	T	2	10	12	0	0	12	0	0
5	36563257	.	T	C	4	5	9	0	0	9	0	0
5	36567750	.	C	A	1	4	5	0	3	8	0	0
5	36568071	.	A	T	3	2	5	0	0	5	0	0
5	36570280	.	G	A	1	1	2	0	0	2	0	0
5	36577828	.	T	C	0	2	2	0	0	2	0	0
5	36583575	.	C	T	0	2	2	0	3	5	0	0
5	36583644	.	G	A	6	6	12	0	1	13	0	0
5	36584779	.	G	T	1	0	1	0	1	2	0	0
5	36584985	.	C	T	1	3	4	0	1	5	0	0
5	36585662	.	G	A	3	3	6	0	0	6	0	0
5	36585933	.	C	T	2	6	8	0	0	8	0	0
5	36586844	.	A	C	4	2	6	0	0	6	0	0
5	36588938	.	A	G	3	1	4	0	0	4	0	0
5	36596278	.	G	A	7	4	11	0	0	11	0	0
5	36596294	.	G	A	5	7	12	0	0	12	0	0
5	36624638	.	A	T	8	12	20	0	0	20	0	0
5	36625809	.	A	T	18	24	42	0	3	45	0	0
5	36626632	.	A	T	19	21	40	0	3	43	0	0
5	36650153	.	C	A	2	8	10	0	0	10	0	0
5	36650176	.	A	T	0	7	7	0	1	8	0	0
5	36650289	.	T	G	3	6	9	0	1	10	0	0
5	36653522	.	G	A	4	3	7	0	0	7	0	0
5	36654147	.	G	A	1	5	6	0	7	13	0	0
5	36654334	.	A	T	4	6	10	0	0	10	0	0
5	36654344	.	G	A	5	4	9	0	1	10	0	0
5	36665351	.	C	T	4	9	13	0	2	15	0	0
5	36668321	.	C	T	3	3	6	0	0	6	0	0
5	36673347	.	C	T	5	7	12	0	0	12	0	0
5	36673470	.	C	A	6	9	15	0	1	16	0	0
5	36673609	.	A	G	2	3	5	0	0	5	0	0
5	36673687	.	A	T	3	6	9	0	1	10	0	0
5	36674796	.	G	C	6	6	12	0	0	13	1	0
5	36674831	.	C	T	6	5	11	0	1	12	0	0
5	36700733	.	A	G	1	0	1	0	2	3	0	0
5	36732199	.	G	C	3	6	9	0	0	9	0	0
5	36732217	.	A	G	3	5	8	0	1	9	0	0
5	36739134	.	T	C	12	20	32	0	0	32	0	0
5	36739310	.	T	A	11	13	24	0	2	26	0	0
5	36739316	.	T	C	14	11	25	0	0	25	0	0
5	36739352	.	T	A	13	8	21	0	2	23	0	0
5	36739361	.	T	C	11	9	20	0	0	20	0	0
5	36786641	.	G	A	0	2	2	0	6	8	0	0
5	36802395	.	A	C	5	3	8	0	0	8	0	0
5	36802407	.	T	C	4	4	8	0	0	8	0	0
5	36851191	.	C	T	3	4	7	0	0	7	0	0
5	36852564	.	A	G	2	0	2	0	2	4	0	0
5	36852848	.	G	A	0	3	3	0	1	4	0	0
5	36853849	.	C	G	7	2	9	0	0	9	0	0
5	36898476	.	C	T	5	4	9	0	0	9	0	0
5	36898668	.	A	G	9	0	9	0	6	15	0	0
5	36901003	.	T	G	2	2	4	0	0	4	0	0
5	36902610	.	A	G	5	0	5	0	5	10	0	0
5	36902628	.	T	C	4	5	9	0	1	10	0	0
5	36907182	.	G	T	5	5	10	0	0	10	0	0
5	36908034	.	T	C	13	27	40	0	2	42	0	0
5	36913570	.	A	G	4	2	6	0	0	6	0	0
5	36913916	.	A	T	2	3	5	0	0	5	0	0
5	36914002	.	C	T	3	3	6	0	0	6	0	0
5	36914018	.	A	C	4	0	4	0	3	7	0	0
5	36916370	.	A	T	1	0	1	0	0	1	0	0
5	36922399	.	A	G	0	1	1	0	0	1	0	0
5	36924122	.	G	C	1	0	1	0	1	2	0	0
5	36945378	.	T	A	19	19	38	0	2	40	0	0
5	36945383	.	A	T	19	18	37	0	3	40	0	0
5	36945463	.	T	A	17	20	37	0	5	42	0	0
5	36945518	.	T	G	24	15	39	0	5	44	0	0
5	36945719	.	G	T	32	27	59	0	8	67	0	0
5	36945747	.	T	A	24	29	53	0	7	60	0	0
5	36945927	.	A	C	32	32	64	0	3	67	0	0
5	36945937	.	C	T	29	30	59	0	1	60	0	0
5	36946244	.	A	G	29	33	62	0	6	68	0	0
5	36946261	.	T	C	28	2	30	0	32	62	0	0
5	36946341	.	C	T	1	29	30	0	32	62	0	0
5	36996458	.	A	G	13	16	29	0	1	30	0	0
5	36996638	.	A	G	15	1	16	0	21	37	0	0
5	36997133	.	A	G	17	10	27	0	0	27	0	0
5	37032095	.	A	G	16	17	33	0	2	35	0	0
5	37032191	.	T	C	10	11	21	0	2	23	0	0
5	37032280	.	C	G	11	12	23	0	1	25	1	0
5	37032339	.	A	G	10	0	10	0	10	20	0	0
5	37032611	.	T	C	12	13	25	0	0	25	0	0
5	37032782	.	G	A	10	14	24	0	0	24	0	0
5	37032799	.	A	T	9	8	17	0	0	17	0	0
5	37032959	.	A	G	5	9	14	0	0	14	0	0
5	37034111	.	T	C	1	7	8	0	1	9	0	0
5	37036404	.	T	C	5	7	12	0	0	12	0	0
5	37036662	.	T	A	9	3	12	0	0	12	0	0
5	37036856	.	T	C	7	11	18	0	0	18	0	0
5	37036975	.	A	T	10	6	16	0	2	18	0	0
5	37037079	.	C	T	14	15	29	0	0	29	0	0
5	37037152	.	T	C	13	15	28	0	2	30	0	0
5	37037308	.	C	A	5	2	7	0	2	9	0	0
5	37037436	.	G	T	0	12	12	0	5	17	0	0
5	37037583	.	T	C	10	9	19	0	1	20	0	0
5	37037617	.	A	T	15	14	29	0	1	30	0	0
5	37037669	.	T	G	18	16	34	0	1	35	0	0
5	37037742	.	A	T	16	19	35	0	1	36	0	0
5	37038017	.	T	C	7	4	11	0	0	11	0	0
5	37038059	.	C	T	2	2	4	0	0	4	0	0
5	37056839	.	A	G	3	0	3	0	2	5	0	0
5	37061485	.	G	A	6	6	12	0	0	12	0	0
5	37061487	.	C	T	6	6	12	0	0	12	0	0
5	37065416	.	T	C	19	21	40	0	5	45	0	0
5	37065729	.	C	T	20	8	28	0	0	32	4	0
5	37095076	.	A	T	3	3	6	0	0	6	0	0
5	37293768	.	G	A	1	2	3	0	0	3	0	0
5	37293841	.	G	A	1	2	3	0	0	3	0	0
5	37299125	.	G	A	4	9	13	0	0	13	0	0
5	37312520	.	T	A	12	9	21	0	2	23	0	0
5	37312556	.	A	T	16	16	32	0	4	36	0	0
5	37312577	.	A	G	15	0	15	0	19	34	0	0
5	37312681	.	C	A	8	9	17	0	0	17	0	0
5	37316716	.	G	C	8	0	8	0	17	25	0	0
5	37316743	.	A	G	5	8	13	0	0	13	0	0
5	37316954	.	A	G	4	11	15	0	0	15	0	0
5	37320254	.	A	G	7	9	16	0	0	16	0	0
5	37321251	.	C	G	0	5	5	0	3	8	0	0
5	37321488	.	G	A	1	3	4	0	0	4	0	0
5	37321519	.	C	T	4	4	8	0	1	9	0	0
5	37323690	.	C	T	1	3	4	0	0	4	0	0
5	37333870	.	G	A	11	17	28	0	0	28	0	0
5	37334264	.	T	A	1	0	1	0	0	1	0	0
5	37380701	.	T	G	9	4	13	0	1	14	0	0
5	37406445	.	G	A	0	5	5	0	3	8	0	0
5	37413762	.	G	A	0	3	3	0	0	3	0	0
5	37413846	.	C	T	0	1	1	0	0	1	0	0
5	37422993	.	C	T	5	0	5	0	0	5	0	0
5	37423193	.	G	A	5	9	14	0	2	16	0	0
5	37423298	.	G	A	0	9	9	0	8	17	0	0
5	37495132	.	T	C	1	5	6	0	0	6	0	0
5	37504636	.	A	T	2	3	5	0	0	5	0	0
5	37504637	.	T	A	2	3	5	0	0	5	0	0
5	37504720	.	T	C	2	3	5	0	0	5	0	0
5	37508274	.	T	C	5	2	7	0	1	8	0	0
5	37508303	.	T	C	4	3	7	0	0	7	0	0
5	37509285	.	T	C	4	9	13	0	0	13	0	0
5	37509374	.	T	A	2	5	7	0	1	8	0	0
5	37510403	.	C	G	10	5	15	0	0	15	0	0
5	37510404	.	C	T	9	5	14	0	1	15	0	0
5	37510491	.	T	A	9	9	18	0	2	20	0	0
5	37510520	.	C	T	8	9	17	0	0	17	0	0
5	37510565	.	A	T	5	5	10	0	0	10	0	0
5	37510574	.	C	G	4	2	6	0	1	7	0	0
5	37584180	.	T	A	5	2	7	0	0	7	0	0
5	37584220	.	T	A	2	2	4	0	0	4	0	0
5	37584380	.	G	A	0	3	3	0	2	5	0	0
5	37584401	.	C	T	2	2	4	0	0	4	0	0
5	37584619	.	T	C	0	2	2	0	0	2	0	0
5	37677229	.	C	T	4	5	9	0	0	9	0	0
5	37678256	.	T	C	6	6	12	0	0	12	0	0
5	37684289	.	G	A	7	4	11	0	0	11	0	0
5	37688371	.	C	T	16	10	26	0	0	26	0	0
5	37688422	.	A	G	7	2	9	0	1	10	0	0
5	37688560	.	C	G	4	2	6	0	0	6	0	0
5	37691223	.	A	G	2	1	3	0	1	4	0	0
5	37691459	.	T	C	13	10	23	0	1	24	0	0
5	37691516	.	C	T	11	7	18	0	1	19	0	0
5	37692171	.	A	G	1	1	2	0	0	2	0	0
5	37692198	.	C	T	3	7	10	0	0	10	0	0
5	37692620	.	T	C	10	10	20	0	1	21	0	0
5	37694283	.	G	A	2	2	4	0	0	4	0	0
5	37699373	.	C	T	9	12	21	0	1	22	0	0
5	37700905	.	C	T	15	14	29	0	0	29	0	0
5	37700908	.	T	C	13	12	25	0	3	28	0	0
5	37701262	.	T	A	10	13	23	0	1	24	0	0
5	37701281	.	C	T	14	10	24	0	0	24	0	0
5	37702934	.	C	T	9	18	27	0	0	27	0	0
5	37703180	.	G	A	6	5	11	0	1	12	0	0
5	37706798	.	C	T	5	12	17	0	1	18	0	0
5	37708995	.	A	T	22	23	45	0	2	47	0	0
5	37709057	.	T	A	19	23	42	0	0	42	0	0
5	37747276	.	C	T	1	1	2	0	0	2	0	0
5	37749854	.	G	C	0	2	2	0	0	2	0	0
5	37757331	.	A	G	3	0	3	0	6	9	0	0
5	37757690	.	T	C	13	8	21	0	0	21	0	0
5	37838415	.	T	C	2	3	5	0	0	5	0	0
5	37839029	.	G	T	26	25	51	0	0	51	0	0
5	37845348	.	C	T	1	2	3	0	0	3	0	0
5	37851351	.	C	T	2	2	4	0	0	4	0	0
5	37851923	.	G	A	1	3	4	0	0	4	0	0
5	37852048	.	A	T	4	7	11	0	1	12	0	0
5	37852053	.	G	A	4	8	12	0	1	13	0	0
5	37864789	.	G	A	13	8	21	0	1	22	0	0
5	37864845	.	A	G	13	5	18	0	1	19	0	0
5	37864849	.	T	G	13	6	19	0	1	20	0	0
5	37864982	.	T	A	5	9	14	0	2	16	0	0
5	37865142	.	C	T	8	3	11	0	1	12	0	0
5	37865429	.	T	A	8	5	13	0	0	13	0	0
5	37865876	.	C	T	3	3	6	0	0	6	0	0
5	37866310	.	C	T	4	5	9	0	0	9	0	0
5	37867046	.	C	T	2	4	6	0	1	7	0	0
5	37867491	.	C	T	1	0	1	0	1	2	0	0
5	37872801	.	C	T	3	3	6	0	0	6	0	0
5	37875576	.	A	G	0	2	2	0	0	2	0	0
5	37880896	.	C	T	0	2	2	0	2	4	0	0
5	37880922	.	G	A	2	4	6	0	0	6	0	0
5	37912292	.	T	A	23	14	37	0	0	37	0	0
5	37912859	.	A	C	16	16	32	0	0	32	0	0
5	37918855	.	G	A	11	6	17	0	1	18	0	0
5	37918882	.	C	T	2	8	10	0	16	26	0	0
5	37918932	.	A	T	14	10	24	0	0	24	0	0
5	37918993	.	T	C	16	5	21	0	1	22	0	0
5	37918994	.	C	T	13	6	19	0	3	22	0	0
5	37919253	.	A	T	11	4	15	0	2	18	1	0
5	37919258	.	T	C	10	0	10	0	7	17	0	0
5	37919293	.	C	T	6	6	12	0	1	13	0	0
5	37926362	.	C	T	0	2	2	0	3	5	0	0
5	37933891	.	A	G	2	1	3	0	0	3	0	0
5	37933914	.	A	G	3	1	4	0	0	4	0	0
5	37933930	.	C	G	0	4	4	0	4	8	0	0
5	37934058	.	G	A	13	7	20	0	1	21	0	0
5	37935468	.	A	C	7	4	11	0	0	11	0	0
5	37963259	.	C	T	10	14	24	0	2	26	0	0
5	37968912	.	T	G	4	2	6	0	0	7	1	0
5	37970764	.	C	T	6	24	30	0	1	31	0	0
5	37970773	.	A	T	5	18	23	0	2	25	0	0
5	37970818	.	T	G	7	0	7	0	13	20	0	0
5	37981972	.	C	T	1	0	1	0	0	1	0	0
5	37981997	.	T	C	1	0	1	0	0	1	0	0
5	37987114	.	A	T	6	8	14	0	0	14	0	0
5	37987301	.	T	C	2	2	4	0	0	4	0	0
5	37987325	.	C	T	0	5	5	0	4	9	0	0
5	37987369	.	G	A	2	3	5	0	0	5	0	0
5	37989128	.	G	C	5	0	5	0	11	16	0	0
5	37989135	.	A	G	6	8	14	0	0	14	0	0
5	37989325	.	G	A	10	8	18	0	2	20	0	0
5	37989379	.	G	T	10	5	15	0	3	18	0	0
5	37989443	.	A	C	6	1	7	0	0	7	0	0
5	37989447	.	A	G	5	1	6	0	0	6	0	0
5	37991350	.	T	A	6	1	7	0	0	7	0	0
5	37991535	.	T	G	1	2	3	0	0	3	0	0
5	37991566	.	C	A	0	2	2	0	1	3	0	0
5	37991756	.	C	T	1	0	1	0	0	1	0	0
5	37991757	.	C	T	1	0	1	0	0	1	0	0
5	37993446	.	G	T	2	2	4	0	1	5	0	0
5	37997251	.	T	A	1	1	2	0	1	3	0	0
5	38089247	.	G	T	4	3	7	0	0	7	0	0
5	38089309	.	G	A	2	4	6	0	1	7	0	0
5	38089337	.	T	C	5	2	7	0	0	7	0	0
5	38089537	.	T	C	4	3	7	0	1	8	0	0
5	38089578	.	T	G	6	6	12	0	1	13	0	0
5	38089651	.	G	A	8	7	15	0	0	15	0	0
5	38089733	.	G	C	2	0	2	0	8	10	0	0
5	38089834	.	A	G	3	5	8	0	0	8	0	0
5	38089930	.	G	T	3	7	10	0	1	11	0	0
5	38090070	.	A	G	4	3	7	0	0	7	0	0
5	38090542	.	G	A	6	6	12	0	0	12	0	0
5	38090659	.	G	C	0	0	0	0	6	6	0	0
5	38090677	.	A	G	5	3	8	0	0	8	0	0
5	38090707	.	G	A	5	2	7	0	0	7	0	0
5	38090734	.	G	T	4	2	6	0	0	6	0	0
5	38091247	.	A	G	2	2	4	0	0	4	0	0
5	38091547	.	A	G	2	2	4	0	0	4	0	0
5	38091573	.	G	A	2	3	5	0	0	5	0	0
5	38097190	.	G	T	0	3	3	0	0	3	0	0
5	38097406	.	C	G	2	2	4	0	0	4	0	0
5	38097408	.	T	A	2	2	4	0	0	4	0	0
5	38100992	.	T	C	1	1	2	0	0	2	0	0
5	38101745	.	T	G	1	1	2	0	2	4	0	0
5	38105012	.	C	G	1	2	3	0	0	3	0	0
5	38106815	.	C	T	1	2	3	0	1	4	0	0
5	38107054	.	T	C	1	2	3	0	0	3	0	0
5	38110826	.	G	T	8	6	14	0	1	15	0	0
5	38110908	.	A	T	9	4	13	0	0	13	0	0
5	38111060	.	T	C	9	0	9	0	13	22	0	0
5	38115349	.	T	C	8	5	13	0	1	14	0	0
5	38115361	.	T	C	9	6	15	0	0	15	0	0
5	38115395	.	A	G	6	4	10	0	0	10	0	0
5	38115502	.	C	T	10	4	14	0	0	14	0	0
5	38115582	.	C	T	8	4	12	0	0	12	0	0
5	38115685	.	A	T	6	8	14	0	0	14	0	0
5	38115940	.	T	C	6	0	6	0	4	10	0	0
5	38120116	.	A	G	1	0	1	0	0	1	0	0
5	38120117	.	C	A	1	0	1	0	0	1	0	0
5	38121914	.	T	A	4	4	8	0	1	9	0	0
5	38121942	.	A	G	9	5	14	0	0	14	0	0
5	38206476	.	C	T	1	0	1	0	0	1	0	0
5	38206485	.	G	T	0	0	0	0	1	1	0	0
5	38212551	.	T	G	3	0	3	0	6	9	0	0
5	38213052	.	A	G	4	0	4	1	4	9	0	0
5	38213310	.	C	A	1	3	4	0	0	4	0	0
5	38213877	.	G	C	7	5	12	0	0	12	0	0
5	38214258	.	A	G	4	7	11	0	0	11	0	0
5	38216175	.	T	G	2	3	5	0	0	5	0	0
5	38216204	.	G	A	3	3	6	0	0	6	0	0
5	38216344	.	G	A	1	3	4	0	0	4	0	0
5	38216469	.	C	A	2	4	6	0	0	6	0	0
5	38216471	.	C	T	0	4	4	0	2	6	0	0
5	38216661	.	G	A	7	2	9	0	0	9	0	0
5	38217376	.	T	C	4	4	8	0	0	8	0	0
5	38217422	.	G	T	2	3	5	0	0	5	0	0
5	38218004	.	G	A	2	3	5	0	0	5	0	0
5	38241247	.	A	G	1	2	3	0	0	3	0	0
5	38245083	.	T	A	2	2	4	0	0	4	0	0
5	38251120	.	A	C	2	4	6	0	0	6	0	0
5	38251244	.	T	G	1	4	5	0	0	5	0	0
5	38251360	.	T	C	3	2	5	0	0	5	0	0
5	38251506	.	C	T	0	2	2	0	2	4	0	0
5	38251968	.	T	G	6	4	10	0	0	10	0	0
5	38252113	.	G	C	1	2	3	0	0	3	0	0
5	38254734	.	A	G	6	2	8	0	0	8	0	0
5	38254919	.	A	G	2	2	4	0	0	4	0	0
5	38254958	.	C	T	0	2	2	0	1	3	0	0
5	38255108	.	G	T	3	3	6	0	0	6	0	0
5	38255132	.	G	A	2	6	8	0	1	9	0	0
5	38255219	.	A	C	2	1	3	0	8	11	0	0
5	38255452	.	G	A	4	3	7	0	0	7	0	0
5	38263384	.	G	A	10	17	27	0	0	27	0	0
5	38263611	.	G	A	14	19	33	0	1	34	0	0
5	38263870	.	C	T	0	2	2	0	0	2	0	0
5	38281540	.	G	C	1	8	9	0	7	16	0	0
5	38287103	.	C	T	14	17	31	0	0	31	0	0
5	38288313	.	T	A	1	1	2	0	0	2	0	0
5	38289358	.	A	C	17	22	39	0	2	41	0	0
5	38296192	.	C	T	25	19	44	0	0	44	0	0
5	38296193	.	A	G	25	19	44	0	0	44	0	0
5	38296475	.	G	A	19	11	30	0	0	30	0	0
5	38296765	.	A	C	26	19	45	0	0	45	0	0
5	38296799	.	A	C	16	23	39	0	0	39	0	0
5	38297305	.	A	G	16	1	17	0	21	38	0	0
5	38302085	.	G	A	8	14	22	0	0	22	0	0
5	38302158	.	C	A	15	16	31	1	1	33	0	0
5	38302159	.	A	C	22	8	30	1	1	33	1	0
5	38302490	.	A	G	19	23	42	0	1	43	0	0
5	38302589	.	T	A	24	18	42	0	1	43	0	0
5	38302753	.	G	T	22	28	50	0	3	53	0	0
5	38302859	.	C	T	25	15	40	0	1	41	0	0
5	38302911	.	A	T	20	8	28	0	2	30	0	0
5	38303028	.	G	T	17	20	37	0	2	39	0	0
5	38303301	.	T	C	17	0	17	0	19	36	0	0
5	38303895	.	A	T	18	21	39	0	2	42	1	0
5	38303896	.	G	A	20	22	42	0	0	42	0	0
5	38304578	.	C	T	23	17	40	0	0	40	0	0
5	38304633	.	T	G	19	17	36	0	0	36	0	0
5	38304768	.	G	A	12	32	44	0	1	45	0	0
5	38305068	.	G	A	25	20	45	0	2	47	0	0
5	38305127	.	T	C	12	14	26	0	2	32	4	0
5	38305493	.	C	T	10	17	27	0	0	27	0	0
5	38305698	.	G	A	16	11	27	0	2	29	0	0
5	38314069	.	C	T	5	9	14	0	0	14	0	0
5	38320825	.	A	G	5	3	8	0	2	10	0	0
5	38324453	.	C	T	3	1	4	0	0	4	0	0
5	38349956	.	A	G	3	0	3	0	0	3	0	0
5	38363132	.	T	C	2	0	2	0	3	5	0	0
5	38388786	.	G	A	2	2	4	0	0	4	0	0
5	38388875	.	C	G	0	3	3	0	2	5	0	0
5	38389087	.	C	G	6	5	11	0	3	14	0	0
5	38389089	.	G	A	7	6	13	0	0	14	1	0
5	38389441	.	A	T	4	0	4	0	1	5	0	0
5	38389538	.	G	A	7	5	12	0	2	14	0	0
5	38389641	.	G	A	3	4	7	0	0	7	0	0
5	38389642	.	G	T	3	4	7	0	0	7	0	0
5	38390352	.	A	G	2	3	5	0	0	5	0	0
5	38390429	.	C	T	3	2	5	0	0	5	0	0
5	38390672	.	C	T	5	4	9	0	0	9	0	0
5	38390728	.	C	T	2	3	5	0	0	5	0	0
5	38401395	.	A	G	1	3	4	0	0	4	0	0
5	38424267	.	G	A	1	1	2	0	0	2	0	0
5	38476030	.	T	A	4	10	14	0	0	14	0	0
5	38476185	.	C	T	9	7	16	0	0	16	0	0
5	38476750	.	C	A	13	7	20	0	0	20	0	0
5	38531848	.	T	A	7	3	10	0	2	12	0	0
5	38532216	.	A	T	5	9	14	0	0	14	0	0
5	38532462	.	T	C	11	1	12	0	14	26	0	0
5	38532535	.	A	G	9	10	19	0	0	19	0	0
5	38533170	.	A	G	7	7	14	0	1	15	0	0
5	38533248	.	G	A	6	5	11	0	0	11	0	0
5	38533296	.	T	G	7	12	19	0	1	20	0	0
5	38533392	.	G	T	10	8	18	0	2	20	0	0
5	38533404	.	C	T	0	7	7	0	13	20	0	0
5	38533464	.	A	G	6	5	11	0	1	12	0	0
5	38533551	.	A	G	11	14	25	0	0	25	0	0
5	38605094	.	C	T	5	9	14	0	1	15	0	0
5	38605106	.	A	T	7	9	16	0	0	16	0	0
5	38605201	.	A	C	10	6	16	0	0	16	0	0
5	38605291	.	G	C	17	6	23	0	1	24	0	0
5	38605347	.	G	T	10	5	15	0	1	16	0	0
5	38611096	.	G	T	3	2	5	0	0	5	0	0
5	38611108	.	T	C	1	0	1	0	0	1	0	0
5	38721044	.	G	C	3	0	3	0	0	3	0	0
5	38726961	.	A	T	3	5	8	0	0	8	0	0
5	38745925	.	C	T	2	2	4	0	0	4	0	0
5	38745962	.	A	T	3	2	5	0	1	6	0	0
5	38745980	.	G	T	0	1	1	0	2	3	0	0
5	38749541	.	T	A	2	2	4	0	0	4	0	0
5	38749767	.	C	T	4	8	12	0	0	12	0	0
5	38749814	.	G	A	3	4	7	0	0	7	0	0
5	38749892	.	C	T	5	3	8	0	1	9	0	0
5	38749893	.	C	T	6	3	9	0	0	9	0	0
5	38749939	.	C	A	2	2	4	0	0	4	0	0
5	38750354	.	T	G	3	4	7	0	0	7	0	0
5	38786808	.	C	T	2	2	4	0	1	5	0	0
5	38786823	.	G	A	2	3	5	0	0	5	0	0
5	38786922	.	T	C	4	3	7	0	1	8	0	0
5	38787083	.	A	T	1	2	3	0	0	3	0	0
5	38787107	.	G	T	1	2	3	0	1	4	0	0
5	38826047	.	A	C	2	2	4	0	0	4	0	0
5	38831573	.	A	G	1	2	3	0	1	4	0	0
5	39035768	.	C	T	1	2	3	0	1	4	0	0
5	39055104	.	T	C	2	1	3	0	0	3	0	0
5	39061917	.	T	C	1	3	4	0	0	4	0	0
5	39067289	.	T	C	1	1	2	0	1	3	0	0
5	39085271	.	T	C	1	2	3	0	0	3	0	0
5	39085302	.	T	A	0	3	3	0	1	4	0	0
5	39085328	.	C	T	1	2	3	0	0	3	0	0
5	39085976	.	C	T	8	7	15	0	0	15	0	0
5	39099379	.	C	T	4	2	6	0	0	6	0	0
5	39099642	.	T	C	7	4	11	0	0	11	0	0
5	39124314	.	C	T	3	1	4	0	0	4	0	0
5	39136032	.	G	A	3	6	9	0	0	9	0	0
5	39142657	.	A	G	3	0	3	0	3	6	0	0
5	39143310	.	C	T	5	8	13	0	0	13	0	0
5	39150608	.	C	A	1	2	3	0	0	3	0	0
5	39150623	.	C	T	1	3	4	0	0	4	0	0
5	39150803	.	T	C	2	4	6	0	0	6	0	0
5	39151379	.	G	A	0	2	2	0	1	3	0	0
5	39151493	.	G	A	0	3	3	0	2	5	0	0
5	39152582	.	A	G	2	4	6	0	0	6	0	0
5	39152613	.	T	A	4	3	7	0	0	7	0	0
5	39154714	.	A	C	3	0	3	0	3	6	0	0
5	39154819	.	C	G	12	10	22	0	0	22	0	0
5	39154829	.	G	T	10	7	17	0	4	21	0	0
5	39154919	.	A	G	6	17	23	0	0	23	0	0
5	39154958	.	C	G	6	14	20	0	1	21	0	0
5	39154979	.	C	T	0	8	8	0	8	16	0	0
5	39155006	.	T	A	7	7	14	0	0	14	0	0
5	39155044	.	A	G	5	8	13	0	0	13	0	0
5	39155419	.	C	T	5	5	10	0	0	10	0	0
5	39155473	.	T	A	3	7	10	0	1	11	0	0
5	39155474	.	G	T	3	8	11	0	0	11	0	0
5	39155511	.	A	G	2	6	8	0	0	8	0	0
5	39160584	.	G	A	5	2	7	0	0	8	1	0
5	39169387	.	T	C	1	0	1	0	2	3	0	0
5	39389246	.	T	A	1	3	4	0	0	4	0	0
5	39389251	.	G	A	1	3	4	0	0	4	0	0
5	39508009	.	C	T	21	18	39	0	2	41	0	0
5	39508059	.	T	A	18	13	31	0	2	33	0	0
5	39508540	.	G	A	1	7	8	0	16	24	0	0
5	39707665	.	A	T	8	4	12	0	0	12	0	0
5	39707758	.	A	C	2	10	12	0	1	13	0	0
5	39707825	.	G	A	4	8	12	0	0	12	0	0
5	39708046	.	A	G	12	11	23	0	1	24	0	0
5	39714917	.	T	C	0	2	2	0	0	2	0	0
5	39715249	.	G	A	6	6	12	0	0	12	0	0
5	39730511	.	A	G	11	5	16	0	1	17	0	0
5	39730575	.	C	T	2	1	3	0	0	3	0	0
5	39730713	.	T	C	1	5	6	0	0	6	0	0
5	39730785	.	A	G	1	0	1	0	0	1	0	0
5	39731805	.	T	C	6	7	13	0	0	13	0	0
5	39736279	.	C	T	7	4	11	0	1	12	0	0
5	40003053	.	G	A	0	3	3	0	0	3	0	0
5	40003650	.	C	T	1	7	8	0	0	8	0	0
5	40012989	.	G	A	0	2	2	0	0	2	0	0
5	40024831	.	C	T	0	4	4	0	8	12	0	0
5	40052933	.	A	G	6	28	34	0	2	36	0	0
5	40054407	.	C	G	3	5	8	0	0	8	0	0
5	40059722	.	C	G	17	22	39	0	0	39	0	0
5	40059761	.	T	C	12	18	30	0	2	32	0	0
5	40062351	.	A	G	13	14	27	0	1	28	0	0
5	40062390	.	G	A	11	6	17	0	1	18	0	0
5	40071745	.	C	T	4	4	8	0	1	9	0	0
5	40077300	.	G	A	2	0	2	0	0	2	0	0
5	40080885	.	G	A	5	2	7	0	0	7	0	0
5	40093858	.	G	A	0	1	1	0	0	1	0	0
5	40095602	.	C	T	0	4	4	0	1	5	0	0
5	40097502	.	A	G	7	5	12	0	0	12	0	0
5	40097505	.	A	G	7	6	13	0	0	13	0	0
5	40097831	.	A	G	8	3	11	0	0	11	0	0
5	40111613	.	G	T	1	1	2	0	0	2	0	0
5	40203540	.	G	A	5	5	10	0	0	10	0	0
5	40206117	.	G	A	1	6	7	0	1	8	0	0
5	40206358	.	A	C	6	9	15	0	0	15	0	0
5	40210379	.	A	C	2	6	8	0	0	8	0	0
5	40273444	.	A	C	1	2	3	0	1	4	0	0
5	40273468	.	T	C	3	4	7	0	0	7	0	0
5	40273510	.	G	T	3	3	6	0	0	6	0	0
5	40273606	.	C	T	0	6	6	0	5	11	0	0
5	40273727	.	T	A	5	4	9	0	0	9	0	0
5	40291442	.	C	G	0	2	2	0	4	6	0	0
5	40505124	.	C	T	1	5	6	0	4	10	0	0
5	40506670	.	G	A	4	4	8	0	0	8	0	0
5	40506837	.	A	G	4	2	6	0	0	6	0	0
5	40507154	.	C	G	5	3	8	0	0	8	0	0
5	40507577	.	C	A	5	6	11	0	0	11	0	0
5	40508436	.	T	C	5	0	5	0	0	5	0	0
5	40510347	.	T	G	3	2	5	0	0	5	0	0
5	40729081	.	A	C	5	5	10	0	0	10	0	0
5	40729147	.	T	C	6	2	8	0	0	8	0	0
5	40729270	.	G	C	5	6	11	0	0	11	0	0
5	40729408	.	G	A	7	11	18	0	0	18	0	0
5	40729618	.	A	G	6	12	18	0	0	18	0	0
5	40732293	.	A	G	3	2	5	0	0	5	0	0
5	40732341	.	T	A	1	1	2	0	0	2	0	0
5	40845312	.	A	G	10	4	14	0	0	14	0	0
5	40845344	.	G	C	8	5	13	0	0	13	0	0
5	40845387	.	A	G	4	7	11	0	0	11	0	0
5	40845389	.	A	T	3	6	9	0	2	11	0	0
5	40845433	.	A	G	3	5	8	0	0	8	0	0
5	40845434	.	G	A	3	4	7	0	1	8	0	0
5	40845505	.	G	C	1	0	1	0	5	6	0	0
5	40845556	.	C	A	9	9	18	0	0	18	0	0
5	40845893	.	A	G	3	10	13	0	0	13	0	0
5	40846122	.	G	A	9	10	19	0	0	19	0	0
5	40865309	.	C	T	0	5	5	0	6	11	0	0
5	40910770	.	A	G	3	10	13	0	2	15	0	0
5	40935003	.	C	T	2	3	5	0	0	5	0	0
5	40952550	.	A	T	2	2	4	0	0	4	0	0
5	40952768	.	A	G	1	2	3	0	0	3	0	0
5	40953178	.	G	T	3	2	5	0	0	5	0	0
5	41082921	.	C	G	14	10	24	0	0	24	0	0
5	41082951	.	A	C	10	0	10	0	8	18	0	0
5	41083000	.	C	A	10	5	15	0	0	15	0	0
5	41083001	.	T	C	10	0	10	0	5	15	0	0
5	41083118	.	C	T	0	3	3	0	4	7	0	0
5	41083763	.	A	G	8	14	22	0	1	23	0	0
5	41083854	.	T	C	13	8	21	1	1	23	0	0
5	41083874	.	G	T	13	15	28	0	3	31	0	0
5	41084063	.	G	C	8	11	19	1	0	20	0	0
5	41084274	.	A	G	11	12	23	0	1	24	0	0
5	41084367	.	C	A	0	6	6	0	12	19	1	0
5	41085049	.	A	C	4	3	7	0	0	7	0	0
5	41085118	.	A	G	3	3	6	0	0	6	0	0
5	41085414	.	T	A	5	7	12	0	0	12	0	0
5	41085511	.	C	T	0	6	6	0	5	11	0	0
5	41085571	.	T	C	4	0	4	0	5	9	0	0
5	41085582	.	C	T	4	4	8	0	1	9	0	0
5	41086082	.	T	G	1	6	7	0	1	8	0	0
5	41086195	.	A	T	7	6	13	0	0	13	0	0
5	41103286	.	T	C	9	10	19	0	2	21	0	0
5	41103462	.	A	G	8	8	16	0	1	17	0	0
5	41103469	.	G	A	5	10	15	0	3	18	0	0
5	41125097	.	C	T	4	6	10	0	0	10	0	0
5	41125229	.	G	T	11	7	18	0	0	18	0	0
5	41125310	.	A	C	23	17	40	0	2	42	0	0
5	41125311	.	A	C	22	16	38	0	4	42	0	0
5	41125354	.	C	A	28	12	40	0	3	43	0	0
5	41125996	.	T	C	23	22	45	0	2	47	0	0
5	41126059	.	G	A	26	23	49	0	3	52	0	0
5	41127078	.	A	G	2	4	6	0	0	6	0	0
5	41127111	.	T	C	4	7	11	0	0	11	0	0
5	41127132	.	C	T	4	7	11	0	0	11	0	0
5	41128808	.	T	G	12	3	15	0	0	15	0	0
5	41133401	.	A	T	11	12	23	0	1	24	0	0
5	41134921	.	A	T	5	10	15	0	0	15	0	0
5	41134942	.	A	G	9	16	25	0	0	25	0	0
5	41135002	.	A	G	13	17	30	0	2	32	0	0
5	41137311	.	G	A	15	13	28	0	5	33	0	0
5	41137341	.	G	A	22	18	40	0	0	40	0	0
5	41138377	.	C	T	21	15	36	0	0	36	0	0
5	41138720	.	T	C	11	13	24	0	2	26	0	0
5	41138738	.	A	G	10	13	23	0	3	26	0	0
5	41138756	.	C	A	17	16	33	0	2	35	0	0
5	41138807	.	T	C	21	0	21	0	16	37	0	0
5	41150615	.	C	T	6	13	19	0	0	19	0	0
5	41150898	.	T	A	17	21	38	0	0	38	0	0
5	41150979	.	A	C	25	25	50	0	2	52	0	0
5	41151265	.	G	A	10	6	16	0	1	17	0	0
5	41260937	.	C	T	7	6	13	0	1	14	0	0
5	41261032	.	A	G	1	5	6	0	0	6	0	0
5	41261680	.	A	G	6	1	7	0	1	8	0	0
5	41261684	.	G	A	7	2	9	0	0	9	0	0
5	41271781	.	A	G	0	2	2	0	0	2	0	0
5	41306594	.	C	T	2	5	7	0	0	7	0	0
5	41306624	.	G	A	2	5	7	0	1	8	0	0
5	41478237	.	G	A	6	2	8	0	4	12	0	0
5	41478264	.	A	G	5	0	5	0	7	12	0	0
5	41478349	.	C	T	4	4	8	0	0	8	0	0
5	41478382	.	T	C	3	4	7	0	0	7	0	0
5	41481405	.	A	G	6	3	9	0	0	9	0	0
5	41481991	.	C	T	0	1	1	0	1	2	0	0
5	41481996	.	C	T	0	2	2	0	0	2	0	0
5	41484391	.	A	C	2	3	5	0	0	5	0	0
5	41484460	.	T	C	6	17	23	0	0	23	0	0
5	41484496	.	T	C	3	12	15	0	3	18	0	0
5	41484680	.	C	T	10	7	17	0	0	17	0	0
5	41484797	.	C	A	8	7	15	0	1	16	0	0
5	41484991	.	A	G	1	1	2	0	1	3	0	0
5	41485363	.	C	G	16	12	28	0	1	29	0	0
5	41485365	.	A	G	16	13	29	0	0	29	0	0
5	41485497	.	C	G	23	20	43	0	1	44	0	0
5	41485533	.	C	T	2	22	24	0	26	50	0	0
5	41485709	.	A	T	19	33	52	0	5	57	0	0
5	41485814	.	A	T	21	30	51	0	0	51	0	0
5	41486025	.	A	G	34	27	61	0	5	66	0	0
5	41486031	.	T	G	34	32	66	0	0	66	0	0
5	41486803	.	G	A	2	3	5	0	0	5	0	0
5	41486890	.	C	T	28	19	47	0	6	53	0	0
5	41488903	.	A	G	24	13	37	0	1	38	0	0
5	41489487	.	G	T	16	16	32	0	3	35	0	0
5	41489493	.	C	T	16	15	31	0	6	37	0	0
5	41489748	.	T	C	8	10	18	0	2	20	0	0
5	41492135	.	C	T	2	0	2	0	1	3	0	0
5	41492183	.	C	T	0	18	18	0	18	36	0	0
5	41492234	.	G	A	24	26	50	0	0	50	0	0
5	41492279	.	G	A	9	14	23	0	0	23	0	0
5	41492901	.	G	A	14	33	47	0	1	48	0	0
5	41492934	.	A	G	13	31	44	0	2	46	0	0
5	41501561	.	T	C	1	2	3	0	0	3	0	0
5	41503549	.	C	T	4	2	6	0	0	6	0	0
5	41508900	.	C	G	0	1	1	0	0	1	0	0
5	41509073	.	T	G	0	2	2	0	1	3	0	0
5	41513013	.	T	C	3	10	13	0	0	13	0	0
5	41514127	.	A	G	3	3	6	0	0	6	0	0
5	41516322	.	A	C	1	6	7	0	0	7	0	0
5	41516521	.	G	A	6	5	11	0	1	12	0	0
5	41518836	.	T	C	18	16	34	0	2	36	0	0
5	41519423	.	A	C	24	21	45	0	1	46	0	0
5	41519459	.	T	C	10	14	24	0	1	25	0	0
5	41520822	.	A	T	21	16	37	0	0	37	0	0
5	41520823	.	T	C	20	12	32	0	4	37	1	0
5	41559351	.	G	T	4	1	5	0	0	5	0	0
5	41560836	.	T	A	0	3	3	0	0	3	0	0
5	41585126	.	C	T	2	0	2	0	0	2	0	0
5	41585186	.	G	A	2	4	6	0	1	7	0	0
5	41591467	.	T	C	1	2	3	0	0	3	0	0
5	41594919	.	G	T	0	4	4	0	0	4	0	0
5	41595242	.	C	T	1	1	2	0	0	2	0	0
5	41595243	.	T	C	1	1	2	0	0	2	0	0
5	41597384	.	C	T	0	2	2	0	2	4	0	0
5	41597659	.	G	T	0	1	1	0	0	1	0	0
5	41597713	.	C	T	1	2	3	0	0	3	0	0
5	41610842	.	G	T	3	3	6	0	0	6	0	0
5	41633397	.	A	G	2	1	3	0	1	4	0	0
5	41633418	.	C	T	4	1	5	0	0	5	0	0
5	41637290	.	C	T	1	2	3	0	0	3	0	0
5	41637701	.	G	C	1	1	2	0	3	5	0	0
5	41639787	.	A	T	3	4	7	0	0	7	0	0
5	41639814	.	A	G	4	3	7	0	1	8	0	0
5	41639874	.	G	T	2	7	9	0	0	9	0	0
5	41641750	.	G	A	6	8	14	0	0	14	0	0
5	41641835	.	G	C	9	8	17	0	0	17	0	0
5	41641887	.	A	G	9	8	17	0	0	17	0	0
5	41642348	.	G	A	0	5	5	0	0	5	0	0
5	41643084	.	A	G	2	2	4	0	1	5	0	0
5	41643095	.	A	G	2	3	5	0	0	5	0	0
5	41643359	.	G	A	1	0	1	0	0	1	0	0
5	41645652	.	A	G	17	16	33	0	2	35	0	0
5	41645982	.	A	G	13	11	24	0	1	25	0	0
5	41650451	.	T	C	13	3	16	0	23	39	0	0
5	41650505	.	T	G	5	4	9	0	13	22	0	0
5	41655134	.	G	A	2	3	5	0	0	5	0	0
5	41655155	.	T	A	5	6	11	0	1	12	0	0
5	41670193	.	G	A	4	9	13	0	0	13	0	0
5	41676855	.	T	C	2	0	2	0	3	5	0	0
5	41684870	.	A	G	10	4	14	0	1	15	0	0
5	41684885	.	A	T	9	4	13	0	0	13	0	0
5	41689439	.	T	G	1	1	2	0	0	2	0	0
5	41708947	.	C	T	0	4	4	0	2	6	0	0
5	41878612	.	A	C	5	13	18	0	0	18	0	0
5	41878660	.	A	G	9	15	24	0	0	24	0	0
5	41878711	.	C	T	0	16	16	0	13	29	0	0
5	41878965	.	G	C	6	9	15	0	0	15	0	0
5	41879465	.	C	G	13	7	20	0	1	21	0	0
5	41879497	.	T	C	9	8	17	0	1	18	0	0
5	41879848	.	C	A	4	8	12	0	0	12	0	0
5	41880240	.	T	C	11	1	12	0	15	27	0	0
5	41880243	.	T	C	8	1	9	0	19	28	0	0
5	41880280	.	C	G	12	20	32	0	1	33	0	0
5	41880288	.	G	A	11	20	31	0	1	32	0	0
5	41882364	.	T	C	4	2	6	0	0	6	0	0
5	41885861	.	C	A	0	1	1	0	0	1	0	0
5	41888132	.	T	C	7	0	7	0	9	16	0	0
5	41890054	.	G	A	11	15	26	0	0	26	0	0
5	41890092	.	A	G	8	13	21	0	0	21	0	0
5	41890277	.	T	G	0	2	2	0	0	2	0	0
5	41891324	.	T	C	0	0	0	0	1	1	0	0
5	41898424	.	A	G	1	1	2	0	0	2	0	0
5	41899006	.	C	G	0	2	2	0	5	7	0	0
5	41899015	.	C	T	0	3	3	0	6	9	0	0
5	41900012	.	A	C	2	0	2	0	0	2	0	0
5	41900020	.	A	G	2	0	2	0	0	2	0	0
5	41900126	.	G	T	5	8	13	0	1	14	0	0
5	41900153	.	T	C	3	0	3	0	10	13	0	0
5	41900604	.	C	T	2	2	4	0	2	6	0	0
5	41901020	.	A	G	1	0	1	0	2	3	0	0
5	41901093	.	T	C	2	5	7	0	0	7	0	0
5	41914679	.	G	T	5	3	8	0	0	8	0	0
5	41914692	.	T	C	5	4	9	0	0	9	0	0
5	41917306	.	A	G	1	5	6	0	0	6	0	0
5	41917426	.	C	T	6	5	11	0	0	11	0	0
5	41917501	.	G	A	3	11	14	0	0	14	0	0
5	41917544	.	C	T	2	7	9	0	0	9	0	0
5	41917615	.	G	A	2	3	5	0	1	6	0	0
5	41917631	.	C	A	1	4	5	0	0	5	0	0
5	41917678	.	T	A	0	2	2	0	0	2	0	0
5	41975971	.	T	A	1	0	1	0	0	1	0	0
5	41996202	.	C	A	0	1	1	0	0	1	0	0
5	41997098	.	T	C	3	4	7	0	0	7	0	0
5	41997144	.	G	A	3	2	5	0	0	5	0	0
5	41997146	.	A	T	3	2	5	0	0	5	0	0
5	42053399	.	T	C	3	5	8	0	0	8	0	0
5	42053465	.	G	C	2	7	9	0	0	9	0	0
5	42053985	.	C	A	3	2	5	0	0	5	0	0
5	42054025	.	T	A	1	2	3	0	0	3	0	0
5	42064204	.	T	G	4	4	8	0	0	8	0	0
5	42066958	.	C	T	0	1	1	0	0	1	0	0
5	42067588	.	G	A	0	0	0	0	0	0	0	0
5	42068736	.	T	C	1	3	4	0	0	4	0	0
5	42122838	.	G	A	0	2	2	0	0	2	0	0
5	42122907	.	C	T	8	6	14	0	1	15	0	0
5	42122914	.	C	T	9	6	15	0	0	15	0	0
5	42123023	.	C	T	20	11	31	0	3	34	0	0
5	42123125	.	C	T	21	17	38	0	0	38	0	0
5	42123375	.	C	A	15	11	26	0	2	28	0	0
5	42123664	.	A	G	13	8	21	0	0	21	0	0
5	42123697	.	G	C	18	11	29	0	0	29	0	0
5	42123766	.	G	T	12	5	17	0	0	17	0	0
5	43073005	.	A	T	6	6	12	0	0	12	0	0
5	43073019	.	T	C	6	7	13	0	1	14	0	0
5	43073116	.	T	C	4	2	6	0	4	10	0	0
5	43082997	.	A	G	7	0	7	0	11	18	0	0
5	43083084	.	A	C	6	6	12	0	2	14	0	0
5	43617277	.	C	G	7	9	16	0	1	17	0	0
5	43617295	.	C	G	8	8	16	0	0	16	0	0
5	43617692	.	T	C	6	0	6	0	22	28	0	0
5	43626060	.	C	T	0	2	2	0	2	4	0	0
5	43638710	.	C	T	0	1	1	0	2	3	0	0
5	43798423	.	G	T	0	1	1	0	0	1	0	0
5	43804235	.	T	C	3	1	4	0	3	7	0	0
5	43804251	.	G	A	8	4	12	0	0	12	0	0
5	43804475	.	T	C	3	0	3	0	2	5	0	0
5	43807070	.	G	A	0	11	11	0	7	18	0	0
5	43807340	.	T	C	2	3	5	0	0	5	0	0
5	43807494	.	G	C	0	1	1	0	0	1	0	0
5	43808863	.	C	T	1	1	2	0	4	6	0	0
5	43808866	.	C	T	1	2	3	0	4	7	0	0
5	43808965	.	T	C	11	9	20	0	1	21	0	0
5	43810302	.	G	A	3	1	4	0	0	4	0	0
5	43812691	.	G	A	1	0	1	0	0	1	0	0
5	43813003	.	G	A	3	2	5	0	0	5	0	0
5	43819422	.	T	A	19	12	31	0	1	32	0	0
5	43861561	.	A	T	8	8	16	0	0	16	0	0
5	43861922	.	A	T	8	5	13	0	1	14	0	0
5	43862069	.	C	T	0	8	8	0	7	15	0	0
5	43862318	.	T	C	9	1	10	0	8	18	0	0
5	43862449	.	G	A	7	7	14	0	0	14	0	0
5	43862628	.	G	A	9	7	16	0	0	16	0	0
5	43862725	.	T	A	9	5	14	0	2	16	0	0
5	43862737	.	C	T	6	8	14	0	0	14	0	0
5	43862924	.	A	G	9	15	24	0	2	26	0	0
5	43862954	.	A	T	13	10	23	0	2	25	0	0
5	43863052	.	C	T	7	10	17	0	0	17	0	0
5	43863222	.	A	T	4	3	7	0	0	7	0	0
5	43863241	.	G	A	5	5	10	0	0	10	0	0
5	43863304	.	T	C	9	6	15	0	0	15	0	0
5	43863315	.	G	A	10	6	16	0	0	16	0	0
5	43864907	.	G	A	2	2	4	0	0	4	0	0
5	43866804	.	T	G	8	4	12	0	0	12	0	0
5	43867013	.	A	C	2	5	7	0	0	7	0	0
5	43893543	.	C	T	4	2	6	0	1	7	0	0
5	43893744	.	C	T	1	0	1	0	1	2	0	0
5	43893750	.	C	T	1	1	2	0	0	2	0	0
5	43894951	.	A	G	6	6	12	0	0	12	0	0
5	44131403	.	T	C	2	1	3	0	0	3	0	0
5	44136677	.	C	T	4	4	8	0	1	9	0	0
5	44228551	.	G	C	0	2	2	0	1	3	0	0
5	44238706	.	G	A	0	1	1	0	0	1	0	0
5	44262496	.	C	T	12	12	24	0	2	26	0	0
5	44262756	.	C	G	5	5	10	0	0	10	0	0
5	44263024	.	T	A	10	5	15	0	0	15	0	0
5	44263078	.	A	T	7	9	16	0	1	17	0	0
5	44263204	.	C	A	9	10	19	0	1	20	0	0
5	44263851	.	T	A	8	7	15	0	1	16	0	0
5	44352300	.	T	C	1	8	9	0	0	9	0	0
5	44354265	.	C	A	0	1	1	0	0	1	0	0
5	44366090	.	G	A	2	2	4	0	0	4	0	0
5	44366621	.	T	C	1	1	2	0	0	2	0	0
5	44370681	.	A	G	6	0	6	0	6	12	0	0
5	44370828	.	C	T	13	11	24	0	2	26	0	0
5	44370910	.	C	T	5	9	14	0	0	14	0	0
5	44370943	.	G	A	5	6	11	0	1	12	0	0
5	44370998	.	G	A	9	6	15	0	0	15	0	0
5	44371043	.	C	T	7	8	15	0	0	15	0	0
5	44494998	.	T	A	4	7	11	0	0	11	0	0
5	44495224	.	A	T	2	3	5	0	0	5	0	0
5	44495275	.	A	T	2	5	7	0	0	7	0	0
5	44495363	.	A	C	3	2	5	0	0	5	0	0
5	44495591	.	G	A	2	2	4	0	0	4	0	0
5	44495777	.	T	A	1	2	3	0	1	4	0	0
5	44495822	.	G	A	1	4	5	0	1	6	0	0
5	44496692	.	T	A	1	2	3	0	0	3	0	0
5	44706810	.	A	G	5	0	5	0	6	11	0	0
5	44706841	.	C	T	4	5	9	0	0	9	0	0
5	44718442	.	A	T	0	1	1	0	0	1	0	0
5	44718481	.	C	T	4	2	6	0	0	6	0	0
5	44754973	.	A	C	6	7	13	0	1	14	0	0
5	44757992	.	C	T	3	2	5	0	0	5	0	0
5	44778273	.	T	C	2	1	3	0	0	3	0	0
5	44778279	.	G	C	2	3	5	0	0	5	0	0
5	44778893	.	A	G	1	3	4	0	0	4	0	0
5	44794455	.	G	A	12	6	18	0	1	19	0	0
5	44794459	.	T	G	12	0	12	0	7	19	0	0
5	44794606	.	C	G	10	14	24	0	0	24	0	0
5	44794613	.	G	T	1	13	14	0	10	24	0	0
5	44794816	.	C	T	8	6	14	0	0	14	0	0
5	44794955	.	A	C	7	6	13	0	0	13	0	0
5	44794969	.	A	G	6	7	13	0	0	13	0	0
5	44795297	.	A	G	9	1	10	0	19	29	0	0
5	44795308	.	A	G	19	9	28	0	2	30	0	0
5	44795467	.	T	G	18	11	29	0	0	29	0	0
5	44795468	.	A	T	16	8	24	0	5	29	0	0
5	44795598	.	G	A	1	8	9	0	10	19	0	0
5	44805182	.	C	T	1	2	3	0	0	3	0	0
5	44806446	.	G	A	15	11	26	0	0	26	0	0
5	44808520	.	T	G	2	1	3	0	1	4	0	0
5	44808553	.	C	T	9	8	17	0	1	18	0	0
5	44810341	.	T	C	4	6	10	0	0	10	0	0
5	44833676	.	A	T	1	2	3	0	0	3	0	0
5	44920250	.	G	A	0	3	3	0	2	5	0	0
5	44935147	.	T	C	0	2	2	0	0	2	0	0
5	44935156	.	T	C	0	2	2	0	0	2	0	0
5	44935777	.	C	G	0	1	1	0	0	1	0	0
5	44935952	.	C	T	3	3	6	0	0	6	0	0
5	45140914	.	A	C	0	1	1	0	0	1	0	0
5	45204118	.	C	T	7	5	12	0	1	13	0	0
5	45204175	.	G	A	2	1	3	0	0	3	0	0
5	45204971	.	A	G	3	2	5	0	0	5	0	0
5	45220330	.	A	G	6	5	11	0	0	11	0	0
5	45230659	.	C	A	10	2	12	0	0	12	0	0
5	45261926	.	C	T	5	4	9	0	0	9	0	0
5	45268941	.	C	T	1	0	1	0	0	1	0	0
5	45271966	.	C	A	1	3	4	0	0	4	0	0
5	45274429	.	G	A	9	10	19	0	0	19	0	0
5	45274486	.	C	T	12	8	20	0	0	20	0	0
5	45282910	.	G	A	4	4	8	0	0	8	0	0
5	45283046	.	G	T	5	4	9	0	0	9	0	0
5	45283446	.	A	G	15	6	21	0	0	21	0	0
5	45283654	.	T	C	6	5	11	0	1	12	0	0
5	45613585	.	T	C	1	5	6	0	0	6	0	0
5	45633060	.	G	A	0	2	2	0	0	2	0	0
5	45633063	.	C	G	0	1	1	0	1	2	0	0
5	45634431	.	G	A	2	3	5	0	0	5	0	0
5	45747118	.	G	T	0	5	5	0	2	7	0	0
5	45747924	.	A	T	6	7	13	0	0	13	0	0
5	45748025	.	A	C	3	12	15	0	0	15	0	0
5	45748172	.	T	A	4	4	8	0	0	8	0	0
5	45748313	.	G	A	12	4	16	0	0	16	0	0
5	45748545	.	T	A	10	11	21	0	0	21	0	0
5	45748563	.	C	T	9	8	17	0	2	19	0	0
5	45748627	.	A	C	8	1	9	0	4	13	0	0
5	45748672	.	G	T	7	7	14	0	1	15	0	0
5	45748726	.	A	C	8	0	8	0	10	18	0	0
5	45751208	.	C	T	0	0	0	0	2	2	0	0
5	45754818	.	C	T	9	5	14	0	0	14	0	0
5	45754851	.	A	G	10	11	21	0	1	22	0	0
5	45757617	.	A	G	2	4	6	0	0	6	0	0
5	45757644	.	A	G	3	5	8	0	0	8	0	0
5	45757731	.	A	G	0	2	2	0	0	2	0	0
5	45762892	.	A	G	0	1	1	0	0	1	0	0
5	45771930	.	G	A	1	3	4	0	0	4	0	0
5	45772014	.	T	C	1	2	3	0	0	3	0	0
5	45781987	.	C	T	1	2	3	0	0	3	0	0
5	45890074	.	C	T	0	8	8	0	5	13	0	0
5	45890086	.	A	T	3	6	9	0	1	10	0	0
5	45890159	.	A	G	2	5	7	0	0	7	0	0
5	45890195	.	A	G	7	7	14	0	1	15	0	0
5	45890219	.	A	T	8	11	19	0	0	19	0	0
5	45890663	.	T	A	14	11	25	0	0	25	0	0
5	45891090	.	A	G	10	4	14	0	0	14	0	0
5	45891226	.	T	A	9	9	18	0	0	18	0	0
5	45891327	.	G	T	11	10	21	0	0	21	0	0
5	45891431	.	C	T	3	2	5	0	0	5	0	0
5	45894547	.	G	A	8	6	14	0	1	15	0	0
5	45894560	.	G	C	7	6	13	0	0	13	0	0
5	45894699	.	C	T	10	12	22	0	1	23	0	0
5	45894720	.	T	C	11	16	27	0	1	28	0	0
5	45894737	.	T	C	9	20	29	0	0	29	0	0
5	45901863	.	G	A	1	2	3	0	0	3	0	0
5	45902041	.	A	C	0	2	2	0	0	2	0	0
5	45910590	.	G	A	0	2	2	0	3	5	0	0
5	45910811	.	G	A	1	5	6	0	3	9	0	0
5	45910838	.	G	T	5	4	9	0	0	9	0	0
5	45990116	.	A	G	6	5	11	0	0	11	0	0
5	45990237	.	C	A	5	6	11	0	0	11	0	0
5	45990465	.	C	T	1	4	5	0	0	5	0	0
5	46056557	.	T	C	2	3	5	0	0	5	0	0
5	46066228	.	A	G	0	0	0	0	1	1	0	0
5	46185572	.	G	A	1	1	2	0	1	3	0	0
5	46192412	.	C	T	1	1	2	0	0	2	0	0
5	46328314	.	C	T	8	8	16	0	2	18	0	0
5	46328476	.	T	C	3	0	3	0	6	9	0	0
5	46328611	.	C	T	4	4	8	0	1	9	0	0
5	46328758	.	C	T	6	6	12	0	0	12	0	0
5	46328797	.	G	A	5	6	11	0	1	12	0	0
5	46491253	.	T	A	1	4	5	0	0	5	0	0
5	46491263	.	G	A	1	4	5	0	0	5	0	0
5	46659401	.	A	G	18	25	43	0	1	44	0	0
5	46659666	.	T	A	18	18	36	0	2	38	0	0
5	46659707	.	C	A	27	22	49	0	1	50	0	0
5	46659861	.	G	A	19	10	29	0	4	33	0	0
5	46659984	.	A	G	10	32	42	0	1	43	0	0
5	46659985	.	A	G	9	33	42	0	1	43	0	0
5	46660068	.	C	T	10	20	30	0	0	30	0	0
5	46660120	.	A	G	8	23	31	0	0	31	0	0
5	46660201	.	A	G	14	14	28	0	1	29	0	0
5	46660259	.	T	C	12	26	38	0	0	39	1	0
5	46660541	.	T	C	23	14	37	0	0	37	0	0
5	46660577	.	T	C	19	5	24	1	0	28	3	0
5	46660600	.	T	A	21	10	31	1	0	32	0	0
5	46660672	.	G	A	18	14	32	0	0	32	0	0
5	46660681	.	A	G	17	10	27	0	1	28	0	0
5	46660727	.	T	C	18	8	26	0	2	28	0	0
5	46660735	.	G	C	21	10	31	0	0	31	0	0
5	46660780	.	A	G	21	22	43	0	1	44	0	0
5	46660819	.	A	G	25	16	41	0	0	41	0	0
5	46660906	.	A	G	9	25	34	0	0	34	0	0
5	46660941	.	A	T	13	23	36	0	0	36	0	0
5	46661006	.	A	T	15	12	27	0	0	27	0	0
5	46661157	.	A	T	5	9	14	0	1	15	0	0
5	46661240	.	A	G	13	17	30	0	0	30	0	0
5	46661348	.	G	C	21	14	35	0	1	36	0	0
5	46661349	.	G	A	22	14	36	0	0	36	0	0
5	46661418	.	T	C	22	24	46	0	1	47	0	0
5	46661423	.	T	C	23	1	24	0	23	47	0	0
5	46661519	.	C	T	14	17	31	0	1	32	0	0
5	46661678	.	T	A	9	9	18	0	0	18	0	0
5	46662184	.	G	T	3	2	5	0	0	5	0	0
5	46724854	.	G	A	15	25	40	0	1	41	0	0
5	46808477	.	A	G	2	1	3	0	0	3	0	0
5	46808567	.	G	A	3	4	7	0	1	8	0	0
5	46868923	.	A	G	9	7	16	0	0	16	0	0
5	47949989	.	A	G	4	0	4	0	3	7	0	0
5	47950862	.	C	T	0	2	2	0	0	2	0	0
5	47953550	.	G	A	4	2	6	0	0	6	0	0
5	47955833	.	C	A	1	1	2	0	0	2	0	0
5	47968970	.	C	T	2	2	4	0	0	4	0	0
5	47972770	.	T	C	2	0	2	0	3	5	0	0
5	47973386	.	T	G	0	1	1	0	0	1	0	0
5	47975340	.	A	T	2	5	7	0	0	7	0	0
5	47975378	.	C	T	1	2	3	0	1	4	0	0
5	47976525	.	C	T	3	4	7	0	0	7	0	0
5	47976728	.	C	G	9	8	17	0	0	17	0	0
5	47976747	.	C	A	7	10	17	0	0	17	0	0
5	47976827	.	A	G	3	3	6	0	1	7	0	0
5	48022939	.	G	A	3	2	5	0	0	5	0	0
5	48023044	.	C	T	2	6	8	0	1	9	0	0
5	48023209	.	C	T	1	2	3	0	0	3	0	0
5	48028112	.	G	A	4	4	8	0	1	9	0	0
5	48028406	.	A	C	5	8	13	0	0	13	0	0
5	48028435	.	G	T	5	5	10	0	1	11	0	0
5	48028508	.	T	C	6	6	12	0	0	12	0	0
5	48029294	.	T	C	6	6	12	0	0	12	0	0
5	48029490	.	T	A	3	4	7	0	3	10	0	0
5	48029510	.	C	A	3	5	8	0	0	8	0	0
5	48029732	.	C	T	0	3	3	0	7	10	0	0
5	48033995	.	T	C	1	1	2	0	0	2	0	0
5	48036243	.	C	T	2	3	5	0	0	5	0	0
5	48036246	.	G	C	2	3	5	0	0	5	0	0
5	48110155	.	C	A	0	1	1	0	2	3	0	0
5	48110331	.	G	A	6	7	13	0	1	14	0	0
5	48154436	.	G	A	2	1	3	0	0	3	0	0
5	48154456	.	T	A	3	1	4	0	0	4	0	0
5	48172446	.	C	A	0	2	2	0	4	6	0	0
5	48182021	.	A	G	7	10	17	0	0	17	0	0
5	48182030	.	T	C	8	0	8	0	8	16	0	0
5	48182066	.	C	G	5	7	12	0	5	17	0	0
5	48182216	.	A	G	5	4	9	0	3	12	0	0
5	48182550	.	A	T	10	7	17	0	0	17	0	0
5	48183414	.	T	C	9	0	9	0	6	15	0	0
5	48183577	.	C	T	0	5	5	0	9	14	0	0
5	48183579	.	A	G	7	6	13	0	0	14	1	0
5	48183628	.	T	C	9	0	9	0	9	18	0	0
5	48188963	.	A	G	10	6	16	0	0	16	0	0
5	48205945	.	T	A	0	1	1	0	0	1	0	0
5	48208539	.	G	A	4	9	13	0	0	13	0	0
5	48242529	.	T	G	3	0	3	0	0	3	0	0
5	48242610	.	G	A	9	6	15	0	0	15	0	0
5	48285619	.	C	T	3	6	9	0	0	9	0	0
5	48285709	.	G	C	2	3	5	0	0	5	0	0
5	48659794	.	T	C	1	0	1	0	2	3	0	0
5	48664229	.	T	C	3	5	8	0	0	8	0	0
5	48672740	.	G	A	11	4	15	0	0	15	0	0
5	48672752	.	C	T	0	11	11	0	5	16	0	0
5	48672925	.	A	T	2	3	5	0	0	5	0	0
5	48672970	.	G	A	3	2	5	0	0	5	0	0
5	48673501	.	A	G	9	10	19	0	0	19	0	0
5	48673639	.	C	A	0	4	4	0	7	11	0	0
5	48679428	.	A	T	2	10	12	0	1	13	0	0
5	48833121	.	A	C	1	3	4	0	0	4	0	0
5	48833199	.	C	T	1	2	3	0	0	3	0	0
5	48833241	.	C	G	2	2	4	0	0	4	0	0
5	48835792	.	C	T	1	2	3	0	0	3	0	0
5	48929274	.	G	A	1	2	3	0	1	4	0	0
5	48986593	.	A	G	15	33	48	0	0	48	0	0
5	48987199	.	C	T	28	9	37	0	1	38	0	0
5	48987772	.	G	A	37	7	44	0	0	44	0	0
5	48987920	.	T	C	29	11	40	0	0	40	0	0
5	48992401	.	T	C	18	0	18	0	11	29	0	0
5	48992972	.	C	T	0	0	0	0	1	1	0	0
5	48993345	.	T	C	1	4	5	0	0	5	0	0
5	48995559	.	A	T	4	12	16	0	0	16	0	0
5	48995613	.	A	G	14	5	19	0	3	22	0	0
5	48995884	.	G	A	9	12	21	0	2	23	0	0
5	48995945	.	G	A	4	7	11	0	1	12	0	0
5	49019328	.	C	T	0	3	3	0	3	6	0	0
5	49019760	.	A	T	1	3	4	0	0	4	0	0
5	49020200	.	T	A	3	2	5	0	0	5	0	0
5	49021633	.	T	C	1	1	2	0	0	2	0	0
5	49028707	.	G	T	2	2	4	0	0	4	0	0
5	49028742	.	T	A	3	2	5	0	1	6	0	0
5	49734545	.	G	A	8	9	17	0	0	17	0	0
5	49734581	.	C	T	6	10	16	0	1	17	0	0
5	49734682	.	C	A	5	8	13	0	1	14	0	0
5	49734751	.	T	G	3	3	6	0	2	8	0	0
5	49734889	.	C	T	5	4	9	0	0	9	0	0
5	49735135	.	C	A	2	3	5	0	0	5	0	0
5	49735169	.	A	T	2	5	7	0	0	7	0	0
5	49735721	.	T	A	5	3	8	0	1	10	1	0
5	49735722	.	C	T	7	3	10	0	0	10	0	0
5	49735942	.	T	G	4	4	8	0	0	8	0	0
5	49743020	.	A	T	3	1	4	0	1	5	0	0
5	49745130	.	T	A	3	5	8	0	0	8	0	0
5	49747271	.	G	T	0	12	12	0	11	23	0	0
5	49750796	.	A	C	12	11	23	0	1	24	0	0
5	49750834	.	A	C	6	10	16	0	2	19	1	0
5	49755368	.	G	C	2	4	6	0	0	6	0	0
5	49768707	.	G	T	3	4	7	0	2	9	0	0
5	49768977	.	A	G	4	2	6	0	0	6	0	0
5	49769217	.	A	G	2	2	4	0	0	4	0	0
5	49769277	.	G	T	5	3	8	0	0	8	0	0
5	49769345	.	G	T	4	5	9	0	0	9	0	0
5	49769477	.	C	G	1	4	5	0	0	8	3	0
5	49769665	.	T	A	3	3	6	0	0	6	0	0
5	49769812	.	A	T	1	8	9	0	0	9	0	0
5	49773649	.	C	T	2	2	4	0	0	4	0	0
5	49866146	.	T	C	2	0	2	0	2	4	0	0
5	49919762	.	G	A	1	1	2	0	0	2	0	0
5	49919774	.	T	A	1	2	3	0	0	3	0	0
5	50081761	.	T	C	1	0	1	0	0	1	0	0
5	50081865	.	T	A	2	2	4	0	0	4	0	0
5	50253591	.	T	C	2	2	4	0	0	4	0	0
5	50253792	.	C	T	0	2	2	0	0	2	0	0
5	50256327	.	T	G	2	2	4	0	0	4	0	0
5	50279709	.	G	C	2	1	3	0	0	3	0	0
5	50371119	.	T	C	2	3	5	0	0	5	0	0
5	50371123	.	T	A	2	3	5	0	0	5	0	0
5	50407324	.	T	C	1	0	1	0	0	1	0	0
5	50436038	.	C	A	3	3	6	0	0	6	0	0
5	50436069	.	C	T	4	3	7	0	0	7	0	0
5	50436354	.	G	A	3	4	7	0	0	7	0	0
5	50436359	.	G	T	4	3	7	0	0	7	0	0
5	50442199	.	C	T	1	2	3	0	1	4	0	0
5	50443077	.	T	C	11	15	26	0	6	32	0	0
5	50443184	.	A	G	13	14	27	0	0	27	0	0
5	50443211	.	C	A	13	7	20	0	1	21	0	0
5	50443399	.	G	C	19	10	29	0	2	31	0	0
5	50443418	.	T	A	19	20	39	0	2	41	0	0
5	50443466	.	A	G	14	19	33	0	1	34	0	0
5	50443837	.	G	A	5	6	11	0	0	11	0	0
5	50443868	.	T	G	6	6	12	0	0	12	0	0
5	50444984	.	C	G	4	2	6	0	0	6	0	0
5	50520009	.	G	A	8	4	12	0	0	12	0	0
5	50543929	.	C	T	0	0	0	0	1	1	0	0
5	50544281	.	T	C	5	4	9	0	0	9	0	0
5	50576705	.	A	G	7	4	11	0	1	12	0	0
5	50582271	.	G	A	4	3	7	0	0	7	0	0
5	50582482	.	T	G	3	1	4	0	0	4	0	0
5	50582594	.	A	G	2	3	5	0	0	5	0	0
5	50594268	.	C	T	0	3	3	0	2	5	0	0
5	50594298	.	G	C	1	0	1	0	5	6	0	0
5	50636003	.	G	A	2	0	2	0	0	2	0	0
5	50781069	.	G	A	1	1	2	0	1	3	0	0
5	50781273	.	A	G	6	4	10	0	0	10	0	0
5	50781301	.	C	T	6	4	10	0	1	11	0	0
5	50817403	.	C	T	2	4	6	0	1	7	0	0
5	50817414	.	C	T	2	4	6	0	0	6	0	0
5	50819811	.	G	A	4	3	7	0	0	7	0	0
5	50819861	.	A	G	5	4	9	0	0	9	0	0
5	50821027	.	G	A	0	2	2	0	0	2	0	0
5	50821075	.	A	T	1	2	3	0	0	3	0	0
5	50837411	.	T	C	0	0	0	0	4	4	0	0
5	50840669	.	G	T	4	4	8	0	1	9	0	0
5	50856871	.	A	T	1	1	2	0	0	2	0	0
5	50856945	.	G	A	1	1	2	0	0	2	0	0
5	50866681	.	G	A	1	2	3	0	0	3	0	0
5	50874827	.	A	G	1	0	1	0	0	1	0	0
5	50876172	.	A	T	0	2	2	0	0	2	0	0
5	50876199	.	A	C	0	1	1	0	0	1	0	0
5	50877549	.	G	A	0	3	3	0	1	4	0	0
5	50879164	.	G	A	0	2	2	0	1	3	0	0
5	50886309	.	C	T	0	1	1	0	0	1	0	0
5	50893082	.	A	G	1	0	1	0	1	2	0	0
5	50893654	.	C	T	0	2	2	0	0	2	0	0
5	50895544	.	C	T	0	2	2	0	0	2	0	0
5	50896056	.	C	T	1	1	2	0	0	2	0	0
5	50897509	.	C	T	4	4	8	0	0	8	0	0
5	50897528	.	C	A	3	4	7	0	0	7	0	0
5	50897585	.	C	T	0	2	2	0	0	2	0	0
5	50953383	.	C	A	1	2	3	0	0	3	0	0
5	50960402	.	C	A	1	2	3	0	0	3	0	0
5	50963250	.	C	G	2	1	3	0	0	3	0	0
5	50970198	.	C	G	1	0	1	0	2	3	0	0
5	50972910	.	G	C	1	3	4	0	0	4	0	0
5	50973014	.	C	T	6	3	9	0	0	9	0	0
5	50973039	.	C	T	6	4	10	0	0	10	0	0
5	50973357	.	T	A	5	4	9	0	0	9	0	0
5	50973471	.	C	G	3	3	6	0	0	6	0	0
5	50973518	.	A	C	9	10	19	0	0	19	0	0
5	50973625	.	A	T	4	4	8	0	0	8	0	0
5	50973748	.	C	T	5	5	10	0	0	10	0	0
5	50976624	.	C	T	0	2	2	0	0	2	0	0
5	50980806	.	T	C	2	0	2	0	0	2	0	0
5	50981123	.	C	T	0	7	7	0	2	9	0	0
5	50983097	.	G	T	5	4	9	0	1	10	0	0
5	51102044	.	T	C	3	3	6	0	0	6	0	0
5	51102266	.	C	T	2	3	5	0	0	5	0	0
5	51102315	.	G	A	2	2	4	0	0	4	0	0
5	51102602	.	T	G	1	3	4	0	0	4	0	0
5	51102641	.	T	C	2	3	5	0	0	5	0	0
5	51102828	.	G	A	4	2	6	0	0	6	0	0
5	51103006	.	T	C	3	4	7	0	0	7	0	0
5	51103007	.	T	C	4	3	7	0	0	7	0	0
5	51103043	.	T	C	2	3	5	0	1	6	0	0
5	51103411	.	G	A	5	5	10	0	0	10	0	0
5	51103550	.	G	A	2	4	6	0	0	6	0	0
5	51103689	.	A	C	3	5	8	0	0	8	0	0
5	51103944	.	A	T	4	3	7	0	0	7	0	0
5	51104010	.	G	A	3	2	5	0	0	5	0	0
5	51104458	.	G	T	3	5	8	0	0	8	0	0
5	51121295	.	G	A	3	2	5	0	0	5	0	0
5	51124019	.	G	A	3	3	6	0	1	7	0	0
5	51124803	.	A	G	0	1	1	0	0	1	0	0
5	51125695	.	C	A	1	4	5	0	0	5	0	0
5	51126885	.	A	T	3	2	5	0	0	5	0	0
5	51127396	.	C	G	3	8	11	0	0	11	0	0
5	51127467	.	C	A	4	5	9	0	1	10	0	0
5	51127672	.	C	G	3	2	5	0	0	5	0	0
5	51127718	.	T	A	4	2	6	0	0	6	0	0
5	51169022	.	G	T	1	2	3	0	0	3	0	0
5	51169354	.	A	T	4	2	6	0	0	6	0	0
5	51169376	.	T	C	6	0	6	0	3	9	0	0
5	51169545	.	C	T	3	3	6	0	0	6	0	0
5	51169732	.	G	A	2	5	7	0	0	7	0	0
5	51169749	.	C	T	1	2	3	0	0	3	0	0
5	51169858	.	T	C	2	3	5	0	0	5	0	0
5	51169859	.	T	A	3	2	5	0	0	5	0	0
5	51170048	.	C	T	5	7	12	0	0	12	0	0
5	51170113	.	G	A	8	4	12	0	0	12	0	0
5	51170171	.	T	C	2	9	11	0	0	11	0	0
5	51170375	.	C	T	2	3	5	0	0	5	0	0
5	51170577	.	G	A	4	3	7	0	0	7	0	0
5	51170595	.	A	G	5	3	8	0	0	8	0	0
5	51171254	.	G	A	1	3	4	0	1	5	0	0
5	51202374	.	T	A	0	1	1	0	0	1	0	0
5	51202938	.	G	A	3	1	4	0	0	4	0	0
5	51203146	.	C	T	1	1	2	0	0	2	0	0
5	51205439	.	G	T	4	2	6	0	1	7	0	0
5	51205473	.	T	A	5	4	9	0	1	10	0	0
5	51208565	.	G	A	0	2	2	0	0	2	0	0
5	51208586	.	C	A	0	2	2	0	0	2	0	0
5	51227011	.	T	A	9	9	18	0	2	20	0	0
5	51228496	.	C	A	7	2	9	0	0	9	0	0
5	51228926	.	T	C	0	0	0	0	1	1	0	0
5	51230901	.	T	C	1	0	1	0	1	2	0	0
5	51232024	.	G	A	2	3	5	0	0	5	0	0
5	51236457	.	C	A	5	9	14	0	0	14	0	0
5	51236474	.	A	T	2	6	8	0	2	10	0	0
5	51240503	.	A	G	2	2	4	0	0	4	0	0
5	51240679	.	A	G	7	3	10	0	0	10	0	0
5	51240711	.	C	T	2	7	9	0	0	9	0	0
5	51240830	.	T	C	4	3	7	0	0	7	0	0
5	51240936	.	A	G	2	5	7	0	1	8	0	0
5	51241023	.	A	G	5	5	10	0	0	10	0	0
5	51241046	.	T	C	8	4	12	0	0	12	0	0
5	51241095	.	C	T	2	5	7	0	1	8	0	0
5	51242245	.	A	T	2	2	4	0	0	4	0	0
5	51242489	.	A	G	7	0	7	0	9	16	0	0
5	51242684	.	A	G	2	2	4	0	0	4	0	0
5	51242882	.	A	G	11	6	17	0	1	18	0	0
5	51243106	.	A	G	8	7	15	0	1	16	0	0
5	51243287	.	G	A	7	2	9	0	0	9	0	0
5	51243302	.	A	C	8	3	11	0	0	11	0	0
5	51243341	.	G	A	6	6	12	0	0	12	0	0
5	51248831	.	G	A	0	2	2	0	1	3	0	0
5	51248838	.	A	T	1	2	3	0	0	3	0	0
5	51360567	.	C	T	1	1	2	0	0	2	0	0
5	51360591	.	C	T	3	2	5	0	0	5	0	0
5	51425579	.	C	A	0	1	1	0	0	1	0	0
5	51425623	.	G	A	0	1	1	0	0	1	0	0
5	51439950	.	C	T	1	6	7	0	0	7	0	0
5	51439958	.	G	T	1	5	6	0	1	7	0	0
5	51548092	.	C	T	2	5	7	0	1	8	0	0
5	51548398	.	A	T	2	3	5	0	0	5	0	0
5	51548408	.	A	C	2	3	5	0	0	5	0	0
5	51571150	.	A	G	1	1	2	0	0	2	0	0
5	51575586	.	C	T	2	2	4	0	0	4	0	0
5	51575756	.	C	T	0	1	1	0	0	1	0	0
5	51578163	.	T	C	1	0	1	0	0	1	0	0
5	51578328	.	G	A	3	2	5	0	0	5	0	0
5	51579076	.	C	T	1	1	2	0	0	2	0	0
5	51616474	.	A	T	3	3	6	0	1	7	0	0
5	51617022	.	T	C	9	13	22	0	1	23	0	0
5	51775052	.	A	G	5	4	9	0	0	9	0	0
5	51775291	.	A	T	16	10	26	0	0	26	0	0
5	51775391	.	A	G	17	12	29	0	3	32	0	0
5	51775458	.	A	C	11	19	30	0	3	33	0	0
5	51775501	.	T	G	7	18	25	0	4	30	1	0
5	51775805	.	A	G	14	22	36	0	0	36	0	0
5	51775837	.	G	C	11	17	28	0	1	29	0	0
5	51775962	.	G	T	14	15	29	0	0	29	0	0
5	51775997	.	A	T	18	14	32	0	1	33	0	0
5	51776150	.	C	A	11	8	19	0	1	20	0	0
5	51779513	.	C	T	4	2	6	0	0	6	0	0
5	51789180	.	C	T	0	10	10	0	3	13	0	0
5	51789264	.	T	G	12	3	15	0	1	16	0	0
5	51789286	.	A	T	10	2	12	0	0	12	0	0
5	51789428	.	A	G	3	6	9	0	0	9	0	0
5	51789453	.	T	C	2	3	5	0	1	6	0	0
5	51789646	.	T	C	1	0	1	0	1	2	0	0
5	51835998	.	T	A	4	1	5	0	0	5	0	0
5	51840420	.	C	T	1	1	2	0	0	2	0	0
5	51846285	.	C	A	0	2	2	0	0	2	0	0
5	51847274	.	T	C	1	0	1	0	0	1	0	0
5	51847429	.	T	C	2	2	4	0	0	4	0	0
5	51894040	.	T	C	2	2	4	0	1	5	0	0
5	51898796	.	C	T	0	4	4	0	5	9	0	0
5	51898933	.	C	G	0	1	1	0	0	1	0	0
5	51902067	.	T	G	1	1	2	0	0	2	0	0
5	51932684	.	T	C	2	3	5	0	0	5	0	0
5	51932690	.	C	T	2	4	6	0	0	6	0	0
5	51932747	.	C	T	3	2	5	0	0	5	0	0
5	51942275	.	C	G	1	1	2	0	1	3	0	0
5	51947370	.	G	T	6	5	11	0	2	13	0	0
5	51947497	.	C	T	9	7	16	0	1	17	0	0
5	51947551	.	T	C	8	14	22	0	0	22	0	0
5	51947650	.	T	C	6	7	13	0	0	13	0	0
5	51947696	.	A	T	9	6	15	0	0	15	0	0
5	51947770	.	T	G	9	5	14	0	0	14	0	0
5	51947976	.	C	G	1	1	2	1	0	3	0	0
5	51948017	.	G	T	2	3	5	0	1	6	0	0
5	51948076	.	G	A	1	6	7	0	0	7	0	0
5	51948222	.	G	C	3	8	11	0	0	11	0	0
5	51948389	.	A	T	9	4	13	0	0	13	0	0
5	51948737	.	C	T	0	4	4	0	9	13	0	0
5	51948755	.	C	A	9	4	13	0	1	14	0	0
5	51948919	.	G	A	12	10	22	0	0	22	0	0
5	51948946	.	T	C	10	0	10	0	12	22	0	0
5	51949069	.	T	A	9	12	21	0	0	21	0	0
5	51949071	.	T	A	9	12	21	0	0	21	0	0
5	51949306	.	T	A	2	2	4	0	0	4	0	0
5	51949896	.	G	A	3	4	7	0	0	7	0	0
5	51950032	.	G	C	2	8	10	0	0	10	0	0
5	51958296	.	T	A	2	3	5	0	0	5	0	0
5	51968073	.	A	G	1	3	4	0	0	4	0	0
5	51985355	.	G	A	2	3	5	0	0	5	0	0
5	52002660	.	T	G	4	3	7	0	0	7	0	0
5	52002708	.	T	C	6	7	13	0	0	13	0	0
5	52002743	.	T	G	3	2	5	0	0	5	0	0
5	52008556	.	T	A	1	2	3	0	0	3	0	0
5	52010104	.	T	C	0	5	5	0	0	5	0	0
5	52010123	.	A	T	0	3	3	0	0	3	0	0
5	52068422	.	C	T	4	2	6	0	0	6	0	0
5	52068452	.	G	A	2	1	3	0	0	3	0	0
5	52121488	.	C	T	1	1	2	0	0	2	0	0
5	52121517	.	T	C	3	1	4	0	0	4	0	0
5	52121629	.	G	A	4	3	7	0	0	7	0	0
5	52121759	.	A	G	1	2	3	0	0	3	0	0
5	52121801	.	G	C	6	3	9	0	0	9	0	0
5	52121940	.	T	G	4	4	8	0	1	9	0	0
5	52122021	.	C	T	4	2	6	0	0	6	0	0
5	52122189	.	C	G	2	4	6	0	0	6	0	0
5	52122711	.	C	T	4	3	7	0	0	7	0	0
5	52123640	.	G	T	8	7	15	0	0	15	0	0
5	52123903	.	A	G	6	3	9	0	1	10	0	0
5	52124259	.	G	A	8	3	11	0	0	11	0	0
5	52124734	.	A	G	5	10	15	0	0	15	0	0
5	52132498	.	A	T	2	2	4	0	0	4	0	0
5	52132561	.	C	T	9	8	17	0	0	17	0	0
5	52132966	.	A	G	8	5	13	0	0	13	0	0
5	52190877	.	A	C	4	3	7	0	0	7	0	0
5	52191039	.	C	T	0	1	1	0	2	3	0	0
5	52191185	.	G	T	3	4	7	0	0	7	0	0
5	52191212	.	A	G	0	3	3	0	1	4	0	0
5	52191263	.	T	C	9	7	16	0	0	16	0	0
5	52191288	.	C	A	6	8	14	0	0	14	0	0
5	52191499	.	G	A	4	5	9	0	1	10	0	0
5	52191758	.	C	T	2	5	7	0	1	8	0	0
5	52191987	.	A	G	3	2	5	0	0	5	0	0
5	52192085	.	A	T	1	2	3	0	0	4	1	0
5	52192557	.	C	T	4	2	6	0	0	6	0	0
5	52192572	.	T	C	2	4	6	0	0	6	0	0
5	52192704	.	T	C	2	0	2	0	5	7	0	0
5	52193240	.	A	T	5	3	8	0	1	9	0	0
5	52193283	.	T	C	1	0	1	0	3	4	0	0
5	52193817	.	A	G	1	1	2	0	0	2	0	0
5	52197793	.	C	T	1	2	3	0	0	3	0	0
5	52198066	.	G	A	2	9	11	0	1	12	0	0
5	52199622	.	C	T	2	3	5	0	2	7	0	0
5	52215311	.	A	G	1	3	4	0	0	4	0	0
5	52227660	.	T	A	1	2	3	0	0	3	0	0
5	52234708	.	A	G	1	7	8	0	0	8	0	0
5	52237028	.	C	T	1	3	4	0	0	4	0	0
5	52237039	.	G	A	1	6	7	0	0	7	0	0
5	52237449	.	G	C	0	0	0	0	1	1	0	0
5	52242924	.	C	G	0	3	3	0	6	9	0	0
5	52257106	.	A	C	7	0	7	0	7	14	0	0
5	52257299	.	G	A	6	8	14	0	2	16	0	0
5	52257463	.	T	C	8	14	22	0	0	22	0	0
5	52257530	.	A	G	13	12	25	0	2	27	0	0
5	52257976	.	G	T	14	6	20	0	0	20	0	0
5	52258036	.	G	A	11	11	22	0	1	23	0	0
5	52258234	.	G	A	9	11	20	0	0	20	0	0
5	52258464	.	T	C	12	1	13	0	14	27	0	0
5	52258653	.	C	G	7	4	11	0	0	11	0	0
5	52258701	.	A	T	3	8	11	0	0	11	0	0
5	52258703	.	G	A	3	8	11	0	0	11	0	0
5	52258921	.	T	G	4	5	9	0	0	9	0	0
5	52259221	.	T	A	9	7	16	0	0	16	0	0
5	52259289	.	A	G	2	5	7	0	0	7	0	0
5	52259542	.	G	C	9	0	9	0	4	13	0	0
5	52259579	.	A	T	8	3	11	0	0	11	0	0
5	52259887	.	G	A	6	9	15	0	0	15	0	0
5	52264354	.	C	T	0	7	7	0	4	11	0	0
5	52264456	.	C	G	0	9	9	0	11	20	0	0
5	52264512	.	G	A	9	3	12	0	0	12	0	0
5	52264549	.	C	T	6	6	12	0	0	12	0	0
5	52264654	.	C	G	0	16	16	0	6	22	0	0
5	52277390	.	G	A	4	11	15	0	0	15	0	0
5	52277487	.	T	A	7	5	12	0	0	12	0	0
5	52277574	.	G	A	5	11	16	0	0	16	0	0
5	52598377	.	C	T	0	1	1	0	0	1	0	0
5	52607289	.	G	A	1	0	1	0	0	1	0	0
5	52608696	.	G	A	5	4	9	0	1	10	0	0
5	52621663	.	A	C	2	4	6	0	1	7	0	0
5	52621885	.	T	C	5	2	7	0	0	7	0	0
5	52696879	.	C	T	7	8	15	0	0	15	0	0
5	52697519	.	A	C	5	7	12	0	2	14	0	0
5	52710951	.	A	G	2	4	6	0	0	6	0	0
5	52710957	.	G	A	2	2	4	0	0	4	0	0
5	52730645	.	C	T	7	4	11	0	0	11	0	0
5	52730704	.	C	T	6	6	12	0	1	13	0	0
5	52730742	.	G	C	6	5	11	0	2	13	0	0
5	52730793	.	G	A	3	6	9	0	0	9	0	0
5	52730846	.	C	A	6	4	10	0	1	11	0	0
5	52731647	.	G	A	1	10	11	0	12	23	0	0
5	52731664	.	C	T	14	10	24	0	1	25	0	0
5	52731787	.	G	A	7	6	13	0	1	14	0	0
5	52731845	.	T	C	6	7	13	0	1	14	0	0
5	52732146	.	C	T	8	9	17	0	0	17	0	0
5	52732147	.	G	A	9	8	17	0	0	17	0	0
5	52732727	.	G	A	8	16	24	0	2	26	0	0
5	52732818	.	G	T	7	12	19	0	0	19	0	0
5	52732931	.	C	T	14	6	20	0	0	20	0	0
5	52733022	.	G	T	8	11	19	0	1	20	0	0
5	52733201	.	C	T	13	7	20	0	0	20	0	0
5	52733230	.	G	A	11	11	22	0	0	22	0	0
5	52733259	.	T	G	16	12	28	0	2	30	0	0
5	52733266	.	T	G	16	14	30	0	2	32	0	0
5	52733370	.	A	T	11	7	18	0	1	20	1	0
5	52733411	.	G	A	16	7	23	0	1	24	0	0
5	52745571	.	T	G	3	4	7	0	0	7	0	0
5	52745637	.	T	C	0	1	1	0	0	1	0	0
5	52748724	.	T	C	2	5	7	0	0	7	0	0
5	52748743	.	T	C	2	0	2	0	3	5	0	0
5	52761212	.	A	T	1	3	4	0	0	4	0	0
5	52845320	.	A	G	2	3	5	0	0	5	0	0
5	52845497	.	A	C	1	1	2	0	0	3	1	0
5	52858847	.	C	T	3	2	5	0	0	5	0	0
5	52858898	.	A	G	4	0	4	0	6	10	0	0
5	52859307	.	A	G	0	3	3	0	0	3	0	0
5	52859422	.	T	G	3	4	7	0	0	7	0	0
5	52859769	.	C	T	6	4	10	0	0	10	0	0
5	52859912	.	G	A	5	6	11	0	1	12	0	0
5	52860243	.	T	A	5	3	8	0	0	8	0	0
5	52860310	.	T	A	2	2	4	0	0	4	0	0
5	52860338	.	T	C	3	2	5	0	0	5	0	0
5	52860863	.	G	T	5	10	15	0	0	15	0	0
5	52860957	.	T	C	2	3	5	0	2	7	0	0
5	52861334	.	T	A	4	8	12	0	0	12	0	0
5	52861396	.	C	G	7	0	7	0	7	14	0	0
5	52861410	.	A	T	7	4	11	0	1	12	0	0
5	52937901	.	C	A	4	9	13	0	1	14	0	0
5	52962667	.	T	C	3	0	3	0	6	9	0	0
5	52972260	.	A	G	5	7	12	0	0	12	0	0
5	52988108	.	C	T	4	6	10	0	1	11	0	0
5	52988147	.	C	T	2	4	6	0	0	6	0	0
5	53003455	.	A	C	1	0	1	0	0	1	0	0
5	53003463	.	C	G	0	2	2	0	2	4	0	0
5	53003640	.	C	G	6	4	10	0	1	11	0	0
5	53003896	.	G	A	5	7	12	0	1	13	0	0
5	53003988	.	A	C	7	0	7	0	7	14	0	0
5	53009239	.	T	A	0	1	1	0	0	1	0	0
5	53067862	.	A	G	6	2	8	0	0	8	0	0
5	53734556	.	C	T	2	3	5	0	0	5	0	0
5	53748244	.	C	T	3	6	9	0	0	9	0	0
5	53759491	.	A	T	10	8	18	0	2	20	0	0
5	53761461	.	C	T	7	5	12	0	1	13	0	0
5	53761541	.	A	T	12	6	18	0	0	18	0	0
5	53825047	.	G	A	6	5	11	0	0	11	0	0
5	53825054	.	T	A	6	5	11	0	0	11	0	0
5	53899573	.	T	C	5	10	15	0	1	16	0	0
5	53908333	.	C	T	10	4	14	0	0	14	0	0
5	53908613	.	T	A	6	3	9	0	0	9	0	0
5	53908695	.	T	A	3	3	6	0	0	6	0	0
5	53908722	.	G	T	3	3	6	0	0	6	0	0
5	53908892	.	A	G	6	2	8	0	3	11	0	0
5	53908893	.	G	A	6	3	9	0	2	11	0	0
5	53909000	.	G	C	8	8	16	0	0	16	0	0
5	53909031	.	T	A	6	10	16	0	1	17	0	0
5	53909118	.	A	G	0	3	3	0	0	3	0	0
5	53909141	.	C	G	1	2	3	0	0	3	0	0
5	53909244	.	A	T	4	2	6	0	0	6	0	0
5	53909659	.	T	C	5	7	12	0	0	12	0	0
5	53909914	.	C	T	2	6	8	0	1	9	0	0
5	53910324	.	C	T	7	5	12	0	0	12	0	0
5	54280294	.	T	C	1	5	6	0	0	6	0	0
5	54280350	.	C	G	3	3	6	0	0	6	0	0
5	54280672	.	C	T	1	1	2	0	0	2	0	0
5	54280801	.	G	A	2	1	3	0	0	3	0	0
5	54280889	.	G	A	4	1	5	0	0	5	0	0
5	54297655	.	G	A	2	2	4	0	0	4	0	0
5	54297668	.	C	T	3	2	5	0	0	5	0	0
5	54304666	.	C	G	3	3	6	0	0	6	0	0
5	54304731	.	T	A	2	1	3	0	0	3	0	0
5	54304736	.	G	T	1	0	1	0	0	1	0	0
5	54305209	.	G	A	2	2	4	0	0	4	0	0
5	54309395	.	G	A	7	6	13	0	0	13	0	0
5	54309449	.	C	T	0	5	5	0	8	13	0	0
5	54309459	.	T	A	7	2	9	0	0	9	0	0
5	54337296	.	A	C	5	0	5	0	3	8	0	0
5	54337485	.	A	G	2	4	6	0	0	6	0	0
5	54337604	.	A	C	2	0	2	0	4	6	0	0
5	54337831	.	T	A	14	10	24	0	3	27	0	0
5	54337880	.	T	C	15	0	15	0	7	22	0	0
5	54337933	.	G	T	7	15	22	0	0	22	0	0
5	54337934	.	C	A	15	7	22	0	0	22	0	0
5	54338040	.	C	A	5	7	12	0	1	13	0	0
5	54340047	.	G	A	4	4	8	0	0	8	0	0
5	54416333	.	T	A	3	2	5	0	0	5	0	0
5	54419992	.	T	C	1	3	4	0	0	4	0	0
5	54420465	.	T	A	2	2	4	0	0	4	0	0
5	54457983	.	G	A	2	5	7	0	0	7	0	0
5	54458053	.	A	C	5	6	11	0	0	11	0	0
5	54458125	.	T	C	2	3	5	0	1	6	0	0
5	54458127	.	A	G	3	2	5	0	1	6	0	0
5	54458326	.	G	A	12	12	24	0	0	24	0	0
5	54458345	.	T	A	11	11	22	0	0	22	0	0
5	54458437	.	C	T	13	8	21	0	0	21	0	0
5	54458668	.	C	A	9	7	16	0	0	16	0	0
5	54458774	.	A	C	9	1	10	0	7	17	0	0
5	54458791	.	C	G	1	6	7	0	11	18	0	0
5	54458974	.	C	G	7	7	14	0	2	16	0	0
5	54459073	.	T	G	7	8	15	0	2	17	0	0
5	54459086	.	G	T	7	5	12	0	2	14	0	0
5	54459337	.	T	C	3	7	10	0	2	12	0	0
5	54459380	.	T	C	4	0	4	0	7	11	0	0
5	54459401	.	T	C	3	7	10	0	1	11	0	0
5	54459415	.	G	A	5	5	10	0	0	10	0	0
5	54459682	.	C	T	5	7	12	0	2	14	0	0
5	54459700	.	T	C	9	0	9	0	3	12	0	0
5	54460218	.	A	C	2	6	8	0	0	8	0	0
5	54460237	.	T	A	2	5	7	0	0	7	0	0
5	54460259	.	G	A	3	3	6	0	0	6	0	0
5	54460274	.	T	A	4	3	7	0	0	7	0	0
5	54460322	.	T	A	4	8	12	0	0	12	0	0
5	54460371	.	T	A	4	10	14	0	0	14	0	0
5	54460481	.	C	T	0	9	9	0	5	14	0	0
5	54460555	.	G	A	8	9	17	0	5	22	0	0
5	54460558	.	A	T	5	8	13	0	9	22	0	0
5	54465149	.	T	C	1	0	1	0	2	3	0	0
5	54467999	.	G	T	4	10	14	0	0	14	0	0
5	54468032	.	A	G	11	4	15	0	0	15	0	0
5	54468506	.	G	A	2	5	7	0	0	7	0	0
5	54470845	.	C	G	0	1	1	0	2	3	0	0
5	54470912	.	C	G	5	8	13	0	1	14	0	0
5	54471091	.	T	C	2	4	6	0	1	7	0	0
5	54482550	.	G	A	1	2	3	0	0	3	0	0
5	54482561	.	A	C	2	1	3	0	0	3	0	0
5	54482795	.	C	A	3	2	5	0	0	5	0	0
5	54482806	.	C	T	3	3	6	0	0	6	0	0
5	54482997	.	T	G	1	6	7	0	0	7	0	0
5	54492839	.	C	T	0	3	3	0	1	4	0	0
5	54498363	.	C	T	2	6	8	0	1	9	0	0
5	54498452	.	C	T	8	12	20	0	3	23	0	0
5	54501179	.	C	T	6	5	11	0	1	12	0	0
5	54501993	.	A	G	2	0	2	0	4	6	0	0
5	54502264	.	G	A	4	8	12	0	1	13	0	0
5	54502307	.	G	A	0	5	5	0	10	15	0	0
5	54502414	.	G	C	9	8	17	0	1	18	0	0
5	54502697	.	A	G	9	0	9	0	5	14	0	0
5	54541975	.	C	A	3	3	6	0	1	7	0	0
5	54558738	.	A	C	5	4	9	0	0	9	0	0
5	54565223	.	T	G	0	0	0	0	1	1	0	0
5	54565379	.	A	C	1	0	1	0	0	1	0	0
5	54572859	.	T	A	0	4	4	0	0	4	0	0
5	54576142	.	C	T	5	2	7	0	0	7	0	0
5	54576223	.	C	T	3	6	9	0	0	9	0	0
5	54576238	.	G	A	3	2	5	0	0	5	0	0
5	54585600	.	C	T	1	2	3	0	0	3	0	0
5	54612354	.	C	T	0	1	1	0	0	1	0	0
5	54624856	.	T	C	0	1	1	0	0	1	0	0
5	54632954	.	A	C	2	2	4	0	0	4	0	0
5	54633277	.	C	T	2	1	3	0	0	3	0	0
5	54643746	.	T	A	3	2	5	0	0	5	0	0
5	54652941	.	T	A	4	7	11	0	0	11	0	0
5	54652947	.	C	A	8	3	11	0	0	11	0	0
5	54656583	.	A	G	4	0	4	0	3	7	0	0
5	54656613	.	T	C	3	3	6	0	0	6	0	0
5	54685235	.	T	C	18	14	32	0	1	33	0	0
5	54685349	.	A	G	16	8	24	0	0	24	0	0
5	54685371	.	A	T	16	8	24	0	0	24	0	0
5	54685445	.	C	A	13	10	23	0	0	23	0	0
5	54716828	.	T	C	7	0	7	0	4	11	0	0
5	54719503	.	A	G	10	3	13	0	0	13	0	0
5	54719844	.	G	A	16	8	24	0	0	24	0	0
5	54724444	.	A	T	1	2	3	0	0	3	0	0
5	54726636	.	A	G	0	3	3	0	0	3	0	0
5	54767734	.	T	A	12	17	29	0	2	31	0	0
5	54769091	.	A	G	8	10	18	0	1	19	0	0
5	54769133	.	A	G	11	6	17	0	1	18	0	0
5	54769896	.	A	G	14	20	34	0	0	34	0	0
5	54769914	.	C	T	13	19	32	0	2	34	0	0
5	54770121	.	T	C	2	1	3	0	0	3	0	0
5	54770370	.	G	A	9	18	27	0	0	27	0	0
5	54770889	.	C	T	8	2	10	0	0	10	0	0
5	54772955	.	T	C	5	6	11	0	0	11	0	0
5	54773182	.	C	A	0	3	3	0	6	9	0	0
5	54773250	.	A	G	9	10	19	0	1	20	0	0
5	54776408	.	T	C	6	2	8	0	1	9	0	0
5	54776413	.	G	C	3	5	8	0	0	8	0	0
5	54777482	.	G	A	0	1	1	0	0	1	0	0
5	54778115	.	G	C	2	0	2	0	0	2	0	0
5	54778236	.	G	C	5	2	7	0	0	7	0	0
5	54790426	.	A	C	5	8	13	0	0	13	0	0
5	54790513	.	T	C	4	4	8	0	0	8	0	0
5	54790751	.	A	C	7	6	13	0	0	13	0	0
5	54790769	.	T	C	5	6	11	0	0	11	0	0
5	54790808	.	T	G	5	2	7	0	0	7	0	0
5	54792072	.	G	C	3	3	6	0	0	6	0	0
5	54945035	.	T	G	11	11	22	0	0	22	0	0
5	54945048	.	A	G	12	10	22	0	0	22	0	0
5	54955874	.	T	C	7	8	15	0	0	15	0	0
5	54955892	.	G	A	5	4	9	0	0	9	0	0
5	54961109	.	A	G	2	0	2	0	0	2	0	0
5	54964633	.	G	A	2	2	4	0	0	4	0	0
5	54965203	.	G	A	3	6	9	0	0	9	0	0
5	54966120	.	C	T	4	9	13	0	1	14	0	0
5	54967094	.	C	T	3	1	4	0	0	4	0	0
5	54971774	.	G	C	3	0	3	0	1	4	0	0
5	54974350	.	A	G	1	0	1	0	0	1	0	0
5	55160572	.	G	A	7	3	10	0	0	10	0	0
5	55168177	.	G	T	12	11	23	0	2	25	0	0
5	55168436	.	T	A	1	3	4	0	0	4	0	0
5	55171359	.	G	A	1	1	2	0	0	2	0	0
5	55201111	.	A	G	8	6	14	0	0	14	0	0
5	55371356	.	C	T	7	5	12	0	2	14	0	0
5	55372218	.	A	G	14	8	22	0	0	22	0	0
5	55372425	.	A	C	15	16	31	0	0	31	0	0
5	55372773	.	A	T	13	8	21	0	0	21	0	0
5	55373299	.	G	A	11	24	35	0	0	35	0	0
5	55373869	.	G	T	8	6	14	0	0	14	0	0
5	55374343	.	T	A	10	11	21	0	1	22	0	0
5	55374560	.	T	C	1	2	3	0	0	3	0	0
5	55588449	.	G	A	9	4	13	0	1	14	0	0
5	55588458	.	T	C	8	7	15	0	0	15	0	0
5	55588562	.	T	C	4	0	4	0	1	5	0	0
5	55593011	.	G	T	6	6	12	0	0	12	0	0
5	55596851	.	C	G	0	10	10	0	7	17	0	0
5	55598383	.	T	C	3	9	12	0	1	13	0	0
5	55599950	.	G	C	8	7	15	0	0	15	0	0
5	55600108	.	A	C	8	8	16	0	0	16	0	0
5	55600149	.	T	C	6	9	15	0	0	15	0	0
5	55600154	.	A	G	6	9	15	0	0	15	0	0
5	55604037	.	G	C	10	5	15	0	0	15	0	0
5	55604211	.	A	T	7	5	12	0	1	13	0	0
5	55604228	.	G	T	11	8	19	0	0	19	0	0
5	55604302	.	A	T	11	1	12	0	0	12	0	0
5	55604438	.	A	G	14	15	29	0	1	30	0	0
5	55609426	.	T	G	22	18	40	0	1	41	0	0
5	55613789	.	G	A	19	13	32	0	1	33	0	0
5	55613813	.	A	C	11	12	23	0	2	25	0	0
5	55613864	.	A	G	12	8	20	0	0	20	0	0
5	55613999	.	G	A	0	2	2	0	0	2	0	0
5	55626700	.	T	A	4	2	6	0	0	6	0	0
5	55669528	.	C	T	2	2	4	0	0	4	0	0
5	55670269	.	T	C	0	2	2	0	0	2	0	0
5	55686574	.	T	C	4	2	6	0	0	6	0	0
5	55689628	.	C	T	6	5	11	0	0	11	0	0
5	55720486	.	C	T	0	7	7	0	8	15	0	0
5	55723534	.	A	G	4	7	11	0	1	12	0	0
5	55763752	.	G	T	19	21	40	0	3	43	0	0
5	55764509	.	G	A	27	24	51	0	1	52	0	0
5	55773856	.	A	G	3	2	5	0	0	5	0	0
5	55801489	.	G	A	2	4	6	0	0	6	0	0
5	55848084	.	C	T	3	5	8	0	0	8	0	0
5	55873688	.	G	T	0	2	2	0	0	2	0	0
5	55876508	.	C	G	2	5	7	0	2	9	0	0
5	55920943	.	A	T	2	4	6	0	0	6	0	0
5	55921076	.	A	T	7	8	15	0	0	15	0	0
5	55921335	.	G	A	14	22	36	0	1	37	0	0
5	55929926	.	G	A	1	1	2	0	0	2	0	0
5	55933055	.	G	A	16	8	24	0	0	24	0	0
5	55951602	.	G	A	5	3	8	0	0	8	0	0
5	55951639	.	A	T	2	6	8	0	0	8	0	0
5	56100260	.	T	A	3	2	5	0	0	5	0	0
5	56110137	.	C	T	0	1	1	0	1	2	0	0
5	56111071	.	A	G	1	0	1	0	0	1	0	0
5	56113951	.	C	T	0	4	4	0	1	5	0	0
5	56116439	.	T	A	0	2	2	0	0	2	0	0
5	56270933	.	T	C	1	2	3	0	0	3	0	0
5	56277975	.	C	T	2	1	3	0	0	3	0	0
5	56280184	.	T	G	1	0	1	0	0	1	0	0
5	56280582	.	A	C	2	3	5	0	0	5	0	0
5	56280645	.	A	G	6	2	8	0	0	8	0	0
5	56280651	.	G	C	2	6	8	0	0	8	0	0
5	56287987	.	T	A	1	2	3	0	0	3	0	0
5	56289800	.	G	A	0	2	2	0	3	5	0	0
5	56289818	.	C	A	5	2	7	0	0	7	0	0
5	56289884	.	A	G	3	4	7	0	2	9	0	0
5	56289904	.	T	C	1	3	4	0	2	6	0	0
5	56289925	.	G	A	2	1	3	0	1	4	0	0
5	56305525	.	C	T	4	2	6	0	0	6	0	0
5	56305526	.	T	C	4	2	6	0	0	6	0	0
5	56305674	.	G	A	2	2	4	0	0	4	0	0
5	56308698	.	T	C	1	2	3	0	6	9	0	0
5	56308816	.	C	T	0	12	12	0	10	22	0	0
5	56309013	.	G	C	10	6	16	0	0	16	0	0
5	56309109	.	C	T	0	24	24	0	14	38	0	0
5	56309115	.	A	T	12	25	37	0	1	38	0	0
5	56309244	.	A	G	2	2	4	0	2	6	0	0
5	56309445	.	C	T	6	18	24	0	2	26	0	0
5	56309454	.	A	G	17	9	26	0	1	27	0	0
5	56309506	.	G	A	15	8	23	0	1	24	0	0
5	56309517	.	T	C	9	13	22	0	1	23	0	0
5	56309672	.	C	A	1	17	18	0	17	35	0	0
5	56309677	.	C	A	16	19	35	0	2	37	0	0
5	56313207	.	G	A	15	13	28	0	1	29	0	0
5	56313246	.	C	T	13	12	25	0	1	26	0	0
5	56317153	.	T	A	9	2	11	0	0	11	0	0
5	56317170	.	C	T	4	2	6	0	0	6	0	0
5	56317377	.	G	A	16	11	27	0	0	27	0	0
5	56317470	.	C	T	0	2	2	0	0	2	0	0
5	56317473	.	T	G	0	2	2	0	0	2	0	0
5	56322205	.	C	T	20	11	31	0	1	32	0	0
5	56322404	.	A	G	3	8	11	0	1	12	0	0
5	56322449	.	T	C	9	12	21	0	0	21	0	0
5	56322467	.	G	A	7	7	14	0	0	14	0	0
5	56322680	.	A	G	1	2	3	0	0	3	0	0
5	56326485	.	C	T	1	1	2	0	1	3	0	0
5	56340613	.	A	G	3	3	6	0	1	7	0	0
5	56343032	.	C	T	0	3	3	0	4	7	0	0
5	56343053	.	G	A	4	3	7	0	1	8	0	0
5	56343095	.	C	T	0	3	3	0	0	3	0	0
5	56345036	.	G	C	3	3	6	0	1	7	0	0
5	56345109	.	A	G	10	5	15	0	0	15	0	0
5	56355129	.	C	T	2	6	8	0	2	10	0	0
5	56355296	.	C	A	3	4	7	0	0	7	0	0
5	56355467	.	T	C	2	0	2	0	0	2	0	0
5	56364862	.	A	G	1	1	2	0	0	2	0	0
5	56364946	.	G	A	2	4	6	0	0	6	0	0
5	56364979	.	A	G	0	2	2	0	0	2	0	0
5	56364982	.	G	T	0	1	1	0	0	1	0	0
5	56376681	.	C	T	1	4	5	0	3	8	0	0
5	56378072	.	C	A	1	1	2	0	0	2	0	0
5	56412197	.	G	A	5	2	7	0	0	7	0	0
5	56915023	.	G	A	3	2	5	0	1	6	0	0
5	56915190	.	C	T	11	6	17	0	3	20	0	0
5	56915422	.	G	A	7	6	13	0	0	13	0	0
5	56915457	.	T	C	2	0	2	0	2	4	0	0
5	56918932	.	G	A	6	9	15	0	0	15	0	0
5	56918974	.	A	G	5	10	15	0	0	15	0	0
5	56920385	.	A	T	2	2	4	0	0	4	0	0
5	56924686	.	C	T	4	2	6	0	0	6	0	0
5	56935031	.	G	T	2	2	4	0	0	4	0	0
5	56937131	.	C	A	1	1	2	0	0	2	0	0
5	56951034	.	G	A	6	6	12	0	3	15	0	0
5	56951156	.	C	T	13	7	20	0	0	20	0	0
5	56951229	.	C	T	18	10	28	0	6	34	0	0
5	56951258	.	A	C	9	7	16	0	0	16	0	0
5	56951686	.	G	A	1	7	8	0	0	8	0	0
5	56951713	.	T	C	6	1	7	0	0	7	0	0
5	56951769	.	A	G	9	6	15	0	3	18	0	0
5	56951830	.	T	A	10	3	13	0	0	13	0	0
5	56952295	.	G	A	14	12	26	0	0	26	0	0
5	56952316	.	A	G	8	7	15	0	1	16	0	0
5	56956359	.	G	A	14	5	19	0	1	20	0	0
5	56958513	.	C	T	3	3	6	0	0	6	0	0
5	56961194	.	A	G	1	2	3	0	0	3	0	0
5	56962827	.	T	C	1	0	1	0	8	9	0	0
5	56964475	.	G	A	6	6	12	0	0	12	0	0
5	57210284	.	G	A	0	0	0	0	1	1	0	0
5	57210293	.	T	C	1	0	1	0	0	1	0	0
5	57217249	.	G	A	0	3	3	0	4	7	0	0
5	57217343	.	T	G	6	7	13	0	0	13	0	0
5	57217391	.	C	G	3	2	5	0	0	5	0	0
5	57219429	.	T	C	1	4	5	0	1	6	0	0
5	57219430	.	T	A	2	4	6	0	0	6	0	0
5	57219496	.	G	A	1	4	5	0	0	5	0	0
5	57219736	.	T	C	5	6	11	0	0	11	0	0
5	57219789	.	C	T	3	5	8	0	0	8	0	0
5	57219938	.	G	C	0	6	6	0	3	9	0	0
5	57220033	.	T	C	7	9	16	0	1	17	0	0
5	57220108	.	G	A	0	9	9	0	9	19	1	0
5	57220190	.	A	G	8	1	9	0	15	24	0	0
5	57220324	.	T	C	1	2	3	0	0	3	0	0
5	57225343	.	C	T	4	2	6	0	0	6	0	0
5	57225496	.	C	G	0	0	0	0	1	1	0	0
5	57234053	.	A	C	2	5	7	0	0	7	0	0
5	57234074	.	C	T	1	3	4	0	0	4	0	0
5	57244075	.	T	G	3	2	5	0	0	5	0	0
5	57246068	.	T	C	1	2	3	0	0	3	0	0
5	57272949	.	A	G	1	0	1	0	0	1	0	0
5	57286268	.	A	G	0	3	3	0	0	3	0	0
5	57320235	.	C	T	28	34	62	0	1	63	0	0
5	57320274	.	G	A	23	33	56	0	3	59	0	0
5	57324956	.	A	C	33	26	59	0	8	67	0	0
5	57325158	.	T	G	30	31	61	0	1	62	0	0
5	57325204	.	T	G	29	1	30	0	31	61	0	0
5	57325210	.	G	A	29	30	59	0	3	62	0	0
5	57325359	.	G	A	19	31	50	0	3	53	0	0
5	57325537	.	C	T	4	4	8	0	2	10	0	0
5	57328572	.	G	C	2	3	5	0	0	5	0	0
5	57347653	.	A	G	1	3	4	0	0	4	0	0
5	57347737	.	T	C	1	2	3	0	0	3	0	0
5	57352332	.	A	C	1	2	3	0	0	3	0	0
5	57352421	.	G	C	0	7	7	0	1	8	0	0
5	57352495	.	A	G	2	2	4	0	1	5	0	0
5	57352568	.	A	C	2	3	5	0	0	5	0	0
5	57353387	.	T	C	2	4	6	0	0	6	0	0
5	57353959	.	C	A	4	7	11	0	3	14	0	0
5	57353981	.	C	T	8	8	16	0	1	17	0	0
5	57354046	.	G	A	6	7	13	0	0	13	0	0
5	57354096	.	A	G	1	5	6	0	0	6	0	0
5	57354166	.	T	C	4	4	8	0	2	10	0	0
5	57354552	.	C	T	5	9	14	0	2	16	0	0
5	57354596	.	C	T	1	5	6	0	0	6	0	0
5	57354656	.	A	G	3	3	6	0	0	6	0	0
5	57354680	.	G	A	0	10	10	0	3	13	0	0
5	57354719	.	T	G	4	13	17	0	0	17	0	0
5	57354786	.	G	T	8	3	11	0	0	11	0	0
5	57354839	.	A	G	3	0	3	0	3	6	0	0
5	57359740	.	G	A	6	11	17	0	1	18	0	0
5	57359811	.	A	G	6	12	18	0	1	19	0	0
5	57446925	.	G	A	1	2	3	0	0	3	0	0
5	57450440	.	C	A	3	5	8	0	1	9	0	0
5	57450973	.	A	G	0	1	1	0	0	1	0	0
5	57453587	.	T	C	9	5	14	0	0	14	0	0
5	57453635	.	T	C	7	6	13	0	0	13	0	0
5	57489777	.	T	C	15	0	15	0	13	28	0	0
5	57490099	.	G	A	11	8	19	0	0	19	0	0
5	57490153	.	T	C	13	11	24	0	0	24	0	0
5	57500086	.	T	C	8	7	15	0	0	15	0	0
5	57506568	.	A	C	4	6	10	0	0	10	0	0
5	57506622	.	A	G	8	15	23	0	0	23	0	0
5	57506646	.	C	T	0	12	12	0	7	19	0	0
5	57514332	.	G	A	8	11	19	0	1	20	0	0
5	57514428	.	G	A	8	5	13	0	0	13	0	0
5	57641711	.	A	T	3	3	6	0	0	6	0	0
5	57641751	.	C	T	5	4	9	0	0	9	0	0
5	57641808	.	T	C	7	9	16	0	0	16	0	0
5	57641823	.	C	T	10	8	18	0	0	18	0	0
5	57643949	.	T	C	3	7	10	0	1	11	0	0
5	57644184	.	T	G	3	2	5	0	1	6	0	0
5	57644256	.	G	A	7	12	19	0	1	20	0	0
5	57644700	.	G	A	1	2	3	0	0	3	0	0
5	57650592	.	G	T	0	2	2	0	8	10	0	0
5	57650777	.	C	T	4	2	6	0	1	7	0	0
5	57650782	.	C	T	5	2	7	0	0	7	0	0
5	57700093	.	T	A	1	1	2	0	0	2	0	0
5	57711761	.	G	A	3	2	5	0	0	5	0	0
5	57715136	.	G	T	3	1	4	0	0	4	0	0
5	57715904	.	T	C	9	12	21	0	1	22	0	0
5	57718488	.	A	C	8	10	18	0	0	19	1	0
5	57718554	.	T	G	6	6	12	0	1	13	0	0
5	57718558	.	G	T	6	4	10	0	0	10	0	0
5	57718614	.	C	A	10	3	13	0	0	13	0	0
5	57718649	.	A	G	14	0	14	0	0	14	0	0
5	57718659	.	C	T	8	10	18	0	1	19	0	0
5	57718716	.	T	C	7	8	15	0	1	16	0	0
5	57718739	.	T	C	8	4	12	0	1	13	0	0
5	57726573	.	T	A	4	6	10	0	0	10	0	0
5	57734692	.	A	T	2	2	4	0	0	4	0	0
5	57735420	.	A	G	3	3	6	0	0	6	0	0
5	57737337	.	A	G	3	3	6	0	1	7	0	0
5	57737389	.	C	T	4	10	14	0	0	14	0	0
5	57737395	.	T	C	4	10	14	0	0	14	0	0
5	57737504	.	C	A	5	5	10	0	0	10	0	0
5	57737587	.	G	A	3	5	8	0	0	8	0	0
5	57737589	.	T	C	3	4	7	0	1	8	0	0
5	57737637	.	A	G	8	0	8	0	4	12	0	0
5	57737673	.	T	C	5	6	11	0	0	11	0	0
5	57737704	.	C	T	4	4	8	0	0	8	0	0
5	57737862	.	T	A	3	6	9	0	0	9	0	0
5	57737863	.	A	C	2	6	8	0	1	9	0	0
5	57738078	.	C	T	4	7	11	0	1	12	0	0
5	57738233	.	C	T	4	9	13	0	1	14	0	0
5	57738321	.	G	A	2	2	4	0	0	4	0	0
5	57743868	.	G	A	5	14	19	0	1	20	0	0
5	57743907	.	A	G	6	16	22	0	1	23	0	0
5	57744681	.	C	T	4	11	15	0	0	15	0	0
5	57744731	.	T	C	3	4	7	0	0	7	0	0
5	57747691	.	A	G	3	3	6	0	0	6	0	0
5	57751167	.	A	G	0	2	2	0	0	2	0	0
5	57751676	.	T	A	2	4	6	0	1	7	0	0
5	57753821	.	C	T	4	4	8	0	0	8	0	0
5	57753827	.	A	G	3	0	3	0	2	5	0	0
5	57755422	.	T	C	0	3	3	0	1	4	0	0
5	57755844	.	C	T	3	4	7	0	1	8	0	0
5	57762423	.	A	T	9	15	24	0	0	24	0	0
5	57762468	.	G	T	10	25	35	0	2	37	0	0
5	57762479	.	A	T	10	24	34	0	2	36	0	0
5	57762656	.	T	G	13	19	32	0	1	33	0	0
5	57762849	.	A	T	12	15	27	0	0	27	0	0
5	57762868	.	A	G	14	17	31	0	0	31	0	0
5	57762900	.	T	C	13	16	29	0	1	30	0	0
5	57762938	.	A	T	10	15	25	0	1	26	0	0
5	57762986	.	C	G	8	11	19	0	1	20	0	0
5	57777906	.	C	G	8	0	8	0	8	16	0	0
5	57787630	.	C	T	11	14	25	0	0	25	0	0
5	57790583	.	G	A	24	14	38	0	1	39	0	0
5	57797085	.	A	C	16	14	30	0	6	36	0	0
5	57797152	.	G	A	1	24	25	0	34	59	0	0
5	57797844	.	C	T	17	29	46	0	11	57	0	0
5	57797887	.	A	T	20	28	48	0	1	49	0	0
5	57797914	.	A	G	17	3	20	0	17	37	0	0
5	57797954	.	T	C	20	11	31	0	0	31	0	0
5	57814627	.	G	A	9	8	17	0	2	19	0	0
5	57815018	.	G	A	0	2	2	0	0	2	0	0
5	57817795	.	T	C	0	3	3	0	0	3	0	0
5	57819091	.	A	T	0	1	1	0	0	1	0	0
5	57820641	.	C	A	2	2	4	0	0	4	0	0
5	57820683	.	A	G	2	3	5	0	0	5	0	0
5	57820743	.	G	C	2	4	6	0	1	7	0	0
5	58075599	.	C	T	0	2	2	0	0	2	0	0
5	58075686	.	A	G	6	4	10	0	0	10	0	0
5	58075815	.	T	G	4	6	10	1	0	11	0	0
5	58075863	.	G	A	2	5	7	0	1	8	0	0
5	58081110	.	C	T	1	0	1	0	0	1	0	0
5	58081173	.	T	A	5	2	7	0	1	8	0	0
5	58086215	.	G	C	2	0	2	0	5	7	0	0
5	58173388	.	C	T	2	3	5	0	0	5	0	0
5	58173435	.	A	T	2	2	4	0	1	5	0	0
5	58372268	.	T	C	21	20	41	0	3	44	0	0
5	58380828	.	A	G	2	1	3	0	0	3	0	0
5	58380842	.	A	G	2	1	3	0	1	4	0	0
5	58382159	.	A	G	27	0	27	0	21	48	0	0
5	58382358	.	C	T	18	36	54	0	2	56	0	0
5	58382440	.	T	A	22	11	33	0	5	49	11	0
5	58382457	.	C	G	29	6	35	0	8	43	0	0
5	58402129	.	C	T	0	2	2	0	1	3	0	0
5	58412403	.	T	C	2	7	9	0	0	9	0	0
5	58455514	.	T	A	2	2	4	0	0	4	0	0
5	58457014	.	T	C	0	2	2	0	0	2	0	0
5	58462891	.	A	G	8	0	8	0	6	14	0	0
5	58468137	.	T	C	2	5	7	0	0	7	0	0
5	58468173	.	A	G	4	0	4	0	7	11	0	0
5	58470952	.	C	G	2	0	2	0	1	3	0	0
5	58477239	.	C	A	2	1	3	0	0	3	0	0
5	58477248	.	T	A	2	1	3	0	0	3	0	0
5	58477449	.	A	T	0	2	2	0	0	2	0	0
5	58478136	.	T	C	3	5	8	0	0	8	0	0
5	58481826	.	T	C	2	5	7	0	3	10	0	0
5	58490636	.	A	T	3	0	3	0	0	3	0	0
5	58504447	.	G	T	3	0	3	0	1	4	0	0
5	58687623	.	A	T	3	12	15	0	0	15	0	0
5	58687649	.	C	A	3	12	15	0	0	15	0	0
5	58687673	.	T	C	2	12	14	0	0	14	0	0
5	58687690	.	T	A	2	6	8	0	0	8	0	0
5	58687739	.	G	A	0	1	1	0	0	1	0	0
5	58688621	.	T	A	5	1	6	0	0	6	0	0
5	58688644	.	A	G	6	4	10	0	0	10	0	0
5	58688687	.	G	A	0	9	9	0	8	17	0	0
5	58691748	.	A	G	4	11	15	0	1	16	0	0
5	58691763	.	T	G	4	11	15	0	0	15	0	0
5	58695814	.	G	A	3	4	7	0	0	7	0	0
5	58695816	.	G	A	3	4	7	0	0	7	0	0
5	58696063	.	G	A	4	7	11	0	3	14	0	0
5	58696236	.	G	A	3	5	8	0	0	8	0	0
5	58696412	.	A	C	8	9	17	0	0	17	0	0
5	58696670	.	T	C	9	2	11	0	13	24	0	0
5	58696840	.	G	A	10	12	22	0	0	22	0	0
5	58696997	.	T	G	6	5	11	0	2	13	0	0
5	58697007	.	A	C	8	6	14	0	1	15	0	0
5	58697050	.	C	T	6	6	12	0	2	14	0	0
5	58704284	.	G	C	4	1	5	0	0	5	0	0
5	58707265	.	A	G	3	3	6	0	0	6	0	0
5	58708812	.	T	G	2	4	6	0	0	6	0	0
5	58708832	.	T	G	2	4	6	0	0	6	0	0
5	58708996	.	G	T	0	1	1	0	0	1	0	0
5	58711159	.	G	T	3	3	6	0	1	7	0	0
5	58717412	.	C	T	2	1	3	0	0	3	0	0
5	58717535	.	C	G	0	2	2	0	0	2	0	0
5	58717618	.	A	T	0	1	1	0	0	1	0	0
5	58719628	.	C	T	0	1	1	0	0	1	0	0
5	58719797	.	C	T	4	5	9	0	0	9	0	0
5	58721406	.	C	T	0	7	7	0	5	12	0	0
5	58722507	.	T	C	10	6	16	0	0	16	0	0
5	58730739	.	G	A	1	4	5	0	0	5	0	0
5	58745861	.	G	A	0	1	1	0	0	1	0	0
5	58751855	.	T	A	0	1	1	0	0	1	0	0
5	58850883	.	A	T	11	22	33	0	0	33	0	0
5	58850923	.	A	C	10	19	29	0	0	29	0	0
5	58850958	.	T	C	13	1	14	0	13	27	0	0
5	58850981	.	A	T	12	15	27	0	1	28	0	0
5	58851041	.	G	T	11	17	28	0	2	30	0	0
5	58852256	.	G	A	13	6	19	0	0	19	0	0
5	58852582	.	G	A	1	6	7	0	0	7	0	0
5	58852687	.	A	G	9	16	25	1	1	27	0	0
5	58852758	.	C	A	9	9	18	0	0	18	0	0
5	58852784	.	A	G	10	7	17	0	1	18	0	0
5	58852825	.	A	C	16	9	25	0	1	26	0	0
5	58852873	.	T	A	2	7	9	0	2	12	1	0
5	58852960	.	G	A	4	3	7	0	0	7	0	0
5	58852983	.	C	T	3	2	5	0	1	6	0	0
5	58853008	.	T	A	6	4	10	0	1	11	0	0
5	58853079	.	C	T	0	2	2	0	1	3	0	0
5	58853121	.	G	T	1	3	4	0	0	4	0	0
5	58853407	.	C	T	4	5	9	0	1	10	0	0
5	59060620	.	C	T	1	3	4	0	0	4	0	0
5	59060824	.	C	T	1	3	4	0	0	4	0	0
5	59063090	.	C	A	0	3	3	0	0	3	0	0
5	59063102	.	C	T	0	3	3	0	0	3	0	0
5	59079594	.	A	G	1	3	4	0	0	4	0	0
5	59079726	.	C	A	17	16	33	0	1	34	0	0
5	59079732	.	A	C	15	16	31	0	2	33	0	0
5	59079806	.	C	A	12	11	23	0	2	26	1	0
5	59079919	.	G	A	1	3	4	0	2	6	0	0
5	59080392	.	C	A	8	7	15	0	1	16	0	0
5	59080682	.	A	T	5	2	7	0	0	7	0	0
5	59080874	.	A	G	4	3	7	0	1	8	0	0
5	59081699	.	C	T	3	4	7	0	0	7	0	0
5	59081730	.	C	T	2	5	7	0	0	7	0	0
5	59081816	.	T	G	2	3	5	0	0	5	0	0
5	59082395	.	C	T	7	2	9	0	0	9	0	0
5	59082497	.	A	T	14	6	20	0	0	20	0	0
5	59082540	.	C	T	9	6	15	0	2	17	0	0
5	59082581	.	T	A	6	9	15	0	0	15	0	0
5	59082685	.	G	A	10	10	20	0	0	20	0	0
5	59082703	.	T	C	11	9	20	0	1	21	0	0
5	59082882	.	C	T	9	10	19	0	1	20	0	0
5	59083180	.	G	T	0	6	6	0	4	10	0	0
5	59083201	.	T	A	4	6	10	0	1	11	0	0
5	59092513	.	A	G	1	3	4	0	1	5	0	0
5	59092644	.	G	A	1	2	3	0	0	3	0	0
5	59100577	.	G	A	4	1	5	0	1	6	0	0
5	59101602	.	A	G	4	0	4	0	1	5	0	0
5	59101813	.	G	A	0	2	2	0	0	2	0	0
5	59103052	.	A	G	1	6	7	0	0	7	0	0
5	59111584	.	G	A	2	2	4	0	1	5	0	0
5	59111918	.	A	C	1	0	1	0	2	3	0	0
5	59147711	.	T	C	10	4	14	0	0	14	0	0
5	59198679	.	C	T	8	4	12	0	0	12	0	0
5	59200206	.	G	T	0	3	3	0	0	3	0	0
5	59200523	.	C	G	4	2	6	0	0	6	0	0
5	59200721	.	G	A	0	3	3	0	2	5	0	0
5	59200733	.	G	A	2	3	5	0	0	5	0	0
5	59200813	.	C	T	3	2	5	0	0	5	0	0
5	59200985	.	A	T	2	2	4	0	0	4	0	0
5	59201129	.	T	A	3	2	5	0	0	5	0	0
5	59201199	.	C	T	2	3	5	0	0	5	0	0
5	59201211	.	A	T	2	2	4	0	0	4	0	0
5	59201364	.	C	T	5	4	9	0	0	9	0	0
5	59201420	.	A	G	2	2	4	0	0	4	0	0
5	59201427	.	C	G	0	2	2	0	0	2	0	0
5	59201474	.	C	T	1	4	5	0	0	5	0	0
5	59201624	.	C	T	6	3	9	0	0	9	0	0
5	59201883	.	T	G	11	2	13	0	1	14	0	0
5	59239773	.	C	G	3	3	6	0	0	6	0	0
5	59248085	.	T	A	2	1	3	0	3	6	0	0
5	59278463	.	T	C	4	8	12	0	0	12	0	0
5	59278508	.	T	G	3	7	10	0	0	10	0	0
5	59278520	.	T	G	2	6	8	0	0	8	0	0
5	59297918	.	C	G	1	2	3	0	1	4	0	0
5	59328475	.	C	T	3	2	5	0	0	5	0	0
5	59328502	.	G	A	3	2	5	0	0	5	0	0
5	59361402	.	A	G	2	3	5	0	0	5	0	0
5	59367819	.	C	G	4	4	8	0	0	8	0	0
5	59368490	.	T	C	0	1	1	0	0	1	0	0
5	59368510	.	C	T	2	4	6	0	0	6	0	0
5	59380488	.	C	T	3	2	5	0	0	5	0	0
5	59386337	.	G	T	0	8	8	0	4	12	0	0
5	59386456	.	T	C	2	7	9	0	0	9	0	0
5	59386512	.	C	G	4	5	9	0	0	9	0	0
5	59386918	.	A	C	1	2	3	0	0	3	0	0
5	59387094	.	A	T	8	3	11	0	1	12	0	0
5	59387120	.	C	T	5	2	7	0	1	8	0	0
5	59387184	.	A	T	4	4	8	0	1	9	0	0
5	59387237	.	T	G	9	6	15	0	0	15	0	0
5	59387415	.	G	A	11	3	14	0	0	14	0	0
5	59387476	.	C	A	8	4	12	0	0	12	0	0
5	59387478	.	C	A	6	4	10	0	2	12	0	0
5	59388343	.	T	C	5	6	11	0	0	11	0	0
5	59388586	.	T	A	11	7	18	0	1	19	0	0
5	59388604	.	T	C	12	10	22	0	1	23	0	0
5	59388951	.	T	A	11	10	21	0	0	22	1	0
5	59389440	.	T	A	3	4	7	0	1	8	0	0
5	59389444	.	T	A	3	4	7	0	1	8	0	0
5	59389688	.	G	A	11	7	18	0	1	19	0	0
5	59389786	.	T	G	2	4	6	0	0	6	0	0
5	59398522	.	A	G	5	4	9	0	0	9	0	0
5	59419988	.	T	C	6	3	9	0	0	9	0	0
5	59420096	.	T	C	5	5	10	0	0	10	0	0
5	59420111	.	G	A	5	5	10	0	0	10	0	0
5	59420138	.	G	A	0	4	4	0	4	8	0	0
5	59420249	.	A	G	3	1	4	0	9	13	0	0
5	59420291	.	A	G	4	0	4	0	8	12	0	0
5	59420321	.	A	C	5	8	13	0	0	13	0	0
5	59444562	.	C	A	4	3	7	0	1	8	0	0
5	59449692	.	G	A	0	1	1	0	3	4	0	0
5	59449713	.	G	A	0	2	2	0	4	6	0	0
5	59449767	.	C	T	5	9	14	0	0	14	0	0
5	59462424	.	G	T	2	2	4	0	0	4	0	0
5	59462457	.	G	A	4	5	9	0	0	9	0	0
5	59462595	.	C	T	7	5	12	0	1	13	0	0
5	59462679	.	C	T	8	7	15	0	0	15	0	0
5	59462881	.	G	A	9	6	15	0	2	17	0	0
5	59462991	.	T	C	4	7	11	0	0	11	0	0
5	59462994	.	A	T	4	7	11	0	0	11	0	0
5	59463183	.	G	T	4	3	7	0	0	7	0	0
5	59463261	.	C	A	12	6	18	0	1	19	0	0
5	59463327	.	A	C	2	9	11	0	0	11	0	0
5	59466867	.	T	G	1	0	1	0	0	1	0	0
5	59466882	.	G	A	0	2	2	0	2	4	0	0
5	59466930	.	A	G	2	2	4	0	0	4	0	0
5	59472724	.	T	C	1	2	3	0	0	3	0	0
5	59479541	.	C	A	0	0	0	0	1	1	0	0
5	59479546	.	A	C	1	0	1	0	0	1	0	0
5	59479973	.	C	T	11	5	16	0	1	17	0	0
5	59515419	.	A	T	3	2	5	0	0	5	0	0
5	59515509	.	A	G	4	4	8	0	1	9	0	0
5	59525071	.	A	G	4	0	4	0	2	6	0	0
5	59544225	.	A	G	2	0	2	0	1	3	0	0
5	59544249	.	T	C	4	3	7	0	0	7	0	0
5	59544291	.	T	C	7	9	16	0	0	16	0	0
5	59544327	.	C	T	7	8	15	0	1	16	0	0
5	59544645	.	G	T	0	1	1	0	0	1	0	0
5	59548976	.	C	G	3	2	5	0	1	6	0	0
5	59549006	.	G	A	0	4	4	0	5	9	0	0
5	59549038	.	A	C	2	4	6	0	0	6	0	0
5	59549143	.	A	G	4	0	4	0	3	7	0	0
5	59549148	.	G	A	4	3	7	0	0	7	0	0
5	59549182	.	G	A	3	4	7	0	0	7	0	0
5	59549306	.	T	A	3	1	4	1	0	5	0	0
5	59549382	.	A	G	4	4	8	0	0	8	0	0
5	59549389	.	G	A	3	4	7	0	0	7	0	0
5	59550260	.	A	T	7	2	9	0	0	9	0	0
5	59550529	.	T	G	8	4	12	0	0	12	0	0
5	59550581	.	T	C	6	3	9	0	1	10	0	0
5	59550636	.	A	T	6	2	8	0	0	8	0	0
5	59553797	.	A	G	4	0	4	0	5	9	0	0
5	59559950	.	T	C	12	9	21	0	0	21	0	0
5	59560110	.	T	C	15	10	25	0	2	27	0	0
5	59560131	.	A	G	7	0	7	0	16	23	0	0
5	59593297	.	G	C	0	14	14	0	7	21	0	0
5	59593408	.	G	T	6	6	12	0	0	12	0	0
5	59593523	.	C	T	6	3	9	0	0	9	0	0
5	59593685	.	A	T	4	3	7	0	0	7	0	0
5	59593773	.	G	C	8	5	13	0	0	13	0	0
5	59593822	.	G	T	7	3	10	0	0	10	0	0
5	59593884	.	T	G	6	2	8	0	0	8	0	0
5	59594076	.	T	A	1	2	3	0	0	3	0	0
5	59594085	.	T	C	1	2	3	0	0	3	0	0
5	59594126	.	G	T	1	4	5	0	0	5	0	0
5	59594199	.	T	C	4	3	7	0	0	7	0	0
5	59594328	.	T	C	3	10	13	0	0	13	0	0
5	59594485	.	G	T	10	12	22	0	1	23	0	0
5	59594551	.	A	G	9	0	9	0	9	18	0	0
5	59594559	.	A	G	13	6	19	0	0	19	0	0
5	59594648	.	A	T	5	7	12	0	1	13	0	0
5	59595127	.	T	C	2	3	5	0	2	7	0	0
5	59595241	.	T	C	3	10	13	0	1	14	0	0
5	59595252	.	C	T	6	11	17	0	0	17	0	0
5	59595502	.	T	C	4	2	6	0	1	7	0	0
5	59595503	.	G	C	4	2	6	0	1	7	0	0
5	60520653	.	C	A	2	2	4	0	0	4	0	0
5	60665225	.	A	C	2	8	10	0	1	11	0	0
5	60673572	.	C	G	1	2	3	0	0	3	0	0
5	60684257	.	C	T	3	3	6	0	0	6	0	0
5	60684494	.	T	C	3	3	6	0	0	6	0	0
5	60684603	.	A	G	8	0	8	0	13	21	0	0
5	60684866	.	C	T	5	5	10	0	0	10	0	0
5	60685209	.	A	T	3	6	9	0	0	9	0	0
5	60685481	.	G	A	10	13	23	0	1	24	0	0
5	60685513	.	A	G	15	10	25	0	1	26	0	0
5	60685758	.	T	C	10	11	21	0	0	21	0	0
5	60685773	.	C	T	11	9	20	0	1	21	0	0
5	60685822	.	C	T	6	7	13	0	0	13	0	0
5	60685851	.	G	A	5	6	11	0	0	11	0	0
5	60685952	.	A	C	4	4	8	0	0	8	0	0
5	60686374	.	A	T	9	7	16	0	0	16	0	0
5	60686380	.	C	A	11	6	17	0	1	18	0	0
5	60686686	.	C	G	9	14	23	0	1	24	0	0
5	60686910	.	G	T	10	8	18	0	1	19	0	0
5	60687327	.	T	C	7	4	11	0	0	11	0	0
5	60687344	.	A	T	5	7	12	0	0	12	0	0
5	60687537	.	T	C	2	4	6	0	0	6	0	0
5	60850390	.	T	C	1	4	5	0	0	5	0	0
5	60850397	.	G	T	1	3	4	0	0	4	0	0
5	60863107	.	C	T	1	2	3	0	1	4	0	0
5	60866063	.	G	T	1	1	2	0	0	2	0	0
5	60868216	.	G	A	4	0	4	0	0	4	0	0
5	60868958	.	T	C	3	1	4	0	0	4	0	0
5	60868960	.	G	A	2	1	3	0	1	4	0	0
5	60869015	.	C	A	1	1	2	0	0	2	0	0
5	60871999	.	A	T	4	5	9	0	0	9	0	0
5	60872126	.	G	A	8	13	21	0	0	21	0	0
5	60872299	.	T	G	7	3	10	0	1	11	0	0
5	60872320	.	T	C	6	5	11	0	1	12	0	0
5	60872472	.	G	A	4	9	13	0	2	15	0	0
5	60872708	.	T	C	5	4	9	0	0	9	0	0
5	60872926	.	T	C	3	1	4	0	0	4	0	0
5	60893399	.	C	T	1	5	6	0	1	7	0	0
5	60894651	.	T	A	2	3	5	0	0	5	0	0
5	60894675	.	G	A	3	5	8	0	0	8	0	0
5	60894738	.	G	T	0	4	4	0	3	7	0	0
5	60906313	.	G	A	0	7	7	0	2	9	0	0
5	61270901	.	G	A	11	10	21	0	0	21	0	0
5	61270905	.	C	T	11	8	19	0	2	21	0	0
5	61329486	.	G	A	11	10	21	0	0	21	0	0
5	61329604	.	C	T	7	8	15	0	0	15	0	0
5	61349991	.	C	T	0	0	0	0	1	1	0	0
5	61351582	.	C	A	1	0	1	0	0	1	0	0
5	61351600	.	C	A	2	0	2	0	0	2	0	0
5	61353710	.	G	C	1	0	1	0	2	3	0	0
5	61354112	.	G	T	9	4	13	0	0	13	0	0
5	61380103	.	T	A	8	6	14	0	0	14	0	0
5	61380130	.	C	T	10	8	18	0	0	18	0	0
5	61392719	.	C	T	11	17	28	0	1	29	0	0
5	61396054	.	G	A	5	2	7	0	1	8	0	0
5	61402030	.	G	A	7	9	16	0	2	18	0	0
5	61402455	.	A	T	15	12	27	0	1	28	0	0
5	61402479	.	G	A	10	14	24	0	0	24	0	0
5	61402570	.	T	C	11	20	31	0	1	32	0	0
5	61402584	.	A	G	23	0	23	0	9	32	0	0
5	61402761	.	T	A	18	21	39	0	2	41	0	0
5	61402999	.	T	A	12	9	21	0	2	23	0	0
5	61404563	.	C	T	1	3	4	0	0	4	0	0
5	61404702	.	A	T	4	1	5	0	0	5	0	0
5	61405203	.	C	T	1	1	2	0	0	2	0	0
5	61405245	.	C	A	1	4	5	0	0	5	0	0
5	61405885	.	A	G	3	0	3	0	0	3	0	0
5	61405954	.	A	G	7	14	21	0	1	22	0	0
5	61414619	.	C	T	7	5	12	0	0	12	0	0
5	61425708	.	C	T	2	0	2	0	0	2	0	0
5	61425723	.	C	T	2	0	2	0	0	2	0	0
5	61425795	.	G	C	1	3	4	0	0	4	0	0
5	61425800	.	A	G	1	3	4	0	0	4	0	0
5	61428878	.	A	G	2	0	2	0	0	2	0	0
5	61428915	.	C	G	3	2	5	0	0	5	0	0
5	61428984	.	C	T	8	6	14	0	0	14	0	0
5	61429013	.	C	A	5	7	12	0	0	12	0	0
5	61429058	.	G	T	2	4	6	0	0	6	0	0
5	61429149	.	C	T	0	1	1	0	0	1	0	0
5	61431765	.	C	T	2	7	9	0	0	9	0	0
5	61433076	.	G	A	1	2	3	0	1	4	0	0
5	61433102	.	G	T	1	4	5	0	0	5	0	0
5	61433196	.	A	T	3	4	7	0	1	8	0	0
5	61459502	.	T	C	5	7	12	0	1	13	0	0
5	61464874	.	G	T	5	9	14	0	0	14	0	0
5	61464900	.	G	T	8	3	11	0	0	11	0	0
5	61472429	.	G	A	5	6	11	0	1	12	0	0
5	61472457	.	C	T	6	4	10	0	1	11	0	0
5	61472543	.	C	G	2	2	4	0	0	4	0	0
5	61472598	.	C	G	2	2	4	0	0	4	0	0
5	61508451	.	A	G	9	7	16	0	0	16	0	0
5	61508648	.	G	T	18	13	31	0	0	31	0	0
5	61548819	.	T	G	16	0	16	0	7	23	0	0
5	61552787	.	T	A	9	7	16	0	3	19	0	0
5	61553022	.	G	A	10	14	24	0	0	24	0	0
5	61553119	.	A	G	5	8	13	0	0	13	0	0
5	61553207	.	C	T	6	11	17	0	0	17	0	0
5	61553309	.	A	G	5	0	5	0	10	15	0	0
5	61553409	.	A	T	14	5	19	0	1	20	0	0
5	61553418	.	G	A	3	16	19	0	2	21	0	0
5	61553452	.	C	T	12	8	20	0	0	20	0	0
5	61553556	.	A	T	6	10	16	0	1	17	0	0
5	61553611	.	T	G	15	4	19	0	1	20	0	0
5	61553614	.	C	T	16	3	19	0	0	19	0	0
5	61553699	.	G	T	12	8	20	0	1	21	0	0
5	61566678	.	G	C	1	4	5	0	0	5	0	0
5	61566819	.	T	C	3	4	7	0	0	7	0	0
5	61584144	.	G	C	6	4	10	0	0	10	0	0
5	61586142	.	C	A	1	1	2	0	0	2	0	0
5	61588974	.	G	T	3	3	6	0	0	6	0	0
5	61660310	.	C	T	3	6	9	0	0	9	0	0
5	61660526	.	C	T	6	4	10	0	2	12	0	0
5	61665215	.	G	A	1	1	2	0	0	2	0	0
5	61668302	.	G	A	0	3	3	0	4	7	0	0
5	61676676	.	T	G	14	1	15	0	11	26	0	0
5	61676700	.	T	G	16	14	30	0	0	30	0	0
5	61676739	.	A	C	10	8	18	0	0	18	0	0
5	61682577	.	C	T	11	5	16	0	0	16	0	0
5	61682715	.	A	C	14	19	33	0	2	35	0	0
5	61682721	.	C	T	13	18	31	0	3	34	0	0
5	61698770	.	C	T	7	3	10	0	0	10	0	0
5	61701969	.	C	A	10	8	18	0	0	18	0	0
5	61706220	.	T	C	7	0	7	0	0	7	0	0
5	61723061	.	G	A	36	29	65	0	3	68	0	0
5	61723481	.	G	T	3	31	34	0	19	53	0	0
5	61723584	.	A	T	17	21	38	0	1	39	0	0
5	61723637	.	A	G	20	22	42	0	3	45	0	0
5	61723674	.	G	A	27	15	42	0	4	46	0	0
5	61723694	.	T	G	14	27	41	0	1	42	0	0
5	61723914	.	T	C	18	24	42	0	2	44	0	0
5	61723979	.	C	T	15	6	21	0	0	21	0	0
5	61790154	.	C	T	3	4	7	0	0	7	0	0
5	61790157	.	T	C	3	4	7	0	0	7	0	0
5	61790442	.	C	G	0	2	2	0	3	5	0	0
5	61793019	.	T	A	0	1	1	0	0	1	0	0
5	61793756	.	T	C	1	2	3	0	0	3	0	0
5	61793811	.	T	C	1	0	1	0	2	3	0	0
5	61793886	.	T	A	6	3	9	0	0	9	0	0
5	61793978	.	C	T	1	1	2	0	0	2	0	0
5	61951038	.	A	G	7	6	13	0	0	13	0	0
5	62290448	.	A	T	0	6	6	0	0	6	0	0
5	62333198	.	C	A	0	8	8	3	0	11	0	0
5	62639596	.	G	A	20	14	34	0	3	37	0	0
5	62806599	.	T	A	7	3	10	0	0	10	0	0
5	62806675	.	A	G	5	6	11	0	0	11	0	0
5	62806701	.	A	G	5	6	11	0	0	11	0	0
5	62806786	.	C	A	4	5	9	0	0	9	0	0
5	62806867	.	C	T	0	2	2	0	8	10	0	0
5	62806951	.	A	G	6	4	10	0	0	10	0	0
5	62807044	.	T	A	3	6	9	0	0	9	0	0
5	62807056	.	T	C	3	4	7	0	0	7	0	0
5	62807294	.	G	A	1	3	4	0	0	4	0	0
5	62807357	.	G	A	2	2	4	0	0	4	0	0
5	62860901	.	A	G	0	2	2	0	0	2	0	0
5	62860902	.	G	T	0	1	1	0	1	2	0	0
5	62860943	.	T	C	2	4	6	0	0	6	0	0
5	62860969	.	T	A	2	3	5	0	0	5	0	0
5	62865289	.	G	A	2	2	4	0	0	4	0	0
5	62884052	.	T	C	1	0	1	0	0	1	0	0
5	62889651	.	C	T	12	5	17	0	2	19	0	0
5	62889957	.	G	A	8	8	16	0	0	16	0	0
5	62889966	.	C	G	7	6	13	0	0	13	0	0
5	62890011	.	T	G	3	4	7	0	0	7	0	0
5	62890026	.	G	A	4	4	8	0	0	8	0	0
5	62890405	.	C	T	5	2	7	0	0	7	0	0
5	62890642	.	G	A	12	4	16	0	2	18	0	0
5	62890846	.	A	G	9	4	13	0	0	13	0	0
5	62937329	.	C	T	2	0	2	0	0	2	0	0
5	62937377	.	T	G	4	2	6	0	0	6	0	0
5	62937410	.	C	A	1	2	3	0	0	3	0	0
5	62937428	.	C	T	0	1	1	0	0	1	0	0
5	62989260	.	C	T	8	8	16	0	0	16	0	0
5	63003145	.	G	A	1	1	2	0	1	3	0	0
5	63065718	.	C	T	2	2	4	0	1	5	0	0
5	63065739	.	G	A	2	4	6	0	1	7	0	0
5	63065768	.	A	C	4	0	4	0	4	8	0	0
5	63089582	.	T	G	0	1	1	0	0	1	0	0
5	63092339	.	A	G	0	2	2	0	0	2	0	0
5	63198185	.	A	G	1	2	3	0	0	3	0	0
5	63248368	.	T	C	2	3	5	0	0	5	0	0
5	63248486	.	G	A	1	3	4	0	0	4	0	0
5	63268902	.	T	C	2	2	4	0	0	4	0	0
5	63268917	.	G	A	2	2	4	0	0	4	0	0
5	63273840	.	T	G	2	1	3	0	0	3	0	0
5	63288717	.	T	A	2	2	4	0	0	4	0	0
5	63289018	.	G	A	0	2	2	0	3	5	0	0
5	63289019	.	G	A	3	2	5	0	0	5	0	0
5	63305505	.	A	T	3	2	5	0	0	5	0	0
5	63305522	.	A	G	3	0	3	0	2	5	0	0
5	63305607	.	G	A	1	2	3	0	0	3	0	0
5	63310766	.	T	A	1	2	3	0	0	3	0	0
5	63319324	.	T	C	1	2	3	0	0	3	0	0
5	63322483	.	T	A	2	2	4	0	0	4	0	0
5	63322568	.	A	T	1	2	3	0	0	3	0	0
5	63322584	.	G	T	3	2	5	0	0	5	0	0
5	63329526	.	G	A	1	1	2	0	0	2	0	0
5	63335216	.	C	A	1	0	1	0	0	1	0	0
5	63338518	.	A	T	2	6	8	0	0	8	0	0
5	63338557	.	C	T	3	7	10	0	0	10	0	0
5	63338563	.	A	G	3	7	10	0	0	10	0	0
5	63360135	.	C	T	1	2	3	0	0	3	0	0
5	63360161	.	T	G	1	0	1	0	3	4	0	0
5	63360290	.	A	G	2	3	5	0	0	5	0	0
5	63360344	.	T	C	4	4	8	0	0	8	0	0
5	63363058	.	C	T	1	2	3	0	0	3	0	0
5	63373157	.	T	C	1	0	1	0	0	1	0	0
5	63375773	.	G	A	2	1	3	0	0	3	0	0
5	63375809	.	G	C	1	4	5	0	0	5	0	0
5	63375818	.	A	G	1	0	1	0	5	6	0	0
5	63375980	.	C	T	1	2	3	0	0	3	0	0
5	63394174	.	C	A	14	11	25	0	2	27	0	0
5	63395057	.	A	T	4	6	10	0	1	11	0	0
5	63398847	.	T	C	7	25	32	0	1	33	0	0
5	63398973	.	G	A	18	12	30	0	5	35	0	0
5	63399066	.	G	C	18	27	45	0	0	45	0	0
5	63399111	.	T	A	23	28	51	0	1	52	0	0
5	63399683	.	T	A	16	15	31	0	0	31	0	0
5	63400524	.	T	G	5	4	9	0	0	9	0	0
5	63400685	.	G	A	1	2	3	0	0	3	0	0
5	63410281	.	T	C	4	3	7	0	0	7	0	0
5	63510908	.	G	T	4	11	15	0	0	15	0	0
5	63511045	.	A	G	4	5	9	0	0	9	0	0
5	63511110	.	T	C	4	0	4	0	8	12	0	0
5	63511264	.	A	G	4	3	7	0	0	7	0	0
5	63511315	.	A	G	5	4	9	0	0	9	0	0
5	63511788	.	A	T	5	5	10	0	0	10	0	0
5	63511791	.	A	G	5	5	10	0	0	10	0	0
5	63514810	.	T	C	1	0	1	0	5	6	0	0
5	63629121	.	C	A	4	7	11	0	0	11	0	0
5	63629136	.	G	A	5	7	12	0	1	13	0	0
5	63629299	.	A	T	10	7	17	0	0	17	0	0
5	63644801	.	T	C	7	0	7	0	5	12	0	0
5	63644850	.	G	A	3	3	6	0	0	6	0	0
5	63648376	.	T	C	3	0	3	0	3	6	0	0
5	63648811	.	A	G	3	5	8	0	0	8	0	0
5	63653276	.	A	G	2	2	4	0	0	4	0	0
5	63655829	.	T	C	0	1	1	0	0	1	0	0
5	63658433	.	T	G	2	0	2	0	0	2	0	0
5	63658436	.	G	C	2	0	2	0	0	2	0	0
5	63658512	.	G	A	2	2	4	0	0	4	0	0
5	63659513	.	C	T	1	0	1	0	0	1	0	0
5	63662111	.	A	T	1	2	3	0	0	3	0	0
5	63662125	.	T	C	1	0	1	0	2	3	0	0
5	63680655	.	A	G	4	0	4	0	9	13	0	0
5	63680661	.	C	G	4	7	11	0	1	12	0	0
5	63680709	.	T	G	2	3	5	0	1	6	0	0
5	63680718	.	A	G	2	0	2	0	1	3	0	0
5	63681123	.	A	G	4	2	6	0	0	6	0	0
5	63681300	.	A	G	1	0	1	0	0	1	0	0
5	63695760	.	C	T	7	7	14	0	0	14	0	0
5	63698549	.	T	C	0	8	8	0	0	8	0	0
5	63699468	.	T	C	1	0	1	0	0	1	0	0
5	63720639	.	A	G	9	11	20	0	3	23	0	0
5	63723807	.	G	A	0	12	12	0	5	17	0	0
5	63730115	.	G	A	3	17	20	0	8	28	0	0
5	63740093	.	C	T	16	14	30	0	0	30	0	0
5	63740097	.	T	A	16	13	29	0	0	29	0	0
5	63740149	.	T	C	14	11	25	0	0	25	0	0
5	63740167	.	A	G	10	12	22	0	0	23	1	0
5	63740280	.	A	G	14	5	19	0	0	19	0	0
5	63740293	.	A	G	13	5	18	0	0	18	0	0
5	63740815	.	A	C	19	24	43	0	2	45	0	0
5	63740874	.	A	C	22	17	39	0	2	41	0	0
5	63740895	.	A	C	21	18	39	0	1	40	0	0
5	63740910	.	A	G	19	22	41	0	1	42	0	0
5	63741023	.	T	A	7	12	19	0	2	21	0	0
5	63741077	.	A	T	5	13	18	0	0	18	0	0
5	63848593	.	T	C	7	5	12	0	0	12	0	0
5	63848662	.	C	T	1	4	5	0	0	5	0	0
5	63848668	.	G	T	1	4	5	0	0	5	0	0
5	63857154	.	A	C	1	1	2	0	0	2	0	0
5	63857156	.	G	A	1	1	2	0	0	2	0	0
5	63860936	.	A	G	2	2	4	0	1	5	0	0
5	63860943	.	A	G	4	0	4	0	1	5	0	0
5	63862696	.	C	A	1	2	3	0	0	3	0	0
5	63862709	.	G	A	1	2	3	0	0	3	0	0
5	63863018	.	G	A	0	2	2	0	1	3	0	0
5	63863073	.	A	G	1	2	3	0	0	3	0	0
5	63863537	.	G	T	2	5	7	0	0	7	0	0
5	63863538	.	T	C	2	5	7	0	0	7	0	0
5	63863651	.	C	G	3	0	3	0	6	9	0	0
5	63863656	.	G	A	2	5	7	0	2	9	0	0
5	63864117	.	C	T	6	8	14	0	0	14	0	0
5	63864150	.	T	C	4	3	7	0	1	8	0	0
5	64205776	.	T	C	6	4	10	0	0	10	0	0
5	64205784	.	T	C	5	5	10	0	0	10	0	0
5	64205914	.	T	C	5	3	8	0	0	8	0	0
5	64207370	.	T	C	10	11	21	0	1	22	0	0
5	65067684	.	C	T	3	4	7	0	1	8	0	0
5	66250917	.	C	T	5	3	8	0	1	9	0	0
5	66252054	.	G	A	0	0	0	0	1	1	0	0
5	66266997	.	A	G	3	3	6	0	0	6	0	0
5	66268964	.	A	G	1	0	1	0	2	3	0	0
5	66271189	.	G	A	1	2	3	0	0	3	0	0
5	66271214	.	C	T	2	2	4	0	0	4	0	0
5	66271446	.	A	T	4	4	8	0	0	8	0	0
5	66389652	.	C	T	0	1	1	0	0	1	0	0
5	66389676	.	C	T	1	2	3	0	0	3	0	0
5	66404663	.	T	C	0	0	0	0	2	2	0	0
5	66509247	.	T	C	1	0	1	0	0	1	0	0
5	66512040	.	G	C	0	2	2	0	0	2	0	0
5	66512064	.	A	G	0	2	2	0	0	2	0	0
5	66512293	.	T	G	0	0	0	0	1	1	0	0
5	66676766	.	C	G	1	2	3	0	0	3	0	0
5	66676768	.	G	A	1	2	3	0	0	3	0	0
5	66699135	.	G	T	11	10	21	1	0	22	0	0
5	66699138	.	C	G	11	9	20	1	1	22	0	0
5	66699564	.	G	T	7	6	13	0	1	14	0	0
5	66700388	.	C	T	4	5	9	0	0	9	0	0
5	66700608	.	T	C	4	2	6	0	0	6	0	0
5	66700734	.	C	A	0	7	7	0	7	14	0	0
5	66700833	.	T	C	1	0	1	0	8	9	0	0
5	66700974	.	T	A	5	5	10	0	0	10	0	0
5	66701266	.	T	C	2	6	8	0	0	8	0	0
5	66701493	.	T	C	7	5	12	0	1	13	0	0
5	66733482	.	C	G	4	2	6	0	0	6	0	0
5	66733572	.	C	T	0	4	4	0	2	6	0	0
5	66733682	.	T	C	15	8	23	0	0	23	0	0
5	66733694	.	T	C	14	0	14	0	9	23	0	0
5	66733891	.	G	C	9	7	16	0	0	16	0	0
5	66736211	.	T	C	1	2	3	0	0	3	0	0
5	66736280	.	A	G	7	7	14	0	0	14	0	0
5	66740183	.	A	T	7	10	17	0	1	18	0	0
5	66740239	.	T	G	4	13	17	0	1	18	0	0
5	66740273	.	A	T	4	9	13	0	0	13	0	0
5	66740324	.	G	A	2	4	6	0	0	6	0	0
5	66740330	.	A	C	2	0	2	0	3	5	0	0
5	66807482	.	C	T	12	13	25	0	4	29	0	0
5	66807543	.	C	T	0	24	24	0	10	34	0	0
5	66807735	.	A	G	9	17	26	0	0	26	0	0
5	66807771	.	T	G	16	14	30	0	0	30	0	0
5	66807788	.	C	T	0	9	9	0	16	25	0	0
5	66807830	.	G	A	6	6	12	0	1	13	0	0
5	66807831	.	A	G	6	7	13	0	0	13	0	0
5	66807881	.	A	G	15	8	23	0	0	23	0	0
5	66807916	.	T	C	20	16	36	0	0	36	0	0
5	66813647	.	T	C	6	1	7	0	7	14	0	0
5	66813674	.	G	A	4	11	15	0	2	17	0	0
5	66813722	.	A	G	0	2	2	0	0	2	0	0
5	66814504	.	T	C	4	6	10	0	0	10	0	0
5	66814522	.	A	G	5	6	11	0	1	12	0	0
5	66818699	.	C	T	13	17	30	0	1	31	0	0
5	66819515	.	T	C	13	9	22	0	1	23	0	0
5	66820859	.	A	T	4	14	18	0	2	20	0	0
5	67736986	.	T	C	0	0	0	0	2	2	0	0
5	67737223	.	C	T	1	4	5	0	0	5	0	0
5	67884508	.	G	A	9	3	12	0	1	13	0	0
5	68767201	.	C	T	11	4	15	0	0	15	0	0
5	68767342	.	T	C	3	5	8	0	1	9	0	0
5	68767358	.	T	C	5	3	8	0	2	10	0	0
5	68892515	.	A	C	1	2	3	0	1	4	0	0
5	68892550	.	C	T	11	5	16	0	0	16	0	0
5	68892872	.	T	C	2	13	15	0	0	15	0	0
5	68892875	.	T	C	10	4	14	0	1	15	0	0
5	69014276	.	T	C	1	2	3	0	0	3	0	0
5	69140658	.	T	C	6	6	12	0	0	12	0	0
5	69291109	.	T	C	1	2	3	1	0	4	0	0
5	69581937	.	G	A	1	3	4	0	0	4	0	0
5	69588720	.	A	T	0	7	7	0	0	7	0	0
5	69595361	.	G	A	2	5	7	0	0	7	0	0
5	69595412	.	G	A	8	2	10	0	0	10	0	0
5	69595416	.	A	C	8	2	10	0	0	10	0	0
5	69599798	.	G	T	0	4	4	0	0	4	0	0
5	69607398	.	T	C	0	6	6	0	1	7	0	0
5	70182082	.	A	G	17	26	43	0	1	44	0	0
5	70182599	.	T	G	29	2	31	0	23	54	0	0
5	70271882	.	C	T	1	0	1	0	0	1	0	0
5	70301379	.	C	T	1	0	1	0	1	2	0	0
5	70301392	.	C	A	1	1	2	0	0	2	0	0
5	70317090	.	T	A	2	3	5	0	1	6	0	0
5	70317576	.	T	C	3	3	6	0	0	6	0	0
5	70317960	.	G	A	3	3	6	0	2	8	0	0
5	70318311	.	T	C	6	4	10	0	0	10	0	0
5	70318320	.	G	A	6	5	11	0	0	11	0	0
5	70318665	.	A	T	3	2	5	0	0	5	0	0
5	70318671	.	C	T	3	2	5	0	0	5	0	0
5	70318898	.	T	A	6	2	8	0	0	9	1	0
5	70318950	.	A	G	6	4	10	0	0	10	0	0
5	70319066	.	G	A	1	5	6	0	2	8	0	0
5	70319330	.	G	C	1	4	5	0	0	5	0	0
5	70319533	.	C	T	4	5	9	0	0	9	0	0
5	70319984	.	T	A	3	5	8	0	0	8	0	0
5	71748357	.	T	C	3	4	7	0	0	7	0	0
5	71765768	.	C	T	9	11	20	0	2	22	0	0
5	71927625	.	A	T	1	2	3	0	0	3	0	0
5	71931476	.	G	T	0	2	2	0	1	3	0	0
5	71934680	.	A	C	1	3	4	0	0	4	0	0
5	71934706	.	T	G	3	0	3	0	3	6	0	0
5	71941870	.	T	C	1	3	4	0	0	4	0	0
5	71944137	.	G	A	0	2	2	0	1	3	0	0
5	71944140	.	G	A	1	2	3	0	0	3	0	0
5	71946074	.	T	C	0	1	1	0	0	1	0	0
5	71946405	.	G	A	2	3	5	0	0	5	0	0
5	71946540	.	A	G	6	4	10	0	0	10	0	0
5	72002655	.	A	C	4	1	5	0	0	5	0	0
5	72002712	.	G	A	1	2	3	0	2	5	0	0
5	72002790	.	G	T	3	4	7	0	0	7	0	0
5	72002796	.	G	A	3	3	6	0	1	7	0	0
5	72023857	.	C	T	18	14	32	0	17	49	0	0
5	72024336	.	C	T	0	3	3	0	3	6	0	0
5	72027464	.	C	T	0	1	1	0	1	2	0	0
5	72028042	.	G	C	5	0	5	0	2	7	0	0
5	72031809	.	G	A	14	16	30	0	0	30	0	0
5	72031846	.	A	G	11	8	19	0	0	19	0	0
5	72033527	.	C	T	0	6	6	0	7	13	0	0
5	72034108	.	C	T	0	5	5	0	5	10	0	0
5	72038586	.	C	T	15	14	29	0	0	29	0	0
5	72038727	.	G	A	5	17	22	0	3	25	0	0
5	72038909	.	C	T	1	13	14	0	11	25	0	0
5	72039105	.	G	A	13	11	24	0	4	28	0	0
5	72043751	.	A	G	5	10	15	0	1	16	0	0
5	72043778	.	G	A	8	14	22	0	0	22	0	0
5	72043791	.	G	T	15	11	26	0	0	26	0	0
5	72044324	.	G	A	9	6	15	0	0	15	0	0
5	72044342	.	A	G	8	10	18	0	0	18	0	0
5	72045010	.	C	T	0	4	4	0	3	7	0	0
5	72046888	.	C	T	3	8	11	0	3	14	0	0
5	72047047	.	C	G	1	13	14	0	11	25	0	0
5	72047127	.	T	A	4	3	7	0	0	7	0	0
5	72047136	.	T	C	1	0	1	0	1	2	0	0
5	72049688	.	C	A	1	2	3	0	2	5	0	0
5	72050192	.	A	G	14	17	31	0	0	31	0	0
5	72050257	.	C	T	1	10	11	0	17	28	0	0
5	72050314	.	T	C	9	3	12	0	19	31	0	0
5	72053139	.	C	T	0	5	5	0	6	11	0	0
5	72058489	.	T	C	1	3	4	0	0	4	0	0
5	72066904	.	C	T	6	5	11	0	0	11	0	0
5	72066993	.	G	A	4	5	9	0	0	9	0	0
5	72067803	.	A	G	3	1	4	0	0	4	0	0
5	72069295	.	C	A	2	2	4	0	0	4	0	0
5	72075379	.	G	A	1	2	3	0	0	3	0	0
5	72092483	.	C	T	34	28	62	0	2	64	0	0
5	72092958	.	G	A	1	9	10	0	10	20	0	0
5	72095464	.	G	A	4	2	6	0	0	6	0	0
5	72095796	.	G	A	0	1	1	0	0	1	0	0
5	72130139	.	C	A	2	3	5	0	0	5	0	0
5	72130656	.	A	G	5	4	9	0	0	9	0	0
5	72131482	.	C	T	0	4	4	0	3	7	0	0
5	72131531	.	C	T	4	6	10	0	2	12	0	0
5	72131558	.	A	T	7	5	12	0	0	12	0	0
5	72131618	.	C	T	1	6	7	0	0	7	0	0
5	72134329	.	A	G	3	2	5	0	0	5	0	0
5	72139978	.	G	A	2	3	5	0	0	5	0	0
5	72142077	.	T	C	5	5	10	0	0	10	0	0
5	72152855	.	C	A	1	1	2	0	0	2	0	0
5	72155508	.	A	C	2	0	2	0	0	2	0	0
5	72157900	.	A	G	5	3	8	0	0	8	0	0
5	72163597	.	A	T	0	1	1	0	0	1	0	0
5	72166708	.	A	G	0	3	3	0	0	3	0	0
5	72167073	.	A	G	1	0	1	0	1	2	0	0
5	72167239	.	C	T	2	2	4	0	0	4	0	0
5	72167379	.	C	T	2	5	7	0	0	7	0	0
5	72168237	.	T	C	4	3	7	0	0	7	0	0
5	72168267	.	A	G	4	5	9	0	1	10	0	0
5	72168297	.	T	G	5	1	6	0	6	12	0	0
5	72168552	.	C	T	7	5	12	0	0	12	0	0
5	72172350	.	T	A	25	20	45	0	1	46	0	0
5	72172446	.	G	T	20	12	32	0	0	32	0	0
5	72172456	.	G	T	13	23	36	0	1	37	0	0
5	72172600	.	T	C	21	9	30	0	0	30	0	0
5	72172752	.	G	A	15	27	42	0	1	43	0	0
5	72173169	.	C	A	12	7	19	0	0	19	0	0
5	72173476	.	T	C	10	19	29	0	1	30	0	0
5	72173483	.	T	G	12	19	31	0	0	31	0	0
5	72173894	.	G	A	15	10	25	0	0	25	0	0
5	72173943	.	C	T	12	10	22	0	0	22	0	0
5	72194557	.	C	T	1	7	8	0	0	8	0	0
5	72196949	.	G	A	2	3	5	0	0	5	0	0
5	72202402	.	G	A	0	3	3	0	6	9	0	0
5	72202467	.	G	A	5	4	9	0	1	10	0	0
5	72203313	.	G	A	2	1	3	0	0	3	0	0
5	72205483	.	A	C	7	8	15	0	0	15	0	0
5	72205583	.	T	G	11	0	11	0	5	16	0	0
5	72205701	.	G	A	0	4	4	0	0	4	0	0
5	72205905	.	T	C	6	2	8	0	0	8	0	0
5	72206090	.	T	C	2	6	8	0	0	8	0	0
5	72206155	.	G	T	3	6	9	0	0	9	0	0
5	72206235	.	T	G	2	0	2	0	3	5	0	0
5	72316948	.	A	G	1	2	3	0	0	3	0	0
5	72316977	.	T	G	1	3	4	0	0	4	0	0
5	72317622	.	C	T	2	5	7	0	1	8	0	0
5	72317643	.	A	G	3	2	5	0	2	7	0	0
5	72317660	.	A	G	1	4	5	0	0	5	0	0
5	72318027	.	T	C	1	5	6	0	1	7	0	0
5	72318163	.	G	A	0	2	2	0	1	3	0	0
5	72318172	.	C	T	1	2	3	0	1	4	0	0
5	72376119	.	C	G	15	26	41	0	0	41	0	0
5	72376227	.	A	G	11	21	32	0	2	34	0	0
5	72376959	.	A	G	12	15	27	0	4	31	0	0
5	72382995	.	C	T	2	4	6	0	1	7	0	0
5	72383263	.	C	T	13	11	24	0	3	27	0	0
5	72383964	.	A	G	7	4	11	0	1	12	0	0
5	72384544	.	A	G	3	6	9	0	5	14	0	0
5	72384546	.	A	G	3	9	12	0	2	14	0	0
5	72384642	.	T	C	4	9	13	0	1	14	0	0
5	72384807	.	T	C	6	1	7	0	19	26	0	0
5	72384978	.	G	A	9	5	14	0	1	15	0	0
5	72385001	.	C	T	16	7	23	0	1	24	0	0
5	72385034	.	A	G	14	12	26	0	1	27	0	0
5	72385075	.	C	T	12	14	26	0	2	28	0	0
5	72386870	.	T	C	15	13	28	0	0	28	0	0
5	72389156	.	C	A	1	6	7	0	6	13	0	0
5	72390189	.	G	A	19	9	28	0	1	29	0	0
6	267568	.	A	G	5	2	7	0	0	7	0	0
6	272194	.	A	G	28	1	29	0	19	48	0	0
6	340480	.	A	C	18	22	40	0	1	41	0	0
6	842391	.	T	C	13	4	17	0	1	18	0	0
6	842581	.	T	C	11	0	11	0	7	18	0	0
6	1561930	.	A	C	1	3	4	0	0	4	0	0
6	1798051	.	T	C	5	1	6	0	0	6	0	0
6	1798081	.	G	T	5	3	8	0	0	8	0	0
6	1798088	.	T	C	5	3	8	0	0	8	0	0
6	3005094	.	T	G	0	5	5	0	0	5	0	0
6	3005179	.	G	T	2	3	5	0	0	5	0	0
6	3040536	.	T	C	2	1	3	0	0	3	0	0
6	3047971	.	A	T	1	2	3	0	0	3	0	0
6	3143292	.	T	A	3	12	15	0	1	16	0	0
6	3143609	.	G	A	1	5	6	0	0	6	0	0
6	3197028	.	C	T	10	10	20	0	1	21	0	0
6	3223245	.	C	T	3	7	10	0	0	10	0	0
6	3223341	.	C	G	3	0	3	0	0	3	0	0
6	3249490	.	C	T	7	4	11	0	0	11	0	0
6	3256066	.	C	A	7	1	8	0	1	9	0	0
6	3268327	.	T	C	3	3	6	0	0	6	0	0
6	3269864	.	A	G	5	1	6	0	8	14	0	0
6	3270011	.	G	A	5	10	15	0	1	16	0	0
6	3273272	.	A	T	11	14	25	0	0	25	0	0
6	3273341	.	T	A	12	9	21	0	3	24	0	0
6	3273379	.	A	G	9	11	20	0	2	22	0	0
6	3273901	.	T	G	11	0	11	0	14	25	0	0
6	3274114	.	G	C	1	24	25	0	17	42	0	0
6	3274191	.	G	C	16	3	19	0	3	22	0	0
6	3282817	.	G	A	0	3	3	0	2	5	0	0
6	3282919	.	G	A	0	1	1	0	0	1	0	0
6	3282934	.	G	A	0	1	1	0	0	1	0	0
6	3290477	.	T	C	3	3	6	0	0	6	0	0
6	3293322	.	T	C	1	2	3	0	0	3	0	0
6	3293385	.	G	A	0	2	2	0	1	3	0	0
6	3293428	.	T	A	1	3	4	0	0	4	0	0
6	3293441	.	C	G	1	2	3	0	0	3	0	0
6	3293490	.	A	G	1	0	1	0	4	5	0	0
6	3293933	.	T	G	2	2	4	0	0	4	0	0
6	3294037	.	C	A	3	1	4	0	0	4	0	0
6	3294251	.	T	C	4	5	9	0	0	9	0	0
6	3294306	.	G	T	0	7	7	0	2	9	0	0
6	3294492	.	C	T	5	9	14	0	1	15	0	0
6	3294755	.	C	T	1	3	4	0	2	6	0	0
6	3295262	.	C	T	2	6	8	0	0	8	0	0
6	3295596	.	G	A	0	2	2	0	3	5	0	0
6	3295607	.	C	T	5	1	6	0	1	7	0	0
6	3295744	.	G	T	6	4	10	0	0	10	0	0
6	3295763	.	T	C	4	3	7	0	0	7	0	0
6	3295796	.	G	A	5	3	8	0	0	8	0	0
6	3298816	.	G	C	1	1	2	0	0	2	0	0
6	3298844	.	C	T	4	2	6	0	0	6	0	0
6	3312627	.	C	T	3	1	4	0	0	4	0	0
6	3312750	.	A	T	0	2	2	0	0	2	0	0
6	3318721	.	G	A	0	4	4	0	4	8	0	0
6	3318880	.	A	C	1	3	4	0	1	5	0	0
6	3319076	.	A	G	1	3	4	0	0	4	0	0
6	3343800	.	T	C	0	2	2	0	1	3	0	0
6	3395649	.	C	T	3	1	4	0	0	4	0	0
6	3398906	.	A	G	6	3	9	0	1	10	0	0
6	3404956	.	G	A	0	2	2	0	8	10	0	0
6	3404974	.	C	T	8	3	11	0	0	11	0	0
6	3405052	.	G	A	3	11	14	0	0	14	0	0
6	3405060	.	G	A	0	11	11	0	5	16	0	0
6	3405143	.	T	C	6	8	14	0	0	14	0	0
6	3405191	.	G	C	8	6	14	0	0	14	0	0
6	3405244	.	A	G	10	4	14	0	0	14	0	0
6	3405245	.	C	A	10	4	14	0	0	14	0	0
6	3500212	.	G	A	3	2	5	0	0	5	0	0
6	3502595	.	C	T	0	3	3	0	0	3	0	0
6	3509041	.	T	G	2	3	5	0	0	5	0	0
6	3514481	.	A	C	21	20	41	0	4	45	0	0
6	3563987	.	A	G	1	2	3	0	0	3	0	0
6	3698558	.	C	T	3	1	4	0	0	4	0	0
6	3704391	.	G	A	0	4	4	0	0	4	0	0
6	3707095	.	A	G	4	6	10	0	0	10	0	0
6	3707116	.	G	A	5	7	12	0	1	13	0	0
6	3707371	.	G	A	1	10	11	0	10	21	0	0
6	3707372	.	A	G	10	10	20	0	1	21	0	0
6	3707407	.	T	C	7	9	16	0	2	18	0	0
6	3708061	.	A	G	6	6	12	0	0	12	0	0
6	3708149	.	T	C	3	7	10	0	1	11	0	0
6	3711200	.	T	A	4	10	14	0	0	14	0	0
6	3711221	.	A	G	7	10	17	0	1	18	0	0
6	3711282	.	T	G	13	0	13	0	13	26	0	0
6	3711338	.	A	G	7	10	17	0	0	17	0	0
6	3711386	.	T	C	6	3	9	0	2	11	0	0
6	3711616	.	G	A	7	4	11	0	0	11	0	0
6	3711665	.	A	T	2	5	7	0	0	7	0	0
6	3711971	.	G	A	6	3	9	0	0	9	0	0
6	3712045	.	T	A	6	3	9	0	1	10	0	0
6	3712069	.	A	T	6	10	16	0	0	16	0	0
6	3712136	.	G	A	7	8	15	0	1	16	0	0
6	3712198	.	G	T	5	4	9	0	0	9	0	0
6	3712199	.	A	C	5	4	9	0	0	9	0	0
6	3712238	.	A	T	4	7	11	0	0	11	0	0
6	3712264	.	A	C	2	6	8	0	1	9	0	0
6	3712335	.	T	G	6	0	6	0	6	12	0	0
6	3712389	.	C	T	2	4	6	0	1	7	0	0
6	3712433	.	A	T	0	3	3	0	0	3	0	0
6	3712713	.	C	G	6	5	11	0	0	11	0	0
6	3717060	.	T	A	0	1	1	0	1	2	0	0
6	3717843	.	C	T	5	1	6	0	1	7	0	0
6	3724870	.	A	C	14	10	24	0	1	25	0	0
6	3725767	.	C	A	12	14	26	0	0	26	0	0
6	3727891	.	C	T	13	6	19	0	1	20	0	0
6	3728295	.	A	T	4	9	13	0	1	14	0	0
6	3728559	.	G	C	5	4	9	0	0	9	0	0
6	3812470	.	T	C	1	2	3	0	0	3	0	0
6	3827894	.	C	A	14	21	35	0	3	39	1	0
6	3834630	.	G	C	33	22	55	0	1	56	0	0
6	3853120	.	T	G	17	0	17	0	13	30	0	0
6	3853165	.	T	C	21	16	37	0	0	37	0	0
6	3862018	.	A	G	15	16	31	0	3	34	0	0
6	3867542	.	A	T	2	5	7	0	1	8	0	0
6	3869454	.	G	A	0	6	6	0	4	10	0	0
6	3869891	.	C	T	9	13	22	0	1	23	0	0
6	3871982	.	T	A	7	8	15	0	0	15	0	0
6	3874504	.	G	A	0	21	21	0	26	47	0	0
6	3874533	.	C	T	22	25	47	0	1	48	0	0
6	3874686	.	A	G	14	12	26	0	1	27	0	0
6	3878513	.	T	A	5	5	10	0	0	10	0	0
6	3878593	.	A	G	6	5	11	0	1	12	0	0
6	3878831	.	G	C	3	7	10	0	0	10	0	0
6	3878983	.	A	T	6	10	16	0	3	19	0	0
6	3879158	.	A	G	12	9	21	0	0	21	0	0
6	3879247	.	C	A	0	15	15	0	10	25	0	0
6	3879314	.	C	G	0	4	4	0	10	14	0	0
6	3879335	.	C	T	9	3	12	0	0	12	0	0
6	3879367	.	G	A	4	2	6	0	0	6	0	0
6	3881078	.	G	A	3	2	5	0	0	5	0	0
6	3885451	.	C	T	10	12	22	0	1	23	0	0
6	3895442	.	A	T	4	3	7	0	1	8	0	0
6	3895460	.	C	T	0	10	10	0	6	16	0	0
6	3901120	.	C	T	0	2	2	0	3	5	0	0
6	3907796	.	A	T	5	3	8	0	0	8	0	0
6	3934836	.	G	A	0	1	1	0	0	1	0	0
6	3950267	.	C	T	1	0	1	0	0	1	0	0
6	3950270	.	C	T	0	1	1	0	0	1	0	0
6	3950309	.	C	T	1	2	3	0	0	3	0	0
6	3953280	.	T	C	1	5	6	0	0	6	0	0
6	3953302	.	A	C	2	5	7	0	0	7	0	0
6	3961387	.	G	A	9	3	12	0	0	12	0	0
6	3962132	.	G	A	26	21	47	0	3	50	0	0
6	3962192	.	A	T	13	8	21	0	0	21	0	0
6	3964619	.	G	A	0	1	1	0	0	1	0	0
6	3965389	.	G	T	3	3	6	0	0	6	0	0
6	3965461	.	A	G	13	9	22	0	0	22	0	0
6	3973572	.	G	A	0	1	1	0	0	1	0	0
6	3973638	.	T	G	0	5	5	0	0	5	0	0
6	3974047	.	G	A	7	9	16	0	2	18	0	0
6	3985083	.	G	A	3	9	12	0	1	13	0	0
6	3985137	.	G	A	6	13	19	0	1	20	0	0
6	3987269	.	G	A	1	0	1	0	0	1	0	0
6	3989704	.	C	A	1	0	1	0	0	1	0	0
6	4144415	.	C	T	2	3	5	0	0	5	0	0
6	4144448	.	C	T	3	1	4	0	0	4	0	0
6	4185678	.	G	A	18	13	31	0	1	32	0	0
6	4191449	.	C	T	8	7	15	0	1	16	0	0
6	4191554	.	A	T	3	9	12	0	0	12	0	0
6	4192025	.	G	A	4	1	5	0	0	5	0	0
6	4192031	.	A	G	1	4	5	0	0	5	0	0
6	4192171	.	G	A	0	4	4	0	0	4	0	0
6	4199494	.	T	C	2	0	2	0	0	2	0	0
6	4204072	.	G	T	1	3	4	0	0	4	0	0
6	4204117	.	G	T	1	2	3	0	0	3	0	0
6	4219856	.	G	A	5	8	13	0	0	13	0	0
6	4229830	.	C	T	1	3	4	0	0	4	0	0
6	4241945	.	C	T	0	4	4	0	0	4	0	0
6	4241954	.	A	G	0	5	5	0	0	5	0	0
6	4246466	.	T	C	3	6	9	0	0	9	0	0
6	4246496	.	G	A	0	5	5	0	8	13	0	0
6	4246638	.	A	C	1	4	5	0	0	5	0	0
6	4247928	.	C	T	7	3	10	0	1	11	0	0
6	4247942	.	T	C	3	6	9	0	2	11	0	0
6	4248231	.	A	G	3	0	3	0	4	7	0	0
6	4249420	.	C	T	0	3	3	0	1	4	0	0
6	4249437	.	A	G	0	2	2	0	0	2	0	0
6	4249821	.	G	A	6	2	8	0	1	9	0	0
6	4250046	.	A	T	1	2	3	0	1	4	0	0
6	4352167	.	C	T	0	1	1	0	0	1	0	0
6	4352176	.	C	A	0	1	1	0	0	1	0	0
6	4401139	.	G	A	2	3	5	0	0	5	0	0
6	6307946	.	A	C	2	2	4	0	1	5	0	0
6	6990063	.	G	A	0	6	6	6	0	12	0	0
6	7542491	.	G	T	0	2	2	0	5	7	0	0
6	7545794	.	C	T	7	5	12	0	2	14	0	0
6	7545824	.	T	C	8	6	14	0	2	16	0	0
6	7547451	.	C	T	3	3	6	0	0	6	0	0
6	7549967	.	G	A	4	6	10	0	1	11	0	0
6	7550210	.	A	C	9	6	15	0	1	16	0	0
6	7550405	.	C	T	14	11	25	0	1	26	0	0
6	7551087	.	C	A	5	3	8	0	0	8	0	0
6	7555618	.	C	T	0	1	1	0	1	2	0	0
6	7591018	.	G	A	2	3	5	0	0	5	0	0
6	7608307	.	C	T	1	1	2	0	0	2	0	0
6	7612455	.	T	C	0	2	2	0	0	2	0	0
6	7624012	.	T	C	8	11	19	0	0	19	0	0
6	7626457	.	C	T	1	2	3	0	1	4	0	0
6	7633452	.	G	C	0	5	5	0	6	11	0	0
6	7636811	.	A	T	9	7	16	0	0	16	0	0
6	7637195	.	C	T	4	4	8	0	0	8	0	0
6	7638717	.	G	A	10	4	14	0	1	15	0	0
6	7645319	.	T	C	2	3	5	0	0	5	0	0
6	7646039	.	A	G	2	4	6	0	0	6	0	0
6	7646102	.	G	A	14	15	29	0	1	30	0	0
6	7646111	.	G	C	13	15	28	0	1	29	0	0
6	7648224	.	A	G	4	0	4	0	7	11	0	0
6	7652458	.	C	T	10	14	24	0	1	25	0	0
6	7652470	.	A	C	11	10	21	0	0	21	0	0
6	7652896	.	G	A	0	21	21	0	18	39	0	0
6	7652959	.	C	T	14	17	31	0	1	32	0	0
6	7652989	.	C	T	5	4	9	0	0	9	0	0
6	7656920	.	A	G	10	0	10	0	18	28	0	0
6	7656932	.	A	G	11	24	35	0	1	36	0	0
6	7657177	.	C	T	13	15	28	0	0	28	0	0
6	7657793	.	A	C	12	16	28	0	0	28	0	0
6	7657886	.	T	A	13	12	25	0	0	25	0	0
6	7657887	.	G	T	13	12	25	0	0	25	0	0
6	7657972	.	T	G	17	6	23	0	0	23	0	0
6	7658076	.	G	A	17	14	31	0	2	33	0	0
6	7659915	.	G	A	3	6	9	1	0	10	0	0
6	7660119	.	A	G	14	9	23	0	0	23	0	0
6	7660369	.	T	C	3	3	6	0	0	6	0	0
6	7660458	.	A	C	3	0	3	0	7	10	0	0
6	7660659	.	C	A	1	6	7	0	2	9	0	0
6	7660707	.	C	T	0	6	6	0	3	9	0	0
6	7682793	.	C	A	0	0	0	0	1	1	0	0
6	7697573	.	G	A	1	1	2	0	0	2	0	0
6	7702770	.	G	T	0	2	2	0	0	2	0	0
6	7705984	.	G	A	2	3	5	0	0	5	0	0
6	7713350	.	A	T	2	2	4	0	1	5	0	0
6	7713433	.	G	A	17	23	40	0	1	41	0	0
6	7721530	.	T	A	4	7	11	0	1	12	0	0
6	7721860	.	G	A	8	3	11	0	0	11	0	0
6	7721906	.	G	A	8	12	20	0	1	21	0	0
6	7721958	.	C	A	14	13	27	1	2	30	0	0
6	7722143	.	G	T	10	15	25	0	1	26	0	0
6	7722159	.	A	T	11	10	21	0	1	22	0	0
6	7722195	.	G	T	9	10	19	0	1	20	0	0
6	7722205	.	G	A	9	11	20	0	2	22	0	0
6	7722333	.	G	A	8	7	15	0	1	16	0	0
6	7722387	.	T	C	12	3	15	0	2	17	0	0
6	7722402	.	T	C	16	4	20	0	0	20	0	0
6	7722577	.	C	T	1	12	13	0	8	21	0	0
6	7722625	.	T	C	19	10	29	0	0	29	0	0
6	7722634	.	T	C	22	5	27	0	2	29	0	0
6	7722921	.	A	T	1	4	5	0	0	5	0	0
6	7723155	.	A	C	8	14	22	0	0	22	0	0
6	7723232	.	A	T	10	3	13	0	1	14	0	0
6	7723850	.	C	T	0	4	4	0	7	11	0	0
6	7723961	.	G	A	10	8	18	0	0	18	0	0
6	7726824	.	G	A	11	15	26	0	0	26	0	0
6	7734250	.	A	C	3	0	3	0	0	3	0	0
6	7734271	.	C	A	1	0	1	0	0	1	0	0
6	7795698	.	C	T	18	11	29	0	6	35	0	0
6	7842013	.	C	T	0	5	5	0	8	13	0	0
6	7842034	.	C	A	9	4	13	0	1	14	0	0
6	8176101	.	A	G	3	6	9	0	0	9	0	0
6	8176575	.	C	T	7	3	10	0	1	11	0	0
6	8177030	.	T	C	12	5	17	0	1	18	0	0
6	8177399	.	T	C	7	5	12	0	0	12	0	0
6	8177600	.	T	C	7	5	12	0	1	13	0	0
6	8177678	.	C	T	7	5	12	0	0	12	0	0
6	8178002	.	T	C	10	13	23	0	0	23	0	0
6	8178053	.	G	A	0	7	7	0	5	12	0	0
6	8178113	.	T	C	6	4	10	0	2	12	0	0
6	8178351	.	G	A	6	5	11	0	0	11	0	0
6	8179022	.	G	T	0	17	17	0	7	24	0	0
6	8179205	.	A	T	11	13	24	0	1	25	0	0
6	8179373	.	G	A	14	9	23	0	2	25	0	0
6	8210334	.	A	G	2	2	4	0	0	4	0	0
6	8210404	.	C	T	2	3	5	0	0	5	0	0
6	8210487	.	T	C	1	5	6	0	0	6	0	0
6	8210488	.	G	A	1	5	6	0	0	6	0	0
6	8210902	.	C	G	2	4	6	0	0	6	0	0
6	8211075	.	C	T	3	6	9	0	0	9	0	0
6	8211106	.	T	C	1	6	7	0	0	7	0	0
6	8211143	.	A	T	2	4	6	0	0	6	0	0
6	8211253	.	G	A	3	3	6	0	0	6	0	0
6	8212174	.	G	A	1	0	1	0	0	1	0	0
6	8214118	.	T	C	1	4	5	0	0	5	0	0
6	8214947	.	T	C	0	0	0	0	4	4	0	0
6	8217870	.	G	A	1	0	1	0	0	1	0	0
6	8224881	.	A	G	1	2	3	0	0	3	0	0
6	8265214	.	G	A	3	3	6	0	0	6	0	0
6	8265282	.	G	A	3	7	10	0	0	10	0	0
6	8267111	.	C	T	16	25	41	0	1	42	0	0
6	8267266	.	A	G	22	13	35	0	1	36	0	0
6	8267284	.	G	A	19	8	27	0	1	28	0	0
6	8267307	.	G	C	16	7	23	0	0	23	0	0
6	8267352	.	A	T	17	17	34	0	1	35	0	0
6	8267519	.	G	A	23	22	45	0	2	47	0	0
6	8267563	.	G	T	20	22	42	0	1	43	0	0
6	8267635	.	T	C	20	18	38	0	2	40	0	0
6	8267795	.	T	A	13	7	20	0	0	20	0	0
6	8267880	.	G	A	4	15	19	0	0	19	0	0
6	8268529	.	A	G	10	10	20	0	2	22	0	0
6	8282275	.	A	G	4	2	6	0	0	6	0	0
6	8283393	.	T	C	0	0	0	0	4	4	0	0
6	8315076	.	A	G	5	5	10	0	0	10	0	0
6	8315078	.	A	G	5	5	10	0	0	10	0	0
6	8318001	.	T	C	2	7	9	0	0	9	0	0
6	8318037	.	G	A	0	11	11	0	8	19	0	0
6	8328181	.	G	T	7	8	15	1	0	16	0	0
6	8365753	.	T	C	1	4	5	0	1	6	0	0
6	8366006	.	A	T	8	8	16	0	1	17	0	0
6	8366167	.	C	T	18	12	30	0	1	31	0	0
6	8370489	.	T	C	7	7	14	0	2	16	0	0
6	8374716	.	G	A	5	2	7	0	0	7	0	0
6	8375089	.	C	T	15	9	24	0	0	24	0	0
6	8380345	.	G	A	4	5	9	0	0	9	0	0
6	8380433	.	G	C	9	3	12	0	1	13	0	0
6	8380485	.	G	T	5	3	8	0	0	8	0	0
6	8391629	.	C	T	0	4	4	0	8	12	0	0
6	8392005	.	G	A	3	5	8	0	1	9	0	0
6	8453550	.	A	G	1	2	3	0	1	4	0	0
6	8460400	.	A	T	1	2	3	0	0	3	0	0
6	8460435	.	G	T	2	4	6	0	0	6	0	0
6	8460493	.	G	T	3	2	5	0	0	5	0	0
6	8460793	.	T	C	2	2	4	0	0	4	0	0
6	8460808	.	A	T	2	1	3	0	0	3	0	0
6	8465662	.	A	G	2	1	3	0	0	3	0	0
6	8501017	.	A	G	0	1	1	0	0	1	0	0
6	8518746	.	T	C	1	2	3	0	0	3	0	0
6	9130510	.	A	G	5	8	13	0	0	13	0	0
6	9130521	.	A	G	6	7	13	0	1	14	0	0
6	9856434	.	A	G	0	0	0	0	3	3	0	0
6	10733179	.	T	C	2	2	4	0	0	4	0	0
6	10830848	.	A	T	1	2	3	0	1	4	0	0
6	10982877	.	C	T	1	2	3	0	0	3	0	0
6	10983029	.	A	C	2	2	4	0	0	4	0	0
6	10983066	.	T	C	2	3	5	0	0	5	0	0
6	10983193	.	T	A	2	5	7	0	1	8	0	0
6	10983203	.	C	T	1	4	5	0	1	6	0	0
6	10983356	.	G	A	1	2	3	0	0	3	0	0
6	10983409	.	A	T	2	3	5	0	0	5	0	0
6	10983465	.	A	T	5	7	12	0	1	13	0	0
6	10985878	.	C	T	1	1	2	0	0	2	0	0
6	10986131	.	C	T	0	7	7	0	2	9	0	0
6	10986652	.	A	G	11	6	17	0	0	17	0	0
6	11067237	.	A	G	1	3	4	0	0	4	0	0
6	11070411	.	G	C	26	7	33	0	0	33	0	0
6	11070563	.	A	C	31	31	62	0	6	68	0	0
6	11070806	.	G	A	29	25	54	0	1	55	0	0
6	11071056	.	T	A	27	20	47	0	1	48	0	0
6	11071222	.	A	G	19	32	51	0	5	56	0	0
6	11071345	.	G	A	8	11	19	0	0	19	0	0
6	11071357	.	A	G	6	5	11	0	1	12	0	0
6	11101852	.	G	A	6	8	14	0	0	14	0	0
6	11107326	.	T	C	3	0	3	0	2	5	0	0
6	11113028	.	C	T	3	4	7	0	0	7	0	0
6	11120420	.	G	A	1	6	7	0	0	7	0	0
6	11122682	.	T	C	1	0	1	0	0	1	0	0
6	11129105	.	C	T	5	4	9	0	0	9	0	0
6	11129447	.	A	T	1	4	5	0	1	6	0	0
6	11250077	.	G	T	4	10	14	0	0	14	0	0
6	11250973	.	T	C	3	3	6	0	0	6	0	0
6	11253396	.	T	C	3	8	11	0	0	11	0	0
6	11253417	.	T	C	1	7	8	0	0	8	0	0
6	11253432	.	A	G	1	4	5	0	0	5	0	0
6	11253881	.	T	C	2	1	3	0	0	3	0	0
6	11253890	.	C	T	3	2	5	0	0	5	0	0
6	11253989	.	C	T	9	6	15	0	0	15	0	0
6	11254196	.	C	T	5	10	15	0	1	16	0	0
6	11254358	.	A	G	5	0	5	0	8	13	0	0
6	11254430	.	C	T	6	7	13	0	1	14	0	0
6	11257788	.	C	T	5	6	11	0	0	11	0	0
6	11261308	.	C	A	9	12	21	0	1	22	0	0
6	11262080	.	C	T	4	5	9	0	2	11	0	0
6	11264258	.	G	A	6	13	19	0	0	19	0	0
6	11265321	.	G	T	8	16	24	0	0	24	0	0
6	11265424	.	T	C	17	16	33	0	3	36	0	0
6	11265505	.	A	T	8	18	26	0	0	26	0	0
6	11265562	.	T	A	5	18	23	0	0	23	0	0
6	11265761	.	A	T	25	24	49	0	1	50	0	0
6	11265833	.	A	G	25	1	26	0	21	47	0	0
6	11266164	.	T	C	14	29	43	0	0	43	0	0
6	11266176	.	C	T	16	24	40	0	1	41	0	0
6	11266360	.	T	G	9	16	25	0	1	26	0	0
6	11266490	.	A	T	3	9	12	0	1	13	0	0
6	11266496	.	T	C	3	9	12	0	1	13	0	0
6	11279815	.	T	C	4	2	6	0	0	6	0	0
6	11281923	.	A	G	0	2	2	0	0	2	0	0
6	11281973	.	G	A	1	6	7	0	0	7	0	0
6	11282272	.	G	C	0	0	0	0	3	3	0	0
6	11282741	.	C	T	1	1	2	0	1	3	0	0
6	11285310	.	C	T	2	2	4	0	0	4	0	0
6	11285362	.	T	C	3	0	3	0	4	7	0	0
6	11285374	.	C	T	2	4	6	0	0	6	0	0
6	11285453	.	T	C	2	6	8	0	0	8	0	0
6	11285459	.	C	G	3	6	9	0	0	9	0	0
6	11285583	.	C	T	5	7	12	0	0	12	0	0
6	11285772	.	C	T	7	5	12	0	0	12	0	0
6	11285835	.	G	A	4	3	7	0	0	7	0	0
6	11288179	.	T	A	2	3	5	0	0	5	0	0
6	11288558	.	T	C	2	1	3	0	1	4	0	0
6	11295408	.	T	G	1	2	3	0	0	3	0	0
6	11295553	.	A	G	2	5	7	0	1	8	0	0
6	11295616	.	T	G	1	7	8	0	0	9	1	0
6	11299680	.	A	T	1	4	5	0	0	5	0	0
6	11299682	.	C	T	1	3	4	0	1	5	0	0
6	11299718	.	G	A	1	2	3	0	0	3	0	0
6	11299883	.	A	G	1	2	3	0	0	3	0	0
6	11299961	.	C	A	3	2	5	0	0	5	0	0
6	11299963	.	C	T	3	2	5	0	0	5	0	0
6	11303338	.	C	T	1	1	2	0	0	2	0	0
6	11316726	.	G	A	1	2	3	0	0	3	0	0
6	11322792	.	T	C	1	0	1	0	0	1	0	0
6	11327083	.	G	A	2	1	3	0	0	3	0	0
6	11337576	.	T	G	0	1	1	0	0	1	0	0
6	11407918	.	G	A	2	1	3	0	0	3	0	0
6	11407944	.	A	G	2	1	3	0	0	3	0	0
6	11407954	.	A	G	2	1	3	0	0	3	0	0
6	11414431	.	A	G	11	0	11	0	13	24	0	0
6	11414448	.	T	C	12	16	28	0	1	29	0	0
6	11414748	.	G	A	8	3	11	0	1	12	0	0
6	11414777	.	A	T	7	4	11	0	0	11	0	0
6	11414822	.	T	G	8	0	8	0	5	13	0	0
6	11415089	.	G	A	6	4	10	0	0	10	0	0
6	11415104	.	C	T	8	4	12	0	2	14	0	0
6	11504430	.	A	T	2	2	4	0	0	4	0	0
6	11507994	.	A	G	6	3	9	0	0	9	0	0
6	11508125	.	T	C	1	1	2	0	0	2	0	0
6	11512622	.	C	T	2	1	3	0	0	3	0	0
6	11540362	.	T	C	2	1	3	0	0	3	0	0
6	11765364	.	A	G	23	25	48	0	2	50	0	0
6	11765506	.	A	G	26	26	52	0	0	52	0	0
6	11765913	.	G	A	20	24	44	0	3	47	0	0
6	11766267	.	G	A	11	28	39	0	3	42	0	0
6	11766276	.	A	G	12	27	39	0	2	41	0	0
6	11766765	.	T	C	5	3	8	0	0	8	0	0
6	11767623	.	T	C	1	3	4	0	0	4	0	0
6	11768196	.	G	C	2	3	5	0	0	5	0	0
6	11771118	.	G	A	5	8	13	0	0	13	0	0
6	11773266	.	C	T	17	30	47	0	2	49	0	0
6	11779940	.	C	A	15	22	37	0	0	37	0	0
6	11780001	.	A	C	5	13	18	0	0	18	0	0
6	11780004	.	A	T	5	12	17	0	0	17	0	0
6	11781567	.	A	C	1	0	1	0	5	6	0	0
6	11791106	.	T	C	5	1	6	0	4	10	0	0
6	11791225	.	T	C	9	0	9	0	3	12	0	0
6	11791258	.	G	A	12	4	16	0	0	16	0	0
6	11791371	.	A	G	8	9	17	0	0	17	0	0
6	11791572	.	A	G	11	8	19	0	0	19	0	0
6	11791644	.	A	G	8	6	14	0	1	15	0	0
6	11791646	.	T	C	7	7	14	0	1	15	0	0
6	11791686	.	A	C	8	0	8	0	4	12	0	0
6	11791770	.	G	A	9	9	18	0	0	18	0	0
6	11791806	.	T	G	9	6	15	0	0	15	0	0
6	11791947	.	A	G	16	13	29	0	1	30	0	0
6	11796238	.	A	T	2	4	6	0	0	6	0	0
6	11816779	.	C	T	6	2	8	0	0	8	0	0
6	11816784	.	A	T	5	2	7	0	0	7	0	0
6	11816993	.	C	T	1	4	5	0	5	10	0	0
6	11817185	.	C	T	4	5	9	0	1	10	0	0
6	11817192	.	A	G	4	5	9	0	0	9	0	0
6	11817278	.	A	T	4	3	7	0	0	7	0	0
6	11817482	.	C	T	0	3	3	0	2	5	0	0
6	11817935	.	A	T	4	2	6	0	0	6	0	0
6	11817945	.	T	C	3	2	5	0	0	5	0	0
6	11819179	.	T	C	1	2	3	0	0	3	0	0
6	11820185	.	A	T	3	2	5	0	0	5	0	0
6	11937631	.	A	G	0	1	1	0	1	2	0	0
6	11939867	.	T	C	4	1	5	0	0	5	0	0
6	11943997	.	G	A	0	9	9	0	6	15	0	0
6	11944003	.	T	G	6	8	14	0	0	14	0	0
6	11944146	.	G	C	9	6	15	0	0	15	0	0
6	11950504	.	A	C	3	7	10	0	0	10	0	0
6	11950543	.	T	A	2	5	7	0	0	7	0	0
6	11950582	.	C	A	8	6	14	0	1	15	0	0
6	11950583	.	A	G	7	7	14	0	1	15	0	0
6	11952477	.	A	C	3	8	11	0	0	11	0	0
6	11960667	.	C	T	2	5	7	0	0	7	0	0
6	11976566	.	A	T	4	7	11	0	0	11	0	0
6	11976614	.	A	G	5	4	9	0	0	9	0	0
6	11976617	.	G	A	0	3	3	0	6	9	0	0
6	11981831	.	C	G	10	0	10	0	6	16	0	0
6	11982213	.	A	C	10	14	24	0	0	24	0	0
6	11982319	.	A	T	2	11	13	0	0	13	0	0
6	11986615	.	C	T	7	8	15	0	0	15	0	0
6	11986656	.	C	G	9	6	15	0	0	15	0	0
6	11994733	.	C	T	10	8	18	0	1	19	0	0
6	11994790	.	T	C	2	3	5	0	1	6	0	0
6	12001212	.	T	C	19	18	37	0	1	38	0	0
6	12002933	.	C	T	2	4	6	0	0	6	0	0
6	12006823	.	G	A	10	5	15	0	0	15	0	0
6	12006904	.	C	T	7	3	10	0	0	10	0	0
6	12006923	.	T	C	4	0	4	0	1	5	0	0
6	12016450	.	G	A	4	6	10	0	1	11	0	0
6	12036984	.	C	T	9	7	16	0	1	17	0	0
6	12037141	.	G	A	17	8	25	0	0	25	0	0
6	12037196	.	C	T	15	10	25	0	0	25	0	0
6	12037197	.	T	G	15	10	25	0	0	25	0	0
6	12037293	.	G	T	8	10	18	0	1	19	0	0
6	12037401	.	G	A	11	8	19	0	1	20	0	0
6	12044204	.	C	T	5	2	7	0	0	7	0	0
6	12044225	.	A	G	3	0	3	0	0	3	0	0
6	12052869	.	T	C	5	7	12	0	0	12	0	0
6	12053036	.	A	T	6	4	10	0	0	10	0	0
6	12053093	.	G	C	5	4	9	0	0	9	0	0
6	12057242	.	T	C	2	1	3	0	0	3	0	0
6	12059524	.	T	C	1	0	1	0	0	1	0	0
6	12066165	.	C	T	0	1	1	0	2	3	0	0
6	12067622	.	C	T	1	1	2	0	1	3	0	0
6	12073008	.	T	C	10	7	17	0	0	17	0	0
6	12084841	.	A	G	1	2	3	0	0	3	0	0
6	12089953	.	G	A	4	8	12	0	0	12	0	0
6	12100124	.	A	G	1	2	3	0	1	4	0	0
6	12100171	.	C	T	2	4	6	0	0	6	0	0
6	12104537	.	G	A	6	5	11	0	0	11	0	0
6	12199728	.	G	A	1	2	3	0	0	3	0	0
6	12200472	.	G	T	14	9	23	0	1	24	0	0
6	12200654	.	T	A	13	4	17	1	1	19	0	0
6	12200808	.	T	A	8	6	14	0	0	14	0	0
6	12200972	.	G	T	10	10	20	0	0	20	0	0
6	12201030	.	G	A	6	13	19	0	0	19	0	0
6	12201132	.	G	A	12	14	26	0	2	28	0	0
6	12212817	.	C	T	1	11	12	0	16	28	0	0
6	12213162	.	A	G	1	1	2	0	0	2	0	0
6	12214149	.	T	C	14	11	25	0	1	26	0	0
6	12217851	.	A	G	10	10	20	0	0	20	0	0
6	12220638	.	A	G	12	9	21	0	0	21	0	0
6	12224262	.	T	A	8	12	20	0	1	21	0	0
6	12224325	.	G	C	5	4	9	0	0	9	0	0
6	12275783	.	C	T	0	1	1	0	6	7	0	0
6	12299421	.	A	G	22	27	49	0	2	51	0	0
6	12299422	.	T	C	24	27	51	0	0	51	0	0
6	12299751	.	A	G	21	40	61	0	1	62	0	0
6	12303882	.	A	G	2	4	6	0	0	6	0	0
6	12303897	.	A	G	3	4	7	0	0	7	0	0
6	12313925	.	A	T	5	3	8	0	0	8	0	0
6	12331625	.	A	C	4	3	7	0	0	7	0	0
6	12331790	.	T	C	1	2	3	0	0	3	0	0
6	12379730	.	G	A	1	5	6	0	0	6	0	0
6	12379794	.	T	C	2	0	2	0	4	6	0	0
6	12428619	.	G	A	1	2	3	0	0	3	0	0
6	12428631	.	G	T	2	2	4	0	0	4	0	0
6	12463069	.	A	G	1	2	3	0	0	3	0	0
6	12464663	.	T	C	3	2	5	0	0	5	0	0
6	12466041	.	A	C	3	2	5	0	0	5	0	0
6	12503989	.	T	G	1	2	3	0	0	3	0	0
6	12504230	.	T	C	7	10	17	0	0	17	0	0
6	12504362	.	C	T	4	4	8	0	0	8	0	0
6	12504392	.	G	C	3	5	8	0	0	8	0	0
6	12516517	.	T	C	5	6	11	0	0	11	0	0
6	12595340	.	C	G	4	5	9	0	0	9	0	0
6	12595518	.	A	G	6	4	10	0	0	10	0	0
6	12600430	.	A	T	4	5	9	0	0	9	0	0
6	12603389	.	G	T	4	5	9	0	1	10	0	0
6	12606904	.	C	A	2	5	7	0	1	8	0	0
6	12617334	.	G	A	2	0	2	0	0	2	0	0
6	12620093	.	T	A	3	2	5	0	1	6	0	0
6	12633166	.	C	T	0	2	2	0	2	4	0	0
6	12635507	.	C	T	1	2	3	0	0	3	0	0
6	12656450	.	C	T	0	0	0	0	2	2	0	0
6	12711436	.	T	A	1	0	1	0	0	1	0	0
6	12797677	.	C	T	6	5	11	0	2	13	0	0
6	12797755	.	G	A	11	9	20	0	2	22	0	0
6	12797815	.	A	G	13	10	23	0	0	23	0	0
6	12798083	.	G	T	1	6	7	0	0	7	0	0
6	12798124	.	T	C	1	3	4	0	0	4	0	0
6	12798345	.	T	C	1	6	7	0	0	7	0	0
6	12803257	.	C	A	5	9	14	0	0	14	0	0
6	12803325	.	A	G	5	3	8	0	1	9	0	0
6	12803568	.	A	G	7	8	15	0	0	15	0	0
6	12803664	.	G	A	6	5	11	0	0	11	0	0
6	12803790	.	A	G	9	6	15	0	0	15	0	0
6	12803919	.	C	G	2	6	8	0	0	8	0	0
6	12804024	.	A	T	6	11	17	0	0	17	0	0
6	12804132	.	G	A	7	6	13	0	0	13	0	0
6	12810249	.	C	G	1	3	4	0	11	15	0	0
6	12853748	.	G	A	18	11	29	0	0	29	0	0
6	13241026	.	C	G	3	1	4	0	0	4	0	0
6	13869343	.	A	C	0	20	20	0	3	23	0	0
6	15527385	.	G	A	10	4	14	0	0	14	0	0
6	15538138	.	G	A	3	5	8	0	1	9	0	0
6	15541015	.	G	A	3	2	5	0	0	5	0	0
6	15543412	.	C	A	1	2	3	0	0	3	0	0
6	15543451	.	C	T	5	2	7	0	0	7	0	0
6	15548966	.	A	G	4	6	10	0	0	10	0	0
6	15603784	.	G	A	5	8	13	0	1	14	0	0
6	15603866	.	T	C	7	10	17	0	1	18	0	0
6	15604016	.	G	A	2	6	8	0	0	8	0	0
6	15604079	.	A	G	5	8	13	0	0	13	0	0
6	15604133	.	C	T	7	8	15	0	0	15	0	0
6	15604142	.	A	G	6	7	13	0	1	14	0	0
6	15604178	.	G	T	2	3	5	0	0	5	0	0
6	15752417	.	A	C	4	3	7	0	0	7	0	0
6	15752602	.	A	G	2	3	5	0	0	5	0	0
6	15752641	.	C	T	3	3	6	0	0	6	0	0
6	15752681	.	A	C	3	3	6	0	0	6	0	0
6	15753199	.	G	A	3	2	5	0	0	5	0	0
6	16031524	.	T	C	3	2	5	0	0	5	0	0
6	16043950	.	C	T	1	10	11	0	12	23	0	0
6	16043980	.	A	G	13	13	26	0	2	28	0	0
6	16043999	.	T	C	14	17	31	0	1	32	0	0
6	16044019	.	T	C	16	0	16	0	16	32	0	0
6	16044282	.	A	G	8	14	22	0	0	22	0	0
6	16044597	.	C	T	11	8	19	0	0	19	0	0
6	16045046	.	G	C	5	4	9	0	3	12	0	0
6	16045413	.	T	C	10	12	22	0	1	23	0	0
6	16045463	.	G	C	12	0	12	0	14	26	0	0
6	16045516	.	G	C	17	12	29	0	1	30	0	0
6	16045712	.	C	T	9	8	17	0	0	17	0	0
6	16045768	.	C	G	11	8	19	0	1	20	0	0
6	16045798	.	T	C	15	6	21	0	2	23	0	0
6	16045946	.	A	C	14	8	22	1	2	25	0	0
6	16045947	.	A	T	15	4	19	1	5	25	0	0
6	16046049	.	G	T	12	14	26	1	2	29	0	0
6	16046272	.	G	T	7	11	18	0	0	18	0	0
6	16046365	.	G	A	4	5	9	0	1	10	0	0
6	16046371	.	A	T	4	3	7	0	1	8	0	0
6	16046419	.	C	T	0	2	2	0	2	4	0	0
6	16046676	.	G	A	8	7	15	0	1	16	0	0
6	16046761	.	A	C	9	10	19	0	3	22	0	0
6	16046850	.	G	A	10	9	19	0	2	21	0	0
6	16046934	.	A	C	16	12	28	0	2	30	0	0
6	16104448	.	G	T	5	5	10	0	0	10	0	0
6	16104463	.	T	C	7	6	13	0	1	14	0	0
6	16162994	.	G	A	1	0	1	0	0	1	0	0
6	16169641	.	G	A	0	5	5	0	0	5	0	0
6	16194568	.	G	A	1	1	2	0	0	2	0	0
6	16393459	.	G	T	5	7	12	0	0	12	0	0
6	16393518	.	G	A	5	8	13	0	0	13	0	0
6	16393816	.	G	C	3	5	8	0	0	8	0	0
6	16393890	.	C	G	4	5	9	0	0	9	0	0
6	16394004	.	G	A	4	2	6	0	0	6	0	0
6	16394018	.	C	T	5	2	7	0	0	7	0	0
6	16394244	.	A	G	2	2	4	0	0	4	0	0
6	16394341	.	A	T	1	2	3	0	0	3	0	0
6	16472394	.	G	T	0	3	3	0	1	4	0	0
6	16473889	.	C	G	2	0	2	0	5	7	0	0
6	16474107	.	G	A	1	2	3	0	0	3	0	0
6	16474381	.	T	C	4	13	17	0	0	17	0	0
6	16474853	.	T	C	4	4	8	0	0	8	0	0
6	16474879	.	T	C	3	5	8	0	0	8	0	0
6	16474948	.	T	C	6	4	10	0	1	11	0	0
6	16475047	.	T	A	4	12	16	0	0	16	0	0
6	16475269	.	C	G	4	12	16	0	0	17	1	0
6	16475395	.	A	C	5	4	9	0	0	9	0	0
6	16475559	.	T	A	4	3	7	0	0	7	0	0
6	16475611	.	A	C	1	0	1	0	0	1	0	0
6	16475728	.	G	A	1	3	4	0	6	10	0	0
6	16478198	.	C	A	0	9	9	0	8	17	0	0
6	16491056	.	G	A	18	8	26	0	0	26	0	0
6	16493381	.	A	T	16	15	31	0	1	32	0	0
6	16493415	.	T	C	24	17	41	0	2	43	0	0
6	16499260	.	A	G	7	3	10	0	0	10	0	0
6	16499311	.	C	T	5	6	11	0	0	11	0	0
6	16499428	.	G	A	6	9	15	0	0	15	0	0
6	16499473	.	G	C	3	8	11	0	0	11	0	0
6	16509980	.	G	A	12	8	20	0	0	20	0	0
6	16510064	.	T	G	3	6	9	0	4	13	0	0
6	16523788	.	G	A	1	0	1	0	0	1	0	0
6	16524067	.	A	G	2	6	8	0	0	8	0	0
6	16524468	.	G	T	2	6	8	0	1	9	0	0
6	16524618	.	C	G	2	3	5	0	0	5	0	0
6	16548741	.	T	C	1	3	4	0	0	4	0	0
6	16551826	.	G	A	1	1	2	0	0	2	0	0
6	16571935	.	G	A	2	3	5	0	0	5	0	0
6	16571947	.	G	T	4	3	7	0	0	7	0	0
6	16574890	.	C	G	2	2	4	0	0	4	0	0
6	16577229	.	C	T	0	1	1	0	2	3	0	0
6	16599048	.	A	G	1	1	2	0	1	3	0	0
6	16674296	.	A	G	6	11	17	0	0	17	0	0
6	16674344	.	T	A	13	10	23	0	1	24	0	0
6	16674371	.	T	C	11	6	17	0	3	20	0	0
6	16674435	.	A	C	12	10	22	0	1	23	0	0
6	16674618	.	G	A	9	13	22	0	1	23	0	0
6	16674808	.	T	C	1	6	7	0	3	10	0	0
6	16683385	.	T	C	3	5	8	0	1	9	0	0
6	16684004	.	A	G	5	5	10	0	0	10	0	0
6	16687429	.	C	A	12	8	20	0	1	21	0	0
6	16687432	.	T	A	13	7	20	0	0	20	0	0
6	16688900	.	T	C	1	5	6	0	0	6	0	0
6	16689083	.	G	A	1	1	2	0	0	2	0	0
6	16689416	.	T	A	7	6	13	0	0	13	0	0
6	16699616	.	G	A	2	6	8	0	0	8	0	0
6	16704848	.	T	C	1	2	3	0	0	3	0	0
6	16704876	.	G	A	2	1	3	0	0	3	0	0
6	17726127	.	T	A	1	2	3	0	0	3	0	0
6	18077210	.	G	A	0	2	2	0	0	2	0	0
6	18203782	.	C	A	14	24	38	0	1	39	0	0
6	18203974	.	A	T	1	4	5	0	1	6	0	0
6	18204420	.	A	G	9	13	22	0	0	22	0	0
6	18220141	.	G	A	1	3	4	0	0	4	0	0
6	18226653	.	T	G	10	7	17	0	0	17	0	0
6	18228324	.	G	A	8	4	12	0	0	12	0	0
6	18244834	.	C	T	2	3	5	0	0	5	0	0
6	18244879	.	A	T	2	4	6	0	0	6	0	0
6	18244987	.	C	T	1	5	6	0	0	6	0	0
6	18245385	.	G	A	11	9	20	0	1	21	0	0
6	18359376	.	C	T	9	7	16	0	0	16	0	0
6	18361359	.	A	T	7	5	12	0	1	13	0	0
6	18361444	.	C	G	17	9	26	0	1	27	0	0
6	18361609	.	T	C	6	6	12	0	1	13	0	0
6	18361729	.	G	C	8	5	13	0	2	15	0	0
6	18362043	.	T	G	6	0	6	0	4	10	0	0
6	18364051	.	A	T	2	2	4	0	0	4	0	0
6	18364081	.	G	A	0	2	2	0	2	4	0	0
6	18364090	.	T	C	2	2	4	0	0	4	0	0
6	18364543	.	A	T	3	8	11	0	0	11	0	0
6	18367758	.	C	T	1	2	3	0	0	3	0	0
6	18381543	.	T	G	1	2	3	0	1	4	0	0
6	18388387	.	T	G	4	6	10	0	0	10	0	0
6	18388517	.	G	C	2	9	11	0	0	11	0	0
6	18388569	.	C	T	3	9	12	0	0	12	0	0
6	18388835	.	C	A	6	12	18	0	0	18	0	0
6	18388975	.	G	A	5	8	13	0	0	13	0	0
6	18389220	.	G	A	6	9	15	0	0	15	0	0
6	18389324	.	T	C	10	1	11	0	9	20	0	0
6	18389541	.	C	T	12	8	20	0	0	20	0	0
6	18393826	.	A	T	1	0	1	0	1	2	0	0
6	18399981	.	C	T	0	6	6	0	0	6	0	0
6	18431063	.	A	C	1	2	3	0	0	3	0	0
6	18436500	.	C	T	1	4	5	0	0	5	0	0
6	18436880	.	C	A	4	3	7	0	1	8	0	0
6	18436966	.	G	A	7	10	17	0	0	17	0	0
6	18436969	.	T	C	6	9	15	0	1	16	0	0
6	18438322	.	C	G	0	1	1	0	0	1	0	0
6	18439222	.	C	T	12	9	21	0	1	22	0	0
6	18439256	.	C	A	6	10	16	0	0	16	0	0
6	18439540	.	G	A	7	8	15	0	0	15	0	0
6	18439683	.	C	T	8	9	17	0	1	18	0	0
6	18520930	.	T	A	13	10	23	0	1	24	0	0
6	18523549	.	C	A	12	11	23	0	0	23	0	0
6	18523770	.	A	T	6	14	20	0	1	21	0	0
6	18523772	.	C	G	14	6	20	0	1	21	0	0
6	18523817	.	T	A	12	5	17	0	0	17	0	0
6	18523895	.	C	G	1	3	4	0	0	4	0	0
6	18524579	.	A	G	3	10	13	0	1	14	0	0
6	18526432	.	A	G	1	3	4	0	0	4	0	0
6	18526754	.	G	T	3	0	3	0	0	3	0	0
6	18529148	.	G	T	1	0	1	0	0	1	0	0
6	18531296	.	T	G	3	3	6	0	0	6	0	0
6	18532445	.	A	T	3	4	7	0	0	7	0	0
6	18536239	.	G	T	3	0	3	0	0	3	0	0
6	18540911	.	T	C	3	12	15	0	0	15	0	0
6	18540932	.	C	T	6	13	19	0	0	19	0	0
6	18543253	.	G	A	0	7	7	0	4	11	0	0
6	18543400	.	A	G	13	11	24	0	0	24	0	0
6	18543637	.	A	G	6	3	9	0	2	11	0	0
6	18543950	.	G	T	7	9	16	0	0	16	0	0
6	18544301	.	T	A	3	6	9	0	0	9	0	0
6	18554431	.	G	A	2	5	7	0	0	7	0	0
6	18554541	.	G	A	4	2	6	0	0	6	0	0
6	18554580	.	C	T	3	4	7	0	0	7	0	0
6	18554719	.	T	C	1	1	2	0	3	5	0	0
6	18554836	.	T	G	3	3	6	0	0	6	0	0
6	18555309	.	T	C	3	2	5	0	1	6	0	0
6	18557909	.	T	C	1	0	1	0	2	3	0	0
6	18569589	.	T	A	2	2	4	0	0	4	0	0
6	18578070	.	A	T	1	0	1	0	0	1	0	0
6	18584751	.	A	G	0	1	1	0	0	1	0	0
6	18584793	.	T	A	1	0	1	0	0	1	0	0
6	18585091	.	G	A	1	5	6	0	0	6	0	0
6	18585103	.	C	T	2	1	3	0	0	3	0	0
6	18588570	.	G	A	2	0	2	0	0	2	0	0
6	18589090	.	T	C	1	2	3	0	0	3	0	0
6	18594539	.	A	C	1	2	3	0	0	3	0	0
6	18594604	.	C	T	2	1	3	0	0	3	0	0
6	18594656	.	T	C	2	4	6	0	0	6	0	0
6	18594867	.	G	A	1	5	6	0	0	6	0	0
6	18595156	.	T	G	5	4	9	0	0	9	0	0
6	18606063	.	T	C	3	4	7	0	0	7	0	0
6	18606230	.	G	T	15	14	29	0	0	29	0	0
6	18607151	.	G	A	13	9	22	0	1	23	0	0
6	18607557	.	C	T	12	11	23	0	1	24	0	0
6	18612230	.	C	T	1	1	2	0	0	2	0	0
6	18617255	.	A	T	15	8	23	0	0	23	0	0
6	18618051	.	C	T	7	10	17	0	0	17	0	0
6	18654314	.	T	A	1	6	7	0	0	7	0	0
6	18715712	.	A	G	2	4	6	0	0	6	0	0
6	18716085	.	C	T	6	5	11	0	0	11	0	0
6	18716242	.	G	A	4	4	8	0	0	8	0	0
6	18716539	.	C	T	0	8	8	0	9	17	0	0
6	18716611	.	T	C	3	0	3	0	9	12	0	0
6	18716641	.	G	A	3	8	11	0	0	11	0	0
6	18718397	.	G	A	5	2	7	0	0	7	0	0
6	18718438	.	T	G	1	6	7	0	0	8	1	0
6	18718473	.	C	T	1	8	9	0	0	9	0	0
6	18718846	.	A	T	4	3	7	0	0	7	0	0
6	18718964	.	A	G	3	6	9	0	0	9	0	0
6	18721021	.	A	G	1	4	5	0	1	6	0	0
6	18721099	.	T	C	3	3	6	0	0	6	0	0
6	18724415	.	T	A	3	6	9	0	0	9	0	0
6	18725196	.	C	T	3	4	7	0	0	7	0	0
6	18725232	.	A	G	2	5	7	0	0	7	0	0
6	18725881	.	T	A	5	4	9	0	0	9	0	0
6	18728766	.	A	G	4	0	4	0	0	4	0	0
6	18731328	.	G	C	3	2	5	0	0	5	0	0
6	18731389	.	G	A	2	2	4	0	0	4	0	0
6	18736413	.	A	C	2	5	7	0	0	7	0	0
6	18736460	.	A	G	1	4	5	0	0	5	0	0
6	18737442	.	A	G	3	3	6	0	0	6	0	0
6	18737807	.	T	C	4	3	7	0	0	7	0	0
6	18738949	.	C	T	1	2	3	0	0	3	0	0
6	18738969	.	G	A	1	2	3	0	0	3	0	0
6	18936455	.	T	C	8	0	8	0	4	12	0	0
6	18958920	.	C	T	1	0	1	0	2	3	0	0
6	19265802	.	C	A	2	2	4	0	0	4	0	0
6	19266732	.	C	T	0	3	3	0	0	3	0	0
6	19271131	.	A	T	1	1	2	0	0	2	0	0
6	19295454	.	C	T	24	18	42	0	2	44	0	0
6	19295469	.	T	C	18	1	19	0	24	43	0	0
6	19295609	.	A	T	11	7	18	0	2	20	0	0
6	19295625	.	T	A	12	13	25	0	1	26	0	0
6	19295644	.	C	T	2	12	14	0	13	27	0	0
6	19327380	.	C	T	4	4	8	0	0	8	0	0
6	19331045	.	G	A	1	0	1	0	0	1	0	0
6	19334678	.	G	C	0	3	3	0	0	3	0	0
6	19334715	.	C	T	0	2	2	0	3	5	0	0
6	19334722	.	A	C	3	2	5	0	0	5	0	0
6	19334899	.	A	G	6	3	9	0	0	9	0	0
6	19334948	.	A	T	3	2	5	0	0	5	0	0
6	19334949	.	C	A	3	2	5	0	0	5	0	0
6	19344846	.	C	T	6	10	16	0	1	17	0	0
6	19344862	.	T	C	9	5	14	0	0	14	0	0
6	19344930	.	G	C	6	6	12	0	1	13	0	0
6	19345191	.	G	A	5	3	8	0	0	8	0	0
6	19347426	.	C	T	1	7	8	0	7	15	0	0
6	19378992	.	G	A	8	7	15	0	0	15	0	0
6	19381816	.	T	G	2	3	5	0	0	5	0	0
6	19381856	.	C	T	4	2	6	0	1	7	0	0
6	19384199	.	C	T	2	2	4	0	0	4	0	0
6	19384208	.	A	T	2	2	4	0	0	4	0	0
6	19715552	.	G	A	0	4	4	0	4	8	0	0
6	19802042	.	T	C	9	7	16	0	0	16	0	0
6	19802145	.	G	T	0	6	6	0	9	15	0	0
6	19802148	.	C	A	9	5	14	0	1	15	0	0
6	19802242	.	C	T	16	5	21	0	0	21	0	0
6	19802330	.	G	A	8	8	16	0	1	17	0	0
6	19802354	.	G	A	6	7	13	0	0	13	0	0
6	19802415	.	G	A	0	2	2	0	5	7	0	0
6	19804702	.	A	C	4	5	9	0	0	9	0	0
6	19804878	.	C	T	2	3	5	0	0	5	0	0
6	19806990	.	C	T	5	2	7	0	0	7	0	0
6	19807126	.	T	A	3	3	6	0	0	6	0	0
6	19807482	.	A	G	3	3	6	0	0	6	0	0
6	19807599	.	A	T	5	1	6	1	1	8	0	0
6	19808670	.	C	T	2	4	6	0	0	6	0	0
6	19808818	.	G	A	6	5	11	0	0	11	0	0
6	20766299	.	G	A	15	14	29	0	0	29	0	0
6	20766307	.	A	G	10	14	24	0	2	26	0	0
6	20766352	.	C	T	9	13	22	0	0	22	0	0
6	20766500	.	G	T	12	8	20	0	0	20	0	0
6	20766565	.	C	G	0	9	9	0	13	22	0	0
6	20767015	.	T	A	19	14	33	0	1	34	0	0
6	20767167	.	C	A	6	15	21	0	0	21	0	0
6	20767502	.	A	G	12	23	35	0	1	36	0	0
6	20767575	.	G	C	19	0	19	0	18	37	0	0
6	20767830	.	T	G	13	3	16	0	0	16	0	0
6	20767910	.	A	G	3	4	7	0	0	7	0	0
6	20767958	.	T	G	7	6	13	0	0	13	0	0
6	20768076	.	C	A	6	6	12	0	1	13	0	0
6	20768107	.	A	T	10	9	19	0	1	20	0	0
6	20768338	.	G	A	20	10	30	0	0	30	0	0
6	20768346	.	T	G	20	8	28	0	1	29	0	0
6	20768407	.	A	T	7	7	14	0	0	14	0	0
6	20768558	.	C	G	1	0	1	0	0	1	0	0
6	20773961	.	G	A	24	12	36	0	1	37	0	0
6	20774048	.	A	C	18	18	36	0	2	38	0	0
6	20774701	.	G	A	5	3	8	0	1	9	0	0
6	20774752	.	G	A	9	19	28	0	0	28	0	0
6	20774768	.	C	T	13	7	20	0	2	22	0	0
6	20910625	.	C	T	4	4	8	0	0	8	0	0
6	20910627	.	A	C	3	4	7	0	1	8	0	0
6	20910713	.	G	T	8	4	12	0	0	12	0	0
6	20910759	.	A	T	6	3	9	0	1	10	0	0
6	20910830	.	T	C	2	5	7	0	2	9	0	0
6	20910880	.	G	A	4	4	8	0	3	11	0	0
6	20910898	.	A	G	5	0	5	0	6	11	0	0
6	20917730	.	A	T	4	5	9	0	1	10	0	0
6	20917780	.	T	A	9	5	14	0	0	14	0	0
6	20917921	.	G	A	4	8	12	0	3	15	0	0
6	20917922	.	A	C	3	11	14	0	1	15	0	0
6	20918418	.	G	T	8	7	15	0	1	16	0	0
6	20918431	.	C	A	8	5	13	0	1	14	0	0
6	20918456	.	C	A	2	7	9	0	0	9	0	0
6	20921859	.	G	A	3	5	8	0	0	8	0	0
6	20921919	.	G	A	6	2	8	0	1	9	0	0
6	20922316	.	G	C	4	0	4	0	3	7	0	0
6	20922330	.	G	A	3	3	6	0	2	8	0	0
6	20922396	.	G	A	7	5	12	0	0	12	0	0
6	20922468	.	G	A	2	3	5	0	0	5	0	0
6	20965780	.	A	G	3	1	4	0	3	7	0	0
6	20969124	.	A	T	3	4	7	0	0	7	0	0
6	20969126	.	G	T	3	4	7	0	0	7	0	0
6	20976263	.	A	G	1	0	1	0	0	1	0	0
6	20977715	.	T	C	0	1	1	0	0	1	0	0
6	20978972	.	C	T	0	2	2	0	0	2	0	0
6	20979015	.	C	T	4	2	6	0	0	6	0	0
6	20986906	.	C	G	0	0	0	0	3	3	0	0
6	20995800	.	A	G	5	4	9	0	1	10	0	0
6	20996640	.	C	T	14	7	21	0	0	21	0	0
6	20997031	.	A	T	10	7	17	0	0	17	0	0
6	21116134	.	C	G	0	1	1	0	0	1	0	0
6	21119574	.	C	T	2	7	9	0	0	9	0	0
6	21119598	.	C	T	6	2	8	0	0	8	0	0
6	21119910	.	G	A	1	3	4	0	0	4	0	0
6	21119914	.	A	G	1	3	4	0	0	4	0	0
6	21119949	.	T	C	1	4	5	0	0	5	0	0
6	21120080	.	A	G	3	4	7	0	1	8	0	0
6	21120193	.	T	C	5	7	12	0	0	12	0	0
6	21120261	.	C	T	3	9	12	0	3	15	0	0
6	21121977	.	T	C	0	1	1	0	0	1	0	0
6	21121986	.	G	C	0	2	2	0	0	2	0	0
6	21131414	.	C	A	2	4	6	0	0	6	0	0
6	21131504	.	G	A	6	4	10	0	0	10	0	0
6	21135702	.	G	A	1	1	2	0	1	3	0	0
6	21138740	.	T	C	1	0	1	0	0	1	0	0
6	21138869	.	C	T	5	3	8	0	0	8	0	0
6	21138870	.	T	G	5	3	8	0	0	8	0	0
6	21140553	.	G	T	3	2	5	0	0	5	0	0
6	21143041	.	C	A	0	1	1	0	0	1	0	0
6	21143417	.	C	A	1	3	4	0	1	5	0	0
6	21143685	.	C	T	0	2	2	0	1	3	0	0
6	21144233	.	G	A	2	7	9	0	0	9	0	0
6	21144245	.	C	T	5	2	7	0	0	7	0	0
6	21146252	.	C	T	3	11	14	0	0	14	0	0
6	21146549	.	G	T	9	4	13	0	1	14	0	0
6	21146633	.	G	A	11	7	18	0	1	19	0	0
6	21146648	.	G	A	11	8	19	0	1	20	0	0
6	21146813	.	T	G	3	0	3	0	9	12	0	0
6	21147332	.	T	A	9	9	18	0	0	18	0	0
6	21147334	.	T	A	9	9	18	0	0	18	0	0
6	21147837	.	A	G	6	5	11	0	2	13	0	0
6	21147920	.	A	C	3	9	12	0	0	12	0	0
6	21148166	.	A	T	6	5	11	0	2	13	0	0
6	21148167	.	T	C	7	5	12	0	1	13	0	0
6	21148367	.	G	A	5	4	9	0	0	9	0	0
6	21148393	.	T	A	4	3	7	0	1	8	0	0
6	21148736	.	T	A	1	2	3	0	0	3	0	0
6	21148737	.	A	T	1	2	3	0	0	3	0	0
6	21148972	.	G	C	1	1	2	0	0	2	0	0
6	21149353	.	G	C	0	4	4	0	3	7	0	0
6	21149383	.	A	T	6	6	12	0	0	12	0	0
6	21150672	.	G	A	10	14	24	0	1	25	0	0
6	21150712	.	A	T	14	16	30	0	2	32	0	0
6	21150772	.	A	T	19	17	36	0	0	36	0	0
6	21150872	.	C	T	14	23	37	0	3	40	0	0
6	21151474	.	C	T	9	2	11	0	0	11	0	0
6	21151664	.	T	G	5	6	11	0	2	13	0	0
6	21151751	.	C	T	19	6	25	0	0	25	0	0
6	21376635	.	T	G	0	2	2	0	0	2	0	0
6	21391499	.	T	A	3	5	8	0	0	8	0	0
6	21391752	.	A	C	4	2	6	0	0	6	0	0
6	21391753	.	A	C	4	2	6	0	0	6	0	0
6	21391810	.	T	A	1	2	3	0	0	3	0	0
6	21392049	.	A	T	6	6	12	0	0	12	0	0
6	21392057	.	C	A	6	2	8	0	3	11	0	0
6	21428926	.	A	G	1	0	1	0	4	5	0	0
6	21454984	.	C	A	2	9	11	0	0	11	0	0
6	21513767	.	G	T	6	2	8	0	1	9	0	0
6	21513778	.	A	G	2	8	10	0	0	10	0	0
6	21513826	.	C	A	3	6	9	0	0	9	0	0
6	21514529	.	C	T	3	4	7	0	0	7	0	0
6	21514651	.	G	T	3	3	6	0	0	6	0	0
6	21514961	.	C	T	0	5	5	0	3	8	0	0
6	21515032	.	C	T	3	1	4	0	0	4	0	0
6	21515063	.	A	G	2	2	4	0	1	5	0	0
6	21515100	.	C	T	3	4	7	0	0	7	0	0
6	21515149	.	T	C	2	2	4	0	1	5	0	0
6	21526395	.	A	G	10	16	26	0	0	26	0	0
6	21526620	.	T	C	4	3	7	0	1	8	0	0
6	21526783	.	G	A	2	1	3	0	0	3	0	0
6	21529229	.	A	G	8	1	9	0	0	9	0	0
6	21529379	.	A	T	4	1	5	0	0	5	0	0
6	21529767	.	A	T	10	4	14	0	3	17	0	0
6	21532427	.	T	C	4	0	4	0	2	6	0	0
6	21570468	.	A	G	1	1	2	0	0	2	0	0
6	21576632	.	T	A	3	2	5	0	0	5	0	0
6	21588285	.	C	T	15	11	26	0	0	26	0	0
6	21589102	.	A	G	4	4	8	0	1	9	0	0
6	21589103	.	G	A	4	5	9	0	0	9	0	0
6	21589325	.	C	T	0	5	5	0	4	9	0	0
6	21602679	.	T	G	8	3	11	0	1	12	0	0
6	21615621	.	T	A	1	1	2	0	0	2	0	0
6	21693589	.	G	T	0	2	2	0	1	3	0	0
6	21693969	.	C	T	1	5	6	0	0	6	0	0
6	21694306	.	G	A	11	7	18	0	1	19	0	0
6	21694401	.	C	A	7	9	16	0	0	16	0	0
6	21694544	.	A	G	2	4	6	0	3	9	0	0
6	21694624	.	C	A	7	8	15	0	2	17	0	0
6	21700062	.	T	C	4	4	8	0	0	8	0	0
6	21700138	.	G	A	10	5	15	0	2	17	0	0
6	21700212	.	A	G	8	5	13	0	1	14	0	0
6	21700263	.	A	G	9	5	14	0	1	15	0	0
6	21703020	.	T	G	1	2	3	0	0	3	0	0
6	21710190	.	G	A	0	1	1	0	0	1	0	0
6	21710226	.	T	G	0	1	1	0	0	1	0	0
6	21716195	.	T	C	2	3	5	0	0	5	0	0
6	21811487	.	A	G	2	0	2	0	0	2	0	0
6	21815301	.	C	A	0	3	3	0	3	6	0	0
6	21815389	.	G	A	3	6	9	0	0	9	0	0
6	21830392	.	G	A	0	1	1	0	0	1	0	0
6	21861324	.	G	T	25	10	35	0	4	39	0	0
6	21861490	.	C	A	2	20	22	0	19	41	0	0
6	21861526	.	T	G	11	14	25	0	2	27	0	0
6	21861736	.	T	G	5	12	17	0	0	17	0	0
6	21861771	.	G	A	11	11	22	0	2	24	0	0
6	21861949	.	G	A	16	26	42	0	2	44	0	0
6	21862288	.	G	A	18	22	40	0	0	40	0	0
6	21862359	.	A	T	15	18	33	0	3	36	0	0
6	21862460	.	A	G	20	13	33	0	3	36	0	0
6	21871928	.	T	C	0	2	2	0	0	2	0	0
6	21871931	.	G	T	0	2	2	0	0	2	0	0
6	21875373	.	C	G	0	2	2	0	3	5	0	0
6	21875429	.	A	C	2	2	4	0	0	4	0	0
6	21875511	.	T	C	3	2	5	0	0	5	0	0
6	21875741	.	G	T	3	5	8	0	1	9	0	0
6	21875903	.	C	A	1	2	3	0	0	3	0	0
6	21876006	.	G	A	2	3	5	0	0	5	0	0
6	21876852	.	C	T	0	8	8	0	5	13	0	0
6	21877278	.	T	G	0	4	4	0	0	4	0	0
6	21877295	.	C	T	0	3	3	0	0	3	0	0
6	21878474	.	T	C	1	0	1	0	3	4	0	0
6	21880932	.	G	A	0	1	1	0	0	1	0	0
6	21993967	.	A	C	3	2	5	0	0	5	0	0
6	21996458	.	G	A	3	2	5	0	0	5	0	0
6	22026088	.	A	G	2	0	2	0	6	8	0	0
6	22026339	.	T	A	3	3	6	0	1	7	0	0
6	22026431	.	G	C	4	4	8	0	0	8	0	0
6	22026440	.	G	A	4	4	8	0	0	8	0	0
6	22026636	.	A	G	2	4	6	0	1	7	0	0
6	22026645	.	A	C	2	3	5	0	0	5	0	0
6	22026825	.	C	A	2	3	5	0	1	6	0	0
6	22027263	.	A	G	4	0	4	0	10	14	0	0
6	22030296	.	G	A	3	5	8	0	0	8	0	0
6	22034802	.	A	G	4	4	8	0	0	8	0	0
6	22034961	.	A	C	10	6	16	0	0	16	0	0
6	22034985	.	A	C	7	9	16	0	1	17	0	0
6	22035352	.	A	G	4	9	13	0	0	13	0	0
6	22035426	.	A	G	8	6	14	0	1	15	0	0
6	22035534	.	G	A	10	3	13	0	0	13	0	0
6	22037715	.	A	T	3	3	6	0	0	6	0	0
6	22037743	.	C	T	0	1	1	0	0	1	0	0
6	22052909	.	C	T	0	2	2	0	0	2	0	0
6	22055545	.	A	G	1	3	4	0	0	4	0	0
6	22062845	.	T	C	1	0	1	0	0	1	0	0
6	22101476	.	G	A	1	2	3	0	0	3	0	0
6	22105135	.	C	A	10	4	14	0	0	14	0	0
6	22105554	.	A	G	5	7	12	0	2	14	0	0
6	22112395	.	A	G	1	0	1	0	1	2	0	0
6	22112416	.	C	T	3	2	5	0	0	5	0	0
6	22118165	.	T	C	16	25	41	0	2	43	0	0
6	22118216	.	G	A	17	34	51	0	0	51	0	0
6	22118630	.	G	A	33	13	46	0	3	49	0	0
6	22118681	.	C	T	17	11	28	0	4	32	0	0
6	22118690	.	C	T	10	19	29	0	0	29	0	0
6	22118885	.	T	G	21	1	22	0	17	39	0	0
6	22119056	.	C	T	29	27	56	0	2	58	0	0
6	22119582	.	T	C	19	12	31	0	2	33	0	0
6	22119836	.	T	A	1	6	7	0	2	9	0	0
6	22119977	.	T	A	13	4	17	0	0	17	0	0
6	22120074	.	C	T	12	9	21	0	0	21	0	0
6	22120342	.	T	A	8	4	12	0	0	12	0	0
6	22120793	.	A	G	2	5	7	0	1	8	0	0
6	22120877	.	A	G	2	7	9	0	0	9	0	0
6	22127197	.	A	G	7	6	13	0	0	13	0	0
6	22128520	.	G	A	4	6	10	0	0	10	0	0
6	22128603	.	G	A	5	4	9	0	0	9	0	0
6	22134174	.	G	A	2	5	7	0	0	7	0	0
6	22134649	.	T	G	1	1	2	0	0	2	0	0
6	22137124	.	A	G	1	1	2	0	0	2	0	0
6	22137403	.	C	T	5	6	11	0	0	11	0	0
6	22330400	.	A	T	3	4	7	0	0	7	0	0
6	22333884	.	A	T	3	4	7	0	0	7	0	0
6	22338938	.	A	G	5	3	8	0	2	10	0	0
6	22344003	.	A	T	8	5	13	0	0	13	0	0
6	22344452	.	C	T	12	8	20	0	0	20	0	0
6	22347259	.	G	A	14	10	24	0	2	26	0	0
6	22348271	.	T	A	15	15	30	0	1	31	0	0
6	22348274	.	G	C	14	13	27	0	3	31	1	0
6	22351770	.	A	C	22	23	45	0	1	46	0	0
6	22352229	.	T	C	3	14	17	0	3	20	0	0
6	22352370	.	C	T	3	10	13	0	1	14	0	0
6	22354738	.	C	A	0	1	1	0	0	1	0	0
6	22355040	.	T	C	0	1	1	0	0	1	0	0
6	22363740	.	A	T	2	1	3	0	0	3	0	0
6	22463151	.	A	G	2	1	3	0	0	3	0	0
6	22519663	.	A	T	1	3	4	0	0	4	0	0
6	22628997	.	T	G	6	0	6	0	8	14	0	0
6	22683362	.	A	G	6	4	10	0	0	10	0	0
6	22980251	.	T	C	3	4	7	0	0	7	0	0
6	22986191	.	A	C	2	2	4	0	0	4	0	0
6	22986242	.	T	G	1	0	1	0	0	1	0	0
6	22988839	.	T	C	5	5	10	0	0	10	0	0
6	22998568	.	G	T	1	3	4	0	0	4	0	0
6	22998590	.	C	T	0	4	4	0	7	11	0	0
6	22998625	.	A	G	7	2	9	0	0	9	0	0
6	22998653	.	C	A	1	1	2	0	1	3	0	0
6	23001656	.	G	T	1	4	5	0	0	6	1	0
6	23001704	.	C	T	8	7	15	0	0	15	0	0
6	23010431	.	T	C	2	2	4	0	0	4	0	0
6	23010479	.	T	A	2	2	4	0	0	4	0	0
6	23010502	.	T	A	1	2	3	0	0	3	0	0
6	23010957	.	G	A	1	3	4	0	0	4	0	0
6	23010975	.	A	C	1	2	3	0	0	3	0	0
6	23018861	.	G	A	1	1	2	0	1	3	0	0
6	23053296	.	A	G	6	8	14	0	0	14	0	0
6	23053393	.	C	A	18	9	27	0	1	28	0	0
6	23053482	.	G	C	9	5	14	0	1	15	0	0
6	23053761	.	A	G	7	10	17	0	0	17	0	0
6	23053824	.	T	C	6	10	16	0	0	16	0	0
6	23053968	.	A	G	12	9	21	0	0	21	0	0
6	23053980	.	A	T	14	13	27	0	0	27	0	0
6	23054266	.	C	T	10	18	28	0	0	28	0	0
6	23054267	.	A	G	16	7	23	0	5	28	0	0
6	23054334	.	A	T	10	11	21	0	4	25	0	0
6	23054403	.	A	G	6	7	13	0	1	14	0	0
6	23054404	.	A	G	7	6	13	0	1	14	0	0
6	23054569	.	C	T	8	13	21	0	2	23	0	0
6	23054705	.	A	G	3	0	3	0	8	11	0	0
6	23107785	.	A	C	3	5	8	0	0	8	0	0
6	23125548	.	G	A	0	5	5	0	4	9	0	0
6	23138066	.	C	A	1	2	3	0	0	3	0	0
6	23617815	.	C	T	2	2	4	0	1	5	0	0
6	23620940	.	C	A	4	3	7	0	0	7	0	0
6	23752615	.	G	A	0	3	3	0	5	8	0	0
6	23752775	.	G	A	1	3	4	0	2	6	0	0
6	23781314	.	C	T	3	8	11	0	0	11	0	0
6	23810518	.	T	C	4	1	5	0	0	5	0	0
6	23810922	.	G	C	3	2	5	0	0	5	0	0
6	23811154	.	C	T	6	9	15	0	0	15	0	0
6	23812885	.	T	C	15	21	36	0	0	36	0	0
6	23813361	.	G	A	1	14	15	0	20	35	0	0
6	23813437	.	G	C	20	13	33	0	0	33	0	0
6	23813554	.	C	A	15	20	35	0	1	36	0	0
6	23901323	.	C	T	1	2	3	0	0	3	0	0
6	23901377	.	T	C	2	2	4	0	1	5	0	0
6	23938676	.	A	C	8	7	15	0	0	15	0	0
6	23938738	.	A	G	4	6	10	0	0	10	0	0
6	23938829	.	G	A	6	3	9	0	0	9	0	0
6	24056103	.	C	T	0	10	10	0	7	17	0	0
6	24056319	.	T	C	3	4	7	0	0	7	0	0
6	24065975	.	C	G	0	3	3	0	2	5	0	0
6	24066296	.	G	A	4	11	15	0	0	15	0	0
6	24066382	.	T	A	6	9	15	0	1	16	0	0
6	24066611	.	G	A	9	12	21	0	0	21	0	0
6	24153075	.	G	A	23	24	47	0	1	48	0	0
6	24153114	.	A	G	31	22	53	0	0	53	0	0
6	24153159	.	C	T	21	29	50	0	1	51	0	0
6	24153297	.	T	C	19	28	47	0	2	49	0	0
6	24155357	.	C	T	20	27	47	0	2	49	0	0
6	24155442	.	A	T	21	15	36	0	0	36	0	0
6	24155459	.	T	G	22	11	33	0	2	35	0	0
6	24155744	.	T	C	14	12	26	0	0	26	0	0
6	24156027	.	T	C	22	14	36	0	2	38	0	0
6	24156219	.	T	C	9	0	9	0	13	22	0	0
6	24156344	.	T	G	11	6	17	0	1	18	0	0
6	24156399	.	C	G	13	4	17	0	2	19	0	0
6	24156428	.	A	T	12	11	23	0	1	24	0	0
6	24156476	.	T	G	6	16	22	0	0	22	0	0
6	24156567	.	T	C	12	2	14	0	12	26	0	0
6	24158601	.	T	C	6	0	6	0	12	18	0	0
6	24163448	.	C	T	4	1	5	0	0	5	0	0
6	24163535	.	A	C	0	2	2	0	0	2	0	0
6	24329685	.	C	T	5	5	10	1	0	11	0	0
6	24330029	.	C	T	19	8	27	0	0	27	0	0
6	24330196	.	G	A	23	21	44	0	0	44	0	0
6	24330229	.	G	A	15	14	29	0	1	30	0	0
6	24338496	.	T	A	20	11	31	0	2	33	0	0
6	24338526	.	G	A	11	12	23	0	0	23	0	0
6	24340631	.	G	A	6	1	7	0	0	7	0	0
6	24340688	.	G	T	11	3	14	0	0	14	0	0
6	24349237	.	T	C	8	5	13	0	0	13	0	0
6	24358323	.	A	T	4	3	7	0	0	7	0	0
6	24358596	.	G	A	6	12	18	0	2	20	0	0
6	24358720	.	C	T	1	3	4	0	1	5	0	0
6	24364750	.	C	T	1	2	3	0	0	3	0	0
6	24365102	.	C	G	5	3	8	0	0	8	0	0
6	24365276	.	C	A	13	8	21	0	0	21	0	0
6	24365453	.	G	A	5	3	8	0	0	8	0	0
6	24365838	.	G	A	6	9	15	0	0	15	0	0
6	24384613	.	T	C	7	8	15	0	0	15	0	0
6	24389518	.	A	T	0	4	4	0	0	4	0	0
6	24392318	.	C	T	7	7	14	0	0	14	0	0
6	24392498	.	G	A	2	3	5	0	0	5	0	0
6	24392562	.	T	C	2	0	2	0	10	12	0	0
6	24392732	.	T	C	3	3	6	0	0	6	0	0
6	24568341	.	G	A	0	3	3	0	1	4	0	0
6	24681529	.	C	T	4	2	6	0	0	6	0	0
6	24681563	.	G	A	4	5	9	0	0	9	0	0
6	24682720	.	T	A	6	8	14	0	3	17	0	0
6	24682913	.	A	T	9	9	18	0	0	18	0	0
6	24682950	.	G	A	8	8	16	0	0	16	0	0
6	24683723	.	A	T	8	6	14	0	0	14	0	0
6	24690886	.	A	G	1	1	2	0	0	2	0	0
6	24691366	.	C	T	10	7	17	0	1	18	0	0
6	24691600	.	A	T	3	3	6	0	0	6	0	0
6	24691718	.	A	T	7	5	12	0	0	12	0	0
6	24691845	.	A	T	9	8	17	0	0	17	0	0
6	24692075	.	G	A	4	2	6	0	0	6	0	0
6	24692168	.	G	A	1	2	3	0	1	4	0	0
6	24692307	.	A	G	9	5	14	0	0	14	0	0
6	24697891	.	T	G	4	6	10	0	0	10	0	0
6	24698036	.	A	G	2	0	2	0	2	4	0	0
6	25158083	.	G	T	1	2	3	0	0	3	0	0
6	25161789	.	A	T	1	2	3	0	0	3	0	0
6	25168647	.	G	C	5	5	10	0	0	10	0	0
6	25169241	.	A	T	3	2	5	0	0	5	0	0
6	25170438	.	T	C	7	4	11	0	1	12	0	0
6	25170579	.	A	G	8	3	11	0	0	11	0	0
6	25170743	.	G	A	4	4	8	0	1	9	0	0
6	25171078	.	T	A	4	2	6	0	1	7	0	0
6	25171100	.	A	G	3	4	7	0	1	8	0	0
6	25171285	.	A	G	10	4	14	0	0	14	0	0
6	25171940	.	A	G	4	4	8	0	0	8	0	0
6	25172176	.	A	T	3	6	9	0	0	9	0	0
6	25173005	.	G	A	4	5	9	0	0	9	0	0
6	25173026	.	A	G	7	6	13	0	0	13	0	0
6	25174178	.	T	C	3	0	3	0	3	6	0	0
6	25261426	.	T	A	1	3	4	0	0	4	0	0
6	25264512	.	C	T	0	1	1	0	0	1	0	0
6	25265306	.	G	A	1	2	3	0	1	4	0	0
6	25266242	.	G	A	0	5	5	0	1	6	0	0
6	25266275	.	C	T	1	2	3	0	0	3	0	0
6	27220317	.	C	T	12	14	26	0	3	29	0	0
6	27221029	.	T	C	2	8	10	0	0	10	0	0
6	27231706	.	G	A	0	5	5	0	1	6	0	0
6	27232880	.	T	C	5	4	9	0	1	10	0	0
6	27234032	.	T	G	5	3	8	0	0	8	0	0
6	27234250	.	C	T	4	10	14	0	0	14	0	0
6	27260541	.	A	G	15	0	15	0	10	25	0	0
6	27265350	.	T	C	11	9	20	0	1	21	0	0
6	27265434	.	C	T	3	2	5	0	0	5	0	0
6	27269268	.	G	A	17	16	33	0	0	33	0	0
6	27269425	.	G	A	0	15	15	0	24	39	0	0
6	27269612	.	T	A	10	17	27	0	1	28	0	0
6	27269662	.	A	T	16	17	33	0	1	34	0	0
6	27269674	.	C	T	18	18	36	0	0	36	0	0
6	27269862	.	G	A	0	19	19	0	19	38	0	0
6	27269902	.	T	A	20	20	40	0	0	40	0	0
6	27270147	.	G	A	7	12	19	0	0	19	0	0
6	27270288	.	A	C	13	15	28	0	2	30	0	0
6	27270346	.	T	C	11	11	22	0	1	23	0	0
6	27270449	.	G	A	12	5	17	1	1	19	0	0
6	27270548	.	G	A	20	18	38	0	2	40	0	0
6	27270664	.	T	A	22	19	41	0	1	42	0	0
6	27270738	.	A	G	16	0	16	0	18	34	0	0
6	27270959	.	C	A	9	16	25	0	2	27	0	0
6	27271114	.	A	G	31	0	31	0	20	51	0	0
6	27271115	.	A	T	30	19	49	0	2	51	0	0
6	27271409	.	G	A	21	14	35	0	0	35	0	0
6	27271443	.	G	A	22	23	45	0	0	45	0	0
6	27271543	.	C	T	18	23	41	0	0	41	0	0
6	27271610	.	A	T	14	14	28	0	0	28	0	0
6	27271617	.	G	A	17	11	28	0	1	29	0	0
6	27271968	.	A	G	45	8	53	0	1	54	0	0
6	27272205	.	G	C	25	21	46	0	0	46	0	0
6	27272364	.	T	A	30	20	50	0	0	50	0	0
6	27272373	.	A	T	28	19	47	0	1	48	0	0
6	27272440	.	C	T	19	21	40	0	1	41	0	0
6	27272555	.	T	C	21	32	53	0	3	56	0	0
6	27272623	.	A	G	19	36	55	0	2	58	1	0
6	27272660	.	C	G	20	31	51	0	1	52	0	0
6	27272835	.	G	T	22	16	38	0	1	39	0	0
6	27574472	.	G	A	3	1	4	0	0	4	0	0
6	27607528	.	C	T	1	4	5	0	0	5	0	0
6	27615210	.	G	A	0	2	2	0	1	3	0	0
6	27660420	.	C	T	0	1	1	0	0	1	0	0
6	27667378	.	C	A	17	15	32	0	0	32	0	0
6	27816260	.	T	C	13	6	19	0	1	20	0	0
6	27874309	.	T	C	18	19	37	0	1	38	0	0
6	27874487	.	G	A	30	19	49	0	3	52	0	0
6	27874529	.	G	A	0	25	25	0	22	47	0	0
6	27874591	.	T	A	21	21	42	0	2	44	0	0
6	27875383	.	G	T	29	23	52	0	3	55	0	0
6	27875519	.	G	T	22	19	41	0	2	43	0	0
6	27875555	.	C	T	17	27	44	0	4	48	0	0
6	27875598	.	T	C	0	26	26	0	1	27	0	0
6	27875600	.	A	C	25	0	25	0	2	27	0	0
6	27875876	.	T	G	25	22	47	0	2	49	0	0
6	27875941	.	C	G	23	25	48	0	2	50	0	0
6	27875944	.	G	A	0	27	27	0	23	50	0	0
6	27925110	.	G	T	2	2	4	0	0	4	0	0
6	27993450	.	A	T	2	2	4	0	0	4	0	0
6	27993735	.	T	C	0	3	3	0	0	3	0	0
6	27997333	.	C	T	8	5	13	0	2	15	0	0
6	27997528	.	A	G	0	4	4	0	0	4	0	0
6	27997662	.	C	A	1	2	3	0	0	3	0	0
6	27999287	.	C	A	2	1	3	0	0	3	0	0
6	28000316	.	G	A	0	10	10	0	2	12	0	0
6	28000597	.	A	C	3	4	7	0	0	7	0	0
6	28000768	.	G	T	7	6	13	0	1	14	0	0
6	28019315	.	G	A	0	1	1	0	0	1	0	0
6	28020204	.	T	C	2	2	4	0	0	4	0	0
6	28025129	.	A	C	2	1	3	0	0	3	0	0
6	28025189	.	A	G	0	0	0	0	2	2	0	0
6	28031468	.	G	A	0	2	2	0	0	2	0	0
6	28031474	.	T	C	0	1	1	0	0	1	0	0
6	28031610	.	T	A	0	2	2	0	0	2	0	0
6	28033036	.	C	T	2	2	4	0	1	5	0	0
6	28033174	.	G	C	0	1	1	0	0	1	0	0
6	28033221	.	T	A	1	2	3	0	0	3	0	0
6	28035197	.	G	A	0	6	6	0	4	10	0	0
6	28036714	.	A	G	2	0	2	0	1	3	0	0
6	28044308	.	C	T	2	1	3	0	0	3	0	0
6	28044398	.	C	T	5	3	8	0	0	8	0	0
6	28044401	.	A	G	3	5	8	0	0	8	0	0
6	28049173	.	A	C	5	3	8	0	0	8	0	0
6	28049185	.	G	A	0	3	3	0	5	8	0	0
6	28125013	.	T	A	2	2	4	0	0	4	0	0
6	28125028	.	G	A	1	2	3	0	0	3	0	0
6	28209177	.	C	T	1	2	3	0	0	3	0	0
6	28216496	.	G	A	3	6	9	0	3	12	0	0
6	28216535	.	C	T	9	18	27	0	1	28	0	0
6	28217058	.	C	G	3	2	5	0	0	5	0	0
6	28217103	.	T	C	5	0	5	0	10	15	0	0
6	28217674	.	T	C	5	0	5	0	3	8	0	0
6	28218159	.	G	T	9	8	17	0	0	17	0	0
6	28218367	.	G	A	10	4	14	0	1	15	0	0
6	28218555	.	T	G	5	12	17	0	2	19	0	0
6	28223810	.	C	A	1	3	4	0	0	4	0	0
6	28223834	.	T	A	2	2	4	0	0	4	0	0
6	28687752	.	G	A	1	2	3	0	0	3	0	0
6	28687784	.	A	T	1	2	3	0	0	3	0	0
6	28687792	.	A	T	1	2	3	0	0	3	0	0
6	28689103	.	T	C	1	2	3	0	0	3	0	0
6	28914336	.	C	T	7	4	11	0	0	11	0	0
6	28914790	.	G	A	15	5	20	0	0	20	0	0
6	28914975	.	T	A	10	6	16	0	1	17	0	0
6	28915342	.	T	G	7	8	15	0	0	15	0	0
6	28929960	.	A	G	6	0	6	0	1	7	0	0
6	28931649	.	A	G	7	6	13	0	0	13	0	0
6	28934498	.	A	G	0	2	2	0	0	2	0	0
6	28946048	.	A	T	11	22	33	0	3	36	0	0
6	28956350	.	T	A	6	3	9	0	1	10	0	0
6	28957820	.	G	T	1	4	5	0	0	5	0	0
6	28961407	.	A	G	3	1	4	0	1	5	0	0
6	29011988	.	C	T	7	3	10	0	0	10	0	0
6	29012037	.	A	T	9	5	14	0	0	14	0	0
6	29034576	.	G	C	6	5	11	0	2	13	0	0
6	29039981	.	A	C	2	0	2	0	2	4	0	0
6	29040066	.	A	C	7	0	7	0	1	8	0	0
6	29040789	.	C	T	0	5	5	0	9	14	0	0
6	29040870	.	C	T	0	1	1	0	4	5	0	0
6	29040885	.	C	T	0	1	1	0	3	4	0	0
6	29043162	.	T	G	3	3	6	0	0	6	0	0
6	29086676	.	A	T	4	4	8	0	0	8	0	0
6	29087164	.	T	G	1	1	2	0	1	3	0	0
6	29089480	.	T	A	12	16	28	0	0	28	0	0
6	29097297	.	G	A	18	15	33	0	4	37	0	0
6	29097344	.	T	C	9	6	15	0	1	16	0	0
6	29103419	.	G	A	3	9	12	0	0	12	0	0
6	29103470	.	T	C	3	6	9	0	3	12	0	0
6	29103551	.	C	A	0	6	6	0	3	9	0	0
6	29103722	.	T	C	5	0	5	0	4	9	0	0
6	29103749	.	T	C	3	5	8	0	0	8	0	0
6	29105698	.	C	T	3	3	6	0	0	6	0	0
6	29144941	.	A	C	6	2	8	0	0	8	0	0
6	29144943	.	C	A	6	2	8	0	0	8	0	0
6	29145433	.	C	A	0	7	7	0	5	12	0	0
6	29145742	.	T	A	1	5	6	0	0	6	0	0
6	29147764	.	C	T	3	1	4	0	1	5	0	0
6	29152334	.	G	A	3	3	6	0	0	6	0	0
6	29152466	.	T	C	1	0	1	0	0	1	0	0
6	29152618	.	A	G	1	2	3	0	0	3	0	0
6	29152669	.	A	G	5	5	10	0	0	10	0	0
6	29154193	.	C	T	4	2	6	0	0	6	0	0
6	29154295	.	T	C	9	0	9	0	5	14	0	0
6	29154496	.	A	G	7	6	13	0	1	14	0	0
6	29154601	.	T	C	5	0	5	0	4	9	0	0
6	29154721	.	G	A	3	5	8	0	0	8	0	0
6	29156573	.	A	C	3	6	9	0	1	10	0	0
6	29159735	.	C	T	3	3	6	0	4	10	0	0
6	29222796	.	A	C	8	15	23	0	0	23	0	0
6	29223513	.	G	A	0	0	0	0	2	2	0	0
6	29223651	.	T	C	4	6	10	0	1	11	0	0
6	29226126	.	G	A	0	15	15	0	12	27	0	0
6	29227149	.	A	G	19	15	34	0	6	42	2	0
6	29273690	.	C	T	2	0	2	0	0	2	0	0
6	29273855	.	G	A	4	1	5	0	0	5	0	0
6	29288121	.	A	G	6	6	12	0	0	12	0	0
6	29289386	.	G	A	0	3	3	0	0	3	0	0
6	29289437	.	G	A	2	2	4	0	0	4	0	0
6	29289844	.	A	T	3	3	6	0	1	7	0	0
6	29289883	.	C	T	4	4	8	0	0	8	0	0
6	29289905	.	G	A	4	2	6	0	0	6	0	0
6	29292610	.	A	C	1	5	6	0	0	6	0	0
6	29292651	.	A	G	3	7	10	0	2	12	0	0
6	29292804	.	G	A	7	3	10	0	0	10	0	0
6	29292849	.	G	T	8	3	11	0	0	11	0	0
6	29295388	.	T	A	5	5	10	0	0	10	0	0
6	29295414	.	A	T	7	6	13	0	1	14	0	0
6	29295713	.	C	A	1	7	8	0	10	18	0	0
6	29303573	.	C	T	9	13	22	0	2	24	0	0
6	29303625	.	G	A	8	11	19	0	1	20	0	0
6	29303863	.	T	A	7	16	23	0	1	24	0	0
6	29313312	.	C	A	8	8	16	0	0	16	0	0
6	29313607	.	A	T	10	13	23	0	2	25	0	0
6	29313679	.	A	G	5	11	16	0	0	16	0	0
6	29322029	.	T	C	3	0	3	0	4	7	0	0
6	29322547	.	G	A	4	4	8	0	1	9	0	0
6	29322595	.	C	G	1	2	3	0	1	4	0	0
6	29328308	.	G	A	3	11	14	0	0	14	0	0
6	29328524	.	A	G	6	6	12	0	0	12	0	0
6	29330676	.	G	A	6	4	10	0	0	10	0	0
6	29330727	.	A	G	6	3	9	0	0	9	0	0
6	29332582	.	A	G	2	4	6	0	1	7	0	0
6	29332588	.	T	C	2	4	6	0	1	7	0	0
6	29335675	.	G	A	6	9	15	0	0	15	0	0
6	29336100	.	T	C	0	1	1	0	0	1	0	0
6	29347514	.	G	A	1	4	5	0	0	5	0	0
6	29348152	.	T	A	2	3	5	0	0	5	0	0
6	29387493	.	G	A	8	5	13	0	0	13	0	0
6	29390565	.	A	G	3	3	6	0	0	6	0	0
6	29391718	.	T	C	1	1	2	0	0	2	0	0
6	29393533	.	T	A	2	6	8	0	0	8	0	0
6	29394244	.	A	T	4	3	7	0	0	7	0	0
6	29395297	.	C	T	10	11	21	0	0	21	0	0
6	29401837	.	T	C	3	4	7	0	0	7	0	0
6	29402220	.	C	T	8	7	15	0	0	15	0	0
6	29402451	.	C	A	0	6	6	0	3	9	0	0
6	29403076	.	C	T	20	9	29	0	1	30	0	0
6	29403550	.	G	A	4	5	9	0	0	9	0	0
6	29404094	.	T	C	10	13	23	0	2	25	0	0
6	29414883	.	T	G	0	1	1	0	0	1	0	0
6	29441055	.	G	A	0	2	2	0	1	3	0	0
6	29466452	.	A	G	3	2	5	0	1	6	0	0
6	29466466	.	A	T	2	3	5	0	0	5	0	0
6	29466588	.	T	A	6	2	8	0	1	9	0	0
6	29466980	.	A	G	3	2	5	0	0	5	0	0
6	29467231	.	C	A	2	2	4	0	0	4	0	0
6	29467251	.	G	A	5	1	6	0	0	6	0	0
6	29468013	.	T	C	3	2	5	0	0	5	0	0
6	29468320	.	C	T	5	4	9	0	0	9	0	0
6	29468331	.	A	T	4	4	8	0	0	8	0	0
6	29468551	.	A	T	3	2	5	0	0	5	0	0
6	29468556	.	T	G	4	2	6	0	0	6	0	0
6	29468671	.	A	G	6	2	8	0	0	8	0	0
6	29477093	.	T	A	4	5	9	0	1	10	0	0
6	29477094	.	T	C	4	5	9	0	1	10	0	0
6	29477164	.	A	C	5	2	7	0	0	7	0	0
6	29477188	.	C	T	2	4	6	0	0	6	0	0
6	29477739	.	C	T	2	8	10	0	2	12	0	0
6	29485253	.	T	C	1	0	1	0	0	1	0	0
6	29488695	.	A	G	3	2	5	0	0	5	0	0
6	29498150	.	A	T	1	2	3	0	0	3	0	0
6	29611905	.	T	C	5	0	5	0	3	8	0	0
6	29703846	.	A	C	3	5	8	0	1	9	0	0
6	29703865	.	A	T	1	4	5	0	0	5	0	0
6	29705343	.	C	T	3	6	9	0	0	9	0	0
6	29705709	.	T	A	5	10	15	0	1	16	0	0
6	29705710	.	T	C	4	10	14	0	2	16	0	0
6	29705767	.	A	G	9	9	18	0	0	18	0	0
6	29708010	.	T	C	2	2	4	0	0	4	0	0
6	29708073	.	A	C	4	8	12	0	1	13	0	0
6	29708100	.	C	T	2	2	4	0	0	4	0	0
6	29710111	.	C	T	2	2	4	0	0	4	0	0
6	29710157	.	A	G	5	0	5	0	9	14	0	0
6	29710216	.	C	T	8	5	13	0	0	13	0	0
6	29710252	.	T	C	4	3	7	0	0	7	0	0
6	29712410	.	C	T	3	1	4	0	0	4	0	0
6	29712420	.	C	A	3	3	6	0	0	6	0	0
6	29712470	.	T	C	9	8	17	0	0	17	0	0
6	29712651	.	G	A	1	6	7	0	0	7	0	0
6	29791206	.	C	G	13	6	19	0	0	19	0	0
6	29791310	.	A	C	5	8	13	0	0	13	0	0
6	29793798	.	C	A	13	9	22	0	0	22	0	0
6	29793814	.	C	T	9	12	21	0	1	22	0	0
6	29794042	.	G	A	4	5	9	0	2	11	0	0
6	29794639	.	T	C	31	29	60	0	1	61	0	0
6	29794695	.	T	C	26	28	54	0	2	56	0	0
6	30019954	.	C	T	8	4	12	0	1	13	0	0
6	30032574	.	A	G	15	0	15	0	9	24	0	0
6	30048285	.	A	G	3	0	3	0	4	7	0	0
6	30048421	.	G	A	0	8	8	0	8	16	0	0
6	30060296	.	C	T	15	29	44	0	1	45	0	0
6	30066414	.	A	T	1	2	3	0	0	3	0	0
6	30066428	.	G	C	0	2	2	0	0	2	0	0
6	30081420	.	C	T	15	11	26	0	2	28	0	0
6	30081421	.	T	C	15	11	26	0	2	28	0	0
6	30081503	.	A	G	19	29	48	0	0	48	0	0
6	30081725	.	C	T	18	20	38	0	1	39	0	0
6	30082255	.	G	A	11	10	21	0	0	21	0	0
6	30082752	.	T	G	15	19	34	0	0	34	0	0
6	30082838	.	G	T	13	14	27	0	1	28	0	0
6	30113800	.	C	T	4	5	9	0	1	10	0	0
6	30117495	.	G	A	0	1	1	0	0	1	0	0
6	30121872	.	G	T	5	0	5	0	1	6	0	0
6	30122248	.	A	T	4	2	6	0	0	6	0	0
6	30133958	.	G	T	10	15	25	0	8	33	0	0
6	30147219	.	G	A	8	5	13	0	0	13	0	0
6	30147831	.	C	T	7	4	11	0	0	11	0	0
6	30148056	.	A	T	11	12	23	0	2	25	0	0
6	30148143	.	G	A	11	9	20	0	3	23	0	0
6	30148182	.	G	A	7	15	22	0	2	24	0	0
6	30148863	.	T	C	16	8	24	0	1	25	0	0
6	30151519	.	G	A	9	11	20	0	4	24	0	0
6	30177635	.	G	A	1	3	4	0	1	5	0	0
6	30177724	.	G	A	1	2	3	0	0	3	0	0
6	30432467	.	G	A	0	2	2	0	1	3	0	0
6	30432477	.	C	A	1	2	3	0	0	3	0	0
6	30433337	.	T	A	1	2	3	0	0	3	0	0
6	30441333	.	G	A	6	3	9	0	0	9	0	0
6	30441536	.	G	A	3	4	7	0	0	7	0	0
6	30452316	.	T	C	5	4	9	0	0	9	0	0
6	30452562	.	A	T	1	8	9	0	0	9	0	0
6	30452811	.	C	T	1	3	4	0	0	4	0	0
6	30452932	.	G	C	0	3	3	0	1	4	0	0
6	30579379	.	C	T	1	2	3	0	1	4	0	0
6	30583746	.	A	G	2	0	2	0	0	2	0	0
6	30587201	.	T	A	2	3	5	0	0	5	0	0
6	30592556	.	T	C	1	2	3	0	0	3	0	0
6	30592558	.	A	T	1	2	3	0	0	3	0	0
6	30592593	.	A	T	2	1	3	0	0	3	0	0
6	30626227	.	A	G	10	8	18	0	0	18	0	0
6	30626240	.	A	T	10	10	20	0	0	20	0	0
6	30626276	.	T	C	11	10	21	0	2	23	0	0
6	30626630	.	T	G	6	10	16	0	2	18	0	0
6	30626715	.	T	G	17	11	28	0	4	32	0	0
6	30626765	.	C	T	22	5	27	0	0	27	0	0
6	30627182	.	T	A	7	9	16	0	0	16	0	0
6	30627228	.	A	C	12	18	30	0	0	30	0	0
6	30627292	.	T	C	17	15	32	0	4	36	0	0
6	30627605	.	G	C	19	10	29	0	0	29	0	0
6	30627606	.	A	C	18	0	18	0	11	29	0	0
6	30627674	.	G	T	19	6	25	0	1	26	0	0
6	30627744	.	C	T	21	10	31	0	1	32	0	0
6	30627764	.	G	T	21	6	27	0	0	27	0	0
6	30627811	.	T	C	17	4	21	0	0	21	0	0
6	30627914	.	T	C	15	8	23	0	0	23	0	0
6	30627921	.	G	T	15	8	23	0	1	24	0	0
6	30627996	.	A	C	4	0	4	0	4	8	0	0
6	30627998	.	T	C	4	0	4	0	4	8	0	0
6	30628097	.	C	T	11	8	19	0	0	19	0	0
6	30628170	.	T	C	1	7	8	0	0	8	0	0
6	30628228	.	A	G	3	2	5	0	0	5	0	0
6	30628848	.	C	T	5	10	15	0	2	17	0	0
6	30628922	.	T	C	8	6	14	0	1	15	0	0
6	30628976	.	T	A	10	8	18	0	0	18	0	0
6	30629229	.	T	A	5	3	8	0	2	10	0	0
6	30629303	.	T	A	5	5	10	0	0	10	0	0
6	30629317	.	C	A	3	3	6	0	1	7	0	0
6	30629384	.	T	C	5	1	6	0	6	12	0	0
6	30629459	.	A	G	3	3	6	0	1	7	0	0
6	30629553	.	C	T	0	5	5	0	9	14	0	0
6	30629827	.	C	A	3	6	9	0	0	9	0	0
6	30629850	.	G	C	3	2	5	0	1	6	0	0
6	30629865	.	A	C	3	1	4	0	1	5	0	0
6	30629912	.	A	T	2	2	4	0	1	5	0	0
6	30629935	.	T	C	5	0	5	0	5	10	0	0
6	30630017	.	C	T	0	2	2	0	3	5	0	0
6	30630057	.	G	A	6	2	8	0	2	10	0	0
6	30630438	.	G	A	4	8	12	0	0	12	0	0
6	30630811	.	T	C	13	7	20	0	0	20	0	0
6	30630904	.	A	G	4	6	10	0	0	10	0	0
6	30631021	.	T	C	10	3	13	0	0	13	0	0
6	30658545	.	G	A	9	8	17	0	0	18	1	0
6	30658728	.	A	C	4	8	12	0	0	12	0	0
6	30677093	.	C	T	1	4	5	0	1	6	0	0
6	30677582	.	T	C	6	4	10	0	1	11	0	0
6	30677602	.	A	T	5	7	12	0	0	12	0	0
6	30677701	.	C	T	2	2	4	0	6	10	0	0
6	30678279	.	T	G	1	5	6	0	2	8	0	0
6	30678406	.	C	A	3	2	5	0	1	6	0	0
6	30681208	.	C	T	0	1	1	0	0	1	0	0
6	30682141	.	A	G	1	0	1	0	0	1	0	0
6	30683382	.	G	A	2	2	4	0	0	4	0	0
6	30683571	.	T	A	4	4	8	0	1	9	0	0
6	30683578	.	T	C	4	6	10	0	0	10	0	0
6	30685027	.	T	C	6	2	8	0	0	8	0	0
6	30685044	.	A	G	5	2	7	0	0	7	0	0
6	30685078	.	A	T	6	5	11	0	0	11	0	0
6	30685632	.	A	G	3	4	7	0	0	7	0	0
6	30685644	.	A	T	3	2	5	0	0	5	0	0
6	30687858	.	T	C	2	2	4	0	0	4	0	0
6	30689024	.	C	T	0	3	3	0	2	5	0	0
6	30710270	.	A	G	21	19	40	0	2	42	0	0
6	30710313	.	C	A	18	22	40	0	2	42	0	0
6	30710342	.	T	G	16	21	37	0	1	38	0	0
6	30710351	.	G	T	16	18	34	0	4	38	0	0
6	30710457	.	C	T	24	13	37	0	0	37	0	0
6	30710460	.	T	G	20	12	32	0	3	35	0	0
6	30710496	.	T	A	15	7	22	0	0	22	0	0
6	30710516	.	T	A	16	5	21	0	0	21	0	0
6	30710544	.	C	T	13	4	17	0	0	17	0	0
6	30711554	.	C	T	0	10	10	0	24	34	0	0
6	30711777	.	C	T	18	12	30	0	0	30	0	0
6	30711779	.	G	A	18	12	30	0	0	30	0	0
6	30711844	.	A	G	10	17	27	0	0	27	0	0
6	30711851	.	T	C	10	17	27	0	1	28	0	0
6	30712265	.	T	C	9	13	22	0	0	22	0	0
6	30712455	.	A	T	4	12	16	0	0	16	0	0
6	30712616	.	C	T	0	5	5	0	12	17	0	0
6	30712622	.	A	G	10	6	16	0	1	17	0	0
6	30712917	.	G	A	18	8	26	0	2	28	0	0
6	30713296	.	C	T	7	12	19	0	0	19	0	0
6	30713334	.	G	C	6	8	14	0	0	14	0	0
6	30713647	.	C	T	5	5	10	0	1	11	0	0
6	30713666	.	T	C	6	6	12	0	1	13	0	0
6	30713822	.	T	G	11	15	26	0	2	28	0	0
6	30713824	.	A	T	11	16	27	0	1	28	0	0
6	30713869	.	C	T	0	16	16	0	16	32	0	0
6	30713910	.	C	T	14	14	28	0	1	29	0	0
6	30714020	.	T	C	17	11	28	0	1	29	0	0
6	30714053	.	T	C	11	11	22	0	0	22	0	0
6	30714177	.	T	A	9	11	20	0	1	21	0	0
6	30715009	.	T	G	16	9	25	0	1	26	0	0
6	30715446	.	T	C	10	0	10	0	7	17	0	0
6	30717579	.	T	C	6	14	20	0	1	21	0	0
6	30717636	.	T	C	8	0	8	0	17	25	0	0
6	30719319	.	G	A	12	5	17	0	0	17	0	0
6	30719935	.	C	T	3	7	10	0	0	10	0	0
6	30740064	.	A	G	2	0	2	0	0	2	0	0
6	30740106	.	G	A	5	3	8	0	0	8	0	0
6	30740127	.	T	A	4	3	7	0	1	8	0	0
6	30740160	.	C	A	0	2	2	0	3	5	0	0
6	30742651	.	A	G	22	16	38	0	0	38	0	0
6	30747415	.	A	G	2	4	6	0	1	7	0	0
6	30761742	.	G	A	7	5	12	0	1	13	0	0
6	30761775	.	G	A	1	1	2	0	1	3	0	0
6	30851611	.	A	T	7	5	12	0	0	12	0	0
6	30855423	.	G	A	10	5	15	0	0	15	0	0
6	30868450	.	A	G	1	2	3	0	1	4	0	0
6	31069556	.	G	A	0	1	1	0	0	1	0	0
6	31069622	.	T	A	3	3	6	0	1	7	0	0
6	31069682	.	T	C	4	4	8	0	1	9	0	0
6	31069748	.	A	G	0	2	2	0	0	2	0	0
6	31146955	.	A	T	1	4	5	0	1	6	0	0
6	31184478	.	A	G	1	8	9	0	0	9	0	0
6	31184674	.	C	T	4	2	6	0	0	6	0	0
6	31184880	.	G	A	1	2	3	0	0	3	0	0
6	31184891	.	A	G	1	2	3	0	0	3	0	0
6	31184952	.	T	C	4	8	12	0	0	12	0	0
6	31185074	.	C	T	4	4	8	0	2	10	0	0
6	31185457	.	C	T	6	0	6	0	0	6	0	0
6	31185515	.	A	T	2	2	4	0	0	4	0	0
6	31185523	.	C	T	1	2	3	0	0	3	0	0
6	31185825	.	A	T	3	5	8	0	0	8	0	0
6	31186981	.	G	A	8	3	11	0	1	12	0	0
6	31187043	.	A	C	2	2	4	0	1	5	0	0
6	31187067	.	A	C	3	2	5	0	0	5	0	0
6	31198869	.	G	A	1	1	2	0	0	2	0	0
6	31198876	.	T	A	1	1	2	0	0	2	0	0
6	31219005	.	G	A	1	1	2	0	0	2	0	0
6	31279834	.	G	A	12	10	22	0	2	24	0	0
6	31280141	.	G	A	25	17	42	0	2	44	0	0
6	31280164	.	T	C	20	19	39	0	1	40	0	0
6	31280185	.	T	A	22	15	37	0	0	37	0	0
6	31280645	.	C	A	11	9	20	0	0	22	2	0
6	31280681	.	C	A	8	8	16	0	0	16	0	0
6	31280735	.	T	G	6	18	24	0	0	24	0	0
6	31280741	.	G	A	7	19	26	0	2	28	0	0
6	31280936	.	A	T	7	14	21	0	1	22	0	0
6	31280945	.	A	T	7	14	21	0	1	22	0	0
6	31281282	.	G	A	17	17	34	0	2	36	0	0
6	31281304	.	C	A	21	19	40	0	1	41	0	0
6	31281533	.	T	A	8	12	20	0	0	20	0	0
6	31281537	.	A	G	6	10	16	0	2	18	0	0
6	31281594	.	A	T	8	9	17	0	1	18	0	0
6	31281674	.	T	C	11	9	20	0	1	21	0	0
6	31281694	.	C	T	9	3	12	0	2	14	0	0
6	31281732	.	T	A	12	10	22	0	0	22	0	0
6	31282205	.	C	T	7	5	12	0	1	13	0	0
6	31282399	.	T	C	6	8	14	0	0	14	0	0
6	31282494	.	C	T	15	12	27	0	0	27	0	0
6	31282835	.	A	G	4	3	7	0	0	7	0	0
6	31283055	.	G	A	10	11	21	0	0	21	0	0
6	31283180	.	C	T	8	7	15	0	1	16	0	0
6	31283191	.	T	C	9	5	14	0	3	17	0	0
6	31283245	.	A	G	12	8	20	0	1	21	0	0
6	31283280	.	T	A	7	3	10	0	2	12	0	0
6	31283299	.	G	A	11	6	17	0	0	17	0	0
6	31285874	.	G	A	10	9	19	0	1	20	0	0
6	31288637	.	C	G	4	4	8	0	0	8	0	0
6	31288642	.	C	G	0	5	5	0	4	9	0	0
6	31288742	.	T	C	12	1	13	0	20	33	0	0
6	31288894	.	T	A	10	9	19	0	0	19	0	0
6	31291030	.	G	A	7	3	10	0	0	10	0	0
6	31291033	.	C	A	7	5	12	0	0	12	0	0
6	31309823	.	C	T	0	2	2	0	4	6	0	0
6	31352298	.	T	A	13	8	21	0	1	22	0	0
6	31352339	.	T	A	10	8	18	0	0	19	1	0
6	31352406	.	C	A	11	10	21	0	1	22	0	0
6	31352555	.	T	C	7	7	14	0	0	14	0	0
6	31352556	.	G	A	7	7	14	0	0	14	0	0
6	31352635	.	T	G	2	6	8	0	0	8	0	0
6	31353022	.	G	C	16	12	28	0	0	28	0	0
6	31353094	.	T	C	8	0	8	0	9	17	0	0
6	31353112	.	G	A	9	9	18	0	1	19	0	0
6	31353345	.	T	A	9	12	21	0	0	21	0	0
6	31353451	.	A	T	10	9	19	0	1	20	0	0
6	31353613	.	G	A	5	7	12	0	3	15	0	0
6	31355787	.	C	T	8	2	10	0	0	10	0	0
6	31358525	.	C	T	0	1	1	0	4	5	0	0
6	31368096	.	C	T	1	3	4	0	0	4	0	0
6	31394445	.	A	C	3	2	5	0	0	5	0	0
6	31394453	.	A	C	3	3	6	0	0	6	0	0
6	31395835	.	G	A	2	3	5	0	0	5	0	0
6	31405898	.	G	A	0	2	2	0	1	3	0	0
6	31405923	.	C	T	1	2	3	0	0	3	0	0
6	31411751	.	C	T	1	0	1	0	0	1	0	0
6	31414061	.	A	C	4	2	6	0	0	6	0	0
6	31416100	.	A	G	0	0	0	0	1	1	0	0
6	31419749	.	T	C	1	1	2	0	0	2	0	0
6	31426287	.	G	T	15	10	25	0	0	25	0	0
6	31426465	.	T	C	14	13	27	0	1	28	0	0
6	31426727	.	C	G	9	5	14	0	2	16	0	0
6	31426886	.	C	T	12	10	22	0	2	24	0	0
6	31426955	.	G	A	12	11	23	0	2	25	0	0
6	31427226	.	C	T	3	4	7	0	0	7	0	0
6	31427240	.	A	G	5	3	8	0	0	8	0	0
6	31427363	.	C	G	6	0	6	0	12	18	0	0
6	31427397	.	T	C	7	10	17	0	2	19	0	0
6	31427437	.	C	A	7	5	12	0	1	13	0	0
6	31427468	.	A	G	8	4	12	0	0	12	0	0
6	31427815	.	G	T	1	11	12	0	6	18	0	0
6	31427883	.	A	G	12	8	20	0	1	21	0	0
6	31428565	.	T	G	6	5	11	0	1	12	0	0
6	31428566	.	A	G	6	5	11	0	1	12	0	0
6	31428705	.	C	T	4	13	17	0	0	17	0	0
6	31428746	.	G	A	7	9	16	0	1	17	0	0
6	31430950	.	T	C	4	0	4	0	5	9	0	0
6	31431355	.	G	A	10	15	25	0	0	25	0	0
6	31431422	.	A	G	11	20	31	0	0	31	0	0
6	31431520	.	A	G	13	16	29	0	0	29	0	0
6	31431646	.	A	T	7	14	21	0	1	22	0	0
6	31431775	.	T	C	12	17	29	0	3	32	0	0
6	31431926	.	A	T	20	19	39	0	1	40	0	0
6	31432232	.	G	A	9	6	15	0	0	15	0	0
6	31432315	.	T	C	4	3	7	0	0	7	0	0
6	31432458	.	A	G	1	4	5	0	0	5	0	0
6	31432554	.	A	T	3	4	7	0	1	8	0	0
6	31432679	.	T	A	4	6	10	0	0	10	0	0
6	31432746	.	A	C	9	6	15	0	2	17	0	0
6	31432761	.	A	G	13	10	23	0	0	23	0	0
6	31433056	.	C	T	8	7	15	0	1	16	0	0
6	31433060	.	T	C	7	7	14	0	0	14	0	0
6	31433126	.	C	G	1	12	13	1	9	23	0	0
6	31433313	.	T	G	5	2	7	0	1	8	0	0
6	31433341	.	G	A	7	5	12	0	1	13	0	0
6	31433362	.	T	A	6	3	9	0	2	11	0	0
6	31433392	.	T	G	8	4	12	0	0	12	0	0
6	31433412	.	A	G	5	2	7	0	1	8	0	0
6	31433756	.	C	A	6	3	9	0	1	10	0	0
6	31434470	.	G	T	5	6	11	0	1	12	0	0
6	31434554	.	G	A	5	3	8	0	0	8	0	0
6	31434555	.	A	G	5	3	8	0	0	8	0	0
6	31434773	.	T	G	9	7	16	0	2	19	1	0
6	31434830	.	A	G	3	6	9	0	0	9	0	0
6	31434923	.	C	T	0	3	3	0	11	14	0	0
6	31435005	.	T	C	3	5	8	0	0	8	0	0
6	31438395	.	T	C	10	8	18	0	0	18	0	0
6	31438404	.	T	G	8	7	15	0	0	15	0	0
6	31441574	.	A	T	3	1	4	0	0	4	0	0
6	31469966	.	T	G	2	1	3	0	1	4	0	0
6	31483364	.	A	C	7	3	10	0	0	10	0	0
6	31518368	.	T	C	4	0	4	0	3	7	0	0
6	31576327	.	G	A	2	2	4	0	0	4	0	0
6	31591116	.	C	T	10	8	18	0	1	19	0	0
6	31591123	.	C	T	6	5	11	0	8	19	0	0
6	31591163	.	A	G	7	8	15	0	0	15	0	0
6	31591452	.	C	T	3	12	15	0	1	16	0	0
6	31591619	.	G	A	8	3	11	0	0	11	0	0
6	31591838	.	T	G	7	18	25	0	2	27	0	0
6	31591883	.	C	T	9	5	14	0	10	24	0	0
6	31591884	.	A	G	5	12	17	0	7	24	0	0
6	31591997	.	A	C	14	0	14	0	19	33	0	0
6	31598783	.	C	T	5	3	8	0	2	10	0	0
6	31607768	.	T	G	8	8	16	0	0	16	0	0
6	31611647	.	T	A	2	2	4	0	1	5	0	0
6	31617167	.	C	G	0	9	9	0	7	16	0	0
6	31631366	.	A	G	2	0	2	0	0	2	0	0
6	31632508	.	T	C	5	3	8	0	0	8	0	0
6	31632519	.	G	A	4	3	7	0	3	10	0	0
6	32020326	.	G	A	10	5	15	0	0	15	0	0
6	32020327	.	T	A	10	5	15	0	0	15	0	0
6	32021615	.	T	A	6	9	15	0	0	15	0	0
6	32029432	.	A	T	1	4	5	0	0	5	0	0
6	32032374	.	A	C	4	7	11	0	0	11	0	0
6	32034354	.	G	A	1	2	3	0	0	3	0	0
6	32034520	.	G	T	0	2	2	0	1	3	0	0
6	32034611	.	G	A	2	2	4	0	0	4	0	0
6	32037710	.	T	C	1	9	10	0	0	10	0	0
6	32040581	.	G	A	1	2	3	0	5	8	0	0
6	32040620	.	G	A	3	2	5	0	0	5	0	0
6	32042501	.	G	A	1	0	1	0	0	1	0	0
6	32043513	.	G	C	3	3	6	0	0	6	0	0
6	32043514	.	G	T	3	3	6	0	0	6	0	0
6	32065310	.	C	T	3	4	7	0	0	7	0	0
6	32068390	.	C	T	0	2	2	0	1	3	0	0
6	32300717	.	G	A	3	3	6	0	0	6	0	0
6	32301040	.	G	C	2	3	5	0	0	5	0	0
6	32301137	.	A	T	6	8	14	0	0	14	0	0
6	32301161	.	C	T	5	8	13	0	0	13	0	0
6	32301214	.	A	T	7	2	9	0	0	9	0	0
6	32301265	.	A	T	13	3	16	0	0	16	0	0
6	32301462	.	C	T	4	5	9	0	0	9	0	0
6	32301487	.	G	C	3	2	5	0	0	5	0	0
6	32301839	.	T	C	1	1	2	0	3	5	0	0
6	32301900	.	C	G	1	3	4	0	1	5	0	0
6	32301969	.	T	G	7	4	11	0	1	12	0	0
6	32302086	.	T	A	1	2	3	0	0	3	0	0
6	32338356	.	T	C	2	1	3	0	0	3	0	0
6	32339831	.	C	A	2	2	4	0	0	4	0	0
6	32340005	.	C	T	5	2	7	0	0	7	0	0
6	32359371	.	A	G	0	1	1	0	0	1	0	0
6	32359533	.	G	A	1	3	4	0	0	4	0	0
6	32364439	.	C	T	2	1	3	0	0	3	0	0
6	32368787	.	A	T	0	1	1	0	0	1	0	0
6	32368952	.	C	T	2	2	4	0	0	4	0	0
6	32368970	.	A	T	2	2	4	0	0	4	0	0
6	32371414	.	A	G	0	7	7	0	1	8	0	0
6	32371423	.	T	C	1	7	8	0	0	8	0	0
6	32371466	.	A	T	1	4	5	0	0	5	0	0
6	32375581	.	T	C	1	2	3	0	0	3	0	0
6	32375838	.	T	C	0	1	1	0	0	1	0	0
6	32378097	.	G	A	0	4	4	0	2	6	0	0
6	32378689	.	T	C	1	3	4	0	0	4	0	0
6	32385091	.	A	G	2	4	6	0	0	6	0	0
6	32386908	.	T	C	8	3	11	0	1	12	0	0
6	32397659	.	T	C	3	3	6	0	0	6	0	0
6	32398844	.	G	A	9	12	21	0	0	21	0	0
6	32403028	.	G	A	11	17	28	0	1	29	0	0
6	32403052	.	T	C	9	11	20	0	0	20	0	0
6	32404957	.	A	G	9	8	17	0	0	17	0	0
6	32404984	.	A	G	7	5	12	0	0	12	0	0
6	32405020	.	G	A	7	7	14	0	0	14	0	0
6	32405054	.	A	T	8	5	13	0	1	14	0	0
6	32405784	.	A	G	11	9	20	0	0	20	0	0
6	32408182	.	A	G	6	4	10	0	0	10	0	0
6	32409135	.	C	T	5	7	12	0	0	12	0	0
6	32409258	.	T	C	5	0	5	0	5	10	0	0
6	32409301	.	G	A	5	4	9	0	0	9	0	0
6	32409846	.	G	A	1	0	1	0	0	1	0	0
6	32410848	.	A	G	3	0	3	0	0	3	0	0
6	32411039	.	C	T	0	0	0	0	1	1	0	0
6	32415658	.	T	G	3	0	3	0	0	3	0	0
6	32416209	.	T	A	1	3	4	0	0	4	0	0
6	32416217	.	C	T	1	3	4	0	0	4	0	0
6	32482213	.	A	G	2	2	4	0	1	5	0	0
6	32482376	.	G	A	6	3	9	0	0	9	0	0
6	32482727	.	G	A	3	3	6	0	0	6	0	0
6	32483456	.	T	G	3	2	5	0	0	5	0	0
6	32483750	.	T	C	6	6	12	0	0	12	0	0
6	32497525	.	A	G	2	0	2	0	2	4	0	0
6	32497549	.	A	G	4	3	7	0	1	8	0	0
6	32504356	.	C	T	3	7	10	0	1	11	0	0
6	32506350	.	G	A	4	1	5	0	0	5	0	0
6	32699666	.	G	A	2	9	11	0	0	11	0	0
6	32699775	.	A	C	5	0	5	0	3	8	0	0
6	32699870	.	A	T	2	4	6	0	0	6	0	0
6	32700228	.	G	A	1	6	7	0	0	7	0	0
6	32700607	.	T	G	1	3	4	0	1	5	0	0
6	32703298	.	T	A	2	3	5	0	0	5	0	0
6	32722579	.	A	G	3	4	7	0	0	7	0	0
6	32722640	.	C	T	0	7	7	0	7	14	0	0
6	32722680	.	A	T	0	4	4	0	0	4	0	0
6	32739226	.	A	G	4	3	7	0	0	7	0	0
6	32830082	.	T	C	2	2	4	0	0	4	0	0
6	32830083	.	A	G	2	2	4	0	0	4	0	0
6	32832003	.	A	G	3	3	6	0	0	6	0	0
6	32832045	.	T	C	2	0	2	0	3	5	0	0
6	32832409	.	G	T	2	3	5	0	1	6	0	0
6	32832499	.	C	T	2	2	4	0	0	4	0	0
6	32832525	.	G	C	3	2	5	0	0	5	0	0
6	32832662	.	A	G	2	4	6	0	0	6	0	0
6	32832747	.	A	C	2	2	4	0	1	5	0	0
6	32883071	.	A	T	2	3	5	0	0	5	0	0
6	32883097	.	G	A	2	2	4	0	0	4	0	0
6	32966915	.	G	C	11	12	23	0	0	23	0	0
6	32967065	.	C	T	1	1	2	0	0	2	0	0
6	32967080	.	T	C	2	4	6	0	1	7	0	0
6	32967174	.	G	A	14	10	24	0	1	25	0	0
6	32967182	.	A	T	12	12	24	0	0	24	0	0
6	32967357	.	G	A	11	9	20	0	0	20	0	0
6	32970032	.	G	A	1	2	3	0	0	3	0	0
6	32970178	.	T	C	1	1	2	0	0	2	0	0
6	32976281	.	G	A	3	2	5	0	0	5	0	0
6	32979285	.	A	C	2	2	4	0	1	5	0	0
6	32999747	.	A	C	3	0	3	0	1	4	0	0
6	33023389	.	T	A	1	1	2	0	0	2	0	0
6	33023545	.	T	C	6	0	6	0	9	15	0	0
6	33023601	.	A	G	6	6	12	0	1	13	0	0
6	33023625	.	G	C	5	6	11	0	0	11	0	0
6	33077446	.	T	C	1	3	4	0	0	4	0	0
6	33085555	.	G	T	1	1	2	0	0	2	0	0
6	33092969	.	A	C	0	1	1	0	0	1	0	0
6	33094767	.	A	C	1	3	4	0	0	4	0	0
6	33549187	.	T	G	7	0	7	0	10	17	0	0
6	33550455	.	C	T	11	13	24	0	1	25	0	0
6	33550947	.	G	A	5	7	12	0	0	12	0	0
6	33552574	.	T	C	8	5	13	0	0	13	0	0
6	33552601	.	A	T	12	11	23	0	0	23	0	0
6	33552793	.	A	G	14	3	17	0	2	19	0	0
6	33553084	.	G	A	4	5	9	0	0	9	0	0
6	33553407	.	T	C	12	2	14	0	0	14	0	0
6	33554009	.	T	A	10	6	16	0	1	17	0	0
6	33554231	.	T	C	7	13	20	0	0	20	0	0
6	33554356	.	T	C	9	13	22	0	1	23	0	0
6	33554576	.	T	C	4	8	12	0	0	12	0	0
6	33554620	.	A	G	7	0	7	0	5	12	0	0
6	33554702	.	T	C	6	7	13	0	0	13	0	0
6	33554737	.	T	C	8	9	17	0	0	17	0	0
6	33554904	.	T	G	5	3	8	0	0	8	0	0
6	33555107	.	A	C	6	2	8	0	0	8	0	0
6	33555159	.	G	A	0	5	5	0	3	8	0	0
6	33555168	.	C	T	4	6	10	0	0	10	0	0
6	33555227	.	A	T	6	3	9	0	1	10	0	0
6	33555241	.	T	C	3	4	7	0	0	7	0	0
6	33555351	.	A	G	8	4	12	0	0	12	0	0
6	33555374	.	G	A	0	2	2	0	5	7	0	0
6	33555397	.	A	G	3	3	6	0	0	6	0	0
6	33555427	.	G	A	0	2	2	0	5	7	0	0
6	33555448	.	A	C	7	2	9	0	0	9	0	0
6	33555570	.	G	A	7	6	13	0	0	13	0	0
6	33555594	.	T	C	3	3	6	0	0	6	0	0
6	33555691	.	T	G	6	0	6	0	9	15	0	0
6	33555736	.	G	T	1	7	8	0	2	10	0	0
6	33555952	.	T	A	8	12	20	0	1	21	0	0
6	33556325	.	A	T	13	9	22	0	0	22	0	0
6	33556441	.	G	A	7	14	21	0	0	21	0	0
6	33556486	.	C	T	11	14	25	0	0	25	0	0
6	33556493	.	A	T	10	17	27	0	1	28	0	0
6	33556730	.	A	G	10	15	25	0	1	26	0	0
6	33556772	.	A	T	6	18	24	0	0	24	0	0
6	33556819	.	G	A	6	15	21	0	1	22	0	0
6	33556835	.	T	C	7	17	24	0	1	25	0	0
6	33556968	.	G	C	10	11	21	0	2	23	0	0
6	33557077	.	G	A	0	6	6	0	9	15	0	0
6	33557141	.	G	C	10	12	22	0	1	23	0	0
6	33557227	.	A	G	6	11	17	0	2	19	0	0
6	33557377	.	A	C	6	15	21	0	1	22	0	0
6	33557438	.	T	A	5	10	15	0	1	16	0	0
6	33557562	.	T	G	22	13	35	0	1	36	0	0
6	33558711	.	G	C	11	19	30	0	1	31	0	0
6	33558837	.	C	T	3	5	8	0	0	8	0	0
6	33663690	.	T	C	3	14	17	0	1	18	0	0
6	33663776	.	A	T	10	10	20	0	0	20	0	0
6	33663842	.	T	A	9	13	22	0	3	25	0	0
6	33664137	.	C	G	0	10	10	0	6	16	0	0
6	33664182	.	A	G	7	13	20	0	0	20	0	0
6	33664390	.	A	G	9	8	17	0	0	17	0	0
6	33664460	.	A	G	2	6	8	0	1	9	0	0
6	33664518	.	G	A	5	3	8	0	1	9	0	0
6	33664612	.	T	C	8	0	8	0	3	11	0	0
6	33664801	.	A	G	9	7	16	0	0	16	0	0
6	33664852	.	T	C	1	8	9	0	1	10	0	0
6	33664899	.	G	A	5	9	14	0	2	16	0	0
6	33664937	.	G	C	7	4	11	0	2	13	0	0
6	33665062	.	A	G	10	4	14	0	0	14	0	0
6	33665097	.	A	G	8	9	17	0	0	17	0	0
6	33665123	.	T	G	11	10	21	0	0	21	0	0
6	33665320	.	G	A	6	5	11	0	0	11	0	0
6	33665327	.	C	T	5	4	9	0	0	9	0	0
6	33665408	.	A	T	6	8	14	0	2	16	0	0
6	33665513	.	C	T	1	7	8	0	5	13	0	0
6	33665867	.	G	T	12	7	19	0	0	19	0	0
6	33666166	.	G	A	10	9	19	0	0	19	0	0
6	33666250	.	C	A	0	8	8	0	9	17	0	0
6	33666532	.	A	C	18	0	18	0	12	30	0	0
6	33666660	.	A	T	9	15	24	0	1	25	0	0
6	33666715	.	C	A	12	10	22	0	2	24	0	0
6	33666733	.	A	G	15	13	28	0	0	28	0	0
6	33666777	.	C	T	12	13	25	0	1	26	0	0
6	33666871	.	A	T	9	12	21	0	1	22	0	0
6	33666952	.	T	C	7	0	7	0	10	17	0	0
6	33666964	.	G	C	7	0	7	0	12	19	0	0
6	33667006	.	C	T	6	5	11	0	1	12	0	0
6	33667162	.	A	G	3	5	8	0	0	8	0	0
6	33667180	.	C	T	0	5	5	0	4	9	0	0
6	33667222	.	G	A	9	3	12	0	1	13	0	0
6	33667252	.	G	C	13	6	19	0	0	19	0	0
6	33667257	.	G	A	13	7	20	0	0	20	0	0
6	33667369	.	G	A	10	9	19	0	1	20	0	0
6	33667435	.	G	A	15	16	31	0	1	32	0	0
6	33667483	.	T	G	5	16	21	0	3	24	0	0
6	33667546	.	G	A	5	10	15	0	1	16	0	0
6	33668681	.	A	G	9	5	14	0	0	14	0	0
6	33669168	.	G	C	6	0	6	0	6	12	0	0
6	33671910	.	C	T	1	4	5	0	0	5	0	0
6	33673964	.	A	G	3	3	6	0	1	7	0	0
6	33683882	.	A	G	2	4	6	0	0	6	0	0
6	33683885	.	T	A	2	2	4	0	2	6	0	0
6	33694269	.	G	A	1	0	1	0	0	1	0	0
6	33883580	.	C	T	4	3	7	0	0	7	0	0
6	33883916	.	T	A	12	14	26	0	1	27	0	0
6	33884447	.	G	A	1	19	20	0	10	30	0	0
6	33896399	.	T	A	19	14	33	0	3	36	0	0
6	33896406	.	T	G	18	0	18	0	18	36	0	0
6	33896476	.	T	C	18	23	41	1	1	43	0	0
6	33896508	.	A	T	19	23	42	1	1	44	0	0
6	33896620	.	C	T	17	19	36	0	0	36	0	0
6	33896858	.	T	C	15	18	33	0	0	33	0	0
6	33896975	.	A	C	18	15	33	0	0	33	0	0
6	33897193	.	T	A	8	5	13	0	1	14	0	0
6	33897472	.	T	A	7	10	17	0	0	17	0	0
6	33897766	.	A	T	4	9	13	0	0	13	0	0
6	33912240	.	G	A	1	2	3	0	0	3	0	0
6	33921298	.	C	T	4	5	9	0	0	9	0	0
6	33921304	.	T	C	4	6	10	0	1	11	0	0
6	33921511	.	G	A	5	6	11	0	0	11	0	0
6	33921559	.	G	A	4	10	14	0	1	15	0	0
6	33921631	.	A	G	5	3	8	0	0	8	0	0
6	33923900	.	C	T	0	1	1	0	0	1	0	0
6	33925182	.	C	A	1	1	2	0	0	2	0	0
6	33925183	.	A	G	1	1	2	0	0	2	0	0
6	33925345	.	G	A	1	2	3	0	0	3	0	0
6	33926956	.	T	G	1	3	4	0	0	4	0	0
6	33927040	.	A	T	8	4	12	0	2	14	0	0
6	33929724	.	G	C	4	3	7	0	0	7	0	0
6	33931582	.	T	C	8	10	18	0	2	20	0	0
6	33982409	.	T	A	1	3	4	0	0	4	0	0
6	33983874	.	C	T	1	2	3	0	0	3	0	0
6	33983878	.	T	C	1	2	3	0	0	3	0	0
6	34072254	.	C	A	3	2	5	0	0	5	0	0
6	34072275	.	T	G	3	0	3	0	3	6	0	0
6	34512342	.	T	A	1	2	3	0	0	3	0	0
6	34767055	.	T	A	1	2	3	0	0	3	0	0
6	34767154	.	T	C	2	3	5	0	0	5	0	0
6	34767157	.	T	A	2	3	5	0	0	5	0	0
6	34767193	.	T	C	2	1	3	0	0	3	0	0
6	34767202	.	C	T	2	1	3	0	0	3	0	0
6	34787495	.	C	G	2	0	2	0	2	4	0	0
6	34787632	.	C	T	0	4	4	0	1	5	0	0
6	34805913	.	C	A	3	4	7	0	0	7	0	0
6	34805923	.	C	T	4	2	6	0	1	7	0	0
6	34806257	.	G	A	4	2	6	0	0	6	0	0
6	34806407	.	G	A	2	5	7	0	0	7	0	0
6	34806450	.	G	T	7	7	14	0	0	14	0	0
6	34806494	.	C	T	6	8	14	0	1	15	0	0
6	34806893	.	A	T	6	4	10	0	0	10	0	0
6	34807576	.	T	C	2	2	4	0	1	5	0	0
6	34807862	.	T	C	2	5	7	0	0	7	0	0
6	34808517	.	A	G	4	4	8	0	0	8	0	0
6	34808591	.	G	A	15	6	21	0	0	21	0	0
6	34808754	.	C	T	11	10	21	0	0	21	0	0
6	34808821	.	G	A	7	6	13	0	0	13	0	0
6	34808835	.	C	A	7	10	17	0	0	17	0	0
6	34808914	.	C	T	8	6	14	0	0	14	0	0
6	34808996	.	A	G	1	0	1	0	6	7	0	0
6	34809040	.	G	A	5	7	12	0	0	12	0	0
6	34809564	.	A	T	4	7	11	0	0	11	0	0
6	34809826	.	C	A	14	11	25	0	2	27	0	0
6	34809850	.	G	T	17	6	23	0	0	23	0	0
6	34810313	.	C	T	9	18	27	0	0	27	0	0
6	34810415	.	A	G	16	0	16	0	13	29	0	0
6	34810490	.	G	A	1	8	9	0	9	18	0	0
6	34810495	.	G	A	0	7	7	0	8	15	0	0
6	34810890	.	T	C	13	4	17	0	1	18	0	0
6	34810908	.	T	C	5	10	15	0	2	17	0	0
6	34811130	.	A	T	3	5	8	0	0	8	0	0
6	34811150	.	A	C	5	6	11	0	0	11	0	0
6	34825910	.	A	C	2	2	4	0	2	6	0	0
6	34825949	.	C	T	4	2	6	0	0	6	0	0
6	34826002	.	T	C	5	3	8	0	0	8	0	0
6	34826051	.	T	C	2	7	9	0	0	9	0	0
6	34826638	.	C	T	2	2	4	0	1	5	0	0
6	34826640	.	C	T	4	1	5	0	0	5	0	0
6	34826711	.	A	T	6	3	9	0	1	10	0	0
6	34826736	.	A	T	8	4	12	0	1	13	0	0
6	34826750	.	C	G	0	7	7	0	8	15	0	0
6	34828893	.	A	T	2	0	2	0	1	3	0	0
6	34847698	.	C	A	0	2	2	0	3	5	0	0
6	34847699	.	G	A	3	2	5	0	0	5	0	0
6	34931646	.	G	A	12	16	28	1	1	30	0	0
6	34931911	.	C	T	26	24	50	0	0	50	0	0
6	34931912	.	C	T	26	24	50	0	0	50	0	0
6	34932657	.	G	A	6	11	17	0	0	17	0	0
6	34932927	.	A	T	23	34	57	0	2	59	0	0
6	34934870	.	C	T	1	16	17	0	18	35	0	0
6	34943714	.	G	A	4	3	7	0	0	7	0	0
6	34943824	.	A	T	4	3	7	0	0	7	0	0
6	34944056	.	T	C	1	3	4	0	0	4	0	0
6	34961041	.	C	T	0	6	6	0	3	9	0	0
6	35036520	.	A	G	3	4	7	0	0	7	0	0
6	35036755	.	T	A	7	9	16	0	1	17	0	0
6	35046852	.	T	C	3	2	5	0	1	6	0	0
6	35047157	.	G	A	0	1	1	0	0	1	0	0
6	35054984	.	T	G	2	6	8	0	0	8	0	0
6	35058850	.	A	G	1	1	2	0	0	2	0	0
6	35060985	.	C	A	1	3	4	0	0	4	0	0
6	35061226	.	C	T	3	3	6	0	0	6	0	0
6	35100461	.	T	A	3	3	6	0	0	6	0	0
6	35100484	.	C	T	1	3	4	0	3	7	0	0
6	35101641	.	A	T	1	2	3	0	0	3	0	0
6	35101645	.	T	C	1	2	3	0	0	3	0	0
6	35102089	.	C	G	0	4	4	0	1	5	0	0
6	35102305	.	T	A	2	3	5	0	0	5	0	0
6	35136781	.	C	T	0	3	3	0	3	6	0	0
6	35310072	.	A	T	1	2	3	0	0	3	0	0
6	35362308	.	T	A	5	2	7	0	0	7	0	0
6	35365098	.	A	T	7	3	10	0	1	11	0	0
6	35365179	.	T	C	7	6	13	0	0	13	0	0
6	35365185	.	T	A	8	5	13	0	0	13	0	0
6	35365234	.	C	T	6	4	10	0	1	11	0	0
6	35365441	.	C	A	1	3	4	0	0	4	0	0
6	35365462	.	T	A	1	4	5	0	0	5	0	0
6	35365492	.	A	G	2	5	7	0	0	7	0	0
6	35365573	.	G	A	0	2	2	0	1	3	0	0
6	35365768	.	C	T	7	6	13	0	0	13	0	0
6	35365785	.	C	G	9	7	16	0	0	16	0	0
6	35365872	.	C	T	12	2	14	0	0	14	0	0
6	35365877	.	C	T	11	2	13	0	1	14	0	0
6	35366375	.	C	T	2	3	5	0	1	6	0	0
6	35388025	.	G	C	8	0	8	0	5	13	0	0
6	35388874	.	C	T	0	3	3	0	3	6	0	0
6	35388971	.	G	A	2	1	3	0	0	3	0	0
6	35388989	.	T	C	1	2	3	0	0	3	0	0
6	35389007	.	T	G	1	4	5	0	0	5	0	0
6	35389493	.	C	T	6	2	8	0	1	9	0	0
6	35389696	.	C	T	2	3	5	0	1	6	0	0
6	35389773	.	G	A	2	11	13	0	0	13	0	0
6	35389826	.	A	G	3	8	11	0	1	12	0	0
6	35389915	.	C	T	0	2	2	0	0	2	0	0
6	35392431	.	G	C	0	1	1	0	0	1	0	0
6	35443636	.	A	T	13	7	20	0	0	20	0	0
6	35443819	.	G	T	10	4	14	0	1	15	0	0
6	35443822	.	C	T	12	4	16	0	0	16	0	0
6	35443951	.	T	C	21	23	44	0	2	46	0	0
6	35443960	.	C	T	0	18	18	0	27	45	0	0
6	35444467	.	G	A	15	12	27	0	2	29	0	0
6	35461688	.	T	C	5	2	7	0	1	8	0	0
6	35461790	.	T	A	2	2	4	0	1	5	0	0
6	35461812	.	A	T	2	3	5	0	0	5	0	0
6	35461859	.	A	G	0	6	6	0	1	7	0	0
6	35462087	.	G	A	10	13	23	0	0	23	0	0
6	35462088	.	A	G	10	13	23	0	0	23	0	0
6	35462134	.	G	A	5	8	13	0	3	16	0	0
6	35462186	.	A	G	13	15	28	0	1	29	0	0
6	35462470	.	G	A	17	19	36	0	1	37	0	0
6	35472834	.	C	T	2	10	12	0	0	12	0	0
6	35472858	.	G	T	2	14	16	0	2	18	0	0
6	35676724	.	C	T	9	6	15	1	2	18	0	0
6	35676784	.	A	G	11	11	22	1	1	24	0	0
6	35677534	.	T	A	10	10	20	0	0	20	0	0
6	35688251	.	T	C	3	0	3	0	5	8	0	0
6	35713078	.	T	A	0	2	2	0	0	2	0	0
6	35718058	.	T	C	9	4	13	0	1	14	0	0
6	35738430	.	C	A	0	6	6	0	8	14	0	0
6	36129135	.	T	A	4	5	9	0	0	9	0	0
6	36129164	.	T	C	2	3	5	0	0	5	0	0
6	36129202	.	G	A	1	2	3	0	0	3	0	0
6	36129565	.	C	T	0	7	7	0	7	14	0	0
6	36129580	.	G	A	5	9	14	0	1	15	0	0
6	36129601	.	G	A	6	11	17	0	0	17	0	0
6	36129779	.	C	T	11	3	14	0	0	14	0	0
6	36130084	.	G	A	10	3	13	0	2	15	0	0
6	36130196	.	A	G	9	2	11	0	1	12	0	0
6	36130245	.	G	A	3	3	6	0	0	6	0	0
6	36130501	.	A	G	3	3	6	0	1	7	0	0
6	36130727	.	T	G	1	2	3	0	0	3	0	0
6	36131055	.	A	G	5	3	8	0	0	8	0	0
6	36131097	.	A	C	2	0	2	0	6	8	0	0
6	36131376	.	A	G	3	7	10	0	1	11	0	0
6	36131538	.	C	T	0	9	9	0	9	18	0	0
6	36131876	.	G	A	3	2	5	0	0	5	0	0
6	36131937	.	G	A	4	3	7	0	0	7	0	0
6	36136977	.	A	G	10	6	16	0	0	16	0	0
6	36157011	.	T	C	3	0	3	0	3	6	0	0
6	36178531	.	A	G	2	6	8	0	0	8	0	0
6	36552154	.	A	G	3	2	5	0	0	5	0	0
6	36552227	.	G	T	2	2	4	0	0	4	0	0
6	36552508	.	A	G	6	6	12	0	2	14	0	0
6	36720006	.	G	A	3	4	7	0	0	7	0	0
6	36720083	.	C	T	2	2	4	0	0	4	0	0
6	36720457	.	C	T	12	13	25	0	0	25	0	0
6	36720563	.	G	T	4	3	7	0	0	7	0	0
6	36720936	.	C	T	7	6	13	0	0	13	0	0
6	36721061	.	T	A	14	20	34	0	0	34	0	0
6	36721066	.	G	T	17	18	35	0	2	37	0	0
6	36721125	.	A	T	16	20	36	0	1	37	0	0
6	36721159	.	A	T	21	17	38	0	1	39	0	0
6	36721339	.	G	T	27	20	47	0	1	48	0	0
6	36721366	.	G	A	19	14	33	0	0	33	0	0
6	36721380	.	C	G	9	12	21	0	1	22	0	0
6	36877313	.	A	G	4	0	4	0	3	7	0	0
6	37163932	.	T	C	23	15	38	0	2	40	0	0
6	37163943	.	C	T	22	13	35	0	1	36	0	0
6	37164060	.	T	C	19	17	36	0	1	37	0	0
6	37164173	.	T	G	21	17	38	0	1	39	0	0
6	37301438	.	G	T	11	10	21	0	0	21	0	0
6	37301458	.	A	G	15	14	29	0	0	29	0	0
6	37301479	.	A	T	15	15	30	0	0	30	0	0
6	37305142	.	A	C	10	12	22	0	3	25	0	0
6	37305368	.	A	G	7	0	7	0	3	10	0	0
6	37305383	.	A	G	9	6	15	0	0	15	0	0
6	37305470	.	G	A	5	3	8	0	0	8	0	0
6	37305532	.	G	T	7	4	11	0	0	11	0	0
6	37305539	.	G	T	8	3	11	0	1	12	0	0
6	37306620	.	A	T	13	8	21	0	0	21	0	0
6	37306827	.	C	T	11	9	20	0	1	21	0	0
6	37307034	.	C	T	5	9	14	0	2	16	0	0
6	37409738	.	C	T	13	6	19	0	0	19	0	0
6	37409986	.	C	T	5	5	10	0	0	10	0	0
6	37410029	.	A	G	5	2	7	0	0	7	0	0
6	37410047	.	C	T	7	3	10	0	0	10	0	0
6	37410119	.	C	T	0	3	3	0	0	3	0	0
6	37417345	.	T	A	4	3	7	0	0	7	0	0
6	37419449	.	G	A	1	2	3	0	0	3	0	0
6	37419479	.	G	A	1	2	3	0	0	3	0	0
6	37419491	.	A	T	1	0	1	0	0	1	0	0
6	37420172	.	A	C	2	3	5	0	0	5	0	0
6	37421038	.	C	A	0	1	1	0	0	1	0	0
6	37422787	.	A	G	7	6	13	0	0	13	0	0
6	37431476	.	T	G	4	6	10	0	0	10	0	0
6	37431532	.	G	C	3	3	6	0	0	6	0	0
6	37431592	.	C	T	4	4	8	0	0	8	0	0
6	37431649	.	T	C	1	3	4	0	0	4	0	0
6	37438129	.	T	C	1	0	1	0	0	1	0	0
6	37438497	.	T	A	1	1	2	0	0	2	0	0
6	37440302	.	A	G	0	5	5	0	0	5	0	0
6	37440515	.	G	T	1	3	4	0	0	4	0	0
6	37440547	.	T	A	2	4	6	0	0	6	0	0
6	37441474	.	T	C	1	1	2	0	0	2	0	0
6	37441492	.	G	A	1	1	2	0	0	2	0	0
6	37442060	.	G	T	2	2	4	0	0	4	0	0
6	37442129	.	C	T	1	3	4	0	1	5	0	0
6	37442218	.	A	C	2	2	4	0	0	4	0	0
6	37445357	.	T	C	1	2	3	0	0	3	0	0
6	37460601	.	G	T	2	2	4	0	0	4	0	0
6	37461072	.	C	T	2	3	5	0	0	5	0	0
6	37461661	.	G	A	5	7	12	0	0	12	0	0
6	37461662	.	T	A	5	7	12	0	0	12	0	0
6	37465953	.	C	T	1	3	4	0	0	4	0	0
6	37469571	.	C	A	0	3	3	0	1	4	0	0
6	37469637	.	C	A	2	2	4	0	0	4	0	0
6	37478859	.	G	A	6	9	15	0	0	15	0	0
6	37478878	.	G	A	5	9	14	0	0	14	0	0
6	37478905	.	G	A	5	6	11	0	0	11	0	0
6	37479506	.	G	A	8	4	12	0	1	13	0	0
6	37479563	.	C	G	4	5	9	0	0	9	0	0
6	37479578	.	G	A	4	5	9	0	0	9	0	0
6	37479779	.	A	C	3	12	15	0	0	15	0	0
6	37479932	.	G	A	15	5	20	0	0	20	0	0
6	37479998	.	A	G	7	8	15	0	1	16	0	0
6	37480028	.	A	G	9	6	15	0	0	15	0	0
6	37480100	.	T	A	1	1	2	0	0	2	0	0
6	37485828	.	G	A	6	3	9	0	0	9	0	0
6	37489092	.	C	G	0	1	1	0	0	1	0	0
6	37495117	.	G	A	1	1	2	0	0	2	0	0
6	37495147	.	G	A	3	4	7	0	0	7	0	0
6	37514749	.	T	C	1	2	3	0	0	3	0	0
6	37515353	.	T	A	5	6	11	0	0	11	0	0
6	37521529	.	A	T	4	13	17	0	1	18	0	0
6	37521594	.	C	A	8	9	17	0	2	19	0	0
6	37525748	.	G	A	7	6	13	0	0	13	0	0
6	37529504	.	C	A	14	18	32	0	1	33	0	0
6	37548605	.	T	C	5	5	10	0	0	10	0	0
6	37548897	.	C	T	6	10	16	0	0	17	1	0
6	37551165	.	G	A	1	3	4	0	4	8	0	0
6	37551548	.	T	C	4	2	6	0	1	7	0	0
6	37552621	.	C	T	7	3	10	0	1	11	0	0
6	37554293	.	C	T	4	2	6	0	0	6	0	0
6	37598966	.	C	T	18	21	39	0	1	40	0	0
6	37599293	.	C	T	8	10	18	0	0	18	0	0
6	37599406	.	G	A	14	11	25	0	1	26	0	0
6	37599499	.	G	T	11	22	33	0	1	34	0	0
6	37599687	.	A	T	18	11	29	0	0	29	0	0
6	37599937	.	T	G	20	16	36	0	0	36	0	0
6	37599954	.	C	T	18	10	28	0	1	29	0	0
6	37600173	.	A	G	22	0	22	0	15	37	0	0
6	37600210	.	G	A	1	21	22	0	17	39	0	0
6	37600233	.	G	A	19	17	36	0	4	40	0	0
6	37604410	.	T	A	6	3	9	0	2	11	0	0
6	37604724	.	G	A	5	4	9	0	1	10	0	0
6	37604866	.	A	C	6	9	15	0	0	15	0	0
6	37621106	.	A	G	4	2	6	0	0	6	0	0
6	37621150	.	T	C	4	3	7	0	0	7	0	0
6	37621204	.	A	G	5	4	9	0	0	9	0	0
6	37621213	.	A	G	5	3	8	0	0	8	0	0
6	37621918	.	A	G	6	5	11	0	0	11	0	0
6	37622089	.	C	T	0	6	6	0	2	8	0	0
6	37623826	.	A	G	5	4	9	0	0	9	0	0
6	37623836	.	A	T	3	2	5	0	1	6	0	0
6	37627004	.	A	G	1	0	1	0	0	1	0	0
6	37627114	.	G	A	2	3	5	0	0	5	0	0
6	37627141	.	C	A	2	3	5	0	0	5	0	0
6	37628973	.	G	A	4	5	9	0	0	9	0	0
6	37628991	.	C	T	3	2	5	0	0	5	0	0
6	37629402	.	A	G	1	0	1	0	2	3	0	0
6	37631456	.	A	G	3	3	6	0	1	7	0	0
6	37632921	.	G	A	1	4	5	0	0	5	0	0
6	37632963	.	A	G	2	0	2	0	7	9	0	0
6	37632966	.	C	T	2	7	9	0	0	9	0	0
6	37633005	.	C	A	7	5	12	0	0	12	0	0
6	37633549	.	G	A	0	2	2	0	3	5	0	0
6	37635589	.	G	A	2	7	9	0	0	9	0	0
6	37635595	.	C	A	3	6	9	0	1	10	0	0
6	37635649	.	T	C	1	3	4	0	0	4	0	0
6	37637987	.	G	A	0	6	6	0	0	6	0	0
6	37651619	.	T	C	9	10	19	0	0	19	0	0
6	37728484	.	T	C	0	2	2	0	0	2	0	0
6	37728496	.	T	C	0	2	2	0	0	2	0	0
6	37730423	.	G	T	5	2	7	0	0	7	0	0
6	37730520	.	C	T	7	4	11	0	0	11	0	0
6	37730527	.	C	T	4	5	9	0	0	9	0	0
6	37737188	.	C	A	0	0	0	0	1	1	0	0
6	37744304	.	C	A	1	2	3	0	0	3	0	0
6	37745914	.	A	T	1	2	3	0	0	3	0	0
6	37757883	.	G	A	2	0	2	0	0	2	0	0
6	37772316	.	T	C	1	2	3	0	0	3	0	0
6	37772400	.	C	T	3	3	6	0	0	6	0	0
6	37772406	.	A	G	3	3	6	0	0	6	0	0
6	37784031	.	A	G	0	0	0	0	1	1	0	0
6	37794637	.	C	A	3	4	7	0	0	8	1	0
6	37796222	.	G	C	2	3	5	0	0	5	0	0
6	37797710	.	G	A	2	2	4	0	0	4	0	0
6	37800824	.	G	A	0	2	2	0	2	4	0	0
6	37808238	.	G	A	0	2	2	0	5	7	0	0
6	37808262	.	G	C	0	3	3	0	5	8	0	0
6	37808349	.	G	A	1	2	3	0	1	4	0	0
6	37810029	.	T	C	2	1	3	0	0	3	0	0
6	37810256	.	C	T	1	4	5	0	0	5	0	0
6	37812199	.	A	G	3	1	4	0	0	4	0	0
6	37812271	.	G	A	0	5	5	0	2	7	0	0
6	37815348	.	C	G	3	0	3	0	0	3	0	0
6	37815525	.	T	C	1	1	2	0	1	3	0	0
6	37815621	.	T	G	8	3	11	0	1	13	1	0
6	37815799	.	C	T	1	3	4	0	0	4	0	0
6	37818324	.	A	C	0	1	1	0	0	1	0	0
6	37818327	.	G	A	0	1	1	0	0	1	0	0
6	37820306	.	C	T	4	6	10	0	0	10	0	0
6	37820960	.	T	C	9	6	15	0	0	15	0	0
6	37821169	.	G	T	0	1	1	0	2	3	0	0
6	37824355	.	G	T	7	7	14	0	0	14	0	0
6	37824645	.	T	C	5	7	12	0	0	12	0	0
6	37825508	.	T	G	3	0	3	0	6	9	0	0
6	37829585	.	G	A	6	6	12	0	0	12	0	0
6	37829613	.	T	C	2	1	3	0	1	4	0	0
6	37830742	.	A	T	8	3	11	0	0	11	0	0
6	37830784	.	C	T	12	12	24	0	1	25	0	0
6	37830811	.	C	T	11	13	24	0	0	24	0	0
6	37832947	.	C	T	9	12	21	0	1	22	0	0
6	37832953	.	G	A	7	11	18	0	1	19	0	0
6	37833493	.	T	C	9	9	18	0	0	18	0	0
6	37835767	.	T	C	17	12	29	0	0	29	0	0
6	37835797	.	C	T	10	11	21	0	0	21	0	0
6	37836387	.	G	A	16	11	27	0	0	27	0	0
6	37841100	.	C	T	4	5	9	0	0	9	0	0
6	37846026	.	C	T	22	26	48	0	0	48	0	0
6	38367062	.	G	C	13	0	13	0	18	31	0	0
6	38367107	.	T	C	18	13	31	0	0	31	0	0
6	38375020	.	G	A	19	12	31	0	2	33	0	0
6	38381094	.	G	A	6	12	18	0	1	19	0	0
6	38386454	.	T	A	0	4	4	0	0	4	0	0
6	38415315	.	G	A	1	1	2	0	0	2	0	0
6	38415385	.	A	G	14	8	22	0	3	25	0	0
6	38426875	.	A	T	1	2	3	0	0	3	0	0
6	38427427	.	G	A	3	2	5	0	1	6	0	0
6	38427515	.	A	T	4	3	7	0	0	7	0	0
6	38477019	.	G	T	4	7	11	0	0	11	0	0
6	38503673	.	C	T	4	6	10	0	0	10	0	0
6	38511604	.	G	A	7	7	14	0	1	15	0	0
6	38511739	.	C	T	9	11	20	0	0	20	0	0
6	38511921	.	T	C	9	9	18	0	0	18	0	0
6	38511967	.	A	T	3	4	7	0	0	7	0	0
6	38512160	.	T	C	11	9	20	0	0	20	0	0
6	38512178	.	G	A	11	14	25	0	1	26	0	0
6	38512236	.	C	T	12	14	26	0	1	27	0	0
6	38512629	.	C	T	11	13	24	0	1	25	0	0
6	38513231	.	C	T	12	9	21	0	0	21	0	0
6	38778327	.	T	C	4	3	7	0	0	7	0	0
6	38782025	.	C	T	5	7	12	0	0	12	0	0
6	38782439	.	C	A	4	10	14	0	0	14	0	0
6	38782442	.	C	T	4	10	14	0	0	14	0	0
6	38782511	.	A	G	4	6	10	0	3	13	0	0
6	38782712	.	T	C	6	10	16	0	0	16	0	0
6	38782794	.	C	T	4	10	14	0	0	14	0	0
6	38782799	.	T	A	4	10	14	0	0	14	0	0
6	38783002	.	T	A	4	7	11	0	0	11	0	0
6	38783044	.	T	A	3	1	4	0	0	4	0	0
6	38786622	.	C	A	2	1	3	0	0	3	0	0
6	38789065	.	C	A	11	9	20	0	1	21	0	0
6	38789292	.	C	T	15	10	25	0	2	27	0	0
6	38789317	.	C	T	10	12	22	0	3	25	0	0
6	38789507	.	A	T	9	10	19	0	1	20	0	0
6	38789583	.	G	C	17	10	27	0	0	27	0	0
6	38789733	.	A	G	8	10	18	0	6	24	0	0
6	38789832	.	A	G	16	9	25	0	1	26	0	0
6	38789853	.	T	A	16	11	27	0	0	27	0	0
6	38789899	.	G	T	10	2	12	0	3	15	0	0
6	38789903	.	A	T	9	2	11	0	4	15	0	0
6	38796012	.	G	A	1	2	3	0	0	3	0	0
6	38845797	.	G	A	7	4	11	0	0	11	0	0
6	38845817	.	T	C	6	3	9	0	1	10	0	0
6	38845865	.	G	A	5	4	9	0	0	9	0	0
6	38845943	.	C	G	10	4	14	0	0	14	0	0
6	38845964	.	A	G	8	3	11	0	2	13	0	0
6	38846240	.	A	G	3	2	5	0	0	5	0	0
6	38858558	.	T	A	4	3	7	0	0	7	0	0
6	38858784	.	T	G	8	9	17	0	1	18	0	0
6	38858832	.	T	G	6	3	9	0	1	10	0	0
6	38860293	.	C	G	6	5	11	0	2	13	0	0
6	38860362	.	T	A	7	5	12	0	0	12	0	0
6	38860421	.	C	T	3	2	5	0	2	7	0	0
6	38860815	.	A	G	3	10	13	0	0	13	0	0
6	38860823	.	C	T	4	12	16	0	0	16	0	0
6	38860898	.	T	C	9	11	20	0	2	22	0	0
6	38860905	.	C	T	9	12	21	0	1	22	0	0
6	38860981	.	T	C	4	5	9	0	1	10	0	0
6	38860985	.	T	G	4	8	12	0	0	12	0	0
6	38861020	.	G	A	8	7	15	0	0	15	0	0
6	38861035	.	C	A	9	10	19	0	1	20	0	0
6	38890691	.	C	T	1	2	3	0	0	3	0	0
6	38896523	.	T	C	6	6	12	0	0	12	0	0
6	38899123	.	T	C	3	0	3	0	1	4	0	0
6	38901991	.	T	C	12	12	24	0	0	24	0	0
6	38902291	.	T	A	4	5	9	0	0	9	0	0
6	39068150	.	T	G	1	1	2	0	0	2	0	0
6	39068153	.	G	A	0	1	1	0	0	1	0	0
6	39068424	.	A	G	14	20	34	0	1	35	0	0
6	39075254	.	A	C	9	12	21	0	0	21	0	0
6	39075513	.	G	A	9	14	23	0	3	26	0	0
6	39077308	.	G	C	7	9	16	0	1	17	0	0
6	39077364	.	C	T	0	1	1	0	1	2	0	0
6	39123923	.	C	A	3	4	7	0	1	8	0	0
6	39124288	.	C	A	8	3	11	0	0	11	0	0
6	39124304	.	A	C	6	4	10	0	0	10	0	0
6	39124389	.	G	A	6	4	10	0	0	10	0	0
6	39124485	.	A	C	6	2	8	0	0	8	0	0
6	39125296	.	C	T	4	7	11	0	0	11	0	0
6	39125390	.	T	A	3	4	7	0	1	8	0	0
6	39125392	.	C	A	4	4	8	0	0	8	0	0
6	39125609	.	A	C	4	5	9	0	0	9	0	0
6	39125626	.	G	A	3	3	6	0	0	6	0	0
6	39125653	.	G	A	6	4	10	0	0	10	0	0
6	39125746	.	A	C	5	5	10	0	0	10	0	0
6	39125843	.	G	C	1	4	5	0	0	5	0	0
6	39125852	.	G	C	1	4	5	0	0	5	0	0
6	39125881	.	T	C	1	3	4	0	2	6	0	0
6	39126503	.	G	A	5	6	11	0	0	11	0	0
6	39126528	.	G	C	9	2	11	0	1	12	0	0
6	39126884	.	C	T	4	7	11	0	0	11	0	0
6	39127005	.	A	T	5	4	9	0	0	9	0	0
6	39127012	.	A	T	5	4	9	0	0	9	0	0
6	39127078	.	C	T	1	3	4	0	0	4	0	0
6	39127079	.	C	T	1	3	4	0	0	4	0	0
6	39127231	.	G	C	7	4	11	0	0	11	0	0
6	39136487	.	A	G	4	4	8	0	0	8	0	0
6	39162488	.	C	A	4	3	7	0	1	8	0	0
6	39162491	.	C	G	3	4	7	0	1	8	0	0
6	39162607	.	C	T	7	10	17	0	0	17	0	0
6	39162718	.	A	T	2	11	13	0	1	14	0	0
6	39162756	.	T	A	6	7	13	0	1	14	0	0
6	39162855	.	C	T	6	5	11	0	0	11	0	0
6	39162896	.	G	A	4	10	14	0	0	14	0	0
6	39163058	.	T	A	4	5	9	0	1	10	0	0
6	39163286	.	G	A	9	4	13	0	0	13	0	0
6	39163363	.	A	T	8	7	15	0	2	17	0	0
6	39163657	.	T	G	13	5	18	0	0	18	0	0
6	39163690	.	T	C	13	0	13	0	7	20	0	0
6	39163876	.	A	G	10	4	14	0	0	14	0	0
6	39164046	.	T	G	8	3	11	0	0	11	0	0
6	39637258	.	A	G	1	7	8	0	0	8	0	0
6	40761959	.	T	C	1	3	4	0	0	4	0	0
6	40761975	.	T	C	3	4	7	0	0	7	0	0
6	41435866	.	A	G	12	7	19	0	2	21	0	0
6	42371400	.	T	C	4	0	4	0	2	6	0	0
6	45927385	.	A	G	1	2	3	0	1	4	0	0
6	46425620	.	A	G	2	3	5	0	1	6	0	0
6	48163738	.	G	T	4	5	9	0	0	9	0	0
6	48172890	.	C	T	7	6	13	0	0	13	0	0
6	48181994	.	A	C	11	11	22	0	1	23	0	0
6	48182033	.	A	G	11	0	11	0	13	24	0	0
6	48182090	.	T	A	9	9	18	0	3	21	0	0
6	48193191	.	T	C	4	5	9	0	0	9	0	0
6	48193426	.	T	C	4	4	8	0	0	8	0	0
6	48195610	.	G	C	2	1	3	0	0	3	0	0
6	48198255	.	T	A	4	0	4	0	0	4	0	0
6	48198431	.	T	C	10	6	16	0	0	16	0	0
6	48198533	.	C	G	5	8	13	0	1	14	0	0
6	48198718	.	C	A	5	5	10	0	0	10	0	0
6	48198883	.	G	A	3	6	9	0	0	9	0	0
6	48198892	.	A	T	3	7	10	0	1	11	0	0
6	48199068	.	G	A	9	4	13	0	0	13	0	0
6	48294637	.	A	G	1	8	9	0	0	9	0	0
6	48312582	.	A	G	1	1	2	0	0	2	0	0
6	48323373	.	A	T	14	9	23	0	2	25	0	0
6	48323476	.	A	G	11	3	14	0	3	17	0	0
6	48325997	.	C	G	12	12	24	0	4	28	0	0
6	48333375	.	C	T	0	0	0	0	5	5	0	0
6	48333480	.	C	T	0	6	6	0	7	13	0	0
6	48333483	.	C	T	7	5	12	0	0	12	0	0
6	48360804	.	T	C	1	1	2	0	0	2	0	0
6	48360849	.	A	G	0	0	0	0	1	1	0	0
6	48366412	.	A	G	1	0	1	0	2	3	0	0
6	48368655	.	T	C	0	1	1	0	0	1	0	0
6	48369069	.	A	T	3	3	6	0	0	6	0	0
6	48375954	.	T	G	4	3	7	0	0	7	0	0
6	48380884	.	C	A	1	2	3	0	0	3	0	0
6	48381090	.	T	C	5	0	5	0	5	10	0	0
6	48381104	.	G	T	4	5	9	0	1	10	0	0
6	48383002	.	G	A	5	3	8	0	0	8	0	0
6	48383029	.	C	T	4	4	8	0	0	8	0	0
6	48383068	.	T	C	4	4	8	0	1	9	0	0
6	48383105	.	G	C	5	4	9	0	0	9	0	0
6	48383142	.	C	A	3	3	6	0	2	8	0	0
6	48383149	.	A	T	5	3	8	0	0	8	0	0
6	48383239	.	G	A	5	4	9	0	0	9	0	0
6	48383291	.	T	C	4	2	6	0	1	7	0	0
6	48383353	.	A	G	6	5	11	0	0	11	0	0
6	48383371	.	A	C	5	3	8	0	1	9	0	0
6	48383414	.	G	A	2	2	4	0	0	4	0	0
6	48383573	.	G	A	3	11	14	0	0	14	0	0
6	48383713	.	T	A	0	2	2	1	0	3	0	0
6	48383998	.	T	G	3	6	9	0	0	9	0	0
6	48384368	.	T	C	5	5	10	0	0	10	0	0
6	48384602	.	G	A	3	3	6	0	0	7	1	0
6	48425552	.	A	T	9	7	16	0	0	16	0	0
6	48425590	.	T	C	8	3	11	0	1	12	0	0
6	48425632	.	G	T	4	5	9	0	2	11	0	0
6	48425652	.	T	G	3	6	9	0	0	9	0	0
6	48425714	.	A	G	1	1	2	0	1	3	0	0
6	48425967	.	A	C	1	4	5	0	1	6	0	0
6	48425975	.	C	T	2	7	9	0	0	9	0	0
6	48426052	.	A	G	7	6	13	0	0	13	0	0
6	48426088	.	T	C	6	5	11	0	0	11	0	0
6	48426381	.	C	T	14	6	20	0	1	21	0	0
6	48426400	.	G	A	13	6	19	0	1	20	0	0
6	48426429	.	A	T	11	8	19	0	0	19	0	0
6	48426535	.	G	A	11	6	17	0	1	18	0	0
6	48426754	.	A	G	3	4	7	0	0	7	0	0
6	48431429	.	T	C	4	11	15	0	0	15	0	0
6	48437957	.	G	A	3	3	6	0	0	6	0	0
6	48439781	.	C	T	4	4	8	0	0	8	0	0
6	48439949	.	G	A	3	8	11	0	0	11	0	0
6	48440054	.	A	G	2	0	2	0	0	2	0	0
6	48440063	.	T	G	1	0	1	0	0	1	0	0
6	48473183	.	G	A	1	2	3	0	0	3	0	0
6	48473318	.	T	C	4	4	8	0	0	8	0	0
6	48689312	.	T	G	18	12	30	0	0	30	0	0
6	49098617	.	C	A	0	3	3	0	1	4	0	0
6	49103203	.	G	A	0	1	1	0	0	1	0	0
6	49105852	.	G	T	3	5	8	0	0	8	0	0
6	49106155	.	A	T	6	7	13	0	1	14	0	0
6	49106450	.	C	T	11	9	20	0	1	21	0	0
6	49106605	.	C	T	21	16	37	0	0	37	0	0
6	49106744	.	C	T	11	10	21	0	0	21	0	0
6	49107156	.	A	C	23	22	45	0	1	46	0	0
6	49107390	.	G	A	28	15	43	0	2	45	0	0
6	49107477	.	T	G	15	13	28	0	6	34	0	0
6	49108077	.	T	C	14	6	20	0	0	20	0	0
6	49108078	.	T	C	14	6	20	0	0	20	0	0
6	49108157	.	T	C	15	5	20	0	1	21	0	0
6	49108244	.	T	A	18	14	32	0	1	33	0	0
6	49108313	.	T	C	13	19	32	0	2	34	0	0
6	49108352	.	A	T	23	15	38	0	1	39	0	0
6	49108355	.	T	G	23	16	39	0	1	40	0	0
6	49108604	.	T	C	17	20	37	0	1	38	0	0
6	49108739	.	T	C	19	28	47	0	0	47	0	0
6	49108838	.	A	T	13	23	36	0	1	37	0	0
6	49108954	.	C	G	17	17	34	1	0	35	0	0
6	49108970	.	T	C	14	12	26	1	0	27	0	0
6	49109347	.	T	C	26	24	50	0	3	53	0	0
6	49109366	.	G	A	27	27	54	0	1	55	0	0
6	49115141	.	T	C	4	2	6	0	0	6	0	0
6	49115259	.	A	G	1	2	3	0	0	3	0	0
6	49115292	.	A	G	1	2	3	0	0	3	0	0
6	49139928	.	G	A	4	6	10	0	0	10	0	0
6	49159082	.	G	A	4	7	11	0	0	11	0	0
6	49413209	.	C	T	7	4	11	0	1	12	0	0
6	49413281	.	A	T	3	4	7	0	1	8	0	0
6	49413437	.	C	T	2	4	6	0	0	6	0	0
6	49413653	.	T	C	2	5	7	0	0	7	0	0
6	49413728	.	G	A	6	3	9	0	0	9	0	0
6	49414007	.	G	C	4	4	8	0	0	8	0	0
6	49414010	.	A	G	4	5	9	0	0	9	0	0
6	49520723	.	C	T	4	2	6	0	2	8	0	0
6	49534100	.	A	G	1	5	6	0	0	6	0	0
6	49537602	.	G	A	1	2	3	0	0	3	0	0
6	49551892	.	C	T	2	4	6	0	0	6	0	0
6	49556822	.	T	C	2	1	3	0	0	3	0	0
6	49573883	.	T	C	2	5	7	0	2	9	0	0
6	49575605	.	T	C	6	11	17	0	2	19	0	0
6	49575715	.	A	C	6	7	13	0	0	13	0	0
6	49575745	.	T	C	4	5	9	0	0	9	0	0
6	49575756	.	C	G	2	5	7	0	0	7	0	0
6	49575792	.	A	C	2	2	4	0	1	5	0	0
6	49575795	.	C	T	3	2	5	0	0	5	0	0
6	49576666	.	T	A	2	2	4	0	1	5	0	0
6	49576723	.	T	C	1	7	8	0	1	9	0	0
6	49576770	.	T	C	2	7	9	0	0	9	0	0
6	49577047	.	C	T	6	6	12	0	0	12	0	0
6	49577139	.	C	G	4	4	8	0	3	11	0	0
6	49577157	.	A	G	3	4	7	0	1	8	0	0
6	49577317	.	C	T	1	2	3	0	0	3	0	0
6	49577363	.	G	T	2	3	5	0	0	5	0	0
6	49577473	.	G	A	2	7	9	0	1	10	0	0
6	49577546	.	A	C	5	5	10	0	0	10	0	0
6	49577549	.	A	G	4	5	9	0	1	10	0	0
6	49577873	.	C	T	9	5	14	0	0	14	0	0
6	49578468	.	G	C	4	2	6	0	0	6	0	0
6	49579458	.	G	T	0	5	5	0	7	12	0	0
6	49583348	.	C	T	12	19	31	0	1	32	0	0
6	49605308	.	G	A	1	9	10	0	19	29	0	0
6	49628476	.	T	C	10	5	15	0	1	16	0	0
6	49635461	.	G	A	28	31	59	0	0	59	0	0
6	49636372	.	T	C	22	12	34	0	2	36	0	0
6	49651269	.	C	A	0	2	2	0	1	3	0	0
6	49651271	.	T	G	1	2	3	0	0	3	0	0
6	49723071	.	G	A	9	4	13	0	0	13	0	0
6	49730334	.	G	A	0	6	6	0	2	8	0	0
6	49732244	.	C	T	1	2	3	0	0	3	0	0
6	49734513	.	G	A	0	2	2	0	3	5	0	0
6	49737251	.	A	T	4	9	13	0	0	13	0	0
6	49737331	.	A	C	9	6	15	0	2	17	0	0
6	49737337	.	C	A	9	10	19	0	0	19	0	0
6	49737477	.	T	A	13	8	21	0	0	21	0	0
6	49737524	.	T	G	7	7	14	0	0	14	0	0
6	49737584	.	A	G	5	0	5	0	6	11	0	0
6	49737590	.	A	G	5	5	10	0	0	10	0	0
6	49737842	.	T	G	5	2	7	0	0	7	0	0
6	49737847	.	A	C	4	2	6	0	1	7	0	0
6	49737917	.	A	G	10	3	13	0	0	13	0	0
6	49738348	.	A	G	4	0	4	0	5	9	0	0
6	49738527	.	A	G	8	6	14	0	2	16	0	0
6	49738704	.	T	A	5	3	8	0	1	9	0	0
6	49738863	.	A	G	7	2	9	0	15	24	0	0
6	49738977	.	T	C	6	11	17	0	0	17	0	0
6	49739084	.	G	A	7	7	14	0	1	15	0	0
6	49739151	.	A	G	5	7	12	0	0	12	0	0
6	49739503	.	G	A	6	5	11	0	0	11	0	0
6	49739579	.	G	A	0	4	4	0	4	8	0	0
6	49739628	.	C	T	4	5	9	0	0	9	0	0
6	49739698	.	A	T	14	4	18	0	0	18	0	0
6	49739845	.	T	C	8	2	10	0	1	11	0	0
6	49740059	.	A	G	5	6	11	0	0	11	0	0
6	49740067	.	C	A	4	5	9	0	3	12	0	0
6	49740247	.	G	A	9	5	14	0	1	15	0	0
6	49744383	.	T	C	3	12	15	0	0	15	0	0
6	49744443	.	C	T	1	4	5	0	0	5	0	0
6	49749689	.	G	A	0	1	1	0	3	4	0	0
6	49751721	.	T	C	16	9	25	0	2	27	0	0
6	49757650	.	T	C	7	12	19	0	1	20	0	0
6	49760278	.	G	C	11	17	28	0	0	28	0	0
6	49760581	.	A	T	10	11	21	0	0	21	0	0
6	49760609	.	A	G	7	10	17	0	1	18	0	0
6	49760740	.	A	G	3	6	9	0	1	12	2	0
6	49763528	.	C	T	1	2	3	0	0	3	0	0
6	49777475	.	C	T	1	1	2	0	0	2	0	0
6	49777640	.	A	C	2	3	5	0	0	5	0	0
6	49778844	.	C	A	5	4	9	0	0	9	0	0
6	49780905	.	T	A	5	5	10	0	0	10	0	0
6	49782007	.	C	T	1	2	3	0	0	3	0	0
6	49782021	.	A	T	1	2	3	0	0	3	0	0
6	49789216	.	C	T	0	7	7	0	6	13	0	0
6	49793870	.	T	G	2	1	3	0	0	3	0	0
6	49796925	.	A	T	2	2	4	0	1	5	0	0
6	49797253	.	A	G	1	0	1	0	0	1	0	0
6	49799982	.	C	T	0	2	2	0	0	2	0	0
6	49811940	.	C	T	0	7	7	1	12	20	0	0
6	49812476	.	G	A	9	17	26	0	1	27	0	0
6	49816372	.	A	G	7	6	13	0	0	13	0	0
6	49901591	.	C	T	14	13	27	0	0	27	0	0
6	49914387	.	T	C	14	16	30	0	1	31	0	0
6	49919063	.	A	G	2	2	4	0	0	4	0	0
6	49919211	.	C	T	13	18	31	0	3	34	0	0
6	49919232	.	A	T	13	17	30	0	0	30	0	0
6	49919326	.	T	A	15	13	28	0	2	30	0	0
6	49919358	.	C	T	16	11	27	0	1	28	0	0
6	49919908	.	A	G	12	1	13	0	21	34	0	0
6	49920119	.	C	A	4	5	9	0	0	9	0	0
6	49920218	.	A	T	16	13	29	0	1	30	0	0
6	49920253	.	A	G	11	0	11	0	11	22	0	0
6	49920392	.	C	T	3	6	9	0	0	9	0	0
6	49920405	.	A	C	1	3	4	0	0	4	0	0
6	49920433	.	A	G	3	0	3	0	10	13	0	0
6	49920442	.	C	T	3	11	14	0	0	14	0	0
6	49920468	.	G	A	7	16	23	0	0	23	0	0
6	49920498	.	T	A	6	11	17	0	0	17	0	0
6	49920514	.	T	C	6	9	15	0	0	16	1	0
6	49920626	.	T	A	1	1	2	0	0	2	0	0
6	49921770	.	G	A	0	4	4	0	10	14	0	0
6	49921853	.	T	A	7	7	14	2	0	16	0	0
6	49930806	.	G	C	2	1	3	0	0	3	0	0
6	49930809	.	T	C	1	0	1	0	1	2	0	0
6	50203687	.	G	A	1	4	5	0	0	5	0	0
6	50382957	.	G	A	0	17	17	0	14	31	0	0
6	50389352	.	C	T	10	10	20	0	2	22	0	0
6	50389424	.	G	A	2	2	4	0	0	4	0	0
6	50390067	.	A	C	0	2	2	0	0	2	0	0
6	50401756	.	T	A	16	14	30	0	2	32	0	0
6	50401894	.	A	T	11	19	30	0	2	32	0	0
6	50402037	.	T	G	10	20	30	0	4	34	0	0
6	50402294	.	G	A	14	7	21	0	1	22	0	0
6	50404635	.	T	A	7	9	16	0	1	18	1	0
6	50404677	.	A	G	13	16	29	0	0	29	0	0
6	50408885	.	G	A	0	2	2	0	1	3	0	0
6	50413410	.	G	A	11	11	22	0	0	22	0	0
6	50413422	.	C	A	14	12	26	0	0	26	0	0
6	50413449	.	T	A	12	10	22	0	2	24	0	0
6	50414033	.	C	A	3	10	13	0	0	13	0	0
6	50414089	.	A	G	3	4	7	0	0	7	0	0
6	50453956	.	T	C	3	3	6	0	0	6	0	0
6	50454183	.	G	T	3	2	5	0	0	5	0	0
6	50581261	.	A	G	7	6	13	0	0	13	0	0
6	50581346	.	C	A	8	12	20	0	1	21	0	0
6	50581579	.	C	T	4	3	7	0	0	7	0	0
6	50581589	.	G	A	4	2	6	0	0	6	0	0
6	50581794	.	G	T	7	5	12	0	0	12	0	0
6	50581851	.	C	T	0	2	2	0	4	6	0	0
6	50582513	.	G	A	15	5	20	0	0	20	0	0
6	50582597	.	C	G	0	1	1	0	2	3	0	0
6	50596389	.	T	C	5	3	8	0	0	8	0	0
6	50685617	.	A	G	2	2	4	0	0	4	0	0
6	50685722	.	G	A	5	3	8	0	0	8	0	0
6	50695569	.	T	C	3	3	6	0	0	6	0	0
6	50695857	.	G	A	5	7	12	0	0	12	0	0
6	50696532	.	A	T	5	1	6	0	0	6	0	0
6	50698791	.	T	C	3	2	5	0	0	5	0	0
6	50699761	.	G	A	5	6	11	0	1	12	0	0
6	50713945	.	C	T	4	3	7	0	0	7	0	0
6	50714055	.	T	A	3	2	5	0	0	5	0	0
6	50714298	.	G	A	5	2	7	0	0	7	0	0
6	50722206	.	G	A	4	7	11	0	0	11	0	0
6	50722230	.	T	C	1	3	4	0	0	4	0	0
6	50730682	.	C	T	2	7	9	0	1	10	0	0
6	51021093	.	C	T	2	11	13	0	0	13	0	0
6	51021107	.	C	T	0	2	2	0	8	10	0	0
6	51045271	.	C	T	3	2	5	0	0	5	0	0
6	51054581	.	G	A	4	3	7	0	0	7	0	0
6	51054614	.	G	A	4	6	10	0	0	10	0	0
6	51054620	.	C	T	6	6	12	0	0	12	0	0
6	51054671	.	G	A	3	2	5	0	1	6	0	0
6	51064869	.	C	T	1	2	3	0	0	3	0	0
6	51161255	.	T	A	3	4	7	0	0	7	0	0
6	51161306	.	A	T	2	1	3	0	0	3	0	0
6	51195641	.	A	C	7	0	7	0	4	11	0	0
6	51237577	.	G	A	5	6	11	0	1	12	0	0
6	51529410	.	C	T	1	5	6	0	4	10	0	0
6	51529422	.	C	T	7	3	10	0	0	10	0	0
6	51529477	.	A	T	6	3	9	0	0	9	0	0
6	51531004	.	G	A	4	4	8	0	0	8	0	0
6	51531067	.	G	A	8	3	11	0	0	11	0	0
6	51531104	.	T	C	1	6	7	0	0	7	0	0
6	51531922	.	G	T	2	1	3	0	2	5	0	0
6	51531924	.	G	A	2	3	5	0	0	5	0	0
6	51532015	.	C	T	0	2	2	0	5	7	0	0
6	51532140	.	G	A	4	2	6	0	1	7	0	0
6	51532156	.	G	C	3	2	5	0	0	5	0	0
6	51532187	.	C	T	0	4	4	0	2	6	0	0
6	51532334	.	G	T	2	1	3	0	0	3	0	0
6	51535160	.	C	G	7	7	14	0	0	14	0	0
6	51535191	.	A	T	4	4	8	0	0	8	0	0
6	51541002	.	G	T	3	3	6	0	0	6	0	0
6	51541166	.	A	C	7	4	11	0	0	11	0	0
6	51541258	.	G	A	5	4	9	0	0	9	0	0
6	51549320	.	C	T	2	4	6	0	2	8	0	0
6	51549368	.	A	G	4	2	6	0	0	6	0	0
6	51558136	.	A	T	2	2	4	0	0	4	0	0
6	51558200	.	A	G	2	3	5	0	0	5	0	0
6	51576354	.	A	C	7	11	18	0	0	18	0	0
6	51576379	.	T	C	7	12	19	0	0	19	0	0
6	51577116	.	G	A	9	10	19	0	0	19	0	0
6	51577365	.	A	T	13	5	18	0	0	18	0	0
6	51577601	.	A	T	1	2	3	0	0	3	0	0
6	51577963	.	A	C	9	3	12	0	0	12	0	0
6	51578452	.	C	A	3	2	5	0	0	5	0	0
6	51578476	.	C	T	0	3	3	0	4	7	0	0
6	51578537	.	A	G	6	5	11	0	0	11	0	0
6	51578595	.	A	G	6	3	9	0	0	9	0	0
6	51578666	.	G	C	5	6	11	0	0	11	0	0
6	51578684	.	C	T	0	5	5	0	3	8	0	0
6	51578704	.	A	G	7	2	9	0	0	9	0	0
6	51579133	.	G	A	8	6	14	0	0	14	0	0
6	51579196	.	C	A	7	5	12	0	0	12	0	0
6	51579813	.	T	C	7	0	7	0	8	15	0	0
6	51580373	.	G	A	4	7	11	0	1	12	0	0
6	51580457	.	G	A	4	5	9	0	1	10	0	0
6	51580529	.	A	G	8	16	24	0	0	24	0	0
6	51581201	.	A	G	4	6	10	0	0	10	0	0
6	51586559	.	C	T	0	1	1	0	0	1	0	0
6	51591176	.	C	T	0	1	1	0	0	1	0	0
6	51592403	.	T	C	0	1	1	0	0	1	0	0
6	51592538	.	C	T	6	8	14	0	0	14	0	0
6	51594323	.	T	C	6	10	16	0	0	16	0	0
6	51594474	.	G	T	6	2	8	0	0	8	0	0
6	51594490	.	T	C	7	3	10	0	0	10	0	0
6	51594542	.	C	T	4	4	8	0	0	8	0	0
6	51594894	.	T	C	4	4	8	0	0	8	0	0
6	51594926	.	C	T	0	5	5	0	5	10	0	0
6	51595043	.	C	T	0	7	7	0	4	11	0	0
6	51595052	.	A	G	6	6	12	0	0	12	0	0
6	51595124	.	G	A	3	2	5	0	1	6	0	0
6	51598123	.	C	A	3	4	7	0	1	8	0	0
6	51598153	.	T	G	4	4	8	0	0	8	0	0
6	51609150	.	A	G	1	1	2	0	0	2	0	0
6	51609156	.	A	G	1	1	2	0	1	3	0	0
6	51612481	.	G	A	2	3	5	0	0	5	0	0
6	51770340	.	C	T	20	23	43	0	5	48	0	0
6	51770436	.	C	T	0	16	16	0	27	43	0	0
6	51770503	.	A	G	14	13	27	0	1	28	0	0
6	51779940	.	A	C	0	2	2	0	0	2	0	0
6	51780532	.	G	C	3	3	6	0	0	6	0	0
6	51780612	.	C	T	4	2	6	0	0	6	0	0
6	51780636	.	T	A	4	2	6	0	0	6	0	0
6	51796672	.	T	C	9	0	9	0	5	14	0	0
6	51796714	.	T	A	15	16	31	0	3	34	0	0
6	51797732	.	A	G	1	0	1	0	1	2	0	0
6	51797741	.	C	T	0	0	0	0	1	1	0	0
6	51808858	.	C	T	0	1	1	0	3	4	0	0
6	51808983	.	T	G	9	4	13	0	2	15	0	0
6	51810855	.	T	G	5	7	12	0	1	13	0	0
6	51810941	.	A	C	6	0	6	0	7	13	0	0
6	51810957	.	A	G	8	4	12	0	0	12	0	0
6	51811024	.	T	C	4	8	12	0	1	13	0	0
6	52082324	.	G	A	1	5	6	0	0	6	0	0
6	52082328	.	A	T	1	5	6	0	0	6	0	0
6	52082361	.	A	T	2	8	10	0	0	10	0	0
6	52082391	.	A	G	4	8	12	0	1	13	0	0
6	52082402	.	A	G	5	6	11	0	1	12	0	0
6	52082569	.	C	A	9	7	16	0	0	16	0	0
6	52082811	.	A	G	4	9	13	0	0	13	0	0
6	52155931	.	G	A	8	8	16	0	1	17	0	0
6	52156247	.	A	G	11	13	24	0	1	25	0	0
6	52223936	.	A	G	33	14	47	0	1	48	0	0
6	52224090	.	A	G	32	11	43	0	2	45	0	0
6	52224406	.	A	G	39	23	62	0	2	64	0	0
6	52224543	.	A	G	38	9	47	0	2	49	0	0
6	52227273	.	G	A	5	5	10	0	0	10	0	0
6	52227301	.	G	A	7	3	10	0	0	10	0	0
6	52227568	.	C	A	6	4	10	0	0	10	0	0
6	52227755	.	T	C	2	0	2	0	3	5	0	0
6	52227844	.	A	G	6	2	8	0	0	8	0	0
6	52239517	.	A	G	4	0	4	0	1	5	0	0
6	52239573	.	T	C	23	26	49	0	2	51	0	0
6	52239613	.	G	C	14	15	29	0	0	29	0	0
6	52247876	.	T	G	0	0	0	0	1	1	0	0
6	52248124	.	A	T	2	4	6	0	1	7	0	0
6	52248223	.	A	G	4	6	10	0	0	10	0	0
6	52248250	.	A	G	3	6	9	0	2	11	0	0
6	52248262	.	A	C	3	7	10	0	1	11	0	0
6	52248478	.	G	A	1	9	10	0	9	19	0	0
6	52248679	.	T	C	2	2	4	0	0	4	0	0
6	52248802	.	T	C	6	8	14	0	0	14	0	0
6	52248847	.	A	C	7	10	17	0	0	17	0	0
6	52249015	.	T	G	5	2	7	0	0	7	0	0
6	52249042	.	T	C	4	2	6	0	1	7	0	0
6	52319305	.	G	A	1	0	1	0	0	1	0	0
6	52323967	.	G	A	0	0	0	0	1	1	0	0
6	52324684	.	A	G	0	1	1	0	0	1	0	0
6	52324735	.	G	C	0	1	1	0	0	1	0	0
6	52324871	.	T	C	0	1	1	0	0	1	0	0
6	52324872	.	A	G	0	0	0	0	1	1	0	0
6	52327951	.	G	C	0	0	0	0	2	2	0	0
6	52339605	.	C	T	2	4	6	0	1	7	0	0
6	52339728	.	G	A	3	4	7	0	0	7	0	0
6	52350571	.	T	C	2	5	7	0	0	7	0	0
6	52351748	.	A	C	7	2	9	0	0	9	0	0
6	52352106	.	A	T	1	2	3	0	0	3	0	0
6	52352339	.	T	C	1	4	5	0	0	5	0	0
6	52352718	.	T	G	4	2	6	0	0	6	0	0
6	52352758	.	G	A	3	4	7	0	0	7	0	0
6	52352788	.	C	G	6	6	12	0	0	12	0	0
6	52353219	.	T	C	6	3	9	0	0	9	0	0
6	52353345	.	T	C	4	3	7	0	0	7	0	0
6	52353357	.	C	G	6	2	8	0	1	9	0	0
6	52354360	.	T	C	1	5	6	1	0	7	0	0
6	52354536	.	T	C	10	5	15	0	0	15	0	0
6	52354717	.	T	A	3	9	12	0	0	12	0	0
6	52354726	.	A	T	3	11	14	0	0	14	0	0
6	52354852	.	A	T	6	12	18	0	0	18	0	0
6	52354892	.	A	T	3	4	7	0	0	7	0	0
6	52354939	.	G	A	3	2	5	0	1	6	0	0
6	52354953	.	T	C	5	2	7	0	0	7	0	0
6	52356050	.	T	A	2	2	4	0	0	4	0	0
6	52356068	.	A	T	1	2	3	0	1	4	0	0
6	52356414	.	A	T	5	2	7	0	0	7	0	0
6	52356415	.	A	T	4	2	6	0	1	7	0	0
6	52356755	.	G	C	9	12	21	0	1	22	0	0
6	52362427	.	G	A	10	12	22	0	0	22	0	0
6	52362517	.	A	T	12	8	20	0	2	22	0	0
6	52362553	.	T	C	8	6	14	0	1	15	0	0
6	52362578	.	A	G	5	5	10	0	1	11	0	0
6	52362605	.	T	C	7	5	12	0	1	13	0	0
6	52362623	.	A	C	7	2	9	0	5	14	0	0
6	52362798	.	A	G	6	4	10	0	0	10	0	0
6	52362956	.	T	C	4	0	4	0	5	9	0	0
6	52363152	.	G	A	4	4	8	0	0	8	0	0
6	52363153	.	G	T	4	4	8	0	0	8	0	0
6	52363683	.	A	T	3	3	6	0	0	6	0	0
6	52363704	.	C	A	2	4	6	0	1	7	0	0
6	52364371	.	G	C	6	5	11	0	1	12	0	0
6	52364539	.	C	T	3	5	8	0	0	8	0	0
6	52364701	.	C	T	1	3	4	0	3	7	0	0
6	52372698	.	C	T	1	3	4	0	2	6	0	0
6	52383370	.	G	A	6	7	13	0	0	13	0	0
6	52397236	.	G	A	3	2	5	0	0	5	0	0
6	52397248	.	C	T	3	3	6	0	0	6	0	0
6	52397326	.	G	A	6	5	11	0	0	11	0	0
6	52521891	.	T	G	14	15	29	0	7	36	0	0
6	52533228	.	G	A	6	9	15	0	0	15	0	0
6	52536386	.	C	T	0	2	2	0	0	2	0	0
6	52552993	.	G	A	6	6	12	0	0	12	0	0
6	52563953	.	A	C	1	1	2	0	0	2	0	0
6	52663242	.	C	G	6	10	16	0	0	16	0	0
6	52663535	.	C	A	1	2	3	0	1	4	0	0
6	52664120	.	A	T	1	4	5	0	0	5	0	0
6	52667345	.	T	C	0	2	2	0	0	2	0	0
6	52675561	.	G	A	4	4	8	0	0	8	0	0
6	52715879	.	G	T	9	7	16	0	0	16	0	0
6	52715929	.	A	T	11	8	19	0	1	20	0	0
6	52716119	.	T	G	12	7	19	0	0	19	0	0
6	52716311	.	C	T	8	14	22	0	3	25	0	0
6	52716325	.	G	A	15	8	23	0	1	24	0	0
6	52716630	.	G	A	5	15	20	0	1	21	0	0
6	52716795	.	G	T	7	10	17	0	0	17	0	0
6	52720727	.	T	G	7	7	14	0	1	15	0	0
6	52827119	.	A	G	0	1	1	0	0	1	0	0
6	52845576	.	A	C	1	3	4	0	0	4	0	0
6	52845763	.	A	G	2	2	4	0	1	5	0	0
6	52845851	.	A	T	1	3	4	0	0	4	0	0
6	52845936	.	A	G	3	5	8	0	0	8	0	0
6	53050515	.	T	A	25	28	53	0	1	54	0	0
6	53050517	.	G	A	27	26	53	0	1	54	0	0
6	53050589	.	G	A	20	19	39	0	0	39	0	0
6	53050761	.	C	T	12	19	31	0	2	33	0	0
6	53050805	.	C	T	15	22	37	0	2	39	0	0
6	53050847	.	G	A	25	17	42	0	1	43	0	0
6	53050895	.	C	T	16	25	41	0	1	42	0	0
6	53052693	.	C	T	18	12	30	1	0	31	0	0
6	53052741	.	G	A	5	4	9	0	0	9	0	0
6	53065954	.	G	A	0	1	1	0	0	1	0	0
6	53143647	.	C	A	0	8	8	0	19	27	0	0
6	53264192	.	T	C	21	33	54	0	3	57	0	0
6	53264365	.	T	A	2	9	11	0	2	13	0	0
6	53264383	.	C	T	10	14	24	0	2	26	0	0
6	53272169	.	G	A	9	13	22	0	0	22	0	0
6	53272571	.	A	G	11	12	23	0	0	23	0	0
6	53273943	.	A	G	10	22	32	0	0	33	1	0
6	53273979	.	A	G	4	11	15	0	1	16	0	0
6	53279886	.	G	T	6	6	12	0	0	12	0	0
6	53279995	.	C	T	4	1	5	0	3	8	0	0
6	53305633	.	T	C	24	24	48	0	2	50	0	0
6	53306806	.	G	T	22	10	32	0	1	33	0	0
6	53306847	.	G	T	18	9	27	0	3	30	0	0
6	53350083	.	T	C	4	2	6	0	1	7	0	0
6	53350105	.	A	T	4	6	10	0	0	10	0	0
6	53350217	.	G	A	6	4	10	0	2	12	0	0
6	53361818	.	T	C	3	6	9	0	0	9	0	0
6	53611488	.	A	G	1	1	2	0	0	2	0	0
6	54063052	.	G	A	1	1	2	0	0	2	0	0
6	54063306	.	G	T	0	2	2	0	1	3	0	0
6	54078725	.	C	T	6	6	12	0	0	12	0	0
6	54079586	.	T	A	2	3	5	0	0	5	0	0
6	54079590	.	G	C	2	3	5	0	0	5	0	0
6	54117152	.	A	G	3	5	8	0	0	8	0	0
6	54117367	.	A	G	8	6	14	0	0	14	0	0
6	54120966	.	G	C	11	8	19	0	0	19	0	0
6	54142351	.	T	G	7	11	18	0	2	20	0	0
6	54149554	.	C	T	5	4	9	0	1	10	0	0
6	54150152	.	C	T	4	3	7	0	0	7	0	0
6	54150154	.	T	A	4	3	7	0	0	7	0	0
6	54150640	.	C	G	10	13	23	0	0	23	0	0
6	54150918	.	C	T	6	9	15	0	0	15	0	0
6	54151406	.	G	A	11	12	23	0	0	23	0	0
6	54151554	.	G	A	0	4	4	1	8	13	0	0
6	54151680	.	G	A	6	10	16	1	2	19	0	0
6	54151683	.	C	T	7	9	16	1	1	18	0	0
6	54151768	.	G	A	12	15	27	0	1	28	0	0
6	54151951	.	T	C	18	13	31	0	1	32	0	0
6	54151963	.	T	C	16	10	26	0	3	29	0	0
6	54152049	.	G	A	1	5	6	0	0	6	0	0
6	54152492	.	C	T	17	18	35	0	0	36	1	0
6	54152529	.	T	A	15	13	28	0	1	29	0	0
6	54154905	.	A	T	4	7	11	0	2	13	0	0
6	54154909	.	G	T	0	6	6	0	6	12	0	0
6	54165082	.	G	T	0	2	2	0	3	5	0	0
6	54165133	.	C	T	0	3	3	0	1	4	0	0
6	54175384	.	A	G	3	3	6	0	0	6	0	0
6	54177352	.	A	T	6	2	8	0	2	10	0	0
6	54177478	.	A	G	17	26	43	0	0	43	0	0
6	54262298	.	C	T	2	1	3	0	0	3	0	0
6	54266244	.	G	A	1	1	2	0	0	2	0	0
6	54266337	.	T	A	12	12	24	0	1	25	0	0
6	54270266	.	C	T	1	0	1	0	0	1	0	0
6	54270561	.	T	A	10	9	19	0	0	19	0	0
6	54270680	.	G	T	14	12	26	0	3	29	0	0
6	54270773	.	T	A	6	10	16	0	1	17	0	0
6	54325234	.	A	G	7	10	17	0	1	18	0	0
6	54325368	.	A	G	12	7	19	0	0	19	0	0
6	54325487	.	A	G	5	7	12	0	0	12	0	0
6	54326031	.	T	A	6	6	12	0	0	12	0	0
6	54326141	.	T	A	1	5	6	0	0	6	0	0
6	54326198	.	T	A	1	3	4	0	0	4	0	0
6	54326206	.	G	A	2	1	3	0	0	3	0	0
6	54326759	.	T	C	3	9	12	0	0	12	0	0
6	54337568	.	G	A	5	4	9	0	0	9	0	0
6	54397394	.	C	T	1	4	5	0	0	5	0	0
6	54397805	.	C	T	2	1	3	0	0	3	0	0
6	54409160	.	T	A	1	1	2	0	0	2	0	0
6	54409807	.	A	T	1	0	1	0	0	1	0	0
6	54421228	.	T	G	3	0	3	0	3	6	0	0
6	54422599	.	T	A	5	2	7	0	0	7	0	0
6	54422635	.	T	A	4	3	7	0	0	7	0	0
6	54422659	.	A	G	2	0	2	0	2	4	0	0
6	54438466	.	G	A	15	11	26	0	1	27	0	0
6	54701931	.	G	A	0	3	3	0	0	3	0	0
6	54702803	.	A	G	1	1	2	0	0	2	0	0
6	54703713	.	T	C	1	2	3	0	0	3	0	0
6	54704691	.	T	G	4	2	6	0	0	6	0	0
6	54704856	.	T	A	2	2	4	0	0	4	0	0
6	54806566	.	T	C	2	5	7	0	0	7	0	0
6	54815767	.	A	C	3	2	5	0	0	5	0	0
6	54838467	.	G	A	14	13	27	0	1	28	0	0
6	54838496	.	T	C	12	11	23	0	3	26	0	0
6	54840083	.	T	C	8	0	8	0	11	19	0	0
6	54843108	.	T	G	9	14	23	0	0	23	0	0
6	54888975	.	T	C	3	4	7	0	0	7	0	0
6	54889038	.	C	T	3	3	6	0	0	6	0	0
6	54959695	.	T	C	2	0	2	0	0	2	0	0
6	54970317	.	T	C	1	3	4	0	0	4	0	0
6	54970643	.	C	A	6	3	9	0	0	9	0	0
6	54970870	.	C	T	0	1	1	0	0	1	0	0
6	54978063	.	G	A	6	1	7	0	1	8	0	0
6	55004574	.	T	C	1	0	1	0	0	1	0	0
6	55006778	.	C	T	2	3	5	0	0	5	0	0
6	55006971	.	C	T	0	1	1	0	0	1	0	0
6	55010951	.	T	C	2	2	4	0	0	4	0	0
6	55010972	.	C	T	2	2	4	0	0	4	0	0
6	55016519	.	A	G	0	0	0	0	1	1	0	0
6	55016522	.	C	A	0	2	2	0	0	2	0	0
6	55016579	.	G	T	3	6	9	0	3	12	0	0
6	55017151	.	T	G	1	3	4	0	0	4	0	0
6	55020076	.	A	C	6	3	9	0	0	9	0	0
6	55020094	.	G	A	0	7	7	0	7	14	0	0
6	55020288	.	A	G	13	0	13	0	7	20	0	0
6	55020327	.	A	T	15	7	22	0	2	24	0	0
6	55020477	.	C	A	3	5	8	0	1	9	0	0
6	55021617	.	T	C	2	6	8	0	2	10	0	0
6	55021735	.	A	C	4	5	9	0	0	9	0	0
6	55021736	.	A	C	4	5	9	0	0	9	0	0
6	55021941	.	A	T	8	8	16	0	2	18	0	0
6	55021943	.	G	T	0	8	8	0	10	18	0	0
6	55022039	.	A	G	5	9	14	0	0	14	0	0
6	55022109	.	T	C	4	5	9	0	0	9	0	0
6	55022114	.	T	A	4	6	10	0	0	10	0	0
6	55022244	.	A	T	3	4	7	0	1	8	0	0
6	55022263	.	G	C	5	3	8	0	0	8	0	0
6	55022286	.	A	T	5	3	8	0	2	10	0	0
6	55022319	.	A	T	6	6	12	0	0	12	0	0
6	55022330	.	A	T	8	6	14	0	0	15	1	0
6	55022437	.	C	T	7	11	18	0	0	18	0	0
6	55217796	.	A	G	3	4	7	0	4	11	0	0
6	55217800	.	A	G	7	0	7	0	3	10	0	0
6	55217903	.	A	G	3	2	5	0	1	6	0	0
6	55217907	.	A	G	2	4	6	0	0	6	0	0
6	55218017	.	A	G	2	4	6	0	0	6	0	0
6	55218047	.	A	G	5	8	13	0	1	14	0	0
6	55218127	.	A	G	8	7	15	0	1	16	0	0
6	55218137	.	A	G	5	10	15	0	1	16	0	0
6	55218256	.	A	G	2	4	6	0	0	6	0	0
6	55218340	.	A	G	5	5	10	0	0	10	0	0
6	55277487	.	G	T	13	8	21	0	1	22	0	0
6	55277559	.	T	G	9	16	25	0	1	26	0	0
6	55288113	.	C	T	0	2	2	0	1	3	0	0
6	55291948	.	C	T	3	1	4	0	2	6	0	0
6	55291981	.	G	A	4	2	6	0	0	6	0	0
6	55296345	.	G	A	1	1	2	0	0	2	0	0
6	55328622	.	C	T	0	4	4	0	9	13	0	0
6	55336952	.	C	T	0	3	3	0	0	3	0	0
6	55337385	.	G	A	1	7	8	0	0	8	0	0
6	55353280	.	G	A	0	2	2	0	0	2	0	0
6	55353440	.	T	C	1	3	4	0	0	4	0	0
6	55373039	.	C	T	5	4	9	0	0	9	0	0
6	55373048	.	T	C	5	3	8	0	1	9	0	0
6	55383374	.	T	C	0	3	3	0	0	3	0	0
6	55393020	.	C	T	21	8	29	0	0	29	0	0
6	55393047	.	C	T	18	6	24	0	2	26	0	0
6	55393304	.	C	A	7	2	9	0	2	11	0	0
6	55397150	.	T	A	5	6	11	0	2	13	0	0
6	55397261	.	T	C	4	0	4	0	5	9	0	0
6	55397302	.	T	C	4	5	9	0	0	9	0	0
6	55399124	.	A	G	0	2	2	0	1	3	0	0
6	55408136	.	T	A	0	1	1	0	0	1	0	0
6	55422890	.	C	T	0	1	1	0	0	1	0	0
6	55429885	.	A	C	7	14	21	0	0	21	0	0
6	55429903	.	C	T	4	8	12	0	0	12	0	0
6	55432278	.	C	G	8	1	9	0	16	25	0	0
6	55432787	.	A	G	19	23	42	0	1	43	0	0
6	55432811	.	T	C	18	23	41	0	0	41	0	0
6	55434178	.	C	T	4	7	11	0	0	11	0	0
6	55436386	.	G	A	29	26	55	0	2	57	0	0
6	55436548	.	A	G	23	0	23	0	34	57	0	0
6	55436644	.	C	T	22	22	44	0	0	44	0	0
6	55436665	.	C	T	18	22	40	0	2	42	0	0
6	55436701	.	C	T	15	22	37	0	2	39	0	0
6	55436881	.	A	C	7	13	20	0	1	21	0	0
6	55449309	.	A	T	4	4	8	0	0	8	0	0
6	55449409	.	A	C	5	1	6	0	0	6	0	0
6	55449451	.	A	G	6	3	9	0	0	9	0	0
6	55449483	.	G	A	7	6	13	0	1	14	0	0
6	55451944	.	T	C	1	0	1	0	3	4	0	0
6	55452013	.	A	G	4	3	7	0	0	7	0	0
6	55453891	.	G	C	7	0	7	0	11	18	0	0
6	55455718	.	A	G	2	5	7	0	0	7	0	0
6	55469606	.	G	A	4	12	16	0	1	17	0	0
6	55476356	.	G	A	1	1	2	0	0	2	0	0
6	55479036	.	T	C	1	2	3	0	0	3	0	0
6	55479078	.	G	T	1	2	3	0	0	3	0	0
6	55482224	.	G	C	2	1	3	0	4	7	0	0
6	55486027	.	A	G	1	0	1	0	0	1	0	0
6	55488614	.	T	C	1	0	1	0	3	4	0	0
6	55578085	.	T	C	0	0	0	0	1	1	0	0
6	55910674	.	A	C	2	0	2	0	4	6	0	0
6	55910839	.	T	A	1	2	3	0	0	3	0	0
6	55933994	.	C	T	1	1	2	0	0	2	0	0
6	56076919	.	C	T	9	5	14	0	1	15	0	0
6	56079175	.	A	G	2	3	5	0	1	6	0	0
6	56080308	.	A	C	2	1	3	0	0	3	0	0
6	56116724	.	C	T	6	1	7	0	0	7	0	0
6	56116741	.	C	T	3	0	3	0	0	3	0	0
6	56132336	.	C	A	4	4	8	0	0	8	0	0
6	56132360	.	A	G	4	4	8	0	0	8	0	0
6	56138404	.	C	T	18	14	32	0	1	33	0	0
6	56138953	.	T	A	3	5	8	0	0	8	0	0
6	56139130	.	A	G	5	0	5	0	5	10	0	0
6	56139188	.	T	A	1	11	12	0	0	12	0	0
6	56139224	.	A	T	2	4	6	0	1	7	0	0
6	56683294	.	G	A	2	2	4	0	0	4	0	0
6	56779752	.	A	G	2	3	5	0	0	5	0	0
6	56779781	.	C	T	0	5	5	0	3	8	0	0
6	56844867	.	C	T	4	3	7	0	0	7	0	0
6	56844882	.	C	T	5	3	8	0	0	8	0	0
6	57402396	.	G	A	1	2	3	0	1	4	0	0
6	57425295	.	C	T	1	2	3	0	0	3	0	0
6	57439089	.	T	G	3	2	5	0	0	5	0	0
6	57439429	.	C	T	1	3	4	0	0	4	0	0
6	57455680	.	G	A	1	0	1	0	0	1	0	0
6	57455683	.	G	A	1	0	1	0	0	1	0	0
6	57459343	.	G	A	1	4	5	0	0	5	0	0
6	57465762	.	A	G	2	2	4	0	0	4	0	0
6	57476343	.	G	A	1	3	4	0	0	4	0	0
6	57478900	.	C	T	0	2	2	0	3	5	0	0
6	57481377	.	A	G	5	5	10	0	0	10	0	0
6	57492141	.	G	A	5	10	15	0	0	15	0	0
6	57492167	.	T	A	4	5	9	0	2	11	0	0
6	57492208	.	G	A	3	9	12	0	1	13	0	0
6	57492209	.	A	G	3	9	12	0	1	13	0	0
6	57498034	.	C	A	1	3	4	0	0	4	0	0
6	57500608	.	C	T	5	4	9	0	0	9	0	0
6	57500617	.	G	C	5	0	5	0	4	9	0	0
6	57503925	.	C	T	0	1	1	0	2	3	0	0
6	57504646	.	G	A	0	2	2	0	0	2	0	0
6	57510245	.	T	A	2	3	5	0	1	6	0	0
6	57510254	.	T	A	3	4	7	0	0	7	0	0
6	57519053	.	T	C	1	0	1	0	7	8	0	0
6	57519597	.	G	C	5	3	8	0	0	8	0	0
6	57523366	.	C	A	0	2	2	0	2	4	0	0
6	57541942	.	T	A	8	5	13	0	0	13	0	0
6	57583996	.	T	C	4	1	5	0	1	6	0	0
6	57595160	.	T	C	2	11	13	0	2	15	0	0
6	57595196	.	T	C	2	1	3	0	0	3	0	0
6	57618934	.	C	T	5	5	10	0	0	10	0	0
6	57620177	.	T	C	22	16	38	0	3	41	0	0
6	57620315	.	A	C	16	19	35	0	1	36	0	0
6	57630819	.	A	G	3	12	15	0	1	16	0	0
6	57630879	.	C	A	3	2	5	0	0	5	0	0
6	57634880	.	T	G	5	11	16	0	1	17	0	0
6	57634922	.	G	A	6	8	14	0	2	16	0	0
6	57634949	.	G	A	4	5	9	0	0	9	0	0
6	57644311	.	A	G	2	5	7	0	6	13	0	0
6	57644779	.	C	T	1	1	2	0	0	2	0	0
6	57651978	.	C	A	0	2	2	0	0	2	0	0
6	57652041	.	T	C	6	0	6	0	6	12	0	0
6	57900462	.	C	T	1	7	8	1	0	9	0	0
6	57901172	.	C	T	11	8	19	0	0	19	0	0
6	57930338	.	C	T	0	2	2	0	6	8	0	0
6	57984173	.	T	C	5	0	5	0	8	13	0	0
6	58038322	.	T	C	1	0	1	0	0	1	0	0
6	58315258	.	T	A	1	3	4	0	1	5	0	0
6	58315270	.	G	C	0	5	5	0	2	7	0	0
6	58315333	.	T	C	6	9	15	0	1	16	0	0
6	58334566	.	A	C	1	3	4	0	1	5	0	0
6	58359511	.	G	A	4	2	6	0	1	7	0	0
6	58367679	.	C	T	1	0	1	0	0	1	0	0
6	58370814	.	A	G	3	0	3	0	3	6	0	0
6	58370817	.	C	T	4	2	6	0	1	7	0	0
6	58373985	.	T	A	4	3	7	0	0	7	0	0
6	58374023	.	C	T	2	2	4	0	0	4	0	0
6	58374026	.	C	A	2	2	4	0	0	4	0	0
6	58381417	.	T	C	3	4	7	0	0	7	0	0
6	58382915	.	T	G	4	5	9	0	0	9	0	0
6	58382939	.	C	T	2	5	7	0	0	7	0	0
6	58382954	.	C	T	1	1	2	0	0	2	0	0
6	58384122	.	C	T	1	2	3	0	0	3	0	0
6	58389115	.	A	C	1	5	6	0	0	6	0	0
6	58389151	.	G	T	1	5	6	0	0	6	0	0
6	58393919	.	A	T	4	3	7	0	0	7	0	0
6	58395372	.	G	A	2	6	8	0	0	8	0	0
6	58395444	.	G	A	0	12	12	0	16	28	0	0
6	58448412	.	T	C	0	1	1	0	0	1	0	0
6	58463718	.	C	T	5	5	10	0	0	10	0	0
6	58463787	.	C	T	1	0	1	0	0	1	0	0
6	58495256	.	C	T	7	5	12	0	2	14	0	0
6	58495301	.	G	A	7	8	15	0	0	15	0	0
6	58495436	.	C	T	4	4	8	0	0	8	0	0
6	58495573	.	G	T	8	4	12	0	0	12	0	0
6	58495634	.	G	A	1	6	7	0	4	11	0	0
6	58496280	.	C	A	2	2	4	0	0	4	0	0
6	58496633	.	T	C	2	2	4	0	0	4	0	0
6	58496698	.	A	G	0	7	7	0	0	7	0	0
6	58496761	.	T	C	4	3	7	0	1	8	0	0
6	58498021	.	C	T	2	3	5	0	0	5	0	0
6	58498424	.	C	A	3	2	5	0	0	5	0	0
6	58498439	.	A	T	2	2	4	0	0	4	0	0
6	58499657	.	T	C	5	5	10	0	1	11	0	0
6	58522689	.	C	G	8	0	8	0	18	26	0	0
6	58522695	.	A	G	8	16	24	0	1	25	0	0
6	58549100	.	A	G	0	1	1	0	2	3	0	0
6	58560682	.	G	A	21	23	44	0	3	47	0	0
6	58560718	.	G	A	22	26	48	0	3	51	0	0
6	58560795	.	C	T	19	22	41	0	0	41	0	0
6	58561003	.	C	T	17	14	31	0	1	32	0	0
6	58561186	.	A	C	15	17	32	0	1	34	1	0
6	58561494	.	G	T	12	0	12	0	1	13	0	0
6	58562056	.	G	T	7	0	7	0	1	8	0	0
6	58562063	.	T	C	8	0	8	0	0	8	0	0
6	58562393	.	G	T	1	5	6	0	2	8	0	0
6	58563302	.	A	T	14	16	30	0	0	30	0	0
6	58563305	.	G	A	1	16	17	0	13	30	0	0
6	58698737	.	C	T	8	8	16	0	0	16	0	0
6	58698910	.	T	G	7	0	7	0	7	14	0	0
6	58712268	.	C	T	4	5	9	0	0	9	0	0
6	58712458	.	G	C	9	17	26	0	0	26	0	0
6	58712477	.	C	G	8	11	19	0	0	19	0	0
6	58712540	.	G	A	0	10	10	0	7	17	0	0
6	58712564	.	A	T	12	6	18	0	0	18	0	0
6	58726066	.	G	A	0	11	11	0	9	20	0	0
6	58726154	.	A	G	10	2	12	0	3	15	0	0
6	58728670	.	G	A	0	0	0	0	2	2	0	0
6	58728706	.	G	A	1	6	7	0	3	10	0	0
6	58728825	.	A	G	7	8	15	0	0	15	0	0
6	58728858	.	G	A	0	8	8	0	9	17	0	0
6	58728907	.	C	T	6	8	14	0	1	15	0	0
6	58728915	.	G	T	9	9	18	0	0	18	0	0
6	58729100	.	C	G	8	1	9	0	2	11	0	0
6	58729120	.	T	C	4	10	14	0	2	16	0	0
6	58730421	.	T	A	1	3	4	0	1	5	0	0
6	58732475	.	C	G	13	18	31	0	0	32	1	0
6	58756858	.	G	A	8	3	11	0	0	11	0	0
6	58778755	.	T	C	1	0	1	0	0	1	0	0
6	58780811	.	C	T	6	4	10	0	0	10	0	0
6	58781017	.	G	A	0	1	1	0	1	2	0	0
6	58781083	.	A	G	8	8	16	0	0	16	0	0
6	58781128	.	C	T	12	6	18	0	1	19	0	0
6	58784777	.	C	T	1	14	15	0	8	23	0	0
6	58786939	.	C	T	11	10	21	0	0	21	0	0
6	58808298	.	G	A	5	2	7	0	1	8	0	0
6	58808328	.	C	T	2	1	3	0	0	3	0	0
6	58828322	.	A	T	8	4	12	0	1	13	0	0
6	58832202	.	C	T	4	3	7	0	0	7	0	0
6	58852853	.	G	A	5	0	5	0	0	5	0	0
6	58855648	.	C	T	1	2	3	0	0	3	0	0
6	58856151	.	C	T	2	1	3	0	0	3	0	0
6	58859737	.	G	A	0	2	2	0	7	9	0	0
6	58861707	.	A	G	1	0	1	0	0	1	0	0
6	58862328	.	A	G	14	0	14	0	10	24	0	0
6	58862341	.	G	A	0	9	9	0	9	18	0	0
6	58863294	.	T	C	1	4	5	0	1	6	0	0
6	58867048	.	A	G	25	0	25	0	18	43	0	0
6	58867090	.	A	T	21	18	39	0	2	41	0	0
6	58867093	.	C	T	20	18	38	0	1	39	0	0
6	58867206	.	A	G	14	0	14	0	9	23	0	0
6	58867240	.	A	G	11	7	18	0	0	18	0	0
6	58867282	.	G	A	6	4	10	0	0	10	0	0
6	58867329	.	G	C	7	7	14	0	0	14	0	0
6	58867372	.	A	T	12	9	21	0	0	21	0	0
6	58875650	.	C	T	0	1	1	0	0	1	0	0
6	58878032	.	A	C	3	6	9	0	0	9	0	0
6	58889258	.	T	G	1	3	4	0	1	5	0	0
6	58889690	.	A	G	2	4	6	0	1	7	0	0
6	58891765	.	T	A	2	6	8	0	0	8	0	0
6	58892027	.	A	G	6	8	14	0	0	14	0	0
6	58892363	.	G	A	2	2	4	0	0	4	0	0
6	58892365	.	C	T	0	2	2	0	2	4	0	0
6	58921434	.	C	A	2	3	5	0	0	5	0	0
6	58921506	.	G	T	5	5	10	0	0	10	0	0
6	58931376	.	G	A	1	0	1	0	0	1	0	0
6	58948931	.	C	T	0	5	5	0	0	5	0	0
6	58949325	.	C	T	0	3	3	0	0	3	0	0
6	58949337	.	G	A	0	3	3	0	0	3	0	0
6	58949364	.	C	A	0	2	2	0	1	3	0	0
6	58950079	.	C	G	1	1	2	0	0	2	0	0
6	58953302	.	G	T	2	3	5	0	0	5	0	0
6	58953366	.	C	T	1	1	2	0	0	2	0	0
6	58974791	.	C	T	4	3	7	0	0	7	0	0
6	59813578	.	G	A	0	4	4	0	6	10	0	0
6	59813608	.	A	G	13	10	23	0	1	24	0	0
6	59813857	.	G	A	0	3	3	0	3	6	0	0
6	59813905	.	A	G	13	0	13	0	15	28	0	0
6	59819362	.	C	T	9	11	20	0	0	20	0	0
6	59824482	.	C	T	17	14	31	0	3	34	0	0
6	59824496	.	C	T	20	12	32	0	2	34	0	0
6	59824672	.	C	T	23	13	36	1	5	42	0	0
6	59824736	.	C	T	15	16	31	0	5	36	0	0
6	59832922	.	T	C	13	12	25	0	0	25	0	0
6	59833006	.	T	A	13	11	24	0	0	24	0	0
6	59833007	.	A	G	13	11	24	0	0	24	0	0
6	59837587	.	C	G	4	6	10	0	1	11	0	0
6	59837747	.	G	A	0	9	9	0	6	15	0	0
6	59839033	.	G	A	2	7	9	0	11	20	0	0
6	59839048	.	G	A	9	6	15	0	0	15	0	0
6	59841394	.	G	A	0	11	11	0	12	23	0	0
6	59845096	.	A	G	2	2	4	0	0	4	0	0
6	59848119	.	C	T	13	11	24	0	3	27	0	0
6	59848345	.	T	C	25	16	41	0	1	42	0	0
6	59848624	.	C	G	3	10	13	3	0	16	0	0
6	59848894	.	T	C	15	22	37	1	1	39	0	0
6	59850253	.	C	T	26	14	40	0	1	41	0	0
6	59850308	.	T	C	20	17	37	0	3	40	0	0
6	59854344	.	G	T	0	5	5	0	2	7	0	0
6	59874147	.	G	A	0	2	2	0	1	3	0	0
6	59882680	.	T	C	9	9	18	0	1	19	0	0
6	59882704	.	T	C	7	10	17	0	0	17	0	0
6	59883154	.	G	A	9	10	19	0	0	19	0	0
6	59883372	.	A	C	6	0	6	0	16	22	0	0
6	59889640	.	G	T	0	4	4	0	2	6	0	0
6	59890125	.	C	T	1	0	1	0	0	1	0	0
6	59891289	.	T	C	10	7	17	0	0	17	0	0
6	59892864	.	C	T	5	2	7	0	0	7	0	0
6	59894548	.	T	C	11	13	24	0	0	24	0	0
6	59894580	.	T	A	12	10	22	0	3	25	0	0
6	59894719	.	T	C	13	2	15	0	1	16	0	0
6	59915599	.	T	C	2	0	2	0	0	2	0	0
6	59915608	.	T	C	0	0	0	0	1	1	0	0
6	59921661	.	T	G	10	11	21	0	1	22	0	0
6	59921685	.	T	C	10	10	20	0	0	20	0	0
6	59921788	.	A	C	8	4	12	0	0	12	0	0
6	59939277	.	G	A	9	6	15	0	0	15	0	0
6	59945088	.	A	G	0	1	1	0	0	1	0	0
6	59947097	.	C	A	3	4	7	0	0	7	0	0
6	59949374	.	C	A	3	3	6	0	0	6	0	0
6	59951450	.	T	A	4	3	7	0	0	7	0	0
6	59951483	.	C	G	2	4	6	0	0	6	0	0
6	59968016	.	T	C	6	6	12	0	1	13	0	0
6	59968039	.	T	C	0	12	12	0	0	12	0	0
6	59968057	.	T	C	0	13	13	0	0	13	0	0
6	59971370	.	A	C	10	14	24	0	14	38	0	0
6	59971416	.	C	T	18	26	44	0	2	46	0	0
6	59971711	.	G	A	14	18	32	4	2	38	0	0
6	59971718	.	C	A	13	21	34	4	1	39	0	0
6	59971897	.	G	A	3	4	7	1	1	9	0	0
6	59972132	.	A	G	13	0	13	0	5	18	0	0
6	59972259	.	T	A	9	15	24	1	0	25	0	0
6	59985833	.	C	T	2	3	5	0	1	6	0	0
6	60031520	.	G	A	8	4	12	0	1	13	0	0
6	60031641	.	C	T	0	4	4	0	10	14	0	0
6	60043150	.	A	G	4	2	6	0	1	7	0	0
6	60043179	.	T	C	5	4	9	0	0	9	0	0
6	60043229	.	A	T	0	3	3	0	0	3	0	0
6	60043297	.	T	A	1	2	3	0	1	4	0	0
6	60043413	.	G	A	9	6	15	0	0	15	0	0
6	60043580	.	G	C	2	3	5	0	0	5	0	0
6	60044319	.	T	A	7	4	11	0	2	13	0	0
6	60044320	.	A	T	8	5	13	0	0	13	0	0
6	60044373	.	G	A	4	3	7	0	1	8	0	0
7	742828	.	T	C	10	25	35	0	1	36	0	0
7	837955	.	T	G	3	3	6	0	0	6	0	0
7	847189	.	A	T	7	9	16	0	1	17	0	0
7	860914	.	A	G	2	5	7	0	0	7	0	0
7	861057	.	G	C	2	2	4	0	0	4	0	0
7	1418299	.	A	G	1	6	7	0	1	8	0	0
7	1418310	.	T	C	1	6	7	0	0	7	0	0
7	1418631	.	T	C	0	2	2	0	0	2	0	0
7	3931029	.	A	G	31	14	45	0	2	47	0	0
7	3931264	.	C	T	23	19	42	0	2	44	0	0
7	3931396	.	A	T	29	29	58	0	1	59	0	0
7	3931543	.	A	T	28	10	38	0	0	38	0	0
7	3931598	.	G	T	21	24	45	0	1	46	0	0
7	3931644	.	T	C	28	0	28	0	13	41	0	0
7	3931976	.	C	T	0	10	10	1	1	12	0	0
7	3932044	.	T	C	20	5	25	0	1	26	0	0
7	3932209	.	A	T	19	18	37	0	1	38	0	0
7	3932402	.	T	C	11	17	28	0	1	29	0	0
7	3932405	.	A	T	11	18	29	0	0	29	0	0
7	3932463	.	T	G	9	10	19	1	1	21	0	0
7	3932546	.	C	A	4	4	8	0	1	9	0	0
7	3932694	.	G	A	23	11	34	0	1	35	0	0
7	3932698	.	T	C	22	12	34	0	3	37	0	0
7	3932731	.	C	A	22	18	40	0	3	43	0	0
7	3932935	.	C	A	18	17	35	0	1	36	0	0
7	3933121	.	G	A	22	23	45	0	2	47	0	0
7	3933243	.	C	A	16	11	27	0	0	27	0	0
7	3933271	.	C	T	23	14	37	0	0	37	0	0
7	3933383	.	A	C	12	0	12	0	17	29	0	0
7	3933481	.	T	C	23	0	23	0	14	37	0	0
7	3933483	.	C	T	0	12	12	0	25	37	0	0
7	3933998	.	C	T	12	12	24	0	0	24	0	0
7	3934038	.	A	T	10	14	24	0	0	24	0	0
7	3934387	.	C	T	18	19	37	0	3	40	0	0
7	3934428	.	G	T	17	25	42	0	1	44	1	0
7	3934551	.	A	T	15	4	19	0	0	19	0	0
7	3934645	.	A	C	4	16	20	0	3	23	0	0
7	3934818	.	G	A	13	7	20	0	0	20	0	0
7	3934970	.	A	G	5	16	21	0	1	22	0	0
7	3935055	.	T	C	7	20	27	0	1	28	0	0
7	3935123	.	A	G	7	13	20	0	3	23	0	0
7	3935171	.	G	C	19	7	26	0	0	26	0	0
7	3935283	.	G	A	9	19	28	0	1	29	0	0
7	3935737	.	C	T	0	16	16	0	14	30	0	0
7	3935788	.	C	A	6	5	11	0	2	13	0	0
7	3936127	.	C	T	0	8	8	0	16	24	0	0
7	3936764	.	G	A	9	4	13	0	0	13	0	0
7	3936946	.	C	T	0	1	1	0	7	8	0	0
7	3951115	.	G	A	3	1	4	0	0	4	0	0
7	3955628	.	G	A	3	2	5	0	0	5	0	0
7	4088334	.	C	T	17	17	34	0	2	36	0	0
7	4088545	.	C	T	0	21	21	0	8	29	0	0
7	4088680	.	G	A	9	13	22	0	3	25	0	0
7	4088727	.	A	T	19	12	31	0	3	34	0	0
7	4088832	.	A	G	15	19	34	0	1	35	0	0
7	4089042	.	A	G	20	16	36	0	1	37	0	0
7	4089090	.	G	A	8	8	16	0	4	20	0	0
7	4095265	.	C	T	0	12	12	0	14	26	0	0
7	4100931	.	C	T	8	9	17	0	1	18	0	0
7	4100967	.	G	A	14	14	28	0	0	28	0	0
7	4110441	.	T	C	1	0	1	0	0	1	0	0
7	4167386	.	C	T	2	0	2	0	0	2	0	0
7	4174962	.	G	A	0	6	6	0	3	9	0	0
7	4175054	.	G	A	1	4	5	0	1	6	0	0
7	4175078	.	G	A	2	2	4	0	0	4	0	0
7	4177088	.	T	C	1	1	2	0	0	2	0	0
7	4177235	.	A	G	1	2	3	0	0	3	0	0
7	4177346	.	T	G	4	4	8	0	0	8	0	0
7	4180324	.	A	G	2	2	4	0	0	4	0	0
7	4180419	.	G	A	1	3	4	0	0	4	0	0
7	4180728	.	G	T	4	2	6	0	0	6	0	0
7	4180742	.	C	T	2	4	6	0	1	7	0	0
7	4181167	.	C	T	3	3	6	0	0	6	0	0
7	4181728	.	G	A	0	6	6	0	0	6	0	0
7	4183222	.	C	G	2	2	4	0	0	4	0	0
7	4183317	.	G	A	3	2	5	0	0	5	0	0
7	4183345	.	C	T	3	3	6	0	0	6	0	0
7	4184141	.	A	G	1	3	4	0	0	4	0	0
7	4184897	.	G	T	2	2	4	0	0	4	0	0
7	4185160	.	A	T	6	12	18	0	0	18	0	0
7	4186499	.	A	G	3	2	5	1	0	6	0	0
7	5180761	.	T	C	6	0	6	0	5	11	0	0
7	7042115	.	A	G	18	6	24	0	3	27	0	0
7	7242384	.	T	C	1	5	6	0	0	6	0	0
7	7245508	.	C	G	1	3	4	0	0	4	0	0
7	7248193	.	C	T	9	11	20	0	3	23	0	0
7	7248212	.	A	T	6	8	14	0	4	18	0	0
7	7372404	.	A	G	9	11	20	0	0	20	0	0
7	7478271	.	T	C	2	3	5	0	0	5	0	0
7	7478281	.	T	C	2	2	4	0	1	5	0	0
7	7478511	.	T	C	18	1	19	0	6	25	0	0
7	7478533	.	T	C	11	12	23	0	0	23	0	0
7	7478546	.	T	C	13	9	22	0	1	23	0	0
7	7552113	.	G	A	10	14	24	0	0	24	0	0
7	7597059	.	A	G	2	0	2	0	1	3	0	0
7	7608920	.	G	A	0	6	6	0	8	14	0	0
7	7608944	.	T	G	11	0	11	0	10	21	0	0
7	7608965	.	C	T	11	11	22	0	2	24	0	0
7	7611758	.	C	T	20	14	34	0	0	34	0	0
7	7611803	.	C	A	9	5	14	0	13	27	0	0
7	7611866	.	T	C	11	14	25	0	1	26	0	0
7	7617855	.	T	C	14	16	30	0	2	32	0	0
7	7617963	.	C	G	16	17	33	0	1	34	0	0
7	7624082	.	A	G	17	27	44	0	4	48	0	0
7	7624090	.	T	C	22	23	45	0	2	47	0	0
7	7641230	.	A	T	24	15	39	0	3	42	0	0
7	7641351	.	G	A	16	22	38	0	1	39	0	0
7	7641353	.	G	A	15	22	37	0	2	39	0	0
7	7641559	.	C	T	22	14	36	0	3	39	0	0
7	7641567	.	C	T	21	14	35	0	2	38	1	0
7	7641608	.	A	G	21	14	35	0	0	35	0	0
7	7641678	.	T	A	22	6	28	0	2	30	0	0
7	7641976	.	T	C	12	14	26	0	0	26	0	0
7	7641984	.	G	T	11	10	21	0	2	23	0	0
7	7642730	.	C	T	21	10	31	0	1	32	0	0
7	7642819	.	G	A	17	18	35	0	2	37	0	0
7	7642840	.	T	A	15	13	28	0	2	30	0	0
7	7642856	.	C	T	14	14	28	0	1	29	0	0
7	7642944	.	C	T	8	6	14	0	1	15	0	0
7	7642991	.	T	A	3	4	7	0	0	7	0	0
7	7643184	.	A	G	14	1	15	0	13	28	0	0
7	7643348	.	G	A	22	18	40	0	4	44	0	0
7	7643362	.	T	A	23	19	42	0	5	47	0	0
7	7643488	.	A	G	22	26	48	0	2	50	0	0
7	7643629	.	A	G	25	25	50	0	7	57	0	0
7	7662467	.	C	G	5	15	20	0	0	20	0	0
7	7662475	.	T	C	5	1	6	0	14	20	0	0
7	7662527	.	A	C	8	11	19	0	1	20	0	0
7	7662580	.	G	A	11	17	28	0	0	28	0	0
7	7662872	.	A	C	12	11	23	0	0	23	0	0
7	7662978	.	A	C	10	9	19	0	0	19	0	0
7	7663017	.	T	A	16	21	37	0	0	37	0	0
7	7663048	.	A	G	21	17	38	0	0	38	0	0
7	7663132	.	A	G	13	12	25	0	0	25	0	0
7	7663152	.	A	T	10	10	20	0	1	22	1	0
7	7663320	.	C	G	18	5	23	0	2	25	0	0
7	7663449	.	A	C	22	0	22	0	6	28	0	0
7	7663453	.	A	T	20	6	26	0	1	27	0	0
7	7663682	.	C	T	0	8	8	0	14	22	0	0
7	7663902	.	G	T	13	6	19	0	1	20	0	0
7	7664083	.	G	A	8	4	12	0	0	12	0	0
7	7664558	.	G	T	8	9	17	2	0	19	0	0
7	7664838	.	G	T	10	5	15	0	1	16	0	0
7	7664870	.	G	T	5	4	9	0	0	9	0	0
7	7664882	.	G	C	7	5	12	0	0	12	0	0
7	7664912	.	A	C	7	3	10	0	0	10	0	0
7	7665338	.	G	T	16	9	25	0	0	25	0	0
7	7665353	.	T	A	17	8	25	0	0	25	0	0
7	7665480	.	A	C	10	5	15	0	0	15	0	0
7	7666388	.	G	A	13	17	30	0	0	30	0	0
7	7666625	.	G	A	13	9	22	0	0	22	0	0
7	7674378	.	T	C	7	0	7	0	19	26	0	0
7	7674462	.	C	G	5	4	9	0	0	9	0	0
7	7674474	.	T	A	3	0	3	0	1	4	0	0
7	7676086	.	C	T	3	4	7	0	0	7	0	0
7	7676112	.	C	T	5	4	9	0	0	9	0	0
7	7683342	.	G	A	1	0	1	0	0	1	0	0
7	7684895	.	T	A	1	1	2	0	0	2	0	0
7	7687435	.	G	A	1	0	1	0	0	1	0	0
7	7696726	.	G	C	8	8	16	0	0	16	0	0
7	7696742	.	A	G	8	9	17	0	1	18	0	0
7	7696785	.	T	A	3	7	10	0	0	10	0	0
7	7696794	.	G	T	0	8	8	0	2	10	0	0
7	7700867	.	G	A	0	1	1	0	0	1	0	0
7	7700965	.	T	G	8	0	8	0	9	17	0	0
7	7700987	.	T	C	7	12	19	0	1	20	0	0
7	7701016	.	G	C	4	10	14	0	1	15	0	0
7	7701293	.	T	C	2	7	9	0	0	9	0	0
7	7705993	.	C	G	2	0	2	0	12	14	0	0
7	7706005	.	C	T	3	9	12	0	3	15	0	0
7	7706702	.	G	A	0	4	4	0	4	8	0	0
7	7706869	.	A	G	3	6	9	0	0	9	0	0
7	7706997	.	C	A	12	7	19	0	0	19	0	0
7	7707029	.	T	G	13	5	18	0	1	19	0	0
7	7707191	.	A	C	6	3	9	0	0	9	0	0
7	7708527	.	C	T	3	4	7	0	1	8	0	0
7	7708572	.	T	C	3	4	7	0	0	7	0	0
7	7708714	.	T	C	3	4	7	0	1	8	0	0
7	7709061	.	A	G	3	2	5	0	0	5	0	0
7	7709233	.	C	T	2	2	4	0	0	4	0	0
7	7709282	.	T	A	4	2	6	0	0	6	0	0
7	7711612	.	T	A	1	2	3	0	0	3	0	0
7	7711631	.	C	T	2	2	4	0	0	4	0	0
7	7711649	.	T	C	1	0	1	0	2	3	0	0
7	7717685	.	G	A	0	1	1	0	0	1	0	0
7	7779047	.	A	T	1	6	7	0	0	7	0	0
7	7779060	.	G	A	0	4	4	0	1	5	0	0
7	8694709	.	T	A	4	3	7	0	0	7	0	0
7	8694818	.	T	G	3	3	6	0	2	8	0	0
7	8694999	.	T	A	1	2	3	0	0	3	0	0
7	8695001	.	C	A	1	2	3	0	0	3	0	0
7	8695191	.	C	T	0	2	2	0	3	5	0	0
7	8890495	.	C	T	0	12	12	0	4	16	0	0
7	8890515	.	G	C	6	0	6	0	15	21	0	0
7	8891675	.	T	A	4	5	9	0	0	9	0	0
7	8891710	.	A	G	4	11	15	0	1	16	0	0
7	8891717	.	A	G	4	10	14	0	1	15	0	0
7	8891755	.	T	G	6	7	13	0	0	13	0	0
7	8893506	.	T	C	2	2	4	0	0	4	0	0
7	8909438	.	C	T	1	3	4	0	0	4	0	0
7	8950378	.	G	A	1	3	4	0	0	4	0	0
7	9229327	.	A	C	3	3	6	0	0	6	0	0
7	9238631	.	A	G	0	0	0	0	1	1	0	0
7	9261589	.	T	C	5	4	9	0	0	9	0	0
7	9290962	.	A	G	3	2	5	0	0	5	0	0
7	9291049	.	C	A	9	11	20	0	4	24	0	0
7	9302654	.	G	A	0	5	5	0	4	9	0	0
7	9302664	.	T	C	5	5	10	0	0	10	0	0
7	9302736	.	C	A	1	6	7	0	2	9	0	0
7	9302750	.	A	G	2	5	7	0	1	8	0	0
7	9302796	.	A	G	4	7	11	0	1	12	0	0
7	9302990	.	T	A	10	4	14	0	0	15	1	0
7	9303000	.	T	A	12	5	17	0	0	17	0	0
7	9304692	.	T	C	4	4	8	0	1	9	0	0
7	9308683	.	A	G	16	17	33	0	0	33	0	0
7	9308715	.	C	T	11	21	32	0	2	34	0	0
7	9308817	.	A	G	6	5	11	0	0	11	0	0
7	9312770	.	G	A	0	8	8	0	10	18	0	0
7	9317990	.	G	A	0	2	2	0	0	2	0	0
7	9319626	.	T	C	15	18	33	0	2	35	0	0
7	9319774	.	A	C	1	3	4	0	0	4	0	0
7	9320085	.	A	G	1	2	3	0	0	3	0	0
7	9320431	.	A	T	4	12	16	0	2	18	0	0
7	9320489	.	A	G	12	8	20	0	1	21	0	0
7	9320719	.	C	T	16	12	28	0	1	29	0	0
7	9321124	.	G	A	0	8	8	0	2	11	1	0
7	9321188	.	G	A	5	6	11	0	2	13	0	0
7	9321374	.	C	T	6	9	15	0	1	16	0	0
7	9321375	.	T	A	7	9	16	0	0	16	0	0
7	9321528	.	A	C	4	2	6	0	3	9	0	0
7	9321529	.	C	G	7	0	7	0	2	9	0	0
7	9321800	.	G	A	0	4	4	0	17	21	0	0
7	9321981	.	G	T	20	19	39	0	0	39	0	0
7	9322271	.	G	C	9	18	27	0	0	27	0	0
7	9322441	.	C	T	5	6	11	0	0	11	0	0
7	9509429	.	C	T	2	4	6	0	0	6	0	0
7	9509450	.	C	T	2	3	5	0	0	5	0	0
7	9509567	.	G	T	0	3	3	0	2	5	0	0
7	9509583	.	A	C	1	3	4	0	0	4	0	0
7	9511184	.	C	T	3	4	7	0	1	8	0	0
7	10875101	.	A	G	11	15	26	0	1	27	0	0
7	10875135	.	A	G	17	0	17	0	8	25	0	0
7	10875187	.	A	G	20	11	31	0	2	33	0	0
7	10875386	.	A	G	20	10	30	0	0	30	0	0
7	10875552	.	A	G	13	9	22	0	0	22	0	0
7	10875746	.	A	G	17	7	24	0	4	28	0	0
7	10875761	.	A	G	19	10	29	0	3	32	0	0
7	10875930	.	A	G	19	11	30	0	0	30	0	0
7	10875937	.	A	G	15	16	31	0	0	31	0	0
7	11005693	.	G	T	5	2	7	0	0	7	0	0
7	11340820	.	A	G	5	5	10	0	1	11	0	0
7	12844513	.	T	C	3	5	8	0	0	8	0	0
7	12844537	.	T	C	7	5	12	0	0	12	0	0
7	12844549	.	T	C	7	0	7	0	6	13	0	0
7	13334748	.	G	A	6	2	8	0	1	9	0	0
7	13569969	.	C	G	0	2	2	2	0	4	0	0
7	13570726	.	C	A	1	4	5	2	1	8	0	0
7	13614246	.	A	G	1	1	2	0	0	2	0	0
7	14203761	.	A	G	2	3	5	0	0	5	0	0
7	14203788	.	A	G	3	2	5	0	0	5	0	0
7	15603595	.	A	G	2	2	4	0	0	4	0	0
7	15603602	.	A	G	2	2	4	0	0	4	0	0
7	15605057	.	A	G	3	0	3	0	2	5	0	0
7	15607890	.	A	G	7	3	10	0	0	10	0	0
7	15608410	.	A	G	8	5	13	0	0	13	0	0
7	16461045	.	C	T	5	2	7	0	0	7	0	0
7	16461094	.	G	T	3	2	5	0	0	5	0	0
7	17761684	.	T	C	5	2	7	0	0	7	0	0
7	17761699	.	T	C	4	2	6	0	0	6	0	0
7	17942540	.	A	G	3	3	6	0	0	6	0	0
7	17969778	.	A	G	3	2	5	0	0	5	0	0
7	17969792	.	A	G	2	3	5	0	0	5	0	0
7	17970558	.	C	T	0	11	11	0	0	11	0	0
7	17970569	.	G	A	9	5	14	0	1	15	0	0
7	18445662	.	T	C	2	1	3	0	0	3	0	0
7	18445664	.	C	T	2	1	3	0	0	3	0	0
7	18619990	.	C	T	1	5	6	0	0	6	0	0
7	19073788	.	T	C	4	12	16	0	0	16	0	0
7	19073818	.	T	C	2	6	8	0	0	8	0	0
7	19745853	.	G	A	0	1	1	0	1	2	0	0
7	19753008	.	C	A	1	2	3	0	1	4	0	0
7	19759079	.	G	T	0	2	2	0	0	2	0	0
7	19759194	.	C	A	2	3	5	0	0	5	0	0
7	19759209	.	G	A	0	3	3	0	6	9	0	0
7	19759263	.	T	A	7	4	11	0	1	12	0	0
7	19759296	.	C	T	5	2	7	0	1	8	0	0
7	19759299	.	A	T	5	3	8	0	0	8	0	0
7	19759550	.	C	T	7	3	10	0	1	11	0	0
7	19759895	.	C	T	8	2	10	0	1	11	0	0
7	19891365	.	A	G	6	1	7	0	3	10	0	0
7	19891551	.	G	A	3	2	5	0	0	5	0	0
7	19891556	.	T	C	4	1	5	0	0	5	0	0
7	19891779	.	G	C	1	2	3	0	0	3	0	0
7	19892592	.	A	G	4	0	4	0	8	12	0	0
7	19892880	.	G	A	0	6	6	0	3	9	0	0
7	19893023	.	A	G	4	2	6	0	0	6	0	0
7	19893149	.	T	G	3	3	6	0	0	6	0	0
7	19893623	.	A	C	2	2	4	0	0	4	0	0
7	19893627	.	G	A	0	1	1	0	1	2	0	0
7	19893705	.	A	T	1	5	6	0	1	7	0	0
7	19894006	.	A	T	2	1	3	0	0	3	0	0
7	19894016	.	A	G	3	2	5	0	0	5	0	0
7	19894099	.	A	G	4	1	5	0	4	9	0	0
7	19894469	.	G	A	1	3	4	0	0	4	0	0
7	19894471	.	G	A	1	3	4	0	0	4	0	0
7	19895088	.	G	A	0	3	3	0	7	10	0	0
7	19895139	.	G	C	3	4	7	0	1	8	0	0
7	19895268	.	G	A	2	2	4	0	0	4	0	0
7	19895506	.	G	A	0	2	2	0	3	5	0	0
7	19895683	.	C	T	6	3	9	0	0	9	0	0
7	19895919	.	C	G	3	2	5	0	0	5	0	0
7	19895958	.	G	A	4	2	6	0	0	6	0	0
7	19895963	.	G	T	4	2	6	0	0	6	0	0
7	19896400	.	A	C	6	5	11	0	0	11	0	0
7	19897309	.	C	T	6	5	11	0	0	11	0	0
7	19897599	.	G	A	2	2	4	0	0	4	0	0
7	19897959	.	T	C	10	6	16	0	2	18	0	0
7	19910438	.	A	T	3	3	6	0	0	6	0	0
7	19965281	.	G	A	7	4	11	0	0	11	0	0
7	19966273	.	T	G	4	3	7	0	0	7	0	0
7	19978847	.	G	A	2	2	4	0	2	6	0	0
7	19979028	.	C	T	3	3	6	0	0	6	0	0
7	19979561	.	C	T	0	3	3	0	1	4	0	0
7	19979575	.	G	T	1	3	4	0	0	4	0	0
7	19979669	.	G	A	3	2	5	0	0	5	0	0
7	19979876	.	A	C	4	1	5	0	3	8	0	0
7	19979943	.	A	T	8	4	12	0	0	12	0	0
7	19979968	.	C	A	0	3	3	0	5	8	0	0
7	19984249	.	A	G	0	2	2	0	0	2	0	0
7	19988581	.	G	A	3	4	7	0	1	8	0	0
7	19991770	.	T	C	2	0	2	0	4	6	0	0
7	19991783	.	G	T	1	2	3	0	0	3	0	0
7	19998712	.	G	T	0	1	1	0	0	1	0	0
7	20026760	.	T	C	1	3	4	0	0	4	0	0
7	20027595	.	A	T	5	6	11	0	0	11	0	0
7	20027717	.	G	A	2	7	9	0	0	9	0	0
7	20028007	.	T	C	3	2	5	0	0	5	0	0
7	20028011	.	G	A	3	2	5	0	0	5	0	0
7	20118228	.	C	G	1	4	5	0	0	5	0	0
7	20118330	.	T	C	3	4	7	0	0	7	0	0
7	20141697	.	T	C	19	8	27	0	0	27	0	0
7	20141823	.	A	G	13	12	25	0	0	25	0	0
7	20141916	.	T	C	9	4	13	0	1	14	0	0
7	20142253	.	A	T	1	6	7	0	0	7	0	0
7	20142360	.	A	G	0	2	2	0	1	3	0	0
7	20142361	.	A	T	1	2	3	0	0	3	0	0
7	20142497	.	T	A	1	2	3	0	1	4	0	0
7	20176444	.	A	T	4	3	7	0	0	7	0	0
7	20222385	.	A	G	3	5	8	0	0	8	0	0
7	20222861	.	C	G	2	3	5	0	0	5	0	0
7	20222949	.	A	C	5	5	10	0	0	10	0	0
7	20222993	.	A	T	9	7	16	0	1	17	0	0
7	20223074	.	G	A	3	8	11	0	0	11	0	0
7	20223079	.	A	G	3	6	9	0	0	9	0	0
7	20223110	.	G	A	2	5	7	0	0	7	0	0
7	20223208	.	G	C	1	3	4	0	0	4	0	0
7	20223384	.	A	C	4	4	8	0	0	8	0	0
7	20223385	.	C	T	4	4	8	0	0	8	0	0
7	20223478	.	T	A	9	5	14	0	0	14	0	0
7	20223568	.	C	T	9	5	14	0	1	15	0	0
7	20223632	.	C	T	6	7	13	0	1	14	0	0
7	20223880	.	G	A	0	2	2	0	2	4	0	0
7	20293939	.	G	A	2	3	5	0	0	5	0	0
7	20295116	.	T	C	2	3	5	0	0	5	0	0
7	20298598	.	A	T	3	0	3	0	0	3	0	0
7	20298670	.	T	C	5	5	10	0	1	11	0	0
7	20298709	.	A	C	2	5	7	0	0	7	0	0
7	20298789	.	C	G	5	7	12	0	0	12	0	0
7	20298851	.	C	G	2	3	5	0	0	5	0	0
7	20302952	.	A	G	12	8	20	0	1	21	0	0
7	20305694	.	C	T	2	1	3	0	0	3	0	0
7	20305697	.	C	T	2	1	3	0	0	3	0	0
7	20310893	.	T	C	4	6	10	0	0	10	0	0
7	20310929	.	T	C	8	10	18	0	2	20	0	0
7	20315913	.	G	A	4	5	9	0	0	9	0	0
7	20325995	.	C	T	4	5	9	0	0	9	0	0
7	20326405	.	T	C	1	1	2	0	0	2	0	0
7	20332513	.	T	C	12	11	23	0	3	26	0	0
7	20332775	.	A	T	9	7	16	0	0	16	0	0
7	20332784	.	G	A	9	9	18	0	1	19	0	0
7	20332959	.	G	A	10	9	19	0	1	20	0	0
7	20332963	.	G	A	10	8	18	0	0	18	0	0
7	20333061	.	A	G	2	1	3	0	7	10	0	0
7	20333076	.	C	A	1	5	6	0	0	6	0	0
7	20333120	.	A	C	4	6	10	0	0	10	0	0
7	20333276	.	T	G	7	11	18	0	0	18	0	0
7	20334603	.	T	C	8	9	17	0	0	17	0	0
7	20334891	.	T	G	3	6	9	0	0	9	0	0
7	20780758	.	T	C	8	5	13	0	0	13	0	0
7	20781253	.	T	C	8	5	13	0	0	13	0	0
7	20781291	.	T	C	7	4	11	0	0	11	0	0
7	20781528	.	T	C	5	3	8	0	2	10	0	0
7	20781535	.	T	C	7	3	10	0	0	10	0	0
7	20781593	.	T	C	2	3	5	0	0	5	0	0
7	22799377	.	A	C	4	1	5	0	15	20	0	0
7	22800390	.	G	T	3	10	13	0	1	14	0	0
7	23969086	.	T	C	0	4	4	0	0	4	0	0
7	23969092	.	T	C	1	3	4	0	0	4	0	0
7	24068761	.	G	T	3	3	6	0	1	7	0	0
7	24494333	.	A	G	4	3	7	0	0	7	0	0
7	24672766	.	A	G	2	2	4	0	0	4	0	0
7	25293637	.	A	G	1	2	3	0	0	3	0	0
7	26078516	.	T	A	22	7	29	0	6	35	0	0
7	26148796	.	C	T	9	4	13	0	1	14	0	0
7	27681025	.	G	T	8	9	17	0	0	17	0	0
7	27681071	.	A	T	9	12	21	0	0	21	0	0
7	27682919	.	C	T	8	7	15	0	1	16	0	0
7	27700517	.	G	A	6	10	16	0	1	17	0	0
7	27700777	.	C	T	0	8	8	0	15	23	0	0
7	27701155	.	C	G	0	7	7	0	2	9	0	0
7	27701231	.	T	A	8	7	15	0	1	16	0	0
7	27701348	.	A	C	4	7	11	0	0	11	0	0
7	27701431	.	T	A	5	6	11	0	0	11	0	0
7	27701561	.	A	T	6	11	17	0	0	17	0	0
7	27701623	.	C	A	3	5	8	0	0	8	0	0
7	27701634	.	A	G	2	2	4	0	0	4	0	0
7	27702003	.	A	C	5	3	8	0	0	8	0	0
7	27702571	.	T	G	6	3	9	0	2	11	0	0
7	27702934	.	G	A	9	4	13	0	1	14	0	0
7	27703102	.	T	C	2	0	2	0	0	2	0	0
7	27705837	.	G	A	4	10	14	0	0	14	0	0
7	27718258	.	C	G	0	1	1	0	2	3	0	0
7	27720520	.	A	G	1	1	2	0	0	2	0	0
7	27722513	.	A	G	3	1	4	0	1	5	0	0
7	27722534	.	A	G	6	5	11	0	0	11	0	0
7	27797760	.	A	G	2	2	4	0	0	4	0	0
7	27798561	.	A	C	11	7	18	0	0	18	0	0
7	27805487	.	A	G	4	5	9	0	0	9	0	0
7	27805547	.	C	T	4	2	6	0	1	7	0	0
7	27806074	.	G	A	0	7	7	0	4	11	0	0
7	27811770	.	C	T	14	10	24	0	0	24	0	0
7	27813749	.	C	T	3	5	8	0	3	11	0	0
7	27813942	.	G	A	10	7	17	0	1	18	0	0
7	27813978	.	A	G	8	1	9	0	9	18	0	0
7	27814326	.	C	T	9	10	19	0	0	19	0	0
7	27816668	.	T	C	10	18	28	0	1	29	0	0
7	27816875	.	C	T	15	11	26	0	1	27	0	0
7	27817229	.	C	A	12	12	24	0	1	25	0	0
7	27817283	.	A	G	9	0	9	0	14	23	0	0
7	27817755	.	G	C	3	7	10	0	0	10	0	0
7	27820177	.	G	A	5	6	11	0	0	11	0	0
7	27820838	.	G	A	2	3	5	0	0	5	0	0
7	27834170	.	A	G	3	8	11	0	0	11	0	0
7	27884185	.	A	G	7	10	17	0	1	18	0	0
7	27884211	.	A	G	7	7	14	0	1	15	0	0
7	27884904	.	A	G	3	4	7	0	0	7	0	0
7	27884908	.	A	G	3	0	3	0	3	6	0	0
7	27885000	.	T	C	4	3	7	0	0	7	0	0
7	27885043	.	C	T	2	2	4	0	0	4	0	0
7	27885160	.	A	G	4	3	7	0	0	7	0	0
7	27885364	.	A	T	1	2	3	0	0	3	0	0
7	27885365	.	A	C	1	2	3	0	0	3	0	0
7	27885703	.	A	T	7	4	11	0	0	11	0	0
7	27885706	.	C	T	7	4	11	0	0	11	0	0
7	27885941	.	G	A	8	6	14	0	0	14	0	0
7	27886502	.	A	T	8	2	10	0	0	10	0	0
7	27886508	.	A	T	7	3	10	0	0	10	0	0
7	27886602	.	C	A	6	5	11	0	0	11	0	0
7	27886923	.	A	G	8	11	19	0	0	19	0	0
7	27886924	.	A	G	8	11	19	0	0	19	0	0
7	27976894	.	C	T	7	5	12	0	0	12	0	0
7	27977061	.	C	T	3	2	5	0	0	5	0	0
7	27977083	.	G	A	0	1	1	0	1	2	0	0
7	28033649	.	G	A	0	0	0	0	1	1	0	0
7	28039990	.	G	A	0	5	5	0	9	14	0	0
7	28040014	.	G	T	0	4	4	0	12	16	0	0
7	28040083	.	T	C	1	0	1	0	0	1	0	0
7	28040885	.	T	C	3	4	7	0	0	7	0	0
7	28041147	.	G	A	0	5	5	0	3	8	0	0
7	28041246	.	T	G	4	0	4	0	4	8	0	0
7	28041496	.	T	C	6	4	10	0	1	11	0	0
7	28041538	.	T	C	3	6	9	0	0	9	0	0
7	28041615	.	C	T	7	3	10	0	0	10	0	0
7	28041736	.	A	G	3	5	8	0	0	8	0	0
7	28041842	.	T	C	8	5	13	0	0	13	0	0
7	28041942	.	T	C	8	5	13	0	1	14	0	0
7	28042060	.	G	A	0	12	12	0	0	12	0	0
7	28042070	.	A	C	1	8	9	0	0	9	0	0
7	28042732	.	G	A	2	7	9	0	1	10	0	0
7	28042740	.	G	A	7	4	11	0	0	11	0	0
7	28042904	.	C	T	12	0	12	0	0	12	0	0
7	28042909	.	C	T	0	12	12	0	0	12	0	0
7	28043040	.	C	A	4	3	7	0	0	7	0	0
7	28043173	.	T	G	6	3	9	0	0	9	0	0
7	28043184	.	A	G	6	0	6	0	7	13	0	0
7	28043284	.	A	G	8	7	15	0	0	15	0	0
7	28043416	.	A	G	6	7	13	0	1	14	0	0
7	28043837	.	T	G	6	0	6	0	11	17	0	0
7	28043852	.	G	A	7	10	17	0	1	18	0	0
7	28044193	.	A	G	12	9	21	0	0	21	0	0
7	28044303	.	A	G	10	4	14	0	0	14	0	0
7	28045160	.	G	A	0	3	3	0	7	10	0	0
7	28045263	.	C	G	6	4	10	0	2	12	0	0
7	28045404	.	A	C	10	5	15	0	0	15	0	0
7	28045444	.	T	A	12	9	21	0	2	23	0	0
7	28045600	.	C	T	10	9	19	1	0	20	0	0
7	28045685	.	C	T	8	9	17	0	0	17	0	0
7	28046436	.	T	C	6	9	15	1	0	16	0	0
7	28046530	.	A	G	14	15	29	0	1	30	0	0
7	28046572	.	T	C	15	7	22	0	1	23	0	0
7	28046580	.	A	G	5	17	22	0	2	24	0	0
7	28046619	.	A	G	16	1	17	0	7	24	0	0
7	28046718	.	G	A	9	6	15	0	0	15	0	0
7	28046723	.	G	A	10	5	15	0	0	15	0	0
7	28046784	.	C	T	2	2	4	0	1	5	0	0
7	28047004	.	G	A	9	8	17	0	1	18	0	0
7	28047072	.	C	T	6	5	11	0	2	13	0	0
7	28047163	.	C	T	3	7	10	0	0	10	0	0
7	28147806	.	T	A	26	15	41	0	1	42	0	0
7	28406477	.	G	A	1	3	4	0	0	4	0	0
7	28407339	.	A	G	1	6	7	0	0	7	0	0
7	28424095	.	G	A	3	2	5	0	0	5	0	0
7	28424237	.	C	G	8	5	13	0	0	13	0	0
7	28424381	.	A	T	5	7	12	0	2	14	0	0
7	28430010	.	G	A	1	5	6	0	0	6	0	0
7	28430127	.	C	A	3	3	6	0	0	6	0	0
7	28430430	.	C	T	10	7	17	0	0	17	0	0
7	28430454	.	C	A	7	7	14	0	0	14	0	0
7	28430503	.	G	A	3	3	6	0	0	6	0	0
7	28430528	.	G	T	4	2	6	0	0	6	0	0
7	28434034	.	A	T	1	2	3	0	0	3	0	0
7	28436486	.	G	C	13	9	22	0	2	24	0	0
7	28442009	.	G	C	5	6	11	0	0	11	0	0
7	28448588	.	C	T	6	4	10	0	0	10	0	0
7	28465338	.	G	A	14	5	19	0	0	19	0	0
7	28467182	.	A	G	8	4	12	0	1	13	0	0
7	28485206	.	G	A	1	1	2	0	0	2	0	0
7	28485287	.	T	A	2	1	3	0	0	3	0	0
7	28515998	.	T	C	1	0	1	0	4	5	0	0
7	28559907	.	G	A	17	8	25	0	0	25	0	0
7	28559969	.	G	T	10	6	16	0	0	16	0	0
7	28560250	.	G	C	26	10	36	0	1	37	0	0
7	28560256	.	G	A	25	12	37	0	0	37	0	0
7	28560467	.	C	G	20	19	39	0	2	41	0	0
7	28562196	.	A	G	13	12	25	0	0	25	0	0
7	28571529	.	G	A	1	2	3	0	0	3	0	0
7	28586850	.	T	C	1	1	2	0	1	3	0	0
7	28612726	.	T	C	13	14	27	0	1	28	0	0
7	28612899	.	G	A	0	8	8	0	11	19	0	0
7	28612929	.	A	G	11	6	17	0	3	20	0	0
7	28612962	.	G	A	4	5	9	0	1	10	0	0
7	28615709	.	T	C	6	4	10	0	0	10	0	0
7	28615850	.	G	A	19	18	37	0	1	38	0	0
7	28615922	.	A	G	21	0	21	0	10	31	0	0
7	28622856	.	G	A	19	17	36	0	3	39	0	0
7	28622970	.	T	C	21	22	43	0	1	44	0	0
7	28623456	.	G	A	5	5	10	0	0	10	0	0
7	28623506	.	T	A	3	4	7	0	0	7	0	0
7	28623533	.	A	T	0	2	2	0	0	2	0	0
7	28623860	.	A	G	10	1	11	0	2	13	0	0
7	28623863	.	A	G	10	3	13	0	0	13	0	0
7	28624106	.	A	T	8	1	9	0	0	9	0	0
7	28624688	.	A	T	9	6	15	0	1	16	0	0
7	28624692	.	T	C	7	9	16	0	0	16	0	0
7	28624965	.	T	C	2	2	4	0	0	4	0	0
7	28624987	.	A	G	0	2	2	0	1	3	0	0
7	28625080	.	G	T	3	5	8	0	1	9	0	0
7	28625145	.	A	T	2	5	7	0	0	7	0	0
7	28625174	.	G	C	1	4	5	0	0	5	0	0
7	28625219	.	C	A	2	1	3	0	0	3	0	0
7	28625555	.	T	A	2	2	4	0	0	4	0	0
7	28625933	.	G	T	2	4	6	0	0	6	0	0
7	28636305	.	G	A	0	1	1	0	1	2	0	0
7	28641495	.	G	A	1	2	3	0	0	3	0	0
7	29109965	.	T	C	2	2	4	0	1	5	0	0
7	29174295	.	A	G	2	2	4	0	0	4	0	0
7	29174313	.	C	T	1	0	1	0	0	1	0	0
7	29177295	.	G	A	0	3	3	0	2	5	0	0
7	29177427	.	T	C	6	4	10	0	0	10	0	0
7	29182733	.	A	G	1	3	4	0	0	4	0	0
7	29185910	.	C	G	6	0	6	0	7	13	0	0
7	29186433	.	T	C	4	8	12	0	0	12	0	0
7	29186453	.	A	C	6	9	15	0	0	15	0	0
7	29186483	.	C	T	8	14	22	0	0	22	0	0
7	29186504	.	T	C	5	11	16	0	3	19	0	0
7	29186549	.	T	C	4	9	13	0	0	13	0	0
7	29186589	.	C	G	4	0	4	0	9	13	0	0
7	29186605	.	T	C	8	4	12	0	0	12	0	0
7	29186640	.	G	A	5	7	12	0	0	12	0	0
7	29186677	.	C	T	6	4	10	0	0	10	0	0
7	29189508	.	G	C	12	7	19	0	2	21	0	0
7	29189652	.	C	T	15	6	21	0	1	22	0	0
7	29199642	.	C	T	6	8	14	0	2	16	0	0
7	29200013	.	G	A	0	1	1	0	0	1	0	0
7	29205418	.	T	G	16	9	25	0	0	25	0	0
7	29207187	.	A	G	4	4	8	0	0	8	0	0
7	29207208	.	T	A	2	2	4	0	0	4	0	0
7	29210014	.	G	A	4	3	7	0	1	8	0	0
7	29214910	.	G	A	1	3	4	0	0	4	0	0
7	29215502	.	C	T	3	4	7	0	0	7	0	0
7	29217704	.	C	T	0	3	3	0	1	4	0	0
7	29229377	.	G	T	2	5	7	0	0	7	0	0
7	29229535	.	G	A	6	5	11	0	0	11	0	0
7	29229624	.	G	A	1	2	3	0	1	4	0	0
7	29229687	.	G	A	3	3	6	0	0	6	0	0
7	29238563	.	C	A	3	2	5	0	0	5	0	0
7	29238575	.	C	T	2	2	4	0	0	4	0	0
7	29240040	.	G	A	2	3	5	0	0	5	0	0
7	29245865	.	G	A	1	4	5	0	0	5	0	0
7	29250406	.	C	T	0	1	1	0	0	1	0	0
7	29250692	.	C	T	0	1	1	0	1	2	0	0
7	29301751	.	C	T	3	2	5	0	0	5	0	0
7	29308739	.	T	A	0	1	1	0	1	2	0	0
7	29308886	.	C	A	4	5	9	0	0	9	0	0
7	29308910	.	G	A	1	4	5	0	0	5	0	0
7	29308930	.	C	A	2	2	4	0	0	4	0	0
7	29308968	.	A	T	7	4	11	0	1	12	0	0
7	29309027	.	A	G	6	3	9	0	1	10	0	0
7	29309225	.	A	C	3	5	8	0	0	8	0	0
7	29309271	.	A	T	5	7	12	0	1	13	0	0
7	29309851	.	T	C	5	14	19	0	1	20	0	0
7	29309994	.	T	C	3	0	3	0	0	3	0	0
7	29310355	.	A	C	11	14	25	0	1	26	0	0
7	29310430	.	T	C	11	10	21	0	0	21	0	0
7	29310437	.	A	G	11	10	21	0	0	21	0	0
7	29310618	.	G	A	8	8	16	0	1	17	0	0
7	29310700	.	G	A	2	3	5	0	0	5	0	0
7	29355244	.	G	C	10	0	10	0	8	18	0	0
7	29356006	.	A	C	15	0	15	0	14	29	0	0
7	29461194	.	G	C	1	2	3	0	0	3	0	0
7	29461466	.	A	C	3	3	6	0	0	6	0	0
7	29539523	.	T	A	2	13	15	0	0	15	0	0
7	29539862	.	T	C	7	11	18	0	1	19	0	0
7	29540412	.	G	A	12	16	28	0	1	29	0	0
7	29540693	.	A	G	8	15	23	0	1	24	0	0
7	29540885	.	T	A	10	16	26	0	4	30	0	0
7	29540999	.	A	G	13	17	30	0	0	30	0	0
7	29542909	.	T	G	5	3	8	0	0	8	0	0
7	29542916	.	T	C	6	3	9	0	0	9	0	0
7	29556713	.	A	G	0	2	2	0	0	2	0	0
7	29625427	.	G	A	12	7	19	0	0	19	0	0
7	29628889	.	A	G	6	3	9	0	0	9	0	0
7	29633693	.	T	C	8	5	13	0	0	13	0	0
7	29633743	.	G	A	13	7	20	0	0	20	0	0
7	29649401	.	C	G	3	0	3	0	0	3	0	0
7	29649414	.	T	C	1	0	1	0	0	1	0	0
7	29651413	.	C	T	0	5	5	0	5	10	0	0
7	29653004	.	A	G	5	4	9	0	0	9	0	0
7	29655006	.	A	G	3	1	4	0	0	4	0	0
7	29657144	.	T	C	6	0	6	0	4	10	0	0
7	29657186	.	A	G	4	3	7	0	0	7	0	0
7	29657213	.	T	A	1	0	1	0	0	1	0	0
7	29657231	.	A	G	1	0	1	0	0	1	0	0
7	29658306	.	T	C	2	2	4	0	0	4	0	0
7	29660377	.	G	A	2	1	3	0	0	3	0	0
7	29661260	.	C	T	2	6	8	0	0	8	0	0
7	29662964	.	G	A	3	1	4	0	1	5	0	0
7	29674982	.	A	G	0	0	0	0	1	1	0	0
7	29694329	.	T	C	1	0	1	0	0	1	0	0
7	29894964	.	T	G	5	2	7	0	0	7	0	0
7	29916800	.	A	G	1	2	3	0	0	3	0	0
7	29921499	.	G	C	0	1	1	0	0	1	0	0
7	29924109	.	A	G	2	1	3	0	1	4	0	0
7	29925438	.	G	A	1	0	1	0	0	1	0	0
7	29928703	.	C	A	3	1	4	0	0	4	0	0
7	29930146	.	G	C	0	2	2	0	2	4	0	0
7	29932496	.	T	A	0	2	2	0	0	2	0	0
7	29939497	.	A	C	0	0	0	0	1	1	0	0
7	29939694	.	G	C	5	2	7	0	0	7	0	0
7	29941709	.	G	A	0	5	5	0	8	13	0	0
7	29942050	.	A	T	2	0	2	0	0	2	0	0
7	29944461	.	T	C	9	9	18	0	1	19	0	0
7	29944670	.	C	T	6	4	10	0	0	10	0	0
7	29944689	.	C	G	2	5	7	0	1	8	0	0
7	29944935	.	A	T	8	3	11	0	1	12	0	0
7	29945011	.	T	C	5	2	7	0	0	7	0	0
7	29945013	.	A	G	5	2	7	0	0	7	0	0
7	29945564	.	C	A	6	11	17	0	0	17	0	0
7	29945607	.	T	C	8	10	18	0	0	18	0	0
7	29945727	.	A	G	10	5	15	0	0	15	0	0
7	29945735	.	T	G	12	0	12	0	6	18	0	0
7	29945837	.	G	A	8	13	21	0	3	24	0	0
7	29960848	.	G	A	7	6	13	0	1	14	0	0
7	29960862	.	G	T	8	3	11	0	1	12	0	0
7	29960947	.	C	T	3	6	9	0	1	10	0	0
7	29961106	.	C	G	12	10	22	0	1	23	0	0
7	29961207	.	A	C	7	5	12	0	0	12	0	0
7	29961296	.	A	G	10	14	24	0	1	25	0	0
7	29961513	.	T	A	12	8	20	0	0	20	0	0
7	29961592	.	G	A	13	9	22	0	0	22	0	0
7	29964289	.	A	G	2	1	3	0	0	3	0	0
7	29967989	.	C	T	3	5	8	0	0	8	0	0
7	29968012	.	G	C	3	10	13	0	0	13	0	0
7	29968099	.	C	T	3	4	7	0	0	7	0	0
7	29968144	.	T	C	4	2	6	0	0	6	0	0
7	29968534	.	A	G	5	4	9	0	0	9	0	0
7	29969031	.	A	G	4	0	4	0	3	7	0	0
7	29969281	.	A	G	4	3	7	0	1	8	0	0
7	29969303	.	T	G	4	4	8	0	0	8	0	0
7	29969557	.	T	A	4	3	7	0	0	7	0	0
7	29969644	.	G	A	0	6	6	0	3	9	0	0
7	29969724	.	A	C	4	8	12	0	0	12	0	0
7	29970015	.	T	G	3	3	6	0	0	6	0	0
7	29970194	.	T	G	4	3	7	0	0	7	0	0
7	29970195	.	C	T	4	3	7	0	0	7	0	0
7	30075289	.	T	G	1	3	4	0	0	4	0	0
7	30076966	.	A	G	3	2	5	0	1	6	0	0
7	30077150	.	A	T	3	2	5	0	0	5	0	0
7	30077161	.	T	C	3	2	5	0	0	5	0	0
7	30077189	.	G	C	2	2	4	0	0	4	0	0
7	30077328	.	A	G	3	6	9	0	2	11	0	0
7	30077347	.	A	G	3	6	9	0	1	10	0	0
7	30077402	.	A	C	1	12	13	0	1	14	0	0
7	30077581	.	T	G	9	12	21	0	2	23	0	0
7	30080032	.	G	A	5	2	7	0	0	7	0	0
7	30080166	.	A	G	4	4	8	0	0	8	0	0
7	30080468	.	C	G	3	4	7	0	1	8	0	0
7	30080603	.	T	C	1	1	2	0	0	2	0	0
7	30080872	.	G	A	8	7	15	0	1	16	0	0
7	30082857	.	C	A	18	16	34	0	1	35	0	0
7	30082871	.	T	A	17	13	30	0	1	31	0	0
7	30082894	.	G	C	11	8	19	0	0	19	0	0
7	30086732	.	T	C	1	4	5	0	1	6	0	0
7	30135859	.	C	T	0	2	2	0	2	4	0	0
7	30136304	.	C	G	4	10	14	0	0	14	0	0
7	30136604	.	C	T	1	3	4	0	1	6	1	0
7	30136899	.	A	T	5	5	10	0	1	11	0	0
7	30137667	.	C	T	6	7	13	0	1	14	0	0
7	30137838	.	A	G	3	2	5	0	0	5	0	0
7	30138559	.	T	A	1	2	3	0	0	3	0	0
7	30138737	.	G	A	5	5	10	0	0	10	0	0
7	30139247	.	G	A	3	4	7	0	0	7	0	0
7	30139465	.	T	G	3	2	5	0	0	5	0	0
7	30139490	.	C	T	5	3	8	0	0	8	0	0
7	30139655	.	C	T	2	6	8	0	1	9	0	0
7	30139952	.	G	A	4	4	8	0	1	9	0	0
7	30139991	.	T	A	4	5	9	0	0	9	0	0
7	30140027	.	G	A	4	3	7	0	0	7	0	0
7	30140062	.	G	A	1	1	2	0	0	2	0	0
7	30176259	.	T	C	1	2	3	0	0	3	0	0
7	30176264	.	T	C	1	2	3	0	0	3	0	0
7	30178807	.	G	A	4	2	6	0	0	6	0	0
7	30178839	.	G	A	2	3	5	0	0	5	0	0
7	30188324	.	T	C	2	2	4	0	0	4	0	0
7	30210151	.	T	A	12	6	18	0	0	18	0	0
7	30210250	.	A	C	6	6	12	0	0	12	0	0
7	30210282	.	T	G	8	9	17	0	1	18	0	0
7	30210659	.	T	C	8	8	16	0	2	18	0	0
7	30210833	.	C	T	5	3	8	0	0	8	0	0
7	30210840	.	T	C	5	5	10	0	0	10	0	0
7	30211482	.	C	T	6	10	16	0	1	17	0	0
7	30211530	.	T	A	2	6	8	0	0	8	0	0
7	30213672	.	A	G	7	12	19	0	1	20	0	0
7	30214023	.	A	T	6	6	12	0	0	12	0	0
7	30214047	.	G	C	7	0	7	0	6	13	0	0
7	30263244	.	A	C	0	1	1	0	0	1	0	0
7	30263253	.	G	C	0	1	1	0	0	1	0	0
7	30263663	.	A	T	4	1	5	0	0	5	0	0
7	30264178	.	C	T	4	6	10	0	0	10	0	0
7	30265622	.	G	A	2	2	4	0	1	5	0	0
7	30265630	.	A	T	2	3	5	0	0	5	0	0
7	30270984	.	G	A	2	4	6	0	0	6	0	0
7	30275668	.	A	T	6	4	10	0	0	10	0	0
7	30276365	.	C	T	21	18	39	0	3	42	0	0
7	30276528	.	T	A	19	23	42	0	2	44	0	0
7	30280856	.	C	G	4	9	13	0	0	13	0	0
7	30283700	.	C	T	4	2	6	0	0	6	0	0
7	30285369	.	A	C	1	2	3	0	0	3	0	0
7	30286489	.	T	C	5	7	12	0	0	12	0	0
7	30409217	.	G	A	1	2	3	0	2	5	0	0
7	30409322	.	T	C	3	9	12	0	0	12	0	0
7	30409539	.	T	A	12	10	22	0	4	26	0	0
7	30409580	.	A	T	9	10	19	0	0	19	0	0
7	30409585	.	G	A	7	11	18	0	1	19	0	0
7	30409661	.	G	A	4	7	11	0	1	12	0	0
7	30410035	.	T	A	7	8	15	0	0	15	0	0
7	30410089	.	C	T	1	12	13	0	4	17	0	0
7	30410443	.	G	T	5	1	6	0	1	7	0	0
7	30410447	.	T	C	2	5	7	0	0	7	0	0
7	30410687	.	T	A	7	4	11	0	1	12	0	0
7	30411052	.	C	T	5	6	11	0	2	13	0	0
7	30412884	.	C	T	6	7	13	0	0	13	0	0
7	30413850	.	A	G	0	1	1	0	0	1	0	0
7	30421532	.	G	A	2	4	6	0	0	6	0	0
7	30425287	.	A	G	1	0	1	0	0	1	0	0
7	30494442	.	G	A	1	3	4	0	1	5	0	0
7	30518843	.	C	T	1	3	4	0	0	4	0	0
7	30519636	.	C	A	0	3	3	0	0	3	0	0
7	30522713	.	C	T	1	1	2	0	0	2	0	0
7	30525721	.	G	T	2	5	7	0	0	7	0	0
7	30530240	.	G	T	6	5	11	0	0	11	0	0
7	30533152	.	A	T	1	3	4	0	0	4	0	0
7	30533299	.	G	T	1	4	5	0	1	6	0	0
7	30534082	.	T	C	3	2	5	0	1	6	0	0
7	30534397	.	G	A	3	2	5	0	1	6	0	0
7	30534433	.	G	T	2	4	6	0	1	7	0	0
7	30534538	.	C	T	3	2	5	0	0	5	0	0
7	30534556	.	C	T	2	2	4	0	1	5	0	0
7	30534678	.	G	A	0	2	2	0	7	9	0	0
7	30534824	.	G	C	1	9	10	0	0	10	0	0
7	30534930	.	T	A	3	3	6	0	0	6	0	0
7	30535162	.	T	G	4	8	12	0	1	13	0	0
7	30535163	.	G	T	4	8	12	0	1	13	0	0
7	30535210	.	T	C	5	4	9	0	0	9	0	0
7	30535422	.	A	G	2	6	8	0	0	8	0	0
7	30536396	.	C	G	11	5	16	0	0	16	0	0
7	30536480	.	G	A	5	7	12	0	1	13	0	0
7	30536566	.	A	G	9	1	10	0	11	21	0	0
7	30536829	.	A	T	5	9	14	0	0	14	0	0
7	30537014	.	G	A	5	7	12	0	0	12	0	0
7	30537190	.	A	G	3	2	5	0	0	5	0	0
7	30537445	.	A	T	5	6	11	0	0	11	0	0
7	30537448	.	T	G	7	5	12	0	0	12	0	0
7	30537804	.	C	T	6	8	14	0	1	15	0	0
7	30537848	.	A	C	8	12	20	0	1	21	0	0
7	30537858	.	G	A	14	6	20	0	1	21	0	0
7	30537955	.	G	A	6	14	20	0	1	21	0	0
7	30538022	.	C	A	10	6	16	0	0	16	0	0
7	30538074	.	G	A	8	6	14	0	0	14	0	0
7	30538081	.	G	A	7	8	15	0	0	15	0	0
7	30538268	.	C	A	6	5	11	0	0	11	0	0
7	30538439	.	C	T	0	2	2	0	3	5	0	0
7	30538995	.	G	A	15	14	29	0	2	31	0	0
7	30543452	.	G	A	17	17	34	0	1	35	0	0
7	30543754	.	A	G	14	18	32	0	3	35	0	0
7	30543882	.	C	T	0	2	2	0	0	2	0	0
7	30544903	.	A	G	11	14	25	0	0	25	0	0
7	30552603	.	G	A	8	8	16	0	2	18	0	0
7	30552610	.	G	A	8	10	18	0	0	18	0	0
7	30552992	.	G	A	8	10	18	0	0	18	0	0
7	30553495	.	T	C	16	17	33	0	0	33	0	0
7	30560354	.	C	T	0	17	17	0	18	35	0	0
7	30562290	.	C	T	0	6	6	0	10	16	0	0
7	30562400	.	T	C	9	15	24	0	1	25	0	0
7	30563080	.	T	C	7	8	15	0	0	15	0	0
7	30563116	.	G	A	8	7	15	0	0	15	0	0
7	30563160	.	G	T	8	9	17	0	0	17	0	0
7	30566157	.	C	T	0	1	1	0	0	1	0	0
7	30571228	.	T	A	12	11	23	0	3	26	0	0
7	30578916	.	G	A	5	10	15	0	0	15	0	0
7	30604846	.	C	T	0	5	5	0	2	7	0	0
7	30604922	.	C	T	0	3	3	0	1	4	0	0
7	30604955	.	C	T	2	1	3	0	2	5	0	0
7	30632737	.	G	T	4	5	9	0	0	9	0	0
7	30632797	.	T	G	5	8	13	0	1	14	0	0
7	30632807	.	G	C	3	0	3	0	11	15	1	0
7	30633038	.	A	G	3	5	8	0	0	8	0	0
7	30638970	.	G	A	6	6	12	0	1	13	0	0
7	30641151	.	G	T	5	4	9	0	0	9	0	0
7	30652369	.	T	C	2	0	2	0	2	4	0	0
7	30660244	.	C	T	1	2	3	0	0	3	0	0
7	30660268	.	G	A	1	2	3	0	0	3	0	0
7	30748591	.	C	T	0	2	2	0	0	2	0	0
7	30763683	.	G	A	0	3	3	0	1	4	0	0
7	30769847	.	A	C	4	2	6	0	1	7	0	0
7	30770003	.	C	T	5	4	9	0	1	10	0	0
7	30770021	.	A	G	3	5	8	0	0	8	0	0
7	30770103	.	T	A	2	3	5	0	0	5	0	0
7	30770107	.	T	A	2	3	5	0	0	5	0	0
7	30770204	.	G	A	6	6	12	0	0	12	0	0
7	30770366	.	G	T	0	5	5	0	5	10	0	0
7	30770549	.	T	C	6	2	8	0	0	8	0	0
7	30770629	.	T	G	3	3	6	0	0	6	0	0
7	30775306	.	C	T	2	0	2	0	0	2	0	0
7	30775882	.	C	T	1	3	4	0	0	4	0	0
7	30777549	.	C	T	4	3	7	0	0	7	0	0
7	30777592	.	C	A	4	8	12	0	1	13	0	0
7	30777617	.	G	A	7	4	11	0	0	11	0	0
7	30778394	.	C	T	4	1	5	0	1	6	0	0
7	30778577	.	G	C	8	4	12	0	0	12	0	0
7	30778802	.	T	C	6	4	10	0	0	10	0	0
7	30778891	.	T	C	5	2	7	0	0	7	0	0
7	30778912	.	A	G	2	3	5	0	0	5	0	0
7	30780017	.	A	G	2	4	6	0	0	6	0	0
7	30782104	.	C	T	5	3	8	0	0	8	0	0
7	30782476	.	T	A	4	8	12	0	0	12	0	0
7	30782929	.	A	T	3	3	6	0	0	6	0	0
7	30783013	.	T	G	1	2	3	0	0	3	0	0
7	30867006	.	C	T	11	11	22	0	0	22	0	0
7	30867286	.	T	C	26	11	37	0	0	37	0	0
7	30867550	.	G	T	15	21	36	0	2	38	0	0
7	30867658	.	T	A	21	20	41	0	2	43	0	0
7	30867702	.	T	C	21	19	40	0	1	41	0	0
7	30867740	.	A	G	20	15	35	0	0	35	0	0
7	30867775	.	T	G	17	17	34	0	0	34	0	0
7	30867817	.	G	A	0	13	13	0	17	30	0	0
7	30867855	.	G	A	0	12	12	0	15	27	0	0
7	30868009	.	C	T	20	24	44	0	2	46	0	0
7	30875257	.	G	A	1	4	5	0	0	5	0	0
7	30875277	.	G	A	4	1	5	0	0	5	0	0
7	30879211	.	G	A	18	14	32	0	1	33	0	0
7	30911937	.	C	T	3	3	6	0	2	8	0	0
7	30914622	.	C	T	11	16	27	0	1	28	0	0
7	30914706	.	C	T	20	19	39	0	2	41	0	0
7	30915040	.	A	G	2	14	16	0	0	16	0	0
7	30915306	.	G	A	33	21	54	0	1	55	0	0
7	30915388	.	A	G	27	23	50	0	2	52	0	0
7	30915823	.	G	A	4	20	24	0	27	51	0	0
7	30923638	.	C	T	0	2	2	0	0	2	0	0
7	30924772	.	T	C	1	2	3	0	0	3	0	0
7	30925569	.	G	C	3	3	6	0	0	6	0	0
7	30970131	.	G	T	5	2	7	0	0	7	0	0
7	31051403	.	G	C	3	3	6	0	0	6	0	0
7	31093055	.	A	G	2	0	2	0	2	4	0	0
7	31107735	.	G	A	0	1	1	0	1	2	0	0
7	31108139	.	A	T	1	1	2	0	0	2	0	0
7	31112120	.	C	T	1	1	2	0	0	2	0	0
7	31112204	.	G	A	2	7	9	0	0	9	0	0
7	31112264	.	G	T	0	2	2	0	0	2	0	0
7	31120825	.	G	A	1	11	12	0	8	20	0	0
7	31120906	.	C	A	11	9	20	0	0	20	0	0
7	31121005	.	C	T	17	11	28	0	1	29	0	0
7	31125653	.	C	T	12	7	19	0	1	20	0	0
7	31125776	.	G	A	0	11	11	0	12	23	0	0
7	31125860	.	T	C	14	15	29	0	2	31	0	0
7	31125980	.	C	A	10	14	24	0	0	24	0	0
7	31126127	.	C	A	5	5	10	0	2	12	0	0
7	31128396	.	T	C	15	18	33	0	0	33	0	0
7	31128475	.	A	C	12	9	21	0	3	24	0	0
7	31130267	.	A	G	1	0	1	0	1	2	0	0
7	31130285	.	T	C	7	2	9	0	0	9	0	0
7	31132771	.	A	C	1	2	3	0	0	3	0	0
7	31140479	.	C	A	13	4	17	0	2	19	0	0
7	31140594	.	G	A	15	13	28	0	1	29	0	0
7	31140634	.	A	C	6	13	19	0	2	21	0	0
7	31140976	.	A	C	8	14	22	0	1	23	0	0
7	31141044	.	C	T	9	11	20	0	0	20	0	0
7	31141086	.	G	A	0	11	11	0	4	15	0	0
7	31141372	.	T	C	18	16	34	0	0	34	0	0
7	31141747	.	T	A	15	11	26	0	0	26	0	0
7	31142030	.	C	T	10	8	18	0	3	21	0	0
7	31145438	.	G	A	1	5	6	0	1	7	0	0
7	31326689	.	G	A	5	5	10	0	0	10	0	0
7	31326759	.	G	A	0	9	9	0	6	15	0	0
7	31326795	.	G	A	7	4	11	0	0	11	0	0
7	31326862	.	T	C	5	9	14	0	0	14	0	0
7	31332206	.	T	C	7	7	14	0	0	14	0	0
7	31335951	.	A	C	2	6	8	0	0	8	0	0
7	31339177	.	T	A	6	5	11	0	1	12	0	0
7	31339344	.	T	C	14	12	26	0	4	30	0	0
7	31359003	.	T	C	2	1	3	0	0	3	0	0
7	31364072	.	C	T	9	6	15	0	0	15	0	0
7	31366684	.	C	T	7	11	18	0	0	18	0	0
7	31367057	.	A	G	11	12	23	0	2	25	0	0
7	31367667	.	A	T	7	2	9	0	0	9	0	0
7	31367668	.	C	T	7	1	8	0	1	9	0	0
7	31367777	.	C	G	19	10	29	0	1	30	0	0
7	31367850	.	C	T	8	4	12	0	1	13	0	0
7	31381100	.	A	T	10	9	19	0	0	19	0	0
7	31381129	.	G	T	6	4	10	0	0	10	0	0
7	31381713	.	C	T	6	3	9	0	0	9	0	0
7	31388206	.	C	T	1	0	1	0	0	1	0	0
7	31390492	.	T	A	4	4	8	0	0	8	0	0
7	31390995	.	T	G	4	5	9	0	0	9	0	0
7	31391020	.	T	C	5	6	11	0	0	11	0	0
7	31391429	.	C	T	8	6	14	0	0	14	0	0
7	31391799	.	C	G	3	9	12	0	0	12	0	0
7	31392315	.	T	A	13	13	26	0	2	28	0	0
7	31392485	.	A	G	4	13	17	0	2	19	0	0
7	31392492	.	G	A	5	14	19	0	0	19	0	0
7	31393386	.	G	A	0	4	4	0	9	13	0	0
7	31426008	.	A	G	1	0	1	0	6	7	0	0
7	31427812	.	T	C	2	2	4	0	0	4	0	0
7	31427842	.	A	C	1	0	1	0	0	1	0	0
7	31428824	.	G	T	0	6	6	0	11	17	0	0
7	31431507	.	T	C	1	3	4	0	1	5	0	0
7	31431548	.	T	A	5	3	8	0	1	9	0	0
7	31431745	.	C	G	7	6	13	0	0	13	0	0
7	31431898	.	T	C	9	5	14	0	0	14	0	0
7	31431930	.	C	T	7	2	9	0	0	9	0	0
7	31494838	.	A	G	1	2	3	0	1	4	0	0
7	31495208	.	A	G	5	4	9	0	1	10	0	0
7	31495329	.	C	T	3	5	8	0	0	8	0	0
7	31495353	.	C	T	7	4	11	0	0	11	0	0
7	31495377	.	C	T	6	3	9	0	0	9	0	0
7	31496350	.	T	C	3	4	7	0	3	10	0	0
7	31496402	.	A	G	1	4	5	0	0	5	0	0
7	31496405	.	A	T	1	4	5	0	0	5	0	0
7	31496524	.	T	C	4	0	4	0	5	9	0	0
7	31496544	.	C	T	3	6	9	0	0	9	0	0
7	31496641	.	T	A	7	3	10	0	0	10	0	0
7	31497462	.	G	A	1	3	4	0	0	4	0	0
7	31497590	.	C	A	4	3	7	0	0	7	0	0
7	31497601	.	T	C	3	3	6	0	0	6	0	0
7	31497627	.	A	G	3	2	5	0	0	5	0	0
7	31497755	.	T	A	6	2	8	0	0	8	0	0
7	31497918	.	T	C	3	2	5	0	0	5	0	0
7	31498706	.	T	C	1	2	3	0	0	3	0	0
7	31498707	.	T	A	1	2	3	0	0	3	0	0
7	31500188	.	T	A	2	3	5	0	0	5	0	0
7	31500367	.	A	G	3	2	5	0	0	5	0	0
7	31500381	.	T	A	2	2	4	0	0	4	0	0
7	31501260	.	A	T	2	4	6	0	0	6	0	0
7	31501492	.	T	A	3	3	6	0	0	6	0	0
7	31501731	.	A	T	0	2	2	0	0	2	0	0
7	31504393	.	C	T	1	3	4	0	0	4	0	0
7	31504703	.	T	A	1	1	2	0	0	2	0	0
7	31504763	.	G	A	1	0	1	0	0	1	0	0
7	31510882	.	C	A	1	2	3	0	0	3	0	0
7	31524734	.	G	A	2	2	4	0	0	4	0	0
7	31603386	.	C	T	2	1	3	0	1	4	0	0
7	31625690	.	C	T	1	2	3	0	1	4	0	0
7	31625921	.	G	A	0	2	2	0	0	2	0	0
7	31626438	.	G	A	2	2	4	0	0	4	0	0
7	31627001	.	A	G	1	2	3	0	0	3	0	0
7	31627572	.	T	C	0	0	0	0	2	2	0	0
7	31627585	.	C	A	1	2	3	0	0	3	0	0
7	31628317	.	C	T	2	4	6	0	0	6	0	0
7	31628968	.	C	T	2	2	4	0	0	4	0	0
7	31651942	.	G	A	1	2	3	0	0	3	0	0
7	31653880	.	A	G	1	1	2	0	0	2	0	0
7	31776224	.	G	A	17	13	30	0	1	31	0	0
7	31776645	.	T	A	7	8	15	0	0	15	0	0
7	31776706	.	G	A	8	15	23	0	0	23	0	0
7	31776735	.	T	C	9	12	21	0	2	23	0	0
7	31776877	.	C	T	3	9	12	0	1	13	0	0
7	31777227	.	T	C	13	10	23	0	0	23	0	0
7	31777528	.	C	T	7	5	12	0	0	12	0	0
7	31777569	.	G	C	2	0	2	0	6	8	0	0
7	31782235	.	A	G	5	8	13	0	1	14	0	0
7	31784996	.	T	C	2	8	10	0	0	10	0	0
7	31796453	.	G	A	7	6	13	0	1	14	0	0
7	31796725	.	T	C	8	0	8	0	9	17	0	0
7	31796845	.	A	G	6	12	18	0	0	18	0	0
7	31796861	.	T	G	6	9	15	0	0	15	0	0
7	31796888	.	T	C	7	1	8	0	11	19	0	0
7	31796990	.	C	T	0	3	3	0	1	4	0	0
7	31802890	.	C	T	4	1	5	0	0	5	0	0
7	31802938	.	A	T	1	1	2	0	0	2	0	0
7	31815146	.	T	G	1	0	1	0	0	1	0	0
7	31817903	.	C	T	5	3	8	0	0	8	0	0
7	31827191	.	G	A	1	5	6	0	0	6	0	0
7	31827218	.	C	A	3	7	10	0	0	10	0	0
7	31827282	.	C	A	2	2	4	0	0	4	0	0
7	31902535	.	G	T	7	9	16	0	1	17	0	0
7	31902536	.	A	T	8	9	17	0	0	17	0	0
7	31902633	.	T	A	7	12	19	0	1	20	0	0
7	31902757	.	T	A	25	13	38	0	0	38	0	0
7	31903205	.	T	A	7	11	18	0	0	18	0	0
7	31903256	.	C	A	4	4	8	0	1	9	0	0
7	31903276	.	G	A	7	7	14	0	0	14	0	0
7	31903516	.	T	G	1	4	5	0	0	5	0	0
7	31903788	.	C	T	5	3	8	0	0	8	0	0
7	31903823	.	G	T	0	6	6	0	0	6	0	0
7	31903993	.	A	T	5	7	12	0	0	12	0	0
7	31904146	.	G	A	3	7	10	0	0	10	0	0
7	31904180	.	G	A	6	8	14	0	0	14	0	0
7	31904192	.	G	T	7	7	14	0	1	15	0	0
7	31904381	.	C	A	12	11	23	0	0	23	0	0
7	31904442	.	T	G	7	9	16	0	0	16	0	0
7	31905040	.	T	C	5	0	5	0	6	12	1	0
7	31905126	.	C	T	6	4	10	0	0	10	0	0
7	31905190	.	A	T	4	3	7	0	0	7	0	0
7	31905217	.	T	A	6	4	10	0	2	12	0	0
7	31905392	.	G	A	14	9	23	0	1	24	0	0
7	31907970	.	C	A	1	4	5	0	0	5	0	0
7	31925975	.	C	T	22	22	44	0	4	48	0	0
7	31940373	.	A	G	2	2	4	0	1	5	0	0
7	32142302	.	A	C	3	5	8	0	0	8	0	0
7	32369117	.	C	T	1	1	2	0	1	3	0	0
7	32455821	.	C	T	1	3	4	0	0	4	0	0
7	32455827	.	A	T	1	3	4	0	0	4	0	0
7	32458136	.	C	A	4	2	6	0	0	6	0	0
7	32458154	.	G	A	0	4	4	0	2	6	0	0
7	32458183	.	G	A	0	2	2	0	5	7	0	0
7	32458227	.	A	T	4	3	7	0	1	8	0	0
7	32458270	.	C	A	4	3	7	0	0	7	0	0
7	32459107	.	C	A	2	2	4	0	0	4	0	0
7	32459126	.	G	T	3	4	7	0	0	7	0	0
7	32459220	.	C	T	5	4	9	0	0	9	0	0
7	32459256	.	G	T	4	4	8	0	1	9	0	0
7	32459486	.	C	T	2	3	5	0	0	5	0	0
7	32597340	.	G	A	2	3	5	0	0	5	0	0
7	32624814	.	T	A	12	9	21	0	0	21	0	0
7	32624823	.	G	A	10	8	18	0	0	18	0	0
7	32624892	.	C	T	10	13	23	0	1	24	0	0
7	32628387	.	T	C	7	4	11	0	0	11	0	0
7	32629309	.	C	A	1	7	8	0	3	11	0	0
7	32629349	.	G	T	7	14	21	0	2	23	0	0
7	32644881	.	G	A	1	4	5	0	0	5	0	0
7	32645094	.	G	A	0	2	2	0	1	3	0	0
7	32700594	.	C	T	1	2	3	0	0	3	0	0
7	32714730	.	T	C	4	2	6	0	1	7	0	0
7	32714833	.	C	T	7	9	16	0	0	16	0	0
7	32722539	.	G	A	2	5	7	0	1	8	0	0
7	32722694	.	G	T	10	5	15	0	0	15	0	0
7	32742962	.	T	C	6	6	12	0	1	13	0	0
7	32742967	.	G	A	6	5	11	0	1	12	0	0
7	32743091	.	A	T	4	5	9	0	0	9	0	0
7	32743110	.	A	T	5	5	10	0	0	10	0	0
7	32743231	.	A	G	4	3	7	0	0	7	0	0
7	32743459	.	A	G	3	0	3	0	10	13	0	0
7	32743512	.	T	C	6	11	17	0	1	18	0	0
7	32743585	.	G	A	1	3	4	0	11	15	0	0
7	32743688	.	A	T	3	2	5	0	0	5	0	0
7	32743728	.	C	G	3	4	7	0	0	7	0	0
7	32743751	.	C	A	3	7	10	0	0	10	0	0
7	32743811	.	T	A	5	3	8	0	0	8	0	0
7	32743818	.	T	A	6	2	8	0	0	8	0	0
7	32743918	.	G	C	3	13	16	0	0	16	0	0
7	32743959	.	A	C	2	8	10	0	2	12	0	0
7	32743961	.	A	G	2	8	10	0	1	11	0	0
7	32744027	.	T	C	7	10	17	0	1	18	0	0
7	32744459	.	T	A	6	9	15	1	0	16	0	0
7	32744485	.	A	G	6	4	10	1	1	12	0	0
7	32744540	.	T	C	9	14	23	0	0	23	0	0
7	32744542	.	A	G	9	2	11	0	12	23	0	0
7	32744648	.	A	G	14	15	29	0	0	29	0	0
7	32744663	.	T	A	11	11	22	0	1	23	0	0
7	32744856	.	G	A	8	10	18	0	0	18	0	0
7	32744906	.	T	C	4	10	14	0	0	14	0	0
7	32744919	.	T	G	5	9	14	0	0	14	0	0
7	32744958	.	T	A	5	7	12	0	0	12	0	0
7	32744974	.	G	C	5	7	12	0	1	13	0	0
7	32745025	.	T	C	6	7	13	0	3	16	0	0
7	32745170	.	A	G	4	4	8	0	0	8	0	0
7	32745190	.	T	C	4	8	12	0	0	12	0	0
7	32745461	.	C	T	6	12	18	0	1	19	0	0
7	32746026	.	T	C	4	5	9	0	1	10	0	0
7	32746152	.	A	C	9	11	20	0	5	25	0	0
7	32746213	.	A	G	13	14	27	0	0	27	0	0
7	32746324	.	G	A	21	12	33	0	2	35	0	0
7	32746327	.	A	C	21	11	32	0	1	33	0	0
7	32746370	.	C	T	14	13	27	0	0	27	0	0
7	32746457	.	A	C	20	14	34	0	1	35	0	0
7	32746546	.	T	C	11	2	13	0	0	13	0	0
7	32746552	.	G	A	12	3	15	0	0	15	0	0
7	32746584	.	C	T	8	12	20	0	0	20	0	0
7	32746614	.	C	T	16	10	26	0	0	26	0	0
7	32746676	.	T	C	17	8	25	1	1	27	0	0
7	32746732	.	A	G	19	5	24	1	0	25	0	0
7	32747029	.	A	T	3	2	5	0	0	6	1	0
7	32747056	.	A	C	2	5	7	0	0	7	0	0
7	32747135	.	T	C	8	8	16	0	0	16	0	0
7	32747424	.	T	A	2	1	3	0	2	5	0	0
7	32747482	.	A	C	1	0	1	0	3	4	0	0
7	32747956	.	A	G	15	0	15	0	11	27	1	0
7	32747973	.	A	G	15	18	33	0	2	35	0	0
7	32748006	.	T	C	12	18	30	1	3	34	0	0
7	32748203	.	A	G	17	9	26	0	1	27	0	0
7	32748319	.	C	A	16	24	40	0	0	42	2	0
7	32748486	.	A	T	15	8	23	0	0	23	0	0
7	32748725	.	G	A	16	17	33	0	1	34	0	0
7	32748914	.	G	A	19	13	32	0	1	33	0	0
7	32749048	.	T	A	11	18	29	0	2	31	0	0
7	32749144	.	T	C	17	14	31	0	0	31	0	0
7	32749146	.	A	G	17	14	31	0	0	31	0	0
7	32812361	.	A	G	27	24	51	0	1	52	0	0
7	32812472	.	G	A	15	11	26	1	2	29	0	0
7	32812804	.	G	A	6	20	26	0	8	34	0	0
7	32813004	.	T	C	18	16	34	0	1	35	0	0
7	32813366	.	A	G	20	18	38	0	2	40	0	0
7	32813605	.	T	G	6	15	21	0	0	22	1	0
7	32813689	.	C	T	11	14	25	0	2	27	0	0
7	32813962	.	A	C	6	3	9	0	1	10	0	0
7	32814139	.	C	G	11	15	26	0	1	27	0	0
7	32814141	.	G	C	10	15	25	0	2	27	0	0
7	32814364	.	G	A	17	3	20	4	0	24	0	0
7	32814379	.	C	A	0	5	5	4	17	26	0	0
7	32814451	.	C	T	0	15	15	0	14	29	0	0
7	32814502	.	T	C	9	0	9	0	14	23	0	0
7	32814542	.	C	T	15	16	31	0	0	31	0	0
7	32814600	.	C	G	25	13	38	0	0	38	0	0
7	32814636	.	A	G	23	11	34	0	1	35	0	0
7	32814830	.	A	G	11	20	31	0	1	32	0	0
7	32815485	.	A	T	12	15	27	0	0	27	0	0
7	32815506	.	A	G	18	16	34	0	0	34	0	0
7	32815661	.	T	C	10	9	19	0	2	21	0	0
7	32815910	.	C	T	1	22	23	0	19	42	0	0
7	32818809	.	G	T	9	7	16	0	0	16	0	0
7	32818848	.	A	T	15	14	29	0	3	32	0	0
7	32827457	.	A	G	2	5	7	0	0	7	0	0
7	32831592	.	G	A	18	15	33	0	0	33	0	0
7	32833155	.	T	G	12	16	28	0	0	28	0	0
7	32834445	.	G	T	2	2	4	0	0	4	0	0
7	32834650	.	C	A	5	5	10	0	1	11	0	0
7	32834674	.	G	A	8	8	16	0	0	16	0	0
7	32834835	.	G	A	5	3	8	0	0	8	0	0
7	32834912	.	C	G	6	6	12	0	0	12	0	0
7	32835042	.	T	G	7	3	10	0	0	10	0	0
7	32835053	.	T	C	7	4	11	0	0	11	0	0
7	32835182	.	G	A	7	3	10	0	0	10	0	0
7	32835349	.	A	G	7	9	16	0	0	16	0	0
7	32835724	.	G	A	2	4	6	0	0	6	0	0
7	32836032	.	T	C	4	6	10	0	1	11	0	0
7	32836100	.	G	A	4	7	11	0	0	11	0	0
7	32836163	.	A	G	6	9	15	0	0	15	0	0
7	32836203	.	A	T	7	6	13	0	1	14	0	0
7	32836227	.	A	G	10	4	14	0	1	15	0	0
7	32836334	.	T	C	0	0	0	0	4	4	0	0
7	32843511	.	T	C	1	0	1	0	4	5	0	0
7	32857842	.	T	C	1	0	1	0	0	1	0	0
7	32895388	.	A	C	1	3	4	0	0	4	0	0
7	32895566	.	G	A	3	5	8	0	1	9	0	0
7	32895595	.	A	C	3	3	6	0	0	6	0	0
7	32898148	.	T	G	10	0	10	0	8	18	0	0
7	32898640	.	A	T	4	5	9	0	1	10	0	0
7	32898696	.	C	T	12	12	24	0	0	24	0	0
7	32898744	.	C	T	9	16	25	0	1	26	0	0
7	32898747	.	T	A	9	16	25	0	0	25	0	0
7	32898827	.	C	A	9	13	22	0	1	23	0	0
7	32899602	.	A	T	7	16	23	0	0	23	0	0
7	32899744	.	A	G	11	8	19	0	0	19	0	0
7	32928369	.	G	A	3	4	7	0	0	7	0	0
7	32942985	.	C	T	1	0	1	0	0	1	0	0
7	32946574	.	T	G	1	2	3	0	0	3	0	0
7	32946639	.	C	T	2	1	3	0	0	3	0	0
7	32964949	.	C	G	1	0	1	0	0	1	0	0
7	32983726	.	T	A	30	18	48	0	0	48	0	0
7	32983948	.	A	C	32	1	33	0	26	59	0	0
7	32984127	.	T	A	36	22	58	0	5	63	0	0
7	32984604	.	C	T	28	27	55	0	0	55	0	0
7	32984625	.	T	A	25	23	48	0	0	48	0	0
7	32984804	.	T	A	28	28	56	0	0	56	0	0
7	32984812	.	C	A	26	26	52	0	1	53	0	0
7	32985013	.	A	T	20	20	40	0	2	42	0	0
7	32985128	.	T	C	26	31	57	0	1	58	0	0
7	32985274	.	A	T	13	11	24	0	1	25	0	0
7	32985282	.	T	A	11	12	23	0	1	24	0	0
7	32985518	.	A	T	20	4	24	0	1	25	0	0
7	32985519	.	C	T	19	5	24	0	1	25	0	0
7	32985602	.	G	A	26	17	43	0	1	44	0	0
7	32985616	.	A	T	26	20	46	0	0	46	0	0
7	32985716	.	A	G	26	25	51	0	0	51	0	0
7	32985847	.	A	G	26	27	53	0	4	57	0	0
7	32986043	.	T	A	22	26	48	0	2	50	0	0
7	32986311	.	T	G	19	15	34	0	2	36	0	0
7	32986422	.	G	T	16	15	31	0	2	33	0	0
7	32988848	.	T	C	9	0	9	0	5	14	0	0
7	32992111	.	G	A	5	6	11	0	0	11	0	0
7	33014041	.	T	C	11	0	11	0	5	16	0	0
7	33028462	.	G	A	1	18	19	0	20	39	0	0
7	33028564	.	T	G	12	18	30	0	2	32	0	0
7	33028738	.	T	C	13	18	31	0	2	33	0	0
7	33068415	.	C	T	9	9	18	0	1	19	0	0
7	33068436	.	T	C	11	11	22	0	1	23	0	0
7	33068457	.	G	A	9	14	23	0	0	23	0	0
7	33068718	.	A	G	16	16	32	0	3	35	0	0
7	33083616	.	A	C	10	10	20	0	1	21	0	0
7	33083665	.	A	G	13	5	18	0	0	18	0	0
7	33084411	.	A	G	7	8	15	0	0	15	0	0
7	33084487	.	T	G	5	5	10	0	0	10	0	0
7	33084644	.	C	T	10	10	20	0	0	20	0	0
7	33084659	.	A	G	7	11	18	0	0	18	0	0
7	33084693	.	C	A	9	8	17	0	0	17	0	0
7	33084697	.	T	A	8	6	14	0	1	15	0	0
7	33084768	.	G	A	0	5	5	0	8	13	0	0
7	33084769	.	G	A	8	5	13	0	0	13	0	0
7	33084892	.	G	T	3	3	6	0	0	6	0	0
7	33085039	.	G	A	4	10	14	0	1	15	0	0
7	33085069	.	A	T	6	9	15	0	0	15	0	0
7	33085082	.	C	A	6	9	15	0	0	15	0	0
7	33085212	.	C	T	14	16	30	0	0	30	0	0
7	33085359	.	G	C	6	12	18	0	7	25	0	0
7	33085667	.	T	A	5	13	18	0	0	18	0	0
7	33086384	.	C	T	14	17	31	0	0	31	0	0
7	33086491	.	T	C	14	21	35	0	1	36	0	0
7	33086564	.	G	C	9	16	25	0	0	25	0	0
7	33086569	.	T	A	10	14	24	0	3	27	0	0
7	33086865	.	G	T	0	14	14	0	20	34	0	0
7	33087209	.	T	G	19	25	44	0	3	47	0	0
7	33087334	.	A	T	20	7	27	0	1	28	0	0
7	33087472	.	A	G	12	11	23	0	5	28	0	0
7	33087841	.	T	G	26	17	43	0	0	43	0	0
7	33088052	.	G	A	7	7	14	0	3	17	0	0
7	33318208	.	C	A	5	5	10	0	1	11	0	0
7	33318226	.	C	T	5	7	12	0	0	12	0	0
7	33318298	.	A	T	1	3	4	0	0	4	0	0
7	33318322	.	A	C	3	1	4	0	0	4	0	0
7	33328477	.	G	A	1	4	5	0	1	6	0	0
7	33328487	.	G	C	4	5	9	0	0	9	0	0
7	33328542	.	C	G	3	3	6	0	0	6	0	0
7	33331303	.	G	A	2	1	3	0	1	4	0	0
7	33332438	.	A	G	4	4	8	0	0	8	0	0
7	33332472	.	T	C	1	3	4	0	1	5	0	0
7	33334977	.	T	C	2	8	10	0	0	10	0	0
7	33340607	.	C	T	5	7	12	0	2	14	0	0
7	33340645	.	C	T	1	8	9	0	1	10	0	0
7	33340747	.	C	T	7	9	16	0	1	17	0	0
7	33341082	.	A	C	9	5	14	0	2	16	0	0
7	33341124	.	T	A	9	3	12	0	2	14	0	0
7	33341143	.	T	G	9	3	12	0	2	14	0	0
7	33341193	.	G	A	4	3	7	0	1	8	0	0
7	33341853	.	G	T	10	4	14	0	1	15	0	0
7	33346451	.	C	T	16	33	49	0	1	50	0	0
7	33347436	.	T	C	22	15	37	0	2	39	0	0
7	33351362	.	A	C	1	5	6	0	0	6	0	0
7	33440343	.	T	C	2	5	7	0	1	8	0	0
7	33440463	.	C	T	3	7	10	0	0	10	0	0
7	33440466	.	C	G	7	0	7	0	3	10	0	0
7	33440571	.	A	T	6	2	8	0	0	8	0	0
7	33441762	.	A	G	10	0	10	0	9	19	0	0
7	33442138	.	A	G	2	2	4	0	0	4	0	0
7	33442491	.	C	T	0	5	5	0	0	5	0	0
7	33442507	.	A	C	4	2	6	0	0	6	0	0
7	33442639	.	C	A	10	6	16	0	0	16	0	0
7	33442680	.	T	C	6	8	14	0	1	15	0	0
7	33442795	.	G	A	2	5	7	0	0	7	0	0
7	33443246	.	A	T	5	5	10	0	0	10	0	0
7	33443587	.	T	A	5	5	10	0	1	11	0	0
7	33443684	.	A	G	7	4	11	0	0	11	0	0
7	33443748	.	C	G	8	7	15	0	0	15	0	0
7	33443808	.	T	C	9	3	12	0	1	13	0	0
7	33645876	.	A	T	8	7	15	0	4	19	0	0
7	33645932	.	C	A	0	8	8	0	11	19	0	0
7	33646044	.	G	C	15	8	23	0	0	24	1	0
7	33646409	.	C	T	10	10	20	0	1	22	1	0
7	33646459	.	G	A	5	11	16	0	0	16	0	0
7	33646920	.	G	C	20	8	28	0	2	30	0	0
7	33649963	.	G	A	12	9	21	0	0	21	0	0
7	33653910	.	G	T	7	8	15	0	0	15	0	0
7	33653982	.	T	C	1	0	1	0	2	3	0	0
7	33682981	.	T	C	5	0	5	0	0	5	0	0
7	33684615	.	T	C	5	0	5	0	5	10	0	0
7	33801112	.	T	A	2	3	5	0	1	6	0	0
7	33801322	.	T	C	5	4	9	0	0	9	0	0
7	33802258	.	C	T	1	3	4	0	0	4	0	0
7	33880379	.	G	A	1	2	3	0	1	4	0	0
7	33880757	.	A	G	2	2	4	0	0	4	0	0
7	33883436	.	A	T	3	4	7	0	0	7	0	0
7	33884325	.	A	C	2	2	4	0	0	4	0	0
7	33886248	.	A	T	1	5	6	0	0	6	0	0
7	33886721	.	C	T	4	3	7	0	0	7	0	0
7	33889923	.	A	G	1	3	4	0	0	4	0	0
7	33955029	.	T	A	3	3	6	0	0	6	0	0
7	33958732	.	G	C	1	2	3	0	0	3	0	0
7	33959445	.	C	T	0	3	3	0	1	4	0	0
7	33971021	.	A	T	5	4	9	0	1	10	0	0
7	33971304	.	A	C	7	14	21	0	0	21	0	0
7	33971429	.	C	T	6	8	14	0	0	14	0	0
7	33971549	.	T	G	2	6	8	0	0	8	0	0
7	33972407	.	C	T	1	4	5	0	0	5	0	0
7	34102974	.	G	A	4	3	7	0	0	7	0	0
7	34104755	.	G	T	2	3	5	0	1	6	0	0
7	34104786	.	G	T	2	3	5	0	1	6	0	0
7	34106188	.	C	A	5	2	7	0	0	7	0	0
7	34106323	.	C	A	1	2	3	0	0	3	0	0
7	34117914	.	G	A	0	1	1	0	0	1	0	0
7	34118099	.	G	T	2	2	4	0	1	5	0	0
7	34124478	.	G	C	4	0	4	0	4	8	0	0
7	34183237	.	T	A	7	3	10	0	0	10	0	0
7	34183285	.	A	T	4	4	8	0	0	8	0	0
7	34191534	.	G	A	2	0	2	0	1	3	0	0
7	34236350	.	T	C	0	1	1	0	0	1	0	0
7	34236359	.	T	C	0	1	1	0	0	1	0	0
7	34237217	.	C	T	0	1	1	0	0	1	0	0
7	34240336	.	T	A	3	4	7	0	1	8	0	0
7	34240568	.	T	A	3	2	5	0	0	5	0	0
7	34240646	.	G	T	0	3	3	0	1	4	0	0
7	34241707	.	C	T	1	4	5	0	0	5	0	0
7	34241719	.	T	C	1	4	5	0	0	5	0	0
7	34241815	.	G	A	6	6	12	0	0	12	0	0
7	34242358	.	C	T	0	3	3	0	0	3	0	0
7	34242478	.	T	C	1	0	1	0	0	1	0	0
7	34290319	.	C	T	3	4	7	0	1	8	0	0
7	34312738	.	G	A	3	2	5	0	0	5	0	0
7	34317746	.	C	T	2	17	19	0	24	43	0	0
7	34318485	.	G	A	23	20	43	0	1	44	0	0
7	34318619	.	C	T	3	22	25	0	26	51	0	0
7	34318750	.	A	G	27	21	48	0	3	51	0	0
7	34321638	.	C	T	3	7	10	0	0	10	0	0
7	34321698	.	C	T	2	3	5	0	0	5	0	0
7	34321735	.	G	A	6	2	8	0	0	8	0	0
7	34342266	.	G	C	9	6	15	0	0	15	0	0
7	34351132	.	A	G	1	2	3	0	0	3	0	0
7	34352941	.	T	A	11	9	20	0	0	20	0	0
7	34353161	.	C	T	0	15	15	0	19	34	0	0
7	34353164	.	T	C	14	0	14	0	17	31	0	0
7	34353202	.	T	C	9	12	21	0	0	21	0	0
7	34360337	.	A	G	14	5	19	0	0	19	0	0
7	34360380	.	T	C	4	0	4	0	0	4	0	0
7	34361708	.	A	G	5	4	9	0	0	9	0	0
7	34361781	.	G	T	5	11	16	0	1	17	0	0
7	34361832	.	G	C	8	8	16	0	2	18	0	0
7	34383082	.	G	A	7	10	17	0	0	17	0	0
7	34385248	.	G	A	12	9	21	0	0	21	0	0
7	34413123	.	T	A	10	5	15	0	0	15	0	0
7	34413218	.	A	G	12	15	27	0	2	29	0	0
7	34413240	.	A	T	10	10	20	0	2	22	0	0
7	34415865	.	G	T	9	2	11	0	0	11	0	0
7	34416106	.	G	A	7	9	16	0	1	17	0	0
7	34416511	.	A	C	7	7	14	0	0	14	0	0
7	34417537	.	T	A	1	3	4	0	1	5	0	0
7	34417696	.	C	T	0	7	7	0	3	10	0	0
7	34417729	.	C	A	3	6	9	0	1	10	0	0
7	34417846	.	T	C	6	4	10	0	0	10	0	0
7	34418240	.	G	A	3	7	10	0	3	13	0	0
7	34418365	.	G	A	5	7	12	0	1	13	0	0
7	34418457	.	G	T	2	6	8	0	0	8	0	0
7	34418546	.	A	T	5	4	9	0	1	10	0	0
7	34418547	.	C	T	6	4	10	0	0	10	0	0
7	34421271	.	C	T	5	2	7	0	0	7	0	0
7	34426954	.	T	C	3	5	8	0	0	8	0	0
7	34426959	.	C	T	3	3	6	0	0	6	0	0
7	34427649	.	G	A	7	4	11	0	0	11	0	0
7	34427727	.	T	C	4	0	4	0	6	10	0	0
7	34429119	.	T	C	2	0	2	0	0	2	0	0
7	34431708	.	T	C	3	10	13	0	0	13	0	0
7	34489051	.	G	T	2	3	5	0	0	5	0	0
7	34490904	.	T	C	0	1	1	0	0	1	0	0
7	34491872	.	C	T	5	3	8	0	0	8	0	0
7	34491878	.	T	A	3	4	7	0	0	7	0	0
7	34491935	.	G	C	6	8	14	0	1	15	0	0
7	34501480	.	G	A	0	1	1	0	0	1	0	0
7	34501782	.	T	G	1	0	1	0	0	1	0	0
7	34505977	.	T	A	0	1	1	0	1	2	0	0
7	34540380	.	C	T	5	2	7	0	1	8	0	0
7	34540500	.	A	G	2	4	6	0	0	6	0	0
7	34540827	.	G	T	1	4	5	0	0	5	0	0
7	34541022	.	A	G	4	2	6	0	0	6	0	0
7	34541163	.	C	T	3	5	8	0	0	8	0	0
7	34541955	.	A	G	3	5	8	0	0	8	0	0
7	34542108	.	A	G	5	0	5	0	5	10	0	0
7	34542156	.	T	C	2	6	8	0	0	8	0	0
7	34544751	.	T	A	10	8	18	0	1	19	0	0
7	34545068	.	C	T	4	13	17	0	0	17	0	0
7	34603157	.	C	A	1	1	2	0	0	2	0	0
7	34612194	.	A	G	0	0	0	0	1	1	0	0
7	34635561	.	A	G	1	1	2	0	0	2	0	0
7	34635582	.	G	A	1	0	1	0	0	1	0	0
7	34643983	.	G	A	1	2	3	0	0	3	0	0
7	34651419	.	G	A	0	6	6	0	2	8	0	0
7	34652081	.	C	G	8	11	19	0	1	20	0	0
7	34765569	.	C	T	2	2	4	0	0	4	0	0
7	34771160	.	C	T	1	2	3	0	0	3	0	0
7	34823861	.	A	G	3	5	8	0	1	9	0	0
7	34823909	.	A	T	1	4	5	0	0	5	0	0
7	34824131	.	A	T	2	3	5	0	0	5	0	0
7	34824695	.	C	A	1	3	4	0	0	4	0	0
7	34828382	.	T	A	3	2	5	0	0	5	0	0
7	34963765	.	G	T	1	3	4	0	0	4	0	0
7	34963887	.	C	T	2	2	4	0	0	4	0	0
7	34964404	.	C	T	2	3	5	0	0	5	0	0
7	34964833	.	G	T	4	4	8	0	1	9	0	0
7	34965022	.	A	G	2	0	2	0	4	6	0	0
7	34965049	.	G	A	2	4	6	0	0	6	0	0
7	34965064	.	T	C	4	6	10	0	0	10	0	0
7	34979972	.	G	A	2	4	6	0	0	6	0	0
7	35086461	.	C	T	24	15	39	0	5	44	0	0
7	35088435	.	T	C	18	15	33	0	0	33	0	0
7	35091113	.	A	T	5	0	5	0	0	5	0	0
7	35091118	.	A	G	5	0	5	0	0	5	0	0
7	35091293	.	G	A	3	5	8	0	0	8	0	0
7	35091365	.	T	A	20	27	47	0	5	52	0	0
7	35093784	.	C	T	5	3	8	0	1	9	0	0
7	35093968	.	A	C	30	26	56	0	1	57	0	0
7	35094025	.	T	A	26	25	51	0	6	58	1	0
7	35094218	.	T	C	26	26	52	0	4	56	0	0
7	35094292	.	T	G	25	2	27	0	10	37	0	0
7	35094604	.	T	G	17	19	36	0	2	38	0	0
7	35094647	.	T	C	18	18	36	0	1	37	0	0
7	35094682	.	T	C	35	0	35	0	1	36	0	0
7	35094859	.	C	T	16	9	25	0	3	28	0	0
7	35112615	.	A	G	0	4	4	0	0	4	0	0
7	35112864	.	C	T	0	3	3	0	2	5	0	0
7	35112919	.	T	C	0	3	3	0	0	3	0	0
7	35112994	.	G	T	4	3	7	0	0	7	0	0
7	35113404	.	G	A	1	5	6	0	0	6	0	0
7	35113419	.	G	A	1	6	7	0	0	7	0	0
7	35116880	.	G	T	0	2	2	0	0	2	0	0
7	35116941	.	G	A	3	3	6	0	0	6	0	0
7	35191299	.	C	T	1	3	4	0	0	4	0	0
7	35193995	.	C	A	3	3	6	0	0	6	0	0
7	35208379	.	G	A	2	1	3	0	1	4	0	0
7	35208381	.	C	T	3	1	4	0	0	4	0	0
7	35210921	.	C	G	3	10	13	0	0	13	0	0
7	35210924	.	C	A	3	9	12	0	0	12	0	0
7	35211010	.	T	G	9	4	13	0	0	13	0	0
7	35211073	.	A	C	6	7	13	0	0	13	0	0
7	35212066	.	C	T	0	2	2	0	1	3	0	0
7	35212070	.	T	A	1	1	2	0	0	2	0	0
7	35212252	.	G	A	2	7	9	0	0	9	0	0
7	35212255	.	C	T	2	7	9	0	0	9	0	0
7	35241563	.	C	T	1	2	3	0	0	3	0	0
7	35241571	.	G	T	1	2	3	0	0	3	0	0
7	35241706	.	T	C	4	2	6	0	0	6	0	0
7	35283238	.	T	A	2	2	4	0	0	4	0	0
7	35351172	.	T	C	1	3	4	0	1	5	0	0
7	35351191	.	T	C	4	2	6	0	0	6	0	0
7	36314372	.	G	A	10	8	18	0	1	19	0	0
7	36483558	.	C	T	1	2	3	0	0	3	0	0
7	37584758	.	A	G	2	2	4	0	0	4	0	0
7	38392031	.	C	T	2	5	7	0	0	7	0	0
7	38392422	.	A	C	1	2	3	0	0	3	0	0
7	38392424	.	C	T	1	2	3	0	0	3	0	0
7	38456578	.	T	C	2	8	10	0	0	10	0	0
7	38456592	.	A	T	2	9	11	0	0	11	0	0
7	38456699	.	T	C	3	6	9	0	0	9	0	0
7	38456944	.	T	C	7	0	7	0	5	12	0	0
7	38476911	.	T	A	5	6	11	0	1	12	0	0
7	38476976	.	C	T	6	4	10	0	1	11	0	0
7	38477026	.	C	T	0	7	7	0	11	18	0	0
7	38477075	.	G	A	6	9	15	0	2	17	0	0
7	38477196	.	C	T	6	6	12	0	0	12	0	0
7	38529503	.	C	T	1	3	4	0	1	5	0	0
7	38529617	.	G	T	0	1	1	0	2	3	0	0
7	38529623	.	C	T	1	2	3	0	0	3	0	0
7	38529680	.	G	A	2	4	6	0	0	6	0	0
7	38529689	.	C	G	2	0	2	0	4	6	0	0
7	38529867	.	A	T	6	3	9	0	1	10	0	0
7	38531729	.	G	A	3	2	5	0	1	6	0	0
7	38532382	.	A	C	2	2	4	0	1	5	0	0
7	38532390	.	G	A	0	3	3	0	2	5	0	0
7	38532495	.	G	A	3	3	6	0	0	6	0	0
7	38532541	.	G	C	4	6	10	0	0	10	0	0
7	38532832	.	C	T	3	3	6	0	0	6	0	0
7	38532833	.	C	T	3	3	6	0	0	6	0	0
7	38533013	.	T	C	8	3	11	1	0	12	0	0
7	38533048	.	C	A	6	3	9	2	1	12	0	0
7	38533074	.	C	T	2	2	4	2	0	6	0	0
7	38533225	.	G	T	5	5	10	0	0	10	0	0
7	38533250	.	C	G	6	4	10	0	0	10	0	0
7	38533275	.	A	G	8	2	10	0	1	11	0	0
7	38533301	.	A	G	8	1	9	0	0	9	0	0
7	38536370	.	C	T	20	13	33	0	1	34	0	0
7	38536416	.	C	T	23	14	37	0	0	37	0	0
7	38536697	.	A	G	16	10	26	0	1	27	0	0
7	38536703	.	A	T	17	12	29	0	1	30	0	0
7	38536889	.	G	T	20	8	28	0	0	28	0	0
7	38537345	.	C	T	12	13	25	0	1	26	0	0
7	38537657	.	C	T	13	10	23	0	0	23	0	0
7	38539320	.	T	A	2	4	6	0	1	7	0	0
7	38539554	.	A	G	8	12	20	0	2	22	0	0
7	38539577	.	A	G	6	12	18	0	2	20	0	0
7	38539643	.	C	A	2	13	15	0	1	16	0	0
7	38539730	.	G	A	6	7	13	0	1	14	0	0
7	38539768	.	T	A	7	12	19	0	0	19	0	0
7	38539992	.	G	A	8	6	14	0	0	14	0	0
7	38540134	.	G	A	10	12	22	0	0	22	0	0
7	38544706	.	A	G	11	5	16	0	0	16	0	0
7	38552294	.	T	C	3	6	9	0	2	11	0	0
7	38570789	.	C	T	1	1	2	0	0	2	0	0
7	38578128	.	T	C	3	2	5	0	1	6	0	0
7	38578140	.	T	C	3	1	4	0	0	4	0	0
7	38594474	.	A	C	14	13	27	0	0	28	1	0
7	38594510	.	G	C	13	10	23	0	0	23	0	0
7	38600226	.	A	G	18	15	33	0	1	34	0	0
7	38600265	.	T	C	26	22	48	0	0	48	0	0
7	38600483	.	A	G	18	14	32	0	1	33	0	0
7	38600585	.	C	T	3	19	22	0	19	41	0	0
7	38600892	.	G	A	21	17	38	0	1	39	0	0
7	38600982	.	G	A	33	28	61	0	0	61	0	0
7	38601025	.	G	T	37	22	59	0	2	61	0	0
7	38601067	.	G	T	33	20	53	0	2	55	0	0
7	38601156	.	G	T	22	15	37	0	3	40	0	0
7	38601374	.	C	T	24	28	52	0	1	53	0	0
7	38601391	.	T	A	25	32	57	0	1	58	0	0
7	38601417	.	A	C	26	33	59	0	1	60	0	0
7	38601625	.	C	A	22	16	38	0	1	39	0	0
7	38601646	.	G	A	19	22	41	0	1	42	0	0
7	38601751	.	T	C	27	20	47	0	1	48	0	0
7	38601759	.	C	G	28	20	48	0	3	51	0	0
7	38601823	.	C	A	2	9	11	0	33	44	0	0
7	38601909	.	C	T	1	17	18	0	30	48	0	0
7	38602123	.	C	T	28	28	56	0	2	58	0	0
7	38602160	.	A	T	24	31	55	0	0	55	0	0
7	38602623	.	T	C	27	32	59	0	2	61	0	0
7	38602656	.	G	A	31	27	58	0	1	59	0	0
7	38602917	.	A	T	32	28	60	0	1	61	0	0
7	38612100	.	A	G	4	2	6	0	0	6	0	0
7	38612109	.	G	A	5	7	12	0	1	13	0	0
7	38673259	.	G	A	0	1	1	0	1	2	0	0
7	38674189	.	T	C	1	0	1	0	0	1	0	0
7	38677497	.	T	C	19	11	30	0	2	32	0	0
7	38677880	.	G	T	9	11	20	0	0	20	0	0
7	38677999	.	A	T	8	8	16	0	0	16	0	0
7	38681322	.	C	T	1	2	3	0	0	3	0	0
7	38683503	.	C	A	1	1	2	0	1	3	0	0
7	38683834	.	T	C	4	10	14	0	0	14	0	0
7	38684830	.	C	T	15	12	27	0	0	27	0	0
7	38684970	.	C	T	11	14	25	0	1	26	0	0
7	38685201	.	T	G	2	3	5	0	0	5	0	0
7	38686194	.	C	T	2	2	4	0	0	4	0	0
7	38686321	.	C	G	2	5	7	0	1	8	0	0
7	38688270	.	G	A	0	3	3	0	3	6	0	0
7	38688294	.	A	G	3	3	6	0	1	7	0	0
7	38688318	.	C	T	3	2	5	0	0	5	0	0
7	38690012	.	C	T	2	4	6	0	0	6	0	0
7	38690013	.	C	T	2	4	6	0	0	6	0	0
7	38696163	.	A	G	45	26	71	0	3	74	0	0
7	38703434	.	T	A	2	4	6	0	0	6	0	0
7	38703509	.	C	T	0	2	2	0	2	4	0	0
7	38703598	.	C	T	6	4	10	0	1	11	0	0
7	38704006	.	G	A	10	4	14	0	0	14	0	0
7	38704009	.	G	A	10	5	15	0	0	15	0	0
7	38704063	.	T	C	2	12	14	0	1	15	0	0
7	38704622	.	C	A	6	5	11	0	0	11	0	0
7	38704623	.	T	C	6	0	6	0	5	11	0	0
7	38704754	.	C	T	3	5	8	0	2	10	0	0
7	38704832	.	G	A	3	6	9	0	0	9	0	0
7	38704834	.	A	G	2	6	8	0	1	9	0	0
7	38705012	.	A	T	7	3	10	0	1	11	0	0
7	38705097	.	A	C	4	2	6	0	4	10	0	0
7	38705367	.	C	G	0	9	9	0	4	13	0	0
7	38705643	.	A	G	5	1	6	0	0	6	0	0
7	38709326	.	G	T	3	2	5	0	0	5	0	0
7	38714503	.	A	T	4	2	6	0	1	7	0	0
7	38717795	.	G	A	0	7	7	0	10	17	0	0
7	38717819	.	A	C	13	12	25	0	0	25	0	0
7	38722708	.	T	C	5	4	9	0	0	9	0	0
7	38722716	.	T	A	7	5	12	0	1	13	0	0
7	38726646	.	A	G	18	9	27	0	1	28	0	0
7	38734152	.	G	A	1	11	12	0	4	16	0	0
7	38734276	.	T	G	11	8	19	0	1	20	0	0
7	38734431	.	C	A	14	8	22	0	1	23	0	0
7	38734475	.	A	C	15	16	31	0	2	33	0	0
7	38734527	.	T	C	16	17	33	0	1	34	0	0
7	38734573	.	A	G	16	15	31	0	1	32	0	0
7	38734626	.	G	T	23	16	39	0	0	39	0	0
7	38735363	.	A	G	17	22	39	0	1	40	0	0
7	38735406	.	C	T	17	19	36	0	2	38	0	0
7	38735460	.	G	T	21	20	41	0	0	41	0	0
7	38735465	.	A	C	21	18	39	0	2	41	0	0
7	38735501	.	T	C	16	23	39	0	0	39	0	0
7	38735552	.	T	A	6	5	11	0	4	15	0	0
7	38735580	.	G	T	2	3	5	0	0	5	0	0
7	38735711	.	G	A	7	17	24	0	1	25	0	0
7	38735727	.	A	T	9	14	23	0	3	26	0	0
7	38735827	.	A	C	10	17	27	0	1	28	0	0
7	38736320	.	G	C	24	18	42	0	2	44	0	0
7	38736526	.	C	T	6	13	19	0	2	21	0	0
7	38736616	.	T	A	6	5	11	0	1	12	0	0
7	38736653	.	T	C	1	6	7	0	0	7	0	0
7	38736818	.	C	A	1	3	4	0	0	4	0	0
7	38736819	.	A	G	1	3	4	0	0	4	0	0
7	38736912	.	T	C	2	5	7	0	1	8	0	0
7	38737020	.	T	C	10	9	19	0	0	19	0	0
7	38737224	.	C	T	16	8	24	1	0	25	0	0
7	38737286	.	C	T	11	8	19	0	0	19	0	0
7	38749816	.	G	A	0	2	2	0	1	3	0	0
7	38762091	.	A	C	4	1	5	0	0	5	0	0
7	38762127	.	A	G	2	0	2	0	0	2	0	0
7	38773039	.	C	T	1	2	3	0	0	3	0	0
7	38777082	.	C	T	4	4	8	0	1	9	0	0
7	38777330	.	T	C	4	9	13	0	3	16	0	0
7	38779297	.	T	A	1	5	6	0	2	8	0	0
7	38779695	.	T	A	1	1	2	0	0	2	0	0
7	38779696	.	T	C	1	1	2	0	0	2	0	0
7	38783718	.	A	G	20	19	39	0	2	41	0	0
7	38783742	.	G	A	21	15	36	0	4	40	0	0
7	38783799	.	A	T	18	20	38	0	3	41	0	0
7	38783881	.	T	A	11	14	25	0	3	28	0	0
7	38783972	.	T	C	9	11	20	0	0	20	0	0
7	38783984	.	G	T	0	11	11	0	13	24	0	0
7	38784370	.	C	G	20	10	30	0	1	31	0	0
7	38784486	.	T	C	7	20	27	0	0	27	0	0
7	38784494	.	A	G	8	0	8	0	21	29	0	0
7	38784648	.	A	G	22	29	51	0	2	53	0	0
7	38784681	.	G	A	24	23	47	0	1	48	0	0
7	38784766	.	C	A	20	27	47	0	0	47	0	0
7	38784818	.	G	A	25	30	55	0	1	56	0	0
7	38784985	.	T	G	19	18	37	0	0	37	0	0
7	38785182	.	G	C	2	20	22	0	24	46	0	0
7	38794233	.	C	T	0	15	15	0	7	22	0	0
7	38794235	.	C	T	7	15	22	0	0	22	0	0
7	38794411	.	A	G	20	14	34	0	2	36	0	0
7	38794562	.	A	G	14	20	34	0	1	35	0	0
7	38799622	.	T	C	6	0	6	0	10	16	0	0
7	38805508	.	T	G	1	0	1	0	0	1	0	0
7	38807714	.	G	A	7	15	22	0	1	23	0	0
7	38807723	.	A	T	7	17	24	0	0	25	1	0
7	38807750	.	C	T	16	16	32	0	0	32	0	0
7	38809502	.	T	C	3	4	7	0	1	8	0	0
7	38809508	.	C	T	3	3	6	0	1	7	0	0
7	38809625	.	T	C	4	5	9	0	0	9	0	0
7	38809865	.	G	T	0	11	11	0	3	14	0	0
7	38810084	.	A	C	3	4	7	0	0	7	0	0
7	38810173	.	C	A	4	2	6	0	0	6	0	0
7	38810518	.	A	G	2	0	2	0	2	4	0	0
7	38820388	.	A	T	6	2	8	0	0	8	0	0
7	38821790	.	G	C	4	2	6	0	0	6	0	0
7	38822365	.	T	A	4	4	8	0	1	9	0	0
7	38822368	.	A	T	5	4	9	0	0	9	0	0
7	38822801	.	A	G	4	4	8	0	1	9	0	0
7	38822825	.	T	C	3	6	9	0	0	9	0	0
7	38824387	.	C	G	6	12	18	0	0	18	0	0
7	38842502	.	C	T	1	2	3	0	3	6	0	0
7	38924331	.	G	A	1	3	4	0	2	6	0	0
7	38954318	.	A	C	2	2	4	0	0	4	0	0
7	38954657	.	T	C	1	4	5	0	0	5	0	0
7	38962353	.	T	G	1	2	3	0	0	3	0	0
7	38962584	.	T	C	0	3	3	0	0	3	0	0
7	39092476	.	A	G	1	1	2	0	0	2	0	0
7	39097193	.	T	C	2	5	7	0	0	7	0	0
7	39142946	.	G	T	2	3	5	0	0	5	0	0
7	39142961	.	C	T	2	4	6	0	0	6	0	0
7	39143018	.	G	A	2	7	9	0	0	9	0	0
7	39153849	.	G	A	0	7	7	0	6	13	0	0
7	39154181	.	A	T	5	8	13	0	1	14	0	0
7	39154273	.	C	G	7	6	13	0	0	13	0	0
7	39154733	.	G	T	4	2	6	0	0	6	0	0
7	39154971	.	C	T	12	6	18	0	0	18	0	0
7	39155508	.	A	T	12	4	16	0	0	16	0	0
7	39155758	.	T	G	2	2	4	0	0	4	0	0
7	39155940	.	T	A	2	9	11	0	0	11	0	0
7	39155943	.	T	C	2	8	10	0	1	11	0	0
7	39156101	.	T	G	10	7	17	0	0	17	0	0
7	39156140	.	T	C	11	8	19	0	1	20	0	0
7	39156207	.	T	C	8	8	16	0	3	19	0	0
7	39156376	.	A	G	6	10	16	0	0	16	0	0
7	39156416	.	T	G	11	0	11	0	7	18	0	0
7	39156417	.	T	G	11	7	18	0	0	18	0	0
7	39156553	.	C	A	17	14	31	0	1	32	0	0
7	39156567	.	G	C	16	15	31	0	1	32	0	0
7	39156673	.	A	T	7	2	9	0	0	9	0	0
7	39156698	.	G	A	0	5	5	0	5	10	0	0
7	39156760	.	A	G	13	15	28	0	0	28	0	0
7	39156846	.	T	C	10	11	21	0	0	21	0	0
7	39156969	.	T	C	13	9	22	0	0	22	0	0
7	39157219	.	G	A	1	4	5	0	11	16	0	0
7	39157320	.	C	T	2	3	5	0	0	5	0	0
7	39174052	.	T	C	4	2	6	0	0	6	0	0
7	39174145	.	T	C	8	18	26	0	2	28	0	0
7	39174452	.	G	A	1	13	14	0	14	28	0	0
7	39176739	.	A	T	11	6	17	0	0	17	0	0
7	39176790	.	T	G	15	8	23	0	0	23	0	0
7	39176881	.	G	A	20	8	28	0	0	28	0	0
7	39176922	.	T	A	13	6	19	0	1	20	0	0
7	39176940	.	A	G	8	5	13	0	0	13	0	0
7	39176957	.	A	G	2	4	6	0	1	7	0	0
7	39176983	.	T	C	2	2	4	0	0	4	0	0
7	39177527	.	G	A	17	11	28	0	2	30	0	0
7	39177558	.	T	C	16	10	26	0	1	27	0	0
7	39177601	.	C	A	15	6	21	0	2	23	0	0
7	39177679	.	C	T	16	7	23	0	0	23	0	0
7	39177717	.	A	G	21	6	27	0	3	30	0	0
7	39177822	.	A	T	12	11	23	0	0	23	0	0
7	39177962	.	T	C	7	3	10	0	0	10	0	0
7	39181264	.	T	C	8	1	9	0	19	28	0	0
7	39181347	.	G	A	16	6	22	0	1	23	0	0
7	39181853	.	C	A	6	8	14	0	0	14	0	0
7	39182127	.	T	C	17	16	33	0	1	34	0	0
7	39182433	.	T	C	14	12	26	0	1	27	0	0
7	39182910	.	G	A	12	16	28	0	0	28	0	0
7	39183045	.	A	G	7	10	17	0	0	17	0	0
7	39203411	.	G	A	1	0	1	0	0	1	0	0
7	39256326	.	A	G	1	2	3	0	2	5	0	0
7	39280835	.	T	A	2	3	5	0	0	5	0	0
7	39316206	.	G	A	1	2	3	0	0	3	0	0
7	39360250	.	T	C	5	2	7	0	0	7	0	0
7	39360263	.	G	A	4	2	6	0	0	6	0	0
7	39364137	.	G	C	1	0	1	0	0	1	0	0
7	39366672	.	C	A	1	0	1	0	0	1	0	0
7	39367765	.	G	A	1	1	2	0	0	2	0	0
7	39371295	.	T	C	3	3	6	0	2	8	0	0
7	39373331	.	A	G	1	0	1	0	0	1	0	0
7	39463701	.	T	G	3	2	5	0	0	5	0	0
7	39464015	.	T	C	3	3	6	0	1	7	0	0
7	39471520	.	G	A	2	8	10	0	0	10	0	0
7	39471782	.	A	C	0	1	1	0	0	1	0	0
7	39474551	.	A	G	1	0	1	0	0	1	0	0
7	39477223	.	A	G	3	6	9	0	0	9	0	0
7	39477304	.	G	A	1	1	2	0	1	3	0	0
7	39481522	.	T	C	1	2	3	0	0	3	0	0
7	39481844	.	A	C	3	5	8	0	1	9	0	0
7	39481848	.	C	T	3	6	9	0	0	9	0	0
7	39482169	.	C	T	0	5	5	0	1	6	0	0
7	39482581	.	T	A	3	3	6	0	2	8	0	0
7	39482671	.	C	G	0	7	7	0	2	9	0	0
7	39482674	.	G	C	1	0	1	0	8	9	0	0
7	39483252	.	T	C	4	2	6	0	0	6	0	0
7	39483373	.	G	A	1	3	4	0	0	4	0	0
7	39483454	.	A	C	1	0	1	0	7	8	0	0
7	39483783	.	C	T	2	3	5	0	0	5	0	0
7	39483808	.	C	T	0	2	2	0	2	4	0	0
7	39484197	.	A	G	0	1	1	0	0	1	0	0
7	39509288	.	G	A	0	2	2	0	0	2	0	0
7	39509291	.	C	T	0	2	2	0	0	2	0	0
7	39514943	.	A	G	1	2	3	0	0	3	0	0
7	39537921	.	A	T	1	2	3	0	0	3	0	0
7	39537983	.	C	G	5	6	11	0	0	11	0	0
7	39636727	.	T	C	2	1	3	0	0	3	0	0
7	39640249	.	C	T	1	5	6	0	1	7	0	0
7	39642671	.	G	A	0	3	3	0	2	5	0	0
7	39643001	.	G	A	1	2	3	0	0	3	0	0
7	39654722	.	C	T	9	10	19	0	1	20	0	0
7	39655237	.	T	A	7	4	11	0	1	12	0	0
7	39656620	.	G	A	9	4	13	0	0	13	0	0
7	39656916	.	C	T	6	5	11	0	0	11	0	0
7	39656950	.	G	T	1	4	5	0	1	6	0	0
7	39656974	.	G	A	3	6	9	0	0	9	0	0
7	39657389	.	C	A	6	5	11	0	0	11	0	0
7	39657467	.	T	A	10	10	20	0	0	20	0	0
7	39657891	.	A	G	1	2	3	0	0	3	0	0
7	39658195	.	C	T	9	10	19	0	0	19	0	0
7	39658293	.	C	A	18	5	23	0	0	23	0	0
7	39658441	.	T	C	7	9	16	0	0	16	0	0
7	39658445	.	C	A	7	11	18	0	0	18	0	0
7	39658730	.	G	T	0	15	15	0	12	27	0	0
7	39659792	.	T	C	4	8	12	0	2	14	0	0
7	39659973	.	A	G	5	10	15	0	1	16	0	0
7	39660240	.	A	T	16	6	22	0	0	22	0	0
7	39660249	.	A	C	18	14	32	0	1	33	0	0
7	39660304	.	A	G	26	18	44	0	5	49	0	0
7	39660624	.	C	A	13	16	29	0	1	30	0	0
7	39676301	.	G	T	11	2	13	0	1	14	0	0
7	39676303	.	A	T	12	2	14	0	0	14	0	0
7	39676776	.	C	G	12	18	30	0	1	31	0	0
7	39676833	.	T	C	11	14	25	0	1	26	0	0
7	39676948	.	T	G	12	3	15	0	3	18	0	0
7	39677549	.	T	C	13	9	22	0	0	22	0	0
7	39677625	.	G	T	12	14	26	0	2	28	0	0
7	39677755	.	C	T	6	8	14	0	1	15	0	0
7	39677878	.	G	C	15	15	30	0	1	31	0	0
7	39677924	.	A	G	12	15	27	0	1	28	0	0
7	39677998	.	C	G	10	17	27	0	0	27	0	0
7	39691119	.	G	A	0	7	7	0	11	18	0	0
7	39691143	.	T	C	8	8	16	0	1	17	0	0
7	39691357	.	G	A	6	3	9	0	0	9	0	0
7	39691394	.	A	G	1	7	8	0	0	8	0	0
7	39693686	.	T	C	2	0	2	0	0	2	0	0
7	39695483	.	C	T	0	1	1	0	0	1	0	0
7	39695527	.	A	G	0	0	0	0	1	1	0	0
7	39695535	.	T	C	0	1	1	0	0	1	0	0
7	39698963	.	T	C	9	16	25	0	0	25	0	0
7	39702022	.	C	G	1	7	8	0	0	8	0	0
7	39702172	.	T	C	6	3	9	0	0	9	0	0
7	39702337	.	C	A	6	4	10	0	1	11	0	0
7	39702396	.	A	T	4	2	6	0	0	6	0	0
7	39702800	.	C	T	4	3	7	0	0	7	0	0
7	39703139	.	G	A	0	3	3	0	4	7	0	0
7	39703669	.	A	T	1	2	3	0	0	3	0	0
7	39703720	.	G	T	1	1	2	0	2	4	0	0
7	39703734	.	T	C	2	2	4	0	1	5	0	0
7	39703760	.	A	G	2	2	4	0	0	4	0	0
7	39703898	.	G	C	5	2	7	0	0	7	0	0
7	39704063	.	T	A	4	8	12	0	0	12	0	0
7	39704085	.	A	G	4	5	9	0	1	10	0	0
7	39704166	.	A	T	9	6	15	0	2	17	0	0
7	39704216	.	T	C	11	6	17	0	0	17	0	0
7	39704223	.	A	G	10	6	16	0	1	17	0	0
7	39704254	.	G	A	7	3	10	0	2	12	0	0
7	39705601	.	A	G	5	4	9	0	0	9	0	0
7	39740579	.	T	C	3	4	7	0	0	7	0	0
7	39740651	.	A	G	1	2	3	0	0	3	0	0
7	39741221	.	C	A	0	2	2	0	1	3	0	0
7	39741416	.	G	A	1	2	3	0	0	3	0	0
7	39742334	.	G	A	0	5	5	0	1	6	0	0
7	39742729	.	T	A	1	3	4	0	0	4	0	0
7	39742730	.	A	T	1	3	4	0	0	4	0	0
7	39742784	.	A	G	2	2	4	0	0	4	0	0
7	39742820	.	T	G	2	3	5	0	1	6	0	0
7	39743014	.	A	G	6	0	6	0	3	9	0	0
7	39743038	.	T	G	6	0	6	0	5	11	0	0
7	39743163	.	T	A	3	3	6	0	0	6	0	0
7	39743181	.	T	C	2	4	6	0	0	6	0	0
7	39743358	.	G	A	1	3	4	0	0	4	0	0
7	39744494	.	G	A	8	11	19	0	1	20	0	0
7	39745091	.	T	C	3	5	8	0	0	8	0	0
7	39745580	.	A	G	2	2	4	0	0	4	0	0
7	40091552	.	A	T	6	2	8	0	2	10	0	0
7	40492740	.	T	A	3	3	6	0	0	6	0	0
7	40492764	.	G	C	1	4	5	0	1	6	0	0
7	40492789	.	T	C	2	4	6	0	0	6	0	0
7	40492800	.	G	T	2	4	6	0	0	6	0	0
7	41358387	.	T	C	1	0	1	0	0	1	0	0
7	41714385	.	T	C	4	6	10	0	0	10	0	0
7	41714454	.	T	C	7	2	9	1	0	10	0	0
7	41714560	.	T	C	6	2	8	0	1	9	0	0
7	41714563	.	T	C	4	4	8	0	1	9	0	0
7	41900402	.	G	C	0	2	2	0	0	2	0	0
7	41901248	.	A	G	5	0	5	0	3	8	0	0
7	43760754	.	T	C	13	6	19	0	3	22	0	0
7	44470494	.	C	T	7	2	9	0	0	9	0	0
7	44588458	.	A	G	13	5	18	0	0	18	0	0
7	46487662	.	C	A	1	5	6	0	0	6	0	0
7	46782084	.	A	C	1	2	3	0	0	3	0	0
7	47265569	.	A	G	2	0	2	0	5	7	0	0
7	47265729	.	T	C	2	3	5	0	0	5	0	0
7	47265810	.	G	A	3	7	10	0	0	10	0	0
7	47265859	.	A	T	4	10	14	0	2	16	0	0
7	47265934	.	G	A	1	4	5	0	2	7	0	0
7	47312817	.	C	T	1	0	1	0	0	1	0	0
7	47317344	.	G	A	0	4	4	0	1	5	0	0
7	47324109	.	G	A	1	0	1	0	0	1	0	0
7	47358452	.	A	G	1	1	2	0	1	3	0	0
7	47358467	.	G	T	1	0	1	0	0	1	0	0
7	47411071	.	G	A	0	11	11	0	7	18	0	0
7	47411934	.	C	T	7	9	16	0	0	16	0	0
7	47411977	.	C	T	9	15	24	0	0	24	0	0
7	47412373	.	C	T	4	5	9	0	0	9	0	0
7	47412418	.	C	T	5	10	15	0	0	15	0	0
7	47412495	.	A	G	9	0	9	0	3	12	0	0
7	47412600	.	G	A	3	4	7	0	0	7	0	0
7	47413615	.	T	C	7	4	11	0	0	11	0	0
7	47414348	.	C	T	12	12	24	0	1	25	0	0
7	47415139	.	A	T	5	5	10	0	0	10	0	0
7	47415181	.	G	T	5	2	7	0	0	7	0	0
7	47416061	.	C	T	9	11	20	0	2	22	0	0
7	47416407	.	A	C	1	10	11	0	0	11	0	0
7	47416496	.	T	A	3	6	9	0	1	10	0	0
7	47416876	.	T	C	5	5	10	0	1	11	0	0
7	47416884	.	G	C	4	3	7	0	0	7	0	0
7	47417195	.	T	A	8	5	13	0	0	13	0	0
7	47417821	.	C	T	6	8	14	0	1	16	1	0
7	47417934	.	T	A	8	11	19	0	0	19	0	0
7	47418225	.	T	G	0	11	11	0	1	12	0	0
7	47418320	.	C	T	12	8	20	0	0	20	0	0
7	47418526	.	T	C	9	13	22	0	0	22	0	0
7	47418575	.	G	T	7	10	17	0	1	18	0	0
7	47418657	.	G	A	11	16	27	0	0	27	0	0
7	47419070	.	T	A	10	7	17	0	0	17	0	0
7	47419177	.	A	C	13	1	14	0	11	25	0	0
7	47419250	.	T	G	8	7	15	0	0	15	0	0
7	47419653	.	G	A	15	9	24	0	1	25	0	0
7	47420019	.	A	G	11	9	20	0	3	23	0	0
7	47420208	.	A	G	0	1	1	0	0	1	0	0
7	47421313	.	C	T	5	6	11	0	1	12	0	0
7	47488246	.	C	T	6	10	16	0	0	16	0	0
7	47507136	.	G	A	9	5	14	0	0	14	0	0
7	47524444	.	T	C	4	7	11	0	0	11	0	0
7	47540131	.	G	C	1	0	1	0	0	1	0	0
7	47563359	.	C	T	0	4	4	0	5	9	0	0
7	47563381	.	A	T	2	6	8	0	0	8	0	0
7	47563677	.	A	G	4	2	6	0	0	6	0	0
7	47563872	.	A	G	2	2	4	0	0	4	0	0
7	47563890	.	A	G	1	6	7	0	0	7	0	0
7	47564430	.	A	G	3	7	10	0	0	10	0	0
7	47584257	.	C	T	3	2	5	0	0	5	0	0
7	47614349	.	A	G	2	7	9	0	0	9	0	0
7	47628203	.	G	A	0	0	0	0	1	1	0	0
7	47691531	.	T	C	1	2	3	0	0	3	0	0
7	48041808	.	A	T	12	8	20	0	1	21	0	0
7	48042483	.	G	T	6	7	13	0	3	16	0	0
7	48372387	.	A	G	2	2	4	0	0	4	0	0
7	49620601	.	T	C	6	3	9	0	0	9	0	0
7	50877064	.	T	C	2	5	7	0	0	7	0	0
7	51220278	.	T	C	12	6	18	0	1	19	0	0
7	51220557	.	G	A	3	7	10	0	0	10	0	0
7	51249441	.	G	T	1	3	4	0	0	4	0	0
7	51315177	.	G	T	1	2	3	0	0	3	0	0
7	51331947	.	C	T	1	1	2	0	0	2	0	0
7	51352721	.	A	T	6	2	8	0	1	9	0	0
7	51352806	.	T	C	3	4	7	0	1	8	0	0
7	51352871	.	T	C	4	6	10	0	1	11	0	0
7	51353191	.	G	A	3	5	8	0	0	8	0	0
7	51353421	.	C	T	6	6	12	0	0	12	0	0
7	51353447	.	G	T	7	7	14	2	1	17	0	0
7	51353935	.	G	A	3	3	6	0	0	6	0	0
7	51354066	.	G	A	0	5	5	0	2	7	0	0
7	51354233	.	A	G	2	10	12	0	0	12	0	0
7	51354296	.	A	G	0	4	4	0	0	4	0	0
7	51354306	.	T	C	4	0	4	0	0	4	0	0
7	51354424	.	T	A	5	4	9	0	0	9	0	0
7	51354442	.	C	A	1	4	5	0	0	5	0	0
7	51354672	.	T	A	3	4	7	0	1	9	1	0
7	51354696	.	C	T	4	5	9	0	1	10	0	0
7	51354756	.	T	C	9	5	14	0	2	16	0	0
7	51354973	.	T	A	3	3	6	0	0	6	0	0
7	51355342	.	A	G	1	2	3	0	2	5	0	0
7	51355936	.	G	T	3	4	7	0	0	7	0	0
7	51355972	.	T	A	3	5	8	0	0	8	0	0
7	51355993	.	T	A	3	3	6	0	0	6	0	0
7	51356100	.	A	T	7	6	13	0	0	13	0	0
7	51365987	.	A	G	1	2	3	0	0	3	0	0
7	51368654	.	T	G	1	3	4	0	0	4	0	0
7	51423426	.	G	A	0	1	1	0	0	1	0	0
7	51468042	.	C	T	0	11	11	0	17	28	0	0
7	51468199	.	C	T	21	17	38	0	0	38	0	0
7	51468389	.	C	T	0	11	11	0	15	26	0	0
7	51468411	.	A	T	15	8	23	0	0	23	0	0
7	51468556	.	G	C	28	12	40	1	1	42	0	0
7	51468577	.	C	A	10	30	40	1	1	42	0	0
7	51468928	.	G	A	9	10	19	0	2	21	0	0
7	51469048	.	T	G	15	19	34	0	1	35	0	0
7	51469166	.	A	T	16	14	30	0	0	30	0	0
7	51469340	.	G	A	12	7	19	0	2	21	0	0
7	51469361	.	A	G	10	7	17	0	0	17	0	0
7	51469578	.	T	G	9	14	23	0	0	23	0	0
7	51469897	.	A	G	10	6	16	0	0	16	0	0
7	51469952	.	A	T	6	14	20	0	0	20	0	0
7	51469956	.	C	T	0	12	12	0	9	21	0	0
7	51470070	.	T	C	10	0	10	0	9	19	0	0
7	51470156	.	T	C	4	3	7	0	0	7	0	0
7	51470166	.	T	C	0	5	5	0	0	5	0	0
7	51470191	.	T	C	4	0	4	0	0	4	0	0
7	51470230	.	T	A	1	1	2	0	0	2	0	0
7	51470276	.	G	A	3	2	5	0	0	5	0	0
7	51470409	.	T	A	0	8	8	0	0	8	0	0
7	51470569	.	G	T	6	8	14	0	0	14	0	0
7	51470741	.	A	G	2	5	7	0	0	7	0	0
7	51470868	.	C	A	12	8	20	0	0	20	0	0
7	51471107	.	G	A	2	15	17	0	1	18	0	0
7	51471117	.	A	G	2	15	17	0	1	18	0	0
7	51471365	.	T	C	11	0	11	0	0	11	0	0
7	51471554	.	T	C	3	0	3	0	12	15	0	0
7	51471690	.	T	C	9	1	10	0	6	16	0	0
7	51471714	.	A	G	9	11	20	0	0	20	0	0
7	51471775	.	G	A	6	5	11	0	0	11	0	0
7	51472456	.	C	T	7	6	13	0	1	14	0	0
7	51472693	.	C	T	0	4	4	0	12	16	0	0
7	51472702	.	A	G	11	4	15	0	1	16	0	0
7	51472793	.	A	C	6	0	6	0	5	11	0	0
7	51473000	.	C	T	1	0	1	0	0	1	0	0
7	51473585	.	T	C	1	0	1	0	5	6	0	0
7	51473673	.	G	A	3	1	4	0	0	4	0	0
7	51473814	.	C	T	3	2	5	0	0	5	0	0
7	51474238	.	G	A	9	3	12	0	0	12	0	0
7	51474279	.	C	A	7	7	14	0	1	15	0	0
7	51474300	.	G	T	7	5	12	0	0	12	0	0
7	51474468	.	C	T	0	12	12	0	8	20	0	0
7	51475111	.	G	A	7	6	13	0	0	13	0	0
7	51475199	.	G	C	5	5	10	0	1	11	0	0
7	51475288	.	G	A	2	4	6	0	0	6	0	0
7	51475795	.	T	A	3	5	8	0	0	8	0	0
7	51476108	.	G	A	4	5	9	0	0	9	0	0
7	51493063	.	C	T	0	2	2	0	1	3	0	0
7	51634231	.	A	G	28	27	55	0	5	60	0	0
7	51634285	.	C	T	14	16	30	0	0	30	0	0
7	51634480	.	G	A	28	43	71	0	0	71	0	0
7	51643163	.	A	G	3	3	6	0	0	6	0	0
7	51643363	.	G	A	2	3	5	0	0	5	0	0
7	51643366	.	G	A	3	3	6	0	0	6	0	0
7	51643639	.	A	C	3	5	8	0	0	8	0	0
7	51643722	.	A	G	7	3	10	0	0	10	0	0
7	51656576	.	A	G	5	2	7	0	1	8	0	0
7	51779552	.	G	A	0	7	7	0	11	18	0	0
7	51779636	.	T	C	4	5	9	0	0	9	0	0
7	51786442	.	T	G	11	0	11	0	12	23	0	0
7	51788729	.	C	T	14	18	32	0	0	32	0	0
7	51788756	.	A	C	8	8	16	0	0	16	0	0
7	51793623	.	C	T	19	14	33	0	0	33	0	0
7	51793747	.	C	T	11	14	25	0	0	25	0	0
7	51793813	.	G	C	9	14	23	0	1	24	0	0
7	51795827	.	C	T	2	1	3	0	1	4	0	0
7	51795835	.	C	T	1	1	2	0	1	3	0	0
7	51808327	.	T	C	1	0	1	0	0	1	0	0
7	51808384	.	G	C	0	3	3	0	5	8	0	0
7	51808396	.	C	T	4	4	8	0	0	8	0	0
7	51813764	.	G	A	4	5	9	0	0	9	0	0
7	51814287	.	C	G	4	5	9	0	0	9	0	0
7	51814385	.	G	C	9	9	18	0	0	18	0	0
7	51814512	.	C	T	1	4	5	0	0	5	0	0
7	51817882	.	T	G	1	2	3	0	0	3	0	0
7	51824687	.	C	A	4	6	10	0	1	11	0	0
7	51824718	.	A	C	4	4	8	0	0	8	0	0
7	51824772	.	T	G	2	4	6	0	0	6	0	0
7	52145099	.	A	T	1	2	3	0	0	3	0	0
7	52152053	.	A	T	2	2	4	0	1	5	0	0
7	52152063	.	C	T	0	2	2	0	3	5	0	0
7	52152863	.	G	A	1	3	4	0	0	4	0	0
7	52156113	.	G	A	0	2	2	0	0	2	0	0
7	52156137	.	T	A	3	2	5	0	0	5	0	0
7	52157782	.	T	C	4	3	7	0	0	7	0	0
7	52157814	.	G	T	10	6	16	0	0	16	0	0
7	52157994	.	A	G	4	0	4	0	4	8	0	0
7	52158339	.	G	C	6	5	11	0	0	11	0	0
7	52158362	.	T	A	5	5	10	0	0	10	0	0
7	52158916	.	C	G	3	2	5	0	0	5	0	0
7	52161646	.	G	T	0	1	1	0	0	1	0	0
7	52165016	.	T	A	1	3	4	0	0	4	0	0
7	52173195	.	C	A	5	5	10	0	1	11	0	0
7	52175362	.	T	C	11	6	17	0	1	18	0	0
7	52178542	.	T	C	0	1	1	0	0	1	0	0
7	52282674	.	G	T	5	2	7	0	1	8	0	0
7	52285113	.	C	G	4	5	9	0	3	12	0	0
7	52285265	.	T	A	2	2	4	0	0	4	0	0
7	52294403	.	G	A	13	21	34	0	0	34	0	0
7	52294540	.	A	T	13	14	27	0	3	30	0	0
7	52294746	.	C	T	0	9	9	0	7	16	0	0
7	52295795	.	C	T	1	14	15	0	11	26	0	0
7	52296018	.	T	C	21	13	34	0	3	37	0	0
7	52296320	.	G	A	8	12	20	0	0	20	0	0
7	52296352	.	G	T	6	8	14	0	1	15	0	0
7	52296400	.	C	A	8	4	12	0	0	12	0	0
7	52309924	.	G	A	1	2	3	0	1	4	0	0
7	52315434	.	C	G	0	3	3	0	2	5	0	0
7	52328463	.	A	G	5	2	7	0	0	7	0	0
7	52328569	.	C	T	4	8	12	0	0	12	0	0
7	52371448	.	T	C	2	0	2	0	2	4	0	0
7	52431954	.	C	T	4	2	6	0	0	6	0	0
7	52449167	.	G	A	1	0	1	0	0	1	0	0
7	52517561	.	C	G	7	7	14	0	0	14	0	0
7	52518017	.	T	A	1	3	4	0	0	4	0	0
7	52518018	.	T	A	1	3	4	0	0	4	0	0
7	52518134	.	G	C	3	0	3	0	10	13	0	0
7	52518271	.	A	T	8	5	13	0	0	13	0	0
7	52519134	.	G	A	10	8	18	0	1	19	0	0
7	52521352	.	G	A	2	5	7	0	1	8	0	0
7	52709772	.	T	A	6	4	10	0	0	10	0	0
7	52716777	.	T	A	2	6	8	0	0	8	0	0
7	52716792	.	A	T	2	8	10	0	0	10	0	0
7	52716875	.	C	A	0	1	1	0	0	1	0	0
7	52717095	.	T	C	15	5	20	0	0	20	0	0
7	52728713	.	G	A	0	2	2	0	1	3	0	0
7	52750565	.	C	T	8	12	20	0	0	20	0	0
7	52750847	.	C	T	10	10	20	0	0	20	0	0
7	52751306	.	T	C	0	4	4	0	1	5	0	0
7	52751357	.	T	C	3	2	5	0	0	5	0	0
7	52753577	.	G	T	0	3	3	0	2	5	0	0
7	52820060	.	T	A	5	3	8	0	0	8	0	0
7	52820320	.	C	T	7	11	18	0	0	18	0	0
7	52820700	.	T	C	1	9	10	0	0	10	0	0
7	52821156	.	T	G	1	2	3	0	0	3	0	0
7	52821244	.	T	C	2	2	4	0	0	4	0	0
7	52821646	.	A	C	3	5	8	0	1	9	0	0
7	52821658	.	C	A	5	5	10	0	0	10	0	0
7	52821701	.	G	A	3	6	9	0	2	11	0	0
7	52822708	.	C	T	5	3	8	0	1	9	0	0
7	52822791	.	T	A	7	10	17	0	0	17	0	0
7	52822793	.	A	G	6	10	16	0	1	17	0	0
7	52823429	.	A	T	11	5	16	0	0	16	0	0
7	52830423	.	G	T	1	4	5	0	0	5	0	0
7	52830447	.	G	T	3	5	8	0	1	9	0	0
7	52830601	.	T	G	9	18	27	0	1	28	0	0
7	52831053	.	G	T	24	19	43	0	1	44	0	0
7	52831413	.	C	T	12	17	29	0	1	30	0	0
7	52831572	.	T	C	9	0	9	1	3	13	0	0
7	52831582	.	G	A	1	4	5	1	0	6	0	0
7	52831622	.	T	C	5	7	12	0	0	12	0	0
7	52832127	.	C	T	21	14	35	0	1	36	0	0
7	52832129	.	C	T	21	11	32	0	4	36	0	0
7	52832351	.	C	A	12	8	20	0	0	20	0	0
7	52832427	.	C	A	6	13	19	0	1	20	0	0
7	52833126	.	C	G	7	10	17	0	0	17	0	0
7	52833248	.	A	T	19	7	26	0	1	27	0	0
7	52833606	.	G	A	15	15	30	0	1	31	0	0
7	52833792	.	G	A	16	15	31	0	1	32	0	0
7	52837804	.	T	G	21	9	30	0	1	31	0	0
7	52837908	.	G	A	13	16	29	0	2	31	0	0
7	52838681	.	G	A	12	16	28	0	0	28	0	0
7	52839062	.	C	T	10	11	21	0	0	21	0	0
7	52841648	.	G	A	8	4	12	0	0	12	0	0
7	52900928	.	A	C	13	7	20	0	1	21	0	0
7	52901531	.	C	T	14	7	21	0	1	22	0	0
7	52902160	.	G	A	5	3	8	0	0	8	0	0
7	52929182	.	G	A	7	7	14	0	1	15	0	0
7	52933191	.	C	T	6	5	11	0	0	11	0	0
7	52937334	.	G	A	8	10	18	0	1	19	0	0
7	52942312	.	G	T	6	7	13	0	0	13	0	0
7	52942472	.	C	T	0	3	3	0	0	3	0	0
7	52944199	.	G	A	9	7	16	0	3	19	0	0
7	52958995	.	T	C	1	4	5	0	0	5	0	0
7	52962765	.	T	C	4	0	4	0	5	9	0	0
7	54039538	.	T	C	3	1	4	0	0	4	0	0
7	54039544	.	G	A	3	1	4	0	0	4	0	0
7	54058312	.	C	T	1	0	1	0	0	1	0	0
7	54069793	.	C	T	2	1	3	0	0	3	0	0
7	54088034	.	C	T	4	6	10	0	2	12	0	0
7	54088230	.	C	T	1	2	3	0	1	4	0	0
7	54088520	.	G	A	4	6	10	0	1	11	0	0
7	54088578	.	T	C	7	11	18	0	2	20	0	0
7	54088850	.	A	G	0	3	3	0	0	3	0	0
7	54088988	.	G	A	7	7	14	0	1	15	0	0
7	54089192	.	A	T	2	4	6	0	0	6	0	0
7	54092602	.	A	T	6	8	14	0	1	15	0	0
7	54102515	.	C	T	6	3	9	0	0	9	0	0
7	54102764	.	C	A	8	4	12	0	1	13	0	0
7	54102884	.	T	A	2	6	8	0	0	8	0	0
7	54102933	.	G	A	1	4	5	0	0	5	0	0
7	54102939	.	A	G	3	2	5	1	3	9	0	0
7	54103168	.	C	T	0	2	2	0	3	5	0	0
7	54103328	.	G	T	3	4	7	0	1	8	0	0
7	54103397	.	A	G	8	4	12	0	0	12	0	0
7	54103841	.	G	A	3	3	6	0	0	6	0	0
7	54103980	.	C	T	2	3	5	0	0	5	0	0
7	54104127	.	C	A	0	2	2	0	5	7	0	0
7	54104318	.	A	G	3	6	9	0	0	9	0	0
7	54104395	.	T	C	3	2	5	0	0	5	0	0
7	54137202	.	G	A	0	2	2	0	0	2	0	0
7	54139515	.	G	A	2	4	6	0	0	6	0	0
7	54307660	.	A	G	3	2	5	0	1	6	0	0
7	54313612	.	G	A	1	1	2	0	1	3	0	0
7	54323986	.	T	C	12	1	13	0	18	31	0	0
7	54324019	.	C	T	9	15	24	0	0	24	0	0
7	54324133	.	C	A	2	1	3	0	0	3	0	0
7	54327110	.	G	A	6	1	7	0	0	7	0	0
7	54327402	.	T	C	5	4	9	0	0	9	0	0
7	54361300	.	C	T	0	1	1	0	1	2	0	0
7	54361303	.	A	G	1	1	2	0	0	2	0	0
7	54373299	.	A	G	1	3	4	0	0	4	0	0
7	54373311	.	C	T	2	4	6	0	1	7	0	0
7	54407619	.	C	T	4	6	10	0	0	10	0	0
7	54407828	.	T	C	2	4	6	0	0	6	0	0
7	54420390	.	C	T	0	1	1	0	1	2	0	0
7	54430450	.	T	C	5	1	6	0	0	6	0	0
7	54498338	.	C	T	2	2	4	0	0	4	0	0
7	54498690	.	A	T	2	3	5	0	1	6	0	0
7	54655025	.	A	T	2	4	6	0	1	7	0	0
7	54655392	.	T	A	2	3	5	0	0	5	0	0
7	54670384	.	C	T	4	3	7	0	1	8	0	0
7	54671934	.	A	T	6	5	11	0	1	12	0	0
7	54673139	.	C	T	4	3	7	0	0	7	0	0
7	55058697	.	A	T	1	2	3	0	1	4	0	0
7	55261074	.	C	T	1	2	3	0	0	3	0	0
7	55300266	.	C	T	1	1	2	0	0	2	0	0
7	55300360	.	T	C	3	2	5	0	0	5	0	0
7	55325582	.	A	T	1	1	2	0	0	2	0	0
7	55325586	.	G	T	1	2	3	0	0	3	0	0
7	55530806	.	T	G	6	2	8	0	1	9	0	0
7	55531105	.	A	G	10	4	14	0	0	14	0	0
7	55531112	.	G	A	9	4	13	0	0	13	0	0
7	55531224	.	G	A	10	4	14	0	4	18	0	0
7	55531430	.	G	T	14	5	19	0	0	19	0	0
7	55531608	.	T	C	8	3	11	0	0	11	0	0
7	55531610	.	G	A	8	3	11	0	0	11	0	0
7	55532125	.	G	A	8	6	14	0	0	14	0	0
7	55532131	.	G	A	8	5	13	0	0	13	0	0
7	55532181	.	C	T	2	2	4	0	0	4	0	0
7	55532234	.	C	T	2	3	5	0	0	5	0	0
7	55532281	.	G	A	3	5	8	0	0	8	0	0
7	55532316	.	A	G	4	5	9	0	0	9	0	0
7	55532327	.	C	A	3	4	7	0	0	7	0	0
7	55532380	.	T	C	5	0	5	0	7	12	0	0
7	55532424	.	C	A	3	11	14	0	0	14	0	0
7	55532429	.	T	C	4	11	15	0	1	16	0	0
7	55532524	.	A	G	3	3	6	0	0	6	0	0
7	55532656	.	A	G	7	7	14	0	0	14	0	0
7	55535754	.	T	A	2	1	3	0	0	3	0	0
7	55536419	.	C	G	1	1	2	0	0	2	0	0
7	55536451	.	G	A	2	3	5	0	0	5	0	0
7	55536487	.	G	A	3	5	8	0	0	8	0	0
7	55539410	.	A	G	5	3	8	0	0	8	0	0
7	55607255	.	C	G	1	1	2	0	0	2	0	0
7	55635202	.	T	C	1	1	2	0	0	2	0	0
7	55635355	.	G	A	0	2	2	0	0	2	0	0
7	55636274	.	G	A	0	3	3	0	1	4	0	0
7	55637122	.	C	A	2	0	2	0	0	2	0	0
7	55660269	.	G	A	15	11	26	0	0	26	0	0
7	55955842	.	G	T	1	2	3	0	0	3	0	0
7	56152363	.	C	A	3	10	13	0	0	13	0	0
7	56152436	.	G	A	5	7	12	0	2	14	0	0
7	56152437	.	G	A	6	7	13	0	1	14	0	0
7	56152660	.	T	C	12	10	22	0	0	22	0	0
7	56152740	.	G	A	18	14	32	0	0	32	0	0
7	56152759	.	C	G	0	18	18	0	14	32	0	0
7	56158197	.	G	A	7	9	16	0	0	16	0	0
7	56164219	.	T	G	1	2	3	0	0	3	0	0
7	56164267	.	G	A	4	12	16	0	0	16	0	0
7	56167349	.	C	A	2	1	3	0	0	3	0	0
7	56177177	.	C	T	0	1	1	0	0	1	0	0
7	56177188	.	T	G	0	1	1	0	0	1	0	0
7	56180417	.	A	C	1	6	7	0	0	7	0	0
7	56180482	.	G	A	1	3	4	0	0	4	0	0
7	56180528	.	G	A	2	3	5	0	1	6	0	0
7	56180589	.	C	A	0	5	5	0	2	7	0	0
7	56253928	.	T	A	1	1	2	0	0	2	0	0
7	56394991	.	T	C	2	2	4	0	1	5	0	0
7	56395495	.	T	C	2	5	7	0	0	7	0	0
7	56395681	.	A	G	2	0	2	0	6	8	0	0
7	56395764	.	G	A	1	3	4	0	0	4	0	0
7	56396599	.	G	A	0	6	6	0	3	9	0	0
7	56400738	.	C	T	2	3	5	0	0	5	0	0
7	56401173	.	T	C	7	10	17	0	1	18	0	0
7	56473558	.	T	A	2	0	2	0	0	2	0	0
7	56473834	.	T	A	1	1	2	0	0	2	0	0
7	56483772	.	T	G	11	9	20	0	2	22	0	0
7	56483928	.	C	T	11	11	22	0	0	22	0	0
7	56484288	.	G	C	14	11	25	0	2	27	0	0
7	56528530	.	T	C	2	2	4	0	0	4	0	0
7	56721933	.	A	G	4	0	4	0	5	9	0	0
7	56737268	.	C	G	1	0	1	0	4	5	0	0
7	56746224	.	T	C	2	4	6	0	1	7	0	0
7	56751971	.	A	G	11	10	21	0	1	22	0	0
7	56752243	.	G	A	3	3	6	0	2	8	0	0
7	56761453	.	A	T	0	2	2	0	0	2	0	0
7	56761482	.	G	T	2	7	9	0	0	9	0	0
7	56764603	.	G	A	2	0	2	0	1	3	0	0
7	56766115	.	C	T	0	4	4	0	9	13	0	0
7	56766282	.	A	C	5	0	5	0	5	10	0	0
7	56766455	.	A	T	3	3	6	0	0	6	0	0
7	56766754	.	A	T	3	3	6	0	2	8	0	0
7	56766828	.	C	G	7	3	10	0	0	10	0	0
7	56766845	.	T	C	5	3	8	0	0	8	0	0
7	56777813	.	T	C	11	1	12	0	6	18	0	0
7	56778305	.	G	A	15	14	29	0	2	31	0	0
7	56778605	.	A	T	27	18	45	0	1	46	0	0
7	56778672	.	G	T	16	16	32	0	0	32	0	0
7	56778721	.	G	T	12	15	27	0	1	28	0	0
7	56778817	.	G	A	7	15	22	0	0	22	0	0
7	56778895	.	A	G	6	14	20	0	0	20	0	0
7	56784046	.	C	T	1	2	3	0	0	3	0	0
7	56784963	.	T	C	13	0	13	0	18	31	0	0
7	56785093	.	A	C	12	14	26	0	1	27	0	0
7	56785308	.	C	T	16	8	24	0	0	24	0	0
7	56787671	.	T	A	9	4	13	0	1	14	0	0
7	56793362	.	G	A	1	0	1	0	0	1	0	0
7	56793377	.	A	C	3	0	3	0	3	6	0	0
7	56793647	.	C	A	0	7	7	0	8	15	0	0
7	57637709	.	T	A	1	3	4	0	0	4	0	0
7	57637713	.	T	C	1	3	4	0	0	4	0	0
7	57839716	.	A	C	1	5	6	0	1	7	0	0
7	57874026	.	G	A	1	0	1	0	0	1	0	0
7	57874038	.	A	C	1	0	1	0	0	1	0	0
7	57874083	.	G	A	0	0	0	0	1	1	0	0
7	57876512	.	T	C	7	6	13	0	0	13	0	0
7	57878712	.	T	C	6	9	15	0	1	16	0	0
7	57878726	.	A	T	4	6	10	0	1	11	0	0
7	57878885	.	C	T	7	6	13	0	0	13	0	0
7	57878973	.	A	T	10	9	19	0	0	19	0	0
7	57878974	.	C	T	10	9	19	0	0	19	0	0
7	57879076	.	A	G	8	0	8	0	7	15	0	0
7	57879205	.	C	T	13	4	17	0	1	18	0	0
7	57879245	.	C	T	10	3	13	0	1	14	0	0
7	57879396	.	T	A	14	23	37	0	0	37	0	0
7	57879431	.	G	T	0	22	22	0	11	34	1	0
7	57879436	.	C	A	11	23	34	0	0	34	0	0
7	57879576	.	C	A	18	16	34	0	1	35	0	0
7	57879601	.	T	C	21	8	29	0	0	29	0	0
7	57879959	.	C	A	10	10	20	0	0	20	0	0
7	57879992	.	G	A	9	9	18	0	1	19	0	0
7	57880073	.	G	C	1	7	8	0	0	8	0	0
7	57886347	.	C	A	17	26	43	0	1	44	0	0
7	57886392	.	T	A	19	27	46	0	1	47	0	0
7	57886964	.	T	G	31	24	55	0	3	58	0	0
7	57887480	.	C	T	20	24	44	0	4	48	0	0
7	57898605	.	G	A	9	8	17	0	2	19	0	0
7	57898623	.	C	T	16	18	34	0	1	35	0	0
7	57898650	.	T	C	27	21	48	0	4	52	0	0
7	57898658	.	C	G	29	27	56	0	2	58	0	0
7	57900948	.	T	A	0	1	1	0	0	1	0	0
7	57913558	.	C	A	21	23	44	0	1	45	0	0
7	57914155	.	T	G	15	14	29	0	2	31	0	0
7	57918590	.	A	G	13	10	23	0	1	24	0	0
7	57918799	.	G	A	26	29	55	0	1	56	0	0
7	57919087	.	T	G	24	20	44	0	2	46	0	0
7	57919241	.	G	A	29	11	40	0	1	41	0	0
7	57919249	.	T	C	25	0	25	0	13	38	0	0
7	57919567	.	T	C	17	8	25	0	3	28	0	0
7	57920608	.	A	T	9	16	25	0	1	26	0	0
7	57920908	.	A	G	11	10	21	0	1	22	0	0
7	57921094	.	A	G	21	22	43	0	1	44	0	0
7	57921335	.	A	G	14	13	27	0	2	29	0	0
7	57921914	.	G	A	8	18	26	0	0	26	0	0
7	57922018	.	T	G	7	5	12	0	1	13	0	0
7	57922480	.	G	A	18	8	26	0	0	26	0	0
7	57922555	.	G	T	22	8	30	0	0	30	0	0
7	57922793	.	G	T	11	9	20	0	1	21	0	0
7	57922827	.	C	T	9	9	18	0	1	19	0	0
7	57922828	.	A	G	9	9	18	0	1	19	0	0
7	57928407	.	A	T	5	7	12	0	1	13	0	0
7	57934036	.	A	T	6	6	12	0	1	13	0	0
7	57934051	.	T	C	6	5	11	0	0	11	0	0
7	57936171	.	G	A	10	6	16	0	0	16	0	0
7	57952714	.	T	C	2	1	3	0	0	3	0	0
7	57954123	.	A	C	1	2	3	0	0	3	0	0
7	57956503	.	C	T	8	4	12	0	0	12	0	0
7	57959962	.	G	A	0	3	3	0	0	3	0	0
7	57961917	.	C	A	3	5	8	0	0	9	1	0
7	57967373	.	A	G	4	7	11	0	0	11	0	0
7	57972616	.	T	C	2	2	4	0	0	4	0	0
7	57994952	.	T	A	1	0	1	0	0	1	0	0
7	58007916	.	G	T	3	3	6	0	0	6	0	0
7	58142814	.	A	T	1	2	3	0	0	3	0	0
7	58142939	.	G	A	3	3	6	1	0	7	0	0
7	58143104	.	A	G	1	2	3	0	0	3	0	0
7	58143123	.	G	C	1	3	4	0	0	4	0	0
7	58143877	.	G	A	1	4	5	0	0	5	0	0
7	58143885	.	G	A	2	4	6	0	0	6	0	0
7	58150120	.	A	T	2	3	5	0	0	5	0	0
7	58153549	.	A	G	2	2	4	0	0	4	0	0
7	58158456	.	C	T	0	5	5	0	2	7	0	0
7	58158484	.	T	C	2	5	7	0	0	7	0	0
7	58158847	.	T	C	3	0	3	0	0	3	0	0
7	58166226	.	G	C	0	2	2	0	0	2	0	0
7	58182134	.	T	C	3	1	4	0	0	4	0	0
7	58188252	.	A	G	4	7	11	0	0	11	0	0
7	58188253	.	A	C	4	7	11	0	0	11	0	0
7	58197726	.	T	C	2	3	5	0	0	5	0	0
7	58199935	.	A	G	1	2	3	0	1	4	0	0
7	58200145	.	G	A	1	3	4	0	0	4	0	0
7	58205460	.	A	T	1	2	3	0	0	3	0	0
7	58207453	.	A	G	2	2	4	0	0	4	0	0
7	58259472	.	C	T	13	5	18	0	0	18	0	0
7	58259494	.	T	A	10	5	15	0	0	15	0	0
7	58259561	.	A	G	11	10	21	0	0	21	0	0
7	58259808	.	C	T	0	1	1	0	3	4	0	0
7	58262100	.	G	A	6	8	14	0	0	14	0	0
7	58264129	.	T	C	10	10	20	0	1	21	0	0
7	58265533	.	G	A	0	5	5	0	0	5	0	0
7	58687138	.	G	A	13	6	19	0	0	19	0	0
7	58695379	.	A	C	5	11	16	0	1	17	0	0
7	58695441	.	C	A	18	15	33	0	0	33	0	0
7	58695599	.	G	T	12	14	26	0	1	27	0	0
7	58720696	.	T	A	2	3	5	0	0	5	0	0
7	58720718	.	T	C	2	0	2	0	2	4	0	0
7	58742854	.	A	G	1	2	3	0	0	3	0	0
7	58748871	.	A	C	12	13	25	0	2	27	0	0
7	58748891	.	T	C	11	8	19	0	0	19	0	0
7	58750327	.	A	C	18	13	31	0	1	32	0	0
7	58841391	.	T	C	10	1	11	0	5	16	0	0
7	58841552	.	T	G	0	1	1	0	2	3	0	0
7	58843134	.	T	C	10	8	18	0	0	18	0	0
7	59037573	.	A	C	1	2	3	0	1	4	0	0
7	59037694	.	C	A	3	2	5	0	0	5	0	0
7	59037972	.	C	T	7	5	12	0	1	13	0	0
7	59041471	.	A	G	2	1	3	0	1	4	0	0
7	59041504	.	A	G	2	1	3	0	0	3	0	0
7	59041531	.	A	G	1	0	1	0	1	2	0	0
7	59046711	.	T	A	6	5	11	0	0	11	0	0
7	59046966	.	T	A	6	2	8	0	0	8	0	0
7	59048307	.	C	T	1	9	10	0	7	17	0	0
7	59048907	.	G	A	6	3	9	0	0	9	0	0
7	59069079	.	G	A	7	7	14	0	0	14	0	0
7	59069080	.	T	G	5	7	12	0	2	14	0	0
7	59202432	.	A	G	1	2	3	0	0	3	0	0
7	59202852	.	T	G	1	4	5	0	0	5	0	0
7	59202989	.	A	T	4	6	10	0	0	10	0	0
7	59203097	.	A	G	1	5	6	0	0	6	0	0
7	59203289	.	G	A	3	1	4	0	0	4	0	0
7	59210423	.	T	A	1	1	2	0	0	2	0	0
7	59235696	.	C	T	2	1	3	0	0	3	0	0
7	59240761	.	G	A	1	3	4	0	0	4	0	0
7	59244716	.	A	G	2	0	2	0	3	5	0	0
7	59245612	.	G	T	2	3	5	0	0	5	0	0
7	59456904	.	A	C	1	4	5	0	0	5	0	0
7	59677543	.	C	T	1	4	5	0	0	5	0	0
7	59712337	.	A	T	1	1	2	0	0	2	0	0
7	60149599	.	C	T	5	0	5	0	1	6	0	0
7	60240748	.	T	C	2	3	5	0	0	5	0	0
7	60241377	.	G	T	3	5	8	0	0	8	0	0
7	60241387	.	C	T	2	3	5	0	1	6	0	0
7	60242851	.	C	A	3	5	8	0	1	9	0	0
7	60244637	.	A	G	7	6	13	0	0	13	0	0
7	60256778	.	C	T	0	1	1	0	3	4	0	0
7	60359455	.	A	G	1	0	1	0	5	6	0	0
7	60359512	.	G	A	1	3	4	0	0	4	0	0
7	60359516	.	A	C	1	2	3	0	1	4	0	0
7	60359574	.	G	A	0	2	2	0	2	4	0	0
7	60359584	.	C	T	2	3	5	0	0	5	0	0
7	60359719	.	A	T	11	4	15	0	1	16	0	0
7	60409230	.	T	C	3	2	5	0	0	5	0	0
7	60415571	.	G	T	4	3	7	0	0	7	0	0
7	60415928	.	T	C	7	6	13	0	0	13	0	0
7	60415945	.	A	T	5	5	10	0	1	11	0	0
7	60416010	.	T	C	4	6	10	0	1	11	0	0
7	60416016	.	A	G	4	5	9	0	1	10	0	0
7	60416175	.	C	T	6	9	15	0	0	15	0	0
7	60416317	.	A	G	6	0	6	0	10	16	0	0
7	60416327	.	C	T	5	11	16	0	0	16	0	0
7	60416379	.	G	A	7	11	18	0	0	18	0	0
7	60416383	.	C	T	6	14	20	0	0	20	0	0
7	60416439	.	A	G	2	14	16	0	0	16	0	0
7	60416724	.	A	G	3	8	11	0	0	11	0	0
7	60416764	.	T	G	4	7	11	0	0	11	0	0
7	60417176	.	T	A	4	8	12	0	0	12	0	0
7	60551171	.	A	C	21	19	40	0	0	40	0	0
7	60551471	.	A	G	6	16	22	0	3	25	0	0
7	60585523	.	A	G	17	1	18	0	19	37	0	0
7	60585599	.	G	A	16	14	30	0	1	31	0	0
7	60585702	.	G	A	8	10	18	0	2	20	0	0
7	60585748	.	G	T	9	5	14	0	0	14	0	0
7	60585818	.	G	C	7	11	18	0	0	18	0	0
7	60586187	.	T	C	19	16	35	0	5	40	0	0
7	60586364	.	A	C	8	20	28	0	1	29	0	0
7	60586771	.	C	T	9	7	16	0	0	16	0	0
7	60586784	.	A	T	10	10	20	0	0	20	0	0
7	60586835	.	C	T	10	15	25	0	0	25	0	0
7	60586874	.	G	A	0	10	10	0	9	19	0	0
7	60586976	.	C	T	16	13	29	0	0	29	0	0
7	60597482	.	G	A	14	9	23	0	2	25	0	0
7	60597500	.	T	G	14	8	22	0	1	23	0	0
7	60597863	.	C	T	19	28	47	0	0	47	0	0
7	60598265	.	T	A	21	21	42	0	1	43	0	0
7	61083293	.	C	A	0	1	1	0	0	1	0	0
7	61586641	.	C	G	4	3	7	0	0	7	0	0
7	61586719	.	C	T	0	3	3	0	4	7	0	0
7	61586910	.	C	T	2	3	5	0	0	5	0	0
7	61587143	.	T	A	7	1	8	0	1	9	0	0
7	61764102	.	G	A	3	3	6	0	1	7	0	0
7	61766585	.	T	C	1	2	3	0	0	3	0	0
7	61769957	.	G	A	1	1	2	0	0	2	0	0
7	61771495	.	C	G	0	1	1	0	2	3	0	0
7	61771497	.	C	T	1	2	3	0	0	3	0	0
7	61775523	.	G	A	1	2	3	0	0	3	0	0
7	61777825	.	A	G	0	3	3	0	0	3	0	0
7	61777828	.	T	C	0	3	3	0	0	3	0	0
7	61804797	.	T	C	1	2	3	0	0	3	0	0
7	61921387	.	T	A	2	6	8	0	0	8	0	0
7	61950074	.	C	T	1	1	2	0	0	2	0	0
7	61953293	.	C	T	3	2	5	0	1	6	0	0
7	61953344	.	G	C	2	3	5	0	0	5	0	0
7	61959031	.	G	A	1	3	4	0	0	4	0	0
7	61961063	.	G	A	1	1	2	0	0	2	0	0
7	61961229	.	T	C	3	5	8	0	0	8	0	0
7	61961552	.	A	G	2	3	5	0	0	5	0	0
7	61961560	.	A	G	0	3	3	0	1	4	0	0
7	61962002	.	A	G	1	2	3	0	0	3	0	0
7	61962040	.	T	C	6	4	10	0	0	10	0	0
7	61962238	.	G	T	0	3	3	0	7	10	0	0
7	61962292	.	G	T	5	2	7	0	0	7	0	0
7	61977170	.	G	C	5	3	8	0	0	8	0	0
7	61977229	.	C	T	5	6	11	0	0	11	0	0
7	61977256	.	A	T	7	4	11	0	0	11	0	0
7	61977744	.	G	A	2	9	11	0	0	11	0	0
7	61977769	.	G	A	0	2	2	0	0	2	0	0
7	61987819	.	A	G	3	4	7	0	0	7	0	0
7	61989033	.	A	C	3	4	7	0	0	7	0	0
7	61995417	.	G	A	1	0	1	0	0	1	0	0
7	62000765	.	G	A	4	3	7	0	0	7	0	0
7	62000825	.	G	A	5	3	8	0	0	8	0	0
7	62004146	.	C	T	14	17	31	0	1	32	0	0
7	62009630	.	T	A	4	9	13	0	1	14	0	0
7	62009652	.	G	A	0	10	10	0	5	15	0	0
7	62009701	.	C	T	3	4	7	0	0	7	0	0
7	62205010	.	A	G	0	2	2	0	0	2	0	0
7	62205112	.	T	C	1	2	3	0	0	3	0	0
7	62205268	.	A	G	1	1	2	0	2	4	0	0
7	62205620	.	C	T	1	2	3	0	1	4	0	0
7	62248635	.	C	T	4	6	10	0	1	11	0	0
7	62248651	.	T	G	5	4	9	0	0	9	0	0
7	62248883	.	C	T	0	3	3	0	0	3	0	0
7	62248906	.	T	A	0	3	3	0	0	3	0	0
7	62261533	.	A	T	2	3	5	0	0	5	0	0
7	62268259	.	C	T	1	5	6	0	0	6	0	0
7	62290480	.	T	A	1	4	5	0	0	5	0	0
7	63325317	.	A	G	5	8	13	0	0	13	0	0
7	63325484	.	T	C	3	2	5	0	0	5	0	0
7	63325567	.	C	G	6	5	11	0	0	11	0	0
7	63325628	.	T	A	0	5	5	0	0	5	0	0
7	63326010	.	A	C	1	3	4	0	0	4	0	0
7	63326184	.	A	G	11	4	15	0	1	16	0	0
7	63326928	.	G	A	0	10	10	0	9	19	0	0
7	63327063	.	C	T	4	5	9	0	0	9	0	0
7	63327252	.	C	T	6	8	14	0	0	14	0	0
7	63327468	.	C	T	5	3	8	0	0	8	0	0
7	63327912	.	G	C	0	11	11	0	5	16	0	0
7	63328125	.	A	T	12	8	20	0	1	21	0	0
7	63328305	.	T	C	9	13	22	0	0	22	0	0
7	63328320	.	T	C	16	9	25	0	0	25	0	0
7	63328446	.	T	A	15	10	25	0	3	29	1	0
7	63328485	.	C	T	13	14	27	0	1	28	0	0
7	63328599	.	A	G	14	0	14	0	12	26	0	0
7	63328632	.	C	A	16	12	28	0	0	28	0	0
7	63328746	.	G	T	19	20	39	0	1	40	0	0
7	63328764	.	G	A	2	14	16	0	22	38	0	0
7	64740893	.	T	C	3	0	3	0	11	14	0	0
7	64978891	.	A	C	4	5	9	0	0	9	0	0
7	64980793	.	A	G	0	1	1	0	0	1	0	0
7	64980820	.	A	G	4	5	9	0	0	9	0	0
7	64988061	.	A	G	6	6	12	0	1	13	0	0
7	64988122	.	C	T	11	12	23	0	1	24	0	0
7	65011498	.	A	G	4	2	6	0	0	6	0	0
7	65011513	.	C	T	2	2	4	0	0	4	0	0
7	65024002	.	G	A	13	11	24	0	0	24	0	0
7	65024082	.	C	T	0	4	4	0	3	7	0	0
7	65035275	.	A	G	10	5	15	0	0	15	0	0
7	65035416	.	G	T	7	5	12	0	1	13	0	0
7	65035437	.	C	T	7	5	12	0	2	14	0	0
7	65039436	.	A	C	10	0	10	0	12	22	0	0
7	65049706	.	C	T	0	2	2	0	3	5	0	0
7	65050312	.	A	T	4	2	6	0	1	7	0	0
7	65093097	.	G	A	14	7	21	0	0	21	0	0
7	65104042	.	A	T	1	3	4	0	1	5	0	0
7	65104080	.	A	G	6	3	9	1	0	10	0	0
7	65104989	.	C	T	1	3	4	0	1	5	0	0
7	65132821	.	T	C	2	0	2	0	0	2	0	0
7	65132884	.	C	T	0	3	3	0	0	3	0	0
7	65140532	.	C	A	2	3	5	0	0	5	0	0
7	65140577	.	T	C	5	6	11	0	0	11	0	0
7	65140786	.	G	A	2	1	3	0	0	3	0	0
7	65144861	.	G	T	0	1	1	0	0	1	0	0
7	65152024	.	T	C	0	1	1	0	1	2	0	0
7	65152036	.	C	A	1	1	2	0	0	2	0	0
7	65152075	.	A	G	0	0	0	0	1	1	0	0
7	65169335	.	G	A	0	19	19	0	16	35	0	0
7	65169795	.	G	A	0	14	14	0	18	32	0	0
7	65173289	.	A	T	16	9	25	0	1	26	0	0
7	65297041	.	A	T	10	8	18	0	0	18	0	0
7	65306085	.	C	T	6	1	7	0	0	7	0	0
7	65306229	.	G	A	3	8	11	0	1	12	0	0
7	65306255	.	A	G	5	6	11	0	0	11	0	0
7	65306417	.	C	A	2	2	4	0	0	4	0	0
7	65306435	.	G	C	0	2	2	0	2	4	0	0
7	65309852	.	T	C	1	5	6	0	1	7	0	0
7	65310699	.	G	A	1	1	2	0	0	2	0	0
7	65333930	.	T	A	6	8	14	0	0	14	0	0
7	65371899	.	C	T	1	1	2	0	0	2	0	0
7	65427004	.	A	G	2	3	5	0	0	5	0	0
7	65433092	.	T	C	1	3	4	0	0	4	0	0
7	65433343	.	G	T	0	1	1	0	0	1	0	0
7	65433352	.	C	A	0	1	1	0	0	1	0	0
7	65434513	.	G	A	0	2	2	0	4	6	0	0
7	65434538	.	C	T	1	7	8	0	0	8	0	0
7	65434589	.	C	T	4	1	5	0	0	5	0	0
7	65434610	.	C	T	0	2	2	0	0	2	0	0
7	65440232	.	T	A	2	0	2	0	1	3	0	0
7	65440361	.	G	A	0	3	3	0	1	4	0	0
7	65443348	.	T	C	1	3	4	0	0	4	0	0
7	65443396	.	G	A	3	2	5	0	1	6	0	0
7	65451369	.	C	T	5	9	14	0	3	17	0	0
7	65452005	.	G	A	0	3	3	0	7	10	0	0
7	65452017	.	G	A	4	2	6	0	0	6	0	0
7	65453057	.	G	A	0	7	7	0	6	13	0	0
7	65453159	.	C	A	1	2	3	0	0	3	0	0
7	65457079	.	G	A	1	0	1	0	0	1	0	0
7	65457103	.	A	G	3	0	3	0	4	7	0	0
7	65463165	.	C	A	7	10	17	0	1	18	0	0
7	65463169	.	G	A	8	11	19	0	0	19	0	0
7	65463297	.	G	T	0	8	8	0	10	18	0	0
7	65464010	.	C	T	12	10	22	0	0	22	0	0
7	65464164	.	G	T	14	3	17	0	0	17	0	0
7	65464204	.	G	A	0	6	6	0	13	19	0	0
7	65464288	.	G	T	1	5	6	0	0	6	0	0
7	65473186	.	A	T	17	18	35	0	0	35	0	0
7	65473364	.	T	C	27	17	44	0	1	45	0	0
7	65473700	.	G	C	37	16	53	0	3	56	0	0
7	65473775	.	G	T	27	21	48	0	4	52	0	0
7	65473814	.	T	C	27	19	46	0	4	50	0	0
7	65473933	.	C	A	15	17	32	0	1	33	0	0
7	65473972	.	T	C	14	21	35	0	1	36	0	0
7	65474100	.	C	T	21	27	48	0	2	50	0	0
7	65474103	.	A	G	21	29	50	0	1	51	0	0
7	65475669	.	C	T	8	3	11	0	1	12	0	0
7	65475708	.	T	G	17	14	31	0	0	31	0	0
7	65488586	.	G	A	6	7	13	0	2	15	0	0
7	65491855	.	A	T	31	19	50	0	3	53	0	0
7	66080231	.	G	A	2	3	5	0	0	5	0	0
7	66086592	.	C	T	2	1	3	0	0	3	0	0
7	66090927	.	C	T	3	2	5	0	0	5	0	0
7	66093051	.	T	A	1	2	3	0	1	4	0	0
7	66105498	.	C	T	7	7	14	0	1	15	0	0
7	66105663	.	A	G	9	0	9	0	5	14	0	0
7	66105752	.	C	T	10	7	17	0	0	17	0	0
7	66105804	.	G	A	0	3	3	0	3	6	0	0
7	66112702	.	T	C	6	3	9	0	1	10	0	0
7	66126466	.	T	C	3	3	6	0	0	6	0	0
7	66133626	.	A	T	1	4	5	0	1	6	0	0
7	66259574	.	A	T	7	7	14	0	0	14	0	0
7	66276243	.	G	A	8	8	16	0	1	17	0	0
7	66361984	.	A	G	5	5	10	0	1	11	0	0
7	66368605	.	G	C	6	0	6	0	4	10	0	0
7	66368653	.	T	C	2	0	2	0	0	2	0	0
7	66634326	.	T	C	7	6	13	0	1	14	0	0
7	66639333	.	T	C	5	1	6	0	0	6	0	0
7	66642286	.	T	A	9	8	17	0	0	17	0	0
7	66646655	.	T	C	3	5	8	0	0	8	0	0
7	66652907	.	G	C	1	2	3	0	0	3	0	0
7	66652919	.	C	G	3	6	9	0	0	9	0	0
7	66653019	.	G	A	17	19	36	0	1	37	0	0
7	66653335	.	G	C	17	14	31	0	0	31	0	0
7	66653442	.	G	T	0	17	17	0	17	34	0	0
7	66653469	.	T	G	14	11	25	0	0	25	0	0
7	66653529	.	T	C	13	11	24	0	0	24	0	0
7	66653785	.	G	A	0	14	14	0	11	25	0	0
7	66653840	.	T	A	6	16	22	0	1	23	0	0
7	66653929	.	T	C	15	15	30	0	1	31	0	0
7	66653950	.	C	T	19	17	36	0	2	38	0	0
7	66655930	.	G	T	1	4	5	0	1	6	0	0
7	66655938	.	A	T	2	4	6	0	0	6	0	0
7	66656242	.	C	T	1	6	7	0	16	23	0	0
7	66660481	.	T	C	2	0	2	0	3	5	0	0
7	66664405	.	C	T	6	11	17	0	0	17	0	0
7	66670802	.	A	G	2	4	6	0	0	6	0	0
7	66676514	.	C	T	2	1	3	0	0	3	0	0
7	66676520	.	T	A	2	1	3	0	0	3	0	0
7	66683439	.	G	A	2	3	5	0	0	5	0	0
7	66683490	.	T	C	3	0	3	0	6	9	0	0
7	66685648	.	T	G	0	2	2	0	0	2	0	0
7	66838824	.	A	G	1	2	3	0	0	3	0	0
7	66988127	.	A	C	0	1	1	0	0	1	0	0
7	67000392	.	T	A	2	1	3	0	0	3	0	0
7	67081803	.	C	T	1	0	1	0	1	2	0	0
7	67081821	.	C	A	1	2	3	0	0	3	0	0
7	67152142	.	C	T	4	1	5	0	0	5	0	0
7	67157950	.	T	C	0	1	1	0	1	2	0	0
7	67161491	.	A	G	3	5	8	0	0	8	0	0
7	67165438	.	G	A	0	1	1	0	2	3	0	0
7	67170774	.	A	G	5	0	5	0	3	8	0	0
7	67170837	.	A	T	6	4	10	0	1	11	0	0
7	67171186	.	G	T	0	5	5	0	6	11	0	0
7	67220614	.	C	T	2	3	5	0	0	5	0	0
7	67227885	.	T	G	0	3	3	0	0	3	0	0
7	67241045	.	T	C	0	3	3	0	0	3	0	0
7	67248773	.	A	G	1	5	6	0	0	6	0	0
7	67252044	.	A	C	5	13	18	0	0	18	0	0
7	67310028	.	G	T	7	5	12	0	0	12	0	0
7	67310030	.	T	A	7	5	12	0	0	12	0	0
7	67310144	.	G	T	9	12	21	0	0	21	0	0
7	67310147	.	T	C	9	1	10	0	10	20	0	0
7	67310200	.	T	G	14	8	22	0	2	24	0	0
7	67310269	.	G	A	10	25	35	0	0	35	0	0
7	67310429	.	A	T	13	13	26	0	1	27	0	0
7	67310507	.	T	C	22	24	46	0	1	47	0	0
7	67310690	.	A	G	17	19	36	0	3	39	0	0
7	67314142	.	A	G	2	2	4	0	0	4	0	0
7	67315481	.	G	T	3	4	7	0	0	7	0	0
7	67435587	.	T	C	2	3	5	0	0	5	0	0
7	67436273	.	C	T	9	8	17	0	0	17	0	0
7	67439428	.	A	C	3	4	7	0	0	7	0	0
7	67444837	.	G	A	2	1	3	0	1	4	0	0
7	67446295	.	C	T	15	11	26	0	1	27	0	0
7	67448338	.	T	C	21	8	29	0	2	31	0	0
7	67448363	.	A	T	15	9	24	0	3	27	0	0
7	67448373	.	T	A	15	9	24	0	0	24	0	0
7	67471561	.	C	T	20	34	54	0	1	55	0	0
7	67476197	.	A	T	1	4	5	0	0	5	0	0
7	67545588	.	T	C	1	1	2	0	0	2	0	0
7	67555434	.	G	A	0	1	1	0	0	1	0	0
7	67591043	.	C	T	0	5	5	0	0	5	0	0
7	67594122	.	C	T	7	6	13	0	0	13	0	0
7	67594380	.	C	G	4	0	4	0	4	8	0	0
7	67594467	.	T	C	6	9	15	0	0	15	0	0
7	67733819	.	G	A	7	4	11	0	1	12	0	0
7	67743603	.	T	A	4	3	7	0	0	7	0	0
7	67743604	.	G	T	4	3	7	0	0	7	0	0
7	67743646	.	A	G	4	1	5	0	0	5	0	0
7	67743878	.	T	C	5	3	8	0	0	8	0	0
7	67747819	.	T	C	12	10	22	0	0	22	0	0
7	67747826	.	T	G	9	9	18	0	1	19	0	0
7	67747869	.	G	C	9	5	14	0	0	14	0	0
7	67747915	.	G	A	4	5	9	0	0	9	0	0
7	67747916	.	A	T	4	5	9	0	0	9	0	0
7	67749343	.	T	C	3	4	7	0	0	7	0	0
7	67749359	.	G	A	1	3	4	0	1	5	0	0
7	67751179	.	C	G	2	2	4	0	0	4	0	0
7	67751286	.	A	G	3	0	3	0	8	11	0	0
7	67752263	.	T	C	0	3	3	0	0	3	0	0
7	67753196	.	T	C	1	2	3	0	0	3	0	0
7	67759739	.	C	T	4	1	5	0	0	5	0	0
7	67759772	.	C	A	7	3	10	0	0	10	0	0
7	67760437	.	G	C	0	1	1	0	2	3	0	0
7	67760488	.	C	G	2	2	4	0	0	4	0	0
7	67760491	.	C	T	2	2	4	0	0	4	0	0
7	67765772	.	T	C	5	3	8	0	2	10	0	0
7	67767943	.	G	A	0	2	2	0	0	2	0	0
7	67770477	.	T	G	2	0	2	0	1	3	0	0
7	67776588	.	C	T	3	1	4	0	0	4	0	0
7	67794260	.	T	A	1	7	8	0	0	8	0	0
7	67794264	.	T	G	1	6	7	0	1	8	0	0
7	67795001	.	T	A	2	2	4	0	0	4	0	0
7	67795002	.	C	A	1	2	3	0	1	4	0	0
7	67795367	.	T	C	3	3	6	0	0	6	0	0
7	67795386	.	A	G	3	5	8	0	0	8	0	0
7	67795429	.	G	A	6	6	12	0	0	12	0	0
7	67796075	.	G	T	10	3	13	1	0	14	0	0
7	67796356	.	G	A	3	2	5	0	0	5	0	0
7	67796413	.	C	A	3	4	7	0	1	8	0	0
7	67796437	.	G	T	4	5	9	0	0	9	0	0
7	67796494	.	G	A	0	7	7	0	7	14	0	0
7	67797037	.	C	G	7	12	19	0	1	20	0	0
7	67797087	.	G	T	12	10	22	0	1	23	0	0
7	67797097	.	C	T	12	9	21	0	0	21	0	0
7	67817399	.	C	T	1	2	3	0	0	3	0	0
7	67830051	.	C	T	0	0	0	0	1	1	0	0
7	67833051	.	G	A	5	5	10	0	0	10	0	0
7	67842641	.	G	T	3	5	8	0	0	8	0	0
7	67846087	.	T	C	2	2	4	0	0	4	0	0
7	67861868	.	T	G	1	4	5	0	0	5	0	0
7	67861872	.	G	C	1	0	1	0	4	5	0	0
7	67876771	.	C	T	0	3	3	0	1	4	0	0
7	67876820	.	T	G	1	4	5	0	0	5	0	0
7	67876822	.	C	T	1	4	5	0	0	5	0	0
7	67876880	.	T	A	1	2	3	0	1	4	0	0
7	67876881	.	G	A	2	2	4	0	0	4	0	0
7	68089878	.	G	A	1	1	2	0	1	3	0	0
7	68215451	.	A	T	15	14	29	0	1	30	0	0
7	68215990	.	T	G	14	12	26	0	1	27	0	0
7	68216504	.	C	A	0	6	6	0	8	14	0	0
7	68217387	.	G	A	8	12	20	0	0	20	0	0
7	68232112	.	A	G	1	2	3	0	0	3	0	0
7	68232123	.	A	G	0	2	2	0	0	2	0	0
7	68328908	.	A	G	3	3	6	0	0	6	0	0
7	68372145	.	C	T	1	2	3	0	0	3	0	0
7	68540716	.	T	A	2	3	5	0	1	6	0	0
7	68541305	.	G	C	2	3	5	0	0	5	0	0
7	68541415	.	G	A	2	2	4	0	0	4	0	0
7	68541467	.	A	C	2	2	4	0	0	4	0	0
7	68542538	.	C	T	2	2	4	0	0	4	0	0
7	68542589	.	T	A	1	2	3	0	0	3	0	0
7	69145138	.	T	C	1	5	6	0	0	6	0	0
7	69145516	.	T	C	9	5	14	0	0	14	0	0
7	69145672	.	T	C	4	0	4	0	4	8	0	0
7	69146362	.	T	C	2	4	6	0	0	6	0	0
7	69383864	.	C	T	1	2	3	0	0	3	0	0
7	69437422	.	A	C	5	2	7	0	0	7	0	0
7	69437472	.	T	C	6	3	9	0	0	9	0	0
7	69437495	.	C	A	2	1	3	0	0	3	0	0
7	69439436	.	T	C	0	1	1	0	0	1	0	0
7	69439580	.	A	G	3	2	5	0	0	5	0	0
7	69439587	.	A	G	2	0	2	0	2	4	0	0
7	69442374	.	C	T	1	0	1	0	0	1	0	0
7	69447324	.	G	A	4	9	13	0	0	13	0	0
7	69447352	.	T	C	6	10	16	0	3	19	0	0
7	69447469	.	C	G	3	2	5	0	0	5	0	0
7	69447516	.	A	G	4	3	7	0	0	7	0	0
7	69447520	.	G	A	3	4	7	0	1	8	0	0
7	69447699	.	G	T	4	3	7	0	0	7	0	0
7	69458611	.	T	C	3	4	7	0	0	7	0	0
7	69467145	.	A	G	5	4	9	0	1	10	0	0
7	69467267	.	A	G	3	7	10	0	0	10	0	0
7	69467383	.	T	G	6	0	6	0	5	11	0	0
7	69467423	.	C	A	1	1	2	0	1	3	0	0
7	69477283	.	T	G	26	15	41	1	4	48	2	0
7	69477303	.	A	G	16	0	16	0	34	50	0	0
7	69477361	.	T	C	30	27	57	0	0	57	0	0
7	69477437	.	A	G	25	30	55	0	1	56	0	0
7	69477464	.	T	C	21	30	51	0	3	54	0	0
7	69484697	.	A	G	0	0	0	0	1	1	0	0
7	69496521	.	C	A	14	14	28	0	1	29	0	0
7	69496537	.	A	T	12	14	26	0	3	29	0	0
7	69496572	.	A	G	10	20	30	0	1	31	0	0
7	69497048	.	A	T	12	9	21	0	1	22	0	0
7	69497493	.	G	T	17	14	31	0	1	33	1	0
7	69497637	.	G	A	2	5	7	0	0	7	0	0
7	69501040	.	A	G	6	5	11	0	0	11	0	0
7	69501300	.	A	G	13	8	21	0	0	21	0	0
7	69501345	.	G	T	15	8	23	0	0	23	0	0
7	69518021	.	T	A	4	10	14	0	1	15	0	0
7	69518077	.	T	A	6	10	16	0	2	18	0	0
7	69521129	.	A	T	3	1	4	0	0	4	0	0
7	69540248	.	G	A	5	1	6	0	0	6	0	0
7	69540312	.	T	C	4	4	8	0	0	8	0	0
7	69566119	.	A	G	6	4	10	0	0	10	0	0
7	69566179	.	A	T	2	2	4	0	0	4	0	0
7	69566908	.	G	A	0	6	6	0	10	16	0	0
7	69576031	.	G	A	2	3	5	0	0	5	0	0
7	69911459	.	T	G	1	0	1	0	1	2	0	0
7	69934781	.	A	C	1	0	1	0	0	1	0	0
7	69946805	.	C	T	2	3	5	0	1	6	0	0
7	69950644	.	G	T	2	3	5	0	0	5	0	0
7	69950666	.	T	C	3	2	5	0	0	5	0	0
7	69959980	.	G	A	3	2	5	0	0	5	0	0
7	70267329	.	T	A	1	3	4	0	0	4	0	0
7	70267378	.	G	A	1	3	4	0	0	4	0	0
7	70267390	.	A	G	1	2	3	0	0	3	0	0
7	70267426	.	T	C	0	2	2	0	0	2	0	0
7	70267680	.	T	C	5	3	8	0	0	8	0	0
7	70588306	.	G	A	1	1	2	0	0	2	0	0
7	70601377	.	C	T	6	4	10	0	0	10	0	0
7	70611159	.	C	T	4	6	10	0	1	11	0	0
7	70611371	.	T	G	2	3	5	0	3	8	0	0
7	70611567	.	T	C	9	4	13	0	0	13	0	0
7	70611606	.	G	A	5	6	11	0	2	13	0	0
7	70611741	.	C	T	0	2	2	0	8	10	0	0
7	70619207	.	C	A	0	7	7	0	1	8	0	0
7	70619253	.	G	A	3	9	12	0	0	12	0	0
7	71783970	.	G	A	1	1	2	0	0	2	0	0
7	71792889	.	T	C	2	2	4	1	0	5	0	0
7	72028326	.	A	G	31	11	42	0	1	43	0	0
7	72028746	.	A	G	2	0	2	0	2	4	0	0
7	72701156	.	A	G	1	2	3	0	0	3	0	0
7	72882627	.	C	T	5	2	7	0	0	7	0	0
7	72882651	.	A	G	1	0	1	0	4	5	0	0
7	72981295	.	C	T	2	4	6	0	0	6	0	0
7	73005090	.	T	C	0	3	3	0	0	3	0	0
7	73013741	.	T	C	1	4	5	0	0	5	0	0
7	73013765	.	T	C	1	3	4	0	0	4	0	0
7	73035395	.	C	T	2	2	4	0	0	4	0	0
7	73035452	.	G	A	0	3	3	0	2	5	0	0
7	73065241	.	A	T	0	1	1	0	0	1	0	0
7	73084736	.	G	A	0	7	7	0	15	22	0	0
7	73084738	.	C	G	13	0	13	0	9	22	0	0
7	73084873	.	T	G	6	0	6	0	7	13	0	0
7	73084948	.	T	C	10	4	14	0	1	15	0	0
7	73085083	.	G	A	9	4	13	0	1	14	0	0
7	73085188	.	A	T	10	3	13	0	0	13	0	0
7	73085190	.	A	C	10	3	13	0	0	13	0	0
7	73085416	.	G	A	0	5	5	0	4	9	0	0
7	73085432	.	T	C	4	5	9	0	0	9	0	0
7	73085730	.	C	T	4	3	7	0	1	8	0	0
7	73085777	.	T	C	5	4	9	0	0	9	0	0
7	73085818	.	G	T	1	4	5	0	1	6	0	0
7	73085837	.	T	C	2	5	7	0	0	7	0	0
7	73085868	.	A	G	1	6	7	0	0	7	0	0
7	73085914	.	A	G	1	2	3	0	1	4	0	0
7	73085967	.	C	T	3	4	7	0	0	7	0	0
7	73085981	.	T	C	4	4	8	0	0	8	0	0
7	73086051	.	T	G	10	4	14	0	0	14	0	0
7	73086061	.	A	T	8	5	13	0	0	13	0	0
7	73086217	.	A	G	8	8	16	0	2	18	0	0
7	73086580	.	G	A	5	3	8	0	0	8	0	0
7	73087208	.	A	G	9	13	22	0	0	22	0	0
7	73087209	.	T	C	8	13	21	0	1	22	0	0
7	73087250	.	A	C	6	11	17	0	0	18	1	0
7	73087266	.	G	A	6	9	15	0	1	16	0	0
7	73087329	.	T	G	8	11	19	0	2	21	0	0
7	73087344	.	T	C	9	17	26	0	0	26	0	0
7	73087374	.	A	T	8	18	26	0	2	28	0	0
7	73087528	.	T	C	11	3	14	0	0	14	0	0
7	73087600	.	A	G	9	1	10	0	7	17	0	0
7	73087702	.	A	G	9	1	10	0	8	18	0	0
7	73087741	.	G	C	0	6	6	0	9	15	0	0
7	73087895	.	A	C	15	17	32	0	0	32	0	0
7	73088489	.	C	T	8	13	21	0	1	22	0	0
7	73316676	.	G	A	3	2	5	0	0	5	0	0
7	73337684	.	G	A	7	3	10	0	1	11	0	0
7	73338005	.	G	A	0	8	8	0	11	19	0	0
7	73338051	.	C	G	15	7	22	0	0	22	0	0
7	73397528	.	G	A	0	2	2	0	2	4	0	0
7	73397531	.	C	T	2	2	4	0	0	4	0	0
7	73397568	.	T	C	2	2	4	0	0	4	0	0
7	73401946	.	C	T	20	17	37	0	0	37	0	0
7	73612138	.	T	A	2	5	7	0	0	7	0	0
7	73612356	.	C	G	5	7	12	0	1	13	0	0
7	73612683	.	G	A	2	5	7	0	0	7	0	0
7	73612806	.	G	A	1	2	3	0	0	3	0	0
7	73613025	.	C	T	3	3	6	0	0	6	0	0
7	73613230	.	G	A	5	5	10	0	0	10	0	0
7	73613362	.	C	A	5	5	10	0	1	11	0	0
7	73613478	.	G	A	6	5	11	0	0	11	0	0
7	73615061	.	T	G	1	4	5	0	1	6	0	0
7	73615097	.	C	T	2	4	6	0	0	6	0	0
7	73615798	.	C	T	8	6	14	0	0	14	0	0
7	73615847	.	G	A	8	5	13	0	0	13	0	0
7	73615851	.	G	A	0	4	4	0	8	12	0	0
7	73615889	.	G	A	4	3	7	0	0	7	0	0
7	73616027	.	A	G	6	6	12	0	0	12	0	0
7	73616711	.	T	C	5	6	11	0	0	11	0	0
7	73617583	.	A	G	6	4	10	0	0	10	0	0
7	73617759	.	G	A	0	6	6	0	8	14	0	0
7	73617792	.	A	G	2	6	8	0	0	8	0	0
7	73617828	.	T	C	1	5	6	0	0	6	0	0
7	73618004	.	G	A	8	16	24	0	1	25	0	0
7	73618220	.	C	A	3	3	6	0	0	6	0	0
7	73618565	.	A	G	3	0	3	0	4	7	0	0
7	73618713	.	A	G	5	0	5	0	3	8	0	0
7	73618733	.	G	A	0	2	2	0	4	6	0	0
7	73618821	.	A	G	3	3	6	0	0	6	0	0
7	73618841	.	A	G	3	3	6	0	0	6	0	0
7	73619153	.	T	A	7	10	17	0	2	19	0	0
7	73619587	.	A	C	10	4	14	0	0	14	0	0
7	73620129	.	C	T	10	9	19	0	2	21	0	0
7	73630951	.	G	C	15	28	43	0	3	46	0	0
7	73630955	.	G	A	0	26	26	0	18	44	0	0
7	73651959	.	C	A	35	29	64	0	1	65	0	0
7	73652321	.	T	A	31	24	55	0	2	57	0	0
7	73652715	.	A	T	19	30	49	0	1	50	0	0
7	73652819	.	C	T	16	29	45	0	0	45	0	0
7	73652873	.	G	T	16	26	42	0	1	43	0	0
7	73652892	.	A	G	17	0	17	0	24	41	0	0
7	73653241	.	T	C	35	25	60	0	3	63	0	0
7	73653373	.	C	A	29	21	50	0	1	52	1	0
7	73653994	.	G	A	24	15	39	0	2	41	0	0
7	73654065	.	T	C	13	17	30	0	3	33	0	0
7	73654505	.	C	T	23	27	50	0	0	50	0	0
7	73654647	.	C	G	28	1	29	0	35	64	0	0
7	73654652	.	G	A	34	18	52	0	8	60	0	0
7	73654693	.	A	C	34	33	67	0	1	68	0	0
7	73654742	.	C	A	32	32	64	0	5	69	0	0
7	73654827	.	A	G	33	26	59	0	2	61	0	0
7	73654878	.	C	T	26	36	62	0	1	63	0	0
7	73654896	.	G	A	42	17	59	0	5	64	0	0
7	73655474	.	T	G	40	18	58	0	3	61	0	0
7	73655580	.	G	A	35	35	70	0	0	70	0	0
7	73655698	.	A	G	22	24	46	0	0	46	0	0
7	73655775	.	T	C	14	13	27	0	0	27	0	0
7	73655997	.	C	T	25	43	68	0	2	70	0	0
7	73655998	.	T	C	25	36	61	0	9	70	0	0
7	73656075	.	T	C	31	28	59	0	8	67	0	0
7	73656136	.	G	A	20	35	55	0	1	56	0	0
7	73656361	.	G	A	4	2	6	0	3	9	0	0
7	74056606	.	G	T	12	13	25	0	1	26	0	0
7	74084304	.	C	A	1	2	3	0	1	4	0	0
7	74084672	.	G	T	5	3	8	0	0	8	0	0
7	74084702	.	C	T	3	2	5	0	1	6	0	0
7	74085487	.	C	T	0	3	3	0	2	5	0	0
7	74134988	.	T	C	10	3	13	0	0	13	0	0
7	74135136	.	G	A	1	14	15	0	17	32	0	0
7	74135375	.	C	T	18	24	42	0	6	48	0	0
7	74135462	.	A	G	12	22	34	0	2	36	0	0
7	74141299	.	T	C	1	2	3	0	0	3	0	0
7	74143628	.	C	T	1	1	2	0	1	3	0	0
7	74144167	.	A	G	0	0	0	0	1	1	0	0
7	74154066	.	C	T	5	2	7	0	1	8	0	0
8	1370	.	T	C	2	3	5	0	0	5	0	0
8	5733	.	T	C	20	22	42	0	2	44	0	0
8	6265	.	C	T	30	26	56	0	2	58	0	0
8	6366	.	T	C	21	18	39	0	7	46	0	0
8	6372	.	T	A	9	26	35	0	6	41	0	0
8	6612	.	A	G	4	8	12	0	0	12	0	0
8	7184	.	T	C	10	13	23	0	1	24	0	0
8	7276	.	G	A	10	5	15	0	1	16	0	0
8	7346	.	G	T	4	10	14	0	1	15	0	0
8	121205	.	A	G	2	4	6	0	0	6	0	0
8	388020	.	G	C	10	5	15	0	0	15	0	0
8	388949	.	G	A	12	5	17	0	3	20	0	0
8	389114	.	T	A	11	6	17	0	2	19	0	0
8	391988	.	C	A	7	6	13	0	2	15	0	0
8	395428	.	G	A	3	3	6	0	0	6	0	0
8	397338	.	T	C	8	12	20	0	1	21	0	0
8	400185	.	C	G	5	5	10	0	0	10	0	0
8	406243	.	G	A	1	1	2	0	0	2	0	0
8	406330	.	T	G	4	7	11	0	0	11	0	0
8	412296	.	T	C	15	0	15	0	8	23	0	0
8	417849	.	A	G	7	9	16	0	0	16	0	0
8	418575	.	A	G	1	0	1	0	0	1	0	0
8	423533	.	T	C	5	6	11	0	0	11	0	0
8	423815	.	C	A	9	13	22	0	1	23	0	0
8	423897	.	A	G	14	2	16	1	2	19	0	0
8	424123	.	G	A	12	12	24	0	0	24	0	0
8	1852056	.	A	G	1	3	4	0	1	5	0	0
8	1852078	.	A	G	3	1	4	0	0	4	0	0
8	1852138	.	A	G	2	3	5	0	0	5	0	0
8	1852145	.	A	G	4	3	7	0	0	7	0	0
8	1852185	.	A	G	3	4	7	0	0	7	0	0
8	1852196	.	A	G	3	9	12	0	0	12	0	0
8	1852550	.	A	G	5	2	7	0	0	7	0	0
8	1852599	.	A	G	6	2	8	0	1	9	0	0
8	1853004	.	A	G	8	3	11	0	0	11	0	0
8	1853072	.	A	G	8	3	11	0	0	11	0	0
8	1853406	.	A	G	7	7	14	0	2	16	0	0
8	1855312	.	A	G	16	7	23	0	2	25	0	0
8	2412800	.	C	T	25	2	27	0	0	27	0	0
8	2412911	.	G	A	23	23	46	0	3	49	0	0
8	2413133	.	T	G	32	33	65	0	4	69	0	0
8	2413160	.	G	C	29	3	32	0	33	67	2	0
8	2416886	.	G	A	28	16	44	0	2	46	0	0
8	2416931	.	C	T	0	3	3	0	10	13	0	0
8	2421318	.	T	C	24	14	38	0	3	41	0	0
8	2421342	.	C	A	19	14	33	0	1	34	0	0
8	2426500	.	A	G	3	2	5	0	1	6	0	0
8	2442765	.	C	T	1	2	3	0	0	3	0	0
8	2456933	.	C	T	8	3	11	0	0	11	0	0
8	2456953	.	C	G	10	3	13	0	1	14	0	0
8	2467230	.	A	G	12	0	12	0	5	17	0	0
8	2467233	.	A	G	12	4	16	0	1	17	0	0
8	2469292	.	G	A	11	10	21	0	0	21	0	0
8	2469377	.	G	C	1	8	9	0	0	9	0	0
8	2469401	.	C	T	1	6	7	0	1	8	0	0
8	2469528	.	G	T	2	5	7	0	0	7	0	0
8	2469559	.	C	T	2	4	6	0	0	6	0	0
8	2469660	.	T	C	2	2	4	0	1	5	0	0
8	2487329	.	T	C	3	4	7	0	0	7	0	0
8	2490968	.	C	T	26	26	52	0	0	52	0	0
8	2491338	.	G	A	17	6	23	0	0	23	0	0
8	2502037	.	G	A	21	18	39	0	4	43	0	0
8	2502067	.	C	T	36	24	60	0	6	66	0	0
8	2502088	.	A	G	25	15	40	0	3	43	0	0
8	2502112	.	A	G	17	7	24	0	0	24	0	0
8	2525435	.	A	G	1	3	4	0	0	4	0	0
8	2525450	.	T	C	1	2	3	0	2	5	0	0
8	2525492	.	A	T	1	4	5	0	1	6	0	0
8	2529817	.	T	A	2	0	2	0	0	2	0	0
8	2530118	.	G	A	13	8	21	0	0	21	0	0
8	2535588	.	T	A	13	11	24	0	1	26	1	0
8	2535642	.	T	C	8	5	13	0	1	14	0	0
8	2536560	.	A	G	4	3	7	0	0	7	0	0
8	2536761	.	G	C	2	4	6	0	0	6	0	0
8	2543700	.	C	T	3	0	3	0	0	3	0	0
8	2549002	.	A	G	0	2	2	0	0	2	0	0
8	2549011	.	G	A	0	4	4	0	0	4	0	0
8	2549579	.	T	C	2	1	3	0	0	3	0	0
8	2549582	.	A	G	1	0	1	0	1	2	0	0
8	2555046	.	C	G	3	7	10	0	0	10	0	0
8	2560680	.	T	G	4	0	4	0	2	6	0	0
8	2560848	.	A	G	3	4	7	0	1	8	0	0
8	2566882	.	G	T	2	2	4	0	0	4	0	0
8	2567788	.	T	C	4	4	8	0	1	9	0	0
8	2567818	.	C	T	6	6	12	0	0	12	0	0
8	2571478	.	T	C	2	1	3	0	0	3	0	0
8	2574463	.	A	G	1	0	1	0	5	6	0	0
8	2574470	.	T	G	1	5	6	0	0	6	0	0
8	2574514	.	A	C	1	9	10	0	1	11	0	0
8	2574524	.	A	C	3	7	10	0	0	10	0	0
8	2585329	.	G	C	8	10	18	0	1	19	0	0
8	2585681	.	C	A	15	16	31	0	0	31	0	0
8	2588348	.	A	G	34	19	53	0	1	54	0	0
8	2588354	.	C	A	0	15	15	0	37	52	0	0
8	2591624	.	A	C	6	0	6	0	6	12	0	0
8	2595746	.	C	T	0	2	2	0	0	2	0	0
8	2598043	.	A	C	2	0	2	0	3	5	0	0
8	2600595	.	T	C	1	0	1	0	0	1	0	0
8	2606354	.	T	C	5	4	9	0	0	9	0	0
8	2606435	.	A	T	3	2	5	0	1	6	0	0
8	2614836	.	A	T	0	1	1	0	0	1	0	0
8	3085466	.	C	A	4	4	8	0	0	8	0	0
8	3099585	.	G	A	0	13	13	0	11	24	0	0
8	3099847	.	A	G	10	4	14	0	0	14	0	0
8	3099890	.	A	T	4	3	7	0	0	7	0	0
8	3101081	.	T	A	5	4	9	0	0	9	0	0
8	3101086	.	C	A	5	4	9	0	0	9	0	0
8	3101241	.	G	T	5	7	12	0	0	12	0	0
8	3101277	.	T	C	7	5	12	0	1	13	0	0
8	3434164	.	A	G	0	0	0	0	1	1	0	0
8	3434170	.	A	G	1	0	1	0	1	2	0	0
8	3434302	.	T	C	1	4	5	0	0	5	0	0
8	3439266	.	G	T	3	2	5	0	0	5	0	0
8	3439351	.	A	G	3	6	9	0	0	9	0	0
8	3571818	.	G	A	0	6	6	0	5	11	0	0
8	3581488	.	G	A	0	1	1	0	1	2	0	0
8	3586385	.	C	T	1	1	2	0	0	2	0	0
8	3591211	.	C	A	4	8	12	0	0	12	0	0
8	3595359	.	C	T	4	4	8	0	0	8	0	0
8	3602041	.	T	C	9	7	16	0	1	17	0	0
8	3605171	.	C	T	1	0	1	0	0	1	0	0
8	3624208	.	G	C	2	5	7	0	0	7	0	0
8	3624690	.	G	A	0	3	3	0	3	6	0	0
8	3628683	.	C	T	2	4	6	0	0	6	0	0
8	3628747	.	C	A	8	11	19	0	0	19	0	0
8	3628758	.	T	A	7	10	17	0	0	17	0	0
8	3628782	.	G	A	1	10	11	0	6	17	0	0
8	3629231	.	G	T	0	7	7	0	9	16	0	0
8	3629232	.	T	C	9	7	16	0	0	16	0	0
8	3630935	.	A	T	5	2	7	0	0	7	0	0
8	3641224	.	C	T	4	5	9	0	0	9	0	0
8	3643299	.	T	C	14	15	29	0	0	29	0	0
8	3659979	.	T	C	1	0	1	0	0	1	0	0
8	3660034	.	C	T	5	2	7	0	0	7	0	0
8	3690953	.	G	A	5	3	8	0	0	8	0	0
8	3690998	.	T	C	2	4	6	0	0	6	0	0
8	3691184	.	C	T	0	3	3	0	3	6	0	0
8	3859383	.	T	A	7	6	13	0	1	14	0	0
8	3865233	.	T	C	8	5	13	0	0	13	0	0
8	3883831	.	C	G	7	2	9	0	0	9	0	0
8	3885609	.	C	T	0	5	5	0	0	5	0	0
8	3886223	.	C	T	1	1	2	0	0	2	0	0
8	3889662	.	G	A	0	5	5	0	2	7	0	0
8	3890837	.	T	C	1	2	3	0	0	3	0	0
8	3893987	.	C	T	1	1	2	0	1	3	0	0
8	3894008	.	A	T	6	3	9	0	0	9	0	0
8	3894077	.	G	A	9	7	16	0	0	16	0	0
8	3904963	.	C	T	6	4	10	0	0	10	0	0
8	3906073	.	C	A	8	6	14	0	0	14	0	0
8	3915909	.	G	A	0	1	1	0	0	1	0	0
8	3918567	.	C	T	15	11	26	0	3	29	0	0
8	3932842	.	T	G	6	4	10	0	0	10	0	0
8	3932889	.	A	T	3	5	8	0	0	8	0	0
8	3932990	.	A	G	4	8	12	0	0	12	0	0
8	3949558	.	G	T	1	7	8	0	1	9	0	0
8	3950039	.	C	G	8	4	12	0	0	12	0	0
8	3950317	.	G	A	5	5	10	0	0	10	0	0
8	3950341	.	A	G	1	3	4	0	0	4	0	0
8	3950529	.	C	T	3	2	5	0	0	5	0	0
8	3950554	.	C	T	1	3	4	0	0	4	0	0
8	3956898	.	G	A	2	2	4	0	0	4	0	0
8	3974903	.	G	A	1	0	1	0	0	1	0	0
8	4044662	.	G	A	2	4	6	0	0	6	0	0
8	4044846	.	G	A	4	10	14	0	0	14	0	0
8	4044876	.	T	C	7	4	11	0	1	12	0	0
8	4074427	.	G	A	0	2	2	0	0	2	0	0
8	4399623	.	A	G	2	3	5	0	0	5	0	0
8	4399624	.	A	G	2	2	4	0	1	5	0	0
8	4399674	.	A	G	5	0	5	0	5	10	0	0
8	4799126	.	T	A	2	2	4	0	0	4	0	0
8	4799139	.	C	T	2	3	5	0	0	5	0	0
8	4799942	.	T	C	2	2	4	0	0	4	0	0
8	4799945	.	T	C	2	2	4	0	0	4	0	0
8	5844982	.	T	C	2	4	6	0	0	6	0	0
8	5845014	.	C	G	2	6	8	0	1	9	0	0
8	5845042	.	C	T	1	7	8	0	0	8	0	0
8	5845807	.	A	G	2	2	4	0	0	4	0	0
8	5845891	.	T	C	8	4	12	0	0	12	0	0
8	5845957	.	T	C	5	4	9	0	1	10	0	0
8	6415959	.	T	C	3	5	8	0	0	8	0	0
8	6863678	.	A	G	13	1	14	0	13	27	0	0
8	6863822	.	G	A	15	7	22	0	1	23	0	0
8	6864062	.	C	G	8	10	18	0	2	20	0	0
8	6864077	.	T	C	6	11	17	0	0	17	0	0
8	6864416	.	C	A	15	11	26	0	0	26	0	0
8	6865247	.	T	A	0	4	4	0	0	4	0	0
8	6865357	.	C	T	9	9	18	0	1	19	0	0
8	6865542	.	C	T	17	24	41	0	0	41	0	0
8	6865834	.	A	G	17	20	37	0	2	39	0	0
8	6866083	.	G	A	19	23	42	0	0	42	0	0
8	6866592	.	G	T	24	18	42	0	1	43	0	0
8	6866835	.	T	G	4	7	11	0	1	12	0	0
8	6874937	.	C	T	9	14	23	0	1	24	0	0
8	6874968	.	A	G	13	14	27	0	1	28	0	0
8	6875061	.	G	T	15	15	30	0	1	32	1	0
8	6875300	.	C	T	7	16	23	0	1	24	0	0
8	6875354	.	T	C	2	2	4	0	0	4	0	0
8	6875562	.	C	T	4	6	10	0	0	10	0	0
8	6875563	.	C	T	4	6	10	0	0	10	0	0
8	6875722	.	A	G	15	10	25	0	2	27	0	0
8	6876297	.	T	C	2	0	2	0	0	2	0	0
8	6876381	.	A	G	12	17	29	0	2	31	0	0
8	6876705	.	A	C	13	11	24	0	0	24	0	0
8	6876941	.	G	T	12	12	24	0	0	24	0	0
8	6876999	.	T	C	14	9	23	0	1	24	0	0
8	6877130	.	T	G	8	10	18	0	0	18	0	0
8	6877248	.	T	C	9	0	9	0	4	13	0	0
8	6877268	.	T	C	7	3	10	0	0	10	0	0
8	6903595	.	G	C	3	0	3	0	2	5	0	0
8	6903650	.	A	G	5	2	7	0	0	7	0	0
8	6903778	.	A	T	2	3	5	0	0	5	0	0
8	6904092	.	C	T	2	2	4	0	0	4	0	0
8	6913809	.	T	C	3	0	3	0	0	3	0	0
8	6920909	.	A	G	5	9	14	0	2	16	0	0
8	6921117	.	C	G	1	13	14	0	27	41	0	0
8	6921344	.	A	C	11	16	27	0	0	27	0	0
8	6921421	.	T	A	22	18	40	0	0	40	0	0
8	6921581	.	A	C	13	35	48	0	1	49	0	0
8	6921671	.	G	A	6	17	23	0	0	23	0	0
8	6927428	.	T	C	6	12	18	0	1	19	0	0
8	6935642	.	A	T	11	15	26	0	0	26	0	0
8	6943167	.	A	T	1	0	1	0	0	1	0	0
8	6970040	.	G	A	4	6	10	0	0	10	0	0
8	6985008	.	A	G	2	3	5	0	0	5	0	0
8	7014341	.	A	G	1	3	4	0	0	4	0	0
8	7014476	.	C	T	1	1	2	0	0	2	0	0
8	7021512	.	C	T	15	8	23	0	0	23	0	0
8	7022029	.	G	A	1	5	6	0	10	16	0	0
8	7022155	.	T	A	7	6	13	0	0	14	1	0
8	7022164	.	T	C	7	6	13	0	0	13	0	0
8	7022216	.	T	A	6	5	11	0	1	12	0	0
8	7023007	.	G	C	2	4	6	1	3	10	0	0
8	7023056	.	G	A	0	14	14	0	13	27	0	0
8	7119123	.	A	G	6	3	9	0	0	9	0	0
8	7119128	.	A	G	7	2	9	0	1	10	0	0
8	7742196	.	C	T	16	7	23	0	1	24	0	0
8	7745898	.	G	A	8	3	11	0	1	12	0	0
8	7745907	.	T	C	10	5	15	0	0	15	0	0
8	7746030	.	C	T	13	6	19	0	1	20	0	0
8	7747613	.	A	G	3	1	4	0	4	8	0	0
8	7747616	.	C	T	3	5	8	0	0	8	0	0
8	7754289	.	C	T	5	7	12	0	0	12	0	0
8	7765230	.	G	A	0	7	7	0	12	20	1	0
8	7772097	.	C	T	10	5	15	0	4	19	0	0
8	7854167	.	G	C	1	3	4	0	0	4	0	0
8	7854194	.	C	G	2	3	5	0	1	6	0	0
8	7854236	.	G	T	0	3	3	0	4	7	0	0
8	7854247	.	T	C	3	3	6	0	0	6	0	0
8	7854287	.	T	G	3	1	4	0	0	4	0	0
8	7855697	.	G	T	0	1	1	0	1	2	0	0
8	7855888	.	G	A	0	4	4	0	3	7	0	0
8	7857369	.	A	G	4	0	4	0	3	7	0	0
8	7857378	.	T	C	4	3	7	0	0	7	0	0
8	7860547	.	A	C	2	0	2	0	0	2	0	0
8	7863603	.	C	T	2	2	4	0	0	4	0	0
8	7872053	.	A	T	7	5	12	0	0	12	0	0
8	7872056	.	C	T	6	5	11	0	1	12	0	0
8	7880956	.	A	G	3	3	6	0	1	7	0	0
8	7889397	.	T	A	2	2	4	0	0	4	0	0
8	7891371	.	A	C	4	4	8	0	0	8	0	0
8	7891397	.	G	A	0	3	3	0	3	6	0	0
8	7891640	.	C	A	2	2	4	0	0	4	0	0
8	7908221	.	T	C	3	2	5	0	0	5	0	0
8	7908461	.	T	G	4	0	4	0	5	9	0	0
8	7910107	.	T	C	2	2	4	0	0	4	0	0
8	7912216	.	A	C	8	7	15	0	0	15	0	0
8	7912267	.	C	G	4	0	4	0	10	14	0	0
8	7912394	.	G	A	6	10	16	0	0	16	0	0
8	8032471	.	T	C	2	3	5	0	0	5	0	0
8	8032918	.	T	C	2	3	5	0	0	5	0	0
8	8032945	.	A	G	3	2	5	0	0	5	0	0
8	8033116	.	G	A	4	4	8	0	0	8	0	0
8	8033275	.	G	A	0	3	3	0	1	4	0	0
8	8033290	.	A	G	1	3	4	0	0	4	0	0
8	8034876	.	A	G	0	0	0	0	1	1	0	0
8	8034912	.	A	G	0	0	0	0	2	2	0	0
8	8034933	.	A	C	1	2	3	0	0	3	0	0
8	8196158	.	C	T	2	2	4	0	0	4	0	0
8	8250814	.	T	G	2	0	2	0	1	3	0	0
8	8253412	.	C	T	4	2	6	0	0	6	0	0
8	8253435	.	T	C	2	1	3	0	0	3	0	0
8	8263732	.	T	C	2	2	4	0	0	4	0	0
8	8270565	.	A	T	0	1	1	0	0	1	0	0
8	8270610	.	A	T	0	1	1	0	0	1	0	0
8	8298291	.	A	G	1	2	3	0	0	3	0	0
8	8298472	.	C	T	10	14	24	0	0	24	0	0
8	8301910	.	A	G	3	1	4	0	0	4	0	0
8	8301913	.	T	A	3	1	4	0	0	4	0	0
8	8325553	.	T	A	5	3	8	0	0	8	0	0
8	8331823	.	A	T	12	14	26	0	0	26	0	0
8	8334428	.	C	T	4	3	7	0	0	7	0	0
8	8338969	.	C	T	10	4	14	0	0	14	0	0
8	8341313	.	T	C	4	7	11	0	0	11	0	0
8	8341340	.	A	C	4	9	13	0	0	13	0	0
8	8341383	.	T	C	6	4	10	0	0	10	0	0
8	8341486	.	A	C	4	8	12	0	0	12	0	0
8	8341617	.	A	C	1	3	4	0	0	4	0	0
8	8341619	.	T	C	1	0	1	0	3	4	0	0
8	8343217	.	T	G	8	14	22	0	1	23	0	0
8	8362684	.	G	A	8	7	15	0	2	17	0	0
8	8363058	.	C	T	0	4	4	0	1	5	0	0
8	8389011	.	A	G	6	5	11	0	0	11	0	0
8	8390797	.	A	G	4	2	6	0	1	7	0	0
8	8391508	.	A	G	2	5	7	0	1	8	0	0
8	8426432	.	A	G	3	2	5	0	0	5	0	0
8	8446197	.	C	T	0	3	3	0	4	7	0	0
8	8446343	.	T	A	9	9	18	0	0	18	0	0
8	8468256	.	A	G	1	0	1	0	0	1	0	0
8	8475010	.	T	C	3	2	5	0	0	5	0	0
8	8478746	.	G	A	1	5	6	0	2	8	0	0
8	8478751	.	C	A	2	4	6	0	1	7	0	0
8	8478921	.	A	C	1	2	3	0	0	3	0	0
8	8480454	.	A	C	1	2	3	0	0	3	0	0
8	8480484	.	A	T	1	2	3	0	0	3	0	0
8	8483765	.	T	C	1	3	4	0	0	4	0	0
8	8484269	.	A	G	4	4	8	0	0	8	0	0
8	8484275	.	A	G	3	5	8	0	1	9	0	0
8	8489175	.	G	A	1	6	7	0	0	7	0	0
8	8579618	.	A	C	1	0	1	0	0	1	0	0
8	8605950	.	T	C	3	6	9	0	1	10	0	0
8	8606286	.	C	T	2	3	5	0	2	7	0	0
8	8699163	.	A	T	6	3	9	0	0	9	0	0
8	8699174	.	T	A	7	3	10	0	0	10	0	0
8	8699211	.	C	T	6	6	12	0	0	12	0	0
8	8699235	.	G	A	5	5	10	0	1	11	0	0
8	8704215	.	C	T	1	0	1	0	0	1	0	0
8	8729278	.	C	G	8	6	14	0	0	14	0	0
8	8729308	.	T	A	5	2	7	0	2	9	0	0
8	8735644	.	T	C	4	0	4	0	0	4	0	0
8	8735698	.	C	A	7	8	15	0	0	15	0	0
8	8846132	.	C	T	4	4	8	0	1	9	0	0
8	8846924	.	G	A	5	9	14	0	0	14	0	0
8	8847410	.	A	G	6	7	13	0	2	15	0	0
8	8847434	.	A	C	6	8	14	0	0	14	0	0
8	8847461	.	A	G	4	0	4	0	4	8	0	0
8	8847593	.	T	C	11	11	22	0	0	22	0	0
8	8847676	.	G	C	17	15	32	0	1	33	0	0
8	8847788	.	A	C	14	9	23	0	0	23	0	0
8	8847857	.	T	C	5	5	10	0	1	11	0	0
8	8847860	.	T	C	4	7	11	0	1	12	0	0
8	8847893	.	A	T	6	12	18	0	1	19	0	0
8	8905416	.	T	C	11	12	23	0	1	24	0	0
8	8914899	.	T	C	13	7	20	0	1	21	0	0
8	8922367	.	T	A	17	17	34	0	0	36	2	0
8	8932581	.	T	A	1	1	2	0	0	2	0	0
8	8974572	.	G	A	0	6	6	0	4	10	0	0
8	8975926	.	T	C	2	5	7	0	0	7	0	0
8	8975929	.	T	C	1	4	5	0	0	5	0	0
8	8993240	.	A	G	7	7	14	0	0	14	0	0
8	9011843	.	G	A	5	6	11	0	0	11	0	0
8	9015855	.	A	G	6	10	16	0	0	16	0	0
8	9015894	.	G	C	4	7	11	0	0	11	0	0
8	9028945	.	G	A	0	7	7	0	16	23	0	0
8	9029076	.	A	G	5	5	10	0	1	11	0	0
8	9052184	.	A	T	8	13	21	0	1	22	0	0
8	9059491	.	C	T	5	0	5	0	0	5	0	0
8	9076296	.	T	C	0	2	2	0	0	2	0	0
8	9076389	.	C	T	0	2	2	0	1	3	0	0
8	9092466	.	A	G	10	5	15	0	0	15	0	0
8	9222894	.	G	A	12	10	22	0	1	23	0	0
8	9222988	.	G	C	15	11	26	0	1	27	0	0
8	9223044	.	A	G	15	15	30	0	0	30	0	0
8	9231039	.	T	C	7	0	7	0	5	12	0	0
8	9231054	.	C	T	5	4	9	0	0	9	0	0
8	9234574	.	G	A	1	3	4	0	0	4	0	0
8	9267615	.	G	C	4	4	8	0	0	8	0	0
8	9270038	.	A	G	7	5	12	0	0	12	0	0
8	9270041	.	G	A	7	5	12	0	0	12	0	0
8	9275102	.	G	A	5	3	8	0	0	8	0	0
8	9280529	.	G	A	1	4	5	0	0	5	0	0
8	9369304	.	A	G	0	2	2	0	0	2	0	0
8	9369382	.	A	G	1	3	4	0	0	4	0	0
8	9369390	.	A	G	1	2	3	0	0	3	0	0
8	9444568	.	T	C	0	1	1	0	0	1	0	0
8	9532683	.	A	G	2	6	8	0	0	8	0	0
8	9543159	.	G	T	2	4	6	0	0	6	0	0
8	9543482	.	C	T	3	3	6	0	0	6	0	0
8	9570386	.	A	C	0	3	3	0	0	3	0	0
8	9699182	.	G	C	4	2	6	0	0	6	0	0
8	9709591	.	T	C	0	1	1	0	0	1	0	0
8	9709653	.	G	C	1	4	5	0	0	5	0	0
8	9731233	.	A	G	4	8	12	0	1	13	0	0
8	9736134	.	A	G	8	5	13	0	0	13	0	0
8	9736287	.	G	A	0	1	1	0	0	1	0	0
8	9755356	.	T	G	3	0	3	0	0	3	0	0
8	9761116	.	A	C	5	2	7	0	0	7	0	0
8	9781903	.	G	A	1	3	4	0	0	4	0	0
8	9791577	.	G	A	2	2	4	0	3	7	0	0
8	9791902	.	T	C	16	5	21	0	1	22	0	0
8	9791976	.	T	C	11	8	19	0	1	20	0	0
8	9792083	.	C	G	7	3	10	0	0	10	0	0
8	9867391	.	T	C	3	4	7	0	0	7	0	0
8	9867459	.	T	C	8	2	10	0	1	11	0	0
8	9867477	.	T	C	7	3	10	0	0	10	0	0
8	9867514	.	G	A	0	3	3	0	3	6	0	0
8	9867790	.	A	G	2	3	5	0	0	5	0	0
8	9867823	.	G	A	2	1	3	0	1	4	0	0
8	9867838	.	A	G	2	1	3	0	1	4	0	0
8	9868004	.	C	T	5	4	9	0	0	9	0	0
8	9868310	.	A	G	3	5	8	0	1	9	0	0
8	9868973	.	G	A	0	0	0	0	2	2	0	0
8	9961673	.	T	C	8	4	12	0	0	12	0	0
8	9985374	.	A	G	7	8	15	0	1	16	0	0
8	9985458	.	T	C	1	2	3	0	0	3	0	0
8	10305260	.	C	T	10	12	22	0	0	22	0	0
8	10306061	.	C	T	13	18	31	0	2	33	0	0
8	10306283	.	T	C	0	1	1	0	0	1	0	0
8	10307170	.	C	T	16	18	34	0	0	34	0	0
8	10307686	.	G	T	8	8	16	1	3	20	0	0
8	10307924	.	G	A	13	14	27	0	2	29	0	0
8	10308278	.	G	T	13	17	30	0	1	31	0	0
8	10308684	.	T	G	5	0	5	0	7	12	0	0
8	10562144	.	C	T	14	11	25	0	1	26	0	0
8	10562198	.	A	G	9	16	25	0	0	25	0	0
8	10562400	.	A	C	8	10	18	0	2	20	0	0
8	10823080	.	G	A	0	2	2	0	4	6	0	0
8	10852169	.	T	A	1	1	2	0	0	2	0	0
8	10856107	.	A	G	4	2	6	0	0	6	0	0
8	10862635	.	C	A	6	7	13	0	0	13	0	0
8	10869785	.	T	C	1	2	3	0	0	3	0	0
8	10870571	.	C	A	3	3	6	0	0	6	0	0
8	10882708	.	T	C	5	3	8	0	0	8	0	0
8	10884375	.	G	A	0	3	3	0	5	8	0	0
8	10884489	.	T	C	5	4	9	0	1	10	0	0
8	10884492	.	C	T	5	5	10	0	0	10	0	0
8	10890056	.	G	A	0	4	4	0	4	8	0	0
8	10890079	.	C	T	2	8	10	0	0	10	0	0
8	10890169	.	T	C	9	3	12	0	0	12	0	0
8	10890318	.	T	C	7	4	11	0	0	11	0	0
8	10890325	.	C	G	8	0	8	0	3	11	0	0
8	10895135	.	T	A	3	1	4	0	0	4	0	0
8	10937696	.	A	T	2	4	6	0	0	6	0	0
8	10938031	.	G	A	1	2	3	0	0	3	0	0
8	10938058	.	A	T	1	2	3	0	0	3	0	0
8	10938191	.	A	G	2	2	4	0	0	4	0	0
8	10938225	.	T	C	1	2	3	0	0	3	0	0
8	10938418	.	T	C	2	0	2	0	1	3	0	0
8	10956561	.	G	T	3	6	9	0	0	9	0	0
8	10956747	.	G	A	2	4	6	0	0	6	0	0
8	10956794	.	G	C	4	4	8	0	0	8	0	0
8	10957168	.	A	C	6	0	6	0	2	8	0	0
8	10969651	.	T	A	2	9	11	0	0	11	0	0
8	10969694	.	C	T	1	6	7	0	0	7	0	0
8	10978029	.	T	C	7	6	13	0	3	16	0	0
8	10978038	.	C	T	10	7	17	0	1	18	0	0
8	10978101	.	A	G	8	11	19	0	0	19	0	0
8	10980909	.	A	G	4	3	7	0	0	7	0	0
8	10981277	.	A	T	3	3	6	0	0	6	0	0
8	10987621	.	G	A	1	1	2	0	0	2	0	0
8	10988963	.	A	G	1	5	6	0	0	6	0	0
8	10991498	.	C	T	0	1	1	0	1	2	0	0
8	11004484	.	C	A	0	5	5	0	9	14	0	0
8	11004549	.	C	T	7	6	13	0	0	13	0	0
8	11004597	.	G	T	8	5	13	0	0	13	0	0
8	11004625	.	A	G	9	10	19	0	1	20	0	0
8	11004652	.	T	A	11	12	23	0	0	23	0	0
8	11008873	.	A	C	1	1	2	0	2	4	0	0
8	11008889	.	C	A	2	5	7	0	1	8	0	0
8	11009006	.	A	T	6	7	13	0	0	13	0	0
8	11009117	.	T	C	9	11	20	0	1	21	0	0
8	11016720	.	A	C	7	6	13	0	0	13	0	0
8	11019138	.	T	C	2	0	2	0	3	5	0	0
8	11019273	.	A	T	5	3	8	0	0	9	1	0
8	11028031	.	T	C	2	2	4	0	0	4	0	0
8	11036882	.	A	G	2	1	3	0	0	3	0	0
8	11036904	.	C	A	2	2	4	0	0	4	0	0
8	11055988	.	A	G	1	3	4	0	0	4	0	0
8	11055994	.	G	A	1	3	4	0	0	4	0	0
8	11066300	.	G	A	0	1	1	0	0	1	0	0
8	11067152	.	G	A	2	3	5	0	0	5	0	0
8	11067186	.	A	C	3	3	6	0	0	6	0	0
8	11067211	.	A	C	2	2	4	0	0	4	0	0
8	11114825	.	A	G	2	2	4	0	0	4	0	0
8	11136791	.	G	A	6	3	9	0	1	10	0	0
8	11139954	.	C	G	1	1	2	0	2	4	0	0
8	11141807	.	C	T	4	7	11	0	0	11	0	0
8	11144820	.	T	C	0	0	0	0	1	1	0	0
8	11146856	.	T	C	3	3	6	0	0	6	0	0
8	11146883	.	T	G	5	7	12	0	0	12	0	0
8	11180115	.	G	C	5	3	8	0	0	8	0	0
8	11182273	.	G	A	10	9	19	0	0	19	0	0
8	11182825	.	G	A	8	9	17	0	0	17	0	0
8	11182873	.	G	A	5	7	12	0	0	12	0	0
8	11183130	.	T	A	6	2	8	0	0	8	0	0
8	11183262	.	T	A	9	7	16	0	1	17	0	0
8	11183284	.	T	G	11	7	18	0	0	18	0	0
8	11183773	.	T	G	1	4	5	0	0	5	0	0
8	11183817	.	C	G	0	6	6	0	9	15	0	0
8	11183892	.	T	A	2	6	8	0	0	8	0	0
8	11183943	.	A	T	9	6	15	0	0	15	0	0
8	11184230	.	G	A	5	3	8	0	0	8	0	0
8	11184413	.	C	A	2	7	9	0	0	9	0	0
8	11185286	.	C	T	4	4	8	0	0	8	0	0
8	11185371	.	T	C	8	7	15	0	0	15	0	0
8	11185986	.	T	C	3	0	3	0	6	9	0	0
8	11186812	.	G	A	0	2	2	0	0	2	0	0
8	11189059	.	A	G	2	4	6	0	0	6	0	0
8	11189290	.	A	G	3	2	5	0	0	5	0	0
8	11190085	.	G	A	2	3	5	0	1	6	0	0
8	11190403	.	A	T	3	3	6	0	0	6	0	0
8	11190919	.	T	C	1	4	5	0	0	5	0	0
8	11191006	.	A	C	1	2	3	0	0	3	0	0
8	11191051	.	T	G	2	2	4	0	0	4	0	0
8	11191097	.	C	T	2	0	2	0	1	3	0	0
8	11191263	.	C	T	2	3	5	0	0	5	0	0
8	11191694	.	A	G	3	3	6	0	0	6	0	0
8	11201802	.	G	A	1	2	3	0	0	3	0	0
8	11201986	.	G	T	1	2	3	0	0	3	0	0
8	11201995	.	T	G	1	2	3	0	0	3	0	0
8	11202058	.	C	T	1	2	3	0	0	3	0	0
8	11204295	.	C	T	1	4	5	0	0	5	0	0
8	11204346	.	T	A	0	7	7	0	1	8	0	0
8	11204365	.	C	A	1	7	8	0	0	8	0	0
8	11204441	.	C	T	0	5	5	0	0	5	0	0
8	11204533	.	A	G	1	4	5	0	0	5	0	0
8	11209538	.	G	A	2	2	4	0	0	4	0	0
8	11209559	.	G	A	2	2	4	0	0	4	0	0
8	11234333	.	A	C	3	0	3	0	2	5	0	0
8	11234334	.	T	G	3	2	5	0	0	5	0	0
8	11234489	.	T	C	5	0	5	0	8	13	0	0
8	11234522	.	T	G	4	11	15	0	0	15	0	0
8	11234573	.	A	G	9	10	19	0	0	19	0	0
8	11234678	.	G	A	4	5	9	0	0	9	0	0
8	11241284	.	A	T	3	5	8	0	0	8	0	0
8	11245918	.	C	T	2	10	12	0	1	13	0	0
8	11245967	.	A	G	4	8	12	0	0	12	0	0
8	11246006	.	G	A	1	1	2	0	0	2	0	0
8	11250740	.	A	T	8	11	19	0	1	20	0	0
8	11268717	.	A	T	1	0	1	0	0	1	0	0
8	11268807	.	G	A	5	6	11	0	0	11	0	0
8	11289265	.	T	A	1	0	1	0	0	1	0	0
8	11289267	.	G	C	1	0	1	0	0	1	0	0
8	11327947	.	C	G	0	1	1	0	0	1	0	0
8	11337395	.	C	T	1	2	3	0	0	4	1	0
8	11338579	.	A	G	2	2	4	0	0	4	0	0
8	11338659	.	A	G	3	0	3	0	4	7	0	0
8	11338660	.	A	G	2	5	7	0	0	7	0	0
8	11338782	.	A	G	1	1	2	0	0	2	0	0
8	11338794	.	A	G	1	2	3	0	0	3	0	0
8	11338934	.	A	T	5	3	8	0	0	8	0	0
8	11338941	.	G	A	0	2	2	0	5	7	0	0
8	11339307	.	T	C	5	13	18	0	0	18	0	0
8	11339379	.	A	T	3	3	6	0	0	6	0	0
8	11339485	.	C	T	3	2	5	0	0	5	0	0
8	11488414	.	C	T	10	7	17	0	1	18	0	0
8	11488468	.	C	T	4	2	6	0	1	7	0	0
8	11491308	.	A	G	8	9	17	0	0	17	0	0
8	11491347	.	G	C	0	2	2	0	1	3	0	0
8	11504174	.	T	A	1	3	4	0	0	4	0	0
8	11511403	.	C	T	0	1	1	0	0	1	0	0
8	11521110	.	A	T	3	2	5	0	0	5	0	0
8	11521244	.	A	G	2	1	3	0	0	3	0	0
8	11535261	.	A	G	8	1	9	0	0	9	0	0
8	11541880	.	T	C	8	12	20	0	1	21	0	0
8	11541960	.	G	T	4	5	9	0	0	9	0	0
8	11542207	.	C	G	5	5	10	0	1	11	0	0
8	11548214	.	T	G	1	2	3	0	0	3	0	0
8	11548311	.	G	T	1	7	8	0	0	8	0	0
8	11548419	.	A	G	2	4	6	0	0	6	0	0
8	11588953	.	C	A	2	4	6	0	0	6	0	0
8	11590976	.	G	A	1	2	3	0	0	3	0	0
8	11648291	.	A	G	1	2	3	0	0	3	0	0
8	11649993	.	T	C	0	2	2	0	0	2	0	0
8	11681056	.	G	T	2	6	8	0	1	9	0	0
8	11681078	.	G	A	2	8	10	0	1	11	0	0
8	11717091	.	A	G	1	1	2	0	0	2	0	0
8	11724237	.	T	C	3	1	4	0	0	4	0	0
8	11728172	.	A	G	1	0	1	0	2	3	0	0
8	11737937	.	A	G	0	1	1	0	0	1	0	0
8	11740220	.	T	C	12	11	23	0	0	23	0	0
8	11740370	.	G	A	11	14	25	0	2	27	0	0
8	11744619	.	A	G	1	5	6	0	0	6	0	0
8	11744660	.	A	G	1	4	5	0	0	5	0	0
8	11744723	.	T	G	1	10	11	0	0	11	0	0
8	11744810	.	G	A	1	6	7	0	0	7	0	0
8	11746759	.	G	A	8	5	13	0	1	14	0	0
8	11752672	.	T	A	1	3	4	0	0	4	0	0
8	11761829	.	T	A	2	3	5	0	0	5	0	0
8	11761862	.	T	C	1	0	1	0	2	3	0	0
8	11770033	.	T	A	5	4	9	0	0	9	0	0
8	11788795	.	C	T	1	2	3	0	0	3	0	0
8	11789554	.	T	C	1	1	2	0	0	2	0	0
8	11789587	.	G	A	1	0	1	0	0	1	0	0
8	11794663	.	C	T	2	0	2	0	0	2	0	0
8	11884919	.	T	A	4	4	8	0	0	8	0	0
8	11884930	.	A	G	5	3	8	0	0	8	0	0
8	11885082	.	T	C	0	1	1	0	0	1	0	0
8	11985228	.	A	G	3	2	5	0	0	5	0	0
8	12016451	.	T	C	7	17	24	0	1	25	0	0
8	12016553	.	G	A	9	4	13	0	0	13	0	0
8	12118473	.	A	G	13	4	17	0	0	17	0	0
8	12121893	.	C	T	9	3	12	0	0	12	0	0
8	12135193	.	A	G	2	0	2	0	0	2	0	0
8	12135196	.	T	C	2	1	3	0	0	3	0	0
8	12142180	.	T	A	3	4	7	0	0	7	0	0
8	12149688	.	C	T	4	2	6	0	0	6	0	0
8	12149865	.	G	T	9	5	14	0	4	18	0	0
8	12150471	.	C	T	3	4	7	0	1	8	0	0
8	12150480	.	A	G	3	5	8	0	1	9	0	0
8	12156204	.	C	T	6	3	9	0	0	9	0	0
8	12183187	.	T	C	3	0	3	0	8	11	0	0
8	12209354	.	C	G	1	3	4	0	0	4	0	0
8	12452284	.	C	T	0	10	10	0	9	19	0	0
8	12521420	.	A	G	3	4	7	0	0	7	0	0
8	12574533	.	A	G	8	4	12	0	0	12	0	0
8	12601513	.	G	A	7	5	12	0	0	12	0	0
8	12668578	.	G	T	2	4	6	0	2	8	0	0
8	12668714	.	C	T	3	2	5	0	0	5	0	0
8	12925505	.	T	C	3	5	8	0	0	8	0	0
8	12932734	.	G	A	2	6	8	0	0	8	0	0
8	12936857	.	A	C	8	10	18	0	1	19	0	0
8	12937147	.	T	C	1	7	8	0	1	9	0	0
8	12962712	.	T	C	1	0	1	0	0	1	0	0
8	12989640	.	T	A	3	3	6	0	0	6	0	0
8	12994619	.	C	T	0	1	1	0	0	1	0	0
8	13068237	.	A	T	3	3	6	0	0	6	0	0
8	13068315	.	C	T	4	3	7	0	0	7	0	0
8	13093662	.	G	A	0	2	2	0	0	2	0	0
8	13093677	.	C	T	0	4	4	0	0	4	0	0
8	13094340	.	C	T	0	1	1	0	0	1	0	0
8	13097535	.	C	T	9	6	15	0	5	20	0	0
8	13097538	.	C	A	8	10	18	0	2	20	0	0
8	13098033	.	A	G	4	3	7	0	0	7	0	0
8	13155009	.	G	A	0	1	1	0	1	2	0	0
8	13157817	.	T	C	3	3	6	0	0	6	0	0
8	13157827	.	A	C	3	3	6	0	0	6	0	0
8	13158766	.	T	A	1	2	3	0	0	3	0	0
8	13161999	.	A	G	10	7	17	0	2	19	0	0
8	13162008	.	T	C	9	9	18	0	1	19	0	0
8	13166176	.	T	A	2	4	6	0	0	6	0	0
8	13192061	.	T	C	0	2	2	0	0	2	0	0
8	13194912	.	C	T	0	5	5	0	2	7	0	0
8	13210957	.	T	C	1	0	1	0	2	3	0	0
8	13352100	.	C	A	0	14	14	0	14	28	0	0
8	13352103	.	T	A	11	14	25	0	2	27	0	0
8	13352166	.	T	C	15	16	31	0	1	32	0	0
8	13352318	.	G	A	15	13	28	0	1	29	0	0
8	13352428	.	A	G	17	31	48	0	2	50	0	0
8	13355949	.	C	T	13	25	38	0	1	39	0	0
8	13362699	.	T	C	17	26	43	0	2	45	0	0
8	13382207	.	G	T	1	2	3	0	0	3	0	0
8	13382216	.	T	C	1	2	3	0	0	3	0	0
8	13643862	.	G	C	1	3	4	0	0	4	0	0
8	13643998	.	A	T	3	2	5	0	0	5	0	0
8	13779556	.	C	T	7	6	13	0	0	13	0	0
8	13779604	.	T	C	4	4	8	0	0	8	0	0
8	13782862	.	C	G	6	7	13	0	0	13	0	0
8	13782902	.	C	A	12	9	21	0	0	21	0	0
8	13784177	.	A	G	7	6	13	0	2	15	0	0
8	13784180	.	G	A	8	5	13	0	2	15	0	0
8	13784219	.	C	T	17	16	33	0	1	34	0	0
8	13784231	.	A	G	16	12	28	0	3	31	0	0
8	13784288	.	A	T	3	1	4	0	1	5	0	0
8	13786944	.	G	C	16	15	31	0	2	33	0	0
8	13787093	.	G	A	0	8	8	0	8	16	0	0
8	13787132	.	G	A	9	11	20	0	0	20	0	0
8	13787150	.	A	T	8	10	18	0	0	18	0	0
8	13787310	.	T	G	7	7	14	0	0	14	0	0
8	13787345	.	G	A	6	6	12	0	0	12	0	0
8	13787528	.	G	A	13	7	20	0	1	21	0	0
8	13852674	.	A	C	0	0	0	0	5	5	0	0
8	13852774	.	C	T	20	22	42	0	1	43	0	0
8	13852795	.	T	C	15	26	41	0	6	47	0	0
8	13852864	.	T	C	20	15	35	0	1	36	0	0
8	13852930	.	G	A	20	13	33	0	1	34	0	0
8	13853026	.	C	T	3	5	8	0	0	8	0	0
8	13910234	.	C	A	11	4	15	0	0	15	0	0
8	13944193	.	T	C	3	11	14	0	1	15	0	0
8	13991828	.	G	A	5	3	8	0	0	8	0	0
8	13991875	.	C	A	3	5	8	0	1	9	0	0
8	13993704	.	A	G	1	1	2	0	0	2	0	0
8	13998361	.	A	C	2	0	2	0	4	6	0	0
8	13998483	.	A	C	2	6	8	0	0	8	0	0
8	13998502	.	C	A	2	5	7	0	0	7	0	0
8	14003374	.	G	A	22	27	49	0	4	53	0	0
8	14012346	.	C	T	1	17	18	0	13	31	0	0
8	14018790	.	C	T	3	7	10	0	0	10	0	0
8	14020571	.	A	G	26	22	48	0	1	49	0	0
8	14027241	.	A	C	12	18	30	0	1	31	0	0
8	14041319	.	A	G	21	24	45	0	1	46	0	0
8	14043810	.	A	G	26	19	45	0	4	49	0	0
8	14049333	.	A	C	17	12	29	0	0	29	0	0
8	14049447	.	G	A	18	25	43	0	1	44	0	0
8	14049462	.	A	G	23	24	47	0	0	47	0	0
8	14049641	.	G	A	19	25	44	0	3	47	0	0
8	14049702	.	T	C	17	14	31	0	2	33	0	0
8	14059173	.	C	T	1	2	3	0	0	3	0	0
8	14063418	.	T	A	9	9	18	0	0	18	0	0
8	14064253	.	T	A	4	4	8	0	0	8	0	0
8	14064374	.	G	A	7	5	12	0	0	12	0	0
8	14064441	.	C	A	7	9	16	0	0	16	0	0
8	14070490	.	T	C	8	7	15	0	0	15	0	0
8	14075809	.	C	T	4	9	13	0	1	14	0	0
8	14076247	.	G	A	7	9	16	0	0	16	0	0
8	14076340	.	T	G	5	9	14	0	1	15	0	0
8	14130264	.	G	A	1	3	4	0	0	4	0	0
8	14130435	.	T	C	6	0	6	0	2	8	0	0
8	14133855	.	G	A	0	1	1	0	0	1	0	0
8	14163845	.	A	G	4	6	10	0	0	10	0	0
8	14170428	.	C	A	5	3	8	0	0	8	0	0
8	14170546	.	A	T	1	3	4	0	1	5	0	0
8	14170712	.	C	T	16	16	32	0	1	33	0	0
8	14170789	.	A	T	14	11	25	0	0	25	0	0
8	14171076	.	A	T	27	10	37	1	3	41	0	0
8	14171346	.	T	C	13	17	30	0	3	33	0	0
8	14171414	.	G	A	14	23	37	0	3	40	0	0
8	14171660	.	T	C	22	18	40	0	1	41	0	0
8	14171825	.	C	T	0	10	10	0	21	31	0	0
8	14171875	.	G	T	31	17	48	0	1	49	0	0
8	14171955	.	T	C	23	18	41	0	0	41	0	0
8	14172113	.	A	T	20	18	38	0	1	39	0	0
8	14174231	.	G	A	20	14	34	0	2	36	0	0
8	14176574	.	T	C	1	0	1	0	0	1	0	0
8	14176592	.	A	G	3	4	7	0	0	7	0	0
8	14184198	.	C	T	0	6	6	0	24	30	0	0
8	14184246	.	A	G	16	28	44	0	1	45	0	0
8	14212264	.	T	G	3	7	10	0	2	12	0	0
8	14212384	.	T	C	6	0	6	0	7	13	0	0
8	14212545	.	T	C	7	0	7	0	11	18	0	0
8	14212676	.	A	G	8	7	15	0	3	18	0	0
8	14213303	.	T	C	5	4	9	0	1	10	0	0
8	14217986	.	T	C	7	3	10	0	0	10	0	0
8	14219756	.	C	T	0	5	5	0	4	9	0	0
8	14229557	.	A	G	5	1	6	0	0	6	0	0
8	14236178	.	A	G	1	1	2	0	0	2	0	0
8	14236182	.	C	T	1	1	2	0	0	2	0	0
8	14238810	.	G	A	1	5	6	0	1	7	0	0
8	14238826	.	C	T	1	3	4	0	1	5	0	0
8	14244494	.	A	G	11	11	22	0	1	23	0	0
8	14246405	.	G	A	20	26	46	0	0	46	0	0
8	14246411	.	A	G	22	21	43	0	1	44	0	0
8	14247431	.	A	G	7	4	11	0	0	11	0	0
8	14250036	.	C	T	11	17	28	0	0	28	0	0
8	14250063	.	A	T	15	14	29	0	3	32	0	0
8	14272806	.	A	G	7	10	17	0	1	18	0	0
8	14275609	.	G	A	1	1	2	0	0	2	0	0
8	14278444	.	G	A	8	8	16	0	0	16	0	0
8	14375543	.	A	T	7	11	18	0	1	19	0	0
8	14375718	.	T	A	5	9	14	0	0	14	0	0
8	14375742	.	C	A	8	8	16	0	0	16	0	0
8	14375841	.	T	C	15	5	20	0	0	20	0	0
8	14375873	.	T	C	5	3	8	0	0	8	0	0
8	14384377	.	A	G	5	3	8	0	1	9	0	0
8	14388428	.	A	G	0	4	4	0	0	4	0	0
8	14388482	.	G	A	0	2	2	0	0	2	0	0
8	14439556	.	T	G	6	6	12	0	0	12	0	0
8	14440447	.	A	C	9	12	21	0	1	22	0	0
8	14440526	.	A	G	2	0	2	0	6	8	0	0
8	14440528	.	T	C	2	5	7	0	1	8	0	0
8	14440564	.	A	G	6	3	9	0	0	9	0	0
8	14440580	.	C	A	9	3	12	0	0	12	0	0
8	14441344	.	C	T	13	7	20	0	0	20	0	0
8	14441416	.	C	A	8	9	17	0	0	17	0	0
8	14441524	.	A	G	3	7	10	0	1	11	0	0
8	14441527	.	A	G	8	2	10	0	1	11	0	0
8	14441656	.	A	C	4	10	14	0	0	14	0	0
8	14441657	.	C	A	4	9	13	0	1	14	0	0
8	14441728	.	A	C	5	4	9	0	0	9	0	0
8	14454287	.	G	C	4	2	6	0	0	6	0	0
8	14454383	.	T	C	4	5	9	0	0	9	0	0
8	14454425	.	G	T	4	3	7	0	0	7	0	0
8	14559476	.	A	G	4	2	6	0	0	6	0	0
8	14559709	.	T	A	2	3	5	0	0	5	0	0
8	14560242	.	A	C	2	7	9	0	0	9	0	0
8	14560252	.	A	G	3	7	10	0	0	10	0	0
8	14560612	.	G	A	2	3	5	0	0	5	0	0
8	14561114	.	G	T	4	3	7	0	2	9	0	0
8	14561129	.	T	G	3	3	6	0	0	6	0	0
8	14564126	.	C	T	0	3	3	0	7	10	0	0
8	14564717	.	T	A	3	5	8	0	0	8	0	0
8	14564813	.	G	T	4	2	6	0	0	6	0	0
8	14565180	.	T	C	3	4	7	0	0	7	0	0
8	14565303	.	T	A	5	4	9	0	0	9	0	0
8	14565350	.	G	A	7	5	12	0	0	12	0	0
8	14565376	.	T	C	3	3	6	0	0	6	0	0
8	14565457	.	T	C	8	3	11	0	0	11	0	0
8	14565780	.	G	T	0	2	2	0	0	2	0	0
8	14565843	.	C	T	0	2	2	0	2	4	0	0
8	14565850	.	A	G	3	1	4	0	0	4	0	0
8	14566295	.	G	T	0	0	0	0	1	1	0	0
8	14566360	.	C	A	2	3	5	0	0	5	0	0
8	14566380	.	A	C	2	0	2	0	1	3	0	0
8	14568760	.	G	A	0	2	2	0	1	3	0	0
8	14571008	.	C	T	3	4	7	0	0	7	0	0
8	14571053	.	A	G	2	4	6	0	0	6	0	0
8	14578369	.	A	G	2	3	5	0	0	5	0	0
8	14578765	.	G	A	1	2	3	0	0	3	0	0
8	14580484	.	A	G	1	0	1	0	0	1	0	0
8	14581138	.	A	T	1	2	3	0	0	3	0	0
8	14581650	.	T	C	1	1	2	0	0	2	0	0
8	14781631	.	G	A	0	3	3	0	1	4	0	0
8	14790282	.	T	C	11	7	18	0	0	18	0	0
8	14790733	.	C	T	4	3	7	0	0	7	0	0
8	14792860	.	A	G	2	6	8	0	0	8	0	0
8	14802951	.	T	C	1	2	3	0	0	3	0	0
8	14805109	.	C	T	2	3	5	0	0	5	0	0
8	14810527	.	A	G	2	4	6	0	1	7	0	0
8	14915387	.	A	C	0	4	4	0	0	4	0	0
8	14915478	.	T	C	2	2	4	0	0	4	0	0
8	14972782	.	T	A	3	0	3	0	0	3	0	0
8	14978906	.	T	C	5	6	11	0	0	11	0	0
8	14979893	.	A	C	10	5	15	0	1	16	0	0
8	14981059	.	A	T	6	3	9	0	0	9	0	0
8	14981124	.	A	T	7	6	13	0	2	15	0	0
8	14981189	.	T	A	1	5	6	0	1	7	0	0
8	14981235	.	C	T	5	2	7	0	1	8	0	0
8	14981991	.	C	T	4	6	10	0	0	10	0	0
8	14982022	.	A	G	5	6	11	0	0	11	0	0
8	14982477	.	A	C	5	7	12	0	1	13	0	0
8	14982775	.	T	C	3	4	7	0	0	7	0	0
8	14982786	.	T	G	3	5	8	0	0	8	0	0
8	14982919	.	C	T	5	4	9	0	0	9	0	0
8	14982962	.	A	T	6	3	9	0	0	9	0	0
8	14983081	.	T	C	1	3	4	0	0	4	0	0
8	14983116	.	A	G	5	2	7	0	0	7	0	0
8	14983117	.	A	G	4	2	6	0	1	7	0	0
8	14983176	.	A	G	3	5	8	0	0	8	0	0
8	14983191	.	A	G	3	4	7	0	0	7	0	0
8	14983211	.	A	G	3	4	7	0	0	7	0	0
8	14983866	.	C	T	7	6	13	0	1	14	0	0
8	15056624	.	C	G	9	3	12	0	0	12	0	0
8	15072236	.	A	C	0	0	0	0	1	1	0	0
8	15080551	.	G	A	13	7	20	0	0	20	0	0
8	15080566	.	A	G	13	5	18	0	0	18	0	0
8	15088972	.	T	C	1	0	1	0	4	5	0	0
8	15088981	.	T	C	1	0	1	0	4	5	0	0
8	15091708	.	C	T	3	4	7	0	0	7	0	0
8	15091727	.	T	A	3	4	7	0	0	7	0	0
8	15094241	.	T	C	4	8	12	0	0	12	0	0
8	15094262	.	C	T	6	2	8	0	1	9	0	0
8	15094525	.	A	G	4	9	13	0	0	13	0	0
8	15094588	.	G	C	6	7	13	0	0	13	0	0
8	15094599	.	C	A	1	8	9	0	6	15	0	0
8	15100461	.	A	G	2	4	6	0	0	6	0	0
8	15100653	.	T	C	4	0	4	0	9	13	0	0
8	15100731	.	A	G	5	3	8	0	1	9	0	0
8	15252141	.	A	G	3	0	3	0	0	3	0	0
8	15252250	.	C	G	14	11	25	0	1	26	0	0
8	15252306	.	G	A	4	1	5	0	0	5	0	0
8	15253365	.	C	A	4	2	6	0	0	6	0	0
8	15253384	.	T	C	6	3	9	0	0	9	0	0
8	15253496	.	G	A	10	5	15	0	0	15	0	0
8	15272931	.	C	T	1	0	1	0	0	1	0	0
8	15275665	.	T	C	3	4	7	0	0	7	0	0
8	15275704	.	G	A	0	3	3	0	1	4	0	0
8	15276587	.	T	A	11	10	21	0	0	21	0	0
8	15276588	.	C	G	11	10	21	0	0	21	0	0
8	15276678	.	G	A	7	5	12	0	0	12	0	0
8	15276684	.	G	A	0	5	5	0	7	12	0	0
8	15276883	.	A	T	2	2	4	0	1	5	0	0
8	15276944	.	T	G	5	8	13	0	1	14	0	0
8	15277957	.	T	C	2	3	5	0	0	5	0	0
8	15277965	.	T	C	2	3	5	0	0	5	0	0
8	15312985	.	A	G	1	1	2	0	0	2	0	0
8	15502946	.	A	G	1	2	3	0	0	3	0	0
8	15502959	.	C	T	0	2	2	0	1	3	0	0
8	15951146	.	C	T	0	4	4	0	5	9	0	0
8	15951185	.	A	G	3	3	6	0	0	6	0	0
8	16054374	.	C	T	19	16	35	0	2	37	0	0
8	16054389	.	T	C	16	11	27	0	2	29	0	0
8	16112107	.	G	A	2	21	23	0	32	55	0	0
8	16112212	.	C	T	37	18	55	0	4	59	0	0
8	16113850	.	C	A	20	14	34	0	3	37	0	0
8	16115682	.	C	T	16	9	25	0	7	34	2	0
8	16257435	.	C	T	3	3	6	0	1	7	0	0
8	16257444	.	G	T	2	2	4	0	0	4	0	0
8	16294511	.	G	A	13	12	25	0	0	25	0	0
8	16382915	.	G	A	1	0	1	0	0	1	0	0
8	16406283	.	C	A	4	4	8	0	1	9	0	0
8	16408621	.	A	G	2	4	6	0	0	6	0	0
8	16408914	.	T	A	2	5	7	0	0	7	0	0
8	16411882	.	A	C	1	1	2	0	1	3	0	0
8	16411892	.	C	T	1	2	3	0	0	3	0	0
8	16425038	.	C	T	7	10	17	0	0	17	0	0
8	16425079	.	C	T	0	7	7	0	8	15	0	0
8	16425383	.	T	C	12	11	23	0	0	23	0	0
8	16439114	.	G	T	7	7	14	0	0	15	1	0
8	16464100	.	A	G	4	3	7	0	0	7	0	0
8	16464166	.	G	A	7	3	10	0	1	11	0	0
8	16464296	.	T	A	6	6	12	0	0	12	0	0
8	16464306	.	T	G	6	5	11	0	1	12	0	0
8	16470445	.	T	C	1	0	1	0	3	4	0	0
8	16470703	.	C	A	1	2	3	0	0	3	0	0
8	16470913	.	T	C	2	2	4	0	0	4	0	0
8	16470914	.	G	T	2	2	4	0	0	4	0	0
8	16471018	.	A	C	2	3	5	0	0	5	0	0
8	16516832	.	A	T	8	6	14	0	0	14	0	0
8	16517152	.	C	A	5	7	12	0	1	13	0	0
8	16517265	.	C	T	0	4	4	0	4	8	0	0
8	16518493	.	T	A	1	3	4	0	0	4	0	0
8	16518724	.	C	T	3	2	5	0	0	5	0	0
8	16519055	.	C	T	10	5	15	0	1	16	0	0
8	16519084	.	C	A	10	7	17	0	0	17	0	0
8	16519102	.	T	G	9	5	14	0	2	16	0	0
8	16519370	.	G	A	7	3	10	0	0	10	0	0
8	16519389	.	C	T	6	4	10	0	0	10	0	0
8	16519506	.	T	C	1	4	5	0	0	5	0	0
8	16519560	.	A	G	2	8	10	0	0	10	0	0
8	16519637	.	C	T	8	5	13	0	0	13	0	0
8	16519646	.	G	T	7	6	13	0	0	13	0	0
8	16525366	.	T	A	6	2	8	0	0	8	0	0
8	16527055	.	C	G	1	7	8	0	0	8	0	0
8	16527060	.	T	C	0	0	0	0	8	8	0	0
8	16527091	.	G	A	1	5	6	0	0	6	0	0
8	16582470	.	T	A	16	6	22	0	6	28	0	0
8	16582608	.	G	A	23	14	37	0	0	37	0	0
8	16583127	.	C	T	8	14	22	0	2	24	0	0
8	16583142	.	A	C	16	12	28	0	1	29	0	0
8	16583447	.	C	T	20	14	34	0	1	35	0	0
8	16583528	.	C	T	14	14	28	0	1	33	4	0
8	16583534	.	G	C	12	21	33	0	0	33	0	0
8	16583591	.	C	T	23	8	31	3	1	35	0	0
8	16587510	.	T	A	15	15	30	0	0	30	0	0
8	16587964	.	A	T	5	17	22	0	0	22	0	0
8	16588157	.	A	G	4	6	10	0	0	10	0	0
8	16588444	.	G	A	9	12	21	0	1	22	0	0
8	16591864	.	A	G	2	2	4	0	0	4	0	0
8	16592465	.	G	C	15	16	31	0	2	33	0	0
8	16597215	.	C	T	5	5	10	0	2	12	0	0
8	16597238	.	G	A	9	11	20	0	1	21	0	0
8	16597252	.	G	A	11	13	24	0	0	24	0	0
8	16597589	.	T	A	3	5	8	0	0	8	0	0
8	16597621	.	T	C	4	5	9	0	0	9	0	0
8	16597654	.	T	C	5	0	5	0	3	8	0	0
8	16597680	.	C	G	3	5	8	0	1	9	0	0
8	16597889	.	G	A	3	5	8	0	1	9	0	0
8	16597949	.	A	T	4	14	18	0	1	19	0	0
8	16597964	.	G	A	6	12	18	0	0	18	0	0
8	16597986	.	G	A	3	12	15	0	1	16	0	0
8	16598076	.	C	T	0	15	15	0	11	26	0	0
8	16598148	.	C	T	0	6	6	0	3	9	0	0
8	16600671	.	T	C	2	4	6	0	0	6	0	0
8	16602571	.	G	A	3	4	7	0	0	7	0	0
8	16605678	.	G	A	6	5	11	0	1	12	0	0
8	16605723	.	G	A	5	8	13	0	0	13	0	0
8	16610221	.	T	A	1	3	4	0	0	4	0	0
8	16611005	.	A	C	1	1	2	0	0	2	0	0
8	16611394	.	A	G	1	3	4	0	0	4	0	0
8	16615802	.	T	C	7	7	14	0	1	15	0	0
8	16616697	.	C	T	0	23	23	0	18	41	0	0
8	16621919	.	A	G	1	2	3	0	0	3	0	0
8	16632794	.	G	A	8	7	15	0	0	15	0	0
8	16680399	.	C	T	2	2	4	0	0	4	0	0
8	16680424	.	C	A	0	1	1	0	0	2	1	0
8	16680448	.	T	A	1	2	3	0	0	3	0	0
8	16681329	.	C	T	1	1	2	0	0	2	0	0
8	16683741	.	G	A	0	1	1	0	0	1	0	0
8	16685439	.	C	T	0	2	2	0	0	2	0	0
8	16702267	.	C	T	0	2	2	0	0	2	0	0
8	16702707	.	G	A	1	1	2	0	0	2	0	0
8	16729938	.	A	G	14	13	27	0	1	28	0	0
8	16729941	.	G	A	14	12	26	0	0	26	0	0
8	16734037	.	A	T	6	5	11	0	0	11	0	0
8	16734074	.	C	G	2	4	6	0	2	8	0	0
8	16734247	.	C	A	7	8	15	0	1	16	0	0
8	16736489	.	A	T	0	5	5	0	0	5	0	0
8	16738054	.	G	A	11	9	20	0	0	20	0	0
8	16738149	.	G	T	10	13	23	0	0	23	0	0
8	16738481	.	C	T	5	2	7	0	1	8	0	0
8	16740792	.	A	G	2	4	6	0	0	6	0	0
8	16740977	.	C	T	2	1	3	0	0	3	0	0
8	16755381	.	G	A	11	8	19	0	0	19	0	0
8	16756847	.	G	C	5	5	10	0	0	10	0	0
8	16758445	.	C	T	2	1	3	0	1	4	0	0
8	16768992	.	A	G	5	0	5	0	7	12	0	0
8	16769126	.	C	T	4	9	13	0	0	13	0	0
8	17039140	.	G	A	2	3	5	0	0	5	0	0
8	17044255	.	G	A	0	3	3	0	2	5	0	0
8	17055727	.	C	T	1	16	17	0	32	49	0	0
8	17055766	.	G	A	26	18	44	0	0	44	0	0
8	17062173	.	G	A	12	10	22	0	0	22	0	0
8	17067269	.	T	C	13	16	29	0	2	31	0	0
8	17079902	.	C	T	6	8	14	0	0	14	0	0
8	17081782	.	C	T	17	6	23	0	1	24	0	0
8	17081863	.	G	A	5	5	10	0	1	11	0	0
8	17082696	.	C	A	2	2	4	0	0	4	0	0
8	17082927	.	G	A	1	4	5	0	5	10	0	0
8	17084696	.	G	C	6	14	20	0	0	20	0	0
8	17084733	.	C	G	3	6	9	0	0	9	0	0
8	17085921	.	G	A	15	15	30	0	3	33	0	0
8	17086002	.	C	T	13	7	20	0	0	20	0	0
8	17086033	.	C	T	6	5	11	0	0	11	0	0
8	17086096	.	A	T	1	7	8	0	0	8	0	0
8	17146845	.	T	G	0	1	1	0	0	1	0	0
8	17146887	.	T	C	3	2	5	0	0	5	0	0
8	17151997	.	A	G	1	0	1	0	1	2	0	0
8	17152057	.	C	A	4	2	6	0	0	6	0	0
8	17154110	.	C	T	6	2	8	0	0	8	0	0
8	17154128	.	A	G	8	0	8	0	3	11	0	0
8	17154188	.	C	T	2	1	3	0	0	3	0	0
8	17156641	.	A	G	3	5	8	0	0	8	0	0
8	17156806	.	A	G	4	5	9	0	0	9	0	0
8	17156869	.	C	T	5	7	12	0	0	12	0	0
8	17156950	.	T	A	2	4	6	0	0	6	0	0
8	17163766	.	T	A	12	7	19	0	0	19	0	0
8	17163771	.	A	G	11	7	18	0	1	19	0	0
8	17163856	.	T	G	4	6	10	0	0	10	0	0
8	17192129	.	A	G	4	4	8	0	0	8	0	0
8	17396056	.	G	T	5	13	18	0	4	22	0	0
8	17396303	.	G	A	17	13	30	0	0	30	0	0
8	17396447	.	A	C	5	4	9	0	0	9	0	0
8	17396657	.	C	G	0	6	6	0	10	16	0	0
8	17396813	.	T	A	8	2	10	0	1	11	0	0
8	17396904	.	T	C	14	0	14	0	10	24	0	0
8	17397095	.	C	T	5	3	8	0	1	9	0	0
8	17397807	.	C	A	6	3	9	0	0	9	0	0
8	17398070	.	T	C	8	9	17	0	0	17	0	0
8	17398229	.	A	T	5	9	14	0	2	16	0	0
8	17398775	.	G	A	15	13	28	0	0	28	0	0
8	17399281	.	A	T	6	6	12	0	0	12	0	0
8	17399586	.	T	A	16	11	27	0	1	28	0	0
8	17399609	.	C	T	13	12	25	0	2	27	0	0
8	17404605	.	C	A	0	5	5	0	4	9	0	0
8	17407150	.	G	A	6	8	14	0	0	14	0	0
8	17407210	.	C	G	0	5	5	0	6	11	0	0
8	17407258	.	T	C	11	0	11	0	7	18	0	0
8	17515848	.	G	A	7	4	11	0	0	11	0	0
8	17516304	.	C	T	0	7	7	0	4	11	0	0
8	17534956	.	C	T	1	3	4	0	0	4	0	0
8	17534958	.	C	T	1	3	4	0	0	4	0	0
8	17563237	.	A	G	1	1	2	0	0	2	0	0
8	17583923	.	T	G	3	2	5	0	0	5	0	0
8	17775655	.	A	C	2	4	6	0	0	6	0	0
8	17775692	.	C	G	2	2	4	0	0	4	0	0
8	17775697	.	A	T	2	2	4	0	0	4	0	0
8	17775728	.	A	G	1	0	1	0	6	7	0	0
8	17778843	.	G	C	5	4	9	0	1	10	0	0
8	17778864	.	C	T	2	2	4	0	0	4	0	0
8	17781165	.	A	G	7	5	12	0	1	13	0	0
8	17781416	.	A	T	1	1	2	0	0	2	0	0
8	17781468	.	C	G	4	5	9	0	0	9	0	0
8	17781555	.	C	T	4	5	9	0	0	9	0	0
8	17783508	.	A	C	1	2	3	0	0	3	0	0
8	17783735	.	G	A	4	7	11	0	1	12	0	0
8	17784322	.	T	A	7	6	13	0	1	14	0	0
8	17784426	.	T	G	0	6	6	0	0	6	0	0
8	17784517	.	T	C	1	2	3	0	1	4	0	0
8	17784521	.	G	A	1	3	4	0	0	4	0	0
8	17787660	.	G	A	4	2	6	0	0	6	0	0
8	17788049	.	C	T	0	1	1	0	1	2	0	0
8	17790323	.	C	T	5	3	8	0	0	8	0	0
8	17800823	.	A	T	2	2	4	0	0	4	0	0
8	17801028	.	G	A	3	4	7	0	0	7	0	0
8	17801061	.	T	C	1	2	3	0	0	3	0	0
8	17801438	.	A	G	2	2	4	0	0	4	0	0
8	17808331	.	A	G	2	4	6	0	1	7	0	0
8	17820727	.	C	T	0	3	3	0	0	3	0	0
8	17820740	.	G	A	2	3	5	0	0	5	0	0
8	17820773	.	T	C	2	2	4	0	0	4	0	0
8	17822181	.	G	A	4	3	7	0	0	7	0	0
8	17895075	.	G	A	0	3	3	0	1	4	0	0
8	17905324	.	A	C	3	1	4	0	0	4	0	0
8	17906164	.	C	T	1	3	4	0	0	4	0	0
8	17911215	.	C	T	0	3	3	0	0	3	0	0
8	17983718	.	G	C	4	2	6	0	0	6	0	0
8	17983788	.	C	A	5	4	9	0	0	9	0	0
8	17983867	.	A	C	1	0	1	0	4	5	0	0
8	17984424	.	C	T	2	2	4	0	0	4	0	0
8	17984835	.	T	C	2	0	2	0	2	4	0	0
8	18024959	.	C	T	1	2	3	0	0	3	0	0
8	18026052	.	G	A	0	1	1	0	0	1	0	0
8	18030857	.	C	T	5	2	7	0	2	9	0	0
8	18030884	.	G	A	1	2	3	0	0	3	0	0
8	18035231	.	T	A	16	15	31	0	0	31	0	0
8	18035290	.	T	C	14	8	22	0	4	26	0	0
8	18035303	.	T	A	12	7	19	0	7	26	0	0
8	18035371	.	T	C	11	18	29	0	0	29	0	0
8	18035786	.	C	T	11	14	25	0	1	26	0	0
8	18035963	.	T	C	8	13	21	0	2	23	0	0
8	18036167	.	T	C	12	4	16	0	3	19	0	0
8	18040581	.	G	A	0	4	4	0	0	4	0	0
8	18041814	.	G	A	1	5	6	0	0	6	0	0
8	18193420	.	C	G	11	5	16	0	2	18	0	0
8	18193503	.	G	T	7	5	12	0	0	12	0	0
8	18193591	.	A	T	15	7	22	0	1	23	0	0
8	18193628	.	T	C	20	13	33	0	2	35	0	0
8	18193707	.	T	C	19	14	33	0	1	34	0	0
8	18194238	.	T	C	23	19	42	0	0	42	0	0
8	18194283	.	G	A	11	7	18	0	0	18	0	0
8	18196444	.	C	T	1	12	13	0	22	35	0	0
8	18196462	.	A	G	27	16	43	0	0	43	0	0
8	18198801	.	C	T	7	9	16	0	0	16	0	0
8	18207056	.	T	G	1	2	3	0	0	3	0	0
8	18215786	.	A	G	2	2	4	0	0	4	0	0
8	18243119	.	C	T	1	2	3	0	0	3	0	0
8	18243671	.	G	T	1	4	5	0	0	5	0	0
8	18244838	.	G	A	1	2	3	0	0	3	0	0
8	18314002	.	G	T	2	2	4	0	0	4	0	0
8	18356524	.	G	A	10	20	30	0	0	30	0	0
8	18356688	.	G	A	16	12	28	0	1	29	0	0
8	18358709	.	T	C	5	2	7	0	1	8	0	0
8	18358760	.	C	A	5	6	11	0	0	11	0	0
8	18361223	.	G	A	8	5	13	0	1	14	0	0
8	18365134	.	G	A	2	3	5	0	0	5	0	0
8	18506299	.	C	T	0	3	3	0	2	5	0	0
8	18510560	.	A	G	2	0	2	0	0	2	0	0
8	18512273	.	T	C	1	0	1	0	0	1	0	0
8	18514466	.	C	T	0	2	2	0	0	2	0	0
8	18514476	.	A	G	0	2	2	0	0	2	0	0
8	18514855	.	A	T	3	5	8	0	0	8	0	0
8	18515137	.	G	A	5	2	7	0	0	7	0	0
8	18515138	.	G	A	4	2	6	0	0	7	1	0
8	18515751	.	C	A	0	0	0	0	2	2	0	0
8	18516279	.	A	T	3	3	6	0	1	7	0	0
8	18519585	.	G	T	1	2	3	0	0	3	0	0
8	18519593	.	T	C	1	2	3	0	0	3	0	0
8	18545641	.	A	T	5	4	9	0	0	9	0	0
8	18554651	.	T	C	3	6	9	0	0	9	0	0
8	18554731	.	T	A	7	10	17	0	1	18	0	0
8	18554826	.	G	A	9	7	16	0	0	16	0	0
8	18555104	.	A	G	9	0	9	0	14	23	0	0
8	18562225	.	C	A	24	13	37	0	0	37	0	0
8	18562570	.	C	T	11	9	20	0	1	21	0	0
8	18566278	.	G	A	7	7	14	0	0	14	0	0
8	18566327	.	C	A	9	11	20	0	1	21	0	0
8	18566419	.	T	A	9	9	18	0	0	18	0	0
8	18566466	.	A	T	8	14	22	0	1	23	0	0
8	18566615	.	T	G	8	16	24	0	1	25	0	0
8	18566669	.	C	T	11	18	29	0	0	29	0	0
8	18566687	.	T	C	12	15	27	0	1	28	0	0
8	18567020	.	G	A	16	15	31	0	1	32	0	0
8	18567230	.	G	A	8	6	14	0	8	22	0	0
8	18567266	.	C	T	0	5	5	0	12	17	0	0
8	18567291	.	A	C	7	7	14	0	2	16	0	0
8	18567342	.	G	A	11	11	22	0	3	25	0	0
8	18567453	.	A	G	18	15	33	0	0	33	0	0
8	18567559	.	C	T	10	3	13	0	1	14	0	0
8	18567577	.	G	T	17	6	23	0	1	24	0	0
8	18568022	.	G	C	12	9	21	0	0	21	0	0
8	18568121	.	C	T	8	15	23	0	0	23	0	0
8	18568741	.	G	T	16	6	22	0	0	22	0	0
8	18569126	.	T	C	8	8	16	0	0	16	0	0
8	18569129	.	A	G	8	8	16	0	0	16	0	0
8	18569221	.	C	A	10	5	15	0	0	15	0	0
8	18569316	.	T	G	6	6	12	0	0	12	0	0
8	18569767	.	A	T	7	4	11	0	0	11	0	0
8	18569795	.	T	A	7	8	15	0	1	16	0	0
8	18570117	.	C	G	0	9	9	0	3	12	0	0
8	18570190	.	G	C	2	7	9	0	1	10	0	0
8	18570201	.	C	T	3	10	13	0	1	14	0	0
8	18570239	.	A	G	5	9	14	0	2	16	0	0
8	18582626	.	G	A	7	6	13	0	0	13	0	0
8	18582710	.	C	A	8	3	11	0	1	12	0	0
8	18582789	.	C	G	5	7	12	0	1	13	0	0
8	18582857	.	T	C	9	9	18	0	0	18	0	0
8	18592966	.	C	T	1	3	4	0	0	4	0	0
8	18592973	.	C	T	2	3	5	0	0	5	0	0
8	18593465	.	C	T	4	2	6	0	0	6	0	0
8	18598306	.	C	T	6	9	15	0	0	16	1	0
8	18598333	.	A	T	5	9	14	0	1	15	0	0
8	18598351	.	A	T	6	9	15	0	0	15	0	0
8	18598590	.	T	G	6	3	9	0	9	18	0	0
8	18598628	.	A	T	6	4	10	0	3	14	1	0
8	18598782	.	T	C	7	14	21	0	1	22	0	0
8	18598997	.	G	T	6	15	21	0	2	23	0	0
8	18599235	.	G	A	7	5	12	0	0	12	0	0
8	18601873	.	T	C	1	0	1	0	4	5	0	0
8	18609265	.	A	T	5	3	8	0	0	8	0	0
8	18609272	.	C	A	5	4	9	0	0	9	0	0
8	18609308	.	C	T	4	5	9	0	0	9	0	0
8	18611048	.	G	A	8	8	16	0	0	16	0	0
8	18613763	.	C	T	2	4	6	0	0	6	0	0
8	18613770	.	A	C	2	4	6	0	0	6	0	0
8	18613889	.	G	A	1	2	3	0	0	3	0	0
8	18622922	.	G	A	1	2	3	0	0	3	0	0
8	18641712	.	T	C	3	3	6	0	0	6	0	0
8	18836881	.	T	C	1	2	3	0	0	3	0	0
8	18837255	.	C	A	1	1	2	0	0	2	0	0
8	18837864	.	C	T	4	0	4	0	1	5	0	0
8	18840330	.	C	T	9	5	14	0	0	14	0	0
8	18842364	.	A	G	1	4	5	0	0	5	0	0
8	18842586	.	T	C	2	2	4	0	0	4	0	0
8	18842587	.	A	T	2	2	4	0	0	4	0	0
8	18890966	.	A	G	7	3	10	0	0	10	0	0
8	18891001	.	G	A	8	4	12	0	0	12	0	0
8	18891033	.	T	A	9	5	14	0	0	14	0	0
8	18936739	.	C	T	0	3	3	0	5	8	0	0
8	19232588	.	C	A	0	3	3	0	0	3	0	0
8	19284169	.	A	G	3	2	5	0	0	5	0	0
8	19285261	.	A	G	5	2	7	0	1	8	0	0
8	19401508	.	C	T	3	12	15	0	28	43	0	0
8	19402136	.	G	T	9	7	16	0	1	17	0	0
8	19402363	.	A	G	14	15	29	0	2	31	0	0
8	19402374	.	C	T	0	17	17	0	17	34	0	0
8	19472131	.	C	G	11	5	16	0	0	16	0	0
8	19474072	.	T	C	3	0	3	0	5	8	0	0
8	19476600	.	A	G	4	2	6	0	0	6	0	0
8	19476613	.	C	T	4	3	7	0	0	7	0	0
8	19477928	.	A	G	8	5	13	0	0	13	0	0
8	19478140	.	C	T	1	2	3	0	0	3	0	0
8	19479784	.	A	G	1	0	1	0	0	1	0	0
8	19483818	.	G	A	6	5	11	0	0	11	0	0
8	19499851	.	C	G	5	2	7	0	0	7	0	0
8	19499867	.	T	C	6	2	8	0	0	8	0	0
8	19504059	.	A	G	7	6	13	0	0	13	0	0
8	19504081	.	T	A	10	8	18	0	0	18	0	0
8	19504144	.	A	G	15	13	28	0	1	29	0	0
8	19508927	.	A	G	6	11	17	0	1	18	0	0
8	19508961	.	C	A	10	13	23	0	0	23	0	0
8	19511673	.	C	G	6	11	17	0	3	20	0	0
8	19511674	.	C	A	6	10	16	0	4	20	0	0
8	19511770	.	A	C	10	17	27	0	0	28	1	0
8	19511901	.	G	A	15	13	28	0	1	29	0	0
8	19511902	.	T	A	15	14	29	0	0	29	0	0
8	19998254	.	G	T	0	2	2	0	3	5	0	0
8	20194801	.	T	C	6	0	6	0	6	12	0	0
8	20194817	.	T	C	5	0	5	0	4	9	0	0
8	20440330	.	C	A	5	5	10	0	0	10	0	0
8	20440699	.	G	A	1	2	3	0	0	3	0	0
8	20443562	.	C	T	1	0	1	0	0	1	0	0
8	20448181	.	G	A	7	7	14	0	1	15	0	0
8	20449016	.	G	A	0	4	4	0	10	14	0	0
8	20449478	.	G	A	0	9	9	0	9	18	0	0
8	20449590	.	G	A	5	10	15	0	2	17	0	0
8	20449614	.	A	G	6	12	18	0	0	18	0	0
8	20449847	.	A	G	3	7	10	0	0	10	0	0
8	20449851	.	T	A	4	7	11	0	0	11	0	0
8	20450168	.	C	T	15	13	28	0	0	28	0	0
8	20450249	.	T	A	15	12	27	0	1	28	0	0
8	20450289	.	G	A	12	6	18	0	1	19	0	0
8	20457791	.	G	A	0	3	3	0	3	6	0	0
8	20457933	.	G	A	4	3	7	0	0	7	0	0
8	20460509	.	A	G	2	0	2	0	3	5	0	0
8	20460633	.	C	A	1	1	2	0	0	2	0	0
8	20471248	.	C	T	3	6	9	0	0	9	0	0
8	20471387	.	G	A	2	2	4	0	1	5	0	0
8	20471391	.	C	T	2	3	5	0	1	6	0	0
8	20471508	.	T	A	2	3	5	0	0	5	0	0
8	20490514	.	A	C	1	1	2	0	0	2	0	0
8	20503515	.	C	T	2	9	11	0	0	11	0	0
8	20503697	.	A	G	7	6	13	0	0	13	0	0
8	20503829	.	C	T	3	7	10	0	3	13	0	0
8	20503838	.	G	A	3	5	8	0	3	11	0	0
8	20546122	.	T	C	8	13	21	0	1	22	0	0
8	20546182	.	T	C	9	12	21	0	0	21	0	0
8	20559103	.	T	C	7	17	24	0	1	25	0	0
8	20559169	.	A	G	7	0	7	0	23	30	0	0
8	20559202	.	A	G	17	0	17	0	19	36	0	0
8	20559211	.	T	A	18	18	36	0	2	38	0	0
8	20559241	.	G	A	20	16	36	0	3	39	0	0
8	20559270	.	A	G	14	22	36	0	1	37	0	0
8	20559373	.	G	A	12	15	27	0	0	27	0	0
8	20559682	.	G	A	13	16	29	0	4	33	0	0
8	20559683	.	A	G	10	19	29	0	4	33	0	0
8	20580314	.	T	C	0	3	3	0	0	3	0	0
8	20679899	.	A	T	1	3	4	0	0	4	0	0
8	20679941	.	A	G	2	1	3	0	1	4	0	0
8	20782390	.	G	T	0	1	1	0	2	3	0	0
8	20846257	.	T	A	4	3	7	0	0	7	0	0
8	20846303	.	G	T	4	3	7	0	0	7	0	0
8	20848614	.	C	T	1	0	1	0	0	1	0	0
8	20850311	.	T	A	2	3	5	0	0	5	0	0
8	20853335	.	A	T	12	15	27	0	1	28	0	0
8	20853987	.	C	G	0	1	1	0	0	1	0	0
8	20856643	.	G	A	0	4	4	0	0	4	0	0
8	20865557	.	A	T	3	3	6	0	1	7	0	0
8	20868167	.	T	A	7	8	15	0	2	17	0	0
8	20868191	.	G	A	6	2	8	0	0	8	0	0
8	20868209	.	G	A	4	0	4	0	0	4	0	0
8	20870301	.	G	A	0	1	1	0	0	1	0	0
8	20870439	.	A	T	5	5	10	0	0	10	0	0
8	20872987	.	G	T	0	2	2	0	0	2	0	0
8	20873011	.	G	A	0	6	6	0	6	12	0	0
8	20873113	.	C	T	15	10	25	0	1	26	0	0
8	20873183	.	C	T	5	4	9	0	0	9	0	0
8	20876466	.	C	T	6	5	11	0	2	13	0	0
8	21047673	.	G	T	3	2	5	0	1	6	0	0
8	21047698	.	C	G	2	4	6	0	1	7	0	0
8	21047824	.	C	A	6	7	13	0	0	13	0	0
8	21050477	.	C	A	0	1	1	0	3	4	0	0
8	21050616	.	T	A	3	0	3	0	0	3	0	0
8	21052672	.	G	A	3	3	6	0	0	6	0	0
8	21052694	.	A	G	3	3	6	0	0	6	0	0
8	21053030	.	G	A	6	12	18	0	1	19	0	0
8	21053084	.	A	T	9	6	15	0	0	15	0	0
8	21053122	.	G	A	6	10	16	0	0	16	0	0
8	21053345	.	T	C	2	0	2	0	10	12	0	0
8	21053371	.	G	A	3	9	12	0	0	12	0	0
8	21053404	.	T	C	1	5	6	0	0	6	0	0
8	21053744	.	G	A	1	1	2	0	0	2	0	0
8	21053754	.	A	G	1	1	2	0	0	2	0	0
8	21068849	.	C	T	1	1	2	0	0	2	0	0
8	21068865	.	C	T	0	1	1	0	1	2	0	0
8	21071724	.	C	T	2	1	3	0	0	3	0	0
8	21089923	.	A	T	1	3	4	0	0	4	0	0
8	21095288	.	G	A	11	5	16	0	0	16	0	0
8	21095439	.	G	C	8	5	13	0	0	13	0	0
8	21095504	.	A	C	7	5	12	0	1	13	0	0
8	21095506	.	G	A	7	6	13	0	0	13	0	0
8	21100278	.	T	A	1	2	3	0	0	3	0	0
8	21100290	.	G	A	1	2	3	0	0	3	0	0
8	21104767	.	A	G	1	4	5	0	0	5	0	0
8	21104837	.	G	A	7	6	13	0	0	13	0	0
8	21104853	.	G	T	6	7	13	0	0	13	0	0
8	21105045	.	G	A	4	6	10	0	0	10	0	0
8	21105504	.	G	A	4	10	14	0	1	15	0	0
8	21110074	.	A	G	3	3	6	0	0	6	0	0
8	21114444	.	C	T	9	3	12	0	0	12	0	0
8	21123607	.	T	C	6	3	9	0	0	9	0	0
8	21130028	.	A	G	9	9	18	0	0	18	0	0
8	21130158	.	G	A	3	11	14	0	0	14	0	0
8	21130373	.	G	C	1	3	4	0	0	4	0	0
8	21130746	.	T	C	5	3	8	0	0	8	0	0
8	21131089	.	A	T	13	4	17	0	0	17	0	0
8	21131532	.	T	C	5	3	8	0	0	8	0	0
8	21131926	.	A	G	5	7	12	0	0	12	0	0
8	21132039	.	A	T	5	4	9	0	0	9	0	0
8	21132190	.	A	G	3	7	10	0	1	11	0	0
8	21132445	.	A	C	7	13	20	0	0	20	0	0
8	21132599	.	G	A	0	10	10	0	12	22	0	0
8	21132648	.	T	C	17	9	26	0	0	26	0	0
8	21132947	.	G	T	0	5	5	0	13	18	0	0
8	21132979	.	T	A	4	5	9	0	0	9	0	0
8	21133043	.	C	T	7	4	11	0	0	11	0	0
8	21133060	.	G	A	5	4	9	0	0	9	0	0
8	21134536	.	T	C	4	6	10	0	0	10	0	0
8	21137675	.	G	A	2	5	7	0	0	7	0	0
8	21139950	.	C	A	0	3	3	0	12	15	0	0
8	21139989	.	G	A	2	13	15	0	0	15	0	0
8	21140286	.	C	T	0	6	6	0	4	10	0	0
8	21140369	.	A	G	9	3	12	0	1	13	0	0
8	21140433	.	G	A	4	3	7	0	0	7	0	0
8	21140589	.	A	C	6	2	8	0	0	8	0	0
8	21140607	.	C	A	5	4	9	0	0	9	0	0
8	21140910	.	C	T	1	4	5	0	4	9	0	0
8	21140913	.	T	G	4	6	10	0	0	10	0	0
8	21141072	.	A	G	3	2	5	0	0	5	0	0
8	21141088	.	G	A	2	2	4	0	0	4	0	0
8	21141329	.	G	C	3	0	3	0	1	4	0	0
8	21141330	.	A	G	3	1	4	0	0	4	0	0
8	21146302	.	G	T	1	1	2	0	0	2	0	0
8	21146840	.	T	G	4	5	9	0	1	10	0	0
8	21148814	.	G	A	4	5	9	0	0	9	0	0
8	21151760	.	C	T	1	0	1	0	0	1	0	0
8	21152728	.	C	G	4	2	6	0	0	6	0	0
8	21152737	.	C	A	4	2	6	0	0	6	0	0
8	21153088	.	G	T	0	2	2	0	0	2	0	0
8	21155864	.	A	G	1	3	4	0	0	4	0	0
8	21155871	.	T	C	1	5	6	0	0	6	0	0
8	21155937	.	T	G	7	6	13	0	1	14	0	0
8	21162056	.	C	T	8	7	15	0	1	16	0	0
8	21162161	.	C	T	7	9	16	0	1	17	0	0
8	21162209	.	T	C	8	5	13	0	3	16	0	0
8	21162278	.	G	A	1	11	12	0	6	18	0	0
8	21162284	.	A	G	8	0	8	0	9	17	0	0
8	21162318	.	T	C	9	17	26	0	0	26	0	0
8	21218169	.	G	A	1	2	3	0	0	3	0	0
8	21225077	.	A	C	1	2	3	0	0	3	0	0
8	21225163	.	G	A	1	11	12	0	16	28	0	0
8	21225172	.	A	G	9	13	22	0	3	25	0	0
8	21241111	.	T	G	7	0	7	0	10	17	0	0
8	21241122	.	T	C	7	7	14	0	1	15	0	0
8	21245422	.	T	C	2	2	4	0	0	4	0	0
8	21245803	.	C	T	6	8	14	0	0	14	0	0
8	21247280	.	G	A	6	5	11	0	1	12	0	0
8	21248852	.	C	A	5	7	12	0	0	12	0	0
8	21248879	.	G	A	3	2	5	0	0	5	0	0
8	21250132	.	T	A	22	20	42	0	0	42	0	0
8	21250183	.	T	A	8	13	21	0	0	21	0	0
8	21250694	.	A	G	12	1	13	0	22	35	0	0
8	21251179	.	T	C	25	28	53	0	0	53	0	0
8	21251456	.	T	G	24	14	38	0	2	40	0	0
8	21251569	.	G	C	25	17	42	0	2	44	0	0
8	21251732	.	C	T	12	17	29	0	2	31	0	0
8	21251775	.	T	C	15	13	28	0	0	28	0	0
8	21252042	.	G	T	10	16	26	0	0	26	0	0
8	21252125	.	A	T	26	21	47	0	0	47	0	0
8	21252155	.	T	C	23	30	53	0	1	54	0	0
8	21252163	.	A	G	25	31	56	0	0	56	0	0
8	21252215	.	A	T	16	28	44	0	0	44	0	0
8	21252237	.	T	C	19	26	45	0	2	47	0	0
8	21252472	.	C	G	19	13	32	0	0	32	0	0
8	21265272	.	G	A	1	3	4	0	0	4	0	0
8	21265488	.	C	G	1	2	3	0	0	3	0	0
8	21265965	.	G	A	2	2	4	0	0	4	0	0
8	21265991	.	A	G	1	2	3	0	0	3	0	0
8	21352639	.	T	C	1	3	4	0	0	4	0	0
8	21352643	.	T	A	1	3	4	0	0	4	0	0
8	21588321	.	C	T	4	2	6	0	0	6	0	0
8	21588443	.	G	T	0	12	12	0	4	16	0	0
8	21672605	.	A	G	6	9	15	0	1	16	0	0
8	21673091	.	T	C	7	5	12	0	0	12	0	0
8	21673248	.	A	T	10	8	18	0	0	18	0	0
8	21673516	.	G	A	0	13	13	0	5	18	0	0
8	21673666	.	G	A	7	3	10	0	0	10	0	0
8	21673789	.	T	G	4	1	5	0	12	17	0	0
8	21673813	.	C	T	11	5	16	0	0	16	0	0
8	21674359	.	A	T	2	5	7	0	0	7	0	0
8	21674449	.	T	A	2	4	6	0	1	7	0	0
8	21674795	.	A	C	6	8	14	0	2	16	0	0
8	21674815	.	A	T	6	12	18	0	0	18	0	0
8	21675004	.	G	A	10	9	19	0	0	19	0	0
8	21675008	.	A	G	9	9	18	0	1	19	0	0
8	21675043	.	G	C	5	4	9	0	0	9	0	0
8	21675057	.	T	A	6	8	14	0	0	14	0	0
8	21675200	.	A	G	6	4	10	0	0	10	0	0
8	21675551	.	A	G	6	15	21	0	2	23	0	0
8	21675575	.	T	C	16	9	25	0	0	25	0	0
8	21675608	.	G	C	9	9	18	0	2	20	0	0
8	21675695	.	G	T	0	9	9	0	8	17	0	0
8	21675698	.	G	A	0	9	9	0	8	17	0	0
8	21675745	.	G	A	6	7	13	0	0	13	0	0
8	21675755	.	A	G	5	5	10	0	0	10	0	0
8	21675787	.	T	A	6	4	10	0	1	11	0	0
8	21675882	.	A	G	1	6	7	0	0	7	0	0
8	21982767	.	C	T	0	0	0	0	1	1	0	0
8	21986654	.	G	A	2	3	5	0	0	5	0	0
8	22030456	.	G	T	2	2	4	0	0	4	0	0
8	22277560	.	A	T	1	0	1	0	0	1	0	0
8	22279922	.	C	A	1	2	3	0	0	3	0	0
8	22283782	.	G	A	2	5	7	0	0	7	0	0
8	22284029	.	T	A	1	2	3	0	0	3	0	0
8	22284192	.	G	T	3	5	8	0	0	8	0	0
8	22284206	.	G	T	3	5	8	0	1	9	0	0
8	22284262	.	C	T	3	4	7	0	0	7	0	0
8	22284266	.	C	T	4	3	7	0	0	7	0	0
8	22284306	.	C	T	5	5	10	0	0	10	0	0
8	22284316	.	C	T	4	5	9	0	2	11	0	0
8	22284379	.	T	G	4	7	11	0	0	11	0	0
8	22284425	.	G	A	7	4	11	0	0	11	0	0
8	22284509	.	T	C	5	12	17	0	0	17	0	0
8	22284570	.	T	G	5	9	14	0	1	15	0	0
8	22287163	.	A	G	4	2	6	0	1	7	0	0
8	22298241	.	A	C	2	1	3	0	0	3	0	0
8	22298242	.	G	T	1	1	2	0	1	3	0	0
8	22301156	.	T	C	4	6	10	0	0	10	0	0
8	22303820	.	G	A	8	4	12	0	0	12	0	0
8	22307003	.	C	T	1	1	2	0	0	2	0	0
8	22317583	.	C	A	2	3	5	0	1	6	0	0
8	22319260	.	A	C	2	1	3	0	3	6	0	0
8	22319303	.	A	G	2	3	5	0	0	5	0	0
8	22320748	.	A	G	1	0	1	0	0	1	0	0
8	22320850	.	C	T	1	3	4	0	0	4	0	0
8	22324866	.	A	G	0	1	1	0	0	1	0	0
8	22324992	.	G	A	1	1	2	0	0	2	0	0
8	22327353	.	G	A	5	3	8	0	0	8	0	0
8	22329411	.	C	A	6	5	11	0	1	12	0	0
8	22329434	.	A	G	5	7	12	0	0	12	0	0
8	22329678	.	T	C	5	2	7	0	0	7	0	0
8	22335414	.	A	G	0	4	4	0	0	4	0	0
8	22335420	.	T	C	0	4	4	0	0	4	0	0
8	22337301	.	T	C	1	1	2	0	0	2	0	0
8	22337337	.	G	A	0	2	2	0	2	4	0	0
8	22337436	.	T	C	8	5	13	0	0	13	0	0
8	22337575	.	A	G	2	3	5	0	0	5	0	0
8	22337674	.	A	T	2	4	6	0	0	6	0	0
8	22345517	.	G	A	0	4	4	0	5	9	0	0
8	22345520	.	G	A	5	4	9	0	0	9	0	0
8	22346502	.	C	T	4	2	6	0	0	6	0	0
8	22394324	.	C	A	10	11	21	0	0	21	0	0
8	22394626	.	T	C	10	4	14	0	2	16	0	0
8	22500293	.	C	T	4	6	10	0	1	11	0	0
8	22500307	.	A	C	8	0	8	0	5	13	0	0
8	22500406	.	A	T	6	8	14	0	0	14	0	0
8	22500543	.	T	C	7	0	7	0	8	15	0	0
8	22500739	.	G	A	2	0	2	0	0	2	0	0
8	22502731	.	C	T	4	2	6	0	0	6	0	0
8	22503494	.	G	T	4	6	10	0	2	12	0	0
8	22503535	.	C	T	3	5	8	0	1	9	0	0
8	22503539	.	A	G	4	4	8	0	1	9	0	0
8	22503748	.	C	T	10	3	13	0	0	13	0	0
8	22504424	.	T	A	5	5	10	0	2	12	0	0
8	22504463	.	T	A	4	3	7	0	0	7	0	0
8	22511092	.	A	C	2	3	5	0	0	5	0	0
8	22511123	.	A	G	1	4	5	0	0	5	0	0
8	22511387	.	G	A	6	2	8	0	0	8	0	0
8	22511518	.	C	T	0	3	3	0	4	7	0	0
8	22511654	.	C	T	0	4	4	0	3	7	0	0
8	22511817	.	G	A	4	2	6	0	1	7	0	0
8	22511936	.	G	A	5	2	7	0	0	7	0	0
8	22512881	.	G	A	1	1	2	0	0	2	0	0
8	22522035	.	G	A	18	22	40	0	10	50	0	0
8	22522385	.	T	C	7	0	7	0	12	19	0	0
8	22522688	.	G	A	19	11	30	0	2	32	0	0
8	22522699	.	C	G	0	7	7	0	18	27	2	0
8	22522744	.	A	G	14	16	30	0	0	30	0	0
8	22522913	.	T	A	22	19	41	0	1	42	0	0
8	22523010	.	A	T	17	18	35	0	0	35	0	0
8	22524820	.	C	T	9	7	16	0	2	18	0	0
8	22525228	.	G	A	9	9	18	0	1	19	0	0
8	22525336	.	G	A	8	10	18	0	1	19	0	0
8	22525773	.	C	T	0	5	5	0	14	19	0	0
8	22525978	.	C	T	12	17	29	0	1	30	0	0
8	22526355	.	T	G	6	4	10	0	0	10	0	0
8	22530480	.	G	A	3	11	14	0	0	14	0	0
8	22530633	.	A	G	2	3	5	0	0	5	0	0
8	22531978	.	G	A	3	2	5	0	0	5	0	0
8	22533535	.	C	T	6	8	14	0	1	15	0	0
8	22536031	.	C	T	3	4	7	0	0	7	0	0
8	22544636	.	G	A	3	5	8	0	0	8	0	0
8	22603951	.	C	T	2	2	4	0	0	4	0	0
8	22604170	.	A	T	2	1	3	0	0	3	0	0
8	22604181	.	T	C	2	1	3	0	0	3	0	0
8	22607125	.	T	C	2	1	3	0	0	3	0	0
8	22608378	.	C	T	4	1	5	0	0	5	0	0
8	22611837	.	C	T	6	5	11	0	0	11	0	0
8	22612158	.	A	C	8	10	18	0	0	18	0	0
8	22612227	.	A	T	6	10	16	0	0	16	0	0
8	22612328	.	A	G	6	5	11	0	1	12	0	0
8	22612329	.	C	T	7	5	12	0	0	12	0	0
8	22612638	.	T	C	7	3	10	0	0	10	0	0
8	22612917	.	T	G	4	5	9	0	0	9	0	0
8	22612950	.	C	T	4	6	10	0	1	11	0	0
8	22613136	.	C	T	6	5	11	0	0	11	0	0
8	22613346	.	G	T	5	6	11	0	0	11	0	0
8	22613493	.	G	A	2	5	7	0	0	7	0	0
8	22613553	.	A	G	4	5	9	0	2	11	0	0
8	22618864	.	A	G	24	9	33	0	8	42	1	0
8	22619110	.	G	A	19	21	40	0	1	41	0	0
8	22619212	.	T	A	16	24	40	0	3	43	0	0
8	22619443	.	G	A	20	20	40	0	5	45	0	0
8	22619669	.	G	A	4	12	16	0	8	24	0	0
8	22622632	.	G	C	7	4	11	0	0	11	0	0
8	22622674	.	A	T	9	11	20	0	1	21	0	0
8	22622712	.	C	T	0	13	13	0	5	18	0	0
8	22622733	.	A	T	1	9	10	0	0	10	0	0
8	22624324	.	C	A	0	7	7	0	5	12	0	0
8	22627917	.	A	C	4	5	9	0	1	10	0	0
8	22630366	.	A	G	8	7	15	0	0	15	0	0
8	22631760	.	T	A	10	10	20	0	3	23	0	0
8	22631865	.	A	G	11	13	24	0	1	25	0	0
8	22631898	.	C	A	0	14	14	0	16	30	0	0
8	22632185	.	G	A	16	16	32	0	1	33	0	0
8	22632213	.	A	G	13	17	30	0	2	32	0	0
8	22632249	.	A	G	11	17	28	0	1	29	0	0
8	22632687	.	T	A	2	1	3	0	0	3	0	0
8	22635426	.	T	C	7	0	7	0	3	10	0	0
8	22637699	.	T	G	5	10	15	0	0	15	0	0
8	22762019	.	G	A	5	2	7	0	0	7	0	0
8	22762173	.	C	T	2	5	7	0	0	7	0	0
8	22762194	.	A	C	2	5	7	0	0	7	0	0
8	22762508	.	A	T	3	5	8	0	0	8	0	0
8	22766529	.	A	C	6	4	10	0	1	11	0	0
8	22787579	.	T	A	1	5	6	0	0	6	0	0
8	22788116	.	G	A	1	5	6	0	0	6	0	0
8	22788511	.	A	G	7	3	10	0	0	10	0	0
8	22788583	.	T	G	1	0	1	0	0	1	0	0
8	22788956	.	A	G	5	3	8	0	0	8	0	0
8	22891257	.	T	C	2	1	3	0	0	3	0	0
8	22902703	.	C	T	0	2	2	0	0	2	0	0
8	22910066	.	C	T	2	0	2	0	0	2	0	0
8	22910089	.	A	C	1	0	1	0	0	1	0	0
8	22926072	.	A	G	3	0	3	0	2	5	0	0
8	22926934	.	T	C	6	4	10	0	0	10	0	0
8	22945179	.	G	T	7	8	15	0	0	15	0	0
8	22945605	.	T	C	23	31	54	0	2	56	0	0
8	22946780	.	T	C	30	15	45	0	3	48	0	0
8	22946987	.	G	C	6	6	12	0	0	13	1	0
8	22951203	.	A	T	30	31	61	0	3	64	0	0
8	22951406	.	T	A	17	23	40	0	6	46	0	0
8	22951691	.	A	T	26	23	49	0	0	49	0	0
8	22951730	.	G	A	28	23	51	0	2	53	0	0
8	22951880	.	A	G	32	29	61	0	1	62	0	0
8	22951979	.	T	G	42	20	62	0	1	64	1	0
8	22952243	.	T	A	42	27	69	0	1	70	0	0
8	22953314	.	C	T	2	4	6	0	1	7	0	0
8	23026459	.	T	A	1	1	2	0	0	2	0	0
8	23028175	.	A	T	3	2	5	0	0	5	0	0
8	23040887	.	A	G	14	13	27	0	0	27	0	0
8	23040913	.	G	C	10	11	21	0	1	22	0	0
8	23044374	.	C	G	0	10	10	0	14	24	0	0
8	23044478	.	G	T	19	6	25	0	0	25	0	0
8	23044554	.	T	C	11	0	11	0	8	19	0	0
8	23044620	.	G	A	10	9	19	0	1	20	0	0
8	23044752	.	A	G	14	7	21	0	0	21	0	0
8	23056164	.	T	A	5	1	6	0	5	11	0	0
8	23081314	.	T	C	9	0	9	0	3	12	0	0
8	23105304	.	T	A	6	7	13	0	1	14	0	0
8	23105429	.	A	G	9	11	20	0	1	21	0	0
8	23109308	.	C	T	7	12	19	0	1	20	0	0
8	23109554	.	C	A	14	16	30	0	0	30	0	0
8	23109803	.	A	C	4	3	7	0	3	10	0	0
8	23109890	.	T	C	8	12	20	0	3	23	0	0
8	23110301	.	T	A	13	13	26	0	1	27	0	0
8	23110475	.	A	G	9	14	23	0	0	23	0	0
8	23118396	.	A	G	8	7	15	0	2	17	0	0
8	23118830	.	T	C	14	10	24	0	0	24	0	0
8	23119100	.	T	A	8	8	16	0	1	17	0	0
8	23119524	.	C	A	17	14	31	0	4	35	0	0
8	23122210	.	T	G	5	6	11	0	1	12	0	0
8	23122265	.	T	C	1	4	5	0	0	5	0	0
8	23122348	.	A	G	8	14	22	0	0	22	0	0
8	23143137	.	G	A	0	4	4	0	0	4	0	0
8	23143144	.	G	A	0	4	4	0	0	4	0	0
8	23147528	.	C	T	2	2	4	0	0	4	0	0
8	23147536	.	G	A	3	2	5	0	0	5	0	0
8	23149815	.	C	G	5	3	8	0	0	8	0	0
8	23149956	.	G	A	0	10	10	0	6	16	0	0
8	23151375	.	C	T	5	9	14	0	3	17	0	0
8	23151697	.	C	T	5	3	8	0	0	8	0	0
8	23165835	.	G	T	0	20	20	0	6	26	0	0
8	23175234	.	C	T	7	12	19	0	0	19	0	0
8	23179659	.	G	T	18	23	41	0	0	41	0	0
8	23179702	.	T	G	14	21	35	0	4	39	0	0
8	23194322	.	A	T	7	14	21	0	2	23	0	0
8	23202757	.	C	T	0	1	1	0	0	1	0	0
8	23210432	.	C	T	3	6	9	0	0	9	0	0
8	23210441	.	T	C	7	8	15	0	0	15	0	0
8	23210492	.	T	C	14	6	20	0	0	20	0	0
8	23210579	.	G	A	9	12	21	0	0	21	0	0
8	23210652	.	G	A	11	9	20	0	0	20	0	0
8	23210832	.	A	T	7	7	14	0	0	14	0	0
8	23210857	.	A	G	7	7	14	0	0	14	0	0
8	23210944	.	T	C	13	4	17	0	0	17	0	0
8	23211047	.	A	C	8	2	10	0	0	10	0	0
8	23211054	.	C	T	7	2	9	0	0	9	0	0
8	23211109	.	G	T	12	7	19	0	1	20	0	0
8	23211120	.	C	T	12	7	19	0	1	20	0	0
8	23211233	.	G	T	15	11	26	0	0	26	0	0
8	23211402	.	T	C	12	10	22	0	1	23	0	0
8	23211424	.	C	A	9	5	14	0	1	15	0	0
8	23211446	.	A	C	10	5	15	0	0	15	0	0
8	23215631	.	C	T	7	5	12	0	1	13	0	0
8	23215643	.	C	T	9	6	15	0	1	16	0	0
8	23215762	.	T	C	12	13	25	0	1	26	0	0
8	23215926	.	G	A	4	1	5	0	0	5	0	0
8	23215927	.	G	A	3	1	4	0	1	5	0	0
8	23253118	.	T	C	1	8	9	0	0	9	0	0
8	23253656	.	C	T	0	2	2	0	1	3	0	0
8	23253720	.	G	A	1	5	6	0	0	6	0	0
8	23253843	.	A	G	4	3	7	0	0	7	0	0
8	23256509	.	A	G	3	5	8	0	0	8	0	0
8	23256521	.	A	G	3	4	7	0	0	7	0	0
8	23258522	.	T	C	1	0	1	0	2	3	0	0
8	23296377	.	A	G	1	2	3	0	0	3	0	0
8	23380249	.	C	T	2	3	5	0	0	5	0	0
8	23380278	.	T	C	2	2	4	0	0	4	0	0
8	23384003	.	G	A	2	7	9	0	0	9	0	0
8	23388923	.	T	G	1	2	3	0	0	3	0	0
8	23390113	.	T	C	0	4	4	0	1	5	0	0
8	23390197	.	T	A	1	2	3	0	1	4	0	0
8	23415651	.	C	T	10	7	17	0	0	17	0	0
8	23415693	.	G	A	7	9	16	0	1	17	0	0
8	23485600	.	T	C	1	3	4	0	0	4	0	0
8	23485604	.	G	T	1	3	4	0	0	4	0	0
8	23553648	.	C	T	4	3	7	0	1	8	0	0
8	23553749	.	A	T	4	2	6	0	0	6	0	0
8	23581100	.	T	C	2	0	2	0	3	5	0	0
8	23615202	.	T	A	2	0	2	0	0	2	0	0
8	23615206	.	A	T	2	0	2	0	0	2	0	0
8	23615446	.	G	A	6	4	10	0	0	10	0	0
8	23617372	.	C	T	4	1	5	0	0	5	0	0
8	23620494	.	G	A	1	0	1	0	1	2	0	0
8	23625823	.	T	G	3	7	10	0	0	10	0	0
8	23627371	.	T	C	4	2	6	0	0	6	0	0
8	23631692	.	C	T	3	3	6	0	0	6	0	0
8	23636779	.	A	C	6	6	12	0	1	13	0	0
8	23636901	.	C	A	2	6	8	0	0	8	0	0
8	23636973	.	T	G	2	3	5	0	0	5	0	0
8	23637245	.	G	T	5	3	8	0	0	8	0	0
8	23637395	.	C	T	3	3	6	0	0	6	0	0
8	23637680	.	C	T	1	4	5	0	0	5	0	0
8	23639163	.	G	A	1	2	3	0	0	3	0	0
8	23639165	.	T	C	1	2	3	0	0	3	0	0
8	23639214	.	T	G	8	8	16	0	0	16	0	0
8	23639301	.	T	C	5	7	12	0	0	12	0	0
8	23639472	.	T	C	4	4	8	0	0	8	0	0
8	23640048	.	A	G	8	0	8	0	7	15	0	0
8	23642271	.	T	C	1	0	1	0	0	1	0	0
8	23644351	.	C	A	1	0	1	0	1	2	0	0
8	23644363	.	T	A	1	1	2	0	1	3	0	0
8	23647323	.	G	C	0	1	1	0	0	1	0	0
8	23648753	.	T	C	2	0	2	0	0	2	0	0
8	23656058	.	G	A	2	11	13	0	1	14	0	0
8	23656151	.	C	T	11	7	18	0	2	20	0	0
8	23667549	.	T	C	1	1	2	0	0	2	0	0
8	23667561	.	C	T	1	2	3	0	0	3	0	0
8	23667739	.	C	T	2	4	6	0	0	6	0	0
8	23667810	.	T	C	3	3	6	0	0	6	0	0
8	23667966	.	G	A	5	5	10	0	0	10	0	0
8	23668050	.	G	A	5	6	11	0	0	11	0	0
8	23668060	.	C	T	5	6	11	0	0	11	0	0
8	23668371	.	A	T	3	2	5	0	1	6	0	0
8	23668623	.	G	A	5	13	18	0	0	18	0	0
8	23669276	.	C	T	6	7	13	0	0	13	0	0
8	23669307	.	T	C	5	8	13	0	0	13	0	0
8	23669423	.	T	C	2	8	10	0	1	11	0	0
8	23669451	.	A	G	3	7	10	0	2	12	0	0
8	23669642	.	C	T	7	10	17	0	3	20	0	0
8	23669736	.	A	T	10	11	21	0	0	21	0	0
8	23669802	.	C	A	7	12	19	0	1	20	0	0
8	23669821	.	G	A	0	12	12	0	7	20	1	0
8	23669933	.	C	A	5	9	14	0	0	14	0	0
8	23669968	.	C	T	6	4	10	0	0	10	0	0
8	23669983	.	T	C	4	3	7	0	0	7	0	0
8	23670115	.	T	C	2	4	6	0	0	6	0	0
8	23670202	.	A	G	2	7	9	0	0	9	0	0
8	23672505	.	C	T	2	7	9	0	0	9	0	0
8	23672740	.	G	C	2	2	4	0	0	4	0	0
8	23672802	.	A	G	4	3	7	0	0	7	0	0
8	23672812	.	G	A	4	3	7	0	0	7	0	0
8	23673401	.	T	A	1	2	3	0	0	3	0	0
8	23703739	.	C	T	3	2	5	0	0	5	0	0
8	23703754	.	C	T	4	2	6	0	0	6	0	0
8	23703775	.	T	A	3	2	5	0	0	5	0	0
8	23703819	.	C	A	6	1	7	0	0	7	0	0
8	23703827	.	T	A	5	2	7	0	0	7	0	0
8	23711985	.	G	A	7	3	10	0	1	11	0	0
8	23716979	.	G	T	3	4	7	0	0	7	0	0
8	23717117	.	C	A	1	1	2	0	0	2	0	0
8	23723723	.	G	A	0	2	2	0	3	5	0	0
8	23724045	.	A	C	8	5	13	0	0	13	0	0
8	23733414	.	G	A	3	4	7	0	0	7	0	0
8	23733495	.	G	C	1	4	5	0	1	6	0	0
8	23733545	.	A	G	2	4	6	0	0	6	0	0
8	23733548	.	G	A	2	3	5	0	0	5	0	0
8	23734596	.	C	T	1	3	4	0	1	5	0	0
8	23735856	.	C	T	0	2	2	0	0	2	0	0
8	23736063	.	G	A	0	6	6	0	4	10	0	0
8	23740519	.	G	A	4	7	11	0	0	11	0	0
8	23753566	.	T	A	6	4	10	0	0	10	0	0
8	23753793	.	C	T	0	4	4	0	3	7	0	0
8	23753834	.	C	G	0	5	5	0	1	6	0	0
8	23756089	.	A	T	3	0	3	0	0	3	0	0
8	23756221	.	T	A	6	5	11	0	3	14	0	0
8	23756536	.	C	G	0	10	10	0	9	19	0	0
8	23756749	.	G	C	4	2	6	0	0	6	0	0
8	23760288	.	C	T	0	8	8	0	4	12	0	0
8	23760703	.	A	T	3	4	7	0	0	7	0	0
8	23763809	.	T	C	2	3	5	0	0	5	0	0
8	23765199	.	T	C	0	1	1	0	0	1	0	0
8	23781425	.	A	G	1	0	1	0	4	5	0	0
8	23781426	.	A	G	1	4	5	0	0	5	0	0
8	23827665	.	A	G	5	0	5	0	4	9	0	0
8	23833257	.	G	A	3	3	6	0	0	6	0	0
8	23857845	.	T	C	1	1	2	0	0	2	0	0
8	23857997	.	G	A	1	1	2	0	1	3	0	0
8	23860200	.	G	A	5	2	7	0	0	7	0	0
8	23865837	.	A	G	2	2	4	0	0	4	0	0
8	23867417	.	A	G	1	1	2	0	0	2	0	0
8	23869978	.	C	T	8	8	16	0	0	16	0	0
8	23878905	.	T	A	0	10	10	0	0	10	0	0
8	23879044	.	T	A	11	9	20	0	0	20	0	0
8	23879238	.	T	A	11	8	19	0	1	20	0	0
8	23879365	.	G	A	7	8	15	0	1	16	0	0
8	24108887	.	A	G	2	5	7	0	0	7	0	0
8	24108899	.	T	C	2	4	6	0	0	6	0	0
8	24109317	.	T	A	5	7	12	0	0	12	0	0
8	24109860	.	G	A	5	9	14	0	0	14	0	0
8	24110817	.	A	G	1	5	6	0	0	6	0	0
8	24111073	.	A	G	4	5	9	0	0	9	0	0
8	24111082	.	T	C	4	3	7	0	0	7	0	0
8	24113044	.	C	A	5	6	11	0	0	11	0	0
8	24113075	.	A	G	0	1	1	0	0	1	0	0
8	24113420	.	A	G	4	8	12	0	0	12	0	0
8	24113519	.	G	C	6	8	14	0	0	14	0	0
8	24120176	.	T	A	6	8	14	0	1	15	0	0
8	24120187	.	A	T	5	9	14	0	0	14	0	0
8	24122960	.	C	A	0	3	3	0	7	10	0	0
8	24123072	.	C	T	6	2	8	0	1	9	0	0
8	24135019	.	C	T	5	6	11	0	0	11	0	0
8	24135022	.	G	A	5	5	10	0	0	10	0	0
8	24292976	.	C	T	1	3	4	0	0	4	0	0
8	24292987	.	C	T	1	1	2	0	0	2	0	0
8	24295076	.	G	A	0	1	1	0	0	1	0	0
8	24303878	.	T	C	0	4	4	0	0	4	0	0
8	24303958	.	A	G	4	2	6	0	0	6	0	0
8	24304577	.	G	A	3	4	7	0	0	7	0	0
8	24308628	.	T	C	2	2	4	0	0	4	0	0
8	24308631	.	A	G	2	2	4	0	0	4	0	0
8	24308772	.	G	A	1	2	3	0	0	3	0	0
8	24313399	.	T	C	0	1	1	0	0	1	0	0
8	24316393	.	T	G	2	0	2	0	5	7	0	0
8	24316484	.	A	G	4	0	4	0	3	7	0	0
8	24316499	.	G	A	5	0	5	0	0	5	0	0
8	24323336	.	T	C	5	2	7	0	0	7	0	0
8	24325363	.	A	G	6	3	9	0	0	9	0	0
8	24730008	.	A	C	1	4	5	0	0	5	0	0
8	24730107	.	T	A	1	2	3	0	0	3	0	0
8	24740168	.	C	A	8	9	17	0	0	17	0	0
8	24741031	.	A	T	13	2	15	0	0	15	0	0
8	24743676	.	A	T	7	5	12	0	0	12	0	0
8	24743874	.	G	A	0	3	3	0	5	8	0	0
8	24788514	.	C	T	10	5	15	0	0	15	0	0
8	24789174	.	C	T	5	4	9	0	0	9	0	0
8	24790139	.	A	G	6	9	15	0	0	15	0	0
8	24790194	.	A	G	5	11	16	0	0	16	0	0
8	24854637	.	G	A	5	1	6	0	0	6	0	0
8	24861530	.	T	C	6	4	10	0	0	10	0	0
8	24870404	.	T	C	2	1	3	0	1	4	0	0
8	24875117	.	C	G	5	0	5	0	10	15	0	0
8	24880220	.	G	A	6	5	11	0	1	12	0	0
8	24881058	.	T	C	1	1	2	0	0	2	0	0
8	24883433	.	G	A	0	7	7	0	3	10	0	0
8	24883487	.	T	C	7	14	21	0	1	22	0	0
8	24883577	.	C	T	7	4	11	0	1	12	0	0
8	24883963	.	C	A	5	5	10	0	0	10	0	0
8	24883975	.	A	G	4	3	7	0	0	7	0	0
8	24886194	.	T	C	6	6	12	0	1	13	0	0
8	24886251	.	A	G	8	12	20	0	0	20	0	0
8	24886626	.	T	G	10	15	25	0	0	25	0	0
8	24889403	.	C	T	9	27	36	0	1	37	0	0
8	24889482	.	A	T	13	20	33	0	2	35	0	0
8	24889586	.	C	T	9	12	21	0	3	24	0	0
8	24889629	.	A	G	8	18	26	0	2	28	0	0
8	24889638	.	T	A	11	18	29	0	0	29	0	0
8	24889796	.	G	A	11	23	34	0	2	36	0	0
8	24890084	.	T	A	16	13	29	0	3	32	0	0
8	24890238	.	T	A	18	10	28	0	0	28	0	0
8	24890798	.	C	T	11	13	24	0	0	24	0	0
8	24890913	.	T	G	12	24	36	0	0	36	0	0
8	24940006	.	C	T	4	2	6	0	0	6	0	0
8	24940282	.	G	A	1	2	3	0	0	3	0	0
8	24972006	.	T	C	14	12	26	0	2	28	0	0
8	24972137	.	G	T	13	16	29	0	9	38	0	0
8	24972413	.	A	C	2	13	15	0	0	15	0	0
8	24972594	.	T	C	18	16	34	0	2	36	0	0
8	24972595	.	T	A	19	16	35	0	1	36	0	0
8	24972746	.	T	A	12	17	29	0	2	31	0	0
8	24973088	.	G	C	6	18	24	0	1	25	0	0
8	24973239	.	T	A	17	19	36	0	0	36	0	0
8	24973276	.	A	G	19	12	31	0	1	32	0	0
8	24973462	.	A	G	5	10	15	0	0	15	0	0
8	24985735	.	T	C	5	5	10	0	1	11	0	0
8	24985741	.	G	C	5	5	10	0	1	11	0	0
8	24986965	.	G	A	3	7	10	0	2	12	0	0
8	24991082	.	G	T	8	5	13	0	1	14	0	0
8	24991127	.	G	A	13	6	19	0	1	20	0	0
8	24991169	.	G	A	4	0	4	0	0	4	0	0
8	25010904	.	C	A	0	17	17	0	16	33	0	0
8	25022506	.	C	T	0	3	3	0	4	7	0	0
8	25022808	.	C	T	1	2	3	0	0	3	0	0
8	25036520	.	T	C	1	2	3	0	1	4	0	0
8	25036523	.	A	G	1	1	2	0	2	4	0	0
8	25036694	.	C	G	0	5	5	0	0	5	0	0
8	25039704	.	T	C	5	7	12	0	0	12	0	0
8	25039967	.	C	A	3	4	7	0	0	7	0	0
8	25040295	.	A	G	3	9	12	0	0	12	0	0
8	25040349	.	A	G	2	3	5	0	2	7	0	0
8	25040479	.	T	C	1	5	6	0	0	6	0	0
8	25040499	.	T	G	1	4	5	0	0	5	0	0
8	25042269	.	T	C	11	8	19	0	0	19	0	0
8	25042275	.	T	C	10	7	17	0	0	17	0	0
8	25042328	.	A	G	4	7	11	0	1	12	0	0
8	25042352	.	G	A	3	11	14	0	1	15	0	0
8	25042474	.	T	C	10	0	10	0	6	16	0	0
8	25042578	.	A	G	8	11	19	0	0	19	0	0
8	25042933	.	T	C	10	9	19	0	0	19	0	0
8	25043125	.	A	G	10	10	20	0	0	20	0	0
8	25043167	.	A	T	9	16	25	0	1	26	0	0
8	25045766	.	T	C	3	3	6	0	0	6	0	0
8	25055972	.	G	T	3	4	7	0	1	8	0	0
8	25056041	.	T	C	4	0	4	0	7	11	0	0
8	25056207	.	A	G	5	7	12	0	0	12	0	0
8	25065675	.	T	A	5	5	10	0	0	10	0	0
8	25065762	.	A	G	1	3	4	0	1	5	0	0
8	25066100	.	C	T	4	2	6	0	0	6	0	0
8	25074042	.	A	C	8	6	14	0	2	16	0	0
8	25091546	.	G	T	3	2	5	0	1	6	0	0
8	25094489	.	C	G	0	2	2	0	0	2	0	0
8	25097431	.	G	A	4	7	11	0	0	11	0	0
8	25103407	.	C	T	7	7	14	0	1	15	0	0
8	25103581	.	C	T	3	3	6	0	0	6	0	0
8	25103719	.	T	C	9	4	13	0	0	13	0	0
8	25103731	.	T	C	8	5	13	0	1	14	0	0
8	25117654	.	T	C	11	10	21	0	0	21	0	0
8	25117759	.	A	G	7	10	17	0	2	19	0	0
8	25118164	.	C	A	16	12	28	0	0	28	0	0
8	25118587	.	A	G	7	1	8	0	0	8	0	0
8	25176197	.	C	T	4	4	8	0	0	8	0	0
8	25176250	.	T	C	9	10	19	0	0	19	0	0
8	25176257	.	T	C	9	10	19	0	1	20	0	0
8	25176303	.	A	G	11	11	22	0	2	24	0	0
8	25176677	.	T	C	6	5	11	0	0	11	0	0
8	25176957	.	C	G	8	6	14	0	0	14	0	0
8	25177285	.	A	G	3	8	11	0	1	12	0	0
8	25267833	.	T	C	2	3	5	0	0	5	0	0
8	25271544	.	T	C	2	4	6	0	1	7	0	0
8	25272507	.	C	T	4	12	16	0	0	16	0	0
8	25280530	.	T	C	6	3	9	0	0	9	0	0
8	25280849	.	C	T	5	7	12	0	0	12	0	0
8	25281877	.	A	G	2	0	2	0	4	6	0	0
8	25283346	.	T	G	6	0	6	0	7	13	0	0
8	25283768	.	A	G	7	2	9	0	0	9	0	0
8	25283771	.	T	C	7	2	9	0	0	9	0	0
8	25289156	.	A	G	0	0	0	0	1	1	0	0
8	25289180	.	C	T	4	10	14	0	0	14	0	0
8	25291478	.	A	T	8	10	18	0	0	18	0	0
8	25291573	.	C	A	7	5	12	0	1	13	0	0
8	25291651	.	A	G	4	11	15	0	0	15	0	0
8	25291662	.	A	G	7	9	16	0	2	18	0	0
8	25291742	.	A	C	11	11	22	0	0	22	0	0
8	25291912	.	A	T	19	16	35	0	1	36	0	0
8	25292188	.	C	T	4	5	9	0	1	10	0	0
8	25292370	.	A	G	10	13	23	0	1	24	0	0
8	25292407	.	G	T	14	10	24	0	0	24	0	0
8	25292482	.	T	C	12	13	25	0	1	26	0	0
8	25292492	.	A	T	11	17	28	0	0	28	0	0
8	25292608	.	T	C	27	13	40	0	2	42	0	0
8	25292865	.	G	C	7	19	26	0	1	27	0	0
8	25293008	.	A	G	14	20	34	0	1	35	0	0
8	25293064	.	C	T	11	18	29	0	0	29	0	0
8	25293111	.	G	T	13	16	29	0	1	30	0	0
8	25293184	.	C	T	18	22	40	0	0	40	0	0
8	25293225	.	T	A	13	12	25	0	0	25	0	0
8	25293275	.	A	G	18	0	18	0	14	32	0	0
8	25293346	.	C	T	12	13	25	0	1	26	0	0
8	25293445	.	T	C	1	7	8	0	0	8	0	0
8	25293459	.	T	C	0	7	7	0	0	7	0	0
8	25295219	.	A	T	4	8	12	0	0	12	0	0
8	25297326	.	A	G	6	0	6	0	16	22	0	0
8	25297371	.	T	C	0	4	4	0	0	4	0	0
8	25297523	.	A	G	14	1	15	0	18	33	0	0
8	25297617	.	G	C	12	21	33	0	2	35	0	0
8	25297741	.	C	T	9	20	29	0	1	30	0	0
8	25297842	.	T	A	13	10	23	0	0	23	0	0
8	25297864	.	A	G	14	6	20	0	0	20	0	0
8	25299819	.	A	G	1	2	3	0	0	3	0	0
8	25300511	.	C	T	1	2	3	0	0	3	0	0
8	25300749	.	T	C	5	6	11	0	0	11	0	0
8	25301185	.	T	C	8	5	13	0	0	13	0	0
8	25301280	.	A	G	13	11	24	0	1	25	0	0
8	25301350	.	A	G	5	8	13	0	1	14	0	0
8	25301389	.	G	A	0	8	8	0	4	12	0	0
8	25301450	.	T	C	5	5	10	0	1	11	0	0
8	25301512	.	G	T	3	10	13	0	0	13	0	0
8	25301524	.	A	G	3	8	11	0	0	11	0	0
8	25301547	.	G	A	6	4	10	0	0	10	0	0
8	25301583	.	C	A	6	5	11	0	0	11	0	0
8	25301590	.	A	C	4	5	9	0	2	11	0	0
8	25329565	.	T	C	5	1	6	0	0	6	0	0
8	25329583	.	A	T	5	2	7	0	0	7	0	0
8	25329606	.	T	A	4	2	6	0	0	6	0	0
8	25329981	.	A	T	12	7	19	0	0	19	0	0
8	25330065	.	T	A	12	12	24	0	0	24	0	0
8	25330181	.	C	T	11	4	15	0	0	15	0	0
8	25330293	.	C	T	13	4	17	0	1	18	0	0
8	25330295	.	T	A	13	5	18	0	0	18	0	0
8	25330334	.	T	A	15	5	20	0	1	21	0	0
8	25330367	.	A	C	12	8	20	0	2	22	0	0
8	25330390	.	A	G	15	11	26	0	1	27	0	0
8	25330498	.	G	A	28	18	46	0	1	47	0	0
8	25332708	.	C	T	7	16	23	0	1	24	0	0
8	25332900	.	A	G	4	2	6	0	0	6	0	0
8	25332945	.	G	A	20	22	42	0	0	42	0	0
8	25335063	.	G	A	28	22	50	0	1	51	0	0
8	25336097	.	T	A	16	15	31	0	1	32	0	0
8	25336102	.	T	G	15	17	32	0	2	34	0	0
8	25367091	.	C	T	3	5	8	0	0	8	0	0
8	25368374	.	A	G	5	5	10	0	0	10	0	0
8	25368421	.	A	G	4	2	6	0	2	8	0	0
8	25368451	.	A	G	3	4	7	0	0	7	0	0
8	25370776	.	T	C	0	4	4	0	0	4	0	0
8	25422072	.	A	C	1	0	1	0	2	3	0	0
8	25424272	.	C	T	3	2	5	0	2	7	0	0
8	25424375	.	C	A	5	7	12	0	0	13	1	0
8	25424411	.	T	A	3	7	10	0	2	12	0	0
8	25424558	.	A	G	2	4	6	0	0	6	0	0
8	25424658	.	G	A	1	3	4	0	0	4	0	0
8	25424721	.	A	G	4	5	9	0	0	9	0	0
8	25424734	.	T	A	6	5	11	0	0	11	0	0
8	25424865	.	T	A	4	4	8	0	0	8	0	0
8	25425395	.	G	A	2	2	4	0	0	4	0	0
8	25425453	.	G	A	2	3	5	0	0	5	0	0
8	25425621	.	T	A	1	2	3	0	0	3	0	0
8	25426321	.	A	G	4	3	7	0	0	7	0	0
8	25431300	.	T	C	4	0	4	0	3	7	0	0
8	25445553	.	A	G	0	1	1	0	0	1	0	0
8	25452117	.	T	C	1	2	3	0	0	3	0	0
8	25650512	.	T	C	1	2	3	0	0	3	0	0
8	25650518	.	T	C	1	0	1	0	2	3	0	0
8	25708263	.	A	G	2	4	6	0	1	7	0	0
8	25708998	.	C	T	7	5	12	0	0	12	0	0
8	25709426	.	G	T	6	4	10	0	0	10	0	0
8	25709521	.	T	A	6	7	13	0	1	14	0	0
8	25709522	.	A	C	6	8	14	0	0	14	0	0
8	25709694	.	T	G	5	5	10	0	0	10	0	0
8	25712660	.	G	T	13	9	22	0	0	22	0	0
8	25713053	.	G	A	6	5	11	0	1	12	0	0
8	25715118	.	A	C	4	4	8	0	6	14	0	0
8	25715181	.	C	T	7	9	16	0	0	16	0	0
8	25715325	.	G	C	8	4	12	0	5	17	0	0
8	25715950	.	C	A	7	7	14	0	0	14	0	0
8	25716000	.	C	A	6	6	12	0	0	12	0	0
8	25733949	.	T	A	9	7	16	0	1	17	0	0
8	25745724	.	C	T	10	12	22	0	0	22	0	0
8	25745840	.	C	T	12	4	16	0	1	17	0	0
8	25745915	.	A	T	8	5	13	0	0	13	0	0
8	25747425	.	A	T	9	6	15	0	0	15	0	0
8	25747518	.	T	C	5	3	8	0	1	9	0	0
8	25747677	.	G	A	10	9	19	0	1	20	0	0
8	25747705	.	A	G	7	0	7	0	8	16	1	0
8	25748147	.	C	T	9	3	12	0	0	12	0	0
8	25748283	.	G	T	6	2	8	0	0	8	0	0
8	25748421	.	T	G	9	16	25	0	1	26	0	0
8	25751167	.	A	G	12	0	12	0	12	24	0	0
8	25761791	.	A	T	4	5	9	0	0	9	0	0
8	25761792	.	C	A	4	5	9	0	0	9	0	0
8	25761886	.	T	C	7	4	11	0	0	11	0	0
8	25764192	.	T	C	16	10	26	0	2	28	0	0
8	25765647	.	G	A	0	7	7	0	14	21	0	0
8	25765788	.	G	A	0	16	16	0	14	30	0	0
8	25765794	.	G	A	14	15	29	0	1	30	0	0
8	25766098	.	G	A	22	4	26	0	1	27	0	0
8	25766131	.	T	C	17	6	23	0	1	24	0	0
8	25766188	.	A	C	8	13	21	0	0	21	0	0
8	25766249	.	A	G	5	4	9	0	0	9	0	0
8	25812075	.	T	C	14	12	26	0	1	27	0	0
8	25812327	.	G	A	12	11	23	0	0	23	0	0
8	25813979	.	G	A	4	11	15	0	1	16	0	0
8	25814003	.	C	T	1	5	6	0	2	8	0	0
8	25816811	.	T	A	7	11	18	0	3	21	0	0
8	25816849	.	G	A	16	10	26	0	2	29	1	0
8	25816863	.	G	A	16	10	26	0	2	28	0	0
8	25816889	.	T	C	13	11	24	0	1	25	0	0
8	25816904	.	T	G	14	11	25	0	0	25	0	0
8	25816959	.	G	T	16	20	36	0	2	38	0	0
8	25818836	.	C	T	0	13	13	1	16	30	0	0
8	25819057	.	T	A	16	9	25	0	2	28	1	0
8	25819090	.	G	T	12	3	15	0	0	15	0	0
8	25819095	.	A	T	12	3	15	0	0	15	0	0
8	25819128	.	A	G	7	2	9	0	1	10	0	0
8	25819137	.	T	C	7	1	8	0	0	8	0	0
8	25819172	.	T	A	4	3	7	0	0	7	0	0
8	25819196	.	G	A	4	3	7	0	0	7	0	0
8	25819349	.	A	G	10	8	18	0	1	19	0	0
8	25819430	.	A	T	9	13	22	0	1	23	0	0
8	25819434	.	C	G	9	15	24	0	0	24	0	0
8	25819548	.	C	G	16	13	29	0	0	29	0	0
8	25820917	.	G	T	8	11	19	0	1	20	0	0
8	25821088	.	T	G	10	4	14	0	1	15	0	0
8	25821426	.	T	C	16	21	37	0	1	38	0	0
8	25845885	.	G	C	19	15	34	0	1	35	0	0
8	25892732	.	C	G	5	0	5	0	6	11	0	0
8	25892857	.	C	T	5	6	11	0	0	11	0	0
8	25892895	.	T	C	3	5	8	0	0	8	0	0
8	25892936	.	G	C	1	3	4	0	0	4	0	0
8	25893610	.	C	G	4	4	8	0	0	8	0	0
8	25893655	.	T	C	6	5	11	0	0	11	0	0
8	25893676	.	T	C	5	5	10	0	1	11	0	0
8	25894080	.	C	G	5	4	9	0	0	9	0	0
8	25894108	.	C	T	4	7	11	0	0	11	0	0
8	25897373	.	G	A	0	1	1	0	9	10	0	0
8	25897378	.	C	T	7	2	9	0	0	9	0	0
8	25897861	.	G	A	3	3	6	0	0	6	0	0
8	25898011	.	T	A	2	6	8	0	0	8	0	0
8	25898067	.	G	T	3	3	6	0	0	6	0	0
8	25902955	.	T	C	16	14	30	0	0	30	0	0
8	25905686	.	T	A	16	19	35	0	1	36	0	0
8	25905919	.	T	C	6	6	12	0	1	13	0	0
8	25913896	.	C	T	1	4	5	0	0	5	0	0
8	25925483	.	G	A	0	1	1	0	3	4	0	0
8	25927455	.	C	T	1	4	5	0	1	6	0	0
8	25948519	.	A	C	1	3	4	0	0	4	0	0
8	25950704	.	G	C	2	1	3	0	0	3	0	0
8	25950880	.	G	T	15	8	23	0	1	24	0	0
8	25951162	.	G	A	0	4	4	0	7	11	0	0
8	25951187	.	T	A	5	6	11	0	0	11	0	0
8	25951197	.	G	A	5	6	11	0	0	11	0	0
8	25951265	.	A	T	12	9	21	0	2	23	0	0
8	25951293	.	A	T	15	7	22	0	0	22	0	0
8	25951310	.	A	C	14	2	16	0	0	16	0	0
8	25951378	.	C	G	14	10	24	0	1	25	0	0
8	25951411	.	C	T	13	14	27	0	0	27	0	0
8	25951575	.	A	T	7	3	10	0	0	10	0	0
8	25951626	.	T	C	10	4	14	0	0	14	0	0
8	25951660	.	G	T	8	4	12	0	2	14	0	0
8	25951665	.	T	A	10	3	13	0	2	15	0	0
8	25951762	.	C	T	10	8	18	0	0	18	0	0
8	25963150	.	A	G	8	5	13	0	2	15	0	0
8	25963151	.	C	A	9	6	15	0	0	15	0	0
8	25964468	.	A	G	4	0	4	0	11	15	0	0
8	25964489	.	A	G	3	0	3	0	14	18	1	0
8	25969188	.	C	T	2	2	4	0	0	4	0	0
8	25969466	.	C	T	5	10	15	0	0	15	0	0
8	25969498	.	A	G	8	8	16	0	3	19	0	0
8	25969506	.	G	A	0	10	10	0	8	18	0	0
8	25969778	.	T	A	7	3	10	0	1	11	0	0
8	25970647	.	A	T	5	4	9	0	0	9	0	0
8	25970719	.	A	T	7	7	14	0	0	14	0	0
8	25970772	.	A	G	18	5	23	0	0	23	0	0
8	25970816	.	G	T	5	14	19	0	1	20	0	0
8	25970932	.	G	A	10	8	18	0	0	18	0	0
8	25971143	.	C	A	9	6	15	0	2	17	0	0
8	25971306	.	T	A	7	15	22	0	0	22	0	0
8	25971367	.	C	T	8	5	13	0	0	13	0	0
8	25971397	.	G	A	10	4	14	0	0	14	0	0
8	26008088	.	G	A	0	4	4	0	1	5	0	0
8	26008118	.	T	C	1	5	6	0	0	6	0	0
8	26008246	.	G	C	1	0	1	0	0	1	0	0
8	26009290	.	C	T	2	2	4	0	0	4	0	0
8	26009393	.	C	T	5	5	10	0	0	10	0	0
8	26012153	.	T	C	1	1	2	0	1	3	0	0
8	26015709	.	T	G	1	1	2	0	1	3	0	0
8	26019711	.	A	G	4	3	7	0	0	7	0	0
8	26034654	.	A	G	10	7	17	0	1	18	0	0
8	26034676	.	C	T	11	7	18	0	0	18	0	0
8	26056801	.	G	A	11	30	41	0	0	41	0	0
8	26056891	.	T	G	17	11	28	0	1	29	0	0
8	26056935	.	T	C	13	25	38	0	2	40	0	0
8	26056970	.	T	C	12	25	37	0	2	39	0	0
8	26056990	.	T	C	12	26	38	0	1	39	0	0
8	26057014	.	T	C	21	20	41	0	2	43	0	0
8	26059717	.	T	G	6	9	15	0	1	16	0	0
8	26059897	.	A	T	4	1	5	0	0	5	0	0
8	26078551	.	C	T	12	7	19	0	0	19	0	0
8	26078825	.	A	G	12	5	17	0	1	18	0	0
8	26078826	.	A	G	12	6	18	0	0	18	0	0
8	26078879	.	T	G	9	5	14	0	0	14	0	0
8	26083987	.	C	T	9	3	12	0	0	12	0	0
8	26091767	.	C	T	9	12	21	0	2	23	0	0
8	26091845	.	A	G	3	0	3	0	3	6	0	0
8	26092050	.	A	G	13	12	25	0	1	26	0	0
8	26092176	.	T	A	6	8	14	0	1	15	0	0
8	26097399	.	T	C	15	21	36	0	5	41	0	0
8	26097749	.	C	T	7	8	15	0	0	15	0	0
8	26097895	.	C	A	9	7	16	0	0	16	0	0
8	26125649	.	T	C	0	3	3	0	1	4	0	0
8	26126279	.	G	T	3	2	5	0	0	5	0	0
8	26126765	.	C	A	2	3	5	0	0	5	0	0
8	26127590	.	A	G	2	2	4	0	0	4	0	0
8	26151750	.	G	T	5	3	8	0	0	8	0	0
8	26176125	.	T	C	5	2	7	0	0	7	0	0
8	26177197	.	A	G	2	2	4	0	0	4	0	0
8	26192798	.	C	T	1	4	5	0	1	6	0	0
8	26199999	.	G	A	0	3	3	0	5	8	0	0
8	26200014	.	G	T	4	5	9	0	1	10	0	0
8	26203373	.	C	T	2	3	5	0	0	5	0	0
8	26203553	.	A	G	0	0	0	0	3	3	0	0
8	26208387	.	T	C	5	2	7	0	0	7	0	0
8	26210178	.	G	A	1	0	1	0	0	1	0	0
8	26210523	.	A	T	6	6	12	0	0	12	0	0
8	26234027	.	A	G	3	3	6	0	1	7	0	0
8	26234044	.	G	A	3	2	5	0	0	5	0	0
8	26234114	.	G	T	0	1	1	0	2	3	0	0
8	26234123	.	T	A	2	2	4	0	0	4	0	0
8	26234563	.	G	A	3	3	6	0	0	6	0	0
8	26234599	.	A	T	3	4	7	0	0	7	0	0
8	26235117	.	A	C	8	2	10	0	1	11	0	0
8	26235164	.	T	C	5	3	8	0	0	8	0	0
8	26235275	.	C	T	8	6	14	0	0	14	0	0
8	26235471	.	A	G	3	4	7	0	0	7	0	0
8	26239916	.	G	A	0	2	2	0	5	7	0	0
8	26239919	.	T	A	5	2	7	0	0	7	0	0
8	26240047	.	T	G	5	4	9	0	0	10	1	0
8	26240196	.	C	T	6	3	9	0	1	10	0	0
8	26240249	.	A	G	2	0	2	0	3	5	0	0
8	26240346	.	G	A	0	3	3	0	3	6	0	0
8	26240348	.	A	T	3	3	6	0	0	6	0	0
8	26293930	.	C	T	10	9	19	0	0	19	0	0
8	26323893	.	A	T	4	2	6	0	0	6	0	0
8	26324620	.	C	T	13	7	20	0	0	20	0	0
8	26324647	.	A	T	10	9	19	0	1	20	0	0
8	26324683	.	C	T	5	6	11	0	1	12	0	0
8	26324709	.	T	C	6	10	16	0	0	16	0	0
8	26324773	.	T	C	10	13	23	0	1	24	0	0
8	26324905	.	A	G	7	17	24	0	0	24	0	0
8	26325332	.	T	A	23	21	44	0	0	44	0	0
8	26325333	.	A	T	22	20	42	0	2	44	0	0
8	26325519	.	A	T	15	13	28	0	1	29	0	0
8	26325600	.	T	C	22	18	40	0	0	40	0	0
8	26325679	.	C	T	15	13	28	0	1	29	0	0
8	26326046	.	G	A	12	17	29	0	1	30	0	0
8	26326152	.	T	C	17	23	40	0	2	42	0	0
8	26326438	.	A	G	1	3	4	0	0	4	0	0
8	26330006	.	G	A	5	7	12	0	0	12	0	0
8	26330047	.	A	C	8	5	13	0	0	13	0	0
8	26330134	.	A	T	11	11	22	0	0	22	0	0
8	26330190	.	T	C	5	16	21	0	0	21	0	0
8	26330666	.	T	C	9	11	20	0	0	20	0	0
8	26357826	.	A	G	2	6	8	0	0	8	0	0
8	26367891	.	T	G	7	14	21	0	0	21	0	0
8	26368025	.	C	T	25	12	37	1	6	44	0	0
8	26368150	.	C	T	27	17	44	0	1	45	0	0
8	26368171	.	T	C	26	21	47	0	0	47	0	0
8	26368446	.	A	T	8	9	17	0	1	18	0	0
8	26376124	.	C	A	1	2	3	0	0	3	0	0
8	26410472	.	G	C	5	4	9	0	0	9	0	0
8	26424873	.	A	G	7	8	15	0	0	15	0	0
8	26426163	.	T	C	0	2	2	0	0	2	0	0
8	26426596	.	T	G	2	6	8	0	1	9	0	0
8	26426621	.	C	T	0	6	6	0	0	6	0	0
8	26426771	.	C	T	5	5	10	0	0	10	0	0
8	26426978	.	A	C	10	5	15	0	1	16	0	0
8	26427081	.	C	T	3	11	14	0	1	15	0	0
8	26436030	.	A	G	3	2	5	0	0	5	0	0
8	26438912	.	A	G	3	3	6	0	0	6	0	0
8	26439041	.	A	C	1	1	2	0	0	2	0	0
8	26439046	.	A	G	1	0	1	0	1	2	0	0
8	26439101	.	G	T	2	2	4	0	0	4	0	0
8	26444701	.	T	C	2	0	2	0	0	2	0	0
8	26444741	.	T	C	2	0	2	0	0	2	0	0
8	26444759	.	A	T	1	0	1	0	0	1	0	0
8	26445075	.	T	C	1	5	6	0	0	6	0	0
8	26445100	.	G	T	5	5	10	0	0	10	0	0
8	26445119	.	A	G	4	3	7	0	1	8	0	0
8	26445184	.	A	T	1	0	1	0	0	1	0	0
8	26447468	.	G	A	3	1	4	0	0	4	0	0
8	26449218	.	A	T	1	2	3	0	0	3	0	0
8	26565265	.	T	G	2	0	2	0	4	6	0	0
8	26565389	.	C	T	2	5	7	0	0	7	0	0
8	26571179	.	C	G	2	1	3	0	0	3	0	0
8	26571193	.	G	T	2	1	3	0	0	3	0	0
8	26572943	.	T	C	2	4	6	0	0	6	0	0
8	26573009	.	T	C	4	3	7	0	0	7	0	0
8	26573030	.	G	A	0	3	3	0	4	7	0	0
8	26573066	.	T	A	3	2	5	0	0	5	0	0
8	26573075	.	A	C	3	2	5	0	0	5	0	0
8	26573622	.	G	A	2	4	6	0	0	6	0	0
8	26586558	.	G	A	15	13	28	0	1	29	0	0
8	26586634	.	A	C	7	5	12	0	1	13	0	0
8	26586900	.	G	T	12	14	26	0	0	26	0	0
8	26587137	.	C	G	11	5	16	0	0	16	0	0
8	26587164	.	G	A	5	4	9	0	0	9	0	0
8	26587323	.	G	A	6	7	13	0	1	14	0	0
8	26587380	.	G	A	9	6	15	0	0	15	0	0
8	26589400	.	A	G	4	5	9	0	0	9	0	0
8	26607064	.	A	C	1	0	1	0	3	4	0	0
8	26609109	.	T	C	2	2	4	0	0	4	0	0
8	26709844	.	T	C	1	6	7	0	1	8	0	0
8	26714641	.	G	T	1	2	3	0	0	3	0	0
8	26718306	.	A	G	2	6	8	0	1	9	0	0
8	26718309	.	T	G	2	6	8	0	0	8	0	0
8	26731764	.	A	C	4	0	4	0	0	4	0	0
8	26731866	.	T	G	11	3	14	0	0	14	0	0
8	26746173	.	C	T	6	4	10	0	0	10	0	0
8	26792849	.	A	G	9	9	18	0	0	18	0	0
8	26830994	.	T	A	1	1	2	0	0	2	0	0
8	26838076	.	C	T	3	3	6	0	0	6	0	0
8	26838478	.	T	G	2	0	2	0	4	6	0	0
8	26838547	.	C	T	7	7	14	0	0	14	0	0
8	26860061	.	C	A	3	3	6	0	0	6	0	0
8	26860064	.	A	T	3	3	6	0	0	6	0	0
8	26860307	.	A	G	7	3	10	0	0	10	0	0
8	26860359	.	G	T	9	5	14	0	0	14	0	0
8	26860430	.	C	T	6	5	11	0	0	11	0	0
8	26860493	.	A	C	4	6	10	0	0	10	0	0
8	26860511	.	T	C	6	4	10	0	1	11	0	0
8	26860600	.	G	T	7	2	9	0	0	9	0	0
8	26860778	.	T	C	4	6	10	0	0	10	0	0
8	26860779	.	G	A	4	6	10	0	0	10	0	0
8	26860909	.	T	C	4	5	9	0	1	10	0	0
8	26861145	.	A	G	8	5	13	0	0	13	0	0
8	26861248	.	G	T	11	11	22	0	2	24	0	0
8	26861434	.	G	A	4	6	10	0	0	10	0	0
8	26861653	.	T	C	7	7	14	0	0	14	0	0
8	26861760	.	C	A	4	14	18	0	0	18	0	0
8	26862002	.	A	C	13	15	28	0	0	28	0	0
8	26862526	.	C	A	14	6	20	0	1	23	2	0
8	26863804	.	C	A	6	9	15	0	2	17	0	0
8	26864121	.	A	G	6	11	17	0	1	18	0	0
8	26864150	.	G	C	9	8	17	0	1	18	0	0
8	26864195	.	G	C	8	11	19	0	2	21	0	0
8	26868418	.	T	C	13	15	28	0	0	28	0	0
8	26881205	.	T	G	10	0	10	0	16	26	0	0
8	26884298	.	T	C	12	20	32	0	5	37	0	0
8	26884313	.	A	G	12	21	33	0	1	34	0	0
8	26884619	.	C	T	31	28	59	0	1	60	0	0
8	26884767	.	C	T	32	19	51	0	1	52	0	0
8	26884903	.	T	A	16	21	37	0	0	37	0	0
8	26885382	.	C	A	21	24	45	0	2	47	0	0
8	26886025	.	C	T	17	14	31	0	0	31	0	0
8	26886177	.	T	C	20	14	34	0	1	35	0	0
8	26886259	.	A	G	15	25	40	0	2	42	0	0
8	26886399	.	C	G	14	31	45	0	2	47	0	0
8	26886667	.	T	A	31	17	48	0	4	53	1	0
8	26886766	.	T	C	30	23	53	0	1	54	0	0
8	26886972	.	A	T	19	20	39	0	1	40	0	0
8	26887013	.	T	C	17	18	35	0	0	35	0	0
8	26887122	.	A	C	16	15	31	0	0	31	0	0
8	26887240	.	G	A	0	7	7	0	6	13	0	0
8	27361846	.	G	A	5	4	9	0	0	9	0	0
8	27362288	.	C	G	5	4	9	0	0	9	0	0
8	27515239	.	T	C	9	8	17	0	2	19	0	0
8	27624026	.	T	A	21	18	39	0	3	42	0	0
8	27624027	.	T	C	22	19	41	0	1	42	0	0
8	27813611	.	C	A	8	15	23	0	1	24	0	0
8	27816560	.	C	A	22	26	48	0	6	54	0	0
8	27816680	.	C	T	16	20	36	0	1	37	0	0
8	28231970	.	T	G	1	0	1	0	22	24	1	0
8	28347757	.	C	T	1	1	2	0	0	2	0	0
8	28399129	.	G	A	4	7	11	0	0	11	0	0
8	28868416	.	G	A	0	4	4	0	3	7	0	0
8	28868425	.	G	A	5	5	10	0	0	10	0	0
8	28901165	.	C	T	5	4	9	0	0	9	0	0
8	28901170	.	C	A	4	5	9	0	0	9	0	0
8	28982606	.	G	A	2	1	3	0	0	3	0	0
8	29285574	.	T	C	5	6	11	0	0	11	0	0
8	29285661	.	C	T	1	2	3	0	0	3	0	0
8	29336744	.	C	A	5	1	6	0	1	7	0	0
8	29336828	.	C	T	7	4	11	0	1	12	0	0
8	29427894	.	C	T	8	4	12	0	2	14	0	0
8	29427954	.	T	C	8	6	14	0	1	15	0	0
8	29428042	.	C	A	8	9	17	0	1	18	0	0
8	29428071	.	G	A	1	5	6	0	9	15	0	0
8	29428110	.	C	T	1	4	5	0	0	5	0	0
8	29476190	.	T	C	3	3	6	0	0	6	0	0
8	29574985	.	C	A	22	13	35	0	4	39	0	0
8	29587262	.	C	A	10	13	23	0	1	24	0	0
8	29587431	.	A	C	2	1	3	0	13	16	0	0
8	29587443	.	A	C	7	1	8	0	10	18	0	0
8	29587500	.	C	A	13	6	19	0	0	19	0	0
8	29587651	.	C	T	12	9	21	0	0	21	0	0
8	29636104	.	G	T	2	2	4	0	0	4	0	0
8	29644195	.	G	A	1	3	4	0	0	4	0	0
8	29647473	.	G	T	7	3	10	0	0	10	0	0
8	29647488	.	A	T	4	2	6	0	1	7	0	0
8	29647748	.	T	C	4	1	5	0	0	5	0	0
8	29651670	.	G	A	1	3	4	0	0	4	0	0
8	29651951	.	A	G	5	5	10	0	0	10	0	0
8	29652100	.	A	G	5	0	5	0	6	11	0	0
8	29652143	.	A	G	5	3	8	0	1	9	0	0
8	29719073	.	G	T	1	2	3	0	0	3	0	0
8	29719306	.	C	T	1	2	3	0	0	3	0	0
8	29742498	.	A	G	1	3	4	0	0	4	0	0
8	29749112	.	T	G	4	4	8	0	0	8	0	0
8	29759726	.	A	C	2	1	3	0	0	3	0	0
8	29763480	.	C	T	7	5	12	0	0	12	0	0
8	29763633	.	C	G	9	0	9	0	8	17	0	0
8	29763812	.	G	C	4	10	14	0	0	14	0	0
8	29763822	.	A	G	11	0	11	0	7	18	0	0
8	29764138	.	C	T	14	4	18	0	0	18	0	0
8	29764150	.	A	T	15	4	19	0	0	19	0	0
8	29764585	.	G	A	3	2	5	0	0	5	0	0
8	29764968	.	T	C	6	3	9	0	0	9	0	0
8	29765045	.	C	T	3	3	6	0	0	6	0	0
8	29765178	.	C	T	3	4	7	0	1	8	0	0
8	29765414	.	A	G	1	2	3	0	0	3	0	0
8	29765429	.	C	A	1	3	4	0	0	4	0	0
8	29765594	.	C	A	1	2	3	0	0	3	0	0
8	29765598	.	C	A	1	2	3	0	0	3	0	0
8	29765824	.	T	C	6	2	8	0	0	8	0	0
8	29765846	.	C	G	3	4	7	0	0	7	0	0
8	29766516	.	T	C	2	3	5	0	0	5	0	0
8	29770371	.	T	A	32	28	60	0	1	61	0	0
8	29773127	.	T	A	14	17	31	0	0	31	0	0
8	29774042	.	C	G	0	15	15	0	14	29	0	0
8	29774428	.	T	A	10	16	26	0	2	28	0	0
8	29793782	.	A	G	8	9	17	0	1	18	0	0
8	29799168	.	C	T	0	18	18	0	17	35	0	0
8	29799360	.	G	A	16	11	27	0	2	29	0	0
8	29799627	.	G	A	4	3	7	0	0	7	0	0
8	29801150	.	C	G	2	4	6	0	0	6	0	0
8	29801291	.	C	T	2	11	13	0	2	15	0	0
8	29806615	.	G	A	5	4	9	0	0	9	0	0
8	29819317	.	G	A	5	7	12	0	0	12	0	0
8	29819419	.	T	C	6	0	6	0	5	11	0	0
8	29819431	.	G	A	4	6	10	0	0	10	0	0
8	29819604	.	C	T	0	6	6	0	6	12	0	0
8	29819610	.	C	T	5	7	12	0	2	14	0	0
8	29851592	.	T	G	3	4	7	0	2	9	0	0
8	29871800	.	T	C	3	4	7	0	0	7	0	0
8	29875822	.	A	T	1	2	3	0	0	3	0	0
8	29876237	.	G	A	1	3	4	0	0	4	0	0
8	29876284	.	A	G	2	2	4	0	0	4	0	0
8	29876291	.	A	C	2	2	4	0	0	4	0	0
8	29898834	.	T	C	1	0	1	0	4	5	0	0
8	29899209	.	T	C	4	4	8	0	0	8	0	0
8	29899248	.	T	C	2	6	8	0	0	8	0	0
8	29899302	.	C	T	1	4	5	0	6	11	0	0
8	29899318	.	T	C	8	6	14	0	0	14	0	0
8	29902904	.	T	C	0	3	3	0	0	3	0	0
8	29904949	.	G	T	2	2	4	0	0	4	0	0
8	29907414	.	C	A	1	4	5	0	0	5	0	0
8	29907494	.	A	G	2	2	4	0	0	4	0	0
8	29907560	.	C	G	2	2	4	0	0	4	0	0
8	29907621	.	G	A	3	2	5	0	0	5	0	0
8	29907648	.	A	C	4	2	6	0	0	6	0	0
8	30021383	.	C	T	1	0	1	0	0	1	0	0
8	30022126	.	G	C	0	2	2	0	1	3	0	0
8	30065861	.	T	G	2	0	2	0	2	4	0	0
8	30065865	.	A	C	2	0	2	0	2	4	0	0
8	30326228	.	G	A	2	7	9	0	0	9	0	0
8	30330694	.	A	T	1	1	2	0	2	4	0	0
8	30338875	.	C	G	3	4	7	0	0	7	0	0
8	30338887	.	G	A	4	3	7	0	0	7	0	0
8	30338926	.	C	T	3	6	9	0	0	9	0	0
8	30356647	.	G	A	1	2	3	0	0	3	0	0
8	30358354	.	G	A	1	2	3	0	0	3	0	0
8	30359873	.	C	A	1	2	3	0	0	3	0	0
8	30359887	.	G	T	1	2	3	0	0	3	0	0
8	30425782	.	G	C	2	6	8	0	0	8	0	0
8	30449771	.	A	T	2	2	4	0	0	4	0	0
8	30546140	.	C	T	4	2	6	0	0	6	0	0
8	30560867	.	C	T	1	4	5	0	0	5	0	0
8	30570193	.	G	T	0	2	2	0	0	2	0	0
8	30590805	.	A	G	2	4	6	0	0	6	0	0
8	30593567	.	G	A	3	8	11	0	0	11	0	0
8	30620073	.	C	T	0	3	3	0	0	3	0	0
8	30623994	.	C	T	6	6	12	0	1	13	0	0
8	30631057	.	C	T	2	2	4	0	0	4	0	0
8	30661270	.	C	T	4	11	15	0	0	15	0	0
8	30661565	.	A	G	10	0	10	0	13	23	0	0
8	30661645	.	G	A	8	7	15	0	0	15	0	0
8	30662366	.	A	T	4	2	6	0	0	6	0	0
8	30662481	.	T	C	12	7	19	0	0	19	0	0
8	30662505	.	A	T	10	3	13	0	2	15	0	0
8	30662713	.	C	T	4	2	6	0	0	6	0	0
8	30662793	.	A	T	1	2	3	0	1	4	0	0
8	30681344	.	C	A	1	2	3	0	0	3	0	0
8	30731187	.	A	G	4	6	10	0	0	10	0	0
8	30731492	.	C	T	0	2	2	0	1	3	0	0
8	30735082	.	T	A	12	8	20	0	0	20	0	0
8	30742130	.	C	T	0	5	5	0	9	14	0	0
8	30743321	.	T	C	3	5	8	0	0	8	0	0
8	30743345	.	A	G	5	4	9	0	0	9	0	0
8	30744468	.	G	A	0	8	8	0	1	9	0	0
8	30744528	.	C	T	3	0	3	0	0	3	0	0
8	30745437	.	A	G	2	3	5	0	0	5	0	0
8	31119730	.	A	G	3	5	8	0	1	9	0	0
8	31119865	.	T	C	2	5	7	0	0	7	0	0
8	31119909	.	T	G	10	0	10	0	12	22	0	0
8	31123029	.	T	C	6	4	10	0	0	10	0	0
8	31131277	.	A	G	3	1	4	0	1	5	0	0
8	31131394	.	A	C	4	3	7	0	0	7	0	0
8	31142074	.	G	A	23	19	42	0	10	52	0	0
8	31146748	.	G	A	20	19	39	0	3	42	0	0
8	31146913	.	G	A	21	20	41	0	6	47	0	0
8	31147380	.	T	G	23	22	45	0	1	46	0	0
8	31147526	.	G	A	25	22	47	0	0	47	0	0
8	31249605	.	A	G	16	12	28	0	0	28	0	0
8	31249881	.	T	A	12	20	32	0	1	33	0	0
8	31249941	.	T	A	15	15	30	0	0	30	0	0
8	31250183	.	C	A	17	12	29	0	1	30	0	0
8	31250357	.	A	G	15	1	16	0	12	28	0	0
8	31250384	.	T	G	14	15	29	0	0	29	0	0
8	31251091	.	A	G	19	15	34	0	1	35	0	0
8	31251129	.	G	A	19	16	35	0	2	37	0	0
8	31251222	.	T	C	10	22	32	0	1	33	0	0
8	31251354	.	T	C	18	18	36	0	0	36	0	0
8	31251426	.	T	C	15	22	37	0	0	37	0	0
8	31251510	.	C	A	18	18	36	0	2	38	0	0
8	31251555	.	G	A	1	21	22	0	18	40	0	0
8	31251792	.	G	C	0	25	25	0	16	41	0	0
8	31253722	.	T	C	11	17	28	0	0	28	0	0
8	31254046	.	C	A	13	11	24	0	0	24	0	0
8	31254176	.	A	T	9	23	32	0	1	33	0	0
8	31254219	.	T	C	12	16	28	0	2	30	0	0
8	31368010	.	G	A	16	10	26	0	2	28	0	0
8	31368279	.	T	G	7	6	13	0	1	14	0	0
8	31368524	.	C	T	7	9	16	0	0	16	0	0
8	31368557	.	A	G	6	7	13	0	0	13	0	0
8	31368611	.	T	C	1	3	4	0	0	4	0	0
8	31368889	.	C	T	4	2	6	0	0	6	0	0
8	31369071	.	G	C	4	8	12	0	2	14	0	0
8	31375260	.	A	T	1	2	3	0	0	3	0	0
8	31375338	.	T	C	0	5	5	0	0	5	0	0
8	31375400	.	C	T	5	8	13	0	2	15	0	0
8	31375405	.	T	C	7	7	14	0	1	15	0	0
8	31375529	.	T	C	15	5	20	0	0	20	0	0
8	31375549	.	C	T	11	3	14	0	2	16	0	0
8	31375670	.	T	G	13	22	35	0	0	35	0	0
8	31375928	.	A	G	4	5	9	0	0	9	0	0
8	31379542	.	C	T	0	2	2	0	4	6	0	0
8	31387695	.	A	G	11	9	20	0	0	20	0	0
8	31387728	.	T	G	11	9	20	0	1	21	0	0
8	31390061	.	T	C	4	2	6	0	0	6	0	0
8	31393235	.	G	A	8	3	11	0	0	11	0	0
8	31393376	.	G	A	6	6	12	0	0	12	0	0
8	31395397	.	C	T	1	1	2	0	1	3	0	0
8	31395400	.	C	T	0	3	3	0	1	4	0	0
8	31395471	.	A	G	3	9	12	0	0	12	0	0
8	31395632	.	A	C	5	4	9	0	0	9	0	0
8	31400775	.	A	G	1	0	1	0	0	1	0	0
8	31406847	.	G	C	13	0	13	0	6	19	0	0
8	31407126	.	A	T	9	12	21	0	1	22	0	0
8	31407153	.	C	T	12	12	24	0	0	24	0	0
8	31407294	.	A	G	1	5	6	0	1	7	0	0
8	31411089	.	C	T	0	9	9	0	8	17	0	0
8	31411578	.	G	A	8	13	21	0	0	21	0	0
8	31411646	.	T	A	2	3	5	0	0	5	0	0
8	31416821	.	G	C	2	2	4	0	0	4	0	0
8	31416822	.	C	A	1	2	3	0	1	4	0	0
8	31437497	.	G	C	5	6	11	0	0	11	0	0
8	31437611	.	C	T	12	16	28	0	0	28	0	0
8	31437768	.	C	G	4	3	7	0	0	7	0	0
8	31441698	.	C	A	21	10	31	0	2	33	0	0
8	31441724	.	G	T	19	8	27	0	4	31	0	0
8	31441733	.	C	A	9	21	30	0	0	30	0	0
8	31441850	.	T	C	28	12	40	0	0	40	0	0
8	31442000	.	G	A	27	20	47	0	1	48	0	0
8	31442595	.	G	A	16	14	30	0	1	31	0	0
8	31442886	.	T	C	26	13	39	0	2	41	0	0
8	31443023	.	A	C	24	23	47	0	8	55	0	0
8	31693405	.	A	G	1	2	3	0	0	3	0	0
8	31705267	.	G	A	20	19	39	0	2	41	0	0
8	31710941	.	G	A	7	8	15	0	0	15	0	0
8	31711411	.	T	C	11	1	12	0	13	25	0	0
8	31730813	.	A	C	5	4	9	0	1	10	0	0
8	31756640	.	A	G	1	1	2	0	0	2	0	0
8	31760785	.	C	T	1	4	5	0	1	6	0	0
8	31817931	.	A	C	0	1	1	0	0	1	0	0
8	31818018	.	T	C	20	13	33	0	1	34	0	0
8	31818022	.	G	A	0	11	11	0	24	35	0	0
8	31818083	.	A	T	15	15	30	0	1	31	0	0
8	31818196	.	G	A	14	28	42	0	0	42	0	0
8	31818267	.	T	G	8	28	36	0	0	36	0	0
8	31818273	.	T	A	8	25	33	0	1	34	0	0
8	31818335	.	G	A	8	11	19	0	0	19	0	0
8	31818349	.	A	C	10	12	22	0	1	23	0	0
8	31818460	.	A	G	4	5	9	0	0	9	0	0
8	31818549	.	C	T	6	5	11	0	0	11	0	0
8	31818748	.	T	C	5	11	16	0	1	17	0	0
8	31818800	.	G	A	7	11	18	0	0	18	0	0
8	31818835	.	T	G	9	14	23	0	1	24	0	0
8	31850955	.	A	T	12	17	29	0	1	30	0	0
8	31850976	.	G	T	17	17	34	0	0	35	1	0
8	31851150	.	A	C	12	10	22	0	0	22	0	0
8	31851270	.	G	A	12	11	23	0	0	23	0	0
8	31851333	.	G	T	11	12	23	0	0	23	0	0
8	31851336	.	A	G	11	11	22	0	1	23	0	0
8	31851582	.	A	G	3	4	7	0	0	7	0	0
8	31851594	.	T	C	0	1	1	0	0	1	0	0
8	31861425	.	A	G	9	12	21	0	1	22	0	0
8	31861580	.	G	A	14	22	36	0	0	36	0	0
8	31861616	.	T	A	13	21	34	0	1	35	0	0
8	31861746	.	C	T	15	15	30	0	3	33	0	0
8	31862063	.	T	C	18	10	28	0	0	28	0	0
8	31862179	.	A	G	14	19	33	0	2	35	0	0
8	31862312	.	G	A	0	22	22	0	18	40	0	0
8	31862584	.	G	T	15	8	23	0	0	23	0	0
8	31862846	.	T	A	7	3	10	0	0	10	0	0
8	31862848	.	C	A	7	3	10	0	0	10	0	0
8	31888723	.	C	T	1	2	3	0	1	4	0	0
8	31901757	.	T	C	2	6	8	0	2	10	0	0
8	31901760	.	C	T	3	7	10	0	0	10	0	0
8	31901925	.	G	A	9	13	22	0	0	22	0	0
8	31906886	.	G	A	2	2	4	0	0	4	0	0
8	31906910	.	C	A	5	10	15	0	0	15	0	0
8	31906927	.	G	A	10	15	25	0	1	26	0	0
8	31919110	.	A	C	2	0	2	0	4	6	0	0
8	31919526	.	C	A	8	16	24	0	2	26	0	0
8	31919558	.	A	C	9	22	31	0	0	31	0	0
8	31941679	.	C	T	4	5	9	0	0	9	0	0
8	31941746	.	C	A	14	9	23	0	1	24	0	0
8	31941853	.	C	T	6	10	16	0	1	17	0	0
8	31941904	.	T	A	8	3	11	0	1	12	0	0
8	31942771	.	C	T	6	12	18	0	1	19	0	0
8	31943276	.	G	A	4	5	9	0	0	9	0	0
8	31943301	.	T	G	7	4	11	0	0	11	0	0
8	31943357	.	T	C	3	2	5	0	0	5	0	0
8	32028856	.	G	T	4	5	9	0	0	9	0	0
8	32028921	.	T	A	4	3	7	0	0	7	0	0
8	32029044	.	T	G	9	6	15	0	0	15	0	0
8	32029218	.	T	C	9	2	11	0	0	11	0	0
8	32029258	.	T	C	2	7	9	0	0	9	0	0
8	32029572	.	T	C	5	3	8	0	1	9	0	0
8	32029573	.	T	C	4	0	4	0	5	9	0	0
8	32029843	.	T	C	3	3	6	0	0	6	0	0
8	32029881	.	G	T	1	2	3	0	0	3	0	0
8	32029882	.	A	T	1	2	3	0	0	3	0	0
8	32030087	.	G	A	4	2	6	0	0	6	0	0
8	32030341	.	A	G	7	8	15	0	0	15	0	0
8	32030538	.	G	A	3	3	6	0	0	6	0	0
8	32030771	.	T	G	6	4	10	0	0	10	0	0
8	32191744	.	G	A	1	0	1	0	0	1	0	0
8	32390401	.	A	G	1	2	3	0	0	3	0	0
8	32486956	.	C	T	0	12	12	0	16	28	0	0
8	32497755	.	T	C	4	4	8	0	0	8	0	0
8	32501541	.	A	G	5	3	8	0	0	8	0	0
8	32506134	.	T	C	4	4	8	0	1	9	0	0
8	32506215	.	T	C	4	0	4	0	3	7	0	0
8	32516296	.	A	G	9	10	19	0	0	19	0	0
8	32588542	.	G	T	0	0	0	0	2	2	0	0
8	32598954	.	A	G	1	2	3	0	1	4	0	0
8	32598963	.	C	G	2	0	2	0	3	5	0	0
8	32599147	.	G	A	13	8	21	0	0	21	0	0
8	32599288	.	T	C	3	4	7	0	0	7	0	0
8	32599295	.	A	G	2	5	7	0	1	8	0	0
8	32599413	.	T	C	8	7	15	0	0	15	0	0
8	32599586	.	C	T	10	4	14	0	0	14	0	0
8	32599795	.	G	A	4	4	8	0	2	10	0	0
8	32914931	.	T	C	13	4	17	0	1	18	0	0
8	32949287	.	C	T	0	5	5	0	3	8	0	0
8	33113932	.	A	G	3	3	6	0	0	6	0	0
8	33114094	.	T	A	5	12	17	0	1	18	0	0
8	33896450	.	A	G	3	10	13	0	1	14	0	0
8	33896524	.	G	T	12	10	22	0	0	22	0	0
8	33896585	.	C	T	19	26	45	0	1	46	0	0
8	33896698	.	A	G	17	23	40	0	1	41	0	0
8	33896902	.	G	A	24	19	43	0	3	46	0	0
8	33896964	.	T	G	19	18	37	0	1	38	0	0
8	33897266	.	T	C	20	1	21	0	30	51	0	0
8	33910017	.	G	A	16	21	37	0	0	37	0	0
8	33918520	.	C	T	7	7	14	0	2	16	0	0
8	33924284	.	A	G	2	9	11	0	1	12	0	0
8	33924333	.	G	T	19	25	44	0	2	46	0	0
8	34051619	.	G	T	23	14	37	0	1	38	0	0
8	34051719	.	G	A	20	5	25	0	0	25	0	0
8	34051850	.	G	A	10	10	20	0	3	23	0	0
8	34342146	.	G	A	7	15	22	0	0	22	0	0
8	34342214	.	A	T	12	10	22	0	0	22	0	0
8	34342462	.	A	G	8	6	14	1	1	16	0	0
8	34345285	.	G	A	6	5	11	0	0	11	0	0
8	34345372	.	T	C	12	22	34	0	0	34	0	0
8	34345390	.	A	G	11	17	28	0	0	28	0	0
8	34345583	.	A	G	0	1	1	0	0	1	0	0
8	34347281	.	T	C	10	16	26	0	5	31	0	0
8	34348958	.	A	C	2	5	7	0	0	7	0	0
8	34376264	.	G	A	4	1	5	0	0	5	0	0
8	34376728	.	G	A	8	4	12	0	1	13	0	0
8	34390998	.	C	T	0	7	7	0	5	12	0	0
8	35580986	.	C	T	0	2	2	0	0	2	0	0
8	35759213	.	G	C	3	2	5	0	1	6	0	0
8	35759363	.	T	G	3	2	5	0	1	6	0	0
8	35759402	.	C	T	1	3	4	0	1	5	0	0
8	35759444	.	C	T	3	4	7	0	0	7	0	0
8	35759726	.	C	T	7	3	10	0	0	10	0	0
8	35759999	.	C	T	4	4	8	0	2	10	0	0
8	35760218	.	C	T	4	3	7	0	0	7	0	0
8	35760423	.	C	T	0	1	1	0	0	1	0	0
8	35950512	.	C	T	1	0	1	0	0	1	0	0
8	35950515	.	G	A	1	0	1	0	0	1	0	0
8	36058699	.	G	A	1	3	4	0	0	4	0	0
8	36059836	.	T	A	2	1	3	0	0	3	0	0
8	36059886	.	A	T	0	2	2	0	0	2	0	0
8	36062021	.	A	T	1	2	3	0	0	3	0	0
8	36062714	.	A	G	0	3	3	0	0	3	0	0
8	36504059	.	A	G	3	0	3	0	2	5	0	0
8	36504089	.	T	C	3	3	6	0	0	6	0	0
8	36504185	.	T	C	4	2	6	0	0	6	0	0
8	36504282	.	C	T	2	2	4	0	0	4	0	0
8	36504728	.	T	G	3	3	6	0	0	6	0	0
8	36507344	.	C	T	3	3	6	0	0	6	0	0
8	36507449	.	T	C	2	4	6	0	0	6	0	0
8	36507470	.	C	T	4	3	7	0	0	7	0	0
8	36512804	.	G	A	0	2	2	0	3	5	0	0
8	36515721	.	A	G	3	2	5	0	0	5	0	0
8	36515779	.	G	A	0	5	5	0	1	6	0	0
8	36560180	.	C	T	2	4	6	0	0	6	0	0
8	36561942	.	A	T	14	10	24	0	1	26	1	0
8	36562451	.	A	G	1	0	1	0	1	2	0	0
8	36564005	.	A	G	21	8	29	0	1	30	0	0
8	36566125	.	C	T	12	5	17	0	1	18	0	0
8	36566167	.	G	A	26	8	34	0	2	36	0	0
8	36566182	.	T	C	26	10	36	0	0	36	0	0
8	36566353	.	T	C	6	6	12	0	1	13	0	0
8	36567283	.	C	T	22	19	41	0	5	46	0	0
8	36568561	.	A	G	5	6	11	0	1	12	0	0
8	36568755	.	T	C	0	1	1	0	0	1	0	0
8	36569810	.	T	C	5	0	5	0	1	6	0	0
8	36569924	.	C	A	11	8	19	0	1	20	0	0
8	36569925	.	T	A	11	9	20	0	0	20	0	0
8	36569968	.	A	C	13	9	22	0	0	22	0	0
8	36569990	.	A	G	13	9	22	0	0	22	0	0
8	36570147	.	T	C	2	3	5	0	0	5	0	0
8	36570569	.	C	G	1	2	3	0	0	3	0	0
8	36570602	.	A	G	1	1	2	0	0	2	0	0
8	36571018	.	A	C	0	1	1	0	0	1	0	0
8	36571187	.	A	G	1	0	1	0	0	1	0	0
8	36571231	.	T	G	1	0	1	0	0	1	0	0
8	36573472	.	T	C	2	2	4	0	0	4	0	0
8	36573727	.	T	C	1	2	3	0	0	3	0	0
8	36573742	.	C	T	2	2	4	0	0	4	0	0
8	36573832	.	A	T	2	3	5	0	0	5	0	0
8	36573835	.	A	G	2	0	2	0	3	5	0	0
8	36575325	.	T	C	0	1	1	0	0	1	0	0
8	36577143	.	C	T	1	3	4	0	0	4	0	0
8	36577158	.	T	C	1	3	4	0	0	4	0	0
8	36583834	.	T	C	3	3	6	0	0	6	0	0
8	36587934	.	A	G	10	5	15	0	2	17	0	0
8	36587936	.	A	G	11	0	11	0	6	17	0	0
8	36587970	.	C	A	13	12	25	0	1	26	0	0
8	36587981	.	G	T	9	9	18	0	5	23	0	0
8	36588124	.	G	A	1	7	8	0	0	8	0	0
8	36589197	.	C	T	6	7	13	0	1	14	0	0
8	36589260	.	T	A	4	4	8	0	2	10	0	0
8	36591868	.	A	C	6	6	12	0	0	12	0	0
8	36591985	.	C	T	10	4	14	0	0	14	0	0
8	36592018	.	A	G	6	4	10	0	0	10	0	0
8	36592021	.	C	A	0	3	3	0	7	10	0	0
8	36592159	.	A	G	4	5	9	0	0	9	0	0
8	36592160	.	A	G	4	5	9	0	0	9	0	0
8	36592297	.	G	A	5	8	13	0	1	14	0	0
8	36592374	.	A	G	4	3	7	0	0	7	0	0
8	36594354	.	T	C	3	0	3	0	2	5	0	0
8	36598244	.	T	C	7	0	7	0	1	8	0	0
8	36598441	.	C	T	0	4	4	0	6	10	0	0
8	36600867	.	C	T	6	4	10	0	0	10	0	0
8	36600879	.	G	A	4	2	6	0	0	6	0	0
8	36602459	.	C	T	1	1	2	0	0	2	0	0
8	36617635	.	C	G	2	6	8	0	0	8	0	0
8	36617669	.	A	G	5	11	16	0	0	16	0	0
8	36617728	.	G	A	6	7	13	0	0	13	0	0
8	36617954	.	C	T	5	8	13	0	0	13	0	0
8	36743554	.	C	T	1	2	3	0	0	3	0	0
8	36746770	.	T	A	0	2	2	0	0	2	0	0
8	36746826	.	T	A	1	2	3	0	0	3	0	0
8	36750219	.	T	C	2	3	5	0	0	5	0	0
8	36750222	.	C	T	2	3	5	0	0	5	0	0
8	36781593	.	G	A	0	2	2	0	3	5	0	0
8	36781596	.	A	G	1	0	1	0	4	5	0	0
8	36783396	.	C	T	6	6	12	0	0	12	0	0
8	36785572	.	A	C	0	8	8	0	1	9	0	0
8	36785599	.	T	C	1	1	2	0	1	3	0	0
8	36803687	.	G	A	6	9	15	0	1	16	0	0
8	36803717	.	G	A	0	13	13	0	7	20	0	0
8	36803850	.	T	C	4	1	5	0	0	5	0	0
8	36951346	.	C	T	13	15	28	0	0	28	0	0
8	36951481	.	C	T	13	11	24	0	1	25	0	0
8	36951610	.	T	C	10	10	20	0	0	20	0	0
8	36952015	.	A	G	15	0	15	0	19	34	0	0
8	36953884	.	A	G	1	6	7	0	0	7	0	0
8	36953947	.	C	T	11	10	21	0	0	22	1	0
8	36953950	.	G	C	10	10	20	0	2	22	0	0
8	36956254	.	C	T	15	12	27	0	1	28	0	0
8	36956269	.	T	C	13	11	24	0	0	24	0	0
8	36959694	.	C	T	3	4	7	0	0	7	0	0
8	36959915	.	T	A	2	1	3	0	1	4	0	0
8	36961895	.	C	A	16	22	38	0	0	38	0	0
8	36964126	.	G	A	16	15	31	0	1	32	0	0
8	36974328	.	C	T	21	15	36	0	3	39	0	0
8	36974514	.	C	T	30	18	48	0	1	49	0	0
8	36975826	.	A	G	15	9	24	0	2	26	0	0
8	36975928	.	T	C	13	12	25	0	0	25	0	0
8	36976089	.	T	C	8	13	21	0	0	21	0	0
8	36976247	.	A	C	4	6	10	0	0	10	0	0
8	36976255	.	T	G	3	6	9	0	0	9	0	0
8	36976288	.	T	A	3	5	8	0	0	8	0	0
8	36976388	.	A	T	20	11	31	0	0	31	0	0
8	36976432	.	T	A	15	19	34	0	1	35	0	0
8	36976557	.	G	A	12	15	27	0	1	28	0	0
8	36976836	.	C	A	17	18	35	0	2	38	1	0
8	36977178	.	A	G	25	16	41	0	1	42	0	0
8	36977199	.	C	A	22	15	37	0	1	38	0	0
8	36977520	.	G	A	20	17	37	0	3	40	0	0
8	36977848	.	T	C	9	15	24	0	0	24	0	0
8	36983676	.	A	T	5	4	9	0	1	10	0	0
8	37007868	.	A	G	0	3	3	0	0	3	0	0
8	37009605	.	C	T	1	0	1	0	0	1	0	0
8	37009674	.	C	G	4	0	4	0	5	9	0	0
8	37010662	.	T	C	4	3	7	0	0	7	0	0
8	37012825	.	C	T	5	3	8	0	0	8	0	0
8	37012872	.	C	G	2	1	3	0	0	3	0	0
8	37013093	.	A	G	8	6	14	0	1	15	0	0
8	37013255	.	T	C	6	5	11	0	0	11	0	0
8	37013282	.	T	C	4	3	7	0	1	8	0	0
8	37014582	.	T	C	7	9	16	0	1	17	0	0
8	37016584	.	G	T	0	15	15	0	13	28	0	0
8	37016616	.	C	T	11	14	25	0	1	26	0	0
8	37016638	.	A	G	12	14	26	0	2	28	0	0
8	37016784	.	G	A	1	13	14	0	2	16	0	0
8	37016790	.	T	C	3	11	14	0	1	15	0	0
8	37017149	.	G	A	2	5	7	0	0	7	0	0
8	37017159	.	C	T	1	5	6	0	1	7	0	0
8	37019048	.	G	A	11	9	20	0	0	20	0	0
8	37019062	.	C	A	12	14	26	0	1	27	0	0
8	37025576	.	A	T	17	11	28	0	3	31	0	0
8	37025614	.	T	A	8	6	14	0	0	14	0	0
8	37025633	.	A	G	2	0	2	0	1	3	0	0
8	37025896	.	T	C	7	8	15	0	2	17	0	0
8	37026130	.	G	A	12	9	21	0	0	21	0	0
8	37060595	.	A	C	7	5	12	0	2	14	0	0
8	37075113	.	T	C	2	2	4	0	0	4	0	0
8	37075172	.	A	G	2	4	6	0	0	6	0	0
8	37075179	.	A	G	2	4	6	0	0	6	0	0
8	37075209	.	A	T	1	4	5	0	0	5	0	0
8	37075742	.	T	A	2	2	4	0	0	4	0	0
8	37101346	.	T	C	3	5	8	0	0	8	0	0
8	37101370	.	G	C	5	3	8	0	0	8	0	0
8	37232122	.	C	T	0	5	5	0	6	11	0	0
8	37232189	.	A	C	10	1	11	0	6	17	0	0
8	37232442	.	A	C	11	1	12	0	18	30	0	0
8	37232487	.	A	C	12	24	36	0	2	38	0	0
8	37239141	.	C	T	0	4	4	0	8	12	0	0
8	37241078	.	A	G	7	1	8	0	2	10	0	0
8	37242367	.	T	G	3	4	7	0	0	7	0	0
8	37242374	.	A	T	3	3	6	0	1	7	0	0
8	37242438	.	T	C	2	3	5	0	0	5	0	0
8	37249727	.	C	T	0	9	9	0	5	14	0	0
8	37249732	.	A	T	6	9	15	0	0	15	0	0
8	37280726	.	C	T	7	13	20	0	0	20	0	0
8	37280858	.	C	T	13	8	21	0	0	21	0	0
8	37281109	.	T	C	14	21	35	0	2	37	0	0
8	37282486	.	A	C	24	14	38	0	1	39	0	0
8	37282487	.	G	T	23	14	37	0	2	39	0	0
8	37282610	.	G	A	28	7	35	0	0	35	0	0
8	37282752	.	C	T	28	23	51	0	0	51	0	0
8	37282866	.	T	G	12	26	38	0	2	40	0	0
8	37282950	.	T	G	7	16	23	0	1	24	0	0
8	37282976	.	G	A	8	14	22	0	1	23	0	0
8	37283487	.	A	C	8	8	16	0	0	17	1	0
8	37283536	.	G	A	9	10	19	0	0	19	0	0
8	37283986	.	A	G	2	7	9	0	0	9	0	0
8	37284018	.	A	T	2	7	9	0	0	9	0	0
8	37284046	.	T	C	4	0	4	0	9	13	0	0
8	37294918	.	C	T	0	19	19	0	12	31	0	0
8	37294923	.	G	A	9	18	27	0	3	30	0	0
8	37297524	.	C	T	0	3	3	0	0	3	0	0
8	37303891	.	G	A	1	6	7	0	0	7	0	0
8	37305515	.	G	C	2	0	2	0	0	2	0	0
8	37306114	.	A	G	2	2	4	0	0	4	0	0
8	37311888	.	T	A	7	7	14	0	0	14	0	0
8	37316284	.	G	A	2	1	3	0	0	3	0	0
8	37317224	.	G	A	3	3	6	0	0	6	0	0
8	37317248	.	G	A	5	6	11	0	0	11	0	0
8	37317290	.	G	T	6	6	12	0	6	18	0	0
8	37320810	.	A	T	8	5	13	0	0	13	0	0
8	37453403	.	A	G	2	3	5	0	1	6	0	0
8	37453683	.	G	A	1	0	1	0	0	1	0	0
8	37456522	.	A	T	1	0	1	0	0	1	0	0
8	37456826	.	C	A	6	6	12	0	0	12	0	0
8	37460743	.	T	C	1	0	1	0	3	4	0	0
8	37460746	.	C	T	0	3	3	0	1	4	0	0
8	37460985	.	T	C	1	2	3	0	0	3	0	0
8	37461060	.	C	T	0	2	2	0	0	2	0	0
8	37461780	.	A	G	4	3	7	0	0	7	0	0
8	39816893	.	G	A	2	4	6	0	0	6	0	0
8	39819518	.	T	A	1	1	2	0	1	3	0	0
8	39822845	.	A	G	1	3	4	0	0	4	0	0
8	39848967	.	A	T	7	4	11	0	1	12	0	0
8	39849354	.	C	T	5	4	9	0	1	10	0	0
8	39849373	.	A	T	6	2	8	0	0	8	0	0
8	39849394	.	C	G	5	3	8	0	1	9	0	0
8	39849466	.	A	C	3	4	7	0	0	7	0	0
8	39849524	.	C	T	5	8	13	0	0	13	0	0
8	39849617	.	A	G	6	7	13	0	0	13	0	0
8	39849686	.	C	G	3	4	7	0	0	7	0	0
8	39849688	.	T	C	3	4	7	0	0	7	0	0
8	39849728	.	A	T	4	7	11	0	0	11	0	0
8	39849767	.	A	T	3	8	11	0	1	12	0	0
8	39849791	.	A	G	3	5	8	0	0	8	0	0
8	39850031	.	C	A	4	2	6	0	1	7	0	0
8	39850149	.	C	T	5	6	11	0	1	12	0	0
8	39850157	.	A	G	5	6	11	0	2	13	0	0
8	39850455	.	G	A	7	3	10	0	0	10	0	0
8	39850475	.	C	T	5	5	10	0	0	10	0	0
8	39850500	.	C	G	3	6	9	0	1	10	0	0
8	39850625	.	T	A	7	8	15	0	0	15	0	0
8	39850759	.	C	T	3	3	6	0	1	7	0	0
8	39850776	.	A	T	3	3	6	0	0	6	0	0
8	39851046	.	T	C	3	3	6	0	0	6	0	0
8	39851386	.	A	G	1	5	6	0	0	6	0	0
8	39851699	.	T	G	1	2	3	0	1	4	0	0
8	39851709	.	G	T	1	2	3	0	2	5	0	0
8	39851966	.	T	G	1	2	3	0	0	3	0	0
8	39852036	.	G	T	3	2	5	0	0	5	0	0
8	39852514	.	C	T	4	5	9	0	0	9	0	0
8	39858164	.	T	C	1	0	1	0	1	2	0	0
8	39859520	.	T	C	2	0	2	0	6	8	0	0
8	39870752	.	G	T	3	4	7	0	0	7	0	0
8	39870765	.	C	T	0	2	2	0	5	7	0	0
8	39870975	.	C	T	4	6	10	0	0	10	0	0
8	39876339	.	G	A	3	2	5	0	1	6	0	0
8	39878550	.	C	T	4	3	7	0	1	8	0	0
8	39901781	.	A	G	3	1	4	0	0	4	0	0
8	40028827	.	C	T	1	2	3	0	0	3	0	0
8	40081408	.	G	C	6	11	17	0	0	17	0	0
8	40081462	.	T	G	9	12	21	0	1	22	0	0
8	40081718	.	T	C	6	9	15	0	1	16	0	0
8	40218288	.	C	T	6	4	10	0	1	11	0	0
8	40218290	.	C	T	7	4	11	0	0	11	0	0
8	40234640	.	C	T	3	8	11	0	1	12	0	0
8	40234830	.	A	G	5	6	11	0	0	11	0	0
8	40234831	.	T	A	4	6	10	0	1	11	0	0
8	40235184	.	A	T	0	6	6	0	0	6	0	0
8	40235192	.	C	T	7	1	8	0	0	8	0	0
8	40235219	.	A	G	6	1	7	0	0	7	0	0
8	40235244	.	C	T	1	3	4	0	0	4	0	0
8	40235281	.	G	A	0	4	4	0	0	4	0	0
8	40235348	.	G	C	3	3	6	0	1	7	0	0
8	40235419	.	T	A	1	2	3	0	0	3	0	0
8	40237799	.	C	A	3	4	7	1	0	8	0	0
8	40237906	.	C	T	3	9	12	0	0	12	0	0
8	40240922	.	C	G	11	6	17	0	0	17	0	0
8	40241441	.	A	G	12	13	25	6	2	33	0	0
8	40241446	.	A	G	12	16	28	6	0	34	0	0
8	40241640	.	A	T	8	8	16	1	0	18	1	0
8	40241681	.	A	G	25	10	35	0	1	36	0	0
8	40241695	.	T	A	26	7	33	0	2	35	0	0
8	40242103	.	G	A	16	12	28	0	0	28	0	0
8	40242453	.	G	A	9	13	22	0	1	23	0	0
8	40242613	.	T	A	7	7	14	0	3	17	0	0
8	40242653	.	C	T	8	8	16	0	2	18	0	0
8	40243052	.	G	C	15	12	27	0	0	27	0	0
8	40243148	.	T	C	20	12	32	0	1	33	0	0
8	40248373	.	T	G	8	9	17	0	1	18	0	0
8	40248673	.	T	C	1	0	1	0	0	1	0	0
8	40248976	.	G	T	5	6	11	0	1	12	0	0
8	40251444	.	T	G	13	18	31	0	0	31	0	0
8	40251834	.	C	A	17	7	24	0	0	24	0	0
8	40252508	.	C	T	1	3	4	0	8	12	0	0
8	40254366	.	A	G	12	11	23	0	0	23	0	0
8	40254375	.	T	G	8	12	20	0	4	24	0	0
8	40270856	.	G	A	3	4	7	0	1	8	0	0
8	40325709	.	G	T	11	5	16	0	0	16	0	0
8	40326039	.	A	G	10	18	28	0	3	31	0	0
8	40326128	.	C	T	18	16	34	0	0	34	0	0
8	40326736	.	A	G	9	5	14	0	0	14	0	0
8	40427500	.	T	C	2	3	5	0	1	6	0	0
8	40427540	.	T	C	4	2	6	0	0	6	0	0
8	40427737	.	T	A	3	4	7	0	0	7	0	0
8	40427912	.	T	C	2	5	7	0	0	7	0	0
8	40427932	.	T	C	1	4	5	0	1	6	0	0
8	40429846	.	G	A	2	3	5	0	1	6	0	0
8	40430038	.	C	A	0	6	6	0	1	7	0	0
8	40430293	.	C	T	0	4	4	0	3	7	0	0
8	40430322	.	A	G	1	3	4	0	3	7	0	0
8	40430599	.	T	A	5	3	8	0	0	8	0	0
8	40430664	.	G	A	3	5	8	0	0	8	0	0
8	40430771	.	A	G	5	3	8	0	1	9	0	0
8	40430902	.	T	A	4	4	8	0	2	10	0	0
8	40430934	.	A	G	3	2	5	0	1	6	0	0
8	40631823	.	C	T	1	2	3	0	0	3	0	0
8	40632014	.	T	C	3	5	8	0	0	8	0	0
8	40632065	.	T	C	3	5	8	0	1	9	0	0
8	40632411	.	A	T	5	3	8	0	1	9	0	0
8	40632534	.	G	A	2	5	7	0	0	7	0	0
8	40633172	.	G	C	3	3	6	0	0	6	0	0
8	40644876	.	T	G	10	8	18	0	0	18	0	0
8	40645165	.	C	T	6	4	10	0	0	10	0	0
8	40646154	.	C	T	9	11	20	0	0	20	0	0
8	41462515	.	A	G	21	7	28	0	1	29	0	0
8	41468269	.	C	T	9	4	13	0	1	14	0	0
8	42075668	.	A	T	4	3	7	0	0	7	0	0
8	42075701	.	A	G	2	0	2	0	1	3	0	0
8	42138863	.	C	T	4	5	9	0	0	9	0	0
8	42138878	.	G	A	5	5	10	0	1	11	0	0
8	42238507	.	A	G	1	4	5	0	0	5	0	0
8	42238508	.	C	A	1	4	5	0	0	5	0	0
8	42642058	.	A	T	8	9	17	0	1	18	0	0
8	42642120	.	C	A	0	7	7	0	4	11	0	0
8	42642139	.	T	C	7	7	14	0	0	14	0	0
8	42642235	.	A	G	15	17	32	0	0	32	0	0
8	42642683	.	G	A	8	5	13	0	0	13	0	0
8	42642879	.	G	A	7	10	17	0	0	17	0	0
8	42642941	.	G	T	8	6	14	0	0	14	0	0
8	42655774	.	G	T	4	3	7	0	1	8	0	0
8	42688733	.	T	C	4	1	5	0	1	6	0	0
8	42689198	.	G	A	5	2	7	0	0	7	0	0
8	42689252	.	G	A	3	2	5	0	0	5	0	0
8	42689483	.	A	T	2	4	6	0	1	7	0	0
8	42689492	.	G	A	1	5	6	0	0	6	0	0
8	42689764	.	G	T	5	3	8	0	0	8	0	0
8	42689805	.	T	C	1	3	4	0	1	5	0	0
8	42689922	.	A	T	2	3	5	0	0	5	0	0
8	42689924	.	C	T	2	2	4	0	1	5	0	0
8	42689992	.	G	T	3	4	7	0	0	7	0	0
8	42690618	.	T	C	5	3	8	0	0	8	0	0
8	42690638	.	T	A	2	2	4	0	0	4	0	0
8	42691252	.	T	C	4	2	6	0	1	7	0	0
8	42691632	.	C	T	1	2	3	0	1	4	0	0
8	42691634	.	G	A	2	2	4	0	0	4	0	0
8	43379779	.	T	C	17	21	38	0	1	39	0	0
8	43380067	.	G	A	15	19	34	0	3	37	0	0
8	43380290	.	A	T	10	15	25	0	1	26	0	0
8	43380543	.	T	G	7	16	23	0	0	23	0	0
8	43380781	.	C	T	0	10	10	0	15	25	0	0
8	43380905	.	A	T	8	9	17	0	0	17	0	0
8	43380923	.	C	T	0	7	7	0	9	16	0	0
8	43381239	.	A	T	9	9	18	0	0	18	0	0
8	43381306	.	A	T	15	19	34	0	1	35	0	0
8	43381417	.	T	G	6	10	16	0	0	16	0	0
8	43381500	.	A	G	9	8	17	0	0	17	0	0
8	43381664	.	A	T	11	14	25	0	1	26	0	0
8	43382046	.	A	T	18	20	38	0	3	41	0	0
8	43386194	.	G	A	12	11	23	0	1	24	0	0
8	43386677	.	T	A	10	14	24	0	1	25	0	0
8	43393575	.	C	A	0	9	9	0	11	20	0	0
8	43400484	.	A	G	1	6	7	0	0	7	0	0
8	43400820	.	G	A	10	13	23	0	1	24	0	0
8	43400880	.	G	A	7	10	17	0	1	18	0	0
8	43401134	.	A	G	3	2	5	0	0	5	0	0
8	43401161	.	T	C	8	0	8	0	3	11	0	0
8	43401423	.	G	A	1	0	1	0	1	2	0	0
8	43413787	.	C	T	1	8	9	0	2	11	0	0
8	43419175	.	C	T	0	1	1	0	4	5	0	0
8	43419763	.	A	C	3	8	11	0	1	12	0	0
8	43423931	.	C	T	6	5	11	0	0	11	0	0
8	43424006	.	C	T	1	0	1	0	0	1	0	0
8	43424205	.	C	T	4	8	12	0	0	12	0	0
8	43455875	.	G	A	4	1	5	0	0	5	0	0
8	43486712	.	T	C	3	6	9	0	0	9	0	0
8	43574555	.	A	T	3	3	6	0	0	6	0	0
8	43574781	.	G	A	5	3	8	0	0	8	0	0
8	43574792	.	A	G	3	3	6	0	1	7	0	0
8	43668521	.	A	G	7	8	15	0	0	15	0	0
8	43668716	.	T	G	15	17	32	0	2	34	0	0
8	43671871	.	C	T	3	4	7	0	0	7	0	0
8	43675370	.	G	A	8	8	16	0	1	17	0	0
8	43675698	.	T	A	7	6	13	0	1	14	0	0
8	43677718	.	T	C	3	7	10	0	0	10	0	0
8	43677736	.	A	C	3	1	4	0	0	4	0	0
8	43680500	.	T	C	6	3	9	0	4	13	0	0
8	43680510	.	A	G	11	3	14	0	0	14	0	0
8	43682544	.	A	G	1	2	3	0	0	3	0	0
8	43683133	.	G	A	2	4	6	0	1	7	0	0
8	43688847	.	G	A	3	3	6	0	0	6	0	0
8	43691854	.	G	T	0	2	2	0	0	2	0	0
8	43693140	.	A	C	2	2	4	0	0	4	0	0
8	43693392	.	A	G	2	1	3	0	0	3	0	0
8	43700886	.	T	C	3	0	3	0	0	3	0	0
8	43700901	.	T	A	3	1	4	0	1	5	0	0
8	43708440	.	C	T	0	1	1	0	0	1	0	0
8	43711819	.	G	T	3	5	8	0	1	9	0	0
8	43712309	.	A	C	1	2	3	0	0	3	0	0
8	43717174	.	A	T	3	2	5	0	0	5	0	0
8	43717198	.	T	A	3	2	5	0	0	5	0	0
8	43720325	.	T	C	0	4	4	0	0	4	0	0
8	43720343	.	T	C	1	2	3	0	0	3	0	0
8	43736215	.	A	C	2	2	4	0	0	4	0	0
8	43736354	.	G	T	3	2	5	0	0	5	0	0
8	43934966	.	G	A	7	5	12	0	1	13	0	0
8	43935120	.	A	G	16	20	36	0	0	36	0	0
8	43935351	.	A	T	5	5	10	0	0	10	0	0
8	43935481	.	C	T	6	17	23	0	1	24	0	0
8	43935552	.	A	G	8	8	16	0	0	16	0	0
8	43935679	.	A	T	2	5	7	0	0	7	0	0
8	43935680	.	A	C	2	5	7	0	0	7	0	0
8	43935731	.	C	T	5	8	13	0	0	13	0	0
8	43935879	.	C	G	5	7	12	0	0	12	0	0
8	43940148	.	C	A	3	2	5	0	0	5	0	0
8	43967218	.	A	G	2	3	5	0	0	5	0	0
8	43967698	.	A	G	3	2	5	0	1	6	0	0
8	43991452	.	G	C	5	3	8	0	0	8	0	0
8	44003950	.	A	G	0	4	4	0	0	4	0	0
8	44004004	.	A	C	4	5	9	0	0	9	0	0
8	45381962	.	G	A	5	1	6	0	0	6	0	0
8	45396028	.	T	C	3	1	4	0	2	6	0	0
8	45427189	.	C	A	3	4	7	0	0	7	0	0
8	45428039	.	C	T	16	16	32	0	1	33	0	0
8	45430757	.	G	A	7	6	13	0	0	13	0	0
8	45755732	.	C	T	25	23	48	0	2	50	0	0
8	45755973	.	C	G	18	17	35	0	0	35	0	0
8	45759960	.	C	T	15	6	21	0	0	21	0	0
8	45760071	.	A	C	17	0	17	0	6	23	0	0
8	45762654	.	C	T	0	3	3	0	2	5	0	0
8	45763350	.	C	T	1	1	2	0	1	3	0	0
8	45763511	.	T	G	2	5	7	0	1	8	0	0
8	45763537	.	A	T	13	4	17	0	2	19	0	0
8	45763562	.	G	A	16	11	27	0	0	27	0	0
8	45763670	.	C	T	22	15	37	0	2	39	0	0
8	45763872	.	T	A	19	5	24	0	4	28	0	0
8	45763991	.	A	G	17	21	38	0	0	38	0	0
8	45764006	.	G	C	23	18	41	0	2	43	0	0
8	45764884	.	G	A	8	16	24	0	0	24	0	0
8	45764893	.	T	C	19	7	26	0	0	26	0	0
8	45765170	.	C	T	1	9	10	0	17	27	0	0
8	45765188	.	A	T	8	3	11	0	2	13	0	0
8	45765326	.	G	A	16	16	32	0	1	33	0	0
8	45772961	.	G	C	22	12	34	0	1	35	0	0
8	45774471	.	C	T	0	2	2	0	1	3	0	0
8	45775089	.	C	T	8	14	22	0	1	23	0	0
8	45779729	.	A	C	7	10	17	0	0	17	0	0
8	45786186	.	C	T	0	4	4	0	1	5	0	0
8	45786612	.	G	T	8	7	15	0	0	15	0	0
8	45786615	.	A	G	8	7	15	0	0	15	0	0
8	45787137	.	A	G	6	11	17	0	0	17	0	0
8	45788941	.	T	G	7	9	16	0	0	16	0	0
8	45789130	.	T	C	2	2	4	0	0	4	0	0
8	45793550	.	A	C	6	5	11	0	0	11	0	0
8	45797305	.	G	A	2	0	2	0	0	2	0	0
8	45834940	.	G	A	1	7	8	0	1	9	0	0
8	45838228	.	C	T	3	3	6	0	0	6	0	0
8	45853067	.	C	T	2	3	5	0	0	5	0	0
8	45853465	.	C	A	0	3	3	0	4	7	0	0
8	45853475	.	G	A	2	5	7	0	0	7	0	0
8	45853533	.	T	C	4	2	6	0	1	7	0	0
8	45853574	.	A	G	2	4	6	0	0	6	0	0
8	45853626	.	G	A	5	8	13	0	0	13	0	0
8	45875593	.	T	C	3	0	3	0	0	3	0	0
8	45880074	.	T	A	0	1	1	0	0	1	0	0
8	45880125	.	G	A	4	3	7	0	0	7	0	0
8	45896997	.	T	C	0	0	0	0	1	1	0	0
8	45907117	.	C	T	0	1	1	0	0	1	0	0
8	45939385	.	G	A	0	1	1	0	0	1	0	0
8	45939398	.	A	G	0	2	2	0	0	2	0	0
8	45939533	.	G	C	1	4	5	0	1	6	0	0
8	45939585	.	G	A	1	5	6	0	0	6	0	0
8	45939607	.	A	G	1	4	5	0	0	5	0	0
8	45939648	.	C	G	1	1	2	0	0	3	1	0
8	45944896	.	T	A	3	2	5	0	2	7	0	0
8	45944983	.	G	A	7	6	13	0	0	13	0	0
8	45948718	.	G	A	11	6	17	0	0	17	0	0
8	45952152	.	A	T	8	3	11	0	0	11	0	0
8	45952231	.	T	C	10	4	14	0	0	14	0	0
8	45952352	.	G	C	9	3	12	0	0	12	0	0
8	45952423	.	A	G	9	4	13	0	0	13	0	0
8	45962391	.	G	C	1	4	5	0	0	5	0	0
8	45962432	.	G	T	2	2	4	0	0	4	0	0
8	45965749	.	G	A	1	3	4	0	1	5	0	0
8	45976125	.	G	A	1	2	3	0	0	3	0	0
8	45976132	.	A	T	1	2	3	0	0	3	0	0
8	45976758	.	A	G	0	2	2	0	0	2	0	0
8	46077675	.	A	G	4	4	8	0	0	8	0	0
8	46077757	.	C	T	7	7	14	0	0	14	0	0
8	46077819	.	G	A	16	5	21	0	0	21	0	0
8	46077832	.	T	A	17	2	19	0	0	19	0	0
8	46078168	.	C	A	4	3	7	0	0	7	0	0
8	46078264	.	A	T	9	7	16	0	0	16	0	0
8	46078287	.	A	G	8	6	14	0	0	14	0	0
8	46078309	.	C	T	6	6	12	0	1	13	0	0
8	46078342	.	C	G	6	9	15	0	0	15	0	0
8	46085480	.	A	T	8	5	13	0	0	13	0	0
8	46089037	.	G	T	0	3	3	0	0	3	0	0
8	46089052	.	T	C	0	3	3	0	0	3	0	0
8	46089634	.	C	T	11	8	19	0	0	19	0	0
8	46123731	.	G	A	5	0	5	0	0	5	0	0
8	46125509	.	G	A	0	4	4	0	0	4	0	0
8	46132662	.	G	C	2	0	2	0	2	4	0	0
8	46160980	.	C	T	0	1	1	0	0	1	0	0
8	46188003	.	A	G	5	3	8	0	0	8	0	0
8	46219729	.	G	A	0	1	1	0	0	1	0	0
8	46220848	.	A	C	1	13	14	0	0	14	0	0
8	46220963	.	A	G	5	0	5	0	8	13	0	0
8	46231128	.	A	G	2	2	4	0	0	4	0	0
8	46247717	.	T	C	1	4	5	0	0	5	0	0
8	46258216	.	A	G	4	5	9	0	1	10	0	0
8	46286410	.	T	C	1	1	2	0	0	2	0	0
8	46286443	.	G	A	1	1	2	0	0	2	0	0
8	46296796	.	G	A	0	2	2	0	0	2	0	0
8	46296851	.	T	C	1	2	3	0	1	4	0	0
8	46306002	.	G	A	2	4	6	0	0	6	0	0
8	46310897	.	A	G	2	2	4	0	0	4	0	0
8	46347183	.	A	G	7	0	7	0	4	11	0	0
8	46347356	.	A	G	3	2	5	0	1	6	0	0
8	46348083	.	A	T	5	4	9	0	1	10	0	0
8	46348121	.	G	A	0	2	2	0	5	7	0	0
8	46348178	.	A	G	5	5	10	0	1	11	0	0
8	46348391	.	T	A	3	4	7	0	0	7	0	0
8	46353290	.	G	C	0	2	2	0	0	2	0	0
8	46356282	.	G	A	0	1	1	0	0	1	0	0
8	46362082	.	G	A	1	1	2	0	0	2	0	0
8	46362083	.	G	T	1	1	2	0	0	2	0	0
8	47834998	.	G	A	2	4	6	0	3	9	0	0
8	47835146	.	T	C	5	3	8	0	0	8	0	0
8	47835148	.	C	T	5	3	8	0	0	8	0	0
8	47835307	.	A	T	2	5	7	0	0	7	0	0
8	47835337	.	A	G	3	3	6	0	0	6	0	0
8	47911031	.	C	G	5	0	5	0	3	8	0	0
8	47917304	.	C	T	6	6	12	0	0	12	0	0
8	47927814	.	C	T	2	1	3	0	1	4	0	0
8	47928187	.	T	A	1	0	1	0	0	1	0	0
8	47932409	.	C	T	8	3	11	0	0	11	0	0
8	47932442	.	G	A	1	3	4	0	2	7	1	0
8	47937152	.	T	C	6	6	12	0	0	12	0	0
8	47937156	.	A	G	5	0	5	0	9	14	0	0
8	47937263	.	T	C	14	16	30	0	0	30	0	0
8	47946517	.	T	C	20	9	29	0	2	31	0	0
8	47946674	.	G	A	6	7	13	0	0	13	0	0
8	47946753	.	C	T	12	13	25	0	1	26	0	0
8	47946776	.	T	C	8	17	25	0	2	27	0	0
8	47946833	.	A	G	12	15	27	0	0	27	0	0
8	47946846	.	A	G	15	11	26	0	1	27	0	0
8	47947052	.	A	C	5	6	11	0	1	12	0	0
8	47947297	.	C	T	9	8	17	0	1	18	0	0
8	47947341	.	C	A	10	6	16	0	2	18	0	0
8	47947649	.	T	A	17	12	29	0	0	29	0	0
8	47947772	.	A	G	16	1	17	0	10	27	0	0
8	47947996	.	T	G	16	8	24	0	0	24	0	0
8	47948102	.	T	A	11	10	21	0	0	21	0	0
8	47948602	.	G	A	0	17	17	0	13	30	0	0
8	47948755	.	C	T	13	14	27	0	1	28	0	0
8	47948820	.	A	C	13	8	21	0	0	21	0	0
8	47948866	.	C	A	4	4	8	0	0	8	0	0
8	48603552	.	T	C	3	4	7	0	0	7	0	0
8	48603788	.	G	C	0	6	6	0	4	10	0	0
8	48603978	.	T	A	7	5	12	0	0	12	0	0
8	48604114	.	T	A	4	4	8	0	1	9	0	0
8	48629640	.	T	A	1	4	5	0	1	6	0	0
8	48629797	.	C	A	8	8	16	0	1	17	0	0
8	48629946	.	A	T	8	7	15	0	2	17	0	0
8	48629969	.	T	C	11	0	11	0	8	19	0	0
8	48630017	.	A	G	7	1	8	0	1	9	0	0
8	48642433	.	G	A	5	5	10	0	0	10	0	0
8	48642496	.	A	G	6	2	8	0	1	9	0	0
8	48646053	.	A	G	2	1	3	0	0	3	0	0
8	48646089	.	G	A	1	3	4	0	0	4	0	0
8	48649106	.	A	C	0	4	4	0	0	4	0	0
8	48801508	.	C	T	5	16	21	0	1	22	0	0
8	48801553	.	C	T	8	8	16	0	3	19	0	0
8	48801678	.	C	T	9	3	12	0	0	12	0	0
8	48809531	.	C	G	4	5	9	0	0	9	0	0
8	48809570	.	G	A	0	7	7	0	1	8	0	0
8	48809587	.	T	G	1	5	6	0	1	7	0	0
8	48809678	.	A	C	6	11	17	0	0	17	0	0
8	48816412	.	C	G	1	2	3	0	0	3	0	0
8	48816438	.	T	G	1	2	3	0	0	3	0	0
8	48816447	.	C	T	0	2	2	0	1	3	0	0
8	48958468	.	C	T	5	4	9	0	0	9	0	0
8	48958637	.	A	G	8	10	18	0	0	18	0	0
8	48958822	.	C	T	16	9	25	0	0	25	0	0
8	48959047	.	G	A	7	6	13	0	1	14	0	0
8	48966016	.	A	C	1	2	3	0	0	3	0	0
8	48966140	.	C	G	2	5	7	0	0	7	0	0
8	48991948	.	C	T	1	4	5	0	0	5	0	0
8	49003785	.	A	G	2	0	2	0	1	3	0	0
8	49009822	.	C	A	1	3	4	0	0	4	0	0
8	49009829	.	C	T	4	1	5	0	0	5	0	0
8	49009917	.	T	C	0	1	1	0	0	1	0	0
8	49021126	.	C	T	4	2	6	0	0	6	0	0
8	49067166	.	G	C	3	3	6	0	0	6	0	0
8	49078792	.	G	A	0	5	5	0	4	9	0	0
8	49078817	.	C	T	4	4	8	0	0	8	0	0
8	49078827	.	A	C	2	3	5	0	1	6	0	0
8	49086105	.	G	T	1	3	4	0	0	4	0	0
8	49092063	.	T	A	3	4	7	0	0	7	0	0
8	49092108	.	C	T	3	8	11	0	0	11	0	0
8	49092129	.	C	T	1	6	7	0	0	7	0	0
8	49096541	.	G	T	1	8	9	0	1	10	0	0
8	49108347	.	A	T	13	10	23	0	1	24	0	0
8	49170190	.	T	A	5	10	15	0	0	15	0	0
8	49170366	.	T	A	13	6	19	0	1	20	0	0
8	49172338	.	A	G	4	4	8	0	1	9	0	0
8	49310830	.	C	T	5	7	12	0	0	12	0	0
8	49311090	.	C	T	16	12	28	0	0	28	0	0
8	49311355	.	T	C	19	16	35	0	1	36	0	0
8	49311396	.	C	A	15	15	30	0	1	31	0	0
8	49311398	.	G	C	15	15	30	0	1	31	0	0
8	49345116	.	C	T	7	5	12	0	1	13	0	0
8	49345191	.	T	C	12	18	30	0	0	30	0	0
8	49345212	.	G	T	14	9	23	0	1	24	0	0
8	49345272	.	A	G	15	8	23	0	3	26	0	0
8	49404152	.	G	T	20	18	38	0	2	40	0	0
8	49404262	.	C	T	27	28	55	0	3	58	0	0
8	49404502	.	C	T	36	26	62	0	1	63	0	0
8	49404928	.	C	T	32	26	58	0	2	61	1	0
8	49413417	.	G	T	36	31	67	0	4	71	0	0
8	49413444	.	G	A	25	41	66	0	4	70	0	0
8	49413459	.	G	A	22	39	61	0	4	65	0	0
8	49415718	.	G	C	5	3	8	0	0	8	0	0
8	49443191	.	A	G	1	0	1	0	5	6	0	0
8	49447428	.	A	G	1	4	5	0	0	5	0	0
8	49447519	.	G	A	3	6	9	0	0	9	0	0
8	49447657	.	C	A	3	6	9	0	0	9	0	0
8	49478073	.	C	T	2	3	5	0	0	5	0	0
8	49941098	.	A	T	1	5	6	0	0	6	0	0
8	50835308	.	A	T	1	1	2	0	0	2	0	0
8	50949903	.	A	G	21	0	21	0	20	41	0	0
8	51228659	.	G	A	0	1	1	0	0	1	0	0
8	51309145	.	T	G	7	9	16	0	1	17	0	0
8	51309311	.	A	G	3	7	10	0	0	10	0	0
8	51314087	.	G	A	8	8	16	0	0	16	0	0
8	51320547	.	C	T	4	2	6	0	0	6	0	0
8	51320652	.	C	T	5	6	11	0	0	11	0	0
8	51325510	.	T	G	3	4	7	0	1	8	0	0
8	51330776	.	T	C	1	2	3	0	0	3	0	0
8	51330836	.	A	T	2	2	4	0	1	5	0	0
8	51351121	.	C	T	5	11	16	0	0	16	0	0
8	51351155	.	T	A	5	5	10	0	0	10	0	0
8	51351200	.	A	T	8	8	16	0	0	16	0	0
8	51352480	.	A	G	9	7	16	0	0	16	0	0
8	51352525	.	A	T	1	2	3	0	2	5	0	0
8	51358769	.	G	A	2	2	4	0	0	4	0	0
8	51364644	.	C	A	0	13	13	0	10	23	0	0
8	51364665	.	T	C	9	8	17	0	2	19	0	0
8	51364696	.	C	G	5	4	9	0	0	9	0	0
8	51364713	.	C	A	0	0	0	0	2	2	0	0
8	51367178	.	A	T	4	2	6	0	0	6	0	0
8	51367206	.	C	T	6	5	11	0	0	11	0	0
8	51367217	.	C	T	7	9	16	0	0	16	0	0
8	51367267	.	A	T	8	11	19	0	1	20	0	0
8	51375405	.	T	G	12	18	30	0	3	33	0	0
8	51379609	.	G	A	1	5	6	0	0	6	0	0
8	51379699	.	G	A	7	4	11	0	0	11	0	0
8	51379741	.	A	T	0	1	1	0	0	1	0	0
8	51379747	.	G	A	0	1	1	0	0	1	0	0
8	51431879	.	C	T	1	2	3	0	0	3	0	0
8	51432096	.	T	C	5	4	9	0	1	10	0	0
8	51432106	.	T	C	4	5	9	0	1	10	0	0
8	51432141	.	C	A	4	5	9	0	0	9	0	0
8	51432145	.	G	T	4	4	8	0	1	9	0	0
8	51433238	.	A	G	2	3	5	0	0	5	0	0
8	51433680	.	G	A	1	2	3	0	0	3	0	0
8	51434384	.	C	T	0	3	3	0	2	5	0	0
8	51437284	.	G	A	1	1	2	0	0	2	0	0
8	51441716	.	G	A	0	2	2	0	0	2	0	0
8	51441734	.	A	G	0	2	2	0	0	2	0	0
8	51507161	.	C	T	2	2	4	0	0	4	0	0
8	51573259	.	A	T	0	3	3	0	0	3	0	0
8	51573283	.	T	C	1	0	1	0	2	3	0	0
8	51573439	.	T	C	1	0	1	0	0	1	0	0
8	51573441	.	T	C	1	0	1	0	0	1	0	0
8	51576997	.	T	G	1	0	1	0	0	1	0	0
8	51590064	.	C	T	0	1	1	0	0	1	0	0
8	51634824	.	C	T	1	2	3	0	0	3	0	0
8	51723249	.	A	G	2	3	5	4	0	9	0	0
8	51723285	.	G	A	0	15	15	5	0	20	0	0
8	51723320	.	A	G	0	10	10	2	2	14	0	0
8	51779797	.	C	T	0	3	3	0	2	5	0	0
8	51781307	.	G	T	2	1	3	0	2	5	0	0
8	51782044	.	A	G	6	5	11	0	0	11	0	0
8	51826625	.	C	T	0	2	2	0	1	3	0	0
8	51925545	.	G	A	2	1	3	0	0	3	0	0
8	51935690	.	G	C	1	2	3	0	0	3	0	0
8	51938097	.	T	G	0	1	1	0	0	1	0	0
8	51939839	.	A	G	2	2	4	0	0	4	0	0
8	51950129	.	T	C	1	2	3	0	0	3	0	0
8	51992393	.	C	A	4	3	7	0	1	8	0	0
8	51992501	.	G	T	8	4	12	0	0	12	0	0
8	51996707	.	A	G	4	4	8	0	0	8	0	0
8	51996727	.	A	G	4	2	6	0	0	6	0	0
8	52002903	.	C	T	1	7	8	0	12	20	0	0
8	52002945	.	T	A	5	0	5	0	0	5	0	0
8	52005582	.	A	C	5	3	8	0	0	8	0	0
8	52006139	.	C	T	0	1	1	0	2	3	0	0
8	52010799	.	T	C	0	4	4	0	0	4	0	0
8	52012737	.	T	A	7	2	9	0	0	9	0	0
8	52015712	.	G	T	1	6	7	0	1	8	0	0
8	52016041	.	G	A	4	6	10	0	0	10	0	0
8	52016101	.	T	C	3	7	10	0	1	11	0	0
8	52016128	.	G	A	2	2	4	0	0	4	0	0
8	52026501	.	G	A	2	4	6	0	0	6	0	0
8	52026702	.	C	A	1	3	4	0	0	4	0	0
8	52029849	.	T	C	2	5	7	0	2	9	0	0
8	52029852	.	G	A	4	6	10	0	0	10	0	0
8	52029978	.	C	T	0	3	3	0	5	8	0	0
8	52031962	.	A	G	0	5	5	0	0	5	0	0
8	52031965	.	A	G	0	5	5	0	0	5	0	0
8	52032016	.	T	A	3	7	10	0	1	11	0	0
8	52034609	.	G	A	2	5	7	0	0	7	0	0
8	52036359	.	A	G	1	1	2	0	0	2	0	0
8	52036392	.	A	G	3	2	5	0	0	5	0	0
8	52037800	.	A	G	1	4	5	0	0	5	0	0
8	52037830	.	C	A	1	3	4	0	0	4	0	0
8	52042175	.	T	C	4	0	4	0	4	8	0	0
8	52042206	.	G	A	3	3	6	0	0	6	0	0
8	52042891	.	T	C	2	3	5	0	0	5	0	0
8	52042893	.	G	A	2	3	5	0	0	5	0	0
8	52043119	.	T	A	0	2	2	0	0	2	0	0
8	52050643	.	T	A	1	0	1	0	0	1	0	0
8	52065100	.	A	C	1	0	1	0	3	4	0	0
8	52070944	.	G	T	0	1	1	0	0	1	0	0
8	52107898	.	T	G	1	4	5	0	1	6	0	0
8	52108233	.	T	C	3	0	3	0	3	6	0	0
8	52109133	.	T	C	1	3	4	0	0	4	0	0
8	52109499	.	T	A	2	2	4	0	2	6	0	0
8	52109581	.	A	G	3	5	8	0	0	8	0	0
8	52109686	.	T	G	10	9	19	0	1	20	0	0
8	52109730	.	T	G	14	9	23	0	0	23	0	0
8	52292515	.	T	C	0	1	1	0	0	1	0	0
8	52296833	.	T	G	4	1	5	0	1	6	0	0
8	52296834	.	T	G	4	2	6	0	0	6	0	0
8	52296922	.	G	A	0	2	2	0	5	7	0	0
8	52297230	.	C	A	3	2	5	0	0	5	0	0
8	52314637	.	G	T	0	2	2	0	6	8	0	0
8	52325649	.	A	G	1	0	1	0	3	4	0	0
8	52336870	.	T	C	1	2	3	0	0	3	0	0
8	52342586	.	A	C	4	4	8	0	1	9	0	0
8	52345733	.	T	C	3	4	7	0	1	8	0	0
8	52345751	.	T	C	5	9	14	0	1	15	0	0
8	52345915	.	T	C	8	9	17	0	0	17	0	0
8	52346035	.	T	C	4	5	9	0	1	10	0	0
8	52346072	.	A	T	5	5	10	0	0	10	0	0
8	52346111	.	A	C	3	4	7	0	1	8	0	0
8	52346225	.	A	T	3	5	8	0	1	9	0	0
8	52346656	.	A	G	0	3	3	0	0	3	0	0
8	52346657	.	A	G	0	3	3	0	0	3	0	0
8	52347460	.	C	T	7	8	15	0	2	17	0	0
8	52347641	.	A	G	3	2	5	0	0	5	0	0
8	52347642	.	A	G	2	3	5	0	0	5	0	0
8	52347840	.	A	G	2	5	7	0	0	7	0	0
8	52348685	.	T	C	11	7	18	0	0	18	0	0
8	52349080	.	T	G	5	5	10	0	2	12	0	0
8	52349607	.	A	G	3	21	24	0	1	25	0	0
8	52350101	.	A	G	5	0	5	0	11	17	1	0
8	52350146	.	A	G	11	0	11	0	11	22	0	0
8	52350251	.	A	G	6	11	17	0	2	19	0	0
8	52350322	.	T	G	3	4	7	0	1	8	0	0
8	52408619	.	G	A	27	22	49	0	3	52	0	0
8	52411451	.	T	C	4	7	11	0	0	11	0	0
8	52412982	.	A	G	12	10	22	0	0	22	0	0
8	52412985	.	C	G	12	10	22	0	0	22	0	0
8	52426530	.	T	C	1	1	2	0	0	2	0	0
8	52453432	.	A	C	4	4	8	0	0	8	0	0
8	52455588	.	A	G	2	1	3	0	0	3	0	0
8	52455610	.	A	G	6	7	13	0	0	13	0	0
8	52455638	.	C	G	7	7	14	0	0	14	0	0
8	52472955	.	C	T	0	2	2	0	1	3	0	0
8	52472997	.	T	C	2	3	5	0	0	5	0	0
8	52473043	.	C	G	2	2	4	0	0	4	0	0
8	52491586	.	G	A	2	3	5	0	0	5	0	0
8	52509559	.	C	A	6	3	9	0	0	9	0	0
8	52509568	.	C	A	4	4	8	0	0	8	0	0
8	52509624	.	G	A	2	7	9	0	0	9	0	0
8	52509762	.	A	T	4	5	9	0	0	9	0	0
8	52509959	.	C	T	4	2	6	0	0	6	0	0
8	52510020	.	G	T	0	3	3	0	0	3	0	0
8	52510088	.	C	T	4	2	6	0	0	6	0	0
8	52521261	.	T	C	2	6	8	0	0	8	0	0
8	52521280	.	T	G	2	6	8	0	0	8	0	0
8	52524436	.	A	T	2	1	3	0	0	3	0	0
8	52528665	.	A	G	13	4	17	0	1	18	0	0
8	52528717	.	A	G	5	12	17	0	1	18	0	0
8	52528770	.	A	G	9	5	14	0	1	15	0	0
8	52528856	.	C	G	7	4	11	0	0	11	0	0
8	52529123	.	C	T	8	7	15	0	0	15	0	0
8	52529206	.	T	C	5	10	15	0	0	15	0	0
8	52529235	.	G	A	6	16	22	0	0	22	0	0
8	52529397	.	A	G	9	8	17	0	0	17	0	0
8	52534056	.	C	T	2	2	4	0	0	4	0	0
8	52534059	.	G	A	0	3	3	0	2	5	0	0
8	52534158	.	A	G	1	2	3	0	0	3	0	0
8	52538056	.	G	A	0	6	6	0	1	7	0	0
8	52538062	.	G	A	0	4	4	0	3	7	0	0
8	52547038	.	T	G	10	14	24	0	0	24	0	0
8	52547091	.	T	C	10	10	20	0	1	21	0	0
8	52547356	.	A	G	8	7	15	0	0	15	0	0
8	52547519	.	C	G	4	0	4	0	6	10	0	0
8	52547569	.	T	A	4	5	9	0	0	9	0	0
8	52547664	.	A	C	5	3	8	0	0	8	0	0
8	52547727	.	G	C	2	5	7	0	0	7	0	0
8	52547787	.	T	A	1	5	6	0	1	7	0	0
8	52550361	.	C	T	4	6	10	0	0	10	0	0
8	52550373	.	T	C	3	0	3	0	7	10	0	0
8	52550462	.	A	G	4	3	7	0	0	7	0	0
8	52553162	.	G	A	1	6	7	0	1	8	0	0
8	52553193	.	A	T	1	4	5	0	5	10	0	0
8	52553197	.	A	G	1	7	8	0	0	8	0	0
8	52554799	.	T	A	2	7	9	0	0	9	0	0
8	52555137	.	G	A	6	8	14	0	1	15	0	0
8	52557454	.	G	T	0	1	1	0	0	1	0	0
8	52559996	.	G	T	1	1	2	0	1	3	0	0
8	52560034	.	T	C	2	1	3	0	0	3	0	0
8	52560058	.	T	C	1	0	1	0	0	1	0	0
8	52561421	.	C	A	1	4	5	0	0	5	0	0
8	52561477	.	C	A	1	0	1	0	0	1	0	0
8	52563316	.	T	G	1	1	2	0	1	3	0	0
8	52563364	.	C	T	3	4	7	0	0	7	0	0
8	52563427	.	C	T	0	1	1	0	0	1	0	0
8	52565222	.	C	A	1	0	1	0	0	1	0	0
8	52565319	.	T	C	2	2	4	0	0	4	0	0
8	52575791	.	C	T	0	1	1	0	1	2	0	0
8	52580094	.	A	G	0	3	3	0	0	3	0	0
8	52580169	.	A	G	3	5	8	0	0	8	0	0
8	52584246	.	T	A	0	2	2	0	1	3	0	0
8	52584249	.	A	T	1	2	3	0	0	3	0	0
8	52591539	.	G	A	0	2	2	0	0	2	0	0
8	52594076	.	C	T	1	0	1	0	0	1	0	0
8	52713677	.	T	G	44	26	70	0	0	70	0	0
8	52713776	.	G	A	33	28	61	0	4	65	0	0
8	52713932	.	G	A	41	28	69	0	2	71	0	0
8	52713974	.	A	G	41	19	60	0	4	64	0	0
8	52713989	.	G	A	41	20	61	0	1	62	0	0
8	52714343	.	T	G	36	31	67	0	2	69	0	0
8	52715220	.	G	A	1	2	3	0	0	3	0	0
8	52715821	.	C	T	16	14	30	0	0	30	0	0
8	52800370	.	G	C	0	1	1	0	1	2	0	0
8	53148951	.	T	C	2	4	6	0	0	6	0	0
8	53149276	.	T	C	5	2	7	0	0	7	0	0
8	53150423	.	T	C	7	4	11	0	0	11	0	0
8	53150630	.	T	C	10	5	15	0	0	15	0	0
8	53150708	.	T	C	7	4	11	0	0	11	0	0
8	53398555	.	A	G	11	4	15	0	0	15	0	0
8	53398564	.	A	G	9	5	14	0	0	14	0	0
8	54221074	.	T	C	31	11	42	0	0	42	0	0
8	54221390	.	T	C	20	7	27	0	5	32	0	0
9	24528	.	C	T	17	11	28	0	0	28	0	0
9	37058	.	G	A	4	5	9	0	0	9	0	0
9	37199	.	G	A	9	3	12	0	0	12	0	0
9	37830	.	C	T	0	12	12	0	18	30	0	0
9	54479	.	C	T	12	15	27	0	1	28	0	0
9	62336	.	T	C	14	18	32	0	2	34	0	0
9	62351	.	A	G	13	17	30	0	4	34	0	0
9	62528	.	T	G	5	5	10	0	0	10	0	0
9	63313	.	G	A	4	9	13	0	0	13	0	0
9	63418	.	G	A	5	3	8	0	0	8	0	0
9	63532	.	G	A	1	0	1	0	0	1	0	0
9	63604	.	G	A	7	6	13	0	0	13	0	0
9	64739	.	C	A	0	2	2	0	7	9	0	0
9	70215	.	G	T	2	2	4	0	0	4	0	0
9	80628	.	A	G	1	0	1	0	0	1	0	0
9	82627	.	G	A	7	3	10	0	0	10	0	0
9	83116	.	A	G	2	2	4	0	0	4	0	0
9	83133	.	G	C	2	1	3	0	1	5	1	0
9	83785	.	T	C	2	4	6	0	0	6	0	0
9	84216	.	G	A	4	4	8	0	0	8	0	0
9	84293	.	A	G	2	2	4	0	0	4	0	0
9	84487	.	A	G	2	2	4	0	0	4	0	0
9	85318	.	T	C	3	4	7	0	0	7	0	0
9	85846	.	A	G	5	5	10	0	1	11	0	0
9	86107	.	C	G	1	3	4	0	0	4	0	0
9	86719	.	T	C	2	6	8	0	0	8	0	0
9	86767	.	T	C	2	6	8	0	0	8	0	0
9	86830	.	T	C	1	4	5	1	0	6	0	0
9	90105	.	C	A	0	3	3	0	0	4	1	0
9	90189	.	A	G	2	5	7	0	1	8	0	0
9	90507	.	G	C	0	2	2	0	0	2	0	0
9	94276	.	T	C	11	12	23	0	4	27	0	0
9	104840	.	G	A	10	4	14	0	0	14	0	0
9	104862	.	T	G	5	3	8	0	0	8	0	0
9	105091	.	C	T	0	6	6	0	6	12	0	0
9	134835	.	C	T	0	5	5	0	1	6	0	0
9	134945	.	C	T	0	5	5	0	2	7	0	0
9	134949	.	C	T	0	5	5	0	2	7	0	0
9	134999	.	C	T	0	2	2	0	2	4	0	0
9	135149	.	C	T	0	3	3	0	1	4	0	0
9	135151	.	G	T	1	3	4	0	0	4	0	0
9	147357	.	A	G	4	2	6	0	2	8	0	0
9	148333	.	G	A	0	11	11	0	4	15	0	0
9	148339	.	A	G	4	11	15	0	0	15	0	0
9	149078	.	G	A	0	10	10	0	12	22	0	0
9	149215	.	C	A	14	4	18	0	3	21	0	0
9	149251	.	A	T	8	14	22	0	1	23	0	0
9	153001	.	C	T	7	15	22	0	0	22	0	0
9	168462	.	A	T	0	5	5	0	1	6	0	0
9	168580	.	T	C	7	2	9	0	0	9	0	0
9	168759	.	T	C	7	3	10	0	0	10	0	0
9	169072	.	T	A	5	6	11	0	1	12	0	0
9	169806	.	G	C	11	2	13	0	9	22	0	0
9	170845	.	G	T	3	6	9	0	0	9	0	0
9	170945	.	G	A	3	2	5	0	0	5	0	0
9	172661	.	C	T	16	12	28	0	1	29	0	0
9	180245	.	G	A	11	7	18	0	0	18	0	0
9	193005	.	A	G	0	1	1	0	0	1	0	0
9	195259	.	A	G	3	2	5	0	0	5	0	0
9	209444	.	T	A	1	2	3	0	0	3	0	0
9	225220	.	T	A	3	2	5	0	0	5	0	0
9	225257	.	C	T	4	6	10	0	1	11	0	0
9	225362	.	T	C	7	11	18	0	1	19	0	0
9	225371	.	T	C	8	9	17	0	0	17	0	0
9	225599	.	C	T	3	4	7	0	0	7	0	0
9	225656	.	C	T	4	2	6	0	0	6	0	0
9	226168	.	C	T	2	8	10	0	0	10	0	0
9	227072	.	C	T	3	3	6	0	0	6	0	0
9	233295	.	A	G	9	0	9	0	9	18	0	0
9	234328	.	G	A	4	3	7	0	1	8	0	0
9	235262	.	G	T	0	12	12	0	10	22	0	0
9	235365	.	T	A	7	11	18	0	1	19	0	0
9	235567	.	C	G	7	6	13	0	0	13	0	0
9	253264	.	T	C	19	2	21	0	18	39	0	0
9	254484	.	A	G	32	26	58	0	7	65	0	0
9	257890	.	A	T	25	14	39	0	2	41	0	0
9	257926	.	G	C	16	2	18	0	9	27	0	0
9	262487	.	A	G	17	7	24	0	1	25	0	0
9	262511	.	C	T	1	13	14	0	28	42	0	0
9	266053	.	T	C	10	13	23	0	2	25	0	0
9	266227	.	T	C	19	31	50	0	0	50	0	0
9	266255	.	C	T	24	33	57	0	0	57	0	0
9	266445	.	G	C	33	25	58	0	1	59	0	0
9	266572	.	T	C	30	0	30	0	22	52	0	0
9	266721	.	A	G	19	23	42	0	0	42	0	0
9	266802	.	A	C	15	17	32	0	1	33	0	0
9	266875	.	T	C	29	6	35	0	5	40	0	0
9	266910	.	G	A	24	15	39	0	0	39	0	0
9	267290	.	G	A	7	4	11	0	0	11	0	0
9	276059	.	A	G	6	9	15	0	0	15	0	0
9	278150	.	A	G	11	16	27	0	1	28	0	0
9	278174	.	G	A	20	25	45	0	1	46	0	0
9	282686	.	C	T	5	2	7	0	1	8	0	0
9	282737	.	T	C	14	2	16	0	17	33	0	0
9	296052	.	G	A	24	23	47	0	1	48	0	0
9	296177	.	T	A	27	21	48	0	3	51	0	0
9	296181	.	T	C	26	0	26	0	24	50	0	0
9	298970	.	A	G	3	6	9	0	0	9	0	0
9	299247	.	C	T	5	2	7	1	0	8	0	0
9	301535	.	A	T	2	7	9	0	1	10	0	0
9	302720	.	T	C	7	7	14	0	1	15	0	0
9	303032	.	C	G	8	6	14	0	0	14	0	0
9	303061	.	T	C	7	0	7	0	9	16	0	0
9	303070	.	T	C	10	6	16	0	0	16	0	0
9	303288	.	C	T	0	5	5	0	4	9	0	0
9	323588	.	A	G	8	8	16	0	0	16	0	0
9	323762	.	T	C	3	5	8	0	0	8	0	0
9	326140	.	C	T	1	1	2	0	0	2	0	0
9	331771	.	G	T	4	3	7	0	0	7	0	0
9	332710	.	T	C	1	2	3	0	0	3	0	0
9	332777	.	A	T	3	3	6	0	0	6	0	0
9	332779	.	A	T	3	3	6	0	0	6	0	0
9	335985	.	A	G	2	0	2	0	4	6	0	0
9	336776	.	G	T	0	1	1	0	0	1	0	0
9	336852	.	A	T	5	7	12	0	1	13	0	0
9	336863	.	A	G	5	0	5	0	5	10	0	0
9	339332	.	T	C	1	1	2	0	0	2	0	0
9	340170	.	T	C	1	6	7	0	0	7	0	0
9	355324	.	A	G	2	8	10	0	0	10	0	0
9	355348	.	G	A	2	8	10	0	0	10	0	0
9	355411	.	A	C	1	3	4	0	0	4	0	0
9	358679	.	C	G	1	4	5	0	13	18	0	0
9	360846	.	G	A	1	4	5	0	0	5	0	0
9	360894	.	A	G	2	2	4	0	0	4	0	0
9	362906	.	G	T	1	2	3	0	0	3	0	0
9	428788	.	T	C	1	0	1	0	0	1	0	0
9	429277	.	A	T	2	4	6	0	0	6	0	0
9	430071	.	T	C	3	9	12	0	0	12	0	0
9	430125	.	G	T	0	3	3	0	0	3	0	0
9	431089	.	C	T	2	3	5	0	0	5	0	0
9	431137	.	C	T	2	5	7	0	1	8	0	0
9	432202	.	A	T	1	2	3	0	0	3	0	0
9	445518	.	C	A	2	2	4	0	0	4	0	0
9	451044	.	T	C	0	0	0	0	2	2	0	0
9	451153	.	G	A	1	2	3	0	0	3	0	0
9	451156	.	T	C	1	2	3	0	0	3	0	0
9	453764	.	G	A	1	1	2	0	0	2	0	0
9	458995	.	T	A	11	9	20	0	2	22	0	0
9	459042	.	A	T	8	12	20	0	0	20	0	0
9	459754	.	C	T	4	9	13	0	1	14	0	0
9	459755	.	T	C	4	0	4	0	10	14	0	0
9	459893	.	C	T	0	1	1	0	2	3	0	0
9	462959	.	T	G	13	2	15	0	0	15	0	0
9	463005	.	A	C	4	9	13	0	0	13	0	0
9	463010	.	T	C	3	1	4	0	10	14	0	0
9	510956	.	C	G	1	2	3	0	0	3	0	0
9	511782	.	G	T	0	2	2	0	2	4	0	0
9	511884	.	C	T	2	3	5	0	0	5	0	0
9	511935	.	C	A	2	2	4	0	1	5	0	0
9	525826	.	C	T	1	2	3	0	0	3	0	0
9	527867	.	A	T	4	4	8	0	0	8	0	0
9	527969	.	G	A	0	3	3	0	6	9	0	0
9	528021	.	A	G	2	3	5	0	1	6	0	0
9	528905	.	T	C	1	4	5	0	0	5	0	0
9	529012	.	G	T	4	4	8	0	1	9	0	0
9	529036	.	G	A	0	3	3	0	5	8	0	0
9	529059	.	A	G	2	0	2	0	4	6	0	0
9	529538	.	C	G	3	1	4	0	1	5	0	0
9	529628	.	C	G	0	3	3	0	0	3	0	0
9	529648	.	G	A	2	2	4	0	0	4	0	0
9	529675	.	A	G	1	2	3	0	0	3	0	0
9	529824	.	C	A	1	3	4	0	0	4	0	0
9	529849	.	G	A	0	2	2	0	1	3	0	0
9	530160	.	A	T	1	2	3	0	0	3	0	0
9	530166	.	A	G	1	2	3	0	0	3	0	0
9	531319	.	C	A	1	1	2	0	1	3	0	0
9	580802	.	G	A	1	1	2	0	2	4	0	0
9	580966	.	C	T	2	2	4	0	0	4	0	0
9	581466	.	G	A	2	2	4	0	0	4	0	0
9	588454	.	A	G	9	6	15	0	1	16	0	0
9	588456	.	C	T	10	6	16	0	0	16	0	0
9	595354	.	G	A	4	2	6	0	0	6	0	0
9	597342	.	C	T	1	6	7	0	2	9	0	0
9	598720	.	A	G	1	1	2	0	0	2	0	0
9	598795	.	A	G	0	4	4	0	0	4	0	0
9	598819	.	G	A	0	1	1	0	0	1	0	0
9	600609	.	G	A	1	1	2	0	0	2	0	0
9	604848	.	A	G	2	3	5	0	0	5	0	0
9	612636	.	G	A	5	4	9	0	0	9	0	0
9	612647	.	C	G	2	5	7	0	1	8	0	0
9	627648	.	C	A	0	4	4	0	1	5	0	0
9	701575	.	A	T	0	1	1	0	0	1	0	0
9	704662	.	T	A	4	4	8	0	0	8	0	0
9	707672	.	A	T	2	1	3	0	0	3	0	0
9	707682	.	A	G	2	2	4	0	0	4	0	0
9	707996	.	C	T	3	19	22	0	27	49	0	0
9	708075	.	T	C	25	0	25	0	27	53	1	0
9	719729	.	G	A	1	0	1	0	0	1	0	0
9	719825	.	A	G	0	2	2	0	0	2	0	0
9	721472	.	C	T	0	1	1	0	1	2	0	0
9	721822	.	T	A	4	10	14	0	0	14	0	0
9	721829	.	A	G	4	9	13	0	0	13	0	0
9	722965	.	A	G	1	4	5	0	1	6	0	0
9	723004	.	G	A	3	6	9	0	0	9	0	0
9	723044	.	C	T	1	1	2	0	0	2	0	0
9	724532	.	G	A	0	1	1	0	0	1	0	0
9	724592	.	G	A	4	3	7	0	1	8	0	0
9	724616	.	G	A	5	4	9	0	1	10	0	0
9	724664	.	G	C	1	4	5	0	0	5	0	0
9	726870	.	A	G	1	2	3	0	0	3	0	0
9	728531	.	C	A	0	5	5	0	5	10	0	0
9	730515	.	C	T	3	3	6	0	0	6	0	0
9	730539	.	C	A	3	5	8	0	0	8	0	0
9	732191	.	C	T	0	0	0	0	2	2	0	0
9	732218	.	G	A	2	0	2	0	0	2	0	0
9	732227	.	C	T	0	2	2	0	0	2	0	0
9	737461	.	C	A	0	0	0	0	2	2	0	0
9	737462	.	G	T	2	0	2	0	0	2	0	0
9	746006	.	A	G	1	0	1	0	0	1	0	0
9	746040	.	A	G	2	1	3	0	0	3	0	0
9	751441	.	A	G	3	2	5	0	0	5	0	0
9	844275	.	G	T	1	2	3	0	0	3	0	0
9	848614	.	A	G	1	4	5	0	0	5	0	0
9	848860	.	G	A	2	5	7	0	0	7	0	0
9	882143	.	T	C	13	0	13	0	8	21	0	0
9	887854	.	A	G	0	2	2	0	0	2	0	0
9	889385	.	A	G	7	3	10	0	0	10	0	0
9	889433	.	G	A	5	6	11	0	0	11	0	0
9	889514	.	G	C	5	4	9	0	1	10	0	0
9	889520	.	A	T	5	2	7	0	2	9	0	0
9	900592	.	G	A	1	3	4	0	0	4	0	0
9	901137	.	A	G	1	3	4	0	0	4	0	0
9	902265	.	T	C	0	0	0	0	1	1	0	0
9	904118	.	A	T	8	3	11	0	0	12	1	0
9	907564	.	A	G	7	2	9	0	1	10	0	0
9	910882	.	C	T	8	6	14	0	1	15	0	0
9	913874	.	T	C	23	18	41	0	1	42	0	0
9	913882	.	C	T	24	21	45	0	2	47	0	0
9	913909	.	G	A	4	24	28	0	18	46	0	0
9	914097	.	G	T	6	6	12	0	0	12	0	0
9	914190	.	C	T	5	2	7	0	0	7	0	0
9	914282	.	A	G	1	2	3	0	1	4	0	0
9	914291	.	T	C	2	3	5	0	0	5	0	0
9	914445	.	T	C	6	1	7	0	0	7	0	0
9	914506	.	C	A	5	1	6	0	0	6	0	0
9	914507	.	C	T	5	1	6	0	0	6	0	0
9	914675	.	C	T	15	2	17	0	0	17	0	0
9	914702	.	A	T	10	1	11	0	0	11	0	0
9	922788	.	T	A	1	2	3	0	1	4	0	0
9	963731	.	C	T	5	5	10	0	0	10	0	0
9	1000443	.	A	G	1	0	1	0	2	3	0	0
9	1000449	.	A	G	1	0	1	0	2	3	0	0
9	1123294	.	T	C	1	0	1	0	1	2	0	0
9	1123303	.	G	A	1	1	2	0	0	2	0	0
9	1133096	.	C	T	2	2	4	0	0	4	0	0
9	1188237	.	G	T	3	2	5	0	0	5	0	0
9	1197200	.	C	T	2	3	5	0	0	5	0	0
9	1197201	.	A	G	2	3	5	0	0	5	0	0
9	1235943	.	G	T	5	2	7	0	0	7	0	0
9	1251753	.	T	C	2	2	4	0	1	5	0	0
9	1251795	.	T	C	1	2	3	0	0	3	0	0
9	1293974	.	C	T	1	1	2	0	0	2	0	0
9	1296937	.	G	A	0	0	0	0	1	1	0	0
9	1296985	.	T	C	2	1	3	0	0	3	0	0
9	1297000	.	G	A	1	1	2	0	1	3	0	0
9	1368428	.	T	A	1	1	2	0	0	2	0	0
9	1371040	.	G	A	2	5	7	0	0	7	0	0
9	1371190	.	C	G	6	2	8	0	1	9	0	0
9	1371362	.	C	T	5	5	10	0	1	11	0	0
9	1371363	.	A	G	5	5	10	0	1	11	0	0
9	1373000	.	A	G	2	4	6	0	1	7	0	0
9	1373075	.	T	G	7	8	15	0	0	15	0	0
9	1373144	.	C	A	4	11	15	0	1	16	0	0
9	1376201	.	A	G	2	0	2	0	8	10	0	0
9	1463287	.	T	C	3	1	4	0	0	4	0	0
9	1465005	.	G	A	1	2	3	0	0	3	0	0
9	1477756	.	C	T	3	4	7	0	1	8	0	0
9	1479290	.	G	T	0	2	2	0	0	2	0	0
9	1481515	.	G	A	0	1	1	0	0	1	0	0
9	1483810	.	T	C	3	3	6	0	0	6	0	0
9	1510742	.	C	G	1	4	5	0	0	5	0	0
9	1510764	.	C	T	1	4	5	0	0	5	0	0
9	1536441	.	T	C	1	1	2	0	0	2	0	0
9	1576074	.	T	C	1	2	3	0	0	3	0	0
9	1579792	.	T	C	8	7	15	0	2	17	0	0
9	1579894	.	T	C	2	1	3	0	0	3	0	0
9	1644531	.	C	T	2	2	4	0	0	4	0	0
9	1644564	.	T	G	2	2	4	0	0	4	0	0
9	1673601	.	C	T	1	3	4	0	0	4	0	0
9	1679969	.	C	A	3	4	7	0	0	7	0	0
9	1680126	.	A	C	2	5	7	0	0	7	0	0
9	1680375	.	C	T	2	4	6	0	0	6	0	0
9	1680636	.	A	G	2	4	6	0	0	6	0	0
9	1680660	.	T	A	1	4	5	0	0	5	0	0
9	1680700	.	T	A	4	4	8	0	0	8	0	0
9	1680809	.	A	C	1	2	3	0	0	3	0	0
9	1682489	.	G	A	1	2	3	0	0	3	0	0
9	1682740	.	G	C	1	7	8	0	7	15	0	0
9	1693082	.	A	C	6	7	13	0	0	13	0	0
9	1693092	.	G	A	8	8	16	0	0	16	0	0
9	1693443	.	G	A	12	5	17	0	0	17	0	0
9	1693494	.	T	G	7	7	14	0	0	14	0	0
9	1694277	.	A	G	4	2	6	0	0	6	0	0
9	1938820	.	G	T	1	4	5	0	0	5	0	0
9	1938839	.	A	G	0	3	3	0	1	4	0	0
9	1948976	.	G	A	2	2	4	0	0	4	0	0
9	1950476	.	C	T	1	1	2	0	1	3	0	0
9	1950477	.	T	A	1	2	3	0	0	3	0	0
9	2004033	.	T	C	1	0	1	0	0	1	0	0
9	2044701	.	C	A	4	3	7	0	0	7	0	0
9	2045046	.	G	T	1	2	3	0	0	3	0	0
9	2045125	.	T	G	2	5	7	0	0	7	0	0
9	2045265	.	G	A	2	3	5	0	0	5	0	0
9	2333984	.	T	A	2	4	6	0	0	6	0	0
9	2334127	.	T	A	1	3	4	0	0	4	0	0
9	2334164	.	C	T	8	3	11	0	0	11	0	0
9	2336682	.	A	G	2	0	2	0	3	5	0	0
9	2337291	.	C	T	1	2	3	0	0	3	0	0
9	2340561	.	G	A	11	4	15	0	0	15	0	0
9	2340564	.	G	A	12	4	16	0	0	16	0	0
9	2340618	.	C	T	27	24	51	0	2	53	0	0
9	2340776	.	C	T	30	39	69	0	6	76	1	0
9	2340957	.	T	A	1	2	3	0	0	3	0	0
9	2340964	.	G	A	5	1	6	0	0	6	0	0
9	2341035	.	T	C	17	18	35	0	1	36	0	0
9	2341053	.	T	C	11	16	27	0	0	27	0	0
9	2351661	.	C	T	2	1	3	0	1	4	0	0
9	2351795	.	C	G	1	1	2	0	0	2	0	0
9	2365092	.	T	C	2	2	4	0	0	4	0	0
9	2365125	.	T	C	3	4	7	0	0	7	0	0
9	2421012	.	T	A	1	0	1	0	0	1	0	0
9	2423047	.	C	T	6	5	11	0	0	11	0	0
9	2423092	.	C	A	9	5	14	0	0	14	0	0
9	2423119	.	C	T	2	10	12	0	0	12	0	0
9	2452697	.	T	C	12	21	33	0	3	36	0	0
9	2543122	.	C	T	1	0	1	0	0	1	0	0
9	2546266	.	T	C	0	1	1	0	0	1	0	0
9	2555975	.	T	G	2	2	4	0	0	4	0	0
9	2556177	.	A	T	3	4	7	0	0	7	0	0
9	2556339	.	T	C	2	4	6	0	1	7	0	0
9	2556415	.	T	A	3	3	6	0	0	6	0	0
9	2556516	.	A	T	3	2	5	0	0	5	0	0
9	2556683	.	C	T	7	6	13	0	0	13	0	0
9	2556981	.	T	A	1	2	3	0	0	3	0	0
9	2557005	.	T	G	0	2	2	0	0	2	0	0
9	2558355	.	G	T	2	6	8	0	0	8	0	0
9	2559047	.	G	A	2	3	5	0	0	5	0	0
9	2559138	.	C	T	1	2	3	0	1	4	0	0
9	2559177	.	C	T	2	5	7	0	0	7	0	0
9	2559204	.	C	T	4	3	7	0	0	7	0	0
9	2559566	.	C	A	1	4	5	0	0	5	0	0
9	2559587	.	G	C	0	1	1	0	3	4	0	0
9	2559640	.	A	T	3	3	6	0	1	7	0	0
9	2560691	.	T	C	1	14	15	0	1	16	0	0
9	2560712	.	T	A	2	14	16	0	0	16	0	0
9	2560765	.	C	T	0	9	9	0	0	9	0	0
9	2561135	.	C	T	3	3	6	0	0	6	0	0
9	2561162	.	T	G	4	3	7	0	0	7	0	0
9	2561182	.	A	G	2	4	6	0	1	7	0	0
9	2561205	.	G	T	2	3	5	0	0	5	0	0
9	2561225	.	T	A	3	1	4	0	0	4	0	0
9	2561254	.	C	T	0	3	3	0	5	8	0	0
9	2561322	.	T	A	3	3	6	0	0	6	0	0
9	2561359	.	T	C	0	0	0	0	3	3	0	0
9	2561383	.	C	A	2	2	4	0	0	4	0	0
9	2561604	.	C	T	11	18	29	0	1	30	0	0
9	2561632	.	A	T	18	17	35	0	0	35	0	0
9	2564111	.	G	A	12	9	21	0	1	22	0	0
9	2564656	.	G	T	1	7	8	0	0	8	0	0
9	2564788	.	A	T	0	4	4	0	0	4	0	0
9	2564790	.	A	T	0	4	4	0	0	4	0	0
9	2568777	.	C	T	11	7	18	0	0	19	1	0
9	2569372	.	T	G	5	3	8	0	0	9	1	0
9	2572756	.	A	T	8	8	16	0	1	17	0	0
9	2572809	.	C	T	0	4	4	0	3	7	0	0
9	2576099	.	T	C	1	0	1	0	0	1	0	0
9	2586206	.	A	G	6	0	6	0	12	18	0	0
9	2586259	.	A	G	8	13	21	0	1	22	0	0
9	2592246	.	C	T	15	11	26	0	1	27	0	0
9	2592518	.	A	T	10	5	15	0	0	15	0	0
9	2592519	.	T	A	4	9	13	0	2	15	0	0
9	2592675	.	G	A	14	11	25	0	2	27	0	0
9	2592960	.	A	G	10	8	18	0	0	18	0	0
9	2592984	.	C	A	0	6	6	0	10	16	0	0
9	2593059	.	C	T	0	8	8	0	5	13	0	0
9	2593518	.	G	A	5	5	10	0	2	12	0	0
9	2593533	.	G	A	5	6	11	0	0	11	0	0
9	2896834	.	T	C	1	0	1	0	2	3	0	0
9	2897200	.	A	T	1	2	3	0	0	3	0	0
9	2909623	.	G	A	0	1	1	0	0	1	0	0
9	2949273	.	G	A	4	3	7	0	0	7	0	0
9	2949291	.	C	A	0	4	4	0	2	6	0	0
9	2949374	.	T	A	1	3	4	0	1	5	0	0
9	2949522	.	G	A	2	4	6	0	0	6	0	0
9	2961086	.	T	C	1	0	1	0	3	4	0	0
9	3232102	.	A	G	4	2	6	0	0	6	0	0
9	5041842	.	A	T	3	3	6	0	0	6	0	0
9	5042724	.	G	T	2	7	9	0	0	9	0	0
9	5042772	.	C	T	4	2	6	0	0	6	0	0
9	5042784	.	A	G	4	1	5	0	0	5	0	0
9	5776845	.	G	A	1	1	2	0	0	2	0	0
9	5911943	.	G	A	1	5	6	0	0	6	0	0
9	6009282	.	C	T	18	16	34	0	3	37	0	0
9	6083012	.	G	A	2	9	11	0	20	31	0	0
9	6083026	.	C	T	13	10	23	0	4	27	0	0
9	6083113	.	C	T	8	14	22	0	1	23	0	0
9	6083169	.	C	T	9	3	12	0	0	12	0	0
9	6083262	.	G	C	4	11	15	0	0	15	0	0
9	6083401	.	G	A	14	13	27	0	1	28	0	0
9	6109544	.	A	G	12	9	21	0	0	21	0	0
9	6123441	.	G	A	17	15	32	0	0	32	0	0
9	6123490	.	G	T	11	15	26	0	1	27	0	0
9	6123742	.	A	C	12	10	22	0	0	22	0	0
9	6123857	.	C	T	6	6	12	0	1	13	0	0
9	6124057	.	G	A	0	11	11	0	8	19	0	0
9	6124100	.	T	C	6	10	16	0	0	16	0	0
9	6124393	.	C	T	5	7	12	0	0	12	0	0
9	6124478	.	G	A	10	9	19	0	1	20	0	0
9	6124759	.	T	A	8	16	24	0	1	27	2	0
9	6124761	.	T	G	18	8	26	0	1	27	0	0
9	6124884	.	T	C	8	8	16	0	0	16	0	0
9	6125227	.	G	A	1	4	5	0	0	5	0	0
9	6125267	.	A	G	0	1	1	0	2	3	0	0
9	6125346	.	T	A	5	5	10	0	0	10	0	0
9	6125427	.	G	C	6	7	13	0	0	13	0	0
9	6125501	.	A	C	6	4	10	0	0	10	0	0
9	6125588	.	A	C	6	6	12	0	0	12	0	0
9	6125707	.	T	C	3	4	7	0	0	7	0	0
9	6125732	.	C	T	6	4	10	0	0	10	0	0
9	6125761	.	G	T	7	5	12	0	1	13	0	0
9	6125859	.	T	A	10	7	17	0	2	19	0	0
9	6126074	.	T	A	17	11	28	0	0	28	0	0
9	6126288	.	A	C	10	9	19	0	0	19	0	0
9	6126410	.	G	A	11	18	29	0	1	30	0	0
9	6126469	.	G	A	10	14	24	0	1	25	0	0
9	6126781	.	T	G	6	15	21	0	0	21	0	0
9	6126900	.	C	T	8	9	17	0	0	17	0	0
9	6126911	.	C	A	7	7	14	0	0	14	0	0
9	6127075	.	G	A	1	29	30	0	24	54	0	0
9	6127346	.	C	A	20	8	28	0	0	28	0	0
9	6127357	.	C	T	16	12	28	0	0	28	0	0
9	6400251	.	G	A	1	7	8	0	0	8	0	0
9	6660314	.	G	A	5	13	18	0	0	18	0	0
9	6660611	.	G	A	14	11	25	0	0	25	0	0
9	6660953	.	C	T	3	6	9	0	10	19	0	0
9	6661361	.	A	T	0	4	4	0	2	6	0	0
9	7030092	.	A	G	9	3	12	0	0	12	0	0
9	7032231	.	C	A	2	4	6	0	1	7	0	0
9	7039659	.	C	T	6	8	14	0	0	14	0	0
9	7039689	.	T	C	6	8	14	0	1	15	0	0
9	7042639	.	C	T	1	1	2	0	0	2	0	0
9	7042659	.	G	A	3	2	5	0	0	5	0	0
9	7042674	.	A	G	3	0	3	0	2	5	0	0
9	7046383	.	A	G	3	0	3	0	0	3	0	0
9	7049484	.	C	G	5	8	13	0	0	13	0	0
9	7056563	.	T	C	7	6	13	0	2	15	0	0
9	7056713	.	A	C	2	4	6	0	1	7	0	0
9	7056968	.	C	T	7	4	11	0	3	14	0	0
9	7092424	.	T	C	9	5	14	0	0	14	0	0
9	7094141	.	T	C	10	6	16	0	0	16	0	0
9	7094898	.	T	C	16	10	26	0	0	26	0	0
9	7213050	.	A	G	7	12	19	0	0	19	0	0
9	7213607	.	T	C	4	4	8	0	0	8	0	0
9	7228272	.	C	A	17	15	32	0	0	32	0	0
9	7228487	.	C	A	13	6	19	0	1	20	0	0
9	7229288	.	G	T	15	13	28	0	1	29	0	0
9	7229343	.	T	G	17	14	31	0	1	32	0	0
9	7229347	.	G	A	18	14	32	0	0	32	0	0
9	7229512	.	C	T	13	17	30	0	1	31	0	0
9	7234590	.	G	A	6	3	9	0	1	10	0	0
9	7234618	.	A	C	13	0	13	0	9	22	0	0
9	7234642	.	G	A	14	9	23	0	2	25	0	0
9	7234681	.	A	C	4	12	16	0	0	16	0	0
9	7238498	.	C	T	15	14	29	0	1	30	0	0
9	7238502	.	C	A	16	14	30	0	0	31	1	0
9	7241047	.	A	T	0	2	2	0	0	2	0	0
9	7241101	.	A	G	1	3	4	0	0	4	0	0
9	7241118	.	G	A	1	3	4	0	0	4	0	0
9	7241409	.	G	T	3	6	9	0	0	9	0	0
9	7241494	.	T	C	1	1	2	0	0	2	0	0
9	7241677	.	G	A	1	2	3	0	0	3	0	0
9	7241855	.	C	T	3	4	7	0	0	7	0	0
9	7241922	.	T	C	5	2	7	0	1	8	0	0
9	7242214	.	G	A	2	4	6	0	0	6	0	0
9	7242534	.	C	A	0	5	5	0	0	5	0	0
9	7242880	.	C	G	0	7	7	0	2	9	0	0
9	7244659	.	T	C	1	3	4	0	0	4	0	0
9	7244985	.	C	T	3	6	9	0	0	9	0	0
9	7245004	.	C	T	7	2	9	0	0	9	0	0
9	7245023	.	T	C	4	6	10	0	0	10	0	0
9	7245075	.	T	G	3	6	9	0	0	9	0	0
9	7245218	.	C	T	2	2	4	0	0	4	0	0
9	7245226	.	A	G	3	1	4	0	1	5	0	0
9	7245681	.	C	G	2	4	6	0	0	6	0	0
9	7245868	.	C	T	0	2	2	0	3	5	0	0
9	7249063	.	G	C	4	4	8	0	1	9	0	0
9	7249072	.	T	A	4	7	11	0	0	11	0	0
9	7249156	.	G	A	7	7	14	0	0	14	0	0
9	7249273	.	T	C	4	8	12	0	0	12	0	0
9	7249443	.	G	T	8	4	12	0	1	13	0	0
9	7516034	.	G	T	3	2	5	0	1	6	0	0
9	7516095	.	G	T	2	2	4	0	0	4	0	0
9	7548591	.	A	G	10	8	18	0	0	18	0	0
9	7548600	.	T	A	12	10	22	0	0	22	0	0
9	7570857	.	A	G	18	2	20	0	29	49	0	0
9	7570891	.	T	A	18	24	42	0	1	43	0	0
9	7574042	.	T	A	8	6	14	0	0	14	0	0
9	7574126	.	C	T	1	4	5	0	1	6	0	0
9	7574135	.	A	T	0	4	4	0	0	4	0	0
9	7575309	.	G	A	7	6	13	0	1	14	0	0
9	7575545	.	A	C	4	3	7	0	0	7	0	0
9	7578595	.	G	C	3	6	9	0	0	9	0	0
9	7604524	.	G	A	13	9	22	0	1	23	0	0
9	7618903	.	A	C	8	9	17	0	2	19	0	0
9	7618906	.	T	C	6	11	17	0	3	20	0	0
9	7635236	.	C	G	1	2	3	0	0	3	0	0
9	7635730	.	C	T	0	2	2	0	1	3	0	0
9	7635925	.	G	A	7	6	13	0	0	13	0	0
9	7671165	.	G	A	4	15	19	0	0	19	0	0
9	7909543	.	G	A	3	3	6	0	3	9	0	0
9	7981498	.	C	G	0	0	0	0	2	2	0	0
9	7995812	.	G	A	1	2	3	0	0	3	0	0
9	8064308	.	C	T	1	1	2	0	0	2	0	0
9	8090089	.	G	T	0	1	1	0	0	1	0	0
9	8090240	.	C	T	5	5	10	0	1	11	0	0
9	8114242	.	T	C	3	3	6	0	0	6	0	0
9	8120971	.	C	T	4	3	7	0	1	8	0	0
9	8121026	.	A	C	9	8	17	0	2	19	0	0
9	8121041	.	C	T	9	10	19	0	0	19	0	0
9	8121093	.	A	G	8	11	19	0	0	19	0	0
9	8121113	.	A	G	10	8	18	0	2	20	0	0
9	8122429	.	C	T	9	7	16	0	3	19	0	0
9	8128576	.	G	A	7	10	17	0	0	17	0	0
9	8429782	.	T	C	14	13	27	0	0	27	0	0
9	8429899	.	A	G	13	10	23	0	7	30	0	0
9	8430162	.	A	G	16	19	35	0	2	37	0	0
9	8430424	.	A	G	11	14	25	0	1	26	0	0
9	8430430	.	C	T	14	11	25	0	0	25	0	0
9	8430464	.	G	A	15	8	23	0	3	26	0	0
9	8430527	.	T	C	10	0	10	0	14	24	0	0
9	8430881	.	C	T	15	7	22	0	2	24	0	0
9	8430962	.	T	C	14	17	31	0	0	31	0	0
9	8431031	.	A	G	25	7	32	0	1	33	0	0
9	8431256	.	G	A	16	13	29	0	0	29	0	0
9	8431345	.	A	C	8	0	8	0	10	18	0	0
9	8431450	.	A	G	13	9	22	0	3	25	0	0
9	8431541	.	A	T	13	10	23	0	1	24	0	0
9	8431714	.	G	T	7	5	12	0	3	15	0	0
9	8431772	.	C	T	10	7	17	0	2	19	0	0
9	8431814	.	A	G	11	12	23	1	1	25	0	0
9	8431837	.	T	C	10	10	20	1	2	23	0	0
9	8431854	.	T	C	8	10	18	1	0	19	0	0
9	8431894	.	A	G	9	7	16	0	1	17	0	0
9	8431998	.	A	C	10	1	11	0	4	15	0	0
9	8432768	.	A	T	15	4	19	0	1	20	0	0
9	8433205	.	G	A	8	10	18	0	0	18	0	0
9	8450740	.	G	A	7	9	16	0	0	16	0	0
9	8450788	.	G	A	9	8	17	0	0	17	0	0
9	8451265	.	G	A	10	3	13	0	0	13	0	0
9	8451312	.	A	G	3	5	8	0	0	8	0	0
9	8451540	.	C	T	13	9	22	0	0	22	0	0
9	8451633	.	G	A	5	11	16	0	2	18	0	0
9	8452099	.	T	C	3	1	4	0	8	12	0	0
9	8452405	.	T	C	2	0	2	0	8	10	0	0
9	8452695	.	C	T	10	8	18	0	1	19	0	0
9	8452705	.	G	A	12	7	19	0	1	20	0	0
9	8888289	.	G	A	3	9	12	0	0	12	0	0
9	8898906	.	G	A	0	6	6	0	7	13	0	0
9	8899665	.	C	T	4	3	7	0	0	7	0	0
9	8899704	.	C	T	12	4	16	0	2	18	0	0
9	8899948	.	G	A	0	9	9	0	9	18	0	0
9	8899974	.	A	G	12	7	19	0	0	19	0	0
9	8903523	.	G	C	4	2	6	0	1	7	0	0
9	8904032	.	C	T	0	0	0	0	0	0	0	0
9	8910116	.	A	T	2	7	9	0	0	9	0	0
9	8914657	.	G	C	2	4	6	0	0	6	0	0
9	8964925	.	G	T	5	5	10	0	0	10	0	0
9	8967459	.	C	T	15	15	30	0	1	31	0	0
9	8968956	.	G	A	1	3	4	0	0	4	0	0
9	8969067	.	C	T	7	3	10	0	0	10	0	0
9	8969571	.	T	C	1	0	1	0	0	1	0	0
9	8971995	.	A	C	9	10	19	0	1	20	0	0
9	8972294	.	A	G	15	10	25	0	1	26	0	0
9	8972340	.	C	G	18	22	40	0	1	41	0	0
9	8972468	.	A	G	13	8	21	0	6	27	0	0
9	8972601	.	G	A	11	12	23	0	0	23	0	0
9	8973188	.	G	T	3	3	6	0	1	8	1	0
9	8973335	.	T	G	2	8	10	0	0	10	0	0
9	8973379	.	T	G	5	3	8	0	0	8	0	0
9	8974221	.	T	C	5	5	10	0	1	11	0	0
9	9112417	.	G	T	2	2	4	0	0	4	0	0
9	9116845	.	C	A	3	1	4	0	0	4	0	0
9	9116890	.	C	T	6	11	17	0	0	17	0	0
9	9117542	.	T	C	4	9	13	0	0	13	0	0
9	9118363	.	A	C	6	3	9	0	0	9	0	0
9	9118602	.	G	A	3	6	9	0	1	10	0	0
9	9118695	.	C	T	2	4	6	0	0	6	0	0
9	9118701	.	A	G	2	3	5	0	0	5	0	0
9	9118991	.	C	T	14	17	31	0	3	34	0	0
9	9118994	.	C	T	14	19	33	0	0	33	0	0
9	9119417	.	C	T	12	10	22	0	1	23	0	0
9	9119987	.	T	C	3	3	6	0	0	6	0	0
9	9120185	.	A	G	11	11	22	0	0	22	0	0
9	9120271	.	T	C	12	10	22	0	1	23	0	0
9	9120847	.	G	A	9	11	20	0	3	23	0	0
9	9121242	.	T	C	13	12	25	0	0	25	0	0
9	9121382	.	G	A	3	7	10	0	0	10	0	0
9	9121917	.	A	T	10	8	18	0	0	18	0	0
9	9183768	.	C	A	7	12	19	0	2	21	0	0
9	9183784	.	A	T	12	8	20	0	0	20	0	0
9	9183848	.	C	A	1	10	11	0	21	32	0	0
9	9183969	.	T	A	20	13	33	0	1	34	0	0
9	9184593	.	T	C	12	18	30	0	1	31	0	0
9	9193044	.	A	C	0	2	2	0	0	2	0	0
9	9198202	.	A	C	18	13	31	0	1	32	0	0
9	9202668	.	T	C	1	1	2	0	0	2	0	0
9	9205089	.	G	A	2	1	3	0	1	4	0	0
9	9206612	.	C	G	1	8	9	0	1	10	0	0
9	9208759	.	A	T	14	12	26	0	1	27	0	0
9	9208786	.	G	A	10	15	25	0	1	26	0	0
9	9225717	.	C	T	8	12	20	0	0	20	0	0
9	9235825	.	G	C	2	0	2	0	8	10	0	0
9	9235849	.	T	C	7	0	7	0	15	22	0	0
9	9238577	.	G	A	3	6	9	0	1	10	0	0
9	9238583	.	G	A	3	7	10	0	0	10	0	0
9	9241683	.	A	G	7	3	10	0	0	10	0	0
9	9322661	.	C	A	2	11	13	0	1	14	0	0
9	9322664	.	A	G	2	12	14	0	0	14	0	0
9	9322733	.	G	A	7	8	15	0	0	15	0	0
9	9342835	.	T	A	8	7	15	0	0	15	0	0
9	9342892	.	C	T	9	10	19	0	0	19	0	0
9	9342994	.	A	G	1	1	2	0	0	2	0	0
9	9345134	.	G	A	4	4	8	0	0	8	0	0
9	9345329	.	A	G	6	2	8	0	0	8	0	0
9	9345709	.	A	G	1	5	6	0	0	6	0	0
9	9345751	.	C	T	0	3	3	0	0	3	0	0
9	9542761	.	C	T	2	1	3	0	0	3	0	0
9	9542773	.	G	A	1	2	3	0	0	3	0	0
9	9542914	.	G	A	1	1	2	0	0	2	0	0
9	9544932	.	C	T	2	1	3	0	0	3	0	0
9	9561816	.	A	T	2	2	4	0	0	4	0	0
9	9578829	.	T	A	22	21	43	0	2	45	0	0
9	9578880	.	G	A	21	20	41	0	2	43	0	0
9	9578936	.	T	G	16	23	39	0	2	41	0	0
9	9579078	.	A	T	22	9	31	0	0	31	0	0
9	9579165	.	C	T	15	16	31	0	4	35	0	0
9	9579551	.	T	A	3	8	11	0	2	13	0	0
9	9579653	.	G	A	18	13	31	0	2	33	0	0
9	9592761	.	G	A	1	1	2	0	0	2	0	0
9	9599452	.	A	G	3	7	10	0	0	10	0	0
9	9670925	.	G	C	6	4	10	0	0	10	0	0
9	9671208	.	G	A	15	8	23	0	0	23	0	0
9	9719301	.	C	T	4	3	7	0	0	7	0	0
9	9719311	.	T	A	4	3	7	0	0	7	0	0
9	9719685	.	A	G	3	2	5	0	0	5	0	0
9	9720319	.	A	G	2	2	4	0	0	4	0	0
9	9720342	.	G	A	2	3	5	0	1	6	0	0
9	9720715	.	G	A	0	3	3	0	0	3	0	0
9	9731771	.	G	A	2	2	4	0	0	4	0	0
9	9732106	.	T	A	1	2	3	0	0	3	0	0
9	9732125	.	C	T	1	3	4	0	0	4	0	0
9	9737150	.	T	C	16	0	16	0	5	21	0	0
9	9737592	.	T	A	7	8	15	0	0	15	0	0
9	9737821	.	C	T	7	9	16	0	2	18	0	0
9	9739135	.	T	C	3	3	6	0	0	6	0	0
9	9930038	.	T	C	3	5	8	0	0	8	0	0
9	9930182	.	T	A	1	2	3	0	0	3	0	0
9	9934733	.	A	G	1	0	1	0	2	3	0	0
9	9937808	.	T	C	0	1	1	0	0	1	0	0
9	9941440	.	G	A	0	2	2	0	0	2	0	0
9	9948145	.	C	T	2	6	8	0	0	8	0	0
9	9953683	.	T	A	5	3	8	0	0	8	0	0
9	10014889	.	G	A	10	4	14	0	1	15	0	0
9	10014972	.	G	A	0	2	2	0	7	9	0	0
9	10015090	.	T	C	7	4	11	0	1	12	0	0
9	10043130	.	T	C	4	3	7	0	0	7	0	0
9	10043201	.	C	G	9	4	13	0	0	14	1	0
9	10043415	.	C	T	9	7	16	0	1	17	0	0
9	10043673	.	C	T	7	11	18	0	1	19	0	0
9	10043739	.	C	T	10	9	19	0	1	20	0	0
9	10051006	.	G	A	9	3	12	0	0	12	0	0
9	10051080	.	T	A	7	6	13	0	0	13	0	0
9	10051354	.	A	G	5	5	10	0	0	10	0	0
9	10138338	.	G	A	9	7	16	0	1	17	0	0
9	10138486	.	G	A	8	6	14	0	0	14	0	0
9	10153342	.	T	A	9	7	16	0	2	18	0	0
9	10153590	.	A	C	9	8	17	0	2	19	0	0
9	10153689	.	G	C	12	9	21	0	0	21	0	0
9	10153705	.	A	T	7	10	17	0	0	17	0	0
9	10154013	.	G	T	11	12	23	0	0	23	0	0
9	10154014	.	C	T	11	12	23	0	0	23	0	0
9	10154138	.	T	C	8	11	19	0	0	19	0	0
9	10154195	.	A	T	4	5	9	0	0	9	0	0
9	10154344	.	T	A	3	2	5	0	0	5	0	0
9	10154461	.	C	T	6	7	13	0	0	13	0	0
9	10154608	.	T	A	3	5	8	0	0	8	0	0
9	10155284	.	A	G	3	6	9	0	0	9	0	0
9	10155977	.	G	A	0	2	2	1	0	3	0	0
9	10156145	.	C	A	7	7	14	0	1	15	0	0
9	10157193	.	C	G	1	6	7	0	1	8	0	0
9	10157397	.	G	A	6	4	10	0	2	12	0	0
9	10168945	.	C	T	0	0	0	0	5	5	0	0
9	10175770	.	C	G	0	1	1	0	0	1	0	0
9	10175785	.	A	G	2	2	4	0	0	4	0	0
9	10175812	.	G	A	6	3	9	0	0	9	0	0
9	10183289	.	C	T	1	0	1	0	0	1	0	0
9	10195488	.	T	A	1	0	1	0	0	1	0	0
9	10199946	.	G	A	0	2	2	0	0	2	0	0
9	10759881	.	A	G	1	2	3	0	0	3	0	0
9	11533292	.	C	T	9	8	17	0	0	17	0	0
9	11533594	.	A	G	9	3	12	0	2	14	0	0
9	11534589	.	T	G	1	4	5	0	0	5	0	0
9	11586656	.	T	A	0	1	1	0	0	1	0	0
9	11592221	.	G	A	0	1	1	0	2	3	0	0
9	11597511	.	A	C	6	10	16	0	0	16	0	0
9	11597569	.	T	A	1	6	7	0	1	8	0	0
9	11597607	.	A	T	2	6	8	0	0	8	0	0
9	11597628	.	C	A	2	8	10	0	0	10	0	0
9	11597803	.	A	T	4	4	8	0	0	8	0	0
9	11597823	.	T	A	8	1	9	0	0	9	0	0
9	11598029	.	T	C	9	1	10	0	1	11	0	0
9	11598149	.	T	C	3	5	8	0	0	8	0	0
9	11598208	.	G	A	4	7	11	0	0	11	0	0
9	11598312	.	C	T	0	7	7	0	13	20	0	0
9	11601089	.	C	T	0	3	3	0	7	10	0	0
9	11601092	.	G	A	7	3	10	0	0	10	0	0
9	11602010	.	A	C	2	0	2	0	1	3	0	0
9	11602207	.	A	G	2	2	4	0	1	5	0	0
9	11602255	.	G	A	2	3	5	0	1	6	0	0
9	11612254	.	A	G	1	1	2	0	0	2	0	0
9	11616134	.	T	C	6	0	6	0	4	10	0	0
9	11619638	.	A	T	3	5	8	0	0	8	0	0
9	11626468	.	T	C	3	3	6	0	1	7	0	0
9	11626478	.	A	G	3	4	7	0	0	7	0	0
9	11628107	.	G	A	1	2	3	0	0	3	0	0
9	11652589	.	G	T	2	1	3	0	0	3	0	0
9	11665071	.	T	A	9	5	14	0	3	17	0	0
9	11665075	.	C	T	11	6	17	0	0	17	0	0
9	11665875	.	T	C	19	11	30	0	0	30	0	0
9	11670127	.	G	A	3	2	5	0	0	5	0	0
9	11906956	.	A	G	9	11	20	0	1	21	0	0
9	11907823	.	G	A	9	9	18	0	0	18	0	0
9	11908453	.	T	C	7	4	11	0	0	11	0	0
9	11908503	.	C	T	4	6	10	0	0	10	0	0
9	11908521	.	C	T	5	5	10	0	1	11	0	0
9	11908855	.	G	A	14	4	18	0	0	18	0	0
9	11908900	.	T	C	15	5	20	0	1	21	0	0
9	11909061	.	C	T	5	2	7	0	0	7	0	0
9	11909318	.	A	C	8	3	11	0	1	12	0	0
9	11909575	.	A	G	6	3	9	0	0	9	0	0
9	11910171	.	G	A	1	3	4	0	0	5	1	0
9	12263245	.	T	A	2	3	5	0	0	5	0	0
9	12269833	.	A	G	0	3	3	0	0	3	0	0
9	12405430	.	T	C	3	5	8	0	0	8	0	0
9	12405454	.	G	T	2	8	10	0	0	10	0	0
9	12405544	.	G	T	5	8	13	0	1	14	0	0
9	12405559	.	T	A	4	9	13	0	1	14	0	0
9	12405684	.	C	G	8	5	13	0	0	13	0	0
9	12405796	.	A	C	4	7	11	0	0	11	0	0
9	12423497	.	A	G	2	1	3	0	0	3	0	0
9	12424725	.	G	T	5	7	12	0	0	12	0	0
9	12424758	.	C	T	0	5	5	0	3	8	0	0
9	12444590	.	C	T	3	3	6	0	0	6	0	0
9	12454478	.	A	C	5	3	8	0	1	9	0	0
9	12454818	.	C	T	8	4	12	0	0	12	0	0
9	12454823	.	C	T	9	4	13	0	0	13	0	0
9	12455343	.	C	T	16	6	22	0	2	24	0	0
9	12582251	.	C	T	10	16	26	0	0	26	0	0
9	12584902	.	T	C	14	0	14	0	20	34	0	0
9	12589968	.	T	C	6	7	13	0	1	14	0	0
9	12590019	.	A	G	16	11	27	0	0	27	0	0
9	12590269	.	A	T	5	5	10	0	0	10	0	0
9	12590356	.	T	G	3	9	12	0	0	12	0	0
9	12594685	.	G	T	12	10	22	0	1	23	0	0
9	12648898	.	C	T	0	7	7	0	14	21	0	0
9	12649224	.	T	C	11	7	18	0	2	20	0	0
9	12649429	.	A	C	17	7	24	1	1	26	0	0
9	12847219	.	T	C	1	2	3	0	0	3	0	0
9	12865859	.	C	T	2	2	4	0	0	4	0	0
9	12866414	.	A	G	1	2	3	0	0	3	0	0
9	12866865	.	C	G	1	1	2	0	1	3	0	0
9	12866868	.	C	T	1	2	3	0	0	3	0	0
9	12870473	.	C	G	2	1	3	0	0	3	0	0
9	12870543	.	T	A	1	7	8	0	0	8	0	0
9	12871640	.	G	A	2	2	4	0	0	4	0	0
9	12883064	.	G	A	1	0	1	0	0	1	0	0
9	12883109	.	C	T	0	1	1	0	0	1	0	0
9	12884742	.	G	A	1	2	3	0	0	3	0	0
9	12912985	.	G	C	1	4	5	0	0	5	0	0
9	12921787	.	G	A	1	2	3	0	0	3	0	0
9	12925881	.	T	C	2	2	4	0	0	4	0	0
9	12932318	.	G	A	0	1	1	0	0	1	0	0
9	12943867	.	G	A	0	3	3	0	0	3	0	0
9	12944578	.	G	A	4	5	9	0	0	9	0	0
9	12944652	.	A	G	4	3	7	0	0	7	0	0
9	12945474	.	A	G	0	3	3	0	0	3	0	0
9	12947400	.	A	T	3	3	6	0	1	7	0	0
9	12947414	.	G	A	5	4	9	0	0	9	0	0
9	12947708	.	A	G	2	3	5	0	0	5	0	0
9	12947742	.	A	G	1	6	7	0	0	7	0	0
9	12947919	.	G	T	2	3	5	0	0	5	0	0
9	12948133	.	G	A	1	2	3	0	0	3	0	0
9	12948144	.	A	G	1	3	4	0	0	4	0	0
9	12948176	.	A	T	2	3	5	0	0	5	0	0
9	12948332	.	A	T	4	2	6	0	0	6	0	0
9	12948410	.	G	C	2	6	8	0	0	8	0	0
9	12948565	.	G	A	0	3	3	0	2	5	0	0
9	12948577	.	C	T	1	4	5	0	0	5	0	0
9	12948649	.	A	G	7	3	10	0	1	11	0	0
9	12948656	.	A	G	5	6	11	0	1	12	0	0
9	12948798	.	G	T	5	6	11	0	0	11	0	0
9	12951293	.	G	A	0	5	5	0	9	14	0	0
9	12951362	.	G	A	2	4	6	0	0	6	0	0
9	12953742	.	T	C	4	2	6	0	1	7	0	0
9	12953810	.	T	C	1	2	3	0	1	4	0	0
9	12959823	.	A	T	4	5	9	0	1	10	0	0
9	12959854	.	A	G	3	4	7	0	1	8	0	0
9	12959918	.	T	C	4	5	9	0	2	11	0	0
9	12960030	.	A	C	3	5	8	0	0	8	0	0
9	12960035	.	A	C	3	4	7	0	0	7	0	0
9	12960386	.	T	C	2	4	6	0	0	6	0	0
9	13076901	.	A	G	1	0	1	0	1	2	0	0
9	13080919	.	G	A	2	1	3	0	0	3	0	0
9	13106541	.	C	T	8	10	18	0	1	19	0	0
9	13106643	.	T	C	10	10	20	0	1	21	0	0
9	13106715	.	A	T	5	6	11	0	0	11	0	0
9	13106736	.	A	G	7	1	8	0	5	13	0	0
9	13106922	.	A	G	6	6	12	0	0	12	0	0
9	13106943	.	A	T	6	4	10	0	1	11	0	0
9	13107513	.	G	A	1	10	11	0	4	15	0	0
9	13107576	.	G	A	0	6	6	0	2	8	0	0
9	13107577	.	G	T	2	6	8	0	0	8	0	0
9	13107642	.	C	T	7	3	10	0	1	11	0	0
9	13107730	.	A	G	1	0	1	0	0	1	0	0
9	13110916	.	T	A	10	4	14	0	0	14	0	0
9	13110955	.	C	T	7	4	11	0	0	11	0	0
9	13212548	.	C	T	1	2	3	0	1	4	0	0
9	13229760	.	C	T	0	3	3	0	0	3	0	0
9	13229814	.	C	G	0	3	3	0	0	3	0	0
9	13230182	.	T	C	1	3	4	0	1	5	0	0
9	13230322	.	A	G	1	1	2	0	0	2	0	0
9	13230942	.	T	C	0	2	2	0	0	2	0	0
9	13230957	.	T	C	0	2	2	0	0	2	0	0
9	13233402	.	G	A	0	2	2	0	5	7	0	0
9	13233609	.	C	T	1	2	3	0	0	3	0	0
9	13233634	.	G	A	0	4	4	0	3	7	0	0
9	13233655	.	A	G	2	3	5	0	1	6	0	0
9	13235245	.	T	C	2	4	6	0	0	6	0	0
9	13236873	.	T	C	1	3	4	0	0	4	0	0
9	13241833	.	G	A	0	1	1	0	0	1	0	0
9	13246442	.	G	T	5	10	15	0	0	16	1	0
9	13352499	.	A	T	4	5	9	0	1	10	0	0
9	13352687	.	A	G	6	14	20	0	0	20	0	0
9	13352720	.	C	A	1	8	9	0	1	10	0	0
9	13353097	.	A	G	7	5	12	0	0	12	0	0
9	13354874	.	T	C	3	4	7	0	3	10	0	0
9	13354910	.	C	G	5	3	8	0	1	9	0	0
9	13720291	.	A	G	7	2	9	0	0	9	0	0
9	13722630	.	A	G	2	0	2	0	1	3	0	0
9	13765232	.	T	C	15	6	21	0	0	22	1	0
9	13774639	.	T	C	11	11	22	0	2	24	0	0
9	13797720	.	T	G	15	0	15	0	7	22	0	0
9	13799301	.	T	C	19	8	27	0	0	27	0	0
9	13799463	.	G	A	18	2	20	0	3	23	0	0
9	13799540	.	T	A	11	12	23	0	0	23	0	0
9	13803002	.	G	A	12	14	26	0	0	26	0	0
9	13815245	.	G	C	17	0	17	0	16	33	0	0
9	13815415	.	A	T	8	13	21	0	5	26	0	0
9	13815485	.	A	G	12	23	35	0	1	36	0	0
9	13815575	.	A	G	5	17	22	0	0	22	0	0
9	13815875	.	T	C	6	8	14	0	1	15	0	0
9	13816130	.	A	G	10	10	20	0	2	22	0	0
9	13816505	.	A	G	5	10	15	0	1	16	0	0
9	13816708	.	T	C	13	5	18	0	2	20	0	0
9	13816758	.	G	A	12	8	20	0	0	20	0	0
9	13816784	.	T	C	13	0	13	0	9	22	0	0
9	13816829	.	C	T	8	8	16	0	3	19	0	0
9	13820234	.	C	T	0	6	6	0	6	12	0	0
9	13839737	.	C	T	0	5	5	0	5	10	0	0
9	14023457	.	C	G	13	13	26	0	0	26	0	0
9	14023493	.	T	A	13	14	27	0	0	27	0	0
9	14023856	.	A	G	7	6	13	0	3	16	0	0
9	14024067	.	T	C	0	1	1	0	0	1	0	0
9	14027874	.	T	A	6	7	13	0	0	13	0	0
9	14027889	.	A	G	4	6	10	0	2	12	0	0
9	14028114	.	T	C	10	6	16	0	0	16	0	0
9	14033029	.	A	G	2	0	2	0	2	4	0	0
9	14037508	.	C	G	11	7	18	0	0	18	0	0
9	14037569	.	T	C	7	3	10	0	0	10	0	0
9	14038110	.	C	T	4	7	11	0	0	11	0	0
9	14038118	.	A	T	4	6	10	0	0	10	0	0
9	14038176	.	C	A	5	2	7	0	0	7	0	0
9	14040972	.	T	C	3	2	5	0	0	5	0	0
9	14112784	.	T	A	6	3	9	0	1	10	0	0
9	14196329	.	A	G	6	2	8	0	0	8	0	0
9	14197103	.	A	G	13	4	17	0	1	18	0	0
9	14368590	.	G	A	1	5	6	0	0	6	0	0
9	17183689	.	C	T	5	2	7	0	1	8	0	0
9	17348855	.	C	A	14	6	20	0	2	22	0	0
9	17348977	.	G	A	3	4	7	0	1	8	0	0
9	17349272	.	C	T	4	2	6	0	0	6	0	0
9	17368825	.	C	T	3	1	4	0	0	4	0	0
9	17368889	.	A	C	11	11	22	0	1	23	0	0
9	17368904	.	C	T	11	12	23	0	2	25	0	0
9	17369071	.	G	A	11	10	21	0	3	24	0	0
9	17378203	.	A	G	3	2	5	0	0	5	0	0
9	17378276	.	A	T	14	7	21	0	0	21	0	0
9	17386091	.	G	A	0	8	8	0	6	14	0	0
9	17386092	.	A	T	6	8	14	0	0	14	0	0
9	17386341	.	G	T	4	2	6	0	1	7	0	0
9	17424225	.	A	G	1	0	1	0	5	6	0	0
9	17424537	.	C	T	1	2	3	0	0	3	0	0
9	17425308	.	T	C	3	2	5	0	0	5	0	0
9	17431348	.	C	T	5	3	8	0	1	9	0	0
9	17431469	.	A	G	1	0	1	0	3	4	0	0
9	17431818	.	C	T	5	4	9	0	0	9	0	0
9	17431925	.	A	T	1	5	6	0	0	6	0	0
9	17432022	.	T	A	4	2	6	0	0	6	0	0
9	17432023	.	T	C	2	3	5	0	1	6	0	0
9	17432170	.	T	C	2	5	7	0	1	8	0	0
9	17432470	.	T	C	6	4	10	0	0	10	0	0
9	17432484	.	C	A	4	3	7	0	2	9	0	0
9	17433769	.	T	G	5	3	8	0	1	9	0	0
9	17433794	.	G	C	4	3	7	0	0	7	0	0
9	17445268	.	T	C	2	1	3	0	0	3	0	0
9	17449399	.	T	C	3	2	5	0	1	6	0	0
9	17542983	.	C	T	0	6	6	0	3	9	0	0
9	17542985	.	A	G	6	3	9	0	0	9	0	0
9	17563067	.	C	T	2	0	2	0	0	2	0	0
9	17600571	.	C	T	0	0	0	0	2	2	0	0
9	17641518	.	C	T	2	5	7	0	1	8	0	0
9	17646993	.	G	T	2	4	6	0	1	7	0	0
9	17674495	.	C	T	1	2	3	0	0	3	0	0
9	17745246	.	T	C	1	1	2	0	0	2	0	0
9	17747719	.	A	G	1	0	1	0	0	1	0	0
9	17766300	.	C	T	1	0	1	0	3	4	0	0
9	17772268	.	C	T	2	3	5	0	0	5	0	0
9	17781994	.	C	T	0	2	2	0	0	2	0	0
9	17862887	.	G	A	0	0	0	0	3	3	0	0
9	17900487	.	C	T	1	5	6	0	0	6	0	0
9	17907587	.	A	T	0	1	1	0	0	1	0	0
9	17907768	.	G	A	2	1	3	0	1	4	0	0
9	17908818	.	G	A	3	4	7	0	0	7	0	0
9	17915275	.	A	G	3	0	3	0	1	4	0	0
9	17918627	.	G	A	2	2	4	0	0	4	0	0
9	17918681	.	G	A	0	1	1	0	0	1	0	0
9	17934232	.	G	A	8	5	13	0	0	13	0	0
9	17934262	.	T	C	8	3	11	0	0	11	0	0
9	17940161	.	C	T	6	4	10	0	1	11	0	0
9	17984877	.	G	T	0	6	6	0	6	12	0	0
9	18001161	.	T	G	27	8	35	0	2	37	0	0
9	18003290	.	G	A	0	4	4	0	3	7	0	0
9	18003487	.	C	A	15	15	30	0	1	31	0	0
9	18003823	.	G	A	1	19	20	0	20	40	0	0
9	18003856	.	T	G	18	0	18	0	21	39	0	0
9	18004476	.	A	C	23	13	36	0	6	42	0	0
9	18005023	.	C	T	22	14	36	0	1	37	0	0
9	18005065	.	C	T	18	21	39	0	2	41	0	0
9	18005217	.	A	T	13	10	23	0	0	23	0	0
9	18005245	.	T	C	16	12	28	0	0	28	0	0
9	18005507	.	C	T	12	13	25	0	2	27	0	0
9	18005655	.	T	A	13	11	24	0	1	25	0	0
9	18005806	.	A	G	18	9	27	0	0	27	0	0
9	18005818	.	A	G	11	13	24	0	5	29	0	0
9	18005879	.	T	A	15	19	34	0	1	35	0	0
9	18005977	.	T	C	22	24	46	0	3	49	0	0
9	18006144	.	T	A	20	15	35	0	5	40	0	0
9	18006282	.	C	T	29	22	51	0	1	52	0	0
9	18235382	.	A	T	3	0	3	0	0	3	0	0
9	18277985	.	T	A	14	16	30	0	1	31	0	0
9	18278009	.	A	G	17	5	22	0	9	31	0	0
9	18278110	.	C	T	2	2	4	0	1	5	0	0
9	18278366	.	G	T	9	7	16	0	0	16	0	0
9	18278431	.	C	T	6	3	9	0	0	9	0	0
9	18278463	.	A	G	2	2	4	0	0	4	0	0
9	18310309	.	G	A	8	11	19	0	0	19	0	0
9	18320009	.	G	A	3	1	4	0	0	4	0	0
9	18390683	.	C	T	7	6	13	0	0	13	0	0
9	18392903	.	C	A	4	4	8	0	0	8	0	0
9	18392924	.	G	A	3	1	4	0	0	4	0	0
9	18424775	.	C	T	5	4	9	0	0	9	0	0
9	18568860	.	C	T	0	5	5	0	10	15	0	0
9	18568875	.	T	C	9	0	9	0	9	18	0	0
9	18716630	.	T	A	25	7	32	0	3	35	0	0
9	18732543	.	T	A	2	5	7	0	0	7	0	0
9	18732819	.	T	C	27	19	46	0	3	49	0	0
9	18733062	.	G	T	23	31	54	0	6	60	0	0
9	18733545	.	G	T	36	28	64	0	7	71	0	0
9	18742401	.	G	T	2	3	5	0	0	5	0	0
9	18742562	.	A	G	1	2	3	0	0	3	0	0
9	18812824	.	G	C	8	9	17	0	2	19	0	0
9	18812960	.	A	G	14	9	23	0	1	24	0	0
9	18813462	.	G	A	11	6	17	0	0	17	0	0
9	18813467	.	A	G	10	6	16	0	0	16	0	0
9	18813624	.	G	A	9	3	12	0	0	12	0	0
9	18813650	.	T	C	6	4	10	0	1	11	0	0
9	18813755	.	T	C	2	6	8	0	0	8	0	0
9	18814056	.	C	T	3	3	6	0	1	7	0	0
9	18814328	.	A	G	6	5	11	0	0	11	0	0
9	18814598	.	T	C	9	12	21	0	1	22	0	0
9	18876266	.	G	A	18	14	32	0	1	33	0	0
9	18876402	.	C	A	10	12	22	0	0	22	0	0
9	18876403	.	C	A	10	12	22	0	0	22	0	0
9	18876592	.	G	T	30	24	54	0	2	56	0	0
9	18877051	.	G	A	18	14	32	0	3	35	0	0
9	18877078	.	G	A	21	12	33	0	3	36	0	0
9	18877485	.	T	C	16	0	16	0	20	36	0	0
9	18911575	.	G	A	3	6	9	0	0	9	0	0
9	19040846	.	C	T	3	3	6	0	0	6	0	0
9	19074840	.	A	G	1	6	7	0	0	7	0	0
9	19119185	.	T	C	3	11	14	0	0	14	0	0
9	19307064	.	C	T	1	2	3	0	0	3	0	0
9	19340429	.	G	A	1	2	3	0	0	3	0	0
9	19348648	.	T	C	1	2	3	0	1	4	0	0
9	19352176	.	G	A	0	3	3	0	0	3	0	0
9	19364025	.	G	A	1	1	2	0	1	3	0	0
9	19407483	.	G	T	1	2	3	0	1	4	0	0
9	19407614	.	G	T	5	4	9	0	0	9	0	0
9	19421855	.	T	C	4	1	5	0	0	5	0	0
9	19469133	.	C	T	6	7	13	0	0	13	0	0
9	19471377	.	A	G	4	3	7	0	0	7	0	0
9	19484382	.	G	A	0	0	0	0	1	1	0	0
9	19488371	.	C	T	0	0	0	0	1	1	0	0
9	19504678	.	C	T	8	6	14	0	1	15	0	0
9	19510699	.	G	A	14	9	23	0	1	24	0	0
9	19510730	.	T	G	10	6	16	0	2	18	0	0
9	19510773	.	A	G	12	6	18	0	0	18	0	0
9	19510853	.	A	T	13	8	21	0	1	22	0	0
9	19510854	.	T	G	14	8	22	0	0	22	0	0
9	19527883	.	T	C	17	12	29	0	2	31	0	0
9	19527981	.	T	C	3	6	9	0	0	9	0	0
9	19534822	.	A	T	1	2	3	0	0	3	0	0
9	19545511	.	T	A	3	4	7	0	0	7	0	0
9	19549349	.	G	C	1	7	8	0	0	8	0	0
9	19549790	.	G	T	0	2	2	0	6	8	0	0
9	19646535	.	T	G	1	0	1	0	5	6	0	0
9	19648173	.	A	G	0	1	1	0	0	1	0	0
9	19648268	.	G	T	1	3	4	0	0	4	0	0
9	19652706	.	G	A	4	5	9	1	1	11	0	0
9	19653188	.	C	T	4	5	9	0	0	9	0	0
9	20076615	.	G	A	12	20	32	0	1	33	0	0
9	20077971	.	A	G	12	16	28	0	1	29	0	0
9	20078034	.	G	A	14	7	21	0	0	21	0	0
9	20078072	.	G	T	9	18	27	0	0	27	0	0
9	20095605	.	A	G	2	3	5	0	0	5	0	0
9	20095725	.	C	G	13	6	19	0	0	19	0	0
9	20160387	.	C	T	7	7	14	0	0	14	0	0
9	20175057	.	T	A	0	4	4	0	0	4	0	0
9	20191222	.	A	T	5	3	8	0	0	8	0	0
9	20191488	.	C	A	2	2	4	0	0	4	0	0
9	20315509	.	G	A	3	3	6	0	0	6	0	0
9	20372861	.	C	T	0	1	1	0	0	1	0	0
9	20372940	.	C	T	3	2	5	0	0	5	0	0
9	20498688	.	T	C	3	1	4	0	0	4	0	0
9	20498690	.	A	G	1	3	4	0	0	4	0	0
9	20498770	.	C	T	2	2	4	0	0	4	0	0
9	20500347	.	G	A	1	0	1	0	0	1	0	0
9	20558247	.	C	T	0	1	1	0	0	1	0	0
9	20623998	.	G	A	8	6	14	0	0	14	0	0
9	20663995	.	C	T	1	3	4	0	0	4	0	0
9	20700073	.	T	C	0	1	1	0	0	1	0	0
9	20731284	.	G	A	0	3	3	0	1	4	0	0
9	20734036	.	T	C	3	2	5	0	0	5	0	0
9	20749770	.	A	T	0	1	1	0	0	1	0	0
9	20763517	.	C	T	2	9	11	0	0	11	0	0
9	20763564	.	C	T	11	26	37	0	2	39	0	0
9	20763585	.	C	T	17	24	41	0	0	41	0	0
9	20763830	.	G	C	16	10	26	0	0	26	0	0
9	20763834	.	G	A	1	10	11	0	16	27	0	0
9	20764004	.	G	A	11	12	23	0	2	25	0	0
9	20764183	.	C	T	9	15	24	0	0	24	0	0
9	20764229	.	G	C	16	13	29	0	0	29	0	0
9	20764231	.	T	A	15	13	28	0	1	29	0	0
9	20764271	.	C	A	15	16	31	0	0	31	0	0
9	20764276	.	A	G	15	0	15	0	14	29	0	0
9	20764468	.	C	T	5	13	18	0	2	20	0	0
9	20764685	.	C	T	19	8	27	0	0	27	0	0
9	20764795	.	T	A	6	5	11	0	0	11	0	0
9	20764994	.	G	A	9	16	25	0	0	25	0	0
9	20765065	.	T	A	11	7	18	0	3	21	0	0
9	20765104	.	A	G	10	2	12	0	0	12	0	0
9	20765131	.	C	A	8	0	8	0	0	8	0	0
9	20806530	.	A	C	3	2	5	0	0	5	0	0
9	20806925	.	C	T	2	7	9	0	1	10	0	0
9	20806942	.	C	T	3	7	10	0	0	10	0	0
9	20807179	.	G	A	4	3	7	0	1	8	0	0
9	20807217	.	G	A	5	4	9	0	0	9	0	0
9	20833676	.	G	A	0	2	2	0	0	2	0	0
9	20850647	.	C	A	3	4	7	0	0	7	0	0
9	20850664	.	C	T	3	5	8	0	0	8	0	0
9	20850693	.	G	A	2	2	4	0	1	5	0	0
9	20853933	.	G	T	2	3	5	0	0	5	0	0
9	20856202	.	T	C	0	2	2	0	1	3	0	0
9	20858632	.	G	C	0	1	1	0	0	1	0	0
9	20859268	.	A	G	3	0	3	0	0	3	0	0
9	20860396	.	A	T	0	1	1	0	0	1	0	0
9	20863822	.	T	C	0	1	1	0	0	1	0	0
9	20869156	.	G	T	2	1	3	0	0	3	0	0
9	20872331	.	T	C	5	4	9	0	0	9	0	0
9	21072504	.	G	C	2	2	4	0	0	4	0	0
9	21072714	.	T	C	2	0	2	0	4	6	0	0
9	21076209	.	A	T	1	1	2	0	1	3	0	0
9	21076422	.	T	C	0	0	0	0	3	3	0	0
9	21084729	.	G	A	1	0	1	0	0	1	0	0
9	21084783	.	A	G	1	7	8	0	0	8	0	0
9	21084813	.	A	G	2	4	6	0	1	7	0	0
9	21098324	.	T	G	1	2	3	0	0	3	0	0
9	21203969	.	G	A	1	3	4	0	0	4	0	0
9	21205123	.	T	A	0	1	1	0	0	1	0	0
9	21217302	.	C	T	1	2	3	0	0	3	0	0
9	21217434	.	G	T	5	8	13	0	1	14	0	0
9	21221874	.	G	A	4	1	5	0	1	6	0	0
9	21221932	.	T	A	0	0	0	0	1	1	0	0
9	21222749	.	G	A	0	7	7	0	14	21	0	0
9	21222750	.	T	A	12	7	19	0	2	21	0	0
9	21222807	.	G	A	0	3	3	0	6	9	0	0
9	21224505	.	A	G	14	1	15	0	9	24	0	0
9	21224671	.	A	C	14	7	21	0	2	23	0	0
9	21224725	.	G	A	6	16	22	0	5	27	0	0
9	21224963	.	T	C	23	9	32	0	1	33	0	0
9	21225461	.	C	A	2	2	4	0	0	4	0	0
9	21225550	.	G	A	2	6	8	0	0	8	0	0
9	21225761	.	T	A	1	9	10	0	0	10	0	0
9	21225795	.	T	A	9	3	12	0	0	12	0	0
9	21225832	.	G	T	0	5	5	0	5	10	0	0
9	21230859	.	T	C	2	2	4	0	0	4	0	0
9	21235717	.	C	T	5	5	10	0	1	11	0	0
9	21235737	.	C	A	6	7	13	0	1	14	0	0
9	21267097	.	T	A	21	22	43	0	1	44	0	0
9	21267323	.	C	T	6	11	17	0	1	18	0	0
9	21268785	.	C	T	2	3	5	0	0	5	0	0
9	21271539	.	G	T	2	2	4	0	0	4	0	0
9	21271573	.	C	G	1	3	4	0	0	4	0	0
9	21271647	.	C	T	3	3	6	0	0	6	0	0
9	21271683	.	G	A	4	2	6	0	0	6	0	0
9	21271781	.	A	T	1	7	8	0	0	8	0	0
9	21271922	.	G	A	1	5	6	0	0	6	0	0
9	21272998	.	T	C	3	4	7	0	0	7	0	0
9	21273105	.	C	A	4	2	6	0	0	6	0	0
9	21336793	.	G	A	0	1	1	0	0	1	0	0
9	21339150	.	T	C	1	2	3	0	0	3	0	0
9	21341312	.	C	T	5	2	7	0	0	7	0	0
9	21345506	.	A	G	1	0	1	0	1	2	0	0
9	21347189	.	G	T	2	5	7	0	0	7	0	0
9	21347234	.	G	A	2	2	4	0	0	4	0	0
9	21349193	.	A	G	2	0	2	0	4	6	0	0
9	21356621	.	G	A	0	1	1	0	2	3	0	0
9	21357172	.	A	C	3	4	7	0	1	8	0	0
9	21357501	.	T	C	4	5	9	0	0	9	0	0
9	21357526	.	A	C	5	4	9	0	0	9	0	0
9	21361507	.	C	T	1	1	2	0	0	2	0	0
9	21361564	.	A	C	1	3	4	0	0	4	0	0
9	21362858	.	A	G	4	8	12	0	1	13	0	0
9	21365805	.	A	T	0	2	2	0	0	2	0	0
9	21366340	.	G	A	2	7	9	0	1	10	0	0
9	21366346	.	A	G	2	6	8	0	1	9	0	0
9	21374039	.	G	A	5	4	9	0	0	9	0	0
9	21375928	.	G	A	2	3	5	0	0	5	0	0
9	21375997	.	G	A	2	7	9	0	1	10	0	0
9	21376217	.	C	T	2	0	2	0	1	3	0	0
9	21376279	.	G	A	5	1	6	0	0	6	0	0
9	21376280	.	A	G	5	1	6	0	0	6	0	0
9	21377476	.	A	G	0	1	1	0	0	1	0	0
9	21379041	.	C	T	6	5	11	0	1	12	0	0
9	21383354	.	C	T	2	2	4	0	0	4	0	0
9	21383375	.	G	A	2	4	6	0	0	6	0	0
9	21383474	.	T	A	2	2	4	0	0	4	0	0
9	21383483	.	A	T	1	3	4	0	0	4	0	0
9	21383725	.	G	A	2	4	6	0	0	6	0	0
9	21383758	.	G	A	2	3	5	0	0	5	0	0
9	21384297	.	T	C	0	1	1	0	0	1	0	0
9	21385937	.	C	T	2	0	2	0	0	2	0	0
9	21388976	.	A	G	1	3	4	0	1	5	0	0
9	21391949	.	C	T	5	6	11	0	0	11	0	0
9	21399284	.	A	C	0	2	2	0	0	2	0	0
9	21399508	.	T	C	1	4	5	0	0	5	0	0
9	21430889	.	T	C	12	9	21	0	0	21	0	0
9	21437038	.	C	T	2	3	5	0	0	5	0	0
9	21437060	.	G	A	2	3	5	0	0	5	0	0
9	21437094	.	A	G	1	1	2	0	0	2	0	0
9	21437349	.	G	A	2	2	4	0	1	5	0	0
9	21440071	.	A	G	1	5	6	0	0	6	0	0
9	21443317	.	T	C	1	2	3	0	1	4	0	0
9	21443744	.	G	A	2	3	5	0	0	5	0	0
9	21446041	.	C	G	0	1	1	0	0	1	0	0
9	21448023	.	T	G	3	5	8	0	0	8	0	0
9	21453954	.	G	A	2	3	5	0	0	5	0	0
9	21462651	.	T	C	5	7	12	0	0	13	1	0
9	21462692	.	C	T	0	8	8	0	6	14	0	0
9	21463152	.	C	T	0	14	14	0	18	32	0	0
9	21463333	.	T	A	8	8	16	0	0	16	0	0
9	21470362	.	A	G	11	7	18	0	0	18	0	0
9	21471685	.	T	C	10	6	16	0	0	16	0	0
9	21472758	.	G	T	2	0	2	0	0	2	0	0
9	21476284	.	T	C	4	5	9	0	0	9	0	0
9	21476307	.	T	G	4	4	8	0	1	9	0	0
9	21478881	.	C	T	0	8	8	0	13	21	0	0
9	21478935	.	T	C	11	8	19	0	1	20	0	0
9	21479115	.	C	T	0	7	7	0	15	22	0	0
9	21479295	.	G	A	14	12	26	0	0	26	0	0
9	21495866	.	T	G	0	2	2	0	0	2	0	0
9	21497001	.	T	C	0	0	0	0	3	3	0	0
9	21535963	.	A	G	13	1	14	0	11	25	0	0
9	21540992	.	C	T	1	3	4	0	0	4	0	0
9	21550306	.	T	C	2	1	3	0	0	3	0	0
9	21554226	.	A	G	1	3	4	0	0	4	0	0
9	21558019	.	G	A	5	9	14	0	1	15	0	0
9	21558276	.	T	C	6	5	11	0	0	11	0	0
9	21558279	.	A	G	6	1	7	0	4	11	0	0
9	21560580	.	G	A	1	0	1	0	1	2	0	0
9	21560749	.	T	C	7	21	28	0	1	29	0	0
9	21561709	.	A	T	13	17	30	0	5	35	0	0
9	21563194	.	T	C	4	5	9	0	0	9	0	0
9	21711965	.	G	A	0	1	1	0	2	3	0	0
9	21722951	.	T	C	12	14	26	0	0	26	0	0
9	21723202	.	C	A	12	4	16	0	0	16	0	0
9	21724003	.	G	A	1	12	13	0	12	25	0	0
9	21802933	.	A	T	1	2	3	0	0	3	0	0
9	21802978	.	T	C	3	5	8	0	1	9	0	0
9	21802981	.	C	T	4	5	9	0	0	9	0	0
9	21803062	.	A	T	3	4	7	0	0	7	0	0
9	21804695	.	A	T	1	0	1	0	0	1	0	0
9	21805160	.	T	C	3	3	6	0	0	6	0	0
9	21810866	.	C	T	2	2	4	0	1	5	0	0
9	21810899	.	G	A	3	3	6	0	0	6	0	0
9	21811211	.	C	G	2	2	4	0	0	4	0	0
9	21811829	.	T	C	4	6	10	0	0	10	0	0
9	21811872	.	T	G	0	2	2	0	0	2	0	0
9	21812480	.	C	T	5	8	13	0	0	13	0	0
9	21816596	.	A	G	5	3	8	0	0	8	0	0
9	21821061	.	T	C	7	7	14	0	0	14	0	0
9	21821362	.	A	G	12	1	13	0	19	32	0	0
9	21821437	.	C	T	12	14	26	0	0	26	0	0
9	21824069	.	C	G	11	0	11	0	6	17	0	0
9	21824124	.	G	A	0	7	7	0	13	20	0	0
9	21824510	.	T	C	7	20	27	0	0	28	1	0
9	21824564	.	A	C	9	7	16	0	0	16	0	0
9	21824788	.	G	A	9	3	12	0	1	13	0	0
9	21824847	.	T	C	13	20	33	0	1	34	0	0
9	21825345	.	C	T	4	2	6	0	1	7	0	0
9	21825632	.	G	A	7	12	19	0	1	20	0	0
9	21825819	.	C	A	17	15	32	0	1	33	0	0
9	21825844	.	A	G	11	7	18	0	1	19	0	0
9	21826817	.	C	T	6	10	16	0	1	17	0	0
9	21826893	.	G	A	3	5	8	0	1	9	0	0
9	21829505	.	C	T	4	10	14	0	1	15	0	0
9	21831293	.	T	A	1	2	3	0	0	3	0	0
9	21834021	.	T	C	1	3	4	0	0	4	0	0
9	21843991	.	C	T	21	14	35	0	0	35	0	0
9	21844190	.	C	A	8	13	21	0	0	21	0	0
9	21844438	.	T	A	11	8	19	0	3	22	0	0
9	21844702	.	A	G	10	8	18	0	1	19	0	0
9	21844944	.	T	C	11	11	22	0	1	23	0	0
9	21845142	.	G	A	3	14	17	0	0	17	0	0
9	21845208	.	G	A	8	13	21	0	1	22	0	0
9	21845365	.	G	C	5	8	13	0	0	13	0	0
9	21845366	.	G	A	5	8	13	0	0	13	0	0
9	21893856	.	A	G	8	7	15	0	0	15	0	0
9	21893862	.	G	A	9	8	17	0	0	17	0	0
9	21894057	.	T	G	5	6	11	0	3	14	0	0
9	21899687	.	T	C	14	6	20	0	0	20	0	0
9	21899795	.	T	C	11	1	12	0	9	21	0	0
9	21899973	.	G	A	6	1	7	0	0	7	0	0
9	21900123	.	C	A	3	5	8	0	0	8	0	0
9	21900141	.	T	C	1	0	1	0	1	2	0	0
9	21904770	.	C	T	5	5	10	0	2	12	0	0
9	21904973	.	G	A	6	1	7	0	1	8	0	0
9	21906892	.	T	C	1	4	5	0	0	5	0	0
9	21908363	.	A	T	0	1	1	0	0	1	0	0
9	21914170	.	A	G	1	2	3	0	0	3	0	0
9	21914184	.	C	G	0	2	2	0	3	5	0	0
9	21919360	.	G	T	6	7	13	0	0	13	0	0
9	21919908	.	G	T	3	1	4	0	0	4	0	0
9	21927241	.	T	C	2	0	2	0	6	8	0	0
9	21927288	.	C	T	3	6	9	0	0	9	0	0
9	21927420	.	A	T	4	3	7	0	1	8	0	0
9	21930120	.	G	T	7	5	12	0	0	12	0	0
9	21971511	.	G	T	6	5	11	0	0	11	0	0
9	21974246	.	T	C	0	1	1	0	0	1	0	0
9	21974252	.	A	C	1	3	4	0	0	4	0	0
9	21976540	.	T	C	9	4	13	0	2	15	0	0
9	22483715	.	G	C	2	4	6	0	0	6	0	0
9	22483724	.	G	A	0	4	4	0	3	7	0	0
9	22483856	.	G	A	0	3	3	0	3	6	0	0
9	22483862	.	C	T	3	3	6	0	0	6	0	0
9	22489047	.	A	G	1	0	1	0	0	1	0	0
9	22613315	.	C	T	1	0	1	0	0	1	0	0
9	22613357	.	A	G	1	1	2	0	1	3	0	0
9	22613379	.	C	T	2	1	3	0	0	3	0	0
9	22634324	.	T	C	1	2	3	0	0	3	0	0
9	22636747	.	C	T	17	20	37	0	1	38	0	0
9	22636988	.	C	T	24	16	40	0	1	41	0	0
9	22637031	.	C	G	23	20	43	0	2	45	0	0
9	22637082	.	A	T	13	28	41	0	4	45	0	0
9	22638738	.	C	G	19	18	37	0	2	39	0	0
9	22647331	.	T	C	18	22	40	0	0	40	0	0
9	22647373	.	A	G	20	0	20	0	26	46	0	0
9	22647391	.	C	T	16	22	38	0	0	38	0	0
9	22647607	.	A	T	20	23	43	0	1	44	0	0
9	22647754	.	A	T	7	18	25	0	0	25	0	0
9	22647755	.	A	T	8	18	26	0	1	27	0	0
9	22648004	.	A	G	9	1	10	0	18	28	0	0
9	22648010	.	G	A	0	18	18	0	9	27	0	0
9	22648051	.	T	C	10	24	34	0	1	35	0	0
9	22648355	.	A	T	16	33	49	0	0	49	0	0
9	22648747	.	T	G	20	24	44	0	2	46	0	0
9	22707438	.	A	C	6	3	9	0	1	10	0	0
9	22707477	.	C	T	3	1	4	0	0	4	0	0
9	22707493	.	C	A	0	1	1	0	0	1	0	0
9	22747419	.	A	G	5	0	5	0	8	13	0	0
9	22747557	.	A	G	5	7	12	0	2	14	0	0
9	22747644	.	G	A	0	8	8	0	7	15	0	0
9	22747865	.	A	C	3	4	7	0	2	9	0	0
9	22781047	.	T	G	1	2	3	0	1	4	0	0
9	22781062	.	C	A	1	2	3	0	1	4	0	0
9	22788756	.	C	T	1	1	2	0	0	2	0	0
9	22796244	.	C	A	1	3	4	0	0	4	0	0
9	22796255	.	C	A	1	3	4	0	0	4	0	0
9	22797816	.	C	A	3	9	12	0	0	13	1	0
9	22797962	.	A	C	7	5	12	0	0	12	0	0
9	22798087	.	C	T	5	3	8	0	0	8	0	0
9	22798715	.	A	G	5	5	10	0	1	11	0	0
9	22798736	.	G	T	2	5	7	0	2	9	0	0
9	22798765	.	A	G	3	4	7	0	0	7	0	0
9	22798789	.	C	T	4	4	8	0	0	8	0	0
9	22799115	.	T	A	5	5	10	0	0	10	0	0
9	22799157	.	G	A	2	7	9	0	0	9	0	0
9	22799255	.	T	C	6	2	8	0	0	8	0	0
9	22799456	.	G	C	0	4	4	0	4	8	0	0
9	22799508	.	T	C	9	7	16	0	0	16	0	0
9	22799810	.	A	G	11	3	14	0	0	14	0	0
9	22799883	.	C	T	4	8	12	0	2	14	0	0
9	22801205	.	C	T	2	3	5	0	0	5	0	0
9	22801527	.	C	T	4	8	12	0	0	12	0	0
9	22801746	.	A	G	7	6	13	0	0	13	0	0
9	22801785	.	A	G	3	0	3	0	7	10	0	0
9	22801929	.	A	G	3	3	6	0	1	7	0	0
9	22802045	.	A	G	8	0	8	0	3	11	0	0
9	22902938	.	A	T	2	9	11	0	0	11	0	0
9	22902997	.	G	A	6	7	13	0	1	14	0	0
9	22903012	.	T	G	5	9	14	0	0	14	0	0
9	22903166	.	C	T	0	16	16	0	14	30	0	0
9	22903270	.	A	T	13	10	23	0	0	23	0	0
9	22906425	.	C	T	4	2	6	0	0	6	0	0
9	22932366	.	T	G	5	2	7	0	0	7	0	0
9	22937852	.	G	A	2	2	4	0	0	4	0	0
9	22938565	.	A	C	3	1	4	0	0	4	0	0
9	22938719	.	A	T	8	9	17	0	0	17	0	0
9	22938828	.	T	G	4	3	7	0	0	7	0	0
9	22938932	.	T	G	7	0	7	0	9	16	0	0
9	22938967	.	T	G	9	7	16	0	2	18	0	0
9	22939068	.	A	G	5	13	18	0	1	19	0	0
9	22939201	.	C	G	2	9	11	0	0	11	0	0
9	22941166	.	C	A	7	7	14	0	0	14	0	0
9	22941285	.	G	T	6	5	11	0	0	11	0	0
9	22946494	.	G	A	8	3	11	0	0	11	0	0
9	22949353	.	C	T	5	9	14	0	2	16	0	0
9	22953228	.	G	A	1	1	2	0	0	2	0	0
9	23006862	.	T	C	0	2	2	0	0	2	0	0
9	23009721	.	C	G	2	3	5	0	0	5	0	0
9	23009730	.	T	C	2	4	6	0	0	6	0	0
9	23009923	.	G	A	4	4	8	0	0	8	0	0
9	23016422	.	T	C	5	6	11	0	0	11	0	0
9	23018709	.	C	A	7	4	11	0	0	11	0	0
9	23022763	.	A	T	5	6	11	0	0	11	0	0
9	23023047	.	A	T	6	9	15	0	0	15	0	0
9	23023064	.	C	T	6	11	17	0	1	18	0	0
9	23023103	.	G	C	8	8	16	0	8	24	0	0
9	23023254	.	G	A	0	7	7	0	4	11	0	0
9	23026412	.	A	T	10	4	14	0	0	14	0	0
9	23033771	.	T	C	8	0	8	0	6	14	0	0
9	23049577	.	A	G	0	0	0	0	1	1	0	0
9	23051913	.	G	T	0	0	0	0	1	1	0	0
9	23055635	.	C	T	4	13	17	0	1	18	0	0
9	23055644	.	A	G	8	16	24	0	0	24	0	0
9	23055674	.	G	C	11	16	27	0	0	27	0	0
9	23055986	.	A	C	4	5	9	0	0	9	0	0
9	23056098	.	A	T	2	5	7	0	0	7	0	0
9	23056104	.	G	C	2	5	7	0	0	7	0	0
9	23056148	.	A	T	4	2	6	0	0	6	0	0
9	23071272	.	A	G	1	2	3	0	0	3	0	0
9	23118208	.	C	T	0	1	1	0	0	1	0	0
9	23185674	.	A	G	18	13	31	0	1	32	0	0
9	23185786	.	A	C	14	5	19	0	0	19	0	0
9	23185801	.	T	A	7	2	9	0	1	10	0	0
9	23186163	.	A	C	11	15	26	0	1	27	0	0
9	23187985	.	T	C	1	0	1	0	0	1	0	0
9	23188003	.	C	T	1	3	4	0	0	4	0	0
9	23194587	.	G	A	10	4	14	0	2	16	0	0
9	23194608	.	A	T	15	7	22	0	2	24	0	0
9	23198166	.	C	T	3	2	5	0	0	5	0	0
9	23202123	.	C	T	1	0	1	0	0	1	0	0
9	23202743	.	G	A	3	1	4	0	0	4	0	0
9	23216991	.	G	T	6	4	10	0	0	10	0	0
9	23216995	.	A	T	5	4	9	0	1	10	0	0
9	23217093	.	C	T	7	5	12	0	0	12	0	0
9	23234567	.	T	C	8	0	8	0	11	19	0	0
9	23236339	.	T	C	9	15	24	0	1	25	0	0
9	23236465	.	G	C	10	12	22	0	1	23	0	0
9	23236515	.	G	A	13	17	30	0	1	31	0	0
9	23236531	.	C	T	1	17	18	0	11	29	0	0
9	23357063	.	T	A	2	4	6	0	0	6	0	0
9	23357134	.	A	G	4	2	6	0	0	6	0	0
9	23357142	.	G	C	3	0	3	0	4	7	0	0
9	23357194	.	C	T	3	7	10	0	2	12	0	0
9	23357200	.	T	C	4	7	11	0	0	11	0	0
9	23357234	.	C	G	6	5	11	0	2	13	0	0
9	23357317	.	T	C	7	0	7	0	3	10	0	0
9	23357528	.	C	T	10	8	18	0	1	19	0	0
9	23372041	.	C	T	1	1	2	0	0	2	0	0
9	23569002	.	C	G	0	1	1	0	0	1	0	0
9	23589297	.	A	T	1	1	2	0	0	2	0	0
9	23597979	.	A	C	0	2	2	0	0	2	0	0
9	23607087	.	G	A	0	2	2	0	2	4	0	0
9	23740555	.	G	C	3	2	5	0	1	6	0	0
9	23740676	.	A	G	10	8	18	0	2	20	0	0
9	23745176	.	C	T	0	2	2	0	4	6	0	0
9	23745201	.	T	A	4	1	5	0	0	5	0	0
9	23745471	.	C	A	13	9	22	0	0	22	0	0
9	23745504	.	A	G	9	13	22	0	1	23	0	0
9	23745531	.	C	T	8	14	22	0	0	22	0	0
9	23745558	.	T	C	5	0	5	0	4	9	0	0
9	23745570	.	G	A	2	3	5	0	0	5	0	0
9	23746628	.	A	G	14	14	28	0	1	29	0	0
9	23746676	.	G	A	10	12	22	0	1	23	0	0
9	23747111	.	T	C	3	1	4	0	0	4	0	0
9	23747118	.	G	A	3	1	4	0	0	4	0	0
9	23747226	.	A	C	6	9	15	0	1	16	0	0
9	23748417	.	C	G	6	5	11	0	2	13	0	0
9	23748421	.	A	G	6	8	14	0	1	15	0	0
9	23748993	.	G	C	2	1	3	0	0	3	0	0
9	23750634	.	T	C	4	9	13	0	0	13	0	0
9	23750643	.	C	T	4	7	11	0	0	11	0	0
9	23754905	.	T	C	4	8	12	0	0	12	0	0
9	23754989	.	C	A	4	5	9	0	1	10	0	0
9	23755024	.	A	T	1	5	6	0	0	6	0	0
9	23755083	.	C	G	3	7	10	0	0	10	0	0
9	23755750	.	G	C	0	3	3	0	5	8	0	0
9	23755774	.	G	A	5	5	10	0	0	10	0	0
9	23755883	.	C	T	1	4	5	0	0	5	0	0
9	23755897	.	G	C	1	4	5	0	0	5	0	0
9	23756108	.	G	C	4	5	9	0	0	9	0	0
9	23756268	.	G	A	8	7	15	0	0	15	0	0
9	23756298	.	A	G	5	0	5	0	4	9	0	0
9	23756332	.	T	A	3	3	6	0	0	6	0	0
9	23756377	.	G	A	5	2	7	0	0	7	0	0
9	23756482	.	A	G	5	5	10	0	0	10	0	0
9	23756498	.	T	C	6	6	12	0	0	12	0	0
9	23756519	.	C	T	4	6	10	0	0	10	0	0
9	23756552	.	C	T	7	5	12	0	0	12	0	0
9	23756584	.	T	C	7	3	10	0	0	10	0	0
9	23756636	.	T	A	3	3	6	0	0	6	0	0
9	23756640	.	C	G	3	3	6	0	0	6	0	0
9	23757076	.	G	A	4	2	6	0	0	6	0	0
9	23757103	.	G	T	3	3	6	0	0	6	0	0
9	23757145	.	C	T	3	2	5	0	0	5	0	0
9	23757157	.	G	A	3	2	5	0	0	5	0	0
9	23808573	.	T	C	1	3	4	0	0	4	0	0
9	23810426	.	A	G	2	5	7	0	1	8	0	0
9	23814104	.	G	C	15	11	26	0	0	26	0	0
9	23823895	.	A	G	15	21	36	0	0	36	0	0
9	23824141	.	T	G	0	2	2	0	1	3	0	0
9	23824150	.	C	A	0	2	2	0	1	3	0	0
9	23826525	.	A	G	2	2	4	0	0	4	0	0
9	23826534	.	G	A	3	3	6	0	0	6	0	0
9	23832650	.	C	A	2	4	6	0	1	7	0	0
9	23832689	.	C	T	3	4	7	0	0	7	0	0
9	23836415	.	T	C	0	3	3	0	0	3	0	0
9	23838898	.	C	T	2	2	4	0	0	4	0	0
9	23840554	.	G	A	2	4	6	0	0	6	0	0
9	23840775	.	G	C	6	10	16	0	1	17	0	0
9	23840824	.	C	T	2	10	12	0	1	13	0	0
9	23841000	.	A	G	0	0	0	0	2	2	0	0
9	23841037	.	T	G	1	3	4	0	0	4	0	0
9	23841088	.	G	A	1	6	7	0	0	7	0	0
9	23841139	.	T	C	3	6	9	0	0	9	0	0
9	23841239	.	T	A	2	5	7	0	1	8	0	0
9	23841240	.	G	C	3	5	8	0	0	8	0	0
9	23846251	.	C	T	1	2	3	0	1	4	0	0
9	23846257	.	G	A	2	2	4	0	0	4	0	0
9	23862447	.	T	G	3	3	6	0	1	7	0	0
9	23862467	.	A	T	3	4	7	0	0	7	0	0
9	23905834	.	A	C	4	2	6	0	0	6	0	0
9	23905848	.	G	T	5	4	9	0	0	9	0	0
9	23906101	.	C	T	4	4	8	0	0	8	0	0
9	24026116	.	C	A	5	2	7	0	0	7	0	0
9	24026205	.	C	A	6	3	9	0	0	9	0	0
9	24026332	.	G	T	0	5	5	0	2	7	0	0
9	24026397	.	G	A	6	4	10	0	0	10	0	0
9	24026400	.	G	A	6	4	10	0	0	10	0	0
9	24044847	.	T	C	2	2	4	0	0	4	0	0
9	24044990	.	G	T	1	2	3	0	0	3	0	0
9	24107215	.	G	A	2	2	4	0	0	4	0	0
9	24107251	.	C	A	0	1	1	0	0	1	0	0
9	24114126	.	C	T	3	1	4	0	0	4	0	0
9	24114655	.	G	C	0	5	5	0	2	7	0	0
9	24114826	.	C	T	6	4	10	0	0	10	0	0
9	24114994	.	G	A	3	5	8	0	1	9	0	0
9	24115004	.	C	T	3	7	10	0	1	11	0	0
9	24116814	.	G	A	3	5	8	0	2	10	0	0
9	24116915	.	C	A	8	3	11	0	0	11	0	0
9	24117048	.	C	A	0	3	3	0	5	8	0	0
9	24122676	.	C	T	1	2	3	0	0	3	0	0
9	24122715	.	G	T	0	5	5	0	4	9	0	0
9	24123504	.	T	C	3	4	7	0	0	7	0	0
9	24140229	.	C	A	3	3	6	0	0	6	0	0
9	24145547	.	T	C	0	2	2	0	0	2	0	0
9	24159317	.	T	G	0	2	2	0	1	3	0	0
9	24159634	.	G	A	0	2	2	0	6	8	0	0
9	24159805	.	C	A	4	2	6	0	0	6	0	0
9	24166575	.	T	C	1	2	3	0	0	3	0	0
9	24166825	.	T	C	3	4	7	0	0	7	0	0
9	24166846	.	C	T	2	5	7	0	1	8	0	0
9	24166867	.	A	G	3	6	9	0	0	9	0	0
9	24167180	.	A	G	5	0	5	0	5	10	0	0
9	24178660	.	G	A	3	1	4	0	0	4	0	0
9	24183438	.	T	C	3	4	7	0	0	7	0	0
9	24183603	.	C	T	0	2	2	0	0	2	0	0
9	24186269	.	G	A	2	3	5	0	1	6	0	0
9	24187510	.	C	A	6	4	10	0	2	13	1	0
9	24187675	.	T	G	4	9	13	0	1	14	0	0
9	24187805	.	C	G	5	7	12	0	0	12	0	0
9	24187967	.	A	G	16	0	16	0	11	27	0	0
9	24188100	.	A	T	4	5	9	0	0	9	0	0
9	24188110	.	A	T	4	3	7	0	1	8	0	0
9	24188729	.	C	G	4	6	10	0	0	10	0	0
9	24188969	.	T	G	13	9	22	0	0	22	0	0
9	24189179	.	T	G	3	6	9	0	1	10	0	0
9	24189198	.	A	G	6	5	11	0	0	11	0	0
9	24189283	.	G	A	8	11	19	0	1	20	0	0
9	24189407	.	A	G	16	15	31	0	1	32	0	0
9	24189757	.	C	A	19	7	26	0	0	26	0	0
9	24189825	.	T	A	11	13	24	0	0	24	0	0
9	24189946	.	C	T	7	9	16	2	0	18	0	0
9	24189977	.	A	G	3	4	7	2	2	11	0	0
9	24190010	.	G	A	3	4	7	0	1	8	0	0
9	24190020	.	G	A	3	7	10	0	0	10	0	0
9	24190048	.	T	C	7	9	16	0	1	17	0	0
9	24190139	.	A	G	12	7	19	0	2	21	0	0
9	24190144	.	A	G	14	5	19	0	2	21	0	0
9	24190295	.	T	C	12	8	20	0	3	23	0	0
9	24190302	.	A	G	16	6	22	0	1	23	0	0
9	24190419	.	G	A	13	9	22	0	0	22	0	0
9	24190466	.	G	T	12	12	24	0	1	25	0	0
9	24190489	.	C	G	11	11	22	0	1	23	0	0
9	24190547	.	C	A	13	6	19	0	1	20	0	0
9	24190630	.	G	C	16	3	19	0	0	19	0	0
9	24190642	.	T	A	19	5	24	0	0	24	0	0
9	24190748	.	G	T	13	9	22	0	0	22	0	0
9	24190767	.	A	G	20	1	21	0	6	27	0	0
9	24190792	.	A	G	17	8	25	0	0	25	0	0
9	24191053	.	T	A	18	14	32	0	0	32	0	0
9	24191462	.	G	A	15	11	26	0	0	26	0	0
9	24192746	.	C	G	1	2	3	0	0	3	0	0
9	24198574	.	G	T	1	1	2	0	0	2	0	0
9	24200608	.	C	T	5	4	9	0	0	9	0	0
9	24204218	.	C	T	1	4	5	0	0	5	0	0
9	24204231	.	A	T	3	4	7	0	1	8	0	0
9	24204456	.	T	C	4	2	6	0	0	6	0	0
9	24204554	.	A	T	3	6	9	0	0	9	0	0
9	24204661	.	T	A	4	6	10	0	0	10	0	0
9	24204723	.	T	A	5	5	10	0	0	10	0	0
9	24204749	.	T	A	5	6	11	0	1	12	0	0
9	24204762	.	A	G	4	7	11	0	0	11	0	0
9	24204806	.	T	C	2	0	2	0	9	11	0	0
9	24204905	.	T	A	7	7	14	0	0	14	0	0
9	24204913	.	G	C	5	9	14	0	2	16	0	0
9	24204947	.	A	C	6	5	11	0	0	11	0	0
9	24205136	.	G	A	5	13	18	0	0	18	0	0
9	24205242	.	C	G	7	6	13	0	0	13	0	0
9	24205260	.	C	T	6	4	10	0	0	10	0	0
9	24205292	.	C	T	4	5	9	0	0	9	0	0
9	24205318	.	A	G	4	5	9	0	0	9	0	0
9	24205391	.	T	C	3	4	7	0	0	7	0	0
9	24205484	.	A	G	5	6	11	0	0	11	0	0
9	24205596	.	C	T	7	6	13	0	0	13	0	0
9	24205681	.	G	T	5	9	14	0	2	16	0	0
9	24205818	.	G	T	8	5	13	0	2	15	0	0
9	24205916	.	G	A	11	5	16	0	2	18	0	0
9	24208774	.	T	C	2	3	5	0	0	5	0	0
9	24208779	.	T	A	3	3	6	0	0	6	0	0
9	24209052	.	G	A	2	4	6	0	0	6	0	0
9	24210083	.	A	G	2	0	2	0	1	3	0	0
9	24210449	.	C	T	0	2	2	0	0	2	0	0
9	24210485	.	C	T	1	4	5	0	0	5	0	0
9	24211081	.	T	C	2	1	3	0	0	3	0	0
9	24212230	.	T	G	2	1	3	0	3	6	0	0
9	24212277	.	C	T	4	8	12	0	0	12	0	0
9	24212299	.	G	A	5	8	13	0	0	13	0	0
9	24212552	.	G	A	0	5	5	0	4	9	0	0
9	24212585	.	A	C	1	1	2	0	0	2	0	0
9	24212629	.	T	A	2	2	4	0	0	4	0	0
9	24212654	.	T	A	2	3	5	0	1	6	0	0
9	24212748	.	T	C	2	2	4	0	1	5	0	0
9	24214792	.	C	T	7	6	13	0	1	14	0	0
9	24216417	.	C	T	0	2	2	0	0	2	0	0
9	24217459	.	G	A	9	5	14	0	0	14	0	0
9	24217801	.	T	A	4	4	8	0	0	8	0	0
9	24217829	.	T	G	3	4	7	0	0	7	0	0
9	24217894	.	T	A	2	3	5	0	0	5	0	0
9	24217910	.	T	C	2	2	4	0	0	4	0	0
9	24223499	.	G	A	0	9	9	0	0	9	0	0
9	24224015	.	T	C	2	0	2	0	3	5	0	0
9	24249396	.	T	G	19	20	39	0	3	42	0	0
9	24249414	.	T	C	14	1	15	0	24	39	0	0
9	24252457	.	C	T	0	17	17	0	21	38	0	0
9	24252490	.	T	C	14	0	14	0	21	35	0	0
9	24255690	.	G	T	1	0	1	0	0	1	0	0
9	24366142	.	G	A	12	19	31	0	0	31	0	0
9	24412781	.	A	G	23	5	28	0	0	28	0	0
9	24412790	.	A	G	18	6	24	0	1	25	0	0
9	24944476	.	C	T	3	2	5	0	0	5	0	0
9	24949068	.	C	T	2	2	4	0	1	5	0	0
9	24949110	.	T	A	1	2	3	0	0	3	0	0
9	25132315	.	C	A	1	1	2	0	1	3	0	0
9	25132516	.	C	T	6	5	11	0	1	12	0	0
9	25139179	.	A	C	2	0	2	0	0	2	0	0
9	25148540	.	C	A	1	1	2	0	0	2	0	0
9	25154390	.	T	G	3	2	5	0	0	5	0	0
9	25154910	.	T	A	1	1	2	0	0	2	0	0
9	25167271	.	C	T	4	2	6	0	0	6	0	0
9	25168569	.	A	C	6	4	10	0	0	10	0	0
9	25169295	.	T	A	2	7	9	0	0	9	0	0
9	25169380	.	A	G	9	5	14	0	0	14	0	0
9	25169399	.	T	A	7	5	12	0	0	12	0	0
9	25169444	.	T	G	10	4	14	0	1	15	0	0
9	25169609	.	T	C	7	3	10	0	1	11	0	0
9	25177600	.	A	G	2	4	6	0	2	8	0	0
9	25177642	.	A	G	4	1	5	0	0	5	0	0
9	25180196	.	G	A	2	2	4	0	0	4	0	0
9	25181203	.	C	T	2	5	7	0	0	7	0	0
9	25181215	.	C	T	2	5	7	0	0	7	0	0
9	25181285	.	A	T	1	2	3	0	0	3	0	0
9	25181286	.	A	T	1	2	3	0	0	3	0	0
9	25198560	.	T	C	2	4	6	0	0	6	0	0
9	25198606	.	T	G	1	2	3	0	0	3	0	0
9	25320799	.	C	T	7	5	12	0	0	12	0	0
9	25320812	.	C	T	5	5	10	0	0	10	0	0
9	25320862	.	G	A	2	4	6	0	0	6	0	0
9	25320914	.	T	A	2	7	9	0	0	9	0	0
9	25320980	.	A	T	2	6	8	0	0	8	0	0
9	25321538	.	G	A	11	14	25	0	0	25	0	0
9	25326386	.	G	A	1	2	3	0	0	3	0	0
9	25331051	.	C	T	0	1	1	0	0	1	0	0
9	25331065	.	T	C	0	1	1	0	0	1	0	0
9	25337403	.	C	T	0	1	1	0	0	1	0	0
9	25337468	.	C	T	0	2	2	0	1	3	0	0
9	25337529	.	G	A	2	3	5	0	0	5	0	0
9	25345948	.	A	G	2	2	4	0	0	4	0	0
9	25353387	.	C	T	0	4	4	0	6	10	0	0
9	25356838	.	A	G	6	4	10	0	0	10	0	0
9	25381021	.	A	G	16	22	38	0	1	39	0	0
9	25381150	.	A	G	12	14	26	0	4	30	0	0
9	25382028	.	T	C	6	1	7	0	9	16	0	0
9	25382097	.	T	C	4	6	10	0	1	11	0	0
9	25382322	.	C	G	10	11	21	0	2	23	0	0
9	25382478	.	C	A	11	4	15	0	2	17	0	0
9	25383046	.	C	A	13	7	20	0	2	22	0	0
9	25383124	.	T	C	10	0	10	0	13	23	0	0
9	25383421	.	G	A	13	9	22	0	0	22	0	0
9	25383780	.	A	C	16	7	23	0	0	23	0	0
9	25384091	.	G	A	11	11	22	0	1	23	0	0
9	25388150	.	T	C	2	1	3	0	0	3	0	0
9	25389931	.	G	A	2	5	7	0	0	7	0	0
9	25392985	.	C	T	7	4	11	0	0	11	0	0
9	25393036	.	T	C	6	4	10	0	1	11	0	0
9	25419211	.	C	G	3	2	5	0	0	5	0	0
9	25443163	.	T	A	7	5	12	0	0	12	0	0
9	25443352	.	A	T	6	3	9	0	0	9	0	0
9	25443419	.	G	T	2	4	6	0	0	6	0	0
9	25443575	.	A	T	3	5	8	0	0	8	0	0
9	25443702	.	T	C	6	3	9	0	0	9	0	0
9	25443874	.	T	A	1	2	3	0	0	3	0	0
9	25443908	.	C	T	1	2	3	0	0	3	0	0
9	25444055	.	T	G	2	3	5	0	1	6	0	0
9	25837206	.	A	T	4	4	8	0	0	8	0	0
9	25837213	.	A	T	8	4	12	0	1	13	0	0
9	26111795	.	T	C	3	1	4	0	0	4	0	0
9	27691970	.	A	G	2	2	4	0	0	4	0	0
9	27692005	.	C	A	2	2	4	0	1	5	0	0
9	27692017	.	T	C	2	4	6	0	0	6	0	0
9	27692075	.	G	T	6	2	8	0	0	8	0	0
9	27692325	.	A	G	9	8	17	0	2	19	0	0
9	27692329	.	G	T	9	12	21	0	0	21	0	0
9	27692389	.	A	G	9	9	18	0	0	18	0	0
9	27692402	.	G	T	8	5	13	0	0	13	0	0
9	27692471	.	C	T	0	5	5	0	5	10	0	0
9	27692699	.	C	G	0	8	8	0	7	15	0	0
9	27694630	.	T	C	2	8	10	0	0	10	0	0
9	27716762	.	A	G	3	7	10	0	0	10	0	0
9	27716974	.	A	G	2	3	5	0	0	5	0	0
9	27720032	.	G	A	0	1	1	0	0	1	0	0
9	27741271	.	G	T	1	2	3	0	0	3	0	0
9	27757831	.	C	T	9	10	19	0	1	20	0	0
9	27757893	.	A	G	5	0	5	0	11	16	0	0
9	27860507	.	G	C	2	2	4	0	1	5	0	0
9	27860734	.	C	T	0	8	8	0	7	15	0	0
9	27861186	.	G	T	5	3	8	0	0	8	0	0
9	27861293	.	C	G	1	8	9	0	10	19	0	0
9	27863828	.	G	T	4	6	10	0	0	10	0	0
9	27886614	.	T	C	1	1	2	0	0	2	0	0
9	27894444	.	G	T	1	1	2	0	0	2	0	0
9	27894656	.	T	C	5	2	7	0	1	8	0	0
9	27897012	.	T	C	0	1	1	0	0	1	0	0
9	27909933	.	C	T	5	9	14	0	0	14	0	0
9	27920595	.	T	A	4	6	10	0	0	10	0	0
9	27920649	.	G	A	4	8	12	0	0	12	0	0
9	27954620	.	G	A	1	0	1	0	0	1	0	0
9	28115886	.	A	G	1	1	2	0	4	6	0	0
9	28115901	.	A	G	1	5	6	0	3	9	0	0
9	28116064	.	T	C	5	6	11	0	1	12	0	0
9	28124661	.	G	A	1	6	7	0	0	7	0	0
9	28124775	.	A	G	2	0	2	0	1	3	0	0
9	28127471	.	A	G	15	8	23	0	1	24	0	0
9	28127513	.	A	C	13	7	20	0	0	20	0	0
9	28127532	.	A	C	13	4	17	0	0	17	0	0
9	28127573	.	A	G	9	9	18	0	1	19	0	0
9	28127706	.	C	G	16	8	24	0	1	25	0	0
9	28151141	.	C	T	3	2	5	0	0	5	0	0
9	28160821	.	C	T	6	2	8	0	0	8	0	0
9	28195905	.	T	A	0	2	2	0	0	2	0	0
9	28195920	.	G	A	0	2	2	0	0	2	0	0
9	28204412	.	C	T	1	2	3	0	0	3	0	0
9	28204787	.	C	T	1	3	4	0	0	4	0	0
9	28205071	.	C	T	0	2	2	0	0	2	0	0
9	28205072	.	G	A	0	2	2	0	0	2	0	0
9	28206947	.	A	T	5	4	9	0	0	9	0	0
9	28207339	.	T	A	4	6	10	0	2	12	0	0
9	28207392	.	T	A	6	4	10	0	0	10	0	0
9	28207647	.	C	T	3	5	8	0	0	8	0	0
9	28238302	.	C	T	1	4	5	0	0	5	0	0
9	28238305	.	C	T	0	5	5	0	1	6	0	0
9	28245874	.	G	A	4	5	9	0	2	11	0	0
9	28254633	.	C	T	6	9	15	0	1	16	0	0
9	28254783	.	C	T	0	9	9	0	10	19	0	0
9	28254810	.	G	A	7	10	17	0	0	17	0	0
9	28263971	.	C	T	12	8	20	0	1	21	0	0
9	28264469	.	T	C	7	0	7	0	10	17	0	0
9	28267158	.	G	A	7	10	17	0	3	20	0	0
9	28268543	.	G	A	3	2	5	0	0	5	0	0
9	28270529	.	A	C	4	1	5	0	3	8	0	0
9	28271181	.	T	C	0	1	1	0	0	1	0	0
9	28341330	.	C	A	0	5	5	0	5	11	1	0
9	28341382	.	G	A	6	6	12	0	0	12	0	0
9	28341591	.	C	A	5	17	22	0	1	23	0	0
9	28341593	.	T	A	3	20	23	0	0	23	0	0
9	28341849	.	T	G	4	1	5	0	11	16	0	0
9	28342963	.	G	A	8	8	16	0	0	16	0	0
9	28343054	.	G	A	10	13	23	0	0	23	0	0
9	28343100	.	A	G	11	11	22	0	0	22	0	0
9	28343121	.	T	G	11	10	21	0	0	21	0	0
9	28343549	.	C	T	8	6	14	0	0	14	0	0
9	28343590	.	G	A	4	6	10	0	1	11	0	0
9	28343629	.	C	T	4	2	6	0	1	7	0	0
9	28344026	.	T	C	5	4	9	0	0	9	0	0
9	28344126	.	A	C	10	8	18	0	0	18	0	0
9	28344320	.	T	G	5	7	12	0	0	12	0	0
9	28345531	.	T	C	3	4	7	0	2	9	0	0
9	28363208	.	G	A	5	11	16	0	0	16	0	0
9	28398942	.	G	C	4	3	7	0	0	7	0	0
9	28688667	.	T	G	5	0	5	0	5	10	0	0
9	28688956	.	C	G	8	0	8	0	6	14	0	0
9	28688965	.	A	G	6	6	12	0	1	13	0	0
9	28689032	.	G	A	9	7	16	0	1	17	0	0
9	28689033	.	C	A	8	7	15	0	2	17	0	0
9	28691645	.	T	C	3	0	3	0	0	3	0	0
9	28696610	.	A	C	6	7	13	0	0	13	0	0
9	28696643	.	A	G	1	4	5	0	0	5	0	0
9	28818327	.	A	G	5	5	10	0	0	10	0	0
9	28818498	.	A	T	7	5	12	0	1	13	0	0
9	28839811	.	T	C	0	2	2	0	0	2	0	0
9	28839859	.	G	A	6	10	16	0	1	17	0	0
9	28839879	.	T	A	8	11	19	0	0	19	0	0
9	28867390	.	T	C	3	0	3	0	14	17	0	0
9	28867421	.	A	C	4	13	17	0	0	17	0	0
9	28867426	.	A	C	4	9	13	0	1	14	0	0
9	28867459	.	C	T	2	4	6	0	0	6	0	0
9	28867555	.	G	A	3	7	10	0	0	10	0	0
9	28871367	.	A	T	2	4	6	0	0	6	0	0
9	28872253	.	T	G	5	5	10	0	1	11	0	0
9	28872341	.	G	A	1	1	2	0	0	2	0	0
9	28875319	.	C	T	3	3	6	0	0	6	0	0
9	28879348	.	C	T	0	1	1	0	0	1	0	0
9	28940998	.	G	A	12	15	27	0	1	28	0	0
9	28941003	.	T	C	10	0	10	0	15	25	0	0
9	28941061	.	A	C	11	5	16	0	0	16	0	0
9	28941179	.	A	G	5	5	10	0	0	10	0	0
9	28941189	.	G	A	5	5	10	0	0	10	0	0
9	28941234	.	C	T	5	5	10	0	0	10	0	0
9	28941414	.	A	G	10	10	20	0	1	21	0	0
9	28941446	.	A	G	12	13	25	0	0	25	0	0
9	28941488	.	T	A	10	10	20	0	1	21	0	0
9	28941498	.	C	G	11	6	17	0	0	17	0	0
9	28941629	.	G	A	7	4	11	0	0	11	0	0
9	28941630	.	G	A	7	4	11	0	0	11	0	0
9	28941684	.	C	G	6	5	11	0	0	11	0	0
9	28941709	.	G	C	7	3	10	0	0	10	0	0
9	28941723	.	A	G	5	3	8	0	1	9	0	0
9	28941795	.	C	T	2	4	6	0	0	6	0	0
9	28941832	.	A	G	2	5	7	0	0	7	0	0
9	28941879	.	A	T	5	7	12	0	0	12	0	0
9	28941897	.	T	G	6	10	16	0	2	18	0	0
9	28942018	.	G	A	6	5	11	0	3	14	0	0
9	28942111	.	A	G	4	3	7	0	0	7	0	0
9	28942542	.	T	A	16	9	25	0	1	26	0	0
9	28942553	.	T	A	16	6	22	0	1	23	0	0
9	28946132	.	A	T	4	6	10	0	1	11	0	0
9	28952959	.	G	A	8	6	14	0	0	14	0	0
9	28955543	.	A	G	1	2	3	0	0	3	0	0
9	28964849	.	C	A	11	7	18	0	0	18	0	0
9	28967048	.	A	G	1	0	1	0	0	1	0	0
9	28972347	.	A	C	1	0	1	0	0	1	0	0
9	28989543	.	C	T	1	0	1	0	0	1	0	0
9	28989549	.	G	A	1	0	1	0	0	1	0	0
9	29029545	.	T	A	6	2	8	0	0	8	0	0
9	29029761	.	A	G	2	2	4	0	0	4	0	0
9	29035572	.	T	C	5	4	9	0	0	9	0	0
9	29035575	.	A	G	4	4	8	0	1	9	0	0
9	29036245	.	A	G	3	0	3	0	0	3	0	0
9	29040544	.	G	A	0	1	1	0	0	1	0	0
9	29049712	.	T	C	1	4	5	0	1	6	0	0
9	29122231	.	T	G	2	3	5	0	1	6	0	0
9	29122536	.	T	A	6	5	11	0	0	11	0	0
9	29122849	.	A	G	6	9	15	0	0	15	0	0
9	29225281	.	G	A	2	0	2	0	0	2	0	0
9	29230754	.	A	G	2	1	3	0	0	3	0	0
9	29339133	.	G	C	1	4	5	0	2	7	0	0
9	29339139	.	A	T	3	3	6	0	2	8	0	0
9	29443840	.	T	C	0	1	1	0	0	1	0	0
9	29448703	.	T	G	1	0	1	0	2	3	0	0
9	29448727	.	C	A	0	1	1	0	0	1	0	0
9	29455415	.	T	C	2	4	6	0	0	6	0	0
9	29458550	.	A	C	0	2	2	0	0	2	0	0
9	29458562	.	T	C	0	2	2	0	0	2	0	0
9	29465051	.	C	T	2	1	3	0	0	3	0	0
9	29470325	.	G	A	0	1	1	0	0	1	0	0
9	29470326	.	G	A	0	1	1	0	0	1	0	0
9	29473785	.	G	T	1	2	3	0	0	3	0	0
9	29473786	.	C	T	1	2	3	0	0	3	0	0
9	29473879	.	T	A	3	2	5	0	0	5	0	0
9	29477021	.	G	C	3	3	6	0	0	6	0	0
9	29481518	.	T	C	10	9	19	0	2	21	0	0
9	29481708	.	A	G	0	2	2	0	0	2	0	0
9	29481732	.	A	G	0	6	6	0	1	7	0	0
9	29481747	.	G	A	0	10	10	0	2	12	0	0
9	29481795	.	T	C	6	6	12	0	0	12	0	0
9	29482135	.	T	A	3	3	6	0	0	6	0	0
9	29484291	.	T	G	3	4	7	0	0	7	0	0
9	29497181	.	C	T	0	2	2	0	1	3	0	0
9	29520819	.	A	G	13	11	24	0	6	30	0	0
9	29523552	.	T	G	7	0	7	0	4	11	0	0
9	29602959	.	T	C	3	2	5	0	0	5	0	0
9	29607543	.	C	T	1	2	3	0	0	3	0	0
9	29615087	.	C	G	17	19	36	0	1	38	1	0
9	29615238	.	T	A	17	13	30	0	0	30	0	0
9	29615575	.	C	T	11	11	22	0	1	23	0	0
9	29647469	.	G	A	23	18	41	0	2	43	0	0
9	29647470	.	C	T	22	18	40	0	3	43	0	0
9	29649571	.	C	A	23	24	47	0	5	52	0	0
9	29654693	.	T	C	0	1	1	0	0	1	0	0
9	29731041	.	T	C	0	1	1	0	0	1	0	0
9	29992145	.	A	G	2	0	2	0	0	2	0	0
9	29992332	.	G	A	4	2	6	0	0	6	0	0
9	30022468	.	G	T	2	0	2	0	0	2	0	0
9	30028016	.	C	T	0	5	5	0	5	10	0	0
9	30028056	.	T	C	2	0	2	0	2	4	0	0
9	30108779	.	T	C	3	0	3	0	0	3	0	0
9	30110026	.	T	C	4	2	6	0	0	6	0	0
9	30110217	.	T	C	3	11	14	0	0	14	0	0
9	30112544	.	A	G	1	1	2	0	0	2	0	0
9	30114853	.	A	G	5	4	9	0	1	10	0	0
9	30121155	.	C	A	15	19	34	0	1	35	0	0
9	30121167	.	C	T	13	19	32	0	0	32	0	0
9	30126136	.	A	G	6	0	6	0	5	11	0	0
9	30128084	.	C	G	22	32	54	0	0	54	0	0
9	30128085	.	C	T	22	31	53	0	1	54	0	0
9	30218140	.	C	T	2	1	3	0	0	3	0	0
9	30218310	.	G	A	5	1	6	0	1	7	0	0
9	30218323	.	A	G	6	3	9	0	0	9	0	0
9	30220931	.	C	T	1	0	1	0	0	1	0	0
9	30220968	.	T	A	4	3	7	0	0	7	0	0
9	30220975	.	C	T	5	3	8	0	1	9	0	0
9	30226160	.	T	C	1	0	1	0	6	7	0	0
9	30226583	.	T	C	1	0	1	0	4	5	0	0
9	30231309	.	G	A	0	1	1	0	0	1	0	0
9	30231360	.	A	C	0	0	0	0	1	1	0	0
9	30231557	.	A	G	0	1	1	0	0	1	0	0
9	30233169	.	A	T	2	4	6	0	0	6	0	0
9	30233386	.	T	C	1	0	1	0	0	1	0	0
9	30236090	.	A	C	3	2	5	0	1	6	0	0
9	30236303	.	A	G	2	3	5	0	0	5	0	0
9	30245756	.	C	A	5	5	10	0	1	11	0	0
9	30246172	.	C	G	6	5	11	0	0	11	0	0
9	30248835	.	A	G	0	2	2	0	1	3	0	0
9	30248931	.	C	T	1	2	3	0	2	5	0	0
9	30249039	.	C	T	0	5	5	0	2	7	0	0
9	30251977	.	A	G	1	0	1	0	0	1	0	0
9	30255146	.	C	G	1	1	2	0	0	2	0	0
9	30326347	.	G	A	0	1	1	0	0	1	0	0
9	30326377	.	A	G	4	5	9	0	0	9	0	0
9	30330206	.	C	T	0	2	2	0	3	5	0	0
9	30330462	.	A	G	4	4	8	0	0	8	0	0
9	30342030	.	T	C	1	0	1	0	3	4	0	0
9	30342072	.	T	C	3	0	3	0	4	7	0	0
9	30344279	.	A	G	2	3	5	0	0	5	0	0
9	30346237	.	T	C	0	1	1	0	0	1	0	0
9	30346243	.	T	G	0	1	1	0	0	1	0	0
9	30375082	.	T	A	0	2	2	0	0	2	0	0
9	30375261	.	A	G	1	3	4	0	0	4	0	0
9	30375391	.	T	C	1	4	5	0	0	5	0	0
9	30375470	.	A	T	10	8	18	0	0	18	0	0
9	30375746	.	G	A	1	4	5	0	0	5	0	0
9	30377562	.	C	T	0	0	0	0	1	1	0	0
9	30377582	.	G	T	1	1	2	0	0	2	0	0
9	30381779	.	T	C	2	0	2	0	3	5	0	0
9	30381813	.	C	G	0	4	4	0	4	8	0	0
9	30484621	.	C	A	5	2	7	0	0	7	0	0
9	30487596	.	C	A	1	1	2	0	0	2	0	0
9	30487599	.	T	C	1	1	2	0	0	2	0	0
9	30489813	.	A	G	3	1	4	0	0	4	0	0
9	30490106	.	G	A	2	3	5	0	1	6	0	0
9	30490949	.	G	T	6	4	10	0	0	10	0	0
9	30491053	.	T	C	7	3	10	0	1	11	0	0
9	30491197	.	G	A	5	9	14	0	1	15	0	0
9	30491560	.	C	T	0	2	2	0	0	2	0	0
9	30494225	.	T	C	3	2	5	0	1	6	0	0
9	30494498	.	C	G	1	5	6	0	6	12	0	0
9	30494854	.	T	A	10	2	12	0	2	14	0	0
9	30494965	.	G	A	14	11	25	0	3	28	0	0
9	30495139	.	C	T	1	7	8	0	6	14	0	0
9	30496325	.	C	T	4	6	10	0	1	11	0	0
9	30496377	.	A	G	4	3	7	0	1	8	0	0
9	30496436	.	A	G	5	2	7	0	0	7	0	0
9	30496446	.	G	T	6	3	9	0	1	10	0	0
9	30496952	.	A	G	2	5	7	0	0	7	0	0
9	30562659	.	A	G	4	3	7	0	0	7	0	0
9	30562689	.	A	T	6	3	9	0	0	9	0	0
9	30562911	.	T	A	4	4	8	0	0	8	0	0
9	30562947	.	A	G	4	3	7	0	0	7	0	0
9	30563056	.	C	T	2	2	4	0	0	4	0	0
9	30563541	.	T	C	5	1	6	0	7	13	0	0
9	30563568	.	T	C	5	0	5	0	6	11	0	0
9	30566872	.	T	C	0	1	1	0	0	1	0	0
9	30566878	.	G	T	0	1	1	0	0	1	0	0
9	30578018	.	A	G	2	3	5	0	1	6	0	0
9	30581779	.	G	C	4	3	7	0	1	8	0	0
9	30581942	.	C	T	1	2	3	0	0	3	0	0
9	30627925	.	A	G	0	1	1	0	0	1	0	0
9	30630597	.	C	G	3	2	5	0	0	5	0	0
9	30636682	.	A	G	1	1	2	0	0	2	0	0
9	30636727	.	T	C	3	3	6	0	0	6	0	0
9	30638922	.	A	G	0	3	3	0	0	3	0	0
9	30639148	.	C	T	2	3	5	0	0	5	0	0
9	30639149	.	T	C	2	3	5	0	0	5	0	0
9	30764489	.	A	T	1	5	6	0	0	6	0	0
9	30800990	.	C	T	2	5	7	0	0	7	0	0
9	30806492	.	A	G	4	6	10	0	0	10	0	0
9	30806642	.	G	T	3	3	6	0	0	6	0	0
9	30806662	.	T	G	2	0	2	0	0	2	0	0
9	30807944	.	C	T	5	7	12	0	0	12	0	0
9	30990731	.	T	C	4	1	5	0	0	5	0	0
9	30990845	.	A	G	4	2	6	0	0	6	0	0
9	31042584	.	T	C	4	3	7	0	1	8	0	0
9	31062518	.	T	A	16	19	35	0	1	36	0	0
9	31062588	.	G	A	23	16	39	0	2	41	0	0
9	31062589	.	G	A	21	17	38	0	3	41	0	0
9	31214307	.	T	G	0	3	3	0	0	3	0	0
9	31214442	.	A	C	3	1	4	0	1	5	0	0
9	31239258	.	A	G	2	0	2	0	0	2	0	0
9	31248923	.	C	T	5	9	14	0	2	16	0	0
9	31258832	.	G	A	8	6	14	0	0	14	0	0
9	31274993	.	T	C	10	0	10	0	9	19	0	0
9	31276912	.	C	T	15	13	28	0	1	29	0	0
9	31510724	.	T	A	2	1	3	0	0	3	0	0
9	31524405	.	G	A	7	3	10	0	0	10	0	0
9	31524406	.	T	C	6	3	9	0	1	10	0	0
9	31524633	.	G	T	0	1	1	0	0	1	0	0
9	31524956	.	C	A	4	2	6	0	0	6	0	0
9	31595634	.	C	T	11	12	23	0	1	24	0	0
9	31604943	.	G	A	2	9	11	0	0	11	0	0
9	31605235	.	A	G	1	0	1	0	0	1	0	0
9	31605260	.	T	C	1	0	1	0	0	1	0	0
9	31605281	.	C	A	0	0	0	0	1	1	0	0
9	31606333	.	C	T	5	7	12	0	0	12	0	0
9	31612184	.	C	T	1	1	2	0	0	2	0	0
9	31617687	.	A	G	2	1	3	0	0	3	0	0
9	31619998	.	A	G	6	9	15	0	0	15	0	0
9	31639107	.	C	T	1	2	3	0	5	8	0	0
9	31735673	.	A	G	4	5	9	0	0	9	0	0
9	31735676	.	A	C	4	5	9	0	0	9	0	0
9	31736102	.	G	A	2	2	4	0	0	4	0	0
9	32169182	.	A	G	9	10	19	0	0	19	0	0
9	32169287	.	G	A	28	24	52	0	3	55	0	0
9	32181865	.	A	G	2	2	4	0	0	4	0	0
9	32187866	.	A	T	4	2	6	0	0	6	0	0
9	32286804	.	C	G	4	3	7	0	0	7	0	0
9	32286858	.	C	T	4	4	8	0	1	9	0	0
9	32287162	.	A	G	16	8	24	0	1	25	0	0
9	32287208	.	A	C	21	14	35	0	2	37	0	0
9	32287418	.	A	G	16	10	26	0	1	27	0	0
9	32287419	.	A	G	16	10	26	0	1	27	0	0
9	32287481	.	T	C	15	15	30	0	1	31	0	0
9	32287688	.	A	G	9	8	17	0	0	17	0	0
9	32289064	.	C	A	0	13	13	0	19	32	0	0
9	32289281	.	G	A	18	10	28	0	0	28	0	0
9	32290957	.	G	A	6	3	9	0	0	9	0	0
9	32297376	.	G	A	9	5	14	0	0	14	0	0
9	32297472	.	T	C	11	9	20	0	0	20	0	0
9	32297487	.	C	T	15	7	22	0	0	22	0	0
9	32304476	.	G	A	10	8	18	0	2	20	0	0
9	32304655	.	A	G	0	3	3	0	0	3	0	0
9	32304701	.	A	T	0	2	2	0	0	2	0	0
9	32304951	.	T	G	3	5	8	0	0	8	0	0
9	32307717	.	T	C	0	1	1	0	0	1	0	0
9	32308523	.	A	C	6	6	12	0	0	12	0	0
9	32312472	.	C	T	30	22	52	0	0	52	0	0
9	32312600	.	A	G	22	0	22	0	23	45	0	0
9	32312683	.	C	A	11	21	32	0	1	33	0	0
9	32313689	.	A	G	2	5	7	0	0	7	0	0
9	32313875	.	G	T	6	2	8	0	1	9	0	0
9	32313964	.	G	A	7	4	11	0	0	11	0	0
9	32433925	.	C	T	3	4	7	0	0	7	0	0
9	32433957	.	A	T	1	3	4	0	0	4	0	0
9	32434098	.	T	G	3	2	5	0	0	5	0	0
9	32435052	.	G	A	6	5	11	0	0	11	0	0
9	32435121	.	T	A	2	3	5	0	1	6	0	0
9	32435127	.	T	A	3	2	5	0	0	5	0	0
9	32441761	.	A	G	7	0	7	0	11	18	0	0
9	32441800	.	T	C	2	9	11	0	0	11	0	0
9	32457192	.	C	T	11	13	24	0	2	26	0	0
9	32641131	.	T	A	3	5	8	0	0	8	0	0
9	32641278	.	A	T	10	9	19	0	0	19	0	0
9	32641294	.	G	T	12	11	23	0	0	23	0	0
9	32641424	.	G	A	12	5	17	0	0	17	0	0
9	32641442	.	G	C	9	6	15	0	2	17	0	0
9	32641548	.	T	A	7	6	13	0	0	13	0	0
9	32641600	.	A	G	8	6	14	0	1	15	0	0
9	32641682	.	A	G	7	13	20	0	1	21	0	0
9	32641731	.	C	A	11	10	21	0	0	21	0	0
9	32641737	.	A	G	9	10	19	0	0	19	0	0
9	32641802	.	T	C	6	9	15	0	1	16	0	0
9	32641805	.	A	G	6	9	15	0	1	16	0	0
9	32642342	.	A	G	3	8	11	0	0	11	0	0
9	32643643	.	G	A	1	2	3	0	0	3	0	0
9	32645615	.	G	C	8	11	19	0	3	22	0	0
9	32645939	.	T	C	3	5	8	0	0	8	0	0
9	32651241	.	A	T	2	4	6	0	0	6	0	0
9	32651277	.	A	G	2	0	2	0	5	7	0	0
9	32651334	.	C	T	0	2	2	0	0	2	0	0
9	32651648	.	A	G	0	1	1	0	0	1	0	0
9	32651826	.	T	C	3	1	4	0	0	4	0	0
9	32651959	.	A	G	1	2	3	0	0	3	0	0
9	32651984	.	T	A	2	2	4	0	1	5	0	0
9	32652059	.	A	G	1	0	1	0	2	3	0	0
9	32652129	.	C	T	1	2	3	0	0	3	0	0
9	32674841	.	T	C	1	2	3	0	0	3	0	0
9	32681720	.	A	T	0	1	1	0	0	1	0	0
9	32681804	.	A	T	6	3	9	0	0	9	0	0
9	32681877	.	A	C	1	3	4	0	0	4	0	0
9	32681880	.	A	C	1	3	4	0	0	4	0	0
9	32728896	.	G	C	7	5	12	0	0	12	0	0
9	32728969	.	A	G	6	10	16	0	2	18	0	0
9	32728984	.	C	A	9	6	15	0	0	15	0	0
9	32729022	.	T	C	7	4	11	0	2	13	0	0
9	32729072	.	G	A	2	9	11	0	0	11	0	0
9	32729183	.	T	G	2	5	7	0	0	7	0	0
9	32729908	.	C	A	1	0	1	0	0	1	0	0
9	32751579	.	A	G	1	4	5	0	1	6	0	0
9	32751640	.	A	G	13	22	35	0	0	35	0	0
9	32751812	.	A	G	10	15	25	0	1	26	0	0
9	32751825	.	C	T	10	14	24	0	0	24	0	0
9	32752272	.	C	T	20	13	33	0	0	33	0	0
9	32752555	.	C	T	12	18	30	0	0	30	0	0
9	32752794	.	A	C	16	0	16	0	16	32	0	0
9	32752824	.	G	T	13	19	32	0	0	32	0	0
9	32752864	.	G	T	15	18	33	0	0	33	0	0
9	32752995	.	T	C	3	3	6	0	0	6	0	0
9	32753016	.	C	G	1	1	2	0	0	2	0	0
9	32804802	.	C	T	1	0	1	0	0	1	0	0
9	32804898	.	C	A	0	6	6	0	4	10	0	0
9	32860395	.	A	C	0	1	1	0	0	1	0	0
9	32860396	.	A	C	0	1	1	0	0	1	0	0
9	32870757	.	G	A	1	5	6	0	0	6	0	0
9	32870793	.	A	G	4	4	8	0	0	8	0	0
9	32871408	.	C	T	2	2	4	0	0	4	0	0
9	32872881	.	G	A	1	3	4	0	0	4	0	0
9	32872932	.	T	C	2	3	5	0	0	5	0	0
9	32873127	.	G	T	4	3	7	0	0	7	0	0
9	32873151	.	G	A	0	3	3	0	3	6	0	0
9	32873544	.	G	T	0	7	7	0	8	15	0	0
9	32873788	.	C	A	5	6	11	0	0	11	0	0
9	32873792	.	C	A	3	7	10	0	1	11	0	0
9	32873834	.	A	T	7	6	13	0	0	13	0	0
9	32873940	.	G	A	4	3	7	0	1	8	0	0
9	32874603	.	G	A	0	7	7	0	9	16	0	0
9	32895294	.	A	T	1	4	5	0	0	5	0	0
9	32895297	.	T	C	1	0	1	0	3	4	0	0
9	32897304	.	C	T	5	5	10	0	0	10	0	0
9	32899796	.	C	T	7	4	11	0	1	12	0	0
9	32900267	.	C	T	0	4	4	0	9	13	0	0
9	32900453	.	A	G	3	8	11	0	0	11	0	0
9	32900628	.	G	A	4	6	10	0	2	12	0	0
9	32900768	.	A	G	8	4	12	0	0	12	0	0
9	32900849	.	G	A	7	5	12	0	0	12	0	0
9	32901173	.	A	G	6	5	11	0	0	11	0	0
9	32901176	.	T	A	6	4	10	0	1	11	0	0
9	32909683	.	A	G	2	3	5	0	0	5	0	0
9	32912464	.	A	G	4	3	7	0	0	7	0	0
9	32980561	.	T	A	1	4	5	0	0	5	0	0
9	32981302	.	C	T	4	3	7	0	0	7	0	0
9	32981317	.	T	C	3	3	6	0	0	6	0	0
9	33411227	.	C	A	3	0	3	0	0	3	0	0
9	33411228	.	A	G	3	0	3	0	0	3	0	0
9	33661021	.	T	C	1	0	1	0	2	3	0	0
9	33661399	.	A	G	11	14	25	0	0	25	0	0
9	33661424	.	G	A	13	15	28	0	1	30	1	0
9	33661645	.	A	T	8	10	18	0	1	19	0	0
9	33661691	.	A	T	8	10	18	0	0	18	0	0
9	33661714	.	G	A	6	10	16	0	0	16	0	0
9	33661765	.	C	T	2	8	10	0	0	10	0	0
9	33661773	.	A	C	2	8	10	0	0	10	0	0
9	33661939	.	T	A	7	8	15	0	0	15	0	0
9	33662043	.	A	G	5	3	8	0	0	8	0	0
9	33662134	.	C	T	7	12	19	0	0	19	0	0
9	33662158	.	A	G	8	12	20	0	0	20	0	0
9	33662175	.	T	G	6	17	23	0	0	23	0	0
9	33662223	.	A	T	2	10	12	0	3	15	0	0
9	33662250	.	A	T	4	4	8	0	1	9	0	0
9	33662273	.	A	C	4	5	9	0	0	9	0	0
9	33663176	.	T	A	5	4	9	0	0	9	0	0
9	33663300	.	G	A	4	6	10	0	0	10	0	0
9	33663331	.	A	G	7	12	19	0	0	19	0	0
9	33663455	.	A	G	3	5	8	0	1	9	0	0
9	33663816	.	T	C	2	1	3	0	6	9	0	0
9	33678095	.	G	A	3	5	8	0	0	8	0	0
9	33678124	.	A	G	5	9	14	0	1	15	0	0
9	33678164	.	T	G	3	4	7	0	0	7	0	0
9	33678191	.	T	C	1	0	1	0	1	2	0	0
9	33741597	.	G	C	4	4	8	0	0	8	0	0
9	33741738	.	C	T	1	2	3	0	0	3	0	0
9	33783761	.	T	A	5	2	7	0	0	7	0	0
9	33783800	.	A	T	9	13	22	0	1	23	0	0
9	33783822	.	T	A	16	16	32	0	1	33	0	0
9	33783852	.	A	G	28	12	40	0	0	40	0	0
9	33783956	.	T	C	39	15	54	0	0	54	0	0
9	33784689	.	T	G	6	10	16	0	0	16	0	0
9	33816289	.	C	T	3	1	4	0	0	4	0	0
9	33853510	.	A	G	8	0	8	0	6	14	0	0
9	33857776	.	C	T	0	0	0	0	1	1	0	0
9	33858088	.	G	A	5	5	10	0	1	11	0	0
9	33858111	.	T	C	4	5	9	0	1	10	0	0
9	33861813	.	A	T	2	3	5	0	3	9	1	0
9	34113140	.	G	A	3	6	9	0	0	9	0	0
9	34117293	.	A	C	7	8	15	0	0	15	0	0
9	34119936	.	A	G	1	0	1	0	0	1	0	0
9	34120863	.	C	A	0	1	1	0	0	1	0	0
9	34147568	.	A	G	1	3	4	0	0	4	0	0
9	34161749	.	G	A	5	6	11	0	0	11	0	0
9	34161933	.	C	T	3	7	10	0	0	10	0	0
9	34170057	.	G	A	1	1	2	0	0	2	0	0
9	34174561	.	C	T	2	4	6	0	0	6	0	0
9	34174682	.	G	A	6	7	13	0	1	14	0	0
9	34191597	.	G	A	2	3	5	0	0	5	0	0
9	34200253	.	T	A	1	7	8	0	0	8	0	0
9	34201156	.	G	A	2	2	4	0	0	4	0	0
9	34205537	.	A	G	0	1	1	0	0	1	0	0
9	34218953	.	A	G	1	4	5	0	0	5	0	0
9	34219058	.	G	T	1	2	3	0	1	4	0	0
9	34219241	.	A	G	7	3	10	0	0	10	0	0
9	34222113	.	C	T	21	16	37	0	0	37	0	0
9	34225055	.	A	G	5	6	11	0	0	11	0	0
9	34225316	.	G	C	7	2	9	0	0	9	0	0
9	34226884	.	G	A	19	32	51	0	1	52	0	0
9	34226888	.	G	A	3	32	35	0	16	51	0	0
9	34226960	.	A	C	15	26	41	0	2	43	0	0
9	34227016	.	A	T	11	18	29	0	3	32	0	0
9	34227020	.	C	G	14	16	30	0	1	31	0	0
9	34227054	.	C	T	11	14	25	0	2	27	0	0
9	34227074	.	C	A	12	9	21	0	1	22	0	0
9	34232612	.	G	T	3	4	7	0	0	7	0	0
9	34232672	.	T	C	4	3	7	0	0	7	0	0
9	34232718	.	G	T	2	3	5	0	0	5	0	0
9	34236709	.	G	A	0	1	1	0	0	1	0	0
9	34238849	.	C	T	5	4	9	0	0	9	0	0
9	34238858	.	C	A	4	3	7	0	1	8	0	0
9	34238915	.	T	C	1	4	5	0	1	6	0	0
9	34239119	.	T	C	3	5	8	0	0	8	0	0
9	34243122	.	G	C	11	7	18	0	0	18	0	0
9	34243567	.	G	T	5	7	12	0	0	12	0	0
9	34246524	.	G	A	10	6	16	0	1	17	0	0
9	34246555	.	T	G	14	7	21	0	1	22	0	0
9	34246628	.	G	A	5	7	12	0	1	13	0	0
9	34246710	.	G	A	6	8	14	0	0	14	0	0
9	34246932	.	A	G	11	16	27	0	0	27	0	0
9	34247086	.	G	T	25	5	30	0	0	30	0	0
9	34247087	.	C	T	23	5	28	0	2	30	0	0
9	34247356	.	G	A	3	8	11	0	0	11	0	0
9	34251632	.	G	A	7	4	11	0	1	12	0	0
9	34251707	.	C	G	14	14	28	0	1	29	0	0
9	34251752	.	G	A	6	8	14	0	0	14	0	0
9	34251764	.	G	A	4	6	10	0	0	10	0	0
9	34251963	.	A	G	14	6	20	0	2	22	0	0
9	34254678	.	A	G	3	3	6	0	0	6	0	0
9	34254685	.	G	A	3	2	5	0	0	5	0	0
9	34254851	.	A	G	6	4	10	0	1	11	0	0
9	34254896	.	G	A	7	3	10	0	1	11	0	0
9	34256016	.	A	C	1	1	2	0	0	2	0	0
9	34258384	.	A	G	3	6	9	0	0	9	0	0
9	34258580	.	C	T	1	3	4	0	0	4	0	0
9	34259406	.	T	A	12	6	18	0	1	19	0	0
9	34259418	.	T	A	10	11	21	0	1	22	0	0
9	34260164	.	C	T	7	2	9	0	0	9	0	0
9	34334173	.	T	G	2	0	2	0	1	3	0	0
9	34349379	.	T	C	2	1	3	0	0	3	0	0
9	34380503	.	T	A	7	12	19	0	1	20	0	0
9	34380525	.	T	A	5	7	12	0	0	12	0	0
9	34382946	.	A	T	16	13	29	0	1	30	0	0
9	34385396	.	A	G	14	0	14	0	15	29	0	0
9	34388882	.	G	A	11	14	25	0	0	25	0	0
9	34389077	.	T	C	8	12	20	0	0	20	0	0
9	34389101	.	C	G	6	13	19	0	2	21	0	0
9	34389288	.	T	G	14	10	24	0	0	24	0	0
9	34389299	.	T	G	14	0	14	0	9	23	0	0
9	34389427	.	C	T	13	24	37	0	0	37	0	0
9	34389602	.	A	G	17	0	17	0	15	33	1	0
9	34389666	.	A	G	6	17	23	0	0	23	0	0
9	34389701	.	A	T	7	18	25	0	2	27	0	0
9	34389704	.	G	C	7	18	25	0	2	27	0	0
9	34389743	.	G	T	5	17	22	0	2	24	0	0
9	34389748	.	A	C	5	19	24	0	1	25	0	0
9	34389791	.	A	G	4	7	11	0	0	11	0	0
9	34398133	.	C	A	1	4	5	0	1	6	0	0
9	34398163	.	T	C	2	2	4	0	0	4	0	0
9	34401847	.	G	T	0	1	1	0	0	1	0	0
9	34404827	.	C	T	3	4	7	0	0	7	0	0
9	34404830	.	T	G	3	4	7	0	0	7	0	0
9	34408154	.	C	T	1	2	3	0	0	3	0	0
9	34410156	.	G	A	1	3	4	0	0	4	0	0
9	34410237	.	T	C	1	0	1	0	0	1	0	0
9	34415308	.	T	C	5	9	14	0	0	14	0	0
9	34416575	.	A	T	5	3	8	0	0	8	0	0
9	34423397	.	C	A	10	10	20	0	2	22	0	0
9	34423415	.	T	A	7	13	20	0	0	20	0	0
9	34423468	.	T	A	4	7	11	0	0	11	0	0
9	34423474	.	A	G	4	0	4	0	7	11	0	0
9	34423794	.	T	C	1	5	6	0	0	6	0	0
9	34423822	.	T	A	5	5	10	0	0	10	0	0
9	34425920	.	C	T	5	5	10	0	0	10	0	0
9	34491034	.	C	A	0	2	2	0	0	2	0	0
9	34647349	.	T	C	3	1	4	0	0	4	0	0
9	34647352	.	G	A	3	0	3	0	1	4	0	0
9	34647415	.	A	G	13	1	14	0	16	30	0	0
9	34647427	.	A	C	13	18	31	0	1	32	0	0
9	34866579	.	T	G	12	14	26	0	0	26	0	0
9	34866684	.	T	A	11	7	18	0	1	19	0	0
9	34866888	.	C	T	13	15	28	0	0	28	0	0
9	34867007	.	C	A	0	18	18	0	15	33	0	0
9	34867015	.	T	C	12	2	14	0	16	30	0	0
9	34869699	.	A	G	16	17	33	0	2	35	0	0
9	34869813	.	G	A	15	12	27	0	2	29	0	0
9	34869945	.	G	A	7	8	15	0	1	16	0	0
9	34871796	.	G	C	3	0	3	0	0	3	0	0
9	34877024	.	G	A	0	1	1	0	0	1	0	0
9	34877042	.	G	A	2	4	6	0	0	6	0	0
9	34877074	.	C	T	2	5	7	0	0	7	0	0
9	34877285	.	G	A	2	1	3	0	0	3	0	0
9	34877315	.	G	A	4	4	8	0	0	8	0	0
9	34878209	.	C	T	1	0	1	0	0	1	0	0
9	34880471	.	T	C	1	3	4	0	0	4	0	0
9	34903218	.	T	G	29	18	47	0	0	47	0	0
9	34906337	.	C	G	23	32	55	0	2	57	0	0
9	34912626	.	A	T	4	9	13	0	1	14	0	0
9	34912695	.	T	C	5	1	6	0	3	9	0	0
9	34912895	.	T	A	12	11	23	0	0	23	0	0
9	34920395	.	G	A	6	2	8	0	0	8	0	0
9	34922670	.	C	T	0	0	0	0	3	3	0	0
9	34922898	.	A	G	1	1	2	0	0	2	0	0
9	34937099	.	G	A	2	2	4	0	0	4	0	0
9	34937145	.	C	G	4	2	6	0	0	6	0	0
9	34937154	.	A	T	3	3	6	0	1	7	0	0
9	34938795	.	C	T	5	8	13	0	1	14	0	0
9	34939336	.	A	G	5	1	6	0	0	6	0	0
9	34939800	.	T	C	9	6	15	0	1	16	0	0
9	34967565	.	A	G	8	4	12	0	0	12	0	0
9	34967733	.	A	G	6	6	12	0	0	12	0	0
9	34967743	.	A	C	8	4	12	0	1	13	0	0
9	34968005	.	A	G	4	8	12	0	0	12	0	0
9	35024459	.	G	C	0	8	8	0	8	16	0	0
9	35025183	.	C	T	2	4	6	0	0	6	0	0
9	35025243	.	A	T	3	4	7	0	0	7	0	0
9	35025430	.	C	T	3	5	8	0	0	8	0	0
9	35026736	.	T	A	28	24	52	0	1	53	0	0
9	35026941	.	T	C	33	22	55	0	4	59	0	0
9	35027262	.	A	G	27	29	56	0	3	59	0	0
9	35027309	.	T	C	21	0	21	0	37	58	0	0
9	35027333	.	A	G	25	33	58	0	1	59	0	0
9	35027365	.	G	T	37	25	62	0	2	64	0	0
9	35027371	.	G	T	41	25	66	0	1	67	0	0
9	35027402	.	G	A	34	30	64	0	1	65	0	0
9	35027549	.	T	G	32	26	58	0	1	59	0	0
9	35027705	.	G	A	18	5	23	0	1	25	1	0
9	35028086	.	T	C	37	4	41	0	37	78	0	0
9	35028282	.	T	C	37	4	41	0	38	79	0	0
9	35030977	.	G	A	31	33	64	0	1	65	0	0
9	35032640	.	A	G	5	3	8	0	0	8	0	0
9	35032643	.	A	G	6	4	10	0	1	11	0	0
9	35033347	.	C	T	26	20	46	0	3	49	0	0
9	35039175	.	T	C	25	26	51	0	2	53	0	0
9	35048839	.	G	C	22	34	56	0	1	57	0	0
9	35048840	.	A	C	20	33	53	0	4	57	0	0
9	35170671	.	G	A	10	15	25	0	2	27	0	0
9	35176030	.	A	G	22	18	40	0	0	40	0	0
9	35228165	.	G	A	3	4	7	0	0	8	1	0
9	35230740	.	G	A	1	0	1	0	0	1	0	0
9	35254679	.	G	A	5	2	7	0	0	7	0	0
9	35266330	.	C	T	0	3	3	0	2	5	0	0
9	35296835	.	C	T	3	0	3	0	0	3	0	0
9	35836674	.	T	G	5	7	12	0	0	12	0	0
9	35836721	.	T	A	5	5	10	0	0	10	0	0
9	35837194	.	C	G	3	0	3	0	10	13	0	0
9	35837404	.	C	A	4	6	10	0	0	10	0	0
9	35838477	.	T	A	11	17	28	0	1	29	0	0
9	35840713	.	G	A	6	10	16	0	0	16	0	0
9	35840782	.	T	C	6	7	13	0	0	13	0	0
9	35841115	.	T	G	2	2	4	0	0	4	0	0
9	35841279	.	G	T	6	5	11	0	0	12	1	0
9	35841282	.	A	G	6	8	14	0	0	14	0	0
9	35841663	.	G	T	5	12	17	0	0	17	0	0
9	35841879	.	T	A	16	5	21	0	0	21	0	0
9	35841994	.	A	G	8	11	19	0	0	19	0	0
9	35842164	.	T	A	13	8	21	0	1	22	0	0
9	35842209	.	G	T	9	8	17	0	0	17	0	0
9	35860982	.	G	A	5	3	8	0	0	8	0	0
9	35860983	.	A	T	5	3	8	0	0	8	0	0
9	35862184	.	A	T	0	1	1	0	1	2	0	0
9	35862299	.	G	A	18	10	28	0	1	29	0	0
9	35863132	.	C	T	13	12	25	0	1	26	0	0
9	35863555	.	T	C	12	12	24	0	0	24	0	0
9	35863603	.	T	C	15	11	26	0	0	26	0	0
9	35863798	.	C	T	16	14	30	0	1	31	0	0
9	35863968	.	A	T	17	11	28	0	1	29	0	0
9	35864155	.	A	T	12	6	18	0	0	18	0	0
9	35864210	.	C	T	11	6	17	0	0	17	0	0
9	35864266	.	C	A	2	12	14	0	2	16	0	0
9	35864277	.	C	T	2	13	15	0	0	15	0	0
9	35864356	.	A	G	2	6	8	0	0	8	0	0
9	35864416	.	A	C	3	2	5	0	0	5	0	0
9	35864486	.	C	T	5	1	6	0	1	7	0	0
9	35864565	.	A	G	3	1	4	0	0	4	0	0
9	35864598	.	C	T	3	5	8	0	1	9	0	0
9	35865073	.	C	T	17	25	42	0	0	42	0	0
9	35865162	.	G	T	17	14	31	0	2	33	0	0
9	35865270	.	C	G	17	10	27	0	1	28	0	0
9	35872927	.	G	A	3	2	5	0	0	5	0	0
9	35872942	.	G	A	3	3	6	0	0	6	0	0
9	35872993	.	A	T	8	5	13	0	0	13	0	0
9	35873884	.	A	G	3	2	5	0	0	5	0	0
9	35901654	.	T	A	2	3	5	0	0	5	0	0
9	35906533	.	C	A	1	0	1	0	0	1	0	0
9	35907553	.	C	T	2	1	3	0	0	3	0	0
9	35909794	.	T	C	3	6	9	0	0	9	0	0
9	35909842	.	A	G	3	2	5	0	1	6	0	0
9	35910390	.	C	G	1	0	1	0	0	1	0	0
9	35910672	.	T	C	1	0	1	0	2	3	0	0
9	35912447	.	A	T	4	3	7	0	0	7	0	0
9	35912459	.	G	A	5	5	10	0	0	10	0	0
9	35912661	.	G	C	1	0	1	0	0	1	0	0
9	35915548	.	C	T	8	8	16	0	0	16	0	0
9	35915557	.	G	A	0	7	7	0	9	16	0	0
9	35916518	.	T	G	3	5	8	0	0	8	0	0
9	35916786	.	G	A	4	4	8	0	1	9	0	0
9	35922046	.	T	G	14	19	33	0	2	35	0	0
9	35922115	.	T	C	9	9	18	0	2	20	0	0
9	36595536	.	G	A	0	1	1	0	0	1	0	0
9	36610139	.	C	T	4	2	6	0	0	6	0	0
9	36610163	.	T	C	4	2	6	0	0	6	0	0
9	36613178	.	C	T	1	2	3	0	0	3	0	0
9	36613202	.	C	T	2	3	5	0	0	5	0	0
9	36656011	.	A	G	1	1	2	0	0	2	0	0
9	36898724	.	C	T	8	9	17	0	0	17	0	0
9	36899065	.	C	T	0	6	6	0	10	16	0	0
9	36973147	.	T	C	2	2	4	0	0	4	0	0
9	36973751	.	T	C	2	3	5	0	1	6	0	0
9	36974170	.	G	T	3	3	6	0	0	6	0	0
9	36974191	.	T	C	4	2	6	0	0	6	0	0
9	37354220	.	A	G	1	0	1	0	0	1	0	0
9	37367358	.	A	G	2	3	5	0	0	5	0	0
9	37371515	.	A	T	2	1	3	0	1	4	0	0
9	37387230	.	T	C	5	4	9	0	1	10	0	0
9	37387233	.	T	C	6	4	10	0	0	10	0	0
9	37431935	.	G	A	0	1	1	0	2	3	0	0
9	37451609	.	T	G	4	4	8	0	1	9	0	0
9	37451809	.	A	G	9	5	14	0	0	14	0	0
9	37452012	.	A	T	14	6	20	0	0	20	0	0
9	37452223	.	C	T	6	10	16	0	1	17	0	0
9	37452432	.	G	A	10	7	17	0	0	17	0	0
9	37452499	.	T	G	8	10	18	0	0	18	0	0
9	37452515	.	G	T	9	10	19	0	0	19	0	0
9	37452616	.	T	G	21	7	28	0	1	29	0	0
9	37452819	.	G	C	7	6	13	0	1	14	0	0
9	37452862	.	T	C	9	9	18	0	0	18	0	0
9	37452924	.	C	G	9	6	15	0	0	15	0	0
9	37492798	.	G	A	1	2	3	0	1	4	0	0
9	37492807	.	A	G	2	1	3	0	0	3	0	0
9	37754913	.	G	A	0	1	1	0	0	1	0	0
9	37815520	.	A	T	8	3	11	0	1	12	0	0
9	37815548	.	A	G	7	0	7	0	2	9	0	0
9	37850479	.	G	C	2	3	5	0	0	5	0	0
9	37850559	.	T	A	1	1	2	0	0	2	0	0
9	37853970	.	A	C	5	6	11	0	0	11	0	0
9	37856541	.	C	T	5	7	12	0	1	13	0	0
9	37856895	.	T	A	4	4	8	0	1	9	0	0
9	37859807	.	G	T	0	4	4	0	0	4	0	0
9	37859881	.	T	G	13	18	31	0	0	31	0	0
9	37860116	.	T	C	4	2	6	0	1	7	0	0
9	37860645	.	A	T	3	4	7	0	0	7	0	0
9	37861307	.	G	A	0	1	1	0	1	2	0	0
9	37861490	.	A	T	3	4	7	0	0	7	0	0
9	37861560	.	A	G	1	0	1	0	3	4	0	0
9	37862333	.	C	A	3	2	5	0	0	5	0	0
9	37941602	.	C	T	0	1	1	0	0	1	0	0
9	38021291	.	A	T	1	5	6	0	0	6	0	0
9	38030131	.	A	T	16	10	26	0	1	27	0	0
9	38030366	.	A	T	8	12	20	0	1	21	0	0
9	38030485	.	A	T	8	6	14	0	3	17	0	0
9	38030503	.	C	T	0	8	8	0	11	19	0	0
9	38030574	.	G	A	10	14	24	0	0	24	0	0
9	38030695	.	C	T	12	3	15	0	0	15	0	0
9	38033363	.	T	C	20	0	20	0	8	28	0	0
9	38033578	.	A	G	1	4	5	0	0	5	0	0
9	38042752	.	G	A	4	4	8	0	0	8	0	0
9	38043476	.	T	C	2	1	3	0	0	3	0	0
9	38057075	.	A	G	1	2	3	0	0	3	0	0
9	38058608	.	T	C	1	0	1	0	0	1	0	0
9	38059042	.	C	T	1	2	3	0	0	3	0	0
9	38061525	.	G	T	0	4	4	0	0	4	0	0
9	38061699	.	T	C	7	3	10	0	0	10	0	0
9	38061788	.	T	C	6	3	9	0	3	12	0	0
9	38063688	.	C	A	7	8	15	0	1	16	0	0
9	38063689	.	C	A	6	9	15	0	1	16	0	0
9	38064165	.	A	T	8	4	12	0	0	12	0	0
9	38064268	.	T	C	5	5	10	0	0	10	0	0
9	38064420	.	T	G	4	5	9	0	0	9	0	0
9	38064421	.	C	A	4	5	9	0	0	9	0	0
9	38064672	.	A	C	5	9	14	0	0	14	0	0
9	38074140	.	A	T	1	3	4	0	0	4	0	0
9	38129312	.	C	G	3	8	11	0	0	11	0	0
9	38140963	.	C	A	0	2	2	0	2	4	0	0
9	38161842	.	C	T	3	3	6	0	0	6	0	0
9	38207504	.	C	T	1	2	3	0	0	3	0	0
9	38238917	.	G	A	0	3	3	0	2	5	0	0
9	38251409	.	T	C	4	1	5	0	0	5	0	0
9	38266131	.	T	C	5	2	7	0	0	7	0	0
9	38269630	.	A	G	1	2	3	0	0	3	0	0
9	38273171	.	G	A	7	5	12	0	0	12	0	0
9	38273264	.	T	A	6	3	9	0	0	9	0	0
9	38277513	.	A	G	2	4	6	0	0	6	0	0
9	38278121	.	A	G	1	1	2	0	0	2	0	0
9	38278289	.	C	T	8	13	21	0	0	21	0	0
9	38278301	.	T	C	9	10	19	0	1	20	0	0
9	38278337	.	T	C	3	6	9	0	0	9	0	0
9	38283647	.	G	A	13	8	21	0	1	22	0	0
9	38283659	.	C	T	11	7	18	0	2	20	0	0
9	38284317	.	A	G	9	0	9	0	11	20	0	0
9	38285598	.	A	G	11	7	18	0	0	18	0	0
9	38286823	.	G	A	11	4	15	0	0	15	0	0
9	38290165	.	C	T	9	13	22	0	0	22	0	0
9	38290210	.	A	G	12	11	23	0	6	29	0	0
9	38290220	.	T	G	15	0	15	0	16	31	0	0
9	38290245	.	C	T	16	16	32	0	0	32	0	0
9	38290414	.	A	G	13	11	24	0	1	25	0	0
9	38290517	.	A	C	10	9	19	0	1	20	0	0
9	38290530	.	A	T	9	12	21	0	2	23	0	0
9	38290561	.	C	T	10	7	17	0	0	17	0	0
9	38290777	.	G	T	0	14	14	0	18	32	0	0
9	38290959	.	A	C	25	18	43	0	0	43	0	0
9	38291439	.	G	T	16	19	35	0	0	35	0	0
9	38291616	.	C	T	12	13	25	0	1	26	0	0
9	38291737	.	C	A	8	3	11	0	7	18	0	0
9	38315128	.	T	G	5	8	13	0	1	14	0	0
9	38315969	.	A	G	3	0	3	0	0	3	0	0
9	38315974	.	T	A	3	0	3	0	0	3	0	0
9	38348252	.	G	A	1	3	4	0	0	4	0	0
9	38351016	.	T	C	7	5	12	0	0	12	0	0
9	38353636	.	C	T	8	4	12	0	2	14	0	0
9	38353643	.	G	A	10	2	12	0	0	12	0	0
9	38353794	.	T	C	12	5	17	0	2	19	0	0
9	38354000	.	T	C	5	5	10	0	0	10	0	0
9	38354224	.	A	G	4	4	8	0	0	8	0	0
9	38354689	.	G	A	3	4	7	0	0	7	0	0
9	38359027	.	A	C	2	0	2	0	0	2	0	0
9	38359737	.	G	A	0	0	0	0	1	1	0	0
9	38360102	.	C	T	0	5	5	0	2	7	0	0
9	38362354	.	G	A	6	5	11	0	1	12	0	0
9	38362380	.	C	T	4	4	8	0	0	8	0	0
9	38365213	.	T	C	0	0	0	0	1	1	0	0
9	38366826	.	A	G	1	1	2	0	0	2	0	0
9	38368055	.	A	G	2	1	3	0	0	3	0	0
9	38375890	.	T	G	4	2	6	0	0	6	0	0
9	38376006	.	G	A	1	1	2	0	2	4	0	0
9	38376129	.	A	T	2	1	3	0	0	3	0	0
9	38376231	.	T	C	0	3	3	0	0	3	0	0
9	38377858	.	G	A	0	0	0	0	1	1	0	0
9	38386066	.	A	G	1	0	1	0	2	3	0	0
9	38386205	.	C	T	2	4	6	0	0	6	0	0
9	38386615	.	C	A	1	4	5	0	0	5	0	0
9	38388492	.	C	T	8	12	20	0	0	20	0	0
9	38388493	.	C	T	4	12	16	0	4	20	0	0
9	38388703	.	T	C	8	4	12	0	1	13	0	0
9	38389026	.	T	A	4	2	6	0	0	6	0	0
9	38389194	.	C	T	6	7	13	0	1	14	0	0
9	38389263	.	T	A	3	5	8	0	1	9	0	0
9	38389426	.	G	A	9	11	20	0	0	20	0	0
9	38389603	.	A	G	10	3	13	0	3	16	0	0
9	38389616	.	C	T	10	8	18	0	1	19	0	0
9	38389644	.	A	T	11	4	15	0	1	16	0	0
9	38389722	.	G	T	9	4	13	0	1	14	0	0
9	38389746	.	T	C	10	4	14	0	0	14	0	0
9	38389886	.	C	T	7	10	17	0	0	17	0	0
9	38390973	.	A	G	1	3	4	0	0	4	0	0
9	38390976	.	G	A	1	3	4	0	0	4	0	0
9	38391549	.	C	T	4	2	6	0	0	6	0	0
9	38392326	.	C	A	1	3	4	0	0	4	0	0
9	38392400	.	T	C	1	0	1	0	2	3	0	0
9	38392460	.	C	T	0	2	2	0	1	3	0	0
9	38393070	.	T	A	2	2	4	0	0	4	0	0
9	38393080	.	G	C	2	3	5	0	0	5	0	0
9	38396592	.	T	C	1	3	4	0	0	4	0	0
9	38396699	.	G	C	1	2	3	0	0	3	0	0
9	38397214	.	T	C	1	2	3	0	0	3	0	0
9	38400139	.	T	C	2	2	4	0	0	4	0	0
9	38400169	.	A	C	3	5	8	0	0	8	0	0
9	38405238	.	A	G	1	5	6	0	0	6	0	0
9	38405271	.	G	C	1	4	5	0	0	5	0	0
9	38413298	.	C	T	1	1	2	0	0	2	0	0
9	38418503	.	T	C	1	2	3	0	0	3	0	0
9	38418623	.	C	T	3	2	5	0	0	5	0	0
9	38456091	.	A	C	2	0	2	0	0	2	0	0
9	38456111	.	T	C	3	0	3	0	0	3	0	0
9	38456782	.	C	T	0	1	1	0	0	1	0	0
9	38458369	.	A	C	2	2	4	0	0	4	0	0
9	38458629	.	A	G	1	2	3	0	0	3	0	0
9	38458825	.	C	T	2	2	4	0	1	5	0	0
9	38458999	.	T	A	2	3	5	0	1	6	0	0
9	38470376	.	C	T	3	2	5	0	0	5	0	0
9	38475598	.	T	C	0	2	2	0	0	2	0	0
9	38476650	.	A	C	0	5	5	0	1	6	0	0
9	38476748	.	G	A	2	4	6	0	0	6	0	0
9	38476780	.	G	C	1	6	7	0	0	7	0	0
9	38476842	.	G	T	0	2	2	0	1	3	0	0
9	38478153	.	G	A	0	2	2	0	4	6	0	0
9	38478164	.	T	C	3	2	5	0	0	5	0	0
9	38478424	.	T	C	2	4	6	0	0	6	0	0
9	38478477	.	G	A	0	2	2	0	1	3	0	0
9	38478643	.	A	T	3	3	6	0	0	6	0	0
9	38479579	.	A	G	2	0	2	0	4	6	0	0
9	38497393	.	C	T	1	0	1	0	0	1	0	0
9	38502640	.	A	G	3	4	7	0	0	7	0	0
9	38502683	.	A	T	1	3	4	0	0	4	0	0
9	38505622	.	T	G	0	1	1	0	0	1	0	0
9	38507790	.	C	T	0	2	2	0	0	2	0	0
9	38510004	.	C	A	1	1	2	0	0	2	0	0
9	38514013	.	A	C	1	2	3	0	0	3	0	0
9	38530916	.	G	A	1	1	2	0	0	2	0	0
9	38550889	.	T	C	4	3	7	0	0	7	0	0
9	38550910	.	T	C	3	2	5	0	0	5	0	0
9	38600006	.	G	A	0	3	3	0	4	7	0	0
9	38603338	.	A	T	1	0	1	0	0	1	0	0
9	38620058	.	C	T	8	7	15	0	2	17	0	0
9	38620308	.	C	A	5	7	12	0	1	13	0	0
9	38620673	.	A	G	14	23	37	0	0	37	0	0
9	38629997	.	T	A	2	0	2	0	0	2	0	0
9	38636152	.	A	G	2	0	2	0	6	8	0	0
9	38636170	.	A	G	3	5	8	0	0	8	0	0
9	38636413	.	G	T	0	6	6	0	5	11	0	0
9	38636797	.	T	C	10	7	17	0	0	17	0	0
9	38637872	.	T	C	4	3	7	0	0	7	0	0
9	38637879	.	A	C	4	3	7	0	0	7	0	0
9	38638197	.	C	T	3	5	8	0	0	8	0	0
9	38638452	.	A	T	4	9	13	0	3	17	1	0
9	38638461	.	C	G	4	10	14	0	1	15	0	0
9	38638492	.	A	G	4	0	4	0	9	13	0	0
9	38638518	.	T	C	6	6	12	0	0	12	0	0
9	38638743	.	T	C	9	7	16	0	0	16	0	0
9	38638862	.	C	T	4	5	9	0	0	9	0	0
9	38638863	.	C	A	4	5	9	0	0	9	0	0
9	38638970	.	G	A	4	3	7	0	1	8	0	0
9	38639799	.	T	C	3	5	8	0	1	9	0	0
9	38639846	.	C	T	5	6	11	0	0	11	0	0
9	38639907	.	A	C	4	4	8	0	0	8	0	0
9	38639999	.	C	T	8	6	14	0	0	14	0	0
9	38640114	.	T	A	10	5	15	0	0	15	0	0
9	38640186	.	T	C	4	4	8	0	0	8	0	0
9	38640193	.	T	C	4	3	7	0	0	7	0	0
9	38640598	.	A	G	5	0	5	0	4	9	0	0
9	38640773	.	A	T	3	4	7	0	0	7	0	0
9	38641111	.	C	T	5	2	7	0	0	7	0	0
9	38707021	.	G	C	1	2	3	0	0	3	0	0
9	38707164	.	T	C	1	2	3	0	1	4	0	0
9	38707187	.	C	T	1	3	4	0	0	4	0	0
9	38744589	.	A	G	1	0	1	0	0	1	0	0
9	38888025	.	A	T	1	2	3	0	0	3	0	0
9	40928199	.	T	C	4	5	9	0	0	9	0	0
9	40928203	.	T	C	7	3	10	0	0	10	0	0
9	40928245	.	T	C	10	5	15	0	1	16	0	0
9	40928284	.	T	C	9	0	9	0	7	16	0	0
9	40930319	.	T	C	3	3	6	0	0	6	0	0
9	40931073	.	T	A	2	0	2	0	3	5	0	0
9	41479871	.	A	G	1	6	7	0	1	8	0	0
9	41479978	.	A	G	4	2	6	0	0	6	0	0
9	41481134	.	A	G	1	5	6	0	0	6	0	0
9	41680581	.	A	G	20	10	30	0	0	30	0	0
9	42360743	.	C	G	3	5	8	0	1	9	0	0
9	42360893	.	C	T	0	2	2	0	3	5	0	0
9	42360899	.	G	A	3	2	5	0	0	5	0	0
9	42421027	.	G	A	6	0	6	0	1	7	0	0
9	42421044	.	G	T	6	1	7	0	0	7	0	0
9	42644892	.	A	G	6	0	6	0	3	9	0	0
9	42649583	.	A	G	1	4	5	0	1	6	0	0
9	42649636	.	T	A	2	5	7	0	0	7	0	0
9	42649653	.	T	C	2	5	7	0	0	7	0	0
9	42649739	.	C	T	7	10	17	0	0	17	0	0
9	42649743	.	A	G	7	10	17	0	0	17	0	0
9	42649923	.	A	G	7	6	13	0	0	13	0	0
9	42653475	.	A	T	2	3	5	0	0	5	0	0
9	42653737	.	T	C	4	2	6	0	0	6	0	0
9	42657418	.	A	T	2	3	5	0	0	5	0	0
9	42658788	.	A	G	2	2	4	0	0	4	0	0
9	42660036	.	T	C	1	2	3	0	0	3	0	0
9	42660732	.	G	A	0	1	1	0	0	1	0	0
9	42660771	.	G	A	0	1	1	0	0	1	0	0
9	42662977	.	A	T	0	2	2	0	0	2	0	0
9	42728603	.	T	C	1	1	2	0	0	2	0	0
9	43082519	.	C	A	0	3	3	0	2	5	0	0
9	43082541	.	A	C	2	0	2	0	1	3	0	0
9	43082717	.	T	G	1	2	3	0	0	3	0	0
9	43085369	.	G	T	5	3	8	0	1	9	0	0
9	43085471	.	G	C	7	3	10	0	1	11	0	0
9	43085527	.	A	T	7	5	12	0	2	14	0	0
9	43085728	.	A	C	7	4	11	0	0	11	0	0
9	43085879	.	C	T	5	2	7	0	1	8	0	0
9	43085949	.	A	C	1	1	2	0	0	2	0	0
9	43088841	.	C	A	1	2	3	0	0	3	0	0
9	43088870	.	T	A	2	3	5	0	1	6	0	0
9	43088884	.	G	A	3	5	8	0	0	8	0	0
9	43088910	.	A	T	3	5	8	0	0	8	0	0
9	43089038	.	C	G	3	5	8	0	0	8	0	0
9	43113358	.	T	A	2	0	2	0	1	3	0	0
9	43113372	.	A	C	2	2	4	0	1	5	0	0
9	43113395	.	C	T	2	2	4	0	1	5	0	0
9	43113730	.	A	G	1	2	3	0	0	3	0	0
9	43116589	.	C	A	1	1	2	0	0	2	0	0
9	43116652	.	T	C	3	2	5	0	0	5	0	0
9	43150018	.	T	A	7	5	12	0	0	12	0	0
9	43150278	.	T	G	10	15	25	0	1	26	0	0
9	43150604	.	A	G	12	14	26	0	1	27	0	0
9	43150817	.	C	T	0	24	24	0	7	31	0	0
9	43153287	.	C	T	4	6	10	0	0	10	0	0
9	43154841	.	C	T	4	4	8	0	1	9	0	0
9	43202097	.	T	C	1	0	1	0	2	3	0	0
9	43243265	.	A	C	6	5	11	0	2	13	0	0
9	43243266	.	T	C	7	5	12	0	1	13	0	0
9	43261951	.	T	A	5	6	11	0	1	12	0	0
9	43287748	.	G	A	1	2	3	0	0	3	0	0
9	43375122	.	G	A	4	3	7	0	0	7	0	0
9	43552604	.	C	A	3	3	6	0	0	6	0	0
9	43552687	.	A	C	3	3	6	0	1	7	0	0
9	43553036	.	G	T	12	20	32	0	0	32	0	0
9	43612482	.	T	G	4	2	6	0	0	6	0	0
9	43617962	.	A	G	7	6	13	0	1	14	0	0
9	44097854	.	C	T	0	1	1	0	1	2	0	0
9	44109260	.	A	G	0	3	3	0	0	3	0	0
9	44292285	.	A	C	30	0	30	0	18	48	0	0
9	44292737	.	T	C	29	22	51	0	1	52	0	0
9	44292909	.	C	T	1	30	31	0	25	56	0	0
9	44293488	.	C	T	25	28	53	0	1	54	0	0
9	44294792	.	A	G	4	1	5	0	0	5	0	0
9	44391507	.	G	C	2	2	4	0	0	4	0	0
9	44391688	.	A	G	3	2	5	0	0	5	0	0
9	44399446	.	C	A	1	2	3	0	0	3	0	0
9	44399472	.	A	G	1	0	1	0	2	3	0	0
9	44400091	.	T	G	1	3	4	0	0	4	0	0
9	44400119	.	G	A	1	3	4	0	0	4	0	0
9	44400706	.	C	A	5	3	8	0	1	9	0	0
9	44411647	.	A	G	7	7	14	0	0	14	0	0
9	44411652	.	C	A	8	7	15	0	1	16	0	0
9	44411828	.	A	C	0	2	2	0	0	2	0	0
9	44419652	.	T	A	8	7	15	0	2	17	0	0
9	44419793	.	C	A	8	3	11	0	1	12	0	0
9	44486011	.	A	G	4	3	7	0	1	8	0	0
9	44488578	.	T	A	4	4	8	0	0	9	1	0
9	44488620	.	G	A	2	1	3	0	0	3	0	0
9	44489843	.	G	A	0	9	9	0	5	14	0	0
9	44489844	.	T	A	5	9	14	0	0	14	0	0
9	44498332	.	T	C	4	12	16	0	1	17	0	0
9	44511218	.	C	T	3	3	6	0	0	6	0	0
9	44515937	.	G	A	3	6	9	0	1	10	0	0
9	44526546	.	G	A	3	3	6	0	0	6	0	0
9	44641974	.	A	T	4	8	12	0	0	12	0	0
9	44642017	.	G	A	4	4	8	0	0	8	0	0
9	44642057	.	T	C	6	0	6	0	6	12	0	0
9	44961166	.	A	G	2	2	4	0	0	4	0	0
9	45504199	.	C	T	1	3	4	0	2	6	0	0
9	45504485	.	A	G	5	2	7	0	0	7	0	0
9	45504888	.	G	A	1	4	5	0	1	6	0	0
9	45523190	.	G	A	6	4	10	0	1	11	0	0
9	45536096	.	A	G	1	2	3	0	0	3	0	0
9	45541036	.	C	A	6	4	10	0	0	10	0	0
9	45541069	.	T	C	3	3	6	0	0	6	0	0
9	45541239	.	G	A	2	3	5	0	0	5	0	0
9	45551273	.	T	C	9	8	17	1	8	26	0	0
9	45552158	.	A	T	6	8	14	0	0	14	0	0
9	45552338	.	T	G	8	7	15	0	0	15	0	0
9	45552364	.	G	A	0	5	5	0	7	12	0	0
9	45552386	.	C	G	5	11	16	0	2	18	0	0
9	45552567	.	G	A	1	21	22	0	13	35	0	0
9	45552715	.	C	T	15	9	24	0	3	27	0	0
9	45552806	.	G	A	1	17	18	0	11	29	0	0
9	45552881	.	T	C	9	22	31	0	0	31	0	0
9	45552924	.	C	A	11	15	26	0	0	26	0	0
9	45552957	.	C	T	16	13	29	0	1	30	0	0
9	45623346	.	C	T	4	4	8	0	1	9	0	0
9	45666600	.	G	A	1	0	1	0	0	1	0	0
9	45884426	.	C	T	1	2	3	0	2	5	0	0
9	45884711	.	G	A	6	3	9	0	0	9	0	0
9	45884768	.	T	G	8	3	11	0	1	12	0	0
9	45934065	.	A	G	0	4	4	0	0	4	0	0
9	45968318	.	A	G	1	3	4	0	0	4	0	0
9	45975846	.	C	T	0	6	6	0	4	10	0	0
9	46029269	.	G	T	2	2	4	0	0	4	0	0
9	46029344	.	G	A	2	0	2	0	0	2	0	0
9	46525673	.	A	G	4	3	7	0	1	8	0	0
9	46598134	.	T	C	1	1	2	0	0	2	0	0
9	46603999	.	A	G	2	0	2	0	5	7	0	0
9	46604056	.	T	C	1	2	3	0	0	3	0	0
9	46604068	.	A	G	1	0	1	0	1	2	0	0
9	46604930	.	C	T	2	2	4	0	0	4	0	0
9	46650764	.	T	C	1	4	5	0	0	5	0	0
9	46656990	.	G	C	0	2	2	0	1	3	0	0
9	46671108	.	G	A	0	3	3	0	2	5	0	0
9	46671174	.	C	T	4	5	9	0	0	9	0	0
9	46672436	.	G	A	0	4	4	0	0	4	0	0
9	46676385	.	C	T	3	3	6	0	0	6	0	0
9	46676393	.	C	G	3	3	6	0	0	6	0	0
9	46678159	.	A	C	2	6	8	0	0	9	1	0
9	46678196	.	C	T	1	7	8	0	1	9	0	0
9	46678255	.	T	C	0	3	3	0	0	3	0	0
9	46678279	.	A	T	0	1	1	0	0	1	0	0
9	46683760	.	C	A	0	5	5	0	0	5	0	0
9	46683861	.	A	C	5	2	7	0	0	7	0	0
9	46684175	.	C	A	1	2	3	0	1	4	0	0
9	46684191	.	G	T	4	2	6	0	0	6	0	0
9	46684311	.	A	G	3	2	5	0	0	5	0	0
9	46692261	.	T	G	14	18	32	0	0	32	0	0
9	46692412	.	G	T	2	3	5	0	1	6	0	0
9	46745653	.	A	G	2	2	4	0	0	4	0	0
9	46784333	.	G	A	2	0	2	0	0	2	0	0
9	46799102	.	T	C	6	3	9	0	0	9	0	0
9	46821464	.	C	T	16	9	25	0	0	25	0	0
9	46821685	.	A	G	5	3	8	0	0	8	0	0
9	46821853	.	G	A	1	6	7	0	2	9	0	0
9	46821855	.	G	T	2	7	9	0	0	9	0	0
9	46821905	.	A	G	6	5	11	0	0	11	0	0
9	46821916	.	A	T	7	6	13	0	1	14	0	0
9	46822079	.	C	T	9	7	16	0	0	16	0	0
9	46822120	.	C	T	0	3	3	0	9	12	0	0
9	46822144	.	T	C	5	4	9	0	2	11	0	0
9	46822417	.	C	T	0	6	6	0	9	15	0	0
9	46823198	.	C	T	12	14	26	0	0	26	0	0
9	46823325	.	G	A	9	20	29	0	1	30	0	0
9	46823366	.	T	C	11	11	22	0	1	23	0	0
9	46823524	.	A	G	11	13	24	0	1	25	0	0
9	46824110	.	A	G	10	8	18	0	0	18	0	0
9	46824160	.	T	A	10	8	18	0	1	19	0	0
9	46824291	.	C	A	4	2	6	0	0	6	0	0
9	46825094	.	A	T	10	10	20	0	0	20	0	0
9	46841787	.	C	G	2	5	7	0	0	7	0	0
9	47463251	.	A	T	1	1	2	0	0	2	0	0
9	47465478	.	G	A	3	3	6	0	0	6	0	0
9	47502293	.	A	T	2	4	6	0	0	6	0	0
9	47502964	.	A	G	2	3	5	0	0	5	0	0
9	48054753	.	G	A	14	12	26	0	1	27	0	0
9	48060592	.	G	C	11	14	25	0	1	26	0	0
9	48076973	.	C	T	25	25	50	0	0	50	0	0
9	48123142	.	G	A	6	5	11	0	0	11	0	0
9	48123222	.	G	C	8	3	11	0	0	11	0	0
9	48127200	.	G	A	2	1	3	0	0	3	0	0
9	48128027	.	G	T	0	6	6	0	4	10	0	0
9	48131637	.	T	A	2	6	8	0	0	8	0	0
9	48131814	.	A	T	4	6	10	0	0	10	0	0
9	48131865	.	G	A	2	4	6	0	0	6	0	0
9	48131920	.	A	C	2	2	4	2	0	6	0	0
9	48131997	.	C	T	2	4	6	0	4	10	0	0
9	48132029	.	T	C	6	1	7	0	7	14	0	0
9	48132037	.	T	A	7	7	14	0	0	14	0	0
9	48132095	.	A	C	6	4	10	0	0	10	0	0
9	48132156	.	A	C	2	3	5	0	1	6	0	0
9	48132176	.	C	T	2	3	5	0	1	6	0	0
9	48132194	.	G	T	2	2	4	0	0	4	0	0
9	48132309	.	G	T	2	7	9	0	0	9	0	0
9	48132336	.	C	T	1	6	7	0	2	9	0	0
9	48132439	.	G	A	2	6	8	0	0	8	0	0
9	48132441	.	A	G	2	6	8	0	0	8	0	0
9	48132531	.	G	A	5	6	11	0	0	11	0	0
9	48132592	.	G	T	3	5	8	0	0	8	0	0
9	48132795	.	A	G	3	4	7	0	0	7	0	0
9	48132865	.	A	C	1	3	4	0	0	5	1	0
9	48133013	.	T	C	6	2	8	0	0	8	0	0
9	48133105	.	G	T	3	8	11	0	0	11	0	0
9	48133541	.	T	C	6	3	9	0	0	9	0	0
9	48133687	.	A	G	1	5	6	0	0	6	0	0
9	48133900	.	G	T	7	3	10	0	1	11	0	0
9	48134012	.	T	A	2	6	8	0	0	8	0	0
9	48134201	.	A	T	1	2	3	0	1	4	0	0
9	48134351	.	G	A	4	3	7	0	0	7	0	0
9	48134568	.	G	A	2	6	8	0	5	13	0	0
9	48134678	.	A	T	3	3	6	0	0	6	0	0
9	48178424	.	C	T	0	4	4	0	3	7	0	0
9	48178876	.	A	G	3	2	5	0	0	5	0	0
9	48184354	.	A	C	2	2	4	0	0	4	0	0
9	48195432	.	C	T	1	1	2	0	0	2	0	0
9	48197877	.	T	A	1	2	3	0	0	3	0	0
9	48201122	.	A	G	1	2	3	0	0	3	0	0
9	48201127	.	G	A	1	2	3	0	0	3	0	0
9	48203875	.	G	A	1	1	2	0	0	2	0	0
9	48203896	.	A	G	1	4	5	0	0	5	0	0
9	48219649	.	T	G	1	0	1	0	3	4	0	0
9	48219700	.	A	G	1	3	4	0	0	4	0	0
9	48228950	.	T	C	1	1	2	0	0	2	0	0
9	48239744	.	G	A	0	2	2	0	1	3	0	0
9	48239757	.	C	A	1	2	3	0	0	3	0	0
9	48252433	.	C	T	2	4	6	0	0	6	0	0
9	48264034	.	C	T	1	1	2	0	0	2	0	0
9	48266227	.	A	G	0	0	0	0	1	1	0	0
9	48266242	.	C	G	1	2	3	0	0	3	0	0
9	48266430	.	C	G	1	3	4	0	0	4	0	0
9	48284901	.	T	C	12	12	24	0	1	25	0	0
9	48284917	.	C	A	0	10	10	0	11	21	0	0
9	48285019	.	G	A	2	1	3	0	0	3	0	0
9	48286702	.	G	A	1	0	1	0	0	1	0	0
9	48287441	.	G	A	5	7	12	0	1	13	0	0
9	48289758	.	G	A	3	0	3	0	0	3	0	0
9	48289797	.	A	T	3	0	3	0	0	3	0	0
9	48289961	.	A	G	2	3	5	0	0	5	0	0
9	48289991	.	T	C	2	5	7	0	1	8	0	0
9	48295210	.	G	A	1	0	1	0	0	1	0	0
9	48295211	.	T	G	1	0	1	0	0	1	0	0
9	48296346	.	C	T	0	4	4	0	10	14	0	0
9	48407342	.	C	T	4	4	8	0	0	8	0	0
9	48407365	.	T	G	4	4	8	0	0	8	0	0
9	48606235	.	C	T	1	2	3	0	0	3	0	0
9	48650859	.	C	T	0	2	2	0	0	2	0	0
9	48665654	.	G	A	1	0	1	0	0	1	0	0
9	48668834	.	C	G	3	2	5	0	0	5	0	0
9	48670316	.	C	T	1	2	3	0	0	3	0	0
9	48670525	.	T	C	1	3	4	0	0	4	0	0
9	48670660	.	G	A	0	6	6	0	2	8	0	0
9	48670747	.	T	G	1	0	1	0	5	6	0	0
9	48670748	.	T	C	2	4	6	0	0	6	0	0
9	48671010	.	T	G	1	2	3	1	0	4	0	0
9	48671052	.	A	G	1	2	3	0	0	3	0	0
9	48706302	.	C	T	3	2	5	0	1	6	0	0
9	48706305	.	C	T	2	2	4	0	1	5	0	0
9	48721107	.	C	T	2	2	4	0	0	4	0	0
9	48721160	.	A	G	1	3	4	0	0	4	0	0
9	48721172	.	A	G	2	3	5	0	0	5	0	0
9	48870578	.	T	C	9	0	9	0	9	18	0	0
9	48870593	.	A	T	9	8	17	0	1	18	0	0
9	48870627	.	T	A	7	5	12	0	0	12	0	0
9	48870680	.	A	G	4	3	7	0	0	7	0	0
9	48870886	.	C	T	2	7	9	0	2	11	0	0
9	48871080	.	G	C	5	3	8	0	0	8	0	0
9	48871495	.	T	G	1	2	3	0	0	3	0	0
9	48872039	.	C	G	0	4	4	3	0	7	0	0
9	48872050	.	C	T	0	3	3	0	0	3	0	0
9	48872615	.	A	G	7	3	10	0	1	11	0	0
9	48872620	.	C	T	6	2	8	0	1	9	0	0
9	48872890	.	C	A	5	5	10	0	0	10	0	0
9	48872924	.	A	G	6	6	12	0	0	12	0	0
9	48872926	.	C	T	0	4	4	0	8	12	0	0
9	48873302	.	T	C	6	5	11	0	0	11	0	0
9	48873371	.	A	G	2	6	8	0	0	8	0	0
9	48873522	.	C	G	5	3	8	0	0	8	0	0
9	48873831	.	A	C	1	0	1	0	3	4	0	0
9	48873853	.	G	A	2	2	4	0	0	4	0	0
9	48874562	.	G	A	5	6	11	0	1	12	0	0
9	48874577	.	G	A	4	6	10	0	1	11	0	0
9	48874728	.	T	C	4	6	10	0	0	10	0	0
9	48875510	.	T	C	2	3	5	0	1	6	0	0
9	48875516	.	G	A	2	2	4	0	1	5	0	0
9	48875674	.	A	G	2	2	4	0	0	4	0	0
9	48875739	.	G	T	0	2	2	0	0	2	0	0
9	48876158	.	C	A	3	4	7	0	0	7	0	0
9	48876188	.	T	C	1	2	3	0	1	4	0	0
9	48876199	.	T	C	1	2	3	0	0	3	0	0
9	48876349	.	T	A	2	2	4	0	0	4	0	0
9	48876587	.	A	G	4	5	9	0	0	9	0	0
9	48876798	.	C	T	0	3	3	0	4	7	0	0
9	48877348	.	A	G	2	5	7	0	1	8	0	0
9	48937081	.	G	C	3	2	5	0	0	5	0	0
9	50196047	.	A	C	1	2	3	0	1	4	0	0
9	50196064	.	C	T	1	2	3	0	0	3	0	0
9	50205289	.	A	C	2	2	4	0	0	4	0	0
9	51206445	.	T	A	3	2	5	0	0	5	0	0
9	51271433	.	A	G	0	0	0	0	3	3	0	0
9	51302422	.	A	G	7	7	14	0	1	15	0	0
9	51307387	.	G	T	2	2	4	0	0	4	0	0
9	51345386	.	C	A	2	2	4	0	0	4	0	0
9	51430606	.	C	G	2	3	5	0	0	5	0	0
9	51430737	.	C	T	0	5	5	0	1	6	0	0
9	51430767	.	T	A	4	4	8	0	0	8	0	0
9	51430826	.	A	T	3	4	7	0	0	7	0	0
9	51430886	.	G	C	1	6	7	0	1	8	0	0
9	51431179	.	C	G	7	14	21	0	1	22	0	0
9	51431642	.	A	C	9	0	9	0	3	12	0	0
9	51431831	.	G	A	1	0	1	0	1	2	0	0
9	51431843	.	C	G	1	1	2	0	2	4	0	0
9	51432279	.	T	G	6	8	14	0	2	16	0	0
9	51752208	.	C	T	1	1	2	0	0	2	0	0
9	51996246	.	C	T	0	4	4	0	2	6	0	0
9	51996280	.	T	A	2	5	7	0	0	7	0	0
9	51996281	.	G	A	1	5	6	0	1	7	0	0
9	51996444	.	T	G	15	8	23	0	0	23	0	0
9	51996469	.	C	T	0	9	9	0	10	19	0	0
9	51996788	.	A	G	4	4	8	0	0	8	0	0
9	51996876	.	A	G	4	2	6	0	0	6	0	0
9	51997286	.	C	A	3	2	5	0	0	5	0	0
9	51998495	.	A	C	6	1	7	0	3	10	0	0
9	51998539	.	G	T	6	4	10	0	0	10	0	0
9	51998547	.	C	T	6	4	10	1	0	11	0	0
9	51998648	.	C	T	7	4	11	0	3	14	0	0
9	51998761	.	C	G	4	4	8	0	0	8	0	0
9	51998784	.	T	G	6	6	12	0	0	12	0	0
9	51998887	.	T	G	2	5	7	0	0	7	0	0
9	51998927	.	A	G	0	3	3	0	0	3	0	0
9	51999842	.	C	G	6	4	10	0	0	10	0	0
9	51999855	.	T	G	8	5	13	0	0	13	0	0
9	51999991	.	A	G	2	3	5	0	0	5	0	0
9	52000032	.	C	T	0	4	4	0	2	6	0	0
9	52000088	.	G	A	3	7	10	0	0	10	0	0
9	52000127	.	C	G	8	4	12	0	0	12	0	0
9	52000293	.	T	C	5	0	5	0	5	10	0	0
9	52000335	.	A	T	7	4	11	0	1	12	0	0
9	52000623	.	C	T	0	2	2	0	5	7	0	0
9	52000665	.	A	G	6	2	8	0	0	8	0	0
9	52000773	.	C	T	0	4	4	0	7	11	0	0
9	52000861	.	A	C	1	3	4	0	0	4	0	0
9	52000869	.	G	C	3	0	3	0	2	5	0	0
9	52001016	.	C	T	0	7	7	0	3	10	0	0
9	52057288	.	A	C	3	0	3	0	2	5	0	0
9	52057708	.	C	T	1	1	2	0	0	2	0	0
9	52062710	.	T	G	5	2	7	0	0	7	0	0
9	52100664	.	G	A	1	1	2	0	0	2	0	0
9	52378682	.	C	T	18	10	28	0	0	28	0	0
9	52378697	.	A	G	15	16	31	0	1	32	0	0
9	52378832	.	T	A	6	15	21	1	1	23	0	0
9	52416005	.	G	A	0	1	1	0	0	1	0	0
9	52431349	.	G	A	0	4	4	0	1	5	0	0
9	52435058	.	G	C	1	2	3	0	1	4	0	0
9	52479199	.	T	C	2	3	5	0	0	5	0	0
9	52479901	.	C	T	0	1	1	0	0	1	0	0
9	52487494	.	T	A	0	2	2	0	0	2	0	0
9	52487535	.	T	C	0	0	0	0	1	1	0	0
9	52489838	.	C	A	0	2	2	0	0	2	0	0
9	52489899	.	T	C	3	0	3	0	6	9	0	0
9	52490015	.	A	G	1	2	3	0	0	3	0	0
9	52490121	.	A	T	1	2	3	0	0	3	0	0
9	52490127	.	A	G	1	2	3	0	0	3	0	0
9	52490250	.	C	T	0	2	2	0	1	3	0	0
9	52490254	.	G	T	1	2	3	0	0	3	0	0
9	52492688	.	C	G	9	0	9	0	9	18	0	0
9	52492705	.	A	G	4	15	19	0	1	20	0	0
9	52492853	.	C	G	6	0	6	0	3	9	0	0
9	52493059	.	A	T	7	1	8	0	1	9	0	0
9	52493231	.	A	T	9	8	17	0	1	18	0	0
9	52493406	.	C	T	9	5	14	0	0	14	0	0
9	52532370	.	C	G	9	4	13	0	1	14	0	0
9	52539290	.	G	A	0	2	2	0	6	8	0	0
9	52539453	.	C	T	17	15	32	0	0	32	0	0
9	52539629	.	C	T	8	11	19	0	2	21	0	0
9	52564578	.	T	C	1	0	1	0	1	2	0	0
9	52572555	.	C	T	1	1	2	0	1	3	0	0
9	52572573	.	G	A	2	2	4	0	0	4	0	0
9	52574737	.	C	G	5	2	7	0	1	8	0	0
9	52577760	.	C	T	0	2	2	0	0	2	0	0
9	52594558	.	G	C	1	2	3	0	0	3	0	0
9	52594573	.	G	A	3	2	5	0	0	5	0	0
9	52629113	.	C	T	7	9	16	0	0	16	0	0
9	52629119	.	C	T	9	7	16	0	0	16	0	0
9	52629155	.	T	C	0	2	2	0	0	2	0	0
9	52631620	.	G	A	1	2	3	0	1	4	0	0
9	52633151	.	C	T	4	0	4	0	0	4	0	0
9	52633184	.	C	G	4	0	4	0	0	4	0	0
9	52645687	.	C	T	0	3	3	0	5	8	0	0
9	52649704	.	C	T	0	2	2	0	1	3	0	0
9	52649740	.	C	A	0	3	3	0	4	7	0	0
9	52649758	.	T	A	4	3	7	0	0	7	0	0
9	52649794	.	A	G	1	2	3	0	0	3	0	0
9	52649941	.	G	A	2	0	2	0	0	2	0	0
9	52651985	.	T	C	0	3	3	0	1	4	0	0
9	53276681	.	G	A	1	8	9	0	8	17	0	0
9	53276976	.	C	T	7	10	17	0	1	18	0	0
9	53276978	.	A	G	10	7	17	0	1	18	0	0
9	53277068	.	C	G	11	0	11	0	5	16	0	0
9	53277131	.	A	T	7	6	13	0	0	13	0	0
9	53277453	.	G	A	0	6	6	0	11	17	0	0
9	53277493	.	A	T	5	11	16	0	1	17	0	0
9	54219391	.	A	C	2	0	2	0	2	4	0	0
9	54219418	.	G	T	3	3	6	0	0	6	0	0
9	54247334	.	A	G	1	3	4	0	1	5	0	0
9	54247336	.	T	C	1	4	5	0	0	5	0	0
9	54256221	.	C	G	5	6	11	0	0	11	0	0
9	54256286	.	C	A	3	2	5	0	0	5	0	0
9	54260901	.	C	T	2	2	4	0	1	5	0	0
9	54261104	.	G	A	0	2	2	0	3	5	0	0
9	54263996	.	C	T	3	2	5	0	0	5	0	0
9	54264236	.	T	C	1	5	6	0	0	6	0	0
9	54264245	.	T	C	1	4	5	0	0	5	0	0
9	54264272	.	C	T	3	5	8	0	0	8	0	0
9	54264299	.	C	A	5	5	10	0	0	10	0	0
9	54267524	.	A	T	1	0	1	0	0	1	0	0
9	54270324	.	C	T	3	2	5	0	0	5	0	0
9	54270348	.	T	A	2	2	4	0	1	5	0	0
9	54273514	.	G	T	1	7	8	0	0	8	0	0
9	54273797	.	C	T	1	1	2	0	0	2	0	0
9	54315617	.	T	G	2	2	4	0	0	4	0	0
9	54329537	.	T	C	5	5	10	0	0	10	0	0
9	54329593	.	C	A	0	2	2	0	2	4	0	0
9	54335139	.	A	G	2	2	4	0	0	4	0	0
9	54335197	.	C	T	2	2	4	0	1	5	0	0
9	54340140	.	C	T	0	1	1	0	0	1	0	0
9	54340317	.	T	A	0	1	1	0	0	1	0	0
9	54345372	.	G	A	0	4	4	0	2	6	0	0
9	54349735	.	G	C	2	0	2	0	0	2	0	0
9	54351499	.	T	C	1	1	2	0	0	2	0	0
9	54351604	.	T	C	0	0	0	0	2	2	0	0
9	54351610	.	C	T	0	2	2	0	0	2	0	0
9	54417949	.	A	T	2	4	6	0	0	7	1	0
9	54418687	.	T	C	4	8	12	0	0	12	0	0
9	54419201	.	A	G	2	2	4	0	1	5	0	0
9	54711802	.	A	G	4	3	7	0	0	7	0	0
9	54712645	.	T	C	15	4	19	0	4	23	0	0
9	54712650	.	T	C	4	12	16	0	3	20	1	0
9	56225617	.	A	G	6	4	10	0	0	10	0	0
